migrationfrom,migrationto,year,n_migrations,n_migrations_back,netmigrations
ES,CN,2003.0,30,16,14
JP,VN,2013.0,51,25,26
US,BO,2008.0,10,4,6
US,CA,2014.0,3360,3521,-161
DE,CN,2001.0,110,146,-36
GB,US,2006.0,4554,4785,-231
TN,IT,2014.0,16,12,4
FI,BD,2013.0,4,2,2
AU,GB,2012.0,1148,1466,-318
DE,NO,1998.0,22,10,12
CN,US,2009.0,5136,6927,-1791
US,IL,2007.0,387,492,-105
FR,US,2019.0,1593,1424,169
US,JP,2021.0,1164,1143,21
ES,EC,2017.0,222,107,115
GB,AU,2017.0,1541,1377,164
AR,nan,2005.0,19,25,-6
AU,CA,1999.0,146,147,-1
DE,CH,2007.0,714,485,229
nan,AU,2007.0,22,19,3
US,TW,2014.0,751,718,33
CH,IT,2020.0,307,330,-23
IN,GB,2011.0,351,395,-44
JP,GB,2000.0,220,194,26
SA,EG,2001.0,23,28,-5
US,IT,1997.0,413,410,3
IN,US,2015.0,2471,2607,-136
MX,GT,2018.0,35,20,15
MY,CN,2003.0,10,11,-1
FR,GB,2004.0,370,329,41
GB,BR,2015.0,217,225,-8
EC,CO,2021.0,97,108,-11
BE,US,2011.0,270,342,-72
GR,GB,2021.0,150,172,-22
IT,JP,2015.0,67,77,-10
BR,ES,2012.0,279,379,-100
US,NZ,2005.0,253,222,31
FR,US,2010.0,1381,1327,54
CA,JP,2012.0,114,105,9
US,IT,1998.0,500,466,34
SA,US,2021.0,158,291,-133
BR,US,2014.0,1120,1202,-82
US,BE,2015.0,418,390,28
CL,CH,2009.0,6,6,0
AU,NZ,1997.0,49,44,5
FR,US,2017.0,1600,1442,158
EC,AR,2009.0,6,4,2
RU,DE,2020.0,187,203,-16
NL,CH,2012.0,109,72,37
MX,RS,2008.0,50,26,24
DE,IE,2003.0,43,23,20
US,NZ,2002.0,209,183,26
IE,US,2021.0,391,399,-8
JP,CN,2008.0,704,392,312
HR,BA,2020.0,45,42,3
CO,US,2021.0,354,218,136
JP,ES,2012.0,30,31,-1
AU,CL,2020.0,21,25,-4
DE,RU,2006.0,136,159,-23
ET,KR,2015.0,109,99,10
CH,JP,2010.0,84,78,6
GB,AU,2010.0,1240,1169,71
nan,PT,2018.0,20,13,7
US,IR,2017.0,420,845,-425
US,IR,2019.0,506,767,-261
US,HU,2003.0,81,90,-9
KR,DE,2011.0,44,49,-5
US,CH,2015.0,911,872,39
GB,IT,2014.0,491,611,-120
PE,US,2022.0,77,64,13
DE,NL,2014.0,368,410,-42
TN,MA,2014.0,43,34,9
CH,JP,2017.0,94,121,-27
PH,US,1997.0,134,121,13
ZA,CH,2014.0,16,27,-11
US,BR,2012.0,1132,909,223
IQ,JP,2011.0,5,3,2
BR,nan,2004.0,27,17,10
NL,DK,2017.0,72,58,14
US,PH,2002.0,222,233,-11
IT,AT,2020.0,82,73,9
DE,FR,2010.0,494,494,0
NL,GB,2003.0,156,155,1
SE,CA,2016.0,41,65,-24
NG,US,2016.0,88,98,-10
NL,CO,2013.0,7,10,-3
PE,GB,2019.0,15,18,-3
JP,IE,2007.0,17,26,-9
US,DK,2014.0,302,249,53
VN,GB,2005.0,8,3,5
BE,NL,2004.0,144,120,24
US,MX,2011.0,315,346,-31
DE,nan,2011.0,87,58,29
GB,IE,2015.0,414,426,-12
AR,CL,2009.0,59,48,11
ES,CA,2021.0,62,72,-10
HR,RS,2017.0,134,127,7
nan,MY,2014.0,72,52,20
FR,CI,2002.0,9,4,5
US,PH,2005.0,295,285,10
PK,AR,2012.0,23,11,12
DK,NO,2007.0,60,85,-25
DE,ES,2008.0,147,133,14
RO,HU,1999.0,69,35,34
BE,CO,2022.0,5,8,-3
GB,MY,2009.0,104,52,52
EG,IT,1999.0,4,8,-4
JP,KR,1997.0,92,51,41
CH,JP,2019.0,116,82,34
MX,CR,2006.0,12,11,1
CL,FR,2021.0,35,39,-4
CU,ES,2001.0,48,36,12
EG,NG,2019.0,8,5,3
BE,NZ,2017.0,6,5,1
BE,NZ,2019.0,5,15,-10
FI,SE,2000.0,45,40,5
IE,GB,2007.0,203,279,-76
IN,KW,2014.0,9,12,-3
FR,CH,2007.0,403,297,106
US,IR,2010.0,198,249,-51
CO,IT,2011.0,8,12,-4
IS,ES,2010.0,5,4,1
NO,FR,1998.0,15,19,-4
AR,US,2018.0,297,321,-24
IL,CH,2003.0,17,4,13
ES,EC,2019.0,259,210,49
ZA,CA,2021.0,54,26,28
LB,AE,2011.0,2,3,-1
JP,FR,2006.0,97,115,-18
CA,nan,2021.0,28,21,7
FR,AT,2016.0,34,44,-10
CH,ZA,2014.0,27,16,11
BN,NZ,2016.0,3,1,2
DK,CN,2015.0,37,43,-6
SA,SD,2009.0,4,4,0
AU,NO,2013.0,28,9,19
IT,BR,2022.0,95,166,-71
CN,NL,2011.0,105,97,8
GR,NL,2006.0,13,16,-3
UG,IT,2014.0,2,5,-3
GB,FR,1999.0,225,314,-89
QA,SE,2003.0,2,4,-2
PK,US,2013.0,164,233,-69
TH,GB,2018.0,42,76,-34
DE,FR,2017.0,546,594,-48
KE,ZA,2012.0,10,15,-5
BE,ZA,2017.0,21,12,9
ZA,QA,2020.0,8,2,6
SY,US,2011.0,7,10,-3
KW,US,2006.0,18,21,-3
AT,SI,2012.0,19,12,7
VN,CN,2003.0,63,20,43
IT,CN,2007.0,41,19,22
GB,CH,2016.0,348,311,37
CN,nan,2008.0,203,226,-23
TH,CN,2012.0,21,18,3
HK,CN,2015.0,108,124,-16
AU,CN,2011.0,323,313,10
CN,TH,2009.0,11,12,-1
CZ,US,2016.0,110,184,-74
CN,IL,2004.0,20,16,4
CN,MY,2021.0,104,103,1
PK,CN,2004.0,47,29,18
CN,GB,2001.0,179,233,-54
RS,CN,2009.0,8,8,0
CN,UZ,2013.0,5,9,-4
CN,KR,2001.0,79,105,-26
MY,BD,2007.0,7,6,1
PH,CA,2009.0,9,10,-1
GB,SG,2004.0,60,44,16
CN,SG,2011.0,342,412,-70
MN,CN,2011.0,4,3,1
IR,ES,2018.0,31,18,13
TN,IQ,2017.0,5,2,3
IE,CA,2005.0,78,69,9
CO,DE,2021.0,30,28,2
US,RS,2019.0,66,58,8
NL,ID,2010.0,22,16,6
JP,MY,2013.0,98,41,57
FR,LB,2010.0,58,28,30
BG,UA,2003.0,6,6,0
TN,FR,2021.0,100,105,-5
GB,BG,2017.0,21,20,1
MX,CL,2020.0,206,199,7
RU,SE,2018.0,34,30,4
ES,BE,2018.0,127,95,32
SS,GB,2016.0,7,11,-4
ES,DK,2019.0,50,48,2
IE,ZA,2014.0,17,3,14
SK,US,2013.0,27,34,-7
NO,RU,2007.0,5,13,-8
AU,JP,2021.0,67,34,33
CH,SI,2019.0,8,13,-5
RU,UA,2004.0,83,91,-8
SA,IN,2017.0,85,176,-91
US,RS,2017.0,64,67,-3
MX,JP,2010.0,12,8,4
SE,CH,2015.0,83,71,12
JP,IT,2009.0,49,64,-15
AT,CH,2003.0,53,67,-14
GB,PT,2012.0,91,79,12
ES,ID,2018.0,12,20,-8
FR,EC,2018.0,21,8,13
SE,DK,2022.0,79,68,11
IN,IR,2020.0,37,17,20
CA,IE,2015.0,181,154,27
EG,JP,2009.0,55,71,-16
JP,RU,2002.0,39,50,-11
CA,PT,2013.0,25,20,5
NZ,SE,2014.0,9,8,1
AU,NZ,1998.0,53,57,-4
FI,PL,2017.0,10,6,4
NL,RO,2015.0,7,8,-1
HU,FI,2022.0,3,3,0
KW,SA,2009.0,8,4,4
FR,LB,2019.0,130,87,43
JP,TW,2000.0,54,34,20
BE,AT,2001.0,3,3,0
GB,RO,2011.0,27,29,-2
IR,QA,2022.0,4,4,0
TN,SA,2022.0,66,64,2
DE,SA,2012.0,35,13,22
RU,BY,2011.0,66,61,5
DK,BD,2019.0,3,1,2
GR,DE,2021.0,45,55,-10
IT,RO,2004.0,9,13,-4
KR,SA,2023.0,1,2,-1
IE,PK,2020.0,15,16,-1
US,RS,2010.0,43,53,-10
CN,BR,2022.0,12,17,-5
CH,NL,2000.0,26,30,-4
CL,DE,2009.0,34,38,-4
FR,AE,2020.0,16,7,9
JO,SD,2018.0,2,1,1
MY,NL,2019.0,16,11,5
FR,SN,2009.0,25,29,-4
FR,LB,2017.0,125,59,66
GB,CL,2012.0,38,31,7
SI,DE,2019.0,20,21,-1
FR,ID,2016.0,33,16,17
KR,VN,2012.0,45,26,19
ES,CH,2021.0,123,84,39
EG,SA,2009.0,138,71,67
PK,BD,2000.0,2,3,-1
LV,US,2019.0,14,5,9
ZA,KE,2002.0,3,6,-3
ES,PE,2006.0,29,22,7
IN,NO,2016.0,18,24,-6
CO,JP,2017.0,20,6,14
DE,KR,2022.0,42,35,7
HR,RS,2010.0,104,59,45
DK,AU,2021.0,47,42,5
CY,GR,2019.0,55,73,-18
ZM,JP,2018.0,3,2,1
PT,AR,2007.0,12,8,4
CH,SK,2004.0,13,8,5
CN,NP,2022.0,16,7,9
TR,CH,2017.0,24,19,5
DE,BG,2013.0,23,18,5
DE,BY,2018.0,9,4,5
HR,CZ,2014.0,11,4,7
BH,TW,2007.0,2,3,-1
AU,IR,2007.0,24,25,-1
PE,MX,2017.0,84,126,-42
NL,DK,2019.0,69,71,-2
CN,UA,2012.0,15,25,-10
SV,MX,2019.0,5,6,-1
SK,RU,2018.0,23,11,12
MX,IT,2014.0,32,39,-7
GB,SK,2001.0,15,38,-23
US,IS,1999.0,6,5,1
IS,SE,2015.0,15,25,-10
PA,MX,2011.0,5,4,1
SE,IT,2016.0,77,116,-39
CH,KR,2011.0,10,11,-1
OM,EG,2021.0,12,11,1
DE,GH,2015.0,10,1,9
ES,CZ,2002.0,1,3,-2
TN,IQ,2019.0,4,3,1
PT,DE,2018.0,59,46,13
ZA,IT,2020.0,20,19,1
VN,AU,2016.0,34,48,-14
BE,BI,2019.0,1,1,0
CA,BD,2020.0,46,47,-1
IT,HU,2020.0,13,7,6
FR,PL,2021.0,38,29,9
BD,ID,2020.0,61,54,7
PK,KR,2014.0,26,31,-5
NG,MY,2018.0,73,140,-67
AR,NL,2021.0,9,6,3
CN,NG,2022.0,30,35,-5
BD,FI,2017.0,7,5,2
LY,EG,2020.0,5,12,-7
SA,IN,2019.0,104,181,-77
CL,DK,2013.0,2,3,-1
PL,RU,2020.0,50,46,4
LV,BY,2020.0,1,1,0
FR,GA,2010.0,8,5,3
OM,QA,2014.0,5,1,4
PL,BR,2015.0,11,12,-1
IL,CN,2015.0,8,16,-8
CL,RS,2015.0,4,1,3
FR,KH,2017.0,8,10,-2
SG,US,1998.0,92,83,9
BE,CA,1998.0,19,18,1
CN,KZ,2012.0,13,11,2
FR,HR,2018.0,11,4,7
TR,CN,2018.0,39,17,22
NL,nan,2001.0,27,23,4
CL,JP,2020.0,8,8,0
AT,CA,2015.0,31,32,-1
NL,DE,2007.0,206,264,-58
EE,DE,2021.0,31,39,-8
US,RW,2017.0,14,14,0
GB,MX,2018.0,58,65,-7
EC,nan,2019.0,11,3,8
RU,FR,2020.0,80,120,-40
BH,EG,2017.0,9,6,3
PE,CR,2011.0,2,5,-3
PS,DE,2019.0,2,8,-6
NO,CA,2023.0,2,2,0
SA,GB,2021.0,99,159,-60
HU,IR,2020.0,2,13,-11
LY,IR,2022.0,1,5,-4
PL,US,1999.0,111,114,-3
KR,NZ,2022.0,9,8,1
MX,GB,2022.0,41,21,20
PL,UA,2015.0,19,40,-21
BD,AU,2022.0,60,33,27
BD,CA,2021.0,41,26,15
AU,SG,2009.0,74,79,-5
IE,DK,2018.0,14,7,7
IR,IQ,2016.0,10,4,6
BE,KR,2020.0,12,16,-4
GR,MK,2018.0,7,8,-1
NL,ID,2017.0,44,33,11
BE,RU,2005.0,12,11,1
LU,IR,2022.0,1,2,-1
MY,YE,2014.0,10,7,3
PH,FR,2016.0,8,9,-1
PT,UA,2018.0,4,2,2
NP,PH,2019.0,2,8,-6
CA,RO,2018.0,15,11,4
UG,PK,2015.0,2,1,1
FR,KR,2003.0,19,9,10
BD,FI,2019.0,6,2,4
UG,KE,2012.0,4,5,-1
NL,AU,2007.0,56,62,-6
IE,SA,2020.0,20,4,16
CN,IE,2020.0,36,36,0
AR,PK,2018.0,4,5,-1
MZ,RU,2014.0,12,6,6
TR,AU,2013.0,5,9,-4
MY,NL,2017.0,13,13,0
SK,CZ,2006.0,47,30,17
IE,PT,2021.0,8,4,4
IT,CA,2011.0,80,80,0
ID,MY,2020.0,223,395,-172
NL,ID,2019.0,50,45,5
FR,SI,2021.0,6,12,-6
JP,MA,2005.0,3,1,2
IR,VN,2019.0,13,2,11
MA,FR,2021.0,138,168,-30
FR,TG,2018.0,16,3,13
GB,TW,2016.0,46,57,-11
RU,IL,2015.0,27,43,-16
RO,ES,2020.0,19,25,-6
HU,PH,2016.0,1,1,0
MY,NL,2010.0,5,3,2
GB,SA,2009.0,56,27,29
SD,US,2007.0,6,4,2
TG,FR,2021.0,4,2,2
CH,NO,2018.0,31,20,11
BO,ES,2020.0,26,19,7
IE,CA,2002.0,38,54,-16
CH,GR,2018.0,36,36,0
IT,TH,2006.0,3,2,1
TN,CA,2013.0,10,8,2
MA,TN,2016.0,34,44,-10
BR,SG,2007.0,4,1,3
RU,IN,2011.0,13,5,8
NL,TR,2009.0,15,26,-11
PL,FI,2010.0,7,8,-1
BE,nan,2009.0,17,21,-4
JP,CA,2004.0,125,101,24
CO,GB,2013.0,27,24,3
TR,RS,2003.0,33,35,-2
HU,DE,2009.0,57,46,11
DE,HU,2013.0,50,65,-15
ES,CZ,2005.0,4,6,-2
IN,PH,2008.0,6,5,1
ID,IN,2006.0,1,2,-1
AT,ES,2012.0,24,23,1
AT,CZ,2015.0,27,21,6
SA,IN,2010.0,22,57,-35
PE,GB,2017.0,10,10,0
FR,KH,2019.0,11,10,1
US,DZ,2008.0,8,5,3
JP,RU,2005.0,42,22,20
JP,KR,1998.0,124,68,56
TR,CH,2019.0,36,27,9
GR,RU,2005.0,3,1,2
NL,DK,2010.0,35,32,3
EG,GR,2016.0,2,4,-2
ID,RU,2019.0,30,27,3
BH,EG,2019.0,9,6,3
MY,UA,2015.0,11,3,8
IL,DE,2014.0,59,75,-16
CO,nan,2017.0,20,7,13
HN,MX,2014.0,25,11,14
DE,DK,2003.0,66,63,3
RS,SI,2015.0,24,19,5
FR,NE,2021.0,16,23,-7
nan,GB,2004.0,56,60,-4
SV,MX,2010.0,3,3,0
IQ,PK,2021.0,35,27,8
PL,SK,2020.0,12,11,1
PL,VN,2007.0,2,1,1
BE,MY,2015.0,7,2,5
AE,PK,2015.0,19,11,8
KE,TZ,2015.0,11,4,7
nan,ID,2014.0,24,23,1
US,UG,2007.0,15,14,1
CA,TR,2018.0,24,35,-11
US,PT,2023.0,11,8,3
CY,GB,2014.0,26,49,-23
US,MU,2020.0,1,2,-1
GB,PH,2013.0,18,17,1
EC,nan,2017.0,6,5,1
BW,ZA,2011.0,8,6,2
PT,DK,2019.0,13,11,2
ES,IN,2020.0,34,22,12
FI,JP,2004.0,11,9,2
ZM,US,2013.0,14,8,6
PL,IL,2009.0,3,6,-3
AT,NO,2021.0,15,11,4
GR,FR,2013.0,63,27,36
LV,US,2017.0,12,6,6
IN,BN,2020.0,3,2,1
EG,NG,2017.0,9,5,4
CM,US,2014.0,9,18,-9
US,ZM,2015.0,24,16,8
ES,SK,2020.0,4,2,2
AT,JP,2022.0,10,4,6
US,ML,2006.0,4,3,1
FR,BI,2014.0,19,22,-3
MY,KR,2016.0,36,31,5
SK,SI,2022.0,5,2,3
PT,CA,2001.0,6,6,0
VE,MX,1998.0,11,10,1
US,VE,2000.0,29,21,8
BE,ES,1999.0,18,15,3
DK,BE,2022.0,39,38,1
TR,CA,2015.0,20,29,-9
SI,DE,2017.0,23,14,9
US,NI,2012.0,3,5,-2
IN,TR,2004.0,6,2,4
CO,JP,2019.0,11,12,-1
BW,AU,2016.0,4,4,0
CL,BR,1998.0,12,9,3
NL,PT,2007.0,19,6,13
FR,MC,2003.0,4,6,-2
GB,BG,2019.0,15,22,-7
FI,LT,2003.0,1,3,-2
CN,EG,2013.0,17,13,4
BE,BJ,2018.0,5,4,1
ZM,AU,2017.0,2,2,0
ET,NL,2017.0,8,8,0
US,KH,2015.0,7,10,-3
DE,JO,2020.0,12,8,4
CH,US,2023.0,28,31,-3
FJ,NL,2020.0,2,1,1
IN,AT,2018.0,17,14,3
ZA,FI,2018.0,5,7,-2
CN,NO,2015.0,32,48,-16
JP,BG,2001.0,6,4,2
BE,EC,2022.0,4,3,1
NL,PH,2020.0,9,4,5
PK,TZ,2021.0,4,1,3
IT,PL,2006.0,13,17,-4
VN,TW,2019.0,19,52,-33
EC,BO,2019.0,3,3,0
IR,TN,2020.0,8,10,-2
DE,PK,2022.0,21,24,-3
KE,NL,2021.0,10,7,3
MX,SA,2019.0,2,2,0
DK,GH,2008.0,2,2,0
UA,PL,2011.0,18,16,2
MX,DK,2018.0,7,2,5
CI,NG,2015.0,1,2,-1
DE,OM,2008.0,2,3,-1
MY,IT,2015.0,46,55,-9
UY,ES,2007.0,20,30,-10
TH,MY,2015.0,5,8,-3
CM,FR,2016.0,20,30,-10
CA,GR,2014.0,13,15,-2
nan,IL,2018.0,27,24,3
SA,ZA,2015.0,5,7,-2
CZ,BE,2003.0,3,2,1
US,CU,2013.0,23,28,-5
PE,MX,2010.0,37,46,-9
DK,IN,2018.0,16,26,-10
AE,BE,2020.0,2,4,-2
IL,KR,2019.0,9,5,4
NL,KW,2021.0,1,1,0
RO,CN,2007.0,3,3,0
QA,AU,2022.0,6,5,1
NG,BR,2014.0,2,3,-1
AR,DE,2006.0,25,17,8
HR,DE,2004.0,15,14,1
RU,BR,2008.0,11,8,3
ZA,IN,2006.0,17,16,1
RO,RU,2010.0,2,8,-6
IN,ID,2012.0,9,5,4
JP,IR,2012.0,23,9,14
ZW,ZA,2011.0,23,7,16
JP,SI,2006.0,3,5,-2
DE,LT,2020.0,6,10,-4
MX,CA,2003.0,17,11,6
IL,IN,2016.0,33,99,-66
ZA,ZW,2011.0,7,23,-16
JP,CL,2011.0,5,8,-3
LU,IE,2016.0,3,1,2
RU,SK,1999.0,4,5,-1
US,AM,2004.0,8,9,-1
GB,CZ,2000.0,10,13,-3
GH,IN,2008.0,4,1,3
IT,LT,2005.0,2,1,1
UA,CZ,2015.0,21,21,0
MK,CN,2003.0,3,5,-2
ZA,KE,2005.0,7,6,1
PT,GB,1997.0,15,17,-2
GB,LU,2006.0,5,5,0
OM,PK,2016.0,8,13,-5
RO,FR,2016.0,62,48,14
GB,UG,2014.0,14,11,3
BG,RU,2011.0,20,20,0
IT,MA,2006.0,11,1,10
GB,GH,2005.0,13,3,10
DE,AR,2005.0,18,21,-3
MA,DZ,2014.0,15,13,2
ES,BG,2016.0,11,3,8
GH,nan,2014.0,3,1,2
NP,PH,2017.0,4,4,0
AT,TR,2006.0,8,5,3
BE,MZ,2013.0,7,2,5
DE,EG,2000.0,10,5,5
ES,AU,2002.0,14,10,4
KR,RU,2006.0,14,9,5
JP,NO,2012.0,10,9,1
HU,SE,2021.0,12,6,6
EG,AT,2019.0,4,7,-3
MX,SI,2021.0,17,6,11
BR,DK,2004.0,4,6,-2
BG,AU,2021.0,2,1,1
IN,RS,2016.0,1,2,-1
RO,GB,2003.0,13,3,10
CY,GR,2017.0,29,73,-44
DK,RO,2013.0,3,2,1
BE,AU,2012.0,44,27,17
CO,JP,2010.0,7,9,-2
BE,HU,2000.0,6,4,2
IN,SD,2020.0,1,1,0
PL,AT,2001.0,8,1,7
MU,AU,2011.0,3,1,2
CA,LB,2003.0,6,4,2
GE,DE,2007.0,6,2,4
DK,NL,2002.0,15,20,-5
AU,BE,2003.0,18,21,-3
PH,IL,2012.0,3,2,1
US,JO,2009.0,44,24,20
VN,FR,2022.0,22,26,-4
BE,IE,2015.0,13,11,2
IT,KZ,2017.0,6,3,3
AE,KW,2020.0,2,4,-2
CA,MX,1998.0,10,10,0
NA,ZA,2009.0,1,2,-1
LT,RU,2013.0,6,15,-9
RU,HU,2022.0,19,8,11
PH,TH,2008.0,1,1,0
RU,NL,2011.0,25,22,3
CA,KR,1997.0,10,5,5
EG,MA,2011.0,3,3,0
CN,IN,1998.0,8,11,-3
PE,GB,2010.0,10,9,1
PT,ZA,2021.0,9,2,7
IN,MY,2006.0,26,16,10
BE,IN,2012.0,21,36,-15
IE,JP,2001.0,20,26,-6
AT,NZ,2015.0,10,5,5
CN,GE,2009.0,4,1,3
TH,FI,2006.0,3,1,2
nan,TW,2009.0,6,9,-3
IS,ES,2017.0,5,13,-8
AO,BR,2008.0,13,14,-1
BR,PL,2011.0,3,10,-7
GB,BG,2010.0,7,13,-6
ES,EC,2010.0,17,28,-11
PT,IT,2000.0,4,7,-3
TW,GB,2000.0,22,28,-6
JP,RO,2000.0,3,4,-1
IN,UG,2012.0,1,2,-1
SS,AU,2006.0,1,1,0
NZ,FJ,2000.0,1,1,0
FR,IL,2006.0,27,27,0
NZ,BR,2014.0,13,9,4
NO,JP,2018.0,7,11,-4
TR,KG,2018.0,3,1,2
SE,HU,2001.0,8,11,-3
DK,MY,2018.0,7,8,-1
EE,SE,2012.0,5,4,1
TR,JP,2015.0,16,27,-11
KR,ES,2009.0,7,3,4
TH,SG,2009.0,2,2,0
JP,SA,2003.0,3,2,1
GB,TH,2008.0,43,24,19
JO,US,2004.0,12,25,-13
NO,HU,2017.0,7,6,1
NO,HU,2019.0,4,4,0
SG,NL,2023.0,2,1,1
MX,PT,2012.0,20,14,6
CR,MX,2013.0,18,24,-6
SN,CH,2014.0,2,1,1
DK,KR,1997.0,2,1,1
BF,CH,2003.0,1,1,0
IR,PL,2022.0,11,7,4
PK,KW,2010.0,2,5,-3
ZA,NA,2021.0,14,5,9
IE,HR,2011.0,10,4,6
BY,DE,2001.0,9,4,5
PK,NZ,2013.0,4,9,-5
BG,SE,2008.0,2,2,0
PT,TW,2004.0,1,1,0
CN,CO,2005.0,1,3,-2
NL,BG,2012.0,6,1,5
GR,CN,2015.0,18,11,7
BE,ZA,2019.0,22,30,-8
NA,ZW,2020.0,1,1,0
VN,DK,2011.0,4,3,1
OM,NZ,2015.0,3,1,2
KW,EG,2006.0,7,6,1
FI,ES,2015.0,18,28,-10
SG,ID,2013.0,9,4,5
BE,BI,2017.0,1,1,0
DE,NG,2021.0,14,14,0
AM,JP,1998.0,21,1,20
FI,BR,2018.0,7,12,-5
IT,KZ,2019.0,3,2,1
EE,FI,2013.0,9,11,-2
CH,LK,2012.0,6,5,1
AZ,RU,2008.0,6,10,-4
MM,US,2021.0,15,12,3
LY,US,2017.0,3,5,-2
AU,GR,2008.0,9,4,5
YE,CA,2018.0,1,1,0
RS,IT,2018.0,10,6,4
CL,GB,2011.0,26,33,-7
BE,RO,2006.0,8,2,6
VN,MX,2013.0,5,5,0
TR,CH,2010.0,17,8,9
VN,TW,2010.0,5,5,0
IT,DZ,2021.0,28,27,1
PL,FI,2019.0,11,9,2
NP,PK,2018.0,6,5,1
ZA,EG,2016.0,6,4,2
VN,TW,2017.0,15,30,-15
CZ,CL,2016.0,1,4,-3
CN,EE,2016.0,1,3,-2
KR,NP,2015.0,9,8,1
MY,QA,2016.0,12,1,11
VN,JP,2012.0,22,50,-28
IQ,BD,2022.0,9,2,7
NL,ES,2004.0,41,46,-5
SI,CH,2022.0,5,2,3
RO,RU,2019.0,8,12,-4
LB,BE,2015.0,6,5,1
RO,DE,1999.0,10,5,5
LB,DE,2019.0,7,6,1
SY,NL,2009.0,1,1,0
IN,ML,2012.0,3,8,-5
PE,CU,2013.0,7,11,-4
CZ,TW,2008.0,1,3,-2
GW,DK,2011.0,1,3,-2
SA,JO,2008.0,8,11,-3
CN,PT,1999.0,8,5,3
US,MW,2011.0,15,5,10
IT,UA,2008.0,18,15,3
UG,DE,2013.0,2,3,-1
IL,FI,2022.0,1,5,-4
DK,JP,2004.0,10,6,4
KE,PE,2019.0,2,2,0
LU,SN,2015.0,1,1,0
FR,CG,2018.0,17,20,-3
BR,VE,2000.0,5,6,-1
NO,AT,2008.0,5,9,-4
BE,NZ,2010.0,4,5,-1
MA,BD,2021.0,18,17,1
BF,FR,2013.0,15,15,0
RS,RU,2013.0,4,5,-1
AL,DE,2003.0,1,2,-1
CY,GR,2010.0,15,31,-16
US,ZW,2018.0,7,8,-1
FR,KH,2010.0,7,6,1
UA,SK,2005.0,2,3,-1
CH,nan,2012.0,11,17,-6
ZA,LK,2010.0,1,1,0
DK,HU,2014.0,2,3,-1
NZ,IT,2019.0,8,9,-1
DE,SI,2006.0,3,5,-2
BE,KE,2002.0,4,4,0
SI,DE,2010.0,10,12,-2
CA,IS,1999.0,1,3,-2
ZA,NG,2006.0,3,11,-8
US,RW,2010.0,6,8,-2
PL,CH,2005.0,12,17,-5
MX,RO,2021.0,2,1,1
CH,IR,2007.0,6,8,-2
NO,IS,2018.0,8,14,-6
OM,JP,2018.0,1,2,-1
KE,BE,2015.0,4,6,-2
ZA,PL,2020.0,7,4,3
HR,US,2011.0,42,44,-2
RE,FR,2007.0,12,18,-6
BE,JP,2003.0,17,25,-8
nan,RU,2021.0,37,44,-7
AM,JP,1997.0,9,5,4
IT,AE,2013.0,2,2,0
IS,NO,2010.0,9,9,0
EG,AT,2010.0,5,3,2
ZA,NO,2020.0,7,6,1
SE,RU,2008.0,13,38,-25
JP,PK,2007.0,18,12,6
KR,LB,2019.0,1,1,0
LV,US,2010.0,9,6,3
SN,ZA,2019.0,2,2,0
RO,NL,2011.0,7,7,0
LI,DE,2010.0,6,2,4
NC,US,2003.0,1,1,0
BE,CA,1997.0,17,19,-2
SK,DE,2022.0,25,11,14
RU,AR,2021.0,2,2,0
VE,AR,2006.0,13,10,3
IN,SK,2017.0,4,2,2
ID,ES,2008.0,9,10,-1
KR,AT,2010.0,2,8,-6
CH,SA,2020.0,8,9,-1
ID,NO,2015.0,4,6,-2
MY,AU,2003.0,9,9,0
ME,RS,2002.0,2,1,1
SK,PL,2012.0,7,5,2
CA,CY,2019.0,4,4,0
AU,QA,2009.0,8,8,0
CZ,HU,2008.0,1,4,-3
SG,SE,2023.0,1,1,0
US,GP,2006.0,1,1,0
DZ,ES,2007.0,3,1,2
TW,nan,2012.0,6,4,2
HU,IT,2016.0,8,11,-3
AR,AT,2006.0,3,3,0
IR,GB,2004.0,21,60,-39
IQ,BH,2017.0,1,6,-5
BD,IN,2004.0,5,5,0
PT,CU,2013.0,2,2,0
BF,BE,2009.0,2,4,-2
OM,DE,2020.0,2,3,-1
ID,NL,2015.0,18,37,-19
MX,RU,2008.0,7,6,1
PT,AT,2013.0,3,7,-4
KR,ZA,2013.0,1,1,0
CA,NL,2003.0,33,54,-21
CN,SI,2002.0,1,1,0
CZ,DK,2001.0,2,3,-1
ID,AZ,2013.0,7,8,-1
NO,NL,2001.0,4,10,-6
ES,BO,2012.0,12,11,1
PK,IN,2000.0,10,17,-7
SI,AT,2000.0,3,3,0
ZA,DK,2005.0,5,5,0
NG,BE,2017.0,2,2,0
CR,CL,2000.0,3,4,-1
CO,nan,2019.0,12,9,3
NL,SG,2001.0,5,1,4
AU,TW,2009.0,30,24,6
CI,GB,2019.0,3,1,2
ES,GR,2018.0,22,16,6
KR,PL,2013.0,8,2,6
GR,ES,2021.0,10,13,-3
NZ,DE,2000.0,19,7,12
AU,CO,2009.0,6,2,4
CA,JO,2016.0,10,12,-2
CA,HR,2011.0,2,1,1
ZA,LS,2014.0,2,2,0
JO,GB,2001.0,4,9,-5
AR,TR,2014.0,5,2,3
FR,GA,2019.0,17,4,13
TT,US,2013.0,12,8,4
TH,MX,2019.0,2,1,1
IL,PS,2022.0,5,4,1
EG,DZ,2018.0,7,14,-7
JO,SY,2013.0,3,3,0
CA,UY,2017.0,5,4,1
IE,CY,2017.0,2,1,1
TW,TZ,2019.0,2,1,1
CO,IE,2017.0,3,3,0
SA,DZ,2020.0,4,12,-8
FI,ID,2021.0,5,9,-4
PH,CL,2019.0,2,9,-7
AT,AE,2010.0,3,1,2
BY,EE,2020.0,2,1,1
TN,CH,2020.0,8,15,-7
FR,ZW,2019.0,1,3,-2
JP,PH,1999.0,10,2,8
NL,HK,2013.0,11,15,-4
PH,IE,2002.0,2,1,1
GR,MX,2010.0,3,5,-2
IN,SG,2008.0,44,42,2
AU,TR,2005.0,8,4,4
PL,HU,2011.0,11,13,-2
LB,DE,2017.0,11,8,3
HR,CA,2002.0,3,2,1
RS,ES,2006.0,2,2,0
DK,HR,2021.0,5,2,3
IL,RS,1999.0,1,2,-1
CA,UY,2019.0,3,2,1
IR,CN,2012.0,30,17,13
SA,BD,2011.0,4,6,-2
HU,PL,2004.0,7,13,-6
NO,CZ,1999.0,4,3,1
AU,UG,2019.0,5,6,-1
PH,JP,2004.0,7,11,-4
nan,NG,2004.0,1,1,0
AU,ZW,2012.0,1,2,-1
AU,LV,2011.0,4,1,3
PL,LT,2012.0,1,1,0
NO,PT,2021.0,3,9,-6
SI,GB,2022.0,7,8,-1
DO,CU,2021.0,1,1,0
EG,TZ,2020.0,3,2,1
JP,NP,2021.0,7,3,4
SA,IQ,2011.0,3,3,0
SI,ME,2015.0,1,1,0
SD,BR,2009.0,4,5,-1
GB,JM,2013.0,5,2,3
PL,PK,2018.0,10,9,1
TH,IT,2012.0,3,5,-2
CI,NL,2012.0,1,1,0
AZ,TR,2020.0,15,27,-12
KE,ES,2009.0,2,4,-2
AU,PL,2001.0,6,2,4
PH,CH,2008.0,3,3,0
FR,CI,2005.0,6,3,3
GR,SE,1999.0,2,3,-1
PL,IT,1999.0,6,6,0
GB,GH,2002.0,4,3,1
MX,GR,2013.0,6,5,1
RU,SG,2014.0,8,7,1
LV,DE,2000.0,4,3,1
UA,IN,2017.0,4,6,-2
ET,BE,2015.0,7,9,-2
FI,DK,2023.0,2,1,1
IT,CU,2003.0,4,2,2
KR,NO,2012.0,5,2,3
ZW,GB,2006.0,5,3,2
ES,SI,2020.0,8,16,-8
CZ,EG,2012.0,2,2,0
AE,SE,2019.0,4,5,-1
BE,AE,2014.0,1,3,-2
GB,VE,2015.0,7,10,-3
NZ,IT,2017.0,11,13,-2
IT,RS,2013.0,9,3,6
MK,GB,2021.0,2,1,1
IN,ET,2010.0,5,3,2
GB,MM,2016.0,4,1,3
FR,UG,2018.0,9,5,4
CA,TN,2022.0,4,4,0
AU,TR,2002.0,6,9,-3
UA,CH,2017.0,7,4,3
FI,MX,2007.0,1,1,0
CH,RU,2007.0,12,18,-6
HU,CN,2014.0,3,5,-2
GB,KH,2016.0,7,2,5
BD,CO,2022.0,1,1,0
IE,CN,2023.0,1,6,-5
BR,BO,2013.0,3,3,0
AE,NG,2014.0,1,2,-1
UA,MY,2022.0,2,3,-1
IN,LY,2007.0,2,1,1
SK,FR,2012.0,9,8,1
IN,PL,2006.0,7,1,6
LV,RU,2020.0,18,14,4
BR,RU,2022.0,9,3,6
LU,NL,2017.0,4,3,1
NP,US,2023.0,2,2,0
UA,IN,2019.0,6,6,0
TR,KR,2021.0,2,9,-7
IR,MA,2009.0,2,2,0
NZ,KR,2012.0,8,7,1
DE,PS,2008.0,4,2,2
NE,FR,2007.0,1,6,-5
EG,DK,2006.0,1,4,-3
BE,RU,2002.0,16,19,-3
DE,AR,2002.0,6,18,-12
AT,IE,1998.0,3,1,2
US,KN,2015.0,5,3,2
NL,HU,2020.0,10,14,-4
FI,PL,2019.0,9,11,-2
CI,nan,2000.0,1,1,0
FI,PL,2010.0,8,7,1
JP,BJ,2019.0,1,1,0
UZ,US,2014.0,2,5,-3
AE,SE,2017.0,2,7,-5
SA,JP,2006.0,7,3,4
IN,VN,2016.0,3,4,-1
HU,AU,2012.0,7,2,5
US,BT,2011.0,1,1,0
CN,RO,2011.0,2,3,-1
CA,MX,1997.0,7,5,2
AE,CA,2000.0,2,3,-1
NO,ES,2007.0,9,21,-12
IT,PA,2019.0,2,3,-1
ID,RU,2017.0,11,12,-1
EE,CH,2021.0,8,11,-3
LT,DE,2009.0,5,8,-3
HR,nan,2020.0,1,1,0
JM,TT,2021.0,8,17,-9
LK,CA,2021.0,2,6,-4
NL,HR,2013.0,5,7,-2
IN,CH,1999.0,5,7,-2
CO,IE,2019.0,1,4,-3
BD,SY,2020.0,1,2,-1
JO,QA,2005.0,2,1,1
ET,EG,2004.0,1,2,-1
FR,IE,2003.0,12,11,1
MM,MY,2016.0,5,5,0
CR,FR,2002.0,1,2,-1
AR,nan,2002.0,14,15,-1
PT,DK,2010.0,4,6,-2
CA,UY,2010.0,3,1,2
ZA,SA,2011.0,3,1,2
IL,PK,2019.0,2,2,0
ES,HU,2020.0,2,7,-5
IE,RS,2014.0,1,4,-3
AR,CN,2012.0,1,3,-2
RW,CD,2016.0,3,1,2
DE,ID,2007.0,11,10,1
BW,BR,2020.0,1,1,0
RO,RU,2017.0,13,2,11
KR,FI,2009.0,4,23,-19
PS,EG,2006.0,2,2,0
PY,ES,2022.0,8,10,-2
BD,TH,2008.0,1,2,-1
AU,UG,2017.0,4,10,-6
AU,IQ,2009.0,2,3,-1
XK,HR,2011.0,2,1,1
KE,PE,2017.0,2,3,-1
SK,IT,2008.0,3,5,-2
BY,AZ,2010.0,1,1,0
ZA,GR,2018.0,5,4,1
PK,MX,2021.0,2,1,1
GB,RW,2017.0,3,1,2
JO,IN,2004.0,2,3,-1
ID,QA,2021.0,1,3,-2
IS,NO,2017.0,7,8,-1
CO,nan,2010.0,8,1,7
DE,MA,2004.0,1,5,-4
SY,GB,2020.0,6,3,3
LI,CH,2015.0,3,1,2
ES,TR,2012.0,5,7,-2
NG,BD,2020.0,2,6,-4
PT,SE,2007.0,1,5,-4
KE,MX,2014.0,2,2,0
BG,PL,2012.0,1,2,-1
CR,FR,2005.0,2,2,0
CY,JP,2008.0,2,1,1
CZ,IE,2009.0,3,2,1
RO,BR,2006.0,3,1,2
VN,ID,2018.0,1,1,0
AU,RU,1998.0,3,13,-10
SE,AE,2014.0,3,3,0
PT,LU,2014.0,3,2,1
BR,GR,2018.0,4,3,1
SE,AR,2013.0,4,12,-8
CA,AR,1999.0,4,5,-1
NL,MY,2021.0,7,7,0
PT,CN,2005.0,6,14,-8
US,JM,2022.0,5,8,-3
CA,CY,2010.0,4,2,2
BJ,DE,2011.0,1,2,-1
KR,HU,2005.0,2,3,-1
CN,MM,2000.0,3,1,2
NZ,IT,2010.0,4,4,0
KR,AT,2019.0,5,7,-2
ET,DE,2011.0,7,6,1
KW,MY,2020.0,6,8,-2
CN,HU,2000.0,2,3,-1
ZA,RW,2014.0,1,3,-2
nan,CZ,2004.0,5,2,3
IT,PH,2002.0,2,1,1
HU,KW,2001.0,1,1,0
IS,NL,2017.0,1,1,0
JP,AE,2007.0,3,3,0
BR,AO,2005.0,5,11,-6
FR,MK,2016.0,2,3,-1
DK,SI,2009.0,1,1,0
ET,NL,2010.0,5,4,1
BG,IE,2011.0,5,1,4
FR,ML,2001.0,1,1,0
PL,ES,2003.0,2,4,-2
MX,FI,2009.0,3,1,2
ID,UZ,2021.0,4,2,2
CI,IT,2014.0,1,1,0
NP,NO,2013.0,3,2,1
UA,VN,2016.0,2,6,-4
nan,UA,2006.0,8,16,-8
MD,BE,2015.0,4,1,3
AR,DK,2001.0,2,1,1
CA,AO,2016.0,1,1,0
PT,ID,2020.0,5,2,3
IE,RU,2015.0,6,5,1
NO,SK,2020.0,1,3,-2
LB,IT,2007.0,9,2,7
nan,BG,2009.0,4,1,3
HU,JP,1999.0,5,9,-4
CM,NG,2019.0,7,4,3
TR,PS,2011.0,4,2,2
NG,CM,2006.0,2,3,-1
NZ,SG,2003.0,9,3,6
ZA,LK,2019.0,2,2,0
PA,CN,2022.0,2,1,1
AU,PT,2022.0,10,12,-2
BH,EG,2010.0,1,4,-3
AU,UG,2010.0,2,1,1
ZA,TH,2001.0,1,2,-1
LT,FI,2011.0,3,2,1
BD,DK,2017.0,4,2,2
CH,SI,2017.0,1,17,-16
TN,DE,2021.0,4,9,-5
SI,CN,2002.0,1,1,0
NG,BE,2019.0,4,6,-2
BW,ZW,2021.0,1,3,-2
NG,FR,2007.0,3,3,0
BG,GR,2009.0,4,3,1
LY,US,2010.0,2,2,0
GE,AU,2012.0,2,2,0
BO,MX,2020.0,10,8,2
MT,CA,2020.0,3,2,1
AE,ES,2020.0,4,6,-2
EG,QA,2008.0,9,9,0
NL,MA,2019.0,2,3,-1
UA,DK,2021.0,1,2,-1
VE,DE,2013.0,3,2,1
BE,VN,2008.0,5,2,3
SK,CN,2015.0,2,1,1
ID,GB,2003.0,2,6,-4
US,KG,2021.0,4,2,2
VN,PK,2020.0,3,5,-2
RO,JP,2015.0,5,5,0
FI,AT,2001.0,4,4,0
UG,CA,2020.0,2,2,0
SG,MX,2021.0,3,2,1
GD,GB,2012.0,2,3,-1
BE,KE,2005.0,1,3,-2
SA,MA,2006.0,1,1,0
UA,HR,2016.0,3,2,1
GH,ZM,2015.0,8,33,-25
ZW,AE,2003.0,1,2,-1
ET,TR,2021.0,4,2,2
NZ,GR,2019.0,1,2,-1
PL,NG,2019.0,1,4,-3
KH,KR,2017.0,1,2,-1
FI,TR,2007.0,4,5,-1
ZA,CM,2016.0,6,9,-3
CO,NZ,2020.0,3,2,1
KR,RS,2016.0,1,2,-1
BR,AG,2022.0,1,3,-2
QA,KR,2017.0,3,5,-2
IQ,nan,2018.0,1,1,0
CR,CN,2019.0,1,2,-1
PE,AR,2001.0,4,4,0
NO,HU,2010.0,1,6,-5
LT,CZ,2014.0,1,2,-1
HU,VN,2016.0,1,2,-1
PL,IS,2019.0,1,2,-1
IE,CZ,2005.0,1,1,0
DE,PA,2017.0,3,5,-2
IS,NL,2019.0,1,6,-5
IE,NZ,2003.0,5,5,0
BO,CN,2000.0,1,3,-2
IL,BE,2008.0,5,4,1
MA,US,2006.0,7,14,-7
CZ,IR,2016.0,4,2,2
ME,RS,2005.0,1,4,-3
US,NE,2003.0,2,1,1
IE,PE,2020.0,3,2,1
PY,IT,2022.0,1,1,0
TH,BR,2013.0,3,7,-4
PE,VE,1997.0,1,1,0
JO,KW,2013.0,3,5,-2
PT,KR,2014.0,4,8,-4
BG,CH,2016.0,3,3,0
GE,ES,2009.0,2,1,1
NO,RS,2008.0,2,2,0
DK,IR,2004.0,2,1,1
UG,MY,2017.0,1,3,-2
LB,TN,2013.0,2,1,1
UA,CH,2019.0,3,10,-7
CA,ET,2015.0,3,3,0
TR,BH,2017.0,2,2,0
SG,VN,2022.0,9,8,1
RU,TN,2018.0,2,5,-3
GB,RW,2019.0,3,2,1
BH,TZ,2006.0,2,1,1
IE,ID,2012.0,5,2,3
IR,SE,1999.0,1,1,0
MY,BN,2012.0,5,5,0
NC,AU,2013.0,1,1,0
TW,PH,2016.0,4,5,-1
SE,CO,2018.0,5,11,-6
BJ,CA,2012.0,1,3,-2
LU,NL,2019.0,5,11,-6
UA,IN,2010.0,6,1,5
LB,CH,2018.0,3,5,-2
PA,ES,2011.0,8,13,-5
GR,IE,1999.0,1,1,0
CU,LB,2006.0,2,4,-2
GB,BH,2020.0,4,8,-4
AE,FR,2013.0,1,10,-9
DK,IS,2011.0,8,4,4
ZA,CN,1998.0,1,2,-1
LT,EE,2016.0,2,1,1
RU,PT,2004.0,3,5,-2
RU,CM,2021.0,1,1,0
ZW,AU,2019.0,3,1,2
CR,CN,2010.0,2,2,0
AU,RU,1997.0,2,8,-6
NO,SJ,2000.0,2,1,1
IR,KW,2008.0,3,3,0
KZ,IN,2020.0,2,2,0
PE,nan,2013.0,7,10,-3
CZ,FI,2001.0,2,3,-1
IN,FI,1999.0,3,1,2
CY,CA,2013.0,3,1,2
BT,TH,2020.0,2,6,-4
TZ,JP,2014.0,1,6,-5
KE,CO,2008.0,2,3,-1
TW,NL,2008.0,2,3,-1
IT,CY,2022.0,3,4,-1
NZ,GR,2017.0,1,3,-2
NL,MA,2017.0,2,1,1
PL,AM,2017.0,1,1,0
BD,ZA,2020.0,2,2,0
SY,FR,2000.0,3,1,2
NZ,GH,2018.0,2,1,1
TZ,CN,2020.0,5,8,-3
NL,TZ,2020.0,1,3,-2
CH,EG,2011.0,6,4,2
CR,DK,2017.0,1,1,0
PT,ME,2021.0,1,1,0
SE,LK,2018.0,3,1,2
ID,MX,2007.0,1,1,0
AU,PA,2005.0,4,2,2
MC,FR,2000.0,1,2,-1
MN,JP,2018.0,6,17,-11
BO,FR,2003.0,2,3,-1
PS,DE,2017.0,3,10,-7
IQ,QA,2015.0,1,1,0
NI,VE,2007.0,1,1,0
JM,BB,2014.0,5,9,-4
PE,FR,2007.0,2,1,1
FR,GE,2009.0,1,1,0
IE,CY,2010.0,1,1,0
IE,CO,2006.0,1,1,0
DK,NZ,2001.0,1,3,-2
AU,LB,2011.0,1,1,0
AE,RU,2019.0,1,2,-1
TR,SA,2002.0,4,3,1
RO,SE,1997.0,2,1,1
CL,NO,2014.0,1,2,-1
AM,FR,2011.0,3,2,1
JP,SK,2014.0,4,10,-6
IE,VN,2021.0,2,3,-1
IT,KE,2022.0,3,3,0
PE,CN,2013.0,2,1,1
IQ,NG,2022.0,2,1,1
NP,PH,2010.0,1,2,-1
ZM,IN,2021.0,1,3,-2
DE,BJ,1999.0,4,2,2
PL,IS,2017.0,2,2,0
LU,IT,2008.0,4,1,3
CY,DE,2015.0,3,1,2
JO,CH,2008.0,1,1,0
KZ,IR,2021.0,3,6,-3
PY,EC,2020.0,2,4,-2
UY,MX,2007.0,4,10,-6
CZ,GE,2018.0,1,3,-2
NI,MY,2013.0,1,1,0
IL,IE,1999.0,1,1,0
BA,AT,2011.0,2,1,1
AF,IR,2018.0,1,6,-5
EC,UY,2021.0,5,2,3
FR,XK,2019.0,2,1,1
MY,PT,2021.0,2,1,1
FR,MR,2018.0,2,3,-1
BZ,FR,2001.0,4,1,3
KH,GN,2020.0,1,1,0
PH,CL,2010.0,3,1,2
GY,CA,2008.0,1,1,0
CZ,AE,2019.0,2,2,0
FR,GA,2017.0,2,8,-6
GH,ML,2020.0,2,1,1
ID,IL,2012.0,1,1,0
GB,RW,2010.0,2,1,1
BR,PK,2014.0,5,5,0
BD,ES,2001.0,1,4,-3
SY,BE,2010.0,1,1,0
TR,SA,2005.0,1,5,-4
JP,BH,2014.0,3,1,2
NO,CL,2016.0,3,3,0
KZ,AE,2019.0,2,3,-1
JP,PE,2008.0,1,2,-1
VN,BE,2016.0,4,15,-11
GM,US,2000.0,1,1,0
HR,CA,2005.0,2,1,1
LK,ET,2010.0,1,1,0
NO,ZA,2009.0,3,5,-2
KE,BW,2018.0,2,5,-3
GP,AT,2015.0,1,1,0
MN,RU,2009.0,5,2,3
QA,KR,2010.0,1,4,-3
UZ,JP,2018.0,1,2,-1
ZM,GB,2021.0,2,1,1
US,BB,2021.0,3,2,1
TJ,RU,2006.0,3,4,-1
US,MK,2018.0,10,6,4
NZ,TR,2020.0,3,4,-1
LB,DE,2010.0,1,4,-3
IL,IR,2020.0,1,4,-3
NZ,PK,2022.0,6,5,1
PL,GR,2003.0,4,4,0
GR,RU,2002.0,3,2,1
DE,CU,2015.0,1,5,-4
GB,UA,2001.0,4,14,-10
TR,NZ,2016.0,2,2,0
IT,AO,2017.0,1,2,-1
JP,AR,2001.0,2,3,-1
CH,MA,2013.0,2,1,1
SE,TH,2022.0,4,2,2
CO,IE,2010.0,1,8,-7
DE,PA,2010.0,2,4,-2
IE,BH,2019.0,3,1,2
TH,ZA,2016.0,2,4,-2
BF,SN,2007.0,1,1,0
MU,GB,1998.0,2,1,1
ES,SA,2015.0,8,3,5
NO,BG,2010.0,3,12,-9
GR,MX,2019.0,3,4,-1
EE,AU,1999.0,1,2,-1
HR,RU,2013.0,3,2,1
TZ,NG,2011.0,3,1,2
BR,FI,2011.0,5,4,1
GR,MX,2017.0,4,2,2
AR,PL,2004.0,1,1,0
IE,CY,2019.0,1,1,0
RU,AM,1998.0,4,5,-1
TN,MY,2011.0,2,2,0
DE,SN,2022.0,1,1,0
GB,SS,2007.0,3,15,-12
PH,ZA,2017.0,2,2,0
AT,AE,2017.0,1,1,0
ZA,MX,2006.0,2,3,-1
ES,FI,2003.0,3,7,-4
EG,SY,2014.0,3,3,0
UA,AM,2019.0,2,1,1
BF,ML,2012.0,2,2,0
BR,CN,2000.0,7,4,3
HR,NL,1998.0,3,1,2
BD,BE,2016.0,3,3,0
BA,US,1999.0,1,1,0
NP,CA,2022.0,1,4,-3
GR,nan,2021.0,1,1,0
MX,BG,2010.0,1,2,-1
GE,CA,2016.0,1,2,-1
SA,TR,2000.0,1,1,0
CI,US,2012.0,3,6,-3
DK,NG,2020.0,2,1,1
SY,EG,2022.0,3,6,-3
KE,BF,2011.0,1,1,0
CZ,AT,2023.0,1,1,0
CY,LB,2020.0,2,2,0
NP,FI,2022.0,2,2,0
GB,ID,1998.0,4,4,0
IR,DE,2023.0,2,2,0
BW,SZ,2009.0,1,1,0
PY,UY,2016.0,2,1,1
UG,CG,2015.0,1,1,0
IE,TR,2005.0,1,3,-2
CM,SN,2002.0,1,1,0
HR,MK,2018.0,2,1,1
PT,SI,2013.0,1,3,-2
FJ,DK,2015.0,1,1,0
QA,CH,2015.0,2,1,1
KE,FI,2011.0,2,1,1
US,FI,2004.0,143,119,24
KR,JP,2015.0,309,408,-99
PL,CH,2002.0,13,12,1
DE,FR,2019.0,530,588,-58
US,AR,2009.0,234,183,51
NL,BE,1999.0,90,93,-3
CH,GB,2012.0,230,316,-86
ES,DK,2017.0,54,35,19
CA,BR,2013.0,273,274,-1
HR,RS,2019.0,148,154,-6
SG,US,1997.0,58,51,7
SK,BE,2014.0,3,2,1
DE,BE,2018.0,139,163,-24
KR,PH,2018.0,7,10,-3
UA,AT,2016.0,5,5,0
IN,ET,2019.0,65,22,43
nan,IN,2001.0,12,1,11
JP,NL,2012.0,34,35,-1
PH,US,1998.0,189,155,34
IT,IR,2022.0,16,52,-36
EE,FR,2008.0,4,2,2
JP,BE,2003.0,25,17,8
TR,DE,2015.0,68,60,8
MK,GR,2018.0,8,7,1
FR,RO,2020.0,59,30,29
MA,SY,2021.0,3,4,-1
MX,JP,2019.0,17,11,6
MA,MY,2020.0,6,8,-2
ES,IL,2007.0,7,9,-2
GB,DK,2008.0,136,96,40
US,RW,2019.0,24,14,10
AT,RU,2008.0,8,14,-6
KR,TH,2009.0,7,10,-3
QA,US,2011.0,22,61,-39
DE,NZ,2016.0,40,49,-9
IN,SE,2016.0,60,43,17
EG,AT,2017.0,4,6,-2
NL,IT,2008.0,62,82,-20
CM,nan,2018.0,10,10,0
SG,AT,2014.0,6,3,3
BR,JP,2004.0,33,35,-2
AU,FR,2015.0,120,133,-13
CH,ZW,2008.0,1,3,-2
CU,MX,2007.0,27,34,-7
MX,JP,2017.0,11,6,5
ES,AU,2005.0,19,15,4
PE,NL,2015.0,1,1,0
CA,KR,1998.0,13,10,3
TR,BE,2015.0,15,15,0
SN,ZA,2017.0,3,2,1
TH,US,2000.0,20,60,-40
CL,PE,2014.0,64,50,14
DK,ZA,2020.0,11,11,0
IR,JP,2016.0,26,11,15
GB,SI,2020.0,19,14,5
LY,US,2019.0,4,10,-6
PT,DK,2017.0,7,9,-2
CA,CL,2002.0,4,5,-1
PT,GB,1998.0,22,33,-11
VN,GB,2002.0,7,4,3
NO,IN,2004.0,28,18,10
IT,AR,2008.0,68,67,1
IS,NO,2019.0,8,3,5
VN,CA,2011.0,2,7,-5
US,VG,2013.0,14,4,10
CM,BR,2019.0,1,1,0
SE,AT,2006.0,14,10,4
UZ,DE,2016.0,3,3,0
NC,PF,2014.0,2,1,1
DE,NO,1997.0,14,12,2
FR,NL,1999.0,82,108,-26
IT,IN,1999.0,24,19,5
DE,UG,2011.0,3,1,2
BG,FR,2008.0,10,10,0
IE,IN,2022.0,14,43,-29
GH,DE,2013.0,8,5,3
JP,LT,2008.0,10,10,0
CA,NO,2007.0,14,11,3
BY,ES,2017.0,1,1,0
CN,IN,1997.0,5,6,-1
PT,nan,2006.0,11,14,-3
nan,NZ,2014.0,8,8,0
FI,FR,2012.0,19,28,-9
nan,NL,2007.0,61,44,17
CU,NI,2018.0,1,1,0
FI,MK,2017.0,1,1,0
AM,IT,2013.0,28,22,6
AU,DK,2006.0,13,21,-8
BG,RO,2007.0,4,2,2
NO,BG,2017.0,5,6,-1
DE,UY,2012.0,5,3,2
BO,PE,2020.0,6,7,-1
CH,SI,2010.0,7,6,1
DK,NL,2005.0,12,27,-15
GB,LT,2011.0,4,6,-2
US,KE,1999.0,20,11,9
IN,ET,2017.0,53,12,41
LT,CN,2000.0,2,3,-1
IT,HR,2011.0,5,6,-1
ES,DK,2010.0,26,17,9
PK,IT,2009.0,4,4,0
BY,UA,2016.0,10,21,-11
BR,CZ,2001.0,2,2,0
GR,EG,2012.0,4,2,2
CH,TW,2016.0,12,6,6
GB,RS,2008.0,20,9,11
PT,TN,2011.0,1,1,0
AR,PY,2016.0,10,13,-3
RS,SK,2001.0,5,12,-7
ET,NL,2019.0,11,17,-6
BY,US,2016.0,6,8,-2
VE,MX,1997.0,5,7,-2
NG,ZA,2009.0,21,7,14
NO,GR,2003.0,3,4,-1
LU,PL,2015.0,4,3,1
NO,IR,2020.0,12,33,-21
ZA,CY,2011.0,1,2,-1
SI,ID,2016.0,8,2,6
AT,EG,2020.0,9,2,7
BE,ZA,2010.0,9,13,-4
CA,CL,2005.0,3,11,-8
ID,CM,2008.0,1,1,0
GR,AL,2021.0,2,2,0
CA,PL,2000.0,10,8,2
TR,DK,2009.0,6,1,5
CH,NZ,2006.0,7,7,0
TW,BR,2020.0,2,4,-2
EC,AU,2018.0,4,6,-2
HR,CH,2021.0,6,5,1
PE,IT,2005.0,1,4,-3
GB,HU,1999.0,18,26,-8
IN,SK,2010.0,1,1,0
LI,DE,2019.0,3,3,0
SV,MX,2017.0,9,1,8
PH,CO,2013.0,7,4,3
FR,CD,2014.0,4,2,2
PL,FI,2017.0,6,10,-4
PG,AU,2018.0,8,8,0
VE,PE,1997.0,1,1,0
IQ,AU,2014.0,4,2,2
KR,KW,2019.0,1,1,0
US,UZ,2014.0,5,2,3
MA,HU,2014.0,4,9,-5
TG,MA,2017.0,2,2,0
KG,UZ,2013.0,1,1,0
NZ,PE,2022.0,1,2,-1
PE,SG,2022.0,1,1,0
LK,SE,2018.0,1,3,-2
IT,KR,1997.0,2,1,1
VN,GR,2008.0,5,7,-2
nan,NP,2014.0,3,1,2
VE,CA,2009.0,4,5,-1
ZA,DK,2002.0,2,1,1
AT,EE,2000.0,3,1,2
SI,PT,2013.0,3,1,2
SG,BE,2014.0,4,8,-4
CU,PL,2020.0,1,1,0
AE,SG,2018.0,4,3,1
NO,BG,2019.0,4,2,2
SG,RU,2022.0,3,3,0
SE,SK,2003.0,1,5,-4
BN,AU,2011.0,1,2,-1
KR,AT,2017.0,4,5,-1
LU,AU,2020.0,4,3,1
GB,HR,2012.0,8,18,-10
TW,SE,1999.0,2,5,-3
DE,CR,2003.0,4,1,3
GR,NG,2017.0,1,2,-1
ML,BF,2020.0,4,2,2
LT,SE,2011.0,2,3,-1
PL,TR,2023.0,1,4,-3
BE,AR,2000.0,2,1,1
JP,UG,2018.0,1,2,-1
IE,KE,2019.0,3,1,2
DE,VE,1999.0,2,2,0
GB,AU,2019.0,1657,1471,186
PE,MX,2019.0,118,197,-79
BE,LB,2016.0,7,5,2
US,TZ,2006.0,2,3,-1
NO,FR,1997.0,14,14,0
CL,CA,1999.0,6,1,5
KH,KR,2019.0,1,4,-3
PT,CN,2002.0,8,16,-8
RU,KR,2022.0,14,7,7
DK,BD,2017.0,2,4,-2
NG,QA,2016.0,2,1,1
US,,2014.0,51250,0,51250
,IT,2000.0,9695,0,9695
,IL,1998.0,2252,0,2252
,SE,2012.0,3368,0,3368
TN,,2021.0,1718,0,1718
IT,,2009.0,4070,0,4070
,ID,1998.0,493,0,493
,CL,2003.0,1321,0,1321
ES,,2009.0,4044,0,4044
,ES,2014.0,12783,0,12783
,TW,2003.0,4859,0,4859
SE,,2022.0,6832,0,6832
,NL,2001.0,4788,0,4788
IN,,2015.0,7734,0,7734
CO,,2019.0,2821,0,2821
AT,,2022.0,4630,0,4630
,CN,2014.0,39311,0,39311
,DK,2003.0,1388,0,1388
,IL,1997.0,2367,0,2367
SK,AR,2008.0,2,0,2
CO,,2017.0,1486,0,1486
BW,,2012.0,27,0,27
BY,,2016.0,238,0,238
,nan,2000.0,652,0,652
LV,,2020.0,340,0,340
,IE,2000.0,891,0,891
JO,,2025.0,293,0,293
,SG,2013.0,1780,0,1780
,NZ,2012.0,1224,0,1224
BA,,2015.0,81,0,81
,SI,2009.0,624,0,624
JP,BN,2015.0,2,0,2
ZA,,2008.0,441,0,441
nan,,2022.0,1637,0,1637
TR,,2007.0,804,0,804
CZ,,2019.0,2218,0,2218
FI,,2018.0,1952,0,1952
JM,,2020.0,62,0,62
CO,,2010.0,290,0,290
MY,,2018.0,2400,0,2400
PH,,2024.0,2768,0,2768
CZ,,2010.0,700,0,700
,NG,1994.0,834,0,834
GH,,2023.0,1928,0,1928
,SA,2009.0,1204,0,1204
,GR,1999.0,2011,0,2011
KE,,2015.0,169,0,169
NZ,,2008.0,365,0,365
BG,,2014.0,270,0,270
,AM,1999.0,164,0,164
ST,GB,2016.0,1,0,1
BM,,2023.0,7,0,7
TZ,,2011.0,63,0,63
SY,,2021.0,114,0,114
,EE,2009.0,363,0,363
,BA,2008.0,198,0,198
CU,,2020.0,613,0,613
,GH,2004.0,119,0,119
CZ,,2017.0,1617,0,1617
,DZ,2018.0,981,0,981
,MU,2002.0,14,0,14
,RO,2013.0,2104,0,2104
,AR,2018.0,1628,0,1628
,UA,2015.0,4393,0,4393
KZ,,2020.0,334,0,334
VE,,2006.0,130,0,130
TJ,,2018.0,23,0,23
UZ,,2011.0,63,0,63
,GE,2016.0,196,0,196
,PG,2005.0,14,0,14
AE,,2025.0,440,0,440
,JP,2020.0,1280,0,1280
,SD,1994.0,86,0,86
JP,CY,2004.0,1,0,1
DK,TH,2016.0,4,0,4
,GM,1995.0,28,0,28
,PA,2016.0,72,0,72
MZ,,2013.0,17,0,17
,CI,2002.0,104,0,104
,AL,2013.0,143,0,143
ZA,CR,2007.0,1,0,1
,RW,2007.0,23,0,23
,LY,2011.0,71,0,71
PG,,2024.0,112,0,112
EC,,2004.0,15,0,15
,JM,2016.0,35,0,35
TH,,2001.0,96,0,96
MZ,BR,2001.0,2,0,2
,ME,2008.0,36,0,36
DO,,2022.0,123,0,123
SK,,2001.0,134,0,134
TH,CO,2011.0,2,0,2
,AO,2008.0,36,0,36
NE,,2018.0,26,0,26
,BO,2004.0,56,0,56
MM,,2020.0,33,0,33
FJ,BH,2018.0,1,0,1
,GF,2007.0,7,0,7
,HT,2017.0,15,0,15
,HN,2018.0,39,0,39
TW,CR,2015.0,1,0,1
,YE,2014.0,77,0,77
CZ,KR,2000.0,9,0,9
,ID,1997.0,402,0,402
GP,,2021.0,41,0,41
NL,MA,2010.0,1,0,1
,CR,2003.0,134,0,134
MX,SA,2017.0,4,0,4
,GH,1996.0,86,0,86
SG,IS,2000.0,3,0,3
CH,RW,2018.0,3,0,3
TN,EE,2021.0,1,0,1
LK,,2016.0,191,0,191
HU,CO,2011.0,1,0,1
ZW,MG,2011.0,1,0,1
RU,CO,2009.0,1,0,1
,CI,2005.0,92,0,92
GB,BA,2004.0,2,0,2
KG,,2017.0,14,0,14
KG,,2019.0,12,0,12
SI,ET,2013.0,1,0,1
MA,GB,2008.0,6,0,6
SN,ZA,2010.0,1,0,1
CN,PL,2023.0,3,0,3
,BH,1999.0,26,0,26
ZM,,2016.0,35,0,35
GA,,2018.0,37,0,37
HK,FR,2015.0,3,0,3
,CG,2016.0,49,0,49
SA,PT,2001.0,1,0,1
PF,,2022.0,30,0,30
ML,IL,2021.0,1,0,1
ID,,2004.0,35,0,35
,LS,2015.0,6,0,6
TH,ID,2023.0,1,0,1
GR,KZ,2014.0,3,0,3
LV,AT,2019.0,1,0,1
LU,,2006.0,14,0,14
IT,QA,2013.0,2,0,2
,IS,2020.0,14,0,14
MY,ET,2015.0,2,0,2
,PR,2015.0,10,0,10
,SS,2000.0,5,0,5
,MU,2005.0,25,0,25
JP,TZ,2020.0,6,0,6
FI,CM,2015.0,1,0,1
IQ,SE,2007.0,1,0,1
NG,KR,2001.0,2,0,2
AE,TZ,2013.0,3,0,3
VE,CN,2006.0,1,0,1
,PG,2002.0,10,0,10
IT,LT,2002.0,1,0,1
IL,KR,2010.0,3,0,3
MA,MG,1997.0,1,0,1
IN,KE,2007.0,8,0,8
ZA,JM,2001.0,1,0,1
BR,BG,2022.0,2,0,2
GR,NG,2019.0,1,0,1
,ER,1997.0,3,0,3
GB,MZ,2003.0,1,0,1
PG,FR,2022.0,1,0,1
IL,UA,2023.0,1,0,1
MD,,2025.0,17,0,17
CR,CN,2017.0,7,0,7
CH,PG,2010.0,4,0,4
ZA,PA,2013.0,2,0,2
SR,US,2021.0,2,0,2
RU,SA,2016.0,4,0,4
LY,CN,2011.0,1,0,1
,SO,2017.0,4,0,4
PH,LA,2007.0,1,0,1
NO,SD,2019.0,1,0,1
,FJ,2016.0,26,0,26
NZ,GR,2010.0,1,0,1
PT,MA,2003.0,2,0,2
NO,KW,1999.0,1,0,1
PK,QA,2009.0,4,0,4
KR,PK,1998.0,1,0,1
KZ,AE,2017.0,1,0,1
IL,TN,2002.0,1,0,1
PL,GE,2000.0,1,0,1
,GL,2012.0,4,0,4
,GA,1999.0,16,0,16
US,MZ,2005.0,2,0,2
XK,,2015.0,36,0,36
BG,AE,2019.0,1,0,1
SD,UG,2019.0,1,0,1
SN,BJ,2006.0,2,0,2
CU,CA,2016.0,5,0,5
FJ,,2005.0,4,0,4
TN,BJ,2013.0,3,0,3
HK,NO,2018.0,3,0,3
PR,PE,2021.0,1,0,1
MU,IN,2013.0,1,0,1
PE,NZ,2012.0,1,0,1
MZ,ST,2006.0,2,0,2
IQ,DZ,2009.0,1,0,1
RU,NG,2008.0,2,0,2
CM,IN,2009.0,1,0,1
GL,,2018.0,4,0,4
EE,RU,2000.0,3,0,3
DE,AZ,2002.0,1,0,1
CM,NG,2010.0,1,0,1
DK,CU,2016.0,1,0,1
MA,AU,2014.0,2,0,2
,BO,1996.0,16,0,16
,MV,2007.0,4,0,4
ZW,ET,2008.0,1,0,1
EC,BO,2010.0,1,0,1
EC,CH,2011.0,1,0,1
TZ,RW,2019.0,3,0,3
BE,BY,2011.0,1,0,1
IN,CG,2018.0,2,0,2
ZW,AU,2010.0,2,0,2
UY,AU,2013.0,1,0,1
SI,CN,2005.0,3,0,3
IT,KZ,2010.0,1,0,1
EC,VE,2003.0,1,0,1
PT,BJ,2017.0,1,0,1
BO,CZ,2009.0,1,0,1
BD,BN,2014.0,1,0,1
GE,NL,2021.0,2,0,2
SD,UG,2017.0,1,0,1
IT,BJ,2006.0,2,0,2
BG,GD,2008.0,3,0,3
CA,AZ,2013.0,2,0,2
ZA,LY,2019.0,1,0,1
CN,AL,2008.0,1,0,1
TZ,RW,2017.0,1,0,1
NE,MD,2019.0,1,0,1
AZ,IR,2016.0,3,0,3
CR,IE,2021.0,1,0,1
RU,HK,2017.0,1,0,1
CA,CI,2022.0,2,0,2
TN,LU,2021.0,1,0,1
SK,SA,2013.0,1,0,1
RS,CR,2015.0,1,0,1
SD,,2007.0,18,0,18
GB,SJ,2003.0,1,0,1
PL,LU,2013.0,4,0,4
LB,IL,2009.0,1,0,1
BF,NG,2013.0,3,0,3
BW,nan,2019.0,2,0,2
,HU,2020.0,75,0,75
PG,BR,2015.0,2,0,2
KH,BE,2021.0,1,0,1
PH,ZA,2019.0,2,0,2
KH,VU,2017.0,1,0,1
IE,MY,2000.0,1,0,1
BN,IN,2009.0,2,0,2
IT,MK,2005.0,2,0,2
TG,,2003.0,2,0,2
EG,AZ,2009.0,1,0,1
PH,IT,2020.0,5,0,5
ZW,CG,2021.0,2,0,2
HU,NG,2003.0,2,0,2
,HT,2019.0,4,0,4
LV,NL,2000.0,1,0,1
US,GM,2002.0,2,0,2
SN,CG,2015.0,4,0,4
NA,,2007.0,7,0,7
ES,MY,2008.0,3,0,3
EE,CN,2002.0,3,0,3
FR,MM,2001.0,1,0,1
RO,IE,2007.0,2,0,2
CN,JO,2016.0,4,0,4
TR,SI,1998.0,1,0,1
,VG,1999.0,9,0,9
DK,SG,2023.0,2,0,2
HT,US,2008.0,2,0,2
SD,TN,2013.0,1,0,1
EC,IN,2015.0,1,0,1
PH,IE,2005.0,2,0,2
PT,ST,2003.0,1,0,1
NZ,SD,2011.0,1,0,1
VG,,2008.0,6,0,6
KW,IQ,2005.0,1,0,1
BG,AE,2017.0,1,0,1
MU,TR,2013.0,1,0,1
YE,FR,2019.0,1,0,1
OM,NG,2011.0,1,0,1
PE,IT,2002.0,3,0,3
RO,PH,2009.0,1,0,1
IS,KE,2017.0,2,0,2
UY,SM,2017.0,1,0,1
IE,BH,2010.0,2,0,2
SY,YE,2017.0,1,0,1
FK,,2006.0,1,0,1
SI,TW,2003.0,3,0,3
,MO,2006.0,1,0,1
SE,LB,2018.0,2,0,2
MD,IT,2013.0,1,0,1
ML,NE,2018.0,2,0,2
,UZ,2020.0,8,0,8
ES,AM,2002.0,1,0,1
AT,ZM,2005.0,1,0,1
AT,IE,1997.0,2,0,2
,GW,2011.0,8,0,8
AT,CR,2011.0,1,0,1
MK,KZ,2021.0,1,0,1
AU,MM,2014.0,1,0,1
MY,CM,2014.0,1,0,1
BW,UG,2021.0,2,0,2
AO,US,2016.0,1,0,1
GR,HR,2017.0,1,0,1
DK,KE,2003.0,1,0,1
GB,GD,2007.0,1,0,1
HR,GR,2014.0,1,0,1
GT,BO,2004.0,1,0,1
,MC,2009.0,10,0,10
TW,PL,1998.0,2,0,2
GW,,2022.0,4,0,4
RS,FI,2020.0,2,0,2
CM,BR,2010.0,1,0,1
BY,EC,2021.0,1,0,1
NC,UY,2021.0,1,0,1
GH,US,2023.0,2,0,2
SE,LY,2020.0,3,0,3
KG,,2010.0,8,0,8
US,ME,1999.0,1,0,1
KH,PK,2018.0,3,0,3
AE,AR,2019.0,2,0,2
US,GI,2015.0,3,0,3
IT,NA,2016.0,1,0,1
ET,BD,2016.0,1,0,1
HN,BO,2014.0,1,0,1
UY,PT,1998.0,1,0,1
SI,UA,2001.0,1,0,1
SN,MR,2000.0,1,0,1
JM,BW,2015.0,1,0,1
CN,PA,2020.0,1,0,1
MY,KZ,2019.0,3,0,3
KW,IL,2007.0,1,0,1
FI,IN,2023.0,1,0,1
IR,VN,2017.0,2,0,2
LY,PS,2017.0,1,0,1
UA,GH,2015.0,2,0,2
NO,TG,2013.0,1,0,1
SI,IE,2007.0,1,0,1
PG,GB,2008.0,2,0,2
CW,,2013.0,11,0,11
KH,KG,2022.0,1,0,1
NZ,MX,2021.0,2,0,2
BY,IL,2022.0,1,0,1
TR,IQ,2023.0,1,0,1
,ER,1998.0,4,0,4
LI,,2013.0,4,0,4
LB,BH,2004.0,1,0,1
SE,MK,2018.0,1,0,1
KE,VN,2009.0,1,0,1
ES,PY,2004.0,3,0,3
NI,PE,2008.0,1,0,1
GB,PF,2005.0,1,0,1
IT,BA,2012.0,2,0,2
BZ,GR,2016.0,1,0,1
BE,GA,2015.0,3,0,3
IN,PT,1999.0,2,0,2
SG,CL,2012.0,1,0,1
GM,,2007.0,3,0,3
CH,TJ,2022.0,1,0,1
NO,BE,2001.0,2,0,2
SG,BN,2009.0,1,0,1
SA,ES,2004.0,1,0,1
VE,PE,1998.0,1,0,1
GB,MC,2017.0,2,0,2
PH,BE,2011.0,4,0,4
BS,IE,2022.0,1,0,1
KW,CZ,2011.0,3,0,3
FJ,NP,2010.0,1,0,1
TT,IQ,2017.0,1,0,1
BJ,CM,2006.0,1,0,1
IR,PH,2005.0,1,0,1
AM,NO,2022.0,1,0,1
IQ,IE,2011.0,1,0,1
BA,MY,2022.0,1,0,1
,SO,2019.0,5,0,5
NP,ID,2011.0,1,0,1
FR,XK,2017.0,1,0,1
LU,LA,2016.0,1,0,1
NO,QA,2023.0,1,0,1
CH,CY,2009.0,1,0,1
NL,RS,1998.0,1,0,1
IE,LY,2009.0,1,0,1
NE,TW,2007.0,1,0,1
IN,VG,2007.0,1,0,1
NL,BA,2013.0,1,0,1
GE,AE,2020.0,2,0,2
FI,TZ,2016.0,1,0,1
NL,UY,2008.0,1,0,1
AU,KZ,2013.0,1,0,1
MN,PL,2002.0,2,0,2
PT,AE,2009.0,1,0,1
MZ,DE,2012.0,1,0,1
NO,KR,1998.0,2,0,2
JP,BJ,2017.0,3,0,3
MY,BA,2014.0,2,0,2
AM,ES,1998.0,1,0,1
CO,BG,2015.0,1,0,1
PT,SK,2014.0,2,0,2
DO,US,1999.0,1,0,1
MX,CZ,1998.0,1,0,1
TL,US,2020.0,1,0,1
CA,MT,2014.0,3,0,3
GN,DE,2022.0,1,0,1
NP,DE,2000.0,1,0,1
PL,BY,1999.0,5,0,5
TW,MX,2004.0,1,0,1
PH,SE,2021.0,3,0,3
TG,TR,2004.0,1,0,1
CY,UG,2005.0,1,0,1
PE,FI,2007.0,3,0,3
CA,SD,2005.0,1,0,1
GR,LY,2013.0,2,0,2
BF,GA,2018.0,1,0,1
ES,MZ,2021.0,1,0,1
MX,NO,2022.0,3,0,3
ZA,PG,2009.0,2,0,2
HU,PT,1999.0,1,0,1
PL,AM,2019.0,2,0,2
TW,NO,2008.0,1,0,1
IN,HK,2005.0,1,0,1
VN,BD,2020.0,3,0,3
AF,ES,2004.0,1,0,1
PA,PE,2013.0,2,0,2
BD,,1998.0,14,0,14
TR,CL,2016.0,3,0,3
KR,SI,2013.0,1,0,1
FR,RS,1997.0,1,0,1
IE,KE,2017.0,1,0,1
MG,RE,2015.0,1,0,1
ZA,ER,2008.0,1,0,1
KZ,BG,2006.0,2,0,2
IE,KN,2016.0,2,0,2
JP,GH,2004.0,2,0,2
CM,BR,2017.0,2,0,2
FI,IQ,2019.0,1,0,1
SN,CM,2011.0,2,0,2
FJ,BN,2002.0,1,0,1
BG,LV,2018.0,1,0,1
AG,GD,2021.0,2,0,2
LY,PL,2019.0,1,0,1
JP,DK,2023.0,2,0,2
BO,PH,2008.0,1,0,1
nan,XK,2015.0,1,0,1
CA,SN,2011.0,5,0,5
CO,PY,2004.0,1,0,1
ID,PA,2007.0,3,0,3
ML,PH,2013.0,1,0,1
DE,MN,1998.0,1,0,1
NZ,PG,2000.0,2,0,2
PR,MY,2019.0,1,0,1
CN,FJ,2019.0,2,0,2
AZ,NL,2014.0,1,0,1
LY,,2004.0,8,0,8
PL,KZ,2014.0,1,0,1
IL,PE,2005.0,1,0,1
JP,MA,2002.0,1,0,1
BS,,2021.0,4,0,4
CO,OM,2013.0,1,0,1
FI,KZ,2004.0,1,0,1
JO,PK,2011.0,2,0,2
KE,BJ,1998.0,1,0,1
HK,DE,2005.0,1,0,1
SK,CU,2014.0,1,0,1
ID,KW,2009.0,1,0,1
VG,TR,2016.0,1,0,1
DE,ET,1999.0,1,0,1
RW,DE,2016.0,1,0,1
RS,NG,2007.0,1,0,1
MA,MR,2020.0,2,0,2
ES,IR,1997.0,1,0,1
MK,NZ,2021.0,1,0,1
MM,TH,2009.0,1,0,1
JP,KW,2022.0,1,0,1
SA,GE,2010.0,1,0,1
,HT,2010.0,5,0,5
PK,CZ,1998.0,1,0,1
GM,SN,2007.0,1,0,1
KH,KR,2010.0,1,0,1
SL,PE,2021.0,1,0,1
DE,SV,2020.0,1,0,1
SA,CO,2021.0,2,0,2
TT,PH,2019.0,1,0,1
EG,NG,2010.0,2,0,2
VE,GB,2020.0,2,0,2
TZ,nan,2010.0,1,0,1
BR,NI,2014.0,1,0,1
UA,IQ,2020.0,2,0,2
NE,IT,2016.0,1,0,1
DE,LB,2000.0,1,0,1
AU,HT,2019.0,1,0,1
SD,CA,2012.0,1,0,1
nan,MC,2016.0,1,0,1
CN,CY,2002.0,1,0,1
PK,LK,2013.0,1,0,1
GR,EE,2020.0,2,0,2
KR,KW,2017.0,1,0,1
JP,AO,2009.0,1,0,1
ER,,2001.0,1,0,1
NG,AZ,2021.0,1,0,1
ZA,LU,2015.0,1,0,1
IN,QA,1999.0,2,0,2
ET,AU,2008.0,1,0,1
TN,CN,2005.0,1,0,1
,VU,2001.0,1,0,1
ET,MT,2022.0,1,0,1
BT,AU,2022.0,4,0,4
MA,CZ,2018.0,1,0,1
BJ,JP,2002.0,1,0,1
AU,HT,2017.0,1,0,1
nan,GR,2003.0,1,0,1
PT,EC,2008.0,1,0,1
GT,JP,2016.0,1,0,1
MY,KZ,2010.0,1,0,1
EC,nan,2010.0,2,0,2
ET,BH,2003.0,1,0,1
IE,CZ,2002.0,1,0,1
NO,CI,2004.0,1,0,1
BY,VN,2017.0,2,0,2
MK,NL,2020.0,2,0,2
SE,AL,2011.0,1,0,1
RO,DK,2000.0,1,0,1
MX,BG,2019.0,1,0,1
RS,GR,2001.0,2,0,2
BD,CU,2008.0,1,0,1
BR,CY,2017.0,1,0,1
HK,ZA,2009.0,1,0,1
KE,NO,2012.0,1,0,1
BJ,LK,2003.0,1,0,1
SE,BW,2002.0,1,0,1
TO,,2009.0,1,0,1
UZ,KR,2008.0,2,0,2
VE,UY,2007.0,1,0,1
BE,IS,2014.0,2,0,2
ST,JP,2011.0,1,0,1
EG,RU,2003.0,1,0,1
FJ,WS,2020.0,1,0,1
HK,MY,2012.0,1,0,1
VE,HR,2007.0,2,0,2
PK,SK,2021.0,1,0,1
HR,IN,2011.0,1,0,1
TW,QA,2007.0,1,0,1
BD,PE,2012.0,1,0,1
ZM,TZ,2003.0,1,0,1
OM,ZA,2005.0,1,0,1
GP,ES,2021.0,1,0,1
SK,ID,2020.0,1,0,1
IE,LK,2018.0,1,0,1
UY,CH,2013.0,1,0,1
ID,TZ,2005.0,1,0,1
OM,NL,1999.0,1,0,1
GB,ID,1997.0,1,0,1
TZ,nan,2019.0,1,0,1
LY,PK,2001.0,1,0,1
DK,BG,2006.0,3,0,3
CZ,HK,2016.0,1,0,1
GE,SE,2017.0,1,0,1
NA,AE,2019.0,1,0,1
CR,BZ,2004.0,1,0,1
TZ,DK,2015.0,1,0,1
SK,CH,2000.0,3,3,0
ZA,LK,2017.0,2,1,1
AE,BD,2022.0,2,1,1
LT,LV,2018.0,3,2,1
AE,TR,2015.0,2,5,-3
MX,SV,2007.0,1,2,-1
BY,CN,2013.0,2,3,-1
AT,AE,2019.0,1,2,-1
PA,MA,2009.0,1,1,0
CH,NP,2013.0,3,1,2
RU,AZ,2003.0,1,3,-2
BG,RS,2003.0,2,3,-1
FJ,US,2016.0,1,2,-1
MX,KR,2005.0,1,3,-2
PS,ES,2009.0,3,3,0
PS,TR,2014.0,3,2,1
BW,MW,2006.0,1,1,0
QA,TN,2012.0,1,3,-2
PE,JP,2016.0,1,2,-1
IL,CZ,1999.0,2,3,-1
EC,BO,2017.0,4,6,-2
CR,DE,2021.0,4,5,-1
FI,CL,2022.0,4,1,3
IS,PT,2014.0,1,1,0
CY,UG,2002.0,1,1,0
LK,ET,2017.0,1,1,0
CR,ZA,2008.0,1,3,-2
IN,SK,2019.0,3,5,-2
AE,RU,2017.0,2,2,0
CM,JP,2003.0,1,1,0
PT,GW,2013.0,1,1,0
TW,ZA,2016.0,3,3,0
JP,SY,2020.0,1,1,0
US,FJ,2000.0,1,1,0
LT,CA,2014.0,1,2,-1
LU,BE,2003.0,1,10,-9
ML,US,1999.0,1,3,-2
MX,PA,2004.0,1,3,-2
CL,IE,2012.0,1,1,0
CA,BO,2015.0,1,2,-1
PK,PS,2013.0,1,3,-2
NO,KR,1997.0,1,1,0
DK,SK,2013.0,3,1,2
BD,DK,2019.0,1,3,-2
BR,AO,2002.0,3,4,-1
MX,BE,2022.0,4,6,-2
IL,KR,2017.0,3,6,-3
SA,MY,2001.0,1,4,-3
BE,TW,2002.0,4,1,3
MY,HK,2021.0,1,1,0
ZA,CL,2001.0,1,1,0
GL,DK,1998.0,1,1,0
GB,MT,2000.0,1,3,-2
CO,BE,2006.0,1,4,-3
CU,nan,2001.0,1,4,-3
CN,MD,2011.0,1,1,0
CL,UA,2003.0,2,1,1
TR,ZW,2014.0,1,1,0
GR,TN,2014.0,1,1,0
RU,MN,2022.0,2,1,1
PY,BR,2000.0,1,1,0
SD,PK,2014.0,2,2,0
IE,nan,2001.0,1,2,-1
SE,GH,2013.0,2,2,0
GB,PG,2012.0,1,1,0
NL,SD,2008.0,1,1,0
PH,NO,2016.0,1,1,0
CN,BN,2020.0,2,7,-5
UY,SE,2009.0,1,3,-2
KH,MY,2016.0,1,2,-1
SY,IQ,2022.0,5,3,2
MZ,US,2006.0,1,2,-1
JP,SD,2007.0,2,1,1
DZ,BR,2020.0,1,2,-1
US,GA,2004.0,1,1,0
DE,AZ,2005.0,2,1,1
ZW,RU,2007.0,1,1,0
FR,DJ,2016.0,2,1,1
US,PR,2003.0,2,1,1
ME,BA,2015.0,1,1,0
NA,AU,2018.0,3,2,1
DK,RS,2022.0,1,2,-1
AU,ZM,2015.0,1,1,0
AZ,DE,2018.0,2,1,1
AT,IL,2001.0,2,2,0
PL,AR,2021.0,2,3,-1
AE,SE,2010.0,3,3,0
PH,ZA,2010.0,1,2,-1
BF,BR,2014.0,1,1,0
IQ,DK,2016.0,1,2,-1
NZ,CZ,2020.0,1,3,-2
SN,BR,2020.0,1,1,0
SK,TW,2004.0,1,1,0
CN,EC,2021.0,2,3,-1
IN,BJ,2019.0,1,1,0
TR,TH,2000.0,1,1,0
PK,KW,2019.0,3,2,1
NL,LT,2020.0,1,1,0
NO,SI,2013.0,1,2,-1
CH,RS,2000.0,1,1,0
SE,BY,2014.0,1,2,-1
UA,CH,2010.0,1,4,-3
TW,TZ,2017.0,1,1,0
KR,KE,2011.0,1,1,0
AT,BA,2013.0,2,1,1
SI,nan,2006.0,1,1,0
AU,KE,2002.0,1,2,-1
NO,SD,2017.0,1,1,0
SI,BR,2010.0,1,1,0
CL,HN,2001.0,1,1,0
NP,NL,2013.0,2,4,-2
AM,DE,2004.0,1,2,-1
nan,VE,2000.0,1,1,0
ZA,TZ,2008.0,3,1,2
CN,CO,2002.0,1,2,-1
MY,TW,1999.0,1,2,-1
TW,PL,1997.0,1,2,-1
PS,DE,2010.0,1,5,-4
RU,TZ,2011.0,1,1,0
CM,NG,2017.0,2,4,-2
PA,CU,2006.0,1,2,-1
SA,AT,2012.0,2,3,-1
SD,KE,2006.0,2,1,1
SI,BR,2017.0,1,1,0
SK,SE,2016.0,2,3,-1
MX,CZ,1997.0,1,1,0
ZM,ZA,2006.0,1,1,0
TH,CL,2018.0,1,1,0
ZW,AU,2017.0,1,1,0
AT,CU,2016.0,1,1,0
SV,CO,2012.0,1,1,0
ID,AE,2018.0,1,6,-5
CH,KH,2020.0,1,3,-2
FR,RS,1998.0,1,1,0
EG,CH,2007.0,2,2,0
HN,PE,2007.0,1,1,0
BD,IQ,2014.0,1,1,0
GH,NE,2015.0,1,1,0
LV,CZ,2013.0,1,1,0
GR,NG,2010.0,1,1,0
LB,TR,2016.0,1,4,-3
GB,MC,2010.0,1,1,0
BD,FI,2010.0,1,2,-1
CU,JP,2008.0,1,4,-3
SV,US,2014.0,1,4,-3
HN,AR,2011.0,1,3,-2
KE,ET,2007.0,2,1,1
FI,CZ,1997.0,1,1,0
NP,CH,2013.0,1,3,-2
CG,TG,2016.0,1,1,0
ID,RU,2010.0,1,4,-3
BR,MD,2017.0,1,2,-1
IT,AO,2010.0,1,2,-1
SA,NL,2023.0,2,1,1
FR,ZW,2010.0,1,2,-1
PK,RS,2010.0,1,2,-1
PA,CA,2013.0,1,3,-2
MX,ZA,2014.0,1,2,-1
NL,UG,2008.0,1,1,0
JP,LU,2018.0,1,1,0
MN,KR,2014.0,1,5,-4
BY,NZ,2018.0,1,1,0
PK,KW,2017.0,1,7,-6
ZW,BR,2019.0,1,1,0
NG,ES,2020.0,1,1,0
LI,DE,2017.0,1,7,-6
IT,BY,2013.0,1,3,-2
NG,IN,2002.0,1,2,-1
SA,RU,2011.0,1,1,0
CL,BR,1997.0,5,6,-1
BE,PE,2007.0,1,1,0
MG,FR,2006.0,5,4,1
UY,NL,2015.0,1,1,0
IQ,BH,2019.0,3,4,-1
NO,NG,2015.0,1,4,-3
nan,RO,2018.0,3,2,1
DK,EG,2016.0,1,3,-2
ZW,MX,2013.0,1,2,-1
QA,KR,2019.0,1,6,-5
KR,BD,2004.0,1,1,0
AU,HK,2015.0,1,3,-2
CA,UG,2020.0,2,2,0
PH,CL,2017.0,2,7,-5
LU,NL,2010.0,2,2,0
MW,BE,2014.0,2,1,1
CA,CY,2017.0,1,6,-5
nan,DO,2015.0,1,1,0
CL,IR,2021.0,1,2,-1
ES,PK,2006.0,1,1,0
TW,BO,2003.0,1,1,0
CH,CI,2014.0,1,1,0
nan,CU,2014.0,1,3,-2
QA,IR,2021.0,1,8,-7
KZ,IQ,2020.0,1,1,0
BY,VN,2010.0,1,1,0
ZA,ML,2009.0,1,0,1
GR,HK,2012.0,1,0,1
MK,CZ,2016.0,1,0,1
KW,DE,2007.0,2,0,2
CN,FJ,2017.0,1,0,1
NL,BY,2013.0,1,0,1
ID,IR,2009.0,1,0,1
UZ,UG,2008.0,1,0,1
XK,GB,2015.0,1,0,1
NC,LA,2021.0,1,0,1
AR,VN,2014.0,1,0,1
VE,IN,2000.0,1,0,1
AM,CO,2015.0,1,0,1
GA,MA,2008.0,1,0,1
SG,ET,2007.0,1,0,1
AU,RO,2004.0,1,0,1
FR,CU,2005.0,1,0,1
DZ,GR,2008.0,1,0,1
RU,ZW,2001.0,1,0,1
PY,MX,2005.0,1,0,1
CZ,LU,2020.0,3,0,3
TZ,ES,2018.0,1,0,1
PE,IN,2012.0,1,0,1
FR,AX,2011.0,1,0,1
LV,AT,2017.0,2,0,2
BY,EG,2019.0,1,0,1
SY,AU,2020.0,1,0,1
UG,CO,2003.0,1,0,1
UY,ST,2016.0,2,0,2
OM,nan,2020.0,1,0,1
CL,SK,2016.0,1,0,1
BD,MK,2016.0,1,0,1
BR,GE,1999.0,1,0,1
XK,TR,2009.0,1,0,1
CM,SN,2005.0,3,0,3
,WS,2007.0,1,0,1
IL,ZW,2020.0,1,0,1
CN,ML,2015.0,1,0,1
LY,ID,2016.0,1,0,1
BE,TW,2005.0,3,0,3
CZ,NI,2020.0,1,0,1
RS,AT,2001.0,1,0,1
SK,BR,2002.0,1,0,1
CL,TT,2012.0,1,0,1
CY,DZ,2020.0,1,0,1
SI,RO,2015.0,1,0,1
DE,PG,2010.0,1,0,1
LB,OM,2015.0,2,0,2
EC,DK,2021.0,1,0,1
BN,CA,2005.0,1,0,1
AU,LA,2004.0,1,0,1
BA,NG,2009.0,1,0,1
SD,AU,2009.0,1,0,1
VN,RS,2021.0,2,0,2
MW,NA,2011.0,1,0,1
KR,IE,2006.0,1,0,1
DK,KR,1998.0,1,0,1
AE,DZ,2014.0,1,0,1
RS,RO,1998.0,1,0,1
TR,LB,2007.0,1,0,1
HN,IL,2016.0,1,0,1
ZA,PT,2003.0,1,0,1
IE,BH,2017.0,1,0,1
LB,SI,2017.0,1,0,1
CI,GB,2010.0,1,0,1
SK,FI,1998.0,1,0,1
CD,TZ,2004.0,1,0,1
CD,RO,2017.0,1,0,1
LK,FR,2021.0,4,0,4
IS,LU,2013.0,2,0,2
EE,NL,2000.0,2,0,2
JM,NZ,2004.0,1,0,1
JP,BJ,2010.0,1,0,1
SA,LY,2006.0,1,0,1
AU,SD,2012.0,1,0,1
CO,TW,2009.0,1,0,1
IL,IQ,2005.0,1,0,1
NG,TW,2022.0,1,0,1
PK,SG,2001.0,1,0,1
,KY,2020.0,1,0,1
NE,SN,2022.0,1,0,1
UA,LV,2005.0,1,0,1
BE,MT,2007.0,1,0,1
GR,NP,2021.0,1,0,1
NE,CO,2019.0,1,0,1
AU,LI,2012.0,1,0,1
IE,PH,2008.0,1,0,1
CA,MQ,2010.0,1,0,1
IT,KR,1998.0,1,0,1
BJ,CO,2021.0,1,0,1
TN,UA,2020.0,1,0,1
TR,BH,2010.0,1,0,1
BW,PT,2010.0,1,0,1
VG,JP,2009.0,1,0,1
RO,CU,2017.0,1,0,1
CH,IE,2023.0,1,0,1
AT,TH,2022.0,1,0,1
IN,HK,2002.0,1,0,1
IL,GM,2020.0,1,0,1
IQ,AE,2000.0,1,0,1
CH,MG,2007.0,1,0,1
MN,GB,2008.0,1,0,1
RO,CO,1999.0,1,0,1
NO,PE,2009.0,1,0,1
CZ,SG,2001.0,1,0,1
ZW,BH,2004.0,1,0,1
PG,CA,2003.0,1,0,1
GB,XK,2010.0,1,0,1
IR,JO,2006.0,2,0,2
MX,PS,2005.0,1,0,1
DE,FJ,2000.0,1,0,1
JO,FI,2013.0,1,0,1
RE,PF,2018.0,2,0,2
RU,GP,2009.0,1,0,1
CU,QA,2016.0,1,0,1
AM,CH,2011.0,1,0,1
NO,GL,1998.0,1,0,1
MA,BJ,2011.0,2,0,2
CL,AU,1999.0,1,0,1
PL,KR,1998.0,1,0,1
IR,OM,2011.0,1,0,1
LU,MG,2014.0,1,0,1
RU,SI,2008.0,2,0,2
RO,SE,1998.0,1,0,1
BJ,JP,2005.0,1,0,1
RU,TH,2000.0,1,0,1
LV,AT,2010.0,1,0,1
UA,ET,2010.0,1,0,1
RW,TZ,2011.0,1,0,1
ID,BR,1999.0,1,0,1
UA,SG,1999.0,1,0,1
BE,UZ,2014.0,1,0,1
NG,SG,2009.0,1,0,1
HT,FR,2023.0,1,0,1
PA,LK,2016.0,1,0,1
CL,AT,2001.0,1,0,1
US,MZ,2002.0,1,0,1
KR,GD,2016.0,1,0,1
LS,ZW,2004.0,1,0,1
TR,TD,2021.0,1,0,1
BZ,,2001.0,2,0,2
MT,AU,2000.0,1,0,1
LK,UZ,2015.0,1,0,1
HK,nan,2005.0,1,0,1
AL,EE,2012.0,1,0,1
BR,CY,2019.0,1,0,1
IL,PK,2010.0,1,0,1
QA,KW,2003.0,1,0,1
PH,FJ,2018.0,1,0,1
BM,nan,2000.0,1,0,1
GT,IL,2017.0,1,0,1
GD,CA,2022.0,1,0,1
AG,BR,2005.0,1,0,1
AF,IT,2005.0,1,0,1
PE,MA,1999.0,1,0,1
CH,SD,2013.0,1,0,1
GF,CA,2012.0,1,0,1
DK,CZ,2023.0,1,0,1
IQ,NO,2015.0,1,0,1
AU,BI,2011.0,1,0,1
SX,,2009.0,1,0,1
US,HT,2001.0,1,0,1
PT,TT,2008.0,1,0,1
KW,YE,2013.0,1,0,1
NP,SD,2012.0,1,0,1
QA,DK,2001.0,1,0,1
SD,MA,2012.0,1,0,1
SD,IT,2009.0,1,0,1
BG,VN,2017.0,1,0,1
HU,LV,2013.0,1,0,1
SG,CO,2009.0,1,0,1
IT,SZ,2020.0,1,0,1
CF,US,2009.0,1,0,1
CZ,EE,2009.0,1,0,1
SK,BA,2012.0,1,0,1
UY,CA,2021.0,1,0,1
NZ,BD,2023.0,1,0,1
UY,NI,2016.0,1,0,1
NE,MZ,2019.0,1,0,1
UY,GT,2013.0,1,0,1
YE,,1999.0,1,0,1
TZ,BR,2003.0,1,0,1
PK,EG,1999.0,1,0,1
AU,HR,2001.0,1,0,1
ET,KE,1999.0,1,0,1
UA,LV,2002.0,1,0,1
NI,PY,2021.0,1,0,1
BR,CV,2003.0,1,0,1
PH,GR,2018.0,1,0,1
FJ,PK,2019.0,1,0,1
SY,MY,2009.0,1,0,1
CO,SE,2001.0,1,0,1
TZ,EG,2003.0,1,0,1
ZA,CG,2019.0,1,0,1
MA,GF,2020.0,1,0,1
DK,BY,1997.0,1,0,1
MY,SK,2006.0,1,0,1
SS,ES,2019.0,1,0,1
MD,NO,2015.0,1,0,1
NZ,UY,2014.0,1,0,1
FR,BN,2006.0,1,0,1
PL,NG,2010.0,1,0,1
CH,AM,2014.0,1,0,1
BR,JM,2018.0,1,0,1
NP,MX,2012.0,1,0,1
SI,MX,2011.0,5,5,0
DE,DK,2001.0,49,50,-1
CO,CA,2012.0,20,17,3
DE,AT,2009.0,429,436,-7
GB,AU,2018.0,1655,1552,103
US,CA,2004.0,2271,2222,49
JP,SE,2006.0,29,44,-15
CA,US,2015.0,3662,3181,481
GB,ES,2021.0,384,319,65
CA,RO,2019.0,13,11,2
JP,US,2002.0,1956,1707,249
JP,US,2005.0,1958,1833,125
SE,US,2020.0,475,493,-18
DK,EG,2022.0,4,3,1
ES,MX,2020.0,881,1033,-152
CN,KR,2003.0,136,166,-30
SE,DK,2016.0,134,139,-5
GB,CA,2011.0,884,754,130
SA,IN,2018.0,90,193,-103
ES,CL,2020.0,400,450,-50
FR,RU,2007.0,42,67,-25
ES,BE,2017.0,106,64,42
SK,ES,2015.0,4,4,0
NL,VN,2020.0,13,6,7
FR,US,2018.0,1643,1503,140
US,ZW,2019.0,12,12,0
TW,IN,2007.0,20,36,-16
NO,JP,2017.0,13,14,-1
NL,GB,2001.0,170,142,28
US,TW,2004.0,641,533,108
TW,FR,2007.0,16,18,-2
CR,MX,2008.0,19,16,3
JP,CN,2013.0,640,423,217
KR,IN,2015.0,143,234,-91
US,DK,2004.0,178,189,-11
US,CL,1997.0,39,25,14
CA,AU,2020.0,430,406,24
FR,AU,2015.0,133,120,13
DE,FR,2018.0,518,586,-68
ES,BE,2010.0,50,48,2
FR,DE,2021.0,407,367,40
AU,BD,2020.0,76,69,7
nan,PT,2017.0,29,26,3
US,AU,1997.0,763,692,71
JP,nan,2020.0,47,32,15
HR,DE,2014.0,22,31,-9
US,AU,1998.0,951,904,47
GB,IL,2002.0,26,33,-7
IL,DE,2004.0,36,25,11
GB,GR,2007.0,157,114,43
DE,BE,2010.0,120,110,10
US,CL,1998.0,51,45,6
VN,AU,2022.0,44,45,-1
SE,CL,2021.0,8,8,0
IT,AR,2013.0,88,95,-7
KR,TW,2021.0,24,38,-14
CL,MX,2020.0,199,206,-7
CN,HK,2009.0,104,46,58
AT,DE,2015.0,580,592,-12
GR,BE,2011.0,25,17,8
IT,BR,2016.0,298,270,28
JP,CA,2014.0,100,86,14
AE,SA,2015.0,12,31,-19
ES,CO,2012.0,437,390,47
GB,DK,2013.0,115,105,10
US,AT,2009.0,190,224,-34
RU,UA,2014.0,229,296,-67
CH,CA,2005.0,73,50,23
AR,US,2010.0,181,233,-52
PE,US,2016.0,99,102,-3
GB,AR,2015.0,27,31,-4
CA,FR,2007.0,410,423,-13
DE,BE,2019.0,165,162,3
MX,ES,2007.0,423,453,-30
IT,FR,1999.0,172,163,9
FR,GB,2014.0,625,567,58
ES,EC,2018.0,243,145,98
CU,ES,2003.0,44,45,-1
BR,nan,2014.0,82,100,-18
DE,KR,2016.0,46,64,-18
FR,MA,2007.0,239,215,24
ES,BR,2011.0,307,274,33
UA,CH,2018.0,10,3,7
GB,BG,2018.0,19,21,-2
US,GE,2021.0,99,157,-58
CR,ES,2015.0,47,58,-11
IS,ES,2018.0,2,5,-3
AR,MX,2020.0,157,158,-1
CA,EG,2005.0,16,16,0
NL,ID,2018.0,63,35,28
RS,IT,2017.0,7,10,-3
IN,NZ,2015.0,34,42,-8
GB,TH,2013.0,81,33,48
CN,UZ,2008.0,16,13,3
CH,BR,1998.0,17,6,11
DK,BD,2018.0,4,3,1
CO,BR,2006.0,32,39,-7
NO,IN,2014.0,15,28,-13
GB,CH,2022.0,231,170,61
JP,MM,2015.0,10,4,6
CH,JP,2018.0,102,112,-10
US,HU,2001.0,94,89,5
CH,TR,2015.0,20,16,4
FR,LB,2018.0,129,80,49
US,PK,2009.0,132,116,16
GB,MX,2017.0,81,52,29
CN,GB,2003.0,235,321,-86
NG,US,2022.0,121,50,71
SG,nan,2006.0,10,8,2
BR,MX,2020.0,145,166,-21
RO,GB,2001.0,9,7,2
BH,EG,2018.0,5,12,-7
US,nan,2020.0,281,268,13
IR,NL,2020.0,62,28,34
CA,BR,2008.0,243,185,58
JP,SK,2004.0,14,20,-6
AT,JP,2016.0,28,14,14
CH,BE,2011.0,75,77,-2
NZ,CN,2007.0,18,19,-1
TW,JP,2015.0,91,80,11
SE,FI,2015.0,105,103,2
HR,RS,2018.0,143,156,-13
BE,NL,2014.0,282,303,-21
TR,CN,2017.0,51,12,39
AU,PT,2016.0,7,22,-15
PK,GB,2012.0,79,139,-60
CA,LU,2009.0,3,3,0
PT,DE,2017.0,52,41,11
CN,PK,2012.0,51,71,-20
NL,AT,2009.0,19,24,-5
GB,IT,2004.0,233,297,-64
PL,DE,2009.0,112,85,27
DE,ES,2013.0,212,243,-31
ES,BE,2019.0,108,94,14
DE,NL,2004.0,203,208,-5
RU,IT,2011.0,27,22,5
US,RS,2018.0,55,66,-11
nan,IL,2017.0,27,28,-1
HU,SK,2012.0,12,4,8
ES,AR,2020.0,376,417,-41
MY,ID,2012.0,75,40,35
NL,DK,2018.0,71,63,8
DK,IN,2010.0,12,16,-4
CA,DK,2007.0,23,25,-2
GR,IN,2007.0,3,4,-1
TN,SA,2016.0,76,24,52
AR,US,2017.0,257,281,-24
IR,ES,2019.0,28,20,8
AT,TH,2016.0,10,2,8
UZ,US,2004.0,3,2,1
SE,IN,2021.0,46,53,-7
ZA,BE,2011.0,16,18,-2
IN,ET,2018.0,59,25,34
BD,GB,2020.0,39,47,-8
UZ,JP,2019.0,1,2,-1
CN,IL,2014.0,19,18,1
CN,ZA,2006.0,11,2,9
CN,nan,2013.0,136,140,-4
CN,VN,2007.0,18,29,-11
US,IR,2018.0,523,856,-333
SN,ZA,2018.0,2,2,0
ES,CN,2001.0,21,12,9
PK,CN,2014.0,83,67,16
DK,BR,1999.0,3,2,1
NG,MY,2017.0,65,105,-40
AR,IT,2011.0,86,86,0
CZ,US,2022.0,74,92,-18
CM,nan,2019.0,16,11,5
BR,ST,2009.0,22,34,-12
PH,MX,2021.0,6,8,-2
GB,MX,2019.0,81,74,7
VE,CU,2021.0,14,13,1
CN,NG,2016.0,13,18,-5
CO,SE,2003.0,3,1,2
CO,IE,2018.0,5,1,4
CN,BE,2007.0,32,50,-18
PE,GB,2018.0,12,16,-4
FI,CA,2007.0,14,15,-1
BY,RU,2020.0,102,84,18
IT,UA,2013.0,32,11,21
FI,GB,2020.0,68,93,-25
DE,NZ,2022.0,20,29,-9
RU,IE,2009.0,7,1,6
MX,CU,1997.0,5,5,0
US,SN,1999.0,6,2,4
CH,US,2000.0,471,400,71
IT,MY,2005.0,30,48,-18
CL,AR,2007.0,44,37,7
TH,GB,2010.0,27,49,-22
IR,JP,2022.0,5,2,3
US,PT,2000.0,54,35,19
ID,SG,2011.0,5,10,-5
US,FI,2014.0,137,127,10
SA,AU,2015.0,27,43,-16
ES,GR,2010.0,12,19,-7
JP,NZ,2000.0,18,15,3
AT,CH,2001.0,44,58,-14
US,CU,2008.0,27,20,7
CO,JP,2018.0,8,9,-1
CA,TR,2019.0,21,46,-25
ZA,CH,2004.0,7,2,5
IE,JP,2003.0,30,12,18
AT,IT,2009.0,26,50,-24
US,MK,2017.0,6,13,-7
RU,TN,2010.0,5,4,1
SK,CA,2011.0,4,6,-2
FR,JP,2002.0,61,54,7
GB,IL,2005.0,34,44,-10
CN,LT,2009.0,12,3,9
RU,CH,2002.0,21,8,13
KZ,AE,2018.0,2,3,-1
JP,PL,2005.0,17,16,1
PK,PR,2021.0,1,1,0
SG,IN,2012.0,73,94,-21
BE,UA,2021.0,3,3,0
NO,FI,2011.0,11,18,-7
ES,PY,2014.0,13,1,12
KR,PH,2019.0,14,8,6
BG,NO,2006.0,6,3,3
MX,GT,2017.0,25,30,-5
JO,SD,2019.0,1,3,-2
NZ,CA,2006.0,45,52,-7
nan,BE,1998.0,14,7,7
PL,CZ,2015.0,50,58,-8
IR,GB,2014.0,83,107,-24
TR,CH,2018.0,27,14,13
US,EG,1997.0,39,45,-6
MY,NL,2018.0,6,12,-6
PT,DE,2010.0,35,21,14
HU,FI,2016.0,14,9,5
ES,ID,2019.0,25,17,8
AU,PK,2020.0,49,55,-6
SA,ES,2014.0,7,5,2
SG,VN,2016.0,16,7,9
PE,MX,2018.0,115,132,-17
NL,JP,2021.0,25,22,3
IN,SE,2022.0,47,27,20
US,DZ,2013.0,19,21,-2
US,LK,2012.0,25,19,6
DK,US,1998.0,121,151,-30
PE,AR,2003.0,7,6,1
IN,NO,2022.0,32,18,14
MX,GT,2019.0,43,26,17
ZA,SE,2002.0,7,3,4
SK,DE,2016.0,39,31,8
ES,UY,2011.0,36,38,-2
BE,LU,2002.0,5,6,-1
LK,BD,2019.0,1,2,-1
nan,GB,2014.0,78,82,-4
RU,GB,2021.0,109,90,19
ET,US,2007.0,14,18,-4
FR,MQ,2015.0,15,10,5
DK,CH,2007.0,20,24,-4
SE,CN,2021.0,122,88,34
TH,JP,2006.0,26,63,-37
PH,TW,2011.0,6,5,1
PT,CA,2003.0,12,9,3
CA,PT,2008.0,15,9,6
IN,PK,2007.0,48,49,-1
SA,EG,2003.0,23,26,-3
FR,EC,2017.0,17,4,13
SE,IT,2022.0,43,59,-16
CA,TN,2016.0,20,11,9
MX,GB,2016.0,50,58,-8
IR,ES,2017.0,18,14,4
BD,AU,2016.0,70,56,14
CN,BR,2016.0,89,40,49
BE,NZ,2018.0,12,9,3
PT,NL,2011.0,17,21,-4
PT,DE,2019.0,51,59,-8
nan,MX,2005.0,8,10,-2
RU,SE,2019.0,41,45,-4
JO,US,2014.0,44,74,-30
PL,PK,2019.0,7,15,-8
CN,EE,2022.0,1,3,-2
FR,JP,2005.0,117,97,20
TH,GB,2017.0,40,71,-31
NG,MY,2019.0,77,167,-90
CN,AT,2002.0,3,8,-5
IN,KW,2004.0,8,9,-1
FI,PK,2014.0,6,7,-1
HU,GH,2018.0,1,1,0
VN,CN,2001.0,30,19,11
IN,BE,2020.0,45,54,-9
IT,BE,1998.0,31,32,-1
NG,SE,2021.0,4,1,3
AU,NO,2008.0,10,9,1
RW,US,2021.0,14,17,-3
TR,FI,2020.0,13,6,7
IN,SG,2013.0,86,102,-16
RU,MK,2021.0,2,2,0
DE,PK,2016.0,42,18,24
QA,KR,2018.0,7,6,1
GB,FI,2005.0,41,51,-10
FR,CZ,1998.0,15,11,4
SI,CH,2016.0,19,5,14
LB,DE,2018.0,8,8,0
SI,GB,2016.0,21,10,11
FR,ID,2022.0,7,19,-12
JP,SG,2007.0,28,20,8
AO,US,2022.0,3,2,1
CZ,NG,2020.0,6,2,4
AU,IT,2006.0,25,37,-12
US,MK,2019.0,6,12,-6
NL,SR,2021.0,3,1,2
CH,NO,2019.0,43,30,13
BD,FI,2018.0,4,4,0
ZM,JP,2019.0,2,1,1
DE,PL,1999.0,55,58,-3
US,IQ,2021.0,77,59,18
RU,TJ,2015.0,23,39,-16
BE,EG,2002.0,3,2,1
TN,IQ,2018.0,2,1,1
AT,MK,2020.0,22,11,11
NP,PH,2018.0,8,4,4
JP,AR,2003.0,4,3,1
SE,CA,2022.0,49,45,4
ZA,FI,2019.0,6,3,3
nan,IL,2019.0,30,22,8
DE,TR,2015.0,60,68,-8
ES,GR,2019.0,11,17,-6
ES,ID,2010.0,10,12,-2
PR,KR,2006.0,29,35,-6
TR,AU,2008.0,5,8,-3
SK,RU,2017.0,20,15,5
TW,TH,2021.0,13,12,1
CA,TR,2017.0,27,34,-7
CH,GR,2017.0,21,40,-19
PT,DK,2018.0,9,6,3
US,BO,2013.0,12,5,7
MW,US,2021.0,14,14,0
NL,ES,2014.0,79,109,-30
JM,US,2007.0,5,11,-6
IE,DK,2019.0,15,14,1
PE,GT,2014.0,3,1,2
IT,EC,2015.0,8,3,5
CR,CO,2021.0,29,33,-4
IS,NO,2018.0,14,8,6
NL,HK,2008.0,21,11,10
CA,NL,2001.0,41,35,6
TZ,NL,2015.0,4,4,0
SK,RS,2005.0,3,1,2
US,UA,2002.0,19,37,-18
CN,IR,2011.0,19,33,-14
MX,BE,2016.0,11,17,-6
DE,MX,2011.0,34,39,-5
GB,NO,2009.0,72,49,23
MY,SG,2012.0,62,89,-27
GB,RS,2013.0,19,18,1
BD,IN,2014.0,106,87,19
RS,RU,2008.0,9,10,-1
MA,DZ,2004.0,1,2,-1
RU,NO,2006.0,10,5,5
BE,LU,2005.0,9,5,4
BR,FR,1999.0,36,55,-19
FI,AT,2003.0,7,1,6
NL,RU,2012.0,24,38,-14
GB,SE,1997.0,49,49,0
GR,FR,2008.0,21,33,-12
FI,BR,2010.0,4,4,0
GB,UA,2003.0,5,20,-15
AU,BE,2001.0,19,11,8
LU,NL,2018.0,4,8,-4
CH,CZ,2009.0,19,19,0
LB,US,2006.0,35,25,10
BR,GB,1999.0,55,62,-7
GB,UY,2012.0,3,4,-1
IN,PH,2013.0,18,14,4
AM,US,2012.0,17,7,10
UG,BE,2007.0,5,2,3
RU,AU,2002.0,16,8,8
RU,BR,2013.0,15,13,2
US,EG,1998.0,56,58,-2
LT,BR,2022.0,1,2,-1
ZA,RO,2021.0,2,12,-10
nan,ES,2015.0,47,47,0
SE,NL,2011.0,46,58,-12
BR,TW,2019.0,6,1,5
MX,PH,2020.0,16,18,-2
NO,IS,2010.0,9,9,0
FR,IN,1998.0,31,22,9
KZ,DE,2015.0,6,7,-1
CH,AU,2007.0,47,39,8
RO,CH,2012.0,5,11,-6
nan,IN,2003.0,9,7,2
KR,BD,2014.0,22,25,-3
FR,KH,2018.0,13,5,8
IT,CU,2001.0,2,2,0
IN,TR,2014.0,22,16,6
LB,CH,2017.0,4,4,0
QA,MX,2015.0,1,2,-1
nan,KR,2012.0,22,23,-1
DK,IT,2002.0,11,13,-2
CA,IL,2007.0,37,47,-10
GH,JP,2020.0,7,9,-2
FR,CZ,1997.0,9,10,-1
PY,ES,2016.0,9,28,-19
RO,US,2006.0,44,30,14
QA,GB,2020.0,26,54,-28
NO,TZ,2020.0,8,1,7
IN,NG,2012.0,13,6,7
CH,BR,1997.0,15,4,11
FR,IN,1997.0,21,11,10
MY,IR,2011.0,48,63,-15
BD,ES,2003.0,6,6,0
NP,IN,2007.0,25,31,-6
MA,TN,2022.0,19,16,3
SY,IQ,2016.0,4,1,3
VE,BR,2021.0,17,13,4
AU,BR,1999.0,19,18,1
FI,PL,2018.0,9,9,0
MK,CN,2001.0,1,2,-1
RU,AZ,2001.0,4,3,1
IT,SE,2011.0,82,59,23
FR,CG,2010.0,13,14,-1
FR,SY,2020.0,8,7,1
TZ,GM,2020.0,1,2,-1
FR,PF,2015.0,16,7,9
GR,LU,2021.0,2,5,-3
BE,JP,2001.0,15,20,-5
DK,GH,2013.0,3,1,2
BY,US,2022.0,7,7,0
SE,KR,2015.0,6,13,-7
CA,GR,2004.0,5,4,1
RO,FR,2022.0,20,22,-2
AM,DE,2014.0,9,1,8
SK,SI,2016.0,2,1,1
SV,ES,2007.0,2,2,0
TW,NL,2013.0,8,6,2
US,VG,2008.0,19,7,12
DK,JP,2014.0,14,17,-3
IR,IQ,2022.0,14,19,-5
TR,CN,2019.0,28,17,11
EG,KW,1999.0,8,5,3
IN,IL,1998.0,5,5,0
CN,NP,2016.0,19,24,-5
ES,FI,2001.0,2,4,-2
NL,ET,2015.0,5,6,-1
CM,nan,2017.0,9,6,3
HR,JP,2015.0,1,1,0
JP,LU,2019.0,3,2,1
FR,BF,2020.0,11,26,-15
VN,FR,2016.0,16,50,-34
DE,BE,2017.0,140,142,-2
NO,JP,2019.0,8,18,-10
RS,SK,2003.0,7,11,-4
EG,DZ,2019.0,6,13,-7
US,ZW,2017.0,14,16,-2
RU,TN,2019.0,7,2,5
VN,TW,2018.0,17,37,-20
SA,JO,2013.0,20,48,-28
CN,DK,2011.0,31,30,1
PG,AU,2017.0,7,6,1
AF,ID,2020.0,1,1,0
IR,HU,2021.0,6,2,4
ES,MY,2013.0,3,8,-5
CO,nan,2018.0,11,12,-1
IQ,DK,2022.0,2,1,1
MY,JP,2021.0,26,46,-20
JO,AT,2020.0,1,1,0
NG,QA,2022.0,3,2,1
PH,IN,2012.0,14,10,4
EG,IL,2021.0,4,4,0
DE,BG,2008.0,19,36,-17
FR,EC,2019.0,14,18,-4
EG,HU,2020.0,5,8,-3
EG,AT,2018.0,5,7,-2
UZ,AZ,2021.0,3,4,-1
MX,JP,2018.0,11,10,1
ID,NZ,2005.0,1,1,0
GB,MX,2010.0,64,43,21
FR,GA,2018.0,11,7,4
DE,IE,2001.0,19,29,-10
GB,PH,2008.0,11,13,-2
UZ,RU,2011.0,15,13,2
IN,DE,2006.0,121,82,39
KZ,TR,2012.0,44,44,0
JP,MY,2008.0,42,19,23
RU,SE,2017.0,17,31,-14
US,CR,2011.0,31,27,4
TH,GB,2019.0,54,73,-19
IT,MY,2002.0,34,30,4
PT,CV,2013.0,2,2,0
BR,AR,2006.0,95,70,25
PE,nan,2008.0,8,4,4
nan,BY,2020.0,1,2,-1
CY,GR,2018.0,32,81,-49
BH,JP,2019.0,2,3,-1
FR,SE,2007.0,63,43,20
JP,GB,2023.0,14,7,7
FR,RE,1998.0,4,1,3
DE,BY,2017.0,6,2,4
UZ,JP,2017.0,4,2,2
BE,UG,2006.0,1,2,-1
US,SI,1997.0,14,5,9
RS,HU,2007.0,5,2,3
CO,AU,2015.0,17,6,11
YE,CA,2019.0,1,1,0
ES,RU,2011.0,15,19,-4
GR,MX,2018.0,4,3,1
MA,GB,2013.0,3,8,-5
ZA,LK,2018.0,3,1,2
MX,RU,2013.0,6,4,2
MY,US,2007.0,50,74,-24
MA,MD,2012.0,5,4,1
US,RW,2018.0,18,9,9
IR,PL,2016.0,7,4,3
US,UA,2005.0,32,46,-14
UA,HR,2022.0,3,17,-14
MX,PA,2014.0,11,4,7
CH,NO,2010.0,19,16,3
MY,AU,2001.0,7,5,2
GR,MK,2010.0,7,1,6
SE,AR,2008.0,8,1,7
CH,ES,2012.0,82,89,-7
JO,SA,2009.0,19,6,13
BY,DE,2003.0,11,7,4
TZ,BE,2015.0,2,3,-1
MA,IT,2007.0,7,12,-5
SI,DE,2018.0,21,18,3
MY,KR,2022.0,14,9,5
CO,CU,2012.0,23,42,-19
NO,DE,2007.0,36,74,-38
DE,CZ,2011.0,58,48,10
NL,nan,2003.0,36,30,6
CA,EG,2002.0,6,12,-6
AT,FR,1998.0,14,19,-5
CA,RO,2010.0,8,13,-5
nan,TR,2006.0,4,3,1
IT,RS,2008.0,5,8,-3
JP,VN,2008.0,25,18,7
DE,HU,2008.0,50,57,-7
RU,AT,2012.0,15,15,0
FI,BR,2019.0,11,21,-10
IQ,US,2012.0,12,17,-5
IT,RO,2014.0,17,10,7
PH,FR,2022.0,5,4,1
DK,IT,2005.0,9,14,-5
BG,FR,2013.0,6,9,-3
CZ,JP,2009.0,13,20,-7
SA,FR,2011.0,7,40,-33
TR,MK,2019.0,2,1,1
SI,FR,2006.0,2,5,-3
SE,PL,2020.0,28,28,0
IR,LB,2006.0,1,1,0
CZ,TR,2011.0,4,4,0
TN,IT,2004.0,3,2,1
CA,KE,2015.0,8,10,-2
SI,CZ,2000.0,4,5,-1
NL,IE,2020.0,23,39,-16
US,BA,2009.0,9,2,7
RU,SE,2010.0,25,30,-5
CH,TW,2022.0,5,10,-5
VN,BE,2022.0,7,7,0
SE,RU,2013.0,27,30,-3
IT,KE,2016.0,3,4,-1
OM,PK,2022.0,2,8,-6
VE,IT,2007.0,5,5,0
CL,PE,2004.0,16,16,0
PL,SE,2005.0,13,19,-6
BO,CL,2011.0,11,6,5
PS,SA,2021.0,7,6,1
US,JM,2016.0,15,26,-11
MX,CA,2001.0,14,16,-2
BE,PT,1997.0,3,1,2
IT,KZ,2018.0,10,2,8
TN,CA,2008.0,5,10,-5
TN,US,2006.0,7,9,-2
US,NP,2009.0,13,20,-7
VE,PT,2020.0,3,4,-1
CA,DZ,2006.0,2,9,-7
SE,HU,2003.0,10,8,2
ID,ES,2013.0,10,15,-5
CO,AT,2014.0,3,1,2
JP,DK,2000.0,12,14,-2
JO,BD,2012.0,1,1,0
FR,BZ,2012.0,1,3,-2
PL,PK,2017.0,11,11,0
TW,FI,2012.0,4,2,2
CA,CZ,2020.0,9,12,-3
ES,DK,2018.0,46,40,6
nan,NG,2014.0,3,3,0
EE,TR,2019.0,3,2,1
HU,CH,2015.0,16,10,6
FR,UG,2019.0,4,6,-2
IL,CH,2001.0,13,4,9
IQ,NG,2016.0,3,3,0
HU,PL,2014.0,10,20,-10
CM,FR,2022.0,7,7,0
PK,SG,2003.0,3,1,2
CN,EG,2008.0,12,7,5
NG,MY,2010.0,5,2,3
EC,nan,2018.0,1,4,-3
MN,JP,2019.0,12,13,-1
FR,TH,2007.0,12,6,6
FR,HR,2019.0,5,8,-3
JO,GB,2003.0,8,3,5
CH,RO,2006.0,4,4,0
TZ,JP,2004.0,3,7,-4
HU,CN,2004.0,3,6,-3
IT,SI,2011.0,14,14,0
UA,SE,2000.0,7,6,1
TW,SK,2004.0,1,1,0
UA,TW,2005.0,3,1,2
JP,LV,1999.0,1,2,-1
LT,LV,2017.0,2,5,-3
FR,UZ,2021.0,1,1,0
SG,RU,2016.0,7,2,5
UA,IN,2018.0,2,6,-4
EG,DE,2006.0,19,32,-13
GB,TW,2022.0,40,30,10
NZ,GH,2019.0,5,2,3
CH,NL,2023.0,9,6,3
ZA,TZ,2013.0,10,6,4
EE,FI,2008.0,9,8,1
IR,TH,2015.0,5,2,3
CA,RS,1999.0,7,2,5
KW,GB,2002.0,3,5,-2
IL,IN,2022.0,46,61,-15
US,ET,2006.0,15,16,-1
AT,FR,1997.0,12,5,7
CA,JO,2022.0,6,7,-1
AU,BG,2015.0,2,4,-2
SE,TH,2016.0,6,4,2
NO,NL,2003.0,22,10,12
RU,HU,2016.0,17,10,7
BW,AU,2022.0,2,1,1
BE,CO,2016.0,14,12,2
EC,ES,2012.0,26,30,-4
PG,AU,2019.0,8,5,3
BE,MZ,2008.0,5,2,3
KR,CZ,2020.0,11,8,3
CH,SK,2014.0,7,5,2
PE,IE,2020.0,2,3,-1
BR,AT,2000.0,2,2,0
IT,IR,2016.0,24,44,-20
SG,IR,2002.0,2,1,1
BZ,FR,2003.0,6,10,-4
AR,PK,2010.0,14,10,4
CI,FR,2011.0,4,27,-23
TZ,SE,2012.0,3,5,-2
JP,GH,2014.0,2,3,-1
ES,ID,2017.0,22,13,9
PL,SE,2002.0,11,10,1
MX,NO,2016.0,3,4,-1
NL,LK,2003.0,2,1,1
SG,IQ,2020.0,7,8,-1
IR,KW,2013.0,1,1,0
DE,CO,2011.0,21,14,7
FI,RU,2002.0,13,13,0
CA,RO,2017.0,14,12,2
CA,LV,2009.0,3,1,2
ET,ZA,2012.0,1,3,-2
ET,SE,2002.0,2,2,0
JP,UG,2017.0,2,1,1
MY,CA,2011.0,16,19,-3
DZ,CN,2021.0,3,2,1
PL,GR,2001.0,5,1,4
CZ,NO,2002.0,6,2,4
US,EE,1999.0,10,3,7
MK,BA,2020.0,2,1,1
BE,EC,2016.0,7,3,4
NL,GR,2009.0,14,18,-4
nan,SG,2015.0,14,7,7
NO,IS,2019.0,3,8,-5
HK,RO,2009.0,7,21,-14
TR,RS,2001.0,19,19,0
SK,IT,2013.0,3,5,-2
nan,CA,2011.0,36,33,3
DK,CZ,2000.0,1,1,0
JP,PL,2002.0,25,12,13
IN,SA,2005.0,11,12,-1
CZ,NO,2005.0,12,3,9
RS,CA,2011.0,11,7,4
EE,FR,2013.0,5,6,-1
HN,MX,2004.0,13,16,-3
SK,US,2008.0,29,39,-10
DK,IN,2017.0,18,24,-6
BR,LB,2011.0,3,3,0
SE,CO,2010.0,2,2,0
DE,PS,2013.0,9,3,6
IT,IL,2015.0,23,17,6
PA,CA,2008.0,3,1,2
CZ,SE,1998.0,5,1,4
IL,KR,2018.0,4,7,-3
HU,DK,2007.0,7,3,4
RS,AT,2003.0,3,4,-1
BW,US,2011.0,2,13,-11
NO,AU,2012.0,21,16,5
NO,BD,2009.0,1,2,-1
CO,CR,2021.0,33,29,4
SI,BR,2018.0,5,1,4
MX,DK,2017.0,6,3,3
CA,TR,2010.0,20,21,-1
CA,ES,1998.0,20,15,5
US,BM,2011.0,4,1,3
SG,FR,2012.0,16,29,-13
MX,DK,2019.0,7,12,-5
AU,GR,2013.0,6,14,-8
FR,BI,2004.0,9,15,-6
ET,AU,2013.0,4,2,2
NZ,PK,2016.0,8,9,-1
IN,EE,2015.0,2,3,-1
FR,CG,2019.0,15,11,4
FR,VN,1997.0,3,3,0
PH,CL,2018.0,7,5,2
IE,CN,2000.0,4,3,1
KR,BR,2020.0,9,6,3
MX,IT,2004.0,16,24,-8
SK,RU,2010.0,3,10,-7
GB,UG,2004.0,2,7,-5
AU,HR,2003.0,2,3,-1
SV,CL,2021.0,3,5,-2
NL,MX,2005.0,7,9,-2
JP,BR,1999.0,23,25,-2
IT,BE,1997.0,24,19,5
IE,DK,2017.0,10,9,1
CA,CU,2009.0,3,1,2
FR,AT,2022.0,32,25,7
BD,NO,2015.0,3,1,2
IT,MX,2020.0,20,50,-30
TZ,ES,2019.0,2,1,1
KG,ID,2022.0,2,1,1
HU,EG,2011.0,1,4,-3
IN,RW,2012.0,7,6,1
BE,PT,1998.0,6,3,3
CN,TR,2021.0,19,15,4
IN,AT,2019.0,18,11,7
IN,SA,2002.0,10,9,1
TW,SA,2011.0,3,1,2
HR,FR,2005.0,3,2,1
ID,RU,2018.0,17,16,1
KW,TR,2020.0,9,9,0
FR,CO,2020.0,36,52,-16
EG,NG,2018.0,6,7,-1
ES,UA,2015.0,3,5,-2
IL,BE,2013.0,4,6,-2
GE,nan,2015.0,4,3,1
GT,IT,2012.0,1,1,0
CA,CI,2016.0,4,3,1
RU,SI,2013.0,3,1,2
VN,ID,2019.0,2,1,1
FR,KR,2001.0,7,13,-6
MX,GR,2008.0,7,3,4
AE,DE,2009.0,2,5,-3
BG,CH,2022.0,3,2,1
CN,CU,2015.0,1,2,-1
LB,CH,2019.0,8,4,4
VG,NO,2020.0,1,1,0
JP,SA,2001.0,3,3,0
BR,HU,2021.0,4,4,0
TW,PH,2022.0,7,5,2
BR,RU,2016.0,14,13,1
SI,ID,2022.0,4,4,0
NG,IT,2007.0,4,1,3
PS,US,1999.0,3,2,1
FR,AM,2006.0,3,3,0
BY,CN,2008.0,4,3,1
NO,CA,2000.0,9,14,-5
SK,RU,2019.0,29,14,15
GB,MA,2009.0,4,2,2
ZA,EG,2022.0,6,4,2
MX,GT,2010.0,8,6,2
CH,GR,2010.0,16,14,2
US,MD,2009.0,5,6,-1
PH,GB,2012.0,9,10,-1
PK,TH,2020.0,7,11,-4
PL,IR,2011.0,2,3,-1
MX,CN,1998.0,1,1,0
ZM,US,2008.0,8,1,7
CO,GB,2008.0,20,23,-3
TW,CL,2006.0,2,1,1
AU,UG,2018.0,2,2,0
CR,DK,2018.0,1,2,-1
SL,GB,2012.0,1,1,0
MX,RS,2013.0,12,1,11
US,SI,1998.0,6,8,-2
IQ,BH,2018.0,2,4,-2
FR,VN,1998.0,4,1,3
CA,ES,1997.0,12,9,3
IL,FI,2016.0,2,4,-2
UY,IT,2005.0,4,2,2
NZ,SG,2001.0,3,1,2
CR,AU,2015.0,4,3,1
IN,IE,2006.0,12,11,1
MW,ZA,2006.0,2,4,-2
MN,JP,2017.0,3,10,-7
GT,US,2020.0,10,6,4
CH,GR,2019.0,20,42,-22
UY,AR,2002.0,4,8,-4
ZA,FI,2017.0,5,8,-3
UY,AR,2005.0,13,9,4
BR,PK,2004.0,3,2,1
IN,LK,2015.0,15,6,9
BG,SE,2013.0,3,4,-1
FR,GP,1997.0,5,3,2
ES,GR,2017.0,27,17,10
NZ,CH,1999.0,3,7,-4
CA,EE,2012.0,2,5,-3
LT,HU,1998.0,1,1,0
FR,IE,2001.0,16,12,4
MK,XK,2016.0,5,2,3
KH,LT,2015.0,1,1,0
GB,MW,2006.0,2,9,-7
CH,RW,2019.0,1,1,0
DE,SY,2012.0,10,3,7
HR,IT,2012.0,3,2,1
BF,GA,2019.0,3,2,1
BH,US,2007.0,5,8,-3
SK,RS,2002.0,6,3,3
MA,SN,2013.0,2,1,1
YE,US,2016.0,1,2,-1
TT,US,2008.0,9,9,0
AE,SG,2019.0,3,2,1
IT,CY,2016.0,3,1,2
GB,SK,2003.0,11,21,-10
IR,IN,2002.0,3,2,1
RO,BE,2011.0,14,15,-1
NL,EE,2005.0,1,2,-1
LT,MZ,2012.0,2,12,-10
DE,BY,2019.0,10,8,2
SE,SI,2000.0,4,1,3
SE,LK,2017.0,4,1,3
GB,JO,2000.0,7,3,4
QA,EG,2009.0,6,13,-7
PE,ES,1999.0,10,14,-4
DE,MA,2014.0,9,4,5
IL,JP,2020.0,15,7,8
KR,NZ,2016.0,12,9,3
GB,SY,2005.0,2,1,1
NO,AT,2013.0,5,12,-7
ID,BE,2020.0,9,10,-1
nan,UY,2008.0,1,3,-2
AE,JP,2001.0,1,2,-1
GA,DE,2015.0,4,9,-5
TW,CZ,2020.0,2,1,1
TH,CL,2019.0,1,2,-1
MY,GM,2018.0,2,1,1
CU,CL,2002.0,6,3,3
SA,KR,2011.0,1,9,-8
CO,MY,2020.0,2,3,-1
AR,PK,2017.0,3,13,-10
SY,EG,2016.0,5,4,1
RU,PT,2014.0,8,4,4
NP,PK,2019.0,3,4,-1
RS,IT,2010.0,4,6,-2
GB,MM,2022.0,1,2,-1
MY,CN,2001.0,11,9,2
IS,FR,2021.0,4,3,1
TZ,CA,2000.0,1,1,0
NC,BJ,2011.0,1,1,0
SA,nan,2015.0,2,5,-3
CZ,ID,2013.0,4,3,1
ES,PS,2009.0,3,3,0
NO,IS,2017.0,8,7,1
SE,TW,2011.0,4,5,-1
IE,DK,2010.0,7,10,-3
NZ,SE,2004.0,3,3,0
BE,BJ,2010.0,5,2,3
FR,TG,2019.0,6,3,3
FR,TG,2017.0,3,5,-2
RO,SK,2021.0,6,2,4
ZA,CM,2022.0,3,1,2
IR,AE,2021.0,8,3,5
IR,IN,2005.0,3,12,-9
IT,ZA,2007.0,8,8,0
CM,NG,2018.0,4,3,1
PE,AT,2015.0,1,2,-1
GH,US,2000.0,6,4,2
KE,AT,2016.0,3,2,1
NO,KZ,2020.0,1,1,0
VE,CL,1999.0,2,8,-6
PS,DE,2018.0,4,7,-3
MA,CH,2015.0,2,4,-2
DK,TH,2022.0,2,1,1
LT,NO,1999.0,2,2,0
TR,MX,2012.0,5,1,4
NL,LU,2002.0,3,2,1
BE,HR,2021.0,3,2,1
BF,FR,2008.0,8,17,-9
QA,AU,2016.0,15,12,3
NL,SG,2003.0,4,1,3
PK,KE,2012.0,9,12,-3
LU,BE,2001.0,3,9,-6
FI,RU,2005.0,12,21,-9
RU,AU,2005.0,13,6,7
NC,AU,2008.0,1,2,-1
PE,CU,2008.0,7,4,3
CY,GB,2004.0,3,12,-9
AE,SG,2017.0,2,6,-4
CA,VN,2021.0,10,21,-11
US,MA,2011.0,13,12,1
BO,SE,2013.0,3,3,0
CZ,MY,2020.0,13,11,2
BR,DK,2014.0,13,16,-3
PE,CA,2013.0,5,4,1
CY,CA,2008.0,1,2,-1
MX,CU,1998.0,11,3,8
BE,BJ,2019.0,3,3,0
GB,SD,2021.0,3,3,0
TW,GB,2023.0,1,3,-2
FR,CG,2017.0,15,8,7
GB,CZ,2023.0,1,2,-1
JP,HU,2012.0,11,10,1
HU,NG,2001.0,3,1,2
NZ,DE,2023.0,1,1,0
NP,FI,2016.0,1,1,0
SE,CO,2017.0,5,5,0
KE,CO,2013.0,4,2,2
UA,MX,2016.0,2,1,1
ID,DE,2005.0,6,9,-3
US,BY,2009.0,8,10,-2
PH,CH,2013.0,4,6,-2
FI,DK,2000.0,3,5,-2
IN,IL,1997.0,3,1,2
MN,JP,2010.0,2,5,-3
nan,CZ,2014.0,2,1,1
SE,RS,2012.0,5,4,1
IR,ES,2010.0,9,6,3
UA,BG,2009.0,4,9,-5
SK,SE,2022.0,2,1,1
DE,SK,2012.0,35,37,-2
IR,QA,2016.0,6,1,5
PT,NP,2007.0,1,1,0
SE,VE,1999.0,4,2,2
CO,UY,2021.0,13,8,5
CA,LB,2001.0,3,6,-3
RS,IT,2019.0,4,6,-2
SE,PK,2020.0,11,10,1
SA,TR,2023.0,2,1,1
UY,CR,2012.0,2,2,0
ZA,TR,2009.0,2,1,1
ID,CH,2013.0,3,7,-4
KE,PH,2000.0,1,1,0
MX,DO,2014.0,6,3,3
HU,KW,2003.0,3,1,2
ID,SD,2015.0,2,2,0
BR,SK,2009.0,2,2,0
TH,IN,2009.0,7,3,4
IE,CY,2018.0,1,2,-1
BR,KR,2020.0,6,9,-3
ES,KE,2016.0,2,2,0
BR,BO,2008.0,2,3,-1
NO,JP,2010.0,6,9,-3
UG,DK,2015.0,1,3,-2
TR,FR,1997.0,1,6,-5
PL,PK,2010.0,1,9,-8
BE,EG,2005.0,2,1,1
KW,GB,2005.0,4,9,-5
UY,EC,2015.0,1,1,0
US,HK,2005.0,3,4,-1
PK,BD,2023.0,2,12,-10
BY,ES,2018.0,1,1,0
LV,DK,2020.0,2,1,1
AR,PK,2019.0,10,9,1
AF,IR,2017.0,2,3,-1
GB,JM,2008.0,3,9,-6
LK,SE,2017.0,1,4,-3
DE,BY,2010.0,7,12,-5
CL,BE,2006.0,4,3,1
ZA,IL,1997.0,3,3,0
MM,MY,2022.0,2,1,1
BR,SD,2020.0,1,1,0
IE,ZA,2004.0,2,5,-3
DZ,IR,2020.0,4,4,0
IR,TW,2002.0,3,1,2
LY,US,2018.0,3,5,-2
BI,US,2015.0,4,2,2
LI,DE,2018.0,2,6,-4
nan,NZ,2004.0,5,13,-8
KR,CL,2020.0,5,1,4
KR,IR,2009.0,1,4,-3
FR,SK,2007.0,9,6,3
RU,PE,2014.0,1,1,0
SD,GB,2007.0,8,4,4
nan,BE,1997.0,4,7,-3
LT,BE,2012.0,3,3,0
NP,TH,2021.0,5,4,1
AT,ZA,2009.0,3,1,2
JP,HR,2012.0,3,4,-1
BG,UA,2001.0,4,1,3
PT,IT,2023.0,2,4,-2
ID,AE,2019.0,8,8,0
CL,IT,2000.0,4,4,0
DK,SG,2000.0,2,2,0
IE,SG,2021.0,7,6,1
AE,SE,2018.0,1,3,-2
DK,RS,2016.0,3,2,1
JP,CZ,2000.0,5,9,-4
KZ,UA,2009.0,1,3,-2
CN,PL,2000.0,4,2,2
CF,FR,2015.0,1,1,0
SE,BO,2011.0,1,2,-1
FI,BR,2017.0,8,10,-2
CH,SI,2018.0,9,7,2
IT,GH,2015.0,1,1,0
PK,NP,2015.0,11,4,7
JO,TN,2021.0,4,3,1
RO,RU,2018.0,7,5,2
BF,GB,2020.0,3,2,1
AR,JP,2021.0,3,3,0
TZ,NO,2012.0,3,3,0
AE,CA,2023.0,1,1,0
SK,RO,2006.0,2,5,-3
AZ,RU,2013.0,8,8,0
NE,BJ,2020.0,2,1,1
AR,PY,2022.0,6,5,1
LB,TR,2022.0,3,1,2
CZ,GE,2019.0,3,1,2
DK,NZ,2003.0,2,1,1
US,SV,2011.0,6,4,2
UA,AT,2022.0,5,1,4
ZA,GR,2019.0,1,3,-2
AR,HN,2015.0,3,7,-4
CU,NL,2015.0,1,1,0
TZ,BH,2007.0,4,4,0
PL,NG,2018.0,1,1,0
IT,CO,2006.0,3,4,-1
FR,TG,2010.0,1,6,-5
ZA,IE,2000.0,2,2,0
BJ,NG,2003.0,2,1,1
SV,US,2004.0,2,2,0
IN,CM,2021.0,4,2,2
US,ZW,2010.0,3,11,-8
FR,ML,2003.0,3,5,-2
AZ,UZ,2014.0,3,2,1
PF,FR,2015.0,7,16,-9
DK,MY,2017.0,4,11,-7
BR,GW,2018.0,1,1,0
SV,MX,2018.0,4,5,-1
KR,DK,2020.0,11,4,7
CA,AT,1999.0,8,10,-2
US,PR,2001.0,3,8,-5
CR,CA,2021.0,2,2,0
IE,CL,2009.0,2,1,1
IR,PK,2005.0,1,2,-1
SG,SE,2000.0,2,2,0
SE,LK,2010.0,3,2,1
GH,DE,2008.0,2,1,1
TR,KG,2019.0,4,3,1
ET,EG,2014.0,4,6,-2
ZA,CL,2003.0,2,1,1
FR,HR,2010.0,2,2,0
DK,GR,1997.0,6,1,5
PA,PH,2020.0,2,1,1
BA,MY,2016.0,2,3,-1
CL,BO,2003.0,1,1,0
SE,LV,2021.0,2,2,0
nan,RO,2010.0,2,2,0
CI,BF,1999.0,1,1,0
GR,MK,2017.0,4,9,-5
AZ,DE,2017.0,7,3,4
US,UZ,2004.0,2,3,-1
IL,SE,2006.0,5,6,-1
EG,PK,2007.0,6,3,3
LT,CZ,2004.0,4,1,3
CZ,BD,2021.0,4,2,2
GH,IR,2019.0,1,1,0
CU,NI,2010.0,1,1,0
BE,LB,2022.0,2,6,-4
PT,NZ,2011.0,1,2,-1
YE,IN,2020.0,2,11,-9
RU,KR,2016.0,6,22,-16
BE,BJ,2017.0,5,3,2
AT,FI,2021.0,12,15,-3
IE,BH,2018.0,1,2,-1
IR,FI,2005.0,1,1,0
EC,GB,2009.0,2,2,0
SE,BG,2007.0,2,4,-2
QA,FI,2009.0,1,1,0
HU,TR,2007.0,1,1,0
PG,IN,2020.0,2,1,1
DE,EE,1997.0,6,1,5
ES,nan,2006.0,5,15,-10
SA,NL,2000.0,1,1,0
NL,UG,2013.0,3,2,1
BR,CN,2023.0,1,1,0
TZ,RW,2018.0,1,2,-1
NL,GH,2009.0,1,2,-1
CZ,AT,2000.0,2,12,-10
JP,HK,2012.0,6,6,0
LB,SY,2009.0,3,1,2
MX,DK,2010.0,4,4,0
UA,BR,2009.0,2,1,1
TW,ZA,2022.0,3,3,0
TN,ZA,2020.0,4,1,3
SN,CH,2004.0,1,1,0
SK,nan,2009.0,3,5,-2
SK,NZ,2000.0,1,1,0
EC,DO,2021.0,2,3,-1
DZ,IN,2020.0,1,2,-1
FJ,IN,2020.0,7,6,1
BE,VN,2013.0,4,8,-4
BD,TH,2013.0,2,2,0
TR,BR,2005.0,5,37,-32
JP,TW,2023.0,4,2,2
CO,NO,2021.0,5,1,4
HU,ET,2020.0,1,2,-1
NZ,IT,2018.0,5,11,-6
QA,DK,2003.0,1,1,0
HR,RU,2008.0,3,3,0
SG,BE,2004.0,2,2,0
MY,PH,2021.0,3,2,1
CD,BE,2021.0,6,10,-4
FR,KE,2009.0,7,8,-1
HR,MK,2019.0,1,3,-2
CZ,HU,2013.0,2,6,-4
EG,PT,2011.0,4,1,3
TZ,ES,2010.0,1,1,0
CW,US,2007.0,1,1,0
BR,CZ,2003.0,2,3,-1
GB,KH,2022.0,1,9,-8
BD,IE,2020.0,2,1,1
SY,AT,2015.0,1,1,0
VE,DE,2008.0,4,2,2
AT,PT,2005.0,1,6,-5
GB,BA,2014.0,1,2,-1
NZ,BR,2004.0,1,3,-2
BR,TW,2010.0,2,2,0
AT,BF,2012.0,1,2,-1
PR,JP,2006.0,1,5,-4
IL,CU,2010.0,1,1,0
FR,GP,1998.0,5,3,2
AL,DE,2001.0,2,1,1
CZ,PH,2013.0,1,1,0
MT,US,2009.0,1,3,-2
NZ,CO,2011.0,2,3,-1
MD,CN,2015.0,3,3,0
FI,SE,2023.0,4,5,-1
BF,ZA,2014.0,1,1,0
ZA,TW,2012.0,3,1,2
NZ,NO,2020.0,5,6,-1
ET,IE,2020.0,1,1,0
PL,PT,2009.0,2,4,-2
EC,HU,2020.0,2,1,1
AE,FR,2008.0,2,5,-3
CN,AT,2005.0,3,19,-16
JM,BB,2004.0,1,2,-1
PK,ID,2003.0,1,3,-2
CN,JO,2022.0,3,1,2
SG,NL,2000.0,1,6,-5
PR,MY,2018.0,2,1,1
CH,IE,2000.0,3,4,-1
ID,DE,2002.0,1,3,-2
KR,AT,2018.0,5,5,0
NG,KW,2015.0,1,1,0
NE,CI,2021.0,1,1,0
DE,RS,1999.0,4,2,2
MY,FI,2011.0,2,1,1
GR,MK,2019.0,6,9,-3
DE,PA,2018.0,6,4,2
OM,BD,2014.0,3,2,1
NP,PK,2017.0,5,4,1
BF,GA,2017.0,2,3,-1
TN,IN,2011.0,3,4,-1
CM,nan,2010.0,1,3,-2
RU,EG,2006.0,1,1,0
BR,BG,2016.0,4,1,3
UG,SE,2014.0,3,8,-5
PK,KW,2018.0,3,4,-1
PH,ZA,2018.0,1,2,-1
BR,GH,2009.0,1,1,0
FI,IN,2000.0,1,2,-1
CH,UG,2007.0,1,2,-1
VE,PY,2003.0,3,1,2
BR,TW,2017.0,1,4,-3
FR,EC,2010.0,3,1,2
BG,CZ,2002.0,2,1,1
IR,DE,2000.0,1,4,-3
CO,GT,2021.0,4,3,1
VG,FR,2007.0,2,5,-3
RU,TN,2017.0,1,4,-3
RO,AT,2006.0,1,1,0
CA,GD,2016.0,2,1,1
NG,TW,2016.0,1,1,0
SE,CO,2019.0,6,10,-4
JP,PT,1997.0,2,2,0
NO,CL,2022.0,1,3,-2
nan,PL,2001.0,2,2,0
PT,NG,2015.0,1,1,0
BS,JM,2016.0,1,1,0
YE,GB,2007.0,1,2,-1
ID,YE,2021.0,1,3,-2
FR,RE,1997.0,3,2,1
KE,SD,2002.0,2,3,-1
SE,UG,1999.0,2,2,0
EG,TR,2015.0,3,3,0
UA,PT,2000.0,1,1,0
US,MC,2006.0,1,1,0
CH,ZA,2004.0,2,7,-5
MY,QA,2022.0,2,3,-1
AT,IL,2003.0,2,3,-1
SD,IN,2021.0,1,1,0
NA,US,2001.0,1,2,-1
IT,VE,2011.0,6,9,-3
SK,JP,2021.0,1,6,-5
AO,CO,2016.0,1,1,0
RU,PK,2014.0,3,1,2
LK,NP,2013.0,2,1,1
GB,RW,2018.0,2,2,0
RU,CY,2020.0,2,1,1
CN,BO,2007.0,3,4,-1
KZ,FR,2020.0,5,4,1
CR,AT,2013.0,2,1,1
PS,GR,2012.0,1,2,-1
AR,DK,2003.0,2,1,1
NZ,GH,2017.0,1,2,-1
CN,AL,2013.0,4,2,2
KZ,GR,2017.0,1,3,-2
CA,CY,2018.0,3,7,-4
GE,AZ,2009.0,1,3,-2
PH,GR,2010.0,1,1,0
RS,BR,2008.0,2,1,1
GN,SN,2005.0,1,1,0
GH,IR,2017.0,1,1,0
FR,HR,2017.0,8,3,5
TH,AT,1997.0,1,1,0
CI,GN,2020.0,3,2,1
IN,IS,2012.0,1,1,0
PT,TW,2014.0,1,1,0
JO,IL,2007.0,1,2,-1
LK,SE,2010.0,2,3,-1
MY,SE,2009.0,2,1,1
AR,IL,2009.0,3,3,0
CA,UY,2018.0,1,3,-2
SD,SE,2015.0,2,1,1
SI,JP,2007.0,3,1,2
IN,MK,2015.0,1,4,-3
BD,DK,2018.0,3,4,-1
FI,SK,2012.0,3,3,0
RO,BG,2005.0,2,1,1
SE,HR,2011.0,1,2,-1
CI,IT,2004.0,1,1,0
GH,CN,2014.0,3,6,-3
NL,CO,2008.0,2,2,0
KR,SE,1998.0,1,5,-4
SE,HK,2015.0,1,1,0
KR,LV,2013.0,1,1,0
NE,GB,2016.0,1,2,-1
LT,LV,2019.0,2,2,0
TZ,ID,2020.0,2,2,0
TH,CH,2009.0,3,3,0
BA,DK,2012.0,1,1,0
nan,LK,2015.0,1,1,0
AU,BS,2020.0,1,2,-1
GH,KE,2014.0,3,1,2
PL,ES,2001.0,1,1,0
AZ,DE,2019.0,4,3,1
ES,HN,2007.0,2,2,0
DK,GR,1998.0,1,1,0
GB,SG,2014.0,165,94,71
AO,BR,2013.0,26,20,6
BR,US,2004.0,485,531,-46
AR,US,2019.0,341,318,23
BR,IT,2020.0,315,298,17
CH,CA,2002.0,44,51,-7
FR,ES,2012.0,256,285,-29
PK,US,2008.0,93,126,-33
IN,AE,2012.0,15,10,5
FR,AR,2015.0,87,91,-4
NL,IT,2013.0,100,122,-22
DE,CN,2003.0,177,128,49
DK,BE,2016.0,58,63,-5
US,IE,2012.0,469,478,-9
nan,RO,2019.0,4,6,-2
US,RU,2007.0,246,319,-73
BR,JP,2014.0,58,68,-10
GR,CH,2011.0,25,14,11
ZA,AU,2015.0,77,62,15
VN,GR,2013.0,11,2,9
PL,FI,2018.0,9,9,0
ZA,GR,2017.0,3,4,-1
JP,LT,2013.0,9,3,6
EC,US,2007.0,9,15,-6
AU,PL,2003.0,6,2,4
EG,QA,2013.0,21,15,6
DK,MY,2019.0,4,8,-4
GB,SE,1998.0,65,60,5
nan,IL,2010.0,26,20,6
nan,PT,2019.0,34,16,18
RU,CH,2005.0,26,12,14
CZ,CH,2011.0,23,27,-4
DK,nan,2009.0,17,24,-7
CH,AT,2007.0,67,70,-3
HN,CO,2020.0,5,7,-2
CA,RU,2020.0,46,38,8
BE,ZA,2018.0,22,20,2
CH,NO,2017.0,30,28,2
PT,FR,2006.0,22,28,-6
FI,TH,2015.0,1,1,0
IR,CA,2006.0,53,55,-2
HN,CL,2021.0,3,1,2
TW,RU,2020.0,9,15,-6
VN,KR,2020.0,61,133,-72
ET,NL,2018.0,7,21,-14
DE,EE,1998.0,9,5,4
NL,CA,2020.0,87,114,-27
GB,FI,2002.0,38,36,2
IT,IE,1999.0,7,6,1
NG,GB,2012.0,42,39,3
US,AM,2014.0,7,11,-4
nan,PT,2010.0,24,27,-3
EG,DZ,2010.0,6,1,5
IL,PS,2016.0,5,2,3
JO,DE,2020.0,8,12,-4
VN,IT,2002.0,1,2,-1
BE,SA,2014.0,6,4,2
RU,MN,2016.0,3,4,-1
IN,SK,2018.0,5,3,2
UA,MY,2016.0,5,2,3
IN,AT,2010.0,15,9,6
DK,IN,2019.0,22,21,1
CZ,SI,2012.0,12,6,6
FI,CL,2016.0,7,4,3
LV,US,2018.0,6,11,-5
UA,US,2009.0,47,30,17
BY,UA,2022.0,8,6,2
EG,DZ,2017.0,6,4,2
GD,CA,2016.0,1,2,-1
BR,LU,2012.0,3,4,-1
BR,GR,2019.0,6,2,4
EC,AU,2017.0,3,2,1
JP,BE,2001.0,20,15,5
CA,KW,2007.0,6,5,1
IL,FR,2011.0,21,30,-9
FI,JP,2014.0,15,11,4
DK,SK,2008.0,2,6,-4
MK,GR,2017.0,9,4,5
FR,UG,2010.0,6,2,4
MK,ID,2016.0,6,3,3
nan,MY,2004.0,6,13,-7
CH,BD,2008.0,2,1,1
NL,MA,2018.0,3,2,1
PL,AT,2003.0,3,10,-7
US,TN,2009.0,16,11,5
LB,AU,2003.0,1,2,-1
RU,CA,1999.0,29,12,17
TW,TZ,2018.0,2,1,1
BR,ID,2012.0,4,5,-1
DZ,IT,2012.0,16,22,-6
AT,PT,2002.0,2,4,-2
AM,IT,2008.0,18,18,0
IN,AT,2017.0,16,8,8
LT,RU,2008.0,10,8,2
MX,VN,2011.0,6,1,5
BY,PT,2005.0,3,1,2
MK,GR,2019.0,9,6,3
CA,HU,2011.0,12,12,0
DK,AT,2020.0,21,11,10
TH,AT,1998.0,2,1,1
TR,AG,2023.0,18,8,10
CR,CN,2018.0,3,2,1
CL,SE,2012.0,3,8,-5
NL,BR,1999.0,13,10,3
IE,IT,1999.0,6,7,-1
TT,PK,2002.0,1,1,0
CZ,BE,2001.0,3,3,0
ID,PK,2003.0,3,1,2
TN,MA,2004.0,3,10,-7
OM,IN,1998.0,1,4,-3
PT,PY,2005.0,1,3,-2
CZ,CL,2022.0,1,3,-2
IN,VN,2022.0,5,10,-5
CZ,MX,2021.0,3,5,-2
US,GA,2014.0,1,1,0
EG,SD,2007.0,2,1,1
PH,JP,2014.0,16,31,-15
nan,MX,2002.0,6,7,-1
PL,UZ,2006.0,2,1,1
SE,QA,2006.0,5,2,3
US,MK,2010.0,8,4,4
TW,AR,2011.0,14,7,7
PT,CU,2008.0,4,2,2
GT,MX,2006.0,5,2,3
DK,IR,2014.0,7,15,-8
KP,JP,2019.0,2,2,0
KE,BW,2017.0,1,2,-1
NI,PE,2013.0,1,1,0
SN,IT,2021.0,2,1,1
LB,CA,2012.0,8,12,-4
TW,NZ,2015.0,14,6,8
GB,IQ,2009.0,5,4,1
ZA,SE,2005.0,8,10,-2
ZA,GR,2010.0,2,2,0
TR,NZ,2022.0,2,1,1
BY,IT,1997.0,5,2,3
GB,CR,2009.0,3,1,2
CI,ML,2021.0,5,4,1
HN,US,2012.0,3,2,1
JP,BG,2003.0,4,4,0
MX,HU,2021.0,4,1,3
LT,UA,2015.0,1,2,-1
GH,NG,2006.0,1,2,-1
HU,IT,2022.0,5,5,0
CH,LU,2021.0,6,4,2
HR,AU,2003.0,3,2,1
NO,HU,2018.0,2,8,-6
NZ,DK,2005.0,4,4,0
UY,IT,2002.0,3,1,2
AU,FJ,2011.0,5,5,0
IN,ER,2005.0,2,1,1
CZ,GE,2010.0,1,3,-2
NL,MX,2002.0,4,4,0
MG,US,2007.0,1,2,-1
NG,BE,2018.0,2,5,-3
KR,HK,2008.0,1,2,-1
MM,KR,2021.0,1,2,-1
HU,IN,1999.0,2,5,-3
CU,CL,2005.0,10,13,-3
CZ,FI,2003.0,2,3,-1
BR,SA,2011.0,4,1,3
IE,NZ,2001.0,4,3,1
NP,CA,2016.0,3,4,-1
TR,HR,2017.0,1,2,-1
US,HK,2002.0,6,1,5
HU,VN,2022.0,3,2,1
ZA,CZ,2012.0,5,7,-2
BG,CZ,2005.0,3,3,0
HR,FR,2002.0,1,1,0
HN,CU,2013.0,2,2,0
nan,RO,2017.0,1,3,-2
BD,BE,2022.0,1,2,-1
PA,CL,2007.0,1,2,-1
TH,US,2023.0,6,6,0
CM,US,2004.0,5,6,-1
KE,BW,2019.0,1,1,0
ID,IQ,2015.0,2,2,0
MX,SA,2018.0,2,1,1
BE,UZ,2004.0,1,1,0
NO,SA,2020.0,2,3,-1
US,ES,2009.0,854,773,81
IE,IN,2016.0,18,39,-21
DK,US,1997.0,103,115,-12
TR,KG,2017.0,8,1,7
EG,GB,2011.0,38,106,-68
RS,PL,2021.0,8,3,5
TR,HR,2010.0,3,2,1
PK,DE,2009.0,17,23,-6
TR,CN,2010.0,10,48,-38
BE,AT,2003.0,4,3,1
KR,PH,2010.0,6,5,1
KR,PH,2017.0,15,9,6
TR,FR,1998.0,2,7,-5
AU,KH,2011.0,2,1,1
FR,UG,2017.0,2,3,-1
AT,RU,2013.0,13,17,-4
DE,TZ,2003.0,1,1,0
,CN,2004.0,60048,0,60048
,ES,1996.0,10117,0,10117
MY,,2019.0,3027,0,3027
,IN,2007.0,14353,0,14353
,GB,2011.0,19065,0,19065
,DE,1995.0,27476,0,27476
,CN,1996.0,11973,0,11973
SE,,2016.0,2415,0,2415
,FI,2007.0,2348,0,2348
,CO,2000.0,736,0,736
US,,2004.0,24003,0,24003
,MX,2012.0,5831,0,5831
CN,,2025.0,31846,0,31846
,ES,2004.0,12405,0,12405
,TW,2001.0,4268,0,4268
KR,,1998.0,134,0,134
HU,,2020.0,1492,0,1492
,AR,2017.0,1925,0,1925
,AR,2010.0,2717,0,2717
,NL,2003.0,5172,0,5172
,PT,2005.0,1482,0,1482
,QA,2011.0,234,0,234
,SG,2008.0,1401,0,1401
,SK,1994.0,1553,0,1553
PE,,2024.0,3459,0,3459
,RO,2008.0,1802,0,1802
MY,,2010.0,340,0,340
,PK,1998.0,335,0,335
,DK,2001.0,1325,0,1325
,RU,2009.0,7717,0,7717
CO,,2018.0,2014,0,2014
,CL,2001.0,1355,0,1355
,HR,2009.0,994,0,994
BY,,2022.0,780,0,780
GI,ES,2016.0,1,0,1
CZ,,2018.0,2009,0,2009
NZ,,2013.0,595,0,595
,EG,1999.0,1043,0,1043
,PT,2002.0,1190,0,1190
FI,,2017.0,1671,0,1671
,BA,2013.0,272,0,272
,CH,2016.0,3671,0,3671
PT,,2009.0,318,0,318
MY,,2017.0,2003,0,2003
AT,,2016.0,1690,0,1690
ID,,2014.0,278,0,278
FI,,2019.0,2215,0,2215
nan,,2016.0,761,0,761
,CR,2001.0,145,0,145
PA,,2012.0,28,0,28
,LB,2009.0,346,0,346
SK,,2003.0,134,0,134
ZA,,2013.0,831,0,831
,TT,2002.0,24,0,24
FI,,2010.0,985,0,985
HR,CN,2015.0,6,0,6
AM,,2024.0,679,0,679
,PK,1997.0,349,0,349
GA,,2019.0,30,0,30
SG,,2025.0,993,0,993
TW,LK,2000.0,1,0,1
,DZ,2010.0,1084,0,1084
,KW,2005.0,145,0,145
PK,KR,2004.0,4,0,4
BD,BN,2004.0,1,0,1
BI,CN,1998.0,1,0,1
,AL,2008.0,83,0,83
DE,RW,2017.0,2,0,2
,NI,2012.0,35,0,35
,GH,2014.0,649,0,649
,HN,2010.0,44,0,44
,BY,2012.0,359,0,359
,AR,2019.0,640,0,640
BE,BI,2018.0,2,0,2
TJ,,2017.0,19,0,19
,TZ,2006.0,166,0,166
PY,,2020.0,87,0,87
,SN,2011.0,176,0,176
,MM,2011.0,24,0,24
LK,,2022.0,957,0,957
ZM,,2022.0,181,0,181
,PE,2007.0,424,0,424
,AZ,2002.0,79,0,79
BO,,2020.0,85,0,85
,LU,1995.0,44,0,44
EC,,2014.0,57,0,57
,AZ,2005.0,119,0,119
SY,BE,2018.0,1,0,1
,BO,2014.0,59,0,59
NE,,2019.0,40,0,40
,DZ,2017.0,1163,0,1163
MX,CM,2018.0,2,0,2
DZ,,2005.0,25,0,25
IR,AT,2023.0,1,0,1
,AG,2016.0,41,0,41
,KW,2002.0,122,0,122
RU,RO,1998.0,1,0,1
,AE,2016.0,506,0,506
UG,,2015.0,92,0,92
,DZ,2019.0,465,0,465
TD,,2023.0,23,0,23
SY,KW,2016.0,1,0,1
DZ,KZ,2015.0,1,0,1
,AO,2013.0,20,0,20
,JO,1999.0,151,0,151
,HN,2017.0,28,0,28
,ME,2013.0,62,0,62
KH,,2007.0,5,0,5
GR,BR,2000.0,1,0,1
BD,TZ,2012.0,1,0,1
KN,IN,2020.0,1,0,1
,YE,2004.0,19,0,19
CL,NI,2015.0,1,0,1
ZW,NA,2016.0,3,0,3
TJ,,2019.0,28,0,28
GR,NG,2018.0,1,0,1
,HN,2019.0,17,0,17
GE,,2024.0,788,0,788
,UG,1994.0,73,0,73
,CD,2015.0,176,0,176
FR,MR,2017.0,5,0,5
,ET,1999.0,109,0,109
,HT,2018.0,7,0,7
,GT,1999.0,10,0,10
LY,TN,2021.0,1,0,1
FR,EE,2007.0,3,0,3
RU,GH,2003.0,1,0,1
VG,,2013.0,9,0,9
IE,MT,2016.0,2,0,2
BG,,2004.0,127,0,127
TH,,2003.0,125,0,125
IN,PE,2008.0,1,0,1
EG,RU,2001.0,2,0,2
OM,,2026.0,1,0,1
GB,LB,1999.0,6,0,6
NL,EC,2011.0,1,0,1
GA,,2010.0,3,0,3
LK,SG,2003.0,2,0,2
BO,FR,2001.0,2,0,2
AU,EC,2009.0,1,0,1
SY,NZ,2014.0,2,0,2
BB,,2015.0,6,0,6
MD,CZ,2020.0,1,0,1
,BM,2002.0,1,0,1
ZM,AU,2018.0,4,0,4
IQ,,2011.0,22,0,22
VE,TH,2015.0,1,0,1
HN,,2020.0,47,0,47
UZ,JP,2010.0,8,0,8
KH,DE,2013.0,2,0,2
TR,IE,2023.0,2,0,2
BH,JP,2010.0,2,0,2
ML,BJ,2009.0,1,0,1
CU,PK,2014.0,1,0,1
SD,SA,1999.0,4,0,4
TH,KW,2018.0,1,0,1
AZ,IT,2006.0,2,0,2
BI,,2015.0,5,0,5
SS,DE,2016.0,1,0,1
GB,PR,2020.0,1,0,1
,GP,2012.0,36,0,36
KR,LB,2018.0,2,0,2
KH,AU,2021.0,3,0,3
,TT,2005.0,38,0,38
,FO,2000.0,5,0,5
CN,PE,2009.0,2,0,2
,SO,2018.0,7,0,7
EG,MR,2015.0,1,0,1
BW,nan,2018.0,1,0,1
PS,,2012.0,16,0,16
BH,BG,2007.0,1,0,1
IS,LU,2008.0,1,0,1
MX,BG,2018.0,2,0,2
CY,UA,2013.0,1,0,1
CR,UY,2003.0,1,0,1
CA,IQ,2005.0,1,0,1
KE,GR,2015.0,1,0,1
KZ,TW,2019.0,3,0,3
RS,GR,2003.0,3,0,3
MZ,,2008.0,6,0,6
CZ,AE,2018.0,2,0,2
,MT,1999.0,21,0,21
FR,BJ,1998.0,3,0,3
ET,UG,2011.0,1,0,1
MT,TN,2016.0,4,0,4
CL,UA,2001.0,2,0,2
PG,AU,2010.0,5,0,5
CA,MT,2004.0,1,0,1
CI,GB,2018.0,2,0,2
ET,PR,2012.0,3,0,3
BN,,2015.0,9,0,9
VG,PK,2019.0,1,0,1
IR,LU,2021.0,3,0,3
DK,BO,2016.0,3,0,3
CU,BE,2000.0,2,0,2
US,AL,2002.0,1,0,1
BY,IT,1998.0,2,0,2
RS,SG,2021.0,2,0,2
GB,BZ,2016.0,1,0,1
IE,LK,2010.0,1,0,1
DE,BF,2001.0,2,0,2
CU,NI,2017.0,2,0,2
GL,,2019.0,1,0,1
AO,,2007.0,9,0,9
DO,,2016.0,17,0,17
BA,CN,2010.0,1,0,1
AT,AE,2018.0,3,0,3
NE,,2017.0,19,0,19
GL,,2017.0,6,0,6
US,GY,2009.0,1,0,1
CH,PW,2016.0,1,0,1
JE,PL,2012.0,1,0,1
MY,KZ,2018.0,3,0,3
PF,,2016.0,10,0,10
OM,JP,2019.0,1,0,1
GH,,2000.0,14,0,14
DZ,,2002.0,18,0,18
RO,PE,2016.0,2,0,2
RU,GL,2012.0,1,0,1
PK,UG,2011.0,2,0,2
LY,,2014.0,22,0,22
KW,,2009.0,70,0,70
CN,KP,2011.0,2,0,2
GB,SZ,2019.0,2,0,2
,TO,2005.0,1,0,1
BF,LU,2020.0,2,0,2
KZ,BY,2009.0,2,0,2
TR,MK,2010.0,3,0,3
CM,ID,2015.0,2,0,2
GA,,2017.0,20,0,20
TR,AF,2020.0,1,0,1
NG,nan,2009.0,4,0,4
LB,UY,2018.0,1,0,1
SE,GH,2008.0,1,0,1
CL,AT,2003.0,1,0,1
FR,MZ,2002.0,1,0,1
AU,CU,2021.0,1,0,1
KR,AE,2012.0,4,0,4
,YE,1996.0,13,0,13
MZ,BE,2003.0,1,0,1
FI,NZ,1999.0,2,0,2
KH,nan,2014.0,1,0,1
LB,MA,2012.0,3,0,3
TZ,CU,2016.0,1,0,1
JP,UG,2019.0,3,0,3
CI,,2011.0,42,0,42
ES,KR,2006.0,3,0,3
BH,IN,2011.0,4,0,4
AU,RO,2014.0,8,0,8
AE,AL,2021.0,1,0,1
MA,,1998.0,8,0,8
RO,FI,2002.0,2,0,2
CO,PY,2014.0,2,0,2
FR,ET,2000.0,2,0,2
AE,AT,2014.0,1,0,1
US,RE,2006.0,2,0,2
YE,BH,2016.0,1,0,1
US,VE,2023.0,2,0,2
GB,AZ,2021.0,2,0,2
GH,nan,2004.0,2,0,2
KG,,2018.0,18,0,18
PA,nan,1999.0,1,0,1
LV,IN,2015.0,3,0,3
CM,MW,2022.0,1,0,1
SE,SD,2020.0,2,0,2
TZ,KR,2022.0,1,0,1
EG,BD,2007.0,5,0,5
,MG,1995.0,15,0,15
DE,OM,2013.0,4,0,4
BG,UZ,2021.0,1,0,1
CN,KH,2013.0,2,0,2
KZ,US,2002.0,4,0,4
MK,PK,2020.0,2,0,2
,VU,2003.0,4,0,4
CA,TH,1999.0,3,0,3
UG,IT,2004.0,2,0,2
SI,PT,2008.0,1,0,1
,TD,2000.0,2,0,2
RU,SG,2004.0,5,0,5
SG,FJ,2010.0,1,0,1
TZ,IE,2011.0,2,0,2
NO,QA,2000.0,1,0,1
HK,,2009.0,11,0,11
GW,,2016.0,3,0,3
,NE,1999.0,8,0,8
DE,AO,2007.0,1,0,1
NL,UY,2013.0,1,0,1
AR,BO,2003.0,3,0,3
LU,CA,1999.0,2,0,2
PL,LU,2008.0,1,0,1
AM,TW,2012.0,2,0,2
,AF,1999.0,2,0,2
AM,IR,2015.0,3,0,3
NZ,PE,2016.0,2,0,2
ZA,LY,2018.0,1,0,1
MT,AE,2011.0,1,0,1
AE,MT,2015.0,2,0,2
TL,,2021.0,3,0,3
UA,ET,2018.0,1,0,1
WS,FJ,2006.0,1,0,1
NZ,CM,2020.0,3,0,3
TN,AR,2020.0,1,0,1
SA,AE,2006.0,9,0,9
ET,TT,2010.0,1,0,1
BR,MD,2018.0,1,0,1
TH,ET,2012.0,1,0,1
,ST,2006.0,22,0,22
SS,,2020.0,5,0,5
TR,QA,2009.0,2,0,2
GB,BW,1997.0,1,0,1
IT,AO,2018.0,2,0,2
IN,IQ,2011.0,5,0,5
PG,ID,2021.0,1,0,1
NE,IT,2022.0,2,0,2
GY,,2025.0,1,0,1
CZ,SE,1997.0,4,0,4
NO,JO,2019.0,2,0,2
CU,EG,2017.0,1,0,1
HR,IL,2019.0,4,0,4
SA,MY,2003.0,3,0,3
LR,,2012.0,1,0,1
,LI,2012.0,9,0,9
LK,FI,2021.0,1,0,1
VE,NI,2012.0,2,0,2
HR,MT,2023.0,1,0,1
MK,VN,2007.0,3,0,3
TZ,nan,2018.0,1,0,1
HT,CA,2019.0,1,0,1
EE,IT,2003.0,1,0,1
MD,EG,2015.0,1,0,1
LT,EE,2022.0,1,0,1
SC,,2021.0,3,0,3
NE,UG,2014.0,1,0,1
ML,AR,2021.0,1,0,1
NZ,BH,2015.0,1,0,1
TW,MX,2014.0,2,0,2
ML,NE,2019.0,2,0,2
GI,,2021.0,4,0,4
BY,GR,2009.0,1,0,1
CO,DO,2005.0,1,0,1
IE,LK,2017.0,1,0,1
SA,EE,2019.0,2,0,2
SG,AR,2023.0,1,0,1
BG,BR,2003.0,1,0,1
NL,NP,2006.0,1,0,1
PG,ES,2010.0,1,0,1
,BS,2000.0,4,0,4
PL,RS,2006.0,2,0,2
KN,,2009.0,1,0,1
GM,DE,2002.0,1,0,1
MY,LA,2019.0,1,0,1
SA,GE,2018.0,1,0,1
AO,MX,2002.0,1,0,1
LT,ES,2005.0,1,0,1
GP,MQ,2011.0,2,0,2
nan,VG,2017.0,1,0,1
AZ,PK,2021.0,1,0,1
ES,KG,2019.0,1,0,1
BR,HN,2021.0,3,0,3
NZ,EE,2021.0,1,0,1
BG,MX,1999.0,1,0,1
NO,PH,2019.0,4,0,4
CZ,MN,2016.0,3,0,3
MZ,NL,2020.0,1,0,1
,GD,2000.0,2,0,2
NP,BR,2008.0,1,0,1
PS,FI,2015.0,1,0,1
TW,NO,2013.0,3,0,3
PY,BR,2023.0,1,0,1
GY,CA,2013.0,2,0,2
JP,UG,2010.0,1,0,1
RO,AL,2015.0,1,0,1
NP,LU,2020.0,1,0,1
TR,BH,2018.0,2,0,2
IE,LV,2002.0,1,0,1
PL,RO,2002.0,1,0,1
GB,BW,1998.0,2,0,2
CA,RW,2013.0,1,0,1
PT,PY,2002.0,2,0,2
TW,NE,2013.0,1,0,1
SE,AE,2004.0,4,0,4
CN,HU,2023.0,3,0,3
NG,OM,2013.0,1,0,1
,MQ,2007.0,8,0,8
SK,BE,2004.0,2,0,2
QA,SE,2001.0,3,0,3
SZ,AU,2009.0,1,0,1
JP,RS,2021.0,2,0,2
IL,GR,2002.0,3,0,3
MW,NL,2006.0,2,0,2
LK,PL,2022.0,1,0,1
ZA,TH,2003.0,1,0,1
NL,BY,2008.0,1,0,1
MQ,,2009.0,2,0,2
PE,PL,2008.0,2,0,2
MU,,1999.0,1,0,1
NA,AU,2010.0,1,0,1
GH,BD,2011.0,1,0,1
NO,PH,2017.0,1,0,1
BR,BY,2007.0,2,0,2
SO,ET,2020.0,1,0,1
,CF,2016.0,9,0,9
AU,CY,2001.0,1,0,1
PE,NI,2014.0,4,0,4
nan,MA,2011.0,3,0,3
CZ,SA,2011.0,2,0,2
LU,IR,2016.0,1,0,1
CH,EE,1998.0,1,0,1
BY,SI,2009.0,1,0,1
NO,SD,2018.0,1,0,1
MA,SG,2006.0,1,0,1
TW,BH,2023.0,1,0,1
TJ,IN,2018.0,1,0,1
PT,UA,2017.0,5,0,5
SG,TR,2007.0,1,0,1
BR,EG,2002.0,1,0,1
SE,LI,2019.0,1,0,1
AR,HU,2017.0,1,0,1
OM,KW,1998.0,1,0,1
MD,IT,2008.0,2,0,2
NI,,1998.0,1,0,1
ML,,2012.0,3,0,3
LU,DK,2006.0,1,0,1
,TG,1995.0,5,0,5
ES,GH,2015.0,1,0,1
LI,AU,2016.0,1,0,1
FR,XK,2018.0,3,0,3
IT,JO,2015.0,4,0,4
BZ,,2003.0,1,0,1
NZ,RW,2021.0,1,0,1
MC,FR,2023.0,1,0,1
PK,AT,2002.0,3,0,3
PE,GE,2020.0,1,0,1
FR,MC,2001.0,1,0,1
KE,nan,2012.0,2,0,2
IT,PA,2018.0,2,0,2
PH,GR,2017.0,1,0,1
GN,FR,2006.0,1,0,1
RU,ZW,2003.0,5,0,5
AO,MX,2005.0,2,0,2
EG,KZ,2020.0,1,0,1
IT,EE,2011.0,2,0,2
PH,FJ,2019.0,1,0,1
BH,BE,2021.0,1,0,1
HK,AT,2003.0,1,0,1
AE,BD,2016.0,3,0,3
AR,MT,2017.0,2,0,2
US,HT,2003.0,1,0,1
JO,IN,2014.0,2,0,2
NE,,2010.0,2,0,2
ID,AE,2010.0,1,0,1
nan,RW,2009.0,1,0,1
PK,CR,2017.0,1,0,1
SN,CD,2016.0,1,0,1
TT,DE,2014.0,2,0,2
MW,GB,1998.0,6,0,6
TN,SK,2014.0,1,0,1
KE,GH,2012.0,1,0,1
BO,DE,2021.0,3,0,3
BR,NI,2004.0,1,0,1
NL,LU,2005.0,2,0,2
GD,DE,2021.0,1,0,1
KW,BE,2013.0,1,0,1
NC,SN,2002.0,1,0,1
IR,NI,2012.0,1,0,1
PK,JO,2009.0,3,0,3
IL,MD,2015.0,2,0,2
WS,NZ,2007.0,1,0,1
BD,MK,2022.0,1,0,1
MQ,CH,2019.0,1,0,1
TJ,,2010.0,5,0,5
NO,RS,2013.0,2,0,2
UG,OM,2021.0,1,0,1
AT,PS,2015.0,1,0,1
IR,IE,2023.0,1,0,1
MQ,SN,2016.0,1,0,1
NE,ZM,2020.0,1,0,1
CW,,2008.0,4,0,4
EC,VE,2001.0,2,0,2
MR,BF,2014.0,1,0,1
ET,BD,2022.0,1,0,1
VE,NL,2001.0,1,0,1
CY,TH,1998.0,1,0,1
HR,DK,2001.0,2,0,2
FI,CO,2007.0,2,0,2
CY,RU,2011.0,1,0,1
HR,NO,2006.0,3,0,3
NG,TT,2020.0,1,0,1
DE,RW,2010.0,1,0,1
LK,HR,2009.0,1,0,1
BW,MM,2015.0,1,0,1
IQ,RO,2013.0,1,0,1
PH,AT,2003.0,1,0,1
CA,RE,2021.0,2,0,2
BJ,GN,2019.0,1,0,1
SN,BY,2013.0,1,0,1
BY,EG,2018.0,1,0,1
GE,CZ,2001.0,1,0,1
PT,KR,2004.0,1,0,1
SV,FR,2009.0,1,0,1
DE,RW,2019.0,1,0,1
NC,DE,2016.0,1,0,1
DO,CO,2006.0,1,0,1
AR,HU,2010.0,1,0,1
KR,UZ,2022.0,4,0,4
VN,KW,2022.0,1,0,1
HK,RS,2011.0,1,0,1
LV,UA,2011.0,1,0,1
UZ,MY,1999.0,1,0,1
KW,FR,1997.0,2,0,2
JP,CU,2021.0,1,0,1
SI,TW,2001.0,1,0,1
CY,JP,2013.0,1,0,1
KR,MK,2020.0,1,0,1
LT,AR,2010.0,1,0,1
VE,IL,2007.0,2,0,2
GW,GF,2003.0,1,0,1
PH,CI,2013.0,1,0,1
nan,PH,1998.0,1,0,1
IE,SI,2009.0,1,0,1
IE,RS,2004.0,1,0,1
LI,,2008.0,2,0,2
SR,,2009.0,1,0,1
EG,FI,2009.0,1,0,1
CW,nan,2021.0,1,0,1
KZ,TZ,2019.0,1,0,1
SD,DE,2006.0,2,0,2
EC,FR,1998.0,1,0,1
RO,AU,1997.0,1,0,1
TZ,NA,2001.0,1,0,1
ML,LU,2011.0,1,0,1
SE,LK,2019.0,3,0,3
MW,CH,2001.0,1,0,1
IL,NZ,2012.0,2,0,2
JO,RO,2019.0,1,0,1
CO,JO,2012.0,1,0,1
TZ,AU,1997.0,1,0,1
OM,QA,2004.0,3,0,3
SE,NP,2006.0,1,0,1
FI,KW,2014.0,1,0,1
NZ,KE,2003.0,2,0,2
UZ,LK,2010.0,2,0,2
SD,NL,2012.0,1,0,1
FJ,ZM,2014.0,1,0,1
AL,SE,2021.0,1,0,1
TD,SN,2014.0,1,0,1
PK,PE,2012.0,1,0,1
ER,ET,2020.0,4,0,4
IR,VN,2018.0,4,0,4
NC,NZ,2022.0,1,0,1
LY,QA,2012.0,1,0,1
CM,BR,2018.0,1,0,1
CZ,TW,2013.0,1,0,1
ML,ES,2018.0,1,0,1
SM,,2025.0,3,0,3
SN,GN,2000.0,1,0,1
CG,TG,2022.0,1,0,1
JP,JM,2009.0,2,0,2
BD,FR,2001.0,2,0,2
nan,PR,2018.0,1,0,1
ME,AU,2013.0,1,0,1
BE,BA,2003.0,1,0,1
OM,IN,1997.0,1,0,1
UG,EG,2020.0,1,0,1
ZA,NE,2019.0,1,0,1
CU,NI,2019.0,2,0,2
TZ,AT,2013.0,1,0,1
GN,SN,2002.0,2,0,2
NG,CD,2015.0,1,0,1
AU,IS,2011.0,1,0,1
GP,CA,2013.0,1,0,1
KR,KZ,2015.0,2,0,2
HT,US,2013.0,2,0,2
HR,SG,2011.0,1,0,1
UG,ZA,2007.0,2,0,2
PL,CO,2000.0,1,0,1
BG,LV,2010.0,2,0,2
EG,CZ,1999.0,1,0,1
,LA,1999.0,4,0,4
AF,IR,2010.0,1,0,1
AR,QA,2013.0,1,0,1
AE,AR,2018.0,1,0,1
IN,CG,2019.0,1,0,1
RO,AR,2009.0,1,0,1
GR,CD,2018.0,1,0,1
IT,PE,1999.0,2,0,2
ZW,BH,2014.0,2,0,2
KR,BH,2014.0,1,0,1
FI,GH,2014.0,1,0,1
LT,HU,1997.0,1,0,1
TZ,ES,2017.0,1,0,1
CH,AM,2004.0,1,0,1
RO,CY,2021.0,1,0,1
PG,FR,2016.0,1,0,1
SK,AE,2020.0,1,0,1
YE,IQ,2009.0,2,0,2
CM,ZA,2006.0,1,0,1
BE,CW,2012.0,2,0,2
NL,PG,1998.0,1,0,1
RU,HK,2018.0,1,0,1
NL,VE,1999.0,1,0,1
MG,DE,2020.0,1,3,-2
AE,RU,2018.0,1,3,-2
KZ,CZ,2021.0,1,2,-1
AE,SG,2010.0,1,5,-4
CN,ZM,2002.0,1,2,-1
AU,OM,2015.0,2,3,-1
MZ,RU,2004.0,2,4,-2
AE,SD,2015.0,2,5,-3
CL,DK,2008.0,1,1,0
SZ,ZA,2020.0,1,11,-10
FR,MR,2019.0,4,4,0
TJ,US,2020.0,1,5,-4
US,ER,2014.0,1,1,0
JP,LU,2010.0,2,1,1
IL,CU,2017.0,1,2,-1
KZ,US,2005.0,3,4,-1
PS,FR,2020.0,1,5,-4
ZA,UA,2008.0,1,2,-1
SS,US,2021.0,1,2,-1
MG,BE,2008.0,1,1,0
SK,DK,2007.0,2,3,-1
ZA,OM,1999.0,1,1,0
ZW,SE,2016.0,1,1,0
PT,UA,2019.0,1,6,-5
RS,UZ,2015.0,1,1,0
KW,PK,2012.0,2,4,-2
GR,VN,2004.0,2,3,-1
HR,IL,2017.0,1,2,-1
ES,HR,2016.0,2,3,-1
KZ,TW,2010.0,1,1,0
BW,DE,1999.0,1,1,0
SG,IR,2005.0,1,1,0
IN,BJ,2018.0,1,1,0
EG,BE,2009.0,2,2,0
RS,MY,2020.0,1,1,0
AT,HR,1999.0,1,2,-1
MK,GR,2010.0,1,7,-6
BY,IL,2016.0,3,1,2
EC,AU,2019.0,4,6,-2
KZ,MK,2022.0,1,1,0
UG,MY,2018.0,2,2,0
BY,HU,2007.0,1,1,0
MZ,UA,2002.0,3,3,0
MA,CZ,2019.0,1,1,0
ES,IE,1999.0,5,3,2
NO,BE,2003.0,2,5,-3
NP,US,2000.0,2,10,-8
RU,VE,2008.0,1,1,0
ET,SE,2005.0,2,4,-2
ML,ZW,2016.0,1,1,0
MG,CN,2008.0,1,1,0
BA,IQ,2006.0,1,1,0
NL,SK,2021.0,2,3,-1
DE,SN,2016.0,1,1,0
PS,IQ,2020.0,3,4,-1
MW,GB,1997.0,2,1,1
NG,CH,2006.0,3,1,2
PA,CN,2016.0,1,1,0
UA,TW,2002.0,3,1,2
EG,GR,2022.0,2,1,1
NG,MW,2018.0,2,1,1
BR,GR,2017.0,1,5,-4
BD,NL,2009.0,1,3,-2
KG,RU,2021.0,4,16,-12
BN,TR,2019.0,1,1,0
HR,BE,2006.0,1,1,0
CY,IN,2014.0,1,1,0
IQ,MY,1997.0,1,1,0
SI,IT,1999.0,1,2,-1
ML,SN,2011.0,2,1,1
NZ,EG,2006.0,1,1,0
LA,SE,2013.0,1,1,0
DZ,CH,2015.0,2,1,1
ZM,BE,2000.0,1,1,0
RU,NG,2013.0,1,1,0
MK,JP,2009.0,1,1,0
ES,KZ,2016.0,1,1,0
MM,nan,2020.0,1,2,-1
ID,GB,2001.0,1,4,-3
DE,EG,2023.0,1,4,-3
NO,JO,2017.0,1,1,0
ET,MY,2011.0,1,2,-1
SS,GB,2022.0,1,4,-3
CH,ZW,2013.0,1,1,0
TR,AL,2014.0,1,1,0
NZ,QA,2021.0,3,2,1
TW,SI,2007.0,1,2,-1
SK,MK,2021.0,2,3,-1
HR,CZ,2004.0,2,1,1
CL,RU,1999.0,1,2,-1
EE,IN,2014.0,1,2,-1
BD,CL,2014.0,1,1,0
BR,AG,2016.0,1,2,-1
AZ,DE,2010.0,1,1,0
KH,PK,2019.0,1,2,-1
FI,LB,2020.0,1,1,0
IQ,BD,2016.0,1,4,-3
CH,MA,2008.0,2,1,1
CR,ZA,2013.0,2,7,-5
GE,CN,2009.0,1,4,-3
NO,TW,2011.0,1,1,0
PL,IS,2018.0,1,2,-1
IS,NL,2018.0,1,3,-2
GB,MC,2018.0,2,1,1
AF,IR,2019.0,2,11,-9
NO,BG,2018.0,1,7,-6
SN,CI,2009.0,1,2,-1
JP,BF,2021.0,1,1,0
AR,IR,2019.0,1,1,0
NL,HR,2008.0,1,2,-1
PE,JP,2022.0,1,1,0
IR,TW,2005.0,1,2,-1
PT,AT,2008.0,1,2,-1
VN,SE,2015.0,1,5,-4
MD,PK,2020.0,1,2,-1
PK,IN,2023.0,2,25,-23
PA,BR,2012.0,1,4,-3
EE,TR,2017.0,1,2,-1
LY,IR,2016.0,1,1,0
SE,VN,2007.0,1,2,-1
PH,TH,2013.0,2,5,-3
RU,SA,2022.0,2,4,-2
ZM,JP,2017.0,1,3,-2
NP,PK,2010.0,2,1,1
JO,SD,2017.0,2,2,0
ID,AE,2017.0,1,5,-4
GB,CU,2009.0,1,5,-4
UA,VN,2022.0,1,7,-6
SD,FI,2020.0,1,1,0
GB,SY,2002.0,1,2,-1
NO,GR,2001.0,1,1,0
MT,FR,2012.0,1,1,0
BE,RE,2009.0,1,1,0
MG,IT,2017.0,1,1,0
CO,PL,2011.0,1,1,0
DE,HK,2008.0,1,1,0
CH,MW,2021.0,1,1,0
EG,IS,2006.0,1,1,0
CG,MX,2009.0,1,1,0
BG,LV,2017.0,1,1,0
NE,SN,2016.0,1,3,-2
SN,MA,2012.0,1,3,-2
BE,PG,2020.0,1,1,0
UG,DE,2008.0,2,3,-1
KE,MA,2011.0,1,1,0
GD,IN,2021.0,1,1,0
IT,SA,2006.0,1,1,0
BH,GH,2007.0,1,1,0
NA,UG,2015.0,1,1,0
JP,PT,1998.0,1,2,-1
IN,AR,2015.0,3,3,0
CA,PL,2023.0,1,1,0
CG,BE,2014.0,1,1,0
FR,GH,2015.0,1,2,-1
GB,MZ,2001.0,1,1,0
PL,TR,2000.0,1,1,0
CU,CA,2022.0,2,1,1
KH,PK,2017.0,1,1,0
TG,MA,2018.0,1,2,-1
SY,JO,2011.0,1,2,-1
ZM,JP,2010.0,1,2,-1
BG,LV,2019.0,1,1,0
GE,SE,2018.0,1,0,1
PK,NZ,2008.0,2,0,2
AR,PL,2014.0,3,0,3
CN,FJ,2018.0,1,0,1
UZ,DE,2022.0,1,0,1
AR,MT,2010.0,1,0,1
PT,UG,2020.0,1,0,1
IE,PH,2013.0,1,0,1
MA,AU,2004.0,1,0,1
PE,SG,2016.0,1,0,1
UG,MZ,2012.0,2,0,2
DO,ZA,2022.0,2,0,2
JO,KW,2008.0,1,0,1
PT,IL,2005.0,1,0,1
SK,IL,2015.0,1,0,1
JP,MR,2018.0,1,0,1
NO,VE,2020.0,1,0,1
SG,BD,2006.0,3,0,3
DK,HU,2004.0,1,0,1
LY,JP,2012.0,1,0,1
CO,PH,2000.0,1,0,1
CL,HR,2001.0,1,0,1
FO,,2009.0,1,0,1
ZA,IL,1998.0,2,0,2
IE,KN,2022.0,1,0,1
FR,MT,2015.0,1,0,1
IN,RS,2022.0,1,0,1
CM,BD,2020.0,1,0,1
FK,US,2021.0,1,0,1
KE,PE,2018.0,3,0,3
LB,CH,2010.0,2,0,2
TT,IE,2016.0,2,0,2
SE,GL,2004.0,1,0,1
AT,CU,2022.0,1,0,1
BF,CM,2017.0,2,0,2
UY,FI,2005.0,1,0,1
CL,KN,2021.0,1,0,1
CD,EC,2014.0,1,0,1
GP,BJ,2015.0,1,0,1
BY,HR,2019.0,1,0,1
SK,SA,2008.0,1,0,1
UZ,KG,1998.0,1,0,1
CO,DO,2002.0,1,0,1
JO,KE,2021.0,1,0,1
AT,BA,2008.0,1,0,1
VN,MK,2022.0,2,0,2
JP,MZ,2007.0,1,0,1
CI,ID,2016.0,1,0,1
BN,TW,2012.0,1,0,1
HU,TW,2006.0,1,0,1
PY,US,2002.0,1,0,1
JP,KZ,2007.0,1,0,1
ID,ET,2005.0,1,0,1
NP,TW,2015.0,1,0,1
GD,FR,2016.0,1,0,1
CH,CG,2013.0,1,0,1
ES,BG,2022.0,1,0,1
KE,SD,2005.0,2,0,2
GE,TJ,2000.0,1,0,1
CR,FI,2006.0,1,0,1
NG,GM,2015.0,2,0,2
GR,SI,2021.0,1,0,1
CU,HU,2022.0,5,0,5
ER,,2003.0,1,0,1
CY,PL,2022.0,1,0,1
BH,JP,2017.0,1,0,1
NP,QA,2015.0,1,0,1
GR,MA,2017.0,1,0,1
DK,ZW,2022.0,1,0,1
MW,CA,1997.0,1,0,1
BI,DE,2014.0,2,0,2
BA,KZ,2017.0,1,0,1
CZ,KR,2023.0,1,0,1
TG,,2001.0,1,0,1
NP,SI,2019.0,1,0,1
MQ,BF,2016.0,1,0,1
BE,BO,2020.0,1,0,1
FR,ZW,2018.0,2,0,2
NP,CH,2008.0,1,0,1
SA,ID,1997.0,1,0,1
PY,IT,2016.0,2,0,2
TN,BJ,2008.0,1,0,1
MN,IE,2015.0,1,0,1
IT,GP,2014.0,1,0,1
GL,BR,2006.0,1,0,1
RU,IS,2009.0,1,0,1
MW,JP,2013.0,1,0,1
SE,MK,2019.0,1,0,1
MY,LT,2021.0,1,0,1
BD,KE,2008.0,1,0,1
NL,DO,2004.0,1,0,1
BY,NZ,2019.0,1,0,1
MX,AO,2011.0,1,0,1
IE,GM,2010.0,1,0,1
NO,LV,2022.0,1,0,1
PF,BE,2009.0,1,0,1
CO,AO,2017.0,1,0,1
SE,CM,2016.0,2,0,2
MD,TR,2006.0,2,0,2
SG,PA,2011.0,1,0,1
CZ,AU,1997.0,1,0,1
FR,BJ,1997.0,1,0,1
ET,FR,2002.0,2,0,2
PH,CU,2008.0,1,0,1
HR,MK,2010.0,1,0,1
UZ,GB,1998.0,1,0,1
GE,LT,2017.0,1,0,1
MY,LK,2001.0,1,0,1
PH,AR,2005.0,1,0,1
MY,LA,2010.0,1,0,1
KE,PG,1999.0,1,0,1
JO,CH,2013.0,1,0,1
UY,ZA,2006.0,1,0,1
PK,LK,2008.0,1,0,1
CY,RO,2009.0,1,0,1
DK,MT,2011.0,1,0,1
TR,HR,2019.0,1,0,1
TR,KG,2010.0,2,0,2
UG,AT,2015.0,1,0,1
LB,DK,2011.0,1,0,1
MZ,UA,2005.0,2,0,2
SI,MY,2001.0,1,0,1
ML,NE,2017.0,1,0,1
FJ,US,2022.0,1,0,1
SE,BF,2011.0,1,0,1
CA,PR,2022.0,1,0,1
MU,JE,2003.0,1,0,1
GB,SZ,2017.0,1,0,1
SY,SS,2008.0,1,0,1
TR,HU,1999.0,1,0,1
ET,nan,2007.0,1,0,1
SG,BH,1998.0,1,0,1
DE,KG,2006.0,1,0,1
EG,IE,2023.0,1,0,1
GB,AL,2009.0,1,0,1
ID,NP,2022.0,1,0,1
AR,TR,2004.0,1,0,1
AR,IR,2010.0,1,0,1
,SR,2007.0,1,0,1
EC,GR,2016.0,2,0,2
RE,PF,2017.0,1,0,1
CU,HN,1998.0,1,0,1
GE,CA,2022.0,1,0,1
LK,ET,2018.0,1,0,1
EE,TR,2010.0,1,0,1
AR,SI,2022.0,1,0,1
GL,QA,1999.0,1,0,1
NZ,MM,2012.0,1,0,1
IQ,ID,2007.0,1,0,1
EE,NL,2023.0,1,0,1
UG,ZW,2012.0,1,0,1
PT,PK,2020.0,1,0,1
IE,TT,2020.0,1,0,1
NI,BE,2017.0,1,0,1
EG,HR,2021.0,1,0,1
GM,IT,2012.0,1,0,1
FI,MK,2018.0,1,0,1
GH,IR,2010.0,1,0,1
UZ,GR,2012.0,1,0,1
AR,ID,1998.0,1,0,1
NG,DZ,2021.0,1,0,1
IS,MZ,2008.0,1,0,1
VG,DZ,2012.0,1,0,1
RW,DE,2022.0,1,0,1
GR,IQ,2011.0,1,0,1
FI,BW,2016.0,1,0,1
CL,AO,2001.0,1,0,1
RO,AU,1998.0,1,0,1
TW,NG,2005.0,1,0,1
JM,CA,2007.0,1,0,1
GE,MX,2021.0,1,0,1
AU,MN,2014.0,1,0,1
DE,NI,2013.0,1,0,1
SY,LB,2015.0,1,0,1
AU,RE,2009.0,1,0,1
GT,PH,2013.0,1,0,1
BH,QA,2013.0,1,0,1
PT,GE,2012.0,1,0,1
SE,LB,2017.0,1,0,1
VN,SI,2020.0,1,0,1
GT,DO,2002.0,1,0,1
UA,EE,2023.0,1,0,1
AT,PK,2005.0,1,0,1
TZ,MW,2014.0,1,0,1
LB,TN,2008.0,1,0,1
TN,LB,2011.0,1,0,1
HU,nan,2007.0,1,0,1
LK,CZ,2012.0,1,0,1
LU,MX,2014.0,1,0,1
ES,SY,2020.0,1,0,1
ID,SY,2012.0,1,0,1
MW,PK,2017.0,1,0,1
,BM,2005.0,1,0,1
PG,ES,2017.0,1,0,1
nan,EG,2002.0,1,0,1
JM,CU,2002.0,1,0,1
IT,GA,2020.0,1,0,1
TZ,BW,2004.0,1,0,1
UG,NA,2009.0,1,0,1
AF,FR,2023.0,1,0,1
NZ,GR,2018.0,1,0,1
MQ,CH,2010.0,1,0,1
NZ,ZM,2021.0,1,0,1
BT,CM,2022.0,1,0,1
MX,IS,2015.0,1,0,1
GR,MA,2019.0,1,0,1
NZ,BD,2000.0,1,0,1
MM,NO,2019.0,1,0,1
FI,BD,2008.0,1,0,1
IN,JE,2022.0,1,0,1
VE,SG,2014.0,1,0,1
MM,NO,2017.0,1,0,1
ID,TW,2023.0,2,0,2
BD,nan,2003.0,1,0,1
LK,PK,2003.0,1,0,1
IN,YE,1998.0,1,0,1
HT,CA,2017.0,1,0,1
CD,ZW,2022.0,1,0,1
OM,JP,2017.0,1,0,1
MC,NO,2021.0,1,0,1
,BI,2020.0,1,0,1
PS,TN,2021.0,1,0,1
PG,ES,2019.0,1,0,1
SD,CO,2013.0,1,0,1
JP,TG,2018.0,1,0,1
AU,KP,2017.0,1,0,1
AT,LB,2004.0,1,0,1
PE,FR,2013.0,10,13,-3
KR,MY,2012.0,22,14,8
US,CA,2015.0,3181,3662,-481
US,IN,2009.0,1579,1678,-99
US,CN,1997.0,1045,751,294
FR,BE,2016.0,360,367,-7
CL,PE,2015.0,58,72,-14
KR,JP,2014.0,340,424,-84
nan,DE,2021.0,66,56,10
IT,GB,2001.0,241,199,42
US,DE,2003.0,1735,1903,-168
NO,SE,2006.0,31,86,-55
CA,MY,2022.0,10,20,-10
CN,TW,2017.0,805,1481,-676
IN,US,2014.0,2108,2681,-573
RO,HK,2011.0,12,23,-11
MX,US,2022.0,260,165,95
GB,CN,2011.0,571,434,137
US,CN,1998.0,1214,1252,-38
FR,BR,2000.0,55,45,10
CN,TW,2010.0,913,1207,-294
HU,BE,2005.0,6,7,-1
NZ,US,2005.0,222,253,-31
US,IL,2013.0,503,495,8
GB,IN,2011.0,395,351,44
CA,CN,2017.0,639,482,157
DE,CH,2013.0,977,711,266
TW,US,2022.0,403,367,36
CA,CN,2019.0,636,527,109
DE,GB,2018.0,1003,993,10
IE,FR,2005.0,21,25,-4
US,FR,2017.0,1442,1600,-158
MX,ES,2008.0,487,435,52
CO,AR,2011.0,70,69,1
NL,NZ,2005.0,13,9,4
LT,JP,2005.0,13,8,5
CA,IE,2014.0,163,151,12
GB,ZA,2000.0,54,42,12
US,ZA,1999.0,140,123,17
IN,NP,2010.0,34,60,-26
LK,US,2003.0,7,9,-2
CN,TW,2019.0,837,1628,-791
BG,DE,2020.0,18,15,3
US,PL,2022.0,127,126,1
CN,DE,1999.0,67,73,-6
GB,DE,2019.0,1080,995,85
CA,US,2004.0,2222,2271,-49
GB,DE,2017.0,953,964,-11
US,CH,2014.0,910,820,90
DE,NL,2015.0,356,400,-44
BR,CO,2020.0,193,163,30
MX,BR,1999.0,20,17,3
FR,DK,1999.0,20,18,2
US,DK,2015.0,282,290,-8
ES,GB,2001.0,132,136,-4
AU,FR,2014.0,149,141,8
IT,JP,2014.0,60,75,-15
TR,KZ,2022.0,76,30,46
MX,PE,2021.0,113,73,40
KR,IN,2004.0,52,52,0
SG,CN,2018.0,564,432,132
JP,SG,2008.0,45,24,21
US,TW,2015.0,731,742,-11
CH,AT,2008.0,78,81,-3
DE,IL,2006.0,29,34,-5
MX,FR,2016.0,53,58,-5
HU,US,1997.0,71,65,6
GB,IT,2015.0,503,707,-204
GB,BR,2014.0,191,175,16
KR,ET,2005.0,96,85,11
GE,US,2021.0,157,99,58
FI,US,2019.0,174,160,14
DK,SE,2017.0,142,128,14
IE,GB,2013.0,396,323,73
US,KR,2001.0,596,551,45
IL,US,2012.0,514,461,53
DE,FI,2005.0,40,21,19
FR,DZ,2006.0,62,37,25
AE,US,2023.0,3,5,-2
US,FR,2019.0,1424,1593,-169
JO,EG,2009.0,5,5,0
CA,FR,2008.0,425,499,-74
US,SA,2009.0,107,50,57
SE,GB,2003.0,113,99,14
KR,ET,2002.0,55,76,-21
MX,AU,2011.0,10,10,0
BR,AU,2020.0,164,131,33
BR,CL,2016.0,102,111,-9
CA,CN,2010.0,482,387,95
IN,NP,2017.0,167,124,43
JP,ID,2016.0,226,78,148
EG,US,2003.0,55,94,-39
NL,DE,2013.0,352,363,-11
US,SE,2022.0,244,225,19
CA,NZ,2002.0,23,33,-10
ET,KR,2014.0,146,104,42
nan,US,2016.0,244,294,-50
CY,GB,2015.0,36,40,-4
JP,DE,2018.0,215,239,-24
SE,CH,2014.0,63,60,3
FR,MA,2008.0,234,268,-34
CO,MX,2022.0,117,154,-37
BG,GB,2011.0,14,11,3
BR,NO,2023.0,4,1,3
CH,ZA,2015.0,14,24,-10
TW,JP,2004.0,40,59,-19
JP,IN,2012.0,118,118,0
CA,BR,2007.0,178,186,-8
CZ,GB,2001.0,15,11,4
LT,RU,2007.0,6,13,-7
AU,ES,2012.0,34,51,-17
UY,ES,2013.0,56,40,16
IT,GR,2016.0,35,31,4
SE,ES,2020.0,72,94,-22
ES,NL,2012.0,84,106,-22
DE,CA,2012.0,260,266,-6
BE,CH,2009.0,64,47,17
SG,TR,2008.0,3,2,1
UZ,CN,2021.0,11,8,3
NZ,US,2002.0,183,209,-26
CO,EC,2020.0,166,129,37
AU,MY,2018.0,125,151,-26
CN,QA,2016.0,15,10,5
AU,AT,2020.0,35,33,2
CH,RU,2013.0,30,27,3
AR,BR,2021.0,124,130,-6
DK,SE,2019.0,141,154,-13
CA,GE,2002.0,2,2,0
AU,ZA,2012.0,70,74,-4
ZA,BR,1998.0,2,1,1
IQ,SE,2013.0,2,4,-2
CN,JP,2012.0,455,598,-143
CL,CU,2021.0,13,27,-14
PL,CA,2002.0,10,9,1
TW,SG,2011.0,46,42,4
nan,CN,2000.0,13,13,0
SG,BR,2019.0,4,3,1
NZ,GB,2003.0,139,175,-36
DE,BG,2007.0,21,23,-2
CU,MX,2013.0,64,46,18
US,TH,1999.0,49,29,20
US,KW,1999.0,8,13,-5
IR,SG,2017.0,39,33,6
IR,US,2005.0,60,71,-11
SY,IN,2017.0,3,2,1
NP,NZ,2020.0,65,65,0
TN,MX,2011.0,4,1,3
MX,AR,2016.0,170,144,26
TR,DE,2014.0,65,97,-32
AU,NL,2018.0,126,120,6
AT,DE,2004.0,301,343,-42
CL,AR,2008.0,53,48,5
GB,CO,2011.0,17,16,1
CN,BE,2008.0,36,51,-15
IN,NP,2019.0,154,201,-47
RE,FR,2013.0,42,40,2
RU,PL,2018.0,36,44,-8
FI,US,2017.0,164,124,40
CN,NO,2014.0,42,37,5
GR,CN,2014.0,23,14,9
SK,CN,2014.0,1,4,-3
CN,CZ,2011.0,56,51,5
BG,CN,2012.0,15,18,-3
CN,PH,2017.0,17,33,-16
IT,CN,2013.0,49,29,20
CR,US,2021.0,36,26,10
AT,GB,2021.0,80,122,-42
IN,CN,1999.0,17,15,2
NP,CN,2011.0,10,30,-20
NZ,ZA,2016.0,8,13,-5
GB,EG,2021.0,107,119,-12
KH,CN,2011.0,2,1,1
HK,CN,2014.0,121,120,1
LU,US,2016.0,24,28,-4
CA,IN,2001.0,101,80,21
CN,VN,2008.0,30,32,-2
DK,CN,2014.0,45,32,13
CA,CH,2021.0,108,90,18
BE,NO,2000.0,8,1,7
IN,FR,2021.0,111,109,2
JP,CH,2011.0,99,67,32
LV,GB,2011.0,4,2,2
HU,ES,2010.0,8,3,5
MA,DE,2019.0,5,11,-6
FR,AU,2004.0,52,42,10
BR,BE,2016.0,55,95,-40
FR,nan,2020.0,137,161,-24
AR,UY,2016.0,33,40,-7
FR,CH,2013.0,452,325,127
NE,FR,2013.0,4,14,-10
SA,YE,2022.0,20,17,3
XK,CZ,2020.0,2,3,-1
ES,JP,2021.0,22,30,-8
DE,FI,2002.0,23,26,-3
AU,NG,2018.0,18,8,10
VE,ES,2001.0,43,33,10
PK,AU,2019.0,69,49,20
PT,AR,2013.0,12,12,0
NO,US,2005.0,91,101,-10
BJ,FR,2003.0,8,5,3
IL,DE,2015.0,55,58,-3
KZ,AU,2020.0,2,3,-1
AU,LK,2022.0,19,33,-14
DK,ES,2017.0,35,54,-19
CA,IR,2022.0,96,245,-149
HU,BR,2006.0,1,4,-3
RU,JP,2003.0,39,51,-12
FR,MQ,2004.0,4,6,-2
US,BE,2014.0,399,387,12
ZA,FR,2002.0,13,8,5
HU,CA,2011.0,12,12,0
IR,AZ,2019.0,2,3,-1
GB,AR,2004.0,13,24,-11
MY,SI,2019.0,1,8,-7
KR,FR,2011.0,40,32,8
DK,FR,2003.0,20,20,0
AT,IR,2022.0,10,12,-2
RU,GR,2009.0,3,1,2
PK,SE,2012.0,9,13,-4
IT,ES,2022.0,183,180,3
nan,GE,2017.0,2,4,-2
CN,RU,1998.0,4,9,-5
CO,GB,2007.0,24,23,1
ES,EG,2021.0,12,7,5
DE,ID,2013.0,29,9,20
SE,nan,2005.0,36,51,-15
JP,EG,1999.0,20,9,11
BE,IT,2018.0,118,183,-65
RU,ES,2021.0,21,18,3
nan,MY,2015.0,90,53,37
IT,AU,2016.0,84,59,25
FR,IQ,2013.0,2,1,1
TR,PL,2017.0,8,3,5
IN,TW,2002.0,38,10,28
DK,TR,2000.0,1,1,0
UA,DE,2018.0,40,29,11
US,UG,2013.0,29,26,3
XK,RS,2016.0,8,18,-10
HN,MX,2015.0,25,26,-1
PL,GB,2009.0,77,51,26
NL,FR,1999.0,108,82,26
DE,BR,2021.0,162,210,-48
RU,nan,2011.0,39,65,-26
JP,MY,2007.0,20,21,-1
GB,GR,2008.0,206,116,90
BG,CA,2017.0,3,2,1
CZ,SK,2020.0,146,150,-4
IN,EG,2016.0,14,19,-5
MY,BD,2013.0,36,59,-23
NO,DK,2016.0,102,107,-5
nan,NZ,2015.0,9,1,8
nan,GE,2010.0,9,6,3
CN,PH,2010.0,23,21,2
EG,AE,2011.0,13,16,-3
NZ,CN,2008.0,26,15,11
ZA,GB,2000.0,42,54,-12
DE,ZA,2002.0,24,14,10
nan,GE,2019.0,6,3,3
ID,NL,2014.0,20,30,-10
GB,IS,2020.0,10,7,3
BD,CN,2018.0,77,40,37
SV,US,2015.0,4,5,-1
SA,QA,2020.0,50,17,33
NL,AE,2020.0,10,3,7
NL,HR,2007.0,5,2,3
JP,KE,2021.0,4,3,1
IN,TH,2011.0,12,3,9
ZA,ZM,2019.0,14,7,7
DK,GL,2021.0,9,4,5
HR,AT,2019.0,11,14,-3
PE,CO,2012.0,43,57,-14
US,PS,2018.0,16,4,12
NL,HK,2007.0,17,11,6
NP,AU,2017.0,10,14,-4
BG,JP,2002.0,7,4,3
ES,DE,2022.0,158,163,-5
SE,AR,2007.0,5,7,-2
ID,EG,2022.0,14,49,-35
AT,AU,2022.0,14,19,-5
DE,UA,2019.0,31,43,-12
ES,IT,2009.0,130,225,-95
BH,US,2008.0,11,9,2
BH,NG,2020.0,5,5,0
CM,DE,2009.0,4,1,3
ST,BR,2019.0,30,23,7
UA,NI,2021.0,15,23,-8
PK,NG,2016.0,11,8,3
ES,CU,2021.0,46,73,-27
SG,CA,2018.0,58,65,-7
SA,SE,2020.0,4,10,-6
GR,CY,2021.0,51,38,13
JP,TR,2021.0,53,55,-2
UA,EG,2021.0,2,1,1
SE,FI,2004.0,52,51,1
FR,TN,2021.0,105,100,5
TW,KR,2020.0,53,51,2
HU,ES,2019.0,7,8,-1
DE,GR,1999.0,27,15,12
PH,AU,2019.0,19,20,-1
nan,ID,2015.0,53,11,42
RU,BE,2011.0,15,16,-1
MY,IT,2014.0,43,61,-18
ES,SE,2022.0,58,40,18
SE,BR,2018.0,28,38,-10
DE,AE,2019.0,14,10,4
CN,SY,2021.0,12,11,1
BY,CZ,2021.0,21,9,12
IN,NL,2021.0,69,49,20
SD,US,2013.0,6,11,-5
GD,US,2021.0,17,12,5
ST,BR,2017.0,26,16,10
ID,CA,2022.0,15,21,-6
DE,IN,2005.0,87,106,-19
KR,CH,2018.0,21,11,10
UY,GB,2018.0,6,9,-3
US,NL,2020.0,905,822,83
DK,ES,2010.0,17,26,-9
AR,ES,2001.0,129,92,37
CZ,IT,2017.0,30,34,-4
JP,FI,2020.0,17,21,-4
BR,PY,2022.0,11,4,7
BR,DE,2022.0,166,90,76
AE,CN,2020.0,20,17,3
FR,SE,2008.0,50,73,-23
AU,HU,2018.0,14,4,10
MD,FR,2018.0,41,35,6
US,GR,2000.0,114,80,34
CA,SA,2000.0,16,6,10
CN,SE,2016.0,109,91,18
JP,IE,2013.0,15,35,-20
CO,PE,2002.0,8,16,-8
DE,UA,2017.0,25,44,-19
VN,NO,2020.0,3,4,-1
BE,IR,2018.0,27,27,0
BE,PL,2017.0,18,15,3
UG,US,2011.0,19,24,-5
CZ,CA,2009.0,9,7,2
NL,RO,2014.0,10,19,-9
HR,AT,2010.0,4,8,-4
PL,UA,2014.0,18,21,-3
CA,GR,2015.0,10,13,-3
CA,BE,1999.0,25,12,13
HU,GR,2011.0,3,2,1
SE,nan,2002.0,47,52,-5
NL,CW,2009.0,19,14,5
IT,TR,2016.0,20,14,6
IL,nan,2012.0,15,24,-9
DE,PH,2016.0,9,12,-3
NG,AU,1997.0,4,2,2
GB,NL,1999.0,124,135,-11
IR,SG,2019.0,47,51,-4
BE,GR,1999.0,5,3,2
NL,NZ,2002.0,5,3,2
DK,ES,2019.0,48,50,-2
FI,CA,2008.0,26,12,14
SG,IE,2019.0,6,7,-1
VE,IT,2008.0,6,3,3
DE,HU,2007.0,45,43,2
IN,CA,1999.0,48,80,-32
GF,FR,2002.0,4,9,-5
IN,OM,2017.0,34,13,21
IT,CH,2023.0,12,8,4
SE,ID,2016.0,12,3,9
CU,UY,2012.0,4,2,2
FR,RU,2008.0,53,71,-18
CA,IT,2001.0,54,64,-10
NP,AU,2019.0,22,18,4
NL,NO,2021.0,33,27,6
DE,IN,2002.0,77,88,-11
CR,EC,2021.0,12,12,0
DE,RO,2018.0,49,28,21
SI,RS,2021.0,9,17,-8
ID,PA,2013.0,2,1,1
CZ,IT,2010.0,15,25,-10
JO,KW,2007.0,2,2,0
nan,AU,2013.0,44,26,18
GT,ES,2011.0,8,5,3
IS,SE,2014.0,26,17,9
FI,NL,2016.0,35,34,1
SE,ET,2019.0,5,9,-4
AU,IR,2013.0,44,103,-59
CR,MX,2007.0,21,10,11
US,CU,2007.0,23,21,2
LK,GB,2005.0,11,9,2
NZ,IN,2020.0,31,42,-11
DK,NO,2013.0,71,93,-22
CH,AU,2008.0,57,66,-9
IR,SG,2010.0,24,4,20
MA,DZ,2015.0,19,15,4
RU,ET,2018.0,6,4,2
PE,CL,2016.0,73,58,15
RU,IL,2014.0,25,41,-16
PA,AU,2019.0,3,3,0
CA,IL,2008.0,30,56,-26
MA,IT,2008.0,7,11,-4
EG,CH,2013.0,6,7,-1
TR,CA,2014.0,18,33,-15
FR,SG,2012.0,29,16,13
CL,EC,2020.0,89,75,14
NL,PT,2013.0,25,25,0
JP,TN,2019.0,2,4,-2
BD,MA,2016.0,22,4,18
ID,SA,2013.0,6,8,-2
TW,DE,2023.0,3,2,1
KR,PR,2009.0,22,41,-19
GR,JP,2006.0,31,33,-2
KZ,UZ,2018.0,7,11,-4
NL,TH,2016.0,11,7,4
PH,AU,2010.0,16,14,2
SA,MX,2022.0,2,2,0
EE,US,2018.0,14,20,-6
IT,IL,2004.0,7,8,-1
HN,GB,2019.0,1,1,0
JP,MX,2009.0,6,11,-5
FR,MX,2012.0,55,39,16
KW,ID,2021.0,4,2,2
CZ,IT,2019.0,30,43,-13
UY,MX,2013.0,8,16,-8
PK,TR,2016.0,26,18,8
MY,EG,2020.0,40,47,-7
US,ZM,2014.0,17,23,-6
HU,BE,2002.0,12,5,7
PT,SK,2015.0,2,1,1
GB,GM,2019.0,28,6,22
AM,IT,2007.0,14,18,-4
RS,XK,2016.0,18,8,10
SI,DK,2018.0,5,2,3
GR,FR,2007.0,19,25,-6
GB,GE,2003.0,6,5,1
CA,PA,2019.0,6,9,-3
nan,SE,2016.0,78,30,48
KE,CA,2000.0,2,1,1
IN,RO,2022.0,5,3,2
PK,FI,2017.0,4,8,-4
CA,NO,2013.0,24,26,-2
YE,GB,2008.0,1,1,0
TH,FR,2012.0,12,22,-10
DE,AE,2017.0,7,11,-4
FR,EG,2018.0,47,21,26
BR,SG,2013.0,2,3,-1
CG,FR,1999.0,4,7,-3
CL,IN,2022.0,3,4,-1
NL,BD,2021.0,3,2,1
CN,KE,2012.0,5,6,-1
NL,SA,2016.0,10,1,9
NO,ES,2013.0,17,30,-13
GL,AU,2018.0,1,1,0
nan,NO,2006.0,23,15,8
CA,QA,2019.0,23,12,11
TN,ES,2018.0,8,11,-3
PT,PE,2013.0,7,4,3
RU,DK,2011.0,9,6,3
OM,CY,2019.0,2,1,1
UA,ES,2011.0,3,2,1
SY,DE,2018.0,1,2,-1
AT,NL,2021.0,34,20,14
SA,OM,2012.0,11,6,5
SE,IS,2016.0,20,13,7
NP,NL,2007.0,1,1,0
NL,FI,2018.0,27,30,-3
CU,US,2022.0,26,14,12
IN,KW,2015.0,10,12,-2
MD,US,2018.0,9,10,-1
PK,AU,2017.0,38,43,-5
CA,BH,2020.0,5,2,3
PE,NG,2019.0,1,1,0
US,LB,2022.0,29,88,-59
FR,AR,2004.0,19,22,-3
CN,FI,2012.0,24,17,7
BG,CA,2010.0,4,1,3
TZ,JP,2015.0,2,8,-6
US,AE,2005.0,23,13,10
IR,IT,2003.0,4,2,2
RU,IR,2017.0,13,8,5
TW,VN,2011.0,9,11,-2
FR,TH,2008.0,13,6,7
AR,CU,2011.0,12,14,-2
PE,CU,2007.0,2,3,-1
MA,ES,2017.0,8,14,-6
HR,PL,2020.0,5,3,2
CU,PT,2021.0,4,1,3
ZW,BW,2012.0,4,1,3
CN,BO,2008.0,7,3,4
JP,KH,2020.0,10,7,3
HU,CH,2004.0,12,6,6
KE,CN,2020.0,16,15,1
AG,TR,2023.0,8,18,-10
US,SK,2000.0,30,22,8
AU,KW,2021.0,1,3,-2
SE,BE,2003.0,13,10,3
IT,RS,2007.0,6,4,2
SK,DK,2008.0,6,2,4
AE,PK,2014.0,11,18,-7
TR,SE,2020.0,17,23,-6
KR,QA,2018.0,6,7,-1
EG,SD,2008.0,5,9,-4
PT,PL,2010.0,4,4,0
AU,IE,1997.0,13,20,-7
IT,NL,2005.0,70,46,24
RU,MX,2016.0,10,7,3
ZW,RU,2013.0,15,12,3
BE,CN,2005.0,47,25,22
GH,ZM,2014.0,18,34,-16
DZ,US,2012.0,24,19,5
RS,SI,2014.0,25,21,4
DE,IS,2009.0,3,5,-2
IL,ES,2005.0,11,8,3
nan,ZA,2003.0,7,2,5
AT,UA,2016.0,5,5,0
BA,RS,2009.0,8,16,-8
PA,US,1998.0,11,11,0
IR,US,2002.0,28,27,1
BE,SK,2001.0,2,2,0
IN,NZ,2004.0,10,8,2
RU,IR,2019.0,9,19,-10
GB,GM,2017.0,35,10,25
ST,BR,2010.0,34,26,8
BE,PL,2019.0,17,18,-1
GH,GB,2003.0,2,3,-1
RS,AU,2000.0,2,2,0
FI,IL,2022.0,5,1,4
FR,HU,2003.0,11,29,-18
MY,NZ,2006.0,2,2,0
TR,JP,2014.0,18,19,-1
VG,US,2012.0,17,9,8
NG,BR,2015.0,12,6,6
SG,ID,2007.0,4,2,2
HU,ES,2017.0,8,8,0
SN,FR,2006.0,20,23,-3
UA,CZ,2014.0,22,20,2
RS,DE,1998.0,6,2,4
MX,DE,2003.0,19,19,0
ES,LU,2016.0,8,4,4
HK,US,2005.0,4,3,1
PH,AU,2017.0,21,14,7
CA,NZ,2005.0,38,39,-1
SD,KR,2020.0,17,14,3
CZ,GR,2010.0,8,2,6
RW,ZA,2019.0,6,12,-6
AE,DZ,2015.0,1,5,-4
TN,MA,2015.0,26,55,-29
DE,ZA,2005.0,35,23,12
MY,YE,2015.0,13,3,10
NO,IT,1999.0,9,12,-3
ET,BE,2014.0,3,12,-9
AU,IE,1998.0,34,21,13
US,EC,2003.0,6,6,0
US,NC,2016.0,4,4,0
KW,IN,2019.0,12,17,-5
BG,CA,2019.0,6,2,4
PT,SE,2013.0,13,5,8
RU,IR,2010.0,10,1,9
CA,NP,2022.0,4,1,3
LK,AU,2012.0,18,9,9
BE,BR,2000.0,15,12,3
FI,AR,2002.0,2,1,1
SY,IN,2010.0,2,2,0
TW,SI,2008.0,3,1,2
MA,CH,2004.0,1,1,0
TN,PK,2018.0,3,2,1
TN,IT,2015.0,17,22,-5
FI,TH,2004.0,1,2,-1
BE,TN,2020.0,8,8,0
PY,CL,2018.0,6,10,-4
IT,TW,1998.0,4,1,3
CZ,IN,2019.0,15,23,-8
ES,NZ,2016.0,13,6,7
BE,IE,2014.0,9,18,-9
JP,GR,2006.0,33,31,2
IE,RU,2014.0,11,2,9
BR,CH,2022.0,50,30,20
GB,BD,2001.0,20,12,8
IN,PK,2008.0,77,65,12
CA,NG,2016.0,13,8,5
TW,FR,2008.0,13,19,-6
CZ,IN,2017.0,17,24,-7
IT,NZ,2022.0,9,1,8
CR,ES,2004.0,20,14,6
LK,JP,1998.0,7,11,-4
MD,BE,2014.0,3,3,0
ZA,CH,2015.0,24,14,10
US,HR,2005.0,21,23,-2
CZ,nan,2005.0,6,3,3
KR,NP,2014.0,7,6,1
GE,DE,2013.0,3,3,0
CM,US,2015.0,18,15,3
FR,SK,2008.0,8,5,3
TL,BR,2022.0,2,1,1
DZ,MA,2009.0,9,2,7
AT,SK,1999.0,4,11,-7
US,VN,1997.0,2,1,1
BD,NP,2016.0,8,4,4
TR,CZ,2006.0,4,1,3
CN,UZ,2007.0,10,12,-2
US,MM,2002.0,2,2,0
LB,FR,1998.0,2,3,-1
CO,CN,2001.0,2,2,0
ZA,ZM,2017.0,10,10,0
RS,RU,2007.0,5,4,1
ID,UY,2020.0,1,1,0
BH,ID,2019.0,4,2,2
PK,KR,2015.0,43,31,12
BE,NE,2013.0,3,2,1
TR,NO,2009.0,2,2,0
UG,PK,2014.0,1,1,0
CL,NO,2015.0,1,1,0
DE,ME,2013.0,1,1,0
FR,GR,2016.0,35,53,-18
NL,IL,2020.0,15,7,8
AR,TW,2021.0,2,3,-1
AU,PE,2021.0,4,1,3
CA,PK,2009.0,17,17,0
JO,IQ,2018.0,19,11,8
US,SD,2005.0,5,2,3
ZA,AU,2004.0,32,28,4
IT,BD,2021.0,6,2,4
CZ,GR,2019.0,8,16,-8
KW,IN,2017.0,9,15,-6
nan,EC,2020.0,8,3,5
FR,EE,2008.0,2,4,-2
GB,IR,1999.0,18,2,16
AT,HU,2022.0,23,19,4
ZA,FR,2005.0,11,13,-2
NG,EG,2016.0,5,5,0
US,BD,2005.0,26,25,1
BE,ET,2016.0,10,2,8
SD,MY,2018.0,11,13,-2
IE,FR,2002.0,12,7,5
KR,PL,2007.0,5,2,3
CY,AU,2010.0,2,3,-1
HR,SI,2009.0,13,14,-1
CR,GB,2006.0,2,1,1
MG,CN,2007.0,1,2,-1
KR,IT,2012.0,6,11,-5
CY,AU,2017.0,5,3,2
MG,US,2008.0,2,1,1
HU,CN,2015.0,8,5,3
GB,DZ,2016.0,10,3,7
OM,QA,2015.0,4,4,0
MY,ET,2014.0,3,2,1
IE,DE,2022.0,43,51,-8
DE,BD,2011.0,8,10,-2
KR,AM,2002.0,9,10,-1
SI,JP,2008.0,5,1,4
CH,MA,2007.0,3,4,-1
RW,ZA,2017.0,3,12,-9
IQ,GB,2011.0,10,9,1
SG,TW,2003.0,23,13,10
PL,NO,2021.0,10,4,6
EG,JO,2016.0,13,20,-7
HR,GB,2021.0,13,15,-2
LK,GB,2002.0,5,5,0
DE,IR,2005.0,18,12,6
PT,BE,2011.0,8,13,-5
IL,CA,2003.0,33,27,6
US,MY,1999.0,26,13,13
QA,CA,2012.0,7,12,-5
PE,CH,2021.0,4,6,-2
NL,ET,2004.0,1,2,-1
US,YE,2011.0,3,1,2
MZ,PL,2001.0,17,5,12
CZ,IN,2010.0,10,22,-12
HK,NL,2000.0,7,4,3
LB,IT,2013.0,10,13,-3
PL,CA,2005.0,20,14,6
BF,FR,2007.0,10,12,-2
CY,US,2020.0,12,31,-19
GB,SL,2005.0,1,1,0
IN,PG,2021.0,2,1,1
CA,KW,2008.0,9,2,7
HU,NL,2000.0,5,3,2
AU,BN,2016.0,7,5,2
SE,IE,2016.0,15,6,9
CN,MA,2012.0,3,2,1
BE,TR,2012.0,17,17,0
CA,PH,2009.0,10,9,1
KE,JP,2001.0,3,2,1
DZ,TN,2020.0,23,43,-20
GB,TR,2023.0,3,8,-5
HR,XK,2012.0,2,1,1
NP,IN,2008.0,32,27,5
IN,ZA,2012.0,41,40,1
KE,BE,2014.0,6,7,-1
IN,LY,2013.0,2,3,-1
RU,TW,2016.0,9,13,-4
CH,PK,2000.0,4,8,-4
SE,ET,2010.0,2,6,-4
MA,DE,2010.0,7,5,2
MA,ES,2010.0,4,9,-5
PE,nan,2007.0,5,6,-1
TH,NZ,2006.0,2,1,1
IN,OM,2019.0,39,33,6
MA,ES,2019.0,4,12,-8
MD,RU,1999.0,2,1,1
CM,BJ,2002.0,1,1,0
DE,UA,2010.0,21,36,-15
RU,CL,2002.0,5,2,3
VN,NL,2016.0,4,9,-5
MY,IN,1997.0,3,4,-1
PL,IN,2009.0,2,7,-5
BF,SN,2013.0,1,5,-4
ZA,ZM,2010.0,1,3,-2
FI,TR,2013.0,5,2,3
TW,AU,2001.0,9,21,-12
KE,MX,2015.0,2,2,0
MX,PL,2009.0,3,11,-8
CH,DK,2001.0,11,18,-7
KR,SG,2005.0,15,17,-2
CA,GH,2011.0,2,1,1
LU,AR,2017.0,1,1,0
MY,CZ,2011.0,2,1,1
IR,FR,2005.0,10,15,-5
UY,NL,2014.0,2,1,1
TR,PT,2011.0,1,2,-1
UG,ZA,2008.0,6,4,2
FR,MY,2001.0,4,3,1
KW,IN,2010.0,7,8,-1
IL,GB,2023.0,3,3,0
NZ,IL,2011.0,2,1,1
VE,DE,2007.0,4,3,1
AR,CR,2018.0,17,19,-2
MX,AE,2021.0,2,2,0
CA,VE,2005.0,2,6,-4
BR,BO,2007.0,4,1,3
EC,US,2008.0,9,14,-5
SA,AU,2004.0,3,8,-5
DO,CH,2020.0,2,2,0
LU,CN,2021.0,1,2,-1
TH,MM,2021.0,13,10,3
US,SS,2009.0,3,3,0
US,PA,1999.0,7,10,-3
JO,CN,2006.0,5,1,4
KR,AM,2005.0,3,10,-7
CA,SG,2000.0,12,11,1
NP,GB,2002.0,2,1,1
GM,GB,2009.0,9,11,-2
KE,TZ,2014.0,5,6,-1
KE,US,1999.0,11,20,-9
CR,PE,2001.0,2,1,1
BE,PL,2010.0,17,22,-5
JP,IL,2012.0,6,5,1
RS,CZ,1997.0,3,1,2
DK,RU,1997.0,7,9,-2
SE,CU,2009.0,1,1,0
DK,RU,1998.0,12,7,5
ZA,RU,2018.0,4,3,1
LK,ES,2013.0,4,5,-1
BR,UY,2000.0,10,12,-2
US,MM,2005.0,2,5,-3
UA,GB,2006.0,8,12,-4
RS,US,2000.0,26,31,-5
IL,IT,2011.0,9,17,-8
LU,SE,2021.0,3,5,-2
KE,AU,2019.0,12,11,1
DO,BR,2020.0,7,10,-3
BH,SA,2021.0,8,15,-7
AT,nan,1999.0,13,7,6
MY,MA,2018.0,6,2,4
AU,BH,2019.0,1,1,0
VN,US,1998.0,4,3,1
HR,AT,2017.0,7,8,-1
BJ,TZ,2016.0,2,2,0
IN,BY,2013.0,6,2,4
PA,TN,2013.0,4,1,3
IN,UA,2011.0,10,4,6
VE,CH,2010.0,1,1,0
IN,OM,2010.0,21,5,16
TR,IR,2018.0,29,38,-9
BR,NI,2015.0,3,3,0
NZ,SE,2015.0,8,12,-4
TW,ID,2009.0,2,3,-1
NL,BJ,2020.0,2,3,-1
JO,AU,2019.0,7,7,0
GB,ZW,2016.0,6,1,5
FR,PH,2002.0,4,3,1
SK,BE,2015.0,7,4,3
ES,PR,2020.0,1,1,0
VE,EC,2021.0,17,12,5
IQ,SD,2020.0,8,10,-2
MY,IN,1998.0,4,4,0
SE,TR,2020.0,23,17,6
CA,QA,2010.0,7,2,5
KE,NG,2020.0,12,5,7
CZ,ZA,2018.0,2,9,-7
AE,JO,2016.0,11,20,-9
FI,MA,2021.0,1,3,-2
PT,JP,2000.0,2,3,-1
ET,US,2008.0,26,19,7
CH,TR,2004.0,6,5,1
TR,nan,1999.0,1,2,-1
NL,PK,2020.0,12,5,7
FR,GF,2012.0,17,4,13
AM,RU,2005.0,8,3,5
US,VG,2007.0,14,8,6
KR,EG,2012.0,8,5,3
GB,BN,2019.0,3,4,-1
nan,AT,2000.0,7,3,4
PT,GR,2022.0,3,1,2
JP,AE,2013.0,5,3,2
CL,US,2023.0,6,3,3
HR,BR,2019.0,3,1,2
BO,BR,2021.0,7,6,1
MY,MM,2019.0,5,5,0
MY,BE,2003.0,1,1,0
SA,TW,2021.0,4,2,2
ZA,JP,2022.0,3,3,0
ZA,MW,2021.0,7,9,-2
SV,BR,2019.0,3,4,-1
KH,US,2018.0,4,5,-1
MZ,RU,2015.0,19,7,12
NO,RU,2013.0,24,7,17
PK,AU,2010.0,18,15,3
IS,US,1999.0,5,6,-1
IN,TW,2005.0,24,10,14
IS,DK,2011.0,4,8,-4
PL,CZ,2004.0,14,16,-2
PL,AU,2003.0,2,6,-4
ZA,SG,1999.0,2,1,1
CN,YE,2018.0,2,1,1
FR,PA,2008.0,1,1,0
DE,SG,2006.0,26,12,14
CI,CN,2016.0,1,1,0
QA,BH,2020.0,4,2,2
SI,US,2000.0,5,9,-4
nan,DK,1998.0,4,11,-7
ES,AT,2000.0,5,9,-4
FR,CR,2018.0,9,4,5
nan,IT,1999.0,47,56,-9
AT,DK,2020.0,11,21,-10
KG,TR,2017.0,1,8,-7
BE,CM,2005.0,2,4,-2
MA,SE,2016.0,1,1,0
GH,IL,2018.0,1,1,0
FR,IS,2012.0,3,2,1
EE,GB,2021.0,8,10,-2
SE,GR,2006.0,7,2,5
RO,SI,2013.0,1,4,-3
TW,MY,2001.0,1,2,-1
MY,MM,2017.0,4,8,-4
GB,GM,2010.0,11,15,-4
BE,IL,2009.0,4,8,-4
KR,MX,2019.0,3,7,-4
GB,JM,2007.0,11,4,7
EG,FR,2001.0,5,5,0
TR,NL,1999.0,4,4,0
IN,HU,2009.0,3,6,-3
UA,CN,2000.0,13,5,8
SG,IL,2018.0,8,4,4
AU,MX,2005.0,2,4,-2
KR,MX,2010.0,4,4,0
BR,ZA,2022.0,12,7,5
TR,RO,2006.0,2,1,1
FI,AE,2021.0,2,1,1
MM,JP,2009.0,2,1,1
BA,ME,2020.0,4,2,2
PS,HU,2020.0,1,2,-1
RU,MZ,2002.0,2,5,-3
GB,BN,2017.0,7,1,6
PS,BE,2019.0,1,1,0
OM,CA,2012.0,4,14,-10
US,KN,2014.0,7,1,6
ES,SG,2011.0,9,5,4
CO,CH,2009.0,7,7,0
BE,GP,2017.0,2,1,1
UA,IL,2002.0,6,3,3
AU,JM,2002.0,1,1,0
BG,PK,2014.0,1,1,0
PL,nan,1999.0,3,1,2
DE,KE,2006.0,6,3,3
HR,JP,2004.0,2,3,-1
VE,FR,2000.0,5,4,1
JP,MM,2004.0,4,2,2
HK,US,2002.0,1,6,-5
HR,TR,2017.0,2,1,1
NP,OM,2022.0,1,1,0
MX,AT,2020.0,11,4,7
PK,JP,2006.0,9,12,-3
NL,MW,2005.0,4,1,3
JM,GB,2009.0,6,9,-3
CH,IR,2013.0,11,34,-23
JP,SK,2015.0,6,5,1
JP,QA,2020.0,6,1,5
JP,PK,2013.0,16,11,5
TZ,MY,2017.0,3,2,1
NL,IN,2003.0,16,15,1
LV,KR,2016.0,1,2,-1
EG,PK,2008.0,5,2,3
IE,AR,1997.0,1,1,0
TR,TW,2009.0,13,8,5
CL,NL,2001.0,1,2,-1
NL,CL,2006.0,2,4,-2
GB,PH,2007.0,6,8,-2
NZ,BR,2015.0,7,9,-2
PK,RO,2018.0,2,1,1
IE,NL,1997.0,4,6,-2
CO,ES,2023.0,7,4,3
MT,IT,2009.0,2,1,1
AE,GB,2012.0,11,41,-30
PE,IL,2018.0,2,2,0
CA,AE,2006.0,10,3,7
BD,CH,2001.0,1,1,0
US,BI,2009.0,2,2,0
IR,RO,2018.0,2,2,0
nan,JO,2019.0,2,1,1
EG,SG,2016.0,4,2,2
CO,PE,2005.0,11,24,-13
RS,MX,2021.0,2,3,-1
BR,IL,2002.0,3,4,-1
FI,ES,2014.0,15,32,-17
KZ,RU,1999.0,4,6,-2
AT,ID,2019.0,8,3,5
ZM,CN,2010.0,2,2,0
MY,RU,2005.0,5,1,4
SE,CZ,2003.0,5,7,-2
NZ,NG,2022.0,2,2,0
PE,NG,2017.0,1,2,-1
PK,ES,2006.0,1,1,0
EG,TN,2006.0,4,2,2
VE,CH,2017.0,3,1,2
VE,UY,2013.0,4,2,2
US,SX,2022.0,2,4,-2
AR,SE,2018.0,7,5,2
HR,TR,2010.0,2,3,-1
KW,BD,2019.0,3,1,2
HU,IE,2010.0,4,2,2
BR,MY,1999.0,6,8,-2
LT,PL,2021.0,8,5,3
RS,AE,2018.0,2,1,1
PL,CU,2020.0,1,1,0
HU,IE,2017.0,3,1,2
NL,CO,2007.0,5,4,1
US,BF,2002.0,1,1,0
GF,FR,2005.0,5,6,-1
PR,US,2011.0,4,2,2
SA,DE,2005.0,4,4,0
IQ,CY,2016.0,1,2,-1
RU,CL,2005.0,6,8,-2
nan,ES,2004.0,7,11,-4
ZA,AR,2018.0,2,4,-2
AU,MX,2002.0,4,2,2
TR,GR,2018.0,8,11,-3
CH,HU,2000.0,5,8,-3
CZ,BR,2018.0,10,6,4
SG,PL,2016.0,6,6,0
MA,TR,2017.0,2,1,1
US,BD,2002.0,18,25,-7
FI,GR,2016.0,8,4,4
FR,TR,2021.0,18,21,-3
CZ,nan,2002.0,1,3,-2
CA,CO,2003.0,3,4,-1
SI,BY,2017.0,2,1,1
BY,SE,2017.0,2,1,1
PT,LU,2015.0,3,1,2
AT,CZ,2014.0,22,27,-5
PK,NL,2020.0,5,12,-7
IN,CL,2003.0,3,1,2
SG,JP,2002.0,12,27,-15
nan,CR,2017.0,3,2,1
ES,HN,2008.0,3,3,0
BG,JP,2005.0,7,3,4
TN,CA,2007.0,3,5,-2
CY,AU,2019.0,4,2,2
CM,EG,2021.0,3,1,2
LI,CH,2014.0,2,2,0
US,NG,1999.0,6,15,-9
PK,FI,2019.0,7,5,2
CH,CO,2011.0,2,4,-2
VN,CZ,2009.0,4,2,2
AT,BE,2012.0,14,16,-2
GB,CY,1999.0,4,1,3
TZ,NL,2004.0,2,1,1
IS,GB,2022.0,5,8,-3
CH,LI,2021.0,1,3,-2
JP,PA,2018.0,1,1,0
UA,IL,2005.0,4,5,-1
ID,NO,2014.0,2,7,-5
PS,IL,2009.0,1,1,0
SG,CH,2009.0,6,6,0
KW,QA,2008.0,1,3,-2
ES,IS,2010.0,4,5,-1
AR,PH,2020.0,6,3,3
LB,QA,2012.0,1,3,-2
DE,AM,2018.0,7,5,2
PL,BG,2001.0,2,4,-2
GR,IN,2008.0,2,3,-1
SV,ES,2008.0,4,1,3
CA,ET,2014.0,2,2,0
KW,CA,2011.0,4,12,-8
EC,BR,2023.0,1,2,-1
EC,UA,2003.0,8,5,3
PL,EG,2020.0,6,3,3
EC,HN,2018.0,2,3,-1
IE,SE,2006.0,8,4,4
LB,BR,2013.0,2,2,0
RU,CU,2014.0,2,1,1
FR,PH,2005.0,2,2,0
HR,BR,2010.0,2,2,0
CN,BG,2022.0,4,2,2
DK,SK,2007.0,3,2,1
FR,PF,2004.0,5,5,0
AZ,ID,2009.0,2,3,-1
BE,CL,1998.0,1,2,-1
RS,DE,1997.0,3,2,1
CH,AR,2000.0,3,5,-2
PL,BE,2000.0,5,7,-2
DE,CU,2014.0,2,6,-4
IL,ES,2002.0,9,8,1
TN,IR,2006.0,1,1,0
CY,TR,2005.0,2,8,-6
GF,US,2021.0,1,2,-1
ZA,RW,2015.0,6,2,4
US,LU,2003.0,1,3,-2
KE,IT,2012.0,6,4,2
UY,CU,2012.0,2,4,-2
CU,VE,2002.0,2,3,-1
SE,ET,2017.0,6,3,3
DK,NP,2020.0,1,3,-2
CA,EC,2013.0,2,2,0
MA,DE,2017.0,7,12,-5
SA,LB,2022.0,3,8,-5
IN,GH,2021.0,10,7,3
HU,nan,2008.0,2,3,-1
MX,GR,2007.0,2,5,-3
BE,IS,2015.0,2,1,1
TZ,BH,2008.0,2,2,0
FR,UA,2000.0,8,10,-2
AU,NO,2007.0,14,12,2
PT,KR,2015.0,2,1,1
ES,TW,2001.0,3,3,0
GB,VE,2014.0,5,1,4
TW,HK,2021.0,1,1,0
IE,MX,2020.0,1,5,-4
RS,SE,2022.0,4,2,2
JM,US,2008.0,14,10,4
GB,SS,2013.0,6,10,-4
AU,DE,2023.0,8,5,3
VG,FR,2008.0,2,3,-1
GT,AR,2016.0,4,2,2
ML,FR,2009.0,7,6,1
SL,NG,2021.0,2,1,1
PA,US,1997.0,8,10,-2
MY,SI,2017.0,1,10,-9
US,TT,2001.0,7,1,6
UZ,BE,2004.0,1,1,0
LV,JP,1999.0,2,1,1
AR,CH,2003.0,7,2,5
RU,EC,2003.0,1,1,0
SG,BR,2017.0,4,3,1
SY,JP,2006.0,1,1,0
BR,HR,2016.0,4,2,2
OM,US,2000.0,5,9,-4
nan,CO,2022.0,5,3,2
FI,RO,2020.0,4,2,2
MA,IR,2018.0,8,19,-11
EE,FI,2007.0,6,3,3
VE,AU,2010.0,2,1,1
JP,SD,2013.0,1,1,0
AT,NZ,2014.0,2,8,-6
MG,GB,2021.0,3,1,2
FR,UY,2002.0,6,2,4
RS,HU,2008.0,5,3,2
SA,ZA,2014.0,3,6,-3
BR,MA,2021.0,2,1,1
MA,TR,2019.0,1,2,-1
ET,FI,2016.0,2,1,1
GT,PE,2021.0,2,6,-4
EG,NZ,2017.0,1,1,0
IN,GE,2022.0,4,1,3
BY,GB,2002.0,6,1,5
CH,AE,2018.0,4,2,2
PT,RO,2018.0,2,1,1
PT,GH,2022.0,1,2,-1
IQ,MM,2020.0,2,1,1
DE,GH,2014.0,6,8,-2
FR,GN,2021.0,4,3,1
RO,JP,2014.0,4,3,1
MM,CN,2009.0,11,5,6
UA,nan,2006.0,16,8,8
BZ,US,2013.0,1,1,0
AT,ID,2017.0,7,4,3
AZ,GB,2011.0,2,1,1
SN,CG,2014.0,1,4,-3
MX,NL,2003.0,4,5,-1
BR,IL,2005.0,3,7,-4
CO,PA,2009.0,4,1,3
NG,FR,2013.0,6,5,1
BE,RW,2016.0,2,1,1
KR,ZA,2007.0,2,2,0
NI,CR,2019.0,3,2,1
TR,SG,2008.0,2,3,-1
AU,BH,2010.0,4,1,3
SG,BE,2015.0,6,8,-2
BY,HU,2008.0,2,1,1
US,SD,2002.0,5,5,0
UZ,US,2015.0,3,2,1
IE,ZA,2015.0,4,10,-6
GB,EE,2022.0,6,6,0
ZA,GE,2012.0,2,1,1
GB,UG,2015.0,4,13,-9
NZ,BE,2003.0,1,3,-2
SA,DE,2002.0,5,4,1
MY,LB,2021.0,4,2,2
EG,KR,2006.0,2,5,-3
DE,MD,2001.0,1,6,-5
NG,SD,2022.0,4,1,3
JP,VE,1998.0,1,2,-1
SY,IR,2012.0,2,1,1
SK,ES,2004.0,1,2,-1
PF,NC,2011.0,1,1,0
QA,HU,2015.0,2,1,1
LK,MY,2013.0,3,4,-1
FR,QA,2005.0,1,3,-2
NP,GB,2005.0,3,1,2
FI,KR,2000.0,2,1,1
CA,PE,2009.0,4,3,1
DO,DE,2015.0,1,1,0
GH,BJ,2019.0,3,1,2
AE,SA,2004.0,1,3,-2
NZ,RU,2022.0,1,1,0
GH,NL,2006.0,3,1,2
FI,IR,2009.0,3,2,1
VN,IN,2023.0,1,1,0
IT,DO,2020.0,7,3,4
CA,PA,2010.0,6,1,5
MY,NG,2023.0,2,1,1
DK,GW,2005.0,4,3,1
EG,NL,2009.0,7,2,5
BH,DE,2011.0,1,1,0
BR,PK,2015.0,9,8,1
KE,ET,2013.0,3,1,2
DK,MZ,2012.0,2,1,1
TR,PL,2010.0,3,3,0
NL,JO,2018.0,1,1,0
ZW,CA,2019.0,2,1,1
UA,MZ,2016.0,1,2,-1
JP,LY,2004.0,1,2,-1
IE,BD,2005.0,1,2,-1
FR,PT,2023.0,1,1,0
UA,UZ,1998.0,2,5,-3
DE,CM,2022.0,2,3,-1
TR,AU,2007.0,3,4,-1
US,VN,1998.0,3,4,-1
nan,CR,2010.0,3,2,1
AT,BR,2005.0,6,4,2
PY,CU,2022.0,1,1,0
EG,SY,2015.0,3,5,-2
NZ,IE,1999.0,2,5,-3
GB,VG,2012.0,4,3,1
GA,FR,2021.0,6,6,0
PH,PE,2021.0,4,5,-1
EG,NZ,2010.0,4,4,0
HU,IL,2022.0,4,2,2
NL,CZ,2000.0,4,3,1
ID,MX,2013.0,1,1,0
GB,BN,2010.0,4,1,3
US,XK,2012.0,3,1,2
IE,RS,2015.0,1,1,0
VN,EG,2020.0,4,7,-3
AE,QA,2000.0,1,1,0
SG,AE,2001.0,1,1,0
UA,TJ,2016.0,2,1,1
CN,EG,2007.0,7,8,-1
IR,AZ,2017.0,4,6,-2
SD,AE,2021.0,5,5,0
BE,MY,2014.0,2,4,-2
SG,MA,2020.0,1,1,0
MY,UA,2014.0,2,1,1
AE,GR,2022.0,4,3,1
DE,PE,2006.0,3,1,2
KE,AU,2017.0,4,7,-3
TW,IT,2001.0,2,2,0
NI,MX,2005.0,1,3,-2
MX,SV,2013.0,3,4,-1
MA,HU,2015.0,2,5,-3
BF,GN,2017.0,2,2,0
PL,CN,1999.0,5,1,4
NZ,NL,1998.0,1,5,-4
CZ,NL,1998.0,5,4,1
SI,EE,2020.0,1,1,0
NG,NE,2018.0,1,2,-1
PT,PL,2019.0,6,8,-2
MX,ZA,2015.0,3,2,1
TZ,BW,2015.0,1,1,0
BF,GN,2019.0,2,1,1
PL,BR,2014.0,4,6,-2
GT,EC,2017.0,4,1,3
BE,CM,2002.0,3,1,2
NG,NO,2022.0,4,2,2
TG,US,2016.0,1,1,0
CH,JM,2018.0,1,1,0
CH,BG,1997.0,3,2,1
PA,JP,2013.0,2,1,1
KW,BD,2017.0,1,1,0
AU,CR,2011.0,1,1,0
EC,CR,2013.0,3,2,1
RS,DK,2017.0,3,1,2
TR,IS,2021.0,1,3,-2
PH,CR,2003.0,1,1,0
NG,SA,2005.0,1,4,-3
AT,BG,1998.0,2,2,0
DK,RO,2007.0,1,3,-2
ZM,US,2007.0,3,2,1
GR,RS,2000.0,1,1,0
SN,BF,2018.0,2,3,-1
PA,CL,2008.0,2,2,0
AR,IE,2021.0,2,1,1
IE,NL,1998.0,4,3,1
GP,GF,2018.0,1,3,-2
CZ,PK,2022.0,2,4,-2
OM,NZ,2014.0,1,4,-3
VE,AU,2019.0,1,4,-3
PT,SA,2013.0,3,3,0
UG,FR,2009.0,3,1,2
nan,VN,2022.0,3,2,1
BD,PH,2018.0,3,1,2
nan,TN,2021.0,5,2,3
CH,BA,2022.0,1,1,0
CV,ES,2016.0,1,1,0
GB,FJ,1999.0,2,1,1
CA,BA,2020.0,1,1,0
GR,IL,2020.0,1,2,-1
DE,UZ,2018.0,2,4,-2
AU,TH,2000.0,7,9,-2
CO,VE,1997.0,6,4,2
BR,DO,2011.0,1,1,0
AU,MG,2018.0,3,1,2
TR,RU,1998.0,1,2,-1
IT,AE,2007.0,1,1,0
SE,PT,1998.0,1,2,-1
DK,BA,2012.0,1,1,0
US,CD,2011.0,5,1,4
RE,CA,2019.0,2,1,1
GB,HK,2002.0,1,1,0
nan,CU,2015.0,5,4,1
TZ,GB,2000.0,2,7,-5
PT,CZ,2003.0,1,2,-1
ML,GH,2018.0,1,1,0
VE,IL,2008.0,1,1,0
IN,KE,2013.0,2,11,-9
DE,DO,2013.0,1,1,0
BJ,TG,2015.0,2,1,1
PA,AU,2017.0,1,5,-4
CO,AU,2004.0,2,2,0
US,KH,2014.0,3,4,-1
MY,CH,2013.0,4,6,-2
PA,SE,2002.0,1,3,-2
KE,AU,2010.0,4,1,3
TN,SY,2016.0,3,4,-1
BY,DK,2002.0,2,1,1
LT,JP,2002.0,6,5,1
IT,ID,2005.0,1,1,0
SE,VN,2008.0,2,2,0
CG,CH,2003.0,1,1,0
BR,QA,2018.0,1,2,-1
PL,ZA,2006.0,2,3,-1
NL,IS,2006.0,1,1,0
TH,RU,2004.0,1,1,0
LY,GB,2022.0,3,3,0
AT,CO,2012.0,2,4,-2
DE,YE,2002.0,1,1,0
QA,SG,2013.0,1,4,-3
ID,GH,2011.0,1,3,-2
AT,KR,2006.0,4,1,3
MQ,GF,2018.0,2,1,1
LT,CZ,2015.0,2,1,1
PK,PH,2002.0,2,1,1
UA,UZ,1997.0,1,1,0
BN,GB,2012.0,3,4,-1
GB,AE,2000.0,3,4,-1
CY,TR,2002.0,1,1,0
SG,PT,2013.0,1,5,-4
CO,IN,2003.0,1,2,-1
CF,FR,2004.0,2,4,-2
NL,KZ,2020.0,1,3,-2
BD,OM,2021.0,2,6,-4
AT,BR,2002.0,2,2,0
DZ,PK,2015.0,1,2,-1
BR,SV,2016.0,1,1,0
KR,ZM,2018.0,1,1,0
JP,UZ,2001.0,1,3,-2
US,GB,2022.0,3424,3438,-14
BR,US,2015.0,1147,1322,-175
GB,IE,2014.0,368,414,-46
US,PE,2016.0,102,99,3
CA,DK,2008.0,25,22,3
KR,AU,2016.0,68,34,34
IN,BD,2011.0,54,70,-16
CL,ES,2016.0,336,512,-176
SE,DE,1998.0,68,64,4
DE,AE,2010.0,8,6,2
HU,US,1998.0,62,68,-6
JP,VN,2007.0,19,13,6
FI,US,2010.0,112,215,-103
KR,GB,2011.0,88,82,6
FR,CA,2020.0,582,584,-2
IE,AU,2011.0,104,92,12
US,NO,2012.0,165,115,50
TW,CA,2016.0,47,40,7
BE,CN,2002.0,52,14,38
ID,AR,2014.0,6,3,3
FR,CL,2021.0,39,35,4
CN,PH,2019.0,19,23,-4
US,HR,2002.0,32,22,10
AU,SA,2020.0,80,33,47
TR,BE,2014.0,14,19,-5
US,RU,2008.0,269,423,-154
HU,DK,2008.0,2,4,-2
CA,SE,2009.0,36,44,-8
IT,ZA,2008.0,5,10,-5
AT,CA,2014.0,26,26,0
DK,CA,2012.0,34,29,5
TW,CN,2023.0,18,63,-45
DK,SE,2010.0,81,136,-55
NO,DE,2008.0,33,78,-45
NO,US,2002.0,80,74,6
PK,US,2007.0,92,116,-24
GB,PL,2022.0,51,60,-9
BR,SE,2011.0,17,13,4
CA,PA,2017.0,8,4,4
MY,AE,2023.0,4,2,2
MA,PK,2022.0,13,7,6
RS,BA,2018.0,59,50,9
AU,MK,2021.0,24,35,-11
JO,CA,2016.0,12,10,2
PT,PL,2017.0,9,4,5
nan,NL,2013.0,73,81,-8
ES,IS,2017.0,13,5,8
EC,GT,2021.0,5,2,3
CA,QA,2017.0,16,13,3
IT,SG,2016.0,12,14,-2
AM,CA,2021.0,3,1,2
SK,US,2007.0,27,37,-10
MY,BR,1999.0,8,6,2
CH,SE,2016.0,76,66,10
TW,IN,2008.0,22,43,-21
IR,CH,2009.0,15,6,9
SD,EG,2011.0,8,10,-2
GB,LY,2016.0,12,5,7
FR,BI,2015.0,15,29,-14
ZA,CR,2013.0,7,2,5
SG,AU,2006.0,57,42,15
US,UZ,2015.0,2,3,-1
SE,NZ,2022.0,4,7,-3
IR,FR,2002.0,3,5,-2
SK,IN,2016.0,4,1,3
NL,AU,2013.0,91,66,25
SE,DE,1997.0,36,56,-20
TH,MY,2014.0,10,7,3
GR,IT,2006.0,11,22,-11
NI,CR,2017.0,2,3,-1
BD,JP,2021.0,32,68,-36
nan,DK,1997.0,5,5,0
SG,JP,2005.0,20,28,-8
CN,GH,2020.0,61,36,25
HU,AT,2022.0,19,23,-4
MT,GB,2020.0,10,22,-12
KG,TR,2019.0,3,4,-1
GT,EC,2019.0,2,4,-2
PA,CO,2021.0,12,9,3
PS,CA,2020.0,1,2,-1
NG,DE,2011.0,7,7,0
DK,CH,2008.0,24,27,-3
KR,MX,2017.0,7,6,1
CL,CN,2006.0,2,2,0
IE,CH,2016.0,20,23,-3
HR,CZ,2015.0,7,8,-1
RU,SG,2015.0,8,10,-2
SE,AE,2015.0,5,3,2
RS,CZ,1998.0,1,5,-4
BG,BE,2018.0,6,7,-1
US,AE,2002.0,23,10,13
CR,CU,2011.0,9,6,3
DE,TN,2009.0,2,6,-4
SE,AU,2012.0,48,65,-17
DE,IR,2002.0,5,5,0
MY,US,2008.0,49,74,-25
AR,VE,2018.0,15,25,-10
IT,NL,2002.0,48,46,2
NZ,MY,2020.0,10,13,-3
ES,PT,2023.0,11,15,-4
UA,RO,2011.0,4,2,2
RU,RS,2012.0,15,8,7
GB,TT,2022.0,2,4,-2
JP,UA,2000.0,5,5,0
DE,CL,2000.0,16,12,4
GR,CZ,2011.0,2,2,0
ES,SA,2014.0,5,7,-2
RU,LT,2012.0,3,5,-2
CY,DE,2014.0,7,5,2
CU,VE,2005.0,9,6,3
AU,HK,2014.0,6,4,2
PL,DK,2011.0,16,8,8
DE,TR,2004.0,25,19,6
NZ,FR,2022.0,9,3,6
SI,NL,2021.0,8,5,3
CH,UG,2008.0,2,2,0
GR,AT,2012.0,6,2,4
IR,ZM,2018.0,1,2,-1
HU,TR,2008.0,1,1,0
BR,UA,2018.0,10,9,1
CN,NZ,2001.0,10,12,-2
VE,PA,2017.0,2,1,1
IT,CZ,2003.0,14,17,-3
TH,NL,2022.0,6,5,1
IL,LB,2011.0,2,1,1
MN,KR,2015.0,2,5,-3
BH,TR,2021.0,1,1,0
EG,OM,2018.0,10,15,-5
CN,JM,2019.0,1,1,0
PT,MX,2001.0,9,6,3
MZ,SE,2013.0,2,2,0
nan,HU,2001.0,6,4,2
KE,CH,2021.0,5,6,-1
BR,UZ,1998.0,1,1,0
CA,PT,2007.0,14,9,5
BR,NZ,2003.0,4,2,2
CN,SD,2021.0,5,10,-5
LV,CH,2018.0,7,2,5
IN,LK,2004.0,4,2,2
PS,QA,2020.0,9,1,8
IT,EG,1999.0,8,4,4
CA,JM,2005.0,4,1,3
UG,IT,2015.0,5,2,3
CA,OM,2018.0,8,11,-3
MD,DE,2016.0,3,1,2
BR,PH,2016.0,7,14,-7
TR,PL,2019.0,5,8,-3
GB,LK,2002.0,5,5,0
AE,CH,2011.0,1,3,-2
CD,IR,2020.0,1,1,0
KR,SG,2002.0,8,12,-4
CO,EG,2010.0,2,1,1
UY,FR,2002.0,2,6,-4
RU,MZ,2005.0,4,3,1
SG,IE,2010.0,4,4,0
UY,FR,2005.0,6,3,3
RU,ZA,2018.0,3,4,-1
NG,IT,2008.0,6,3,3
SY,CA,2015.0,2,3,-1
RS,BE,2022.0,6,4,2
DZ,CA,2001.0,4,2,2
TT,US,2007.0,6,4,2
EG,NZ,2019.0,2,5,-3
BE,RS,2009.0,3,3,0
GR,BG,2011.0,3,1,2
SE,BG,2008.0,2,2,0
NZ,TW,2000.0,1,1,0
TW,NZ,2004.0,2,2,0
FR,MG,2000.0,1,3,-2
TW,CH,2016.0,6,12,-6
DK,HU,2015.0,2,6,-4
JO,MA,2014.0,2,1,1
PK,AM,2016.0,1,2,-1
EG,BD,2008.0,1,1,0
PE,NL,2014.0,3,1,2
SJ,NO,2009.0,3,5,-2
TN,ID,2020.0,3,3,0
RU,TJ,2004.0,6,2,4
MA,NL,2011.0,2,2,0
AU,BG,2004.0,3,5,-2
PE,ZA,2021.0,2,1,1
NL,SI,2009.0,3,3,0
nan,SI,2016.0,3,2,1
BG,RO,2013.0,2,5,-3
HU,HR,2015.0,2,3,-1
CZ,GR,2017.0,2,11,-9
PF,FR,2004.0,5,5,0
TH,OM,2019.0,1,1,0
UG,RW,2022.0,2,2,0
BB,JM,2020.0,3,4,-1
IT,ET,2020.0,5,5,0
BF,AT,2012.0,2,1,1
BW,NG,2006.0,2,2,0
CY,SE,2018.0,2,3,-1
RE,IN,2016.0,1,1,0
UZ,CZ,2010.0,1,2,-1
DE,LY,2018.0,3,1,2
TW,RO,2018.0,1,1,0
KE,SG,2004.0,1,1,0
KY,US,2013.0,2,2,0
CH,PE,2018.0,2,1,1
MM,IT,2020.0,1,1,0
GB,DE,2010.0,766,768,-2
US,FR,2010.0,1327,1381,-54
IL,CN,2014.0,18,19,-1
DK,FI,2009.0,7,13,-6
BE,DE,2000.0,57,59,-2
EG,MY,2016.0,40,50,-10
NC,FR,2020.0,12,17,-5
MX,IT,2015.0,46,42,4
ES,IL,2013.0,14,10,4
HR,BR,2017.0,6,1,5
GB,LK,2005.0,9,11,-2
JM,BB,2015.0,8,2,6
FR,LT,2016.0,4,3,1
JO,AU,2017.0,6,14,-8
DO,ES,2011.0,3,2,1
CN,GR,2020.0,6,8,-2
nan,CR,2019.0,5,2,3
SG,IE,2017.0,3,5,-2
EC,CL,2003.0,2,3,-1
MY,CO,2020.0,3,2,1
CL,,2020.0,2057,0,2057
,CN,2015.0,42154,0,42154
,FR,1994.0,46657,0,46657
,US,2006.0,71626,0,71626
,IN,2008.0,16785,0,16785
CN,,2016.0,34495,0,34495
US,,2015.0,56543,0,56543
DE,,2018.0,19089,0,19089
,FI,2008.0,1920,0,1920
,CA,2001.0,8122,0,8122
IN,,2014.0,5883,0,5883
MX,,2020.0,5877,0,5877
SG,,2016.0,871,0,871
AR,,2017.0,1673,0,1673
XK,PL,2018.0,1,0,1
,IR,1994.0,583,0,583
TW,,2020.0,4134,0,4134
,PE,2008.0,452,0,452
NL,,2006.0,1761,0,1761
CA,,2002.0,2456,0,2456
CA,,2005.0,2526,0,2526
AR,,2019.0,2413,0,2413
,NP,2010.0,422,0,422
VE,PA,2019.0,2,0,2
BR,,2003.0,934,0,934
,PL,2001.0,4066,0,4066
PE,,2023.0,4016,0,4016
TR,,2013.0,1634,0,1634
,ES,2015.0,13271,0,13271
,NP,2017.0,385,0,385
CH,UY,1999.0,1,0,1
KE,,2014.0,137,0,137
,MA,2006.0,650,0,650
,RO,2007.0,1663,0,1663
RO,,2009.0,196,0,196
AU,,2011.0,2780,0,2780
TT,,2020.0,63,0,63
,VN,2010.0,361,0,361
RU,,2021.0,18616,0,18616
,SG,2007.0,1276,0,1276
SE,,2025.0,2116,0,2116
,SA,1995.0,720,0,720
,TN,2006.0,1133,0,1133
AR,,2010.0,646,0,646
PL,,2003.0,689,0,689
nan,,2025.0,174,0,174
,RS,2010.0,1318,0,1318
AE,,2022.0,852,0,852
,SY,2006.0,71,0,71
GE,,2023.0,905,0,905
AT,,2025.0,1318,0,1318
LT,,2021.0,930,0,930
,VE,2001.0,404,0,404
MX,BI,2013.0,1,0,1
AM,,2023.0,638,0,638
SE,KR,2004.0,4,0,4
BA,QA,2015.0,2,0,2
,ZA,2016.0,2369,0,2369
MY,PL,2014.0,4,0,4
,HK,1998.0,12,0,12
,VN,2019.0,483,0,483
,VN,2017.0,821,0,821
,PH,2002.0,273,0,273
,PH,2005.0,377,0,377
,RS,2017.0,608,0,608
MG,GF,2017.0,1,0,1
IE,,2001.0,157,0,157
JO,,2022.0,993,0,993
NA,,2013.0,4,0,4
,UA,2014.0,3722,0,3722
LU,BR,2008.0,2,0,2
,BE,2018.0,2516,0,2516
SI,TR,2005.0,1,0,1
,PR,2014.0,27,0,27
,EE,1995.0,220,0,220
BG,,2015.0,327,0,327
MT,,2019.0,64,0,64
,CD,2004.0,29,0,29
,SI,1995.0,571,0,571
CA,BO,2014.0,2,0,2
,YE,2015.0,73,0,73
IR,,1999.0,42,0,42
TW,MW,2020.0,1,0,1
SA,,2026.0,38,0,38
AU,TO,2019.0,1,0,1
,TJ,1998.0,17,0,17
BH,,2012.0,16,0,16
JP,VE,1997.0,1,0,1
SL,,2022.0,26,0,26
,ML,2016.0,38,0,38
JP,PY,2003.0,1,0,1
SV,,2016.0,9,0,9
,MK,2016.0,141,0,141
DZ,UA,2015.0,1,0,1
TD,,2024.0,20,0,20
,EC,2000.0,105,0,105
MD,,2022.0,188,0,188
,RW,2013.0,62,0,62
CR,JP,2016.0,2,0,2
MW,,2006.0,13,0,13
SD,,2013.0,24,0,24
HR,,2001.0,77,0,77
,KG,2016.0,58,0,58
PH,,2000.0,71,0,71
,RS,2019.0,258,0,258
,IQ,1999.0,42,0,42
NP,AU,2010.0,5,0,5
BY,TN,2017.0,1,0,1
,NP,2019.0,246,0,246
,LS,2014.0,10,0,10
GD,,2013.0,5,0,5
,MZ,2005.0,45,0,45
,OM,2012.0,223,0,223
BA,,2014.0,61,0,61
NL,OM,1997.0,1,0,1
MT,,2010.0,14,0,14
XK,,2014.0,28,0,28
MT,,2017.0,35,0,35
AR,HN,2004.0,1,0,1
GA,DE,2004.0,2,0,2
LU,TN,2017.0,1,0,1
BE,JO,2019.0,1,0,1
GB,NA,2012.0,4,0,4
,WS,2013.0,8,0,8
,MZ,2002.0,28,0,28
CN,PS,2008.0,1,0,1
UY,IL,2016.0,1,0,1
CZ,MK,2015.0,1,0,1
CL,DK,2007.0,3,0,3
GT,,2018.0,30,0,30
,SV,2018.0,23,0,23
PG,,2000.0,7,0,7
BE,GP,2010.0,2,0,2
,FR,2021.0,1,0,1
NL,LV,2012.0,2,0,2
NC,,2021.0,17,0,17
IR,PA,2017.0,4,0,4
NG,,2003.0,119,0,119
CL,RO,2018.0,1,0,1
MA,ID,2012.0,1,0,1
BY,SE,2019.0,1,0,1
TR,MA,2015.0,2,0,2
PT,AU,2001.0,2,0,2
CD,ID,2019.0,2,0,2
AO,,2008.0,10,0,10
UZ,CZ,2019.0,5,0,5
PT,AT,2007.0,2,0,2
VG,AU,2013.0,2,0,2
,AL,2007.0,64,0,64
JP,BH,2015.0,2,0,2
AM,PK,2019.0,6,0,6
NG,RU,2005.0,2,0,2
,CY,2001.0,58,0,58
,BJ,2000.0,22,0,22
,ZW,2001.0,69,0,69
IT,JO,2004.0,6,0,6
MK,SI,2009.0,1,0,1
PS,AU,2010.0,1,0,1
,MW,1999.0,39,0,39
,GM,2009.0,8,0,8
UA,GR,2022.0,1,0,1
PS,BE,2010.0,1,0,1
JP,BO,2016.0,1,0,1
ES,KN,2018.0,1,0,1
MA,NE,2003.0,1,0,1
,JE,2000.0,1,0,1
,KH,2001.0,13,0,13
ES,MW,2018.0,2,0,2
GF,GT,2002.0,1,0,1
SV,CA,2018.0,1,0,1
,BT,2005.0,2,0,2
MN,AU,2009.0,1,0,1
PE,RO,2018.0,2,0,2
NO,MM,2013.0,1,0,1
UY,CL,2023.0,1,0,1
BE,AE,2015.0,3,0,3
,NC,2005.0,18,0,18
JM,CA,2008.0,2,0,2
NP,SE,2016.0,3,0,3
nan,PK,2023.0,1,0,1
SN,,2006.0,10,0,10
NP,LK,2019.0,2,0,2
KH,PH,2013.0,1,0,1
NE,MG,2014.0,1,0,1
US,BF,2005.0,2,0,2
,HK,1997.0,34,0,34
SG,TN,2000.0,1,0,1
KR,GR,2009.0,3,0,3
BW,FR,2016.0,1,0,1
,MC,1995.0,8,0,8
,BW,1999.0,34,0,34
CY,SI,2021.0,1,0,1
,GF,2013.0,15,0,15
PK,NO,2023.0,2,0,2
PK,,1999.0,28,0,28
CO,IL,2009.0,4,0,4
KH,,2008.0,5,0,5
SD,CN,2006.0,2,0,2
,CD,1996.0,12,0,12
AL,BR,2019.0,1,0,1
SO,,2021.0,4,0,4
CR,ID,2004.0,1,0,1
PK,GE,2013.0,1,0,1
TH,LU,2009.0,1,0,1
SA,nan,2004.0,2,0,2
ID,ZA,2005.0,1,0,1
IS,MZ,2007.0,1,0,1
GB,HK,2005.0,1,0,1
JP,TN,2010.0,4,0,4
HU,BG,2003.0,6,0,6
MR,,2002.0,4,0,4
GL,NO,2010.0,3,0,3
CA,MK,2016.0,2,0,2
GB,AF,2006.0,1,0,1
MY,KW,2000.0,1,0,1
BW,CA,2002.0,1,0,1
BO,BE,1999.0,1,0,1
KH,JP,1999.0,2,0,2
PT,ZM,2010.0,1,0,1
TN,VN,2020.0,1,0,1
IN,CO,2009.0,2,0,2
MX,IR,2017.0,1,0,1
RO,NO,2011.0,3,0,3
BE,,2026.0,1,0,1
NI,VE,2013.0,2,0,2
IN,MW,2007.0,2,0,2
MD,IT,2007.0,1,0,1
FR,AL,2013.0,6,0,6
IN,VG,2013.0,2,0,2
MX,KZ,2002.0,1,0,1
UG,SL,2019.0,1,0,1
MR,MA,2018.0,2,0,2
PT,BO,2000.0,1,0,1
RW,BI,2019.0,1,0,1
IN,PS,2001.0,2,0,2
BO,AU,2021.0,1,0,1
CY,DK,2016.0,4,0,4
BG,HU,2001.0,3,0,3
CN,GL,2012.0,1,0,1
NI,SE,2009.0,4,0,4
AT,VN,1998.0,1,0,1
TR,LA,2017.0,2,0,2
DE,CD,2018.0,2,0,2
CY,LY,2022.0,1,0,1
SA,ET,2020.0,3,0,3
DO,,2025.0,6,0,6
SG,LU,2016.0,2,0,2
DZ,NO,2016.0,2,0,2
RO,LK,2015.0,4,0,4
,NC,2002.0,13,0,13
CA,BW,1999.0,2,0,2
NG,VE,2012.0,1,0,1
TZ,BE,2004.0,2,0,2
IR,KR,2000.0,3,0,3
ES,IS,2019.0,4,0,4
GB,SN,2009.0,1,0,1
BO,CH,2006.0,1,0,1
AT,CM,2020.0,3,0,3
KZ,CN,1998.0,1,0,1
MZ,,2007.0,5,0,5
RS,PK,2011.0,1,0,1
VE,PL,2010.0,2,0,2
MD,RO,2006.0,1,0,1
IE,BD,2002.0,1,0,1
nan,KW,2001.0,1,0,1
TG,MQ,2019.0,1,0,1
BE,GM,2002.0,1,0,1
BY,DK,2005.0,2,0,2
ES,EE,1999.0,1,0,1
SI,RO,2014.0,2,0,2
MY,CM,2015.0,1,0,1
BA,IT,2006.0,1,0,1
IT,AL,2006.0,3,0,3
TZ,PL,1999.0,1,0,1
ES,RS,1999.0,3,0,3
SI,ME,2014.0,1,0,1
JE,AU,2021.0,1,0,1
NG,TR,2003.0,1,0,1
BO,US,1999.0,1,0,1
ID,KE,2002.0,1,0,1
JO,IL,2008.0,1,0,1
RW,GB,2011.0,1,0,1
NP,KR,2000.0,1,0,1
NO,NZ,2003.0,1,0,1
ZW,MY,2013.0,1,0,1
MZ,BY,2017.0,4,0,4
PH,CO,2007.0,3,0,3
,TJ,1997.0,3,0,3
GE,IT,2012.0,1,0,1
CM,PT,2012.0,1,0,1
JP,TN,2017.0,4,0,4
QA,SA,1999.0,1,0,1
VN,,1999.0,5,0,5
CM,KE,1998.0,2,0,2
GR,TW,2020.0,4,0,4
CW,,2007.0,4,0,4
IN,AR,2004.0,2,0,2
RW,ZA,2010.0,2,0,2
SN,GA,2016.0,2,0,2
ML,IT,2015.0,1,0,1
nan,BO,2022.0,1,0,1
JP,GE,1997.0,3,0,3
GH,PE,2015.0,2,0,2
BD,VN,2012.0,1,0,1
NL,PY,2018.0,1,0,1
UA,JO,2017.0,1,0,1
JO,YE,2017.0,1,0,1
TW,HU,2018.0,2,0,2
,SR,2008.0,2,0,2
PT,TH,2021.0,3,0,3
,MQ,2008.0,11,0,11
JP,BN,2014.0,3,0,3
LR,UG,2018.0,1,0,1
ES,MT,2000.0,1,0,1
FR,PY,2015.0,1,0,1
ET,CM,2022.0,2,0,2
AL,IR,2013.0,2,0,2
VU,,2013.0,1,0,1
CY,CH,2002.0,1,0,1
ET,ML,2021.0,1,0,1
CH,AM,2015.0,1,0,1
BG,TR,1998.0,1,0,1
KH,DK,2016.0,1,0,1
ET,HU,2007.0,1,0,1
NG,GM,2004.0,1,0,1
GL,NO,2019.0,2,0,2
TW,EE,2004.0,1,0,1
ES,OM,2021.0,2,0,2
KW,RO,2005.0,1,0,1
FI,TW,2003.0,1,0,1
GD,ES,2015.0,1,0,1
AT,ID,2010.0,2,0,2
AL,,2012.0,17,0,17
QA,BA,2021.0,1,0,1
SD,BH,2008.0,1,0,1
ZW,NZ,2002.0,1,0,1
UY,GT,2007.0,1,0,1
nan,ZW,2018.0,1,0,1
KW,CN,2016.0,1,0,1
JO,MY,1998.0,1,0,1
CH,MX,2023.0,1,0,1
CH,AZ,2019.0,2,0,2
PR,PS,2019.0,1,0,1
PA,TR,2021.0,1,0,1
PL,SG,2003.0,2,0,2
MY,GH,2014.0,4,0,4
,PF,2003.0,10,0,10
IT,HN,2007.0,1,0,1
AR,ML,2020.0,1,0,1
VN,SE,2004.0,1,0,1
VE,GD,2009.0,1,0,1
CM,KE,1997.0,1,0,1
,SX,2019.0,4,0,4
IE,BG,2008.0,1,0,1
BB,,2004.0,1,0,1
RW,SA,2022.0,1,0,1
FI,PS,2016.0,1,0,1
NA,GB,2013.0,1,0,1
PE,AT,2004.0,3,0,3
AZ,US,2004.0,3,0,3
MG,,2006.0,4,0,4
FJ,LK,2018.0,1,0,1
CO,ZA,2020.0,2,0,2
CM,CA,2009.0,2,0,2
RS,MC,2017.0,1,0,1
BF,NG,2007.0,1,0,1
TW,RS,2004.0,1,0,1
nan,GH,2003.0,2,0,2
CG,ZA,2017.0,1,0,1
KW,SK,2007.0,1,0,1
CU,FI,2009.0,1,0,1
TM,,2018.0,3,0,3
MZ,LT,2005.0,1,0,1
ES,DZ,2004.0,3,0,3
CD,,2003.0,1,0,1
FJ,NC,2022.0,2,0,2
BJ,TN,2019.0,1,0,1
PH,CU,2007.0,2,0,2
MY,RU,2002.0,1,0,1
IQ,MA,2012.0,1,0,1
VE,AU,2017.0,3,0,3
SY,IN,2019.0,3,0,3
LA,NZ,2005.0,2,0,2
NL,ML,2015.0,1,0,1
KG,NL,2021.0,1,0,1
KW,RO,2002.0,1,0,1
PA,CA,2007.0,2,0,2
AU,ZM,2014.0,1,0,1
RU,FK,2001.0,1,0,1
TW,CR,2014.0,1,0,1
SC,nan,2010.0,1,0,1
TH,VN,1999.0,1,0,1
BG,MD,2011.0,1,0,1
KZ,CA,2022.0,1,0,1
JO,FI,2007.0,1,0,1
SA,BR,1998.0,1,0,1
PK,NZ,2007.0,1,0,1
DO,CL,1999.0,1,0,1
AL,BR,2010.0,1,0,1
EG,LU,2006.0,2,0,2
TM,TR,2019.0,2,0,2
OM,BR,2011.0,1,0,1
RO,CZ,1997.0,1,0,1
NE,CM,2009.0,2,0,2
MK,ZA,2015.0,1,0,1
MY,UG,2016.0,2,0,2
GB,BF,2011.0,1,0,1
CG,,1998.0,2,0,2
MY,TZ,2016.0,2,0,2
KY,MY,2012.0,1,0,1
SN,RW,2010.0,1,0,1
MW,RW,2020.0,2,0,2
UA,RS,2016.0,1,0,1
ZM,MA,2020.0,1,0,1
DK,GW,2002.0,2,0,2
UG,,2004.0,15,0,15
FI,AR,2005.0,2,0,2
KW,SG,2006.0,1,0,1
FJ,IT,2018.0,2,0,2
BN,,2004.0,2,0,2
KZ,KH,2020.0,1,0,1
NP,NO,2007.0,1,0,1
TR,EG,2011.0,2,0,2
IN,EE,2004.0,1,0,1
GH,BJ,2017.0,2,0,2
AE,CL,2018.0,1,0,1
BH,ME,2019.0,1,0,1
BW,LS,2017.0,1,0,1
PR,PK,2019.0,1,0,1
LK,MK,2014.0,1,0,1
AM,PK,2017.0,1,0,1
TR,LB,2013.0,1,0,1
PL,MD,1997.0,2,0,2
MX,NG,2015.0,1,0,1
JO,nan,2008.0,1,0,1
EC,RU,1999.0,2,0,2
MD,PF,2018.0,1,0,1
JO,YE,2019.0,3,0,3
EG,SE,2023.0,2,0,2
IT,VA,2015.0,1,0,1
HU,ME,2010.0,1,0,1
NI,CL,2020.0,1,0,1
NZ,BN,2003.0,1,0,1
SN,ID,2019.0,1,0,1
VU,US,2006.0,1,0,1
SV,PA,2019.0,1,0,1
IL,MY,2003.0,1,0,1
BI,,2004.0,1,0,1
HR,CN,2004.0,1,0,1
BY,JP,2002.0,2,0,2
IR,BW,2009.0,1,0,1
GB,GF,2003.0,1,0,1
MD,CN,2004.0,1,0,1
SN,RW,2019.0,1,0,1
UA,ZA,2012.0,1,0,1
CV,US,2022.0,1,0,1
NG,SZ,2019.0,1,0,1
PS,BE,2017.0,1,0,1
BI,BF,2012.0,1,0,1
HK,SE,2013.0,1,0,1
AZ,,2001.0,5,0,5
FR,CD,2015.0,4,0,4
GH,MA,2021.0,1,0,1
DE,BI,2009.0,1,0,1
LV,BE,2002.0,1,0,1
CH,PF,2018.0,1,0,1
NO,MW,2020.0,3,0,3
QA,FR,2001.0,1,0,1
TH,AM,2005.0,1,0,1
GF,TZ,2013.0,1,0,1
MK,EG,2017.0,1,0,1
YE,SA,2011.0,1,0,1
MY,TH,1998.0,1,0,1
SE,GH,2007.0,1,0,1
BN,NO,2021.0,1,0,1
MG,GF,2019.0,2,0,2
QA,IN,2006.0,1,0,1
US,TJ,1999.0,1,0,1
EE,AT,2022.0,3,0,3
MA,PH,2008.0,1,0,1
PL,KE,2005.0,1,0,1
AO,FR,2014.0,1,0,1
MY,SD,2000.0,1,0,1
SE,GM,2018.0,1,0,1
PK,BE,2006.0,3,0,3
IE,PA,2017.0,2,0,2
MK,RS,2001.0,1,0,1
PH,MM,2017.0,1,0,1
MR,,2005.0,2,0,2
BG,BY,2012.0,1,0,1
SE,LU,2006.0,1,0,1
TR,PY,2012.0,1,0,1
SK,IE,2000.0,1,0,1
IT,IS,2000.0,1,0,1
NC,AU,2007.0,1,0,1
IL,EE,1998.0,1,0,1
BE,VG,2015.0,1,0,1
BW,PL,2007.0,1,0,1
IR,GE,2019.0,1,0,1
EG,BA,2013.0,1,0,1
SA,BY,1998.0,1,0,1
NI,CR,2010.0,1,0,1
,BT,2002.0,6,0,6
MK,SK,2010.0,1,0,1
CD,HU,2017.0,1,0,1
VA,,2018.0,1,0,1
nan,SY,2000.0,1,0,1
FK,CL,2006.0,1,0,1
NO,HR,2011.0,2,0,2
EG,BW,2006.0,1,0,1
,SJ,1998.0,2,0,2
IN,PE,2007.0,1,0,1
SG,ZA,2012.0,1,0,1
NZ,VG,2018.0,1,0,1
SK,BD,2005.0,1,0,1
NG,CR,2001.0,1,0,1
BE,PE,2013.0,2,0,2
SA,SG,2005.0,1,0,1
MG,CA,2016.0,1,0,1
MO,AT,2011.0,1,0,1
TG,IT,2015.0,1,0,1
nan,UY,2007.0,1,0,1
OM,AE,2003.0,1,0,1
BF,CA,2011.0,2,0,2
BA,PL,2005.0,2,0,2
MC,IT,2012.0,3,0,3
JO,LY,2016.0,1,0,1
US,CM,2000.0,2,0,2
ML,NG,2018.0,1,0,1
SJ,IT,2020.0,1,0,1
HR,UG,2017.0,1,0,1
RS,ZM,2002.0,1,0,1
AT,XK,2020.0,3,0,3
BI,CD,2014.0,1,0,1
AM,CO,2014.0,2,0,2
CU,BO,2020.0,1,0,1
VE,NO,2014.0,2,0,2
CR,nan,2011.0,1,0,1
NZ,LA,2009.0,1,0,1
LK,ID,1999.0,1,0,1
NZ,JM,2006.0,1,0,1
GR,CM,2021.0,1,0,1
PG,TR,2009.0,1,0,1
CM,TW,2016.0,1,0,1
BA,KW,2019.0,1,0,1
BA,BE,2021.0,1,0,1
LU,PL,2014.0,3,3,0
MX,IE,2006.0,2,2,0
CA,VE,2002.0,3,5,-2
SA,UA,2022.0,1,1,0
AE,TR,2014.0,1,6,-5
NG,SA,2002.0,2,1,1
RS,DK,2010.0,1,2,-1
QA,PH,2018.0,1,1,0
HN,nan,2019.0,1,1,0
FR,JO,2011.0,2,5,-3
HU,KR,2018.0,1,5,-4
IL,MX,1998.0,1,2,-1
SG,BR,2010.0,2,4,-2
CZ,UA,2001.0,2,4,-2
AU,OM,2004.0,1,2,-1
UA,NL,2000.0,5,2,3
IE,IL,2021.0,1,2,-1
NZ,OM,2011.0,1,1,0
CU,AU,1998.0,2,1,1
RO,IQ,2016.0,6,2,4
PT,CU,2007.0,2,3,-1
VE,BO,2016.0,1,1,0
KZ,BD,2017.0,1,1,0
KW,DE,2013.0,1,3,-2
BE,GM,2005.0,1,1,0
GH,SE,2021.0,1,2,-1
NL,AR,2022.0,4,7,-3
CU,DE,1997.0,2,1,1
IL,TW,2001.0,2,1,1
NG,HU,2001.0,1,3,-2
TR,LA,2019.0,5,1,4
ZA,SZ,2021.0,2,7,-5
MS,GB,2004.0,2,2,0
SG,PH,2003.0,4,2,2
ID,EC,2018.0,1,3,-2
MT,AR,2012.0,1,2,-1
GB,BB,2005.0,2,5,-3
AU,JM,2005.0,2,1,1
HK,FR,2014.0,1,2,-1
KZ,JP,2009.0,1,2,-1
SG,AT,2015.0,3,5,-2
PG,US,2003.0,3,2,1
CL,KR,2020.0,1,5,-4
ES,UA,2004.0,2,2,0
UY,AU,2007.0,1,1,0
DE,AF,2020.0,1,2,-1
ZA,BD,2016.0,1,1,0
CL,RS,2014.0,1,1,0
HR,RU,2007.0,1,4,-3
CO,SV,2005.0,1,1,0
ZA,BR,1997.0,1,2,-1
VN,MX,2007.0,1,1,0
MW,BE,2015.0,1,1,0
LT,CA,2015.0,1,2,-1
KE,MY,2011.0,1,1,0
SZ,US,2018.0,2,1,1
DZ,ID,2021.0,2,4,-2
PA,SE,2005.0,1,2,-1
CL,PH,2013.0,4,1,3
IE,JO,2006.0,1,1,0
PS,NO,2018.0,2,3,-1
BN,PK,2013.0,1,3,-2
BE,MZ,2007.0,1,6,-5
IL,BR,2022.0,2,3,-1
PS,TR,2015.0,1,1,0
nan,JO,2017.0,1,2,-1
ZM,CN,2019.0,2,2,0
LA,US,2001.0,1,1,0
VE,PL,2019.0,1,2,-1
BR,PA,2001.0,1,2,-1
ZA,PK,2009.0,1,1,0
IR,CO,2009.0,1,1,0
CM,TD,2018.0,1,1,0
QA,ZA,2018.0,1,4,-3
NG,AU,1998.0,2,2,0
BR,BY,2008.0,1,1,0
NL,UA,1999.0,3,3,0
SK,GE,2016.0,1,1,0
VE,BE,2016.0,1,2,-1
AF,MX,2009.0,2,2,0
AU,TN,2011.0,1,1,0
NZ,NP,2000.0,1,4,-3
SD,PK,2015.0,2,5,-3
GT,PT,2016.0,1,2,-1
BE,GA,2014.0,2,2,0
TZ,MY,2019.0,1,3,-2
PK,IN,2024.0,1,1,0
CH,CU,2019.0,1,1,0
MX,NI,2012.0,1,1,0
KW,NG,2006.0,1,1,0
BD,SD,2019.0,1,1,0
BN,EG,2018.0,1,2,-1
IR,ZA,2009.0,1,2,-1
PL,TN,2021.0,1,2,-1
BO,VE,2009.0,1,2,-1
OM,TR,2002.0,1,2,-1
TZ,DK,2014.0,1,2,-1
TW,UA,2001.0,1,2,-1
MZ,BY,2019.0,2,1,1
SA,AR,2014.0,1,2,-1
DO,MX,2021.0,1,4,-3
NL,KH,2009.0,1,2,-1
PT,VE,2002.0,1,1,0
BG,NL,2012.0,1,6,-5
BG,DK,2003.0,1,1,0
CZ,IL,2000.0,1,3,-2
US,HN,2011.0,2,4,-2
AE,NZ,2006.0,2,3,-1
AZ,CY,2019.0,1,1,0
QA,CH,2014.0,1,2,-1
RU,VE,2007.0,1,1,0
MD,CH,2012.0,2,3,-1
CU,BR,2003.0,4,8,-4
FO,GB,2013.0,1,1,0
FR,UY,2005.0,3,6,-3
TW,QA,2013.0,1,2,-1
SA,IT,2023.0,2,1,1
HR,ES,2016.0,3,2,1
PT,IS,2017.0,1,2,-1
LK,JP,1997.0,1,4,-3
CG,US,2016.0,2,4,-2
PL,VN,2013.0,1,1,0
BG,FI,2016.0,1,1,0
AE,KZ,2021.0,1,1,0
PH,EC,2021.0,1,3,-2
PL,AZ,2018.0,1,2,-1
RS,DK,2019.0,3,2,1
FI,HU,2011.0,3,15,-12
JE,US,2008.0,1,1,0
nan,SK,2011.0,1,3,-2
IT,GE,1998.0,1,1,0
PK,IE,2006.0,1,2,-1
nan,LK,2004.0,1,1,0
QA,TR,2022.0,2,2,0
DZ,FI,2019.0,1,1,0
UA,IR,2020.0,1,2,-1
AE,NG,2015.0,1,2,-1
SI,BY,2010.0,1,1,0
ET,NO,2000.0,1,1,0
PT,MZ,2016.0,1,2,-1
BY,GB,2005.0,1,1,0
GN,ML,2021.0,1,3,-2
LA,NZ,2002.0,1,3,-2
PK,GM,2020.0,1,1,0
PL,KZ,2015.0,1,1,0
MD,FI,2006.0,1,1,0
IR,CZ,2012.0,1,3,-2
TW,MA,2021.0,1,1,0
FJ,ID,2016.0,1,1,0
IN,BB,2006.0,1,2,-1
HU,IE,2019.0,1,3,-2
NG,ET,2012.0,1,1,0
OM,FR,2008.0,1,1,0
IQ,ES,2011.0,1,1,0
ZA,LS,2015.0,1,8,-7
HK,GB,2022.0,1,3,-2
US,BZ,2020.0,2,1,1
IT,UY,2020.0,1,7,-6
KN,BR,2022.0,1,2,-1
CH,CI,2015.0,1,1,0
IE,BR,2006.0,1,4,-3
PK,FI,2010.0,1,3,-2
KE,NZ,2016.0,1,1,0
GR,KW,2012.0,2,5,-3
LY,MA,2019.0,1,1,0
DE,DZ,2012.0,1,3,-2
ES,TN,2009.0,1,3,-2
BR,TH,2022.0,1,3,-2
LV,KZ,2021.0,2,1,1
IQ,IT,2009.0,1,1,0
AM,RU,2002.0,2,3,-1
CN,BD,1999.0,1,1,0
BE,DZ,2006.0,1,1,0
VN,RO,2009.0,1,2,-1
ET,CN,2006.0,1,1,0
LB,SA,1997.0,1,1,0
UZ,CZ,2017.0,1,3,-2
DO,PT,2019.0,1,1,0
DZ,ES,2013.0,1,1,0
FI,ZA,1998.0,1,1,0
GA,BF,2015.0,1,2,-1
CZ,NL,1997.0,2,7,-5
MN,DE,2021.0,1,1,0
JO,PS,2009.0,1,1,0
CN,JM,2010.0,1,1,0
AT,RO,2006.0,1,1,0
GB,GA,2014.0,1,1,0
IT,PS,2013.0,1,1,0
ZM,CN,2017.0,1,2,-1
AU,MM,2015.0,1,1,0
CH,NE,2020.0,1,4,-3
MW,MY,2022.0,1,1,0
UY,VE,2021.0,1,1,0
GE,RU,2009.0,1,4,-3
VN,US,1997.0,1,2,-1
JO,LB,2021.0,3,6,-3
JO,AU,2010.0,2,3,-1
BY,JP,2005.0,4,2,2
US,GT,1999.0,2,1,1
MY,SY,2018.0,2,1,1
AU,LU,2022.0,1,1,0
NZ,AT,2008.0,1,1,0
NO,AR,2002.0,1,1,0
LV,LT,2020.0,1,2,-1
SA,PS,2011.0,1,1,0
HR,ME,2011.0,1,1,0
FO,US,2020.0,1,2,-1
GH,nan,2015.0,1,2,-1
LK,GR,2006.0,1,2,-1
SV,BR,2017.0,1,3,-2
CI,IT,2015.0,1,1,0
CN,RU,1997.0,2,1,1
ET,IN,2009.0,2,1,1
ML,AU,2013.0,1,1,0
LA,FR,2018.0,1,1,0
NI,RU,2022.0,1,1,0
RO,PT,1999.0,1,0,1
MK,DK,2014.0,1,0,1
IT,TW,1997.0,2,0,2
CY,AT,2016.0,1,0,1
KW,SE,2012.0,1,0,1
IE,UY,2011.0,1,0,1
BH,GH,2008.0,3,0,3
VN,TR,2002.0,1,0,1
TW,MM,2013.0,1,0,1
IT,BF,2003.0,1,0,1
PK,KZ,2009.0,1,0,1
MC,TN,2019.0,1,0,1
SK,GR,2004.0,1,0,1
GY,,2016.0,2,0,2
ID,KZ,2020.0,2,0,2
NZ,CU,2012.0,1,0,1
DK,EC,2002.0,2,0,2
ZW,CA,2017.0,2,0,2
SN,ET,2018.0,1,0,1
ID,KE,2005.0,1,0,1
NP,KW,2016.0,1,0,1
FJ,IE,2021.0,1,0,1
VG,VN,2011.0,1,0,1
HN,UY,2011.0,2,0,2
TH,CZ,2015.0,1,0,1
HU,CL,2008.0,1,0,1
CA,HK,2001.0,2,0,2
AF,GB,2011.0,2,0,2
AT,SA,2001.0,1,0,1
CN,ML,2014.0,2,0,2
nan,HN,2004.0,1,0,1
CD,nan,2011.0,1,0,1
JE,,2012.0,1,0,1
GH,MK,2022.0,1,0,1
CN,NA,2009.0,2,0,2
UZ,CA,2001.0,1,0,1
PK,NP,2004.0,1,0,1
NC,NO,1999.0,1,0,1
NA,SE,2011.0,1,0,1
CZ,GT,2018.0,1,0,1
DK,LB,2016.0,2,0,2
UA,PK,2016.0,2,0,2
IR,NO,2001.0,1,0,1
NZ,SS,2006.0,1,0,1
NG,UG,2003.0,2,0,2
MK,UA,2016.0,1,0,1
NP,FR,2012.0,1,0,1
RE,CA,2010.0,1,0,1
SD,TN,2007.0,1,0,1
GB,ET,2023.0,1,0,1
TW,SK,2015.0,1,0,1
CO,VE,1998.0,6,0,6
CL,AE,2021.0,1,0,1
AT,ET,2003.0,1,0,1
PT,IS,2010.0,1,0,1
IL,MX,1997.0,1,0,1
PH,MW,2016.0,1,0,1
IE,ET,2011.0,1,0,1
GB,GD,2013.0,1,0,1
CA,PF,2017.0,1,0,1
ZA,CU,2014.0,1,0,1
SR,ID,2020.0,1,0,1
PG,NG,2020.0,2,0,2
ZA,CD,2013.0,1,0,1
,MV,2013.0,2,0,2
DK,CR,1999.0,1,0,1
KW,IE,2016.0,2,0,2
IT,MZ,2002.0,1,0,1
LK,DK,2008.0,3,0,3
MD,ES,2022.0,1,0,1
RU,CD,2020.0,1,0,1
SY,ID,2022.0,1,0,1
PT,IS,2019.0,1,0,1
NG,KE,1998.0,1,0,1
CH,CM,2006.0,3,0,3
DK,MG,2009.0,1,0,1
MX,BZ,2019.0,1,0,1
MK,SK,2017.0,1,0,1
DK,SY,2012.0,1,0,1
MZ,CL,2013.0,1,0,1
BT,IN,2015.0,2,0,2
nan,AE,2003.0,1,0,1
EE,RO,2015.0,1,0,1
SN,ID,2017.0,1,0,1
NZ,LK,2001.0,1,0,1
BO,UY,2018.0,1,0,1
BD,IQ,2015.0,1,0,1
PL,UG,2018.0,1,0,1
BE,PS,2006.0,1,0,1
TW,AM,2000.0,1,0,1
CU,IE,2013.0,1,0,1
JM,MX,2013.0,2,0,2
US,KZ,2001.0,4,0,4
FR,QA,2002.0,1,0,1
IQ,BG,2011.0,1,0,1
PA,AU,2010.0,3,0,3
BE,TH,1998.0,2,0,2
SG,NO,2023.0,2,0,2
CG,MA,2011.0,1,0,1
UZ,TJ,2008.0,1,0,1
TZ,ZA,2000.0,2,0,2
BE,JO,2017.0,1,0,1
FI,TN,2008.0,1,0,1
AU,CZ,2023.0,1,0,1
LI,,2007.0,2,0,2
SY,SE,2008.0,1,0,1
OM,AU,2023.0,1,0,1
SE,JO,2001.0,1,0,1
RU,ZM,2018.0,1,0,1
TH,OM,2010.0,1,0,1
GR,TN,2015.0,1,0,1
BE,ZW,2008.0,1,0,1
,SX,2017.0,1,0,1
NI,NL,2015.0,1,0,1
CW,US,2008.0,1,0,1
AU,JO,1998.0,1,0,1
SK,EG,2011.0,1,0,1
GB,SM,2009.0,2,0,2
XK,NZ,2014.0,1,0,1
CR,EE,2010.0,1,0,1
SN,nan,2009.0,1,0,1
NG,TG,2021.0,1,0,1
BA,MX,2006.0,1,0,1
nan,UG,2017.0,1,0,1
CD,ID,2017.0,1,0,1
ST,PT,2006.0,1,0,1
CN,AG,2012.0,1,0,1
BR,GL,2022.0,1,0,1
PH,RU,2008.0,1,0,1
HR,GR,2015.0,1,0,1
MY,ZA,2006.0,1,0,1
QA,OM,2006.0,1,0,1
BD,NO,2004.0,1,0,1
IQ,NZ,2003.0,1,0,1
IQ,TN,2014.0,1,0,1
ID,RO,2011.0,1,0,1
CG,NO,2010.0,1,0,1
AZ,CN,2004.0,1,0,1
KE,ZM,2007.0,1,0,1
PH,LY,2019.0,1,0,1
PS,AU,2019.0,2,0,2
IT,MU,2020.0,1,0,1
MZ,CN,2020.0,1,0,1
MN,IT,2013.0,1,0,1
RW,BI,2017.0,1,0,1
PA,PT,2010.0,1,0,1
JM,IN,2006.0,1,0,1
RU,UY,2006.0,1,0,1
NP,LK,2017.0,1,0,1
QA,CU,2015.0,1,0,1
CZ,XK,2005.0,1,0,1
BR,MT,2004.0,3,0,3
SN,AE,2021.0,1,0,1
UA,BE,1997.0,2,0,2
BF,ES,2017.0,1,0,1
CA,GF,2021.0,1,0,1
GA,PK,2001.0,1,0,1
CM,NL,2002.0,1,0,1
IT,JM,2016.0,1,0,1
YE,EG,2000.0,2,0,2
RO,nan,2011.0,2,0,2
ME,BA,2014.0,1,0,1
SK,KE,2017.0,1,0,1
FI,RS,2023.0,1,0,1
BN,US,2001.0,1,0,1
BA,PL,2002.0,1,0,1
SA,CM,2022.0,1,0,1
AT,LB,2015.0,1,0,1
GR,TH,2016.0,1,0,1
NO,AR,2005.0,1,0,1
CZ,JM,2021.0,1,0,1
AE,CO,2009.0,1,0,1
CG,GB,2009.0,1,0,1
TJ,IR,2008.0,1,0,1
TT,MY,2001.0,1,0,1
JM,GD,2007.0,1,0,1
NO,MZ,2010.0,1,0,1
FO,IS,2014.0,1,0,1
CY,SK,2022.0,2,0,2
RE,CA,2017.0,1,0,1
TH,SO,2020.0,1,0,1
MG,LU,2002.0,1,0,1
UG,DK,2004.0,1,0,1
UA,TR,2009.0,1,0,1
ZM,TH,2002.0,1,0,1
TR,JO,2014.0,1,0,1
BH,NO,2015.0,1,0,1
BD,MX,2005.0,1,0,1
BW,SE,2008.0,1,0,1
HU,LU,2016.0,1,0,1
UA,BE,1998.0,1,0,1
GH,PT,2015.0,1,0,1
JP,BW,2011.0,2,0,2
DZ,FI,2010.0,1,0,1
BR,AL,2009.0,1,0,1
AE,IR,2003.0,1,0,1
LT,ID,2012.0,1,0,1
VG,CN,2005.0,1,0,1
IL,SG,2006.0,1,0,1
MA,TR,2010.0,1,0,1
ZM,DE,2020.0,1,0,1
JP,EC,2016.0,2,0,2
MG,TN,2011.0,1,0,1
PE,CG,2002.0,1,0,1
MY,CD,2016.0,1,0,1
AR,EE,2007.0,1,0,1
NL,SS,2003.0,1,0,1
SY,ES,2011.0,1,0,1
DE,KN,2008.0,1,0,1
BY,CR,2018.0,1,0,1
ES,KW,2016.0,1,0,1
CH,BD,2007.0,1,0,1
AZ,CZ,2015.0,1,0,1
NO,SG,1997.0,1,0,1
AO,ES,1999.0,1,0,1
EG,nan,2003.0,1,0,1
ES,MO,2022.0,1,0,1
PE,BJ,2012.0,1,0,1
GB,TN,2022.0,2,0,2
BJ,TN,2010.0,1,0,1
SZ,NL,2021.0,1,0,1
NL,MW,2002.0,1,0,1
UG,IN,2006.0,1,0,1
IN,MK,2004.0,1,0,1
AR,SG,2011.0,1,0,1
CM,NE,2021.0,1,0,1
JP,GT,2017.0,1,0,1
SM,IT,2002.0,1,0,1
DE,SJ,2010.0,1,0,1
ZM,nan,2013.0,1,0,1
LB,PS,2021.0,1,0,1
GB,CI,2003.0,1,0,1
CZ,MC,2015.0,1,0,1
CI,NG,2014.0,1,0,1
ID,ZA,2002.0,1,0,1
HK,SK,2005.0,1,0,1
SN,TR,2016.0,1,0,1
CO,MN,2013.0,1,0,1
MM,ES,2017.0,1,0,1
UG,CG,2014.0,1,0,1
PS,MY,2023.0,1,0,1
VE,CH,2019.0,1,0,1
VN,CL,2000.0,1,0,1
BW,BA,2020.0,1,0,1
MX,MZ,2022.0,1,0,1
ES,BJ,2010.0,1,0,1
CN,ES,2012.0,58,68,-10
SG,CN,2019.0,624,460,164
KR,US,2020.0,1303,1305,-2
AU,DE,2000.0,73,80,-7
BR,nan,2015.0,119,122,-3
IN,KR,2005.0,72,49,23
KR,AU,2022.0,32,37,-5
US,GB,2016.0,6126,6202,-76
NZ,GB,2001.0,119,124,-5
ZA,US,2020.0,402,313,89
AU,US,2021.0,1996,2053,-57
US,IL,2008.0,392,473,-81
US,RU,2013.0,483,383,100
DE,US,2020.0,2338,2468,-130
KR,JP,2004.0,170,217,-47
CA,FR,2013.0,543,631,-88
US,DE,2001.0,1570,1732,-162
FR,LU,2021.0,26,21,5
CL,AR,2013.0,74,91,-17
CH,SN,2017.0,3,3,0
JP,CN,2007.0,690,386,304
US,KR,2003.0,771,768,3
GB,IE,2004.0,208,152,56
AT,AU,2016.0,30,32,-2
US,BE,2004.0,146,209,-63
CH,DE,2011.0,659,943,-284
GB,DE,2018.0,993,1003,-10
AU,NL,2010.0,70,72,-2
SE,GB,2001.0,92,83,9
FR,EG,2017.0,33,29,4
VN,NL,2022.0,5,2,3
CO,CL,2012.0,151,187,-36
TW,IN,2013.0,45,45,0
NP,IN,2013.0,77,82,-5
GB,SG,2015.0,186,136,50
US,SG,1999.0,138,90,48
FI,US,2018.0,176,147,29
RO,IT,2021.0,17,8,9
ES,US,2021.0,863,742,121
IT,CL,1998.0,3,3,0
CO,MX,2016.0,354,409,-55
DE,GB,2019.0,995,1080,-85
JP,DE,2019.0,224,195,29
CN,nan,2007.0,146,238,-92
FR,GB,2015.0,652,548,104
GB,BR,2004.0,104,97,7
CN,QA,2022.0,22,40,-18
UY,US,2021.0,20,23,-3
IN,NP,2018.0,175,141,34
CL,ES,2022.0,249,210,39
US,SE,2016.0,487,477,10
MX,ES,2013.0,721,756,-35
FR,CH,2008.0,347,361,-14
IT,ES,2016.0,283,269,14
JP,SG,2013.0,41,44,-3
DE,GB,2017.0,964,953,11
IN,US,2004.0,1059,835,224
nan,CO,2016.0,11,7,4
BD,KR,2009.0,6,6,0
DK,SE,2018.0,151,141,10
SI,HR,2009.0,14,13,1
PL,CZ,2014.0,41,45,-4
AT,DE,2014.0,528,656,-128
AE,SA,2014.0,12,24,-12
DE,AU,2012.0,225,203,22
GB,GR,2013.0,168,205,-37
ZA,AU,2014.0,79,62,17
MX,AR,2022.0,59,65,-6
CA,CN,2018.0,613,488,125
IE,GB,2008.0,254,272,-18
GB,NZ,2021.0,228,213,15
CU,FR,2000.0,3,3,0
US,FR,2018.0,1503,1643,-140
DE,CH,2008.0,740,558,182
CA,IT,2003.0,71,39,32
CN,TW,2018.0,756,1681,-925
MX,CH,2005.0,3,3,0
AU,HU,2019.0,15,15,0
CH,AT,2013.0,110,120,-10
NL,US,2021.0,652,711,-59
SG,CN,2017.0,587,478,109
RU,US,2002.0,393,223,170
IT,UA,2007.0,19,9,10
BR,DE,2016.0,239,273,-34
CF,NC,2001.0,1,1,0
BE,NL,2015.0,278,300,-22
CA,HK,2003.0,3,3,0
PK,CN,2015.0,109,63,46
NO,BR,2021.0,16,22,-6
FR,MD,2021.0,27,36,-9
DK,CN,2004.0,19,8,11
BR,PT,1998.0,112,142,-30
KR,BD,2015.0,17,34,-17
AU,RS,2009.0,2,4,-2
KR,QA,2019.0,6,1,5
NL,IT,2007.0,72,85,-13
AU,MY,2010.0,50,49,1
MX,UY,1998.0,1,2,-1
UY,MX,2008.0,3,4,-1
NZ,JP,2012.0,16,10,6
FR,CN,2020.0,239,131,108
CN,IT,2009.0,29,43,-14
DK,DE,1998.0,47,43,4
CH,PT,2021.0,19,24,-5
AU,IN,2012.0,115,131,-16
DK,GB,2012.0,98,116,-18
RS,HR,2006.0,60,53,7
DE,IT,2006.0,172,160,12
IT,CH,2000.0,110,98,12
FI,CA,2013.0,19,22,-3
CZ,PL,1998.0,10,7,3
TW,JP,2014.0,89,75,14
AU,SE,2021.0,50,55,-5
DE,ES,2007.0,161,127,34
FR,AL,2008.0,1,1,0
DK,ES,2018.0,40,46,-6
US,CH,2004.0,536,498,38
FR,AU,2014.0,141,149,-8
BE,FR,2006.0,240,217,23
ES,DE,2016.0,280,190,90
MX,US,2016.0,449,456,-7
IT,GR,2022.0,37,30,7
RU,US,2005.0,342,252,90
nan,US,2022.0,133,115,18
BR,CL,2022.0,49,53,-4
AU,MY,2017.0,154,166,-12
MX,RS,2007.0,41,18,23
VE,IT,2013.0,4,3,1
PH,CN,2011.0,27,13,14
IT,DE,2021.0,301,291,10
IN,JP,2006.0,109,120,-11
CH,TH,2003.0,2,2,0
NL,FI,2019.0,30,47,-17
FI,NL,2022.0,25,22,3
NL,AU,2008.0,78,54,24
NZ,CN,2013.0,41,32,9
GB,PL,2016.0,103,105,-2
MY,MM,2018.0,12,4,8
CH,PL,1998.0,11,9,2
AM,DE,2015.0,12,1,11
IN,TZ,2012.0,4,2,2
NL,PL,2002.0,12,2,10
US,CZ,1999.0,53,53,0
NL,CN,1998.0,17,16,1
TW,AU,2003.0,9,17,-8
CZ,CN,2012.0,48,51,-3
CN,BE,2013.0,103,45,58
CO,AU,2014.0,9,7,2
CN,VN,2013.0,22,29,-7
CN,MX,2011.0,8,12,-4
UA,DE,2017.0,44,25,19
ES,GB,2003.0,165,144,21
GB,NG,2021.0,80,104,-24
GB,AR,2014.0,26,35,-9
KR,IN,2014.0,142,203,-61
GB,VN,2011.0,10,3,7
nan,FR,2009.0,162,178,-16
BD,IN,2015.0,115,123,-8
TT,JM,2020.0,13,13,0
JP,ZA,1997.0,4,2,2
SE,NO,2020.0,110,104,6
FI,DE,2020.0,71,58,13
BD,CN,2017.0,104,38,66
IT,nan,2012.0,172,89,83
CZ,IT,2018.0,37,34,3
TR,IR,2019.0,30,50,-20
JP,DE,2010.0,200,181,19
NL,ES,2015.0,68,114,-46
BR,DK,2015.0,28,18,10
HU,GB,2020.0,39,41,-2
GB,JP,1997.0,161,128,33
PK,AU,2018.0,60,52,8
BE,IT,2017.0,131,179,-48
US,ID,2021.0,279,232,47
IT,RU,2020.0,86,55,31
DE,TR,2014.0,97,65,32
GB,JP,1998.0,184,194,-10
NZ,RU,2016.0,12,3,9
AU,MY,2019.0,136,159,-23
IT,AU,2022.0,35,32,3
AU,ID,2011.0,41,17,24
NO,IN,2015.0,22,22,0
PY,CU,2016.0,2,5,-3
IN,nan,2020.0,113,121,-8
PT,US,2020.0,206,197,9
JP,LT,2007.0,10,11,-1
IT,JP,2004.0,45,37,8
FR,RU,2013.0,83,69,14
CH,IN,2006.0,14,30,-16
IT,AZ,2012.0,2,2,0
VE,ES,2003.0,54,36,18
IN,NZ,2014.0,24,20,4
GB,TR,2000.0,60,22,38
nan,CZ,2015.0,7,7,0
nan,AR,2005.0,25,19,6
UG,CD,2020.0,6,5,1
BN,EG,2019.0,3,3,0
IT,ZA,2013.0,22,11,11
TR,GB,2012.0,83,99,-16
NZ,AU,2009.0,183,128,55
UA,DE,2010.0,36,21,15
ID,CN,2020.0,258,331,-73
IT,CN,2008.0,41,31,10
IR,GB,2015.0,114,84,30
IT,AR,2007.0,58,59,-1
GR,US,2005.0,135,143,-8
BR,JP,2015.0,42,54,-12
AR,PE,2009.0,12,10,2
GB,PK,2006.0,48,42,6
RU,BG,2012.0,26,24,2
JO,US,2015.0,44,57,-13
JP,ID,2022.0,78,87,-9
CH,FR,2021.0,293,344,-51
CM,TZ,2019.0,2,1,1
DK,IQ,2021.0,1,2,-1
JO,AU,2018.0,7,14,-7
DE,RO,2010.0,31,17,14
IT,PT,1997.0,14,3,11
CR,AU,2014.0,3,1,2
TR,KZ,2016.0,46,59,-13
DZ,SA,2020.0,12,4,8
nan,ES,2014.0,41,58,-17
IN,PK,2013.0,154,195,-41
RS,BA,2017.0,55,29,26
ES,IL,2008.0,9,13,-4
BG,IT,2000.0,5,1,4
ID,CA,2016.0,27,40,-13
NO,DE,2013.0,56,106,-50
SG,CA,2019.0,62,59,3
CZ,DE,2006.0,52,44,8
BR,PT,1997.0,71,95,-24
BR,BE,2022.0,41,27,14
US,EC,2001.0,6,4,2
EG,US,2001.0,72,62,10
ZA,RU,2010.0,1,5,-4
BD,CN,2019.0,97,42,55
CA,IN,2003.0,89,120,-31
MY,BD,2008.0,13,11,2
SE,LT,2002.0,1,4,-3
MY,IT,2004.0,42,43,-1
MA,IT,2013.0,23,14,9
CO,PY,2015.0,12,5,7
AT,CN,2005.0,19,3,16
LY,IQ,2012.0,3,1,2
AR,CR,2010.0,12,12,0
SA,LB,2016.0,5,4,1
GR,US,2002.0,97,139,-42
AR,FR,1999.0,13,16,-3
GB,nan,2012.0,83,88,-5
AU,PH,2005.0,6,3,3
DZ,FR,2011.0,71,147,-76
RU,FI,2005.0,21,12,9
CA,MK,2022.0,2,1,1
NO,DK,2022.0,78,58,20
AU,LK,2016.0,28,28,0
FR,TH,2013.0,29,16,13
RU,PL,2017.0,33,43,-10
MA,ES,2018.0,12,16,-4
RS,BA,2019.0,55,43,12
TW,HU,2017.0,1,1,0
IT,GB,2003.0,245,218,27
LU,US,2022.0,10,12,-2
UG,CH,2020.0,4,1,3
FR,GR,2022.0,20,28,-8
CA,MY,2016.0,43,36,7
CZ,IN,2018.0,12,26,-14
DE,PT,2020.0,44,44,0
IN,IT,2009.0,60,47,13
RU,KZ,2020.0,112,92,20
TW,DE,2000.0,8,12,-4
SN,BF,2019.0,2,3,-1
JP,PK,2008.0,19,6,13
GR,NO,2021.0,6,8,-2
IT,SG,2022.0,9,4,5
DE,TW,2020.0,27,24,3
IN,PH,2007.0,10,8,2
ES,LU,2022.0,6,6,0
RU,PL,2019.0,47,61,-14
HR,DE,2015.0,31,19,12
LT,CH,2005.0,1,1,0
AU,KR,2012.0,35,37,-2
UY,BR,2002.0,21,11,10
AU,FI,2009.0,7,13,-6
CN,SE,2022.0,61,107,-46
ES,FR,1999.0,101,137,-36
HU,CH,2014.0,29,16,13
MY,MA,2019.0,6,2,4
GB,TH,2007.0,41,28,13
TH,AU,2021.0,11,16,-5
AU,NL,2019.0,113,129,-16
PK,CA,1999.0,6,3,3
ZA,BH,2020.0,3,4,-1
ID,EG,2016.0,6,21,-15
ZA,JP,2016.0,3,7,-4
DE,RO,2017.0,50,37,13
UY,ES,2008.0,29,32,-3
SA,YE,2016.0,7,19,-12
BE,IR,2019.0,29,28,1
CN,PH,2018.0,19,23,-4
KE,AU,2018.0,13,7,6
BE,IR,2017.0,18,31,-13
US,PE,2022.0,64,77,-13
CH,DK,2003.0,20,17,3
DK,NO,2008.0,57,62,-5
IN,LK,2014.0,12,6,6
SE,RU,2007.0,23,17,6
US,OM,2012.0,15,11,4
AR,VE,2010.0,19,10,9
FR,NO,2002.0,22,34,-12
SG,BR,2018.0,6,8,-2
IR,RO,2019.0,2,1,1
SE,BR,2019.0,31,54,-23
CO,FR,2021.0,42,23,19
AU,PG,2009.0,5,3,2
PK,NG,2022.0,7,7,0
SE,FI,2014.0,77,93,-16
nan,NL,2008.0,66,46,20
AR,GB,2020.0,45,34,11
ZA,nan,2020.0,7,8,-1
TR,DZ,2021.0,1,5,-4
ES,AT,2023.0,2,1,1
NG,CN,2020.0,45,27,18
ES,SE,2016.0,93,50,43
EE,US,2017.0,23,18,5
CR,ES,2014.0,45,46,-1
CU,US,2016.0,46,17,29
FR,OM,2001.0,2,1,1
US,PL,2016.0,272,262,10
FR,SE,2013.0,92,56,36
MY,US,2013.0,127,221,-94
ET,KR,2004.0,82,65,17
TR,US,2002.0,202,236,-34
RU,UA,2015.0,239,411,-172
AU,NL,2017.0,101,125,-24
US,GH,2020.0,60,66,-6
BE,GB,2011.0,108,131,-23
FR,NZ,2021.0,29,16,13
TR,US,2005.0,235,326,-91
JP,IE,2008.0,32,15,17
CL,PA,2011.0,4,4,0
UG,BR,2021.0,1,1,0
US,RO,2005.0,37,35,2
VE,CO,2011.0,48,40,8
IT,RO,2015.0,25,19,6
SG,IT,2011.0,3,7,-4
MD,FR,2017.0,56,31,25
UA,DE,2019.0,43,31,12
UG,GB,2021.0,31,15,16
US,FI,2015.0,140,155,-15
EC,US,2013.0,22,42,-20
BE,IT,2019.0,130,200,-70
JO,IQ,2017.0,15,5,10
RU,CN,2021.0,70,49,21
GB,GM,2018.0,29,11,18
CA,IL,2013.0,53,59,-6
RO,CA,2009.0,10,12,-2
JP,AU,2012.0,81,65,16
TW,FR,2013.0,15,15,0
RE,FR,2008.0,17,18,-1
IN,KR,2002.0,58,21,37
GR,IN,2013.0,3,4,-1
ES,IS,2018.0,5,2,3
FR,MA,2013.0,310,202,108
BE,PL,2018.0,21,18,3
VN,GR,2007.0,4,6,-2
KE,NZ,2022.0,1,1,0
GB,VE,2004.0,8,7,1
RS,GB,2000.0,5,5,0
DE,RO,2019.0,51,36,15
IR,AU,2005.0,11,19,-8
PK,IR,2021.0,12,18,-6
SE,IR,2011.0,20,31,-11
CH,SE,2022.0,33,50,-17
AT,HU,2016.0,30,37,-7
AU,OM,2014.0,8,2,6
FR,AR,2014.0,92,100,-8
JO,IQ,2019.0,19,9,10
IE,DE,2016.0,99,101,-2
SE,ET,2018.0,10,8,2
US,BS,2011.0,1,2,-1
SI,DK,2010.0,4,3,1
CO,ES,2000.0,39,48,-9
CA,DK,2013.0,33,33,0
FR,NC,2012.0,19,11,8
EG,SD,2013.0,12,15,-3
NP,AU,2018.0,21,12,9
UA,HU,2011.0,3,1,2
AR,VE,2019.0,13,17,-4
RU,ET,2017.0,9,5,4
CU,AR,2012.0,15,12,3
FR,SK,2013.0,14,7,7
IT,JO,2014.0,2,1,1
FR,MQ,2014.0,22,9,13
MA,DE,2018.0,7,7,0
CL,IN,2016.0,8,3,5
PE,EC,2012.0,4,3,1
EG,TW,2011.0,9,6,3
IT,CZ,2001.0,21,18,3
AT,CA,2004.0,17,22,-5
RS,TR,2006.0,56,61,-5
IE,EG,2020.0,9,12,-3
CH,MX,2000.0,2,4,-2
US,RO,2002.0,24,50,-26
NL,CY,2015.0,4,1,3
CZ,UZ,2012.0,4,2,2
ST,BR,2018.0,32,28,4
MX,DE,2001.0,9,16,-7
BE,IT,2010.0,65,106,-41
DE,UA,2018.0,29,40,-11
KR,OM,2021.0,1,2,-1
JP,CA,2015.0,92,113,-21
AU,NG,2019.0,12,17,-5
AR,CR,2017.0,18,19,-1
TN,ES,2017.0,7,8,-1
TR,JP,2004.0,55,39,16
NO,GB,1998.0,17,22,-5
IN,SG,2007.0,38,47,-9
nan,CL,2020.0,9,2,7
MA,IR,2019.0,6,10,-4
AU,FR,2004.0,42,52,-10
RS,DK,2018.0,6,2,4
HR,AT,2018.0,15,6,9
CL,CO,2005.0,74,47,27
SE,BR,2010.0,19,19,0
KR,CA,1998.0,10,13,-3
UA,EC,2009.0,9,16,-7
CL,VE,2020.0,19,30,-11
AZ,RU,2007.0,4,4,0
CZ,LT,2011.0,33,3,30
SE,FR,2006.0,49,45,4
KR,QA,2017.0,5,3,2
BD,CN,2010.0,56,54,2
KZ,UZ,2019.0,7,4,3
NG,NL,2012.0,8,2,6
PK,TR,2022.0,17,8,9
GB,EE,2016.0,9,10,-1
GB,BD,2003.0,14,27,-13
DE,AE,2018.0,20,10,10
GR,NZ,2020.0,1,1,0
SE,VN,2013.0,6,5,1
NG,NO,2016.0,3,3,0
MY,GB,2011.0,52,163,-111
CN,AE,2021.0,7,4,3
DE,UZ,2019.0,4,1,3
BR,PY,2016.0,9,7,2
SG,MY,2006.0,30,24,6
ZA,GB,2023.0,9,6,3
BG,nan,2010.0,3,3,0
IQ,IR,2015.0,5,5,0
FR,TW,2009.0,19,10,9
FJ,NZ,2016.0,3,2,1
ES,PA,2009.0,5,4,1
PL,FR,2009.0,47,42,5
IT,IL,2014.0,24,18,6
IL,CN,2004.0,16,20,-4
PY,CL,2019.0,6,13,-7
MY,PK,2012.0,31,48,-17
AU,GR,2007.0,8,6,2
IN,OM,2018.0,27,21,6
BD,MA,2022.0,17,10,7
ES,PH,2011.0,12,14,-2
SE,MX,1998.0,2,1,1
SG,CA,2017.0,47,52,-5
AL,GH,2020.0,2,1,1
SD,MY,2019.0,7,13,-6
SG,IL,2010.0,3,3,0
SG,DE,1999.0,2,5,-3
IR,IT,2001.0,5,1,4
AU,BH,2018.0,4,1,3
VE,US,2012.0,53,29,24
IR,RU,2005.0,2,21,-19
SE,IS,2022.0,7,9,-2
UG,ZA,2013.0,9,8,1
IN,EG,2022.0,8,9,-1
PK,NP,2014.0,3,4,-1
CN,AM,2003.0,4,2,2
EE,US,2010.0,10,7,3
LA,TR,2021.0,1,10,-9
DE,SE,1997.0,56,36,20
nan,SE,2022.0,8,4,4
HK,CN,2004.0,12,14,-2
CN,LB,2021.0,22,7,15
PK,CH,2012.0,23,17,6
CN,IL,2015.0,16,8,8
CA,NG,2022.0,7,17,-10
AU,NG,2017.0,6,12,-6
FI,PK,2015.0,2,7,-5
CU,MX,2008.0,36,32,4
AE,EG,2006.0,13,6,7
EG,JO,2022.0,18,13,5
CZ,FR,2005.0,24,22,2
EG,TR,2014.0,4,7,-3
CA,OM,2019.0,10,10,0
CA,SK,2009.0,4,5,-1
JP,GH,2015.0,7,1,6
RS,BA,2010.0,15,18,-3
AR,UY,2022.0,15,11,4
RS,NL,2020.0,8,12,-4
SG,DZ,2020.0,2,5,-3
EG,MY,2022.0,18,19,-1
PL,TW,2022.0,7,1,6
ZA,ZM,2018.0,14,6,8
JP,TN,2018.0,3,2,1
FR,EG,2019.0,47,15,32
JM,CA,2013.0,6,3,3
ES,PT,2000.0,41,34,7
IT,GH,2014.0,3,2,1
ZA,BW,2012.0,15,14,1
NZ,AE,2005.0,2,2,0
BE,CZ,2002.0,4,4,0
US,AM,2015.0,16,8,8
NO,nan,1997.0,5,2,3
MX,SV,2008.0,3,2,1
BG,ES,2016.0,3,11,-8
MD,US,2010.0,8,4,4
DE,SE,1998.0,64,68,-4
IN,TR,2015.0,18,13,5
TR,IR,2010.0,7,7,0
LT,UA,2014.0,2,1,1
NO,ES,2008.0,19,28,-9
RS,BE,2016.0,9,4,5
AR,SE,2017.0,4,7,-3
HU,RU,2020.0,19,25,-6
FR,NO,2005.0,34,27,7
GB,RS,2007.0,7,16,-9
PL,UA,2004.0,5,9,-4
NL,RO,2004.0,2,4,-2
SK,GB,2021.0,7,8,-1
ZA,NL,2011.0,37,32,5
nan,AR,2002.0,15,14,1
FR,PS,2021.0,3,2,1
BE,SE,2020.0,37,42,-5
HU,PL,2015.0,8,21,-13
TR,AT,1999.0,2,7,-5
RU,IL,2004.0,20,17,3
KR,CH,2017.0,16,18,-2
AU,HU,2017.0,11,14,-3
IL,CA,2001.0,24,22,2
SE,TZ,2020.0,5,6,-1
FI,NO,2021.0,32,28,4
US,BG,2011.0,32,23,9
SA,AU,2014.0,21,42,-21
BE,SA,2015.0,8,1,7
CA,OM,2010.0,7,4,3
MX,FR,2022.0,27,31,-4
HU,nan,2013.0,7,4,3
UY,BR,2005.0,37,16,21
TR,DE,2004.0,19,25,-6
RU,ZA,2010.0,5,1,4
PL,NL,2005.0,11,7,4
PT,NO,2009.0,4,2,2
IS,GB,2016.0,9,4,5
AT,SE,2021.0,23,35,-12
DE,ID,2008.0,15,5,10
PK,AF,2021.0,2,5,-3
EG,CN,2002.0,3,6,-3
NZ,AT,2013.0,5,1,4
CL,US,2000.0,58,61,-3
NO,RU,2008.0,5,30,-25
KR,CH,2019.0,29,17,12
RU,JP,2001.0,41,30,11
PY,CL,2017.0,5,7,-2
OM,AE,2001.0,3,1,2
PT,AR,2008.0,5,9,-4
CO,AT,2015.0,3,2,1
EG,OM,2019.0,14,10,4
FI,JP,2015.0,12,10,2
IL,NL,1999.0,8,6,2
US,DO,2006.0,1,1,0
HK,GB,2016.0,7,3,4
HR,CN,2014.0,3,3,0
NL,CN,1997.0,9,15,-6
TW,HU,2010.0,2,2,0
nan,AU,2008.0,22,39,-17
SA,UA,2016.0,1,1,0
AT,ID,2018.0,10,5,5
IT,FI,2012.0,17,16,1
ZA,ES,2001.0,3,2,1
AT,CZ,2004.0,4,9,-5
FR,EE,2013.0,6,5,1
VG,AU,2008.0,2,2,0
GB,SS,2008.0,8,12,-4
EG,FR,2003.0,1,5,-4
JP,CO,1999.0,7,1,6
BH,GH,2013.0,4,5,-1
EG,PK,2013.0,9,10,-1
DK,TW,2009.0,2,1,1
KR,IL,2005.0,3,1,2
BE,VN,2007.0,2,4,-2
US,KZ,2003.0,3,4,-1
UA,FR,1999.0,15,8,7
ZA,TN,2018.0,2,1,1
NP,JP,2011.0,9,5,4
BH,US,2013.0,8,13,-5
LY,GB,2016.0,5,12,-7
EE,CA,2020.0,4,5,-1
RO,VN,2011.0,6,9,-3
CZ,BY,2002.0,4,7,-3
SE,BD,2021.0,8,2,6
NZ,FR,2016.0,13,14,-1
CG,UG,2015.0,1,1,0
ET,EG,2015.0,4,6,-2
GB,AE,2023.0,3,1,2
MD,TN,2006.0,6,9,-3
IN,RO,2016.0,20,16,4
FR,EG,2010.0,21,17,4
BD,DE,2006.0,2,4,-2
IL,PL,2005.0,4,5,-1
CL,CO,2002.0,17,32,-15
GB,ZW,2022.0,4,5,-1
RU,TJ,2014.0,25,33,-8
ET,US,2013.0,33,24,9
CN,NZ,2003.0,12,17,-5
GR,KR,2012.0,2,1,1
IN,ES,2006.0,12,10,2
SG,ES,2009.0,3,2,1
PH,AU,2018.0,28,19,9
PH,CH,2007.0,3,2,1
CR,CH,2009.0,1,1,0
AU,IR,2008.0,34,26,8
FI,EE,1998.0,6,3,3
FR,PA,2013.0,3,1,2
BE,SK,2003.0,3,2,1
CZ,BY,2005.0,4,4,0
SE,JP,2012.0,25,29,-4
MZ,PL,2003.0,10,3,7
BG,US,2012.0,29,25,4
PT,AO,2020.0,2,4,-2
HN,ES,2006.0,4,2,2
AU,HU,2010.0,10,11,-1
AU,RO,2015.0,2,5,-3
BE,PE,2008.0,1,2,-1
AU,NP,2002.0,1,1,0
CZ,ES,2012.0,12,17,-5
AT,KE,2011.0,3,1,2
PH,PT,2020.0,2,1,1
GT,EC,2018.0,4,1,3
RU,EE,2020.0,10,11,-1
GB,NP,2005.0,1,3,-2
CZ,BR,2019.0,7,14,-7
PE,CL,2022.0,35,21,14
BI,GB,2017.0,2,2,0
IL,GB,2000.0,20,22,-2
SD,MY,2017.0,4,9,-5
TR,ES,2009.0,10,4,6
SK,IT,2007.0,13,8,5
JP,NG,2020.0,22,26,-4
SE,ZA,2012.0,12,18,-6
GE,nan,2014.0,3,6,-3
BO,CR,2020.0,1,1,0
FR,CM,1998.0,3,7,-4
KH,US,2010.0,2,3,-1
ZM,GH,2011.0,6,18,-12
GH,FR,2020.0,4,2,2
AU,SI,2005.0,2,1,1
TH,NL,2016.0,7,11,-4
DZ,ES,2008.0,2,1,1
NO,PL,2002.0,6,2,4
TR,CA,2004.0,12,9,3
UG,AT,2014.0,2,2,0
CZ,BR,2017.0,7,6,1
IT,NG,2021.0,7,8,-1
MA,PK,2016.0,18,19,-1
DE,CM,2016.0,4,4,0
AO,BR,2007.0,12,7,5
DK,JP,2015.0,17,16,1
CZ,FR,2002.0,14,12,2
FR,PF,2014.0,8,11,-3
US,BH,2021.0,13,13,0
PH,TH,2007.0,1,2,-1
CA,QA,2018.0,18,17,1
CZ,HU,2007.0,8,2,6
IL,BR,2016.0,11,7,4
FI,IT,2011.0,8,24,-16
SI,BE,2009.0,6,2,4
IR,SA,2011.0,5,2,3
JO,SE,2011.0,3,1,2
US,BJ,2012.0,2,2,0
KW,IN,2018.0,17,11,6
CA,ET,2004.0,1,1,0
TR,PL,2018.0,5,3,2
BI,FR,2020.0,15,26,-11
BR,UA,2019.0,13,5,8
ES,UA,2014.0,4,3,1
ES,PY,2015.0,16,8,8
QA,TR,2016.0,2,2,0
DZ,CA,2003.0,9,1,8
CH,ZW,2007.0,3,2,1
LV,CH,2019.0,3,3,0
TZ,DE,2012.0,5,1,4
IE,NO,2005.0,2,1,1
MX,BO,2012.0,7,5,2
TN,PK,2017.0,1,1,0
AU,CH,1999.0,20,32,-12
BR,PH,2022.0,6,3,3
BE,DE,2023.0,6,1,5
NZ,CL,2012.0,1,5,-4
PT,SE,2008.0,7,9,-2
HU,RS,2002.0,1,1,0
IL,PL,2002.0,3,4,-1
BR,PE,2006.0,9,10,-1
CZ,BR,2010.0,4,2,2
OM,SA,2009.0,3,3,0
TW,NL,2007.0,1,1,0
PT,RO,2010.0,6,1,5
IL,TW,2003.0,1,1,0
MX,CO,1998.0,12,18,-6
SE,UY,2009.0,3,1,2
IE,FI,2020.0,7,6,1
KE,FR,2009.0,8,7,1
QA,AE,2005.0,1,1,0
KR,nan,2009.0,20,15,5
SD,GB,2013.0,3,9,-6
VN,PL,2022.0,4,3,1
NL,IN,2001.0,7,12,-5
ZA,IR,2021.0,2,3,-1
TW,CH,2022.0,10,5,5
PT,RU,2009.0,3,7,-4
PY,AR,2020.0,16,10,6
TN,PK,2019.0,3,2,1
SE,ID,2022.0,3,4,-1
HU,FR,2009.0,24,18,6
DE,VN,1997.0,2,1,1
PH,KR,2006.0,3,2,1
SY,DE,2017.0,2,2,0
IN,AR,2014.0,7,5,2
GE,GB,2002.0,6,8,-2
TR,KW,2005.0,4,1,3
KR,MX,2018.0,4,7,-3
PL,JP,2006.0,10,16,-6
RS,IE,2009.0,1,3,-2
CA,MA,1998.0,2,3,-1
SK,NL,1997.0,3,5,-2
NG,IT,2013.0,8,7,1
SE,KR,2014.0,5,11,-6
CR,BR,1999.0,2,1,1
IT,CM,2005.0,2,2,0
SN,BF,2017.0,6,3,3
TR,IN,2005.0,4,2,2
CA,SG,2023.0,2,1,1
SE,NZ,2016.0,6,9,-3
KZ,UZ,2010.0,3,4,-1
KE,GB,1999.0,6,11,-5
AE,JO,2022.0,15,24,-9
RU,ZA,2019.0,9,9,0
CH,RU,2008.0,12,18,-6
TR,CY,2005.0,8,2,6
IL,RU,2000.0,14,19,-5
AR,SE,2019.0,6,6,0
KR,BE,2006.0,3,10,-7
SZ,US,2017.0,1,4,-3
MX,IN,2011.0,11,13,-2
IT,EC,2014.0,7,2,5
PK,PL,2021.0,14,9,5
TW,GR,2005.0,2,1,1
CN,ID,2012.0,19,16,3
CU,EC,2021.0,18,19,-1
EC,CL,2001.0,2,1,1
NO,GB,1997.0,15,15,0
FR,CR,2010.0,5,2,3
US,BO,2007.0,10,4,6
FI,IL,2016.0,4,2,2
KE,ET,2008.0,1,1,0
CH,PL,1997.0,11,8,3
BR,NO,2000.0,7,3,4
KH,GB,2021.0,12,8,4
AT,AR,2009.0,3,2,1
BI,US,2014.0,4,5,-1
IQ,PS,2021.0,4,2,2
AE,AU,2020.0,14,14,0
RO,UA,2021.0,8,8,0
NG,NE,2019.0,2,5,-3
SA,JO,2007.0,4,4,0
BE,MX,2009.0,6,4,2
CI,DE,2017.0,2,2,0
GB,BN,2018.0,12,4,8
UY,CL,2000.0,2,1,1
MY,nan,2006.0,12,19,-7
BE,IR,2010.0,11,12,-1
PH,JP,2015.0,26,31,-5
IQ,JO,2021.0,15,12,3
EG,OM,2017.0,9,19,-10
NG,GH,2020.0,12,13,-1
IE,RU,2004.0,1,3,-2
DK,GH,2007.0,1,2,-1
CN,CL,2012.0,4,6,-2
PT,BG,2006.0,1,2,-1
AO,PT,2021.0,2,6,-4
SG,TR,2013.0,4,10,-6
CL,PT,2021.0,12,7,5
NO,nan,1998.0,9,8,1
CY,IN,2015.0,2,2,0
CN,ET,2011.0,2,4,-2
MX,PA,2015.0,9,6,3
TW,NZ,2014.0,7,7,0
EG,CN,2005.0,5,7,-2
AR,AU,2000.0,1,3,-2
DE,PH,2022.0,4,4,0
UA,CN,2023.0,1,1,0
NL,PT,2008.0,16,16,0
US,CY,2006.0,21,13,8
LT,BG,2010.0,1,1,0
US,LV,2012.0,6,9,-3
JM,US,2013.0,11,19,-8
PT,PL,2018.0,5,1,4
ES,PL,2009.0,14,15,-1
FR,BG,2002.0,4,9,-5
AR,CR,2019.0,12,19,-7
BE,RW,2022.0,1,2,-1
NZ,ZA,2022.0,9,18,-9
MG,US,2013.0,2,6,-4
CZ,GB,2003.0,16,14,2
KH,US,2019.0,4,9,-5
CY,SE,2017.0,4,2,2
nan,GE,2018.0,3,1,2
FR,HU,2001.0,15,20,-5
TR,IL,2005.0,6,1,5
AE,FI,2016.0,2,3,-1
SE,CH,2004.0,35,26,9
UG,BE,2013.0,8,5,3
SE,LT,2005.0,4,4,0
SK,AT,2020.0,14,19,-5
AU,PH,2002.0,4,8,-4
SI,SE,1998.0,2,1,1
GH,BJ,2018.0,2,2,0
ZA,CR,2008.0,3,1,2
NL,UG,2007.0,3,1,2
RS,XK,2022.0,7,2,5
BE,FI,1998.0,3,5,-2
PH,NL,2020.0,4,9,-5
TN,PK,2010.0,1,8,-7
NE,FR,2008.0,2,4,-2
HU,RS,2005.0,3,5,-2
CA,NO,2008.0,14,14,0
FR,BG,2005.0,2,11,-9
JO,FR,2009.0,2,4,-2
NZ,FI,2006.0,1,3,-2
PE,IL,2010.0,1,2,-1
JP,PA,2010.0,2,2,0
AR,IN,1998.0,1,1,0
AU,EG,2009.0,7,7,0
CA,KW,2013.0,11,4,7
CA,BB,2011.0,1,2,-1
OM,MY,2020.0,7,13,-6
ES,DZ,2014.0,1,2,-1
AU,BW,2005.0,2,1,1
SG,TW,2001.0,14,16,-2
IL,PH,1998.0,1,1,0
MY,SI,2018.0,4,11,-7
MX,TW,2000.0,1,2,-1
GB,ZA,2023.0,6,9,-3
BR,ZM,2020.0,5,2,3
IL,SA,2020.0,3,1,2
FI,AU,2006.0,11,6,5
EC,HN,2017.0,2,2,0
US,TT,2003.0,2,6,-4
PT,RO,2017.0,3,1,2
JP,KZ,2013.0,3,1,2
JO,nan,2013.0,1,1,0
LY,AT,2020.0,1,1,0
US,UG,2008.0,24,9,15
EG,OM,2010.0,5,9,-4
MX,RU,2007.0,5,5,0
BG,FR,2007.0,11,8,3
DE,AM,2019.0,2,4,-2
ES,MY,2007.0,2,3,-1
CN,NO,2004.0,4,11,-7
CN,BY,2021.0,2,4,-2
GH,ZA,2013.0,5,3,2
PS,BE,2018.0,2,1,1
RU,PL,2010.0,15,16,-1
SA,MK,2016.0,1,2,-1
EE,IN,2015.0,3,2,1
KZ,DE,2014.0,1,7,-6
BE,BR,2023.0,2,6,-4
IE,PL,2011.0,12,10,2
RW,KR,2019.0,1,2,-1
ES,HN,2013.0,7,7,0
JO,LY,2022.0,2,1,1
UA,PK,2022.0,3,2,1
PF,FR,2014.0,11,8,3
PL,AZ,2017.0,1,1,0
FI,LV,2004.0,1,1,0
CR,BO,2013.0,1,2,-1
TR,MN,2019.0,2,1,1
PK,FR,1997.0,1,1,0
UZ,CZ,2018.0,6,2,4
ID,ES,2007.0,5,11,-6
BG,MK,2011.0,1,3,-2
SA,ES,2015.0,3,8,-5
PL,AU,2001.0,2,6,-4
AT,NZ,2004.0,3,3,0
TW,HU,2019.0,1,1,0
MY,DZ,2016.0,4,4,0
CW,NL,2000.0,2,6,-4
MX,CO,1997.0,7,6,1
FI,CH,1999.0,5,4,1
GB,TT,2016.0,7,5,2
TN,ES,2010.0,3,4,-1
NO,RS,2007.0,1,2,-1
SG,IE,2018.0,7,4,3
EG,QA,2007.0,6,5,1
NI,ES,2005.0,2,1,1
TR,AE,2012.0,2,2,0
TN,ES,2019.0,8,8,0
CN,BG,2016.0,6,9,-3
NL,ET,2014.0,8,4,4
GR,AU,2006.0,6,7,-1
MA,GB,2007.0,9,7,2
ZA,SK,2019.0,1,1,0
SA,GR,2020.0,4,5,-1
CH,SN,2019.0,4,1,3
DK,PT,1998.0,5,1,4
PA,AU,2018.0,4,3,1
nan,SG,2014.0,9,11,-2
EG,LY,2009.0,2,3,-1
BE,ET,2022.0,6,8,-2
US,PS,2019.0,17,13,4
EG,BD,2013.0,3,3,0
EC,MX,2006.0,3,6,-3
SE,MX,1997.0,1,1,0
FI,TR,2008.0,7,7,0
CO,NL,2006.0,3,6,-3
EE,US,2019.0,17,15,2
nan,CR,2018.0,5,3,2
ES,BD,2006.0,6,5,1
BE,CZ,2005.0,3,3,0
ZM,PK,2016.0,1,2,-1
TW,AT,2002.0,3,1,2
nan,FI,2021.0,11,7,4
DE,VN,1998.0,3,2,1
AR,CH,2001.0,2,3,-1
IT,PK,2011.0,5,9,-4
BH,ID,2018.0,1,2,-1
MX,LB,2020.0,1,1,0
PT,AU,2003.0,3,3,0
SG,KR,1999.0,4,2,2
KE,CO,2007.0,2,1,1
PG,US,2001.0,1,2,-1
KR,BH,2015.0,1,2,-1
TW,TR,1999.0,3,2,1
MA,JP,2011.0,2,1,1
RU,MX,2022.0,3,6,-3
HU,IE,2018.0,3,7,-4
BR,ZA,2016.0,11,8,3
NO,ET,2012.0,8,3,5
FR,CM,1997.0,6,4,2
IR,ZM,2019.0,3,4,-1
TN,EG,2009.0,6,6,0
BR,CU,1999.0,2,9,-7
AU,VN,2023.0,3,8,-5
GL,NO,2018.0,1,2,-1
CO,FI,2013.0,1,1,0
AU,VE,2020.0,2,1,1
JM,AU,2009.0,2,1,1
GE,SK,2015.0,1,3,-2
RS,HU,2013.0,3,9,-6
QA,DZ,2020.0,2,4,-2
FR,LT,2022.0,4,1,3
UA,AZ,2021.0,2,3,-1
BG,BE,2010.0,7,7,0
RS,FR,2005.0,2,1,1
KW,FI,2005.0,2,1,1
HR,BR,2018.0,2,3,-1
CY,JP,2007.0,2,4,-2
UA,JP,2005.0,6,6,0
PA,CR,2020.0,1,3,-2
FI,MX,2008.0,1,2,-1
GH,UA,2013.0,1,8,-7
IN,GE,2016.0,2,1,1
IE,CH,2022.0,11,6,5
KG,US,2021.0,2,4,-2
UY,GB,2019.0,6,6,0
IR,AZ,2018.0,4,7,-3
CH,AE,2017.0,1,2,-1
IN,RE,2009.0,1,1,0
CU,GB,2011.0,3,3,0
PH,ES,2003.0,4,6,-2
SE,CZ,2001.0,4,2,2
RU,FI,2002.0,13,13,0
SI,JP,2013.0,3,3,0
BR,HR,2022.0,2,1,1
TR,ME,2021.0,2,1,1
CZ,TW,2007.0,1,3,-2
SY,LB,2014.0,2,2,0
CZ,ZA,2019.0,7,7,0
NL,NG,2020.0,7,11,-4
AL,IT,2020.0,3,3,0
GE,DE,2008.0,4,6,-2
GT,BR,2012.0,1,1,0
BE,IE,2004.0,2,3,-1
KW,IE,2022.0,1,1,0
RW,ZA,2018.0,2,10,-8
AR,HN,2014.0,1,1,0
CN,PG,2019.0,3,1,2
NL,PL,2005.0,7,11,-4
GE,GB,2005.0,4,4,0
MD,US,2019.0,7,5,2
FI,CN,2006.0,16,9,7
CH,IL,2006.0,4,12,-8
UG,SE,2015.0,2,4,-2
CI,CN,2022.0,3,1,2
UZ,PL,2020.0,2,1,1
SZ,US,2019.0,1,1,0
ZM,BR,2021.0,8,3,5
EC,BE,2020.0,6,5,1
YE,nan,2019.0,2,1,1
ZA,AR,2010.0,1,2,-1
HU,ES,2018.0,7,7,0
FI,BG,2002.0,2,1,1
TR,GR,2010.0,3,4,-1
RU,PA,2018.0,1,1,0
TN,MD,2012.0,4,17,-13
GH,IN,2007.0,4,3,1
GH,AU,2020.0,14,18,-4
AE,ID,2020.0,6,8,-2
IN,MN,2020.0,2,1,1
PT,PE,2008.0,1,1,0
NZ,NG,2016.0,2,3,-1
RS,SI,2004.0,4,3,1
DE,CD,2019.0,3,1,2
FK,GB,2009.0,2,2,0
MX,NL,2001.0,2,2,0
AO,IT,2000.0,4,3,1
AE,SD,2014.0,2,2,0
BR,UA,2017.0,4,7,-3
ZA,UG,2011.0,4,7,-3
IE,HU,2009.0,1,2,-1
DZ,CH,2014.0,1,1,0
ZA,CI,2011.0,2,1,1
TH,KR,2000.0,1,1,0
CA,PA,2018.0,4,13,-9
IL,BE,2007.0,6,2,4
OM,BD,2015.0,1,2,-1
TZ,BE,2014.0,1,4,-3
US,LU,2001.0,3,2,1
AU,AR,2011.0,3,5,-2
NZ,UG,2021.0,5,1,4
SE,IE,2022.0,7,6,1
PT,FI,2011.0,2,2,0
PL,MZ,2000.0,2,10,-8
CH,AE,2019.0,3,3,0
RO,CN,2008.0,1,4,-3
BG,BE,2017.0,5,6,-1
PE,NI,2015.0,4,5,-1
BJ,US,1999.0,2,1,1
LK,US,2001.0,2,5,-3
UY,CO,2005.0,4,1,3
SE,BG,2013.0,4,3,1
QA,GR,2016.0,2,11,-9
RU,PK,2015.0,4,2,2
VE,CH,2018.0,1,1,0
IQ,ID,2013.0,1,1,0
VN,BY,2009.0,1,6,-5
DE,UZ,2010.0,4,4,0
CZ,RS,1998.0,5,1,4
CA,NP,2016.0,4,3,1
IR,TR,2012.0,8,8,0
CA,TT,2012.0,1,1,0
CG,PK,2009.0,1,1,0
EG,AU,1997.0,1,2,-1
IT,TR,2022.0,7,16,-9
EG,PH,2020.0,5,1,4
AE,IS,2020.0,1,1,0
CR,VE,2020.0,1,2,-1
nan,BD,2016.0,1,1,0
PT,MZ,2022.0,11,1,10
FR,AO,2016.0,1,1,0
LB,EG,2006.0,4,2,2
MA,BI,1999.0,1,1,0
AE,MY,2011.0,2,6,-4
BE,MA,2012.0,5,3,2
BE,SG,2012.0,2,2,0
SE,MY,2013.0,7,6,1
BR,IE,2006.0,4,1,3
PY,PT,2011.0,1,2,-1
SG,FI,2020.0,2,4,-2
IE,PH,2007.0,1,1,0
CZ,ZA,2017.0,5,4,1
SE,BE,2001.0,12,13,-1
SA,MX,2016.0,1,2,-1
PK,FI,2018.0,6,6,0
BD,TW,2003.0,4,2,2
SG,NO,2000.0,1,1,0
NZ,AE,2002.0,1,1,0
BD,TN,2019.0,1,2,-1
RS,US,2023.0,3,1,2
IR,TH,2014.0,4,1,3
CA,LK,2012.0,2,2,0
BG,SE,2007.0,4,2,2
TW,IT,2003.0,3,1,2
RS,AE,2017.0,2,1,1
RU,BR,2007.0,5,14,-9
CH,BA,2016.0,1,2,-1
AR,PL,2015.0,1,1,0
OM,JO,2011.0,1,6,-5
FR,CR,2017.0,5,7,-2
AE,GR,2016.0,2,6,-4
ZA,MZ,2021.0,1,3,-2
BR,QA,2019.0,3,1,2
YE,GB,2013.0,2,2,0
TN,BE,2009.0,2,2,0
PH,DE,1997.0,2,4,-2
DZ,nan,2021.0,4,10,-6
HR,SK,2021.0,6,6,0
TH,NG,2021.0,3,3,0
PT,BY,2005.0,1,3,-2
MX,nan,1998.0,1,4,-3
FI,ES,2004.0,6,3,3
CH,PE,2017.0,4,3,1
TW,SI,2013.0,3,1,2
MW,JP,2007.0,1,1,0
IS,SE,2004.0,3,10,-7
BJ,TN,2018.0,1,1,0
CO,SG,2016.0,2,2,0
ID,TR,2012.0,2,1,1
DE,GE,2021.0,3,2,1
EC,HN,2019.0,1,2,-1
US,KH,2004.0,2,1,1
LU,JP,2009.0,1,3,-2
AT,PH,2016.0,2,2,0
IT,BH,2022.0,1,1,0
CU,BR,2001.0,6,6,0
CH,CU,2018.0,1,2,-1
BE,BD,2020.0,4,2,2
RW,CN,2020.0,4,5,-1
EC,UA,2001.0,2,5,-3
US,PY,2012.0,3,2,1
BE,LV,2001.0,1,1,0
GM,ID,2020.0,1,1,0
MX,PK,2021.0,1,2,-1
AE,US,2000.0,5,24,-19
CA,CR,2016.0,3,2,1
KR,FJ,2010.0,1,1,0
CZ,PL,1997.0,3,2,1
DK,MX,2005.0,1,1,0
UA,MZ,2022.0,3,1,2
FR,NG,2009.0,1,2,-1
IT,CL,1997.0,5,3,2
TH,SE,2021.0,3,4,-1
PH,ID,2009.0,1,2,-1
IL,AR,2016.0,6,2,4
AE,TN,2020.0,5,6,-1
CY,SE,2019.0,3,3,0
KW,GR,2016.0,2,3,-1
MW,ZM,2021.0,3,4,-1
AE,PK,2004.0,3,1,2
AU,AE,2006.0,4,5,-1
CI,TN,2011.0,1,1,0
PY,CL,2010.0,1,1,0
SV,BR,2018.0,3,2,1
BR,PA,2003.0,2,1,1
HU,KR,2010.0,1,1,0
NG,CA,2012.0,5,5,0
KW,IR,2012.0,2,1,1
RU,TW,2022.0,3,4,-1
FR,BD,2009.0,2,2,0
CF,FR,2014.0,1,2,-1
DZ,SE,2021.0,4,1,3
MK,TR,2019.0,1,2,-1
ID,EC,2019.0,2,1,1
HU,IL,2016.0,5,2,3
ET,ZW,2012.0,1,1,0
QA,SD,2022.0,1,2,-1
DE,AM,2010.0,2,5,-3
BR,AF,2012.0,1,2,-1
ES,NZ,2022.0,5,7,-2
MA,IR,2010.0,1,2,-1
DE,AM,2017.0,4,2,2
SA,NO,2021.0,4,5,-1
US,PS,2017.0,5,16,-11
ZA,TZ,2007.0,2,3,-1
MA,AE,2020.0,3,6,-3
IT,CM,2002.0,2,2,0
CN,CD,2013.0,2,1,1
GB,TN,2016.0,3,5,-2
CO,KE,2006.0,1,1,0
NZ,SK,2000.0,1,1,0
UY,GB,2017.0,5,4,1
BH,ZA,2020.0,4,3,1
SY,BD,2020.0,2,1,1
VN,ZA,2015.0,2,1,1
PA,IT,2015.0,3,1,2
QA,ZA,2017.0,1,3,-2
BB,TT,2012.0,3,1,2
XK,RS,2022.0,2,7,-5
AT,GR,2003.0,3,1,2
SG,DK,1997.0,1,3,-2
PS,GB,2009.0,1,2,-1
KW,QA,2013.0,1,2,-1
JP,UZ,2003.0,3,5,-2
GP,GF,2019.0,1,1,0
RU,JO,2006.0,1,1,0
NG,EG,2022.0,3,3,0
GE,FR,2009.0,1,1,0
SK,AR,2007.0,1,1,0
MX,SE,2006.0,3,2,1
UZ,KR,2007.0,2,2,0
MD,NL,2005.0,1,1,0
IL,BG,2001.0,2,1,1
RO,JP,2004.0,2,3,-1
MX,CH,2002.0,3,2,1
KE,PK,2011.0,6,5,1
NO,PL,2005.0,1,3,-2
GR,DK,1999.0,1,1,0
PY,CO,2011.0,2,3,-1
MD,US,2017.0,3,4,-1
NI,RU,2016.0,1,1,0
CA,LT,2006.0,1,1,0
SK,ES,2014.0,1,3,-2
nan,HU,2003.0,2,7,-5
ID,NL,2004.0,2,6,-4
AT,PS,2014.0,1,2,-1
ME,HR,2021.0,2,2,0
SI,DK,2019.0,5,2,3
DE,BH,2011.0,1,1,0
TW,IL,2012.0,1,1,0
nan,JO,2018.0,1,2,-1
AU,LU,2016.0,1,2,-1
IN,CD,2015.0,1,1,0
ID,FR,2000.0,1,5,-4
CA,CO,2001.0,1,2,-1
GA,NL,2009.0,2,1,1
ZA,AR,2019.0,1,1,0
PE,KR,2020.0,1,2,-1
BD,PH,2017.0,1,2,-1
PL,IE,2003.0,1,1,0
FI,GR,2022.0,2,3,-1
MD,CN,2014.0,1,1,0
CD,CG,2022.0,1,1,0
DE,MD,2003.0,2,2,0
KE,JP,2003.0,3,3,0
US,ZM,2004.0,4,4,0
SD,MY,2010.0,3,4,-1
AZ,US,2014.0,1,2,-1
BR,TH,2016.0,1,5,-4
MX,AF,2005.0,3,1,2
PT,IR,2009.0,1,3,-2
IR,MK,2009.0,1,1,0
BZ,IN,2017.0,1,1,0
PE,PT,2009.0,1,1,0
PK,KH,2009.0,2,1,1
LB,IT,2008.0,2,3,-1
NO,LU,2012.0,2,2,0
CZ,ET,2018.0,1,1,0
BG,BE,2019.0,3,6,-3
JO,IQ,2010.0,2,2,0
NL,KE,2009.0,1,4,-3
VG,BR,2021.0,1,1,0
SI,CA,2006.0,1,3,-2
MA,IR,2017.0,5,5,0
CW,US,2013.0,1,1,0
ID,LK,2008.0,1,3,-2
SK,NL,1998.0,3,11,-8
OM,FR,2013.0,1,2,-1
DE,UZ,2017.0,2,1,1
TR,BE,2004.0,4,5,-1
BY,PL,2000.0,3,1,2
TH,BD,2005.0,1,2,-1
PA,DE,2005.0,1,3,-2
IN,VE,2004.0,1,1,0
PH,CY,2021.0,1,1,0
HR,JP,2014.0,2,3,-1
JO,IT,2006.0,1,7,-6
DK,PT,1997.0,1,1,0
LU,IN,2013.0,1,1,0
TW,US,2016.0,774,623,151
US,TR,2009.0,361,342,19
DE,GB,2010.0,768,766,2
FR,IT,2009.0,224,352,-128
GB,DK,2007.0,125,75,50
ID,US,2011.0,56,80,-24
ID,JP,2012.0,43,131,-88
UA,IT,2011.0,12,9,3
FR,BR,2023.0,5,6,-1
JP,DE,2017.0,185,216,-31
SK,HU,2020.0,14,7,7
NL,FI,2017.0,41,38,3
NL,DE,2008.0,269,295,-26
MD,FR,2010.0,63,49,14
UY,CO,2002.0,1,2,-1
CA,SA,2023.0,3,4,-1
SG,CN,2010.0,362,373,-11
CA,DE,2012.0,266,260,6
TW,CN,2000.0,400,273,127
CN,FR,2006.0,194,309,-115
DK,CH,2013.0,42,33,9
GR,CN,2004.0,7,8,-1
DE,HR,1999.0,14,7,7
CA,IR,2016.0,170,305,-135
ES,CR,2012.0,34,51,-17
ID,TH,2011.0,2,8,-6
AT,RU,2007.0,12,7,5
EG,CA,2020.0,76,113,-37
TR,IR,2017.0,26,50,-24
CH,AU,2013.0,81,75,6
MD,FR,2019.0,50,23,27
HU,AT,2016.0,37,30,7
NL,SA,2022.0,6,9,-3
BR,CH,2016.0,54,41,13
FR,CR,2019.0,6,9,-3
KR,CH,2010.0,8,12,-4
IR,SG,2018.0,43,65,-22
IT,NZ,2016.0,9,6,3
US,LB,2016.0,71,100,-29
SG,IL,2019.0,8,3,5
DE,JP,2021.0,131,151,-20
KH,US,2017.0,10,8,2
DK,DE,1997.0,34,41,-7
NL,AR,2016.0,6,12,-6
ZA,RU,2019.0,9,9,0
GH,CN,2015.0,14,12,2
GB,RU,2006.0,56,92,-36
US,BW,2009.0,11,7,4
ET,nan,2013.0,1,4,-3
UY,GB,2010.0,1,4,-3
IE,BG,2013.0,1,1,0
CH,TR,2014.0,20,18,2
SG,CA,2010.0,41,40,1
CN,LK,2012.0,5,6,-1
TR,GR,2019.0,11,2,9
SE,BR,2017.0,19,37,-18
BD,PH,2010.0,1,2,-1
FI,BE,1999.0,3,2,1
RU,IR,2018.0,10,12,-2
US,MT,2006.0,1,1,0
FR,BO,2012.0,2,3,-1
AU,IL,2021.0,15,18,-3
GB,LY,2022.0,3,3,0
GB,KE,2012.0,35,20,15
CA,SI,2012.0,1,2,-1
IT,TN,2020.0,24,28,-4
FO,DK,2020.0,2,3,-1
ES,ZA,2012.0,11,3,8
CA,IE,2004.0,62,72,-10
HR,IE,2021.0,1,2,-1
UA,AU,2015.0,3,1,2
TZ,US,2006.0,3,2,1
BR,TR,2000.0,1,3,-2
US,UY,1999.0,5,8,-3
JP,ZA,1998.0,3,2,1
RU,PT,2015.0,5,8,-3
FR,PT,2000.0,25,13,12
NL,FI,2010.0,29,39,-10
BR,NL,2011.0,40,34,6
KR,QA,2010.0,4,1,3
CA,KE,2014.0,7,9,-2
BE,CU,2006.0,2,1,1
BD,PH,2019.0,3,1,2
SY,DE,2019.0,8,6,2
CH,SK,2015.0,3,15,-12
MX,HN,1999.0,5,4,1
CO,CN,2003.0,5,3,2
SN,US,2020.0,13,14,-1
NG,FR,2008.0,3,5,-2
SA,PK,2006.0,18,10,8
AT,IR,2016.0,11,14,-3
RS,SE,2016.0,8,4,4
BD,KW,2021.0,2,1,1
CH,KE,2021.0,6,5,1
DE,MA,2015.0,4,4,0
SK,CN,2004.0,1,2,-1
DK,IR,2015.0,5,21,-16
GR,FI,2020.0,5,3,2
AR,CA,1999.0,5,4,1
TW,CA,2022.0,26,23,3
CZ,CO,2013.0,3,1,2
GB,GE,2001.0,1,2,-1
AR,SE,2010.0,4,5,-1
CH,IR,2008.0,5,17,-12
BF,GN,2018.0,2,1,1
FR,GT,2011.0,1,1,0
DE,TH,2021.0,14,17,-3
BR,UA,2010.0,4,4,0
NL,TH,2022.0,5,6,-1
GB,QA,2012.0,20,15,5
CD,FR,2014.0,2,4,-2
RS,PT,2002.0,1,1,0
CH,PE,2010.0,3,1,2
CL,DO,2021.0,1,3,-2
UA,JP,2002.0,5,12,-7
KZ,GB,2021.0,10,5,5
HU,NO,2011.0,3,1,2
CZ,RU,2012.0,32,28,4
PL,NL,2002.0,2,12,-10
BG,RO,2008.0,2,1,1
GB,KW,1998.0,3,1,2
IN,MT,2022.0,1,2,-1
GB,DZ,2022.0,5,7,-2
SI,BA,2012.0,2,2,0
TR,GR,2017.0,7,5,2
IN,BR,1999.0,8,2,6
ET,BR,2020.0,1,3,-2
IN,KE,2008.0,1,3,-2
AT,IN,2006.0,7,11,-4
nan,NG,2015.0,6,1,5
JP,AT,2021.0,12,14,-2
SG,SA,2021.0,7,3,4
IN,IM,2002.0,1,1,0
JP,AG,2021.0,6,4,2
PT,MX,2003.0,8,12,-4
SI,IN,2021.0,2,4,-2
CH,PE,2019.0,5,2,3
TW,MY,2003.0,2,1,1
KR,CA,1997.0,5,10,-5
CI,DE,2019.0,1,2,-1
SK,DK,2013.0,1,3,-2
CA,OM,2017.0,7,14,-7
LT,NL,2020.0,1,1,0
PS,JO,2006.0,1,2,-1
LB,BR,2008.0,3,5,-2
JO,CA,2022.0,7,6,1
CU,CR,2000.0,1,1,0
TH,TR,2006.0,2,1,1
PK,DK,2012.0,1,5,-4
ES,DO,2021.0,9,6,3
PG,FJ,2015.0,1,1,0
SN,ID,2018.0,2,1,1
CL,NL,2003.0,1,2,-1
AR,BE,2011.0,1,5,-4
nan,UG,2018.0,1,2,-1
GB,KW,1997.0,2,3,-1
KZ,UZ,2017.0,2,8,-6
LA,FR,2017.0,5,1,4
MA,CH,2014.0,2,5,-3
MY,IE,2009.0,1,8,-7
FI,CO,2013.0,1,1,0
PL,MX,2021.0,3,7,-4
HU,CZ,1999.0,2,2,0
SE,RO,1999.0,2,2,0
BJ,FR,2001.0,3,7,-4
XK,PL,2017.0,2,1,1
GA,DE,2014.0,1,9,-8
KG,TR,2018.0,1,3,-2
FR,CF,2000.0,1,1,0
EC,CU,2012.0,2,5,-3
CL,CR,1997.0,1,1,0
MX,VE,1999.0,4,18,-14
BD,NP,2022.0,3,2,1
CZ,GR,2018.0,3,9,-6
IN,EE,2014.0,2,1,1
CH,AE,2010.0,1,1,0
DJ,FR,2020.0,4,1,3
IN,BW,2014.0,1,1,0
AR,ES,2003.0,154,121,33
CA,US,2014.0,3521,3360,161
AT,CN,2002.0,8,3,5
AR,VE,2017.0,12,19,-7
FR,BE,2022.0,176,190,-14
TR,PH,2016.0,2,1,1
HN,EC,2020.0,3,1,2
DK,FR,2001.0,12,16,-4
TR,SG,2013.0,10,4,6
BA,HR,2002.0,3,5,-2
US,DZ,2007.0,7,6,1
NL,IR,2002.0,3,5,-2
RE,CA,2018.0,2,2,0
US,GR,2023.0,4,9,-5
nan,VN,2016.0,4,1,3
ME,ES,2019.0,1,1,0
CH,UG,2013.0,4,7,-3
KE,RW,2011.0,1,1,0
NL,IR,2005.0,2,5,-3
TH,RU,2014.0,2,2,0
BE,FI,1997.0,2,2,0
nan,GB,2015.0,62,100,-38
DE,,2019.0,21409,0,21409
,MY,2012.0,5482,0,5482
,KR,1999.0,4072,0,4072
,AT,2005.0,2005,0,2005
,DE,2009.0,19783,0,19783
,IN,2013.0,28843,0,28843
CN,,2022.0,56780,0,56780
,BR,1994.0,9474,0,9474
,VE,2003.0,409,0,409
DE,,2017.0,16868,0,16868
JP,,2009.0,9476,0,9476
,BE,2010.0,3359,0,3359
BE,ZW,2013.0,1,0,1
AM,,2000.0,34,0,34
IN,,2004.0,1747,0,1747
,TR,2016.0,5604,0,5604
,CA,2003.0,9145,0,9145
FR,,2020.0,17858,0,17858
PL,XK,2021.0,1,0,1
DE,,2010.0,9547,0,9547
,AT,2002.0,1730,0,1730
GB,,2006.0,6128,0,6128
TR,,2008.0,927,0,927
SG,,2022.0,2990,0,2990
NO,,2020.0,2061,0,2061
,RU,1995.0,10049,0,10049
PH,,2023.0,2426,0,2426
,PL,2003.0,4363,0,4363
ZA,,2007.0,474,0,474
EC,,2015.0,75,0,75
BR,,2001.0,619,0,619
AR,,2018.0,2114,0,2114
,LK,1994.0,165,0,165
EG,,2006.0,240,0,240
IE,,2003.0,232,0,232
DK,,2021.0,2952,0,2952
,LB,1995.0,141,0,141
,BD,2005.0,533,0,533
,HR,1995.0,770,0,770
AE,,2016.0,190,0,190
,BD,2002.0,192,0,192
,PE,2013.0,918,0,918
GT,,2019.0,43,0,43
GH,,2024.0,3296,0,3296
ID,,2015.0,437,0,437
PG,,2023.0,103,0,103
SI,,2005.0,108,0,108
,UA,2004.0,1335,0,1335
NZ,,2007.0,341,0,341
,PR,1996.0,44,0,44
GR,,2005.0,550,0,550
,FI,2013.0,1985,0,1985
,BA,2007.0,186,0,186
,WS,2008.0,1,0,1
SV,,2022.0,50,0,50
MT,,2018.0,49,0,49
PL,,2001.0,509,0,509
,BG,2011.0,552,0,552
,UA,1996.0,1397,0,1397
,BE,2017.0,2679,0,2679
PE,GT,2015.0,5,0,5
CM,,2021.0,468,0,468
JO,,2016.0,182,0,182
NG,,2001.0,97,0,97
,CD,2014.0,237,0,237
KE,,2004.0,55,0,55
AM,CN,2006.0,3,0,3
,KE,2016.0,731,0,731
AZ,,2003.0,12,0,12
,CM,2006.0,173,0,173
,MQ,2013.0,26,0,26
GR,,2002.0,324,0,324
ET,,2006.0,25,0,25
DE,GH,2004.0,4,0,4
,LT,2006.0,449,0,449
YE,JO,2018.0,3,0,3
NA,KE,2023.0,1,0,1
MD,,2016.0,52,0,52
SI,,2002.0,52,0,52
,KZ,2006.0,94,0,94
BJ,KE,2011.0,2,0,2
,CW,2016.0,10,0,10
,VN,2018.0,761,0,761
UG,,2014.0,86,0,86
,ME,2007.0,25,0,25
,BE,2019.0,1628,0,1628
,TG,2009.0,27,0,27
RW,,2021.0,84,0,84
,GH,2015.0,660,0,660
,RS,2018.0,468,0,468
CR,,2012.0,48,0,48
,CY,2003.0,81,0,81
CY,,2009.0,26,0,26
HR,,2003.0,65,0,65
UA,RS,2022.0,3,0,3
,ZW,2003.0,68,0,68
,BO,2015.0,68,0,68
AE,CL,2017.0,1,0,1
IR,PA,2018.0,5,0,5
,NP,2018.0,387,0,387
IQ,GH,2020.0,2,0,2
SE,JO,2003.0,2,0,2
CN,CI,1999.0,1,0,1
AR,AO,2013.0,2,0,2
,MG,2009.0,58,0,58
SX,US,2005.0,1,0,1
LK,,2025.0,93,0,93
PK,TN,2002.0,1,0,1
ZA,RU,2017.0,12,0,12
FR,AZ,2003.0,1,0,1
,LV,2000.0,90,0,90
FI,HR,2014.0,1,0,1
OM,AU,2000.0,1,0,1
DE,CD,2017.0,1,0,1
IS,,2002.0,13,0,13
AF,,2021.0,27,0,27
ZW,CH,2009.0,5,0,5
MY,BH,2003.0,1,0,1
BY,CA,2006.0,4,0,4
PT,CV,2007.0,1,0,1
UY,IL,2022.0,1,0,1
KH,,2013.0,12,0,12
MA,UG,2018.0,1,0,1
,SR,2013.0,10,0,10
,RW,2008.0,30,0,30
,PR,2004.0,31,0,31
,BR,2021.0,11,0,11
BN,,2014.0,4,0,4
JP,SV,2021.0,1,0,1
ZM,nan,2008.0,2,0,2
GY,,2022.0,16,0,16
GY,CA,2007.0,1,0,1
TG,US,2022.0,1,0,1
,ZM,1997.0,25,0,25
SI,DK,2017.0,4,0,4
PA,ZA,2002.0,1,0,1
,SV,2017.0,17,0,17
nan,LK,2014.0,2,0,2
HU,DZ,2022.0,1,0,1
,SX,2018.0,6,0,6
NG,KH,2018.0,1,0,1
BY,,2025.0,58,0,58
MC,BR,2022.0,1,0,1
,LU,2009.0,122,0,122
PL,VN,2008.0,3,0,3
KE,DE,2003.0,3,0,3
DK,SJ,2011.0,1,0,1
,SV,2010.0,19,0,19
VN,ES,2021.0,5,0,5
HU,DK,2013.0,6,0,6
MY,SY,2019.0,4,0,4
CF,,2020.0,8,0,8
MM,CZ,2005.0,3,0,3
BE,CY,2014.0,4,0,4
BE,EE,2012.0,3,0,3
HR,CO,2017.0,2,0,2
LY,,2015.0,38,0,38
CW,DE,2000.0,2,0,2
GH,BF,2011.0,1,0,1
,ZM,1998.0,23,0,23
DK,ID,2009.0,1,0,1
RO,RS,2011.0,2,0,2
,AO,2007.0,7,0,7
JP,MM,2014.0,12,0,12
RE,BR,2012.0,1,0,1
LY,ES,1999.0,1,0,1
BI,DE,2015.0,1,0,1
GT,,2010.0,3,0,3
AR,PT,1998.0,3,0,3
SD,,2008.0,10,0,10
HU,LU,2022.0,2,0,2
BW,NA,2017.0,3,0,3
AU,VU,2018.0,2,0,2
SG,PH,2001.0,2,0,2
BE,MC,2006.0,1,0,1
VE,BO,2022.0,2,0,2
MD,GB,2006.0,2,0,2
DE,SJ,2018.0,2,0,2
AG,US,2011.0,1,0,1
VG,,2007.0,11,0,11
SI,IE,2008.0,1,0,1
TH,DK,1999.0,1,0,1
,XK,1999.0,2,0,2
AO,,2013.0,9,0,9
AL,US,1999.0,1,0,1
CN,AL,2007.0,1,0,1
BF,TG,2020.0,2,0,2
FI,TN,2013.0,1,0,1
KZ,SG,2006.0,1,0,1
GE,,2000.0,22,0,22
EG,SG,2022.0,2,0,2
DK,LK,2011.0,1,0,1
IS,,2005.0,34,0,34
LK,KE,2005.0,1,0,1
FI,UG,2012.0,2,0,2
DZ,FI,2018.0,2,0,2
BR,SM,2015.0,1,0,1
FR,IR,1999.0,7,0,7
AU,RW,2021.0,1,0,1
BE,GA,2004.0,1,0,1
nan,OM,2016.0,1,0,1
SG,TH,1997.0,3,0,3
,NA,2005.0,7,0,7
QA,ZA,2010.0,1,0,1
CO,CG,2008.0,1,0,1
TT,AU,2019.0,3,0,3
nan,MK,2015.0,1,0,1
XK,PL,2010.0,6,0,6
NL,LY,2016.0,1,0,1
SD,OM,2003.0,2,0,2
PE,,2000.0,14,0,14
,KH,2003.0,32,0,32
CM,CN,2006.0,1,0,1
,PF,2001.0,7,0,7
IL,VN,2020.0,1,0,1
PG,CH,2017.0,1,0,1
ES,GH,2014.0,1,0,1
AM,IR,2014.0,7,0,7
SE,SA,2011.0,6,0,6
RS,SA,2020.0,1,0,1
BA,,2004.0,3,0,3
ZW,AM,2006.0,2,0,2
SM,,2022.0,4,0,4
CL,JO,2020.0,2,0,2
nan,PK,2000.0,1,0,1
GE,PH,2019.0,1,0,1
PH,FI,2011.0,1,0,1
KW,BE,2007.0,1,0,1
KE,ER,2002.0,1,0,1
IR,KR,2023.0,1,0,1
,LS,1996.0,4,0,4
MA,TR,2018.0,3,0,3
nan,ZW,2019.0,1,0,1
BH,QA,2007.0,1,0,1
LS,TZ,2012.0,1,0,1
,BN,2000.0,5,0,5
SE,GE,2019.0,2,0,2
IR,GE,2018.0,1,0,1
BR,QA,2010.0,2,0,2
GT,,2017.0,29,0,29
IE,ES,1998.0,4,0,4
UZ,IL,2008.0,2,0,2
ZM,,2025.0,20,0,20
TW,RO,2017.0,1,0,1
TW,HR,2006.0,1,0,1
ES,MW,2017.0,1,0,1
,MR,1994.0,3,0,3
HU,KR,2017.0,5,0,5
FI,TH,2014.0,3,0,3
EE,,1999.0,12,0,12
NP,MY,2016.0,6,0,6
BW,LS,2018.0,1,0,1
PY,AU,2018.0,2,0,2
RO,LT,2011.0,10,0,10
DE,NC,2011.0,1,0,1
TN,JP,2005.0,1,0,1
HR,SE,1998.0,2,0,2
NG,NE,2017.0,3,0,3
BE,MY,2004.0,1,0,1
,MD,2020.0,5,0,5
BI,,2014.0,5,0,5
SE,KG,2008.0,1,0,1
PS,NO,2017.0,2,0,2
TW,PT,2011.0,2,0,2
IN,MX,1997.0,2,0,2
SN,IN,2021.0,1,0,1
TW,JO,2013.0,1,0,1
DK,MX,2002.0,1,0,1
ES,GP,2009.0,1,0,1
PS,NO,2010.0,2,0,2
VG,IT,2011.0,1,0,1
ME,PL,2018.0,1,0,1
EG,AU,1998.0,2,0,2
HN,BR,2000.0,2,0,2
BD,KZ,2012.0,1,0,1
IT,VN,1998.0,3,0,3
EG,NZ,2018.0,5,0,5
BR,SI,1999.0,1,0,1
RU,MA,2020.0,1,0,1
UY,EC,2014.0,3,0,3
NL,JO,2019.0,2,0,2
TH,BJ,2008.0,1,0,1
GM,GA,2011.0,1,0,1
IT,AM,1999.0,3,0,3
KH,RU,2012.0,3,0,3
RS,FR,2002.0,1,0,1
BR,SV,2022.0,2,0,2
SG,HK,2002.0,1,0,1
IR,ZM,2017.0,2,0,2
HR,ES,2022.0,4,0,4
CU,NL,2014.0,4,0,4
ID,CO,2009.0,1,0,1
SY,MA,2002.0,1,0,1
TW,ES,2021.0,2,0,2
ZW,PT,2019.0,1,0,1
IM,SG,2004.0,1,0,1
VE,nan,2016.0,3,0,3
AU,TH,2023.0,5,0,5
AL,CZ,2018.0,1,0,1
JO,AE,1998.0,1,0,1
PL,SG,2001.0,2,0,2
US,DJ,2009.0,1,0,1
PG,NL,2016.0,1,0,1
ES,MA,1997.0,3,0,3
SR,BE,2019.0,1,0,1
IN,BG,2009.0,2,0,2
,SC,2000.0,2,0,2
MS,,2009.0,2,0,2
IL,BI,2006.0,1,0,1
QA,GL,2013.0,1,0,1
MA,nan,2009.0,2,0,2
GH,IE,2020.0,1,0,1
BI,GB,2019.0,3,0,3
MM,CA,2022.0,1,0,1
CG,ZA,2018.0,1,0,1
,LR,2020.0,1,0,1
CD,ID,2018.0,3,0,3
OM,NO,2016.0,1,0,1
IN,HR,1998.0,1,0,1
US,PS,2010.0,7,0,7
GE,BE,2009.0,3,0,3
,GF,2008.0,6,0,6
BR,KZ,2003.0,1,0,1
UG,JP,2015.0,3,0,3
MG,CA,2022.0,1,0,1
GB,MU,2000.0,1,0,1
OM,CO,2022.0,2,0,2
MY,GR,2008.0,1,0,1
UY,,1999.0,8,0,8
NZ,ID,2006.0,2,0,2
AE,BH,2013.0,4,0,4
BR,GF,2019.0,1,0,1
MA,NO,2014.0,1,0,1
QA,IL,2009.0,1,0,1
MX,LV,2006.0,1,0,1
ID,BI,2015.0,1,0,1
PR,EG,2017.0,1,0,1
UY,RS,2020.0,1,0,1
CH,MC,2002.0,1,0,1
ET,NO,2023.0,1,0,1
IN,NA,2016.0,3,0,3
TZ,SN,2003.0,1,0,1
VE,PA,2018.0,3,0,3
KZ,BD,2018.0,1,0,1
nan,TH,2021.0,1,0,1
VE,AU,2018.0,1,0,1
RS,BG,2000.0,1,0,1
RS,AE,2019.0,1,0,1
PG,GB,2007.0,1,0,1
SA,TN,2005.0,1,0,1
NC,GF,2014.0,1,0,1
SN,GB,2002.0,1,0,1
NG,CO,2012.0,1,0,1
VE,DO,2015.0,2,0,2
CO,IQ,2017.0,1,0,1
JO,GE,2020.0,1,0,1
BW,KE,2009.0,1,0,1
IL,TZ,2009.0,1,0,1
SD,BH,2013.0,1,0,1
EG,NA,2017.0,1,0,1
,GY,2006.0,2,0,2
NP,ZA,2019.0,2,0,2
AF,CA,2022.0,2,0,2
AE,AT,2015.0,3,0,3
,GQ,2016.0,1,0,1
ZM,ID,2001.0,1,0,1
KR,AR,2006.0,3,0,3
MU,JO,2022.0,1,0,1
TN,SY,2022.0,1,0,1
AT,TZ,2010.0,2,0,2
SK,TH,2014.0,1,0,1
PT,HN,2012.0,1,0,1
UA,TJ,2022.0,2,0,2
,SV,2019.0,2,0,2
KE,SZ,2001.0,1,0,1
MZ,CL,2008.0,1,0,1
FI,GH,2015.0,3,0,3
RU,VG,2005.0,1,0,1
IT,KH,2020.0,1,0,1
BE,JO,2018.0,1,0,1
MY,AE,2000.0,2,0,2
RU,SI,2007.0,4,0,4
LA,KH,2013.0,1,0,1
TZ,PT,1999.0,1,0,1
UG,CZ,2009.0,1,0,1
BG,AT,2009.0,4,0,4
BY,HU,2013.0,2,0,2
GB,MS,1999.0,5,0,5
JP,ML,2014.0,1,0,1
AD,,2012.0,1,0,1
SD,SY,2013.0,1,0,1
US,MG,1998.0,2,0,2
SL,,2016.0,3,0,3
CH,AG,2018.0,1,0,1
PL,AZ,2019.0,1,0,1
CL,PH,2008.0,3,0,3
KR,PT,2001.0,2,0,2
ME,LU,2021.0,1,0,1
NL,PY,2010.0,1,0,1
NL,PY,2017.0,1,0,1
FR,LI,2022.0,1,0,1
CU,TT,2007.0,1,0,1
RO,AL,2014.0,1,0,1
ME,US,2009.0,1,0,1
UA,MD,2020.0,1,0,1
LY,SD,2020.0,3,0,3
JP,AE,2008.0,2,0,2
TW,GM,2011.0,1,0,1
CY,BE,2015.0,1,0,1
CN,HR,2006.0,1,0,1
BI,DZ,2009.0,1,0,1
SV,UY,2003.0,1,0,1
KR,SD,2023.0,1,0,1
EG,IN,1999.0,1,0,1
SE,IL,1999.0,4,0,4
MX,BI,2008.0,1,0,1
nan,AL,2018.0,1,0,1
NL,PA,2020.0,2,0,2
AU,SK,2021.0,4,0,4
BH,KR,2021.0,3,0,3
RU,GE,2003.0,5,0,5
,SL,2005.0,4,0,4
HU,CL,2013.0,2,0,2
TL,AU,2015.0,1,0,1
HU,SG,2015.0,2,0,2
QA,SK,2011.0,1,0,1
ET,BE,2004.0,1,0,1
LV,TW,2001.0,1,0,1
BO,AT,2019.0,1,0,1
BF,TH,2014.0,1,0,1
AU,BJ,2007.0,1,0,1
GF,DE,2010.0,1,0,1
LV,IN,2014.0,1,0,1
ID,AR,2004.0,1,0,1
ZA,CU,2004.0,1,0,1
AR,RS,1999.0,1,0,1
AT,BD,2006.0,1,0,1
AU,SI,2002.0,1,0,1
GB,EC,2001.0,1,0,1
CO,EG,2018.0,3,0,3
UY,UG,2016.0,2,0,2
ML,DE,2011.0,1,0,1
US,NC,2022.0,3,0,3
NP,QA,2014.0,1,0,1
CM,MY,2006.0,2,0,2
EG,MN,2021.0,1,0,1
GH,ZM,2004.0,4,0,4
ZA,SK,2010.0,1,0,1
SG,PL,2022.0,2,0,2
IS,NZ,2009.0,1,0,1
CY,SE,2010.0,1,0,1
AU,BG,2014.0,1,0,1
KR,BY,2008.0,1,0,1
MK,CY,2020.0,1,0,1
,NA,2002.0,8,0,8
SK,GR,2014.0,5,0,5
GB,MK,2005.0,1,0,1
MK,MY,2016.0,3,0,3
IL,EC,2006.0,1,0,1
DO,nan,2013.0,1,0,1
TZ,ML,2016.0,1,0,1
AZ,DK,2020.0,1,0,1
GE,ET,2008.0,1,0,1
NI,VE,2008.0,1,0,1
MX,NP,2014.0,2,0,2
DK,GE,2017.0,1,0,1
BE,NO,2023.0,2,0,2
CF,GF,2004.0,1,0,1
SE,GE,2010.0,1,0,1
nan,ST,2004.0,1,0,1
PE,RO,2017.0,1,0,1
DZ,AE,2003.0,1,0,1
IR,RO,2017.0,1,0,1
AE,nan,2005.0,1,0,1
TG,ID,2018.0,1,0,1
LU,QA,2018.0,1,0,1
nan,LU,2009.0,1,0,1
VE,PL,2018.0,2,0,2
PL,HK,2012.0,2,0,2
IN,LY,2008.0,1,0,1
TH,BT,2013.0,2,0,2
NO,NG,2004.0,1,0,1
KE,TH,2012.0,1,0,1
NL,WS,2021.0,1,0,1
FJ,TL,2015.0,1,0,1
MA,KR,2019.0,1,0,1
CG,BF,2016.0,1,0,1
MG,AU,2013.0,1,0,1
IE,TH,2021.0,1,0,1
PH,MM,2018.0,1,0,1
BM,,2024.0,7,0,7
CM,IT,1999.0,2,0,2
QA,AE,2002.0,1,0,1
PH,CZ,2006.0,1,0,1
CR,JP,2022.0,1,0,1
EG,KN,2021.0,1,0,1
BR,NE,2013.0,2,0,2
MX,CG,2011.0,1,0,1
JP,PE,2007.0,1,0,1
IL,GE,2001.0,1,0,1
KR,FJ,2019.0,1,0,1
CY,IT,2002.0,2,0,2
PL,UG,2019.0,1,0,1
,LS,2004.0,6,0,6
AE,NP,2012.0,1,0,1
DZ,MD,2019.0,1,0,1
RU,EC,2001.0,1,0,1
GM,,2008.0,9,0,9
QA,CY,2021.0,2,0,2
MR,SN,2002.0,1,0,1
PK,AM,2022.0,4,0,4
MZ,SE,2008.0,1,0,1
PA,ID,2012.0,2,0,2
KR,SK,2020.0,1,0,1
TW,EE,2014.0,1,0,1
ID,NA,2022.0,1,0,1
LK,IL,2021.0,2,0,2
CA,BJ,2005.0,1,0,1
NA,,2008.0,5,0,5
DZ,NO,2022.0,3,0,3
CM,TZ,2010.0,1,0,1
HK,SE,2008.0,1,0,1
SY,ID,2016.0,1,0,1
PS,IR,2011.0,1,0,1
CU,PY,1998.0,1,0,1
MG,NE,2004.0,2,0,2
IE,MA,2019.0,1,0,1
SE,JM,2019.0,1,0,1
AU,MT,2005.0,1,0,1
BR,ME,2020.0,1,0,1
UA,PE,2020.0,2,0,2
AR,SV,2012.0,1,0,1
DZ,RU,2003.0,1,0,1
PK,NO,2000.0,5,0,5
PH,BJ,2017.0,1,0,1
KH,nan,2015.0,1,0,1
AZ,CY,2018.0,1,0,1
BE,LT,1999.0,1,0,1
SY,IT,2011.0,1,0,1
DE,BW,2009.0,2,0,2
LT,KW,1998.0,1,0,1
BO,CG,2008.0,1,0,1
IE,DZ,2017.0,1,0,1
QA,SI,2020.0,1,0,1
MM,CZ,2002.0,2,0,2
MR,MA,2017.0,1,0,1
BB,,2014.0,5,0,5
ST,US,1999.0,1,0,1
SA,BE,2003.0,1,0,1
HK,CH,2014.0,1,0,1
MC,TN,2018.0,1,0,1
VE,MY,2019.0,1,0,1
PT,KZ,2019.0,1,0,1
GB,ME,2014.0,1,0,1
IT,UZ,2016.0,2,0,2
FR,PE,2005.0,1,0,1
IE,MA,2010.0,1,0,1
TW,MM,2008.0,1,0,1
KH,GA,2011.0,1,0,1
MK,TR,2017.0,2,0,2
LU,IS,2018.0,1,0,1
MY,NG,2000.0,1,0,1
DE,CL,2023.0,1,0,1
TN,PT,2006.0,1,0,1
CY,DE,2004.0,1,0,1
PH,BJ,2019.0,1,0,1
IT,BF,2001.0,1,0,1
IL,KH,2018.0,1,0,1
KE,SA,2010.0,1,0,1
RS,AZ,2007.0,2,0,2
IS,SJ,2017.0,1,0,1
NG,SZ,2018.0,2,0,2
FJ,LK,2019.0,1,0,1
PG,CH,2019.0,1,0,1
FR,PR,2016.0,1,0,1
GT,BO,2015.0,1,0,1
GE,TW,2021.0,1,0,1
QA,BW,2009.0,1,0,1
VE,CZ,2015.0,1,0,1
NZ,BH,2014.0,1,0,1
IN,JM,2023.0,1,0,1
MD,DZ,2016.0,2,0,2
GH,GB,2001.0,3,3,0
IE,RO,2009.0,2,1,1
KE,BH,2002.0,1,4,-3
QA,PH,2017.0,3,3,0
IN,CZ,1998.0,3,4,-1
NO,AT,2007.0,2,6,-4
KE,BE,2004.0,1,6,-5
RU,ET,2019.0,2,3,-1
ZW,BH,2015.0,1,1,0
BG,CA,2018.0,2,6,-4
MM,IN,2020.0,1,3,-2
NI,CR,2018.0,1,4,-3
JP,EC,2022.0,2,2,0
BW,SE,2013.0,1,1,0
AU,CZ,2000.0,2,3,-1
DZ,DE,2012.0,3,1,2
CN,CU,2014.0,1,1,0
PS,NO,2019.0,2,3,-1
GF,DE,2019.0,1,1,0
TR,CY,2002.0,1,1,0
GF,GP,2005.0,2,1,1
QA,IT,2011.0,1,1,0
CU,PY,1997.0,2,5,-3
ET,JP,2012.0,3,2,1
HU,UA,2011.0,1,3,-2
EG,ID,2009.0,2,3,-1
BY,SE,2018.0,1,2,-1
PE,DK,2020.0,2,2,0
LT,FR,2009.0,2,2,0
CI,DE,2010.0,1,1,0
BF,KE,2007.0,1,1,0
ID,UG,2022.0,1,1,0
UA,CZ,2004.0,1,2,-1
DE,CU,2004.0,3,4,-1
MX,DO,2015.0,4,4,0
GP,CA,2007.0,1,1,0
CN,YE,2019.0,2,2,0
ID,IQ,2014.0,2,1,1
NL,JO,2017.0,1,1,0
RO,IE,2008.0,1,4,-3
TZ,IN,2020.0,1,5,-4
PE,CA,2007.0,4,1,3
TR,KW,2002.0,2,2,0
CH,PF,2017.0,1,1,0
GT,AR,2022.0,1,1,0
PH,DE,1998.0,1,4,-3
CN,KH,2007.0,1,1,0
GB,MK,2002.0,2,2,0
IN,TT,2006.0,2,2,0
BB,GB,2001.0,1,1,0
EG,BH,2002.0,1,1,0
VN,SE,2014.0,2,5,-3
BN,EG,2017.0,1,2,-1
TR,IL,2002.0,1,4,-3
SI,US,2023.0,1,1,0
CA,ID,1999.0,1,1,0
AG,CO,2023.0,1,1,0
UG,CY,2018.0,1,1,0
CY,DK,2022.0,1,1,0
OM,SD,2016.0,1,1,0
RU,NZ,2009.0,1,1,0
PT,RO,2019.0,3,3,0
CZ,RS,1997.0,1,3,-2
FR,PK,1999.0,2,2,0
BD,NO,2014.0,1,1,0
ME,SI,2016.0,1,2,-1
IT,PT,1998.0,2,6,-4
HR,CL,2016.0,1,1,0
FO,GB,2008.0,1,1,0
SV,ES,2013.0,2,5,-3
NP,ZA,2017.0,1,1,0
IS,IQ,2021.0,1,1,0
SN,BF,2010.0,3,2,1
PA,VE,2016.0,1,4,-3
MK,SK,2018.0,1,2,-1
BR,QA,2017.0,1,2,-1
EG,SE,2000.0,1,2,-1
AU,BN,2022.0,2,1,1
CO,PT,1999.0,1,1,0
PE,PK,2017.0,2,1,1
nan,ZA,2001.0,1,1,0
LA,FR,2019.0,1,2,-1
GR,TR,1998.0,1,1,0
AR,SK,2007.0,1,1,0
LU,BR,2013.0,1,4,-3
ZW,BE,2016.0,1,1,0
KE,BH,2005.0,1,3,-2
GH,ET,2016.0,1,1,0
TR,MY,2002.0,1,2,-1
CY,AU,2018.0,1,3,-2
MA,BE,2002.0,2,1,1
BE,SI,2005.0,2,1,1
PL,BG,2003.0,2,2,0
US,FO,2008.0,1,1,0
JO,IN,2015.0,1,2,-1
PH,MY,2011.0,1,3,-2
EE,AM,2017.0,1,1,0
IN,MX,1998.0,1,4,-3
CG,BE,2015.0,1,2,-1
NZ,BE,2001.0,1,2,-1
UG,ES,2014.0,1,3,-2
SC,FR,2013.0,1,1,0
EG,CH,2008.0,1,2,-1
ZA,GA,2011.0,1,1,0
BZ,US,2008.0,1,1,0
FR,GH,2014.0,2,1,1
BD,SE,2011.0,2,5,-3
KE,SA,2019.0,1,1,0
HU,TR,2013.0,2,2,0
BR,RO,2021.0,1,7,-6
PE,DE,2000.0,1,2,-1
PA,RU,2015.0,1,1,0
PA,TN,2008.0,1,1,0
PL,BR,2004.0,1,1,0
CA,MZ,2008.0,1,1,0
DE,LY,2017.0,2,1,1
TR,AL,2015.0,2,2,0
AE,IE,2021.0,1,4,-3
MY,MK,2011.0,1,2,-1
AM,KR,2020.0,2,3,-1
SY,IN,2018.0,2,6,-4
SI,RU,2006.0,1,2,-1
MD,BE,2004.0,1,2,-1
GB,NP,2002.0,1,2,-1
IN,CZ,1997.0,1,1,0
IL,PH,1997.0,1,1,0
ES,RO,1997.0,1,2,-1
BW,NA,2019.0,1,1,0
GB,ZM,2021.0,1,2,-1
DZ,MD,2010.0,1,7,-6
BO,SE,2007.0,1,1,0
EG,ZA,2011.0,1,2,-1
SE,UA,1998.0,1,8,-7
JP,AM,2011.0,1,4,-3
IE,GR,2006.0,1,3,-2
US,LY,2001.0,1,2,-1
KW,CN,2022.0,2,1,1
CH,GT,2011.0,1,1,0
AU,MN,2015.0,1,1,0
GR,HU,2001.0,1,1,0
TN,JP,2002.0,2,2,0
QA,MX,2014.0,1,2,-1
UA,KZ,2003.0,1,1,0
nan,BO,2016.0,1,1,0
AU,NP,2005.0,2,2,0
PK,FR,1998.0,1,3,-2
AM,AZ,2020.0,1,1,0
SY,DE,2010.0,1,3,-2
BD,MY,2006.0,2,3,-1
ZM,CN,2018.0,2,3,-1
CZ,ZA,2010.0,1,3,-2
FR,MY,2003.0,1,1,0
PE,FR,2008.0,1,1,0
TW,NO,2007.0,1,1,0
DE,PS,2007.0,1,3,-2
NO,UA,2006.0,1,1,0
IE,ES,1997.0,1,2,-1
CN,PS,2013.0,1,1,0
SG,DK,1998.0,1,3,-2
YE,DE,2002.0,1,1,0
TR,IN,2002.0,2,5,-3
RU,PE,2015.0,1,1,0
LU,RO,2020.0,1,1,0
GB,BT,2021.0,1,1,0
nan,CN,2023.0,2,11,-9
CH,PK,2023.0,1,1,0
GM,CH,2019.0,1,1,0
TT,AU,2017.0,1,2,-1
MY,SA,1997.0,1,1,0
FI,EE,1997.0,1,6,-5
SG,IL,2017.0,3,4,-1
BF,IT,2012.0,2,2,0
VE,UY,2008.0,1,2,-1
MZ,BY,2018.0,1,1,0
LV,CH,2017.0,1,3,-2
DK,TR,2023.0,1,1,0
TZ,NL,2014.0,2,8,-6
TZ,MY,2018.0,1,2,-1
SE,MA,2016.0,1,1,0
GB,BO,2009.0,1,2,-1
MK,CH,2021.0,1,1,0
CU,JP,2007.0,1,2,-1
AT,UA,2022.0,1,5,-4
HR,SE,1997.0,1,3,-2
JP,CY,2015.0,1,1,0
MZ,KE,2017.0,1,0,1
CI,CZ,2015.0,1,0,1
LV,PK,2017.0,1,0,1
RU,VN,2006.0,1,0,1
BD,BH,2015.0,1,0,1
LB,KW,2011.0,1,0,1
FI,KZ,2015.0,1,0,1
JP,PR,2021.0,1,0,1
CM,IR,2018.0,1,0,1
ET,RW,2021.0,1,0,1
DE,LY,2010.0,1,0,1
CM,UG,1999.0,1,0,1
NI,CO,2011.0,1,0,1
GA,MA,2007.0,2,0,2
NZ,NP,2023.0,1,0,1
JP,SD,2008.0,3,0,3
ME,ES,2010.0,1,0,1
ML,AU,2008.0,1,0,1
BW,QA,2007.0,1,0,1
RW,ZM,2010.0,1,0,1
NZ,GE,2001.0,1,0,1
LY,MY,2003.0,1,0,1
MG,FI,2020.0,2,0,2
BY,IQ,2021.0,1,0,1
ES,MA,1998.0,1,0,1
RW,BI,2018.0,1,0,1
DE,GM,2019.0,1,0,1
MD,SE,2002.0,1,0,1
BJ,TH,2005.0,1,0,1
AE,TR,2004.0,1,0,1
US,LR,1999.0,2,0,2
BZ,ES,2018.0,1,0,1
US,SK,2023.0,1,0,1
KH,LT,2014.0,1,0,1
MN,US,2000.0,1,0,1
TT,SA,2009.0,1,0,1
TW,UA,2003.0,3,0,3
KZ,RS,2011.0,1,0,1
GB,BA,2015.0,4,0,4
CM,TD,2019.0,2,0,2
CZ,TZ,2021.0,1,0,1
DE,MW,2011.0,1,0,1
NG,AR,2000.0,1,0,1
LA,SL,2017.0,1,0,1
FR,GM,2002.0,2,0,2
JM,NG,2014.0,1,0,1
GB,FK,2021.0,3,0,3
FI,QA,2000.0,2,0,2
AL,BE,2013.0,1,0,1
CW,AU,2018.0,1,0,1
RW,ZM,2017.0,2,0,2
LA,CG,2021.0,1,0,1
EC,CR,2008.0,1,0,1
IE,KR,2003.0,1,0,1
IQ,QA,2004.0,1,0,1
CL,RO,2010.0,1,0,1
ET,NA,2014.0,1,0,1
GT,PH,2007.0,1,0,1
CL,LU,2021.0,1,0,1
GR,ET,2017.0,1,0,1
TG,TR,2015.0,2,0,2
ZA,BN,2008.0,1,0,1
UZ,TR,2011.0,1,0,1
MW,KE,2002.0,1,0,1
CG,US,2022.0,1,0,1
NP,AT,2020.0,1,0,1
MT,IN,2014.0,1,0,1
US,GA,2015.0,2,0,2
US,SX,2016.0,1,0,1
ID,MX,2008.0,2,0,2
BN,EG,2010.0,1,0,1
MG,ID,2018.0,1,0,1
SE,KE,1998.0,1,0,1
KE,EC,2021.0,1,0,1
GI,MT,2017.0,1,0,1
KR,JO,2021.0,1,0,1
ES,QA,2001.0,1,0,1
AD,ES,2012.0,1,0,1
YE,nan,2017.0,1,0,1
TT,SG,2020.0,1,0,1
KH,HK,2007.0,1,0,1
PH,RU,2013.0,1,0,1
CH,IS,2006.0,2,0,2
FI,SI,1999.0,1,0,1
PA,JP,2008.0,2,0,2
TT,BD,2015.0,1,0,1
CY,MA,2022.0,1,0,1
TR,RW,2021.0,2,0,2
IT,VN,1997.0,1,0,1
PT,UY,2002.0,1,0,1
BA,ES,2012.0,1,0,1
LU,GR,2023.0,1,0,1
CW,DK,2018.0,1,0,1
MY,IQ,1999.0,1,0,1
QA,UG,2020.0,1,0,1
MN,,2006.0,1,0,1
BF,DZ,2014.0,1,0,1
BD,PY,2015.0,1,0,1
BE,PA,2008.0,1,0,1
NA,GB,2008.0,1,0,1
ZA,UZ,2011.0,1,0,1
SE,KP,1999.0,1,0,1
GB,GA,2004.0,1,0,1
JO,CH,2007.0,1,0,1
AW,,2022.0,1,0,1
KG,KZ,2013.0,1,0,1
JP,SN,2011.0,1,0,1
TR,GH,2013.0,2,0,2
CY,IT,2005.0,2,0,2
ML,MA,2002.0,1,0,1
MN,GB,2007.0,1,0,1
SI,PH,2017.0,1,0,1
AU,HK,2004.0,1,0,1
SY,SA,2002.0,1,0,1
CA,PG,2000.0,1,0,1
IT,PS,2008.0,1,0,1
YE,ES,2011.0,1,0,1
GE,BY,2012.0,1,0,1
MT,FI,2006.0,1,0,1
JP,IQ,2020.0,3,0,3
LB,PL,2017.0,1,0,1
KR,BG,2016.0,1,0,1
MZ,TT,2019.0,1,0,1
HK,PK,2007.0,1,0,1
CO,PR,2006.0,1,0,1
SK,NO,2006.0,1,0,1
SY,HU,2012.0,1,0,1
UZ,SK,2013.0,1,0,1
AE,BN,2021.0,1,0,1
BJ,ZM,2016.0,1,0,1
AT,QA,2011.0,1,0,1
DK,LT,2005.0,1,0,1
NL,CZ,2023.0,1,0,1
TZ,ZA,2023.0,1,0,1
NG,BF,2008.0,1,0,1
CA,BI,2022.0,1,0,1
PL,UG,2017.0,1,0,1
SG,PK,2009.0,1,0,1
VN,FI,2009.0,1,0,1
AT,LI,2002.0,1,0,1
CZ,UA,2003.0,1,0,1
IR,nan,2023.0,1,0,1
AT,ET,2001.0,1,0,1
AT,VE,1999.0,1,0,1
CD,US,2003.0,1,0,1
DE,MZ,2000.0,1,0,1
PT,EC,2007.0,1,0,1
SG,CZ,2023.0,1,0,1
CU,PE,2006.0,1,0,1
BE,NP,2013.0,1,0,1
TT,BB,2000.0,1,0,1
PT,KZ,2010.0,1,0,1
BR,LY,2019.0,1,0,1
KH,SG,2008.0,1,0,1
CN,HN,2019.0,1,0,1
PA,RO,2016.0,1,0,1
HN,GB,2018.0,1,0,1
nan,GH,2001.0,1,0,1
MG,PK,2020.0,1,0,1
MX,AF,2002.0,1,0,1
PT,PG,2006.0,1,0,1
GF,GP,2002.0,1,0,1
SD,nan,2020.0,1,0,1
JO,CY,2016.0,1,0,1
AM,AT,2021.0,1,0,1
PR,PK,2018.0,1,0,1
LV,BR,2020.0,1,0,1
TT,ES,2005.0,1,0,1
HU,NL,2023.0,1,0,1
ZM,UG,2002.0,1,0,1
LA,,2009.0,1,0,1
PT,IS,2018.0,1,0,1
DZ,GB,2000.0,1,0,1
EC,IS,2016.0,1,0,1
KE,GR,2014.0,1,0,1
CA,AL,2016.0,1,0,1
RU,ZM,2019.0,1,0,1
SE,KE,1997.0,1,0,1
BE,ZM,2002.0,1,0,1
RO,GW,2014.0,1,0,1
PK,VN,2011.0,1,0,1
nan,LB,2016.0,2,0,2
LK,ES,2008.0,1,0,1
SE,LA,2018.0,1,0,1
BJ,BI,2008.0,1,0,1
BR,IQ,2011.0,1,0,1
KZ,CA,2016.0,1,0,1
NP,KR,2023.0,2,0,2
US,GD,2001.0,1,0,1
PL,SA,2009.0,1,0,1
RE,ZA,2012.0,1,0,1
SD,JP,1998.0,1,0,1
CZ,YE,2002.0,1,0,1
MY,SY,2010.0,1,0,1
FJ,CZ,2006.0,1,0,1
VE,FI,2008.0,1,0,1
,KN,2009.0,1,0,1
KE,CR,2013.0,1,0,1
BO,IT,2000.0,1,0,1
CD,PK,2020.0,1,0,1
CH,GN,2013.0,1,0,1
GE,HU,2021.0,1,0,1
GB,TG,2006.0,1,0,1
LV,CH,2010.0,1,0,1
SN,TN,2021.0,1,0,1
BY,NO,2013.0,1,0,1
CA,BJ,2002.0,1,0,1
MX,IS,2014.0,1,0,1
US,KR,2012.0,1371,1064,307
US,JP,2011.0,1881,1758,123
VN,NO,2014.0,3,5,-2
PT,AU,2012.0,10,9,1
IN,US,2020.0,3064,3043,21
DE,US,2004.0,2028,1852,176
GB,US,2022.0,3438,3424,14
VE,US,2003.0,43,42,1
US,BE,2020.0,405,383,22
PT,IT,2009.0,12,26,-14
GB,DK,2002.0,51,66,-15
CA,GB,2010.0,809,802,7
CH,IT,2015.0,218,365,-147
US,NL,2014.0,743,715,28
FR,IL,2022.0,16,12,4
VE,ES,2012.0,115,53,62
JP,CN,2002.0,412,305,107
CN,CA,2010.0,387,482,-95
CH,CN,2018.0,92,101,-9
CN,CA,2017.0,482,639,-157
CN,AU,2017.0,494,509,-15
KR,US,2004.0,724,857,-133
AT,US,2019.0,228,274,-46
NZ,CA,2016.0,78,70,8
CN,US,2000.0,1847,2060,-213
IT,GB,2012.0,502,387,115
IN,GB,2021.0,483,450,33
CA,GB,2019.0,1013,1063,-50
FR,JP,2013.0,111,125,-14
FR,CN,2004.0,232,179,53
CA,IE,2020.0,161,147,14
KR,JP,2020.0,374,371,3
GB,SA,2000.0,17,12,5
IN,AU,2018.0,230,200,30
DE,ES,2002.0,78,74,4
GR,US,2007.0,139,175,-36
CA,GB,2017.0,938,888,50
CL,DE,2000.0,12,16,-4
JP,CN,2005.0,590,379,211
MX,EC,2019.0,193,112,81
IT,US,2018.0,1159,1063,96
EG,QA,2002.0,6,5,1
CO,BR,2016.0,168,143,25
CN,NL,2021.0,126,166,-40
CN,AU,2019.0,599,582,17
CA,DE,2003.0,126,173,-47
US,NZ,2008.0,318,283,35
IN,KR,2007.0,120,65,55
UA,RU,2017.0,543,419,124
TH,DE,2019.0,16,25,-9
JP,BD,2019.0,91,62,29
MA,FR,2011.0,271,275,-4
CN,CA,2019.0,527,636,-109
LB,US,2016.0,100,71,29
CO,US,2011.0,214,239,-25
ES,VE,2018.0,53,75,-22
IR,CA,2016.0,305,170,135
IN,DE,2016.0,222,226,-4
DE,ES,2005.0,138,104,34
ES,nan,2016.0,104,52,52
BR,FR,1997.0,24,41,-17
JP,FR,2022.0,90,101,-11
SE,AU,2001.0,17,24,-7
PE,BR,2018.0,84,95,-11
ES,GB,2012.0,314,336,-22
NO,CH,2010.0,16,19,-3
US,AU,1999.0,1107,987,120
NL,AE,2014.0,1,2,-1
UA,RU,2019.0,755,594,161
JP,GB,2009.0,276,290,-14
AU,nan,2019.0,27,32,-5
IN,IE,2016.0,39,18,21
JP,BD,2017.0,52,63,-11
CA,IN,2012.0,190,178,12
CN,AU,2010.0,281,270,11
ES,PE,2022.0,74,79,-5
EC,IT,2021.0,11,5,6
CN,SG,2021.0,398,571,-173
UY,BR,2007.0,24,22,2
JP,IQ,2004.0,1,1,0
IE,US,2011.0,449,519,-70
US,KN,2020.0,10,5,5
SA,IQ,2021.0,33,30,3
CN,JP,2001.0,327,377,-50
AE,OM,2017.0,3,11,-8
DK,CN,2020.0,60,86,-26
PE,ES,1998.0,7,9,-2
CU,CL,2013.0,23,10,13
PY,FR,2017.0,1,2,-1
IT,AR,2002.0,36,35,1
SA,AE,2016.0,37,19,18
FR,CA,2014.0,623,559,64
DE,AR,2008.0,18,16,2
ES,CA,2011.0,76,70,6
CA,ES,1999.0,19,19,0
AT,JP,2006.0,8,8,0
ES,SA,2020.0,9,6,3
CN,BR,2006.0,26,38,-12
PT,FR,2016.0,56,62,-6
AU,CN,2021.0,552,431,121
BD,PK,2018.0,55,51,4
IT,CA,2021.0,107,108,-1
FR,CZ,1999.0,23,12,11
US,MX,2021.0,293,388,-95
BR,AR,2016.0,164,173,-9
IN,MY,2022.0,46,76,-30
PA,MX,2021.0,7,5,2
CH,SG,2017.0,20,18,2
IT,BE,1999.0,52,35,17
HU,FI,2006.0,3,7,-4
TR,DE,2020.0,140,101,39
US,SY,2010.0,4,4,0
IT,FR,1998.0,157,108,49
MK,AU,2010.0,31,28,3
US,JM,2006.0,15,8,7
KR,DE,2021.0,59,46,13
BR,CO,2014.0,129,145,-16
CL,CO,2007.0,80,84,-4
GB,DK,2005.0,78,97,-19
GB,TH,2005.0,43,20,23
RU,BR,2002.0,11,12,-1
ZA,CA,2011.0,25,31,-6
US,QA,2017.0,84,81,3
AU,SG,2000.0,36,27,9
FR,RO,2015.0,51,44,7
SA,KW,2018.0,28,33,-5
NG,ID,2019.0,26,20,6
SE,TH,2006.0,7,3,4
GP,FR,2019.0,28,24,4
AT,US,2017.0,236,275,-39
EG,FR,2012.0,23,32,-9
LU,GB,2010.0,5,6,-1
GB,IE,2020.0,499,428,71
ZA,ZW,2021.0,38,52,-14
CN,CO,2008.0,2,4,-2
CO,CN,2012.0,3,7,-4
PK,IN,2009.0,80,81,-1
SA,CN,2010.0,6,9,-3
CZ,CN,2003.0,20,24,-4
IT,AT,2015.0,66,36,30
BE,US,2021.0,295,294,1
CN,IE,2015.0,45,46,-1
MX,GB,2006.0,35,48,-13
GB,nan,2003.0,84,38,46
SE,NO,2004.0,54,57,-3
GR,GB,2011.0,192,173,19
CN,MY,2011.0,45,34,11
BE,KR,2015.0,16,9,7
IT,AR,2005.0,50,61,-11
NL,KW,2011.0,1,1,0
RU,DE,2015.0,158,169,-11
AR,GB,2004.0,24,13,11
RU,US,2007.0,319,246,73
SA,QA,2014.0,18,6,12
PH,ES,2012.0,11,14,-3
ZA,NA,2011.0,5,2,3
MX,CU,1999.0,16,11,5
LT,FI,2021.0,2,4,-2
DK,PL,2017.0,14,11,3
FR,PL,2011.0,50,30,20
RU,NL,2021.0,34,24,10
FR,NE,2011.0,3,2,1
IN,IR,2015.0,53,27,26
RU,IL,2020.0,54,39,15
nan,RU,2011.0,65,39,26
RU,CZ,2019.0,72,75,-3
FR,nan,2014.0,242,214,28
SK,CZ,2022.0,80,69,11
TR,SE,2014.0,11,14,-3
CH,CA,2013.0,106,111,-5
GB,AT,2018.0,130,114,16
CA,TN,2006.0,8,2,6
PR,ET,2019.0,4,8,-4
NL,KR,2010.0,8,6,2
DE,RU,2022.0,70,113,-43
AU,FR,2020.0,112,139,-27
IT,HU,2015.0,13,10,3
JP,TH,2017.0,105,67,38
SA,US,2011.0,59,153,-94
KW,US,2022.0,9,18,-9
ID,BN,2019.0,5,6,-1
CN,FI,2001.0,6,15,-9
GB,MW,2016.0,8,12,-4
EG,PS,2019.0,9,19,-10
MX,EC,2017.0,144,60,84
CA,IT,2012.0,76,91,-15
UG,CA,2015.0,3,1,2
ML,GN,2018.0,2,5,-3
CH,NL,2009.0,87,104,-17
NL,PL,2007.0,20,22,-2
BE,DK,2019.0,69,64,5
CO,IT,2021.0,25,17,8
CZ,SK,2014.0,106,132,-26
IN,PH,2005.0,3,1,2
TR,JP,2020.0,73,51,22
AR,nan,2008.0,28,29,-1
TN,CH,2015.0,8,10,-2
VN,IT,2013.0,3,2,1
US,QA,2010.0,46,16,30
SE,TR,2014.0,14,11,3
GB,SE,1999.0,65,68,-3
BR,CN,2009.0,39,35,4
EE,DE,2011.0,34,43,-9
VN,MY,2022.0,4,6,-2
ID,NL,2020.0,45,51,-6
PL,RU,2015.0,32,26,6
ZA,IT,2015.0,15,20,-5
MK,AU,2019.0,49,37,12
JP,SE,2016.0,39,43,-4
ES,NL,2001.0,33,30,3
IT,NO,2010.0,14,7,7
US,EG,1999.0,53,47,6
IN,RU,2019.0,43,32,11
AR,DE,2022.0,26,23,3
DK,AU,2011.0,32,34,-2
CA,nan,2011.0,33,36,-3
IT,RU,2004.0,24,24,0
US,PH,2008.0,362,338,24
AU,HK,2020.0,8,2,6
SE,ES,2014.0,39,72,-33
GB,IL,2013.0,70,47,23
SA,MA,2022.0,8,4,4
AT,RU,2005.0,11,13,-2
TH,JP,2016.0,86,116,-30
FR,NO,2007.0,58,26,32
AE,IN,2018.0,55,107,-52
CZ,AU,1999.0,2,1,1
AU,SA,2014.0,42,21,21
SA,RU,2021.0,5,3,2
QA,US,2021.0,76,59,17
BR,GB,1997.0,29,37,-8
US,UA,2013.0,44,53,-9
US,AR,2000.0,79,118,-39
AT,CA,2020.0,22,23,-1
SE,CH,2020.0,64,120,-56
AU,nan,2010.0,46,32,14
TJ,RU,2022.0,30,375,-345
CN,AT,2013.0,13,17,-4
CL,VE,2004.0,11,6,5
ZA,IN,2022.0,29,35,-6
IN,SA,2013.0,105,36,69
HR,US,2021.0,39,29,10
HU,DE,2000.0,43,25,18
NL,MX,2013.0,13,18,-5
FR,MX,2001.0,32,22,10
US,PK,2023.0,26,19,7
UA,PL,2021.0,62,44,18
CA,EG,2013.0,53,35,18
MA,US,2022.0,14,10,4
US,QA,2019.0,83,77,6
HU,SA,2019.0,3,2,1
MA,KW,2010.0,4,5,-1
CY,US,2014.0,15,22,-7
RU,IN,2021.0,29,22,7
MY,JO,2013.0,15,13,2
ES,HU,2015.0,10,4,6
AT,PL,2010.0,8,17,-9
CH,NZ,2022.0,7,9,-2
RU,LV,2019.0,18,21,-3
IT,NO,2019.0,49,23,26
HK,CN,2020.0,143,176,-33
GH,PH,2019.0,4,1,3
IQ,EG,2022.0,44,56,-12
DZ,US,2001.0,1,1,0
MK,AU,2017.0,60,49,11
PL,IL,2000.0,1,2,-1
JP,AU,2003.0,56,52,4
GB,NO,2023.0,5,4,1
AT,CZ,2020.0,42,39,3
PT,US,2004.0,80,115,-35
ZA,GH,2019.0,17,22,-5
RU,AU,2013.0,40,20,20
GB,RO,2021.0,57,54,3
DE,PL,1998.0,45,54,-9
NZ,VN,2016.0,3,3,0
ID,IN,2022.0,63,20,43
GR,ES,2011.0,14,15,-1
HU,GB,2004.0,43,27,16
LU,DE,2017.0,33,43,-10
ET,KR,2020.0,100,86,14
TR,AZ,2018.0,7,14,-7
ZA,NG,2022.0,64,80,-16
TH,MY,2020.0,11,11,0
BR,PL,2021.0,26,24,2
KE,TZ,2020.0,15,10,5
IT,PL,2022.0,21,25,-4
AU,nan,2017.0,21,40,-19
RU,CA,1997.0,18,17,1
US,TZ,2022.0,15,5,10
IT,JP,2020.0,55,48,7
CH,NG,2009.0,3,3,0
ID,nan,2018.0,65,92,-27
CO,DE,2011.0,14,21,-7
AT,MX,2017.0,3,9,-6
IR,IN,2013.0,34,41,-7
BE,IE,2020.0,12,8,4
KW,JO,2018.0,8,10,-2
CA,TW,2019.0,45,41,4
IQ,SA,2018.0,22,39,-17
BR,IN,2018.0,40,46,-6
DE,UG,2021.0,4,3,1
AU,IN,2003.0,48,48,0
ZW,US,2019.0,12,12,0
CA,LK,2003.0,4,1,3
GR,TW,2014.0,1,1,0
PL,BR,2020.0,20,27,-7
IN,PL,2022.0,18,4,14
PT,TN,2021.0,4,4,0
TJ,UA,2019.0,1,6,-5
CY,IQ,2021.0,2,2,0
MZ,US,2022.0,5,1,4
LT,SE,2021.0,9,7,2
MY,UA,2020.0,9,4,5
LB,AE,2021.0,11,2,9
PL,UA,2020.0,58,58,0
JO,PK,2021.0,3,3,0
TZ,KE,2018.0,10,9,1
MY,VN,2018.0,12,2,10
SA,CN,2017.0,52,41,11
US,CH,2020.0,823,887,-64
AU,JP,2011.0,56,82,-26
IT,UA,2002.0,7,8,-1
IE,CA,2008.0,105,115,-10
TW,AU,2012.0,34,30,4
TR,US,2007.0,276,340,-64
JP,TH,2019.0,117,90,27
RU,CZ,2017.0,59,88,-29
BE,nan,2000.0,11,11,0
VN,GR,2002.0,5,4,1
FR,IN,1999.0,53,23,30
IT,DK,2019.0,52,35,17
TN,SE,2019.0,3,3,0
JP,BD,2010.0,58,47,11
SK,CH,2009.0,13,4,9
PH,PL,2014.0,1,2,-1
CN,CH,2018.0,101,92,9
MY,PL,2020.0,3,1,2
MM,IQ,2021.0,4,2,2
TR,IT,2017.0,23,15,8
BG,US,2003.0,29,21,8
SA,TN,2007.0,2,6,-4
SA,SE,2014.0,4,11,-7
NL,IT,2002.0,46,48,-2
nan,SN,2013.0,1,1,0
RU,CH,2013.0,27,30,-3
JP,TW,2009.0,94,55,39
IT,BR,2006.0,119,118,1
CN,GH,2014.0,6,3,3
BR,RU,2006.0,11,8,3
TW,KR,2014.0,55,34,21
NP,NZ,2014.0,28,25,3
UA,RU,2010.0,123,137,-14
NL,PH,2015.0,2,5,-3
TN,US,2016.0,26,26,0
BI,FR,2004.0,15,9,6
SG,MX,2011.0,5,2,3
BE,TR,2001.0,5,3,2
SE,DK,2006.0,81,69,12
ME,RS,2008.0,11,5,6
ID,CN,2004.0,10,5,5
IT,MY,2013.0,55,48,7
CL,FR,2011.0,24,37,-13
IS,SE,2020.0,26,21,5
GP,FR,2017.0,34,20,14
ES,CH,2011.0,85,67,18
HR,BA,2015.0,31,28,3
FR,GF,2001.0,1,4,-3
SG,nan,2016.0,12,11,1
AT,US,2010.0,168,221,-53
LT,US,2010.0,9,7,2
CA,DZ,2016.0,12,11,1
NL,TN,2016.0,2,3,-1
TN,FR,2011.0,116,227,-111
ZA,PL,2015.0,7,2,5
EG,JP,2000.0,20,22,-2
SE,EE,2019.0,4,7,-3
BE,MA,2003.0,7,1,6
IT,FR,1997.0,96,120,-24
UA,CZ,2020.0,40,27,13
SK,DE,2006.0,30,25,5
IE,LV,2013.0,2,1,1
DK,PL,2019.0,12,11,1
NL,SE,2019.0,90,82,8
FR,FI,2017.0,42,24,18
GR,DE,2011.0,66,63,3
US,ES,2023.0,36,37,-1
VN,SG,2009.0,5,6,-1
IT,MA,2022.0,23,4,19
BG,RU,2021.0,33,60,-27
KR,NP,2020.0,23,7,16
CR,DE,2011.0,7,2,5
NG,JP,2018.0,23,26,-3
SE,JP,2003.0,36,37,-1
ES,NO,2018.0,35,24,11
UG,AU,2013.0,6,1,5
NG,CA,2003.0,2,2,0
AT,CN,2007.0,16,5,11
TH,FR,2001.0,2,1,1
FR,BO,2003.0,3,2,1
ID,AU,2019.0,67,126,-59
RU,BY,2021.0,84,65,19
DE,PL,1997.0,41,36,5
KE,JP,2012.0,10,9,1
SA,BD,2021.0,27,34,-7
TH,PH,2018.0,5,7,-2
CA,BD,2015.0,37,41,-4
IN,SD,2015.0,4,4,0
BE,KE,2008.0,2,2,0
VN,nan,2019.0,6,8,-2
RU,RS,2001.0,1,2,-1
AT,PL,2019.0,25,23,2
CU,AR,2003.0,7,6,1
AU,DK,2022.0,39,33,6
PL,SE,2013.0,16,19,-3
DK,NG,2015.0,1,1,0
IR,TN,2015.0,9,7,2
KW,GB,2013.0,5,24,-19
DK,IT,2013.0,21,40,-19
FR,CI,2008.0,22,11,11
DE,JO,2015.0,11,11,0
CA,TW,2017.0,36,40,-4
LT,US,2017.0,13,8,5
IL,SE,2016.0,7,7,0
SD,FR,2017.0,1,1,0
NO,LT,2018.0,1,1,0
IT,SA,2016.0,19,13,6
SA,CN,2019.0,44,56,-12
CY,DE,2020.0,4,11,-7
CL,GB,2021.0,57,49,8
KH,NL,2001.0,3,1,2
US,JO,2000.0,13,12,1
SI,FR,2016.0,8,7,1
CA,CL,2008.0,15,10,5
ZA,US,2004.0,190,194,-4
CZ,GB,2012.0,29,41,-12
RU,FR,2015.0,71,99,-28
GR,CA,2010.0,15,5,10
SI,ES,2019.0,13,15,-2
DK,BE,2006.0,9,11,-2
MM,SG,2018.0,5,9,-4
CN,LU,2017.0,4,3,1
US,GH,2004.0,7,9,-2
SN,US,2004.0,6,9,-3
CZ,UA,2012.0,13,22,-9
EE,CH,2011.0,6,7,-1
SG,IR,2013.0,40,27,13
US,CL,1999.0,54,37,17
AZ,IT,2016.0,7,2,5
AZ,RU,2005.0,2,1,1
AU,TW,2000.0,12,9,3
RS,SI,2020.0,21,19,2
AU,CL,2015.0,26,17,9
RW,SE,2017.0,2,4,-2
TR,CA,2020.0,49,23,26
HU,RO,2018.0,43,40,3
BA,DE,2021.0,6,3,3
NL,TW,2018.0,8,8,0
PT,CN,2008.0,12,11,1
IT,DZ,2011.0,18,11,7
UA,CA,2018.0,7,15,-8
DK,TZ,2019.0,1,1,0
GB,SY,2013.0,10,5,5
MA,CA,2019.0,19,26,-7
GR,CA,2017.0,19,15,4
FR,FI,2019.0,46,25,21
BE,LU,2013.0,15,13,2
US,AT,2023.0,8,7,1
nan,AR,2007.0,21,26,-5
ET,DE,2021.0,7,13,-6
nan,MX,2013.0,21,29,-8
KE,UG,2018.0,15,23,-8
JP,PL,2013.0,22,13,9
AR,ZA,2019.0,1,1,0
JP,IT,2000.0,33,26,7
NO,CH,2019.0,30,43,-13
CN,NO,2020.0,33,50,-17
GB,TH,2002.0,30,14,16
DE,MY,2019.0,22,27,-5
AE,PK,2020.0,32,29,3
nan,BE,1999.0,8,18,-10
NL,SE,2017.0,89,65,24
US,VE,2009.0,32,58,-26
UZ,KR,2005.0,2,2,0
BD,CA,2011.0,32,19,13
NG,ID,2017.0,16,6,10
CH,KR,2021.0,22,13,9
JP,ZM,2018.0,2,3,-1
KR,TR,2019.0,10,11,-1
SK,CN,2020.0,5,3,2
AT,TR,2022.0,14,4,10
RU,CZ,2010.0,19,27,-8
MA,SA,2018.0,12,2,10
RO,NL,2021.0,15,5,10
AZ,TR,2015.0,8,12,-4
RW,SE,2019.0,3,2,1
CH,BR,1999.0,9,9,0
NL,KR,2019.0,11,12,-1
SK,AT,2004.0,10,15,-5
PH,CH,2005.0,3,2,1
UY,IT,2013.0,9,15,-6
MA,BD,2011.0,10,4,6
PL,HU,2021.0,38,32,6
PL,NL,2007.0,22,20,2
EE,NO,2017.0,6,1,5
PL,BG,2012.0,2,1,1
DE,AU,2003.0,116,96,20
GR,LK,2017.0,7,4,3
BE,CI,2019.0,3,4,-1
DE,PK,2006.0,11,7,4
NZ,MY,2014.0,25,19,6
IT,NO,2017.0,41,16,25
GB,CZ,2009.0,35,39,-4
KR,RU,2022.0,7,14,-7
NG,CN,2004.0,6,2,4
CZ,HU,2005.0,6,5,1
SA,SD,2000.0,2,1,1
RU,LV,2017.0,20,21,-1
IL,AU,2018.0,27,14,13
PL,EG,2014.0,5,2,3
TN,DE,2011.0,5,5,0
KR,NL,2022.0,5,14,-9
SE,EE,2010.0,18,8,10
IE,MY,2009.0,8,1,7
PK,EE,2020.0,4,1,3
IN,SG,2005.0,27,26,1
CN,ES,2003.0,16,30,-14
NL,MY,2011.0,14,6,8
KE,DE,2012.0,12,11,1
HU,IN,1998.0,5,7,-2
US,SI,1999.0,8,14,-6
CA,MU,2013.0,1,1,0
nan,CL,2004.0,3,1,2
NO,IR,2015.0,11,10,1
TR,IL,2007.0,5,3,2
TR,GB,2003.0,17,51,-34
EE,RU,2009.0,2,5,-3
DK,CA,2001.0,10,24,-14
DZ,CA,2012.0,6,8,-2
SI,CH,2006.0,2,3,-1
CZ,LV,2018.0,2,2,0
HU,SE,2011.0,10,9,1
US,AL,2013.0,6,1,5
BE,RO,2022.0,10,7,3
JO,JP,2007.0,3,3,0
SK,RS,2013.0,8,5,3
RW,NL,2013.0,1,3,-2
BE,TZ,2018.0,4,1,3
ES,KR,2016.0,7,17,-10
GB,SI,2015.0,11,16,-5
SI,ES,2017.0,15,12,3
TR,PK,2012.0,9,9,0
BO,ES,2015.0,19,28,-9
PE,US,2006.0,33,37,-4
TR,SA,2008.0,6,3,3
SA,GB,2011.0,21,100,-79
PK,CO,2015.0,1,1,0
GB,KE,2003.0,16,13,3
BG,DE,2014.0,27,21,6
NO,CH,2017.0,28,30,-2
JP,RU,2008.0,30,53,-23
AU,ES,2001.0,9,10,-1
US,RO,2007.0,50,43,7
KE,BE,2020.0,9,6,3
LU,DE,2019.0,30,44,-14
ML,IN,2014.0,6,13,-7
CL,JP,2015.0,6,3,3
NO,PT,2011.0,5,10,-5
BN,MY,2019.0,12,13,-1
UA,JP,2007.0,7,2,5
PL,IE,2012.0,5,3,2
FI,SE,2009.0,71,109,-38
DK,AR,2017.0,6,5,1
US,AG,2016.0,4,3,1
DE,EG,2009.0,32,40,-8
MX,RU,2005.0,5,4,1
MA,CA,2017.0,21,23,-2
DE,NG,2011.0,7,7,0
ZA,GH,2017.0,16,17,-1
MY,EG,2014.0,34,36,-2
AT,DK,2014.0,16,10,6
GB,RS,2005.0,12,12,0
LU,DE,2010.0,19,39,-20
PT,MX,2012.0,14,20,-6
GE,GB,2007.0,5,2,3
FI,RU,2013.0,22,33,-11
MY,PS,2012.0,6,1,5
CL,ZA,2019.0,4,5,-1
FR,NC,2003.0,6,6,0
DZ,BR,2015.0,1,1,0
CA,AT,1997.0,4,5,-1
IN,SG,2002.0,25,17,8
CN,ZA,2016.0,11,26,-15
CH,SG,2019.0,17,22,-5
EG,LB,2012.0,11,5,6
NL,HU,2015.0,14,12,2
SE,AT,2022.0,23,19,4
RU,CA,1998.0,16,8,8
DE,GH,2020.0,22,12,10
IT,IR,2006.0,4,2,2
BR,GB,1998.0,41,67,-26
IE,AT,1998.0,1,3,-2
AR,ZA,2010.0,2,1,1
US,NO,2001.0,69,53,16
PE,ES,1997.0,13,7,6
CH,RO,2016.0,14,8,6
CO,CL,2003.0,39,32,7
PL,RO,2013.0,5,10,-5
UY,CO,2007.0,4,4,0
ID,JP,2003.0,16,44,-28
MY,PT,2011.0,4,2,2
VE,CR,2018.0,9,6,3
SE,EG,1999.0,2,1,1
PE,CR,2021.0,8,7,1
PE,CO,2001.0,8,1,7
LT,US,2019.0,5,16,-11
AR,NL,2011.0,9,7,2
IE,TR,2008.0,3,3,0
US,FJ,2009.0,3,4,-1
SI,ES,2010.0,12,12,0
MX,EC,2010.0,13,8,5
UY,NL,2020.0,5,1,4
CA,IQ,2013.0,4,3,1
CR,IL,2018.0,6,2,4
SG,HK,2007.0,1,2,-1
IT,DK,2010.0,23,21,2
BR,TL,2020.0,2,1,1
nan,TR,2016.0,16,24,-8
GB,VG,2001.0,2,4,-2
DE,SI,2022.0,12,10,2
US,SN,1998.0,3,7,-4
GN,FR,2016.0,4,3,1
AT,FR,1999.0,14,18,-4
VN,nan,2010.0,1,4,-3
DE,PT,2004.0,14,17,-3
CN,HU,2009.0,2,5,-3
SG,NZ,2019.0,13,20,-7
TN,SE,2017.0,2,2,0
BO,CN,2009.0,4,1,3
NL,BR,1998.0,10,4,6
FR,AM,2016.0,2,2,0
EG,PS,2017.0,9,9,0
KE,IN,2017.0,4,17,-13
AE,TR,2020.0,4,8,-4
KR,LK,2021.0,7,2,5
IE,SA,2015.0,8,5,3
JM,TT,2011.0,13,13,0
PK,BD,2009.0,17,14,3
GB,IS,2014.0,13,5,8
NA,DE,2020.0,2,2,0
CM,BE,2009.0,2,1,1
RU,GE,2012.0,6,2,4
RU,NO,2016.0,17,15,2
PL,SK,2015.0,14,13,1
SE,RU,2005.0,27,34,-7
DE,EE,1999.0,6,4,2
MC,FR,2009.0,4,4,0
RO,BG,2013.0,5,2,3
PK,AE,2022.0,28,14,14
FI,LV,2020.0,2,3,-1
RO,AT,2016.0,8,7,1
QA,AU,2006.0,5,6,-1
NL,EE,2013.0,4,2,2
UY,PE,2019.0,6,2,4
CZ,FR,2007.0,23,22,1
IT,LB,2018.0,7,10,-3
MW,AU,2018.0,4,1,3
BE,DK,2017.0,51,47,4
CO,TR,2016.0,7,23,-16
GE,CN,2023.0,1,1,0
PL,EE,2020.0,4,3,1
JO,SA,2023.0,1,2,-1
IL,nan,2001.0,8,17,-9
US,OM,2003.0,6,8,-2
MX,RU,2002.0,8,14,-6
FI,DE,2004.0,26,26,0
EG,ES,2017.0,5,14,-9
AU,PH,2007.0,8,4,4
IE,KR,2012.0,10,3,7
DE,KR,2006.0,37,17,20
ID,DE,2013.0,9,29,-20
GB,MY,2000.0,22,12,10
TN,SA,2006.0,1,2,-1
US,ZM,2020.0,18,16,2
GR,NL,2022.0,11,15,-4
BR,FR,1998.0,32,61,-29
JP,RO,2009.0,5,1,4
RS,ES,2022.0,3,2,1
BN,MY,2010.0,3,1,2
KE,NG,2014.0,2,5,-3
BA,NO,2019.0,1,1,0
UY,AR,2013.0,26,40,-14
US,ET,2016.0,44,47,-3
DE,MY,2017.0,18,30,-12
US,KZ,2012.0,10,6,4
HU,RU,2004.0,9,1,8
FR,AE,2015.0,25,6,19
ES,CZ,2008.0,11,10,1
TN,JP,2007.0,2,1,1
JO,QA,2008.0,3,3,0
TR,IT,2019.0,16,17,-1
MX,RS,2005.0,23,22,1
SG,AE,2012.0,5,2,3
TR,KR,2011.0,9,2,7
DK,NL,2008.0,21,28,-7
JP,NG,2004.0,8,4,4
CH,DZ,2019.0,5,2,3
US,RE,2016.0,5,1,4
CH,DK,2012.0,28,30,-2
AT,PL,2017.0,16,16,0
CH,GH,2018.0,4,2,2
AT,SA,2012.0,3,2,1
IL,BE,2005.0,9,4,5
IR,PT,2016.0,13,13,0
JP,FI,2014.0,11,15,-4
BE,UG,2016.0,22,6,16
UY,CA,2011.0,4,3,1
NG,GR,2010.0,1,1,0
SI,AT,2009.0,9,8,1
NL,MT,2019.0,2,1,1
LV,RU,2015.0,18,21,-3
MY,TR,2018.0,17,11,6
PK,DK,2003.0,2,1,1
ID,AU,2010.0,12,40,-28
CA,AT,1998.0,14,5,9
MA,CA,2010.0,9,15,-6
GR,nan,2011.0,4,4,0
ES,SI,2015.0,11,13,-2
AT,NZ,2020.0,8,2,6
RU,EG,2016.0,7,7,0
DE,NP,2007.0,4,2,2
BE,ID,2018.0,8,7,1
NL,RO,2020.0,11,8,3
IT,DK,2017.0,40,32,8
CZ,NO,2013.0,3,11,-8
PK,DE,2023.0,1,3,-2
nan,UA,2022.0,9,8,1
HR,CH,2011.0,7,2,5
BE,SE,2004.0,16,14,2
BR,PA,2012.0,4,1,3
SA,BE,2012.0,2,3,-1
ZA,SE,2013.0,17,8,9
KW,EG,2022.0,13,19,-6
UZ,BY,2010.0,2,2,0
IR,FI,2013.0,10,7,3
FR,RE,1999.0,4,7,-3
AT,SG,2018.0,6,4,2
PH,BR,2016.0,14,7,7
NL,LU,2013.0,9,4,5
NZ,IN,2014.0,20,24,-4
BR,VE,2009.0,9,18,-9
US,SY,2019.0,8,9,-1
DK,PL,2010.0,10,17,-7
BR,EG,2013.0,2,4,-2
PL,IQ,2017.0,2,2,0
AU,KR,2003.0,14,16,-2
ID,PL,2020.0,11,11,0
FR,MY,2012.0,13,12,1
PK,NL,2014.0,7,18,-11
CO,KR,2013.0,8,4,4
TN,MD,2003.0,2,1,1
ES,IN,2015.0,24,25,-1
OM,IN,1999.0,5,1,4
KR,SK,2004.0,2,2,0
CN,LU,2019.0,4,2,2
DE,AT,2023.0,21,18,3
CL,NL,2012.0,5,7,-2
AU,EE,2018.0,4,5,-1
SI,GB,2006.0,4,7,-3
CA,PL,2009.0,27,17,10
BE,RU,2008.0,16,17,-1
HU,SA,2017.0,2,3,-1
AE,CA,2009.0,10,17,-7
FR,SI,2011.0,10,7,3
CH,RS,2009.0,3,3,0
EG,ES,2019.0,8,13,-5
NZ,EG,2016.0,2,6,-4
BJ,GB,2018.0,3,1,2
BO,PE,2015.0,4,6,-2
CA,HR,2021.0,4,3,1
US,HK,2013.0,10,17,-7
BE,VN,2002.0,2,2,0
ES,IE,1997.0,2,1,1
LA,US,2012.0,1,2,-1
PK,CY,2018.0,2,1,1
PK,CH,2003.0,10,19,-9
KE,IN,2019.0,17,13,4
CL,PL,2018.0,5,3,2
CN,MD,2021.0,2,2,0
nan,VE,2009.0,1,2,-1
IT,CO,2016.0,20,24,-4
NZ,SA,2013.0,3,2,1
PK,TN,2007.0,1,6,-5
PA,ES,2021.0,9,12,-3
MX,CR,2022.0,10,17,-7
BO,CO,2018.0,6,9,-3
GH,NG,2016.0,5,14,-9
BH,PK,2021.0,2,4,-2
CN,AF,2020.0,2,1,1
IL,CN,2020.0,31,29,2
GB,NP,2007.0,5,5,0
GA,US,2016.0,2,2,0
BD,SG,2016.0,2,3,-1
GB,BH,2015.0,5,5,0
TZ,UG,2021.0,5,2,3
NL,TR,2000.0,10,5,5
LU,nan,2007.0,4,1,3
CN,RO,2021.0,8,9,-1
ZA,nan,2004.0,4,4,0
TH,DE,2010.0,20,17,3
DK,NP,2014.0,1,1,0
IR,TW,2013.0,3,10,-7
FI,SG,2017.0,5,1,4
ZA,SA,2021.0,2,5,-3
IE,PT,2011.0,6,2,4
EG,CA,2004.0,14,11,3
GB,MK,2007.0,3,4,-1
PT,PA,2016.0,2,1,1
BB,JM,2014.0,9,5,4
ZA,KE,2008.0,6,9,-3
CH,SA,2015.0,4,3,1
UY,DE,2022.0,4,1,3
CN,GR,2014.0,14,23,-9
BR,FI,2021.0,22,4,18
BR,BD,2018.0,2,1,1
JP,MA,2008.0,2,1,1
AE,OM,2010.0,3,1,2
DE,LT,2015.0,5,6,-1
PK,BR,2016.0,9,9,0
JP,IL,2001.0,12,8,4
TT,IN,2019.0,4,8,-4
LV,EE,2016.0,5,1,4
BE,EG,2013.0,5,4,1
US,BO,2005.0,11,5,6
SD,FR,2019.0,1,1,0
KZ,IN,2015.0,1,1,0
DZ,TN,2014.0,22,27,-5
HR,NO,2016.0,4,3,1
BE,DK,2010.0,11,10,1
SK,IT,2002.0,4,1,3
CR,FR,2008.0,4,1,3
NL,KR,2017.0,15,14,1
AT,MX,2019.0,5,4,1
PR,ET,2017.0,11,9,2
KR,SE,1999.0,6,2,4
BI,BE,2015.0,2,4,-2
JP,LT,2005.0,8,13,-5
VE,ID,2009.0,6,1,5
MT,NZ,2015.0,1,2,-1
BG,CZ,2013.0,2,4,-2
JP,TZ,2015.0,8,2,6
CN,LK,2003.0,2,2,0
BE,HU,2009.0,6,10,-4
QA,FR,2012.0,3,14,-11
US,MW,2021.0,14,14,0
OM,EG,2011.0,4,5,-1
DE,AZ,2008.0,1,2,-1
nan,PH,1999.0,1,1,0
LU,PL,2020.0,4,5,-1
GR,ZA,2012.0,2,1,1
IL,AT,2017.0,4,4,0
KE,NL,2011.0,4,5,-1
US,LV,2003.0,3,3,0
IE,IT,1998.0,4,3,1
IR,AT,2009.0,5,4,1
MA,BE,2007.0,4,6,-2
CL,ZA,2017.0,2,2,0
RO,ES,2015.0,9,21,-12
TT,JM,2004.0,7,8,-1
CU,TT,2002.0,1,1,0
RU,LT,2001.0,7,1,6
DE,CY,2018.0,7,6,1
AT,IT,2023.0,4,3,1
CZ,UZ,2003.0,2,4,-2
MK,GB,2011.0,2,7,-5
RU,HU,2006.0,8,7,1
ZA,DK,2008.0,6,3,3
MW,ZA,2016.0,10,8,2
DK,RS,2006.0,3,4,-1
CH,SG,2010.0,11,12,-1
GB,MT,2009.0,5,8,-3
US,KH,2020.0,7,13,-6
IL,AT,2019.0,9,6,3
BR,AO,2008.0,14,13,1
ID,ES,2002.0,4,2,2
IT,FI,2003.0,4,6,-2
GB,QA,2003.0,1,2,-1
BN,MY,2017.0,9,7,2
ES,TW,2012.0,3,2,1
CL,FI,2016.0,4,7,-3
DO,CO,2016.0,7,3,4
DE,LB,2009.0,1,1,0
IE,PH,2002.0,1,2,-1
NZ,DK,2013.0,8,2,6
DE,CU,2020.0,6,4,2
ET,BE,2020.0,10,14,-4
VG,US,2001.0,7,1,6
BE,CZ,2007.0,6,3,3
CN,HK,2023.0,11,12,-1
AT,CL,2018.0,3,8,-5
IL,IR,2015.0,2,2,0
KR,ES,2000.0,4,1,3
ES,MZ,2011.0,3,1,2
US,EE,1998.0,5,3,2
IN,ZA,2001.0,3,11,-8
SY,GB,2015.0,4,2,2
GP,FR,2010.0,6,12,-6
EC,PA,2019.0,4,5,-1
BA,HR,2007.0,10,4,6
MG,FR,2022.0,4,4,0
ZA,NO,2015.0,9,4,5
SG,NZ,2010.0,9,8,1
BM,US,2014.0,5,4,1
CI,NG,2020.0,3,1,2
CL,BE,2016.0,10,9,1
RU,KZ,2004.0,8,6,2
RO,GR,2017.0,2,2,0
TR,IN,2007.0,7,11,-4
KE,IN,2010.0,9,4,5
KE,CN,2014.0,4,13,-9
CN,ID,2003.0,6,6,0
ZW,NG,2016.0,1,1,0
RU,BR,2005.0,7,8,-1
CZ,VN,2022.0,7,7,0
IR,ET,2018.0,3,1,2
VE,CL,1998.0,3,1,2
HN,AR,2021.0,1,1,0
CY,NG,2019.0,4,3,1
BD,ID,2015.0,8,17,-9
AT,HR,1998.0,2,4,-2
AU,LB,2021.0,3,1,2
HU,RS,2007.0,2,5,-3
RU,KR,2006.0,9,14,-5
VN,GB,2008.0,7,1,6
GL,QA,1997.0,1,1,0
SG,FI,2004.0,2,2,0
AE,GB,2001.0,7,10,-3
GH,ZM,2020.0,21,35,-14
SX,US,2007.0,1,1,0
BE,CO,2006.0,4,1,3
CZ,KR,2009.0,7,2,5
AE,CN,2014.0,7,8,-1
LV,LT,2014.0,4,4,0
XK,DE,2021.0,2,1,1
IR,OM,2021.0,4,2,2
PY,FR,2019.0,2,2,0
PT,CL,2018.0,7,13,-6
AR,CL,2000.0,23,14,9
US,BO,2002.0,2,4,-2
GR,BD,2010.0,1,1,0
CH,DZ,2017.0,3,4,-1
ID,NO,2020.0,4,1,3
AR,RU,2021.0,2,2,0
SN,ML,2019.0,9,7,2
FI,ZM,2018.0,2,1,1
GB,GH,2008.0,7,9,-2
IT,MT,2018.0,10,4,6
BY,BR,2000.0,1,2,-1
LV,NO,2019.0,3,1,2
NP,DE,2009.0,3,2,1
CZ,RU,2003.0,10,10,0
NZ,CH,1998.0,3,2,1
GE,PL,2016.0,1,2,-1
IT,UY,2014.0,10,2,8
IE,PK,2015.0,8,7,1
SA,TR,2009.0,3,4,-1
EE,JP,2010.0,2,1,1
CZ,IE,2000.0,2,1,1
GB,MN,2016.0,4,1,3
FR,CU,2008.0,3,6,-3
AT,TH,2006.0,5,2,3
BG,IL,2019.0,3,1,2
MY,FR,2009.0,4,12,-8
MW,GB,1999.0,3,3,0
KE,BH,2007.0,3,8,-5
MZ,PL,2012.0,8,11,-3
EG,QA,2005.0,4,3,1
US,GM,2008.0,1,3,-2
BW,ZA,2021.0,12,6,6
US,SY,2017.0,3,11,-8
IL,AT,2010.0,2,1,1
IN,IL,1999.0,11,6,5
IQ,DE,2018.0,7,13,-6
MA,GB,2002.0,2,1,1
CR,CL,2009.0,12,12,0
CH,EG,2021.0,6,6,0
MX,KR,2008.0,5,4,1
IR,PK,2013.0,8,10,-2
DK,AR,2019.0,2,8,-6
IL,HU,1998.0,4,3,1
GR,PK,2015.0,2,6,-4
BH,AE,2017.0,3,2,1
TW,NL,2002.0,6,1,5
KE,CO,2002.0,1,1,0
QA,CH,2020.0,2,1,1
IE,RU,2020.0,7,13,-6
EG,ES,2010.0,1,6,-5
AT,BE,2001.0,3,3,0
NG,ES,2015.0,2,1,1
PH,IT,2015.0,5,3,2
EE,NO,2019.0,3,4,-1
SA,ZA,2020.0,4,10,-6
PK,MX,2011.0,4,2,2
AE,ES,2015.0,4,4,0
KR,GH,2016.0,2,2,0
AT,RU,2002.0,3,8,-5
CU,DO,2019.0,3,1,2
BG,FR,2005.0,11,2,9
SA,JO,2002.0,5,5,0
TR,MY,2007.0,2,2,0
GH,TH,2019.0,3,1,2
BN,US,2012.0,1,3,-2
SA,IL,2008.0,1,1,0
ZM,ZA,2022.0,5,6,-1
KE,FI,2021.0,4,2,2
AT,EG,2015.0,6,5,1
RU,TH,2009.0,2,1,1
NO,SK,2015.0,1,1,0
PY,BR,2009.0,3,3,0
NO,PL,2007.0,2,7,-5
BE,SI,2007.0,2,1,1
KW,SA,2000.0,1,1,0
BY,IT,1999.0,1,3,-2
DK,BG,2022.0,2,2,0
ZA,AT,2022.0,3,7,-4
KR,TR,2010.0,5,4,1
BR,CR,2018.0,17,14,3
PL,DE,2023.0,5,7,-2
BD,AU,2006.0,10,6,4
IN,KZ,2022.0,2,3,-1
JP,PT,1999.0,1,3,-2
NG,GR,2017.0,2,1,1
BW,TZ,2010.0,1,2,-1
US,MU,2015.0,2,2,0
IT,UA,2005.0,10,7,3
CH,MT,2018.0,1,1,0
KE,IT,2001.0,3,1,2
KW,FR,1999.0,1,2,-1
DE,TW,2004.0,10,14,-4
NO,AT,2005.0,5,8,-3
AZ,RU,2002.0,1,2,-1
PH,CH,2002.0,2,2,0
EC,CO,2011.0,13,11,2
TN,KR,2013.0,1,1,0
SK,IT,2005.0,3,6,-3
KR,NZ,2006.0,3,4,-1
MX,AT,2014.0,2,2,0
NL,BR,1997.0,8,5,3
DE,MY,2010.0,9,13,-4
CL,ID,2008.0,2,1,1
CH,DZ,2010.0,1,4,-3
LT,CN,2009.0,3,12,-9
SE,EE,2017.0,5,16,-11
ZA,SD,2019.0,3,2,1
CN,NP,2006.0,2,1,1
AE,OM,2019.0,10,15,-5
CA,HK,2012.0,1,4,-3
FR,FI,2010.0,16,23,-7
VN,FR,2006.0,5,13,-8
BI,KE,2021.0,1,1,0
NG,JM,2021.0,1,1,0
AU,BW,2007.0,2,2,0
LA,TH,2016.0,2,2,0
AU,VE,2004.0,2,2,0
SG,PS,2019.0,1,1,0
AU,UY,2021.0,3,2,1
CZ,SE,1999.0,2,3,-1
BH,AE,2019.0,8,2,6
GB,FO,2017.0,1,1,0
PK,BN,2012.0,2,1,1
GB,NE,2020.0,2,2,0
GB,RS,2002.0,5,7,-2
UY,PE,2017.0,1,5,-4
MA,KW,2019.0,7,3,4
RS,IL,2009.0,1,11,-10
CH,TH,2012.0,1,6,-5
US,PF,2019.0,3,1,2
NO,SJ,2009.0,5,3,2
KZ,AU,2014.0,1,2,-1
CN,ZM,2013.0,1,1,0
MX,MA,2019.0,1,4,-3
MX,HR,2010.0,5,1,4
AU,UZ,2017.0,1,1,0
FR,VN,1999.0,2,3,-1
CH,CY,2000.0,1,1,0
IE,MX,2014.0,3,1,2
DE,LV,2018.0,9,4,5
LT,PT,2015.0,1,1,0
EG,KW,1997.0,2,3,-1
RU,BG,2003.0,14,12,2
KR,KE,2021.0,1,1,0
PE,CA,2002.0,2,1,1
US,AO,2010.0,1,1,0
AT,ZA,2023.0,1,1,0
KR,LV,2002.0,1,1,0
IQ,QA,2020.0,12,4,8
SA,JO,2005.0,4,5,-1
JP,BR,1998.0,14,18,-4
nan,BG,2000.0,2,1,1
nan,TW,2000.0,3,2,1
OM,TN,2013.0,1,1,0
AR,FI,2010.0,2,1,1
MX,CH,2007.0,3,6,-3
AZ,GE,2004.0,1,1,0
EG,BH,2007.0,1,1,0
CN,TH,2000.0,2,5,-3
EG,IE,2009.0,2,1,1
LK,nan,2018.0,1,4,-3
NG,CH,2016.0,1,1,0
ID,SI,2022.0,4,4,0
TZ,NG,2021.0,2,3,-1
TR,JO,2020.0,2,6,-4
CZ,PT,2019.0,4,3,1
FI,SG,2019.0,3,8,-5
CZ,BY,2007.0,3,8,-5
CD,US,2012.0,4,1,3
AT,NO,2011.0,7,2,5
AU,BR,1998.0,7,6,1
NL,QA,2009.0,2,3,-1
FR,SN,2000.0,12,17,-5
AU,GR,2005.0,3,6,-3
JP,KW,2006.0,1,2,-1
CY,UG,2008.0,2,1,1
AU,SY,2009.0,1,2,-1
CY,NG,2017.0,1,4,-3
AE,KW,2015.0,1,3,-2
VE,AR,2022.0,6,5,1
SY,FR,2009.0,1,14,-13
IR,RU,2007.0,4,5,-1
KR,IL,2007.0,1,2,-1
TR,KW,2007.0,7,2,5
MW,NL,2016.0,1,1,0
HR,FR,2013.0,3,3,0
NL,NP,2016.0,3,4,-1
DK,GR,1999.0,1,1,0
TW,BR,2015.0,1,1,0
GR,CA,2019.0,13,14,-1
UA,KZ,2012.0,1,4,-3
AU,GR,2002.0,4,2,2
TZ,CN,2015.0,2,5,-3
RO,JP,2020.0,5,1,4
PL,IQ,2019.0,6,1,5
US,DZ,2005.0,5,5,0
TJ,UA,2017.0,1,1,0
IR,LB,2016.0,3,1,2
IS,CA,2018.0,1,3,-2
ZA,SN,2018.0,2,2,0
ZA,GH,2010.0,1,2,-1
US,SN,1997.0,2,1,1
NZ,JP,2003.0,5,7,-2
BN,AU,2021.0,1,1,0
DE,GA,2018.0,5,8,-3
SN,CM,2021.0,1,2,-1
LA,GB,2017.0,1,4,-3
BJ,ZA,2019.0,1,1,0
ZM,GB,2011.0,1,10,-9
NZ,CH,1997.0,3,4,-1
CO,DK,2011.0,1,2,-1
BE,TN,2014.0,2,2,0
IT,HR,2021.0,4,6,-2
TH,IN,2023.0,1,3,-2
VN,DK,2021.0,2,5,-3
US,AZ,2017.0,2,1,1
LI,CH,2020.0,2,6,-4
CZ,HU,2002.0,4,3,1
US,TT,2012.0,4,9,-5
MY,LY,2012.0,3,1,2
SG,KH,2022.0,1,1,0
CN,BN,2015.0,3,1,2
SE,TZ,2004.0,1,1,0
AR,FI,2019.0,1,1,0
CA,BH,2014.0,3,2,1
BD,TW,2012.0,1,2,-1
MY,KE,2009.0,1,1,0
JP,NP,2011.0,5,9,-4
SN,ML,2017.0,4,3,1
PY,GB,2017.0,2,2,0
MN,CN,2021.0,3,4,-1
CZ,BG,2011.0,2,4,-2
UG,PK,2020.0,2,2,0
EG,DK,2022.0,3,4,-1
KR,KH,2016.0,2,1,1
PK,AT,2013.0,6,16,-10
PH,CA,2000.0,7,4,3
AR,BD,2018.0,1,1,0
AT,UG,2019.0,1,1,0
EC,PA,2017.0,2,4,-2
RS,NL,2004.0,5,1,4
IE,BS,2017.0,1,1,0
UA,TW,2013.0,1,1,0
CO,SI,2018.0,3,2,1
CZ,PT,2010.0,2,1,1
LV,DE,2009.0,3,7,-4
TR,TH,2009.0,2,3,-1
CM,CH,2018.0,3,5,-2
ZA,SD,2017.0,2,4,-2
SI,IT,1997.0,2,3,-1
NO,MW,2014.0,1,3,-2
IL,BE,2002.0,4,9,-5
MA,GB,2005.0,3,3,0
CL,ZA,2010.0,2,2,0
SD,DE,2016.0,4,2,2
CU,GT,2015.0,2,1,1
FI,NZ,1998.0,1,1,0
BE,TW,2008.0,2,4,-2
TR,ET,2001.0,1,1,0
ID,DK,2012.0,2,1,1
EG,SA,2000.0,8,24,-16
MX,CN,1999.0,2,2,0
LY,FR,2015.0,1,2,-1
GH,EG,2013.0,1,1,0
NL,GR,2023.0,1,2,-1
TR,FR,1999.0,2,4,-2
NO,NG,2020.0,2,2,0
CZ,PT,2017.0,1,3,-2
IL,TW,2012.0,1,1,0
LY,IN,2022.0,2,3,-1
NO,BD,2023.0,1,2,-1
PS,CA,2014.0,1,1,0
RO,GR,2019.0,2,2,0
DE,RS,1997.0,2,3,-1
TT,IN,2017.0,4,6,-2
VN,nan,2017.0,4,7,-3
GN,SN,2013.0,1,4,-3
PT,PY,2013.0,3,1,2
BD,ZA,2015.0,2,1,1
FR,LA,2018.0,1,1,0
CU,CH,2019.0,1,1,0
SE,LT,2007.0,4,1,3
DO,BR,2014.0,2,2,0
EG,ET,2012.0,3,2,1
SK,BR,2008.0,1,1,0
JP,CL,2021.0,3,2,1
TZ,IL,2014.0,1,1,0
NL,UG,2005.0,1,1,0
DZ,MY,2013.0,1,1,0
AR,FI,2017.0,3,1,2
FI,RO,2014.0,3,2,1
AT,HR,1997.0,2,1,1
PH,NL,2004.0,2,2,0
NI,nan,2018.0,3,2,1
RO,DK,2009.0,3,1,2
CL,RU,1998.0,1,2,-1
MA,MY,2015.0,2,3,-1
IE,CZ,2008.0,1,1,0
LU,AU,2015.0,3,2,1
SA,TH,2016.0,2,2,0
MX,AF,2007.0,1,5,-4
IN,LV,2022.0,2,9,-7
EG,PS,2010.0,1,1,0
BJ,NL,2018.0,2,2,0
FI,UA,2018.0,3,4,-1
AT,PT,2013.0,7,3,4
LK,FR,2011.0,1,5,-4
CO,NZ,2015.0,2,2,0
NG,JO,2022.0,1,1,0
AU,SI,2007.0,1,2,-1
BB,US,2016.0,1,3,-2
ML,CH,2013.0,2,1,1
KR,GE,2018.0,3,1,2
IN,BN,2015.0,2,2,0
DE,RS,1998.0,2,6,-4
GR,FI,2004.0,1,2,-1
DK,GH,2005.0,1,1,0
AU,PT,2006.0,1,8,-7
nan,EG,2013.0,2,6,-4
CZ,ES,2003.0,1,3,-2
AU,QA,2000.0,2,1,1
KN,US,2009.0,1,4,-3
GH,CA,1999.0,2,1,1
IQ,TN,2020.0,1,4,-3
HK,DE,2008.0,1,1,0
NL,TZ,2015.0,4,4,0
CM,AU,2020.0,2,1,1
BI,MA,2019.0,1,1,0
IT,ET,2014.0,2,4,-2
TH,GH,2017.0,1,1,0
BD,CH,2012.0,1,4,-3
US,EE,1997.0,1,5,-4
PS,US,1998.0,1,1,0
OM,IR,2016.0,2,1,1
CA,TW,2010.0,41,31,10
JP,US,2013.0,1641,1757,-116
NL,SE,2010.0,47,41,6
ID,MY,2015.0,95,210,-115
SE,RU,2002.0,32,41,-9
CN,NZ,2012.0,24,35,-11
CL,EC,2014.0,33,18,15
BR,AU,2014.0,134,81,53
GB,BR,2020.0,249,310,-61
AR,ES,2012.0,324,336,-12
DK,US,1999.0,134,122,12
BN,SG,2021.0,1,2,-1
GB,BD,2012.0,54,42,12
JP,IN,2001.0,83,137,-54
MY,IT,2020.0,39,47,-8
CN,nan,2005.0,105,134,-29
PT,nan,2022.0,20,8,12
ES,AU,2008.0,31,28,3
AU,AT,2014.0,26,31,-5
ZW,ZA,2021.0,52,38,14
LU,GB,2019.0,10,18,-8
QA,CN,2018.0,39,16,23
IE,IN,2006.0,11,12,-1
CN,nan,2002.0,38,45,-7
JP,TH,2010.0,80,55,25
PR,KR,2016.0,42,28,14
NL,IT,2005.0,46,70,-24
BO,MX,2015.0,6,10,-4
MX,CL,2015.0,170,188,-18
TR,BR,2013.0,30,19,11
IL,US,2001.0,390,307,83
MY,PK,2003.0,6,1,5
DE,LU,2018.0,60,33,27
BJ,DE,2021.0,1,1,0
DE,nan,2021.0,56,66,-10
AM,KR,2004.0,10,11,-1
CR,PE,2012.0,8,5,3
NL,PK,2014.0,18,7,11
GT,MX,2016.0,20,20,0
BE,MY,2020.0,7,7,0
CA,SN,2021.0,4,2,2
GR,CN,2020.0,8,6,2
RO,ID,2017.0,9,3,6
IR,BD,2013.0,4,4,0
VE,GB,2015.0,10,7,3
RO,ID,2019.0,9,3,6
FI,ES,2020.0,19,31,-12
UZ,KZ,2018.0,11,7,4
DE,CA,2001.0,134,123,11
PE,NL,2020.0,8,2,6
PS,EG,2022.0,11,5,6
ID,AU,2017.0,54,128,-74
CO,EC,2014.0,56,18,38
GB,FI,2013.0,59,55,4
CM,ZA,2016.0,9,6,3
RO,US,2016.0,88,79,9
NC,FR,2014.0,17,15,2
CZ,TW,2005.0,3,2,1
IT,nan,2003.0,47,93,-46
TH,US,2009.0,98,165,-67
AO,BR,2005.0,11,5,6
VN,CA,2021.0,21,10,11
ET,RU,2018.0,4,6,-2
AU,ZA,2001.0,22,15,7
TW,GB,2009.0,57,46,11
RW,IN,2016.0,19,5,14
PL,CH,2008.0,12,16,-4
BG,FR,2002.0,9,4,5
LB,BE,2020.0,5,5,0
AO,BR,2002.0,4,3,1
MY,GH,2020.0,8,2,6
CN,MM,2009.0,5,11,-6
LT,GB,2018.0,14,9,5
AT,PK,2013.0,16,6,10
EG,PL,2022.0,3,1,2
CA,ET,2020.0,8,8,0
US,NP,2023.0,2,2,0
HR,BE,2016.0,4,1,3
ZW,GB,2022.0,5,4,1
AU,IT,2016.0,59,84,-25
IR,NO,2012.0,22,9,13
SY,US,2021.0,5,4,1
CU,IT,2010.0,3,2,1
ZW,US,2010.0,11,3,8
PL,UZ,2016.0,2,1,1
TR,IT,2010.0,19,16,3
DK,GB,2003.0,74,76,-2
RU,LV,2010.0,22,10,12
IT,IE,1998.0,3,4,-1
SG,NZ,2017.0,17,14,3
NZ,DE,2009.0,38,39,-1
FR,GP,1999.0,8,4,4
KE,SE,2018.0,5,7,-2
EG,DE,2016.0,53,79,-26
TH,DE,2017.0,14,31,-17
IN,SI,2010.0,3,2,1
KR,IT,2001.0,5,2,3
IN,RU,2010.0,13,12,1
ES,CR,2003.0,18,7,11
SV,EC,2016.0,2,1,1
IN,RU,2017.0,40,27,13
VN,GR,2005.0,2,2,0
US,BJ,2003.0,5,1,4
CN,CM,2022.0,2,5,-3
LT,DE,2000.0,6,1,5
TR,BE,2020.0,20,16,4
PH,AR,2013.0,3,1,2
LU,GB,2017.0,8,10,-2
RU,FI,2007.0,22,15,7
FR,BG,2007.0,8,11,-3
TT,IN,2010.0,4,1,3
ZW,US,2017.0,16,14,2
EG,CN,2007.0,8,7,1
YE,US,2006.0,1,1,0
AU,TR,2008.0,8,5,3
IL,GR,2013.0,1,3,-2
CL,NZ,2013.0,6,5,1
GB,LU,2022.0,6,8,-2
TW,MY,2012.0,20,6,14
HU,IN,1997.0,2,3,-1
BG,SE,2005.0,3,4,-1
GR,IL,2014.0,4,3,1
EG,MA,2021.0,15,7,8
IR,BR,2009.0,3,7,-4
PL,BA,2013.0,7,1,6
IT,BG,2018.0,12,13,-1
NL,IR,2007.0,9,6,3
US,AZ,2010.0,2,2,0
KR,IE,2022.0,4,1,3
QA,ES,2008.0,8,3,5
BD,TH,2005.0,2,1,1
BE,AR,2009.0,6,4,2
CH,VE,2017.0,1,3,-2
JP,BR,1997.0,17,16,1
BH,IQ,2021.0,6,4,2
DE,PS,2002.0,2,1,1
TR,DK,2000.0,1,1,0
US,BB,2011.0,3,2,1
LY,EG,2015.0,5,3,2
EG,KW,1998.0,1,2,-1
IN,nan,2004.0,7,9,-2
ID,BN,2017.0,1,3,-2
EE,FR,2002.0,1,3,-2
JP,LT,2002.0,5,6,-1
MT,GB,2014.0,11,14,-3
MA,CL,2021.0,3,1,2
JP,JO,2018.0,2,1,1
AT,SY,2017.0,1,1,0
BG,NO,2016.0,3,4,-1
DK,LT,2007.0,1,4,-3
US,LT,2018.0,14,11,3
KW,BH,2019.0,5,1,4
DK,ZA,2015.0,6,1,5
BG,IL,2017.0,2,1,1
CZ,TW,2002.0,5,3,2
SE,ZA,2003.0,3,8,-5
ZA,MY,2022.0,3,5,-2
ZA,AE,2022.0,6,2,4
ES,SK,2015.0,4,4,0
IR,PL,2006.0,2,9,-7
BR,NG,2013.0,5,3,2
NL,IL,2014.0,10,6,4
MX,TH,2019.0,1,2,-1
DE,KG,2016.0,2,1,1
JP,UZ,2012.0,1,3,-2
TR,CY,2007.0,5,6,-1
MX,SI,2011.0,5,5,0
RO,ZA,2008.0,1,2,-1
PL,PT,2023.0,1,1,0
DK,IS,2021.0,3,9,-6
IN,SI,2019.0,3,4,-1
ID,TW,2009.0,3,2,1
KW,TN,2007.0,1,2,-1
KR,TH,2000.0,1,1,0
IT,CM,2007.0,1,7,-6
PL,RS,2016.0,3,4,-1
CA,UA,2001.0,2,4,-2
ME,BA,2020.0,2,4,-2
GB,IQ,2023.0,2,1,1
EC,SE,2018.0,2,3,-1
SG,BD,2016.0,3,2,1
SA,CA,2018.0,85,123,-38
CU,IT,2017.0,4,5,-1
JP,MN,2018.0,17,6,11
CO,BE,2022.0,8,5,3
TR,ID,2016.0,15,6,9
IR,AU,2007.0,25,24,1
KW,MA,2018.0,8,2,6
RS,nan,2015.0,1,2,-1
OM,DE,2015.0,2,4,-2
AR,AT,2022.0,3,1,2
AT,GR,2012.0,2,6,-4
DE,BA,2009.0,3,1,2
KW,BH,2017.0,2,2,0
IQ,NO,2020.0,1,1,0
FR,,2004.0,4371,0,4371
,PL,2012.0,8192,0,8192
IN,,2020.0,20204,0,20204
,CA,2012.0,11037,0,11037
CH,,2019.0,4571,0,4571
,IT,2009.0,11935,0,11935
,EG,1997.0,1027,0,1027
,JP,2015.0,14789,0,14789
BR,LA,2016.0,3,0,3
,NO,2010.0,1881,0,1881
PT,,2023.0,7594,0,7594
NL,,2025.0,3406,0,3406
IT,,2000.0,2183,0,2183
,EG,1998.0,898,0,898
RO,,2024.0,10118,0,10118
,BD,2007.0,857,0,857
TW,,2014.0,2921,0,2921
MX,,2014.0,1789,0,1789
IL,,2018.0,2102,0,2102
,SD,2011.0,163,0,163
VE,,2022.0,620,0,620
,CH,2006.0,3356,0,3356
,AT,2007.0,2303,0,2303
CL,,2014.0,775,0,775
JP,AO,2000.0,2,0,2
,NG,2011.0,2877,0,2877
,AU,2018.0,5886,0,5886
,CZ,2010.0,2433,0,2433
CH,,2017.0,3550,0,3550
,EE,2000.0,193,0,193
,CI,2008.0,129,0,129
CR,,2003.0,12,0,12
,IE,2009.0,1428,0,1428
NP,,2019.0,297,0,297
,PT,2013.0,1964,0,1964
UA,,2019.0,2171,0,2171
,ET,1997.0,122,0,122
,MY,2003.0,963,0,963
,VE,2012.0,267,0,267
,OM,2001.0,90,0,90
RS,,2017.0,652,0,652
ID,QA,2011.0,2,0,2
SE,,2006.0,1095,0,1095
SX,GD,2006.0,1,0,1
ES,,2000.0,1273,0,1273
OM,,2018.0,167,0,167
TN,,2011.0,330,0,330
RS,,2019.0,1049,0,1049
CH,,2010.0,1914,0,1914
,CU,2017.0,361,0,361
ME,,2019.0,46,0,46
NZ,,2005.0,251,0,251
,KH,2012.0,67,0,67
,CU,2010.0,466,0,466
JM,,2015.0,37,0,37
LU,,2022.0,335,0,335
ZA,,2005.0,322,0,322
UA,,2017.0,1705,0,1705
MQ,,2023.0,49,0,49
TZ,,2021.0,313,0,313
KW,,2023.0,880,0,880
HK,,2023.0,248,0,248
,PK,1999.0,315,0,315
NZ,,2002.0,211,0,211
CU,DO,2017.0,6,0,6
,ZW,2012.0,222,0,222
,AE,2006.0,162,0,162
UA,,2010.0,713,0,713
ZA,,2002.0,290,0,290
,nan,2009.0,880,0,880
KE,,2020.0,585,0,585
GR,,2007.0,806,0,806
PT,VN,2019.0,1,0,1
AT,,2006.0,627,0,627
SY,,2011.0,30,0,30
KZ,,2015.0,76,0,76
nan,,2006.0,230,0,230
DZ,SA,2004.0,1,0,1
,MT,1998.0,22,0,22
DZ,,2013.0,173,0,173
NP,,2017.0,158,0,158
,KW,2013.0,182,0,182
,JO,1998.0,161,0,161
ES,AZ,2015.0,1,0,1
,ME,2002.0,15,0,15
,TT,2013.0,43,0,43
UZ,,2021.0,166,0,166
,NO,2019.0,924,0,924
,CZ,2017.0,1843,0,1843
NO,,2004.0,304,0,304
,IS,2015.0,133,0,133
,NO,2017.0,1589,0,1589
AZ,,2012.0,64,0,64
,SI,2000.0,460,0,460
,MD,2004.0,81,0,81
MS,PL,2013.0,1,0,1
,MD,1996.0,110,0,110
,TO,2013.0,2,0,2
KR,,1999.0,194,0,194
BA,,2020.0,289,0,289
LV,,2015.0,155,0,155
RS,,2010.0,227,0,227
,BA,2002.0,91,0,91
,UZ,2015.0,125,0,125
PE,CA,2005.0,2,0,2
NP,,2010.0,24,0,24
KN,,2023.0,33,0,33
,JO,1997.0,160,0,160
CR,IT,2008.0,2,0,2
IT,BW,2017.0,1,0,1
SE,JO,2012.0,3,0,3
,ST,2016.0,5,0,5
,AO,2002.0,18,0,18
CZ,IQ,2012.0,1,0,1
,PS,2010.0,88,0,88
DO,,2006.0,4,0,4
,TZ,2016.0,323,0,323
BJ,,2018.0,86,0,86
BN,GB,2001.0,4,0,4
,MN,2017.0,92,0,92
HU,AL,2017.0,1,0,1
,GN,2018.0,12,0,12
HU,MX,2022.0,1,0,1
,PG,2008.0,37,0,37
,PS,2019.0,138,0,138
YE,TN,2007.0,1,0,1
,DO,2018.0,35,0,35
,CY,2012.0,179,0,179
,MN,2019.0,46,0,46
SR,,2023.0,45,0,45
PT,CR,2019.0,2,0,2
MW,,2025.0,11,0,11
AM,IE,2020.0,1,0,1
IE,,2012.0,623,0,623
CU,,2015.0,310,0,310
,HU,2015.0,1184,0,1184
,SA,2000.0,419,0,419
XK,,2020.0,116,0,116
,PS,2017.0,104,0,104
,CZ,2019.0,868,0,868
SI,CN,2008.0,3,0,3
,AZ,2013.0,158,0,158
,BF,2018.0,66,0,66
,CU,2019.0,118,0,118
NG,nan,2023.0,1,0,1
BA,BG,2009.0,1,0,1
,ET,1998.0,115,0,115
HR,,2012.0,334,0,334
,EC,1995.0,67,0,67
,LA,1997.0,2,0,2
FR,BJ,1999.0,6,0,6
AU,PW,2007.0,1,0,1
GN,,2017.0,9,0,9
,MU,2008.0,21,0,21
,BA,2005.0,160,0,160
NZ,AR,2014.0,3,0,3
BI,CD,2020.0,1,0,1
SA,NZ,2009.0,2,0,2
QA,NP,2010.0,1,0,1
TW,CL,2016.0,1,0,1
IE,VE,2008.0,2,0,2
MM,,2015.0,13,0,13
PT,SN,2001.0,1,0,1
GN,,2019.0,10,0,10
,SS,2009.0,6,0,6
MY,MN,2017.0,2,0,2
FR,GE,2000.0,1,0,1
,SZ,2014.0,6,0,6
CH,UZ,2018.0,2,0,2
KW,IR,2003.0,1,0,1
PR,,2018.0,17,0,17
LA,CA,2016.0,1,0,1
BW,MW,2022.0,1,0,1
,AO,2005.0,14,0,14
,UA,2020.0,55,0,55
KP,,2021.0,32,0,32
RE,,2018.0,23,0,23
SD,AR,2012.0,1,0,1
TR,PS,2021.0,4,0,4
AG,RS,1998.0,1,0,1
,ME,2005.0,27,0,27
BH,NG,2014.0,1,0,1
DK,BR,1998.0,7,0,7
TT,,2014.0,26,0,26
SI,,2007.0,141,0,141
CD,MG,2019.0,2,0,2
,MN,2010.0,60,0,60
,BB,2018.0,5,0,5
,BJ,1995.0,28,0,28
TZ,AU,1999.0,1,0,1
MU,,1998.0,1,0,1
HU,LT,2003.0,30,0,30
CA,TH,1998.0,2,0,2
NO,LY,2012.0,1,0,1
,GT,1998.0,12,0,12
UG,CH,2004.0,2,0,2
JP,SY,2015.0,2,0,2
SD,ZA,2012.0,2,0,2
IT,IE,1997.0,4,0,4
CY,ES,2012.0,4,0,4
DK,PK,1998.0,1,0,1
ZA,PS,2007.0,1,0,1
IL,RO,2014.0,2,0,2
PF,,2006.0,2,0,2
GE,NL,2011.0,2,0,2
AG,HU,2000.0,4,0,4
KE,LA,2010.0,1,0,1
,NE,1998.0,18,0,18
IS,,2007.0,29,0,29
MY,NE,2020.0,1,0,1
PT,TZ,2011.0,1,0,1
BO,PH,2005.0,1,0,1
NG,HU,2012.0,3,0,3
RS,CN,2000.0,2,0,2
BY,RS,2009.0,1,0,1
NZ,PH,1997.0,1,0,1
DK,PK,1997.0,2,0,2
SG,RS,2011.0,1,0,1
BE,SG,2003.0,2,0,2
CU,JP,2005.0,1,0,1
,AG,2006.0,3,0,3
,MT,1997.0,15,0,15
,GT,1997.0,11,0,11
PY,GB,2019.0,2,0,2
UA,SK,2008.0,6,0,6
CF,DE,2019.0,1,0,1
AR,PH,2014.0,1,0,1
TN,MY,2021.0,1,0,1
LK,UZ,2020.0,1,0,1
GH,DK,2012.0,2,0,2
ZA,QA,2015.0,2,0,2
BG,MX,1998.0,1,0,1
,NE,1997.0,6,0,6
FR,KW,2007.0,5,0,5
IQ,FI,2013.0,3,0,3
IQ,AE,2009.0,5,0,5
MW,CY,2014.0,1,0,1
DK,PH,2010.0,3,0,3
BB,IE,2012.0,2,0,2
GW,,2006.0,2,0,2
,LY,1994.0,27,0,27
MA,,1999.0,21,0,21
,MC,2000.0,7,0,7
GR,JO,2004.0,8,0,8
NO,GH,2017.0,3,0,3
IE,NO,2007.0,3,0,3
ET,CH,2009.0,5,0,5
CO,,2026.0,8,0,8
ME,,2017.0,22,0,22
ZA,HR,2021.0,1,0,1
DK,AR,2010.0,3,0,3
IL,SK,2010.0,1,0,1
GR,KR,2003.0,1,0,1
NO,AT,2002.0,2,0,2
KY,AU,2000.0,1,0,1
KE,ES,2000.0,1,0,1
CH,TG,2010.0,1,0,1
CR,TG,2015.0,1,0,1
SN,,2025.0,10,0,10
BS,,2011.0,1,0,1
MT,IE,2022.0,1,0,1
US,MZ,2008.0,3,0,3
BG,CN,2001.0,1,0,1
ES,ZA,2003.0,4,0,4
JP,PE,2005.0,1,0,1
AT,ZM,2008.0,1,0,1
BF,PK,2011.0,1,0,1
GP,,2011.0,9,0,9
CN,KE,2001.0,2,0,2
JP,QA,2014.0,1,0,1
MX,TT,2013.0,1,0,1
KR,LU,2022.0,3,0,3
,NA,2007.0,11,0,11
CN,AM,2012.0,1,0,1
IL,BA,2015.0,1,0,1
CZ,AZ,2002.0,2,0,2
FO,,2023.0,18,0,18
AL,JP,2019.0,2,0,2
CA,LR,2015.0,1,0,1
TH,JO,2018.0,1,0,1
HK,ES,2000.0,1,0,1
PL,IQ,2010.0,1,0,1
IR,UY,2018.0,1,0,1
PE,UG,2008.0,2,0,2
SI,BA,2003.0,1,0,1
SJ,CA,2016.0,1,0,1
MC,,2018.0,6,0,6
FJ,,2008.0,5,0,5
CU,CH,2017.0,3,0,3
RS,PT,2007.0,1,0,1
IE,MN,2021.0,1,0,1
IN,MA,2018.0,9,0,9
IT,ER,2011.0,1,0,1
GB,NA,2001.0,1,0,1
DE,VG,2012.0,1,0,1
SI,nan,2022.0,2,0,2
NA,ZM,2013.0,1,0,1
MR,CH,2013.0,1,0,1
OM,NZ,2020.0,2,0,2
JP,VG,2004.0,2,0,2
BJ,CH,2003.0,1,0,1
TW,NL,2005.0,3,0,3
KR,HU,2008.0,4,0,4
TR,ZA,1997.0,6,0,6
CU,PL,2015.0,1,0,1
IR,UG,2016.0,1,0,1
MX,RO,2011.0,2,0,2
AU,BR,1997.0,8,0,8
KR,MY,2001.0,2,0,2
LB,AR,2016.0,2,0,2
RU,AR,2011.0,1,0,1
PA,KR,2016.0,3,0,3
RU,VG,2007.0,3,0,3
EE,JP,2019.0,1,0,1
NO,GH,2019.0,6,0,6
CH,BJ,2018.0,1,0,1
ES,HK,2021.0,1,0,1
CI,PK,2017.0,2,0,2
GR,QA,2007.0,2,0,2
SY,PK,2019.0,2,0,2
VG,,2002.0,10,0,10
EC,DK,2011.0,1,0,1
,LR,2004.0,1,0,1
ZA,TZ,2005.0,1,0,1
CU,IT,2019.0,4,0,4
PS,SG,2021.0,2,0,2
NA,PH,2018.0,1,0,1
NG,CM,2022.0,2,0,2
NC,CH,2016.0,1,0,1
BA,ID,2019.0,1,0,1
RU,ID,2003.0,1,0,1
LA,GB,2019.0,1,0,1
SV,nan,2003.0,1,0,1
,MS,1998.0,1,0,1
IR,KW,2002.0,1,0,1
CA,SD,2008.0,1,0,1
BE,ZM,2007.0,1,0,1
IL,TH,2012.0,1,0,1
IN,MZ,2016.0,1,0,1
BH,,2001.0,6,0,6
JM,KE,2015.0,1,0,1
BG,BY,2001.0,3,0,3
KZ,IQ,2015.0,1,0,1
NG,MX,2022.0,2,0,2
,CF,2006.0,6,0,6
PA,IN,2013.0,5,0,5
SK,PT,2010.0,1,0,1
,LA,1998.0,6,0,6
IS,TR,2005.0,1,0,1
YE,QA,2013.0,1,0,1
PF,MG,2000.0,1,0,1
NG,ZA,2000.0,1,0,1
BE,GA,2020.0,1,0,1
NE,US,2000.0,2,0,2
IT,KE,2006.0,1,0,1
BO,AR,1999.0,1,0,1
TR,IE,2009.0,1,0,1
DK,TZ,2017.0,1,0,1
IL,AE,2018.0,2,0,2
LB,ES,2021.0,3,0,3
PL,MY,2021.0,2,0,2
PK,UY,1999.0,1,0,1
NC,VU,2011.0,1,0,1
MH,,2023.0,1,0,1
,IM,2004.0,3,0,3
BA,ID,2017.0,1,0,1
IL,PS,2006.0,2,0,2
BR,JO,2010.0,1,0,1
CH,KW,2013.0,1,0,1
SX,FR,2015.0,1,0,1
FR,IS,2001.0,2,0,2
JP,ET,1998.0,2,0,2
PE,DK,2004.0,3,0,3
CD,PK,2004.0,1,0,1
NO,GH,2010.0,1,0,1
KZ,BE,2000.0,1,0,1
TN,ID,2014.0,3,0,3
BI,CA,2011.0,2,0,2
CU,UY,2001.0,1,0,1
GB,PY,1998.0,1,0,1
RS,FI,2015.0,1,0,1
HR,IN,2021.0,1,0,1
BF,BJ,2009.0,1,0,1
GM,NG,2009.0,1,0,1
NG,GH,2004.0,3,0,3
NG,ZM,2007.0,3,0,3
AR,BG,2018.0,1,0,1
CR,IE,2011.0,1,0,1
BG,IL,2010.0,1,0,1
TW,GR,2007.0,4,0,4
SC,ZA,2016.0,2,0,2
AU,CO,2000.0,1,0,1
PG,GB,2002.0,1,0,1
,SL,2007.0,6,0,6
NE,NG,2009.0,1,0,1
CM,SD,2019.0,1,0,1
GT,HN,2022.0,1,0,1
ST,AU,2020.0,1,0,1
DK,PH,2017.0,1,0,1
GH,FI,2013.0,1,0,1
NI,,1999.0,2,0,2
BI,ZA,2016.0,1,0,1
FM,,2020.0,1,0,1
MU,MX,2017.0,1,0,1
RW,PH,2017.0,1,0,1
BR,ET,2016.0,1,0,1
BH,OM,1997.0,1,0,1
SD,OM,2012.0,2,0,2
GE,TR,2021.0,1,0,1
BE,CD,1997.0,1,0,1
AM,SA,2017.0,1,0,1
NL,LV,2001.0,1,0,1
TD,,2009.0,1,0,1
BW,CH,2013.0,1,0,1
PG,GB,2005.0,3,0,3
BD,PT,2020.0,2,0,2
EE,nan,2016.0,2,0,2
MT,PT,2020.0,2,0,2
CA,BO,2020.0,4,0,4
MU,KW,2002.0,1,0,1
EC,GB,2023.0,1,0,1
PT,ID,2015.0,2,0,2
IM,GB,2006.0,1,0,1
DK,GH,2002.0,3,0,3
OM,nan,2015.0,1,0,1
PS,SE,2007.0,1,0,1
PT,AO,2004.0,1,0,1
ZA,BH,2004.0,1,0,1
SG,OM,2014.0,1,0,1
EE,SG,2012.0,1,0,1
AE,NO,2000.0,1,0,1
JP,SI,2022.0,2,0,2
IN,LT,2013.0,1,0,1
TN,AU,2013.0,1,0,1
PH,SE,2011.0,1,0,1
BY,PT,2013.0,1,0,1
ES,PR,2014.0,2,0,2
PR,VE,2017.0,1,0,1
VG,CA,2008.0,3,0,3
KE,SY,2013.0,2,0,2
US,KG,2011.0,2,0,2
DE,ER,2004.0,1,0,1
MA,MR,2015.0,1,0,1
VE,JP,2001.0,1,0,1
,BM,2013.0,3,0,3
KW,LB,2013.0,2,0,2
KE,TH,2003.0,1,0,1
IQ,MM,2014.0,1,0,1
AT,UG,2017.0,1,0,1
BE,JM,2013.0,1,0,1
IT,BW,2010.0,2,0,2
NL,CI,2019.0,2,0,2
CN,MT,2001.0,1,0,1
PR,FR,2003.0,1,0,1
LK,PG,2001.0,1,0,1
CY,JP,2002.0,2,0,2
MD,PL,2008.0,1,0,1
BJ,DZ,2017.0,1,0,1
LT,CY,2023.0,1,0,1
MK,BG,2022.0,1,0,1
NG,TW,2006.0,2,0,2
LY,IT,2007.0,1,0,1
ZA,OM,1997.0,1,0,1
MU,ZA,2012.0,1,0,1
VG,CY,2009.0,1,0,1
FR,AZ,2012.0,1,0,1
AM,CZ,2008.0,1,0,1
CZ,GY,2021.0,1,0,1
CY,GH,2022.0,1,0,1
PK,MY,1999.0,1,0,1
SN,CG,2020.0,2,0,2
PA,NO,2013.0,2,0,2
GH,IN,2005.0,2,0,2
SG,BY,2019.0,1,0,1
TR,QA,2023.0,2,0,2
NL,LI,2015.0,1,0,1
GB,CW,2003.0,1,0,1
TT,IE,2006.0,1,0,1
QA,PT,2016.0,1,0,1
GM,US,2009.0,4,0,4
BR,TN,1999.0,1,0,1
MA,BJ,2021.0,1,0,1
HK,TW,2007.0,1,0,1
NO,LU,2003.0,1,0,1
MX,MY,2018.0,2,0,2
PA,BE,2021.0,3,0,3
ZA,PH,2012.0,2,0,2
CR,TW,2005.0,1,0,1
LK,ZW,2020.0,1,0,1
IN,NC,2020.0,1,0,1
VG,,2005.0,4,0,4
IR,JO,2022.0,6,0,6
IR,HR,2008.0,1,0,1
BE,BF,2016.0,3,0,3
CU,SE,2001.0,1,0,1
EE,CA,2004.0,2,0,2
IN,GD,2008.0,1,0,1
MY,ET,2020.0,1,0,1
BA,LT,2012.0,1,0,1
CH,GE,1998.0,1,0,1
NG,OM,2005.0,1,0,1
CM,PH,2015.0,1,0,1
MD,AU,2015.0,1,0,1
JP,XK,2020.0,2,0,2
TN,SE,2010.0,1,0,1
UZ,RS,2004.0,1,0,1
US,PY,2003.0,1,0,1
GR,AT,2001.0,3,0,3
BI,AU,2018.0,1,0,1
SG,MK,2005.0,1,0,1
US,AO,2019.0,2,0,2
DE,OM,2005.0,1,0,1
HR,UA,1998.0,1,0,1
BA,EG,2014.0,1,0,1
RU,KE,2008.0,1,0,1
LT,NO,1998.0,2,0,2
UA,DK,2011.0,1,0,1
BO,TW,2001.0,1,0,1
BA,MK,2018.0,2,0,2
BT,,2008.0,1,0,1
LT,PK,2010.0,3,0,3
IE,SC,2019.0,1,0,1
NZ,CZ,2015.0,3,0,3
,GW,1994.0,1,0,1
JP,MG,2004.0,1,0,1
TT,PK,2013.0,2,0,2
YE,CY,2021.0,1,0,1
HK,SG,2012.0,1,0,1
GH,BR,2003.0,1,0,1
MX,BO,2003.0,3,0,3
CH,EC,2013.0,1,0,1
SO,IE,2017.0,1,0,1
NZ,PG,2009.0,2,0,2
AU,PF,2019.0,1,0,1
SI,CL,2002.0,1,0,1
DE,SD,1998.0,1,0,1
IN,TN,2007.0,1,0,1
ET,IT,1999.0,1,0,1
EE,AE,2005.0,1,0,1
,AF,1997.0,2,0,2
NL,LT,2015.0,1,0,1
UA,EE,2009.0,2,0,2
DK,BF,2012.0,1,0,1
PY,nan,2019.0,1,0,1
UA,US,2023.0,4,0,4
UY,PE,2010.0,2,0,2
SS,ZA,2002.0,1,0,1
KR,MA,2018.0,1,0,1
ML,BR,2020.0,1,0,1
BW,MY,2013.0,1,0,1
LV,NG,2016.0,1,0,1
SY,MY,2000.0,1,0,1
NE,MG,2020.0,2,0,2
LT,NL,2004.0,3,0,3
CU,CH,2010.0,1,0,1
FM,US,2021.0,1,0,1
IR,IE,2009.0,1,0,1
SG,AR,2009.0,2,0,2
ME,,2010.0,2,0,2
ES,MY,2002.0,1,0,1
AR,ZA,2017.0,1,0,1
VE,CN,2022.0,1,0,1
ME,NO,2015.0,1,0,1
JE,GB,2012.0,3,0,3
SG,PE,2009.0,1,0,1
BR,RS,2009.0,1,0,1
US,MC,2016.0,1,0,1
,IM,1996.0,1,0,1
LV,nan,2018.0,1,0,1
VG,MY,2017.0,1,0,1
SY,PK,2017.0,1,0,1
MK,IE,2022.0,1,0,1
UA,MY,2006.0,1,0,1
IQ,PK,2011.0,1,6,-5
UA,MX,2006.0,2,3,-1
BR,JO,2019.0,1,1,0
ES,CM,2017.0,1,1,0
XK,AT,2021.0,2,3,-1
FR,NP,2015.0,2,1,1
GR,LK,2010.0,3,4,-1
RS,FR,2007.0,2,4,-2
BE,PT,1999.0,3,3,0
BI,MA,2010.0,1,1,0
IL,ZA,2018.0,1,6,-5
US,ML,2022.0,1,4,-3
CH,EE,1999.0,1,3,-2
LV,SE,2018.0,3,6,-3
NZ,AE,2007.0,1,1,0
IL,PL,2007.0,1,8,-7
RU,KG,1999.0,1,1,0
EE,NL,2009.0,1,2,-1
US,DZ,2002.0,3,1,2
NL,AT,2023.0,1,2,-1
AE,RO,2016.0,1,1,0
BE,EC,2006.0,1,1,0
TR,MD,2023.0,1,2,-1
CR,VE,2004.0,1,2,-1
LK,CA,2011.0,2,7,-5
GR,AM,2018.0,1,1,0
DE,IQ,2007.0,1,1,0
DE,PS,2005.0,1,1,0
NG,ID,2010.0,1,1,0
SE,MW,2009.0,1,1,0
HU,IR,2015.0,1,2,-1
XK,GB,2020.0,1,6,-5
DK,MX,2007.0,4,2,2
AU,NP,2007.0,2,2,0
IQ,IE,2021.0,1,3,-2
ES,CM,2019.0,1,1,0
CH,GM,2019.0,1,1,0
SA,JP,2022.0,4,3,1
MM,US,2011.0,2,2,0
PS,CN,2019.0,1,2,-1
IN,FJ,2021.0,2,3,-1
ZA,BW,2003.0,4,2,2
AU,NA,2018.0,2,3,-1
CY,SA,2018.0,1,2,-1
ES,HR,2006.0,2,1,1
AL,GR,2017.0,2,1,1
CL,RS,2020.0,2,1,1
UZ,BG,2019.0,1,1,0
RU,CU,2020.0,3,2,1
TW,IT,2012.0,1,4,-3
GR,LK,2019.0,1,2,-1
NL,NG,2004.0,2,1,1
SA,AR,2020.0,2,1,1
SA,DZ,2015.0,1,7,-6
MT,AT,2020.0,1,1,0
JP,KH,2014.0,1,2,-1
IE,TW,2016.0,1,1,0
MX,BE,2006.0,3,5,-2
SK,RO,2016.0,1,6,-5
CN,CL,2003.0,1,6,-5
SY,OM,2001.0,1,1,0
NZ,MX,2011.0,1,3,-2
SG,RU,2006.0,2,3,-1
ET,SE,2013.0,2,8,-6
MD,BE,2020.0,1,1,0
BE,SK,2012.0,5,4,1
DE,MD,2012.0,2,4,-2
DK,PH,2019.0,2,3,-1
US,AZ,2019.0,1,6,-5
QA,JP,2000.0,1,2,-1
IR,QA,2006.0,1,1,0
GR,RU,2008.0,2,2,0
ZA,LU,2020.0,1,2,-1
JO,NL,2015.0,1,1,0
UA,CO,2014.0,1,2,-1
IT,TN,2004.0,2,3,-1
GB,GA,2020.0,1,2,-1
ID,AR,2020.0,3,4,-1
CN,CR,2018.0,2,3,-1
KE,CO,2005.0,1,2,-1
US,PF,2010.0,1,2,-1
VN,PK,2015.0,1,1,0
BG,GR,2000.0,1,2,-1
KW,MY,2015.0,1,1,0
ZA,MX,2022.0,1,1,0
RW,TZ,2021.0,1,1,0
KZ,AT,2019.0,1,1,0
SA,OM,2001.0,1,3,-2
BO,SE,2005.0,1,1,0
CL,MD,2016.0,1,1,0
MA,CI,2013.0,1,1,0
CO,DO,2013.0,2,3,-1
AL,GR,2019.0,1,1,0
MT,DE,2016.0,1,2,-1
MW,IN,2015.0,1,3,-2
LT,IR,2014.0,1,1,0
NG,NL,2003.0,1,2,-1
GH,TG,2018.0,1,1,0
NA,ZW,2015.0,1,2,-1
PE,HN,2022.0,2,1,1
LV,AU,2014.0,1,1,0
TH,FI,2022.0,1,1,0
PK,ZA,2007.0,2,1,1
KR,TR,2017.0,3,8,-5
OM,ZA,2008.0,1,1,0
BG,NL,2001.0,1,3,-2
LT,HU,1999.0,2,1,1
SK,PT,2019.0,1,3,-2
SR,US,2011.0,1,1,0
SE,QA,2016.0,1,5,-4
IT,CR,2013.0,1,3,-2
SK,PT,2017.0,1,2,-1
DE,SN,2006.0,1,2,-1
TZ,DE,2003.0,1,1,0
RU,EE,2004.0,1,1,0
VE,CA,2000.0,1,2,-1
ET,AT,2022.0,1,2,-1
FR,PE,2007.0,1,2,-1
PT,ZA,2011.0,1,2,-1
FI,SG,2010.0,1,5,-4
ES,PK,2022.0,1,4,-3
AO,CA,2016.0,1,1,0
LU,DK,2016.0,1,2,-1
EE,JP,2017.0,1,2,-1
HU,CO,2021.0,1,2,-1
AT,CM,2014.0,1,1,0
AU,LV,2021.0,1,1,0
CR,PT,2018.0,1,2,-1
NA,ZA,2000.0,1,1,0
MD,CA,2016.0,1,3,-2
NG,BD,2015.0,1,1,0
GH,TH,2017.0,1,1,0
OM,IQ,2016.0,3,1,2
RU,RO,1999.0,1,1,0
EE,LV,2016.0,1,5,-4
PT,CR,2010.0,1,1,0
CZ,ID,2002.0,1,1,0
CI,BE,2022.0,2,1,1
BA,AT,2021.0,1,2,-1
KR,FI,2000.0,1,2,-1
IL,SK,2019.0,1,1,0
MK,NL,2015.0,1,1,0
DK,HR,2011.0,1,1,0
TR,BG,2009.0,1,2,-1
GP,US,1999.0,1,1,0
SI,AR,2013.0,1,2,-1
SJ,DK,2014.0,1,1,0
JP,KG,2016.0,1,1,0
DZ,EG,2012.0,1,8,-7
PE,IT,2008.0,1,3,-2
BG,SE,2002.0,1,1,0
CA,UG,2015.0,1,3,-2
CN,LU,2010.0,1,7,-6
PL,LV,2016.0,1,1,0
CO,NP,2009.0,1,1,0
IT,CG,2021.0,1,1,0
SK,HU,2004.0,1,5,-4
MD,TR,2016.0,1,1,0
PK,IT,2000.0,1,1,0
JM,DE,2018.0,1,1,0
GB,LT,2021.0,6,6,0
FR,SG,2001.0,1,2,-1
UZ,PK,2011.0,1,1,0
FR,MZ,2013.0,1,2,-1
KZ,US,2013.0,3,14,-11
XK,HR,2021.0,5,2,3
NG,IN,2008.0,2,4,-2
ML,BF,2015.0,1,5,-4
ET,FR,2013.0,1,7,-6
IE,HR,2021.0,2,1,1
TH,GH,2019.0,1,3,-2
BJ,IN,2018.0,1,1,0
CH,VE,2010.0,1,1,0
BE,CI,2010.0,1,1,0
ZA,EE,2016.0,1,1,0
TW,IL,2003.0,1,1,0
BG,HU,2012.0,1,1,0
IR,TR,2003.0,1,2,-1
SY,AU,2015.0,1,1,0
PK,SK,2011.0,1,1,0
GN,MA,2017.0,1,1,0
MY,CO,2014.0,1,2,-1
LY,MY,2012.0,1,3,-2
CU,SK,2017.0,1,0,1
SE,LY,2015.0,1,0,1
AU,MT,2007.0,1,0,1
BA,HU,2013.0,1,0,1
NC,IE,2018.0,1,0,1
HU,FJ,2019.0,1,0,1
CA,GD,2006.0,1,0,1
TR,BA,2012.0,2,0,2
SV,JP,2013.0,1,0,1
DK,PA,2020.0,1,0,1
BF,NP,2018.0,2,0,2
UY,NZ,2019.0,1,0,1
BH,AU,2013.0,1,0,1
SE,CI,2017.0,1,0,1
,VA,2003.0,4,0,4
BR,BG,2006.0,1,0,1
AE,BD,2006.0,1,0,1
OM,FJ,2004.0,1,0,1
BH,IT,2004.0,1,0,1
NA,nan,2020.0,1,0,1
GA,NE,2013.0,1,0,1
ZM,NP,2013.0,1,0,1
SA,KE,2018.0,1,0,1
HU,AL,2019.0,1,0,1
BI,nan,2011.0,1,0,1
DE,TT,2020.0,1,0,1
FR,BA,2018.0,1,0,1
IR,DZ,2011.0,1,0,1
ZM,RS,2004.0,1,0,1
MT,ES,2007.0,1,0,1
PK,DZ,2013.0,1,0,1
GT,CR,2016.0,1,0,1
BW,SZ,2000.0,1,0,1
NL,BJ,2014.0,3,0,3
NL,ZW,2013.0,2,0,2
HR,TW,2022.0,1,0,1
BY,SK,2022.0,1,0,1
ZW,IT,2014.0,1,0,1
AZ,IE,2000.0,1,0,1
BS,JM,2006.0,1,0,1
SI,ME,2020.0,1,0,1
MG,,2025.0,1,0,1
RU,PH,2002.0,1,0,1
RE,CF,2014.0,1,0,1
NL,BF,2016.0,1,0,1
CI,KE,2022.0,1,0,1
HN,PR,2021.0,1,0,1
DE,MT,2012.0,1,0,1
MY,NC,2007.0,1,0,1
TH,AE,2012.0,1,0,1
GB,LB,1997.0,2,0,2
SI,NO,2018.0,1,0,1
BH,ZW,2021.0,1,0,1
GR,AL,2011.0,1,0,1
SG,KZ,2021.0,1,0,1
DJ,FR,2004.0,1,0,1
FR,TD,2001.0,1,0,1
NG,KZ,2019.0,2,0,2
BY,CH,2018.0,1,0,1
MX,SK,2018.0,3,0,3
BR,SK,2023.0,1,0,1
HR,VE,2018.0,1,0,1
ZW,SE,2006.0,1,0,1
LI,IT,2015.0,1,0,1
BH,CA,2009.0,1,0,1
IL,SI,2011.0,1,0,1
NO,AE,2016.0,2,0,2
BY,IL,2006.0,1,0,1
SG,MA,2014.0,1,0,1
JO,LU,2019.0,1,0,1
AT,UY,2022.0,1,0,1
MY,KH,2003.0,1,0,1
RU,CM,2011.0,1,0,1
MT,CN,2021.0,1,0,1
KZ,KR,2016.0,1,0,1
LR,KE,2015.0,1,0,1
HN,FR,2005.0,1,0,1
CY,AE,2003.0,1,0,1
JO,MA,2020.0,1,0,1
CR,LU,2014.0,1,0,1
FR,PG,2010.0,1,0,1
PL,AR,2011.0,1,0,1
TH,BD,2007.0,2,0,2
CU,RO,2016.0,1,0,1
BE,CI,2017.0,4,0,4
DO,AR,2009.0,1,0,1
KW,SY,2003.0,1,0,1
MD,IN,2020.0,1,0,1
SK,GH,1998.0,1,0,1
DZ,DE,2003.0,2,0,2
nan,AO,2013.0,1,0,1
GR,BD,2017.0,2,0,2
GT,CZ,2016.0,1,0,1
KH,LA,2021.0,1,0,1
CY,RS,2000.0,1,0,1
BD,GE,2012.0,1,0,1
PT,CR,2017.0,2,0,2
ID,VN,2008.0,1,0,1
RU,SI,2005.0,2,0,2
ET,EC,2015.0,1,0,1
SG,KW,2016.0,1,0,1
PH,KH,2012.0,1,0,1
SD,BD,2009.0,1,0,1
AE,HU,2001.0,1,0,1
KR,UA,1998.0,2,0,2
DO,UY,2020.0,1,0,1
BN,DK,2021.0,1,0,1
RW,CA,2022.0,2,0,2
NZ,MW,2012.0,1,0,1
AL,JP,2017.0,1,0,1
TW,ST,2019.0,1,0,1
TH,SG,2000.0,1,0,1
NE,ET,2013.0,1,0,1
PH,TH,2005.0,1,0,1
BD,BT,2017.0,1,0,1
MY,BH,2012.0,3,0,3
ZM,ZW,2008.0,1,0,1
nan,AZ,2015.0,1,0,1
MD,EE,2013.0,1,0,1
FI,BG,2007.0,1,0,1
ZM,IN,2011.0,1,0,1
BS,GB,2009.0,2,0,2
nan,NI,2022.0,1,0,1
IN,YE,1999.0,1,0,1
ZA,CU,2020.0,1,0,1
MM,IT,2014.0,1,0,1
ZW,IN,2007.0,1,0,1
CO,BG,2020.0,1,0,1
LS,NA,1998.0,1,0,1
NL,PE,2001.0,1,0,1
GB,LB,1998.0,2,0,2
CG,NG,2009.0,1,0,1
EC,SV,2017.0,1,0,1
,JE,1995.0,2,0,2
UZ,GB,1999.0,1,0,1
CH,AL,2015.0,1,0,1
KW,UA,2014.0,1,0,1
GA,CF,2016.0,1,0,1
PK,ML,2021.0,1,0,1
LV,SK,2012.0,1,0,1
LU,NZ,2018.0,1,0,1
CR,ZA,2005.0,1,0,1
VG,IE,2006.0,1,0,1
IN,ZM,2014.0,2,0,2
SI,LV,2014.0,1,0,1
AT,GT,2022.0,1,0,1
GT,AT,2002.0,1,0,1
KE,GM,2021.0,1,0,1
PT,VN,2017.0,1,0,1
EC,SI,2021.0,1,0,1
LU,CM,2013.0,1,0,1
FI,PT,1999.0,1,0,1
GE,AE,2015.0,1,0,1
BR,ZM,2004.0,1,0,1
AF,FR,2009.0,1,0,1
CM,UA,2021.0,1,0,1
JP,BY,2015.0,1,0,1
CG,nan,2000.0,1,0,1
RO,IN,1998.0,1,0,1
EC,GR,2006.0,1,0,1
IN,SY,2000.0,1,0,1
FR,BN,2022.0,1,0,1
CU,PA,2013.0,1,0,1
CZ,EE,2000.0,2,0,2
,TM,1998.0,3,0,3
AU,NC,2004.0,1,0,1
AT,BJ,2009.0,1,0,1
PR,RU,1999.0,1,0,1
MY,PE,2018.0,1,0,1
CZ,VE,2017.0,1,0,1
PT,UY,2007.0,1,0,1
SK,CL,2003.0,1,0,1
PK,LB,2016.0,1,0,1
EG,FI,2023.0,1,0,1
RU,GP,2000.0,1,0,1
CR,RO,2003.0,1,0,1
HK,FR,2020.0,1,0,1
CN,LT,2023.0,1,0,1
AT,MD,2006.0,1,0,1
EC,CH,2021.0,1,0,1
IE,FI,2004.0,1,0,1
EG,CY,2022.0,1,0,1
HR,RO,2011.0,1,0,1
EG,CZ,1998.0,1,0,1
ZW,TW,2021.0,1,0,1
HK,IL,2017.0,1,0,1
SD,SA,1998.0,1,0,1
OM,CA,2001.0,1,0,1
MC,CA,2012.0,1,0,1
NC,DE,2006.0,1,0,1
GH,SD,2016.0,1,0,1
SG,SN,2010.0,1,0,1
TR,ZA,1998.0,1,0,1
VE,CL,1997.0,1,0,1
TT,EG,2020.0,1,0,1
LS,NA,1997.0,1,0,1
SN,SG,2011.0,1,0,1
IL,TN,2008.0,1,0,1
PT,CV,2005.0,1,0,1
MW,CG,2009.0,1,0,1
CD,CH,2012.0,1,0,1
IE,UA,2015.0,1,0,1
BD,SY,2015.0,1,0,1
BI,IT,2016.0,1,0,1
KW,CO,2004.0,1,0,1
SD,FR,2010.0,1,0,1
NO,ZA,2000.0,1,0,1
BY,KR,2022.0,1,0,1
ME,CN,2008.0,1,0,1
ES,CG,2019.0,1,0,1
FI,CM,2020.0,1,0,1
UY,CN,2019.0,1,0,1
IE,OM,2002.0,1,0,1
CZ,LI,2013.0,1,0,1
PY,PA,2016.0,1,0,1
LY,AE,2013.0,1,0,1
AU,PA,2008.0,1,0,1
SY,PS,2022.0,1,0,1
DJ,SO,2022.0,1,0,1
MZ,RW,2018.0,1,0,1
GR,EC,2007.0,1,0,1
ID,SK,2014.0,1,0,1
ES,MY,2005.0,1,0,1
NO,MA,1997.0,1,0,1
MX,HR,2019.0,1,0,1
AL,,2001.0,1,0,1
KZ,IR,2011.0,1,0,1
,TM,1997.0,1,0,1
SD,CH,2020.0,1,0,1
AM,JO,2006.0,1,0,1
KR,US,2014.0,1207,1351,-144
GB,US,2016.0,6202,6126,76
MY,CA,2021.0,26,19,7
GB,ES,2011.0,365,316,49
ZA,SD,2018.0,5,1,4
BR,AT,2009.0,13,10,3
JP,US,2008.0,1930,1798,132
CA,AU,2015.0,428,337,91
SE,US,2015.0,399,491,-92
DE,AT,2000.0,240,201,39
PH,US,1999.0,180,161,19
CA,US,2020.0,3689,3174,515
GB,CA,2021.0,695,678,17
VE,CU,2011.0,14,11,3
IL,US,2003.0,412,335,77
AU,DK,2016.0,60,55,5
CN,CH,2019.0,109,89,20
CN,JP,2003.0,353,467,-114
RS,RU,2002.0,5,1,4
JP,IN,2003.0,96,114,-18
ES,AR,2015.0,387,331,56
CO,UY,2011.0,7,10,-3
IT,US,2019.0,1153,1065,88
US,NL,2004.0,459,447,12
CN,CH,2010.0,57,68,-11
US,DE,2012.0,2425,2505,-80
DE,US,2014.0,2461,2537,-76
FI,DE,2014.0,58,74,-16
IT,US,2010.0,999,814,185
DE,MX,2021.0,35,49,-14
ES,CL,2015.0,471,349,122
FR,DE,2011.0,508,559,-51
ES,PE,2016.0,128,155,-27
PE,BR,2010.0,15,30,-15
CO,BR,2022.0,66,79,-13
BR,IN,2010.0,29,12,17
US,LU,2012.0,19,15,4
ES,MX,2015.0,935,827,108
DK,PL,2018.0,12,16,-4
CN,EG,2005.0,7,5,2
SG,SE,2009.0,9,14,-5
US,PH,2013.0,397,469,-72
NO,CH,2018.0,20,31,-11
JP,KR,1999.0,126,82,44
AR,IT,2021.0,92,56,36
BR,IT,2015.0,231,292,-61
CA,GB,2018.0,974,971,3
NZ,VN,2022.0,5,1,4
CH,US,2009.0,641,681,-40
AE,IN,2019.0,58,118,-60
US,AT,2000.0,130,142,-12
IS,CA,2010.0,3,2,1
CA,BR,2002.0,89,117,-28
BR,AU,2004.0,24,33,-9
IN,AU,2017.0,233,177,56
CR,IT,2013.0,3,1,2
SK,HU,2014.0,5,13,-8
AT,DE,2020.0,682,727,-45
PE,BR,2019.0,83,103,-20
CN,US,2023.0,865,192,673
JP,DK,2009.0,25,13,12
BI,FR,2014.0,22,19,3
NZ,US,2007.0,238,309,-71
US,NZ,2013.0,357,336,21
JP,FR,2016.0,172,153,19
GB,CH,2006.0,190,181,9
KW,GB,2008.0,6,6,0
BR,CO,2004.0,31,14,17
AR,MX,2015.0,138,133,5
BE,ES,1998.0,15,18,-3
JO,QA,2013.0,5,1,4
FR,MX,2003.0,35,20,15
SA,AE,2022.0,33,15,18
PK,US,2005.0,77,92,-15
BO,CO,2017.0,8,9,-1
CL,CA,1997.0,2,1,1
FR,CA,2004.0,364,275,89
KR,ET,2007.0,105,109,-4
CU,AR,2001.0,7,4,3
AT,US,2018.0,273,251,22
NC,FR,2004.0,7,12,-5
GR,NL,2016.0,43,24,19
IT,JO,2020.0,3,2,1
SE,NO,2014.0,96,74,22
CL,PL,2019.0,3,6,-3
AU,IN,2001.0,34,30,4
NG,IN,2013.0,23,8,15
CL,MX,2015.0,188,170,18
VE,US,2001.0,52,34,18
SE,AU,2003.0,34,25,9
BD,PK,2019.0,62,47,15
CO,AU,2020.0,16,14,2
IN,AU,2019.0,262,195,67
IN,AU,2010.0,121,82,39
SE,IN,2011.0,29,37,-8
FR,AR,2020.0,86,82,4
CN,AU,2018.0,521,549,-28
DE,CZ,2021.0,72,74,-2
CA,BR,2005.0,121,174,-53
PT,US,2014.0,165,198,-33
KR,TW,2011.0,28,32,-4
IL,GE,2012.0,1,1,0
VE,CR,2010.0,3,3,0
SE,CN,2011.0,83,84,-1
US,ES,2000.0,446,422,24
IT,DK,2018.0,71,32,39
AU,KR,2001.0,13,13,0
GB,nan,2001.0,56,36,20
NP,US,2009.0,20,13,7
FR,nan,2004.0,124,86,38
NO,FI,2021.0,28,32,-4
QA,CN,2019.0,31,28,3
ES,VE,2010.0,56,99,-43
BR,CR,2019.0,15,17,-2
DE,LU,2010.0,39,19,20
BE,ID,2019.0,9,3,6
IL,AU,2017.0,24,22,2
GE,CA,2006.0,4,2,2
NL,JP,2011.0,44,39,5
US,IT,1999.0,475,498,-23
EG,GB,2021.0,119,107,12
IN,IE,2022.0,43,14,29
IE,CA,2013.0,149,142,7
IT,US,2017.0,1178,904,274
JP,VN,2005.0,13,15,-2
DE,TR,2020.0,101,140,-39
NZ,GB,2012.0,268,262,6
PL,US,1998.0,103,103,0
HU,CH,2020.0,13,17,-4
AU,nan,2018.0,48,30,18
BR,IN,2019.0,42,41,1
CN,PL,2009.0,35,28,7
NG,US,2006.0,26,20,6
IN,MY,2016.0,148,114,34
IT,RU,2014.0,42,18,24
RU,IT,2021.0,51,56,-5
CI,BJ,2019.0,3,1,2
CH,CA,2008.0,95,84,11
nan,ES,2020.0,80,88,-8
US,AE,2007.0,38,18,20
AE,IN,2017.0,58,82,-24
IN,RU,2018.0,42,22,20
SE,nan,2007.0,55,84,-29
IT,MY,2008.0,36,60,-24
SG,NZ,2018.0,23,18,5
US,UA,2008.0,35,43,-8
BH,KE,2011.0,2,1,1
SG,JP,2007.0,20,28,-8
MX,EC,2018.0,152,99,53
ZA,KE,2013.0,22,25,-3
KE,UG,2019.0,20,13,7
ES,NO,2010.0,24,22,2
SE,FI,2020.0,101,104,-3
BR,AR,2022.0,81,68,13
PK,US,2002.0,55,53,2
FR,CN,2014.0,201,174,27
US,nan,2015.0,290,236,54
IE,CN,2009.0,33,46,-13
PK,NL,2004.0,2,3,-1
PY,AR,2014.0,4,7,-3
IN,DE,2022.0,137,111,26
BH,ET,2021.0,31,29,2
FR,JP,2008.0,108,105,3
RO,ID,2018.0,10,1,9
HK,US,2007.0,3,13,-10
NO,US,2007.0,77,135,-58
RU,BG,2001.0,12,9,3
SA,SD,2023.0,2,1,1
VN,GB,2013.0,6,7,-1
BE,DK,2018.0,73,59,14
FR,FI,2018.0,25,30,-5
IT,NL,2007.0,85,72,13
UA,RU,2018.0,681,515,166
CU,IT,2018.0,6,4,2
GB,MW,2022.0,9,14,-5
GH,US,2009.0,8,6,2
ES,KR,2022.0,10,11,-1
SG,TW,2012.0,39,48,-9
IR,IT,2012.0,27,14,13
RU,KZ,2014.0,31,27,4
DE,CA,2003.0,173,126,47
US,GE,2011.0,159,172,-13
IL,SA,2014.0,1,1,0
IT,SE,2021.0,61,66,-5
BD,PK,2017.0,61,42,19
IR,NL,2015.0,31,26,5
JP,nan,2015.0,59,43,16
SA,JP,2016.0,9,14,-5
GB,FR,1998.0,185,215,-30
AM,JP,1999.0,9,7,2
LV,IN,2020.0,3,3,0
AE,AU,2014.0,10,15,-5
RO,US,2022.0,38,51,-13
AU,CA,1998.0,94,136,-42
TR,AZ,2019.0,20,5,15
EG,CA,2014.0,45,84,-39
PT,CL,2019.0,24,14,10
CA,HU,2021.0,9,14,-5
IT,MA,2016.0,50,28,22
MK,AU,2018.0,57,41,16
DE,HU,2005.0,34,47,-13
HK,AU,2012.0,6,4,2
SA,CA,2019.0,96,149,-53
IN,nan,2014.0,75,63,12
MM,SG,2019.0,4,6,-2
CZ,VN,2016.0,3,2,1
DE,FI,2007.0,54,25,29
JP,NZ,2009.0,15,7,8
CL,BE,2022.0,4,5,-1
FR,CO,2015.0,32,37,-5
CL,IT,2009.0,12,21,-9
RW,US,2011.0,3,4,-1
US,BY,2000.0,7,4,3
IQ,SA,2019.0,26,52,-26
CH,BE,2021.0,72,66,6
MG,FR,2016.0,11,11,0
PL,SE,2008.0,25,20,5
CZ,TR,2021.0,9,7,2
BE,CY,2020.0,1,2,-1
IN,SA,2008.0,28,15,13
TW,PH,2006.0,4,1,3
US,PT,2009.0,108,116,-8
RO,HU,1997.0,25,45,-20
ID,nan,2019.0,73,121,-48
UZ,RU,2021.0,35,49,-14
CZ,AT,2009.0,14,13,1
GB,AT,2017.0,121,107,14
CU,VE,2007.0,10,13,-3
CA,NZ,2007.0,64,45,19
MY,IR,2021.0,55,33,22
GB,AT,2019.0,148,161,-13
PT,VE,2007.0,3,2,1
CN,DK,2021.0,63,74,-11
US,ET,2022.0,35,45,-10
ES,VE,2019.0,51,89,-38
DE,NZ,2006.0,38,18,20
VE,PT,2015.0,4,2,2
SK,US,2002.0,38,18,20
CH,CZ,2000.0,10,10,0
CZ,SK,2004.0,41,40,1
NL,SE,2018.0,82,82,0
VE,BR,2011.0,11,8,3
NL,VN,2015.0,12,3,9
GB,FR,1997.0,143,155,-12
US,LT,2010.0,7,9,-2
FR,BF,2015.0,20,17,3
KR,IN,2020.0,169,245,-76
CL,DK,2002.0,3,1,2
MA,US,2016.0,20,15,5
MY,VN,2019.0,17,4,13
FR,MQ,2020.0,21,18,3
HU,RO,2019.0,49,51,-2
TH,DE,2018.0,18,25,-7
FR,NL,1998.0,101,79,22
DE,IR,2007.0,27,23,4
SE,ES,2004.0,26,21,5
TJ,RU,2016.0,50,15,35
BY,US,2006.0,13,1,12
NG,JP,2019.0,31,28,3
CR,CO,2011.0,24,20,4
SL,US,2021.0,5,2,3
IR,US,2007.0,111,114,-3
NL,BY,2005.0,3,3,0
RU,CH,2008.0,18,12,6
RO,HU,1998.0,47,32,15
PT,FR,2022.0,28,28,0
DE,LU,2017.0,43,33,10
CZ,LV,2017.0,1,1,0
CU,DO,2018.0,3,2,1
LU,GB,2018.0,14,14,0
DZ,IR,2015.0,1,2,-1
NG,JP,2017.0,24,13,11
CO,PE,2007.0,12,28,-16
CN,CM,2016.0,4,1,3
NL,IE,2015.0,23,18,5
JP,MY,2005.0,10,13,-3
HU,RO,2017.0,41,49,-8
IT,nan,2001.0,62,79,-17
SE,KR,2020.0,12,13,-1
EG,US,2012.0,153,235,-82
nan,CA,2021.0,21,28,-7
ZA,IN,2016.0,66,89,-23
EC,PA,2018.0,5,8,-3
LB,US,2022.0,88,29,59
JP,NG,2014.0,15,12,3
nan,MA,2021.0,9,6,3
ZA,AU,2020.0,81,64,17
SE,CA,2006.0,38,29,9
AT,BR,2007.0,8,5,3
CH,CN,2019.0,89,109,-20
ES,AU,2013.0,63,40,23
JP,MM,2020.0,16,8,8
DE,TW,2014.0,21,47,-26
IE,SG,2011.0,8,5,3
MX,MA,2018.0,1,3,-2
MX,NL,2012.0,14,9,5
VN,NZ,2021.0,6,4,2
AZ,US,2020.0,7,1,6
US,BD,2007.0,62,34,28
DE,PT,2014.0,48,57,-9
PT,NL,2021.0,27,17,10
TZ,IN,2014.0,4,3,1
RU,CZ,2018.0,53,77,-24
ID,IQ,2020.0,5,18,-13
CZ,CH,2021.0,26,20,6
ZA,NG,2016.0,65,86,-21
IQ,DE,2017.0,5,10,-5
KW,JO,2017.0,3,6,-3
GB,FI,2008.0,50,56,-6
ID,AU,2018.0,64,148,-84
PL,US,1997.0,66,87,-21
SA,AU,2020.0,33,80,-47
TR,ID,2022.0,5,12,-7
IL,FR,2021.0,25,31,-6
BY,RU,2015.0,98,49,49
BR,LB,2021.0,3,11,-8
GB,AT,2010.0,89,93,-4
GR,BE,2021.0,18,19,-1
US,GM,2013.0,2,1,1
CR,ES,2020.0,59,65,-6
AE,SA,2020.0,36,41,-5
BG,US,2001.0,28,9,19
GR,CH,2021.0,21,24,-3
ID,BN,2018.0,4,1,3
FR,IL,2016.0,36,38,-2
ES,DZ,2020.0,3,5,-2
BD,NO,2020.0,6,17,-11
BE,CI,2018.0,2,3,-1
SI,CN,2013.0,5,4,1
NL,ET,2020.0,15,13,2
CO,BE,2016.0,12,14,-2
PK,AE,2016.0,8,19,-11
JP,MN,2019.0,13,12,1
CN,IR,2021.0,47,66,-19
ID,CN,2014.0,74,59,15
SI,MX,2021.0,6,17,-11
BE,EG,2008.0,2,2,0
ES,NL,2003.0,32,40,-8
ES,CZ,2013.0,17,12,5
GB,TW,2006.0,46,44,2
TW,JP,2020.0,89,73,16
RU,TJ,2020.0,122,34,88
RU,AM,1999.0,4,2,2
SE,GB,2012.0,143,192,-49
ID,SG,2021.0,12,16,-4
SK,CZ,2016.0,160,103,57
SE,PK,2015.0,20,9,11
SE,NL,2021.0,66,55,11
AU,PK,2015.0,37,38,-1
US,CR,2021.0,26,36,-10
CN,CH,2017.0,76,86,-10
ID,nan,2017.0,31,92,-61
CO,TR,2022.0,101,89,12
US,QA,2018.0,77,88,-11
PF,FR,2020.0,12,8,4
SK,JP,2011.0,25,9,16
US,CU,2002.0,16,19,-3
YE,CN,2020.0,8,5,3
CU,CL,2008.0,20,10,10
SA,KW,2019.0,40,32,8
DK,CA,2003.0,21,18,3
US,NA,2013.0,3,1,2
DE,ZA,2007.0,39,42,-3
KE,SE,2010.0,6,3,3
BG,DE,2004.0,21,10,11
DE,HU,2002.0,32,39,-7
IT,PL,2016.0,20,28,-8
NL,BE,1997.0,83,71,12
SA,CN,2018.0,55,47,8
GB,KE,2001.0,13,8,5
RO,PL,2012.0,8,7,1
MW,AU,2017.0,2,2,0
IL,JP,2015.0,9,9,0
KE,UG,2017.0,13,12,1
CN,CR,2010.0,2,2,0
ES,UY,2021.0,32,30,2
KW,EG,2016.0,36,22,14
HU,GB,2014.0,48,39,9
CZ,RU,2001.0,11,8,3
TW,KR,2004.0,25,17,8
MX,DE,2012.0,37,40,-3
PL,RS,2022.0,4,5,-1
HU,JP,1998.0,13,8,5
IQ,FR,2012.0,1,1,0
QA,CN,2010.0,14,24,-10
US,ML,2016.0,3,4,-1
LK,GB,2007.0,8,24,-16
AR,GB,2014.0,35,26,9
EG,IT,1997.0,1,3,-2
TT,JM,2014.0,18,24,-6
PK,OM,2012.0,7,2,5
US,GD,2012.0,6,5,1
BJ,FR,2012.0,28,28,0
DE,VE,1997.0,1,2,-1
PL,DE,2000.0,56,65,-9
nan,ZA,2012.0,9,6,3
BD,GB,2015.0,47,63,-16
RO,FR,2006.0,27,30,-3
NG,SA,2007.0,3,2,1
US,GH,2014.0,30,27,3
FI,IN,2009.0,5,7,-2
IT,IN,1998.0,26,17,9
FI,DK,2009.0,13,7,6
SA,KW,2010.0,9,10,-1
IQ,EG,2016.0,18,33,-15
AU,SA,2004.0,8,3,5
CA,GT,2020.0,1,1,0
JP,MY,2002.0,18,10,8
ES,NO,2017.0,36,20,16
CH,RO,2022.0,9,6,3
FR,CI,2013.0,39,13,26
VE,CR,2019.0,5,2,3
GB,GH,2013.0,26,7,19
DE,LU,2019.0,44,30,14
SG,US,1999.0,90,138,-48
LU,DE,2018.0,33,60,-27
HU,RU,2014.0,7,14,-7
NL,SK,2011.0,3,8,-5
IR,DK,2012.0,9,13,-4
JP,IQ,2014.0,7,4,3
CZ,CN,2001.0,9,7,2
SE,IT,2006.0,64,61,3
DE,AU,2001.0,96,100,-4
EG,PS,2018.0,13,11,2
IT,NO,2018.0,40,19,21
QA,CN,2017.0,10,26,-16
MY,JP,2011.0,17,61,-44
NL,IN,2012.0,36,65,-29
ID,BE,2015.0,6,3,3
FI,GB,2015.0,71,66,5
IT,UY,2004.0,4,1,3
UY,IT,2008.0,8,5,3
GP,FR,2018.0,20,44,-24
CA,EG,2008.0,26,32,-6
PL,KR,1999.0,1,1,0
DE,LV,2017.0,3,5,-2
IT,IL,2020.0,31,17,14
HU,BE,2007.0,10,8,2
US,LT,2019.0,16,5,11
RU,JP,2012.0,30,28,2
US,HK,2008.0,12,6,6
SI,CZ,2009.0,10,15,-5
CN,IN,1999.0,15,17,-2
PK,RU,2012.0,1,2,-1
MY,BE,2012.0,4,7,-3
IT,MT,2019.0,10,6,4
MA,SA,2017.0,5,9,-4
AF,BR,2021.0,7,3,4
NZ,CA,2022.0,34,32,2
TR,GB,2001.0,25,51,-26
CA,KR,1999.0,13,13,0
ZA,SN,2019.0,2,2,0
ES,VE,2017.0,53,66,-13
GB,HU,1998.0,21,18,3
ZA,FR,2007.0,17,23,-6
NG,ZA,2023.0,10,2,8
FI,SG,2018.0,6,2,4
IN,NO,2006.0,21,19,2
IT,CZ,2012.0,14,25,-11
TN,US,2022.0,13,11,2
IT,LB,2019.0,23,15,8
ES,NO,2019.0,37,27,10
AR,AT,2016.0,3,6,-3
ID,IN,2016.0,28,66,-38
DE,AR,2013.0,28,42,-14
PH,TW,2021.0,7,12,-5
CN,SA,1999.0,2,1,1
DE,MY,2018.0,19,26,-7
IN,TW,2007.0,36,20,16
CA,CZ,2015.0,14,11,3
SA,KR,2021.0,9,8,1
BD,SG,2022.0,1,2,-1
US,MA,2021.0,14,14,0
CR,ID,2020.0,1,1,0
MY,TR,2017.0,20,12,8
NG,ID,2018.0,22,11,11
FR,PH,2007.0,4,2,2
US,IQ,2011.0,5,5,0
JO,DE,2015.0,11,11,0
TW,SE,1998.0,2,3,-1
FI,UA,2017.0,6,2,4
UA,CA,2019.0,5,6,-1
CN,GR,2004.0,8,7,1
CR,MX,2005.0,10,6,4
GR,CA,2018.0,14,9,5
SE,EE,2018.0,7,6,1
AT,CL,2019.0,7,3,4
NL,KR,2018.0,10,10,0
GB,JM,2005.0,5,5,0
TR,BR,2008.0,41,17,24
JP,AU,2001.0,38,40,-2
DK,FR,2012.0,43,26,17
CZ,US,2006.0,111,82,29
AE,SD,2020.0,8,5,3
AR,DE,2016.0,36,43,-7
KR,RU,2016.0,22,6,16
CA,DZ,2022.0,13,7,6
EE,LV,2022.0,2,2,0
KR,NL,2016.0,7,14,-7
SK,US,2005.0,43,16,27
ZW,GB,2016.0,1,6,-5
RU,EG,2022.0,22,10,12
AT,PT,2008.0,2,1,1
US,NO,2003.0,96,59,37
NZ,NO,2015.0,7,5,2
DO,CO,2022.0,1,2,-1
GB,SA,2023.0,4,1,3
ZA,nan,2014.0,4,12,-8
CL,FI,2022.0,1,4,-3
TR,AU,2002.0,9,6,3
BR,CR,2010.0,11,7,4
CN,CU,2020.0,2,6,-4
AL,IT,2014.0,6,4,2
CN,FI,2003.0,9,11,-2
IN,IQ,2021.0,12,13,-1
DE,CO,2021.0,28,30,-2
KE,IN,2018.0,7,9,-2
DK,NL,2013.0,25,37,-12
BO,CL,2021.0,9,9,0
BE,UA,2011.0,3,3,0
JP,PH,1997.0,6,1,5
RO,SK,2011.0,5,5,0
IT,GH,2020.0,7,4,3
CZ,NO,2008.0,14,7,7
UA,CO,2004.0,2,2,0
SE,PE,2015.0,3,1,2
IE,FI,2014.0,1,1,0
AU,MX,2007.0,8,8,0
IT,ET,2004.0,1,2,-1
UY,DE,2016.0,5,6,-1
AT,SG,2019.0,7,2,5
BE,ES,1997.0,30,15,15
AT,IT,2000.0,12,9,3
FR,HU,2012.0,30,22,8
AR,FI,2018.0,4,2,2
SA,FR,2021.0,18,23,-5
SG,nan,2022.0,7,4,3
AT,IS,2009.0,1,1,0
IR,FR,2007.0,13,24,-11
CH,NZ,2016.0,17,16,1
UY,AU,2005.0,2,2,0
FR,NL,1997.0,63,66,-3
PL,IQ,2018.0,4,1,3
NO,IL,2012.0,2,6,-4
JP,JO,2019.0,2,4,-2
CU,CA,2006.0,2,1,1
IR,DE,2009.0,36,28,8
ZA,SE,2008.0,8,11,-3
HU,RO,2010.0,28,26,2
BR,AO,2013.0,20,26,-6
DK,IT,2008.0,15,27,-12
UA,CA,2017.0,7,10,-3
VE,DE,2002.0,3,4,-1
BG,JP,2007.0,3,7,-4
PL,CA,2007.0,23,30,-7
TR,SA,2013.0,13,5,8
BE,UG,2022.0,7,8,-1
IT,SI,2021.0,15,11,4
BR,IN,2017.0,37,43,-6
IT,MT,2017.0,11,2,9
GB,SY,2008.0,2,2,0
MY,TR,2019.0,15,10,5
AR,CL,2023.0,3,1,2
IL,nan,2003.0,11,9,2
TZ,KE,2017.0,8,9,-1
ID,JP,2001.0,13,29,-16
RU,LV,2018.0,12,23,-11
BW,US,2021.0,8,6,2
CA,GE,2007.0,1,1,0
US,AR,2023.0,10,5,5
IT,IN,1997.0,21,12,9
KR,PL,2005.0,1,1,0
DE,CY,2017.0,2,7,-5
DE,CY,2019.0,9,9,0
GH,FR,2014.0,1,2,-1
ET,RU,2019.0,3,2,1
SE,AT,2016.0,27,48,-21
nan,UA,2016.0,24,23,1
UA,IL,2007.0,3,1,2
US,IS,1997.0,1,7,-6
RU,NO,2022.0,17,10,7
CR,AU,2020.0,1,3,-2
CA,CO,2012.0,17,20,-3
TN,CA,2002.0,3,4,-1
SA,CA,2010.0,28,74,-46
PR,KR,2022.0,14,11,3
AU,RU,1999.0,5,4,1
EG,ES,2018.0,8,15,-7
FJ,IN,2015.0,3,8,-5
SG,PH,2012.0,8,6,2
CO,GB,2005.0,13,16,-3
IL,ZA,2019.0,5,4,1
BH,IN,2021.0,6,6,0
ES,nan,2022.0,32,41,-9
BO,CO,2010.0,4,4,0
GB,AR,2020.0,34,45,-11
RS,NL,2014.0,5,5,0
ET,SE,2008.0,2,1,1
SG,NL,2009.0,12,10,2
CL,NZ,2008.0,2,1,1
SI,ES,2018.0,12,14,-2
TN,CA,2005.0,1,4,-3
NL,MX,2008.0,8,9,-1
MQ,DE,2015.0,1,1,0
JP,RU,2013.0,40,33,7
DO,US,1997.0,2,1,1
NL,NZ,2007.0,8,7,1
CL,ID,2013.0,2,2,0
IT,TH,2016.0,6,2,4
PL,CH,2013.0,29,32,-3
TW,AR,2021.0,3,2,1
AU,IT,2022.0,32,35,-3
CN,IQ,2013.0,10,2,8
CU,BR,2012.0,21,9,12
US,AF,2012.0,2,2,0
ES,RU,2021.0,18,21,-3
US,KE,1997.0,9,8,1
PT,NZ,2021.0,2,1,1
US,VG,2002.0,4,6,-2
GH,BH,2012.0,4,3,1
US,VG,2005.0,10,8,2
MA,SA,2019.0,11,8,3
SK,CA,2021.0,4,2,2
VE,AR,2016.0,26,13,13
IN,SE,2006.0,24,14,10
GB,JO,2009.0,12,11,1
CN,UZ,2005.0,4,3,1
SK,BR,2013.0,3,5,-2
SN,US,2014.0,8,12,-4
LK,nan,2017.0,1,1,0
IE,FR,2007.0,19,37,-18
TW,NZ,2020.0,5,9,-4
RO,ZA,2013.0,3,4,-1
BO,CO,2019.0,10,14,-4
US,OM,2001.0,7,2,5
BE,RU,2013.0,15,17,-2
BI,US,2020.0,5,1,4
NZ,JP,2001.0,7,11,-4
IN,PL,2016.0,11,21,-10
JP,FI,2004.0,9,11,-2
IN,ER,2008.0,1,1,0
JP,ZM,2017.0,3,1,2
BF,DE,2013.0,1,1,0
SA,DE,2007.0,5,7,-2
IT,KR,1999.0,4,1,3
FR,NC,2001.0,6,3,3
BT,LK,2021.0,4,3,1
NE,BE,2019.0,3,3,0
SI,NO,2019.0,2,2,0
DK,AR,2018.0,5,5,0
NL,HK,2002.0,5,5,0
KR,TR,2018.0,4,8,-4
FR,AT,2006.0,26,27,-1
SK,FI,1999.0,3,1,2
CL,VE,2014.0,14,24,-10
IL,UG,2015.0,1,2,-1
SI,nan,2016.0,2,3,-1
SN,ML,2018.0,6,4,2
BE,TZ,2019.0,4,3,1
CA,MX,1999.0,13,12,1
DE,SI,2016.0,18,16,2
GF,FR,2007.0,6,9,-3
GA,US,2022.0,1,2,-1
MA,TN,2006.0,14,6,8
DE,BG,2005.0,21,25,-4
SZ,ZA,2015.0,6,2,4
NZ,IN,2004.0,8,10,-2
CR,CA,2011.0,1,1,0
AU,EE,2017.0,1,2,-1
CO,CL,2001.0,23,20,3
PL,BA,2008.0,7,6,1
BR,NZ,2012.0,5,9,-4
JP,PL,2008.0,18,17,1
nan,TR,2022.0,12,12,0
FI,UA,2010.0,2,3,-1
PT,CL,2017.0,12,9,3
EG,TR,2020.0,18,12,6
BG,NO,2022.0,3,2,1
DE,CW,1999.0,1,1,0
AO,US,2006.0,1,1,0
UZ,KZ,2017.0,8,2,6
OM,IQ,2022.0,2,5,-3
MZ,CH,2008.0,1,1,0
IT,MD,2020.0,3,2,1
IT,SA,2022.0,14,6,8
SE,CZ,2012.0,11,9,2
SA,nan,2020.0,1,5,-4
CZ,nan,2007.0,11,1,10
BR,SD,2015.0,7,9,-2
US,EC,2012.0,28,14,14
PK,AT,2008.0,4,4,0
CZ,JP,2000.0,9,5,4
KW,US,2016.0,20,26,-6
DK,GB,2001.0,56,54,2
NO,NZ,2012.0,4,9,-5
PT,CU,2005.0,2,3,-1
QA,LB,2012.0,3,1,2
SS,GB,2006.0,7,12,-5
RU,RS,2003.0,2,2,0
MX,KR,2013.0,4,3,1
CA,AR,1997.0,6,4,2
AT,MK,2015.0,5,14,-9
KE,UG,2010.0,5,2,3
CA,RU,2015.0,38,27,11
BE,TN,2004.0,4,2,2
AU,AT,2004.0,9,14,-5
CZ,LV,2019.0,2,1,1
UZ,PL,2014.0,4,1,3
EC,UA,2012.0,16,15,1
PL,IT,1998.0,6,9,-3
BE,CA,1999.0,12,25,-13
GH,NG,2022.0,2,6,-4
SK,RS,2008.0,6,7,-1
SE,PL,2015.0,17,29,-12
ZA,IE,2009.0,5,8,-3
IT,BG,2010.0,6,3,3
BF,LU,2015.0,1,1,0
KW,BH,2018.0,1,4,-3
RS,BR,2002.0,2,1,1
EG,SA,2023.0,41,29,12
AT,CL,2010.0,2,2,0
FR,BY,2017.0,3,3,0
LY,IN,2016.0,4,3,1
GB,IS,2004.0,1,2,-1
HU,IT,2006.0,16,8,8
PH,NL,2014.0,5,5,0
BE,RO,2016.0,12,11,1
GB,LU,2016.0,7,7,0
HR,HU,2011.0,2,1,1
TR,IT,2018.0,26,19,7
SA,CH,2012.0,2,4,-2
IN,ZA,2003.0,13,13,0
TN,SE,2018.0,3,3,0
IT,LB,2017.0,11,15,-4
US,KE,1998.0,18,14,4
IE,CZ,2013.0,2,3,-1
AE,IR,2012.0,4,3,1
BA,PL,2007.0,4,5,-1
TZ,KE,2010.0,6,2,4
BE,ID,2017.0,11,8,3
LT,GB,2010.0,6,4,2
JP,CZ,2009.0,20,13,7
IR,LB,2022.0,4,2,2
GB,SD,2011.0,10,4,6
RO,AT,2022.0,4,11,-7
GM,BE,2015.0,2,1,1
DK,SK,2005.0,2,2,0
KR,DK,2015.0,7,3,4
IE,BD,2007.0,1,2,-1
DE,BG,2002.0,14,22,-8
KR,ZA,2005.0,2,2,0
BR,ZM,2014.0,6,8,-2
PT,nan,2016.0,12,37,-25
CO,CR,2011.0,20,24,-4
UA,NG,2017.0,1,2,-1
CR,IL,2010.0,2,2,0
SE,SD,2015.0,1,2,-1
NZ,BE,2012.0,4,6,-2
AU,OM,2020.0,8,7,1
CA,SY,2006.0,1,1,0
IT,PH,2013.0,9,4,5
ES,ZA,2001.0,2,3,-1
SA,QA,2004.0,5,2,3
LK,US,2012.0,19,25,-6
NZ,DK,2008.0,7,7,0
EC,CL,2012.0,14,19,-5
DK,SG,2009.0,3,8,-5
US,LV,2001.0,4,6,-2
US,HR,2007.0,34,37,-3
BE,QA,2016.0,3,1,2
IT,CO,2022.0,8,9,-1
MY,PK,2001.0,2,3,-1
VE,JP,2003.0,1,1,0
ES,PK,2016.0,7,5,2
MA,CA,2018.0,19,24,-5
NO,CZ,1997.0,2,2,0
NL,LU,2008.0,4,2,2
EG,PH,2014.0,1,2,-1
IT,FI,2001.0,7,6,1
PK,CY,2017.0,3,1,2
BN,MY,2018.0,10,13,-3
ES,UA,2020.0,2,4,-2
BH,AE,2018.0,3,2,1
AT,PL,2018.0,16,13,3
EG,DK,2016.0,3,1,2
NG,GM,2020.0,4,3,1
US,CU,2005.0,19,16,3
TN,NG,2011.0,4,2,2
ML,GN,2017.0,2,2,0
CN,ES,2001.0,12,21,-9
CN,MK,2009.0,7,2,5
MY,NI,2013.0,1,1,0
KE,CN,2004.0,1,3,-2
KE,SE,2017.0,4,5,-1
KR,BR,2015.0,9,4,5
BR,BD,2019.0,3,2,1
IE,EG,2014.0,9,2,7
PT,CL,2010.0,8,9,-1
SA,KW,2017.0,16,32,-16
CV,PT,2012.0,1,1,0
AU,ES,2003.0,11,18,-7
PT,AO,2014.0,5,2,3
FR,LA,2019.0,2,1,1
CN,ID,2001.0,4,5,-1
MW,ZA,2022.0,8,5,3
CO,IN,2012.0,5,5,0
BJ,ZA,2018.0,2,2,0
PS,EG,2016.0,9,13,-4
FR,SY,2015.0,10,9,1
IT,EC,2020.0,8,7,1
BE,LU,2008.0,15,9,6
LT,GB,2019.0,8,7,1
RW,SE,2018.0,3,3,0
KR,GH,2022.0,2,1,1
IR,ET,2019.0,3,1,2
ZA,GH,2018.0,20,24,-4
NP,TW,2020.0,2,2,0
MY,VN,2017.0,7,4,3
IE,TW,2022.0,2,2,0
ID,SI,2016.0,2,8,-6
NP,CO,2009.0,1,1,0
nan,SG,2020.0,8,8,0
SA,LV,2019.0,2,2,0
AT,TR,2016.0,8,18,-10
CA,MU,2008.0,1,1,0
BD,IE,2015.0,3,2,1
CH,IE,2009.0,14,7,7
UY,AR,2008.0,18,18,0
ML,CH,2008.0,2,2,0
MX,PH,2015.0,8,6,2
US,PK,2000.0,36,40,-4
CL,BR,1999.0,7,7,0
CH,EC,2008.0,1,1,0
KH,FR,2012.0,5,2,3
SY,JO,2021.0,5,3,2
PE,CO,2003.0,14,6,8
US,AL,2008.0,2,1,1
TW,TH,2011.0,2,4,-2
RU,MZ,2007.0,21,1,20
AR,CH,2012.0,15,8,7
BW,TZ,2018.0,2,1,1
MG,DE,2015.0,2,1,1
SI,FR,2022.0,3,1,2
BE,BF,2022.0,9,2,7
NG,GH,2014.0,6,2,4
NL,TW,2017.0,4,5,-1
IL,AU,2010.0,18,18,0
IT,BF,2012.0,2,2,0
CH,GH,2017.0,3,3,0
SG,MM,2009.0,1,1,0
BR,SA,2021.0,6,1,5
ES,BG,2006.0,6,6,0
RO,DE,1998.0,11,11,0
ID,IT,2009.0,1,2,-1
LV,SE,2017.0,3,3,0
BY,CH,2019.0,1,1,0
DE,LI,2011.0,5,1,4
IR,PT,2022.0,12,5,7
IL,SE,2022.0,6,6,0
CI,FR,2021.0,15,17,-2
IL,ZA,2017.0,4,3,1
SK,AT,2014.0,11,12,-1
ME,RS,2013.0,13,20,-7
DK,TH,2006.0,3,1,2
GR,FR,2005.0,19,22,-3
OM,MY,2014.0,3,7,-4
IT,TN,2014.0,12,16,-4
SE,LV,2011.0,2,3,-1
FR,UZ,2011.0,1,1,0
MY,RU,2007.0,5,3,2
DK,EG,2006.0,4,1,3
nan,CL,2014.0,9,4,5
NP,NL,2002.0,2,2,0
ID,nan,2010.0,4,4,0
SE,SI,2009.0,2,1,1
IN,CH,1997.0,5,6,-1
GR,FR,2002.0,10,28,-18
GB,HU,1997.0,9,20,-11
VN,MX,2002.0,4,2,2
SE,JP,2001.0,27,32,-5
AE,KE,2021.0,1,1,0
KR,MY,2003.0,2,2,0
ID,SD,2020.0,1,7,-6
CH,LU,2011.0,7,4,3
IL,IN,2006.0,9,15,-6
LU,NZ,2019.0,1,1,0
CA,PT,2005.0,3,8,-5
ET,NG,2012.0,1,1,0
AU,ZA,2003.0,18,33,-15
VE,CR,2017.0,3,5,-2
EG,IL,2011.0,2,4,-2
AE,GB,2003.0,5,5,0
PK,DE,2000.0,5,1,4
PE,CU,2005.0,2,3,-1
PL,IT,1997.0,7,7,0
UG,CH,2014.0,2,5,-3
SY,CN,1999.0,1,1,0
CU,UY,2003.0,2,1,1
TR,SE,2004.0,3,7,-4
CM,FR,2006.0,12,12,0
KW,JO,2019.0,11,5,6
VN,nan,2018.0,3,4,-1
ES,QA,2012.0,5,11,-6
NO,HK,2013.0,1,1,0
NL,TW,2019.0,3,12,-9
HU,EG,2021.0,8,6,2
FR,CU,2013.0,3,5,-2
BG,DK,2012.0,2,2,0
VN,BE,2006.0,2,6,-4
CN,PT,1998.0,2,4,-2
IT,MT,2010.0,3,1,2
TH,GH,2018.0,2,2,0
CZ,UZ,2001.0,5,2,3
MM,SG,2017.0,2,9,-7
PT,CU,2002.0,2,2,0
AR,HN,2020.0,4,3,1
PT,CR,2018.0,2,1,1
UY,FR,2007.0,8,1,7
AR,IL,2000.0,3,6,-3
IT,BG,2017.0,7,6,1
OM,AE,2012.0,1,1,0
PK,CY,2019.0,1,2,-1
CN,CR,2019.0,2,1,1
GB,QA,2001.0,5,3,2
CL,EC,2004.0,2,2,0
IS,CA,2019.0,1,1,0
BR,CR,2017.0,16,15,1
EC,SE,2017.0,1,1,0
AM,IT,2002.0,5,3,2
NO,CA,2009.0,6,24,-18
LT,RU,2002.0,5,1,4
PL,AU,2012.0,14,19,-5
FR,ID,2006.0,5,8,-3
NG,CN,2014.0,5,3,2
GB,JM,2002.0,2,2,0
TW,RU,2015.0,5,13,-8
MX,MY,2019.0,5,4,1
FR,SG,2003.0,5,1,4
SE,HR,2021.0,6,5,1
KR,CZ,2015.0,10,11,-1
KH,TR,2020.0,3,7,-4
NZ,CO,2021.0,3,3,0
NL,GR,2000.0,8,15,-7
MY,PH,2011.0,3,1,2
nan,NI,2016.0,2,2,0
UY,EC,2020.0,2,10,-8
MX,UZ,2021.0,1,1,0
RU,TM,2020.0,3,3,0
CA,VN,2011.0,7,2,5
BE,TR,2003.0,10,6,4
ES,CR,2001.0,8,14,-6
BE,MA,2001.0,3,3,0
BR,GT,2012.0,1,1,0
MY,KR,2006.0,4,4,0
FI,TH,2020.0,3,1,2
BY,JP,2007.0,1,1,0
RO,DE,1997.0,8,4,4
NO,TZ,2015.0,7,7,0
MZ,US,2016.0,4,5,-1
IR,FI,2008.0,3,2,1
IR,SE,1998.0,3,3,0
NI,nan,2019.0,3,3,0
PT,GB,1999.0,18,21,-3
HU,LT,2001.0,4,1,3
AU,TW,2023.0,2,1,1
CN,KE,2003.0,2,5,-3
KE,SE,2019.0,4,5,-1
UG,AU,2008.0,2,3,-1
FI,ZM,2017.0,2,1,1
DE,GA,2017.0,4,5,-1
CO,RU,2016.0,8,3,5
EE,FI,2005.0,1,4,-3
CN,EG,2002.0,6,3,3
NP,NZ,2004.0,3,2,1
ZM,NP,2008.0,1,1,0
TT,US,2002.0,7,1,6
ZA,RO,2011.0,2,1,1
KW,OM,2017.0,1,2,-1
ZA,AT,2016.0,6,6,0
KR,AM,2007.0,7,11,-4
TR,AZ,2017.0,18,12,6
IN,CH,1998.0,4,6,-2
IN,SI,2018.0,4,5,-1
JP,ZM,2010.0,2,1,1
PH,FR,2006.0,2,3,-1
UA,AT,2006.0,6,6,0
AT,FI,2011.0,7,8,-1
AU,FJ,2021.0,3,3,0
GB,PH,2002.0,10,5,5
IN,LK,2020.0,18,34,-16
NO,FO,2015.0,2,2,0
AT,CL,2017.0,4,6,-2
US,SD,2007.0,4,6,-2
SE,CL,2011.0,3,4,-1
GB,ID,1999.0,2,1,1
ZA,ES,2012.0,3,11,-8
PL,BY,1997.0,1,2,-1
CN,CL,2001.0,3,3,0
DE,LV,2019.0,7,2,5
OM,PK,2006.0,1,2,-1
VN,SE,2020.0,3,5,-2
BA,NO,2018.0,2,1,1
NL,CO,2002.0,2,5,-3
AE,OM,2018.0,10,8,2
SE,TR,2004.0,7,3,4
BG,HR,2022.0,1,1,0
DZ,SA,2014.0,5,6,-1
IR,TH,2020.0,3,2,1
PK,UG,2021.0,2,1,1
IR,JP,2006.0,7,27,-20
PK,IT,2023.0,2,3,-1
CL,ZA,2018.0,3,3,0
DE,GA,2010.0,4,1,3
CM,ZA,2022.0,1,3,-2
BB,JM,2004.0,2,1,1
PL,RO,2008.0,4,2,2
AE,IN,2010.0,7,16,-9
SE,AR,2002.0,2,1,1
IT,BY,2005.0,3,1,2
CD,BE,2011.0,5,8,-3
CA,AR,1998.0,3,4,-1
MY,TR,2010.0,3,5,-2
NL,EC,2021.0,3,4,-1
ZM,US,2005.0,2,7,-5
KN,IN,2015.0,2,2,0
CH,SG,2018.0,15,19,-4
US,SY,2018.0,4,14,-10
UZ,KZ,2019.0,4,7,-3
RS,ES,2016.0,5,3,2
PY,MX,2013.0,4,4,0
BR,IL,2007.0,3,6,-3
PE,AU,2012.0,4,1,3
CN,MT,2003.0,1,1,0
KW,MA,2010.0,5,4,1
TH,FR,2003.0,8,7,1
KR,SG,2007.0,20,29,-9
GB,MA,2000.0,2,2,0
IR,IN,2008.0,5,23,-18
AT,MX,2018.0,5,9,-4
PL,SG,2012.0,3,3,0
DK,CZ,2009.0,7,2,5
MW,US,2011.0,5,15,-10
CR,MX,2002.0,5,6,-1
TN,CN,2013.0,2,1,1
RU,SK,1998.0,2,4,-2
LT,GB,2017.0,9,8,1
VN,MX,2005.0,5,1,4
IS,CA,2017.0,2,4,-2
GN,FR,2022.0,3,6,-3
IE,CO,2016.0,2,3,-1
MY,SE,2000.0,2,1,1
QA,NP,2018.0,1,1,0
FR,BA,2019.0,3,2,1
IT,VE,2021.0,3,6,-3
BB,US,2022.0,3,2,1
EC,BE,2014.0,2,2,0
GB,PH,2005.0,12,8,4
GA,DE,2020.0,5,3,2
NL,PK,2004.0,3,2,1
HU,BG,2012.0,1,1,0
UA,FI,2015.0,4,3,1
VG,US,2003.0,3,6,-3
CL,PL,2010.0,1,1,0
GB,MY,2023.0,3,3,0
DE,GA,2019.0,2,5,-3
ID,DE,2008.0,5,15,-10
RS,RU,2005.0,3,6,-3
JP,ZM,2019.0,1,2,-1
AU,EE,2019.0,4,2,2
DE,LV,2010.0,3,4,-1
US,IS,1998.0,4,3,1
EE,FI,2002.0,2,9,-7
IR,PH,2013.0,1,1,0
PA,GB,2009.0,3,4,-1
US,MM,2007.0,4,1,3
AE,YE,2013.0,1,1,0
AR,ZA,2018.0,4,2,2
IN,BW,2020.0,5,1,4
MD,TR,2022.0,1,14,-13
KR,PT,2012.0,4,2,2
PT,PY,2008.0,1,4,-3
EG,BN,2012.0,2,1,1
SN,BJ,2016.0,1,1,0
PE,BO,2009.0,3,3,0
SD,FR,2018.0,1,2,-1
RO,BR,2016.0,4,6,-2
JP,VN,2002.0,5,6,-1
PK,SD,2016.0,1,2,-1
VN,CH,2012.0,1,3,-2
BD,PK,2010.0,10,27,-17
BE,TW,2013.0,5,5,0
SA,IL,2013.0,2,1,1
IS,FR,2011.0,4,3,1
SG,FI,2014.0,1,2,-1
GH,TH,2018.0,2,2,0
CM,ID,2020.0,3,1,2
EE,NO,2018.0,2,1,1
KW,TR,2015.0,3,3,0
MX,SK,2019.0,2,1,1
PE,CU,2002.0,1,1,0
JP,RS,2011.0,1,3,-2
NO,CZ,1998.0,5,2,3
AT,BE,2003.0,3,4,-1
BG,SI,2006.0,1,1,0
US,AO,2018.0,2,2,0
CN,TN,2021.0,4,2,2
ML,SN,2021.0,4,2,2
US,MZ,2013.0,5,4,1
BH,PL,2013.0,2,5,-3
DZ,TN,2004.0,3,1,2
SE,BA,2019.0,1,2,-1
BF,FR,2002.0,2,5,-3
DO,CH,2004.0,1,1,0
AT,SG,2017.0,3,3,0
NG,CM,2016.0,4,2,2
AU,NC,2014.0,1,2,-1
NL,TR,2023.0,1,2,-1
PK,PT,2009.0,1,1,0
FR,RW,2020.0,2,1,1
BE,TZ,2010.0,3,1,2
MT,US,2000.0,2,1,1
TH,FI,2016.0,1,3,-2
SK,RO,2022.0,8,1,7
KR,IE,2016.0,7,5,2
IE,TR,2013.0,2,2,0
KR,GE,2017.0,2,3,-1
IL,GR,2008.0,1,2,-1
ZW,US,2018.0,8,7,1
DE,CY,2010.0,4,3,1
PE,nan,2005.0,4,4,0
DE,BO,2015.0,1,2,-1
PK,CH,2001.0,3,7,-4
LT,RU,2005.0,5,6,-1
TJ,US,2015.0,2,2,0
US,AG,2022.0,5,1,4
NL,TW,2010.0,4,8,-4
BR,ST,2000.0,8,1,7
VG,CA,2013.0,1,1,0
BY,GB,2007.0,4,2,2
IT,RE,2000.0,1,1,0
UA,CA,2010.0,6,3,3
AU,KE,2013.0,6,10,-4
MN,KZ,2021.0,3,1,2
NO,GH,2018.0,3,5,-2
SA,GR,2014.0,4,5,-1
TT,IN,2018.0,3,5,-2
ZA,DK,2013.0,7,9,-2
CN,PT,1997.0,3,2,1
KR,IT,2003.0,2,2,0
ZA,MX,2016.0,2,5,-3
SA,OM,2003.0,1,2,-1
EC,SE,2019.0,1,1,0
TW,SE,1997.0,3,1,2
GB,BB,2007.0,1,2,-1
CO,GB,2002.0,7,11,-4
CA,KE,2020.0,7,13,-6
GH,JP,2015.0,1,7,-6
VN,AU,2006.0,1,6,-5
UA,SK,2013.0,1,1,0
MA,AM,2021.0,1,1,0
SG,KE,2006.0,2,1,1
CZ,NZ,2009.0,2,1,1
CY,SA,2019.0,1,1,0
SD,DE,2022.0,1,1,0
JP,JO,2010.0,1,1,0
MK,PL,2012.0,1,1,0
TR,IQ,2009.0,1,1,0
PK,TH,2015.0,4,5,-1
BD,BE,2006.0,1,2,-1
GB,HK,2007.0,4,1,3
PF,US,2015.0,4,1,3
TH,PH,2019.0,2,5,-3
PT,AT,2002.0,4,2,2
CR,FR,2013.0,2,1,1
CH,NP,2002.0,1,1,0
SK,ES,2020.0,2,4,-2
PK,NP,2020.0,2,6,-4
TR,NG,2013.0,1,4,-3
AL,GR,2018.0,2,3,-1
UY,PE,2018.0,2,5,-3
NZ,PL,2012.0,1,3,-2
BE,LV,2012.0,1,1,0
CH,DZ,2018.0,3,1,2
GR,SE,1998.0,1,3,-2
NL,IL,2004.0,3,13,-10
GH,TG,2017.0,1,3,-2
CZ,MY,2015.0,5,14,-9
NL,HK,2005.0,2,10,-8
GE,PL,2022.0,1,1,0
RU,SK,1997.0,3,2,1
IL,MY,2012.0,3,1,2
IE,MX,2004.0,2,2,0
CO,GT,2011.0,3,2,1
TN,DZ,2009.0,3,4,-1
US,MC,2022.0,2,2,0
NL,NG,2014.0,9,3,6
UA,BG,2000.0,3,1,2
BO,TW,2003.0,1,1,0
IL,ZA,2010.0,2,4,-2
DE,KW,2012.0,4,1,3
SE,TW,2021.0,5,5,0
TH,SG,2023.0,1,1,0
MY,FI,2021.0,3,2,1
GB,WS,2017.0,1,1,0
MX,NP,2020.0,1,1,0
IN,BZ,2017.0,1,1,0
IL,RO,2004.0,1,1,0
MX,ZW,2014.0,1,3,-2
nan,GH,2012.0,2,2,0
IT,EE,2021.0,5,5,0
CN,CO,2013.0,1,5,-4
IT,ID,2007.0,3,1,2
IL,AT,2018.0,4,3,1
SN,PK,2016.0,1,1,0
DZ,CH,2020.0,2,2,0
OM,IR,2022.0,2,10,-8
SA,KE,2019.0,1,1,0
JP,PH,1998.0,4,8,-4
IS,QA,2018.0,1,1,0
PA,CR,2014.0,1,2,-1
SD,NG,2000.0,1,1,0
KZ,FR,2015.0,1,2,-1
EG,BR,2012.0,2,3,-1
CH,GH,2019.0,2,2,0
KE,ML,2017.0,3,2,1
RU,EE,2014.0,4,3,1
QA,RS,2016.0,2,2,0
CM,SN,2013.0,1,2,-1
KR,KZ,2020.0,2,2,0
ZW,JP,2021.0,1,1,0
VN,BA,2020.0,1,1,0
PT,CZ,2012.0,2,5,-3
IS,BE,2015.0,1,2,-1
CN,HK,2000.0,2,3,-1
FI,KE,2020.0,1,2,-1
SK,KR,2011.0,1,2,-1
GB,NA,2003.0,1,2,-1
MA,KW,2018.0,2,8,-6
CN,TH,2023.0,6,2,4
ML,US,1998.0,2,2,0
SG,BD,2022.0,2,1,1
AR,BD,2019.0,1,1,0
TW,SA,2021.0,2,4,-2
TH,IN,2000.0,1,3,-2
BR,JO,2018.0,2,2,0
BE,BD,2014.0,2,3,-1
SK,PT,2018.0,1,2,-1
FJ,US,2006.0,4,3,1
FR,GH,2020.0,2,4,-2
TH,LA,2012.0,1,2,-1
RE,US,2012.0,2,4,-2
AZ,IT,2022.0,4,7,-3
AE,TN,2014.0,2,4,-2
BO,GB,2021.0,1,1,0
UA,BR,2000.0,3,2,1
NL,EE,2008.0,1,1,0
JO,AT,2015.0,1,1,0
HT,ES,2013.0,1,1,0
PH,BR,2022.0,3,6,-3
ES,SD,2019.0,2,1,1
CN,KN,2021.0,1,1,0
NE,BE,2017.0,2,1,1
FR,MT,2020.0,2,2,0
CM,CH,2019.0,5,5,0
BY,PT,2008.0,3,1,2
TN,LB,2021.0,1,2,-1
GH,GB,2012.0,5,22,-17
IS,DE,2012.0,2,14,-12
IL,IS,2014.0,1,1,0
LT,NL,2014.0,2,1,1
AE,ID,2014.0,2,1,1
NP,GB,2007.0,5,5,0
LK,OM,2018.0,1,1,0
SK,GR,2020.0,1,1,0
RO,FI,2008.0,1,2,-1
MX,SY,2012.0,1,1,0
PE,HN,2016.0,3,3,0
US,PG,2006.0,1,1,0
CI,BJ,2017.0,1,2,-1
US,AZ,2018.0,1,2,-1
GN,SN,2008.0,1,1,0
EG,PL,2016.0,2,3,-1
GR,LK,2018.0,2,5,-3
NZ,EG,2022.0,1,1,0
HR,PL,2004.0,1,2,-1
FR,BY,2010.0,1,3,-2
MX,GR,2005.0,1,2,-1
MK,HR,2007.0,1,1,0
KE,ML,2010.0,1,1,0
US,CI,2000.0,1,1,0
ZA,US,2014.0,367,405,-38
AR,nan,2013.0,38,51,-13
SA,CA,2017.0,68,134,-66
BF,FR,2005.0,7,6,1
FR,AU,2020.0,139,112,27
AU,NZ,1999.0,56,62,-6
VN,KR,2015.0,35,59,-24
MX,CR,2016.0,49,35,14
IR,CA,2022.0,245,96,149
CN,CA,2018.0,488,613,-125
ES,BR,2021.0,278,304,-26
RU,GB,2011.0,65,95,-30
NL,BE,1998.0,106,78,28
LV,EE,2022.0,2,2,0
PL,CZ,2020.0,97,78,19
JP,SE,2022.0,19,21,-2
ZA,BE,2021.0,20,14,6
AU,CA,1997.0,76,103,-27
NO,FR,1999.0,27,12,15
JP,TH,2018.0,119,68,51
CN,TR,2011.0,128,18,110
BE,CN,2007.0,50,32,18
TR,AU,2005.0,4,8,-4
DE,IN,2007.0,89,143,-54
TH,JP,2022.0,22,42,-20
MD,UA,2017.0,2,1,1
DK,AT,2015.0,18,28,-10
CN,SI,2013.0,4,5,-1
AU,BD,2015.0,57,66,-9
CH,CN,2010.0,68,57,11
IT,MX,2015.0,42,46,-4
LT,US,2018.0,11,14,-3
AU,NO,2005.0,13,5,8
IL,AU,2019.0,29,18,11
EG,DE,2022.0,36,44,-8
HN,CO,2015.0,5,7,-2
IN,BE,2015.0,35,37,-2
CN,ZA,2022.0,9,13,-4
IN,NZ,2020.0,42,31,11
CH,CN,2017.0,86,76,10
JP,BD,2018.0,72,77,-5
BR,MX,2015.0,125,139,-14
GH,TG,2019.0,2,1,1
DE,RU,2016.0,172,183,-11
IL,ES,2007.0,9,7,2
HU,JP,1997.0,13,8,5
VE,MX,1999.0,18,4,14
QA,GB,2015.0,18,41,-23
GB,LK,2007.0,24,8,16
SE,BE,2012.0,25,32,-7
MY,JO,2008.0,6,1,5
PE,BR,2017.0,73,62,11
US,TZ,2016.0,27,28,-1
nan,MX,2008.0,17,11,6
RU,AU,2008.0,19,9,10
QA,ES,2013.0,5,10,-5
CA,CL,2013.0,23,15,8
CA,JO,2006.0,4,4,0
IL,CA,2012.0,61,60,1
CA,PT,2002.0,9,6,3
IT,BG,2019.0,10,8,2
PT,MY,2009.0,5,3,2
BE,SE,2014.0,27,25,2
UA,US,2000.0,29,20,9
QA,EG,2000.0,2,2,0
IN,AR,2020.0,7,2,5
CA,TW,2018.0,27,50,-23
LT,JP,2007.0,11,10,1
GH,AU,2014.0,4,7,-3
JP,MN,2010.0,5,2,3
MK,BG,2016.0,8,5,3
RO,BE,2021.0,11,10,1
GB,NO,2000.0,23,27,-4
FR,PF,2020.0,8,12,-4
CY,US,2004.0,11,22,-11
BG,CZ,2008.0,2,4,-2
TR,AZ,2010.0,9,7,2
RU,CL,2007.0,5,6,-1
GB,IL,2008.0,30,51,-21
UA,SE,2009.0,6,5,1
CU,CH,2018.0,2,1,1
TZ,KE,2019.0,13,12,1
AU,TR,2013.0,9,5,4
IR,AE,2011.0,4,1,3
CH,TR,2020.0,27,29,-2
IT,LB,2010.0,10,8,2
AM,KR,2014.0,2,2,0
DE,NO,1999.0,17,8,9
US,NP,2000.0,10,2,8
PT,CN,2013.0,11,12,-1
PT,AT,2005.0,6,1,5
PR,ET,2018.0,14,3,11
AT,DK,2004.0,4,5,-1
TR,FI,2015.0,8,7,1
AT,PK,2008.0,4,4,0
ET,RU,2017.0,5,9,-4
AR,JP,2011.0,7,5,2
ZA,SN,2017.0,2,3,-1
FR,GF,2003.0,6,2,4
UY,CU,2003.0,1,2,-1
CY,TR,2007.0,6,5,1
MX,VN,2021.0,9,9,0
US,LT,2017.0,8,13,-5
MA,SA,2010.0,3,1,2
NG,CH,2022.0,4,2,2
FI,TW,2012.0,2,4,-2
CN,CY,2013.0,2,1,1
ZA,MY,2016.0,6,4,2
CM,CH,2017.0,6,1,5
AM,RU,2007.0,10,5,5
NL,AT,2000.0,5,14,-9
SA,MA,2016.0,3,4,-1
VE,DE,2005.0,6,3,3
ES,TH,2012.0,1,1,0
BR,MZ,2012.0,8,5,3
HU,TW,2022.0,1,1,0
MX,IL,2007.0,2,3,-1
TW,PL,1999.0,4,2,2
LU,CH,2009.0,3,8,-5
AE,BG,2016.0,1,1,0
EG,CM,2021.0,1,3,-2
BJ,NL,2019.0,1,1,0
GT,US,2015.0,15,15,0
IN,GD,2013.0,3,1,2
FR,SA,2009.0,6,6,0
CN,LT,2000.0,3,2,1
GH,PH,2018.0,1,1,0
CH,TW,2006.0,5,5,0
AT,ZA,2000.0,2,1,1
BR,KR,2015.0,4,9,-5
BR,EG,2008.0,2,1,1
KZ,US,2008.0,5,3,2
UA,TW,2008.0,3,1,2
FI,RU,2008.0,15,20,-5
TZ,NL,2020.0,3,1,2
BG,NL,2003.0,4,4,0
MD,UA,2010.0,4,1,3
TN,RU,2021.0,1,2,-1
KR,CL,2015.0,2,1,1
LK,NL,1998.0,1,2,-1
IR,ET,2017.0,1,2,-1
DK,GW,2007.0,2,3,-1
RO,SE,1999.0,2,2,0
FI,CZ,1999.0,1,2,-1
EE,ZA,2016.0,1,1,0
KE,ML,2019.0,4,2,2
FR,BA,2017.0,1,2,-1
BR,MT,2020.0,2,1,1
AU,SG,2023.0,5,7,-2
UZ,KZ,2010.0,4,3,1
KG,JP,2016.0,1,1,0
QA,SI,2014.0,2,2,0
FR,ET,2009.0,2,2,0
KW,MA,2019.0,3,7,-4
UZ,DE,2006.0,4,2,2
ZM,ZA,2016.0,6,13,-7
AM,IT,2005.0,3,17,-14
ET,ES,2012.0,2,1,1
CM,CH,2010.0,1,2,-1
NO,TR,2009.0,2,2,0
SN,GN,2009.0,1,1,0
NL,CA,2015.0,96,82,14
CN,KP,2021.0,7,5,2
IQ,SA,2017.0,14,35,-21
ET,UG,2021.0,2,2,0
JP,IL,2003.0,13,13,0
KE,NG,2004.0,1,1,0
PE,IT,2013.0,5,4,1
GT,MX,2022.0,7,16,-9
JP,MN,2017.0,10,3,7
AU,NO,2002.0,4,7,-3
DK,BY,1999.0,2,1,1
IQ,SA,2010.0,1,2,-1
IN,MA,2019.0,2,5,-3
CA,DE,2001.0,123,134,-11
,GB,1994.0,56481,0,56481
JP,,2024.0,125586,0,125586
ES,,2023.0,54176,0,54176
,SG,2002.0,1248,0,1248
BR,,2012.0,4534,0,4534
IL,,2019.0,2449,0,2449
IT,,2023.0,49530,0,49530
,PT,2008.0,1648,0,1648
,AW,2008.0,1,0,1
CH,,2018.0,3901,0,3901
CA,,2007.0,3132,0,3132
FR,,2014.0,9484,0,9484
,AU,2010.0,7041,0,7041
,SG,2005.0,1094,0,1094
GB,,2025.0,9630,0,9630
,IL,1999.0,2135,0,2135
,AU,2017.0,6529,0,6529
,CO,2009.0,2419,0,2419
RS,,2018.0,810,0,810
,RU,2000.0,7922,0,7922
,MY,2001.0,675,0,675
,SK,2011.0,1219,0,1219
TW,,2004.0,734,0,734
,GR,1997.0,1759,0,1759
IL,,2010.0,1274,0,1274
ES,SV,2003.0,2,0,2
IQ,,2021.0,930,0,930
,PH,2007.0,440,0,440
CZ,LV,2010.0,2,0,2
,AU,2019.0,3966,0,3966
CY,,2024.0,1647,0,1647
UA,,2018.0,1910,0,1910
EG,,2025.0,1215,0,1215
,RO,2005.0,1388,0,1388
OM,,2017.0,152,0,152
PL,,2012.0,1609,0,1609
,QA,1994.0,61,0,61
IL,,2017.0,1917,0,1917
,PA,2006.0,48,0,48
,NO,2018.0,1437,0,1437
,MD,2014.0,91,0,91
,SZ,1996.0,7,0,7
NO,,2014.0,980,0,980
HU,,2015.0,817,0,817
,LV,1995.0,200,0,200
,RO,2002.0,672,0,672
,OM,2003.0,78,0,78
,GR,1998.0,1876,0,1876
,ID,1999.0,522,0,522
,DO,2017.0,66,0,66
GN,,2018.0,6,0,6
ET,,2025.0,433,0,433
BN,,2020.0,32,0,32
MX,,2004.0,429,0,429
CY,AE,2001.0,1,0,1
,FJ,2006.0,16,0,16
HN,,2015.0,12,0,12
,UG,2011.0,323,0,323
NG,,2012.0,362,0,362
OM,,2019.0,159,0,159
,AZ,2008.0,174,0,174
,CU,2018.0,361,0,361
CL,,2004.0,161,0,161
PR,,2010.0,5,0,5
,CI,2013.0,263,0,263
,AM,1997.0,108,0,108
PR,,2019.0,18,0,18
BJ,,2019.0,88,0,88
BB,,2020.0,14,0,14
BY,,2006.0,142,0,142
PT,,2000.0,89,0,89
,CZ,2018.0,1544,0,1544
,BF,2019.0,44,0,44
LA,,2024.0,111,0,111
VE,,2016.0,296,0,296
,BF,2010.0,120,0,120
,HR,2000.0,556,0,556
CD,,2012.0,14,0,14
ID,LT,2020.0,2,0,2
,AL,2005.0,45,0,45
,AM,1998.0,187,0,187
,SN,1994.0,125,0,125
LU,,2016.0,107,0,107
CI,,2021.0,365,0,365
UG,,2020.0,232,0,232
QA,CZ,2005.0,1,0,1
ES,PR,2004.0,2,0,2
OM,,2010.0,36,0,36
MR,,2007.0,2,0,2
BJ,,2017.0,55,0,55
,MZ,2007.0,55,0,55
NP,,2018.0,171,0,171
,BN,1995.0,18,0,18
,VG,1998.0,19,0,19
,LB,2000.0,146,0,146
,GE,2006.0,173,0,173
NL,BF,2022.0,2,0,2
GR,FI,2014.0,8,0,8
IL,MD,2020.0,1,0,1
,BI,2015.0,29,0,29
BN,GB,2003.0,4,0,4
CO,PH,2009.0,1,0,1
,PS,2018.0,150,0,150
,BF,2017.0,81,0,81
,MN,2018.0,64,0,64
PE,KR,2014.0,1,0,1
,GN,2017.0,26,0,26
IN,EE,2020.0,11,0,11
DK,LV,2021.0,3,0,3
,JM,2006.0,54,0,54
,BB,2019.0,5,0,5
RE,,2017.0,26,0,26
,KW,2008.0,149,0,149
NL,AE,2004.0,3,0,3
MC,,2019.0,22,0,22
TR,PE,2019.0,3,0,3
,BB,2017.0,6,0,6
AU,MW,2016.0,1,0,1
PY,,2015.0,10,0,10
,GD,2009.0,18,0,18
PR,,2017.0,12,0,12
,GN,2010.0,10,0,10
,LR,2014.0,16,0,16
,BZ,2010.0,1,0,1
TN,NO,2013.0,1,0,1
UG,PT,2014.0,1,0,1
CR,,2001.0,9,0,9
DK,DZ,2012.0,1,0,1
BJ,,2010.0,7,0,7
SA,TH,2022.0,2,0,2
,PG,2013.0,25,0,25
BE,PY,2014.0,1,0,1
GH,HU,2021.0,2,0,2
KR,ES,2023.0,4,0,4
KW,SD,2012.0,1,0,1
,RE,2015.0,29,0,29
BH,,2003.0,12,0,12
RE,,2019.0,36,0,36
KW,MA,2017.0,8,0,8
,DO,2010.0,17,0,17
PA,KR,2022.0,1,0,1
,DO,2019.0,11,0,11
SD,KE,2016.0,1,0,1
MY,,2026.0,9,0,9
DJ,,2022.0,4,0,4
RW,PK,2017.0,1,0,1
GH,,2009.0,29,0,29
KZ,AT,2018.0,1,0,1
BI,,2020.0,24,0,24
VG,NL,2014.0,2,0,2
HR,CN,2020.0,5,0,5
BG,KZ,2013.0,1,0,1
ID,NZ,2008.0,1,0,1
IL,AE,2010.0,1,0,1
TG,NE,2016.0,3,0,3
SS,PK,2020.0,1,0,1
MC,,2017.0,17,0,17
PL,LV,2022.0,2,0,2
,AL,2002.0,13,0,13
PL,IL,2023.0,1,0,1
EE,PL,2021.0,4,0,4
PH,PL,2004.0,4,0,4
FI,TZ,2006.0,1,0,1
KW,,2000.0,33,0,33
TH,ID,2009.0,5,0,5
LK,,2006.0,42,0,42
ZM,,2006.0,5,0,5
AU,BG,2020.0,2,0,2
BW,AU,2006.0,3,0,3
ME,,2018.0,24,0,24
PT,SV,2016.0,2,0,2
BO,,2015.0,30,0,30
MM,NL,2015.0,1,0,1
NL,CO,2005.0,5,0,5
KG,RU,2011.0,2,0,2
ZA,MQ,1998.0,1,0,1
SJ,,2021.0,4,0,4
IN,HK,2013.0,1,0,1
JM,ES,2015.0,1,0,1
LB,TN,2002.0,1,0,1
BR,BO,2005.0,2,0,2
FR,RS,1999.0,2,0,2
AU,NA,2017.0,1,0,1
MM,PL,2020.0,2,0,2
PH,CU,2002.0,1,0,1
ES,PS,2000.0,3,0,3
SY,KE,2015.0,1,0,1
MQ,,2000.0,3,0,3
IL,OM,2020.0,1,0,1
BA,CH,2013.0,2,0,2
,MU,2013.0,38,0,38
BD,,1999.0,32,0,32
,BH,1997.0,38,0,38
DZ,,2008.0,60,0,60
MZ,CN,2004.0,1,0,1
UA,PT,2009.0,3,0,3
SK,IL,2020.0,3,0,3
CO,PL,2021.0,2,0,2
AM,LT,2016.0,1,0,1
GR,JO,2014.0,1,0,1
CI,BI,2020.0,1,0,1
BH,ZA,2014.0,1,0,1
SX,,2023.0,8,0,8
GF,CH,2018.0,2,0,2
ET,PK,2011.0,1,0,1
,GA,1997.0,14,0,14
TR,ET,2003.0,2,0,2
NE,ET,2008.0,1,0,1
TT,,2004.0,12,0,12
IN,ZM,2004.0,1,0,1
,BH,1998.0,19,0,19
PT,PK,2015.0,1,0,1
,NC,2007.0,13,0,13
PH,AR,2008.0,2,0,2
PS,FI,2020.0,1,0,1
MZ,,2005.0,3,0,3
MT,BR,2012.0,3,0,3
MN,,2025.0,7,0,7
GL,ZA,2020.0,1,0,1
,TT,2008.0,26,0,26
,BB,2010.0,8,0,8
SY,PK,2018.0,2,0,2
DK,SD,2020.0,1,0,1
SI,PT,2005.0,1,0,1
MT,DE,2022.0,2,0,2
RS,RO,1999.0,2,0,2
IT,AE,2002.0,2,0,2
CR,IL,2017.0,2,0,2
ZA,AE,2016.0,4,0,4
BE,TZ,2017.0,3,0,3
NL,ZW,2008.0,3,0,3
CW,IE,2005.0,1,0,1
NZ,AR,2004.0,2,0,2
NZ,SA,2008.0,3,0,3
AT,ET,2012.0,3,0,3
ES,LV,2012.0,1,0,1
,FO,2009.0,5,0,5
AU,SL,2021.0,1,0,1
ES,CG,2018.0,1,0,1
HR,VE,2017.0,1,0,1
BE,KE,2013.0,4,0,4
UA,KR,1999.0,1,0,1
LI,,2005.0,2,0,2
FJ,,2013.0,6,0,6
SE,AM,2005.0,1,0,1
IT,AZ,2001.0,1,0,1
IN,PE,2002.0,1,0,1
CY,RU,2021.0,3,0,3
UA,BI,2017.0,1,0,1
,CG,2006.0,12,0,12
,SZ,2004.0,4,0,4
AO,CL,2020.0,1,0,1
CU,BE,2009.0,3,0,3
GA,CM,2007.0,1,0,1
SS,,2015.0,8,0,8
KR,LU,2016.0,3,0,3
US,GP,2016.0,2,0,2
MC,,2010.0,5,0,5
SD,MM,2019.0,1,0,1
RU,LT,2003.0,13,0,13
UA,AE,2007.0,1,0,1
ZW,SZ,2009.0,2,0,2
MM,PK,2021.0,1,0,1
RE,CR,2021.0,1,0,1
AM,nan,2017.0,2,0,2
DZ,MY,2008.0,1,0,1
CF,,2014.0,5,0,5
IN,CL,2012.0,3,0,3
BE,ID,2010.0,4,0,4
NL,MW,2007.0,2,0,2
LV,HU,2020.0,1,0,1
BG,CH,2006.0,4,0,4
CU,ET,2020.0,1,0,1
AM,GB,1998.0,2,0,2
YE,,1998.0,1,0,1
FI,UY,2021.0,2,0,2
,GA,1998.0,10,0,10
nan,MD,1999.0,1,0,1
BF,UG,2019.0,1,0,1
NI,US,1998.0,1,0,1
,VG,1997.0,11,0,11
ZA,KR,2009.0,2,0,2
UG,DE,2005.0,2,0,2
JO,KW,2002.0,1,0,1
,TL,2015.0,4,0,4
TW,KZ,2021.0,1,0,1
AZ,CN,2020.0,3,0,3
,PF,2012.0,16,0,16
SA,LV,2017.0,1,0,1
nan,BY,2015.0,1,0,1
NI,CA,1998.0,1,0,1
CM,ZW,2010.0,1,0,1
HN,VE,2005.0,2,0,2
CU,NL,2020.0,4,0,4
,BZ,2019.0,2,0,2
LY,KW,2020.0,1,0,1
NZ,IS,2004.0,1,0,1
AM,IR,2020.0,2,0,2
BJ,PE,2019.0,1,0,1
IN,FI,1998.0,2,0,2
CN,PE,2000.0,1,0,1
SA,SE,2004.0,1,0,1
SA,DK,2009.0,1,0,1
MS,,2024.0,4,0,4
VE,PH,2009.0,2,0,2
CH,BD,2002.0,1,0,1
KZ,BY,2000.0,1,0,1
BG,BA,2010.0,1,0,1
LS,KE,2021.0,1,0,1
SV,CL,2011.0,1,0,1
CY,SA,2017.0,1,0,1
CU,AT,2009.0,2,0,2
nan,MC,2006.0,3,0,3
IN,RS,2006.0,3,0,3
NL,BW,2011.0,1,0,1
GR,NZ,2014.0,3,0,3
CZ,SA,2021.0,2,0,2
FI,HR,2020.0,2,0,2
,FM,1994.0,1,0,1
FR,QA,2007.0,2,0,2
ZW,OM,2019.0,1,0,1
HK,,2000.0,5,0,5
FR,HT,2006.0,3,0,3
RS,EE,2020.0,1,0,1
SN,IT,2011.0,1,0,1
BE,GH,2015.0,2,0,2
,GB,2021.0,1,0,1
PH,CO,2002.0,1,0,1
SI,AR,2008.0,1,0,1
MX,AM,2020.0,1,0,1
CH,BD,2005.0,1,0,1
,MM,1994.0,9,0,9
GE,CN,2000.0,1,0,1
DE,AZ,2013.0,1,0,1
JM,PK,2018.0,1,0,1
BA,IQ,2022.0,3,0,3
IE,VE,2013.0,2,0,2
CG,ZW,2020.0,1,0,1
BG,BY,2003.0,1,0,1
CZ,KW,2001.0,2,0,2
BT,,2013.0,1,0,1
BJ,GR,2020.0,3,0,3
LT,BR,2006.0,1,0,1
JP,MA,2013.0,1,0,1
AM,MA,2010.0,1,0,1
SA,FI,2021.0,4,0,4
BE,BO,2015.0,2,0,2
UY,AU,2002.0,1,0,1
LA,TH,2022.0,2,0,2
NZ,GE,2012.0,1,0,1
CA,SI,2001.0,1,0,1
,TD,2009.0,4,0,4
MT,GB,2004.0,2,0,2
BJ,ML,2016.0,3,0,3
UA,CY,2021.0,1,0,1
ET,CI,2022.0,1,0,1
SE,BA,2017.0,1,0,1
UZ,AL,2019.0,1,0,1
PE,SV,1998.0,1,0,1
KN,CL,2016.0,2,0,2
PT,SD,2014.0,1,0,1
CA,TT,2001.0,1,0,1
LK,NL,1997.0,1,0,1
GB,PA,2007.0,2,0,2
TZ,NZ,2017.0,1,0,1
UA,TN,2018.0,1,0,1
MZ,nan,1999.0,1,0,1
MU,IN,2005.0,1,0,1
CH,CY,2023.0,1,0,1
GP,IT,2016.0,1,0,1
BY,CN,2005.0,1,0,1
MZ,RW,2017.0,1,0,1
PY,JP,2011.0,2,0,2
IN,MA,2010.0,1,0,1
ID,VN,2013.0,2,0,2
PL,PS,2016.0,1,0,1
MZ,,2002.0,5,0,5
GB,BJ,2011.0,4,0,4
EG,CY,2016.0,1,0,1
CH,GM,2018.0,2,0,2
NO,AM,2019.0,1,0,1
BG,CN,2003.0,3,0,3
UZ,MX,2022.0,2,0,2
,BM,2008.0,3,0,3
CI,GF,2008.0,1,0,1
RW,FR,2021.0,1,0,1
ID,JM,2019.0,1,0,1
MY,IS,2022.0,1,0,1
LB,LY,2021.0,1,0,1
AZ,TM,2014.0,1,0,1
TH,AM,2007.0,1,0,1
KH,NL,2003.0,8,0,8
SI,BG,2013.0,1,0,1
BE,GE,2002.0,1,0,1
,BS,2009.0,6,0,6
CI,KE,2016.0,4,0,4
TT,GH,2008.0,1,0,1
CA,AZ,2002.0,1,0,1
IL,ET,2012.0,1,0,1
KE,TH,2001.0,1,0,1
LY,CA,2016.0,2,0,2
FI,AR,2007.0,1,0,1
LK,CI,2012.0,1,0,1
CO,NO,2011.0,3,0,3
AU,LR,2018.0,1,0,1
LT,TR,2008.0,1,0,1
VE,SV,2019.0,2,0,2
LT,IT,2009.0,2,0,2
MX,GE,2018.0,2,0,2
MD,IT,2002.0,1,0,1
NO,AG,2020.0,1,0,1
LU,SA,2008.0,1,0,1
CH,VN,1997.0,1,0,1
SE,GT,2020.0,1,0,1
FJ,PG,2017.0,1,0,1
NI,MX,2007.0,3,0,3
PS,CA,2004.0,1,0,1
AL,,2003.0,5,0,5
AZ,GE,2014.0,2,0,2
FR,OM,2012.0,2,0,2
MK,LK,2016.0,1,0,1
CA,ZW,2011.0,1,0,1
DE,KG,2022.0,2,0,2
RS,SA,2014.0,1,0,1
RO,KW,1997.0,2,0,2
CW,,2005.0,2,0,2
PK,NZ,2005.0,1,0,1
NZ,QA,2011.0,2,0,2
IN,AM,2007.0,1,0,1
NG,LS,2017.0,1,0,1
GF,KH,2003.0,2,0,2
RU,MK,2011.0,2,0,2
RE,,2010.0,5,0,5
BR,ME,2014.0,2,0,2
PL,AE,1998.0,1,0,1
NO,LV,2006.0,1,0,1
BE,JM,2008.0,1,0,1
MY,QA,2006.0,1,0,1
GE,IT,2003.0,2,0,2
IL,PE,2013.0,1,0,1
GB,ME,2020.0,1,0,1
SD,MW,1999.0,1,0,1
IQ,GH,2014.0,1,0,1
RS,KW,2013.0,3,0,3
,GN,2019.0,6,0,6
KZ,IT,2012.0,2,0,2
AZ,LV,2019.0,1,0,1
IL,TN,2013.0,1,0,1
NG,GA,2019.0,1,0,1
GB,EC,2012.0,1,0,1
NG,MX,2016.0,2,0,2
MX,LB,2014.0,1,0,1
BD,NL,2000.0,1,0,1
GN,MA,2018.0,1,0,1
CH,MT,2010.0,1,0,1
RU,KH,2014.0,2,0,2
FR,SV,1999.0,1,0,1
PT,SI,2002.0,1,0,1
SN,MQ,1998.0,1,0,1
UG,EG,2015.0,1,0,1
GB,IQ,2000.0,1,0,1
NG,SE,2011.0,2,0,2
JM,UG,2019.0,1,0,1
GA,CG,2014.0,1,0,1
BH,FR,2019.0,1,0,1
GT,BE,2009.0,1,0,1
GN,MR,2013.0,1,0,1
JP,KG,2022.0,1,0,1
LI,,2002.0,3,0,3
GB,AD,2019.0,1,0,1
BI,PH,2021.0,1,0,1
BY,SI,2000.0,1,0,1
NL,AW,2017.0,1,0,1
BR,OM,2020.0,1,0,1
KE,NE,2014.0,1,0,1
SI,NO,2010.0,1,0,1
CH,TG,2018.0,1,0,1
US,PF,2018.0,1,0,1
CA,AZ,2005.0,1,0,1
CN,LY,2008.0,1,0,1
,BT,2007.0,4,0,4
CA,GP,2010.0,1,0,1
CH,GF,2003.0,1,0,1
CM,ML,2006.0,1,0,1
nan,EC,2004.0,1,0,1
MV,PF,2019.0,1,0,1
GB,LA,1999.0,2,0,2
DO,NL,1998.0,1,0,1
CO,NG,2014.0,1,0,1
MX,BO,2001.0,4,0,4
PE,JP,2006.0,2,0,2
SD,PH,2002.0,1,0,1
FR,BH,1999.0,1,0,1
LY,HU,1999.0,3,0,3
VN,LV,2019.0,1,0,1
CW,AT,2008.0,1,0,1
PE,KE,2015.0,2,0,2
IE,TT,2015.0,1,0,1
RU,SZ,1997.0,1,0,1
BY,BG,2017.0,1,0,1
SD,IN,2011.0,1,0,1
IR,MA,2023.0,1,0,1
PL,VI,2015.0,2,0,2
EE,AU,1997.0,1,0,1
HT,FR,2009.0,1,0,1
NP,BW,2018.0,1,0,1
MD,UA,2019.0,3,0,3
PH,NO,2006.0,3,0,3
KR,PK,1999.0,2,0,2
FR,IS,2003.0,1,0,1
CH,OM,2001.0,1,0,1
EG,AR,2021.0,1,0,1
CO,TL,2018.0,1,0,1
CA,CG,2020.0,1,0,1
CO,ZA,2004.0,1,0,1
CY,UG,2013.0,1,0,1
PT,AE,2023.0,1,0,1
SG,PS,2018.0,1,0,1
MD,KR,2010.0,1,0,1
nan,AE,2012.0,2,0,2
CU,LB,2016.0,3,0,3
TJ,UA,2018.0,1,0,1
HU,BY,2000.0,4,0,4
KW,RO,2007.0,1,0,1
RO,KW,1998.0,1,0,1
CA,SD,2013.0,3,0,3
UA,SG,1998.0,1,0,1
UZ,RS,2014.0,2,0,2
EE,JP,2018.0,2,0,2
KZ,EG,2023.0,1,0,1
ZM,KE,2012.0,1,0,1
CW,BE,2003.0,2,0,2
BM,,2009.0,3,0,3
nan,EG,2008.0,1,0,1
CZ,IR,2006.0,1,0,1
IN,QA,1998.0,1,0,1
AT,SN,1999.0,1,0,1
GB,FO,2018.0,3,0,3
SN,MD,2003.0,2,0,2
IS,SG,2007.0,1,0,1
KE,SG,2020.0,1,0,1
TJ,BY,2020.0,1,0,1
IE,LV,2008.0,2,0,2
RW,TR,2013.0,1,0,1
CN,MA,2003.0,1,0,1
BT,CH,2017.0,1,0,1
SI,EG,2016.0,2,0,2
FI,MW,2011.0,1,0,1
CA,LU,2000.0,2,0,2
SG,QA,2012.0,3,0,3
MC,IT,2003.0,1,0,1
JM,nan,1997.0,1,0,1
CI,TG,2012.0,1,0,1
NI,CL,2004.0,1,0,1
IT,BJ,2016.0,1,0,1
JP,BF,2011.0,1,0,1
CY,SA,2010.0,1,0,1
WS,GB,2008.0,1,0,1
MS,NZ,2009.0,1,0,1
BR,AE,1999.0,1,0,1
CI,MK,2013.0,1,0,1
NL,BJ,2004.0,1,0,1
DZ,PT,1999.0,1,0,1
IL,QA,2021.0,1,0,1
RW,CA,2016.0,1,0,1
DK,BG,2016.0,1,0,1
PL,CO,2009.0,1,0,1
NL,SR,2011.0,1,0,1
,ER,1999.0,2,0,2
IR,MY,1998.0,1,0,1
JO,ID,2016.0,4,0,4
LS,BW,2015.0,1,0,1
KW,IQ,2013.0,1,0,1
ES,SY,2015.0,1,0,1
SG,EG,2012.0,1,0,1
SY,MY,2023.0,1,0,1
PK,SE,2003.0,2,0,2
AE,MT,2020.0,1,0,1
PE,nan,2002.0,2,0,2
DE,YE,2007.0,1,0,1
PF,GB,2007.0,1,0,1
KR,HU,2013.0,1,0,1
OM,LK,2021.0,1,0,1
HR,CA,2013.0,3,2,1
CO,MY,2015.0,2,3,-1
CA,BG,2000.0,2,2,0
EG,HU,2015.0,1,3,-2
TW,IL,2001.0,1,2,-1
GB,CU,2000.0,1,2,-1
IT,RS,2005.0,2,1,1
CR,VE,2014.0,2,3,-1
MX,HU,2011.0,1,2,-1
BD,IL,2014.0,2,1,1
CY,NG,2018.0,1,3,-2
US,LY,2012.0,1,2,-1
BO,CR,2014.0,2,3,-1
PK,BR,2022.0,3,3,0
BF,GB,2015.0,2,1,1
NL,HR,2005.0,3,3,0
JP,SI,2016.0,1,1,0
MZ,GB,2001.0,1,1,0
SK,SE,2006.0,1,4,-3
GR,AT,2003.0,1,3,-2
FI,MY,2017.0,1,4,-3
GB,GE,2012.0,3,7,-4
CN,AT,2008.0,6,13,-7
CD,FR,2020.0,2,3,-1
RW,IN,2022.0,3,9,-6
IT,RS,2002.0,2,2,0
TR,PE,2017.0,1,1,0
FI,MY,2019.0,1,4,-3
MY,EG,2004.0,2,4,-2
KW,OM,2019.0,2,1,1
US,TN,2000.0,3,4,-1
KH,AU,2011.0,1,2,-1
NG,CA,2001.0,1,1,0
AU,PA,2013.0,1,1,0
RO,GR,2018.0,3,4,-1
US,SV,2021.0,1,5,-4
BM,US,2004.0,2,1,1
CA,VE,2007.0,3,5,-2
MW,NL,2022.0,2,1,1
CZ,NG,2015.0,2,1,1
ZA,NP,2017.0,1,1,0
KR,GE,2019.0,2,1,1
KW,JO,2010.0,1,3,-2
PS,FR,2015.0,1,4,-3
CH,VE,2018.0,1,1,0
BT,US,2015.0,1,1,0
OM,SE,2008.0,1,1,0
NE,TG,2017.0,1,1,0
MA,ET,2022.0,1,2,-1
CN,AO,2007.0,1,1,0
NG,UG,2012.0,1,3,-2
AF,ID,2015.0,1,2,-1
GT,FR,2011.0,1,1,0
SG,IR,2008.0,2,13,-11
KE,MW,2021.0,1,3,-2
GB,VG,2003.0,1,3,-2
GA,CO,2012.0,1,1,0
DZ,BE,2009.0,1,2,-1
TH,PH,2017.0,1,3,-2
SD,IQ,2013.0,2,1,1
IR,HU,2011.0,2,1,1
CO,SI,2019.0,1,1,0
SI,NO,2017.0,1,1,0
BO,DE,2011.0,2,2,0
LT,UA,2020.0,1,4,-3
EE,CA,2014.0,3,5,-2
RO,BG,2008.0,1,2,-1
GR,RO,2016.0,2,4,-2
CA,LK,2001.0,2,2,0
DK,TZ,2018.0,1,1,0
NG,DK,2008.0,1,2,-1
KR,PL,2002.0,1,3,-2
EE,CN,2013.0,1,2,-1
PE,AT,2020.0,1,2,-1
NP,NO,2005.0,1,2,-1
BB,GB,2012.0,3,6,-3
MZ,LT,2007.0,2,6,-4
AE,FR,2005.0,1,4,-3
CA,UA,2003.0,2,1,1
CR,IL,2019.0,1,4,-3
BY,UA,2006.0,2,4,-2
TT,US,2005.0,1,6,-5
BR,BD,2017.0,2,4,-2
LU,KR,2012.0,1,1,0
AZ,DK,2014.0,1,1,0
KZ,DE,2020.0,4,5,-1
TZ,BE,2020.0,1,1,0
CH,JO,2018.0,2,1,1
MA,CH,2020.0,2,3,-1
NP,DK,2016.0,1,3,-2
AT,SG,2010.0,2,4,-2
EG,PT,2021.0,1,4,-3
NL,HR,2002.0,2,2,0
US,MD,2000.0,2,3,-1
NZ,MY,2004.0,2,1,1
PG,US,2012.0,1,4,-3
TR,DK,2023.0,1,1,0
CR,PT,2010.0,1,1,0
NO,KZ,2015.0,1,2,-1
UZ,BY,2018.0,2,1,1
GR,RU,2013.0,1,1,0
GE,nan,2020.0,2,3,-1
MY,VN,2010.0,1,2,-1
BR,HN,2011.0,1,1,0
NP,CH,2002.0,1,1,0
HU,MX,2016.0,2,2,0
BR,HU,2011.0,1,4,-3
KR,SA,2009.0,1,5,-4
FR,LA,2017.0,1,5,-4
IR,JO,2016.0,1,1,0
FI,UA,2019.0,1,6,-5
BJ,IN,2019.0,1,1,0
PS,CN,2018.0,1,1,0
JP,KH,2004.0,2,2,0
PH,PT,2014.0,1,1,0
CO,DO,2008.0,1,1,0
BG,LT,2012.0,1,1,0
nan,LK,2020.0,1,1,0
KR,GE,2010.0,1,1,0
NG,JP,2010.0,3,7,-4
BF,NG,2005.0,1,1,0
NG,nan,2000.0,1,1,0
RU,CY,2015.0,1,2,-1
HR,BE,2022.0,1,2,-1
MX,CZ,1999.0,1,1,0
RS,CA,2021.0,3,9,-6
IT,BY,2002.0,1,1,0
FR,BA,2010.0,1,1,0
GR,SE,1997.0,1,2,-1
IL,UA,2009.0,1,2,-1
CD,NL,2017.0,1,1,0
CI,CH,2015.0,1,1,0
NI,nan,2017.0,2,6,-4
NO,AE,2022.0,1,1,0
HR,RU,2005.0,1,9,-8
CL,PL,2017.0,1,3,-2
FR,UY,2007.0,1,8,-7
EG,MR,2020.0,1,1,0
SE,BW,2013.0,1,1,0
NL,MT,2018.0,1,1,0
MX,SK,2017.0,1,2,-1
MD,CH,2003.0,1,1,0
MX,MY,2017.0,1,5,-4
NL,NP,2022.0,2,2,0
ZA,CN,1999.0,1,4,-3
AU,EE,2010.0,1,3,-2
PL,IR,2021.0,1,17,-16
DJ,FR,2014.0,1,2,-1
IT,LT,2013.0,1,1,0
RU,EC,2012.0,1,3,-2
BJ,GB,2017.0,1,1,0
EG,IT,1998.0,1,4,-3
ES,VN,2013.0,1,2,-1
GB,AZ,2011.0,1,2,-1
CO,KR,2008.0,1,3,-2
ML,IN,2004.0,1,2,-1
JP,IT,2023.0,1,2,-1
NL,TN,2022.0,1,1,0
BO,IR,2012.0,1,1,0
JP,JO,2017.0,1,3,-2
CN,GE,2023.0,1,1,0
PA,AT,2013.0,1,1,0
FR,BY,2019.0,1,1,0
US,JO,2023.0,1,2,-1
HU,DE,2023.0,1,2,-1
VN,IT,2008.0,2,2,0
IQ,DE,2019.0,2,22,-20
DK,RO,2005.0,1,2,-1
ZA,BJ,2020.0,1,1,0
VG,DE,2007.0,1,1,0
RS,PL,2011.0,1,4,-3
CH,MA,2005.0,1,2,-1
NG,NL,2001.0,2,1,1
CN,LU,2018.0,1,2,-1
TT,CA,2012.0,1,1,0
AM,CZ,2013.0,2,1,1
EE,IR,2011.0,1,1,0
CL,CA,1998.0,3,2,1
DE,VE,1998.0,4,1,3
LV,NO,2018.0,1,1,0
PK,QA,2023.0,1,2,-1
GR,IE,1997.0,1,1,0
TH,NO,2022.0,1,2,-1
DK,nan,2000.0,1,4,-3
MM,SG,2010.0,1,2,-1
AR,PA,2009.0,2,7,-5
TZ,CY,2019.0,1,1,0
PS,SA,2011.0,1,1,0
SE,AR,2005.0,1,2,-1
CN,JO,2006.0,1,5,-4
MW,AU,2019.0,1,1,0
GR,IL,2004.0,1,3,-2
RS,KR,2018.0,1,1,0
TN,MD,2001.0,1,1,0
CA,RE,2011.0,1,0,1
RU,KE,2013.0,1,0,1
ZW,IL,2017.0,1,0,1
RU,VE,2002.0,1,0,1
GI,US,2022.0,1,0,1
CH,LB,1998.0,1,0,1
SG,CM,2007.0,1,0,1
GH,DE,2005.0,1,0,1
GB,KH,2006.0,1,0,1
MM,IN,2014.0,1,0,1
ID,AZ,2002.0,2,0,2
CR,BE,2011.0,1,0,1
CA,ER,2019.0,1,0,1
TZ,BI,2016.0,1,0,1
IN,VN,2006.0,1,0,1
FI,NG,1997.0,1,0,1
MD,IT,2005.0,1,0,1
RO,AL,2020.0,1,0,1
CA,MD,1999.0,1,0,1
BE,MZ,2002.0,1,0,1
NL,KZ,2004.0,1,0,1
ET,MR,2018.0,1,0,1
PT,DO,2012.0,1,0,1
NP,IL,2012.0,1,0,1
NO,BY,2022.0,1,0,1
SY,AT,2020.0,1,0,1
UG,TH,2016.0,1,0,1
MY,MU,2017.0,1,0,1
ZM,MM,2012.0,1,0,1
SE,HK,2020.0,2,0,2
IE,LU,2005.0,1,0,1
KR,TH,2023.0,1,0,1
IN,KZ,2016.0,2,0,2
IL,NP,2013.0,1,0,1
NP,QA,2020.0,1,0,1
KE,HR,2012.0,1,0,1
CM,IN,2023.0,1,0,1
CN,GH,2004.0,1,0,1
JO,KW,2005.0,1,0,1
PL,TH,2011.0,1,0,1
LY,SA,2016.0,2,0,2
CW,,2002.0,2,0,2
ZA,TR,2000.0,1,0,1
KW,CO,2014.0,1,0,1
SG,BY,2018.0,1,0,1
US,MN,1997.0,1,0,1
DK,SA,1998.0,1,0,1
AU,NA,2019.0,1,0,1
IR,BD,2008.0,4,0,4
CZ,CL,2006.0,2,0,2
AU,GD,2009.0,2,0,2
NG,XK,2022.0,1,0,1
BI,MA,2018.0,2,0,2
NG,GA,2017.0,1,0,1
LK,EG,2021.0,1,0,1
MX,NI,2003.0,1,0,1
NP,NI,2021.0,1,0,1
SK,TZ,2018.0,1,0,1
BA,ID,2018.0,1,0,1
TR,AE,2001.0,1,0,1
NL,KN,2017.0,1,0,1
NG,HR,2014.0,1,0,1
CH,BJ,2019.0,1,0,1
LT,GR,2013.0,1,0,1
JP,LY,2020.0,1,0,1
ET,LB,2014.0,1,0,1
LY,AE,2008.0,1,0,1
HN,CH,2008.0,1,0,1
XK,FR,2016.0,1,0,1
VN,IE,2001.0,1,0,1
AU,BT,2005.0,1,0,1
JP,JM,2000.0,1,0,1
IL,CZ,1998.0,4,0,4
NP,PT,2017.0,1,0,1
BB,MX,2015.0,1,0,1
BE,ML,2000.0,1,0,1
BJ,IN,2017.0,1,0,1
CI,BJ,2010.0,1,0,1
ZW,ML,2011.0,1,0,1
MQ,US,2022.0,1,0,1
VG,JP,2023.0,1,0,1
BD,AT,2003.0,1,0,1
US,BF,2007.0,1,0,1
NG,CO,2001.0,1,0,1
AE,KR,2009.0,1,0,1
CN,KY,2018.0,1,0,1
PA,PY,2014.0,1,0,1
HK,NZ,2010.0,1,0,1
KE,ZM,2005.0,1,0,1
HR,NO,2022.0,1,0,1
GM,GH,2012.0,1,0,1
CF,MA,2011.0,1,0,1
PG,IN,2015.0,1,0,1
ZM,MW,2007.0,1,0,1
SD,IR,2016.0,1,0,1
AT,UG,2018.0,2,0,2
MZ,NL,2015.0,1,0,1
BI,ZW,2015.0,1,0,1
IR,CZ,2003.0,1,0,1
UG,AT,2020.0,1,0,1
NG,SI,2020.0,1,0,1
NZ,BD,2009.0,3,0,3
PK,BG,2009.0,1,0,1
CM,ES,2011.0,1,0,1
SE,NP,2022.0,1,0,1
MD,PL,2013.0,1,0,1
MX,ET,2012.0,1,0,1
JO,KE,2011.0,1,0,1
MZ,ST,2016.0,2,0,2
MZ,SN,2022.0,1,0,1
nan,BW,2007.0,1,0,1
IL,IE,1997.0,1,0,1
BH,AU,2008.0,1,0,1
OM,MA,2012.0,1,0,1
LV,IL,2018.0,1,0,1
UG,OM,2011.0,1,0,1
PT,VN,2018.0,1,0,1
PK,NZ,2002.0,1,0,1
FR,MZ,2008.0,1,0,1
FI,HN,2015.0,1,0,1
BT,SG,2019.0,1,0,1
LV,BE,2007.0,1,0,1
AT,LV,2007.0,1,0,1
KW,VE,2002.0,1,0,1
UZ,IE,2022.0,1,0,1
CZ,GH,2009.0,1,0,1
UA,LV,2013.0,1,0,1
ZM,SE,2000.0,1,0,1
KE,MA,2021.0,1,0,1
ZM,NG,1998.0,1,0,1
PR,BR,2011.0,2,0,2
ZM,PH,1998.0,2,0,2
CH,MT,2017.0,1,0,1
ZW,MX,2002.0,1,0,1
US,MN,1998.0,1,0,1
AM,KZ,2009.0,1,0,1
BW,AE,2020.0,1,0,1
RU,XK,2017.0,1,0,1
VN,AT,1999.0,1,0,1
CN,BH,2023.0,1,0,1
IR,TR,2001.0,1,0,1
BJ,GB,2019.0,1,0,1
JE,MG,2010.0,1,0,1
OM,GH,2011.0,1,0,1
NA,ES,2021.0,1,0,1
ZA,NP,2010.0,1,0,1
KR,TZ,2016.0,1,0,1
AL,ES,2016.0,1,0,1
EG,KZ,2015.0,1,0,1
NG,ET,2003.0,1,0,1
AL,GH,2014.0,1,0,1
ME,ZA,2020.0,1,0,1
PT,PA,2022.0,1,0,1
PF,KH,2021.0,1,0,1
PL,PR,2017.0,1,0,1
AU,VG,2017.0,1,0,1
SA,LK,2007.0,1,0,1
MD,EG,2020.0,1,0,1
RO,CR,2001.0,1,0,1
TR,GE,1998.0,1,0,1
SA,SY,2001.0,1,0,1
HR,NL,1999.0,1,0,1
HU,PT,1998.0,1,0,1
LB,RU,2021.0,1,0,1
CY,IE,2013.0,1,0,1
BG,EG,2007.0,1,0,1
AT,BA,2002.0,1,0,1
DE,MK,1997.0,1,0,1
KZ,UA,2000.0,1,0,1
BI,AT,2015.0,1,0,1
TR,CR,2007.0,1,0,1
IN,PE,2005.0,1,0,1
EC,NO,2009.0,1,0,1
PH,nan,2003.0,1,0,1
PL,UZ,2022.0,1,0,1
EE,CY,2019.0,1,0,1
GA,BI,2021.0,1,0,1
GR,CR,2017.0,1,0,1
PK,ER,2016.0,1,0,1
NZ,RS,1998.0,1,0,1
SN,NC,2003.0,2,0,2
GH,SN,2020.0,1,0,1
ZA,EE,2022.0,1,0,1
BR,HK,2000.0,1,0,1
CR,TR,2019.0,1,0,1
MD,HR,2016.0,1,0,1
TN,BJ,2005.0,1,0,1
MX,IS,2020.0,1,0,1
AO,AR,2012.0,1,0,1
IN,MK,2020.0,1,0,1
HR,BD,2006.0,1,0,1
MW,NO,2007.0,1,0,1
KG,PK,2022.0,1,0,1
TJ,PR,2012.0,1,0,1
TH,PH,2010.0,1,0,1
CN,BA,2011.0,1,0,1
PS,ES,2023.0,1,0,1
KH,LT,2020.0,1,0,1
NO,LT,2017.0,1,0,1
MM,TH,2023.0,1,0,1
ML,GN,2010.0,1,0,1
FI,GY,2022.0,1,0,1
SG,ID,2005.0,1,0,1
SE,CI,2018.0,1,0,1
BR,UY,2009.0,31,33,-2
MX,US,2006.0,248,212,36
KR,CN,2019.0,368,246,122
UY,BR,2013.0,56,35,21
US,CO,2010.0,195,174,21
KR,BR,2004.0,4,1,3
AU,GB,2001.0,658,683,-25
JP,US,2007.0,1867,1835,32
KR,CN,2017.0,337,237,100
FJ,AU,2017.0,6,8,-2
CL,CO,2013.0,210,160,50
US,GB,2006.0,4785,4554,231
US,CA,2020.0,3174,3689,-515
nan,DE,2011.0,58,87,-29
BR,ES,2001.0,84,124,-40
MX,CL,2014.0,163,142,21
IT,ES,2006.0,123,114,9
BR,PT,1999.0,148,135,13
US,SE,2006.0,292,329,-37
FR,BR,2009.0,149,117,32
GE,US,2011.0,172,159,13
GB,IL,2007.0,30,44,-14
GB,EG,2011.0,106,38,68
AR,CO,2019.0,144,140,4
US,CO,2017.0,370,341,29
nan,CN,2009.0,247,176,71
CU,ES,2012.0,114,86,28
BR,CA,2010.0,235,249,-14
BR,CA,2019.0,292,262,30
US,IN,2000.0,538,648,-110
PT,BR,2019.0,1252,1298,-46
RU,DE,2014.0,129,176,-47
CY,US,2015.0,12,23,-11
KR,CN,2010.0,313,259,54
GB,RU,2016.0,129,106,23
CH,GB,2001.0,142,115,27
DE,IT,2016.0,277,391,-114
IT,MY,2007.0,53,24,29
IN,KR,2013.0,186,112,74
SV,ES,2002.0,1,1,0
SV,ES,2005.0,2,1,1
DE,BR,2011.0,196,167,29
CN,FR,2016.0,135,232,-97
HK,JP,2019.0,15,13,2
TW,US,2006.0,540,679,-139
ZA,DE,2019.0,68,67,1
NG,SA,2008.0,2,2,0
US,nan,2004.0,148,190,-42
US,NL,2015.0,797,704,93
PT,BR,2017.0,1134,1077,57
DE,IN,2008.0,101,110,-9
SG,JP,2008.0,24,45,-21
AR,MX,2004.0,39,48,-9
CU,PE,2016.0,16,9,7
FR,IR,1998.0,3,1,2
EG,AE,2021.0,54,39,15
SA,EG,2012.0,188,273,-85
CH,IT,2014.0,208,359,-151
US,CO,2019.0,345,451,-106
PT,BR,2010.0,549,692,-143
HK,JP,2017.0,8,11,-3
SI,CA,2016.0,3,2,1
US,PL,2006.0,188,190,-2
FR,TN,2011.0,227,116,111
BD,US,2018.0,223,117,106
GB,GR,2002.0,131,54,77
DE,CN,2012.0,279,250,29
CA,CH,2011.0,117,105,12
BR,CA,2017.0,245,261,-16
GB,IT,2020.0,586,657,-71
NZ,BR,2020.0,9,24,-15
BR,IT,2004.0,72,102,-30
GB,CN,2021.0,712,541,171
BR,US,2020.0,1461,1295,166
NO,DE,2005.0,28,47,-19
BR,DE,2006.0,99,111,-12
CA,ZA,2010.0,33,32,1
CN,GB,2012.0,401,568,-167
PT,ES,2018.0,166,204,-38
US,BR,2001.0,374,355,19
PL,BA,2007.0,5,4,1
BA,PL,2008.0,6,7,-1
DK,DE,1999.0,53,62,-9
US,TW,2020.0,616,608,8
BR,CO,2015.0,128,160,-32
AR,BR,2011.0,133,113,20
PE,AR,2012.0,18,33,-15
MX,ES,2005.0,361,348,13
RU,US,2013.0,383,483,-100
CA,EG,2007.0,22,20,2
CH,IN,2016.0,54,64,-10
IN,BD,2021.0,131,110,21
US,CZ,1998.0,41,42,-1
DE,NL,2020.0,421,410,11
AU,CH,1998.0,18,22,-4
CU,CO,2019.0,36,46,-10
PK,SG,2012.0,4,2,2
IN,TW,2008.0,43,22,21
IE,BD,2008.0,1,1,0
PT,CH,2019.0,24,20,4
NL,nan,2012.0,62,76,-14
MX,ES,2002.0,276,245,31
KR,GB,2021.0,112,76,36
CL,CU,2011.0,13,13,0
NO,IR,2014.0,5,18,-13
PA,CO,2011.0,4,4,0
RS,HR,2016.0,134,129,5
MX,HN,1998.0,6,3,3
ES,CL,2004.0,115,121,-6
ES,SG,2021.0,11,4,7
KR,PR,2000.0,12,34,-22
US,AE,2008.0,55,23,32
BR,PE,2016.0,64,59,5
MY,YE,2020.0,17,8,9
FR,CL,2011.0,37,24,13
ML,IN,2015.0,7,7,0
KR,SG,2008.0,34,21,13
NL,CN,1999.0,25,20,5
ES,DE,2006.0,106,128,-22
DE,CL,2009.0,38,34,4
CA,FR,2002.0,249,332,-83
nan,CH,2018.0,25,16,9
US,HK,2007.0,13,3,10
IN,JP,2016.0,150,135,15
MY,nan,2016.0,104,41,63
JP,GR,2022.0,21,7,14
BG,ES,2006.0,6,6,0
GR,US,2013.0,200,156,44
TW,SG,2021.0,51,33,18
CH,CA,2007.0,97,72,25
CA,AU,2004.0,208,230,-22
MY,US,2002.0,24,34,-10
CA,ZA,2017.0,46,51,-5
TW,BE,2019.0,5,7,-2
PS,CA,2015.0,4,1,3
QA,IN,2022.0,13,24,-11
AR,CO,2010.0,63,52,11
US,IE,2003.0,282,244,38
NO,SE,2022.0,57,88,-31
TZ,US,2016.0,28,27,1
BR,AU,2015.0,134,109,25
SK,RS,2007.0,6,3,3
CR,US,2011.0,27,31,-4
BR,IL,2008.0,7,8,-1
CU,CN,2019.0,5,4,1
CH,ZA,2020.0,23,25,-2
US,LB,2006.0,25,35,-10
AT,RO,2022.0,11,4,7
NL,PK,2015.0,15,6,9
GB,PK,2016.0,187,106,81
GB,BE,2017.0,161,194,-33
BY,CZ,2011.0,11,18,-7
GB,BE,2019.0,186,179,7
IN,GH,2011.0,1,3,-2
BD,MY,2016.0,45,56,-11
US,GR,2009.0,170,163,7
HR,IT,2003.0,5,3,2
CA,FI,2017.0,20,21,-1
AU,AT,2015.0,25,46,-21
IL,DE,2020.0,71,78,-7
CO,AR,2021.0,91,89,2
AR,CO,2017.0,126,134,-8
US,SG,1998.0,83,92,-9
NL,NO,2011.0,22,30,-8
IE,ES,1999.0,3,5,-2
SG,TH,1999.0,1,1,0
JP,CH,2021.0,59,80,-21
FR,MA,2005.0,159,168,-9
ZA,NZ,2019.0,27,12,15
NP,IN,2005.0,25,24,1
TW,HK,2011.0,4,3,1
BE,DE,2009.0,82,106,-24
CA,GR,2020.0,14,15,-1
NZ,CN,2005.0,20,16,4
PK,ID,2012.0,7,9,-2
BE,CN,2008.0,51,36,15
UZ,CN,2011.0,9,14,-5
CN,VN,2005.0,24,54,-30
CN,IE,2014.0,52,45,7
IT,NL,2008.0,82,62,20
GB,GR,2005.0,138,106,32
FR,PE,2013.0,13,10,3
IN,ES,2016.0,22,24,-2
TR,KZ,2006.0,21,18,3
CA,JP,2001.0,95,91,4
IR,FR,2008.0,16,28,-12
UG,NL,2019.0,9,7,2
nan,BR,2018.0,147,136,11
ET,US,2005.0,18,14,4
NO,CN,2018.0,37,34,3
PK,SA,2018.0,113,115,-2
US,RO,2013.0,98,71,27
IN,NL,2011.0,40,40,0
SD,EG,2021.0,27,30,-3
RU,MY,2017.0,15,28,-13
NP,GB,2008.0,6,7,-1
DE,SG,2022.0,22,18,4
DE,IR,2008.0,24,24,0
IE,AU,2021.0,82,105,-23
SE,SG,2018.0,22,24,-2
CZ,FR,2013.0,36,26,10
FR,RU,2005.0,44,54,-10
CO,EC,2015.0,103,35,68
GB,HR,2001.0,7,6,1
AR,EC,2010.0,2,12,-10
JP,AR,2012.0,4,4,0
ES,AR,2004.0,144,156,-12
CZ,SI,2003.0,6,6,0
DE,SE,1999.0,73,53,20
nan,JP,2018.0,54,43,11
SE,US,2004.0,315,307,8
MA,DZ,2020.0,21,39,-18
FR,MA,2002.0,99,132,-33
GB,JP,1999.0,197,216,-19
FR,ES,2003.0,126,131,-5
MX,IT,2020.0,50,20,30
CA,IL,2005.0,27,59,-32
FI,GB,2004.0,38,38,0
NO,NL,2012.0,31,37,-6
SA,TN,2013.0,10,38,-28
FI,HU,2021.0,6,5,1
JP,LK,2017.0,32,20,12
CA,SA,2009.0,65,29,36
IR,US,2008.0,140,171,-31
FR,ZA,2017.0,46,31,15
IQ,CA,2019.0,14,14,0
ES,JP,2011.0,37,32,5
CA,IL,2002.0,26,28,-2
FR,nan,2015.0,202,206,-4
ID,EG,2006.0,2,3,-1
RU,FR,2014.0,74,94,-20
ES,SE,2006.0,26,40,-14
SN,CH,2020.0,2,9,-7
CR,UY,2012.0,2,2,0
NZ,MY,2015.0,35,18,17
IT,ET,2015.0,6,1,5
SD,AE,2011.0,1,2,-1
AE,EG,2016.0,36,36,0
JO,TR,2019.0,3,2,1
SN,CA,2021.0,2,4,-2
ES,BD,2016.0,21,13,8
CN,AT,2007.0,5,16,-11
ML,CI,2017.0,7,7,0
NL,EG,2010.0,8,4,4
BE,BR,2009.0,39,42,-3
ZA,DE,2017.0,69,55,14
JP,LK,2019.0,26,22,4
BE,CH,2000.0,28,17,11
CL,CZ,2018.0,4,3,1
NP,NZ,2015.0,33,37,-4
NL,AE,2015.0,5,1,4
BE,NO,2009.0,7,2,5
MZ,RU,2020.0,28,17,11
CA,FR,2005.0,317,453,-136
GR,QA,2013.0,5,1,4
US,LK,2003.0,9,7,2
AU,CL,2014.0,14,17,-3
CN,PK,2003.0,25,49,-24
LB,EG,2016.0,16,15,1
IN,DK,2018.0,26,16,10
GB,SK,2012.0,17,18,-1
CZ,SK,2015.0,125,153,-28
SE,ES,2015.0,46,104,-58
CL,EC,2015.0,43,25,18
JP,MX,2000.0,9,4,5
IN,CZ,1999.0,5,5,0
SA,QA,2015.0,21,7,14
ZA,CH,2020.0,25,23,2
NL,HU,2014.0,15,18,-3
GB,AE,2009.0,21,14,7
BH,GB,2019.0,6,8,-2
RU,HR,2019.0,9,12,-3
NL,PH,2014.0,5,5,0
MQ,FR,2018.0,11,21,-10
DK,IT,2007.0,10,23,-13
BD,DE,2016.0,11,11,0
MY,EG,2015.0,44,38,6
MX,ZA,2020.0,3,2,1
SN,FR,2022.0,17,16,1
MY,US,2005.0,35,52,-17
BG,BR,2012.0,4,1,3
CN,BE,2002.0,14,52,-38
AR,SG,2021.0,1,1,0
FR,IT,2023.0,9,14,-5
CA,CM,2017.0,5,7,-2
IE,SA,2014.0,9,8,1
IT,AT,2014.0,58,32,26
DE,IL,2022.0,33,38,-5
SA,PK,2016.0,84,95,-11
ES,SI,2014.0,18,11,7
SG,MY,2016.0,150,116,34
MX,PY,2017.0,20,11,9
nan,MY,2020.0,62,53,9
DK,CL,2016.0,2,4,-2
AU,GH,2022.0,13,12,1
FI,nan,2017.0,11,8,3
LK,IN,2019.0,34,36,-2
RO,TR,2019.0,6,4,2
RS,CL,2018.0,1,1,0
EC,PE,2017.0,29,53,-24
US,SG,1997.0,51,58,-7
UA,CN,2009.0,12,14,-2
RS,CH,2018.0,11,6,5
IE,ET,2021.0,1,1,0
SK,NL,1999.0,9,8,1
CH,PL,1999.0,13,8,5
HN,ES,2016.0,10,3,7
nan,IN,2012.0,37,46,-9
PH,PE,2011.0,3,1,2
VE,FR,2009.0,8,11,-3
ET,TW,2021.0,5,10,-5
KE,MY,2021.0,2,1,1
FR,DZ,2022.0,46,55,-9
ID,OM,2021.0,2,1,1
RS,TR,2016.0,91,53,38
HN,MX,2020.0,24,19,5
CA,SE,2000.0,30,31,-1
BE,AU,2001.0,11,19,-8
BW,GB,2003.0,3,2,1
TW,KR,2015.0,56,34,22
TN,MA,2020.0,37,40,-3
IQ,AU,2020.0,22,43,-21
IE,nan,2012.0,2,1,1
DK,HU,2020.0,6,6,0
US,BZ,2015.0,1,1,0
JP,LK,2010.0,23,15,8
CU,CO,2017.0,37,31,6
CN,SK,2018.0,4,6,-2
IL,NZ,2003.0,1,2,-1
QA,OM,2022.0,4,1,3
GB,CO,2021.0,21,24,-3
NL,SG,2012.0,16,9,7
MK,US,2017.0,13,6,7
IN,IR,2014.0,48,18,30
BH,DE,2021.0,1,1,0
DK,IE,2018.0,7,14,-7
DE,ZA,2008.0,37,35,2
IS,DK,2021.0,9,3,6
FR,UA,2009.0,12,17,-5
CH,ES,2003.0,38,37,1
CR,CU,2021.0,29,16,13
ES,FR,1997.0,84,73,11
US,BD,2008.0,66,52,14
CH,FI,2019.0,21,20,1
IN,AF,2021.0,4,4,0
US,BW,2023.0,1,2,-1
GR,AE,2016.0,6,2,4
nan,ID,2020.0,92,78,14
VN,HU,2022.0,2,3,-1
RU,DK,2021.0,12,12,0
DZ,TN,2015.0,23,18,5
GR,IT,2022.0,30,37,-7
IL,IT,2021.0,14,15,-1
MX,PE,2011.0,70,42,28
GB,UG,2020.0,22,19,3
US,RU,2002.0,223,393,-170
ES,CO,2003.0,100,89,11
TR,US,2013.0,411,428,-17
AR,CN,2001.0,2,2,0
JM,US,2005.0,7,7,0
GB,ZA,2009.0,132,128,4
ES,CU,2011.0,82,110,-28
BD,ES,2012.0,23,29,-6
GB,KR,2018.0,89,148,-59
MX,VE,1998.0,10,11,-1
CH,CL,2018.0,22,26,-4
IS,AE,2020.0,1,1,0
GB,BE,2010.0,101,115,-14
NL,IL,2015.0,14,11,3
CH,AT,2005.0,66,53,13
BD,SA,2018.0,23,32,-9
RS,HU,2005.0,5,3,2
TZ,CH,2018.0,9,3,6
FR,SE,2005.0,39,45,-6
ES,FR,1998.0,124,104,20
JP,nan,2004.0,50,96,-46
AE,CN,2015.0,8,9,-1
PK,JP,2022.0,10,6,4
US,TR,2023.0,13,22,-9
TZ,BH,2005.0,2,2,0
US,CZ,1997.0,41,32,9
TW,VN,2021.0,39,24,15
PH,KR,2016.0,12,11,1
PK,KR,2020.0,49,72,-23
NZ,ID,2016.0,12,4,8
CZ,DE,2016.0,83,86,-3
BE,KR,2014.0,11,9,2
NL,ZA,2018.0,56,50,6
FR,SE,2002.0,47,35,12
GT,US,2004.0,2,2,0
AU,SA,2015.0,43,27,16
TW,IN,2002.0,10,38,-28
RU,MZ,2008.0,41,1,40
PL,SE,2007.0,11,15,-4
MK,US,2010.0,4,8,-4
US,SK,2009.0,35,30,5
IL,JP,2004.0,10,6,4
BR,IR,2018.0,14,15,-1
GF,FR,2008.0,4,9,-5
SE,nan,2008.0,42,52,-10
GR,AU,2016.0,13,4,9
FR,BZ,2003.0,10,6,4
IL,NO,2012.0,6,2,4
GB,PL,2006.0,36,39,-3
GB,LK,2008.0,17,14,3
AU,PL,2012.0,19,14,5
CA,MY,2006.0,6,7,-1
IN,LU,2017.0,4,2,2
BE,BG,2010.0,7,7,0
PL,NL,2013.0,16,34,-18
TR,BR,2007.0,74,12,62
BE,LU,2007.0,8,5,3
NL,AR,2006.0,3,8,-5
BR,DO,2021.0,6,6,0
NO,nan,1999.0,7,4,3
CH,PK,2009.0,15,6,9
SE,HU,2012.0,8,15,-7
GB,BH,2014.0,6,5,1
IR,AU,2013.0,103,44,59
FR,ZA,2010.0,35,29,6
LV,CA,2018.0,2,1,1
TH,BD,2013.0,2,2,0
PH,SG,2010.0,4,3,1
CZ,HR,2017.0,13,5,8
SE,TR,2015.0,20,15,5
CN,CZ,2021.0,19,6,13
TR,CY,2013.0,34,25,9
MY,CZ,2021.0,10,11,-1
CL,UY,2017.0,13,10,3
ZW,ZM,2018.0,4,3,1
MD,TN,2016.0,7,3,4
IL,DK,2018.0,8,4,4
LT,JP,2008.0,10,10,0
DE,BD,2021.0,19,13,6
TN,IT,2020.0,28,24,4
LT,CH,2013.0,3,2,1
SG,AU,2022.0,82,62,20
CA,NZ,2008.0,50,64,-14
QA,DE,2019.0,10,5,5
ID,CA,2006.0,6,3,3
KR,CA,1999.0,13,13,0
TW,EG,2018.0,26,27,-1
SG,HK,2013.0,5,2,3
FI,CN,2016.0,40,20,20
CA,SG,2009.0,35,33,2
UG,US,2021.0,38,28,10
FR,RO,2014.0,70,42,28
NL,TZ,2014.0,8,2,6
AU,PH,2013.0,11,15,-4
TN,JO,2019.0,2,2,0
KR,ET,2008.0,96,131,-35
LB,CA,2003.0,4,6,-2
BE,BG,2019.0,6,3,3
JP,TR,2011.0,38,35,3
ZA,GB,2009.0,128,132,-4
NL,EG,2017.0,11,6,5
TR,UA,2019.0,3,1,2
IN,BR,1997.0,3,2,1
IT,MG,2014.0,3,2,1
CH,AT,2002.0,58,47,11
FR,EE,2002.0,3,1,2
CL,AR,2005.0,29,32,-3
AR,BO,2012.0,3,4,-1
ML,CI,2010.0,3,4,-1
DE,SK,2003.0,19,20,-1
CL,JP,2014.0,7,7,0
AT,IL,2012.0,3,5,-2
RO,ES,2014.0,16,23,-7
JO,TW,2018.0,1,2,-1
GA,CA,2019.0,1,1,0
CO,NL,2016.0,10,14,-4
CU,CL,2007.0,14,15,-1
IQ,US,2003.0,1,2,-1
GH,PT,2020.0,1,1,0
PT,BE,2021.0,11,18,-7
UA,NL,2009.0,6,2,4
GD,US,2011.0,8,4,4
ES,BO,2001.0,1,2,-1
AU,BW,2013.0,3,2,1
CL,UY,2019.0,19,23,-4
IT,PT,1999.0,13,7,6
GB,UZ,2018.0,6,1,5
CH,FI,2017.0,27,31,-4
IQ,CN,2018.0,6,14,-8
MX,CO,1999.0,24,29,-5
CN,AO,2008.0,1,2,-1
KZ,AU,2015.0,1,2,-1
IE,MX,2015.0,5,3,2
GB,CM,2019.0,8,13,-5
EG,CN,2013.0,13,17,-4
AT,DK,2015.0,28,18,10
MY,SG,2003.0,10,15,-5
BR,ZA,2006.0,6,5,1
MM,CN,2000.0,1,3,-2
LU,FR,2018.0,39,49,-10
IN,FR,2011.0,142,92,50
ES,GT,2018.0,24,9,15
NL,MX,2007.0,5,2,3
TR,SE,2015.0,15,20,-5
CR,NL,2013.0,1,1,0
KE,CN,2015.0,10,10,0
FI,AU,2016.0,19,14,5
FR,BI,2020.0,26,15,11
GB,UA,2012.0,10,8,2
BE,IN,2001.0,10,5,5
FI,BE,1998.0,5,3,2
ID,RO,2021.0,4,2,2
IN,BH,2018.0,8,2,6
RU,VN,2016.0,9,4,5
SA,IR,2019.0,15,18,-3
GB,NP,2013.0,12,9,3
RU,UZ,2018.0,31,36,-5
TW,RU,2004.0,12,11,1
HU,AU,2001.0,9,4,5
EG,IR,2019.0,15,27,-12
AT,AU,2006.0,19,16,3
AR,FR,1997.0,5,9,-4
DE,IQ,2013.0,4,5,-1
UA,ES,2021.0,4,4,0
BG,DE,2015.0,16,17,-1
RU,HR,2010.0,3,4,-1
SE,GR,2022.0,14,19,-5
FR,ZA,2019.0,32,36,-4
NP,CN,2021.0,12,16,-4
IT,MX,2004.0,24,16,8
AT,IN,2016.0,12,11,1
ES,AT,2009.0,14,26,-12
US,SA,2000.0,40,36,4
AF,PK,2020.0,4,8,-4
RS,FR,2013.0,9,7,2
CA,DK,2002.0,16,19,-3
TR,IN,2013.0,14,18,-4
LK,CN,2016.0,9,8,1
NG,IT,2005.0,5,8,-3
BD,JP,2011.0,51,84,-33
FR,TR,2011.0,19,25,-6
UY,AR,2007.0,15,6,9
JP,TZ,2014.0,6,1,5
QA,DE,2017.0,6,10,-4
CZ,FI,2012.0,7,10,-3
NO,SK,2014.0,1,2,-1
OM,IT,2018.0,2,2,0
IE,IR,2017.0,6,10,-4
RU,MY,2019.0,21,34,-13
FR,VG,2006.0,1,2,-1
FR,CO,2004.0,10,12,-2
NO,HR,2021.0,3,3,0
IE,DE,2006.0,39,71,-32
FR,CM,1999.0,12,8,4
nan,AR,2013.0,51,38,13
IL,SG,2022.0,2,2,0
FI,CA,2005.0,25,15,10
NL,PL,2013.0,34,16,18
MA,IT,2002.0,6,4,2
OM,GB,2017.0,10,21,-11
GB,OM,2018.0,21,13,8
PL,AT,2012.0,18,14,4
SE,PL,2004.0,11,18,-7
BE,CZ,2013.0,15,7,8
PK,TN,2013.0,7,3,4
SE,VN,2005.0,2,1,1
US,UA,2007.0,32,40,-8
UA,BY,2019.0,23,24,-1
PY,CU,2006.0,11,6,5
BH,US,2005.0,7,11,-4
IT,CL,1999.0,2,4,-2
LV,RU,2014.0,20,35,-15
DE,KE,2022.0,2,8,-6
BY,FR,2010.0,3,1,2
JP,FI,2015.0,10,12,-2
BR,CZ,2012.0,3,9,-6
UA,BY,2010.0,7,9,-2
CZ,BY,2013.0,22,7,15
BE,BG,2017.0,6,5,1
EE,GB,2011.0,6,11,-5
BO,ES,2014.0,20,18,2
RU,MY,2010.0,8,2,6
FI,CA,2002.0,9,10,-1
IN,MX,1999.0,7,1,6
RS,JP,2018.0,3,1,2
GB,FI,2007.0,41,46,-5
CA,BD,2014.0,33,42,-9
FR,ML,2012.0,10,5,5
HU,NL,2009.0,15,11,4
NO,MX,2018.0,3,5,-2
RU,AU,2007.0,18,6,12
PL,RU,2014.0,32,20,12
EG,IR,2017.0,13,19,-6
TW,FR,2005.0,17,20,-3
SA,NG,2018.0,13,14,-1
BY,FR,2017.0,3,3,0
HK,NL,2009.0,11,16,-5
BT,TH,2014.0,1,1,0
JP,KE,2011.0,8,5,3
CA,NI,2013.0,2,1,1
KR,BE,2016.0,13,16,-3
CL,SV,2017.0,8,1,7
CA,MT,2020.0,2,3,-1
BF,CI,2012.0,1,3,-2
BD,AE,2012.0,6,2,4
MY,NO,2017.0,5,6,-1
SA,IR,2017.0,13,11,2
CO,PE,2008.0,18,19,-1
TR,TW,2000.0,2,3,-1
NO,PK,2022.0,8,12,-4
NO,AU,2003.0,10,1,9
HU,HR,2020.0,2,3,-1
KR,NG,2017.0,11,10,1
BZ,FR,2012.0,3,1,2
IL,ES,2008.0,13,9,4
UA,RO,2021.0,8,8,0
CH,AU,2005.0,33,32,1
NL,NZ,2008.0,20,10,10
FI,IE,2018.0,7,6,1
GB,PT,2001.0,47,30,17
IL,TR,2017.0,5,4,1
NO,GB,1999.0,23,22,1
JO,EG,2000.0,2,1,1
US,HN,2021.0,2,5,-3
GT,ES,2021.0,9,8,1
CL,UY,2010.0,11,1,10
MA,CN,2018.0,4,3,1
BR,SE,2021.0,41,21,20
JP,SG,2002.0,27,12,15
PT,CA,2012.0,10,13,-3
SK,FR,2001.0,7,4,3
CH,IL,2016.0,10,16,-6
CL,IL,2012.0,4,3,1
IR,CY,2019.0,9,9,0
NG,BD,2014.0,3,2,1
CN,GR,2015.0,11,18,-7
OM,US,2009.0,4,8,-4
BG,GB,2021.0,8,9,-1
MX,AT,2015.0,7,1,6
ES,IN,2014.0,31,35,-4
DE,FI,2008.0,45,43,2
KE,NG,2015.0,2,4,-2
PL,SK,2014.0,4,9,-5
NC,FR,2015.0,16,16,0
AT,ES,2001.0,9,5,4
BI,BE,2014.0,1,1,0
PS,TR,2020.0,2,3,-1
IR,TN,2014.0,10,5,5
BO,MX,2014.0,5,4,1
CZ,HR,2019.0,8,15,-7
MX,PR,2019.0,4,4,0
CU,CO,2010.0,30,16,14
IN,HU,2000.0,13,3,10
PL,JP,2016.0,13,32,-19
SI,RS,2011.0,16,6,10
NG,BJ,2018.0,10,12,-2
AT,HU,2006.0,20,15,5
UA,FR,1997.0,7,5,2
CA,GH,2021.0,5,13,-8
EG,SY,2020.0,10,9,1
GB,BF,2021.0,3,1,2
MX,PY,2019.0,27,13,14
PH,SG,2019.0,9,16,-7
EG,AU,1999.0,1,2,-1
JM,US,2002.0,10,9,1
LY,EG,2014.0,4,9,-5
ZA,FR,2008.0,13,18,-5
PK,KE,2003.0,2,1,1
CA,BH,2015.0,2,1,1
KE,CH,2011.0,2,2,0
GB,CM,2017.0,8,5,3
RU,FI,2013.0,33,22,11
nan,NZ,2020.0,5,5,0
TW,IN,2005.0,10,24,-14
ET,US,2002.0,12,11,1
NL,IE,2004.0,9,6,3
KR,AM,2008.0,9,8,1
EC,US,2005.0,8,7,1
AT,KR,2022.0,7,2,5
KR,FR,2021.0,26,23,3
MY,DK,2017.0,11,4,7
SE,FR,2016.0,78,114,-36
GB,HK,2008.0,1,2,-1
CM,US,2020.0,12,15,-3
UG,ZA,2005.0,2,4,-2
GB,TZ,2018.0,11,11,0
RS,IN,2016.0,2,1,1
NC,CA,2010.0,1,1,0
FI,RU,2007.0,15,22,-7
BY,RU,2004.0,27,23,4
EC,DE,2021.0,7,9,-2
IN,PK,2005.0,30,45,-15
CL,AR,2002.0,26,16,10
RU,HR,2017.0,7,7,0
UG,MW,2018.0,2,1,1
QA,GB,2004.0,3,3,0
CA,CZ,2004.0,9,4,5
NG,KR,2012.0,4,5,-1
IR,IN,2007.0,10,8,2
FR,VE,2018.0,7,6,1
NL,EG,2019.0,8,14,-6
JO,CN,2022.0,1,3,-2
NL,LU,2007.0,1,1,0
AU,CH,1997.0,16,13,3
SG,IN,2003.0,14,21,-7
NL,LK,2012.0,2,3,-1
HU,RS,2013.0,9,3,6
FI,nan,2019.0,9,10,-1
NL,CH,2001.0,45,44,1
LK,IN,2010.0,6,8,-2
TR,PH,2006.0,1,1,0
US,HR,2008.0,49,35,14
HR,GB,2011.0,10,6,4
UG,PE,2010.0,2,1,1
FR,TH,2002.0,5,5,0
BG,JP,2008.0,5,5,0
ES,IT,2000.0,63,64,-1
US,MT,2016.0,7,8,-1
TR,KW,2013.0,9,2,7
TT,GB,2018.0,5,12,-7
BY,DE,2012.0,5,6,-1
IE,BE,2018.0,16,27,-11
FI,AT,2012.0,8,11,-3
NO,BE,2012.0,7,10,-3
ZA,NZ,2017.0,20,8,12
AU,TH,2009.0,37,21,16
IN,TN,2013.0,6,1,5
BR,PK,2020.0,8,5,3
CY,TR,2008.0,3,9,-6
US,CY,2016.0,20,25,-5
FI,nan,2010.0,8,13,-5
PT,JP,2009.0,4,3,1
ES,EG,2011.0,6,4,2
LT,PL,2011.0,2,6,-4
MD,RO,2022.0,13,1,12
CZ,NO,2007.0,29,3,26
DE,HR,1997.0,3,14,-11
GB,PS,1998.0,1,1,0
ZA,MW,2011.0,6,1,5
ET,GB,2018.0,11,9,2
PL,CA,2008.0,24,19,5
EG,TN,2022.0,14,14,0
CZ,DK,2012.0,4,8,-4
ZA,NO,2014.0,8,6,2
MK,RU,2012.0,1,1,0
MA,IT,2005.0,5,10,-5
KW,AU,2016.0,1,3,-2
UY,CO,2013.0,13,12,1
CA,FI,2010.0,16,18,-2
GF,GP,2013.0,3,2,1
DK,IL,2019.0,4,3,1
nan,NO,2022.0,14,10,4
ZA,IT,2014.0,9,18,-9
KE,GB,1997.0,7,4,3
SE,AE,2020.0,4,2,2
SA,PS,2021.0,6,7,-1
JP,NO,2001.0,8,3,5
CU,CN,2017.0,7,1,6
RU,IQ,2018.0,6,3,3
CN,RS,2009.0,8,8,0
ES,HN,2005.0,3,6,-3
IL,AR,2006.0,3,3,0
FR,BG,2013.0,9,6,3
KR,NG,2019.0,6,15,-9
AU,SI,2013.0,4,4,0
CA,VE,2008.0,4,3,1
BT,IN,2020.0,4,4,0
VG,GB,2018.0,6,6,0
ES,NI,2018.0,5,7,-2
CU,nan,2012.0,6,2,4
BR,MX,2004.0,30,35,-5
PA,AR,2018.0,8,4,4
NO,RO,2010.0,1,4,-3
LB,IN,2016.0,5,4,1
MY,SD,2009.0,1,4,-3
NI,MX,2008.0,1,2,-1
JP,QA,2015.0,3,2,1
DK,AT,2004.0,5,4,1
SE,VN,2002.0,1,2,-1
PK,GB,2003.0,24,23,1
MX,AU,2021.0,12,13,-1
CO,NI,2012.0,3,1,2
TN,LY,2019.0,1,1,0
AR,TW,2011.0,7,14,-7
BG,CZ,2007.0,2,1,1
TR,MX,2003.0,3,1,2
DK,PT,1999.0,2,2,0
SG,NP,2017.0,1,1,0
TN,CH,2014.0,19,12,7
HR,SI,2000.0,4,2,2
YE,SA,2021.0,17,17,0
AE,nan,2013.0,1,2,-1
ES,UG,2022.0,2,4,-2
EC,SG,2017.0,1,2,-1
BD,OM,2011.0,2,1,1
ZA,SE,2007.0,4,10,-6
AE,DZ,2020.0,4,3,1
SE,RS,2003.0,2,3,-1
BA,HR,2013.0,16,32,-16
RU,AE,2018.0,3,1,2
IQ,SD,2015.0,4,9,-5
PH,DE,1999.0,3,1,2
SK,HR,2022.0,5,3,2
RS,NO,2019.0,3,2,1
BR,SD,2004.0,2,3,-1
NG,TH,2016.0,3,3,0
IN,GR,2018.0,9,3,6
EC,ES,2003.0,8,6,2
DK,MX,2013.0,6,8,-2
IR,CN,2001.0,3,2,1
PS,JP,2003.0,1,1,0
MA,TG,2016.0,2,1,1
IQ,CA,2017.0,8,5,3
UG,IT,2020.0,2,5,-3
BA,ME,2015.0,1,1,0
CN,KZ,2001.0,1,2,-1
IN,TH,2021.0,25,17,8
AE,PL,2021.0,3,1,2
RU,SG,2020.0,7,6,1
RS,SE,2006.0,1,3,-2
SA,MT,2019.0,2,2,0
YE,EG,2009.0,2,2,0
AM,RU,2008.0,4,5,-1
MX,PR,2017.0,8,4,4
MX,VE,1997.0,7,5,2
TR,CZ,2022.0,5,2,3
FR,JO,2021.0,1,2,-1
TR,EG,2021.0,9,4,5
UZ,UA,2018.0,4,3,1
US,CD,2021.0,2,6,-4
UA,NO,2018.0,4,3,1
TR,BD,2019.0,4,2,2
nan,AT,2009.0,10,5,5
CN,RW,2022.0,2,2,0
MX,SE,2016.0,16,9,7
nan,MX,2007.0,10,8,2
FR,AE,2014.0,12,5,7
CY,GB,2020.0,24,56,-32
CA,FI,2019.0,19,18,1
UA,JP,2013.0,8,10,-2
JP,SY,2014.0,1,1,0
JP,PL,2007.0,9,23,-14
CA,RU,2004.0,15,35,-20
DK,NZ,2012.0,4,8,-4
BY,FR,2019.0,1,1,0
EG,BH,2013.0,2,3,-1
AR,IE,2011.0,2,1,1
KE,SD,2007.0,4,1,3
IL,NL,1997.0,5,4,1
AT,BR,2008.0,9,6,3
IN,SA,2007.0,8,13,-5
MY,NO,2019.0,7,1,6
NL,RU,2003.0,22,25,-3
KW,GB,2007.0,8,8,0
nan,NP,2020.0,7,2,5
CN,UA,2001.0,19,4,15
NP,IN,2002.0,7,12,-5
NZ,AU,2023.0,9,10,-1
TN,nan,2012.0,1,1,0
SA,MY,2012.0,16,24,-8
FR,CY,2012.0,6,2,4
IE,IR,2019.0,12,21,-9
RU,CL,2008.0,3,2,1
EE,SE,2001.0,7,6,1
AT,SI,2001.0,4,3,1
BE,PH,2017.0,1,3,-2
AU,VN,2009.0,9,7,2
MK,US,2019.0,12,6,6
NP,KR,2009.0,4,3,1
AR,PT,1999.0,2,2,0
NZ,AE,2013.0,10,2,8
IL,NL,1998.0,7,3,4
PE,RU,2017.0,1,1,0
MY,CO,2015.0,3,2,1
CR,BR,1998.0,3,1,2
CH,AR,2009.0,5,12,-7
HU,NZ,2019.0,1,3,-2
PK,CA,1997.0,2,1,1
IN,JM,2009.0,1,2,-1
JP,ZA,1999.0,3,3,0
BD,GB,2004.0,21,22,-1
JM,GB,2000.0,5,4,1
JP,UA,2009.0,7,4,3
FI,KR,2009.0,23,4,19
HU,BR,2022.0,4,4,0
FI,VE,2003.0,1,1,0
CI,US,2001.0,1,2,-1
ZA,SZ,2011.0,1,3,-2
TR,PT,2021.0,3,1,2
FR,BF,2004.0,1,5,-4
FR,SY,2004.0,2,2,0
QA,JO,2009.0,2,2,0
EC,US,2002.0,6,4,2
UG,NL,2017.0,2,4,-2
JO,GB,2012.0,10,33,-23
FR,PK,1998.0,3,1,2
JP,BG,2012.0,2,3,-1
CO,NZ,2014.0,3,3,0
AR,FR,1998.0,15,10,5
BE,SI,2013.0,3,3,0
MZ,BE,2012.0,5,3,2
FI,CH,1998.0,4,6,-2
AE,MA,2009.0,1,2,-1
AM,GR,2013.0,1,1,0
CA,GE,2008.0,2,3,-1
DK,ZA,2014.0,8,4,4
NG,IL,2016.0,2,1,1
DE,SA,2001.0,4,1,3
QA,GL,2005.0,1,1,0
FR,CD,2020.0,3,2,1
RS,AT,2012.0,6,8,-2
nan,IR,2009.0,7,3,4
CH,UA,2018.0,3,10,-7
LT,DK,2009.0,2,3,-1
IT,ZA,2005.0,7,3,4
CH,LV,2015.0,3,4,-1
IE,RS,2020.0,1,1,0
BR,CH,2006.0,17,27,-10
DO,MX,2011.0,1,3,-2
MX,CH,2013.0,8,11,-3
VN,KR,2004.0,6,1,5
DE,HR,1998.0,8,4,4
TW,nan,2001.0,6,1,5
GR,JP,2022.0,7,21,-14
IN,GE,2006.0,1,1,0
HU,CZ,1998.0,2,4,-2
SG,BE,2020.0,2,7,-5
AR,CA,1997.0,4,6,-2
BD,GR,2006.0,2,1,1
VE,PT,2004.0,1,2,-1
GR,PL,2003.0,4,4,0
FR,SK,2005.0,4,11,-7
OM,TR,2008.0,1,1,0
MX,PH,2004.0,1,3,-2
CO,CU,2003.0,8,17,-9
GR,TN,2020.0,1,1,0
MY,NZ,2022.0,7,8,-1
IN,BR,1998.0,6,2,4
US,UY,1998.0,6,6,0
DO,BR,2015.0,1,5,-4
KZ,TR,2003.0,4,7,-3
NZ,NP,2009.0,6,6,0
MX,PT,2001.0,6,9,-3
AT,BD,2016.0,1,1,0
IN,AE,2003.0,2,3,-1
HR,CZ,2020.0,6,16,-10
IT,BD,2011.0,2,3,-1
CO,SE,2012.0,4,6,-2
MX,UY,1999.0,4,3,1
RW,GB,2021.0,4,1,3
FI,EE,1999.0,3,2,1
HR,AU,2012.0,2,2,0
SI,RU,2016.0,5,4,1
PT,CO,1999.0,1,1,0
BE,TN,2015.0,4,2,2
JP,IR,2001.0,6,2,4
UA,TW,2007.0,2,2,0
nan,PE,2009.0,6,7,-1
AM,CL,2019.0,1,1,0
NZ,FR,2006.0,9,15,-6
CO,CA,2003.0,4,3,1
PH,IR,2017.0,2,2,0
ET,ID,2021.0,2,6,-4
ZA,RW,2020.0,8,3,5
UA,nan,2022.0,8,9,-1
MT,NL,2019.0,1,2,-1
SE,PK,2004.0,2,1,1
BJ,TG,2020.0,6,1,5
RS,ZA,2019.0,2,1,1
TH,NL,2006.0,4,4,0
HU,AT,2006.0,15,20,-5
KE,ZA,2001.0,2,1,1
GB,SI,2014.0,9,12,-3
RS,MX,2011.0,4,91,-87
GB,MK,2013.0,2,6,-4
TR,IL,2013.0,3,2,1
SY,SA,2013.0,6,1,5
CI,CA,2016.0,3,4,-1
nan,KR,2003.0,11,8,3
SG,KR,1997.0,7,1,6
IL,PL,2013.0,4,5,-1
EG,NO,2010.0,2,2,0
RU,AT,2003.0,10,4,6
BE,EG,2007.0,4,1,3
NZ,ES,2016.0,6,13,-7
NG,GB,2003.0,10,10,0
BH,GB,2017.0,3,12,-9
GR,KZ,2020.0,1,2,-1
IR,CY,2017.0,10,4,6
BH,NG,2015.0,1,3,-2
ZA,HU,2019.0,2,1,1
TR,BD,2017.0,1,4,-3
SE,NZ,2006.0,5,1,4
SE,UA,1999.0,1,2,-1
AU,PK,2004.0,3,5,-2
CM,DE,2000.0,2,1,1
SD,PK,2020.0,5,3,2
PK,FR,1999.0,2,2,0
DK,FI,2000.0,5,3,2
AR,CA,1998.0,4,3,1
IE,ZA,2020.0,8,10,-2
NO,DE,2002.0,23,32,-9
IT,UY,2015.0,7,10,-3
CL,CN,2022.0,4,5,-1
SI,SK,2012.0,2,3,-1
CH,nan,2001.0,7,4,3
MN,KR,2020.0,5,5,0
IR,NL,2004.0,3,4,-1
GB,EE,2006.0,3,4,-1
TR,AT,1998.0,6,6,0
KW,JP,2004.0,1,2,-1
NO,MW,2015.0,1,3,-2
CH,MD,2009.0,1,1,0
FR,MW,2018.0,1,1,0
BR,CU,1997.0,4,1,3
ES,RO,1999.0,1,1,0
CZ,IL,2009.0,7,4,3
PT,RU,2023.0,1,1,0
TR,OM,2017.0,1,1,0
GA,FR,2011.0,4,5,-1
JO,DE,2004.0,2,2,0
US,HT,2012.0,3,5,-2
JP,DZ,2010.0,1,1,0
GR,IR,2018.0,3,4,-1
NL,KH,2000.0,2,1,1
PH,IN,2003.0,3,5,-2
FR,KW,2013.0,1,2,-1
EG,NL,2000.0,1,2,-1
GH,ZA,2002.0,2,1,1
BE,CU,2016.0,2,7,-5
HU,NZ,2017.0,3,1,2
US,PW,1998.0,1,1,0
PK,CA,1998.0,4,4,0
SA,LB,2006.0,3,3,0
SD,GB,2002.0,3,3,0
ZM,CD,2019.0,2,2,0
RO,HK,2021.0,4,16,-12
SA,DZ,2014.0,6,5,1
BD,IT,2017.0,2,9,-7
GB,CM,2010.0,7,2,5
CF,SN,2015.0,1,3,-2
JO,IT,2016.0,4,4,0
IN,LU,2019.0,6,3,3
BF,US,2018.0,2,4,-2
PT,BG,2016.0,2,1,1
DE,LT,2014.0,8,7,1
BD,ZA,2014.0,1,1,0
RU,MD,2018.0,5,10,-5
IT,SK,2018.0,2,5,-3
CD,DE,2019.0,1,3,-2
IL,BR,2006.0,4,4,0
ET,ZA,2003.0,2,2,0
IE,BR,2022.0,5,8,-3
UA,GB,2022.0,11,6,5
NG,MA,2017.0,1,1,0
BD,IQ,2020.0,7,4,3
NL,CZ,2009.0,12,8,4
TT,FR,2021.0,1,2,-1
CH,FI,2010.0,14,22,-8
IE,SE,2022.0,6,7,-1
CZ,HR,2010.0,3,2,1
AR,TR,2020.0,3,1,2
ML,BF,2014.0,3,2,1
NZ,CZ,2014.0,1,2,-1
PT,UY,2013.0,3,10,-7
TR,MY,2013.0,13,11,2
AL,TR,2011.0,4,5,-1
CZ,CA,2000.0,5,2,3
AU,JM,2008.0,2,2,0
NL,CL,2022.0,9,9,0
FI,RO,2015.0,2,4,-2
ML,CI,2019.0,4,12,-8
CA,PH,2000.0,4,7,-3
IL,TR,2010.0,1,4,-3
IR,PK,2007.0,2,3,-1
UG,CA,2014.0,2,4,-2
AT,EG,2014.0,7,6,1
PK,ES,2022.0,4,1,3
GM,GB,2000.0,3,13,-10
US,MM,2008.0,4,1,3
SD,CN,2022.0,5,10,-5
EG,BD,2002.0,1,1,0
ES,JO,2012.0,2,1,1
CU,VE,2008.0,10,10,0
IS,GB,2006.0,6,3,3
PS,QA,2015.0,2,2,0
PE,SE,2018.0,1,2,-1
SD,GB,2005.0,2,6,-4
IE,PK,2014.0,3,5,-2
KE,GB,1998.0,8,9,-1
LT,CA,2020.0,3,2,1
CL,KR,2015.0,1,2,-1
IR,KR,2009.0,4,1,3
VN,PR,2001.0,1,1,0
ZA,TW,2003.0,2,1,1
AU,BD,2004.0,3,7,-4
ES,TR,2001.0,2,2,0
CH,SA,2014.0,3,4,-1
BE,FI,1999.0,2,3,-1
NO,PL,2013.0,4,8,-4
AU,MX,2008.0,4,13,-9
NZ,SE,2020.0,8,5,3
US,DO,2016.0,3,3,0
CH,CO,2021.0,6,7,-1
ZA,CO,2018.0,4,3,1
PT,VE,2008.0,3,5,-2
TR,MA,2020.0,5,2,3
AR,KR,2019.0,1,1,0
NL,VN,2004.0,2,3,-1
TH,IT,2001.0,3,3,0
SY,AE,2022.0,2,1,1
RU,TR,2018.0,2,13,-11
MY,ZA,2022.0,5,3,2
EC,PH,2017.0,2,3,-1
PE,PH,2016.0,2,3,-1
TH,IR,2018.0,4,3,1
IN,KW,2020.0,5,14,-9
QA,AE,2013.0,4,5,-1
HU,BE,2008.0,6,7,-1
TW,IR,2019.0,1,2,-1
AE,CH,2021.0,2,3,-1
DK,GL,2011.0,4,1,3
IE,KW,2010.0,1,2,-1
ZA,HU,2017.0,3,2,1
EG,HU,2004.0,1,2,-1
UA,EG,2011.0,1,1,0
nan,CO,2006.0,2,2,0
PK,ZA,2013.0,4,4,0
SE,BG,2005.0,4,3,1
PK,UZ,2011.0,1,1,0
CN,IT,2023.0,4,6,-2
AU,PE,2011.0,2,2,0
TW,IR,2017.0,5,4,1
ET,SE,2007.0,3,5,-2
MA,MD,2003.0,3,7,-4
PK,NL,2015.0,6,15,-9
AU,NP,2013.0,5,6,-1
MY,NP,2019.0,6,2,4
RS,nan,2014.0,1,2,-1
GA,ZA,2011.0,1,1,0
SN,GB,2013.0,3,2,1
MA,AU,2020.0,1,1,0
ML,KE,2011.0,2,1,1
NL,CW,2000.0,6,2,4
SA,ET,2015.0,1,2,-1
UG,BE,2002.0,1,1,0
VN,PK,2014.0,1,2,-1
VN,DE,1997.0,1,2,-1
SG,LK,2018.0,6,3,3
KE,BH,2013.0,1,6,-5
GB,TN,2006.0,4,1,3
SG,KR,1998.0,5,6,-1
KR,CZ,2004.0,2,3,-1
JO,AE,1999.0,5,1,4
IN,IT,2023.0,7,4,3
IT,AM,1998.0,2,3,-1
CN,PA,2014.0,1,4,-3
PT,EG,2013.0,2,1,1
BA,QA,2020.0,2,1,1
GB,CL,2001.0,10,9,1
MX,PL,2000.0,2,2,0
HU,CN,2020.0,4,13,-9
TW,SI,2005.0,2,2,0
OM,nan,2014.0,2,1,1
GB,KW,1999.0,3,2,1
NG,BW,2021.0,2,1,1
EG,IN,1998.0,1,1,0
LU,CN,2011.0,3,1,2
CN,HT,2011.0,1,1,0
TN,PT,2016.0,1,1,0
VN,KE,2020.0,1,2,-1
BR,LK,2014.0,1,2,-1
HU,SK,2003.0,3,2,1
GH,NL,2022.0,4,2,2
IR,nan,2009.0,3,7,-4
GR,IN,2005.0,4,2,2
LB,AU,2012.0,2,5,-3
PL,EG,2015.0,2,2,0
CU,PY,1999.0,4,5,-1
FR,HK,2012.0,1,2,-1
MA,HU,2020.0,2,1,1
UA,GR,2006.0,2,1,1
MT,FR,2003.0,1,2,-1
SY,AU,2014.0,2,1,1
TH,CN,2001.0,3,4,-1
MY,BA,2020.0,2,2,0
TZ,NO,2003.0,2,2,0
MX,AF,2013.0,1,1,0
MX,EG,2019.0,2,1,1
MY,IQ,1997.0,1,1,0
SG,CZ,2009.0,1,3,-2
SG,HU,2016.0,1,2,-1
UG,NL,2010.0,2,1,1
IN,BN,2014.0,2,5,-3
IE,JO,2022.0,1,1,0
MK,NL,2014.0,1,1,0
OM,QA,2020.0,5,3,2
AZ,TR,2014.0,2,12,-10
SR,NL,2021.0,1,3,-2
ZA,LS,2020.0,2,6,-4
SA,DE,2008.0,4,3,1
IN,SD,2014.0,1,3,-2
FI,SK,2003.0,3,5,-2
IE,GR,2016.0,4,6,-2
NO,RO,2017.0,2,7,-5
EG,ID,2023.0,5,1,4
UA,FR,1998.0,5,8,-3
MA,PK,2006.0,1,7,-6
PT,QA,2018.0,1,1,0
NG,CY,2018.0,3,1,2
EG,GH,2018.0,5,5,0
PL,BE,2009.0,12,17,-5
ZA,VN,2022.0,1,1,0
KR,NG,2010.0,4,6,-2
VE,EC,2011.0,2,3,-1
PL,RO,2007.0,5,2,3
ZA,JP,2006.0,2,3,-1
IN,NG,2003.0,1,1,0
ES,NP,2018.0,1,1,0
nan,CU,2020.0,5,5,0
AM,US,2003.0,4,4,0
SE,EC,2017.0,1,1,0
CY,NL,2018.0,3,2,1
LU,nan,2013.0,1,1,0
HU,IR,2014.0,3,3,0
IT,HU,2014.0,5,12,-7
TH,NZ,2022.0,3,2,1
CN,BO,2002.0,1,3,-2
GR,IL,2015.0,2,1,1
SI,JP,2005.0,4,3,1
AR,PH,2015.0,1,4,-3
DZ,IT,2003.0,1,11,-10
RS,NO,2017.0,1,3,-2
BH,US,2002.0,2,5,-3
TR,ES,2023.0,1,1,0
NZ,AR,2015.0,1,1,0
KZ,US,2007.0,4,2,2
CZ,IS,2019.0,1,1,0
TW,BE,2017.0,5,4,1
JM,BB,2020.0,4,3,1
GR,BG,2021.0,2,3,-1
CN,BO,2005.0,4,5,-1
CU,PH,2004.0,1,1,0
CA,CM,2019.0,1,8,-7
CA,BA,2015.0,1,1,0
CU,PT,2011.0,3,5,-2
LB,JO,2019.0,3,5,-2
LK,RO,2013.0,1,1,0
US,UZ,2020.0,8,2,6
SI,HU,2016.0,1,2,-1
SG,DE,1997.0,1,4,-3
SD,ID,2021.0,3,1,2
GR,TW,2015.0,2,4,-2
ET,FR,2007.0,1,1,0
LK,NO,2021.0,1,4,-3
MX,IE,2022.0,2,2,0
PY,VE,2019.0,2,5,-3
CH,IS,2016.0,1,2,-1
IT,DO,2015.0,2,1,1
MG,GB,2011.0,1,1,0
NL,CR,2018.0,2,1,1
NZ,AT,2002.0,1,5,-4
JO,ES,2021.0,2,4,-2
GB,BB,2008.0,3,5,-2
CI,SN,2018.0,1,1,0
RS,GR,2012.0,2,1,1
MX,IL,2008.0,2,1,1
EG,NO,2019.0,3,6,-3
NO,TZ,2004.0,2,1,1
EG,PK,2005.0,1,1,0
ZA,TH,2012.0,2,4,-2
HR,PT,2016.0,1,1,0
AR,DK,2012.0,1,3,-2
BG,PL,2001.0,4,2,2
CO,ZA,2015.0,1,1,0
NI,SE,2000.0,2,1,1
LT,RO,2006.0,2,7,-5
MZ,LT,2008.0,3,4,-1
PK,AR,2001.0,1,3,-2
SG,NP,2019.0,2,1,1
AU,ZW,2001.0,1,1,0
TN,JP,2013.0,2,3,-1
AT,LI,2013.0,3,1,2
BE,CM,2008.0,2,1,1
NZ,FI,2016.0,4,6,-2
DE,TZ,2012.0,1,5,-4
FJ,AU,2010.0,5,4,1
NO,MY,2012.0,2,4,-2
PL,FR,2023.0,2,1,1
GH,MY,2018.0,3,5,-2
CY,IT,2013.0,2,1,1
SG,DE,1998.0,1,7,-6
UG,NZ,2012.0,4,2,2
AT,PK,2007.0,1,3,-2
EG,CL,2019.0,1,2,-1
JO,OM,1997.0,2,1,1
BM,US,2015.0,2,2,0
SA,PT,2012.0,2,3,-1
TH,LK,2019.0,1,1,0
CI,GH,2017.0,1,3,-2
DK,IL,2010.0,3,6,-3
SA,IE,2016.0,4,5,-1
JP,BH,2020.0,1,2,-1
MA,BE,2013.0,2,6,-4
RU,GR,2000.0,5,1,4
TR,RO,2022.0,1,4,-3
CR,nan,2021.0,1,1,0
AU,EG,2023.0,3,1,2
PH,IT,2014.0,2,4,-2
NO,RO,2019.0,2,5,-3
KW,CA,2021.0,9,8,1
SE,IL,1998.0,1,2,-1
BR,PY,2006.0,1,3,-2
ES,MA,1999.0,1,3,-2
AT,ZW,2010.0,1,1,0
HU,NZ,2010.0,1,2,-1
AZ,PL,2011.0,1,1,0
QA,HU,2020.0,1,1,0
US,CM,2009.0,5,8,-3
NZ,TR,2014.0,2,2,0
JP,SK,2020.0,2,2,0
UG,FR,2000.0,1,2,-1
IT,ZA,2002.0,2,4,-2
PT,ID,2014.0,1,2,-1
PA,CL,2005.0,2,1,1
CL,BO,2012.0,3,7,-4
CH,TZ,2009.0,1,3,-2
KW,GR,2006.0,1,2,-1
IE,LB,2019.0,1,4,-3
HU,nan,2002.0,3,1,2
PL,KZ,2020.0,1,2,-1
CO,ET,2015.0,2,1,1
UY,VE,2011.0,1,2,-1
GH,ZA,2005.0,1,1,0
GE,GB,2013.0,5,4,1
NL,BG,2001.0,3,1,2
TW,PK,2021.0,2,9,-7
KE,CA,2009.0,5,4,1
TZ,GB,2009.0,2,11,-9
CN,KR,2012.0,265,346,-81
CL,MX,2004.0,54,47,7
IE,JP,2012.0,25,20,5
GB,IN,2021.0,450,483,-33
US,DK,2020.0,318,293,25
FR,JP,2007.0,102,125,-23
NZ,US,2008.0,283,318,-35
JP,ES,2001.0,28,17,11
ES,MX,2004.0,323,347,-24
SG,GB,2018.0,140,181,-41
FR,CA,2015.0,591,540,51
CN,HR,2016.0,5,4,1
CN,SY,2011.0,36,34,2
AT,GB,2011.0,105,98,7
JP,NL,2001.0,39,27,12
HK,US,2008.0,6,12,-6
EC,PE,2019.0,66,58,8
RS,HU,2002.0,1,1,0
NZ,IN,2015.0,42,34,8
nan,TN,2011.0,5,2,3
BE,FR,2016.0,367,360,7
EG,IQ,2018.0,74,47,27
CH,AU,2002.0,39,28,11
CO,MX,2006.0,75,108,-33
US,RU,2005.0,252,342,-90
EC,MX,2016.0,44,97,-53
BR,IE,2016.0,14,4,10
CN,DZ,2019.0,12,6,6
HU,CA,2021.0,14,9,5
PL,NO,2011.0,8,5,3
AE,BE,2014.0,3,1,2
AU,MK,2011.0,50,32,18
AU,AE,2016.0,31,12,19
CZ,nan,2008.0,9,14,-5
CA,IR,2006.0,55,53,2
HU,nan,2005.0,3,2,1
CL,PE,2020.0,88,61,27
LK,IN,2017.0,13,25,-12
CA,AE,2022.0,7,14,-7
PT,CH,2017.0,29,16,13
ID,MY,2014.0,76,160,-84
NL,CA,2004.0,49,45,4
RU,nan,2021.0,44,37,7
FI,FR,2001.0,9,4,5
CN,BE,2005.0,25,47,-22
BD,IT,2019.0,10,7,3
GR,CY,2011.0,51,17,34
RS,US,2009.0,44,53,-9
NL,IR,2013.0,34,34,0
PH,SG,2017.0,17,9,8
DK,CH,2002.0,11,9,2
HR,BA,2014.0,26,38,-12
MK,AT,2016.0,11,12,-1
FR,NO,2013.0,65,62,3
CZ,PL,1999.0,11,11,0
AR,EC,2017.0,48,18,30
PK,IE,2022.0,11,5,6
LK,GB,2008.0,14,17,-3
RU,BE,2021.0,26,11,15
SI,US,2009.0,21,24,-3
CU,US,2006.0,16,15,1
DE,JO,2014.0,21,7,14
ID,GH,2021.0,17,15,2
NG,BR,2020.0,14,11,3
RS,AU,2009.0,4,2,2
TW,FR,2002.0,10,24,-14
DZ,PK,2020.0,3,3,0
OM,GB,2019.0,19,13,6
IQ,GB,2021.0,42,69,-27
NG,DE,2021.0,14,14,0
SY,CA,2020.0,3,1,2
BE,AT,2012.0,16,14,2
NZ,TW,2009.0,6,2,4
NO,US,2008.0,115,143,-28
CA,ZA,2019.0,51,60,-9
NZ,CN,2002.0,20,9,11
AR,EC,2019.0,57,45,12
CN,VN,2002.0,27,41,-14
GR,PT,2018.0,7,3,4
LK,SG,2012.0,1,1,0
RU,CH,2007.0,18,12,6
TW,AT,2013.0,2,6,-4
CH,HR,2010.0,5,6,-1
CN,GH,2015.0,12,14,-2
BD,ID,2014.0,12,8,4
OM,GB,2010.0,4,7,-3
FJ,NZ,2006.0,2,1,1
PH,GB,2003.0,13,6,7
ZA,NZ,2010.0,10,16,-6
DO,ES,2021.0,6,9,-3
JP,SG,2005.0,28,20,8
CA,DK,2005.0,15,20,-5
JP,HU,2003.0,5,15,-10
RS,SK,2012.0,5,7,-2
CH,HU,2009.0,6,24,-18
PL,GB,2000.0,18,30,-12
IN,PK,2002.0,23,13,10
CN,BG,2006.0,4,7,-3
IR,EG,2012.0,7,5,2
CL,NO,2020.0,3,5,-2
PA,DE,2013.0,3,4,-1
IE,FR,2008.0,18,34,-16
ID,DE,2007.0,10,11,-1
DK,CH,2005.0,13,9,4
IN,UA,2021.0,7,1,6
PK,CG,2018.0,5,3,2
LK,IT,2006.0,1,1,0
DE,CM,2006.0,2,1,1
GB,TT,2006.0,4,5,-1
IE,NO,2013.0,6,4,2
GB,IS,2015.0,9,4,5
VE,IT,2005.0,4,5,-1
MX,nan,1999.0,4,4,0
TR,OM,2010.0,2,1,1
SN,CF,2015.0,3,1,2
IT,IS,2009.0,2,1,1
FJ,AU,2019.0,9,6,3
SK,DK,2005.0,2,2,0
MT,GB,2015.0,9,19,-10
AT,RS,2018.0,11,4,7
FI,AR,2008.0,1,1,0
ID,PK,2012.0,9,7,2
UA,BY,2017.0,12,27,-15
KE,MX,2020.0,2,2,0
GR,CZ,2021.0,6,7,-1
IL,TR,2019.0,4,6,-2
BH,GB,2010.0,5,1,4
AR,CU,2021.0,10,15,-5
ET,CN,2022.0,14,19,-5
BD,IR,2012.0,4,2,2
KR,IL,2013.0,6,4,2
PT,KR,2020.0,1,1,0
IN,BE,2004.0,6,7,-1
LY,GB,2006.0,2,2,0
SV,US,2020.0,2,4,-2
NG,IT,2002.0,2,3,-1
MY,DK,2019.0,8,4,4
NZ,DK,2007.0,6,7,-1
MZ,BR,2012.0,5,8,-3
CO,CH,2000.0,2,1,1
SG,DK,1999.0,2,8,-6
CH,HR,2019.0,10,8,2
PK,TW,2019.0,2,2,0
QA,NL,2021.0,2,3,-1
KZ,JP,2000.0,1,1,0
FR,PK,1997.0,1,1,0
PK,AT,2007.0,3,1,2
AE,IQ,2018.0,13,9,4
FR,MG,2009.0,9,6,3
NP,BE,2011.0,2,1,1
DE,PE,2022.0,3,8,-5
ES,SK,2014.0,3,1,2
JM,CN,2019.0,1,1,0
NI,UA,2016.0,5,5,0
PT,CH,2010.0,8,11,-3
FR,GN,2011.0,3,1,2
TR,FI,2004.0,5,2,3
HR,ME,2021.0,2,2,0
DK,IL,2017.0,7,6,1
ZA,PL,2014.0,4,5,-1
TN,NL,2016.0,3,2,1
PA,SE,2008.0,2,2,0
BD,KR,2023.0,3,3,0
SE,LT,2013.0,3,8,-5
ES,HU,2014.0,4,9,-5
GR,UA,2006.0,1,2,-1
FI,BE,1997.0,2,2,0
CH,HR,2017.0,5,8,-3
JP,HK,2003.0,2,16,-14
ZA,QA,2014.0,2,1,1
HK,GB,2006.0,2,2,0
CA,PK,2000.0,2,4,-2
CN,DZ,2017.0,2,4,-2
SN,ES,2015.0,1,1,0
NL,BD,2011.0,2,4,-2
SE,EC,2019.0,1,1,0
MY,NP,2017.0,1,1,0
BF,ML,2001.0,1,1,0
CA,UG,2014.0,4,2,2
AU,MM,2020.0,6,3,3
FR,RU,2002.0,36,64,-28
AT,CN,2013.0,17,13,4
RU,ES,2011.0,19,15,4
SG,AT,2020.0,4,2,2
ZA,DE,2010.0,46,44,2
ZA,PE,2021.0,1,2,-1
AT,NL,2011.0,23,27,-4
EG,BD,2005.0,3,2,1
FR,SK,2002.0,4,9,-5
PS,JO,2016.0,3,7,-4
ES,MT,2009.0,3,2,1
TN,IR,2022.0,2,5,-3
FR,TH,2005.0,8,5,3
IT,,2024.0,96464,0,96464
,KR,1998.0,4034,0,4034
GB,,2016.0,13181,0,13181
US,,2020.0,87523,0,87523
,KR,1997.0,3695,0,3695
,IN,2002.0,8442,0,8442
JP,,2023.0,74200,0,74200
ES,,2024.0,80617,0,80617
NL,,2022.0,11658,0,11658
BE,,2010.0,1413,0,1413
TW,,2015.0,3423,0,3423
,MX,2003.0,3454,0,3454
,SE,2001.0,3014,0,3014
,IR,2011.0,14368,0,14368
,IT,1995.0,18358,0,18358
,PH,2008.0,458,0,458
,NL,2012.0,6431,0,6431
,IN,2005.0,11975,0,11975
AU,,2021.0,9869,0,9869
,JP,2014.0,14214,0,14214
,CN,2020.0,10409,0,10409
BE,,2019.0,3374,0,3374
,HU,2014.0,1268,0,1268
SN,,2022.0,340,0,340
MX,,2015.0,2062,0,2062
,IE,1995.0,1001,0,1001
,TR,2006.0,4963,0,4963
CY,,2023.0,1053,0,1053
,FR,2011.0,16462,0,16462
,nan,1995.0,854,0,854
BE,,2017.0,2804,0,2804
BJ,TH,2013.0,1,0,1
,PE,2005.0,389,0,389
CL,,2015.0,830,0,830
RU,,2011.0,3249,0,3249
EG,,2016.0,987,0,987
KH,BD,2010.0,1,0,1
GR,,2013.0,1526,0,1526
PH,,2009.0,115,0,115
SA,,2019.0,1330,0,1330
,FI,2005.0,1802,0,1802
,BD,2013.0,1218,0,1218
,PT,2007.0,1632,0,1632
,AZ,2007.0,191,0,191
ZW,,2018.0,81,0,81
CU,,2014.0,234,0,234
,FI,2002.0,1676,0,1676
LB,,2017.0,226,0,226
,NZ,2001.0,859,0,859
HU,,2004.0,330,0,330
LU,,2025.0,74,0,74
LB,,2019.0,310,0,310
,EC,2009.0,174,0,174
FJ,IN,2004.0,1,0,1
,XK,1997.0,4,0,4
LT,,2011.0,156,0,156
QA,,2018.0,203,0,203
,PE,2002.0,247,0,247
LV,,2014.0,101,0,101
IS,,2013.0,56,0,56
JM,,2014.0,44,0,44
SK,,2012.0,317,0,317
BG,,2020.0,648,0,648
,KE,2006.0,332,0,332
SA,,2017.0,854,0,854
,LT,2016.0,589,0,589
,TH,2018.0,2265,0,2265
MX,HN,1997.0,3,0,3
,KW,2007.0,167,0,167
NG,MA,2019.0,4,0,4
,IS,2014.0,130,0,130
,ES,2020.0,658,0,658
TH,,2012.0,592,0,592
,UZ,2014.0,141,0,141
,BJ,2009.0,103,0,103
ET,,2016.0,91,0,91
,PY,2017.0,90,0,90
JO,OM,1998.0,2,0,2
MW,,2022.0,173,0,173
,ZM,1999.0,21,0,21
,BY,2003.0,300,0,300
MG,,2022.0,141,0,141
,KZ,2016.0,724,0,724
,CM,2016.0,532,0,532
,SZ,2015.0,12,0,12
RO,,2000.0,91,0,91
LA,,2023.0,72,0,72
MN,,2016.0,46,0,46
LB,,2010.0,78,0,78
JM,BS,2014.0,2,0,2
,PY,2010.0,32,0,32
LU,UA,2018.0,2,0,2
HR,MX,2018.0,2,0,2
AE,,2006.0,32,0,32
FI,MD,1998.0,1,0,1
,NA,2013.0,39,0,39
,CW,2006.0,16,0,16
CN,MW,2021.0,6,0,6
,KP,2017.0,75,0,75
GM,NZ,2016.0,1,0,1
TW,SK,2020.0,2,0,2
,UY,2018.0,171,0,171
IL,KE,2018.0,3,0,3
FR,JM,2019.0,3,0,3
CA,,2008.0,3557,0,3557
,AT,2013.0,2409,0,2409
SA,,2010.0,189,0,189
,MZ,2008.0,44,0,44
CA,BN,2003.0,1,0,1
PE,CH,2011.0,2,0,2
AT,IR,2006.0,4,0,4
HR,PL,2015.0,6,0,6
MA,CM,2017.0,2,0,2
,RE,1996.0,29,0,29
PA,,2003.0,7,0,7
SI,,2013.0,251,0,251
JO,JP,2013.0,1,0,1
JO,PL,2009.0,1,0,1
MD,AR,2010.0,1,0,1
NZ,LB,2018.0,2,0,2
IN,TT,2016.0,5,0,5
UA,CO,2015.0,1,0,1
IR,SK,2019.0,1,0,1
SS,,2004.0,3,0,3
NL,GN,2020.0,1,0,1
,SL,2013.0,21,0,21
IL,PH,1999.0,2,0,2
VE,,2025.0,22,0,22
KZ,,2014.0,52,0,52
BN,OM,2018.0,1,0,1
EG,NP,2017.0,1,0,1
CN,LA,2020.0,2,0,2
PR,US,2021.0,8,0,8
NZ,RU,2006.0,2,0,2
DZ,,2007.0,34,0,34
ET,nan,2005.0,1,0,1
PT,ET,2021.0,1,0,1
MD,,2006.0,11,0,11
EC,AE,2019.0,1,0,1
,TT,2007.0,37,0,37
IE,KW,2019.0,4,0,4
TW,RE,2022.0,1,0,1
SX,,2024.0,7,0,7
BG,PT,1999.0,1,0,1
,BT,2008.0,2,0,2
MY,IE,2023.0,1,0,1
SG,PK,2023.0,1,0,1
SI,LU,2014.0,1,0,1
DE,NA,2018.0,3,0,3
,LI,2003.0,6,0,6
NZ,MV,2014.0,1,0,1
RO,TR,2010.0,1,0,1
IT,NZ,2006.0,4,0,4
,BI,1996.0,9,0,9
MV,nan,2016.0,1,0,1
BE,IS,2020.0,3,0,3
GB,KZ,2022.0,5,0,5
VN,IT,2007.0,3,0,3
FR,QA,2008.0,4,0,4
CG,CM,2005.0,1,0,1
BY,CA,2016.0,3,0,3
,XK,1998.0,6,0,6
RU,VG,2013.0,2,0,2
SG,NP,2010.0,3,0,3
IN,UZ,2010.0,3,0,3
MX,CY,2016.0,1,0,1
,SS,1995.0,10,0,10
KR,DK,2004.0,2,0,2
VN,PH,2006.0,1,0,1
DE,VN,1999.0,2,0,2
SK,PL,2001.0,4,0,4
CO,PT,1997.0,2,0,2
SO,CN,2011.0,1,0,1
SD,SG,2020.0,1,0,1
TR,NO,2000.0,5,0,5
PW,SA,2017.0,1,0,1
PK,CO,2014.0,1,0,1
US,SS,2000.0,5,0,5
JM,CA,2002.0,4,0,4
,PY,2019.0,43,0,43
,CV,2016.0,1,0,1
SV,CO,2001.0,1,0,1
,BI,2004.0,11,0,11
LY,TR,2003.0,1,0,1
TN,AU,2007.0,1,0,1
nan,SY,2009.0,2,0,2
PW,,2018.0,2,0,2
,KY,2014.0,1,0,1
DE,SY,2003.0,2,0,2
TT,SE,2018.0,1,0,1
FR,LY,2017.0,3,0,3
MY,BF,2015.0,1,0,1
MX,KZ,2008.0,1,0,1
CH,CI,2020.0,3,0,3
VE,IT,2002.0,7,0,7
MT,DK,2021.0,2,0,2
MR,SN,2013.0,3,0,3
nan,SS,1998.0,1,0,1
LT,IR,2015.0,1,0,1
,BM,2007.0,1,0,1
TO,KH,2009.0,1,0,1
FR,LY,2019.0,1,0,1
SJ,DE,2016.0,1,0,1
KZ,MX,2006.0,1,0,1
HR,nan,2014.0,1,0,1
NC,,2011.0,3,0,3
AR,,2026.0,2,0,2
CA,KW,2002.0,6,0,6
UA,IL,2008.0,4,0,4
RO,HR,2013.0,2,0,2
FR,UY,2008.0,5,0,5
AR,MY,2021.0,1,0,1
LI,US,2006.0,1,0,1
nan,BY,2004.0,1,0,1
NP,OM,2006.0,1,0,1
,SR,2002.0,8,0,8
LB,NL,2009.0,1,0,1
PT,SK,2020.0,4,0,4
,GP,2003.0,13,0,13
JO,,2006.0,32,0,32
MZ,NL,2004.0,1,0,1
TZ,BH,2002.0,2,0,2
HN,,2004.0,4,0,4
MX,CD,2019.0,2,0,2
AT,GE,2001.0,1,0,1
LY,JP,2003.0,3,0,3
BJ,US,1998.0,1,0,1
IS,CN,2000.0,1,0,1
MY,AF,2019.0,3,0,3
GH,AE,2011.0,1,0,1
AZ,EG,2012.0,1,0,1
BR,EG,2007.0,2,0,2
BJ,MA,2022.0,2,0,2
DZ,BR,2014.0,1,0,1
CO,PK,2016.0,1,0,1
AU,MZ,2021.0,1,0,1
,KP,2019.0,30,0,30
DE,ML,2018.0,3,0,3
,SM,2009.0,1,0,1
RO,FI,2007.0,2,0,2
IR,FI,2007.0,5,0,5
TT,,2015.0,22,0,22
JP,CO,1998.0,1,0,1
UY,LB,2016.0,1,0,1
US,UY,1997.0,3,0,3
DZ,EC,2013.0,2,0,2
CL,TW,2009.0,1,0,1
NP,MY,2006.0,1,0,1
CA,BF,2012.0,3,0,3
LV,CN,2018.0,2,0,2
DZ,PS,2020.0,2,0,2
LK,KE,2013.0,1,0,1
MM,,2014.0,13,0,13
,MQ,2002.0,7,0,7
SE,PE,2004.0,2,0,2
CM,CA,2000.0,1,0,1
KE,SN,2022.0,2,0,2
CY,FR,1998.0,1,0,1
KH,,2002.0,4,0,4
MW,IE,2018.0,1,0,1
,MQ,2005.0,11,0,11
BY,HU,2005.0,1,0,1
,SR,2005.0,2,0,2
MA,HK,2009.0,2,0,2
TZ,BJ,2010.0,1,0,1
BD,DZ,2014.0,1,0,1
FJ,NO,2019.0,1,0,1
GA,BF,2020.0,2,0,2
BY,GB,2008.0,4,0,4
VE,HU,2013.0,1,0,1
KZ,CA,2006.0,1,0,1
GN,GB,2002.0,1,0,1
TZ,TW,2016.0,1,0,1
GB,SY,2007.0,4,0,4
GM,BE,2004.0,3,0,3
GY,IN,2020.0,2,0,2
AR,KR,2017.0,1,0,1
AR,KR,2010.0,2,0,2
US,SX,2006.0,1,0,1
WS,,2018.0,4,0,4
MS,,2023.0,4,0,4
BO,EC,2018.0,3,0,3
RS,QA,2017.0,3,0,3
SI,EE,2015.0,1,0,1
CA,ID,1997.0,2,0,2
JO,HR,2020.0,2,0,2
SA,IR,2010.0,4,0,4
CN,ZM,2007.0,1,0,1
NP,MV,2018.0,1,0,1
PS,IE,2018.0,1,0,1
ES,UZ,2020.0,2,0,2
,NI,2003.0,13,0,13
AM,CN,2016.0,1,0,1
EE,,1998.0,7,0,7
SE,MZ,1999.0,1,0,1
,RE,2004.0,14,0,14
,GY,2016.0,7,0,7
KY,,2012.0,1,0,1
TW,MW,2015.0,1,0,1
GE,KR,2000.0,1,0,1
PT,BO,2009.0,1,0,1
DJ,US,2013.0,1,0,1
UY,,1998.0,4,0,4
CH,KG,2014.0,1,0,1
UG,IN,2022.0,1,0,1
MD,GB,2016.0,3,0,3
IS,IL,2019.0,1,0,1
MA,AT,2016.0,2,0,2
NP,GW,2011.0,1,0,1
VE,NI,2003.0,1,0,1
JM,CH,2013.0,3,0,3
GE,FI,1999.0,1,0,1
GR,RS,2009.0,3,0,3
TR,AM,2000.0,1,0,1
GR,LT,2018.0,1,0,1
ZM,NL,2013.0,2,0,2
CH,LI,2011.0,2,0,2
JP,OM,2010.0,2,0,2
BW,,2001.0,6,0,6
TN,LY,2017.0,1,0,1
SE,SD,2004.0,3,0,3
RE,MG,2022.0,2,0,2
QA,GR,2006.0,1,0,1
SE,EC,2010.0,1,0,1
JM,NL,2018.0,1,0,1
IE,IQ,2022.0,2,0,2
CA,EE,2003.0,1,0,1
NI,BR,2007.0,1,0,1
US,SD,2008.0,2,0,2
CU,FI,2000.0,1,0,1
PH,SN,2018.0,1,0,1
RS,FI,2014.0,1,0,1
EG,LU,2022.0,1,0,1
MO,CN,2006.0,1,0,1
KW,ES,2022.0,2,0,2
CN,AZ,2016.0,3,0,3
JO,TR,2010.0,3,0,3
IN,KN,2016.0,1,0,1
LV,PH,2012.0,2,0,2
EG,SD,2005.0,1,0,1
MA,CM,2019.0,3,0,3
EG,IR,2010.0,4,0,4
MG,BR,2011.0,1,0,1
AF,BH,2020.0,1,0,1
NC,CA,2017.0,3,0,3
IS,IR,2012.0,1,0,1
SJ,ES,2020.0,1,0,1
VN,EG,2015.0,3,0,3
BR,TH,2006.0,1,0,1
MR,,2008.0,2,0,2
,NC,2008.0,16,0,16
IM,IN,2009.0,1,0,1
AO,,2005.0,2,0,2
KH,,2005.0,3,0,3
LT,MD,2017.0,1,0,1
SL,,2006.0,1,0,1
ET,TZ,2013.0,1,0,1
MX,JM,2007.0,1,0,1
,GM,2000.0,7,0,7
LB,PS,2011.0,1,0,1
TW,SI,2002.0,3,0,3
CH,PY,2020.0,1,0,1
MX,AE,2011.0,1,0,1
SY,MN,2018.0,1,0,1
AU,UA,1997.0,1,0,1
GN,ML,2011.0,2,0,2
NG,SL,2020.0,1,0,1
IL,ZW,2014.0,1,0,1
PL,LI,2001.0,1,0,1
CO,UG,2021.0,1,0,1
TW,CZ,2004.0,1,0,1
LK,BN,2022.0,1,0,1
AL,ET,2012.0,1,0,1
SZ,MW,2018.0,1,0,1
CG,NZ,2018.0,1,0,1
JP,KH,2015.0,3,0,3
AE,IT,2001.0,1,0,1
FR,TZ,1999.0,1,0,1
QA,BA,2011.0,1,0,1
RW,NG,2009.0,1,0,1
TN,CZ,2019.0,4,0,4
CH,AM,2020.0,2,0,2
BO,BR,2011.0,4,0,4
LS,IN,2007.0,1,0,1
JO,PA,2007.0,1,0,1
nan,EG,2007.0,1,0,1
PH,UA,2009.0,2,0,2
BJ,UY,2012.0,1,0,1
CO,PR,2016.0,2,0,2
NP,SG,2009.0,1,0,1
MY,RU,2008.0,3,0,3
CG,BF,2006.0,1,0,1
MN,KE,2020.0,1,0,1
IT,VG,2015.0,1,0,1
IN,UZ,2019.0,4,0,4
CA,ID,1998.0,1,0,1
VG,NO,2004.0,1,0,1
CM,SE,2019.0,2,0,2
IE,KW,2017.0,3,0,3
HU,CL,2002.0,1,0,1
BI,CM,2011.0,1,0,1
SI,AR,2007.0,1,0,1
TO,,2024.0,2,0,2
nan,LB,2006.0,1,0,1
BA,EG,2015.0,1,0,1
SE,KE,1999.0,2,0,2
TH,LK,2010.0,1,0,1
MQ,MD,2001.0,1,0,1
LV,BE,2008.0,2,0,2
PH,PL,2015.0,3,0,3
BY,NO,2005.0,1,0,1
AF,GB,2021.0,1,0,1
CH,GA,2008.0,1,0,1
KH,VN,2012.0,1,0,1
GB,SA,2024.0,1,0,1
GB,MQ,2007.0,2,0,2
CA,BJ,2013.0,1,0,1
JP,CI,2017.0,2,0,2
FR,EE,2005.0,3,0,3
AM,BE,2009.0,2,0,2
IN,ML,2001.0,1,0,1
CI,GN,2004.0,1,0,1
KW,MK,2001.0,1,0,1
ES,CV,2018.0,1,0,1
MT,NL,2017.0,1,0,1
RU,ZW,2012.0,4,0,4
PS,,2003.0,2,0,2
ES,AO,2000.0,3,0,3
CH,UG,2005.0,2,0,2
UA,PA,2013.0,1,0,1
CI,NL,2001.0,1,0,1
PE,SA,2021.0,1,0,1
BY,PT,2007.0,1,0,1
KE,ID,1997.0,1,0,1
SG,KG,2016.0,1,0,1
MD,DZ,2006.0,2,0,2
UG,TZ,2008.0,2,0,2
US,SJ,2016.0,1,0,1
SM,IT,2008.0,1,0,1
EG,RO,2016.0,1,0,1
CI,GH,2019.0,1,0,1
SE,CU,2000.0,1,0,1
CA,MA,1999.0,3,0,3
CD,GH,2019.0,1,0,1
CZ,EG,2001.0,2,0,2
BW,CA,2008.0,2,0,2
KG,DE,2021.0,1,0,1
NZ,IL,2021.0,3,0,3
LA,NZ,2008.0,1,0,1
SK,IE,2009.0,1,0,1
IL,LB,2021.0,2,0,2
MX,EG,2010.0,1,0,1
MK,LU,2015.0,1,0,1
PH,LK,2022.0,1,0,1
FI,LB,2004.0,1,0,1
CN,MO,2003.0,1,0,1
TW,PA,2011.0,2,0,2
KR,BG,2006.0,1,0,1
LS,GR,2003.0,1,0,1
TG,BF,2019.0,1,0,1
EC,VN,2018.0,1,0,1
ID,NZ,2007.0,1,0,1
IE,TT,2004.0,2,0,2
UY,IE,2016.0,1,0,1
AL,MK,2013.0,2,0,2
IN,HR,1999.0,1,0,1
ES,PR,2015.0,1,0,1
ID,GA,2013.0,1,0,1
MD,AU,2014.0,1,0,1
ST,US,1997.0,1,0,1
MU,DE,2017.0,1,0,1
IL,MA,2009.0,1,0,1
BE,UZ,2020.0,1,0,1
RU,NI,2009.0,1,0,1
BY,HU,2002.0,2,0,2
ID,ZA,2008.0,4,0,4
MC,AU,2014.0,1,0,1
SN,BR,2014.0,1,0,1
AR,PR,2003.0,1,0,1
PK,LT,2019.0,3,0,3
TT,NZ,2020.0,1,0,1
DE,BI,2000.0,1,0,1
VN,TT,2017.0,1,0,1
SK,DK,2002.0,2,0,2
BE,BW,2016.0,1,0,1
HU,LY,2007.0,1,0,1
HN,US,2003.0,2,0,2
ZA,HK,2001.0,1,0,1
NC,RE,2016.0,1,0,1
BE,BO,2004.0,1,0,1
CF,BF,2017.0,1,0,1
nan,PA,2011.0,1,0,1
LK,PK,2012.0,1,0,1
SE,KP,1997.0,2,0,2
SI,TR,2008.0,1,0,1
KW,CH,2016.0,2,0,2
CO,DO,2007.0,3,0,3
ET,PR,2003.0,1,0,1
SN,TG,2010.0,1,0,1
TH,KH,2012.0,1,0,1
IR,LT,2017.0,1,0,1
ET,IN,2000.0,1,0,1
SX,HT,2015.0,1,0,1
CM,KR,2009.0,1,0,1
CH,MY,2009.0,1,0,1
AU,MT,2013.0,5,0,5
CA,NP,2006.0,1,0,1
BY,ZA,2008.0,1,0,1
JE,TT,2003.0,1,0,1
UA,TR,2000.0,5,0,5
CH,NE,2015.0,2,0,2
SV,AR,2011.0,1,0,1
RE,RU,2016.0,1,0,1
EG,SA,2024.0,1,0,1
BH,AU,2007.0,1,0,1
FR,MZ,2007.0,2,0,2
NG,ML,2022.0,1,0,1
AT,MY,2022.0,1,0,1
GY,US,2002.0,3,0,3
AU,LT,2017.0,1,0,1
MN,TW,2012.0,3,0,3
nan,SA,2018.0,5,2,3
SE,BG,2002.0,1,1,0
EG,KR,2022.0,6,7,-1
VN,DE,1998.0,2,3,-1
HU,CZ,1997.0,1,1,0
DK,VN,2012.0,2,2,0
EC,PE,2010.0,3,4,-1
PH,IR,2019.0,1,2,-1
RO,BG,2007.0,2,4,-2
CM,PK,2003.0,1,1,0
SY,GB,2014.0,2,10,-8
OM,FR,2005.0,1,2,-1
US,BF,2008.0,1,2,-1
US,MU,2014.0,1,1,0
NZ,nan,2018.0,3,5,-2
MC,US,2012.0,1,1,0
MY,NO,2010.0,4,2,2
MD,MA,2014.0,3,1,2
EE,ES,2018.0,2,2,0
KE,TR,2018.0,2,1,1
TR,SG,2005.0,1,1,0
JP,DZ,2019.0,3,3,0
TG,BF,2017.0,1,1,0
BR,NG,2007.0,1,1,0
CA,KW,2005.0,1,5,-4
KR,nan,2023.0,3,2,1
KW,MY,2014.0,3,2,1
TR,UA,2017.0,3,2,1
PL,LT,2001.0,2,1,1
NO,TH,2018.0,4,2,2
JO,BH,2000.0,1,3,-2
LV,LT,2015.0,1,4,-3
MG,US,2005.0,1,4,-3
HU,GR,2021.0,1,1,0
EC,IL,2018.0,1,6,-5
BD,IE,2004.0,2,1,1
PL,ZA,2022.0,2,2,0
CL,SE,2003.0,1,4,-3
CD,CI,2015.0,1,1,0
ML,FR,2000.0,1,1,0
KR,NO,2001.0,3,1,2
SJ,NO,2000.0,1,2,-1
UY,IT,2007.0,2,4,-2
GR,DK,1998.0,1,1,0
TH,CZ,2020.0,1,1,0
HR,FR,2007.0,2,4,-2
BB,JM,2015.0,2,8,-6
UG,GH,2017.0,1,1,0
GB,PA,2008.0,1,1,0
MY,UZ,2013.0,2,2,0
TZ,BJ,2017.0,1,2,-1
LY,FR,2014.0,1,2,-1
AU,LK,2006.0,2,4,-2
PK,BE,2022.0,1,5,-4
BO,PE,2014.0,3,3,0
ET,NO,2009.0,2,3,-1
PG,CN,2011.0,1,1,0
LB,MY,1999.0,1,1,0
VN,NO,2015.0,1,3,-2
PK,TW,2017.0,2,2,0
IE,UA,2014.0,1,2,-1
BH,SA,2011.0,1,2,-1
FR,PH,2008.0,3,3,0
LB,JO,2017.0,1,1,0
BR,NI,2020.0,2,1,1
AU,TZ,2013.0,1,1,0
UZ,BR,2008.0,1,1,0
BE,AE,2020.0,4,2,2
SA,SE,2015.0,4,8,-4
JM,CA,2005.0,1,4,-3
BY,JP,2008.0,1,2,-1
JP,CR,2007.0,1,1,0
SA,TW,2011.0,1,3,-2
PS,PK,2016.0,1,4,-3
PL,DK,2021.0,5,10,-5
SJ,DK,2015.0,1,1,0
PY,US,2007.0,1,1,0
BJ,NG,2012.0,3,1,2
TW,TR,1997.0,1,3,-2
BA,SI,2009.0,1,2,-1
HU,XK,2016.0,1,1,0
UZ,US,2020.0,2,8,-6
MA,RU,2012.0,2,1,1
SG,TR,2005.0,1,1,0
FR,LY,2010.0,1,1,0
KW,TR,2004.0,1,2,-1
CL,NZ,2007.0,1,1,0
VE,GB,2014.0,1,5,-4
GB,BY,2000.0,1,1,0
JO,RU,2020.0,1,2,-1
UG,GH,2019.0,2,4,-2
LK,GR,2022.0,1,4,-3
DK,GW,2008.0,1,3,-2
FI,CH,1997.0,1,8,-7
SD,NL,2003.0,1,1,0
IR,TW,2007.0,1,1,0
CL,IE,2001.0,1,1,0
DZ,SG,2022.0,1,2,-1
DZ,MA,2000.0,1,1,0
HR,GR,2020.0,1,1,0
AE,KW,2014.0,1,1,0
BE,DZ,2022.0,2,1,1
AE,CY,2021.0,1,2,-1
CR,BO,2002.0,1,1,0
BF,CA,2021.0,3,1,2
SN,TG,2017.0,2,1,1
CL,AT,2012.0,3,4,-1
IE,PE,2014.0,1,1,0
ML,CA,2012.0,1,2,-1
US,WS,2018.0,1,3,-2
TR,AT,1997.0,1,4,-3
DK,TR,2009.0,1,6,-5
SY,MA,2013.0,1,1,0
CO,SV,2008.0,1,3,-2
GA,GB,2017.0,1,1,0
JP,HR,2003.0,1,1,0
RO,TR,2017.0,1,3,-2
LR,US,2018.0,1,5,-4
IR,RU,2013.0,3,11,-8
CO,IR,2009.0,1,1,0
CR,EC,2011.0,1,1,0
AM,PL,2017.0,1,1,0
ID,CR,2019.0,1,1,0
TG,BE,2019.0,1,1,0
KZ,AZ,2022.0,1,1,0
RO,nan,2021.0,2,1,1
CA,CM,2010.0,1,2,-1
BR,KR,2004.0,1,4,-3
CR,GB,2022.0,1,1,0
GE,BR,2018.0,1,2,-1
TW,GR,2013.0,1,1,0
GE,RU,2000.0,4,1,3
EG,SD,2002.0,1,1,0
MZ,FR,2004.0,1,2,-1
ID,BE,2004.0,1,2,-1
UG,NG,1999.0,2,1,1
BE,ZW,2005.0,1,1,0
ID,KH,2018.0,1,1,0
MX,PY,2010.0,2,3,-1
SG,NG,2019.0,1,1,0
JM,FR,2018.0,1,1,0
AU,LT,2019.0,1,1,0
VE,SE,2009.0,2,2,0
CO,KR,2007.0,1,3,-2
IT,NP,2016.0,2,3,-1
CL,GT,2013.0,1,1,0
RS,QA,2019.0,1,5,-4
HU,IQ,2023.0,1,1,0
IT,LK,2018.0,2,1,1
HU,IL,2006.0,2,5,-3
SZ,ZA,2004.0,1,1,0
AU,HR,2012.0,2,2,0
ML,CH,2007.0,1,1,0
RS,BE,2006.0,1,2,-1
GR,EE,2014.0,1,1,0
AR,RS,1998.0,1,1,0
SK,NO,2016.0,1,1,0
IT,SN,2021.0,1,2,-1
UA,SI,2016.0,1,2,-1
nan,FR,2023.0,2,4,-2
TZ,CN,2014.0,1,5,-4
ES,PL,2023.0,1,3,-2
SE,RO,1997.0,1,2,-1
IE,BG,2005.0,1,1,0
FR,JM,2017.0,1,1,0
PA,BR,2003.0,1,2,-1
IT,VA,2020.0,1,2,-1
CA,GY,2008.0,1,1,0
NL,SI,2000.0,1,5,-4
BE,PH,2010.0,2,3,-1
PE,BE,2018.0,1,6,-5
MY,JO,2007.0,1,5,-4
CH,CD,2019.0,1,1,0
AE,NZ,2022.0,1,1,0
ZM,FI,2018.0,1,2,-1
RS,PT,2013.0,2,2,0
SE,IL,1997.0,1,1,0
GT,CO,2009.0,1,2,-1
CO,KE,2016.0,1,5,-4
MW,IN,2014.0,1,1,0
RU,LU,2012.0,1,2,-1
CM,CN,2016.0,1,4,-3
CR,BR,1997.0,1,1,0
CA,TZ,2018.0,2,1,1
QA,NG,2022.0,2,3,-1
SL,DE,2019.0,1,1,0
TH,TR,2016.0,2,2,0
JM,CN,2010.0,1,1,0
AZ,BY,2010.0,1,1,0
VE,PY,2012.0,1,1,0
MY,KW,2009.0,1,1,0
AE,TW,2021.0,1,3,-2
TW,IE,1997.0,1,2,-1
ET,NP,2016.0,1,2,-1
PF,US,2004.0,1,1,0
TH,LK,2017.0,2,1,1
FR,JM,2010.0,1,1,0
LV,FI,2022.0,1,1,0
GH,nan,2020.0,2,6,-4
BW,JP,2017.0,1,1,0
TW,BR,2014.0,1,1,0
XK,CZ,2015.0,1,1,0
IT,AL,2022.0,1,4,-3
UG,KE,2001.0,1,1,0
PH,TR,2003.0,1,1,0
KW,PK,2003.0,2,1,1
AE,NG,2020.0,1,6,-5
LT,MD,2010.0,1,1,0
UG,PE,2017.0,1,1,0
FR,SD,2005.0,1,1,0
IQ,CA,2010.0,1,2,-1
VE,nan,2006.0,1,1,0
IQ,KW,2012.0,1,2,-1
CZ,RS,1999.0,1,8,-7
SI,JP,2002.0,1,3,-2
SG,IR,2007.0,1,1,0
SD,KR,2015.0,1,1,0
nan,RS,2012.0,1,2,-1
GR,DK,1997.0,1,6,-5
BW,JP,2019.0,1,1,0
BD,BN,2020.0,1,3,-2
LV,GB,2021.0,1,6,-5
OM,NP,2022.0,1,1,0
VN,JP,2001.0,3,10,-7
RO,CH,2003.0,2,1,1
EG,NP,2019.0,1,1,0
TZ,ZA,2009.0,2,2,0
JO,GR,2015.0,1,2,-1
BE,IL,2000.0,3,7,-4
AE,CZ,2012.0,2,1,1
ID,MK,2016.0,3,6,-3
SG,FR,2003.0,1,5,-4
MY,CM,2020.0,1,1,0
TW,TR,1998.0,1,5,-4
DK,LT,2013.0,2,4,-2
KW,ZA,2007.0,1,1,0
NZ,AT,2005.0,1,2,-1
SI,HR,2023.0,1,1,0
BE,PH,2019.0,2,5,-3
XK,US,2022.0,2,1,1
CL,SV,2019.0,1,3,-2
TH,MM,2011.0,1,3,-2
NL,LT,2014.0,1,2,-1
NI,ES,2013.0,1,4,-3
NZ,BG,2021.0,1,1,0
IL,RO,2015.0,1,3,-2
ET,ER,2018.0,1,1,0
HU,MA,2008.0,1,2,-1
KE,AE,2021.0,1,1,0
RO,TW,2018.0,1,1,0
DK,AE,2016.0,1,2,-1
AU,SS,2006.0,1,1,0
MT,NL,2010.0,1,0,1
IT,CM,2013.0,2,0,2
GB,MS,1997.0,2,0,2
SD,ES,2021.0,1,0,1
HR,SE,1999.0,2,0,2
TN,NE,2012.0,1,0,1
GB,PS,1997.0,1,0,1
PL,LB,2006.0,1,0,1
IL,GR,2007.0,2,0,2
UY,KE,2008.0,1,0,1
PY,,2004.0,2,0,2
AZ,CZ,2020.0,1,0,1
PE,ZA,2011.0,1,0,1
BD,BG,2001.0,1,0,1
MZ,DK,2018.0,1,0,1
KZ,AM,2019.0,1,0,1
HU,JO,2003.0,1,0,1
BR,PR,2014.0,3,0,3
HU,TR,2005.0,1,0,1
SG,TN,2009.0,1,0,1
BE,ZW,2002.0,1,0,1
nan,KE,2000.0,1,0,1
JM,AE,2017.0,1,0,1
US,CW,1997.0,1,0,1
ET,MZ,2016.0,1,0,1
VE,TT,2015.0,1,0,1
NG,SD,2006.0,2,0,2
CH,HK,2004.0,2,0,2
LK,DK,2002.0,1,0,1
CY,KZ,2016.0,2,0,2
TJ,ZW,2020.0,1,0,1
VG,DE,2008.0,1,0,1
CD,UZ,2021.0,1,0,1
IN,DZ,2013.0,2,0,2
ES,MD,2004.0,1,0,1
JM,GP,1997.0,2,0,2
RS,KZ,2008.0,1,0,1
LI,IT,2014.0,1,0,1
BG,TW,2019.0,1,0,1
CZ,KE,2014.0,1,0,1
SK,TR,2006.0,1,0,1
ET,SD,2008.0,1,0,1
BA,FR,2008.0,1,0,1
PA,VE,2006.0,1,0,1
RS,NO,2010.0,5,0,5
BF,MR,2019.0,1,0,1
nan,OM,2006.0,1,0,1
SA,DO,2016.0,1,0,1
PT,NA,2020.0,1,0,1
PT,IR,2023.0,1,0,1
nan,BJ,2020.0,2,0,2
UY,LU,2014.0,1,0,1
PH,PS,2008.0,1,0,1
IN,ZM,2015.0,2,0,2
HU,TR,2002.0,2,0,2
AE,QA,2009.0,1,0,1
TN,CM,2016.0,1,0,1
BO,,2004.0,2,0,2
,VU,2012.0,2,0,2
CO,JE,2005.0,1,0,1
SA,YE,2006.0,1,0,1
,KP,2010.0,1,0,1
PT,PY,2007.0,2,0,2
XK,AL,2012.0,1,0,1
TR,UA,2010.0,1,0,1
AO,,2002.0,2,0,2
JP,BY,2014.0,1,0,1
PS,LB,2007.0,1,0,1
MD,IE,2022.0,2,0,2
US,AL,2007.0,1,0,1
VN,ET,2014.0,1,0,1
MY,DK,2010.0,1,0,1
RO,PK,2017.0,1,0,1
MG,LU,2008.0,1,0,1
JP,ZW,2019.0,2,0,2
RE,BE,2021.0,1,0,1
ZA,TT,2018.0,1,0,1
SZ,ZW,2005.0,1,0,1
FR,NP,2014.0,1,0,1
NL,ML,2020.0,1,0,1
ML,MW,2021.0,1,0,1
HR,NZ,2018.0,1,0,1
AT,GA,2004.0,1,0,1
JP,BS,2021.0,1,0,1
ZM,TH,2008.0,1,0,1
CL,IN,2006.0,1,0,1
IN,PA,2008.0,1,0,1
PT,LU,2020.0,2,0,2
GR,PK,2014.0,2,0,2
IT,LI,2008.0,1,0,1
SG,BA,2015.0,1,0,1
KZ,TJ,2016.0,1,0,1
PG,,2009.0,4,0,4
FR,PY,2020.0,3,0,3
PT,NO,2023.0,1,0,1
nan,BA,2009.0,2,0,2
TZ,SS,2020.0,2,0,2
CO,GA,2014.0,1,0,1
IS,PT,2020.0,1,0,1
TN,ID,2015.0,2,0,2
VG,nan,2010.0,1,0,1
TR,XK,2013.0,1,0,1
IE,MG,2019.0,1,0,1
GA,CI,2008.0,1,0,1
HU,SI,2009.0,1,0,1
ZW,IN,2013.0,1,0,1
KE,FR,2023.0,1,0,1
ER,,2012.0,1,0,1
AO,JP,2022.0,1,0,1
PK,AZ,2012.0,1,0,1
UG,PH,2017.0,1,0,1
AR,SA,2009.0,1,0,1
RE,IT,2015.0,1,0,1
ZM,IT,2013.0,1,0,1
TZ,BJ,2019.0,1,0,1
CM,NL,2008.0,2,0,2
TW,JO,2005.0,1,0,1
HU,AE,1999.0,1,0,1
LK,CM,2017.0,1,0,1
GH,SK,1997.0,1,0,1
PE,AM,2015.0,1,0,1
AE,NA,2003.0,1,0,1
AO,MX,2007.0,1,0,1
PT,TH,2011.0,2,0,2
UA,NZ,1997.0,1,0,1
FI,GE,1998.0,1,0,1
GR,BY,2005.0,1,0,1
TW,LT,2003.0,1,0,1
CA,PS,1999.0,1,0,1
FI,AE,2011.0,1,0,1
BW,IN,1997.0,1,0,1
CO,PT,1998.0,1,0,1
VN,RU,1997.0,1,0,1
LK,KH,1997.0,1,0,1
PH,EE,2011.0,1,0,1
IR,CY,2010.0,2,0,2
OM,CR,2009.0,1,0,1
BR,BY,2005.0,2,0,2
IQ,ES,2021.0,1,0,1
PK,LV,2018.0,1,0,1
KW,LB,2007.0,1,0,1
AT,LV,2008.0,1,0,1
AZ,AU,2012.0,1,0,1
KE,CI,2021.0,1,0,1
AZ,CH,2017.0,1,0,1
BB,FR,2013.0,1,0,1
BO,VE,2000.0,1,0,1
CU,GT,2014.0,1,0,1
VN,SV,2012.0,1,0,1
FR,CW,2014.0,1,0,1
DE,UY,2001.0,1,0,1
PK,GH,2021.0,1,0,1
BT,CA,2012.0,1,0,1
LK,NZ,2012.0,1,0,1
VN,PT,2011.0,1,0,1
LS,NG,2002.0,1,0,1
LI,AT,2000.0,1,0,1
NO,PS,2012.0,1,0,1
SN,TG,2019.0,1,0,1
AU,LT,2010.0,1,0,1
MX,NG,2020.0,3,0,3
BG,GE,2015.0,1,0,1
GR,IN,2002.0,1,0,1
CZ,XK,2008.0,1,0,1
IS,LK,2013.0,1,0,1
PT,YE,2021.0,1,0,1
GB,AF,2022.0,1,0,1
NZ,JM,2022.0,1,0,1
AF,KW,2020.0,1,0,1
BR,BY,2002.0,1,0,1
AO,nan,2019.0,1,0,1
ZW,FR,2022.0,1,0,1
BF,UZ,2008.0,1,0,1
KG,KZ,2005.0,1,0,1
UA,NZ,1998.0,1,0,1
BN,NL,2016.0,1,0,1
BN,CN,2001.0,1,0,1
CU,PA,2007.0,1,0,1
CL,HN,2012.0,1,0,1
BF,GM,2006.0,1,0,1
AM,IL,2012.0,1,0,1
MG,MC,2014.0,1,0,1
TL,US,2014.0,1,0,1
ZW,DE,2023.0,1,0,1
KZ,MA,2021.0,1,0,1
BY,TW,2021.0,1,0,1
IL,EC,2016.0,1,0,1
HU,AM,2021.0,1,0,1
CL,NG,2016.0,1,0,1
JE,US,2005.0,1,0,1
CI,RE,2020.0,1,0,1
ES,OM,2011.0,1,0,1
VN,MM,2022.0,2,0,2
MW,KE,2013.0,1,0,1
BY,DK,2008.0,1,0,1
IQ,IT,2000.0,1,0,1
nan,SN,2007.0,1,0,1
ML,,2003.0,1,0,1
MY,LU,2017.0,1,0,1
RU,MM,2022.0,2,0,2
TW,UZ,2022.0,1,0,1
BW,NL,2020.0,1,0,1
NZ,NO,2004.0,1,0,1
FR,SS,2005.0,1,0,1
PL,JO,2015.0,1,0,1
FI,XK,2015.0,1,0,1
KR,CL,2004.0,1,0,1
NE,BJ,2004.0,1,0,1
,JE,2009.0,1,0,1
PL,MT,1998.0,1,0,1
CO,PA,2000.0,1,0,1
QA,IE,2022.0,1,0,1
AT,VE,1998.0,1,0,1
EG,PK,2002.0,1,0,1
IE,LV,2007.0,1,0,1
ML,GB,1997.0,1,0,1
MR,ML,2008.0,1,0,1
ML,MA,2013.0,1,0,1
TN,CZ,2010.0,1,0,1
AT,LB,2020.0,1,0,1
ZM,ES,2018.0,1,0,1
KH,CN,2021.0,1,0,1
,YE,2020.0,8,0,8
RS,UA,2006.0,1,0,1
IT,CR,2007.0,1,0,1
AU,MV,2016.0,1,0,1
CZ,IS,2010.0,1,0,1
EC,SA,2015.0,1,0,1
TZ,SE,2003.0,1,0,1
IL,CL,2023.0,1,0,1
SG,NG,2017.0,1,0,1
IR,LT,2019.0,1,0,1
SA,AZ,2017.0,1,0,1
XK,CH,2020.0,1,0,1
LS,AE,2019.0,1,0,1
NC,CA,2019.0,1,0,1
SE,AZ,2022.0,1,0,1
MW,UG,2022.0,1,0,1
PG,BE,2017.0,1,0,1
CZ,ME,2015.0,1,0,1
BH,KW,2009.0,1,0,1
PT,BR,2018.0,1249,1140,109
AT,ES,2003.0,11,5,6
PT,US,2015.0,195,208,-13
US,CO,2018.0,393,397,-4
AR,MX,2014.0,163,111,52
FR,CN,2015.0,203,160,43
NZ,US,2013.0,336,357,-21
US,IL,2005.0,317,453,-136
DE,CH,2002.0,440,358,82
IT,AT,2004.0,25,22,3
AT,BR,2013.0,17,13,4
SG,GB,2010.0,71,119,-48
CH,ES,2001.0,38,26,12
BD,US,2017.0,195,119,76
AU,US,2011.0,1961,2333,-372
IE,GB,2005.0,175,236,-61
SE,FR,2022.0,59,57,2
ES,MX,2014.0,829,700,129
TW,CN,2009.0,1157,772,385
CA,AU,2014.0,429,336,93
CH,SE,2006.0,38,35,3
NZ,AU,2000.0,80,69,11
AE,US,2009.0,22,48,-26
GB,KR,2017.0,114,98,16
KR,NG,2018.0,8,15,-7
PT,ES,2019.0,187,208,-21
DE,US,2015.0,2505,2512,-7
CA,NL,2012.0,101,100,1
US,CN,1999.0,1550,1538,12
AT,CH,2012.0,117,97,20
US,IN,2023.0,51,130,-79
NL,US,2011.0,645,690,-45
PL,CA,2013.0,37,42,-5
HU,GB,2015.0,65,59,6
MY,NO,2018.0,3,3,0
BR,ES,2003.0,148,148,0
IT,DE,2011.0,278,204,74
DE,FI,2013.0,62,69,-7
SG,GB,2017.0,131,166,-35
IT,CH,2009.0,248,135,113
GB,NZ,2011.0,267,201,66
PT,ES,2017.0,166,227,-61
ES,CL,2014.0,400,290,110
ES,IL,2005.0,8,11,-3
BR,CA,2018.0,276,285,-9
KR,CN,2018.0,331,275,56
BR,MX,2014.0,94,124,-30
ES,AR,2014.0,388,340,48
GR,US,2008.0,170,178,-8
DK,IE,2017.0,9,10,-1
AU,GB,2003.0,836,765,71
HR,DE,2020.0,23,24,-1
US,NZ,2007.0,309,238,71
US,PH,2007.0,304,359,-55
KR,US,2015.0,1170,1257,-87
CL,JP,2004.0,6,1,5
DK,IR,2020.0,19,40,-21
HK,US,2013.0,17,10,7
BE,GB,2021.0,130,138,-8
BR,DK,2020.0,33,31,2
nan,AU,2005.0,13,16,-3
UA,JP,2008.0,7,4,3
TR,RS,2012.0,83,82,1
NL,DE,2002.0,169,194,-25
nan,BR,2010.0,84,48,36
BD,SA,2019.0,35,31,4
CA,JP,2003.0,82,111,-29
BR,CL,2006.0,38,31,7
ET,GB,2017.0,7,12,-5
US,ZA,1997.0,77,87,-10
US,BR,2003.0,484,428,56
IE,GB,2002.0,132,203,-71
SG,AU,2016.0,111,133,-22
KR,ET,2013.0,86,145,-59
nan,GB,2020.0,85,109,-24
NO,US,2013.0,132,161,-29
DE,CH,2005.0,524,407,117
JP,ID,2006.0,57,25,32
RU,UA,2020.0,545,696,-151
FR,CH,2002.0,237,204,33
AT,CN,2008.0,13,6,7
CH,UA,2019.0,10,3,7
ES,US,2011.0,953,885,68
PL,NL,2008.0,23,17,6
US,IE,2001.0,205,163,42
FR,MD,2011.0,49,56,-7
IR,US,2013.0,578,269,309
CL,US,2009.0,141,162,-21
CL,CO,2008.0,117,85,32
NL,GB,2012.0,273,258,15
ID,CN,2015.0,81,105,-24
AR,UY,2006.0,14,14,0
CH,DE,2021.0,675,719,-44
US,AE,2013.0,74,42,32
nan,BR,2017.0,114,136,-22
DE,JP,2011.0,192,210,-18
GB,KR,2010.0,83,76,7
BE,CN,2013.0,45,103,-58
JP,BE,2012.0,33,26,7
AU,IE,1999.0,42,34,8
ZA,US,2015.0,347,359,-12
GR,JP,2016.0,48,19,29
IN,nan,2015.0,77,77,0
DZ,FR,2021.0,85,83,2
CA,ZA,2018.0,54,56,-2
BR,IT,2014.0,215,289,-74
VE,GB,2004.0,7,8,-1
BE,NL,2020.0,267,319,-52
SG,GB,2019.0,149,166,-17
ES,CO,2001.0,71,66,5
PK,SA,2017.0,92,91,1
SE,US,2014.0,424,454,-30
BE,FR,2022.0,190,176,14
nan,BR,2019.0,154,161,-7
IT,AU,2006.0,37,25,12
CY,TR,2013.0,25,34,-9
CH,CL,2017.0,15,16,-1
SE,nan,2013.0,52,49,3
MX,PA,2020.0,10,17,-7
FR,NO,2008.0,59,36,23
FR,CH,2005.0,300,240,60
JP,ES,2003.0,17,14,3
FJ,AU,2018.0,12,7,5
IN,KR,2008.0,136,62,74
BR,PE,2022.0,51,25,26
VN,KR,2014.0,32,62,-30
AU,TR,2007.0,4,3,1
EG,IQ,2019.0,102,93,9
US,ZA,1998.0,114,122,-8
US,TR,2000.0,194,164,30
CO,ES,2009.0,268,263,5
PK,CN,2020.0,288,309,-21
ZA,FR,2013.0,36,38,-2
AL,GH,2015.0,2,1,1
US,nan,2014.0,279,260,19
PK,GB,2001.0,20,35,-15
NL,ZA,2010.0,38,36,2
FI,NO,2011.0,18,11,7
ID,US,2021.0,232,279,-47
US,FI,2020.0,161,133,28
IN,DK,2017.0,24,18,6
DE,IL,2016.0,66,63,3
GR,IR,2019.0,2,3,-1
SA,PK,2022.0,64,65,-1
AR,CO,2018.0,125,150,-25
BD,IN,2020.0,151,172,-21
NO,RU,2005.0,9,5,4
FR,ES,2001.0,129,123,6
IL,GB,2009.0,52,43,9
DE,SG,2016.0,38,36,2
US,BD,2013.0,85,98,-13
BD,GB,2014.0,55,61,-6
CH,FR,2011.0,341,424,-83
nan,CH,2019.0,25,20,5
KZ,RU,1997.0,1,1,0
SE,NO,2015.0,116,70,46
nan,JP,2017.0,71,37,34
CN,IE,2004.0,17,7,10
NO,CN,2010.0,28,33,-5
nan,US,2006.0,229,245,-16
ES,CN,2012.0,68,58,10
IT,CN,2005.0,21,20,1
LU,FR,2010.0,30,36,-6
CN,CO,2007.0,1,2,-1
RU,CN,2011.0,48,65,-17
AU,DE,2009.0,163,217,-54
KR,nan,2000.0,12,14,-2
CN,KZ,2003.0,6,4,2
DE,IE,2012.0,67,65,2
DE,IR,2013.0,49,75,-26
MY,CN,2012.0,32,60,-28
SA,NG,2019.0,21,25,-4
VN,CN,2012.0,37,35,2
DE,DK,2012.0,140,125,15
FR,SY,2014.0,13,7,6
UY,BR,2008.0,32,30,2
JP,IR,2003.0,13,5,8
RU,US,2008.0,423,269,154
CH,IT,2004.0,113,135,-22
BR,JP,2020.0,65,46,19
NO,SE,2016.0,82,125,-43
DE,MA,2020.0,12,7,5
CH,nan,2003.0,10,13,-3
FR,DZ,2016.0,187,106,81
BY,RU,2014.0,112,77,35
nan,FR,2000.0,52,52,0
JP,LK,2018.0,42,25,17
GB,OM,2019.0,13,19,-6
JP,TZ,2004.0,7,3,4
CZ,BY,2008.0,7,16,-9
NL,IE,2014.0,17,15,2
LK,CN,2022.0,7,4,3
FR,BE,2006.0,217,240,-23
nan,JP,2010.0,44,44,0
CO,PE,2013.0,70,47,23
GB,KR,2019.0,120,144,-24
nan,NO,2016.0,26,40,-14
DE,TJ,2019.0,1,2,-1
CU,MX,2005.0,33,22,11
FR,GB,2020.0,582,561,21
IT,RU,2015.0,43,20,23
GB,NL,1998.0,98,107,-9
nan,SE,2006.0,59,36,23
CA,FI,2018.0,20,25,-5
HU,RU,2015.0,11,7,4
EG,KR,2016.0,6,15,-9
BR,nan,2020.0,156,130,26
CH,CL,2019.0,13,12,1
UA,GB,2016.0,10,17,-7
MY,NZ,2016.0,21,23,-2
IT,MX,2014.0,39,32,7
RU,DE,2004.0,195,114,81
IQ,IR,2020.0,25,33,-8
AR,GB,2015.0,31,27,4
TZ,MW,2020.0,3,1,2
RE,FR,2005.0,20,9,11
DE,IN,2013.0,161,183,-22
RS,QA,2018.0,4,3,1
AU,ID,2021.0,52,53,-1
RO,GB,2012.0,37,30,7
GB,NL,1997.0,67,103,-36
CU,CR,2009.0,7,6,1
CA,NZ,2013.0,73,73,0
FR,QA,2013.0,19,5,14
RU,KZ,2015.0,56,32,24
RU,AE,2017.0,2,2,0
MY,nan,2022.0,31,36,-5
FR,CO,2014.0,48,34,14
BR,BE,2006.0,35,41,-6
ES,FI,2012.0,20,15,5
FI,CN,2022.0,40,30,10
FR,NZ,2011.0,24,19,5
IT,CN,2002.0,24,20,4
AR,BE,2021.0,12,5,7
KR,AU,2006.0,23,15,8
RU,UZ,2019.0,57,31,26
TW,EG,2019.0,28,27,1
DK,JP,2020.0,17,17,0
LT,JP,2013.0,3,9,-6
NL,DE,2005.0,182,216,-34
GB,SG,2020.0,151,172,-21
ES,PT,2009.0,104,115,-11
SA,NG,2017.0,12,7,5
BE,AU,2003.0,21,18,3
FR,KR,2012.0,31,30,1
FR,RO,2004.0,17,32,-15
RO,CN,2002.0,8,3,5
VE,PT,2014.0,5,3,2
EG,CN,2008.0,7,12,-5
LU,US,2006.0,6,4,2
BD,US,2019.0,257,149,108
LK,IN,2018.0,21,25,-4
TR,IL,2008.0,2,1,1
AU,BD,2014.0,33,67,-34
PA,US,1999.0,10,7,3
MA,CN,2019.0,4,3,1
NL,PT,2005.0,7,9,-2
PH,JP,2020.0,27,36,-9
FR,LU,2011.0,43,20,23
AU,GH,2016.0,9,15,-6
FR,DK,1998.0,16,14,2
QA,GB,2014.0,10,40,-30
JP,PK,2002.0,7,8,-1
IR,NL,2014.0,36,26,10
BE,SE,2015.0,35,20,15
FI,DE,2015.0,73,91,-18
NG,TH,2022.0,8,2,6
GB,PK,2022.0,98,110,-12
ZA,nan,2015.0,1,4,-3
GB,BA,2020.0,2,2,0
FR,IT,2000.0,155,168,-13
CA,VE,2013.0,1,3,-2
EG,IQ,2017.0,53,31,22
RS,HR,2022.0,85,78,7
IQ,CN,2019.0,10,16,-6
CN,IL,2020.0,29,31,-2
UG,GB,2011.0,11,6,5
US,HU,2012.0,95,115,-20
JP,AT,2011.0,17,16,1
MX,PR,2018.0,10,3,7
DE,ZA,2013.0,60,40,20
nan,JP,2019.0,43,46,-3
UY,CL,2009.0,7,4,3
CN,MX,2021.0,11,5,6
GB,TZ,2019.0,25,22,3
KW,TR,2014.0,5,8,-3
BD,US,2010.0,62,84,-22
IN,TR,2020.0,20,19,1
CO,PY,2020.0,18,14,4
CH,RU,2005.0,12,26,-14
CH,SK,2020.0,9,7,2
GB,HR,2003.0,7,7,0
PT,AR,2002.0,6,5,1
HU,US,1999.0,83,61,22
FR,BF,2014.0,15,9,6
ID,GB,2012.0,20,19,1
NG,BJ,2010.0,3,2,1
FI,nan,2018.0,13,5,8
IR,GB,2020.0,128,84,44
RS,CH,2017.0,10,9,1
IN,JP,2022.0,72,58,14
LB,EG,2022.0,16,14,2
QA,IT,2021.0,5,7,-2
TH,AU,2011.0,27,46,-19
MY,NP,2018.0,4,4,0
ZA,DE,2018.0,63,62,1
ID,TH,2021.0,35,23,12
US,RO,2008.0,57,30,27
US,DO,2022.0,3,1,2
MN,DZ,2021.0,1,5,-4
UY,ES,2002.0,14,12,2
TH,IR,2019.0,5,4,1
GH,MY,2019.0,4,5,-1
CR,PH,2021.0,1,1,0
EG,MY,2006.0,11,1,10
IE,IR,2018.0,15,16,-1
AR,EC,2018.0,44,29,15
UA,nan,2016.0,23,24,-1
PT,ES,2010.0,113,136,-23
IE,CA,2007.0,86,102,-16
VE,CO,2021.0,27,19,8
BE,JP,2012.0,26,33,-7
SG,MY,2022.0,116,95,21
CN,IT,2000.0,20,17,3
GB,BE,2018.0,175,191,-16
EG,CA,2015.0,66,95,-29
SE,SG,2017.0,26,15,11
NL,AU,2005.0,40,31,9
SK,GB,2011.0,27,18,9
DE,PT,2015.0,47,50,-3
BD,SA,2017.0,22,22,0
MD,RO,2016.0,6,6,0
IT,RO,2020.0,27,17,10
CU,CN,2018.0,5,2,3
CI,GH,2018.0,1,2,-1
CL,CZ,2019.0,3,1,2
PS,JO,2022.0,3,2,1
BR,NL,2021.0,75,46,29
HR,CA,2007.0,5,3,2
FI,NL,2006.0,22,44,-22
IT,NL,2013.0,122,100,22
RS,CZ,1999.0,8,1,7
AU,RO,2020.0,4,8,-4
NL,HU,2004.0,6,10,-4
MX,CA,2012.0,50,40,10
US,TH,1997.0,27,14,13
CH,FI,2018.0,23,26,-3
US,TH,1998.0,45,31,14
NL,CH,2003.0,49,53,-4
RU,UZ,2010.0,12,17,-5
TN,LY,2018.0,2,2,0
AT,EG,2004.0,1,2,-1
DK,NO,2002.0,43,43,0
NO,DK,2006.0,63,50,13
BR,MY,1998.0,4,2,2
QA,DE,2018.0,6,9,-3
AT,MK,2014.0,19,9,10
PK,NG,2006.0,2,4,-2
JP,EG,1998.0,17,18,-1
CH,CL,2010.0,7,14,-7
nan,NG,2020.0,11,8,3
NL,FR,1998.0,79,101,-22
NO,IT,1998.0,9,11,-2
CA,TZ,2019.0,1,1,0
CO,FR,2011.0,25,22,3
IL,SG,2016.0,5,3,2
FR,VE,2019.0,3,7,-4
BI,FR,2015.0,29,15,14
DZ,nan,2011.0,4,4,0
BR,TR,2009.0,13,47,-34
IL,TR,2018.0,6,5,1
RS,GB,2009.0,7,14,-7
IN,CA,1998.0,36,49,-13
SA,NG,2010.0,6,1,5
DE,AR,2007.0,23,23,0
IN,IT,2000.0,33,16,17
CA,SK,2000.0,2,1,1
DK,IE,2010.0,10,7,3
IL,PL,2008.0,4,3,1
ID,EE,2019.0,3,1,2
IN,CA,1997.0,32,38,-6
PE,CL,2006.0,26,23,3
AE,NZ,2016.0,3,1,2
AE,AU,2015.0,12,15,-3
nan,AR,2008.0,29,28,1
TH,KR,2009.0,10,7,3
TH,SE,2011.0,6,5,1
PH,BD,2016.0,2,2,0
FR,ZA,2018.0,46,33,13
US,BG,2021.0,20,21,-1
US,SD,2013.0,11,6,5
CA,NO,2002.0,8,14,-6
US,GH,2015.0,58,22,36
DE,MW,2021.0,2,2,0
MY,ID,2001.0,1,1,0
CZ,HR,2018.0,16,9,7
SE,PK,2014.0,22,10,12
MX,PY,2018.0,20,15,5
KR,SG,2013.0,36,33,3
CA,BD,2004.0,8,9,-1
nan,NL,2005.0,46,52,-6
NL,CR,2019.0,3,3,0
FR,GR,2006.0,25,21,4
ZA,NL,2021.0,44,28,16
BD,MY,2022.0,37,31,6
SG,IN,2001.0,12,19,-7
JP,RU,2007.0,30,43,-13
SE,DE,1999.0,53,73,-20
AU,IL,2011.0,17,16,1
BR,SG,2002.0,2,1,1
KR,BD,2020.0,43,27,16
NL,ZA,2019.0,49,57,-8
RS,NO,2018.0,4,1,3
MQ,FR,2017.0,24,12,12
FI,PK,2020.0,6,5,1
IE,NZ,2012.0,14,17,-3
TT,JM,2015.0,22,15,7
DK,MW,2001.0,1,1,0
JP,GH,2020.0,9,7,2
GR,AE,2022.0,3,4,-1
MX,AR,2006.0,63,56,7
NO,IN,2020.0,34,45,-11
CL,VE,2015.0,11,29,-18
CA,PK,2023.0,3,1,2
AU,IR,2005.0,19,11,8
MZ,FR,2014.0,1,1,0
HU,PL,2020.0,36,88,-52
IN,ML,2003.0,2,2,0
PT,VE,2013.0,2,10,-8
FR,BG,2008.0,10,10,0
CH,PT,2011.0,11,8,3
QA,IN,2016.0,23,14,9
RE,FR,2002.0,8,5,3
BR,SD,2014.0,7,16,-9
PE,PH,2022.0,5,1,4
BE,GR,1998.0,7,4,3
CA,AE,2016.0,38,18,20
GH,AU,2015.0,4,5,-1
BE,CZ,2008.0,8,5,3
CA,BE,1998.0,18,19,-1
GR,IT,2016.0,31,35,-4
RU,MD,2017.0,6,5,1
MQ,FR,2019.0,17,19,-2
RU,HR,2018.0,9,10,-1
ES,UG,2016.0,1,1,0
GH,MY,2017.0,4,3,1
nan,CH,2010.0,9,8,1
GB,TR,2009.0,47,58,-11
PA,AR,2017.0,3,7,-4
BE,SA,2020.0,15,3,12
NL,CL,2016.0,11,12,-1
IT,ID,2013.0,5,4,1
SK,IN,2006.0,3,4,-1
DZ,SA,2015.0,7,1,6
MX,PH,2014.0,9,10,-1
MX,DO,2020.0,4,3,1
nan,BY,2014.0,2,2,0
RU,FR,2004.0,49,43,6
AR,AU,2009.0,5,2,3
BE,IN,2003.0,4,7,-3
PK,SA,2019.0,125,127,-2
BO,EC,2017.0,6,4,2
DE,SK,2001.0,15,15,0
AE,EG,2022.0,32,56,-24
BD,FR,2012.0,8,11,-3
KR,CZ,2014.0,15,5,10
GB,RU,2022.0,69,83,-14
RU,TR,2019.0,3,9,-6
RU,MY,2018.0,17,12,5
RU,TW,2006.0,13,15,-2
CA,RU,2014.0,31,18,13
UA,FI,2014.0,4,3,1
FI,KZ,2020.0,2,1,1
BD,DE,2022.0,11,10,1
MA,IN,2022.0,1,7,-6
AE,JO,2006.0,3,4,-1
FI,FR,2003.0,11,10,1
SN,FR,2016.0,34,43,-9
AE,IQ,2017.0,14,7,7
UA,HU,2021.0,4,2,2
SA,IR,2018.0,13,13,0
ES,BO,2003.0,4,2,2
ET,CN,2016.0,6,5,1
FI,GB,2014.0,79,73,6
MA,MD,2001.0,4,5,-1
FR,VE,2010.0,13,14,-1
BO,FR,2012.0,3,2,1
CN,SI,2007.0,3,1,2
TZ,CH,2019.0,10,6,4
AT,SE,2011.0,22,24,-2
AM,RU,2013.0,5,4,1
CH,IN,2022.0,35,32,3
MY,IN,1999.0,9,10,-1
GB,ZM,2011.0,10,1,9
PH,CN,2021.0,12,12,0
LB,IN,2022.0,10,16,-6
UY,CO,2008.0,6,4,2
TZ,CH,2017.0,7,2,5
LU,FR,2017.0,40,57,-17
SN,NE,2019.0,3,1,2
AT,IN,2022.0,7,10,-3
RO,IT,2011.0,16,11,5
SG,NO,2009.0,2,2,0
PK,TH,2014.0,2,6,-4
IE,BE,2017.0,5,7,-2
IT,AL,2016.0,6,1,5
DK,UY,2008.0,2,2,0
PK,JP,2016.0,13,16,-3
GB,TZ,2010.0,17,6,11
IE,NO,2008.0,2,3,-1
SI,AU,2012.0,3,4,-1
DE,TH,2011.0,17,14,3
OM,GB,2018.0,13,21,-8
MX,PK,2011.0,2,4,-2
CU,EC,2011.0,2,1,1
GB,NG,2011.0,31,28,3
IN,BH,2019.0,18,5,13
SE,GR,2016.0,15,29,-14
NO,IT,1997.0,5,6,-1
RU,UZ,2017.0,16,34,-18
IL,JP,2014.0,9,11,-2
PL,ES,2012.0,14,22,-8
JP,PK,2005.0,7,9,-2
NO,MX,2019.0,7,4,3
US,HR,2013.0,43,47,-4
RS,JP,2019.0,4,3,1
NO,ES,2005.0,11,17,-6
IN,GR,2017.0,4,6,-2
DK,NO,2005.0,45,43,2
LU,BE,2012.0,12,18,-6
NL,PL,2008.0,17,23,-6
GB,HK,2013.0,6,5,1
LV,RU,2004.0,3,22,-19
MY,AU,2012.0,77,101,-24
GB,DZ,2006.0,8,2,6
NL,RU,2001.0,10,30,-20
UA,BY,2018.0,18,20,-2
JP,IE,2002.0,20,34,-14
US,KW,1998.0,10,5,5
US,BH,2011.0,9,11,-2
US,PA,1998.0,11,11,0
PY,AR,2015.0,7,8,-1
GB,PT,2003.0,47,22,25
CW,NL,2009.0,14,19,-5
IE,BE,2010.0,8,7,1
nan,SA,2017.0,5,3,2
IE,FR,2013.0,32,41,-9
RS,CH,2019.0,12,10,2
NP,GB,2013.0,9,12,-3
MY,RU,2013.0,10,13,-3
nan,IT,1997.0,37,33,4
LB,IT,2005.0,9,8,1
SI,HR,2000.0,2,4,-2
BE,SI,2008.0,4,4,0
nan,SA,2019.0,6,3,3
GB,IR,1998.0,19,2,17
JP,GR,2016.0,19,48,-29
AT,SK,1998.0,2,5,-3
JP,EG,1997.0,5,7,-2
MY,SG,2001.0,8,14,-6
GR,NO,2011.0,2,5,-3
NC,US,2012.0,2,1,1
IL,CH,2012.0,22,13,9
RS,CH,2010.0,8,6,2
UA,IT,2021.0,16,7,9
US,MY,1997.0,5,8,-3
LB,JO,2018.0,5,2,3
IN,TT,2022.0,2,4,-2
NO,RU,2002.0,2,5,-3
TN,JO,2018.0,3,1,2
ES,CZ,2007.0,5,5,0
CZ,BE,2012.0,11,9,2
IN,IR,2004.0,7,1,6
FI,MX,2002.0,2,2,0
TT,GB,2019.0,7,10,-3
PT,CH,2018.0,20,25,-5
NZ,AE,2008.0,3,4,-1
DE,PH,2006.0,6,4,2
CN,SE,2006.0,42,81,-39
KH,JP,1997.0,2,2,0
GH,JP,2014.0,3,2,1
AU,GE,2011.0,2,1,1
ME,IT,2013.0,3,2,1
FR,PT,2009.0,33,40,-7
NO,CN,2019.0,40,32,8
nan,IT,1998.0,36,68,-32
SE,SG,2019.0,24,25,-1
FR,TW,2000.0,11,6,5
CR,NL,2008.0,1,2,-1
NL,CR,2017.0,2,7,-5
ZA,NO,2004.0,4,1,3
CU,FR,2009.0,5,4,1
PL,ZA,2016.0,6,2,4
ES,PH,2021.0,15,11,4
TT,GB,2017.0,7,6,1
GE,DE,2002.0,6,6,0
NZ,nan,2017.0,7,2,5
PL,FR,2000.0,25,37,-12
SE,PL,2014.0,22,23,-1
AU,PK,2014.0,32,32,0
NL,ZA,2017.0,44,55,-11
NL,CY,2020.0,5,2,3
CA,BE,1997.0,19,17,2
PL,XK,2011.0,3,5,-2
KW,IL,2005.0,1,1,0
BR,IL,2013.0,6,5,1
SE,IS,2006.0,13,18,-5
TW,ES,2011.0,4,3,1
RO,TR,2018.0,7,3,4
SE,SG,2010.0,14,8,6
FR,UY,2013.0,5,5,0
AF,ES,2020.0,2,1,1
ZA,CO,2017.0,6,3,3
ES,SK,2004.0,2,1,1
NG,CY,2019.0,3,4,-1
SG,LK,2017.0,1,4,-3
IT,PK,2021.0,10,18,-8
NZ,ID,2022.0,2,6,-4
IR,CN,2003.0,2,4,-2
AE,IQ,2019.0,14,14,0
IE,BE,2019.0,13,9,4
BE,RU,2007.0,16,17,-1
PA,DE,2008.0,4,5,-1
AU,SE,2011.0,55,54,1
IN,BH,2010.0,1,2,-1
LU,FR,2019.0,36,59,-23
CU,CO,2018.0,33,32,1
HU,BE,2013.0,8,10,-2
KE,TR,2019.0,2,1,1
CA,TZ,2017.0,3,3,0
ET,EG,2020.0,6,9,-3
EG,IR,2018.0,16,22,-6
CL,PA,2021.0,6,3,3
PK,ES,2016.0,5,7,-2
GB,ET,2009.0,4,8,-4
US,LK,2001.0,5,2,3
NL,PT,2002.0,14,8,6
NL,FR,1997.0,66,63,3
ES,AU,2007.0,18,25,-7
HR,IE,2011.0,4,10,-6
CO,NL,2022.0,9,5,4
ZM,BR,2011.0,3,5,-2
NL,AU,2002.0,20,41,-21
FR,DK,1997.0,16,13,3
RU,BD,2021.0,2,1,1
FR,CI,2007.0,12,5,7
MX,CL,2004.0,47,54,-7
TW,DE,2009.0,21,26,-5
CA,LB,2012.0,12,8,4
US,NG,1998.0,7,12,-5
DE,ID,2005.0,9,6,3
BR,IR,2010.0,3,3,0
EE,CN,2007.0,1,1,0
IR,AU,2008.0,26,34,-8
JO,TR,2018.0,2,1,1
GR,PT,2017.0,5,4,1
IT,TR,2006.0,13,10,3
DE,TW,2015.0,31,27,4
BE,PE,2005.0,1,1,0
KR,BE,2022.0,10,5,5
IE,PL,2021.0,5,4,1
JP,NL,2003.0,25,36,-11
IN,CN,1998.0,11,8,3
GB,LK,2013.0,32,12,20
NO,TZ,2014.0,9,6,3
nan,EE,2012.0,1,1,0
SE,SA,2021.0,3,12,-9
US,UG,2005.0,15,4,11
SK,HU,2015.0,11,7,4
ZA,DK,2007.0,4,2,2
ZW,ZM,2017.0,3,1,2
nan,FI,2011.0,13,13,0
AE,KW,2004.0,2,2,0
AL,DE,2012.0,1,3,-2
GR,EC,2008.0,3,2,1
BE,GR,1997.0,5,3,2
IL,RU,2009.0,14,23,-9
nan,SA,2010.0,5,2,3
SG,JP,2013.0,44,41,3
MX,SE,2022.0,12,3,9
CA,JM,2013.0,3,6,-3
ES,HU,2004.0,4,2,2
DE,ME,2005.0,1,1,0
EG,BH,2008.0,2,3,-1
NL,BG,2003.0,4,4,0
AM,SE,2019.0,1,1,0
SY,JP,2016.0,2,1,1
PA,AR,2019.0,5,5,0
MY,BR,1998.0,2,4,-2
ET,MX,2017.0,5,2,3
ID,MY,2004.0,6,4,2
SI,HU,2022.0,1,1,0
IT,NG,2011.0,10,10,0
FJ,IN,2014.0,4,3,1
AG,US,2021.0,4,7,-3
GB,MU,2009.0,3,2,1
GR,JO,2015.0,2,1,1
MU,US,2011.0,1,1,0
GB,OM,2010.0,7,4,3
US,SA,2023.0,12,9,3
AU,JO,1999.0,1,1,0
HU,MA,2013.0,3,7,-4
MD,RU,1998.0,4,6,-2
BG,RS,2012.0,10,1,9
IT,SM,2012.0,2,1,1
IE,EG,2015.0,6,5,1
OM,MY,2015.0,4,12,-8
SE,SK,2012.0,2,2,0
LU,RU,2009.0,1,3,-2
VN,GB,2007.0,4,6,-2
VN,IN,2009.0,2,1,1
CZ,FR,2008.0,18,30,-12
SG,FI,2015.0,5,2,3
TW,RU,2014.0,11,26,-15
QA,SE,2012.0,1,1,0
JP,IE,2005.0,11,28,-17
MX,BR,1998.0,21,14,7
TW,BR,2004.0,2,2,0
PH,IN,2001.0,6,3,3
SG,IT,2021.0,5,6,-1
NL,TZ,2004.0,1,2,-1
LB,FR,1999.0,7,6,1
BR,KR,2014.0,11,4,7
TR,CZ,2016.0,13,11,2
CL,UY,2018.0,16,18,-2
JO,JP,2008.0,5,3,2
GB,VN,2021.0,20,15,5
TR,CY,2008.0,9,3,6
LK,JP,1999.0,9,8,1
LU,ES,2012.0,1,6,-5
AU,JM,2013.0,2,1,1
SK,FR,2003.0,4,6,-2
RU,TR,2010.0,5,6,-1
PE,GT,2020.0,4,7,-3
MG,DE,2014.0,4,1,3
MY,DK,2018.0,8,7,1
IN,DK,2019.0,21,22,-1
AU,NP,2008.0,2,1,1
QA,ES,2007.0,2,3,-1
nan,PL,2012.0,8,6,2
BR,IR,2019.0,17,16,1
RO,UA,2011.0,2,4,-2
CY,NL,2019.0,6,4,2
MX,CH,2008.0,8,2,6
PK,IR,2011.0,6,6,0
PT,SE,2002.0,3,1,2
ZA,CO,2019.0,4,4,0
SK,BY,2003.0,2,1,1
QA,AE,2008.0,3,4,-1
CH,UA,2010.0,4,1,3
NG,BJ,2017.0,4,4,0
IT,SK,2017.0,5,4,1
nan,KR,2001.0,14,7,7
SD,US,2002.0,5,5,0
CH,UA,2017.0,4,7,-3
TR,UA,2018.0,1,3,-2
PT,CN,2007.0,13,5,8
UY,US,2011.0,11,21,-10
IE,GR,2022.0,5,3,2
AU,CZ,2009.0,7,11,-4
DK,IL,2018.0,4,8,-4
IL,ES,2013.0,10,14,-4
UY,MX,2005.0,3,6,-3
LV,BG,2017.0,1,1,0
AU,AE,2022.0,10,6,4
SE,ZW,2011.0,2,1,1
BN,BD,2021.0,1,1,0
CL,CZ,2010.0,2,1,1
NG,GH,2015.0,3,13,-10
NZ,LB,2017.0,1,1,0
SE,IR,2021.0,17,57,-40
AZ,UZ,2020.0,7,1,6
CN,DZ,2018.0,5,7,-2
BD,IT,2018.0,9,7,2
BF,US,2019.0,4,3,1
MX,PT,2003.0,12,8,4
CY,BE,2020.0,2,1,1
IE,BR,2016.0,4,14,-10
BR,IE,2022.0,8,5,3
AT,LV,2013.0,1,1,0
ID,CL,2021.0,4,22,-18
TH,CN,2003.0,2,5,-3
EC,PE,2018.0,37,41,-4
KR,BH,2020.0,6,2,4
IN,GR,2019.0,6,5,1
SA,IE,2022.0,10,5,5
BE,TW,2007.0,2,3,-1
DE,GR,1997.0,13,11,2
RU,MZ,2013.0,10,13,-3
RU,MD,2019.0,4,9,-5
ES,SI,2004.0,6,7,-1
NL,EG,2018.0,6,4,2
US,MY,1998.0,17,5,12
BD,IE,2014.0,2,6,-4
PL,VN,2002.0,4,1,3
SK,BR,2007.0,1,1,0
HN,CO,2014.0,9,7,2
BH,TN,2021.0,1,4,-3
PY,CO,2021.0,7,9,-2
CZ,NL,1999.0,4,4,0
RU,MD,2010.0,3,4,-1
AT,nan,1998.0,7,3,4
AT,SK,1997.0,5,1,4
AL,IT,2015.0,4,5,-1
ZW,ZM,2019.0,3,4,-1
EG,HU,2014.0,2,6,-4
VE,DO,2020.0,1,1,0
VN,US,1999.0,4,5,-1
DE,GR,1998.0,19,15,4
DE,GE,2011.0,6,5,1
CA,CL,2007.0,13,10,3
SG,PK,2000.0,1,1,0
IS,US,1998.0,3,4,-1
nan,CH,2017.0,22,29,-7
SZ,ZA,2014.0,3,7,-4
GB,LY,2006.0,2,2,0
BG,NZ,2021.0,1,1,0
ES,GT,2017.0,13,16,-3
NO,BR,2011.0,17,14,3
MQ,FR,2010.0,10,22,-12
MX,IN,2021.0,6,12,-6
CA,SE,2023.0,5,2,3
NO,CN,2017.0,32,27,5
US,NG,1997.0,7,8,-1
TR,SA,2007.0,2,2,0
CN,LB,2011.0,20,18,2
CN,SK,2010.0,2,8,-6
JP,SA,2012.0,9,7,2
EG,JO,2006.0,2,1,1
CM,JP,2012.0,1,3,-2
BE,MD,2011.0,3,2,1
US,UG,2002.0,5,5,0
DE,JO,2004.0,2,2,0
IT,SK,2010.0,7,1,6
GB,MK,2008.0,2,2,0
UZ,FR,2016.0,1,1,0
JP,OM,2018.0,2,1,1
NL,NZ,2013.0,10,9,1
FR,IE,2012.0,36,36,0
GB,GH,2007.0,6,6,0
AU,MX,2013.0,12,17,-5
NG,BJ,2019.0,5,4,1
NG,GB,2001.0,5,12,-7
MY,OM,2013.0,6,6,0
ES,IL,2002.0,8,9,-1
TR,RO,2016.0,4,2,2
UA,NO,2017.0,3,3,0
MD,MA,2004.0,10,3,7
KR,DK,2014.0,11,5,6
IL,DK,2017.0,6,7,-1
MK,AT,2022.0,9,1,8
GR,FI,2015.0,6,3,3
GR,IR,2017.0,2,3,-1
QA,KW,2012.0,3,2,1
NZ,ES,2022.0,7,5,2
FR,PH,2013.0,6,7,-1
PT,AO,2015.0,6,2,4
RE,NC,2011.0,1,1,0
DK,NL,2007.0,8,30,-22
ZA,UG,2021.0,16,13,3
PL,MX,2011.0,8,9,-1
JP,HK,2001.0,2,9,-7
HU,NZ,2018.0,3,4,-1
BE,CL,1999.0,1,1,0
IS,US,1997.0,7,1,6
RS,KZ,2013.0,7,1,6
ZA,BR,1999.0,2,1,1
ET,MX,2019.0,1,4,-3
IE,TR,2007.0,1,1,0
IQ,JO,2011.0,4,6,-2
PK,IE,2016.0,4,11,-7
EG,RU,2012.0,2,2,0
GR,RU,2007.0,2,2,0
PA,AR,2010.0,4,5,-1
AU,PG,2000.0,3,3,0
ES,BD,2022.0,4,10,-6
TW,CA,2006.0,25,31,-6
BA,HR,2008.0,6,15,-9
AU,AR,2021.0,7,12,-5
IT,SK,2019.0,7,3,4
ZA,PL,2004.0,3,1,2
DE,NP,2008.0,1,1,0
VE,UY,2005.0,1,1,0
GE,BR,2019.0,1,3,-2
PT,UY,2008.0,2,3,-1
DK,AT,2014.0,10,16,-6
EE,SE,2003.0,5,10,-5
HU,NO,2021.0,4,3,1
AU,KE,2007.0,2,3,-1
BN,ID,2021.0,3,6,-3
CH,IL,2022.0,9,8,1
JP,EE,2017.0,2,1,1
IT,EG,1997.0,3,1,2
CR,VE,2015.0,4,5,-1
CN,SK,2019.0,4,5,-1
NZ,IE,1998.0,3,1,2
ID,EE,2017.0,9,2,7
RO,CH,2001.0,4,2,2
IE,CH,2006.0,4,13,-9
DE,SA,2003.0,6,4,2
AT,RO,2016.0,7,8,-1
CH,HR,2018.0,4,7,-3
BR,SV,2006.0,1,1,0
NI,CO,2021.0,1,3,-2
CZ,MY,2014.0,4,5,-1
PA,IT,2020.0,2,1,1
CN,RW,2016.0,1,2,-1
PK,CG,2019.0,4,3,1
GB,CM,2018.0,8,6,2
FI,IT,2021.0,23,49,-26
SK,AT,2015.0,18,17,1
NG,SA,2013.0,4,9,-5
UA,IE,2014.0,2,1,1
CR,GB,2016.0,4,4,0
KE,PK,2021.0,6,11,-5
GE,GB,2008.0,11,3,8
AR,TN,2013.0,1,2,-1
LK,MY,2005.0,1,1,0
HU,AU,2003.0,5,6,-1
RU,EE,2015.0,3,9,-6
DE,LT,2004.0,4,3,1
CU,VE,2013.0,9,11,-2
US,PR,2012.0,6,3,3
TR,ES,2000.0,1,4,-3
nan,CL,2015.0,6,12,-6
US,PA,1997.0,10,8,2
FI,IE,2017.0,4,4,0
HK,JP,2018.0,6,11,-5
US,BS,2021.0,5,3,2
MA,CM,2018.0,3,2,1
RU,PK,2020.0,19,9,10
AM,DE,2020.0,2,6,-4
HR,BA,2004.0,7,5,2
BE,UY,2011.0,2,1,1
CO,CA,2001.0,2,1,1
ZA,PT,2012.0,4,3,1
BA,IT,2016.0,1,3,-2
VN,ZA,2020.0,4,3,1
NO,PK,2016.0,6,4,2
GB,AF,2016.0,2,1,1
EG,IQ,2010.0,4,3,1
BE,DZ,2016.0,8,2,6
AU,PH,2008.0,10,5,5
IT,CU,2012.0,2,6,-4
NG,ML,2016.0,2,1,1
BE,BD,2015.0,3,4,-1
NL,IS,2016.0,2,2,0
ZM,FI,2017.0,1,2,-1
TZ,US,2022.0,5,15,-10
SE,LT,2008.0,3,3,0
PK,TR,2006.0,1,4,-3
JP,NO,2003.0,11,9,2
SE,LU,2016.0,2,3,-1
SA,RW,2017.0,1,3,-2
IE,CZ,2007.0,2,5,-3
IN,NG,2001.0,3,3,0
BG,ZA,2010.0,1,1,0
AT,RS,2019.0,10,15,-5
CO,KE,2022.0,3,1,2
DZ,IT,2001.0,3,2,1
MY,BD,2005.0,5,4,1
FR,VE,2017.0,6,9,-3
NO,RO,2018.0,3,3,0
BG,PL,2003.0,2,2,0
JM,FR,2010.0,1,1,0
KE,ZA,2003.0,5,7,-2
BF,ZA,2020.0,2,1,1
NL,VN,2014.0,5,5,0
NO,PL,2008.0,3,4,-1
ID,BE,2014.0,2,8,-6
ES,NI,2010.0,1,3,-2
RU,MX,2006.0,10,9,1
TW,IR,2018.0,2,5,-3
CO,HN,2012.0,2,3,-1
CY,IN,2020.0,2,4,-2
PH,GB,2001.0,10,11,-1
TH,NZ,2016.0,4,8,-4
EC,BR,2009.0,1,9,-8
CA,LY,2012.0,1,1,0
BR,AO,2007.0,7,12,-5
CL,SE,2001.0,1,5,-4
GB,UZ,2017.0,2,1,1
MY,AE,2009.0,4,2,2
OM,BD,2020.0,4,1,3
NZ,NL,1999.0,5,1,4
BF,DE,2007.0,1,1,0
CL,CZ,2017.0,6,3,3
FR,PE,2008.0,1,1,0
NP,IT,2007.0,2,1,1
JO,DE,2014.0,7,21,-14
AE,JP,2012.0,1,6,-5
SI,CN,2007.0,1,3,-2
BR,ZM,2015.0,14,9,5
BG,IT,2009.0,2,5,-3
AM,UA,2008.0,1,1,0
ET,ER,2019.0,1,2,-1
QA,SA,1998.0,3,1,2
CN,RU,1999.0,5,9,-4
ET,IN,2023.0,2,2,0
AR,NO,2009.0,2,1,1
nan,HR,2016.0,1,4,-3
DK,MX,2008.0,4,2,2
PK,NO,2009.0,2,1,1
MA,CN,2017.0,2,1,1
RU,KH,2015.0,2,2,0
UA,AU,2020.0,2,2,0
AO,PT,2011.0,3,3,0
PT,MA,2012.0,5,5,0
ZM,GH,2021.0,16,25,-9
PE,BE,2019.0,4,5,-1
CA,NG,2006.0,3,3,0
AR,PL,2020.0,4,1,3
US,BW,2000.0,1,1,0
DK,RU,1999.0,4,7,-3
EC,PH,2018.0,2,3,-1
CN,UA,2003.0,10,7,3
JO,IN,2020.0,5,3,2
PE,DK,2015.0,1,2,-1
PL,RU,2004.0,9,19,-10
CO,CU,2001.0,3,6,-3
UZ,UA,2019.0,6,5,1
CA,PE,2023.0,1,1,0
MZ,SE,2002.0,1,2,-1
OM,LB,2019.0,2,1,1
PE,DE,2009.0,2,5,-3
EG,GH,2017.0,9,5,4
SA,TN,2008.0,2,8,-6
US,KW,1997.0,5,3,2
NZ,KR,2003.0,1,1,0
FI,ET,2017.0,4,1,3
AZ,TR,2004.0,4,3,1
EG,SE,2009.0,2,3,-1
GF,FR,2013.0,10,21,-11
CY,NL,2017.0,4,4,0
JM,IN,2016.0,2,3,-1
RS,JP,2017.0,4,3,1
IN,GR,2010.0,2,3,-1
PT,BY,2008.0,1,3,-2
DZ,GB,2009.0,7,4,3
FR,MC,2012.0,6,6,0
NZ,nan,2010.0,3,38,-35
CZ,SI,2001.0,2,4,-2
SN,US,2015.0,7,10,-3
PF,US,2014.0,1,1,0
UY,FR,2013.0,5,5,0
GP,MA,2009.0,2,1,1
ID,LK,2005.0,2,1,1
MA,BE,2008.0,2,6,-4
IQ,CN,2017.0,4,9,-5
UZ,TR,2021.0,1,1,0
JP,AM,2021.0,1,1,0
nan,CZ,2020.0,5,2,3
DK,GW,2013.0,3,3,0
SA,SG,2013.0,2,8,-6
EG,GH,2019.0,1,13,-12
PY,VE,2018.0,3,2,1
BO,EC,2019.0,3,3,0
UA,EC,2000.0,5,1,4
GR,PT,2010.0,2,1,1
SD,JO,2021.0,1,2,-1
CM,CI,2013.0,2,2,0
BE,CH,2023.0,4,3,1
NO,TH,2017.0,1,2,-1
NO,TH,2019.0,1,2,-1
EE,ES,2017.0,3,5,-2
LK,KR,2012.0,1,1,0
IL,UZ,2009.0,1,1,0
SE,IE,2006.0,4,8,-4
AT,SI,2003.0,5,4,1
SV,PE,2016.0,4,4,0
FR,NG,2000.0,1,2,-1
BE,MX,2000.0,3,2,1
MK,FI,2017.0,1,1,0
XK,MK,2016.0,2,5,-3
GH,KE,2020.0,1,5,-4
BE,CM,2013.0,3,2,1
BA,CZ,2011.0,1,4,-3
UG,MW,2019.0,3,2,1
PH,SG,2018.0,6,12,-6
TH,NG,2011.0,2,1,1
JO,QA,2007.0,1,1,0
ES,IN,2004.0,3,6,-3
LR,US,2019.0,2,9,-7
VE,BO,2006.0,1,1,0
BE,BG,2018.0,7,6,1
MY,LK,2012.0,4,1,3
NG,KE,1999.0,1,2,-1
MX,IL,2013.0,3,3,0
NG,FR,2005.0,5,1,4
MX,KR,2007.0,4,4,0
PT,PE,2002.0,2,1,1
IL,DK,2019.0,3,4,-1
IT,HU,2004.0,3,10,-7
AT,nan,1997.0,1,2,-1
IL,DK,2010.0,6,3,3
RU,AE,2019.0,2,1,1
AR,NZ,2011.0,4,1,3
nan,AU,2002.0,8,10,-2
VN,HU,2016.0,2,1,1
TN,NL,2022.0,1,1,0
RU,TR,2017.0,3,12,-9
TH,IR,2017.0,5,2,3
BY,IN,2012.0,5,2,3
HU,RS,2008.0,3,5,-2
SD,CN,2016.0,6,4,2
EG,NO,2018.0,4,1,3
PL,ET,2021.0,1,2,-1
CA,TZ,2010.0,2,3,-1
PK,PL,2011.0,4,2,2
PL,JP,2022.0,9,5,4
GB,UZ,2019.0,3,3,0
AE,ZA,2019.0,5,7,-2
KE,BH,2008.0,2,4,-2
IN,LU,2018.0,4,1,3
CZ,CA,2023.0,1,1,0
BY,GB,2013.0,2,3,-1
BE,KR,2004.0,2,7,-5
GH,NL,2016.0,2,4,-2
NI,MX,2013.0,2,4,-2
MK,US,2018.0,6,10,-4
ES,RS,1997.0,1,1,0
BF,US,2017.0,4,4,0
TZ,EG,2012.0,1,1,0
IE,FI,2015.0,5,5,0
GE,SK,2020.0,3,2,1
AR,PE,2000.0,2,2,0
AE,LB,2012.0,3,2,1
TR,FI,2014.0,5,4,1
NO,MX,2017.0,4,3,1
TW,EG,2010.0,4,3,1
EG,ZA,2021.0,3,8,-5
ES,NI,2019.0,2,6,-4
RU,IQ,2019.0,3,1,2
PA,BR,2001.0,2,1,1
UA,SK,2007.0,1,1,0
UG,NL,2018.0,7,4,3
SG,LK,2019.0,3,4,-1
CM,CN,2022.0,5,2,3
PS,IQ,2014.0,1,2,-1
PK,LY,2017.0,1,1,0
EC,IL,2017.0,1,5,-4
IQ,US,2001.0,4,1,3
LV,CA,2019.0,1,2,-1
DE,BO,2014.0,2,3,-1
ZW,RU,2005.0,2,3,-1
MX,UA,1997.0,1,1,0
NZ,nan,2019.0,4,9,-5
EE,HU,2013.0,1,1,0
EG,GH,2010.0,3,4,-1
CR,FR,2007.0,2,3,-1
CM,MY,2022.0,3,2,1
PL,MZ,2009.0,3,6,-3
RU,IQ,2017.0,2,1,1
SG,HK,2008.0,1,1,0
CL,PT,2011.0,1,6,-5
SK,HR,2016.0,2,7,-5
IR,CY,2018.0,8,10,-2
BD,RO,2012.0,2,1,1
PK,TW,2018.0,5,1,4
SA,NO,2011.0,3,3,0
NC,RE,2022.0,1,3,-2
HN,ES,2022.0,4,5,-1
IE,LB,2018.0,1,1,0
PE,KE,2014.0,1,2,-1
IQ,CA,2018.0,4,18,-14
ID,FI,2012.0,1,2,-1
ZA,IT,2004.0,3,5,-2
MK,FR,2011.0,1,1,0
ID,EE,2010.0,1,1,0
US,MT,2022.0,2,3,-1
NI,EC,2020.0,5,3,2
ID,KE,2013.0,1,3,-2
NZ,IE,1997.0,3,4,-1
AU,CY,2012.0,3,1,2
JP,EE,2010.0,1,2,-1
NI,ES,2008.0,2,2,0
IT,SG,2006.0,3,4,-1
UG,IN,2016.0,3,2,1
MZ,SE,2005.0,1,1,0
LU,MX,2020.0,2,1,1
IS,IT,2017.0,1,1,0
LR,US,2017.0,5,6,-1
IN,EG,2006.0,3,2,1
CG,FR,1998.0,2,3,-1
NE,FR,2005.0,3,3,0
RS,BG,2009.0,2,6,-4
AE,ZA,2010.0,1,3,-2
SY,MA,2008.0,1,1,0
GB,SS,2005.0,6,11,-5
TN,PT,2022.0,2,2,0
GB,SS,2002.0,2,6,-4
US,BF,2013.0,1,2,-1
US,MM,2013.0,2,3,-1
TN,PG,2016.0,4,2,2
KW,NG,2016.0,2,1,1
PE,SE,2019.0,1,1,0
BD,SE,2021.0,2,8,-6
AE,IE,2011.0,1,2,-1
nan,PK,2009.0,1,3,-2
DK,UA,2021.0,2,1,1
JO,IT,2022.0,2,2,0
GR,PL,2001.0,1,5,-4
GM,SN,2002.0,1,2,-1
SD,KW,2022.0,2,2,0
EC,PT,2021.0,7,9,-2
NL,GA,2009.0,1,2,-1
BH,IT,2015.0,1,1,0
FI,LT,2012.0,2,4,-2
PE,BE,2017.0,2,5,-3
VG,GB,2017.0,3,3,0
PE,IT,2007.0,2,2,0
MX,TW,2009.0,1,4,-3
CA,NO,2005.0,7,13,-6
TJ,US,2014.0,1,1,0
BG,UA,2012.0,1,5,-4
CN,BD,1998.0,1,1,0
LS,ZW,2020.0,1,1,0
ES,TR,2003.0,6,2,4
AU,BS,2014.0,1,1,0
CY,IT,2008.0,1,1,0
CO,MY,2014.0,2,1,1
JP,PS,2005.0,1,1,0
UG,CH,2015.0,4,6,-2
GB,ZW,2006.0,3,5,-2
CA,MW,2022.0,1,1,0
KE,ET,2005.0,2,3,-1
DK,LT,2008.0,1,2,-1
DE,IQ,2008.0,2,2,0
SD,NL,2001.0,1,2,-1
ZA,VN,2016.0,1,2,-1
FI,IE,2019.0,3,7,-4
JP,SV,2011.0,2,1,1
HK,TW,2008.0,1,5,-4
ES,LT,2009.0,1,2,-1
CU,PE,2022.0,4,6,-2
KZ,RU,1998.0,8,3,5
ZW,CH,2000.0,1,2,-1
BF,US,2010.0,2,1,1
VN,NL,2006.0,3,4,-1
DZ,IR,2014.0,2,4,-2
PK,VN,2021.0,2,2,0
BO,NL,2015.0,1,1,0
XK,HU,2016.0,1,1,0
CO,VE,1999.0,5,7,-2
ML,BF,2004.0,1,1,0
UG,TZ,2013.0,2,4,-2
ZM,CD,2018.0,1,1,0
KZ,GB,2011.0,1,2,-1
CW,DE,2009.0,2,3,-1
CH,IR,2005.0,1,2,-1
MX,IE,2016.0,1,2,-1
CD,CN,2013.0,1,2,-1
HU,SK,2001.0,2,2,0
EC,VE,2012.0,2,6,-4
LB,IT,2002.0,1,2,-1
TR,OM,2018.0,1,2,-1
BW,CA,2013.0,1,2,-1
FI,IE,2010.0,1,4,-3
MY,UZ,2008.0,1,1,0
nan,DK,1999.0,6,2,4
JP,IQ,2015.0,3,1,2
BD,KR,2000.0,1,1,0
TH,IT,2003.0,4,1,3
MX,AF,2008.0,2,5,-3
US,GA,2020.0,2,1,1
UG,GH,2018.0,1,2,-1
HN,US,2001.0,2,1,1
SG,FR,2001.0,2,1,1
MY,BD,2002.0,2,4,-2
CL,BG,2020.0,1,1,0
ZA,HU,2018.0,2,1,1
CA,CM,2018.0,3,6,-3
FI,GH,2020.0,1,1,0
DE,ML,2017.0,1,2,-1
VG,CN,2013.0,2,1,1
ES,GT,2010.0,4,4,0
OM,AU,2009.0,2,3,-1
SA,HU,2012.0,1,1,0
ZW,BH,2020.0,2,3,-1
NO,AU,2001.0,3,5,-2
OM,SG,2006.0,1,1,0
RU,VN,2022.0,2,4,-2
GE,CZ,2012.0,2,3,-1
SI,PL,2009.0,1,3,-2
SA,GR,2015.0,2,3,-1
EG,CL,2018.0,1,1,0
EE,ES,2010.0,1,3,-2
BD,SA,2010.0,2,5,-3
KR,IL,2008.0,3,2,1
MX,SV,2005.0,1,1,0
SK,UA,2009.0,9,2,7
GB,CL,2003.0,16,4,12
CH,GB,2003.0,146,136,10
CL,ES,2006.0,130,138,-8
GB,TZ,2017.0,19,15,4
NL,ES,2020.0,92,129,-37
IR,FR,2013.0,16,35,-19
CL,MX,2014.0,142,163,-21
JP,HU,2001.0,9,9,0
US,IL,2002.0,316,410,-94
CU,MX,2002.0,29,19,10
DE,IT,2022.0,238,192,46
US,ID,2011.0,80,56,24
CN,DE,1998.0,71,57,14
CN,PK,2001.0,16,16,0
MX,FR,2006.0,33,41,-8
JP,CA,2020.0,74,116,-42
IT,TN,2015.0,22,17,5
FI,JP,2020.0,21,17,4
RO,ES,2004.0,6,2,4
BR,IR,2017.0,13,13,0
JP,nan,2014.0,39,43,-4
NG,CN,2015.0,18,9,9
GB,OM,2017.0,21,10,11
CN,DE,1997.0,49,48,1
CN,ET,2021.0,29,16,13
MY,GB,2021.0,88,87,1
SD,US,2005.0,2,5,-3
PK,SA,2010.0,21,17,4
JO,US,2020.0,63,68,-5
DE,KE,2016.0,16,11,5
SA,DE,2013.0,18,35,-17
PH,NL,2015.0,5,2,3
nan,NL,2002.0,27,40,-13
US,CY,2022.0,11,15,-4
KE,RW,2021.0,6,7,-1
IN,BE,2014.0,41,32,9
IN,ES,2022.0,13,17,-4
TH,LK,2018.0,4,2,2
CN,FR,2022.0,113,127,-14
GH,CN,2020.0,36,61,-25
TR,US,2008.0,318,337,-19
SE,TN,2021.0,3,2,1
AM,US,2001.0,5,2,3
IN,TW,2013.0,45,45,0
US,AM,2020.0,8,15,-7
UY,ES,2005.0,24,13,11
US,PE,2006.0,37,33,4
ML,CI,2018.0,3,5,-2
GB,IR,1997.0,7,5,2
AE,MY,2021.0,6,19,-13
RU,PT,2020.0,13,24,-11
JO,CA,2006.0,4,4,0
CA,CZ,2014.0,19,12,7
PT,SE,2005.0,9,10,-1
HU,BR,2016.0,4,3,1
ES,IT,2023.0,14,20,-6
GB,KZ,2016.0,17,7,10
EC,MX,2022.0,51,36,15
UA,NO,2019.0,3,2,1
AU,BE,2012.0,27,44,-17
PL,CH,2007.0,9,12,-3
CL,CN,2016.0,3,5,-2
NZ,NO,2014.0,6,1,5
AR,nan,2007.0,26,21,5
CH,RU,2002.0,8,21,-13
IE,SE,2016.0,6,15,-9
TR,IN,2008.0,12,9,3
HU,FR,2000.0,12,15,-3
FI,AR,2013.0,2,1,1
ES,PY,2020.0,18,23,-5
HR,MX,2010.0,1,5,-4
NL,SY,2009.0,1,1,0
MX,BR,1997.0,12,7,5
TW,EG,2017.0,18,8,10
BR,RO,2011.0,1,2,-1
TN,QA,2012.0,3,1,2
NZ,SG,2012.0,7,10,-3
GT,US,2014.0,9,9,0
SE,BD,2011.0,5,2,3
NO,ES,2002.0,14,10,4
TW,nan,2003.0,5,3,2
CN,QA,2006.0,8,11,-3
EG,TW,2021.0,24,24,0
IR,SA,2021.0,12,12,0
GB,NP,2008.0,7,6,1
KE,US,1998.0,14,18,-4
KW,AU,2022.0,2,3,-1
IT,GR,2006.0,22,11,11
RS,FR,2008.0,6,1,5
LV,BE,2013.0,2,1,1
UG,SE,2020.0,3,2,1
AE,IQ,2010.0,2,3,-1
VN,JP,2003.0,8,11,-3
IE,BD,2013.0,2,2,0
LK,BN,2016.0,2,2,0
LB,CA,2001.0,6,3,3
BR,NO,2009.0,20,21,-1
MY,ZA,2016.0,4,6,-2
CZ,nan,2013.0,8,6,2
BG,JP,2013.0,6,5,1
FI,ET,2019.0,4,3,1
PG,PK,2014.0,1,1,0
DE,PE,2016.0,11,9,2
JM,FR,2017.0,1,1,0
DE,ML,2019.0,1,2,-1
PA,SE,2013.0,2,2,0
KE,RU,2020.0,2,1,1
DK,IE,2019.0,14,15,-1
LK,GB,2013.0,12,32,-20
IN,DK,2010.0,16,12,4
RO,CN,2005.0,2,2,0
IN,BH,2017.0,3,3,0
ES,GT,2019.0,14,14,0
US,VN,1999.0,5,4,1
NL,TH,2006.0,4,4,0
IN,KE,2005.0,4,3,1
CH,MX,2009.0,6,6,0
NL,PH,2004.0,2,2,0
GB,SI,2004.0,7,4,3
TZ,IN,2015.0,2,6,-4
TT,GB,2010.0,4,6,-2
ZA,KE,2007.0,6,5,1
NP,JP,2021.0,3,7,-4
FI,AU,2022.0,8,5,3
ID,FR,2009.0,4,11,-7
KZ,TR,2001.0,6,4,2
JP,NG,2015.0,13,18,-5
ES,RS,1998.0,1,1,0
RS,NL,2015.0,6,10,-4
ID,ZA,2013.0,3,5,-2
AO,JP,2016.0,2,1,1
DE,ID,2002.0,3,1,2
US,SR,2019.0,1,1,0
PH,IT,2004.0,1,2,-1
PK,BE,2016.0,2,1,1
KR,VN,2003.0,2,4,-2
BE,KH,2017.0,2,3,-1
IN,TN,2008.0,5,1,4
IN,CN,1997.0,6,5,1
RU,AT,2001.0,11,4,7
KR,BR,2014.0,4,11,-7
VG,GB,2010.0,3,2,1
ES,NI,2017.0,9,6,3
SE,EC,2018.0,3,2,1
ES,DO,2011.0,2,3,-1
NG,CY,2017.0,4,1,3
AT,RS,2017.0,9,10,-1
DK,ZA,2004.0,3,1,2
PK,AR,2003.0,3,4,-1
AU,RS,2000.0,2,2,0
PL,CN,1998.0,1,3,-2
FR,KW,2008.0,3,1,2
NZ,ZA,2006.0,7,6,1
BG,MK,2021.0,2,1,1
CL,GT,2008.0,2,1,1
MO,US,2011.0,1,1,0
ZA,NZ,2018.0,13,12,1
SY,AE,2016.0,1,1,0
ME,RS,2007.0,3,6,-3
TN,IR,2016.0,11,13,-2
IE,NL,1999.0,1,5,-4
FI,EG,2012.0,2,3,-1
BO,ES,2004.0,3,4,-1
PE,NI,2020.0,2,1,1
BW,NG,2016.0,2,1,1
AT,KR,2016.0,1,4,-3
PH,FI,2021.0,1,2,-1
PH,KR,2022.0,2,5,-3
ZW,NL,1997.0,1,1,0
BN,LK,2016.0,2,2,0
KE,US,1997.0,8,9,-1
CZ,DE,2022.0,49,54,-5
AU,FI,2000.0,3,3,0
RU,FI,2008.0,20,15,5
NL,IR,2008.0,13,10,3
NI,UA,2022.0,10,7,3
ET,GB,2019.0,11,14,-3
DE,CR,2012.0,3,6,-3
AT,UA,2006.0,6,6,0
EG,TN,2016.0,9,13,-4
UG,CD,2015.0,1,1,0
CL,SV,2018.0,3,5,-2
SD,IE,2016.0,1,1,0
TW,CH,2006.0,5,5,0
NL,CA,2014.0,82,93,-11
IT,EG,1998.0,4,1,3
,JP,1996.0,29255,0,29255
NL,,2016.0,4543,0,4543
,DE,2000.0,15150,0,15150
GB,,2022.0,34267,0,34267
,BR,2011.0,21061,0,21061
PT,,2024.0,14562,0,14562
,US,2016.0,69514,0,69514
ID,,2020.0,5302,0,5302
,CL,2012.0,1874,0,1874
,JP,2004.0,16320,0,16320
,DK,2012.0,2481,0,2481
,CR,2012.0,279,0,279
,UY,2010.0,285,0,285
CA,,2013.0,5617,0,5617
CN,,2006.0,3771,0,3771
RO,,2023.0,6862,0,6862
,BD,2008.0,958,0,958
,NZ,2003.0,969,0,969
FR,,2015.0,10608,0,10608
,ZA,2006.0,1862,0,1862
JP,,2000.0,5691,0,5691
,HU,1996.0,1352,0,1352
EG,,2022.0,7352,0,7352
FR,GT,2021.0,1,0,1
,PH,2013.0,769,0,769
LB,,2018.0,248,0,248
EC,,2020.0,914,0,914
,SE,2003.0,3150,0,3150
,TW,2012.0,3893,0,3893
ET,,2022.0,1260,0,1260
QA,,2019.0,205,0,205
,HU,2004.0,1245,0,1245
,MA,2016.0,1457,0,1457
DK,,2011.0,1768,0,1768
,BN,2009.0,11,0,11
,CO,1995.0,649,0,649
HK,,2024.0,515,0,515
BE,,2018.0,3082,0,3082
,MX,2001.0,2962,0,2962
,TH,2017.0,2447,0,2447
,TH,2010.0,2686,0,2686
,PG,2007.0,19,0,19
KW,,2024.0,1057,0,1057
SA,,2018.0,1037,0,1037
HU,,2014.0,753,0,753
NO,,2015.0,1142,0,1142
,IQ,1997.0,38,0,38
,CI,2007.0,117,0,117
CI,GN,2014.0,2,0,2
PE,,2009.0,63,0,63
CO,NG,2015.0,1,0,1
,BY,2001.0,350,0,350
TR,,2005.0,492,0,492
,LK,2011.0,416,0,416
AU,PA,2007.0,1,0,1
,ML,2006.0,45,0,45
SG,,2006.0,287,0,287
SG,SA,2011.0,9,0,9
,NA,2008.0,19,0,19
,TJ,1999.0,10,0,10
,LV,2009.0,378,0,378
FO,,2024.0,71,0,71
ZW,,2017.0,91,0,91
,BG,1994.0,1412,0,1412
MN,,2022.0,190,0,190
ZW,CN,2009.0,2,0,2
HT,CN,2014.0,1,0,1
,UZ,2004.0,111,0,111
TH,PK,2013.0,12,0,12
,TN,2016.0,1352,0,1352
,UZ,1996.0,109,0,109
LY,,2020.0,71,0,71
GR,,2008.0,902,0,902
ZW,,2019.0,111,0,111
TR,,2002.0,288,0,288
BD,CY,2017.0,1,0,1
VN,,1998.0,8,0,8
QA,,2017.0,141,0,141
,MK,2006.0,77,0,77
GE,,2009.0,68,0,68
RS,CL,2019.0,1,0,1
VN,TR,2013.0,1,0,1
,RW,2005.0,11,0,11
CF,CO,2015.0,2,0,2
CA,UG,2004.0,2,0,2
IS,,2008.0,38,0,38
SG,EE,2019.0,1,0,1
,MW,1997.0,30,0,30
SI,,2008.0,127,0,127
AM,,2009.0,72,0,72
SN,,2016.0,51,0,51
BW,JP,2018.0,1,0,1
IL,VN,2015.0,1,0,1
CU,,2004.0,51,0,51
ID,MX,2002.0,1,0,1
,UY,2017.0,220,0,220
MQ,,2024.0,82,0,82
GR,NZ,2015.0,2,0,2
ET,LB,2015.0,1,0,1
,UY,2019.0,101,0,101
GE,AU,2003.0,2,0,2
,NC,2013.0,18,0,18
TZ,CN,2004.0,1,0,1
,IQ,1998.0,43,0,43
,LR,2015.0,9,0,9
JM,,2004.0,22,0,22
,BW,1998.0,40,0,40
,GP,2001.0,11,0,11
,TL,2014.0,5,0,5
KR,PR,2023.0,1,0,1
,KG,2006.0,21,0,21
,SY,2016.0,118,0,118
,MZ,2013.0,77,0,77
RU,PE,2020.0,8,0,8
TN,BY,2015.0,1,0,1
,PY,2018.0,64,0,64
MW,,2016.0,32,0,32
CI,CG,2018.0,2,0,2
CZ,MM,2021.0,29,0,29
UZ,UA,2017.0,14,0,14
,AT,2008.0,2314,0,2314
,TH,2019.0,1385,0,1385
JP,CI,2018.0,2,0,2
,KP,2018.0,68,0,68
,IS,2004.0,95,0,95
CM,,2011.0,42,0,42
,HK,1999.0,22,0,22
CH,MG,2005.0,1,0,1
RO,PT,1997.0,1,0,1
KN,,2024.0,33,0,33
KH,IN,2021.0,5,0,5
NL,AZ,2005.0,1,0,1
BO,CG,2005.0,1,0,1
CH,CM,2016.0,7,0,7
BE,XK,2021.0,1,0,1
RO,TW,2010.0,1,0,1
QA,,2010.0,37,0,37
SE,TZ,2015.0,3,0,3
ZW,,2010.0,19,0,19
IR,,1998.0,14,0,14
MG,,2016.0,52,0,52
IE,JO,2016.0,2,0,2
,MD,2015.0,62,0,62
GR,GH,2012.0,4,0,4
KZ,,2004.0,17,0,17
UG,BR,2011.0,1,0,1
MD,FI,2016.0,1,0,1
IL,TZ,2000.0,1,0,1
IE,UG,2009.0,1,0,1
,IS,1996.0,130,0,130
PK,,1998.0,42,0,42
TR,RU,1999.0,2,0,2
,RE,2014.0,29,0,29
FR,MU,2016.0,2,0,2
AZ,FR,2016.0,2,0,2
DZ,SG,2016.0,3,0,3
AG,DE,2020.0,1,0,1
,BW,1997.0,31,0,31
TN,SY,2006.0,1,0,1
GB,BH,2004.0,1,0,1
PW,,2019.0,1,0,1
,MU,2007.0,29,0,29
GE,GR,2009.0,1,0,1
,RW,2002.0,8,0,8
BG,IQ,2017.0,1,0,1
SK,LY,2011.0,1,0,1
BG,ZA,2019.0,2,0,2
AF,,2011.0,5,0,5
ET,MX,2010.0,2,0,2
NO,AR,2013.0,3,0,3
ET,CA,1998.0,1,0,1
BO,,2014.0,33,0,33
SE,PE,2014.0,6,0,6
,MR,2011.0,8,0,8
AR,CN,2003.0,2,0,2
RS,XK,2006.0,2,0,2
SG,JO,2021.0,1,0,1
CN,CG,2012.0,1,0,1
BR,PH,2006.0,3,0,3
CN,VG,1997.0,1,0,1
EC,CR,2002.0,1,0,1
EG,NC,2019.0,1,0,1
LV,CA,2017.0,1,0,1
TG,,2012.0,7,0,7
,GH,2020.0,37,0,37
MZ,LT,2013.0,9,0,9
SV,KR,2002.0,1,0,1
RS,MK,2012.0,2,0,2
ZM,CA,2001.0,2,0,2
BW,,2003.0,6,0,6
,LU,2000.0,37,0,37
LV,CN,2019.0,1,0,1
DE,BF,2012.0,1,0,1
IT,LK,2019.0,4,0,4
TL,AU,2020.0,1,0,1
MN,UA,2020.0,1,0,1
GH,OM,2021.0,18,0,18
UZ,PL,2015.0,2,0,2
UA,PK,2006.0,1,0,1
NO,FO,2014.0,2,0,2
,BI,2014.0,26,0,26
,SL,2008.0,11,0,11
PE,FR,2002.0,2,0,2
CN,BB,2019.0,1,0,1
,WS,2005.0,1,0,1
SA,RW,2019.0,1,0,1
BE,KE,2007.0,5,0,5
RO,CA,2000.0,5,0,5
MU,GE,2006.0,1,0,1
AU,IR,2002.0,18,0,18
AM,PH,2000.0,2,0,2
MK,HR,2013.0,2,0,2
,MW,1998.0,25,0,25
UA,CL,2017.0,2,0,2
FI,GP,2016.0,1,0,1
VG,SK,2009.0,1,0,1
BJ,SN,2009.0,2,0,2
TD,TN,2018.0,1,0,1
AZ,KR,2022.0,1,0,1
BR,MY,1997.0,1,0,1
AE,NL,2009.0,6,0,6
US,GM,2007.0,5,0,5
TZ,CH,2010.0,2,0,2
MK,ET,2015.0,1,0,1
AE,ES,2004.0,1,0,1
SK,BJ,2009.0,1,0,1
NI,IT,2012.0,1,0,1
US,NC,2006.0,2,0,2
HR,DK,2012.0,2,0,2
MD,RU,1997.0,3,0,3
LV,,2004.0,40,0,40
RS,MY,2014.0,1,0,1
EG,BE,2024.0,1,0,1
LV,JP,1997.0,1,0,1
PS,,2001.0,6,0,6
PK,PH,2013.0,3,0,3
RO,MY,2016.0,2,0,2
DK,UG,2002.0,1,0,1
AT,BW,2016.0,1,0,1
ZW,CD,2016.0,1,0,1
HN,,2014.0,11,0,11
,LI,2001.0,4,0,4
ID,VE,2006.0,1,0,1
PS,IE,2019.0,1,0,1
EG,LU,2016.0,1,0,1
DK,ID,2000.0,1,0,1
CI,EG,2016.0,3,0,3
ID,PA,2005.0,4,0,4
TR,DZ,2011.0,2,0,2
,GF,2005.0,2,0,2
GT,IT,2001.0,2,0,2
GM,,2002.0,5,0,5
NG,GD,2021.0,1,0,1
AT,KE,2021.0,4,0,4
AU,MT,2008.0,1,0,1
HR,nan,2004.0,1,0,1
CN,AE,2011.0,1,0,1
QA,SA,1997.0,1,0,1
JO,FR,2000.0,1,0,1
KR,CL,2014.0,3,0,3
PY,,2014.0,8,0,8
AM,LK,2001.0,1,0,1
BE,RW,2006.0,2,0,2
CD,MW,2021.0,1,0,1
LV,CA,2010.0,1,0,1
SJ,DE,2022.0,2,0,2
PS,PK,2022.0,1,0,1
,MG,2000.0,13,0,13
EE,ID,2006.0,1,0,1
LT,KH,2009.0,1,0,1
SI,MY,2012.0,2,0,2
DE,BW,2000.0,1,0,1
CU,PL,2004.0,1,0,1
,NI,2001.0,5,0,5
GT,nan,2005.0,1,0,1
CA,BI,2006.0,1,0,1
NO,MN,2007.0,1,0,1
NZ,FI,2022.0,8,0,8
FI,TR,2002.0,1,0,1
ES,NZ,2006.0,3,0,3
SC,US,2004.0,1,0,1
CN,BD,1997.0,3,0,3
CA,FK,2017.0,1,0,1
GB,GD,2002.0,1,0,1
ET,ZA,2001.0,1,0,1
QA,CL,2022.0,1,0,1
CI,SN,2017.0,3,0,3
GB,PE,1998.0,1,0,1
BR,EC,1999.0,1,0,1
NA,,2005.0,3,0,3
SR,,2024.0,20,0,20
LA,NC,2013.0,1,0,1
ZA,HK,2003.0,1,0,1
KZ,SG,2022.0,1,0,1
MG,MY,2021.0,1,0,1
IN,HU,2023.0,1,0,1
AE,BE,2004.0,1,0,1
PA,,2001.0,3,0,3
AO,nan,2018.0,1,0,1
CA,PG,2009.0,1,0,1
PT,PK,2014.0,3,0,3
GP,SN,2002.0,1,0,1
NO,MD,2013.0,1,0,1
GR,QA,2008.0,2,0,2
DE,CG,2013.0,1,0,1
HU,MN,2021.0,1,0,1
WS,,2019.0,3,0,3
DE,ZM,2008.0,1,0,1
BE,TT,2007.0,1,0,1
MA,AE,2015.0,4,0,4
CM,SN,2007.0,1,0,1
TR,PG,2013.0,1,0,1
NC,NO,1998.0,3,0,3
IT,SL,2017.0,2,0,2
SS,,2014.0,2,0,2
VN,BY,2000.0,1,0,1
HR,NZ,2017.0,1,0,1
BD,IL,2015.0,3,0,3
PT,RS,1998.0,1,0,1
DZ,SE,2011.0,3,0,3
LS,,1999.0,1,0,1
TW,SZ,2019.0,1,0,1
EG,NP,2018.0,1,0,1
TH,VN,1997.0,1,0,1
CU,DE,1999.0,3,0,3
,TG,2000.0,15,0,15
DO,NZ,2001.0,1,0,1
WS,,2017.0,3,0,3
KP,CH,2019.0,1,0,1
GB,BI,2022.0,1,0,1
ID,PE,2002.0,1,0,1
HT,,2012.0,1,0,1
SK,BG,1997.0,2,0,2
IT,ML,2011.0,1,0,1
MQ,JM,2020.0,1,0,1
PW,,2017.0,2,0,2
IR,CD,2017.0,2,0,2
,SC,2009.0,5,0,5
GB,IM,2016.0,1,0,1
MY,EE,2019.0,1,0,1
RS,CL,2017.0,1,0,1
EG,KE,2006.0,2,0,2
FI,VE,2001.0,1,0,1
PT,QA,2017.0,2,0,2
ZA,TT,2019.0,3,0,3
EE,AL,2017.0,1,0,1
AL,EG,2015.0,1,0,1
ZW,ER,2003.0,1,0,1
IN,AG,2012.0,2,0,2
AZ,TJ,2019.0,2,0,2
UY,IL,2006.0,1,0,1
TR,MY,2008.0,4,0,4
AR,UA,2013.0,1,0,1
JP,VG,2015.0,1,0,1
CO,AE,2021.0,2,0,2
PR,CN,2009.0,1,0,1
HU,XK,2022.0,1,0,1
TW,MD,2007.0,1,0,1
GN,TD,2021.0,1,0,1
IT,MK,2007.0,1,0,1
AE,FJ,2021.0,1,0,1
US,WS,2017.0,1,0,1
AT,QA,2021.0,1,0,1
CG,BE,2020.0,1,0,1
SG,CH,2023.0,1,0,1
GM,FR,1998.0,1,0,1
MK,AL,2020.0,6,0,6
NP,AE,2014.0,1,0,1
MX,BA,2011.0,1,0,1
ES,GI,2012.0,1,0,1
GM,,2005.0,4,0,4
KR,PA,2009.0,1,0,1
UG,SG,2011.0,1,0,1
BW,BJ,2020.0,1,0,1
BH,PL,2007.0,1,0,1
QA,PS,1998.0,1,0,1
BR,SG,2005.0,1,0,1
nan,CY,2014.0,1,0,1
FI,KW,2020.0,1,0,1
CZ,EG,2003.0,1,0,1
RE,MD,2020.0,1,0,1
ZM,GR,2019.0,1,0,1
VE,ZA,2004.0,1,0,1
MD,PK,2014.0,1,0,1
IT,GM,2013.0,1,0,1
LV,FI,2016.0,1,0,1
RS,TR,2022.0,1,0,1
IR,CO,2023.0,1,0,1
BY,LV,1999.0,1,0,1
ZA,TT,2017.0,2,0,2
SD,BE,2021.0,1,0,1
NE,CN,2022.0,1,0,1
BH,SD,2021.0,1,0,1
MY,PG,2019.0,1,0,1
RO,VN,2021.0,1,0,1
FJ,,2007.0,5,0,5
PG,CA,2012.0,1,0,1
KE,CM,2001.0,1,0,1
CA,FJ,1999.0,1,0,1
CF,BJ,2017.0,1,0,1
AT,LT,2005.0,1,0,1
KW,MY,2004.0,2,0,2
ZM,TZ,2012.0,1,0,1
,IM,2015.0,1,0,1
CV,,2021.0,4,0,4
IT,TJ,2021.0,1,0,1
,WS,2002.0,1,0,1
NL,PA,2015.0,4,0,4
CH,BW,2018.0,2,0,2
TZ,TW,2022.0,3,0,3
CH,SA,2004.0,1,0,1
PH,GA,2010.0,1,0,1
SY,KE,2014.0,2,0,2
JP,SD,2002.0,2,0,2
CF,,2015.0,1,0,1
SE,RS,2001.0,1,0,1
SA,GH,2022.0,1,0,1
SG,PT,2005.0,1,0,1
MD,DE,2006.0,1,0,1
ES,CV,2019.0,3,0,3
CA,ME,2021.0,1,0,1
TW,GE,1997.0,1,0,1
AT,MN,2008.0,1,0,1
PK,ZA,2008.0,3,0,3
KE,CL,2018.0,2,0,2
MN,PK,2020.0,1,0,1
CY,,2000.0,4,0,4
HU,ET,2014.0,1,0,1
NZ,UG,2011.0,2,0,2
SG,GR,1999.0,1,0,1
NO,VG,2006.0,1,0,1
BD,CY,2010.0,1,0,1
PL,TW,2006.0,1,0,1
SZ,GP,2017.0,1,0,1
SY,ET,2009.0,1,0,1
PS,JP,2001.0,1,0,1
US,PK,2024.0,4,0,4
MM,NZ,2021.0,1,0,1
ZW,RU,2002.0,5,0,5
MX,TR,2011.0,1,0,1
PA,SG,1999.0,1,0,1
SD,,2005.0,13,0,13
MZ,DK,2019.0,1,0,1
CR,BZ,2020.0,1,0,1
BY,NL,2006.0,1,0,1
CG,PK,2000.0,1,0,1
TZ,NA,2012.0,1,0,1
IE,TH,2011.0,1,0,1
MR,,2013.0,6,0,6
GF,,1999.0,1,0,1
SE,NI,2010.0,1,0,1
PL,VN,2005.0,1,0,1
ZM,LK,2012.0,1,0,1
IL,NP,2007.0,1,0,1
LB,KW,2021.0,4,0,4
QA,IL,2000.0,2,0,2
SL,NL,2021.0,1,0,1
SZ,OM,2018.0,1,0,1
PY,CZ,2008.0,1,0,1
JP,AE,2005.0,1,0,1
SD,,2002.0,2,0,2
YE,SD,2018.0,1,0,1
DK,SJ,2021.0,1,0,1
MO,BR,2010.0,1,0,1
NZ,ZW,2006.0,1,0,1
NL,CR,2010.0,1,0,1
GB,CY,1997.0,2,0,2
ID,GE,2012.0,1,0,1
CM,NL,2013.0,2,0,2
SZ,ZM,2019.0,1,0,1
NG,IR,2023.0,1,0,1
TH,HK,2020.0,1,0,1
PT,EG,2008.0,2,0,2
CH,MN,2021.0,1,0,1
CR,PK,2010.0,1,0,1
TH,VG,2016.0,1,0,1
,BT,2013.0,4,0,4
RE,MG,2016.0,1,0,1
MK,ES,2016.0,1,0,1
VG,GB,2019.0,2,0,2
SN,GF,1998.0,1,0,1
BN,NE,2021.0,1,0,1
GT,AR,2006.0,2,0,2
NL,NG,2015.0,5,0,5
GT,CU,2013.0,1,0,1
AU,NC,2015.0,3,0,3
CD,TH,2020.0,1,0,1
IE,RO,2000.0,2,0,2
GH,VN,2012.0,1,0,1
ID,BJ,2011.0,1,0,1
IR,SK,2018.0,4,0,4
GR,VG,2002.0,1,0,1
SO,PK,2013.0,1,0,1
NL,VG,2001.0,2,0,2
BB,PT,2022.0,1,0,1
MY,AF,2018.0,1,0,1
KW,HU,2006.0,1,0,1
BF,TD,2000.0,1,0,1
CO,NZ,2004.0,2,0,2
MM,,2004.0,2,0,2
LT,LU,2016.0,1,0,1
KG,GB,2010.0,1,0,1
JP,SD,2005.0,3,0,3
TH,VN,1998.0,1,0,1
KR,NO,2003.0,2,0,2
GM,CA,2013.0,1,0,1
GP,DE,2009.0,1,0,1
,GF,2002.0,4,0,4
VE,CZ,2020.0,1,0,1
SE,NI,2019.0,1,0,1
FI,BG,2008.0,1,0,1
GB,MZ,2012.0,1,0,1
AM,SE,2017.0,2,0,2
US,CF,2008.0,1,0,1
NL,CU,1998.0,1,0,1
CN,IQ,2007.0,3,0,3
AT,KW,2013.0,2,0,2
CM,TR,2017.0,1,0,1
CL,nan,1998.0,1,0,1
MW,BD,2007.0,1,0,1
BH,BN,1998.0,1,0,1
TW,PT,2021.0,1,0,1
ET,NP,2022.0,1,0,1
NP,nan,2013.0,2,0,2
UA,UZ,1999.0,1,0,1
IE,IQ,2016.0,2,0,2
SY,KR,2016.0,1,0,1
ZA,ID,2009.0,1,0,1
BJ,KE,2021.0,1,0,1
AR,KR,2018.0,1,0,1
NL,AD,2016.0,1,0,1
RU,NP,2021.0,1,0,1
UA,SI,2022.0,2,0,2
AZ,GE,2015.0,1,0,1
CO,VN,2021.0,1,0,1
DE,KZ,2009.0,3,0,3
IN,LY,2005.0,2,0,2
GM,AU,2018.0,1,0,1
MQ,BJ,2021.0,1,0,1
IQ,GR,2009.0,1,0,1
VG,BE,2016.0,1,0,1
GW,BR,2003.0,1,0,1
UG,LK,2005.0,1,0,1
PG,PH,2015.0,1,0,1
BJ,MQ,2018.0,1,0,1
AO,IT,2009.0,1,0,1
MD,GB,2022.0,1,0,1
JP,DZ,2018.0,3,0,3
CM,VN,2011.0,1,0,1
KW,FI,2008.0,1,0,1
SG,NP,2018.0,2,0,2
US,MV,2008.0,1,0,1
TN,JP,2008.0,3,0,3
NZ,KZ,2012.0,1,0,1
ET,CL,2006.0,1,0,1
QA,YE,2014.0,1,0,1
,GL,2003.0,2,0,2
QA,SD,2006.0,1,0,1
GR,LT,2017.0,1,0,1
FJ,FR,2020.0,1,0,1
ZW,GR,2000.0,1,0,1
CL,LK,2017.0,1,0,1
LA,BM,2011.0,1,0,1
PY,DO,2019.0,2,0,2
FI,LU,1999.0,1,0,1
BE,ET,2006.0,1,0,1
RE,RU,2022.0,1,0,1
RU,LB,2005.0,1,0,1
HT,GB,2019.0,1,0,1
SI,RU,2022.0,1,0,1
PS,GB,2000.0,1,0,1
UZ,UA,2010.0,4,8,-4
EC,IL,2019.0,2,1,1
US,BN,1998.0,1,1,0
HR,SI,2023.0,1,1,0
GB,BB,2013.0,2,3,-1
PE,SE,2017.0,1,3,-2
FR,MW,2017.0,2,1,1
GB,FJ,1998.0,2,1,1
nan,TZ,2007.0,1,2,-1
FO,DK,2015.0,1,2,-1
JO,DZ,2012.0,1,1,0
SA,IT,2009.0,1,4,-3
PT,FI,2021.0,1,2,-1
PS,ID,2021.0,1,2,-1
MT,NL,2018.0,1,1,0
VE,UY,2002.0,1,1,0
NO,EG,2009.0,2,1,1
PE,BE,2010.0,1,2,-1
GE,DE,2005.0,2,1,1
NO,UA,2022.0,1,2,-1
RO,CZ,1999.0,1,1,0
FR,PS,2011.0,1,1,0
DJ,FR,2015.0,2,3,-1
RU,AZ,2012.0,8,9,-1
BG,RO,2005.0,1,2,-1
ZA,MA,2013.0,2,1,1
CH,IR,2002.0,1,1,0
ML,DE,2021.0,2,1,1
IT,TW,1999.0,1,2,-1
AU,SI,2008.0,1,3,-2
GH,BF,2021.0,2,2,0
QA,OM,2016.0,2,3,-1
TR,SD,2021.0,1,1,0
NO,GR,2012.0,2,4,-2
IL,KW,2005.0,1,1,0
SA,ES,2020.0,6,9,-3
VN,PL,2006.0,1,1,0
NL,KE,2000.0,1,2,-1
MN,US,2009.0,2,1,1
TH,BD,2008.0,2,1,1
PK,TN,2008.0,1,2,-1
BJ,BE,2009.0,1,3,-2
TN,CH,2004.0,1,1,0
CL,PH,2005.0,1,3,-2
MY,NG,2009.0,1,5,-4
BE,CU,2022.0,1,1,0
CL,IE,2003.0,1,1,0
BR,HR,2006.0,1,1,0
YE,IN,2014.0,1,3,-2
LB,BR,2005.0,1,2,-1
HR,SK,2011.0,2,3,-1
BE,TH,1999.0,1,1,0
IE,AR,1999.0,1,2,-1
VE,NL,2012.0,1,1,0
NZ,CZ,2004.0,1,1,0
TJ,UZ,2022.0,2,2,0
MX,ZW,2015.0,2,1,1
SN,DK,2017.0,1,1,0
TR,TW,2023.0,1,1,0
ID,KH,2017.0,2,1,1
SE,PT,1999.0,2,1,1
UZ,RS,2015.0,1,1,0
GB,BM,2011.0,1,1,0
OM,DE,2004.0,1,1,0
FI,GR,2006.0,3,1,2
TR,RW,2011.0,1,4,-3
SI,TW,2012.0,1,2,-1
RS,CL,2010.0,1,1,0
AU,CL,2004.0,1,3,-2
SG,PT,2002.0,1,1,0
MW,NO,2013.0,1,3,-2
UA,IL,2013.0,4,5,-1
MX,UA,1998.0,3,2,1
RS,DE,1999.0,2,4,-2
UA,BE,1999.0,3,1,2
IR,RU,2008.0,2,15,-13
TT,NL,2008.0,1,1,0
BH,GB,2018.0,5,9,-4
GR,PT,2019.0,3,6,-3
AT,BG,1999.0,1,4,-3
AE,ID,2015.0,3,2,1
OM,JO,2021.0,1,2,-1
SY,GB,2004.0,1,1,0
TR,BD,2018.0,1,3,-2
CO,UA,2008.0,2,1,1
MZ,JP,2019.0,1,1,0
SG,NG,2018.0,1,1,0
KH,JP,1998.0,2,1,1
JP,MX,2023.0,1,1,0
AE,TN,2015.0,1,6,-5
EG,YE,2009.0,2,2,0
LV,CN,2017.0,1,1,0
ET,BR,2015.0,1,1,0
MW,KE,2008.0,1,1,0
GB,FJ,1997.0,2,1,1
CN,HR,2022.0,1,2,-1
LT,CH,2008.0,1,1,0
EE,CA,2015.0,1,2,-1
DE,BH,2021.0,1,1,0
ZW,ZM,2010.0,1,1,0
CZ,RO,1999.0,1,1,0
RU,CL,2013.0,2,5,-3
VN,LU,2019.0,1,1,0
JP,HR,2001.0,1,2,-1
BJ,BI,2005.0,1,1,0
PT,AR,2005.0,4,7,-3
TW,BE,2018.0,3,2,1
ZA,MZ,2011.0,2,1,1
UZ,IL,2005.0,1,1,0
AU,SD,2003.0,1,1,0
CH,KE,2011.0,2,2,0
MX,EG,2018.0,2,1,1
SI,IN,2011.0,2,2,0
CO,SV,2013.0,3,3,0
SI,IE,2005.0,1,1,0
PL,GB,2023.0,3,5,-2
ME,HR,2011.0,1,1,0
TR,KW,2008.0,1,5,-4
HR,IT,2001.0,2,2,0
TR,NL,1997.0,1,1,0
BE,PE,2002.0,1,1,0
SI,TR,2013.0,1,1,0
EG,CH,2002.0,1,3,-2
KZ,FR,2014.0,2,2,0
IS,IL,2018.0,1,1,0
BR,KW,2020.0,1,1,0
HN,EC,2015.0,1,1,0
KW,PK,2001.0,1,2,-1
CZ,AM,2012.0,1,1,0
PH,IE,2007.0,1,1,0
UA,MD,2015.0,1,1,0
CN,AO,2013.0,1,1,0
PL,IN,2023.0,1,3,-2
FI,QA,2009.0,1,1,0
AU,BN,2006.0,2,1,1
LK,KE,2008.0,1,1,0
NG,IN,2007.0,1,2,-1
CN,OM,2020.0,1,3,-2
EC,ES,2001.0,1,2,-1
TW,CZ,2014.0,1,2,-1
CA,GE,2013.0,1,2,-1
QA,NG,2016.0,1,2,-1
FR,CF,2009.0,1,1,0
BO,IT,2009.0,1,1,0
CG,US,2006.0,1,1,0
NG,BF,2005.0,1,1,0
BO,CR,2015.0,1,2,-1
IR,CH,2023.0,1,1,0
UG,ID,2022.0,1,1,0
LY,JO,2021.0,1,3,-2
FR,BZ,2001.0,1,4,-3
PT,HU,2003.0,1,2,-1
KE,SN,2016.0,1,2,-1
PK,LY,2019.0,1,2,-1
PL,nan,1998.0,1,2,-1
RO,PK,2018.0,1,2,-1
EE,ES,2019.0,3,3,0
US,CG,2012.0,1,1,0
GR,IR,2010.0,2,1,1
KW,DE,2002.0,1,1,0
BA,PL,2013.0,1,7,-6
US,SR,2017.0,1,1,0
PL,CN,1997.0,1,4,-3
BF,ML,2003.0,1,1,0
CW,ID,2020.0,1,1,0
ES,PL,2000.0,1,5,-4
CI,CH,2014.0,1,1,0
CY,CH,2013.0,1,2,-1
CU,PH,2014.0,1,1,0
ZW,FR,2016.0,2,2,0
NG,RU,2013.0,1,1,0
US,NE,2012.0,1,1,0
AU,EG,2000.0,1,1,0
GH,FR,2015.0,2,1,1
BD,BH,2020.0,1,1,0
BE,KH,2010.0,1,2,-1
EC,BE,2015.0,1,10,-9
NO,IR,2004.0,1,1,0
GE,JP,2018.0,1,1,0
ET,CA,1997.0,1,1,0
CH,CD,2018.0,1,2,-1
GR,AU,2022.0,1,9,-8
ES,PA,2000.0,1,2,-1
NG,IL,2022.0,2,2,0
AT,BD,2022.0,1,1,0
PH,EG,2016.0,1,1,0
MR,SN,2008.0,1,1,0
NA,US,2012.0,1,3,-2
CI,SN,2019.0,2,4,-2
QA,DZ,2015.0,1,1,0
DK,FI,2023.0,1,2,-1
PE,IE,2014.0,1,1,0
UZ,AU,2017.0,1,1,0
TW,GM,2021.0,1,1,0
DK,AE,2022.0,1,2,-1
HU,UA,2021.0,2,4,-2
SL,DE,2018.0,1,1,0
BW,FR,2006.0,1,2,-1
ZM,BH,2011.0,1,1,0
FI,TR,2005.0,3,3,0
MX,SV,2002.0,1,1,0
SE,ID,2006.0,2,1,1
PH,MY,2021.0,2,3,-1
BS,US,2009.0,2,2,0
IT,CM,2008.0,2,2,0
PH,IL,2003.0,1,1,0
RS,JP,2010.0,2,2,0
GA,CM,2013.0,1,1,0
FI,SK,2001.0,2,3,-1
PL,SK,2004.0,1,5,-4
CO,AT,2020.0,2,2,0
BE,PH,2018.0,2,2,0
LU,ZA,2020.0,2,1,1
EC,NI,2016.0,1,1,0
MK,CN,2012.0,3,5,-2
HR,ES,2006.0,1,2,-1
PK,nan,2009.0,3,1,2
GB,PA,2013.0,1,8,-7
EC,RU,1997.0,1,1,0
nan,SI,2006.0,1,1,0
KH,GB,2011.0,1,2,-1
FR,JM,2018.0,1,1,0
PT,QA,2019.0,1,2,-1
SM,IT,2013.0,1,3,-2
AE,AT,2020.0,1,2,-1
LV,BG,2019.0,1,1,0
SC,AU,2021.0,1,1,0
DK,KE,2012.0,3,2,1
OM,VN,2016.0,1,0,1
BN,ZA,2020.0,1,0,1
EG,CH,2005.0,3,0,3
RW,,2011.0,2,0,2
CM,BD,2014.0,1,0,1
KH,nan,2020.0,1,0,1
IL,LU,2014.0,1,0,1
CG,,1999.0,2,0,2
GB,SO,2012.0,1,0,1
NG,LK,2016.0,1,0,1
BE,GH,2014.0,2,0,2
IN,VG,2002.0,1,0,1
CA,VG,2006.0,2,0,2
,FO,1995.0,2,0,2
OM,PH,2016.0,1,0,1
JM,NZ,2020.0,1,0,1
ET,GB,2010.0,5,0,5
GT,BO,2020.0,1,0,1
PG,BE,2018.0,1,0,1
PT,DZ,2001.0,1,0,1
NP,MV,2019.0,1,0,1
HR,OM,2018.0,1,0,1
ET,DK,2022.0,1,0,1
CG,FR,1997.0,1,0,1
UY,MX,2002.0,3,0,3
ES,ST,2004.0,1,0,1
RU,VG,2008.0,2,0,2
AO,ES,1998.0,3,0,3
TW,QA,2005.0,1,0,1
HN,CR,2020.0,2,0,2
MA,FI,2001.0,1,0,1
IT,PH,2007.0,1,0,1
HR,NZ,2019.0,1,0,1
ML,,2001.0,3,0,3
DE,NA,2019.0,3,0,3
PK,LV,2019.0,1,0,1
BE,KH,2019.0,2,0,2
ID,MK,2022.0,1,0,1
EC,SG,2018.0,1,0,1
CZ,LB,2020.0,1,0,1
TW,QA,2002.0,1,0,1
GR,LT,2019.0,1,0,1
OM,GR,2020.0,1,0,1
KE,OM,2021.0,2,0,2
CL,DO,2011.0,2,0,2
BH,KR,2011.0,1,0,1
AM,PL,2018.0,2,0,2
IS,IT,2019.0,2,0,2
AU,LA,2020.0,1,0,1
PG,TN,2012.0,2,0,2
IT,LK,2010.0,1,0,1
UG,SN,2015.0,1,0,1
ZW,CZ,2013.0,1,0,1
UY,IE,2022.0,1,0,1
AT,MY,2016.0,1,0,1
nan,NA,2016.0,1,0,1
TR,AL,2020.0,2,0,2
CY,NO,2012.0,1,0,1
DK,LK,2021.0,1,0,1
CO,MZ,2015.0,2,0,2
TR,EE,2013.0,1,0,1
VN,MN,2018.0,1,0,1
SL,GB,2001.0,1,0,1
TR,nan,1998.0,2,0,2
GY,AU,2015.0,1,0,1
SE,UY,2000.0,2,0,2
MA,GP,2001.0,1,0,1
CN,AZ,2022.0,1,0,1
AL,FI,2020.0,1,0,1
VE,NG,2017.0,1,0,1
PK,CG,2017.0,1,0,1
KG,LT,2019.0,1,0,1
TH,BJ,2002.0,1,0,1
NL,UA,1997.0,2,0,2
GE,KN,2015.0,1,0,1
CY,NL,2010.0,1,0,1
RE,MA,2013.0,1,0,1
MX,JE,2007.0,1,0,1
FR,AE,2004.0,3,0,3
KE,FR,2000.0,1,0,1
AR,NG,2012.0,1,0,1
RW,BE,1998.0,1,0,1
PL,GR,2012.0,2,0,2
DE,TJ,2017.0,2,0,2
SV,CO,2003.0,1,0,1
ES,VN,2007.0,1,0,1
CH,BN,2011.0,1,0,1
AT,KZ,2009.0,1,0,1
KR,AR,2022.0,1,0,1
US,MZ,2007.0,1,0,1
RO,SI,2005.0,2,0,2
AU,SK,2011.0,1,0,1
ET,UZ,2013.0,1,0,1
KR,VE,2008.0,1,0,1
CO,PK,2022.0,1,0,1
CH,ME,2013.0,1,0,1
AU,TZ,2008.0,1,0,1
ES,SY,2014.0,1,0,1
ID,SA,2005.0,1,0,1
EG,RO,2022.0,1,0,1
SN,IE,2017.0,1,0,1
UZ,BR,2013.0,1,0,1
IS,BR,2011.0,1,0,1
NG,BZ,2017.0,1,0,1
CL,NG,2022.0,1,0,1
UY,ET,2019.0,1,0,1
BR,CG,2009.0,2,0,2
KW,TN,2008.0,1,0,1
PE,NO,2016.0,1,0,1
BY,PL,2009.0,1,0,1
BF,CH,2012.0,1,0,1
FR,AL,2005.0,1,0,1
US,VA,2014.0,1,0,1
CH,LK,2003.0,1,0,1
NG,FJ,2000.0,1,0,1
PY,BD,2018.0,1,0,1
ZA,BH,2015.0,2,0,2
CR,AR,1999.0,1,0,1
DE,AX,2010.0,1,0,1
VE,QA,2018.0,1,0,1
NA,,2002.0,1,0,1
PL,HR,1999.0,1,0,1
SD,IQ,2007.0,1,0,1
IL,TN,2007.0,1,0,1
MY,CH,2002.0,1,0,1
BR,CV,2012.0,1,0,1
FR,LY,2018.0,1,0,1
UZ,TW,2004.0,1,0,1
TH,CG,2015.0,1,0,1
RU,ML,2007.0,1,0,1
NO,SA,2014.0,1,0,1
CH,GT,2021.0,1,0,1
SX,US,2008.0,1,0,1
VG,BR,2011.0,1,0,1
AZ,IQ,2017.0,1,0,1
MA,JP,2021.0,1,0,1
PS,IL,2023.0,1,0,1
ES,EE,1998.0,1,0,1
AZ,AE,2015.0,1,0,1
,SJ,1999.0,1,0,1
KW,LA,2008.0,1,0,1
MA,ZA,2000.0,1,0,1
AM,PT,2012.0,1,0,1
MG,ZA,2012.0,1,0,1
SD,CW,2017.0,1,0,1
IR,ZA,2023.0,1,0,1
BY,FR,2018.0,1,0,1
IN,ID,2003.0,1,0,1
FJ,WS,2004.0,1,0,1
ID,LK,2002.0,1,0,1
BY,IE,2006.0,1,0,1
GF,nan,2003.0,1,0,1
RU,NZ,2000.0,1,0,1
CY,DK,2006.0,1,0,1
PF,RE,2011.0,1,0,1
RS,PT,2008.0,1,0,1
IT,GF,2021.0,2,0,2
CI,CM,2022.0,1,0,1
US,SR,2010.0,1,0,1
BI,DE,2020.0,1,0,1
BJ,EC,2003.0,1,0,1
JM,CZ,2020.0,1,0,1
EG,EE,2017.0,1,0,1
CG,UG,2020.0,1,0,1
TW,MX,2020.0,1,0,1
PG,KH,2016.0,1,0,1
VN,EE,2021.0,1,0,1
VG,NL,2015.0,1,0,1
SI,IL,2003.0,1,0,1
KZ,KG,2012.0,1,0,1
PR,PT,2010.0,1,0,1
MY,SV,2012.0,1,0,1
ZA,EC,1997.0,1,0,1
JM,KR,2018.0,1,0,1
AE,PH,2019.0,1,0,1
RU,MM,2016.0,2,0,2
ES,MR,2007.0,1,0,1
MX,BY,2009.0,1,0,1
CI,SN,2010.0,1,0,1
JM,CR,2012.0,1,0,1
IN,DZ,2008.0,1,0,1
DO,FR,2012.0,1,0,1
JP,SY,2004.0,1,0,1
SN,NE,2017.0,1,0,1
LV,DK,2014.0,1,0,1
NP,LU,2014.0,1,0,1
BD,EG,2023.0,1,0,1
QA,LU,2017.0,1,0,1
BD,ZA,2004.0,1,0,1
IT,PS,2005.0,1,0,1
TH,TZ,2010.0,1,0,1
MD,CZ,2014.0,1,0,1
DE,ML,2010.0,1,0,1
PH,LK,2016.0,1,0,1
CM,NP,2020.0,1,0,1
VN,CZ,2023.0,1,0,1
IE,UA,2004.0,1,0,1
ER,PK,2017.0,1,0,1
IR,TN,2004.0,1,0,1
SV,,2006.0,5,0,5
MY,ST,2013.0,1,0,1
TR,NO,2023.0,1,0,1
AU,BO,2000.0,1,0,1
SE,SD,2014.0,1,0,1
CM,PK,2001.0,1,0,1
DE,FO,2009.0,1,0,1
GA,GB,2018.0,1,0,1
PY,PT,2021.0,1,0,1
HN,PE,2005.0,1,0,1
ET,CG,2012.0,1,0,1
AT,IQ,2021.0,1,0,1
IR,YE,2011.0,1,0,1
LV,BY,2004.0,1,0,1
SA,CY,2002.0,1,0,1
SE,BW,2007.0,1,0,1
MY,VE,2020.0,1,0,1
DZ,BR,2004.0,1,0,1
SA,RO,2015.0,1,0,1
CY,IE,2007.0,1,0,1
KE,UZ,2020.0,1,0,1
CU,MY,2016.0,1,0,1
FI,ZA,1999.0,1,0,1
ZW,DE,2000.0,1,0,1
UG,KE,2003.0,1,0,1
JO,NO,1999.0,1,0,1
CU,AU,1999.0,1,0,1
ER,DE,2000.0,1,0,1
DZ,RO,2020.0,1,0,1
AT,BY,2019.0,1,0,1
TW,LU,2019.0,1,0,1
PK,LT,2018.0,1,0,1
CN,UA,2014.0,15,28,-13
TR,US,1997.0,58,81,-23
PE,CO,2015.0,96,62,34
AU,GB,2014.0,1296,1504,-208
US,TW,2012.0,745,743,2
US,BR,2014.0,1202,1120,82
US,IN,2011.0,2015,1774,241
AR,BO,2020.0,6,5,1
IT,FR,2007.0,254,264,-10
US,CA,2012.0,3106,3172,-66
AU,PT,2010.0,10,8,2
IN,BD,2009.0,47,37,10
IL,US,2015.0,552,540,12
FR,ES,2004.0,158,160,-2
GB,PT,2014.0,84,121,-37
PL,nan,2008.0,9,5,4
DE,CN,2020.0,426,424,2
RU,CZ,2006.0,39,13,26
BR,PT,2005.0,333,311,22
CN,BR,2017.0,60,50,10
GB,JP,2005.0,287,234,53
JP,IN,2015.0,159,104,55
PL,GB,2011.0,90,71,19
US,UY,2013.0,26,15,11
AT,JP,2010.0,18,10,8
CH,GB,2014.0,308,302,6
US,LK,2004.0,9,7,2
US,SA,2011.0,153,59,94
PH,GB,2004.0,9,8,1
GB,AU,2022.0,855,767,88
JP,CH,2009.0,73,57,16
ES,CO,2004.0,123,133,-10
ZA,GB,2021.0,149,130,19
CU,nan,2020.0,5,5,0
SA,EG,2020.0,404,443,-39
IT,BR,2019.0,360,376,-16
FR,MX,2015.0,68,65,3
PE,US,2010.0,52,56,-4
PE,US,2017.0,76,123,-47
DE,CL,2021.0,30,56,-26
CN,DE,2008.0,208,243,-35
SE,US,2003.0,317,279,38
JP,ES,2014.0,41,42,-1
CN,KR,2020.0,296,320,-24
US,IE,2004.0,296,226,70
GR,US,1997.0,62,66,-4
CH,NO,2016.0,34,16,18
IT,BR,2010.0,216,162,54
GB,IN,2009.0,307,322,-15
AR,US,2016.0,251,268,-17
BR,US,2012.0,909,1132,-223
AU,VN,2021.0,65,41,24
IN,KR,1997.0,12,6,6
PL,DK,2009.0,15,9,6
DE,NL,2012.0,337,343,-6
BR,ES,2014.0,348,424,-76
SI,SE,2005.0,1,2,-1
ES,AR,2003.0,121,154,-33
FR,ML,2020.0,27,12,15
IN,CA,2008.0,171,91,80
BR,IT,2003.0,76,98,-22
TR,US,1998.0,102,114,-12
GB,JP,2002.0,234,236,-2
RU,US,1998.0,244,168,76
US,nan,2003.0,148,143,5
GB,MX,2016.0,58,50,8
PE,US,2019.0,151,150,1
FR,BR,2021.0,150,214,-64
US,SG,2013.0,418,366,52
CO,AO,2016.0,1,1,0
BO,ES,2001.0,2,1,1
CA,BE,2008.0,48,58,-10
CN,GB,2020.0,663,764,-101
NZ,IE,2008.0,10,10,0
ZA,CH,2012.0,16,20,-4
IN,CZ,2005.0,17,17,0
VN,FR,2019.0,26,72,-46
IN,ZA,2015.0,101,36,65
CN,CA,2006.0,282,385,-103
CR,US,2000.0,11,8,3
GB,CN,2009.0,552,393,159
PR,US,2009.0,8,2,6
CO,AR,2009.0,57,44,13
AT,US,2006.0,203,171,32
ID,PK,2020.0,47,54,-7
PE,AR,2020.0,68,66,2
SI,GB,2010.0,8,11,-3
FR,PK,2013.0,31,15,16
KR,NO,2014.0,3,7,-4
MX,BR,2008.0,62,44,18
ES,GR,2016.0,18,21,-3
FR,SE,1999.0,27,39,-12
IN,SE,2018.0,74,47,27
AU,BR,2007.0,38,41,-3
CA,GB,2006.0,615,718,-103
ES,FR,2013.0,329,285,44
KR,GB,2009.0,78,68,10
MX,CO,2005.0,97,70,27
BR,PT,2002.0,227,216,11
RU,US,1997.0,191,125,66
CH,IT,2001.0,87,127,-40
CA,AU,2003.0,176,182,-6
UA,RU,2006.0,118,107,11
IT,BR,2017.0,279,288,-9
DE,BE,2016.0,144,125,19
IN,ML,2014.0,13,6,7
JP,EG,2008.0,58,48,10
BD,AU,2019.0,122,72,50
ES,IE,2007.0,23,11,12
CA,JP,2014.0,86,100,-14
CA,TR,2016.0,31,26,5
GB,AE,2021.0,61,29,32
TN,SA,2019.0,157,50,107
GB,TW,2018.0,48,68,-20
FI,HU,2009.0,6,8,-2
HU,FI,2010.0,7,6,1
PE,MX,2022.0,48,58,-10
BE,CO,2017.0,12,14,-2
FR,TN,2000.0,43,26,17
PL,NL,1998.0,7,7,0
MX,CL,2001.0,29,27,2
CG,FR,2008.0,21,21,0
KR,CA,2005.0,37,33,4
RO,FR,2018.0,34,51,-17
DE,CA,2015.0,271,262,9
NL,PL,1997.0,7,2,5
AT,TH,2017.0,7,4,3
IL,PL,1997.0,3,3,0
PT,CA,2020.0,24,16,8
CN,PK,2004.0,29,47,-18
NG,MY,2016.0,67,91,-24
FR,LB,2022.0,39,64,-25
DK,EG,2018.0,7,4,3
IN,FR,2000.0,29,122,-93
BR,RU,2019.0,19,9,10
IN,CN,2008.0,176,143,33
KR,VN,2014.0,62,32,30
CL,PE,2012.0,61,20,41
CN,NP,2010.0,13,7,6
ES,NL,2015.0,114,68,46
CN,NG,2017.0,10,20,-10
BG,CN,2015.0,7,20,-13
NL,CW,2011.0,25,20,5
CN,BR,2019.0,59,41,18
CN,CZ,2009.0,50,62,-12
SG,RU,2019.0,8,7,1
NL,CH,2014.0,119,109,10
CN,AU,2006.0,142,183,-41
BE,TR,2015.0,15,15,0
DE,NZ,2018.0,60,45,15
TN,SA,2017.0,86,38,48
DK,BE,2019.0,64,69,-5
US,IR,2022.0,233,415,-182
AR,BR,2000.0,39,20,19
NL,RU,2004.0,12,15,-3
US,DK,2012.0,295,222,73
AT,ES,2014.0,18,35,-17
NZ,IR,2021.0,9,14,-5
FR,MA,1999.0,126,92,34
ES,IT,2011.0,131,274,-143
IQ,BD,2017.0,2,3,-1
FR,EC,2016.0,14,5,9
CM,nan,2016.0,4,3,1
DE,PL,2007.0,88,104,-16
GB,NL,2008.0,206,241,-35
GE,US,2000.0,78,67,11
NG,US,2018.0,116,151,-35
JO,DE,2003.0,6,4,2
RU,FI,1998.0,14,5,9
SI,GB,2017.0,15,8,7
nan,PT,2016.0,37,12,25
FI,SK,2004.0,6,3,3
TR,NL,2008.0,29,16,13
GR,VN,2012.0,5,4,1
RU,MN,2017.0,5,2,3
NO,GB,2005.0,35,49,-14
FR,DK,2008.0,35,25,10
CH,GR,2016.0,17,57,-40
SG,VN,2017.0,13,7,6
GB,CO,2009.0,18,10,8
ES,US,2023.0,37,36,1
SA,MY,2020.0,46,84,-38
SE,DK,2010.0,136,81,55
IE,JP,2020.0,30,27,3
VN,AU,2018.0,42,59,-17
NO,JP,2016.0,14,13,1
IR,KR,2021.0,15,3,12
SK,RU,2016.0,27,12,15
GB,GR,1999.0,59,53,6
PT,DE,2016.0,44,42,2
BE,NO,2021.0,15,10,5
BT,AU,2017.0,4,1,3
SG,DE,2013.0,22,36,-14
GR,US,1998.0,68,106,-38
US,CM,2021.0,10,18,-8
FR,AT,2018.0,64,48,16
DK,PT,2002.0,2,3,-1
KE,CA,2021.0,12,9,3
MY,IQ,2013.0,49,13,36
NL,FR,2008.0,223,148,75
VN,FR,2017.0,24,65,-41
MA,TN,2018.0,40,45,-5
SE,IT,2018.0,77,126,-49
MX,PL,2011.0,9,8,1
JP,BD,2006.0,50,28,22
CN,NG,2010.0,11,4,7
IT,PT,2005.0,13,13,0
UG,KE,2014.0,11,13,-2
CN,BR,2010.0,46,45,1
CH,HU,2021.0,13,8,5
BR,FR,2007.0,111,120,-9
DE,PK,2019.0,45,36,9
NL,SG,2020.0,15,27,-12
FR,ID,2018.0,62,33,29
PE,ES,2007.0,41,38,3
CU,CA,2018.0,10,2,8
AE,GB,2015.0,29,53,-24
IL,AT,2006.0,10,1,9
IR,IQ,2018.0,16,8,8
BR,RU,2017.0,19,22,-3
US,KW,2008.0,21,16,5
EC,ES,2004.0,11,10,1
US,CZ,2013.0,169,152,17
MA,HU,2012.0,8,7,1
AU,PL,2020.0,23,19,4
NG,GB,2004.0,12,12,0
SK,EG,2009.0,1,1,0
PY,ES,2019.0,17,35,-18
ES,ID,2016.0,18,13,5
BE,GR,2008.0,12,14,-2
HR,RS,2022.0,78,85,-7
MX,GB,2017.0,52,81,-29
LK,AU,2015.0,39,27,12
US,TH,2008.0,175,96,79
OM,PK,2018.0,8,7,1
LB,AU,2020.0,5,6,-1
PK,AR,2014.0,18,5,13
NL,ID,2022.0,27,28,-1
SK,SI,2019.0,4,7,-3
CU,ES,2020.0,92,88,4
BE,AT,2020.0,22,16,6
KR,SD,2021.0,11,10,1
NI,SV,2013.0,3,2,1
GB,SK,2020.0,16,30,-14
TR,CN,2016.0,64,16,48
CA,TN,2017.0,15,13,2
FR,SG,2015.0,32,18,14
SI,CH,2019.0,13,8,5
US,SN,2007.0,9,3,6
CZ,DK,2020.0,5,11,-6
NL,nan,2020.0,66,76,-10
IT,CY,2019.0,3,1,2
NP,KR,2021.0,13,13,0
NL,DK,2022.0,34,33,1
TH,CN,2014.0,27,29,-2
DE,KR,2010.0,35,37,-2
CN,AR,2008.0,3,2,1
CA,SA,2021.0,83,61,22
VN,TW,2022.0,22,33,-11
GB,HR,2014.0,21,21,0
ES,BE,2016.0,92,71,21
SG,CH,2011.0,9,17,-8
IL,PL,1998.0,5,1,4
ES,MT,2021.0,2,1,1
RU,DE,2001.0,162,78,84
BE,IN,2014.0,32,41,-9
NO,NL,2020.0,36,38,-2
LK,NZ,2020.0,10,3,7
nan,IN,2020.0,121,113,8
SE,DK,2019.0,154,141,13
NZ,PK,2019.0,17,9,8
CH,CO,2009.0,7,7,0
AT,JP,2017.0,20,12,8
NZ,NP,2021.0,60,37,23
ES,KE,2017.0,3,1,2
UA,HR,2018.0,16,8,8
SK,SE,2018.0,3,2,1
PG,AU,2016.0,7,7,0
TN,MA,2012.0,28,29,-1
RU,FR,2001.0,45,45,0
ES,AT,2021.0,31,31,0
PT,CO,2002.0,1,2,-1
MX,PT,2014.0,21,11,10
DK,PL,2006.0,6,5,1
SI,CH,2017.0,17,1,16
KR,NZ,2017.0,13,6,7
MX,GB,2019.0,74,81,-7
AR,FR,2013.0,84,85,-1
TZ,ZA,2021.0,8,8,0
BY,UA,2018.0,20,18,2
DE,BR,2000.0,48,33,15
FR,CL,2000.0,15,4,11
FR,BI,2012.0,14,25,-11
CH,MD,2021.0,1,1,0
UA,CN,2021.0,27,21,6
IR,QA,2019.0,9,8,1
SA,IN,2022.0,61,73,-12
DE,HR,2013.0,17,26,-9
GB,UA,2020.0,19,12,7
NZ,CN,1999.0,10,11,-1
UA,MY,2019.0,2,13,-11
IL,DE,2012.0,62,48,14
TR,NZ,2018.0,4,1,3
CA,RO,2016.0,22,14,8
GB,NG,2023.0,3,2,1
ES,CU,2000.0,41,39,2
RS,US,2021.0,38,41,-3
US,RU,1999.0,177,301,-124
DE,SE,2002.0,85,90,-5
ZA,CM,2018.0,15,10,5
BE,EC,2010.0,7,2,5
DK,IN,2016.0,22,24,-2
CH,JP,2022.0,44,34,10
US,NO,2015.0,164,161,3
IR,PL,2019.0,16,1,15
US,PA,2008.0,26,24,2
JP,NL,2014.0,33,27,6
CZ,US,2018.0,142,172,-30
JM,GB,2011.0,5,3,2
DK,NZ,2020.0,7,11,-4
CN,BE,1999.0,15,9,6
IL,IN,2018.0,56,105,-49
MX,BE,2010.0,14,7,7
CA,GH,2009.0,2,2,0
AU,CH,2013.0,75,81,-6
AU,ES,2015.0,52,96,-44
MZ,BE,2020.0,6,6,0
CA,TN,2010.0,9,9,0
CZ,CA,2011.0,10,6,4
CZ,RS,2002.0,11,3,8
BE,AU,2014.0,57,36,21
CA,RS,2007.0,10,9,1
IT,AT,2001.0,23,14,9
MZ,RU,2012.0,22,13,9
US,SK,2021.0,17,28,-11
JP,SK,2012.0,9,14,-5
SK,DE,2010.0,32,41,-9
DE,RS,2007.0,20,13,7
BD,AU,2017.0,73,54,19
SE,HU,2020.0,13,12,1
IR,CN,2014.0,51,32,19
JP,TR,2000.0,27,37,-10
IN,BR,2013.0,30,27,3
HU,NL,2021.0,13,9,4
GR,PL,2004.0,3,3,0
NL,CN,2002.0,27,31,-4
TZ,GB,2021.0,20,9,11
PY,ES,2017.0,19,19,0
MD,NL,1997.0,1,1,0
CH,AR,2021.0,10,13,-3
US,NG,2008.0,32,32,0
QA,CA,2015.0,11,18,-7
US,GR,2021.0,106,116,-10
JP,nan,2003.0,76,97,-21
KE,US,2008.0,39,36,3
KZ,GR,2016.0,1,3,-2
CA,SE,2011.0,59,40,19
DE,PK,2010.0,12,18,-6
ID,IL,2014.0,3,1,2
NO,nan,2005.0,15,25,-10
HR,ME,2009.0,2,3,-1
MX,CO,2002.0,46,50,-4
AZ,PL,2000.0,3,2,1
GR,CY,2000.0,6,2,4
AR,DK,2020.0,4,2,2
DE,SE,2005.0,101,100,1
GB,PE,2008.0,5,9,-4
EG,PS,2006.0,2,2,0
nan,MY,2012.0,64,39,25
BR,MY,2008.0,145,59,86
TR,HU,2007.0,1,1,0
BH,EG,2022.0,4,8,-4
DK,TR,2021.0,6,17,-11
HR,CZ,2012.0,6,4,2
KR,MY,2015.0,30,29,1
CN,RS,2021.0,6,3,3
CH,ES,2004.0,40,28,12
IL,PS,2017.0,3,4,-1
NL,SE,2006.0,32,29,3
NO,GB,2002.0,29,29,0
NL,LK,2020.0,3,2,1
SK,DE,2019.0,36,47,-11
CZ,IL,2021.0,4,1,3
FJ,US,2018.0,5,4,1
UA,FR,2013.0,21,19,2
VE,IT,1999.0,6,1,5
PE,GB,2022.0,11,7,4
FR,IR,2013.0,35,16,19
EG,IN,2013.0,10,7,3
DE,KR,2019.0,57,63,-6
SG,RU,2017.0,12,12,0
EG,NG,2022.0,3,3,0
NP,CA,2019.0,14,5,9
MX,GT,2016.0,20,20,0
IR,JP,2018.0,19,23,-4
TW,nan,2014.0,7,5,2
NO,IT,2008.0,26,22,4
CN,FI,2015.0,33,25,8
RU,HU,2017.0,13,21,-8
nan,RO,2016.0,2,1,1
US,MY,2008.0,74,49,25
SG,VN,2019.0,28,9,19
MY,YE,2012.0,8,3,5
QA,AU,2017.0,11,13,-2
CH,nan,2014.0,25,23,2
IT,AO,2022.0,1,1,0
PL,AT,2020.0,29,22,7
GB,CL,2014.0,40,35,5
BR,RU,2010.0,15,6,9
PK,GB,2004.0,32,30,2
JO,PS,2011.0,3,1,2
SK,DE,2017.0,24,46,-22
CM,PT,2015.0,2,1,1
MX,BE,2017.0,12,17,-5
CR,UY,2020.0,2,1,1
MX,VE,2013.0,27,47,-20
PL,RU,2001.0,17,7,10
CA,SG,2021.0,29,39,-10
JP,IR,2014.0,26,17,9
DZ,US,2015.0,43,34,9
SY,EG,2010.0,2,3,-1
MY,BR,2008.0,59,145,-86
ML,BF,2001.0,1,1,0
KR,CA,2002.0,26,18,8
FR,BG,1998.0,7,9,-2
RU,CN,2023.0,5,3,2
CA,ID,2013.0,11,8,3
CO,CU,2004.0,3,4,-1
DK,CH,1999.0,8,14,-6
nan,NZ,2012.0,12,3,9
NP,CN,2009.0,4,11,-7
EE,SE,2014.0,10,7,3
KE,GB,2013.0,31,30,1
TW,SG,2009.0,26,27,-1
GB,KH,2018.0,3,4,-1
SG,TH,2002.0,1,2,-1
PK,CA,2013.0,28,39,-11
AR,MX,2003.0,42,46,-4
IT,ZA,1999.0,4,1,3
DK,CA,2015.0,32,48,-16
CH,AT,1999.0,42,35,7
IL,IT,2009.0,6,15,-9
nan,CN,2021.0,114,96,18
IN,KR,1998.0,18,17,1
BE,BR,2021.0,60,74,-14
PH,IN,2004.0,4,1,3
TH,CA,2008.0,10,14,-4
UZ,JP,2016.0,1,1,0
MX,NI,2015.0,4,3,1
IN,NO,2018.0,81,21,60
JP,UA,2021.0,2,3,-1
CH,PT,2023.0,2,2,0
CM,FR,2018.0,21,33,-12
AZ,DE,2016.0,2,2,0
LB,GB,2013.0,8,6,2
HU,CN,2012.0,6,2,4
DK,MY,2016.0,4,5,-1
XK,AL,2020.0,3,5,-2
CM,DE,2011.0,3,8,-5
VN,FR,2010.0,10,28,-18
KR,PH,2016.0,11,12,-1
IR,ES,2016.0,18,16,2
IT,IR,2017.0,24,41,-17
KE,AT,2019.0,2,1,1
CL,MX,2003.0,40,49,-9
BE,EC,2019.0,7,13,-6
HR,SI,2011.0,16,21,-5
ES,DK,2022.0,26,13,13
VN,RO,2011.0,9,6,3
AF,MX,2011.0,3,6,-3
ZA,TH,2020.0,4,1,3
IR,EG,2020.0,27,16,11
RU,nan,2009.0,69,54,15
IR,KZ,2021.0,6,3,3
QA,AU,2019.0,11,18,-7
AT,IL,2020.0,8,16,-8
IE,IN,2017.0,24,42,-18
CY,GR,2022.0,29,39,-10
PK,KR,2012.0,22,15,7
YE,US,2019.0,4,3,1
SI,DE,2022.0,10,12,-2
LB,NL,2021.0,7,4,3
JP,IL,2015.0,9,9,0
MA,CA,2006.0,9,8,1
BD,FI,2022.0,4,1,3
CU,PY,2005.0,7,3,4
ES,BO,2014.0,18,20,-2
AR,PK,2016.0,8,13,-5
MD,RU,2008.0,6,4,2
IT,NO,2006.0,20,10,10
BG,PT,2005.0,1,1,0
MK,XK,2019.0,4,4,0
RU,SE,2016.0,27,43,-16
EG,AE,2009.0,10,11,-1
nan,KR,2004.0,17,7,10
FR,GF,2015.0,10,13,-3
TR,AT,2013.0,11,8,3
IN,KW,2012.0,4,6,-2
HU,DK,1999.0,1,2,-1
KE,AT,2017.0,2,4,-2
GB,IR,2008.0,66,36,30
IL,nan,2015.0,25,30,-5
SE,CA,2018.0,60,61,-1
IE,IN,2019.0,46,54,-8
FR,CO,2003.0,4,11,-7
IN,ET,2022.0,27,20,7
AU,UG,2022.0,4,4,0
DK,MX,1998.0,2,1,1
US,CD,2009.0,3,2,1
IL,NL,2013.0,12,11,1
CA,IL,1999.0,17,31,-14
RU,ZW,2020.0,30,17,13
HU,GR,2009.0,3,3,0
CA,DK,1999.0,17,18,-1
JP,TH,2006.0,63,26,37
AT,nan,2008.0,13,6,7
RU,HU,2019.0,28,20,8
ZA,GH,2006.0,2,1,1
FR,RO,2001.0,11,20,-9
AR,CA,2013.0,22,23,-1
PH,DE,2005.0,7,4,3
MA,DZ,2012.0,24,11,13
IL,HU,2007.0,6,2,4
RU,AT,2004.0,7,8,-1
FI,GB,2003.0,31,30,1
CA,PK,2011.0,25,21,4
SG,DK,2005.0,4,4,0
FR,NO,1998.0,19,15,4
GR,MK,2016.0,3,5,-2
AE,RU,2022.0,1,3,-2
nan,DE,2000.0,17,18,-1
CH,PK,2021.0,14,18,-4
CH,FR,2023.0,11,15,-4
BR,MX,2003.0,30,27,3
LV,RU,2001.0,11,9,2
ES,TR,2014.0,7,5,2
BA,RS,2011.0,11,18,-7
RU,FI,1997.0,16,5,11
US,ZW,2016.0,10,14,-4
CA,CH,2000.0,44,39,5
AU,MM,2012.0,2,3,-1
SK,PL,2014.0,9,4,5
GB,CY,2008.0,19,7,12
PL,LT,2014.0,4,2,2
AT,JP,2019.0,15,23,-8
CH,PL,2002.0,12,13,-1
LB,CH,2016.0,7,3,4
IE,IT,2007.0,16,19,-3
JO,OM,2013.0,5,2,3
TH,KH,2020.0,2,5,-3
BD,AU,2010.0,21,14,7
CA,CZ,2003.0,8,6,2
nan,DZ,2005.0,2,1,1
IT,CY,2010.0,2,1,1
BE,LB,2018.0,7,8,-1
GB,BG,2022.0,4,7,-3
MX,IT,2012.0,43,31,12
GB,KW,2002.0,5,3,2
nan,IL,2016.0,30,22,8
NZ,SE,2012.0,11,8,3
US,EE,2007.0,14,14,0
AU,ZA,2015.0,62,77,-15
BR,SE,2009.0,10,15,-5
FR,TG,2016.0,11,4,7
DZ,MA,2011.0,8,6,2
PL,CN,2008.0,30,31,-1
IE,IN,2010.0,11,28,-17
IT,EG,2008.0,6,6,0
VN,DE,2013.0,12,6,6
BD,GB,2003.0,27,14,13
IQ,GB,2009.0,4,5,-1
BR,CU,2013.0,18,24,-6
MM,JP,2011.0,2,6,-4
AR,CU,2009.0,17,14,3
FR,JO,2009.0,4,2,2
IN,ID,2014.0,22,17,5
ES,JP,2000.0,11,19,-8
US,RO,1997.0,14,11,3
FI,PL,2022.0,5,5,0
ES,RO,2005.0,4,3,1
VE,CL,2007.0,16,21,-5
MY,SG,2004.0,24,23,1
KW,CA,2009.0,2,9,-7
IN,NL,2000.0,21,12,9
LU,DE,2006.0,8,16,-8
MX,UY,2005.0,6,3,3
IT,CL,2005.0,12,5,7
CN,NP,2019.0,19,19,0
IT,DE,2023.0,11,15,-4
RU,CA,2007.0,21,20,1
BR,UY,2021.0,44,34,10
AT,SK,2008.0,14,6,8
LU,IR,2019.0,2,2,0
NL,VN,2003.0,2,2,0
FI,BG,1998.0,1,1,0
CL,AR,1999.0,13,13,0
GB,NA,2015.0,4,1,3
IT,VN,2002.0,2,1,1
NL,CZ,2021.0,9,15,-6
UA,JP,1998.0,4,4,0
ES,CL,2003.0,94,125,-31
VE,PY,2020.0,2,1,1
CL,BO,2020.0,13,5,8
IL,PS,2019.0,5,3,2
SE,TH,2019.0,11,4,7
CL,JP,2001.0,3,2,1
DK,RS,2010.0,2,1,1
FI,CH,2013.0,20,23,-3
DE,IS,2011.0,5,4,1
IR,PL,2017.0,4,3,1
SI,GB,2019.0,17,13,4
CA,TH,2007.0,8,7,1
TN,IT,2012.0,17,6,11
AU,nan,2006.0,9,8,1
GT,US,2003.0,1,2,-1
SS,GB,2018.0,13,5,8
KR,PR,2011.0,27,36,-9
JP,KE,2000.0,5,3,2
BE,FI,2005.0,6,7,-1
CN,BD,2008.0,40,26,14
PK,SG,2020.0,6,11,-5
KE,ZW,2021.0,1,1,0
IT,IE,2007.0,19,16,3
LB,TR,2018.0,4,2,2
TZ,ES,2016.0,1,1,0
PH,FR,2018.0,7,13,-6
NP,CA,2017.0,6,5,1
PT,DK,2022.0,7,5,2
RU,LU,2020.0,10,2,8
FR,TR,2000.0,3,2,1
KR,UZ,2018.0,3,2,1
KE,BH,1998.0,3,1,2
PY,UY,2018.0,6,6,0
FR,UA,2021.0,10,6,4
BG,MX,2007.0,2,1,1
GB,LB,2007.0,8,2,6
TN,nan,2020.0,4,14,-10
BY,CZ,2000.0,5,4,1
CM,US,2012.0,17,11,6
RU,LV,2006.0,3,12,-9
RU,MN,2019.0,4,3,1
EC,nan,2022.0,4,1,3
ES,HR,2019.0,3,4,-1
CH,PL,2005.0,17,12,5
FI,EE,2005.0,4,1,3
AT,BE,2015.0,15,22,-7
AT,SI,2014.0,13,25,-12
GB,BH,2001.0,4,1,3
FI,IR,2011.0,2,7,-5
DE,BI,2011.0,1,2,-1
MK,GR,2016.0,5,3,2
TH,GB,2016.0,34,81,-47
MY,US,1999.0,13,26,-13
US,AZ,2006.0,1,1,0
AE,CH,2009.0,1,1,0
US,MG,2005.0,4,1,3
MX,DK,2016.0,7,7,0
IQ,KW,2020.0,6,10,-4
SA,OM,2015.0,12,15,-3
KR,CZ,2003.0,3,1,2
VN,JP,2014.0,28,44,-16
SY,EG,2019.0,6,6,0
BD,AE,2020.0,4,4,0
RO,HK,2009.0,21,7,14
UG,NZ,2020.0,3,11,-8
CA,RU,2003.0,15,28,-13
BY,DE,2020.0,8,6,2
MY,BN,2014.0,10,4,6
ID,KR,2008.0,3,1,2
SG,NZ,2006.0,8,3,5
NO,CH,2006.0,7,12,-5
EG,AU,2005.0,1,1,0
MY,SD,2021.0,9,4,5
JP,HU,2004.0,7,7,0
CH,MY,2021.0,4,2,2
DK,TH,2018.0,4,1,3
SE,AU,2015.0,55,58,-3
CA,MA,2002.0,5,4,1
UG,IT,2012.0,3,1,2
AT,NL,2000.0,14,5,9
DK,FI,2011.0,16,16,0
CZ,PL,2005.0,24,22,2
FR,BZ,2004.0,4,8,-4
NL,IE,2003.0,8,6,2
RU,RS,2015.0,11,5,6
TH,ZA,2018.0,2,3,-1
JP,NO,2014.0,16,10,6
MX,EC,2006.0,6,3,3
UG,US,2009.0,26,22,4
KR,FR,2009.0,28,21,7
CZ,RS,2005.0,7,14,-7
TW,ID,2011.0,12,9,3
RU,BE,2009.0,20,12,8
SE,PL,2003.0,13,12,1
FI,EE,2002.0,9,2,7
QA,KR,2022.0,3,3,0
NO,BE,2020.0,17,11,6
PK,MA,2005.0,5,2,3
PK,FR,2002.0,4,4,0
MD,MA,2001.0,5,4,1
US,JM,2019.0,14,12,2
SI,US,2021.0,18,15,3
HK,NL,2021.0,12,18,-6
CU,IT,2006.0,3,3,0
BG,NL,2015.0,4,1,3
EC,CA,2013.0,2,2,0
JP,ZA,2002.0,2,3,-1
VG,US,2015.0,13,12,1
IN,PK,1999.0,16,11,5
CL,GR,2004.0,2,1,1
JP,BR,2007.0,49,36,13
RU,SA,2018.0,7,2,5
DE,SK,2004.0,22,42,-20
US,BI,2011.0,4,2,2
US,RW,2022.0,7,12,-5
AE,HU,2015.0,2,3,-1
CH,TZ,2021.0,6,7,-1
DE,JO,2001.0,5,5,0
LV,US,2022.0,7,5,2
FR,BF,2003.0,7,8,-1
RO,IN,2007.0,14,11,3
TH,DE,2006.0,9,14,-5
MY,KR,2018.0,43,47,-4
IE,DK,2016.0,12,10,2
CA,KW,1999.0,3,2,1
FR,CG,2016.0,16,27,-11
ZW,US,2006.0,13,4,9
PH,IT,2001.0,2,2,0
BE,NZ,2022.0,3,3,0
BW,IN,2013.0,2,1,1
LU,GB,2006.0,5,5,0
CL,AT,2020.0,8,7,1
AU,CR,2009.0,1,1,0
CL,nan,2008.0,5,4,1
BR,BG,2017.0,5,2,3
GR,IN,1999.0,4,4,0
MX,AU,2009.0,6,8,-2
BI,CH,2019.0,1,1,0
CO,SE,2020.0,8,5,3
US,RO,1998.0,16,26,-10
IN,CZ,2002.0,10,12,-2
ID,RU,2022.0,9,9,0
CO,PA,2011.0,4,4,0
BR,KR,2003.0,2,3,-1
CZ,FR,1997.0,10,9,1
SI,UA,2020.0,3,1,2
JP,MX,2011.0,6,7,-1
FI,BR,2016.0,11,8,3
BD,IR,2020.0,3,8,-5
AR,PY,2018.0,22,5,17
FI,NZ,2007.0,2,5,-3
IR,NL,2003.0,3,3,0
SE,RO,2013.0,5,9,-4
CI,US,2014.0,4,6,-2
CZ,SI,2004.0,5,6,-1
BR,TT,2020.0,1,1,0
JP,SG,1999.0,19,9,10
KE,ZA,2014.0,17,31,-14
UY,BR,1997.0,5,2,3
HR,BA,2001.0,4,3,1
ES,RS,2008.0,3,2,1
AT,CN,1997.0,7,6,1
SE,EE,2006.0,14,2,12
MY,ES,2013.0,8,3,5
IN,MX,2002.0,7,8,-1
LY,JP,2004.0,2,1,1
IN,RU,2006.0,7,9,-2
CN,NG,2019.0,30,44,-14
BY,RU,2003.0,21,23,-2
GR,CA,2006.0,7,10,-3
NG,IR,2011.0,5,2,3
TR,NO,2011.0,4,2,2
CA,GR,2012.0,9,14,-5
nan,IR,2021.0,4,3,1
TH,IT,2014.0,6,3,3
CN,KZ,2014.0,9,13,-4
LT,CA,2012.0,1,1,0
AE,MA,2021.0,2,3,-1
IN,AE,2004.0,6,6,0
AR,FI,2006.0,2,2,0
OM,US,2021.0,7,11,-4
SG,FR,2004.0,6,2,4
IR,AU,1997.0,2,5,-3
CL,IL,2020.0,2,5,-3
IR,nan,2021.0,3,4,-1
RS,AT,2020.0,8,8,0
BW,DE,2007.0,2,1,1
FR,HR,2016.0,4,3,1
AG,CO,2021.0,28,40,-12
BG,BR,2020.0,4,1,3
DE,TZ,2020.0,4,2,2
HU,IT,2018.0,11,10,1
NZ,KR,2014.0,9,10,-1
CD,ZW,2018.0,1,1,0
PK,MA,2002.0,7,1,6
AM,US,2004.0,9,8,1
AL,XK,2020.0,5,3,2
CL,CU,2000.0,3,4,-1
FI,CA,1999.0,9,9,0
NG,QA,2018.0,3,1,2
JO,GB,2020.0,22,33,-11
JP,KP,2019.0,2,2,0
IT,KE,2019.0,4,5,-1
SI,ID,2018.0,7,7,0
GR,DK,2013.0,11,3,8
LU,IE,2018.0,3,2,1
IT,IR,2010.0,13,10,3
AT,GB,2000.0,34,24,10
CR,BR,2013.0,9,6,3
ET,US,1999.0,8,7,1
LT,US,2006.0,4,10,-6
NL,US,2023.0,25,28,-3
LU,CA,2007.0,1,2,-1
GM,GB,2011.0,12,7,5
US,YE,2009.0,3,2,1
BE,DK,2006.0,11,9,2
YE,US,2010.0,2,3,-1
IT,PT,2002.0,15,7,8
TW,RU,2003.0,9,12,-3
QA,TN,2014.0,2,7,-5
SG,IN,2004.0,15,39,-24
VE,JP,2015.0,5,1,4
IR,CH,2011.0,17,13,4
CZ,PL,2002.0,11,11,0
DE,DZ,2015.0,4,5,-1
MA,PT,2005.0,2,1,1
IN,TH,2009.0,3,7,-4
JP,HR,2004.0,3,2,1
EG,KW,2007.0,12,12,0
LY,US,2022.0,1,3,-2
EG,SY,2012.0,4,3,1
CO,ID,2008.0,2,1,1
UA,JP,1997.0,3,4,-1
CN,NP,2017.0,7,22,-15
FR,FI,2006.0,17,11,6
UZ,US,2012.0,4,1,3
US,JM,2017.0,11,18,-7
IT,DK,2006.0,19,13,6
BG,PT,2002.0,2,1,1
VN,BE,2018.0,2,14,-12
PH,ZA,2022.0,2,1,1
SD,EG,2009.0,7,2,5
MX,nan,2002.0,7,6,1
IT,CL,2002.0,11,10,1
TR,nan,2008.0,6,6,0
FR,MG,2021.0,12,5,7
UA,MY,2010.0,2,1,1
CA,TN,2019.0,10,20,-10
CN,MA,2015.0,1,2,-1
NP,BD,2011.0,2,5,-3
BD,BE,2018.0,5,6,-1
HN,US,2004.0,2,3,-1
CL,CO,1998.0,12,6,6
AU,TH,2021.0,16,11,5
IN,VN,2018.0,8,4,4
CY,CZ,2020.0,1,1,0
SE,TH,2017.0,9,6,3
ZA,IT,2001.0,4,3,1
DK,AT,2003.0,2,5,-3
AE,KW,2001.0,1,2,-1
KE,DK,2007.0,3,1,2
JM,BB,2012.0,8,4,4
IN,MX,2005.0,5,10,-5
RS,IT,2016.0,8,8,0
BF,CM,2016.0,2,1,1
YE,US,2017.0,4,2,2
CO,NI,2020.0,5,4,1
AU,PT,2017.0,11,17,-6
MA,CZ,2016.0,1,1,0
TN,SA,2010.0,16,5,11
VE,HU,1997.0,1,1,0
PT,UA,2016.0,1,3,-2
NL,BG,2014.0,3,4,-1
SD,SA,2007.0,4,5,-1
CZ,FR,1998.0,11,15,-4
ES,UZ,2012.0,1,1,0
NO,KE,2013.0,4,1,3
NG,BW,2009.0,5,1,4
SG,BE,2012.0,2,2,0
DE,VN,2005.0,4,7,-3
SE,UA,2005.0,1,6,-5
TH,VN,2008.0,7,3,4
IR,VN,2022.0,1,7,-6
CM,GB,2013.0,2,4,-2
TR,LT,2016.0,2,1,1
IS,DK,2009.0,4,3,1
MG,IT,2016.0,2,2,0
CL,RU,2007.0,6,5,1
MY,DE,2007.0,5,8,-3
BD,EG,2011.0,3,5,-2
NO,DE,1999.0,8,17,-9
JP,ZA,2005.0,5,6,-1
CA,BF,2020.0,6,3,3
NP,PK,2016.0,3,3,0
JP,KW,2017.0,2,1,1
KR,BR,2003.0,3,2,1
ET,CA,2008.0,4,1,3
GB,NZ,2023.0,9,11,-2
CA,CY,2022.0,2,1,1
BO,US,2008.0,4,10,-6
CZ,FI,2020.0,9,10,-1
US,JM,2010.0,15,10,5
BA,XK,2015.0,2,2,0
IT,AM,2013.0,22,28,-6
CA,CI,2019.0,7,2,5
BN,MY,2006.0,2,1,1
CZ,CL,2018.0,3,4,-1
IR,AU,1998.0,2,11,-9
US,AO,2006.0,1,1,0
PL,BE,2021.0,17,9,8
nan,PE,2021.0,7,10,-3
GB,RW,2022.0,2,2,0
GB,SI,2001.0,5,3,2
HN,MX,2012.0,14,18,-4
SK,PK,2011.0,1,1,0
FJ,GB,2014.0,1,3,-2
SG,KR,2013.0,33,36,-3
US,MK,2016.0,4,7,-3
TN,GB,2005.0,2,3,-1
TR,KG,2016.0,2,2,0
SN,ML,2006.0,1,1,0
AT,PL,2006.0,9,9,0
GP,FR,2006.0,12,10,2
US,HT,2020.0,2,2,0
SA,PS,2009.0,1,2,-1
HR,AU,2020.0,5,1,4
CL,CR,2005.0,7,6,1
UA,NL,2021.0,3,1,2
ZM,JP,2016.0,4,3,1
BE,BA,2020.0,1,1,0
LK,PK,2020.0,2,1,1
DE,VN,2002.0,1,2,-1
CO,nan,2022.0,3,5,-2
nan,AT,2021.0,8,9,-1
TR,EG,2009.0,5,2,3
JO,EG,2011.0,12,11,1
NO,nan,2002.0,8,10,-2
MX,nan,2005.0,10,8,2
LU,GR,2021.0,5,2,3
ZA,EG,2018.0,5,7,-2
SE,LT,1997.0,1,2,-1
CO,CH,2011.0,4,2,2
MY,QA,2018.0,11,5,6
DK,BO,2017.0,1,1,0
US,UZ,2012.0,1,4,-3
PT,BE,2009.0,9,11,-2
DE,BD,2009.0,4,3,1
FR,CM,2005.0,14,6,8
SE,LK,2016.0,2,2,0
RU,GH,2020.0,2,1,1
DZ,TR,2013.0,2,1,1
GR,TR,2005.0,6,5,1
UA,IN,2022.0,3,2,1
FR,CY,2020.0,8,3,5
BN,GB,2015.0,3,8,-5
MA,MD,2004.0,3,10,-7
UA,VN,2018.0,6,2,4
CA,PH,2011.0,11,4,7
UA,CH,2022.0,5,1,4
KE,IN,2006.0,2,1,1
AZ,ID,2011.0,4,5,-1
JP,LV,2007.0,2,2,0
SK,SI,2017.0,3,1,2
PK,IR,2023.0,1,1,0
US,PG,2018.0,3,1,2
MX,NO,2019.0,4,7,-3
RU,KR,2017.0,13,29,-16
HU,FI,2017.0,7,4,3
CA,MA,2005.0,2,11,-9
IE,AT,2007.0,6,5,1
KE,ID,2013.0,3,1,2
IS,US,2008.0,16,23,-7
EC,DE,2009.0,1,1,0
NO,BG,2022.0,2,3,-1
GB,LV,2013.0,1,2,-1
TW,IE,2013.0,5,3,2
GR,TR,2002.0,4,1,3
ZA,CL,2020.0,3,1,2
NZ,CH,2007.0,6,15,-9
SE,MX,2002.0,2,3,-1
IN,CY,2020.0,4,2,2
CH,ZA,2012.0,20,16,4
FI,SI,2013.0,2,2,0
NZ,TH,2005.0,4,1,3
IN,HU,2011.0,8,7,1
DK,AR,2006.0,3,1,2
SE,LT,1998.0,3,5,-2
PL,NG,2022.0,1,4,-3
CA,KZ,2017.0,2,3,-1
NG,IT,1999.0,1,2,-1
NI,AR,2021.0,3,1,2
JO,AE,2005.0,5,2,3
RU,SG,2012.0,3,3,0
QA,AU,2010.0,7,17,-10
QA,JO,2021.0,5,15,-10
EC,GR,2010.0,3,1,2
PS,IL,2011.0,1,5,-4
BM,GB,2005.0,1,1,0
AU,UA,2013.0,1,2,-1
QA,SA,2008.0,2,3,-1
DK,BR,2007.0,4,3,1
BE,EC,2017.0,5,3,2
ES,MA,2005.0,5,11,-6
MM,MY,2018.0,4,12,-8
NI,ES,1998.0,1,1,0
NI,SE,2011.0,3,3,0
PY,ES,2010.0,6,2,4
AF,US,2008.0,1,3,-2
IT,PE,2007.0,2,2,0
KH,JP,2008.0,6,1,5
AU,CL,2001.0,1,1,0
ET,NL,2022.0,4,7,-3
ES,SV,2015.0,10,4,6
GR,ID,2014.0,3,1,2
SI,ES,2006.0,5,3,2
ES,HN,1999.0,2,2,0
LK,DE,2008.0,1,1,0
BA,SI,2021.0,3,3,0
VE,GB,2001.0,5,3,2
NO,BR,2023.0,1,4,-3
BE,BJ,2016.0,3,1,2
CM,CA,2011.0,3,2,1
CO,IL,2011.0,2,2,0
JP,ET,2007.0,2,1,1
ES,SG,2009.0,2,3,-1
FI,CL,2017.0,3,6,-3
NL,NO,2000.0,10,13,-3
NO,MY,2020.0,4,3,1
PS,DE,2022.0,1,1,0
DZ,IT,2004.0,3,7,-4
TW,ZA,2018.0,1,7,-6
nan,BF,2017.0,1,1,0
SY,IQ,2017.0,1,2,-1
FI,AT,2020.0,12,9,3
ID,BE,2003.0,1,1,0
BR,MA,2000.0,1,1,0
MX,PE,2000.0,9,8,1
OM,QA,2012.0,4,2,2
nan,CU,2012.0,2,6,-4
UA,MY,2017.0,6,4,2
PK,SE,2015.0,9,20,-11
NG,KR,2020.0,8,6,2
BW,AU,2018.0,3,4,-1
KE,IT,2015.0,4,1,3
GE,AU,2014.0,2,3,-1
PF,NC,2009.0,1,1,0
MY,KW,2021.0,5,3,2
RE,BE,2009.0,1,1,0
CN,JO,2018.0,7,4,3
MA,IT,1999.0,2,7,-5
RU,TN,2016.0,4,1,3
MA,BE,1998.0,1,5,-4
JO,ES,2009.0,2,1,1
SE,IL,2013.0,6,4,2
MY,NL,2022.0,11,3,8
nan,IE,2018.0,4,3,1
AU,CM,2021.0,1,2,-1
JP,UG,2016.0,2,2,0
GM,BE,2003.0,1,1,0
AT,AE,2022.0,1,2,-1
MQ,SN,2019.0,1,1,0
BE,LT,2013.0,2,1,1
AU,ZW,2014.0,1,1,0
AZ,IR,2018.0,7,4,3
PT,HU,2014.0,5,2,3
IQ,NG,2019.0,7,9,-2
UA,MX,2017.0,3,2,1
TN,GB,2002.0,1,3,-2
LK,ID,2008.0,3,1,2
LU,NL,2022.0,9,2,7
XK,CH,2012.0,1,1,0
EG,AU,2002.0,2,1,1
ET,CZ,2020.0,6,1,5
EG,HU,2003.0,3,3,0
MY,SA,2005.0,1,2,-1
TH,FR,2015.0,13,16,-3
US,GT,2008.0,3,5,-2
TW,BR,2001.0,2,1,1
VN,MK,2018.0,1,2,-1
SI,NL,2000.0,5,1,4
IE,RS,2012.0,1,1,0
HR,SE,2005.0,2,2,0
AE,SE,2022.0,1,6,-5
CZ,HK,2018.0,1,1,0
BD,ES,2020.0,15,14,1
DO,ES,2009.0,3,1,2
NG,PK,2011.0,7,3,4
AU,SE,2023.0,2,4,-2
HU,FI,2019.0,3,3,0
AT,TH,2019.0,4,4,0
CZ,BY,1998.0,6,2,4
MX,UA,2008.0,1,3,-2
GE,RU,2011.0,4,4,0
IE,ZA,2012.0,7,10,-3
BE,CZ,1997.0,4,5,-1
LB,QA,2015.0,2,2,0
ML,FR,2011.0,10,9,1
PL,NL,1997.0,2,7,-5
IE,ID,2014.0,2,1,1
GB,EG,2000.0,11,5,6
NG,ET,2015.0,3,5,-2
AU,PH,1998.0,4,1,3
FR,PE,1998.0,3,1,2
KR,TR,2006.0,6,2,4
LA,JP,2017.0,1,2,-1
KR,AT,2022.0,2,7,-5
SI,RS,2000.0,1,2,-1
IL,PK,2022.0,1,1,0
CH,AM,2012.0,3,1,2
AT,CN,1998.0,4,8,-4
GT,CO,2021.0,3,4,-1
BR,SD,2003.0,2,2,0
CL,IE,2014.0,2,1,1
AO,US,2018.0,2,2,0
BE,CW,2004.0,2,1,1
VN,RU,2013.0,4,5,-1
DE,XK,2021.0,1,2,-1
BE,SI,1998.0,3,2,1
TR,SG,1999.0,1,1,0
TW,PK,2009.0,1,2,-1
BW,GB,2004.0,2,2,0
BA,NO,2006.0,1,1,0
NL,LT,2001.0,1,1,0
RO,ES,2001.0,3,1,2
BF,CI,2020.0,5,9,-4
PL,PK,2016.0,7,9,-2
RU,ES,2000.0,4,9,-5
SI,CH,2010.0,6,7,-1
RS,AU,2021.0,4,11,-7
US,XK,2015.0,2,4,-2
ET,SG,2015.0,2,1,1
GE,AT,2014.0,1,1,0
US,NI,2014.0,4,7,-3
MN,JP,2016.0,3,15,-12
SV,MX,2022.0,1,2,-1
ID,AM,2020.0,4,2,2
SA,PT,2020.0,2,4,-2
LV,FR,2014.0,1,1,0
nan,SK,2009.0,5,3,2
GE,GB,1998.0,3,3,0
DE,UY,2014.0,3,3,0
NZ,PK,2017.0,10,5,5
SG,AT,2012.0,3,4,-1
FR,CM,2002.0,8,7,1
SK,NL,2005.0,3,5,-2
AT,LB,2012.0,1,1,0
SD,TR,2021.0,1,1,0
CN,KE,2015.0,10,10,0
ES,IN,2001.0,3,4,-1
CA,KZ,2019.0,5,3,2
DE,PA,2022.0,1,6,-5
RO,MX,2008.0,1,1,0
SK,FR,2014.0,7,8,-1
NP,IN,1999.0,4,4,0
KZ,AE,2022.0,1,1,0
SA,AT,2014.0,4,1,3
SG,TH,2005.0,2,1,1
GR,CZ,2009.0,3,7,-4
BE,RS,2011.0,6,3,3
EG,NL,2011.0,1,9,-8
CA,JO,2018.0,15,14,1
EE,IT,2020.0,5,5,0
JP,LU,2016.0,2,5,-3
TR,TN,2021.0,2,1,1
TH,NG,2023.0,1,1,0
PL,FI,2022.0,5,5,0
NO,CL,2018.0,1,6,-5
BH,KW,2021.0,3,3,0
SY,EG,2017.0,3,5,-2
PS,US,2007.0,3,6,-3
QA,ET,2021.0,2,1,1
NO,LV,2018.0,1,1,0
UA,AT,2018.0,4,8,-4
GE,CA,2018.0,1,6,-5
MX,SA,2022.0,2,2,0
NG,BR,2012.0,2,4,-2
US,HN,2009.0,3,2,1
NI,ES,1997.0,1,2,-1
MA,GN,2020.0,1,1,0
NO,IS,2016.0,7,3,4
BR,RE,2005.0,1,1,0
SE,TH,2010.0,4,5,-1
SI,MK,2010.0,1,1,0
KZ,TR,2004.0,5,13,-8
NZ,AE,1998.0,2,1,1
NP,CA,2010.0,1,1,0
ET,NO,2021.0,7,8,-1
BO,DK,2017.0,1,1,0
KR,NZ,2010.0,3,4,-1
CR,CU,2009.0,6,7,-1
DE,LK,2021.0,1,3,-2
AT,MX,2006.0,2,3,-1
LU,NO,2008.0,1,1,0
JP,CO,2013.0,7,9,-2
HU,CZ,2013.0,6,2,4
MX,NO,2017.0,3,4,-1
SK,SI,2010.0,2,1,1
RW,CD,2018.0,1,1,0
ZW,SE,2017.0,1,1,0
MX,AF,1997.0,1,1,0
NL,HU,2001.0,5,6,-1
KR,CO,2013.0,4,8,-4
DO,VE,2006.0,1,1,0
RU,NI,2021.0,2,3,-1
VN,TH,2008.0,3,7,-4
IN,JO,2013.0,2,1,1
ZM,NO,2014.0,1,2,-1
LK,SG,2020.0,3,4,-1
EE,GR,2021.0,1,1,0
CL,CR,2002.0,2,4,-2
DE,LT,2001.0,3,1,2
BE,FI,2002.0,6,4,2
CL,ZM,2018.0,1,1,0
OM,ID,2021.0,1,2,-1
PT,CO,2005.0,2,3,-1
FR,CD,2012.0,1,2,-1
UG,FR,2011.0,3,2,1
IN,RS,2018.0,3,1,2
CY,PK,2019.0,2,1,1
AT,LU,2013.0,1,2,-1
SA,TN,1998.0,1,1,0
CZ,SG,2020.0,4,3,1
SY,KW,2019.0,3,2,1
PT,JP,2021.0,4,1,3
LV,ES,2013.0,1,2,-1
MK,RU,2020.0,1,1,0
TZ,SE,2004.0,1,1,0
BG,PL,2014.0,6,4,2
ES,KE,2019.0,2,1,1
ZW,BW,2015.0,2,3,-1
SG,DK,2002.0,6,1,5
SK,BG,2008.0,1,3,-2
TR,CY,1998.0,3,1,2
ES,EE,2008.0,1,2,-1
MY,BA,2012.0,2,1,1
ES,JO,2020.0,4,2,2
NL,UA,2008.0,3,4,-1
CO,PT,2013.0,7,9,-2
CL,CO,1997.0,3,1,2
BO,BE,2008.0,1,2,-1
CA,UA,2015.0,1,8,-7
EE,GB,2000.0,2,1,1
IT,KE,2017.0,4,3,1
ES,MA,2002.0,2,5,-3
IN,CO,2011.0,2,3,-1
CU,UY,2015.0,4,5,-1
BJ,BR,2008.0,2,1,1
AT,GE,2014.0,1,1,0
US,MS,2017.0,2,1,1
TH,SE,2023.0,2,2,0
AZ,TR,2001.0,2,1,1
UA,MX,2010.0,3,3,0
TW,VN,2009.0,2,2,0
BE,CO,2019.0,9,9,0
SG,RU,2010.0,1,4,-3
CA,BD,2001.0,3,4,-1
ZA,FI,2016.0,1,4,-3
RO,IT,2023.0,1,2,-1
OM,BH,2008.0,1,1,0
BE,CG,2007.0,3,1,2
NE,IT,2018.0,1,2,-1
KE,CH,2000.0,4,1,3
RU,LT,2015.0,2,4,-2
KR,EG,2015.0,6,9,-3
CL,SE,2004.0,4,6,-2
TZ,RW,2022.0,2,1,1
AE,OM,2006.0,2,1,1
BG,BY,2015.0,1,2,-1
JO,IR,2020.0,1,1,0
SE,KW,2021.0,2,1,1
IL,FI,2017.0,1,5,-4
NP,ES,2015.0,1,1,0
BR,SI,2013.0,2,1,1
CA,GD,2010.0,2,2,0
SK,AU,2007.0,1,1,0
GH,nan,2012.0,2,2,0
NP,SG,2021.0,2,1,1
UY,BR,1998.0,2,8,-6
UA,TR,2011.0,1,1,0
GR,LK,2006.0,2,1,1
SI,MK,2017.0,3,2,1
NO,PH,2016.0,1,1,0
IN,HR,2005.0,1,2,-1
NZ,TW,2021.0,3,5,-2
MT,IT,2011.0,1,5,-4
SE,MT,2021.0,2,2,0
SK,IE,2021.0,1,2,-1
SD,SS,2013.0,1,2,-1
SD,FR,2006.0,1,1,0
BS,IE,2017.0,1,1,0
SE,CO,2016.0,3,3,0
PK,KE,2004.0,3,2,1
FI,GE,2013.0,1,1,0
GB,PR,2003.0,1,2,-1
CL,HN,2020.0,1,3,-2
EG,ES,2006.0,1,3,-2
SI,SK,2020.0,3,6,-3
CA,CI,2010.0,3,1,2
SE,NG,2007.0,2,2,0
IL,NG,2021.0,2,1,1
LU,AT,2021.0,2,2,0
GB,NP,1998.0,1,2,-1
KW,PK,2004.0,1,2,-1
ZA,PK,2011.0,2,1,1
IT,KE,2010.0,3,6,-3
GN,CI,2021.0,1,2,-1
FR,EE,1999.0,3,2,1
CN,VE,2021.0,1,1,0
IL,CU,2016.0,1,1,0
MK,CZ,2018.0,1,2,-1
HK,MY,2014.0,1,3,-2
IL,KR,2022.0,3,3,0
DK,DE,2002.0,60,57,3
CR,nan,2009.0,2,2,0
NL,BR,2007.0,24,33,-9
ES,MX,2003.0,294,293,1
FR,US,2022.0,713,629,84
BR,GB,2007.0,111,121,-10
GB,CH,2018.0,342,378,-36
GB,ZA,2021.0,130,149,-19
IL,NO,2020.0,6,6,0
ES,EC,2022.0,79,98,-19
MX,ES,1999.0,175,165,10
DE,PK,2017.0,38,32,6
IE,ES,2005.0,7,16,-9
UA,ES,2009.0,2,1,1
CA,FR,1999.0,209,232,-23
BE,DE,2021.0,112,115,-3
GB,IT,2012.0,387,502,-115
IE,AU,2009.0,71,82,-11
IT,MX,2003.0,16,22,-6
IT,IR,2019.0,37,78,-41
CN,JP,2015.0,439,590,-151
CN,MN,2005.0,4,3,1
DE,KR,2017.0,52,65,-13
MZ,UZ,2021.0,1,1,0
PK,BJ,2020.0,1,2,-1
SE,DK,2017.0,128,142,-14
PK,ID,2020.0,54,47,7
DK,BE,2017.0,47,51,-4
KZ,RU,2008.0,18,9,9
DE,GR,2008.0,46,46,0
DE,FR,2022.0,260,247,13
DE,SA,2014.0,39,13,26
PE,JP,2018.0,2,2,0
FR,KH,2022.0,5,1,4
AR,PT,2005.0,7,4,3
NO,AU,2004.0,5,11,-6
CH,LK,2014.0,2,2,0
MX,GB,2010.0,43,64,-21
BR,PK,2012.0,8,6,2
CW,BE,2015.0,4,1,3
TR,CH,2022.0,23,8,15
US,QA,2006.0,11,8,3
SY,IQ,2019.0,1,9,-8
IN,AT,2016.0,11,12,-1
TW,PH,2018.0,6,7,-1
AU,US,2023.0,80,109,-29
GB,UG,2012.0,13,13,0
FI,FR,2014.0,30,24,6
KR,IT,2015.0,14,6,8
MX,HN,2013.0,17,23,-6
JP,HK,2004.0,5,8,-3
AR,PT,2002.0,5,6,-1
HU,CA,2009.0,15,11,4
IL,JP,2003.0,13,13,0
YE,EG,2021.0,7,11,-4
DK,DE,2005.0,63,75,-12
US,RS,2022.0,30,22,8
SG,VN,2010.0,9,6,3
FR,RU,1999.0,38,50,-12
BE,CH,2011.0,77,75,2
CA,PE,2011.0,6,5,1
IQ,NG,2017.0,6,2,4
IR,CZ,2015.0,5,3,2
RU,KR,2019.0,25,29,-4
BD,ZM,2015.0,2,1,1
SG,CZ,2021.0,4,2,2
NL,CN,2005.0,58,49,9
CO,CA,2004.0,9,6,3
RU,HU,2010.0,9,10,-1
FR,SK,1999.0,5,3,2
RS,SK,2020.0,8,10,-2
AE,QA,2021.0,10,13,-3
nan,AR,1998.0,8,10,-2
BR,GR,2016.0,3,4,-1
FR,BG,1997.0,6,10,-4
AU,HR,2020.0,1,5,-4
IS,NO,2022.0,5,4,1
IE,ES,2002.0,3,9,-6
IN,BE,2003.0,7,4,3
MK,AU,2006.0,22,19,3
CY,GB,2012.0,24,37,-13
LU,IR,2017.0,1,2,-1
SE,UG,2007.0,3,3,0
UY,CU,2015.0,5,4,1
BY,US,2018.0,11,10,1
GB,KW,2005.0,9,4,5
TW,FR,1999.0,6,10,-4
CH,AU,1999.0,32,20,12
LB,CA,2004.0,6,3,3
nan,IT,2008.0,67,103,-36
DE,JP,2023.0,7,8,-1
JM,US,1999.0,6,9,-3
FR,NO,1997.0,14,14,0
KR,NZ,2019.0,11,7,4
HU,AU,2014.0,9,6,3
nan,ID,2012.0,10,5,5
HR,MK,2016.0,1,2,-1
MZ,BR,2020.0,16,15,1
CO,JP,2022.0,5,11,-6
DE,TN,2011.0,5,5,0
PL,IN,2011.0,7,5,2
SK,NL,2002.0,6,5,1
SG,ZA,2015.0,2,3,-1
CH,TW,2018.0,12,5,7
ES,HR,2010.0,4,2,2
BR,BG,2019.0,4,5,-1
EG,DZ,2016.0,8,7,1
DE,MY,2006.0,3,2,1
NG,DE,2009.0,5,7,-2
RO,CH,2004.0,4,2,2
BG,GB,2009.0,8,10,-2
EG,AT,2022.0,2,4,-2
SE,MZ,2005.0,1,1,0
FI,BE,2013.0,9,5,4
DK,HU,2012.0,3,3,0
CH,SG,2006.0,6,5,1
CN,VN,1999.0,9,3,6
BE,ZA,2022.0,9,14,-5
PL,NO,2000.0,4,5,-1
AU,MK,2000.0,6,2,4
QA,DK,2020.0,3,1,2
GB,MM,2018.0,1,3,-2
nan,AR,1997.0,7,4,3
PH,nan,2015.0,1,2,-1
BJ,NG,2020.0,6,5,1
UZ,DE,2018.0,4,2,2
FR,PY,2012.0,1,2,-1
ZA,GR,2016.0,3,7,-4
AU,PT,2019.0,9,17,-8
BR,CZ,2020.0,9,5,4
MY,ID,2004.0,4,6,-2
TZ,FR,2013.0,2,1,1
ES,AE,2013.0,3,1,2
BE,IL,2011.0,5,2,3
KR,UA,2007.0,3,1,2
BD,JP,2000.0,9,14,-5
CA,CI,2017.0,5,3,2
IT,HU,2001.0,6,3,3
TR,FI,2003.0,1,3,-2
US,SY,2006.0,5,3,2
SY,TN,2014.0,3,1,2
LU,CN,2000.0,1,2,-1
JO,AE,2002.0,4,3,1
GB,PS,2013.0,2,3,-1
HU,SK,2004.0,5,1,4
BR,TW,2016.0,2,3,-1
BE,CO,2010.0,4,4,0
ET,ZA,2004.0,1,1,0
AR,CN,2014.0,8,5,3
ID,MY,2001.0,1,1,0
HU,IN,2007.0,3,6,-3
SI,IT,2007.0,5,10,-5
GT,ES,2009.0,4,4,0
LT,LV,2016.0,1,2,-1
AE,IT,2014.0,2,4,-2
CY,PK,2017.0,1,3,-2
ES,SN,2013.0,2,1,1
FI,KR,2021.0,3,9,-6
IN,UG,2014.0,1,1,0
RU,DK,2009.0,3,4,-1
TW,IN,1999.0,2,13,-11
QA,NL,2009.0,3,2,1
IL,FI,2019.0,2,2,0
LT,PK,2006.0,2,1,1
ES,BG,2018.0,3,3,0
EC,US,1999.0,3,2,1
DK,RS,2019.0,2,3,-1
MX,JP,2022.0,4,6,-2
RU,KR,2010.0,5,13,-8
NO,TZ,2003.0,2,2,0
TW,TR,2013.0,2,7,-5
PT,TR,2008.0,1,3,-2
ID,AU,2006.0,5,21,-16
MX,TN,2011.0,1,4,-3
IL,EG,2008.0,2,1,1
VE,FR,2021.0,1,2,-1
ES,KZ,2019.0,1,1,0
BD,nan,2020.0,6,3,3
MC,US,2020.0,2,1,1
JP,BY,2001.0,3,3,0
GR,BG,2009.0,3,4,-1
MY,SA,2002.0,1,1,0
NL,VE,2007.0,2,1,1
PH,IL,2014.0,2,1,1
KZ,IE,2019.0,1,2,-1
KE,MY,2009.0,1,1,0
CA,TW,2006.0,31,25,6
US,ZA,2008.0,282,214,68
MM,CN,2011.0,5,4,1
CA,AT,2007.0,14,20,-6
MX,BE,2019.0,9,20,-11
NZ,BR,2012.0,9,5,4
DK,BE,2010.0,10,11,-1
LK,SE,2016.0,2,2,0
SK,BE,2012.0,4,5,-1
VN,KR,2003.0,4,2,2
CN,LV,2014.0,2,2,0
PK,FR,2005.0,1,3,-2
GR,AT,2015.0,10,7,3
FR,TZ,2005.0,1,1,0
NL,PL,1998.0,7,7,0
FR,UG,2016.0,7,8,-1
TR,IT,2006.0,10,13,-3
PK,IQ,2011.0,6,1,5
NL,CA,2003.0,54,33,21
RU,GR,2011.0,3,2,1
CO,,2022.0,6282,0,6282
,CN,2012.0,49597,0,49597
,JP,2001.0,18048,0,18048
,IN,1999.0,6790,0,6790
SE,,2017.0,2682,0,2682
AT,,2017.0,1762,0,1762
,PE,1999.0,216,0,216
DK,,2023.0,8659,0,8659
US,,2012.0,46130,0,46130
,ES,2012.0,14186,0,14186
,AT,1997.0,1712,0,1712
TN,,2024.0,6796,0,6796
,NO,2006.0,1715,0,1715
,CH,2010.0,4094,0,4094
,FR,2000.0,11995,0,11995
,CU,2006.0,502,0,502
,KR,2013.0,5768,0,5768
,CZ,2006.0,1947,0,1947
AT,,2019.0,2357,0,2357
,EG,2007.0,2500,0,2500
,AT,1998.0,1690,0,1690
AT,,2010.0,1085,0,1085
,NI,2004.0,20,0,20
AU,,2009.0,2345,0,2345
SE,,2010.0,1802,0,1802
CZ,,2022.0,4181,0,4181
,HU,2001.0,1210,0,1210
,NZ,2014.0,1144,0,1144
,FI,1999.0,1717,0,1717
,MX,1996.0,2524,0,2524
,MX,2004.0,3574,0,3574
,IR,2000.0,1433,0,1433
AR,,2025.0,548,0,548
PH,,2021.0,826,0,826
,EC,1994.0,44,0,44
RU,,2000.0,1208,0,1208
,JO,2007.0,367,0,367
CH,,2006.0,1280,0,1280
HR,CU,2018.0,3,0,3
PK,,2008.0,111,0,111
FI,,2016.0,1471,0,1471
SN,MG,2018.0,1,0,1
GP,,2024.0,112,0,112
LK,,2018.0,299,0,299
SY,,2024.0,572,0,572
,BY,1996.0,356,0,356
nan,,2019.0,812,0,812
RW,,2023.0,286,0,286
HU,,2003.0,352,0,352
,SE,2014.0,3005,0,3005
MY,,2016.0,1600,0,1600
,CH,2017.0,3669,0,3669
RO,,2011.0,372,0,372
,BJ,1994.0,31,0,31
,MQ,1999.0,9,0,9
nan,,2017.0,675,0,675
EE,,2013.0,187,0,187
,AR,2016.0,2092,0,2092
TH,,2020.0,2532,0,2532
BY,,2018.0,313,0,313
,CH,2019.0,2184,0,2184
,YE,2012.0,70,0,70
ES,SK,2001.0,1,0,1
AL,,2015.0,68,0,68
SK,,2020.0,996,0,996
,IS,2001.0,106,0,106
NL,MA,2022.0,2,0,2
IR,,2008.0,327,0,327
SC,GB,2004.0,1,0,1
RW,RS,2015.0,1,0,1
MT,,2025.0,30,0,30
BG,,2012.0,342,0,342
CM,,2023.0,1856,0,1856
UA,,2006.0,497,0,497
nan,,2010.0,438,0,438
ER,,2020.0,6,0,6
VN,,2008.0,32,0,32
,DZ,2016.0,1248,0,1248
DO,,2017.0,13,0,13
,AE,2017.0,520,0,520
,UZ,2001.0,109,0,109
GA,,2016.0,21,0,21
,IQ,2008.0,237,0,237
BS,,2024.0,17,0,17
,BY,2004.0,392,0,392
,MN,2006.0,51,0,51
,AG,2019.0,57,0,57
,AE,2019.0,372,0,372
,OM,2015.0,159,0,159
TR,ZA,2007.0,1,0,1
GR,,1998.0,170,0,170
SI,,1998.0,16,0,16
LV,,2001.0,23,0,23
PG,,2021.0,46,0,46
TR,CL,2018.0,3,0,3
RS,,2006.0,140,0,140
,NL,2020.0,409,0,409
,AE,2010.0,301,0,301
PF,,2019.0,19,0,19
,AG,2017.0,55,0,55
,XK,2013.0,89,0,89
YE,IR,2015.0,1,0,1
KG,,2022.0,80,0,80
CM,ML,2018.0,2,0,2
PT,IQ,2020.0,3,0,3
,ZM,2005.0,45,0,45
NL,GN,2012.0,1,0,1
TR,HR,2016.0,3,0,3
TJ,,2016.0,13,0,13
MT,FR,2004.0,2,0,2
,HN,2016.0,49,0,49
,PA,2018.0,77,0,77
ZM,,2018.0,55,0,55
,FJ,2018.0,39,0,39
,NE,2007.0,17,0,17
,GE,2018.0,196,0,196
PK,SI,2012.0,1,0,1
,RE,2003.0,28,0,28
IN,SD,2001.0,1,0,1
,ET,2007.0,218,0,218
,JM,2018.0,24,0,24
,CG,2018.0,41,0,41
SE,,2019.0,3549,0,3549
KE,BR,2020.0,2,0,2
,BD,1997.0,138,0,138
AF,,2023.0,96,0,96
,BD,1998.0,163,0,163
LY,IR,2017.0,2,0,2
KY,,2020.0,7,0,7
,MT,2007.0,37,0,37
VE,VG,2009.0,1,0,1
,PS,2006.0,51,0,51
,MW,2008.0,60,0,60
,BW,2008.0,50,0,50
KZ,,2001.0,7,0,7
BW,,2014.0,33,0,33
NE,,2016.0,31,0,31
IN,NG,2004.0,3,0,3
LV,JP,2008.0,4,0,4
,GM,2011.0,11,0,11
MO,ES,2005.0,1,0,1
SE,GL,2012.0,1,0,1
NZ,TR,2001.0,1,0,1
nan,BF,2010.0,1,0,1
UY,,2013.0,69,0,69
,GP,2004.0,14,0,14
,GT,2007.0,23,0,23
LT,,2000.0,19,0,19
,BI,2003.0,9,0,9
OM,FR,1999.0,1,0,1
DO,,2019.0,26,0,26
DE,HN,2011.0,1,0,1
CN,NA,2011.0,1,0,1
,GW,1995.0,3,0,3
BR,MM,2020.0,1,0,1
IE,ET,2009.0,1,0,1
,SL,1997.0,4,0,4
,ZM,2002.0,45,0,45
BE,BI,2022.0,1,0,1
CO,CM,2012.0,1,0,1
,AF,2007.0,7,0,7
CU,,2001.0,42,0,42
HU,ID,2007.0,1,0,1
BH,,2015.0,28,0,28
,LA,2007.0,11,0,11
,SR,1999.0,2,0,2
IR,ZA,2011.0,1,0,1
MK,,2008.0,15,0,15
FI,BW,2017.0,1,0,1
CO,HR,2019.0,2,0,2
AU,MZ,2009.0,1,0,1
KZ,GB,2023.0,1,0,1
US,LR,2013.0,3,0,3
MX,DZ,2008.0,2,0,2
,GP,1996.0,13,0,13
NZ,KE,2020.0,2,0,2
NE,CH,2022.0,1,0,1
SY,IL,2017.0,1,0,1
CA,MT,2012.0,1,0,1
US,SL,2011.0,2,0,2
KE,AT,2010.0,4,0,4
PK,ZA,1997.0,2,0,2
SE,SJ,2008.0,2,0,2
NA,KE,2021.0,1,0,1
ET,SA,2005.0,1,0,1
EE,TR,2016.0,1,0,1
SZ,,2007.0,4,0,4
AF,CH,2019.0,1,0,1
HT,CA,2016.0,1,0,1
BY,NO,1999.0,1,0,1
KR,CM,2018.0,1,0,1
HR,XK,2015.0,3,0,3
CM,UG,2013.0,1,0,1
TW,ES,2023.0,1,0,1
SA,CN,2006.0,3,0,3
IT,VN,2005.0,1,0,1
CD,GB,2020.0,1,0,1
MK,ID,2017.0,12,0,12
IS,ES,2022.0,2,0,2
CH,TN,2002.0,1,0,1
BN,RU,2010.0,1,0,1
UY,BE,2021.0,1,0,1
KE,LK,2004.0,1,0,1
LY,PK,2020.0,2,0,2
PF,,2017.0,10,0,10
NP,,2006.0,13,0,13
FR,LK,2007.0,1,0,1
IE,UY,2009.0,1,0,1
EG,CN,1997.0,1,0,1
AR,SI,2018.0,1,0,1
AR,HU,2016.0,1,0,1
GR,HR,2022.0,1,0,1
BR,ID,2004.0,2,0,2
SK,FJ,2011.0,1,0,1
GW,,2017.0,4,0,4
HU,GH,2022.0,2,0,2
HU,AE,2002.0,3,0,3
,CF,2010.0,3,0,3
MA,GP,2004.0,1,0,1
US,MS,2010.0,3,0,3
IN,BJ,2022.0,3,0,3
BE,CZ,1998.0,3,0,3
GB,UY,2004.0,1,0,1
TN,NZ,2015.0,1,0,1
IR,SY,2013.0,2,0,2
BB,AT,2015.0,1,0,1
AE,DZ,2012.0,1,0,1
BR,BG,2010.0,4,0,4
FI,NO,2023.0,2,0,2
DK,MX,1997.0,1,0,1
MY,RS,2015.0,1,0,1
SC,NZ,2016.0,1,0,1
TR,MX,2004.0,7,0,7
DO,,2010.0,8,0,8
NO,PL,1998.0,2,0,2
BO,VE,2011.0,1,0,1
,LY,1995.0,23,0,23
,SM,1994.0,1,0,1
MT,ES,1998.0,1,0,1
LS,CH,2016.0,1,0,1
,NA,1998.0,5,0,5
GM,KE,2019.0,1,0,1
TN,BH,2014.0,3,0,3
PS,,2004.0,9,0,9
LV,GR,2010.0,2,0,2
IT,NE,2020.0,1,0,1
DK,BA,2015.0,1,0,1
NG,BE,2022.0,5,0,5
CD,RU,2019.0,1,0,1
US,BH,2023.0,1,0,1
BD,IE,2003.0,1,0,1
FI,SA,2013.0,2,0,2
MA,PT,2002.0,4,0,4
IS,PL,2011.0,1,0,1
US,TM,2018.0,1,0,1
JO,PL,2021.0,3,0,3
IN,SI,2006.0,2,0,2
RS,HU,1999.0,1,0,1
IR,PL,2010.0,7,0,7
TW,DK,2008.0,4,0,4
CM,BF,2008.0,1,0,1
SM,ES,2016.0,1,0,1
BH,SA,2000.0,1,0,1
BE,MD,2023.0,1,0,1
UG,NG,2005.0,1,0,1
SE,BG,1999.0,3,0,3
SE,BH,2008.0,1,0,1
MC,IT,2015.0,1,0,1
BJ,LU,2014.0,3,0,3
PL,SI,2007.0,1,0,1
GH,CH,2004.0,1,0,1
ML,NE,2016.0,3,0,3
IE,AE,2005.0,2,0,2
UG,ZW,2004.0,2,0,2
NZ,PE,2019.0,1,0,1
JM,,2001.0,11,0,11
FR,TZ,2002.0,1,0,1
GB,VG,2015.0,5,0,5
DK,PT,2005.0,2,0,2
JP,DO,2018.0,1,0,1
GF,nan,2014.0,1,0,1
GL,,2016.0,5,0,5
BO,,2003.0,5,0,5
RO,CL,2020.0,1,0,1
MX,NG,2012.0,1,0,1
HU,AE,2005.0,2,0,2
CW,SE,2005.0,1,0,1
BD,CO,2019.0,6,0,6
ML,ZW,2017.0,1,0,1
MT,TN,2019.0,1,0,1
RW,DE,2018.0,1,0,1
CN,ZW,2021.0,4,0,4
ZW,TZ,2021.0,1,0,1
,NI,1996.0,6,0,6
IM,GB,2010.0,2,0,2
CR,NL,1997.0,1,0,1
TJ,FR,2021.0,1,0,1
IN,IR,2001.0,5,0,5
JE,BR,2008.0,1,0,1
PK,GR,2002.0,1,0,1
GH,PK,2019.0,1,0,1
VN,nan,2006.0,1,0,1
PH,AT,2020.0,2,0,2
,CF,2017.0,3,0,3
FR,HT,2018.0,2,0,2
KE,MZ,2018.0,2,0,2
DK,QA,2013.0,1,0,1
DK,CU,2018.0,1,0,1
FR,DJ,2018.0,3,0,3
BJ,RE,2013.0,3,0,3
PF,,2010.0,4,0,4
LA,VN,2004.0,1,0,1
HK,PL,2021.0,1,0,1
PY,FR,2006.0,2,0,2
FR,TD,2015.0,5,0,5
IE,LK,2016.0,2,0,2
SI,SG,2013.0,1,0,1
TW,AZ,2014.0,1,0,1
AL,GR,2006.0,1,0,1
GB,SN,2011.0,3,0,3
IS,,1998.0,4,0,4
JP,SY,2001.0,1,0,1
IN,SK,2022.0,1,0,1
GI,ES,2019.0,2,0,2
TN,MX,2009.0,1,0,1
JP,AT,2023.0,1,0,1
AE,BH,1999.0,2,0,2
CU,PT,2000.0,1,0,1
GR,KW,2015.0,4,0,4
KW,RU,2017.0,1,0,1
VN,KE,2012.0,1,0,1
WS,SA,2020.0,1,0,1
BZ,FR,2020.0,1,0,1
FR,GM,1997.0,2,0,2
NO,EE,2007.0,1,0,1
CO,IE,2022.0,1,0,1
SG,CL,2014.0,2,0,2
TH,BD,1997.0,1,0,1
MX,BD,2011.0,1,0,1
BJ,CD,2021.0,2,0,2
,LI,2004.0,4,0,4
DZ,AR,2018.0,2,0,2
US,MG,2002.0,1,0,1
ES,KE,2010.0,2,0,2
CN,BJ,2013.0,1,0,1
PY,,2003.0,1,0,1
LK,TR,2020.0,1,0,1
GB,XK,2022.0,2,0,2
NG,TW,2010.0,1,0,1
CL,GE,2020.0,1,0,1
GB,MG,2013.0,1,0,1
ES,SL,2014.0,1,0,1
AO,DE,2004.0,2,0,2
,GL,2014.0,4,0,4
,NA,1997.0,5,0,5
KR,SS,2008.0,1,0,1
SY,LK,2017.0,1,0,1
DE,SY,2004.0,2,0,2
CA,SY,2018.0,1,0,1
PA,CN,2017.0,1,0,1
BJ,AT,2019.0,1,0,1
IR,RU,1997.0,1,0,1
RS,MX,2000.0,2,0,2
BZ,,2020.0,3,0,3
PL,VI,2003.0,2,0,2
EG,ZW,2014.0,1,0,1
YE,RU,2021.0,1,0,1
KR,IL,1997.0,1,0,1
AU,NP,1998.0,1,0,1
LB,GP,2021.0,1,0,1
AR,ZA,2006.0,1,0,1
TT,CN,2014.0,1,0,1
JP,KW,2019.0,2,0,2
GE,JO,2005.0,1,0,1
CH,DZ,2006.0,3,0,3
IQ,KZ,2017.0,1,0,1
IL,PS,2010.0,3,0,3
BE,AE,2012.0,1,0,1
MX,NO,2010.0,3,0,3
FR,SY,2003.0,1,0,1
AU,SI,1998.0,1,0,1
BD,ET,2019.0,2,0,2
NG,TN,2005.0,3,0,3
BD,CO,2010.0,1,0,1
TW,CZ,2003.0,1,0,1
CY,QA,2007.0,1,0,1
NE,MR,2000.0,1,0,1
BY,IL,2019.0,1,0,1
AG,CY,2020.0,1,0,1
BR,NI,2012.0,2,0,2
GH,JP,2003.0,2,0,2
NZ,BS,2002.0,1,0,1
SY,AU,2001.0,1,0,1
PH,TN,2014.0,1,0,1
PT,NP,1999.0,1,0,1
KY,MY,2015.0,1,0,1
PL,LY,2022.0,1,0,1
UY,HN,2021.0,1,0,1
SK,ME,2008.0,1,0,1
MD,BJ,2019.0,1,0,1
AT,SS,2018.0,1,0,1
JM,ZA,2022.0,1,0,1
BH,SE,1999.0,1,0,1
PH,LB,2018.0,2,0,2
RU,CY,2003.0,2,0,2
UA,LT,2008.0,1,0,1
PL,BH,2011.0,1,0,1
SE,KE,2002.0,4,0,4
SE,CM,2017.0,1,0,1
SK,PT,2006.0,2,0,2
NO,FJ,2021.0,1,0,1
BE,KR,2001.0,1,0,1
GH,PK,2017.0,1,0,1
AT,MD,2019.0,1,0,1
US,SS,2011.0,2,0,2
HU,VN,2018.0,4,0,4
EG,CI,2018.0,1,0,1
BJ,CA,2014.0,2,0,2
NL,SI,2011.0,3,0,3
DZ,BJ,2016.0,1,0,1
TZ,CF,2014.0,1,0,1
KG,GH,2011.0,1,0,1
ES,ER,2016.0,1,0,1
AU,SD,2014.0,1,0,1
GH,PT,2012.0,1,0,1
CN,SY,2000.0,2,0,2
EG,CZ,2007.0,1,0,1
NI,DO,2017.0,1,0,1
CH,PG,2022.0,1,0,1
GT,GB,2008.0,1,0,1
SE,VN,1999.0,1,0,1
GB,NP,1997.0,2,0,2
PA,,2004.0,6,0,6
LT,BE,2004.0,1,0,1
LB,DE,2022.0,6,0,6
MW,NZ,2015.0,1,0,1
KG,DE,2009.0,1,0,1
DK,BO,2019.0,1,0,1
BS,IE,2019.0,1,0,1
NZ,HU,2007.0,1,0,1
CA,GD,2019.0,1,0,1
FI,CL,2010.0,2,0,2
LK,OM,2006.0,1,0,1
GB,BZ,2017.0,1,0,1
GD,FR,2017.0,1,0,1
ST,CL,2019.0,1,0,1
JP,NA,2015.0,2,0,2
TO,FJ,2011.0,1,0,1
SY,KW,2017.0,1,0,1
SO,CA,2013.0,1,0,1
MK,ID,2019.0,2,0,2
VE,EC,2000.0,2,0,2
MD,CU,2010.0,1,0,1
BR,CY,2022.0,1,0,1
ZA,RW,2012.0,3,0,3
DK,UY,1998.0,1,0,1
KW,TW,2018.0,1,0,1
GB,ML,2011.0,2,0,2
MD,NL,1998.0,1,0,1
IT,VA,2012.0,1,0,1
YE,IT,2021.0,2,0,2
BE,UZ,2012.0,1,0,1
NC,DE,2010.0,2,0,2
CN,VG,2008.0,2,0,2
RE,NC,2023.0,1,0,1
GB,LS,2005.0,1,0,1
NO,MA,2007.0,1,0,1
ET,TT,2016.0,1,0,1
SA,SO,2019.0,1,0,1
CN,SD,2000.0,2,0,2
ET,ID,2009.0,1,0,1
NO,HR,2009.0,1,0,1
ID,BH,2005.0,1,0,1
BB,CH,2013.0,1,0,1
GF,CH,2006.0,1,0,1
PY,DE,2011.0,1,0,1
PT,KE,2015.0,2,0,2
UZ,NO,2007.0,1,0,1
TW,KE,2020.0,1,0,1
CD,RU,2017.0,1,0,1
AM,UA,1997.0,1,0,1
NG,TT,2003.0,1,0,1
BO,CA,2005.0,1,0,1
SS,AE,2013.0,1,0,1
GB,TJ,2010.0,1,0,1
FI,AO,2013.0,1,0,1
IN,IM,1998.0,2,0,2
BH,US,1999.0,1,0,1
IS,BE,2003.0,1,0,1
GR,PH,2013.0,3,0,3
AT,CG,2001.0,1,0,1
ID,CZ,2008.0,3,0,3
NP,PL,2005.0,1,0,1
TR,IN,1997.0,1,0,1
CF,RE,2016.0,1,0,1
PA,PH,2003.0,1,0,1
MK,IR,2015.0,1,0,1
GH,CG,2013.0,1,0,1
JP,NE,2022.0,1,0,1
SI,ZA,2019.0,1,0,1
RO,NO,2009.0,1,0,1
ID,AG,2022.0,1,0,1
CR,BD,2017.0,1,0,1
CO,RO,2008.0,1,0,1
FR,MR,2016.0,2,0,2
MY,CZ,2009.0,3,0,3
LY,ID,2018.0,1,0,1
CL,ZA,2006.0,3,0,3
GB,HN,2002.0,1,0,1
KH,VN,2020.0,3,0,3
PG,UY,2005.0,1,0,1
BD,CR,2016.0,1,0,1
MA,SD,2018.0,1,0,1
HK,VU,2016.0,1,0,1
LK,PT,2008.0,1,0,1
SK,VN,2018.0,1,0,1
RO,GR,2006.0,2,0,2
KE,nan,2004.0,1,0,1
BD,MV,2018.0,2,0,2
CZ,GE,2016.0,1,0,1
NO,NP,2008.0,1,0,1
TW,CO,2005.0,1,0,1
PG,KR,2021.0,1,0,1
ML,ZA,2008.0,1,0,1
ZA,NE,2016.0,2,0,2
PA,SA,2018.0,1,0,1
BA,BE,2000.0,1,0,1
EG,SD,1999.0,1,0,1
AZ,AU,2020.0,2,0,2
TR,EC,2021.0,1,0,1
LT,MZ,2004.0,3,1,2
FI,CL,2019.0,1,3,-2
BT,AU,2019.0,5,1,4
MK,XK,2017.0,3,3,0
UZ,IT,2012.0,1,1,0
SI,MK,2019.0,2,3,-1
BI,CH,2010.0,1,1,0
CH,SI,2022.0,2,5,-3
QA,GB,2003.0,2,1,1
NG,IQ,2013.0,1,2,-1
FJ,IN,2003.0,1,1,0
HU,SI,2021.0,2,1,1
JP,BH,2012.0,1,2,-1
NL,TZ,2001.0,1,1,0
MY,TN,2011.0,2,2,0
SY,GB,2001.0,3,1,2
FR,IS,2015.0,2,2,0
US,GN,2014.0,2,1,1
DE,BY,2016.0,1,5,-4
GE,KR,2011.0,3,1,2
NL,ZM,2021.0,1,1,0
LT,DK,2021.0,2,5,-3
MX,CH,1998.0,1,4,-3
IR,QA,2010.0,1,2,-1
AF,IR,2016.0,1,4,-3
BF,ML,2014.0,2,3,-1
IQ,BD,2019.0,3,10,-7
SY,BE,2022.0,2,1,1
CO,IR,2021.0,5,2,3
AM,UA,1998.0,2,2,0
KR,DK,2003.0,2,2,0
PA,FR,2013.0,1,3,-2
CU,PY,2002.0,2,1,1
TR,IL,1997.0,1,1,0
IQ,BH,2022.0,2,1,1
FI,SG,2006.0,2,2,0
PT,KR,2012.0,2,4,-2
JP,AR,2020.0,1,3,-2
FR,KZ,2020.0,4,5,-1
MN,KR,2012.0,2,4,-2
AU,BD,2003.0,1,4,-3
TH,DK,2013.0,2,3,-1
LV,GB,2009.0,1,2,-1
UG,IL,2021.0,1,1,0
IE,MT,2019.0,2,1,1
BF,JP,2020.0,1,1,0
AU,PK,2003.0,3,5,-2
RO,PT,2008.0,2,3,-1
IE,nan,2020.0,3,4,-1
CN,IE,2001.0,4,4,0
ES,SI,2001.0,1,2,-1
PT,LU,2012.0,1,1,0
IR,AM,2019.0,2,5,-3
CN,EE,2018.0,2,3,-1
SJ,NO,2011.0,3,3,0
IN,UA,2009.0,3,1,2
SN,CH,2012.0,2,5,-3
PK,PL,2023.0,3,1,2
CA,AM,2013.0,1,4,-3
AT,CO,2015.0,2,3,-1
NZ,IL,2009.0,1,3,-2
IR,QA,2017.0,2,1,1
AU,PH,1997.0,5,6,-1
TZ,NO,2004.0,1,2,-1
BE,CD,2007.0,1,1,0
DK,VN,2020.0,2,3,-1
JP,BG,2020.0,5,1,4
EC,RU,2008.0,1,4,-3
AL,US,2013.0,1,6,-5
CM,DZ,2015.0,1,1,0
ZA,DZ,2021.0,1,1,0
KW,TR,2003.0,1,2,-1
GR,BD,2006.0,1,2,-1
MY,AT,2007.0,1,1,0
PY,IT,2019.0,1,2,-1
OM,CA,2015.0,3,10,-7
nan,NP,2012.0,1,1,0
HR,IT,2004.0,1,5,-4
UA,RO,2009.0,1,1,0
TZ,IR,2014.0,1,2,-1
AM,IL,2020.0,1,1,0
NG,CI,2021.0,2,1,1
IL,PH,2002.0,2,1,1
AU,IL,2023.0,1,3,-2
AO,ES,2008.0,2,1,1
CY,IT,1998.0,1,1,0
PK,KW,2022.0,2,5,-3
SE,MX,2005.0,1,2,-1
SK,IR,2015.0,1,1,0
LK,ZA,2014.0,1,2,-1
CN,AE,2023.0,1,2,-1
GD,CA,2010.0,2,2,0
AT,HR,2007.0,2,1,1
MD,CH,2015.0,1,1,0
CZ,PT,2006.0,2,2,0
LB,CU,2005.0,2,2,0
RS,PK,2009.0,1,1,0
NL,PE,2015.0,1,1,0
SN,GP,2011.0,1,1,0
SD,IL,2017.0,1,1,0
AU,KW,2000.0,1,1,0
FR,TH,1999.0,1,1,0
CZ,BY,1997.0,2,4,-2
KZ,TW,2016.0,1,2,-1
ET,IN,2011.0,4,10,-6
PL,PH,2009.0,2,1,1
ID,RO,2009.0,1,3,-2
FI,NP,2013.0,1,2,-1
PE,IN,2014.0,1,3,-2
ID,AE,2016.0,1,2,-1
RW,KE,2011.0,1,1,0
LV,IT,2020.0,1,2,-1
CL,TW,2021.0,1,1,0
DK,RS,2017.0,1,3,-2
HR,GB,2000.0,1,1,0
SE,KE,2005.0,1,3,-2
AT,EG,2001.0,1,2,-1
ES,AO,2011.0,1,4,-3
BF,CA,2009.0,1,1,0
DK,PK,2007.0,1,1,0
HU,HR,2012.0,1,1,0
VE,PT,2003.0,1,1,0
ZA,TW,2004.0,1,1,0
SK,BA,2014.0,1,1,0
FR,GA,2022.0,1,2,-1
NE,SN,2019.0,1,3,-2
AE,SG,2016.0,1,7,-6
BG,CH,2018.0,1,1,0
NP,FR,2015.0,1,2,-1
TT,IN,2006.0,2,2,0
ES,HR,2017.0,2,3,-1
IQ,IT,2011.0,1,2,-1
UY,GR,2006.0,1,1,0
MN,TW,2020.0,1,4,-3
GB,PY,2007.0,1,2,-1
MA,ID,2015.0,1,2,-1
QA,PK,2008.0,1,2,-1
PH,DE,2002.0,1,1,0
AR,IN,2005.0,1,3,-2
NG,ES,2001.0,1,1,0
BD,LB,2020.0,1,1,0
GE,IT,2015.0,1,2,-1
LB,MY,2002.0,1,1,0
RS,FR,1998.0,1,1,0
GB,FJ,2008.0,1,1,0
nan,GT,2019.0,1,1,0
TZ,RU,2020.0,1,1,0
ZW,IN,1997.0,1,1,0
SD,CA,2014.0,1,1,0
NG,CZ,2021.0,2,9,-7
MA,AU,2012.0,1,1,0
QA,NO,2020.0,1,1,0
KH,MY,2018.0,1,2,-1
EC,CY,2021.0,1,1,0
MX,ZA,2012.0,1,2,-1
MX,CH,1997.0,1,4,-3
CH,TN,2005.0,1,3,-2
ZW,NA,2019.0,1,1,0
IT,CY,2017.0,1,2,-1
AE,BD,2019.0,1,3,-2
KR,RS,2018.0,1,1,0
MA,KW,2006.0,1,1,0
DE,TH,2023.0,1,1,0
CY,FR,2013.0,1,2,-1
GB,AM,2013.0,2,3,-1
IT,BA,2014.0,1,1,0
IQ,DK,2018.0,1,3,-2
SE,MZ,2002.0,2,1,1
SV,CO,2014.0,4,1,3
US,CW,2013.0,1,1,0
MA,PA,2009.0,1,1,0
ZA,CG,2022.0,1,1,0
DE,GT,2021.0,1,1,0
VE,RU,2007.0,1,1,0
TR,IN,1998.0,1,1,0
SG,TR,1999.0,1,1,0
RO,RU,2022.0,1,3,-2
SV,PY,2017.0,1,1,0
AR,MY,2009.0,2,1,1
NZ,IT,2022.0,1,9,-8
SN,KE,2020.0,1,1,0
GA,FR,2000.0,1,2,-1
LI,DE,2022.0,1,4,-3
ES,RO,2002.0,1,4,-3
TN,CH,2001.0,1,2,-1
AT,TN,2015.0,1,0,1
HN,,2003.0,3,0,3
CW,US,1999.0,1,0,1
nan,MC,2018.0,1,0,1
IS,NL,2022.0,1,0,1
US,KY,2008.0,1,0,1
DO,GB,2022.0,1,0,1
MD,AT,2013.0,1,0,1
TZ,TR,2004.0,1,0,1
MX,GE,2006.0,1,0,1
NL,ML,2012.0,1,0,1
BH,JP,2016.0,1,0,1
GW,HK,2006.0,1,0,1
KH,GW,1999.0,1,0,1
UA,FI,2003.0,1,0,1
RU,LS,2013.0,1,0,1
BW,BR,2001.0,1,0,1
SN,CD,2017.0,1,0,1
IT,PR,2013.0,1,0,1
MY,SO,2020.0,1,0,1
HK,NO,2016.0,1,0,1
TR,CF,2018.0,1,0,1
CU,SE,2015.0,1,0,1
BJ,US,2013.0,1,0,1
LS,BW,2003.0,1,0,1
CI,BF,2007.0,1,0,1
BA,JP,2000.0,1,0,1
NG,IE,2011.0,2,0,2
GW,SE,2017.0,1,0,1
ZW,SE,2019.0,1,0,1
MU,,2007.0,2,0,2
CL,SG,2004.0,1,0,1
RO,NZ,2002.0,1,0,1
NE,GB,2010.0,1,0,1
UA,IE,2003.0,1,0,1
,SL,1998.0,3,0,3
JO,NL,2001.0,1,0,1
BG,MA,2013.0,1,0,1
RS,FI,2001.0,1,0,1
PH,KE,2004.0,1,0,1
GB,BZ,2019.0,2,0,2
SI,IL,2014.0,2,0,2
CR,DK,2022.0,1,0,1
QA,SY,2021.0,1,0,1
MC,CN,2022.0,1,0,1
ID,DO,2020.0,1,0,1
RO,GH,2012.0,1,0,1
IQ,MA,2015.0,1,0,1
DZ,QA,2014.0,1,0,1
GR,MA,2016.0,1,0,1
NL,KR,2006.0,4,0,4
RS,NZ,2020.0,1,0,1
NL,YE,2023.0,1,0,1
GH,IR,2016.0,1,0,1
TW,HK,2000.0,1,0,1
CD,BW,2008.0,1,0,1
BY,HU,1999.0,1,0,1
CM,MA,2021.0,1,0,1
RO,NZ,2005.0,1,0,1
NL,CU,2008.0,1,0,1
TZ,IQ,2021.0,2,0,2
UG,BI,2014.0,1,0,1
LB,BW,2013.0,1,0,1
CH,JO,2006.0,1,0,1
TN,MQ,2011.0,1,0,1
SN,CA,2009.0,1,0,1
RS,BD,2005.0,1,0,1
DK,ZW,2018.0,1,0,1
PG,TR,2011.0,1,0,1
LB,CZ,2021.0,1,0,1
BG,IL,2006.0,1,0,1
JP,AG,2023.0,1,0,1
SS,,2003.0,1,0,1
NL,MT,2006.0,2,0,2
NO,PL,1997.0,1,0,1
GW,,2019.0,3,0,3
TR,MK,2016.0,1,0,1
,PW,1994.0,1,0,1
ZA,MK,2009.0,1,0,1
SA,SO,2017.0,1,0,1
SY,PT,2018.0,1,0,1
,CF,2019.0,5,0,5
AM,TW,2004.0,1,0,1
ML,,2004.0,2,0,2
PK,EC,2020.0,1,0,1
nan,BF,2019.0,1,0,1
TZ,CD,2014.0,1,0,1
EG,BD,1999.0,1,0,1
ER,GB,2014.0,1,0,1
UY,CO,1997.0,1,0,1
CA,KZ,2010.0,1,0,1
SE,AE,2012.0,1,0,1
ET,OM,2008.0,1,0,1
EG,SN,2021.0,1,0,1
IR,AM,2017.0,1,0,1
,MS,2007.0,1,0,1
MA,FI,2004.0,1,0,1
GW,SE,2010.0,1,0,1
DZ,GP,2008.0,1,0,1
US,TJ,2008.0,1,0,1
CM,GH,2011.0,1,0,1
NL,VG,2004.0,1,0,1
SY,IE,2014.0,1,0,1
RU,MN,2010.0,2,0,2
MS,ZA,2012.0,1,0,1
UZ,GE,2002.0,2,0,2
CR,CN,2022.0,1,0,1
CH,PS,2011.0,1,0,1
JP,MD,2013.0,1,0,1
AT,CY,2004.0,1,0,1
LR,,2004.0,1,0,1
,JE,1994.0,1,0,1
ME,TR,2019.0,1,0,1
BE,ZM,1997.0,1,0,1
BO,PE,2001.0,1,0,1
BH,KR,2023.0,1,0,1
CZ,MN,2017.0,1,0,1
AU,SI,1997.0,1,0,1
NP,FI,2010.0,1,0,1
EC,PY,2011.0,1,0,1
PK,GR,2005.0,1,0,1
FI,ML,2007.0,1,0,1
IN,HR,2002.0,1,0,1
BF,ID,2020.0,1,0,1
AR,SA,2021.0,1,0,1
BT,IN,2012.0,1,0,1
HU,KE,2012.0,1,0,1
,FK,2006.0,1,0,1
IQ,AU,2012.0,2,0,2
US,MQ,2004.0,1,0,1
DK,BJ,2022.0,1,0,1
KW,DK,2017.0,1,0,1
MW,BE,2012.0,1,0,1
IQ,JO,2023.0,1,0,1
PH,FJ,2016.0,1,0,1
IS,PK,2020.0,1,0,1
FI,MK,2022.0,1,0,1
OM,DZ,2018.0,1,0,1
PS,IT,2007.0,1,0,1
NA,AU,2016.0,1,0,1
EE,NO,2006.0,1,0,1
GM,AE,2023.0,1,0,1
MU,NL,2011.0,1,0,1
HU,MD,2018.0,1,0,1
PL,MN,2004.0,1,0,1
GE,LU,2017.0,1,0,1
UG,MY,2022.0,1,0,1
TH,EG,2014.0,1,0,1
KR,AF,2020.0,1,0,1
CV,DE,1999.0,1,0,1
BF,CO,2004.0,1,0,1
EE,TN,2013.0,1,0,1
ES,LB,2011.0,1,0,1
HK,TW,1998.0,1,0,1
DE,CV,1997.0,1,0,1
TW,AT,1997.0,1,0,1
NA,FR,2003.0,1,0,1
TH,nan,2005.0,1,0,1
NG,UA,2014.0,1,0,1
HR,PH,2005.0,1,0,1
LU,CY,2022.0,1,0,1
GB,LS,2002.0,1,0,1
TR,BI,2020.0,1,0,1
TR,MY,1998.0,1,0,1
BR,NP,2014.0,1,0,1
PA,DE,1997.0,1,0,1
SC,US,2001.0,1,0,1
CI,RE,2012.0,1,0,1
BJ,AT,2010.0,1,0,1
TW,CO,2002.0,1,0,1
IL,GT,2018.0,1,0,1
EC,BO,2022.0,1,0,1
SI,KW,2019.0,1,0,1
TR,PT,2009.0,1,0,1
SY,OM,2015.0,1,0,1
LT,TJ,2018.0,1,0,1
MG,JP,2021.0,1,0,1
KE,PE,2022.0,1,0,1
ZW,SE,2010.0,1,0,1
BF,AT,2015.0,1,0,1
SD,IL,2019.0,1,0,1
ML,TG,2022.0,1,0,1
IM,GB,2017.0,1,0,1
GN,DE,2017.0,1,0,1
PA,ZA,1998.0,1,0,1
SY,IQ,2010.0,2,0,2
IN,KP,2021.0,1,0,1
PF,CG,2013.0,1,0,1
MK,SI,2011.0,1,0,1
HK,UZ,2004.0,1,0,1
MM,,2001.0,1,0,1
PA,CL,1999.0,1,0,1
GR,TN,2012.0,1,0,1
ML,CM,2007.0,1,0,1
GP,BR,2018.0,1,0,1
BY,RO,2015.0,1,0,1
SY,KW,2010.0,1,0,1
US,MU,2001.0,1,0,1
BG,KG,2020.0,1,0,1
AU,KN,2017.0,1,0,1
VE,IS,2012.0,1,0,1
DK,BD,2022.0,1,0,1
UG,BE,1999.0,1,0,1
CH,BN,2023.0,1,0,1
ZM,CA,2004.0,1,0,1
NZ,ET,2021.0,1,0,1
HR,PK,2022.0,1,0,1
QA,IQ,2008.0,1,0,1
ID,GH,2009.0,1,0,1
CG,AE,2012.0,1,0,1
RS,AG,2021.0,1,0,1
BN,NZ,2018.0,1,0,1
SI,ZA,2010.0,1,0,1
EC,PA,2006.0,1,0,1
EG,TZ,2001.0,1,0,1
VN,GH,2007.0,1,0,1
BB,CA,2005.0,1,0,1
UG,GB,2023.0,1,0,1
TT,MX,1997.0,1,0,1
BF,CD,2014.0,1,0,1
BE,BO,2003.0,1,0,1
ME,,2006.0,2,0,2
GT,JP,2018.0,1,0,1
IT,OM,2007.0,1,0,1
AX,,2024.0,1,0,1
TH,ET,2004.0,1,0,1
AR,PR,2004.0,1,0,1
IL,MA,2021.0,1,0,1
BT,EE,2020.0,1,0,1
UY,US,2023.0,1,0,1
TH,MM,2000.0,1,0,1
LY,EG,2001.0,1,0,1
BA,ET,2018.0,1,0,1
NZ,TG,2015.0,1,0,1
nan,RS,2020.0,1,0,1
MY,AU,2020.0,106,96,10
FR,ES,2014.0,290,393,-103
MY,KR,2017.0,31,42,-11
UA,MX,2018.0,3,1,2
US,IE,2014.0,506,495,11
DE,CH,1999.0,345,300,45
US,CN,2002.0,3701,3084,617
GB,AU,2016.0,1407,1441,-34
CZ,US,2017.0,160,169,-9
CL,US,2021.0,272,187,85
CH,IT,2003.0,134,119,15
AU,US,2000.0,1103,1073,30
CH,JP,2016.0,87,112,-25
IT,RO,2012.0,16,7,9
FR,AT,2017.0,66,54,12
GB,TR,2021.0,109,127,-18
NL,GB,2020.0,376,396,-20
DE,AU,2015.0,254,257,-3
BE,GB,2009.0,100,114,-14
AU,IN,2015.0,164,194,-30
CA,AU,2001.0,158,162,-4
GB,CH,2019.0,433,339,94
ES,DK,2016.0,75,33,42
US,IS,2007.0,15,12,3
IN,CA,2013.0,191,213,-22
CA,JO,2019.0,14,11,3
US,MY,2013.0,221,127,94
US,BR,2004.0,531,485,46
ES,US,2000.0,422,446,-24
GB,CH,2017.0,362,281,81
US,ZA,2013.0,390,304,86
IT,BR,2018.0,369,298,71
GB,IR,2013.0,89,91,-2
ES,CO,2014.0,538,426,112
BR,MX,2001.0,18,30,-12
FR,CH,1999.0,187,151,36
CO,CL,2015.0,232,241,-9
AU,MX,1998.0,5,1,4
US,KE,2007.0,29,36,-7
AU,GB,2004.0,835,952,-117
CN,DE,2013.0,274,271,3
IN,TR,2012.0,18,14,4
GB,NZ,2000.0,102,113,-11
CO,CU,2014.0,15,31,-16
MX,BO,2015.0,10,6,4
ES,AR,2001.0,92,129,-37
FR,IT,2011.0,260,415,-155
CH,ES,2014.0,67,126,-59
CA,NL,2020.0,114,87,27
BR,nan,2012.0,88,78,10
IN,CH,2007.0,30,22,8
NL,DE,1999.0,113,141,-28
US,CZ,2008.0,141,121,20
IR,GB,2012.0,79,98,-19
VN,AU,2019.0,36,71,-35
IN,NO,2010.0,20,15,5
KR,BD,2012.0,22,11,11
DE,BE,2022.0,79,70,9
NG,US,2019.0,147,170,-23
ES,CR,2015.0,58,47,11
BR,LU,2014.0,7,6,1
FR,GB,2012.0,523,559,-36
SA,IN,2016.0,88,156,-68
AU,DE,2021.0,166,174,-8
QA,CN,2006.0,11,8,3
nan,FR,2011.0,223,170,53
GB,SG,2012.0,132,77,55
HR,RS,2016.0,129,134,-5
RU,DE,2003.0,186,124,62
TW,FI,2014.0,1,2,-1
GB,CY,2013.0,41,17,24
HU,US,2002.0,97,75,22
HU,US,2005.0,105,102,3
CN,IT,2011.0,42,43,-1
IE,GB,1999.0,110,121,-11
SE,ZA,2015.0,16,21,-5
SE,IT,2010.0,62,91,-29
PE,US,2018.0,118,130,-12
ES,EC,2016.0,177,62,115
CN,BD,2013.0,77,84,-7
ES,MX,2001.0,210,239,-29
MX,PT,2004.0,6,14,-8
AU,PT,2018.0,12,18,-6
BE,NL,2012.0,218,279,-61
AR,PE,2011.0,14,13,1
PK,BA,2020.0,1,1,0
IT,nan,2015.0,122,187,-65
ES,PT,2021.0,148,154,-6
US,TH,2013.0,205,126,79
PT,TR,2013.0,5,2,3
FR,DK,2013.0,60,38,22
NL,ES,2012.0,106,84,22
CH,DE,2009.0,651,813,-162
CZ,US,2019.0,153,170,-17
IT,US,2006.0,860,732,128
FJ,US,2010.0,8,5,3
ES,VE,2006.0,67,62,5
GH,CZ,2020.0,5,7,-2
AU,ID,2009.0,29,12,17
CN,CH,2006.0,31,63,-32
nan,GB,2012.0,88,83,5
AE,US,2021.0,75,78,-3
ES,PA,2011.0,13,8,5
FR,US,2016.0,1563,1486,77
AU,CA,2007.0,237,269,-32
TR,GB,2015.0,116,127,-11
CH,FR,2000.0,173,202,-29
MY,KR,2010.0,15,15,0
PT,DE,2022.0,25,25,0
FR,LB,2016.0,97,42,55
MY,BR,2013.0,85,32,53
CA,BE,2013.0,68,60,8
CN,PK,2014.0,67,83,-16
VN,BE,2019.0,10,16,-6
EC,ES,2014.0,23,90,-67
GB,CH,2010.0,317,214,103
MX,BR,2013.0,90,95,-5
SE,IT,2019.0,74,105,-31
JP,NL,2004.0,27,53,-26
CA,NZ,1998.0,20,17,3
JP,PH,2007.0,23,16,7
VN,US,2005.0,22,24,-2
VE,CO,2009.0,43,25,18
CL,SE,2014.0,9,4,5
NL,DK,2016.0,58,46,12
ZA,NL,2009.0,32,31,1
BE,ES,2007.0,27,33,-6
NO,US,1997.0,54,48,6
RS,ME,2005.0,4,1,3
CO,ES,2021.0,467,372,95
CN,RU,2002.0,13,24,-11
GB,UY,2014.0,4,6,-2
US,TR,2011.0,441,366,75
GB,FR,2007.0,437,527,-90
KR,nan,2011.0,23,32,-9
DK,GB,2015.0,112,133,-21
GB,QA,2015.0,41,18,23
NG,US,2017.0,106,123,-17
ES,BE,2022.0,48,64,-16
NZ,JP,2015.0,11,5,6
NL,MA,2016.0,1,1,0
GB,nan,2015.0,100,62,38
DE,FR,2016.0,567,530,37
SK,GB,2000.0,26,9,17
IE,NZ,2020.0,19,15,4
NG,CA,2015.0,5,12,-7
PA,US,2005.0,14,16,-2
AU,IE,2005.0,64,43,21
RS,IT,2022.0,5,4,1
FI,CL,2018.0,2,6,-4
US,FI,2012.0,126,110,16
SE,RO,2008.0,7,3,4
DE,JP,2000.0,131,124,7
SE,US,2001.0,318,255,63
CL,MX,2001.0,27,29,-2
ZA,CM,2017.0,9,11,-2
AR,PY,2019.0,10,13,-3
BR,IT,2001.0,53,58,-5
PK,CH,2015.0,26,11,15
MA,TN,2017.0,41,38,3
NL,US,2000.0,349,322,27
KR,ET,1997.0,31,65,-34
FR,TW,2011.0,25,19,6
AG,TR,2021.0,199,318,-119
AU,KR,2015.0,41,48,-7
CZ,CN,2015.0,22,21,1
BR,ES,2004.0,134,162,-28
NG,US,2010.0,34,30,4
IT,AT,2003.0,17,18,-1
VN,US,2002.0,13,18,-5
AR,PY,2017.0,15,5,10
CN,IL,2012.0,20,20,0
ET,BH,2020.0,42,26,16
SE,DE,2005.0,100,101,-1
US,BD,1998.0,6,18,-12
CN,AR,2013.0,4,3,1
BE,ZA,2016.0,20,17,3
US,VN,2002.0,18,13,5
RU,UA,2012.0,184,169,15
US,IR,2016.0,391,794,-403
GB,NL,2013.0,308,325,-17
DE,IE,2020.0,101,86,15
UA,AT,2017.0,6,6,0
IR,US,1998.0,11,10,1
ID,JP,2015.0,63,215,-152
NL,FR,2013.0,188,167,21
FR,PT,2021.0,49,33,16
DE,KR,2018.0,65,68,-3
BE,CN,1998.0,10,10,0
PE,MX,2016.0,123,103,20
AR,US,2022.0,158,134,24
TR,CH,2016.0,18,15,3
CO,FR,2000.0,8,5,3
US,NG,2013.0,60,69,-9
IL,RU,2021.0,32,39,-7
SK,PL,2004.0,5,1,4
IN,NO,2019.0,36,26,10
JP,HK,2014.0,18,12,6
IL,IN,2019.0,56,127,-71
SA,IT,2021.0,11,11,0
IR,IQ,2017.0,22,8,14
GB,HU,2007.0,38,44,-6
MD,RU,2013.0,8,5,3
ES,PH,2009.0,14,12,2
HU,IT,2017.0,13,13,0
IE,IN,2018.0,24,38,-14
IL,PS,2018.0,8,4,4
ID,US,2009.0,36,61,-25
IT,CH,2021.0,274,237,37
TR,MX,2014.0,2,4,-2
SE,JP,2015.0,31,36,-5
SE,CA,2017.0,49,59,-10
US,BD,1997.0,12,9,3
ES,KZ,2018.0,3,1,2
GB,TW,2019.0,44,83,-39
CM,FR,2017.0,13,28,-15
TR,ES,2011.0,9,7,2
JP,IE,1999.0,24,8,16
GB,MM,2019.0,8,4,4
IT,KZ,2016.0,2,2,0
DK,AT,2001.0,3,3,0
IT,TW,2002.0,4,1,3
NO,AU,2014.0,17,22,-5
US,IL,1999.0,303,356,-53
PE,DE,2021.0,6,9,-3
MA,TN,2010.0,26,15,11
IR,IQ,2019.0,31,15,16
MX,CA,2020.0,54,37,17
VN,AU,2017.0,37,48,-11
BD,AU,2018.0,91,61,30
BE,BI,2016.0,3,2,1
SG,VN,2018.0,19,9,10
DE,ZA,1998.0,18,12,6
CA,SY,2010.0,1,3,-2
ES,CL,2001.0,87,78,9
FI,IT,2009.0,14,15,-1
GB,KE,2015.0,34,28,6
CU,DE,2005.0,6,5,1
IN,FR,2023.0,4,1,3
RO,DE,2007.0,22,36,-14
CH,GB,2004.0,133,164,-31
BR,RU,2018.0,14,11,3
MY,CN,2020.0,156,130,26
ES,FR,2008.0,240,237,3
NL,ID,2016.0,58,30,28
BR,NL,2009.0,44,33,11
NZ,PK,2018.0,6,8,-2
PL,US,2007.0,201,169,32
CZ,RU,2015.0,54,42,12
IQ,US,2014.0,20,18,2
JP,EG,2013.0,80,45,35
VE,US,2015.0,36,41,-5
US,SG,2008.0,253,230,23
IL,GB,2021.0,56,58,-2
UA,HR,2019.0,24,8,16
CU,CA,2010.0,5,1,4
MY,PK,2015.0,98,74,24
DE,HR,2008.0,25,17,8
CA,RO,2022.0,10,10,0
CN,ID,2015.0,105,81,24
GB,TW,2010.0,57,57,0
MY,ID,2014.0,160,76,84
BG,RS,2020.0,4,7,-3
BY,JP,1997.0,1,2,-1
TR,nan,2013.0,16,10,6
US,nan,2001.0,121,113,8
GB,TW,2017.0,54,58,-4
AU,RO,2012.0,4,2,2
IN,AE,2014.0,50,18,32
PT,NO,2011.0,10,5,5
ID,GB,2020.0,74,89,-15
JP,BE,2020.0,20,20,0
IE,PL,2009.0,3,8,-5
DK,JP,2012.0,15,18,-3
HU,VN,2019.0,2,3,-1
US,HR,1998.0,14,25,-11
GB,MX,2022.0,21,41,-20
IT,FI,2015.0,25,19,6
BJ,BE,2021.0,2,1,1
IN,TW,1998.0,9,6,3
DE,IN,1997.0,29,40,-11
FR,AT,2019.0,79,44,35
RU,BG,2015.0,21,54,-33
PL,CN,2013.0,28,40,-12
RU,HU,2018.0,28,10,18
JO,HU,2021.0,3,3,0
IR,TR,2015.0,41,24,17
TR,NL,2013.0,28,29,-1
IN,AU,2006.0,66,57,9
BR,TR,2021.0,11,10,1
US,RS,2016.0,52,70,-18
US,VN,2005.0,24,22,2
FR,NC,2015.0,16,16,0
IR,JP,2017.0,26,38,-12
JP,CA,2012.0,105,114,-9
PH,FR,2017.0,7,2,5
LK,KR,2020.0,3,6,-3
US,JM,2018.0,11,20,-9
AU,CZ,2021.0,6,1,5
IQ,BH,2016.0,1,1,0
KR,NZ,2018.0,11,12,-1
NG,GB,2014.0,44,68,-24
EG,RU,2020.0,29,34,-5
FR,CO,2001.0,9,9,0
VN,BE,2017.0,6,10,-4
DE,SK,2014.0,37,38,-1
AU,BE,2020.0,43,52,-9
NC,CG,2007.0,2,1,1
SE,CA,2019.0,52,66,-14
NG,MY,2022.0,38,42,-4
KR,NO,2004.0,2,4,-2
EG,YE,2021.0,11,7,4
BR,NO,2021.0,22,16,6
SG,KR,2008.0,21,34,-13
DK,BE,2018.0,59,73,-14
IQ,DK,2019.0,1,2,-1
nan,IL,2022.0,22,7,15
NL,AU,1999.0,28,21,7
SE,DE,2002.0,90,85,5
ID,TR,2015.0,4,6,-2
EC,BR,2021.0,43,34,9
IT,AZ,2015.0,4,1,3
NO,US,1998.0,48,56,-8
US,HU,2020.0,87,101,-14
BG,CH,2019.0,8,4,4
CM,nan,2022.0,2,6,-4
HU,SK,2014.0,13,5,8
AU,CL,2003.0,3,5,-2
nan,IE,2019.0,8,4,4
TN,SA,2018.0,131,49,82
TH,VN,2013.0,5,1,4
CU,CA,2017.0,8,2,6
PL,ES,2020.0,29,26,3
MY,KR,2019.0,34,30,4
CZ,US,2010.0,119,145,-26
RO,GB,2020.0,59,77,-18
CO,JP,2016.0,15,17,-2
CN,BR,2018.0,109,49,60
IR,JP,2019.0,30,17,13
SI,MY,2020.0,3,1,2
MY,QA,2017.0,14,6,8
CN,NG,2018.0,19,24,-5
IN,SE,2019.0,72,54,18
AR,CA,2008.0,17,14,3
SA,SY,2015.0,5,4,1
IN,IT,2011.0,62,56,6
RU,FR,2003.0,54,32,22
LU,NL,2016.0,5,8,-3
FR,KH,2016.0,6,5,1
IT,NL,1998.0,37,24,13
IT,CN,1999.0,17,9,8
TR,RU,2005.0,6,7,-1
TW,PH,2017.0,12,8,4
nan,IE,2017.0,8,4,4
SK,DE,2018.0,38,36,2
FR,NL,2007.0,152,198,-46
LB,CA,2014.0,19,11,8
FI,GB,2001.0,26,25,1
UA,EC,2011.0,18,18,0
IN,PT,2007.0,8,4,4
ES,ZA,2015.0,14,5,9
RE,FR,1999.0,7,4,3
NL,BE,2007.0,193,199,-6
MM,MY,2017.0,8,4,4
CN,CR,2006.0,1,1,0
BR,BG,2018.0,6,6,0
NL,CH,2004.0,58,58,0
OM,PK,2019.0,13,18,-5
NL,RU,2014.0,33,41,-8
IL,RS,2007.0,7,8,-1
GR,SE,2007.0,9,10,-1
IT,IR,2018.0,41,64,-23
GB,LK,1998.0,6,2,4
BW,AU,2010.0,1,2,-1
MA,SD,2017.0,2,3,-1
CZ,BE,2020.0,11,11,0
CM,NG,2016.0,2,4,-2
FR,MD,2000.0,28,61,-33
DE,GA,2006.0,5,4,1
LB,TR,2017.0,3,2,1
JP,nan,2001.0,70,136,-66
BD,IN,2012.0,64,65,-1
PT,SE,1999.0,1,2,-1
US,BW,2011.0,13,2,11
ID,KR,2013.0,6,16,-10
IL,AU,2006.0,11,10,1
nan,DK,2005.0,9,9,0
BD,KR,2011.0,14,15,-1
CN,NP,2018.0,23,20,3
UY,CL,2021.0,12,17,-5
AU,CY,2020.0,3,1,2
CM,FR,2019.0,16,41,-25
TH,GB,2022.0,16,37,-21
GB,NG,2000.0,8,4,4
NG,KE,2002.0,2,3,-1
nan,IT,2013.0,95,318,-223
AE,MY,2009.0,2,4,-2
IQ,BD,2018.0,2,6,-4
NL,UA,2013.0,7,8,-1
VN,FR,2018.0,31,69,-38
MX,BE,2018.0,11,12,-1
VN,TW,2016.0,8,22,-14
PH,JP,2012.0,15,36,-21
RO,FR,2019.0,34,55,-21
RO,HU,2007.0,18,21,-3
IL,ES,1997.0,3,1,2
AU,IE,2002.0,55,33,22
LT,FR,2011.0,2,4,-2
GB,PT,2004.0,43,46,-3
UY,CR,2014.0,2,3,-1
ZA,FR,1997.0,5,7,-2
ES,FI,2020.0,31,19,12
KZ,TR,2014.0,65,46,19
KW,OM,2006.0,3,1,2
OM,SA,2011.0,3,2,1
SV,MX,2016.0,4,5,-1
HU,PL,2012.0,11,7,4
NZ,SG,2020.0,27,19,8
MA,TN,2019.0,48,36,12
CY,GR,2016.0,35,51,-16
JO,US,2012.0,47,64,-17
SG,IN,2014.0,108,110,-2
TZ,TR,2014.0,2,1,1
FR,ID,2019.0,45,25,20
DE,IN,1998.0,42,54,-12
UA,FR,2008.0,13,8,5
SE,nan,1998.0,32,30,2
AR,FR,2008.0,38,41,-3
JO,IN,2012.0,3,1,2
RO,FR,2017.0,39,63,-24
KE,FR,2011.0,12,7,5
RO,FR,2010.0,38,60,-22
FR,BY,2006.0,5,5,0
CN,LK,2015.0,5,5,0
AR,PY,2010.0,3,5,-2
IN,AT,2022.0,10,7,3
VN,CN,2020.0,18,54,-36
SD,US,1999.0,3,1,2
BO,FR,2020.0,3,4,-1
KE,PK,2009.0,6,7,-1
BE,LB,2017.0,10,8,2
CH,MX,2021.0,13,8,5
SK,SE,2019.0,4,1,3
CN,PT,2007.0,5,13,-8
IL,FI,2018.0,2,4,-2
CA,KZ,2018.0,7,4,3
CA,TN,2018.0,14,14,0
RS,CZ,2005.0,14,7,7
BR,MY,2013.0,32,85,-53
AU,CH,2008.0,66,57,9
BY,US,2017.0,9,9,0
IN,ET,2016.0,37,15,22
FR,BD,2011.0,7,3,4
JP,PK,1999.0,2,9,-7
HR,DK,2020.0,2,3,-1
SI,ID,2019.0,13,15,-2
TW,ZA,2010.0,3,3,0
ES,CN,2020.0,70,78,-8
DO,PE,2020.0,6,2,4
US,OM,2015.0,16,13,3
OM,PK,2017.0,12,7,5
TN,MD,2015.0,6,9,-3
RU,AZ,2020.0,20,30,-10
AZ,DE,2022.0,1,1,0
FR,EC,2022.0,6,4,2
PE,GB,2016.0,13,9,4
MY,LK,2020.0,8,4,4
GB,ET,2021.0,14,7,7
DE,SN,2018.0,3,1,2
IR,ES,2022.0,19,12,7
BY,US,2019.0,16,8,8
IQ,NG,2018.0,4,4,0
BD,BE,2017.0,5,4,1
MY,AE,2021.0,19,6,13
LT,EE,2019.0,1,2,-1
RO,LT,2009.0,4,2,2
DZ,FR,2009.0,51,100,-49
MU,US,2000.0,1,1,0
PK,KE,2014.0,25,14,11
SE,CA,2010.0,40,36,4
TH,PH,2006.0,1,1,0
HR,DE,2012.0,13,18,-5
RU,SE,2022.0,32,17,15
JP,AU,2015.0,79,76,3
DE,NZ,2017.0,54,50,4
CN,JO,2017.0,2,3,-1
GR,DK,2008.0,7,5,2
BE,SG,2015.0,8,6,2
DE,JO,2003.0,4,6,-2
MW,BW,2021.0,1,1,0
KE,KR,2011.0,1,1,0
SA,CA,2006.0,18,27,-9
KZ,KG,2020.0,8,5,3
BY,UA,2017.0,27,12,15
LB,CH,2022.0,8,2,6
KR,PA,2021.0,1,1,0
BY,UA,2019.0,24,23,1
BE,GR,2013.0,14,37,-23
DE,NZ,2010.0,34,30,4
IN,SE,2010.0,35,29,6
MX,HN,2008.0,11,22,-11
BE,LT,2008.0,1,3,-2
IE,FR,1997.0,4,6,-2
SE,PT,2005.0,10,9,1
HU,FR,2011.0,29,19,10
US,HR,1997.0,12,14,-2
SE,nan,1997.0,31,18,13
JP,IR,2004.0,8,2,6
FI,CH,2008.0,13,14,-1
DE,BR,2023.0,13,12,1
PK,KW,2016.0,1,4,-3
TR,CO,2015.0,10,3,7
ZA,UG,2009.0,9,4,5
BO,ES,2003.0,2,4,-2
ES,BG,2017.0,2,2,0
US,KW,2013.0,18,16,2
GB,AT,2006.0,39,61,-22
AU,IR,1999.0,15,4,11
KE,AT,2018.0,2,2,0
BD,GB,2001.0,12,20,-8
IR,US,1997.0,6,13,-7
CM,FR,2010.0,9,10,-1
MK,HR,1997.0,1,1,0
PS,JP,2014.0,1,1,0
nan,NL,1999.0,16,20,-4
FR,IR,2008.0,28,16,12
AU,SE,2000.0,19,17,2
AT,BR,1998.0,1,1,0
MD,MA,2003.0,7,3,4
AE,SE,2016.0,7,10,-3
IN,BR,2008.0,17,12,5
US,AE,1998.0,4,7,-3
IR,SE,2007.0,11,16,-5
GE,DE,1999.0,2,2,0
GB,HR,2004.0,6,4,2
SS,GB,2019.0,9,6,3
nan,PT,2022.0,8,20,-12
TR,AT,2008.0,3,2,1
IT,IN,2007.0,48,58,-10
AU,IL,2000.0,6,10,-4
CH,GR,2022.0,14,21,-7
GR,IE,2007.0,5,3,2
MM,MY,2019.0,5,5,0
HU,IT,2010.0,14,7,7
LT,BE,2014.0,2,2,0
RO,CA,2011.0,11,17,-6
BE,NZ,2016.0,8,5,3
GR,KR,2015.0,2,2,0
HU,CZ,2008.0,4,1,3
IT,BG,2006.0,4,1,3
US,LK,2014.0,27,26,1
PL,CA,1998.0,8,9,-1
MY,GB,2009.0,52,104,-52
NG,KE,2005.0,2,2,0
LB,FR,2005.0,18,24,-6
DK,NO,1999.0,19,33,-14
MY,NL,2016.0,15,12,3
HU,RO,2006.0,16,25,-9
SI,GB,2018.0,19,16,3
NC,US,2020.0,2,3,-1
DK,EG,2017.0,4,5,-1
CA,JO,2010.0,12,5,7
GB,VN,2009.0,10,3,7
QA,PK,2013.0,6,5,1
PH,IN,2014.0,13,25,-12
FR,MC,2020.0,13,7,6
DE,SA,2004.0,7,2,5
KW,PK,2014.0,4,2,2
IN,FI,2007.0,4,4,0
GB,PG,2004.0,3,2,1
GB,CL,2004.0,11,11,0
PK,NO,2021.0,4,8,-4
DK,IN,2022.0,15,20,-5
ZM,GH,2009.0,6,6,0
PE,BR,2006.0,10,9,1
CA,AR,2007.0,14,19,-5
BR,IN,2006.0,16,14,2
ES,LK,2013.0,5,4,1
CA,NO,1999.0,11,3,8
IN,VN,2019.0,7,4,3
DE,FI,1997.0,17,17,0
SG,DE,2008.0,14,31,-17
BR,SD,2001.0,3,2,1
CH,SK,2012.0,2,9,-7
PE,JP,2010.0,1,2,-1
AT,nan,2013.0,10,16,-6
SS,GB,2010.0,13,6,7
TW,ZA,2017.0,3,3,0
IN,TW,1997.0,4,2,2
BR,CR,2006.0,4,5,-1
IN,NG,2014.0,15,12,3
ES,PL,2011.0,12,15,-3
LK,JP,2005.0,8,13,-5
CA,SI,2015.0,7,3,4
nan,PK,2021.0,5,7,-2
IR,MY,2007.0,6,4,2
CH,BG,2005.0,3,4,-1
AT,SK,2013.0,16,14,2
PS,DE,2016.0,3,7,-4
EG,DZ,2022.0,9,2,7
SE,IR,2009.0,21,17,4
CO,nan,2016.0,7,11,-4
CO,HN,2020.0,7,5,2
KR,CM,2019.0,2,1,1
AR,AU,2021.0,12,7,5
NG,SA,1997.0,3,1,2
HU,BE,1998.0,5,2,3
SK,SI,2018.0,3,2,1
BG,US,2015.0,27,35,-8
HU,IT,2019.0,12,9,3
MX,VE,2008.0,43,37,6
US,RW,2016.0,12,20,-8
IL,IN,2010.0,21,25,-4
HU,UA,2009.0,1,3,-2
RO,CH,2014.0,14,7,7
FJ,US,2019.0,6,4,2
ET,NL,2016.0,2,13,-11
CN,RU,2005.0,20,54,-34
KW,MA,2006.0,1,1,0
GB,KH,2019.0,5,3,2
KR,CO,2008.0,3,1,2
nan,GR,2020.0,6,2,4
CN,KZ,2004.0,4,11,-7
DE,LT,2003.0,5,3,2
nan,DK,2002.0,11,7,4
NO,IN,2012.0,14,29,-15
DZ,GB,2021.0,11,5,6
ZA,CM,2019.0,10,7,3
AR,BE,2009.0,4,6,-2
KW,IR,2015.0,1,1,0
IL,CH,2020.0,21,22,-1
PY,ES,2018.0,8,36,-28
DE,GR,2013.0,57,90,-33
AT,BG,2005.0,2,3,-1
IN,VN,2017.0,6,1,5
IR,JP,2010.0,21,25,-4
CA,NZ,1997.0,22,20,2
nan,AU,1999.0,9,9,0
VE,GB,2003.0,8,8,0
ES,IN,2003.0,12,11,1
DK,BD,2016.0,3,2,1
DK,EG,2019.0,6,4,2
CZ,NL,2005.0,10,8,2
NO,ES,1999.0,9,6,3
CA,BD,2003.0,5,8,-3
JP,ES,2004.0,23,26,-3
CA,GD,2018.0,2,3,-1
CN,MX,2009.0,10,11,-1
NO,HU,2016.0,7,8,-1
CH,RU,1999.0,9,13,-4
SS,GB,2017.0,10,7,3
CA,SY,2017.0,1,3,-2
LK,DE,2013.0,3,2,1
BR,DK,2012.0,20,8,12
KE,GB,2008.0,22,11,11
EG,LY,2011.0,1,2,-1
GH,BR,2015.0,1,1,0
US,UY,2008.0,19,14,5
CU,CA,2019.0,9,1,8
PE,EC,2015.0,31,8,23
DE,VE,2007.0,3,4,-1
RU,AT,2014.0,19,16,3
FR,GA,2016.0,7,6,1
AF,US,2013.0,2,1,1
BY,CZ,2023.0,1,2,-1
PK,AR,2004.0,4,2,2
FI,JP,2012.0,13,23,-10
SI,BE,2011.0,5,7,-2
FR,AT,2010.0,36,44,-8
SI,AU,2020.0,4,4,0
MX,PA,2012.0,8,4,4
NG,JP,2006.0,2,7,-5
LK,JP,2002.0,3,13,-10
FI,ZA,2005.0,1,1,0
UA,HR,2017.0,4,3,1
NL,HU,2003.0,6,9,-3
FR,KR,2020.0,28,34,-6
nan,KR,2014.0,23,27,-4
IE,NL,2005.0,10,9,1
UA,CH,2016.0,7,6,1
CG,FR,2013.0,20,16,4
IS,ES,2016.0,6,6,0
TZ,RW,2016.0,2,2,0
US,BG,2009.0,20,31,-11
HU,JP,2007.0,9,6,3
ES,HR,2018.0,7,6,1
nan,CZ,2012.0,12,8,4
US,LV,2015.0,8,9,-1
US,AE,1997.0,3,5,-2
IT,AM,2008.0,18,18,0
DE,ZA,1997.0,14,11,3
CA,LB,2020.0,10,20,-10
AU,EG,2011.0,13,8,5
FI,PL,2016.0,9,6,3
IT,NL,1997.0,17,39,-22
AU,MX,1997.0,2,2,0
TZ,DE,2015.0,7,5,2
US,AM,2012.0,7,17,-10
CN,CL,2015.0,4,5,-1
VN,AU,2010.0,11,26,-15
CM,JP,2020.0,3,3,0
DE,FI,1998.0,17,14,3
MY,TW,2007.0,6,6,0
MX,IN,2009.0,7,10,-3
KH,JP,2013.0,5,3,2
BG,IT,2021.0,4,4,0
CA,JO,2017.0,16,8,8
IE,SK,2021.0,2,1,1
BE,LB,2019.0,11,9,2
PE,NI,2012.0,2,1,1
ML,TG,2016.0,2,1,1
EG,SE,2021.0,6,12,-6
BE,CL,2005.0,6,2,4
AT,JP,2018.0,20,26,-6
US,ST,2007.0,1,2,-1
PH,FR,2010.0,9,6,3
CO,CA,2014.0,14,28,-14
JP,JO,2006.0,6,2,4
LU,BE,2020.0,16,22,-6
SY,IQ,2018.0,5,1,4
KR,BH,2012.0,1,1,0
LU,ES,2020.0,8,12,-4
CR,AR,2005.0,5,3,2
BE,AU,2004.0,23,18,5
CA,EE,2014.0,5,3,2
LB,DE,2016.0,5,5,0
BE,JP,2020.0,20,20,0
IN,IR,2003.0,6,2,4
MY,BD,1999.0,1,1,0
BD,JP,2023.0,5,2,3
AR,MX,2001.0,23,41,-18
CH,TW,2017.0,6,8,-2
NO,EG,2021.0,2,1,1
NO,IT,2013.0,17,26,-9
MY,CY,2014.0,2,1,1
AU,SK,2000.0,2,4,-2
US,GT,2013.0,8,14,-6
AT,AR,2011.0,2,2,0
QA,SA,2013.0,4,13,-9
KE,ZA,2004.0,5,3,2
SE,SA,2009.0,2,1,1
TR,CN,2022.0,13,9,4
DK,RU,2005.0,7,6,1
PK,DK,2015.0,5,4,1
PT,MA,2020.0,21,28,-7
NP,PH,2016.0,4,6,-2
BY,UA,2010.0,9,7,2
GB,SI,2003.0,6,3,3
JO,OM,2008.0,4,1,3
ES,NO,2006.0,15,12,3
UY,ES,1999.0,11,6,5
NZ,IT,2016.0,6,9,-3
PT,DK,2016.0,15,4,11
ES,SI,2003.0,5,3,2
BD,PK,2006.0,9,10,-1
CO,AT,2012.0,4,2,2
SY,ET,2021.0,1,2,-1
MY,IN,2005.0,19,19,0
CZ,LT,2009.0,15,6,9
VN,ID,2022.0,2,1,1
TH,CN,2004.0,7,1,6
RU,CL,1998.0,2,1,1
CZ,IR,2010.0,4,3,1
EE,TR,2022.0,1,1,0
NZ,IE,2013.0,11,20,-9
DE,GE,2000.0,1,5,-4
FI,LT,2020.0,3,4,-1
CA,LY,2020.0,3,2,1
IS,US,2013.0,11,21,-10
FR,HT,2019.0,5,1,4
IE,AR,2005.0,2,2,0
IR,CN,2004.0,8,8,0
BY,GB,1998.0,2,1,1
NL,IE,2001.0,6,11,-5
UA,HU,2009.0,3,1,2
QA,AU,2018.0,8,11,-3
RW,BE,2013.0,4,4,0
CL,CA,2007.0,10,13,-3
CA,GE,1997.0,2,1,1
SY,EG,2018.0,14,5,9
DK,IR,2012.0,13,9,4
NP,CA,2018.0,7,7,0
FR,ID,2010.0,11,3,8
ID,FI,2020.0,7,4,3
QA,KW,2020.0,7,4,3
SE,TH,2018.0,6,3,3
TZ,NA,2020.0,1,1,0
KR,UZ,2019.0,5,2,3
SK,RU,2022.0,9,29,-20
EC,VE,2020.0,17,27,-10
US,KY,2013.0,2,2,0
GR,NG,2016.0,1,1,0
SN,MG,2017.0,1,1,0
ET,JP,2015.0,4,1,3
AU,PG,2011.0,5,5,0
PK,CA,2008.0,12,13,-1
JP,NO,2004.0,6,2,4
TW,DE,2021.0,26,24,2
CO,PE,1997.0,3,2,1
IR,PL,2018.0,10,1,9
AU,FI,2011.0,8,11,-3
DE,MA,2012.0,6,5,1
BY,RU,2001.0,23,17,6
EG,NG,2016.0,5,5,0
PL,MZ,2021.0,4,4,0
IN,NO,2017.0,37,17,20
HU,VN,2017.0,3,4,-1
DE,SY,2014.0,5,2,3
EG,AT,2016.0,5,9,-4
BG,UA,2020.0,8,15,-7
TR,CL,2019.0,2,1,1
PL,LT,2004.0,5,4,1
GB,RW,2016.0,2,1,1
RS,DE,2002.0,11,8,3
CH,TW,2010.0,6,6,0
CN,IE,2003.0,7,9,-2
ES,JP,2023.0,1,2,-1
RW,CD,2019.0,3,1,2
PE,JP,2019.0,3,3,0
TZ,NO,2014.0,6,9,-3
CU,VE,1998.0,3,4,-1
VN,BY,2011.0,2,1,1
NO,BG,2016.0,4,3,1
US,BJ,2015.0,4,7,-3
TN,EG,2011.0,6,6,0
PT,CY,2020.0,1,1,0
TH,AU,2000.0,9,7,2
PG,AU,2022.0,6,4,2
CU,CR,2021.0,16,29,-13
PL,nan,2013.0,9,8,1
AT,CL,2006.0,5,1,4
LT,AM,2014.0,2,2,0
UG,SE,2012.0,3,5,-2
HR,IT,2014.0,7,6,1
FR,UY,1998.0,4,3,1
IT,HU,2003.0,10,7,3
GB,LK,1997.0,3,2,1
ML,US,2007.0,4,1,3
IE,BH,2016.0,2,1,1
IE,FR,1998.0,5,8,-3
MA,GP,2014.0,2,1,1
RO,CZ,2005.0,3,1,2
EC,RU,2013.0,6,1,5
KZ,RU,2013.0,16,31,-15
DK,ZA,2003.0,5,2,3
DZ,IT,2014.0,18,24,-6
CA,CH,2023.0,4,9,-5
CA,UY,2016.0,8,4,4
DZ,DE,2015.0,5,4,1
PK,nan,2021.0,7,5,2
BE,KR,2003.0,4,4,0
PH,CL,2016.0,3,6,-3
RO,RU,2016.0,3,4,-1
JP,LU,2022.0,1,1,0
CH,PH,2011.0,2,3,-1
UA,IT,2009.0,7,11,-4
LT,JP,1998.0,6,4,2
ZA,BR,2005.0,2,5,-3
CA,RU,2001.0,16,34,-18
UY,MX,1999.0,3,4,-1
FI,NO,2000.0,8,4,4
UY,AT,2018.0,2,2,0
TW,PH,2010.0,4,4,0
AU,JO,2005.0,2,3,-1
IL,EG,2013.0,2,2,0
NO,JP,2022.0,3,8,-5
ES,TR,2004.0,3,7,-4
CH,nan,2004.0,6,6,0
KR,AE,2014.0,3,2,1
FR,NZ,2000.0,4,6,-2
NL,TW,2006.0,4,1,3
TW,TR,2008.0,7,13,-6
GE,TW,2000.0,1,1,0
CN,ET,2009.0,1,3,-2
FI,FR,2004.0,9,13,-4
NE,FR,1999.0,2,2,0
KE,SE,2006.0,3,3,0
FR,PK,2008.0,3,3,0
IS,CA,2006.0,3,2,1
CZ,IR,2019.0,1,17,-16
UY,US,2000.0,5,7,-2
MX,DO,2012.0,4,5,-1
CY,AE,2015.0,3,1,2
SG,NO,2021.0,3,2,1
GB,KH,2017.0,6,6,0
NZ,PE,2018.0,2,2,0
LB,MA,2014.0,2,2,0
JP,HU,2014.0,6,13,-7
GB,PE,2013.0,11,8,3
ET,ZA,2014.0,7,4,3
PY,UY,2019.0,2,4,-2
HU,SG,2012.0,2,1,1
TH,PK,1998.0,1,1,0
BE,MA,2015.0,8,5,3
AT,ES,2004.0,7,5,2
NL,KE,2011.0,5,4,1
ZM,TZ,2020.0,2,1,1
PL,RU,2003.0,11,16,-5
SI,HR,2011.0,21,16,5
PL,IT,2007.0,16,21,-5
BD,FR,2020.0,6,5,1
UA,IN,2016.0,2,3,-1
FR,BF,2001.0,4,5,-1
CO,IE,2016.0,3,2,1
HU,FI,2018.0,2,5,-3
CZ,UZ,2015.0,6,2,4
US,CG,2020.0,3,4,-1
QA,IQ,2013.0,1,1,0
CN,JO,2019.0,3,3,0
SE,CO,2022.0,5,2,3
MX,PH,2001.0,1,1,0
GF,FR,1997.0,1,3,-2
MA,SA,2006.0,1,1,0
NO,ET,2015.0,7,5,2
JP,AM,2009.0,4,6,-2
DE,ET,2007.0,5,6,-1
IN,RS,2017.0,3,1,2
IN,AG,2020.0,2,2,0
AR,CZ,2007.0,2,1,1
ZA,SG,2013.0,2,1,1
CZ,RO,2002.0,2,2,0
TW,RU,2001.0,7,11,-4
TR,RS,2020.0,4,24,-20
TH,CA,2013.0,11,18,-7
BE,IN,2004.0,7,6,1
CA,TT,2015.0,3,3,0
LT,JP,1997.0,5,3,2
DZ,CM,2020.0,1,1,0
BD,DK,2016.0,2,3,-1
ZA,ET,2007.0,4,4,0
EE,LT,2015.0,1,1,0
GB,MU,2021.0,1,4,-3
DK,TH,2017.0,3,1,2
KH,MY,2019.0,1,3,-2
IN,IS,2014.0,3,1,2
BR,GW,2016.0,1,1,0
FR,CG,2022.0,7,9,-2
TH,KR,2021.0,6,15,-9
CL,AU,2007.0,8,4,4
CU,FR,2021.0,3,1,2
CU,AR,2015.0,12,13,-1
KE,GH,2014.0,1,3,-2
VN,DE,2008.0,6,10,-4
BD,BE,2010.0,2,3,-1
ZA,PT,2020.0,7,3,4
SK,SE,2017.0,3,1,2
ZA,FR,1998.0,4,6,-2
NO,GR,2020.0,9,20,-11
AT,SI,2004.0,2,5,-3
AT,GB,2023.0,4,8,-4
IT,LB,2006.0,7,3,4
IT,PA,2016.0,2,1,1
LU,NO,2013.0,2,4,-2
OM,ZW,2022.0,1,1,0
RO,ES,2003.0,1,2,-1
ES,BG,2010.0,5,2,3
TR,TZ,2020.0,2,1,1
RO,RS,2009.0,1,1,0
ZA,BR,2002.0,3,5,-2
US,PY,2015.0,8,5,3
CL,nan,2013.0,8,5,3
DZ,JP,2000.0,2,1,1
IQ,TR,2014.0,1,1,0
EE,SE,2004.0,2,12,-10
IL,ES,1998.0,6,2,4
KZ,CN,2005.0,9,4,5
BO,CO,2006.0,4,2,2
MZ,PT,2002.0,2,3,-1
ID,CL,2009.0,2,2,0
MK,XK,2018.0,5,5,0
BR,CV,2020.0,2,2,0
KR,SG,1998.0,6,5,1
RO,IT,2000.0,4,6,-2
FR,SY,2001.0,2,2,0
FI,RS,2021.0,1,2,-1
BY,US,2010.0,11,15,-4
RU,MN,2018.0,6,5,1
IT,IQ,2013.0,2,2,0
ES,PY,2012.0,3,4,-1
IS,CH,2012.0,1,1,0
ZA,EG,2017.0,6,6,0
CZ,nan,1998.0,5,1,4
GH,VN,2020.0,2,4,-2
PT,RS,2013.0,2,2,0
LV,RU,2003.0,8,14,-6
TW,MX,2012.0,2,2,0
HR,BD,2019.0,1,1,0
SE,SK,2020.0,4,4,0
VN,JP,2004.0,6,15,-9
CL,PT,2000.0,3,1,2
AR,SV,2015.0,2,2,0
CO,BO,2007.0,2,1,1
PT,RU,2011.0,3,5,-2
FR,BO,2015.0,3,2,1
IT,KE,2018.0,3,5,-2
PK,EG,2007.0,3,6,-3
UZ,BR,1998.0,1,1,0
SA,BH,2011.0,2,1,1
GD,CA,2018.0,3,2,1
EC,nan,2016.0,4,1,3
AZ,IR,2017.0,6,4,2
ID,NP,2019.0,1,7,-6
BE,SA,2012.0,3,2,1
AZ,TR,2003.0,1,3,-2
IE,NL,2002.0,5,2,3
IN,TZ,2015.0,6,2,4
SE,PL,2001.0,9,21,-12
IL,ZA,2006.0,3,4,-1
HN,US,2014.0,8,4,4
TZ,BR,2020.0,3,1,2
RU,ID,2015.0,3,2,1
AZ,IR,2019.0,3,2,1
CO,PE,1998.0,5,4,1
NZ,KR,2004.0,2,3,-1
NL,NZ,1998.0,5,1,4
RU,SK,2007.0,3,7,-4
TR,AE,2015.0,5,2,3
AR,PK,2022.0,1,1,0
NO,AL,2017.0,1,2,-1
KE,BW,2022.0,1,1,0
KR,PH,2022.0,5,2,3
CH,BG,2002.0,3,1,2
PK,RS,2016.0,3,1,2
MM,SG,2006.0,4,1,3
MN,NL,2021.0,1,1,0
US,ZW,2022.0,4,3,1
LT,GB,2006.0,4,4,0
ZA,CG,2016.0,1,1,0
LY,US,2016.0,1,5,-4
PH,IT,2003.0,2,6,-4
IL,AM,2007.0,1,1,0
IT,SM,2020.0,4,2,2
IR,FR,1998.0,1,3,-2
AE,SY,2021.0,2,2,0
FR,NG,2011.0,5,5,0
AE,IN,2006.0,4,5,-1
UZ,DE,2019.0,1,4,-3
GH,CM,2020.0,1,3,-2
UA,MY,2018.0,11,4,7
MX,UA,2013.0,2,3,-1
MY,IN,2002.0,5,12,-7
SE,CY,2020.0,1,3,-2
SE,UY,2011.0,3,2,1
BE,CN,1997.0,8,6,2
HU,NG,2020.0,3,2,1
ZA,CZ,2014.0,2,4,-2
EG,TT,2021.0,1,1,0
TW,PH,2019.0,3,14,-11
JP,MN,2006.0,1,1,0
PA,ID,2015.0,2,3,-1
DE,KZ,2021.0,7,7,0
GB,MM,2017.0,1,1,0
IQ,nan,2022.0,1,2,-1
HU,VN,2010.0,2,1,1
GB,SS,1999.0,5,2,3
PK,PG,2019.0,1,1,0
JP,TR,2023.0,1,1,0
LB,TR,2019.0,2,2,0
SI,BA,2015.0,5,5,0
BO,US,2013.0,5,12,-7
ET,CA,2013.0,2,2,0
PA,IT,2012.0,2,3,-1
CR,RU,2011.0,1,1,0
CO,VE,2005.0,7,10,-3
CY,BE,2012.0,1,2,-1
MX,DK,2022.0,4,3,1
BR,IL,1997.0,1,1,0
PE,FR,1999.0,3,2,1
FJ,US,2017.0,4,6,-2
IN,BE,2001.0,5,10,-5
NO,CZ,2007.0,3,29,-26
NG,BE,2016.0,1,1,0
EC,BO,2016.0,2,4,-2
FI,SK,2014.0,1,2,-1
US,PR,2020.0,2,6,-4
GT,US,2001.0,2,3,-1
LB,FR,2002.0,5,16,-11
SK,FR,2004.0,3,5,-2
JP,AT,2000.0,3,10,-7
ID,TN,2013.0,1,2,-1
FI,PK,2012.0,2,1,1
PT,FI,2009.0,3,1,2
VE,UY,1999.0,1,1,0
LK,GB,1997.0,2,3,-1
UY,FR,1998.0,3,4,-1
TR,FI,2001.0,1,2,-1
CU,DE,2002.0,3,1,2
AF,IR,2022.0,2,8,-6
PL,CA,1997.0,7,10,-3
FR,DJ,2019.0,2,1,1
TR,NZ,2019.0,3,1,2
SG,JP,1997.0,4,9,-5
FI,UA,2006.0,1,1,0
IN,ID,2004.0,1,1,0
QA,GB,2001.0,3,5,-2
BW,AU,2019.0,1,1,0
ID,AE,2022.0,2,1,1
BG,MK,2009.0,3,1,2
BN,NZ,2017.0,1,1,0
QA,BD,2019.0,2,2,0
BT,AU,2018.0,3,2,1
ES,SK,2003.0,2,2,0
US,NE,2020.0,3,4,-1
AM,DE,2012.0,4,5,-1
AE,SG,2022.0,3,4,-1
TH,ZA,2010.0,1,1,0
GB,PA,1997.0,2,1,1
BG,CH,2017.0,3,6,-3
AU,RS,2011.0,3,1,2
SA,DE,1997.0,1,1,0
PS,GB,2011.0,4,4,0
AU,JO,2002.0,1,1,0
BD,BE,2019.0,4,2,2
IL,KR,2016.0,5,8,-3
NP,PK,2022.0,2,5,-3
CA,LK,2015.0,5,3,2
FI,BE,2008.0,4,8,-4
BF,IT,2015.0,2,1,1
UZ,DE,2010.0,4,4,0
TR,KG,2022.0,9,1,8
nan,MM,2020.0,2,1,1
FR,LU,2000.0,2,7,-5
TH,KE,2005.0,1,1,0
SE,FO,2018.0,1,1,0
SA,ES,2012.0,1,6,-5
LV,IE,2011.0,2,1,1
BE,BJ,2022.0,3,4,-1
CA,CI,2018.0,9,3,6
US,PG,2010.0,1,5,-4
TG,MA,2016.0,1,2,-1
DK,RS,2018.0,2,6,-4
SG,RU,2018.0,6,16,-10
MY,IE,2011.0,1,6,-5
BN,JP,2021.0,1,1,0
CA,CY,2016.0,4,5,-1
NZ,NL,2002.0,3,5,-2
IR,QA,2018.0,6,3,3
nan,NG,2012.0,7,1,6
HR,IE,2000.0,1,4,-3
SI,RS,2023.0,1,4,-3
CN,KW,2015.0,1,1,0
CN,EE,2017.0,2,1,1
YE,US,2018.0,2,4,-2
BE,EE,2015.0,3,1,2
NE,MA,2020.0,1,4,-3
FI,BR,2022.0,5,8,-3
MN,JP,2022.0,2,5,-3
NO,CL,2017.0,3,1,2
TH,BE,2021.0,2,3,-1
RU,SA,2019.0,5,5,0
GE,UA,2020.0,1,1,0
ZA,IT,2003.0,6,10,-4
AT,NL,2023.0,2,1,1
UY,FR,1997.0,1,2,-1
ZM,JP,2022.0,2,1,1
AT,EG,2003.0,2,1,1
GE,CZ,2020.0,1,3,-2
PL,HK,2015.0,2,1,1
US,BH,2000.0,4,3,1
RS,IE,2011.0,2,2,0
CZ,CL,2017.0,3,6,-3
TZ,EG,2020.0,2,3,-1
CR,BR,2008.0,3,5,-2
LU,IE,2017.0,1,3,-2
ES,AE,2008.0,2,1,1
NP,GB,1998.0,2,1,1
US,BN,2013.0,2,1,1
KZ,MY,2014.0,2,1,1
NO,IS,2022.0,4,5,-1
NO,SG,2005.0,2,2,0
ES,GR,2022.0,8,13,-5
EC,CU,2015.0,3,42,-39
CA,SY,2019.0,1,1,0
FR,TG,2022.0,2,1,1
CM,IT,2008.0,2,2,0
AU,PK,2001.0,1,7,-6
VN,IN,2021.0,8,5,3
BF,CH,2020.0,3,2,1
PT,CL,2006.0,3,7,-4
JP,CO,2008.0,7,4,3
nan,FI,2000.0,2,1,1
NO,LK,2020.0,3,3,0
CH,MG,1999.0,3,1,2
PK,CM,2021.0,3,1,2
NZ,CL,2015.0,8,7,1
IL,IE,2007.0,2,4,-2
CZ,nan,1997.0,1,2,-1
RO,PT,2013.0,4,4,0
KE,UG,2006.0,2,4,-2
PL,MX,2000.0,2,2,0
CA,ID,2008.0,3,5,-2
IS,NO,2016.0,3,7,-4
BS,US,2021.0,3,5,-2
TH,DK,2008.0,3,1,2
UA,BE,2005.0,1,7,-6
LK,NL,2007.0,1,2,-1
CU,AU,2002.0,3,1,2
TW,SE,2007.0,4,3,1
CL,PA,2009.0,3,2,1
AU,GM,2020.0,1,1,0
SI,PL,2021.0,2,4,-2
BG,CH,2010.0,3,2,1
BD,FI,2016.0,1,1,0
EG,GR,2019.0,1,2,-1
NP,FI,2018.0,3,1,2
SY,GB,2003.0,2,2,0
UA,IL,1998.0,2,2,0
OM,JO,2009.0,3,1,2
TN,BE,2011.0,2,3,-1
ES,HU,2003.0,3,5,-2
IR,NL,2001.0,3,2,1
AT,TW,2013.0,6,2,4
CA,GE,1998.0,1,1,0
IN,RS,2019.0,3,4,-1
RO,VN,2009.0,2,1,1
UA,AU,2012.0,2,1,1
CN,UA,2004.0,6,9,-3
SE,PT,2002.0,1,3,-2
CL,EG,2020.0,1,1,0
US,NI,2004.0,2,1,1
FR,PH,1997.0,2,1,1
JO,DE,2001.0,5,5,0
US,MK,2022.0,5,4,1
AU,UA,2008.0,1,4,-3
MX,NO,2018.0,5,3,2
DK,TH,2019.0,1,1,0
BY,JP,1998.0,2,1,1
NL,BG,2004.0,3,1,2
CZ,AM,2020.0,5,2,3
RO,IE,1999.0,1,2,-1
DE,CR,2020.0,1,7,-6
ZA,BW,2015.0,7,8,-1
PT,AR,1999.0,2,2,0
CH,PT,2000.0,1,2,-1
ML,BF,2003.0,1,1,0
IT,PK,2009.0,4,4,0
CI,ID,2018.0,1,2,-1
IN,ML,2004.0,2,1,1
BD,KW,2000.0,1,1,0
CY,PK,2018.0,1,2,-1
US,UG,1999.0,8,3,5
HN,PE,1999.0,1,1,0
EG,GR,2017.0,3,2,1
PL,PE,2020.0,1,1,0
UG,KE,2004.0,2,1,1
FJ,FR,2012.0,1,1,0
DE,PA,2016.0,5,4,1
BR,EC,2005.0,5,1,4
CA,UG,2003.0,1,1,0
BR,GR,2022.0,2,1,1
JP,KW,2018.0,1,1,0
RE,BR,2015.0,1,2,-1
BO,BJ,2008.0,1,2,-1
FR,PH,1998.0,2,1,1
GR,MX,2016.0,2,4,-2
BR,TW,2022.0,1,2,-1
DE,IR,1997.0,1,2,-1
IN,KE,1999.0,1,4,-3
SK,UA,2021.0,1,6,-5
IM,GB,2018.0,1,1,0
SA,NO,2000.0,1,2,-1
MK,CZ,2019.0,1,1,0
KH,RU,2015.0,2,2,0
FI,SI,2008.0,1,1,0
AG,KH,2021.0,2,1,1
UG,NO,2007.0,2,4,-2
AU,BA,2013.0,1,1,0
SI,ID,2017.0,6,3,3
RU,MZ,1997.0,2,1,1
DK,LU,2013.0,4,1,3
SI,BR,2016.0,1,5,-4
ID,RU,2016.0,6,9,-3
JP,LA,2020.0,4,1,3
NL,PT,1999.0,3,5,-2
MA,MD,2014.0,1,3,-2
KR,VN,2004.0,1,6,-5
IQ,LB,2021.0,3,4,-1
BO,BE,2013.0,1,4,-3
SL,GB,2014.0,1,1,0
BE,EC,2018.0,2,7,-5
ZA,EG,2019.0,7,6,1
SE,RS,2014.0,3,4,-1
GH,JP,2001.0,2,3,-1
CA,VE,1998.0,1,1,0
CI,UG,2018.0,2,1,1
SA,KW,2006.0,3,1,2
FI,TR,1999.0,1,1,0
IT,AO,2016.0,1,4,-3
GB,BB,1997.0,1,2,-1
IE,HU,2011.0,1,2,-1
NZ,AU,2011.0,230,145,85
US,CN,2005.0,6046,4003,2043
CO,VE,2002.0,3,14,-11
BR,JP,2012.0,43,57,-14
TW,CN,2021.0,925,804,121
MX,CL,2003.0,49,40,9
CA,JP,2004.0,101,125,-24
SE,DK,2018.0,141,151,-10
DE,DK,2020.0,211,166,45
QA,SE,2020.0,3,2,1
BR,CU,2008.0,11,10,1
ZA,ID,2021.0,174,127,47
CN,ES,2015.0,83,75,8
PK,CN,2012.0,71,51,20
IN,SE,2017.0,68,49,19
IL,IN,2017.0,45,86,-41
LB,GB,2008.0,11,6,5
PL,FR,2011.0,30,50,-20
IN,CN,2013.0,142,140,2
KE,US,2013.0,61,62,-1
PK,GB,2014.0,83,159,-76
AT,CH,2020.0,145,122,23
BE,CO,2018.0,9,8,1
AM,RU,1998.0,5,4,1
SI,CH,2018.0,7,9,-2
MY,SG,2014.0,95,130,-35
CH,CN,2006.0,63,31,32
TZ,PH,2017.0,1,1,0
NZ,US,1998.0,127,174,-47
US,PA,2013.0,52,40,12
US,ID,2000.0,9,6,3
PH,CN,2009.0,25,22,3
RS,DE,2005.0,22,18,4
MY,NG,2021.0,80,66,14
ES,IL,1999.0,5,8,-3
MX,GB,2018.0,65,58,7
CY,JO,2020.0,4,2,2
JP,SA,2020.0,16,5,11
nan,PL,2020.0,32,18,14
CU,MX,1999.0,11,16,-5
CH,NO,2022.0,20,15,5
ID,SE,2021.0,8,7,1
IR,ID,2021.0,20,17,3
CH,TW,2019.0,8,16,-8
IT,DE,2000.0,126,111,15
PA,US,2002.0,6,14,-8
ID,FR,2021.0,20,35,-15
DE,NZ,2019.0,49,42,7
SG,FR,2014.0,24,40,-16
DK,EG,2010.0,3,1,2
NL,CA,2001.0,35,41,-6
RU,CN,2000.0,10,13,-3
BW,GB,2014.0,3,5,-2
KE,PE,2016.0,5,2,3
PL,PK,2022.0,10,5,5
HU,AU,2004.0,16,6,10
EE,IL,2020.0,2,1,1
TN,QA,2020.0,13,5,8
SE,IT,2017.0,61,94,-33
RU,KR,2018.0,21,37,-16
FR,ID,2017.0,59,15,44
AM,US,2014.0,11,7,4
PH,GB,2014.0,17,19,-2
FR,ZW,2016.0,2,2,0
NG,MW,2016.0,1,1,0
FR,RO,2003.0,25,30,-5
NP,JP,2009.0,8,12,-4
KR,AT,2016.0,4,1,3
SG,IT,2009.0,3,5,-2
EG,IT,2007.0,8,6,2
ET,PR,2014.0,6,6,0
CU,GB,2009.0,5,1,4
ES,LT,2021.0,1,1,0
CA,TR,2022.0,20,24,-4
NZ,US,1997.0,95,116,-21
CO,PT,2008.0,7,5,2
CZ,ES,2015.0,6,37,-31
KR,ET,1998.0,42,59,-17
DE,LU,2006.0,16,8,8
EG,ID,2011.0,3,3,0
ID,CZ,2013.0,3,4,-1
IN,RW,2014.0,9,6,3
RO,CZ,2002.0,2,2,0
NZ,NL,2005.0,9,13,-4
GR,PL,2014.0,6,9,-3
SI,DE,2016.0,16,18,-2
IL,JP,2001.0,8,12,-4
CZ,SI,2014.0,9,9,0
IT,EG,2013.0,6,8,-2
SG,ES,2011.0,5,9,-4
GH,CN,2012.0,4,5,-1
RS,MK,2020.0,4,6,-2
ID,nan,2006.0,1,3,-2
GB,BG,2016.0,15,12,3
IT,MX,2001.0,15,13,2
PH,FR,2019.0,9,11,-2
AE,BD,2018.0,2,2,0
SG,JP,1998.0,4,15,-11
PA,BR,2014.0,4,2,2
LV,US,2016.0,3,8,-5
CW,DE,2021.0,2,2,0
MX,JP,2016.0,6,13,-7
UA,AT,2019.0,7,6,1
JO,FR,2011.0,5,2,3
RW,IT,2019.0,1,1,0
BR,ID,2014.0,13,8,5
CO,RO,2013.0,1,1,0
IT,CY,2018.0,3,2,1
TW,ZA,2019.0,5,1,4
HU,PH,2019.0,1,1,0
SG,PK,2011.0,5,1,4
DK,QA,2008.0,1,1,0
HU,PT,2007.0,3,1,2
ES,ET,2013.0,2,1,1
US,LT,2006.0,10,4,6
BE,MX,2011.0,8,13,-5
RS,GB,2021.0,11,16,-5
MN,US,2021.0,1,3,-2
IL,NL,2008.0,14,7,7
LK,GB,1998.0,2,6,-4
KH,KR,2016.0,1,2,-1
IE,DK,2022.0,5,8,-3
JP,GH,2012.0,4,1,3
NL,GA,2021.0,5,5,0
TW,IL,2015.0,4,1,3
ID,MA,2021.0,7,2,5
DE,ID,1999.0,3,1,2
DO,CL,2013.0,3,2,1
IL,CZ,2007.0,2,1,1
PL,FI,2016.0,6,9,-3
GA,NL,2011.0,2,2,0
BA,US,2007.0,3,7,-4
BD,CO,2018.0,1,2,-1
CH,LK,2004.0,2,1,1
CA,CZ,2001.0,4,5,-1
CZ,CL,2010.0,1,2,-1
CH,SI,2016.0,5,19,-14
RS,CZ,2002.0,3,11,-8
CN,VG,2013.0,1,2,-1
ZW,LS,2020.0,1,1,0
RU,PK,2012.0,2,1,1
ZA,LY,2016.0,1,1,0
BF,ML,2004.0,1,1,0
HK,CA,2013.0,3,7,-4
NO,NP,2013.0,2,3,-1
GA,FR,2023.0,1,1,0
EG,TW,2009.0,5,2,3
CR,CN,2016.0,4,2,2
NL,SY,2021.0,1,1,0
NG,QA,2019.0,2,1,1
AO,ES,2013.0,1,1,0
DK,KE,2020.0,1,4,-3
FR,UY,1997.0,2,1,1
DE,TH,2000.0,3,1,2
CA,SK,2011.0,6,4,2
CH,KE,2000.0,1,4,-3
BH,EG,2016.0,1,5,-4
NO,BR,2000.0,3,7,-4
CY,IR,2013.0,1,4,-3
ZA,GR,2022.0,2,2,0
NO,SG,2002.0,1,1,0
VE,DK,2014.0,1,1,0
CA,DE,2015.0,262,271,-9
FR,IE,2020.0,33,42,-9
MX,GT,2022.0,16,7,9
DE,PK,2018.0,43,28,15
JP,HR,2014.0,3,2,1
AT,SE,2000.0,6,4,2
CZ,NL,2002.0,7,6,1
BY,IN,2020.0,4,11,-7
MX,IL,1998.0,2,1,1
AR,CN,2004.0,2,2,0
ET,QA,2021.0,1,2,-1
MY,,2022.0,6299,0,6299
RU,,2023.0,60150,0,60150
,DE,2011.0,21206,0,21206
PK,,2013.0,227,0,227
CZ,,2016.0,1495,0,1495
,KR,2008.0,5833,0,5833
CR,,2015.0,112,0,112
,BR,2000.0,9087,0,9087
PE,,2021.0,1361,0,1361
,GB,1995.0,28419,0,28419
,JP,2003.0,16640,0,16640
,NZ,1996.0,1100,0,1100
JP,,2011.0,10319,0,10319
,SE,1996.0,4117,0,4117
,AU,2006.0,6157,0,6157
FI,,2022.0,3951,0,3951
,SE,2004.0,3204,0,3204
nan,,2018.0,740,0,740
,HU,2003.0,1305,0,1305
DK,,2000.0,314,0,314
,LV,1994.0,252,0,252
,MY,2015.0,4447,0,4447
,BO,2012.0,46,0,46
,NZ,2004.0,1047,0,1047
DE,,2025.0,8935,0,8935
LK,,2017.0,267,0,267
,LK,2000.0,108,0,108
AT,,2018.0,2160,0,2160
SE,,2018.0,3071,0,3071
CA,,1998.0,1849,0,1849
AE,NL,2021.0,3,0,3
VN,PF,2021.0,1,0,1
CO,,2016.0,1060,0,1060
IR,,2013.0,1770,0,1770
,BI,2001.0,6,0,6
,GR,2007.0,2898,0,2898
PA,GT,2002.0,1,0,1
,MX,2014.0,5525,0,5525
ID,,2012.0,159,0,159
ZM,,2019.0,80,0,80
,TW,2020.0,273,0,273
,IQ,2013.0,707,0,707
,PA,2017.0,72,0,72
,PH,1997.0,305,0,305
NC,,2023.0,60,0,60
VN,,2013.0,77,0,77
LT,,2023.0,2669,0,2669
NE,,2022.0,160,0,160
HU,,2001.0,268,0,268
,BZ,2006.0,3,0,3
,UZ,2003.0,111,0,111
BY,,2017.0,248,0,248
,BY,2014.0,322,0,322
,CH,2018.0,3351,0,3351
BY,,2019.0,332,0,332
,BW,2013.0,83,0,83
AM,,2021.0,216,0,216
LK,,2019.0,366,0,366
CN,JO,2010.0,3,0,3
,GE,2017.0,204,0,204
VN,KR,2001.0,5,0,5
BY,,2010.0,171,0,171
,MG,2011.0,83,0,83
,BG,2009.0,445,0,445
PL,SK,2003.0,2,0,2
GE,,2021.0,279,0,279
TJ,,2022.0,77,0,77
,MW,2013.0,92,0,92
TR,,1999.0,177,0,177
,LU,2011.0,131,0,131
,PH,1998.0,254,0,254
,JM,2010.0,54,0,54
,IS,2003.0,91,0,91
CH,LT,2011.0,2,0,2
EE,,2008.0,66,0,66
TG,,2020.0,64,0,64
,GP,2014.0,34,0,34
IN,SV,2012.0,2,0,2
,BF,2006.0,82,0,82
,GE,2010.0,233,0,233
LV,,2003.0,33,0,33
CU,,2003.0,43,0,43
PR,,2006.0,2,0,2
,AM,2007.0,130,0,130
LK,,2010.0,59,0,59
,FJ,2010.0,29,0,29
,LI,2014.0,5,0,5
,PA,2010.0,84,0,84
nan,IQ,2011.0,1,0,1
,SN,1995.0,86,0,86
KH,GB,2000.0,2,0,2
GL,,2022.0,10,0,10
DK,XK,2020.0,1,0,1
UY,,2008.0,38,0,38
,AG,2018.0,62,0,62
SA,HU,2020.0,4,0,4
CI,NE,2015.0,1,0,1
BW,,2004.0,7,0,7
JM,,2003.0,9,0,9
,AE,2018.0,538,0,538
AO,CN,2011.0,3,0,3
,FJ,2017.0,37,0,37
FR,HT,2017.0,2,0,2
GA,,2022.0,58,0,58
MY,QA,2019.0,18,0,18
,HK,2002.0,24,0,24
,DK,2020.0,206,0,206
,GE,2019.0,76,0,76
SI,IL,2004.0,1,0,1
DO,,2018.0,26,0,26
IL,,2006.0,858,0,858
,HK,2005.0,49,0,49
EC,,2012.0,43,0,43
,GH,2012.0,564,0,564
OM,,2006.0,23,0,23
,NI,2014.0,51,0,51
ID,NP,2017.0,1,0,1
KE,MZ,2019.0,1,0,1
IN,NL,2023.0,4,0,4
KZ,,2003.0,16,0,16
MK,CN,2020.0,4,0,4
,BH,2007.0,41,0,41
,MZ,1997.0,30,0,30
,VG,2007.0,17,0,17
ZM,,2017.0,37,0,37
NE,SN,2018.0,1,0,1
LT,BR,2019.0,3,0,3
,QA,1995.0,28,0,28
,GA,2007.0,24,0,24
GL,SE,2007.0,1,0,1
PF,,2018.0,9,0,9
BH,JM,2020.0,1,0,1
KG,,2016.0,7,0,7
MN,CZ,2021.0,2,0,2
,MM,1995.0,11,0,11
HR,nan,2003.0,1,0,1
SY,TN,2004.0,1,0,1
TZ,SE,2014.0,5,0,5
,TG,2011.0,67,0,67
GD,,1999.0,2,0,2
MK,GR,2022.0,1,0,1
MM,MY,2010.0,1,0,1
US,CV,2020.0,2,0,2
,CG,2017.0,53,0,53
TW,MM,1999.0,1,0,1
,BB,2006.0,12,0,12
PT,SA,1999.0,1,0,1
PS,,2014.0,24,0,24
ET,IL,2015.0,1,0,1
,VA,2015.0,1,0,1
GH,MW,2021.0,1,0,1
,JM,2017.0,27,0,27
LK,ID,2013.0,4,0,4
,CL,2020.0,53,0,53
SO,,2023.0,13,0,13
SC,,2024.0,13,0,13
,PA,2019.0,36,0,36
OM,BD,2012.0,1,0,1
,CG,2019.0,23,0,23
KZ,ZW,2018.0,1,0,1
FI,TZ,2019.0,2,0,2
,TJ,2002.0,11,0,11
BY,IL,2018.0,3,0,3
,XK,2008.0,77,0,77
GB,KN,2009.0,1,0,1
DZ,SD,2016.0,2,0,2
AZ,IR,2010.0,4,0,4
GE,IL,2011.0,2,0,2
UA,CA,2006.0,8,0,8
AR,SI,2010.0,2,0,2
BY,GB,1997.0,2,0,2
MX,MY,2006.0,1,0,1
BD,LS,2012.0,1,0,1
CY,TR,1997.0,2,0,2
YE,,2007.0,8,0,8
GF,FR,1998.0,4,0,4
EG,ZA,2009.0,1,0,1
PT,VE,1998.0,2,0,2
MY,QA,2010.0,3,0,3
NZ,EC,2014.0,2,0,2
,BN,1994.0,15,0,15
HU,MY,2014.0,1,0,1
SJ,SE,2011.0,1,0,1
NL,BO,2013.0,1,0,1
PT,HR,2014.0,4,0,4
DO,US,2007.0,1,0,1
VG,CN,1998.0,1,0,1
BZ,CO,2017.0,1,0,1
,NC,1997.0,7,0,7
ML,,2014.0,13,0,13
CN,TG,2013.0,1,0,1
SN,BR,2003.0,1,0,1
EC,NZ,2020.0,2,0,2
NZ,GH,2022.0,1,0,1
CI,PL,2020.0,1,0,1
,DO,2006.0,11,0,11
CH,KH,2003.0,1,0,1
BA,DK,2014.0,1,0,1
JP,TZ,2003.0,3,0,3
US,PG,2019.0,3,0,3
CI,US,2004.0,4,0,4
LA,,2011.0,1,0,1
,HT,2016.0,10,0,10
AT,VN,2002.0,1,0,1
PA,,2014.0,31,0,31
,MZ,1998.0,38,0,38
CY,,2011.0,35,0,35
NO,TZ,2001.0,2,0,2
VN,BR,2008.0,1,0,1
PL,MN,2014.0,4,0,4
AU,MN,2012.0,1,0,1
MY,MX,2007.0,2,0,2
RW,AU,2020.0,1,0,1
nan,IE,2010.0,3,0,3
BG,PL,2004.0,10,0,10
PH,FI,2009.0,1,0,1
NO,KE,2008.0,2,0,2
,SJ,2005.0,3,0,3
CN,SL,2015.0,2,0,2
JO,BD,2014.0,2,0,2
SE,SD,2001.0,2,0,2
QA,TN,2004.0,1,0,1
UG,ZM,2009.0,1,0,1
SE,BD,2000.0,3,0,3
,RE,2001.0,9,0,9
CI,BJ,2006.0,2,0,2
GB,BH,2003.0,2,0,2
DE,QA,2007.0,4,0,4
,GN,2006.0,7,0,7
LY,,2012.0,17,0,17
RO,CN,1999.0,1,0,1
KR,BR,2001.0,2,0,2
ID,MY,2003.0,2,0,2
AT,KW,1998.0,1,0,1
BE,CR,2008.0,1,0,1
ZM,,2010.0,16,0,16
BJ,,2006.0,8,0,8
SG,GR,2002.0,3,0,3
AT,BR,1997.0,2,0,2
RU,BD,2009.0,1,0,1
IN,JO,2008.0,3,0,3
SI,FI,2007.0,2,0,2
NO,LV,2010.0,1,0,1
AR,SI,2017.0,1,0,1
MX,TR,2000.0,2,0,2
GI,CA,2005.0,1,0,1
AR,BD,2006.0,1,0,1
PT,HN,2015.0,2,0,2
DE,BF,2020.0,3,0,3
CY,IN,2012.0,3,0,3
IE,AR,2002.0,2,0,2
,TJ,2005.0,19,0,19
VE,FI,1999.0,1,0,1
HT,,2020.0,15,0,15
KR,ZW,2002.0,1,0,1
MX,RE,2018.0,1,0,1
CL,SK,2017.0,1,0,1
,GF,1999.0,9,0,9
,JM,2019.0,13,0,13
ES,BG,2019.0,1,0,1
LB,UA,2018.0,1,0,1
,CG,2010.0,37,0,37
JP,TG,2016.0,1,0,1
GM,,1999.0,3,0,3
RE,,2006.0,4,0,4
PR,MX,2007.0,1,0,1
BR,AG,2018.0,2,0,2
IN,VN,2010.0,1,0,1
SD,CA,2004.0,1,0,1
DK,CR,2013.0,1,0,1
TW,nan,2004.0,4,0,4
ES,TG,2020.0,1,0,1
,FJ,2019.0,20,0,20
,NC,1998.0,10,0,10
BS,JM,2018.0,1,0,1
AL,FR,2014.0,4,0,4
MK,KW,2018.0,1,0,1
MK,,2013.0,35,0,35
PG,CA,2020.0,1,0,1
PE,CZ,2008.0,1,0,1
AZ,UZ,2012.0,2,0,2
,RW,1999.0,3,0,3
NC,NZ,2019.0,1,0,1
NZ,RS,2007.0,1,0,1
BR,BJ,2004.0,1,0,1
MD,LU,2007.0,1,0,1
RO,MX,2013.0,1,0,1
BN,PK,1999.0,1,0,1
CR,PT,2006.0,3,0,3
KW,DE,1999.0,2,0,2
CA,BN,2014.0,1,0,1
GL,CH,2019.0,1,0,1
ST,US,2008.0,1,0,1
IL,MX,2005.0,2,0,2
IN,AM,1998.0,1,0,1
GW,NP,2010.0,1,0,1
AU,MU,2003.0,1,0,1
JO,MY,2005.0,3,0,3
TN,BD,2013.0,1,0,1
PK,IR,2000.0,1,0,1
CH,MM,2017.0,1,0,1
FK,GB,2011.0,3,0,3
IL,MX,2002.0,3,0,3
IE,PK,2003.0,3,0,3
PH,NZ,2015.0,5,0,5
IQ,KZ,2018.0,1,0,1
BH,JP,2022.0,3,0,3
KR,CL,2001.0,1,0,1
OM,IE,2000.0,1,0,1
LR,,2014.0,3,0,3
GB,BO,2011.0,1,0,1
MD,KZ,2020.0,1,0,1
BE,NC,2012.0,1,0,1
NO,LB,2019.0,1,0,1
UZ,KZ,2006.0,1,0,1
AR,NO,2021.0,1,0,1
RU,NZ,2011.0,7,0,7
NL,NZ,1997.0,3,0,3
UZ,PH,2014.0,1,0,1
ZW,AU,2016.0,3,0,3
,SJ,2002.0,3,0,3
FR,CL,2023.0,2,0,2
GW,NP,2019.0,2,0,2
SK,UG,2013.0,1,0,1
BE,TZ,2006.0,3,0,3
LU,LB,2018.0,1,0,1
US,MS,2018.0,1,0,1
LK,ZA,2004.0,1,0,1
SE,LB,2022.0,2,0,2
CL,PH,1999.0,1,0,1
LT,IN,2008.0,1,0,1
ZM,BI,2012.0,1,0,1
UA,ID,2021.0,1,0,1
MD,TH,2013.0,1,0,1
AT,LU,2008.0,2,0,2
BY,AU,2012.0,2,0,2
SE,LK,2022.0,1,0,1
RW,CD,2017.0,1,0,1
HR,GB,2023.0,1,0,1
EE,TW,2005.0,1,0,1
UA,FI,2001.0,3,0,3
TN,CI,2004.0,1,0,1
TR,NZ,2010.0,2,0,2
LY,EG,2003.0,1,0,1
CZ,AE,2016.0,2,0,2
GW,,2018.0,7,0,7
SD,,1999.0,4,0,4
CG,TG,2017.0,1,0,1
TW,DK,2013.0,4,0,4
BI,BD,2017.0,1,0,1
RS,BY,2017.0,1,0,1
ET,ZW,2015.0,1,0,1
DE,CY,2006.0,4,0,4
CM,,2000.0,2,0,2
MK,TH,2018.0,1,0,1
TH,IE,2009.0,1,0,1
AT,VN,2005.0,1,0,1
LS,ZA,2007.0,2,0,2
BD,HR,2017.0,1,0,1
CA,JM,1997.0,2,0,2
CH,PG,2016.0,1,0,1
IE,AO,2013.0,1,0,1
YE,AU,2018.0,1,0,1
OM,JP,2022.0,1,0,1
IR,MK,2011.0,5,0,5
MK,CZ,2017.0,2,0,2
CD,RW,2020.0,2,0,2
IR,FR,1997.0,1,0,1
TD,ET,2013.0,1,0,1
JO,BR,2007.0,1,0,1
NZ,NO,2001.0,2,0,2
LA,UZ,2002.0,1,0,1
NO,VE,2001.0,1,0,1
JP,ZM,2006.0,1,0,1
ZA,SS,2005.0,1,0,1
GB,ZM,2000.0,3,0,3
KR,DK,2001.0,2,0,2
TT,DE,2012.0,1,0,1
BA,IE,2010.0,1,0,1
KG,US,2000.0,1,0,1
RU,MZ,1998.0,2,0,2
BY,VN,2016.0,1,0,1
SE,PA,2007.0,1,0,1
KW,BA,2021.0,1,0,1
GL,AT,2019.0,1,0,1
TR,SD,2009.0,2,0,2
SI,MK,2018.0,2,0,2
IN,LB,2007.0,1,0,1
GB,BA,2012.0,2,0,2
PL,NG,2016.0,2,0,2
SA,BR,2005.0,1,0,1
MY,KZ,2016.0,4,0,4
LK,SY,2016.0,1,0,1
IR,NG,2007.0,1,0,1
MX,BG,2016.0,1,0,1
BE,IQ,2020.0,1,0,1
US,GF,1998.0,2,0,2
CD,BJ,2022.0,2,0,2
BD,KZ,2015.0,2,0,2
DO,MT,2016.0,1,0,1
CH,OM,2015.0,1,0,1
AR,RO,2021.0,1,0,1
GE,SE,2016.0,2,0,2
LT,SK,2010.0,1,0,1
SD,AE,2023.0,1,0,1
RE,PF,2022.0,1,0,1
FI,NI,2011.0,1,0,1
TT,BB,2021.0,1,0,1
,SO,2016.0,3,0,3
PL,IS,2016.0,3,0,3
IT,ML,2000.0,1,0,1
BY,NI,2013.0,1,0,1
TH,KE,2002.0,1,0,1
KW,MY,2003.0,1,0,1
TN,DJ,2016.0,1,0,1
PG,TN,2020.0,3,0,3
CA,AM,2008.0,1,0,1
TN,KW,2013.0,1,0,1
RS,BG,2021.0,2,0,2
SV,CO,2004.0,1,0,1
PG,VU,2020.0,2,0,2
CR,AR,2002.0,1,0,1
TW,ES,2000.0,3,0,3
PK,CL,2002.0,1,0,1
IS,AU,2002.0,1,0,1
HK,AE,2017.0,1,0,1
VE,ZA,2003.0,1,0,1
UA,BE,2002.0,2,0,2
CW,SK,2016.0,1,0,1
KW,SY,2015.0,1,0,1
MY,GM,2016.0,1,0,1
PL,CL,2007.0,2,0,2
DO,IN,2018.0,2,0,2
GB,GN,2013.0,1,0,1
DO,GB,2016.0,1,0,1
GM,CA,1997.0,1,0,1
HN,KR,2012.0,1,0,1
LB,SA,2002.0,1,0,1
PH,LB,2010.0,1,0,1
ZW,RU,1999.0,4,0,4
TH,RS,2010.0,1,0,1
MZ,GR,2012.0,1,0,1
ET,BD,2017.0,1,0,1
BR,TG,2011.0,1,0,1
CA,GM,2002.0,1,0,1
GE,CA,2019.0,3,0,3
PH,ZA,2016.0,2,0,2
,KN,2011.0,3,0,3
nan,MC,2017.0,1,0,1
IT,GE,2005.0,1,0,1
JM,NZ,2012.0,1,0,1
ES,ST,2003.0,1,0,1
UA,LT,2013.0,1,0,1
MA,SK,2019.0,1,0,1
BD,ET,2018.0,2,0,2
BG,LV,2022.0,1,0,1
KZ,ET,2015.0,1,0,1
SZ,EG,2021.0,1,0,1
LB,ZA,2020.0,1,0,1
AM,TH,2021.0,1,0,1
MY,BN,2004.0,2,0,2
FR,AE,2003.0,1,0,1
BY,PL,2021.0,3,0,3
IL,MM,2017.0,1,0,1
TT,LY,2011.0,1,0,1
BW,CA,1998.0,1,0,1
NG,SA,1998.0,4,0,4
TW,BG,2005.0,3,0,3
MM,,2003.0,2,0,2
NL,VN,2001.0,1,0,1
PG,IN,2001.0,1,0,1
,SC,1994.0,2,0,2
GE,AR,2003.0,1,0,1
GB,AO,1999.0,1,0,1
IN,CI,2021.0,1,0,1
JO,SE,2009.0,1,0,1
AT,AE,2016.0,1,0,1
BE,CL,2002.0,1,0,1
TW,CZ,2001.0,2,0,2
SA,LU,2022.0,1,0,1
CR,TT,2009.0,1,0,1
TL,,2024.0,6,0,6
DK,TW,2011.0,1,0,1
DZ,CL,2010.0,1,0,1
SE,RW,2008.0,1,0,1
BJ,KE,2009.0,1,0,1
SE,AX,2015.0,1,0,1
,WS,1999.0,1,0,1
FR,BZ,2014.0,1,0,1
CG,DE,1999.0,1,0,1
AR,GT,2002.0,1,0,1
TH,IT,2004.0,2,0,2
ZW,NZ,1998.0,1,0,1
LB,IT,1999.0,1,0,1
NL,XK,2008.0,3,0,3
CD,CA,2011.0,1,0,1
DE,MK,2007.0,2,0,2
BE,GM,1998.0,1,0,1
CA,DJ,2008.0,1,0,1
SK,MY,2012.0,1,0,1
AM,PH,2011.0,1,0,1
NZ,TR,2003.0,2,0,2
CI,AU,2021.0,1,0,1
,MR,2000.0,2,0,2
NL,MQ,2019.0,1,0,1
MY,KH,2015.0,1,0,1
KW,VN,2020.0,1,0,1
FI,UG,2015.0,1,0,1
ID,BE,2001.0,1,0,1
ES,EE,2013.0,3,0,3
GB,MM,2010.0,1,0,1
PT,TJ,2021.0,1,0,1
HN,,2001.0,3,0,3
AM,UG,2021.0,1,0,1
nan,TH,2000.0,1,0,1
CZ,BN,2008.0,1,0,1
PK,PE,2014.0,1,0,1
IN,GT,2020.0,1,0,1
AF,CH,2018.0,1,0,1
LK,ET,2016.0,2,0,2
FI,AM,2019.0,1,0,1
IE,BD,1998.0,1,0,1
CZ,HK,2017.0,1,0,1
MX,PK,2000.0,1,0,1
GB,CG,2021.0,2,0,2
NG,BF,1999.0,1,0,1
TR,BY,2003.0,1,0,1
GB,YE,2009.0,2,0,2
BG,JP,1997.0,5,0,5
ZW,DK,2002.0,1,0,1
LY,JP,2014.0,2,0,2
DE,PG,2016.0,1,0,1
CR,MT,2009.0,1,0,1
CL,HU,1998.0,1,0,1
BJ,MG,2002.0,1,0,1
BE,SN,2013.0,1,0,1
SK,VN,2019.0,1,0,1
GE,CO,2021.0,1,0,1
HN,CO,2001.0,1,0,1
RU,CL,1997.0,1,0,1
SA,KY,2010.0,1,0,1
RU,SA,2017.0,2,0,2
PG,NZ,2008.0,1,0,1
AT,LV,1997.0,1,0,1
CH,RE,2011.0,2,0,2
DE,MW,2009.0,1,0,1
ST,CH,2009.0,1,0,1
EC,GR,2018.0,1,0,1
SY,QA,2005.0,1,0,1
JP,KP,2018.0,3,0,3
RU,PE,2012.0,1,0,1
AF,EG,2010.0,1,0,1
ME,HR,2000.0,1,0,1
ES,IQ,2020.0,2,0,2
GE,FR,2011.0,2,0,2
MX,SV,1999.0,1,0,1
,CR,2020.0,6,0,6
NL,OM,2002.0,1,0,1
TZ,GH,2002.0,1,0,1
GW,US,2000.0,1,0,1
MN,IL,2019.0,1,0,1
FR,BW,2020.0,1,0,1
LB,SA,2005.0,2,0,2
LK,CH,2007.0,1,0,1
BN,NG,2019.0,1,0,1
IT,ID,1998.0,1,0,1
IQ,TW,2011.0,1,0,1
UG,JP,2012.0,1,0,1
IS,BE,2001.0,1,0,1
FJ,KR,2012.0,1,0,1
IN,QA,2007.0,2,0,2
CR,CH,2011.0,2,0,2
VG,IN,2000.0,1,0,1
RS,EG,2019.0,1,0,1
GE,AT,2004.0,1,0,1
IQ,GR,2021.0,1,0,1
CH,SA,2003.0,1,0,1
MY,LA,2022.0,1,0,1
PY,UY,2010.0,1,0,1
GB,MO,2001.0,1,0,1
EE,BA,2008.0,1,0,1
SI,GR,2005.0,2,0,2
TZ,MW,2012.0,1,0,1
JP,CW,2003.0,1,0,1
VN,PR,2004.0,1,0,1
SA,NP,2011.0,1,1,0
DE,IR,1998.0,2,1,1
CM,BR,2016.0,2,3,-1
LB,nan,2013.0,1,1,0
ZA,HK,2004.0,1,1,0
BA,IE,2019.0,1,1,0
TH,ZA,2019.0,1,3,-2
ET,EG,2012.0,2,3,-1
DE,BY,2022.0,4,3,1
US,PG,2017.0,2,1,1
NO,LV,2019.0,1,3,-2
UG,ET,2021.0,2,2,0
GE,CA,2017.0,3,2,1
TW,BD,2007.0,1,1,0
HR,BA,2003.0,3,2,1
US,TJ,2013.0,1,1,0
ES,ID,2022.0,4,9,-5
UA,VN,2019.0,2,3,-1
TR,AZ,2006.0,3,6,-3
PS,MY,2021.0,2,8,-6
US,LR,2008.0,1,1,0
VN,RU,2008.0,1,1,0
DK,RU,2002.0,4,7,-3
BG,JP,1998.0,3,1,2
JP,BY,2003.0,1,2,-1
AU,AR,2009.0,2,5,-3
JP,UG,2022.0,1,1,0
ES,BO,2004.0,4,3,1
PE,PT,2011.0,2,4,-2
US,MN,2007.0,1,3,-2
NO,CL,2019.0,2,3,-1
TR,NZ,2017.0,3,3,0
PA,FR,2008.0,1,1,0
TR,RU,2002.0,2,3,-1
IE,MK,2019.0,1,1,0
ML,BE,2020.0,1,1,0
AL,US,2008.0,1,2,-1
US,BS,2009.0,2,2,0
PT,IR,2011.0,1,7,-6
CG,BJ,2005.0,1,1,0
AT,CU,2017.0,1,1,0
AU,UG,2016.0,2,5,-3
CZ,IR,2017.0,2,4,-2
AR,BR,2023.0,2,6,-4
GT,BR,2015.0,2,1,1
ID,BD,2002.0,1,1,0
SN,ZA,2016.0,1,1,0
ZM,AU,2016.0,1,1,0
MW,TZ,2008.0,1,1,0
VN,BE,2010.0,2,5,-3
MA,BR,2007.0,1,3,-2
LA,JP,2018.0,2,2,0
DE,UY,2004.0,1,2,-1
EG,HU,2001.0,1,3,-2
GH,CH,2014.0,1,5,-4
KR,UG,2020.0,2,2,0
ET,KE,2007.0,1,2,-1
GE,US,2023.0,2,6,-4
MX,CG,2009.0,1,1,0
TH,ZA,2017.0,1,2,-1
CA,BW,2013.0,2,1,1
BJ,SN,2021.0,1,3,-2
KW,AE,2007.0,1,6,-5
GB,PS,2008.0,1,2,-1
CL,IE,2004.0,1,1,0
UG,GB,2000.0,2,3,-1
LT,SI,2017.0,1,2,-1
HU,NO,2009.0,1,1,0
BI,BJ,2005.0,1,1,0
UZ,DE,2017.0,1,2,-1
SK,SE,2010.0,2,5,-3
BR,SI,2008.0,1,1,0
UA,UZ,2005.0,2,1,1
PT,HU,2004.0,1,1,0
ES,RS,2013.0,1,3,-2
TZ,KE,2006.0,1,2,-1
DK,GW,1998.0,1,1,0
nan,DE,2023.0,3,3,0
FR,UG,2022.0,2,1,1
AO,US,2010.0,1,1,0
CZ,CL,2019.0,1,3,-2
AU,DZ,2018.0,1,2,-1
BE,LB,2010.0,2,1,1
GB,XK,2016.0,1,1,0
ID,IE,2011.0,1,1,0
CU,HU,2019.0,1,1,0
AT,SG,2006.0,1,1,0
AT,TH,2018.0,2,6,-4
CN,EE,2019.0,1,2,-1
LT,LV,2022.0,1,1,0
ML,NE,2022.0,1,1,0
BR,AF,2015.0,2,3,-1
MK,FR,2000.0,1,1,0
GB,EG,2023.0,2,6,-4
DK,MY,2022.0,1,1,0
CY,TR,1998.0,1,3,-2
CG,SN,2007.0,2,1,1
NG,FR,1999.0,1,1,0
LI,DE,2016.0,1,1,0
MT,CA,2003.0,1,2,-1
BB,AU,2008.0,1,1,0
BJ,GB,2006.0,2,1,1
MA,LB,2021.0,1,1,0
BG,AE,2016.0,1,1,0
MY,TR,2006.0,1,2,-1
LU,ZA,2012.0,1,1,0
LU,JP,2011.0,1,2,-1
AT,BG,2002.0,1,1,0
HU,BE,1997.0,1,6,-5
IS,NL,2016.0,2,2,0
CO,ID,2013.0,1,1,0
VN,MK,2017.0,2,2,0
GB,MC,2016.0,1,2,-1
KR,GE,2006.0,1,2,-1
ZA,BF,2014.0,1,1,0
GT,GB,2013.0,1,1,0
LV,SE,2006.0,1,5,-4
IL,CL,2011.0,2,3,-1
BY,LV,2002.0,1,1,0
CA,JM,1998.0,1,1,0
UG,CA,2003.0,1,1,0
TZ,KR,2019.0,1,1,0
KG,ID,2019.0,1,1,0
KR,SG,1997.0,1,7,-6
NZ,GR,2016.0,1,1,0
MY,IQ,2008.0,1,1,0
LT,EE,2017.0,1,1,0
PH,TR,2014.0,1,1,0
IT,CU,2020.0,1,5,-4
NA,US,2020.0,1,7,-6
CZ,GE,2022.0,2,1,1
VE,GT,2020.0,1,2,-1
RU,ES,2023.0,1,2,-1
FI,TZ,2010.0,1,2,-1
PE,JP,2017.0,1,4,-3
QA,KR,2016.0,2,8,-6
BR,EC,2002.0,1,1,0
EC,AU,2022.0,4,2,2
RS,ME,2002.0,1,2,-1
CZ,RO,2005.0,1,3,-2
IN,SK,2016.0,1,4,-3
LU,RU,2021.0,1,4,-3
CN,MG,2007.0,2,1,1
SE,IL,2008.0,3,2,1
VN,TH,2013.0,1,5,-4
DK,UA,2009.0,2,1,1
ZA,FI,2022.0,3,2,1
MX,SA,2016.0,2,1,1
KE,CM,2014.0,1,2,-1
BD,HR,2019.0,1,1,0
TZ,ZM,2020.0,1,2,-1
FI,EG,2020.0,1,3,-2
GI,GB,2021.0,1,0,1
JM,ZA,2016.0,1,0,1
GF,,2005.0,1,0,1
NL,TT,2003.0,1,0,1
TL,AU,2012.0,1,0,1
AD,ES,2015.0,2,0,2
IN,BT,2014.0,3,0,3
MZ,GB,2015.0,1,0,1
GM,TR,2020.0,2,0,2
LT,AT,2002.0,1,0,1
AM,BR,2011.0,1,0,1
UZ,CN,2023.0,1,0,1
SZ,PK,2019.0,2,0,2
EG,KH,2020.0,2,0,2
GT,PY,2014.0,1,0,1
LS,ZW,2012.0,1,0,1
BO,,2001.0,3,0,3
CN,AE,2000.0,1,0,1
CA,AO,2017.0,1,0,1
SZ,ZA,2001.0,2,0,2
NA,,1999.0,2,0,2
OM,DZ,2019.0,1,0,1
CG,NC,2002.0,1,0,1
SE,PK,2001.0,2,0,2
CM,ZW,2006.0,1,0,1
NE,BE,2006.0,1,0,1
LS,US,2020.0,3,0,3
NG,TW,2018.0,2,0,2
AM,RU,1997.0,2,0,2
VG,DE,1997.0,1,0,1
FR,BA,2006.0,1,0,1
JM,AU,2011.0,1,0,1
IN,BN,2003.0,2,0,2
IT,TW,2005.0,3,0,3
KR,PY,2017.0,1,0,1
BT,SG,2006.0,1,0,1
IR,SA,2009.0,1,0,1
IE,MT,2018.0,1,0,1
NI,CZ,2021.0,1,0,1
BR,EE,2021.0,2,0,2
MY,TH,2005.0,1,0,1
AL,DE,2020.0,2,0,2
UY,PA,2011.0,1,0,1
NO,CL,2010.0,2,0,2
BJ,MG,2005.0,1,0,1
FI,LU,2005.0,3,0,3
CU,HU,2010.0,1,0,1
PL,QA,2014.0,1,0,1
PF,CG,2008.0,2,0,2
TH,KW,2016.0,1,0,1
LY,DE,2015.0,1,0,1
KR,RS,2017.0,1,0,1
DK,CO,2002.0,1,0,1
CY,PL,2010.0,1,0,1
CL,MY,2015.0,1,0,1
HU,MA,1998.0,1,0,1
IL,PT,2002.0,1,0,1
NG,SY,2005.0,1,0,1
MY,TH,2002.0,1,0,1
NO,LV,2017.0,1,0,1
GB,NC,2009.0,1,0,1
KE,CH,2023.0,1,0,1
CM,NL,1997.0,1,0,1
CM,BF,2013.0,1,0,1
HK,LK,2011.0,1,0,1
PT,EE,2017.0,2,0,2
NG,GD,2009.0,1,0,1
LA,UZ,2005.0,1,0,1
NE,LU,2020.0,1,0,1
FI,TZ,2017.0,2,0,2
CY,NO,2020.0,1,0,1
SG,AM,2006.0,1,0,1
VN,AZ,2021.0,1,0,1
MX,KE,2002.0,2,0,2
UA,IL,1997.0,1,0,1
nan,IS,2012.0,1,0,1
PL,MD,2002.0,1,0,1
TD,CG,2019.0,1,0,1
NI,FI,2015.0,1,0,1
IL,KZ,2021.0,1,0,1
SE,YE,2017.0,1,0,1
TZ,KR,2017.0,1,0,1
SY,HU,2015.0,1,0,1
KR,KW,2016.0,1,0,1
MX,DZ,2013.0,1,0,1
GT,,2025.0,3,0,3
LB,IQ,2011.0,1,0,1
SK,PA,2001.0,1,0,1
BD,MX,1997.0,1,0,1
TN,ZA,2001.0,1,0,1
JP,FJ,2015.0,1,0,1
VE,TW,2010.0,1,0,1
BI,BR,2012.0,1,0,1
AT,IQ,2009.0,1,0,1
MX,PE,2023.0,2,0,2
EG,CI,2019.0,1,0,1
BG,VN,2016.0,1,0,1
CY,SA,2006.0,1,0,1
OM,DZ,2017.0,1,0,1
PE,UY,2005.0,1,0,1
nan,LU,2011.0,1,0,1
KZ,TW,2022.0,1,0,1
MK,ID,2018.0,2,0,2
IQ,JO,2000.0,1,0,1
AU,SD,2004.0,1,0,1
NL,CM,2009.0,1,0,1
FJ,CA,2021.0,1,0,1
US,ME,2007.0,1,0,1
TG,TR,2012.0,1,0,1
KR,CM,2017.0,1,0,1
JP,VE,2005.0,1,0,1
CA,PR,2019.0,1,0,1
EE,GB,2023.0,1,0,1
GE,CA,2010.0,1,0,1
TR,MK,2022.0,1,0,1
NL,GE,2002.0,1,0,1
CR,AZ,2018.0,1,0,1
FI,GH,2012.0,1,0,1
BZ,US,1999.0,1,0,1
CO,GR,2011.0,1,0,1
ZW,NA,2018.0,1,0,1
MC,,2006.0,1,0,1
NZ,NA,2008.0,1,0,1
FR,MK,2019.0,1,0,1
,GL,2004.0,2,0,2
SG,TZ,2021.0,1,0,1
GB,FK,2000.0,1,0,1
VE,DO,2012.0,2,0,2
FR,PS,2000.0,1,0,1
RE,EG,2016.0,1,0,1
IE,NP,2011.0,1,0,1
CI,CH,2001.0,1,0,1
AT,KE,2009.0,1,0,1
BO,IT,2021.0,1,0,1
TD,DE,1997.0,1,0,1
RE,NZ,2008.0,1,0,1
SG,UG,2013.0,1,0,1
KZ,AL,2012.0,1,0,1
LU,AU,2003.0,1,0,1
VU,CG,2013.0,1,0,1
GB,CW,2015.0,1,0,1
IE,MK,2010.0,1,0,1
BG,AT,2011.0,1,0,1
NL,IQ,2015.0,1,0,1
FI,AE,2023.0,1,0,1
CG,,2005.0,2,0,2
QA,LY,2011.0,1,0,1
MT,QA,2018.0,1,0,1
BW,HR,2008.0,1,0,1
LS,DE,2007.0,1,0,1
AU,BO,2011.0,1,0,1
nan,EE,2020.0,1,0,1
KH,CO,2020.0,1,0,1
PH,PE,2023.0,1,0,1
TN,IQ,2016.0,2,0,2
KR,DZ,2019.0,1,0,1
BY,DK,1998.0,2,0,2
IE,BW,2014.0,1,0,1
DZ,CL,2019.0,1,0,1
DK,TH,2010.0,1,0,1
NG,LS,2006.0,1,0,1
DE,NC,2009.0,1,0,1
SA,UG,2021.0,1,0,1
DE,BB,2004.0,1,0,1
CA,MQ,2016.0,1,0,1
TN,CO,2020.0,1,0,1
MY,OM,1998.0,1,0,1
BN,IQ,2014.0,1,0,1
BW,KE,2011.0,1,0,1
EC,PT,2009.0,1,0,1
PR,GB,2009.0,1,0,1
PH,NO,2010.0,1,0,1
TW,GE,2013.0,1,0,1
TN,BF,2020.0,1,0,1
BD,OM,2023.0,1,0,1
UZ,PT,2001.0,1,0,1
IT,BA,2004.0,1,0,1
SE,FJ,2001.0,1,0,1
HU,GD,2007.0,1,0,1
ZM,CG,2018.0,1,0,1
DZ,GH,2022.0,1,0,1
NL,OM,2005.0,1,0,1
CM,DK,2004.0,1,0,1
UA,NZ,2008.0,1,0,1
SE,ZW,2000.0,1,0,1
TD,NG,2022.0,1,0,1
,BT,1998.0,1,0,1
NO,CO,2005.0,1,0,1
EE,MX,2014.0,1,0,1
ET,ZM,2020.0,1,0,1
CO,CZ,2005.0,1,0,1
AT,BF,2014.0,1,0,1
GR,EG,2004.0,1,0,1
ES,MK,2015.0,1,0,1
PT,SG,2007.0,1,0,1
UY,NO,2014.0,1,0,1
PT,TL,2020.0,1,0,1
,CF,2018.0,1,0,1
SA,MV,2021.0,1,0,1
RO,KR,2013.0,1,0,1
TZ,GA,2015.0,1,0,1
DZ,AR,2019.0,1,0,1
LT,SI,2019.0,1,0,1
KW,RU,2018.0,1,0,1
MX,ML,2010.0,1,0,1
NO,SK,2003.0,1,0,1
FR,DJ,2010.0,2,0,2
US,BF,1998.0,1,0,1
UG,SO,2020.0,1,0,1
LK,BD,2022.0,1,0,1
UY,CI,2017.0,1,0,1
KE,ZA,2015.0,22,22,0
MX,US,2017.0,459,487,-28
US,NO,2014.0,170,149,21
CN,TW,2022.0,708,723,-15
US,GB,2010.0,5395,5293,102
US,JP,2000.0,1586,1593,-7
CA,MY,2019.0,32,36,-4
CN,US,2011.0,5304,6996,-1692
TR,AG,2021.0,318,199,119
IN,US,2012.0,2002,2243,-241
CO,MX,2019.0,475,435,40
US,GB,2017.0,6108,6215,-107
DK,GB,2004.0,83,73,10
JP,US,1998.0,1414,1362,52
SG,CN,2016.0,507,481,26
ES,GB,2020.0,421,494,-73
US,CO,2006.0,157,114,43
JP,US,1997.0,1063,1127,-64
AU,CN,2009.0,227,236,-9
KR,CN,2006.0,219,165,54
IL,US,2014.0,538,461,77
JP,EC,2018.0,2,2,0
JP,BR,2013.0,47,43,4
US,SE,2017.0,526,539,-13
MX,US,2019.0,554,507,47
DE,US,2003.0,1903,1735,168
TW,US,2010.0,621,760,-139
JP,IT,2011.0,93,69,24
CA,IR,2019.0,179,434,-255
ES,NL,2014.0,109,79,30
AU,ZA,2014.0,62,79,-17
CL,CA,2008.0,10,15,-5
CN,SG,2009.0,360,317,43
US,FR,2022.0,629,713,-84
KR,US,2003.0,768,771,-3
US,AU,2002.0,1123,1302,-179
DK,US,2002.0,169,149,20
US,LB,2019.0,83,113,-30
DE,GB,2016.0,974,897,77
US,EG,2002.0,60,73,-13
BR,AU,2001.0,17,21,-4
PT,BR,2006.0,365,452,-87
AR,ES,2020.0,417,376,41
CH,KR,2009.0,19,12,7
MX,US,2010.0,292,321,-29
CA,ES,2005.0,43,46,-3
PK,IN,2021.0,348,354,-6
BR,ES,2015.0,375,454,-79
IT,NZ,2019.0,9,8,1
FR,MX,2014.0,70,55,15
BE,IN,2015.0,37,35,2
IN,nan,2003.0,7,9,-2
US,BE,2012.0,390,276,114
AT,ES,2015.0,24,42,-18
GB,BR,2012.0,176,149,27
IT,FR,2013.0,423,326,97
GB,MY,2011.0,163,52,111
TW,US,2017.0,802,649,153
ES,FR,2007.0,186,243,-57
GB,IL,1998.0,26,25,1
BE,IT,2016.0,112,184,-72
AU,JP,2000.0,37,37,0
US,AR,2011.0,219,241,-22
GB,CL,2015.0,48,40,8
JP,PH,2008.0,17,22,-5
GB,SE,2005.0,115,127,-12
JP,DE,2016.0,214,217,-3
BN,GB,2014.0,3,7,-4
ES,CA,2000.0,27,23,4
SD,BR,2011.0,10,9,1
PE,PA,2020.0,4,3,1
ES,DE,2010.0,193,205,-12
TW,AU,2020.0,35,51,-16
ZA,US,2003.0,188,181,7
DE,PH,2018.0,12,9,3
TW,US,2019.0,710,744,-34
ET,KR,2012.0,115,100,15
IN,NP,2022.0,67,64,3
JP,GB,2021.0,163,218,-55
DE,nan,2009.0,60,48,12
CL,ES,2018.0,379,493,-114
US,AU,2005.0,1555,1462,93
PL,US,2008.0,195,197,-2
IT,ES,2017.0,291,249,42
CA,IT,2020.0,120,159,-39
PK,AU,2022.0,33,29,4
US,SE,2010.0,364,366,-2
IT,GB,2020.0,657,586,71
US,NL,2001.0,391,348,43
US,EG,2005.0,100,81,19
BR,CH,2017.0,70,49,21
CA,IN,2020.0,259,270,-11
GB,FR,2008.0,485,532,-47
BR,DE,2017.0,247,262,-15
BR,DE,2010.0,168,174,-6
EG,CA,2003.0,12,14,-2
CZ,CN,2004.0,42,28,14
CO,MX,2010.0,163,178,-15
IT,ES,2010.0,247,155,92
BR,CA,2006.0,153,172,-19
BR,CH,2019.0,68,64,4
CH,GB,2015.0,330,307,23
ES,DE,2019.0,297,284,13
MX,VE,2007.0,39,34,5
SE,AU,2014.0,43,58,-15
JO,CA,2018.0,14,15,-1
AU,CA,2008.0,268,294,-26
JP,IN,2014.0,142,123,19
CA,IE,2012.0,160,137,23
AU,BR,2013.0,89,105,-16
DK,US,2005.0,164,175,-11
AU,MY,2016.0,129,143,-14
CN,JP,2014.0,410,560,-150
IT,ES,2019.0,295,303,-8
IN,GB,2009.0,322,307,15
BR,CL,2018.0,123,118,5
IE,US,2000.0,167,184,-17
EG,NZ,2022.0,1,1,0
BD,CH,2020.0,5,6,-1
CN,NL,2009.0,83,80,3
AU,LK,2017.0,28,34,-6
BD,CN,2016.0,94,58,36
IR,NO,2020.0,33,12,21
CA,CN,2022.0,437,304,133
SG,KR,2007.0,29,20,9
ES,DE,2017.0,272,244,28
BN,CN,2015.0,1,3,-2
EG,JP,2011.0,46,87,-41
US,SG,2007.0,206,255,-49
AR,CO,2006.0,34,23,11
GB,IE,2012.0,342,340,2
DE,TW,2003.0,15,20,-5
AU,NL,2016.0,101,142,-41
GB,BE,2006.0,93,95,-2
nan,SE,2018.0,80,25,55
DE,AU,2004.0,138,111,27
TR,KZ,2019.0,56,40,16
US,PL,2017.0,267,263,4
DE,HR,2007.0,14,18,-4
IT,MY,1998.0,25,13,12
KR,DE,2009.0,37,48,-11
US,SE,2019.0,533,573,-40
US,FJ,2021.0,2,2,0
PE,CO,2014.0,71,89,-18
CN,FI,2014.0,27,30,-3
JP,PL,1997.0,9,6,3
CN,nan,1999.0,12,8,4
DE,CA,2014.0,262,298,-36
RU,RS,2014.0,8,9,-1
JP,CN,1999.0,256,228,28
US,CH,2012.0,859,749,110
AT,HU,2010.0,29,27,2
FR,CZ,2002.0,12,14,-2
SG,CA,2016.0,56,37,19
IE,DE,2017.0,87,88,-1
NZ,FR,2010.0,16,14,2
IR,CN,2015.0,48,34,14
AT,BE,2014.0,15,15,0
IL,BR,2019.0,14,14,0
EG,SA,2011.0,262,102,160
JP,AU,2004.0,63,44,19
PT,US,2003.0,53,95,-42
BE,US,2009.0,241,261,-20
BR,CU,2007.0,15,19,-4
AU,FR,2012.0,106,159,-53
ID,CA,2017.0,37,46,-9
ET,BE,2012.0,3,2,1
FR,NL,2008.0,148,223,-75
CA,IR,2010.0,91,176,-85
BG,US,2004.0,29,26,3
SY,DE,2016.0,4,3,1
FR,BE,2018.0,380,355,25
IE,IT,2013.0,36,39,-3
PE,ES,2013.0,76,135,-59
IN,ZA,2014.0,61,56,5
HK,CN,2012.0,77,123,-46
MX,CN,2005.0,9,3,6
FR,CA,2001.0,265,219,46
HU,AT,2019.0,36,45,-9
nan,US,2018.0,307,313,-6
IN,RO,2010.0,83,18,65
IL,CN,2012.0,20,20,0
BE,ES,2008.0,49,43,6
JP,ID,2018.0,231,137,94
TN,FR,2000.0,26,43,-17
SG,DE,2007.0,12,31,-19
CA,nan,2000.0,10,6,4
DE,PL,2013.0,163,95,68
US,CL,2005.0,98,112,-14
ID,NL,2012.0,15,18,-3
FR,GP,2002.0,3,6,-3
FR,SG,2014.0,40,24,16
nan,BE,2005.0,38,15,23
NZ,CH,2013.0,16,20,-4
GB,PL,2017.0,124,134,-10
CR,BR,2007.0,5,1,4
GB,PL,2019.0,129,163,-34
KE,DE,2020.0,18,21,-3
CZ,SK,2001.0,28,30,-2
CU,US,2019.0,73,31,42
ZA,JP,2019.0,8,6,2
VN,JP,2015.0,27,59,-32
CH,BR,2005.0,26,17,9
JP,NO,2015.0,11,11,0
IT,BE,2005.0,66,56,10
TR,DE,2012.0,60,64,-4
SE,NO,2003.0,60,37,23
SE,JP,2004.0,23,42,-19
CL,GB,2009.0,28,26,2
CN,SE,2018.0,103,136,-33
CH,nan,2015.0,23,11,12
CH,DK,2020.0,46,54,-8
RU,CA,2013.0,23,23,0
BR,CN,2021.0,29,35,-6
EC,AR,2011.0,4,6,-2
TR,GB,2004.0,30,43,-13
FR,BJ,2002.0,13,4,9
US,TT,2020.0,10,18,-8
SA,TR,2021.0,11,12,-1
CA,NG,2018.0,17,19,-2
EE,AT,2017.0,7,8,-1
SE,IS,2018.0,18,28,-10
US,PL,2010.0,207,197,10
IT,RU,2003.0,15,18,-3
PK,TR,2018.0,20,18,2
IR,SE,2008.0,13,21,-8
CA,JP,2015.0,113,92,21
GB,FI,1998.0,27,15,12
SD,SA,2013.0,26,9,17
CL,IN,2017.0,6,10,-4
BR,ZA,2019.0,19,24,-5
NL,AR,2017.0,7,8,-1
BE,ET,2018.0,15,3,12
CH,NL,2021.0,113,108,5
PH,ES,2020.0,11,24,-13
AU,ES,2014.0,43,75,-32
IN,EG,2018.0,25,7,18
TN,AE,2021.0,5,1,4
US,UY,2007.0,15,14,1
DZ,EG,2020.0,11,5,6
DE,EG,2021.0,55,47,8
LU,US,2018.0,18,35,-17
GB,RO,2009.0,22,24,-2
HU,AT,2010.0,27,29,-2
PA,ES,2009.0,4,5,-1
UA,DE,2016.0,52,21,31
EG,OM,2016.0,9,6,3
FI,nan,2006.0,8,7,1
DE,ES,1999.0,57,63,-6
FR,EG,2016.0,31,28,3
NL,FI,2016.0,34,35,-1
GB,TN,2010.0,8,3,5
NG,ZA,2011.0,22,13,9
RS,UA,2017.0,4,1,3
BF,ML,2015.0,5,1,4
RU,BY,2009.0,60,36,24
US,CZ,2007.0,129,109,20
RU,TW,2018.0,15,14,1
KW,SA,2011.0,8,17,-9
HU,IL,2017.0,2,4,-2
SK,PL,2015.0,13,14,-1
CA,IR,2017.0,182,337,-155
IL,TR,2006.0,7,2,5
HU,GB,2003.0,32,27,5
US,UA,1998.0,14,21,-7
CA,TH,2013.0,18,11,7
NO,DK,2018.0,135,145,-10
ID,DK,2020.0,7,4,3
PT,IT,2021.0,35,42,-7
CZ,UA,2020.0,27,40,-13
GB,MT,2021.0,12,8,4
IN,OM,2022.0,15,15,0
US,LB,2017.0,86,95,-9
CZ,ES,2004.0,5,1,4
ZW,BW,2014.0,1,1,0
IT,TR,2018.0,19,26,-7
BR,FR,2013.0,154,214,-60
GB,IL,1997.0,26,18,8
AR,UY,2018.0,45,39,6
CN,NZ,2020.0,60,69,-9
SA,GB,2000.0,12,17,-5
AE,JO,2018.0,16,28,-12
IN,ID,2015.0,31,22,9
BE,IR,2016.0,25,31,-6
TW,GB,2021.0,34,56,-22
NG,SD,2019.0,8,3,5
CA,QA,2022.0,6,17,-11
BF,BE,2011.0,3,3,0
GB,EE,2019.0,9,16,-7
AT,UA,2018.0,8,4,4
MY,FR,2021.0,9,10,-1
EG,FR,2020.0,33,34,-1
MY,PK,2004.0,5,5,0
GB,nan,2004.0,60,56,4
CR,CL,2021.0,27,30,-3
UA,EE,2021.0,1,1,0
GR,GB,2000.0,48,103,-55
KE,JP,2020.0,7,7,0
ES,SE,2019.0,98,60,38
IR,IE,2021.0,25,6,19
SI,AT,2021.0,10,6,4
MY,MA,2016.0,1,6,-5
nan,BE,2002.0,12,9,3
SA,NZ,2021.0,4,6,-2
AT,AU,2019.0,24,37,-13
RO,DE,2008.0,18,19,-1
FI,CH,2007.0,14,10,4
GB,DZ,2018.0,10,7,3
NL,CH,2015.0,125,107,18
ES,NZ,2018.0,9,5,4
ID,TW,2021.0,75,58,17
IE,CH,2018.0,20,16,4
NZ,ZA,2018.0,12,13,-1
MA,PK,2010.0,14,5,9
MA,PK,2017.0,20,19,1
FR,BJ,2005.0,22,8,14
MY,BH,2020.0,7,2,5
SE,ID,2018.0,12,4,8
FI,SE,2021.0,93,70,23
ID,CA,2019.0,56,95,-39
FR,DE,2023.0,19,14,5
FR,IN,2005.0,41,85,-44
PL,HU,2009.0,14,11,3
US,CL,2002.0,99,64,35
ES,SE,2017.0,105,64,41
NP,AU,2022.0,16,11,5
VE,US,2004.0,53,32,21
BR,DE,2019.0,310,277,33
IT,AU,2018.0,76,81,-5
US,PL,2019.0,258,312,-54
IT,CA,2009.0,95,71,24
MA,PK,2019.0,24,21,3
SA,OM,2014.0,11,7,4
MX,AR,2018.0,201,192,9
EG,MY,2018.0,33,47,-14
TH,US,2021.0,100,128,-28
TR,IR,2016.0,26,48,-22
CR,PE,2020.0,23,6,17
NL,TR,2011.0,19,31,-12
JP,CO,2007.0,9,7,2
BR,CH,2010.0,37,36,1
UA,FR,2007.0,6,10,-4
TW,CH,2018.0,5,12,-7
IT,nan,2004.0,54,63,-9
SK,AU,2013.0,3,3,0
EG,ET,2020.0,9,6,3
PK,AR,2015.0,20,13,7
FR,MY,2020.0,12,18,-6
AU,IN,2004.0,42,41,1
CO,MX,2017.0,411,439,-28
RU,PL,2016.0,32,60,-28
ID,EG,2017.0,15,35,-20
VE,ES,2020.0,67,49,18
SE,CH,2012.0,46,67,-21
GB,ZW,2018.0,7,7,0
nan,VN,2017.0,7,4,3
AT,HR,2013.0,8,9,-1
RU,ZA,2016.0,6,9,-3
UA,CZ,2012.0,22,13,9
AR,FR,2007.0,31,30,1
DK,ES,2022.0,13,26,-13
MX,RU,1999.0,4,19,-15
NL,TH,2018.0,11,10,1
MX,HN,2007.0,26,13,13
GB,LB,2013.0,6,8,-2
FR,VN,2002.0,13,5,8
FR,NE,2000.0,1,2,-1
DE,GH,2012.0,6,2,4
AT,HU,2019.0,45,36,9
RU,MX,2018.0,8,14,-6
KR,MY,2014.0,33,25,8
HU,JP,2008.0,11,7,4
PS,ES,2011.0,10,6,4
GB,SE,2002.0,76,103,-27
UA,PL,2009.0,15,10,5
NL,BE,2008.0,208,199,9
AU,CH,2007.0,39,47,-8
CL,CH,2011.0,6,16,-10
AT,AU,2010.0,26,21,5
US,LB,2010.0,51,76,-25
JP,NL,2015.0,30,22,8
TW,TR,2007.0,7,9,-2
IS,GB,2010.0,4,5,-1
IT,JP,2012.0,90,78,12
UY,CU,2014.0,7,1,6
QA,US,2009.0,20,24,-4
DE,SA,2015.0,25,29,-4
ES,BO,2015.0,28,19,9
FR,nan,2001.0,67,69,-2
CA,EG,1998.0,6,3,3
JP,ES,2015.0,34,38,-4
JO,IQ,2016.0,10,15,-5
GB,CZ,2021.0,36,51,-15
ZW,ZA,2009.0,26,2,24
KR,AU,2018.0,65,43,22
KE,AU,2022.0,4,4,0
PL,SE,1997.0,4,5,-1
NL,SA,2018.0,14,10,4
TR,PK,2020.0,19,14,5
FR,IN,2002.0,88,72,16
AT,IR,2010.0,7,9,-2
HU,AU,2015.0,12,9,3
PK,FI,2022.0,4,4,0
DE,BA,2021.0,3,6,-3
DE,RO,2016.0,42,42,0
IN,RO,2017.0,20,13,7
IL,nan,2014.0,25,18,7
ID,EG,2019.0,53,43,10
TH,CN,2015.0,25,18,7
HU,NZ,2006.0,2,1,1
US,VE,2021.0,26,21,5
IN,RO,2019.0,16,8,8
TW,MY,2020.0,34,24,10
CA,RS,2013.0,18,12,6
nan,BD,2010.0,1,4,-3
PE,CL,2018.0,75,91,-16
PA,VE,2017.0,1,2,-1
CR,PA,2021.0,5,3,2
PY,CU,2017.0,3,7,-4
CA,ES,2002.0,23,29,-6
JP,CL,2009.0,4,3,1
EG,KW,2013.0,10,24,-14
RO,HU,2008.0,20,34,-14
NL,BR,2013.0,39,53,-14
TW,CA,2018.0,50,27,23
nan,VN,2010.0,4,1,3
FR,BO,2004.0,2,1,1
MX,PT,2015.0,22,26,-4
GB,LY,2018.0,27,4,23
EE,AT,2010.0,2,2,0
MA,FR,2000.0,96,117,-21
KR,TH,2011.0,7,20,-13
UG,KE,2015.0,7,8,-1
AT,HU,2017.0,25,48,-23
IT,BE,2002.0,58,54,4
MD,FR,2016.0,41,35,6
SK,TR,2019.0,1,1,0
TH,LK,2006.0,2,1,1
CA,NP,2019.0,5,14,-9
SA,YE,2017.0,4,24,-20
FI,ES,2012.0,15,20,-5
GB,PL,2010.0,50,80,-30
SE,ES,2001.0,19,20,-1
HU,SE,2000.0,5,9,-4
RU,GB,2023.0,6,8,-2
SD,MY,2016.0,10,13,-3
NG,ET,2014.0,1,3,-2
BO,AR,2005.0,2,1,1
JP,IL,2014.0,11,9,2
PL,IE,2020.0,4,6,-2
NZ,RU,2019.0,9,4,5
BE,nan,2011.0,26,23,3
JO,CY,2017.0,2,1,1
JP,TW,2021.0,72,73,-1
US,IS,2008.0,23,16,7
RU,GE,2020.0,6,8,-2
BG,BE,2016.0,4,2,2
TR,KZ,2017.0,27,61,-34
SY,FR,2021.0,4,3,1
CO,US,2000.0,45,61,-16
GE,AU,2015.0,4,2,2
TR,KZ,2010.0,28,24,4
AT,FR,2002.0,16,22,-6
CA,PL,2021.0,19,16,3
SK,CN,2012.0,6,5,1
RO,MD,2005.0,1,1,0
IT,DZ,2000.0,1,3,-2
JP,IR,2015.0,22,16,6
TR,ZA,2013.0,3,3,0
CH,CA,1998.0,38,48,-10
CN,KZ,2015.0,10,11,-1
NP,DE,2021.0,3,3,0
MX,CU,2002.0,19,29,-10
AU,BN,2018.0,6,5,1
AU,LK,2019.0,47,70,-23
KR,NO,2015.0,8,4,4
BE,CD,2013.0,7,8,-1
IT,GR,2018.0,34,30,4
CZ,GB,2020.0,47,49,-2
US,KZ,2020.0,23,13,10
RO,NL,2009.0,6,7,-1
AT,GR,2020.0,8,12,-4
ID,CN,2003.0,6,6,0
CH,NG,2021.0,6,6,0
NZ,FR,2017.0,20,28,-8
GR,CN,2012.0,26,31,-5
FR,VG,2017.0,2,1,1
IS,GB,2019.0,8,16,-8
DE,EC,2020.0,11,5,6
AU,LK,2010.0,8,14,-6
IQ,HU,2020.0,6,3,3
AT,AU,2017.0,39,31,8
TH,NL,2010.0,8,6,2
MY,IT,2012.0,37,69,-32
ID,IR,2011.0,3,2,1
GB,ES,2023.0,19,18,1
nan,CO,2019.0,9,12,-3
BG,ES,2010.0,2,5,-3
GB,GM,2022.0,6,15,-9
IQ,AE,2021.0,13,18,-5
PL,IT,2008.0,23,13,10
MA,ES,2022.0,5,4,1
SK,FR,2015.0,3,10,-7
LV,NL,2021.0,1,1,0
nan,TW,2011.0,7,6,1
TR,PL,2022.0,5,1,4
CH,BA,2019.0,2,5,-3
BD,CA,2000.0,2,1,1
DK,IT,1997.0,11,16,-5
RS,BE,2010.0,4,2,2
FR,JP,1998.0,65,50,15
XK,RS,2018.0,19,21,-2
CO,BO,2008.0,5,3,2
FJ,AU,2006.0,2,1,1
CY,US,2001.0,5,6,-1
PT,MX,2020.0,13,31,-18
TN,ES,2016.0,6,13,-7
FR,VN,2005.0,10,8,2
ES,SE,2010.0,40,41,-1
BE,AU,2015.0,55,33,22
IL,HU,2013.0,4,5,-1
UG,RW,2019.0,6,8,-2
EG,SG,2018.0,6,1,5
IN,PS,2020.0,3,2,1
QA,FR,2020.0,6,12,-6
SE,BR,2016.0,30,34,-4
IR,UA,2021.0,3,3,0
NO,ET,2004.0,2,4,-2
IE,DE,2019.0,90,101,-11
SE,UG,2013.0,4,4,0
TR,FR,2005.0,15,13,2
IN,GE,2019.0,6,1,5
EE,SE,2015.0,19,8,11
DZ,CA,2020.0,17,13,4
GB,TH,1999.0,13,11,2
BM,US,2001.0,1,2,-1
GB,EE,2010.0,7,5,2
US,ZM,2012.0,9,9,0
CZ,AU,2005.0,5,3,2
GR,DE,2000.0,19,21,-2
GR,ES,2000.0,4,1,3
RS,SI,2012.0,11,21,-10
PT,RO,2016.0,4,3,1
QA,CA,2014.0,6,26,-20
DK,CA,2014.0,30,43,-13
KW,GR,2010.0,4,3,1
MX,SG,2005.0,5,6,-1
SA,LB,2017.0,13,5,8
US,KE,2008.0,36,39,-3
RU,SK,2008.0,14,8,6
US,JO,2011.0,59,33,26
GB,TN,2017.0,13,2,11
AE,GB,2014.0,27,30,-3
DE,EE,2005.0,21,14,7
LY,GB,2010.0,4,5,-1
BE,PL,2022.0,17,13,4
FR,LK,2013.0,4,1,3
SE,NZ,2019.0,9,16,-7
CA,ET,2012.0,4,1,3
DE,RS,2013.0,22,17,5
PT,AU,2020.0,6,26,-20
GB,TT,2019.0,10,7,3
BR,ZA,2010.0,13,12,1
GR,SG,2011.0,1,1,0
IN,JO,2007.0,3,1,2
CA,ID,2007.0,5,3,2
KE,TZ,2012.0,3,4,-1
TR,BR,1998.0,1,1,0
GB,HR,2015.0,20,23,-3
DE,LY,2016.0,3,1,2
AU,NG,2016.0,10,6,4
DE,AE,2022.0,4,8,-4
CG,US,2018.0,3,4,-1
IT,NZ,2010.0,4,4,0
CH,FI,2006.0,6,5,1
DE,EE,2002.0,12,3,9
RO,SG,2019.0,1,1,0
FR,PL,2000.0,37,25,12
AU,AT,2001.0,9,9,0
BE,IE,2012.0,13,8,5
RS,CN,2011.0,11,9,2
SE,NZ,2010.0,6,5,1
GR,SE,2008.0,11,7,4
RU,CH,1998.0,15,4,11
GM,US,2021.0,3,3,0
UY,PY,2020.0,2,3,-1
RO,IN,2013.0,16,26,-10
NL,JO,2016.0,4,1,3
CA,FI,2006.0,19,14,5
ZA,IL,2005.0,3,5,-2
IN,PT,2008.0,10,5,5
ZA,AR,2016.0,1,1,0
AT,CZ,2012.0,16,16,0
RU,AU,1998.0,13,3,10
CA,MY,2010.0,25,16,9
IR,SG,2022.0,8,8,0
AU,KR,2004.0,19,10,9
CU,US,2017.0,46,30,16
IN,FI,2008.0,5,4,1
TH,AT,2005.0,3,2,1
VG,US,2014.0,16,18,-2
AR,CR,2016.0,7,26,-19
NC,FR,2001.0,3,6,-3
LB,BE,2012.0,2,1,1
IT,IE,2013.0,39,36,3
JP,LK,2006.0,21,8,13
AU,UA,2007.0,3,2,1
SK,HU,2003.0,2,3,-1
RU,IN,2009.0,15,13,2
RU,IL,2012.0,20,19,1
FR,JP,1997.0,48,39,9
SI,DK,2016.0,2,1,1
RU,BG,2004.0,15,13,2
AR,SE,2016.0,2,3,-1
CA,NP,2010.0,1,1,0
IN,GE,2010.0,2,2,0
CZ,IT,2022.0,21,38,-17
NL,IL,2001.0,8,8,0
SE,ZA,2004.0,6,7,-1
nan,SI,2018.0,4,11,-7
BE,SE,2003.0,10,13,-3
HR,ES,2018.0,6,7,-1
ZA,DE,2006.0,31,37,-6
FI,NZ,2013.0,5,1,4
BG,CN,2014.0,14,20,-6
US,MW,2009.0,6,5,1
AE,AU,2003.0,2,1,1
PT,CH,2006.0,7,9,-2
DK,AU,2000.0,15,12,3
FR,GF,2014.0,17,7,10
SE,RU,1999.0,12,32,-20
EG,QA,1999.0,1,4,-3
IT,FI,2004.0,5,11,-6
US,EE,2013.0,17,16,1
IN,CH,2008.0,21,20,1
ZA,CA,2000.0,11,7,4
MD,ES,2010.0,1,1,0
US,UA,1997.0,5,19,-14
LV,CH,2016.0,2,1,1
CH,CA,1997.0,25,30,-5
UZ,LA,2015.0,2,2,0
DK,CN,2012.0,31,35,-4
IL,BR,2017.0,13,12,1
SI,RO,2012.0,1,1,0
GB,FI,1997.0,12,18,-6
CN,LV,2015.0,6,2,4
US,NI,2015.0,7,2,5
NP,MY,2019.0,2,6,-4
ET,IR,2014.0,1,1,0
SG,ZA,2014.0,3,2,1
AU,HU,2016.0,7,13,-6
BR,PA,2020.0,7,4,3
MM,TH,2011.0,3,1,2
MW,GB,2002.0,6,7,-1
FR,IR,2007.0,24,13,11
CO,IT,2009.0,7,5,2
RU,CH,1997.0,11,5,6
HU,IL,2019.0,15,6,9
NP,OM,2019.0,1,1,0
BG,CZ,1998.0,2,2,0
PL,SI,2013.0,5,4,1
GB,EE,2017.0,14,7,7
BG,DE,2001.0,21,11,10
VE,CL,2013.0,24,19,5
NG,NZ,2021.0,8,1,7
RW,RS,2014.0,1,1,0
AE,GR,2017.0,5,11,-6
BJ,DE,2009.0,3,1,2
SE,TR,2001.0,4,2,2
MD,DZ,2010.0,7,1,6
TR,SY,2014.0,1,1,0
DE,SD,2013.0,8,5,3
AU,LU,2010.0,2,2,0
SG,IE,2022.0,4,3,1
DE,CM,2019.0,9,5,4
RU,NL,2009.0,38,27,11
CA,PA,2022.0,3,1,2
CN,AT,1997.0,6,7,-1
PK,CA,2007.0,10,6,4
TW,nan,2015.0,6,2,4
TH,IT,2015.0,2,4,-2
SE,IE,2018.0,18,11,7
HR,US,2009.0,32,48,-16
CN,CL,2004.0,2,3,-1
CY,AU,2022.0,2,2,0
EC,FR,2002.0,2,1,1
IS,SE,2012.0,12,19,-7
EE,FR,1999.0,2,3,-1
ZA,RU,2016.0,9,6,3
AR,GB,2003.0,16,19,-3
MY,DE,2013.0,10,17,-7
HR,AT,2022.0,5,3,2
BR,CO,2001.0,11,6,5
CN,MD,2009.0,1,2,-1
ES,SA,2012.0,6,1,5
IT,MY,1997.0,7,14,-7
CM,GB,2007.0,6,1,5
IR,MA,2011.0,1,6,-5
EC,MY,2016.0,1,1,0
BR,SV,2018.0,2,3,-1
JP,PL,1998.0,9,12,-3
IT,AM,2007.0,18,14,4
MY,BN,2015.0,10,5,5
KE,NZ,2018.0,1,2,-1
PT,GR,2019.0,6,3,3
FR,RE,2002.0,5,8,-3
FI,FR,2015.0,24,34,-10
CU,US,2010.0,26,27,-1
AT,SI,2015.0,16,18,-2
DZ,US,2014.0,35,40,-5
BR,PY,2010.0,6,6,0
CN,PT,2008.0,11,12,-1
ZA,JP,2010.0,9,5,4
MX,FI,2011.0,2,2,0
UZ,CZ,2022.0,3,1,2
US,SI,2002.0,17,13,4
ES,LU,2018.0,8,3,5
IN,PH,1999.0,5,4,1
BW,ZA,2009.0,12,4,8
RO,JP,2012.0,6,3,3
GB,TT,2010.0,6,4,2
LK,AU,2014.0,26,19,7
SG,LU,2018.0,1,3,-2
nan,MX,1998.0,4,1,3
RU,AU,1997.0,8,2,6
AT,CA,2012.0,25,22,3
LI,CH,2012.0,1,2,-1
NO,CZ,2008.0,7,14,-7
nan,BD,2017.0,4,4,0
IN,SA,1998.0,5,8,-3
TW,KR,2001.0,16,24,-8
DK,IT,1998.0,6,13,-7
MR,SA,2019.0,1,1,0
FI,IL,2019.0,2,2,0
CZ,SE,2005.0,3,12,-9
RU,IR,2022.0,5,6,-1
ST,BR,2022.0,9,11,-2
MW,GB,2005.0,10,5,5
IS,GB,2017.0,5,12,-7
FI,NL,2018.0,30,27,3
CA,MK,2018.0,3,1,2
GH,ZM,2012.0,15,13,2
VN,DE,2007.0,7,4,3
PH,CH,1999.0,4,1,3
SK,IT,1999.0,2,8,-6
AM,KR,2003.0,2,7,-5
NL,MZ,2017.0,1,1,0
SA,BD,2009.0,5,6,-1
CN,BG,2010.0,11,10,1
KE,IT,2014.0,2,5,-3
FR,NC,2004.0,12,7,5
HU,ES,2022.0,6,6,0
CH,LK,2015.0,5,4,1
SE,CN,2023.0,6,26,-20
SK,RS,1997.0,1,4,-3
FI,DE,2003.0,31,37,-6
AR,CA,2007.0,19,14,5
MA,IR,2016.0,7,5,2
AR,RU,2009.0,1,2,-1
DE,ET,2008.0,3,5,-2
KR,NG,2006.0,3,1,2
VE,CA,2011.0,7,2,5
ES,CH,2000.0,19,21,-2
TH,FR,2014.0,17,24,-7
BR,PY,2017.0,15,5,10
nan,VN,2019.0,8,6,2
TR,AT,2007.0,3,7,-4
CZ,GR,2022.0,5,7,-2
PK,MY,2002.0,5,1,4
TR,GR,2016.0,3,12,-9
MX,CN,2002.0,3,2,1
LB,GB,2007.0,2,8,-6
EG,JO,2018.0,23,22,1
EE,NL,2021.0,1,5,-4
SE,IL,2007.0,2,4,-2
SK,AT,2003.0,12,4,8
ET,SE,1998.0,3,1,2
SG,AE,2020.0,4,2,2
RE,IN,2018.0,2,1,1
CN,TZ,2013.0,3,2,1
SA,MX,2019.0,2,2,0
ST,US,2007.0,2,1,1
CH,JM,2016.0,1,1,0
US,NC,2018.0,4,3,1
IN,IL,2005.0,15,8,7
CA,EG,1997.0,5,4,1
IE,AT,2013.0,12,4,8
RS,IL,2021.0,2,1,1
QA,GR,2017.0,5,1,4
EG,IE,2021.0,8,6,2
MY,DZ,2017.0,7,1,6
IL,IE,2008.0,6,2,4
CA,OM,2016.0,8,3,5
ID,JP,2004.0,13,37,-24
GB,TN,2019.0,5,6,-1
AE,IT,2015.0,5,6,-1
CY,ES,2020.0,1,2,-1
GB,QA,2004.0,3,3,0
FR,VG,2010.0,3,6,-3
FR,CZ,2005.0,22,24,-2
MA,ID,2014.0,1,1,0
AM,FR,2009.0,5,2,3
DK,IL,2006.0,6,2,4
FR,PK,2007.0,6,5,1
VN,NL,2018.0,5,15,-10
BR,PH,2018.0,14,16,-2
AE,TR,2012.0,2,2,0
PY,CU,2019.0,5,11,-6
HU,IN,2013.0,8,9,-1
BR,PY,2019.0,17,16,1
CA,UA,2014.0,6,7,-1
LY,GB,2017.0,3,10,-7
VE,JP,2014.0,2,1,1
CA,NP,2017.0,5,6,-1
MK,US,2006.0,3,4,-1
CA,CR,2019.0,2,5,-3
PE,PY,2021.0,2,5,-3
CN,HU,2021.0,10,3,7
IT,HR,2009.0,4,5,-1
UA,BY,2006.0,4,2,2
ZA,JP,2017.0,11,4,7
IL,BE,1999.0,7,5,2
TR,JP,2012.0,32,28,4
NL,RO,2012.0,11,11,0
HU,RU,2003.0,4,4,0
ES,CR,2004.0,14,20,-6
RE,AU,2005.0,1,1,0
RS,BE,2017.0,7,7,0
NP,NZ,2001.0,1,4,-3
NZ,KR,2015.0,6,6,0
BE,HU,2021.0,10,8,2
IL,CO,2011.0,2,2,0
UZ,GB,2002.0,4,1,3
LY,GB,2019.0,1,14,-13
UG,LU,2017.0,3,1,2
JP,PA,2016.0,2,1,1
CN,BG,2017.0,6,7,-1
FJ,NZ,2017.0,2,1,1
ID,UG,2018.0,1,1,0
IN,SG,1999.0,19,4,15
GH,CA,2002.0,2,1,1
NL,MK,2011.0,2,1,1
MT,GB,2001.0,1,8,-7
FR,SN,2011.0,32,25,7
AU,CO,2011.0,7,16,-9
KR,QA,2016.0,8,2,6
TH,NL,2019.0,7,10,-3
US,PS,2016.0,16,4,12
EG,LB,2020.0,24,26,-2
MA,DE,2022.0,7,2,5
MY,TW,2008.0,6,4,2
DZ,DE,2004.0,2,2,0
GB,TT,2017.0,6,7,-1
KE,IE,2011.0,1,1,0
CD,US,2020.0,7,10,-3
DE,CM,2010.0,3,7,-4
FR,GP,2005.0,6,10,-4
EE,US,2016.0,16,11,5
BE,RW,2018.0,3,2,1
DK,GR,2005.0,1,8,-7
TT,AU,2016.0,1,1,0
RU,KZ,2003.0,4,6,-2
KR,EE,2020.0,4,1,3
NL,NG,2003.0,2,1,1
JO,CY,2019.0,3,4,-1
GB,LV,2007.0,2,2,0
AT,SA,2020.0,1,2,-1
CH,SN,2016.0,2,4,-2
TH,NL,2017.0,4,11,-7
CA,CR,2017.0,8,5,3
DE,UZ,2016.0,3,3,0
US,BB,2000.0,2,1,1
DK,IS,2009.0,3,4,-1
BR,PL,2009.0,4,5,-1
MA,SE,2018.0,3,2,1
EG,IT,2008.0,6,6,0
GB,IS,2001.0,5,1,4
IN,ML,2015.0,7,7,0
RU,EE,2003.0,4,1,3
EE,RU,2021.0,11,14,-3
KR,NP,2012.0,9,7,2
IE,RU,2012.0,5,9,-4
FR,ZA,2006.0,14,14,0
PL,UA,2012.0,16,14,2
TR,SE,2001.0,2,4,-2
CO,PT,2007.0,9,6,3
LU,CA,2013.0,6,3,3
CN,AT,1998.0,8,4,4
BR,FI,2009.0,4,1,3
MY,LY,2020.0,5,5,0
BA,TR,2020.0,4,3,1
CZ,NO,1998.0,2,5,-3
BR,TH,2019.0,2,5,-3
KR,EG,2014.0,5,3,2
GB,KE,2004.0,12,12,0
CO,SG,2019.0,1,1,0
KR,IT,2014.0,6,6,0
UY,SE,2011.0,2,3,-1
JP,LT,1999.0,2,3,-1
MA,GB,1999.0,1,1,0
KR,FI,2011.0,2,1,1
PH,AU,2022.0,9,4,5
JP,PT,2002.0,1,3,-2
US,KH,2012.0,4,2,2
VN,CA,2009.0,2,8,-6
AT,IR,2017.0,9,22,-13
CA,GN,2020.0,1,2,-1
BG,RU,2009.0,19,25,-6
LB,QA,2014.0,4,2,2
AE,HU,2014.0,1,1,0
BD,MA,2018.0,8,12,-4
ME,DE,2018.0,2,1,1
PH,SG,2006.0,8,2,6
KE,BE,2012.0,2,4,-2
EC,HN,2016.0,1,3,-2
KR,SK,2003.0,1,2,-1
IE,FI,2003.0,3,2,1
MO,CN,2010.0,1,1,0
CN,TH,2011.0,6,14,-8
GR,ZA,2020.0,4,2,2
ES,TW,2020.0,2,3,-1
VE,BO,2018.0,1,1,0
SE,NG,2013.0,4,2,2
KW,CN,2018.0,3,2,1
SK,IN,2018.0,3,5,-2
UA,MZ,2018.0,3,2,1
ES,TR,2015.0,5,15,-10
RW,ZA,2022.0,4,2,2
HR,XK,2014.0,5,2,3
RO,IL,2002.0,1,1,0
DK,PK,2013.0,1,4,-3
TT,JM,2003.0,6,8,-2
HR,FR,1997.0,1,3,-2
NL,MX,1997.0,3,1,2
ET,DE,2009.0,7,3,4
HK,GB,2017.0,2,2,0
EG,KE,2018.0,1,1,0
SE,NZ,2017.0,5,16,-11
MD,DE,2018.0,3,3,0
GB,VG,2014.0,7,1,6
KZ,CA,2017.0,3,2,1
RU,CU,2012.0,1,2,-1
IR,BR,2021.0,9,8,1
CN,MY,2000.0,5,6,-1
SA,LB,2019.0,9,10,-1
DE,MD,2020.0,4,1,3
CZ,SE,2002.0,7,7,0
MY,JP,2023.0,2,2,0
BD,GR,2010.0,1,1,0
MT,AR,2014.0,1,1,0
BE,PT,2005.0,5,3,2
MY,PS,2020.0,8,4,4
NC,IT,2018.0,1,1,0
KW,GR,2017.0,2,4,-2
TH,SG,2011.0,6,4,2
SE,JO,2020.0,1,2,-1
GB,VE,2012.0,1,4,-3
TR,KR,2000.0,1,2,-1
SY,US,2009.0,6,7,-1
UG,RW,2017.0,2,2,0
US,SI,2005.0,18,17,1
DZ,QA,2015.0,1,1,0
IR,MY,2008.0,16,6,10
AT,FR,2005.0,22,35,-13
US,KN,2012.0,4,2,2
JP,MW,2009.0,1,1,0
SK,BY,2015.0,2,2,0
HU,ID,2013.0,3,1,2
KR,ES,2011.0,4,8,-4
LU,TW,2013.0,1,1,0
QA,SD,2018.0,1,2,-1
HK,JP,2006.0,10,3,7
KH,US,2016.0,3,5,-2
FR,SI,2000.0,2,3,-1
nan,CL,2003.0,3,3,0
MZ,PL,2020.0,12,4,8
SN,US,2003.0,4,5,-1
AT,IR,2019.0,10,20,-10
RS,UA,2019.0,2,2,0
GR,AT,2014.0,10,5,5
BG,ES,2017.0,2,2,0
CM,IT,2007.0,7,1,6
BG,FR,1999.0,11,12,-1
JP,KH,2001.0,4,2,2
FI,PT,2005.0,3,3,0
RS,NO,2006.0,1,1,0
CO,DE,2000.0,1,4,-3
CZ,PK,2019.0,7,6,1
ID,AT,2013.0,2,2,0
MS,TT,1999.0,1,1,0
IE,ID,2015.0,3,2,1
AU,LU,2017.0,3,1,2
NL,EG,2006.0,2,3,-1
AR,CN,2015.0,2,3,-1
RS,SE,2017.0,5,3,2
TW,IT,2020.0,10,5,5
UY,IL,2018.0,3,2,1
EG,IN,2007.0,2,3,-1
GB,CM,2006.0,3,1,2
EE,DE,2000.0,6,4,2
BB,JM,2001.0,2,2,0
TW,SE,2008.0,2,2,0
IT,UA,1999.0,5,2,3
ZA,PH,2020.0,5,1,4
RU,BR,1999.0,7,6,1
BJ,RE,2007.0,1,1,0
RO,DK,2021.0,4,1,3
ES,SV,2014.0,5,5,0
SK,GE,2018.0,1,3,-2
CG,ZA,2022.0,1,1,0
CL,RU,2013.0,5,2,3
NG,CN,2003.0,3,2,1
MX,EG,2006.0,2,1,1
AU,LU,2019.0,1,6,-5
PH,DK,2021.0,1,1,0
MK,RS,2020.0,6,4,2
IR,CZ,2014.0,5,2,3
XK,HR,2009.0,2,2,0
IL,RS,2008.0,9,5,4
RU,MY,2006.0,5,4,1
MY,EG,2001.0,3,4,-1
US,OM,2004.0,5,8,-3
BD,NP,2018.0,6,7,-1
NZ,PH,2013.0,3,3,0
IN,IL,2002.0,10,9,1
CZ,RU,2004.0,10,12,-2
CZ,IN,2022.0,11,20,-9
JP,NG,2003.0,4,2,2
KE,NL,2000.0,2,1,1
LT,DE,2011.0,3,6,-3
CN,BG,2019.0,6,3,3
KE,ES,2011.0,2,1,1
MK,CA,2008.0,1,1,0
UA,PK,2018.0,5,1,4
US,GE,2023.0,6,2,4
FR,LT,2018.0,4,3,1
SA,CM,2019.0,1,1,0
FR,TD,2014.0,2,1,1
CY,AT,2018.0,2,1,1
KH,TH,2020.0,5,2,3
BG,nan,2016.0,3,1,2
CO,ZA,2001.0,1,1,0
CO,CN,2020.0,3,3,0
CZ,BR,2016.0,12,5,7
KZ,CA,2019.0,3,5,-2
AU,TL,2009.0,1,1,0
BE,LU,1998.0,2,6,-4
BR,ZA,2017.0,13,8,5
BE,MG,2015.0,1,1,0
IE,IR,2006.0,3,1,2
IT,PE,2013.0,4,5,-1
NG,NL,2004.0,1,2,-1
NP,SE,2018.0,1,1,0
GB,BW,2005.0,1,1,0
US,SN,2013.0,5,6,-1
nan,CO,2017.0,7,20,-13
US,GH,2003.0,4,3,1
QA,JP,2011.0,1,1,0
IT,TN,2003.0,2,3,-1
PT,GR,2017.0,4,5,-1
IN,QA,2008.0,4,4,0
HK,GB,2010.0,3,6,-3
GB,AG,2020.0,4,1,3
AE,FI,2019.0,2,4,-2
MK,MY,2017.0,1,1,0
VE,nan,2017.0,1,4,-3
BR,UA,2016.0,2,8,-6
UZ,MY,2013.0,2,2,0
SE,PA,2008.0,2,2,0
JO,OM,2007.0,2,4,-2
BE,AR,2021.0,5,12,-7
CI,US,2015.0,2,8,-6
SA,LB,2010.0,1,4,-3
BW,IN,2007.0,1,1,0
QA,GR,2010.0,1,3,-2
PK,TW,2006.0,2,3,-1
RS,BE,2019.0,2,5,-3
KR,LK,2009.0,2,2,0
TR,IE,2021.0,6,6,0
CH,TH,2020.0,2,3,-1
MT,AU,2021.0,3,1,2
CR,DE,2000.0,1,1,0
AU,NC,2003.0,1,1,0
IN,SA,1997.0,5,5,0
TW,IE,2007.0,4,1,3
VE,nan,2019.0,5,2,3
MA,BR,2008.0,1,1,0
PA,MX,2009.0,2,5,-3
MW,CA,2005.0,2,1,1
FI,GR,2018.0,5,8,-3
MY,KE,2021.0,1,2,-1
TZ,FR,2007.0,1,2,-1
GR,EG,2015.0,1,2,-1
MY,DZ,2019.0,4,3,1
US,LV,2004.0,3,1,2
PT,MZ,2018.0,3,4,-1
MX,NI,2014.0,4,4,0
ID,CA,2010.0,4,9,-5
EE,CH,2000.0,1,4,-3
NG,NO,2019.0,4,2,2
TR,DK,2011.0,5,5,0
KE,SD,1997.0,2,8,-6
TH,MY,2012.0,5,3,2
NZ,JP,2004.0,7,13,-6
CA,HR,2009.0,2,5,-3
PT,GR,2010.0,1,2,-1
JP,PT,2005.0,2,3,-1
PE,CR,2009.0,3,1,2
AT,NZ,2012.0,5,5,0
KE,CG,2021.0,1,1,0
AE,PK,2012.0,5,5,0
GA,GB,2006.0,1,1,0
LB,HU,2019.0,1,1,0
EC,CO,2000.0,2,2,0
US,BJ,2004.0,5,1,4
KR,CO,2007.0,3,1,2
AR,MQ,2010.0,1,1,0
KR,SE,2002.0,2,5,-3
MD,US,2016.0,4,5,-1
CN,RO,2009.0,1,3,-2
CU,CL,1997.0,1,1,0
NI,RU,2019.0,1,1,0
AU,ZM,2012.0,3,1,2
NL,AR,2010.0,5,6,-1
ET,JP,2004.0,2,3,-1
GT,EC,2022.0,1,1,0
CM,BE,2021.0,5,6,-1
SA,BE,2020.0,3,15,-12
NL,PE,2014.0,1,3,-2
CH,RS,2021.0,6,7,-1
IT,UY,2001.0,2,1,1
BR,QA,2016.0,2,3,-1
FR,CR,2016.0,4,6,-2
KZ,EG,2011.0,1,1,0
KR,SE,2005.0,2,5,-3
FJ,NZ,2019.0,1,4,-3
BR,HR,2018.0,3,2,1
US,IQ,2023.0,3,1,2
RU,TH,2021.0,2,4,-2
CU,CL,1998.0,3,3,0
AU,HK,2012.0,4,6,-2
NZ,NG,2017.0,2,5,-3
TM,RU,2020.0,3,3,0
SD,ZA,2020.0,3,4,-1
NZ,NG,2019.0,6,7,-1
EC,FR,2005.0,3,1,2
GR,UA,2017.0,1,1,0
KZ,MX,2019.0,1,1,0
GW,DK,2009.0,2,3,-1
IL,AR,2010.0,3,2,1
CU,AR,2004.0,6,6,0
BG,CA,2022.0,1,1,0
GB,PS,2007.0,3,1,2
HR,CL,2019.0,2,2,0
AU,SA,2001.0,4,2,2
OM,IN,2002.0,1,9,-8
OM,KR,2017.0,1,3,-2
LB,IL,2011.0,1,2,-1
FI,RU,1997.0,5,16,-11
NI,RU,2017.0,1,2,-1
CG,BF,2019.0,1,1,0
ID,DE,1997.0,1,1,0
HK,GB,2019.0,4,4,0
QA,TR,2019.0,4,5,-1
TW,UA,2020.0,2,2,0
MD,BE,2012.0,2,1,1
SG,IL,2016.0,3,5,-2
JM,TT,2000.0,5,3,2
MY,NO,2006.0,1,1,0
CH,EE,2002.0,2,2,0
CO,SG,2017.0,2,1,1
QA,TR,2017.0,3,4,-1
OM,CA,2014.0,3,9,-6
HK,FR,2012.0,2,1,1
FR,AO,2019.0,1,1,0
ML,US,2008.0,1,5,-4
GR,DK,2007.0,5,9,-4
GR,KW,2014.0,3,1,2
SY,IN,2022.0,2,1,1
RO,TR,2006.0,1,2,-1
CH,HR,2006.0,2,6,-4
KW,IN,2022.0,4,8,-4
IN,GE,2017.0,1,2,-1
SG,PL,2018.0,1,4,-3
KW,GB,1997.0,3,2,1
CL,IE,2015.0,4,1,3
PY,CL,2016.0,2,11,-9
TW,BE,2006.0,4,1,3
CZ,PK,2017.0,2,3,-1
CR,SE,2010.0,1,1,0
QA,PH,2016.0,1,1,0
NG,UA,2015.0,1,1,0
BH,MY,2021.0,1,2,-1
UY,GB,2016.0,4,4,0
NO,ZA,2011.0,4,6,-2
SN,BF,2016.0,4,6,-2
NP,MY,2017.0,1,1,0
EE,BE,2021.0,4,2,2
AT,NO,2000.0,1,1,0
AE,BR,2021.0,2,8,-6
CH,PE,2016.0,2,5,-3
OM,SD,2019.0,1,4,-3
GT,AR,2018.0,5,3,2
OM,IN,2005.0,2,9,-7
PS,NO,2016.0,1,1,0
TZ,DE,2004.0,1,1,0
NI,US,2008.0,1,3,-2
MY,TZ,2018.0,2,1,1
IE,EG,2003.0,1,1,0
AR,CZ,2008.0,2,4,-2
NA,TZ,2018.0,1,1,0
SE,AL,2009.0,1,3,-2
CU,UY,2014.0,1,7,-6
CH,CR,2009.0,1,1,0
NZ,RU,2010.0,1,2,-1
TR,FR,2002.0,7,7,0
AT,RU,1999.0,4,4,0
ZA,ET,2008.0,2,1,1
DO,US,2008.0,1,2,-1
CZ,HR,2006.0,2,5,-3
MD,CH,2014.0,3,1,2
AE,GR,2019.0,2,5,-3
JO,AU,2022.0,2,4,-2
FR,VG,2019.0,2,1,1
FI,RU,1998.0,5,14,-9
IQ,SK,2020.0,1,1,0
HR,FR,1998.0,2,7,-5
IL,TH,2020.0,1,1,0
DK,GE,2016.0,1,1,0
nan,HU,2020.0,2,3,-1
RU,RO,2005.0,3,2,1
SG,BR,2022.0,2,1,1
NL,MX,1998.0,6,1,5
AR,NL,2000.0,2,3,-1
OM,SG,2018.0,2,1,1
CH,ID,2011.0,1,1,0
SA,ZA,2012.0,3,4,-1
HU,IL,2010.0,4,4,0
FR,IS,2014.0,3,6,-3
LA,US,2020.0,1,1,0
IL,GR,1998.0,2,1,1
IT,UZ,2010.0,1,2,-1
CZ,HU,1999.0,2,2,0
NL,BG,2015.0,1,4,-3
NP,KE,2013.0,1,1,0
BG,FI,2018.0,1,1,0
PK,EE,2012.0,1,1,0
FR,JM,2006.0,1,1,0
PH,CA,2011.0,4,11,-7
PK,MY,2005.0,3,2,1
CZ,KR,2021.0,4,8,-4
SI,ME,2012.0,1,2,-1
HR,CL,2017.0,4,1,3
SY,TN,2015.0,2,3,-1
MC,FR,2021.0,4,8,-4
MY,UA,2012.0,1,2,-1
NG,CG,2020.0,2,1,1
nan,JO,2022.0,1,4,-3
AU,IQ,2011.0,1,2,-1
CA,HT,2011.0,1,1,0
SA,IR,2006.0,1,1,0
PA,DK,2017.0,1,2,-1
GB,MS,2007.0,1,1,0
GB,MR,2003.0,1,1,0
PL,BY,2008.0,2,3,-1
SN,CG,2012.0,1,1,0
nan,GE,2022.0,1,2,-1
SE,ET,2022.0,3,4,-1
BR,TH,2017.0,3,4,-1
IE,IS,2013.0,1,1,0
IT,LU,2008.0,1,4,-3
KR,UA,2013.0,2,1,1
IN,FJ,2009.0,1,3,-2
PL,EC,2018.0,1,2,-1
CN,GE,2011.0,2,3,-1
VN,GR,1999.0,1,4,-3
ZA,SE,1998.0,2,1,1
NZ,RU,2017.0,3,4,-1
IT,LV,2009.0,1,1,0
IE,PH,1999.0,1,2,-1
TR,PH,2010.0,1,2,-1
VN,SG,2021.0,3,13,-10
XK,TR,2011.0,1,1,0
SE,RO,2007.0,3,1,2
US,GB,2019.0,6500,6655,-155
US,KR,2020.0,1305,1303,2
IR,CL,2021.0,2,1,1
FR,CN,2003.0,240,169,71
US,BR,2015.0,1322,1147,175
GB,DE,2022.0,556,444,112
RS,BA,2016.0,45,38,7
KR,JP,2012.0,305,379,-74
AU,SG,2011.0,74,109,-35
CO,CL,2004.0,44,59,-15
US,MX,2009.0,309,290,19
CA,MY,2017.0,31,46,-15
KR,VN,2015.0,59,35,24
BR,BE,2018.0,109,88,21
CL,UY,2006.0,4,3,1
CL,DE,2011.0,47,35,12
IE,DE,2010.0,79,88,-9
US,PE,2018.0,130,118,12
KR,CH,2016.0,19,18,1
PK,IT,2011.0,9,5,4
HU,DE,2011.0,60,45,15
SY,NL,2011.0,2,1,1
CN,NO,2012.0,54,30,24
CH,SE,2018.0,93,65,28
NZ,FR,2019.0,29,33,-4
LB,CN,2005.0,7,4,3
BR,GB,2013.0,163,177,-14
TR,CA,2012.0,25,29,-4
AR,CL,2011.0,84,62,22
FR,GR,2018.0,47,69,-22
GB,LT,2009.0,2,4,-2
NZ,DE,2021.0,38,36,2
CA,AT,2013.0,27,20,7
AT,EE,2021.0,5,1,4
CA,AR,2008.0,14,17,-3
BR,VE,2021.0,13,17,-4
CL,NL,2020.0,20,18,2
SA,US,2000.0,36,40,-4
CN,PH,2022.0,23,10,13
CN,QA,2018.0,16,39,-23
GB,SA,2011.0,100,21,79
AU,QA,2011.0,7,5,2
CN,KE,2014.0,13,4,9
CL,EC,2001.0,1,2,-1
PK,NG,2018.0,11,6,5
PY,BR,2021.0,14,9,5
AE,CA,2021.0,22,21,1
IT,AR,1999.0,31,32,-1
NG,EG,2018.0,7,6,1
KW,AE,2008.0,3,2,1
IT,IN,2008.0,65,71,-6
AU,GB,2015.0,1257,1519,-262
CI,MA,2020.0,2,2,0
GB,DK,1999.0,53,51,2
UY,AR,1997.0,9,1,8
ES,IE,2013.0,31,24,7
BY,FR,2006.0,5,5,0
AU,TW,2011.0,40,34,6
MX,FR,2018.0,68,66,2
PK,CH,2004.0,13,7,6
FI,US,2022.0,72,87,-15
RU,LT,2014.0,6,4,2
IT,SG,2018.0,10,12,-2
DK,SE,2022.0,68,79,-11
SK,RS,1998.0,6,4,2
nan,BD,2019.0,5,1,4
TR,LA,2022.0,3,4,-1
GB,PT,2015.0,99,136,-37
RS,XK,2018.0,21,19,2
IT,SY,2019.0,2,5,-3
EE,AT,2019.0,5,8,-3
IR,AT,2021.0,21,5,16
IR,TR,2004.0,1,1,0
IL,TW,2020.0,3,1,2
CN,ES,2004.0,21,24,-3
BG,NL,2014.0,4,3,1
LT,SE,2009.0,2,4,-2
ID,NO,2012.0,4,1,3
GB,HU,2008.0,30,65,-35
PL,SE,1998.0,10,8,2
BE,SG,2004.0,2,2,0
NL,IT,1999.0,30,40,-10
IL,BR,2010.0,7,3,4
PK,BD,2021.0,37,31,6
SI,IT,2013.0,16,13,3
IN,BR,2007.0,20,14,6
CA,ZA,2006.0,18,27,-9
nan,RU,2000.0,9,11,-2
NZ,IN,2001.0,5,8,-3
IE,KR,2020.0,7,7,0
MY,ES,2007.0,3,2,1
AR,VE,2016.0,13,26,-13
DK,BR,2013.0,14,12,2
CN,ID,2004.0,5,10,-5
HU,AT,2017.0,48,25,23
TR,BE,2012.0,17,17,0
BI,FR,2003.0,14,16,-2
JP,FI,2001.0,9,8,1
BA,DE,2009.0,1,3,-2
KE,GB,2007.0,14,16,-2
MX,CU,2005.0,22,33,-11
IE,MY,2021.0,8,9,-1
CN,UA,2015.0,11,13,-2
DE,PT,2003.0,18,7,11
CZ,ZA,2016.0,2,2,0
JP,ET,2013.0,2,1,1
ID,EG,2010.0,3,6,-3
CH,EE,2005.0,4,1,3
IE,LY,2011.0,2,1,1
BE,MY,2012.0,7,4,3
NL,AR,2019.0,12,8,4
ZA,ZM,2022.0,6,5,1
IR,IN,1997.0,1,2,-1
DE,UA,2022.0,7,24,-17
BG,CZ,1997.0,1,1,0
DE,CM,2017.0,5,5,0
IT,NZ,2017.0,13,11,2
NZ,DK,1998.0,1,4,-3
NL,QA,2021.0,3,2,1
LV,SA,2019.0,2,2,0
ES,CY,2020.0,2,1,1
FR,RE,2005.0,9,20,-11
BF,GN,2022.0,2,1,1
HU,CZ,2007.0,2,8,-6
BY,IT,2002.0,1,1,0
CA,TT,2004.0,2,2,0
EG,CZ,2013.0,3,2,1
JP,NP,2000.0,2,1,1
UA,KZ,2020.0,5,7,-2
BE,PT,2002.0,4,3,1
CZ,IE,2011.0,3,4,-1
nan,BG,2011.0,2,5,-3
IL,NL,2007.0,13,13,0
NO,SJ,2021.0,7,3,4
TH,AE,2020.0,1,1,0
MY,UG,2018.0,2,2,0
NZ,LK,2020.0,3,10,-7
DZ,AE,2020.0,3,4,-1
SE,MA,2019.0,2,3,-1
PT,PL,2022.0,2,5,-3
RS,NL,2003.0,3,1,2
EG,MA,2009.0,2,2,0
NO,AT,1999.0,1,1,0
CH,BR,2002.0,6,10,-4
CL,VE,2003.0,5,7,-2
ZA,NZ,2006.0,6,7,-1
FI,IL,2017.0,5,1,4
CL,IN,2019.0,4,12,-8
RS,SE,2010.0,1,4,-3
NZ,CL,2004.0,4,3,1
KG,TR,2022.0,1,9,-8
RW,SA,2017.0,3,1,2
CA,VN,2023.0,1,3,-2
SN,CM,2009.0,1,1,0
PS,US,2013.0,4,11,-7
LY,MY,2020.0,5,5,0
CL,AU,2008.0,4,3,1
CN,GR,2001.0,5,2,3
NZ,DK,1997.0,3,1,2
CA,HK,2020.0,3,3,0
NL,RW,2013.0,3,1,2
HU,PT,2008.0,2,1,1
ID,ES,1999.0,1,1,0
GH,DK,2020.0,1,5,-4
DK,GR,2002.0,4,3,1
DE,AM,2016.0,7,2,5
LV,DE,2021.0,4,2,2
HK,KR,2008.0,2,1,1
DE,VE,2008.0,2,4,-2
SE,MA,2010.0,2,1,1
TR,BA,2020.0,3,4,-1
MY,SY,2016.0,1,2,-1
GR,KR,2004.0,1,2,-1
FI,BE,2007.0,5,6,-1
TW,IL,2004.0,2,1,1
CZ,NO,1997.0,2,2,0
BS,GB,2021.0,1,1,0
CA,DE,2004.0,137,181,-44
NG,HU,2020.0,2,3,-1
BE,TR,2014.0,19,14,5
SA,YE,2019.0,21,16,5
CU,CO,2006.0,8,12,-4
SA,JO,1999.0,1,1,0
BE,BG,2006.0,7,6,1
TR,HU,2013.0,2,2,0
CL,FR,2000.0,4,15,-11
nan,CO,2010.0,1,8,-7
PK,SE,2014.0,10,22,-12
GB,BD,2020.0,47,39,8
ES,,2011.0,4949,0,4949
,PK,2005.0,903,0,903
,KR,2007.0,5634,0,5634
,IT,1994.0,40853,0,40853
FR,,2003.0,4199,0,4199
SG,,2018.0,1141,0,1141
,TR,2010.0,6459,0,6459
IN,,2012.0,4628,0,4628
KR,,2002.0,403,0,403
AR,,2022.0,6505,0,6505
,NG,2000.0,793,0,793
IT,,2011.0,5678,0,5678
DE,,2016.0,15144,0,15144
ZW,BE,2017.0,1,0,1
,JO,2013.0,435,0,435
,IE,1994.0,1816,0,1816
CN,,2018.0,21226,0,21226
IE,,2020.0,1609,0,1609
RU,,2024.0,64540,0,64540
,EG,2013.0,4194,0,4194
,PT,1997.0,1055,0,1055
,NZ,2015.0,1123,0,1123
,SE,2015.0,2860,0,2860
,TR,2017.0,6184,0,6184
,SA,2011.0,1782,0,1782
,nan,1994.0,1460,0,1460
KR,,2005.0,588,0,588
,ET,2013.0,756,0,756
AE,,2019.0,295,0,295
CL,,2001.0,114,0,114
,GR,2008.0,2640,0,2640
,MY,2004.0,1133,0,1133
NO,,2003.0,334,0,334
GI,,2023.0,2,0,2
LT,,2024.0,3404,0,3404
,PT,1998.0,1016,0,1016
ZA,,1999.0,240,0,240
QA,ID,2015.0,3,0,3
,SV,2016.0,12,0,12
,PK,2002.0,532,0,532
MT,,2022.0,158,0,158
MR,SA,2017.0,1,0,1
SA,,2006.0,122,0,122
CZ,,2025.0,1035,0,1035
,KW,1997.0,178,0,178
GB,MD,2009.0,1,0,1
,AZ,1998.0,98,0,98
,UA,2012.0,2883,0,2883
BE,,2006.0,837,0,837
,KE,2010.0,557,0,557
AE,,2017.0,209,0,209
MA,,2005.0,96,0,96
,MY,1996.0,460,0,460
TW,,2001.0,561,0,561
AE,,2010.0,66,0,66
NZ,,1999.0,181,0,181
PH,PL,2001.0,15,0,15
MD,,2017.0,61,0,61
MX,,2001.0,225,0,225
,SI,2011.0,740,0,740
HR,,2020.0,992,0,992
,BE,2016.0,2862,0,2862
,OM,2014.0,193,0,193
,AF,2013.0,11,0,11
,TR,2019.0,5639,0,5639
,MK,2018.0,99,0,99
EE,ID,2018.0,14,0,14
EE,,2007.0,59,0,59
,EE,2011.0,416,0,416
JO,,2019.0,286,0,286
LB,,2006.0,33,0,33
,KW,1998.0,105,0,105
BH,,2014.0,19,0,19
,LS,2012.0,12,0,12
,PY,2006.0,26,0,26
MA,,2002.0,69,0,69
AZ,,2020.0,192,0,192
,KE,2019.0,342,0,342
BF,BJ,2021.0,1,0,1
,ZA,2018.0,2183,0,2183
HK,MY,2015.0,2,0,2
KE,,2012.0,93,0,93
CO,,2025.0,515,0,515
,MD,2003.0,70,0,70
JO,,2017.0,236,0,236
JO,,2010.0,75,0,75
FI,VN,2020.0,3,0,3
BW,SC,2021.0,1,0,1
SC,,2023.0,15,0,15
RE,CA,2022.0,2,0,2
MM,IN,2003.0,1,0,1
PW,GB,2012.0,1,0,1
,KE,2017.0,662,0,662
US,HK,1998.0,2,0,2
,GL,2015.0,5,0,5
,BH,2008.0,40,0,40
TD,,2021.0,7,0,7
NC,,2024.0,81,0,81
,KG,2018.0,133,0,133
KG,,2025.0,10,0,10
SV,,2018.0,19,0,19
,MT,2013.0,92,0,92
YE,,2008.0,11,0,11
MD,,2019.0,73,0,73
ZA,SK,2016.0,2,0,2
,GQ,2017.0,1,0,1
UA,RS,2018.0,1,0,1
SO,,2024.0,49,0,49
,PL,2020.0,321,0,321
TL,,2023.0,5,0,5
CR,,2004.0,9,0,9
,CA,2020.0,680,0,680
,LY,2009.0,35,0,35
SK,CH,2021.0,6,0,6
,PR,2012.0,24,0,24
ET,TH,2013.0,1,0,1
SY,CH,2012.0,1,0,1
,NE,2013.0,45,0,45
,SD,2000.0,39,0,39
,ML,2018.0,43,0,43
UY,,2007.0,39,0,39
,SZ,2001.0,5,0,5
,XK,2007.0,85,0,85
,AM,2008.0,135,0,135
IR,LY,2020.0,1,0,1
NL,LU,1997.0,2,0,2
EG,IR,2006.0,1,0,1
,ME,1999.0,3,0,3
AL,,2014.0,35,0,35
,AZ,1997.0,32,0,32
JO,BE,2020.0,1,0,1
AE,FI,2017.0,2,0,2
PH,VE,2021.0,1,0,1
,GT,2013.0,62,0,62
,CW,2019.0,1,0,1
,TT,1997.0,26,0,26
nan,TO,2018.0,1,0,1
SL,,2019.0,10,0,10
GE,JP,2006.0,2,0,2
KZ,BD,2022.0,1,0,1
,CW,2010.0,19,0,19
MD,,2010.0,40,0,40
IR,KW,1999.0,1,0,1
IR,PE,2019.0,3,0,3
TZ,IL,2001.0,1,0,1
EC,CU,2004.0,1,0,1
PT,HU,2015.0,4,0,4
TZ,CG,2020.0,1,0,1
PK,AM,2018.0,5,0,5
MN,CN,2009.0,4,0,4
IL,AR,2017.0,7,0,7
,CY,2020.0,16,0,16
MA,TR,2022.0,1,0,1
GH,AL,2018.0,4,0,4
BO,CU,2002.0,1,0,1
OM,SD,2010.0,1,0,1
,BA,1999.0,27,0,27
IE,BI,2022.0,1,0,1
SM,,2018.0,6,0,6
KW,HU,2018.0,1,0,1
,LA,2013.0,12,0,12
SV,UY,2020.0,1,0,1
MK,UA,2018.0,1,0,1
MU,FR,2002.0,1,0,1
JM,KR,2006.0,1,0,1
OM,BJ,2019.0,1,0,1
AT,PT,1998.0,3,0,3
IR,GE,2022.0,1,0,1
TG,ID,2022.0,1,0,1
,BM,1998.0,2,0,2
BA,,2012.0,29,0,29
SG,CL,2015.0,2,0,2
CA,MU,1998.0,1,0,1
UZ,,2009.0,61,0,61
BE,LU,1997.0,6,0,6
TZ,,2009.0,47,0,47
IL,CZ,2008.0,4,0,4
DK,SI,2011.0,2,0,2
BN,PL,2013.0,1,0,1
HR,CO,2016.0,2,0,2
NP,BN,2013.0,1,0,1
GT,,2016.0,12,0,12
CZ,UZ,2004.0,2,0,2
NL,RE,2019.0,1,0,1
JP,MK,2000.0,1,0,1
ID,BR,2008.0,4,0,4
SI,IL,2015.0,3,0,3
AO,BR,1999.0,5,0,5
JP,MD,2007.0,1,0,1
OM,NG,2009.0,1,0,1
,AO,1999.0,11,0,11
KE,TW,2017.0,1,0,1
TN,,2000.0,20,0,20
BW,,2015.0,37,0,37
GR,CO,2017.0,2,0,2
CY,CN,2005.0,2,0,2
LB,FI,2014.0,1,0,1
NI,,2005.0,2,0,2
ID,MM,2021.0,2,0,2
,TT,1998.0,33,0,33
LK,IT,2017.0,1,0,1
CA,AL,2010.0,1,0,1
KR,SN,2004.0,2,0,2
XK,,2012.0,6,0,6
ML,GB,2007.0,1,0,1
NO,PR,2011.0,1,0,1
MR,SA,2010.0,1,0,1
BD,CW,2020.0,1,0,1
TH,IQ,2018.0,1,0,1
CN,MA,2014.0,1,0,1
DZ,,1998.0,3,0,3
KW,BD,2022.0,2,0,2
GH,ET,2017.0,3,0,3
,CW,2017.0,3,0,3
,SS,1994.0,16,0,16
BE,JM,1997.0,1,0,1
,GA,2008.0,25,0,25
NL,ZW,1998.0,3,0,3
CZ,AL,2017.0,1,0,1
EE,KZ,2017.0,2,0,2
GB,MG,2007.0,1,0,1
PK,DK,2004.0,2,0,2
SA,UA,2019.0,1,0,1
DZ,SA,2003.0,2,0,2
UA,DK,2000.0,1,0,1
PG,ZW,2013.0,1,0,1
CW,BE,2014.0,3,0,3
GR,CL,2005.0,3,0,3
,MC,2011.0,15,0,15
CF,SN,2001.0,1,0,1
VN,PE,2013.0,2,0,2
HU,LU,2018.0,2,0,2
PL,EG,2001.0,3,0,3
BT,GB,2019.0,2,0,2
PL,CL,2008.0,3,0,3
PE,NL,2012.0,2,0,2
JM,CU,1997.0,1,0,1
HU,LT,2004.0,14,0,14
CH,KZ,2021.0,1,0,1
KH,NZ,2011.0,1,0,1
TW,ET,2011.0,1,0,1
BD,PT,2012.0,2,0,2
GP,GB,2012.0,1,0,1
MX,BO,2004.0,4,0,4
nan,EG,1998.0,1,0,1
VE,CH,2022.0,2,0,2
PK,QA,2011.0,2,0,2
KE,DK,2013.0,2,0,2
ZW,MW,2013.0,1,0,1
CO,NG,2003.0,1,0,1
AE,MN,2018.0,4,0,4
SY,,2000.0,9,0,9
TR,PH,2019.0,5,0,5
CM,TD,2016.0,1,0,1
IR,NG,2008.0,6,0,6
NO,RW,2018.0,1,0,1
CD,SA,2018.0,1,0,1
CZ,AL,2010.0,1,0,1
QA,RU,2007.0,1,0,1
,ZW,2020.0,9,0,9
SI,BA,2004.0,2,0,2
PH,NL,2003.0,1,0,1
BH,RU,2008.0,1,0,1
TW,NL,1999.0,3,0,3
BD,SD,2022.0,1,0,1
JP,LV,2013.0,1,0,1
RU,ET,2016.0,4,0,4
MY,ET,2012.0,3,0,3
GR,NP,2000.0,1,0,1
GR,UA,2019.0,1,0,1
BE,SK,2020.0,3,0,3
CH,AE,2016.0,3,0,3
PY,CU,2010.0,4,0,4
BR,ZM,2003.0,1,0,1
CY,MY,2010.0,1,0,1
nan,BO,2019.0,3,0,3
US,DZ,1999.0,5,0,5
US,AL,1998.0,2,0,2
JO,GR,2001.0,1,0,1
HU,IE,2022.0,3,0,3
IL,DZ,2018.0,1,0,1
GW,FR,2006.0,1,0,1
CN,KG,2021.0,2,0,2
GP,,2000.0,1,0,1
TN,BH,2015.0,2,0,2
AU,ZW,2015.0,2,0,2
DE,QA,2008.0,3,0,3
ID,NZ,1998.0,1,0,1
RO,KZ,2013.0,2,0,2
TN,MY,2009.0,3,0,3
TZ,DK,2012.0,2,0,2
nan,ZW,2016.0,4,0,4
SY,IR,2014.0,1,0,1
MD,DZ,2017.0,4,0,4
ET,DO,2013.0,1,0,1
TH,CM,2020.0,2,0,2
RO,MD,2002.0,1,0,1
BJ,CH,2004.0,1,0,1
RO,IL,2005.0,1,0,1
EC,PE,2006.0,2,0,2
HK,ES,2011.0,1,0,1
FR,PR,2019.0,1,0,1
JP,RO,2021.0,6,0,6
TN,GE,2019.0,1,0,1
HR,BH,2016.0,1,0,1
IS,AT,1997.0,1,0,1
BD,TH,1999.0,1,0,1
SE,TT,1998.0,1,0,1
MY,JM,2014.0,1,0,1
SV,SE,2020.0,1,0,1
AU,FM,2006.0,1,0,1
MU,ZA,2020.0,2,0,2
IL,RO,2001.0,1,0,1
BH,IQ,2009.0,1,0,1
CR,CO,2023.0,1,0,1
ZA,WS,2003.0,1,0,1
ZA,PG,2011.0,2,0,2
DE,NG,2000.0,3,0,3
MV,NP,2022.0,1,0,1
TW,HU,2016.0,3,0,3
US,LR,2007.0,3,0,3
UZ,GB,2005.0,2,0,2
,IT,2021.0,3,0,3
BR,TN,2005.0,1,0,1
BD,NG,2013.0,1,0,1
AU,SS,2017.0,1,0,1
,GW,2009.0,3,0,3
LT,LK,2017.0,1,0,1
VE,BE,2018.0,4,0,4
SG,RO,2009.0,2,0,2
JP,DZ,2006.0,1,0,1
MK,SE,2020.0,2,0,2
ZM,PK,2017.0,2,0,2
DE,MT,2020.0,3,0,3
FM,,2012.0,1,0,1
GT,AU,2017.0,1,0,1
CH,BA,2010.0,1,0,1
PG,GB,1999.0,2,0,2
LT,IE,2005.0,1,0,1
nan,EG,1997.0,1,0,1
NP,ZA,2016.0,3,0,3
BW,JM,2014.0,1,0,1
PT,PY,1998.0,1,0,1
SA,NE,2019.0,1,0,1
BR,KE,2011.0,2,0,2
TJ,HR,2012.0,1,0,1
BS,LS,2009.0,1,0,1
US,GN,2015.0,1,0,1
TH,IL,2008.0,1,0,1
EG,TG,2019.0,1,0,1
CG,BR,2018.0,1,0,1
TT,,2001.0,6,0,6
SG,BN,2011.0,3,0,3
BE,KZ,2005.0,1,0,1
DE,TG,2009.0,1,0,1
ET,FR,1998.0,2,0,2
ME,ES,2016.0,2,0,2
LR,CN,2021.0,1,0,1
GB,GT,2018.0,1,0,1
UZ,ID,2011.0,1,0,1
ES,MO,2010.0,1,0,1
BD,GE,2020.0,1,0,1
MD,ES,2019.0,1,0,1
RO,IQ,2018.0,8,0,8
UA,CR,2021.0,1,0,1
XK,IT,2012.0,1,0,1
PL,AR,2000.0,1,0,1
KE,CZ,2019.0,2,0,2
CI,CG,2006.0,1,0,1
LT,AU,2018.0,2,0,2
UA,YE,2018.0,1,0,1
GT,BR,2004.0,1,0,1
KR,KE,2009.0,1,0,1
PK,AT,1998.0,1,0,1
,VG,2008.0,18,0,18
TJ,DE,2008.0,1,0,1
CU,GR,2020.0,2,0,2
MN,IN,2021.0,2,0,2
CA,IS,2008.0,3,0,3
EC,BE,2003.0,2,0,2
FI,IL,2010.0,1,0,1
PK,KY,2020.0,1,0,1
ME,SI,2017.0,1,0,1
PL,LB,2019.0,2,0,2
,TM,2013.0,3,0,3
SA,SE,2001.0,1,0,1
NZ,MX,2000.0,1,0,1
CY,DK,2018.0,1,0,1
IL,JM,2014.0,2,0,2
SZ,,2013.0,2,0,2
IT,PY,2013.0,2,0,2
SY,CY,2019.0,1,0,1
GR,ME,2015.0,1,0,1
BY,BR,2011.0,2,0,2
VG,,1999.0,4,0,4
BF,KE,1999.0,1,0,1
BE,BY,2009.0,2,0,2
KH,NL,2014.0,1,0,1
KN,AU,2015.0,1,0,1
RS,LY,2013.0,2,0,2
US,GL,2005.0,1,0,1
VN,BG,2010.0,1,0,1
MA,ML,2020.0,4,0,4
JM,CU,1998.0,1,0,1
TG,SA,2009.0,1,0,1
AM,AR,2018.0,1,0,1
NC,MX,2009.0,1,0,1
IT,BH,2018.0,1,0,1
KN,IE,2017.0,1,0,1
US,BZ,2001.0,1,0,1
NG,NE,2016.0,1,0,1
BY,PK,2009.0,1,0,1
AZ,ES,2019.0,2,0,2
LB,CY,2021.0,1,0,1
PG,NL,2019.0,1,0,1
JP,AL,2018.0,1,0,1
YE,OM,2016.0,1,0,1
SL,,2017.0,4,0,4
FR,SC,2014.0,1,0,1
NZ,MW,2020.0,1,0,1
PL,EE,2012.0,2,0,2
MA,TD,2017.0,3,0,3
UA,SG,2008.0,1,0,1
MA,TD,2019.0,1,0,1
IR,PK,1998.0,1,0,1
GH,SG,2018.0,1,0,1
IR,TJ,2020.0,1,0,1
MT,CH,2020.0,2,0,2
CN,NE,2021.0,1,0,1
TR,JO,2012.0,1,0,1
BY,SE,2022.0,1,0,1
TJ,TH,2014.0,1,0,1
IE,KW,2006.0,1,0,1
JO,LY,2018.0,2,0,2
PL,RO,1998.0,2,0,2
IN,YE,2005.0,1,0,1
NC,VU,2000.0,1,0,1
nan,OM,2017.0,1,0,1
GR,TW,2001.0,1,0,1
PA,CH,2002.0,1,0,1
RU,RO,2002.0,1,0,1
MU,,2013.0,8,0,8
DE,AL,2005.0,1,0,1
LB,IE,2013.0,1,0,1
SK,TN,2018.0,1,0,1
TN,MD,2004.0,4,0,4
ES,ZW,2005.0,1,0,1
,IM,2003.0,2,0,2
GW,BR,2015.0,1,0,1
LR,UG,2016.0,1,0,1
UG,TW,2010.0,1,0,1
GF,ZA,2017.0,1,0,1
IS,SI,2016.0,1,0,1
SK,BA,2015.0,2,0,2
TZ,CD,2015.0,1,0,1
NL,AF,2021.0,1,0,1
ZW,UG,2008.0,1,0,1
IQ,CA,2006.0,1,0,1
AT,SZ,2021.0,1,0,1
NL,BH,2014.0,1,0,1
NI,CL,2001.0,2,0,2
MY,MX,2008.0,1,0,1
KE,ID,2007.0,2,0,2
PH,nan,2014.0,1,0,1
EC,BY,2020.0,1,0,1
PR,MX,2008.0,2,0,2
MZ,AR,2010.0,1,0,1
TR,OM,2006.0,1,0,1
MD,RE,1999.0,1,0,1
TR,PH,2017.0,1,0,1
LT,TR,1998.0,1,0,1
LT,IE,2002.0,1,0,1
US,SX,2017.0,2,0,2
CA,AL,2017.0,1,0,1
MX,CD,2006.0,1,0,1
AM,CO,2012.0,1,0,1
nan,MX,1997.0,3,0,3
LK,BR,2013.0,2,0,2
AE,EC,2015.0,1,0,1
KW,FR,2005.0,2,0,2
MQ,GF,2016.0,2,0,2
SM,CA,2019.0,1,0,1
MX,AT,2001.0,2,0,2
nan,KW,2020.0,1,0,1
AR,MQ,2019.0,1,0,1
BW,SG,2021.0,1,0,1
VE,PA,2022.0,1,0,1
CL,SI,2015.0,1,0,1
OM,CH,2002.0,1,0,1
RU,SI,1999.0,3,0,3
NO,VN,2005.0,1,0,1
SA,VG,2013.0,1,0,1
PF,CA,2021.0,2,0,2
HR,CH,2000.0,2,0,2
BY,MK,2019.0,1,0,1
NP,MY,2010.0,2,0,2
LK,PG,2014.0,1,0,1
IS,UG,2021.0,1,0,1
PT,PS,2008.0,1,0,1
DZ,TN,2001.0,1,0,1
ZA,SA,2009.0,2,0,2
KE,JO,2016.0,1,0,1
CI,TR,2012.0,1,0,1
KR,MN,2008.0,1,0,1
IN,LU,2006.0,1,0,1
RU,HR,2006.0,3,0,3
JP,NA,2014.0,1,0,1
SD,QA,2005.0,1,0,1
PE,NZ,2015.0,1,0,1
CU,CN,2006.0,1,0,1
JP,RW,2014.0,1,0,1
PA,VE,2010.0,1,0,1
BE,EE,2004.0,1,0,1
,VE,2020.0,2,0,2
,KP,2006.0,2,0,2
NO,RO,2006.0,2,0,2
AU,ET,2011.0,2,0,2
FI,NG,2008.0,2,0,2
UG,NL,2006.0,1,0,1
AZ,ES,2010.0,1,0,1
AT,PH,2010.0,1,0,1
SK,MX,2002.0,2,0,2
SY,MY,2011.0,2,0,2
JO,MA,2012.0,1,0,1
NL,RE,2017.0,1,0,1
RO,AU,2002.0,1,0,1
CL,LB,2021.0,1,0,1
PS,OM,2016.0,1,0,1
NL,AG,1999.0,1,0,1
OM,NO,2017.0,1,0,1
KR,BG,2017.0,1,0,1
ML,CG,2013.0,1,0,1
BF,VN,2007.0,1,0,1
PK,SK,2000.0,1,0,1
KR,MM,2007.0,1,0,1
SA,IQ,2009.0,3,0,3
NL,FJ,2005.0,1,0,1
KE,SA,2016.0,1,0,1
CH,HT,2019.0,1,0,1
VU,GB,2004.0,1,0,1
BR,RS,2021.0,1,0,1
LU,PF,2020.0,1,0,1
EG,SO,2021.0,1,0,1
SY,ID,2019.0,3,0,3
DK,HR,2000.0,1,0,1
HN,CU,1999.0,1,0,1
JP,SL,2014.0,1,0,1
IR,AZ,2022.0,1,0,1
LU,FI,2002.0,2,0,2
BD,TN,2016.0,1,0,1
CH,CY,2011.0,2,0,2
CH,LU,2023.0,1,0,1
GR,SK,2013.0,3,0,3
BJ,IT,2021.0,1,0,1
CA,BH,2001.0,1,0,1
PL,KN,2019.0,1,0,1
CO,VG,2004.0,1,0,1
CZ,BA,2005.0,1,0,1
HK,RU,2019.0,1,0,1
BA,EE,2005.0,1,0,1
BA,RU,2005.0,1,0,1
VG,TT,2012.0,1,0,1
AR,SV,2004.0,1,0,1
BH,AT,2017.0,1,0,1
IE,ER,1998.0,1,0,1
MZ,HU,2020.0,1,0,1
CD,ID,2022.0,1,0,1
AM,GB,2008.0,2,0,2
KH,HK,1999.0,2,0,2
CL,PY,2002.0,1,0,1
TR,PS,2009.0,1,0,1
nan,LB,2019.0,1,0,1
SA,PG,2018.0,1,0,1
BR,BJ,2015.0,2,0,2
AF,FR,2021.0,2,0,2
VN,PH,2019.0,2,4,-2
YE,JO,2022.0,1,1,0
QA,GR,2019.0,3,5,-2
BJ,CG,2005.0,1,1,0
SK,TR,2010.0,1,1,0
BN,US,2020.0,3,5,-2
PL,IL,2011.0,3,2,1
DE,DZ,2014.0,2,1,1
AT,DK,2001.0,3,3,0
TR,SK,2009.0,1,1,0
ZA,SE,1997.0,1,1,0
PL,GE,2021.0,1,1,0
IN,SY,2011.0,2,2,0
CN,LK,2004.0,2,2,0
KH,MM,2021.0,1,1,0
UA,GR,2017.0,1,1,0
MY,PL,2012.0,1,1,0
PK,BN,2020.0,1,1,0
BA,AT,2009.0,1,1,0
SE,IN,2023.0,3,6,-3
FJ,GB,2015.0,1,3,-2
TH,AT,2002.0,1,2,-1
DE,CU,2012.0,2,5,-3
GB,SY,1997.0,1,2,-1
SA,SD,2011.0,2,9,-7
KZ,UZ,2016.0,3,11,-8
KN,US,2021.0,5,5,0
ZA,ZW,2009.0,2,26,-24
DK,FO,2002.0,1,1,0
IE,SG,2023.0,1,1,0
BE,GA,2012.0,1,1,0
GR,IE,2008.0,4,3,1
CA,BY,2008.0,2,4,-2
BD,PH,2016.0,2,2,0
KE,SD,1998.0,1,2,-1
ZA,nan,2003.0,2,7,-5
BA,US,2008.0,2,4,-2
BF,nan,2017.0,1,1,0
BF,MD,2019.0,1,1,0
PK,NL,2001.0,2,1,1
CD,CG,2018.0,1,2,-1
BD,QA,2015.0,2,1,1
PH,NP,2021.0,1,2,-1
NO,EE,2013.0,1,1,0
BJ,CA,2015.0,1,4,-3
CN,MG,2008.0,1,1,0
MN,RU,2011.0,2,1,1
US,CW,2007.0,1,1,0
VE,HN,2017.0,2,1,1
PH,IL,2015.0,2,3,-1
IL,BD,2021.0,1,2,-1
PK,EG,2008.0,2,5,-3
CA,SI,2004.0,3,1,2
GB,SY,1998.0,2,2,0
BH,CA,2021.0,2,2,0
TN,PK,2016.0,1,1,0
CH,EG,2009.0,2,6,-4
NG,AT,2021.0,1,1,0
CA,CM,2006.0,1,3,-2
MY,IQ,2007.0,1,1,0
AE,ID,2003.0,1,1,0
BH,ID,2022.0,2,1,1
LB,SD,2021.0,1,1,0
SG,AR,2021.0,1,1,0
PS,IT,2013.0,1,1,0
NA,ZA,2011.0,2,5,-3
JO,YE,2022.0,1,1,0
MY,AT,2013.0,2,4,-2
ML,NG,2016.0,1,2,-1
GB,NA,2014.0,1,4,-3
BE,MA,2004.0,1,5,-4
LS,ZA,2008.0,2,3,-1
KW,GR,2019.0,1,6,-5
CA,AM,2007.0,1,4,-3
IL,AR,2019.0,2,4,-2
ID,DZ,2015.0,1,3,-2
TH,DK,2007.0,1,2,-1
SI,CO,2021.0,1,1,0
OM,GB,2006.0,2,10,-8
YE,IR,2014.0,1,2,-1
CA,LK,2004.0,3,2,1
SV,CO,2015.0,2,5,-3
CN,AM,2020.0,1,1,0
BR,TH,2010.0,2,4,-2
ZM,NO,2015.0,1,2,-1
OM,MY,2003.0,1,2,-1
NL,MZ,2019.0,1,1,0
JP,VG,2003.0,2,1,1
ME,SI,2010.0,1,1,0
nan,CM,2011.0,1,2,-1
ID,HU,2013.0,1,3,-2
RO,PH,2011.0,1,1,0
SE,VE,2013.0,1,1,0
UZ,PL,2003.0,1,3,-2
BG,GR,2011.0,1,3,-2
IR,BO,2013.0,2,6,-4
CL,RS,2012.0,1,2,-1
MT,NO,2021.0,1,1,0
CI,BF,2013.0,1,3,-2
IR,RO,2016.0,1,2,-1
TZ,PK,2015.0,1,1,0
CH,CU,2022.0,1,2,-1
MM,US,2000.0,1,3,-2
MY,MM,2022.0,1,2,-1
LT,NO,2013.0,1,1,0
ET,IT,2005.0,1,1,0
PK,LT,2006.0,1,2,-1
BE,EG,1998.0,1,2,-1
IL,SI,2000.0,1,1,0
ZA,NA,2000.0,1,1,0
BD,EC,2019.0,1,1,0
OM,NL,2008.0,1,1,0
HR,BR,2022.0,1,2,-1
UY,IT,1998.0,2,1,1
JP,IQ,2003.0,1,3,-2
TZ,NG,2009.0,1,1,0
SE,EG,2002.0,2,1,1
BG,IE,2009.0,1,1,0
RU,CO,2011.0,1,1,0
RS,DK,2022.0,2,1,1
TW,IR,2006.0,1,1,0
PY,VE,2006.0,1,1,0
QA,CH,2012.0,1,1,0
JP,PE,1999.0,1,1,0
DE,UY,2015.0,1,7,-6
BY,IT,2005.0,1,3,-2
AR,EC,2006.0,1,2,-1
ID,PL,2012.0,1,1,0
BJ,GA,2021.0,1,1,0
RO,FI,1997.0,1,3,-2
PE,EC,2004.0,1,2,-1
QA,DE,2006.0,1,1,0
BR,GE,2008.0,1,3,-2
NL,JP,2023.0,1,2,-1
PL,BR,2012.0,2,5,-3
ET,KE,2008.0,1,1,0
SI,FI,2008.0,1,1,0
PL,TW,2018.0,1,4,-3
KW,GB,1998.0,1,3,-2
TG,FR,2000.0,1,3,-2
UG,NO,2008.0,1,2,-1
GE,IT,2014.0,1,1,0
BH,GB,2006.0,1,3,-2
LT,CN,2021.0,1,5,-4
CH,QA,2009.0,1,1,0
LB,AT,2012.0,1,1,0
TW,NP,2011.0,2,1,1
CH,LB,2008.0,1,1,0
LK,ZA,2015.0,1,2,-1
KE,TW,2019.0,1,3,-2
SD,BD,2021.0,1,1,0
OM,KR,2019.0,1,1,0
BE,GP,2022.0,1,1,0
GM,NG,2021.0,1,4,-3
AT,CO,2014.0,1,3,-2
CY,DE,2012.0,3,7,-4
CN,MM,2021.0,4,7,-3
JP,BO,2018.0,2,1,1
RS,SE,2019.0,3,4,-1
TN,SY,2018.0,1,1,0
DE,LB,2021.0,2,7,-5
CZ,EG,2015.0,2,1,1
EC,ID,2019.0,1,2,-1
CL,IN,2010.0,1,4,-3
KR,BG,2010.0,1,1,0
AT,ID,2022.0,1,6,-5
NL,ZW,1997.0,1,1,0
ZA,LU,2012.0,1,1,0
NL,PK,2001.0,1,2,-1
XK,PL,2016.0,1,3,-2
CZ,IQ,2020.0,1,1,0
KE,NO,2015.0,1,1,0
SA,AT,2015.0,1,2,-1
UG,CY,2022.0,2,0,2
ME,GB,2023.0,1,0,1
PT,PY,1997.0,1,0,1
IQ,IE,2009.0,1,0,1
IN,FO,2016.0,1,0,1
NC,JP,2001.0,1,0,1
SV,CR,2000.0,1,0,1
SD,QA,2002.0,1,0,1
AG,HU,2011.0,1,0,1
TZ,ML,2019.0,1,0,1
PL,MY,2009.0,1,0,1
US,SO,2020.0,2,0,2
GB,GI,2017.0,1,0,1
DK,SA,2008.0,1,0,1
BE,JO,2022.0,1,0,1
MM,KH,2013.0,1,0,1
PG,NZ,2007.0,1,0,1
PH,TH,1999.0,1,0,1
NP,IE,2019.0,1,0,1
RS,AE,2016.0,2,0,2
SG,IR,1997.0,1,0,1
KZ,US,1998.0,1,0,1
NC,MY,2010.0,1,0,1
CA,ML,2009.0,2,0,2
KW,CZ,2009.0,1,0,1
PA,AU,2022.0,1,0,1
AU,SY,2021.0,1,0,1
FR,AO,2010.0,1,0,1
KR,VG,2015.0,1,0,1
BR,LY,2016.0,1,0,1
TT,CN,2015.0,1,0,1
CU,SE,2014.0,1,0,1
CO,IQ,2016.0,1,0,1
nan,PS,2014.0,1,0,1
CI,ZA,2015.0,1,0,1
FJ,NZ,2010.0,2,0,2
MM,GB,2004.0,1,0,1
DO,PT,2022.0,1,0,1
CI,TZ,2020.0,1,0,1
US,AL,1997.0,1,0,1
BI,CN,2002.0,1,0,1
CF,US,2011.0,1,0,1
LK,NL,2008.0,1,0,1
BH,HU,2022.0,1,0,1
GI,MT,2016.0,2,0,2
DZ,RU,2020.0,1,0,1
SA,HK,2021.0,1,0,1
TR,BR,1997.0,1,0,1
SS,NL,2019.0,1,0,1
CD,CH,2020.0,1,0,1
KE,NG,2001.0,1,0,1
SG,IS,2021.0,1,0,1
GY,,2018.0,3,0,3
ET,AU,1999.0,1,0,1
NG,PG,2017.0,1,0,1
NZ,MY,2001.0,1,0,1
BJ,TZ,2018.0,2,0,2
US,HK,1997.0,1,0,1
BR,BF,2021.0,1,0,1
BF,GM,2017.0,1,0,1
MR,MA,2016.0,1,0,1
,nan,2021.0,1,0,1
SD,OM,2020.0,2,0,2
GF,EC,2017.0,1,0,1
TN,KZ,2019.0,1,0,1
PA,MA,2011.0,1,0,1
PE,HU,2018.0,2,0,2
ZA,MU,2005.0,1,0,1
RO,BG,1997.0,1,0,1
NL,DZ,2015.0,1,0,1
NL,GM,2000.0,2,0,2
SY,OM,2014.0,1,0,1
HU,TG,2014.0,1,0,1
SY,ID,2017.0,1,0,1
NG,OM,1999.0,1,0,1
ZA,GE,2014.0,1,0,1
NO,MZ,2022.0,1,0,1
KE,FI,2009.0,1,0,1
LI,US,2017.0,1,0,1
LB,ES,2009.0,1,0,1
UG,LU,2010.0,1,0,1
BD,HU,2005.0,2,0,2
CG,BF,2010.0,1,0,1
IN,NA,2017.0,1,0,1
EE,MD,2012.0,1,0,1
XK,CZ,2001.0,1,0,1
SE,CL,2023.0,2,0,2
UZ,IN,2003.0,1,0,1
NG,NP,2020.0,1,0,1
VE,HN,2010.0,1,0,1
CO,GE,2002.0,1,0,1
PH,RO,2014.0,2,0,2
JP,MT,2005.0,1,0,1
CU,HN,2002.0,1,0,1
JP,CI,2006.0,1,0,1
nan,SD,2012.0,1,0,1
GE,KE,2005.0,1,0,1
BE,KZ,2002.0,1,0,1
HN,AR,2009.0,1,0,1
GD,GB,2015.0,2,0,2
CY,FR,2007.0,1,0,1
IT,PR,2007.0,1,0,1
NP,MM,2012.0,1,0,1
TW,BD,2008.0,1,0,1
YE,NL,2019.0,1,0,1
PK,RO,2016.0,1,0,1
KR,LA,2018.0,1,0,1
TZ,CM,2018.0,1,0,1
KG,ZW,2020.0,1,0,1
BG,PK,2012.0,1,0,1
VE,PL,2022.0,1,0,1
IN,LR,2021.0,1,0,1
KW,NL,2008.0,1,0,1
CR,GT,2007.0,1,0,1
LV,SK,2020.0,1,0,1
ES,AF,2007.0,1,0,1
AO,AU,2014.0,1,0,1
NZ,PG,2021.0,1,0,1
BH,LT,2012.0,1,0,1
CO,KP,2012.0,1,0,1
LK,FR,2000.0,1,0,1
JP,FJ,2004.0,1,0,1
TR,PA,2015.0,1,0,1
DE,FJ,2021.0,1,0,1
SE,VG,2003.0,1,0,1
KE,PG,2013.0,1,0,1
AL,CZ,2022.0,1,0,1
PA,CH,2005.0,1,0,1
IR,BD,1998.0,1,0,1
GR,PS,2002.0,1,0,1
IQ,MY,2005.0,1,0,1
VE,RU,2013.0,1,0,1
CA,KN,2008.0,1,0,1
BR,TL,2012.0,1,0,1
JM,KZ,2008.0,1,0,1
UA,JO,2022.0,1,0,1
MY,PT,2000.0,1,0,1
MK,IR,2014.0,1,0,1
KR,ZM,2016.0,1,0,1
LB,JO,2006.0,1,0,1
NG,AO,2006.0,1,0,1
NO,BI,2017.0,1,0,1
US,SX,2019.0,1,0,1
AU,PS,2008.0,1,0,1
GP,JM,2013.0,1,0,1
SG,GE,2019.0,1,0,1
LT,MA,2018.0,1,0,1
CM,SI,2020.0,1,0,1
BJ,CG,2002.0,1,0,1
NG,CA,2004.0,1,0,1
CY,OM,2018.0,1,0,1
PR,DE,2020.0,1,0,1
AT,PH,2019.0,1,0,1
RO,PK,2006.0,1,0,1
JM,GP,2007.0,1,0,1
JO,BI,2007.0,1,0,1
MS,FR,1998.0,1,0,1
KH,BR,2017.0,1,0,1
DZ,CN,2023.0,1,0,1
AU,SD,2015.0,1,0,1
BF,ES,2022.0,1,0,1
MK,NO,2020.0,1,0,1
KH,NC,2018.0,1,0,1
SK,IR,2014.0,1,0,1
,KH,2020.0,1,0,1
BI,CA,2000.0,1,0,1
GT,AU,2019.0,1,0,1
CH,GP,2013.0,1,0,1
JO,PH,2002.0,1,0,1
DE,ER,2003.0,1,0,1
CM,SE,2006.0,1,0,1
XK,SE,2013.0,1,0,1
GR,CO,2019.0,1,0,1
GH,GR,2014.0,1,0,1
SD,SO,2009.0,1,0,1
RS,UA,2010.0,1,0,1
TZ,IR,2015.0,1,0,1
TW,US,2018.0,764,652,112
PE,CL,2017.0,66,80,-14
US,NL,2003.0,467,421,46
CN,TW,2016.0,842,1479,-637
AT,DE,2012.0,533,505,28
US,GB,2018.0,6471,6431,40
US,IE,2015.0,524,485,39
ES,BR,2009.0,243,238,5
US,IT,2002.0,645,653,-8
CO,CL,2014.0,199,230,-31
US,FR,2016.0,1486,1563,-77
IE,DE,2018.0,105,96,9
JP,KR,2005.0,257,191,66
IL,US,2004.0,465,283,182
ES,CO,2015.0,580,476,104
US,DE,2020.0,2468,2338,130
CA,US,2012.0,3172,3106,66
CN,PT,2013.0,12,11,1
DE,US,2001.0,1732,1570,162
BE,CA,2005.0,36,33,3
US,NZ,1998.0,174,127,47
GB,IR,2007.0,80,25,55
CA,CN,2016.0,564,521,43
MX,BR,2007.0,56,44,12
MX,AR,2010.0,96,80,16
CO,MX,2018.0,483,464,19
CL,ES,2019.0,445,469,-24
JP,CZ,2021.0,18,14,4
SE,ET,2016.0,5,6,-1
NL,BE,2013.0,311,250,61
JP,ID,2010.0,131,38,93
GB,CA,2009.0,836,732,104
ES,DE,2018.0,321,236,85
US,PT,2021.0,165,126,39
ES,CR,2014.0,46,45,1
BD,CN,2022.0,36,33,3
US,ZA,2007.0,230,232,-2
US,JP,2023.0,55,63,-8
CL,BR,2002.0,24,18,6
FR,NL,2013.0,167,188,-21
PL,DE,2011.0,113,126,-13
EG,KW,2008.0,11,10,1
AU,BR,2008.0,47,57,-10
JP,EG,2007.0,60,31,29
MX,FR,2019.0,80,74,6
MY,ID,2015.0,210,95,115
AT,ID,2016.0,13,2,11
DE,AT,2011.0,531,512,19
DE,CA,2004.0,181,137,44
SE,GB,2020.0,193,243,-50
CL,ES,2010.0,253,247,6
PL,TW,2017.0,4,4,0
BR,DE,2018.0,259,280,-21
GB,CY,2007.0,23,8,15
MX,US,2018.0,534,496,38
IN,CH,2013.0,55,46,9
CA,DE,2014.0,298,262,36
SG,US,2002.0,159,164,-5
FR,BE,2017.0,372,383,-11
PE,CO,2004.0,28,8,20
RU,TW,2019.0,11,10,1
IN,CA,2007.0,244,94,150
FR,BE,2019.0,421,374,47
JP,KR,2002.0,186,154,32
ID,IT,2021.0,20,14,6
SE,ZA,2014.0,14,11,3
US,PE,2017.0,123,76,47
CL,BR,2005.0,35,22,13
FR,CN,2001.0,155,114,41
MX,AR,2017.0,147,197,-50
US,ES,2011.0,885,953,-68
CA,IR,2018.0,213,339,-126
CN,SE,2019.0,117,146,-29
AU,CA,2013.0,337,426,-89
IT,AU,2019.0,84,79,5
CN,DK,2009.0,28,30,-2
MY,SG,2015.0,100,142,-42
BR,GB,2008.0,121,122,-1
GB,HU,2013.0,52,50,2
FR,DK,2007.0,44,26,18
ES,NL,2004.0,46,41,5
ES,UY,2009.0,32,30,2
NO,ET,2014.0,5,8,-3
US,SE,2018.0,554,549,5
TR,GB,2014.0,108,118,-10
MG,GP,2022.0,1,1,0
PK,NG,2017.0,20,8,12
SG,US,2005.0,177,233,-56
SG,CN,2022.0,454,317,137
SE,AR,1999.0,2,4,-2
US,AT,2011.0,233,219,14
JP,IN,2004.0,108,160,-52
FR,BE,2010.0,296,292,4
nan,BR,2006.0,62,43,19
PL,US,2013.0,199,218,-19
VN,CH,2020.0,6,4,2
PK,KE,2015.0,19,23,-4
SE,IS,2019.0,30,14,16
CH,US,2021.0,657,698,-41
PH,US,2005.0,285,295,-10
CN,QA,2017.0,26,10,16
IN,NZ,2012.0,18,20,-2
KR,AU,2019.0,81,54,27
NZ,GB,2020.0,275,275,0
US,IT,2005.0,640,745,-105
CN,DE,2007.0,173,259,-86
SE,FI,2012.0,76,92,-16
MX,AR,2019.0,208,184,24
IT,FR,2008.0,315,220,95
CL,ES,2017.0,369,445,-76
IT,TR,2010.0,16,19,-3
AR,IT,2009.0,70,60,10
JP,MY,1999.0,8,5,3
VE,US,2014.0,43,29,14
nan,US,2010.0,229,268,-39
ES,CH,2023.0,6,4,2
KR,AU,2017.0,72,46,26
US,NP,2011.0,26,16,10
CU,US,2018.0,74,41,33
PT,NL,2009.0,20,12,8
IQ,TR,2015.0,4,6,-2
JP,BR,2008.0,49,34,15
nan,SE,2019.0,43,14,29
CA,MM,2015.0,1,1,0
CH,BE,2009.0,47,64,-17
NL,FR,2007.0,198,152,46
AU,NZ,2002.0,68,84,-16
nan,US,2019.0,288,330,-42
BR,CL,2017.0,113,122,-9
US,PH,1997.0,121,134,-13
PH,US,2002.0,233,222,11
US,MY,2007.0,74,50,24
MY,AT,2008.0,1,2,-1
EG,MY,2010.0,22,5,17
PT,US,2001.0,60,60,0
NO,DK,2010.0,74,75,-1
AU,NL,2022.0,59,46,13
IL,CA,2020.0,66,71,-5
SG,TW,2020.0,44,57,-13
IE,CN,2021.0,33,28,5
AE,JO,2010.0,3,11,-8
BW,GB,2015.0,5,2,3
AU,IN,2014.0,161,193,-32
CA,CR,2018.0,7,4,3
FI,US,2016.0,164,137,27
NL,ZA,2006.0,26,20,6
KR,PK,2002.0,7,4,3
CN,PH,2016.0,28,26,2
ZA,US,2001.0,160,165,-5
CN,IR,2009.0,24,21,3
QA,EG,2011.0,17,19,-2
BR,CH,2018.0,75,66,9
PK,GB,2015.0,106,170,-64
BR,ST,2011.0,27,29,-2
CA,MX,2002.0,14,15,-1
CH,CZ,2011.0,27,23,4
DE,GB,2022.0,444,556,-112
DE,PL,2008.0,102,129,-27
JP,ID,2017.0,199,99,100
nan,JP,2006.0,104,49,55
ET,ZA,2015.0,7,7,0
PK,CH,2014.0,18,19,-1
DE,TW,2001.0,15,15,0
CH,ES,2015.0,74,134,-60
DK,CA,2004.0,23,11,12
GB,PL,2018.0,123,128,-5
SD,SA,2008.0,6,4,2
AT,IT,2011.0,31,37,-6
IN,TZ,2014.0,3,4,-1
IN,GR,2006.0,4,4,0
CN,TR,2000.0,4,4,0
NO,DK,2019.0,108,161,-53
US,PK,2011.0,180,129,51
NG,NL,2014.0,3,9,-6
IT,ES,2018.0,307,287,20
DE,RS,2008.0,11,7,4
DE,CO,2009.0,11,12,-1
IN,CL,2020.0,17,10,7
CA,KR,2005.0,33,37,-4
IN,CN,2007.0,147,116,31
CN,HK,2011.0,139,86,53
CN,ES,2014.0,78,77,1
NL,RU,2015.0,33,47,-14
CN,BD,2007.0,23,26,-3
CZ,CN,2014.0,34,19,15
CN,IN,2005.0,82,99,-17
SY,CN,2002.0,4,2,2
SY,CN,2005.0,12,16,-4
FR,DE,2000.0,269,253,16
GB,FR,2013.0,544,554,-10
SA,KR,2009.0,5,1,4
KE,CN,2003.0,5,2,3
GB,nan,2014.0,82,78,4
TR,KZ,2018.0,32,49,-17
RU,TW,2017.0,12,9,3
JP,IL,2004.0,6,10,-4
NO,CA,2021.0,17,22,-5
IR,DE,2021.0,136,63,73
GB,NL,2007.0,174,242,-68
CN,PK,2015.0,63,109,-46
IT,AU,2010.0,48,54,-6
AE,IR,2020.0,9,10,-1
AE,JO,2019.0,19,39,-20
FR,AU,2012.0,159,106,53
MX,FR,2017.0,62,81,-19
JP,AU,2014.0,82,67,15
JO,SA,2011.0,40,9,31
TW,JP,2012.0,71,82,-11
IT,SE,2009.0,71,69,2
DE,AU,2014.0,240,229,11
CH,TR,2012.0,16,13,3
CO,IN,2020.0,7,4,3
GH,ID,2020.0,26,13,13
SG,CA,2022.0,32,23,9
FR,nan,2003.0,84,71,13
GB,NO,2011.0,91,55,36
DE,AR,1998.0,10,7,3
SE,BE,2020.0,42,37,5
CA,CO,2020.0,30,36,-6
HR,ES,2010.0,2,4,-2
CN,LT,2011.0,44,3,41
GB,JO,2021.0,29,13,16
BR,PY,2018.0,16,7,9
MY,PK,2014.0,76,54,22
KR,AU,2010.0,35,27,8
ES,IE,2008.0,16,17,-1
DK,FR,2020.0,41,57,-16
RU,SK,2013.0,14,16,-2
MY,MA,2022.0,3,1,2
AT,HU,2018.0,37,39,-2
GR,SE,2013.0,26,11,15
FI,IN,2021.0,19,36,-17
IE,US,2023.0,13,10,3
NZ,JP,2014.0,13,11,2
VE,JP,2004.0,2,2,0
DE,MX,2009.0,32,30,2
VE,BE,2017.0,3,1,2
IQ,US,2015.0,21,38,-17
GB,ES,2000.0,136,102,34
NO,DK,2017.0,75,141,-66
CH,SE,2017.0,67,62,5
SE,LV,2000.0,3,1,2
PT,MZ,2019.0,5,12,-7
IN,EG,2017.0,23,23,0
KZ,TR,2015.0,64,42,22
IT,CZ,2020.0,38,39,-1
VE,MX,2005.0,24,25,-1
TW,CA,2017.0,40,36,4
NO,AU,2015.0,16,27,-11
BR,AT,2021.0,24,12,12
FR,AR,2012.0,133,61,72
CO,CA,2015.0,40,25,15
RU,GB,2000.0,74,50,24
NL,BR,2008.0,26,22,4
ET,NG,2020.0,15,15,0
CA,MY,2018.0,26,63,-37
ET,PR,2015.0,12,7,5
TR,NL,2007.0,10,11,-1
EG,FI,2011.0,1,2,-1
IN,EG,2010.0,6,4,2
SG,SE,2021.0,17,15,2
IL,FR,2009.0,32,28,4
SY,CG,2016.0,1,1,0
NZ,FR,2018.0,23,18,5
PH,IN,2015.0,25,22,3
GB,AR,2012.0,29,39,-10
DE,CZ,2009.0,53,45,8
IE,CA,1997.0,30,26,4
ES,NZ,2017.0,6,10,-4
SA,NL,2021.0,6,6,0
IR,IT,2020.0,79,36,43
MX,NL,2020.0,13,13,0
TR,AU,1999.0,5,2,3
US,KW,2007.0,16,15,1
AU,NZ,2005.0,99,135,-36
UA,DE,2022.0,24,7,17
BR,MY,2007.0,123,96,27
QA,SA,2007.0,3,3,0
CL,VE,2001.0,5,4,1
SE,TW,2009.0,4,4,0
CH,SE,2019.0,83,83,0
MA,PK,2018.0,32,26,6
SG,IN,2015.0,115,117,-2
CZ,AT,2021.0,30,46,-16
AU,MY,2022.0,39,59,-20
IR,SG,2016.0,42,47,-5
FI,GR,2019.0,10,4,6
AT,ZA,2011.0,1,4,-3
NP,US,2021.0,74,73,1
nan,IT,2007.0,107,81,26
PK,TR,2017.0,22,9,13
IT,AZ,2014.0,5,2,3
UZ,RU,2009.0,13,13,0
CA,KE,2012.0,3,2,1
RU,JP,2020.0,30,38,-8
nan,SE,2017.0,89,23,66
US,NO,2004.0,87,85,2
KR,CH,2022.0,6,12,-6
TW,CH,2017.0,8,6,2
IN,NP,2016.0,145,122,23
PK,AU,2016.0,50,40,10
FR,GR,2019.0,53,47,6
MT,BR,2020.0,1,2,-1
FR,GR,2017.0,45,50,-5
KE,nan,2015.0,2,3,-1
EC,ES,2015.0,35,148,-113
NL,IN,2020.0,62,87,-25
BR,CL,2019.0,140,129,11
GB,IQ,2011.0,9,10,-1
BR,PH,2017.0,13,12,1
AR,GB,2001.0,18,12,6
TZ,NL,2012.0,3,2,1
IT,IE,2008.0,24,12,12
AR,UY,2017.0,36,46,-10
GB,EE,2018.0,13,16,-3
CA,OM,2022.0,7,2,5
CL,IT,2021.0,31,15,16
KR,IR,2011.0,3,10,-7
ZA,RU,2022.0,6,3,3
AE,JO,2017.0,15,22,-7
OM,AE,2020.0,7,5,2
SE,AU,2004.0,35,34,1
GB,ID,2005.0,9,3,6
PK,TR,2019.0,18,20,-2
PE,CL,2010.0,15,40,-25
EC,UA,2020.0,21,14,7
KE,PH,2021.0,4,2,2
CO,US,2023.0,8,8,0
CO,AU,2012.0,7,7,0
BB,GB,2020.0,4,3,1
TR,IQ,2021.0,12,19,-7
ID,CA,2018.0,46,62,-16
GB,LY,2017.0,10,3,7
RU,PL,2022.0,31,19,12
AR,PA,2021.0,4,1,3
IQ,CY,2019.0,1,2,-1
SA,GB,2023.0,1,4,-3
ZA,TG,2020.0,1,1,0
nan,VN,2018.0,4,3,1
AT,HR,2008.0,6,4,2
MY,TW,2013.0,13,22,-9
CL,AU,2013.0,20,13,7
ZA,TW,2015.0,3,2,1
CN,LK,2014.0,8,3,5
FI,DK,2021.0,20,18,2
MA,IR,2022.0,4,2,2
US,TH,2007.0,159,97,62
IT,nan,2014.0,195,132,63
US,LK,2015.0,34,23,11
US,LU,2020.0,29,24,5
BR,FR,2008.0,133,144,-11
BE,IT,2022.0,100,100,0
PT,GB,2005.0,53,58,-5
AU,RU,2005.0,6,13,-7
NI,CR,2016.0,2,1,1
UA,MZ,2019.0,2,3,-1
US,CR,2009.0,25,16,9
IR,MY,2013.0,104,125,-21
GH,US,2021.0,44,53,-9
IN,OM,2016.0,23,18,5
SE,IS,2017.0,19,17,2
SE,ID,2017.0,18,3,15
HU,LU,2019.0,1,1,0
RU,TR,2006.0,3,1,2
SE,NZ,2018.0,10,15,-5
SN,GN,2021.0,7,3,4
ZA,ES,2020.0,11,7,4
BR,BE,2017.0,86,94,-8
EG,MY,2017.0,37,56,-19
US,EE,2008.0,5,7,-2
BR,BE,2019.0,86,104,-18
CA,AR,2013.0,23,22,1
BE,IR,2022.0,9,18,-9
CA,RS,2008.0,20,10,10
GB,DZ,2017.0,8,7,1
EG,GB,2009.0,43,70,-27
NO,FR,2005.0,27,34,-7
EE,MX,2015.0,1,1,0
GB,TT,2018.0,12,5,7
SE,ES,2003.0,20,22,-2
IT,IN,2013.0,63,81,-18
JP,FI,2003.0,9,15,-6
IL,nan,2004.0,17,16,1
NG,CA,2014.0,11,7,4
US,NZ,1997.0,116,95,21
nan,SE,2010.0,50,52,-2
NO,FR,2002.0,34,22,12
LK,US,2020.0,31,37,-6
IL,AR,2018.0,4,6,-2
US,GE,2000.0,67,78,-11
IE,CA,1998.0,27,30,-3
IT,GR,2019.0,43,38,5
AR,CH,2020.0,22,23,-1
MX,FR,2010.0,43,48,-5
CA,QA,2016.0,28,9,19
SE,JP,2014.0,34,38,-4
FR,MX,2004.0,35,27,8
FR,BO,2014.0,4,3,1
LT,IT,2021.0,1,3,-2
HR,JP,2012.0,4,3,1
DE,TR,2012.0,64,60,4
PE,CL,2019.0,66,110,-44
GB,DZ,2010.0,6,3,3
RS,XK,2017.0,26,8,18
IR,SE,2013.0,56,41,15
CA,LU,2011.0,3,2,1
NL,AT,2011.0,27,23,4
KE,US,2007.0,36,29,7
GB,GM,2016.0,20,6,14
CA,BR,1999.0,36,44,-8
MQ,FR,2006.0,6,11,-5
SG,GB,2006.0,61,71,-10
MX,DE,2020.0,65,40,25
BE,ES,2013.0,64,94,-30
BR,AU,2003.0,16,23,-7
ES,AU,1997.0,9,3,6
IT,SG,2019.0,11,10,1
FR,GR,2010.0,29,31,-2
ES,CZ,1998.0,6,2,4
AR,SE,2022.0,6,2,4
AT,AU,2018.0,29,42,-13
CA,NG,2019.0,23,30,-7
ES,ZA,2014.0,11,9,2
RS,CA,2009.0,3,28,-25
AT,SK,2007.0,14,13,1
KH,FR,2020.0,12,7,5
PK,US,1999.0,39,39,0
EC,ID,2018.0,3,1,2
IN,AE,2015.0,60,37,23
IN,EG,2019.0,18,17,1
PT,GB,2002.0,20,39,-19
RU,TJ,2012.0,29,17,12
MD,DE,2017.0,5,1,4
ES,LU,2017.0,12,2,10
SN,BE,2021.0,4,3,1
UA,US,2011.0,52,35,17
DE,NO,2005.0,47,28,19
BE,SG,2014.0,8,4,4
JP,PH,2013.0,37,20,17
GB,QA,2014.0,40,10,30
SG,NL,2021.0,18,8,10
CA,BE,2007.0,43,51,-8
SA,AU,2012.0,8,22,-14
JO,AU,2016.0,4,11,-7
IT,BF,2020.0,2,1,1
NG,BJ,2006.0,2,1,1
UG,CM,2020.0,1,2,-1
DE,UA,2016.0,21,52,-31
CN,BG,2018.0,11,2,9
BE,GR,2007.0,10,10,0
BD,MA,2017.0,9,9,0
BI,FR,2001.0,13,6,7
SE,BR,2022.0,15,30,-15
DE,HU,1999.0,26,22,4
NP,AU,2016.0,9,8,1
BJ,NE,2021.0,2,1,1
NL,FI,2022.0,22,25,-3
TH,FR,2004.0,3,5,-2
DK,nan,2011.0,11,12,-1
PE,EC,2014.0,12,15,-3
SK,GE,2010.0,7,3,4
GL,DK,2005.0,3,2,1
PT,AT,1999.0,1,1,0
US,MZ,1998.0,1,2,-1
JP,RU,1998.0,19,36,-17
CZ,RU,2014.0,41,38,3
BR,PH,2010.0,5,1,4
RU,IS,2011.0,2,1,1
GR,DE,2023.0,6,3,3
TN,DZ,2021.0,27,26,1
DE,PH,2017.0,11,12,-1
SE,NO,2001.0,43,20,23
SD,MY,2022.0,6,2,4
HU,IN,2008.0,3,3,0
BD,MA,2019.0,24,22,2
MD,FR,2022.0,19,19,0
NL,SA,2019.0,16,8,8
DE,PH,2019.0,9,12,-3
NZ,nan,2006.0,18,15,3
IN,PT,2013.0,16,14,2
KE,AU,2016.0,5,5,0
EG,JO,2019.0,35,33,2
DZ,IT,2015.0,24,41,-17
SA,YE,2018.0,11,17,-6
IT,SG,2017.0,8,9,-1
GB,ZW,2017.0,4,8,-4
IS,DE,2020.0,6,6,0
FR,SA,2021.0,23,18,5
AU,HU,2022.0,8,5,3
SE,IE,2017.0,12,9,3
TT,GB,2006.0,5,4,1
MY,UG,2017.0,3,1,2
nan,KR,2015.0,25,23,2
CO,PH,2021.0,15,1,14
LK,BT,2021.0,3,4,-1
ES,PS,2011.0,6,10,-4
UA,RS,2019.0,2,2,0
NO,IL,2020.0,6,6,0
ET,FI,2019.0,3,4,-1
FR,VE,2006.0,11,12,-1
RO,IN,2008.0,38,21,17
US,PE,2010.0,56,52,4
DE,NO,2002.0,32,23,9
IS,US,2007.0,12,15,-3
AM,US,2015.0,8,16,-8
PE,ES,2008.0,36,37,-1
ZA,BW,2014.0,9,9,0
CY,AU,2016.0,3,3,0
ID,JP,2014.0,67,202,-135
UY,IL,2019.0,2,1,1
IN,RW,2015.0,12,12,0
IL,BR,2018.0,7,9,-2
DK,ES,2016.0,33,75,-42
DK,NL,1997.0,5,8,-3
SG,BR,2016.0,1,2,-1
HU,CH,2012.0,16,8,8
PK,NG,2019.0,14,4,10
TW,KR,2003.0,20,20,0
UA,PK,2019.0,4,2,2
KH,US,2022.0,8,6,2
JP,RU,1997.0,21,28,-7
RU,IT,2009.0,21,15,6
AR,CZ,2013.0,3,1,2
NL,JP,2000.0,25,34,-9
IT,TR,2019.0,17,16,1
KE,CM,2015.0,2,3,-1
US,PA,2007.0,30,8,22
FR,HU,2020.0,22,9,13
RS,SE,2018.0,10,4,6
HK,RO,2011.0,23,12,11
CA,AT,2008.0,18,22,-4
BE,CA,2002.0,36,26,10
DE,GR,2007.0,41,54,-13
PL,TW,2010.0,3,3,0
SE,NL,2009.0,28,32,-4
GR,CH,2009.0,13,7,6
SA,LB,2018.0,13,5,8
IT,GH,2012.0,2,3,-1
IL,UA,2021.0,2,5,-3
PK,NG,2010.0,5,4,1
KR,MN,2013.0,6,1,5
TH,TW,2002.0,1,1,0
MY,BR,2007.0,96,123,-27
UG,NO,2013.0,2,2,0
US,PY,2014.0,6,4,2
RU,CA,2008.0,29,17,12
FI,DE,2001.0,28,20,8
AR,nan,1998.0,10,8,2
DE,QA,2013.0,8,3,5
FI,GR,2010.0,4,5,-1
CH,SE,2010.0,49,42,7
BR,CL,2010.0,57,57,0
CZ,SK,2003.0,26,41,-15
AR,UY,2010.0,26,21,5
IT,SG,2010.0,4,2,2
GB,TZ,2006.0,6,8,-2
ID,SD,2012.0,1,1,0
CZ,CH,2009.0,19,19,0
BR,BE,2010.0,54,65,-11
GB,GH,1998.0,4,6,-2
ZA,JP,2018.0,5,7,-2
RU,MX,2019.0,4,14,-10
SK,US,1999.0,26,26,0
CA,EE,2015.0,2,1,1
ES,LU,2019.0,14,8,6
RS,JP,2006.0,5,3,2
IT,SK,2006.0,9,6,3
RS,BA,2022.0,25,22,3
TN,SY,2017.0,1,2,-1
GH,CH,2015.0,6,2,4
BE,ET,2017.0,8,9,-1
CL,RU,2008.0,2,3,-1
JP,HK,2015.0,7,11,-4
PL,CN,2007.0,37,26,11
DK,SG,2021.0,1,5,-4
IT,EE,2009.0,1,1,0
JO,CA,2017.0,8,16,-8
CA,KR,2002.0,18,26,-8
TR,SE,2003.0,2,2,0
SG,QA,2020.0,2,2,0
MY,CA,2009.0,7,18,-11
AU,RU,2002.0,8,16,-8
AM,JP,2002.0,6,7,-1
AR,CR,2022.0,7,3,4
CU,BR,2020.0,25,20,5
JP,KH,2003.0,3,3,0
TW,DK,2007.0,1,2,-1
JP,NZ,2021.0,6,4,2
ZA,BE,2009.0,8,17,-9
TW,SE,2013.0,3,7,-4
SG,FR,2015.0,18,32,-14
AE,GB,2004.0,7,12,-5
PL,PT,2011.0,6,3,3
SE,KR,2012.0,11,8,3
JP,DK,2021.0,12,9,3
IT,KR,2002.0,4,2,2
IT,BY,1999.0,3,1,2
LU,US,2017.0,25,29,-4
JP,CU,2000.0,2,1,1
CA,NG,2017.0,15,17,-2
US,BA,2011.0,10,5,5
MY,SI,2016.0,2,1,1
BR,UA,2022.0,1,3,-2
HU,AT,2018.0,39,37,2
PK,RU,2020.0,9,19,-10
AU,OM,2012.0,2,2,0
NO,EE,2008.0,1,2,-1
NO,CN,2006.0,20,11,9
MA,DE,2016.0,4,11,-7
HR,IT,2015.0,3,7,-4
NC,FR,2003.0,6,6,0
IT,NZ,2018.0,11,5,6
GB,TN,2018.0,6,5,1
BR,TH,2018.0,6,4,2
nan,ES,2012.0,29,38,-9
CO,CU,2015.0,22,48,-26
LU,US,2019.0,17,28,-11
CU,AR,2014.0,18,18,0
NL,RS,2005.0,3,2,1
nan,CO,2018.0,12,11,1
RO,HU,2013.0,26,31,-5
IT,GR,2017.0,33,31,2
GB,PH,1999.0,10,8,2
CZ,PK,2018.0,6,8,-2
PL,CZ,2012.0,33,37,-4
MD,DE,2010.0,3,2,1
RO,DE,2013.0,30,44,-14
AT,FI,2000.0,3,1,2
ZA,CN,2005.0,6,2,4
CN,AR,2007.0,5,2,3
BG,US,2014.0,33,29,4
CI,FR,2009.0,16,16,0
SA,US,2023.0,9,12,-3
BH,KE,2000.0,1,1,0
NE,GH,2021.0,1,1,0
CN,PL,2021.0,23,16,7
IE,CH,2017.0,25,19,6
nan,SG,2012.0,10,8,2
RS,XK,2010.0,7,6,1
VE,CL,2008.0,21,13,8
IE,CH,2010.0,13,16,-3
XK,RS,2019.0,20,21,-1
PS,US,2008.0,7,5,2
US,TN,2011.0,10,19,-9
CG,FR,2007.0,14,9,5
NL,GR,2011.0,15,21,-6
ID,CN,2001.0,5,4,1
CL,IN,2018.0,12,10,2
TW,NZ,2012.0,5,12,-7
CN,YE,2022.0,8,2,6
IT,RU,2001.0,11,20,-9
BR,ZA,2018.0,23,15,8
SA,CH,2020.0,9,8,1
CZ,GR,2016.0,6,14,-8
CA,HU,2009.0,11,15,-4
CH,AE,2022.0,5,1,4
IN,GE,2018.0,2,2,0
SK,FI,2005.0,11,2,9
PL,IT,2013.0,31,22,9
GB,BN,2016.0,9,4,5
RU,MX,2010.0,3,9,-6
KH,JP,2007.0,4,5,-1
CA,MX,2005.0,22,24,-2
AR,UY,2019.0,56,49,7
US,CU,1999.0,7,13,-6
HU,SK,2015.0,7,11,-4
IQ,FR,2020.0,1,15,-14
PH,AU,2016.0,12,19,-7
PG,NL,2018.0,1,1,0
NL,AR,2018.0,5,7,-2
EG,MY,2019.0,38,66,-28
HR,CL,2018.0,1,1,0
RU,AT,2015.0,14,21,-7
nan,SI,2019.0,15,2,13
CZ,UZ,2014.0,6,4,2
KZ,RU,2007.0,9,8,1
MY,BE,2020.0,7,7,0
SI,CZ,2021.0,5,7,-2
BF,US,2006.0,2,2,0
LU,FR,2006.0,6,28,-22
CA,BG,2011.0,5,2,3
CN,SK,2006.0,4,2,2
GR,KW,2004.0,2,1,1
RO,PL,2020.0,13,12,1
EE,US,2022.0,9,6,3
UA,SE,2021.0,11,3,8
SG,PH,2020.0,14,20,-6
JO,IQ,2022.0,8,11,-3
AE,SA,2012.0,14,10,4
IN,NG,2015.0,12,8,4
NO,NZ,2020.0,6,5,1
AT,IR,2018.0,12,14,-2
SK,HU,2001.0,2,2,0
SK,JP,2000.0,12,8,4
EG,JO,2017.0,16,20,-4
ES,UA,2012.0,5,4,1
IE,CH,2019.0,23,10,13
ML,IN,2003.0,2,2,0
MT,GB,2003.0,5,2,3
CZ,IT,2016.0,26,33,-7
KW,GR,2018.0,3,2,1
AT,BE,2004.0,7,6,1
GB,MA,2011.0,5,3,2
SG,PL,2017.0,4,3,1
US,GH,2001.0,7,7,0
IN,LK,2012.0,7,12,-5
GH,BH,2020.0,21,25,-4
HK,CA,2007.0,2,1,1
FR,EG,2022.0,10,18,-8
BE,PL,2016.0,15,15,0
US,LV,2014.0,7,3,4
KR,MX,2016.0,4,2,2
PL,nan,2007.0,4,10,-6
MY,DZ,2018.0,2,2,0
AL,FR,2015.0,1,1,0
NZ,ZA,2019.0,12,27,-15
LB,CA,2015.0,11,18,-7
KR,PL,1999.0,1,1,0
AT,RS,2006.0,5,5,0
SA,NG,2006.0,3,1,2
NZ,BE,2020.0,4,3,1
AU,ES,2004.0,16,16,0
IT,IL,2012.0,20,6,14
KW,IN,2016.0,15,13,2
ZA,KR,2021.0,4,5,-1
AU,NG,2022.0,7,6,1
TW,AR,2009.0,11,5,6
BD,US,2006.0,21,57,-36
JO,CA,2010.0,5,12,-7
CH,PE,2022.0,2,2,0
CY,US,2003.0,5,11,-6
IN,BH,2006.0,1,2,-1
SE,IN,2000.0,8,17,-9
ZA,IE,2021.0,10,6,4
PH,GB,2015.0,21,16,5
GB,EC,2020.0,14,11,3
BR,CO,2003.0,15,16,-1
BR,LU,2015.0,3,4,-1
PL,KR,2002.0,3,1,2
DK,AU,2023.0,7,5,2
RU,BG,2014.0,18,40,-22
MX,BO,2014.0,4,5,-1
CU,UY,2004.0,3,2,1
BE,SE,2001.0,13,12,1
US,NG,2007.0,34,29,5
NZ,IE,2007.0,12,11,1
TT,JM,2001.0,7,5,2
SG,IE,2016.0,8,7,1
PA,AR,2006.0,2,3,-1
nan,CH,2006.0,13,11,2
AL,CN,2019.0,2,1,1
NG,UG,2020.0,10,4,6
AR,IL,2011.0,2,3,-1
GH,UG,2021.0,2,1,1
KR,SA,2021.0,8,9,-1
PK,DK,2014.0,1,4,-3
TT,NG,2011.0,1,1,0
GB,LB,2008.0,6,11,-5
HU,ES,2016.0,6,8,-2
IN,ZA,2004.0,10,8,2
XK,CN,2018.0,1,1,0
PA,AU,2016.0,3,2,1
BE,RW,2019.0,3,1,2
LU,KR,2020.0,1,4,-3
SE,ID,2019.0,15,4,11
IT,FI,2014.0,19,17,2
LB,IR,2020.0,2,2,0
FR,GF,2004.0,4,9,-5
KR,TW,2000.0,13,14,-1
TH,NL,2018.0,10,11,-1
TW,BD,2013.0,4,3,1
ML,US,2013.0,4,2,2
US,LY,2020.0,10,4,6
NL,TH,2010.0,6,8,-2
NZ,BD,2021.0,5,4,1
PH,PA,2013.0,1,1,0
KZ,DE,2012.0,3,4,-1
DE,AM,2022.0,5,2,3
NP,SE,2017.0,2,1,1
VN,NL,2019.0,5,10,-5
UZ,CZ,2016.0,10,3,7
KH,LT,2012.0,1,1,0
NG,EG,2017.0,5,9,-4
CL,NI,2012.0,2,1,1
IE,AT,2008.0,1,6,-5
RS,DK,2016.0,2,3,-1
BY,NL,2019.0,1,1,0
LY,GB,2018.0,4,27,-23
TH,ID,2021.0,23,35,-12
KZ,CA,2018.0,4,7,-3
ZA,ET,2013.0,4,4,0
ES,QA,2020.0,7,7,0
CZ,ES,2014.0,15,31,-16
AT,DK,2003.0,5,2,3
NO,FI,2009.0,7,18,-11
PH,PL,2003.0,7,1,6
GB,LY,2019.0,14,1,13
GB,ZW,2019.0,10,7,3
FR,MQ,2012.0,17,16,1
PF,FR,2012.0,3,10,-7
IE,IT,2008.0,12,24,-12
HU,JP,2013.0,8,18,-10
SE,CZ,2020.0,12,23,-11
NL,RS,2002.0,1,5,-4
BE,PK,2021.0,4,6,-2
MY,MM,2016.0,5,5,0
SE,IE,2019.0,20,13,7
SE,CN,2000.0,39,28,11
US,BY,2011.0,14,8,6
ES,RU,2009.0,9,18,-9
EG,NZ,2016.0,6,2,4
UY,CU,2004.0,2,3,-1
CY,SE,2022.0,2,1,1
EG,JO,2010.0,6,4,2
TW,CH,2019.0,16,8,8
FR,PF,2012.0,10,3,7
HU,EG,2009.0,4,2,2
SN,US,2001.0,2,4,-2
FR,CR,2022.0,2,4,-2
IR,NG,2013.0,5,6,-1
US,SN,2008.0,13,6,7
KZ,UZ,2022.0,11,10,1
ES,SV,2004.0,2,3,-1
UA,PT,2021.0,3,1,2
GB,AL,2011.0,1,1,0
VE,RU,2008.0,1,1,0
ID,BR,2013.0,7,4,3
DZ,DE,2014.0,1,2,-1
nan,BD,2018.0,5,3,2
BG,CN,2004.0,4,1,3
HU,IL,2018.0,7,3,4
PT,MZ,2017.0,2,3,-1
NZ,CH,2008.0,8,6,2
SN,CI,2011.0,3,1,2
AT,UA,2019.0,6,7,-1
PY,CU,2018.0,3,10,-7
IN,MT,2019.0,1,1,0
ME,DE,2017.0,1,1,0
SA,FR,2009.0,6,6,0
CN,EG,1999.0,1,1,0
DE,RO,2022.0,18,16,2
EG,OM,2022.0,12,7,5
JP,TN,2016.0,5,2,3
MW,US,2000.0,3,4,-1
BR,MZ,2020.0,15,16,-1
PT,CN,1997.0,2,3,-1
SE,ID,2010.0,4,1,3
US,CI,2011.0,4,2,2
NG,nan,2011.0,3,4,-1
ZA,CA,2023.0,2,1,1
HU,GB,2001.0,22,26,-4
MG,CA,2017.0,2,1,1
TZ,NO,2015.0,7,7,0
UG,RW,2018.0,3,1,2
DO,IT,2021.0,2,4,-2
TH,CA,2007.0,7,8,-1
TR,PL,2016.0,1,7,-6
BE,RW,2010.0,2,3,-1
HK,GB,2018.0,7,2,5
BE,MA,2014.0,3,6,-3
BD,NL,2011.0,4,2,2
nan,AE,2020.0,6,3,3
TR,SA,1998.0,3,2,1
LB,MA,2015.0,2,2,0
DE,PH,2010.0,10,4,6
NO,IE,2005.0,1,2,-1
FR,ET,2021.0,5,1,4
AT,nan,2007.0,8,11,-3
JP,VN,1999.0,7,5,2
SE,CL,2000.0,3,1,2
nan,CR,2016.0,3,3,0
NZ,ZA,2017.0,8,20,-12
TN,RU,2009.0,1,1,0
DK,BR,2008.0,4,6,-2
EC,CU,2014.0,3,18,-15
GR,KR,2014.0,2,1,1
TW,CH,2010.0,6,6,0
GT,AR,2017.0,5,6,-1
IN,DK,2006.0,8,5,3
PL,AU,2020.0,19,23,-4
MD,RU,2007.0,3,6,-3
CH,IE,2021.0,13,12,1
CZ,TR,2009.0,5,3,2
KR,PK,2005.0,2,1,1
FI,CZ,2002.0,3,3,0
OM,SD,2018.0,1,1,0
CG,BR,2017.0,1,2,-1
UY,CR,2015.0,1,1,0
EE,AU,2013.0,1,1,0
IT,TN,2001.0,1,2,-1
SE,PA,2013.0,2,2,0
AU,AT,2003.0,13,20,-7
NL,SA,2010.0,2,1,1
JP,RS,2000.0,6,3,3
MX,NI,2004.0,1,1,0
PG,US,2020.0,2,1,1
IE,BE,2006.0,5,4,1
NL,IL,2003.0,8,7,1
EG,IT,2013.0,8,6,2
EC,GB,2011.0,5,2,3
CA,CU,2011.0,1,4,-3
BH,IN,2009.0,2,2,0
QA,SD,2019.0,4,14,-10
CL,nan,2007.0,2,4,-2
DZ,US,2004.0,5,4,1
KZ,NL,2021.0,1,1,0
JM,FR,2006.0,1,1,0
BE,CW,2015.0,1,4,-3
TZ,DE,2014.0,5,2,3
SG,PL,2019.0,3,7,-4
JO,CA,2019.0,11,14,-3
TW,IL,2014.0,1,1,0
RU,IR,2016.0,12,7,5
IT,PE,2008.0,3,1,2
VE,HN,2018.0,2,2,0
ZA,CZ,2015.0,3,2,1
PH,TR,2015.0,2,3,-1
VN,TH,2007.0,3,1,2
nan,ZA,2020.0,8,7,1
XK,RS,2017.0,8,26,-18
KW,PK,2015.0,2,5,-3
US,GD,2020.0,14,27,-13
HR,ES,2019.0,4,3,1
IQ,SY,2020.0,4,3,1
GB,JE,2013.0,3,1,2
AT,KH,2019.0,1,1,0
CA,SI,2014.0,2,4,-2
nan,GH,2020.0,6,2,4
UY,UG,2018.0,1,1,0
DE,BG,1999.0,9,20,-11
FR,LK,2008.0,3,2,1
TR,MX,2015.0,3,2,1
CA,PT,1999.0,2,6,-4
CL,SE,2015.0,3,11,-8
MA,BR,2013.0,2,1,1
DE,AR,1997.0,7,12,-5
DK,NL,1998.0,16,16,0
MY,EG,2003.0,3,1,2
MD,DE,2019.0,6,4,2
SE,NI,2006.0,2,1,1
AU,NO,1999.0,4,6,-2
RU,AM,2005.0,3,8,-5
IE,BW,2015.0,1,1,0
BE,KE,1997.0,4,1,3
MY,SE,2011.0,3,1,2
SY,JO,2009.0,1,2,-1
GB,ID,2002.0,4,3,1
IT,LK,2006.0,1,1,0
ZA,DK,1998.0,2,1,1
DE,KW,2020.0,2,2,0
IT,SI,2009.0,10,7,3
BG,CA,2016.0,2,5,-3
CY,NL,2006.0,1,1,0
PL,SG,2020.0,1,4,-3
QA,TR,2018.0,7,9,-2
DE,VE,2013.0,2,3,-1
DE,CM,2018.0,9,6,3
GR,IE,2013.0,6,3,3
GR,GB,2023.0,4,6,-2
TH,IN,2011.0,3,12,-9
IN,BW,2012.0,2,3,-1
MX,VN,2009.0,4,3,1
BR,SV,2019.0,4,3,1
BF,FR,1999.0,4,2,2
SK,AT,2001.0,7,9,-2
AU,JP,2023.0,5,6,-1
nan,CA,2009.0,22,20,2
CN,CU,2012.0,2,1,1
RU,UZ,2006.0,16,7,9
AE,TN,2001.0,1,1,0
FR,NC,2014.0,15,17,-2
PL,HK,2014.0,1,1,0
BO,US,2007.0,4,10,-6
PT,IE,2005.0,1,1,0
MU,GB,2005.0,2,3,-1
CG,US,2019.0,2,3,-1
MY,IR,2009.0,5,32,-27
ES,NZ,2010.0,4,6,-2
TH,VN,2007.0,1,3,-2
BR,HR,2017.0,1,6,-5
CN,FI,2004.0,7,11,-4
NL,UA,2007.0,2,6,-4
PE,VE,2002.0,2,5,-3
SE,HR,2009.0,2,2,0
FI,CZ,2005.0,3,5,-2
CN,KE,2004.0,3,1,2
FI,GR,2017.0,4,6,-2
GM,GH,2020.0,2,1,1
IN,ZW,2021.0,3,1,2
CO,GB,1999.0,5,7,-2
IL,MY,2020.0,2,1,1
PK,TR,2010.0,3,5,-2
IL,IE,2013.0,3,2,1
AU,EC,2011.0,1,2,-1
NZ,CO,2009.0,1,2,-1
US,NC,2010.0,3,2,1
NZ,NG,2018.0,4,5,-1
PT,NZ,2009.0,4,2,2
MA,SE,2010.0,1,2,-1
CG,CH,2020.0,4,2,2
NP,NZ,2003.0,6,1,5
PA,ID,2014.0,2,2,0
TR,nan,2007.0,7,2,5
GR,BE,2009.0,10,15,-5
VE,BE,2019.0,2,1,1
ES,GT,2006.0,3,4,-1
NL,SA,2017.0,8,3,5
NP,MY,2018.0,4,4,0
NL,SK,2000.0,15,6,9
HR,BR,2016.0,2,4,-2
SG,LU,2017.0,2,2,0
SE,RS,2015.0,2,4,-2
US,GT,2007.0,3,6,-3
ZA,CN,2002.0,3,3,0
RU,LT,2004.0,4,2,2
BE,TW,1998.0,2,1,1
DK,LB,2019.0,3,1,2
CA,NP,2018.0,7,7,0
TR,UG,2020.0,1,1,0
AU,SA,2003.0,4,2,2
RU,BH,2021.0,1,8,-7
SI,BA,2014.0,2,8,-6
IS,GB,2018.0,4,5,-1
MK,IN,2021.0,2,2,0
BO,CL,2009.0,2,3,-1
DK,KR,2002.0,1,1,0
GB,CU,2011.0,3,3,0
CY,DK,2017.0,1,1,0
CA,TH,2008.0,14,10,4
TN,MD,2014.0,5,18,-13
LK,AU,2004.0,4,1,3
VN,SE,2012.0,2,2,0
GH,IT,2021.0,3,2,1
VN,MX,1999.0,1,2,-1
DK,CZ,2021.0,2,4,-2
PK,PT,2021.0,1,1,0
QA,ZA,2022.0,1,1,0
BO,GB,2009.0,2,1,1
IT,EC,2012.0,4,1,3
NP,NG,2014.0,1,2,-1
CO,BO,2013.0,4,5,-1
EE,AT,2018.0,2,4,-2
GR,BR,2021.0,2,3,-1
DZ,FI,2016.0,1,1,0
PE,AU,2020.0,3,3,0
SI,IT,2008.0,7,7,0
AM,KZ,2021.0,2,2,0
KR,MY,2004.0,3,4,-1
KE,NZ,2010.0,3,2,1
GR,IL,2003.0,2,2,0
HR,NL,2002.0,2,2,0
IT,VE,2009.0,3,14,-11
CA,CL,1998.0,2,3,-1
ZA,BD,2017.0,1,2,-1
HU,BY,2011.0,1,2,-1
DK,LB,2017.0,1,2,-1
BR,LB,2009.0,3,5,-2
VE,BR,2000.0,6,5,1
JP,NG,2001.0,3,2,1
MY,JP,2000.0,7,8,-1
BA,US,2013.0,5,4,1
KR,PT,2020.0,1,1,0
IN,LB,2013.0,4,2,2
IT,EG,2007.0,6,8,-2
SN,MD,2004.0,1,1,0
IT,UY,2003.0,3,2,1
BR,IR,2006.0,1,3,-2
CZ,SI,2015.0,4,17,-13
FI,KE,2012.0,1,1,0
PT,TR,2007.0,1,1,0
CN,MY,2023.0,7,7,0
SK,nan,2011.0,3,1,2
FI,IE,2006.0,2,4,-2
IN,nan,2001.0,1,12,-11
JO,LY,2017.0,2,1,1
RS,BE,2018.0,1,4,-3
HU,KR,2022.0,1,1,0
PL,BY,2013.0,4,6,-2
ZA,KE,1998.0,1,5,-4
AE,GR,2018.0,2,12,-10
VE,BE,2010.0,2,1,1
AU,KE,1998.0,1,1,0
PT,SG,2013.0,5,1,4
FI,NZ,2008.0,1,3,-2
TN,KW,2007.0,2,1,1
UA,BG,2011.0,3,4,-1
BG,NL,2004.0,1,3,-2
CA,NG,2010.0,5,7,-2
CH,BD,1999.0,2,1,1
MA,FR,2023.0,2,4,-2
HR,AT,2016.0,11,4,7
IL,HU,2008.0,2,4,-2
AT,ET,2020.0,2,2,0
DE,DZ,2004.0,2,2,0
MY,DE,2008.0,7,7,0
DE,PT,2001.0,6,8,-2
EE,FI,1999.0,2,3,-1
IE,EG,2001.0,1,1,0
CA,PA,2016.0,6,2,4
GB,JM,1999.0,1,4,-3
ZA,nan,2001.0,1,1,0
TN,PK,2022.0,1,4,-3
SD,NO,2017.0,1,1,0
MM,AU,2005.0,1,1,0
NZ,RU,2018.0,4,4,0
CR,MX,1999.0,3,1,2
BR,SV,2017.0,3,1,2
SA,DK,2021.0,5,1,4
CY,KH,2021.0,2,2,0
CN,GR,2003.0,4,5,-1
TT,CA,2020.0,5,4,1
MK,CA,2013.0,1,3,-2
MX,UA,2007.0,2,3,-1
EG,KE,2010.0,1,2,-1
AE,FI,2018.0,1,2,-1
US,PS,2022.0,5,7,-2
CY,MY,2018.0,1,1,0
RW,KR,2022.0,1,2,-1
LK,NL,2013.0,1,1,0
KR,IT,2004.0,2,3,-1
TR,ZA,2008.0,2,1,1
CA,LK,2014.0,4,1,3
BE,RW,2017.0,2,1,1
PK,OM,2020.0,4,15,-11
LU,US,2010.0,8,18,-10
VE,BO,2017.0,1,2,-1
MY,TZ,2017.0,2,3,-1
CH,LB,2013.0,5,3,2
AR,SV,2014.0,2,1,1
PT,MZ,2010.0,2,1,1
FR,KE,2011.0,7,12,-5
PT,HR,2015.0,1,1,0
DE,BJ,2013.0,1,1,0
GB,UY,2015.0,6,3,3
TG,US,2019.0,2,2,0
MY,MX,2013.0,1,1,0
BG,DK,2020.0,4,6,-2
GB,KG,2012.0,4,1,3
KR,QA,2022.0,3,3,0
FR,MT,2012.0,1,1,0
MD,CN,2012.0,2,3,-1
UY,GB,2022.0,2,1,1
GB,PE,2007.0,3,5,-2
TR,AE,2014.0,6,1,5
ZA,TR,2011.0,4,4,0
RO,IQ,2019.0,3,1,2
US,NA,1998.0,2,1,1
BG,ZA,2006.0,1,1,0
CO,EC,2003.0,2,1,1
CH,CL,2006.0,3,3,0
PK,NP,2012.0,2,3,-1
PL,QA,2015.0,1,1,0
GT,AR,2019.0,2,4,-2
VE,CU,2000.0,4,4,0
GB,IS,2003.0,2,4,-2
UA,TJ,2019.0,6,1,5
ZM,ID,2020.0,1,1,0
RU,AM,2002.0,3,2,1
SK,BG,2007.0,1,1,0
AR,HN,2012.0,2,2,0
nan,GE,2016.0,3,2,1
RS,CH,2006.0,1,7,-6
JP,CM,2011.0,3,1,2
BG,FI,2017.0,1,1,0
EE,ID,2019.0,1,3,-2
CL,EC,2003.0,3,2,1
NZ,CL,2014.0,3,8,-5
AR,VE,2022.0,5,6,-1
US,NC,2019.0,2,2,0
GA,DE,2012.0,3,5,-2
LU,CA,2008.0,1,2,-1
ID,SG,2009.0,2,2,0
NG,EG,2019.0,5,8,-3
VG,GB,2006.0,2,3,-1
UZ,MY,2008.0,1,1,0
CG,US,2010.0,1,1,0
RW,ZA,2016.0,6,5,1
SK,IN,2017.0,2,4,-2
VN,PL,2019.0,2,5,-3
AU,BG,2012.0,5,2,3
SI,DK,2022.0,1,5,-4
UG,FI,2020.0,2,1,1
SN,MA,2015.0,1,2,-1
BG,FI,2010.0,1,1,0
NG,ZW,1998.0,2,1,1
BN,GB,2004.0,1,5,-4
SV,BR,2016.0,1,1,0
NP,TW,2012.0,1,2,-1
LT,NL,2001.0,1,1,0
KZ,MX,2018.0,1,1,0
VN,GB,1997.0,2,1,1
ET,CA,2007.0,2,2,0
DE,CW,2005.0,1,1,0
BE,UA,2000.0,1,1,0
CD,CG,2017.0,1,2,-1
CH,LV,2003.0,1,1,0
DK,BY,2002.0,1,2,-1
FI,TH,2012.0,3,4,-1
EE,ID,2017.0,2,9,-7
NL,GH,2011.0,1,1,0
PT,DZ,2015.0,1,2,-1
KE,TW,2018.0,1,2,-1
GR,AT,2004.0,3,3,0
TZ,BE,2012.0,4,3,1
BW,LS,2016.0,1,1,0
ER,US,2017.0,1,1,0
AR,nan,1997.0,4,7,-3
CR,JP,2017.0,1,1,0
LV,JP,2007.0,2,2,0
CA,UA,2004.0,6,7,-1
ZA,CO,2006.0,1,1,0
GH,BR,2014.0,1,1,0
UA,NO,2006.0,1,1,0
LK,IT,2018.0,1,2,-1
TR,SA,1997.0,1,1,0
BR,GT,2020.0,3,5,-2
FR,CI,1997.0,2,2,0
PE,SV,2013.0,1,1,0
TZ,CH,2006.0,1,1,0
IN,AR,2012.0,2,1,1
GT,BR,2014.0,1,1,0
LI,US,2018.0,1,2,-1
RO,CO,2013.0,1,1,0
ZA,OM,2008.0,1,1,0
BE,CD,2008.0,2,1,1
PH,TW,2009.0,1,2,-1
IN,MK,2012.0,1,1,0
ME,DE,2019.0,1,2,-1
ES,CA,2023.0,2,2,0
AL,SE,2000.0,1,2,-1
RS,CL,2006.0,2,4,-2
LU,AR,2016.0,1,1,0
RS,RU,1999.0,2,2,0
CA,VG,2010.0,2,1,1
TL,BR,2018.0,1,3,-2
PT,CZ,2020.0,7,6,1
IL,CZ,2013.0,3,2,1
BR,AF,2014.0,2,1,1
SK,FI,2002.0,1,6,-5
ES,CZ,1997.0,3,1,2
US,SV,2009.0,1,1,0
BW,FR,2019.0,1,1,0
BI,US,2012.0,2,4,-2
TH,IL,2013.0,1,1,0
TH,LA,2020.0,2,1,1
CZ,MX,2000.0,1,1,0
BY,nan,2020.0,2,1,1
BJ,PH,2014.0,2,1,1
ES,LU,2010.0,2,3,-1
FR,SG,2004.0,2,6,-4
AU,BN,2017.0,1,2,-1
VN,PH,2018.0,2,3,-1
HR,NL,2005.0,3,3,0
NL,HK,1999.0,2,1,1
EG,BE,2011.0,3,1,2
GR,HU,2020.0,2,1,1
LB,SY,2011.0,1,1,0
TG,US,2010.0,1,1,0
PL,NZ,2008.0,3,2,1
SE,SI,2021.0,3,1,2
ID,KR,2007.0,2,3,-1
BJ,TZ,2017.0,2,1,1
MA,NE,2020.0,4,1,3
NO,LU,2014.0,1,1,0
IT,RE,2011.0,1,1,0
SG,IL,2022.0,2,2,0
SA,CM,2018.0,1,1,0
TG,US,2017.0,1,2,-1
AG,BE,2018.0,1,1,0
SG,ZA,2004.0,1,3,-2
AT,NO,2023.0,2,1,1
JP,EC,2017.0,1,1,0
GB,FJ,2007.0,1,1,0
PA,GB,2021.0,3,7,-4
RU,IE,2011.0,2,7,-5
FR,CA,2003.0,333,261,72
GB,DE,2016.0,897,974,-77
ZA,AU,2012.0,74,70,4
VG,US,2004.0,8,5,3
KR,US,2001.0,551,596,-45
CN,JP,2004.0,339,522,-183
FI,NL,2010.0,39,29,10
FI,NL,2019.0,47,30,17
TW,CA,2010.0,31,41,-10
CN,SE,2010.0,69,86,-17
US,PL,2018.0,270,305,-35
DK,GB,2014.0,121,151,-30
US,PH,1998.0,155,189,-34
EC,CL,2020.0,75,89,-14
GB,KR,2006.0,55,61,-6
ST,BR,2016.0,43,22,21
FR,ES,2015.0,289,369,-80
AU,LK,2018.0,28,52,-24
nan,US,2017.0,273,294,-21
NL,TH,2019.0,10,7,3
EG,SG,2017.0,5,2,3
US,PE,2019.0,150,151,-1
CN,QA,2010.0,24,14,10
CN,IN,2002.0,35,43,-8
CN,ID,2014.0,59,74,-15
JP,ID,2019.0,255,177,78
VE,PA,2016.0,4,1,3
US,VG,1999.0,9,2,7
ES,SE,2018.0,106,55,51
CN,SE,2017.0,120,144,-24
DE,SK,2015.0,37,33,4
US,LB,2018.0,89,96,-7
KR,IN,2012.0,111,186,-75
DK,SE,2016.0,139,134,5
PK,SA,2006.0,10,18,-8
US,EC,2020.0,105,123,-18
ET,FI,2017.0,1,4,-3
RO,CH,2015.0,14,9,5
GB,DZ,2019.0,14,3,11
CR,ES,2012.0,51,34,17
HU,MY,2015.0,1,1,0
IN,RO,2018.0,19,9,10
NG,GB,2015.0,61,82,-21
MA,ES,2016.0,9,17,-8
CL,CA,2013.0,15,23,-8
AU,KR,2014.0,42,47,-5
PT,ES,2006.0,73,81,-8
ZA,ZM,2016.0,13,6,7
CN,CL,2014.0,1,3,-2
PK,DE,2011.0,16,13,3
ID,EG,2018.0,22,38,-16
IT,AU,2017.0,83,52,31
EG,US,2020.0,296,364,-68
PA,BR,2015.0,3,2,1
MA,SE,2019.0,3,2,1
FI,NL,2017.0,38,41,-3
SK,CA,2009.0,5,4,1
AU,ZA,2004.0,28,32,-4
JP,DE,2022.0,91,80,11
TN,SY,2019.0,2,2,0
RU,TW,2010.0,14,14,0
JP,HU,2015.0,9,13,-4
DK,KR,2005.0,2,1,1
GB,KE,2014.0,47,22,25
KZ,IT,2020.0,1,1,0
IN,FI,2013.0,16,13,3
BR,HR,2010.0,2,2,0
SG,MM,2021.0,2,7,-5
RU,MX,2017.0,6,14,-8
IR,DK,2020.0,40,19,21
CZ,JP,2011.0,14,16,-2
BR,ID,2015.0,10,7,3
NL,TH,2017.0,11,4,7
JP,ET,2008.0,6,1,5
PT,PL,2016.0,5,4,1
GR,FR,1999.0,7,13,-6
GB,LY,2010.0,5,4,1
NO,CZ,2013.0,11,3,8
SE,SG,2006.0,6,4,2
GB,OM,2006.0,10,2,8
NZ,ZA,2010.0,16,10,6
BE,RU,1997.0,10,7,3
DK,IE,2006.0,4,4,0
NO,TR,2021.0,7,7,0
US,IS,2013.0,21,11,10
VE,MX,2002.0,11,8,3
VE,PE,2002.0,5,2,3
US,OM,2014.0,16,8,8
ES,NZ,2019.0,15,3,12
SE,IS,2010.0,18,16,2
DE,ET,2013.0,10,3,7
XK,RS,2010.0,6,7,-1
TW,FI,2015.0,1,2,-1
FR,LT,2017.0,6,7,-1
CZ,IN,2016.0,12,26,-14
PT,CN,1998.0,4,2,2
NI,CA,2013.0,1,2,-1
BR,PH,2019.0,16,15,1
BR,NZ,2020.0,24,9,15
US,AF,2020.0,2,3,-1
BG,DE,2003.0,18,17,1
AT,UA,2017.0,6,6,0
MT,US,2011.0,3,5,-2
HU,IE,2016.0,2,2,0
BE,RU,1998.0,9,13,-4
BE,LV,2020.0,3,3,0
BE,KE,1998.0,5,1,4
NO,IT,2007.0,19,15,4
RS,XK,2019.0,21,20,1
AM,JP,2005.0,6,5,1
IR,TR,2014.0,35,19,16
PL,CH,1997.0,8,11,-3
US,MA,2009.0,12,13,-1
CV,PT,2020.0,2,1,1
BD,NP,2019.0,6,3,3
RU,ZA,2022.0,3,6,-3
LU,CH,2021.0,4,6,-2
NG,TR,2020.0,11,6,5
NO,KR,2002.0,5,1,4
PK,EG,2013.0,10,9,1
MC,GB,2011.0,1,1,0
BW,US,2009.0,7,11,-4
BF,DE,1998.0,1,1,0
EE,ID,2010.0,1,1,0
IT,GR,2010.0,22,21,1
PL,IR,2009.0,3,1,2
BJ,FR,2020.0,22,25,-3
SE,MA,2018.0,2,3,-1
MY,TZ,2019.0,3,1,2
SE,IE,2010.0,11,20,-9
FI,DZ,2020.0,1,3,-2
QA,GR,2018.0,2,1,1
ES,AU,1998.0,7,8,-1
CN,QA,2019.0,28,31,-3
ES,IS,2016.0,6,6,0
RE,US,2020.0,2,3,-1
VN,PL,2017.0,3,3,0
AE,DE,2011.0,3,5,-2
PL,CH,1998.0,9,11,-2
BD,NP,2017.0,5,6,-1
PE,AT,2012.0,1,2,-1
CZ,BR,2022.0,4,15,-11
PL,TR,2021.0,5,9,-4
RU,KZ,2001.0,8,6,2
LT,RU,1999.0,2,3,-1
FR,LT,2010.0,3,5,-2
GB,ZW,2010.0,2,2,0
SE,TR,2003.0,2,2,0
FR,PL,2023.0,1,2,-1
PL,KR,2005.0,1,1,0
SK,IN,2019.0,5,3,2
AT,IE,2005.0,2,4,-2
AM,GB,2013.0,3,2,1
BE,CY,2012.0,2,1,1
IT,SY,2018.0,1,1,0
RO,BE,2009.0,7,8,-1
PK,FI,2016.0,4,4,0
VN,NL,2017.0,4,11,-7
BE,ET,2019.0,6,9,-3
US,MD,2011.0,3,1,2
nan,RU,2023.0,1,1,0
EE,UA,2021.0,1,1,0
BD,NZ,2021.0,4,5,-1
FI,RO,2003.0,1,1,0
BR,SA,2009.0,3,1,2
PA,PT,2016.0,1,2,-1
FJ,NZ,2018.0,4,3,1
TR,PH,2018.0,1,1,0
FR,LT,2019.0,3,2,1
UA,MZ,2010.0,1,3,-2
QA,LB,2020.0,1,7,-6
VE,DE,1999.0,2,2,0
UA,SG,2013.0,1,1,0
KW,IE,2010.0,2,1,1
PT,IE,2002.0,2,2,0
HR,ES,2017.0,3,2,1
ID,NG,2011.0,2,2,0
AM,KR,2001.0,6,8,-2
CG,US,2017.0,3,2,1
FI,IL,2018.0,4,2,2
GR,PL,2015.0,2,5,-3
ZA,KE,1997.0,1,2,-1
CG,ZA,2016.0,1,1,0
TR,HU,2008.0,1,1,0
RO,AR,2011.0,1,1,0
VN,NL,2010.0,2,4,-2
GE,CN,2011.0,3,2,1
AU,TR,1998.0,3,1,2
SK,ES,2012.0,1,2,-1
NI,US,2013.0,5,3,2
SE,UG,2008.0,2,2,0
CH,MA,1999.0,2,1,1
RS,UZ,2012.0,1,4,-3
CD,FR,2012.0,2,1,1
IT,KR,2005.0,3,2,1
GH,GB,2020.0,32,33,-1
HT,FR,2021.0,3,1,2
IT,TR,2017.0,15,23,-8
BG,ES,2018.0,3,3,0
US,KE,2013.0,62,61,1
TR,IR,2022.0,12,38,-26
ET,JP,2014.0,2,3,-1
PY,CL,2022.0,2,7,-5
EG,CA,2001.0,3,12,-9
NL,ET,2012.0,2,4,-2
WS,US,2018.0,3,1,2
nan,SI,2010.0,2,3,-1
TW,CA,2019.0,41,45,-4
DE,AE,2016.0,12,6,6
CN,,2017.0,44881,0,44881
DK,,2024.0,17024,0,17024
BR,,2020.0,20232,0,20232
CN,,2019.0,20888,0,20888
DE,,2022.0,37012,0,37012
,IL,2005.0,2290,0,2290
NO,,2001.0,278,0,278
AR,,2016.0,1352,0,1352
CN,,2010.0,19822,0,19822
NG,,2020.0,2108,0,2108
PL,,2020.0,7820,0,7820
,EG,2008.0,2823,0,2823
,TR,2018.0,6990,0,6990
,GB,2009.0,18017,0,18017
,MX,2015.0,5558,0,5558
SG,,2019.0,1374,0,1374
,CO,1994.0,701,0,701
RO,SE,2005.0,2,0,2
,HR,2011.0,942,0,942
,ZA,2010.0,2717,0,2717
,IL,2002.0,2253,0,2253
FR,,2001.0,4042,0,4042
PT,,2011.0,399,0,399
SG,,2010.0,491,0,491
TW,,2003.0,720,0,720
,RU,2011.0,9531,0,9531
PK,,2007.0,85,0,85
LV,PL,2002.0,3,0,3
,SG,1999.0,808,0,808
GT,,2022.0,123,0,123
,GR,2013.0,2423,0,2423
JO,,2018.0,225,0,225
,NP,2016.0,519,0,519
TN,,2023.0,4792,0,4792
,MY,2014.0,4362,0,4362
BD,,2002.0,16,0,16
,ID,2005.0,1562,0,1562
FI,,2025.0,1131,0,1131
SG,,2017.0,1009,0,1009
,MK,2010.0,201,0,201
,OM,2004.0,90,0,90
,LB,2011.0,371,0,371
CD,,2020.0,151,0,151
,BG,1995.0,863,0,863
MY,,2025.0,1158,0,1158
CM,,2024.0,2231,0,2231
,ID,2002.0,712,0,712
SV,,2019.0,59,0,59
CZ,GH,2021.0,9,0,9
,ZA,2017.0,2291,0,2291
,UY,2006.0,227,0,227
,MK,2017.0,130,0,130
,TH,2006.0,1846,0,1846
MX,,2003.0,335,0,335
AF,,2024.0,136,0,136
NZ,QA,2000.0,1,0,1
FR,IS,2004.0,2,0,2
,MT,2008.0,42,0,42
MT,,2016.0,30,0,30
PA,,2015.0,36,0,36
,ET,2008.0,245,0,245
,UG,2000.0,100,0,100
,QA,2009.0,245,0,245
AE,,2018.0,245,0,245
,RS,2016.0,628,0,628
,RO,1999.0,473,0,473
,ZA,2019.0,1224,0,1224
HK,,2011.0,33,0,33
,VN,2016.0,659,0,659
,BY,2015.0,304,0,304
IR,,2007.0,261,0,261
,MW,2007.0,44,0,44
,JO,2008.0,412,0,412
CL,,2003.0,146,0,146
,KG,2010.0,29,0,29
,CD,2012.0,197,0,197
GH,,2021.0,455,0,455
MD,,2018.0,68,0,68
,GP,2015.0,18,0,18
,SK,2000.0,433,0,433
TR,GR,2022.0,4,0,4
,BH,2013.0,73,0,73
,AM,2013.0,133,0,133
,KE,2018.0,635,0,635
SA,PG,2019.0,1,0,1
NL,EC,2009.0,1,0,1
,IQ,2007.0,200,0,200
,CI,1998.0,41,0,41
DJ,PK,2014.0,1,0,1
,LI,2015.0,6,0,6
,LA,2008.0,12,0,12
TJ,,2025.0,27,0,27
IQ,,2009.0,18,0,18
,OM,1996.0,72,0,72
,KG,2017.0,83,0,83
,SN,2009.0,139,0,139
,NI,2015.0,34,0,34
CU,AT,2021.0,1,0,1
EC,MY,2022.0,1,0,1
,MM,2009.0,31,0,31
,GA,2013.0,48,0,48
KW,,2011.0,88,0,88
RW,,2024.0,421,0,421
GP,,2023.0,67,0,67
,ML,2017.0,40,0,40
,MK,2019.0,36,0,36
CY,LY,2018.0,1,0,1
KE,SA,2022.0,3,0,3
HU,KZ,2020.0,3,0,3
NG,PS,2019.0,1,0,1
MA,GA,2020.0,1,0,1
SD,IN,2000.0,1,0,1
CI,CN,2019.0,5,0,5
,CI,1997.0,51,0,51
EG,,2026.0,15,0,15
SY,,2023.0,408,0,408
,MD,2001.0,59,0,59
ES,LV,2020.0,4,0,4
CO,HU,2020.0,5,0,5
CR,,2014.0,72,0,72
,CW,2018.0,8,0,8
SM,,2017.0,6,0,6
ME,SI,2018.0,1,0,1
CA,BI,2017.0,1,0,1
PK,NZ,1999.0,1,0,1
,MU,1997.0,26,0,26
NP,SE,2010.0,2,0,2
,ML,2010.0,59,0,59
BD,,2005.0,28,0,28
DE,ML,2006.0,2,0,2
PS,,2015.0,41,0,41
UG,,2012.0,55,0,55
AR,LU,2013.0,1,0,1
nan,UG,2016.0,5,0,5
SG,CU,2020.0,1,0,1
DJ,EG,2016.0,1,0,1
JM,BH,2017.0,1,0,1
QA,,2006.0,13,0,13
,GT,2008.0,23,0,23
NP,NO,1999.0,1,0,1
,GD,1994.0,2,0,2
IL,LV,2007.0,2,0,2
SV,,2017.0,13,0,13
,ER,2005.0,5,0,5
IN,QA,2013.0,20,0,20
GL,,2025.0,1,0,1
HN,GB,2016.0,2,0,2
VN,,2007.0,28,0,28
ID,UG,2019.0,1,0,1
MT,CO,2017.0,1,0,1
,NE,2008.0,25,0,25
CA,TD,2011.0,1,0,1
SR,BE,2022.0,1,0,1
GH,ET,2018.0,2,0,2
KW,CN,2019.0,3,0,3
,MU,1998.0,21,0,21
CM,NO,2020.0,1,0,1
AU,KZ,1999.0,1,0,1
BI,,2012.0,5,0,5
ML,,2015.0,21,0,21
ZW,,2006.0,16,0,16
LK,DE,2007.0,3,0,3
MX,MZ,2018.0,2,0,2
,PG,1997.0,34,0,34
NO,IE,2002.0,2,0,2
,BW,2007.0,61,0,61
DK,LB,2010.0,1,0,1
SK,AU,2008.0,4,0,4
,PG,1998.0,23,0,23
GY,,2019.0,3,0,3
NG,CD,2012.0,1,0,1
MU,,2008.0,7,0,7
IL,RS,2013.0,1,0,1
AL,IN,2013.0,2,0,2
MW,KH,2013.0,1,0,1
BS,,2023.0,27,0,27
LR,,2015.0,2,0,2
RO,ZA,1998.0,1,0,1
CF,FR,2012.0,3,0,3
IT,KW,2017.0,3,0,3
SM,BR,2014.0,1,0,1
BE,BD,2001.0,1,0,1
OM,CA,2004.0,4,0,4
FI,TW,2020.0,3,0,3
ZM,CN,2016.0,1,0,1
PL,TW,2019.0,7,0,7
CD,ID,2016.0,3,0,3
NZ,BT,2020.0,4,0,4
CW,,1999.0,2,0,2
HR,CN,2012.0,2,0,2
JP,EE,2006.0,2,0,2
CR,AU,2012.0,3,0,3
ES,KW,2010.0,2,0,2
GA,,2025.0,7,0,7
IR,TH,2012.0,4,0,4
CI,,2009.0,26,0,26
GH,BJ,2016.0,1,0,1
MY,KN,2014.0,1,0,1
BR,QA,2022.0,3,0,3
HK,PT,2017.0,2,0,2
KG,ES,2020.0,1,0,1
,KG,2019.0,108,0,108
PH,NZ,2014.0,1,0,1
CY,AT,2017.0,1,0,1
ES,KN,2022.0,1,0,1
,VG,2013.0,18,0,18
CU,SE,2004.0,4,0,4
PA,IR,2014.0,1,0,1
IT,SD,2012.0,2,0,2
MQ,,2011.0,8,0,8
MY,UG,2019.0,3,0,3
PE,HU,2019.0,4,0,4
CR,KE,2016.0,2,0,2
US,MN,2013.0,4,0,4
AL,CZ,2016.0,2,0,2
,AL,1999.0,13,0,13
TN,FR,2023.0,6,0,6
LV,IN,2012.0,1,0,1
KH,NC,2017.0,1,0,1
BH,DK,2009.0,1,0,1
VA,,2022.0,3,0,3
CA,BW,2007.0,1,0,1
KH,SE,2012.0,1,0,1
MV,,2020.0,3,0,3
LI,CO,2020.0,1,0,1
YE,JP,2011.0,1,0,1
US,GM,1997.0,2,0,2
PL,UY,2009.0,1,0,1
IT,MW,2011.0,1,0,1
VN,FO,2014.0,1,0,1
KR,RO,2008.0,2,0,2
GW,BE,2004.0,1,0,1
ML,JP,2007.0,3,0,3
KE,MA,2009.0,1,0,1
ES,VN,1997.0,1,0,1
GY,,2010.0,2,0,2
IR,RO,2022.0,3,0,3
GB,GT,2019.0,5,0,5
SN,ID,2016.0,2,0,2
GB,UZ,2006.0,1,0,1
SZ,NG,2005.0,1,0,1
SZ,,2008.0,2,0,2
JO,QA,1998.0,3,0,3
ZA,BD,2019.0,2,0,2
IT,DZ,2023.0,2,0,2
BN,,2012.0,4,0,4
PL,SI,2008.0,3,0,3
,ML,2019.0,23,0,23
GY,,2017.0,6,0,6
IL,BG,2020.0,2,0,2
NO,QA,2021.0,2,0,2
SI,CN,1998.0,1,0,1
CO,MZ,2001.0,1,0,1
CR,ID,2012.0,1,0,1
US,GY,2011.0,1,0,1
CN,SA,2005.0,2,0,2
UG,CY,2016.0,2,0,2
TH,NP,2011.0,5,0,5
KH,NL,2004.0,2,0,2
CG,ZW,2012.0,1,0,1
MA,MD,2015.0,1,0,1
CN,BI,2013.0,2,0,2
JM,NG,2012.0,2,0,2
SL,,2018.0,8,0,8
CA,MG,2007.0,1,0,1
LT,BE,2015.0,3,0,3
MA,BF,2020.0,2,0,2
TZ,IT,2008.0,1,0,1
IT,BH,2019.0,2,0,2
HU,GE,2011.0,3,0,3
BI,BF,2004.0,1,0,1
LK,PT,2007.0,1,0,1
BS,AU,2022.0,1,0,1
BE,MK,2015.0,2,0,2
TR,CO,2014.0,4,0,4
FI,HR,2012.0,1,0,1
,ER,2002.0,5,0,5
CI,TG,2020.0,1,0,1
LK,BE,2004.0,1,0,1
RU,ET,2022.0,4,0,4
VN,CY,2017.0,1,0,1
PG,nan,1998.0,1,0,1
BF,,2005.0,4,0,4
PT,SN,2004.0,1,0,1
PS,JP,2015.0,1,0,1
CU,JM,2014.0,1,0,1
AM,RO,2006.0,1,0,1
PE,VE,2005.0,4,0,4
BO,NI,2011.0,3,0,3
MY,KH,2014.0,1,0,1
EE,KZ,2018.0,3,0,3
AE,HU,2004.0,2,0,2
AT,UA,2010.0,2,0,2
IT,NI,2008.0,1,0,1
,MS,2008.0,4,0,4
MA,KR,2022.0,1,0,1
JO,YE,2016.0,2,0,2
XK,SI,2010.0,2,0,2
MS,GB,2012.0,1,0,1
CH,GP,2008.0,3,0,3
JP,IQ,2001.0,2,0,2
AM,SE,2006.0,1,0,1
BH,AG,2006.0,1,0,1
CH,AF,2005.0,1,0,1
MX,SI,2023.0,3,0,3
TT,AU,2022.0,2,0,2
LU,UG,2008.0,2,0,2
RW,ZM,2022.0,1,0,1
PE,nan,1999.0,2,0,2
NO,ZM,2011.0,1,0,1
GH,BD,2009.0,1,0,1
AU,IS,2009.0,3,0,3
CF,,2001.0,1,0,1
NL,MZ,2018.0,1,0,1
TJ,PK,2021.0,1,0,1
SK,GH,2008.0,1,0,1
NG,ZW,1997.0,1,0,1
HR,TN,2003.0,1,0,1
MY,UG,2010.0,1,0,1
SJ,,2009.0,2,0,2
KW,NL,2013.0,4,0,4
GR,SK,2008.0,2,0,2
BB,,2012.0,4,0,4
PA,FI,2013.0,1,0,1
FJ,,1998.0,3,0,3
CU,BO,2003.0,1,0,1
IL,KE,2006.0,1,0,1
PH,NL,2001.0,1,0,1
SG,ID,1999.0,1,0,1
BE,RE,2011.0,2,0,2
BF,,2002.0,4,0,4
GB,SD,2000.0,1,0,1
MK,,2007.0,10,0,10
EC,NO,2021.0,2,0,2
CN,SI,1997.0,1,0,1
CH,ET,2021.0,3,0,3
SY,ID,2018.0,2,0,2
YE,,2013.0,13,0,13
RO,SA,2021.0,1,0,1
UG,MZ,2015.0,1,0,1
HU,LU,2010.0,4,0,4
MY,FI,2009.0,2,0,2
FI,KY,2009.0,1,0,1
CY,AE,2014.0,2,0,2
MA,HR,2015.0,1,0,1
WS,,2006.0,1,0,1
AO,AR,2020.0,1,0,1
US,KY,2007.0,1,0,1
SY,HU,2014.0,2,0,2
JO,LY,2019.0,4,0,4
AM,FI,2008.0,1,0,1
UY,PT,2005.0,1,0,1
KZ,AU,2003.0,1,0,1
,AF,2008.0,5,0,5
SY,DE,2022.0,1,0,1
CU,RU,2021.0,2,0,2
TW,BN,2015.0,2,0,2
HU,SE,2023.0,1,0,1
SE,TZ,2001.0,2,0,2
BD,NP,2010.0,4,0,4
,FO,1994.0,5,0,5
CD,CG,2019.0,3,0,3
MK,DE,2021.0,2,0,2
TN,LB,2009.0,1,0,1
TT,,2003.0,4,0,4
GR,PT,2006.0,1,0,1
BN,EG,2022.0,1,0,1
SL,LA,2019.0,1,0,1
JO,QA,1997.0,1,0,1
TH,UA,2018.0,1,0,1
,IM,2001.0,1,0,1
IT,LU,2013.0,4,0,4
DE,LI,2000.0,6,0,6
CW,MY,2021.0,1,0,1
BG,nan,2022.0,1,0,1
BH,,2004.0,6,0,6
ZW,KE,2005.0,1,0,1
US,SC,2013.0,2,0,2
IT,AE,1999.0,1,0,1
KZ,BY,2011.0,1,0,1
PS,AE,2005.0,2,0,2
FR,MW,2006.0,1,0,1
AE,ZA,2006.0,1,0,1
ES,AM,1997.0,1,0,1
SE,BF,2009.0,1,0,1
JM,KY,2006.0,1,0,1
JP,BO,2010.0,1,0,1
RE,IN,2019.0,1,0,1
MR,NE,2002.0,1,0,1
AF,BR,2009.0,1,0,1
KN,,2011.0,1,0,1
DK,PK,2008.0,1,0,1
CN,GN,2021.0,1,0,1
NG,NE,2022.0,1,0,1
XK,RU,2019.0,1,0,1
KW,NZ,2006.0,1,0,1
VG,CL,2010.0,1,0,1
SN,PH,2020.0,1,0,1
NP,VN,2022.0,2,0,2
TH,TZ,2006.0,1,0,1
LY,MA,2016.0,1,0,1
CA,LV,2011.0,2,0,2
PL,CW,2018.0,2,0,2
KE,GH,2015.0,3,0,3
CW,JP,2007.0,1,0,1
GM,CM,2015.0,1,0,1
BN,IE,2016.0,1,0,1
IE,LU,1999.0,1,0,1
IL,HK,2016.0,1,0,1
KW,HU,2010.0,1,0,1
IN,EE,2012.0,2,0,2
LK,TW,1999.0,3,0,3
KW,CN,2017.0,1,0,1
SG,LK,2006.0,1,0,1
ET,IL,2014.0,1,0,1
NE,BF,2011.0,1,0,1
CA,NA,2011.0,1,0,1
FO,,2011.0,1,0,1
BJ,TW,2017.0,1,0,1
AL,,2004.0,2,0,2
GY,SA,2016.0,1,0,1
VU,FR,2013.0,1,0,1
HK,PE,2012.0,1,0,1
AM,DK,2013.0,1,0,1
CL,MY,2014.0,1,0,1
BH,NG,2003.0,3,0,3
MC,EG,2020.0,1,0,1
MA,UY,2019.0,1,0,1
IN,MM,2007.0,1,0,1
MA,GP,2015.0,1,0,1
IL,RO,2003.0,1,0,1
RE,BF,2016.0,1,0,1
NZ,MK,2011.0,2,0,2
IN,BM,2017.0,1,0,1
AZ,CL,2014.0,1,0,1
RO,QA,2015.0,1,0,1
IE,SG,2000.0,2,0,2
PS,BE,2016.0,1,0,1
,GQ,2018.0,1,0,1
GN,CH,2020.0,1,0,1
SV,FR,2011.0,1,0,1
HU,ZM,1997.0,1,0,1
NI,IR,2019.0,1,0,1
KR,KP,2011.0,1,0,1
TZ,MX,2014.0,1,0,1
FR,GH,2012.0,1,0,1
GM,ET,2020.0,1,0,1
BJ,QA,2014.0,1,0,1
BA,KW,2016.0,2,0,2
PE,NG,2016.0,1,0,1
US,TJ,2007.0,1,0,1
JM,NL,2006.0,2,0,2
nan,LT,2012.0,2,0,2
UA,KR,2002.0,1,0,1
DO,CH,2003.0,1,0,1
AU,KE,1997.0,2,0,2
EG,PT,2009.0,2,0,2
ML,BJ,2011.0,1,0,1
VE,BO,2019.0,1,0,1
LU,NO,2007.0,1,0,1
CV,ES,2010.0,1,0,1
MW,IT,2002.0,1,0,1
ET,ES,2020.0,3,0,3
HK,HR,2009.0,1,0,1
BD,PH,2022.0,1,0,1
ML,SN,2009.0,1,0,1
VE,DK,2015.0,1,0,1
CZ,ME,2003.0,1,0,1
PH,nan,2004.0,1,0,1
GT,PT,2017.0,1,0,1
UG,IS,2020.0,1,0,1
CA,BY,2013.0,2,0,2
KW,SD,2020.0,1,0,1
SA,PG,2017.0,1,0,1
CZ,SA,2009.0,1,0,1
KE,NZ,2019.0,2,0,2
UG,RU,2020.0,1,0,1
BF,nan,2018.0,1,0,1
LV,SI,2011.0,1,0,1
LA,MG,2022.0,1,0,1
PE,AM,2003.0,1,0,1
ET,FI,2010.0,1,0,1
PH,IE,1997.0,1,0,1
VE,PL,2016.0,1,0,1
LK,AT,2005.0,1,0,1
MZ,ES,2002.0,1,0,1
GH,AU,2001.0,2,0,2
TH,IQ,2019.0,1,0,1
NL,RE,2018.0,1,0,1
UZ,PL,2001.0,3,0,3
SE,BW,1997.0,1,0,1
US,BJ,2014.0,3,0,3
NA,CA,2017.0,1,0,1
AR,MZ,2008.0,1,0,1
VU,NC,2009.0,1,0,1
,BS,1994.0,1,0,1
NZ,GE,2020.0,1,0,1
BR,AO,1998.0,1,0,1
NC,IT,2019.0,1,0,1
BD,EC,2018.0,1,0,1
JO,CL,2007.0,1,0,1
TH,TW,2005.0,2,0,2
nan,CW,2015.0,1,0,1
DZ,SA,2001.0,2,0,2
BJ,SE,2009.0,1,0,1
GT,DE,2011.0,1,0,1
US,TG,2007.0,1,0,1
SG,GH,2013.0,1,0,1
PH,MX,2000.0,2,0,2
PH,CR,2020.0,1,0,1
MM,FR,2000.0,1,0,1
PS,QA,2003.0,1,0,1
NL,LB,2013.0,2,0,2
EC,BE,2001.0,1,0,1
JP,EC,2019.0,3,0,3
AU,PA,1997.0,1,0,1
XK,SI,2019.0,1,0,1
UA,KR,2005.0,1,0,1
GR,CO,2018.0,1,0,1
KE,TH,2014.0,1,0,1
AT,PA,2012.0,1,0,1
TT,US,1999.0,2,0,2
DE,MM,2004.0,1,0,1
MH,,2011.0,1,0,1
BE,FJ,2017.0,1,0,1
IQ,NZ,2020.0,2,0,2
BD,GM,2014.0,1,0,1
SY,IN,2016.0,2,0,2
HR,SG,2009.0,1,0,1
SE,MD,2017.0,1,0,1
TT,CZ,2010.0,1,0,1
IQ,CD,2020.0,1,0,1
DZ,PL,2018.0,2,0,2
GH,AL,2019.0,2,0,2
FJ,SG,2009.0,1,0,1
MA,SE,2017.0,1,0,1
BE,HK,2005.0,1,0,1
IT,SV,2003.0,4,0,4
AT,PE,2005.0,2,0,2
JP,AZ,2014.0,1,0,1
IT,MD,2012.0,1,0,1
CA,UZ,1997.0,1,0,1
SK,IL,2012.0,1,0,1
FI,UG,2014.0,1,0,1
MO,TH,2013.0,1,0,1
NO,IQ,2008.0,1,0,1
CM,CG,2021.0,3,0,3
CU,CZ,2013.0,1,0,1
DZ,PT,2002.0,1,0,1
MQ,PR,2013.0,1,0,1
SA,MM,2012.0,1,0,1
PE,ID,2007.0,1,0,1
LY,JP,2015.0,1,0,1
CA,MK,2010.0,1,0,1
VN,IE,2014.0,1,0,1
GE,BR,2006.0,1,0,1
CN,VG,2007.0,2,0,2
NL,LV,2004.0,1,0,1
IR,NZ,2005.0,2,0,2
TH,OM,2016.0,2,0,2
AE,FR,1999.0,1,0,1
QA,PH,2022.0,1,0,1
MZ,AR,2018.0,1,0,1
ZA,NA,2023.0,1,0,1
RE,ZA,2014.0,1,2,-1
SA,MX,2018.0,1,2,-1
TG,BJ,2021.0,2,2,0
CU,BE,2021.0,2,1,1
ZW,PK,2021.0,7,3,4
ID,TR,2014.0,3,5,-2
US,BN,2007.0,2,2,0
KN,ZA,2016.0,1,1,0
BE,TR,2004.0,5,4,1
KG,TR,2016.0,2,2,0
MK,SK,2016.0,1,1,0
PE,BO,2021.0,4,3,1
SE,NG,2008.0,2,6,-4
PL,EG,2003.0,1,2,-1
CH,DO,2000.0,1,1,0
NO,BD,2011.0,1,1,0
JP,HR,2015.0,1,1,0
HU,RU,2001.0,2,8,-6
IN,MT,2017.0,2,1,1
CY,OM,2019.0,1,2,-1
EG,BR,2020.0,3,4,-1
DE,SY,2015.0,1,2,-1
EG,KE,2017.0,2,3,-1
RU,EC,2020.0,1,3,-2
TW,EG,2006.0,1,2,-1
EG,TR,2012.0,2,1,1
FR,LI,2019.0,1,1,0
UA,PK,2017.0,1,1,0
JP,NP,2023.0,2,1,1
CH,BA,2018.0,1,1,0
MW,DE,2015.0,3,2,1
PT,GR,2018.0,3,7,-4
NL,NG,2001.0,1,2,-1
BE,JO,2016.0,1,1,0
FR,CI,1998.0,2,1,1
NG,IN,1998.0,1,2,-1
HU,PT,2013.0,3,1,2
AU,SN,2012.0,1,1,0
AE,KR,2021.0,5,6,-1
CA,VG,2019.0,1,1,0
SI,BY,2016.0,1,2,-1
ES,EE,2007.0,1,1,0
BG,FI,2019.0,1,1,0
UA,LT,2007.0,1,1,0
NC,IT,2010.0,1,1,0
ZM,KE,2020.0,2,1,1
CZ,NZ,2021.0,2,2,0
OM,KR,2018.0,1,3,-2
DO,CL,2007.0,1,1,0
BD,CA,2023.0,1,1,0
IQ,YE,2021.0,1,1,0
MM,GB,2014.0,1,1,0
IS,FI,2020.0,1,2,-1
BG,BE,2022.0,2,4,-2
BR,SK,2011.0,1,4,-3
TW,HU,2022.0,1,1,0
CA,IS,2013.0,1,3,-2
CG,BR,2010.0,1,2,-1
EE,LT,2014.0,1,1,0
UA,BR,2011.0,2,4,-2
BR,HR,2019.0,1,3,-2
NZ,PL,2020.0,2,2,0
SE,VE,2008.0,1,1,0
CL,QA,2021.0,1,1,0
AZ,JP,2020.0,1,2,-1
SA,nan,2012.0,1,1,0
AE,SD,2012.0,1,1,0
AU,FJ,2009.0,2,5,-3
ZM,CA,2015.0,1,2,-1
GR,TH,2017.0,1,1,0
CA,CL,1997.0,1,2,-1
KE,KH,2021.0,1,2,-1
BB,JM,2003.0,1,2,-1
ES,TH,2020.0,2,1,1
CO,JO,2015.0,1,1,0
BH,OM,2008.0,1,1,0
ZM,PK,2018.0,1,2,-1
nan,JO,2016.0,1,2,-1
RE,IN,2017.0,1,1,0
CL,DK,1999.0,1,1,0
JO,NG,2012.0,1,1,0
JP,MM,2012.0,1,2,-1
AM,IR,2012.0,2,2,0
GB,VG,2004.0,2,1,1
MR,SA,2018.0,1,1,0
EG,nan,2020.0,3,11,-8
CI,CD,2015.0,1,1,0
SD,NG,2011.0,1,1,0
MR,FR,2012.0,2,2,0
GL,DK,2002.0,1,1,0
CN,KW,2014.0,1,1,0
CY,IR,2007.0,1,1,0
nan,SI,2017.0,1,7,-6
LT,AU,2019.0,1,1,0
TR,QA,2011.0,1,1,0
CA,VN,2000.0,1,1,0
TN,IN,2009.0,2,1,1
SL,GB,2015.0,1,1,0
TH,IR,2006.0,1,2,-1
RU,MD,2006.0,1,4,-3
NL,IQ,2014.0,1,2,-1
SA,SY,2014.0,1,3,-2
IL,NZ,2015.0,1,2,-1
ZA,SG,2007.0,2,5,-3
TR,GE,2013.0,1,2,-1
TD,FR,2021.0,1,1,0
GH,SL,2019.0,1,1,0
KW,SE,2004.0,1,1,0
ET,KE,2013.0,1,3,-2
NZ,MY,2003.0,1,1,0
NL,VE,2008.0,1,2,-1
TZ,CM,2019.0,1,2,-1
ZM,US,1999.0,1,1,0
SI,FI,2013.0,2,2,0
AE,YE,1998.0,1,1,0
RU,ID,2014.0,2,5,-3
IT,IQ,2007.0,1,1,0
NG,KW,2012.0,1,2,-1
LV,KR,2019.0,1,1,0
ES,RS,2007.0,1,1,0
PR,MX,2013.0,1,4,-3
EG,KE,2019.0,1,4,-3
VE,nan,2018.0,1,2,-1
CR,JP,2019.0,1,2,-1
nan,RW,2011.0,1,4,-3
PE,CU,1999.0,1,2,-1
CN,IS,2021.0,1,1,0
GB,GE,2020.0,1,5,-4
PT,MY,2021.0,1,2,-1
PE,BE,2006.0,1,2,-1
KE,IT,2004.0,1,1,0
SG,EG,2020.0,2,6,-4
IN,IS,2015.0,1,2,-1
GB,CR,2011.0,2,1,1
UA,TJ,2017.0,1,1,0
FR,RS,2005.0,1,2,-1
LT,VE,2010.0,1,1,0
KW,IR,2014.0,1,1,0
OM,IT,2006.0,1,1,0
BM,US,2003.0,1,2,-1
MU,GB,2002.0,1,1,0
CG,SN,2013.0,1,2,-1
LV,KR,2017.0,1,1,0
BY,EC,2023.0,1,1,0
DZ,BE,2021.0,2,4,-2
FR,TD,2004.0,1,1,0
LK,CH,2013.0,2,3,-1
AU,BN,2019.0,4,4,0
ET,GB,2006.0,1,3,-2
AM,PK,2016.0,2,1,1
AT,PH,2018.0,1,2,-1
SK,IN,2010.0,1,1,0
CW,BE,2004.0,1,2,-1
SG,PL,2010.0,1,3,-2
NI,RU,2018.0,1,4,-3
NZ,IN,2003.0,3,13,-10
RU,RS,2004.0,2,2,0
UA,RS,2017.0,1,4,-3
AL,CN,2010.0,1,2,-1
CY,DK,2019.0,2,1,1
VN,PL,2010.0,1,3,-2
LS,ZA,2013.0,1,3,-2
IL,DK,2006.0,2,6,-4
LT,NO,2008.0,1,2,-1
ES,GE,2009.0,1,2,-1
SI,MX,2009.0,1,1,0
PK,SE,2004.0,1,2,-1
HK,AU,2020.0,2,8,-6
MX,ZW,2001.0,1,1,0
EG,SG,2019.0,2,5,-3
LV,CH,2022.0,1,1,0
MR,MA,2022.0,1,1,0
ZA,AR,2022.0,1,2,-1
CO,DE,2023.0,1,1,0
NG,CY,2006.0,1,0,1
LV,BG,2006.0,1,0,1
CH,MQ,2021.0,1,0,1
NL,CR,2006.0,1,0,1
KW,AE,2013.0,2,0,2
IQ,PL,2023.0,1,0,1
KW,HU,2019.0,1,0,1
GP,JM,2008.0,1,0,1
FR,RW,2012.0,3,0,3
NL,JE,2011.0,1,0,1
CU,NO,2015.0,1,0,1
LB,IE,2008.0,1,0,1
LY,IQ,2014.0,1,0,1
PT,NG,2012.0,1,0,1
ID,HU,2008.0,1,0,1
UY,IL,2017.0,1,0,1
EG,AR,2009.0,1,0,1
UA,LU,2019.0,1,0,1
AR,PH,2003.0,2,0,2
UY,EC,2012.0,1,0,1
nan,MD,2005.0,1,0,1
BW,BE,2012.0,1,0,1
DE,CW,2002.0,1,0,1
AE,CN,2003.0,1,0,1
PE,RO,2022.0,1,0,1
HR,CA,1997.0,1,0,1
GR,MD,2012.0,1,0,1
OM,BN,2015.0,1,0,1
EG,BN,2020.0,2,0,2
LB,NO,2015.0,2,0,2
AU,VE,2001.0,1,0,1
HU,LT,2014.0,1,0,1
AM,IN,2020.0,1,0,1
UA,GE,2011.0,1,0,1
LK,IE,2013.0,1,0,1
CZ,KW,2014.0,1,0,1
,SX,2016.0,2,0,2
EG,HK,2022.0,1,0,1
HR,CA,1998.0,2,0,2
AT,IE,2002.0,2,0,2
UZ,RS,2001.0,1,0,1
JM,SN,1999.0,1,0,1
BO,IN,2017.0,1,0,1
KE,JO,2022.0,1,0,1
SE,MM,2017.0,1,0,1
BF,IT,2014.0,1,0,1
YE,IQ,2011.0,1,0,1
MK,MY,2018.0,1,0,1
FI,CD,2019.0,1,0,1
MA,EG,2005.0,1,0,1
ES,DZ,2012.0,1,0,1
MZ,ES,2005.0,1,0,1
LT,VE,2019.0,1,0,1
TN,KZ,2018.0,1,0,1
KG,UZ,1999.0,2,0,2
QA,MX,2012.0,1,0,1
CA,AL,2018.0,1,0,1
MA,KE,2006.0,1,0,1
JP,EC,2010.0,1,0,1
NG,GH,2001.0,1,0,1
BD,NO,2012.0,2,0,2
MG,TH,2021.0,1,0,1
IE,IS,2008.0,2,0,2
TR,DO,2002.0,1,0,1
TR,DO,2005.0,1,0,1
CH,JM,2022.0,1,0,1
US,SX,2018.0,2,0,2
CO,DK,2023.0,1,0,1
BD,CY,2006.0,1,0,1
SV,,2010.0,1,0,1
EG,IL,2000.0,1,0,1
PS,FI,2012.0,1,0,1
CU,PR,2015.0,1,0,1
CH,SN,2022.0,1,0,1
SE,CD,2018.0,1,0,1
AU,KH,2009.0,1,0,1
PK,HK,2022.0,1,0,1
NZ,PY,2013.0,1,0,1
CN,MG,2013.0,1,0,1
BW,CN,2002.0,1,0,1
FJ,ZA,2015.0,1,0,1
FI,PS,2019.0,1,0,1
MK,SG,2019.0,1,0,1
RS,PL,2000.0,1,0,1
BD,GR,2018.0,2,0,2
BR,ZM,2001.0,1,0,1
IQ,PK,2023.0,2,0,2
ER,US,2019.0,1,0,1
BE,CG,2008.0,1,0,1
GB,GH,1997.0,2,0,2
CN,BA,2000.0,1,0,1
JM,KN,2018.0,1,0,1
BY,SE,2016.0,1,0,1
PE,IL,2022.0,1,0,1
GR,ES,2023.0,1,0,1
MM,ES,2016.0,1,0,1
SN,CF,2003.0,1,0,1
AL,GB,2005.0,1,0,1
CH,XK,2009.0,1,0,1
BE,MW,2020.0,1,0,1
EG,MX,2011.0,1,0,1
NL,PK,2003.0,1,0,1
FR,VG,2018.0,1,0,1
MA,YE,2013.0,1,0,1
MA,UG,2016.0,1,0,1
ZW,PT,2022.0,1,0,1
ZA,UA,1999.0,1,0,1
AE,MT,2012.0,1,0,1
TG,MQ,2016.0,1,0,1
BI,HT,2010.0,1,0,1
NE,,2025.0,1,0,1
IS,nan,2005.0,1,0,1
TR,MD,2011.0,1,0,1
US,XK,2004.0,1,0,1
BJ,VE,2019.0,1,0,1
SY,MX,2002.0,1,0,1
ET,NA,2012.0,1,0,1
KR,LA,2017.0,1,0,1
RW,SA,2018.0,2,0,2
SS,NL,2018.0,1,0,1
FI,ET,2006.0,1,0,1
NG,FI,2005.0,1,0,1
GT,BE,2021.0,1,0,1
MY,PT,2023.0,1,0,1
MW,KR,2011.0,1,0,1
OM,JM,1997.0,1,0,1
FR,NE,2023.0,1,0,1
KH,HR,2022.0,1,0,1
UG,AT,2012.0,1,0,1
CM,SN,1998.0,1,0,1
RE,GP,2013.0,1,0,1
ZW,NL,2007.0,2,0,2
OM,EG,2023.0,1,0,1
RS,EE,2012.0,1,0,1
MD,DZ,2018.0,1,0,1
RO,IQ,2017.0,1,0,1
IR,PE,2018.0,1,0,1
MT,KR,2013.0,1,0,1
UG,CH,2001.0,2,0,2
CG,BR,2019.0,1,0,1
PH,NE,2012.0,1,0,1
SM,,2019.0,1,0,1
US,MZ,1997.0,1,0,1
NP,IQ,2019.0,1,0,1
LB,PL,2022.0,1,0,1
UA,TH,2005.0,1,0,1
CI,CN,2017.0,1,0,1
,TD,1994.0,1,0,1
NI,CL,2003.0,1,0,1
IT,RS,1999.0,1,0,1
CO,EG,2016.0,2,0,2
OM,CY,2016.0,1,0,1
AT,PS,2012.0,1,0,1
EC,CO,2023.0,1,0,1
TM,,2022.0,1,0,1
LT,MA,2017.0,1,0,1
MU,MA,2014.0,1,0,1
GT,IT,2015.0,1,0,1
BD,TZ,2015.0,1,0,1
IQ,CN,2006.0,1,0,1
PE,HU,2017.0,1,0,1
JP,VG,2001.0,1,0,1
GH,AL,2017.0,1,0,1
SN,MY,2016.0,1,0,1
AL,CH,2018.0,1,0,1
CO,NO,2000.0,1,0,1
NP,IL,2020.0,1,0,1
NG,TZ,2002.0,1,0,1
BS,NO,2018.0,1,0,1
DZ,NO,2019.0,1,0,1
BH,MA,2020.0,1,0,1
IE,BN,2020.0,1,0,1
KE,NL,2023.0,1,0,1
MY,ER,2017.0,1,0,1
BW,CG,2021.0,1,0,1
SE,SJ,2007.0,1,0,1
ZA,PA,1999.0,1,0,1
IR,AE,2000.0,1,0,1
RU,MA,2001.0,1,0,1
BD,SA,2006.0,1,0,1
MG,CA,2019.0,1,0,1
MU,KE,2015.0,1,0,1
KE,NG,2003.0,1,0,1
NI,UY,2019.0,1,0,1
FR,CU,1998.0,1,0,1
SK,XK,2018.0,1,0,1
IN,MD,2008.0,1,0,1
IL,EG,2007.0,1,0,1
VE,NI,2015.0,1,0,1
GD,ZA,2011.0,1,0,1
AM,TW,2015.0,1,0,1
TR,SY,2004.0,1,0,1
NZ,BN,2020.0,1,0,1
AL,RU,2018.0,1,0,1
KR,KZ,2012.0,1,0,1
CH,CU,2016.0,1,0,1
SE,KN,2022.0,1,0,1
UA,CO,2003.0,1,0,1
ES,LK,2007.0,1,0,1
RS,TW,2009.0,1,0,1
KW,BB,2001.0,1,0,1
DZ,TN,2003.0,1,0,1
CH,GY,2018.0,1,0,1
SE,LA,2016.0,1,0,1
NO,RW,2019.0,1,0,1
SO,US,2022.0,1,0,1
NL,PF,2001.0,1,0,1
SG,LU,2019.0,1,0,1
JP,PW,2006.0,1,0,1
SR,US,2023.0,1,0,1
LR,GH,2021.0,1,0,1
TH,ES,2002.0,1,0,1
,SZ,2003.0,1,0,1
DZ,YE,2017.0,1,0,1
LK,RU,2021.0,1,0,1
BY,MD,2004.0,1,0,1
KZ,BD,2016.0,1,0,1
MM,DE,2021.0,1,0,1
BR,PT,2008.0,569,488,81
FR,US,2006.0,1223,1145,78
US,IN,2021.0,2440,2364,76
GB,US,2010.0,5293,5395,-102
US,KR,2014.0,1351,1207,144
BD,JP,2009.0,40,64,-24
TW,JP,2003.0,43,49,-6
CN,JP,2020.0,465,552,-87
US,NL,2012.0,763,681,82
US,DE,2004.0,1852,2028,-176
CA,IT,2014.0,86,151,-65
NL,FR,2005.0,163,153,10
ES,GB,2014.0,524,325,199
CA,SA,2011.0,77,28,49
MX,CO,2008.0,127,114,13
AU,IT,2018.0,81,76,5
DE,CN,2015.0,312,307,5
RS,MX,2009.0,49,31,18
SA,MY,2015.0,37,66,-29
ES,PE,2019.0,205,144,61
nan,IN,2015.0,77,77,0
BD,PK,2016.0,46,63,-17
VE,CR,2016.0,7,2,5
FR,CH,1997.0,100,115,-15
KW,EG,2017.0,32,16,16
AR,ES,2014.0,340,388,-48
CN,CA,2022.0,304,437,-133
JP,FR,2010.0,124,124,0
CL,HN,2015.0,8,1,7
NZ,US,1999.0,156,129,27
US,BE,2001.0,133,176,-43
FR,BR,2011.0,167,167,0
GB,BR,2001.0,76,64,12
US,IT,2007.0,770,854,-84
NG,SY,2013.0,1,1,0
IE,GB,1998.0,93,94,-1
CN,GB,2015.0,507,542,-35
SA,CA,2016.0,67,107,-40
CH,JP,2006.0,34,50,-16
DE,RU,2019.0,237,201,36
US,NO,2020.0,224,136,88
KR,JP,2001.0,121,167,-46
HU,US,2013.0,106,95,11
nan,PE,2011.0,8,5,3
GB,IN,2000.0,106,125,-19
NL,DE,1997.0,90,101,-11
IL,SE,2018.0,6,10,-4
CA,SE,2021.0,61,43,18
ES,VE,2016.0,63,88,-25
GB,CN,2000.0,200,150,50
ML,FR,2021.0,14,17,-3
GB,JP,2008.0,276,321,-45
CZ,GB,2014.0,44,56,-12
CO,VE,2013.0,40,70,-30
CN,KR,2015.0,288,281,7
CA,MX,2007.0,23,23,0
AR,CU,2000.0,8,10,-2
IN,DE,2018.0,246,194,52
DE,NO,2007.0,74,36,38
BA,RS,2021.0,33,37,-4
IT,MA,2010.0,13,5,8
BG,GB,2000.0,9,5,4
CA,KR,2007.0,35,41,-6
EG,US,2004.0,74,102,-28
US,ZA,2005.0,204,201,3
CN,DE,2005.0,184,198,-14
GB,AU,2006.0,1053,911,142
MX,CR,2017.0,39,53,-14
CA,IN,2014.0,214,203,11
US,IL,1998.0,301,303,-2
ET,KR,2001.0,86,47,39
CN,NZ,2014.0,40,42,-2
BE,CL,2013.0,11,4,7
AU,ZA,2020.0,64,81,-17
FR,CA,2012.0,603,514,89
ES,IT,2021.0,210,267,-57
GB,AE,2011.0,33,20,13
ZA,FR,1999.0,6,5,1
KR,IN,2003.0,24,49,-25
IT,US,2016.0,1155,965,190
KR,ET,1999.0,49,70,-21
DE,BR,2009.0,127,140,-13
IE,GB,1997.0,55,67,-12
JP,FR,2019.0,186,212,-26
LU,DE,2022.0,18,19,-1
SE,CH,2001.0,16,27,-11
US,KZ,2014.0,21,8,13
GB,IE,2001.0,171,105,66
JP,CH,2000.0,40,44,-4
CH,NZ,2019.0,18,13,5
PH,US,2007.0,359,304,55
AU,IE,2013.0,107,111,-4
QA,CA,2020.0,12,18,-6
TW,AU,2014.0,44,38,6
NL,DE,1998.0,120,123,-3
DE,FR,2006.0,418,369,49
US,MY,2005.0,52,35,17
AT,DE,2003.0,253,277,-24
DE,ZA,1999.0,14,9,5
CA,BE,2002.0,26,36,-10
MX,BR,2005.0,41,32,9
MX,EC,2022.0,36,51,-15
AR,DE,2017.0,51,49,2
NZ,GB,2004.0,158,173,-15
BR,AU,2012.0,86,56,30
CU,ES,2015.0,104,89,15
VE,MX,2007.0,34,39,-5
DE,CH,1998.0,318,260,58
AR,DE,2010.0,29,27,2
MX,CR,2019.0,56,44,12
AR,DK,2015.0,1,3,-2
PL,RS,2018.0,9,8,1
MX,PE,2009.0,40,36,4
PT,nan,2019.0,16,34,-18
DE,CH,1997.0,201,204,-3
IN,US,2001.0,739,617,122
CO,AR,2000.0,7,15,-8
SE,AU,2020.0,65,81,-16
VE,FR,2011.0,8,8,0
nan,IT,2005.0,57,78,-21
BR,MY,2002.0,32,25,7
IE,ES,2008.0,17,16,1
SG,JP,1999.0,9,19,-10
MY,IN,2013.0,85,158,-73
DK,NO,1998.0,34,33,1
BR,CO,2012.0,87,112,-25
JO,EG,2021.0,31,33,-2
MM,SG,2016.0,3,5,-2
CA,NZ,1999.0,28,18,10
SE,GB,2004.0,116,96,20
JP,FR,2017.0,151,200,-49
IE,KR,2014.0,6,3,3
FR,MX,2020.0,72,69,3
CA,DZ,2018.0,16,21,-5
US,VN,2013.0,70,48,22
BR,MY,2005.0,45,95,-50
DE,RU,2010.0,133,162,-29
EG,PL,2010.0,4,5,-1
ID,IN,2019.0,72,145,-73
IN,CA,2005.0,147,114,33
US,CH,2001.0,416,470,-54
ES,JP,2009.0,29,35,-6
AR,PT,2008.0,9,5,4
CZ,IL,2011.0,7,2,5
BR,BD,2016.0,4,2,2
CR,AR,2013.0,5,15,-10
AU,ES,2020.0,63,75,-12
UA,RU,2022.0,187,220,-33
HU,SI,2011.0,1,2,-1
BE,DE,2011.0,110,129,-19
CN,IN,2007.0,116,147,-31
GB,SK,2015.0,15,16,-1
UZ,CN,2009.0,16,19,-3
UY,DE,2017.0,12,5,7
CN,DE,2002.0,131,168,-37
UA,CN,2011.0,19,15,4
CN,GR,2012.0,31,26,5
SY,CN,2007.0,17,20,-3
US,SA,2021.0,291,158,133
IN,CN,2005.0,99,82,17
ES,AT,2011.0,30,18,12
ID,IN,2017.0,36,70,-34
SA,EG,2015.0,320,329,-9
ES,nan,2018.0,81,58,23
CN,CM,2017.0,4,3,1
CN,GH,2012.0,5,4,1
DK,DE,2008.0,78,109,-31
ZA,IN,2017.0,50,75,-25
PT,FR,2018.0,48,51,-3
LB,FR,2013.0,39,91,-52
BE,CH,2021.0,66,72,-6
ES,PE,2017.0,160,120,40
RU,EG,2018.0,22,12,10
IL,nan,2020.0,19,32,-13
US,AE,1999.0,14,13,1
AT,IL,2015.0,4,5,-1
KW,EG,2019.0,33,38,-5
AU,NZ,2007.0,115,147,-32
AU,FR,2001.0,49,43,6
KR,CA,2008.0,28,42,-14
CH,RO,2018.0,17,15,2
TW,MY,2014.0,27,14,13
IL,CA,2004.0,54,21,33
BG,DE,2012.0,22,25,-3
SK,CZ,2019.0,190,142,48
ES,DK,2006.0,60,18,42
PR,KR,2018.0,35,53,-18
IN,CA,2002.0,90,102,-12
PT,nan,2017.0,26,29,-3
ES,TN,2021.0,8,8,0
JP,IN,2020.0,126,139,-13
IR,CA,2018.0,339,213,126
JP,TR,2009.0,27,35,-8
NO,CH,2022.0,15,20,-5
KR,RU,2017.0,29,13,16
IN,ZA,2020.0,65,54,11
PH,ES,2014.0,12,18,-6
IE,NL,2013.0,24,18,6
CL,BR,2007.0,50,39,11
AU,DK,2017.0,49,56,-7
CN,RS,2011.0,9,11,-2
QA,CN,2016.0,10,15,-5
CR,US,2009.0,16,25,-9
DE,RU,2017.0,206,170,36
HU,NL,2011.0,13,16,-3
AT,nan,2005.0,6,15,-9
PE,MX,2006.0,22,30,-8
DE,CA,2020.0,301,246,55
RU,CZ,2022.0,72,28,44
DE,FI,1999.0,29,9,20
US,ZA,2002.0,136,180,-44
MX,nan,2008.0,11,17,-6
US,TZ,2017.0,19,27,-8
VE,ES,2014.0,75,49,26
AT,TR,2017.0,12,10,2
FR,ML,2015.0,8,8,0
CL,EC,2012.0,19,14,5
PE,CO,2020.0,83,107,-24
AT,nan,2002.0,7,5,2
JO,MY,2013.0,13,15,-2
IN,MY,2017.0,160,142,18
DE,GR,2002.0,32,25,7
SG,CH,2021.0,13,13,0
JP,AF,2020.0,6,3,3
EG,DE,2018.0,60,80,-20
JP,EG,2005.0,51,36,15
BR,AR,2018.0,197,198,-1
AZ,IT,2018.0,16,10,6
HR,GB,2009.0,10,7,3
EG,DK,2019.0,4,6,-2
IN,LV,2019.0,2,1,1
US,PA,2005.0,16,14,2
CZ,SK,2012.0,92,82,10
GB,LU,2019.0,18,10,8
CN,CH,2016.0,69,71,-2
IL,AU,2016.0,27,13,14
SE,AT,2017.0,24,36,-12
FR,CH,1998.0,172,124,48
IN,MY,2019.0,166,166,0
JP,EG,2002.0,33,12,21
JP,TH,2022.0,42,22,20
US,BD,1999.0,13,6,7
IQ,DE,2016.0,8,9,-1
ID,nan,2016.0,29,69,-40
SG,TW,2004.0,24,29,-5
AT,BE,2020.0,16,22,-6
SK,CZ,2017.0,137,157,-20
FI,HU,2000.0,8,1,7
IN,FR,2009.0,136,63,73
KE,US,2005.0,32,29,3
NP,GB,1999.0,3,3,0
BE,NO,2011.0,13,8,5
CO,BE,2017.0,14,12,2
BD,ES,2015.0,12,17,-5
PL,GB,2021.0,74,106,-32
TW,ID,2021.0,58,75,-17
SA,AE,2018.0,46,19,27
AE,MA,2011.0,1,1,0
AR,DE,2019.0,65,40,25
SA,CN,2022.0,45,38,7
NO,NL,2015.0,28,55,-27
MY,BR,2005.0,95,45,50
PK,IQ,2021.0,27,35,-8
IQ,EG,2017.0,31,53,-22
MA,US,2017.0,19,22,-3
ES,EC,2006.0,15,8,7
RU,JP,2004.0,42,40,2
DE,IN,1999.0,55,48,7
FR,CL,2009.0,27,26,1
PE,BR,2016.0,59,64,-5
BE,RO,2019.0,16,13,3
AE,IN,2016.0,55,69,-14
ZA,NG,2017.0,88,125,-37
US,NG,2005.0,14,22,-8
IN,MX,2008.0,12,7,5
ES,PE,2010.0,60,53,7
ZA,IN,2010.0,28,59,-31
DK,RU,2013.0,10,4,6
BR,CR,2016.0,23,15,8
JP,BD,2022.0,35,35,0
DZ,MA,2021.0,39,25,14
TR,AZ,2016.0,9,7,2
US,TH,2002.0,96,54,42
DK,CA,2020.0,47,56,-9
BE,BR,2011.0,62,49,13
NL,KR,2022.0,14,5,9
ZA,NG,2019.0,103,157,-54
ID,SI,2019.0,15,13,2
ZA,GH,2022.0,16,18,-2
US,ET,2018.0,80,52,28
BE,TR,2020.0,16,20,-4
HR,SI,2021.0,23,28,-5
DE,TN,2021.0,9,4,5
NL,PK,2012.0,10,12,-2
IN,PL,2019.0,34,24,10
SE,IQ,2013.0,4,2,2
IQ,EG,2019.0,93,102,-9
PS,IL,2021.0,3,5,-2
DZ,US,2020.0,72,70,2
FR,TR,2009.0,24,16,8
CO,JP,2006.0,10,5,5
MY,SA,2008.0,12,7,5
KW,JO,2016.0,5,9,-4
PK,AE,2019.0,36,14,22
EG,AE,2000.0,6,6,0
KW,EG,2010.0,18,9,9
BE,ID,2016.0,16,4,12
FR,MT,2003.0,2,1,1
KZ,CN,2013.0,7,10,-3
GB,CO,2000.0,3,7,-4
CN,KE,2020.0,15,16,-1
CA,PK,2021.0,22,53,-31
IN,IE,2018.0,38,24,14
JP,MX,2021.0,5,6,-1
LB,US,2018.0,96,89,7
SE,QA,2018.0,6,3,3
RU,IL,2001.0,26,15,11
ET,IR,2020.0,3,3,0
NG,ET,2020.0,15,15,0
BD,IR,2015.0,7,6,1
LK,GB,1999.0,6,3,3
CN,RU,2013.0,49,34,15
DE,DZ,2020.0,11,8,3
TR,ID,2018.0,27,13,14
AU,SA,2012.0,22,8,14
NL,AU,1997.0,16,13,3
IT,IS,2011.0,1,1,0
GF,FR,1999.0,3,3,0
GR,NL,2019.0,29,44,-15
DE,SI,2019.0,21,20,1
LY,IN,2017.0,6,1,5
CH,CN,2016.0,71,69,2
CA,PH,2021.0,6,9,-3
ID,AU,2022.0,42,30,12
CH,DK,2014.0,47,35,12
AT,TR,2010.0,8,5,3
ZW,US,2022.0,3,4,-1
CZ,VN,2019.0,6,3,3
CA,IE,2001.0,43,29,14
PT,CL,2016.0,13,10,3
IT,MA,2019.0,39,21,18
CY,GR,2006.0,8,15,-7
GR,NL,2017.0,40,32,8
TR,IT,2022.0,16,7,9
GH,PH,2022.0,7,3,4
US,TZ,2019.0,22,24,-2
CN,ZA,2018.0,22,17,5
SG,nan,2018.0,17,4,13
NL,CZ,2011.0,19,14,5
ET,IN,2021.0,27,54,-27
BD,EG,2021.0,12,10,2
ZA,MY,2017.0,4,9,-5
US,MY,2002.0,34,24,10
ES,CU,2009.0,82,96,-14
US,IL,1997.0,259,240,19
IN,AU,2016.0,219,189,30
AR,BR,2009.0,130,104,26
CH,NZ,2017.0,11,17,-6
IT,TH,2019.0,4,3,1
US,GR,2011.0,177,176,1
QA,RS,2019.0,5,1,4
IN,NL,2009.0,44,29,15
DZ,TN,2012.0,18,18,0
nan,UA,2017.0,34,10,24
ZA,AU,2003.0,33,18,15
ZA,MX,2019.0,2,1,1
GH,NG,2018.0,18,23,-5
NZ,CA,2018.0,82,78,4
GR,RO,2017.0,2,2,0
LK,AU,2020.0,48,41,7
IR,CH,2021.0,31,16,15
IT,PL,2019.0,49,52,-3
CZ,nan,1999.0,4,4,0
FR,nan,2012.0,178,201,-23
NL,NO,2009.0,31,16,15
nan,CN,2011.0,236,214,22
US,TH,2005.0,137,82,55
CN,FI,2020.0,65,36,29
CA,GB,2022.0,453,500,-47
ES,NL,2020.0,129,92,37
GB,MW,2018.0,24,20,4
IQ,SD,2012.0,1,3,-2
RO,JP,2001.0,7,6,1
IT,CO,2018.0,22,24,-2
DK,TR,2011.0,5,5,0
CZ,NL,2013.0,15,17,-2
US,RS,2006.0,40,30,10
CM,KE,2013.0,3,1,2
CH,PK,2011.0,11,21,-10
TR,NL,2005.0,8,12,-4
NL,FR,2002.0,95,131,-36
GB,NL,2005.0,163,192,-29
TR,NL,2002.0,12,7,5
NL,IL,2012.0,15,13,2
CH,SG,2022.0,6,15,-9
US,QA,2022.0,30,69,-39
TH,KH,2015.0,1,2,-1
GB,AR,2003.0,19,16,3
SA,MA,2010.0,1,3,-2
FR,AU,2003.0,62,48,14
BE,FI,2008.0,8,4,4
DE,TR,2003.0,19,28,-9
ES,NO,2016.0,43,34,9
AT,US,2022.0,135,136,-1
SE,UA,2008.0,7,6,1
BE,BF,2018.0,4,3,1
DE,SE,2008.0,148,144,4
BE,GR,2005.0,11,9,2
SE,ES,2012.0,51,43,8
FR,MY,2014.0,20,7,13
DZ,CA,2014.0,7,11,-4
CH,PL,2008.0,16,12,4
DK,NO,1997.0,24,21,3
IN,MY,2010.0,66,50,16
GB,BD,2014.0,61,55,6
AU,TH,2011.0,46,27,19
NP,NZ,2012.0,22,21,1
TJ,RU,2019.0,42,72,-30
NZ,NL,2013.0,9,10,-1
NO,IT,2005.0,14,22,-8
IN,RU,2022.0,30,15,15
IT,PT,2008.0,30,19,11
CZ,CA,2021.0,7,6,1
IL,CN,2001.0,15,5,10
TR,DE,2001.0,13,18,-5
ZW,GB,2017.0,8,4,4
IT,NO,2022.0,24,8,16
BG,TR,2013.0,1,3,-2
FR,MG,2011.0,10,8,2
SE,AT,2019.0,34,54,-20
ES,RO,2008.0,10,8,2
PK,AE,2017.0,13,8,5
MK,BG,2019.0,3,5,-2
nan,UA,2019.0,25,21,4
MY,EG,2012.0,20,24,-4
MG,FR,2017.0,18,20,-2
nan,IT,2002.0,81,53,28
KR,NL,2017.0,14,15,-1
KR,IE,2017.0,6,7,-1
NO,IT,2002.0,20,11,9
nan,KE,2021.0,5,3,2
CA,BE,2005.0,33,36,-3
NO,GB,2008.0,45,63,-18
VN,US,2013.0,48,70,-22
DK,PE,2017.0,2,1,1
PE,AR,2015.0,59,46,13
SJ,DK,2012.0,1,1,0
SA,LY,2019.0,1,10,-9
DE,CL,2011.0,35,47,-12
RU,RS,2020.0,20,18,2
NE,FR,1997.0,2,1,1
ES,KR,2018.0,15,18,-3
IT,MA,2017.0,43,21,22
JP,SE,2018.0,30,41,-11
GR,AT,2020.0,12,8,4
SK,CZ,2010.0,70,51,19
EC,UA,2004.0,8,9,-1
IT,EG,2002.0,1,5,-4
MX,JP,2006.0,4,9,-5
AU,DK,2019.0,70,47,23
HU,RO,2016.0,50,43,7
TH,FR,2020.0,18,15,3
IL,MX,2013.0,3,3,0
TW,KR,2012.0,34,34,0
FR,HU,2004.0,15,13,2
NL,AU,1998.0,20,22,-2
PE,UY,2013.0,3,3,0
PT,TR,2005.0,2,2,0
RO,AT,2018.0,14,7,7
US,IR,2006.0,109,85,24
HR,RS,2006.0,53,60,-7
EG,ES,2022.0,4,7,-3
JP,SI,2019.0,6,3,3
nan,DK,2013.0,22,18,4
FI,AT,2015.0,14,5,9
NG,CM,2017.0,4,2,2
IT,MT,2016.0,6,3,3
KW,US,2019.0,27,35,-8
TN,US,2018.0,18,32,-14
CG,FR,2005.0,7,12,-5
TJ,RU,2017.0,35,25,10
GB,SS,1998.0,5,5,0
MA,CA,2022.0,12,8,4
ZA,BR,2013.0,19,7,12
BE,ZA,2006.0,2,22,-20
BW,MW,2019.0,1,1,0
JP,PK,1998.0,8,8,0
CO,SE,2015.0,7,4,3
SG,NZ,2022.0,11,4,7
RU,GE,2014.0,5,4,1
DK,CN,2001.0,11,15,-4
AR,AT,2017.0,5,2,3
CL,NL,2014.0,12,8,4
DO,CO,2018.0,6,5,1
KE,IN,2022.0,6,4,2
NL,SE,2022.0,40,49,-9
EG,ET,2014.0,6,4,2
CO,NI,2015.0,4,3,1
KW,MA,2016.0,6,7,-1
NL,CN,2008.0,77,62,15
TG,SN,2017.0,1,2,-1
IT,DK,2022.0,24,23,1
PK,NL,2012.0,12,10,2
NG,GA,2016.0,1,1,0
DK,GL,2009.0,4,1,3
FR,FI,2022.0,15,19,-4
NG,IR,2021.0,4,3,1
EG,FR,2014.0,19,26,-7
CL,FI,2018.0,6,2,4
FR,GF,2020.0,35,17,18
CO,EC,2012.0,18,15,3
RW,IN,2018.0,8,5,3
IQ,EG,2010.0,3,4,-1
EG,LB,2014.0,11,10,1
NG,ID,2022.0,6,13,-7
GB,IR,2005.0,67,18,49
CA,CH,2009.0,98,110,-12
SA,BE,2014.0,4,6,-2
JO,GB,2015.0,16,28,-12
PH,BR,2018.0,16,14,2
GM,GB,2021.0,6,11,-5
ID,SI,2017.0,3,6,-3
IE,JP,2015.0,24,24,0
MM,CN,2021.0,7,4,3
EG,NL,2021.0,13,6,7
DK,BG,2019.0,3,3,0
BE,GB,2023.0,9,9,0
EC,PY,2021.0,6,1,5
nan,TR,2018.0,27,34,-7
RO,BR,2010.0,2,2,0
QA,IQ,2005.0,1,1,0
RW,KE,2021.0,7,6,1
KR,TZ,2019.0,1,1,0
VN,CZ,2021.0,7,5,2
IR,ZA,2021.0,3,2,1
SD,KE,2017.0,2,1,1
KR,PR,2021.0,13,40,-27
MA,KW,2022.0,6,4,2
AE,MY,2023.0,2,4,-2
FR,IL,2017.0,39,36,3
IN,PL,2017.0,13,13,0
FR,AR,2003.0,16,17,-1
KW,US,2010.0,18,21,-3
MT,IE,2019.0,1,2,-1
AR,TW,2009.0,5,11,-6
NL,SG,2015.0,23,15,8
MY,IT,2001.0,29,35,-6
JP,IE,1998.0,15,10,5
GB,ZA,2011.0,152,127,25
NZ,KE,2015.0,4,2,2
KE,JP,2014.0,3,10,-7
nan,DE,2009.0,48,60,-12
DK,GW,1999.0,1,1,0
CH,DE,2023.0,18,20,-2
AT,PL,2022.0,5,10,-5
IL,AT,2022.0,4,7,-3
GB,UA,2015.0,10,18,-8
LT,GB,2016.0,12,2,10
RS,ME,2013.0,20,13,7
nan,HU,2014.0,4,6,-2
US,KW,2005.0,10,10,0
CD,US,2014.0,2,2,0
PK,ID,2015.0,33,20,13
ZA,GB,2011.0,127,152,-25
SA,MA,2019.0,8,11,-3
KW,US,2017.0,24,27,-3
NZ,MY,2012.0,20,18,2
HU,MX,2017.0,3,2,1
CZ,UA,2014.0,20,22,-2
TR,CA,2001.0,10,12,-2
FR,LB,2006.0,39,17,22
GE,RU,2021.0,4,2,2
PT,IN,2007.0,4,8,-4
YE,EG,2011.0,4,2,2
BE,GR,2002.0,8,3,5
AU,JO,2013.0,11,7,4
IT,JP,2001.0,35,31,4
FR,SG,2020.0,32,16,16
UG,TH,2010.0,1,1,0
NG,KE,2013.0,1,2,-1
MZ,PL,2014.0,13,20,-7
BR,IN,2016.0,24,37,-13
GD,US,2009.0,8,3,5
NL,DK,2006.0,16,29,-13
IN,CZ,2008.0,22,11,11
GR,CZ,2000.0,1,1,0
FR,RS,2007.0,4,2,2
IT,BG,2016.0,14,8,6
CA,MA,2008.0,17,7,10
PT,MX,2014.0,11,21,-10
IT,UY,2012.0,4,8,-4
IS,SE,2001.0,4,8,-4
BG,BR,2015.0,4,9,-5
AU,HR,2015.0,1,1,0
IS,US,2005.0,14,14,0
SK,FI,2007.0,16,2,14
LV,US,2006.0,2,6,-4
KZ,KR,2018.0,3,7,-4
GR,LK,2022.0,4,1,3
AU,PL,2015.0,19,22,-3
IT,PL,2010.0,18,28,-10
US,NG,2002.0,13,17,-4
KE,UG,2016.0,9,8,1
CU,MX,1998.0,3,11,-8
JP,IE,1997.0,6,14,-8
BR,UY,2011.0,33,50,-17
US,ML,2010.0,5,6,-1
CA,BF,2015.0,4,3,1
IT,CZ,2004.0,6,10,-4
IL,IT,2000.0,8,14,-6
CA,CY,2006.0,2,2,0
SE,HU,2015.0,11,18,-7
JP,BG,2015.0,9,2,7
KR,MY,2020.0,25,27,-2
US,SK,2011.0,37,31,6
SE,nan,1999.0,25,37,-12
IR,BE,2013.0,22,17,5
GR,RS,2011.0,3,1,2
CY,US,2012.0,13,31,-18
VG,US,2020.0,7,5,2
AU,DK,2010.0,34,28,6
IT,LB,2016.0,11,11,0
ML,IN,2012.0,8,3,5
AT,SK,2002.0,12,4,8
AU,AT,2012.0,23,25,-2
FI,UA,2016.0,2,6,-4
RU,BE,2000.0,14,9,5
GB,SS,1997.0,2,7,-5
BJ,FR,2004.0,15,14,1
AT,TN,2020.0,1,1,0
PT,nan,2010.0,27,24,3
US,SY,2022.0,3,10,-7
US,RE,2018.0,2,2,0
IS,CN,2021.0,1,1,0
EC,CL,2004.0,2,2,0
CZ,PL,2008.0,25,42,-17
MT,GB,2012.0,7,12,-5
SA,QA,2012.0,7,10,-3
ZA,CN,2007.0,2,5,-3
CU,DE,2013.0,5,1,4
KR,GB,2000.0,26,32,-6
RS,DE,2013.0,17,22,-5
TR,JP,2001.0,29,45,-16
IN,BD,2000.0,6,9,-3
TT,IN,2022.0,4,2,2
CH,AR,2011.0,10,15,-5
CL,CR,2008.0,7,13,-6
GR,MY,2011.0,2,1,1
JP,AR,2015.0,4,6,-2
CZ,FI,2015.0,5,10,-5
DK,PT,2008.0,1,4,-3
CR,EC,2009.0,1,1,0
GE,nan,2003.0,1,1,0
SI,nan,2017.0,7,1,6
AU,VN,2011.0,19,11,8
IE,BD,1999.0,1,2,-1
nan,ES,2003.0,12,11,1
TR,nan,2005.0,2,5,-3
AU,RU,2007.0,6,18,-12
AE,GB,2020.0,38,76,-38
CO,IL,2021.0,5,3,2
ZA,PK,2021.0,8,5,3
TR,CH,2006.0,8,7,1
ID,IN,2010.0,9,7,2
MX,CR,2010.0,19,23,-4
VE,SE,2011.0,1,1,0
FR,MQ,2003.0,8,5,3
MX,DE,2004.0,15,22,-7
US,BN,2002.0,1,1,0
AE,OM,2022.0,3,3,0
NP,KR,2011.0,4,7,-3
US,LT,2016.0,13,13,0
GT,ES,2000.0,2,1,1
CL,IL,2015.0,2,1,1
FR,GA,2006.0,5,7,-2
SE,PT,2013.0,5,13,-8
CL,BE,2018.0,8,18,-10
PR,US,2000.0,8,3,5
CN,SA,2007.0,5,3,2
KW,CA,2000.0,3,3,0
JO,ID,2017.0,2,3,-1
KZ,JP,2021.0,3,4,-1
SC,ZA,2018.0,2,1,1
CA,CO,2004.0,6,9,-3
SK,ES,2003.0,2,2,0
SE,FI,2003.0,41,64,-23
CM,CA,2021.0,2,1,1
FI,IR,2021.0,5,34,-29
CW,BE,2020.0,5,2,3
PL,BE,2011.0,15,20,-5
CH,TZ,2011.0,2,6,-4
TW,SG,2000.0,14,17,-3
IN,NZ,2003.0,13,3,10
KR,PK,2007.0,5,6,-1
SA,KW,2016.0,9,19,-10
SG,TH,2008.0,4,8,-4
PL,CZ,2003.0,11,18,-7
BE,TH,2013.0,5,1,4
SE,CZ,2004.0,7,6,1
LB,QA,2020.0,7,1,6
GR,CY,2009.0,23,14,9
CH,HU,2011.0,18,10,8
MK,AU,2022.0,13,43,-30
RU,DK,2000.0,4,7,-3
IT,PL,2017.0,26,26,0
FR,IL,2010.0,29,28,1
GE,DE,1998.0,4,2,2
BE,DK,2022.0,38,39,-1
IT,NL,1999.0,40,30,10
AE,CN,2012.0,4,2,2
IE,AU,2000.0,39,27,12
MX,PL,2021.0,7,3,4
nan,AU,1998.0,5,5,0
IR,IT,2004.0,2,5,-3
CN,AR,2002.0,1,1,0
BO,US,2005.0,5,11,-6
DE,MY,2022.0,8,17,-9
FR,UA,2011.0,14,16,-2
US,AZ,2022.0,4,3,1
VE,AR,2019.0,17,13,4
AZ,UA,2013.0,3,1,2
AM,LT,2017.0,1,1,0
PT,CA,2015.0,17,15,2
CM,ZA,2018.0,10,15,-5
GB,CY,2002.0,6,3,3
AU,IR,1998.0,11,2,9
NO,RU,1998.0,6,1,5
HU,CH,2003.0,6,11,-5
KE,US,2002.0,21,22,-1
IS,US,2002.0,7,13,-6
ZA,IN,2019.0,67,86,-19
TH,nan,2008.0,1,1,0
MW,ZA,2018.0,7,17,-10
MY,BR,2002.0,25,32,-7
RU,ZW,2015.0,19,15,4
OM,IQ,2018.0,6,4,2
NG,PK,2021.0,11,4,7
SI,NO,2016.0,2,1,1
MX,NZ,2011.0,3,1,2
DE,SI,2017.0,14,23,-9
BA,CA,2011.0,2,1,1
AR,CH,2004.0,4,4,0
BR,SE,2000.0,13,7,6
LK,JP,2013.0,19,21,-2
GP,FR,2022.0,9,21,-12
JP,ZA,2008.0,3,5,-2
NG,JP,2016.0,14,14,0
MY,TH,2013.0,6,6,0
GR,BG,2000.0,2,1,1
nan,AT,2011.0,5,11,-6
JP,KE,2009.0,6,5,1
FI,ZA,2013.0,7,2,5
SI,ES,2022.0,5,7,-2
PL,UA,2001.0,8,14,-6
US,YE,2000.0,2,1,1
GR,NL,2010.0,15,16,-1
RS,ES,2019.0,3,4,-1
CH,TN,2008.0,6,4,2
JP,PK,1997.0,5,10,-5
SA,SE,2012.0,4,6,-2
LI,AT,2021.0,4,2,2
CH,MZ,2008.0,1,1,0
KZ,RU,2005.0,5,10,-5
nan,UA,2010.0,17,19,-2
ES,MA,2008.0,5,6,-1
LT,JP,1999.0,3,2,1
US,ML,2017.0,8,7,1
KR,EG,2020.0,11,11,0
CZ,RS,2008.0,13,9,4
SK,NL,2008.0,9,7,2
SA,IN,2006.0,10,9,1
ZA,AT,2017.0,4,8,-4
PS,EG,2017.0,9,9,0
DE,MD,2014.0,3,3,0
AM,JP,2007.0,6,7,-1
GH,GB,2004.0,5,12,-7
GB,VN,2023.0,3,3,0
CA,YE,2019.0,1,1,0
AT,GR,2014.0,5,10,-5
IR,LY,2014.0,1,1,0
MA,SA,2016.0,4,3,1
LI,DE,2006.0,1,9,-8
UA,TR,2021.0,5,2,3
TT,CA,2004.0,2,2,0
CU,BR,2004.0,15,5,10
IN,TW,1999.0,13,2,11
SI,RS,2009.0,10,8,2
RS,CZ,2013.0,10,8,2
IL,ES,1999.0,8,5,3
YE,MY,2007.0,1,1,0
AT,TR,2019.0,18,7,11
ES,RS,2005.0,2,2,0
GR,IL,2012.0,2,1,1
NI,nan,2016.0,2,2,0
CO,CH,2021.0,7,6,1
NZ,NP,2011.0,14,20,-6
GB,LK,1999.0,3,6,-3
BH,NG,2012.0,5,4,1
AU,MK,2009.0,28,20,8
NO,KR,2007.0,4,2,2
CL,CU,2009.0,8,15,-7
DE,EC,2014.0,5,4,1
CZ,DK,2015.0,7,2,5
GR,TW,2012.0,4,1,3
LY,SA,2019.0,10,1,9
MT,IT,2021.0,2,4,-2
VE,AR,2010.0,10,19,-9
BE,TN,2012.0,3,3,0
HU,CA,2000.0,9,6,3
SJ,NO,2021.0,3,7,-4
US,KW,2002.0,9,14,-5
US,EC,2004.0,6,6,0
TH,VN,2005.0,1,1,0
PL,IN,2021.0,13,25,-12
PT,AU,2014.0,16,7,9
MX,BR,2002.0,23,24,-1
PT,BE,2000.0,2,2,0
CL,KR,2012.0,1,2,-1
VN,MY,2019.0,4,17,-13
SN,PK,2017.0,2,2,0
CM,NG,2006.0,3,2,1
DZ,EG,2014.0,6,3,3
PL,AT,2015.0,15,20,-5
US,TZ,2010.0,5,6,-1
JO,IR,2015.0,5,2,3
CH,RU,1998.0,4,15,-11
ZA,MW,2009.0,3,2,1
FI,ES,2001.0,4,2,2
RU,nan,2000.0,11,9,2
CA,NO,1998.0,5,6,-1
NO,GH,2022.0,2,2,0
PL,BR,2001.0,5,2,3
CA,KE,2003.0,3,2,1
UY,ES,1998.0,6,8,-2
IT,CN,1998.0,9,11,-2
CA,PE,2021.0,11,7,4
KE,NG,2012.0,4,3,1
ID,CZ,2002.0,1,1,0
NO,ES,1997.0,7,7,0
GR,CN,2001.0,2,5,-3
CG,FR,2002.0,7,7,0
BE,RS,2021.0,7,1,6
TN,nan,2015.0,6,6,0
IQ,SA,2016.0,12,18,-6
GB,NA,2020.0,3,2,1
RW,SE,2022.0,1,1,0
KR,GH,2018.0,3,4,-1
ZM,ZA,2019.0,7,14,-7
OM,CA,2020.0,9,8,1
IE,CO,2019.0,4,1,3
FR,AM,2018.0,2,4,-2
CM,DE,2021.0,7,3,4
PA,US,2013.0,40,52,-12
HR,TW,2010.0,1,2,-1
LY,CA,2019.0,1,1,0
TH,TW,2007.0,3,1,2
LK,DE,2005.0,1,1,0
CO,BE,2010.0,4,4,0
PL,CN,2002.0,8,7,1
BO,CO,2016.0,14,6,8
MX,UY,2008.0,4,3,1
UZ,KZ,2016.0,11,3,8
MG,FR,2010.0,10,3,7
CN,CZ,2000.0,1,7,-6
US,MG,2008.0,1,2,-1
MA,US,2019.0,24,30,-6
CR,UY,2015.0,1,1,0
CZ,KZ,2021.0,2,1,1
AR,AT,2019.0,6,4,2
NE,BE,2016.0,2,3,-1
BH,AE,2022.0,2,1,1
PT,CO,2008.0,5,7,-2
BE,RO,2017.0,10,12,-2
IT,TH,2017.0,5,3,2
JP,VE,2013.0,4,1,3
PL,BH,2021.0,9,12,-3
MA,ID,2020.0,7,5,2
RU,GR,2021.0,5,2,3
ID,BD,2013.0,7,5,2
IS,CA,2016.0,6,2,4
PL,LV,2018.0,1,3,-2
SG,BD,2018.0,7,3,4
KE,BE,2001.0,2,1,1
RU,NO,2018.0,13,21,-8
US,HR,1999.0,23,16,7
US,TT,2014.0,6,8,-2
SE,BA,2016.0,1,4,-3
AU,nan,2022.0,15,12,3
GB,VE,2001.0,3,5,-2
PK,AE,2010.0,6,4,2
NL,IN,2004.0,15,20,-5
PH,PL,2012.0,2,1,1
BG,CN,2020.0,7,3,4
UY,BE,2011.0,1,2,-1
BY,GB,1999.0,2,2,0
IN,HU,2021.0,9,9,0
KR,RU,2010.0,13,5,8
ES,JO,2015.0,6,1,5
BD,nan,2015.0,4,4,0
IT,CL,2008.0,18,14,4
NZ,TW,2011.0,9,6,3
NL,PT,1997.0,5,5,0
BG,JP,1999.0,7,3,4
DK,NZ,2015.0,7,5,2
SA,BR,2013.0,3,1,2
ES,IL,1997.0,1,3,-2
KR,NL,2010.0,6,8,-2
DK,FR,2004.0,17,27,-10
BD,AE,2015.0,4,3,1
BD,SG,2018.0,3,7,-4
US,ML,2019.0,10,5,5
DE,CY,2016.0,7,6,1
IE,CO,2017.0,3,3,0
GR,TR,2008.0,5,8,-3
NO,nan,2008.0,22,24,-2
GR,ZA,2014.0,3,2,1
RO,BR,2017.0,3,6,-3
NG,KR,2015.0,11,10,1
GB,CY,2005.0,10,1,9
MD,CH,2020.0,5,5,0
KZ,RU,2002.0,11,11,0
GA,FR,2009.0,5,6,-1
MA,CG,2013.0,1,2,-1
HR,NL,2007.0,2,5,-3
IR,PT,2018.0,18,11,7
NG,FR,1998.0,1,2,-1
AF,MX,2021.0,1,1,0
FR,CM,2008.0,11,12,-1
ES,SV,2020.0,2,9,-7
QA,DK,2015.0,2,2,0
HK,NL,2011.0,5,13,-8
US,CM,2011.0,8,14,-6
PL,CN,2005.0,10,14,-4
RO,PT,2005.0,5,3,2
HU,BE,1999.0,7,4,3
GL,DK,2007.0,7,1,6
MM,JP,2021.0,5,8,-3
SI,SK,2015.0,4,2,2
OM,US,2011.0,7,14,-7
BG,DK,2004.0,6,2,4
NL,PT,1998.0,4,1,3
EG,DK,2010.0,1,3,-2
SE,MX,2008.0,6,7,-1
DE,GA,2016.0,5,5,0
RO,PL,2004.0,5,1,4
CH,RU,1997.0,5,11,-6
IT,BJ,2017.0,1,1,0
PL,UZ,2018.0,2,1,1
GE,PL,2018.0,1,1,0
nan,ZA,2004.0,4,4,0
CR,PE,2014.0,4,10,-6
MA,US,2010.0,16,10,6
MA,EG,2007.0,2,1,1
MZ,BR,2015.0,15,20,-5
AM,BE,2011.0,2,1,1
AT,CO,2020.0,2,2,0
SE,KR,2003.0,5,3,2
IN,SK,2006.0,4,3,1
US,SD,1999.0,1,3,-2
PE,HN,2019.0,2,4,-2
BO,US,2002.0,4,2,2
SI,US,2011.0,14,26,-12
RO,MX,2005.0,1,3,-2
IL,PH,2008.0,2,2,0
JM,GB,2021.0,5,4,1
CI,MA,2014.0,1,1,0
BR,NL,2023.0,3,1,2
CO,PA,2021.0,9,12,-3
GE,IE,2019.0,1,1,0
CO,PE,1999.0,6,8,-2
ZA,AE,2019.0,7,5,2
CZ,RO,2013.0,8,20,-12
CN,BD,2002.0,2,2,0
CN,CR,2016.0,2,4,-2
KR,FR,2000.0,10,4,6
RS,AT,2015.0,8,4,4
IN,KZ,2017.0,1,3,-2
SA,JP,2019.0,9,15,-6
MA,CH,2003.0,2,1,1
IR,EG,2015.0,4,5,-1
JO,ID,2019.0,8,2,6
LA,US,2014.0,1,1,0
FI,TH,2003.0,2,2,0
CR,ES,2003.0,7,18,-11
CO,CN,2014.0,6,2,4
JO,PS,2021.0,7,10,-3
NZ,IE,2002.0,5,5,0
NO,ES,1998.0,8,7,1
CA,GP,2016.0,1,1,0
CY,NG,2022.0,4,2,2
JP,JO,2016.0,4,1,3
KE,CA,2011.0,4,5,-1
ES,PK,2019.0,7,2,5
MY,SD,2011.0,4,3,1
TH,CA,2005.0,7,6,1
HR,JP,2003.0,1,1,0
IE,nan,2015.0,3,2,1
US,PA,2002.0,14,6,8
JP,SI,2017.0,3,4,-1
IT,SA,2018.0,8,11,-3
ZA,NG,2010.0,10,28,-18
IR,US,1999.0,8,19,-11
BM,US,2012.0,3,3,0
AU,MW,2017.0,2,2,0
BG,NO,2018.0,7,1,6
NL,BD,2009.0,3,1,2
NL,UA,2002.0,5,1,4
RO,CZ,2013.0,20,8,12
KE,SE,2016.0,1,6,-5
SG,PH,2004.0,3,3,0
GE,IN,2008.0,2,3,-1
EG,VN,2008.0,1,2,-1
CL,BO,2015.0,6,5,1
NG,BH,2011.0,2,2,0
KR,ID,2008.0,1,3,-2
AT,SG,2016.0,3,5,-2
GH,SA,2018.0,1,1,0
PK,SE,2020.0,10,11,-1
nan,NL,1997.0,8,14,-6
PL,IE,2014.0,4,9,-5
PL,EG,2012.0,3,4,-1
RO,NO,2000.0,2,1,1
CY,ES,2014.0,2,1,1
FR,IS,2020.0,6,5,1
DE,PA,2006.0,2,1,1
JP,IL,2020.0,7,15,-8
CL,PL,2016.0,6,4,2
FR,CY,2015.0,3,2,1
SK,NG,2019.0,1,1,0
BB,CA,2008.0,1,1,0
KR,IE,2019.0,7,4,3
TR,BE,2001.0,3,5,-2
CN,BD,2005.0,10,8,2
UA,CA,2016.0,5,13,-8
RE,FR,1997.0,2,3,-1
FR,PF,2003.0,8,3,5
CU,MX,1997.0,5,5,0
CH,TR,2003.0,3,4,-1
MU,ZA,2014.0,2,1,1
CU,nan,2015.0,4,5,-1
BJ,CM,2019.0,2,1,1
BR,CZ,2015.0,3,7,-4
KE,IT,2020.0,8,2,6
UA,CZ,2001.0,4,2,2
RS,SI,2001.0,2,2,0
TR,TW,2021.0,10,5,5
NL,BJ,2012.0,3,1,2
PL,BG,2014.0,4,6,-2
KH,JP,2002.0,6,3,3
VE,PE,2007.0,3,6,-3
US,LU,2004.0,7,2,5
HU,MX,2019.0,1,3,-2
KR,AT,2006.0,1,4,-3
IL,UY,2019.0,1,2,-1
ES,UA,2003.0,2,4,-2
CN,NO,2001.0,4,9,-5
IN,CY,2015.0,2,2,0
CH,MY,2011.0,5,2,3
NG,AU,2013.0,8,3,5
MZ,PT,2013.0,1,4,-3
FJ,DE,2015.0,1,1,0
UY,PE,2022.0,1,2,-1
TZ,GB,2011.0,12,14,-2
UY,MX,1998.0,2,1,1
nan,AU,1997.0,4,3,1
BY,DE,2015.0,4,5,-1
AT,SK,2005.0,7,13,-6
TW,PL,2007.0,2,1,1
ES,PK,2010.0,3,1,2
PF,FR,2003.0,3,8,-5
JP,QA,2012.0,4,1,3
EE,GB,2009.0,7,7,0
TR,RU,2013.0,4,8,-4
NZ,IR,2011.0,7,3,4
RS,AU,2011.0,1,3,-2
CF,FR,2003.0,1,3,-2
CH,PS,2021.0,1,1,0
CN,PR,2008.0,1,1,0
LU,TR,2017.0,1,2,-1
NP,DK,2019.0,5,1,4
AF,IN,2019.0,3,4,-1
IS,NO,2006.0,4,4,0
KZ,BG,2019.0,3,2,1
MZ,US,2019.0,6,3,3
FR,BY,2016.0,1,2,-1
JP,ZM,2016.0,3,4,-1
BF,NE,2014.0,2,1,1
PE,HN,2017.0,1,4,-3
CN,MA,2020.0,7,7,0
CA,NO,1997.0,4,4,0
BJ,ML,2019.0,2,1,1
LB,SA,2013.0,9,4,5
IE,FR,1999.0,5,10,-5
ES,MT,2011.0,3,7,-4
PK,KW,2006.0,2,3,-1
IQ,MA,2020.0,2,6,-4
IT,TH,2010.0,3,3,0
CH,LI,2009.0,3,3,0
LU,PT,2008.0,1,1,0
NL,LK,2015.0,2,3,-1
MW,NL,2018.0,3,1,2
NG,CH,2018.0,4,3,1
GT,CR,2018.0,1,1,0
KE,CN,2012.0,6,5,1
KR,IT,2020.0,9,7,2
CN,KY,2022.0,2,1,1
BN,US,2014.0,4,5,-1
CH,SI,2006.0,3,2,1
VN,MY,2017.0,4,7,-3
SD,DE,2018.0,1,3,-2
RW,CA,2010.0,1,1,0
VN,SE,2003.0,2,2,0
MA,ML,2014.0,2,2,0
PL,DK,2000.0,3,3,0
MX,BG,2006.0,1,3,-2
PL,NO,2009.0,7,4,3
SE,EE,2022.0,5,7,-2
JO,AE,2008.0,3,2,1
VN,TW,2006.0,1,3,-2
CU,PT,2009.0,5,1,4
SI,FR,2018.0,3,16,-13
TR,NO,2021.0,7,7,0
QA,FR,2014.0,7,18,-11
NL,NP,2018.0,8,3,5
GR,KW,2020.0,3,4,-1
GB,BG,2006.0,5,9,-4
MY,KW,2011.0,1,2,-1
DK,VN,2015.0,5,1,4
DK,PL,2022.0,6,12,-6
LY,MY,2014.0,5,4,1
RS,ES,2017.0,5,2,3
UA,UZ,2013.0,2,4,-2
NG,SA,1999.0,1,3,-2
PL,CA,1999.0,6,8,-2
PK,BR,2018.0,5,10,-5
IN,LV,2017.0,2,1,1
KR,SG,1999.0,2,4,-2
SI,nan,2019.0,2,15,-13
BA,IQ,2018.0,2,6,-4
BE,IL,2021.0,3,6,-3
IN,CO,2021.0,2,3,-1
SE,KE,2008.0,4,3,1
AT,CZ,2001.0,3,9,-6
NG,FR,1997.0,1,1,0
PL,nan,2002.0,2,5,-3
SG,SI,2017.0,1,2,-1
ZM,ZA,2010.0,3,1,2
ES,TW,2014.0,5,4,1
CL,AT,2015.0,3,7,-4
DK,AR,2022.0,3,5,-2
VN,TH,2005.0,1,1,0
VN,nan,2022.0,2,3,-1
ZA,NL,2023.0,1,2,-1
AT,CL,2016.0,7,6,1
CI,BE,2010.0,1,1,0
GB,KW,2008.0,6,6,0
NO,CO,2013.0,4,3,1
US,GT,2005.0,1,4,-3
GB,ID,2007.0,10,3,7
SN,CG,2001.0,1,1,0
AT,TW,2002.0,1,3,-2
RS,GR,2015.0,2,2,0
CU,CH,2022.0,2,1,1
TZ,ZA,2011.0,3,5,-2
HK,CN,2001.0,2,1,1
TW,NZ,2003.0,1,3,-2
SI,NL,2009.0,3,3,0
PK,SG,2015.0,5,7,-2
AE,SE,2006.0,1,3,-2
BY,JP,1999.0,5,5,0
PK,BF,2010.0,1,1,0
PK,BF,2017.0,1,1,0
BF,CI,2015.0,2,6,-4
ZW,AU,2006.0,2,1,1
PT,JP,2011.0,5,6,-1
SA,PT,2015.0,2,5,-3
HR,AU,2015.0,1,1,0
GR,CA,2022.0,7,7,0
IR,KR,2011.0,10,3,7
GA,US,2018.0,1,3,-2
BY,CZ,2009.0,8,7,1
DE,VN,2008.0,10,6,4
NL,ID,2006.0,7,4,3
SA,OM,2020.0,13,14,-1
MX,NL,2004.0,4,5,-1
NL,TW,2016.0,3,8,-5
KG,CA,2020.0,1,1,0
IE,IL,2009.0,2,3,-1
ES,PK,2017.0,5,2,3
MZ,BE,2015.0,3,1,2
NO,BE,2015.0,8,12,-4
CU,SV,2014.0,1,1,0
TR,ET,2020.0,3,1,2
TZ,KE,2016.0,12,7,5
AT,SA,2014.0,1,4,-3
IT,PK,2023.0,3,2,1
BG,IN,2013.0,1,1,0
ID,GR,2019.0,2,5,-3
NG,SN,2019.0,2,2,0
CN,LU,2022.0,2,3,-1
VN,MY,2010.0,2,1,1
ID,BN,2022.0,3,1,2
nan,NI,2019.0,3,3,0
NZ,IL,2000.0,2,3,-1
GB,BB,1999.0,2,1,1
ES,SD,2016.0,2,1,1
PT,IE,2007.0,4,3,1
TH,DE,2022.0,2,16,-14
BD,CH,2014.0,3,3,0
PA,CU,2019.0,3,6,-3
GE,IT,2020.0,2,2,0
PS,EG,2010.0,1,1,0
NG,CM,2019.0,4,7,-3
SY,PS,2019.0,1,2,-1
PL,MA,2021.0,1,1,0
BE,CN,1999.0,9,15,-6
BY,SK,2017.0,1,4,-3
AE,HU,2020.0,2,1,1
XK,AL,2015.0,3,5,-2
NZ,JO,2021.0,1,1,0
CA,FJ,2013.0,1,1,0
MZ,ES,2007.0,1,1,0
BR,IL,1999.0,2,1,1
NG,JO,2017.0,1,2,-1
CU,BO,2012.0,2,1,1
FR,TT,2010.0,1,1,0
CA,VE,1999.0,4,1,3
UA,KZ,2014.0,2,2,0
GN,BF,2021.0,1,1,0
EG,PS,2022.0,5,11,-6
CN,CM,2019.0,3,1,2
BG,KR,2010.0,1,1,0
QA,NZ,2021.0,2,3,-1
BB,JM,2012.0,4,8,-4
IR,JO,2019.0,3,6,-3
CZ,PT,2022.0,2,2,0
BO,BR,2009.0,1,3,-2
RS,ES,2010.0,1,2,-1
IN,ZM,2012.0,1,2,-1
UG,US,2000.0,3,4,-1
SE,CU,2021.0,1,1,0
GB,GE,2004.0,2,3,-1
VE,CN,2019.0,1,2,-1
CO,RS,2019.0,1,6,-5
PL,AU,2004.0,3,5,-2
IN,GH,2009.0,1,4,-3
TR,nan,2002.0,4,3,1
PH,AT,2015.0,1,1,0
IR,ET,2016.0,1,2,-1
IR,DK,2004.0,1,2,-1
RU,TJ,2003.0,3,3,0
IR,TH,2003.0,1,1,0
LY,IN,2010.0,2,5,-3
DE,ID,1997.0,1,1,0
NO,BG,2006.0,3,6,-3
PA,IE,2013.0,1,1,0
MD,UA,2016.0,2,1,1
DE,LK,2011.0,1,2,-1
US,BI,2021.0,1,1,0
UA,NL,2011.0,3,5,-2
PH,ZA,2006.0,1,1,0
ES,IL,1998.0,2,6,-4
CU,PY,2008.0,3,12,-9
EG,PL,2017.0,1,4,-3
PK,SD,2019.0,4,4,0
CH,BG,2013.0,1,2,-1
CA,UA,2020.0,6,9,-3
CL,nan,2005.0,1,3,-2
CU,VE,1999.0,1,2,-1
TH,CA,2002.0,3,2,1
IN,PL,2010.0,5,6,-1
PL,FI,2006.0,2,5,-3
RS,HK,2010.0,1,2,-1
DO,BR,2012.0,2,1,1
AU,MX,1999.0,3,4,-1
MY,GB,2023.0,3,3,0
SV,MX,2006.0,1,1,0
NO,SG,2013.0,1,2,-1
SK,PT,2022.0,2,1,1
NL,UA,2005.0,1,6,-5
LK,NZ,2015.0,1,4,-3
NI,CL,2012.0,1,2,-1
CY,TR,1999.0,2,1,1
LV,SE,2016.0,4,2,2
NG,TZ,2007.0,1,2,-1
PT,SE,1998.0,2,1,1
TW,HK,2009.0,1,1,0
AZ,US,2003.0,3,1,2
PL,nan,2005.0,1,8,-7
BE,NZ,2006.0,5,2,3
DE,IS,2021.0,2,5,-3
RU,AM,2007.0,5,10,-5
US,XK,2020.0,4,3,1
PA,CU,2017.0,1,2,-1
TH,ES,2007.0,1,1,0
BD,LK,2013.0,2,1,1
CA,HK,2014.0,1,5,-4
ZA,AE,2010.0,3,1,2
UA,ES,2000.0,1,2,-1
KE,BJ,2007.0,1,1,0
GB,PE,2005.0,4,7,-3
JP,SI,2010.0,5,2,3
SJ,FI,2015.0,3,1,2
CH,MD,2011.0,2,2,0
AT,MX,2022.0,1,3,-2
SA,KZ,2021.0,1,4,-3
VE,SV,2016.0,1,1,0
BE,QA,2017.0,1,1,0
EG,PL,2019.0,3,2,1
CH,GH,2016.0,2,2,0
MX,AU,2000.0,3,4,-1
FI,PL,2006.0,5,2,3
MK,BG,2017.0,2,2,0
HR,SE,2008.0,3,3,0
IN,JM,2011.0,1,1,0
IS,IE,2013.0,1,1,0
ET,NO,2011.0,4,4,0
LU,CN,2009.0,2,6,-4
AR,ZA,2022.0,2,1,1
FI,CZ,2007.0,2,2,0
NO,RU,1997.0,2,2,0
MX,UA,2005.0,2,2,0
TW,PK,2000.0,1,1,0
PS,CA,2012.0,1,1,0
CU,AU,2013.0,1,2,-1
CR,PT,2016.0,1,2,-1
CO,IE,2006.0,1,1,0
IT,EG,2005.0,1,5,-4
BG,BY,2020.0,3,1,2
KG,JP,2019.0,1,5,-4
FI,IT,2023.0,5,6,-1
NG,NP,2014.0,2,1,1
KZ,DE,2003.0,1,4,-3
KH,FR,2004.0,3,3,0
ES,CY,2014.0,1,2,-1
DO,VE,2022.0,1,1,0
BB,US,2018.0,1,6,-5
ML,GN,2016.0,2,1,1
DE,BD,2000.0,2,2,0
GN,FR,2018.0,3,5,-2
MX,UA,2002.0,1,3,-2
BR,PA,2014.0,2,4,-2
MD,RU,2002.0,1,3,-2
JO,BE,2014.0,1,1,0
KZ,FI,2020.0,1,2,-1
KW,OM,2016.0,2,1,1
BE,IE,2001.0,2,4,-2
IT,VN,2008.0,2,2,0
LK,nan,2016.0,1,1,0
MK,RS,2014.0,2,1,1
GB,FJ,2005.0,1,1,0
BG,HU,2014.0,1,2,-1
IT,AO,2006.0,1,1,0
IT,MD,2003.0,2,2,0
KW,DE,1997.0,1,1,0
BR,MA,2009.0,1,1,0
LU,NL,2006.0,1,3,-2
QA,PT,2018.0,1,1,0
ZA,GE,2020.0,1,1,0
GB,US,2017.0,6215,6108,107
US,CN,2013.0,6041,4715,1326
CA,US,2003.0,2171,2072,99
JP,KR,2007.0,254,229,25
IL,US,2020.0,541,553,-12
SE,AT,2010.0,18,16,2
GB,NL,2002.0,154,161,-7
IT,GB,2014.0,611,491,120
SG,US,2007.0,255,206,49
GE,US,2009.0,137,164,-27
HK,CA,2005.0,3,1,2
CN,AU,2022.0,332,480,-148
SE,DE,2013.0,176,234,-58
CO,BR,2018.0,237,216,21
DE,LU,2016.0,42,23,19
AT,GB,2009.0,97,70,27
RS,US,2011.0,41,50,-9
KR,IE,2010.0,11,3,8
EG,DK,2017.0,5,4,1
NL,nan,2015.0,73,87,-14
CN,SY,2009.0,32,34,-2
IN,CN,2002.0,43,35,8
RO,US,2018.0,102,96,6
TH,JP,2018.0,68,119,-51
ES,BA,2020.0,2,1,1
NO,US,1999.0,63,67,-4
TR,PK,2014.0,17,11,6
CH,ML,2013.0,1,2,-1
CA,SG,2011.0,34,32,2
BE,AT,2015.0,22,15,7
LT,US,2022.0,4,5,-1
GB,EG,2009.0,70,43,27
GT,MX,2018.0,20,35,-15
IR,CZ,2020.0,14,3,11
US,AO,2022.0,2,3,-1
DE,GR,2005.0,32,33,-1
FR,IL,2019.0,58,27,31
DO,EC,2021.0,3,2,1
PY,DE,2021.0,2,2,0
ID,PK,2015.0,20,33,-13
FR,TN,2009.0,166,130,36
BE,RO,2010.0,7,7,0
IR,NO,2014.0,18,5,13
NL,SI,2021.0,5,8,-3
nan,NI,2017.0,6,2,4
PH,DE,2008.0,7,6,1
GB,IR,2002.0,47,11,36
NO,FR,2007.0,26,58,-32
GB,IS,2012.0,8,5,3
TW,IT,2014.0,6,3,3
SA,MA,2017.0,9,5,4
KE,DE,2014.0,11,19,-8
PS,EG,2019.0,19,9,10
SA,JP,2010.0,7,6,1
nan,NL,1998.0,19,18,1
TH,NO,2018.0,2,4,-2
ZM,ZA,2017.0,10,10,0
FR,KZ,2015.0,2,1,1
KR,RU,2019.0,29,25,4
SA,TH,2018.0,6,5,1
CO,TR,2018.0,20,147,-127
DK,FI,2021.0,18,20,-2
SG,DK,2008.0,5,1,4
AZ,ID,2021.0,3,2,1
FR,DK,2005.0,29,17,12
BE,CA,2007.0,51,43,8
BD,PL,2013.0,4,1,3
nan,RS,2015.0,2,1,1
PL,KR,2007.0,2,5,-3
US,AG,2018.0,4,4,0
CA,TW,2022.0,23,26,-3
DE,SI,2010.0,12,10,2
TR,SE,2012.0,10,8,2
JP,FI,2012.0,23,13,10
US,SL,2021.0,2,5,-3
UY,DE,2019.0,5,2,3
MG,FR,2019.0,12,20,-8
PE,VE,2007.0,6,3,3
IT,IL,2003.0,6,9,-3
RO,SE,2007.0,1,3,-2
NZ,IN,2012.0,20,18,2
BE,UG,2018.0,10,17,-7
TR,PT,2000.0,1,1,0
AT,CA,2001.0,13,16,-3
BR,EC,2013.0,7,7,0
PL,BD,2008.0,4,1,3
RS,SK,2015.0,6,8,-2
CH,NZ,2010.0,13,5,8
FR,DK,2002.0,17,18,-1
JP,MN,2016.0,15,3,12
SA,JP,2017.0,12,13,-1
NL,PE,2020.0,2,8,-6
MY,TR,2016.0,21,13,8
AU,MW,2019.0,1,1,0
TW,KE,2015.0,2,1,1
DE,TZ,2015.0,5,7,-2
AE,QA,2011.0,8,1,7
CO,RU,2019.0,2,3,-1
CR,CN,2006.0,1,1,0
LU,GB,2022.0,8,6,2
ZA,MY,2019.0,6,7,-1
RU,LT,2020.0,7,14,-7
MY,LY,2014.0,4,5,-1
SE,TR,2012.0,8,10,-2
BG,NL,2020.0,1,3,-2
VN,NO,2012.0,4,3,1
NC,FR,2012.0,11,19,-8
CI,BE,2019.0,4,3,1
SE,BE,2004.0,14,16,-2
SI,DE,2006.0,5,3,2
ZA,RE,2013.0,1,2,-1
AT,DK,2012.0,10,10,0
FI,EE,2008.0,8,9,-1
GB,LU,2010.0,6,5,1
UG,FR,2021.0,3,1,2
VE,AR,2017.0,19,12,7
NZ,IE,2005.0,7,4,3
AF,IN,2017.0,1,1,0
MY,RS,2020.0,1,1,0
NP,JP,2023.0,1,2,-1
IQ,OM,2021.0,2,9,-7
IT,CN,1997.0,10,11,-1
SN,BJ,2017.0,4,2,2
EE,nan,2018.0,1,1,0
MX,NI,2020.0,4,7,-3
CU,UY,2020.0,3,3,0
ZW,GB,2010.0,2,2,0
UA,IL,1999.0,2,1,1
KW,BH,2022.0,3,3,0
IT,TW,2013.0,3,4,-1
IE,CO,2010.0,8,1,7
CH,TH,2014.0,2,1,1
ZA,AT,2010.0,3,3,0
NO,MY,2015.0,2,3,-1
RO,BR,2019.0,6,9,-3
FI,MY,2016.0,6,1,5
NL,NZ,1999.0,1,5,-4
VE,CN,2017.0,2,1,1
EC,RU,2002.0,1,1,0
IN,TH,2000.0,3,1,2
EE,ZA,2017.0,1,2,-1
ZA,EE,2018.0,1,1,0
US,UG,1998.0,4,3,1
SE,NP,2018.0,1,1,0
CA,KG,2019.0,1,1,0
TJ,RU,2010.0,8,15,-7
BE,SK,2014.0,2,3,-1
AU,IR,1997.0,5,2,3
IR,CO,2021.0,2,5,-3
NE,FR,1998.0,4,2,2
BJ,NG,2015.0,5,3,2
QA,BH,2012.0,1,1,0
ES,EG,2009.0,3,2,1
GT,CO,2011.0,2,3,-1
CO,BE,2019.0,9,9,0
HR,BE,2018.0,6,4,2
XK,FR,2019.0,1,2,-1
IS,NL,2006.0,1,1,0
IT,KR,2007.0,4,8,-4
PT,GB,2007.0,52,59,-7
GB,AT,2016.0,105,127,-22
AT,NL,2009.0,24,19,5
RU,LV,2022.0,8,10,-2
ZW,GB,2019.0,7,10,-3
AL,XK,2015.0,5,3,2
GB,LU,2017.0,10,8,2
PA,CO,2009.0,1,4,-3
AT,IE,2007.0,5,6,-1
JP,KH,2012.0,2,6,-4
RU,ES,2009.0,18,9,9
AU,KW,2009.0,2,4,-2
BE,CI,2022.0,1,2,-1
LK,ID,2005.0,1,2,-1
PS,SY,2019.0,2,1,1
KR,NL,2019.0,12,11,1
LK,US,2004.0,7,9,-2
GB,US,2019.0,6655,6500,155
AU,,2000.0,1158,0,1158
BR,,2004.0,1036,0,1036
,IR,2009.0,12926,0,12926
CH,,2022.0,8935,0,8935
RS,,2022.0,1950,0,1950
,CA,2014.0,10613,0,10613
,FR,2009.0,15649,0,15649
HR,,2014.0,429,0,429
CA,,1999.0,2221,0,2221
UA,,2022.0,8227,0,8227
TW,,2012.0,2380,0,2380
NP,,2022.0,700,0,700
RO,,2021.0,2187,0,2187
IL,,2016.0,1689,0,1689
,PL,2014.0,7769,0,7769
PL,,2004.0,653,0,653
SA,,2025.0,1886,0,1886
TH,,2015.0,1067,0,1067
,AU,2016.0,6399,0,6399
,ID,2007.0,2060,0,2060
IN,,2001.0,1394,0,1394
MX,,2012.0,1288,0,1288
,IL,2007.0,2370,0,2370
BE,,2025.0,1687,0,1687
VE,,2010.0,216,0,216
,PH,1999.0,248,0,248
CO,,2006.0,104,0,104
CL,,2012.0,552,0,552
,VE,2014.0,237,0,237
VE,,2017.0,380,0,380
IR,,2005.0,136,0,136
IE,,2014.0,766,0,766
RU,,2009.0,4689,0,4689
KR,AM,1999.0,4,0,4
SK,,2015.0,387,0,387
TZ,,2024.0,1614,0,1614
CZ,,2006.0,409,0,409
CN,AR,2005.0,3,0,3
UY,MX,1997.0,3,0,3
VE,,2019.0,433,0,433
PH,,2011.0,157,0,157
CR,TH,2016.0,1,0,1
,NL,2015.0,5874,0,5874
,HK,2013.0,74,0,74
ES,MG,2004.0,1,0,1
,CY,2014.0,272,0,272
,EC,2011.0,253,0,253
UZ,,2024.0,1058,0,1058
,TJ,2013.0,38,0,38
KP,,2024.0,161,0,161
,TZ,2018.0,300,0,300
HN,PT,1999.0,1,0,1
,ZW,2014.0,155,0,155
VN,,2005.0,21,0,21
,UA,2001.0,1277,0,1277
,IQ,2005.0,95,0,95
,BJ,2011.0,116,0,116
BJ,,2016.0,46,0,46
PK,,2002.0,42,0,42
,ZM,2008.0,56,0,56
LB,,2025.0,128,0,128
PG,,2011.0,8,0,8
,KH,2014.0,52,0,52
,MW,2005.0,66,0,66
CV,,2023.0,21,0,21
NG,,2004.0,112,0,112
,MZ,1999.0,33,0,33
AL,,2020.0,109,0,109
LU,,2019.0,121,0,121
,DO,2016.0,43,0,43
BD,,2007.0,36,0,36
IL,NO,2015.0,5,0,5
GR,VG,1997.0,1,0,1
ME,,2022.0,96,0,96
PH,AF,2017.0,1,0,1
MX,SK,2016.0,4,0,4
,BF,2016.0,125,0,125
GH,TG,2016.0,1,0,1
NL,CW,2021.0,3,0,3
MY,MU,2016.0,3,0,3
LY,FI,2011.0,1,0,1
OM,,2016.0,104,0,104
BH,,2020.0,66,0,66
CA,NE,2021.0,2,0,2
IE,MX,2012.0,4,0,4
RE,,2016.0,22,0,22
IT,VG,2012.0,1,0,1
IL,PT,2013.0,3,0,3
,IQ,2002.0,29,0,29
CY,ID,2018.0,2,0,2
JO,BH,2021.0,2,0,2
ET,MA,2021.0,1,0,1
JP,IS,2006.0,1,0,1
RE,IT,2012.0,1,0,1
GN,,2022.0,40,0,40
LT,,2009.0,168,0,168
,BW,2002.0,62,0,62
GP,RE,2021.0,2,0,2
MX,AT,2012.0,6,0,6
NI,PK,2017.0,1,0,1
KR,MA,2016.0,1,0,1
BF,,2007.0,8,0,8
ZW,NL,2002.0,6,0,6
CR,HN,2013.0,1,0,1
SD,,1998.0,9,0,9
CN,MX,2023.0,2,0,2
LU,,2017.0,95,0,95
EE,LV,2018.0,4,0,4
MY,PS,2014.0,4,0,4
BJ,OM,2010.0,1,0,1
JE,,2020.0,3,0,3
,BW,2005.0,64,0,64
ES,CD,2017.0,2,0,2
ZW,NG,2018.0,2,0,2
MK,,2002.0,5,0,5
MC,,2016.0,6,0,6
CZ,GP,2014.0,2,0,2
CG,,2013.0,13,0,13
IE,PL,2023.0,2,0,2
LU,DK,2018.0,3,0,3
IN,MM,2005.0,1,0,1
US,SM,1999.0,1,0,1
AT,ET,2004.0,2,0,2
IN,KZ,2019.0,2,0,2
TR,TT,2017.0,1,0,1
IL,RO,2012.0,4,0,4
,OM,2020.0,9,0,9
OM,ET,2018.0,1,0,1
AZ,,2014.0,90,0,90
,NG,1995.0,605,0,605
KE,,2001.0,42,0,42
CH,GA,1999.0,1,0,1
BA,UA,2017.0,1,0,1
,ST,2018.0,8,0,8
BW,TZ,2022.0,1,0,1
PK,,2005.0,75,0,75
NL,TN,2018.0,3,0,3
SV,EC,2018.0,4,0,4
MZ,ST,2010.0,1,0,1
DE,KW,2004.0,3,0,3
JP,UZ,2014.0,3,0,3
IT,JO,2003.0,1,0,1
TR,,1998.0,116,0,116
CZ,LV,2016.0,4,0,4
UA,RO,2000.0,3,0,3
,PF,1996.0,11,0,11
BG,AZ,2020.0,1,0,1
US,HT,2015.0,5,0,5
MA,PT,2008.0,2,0,2
LU,,2010.0,34,0,34
FR,AL,1998.0,1,0,1
VG,AU,1997.0,1,0,1
CO,RU,2017.0,4,0,4
,GM,1994.0,17,0,17
,SJ,2013.0,13,0,13
UG,,2003.0,14,0,14
UA,CH,2006.0,4,0,4
VE,GD,2021.0,1,0,1
UG,TN,2013.0,1,0,1
BB,GB,2004.0,3,0,3
ZA,CL,2015.0,5,0,5
AT,UY,2017.0,1,0,1
AU,HK,2001.0,3,0,3
HU,PE,2016.0,2,0,2
IN,MA,2016.0,8,0,8
BE,SN,2002.0,1,0,1
,MW,2002.0,39,0,39
MX,KE,2013.0,1,0,1
IE,QA,2008.0,1,0,1
FR,TZ,2008.0,2,0,2
CI,CO,2014.0,1,0,1
,GN,2016.0,18,0,18
VN,,2002.0,13,0,13
ZA,AE,2017.0,3,0,3
BI,NO,2004.0,1,0,1
HU,PK,2013.0,4,0,4
ZW,NL,2005.0,3,0,3
SD,DZ,2020.0,1,0,1
VE,TH,2003.0,1,0,1
PK,GM,2012.0,1,0,1
,CD,2003.0,25,0,25
AZ,NO,1999.0,2,0,2
FJ,SK,2010.0,1,0,1
LK,SG,2015.0,2,0,2
,GF,1997.0,9,0,9
,BT,1999.0,1,0,1
BG,PT,2008.0,3,0,3
BJ,ML,2017.0,1,0,1
PK,RU,2004.0,2,0,2
IT,ME,2011.0,4,0,4
GW,NL,2018.0,1,0,1
ZW,TZ,2011.0,2,0,2
BE,NE,1997.0,1,0,1
PT,TR,2002.0,1,0,1
EG,AU,2008.0,7,0,7
ZW,BW,2020.0,2,0,2
JM,DK,2014.0,1,0,1
BS,BT,2011.0,1,0,1
SG,AE,2014.0,3,0,3
CZ,VN,2017.0,2,0,2
UZ,BR,1999.0,1,0,1
LV,AT,2006.0,2,0,2
CN,SD,2009.0,1,0,1
CA,GF,2009.0,1,0,1
GE,IE,2010.0,1,0,1
BH,IE,2008.0,1,0,1
ES,RS,2002.0,3,0,3
NZ,BE,2004.0,3,0,3
GT,HN,2019.0,1,0,1
IL,KR,2006.0,2,0,2
LY,IN,2019.0,4,0,4
NZ,TH,2008.0,7,0,7
IN,SI,2022.0,4,0,4
BJ,DZ,2022.0,2,0,2
EG,NE,2016.0,1,0,1
MZ,US,2017.0,5,0,5
,GF,1998.0,6,0,6
ID,AM,2015.0,1,0,1
VN,EG,2012.0,1,0,1
ES,SG,2000.0,2,0,2
BY,KR,2019.0,2,0,2
AF,YE,2015.0,1,0,1
AR,BE,2023.0,1,0,1
HK,MX,2013.0,1,0,1
CU,FI,2021.0,1,0,1
CU,IT,2022.0,2,0,2
ZM,GH,2023.0,7,0,7
ET,NL,2006.0,2,0,2
IR,,2002.0,61,0,61
MT,AR,2020.0,2,0,2
TT,,2012.0,16,0,16
AR,HN,2003.0,1,0,1
PR,,2016.0,7,0,7
JP,PG,2011.0,2,0,2
,NC,1999.0,7,0,7
,PF,2004.0,5,0,5
,PR,2001.0,13,0,13
SV,CH,2014.0,1,0,1
QA,MA,2021.0,2,0,2
FI,LV,2001.0,1,0,1
CD,,2004.0,3,0,3
BJ,SD,2016.0,1,0,1
GN,NE,2015.0,1,0,1
UG,NG,2008.0,2,0,2
GI,CA,2013.0,1,0,1
PR,ET,2022.0,6,0,6
RW,CA,2019.0,2,0,2
NP,SG,2011.0,1,0,1
,SD,1995.0,47,0,47
EG,BR,2004.0,1,0,1
AU,WS,2013.0,1,0,1
CA,KG,2017.0,1,0,1
CM,CD,2021.0,2,0,2
HR,TW,2019.0,1,0,1
LA,GB,2022.0,2,0,2
MA,ET,2018.0,1,0,1
CA,GN,2014.0,1,0,1
TN,GB,2008.0,7,0,7
FK,,2010.0,1,0,1
PS,BD,2000.0,1,0,1
TZ,RU,2015.0,1,0,1
IT,MU,2012.0,1,0,1
TH,FI,2010.0,4,0,4
ID,MX,1997.0,1,0,1
NZ,BS,2008.0,1,0,1
PE,CH,2009.0,2,0,2
,BB,2016.0,5,0,5
FR,IQ,1997.0,1,0,1
BA,TR,2014.0,3,0,3
BB,,2003.0,5,0,5
BJ,GB,2016.0,1,0,1
MY,BF,2012.0,1,0,1
VN,IQ,2021.0,2,0,2
ZW,ID,2002.0,1,0,1
NG,HU,2014.0,4,0,4
PH,SA,2007.0,1,0,1
MK,,2005.0,10,0,10
BA,SI,2011.0,2,0,2
UA,BE,2013.0,2,0,2
RO,KR,2002.0,2,0,2
GA,CD,2020.0,1,0,1
GM,,1998.0,1,0,1
BE,QA,2019.0,4,0,4
ER,IN,2018.0,2,0,2
SA,BD,2024.0,1,0,1
CG,DE,1998.0,2,0,2
NZ,NC,2021.0,1,0,1
LS,,2013.0,5,0,5
KE,IQ,2020.0,2,0,2
TG,NE,2019.0,2,0,2
ST,CU,2011.0,1,0,1
AU,MW,2010.0,1,0,1
ID,SN,1998.0,1,0,1
BH,TZ,2010.0,1,0,1
GM,TZ,2010.0,1,0,1
ZA,GN,2021.0,1,0,1
IT,RW,2020.0,1,0,1
GF,,2013.0,3,0,3
BR,ET,2018.0,7,0,7
SD,IR,2017.0,1,0,1
ID,AL,2019.0,2,0,2
AU,BA,2005.0,2,0,2
PK,GR,2008.0,1,0,1
DK,SD,2003.0,1,0,1
SK,IL,2003.0,4,0,4
CZ,CU,2011.0,2,0,2
FI,MX,1998.0,1,0,1
ZA,ES,2004.0,1,0,1
TW,UA,2014.0,3,0,3
PT,BD,2014.0,1,0,1
DK,BY,2007.0,1,0,1
GR,RO,2010.0,4,0,4
IN,AM,1999.0,1,0,1
AE,RO,2018.0,1,0,1
OM,PS,2002.0,1,0,1
IR,SA,2023.0,1,0,1
PK,MV,2019.0,1,0,1
TH,AE,2014.0,1,0,1
AE,EE,2017.0,1,0,1
IN,UY,2015.0,2,0,2
ZM,DE,2012.0,1,0,1
US,CD,2000.0,1,0,1
BR,CY,2006.0,1,0,1
RO,ID,2022.0,2,0,2
ET,AR,2021.0,1,0,1
KE,ET,1998.0,1,0,1
MD,IL,2008.0,1,0,1
MY,PE,2016.0,1,0,1
PL,VN,1998.0,1,0,1
MU,CH,2012.0,1,0,1
ES,LK,2005.0,1,0,1
GR,HR,2006.0,2,0,2
BO,MA,1997.0,1,0,1
nan,IR,2011.0,3,0,3
DK,CO,2013.0,2,0,2
MU,SE,2011.0,1,0,1
KW,DE,1998.0,1,0,1
AR,HR,2002.0,1,0,1
,PW,2011.0,1,0,1
RO,GR,2022.0,4,0,4
,SZ,2012.0,6,0,6
SY,MX,2007.0,2,0,2
NP,BW,2022.0,1,0,1
IT,DO,2012.0,3,0,3
PK,GH,2000.0,1,0,1
SD,ZA,2014.0,2,0,2
PK,BF,2019.0,1,0,1
GF,CI,2010.0,1,0,1
MQ,GP,2018.0,1,0,1
PK,HT,2022.0,1,0,1
BR,PF,2005.0,1,0,1
TN,SE,2022.0,1,0,1
PK,OM,2004.0,1,0,1
XK,FR,2010.0,2,0,2
FI,MA,2009.0,1,0,1
SA,LY,2010.0,1,0,1
GR,MT,2005.0,1,0,1
ES,AD,2013.0,2,0,2
GB,VG,2020.0,3,0,3
NO,PS,2015.0,1,0,1
ZA,VG,2019.0,1,0,1
ET,BE,2001.0,1,0,1
BE,MY,2001.0,1,0,1
DZ,BI,2008.0,1,0,1
NE,MG,2001.0,1,0,1
HK,SE,1997.0,2,0,2
VE,VG,2000.0,1,0,1
IL,BG,2004.0,1,0,1
MY,CO,2012.0,2,0,2
AT,BR,1999.0,2,0,2
,DJ,2009.0,1,0,1
SG,QA,2004.0,1,0,1
GA,ZA,2009.0,1,0,1
TR,JO,2001.0,2,0,2
MT,CH,2014.0,1,0,1
IS,DK,2000.0,3,0,3
CA,AF,2011.0,1,0,1
TZ,BI,2019.0,1,0,1
SD,IR,2019.0,2,0,2
BF,UG,2016.0,1,0,1
ZA,MX,2017.0,5,0,5
ZA,PH,2014.0,3,0,3
UG,SA,2008.0,1,0,1
KR,KZ,2003.0,2,0,2
HK,US,1999.0,2,0,2
GH,BN,2012.0,1,0,1
AT,GH,2010.0,1,0,1
DK,BG,2010.0,2,0,2
AR,MY,2000.0,1,0,1
MY,VN,2016.0,3,0,3
LB,CU,2008.0,2,0,2
DZ,AU,2009.0,1,0,1
ID,NL,2001.0,1,0,1
TN,MX,2000.0,1,0,1
IT,GE,2013.0,3,0,3
IT,ET,2012.0,2,0,2
AM,NL,2016.0,2,0,2
PT,VN,2022.0,1,0,1
IL,EG,2002.0,1,0,1
UG,NZ,2015.0,3,0,3
MX,TN,2021.0,2,0,2
AU,PE,2009.0,1,0,1
MK,HR,1999.0,1,0,1
KG,,2006.0,3,0,3
SN,PF,1999.0,1,0,1
ZM,FR,2019.0,1,0,1
ES,BH,2020.0,1,0,1
BH,UG,2003.0,1,0,1
IS,PK,2015.0,1,0,1
NO,SD,2006.0,1,0,1
CM,BJ,1999.0,4,0,4
CU,MA,2005.0,1,0,1
GB,BS,2013.0,2,0,2
nan,SG,2003.0,4,0,4
MG,TZ,2012.0,1,0,1
BZ,FR,2015.0,2,0,2
EG,ZA,2023.0,2,0,2
IN,PG,2009.0,1,0,1
IL,GE,2004.0,1,0,1
VE,JP,2020.0,1,0,1
CO,LT,2022.0,1,0,1
IT,SD,2003.0,1,0,1
,JE,2011.0,1,0,1
MZ,ZA,2008.0,1,0,1
SD,EG,2000.0,1,0,1
JP,AE,1997.0,1,0,1
ES,GD,2019.0,1,0,1
BW,BS,2021.0,1,0,1
DE,MN,2007.0,1,0,1
JP,KY,2012.0,1,0,1
FR,OM,2004.0,1,0,1
NZ,OM,2000.0,2,0,2
QA,RS,2010.0,1,0,1
PL,EE,2001.0,2,0,2
US,ZM,2001.0,1,0,1
NO,AZ,2018.0,1,0,1
NL,GE,2013.0,1,0,1
,HT,2006.0,5,0,5
AR,MC,2012.0,1,0,1
NG,GM,2003.0,1,0,1
PG,MW,2013.0,1,0,1
JO,PT,2007.0,1,0,1
SK,GR,2003.0,2,0,2
AT,TW,2005.0,1,0,1
CO,ZM,2004.0,1,0,1
BN,,2003.0,3,0,3
GE,KR,2021.0,2,0,2
CR,HU,2021.0,1,0,1
LY,US,2006.0,1,0,1
MA,RO,2021.0,1,0,1
PK,RS,2006.0,1,0,1
IE,MC,2016.0,1,0,1
AL,ES,2017.0,2,0,2
SV,MA,2012.0,1,0,1
MN,CO,2007.0,1,0,1
CO,ZA,2012.0,1,0,1
JM,PH,2015.0,1,0,1
CR,nan,2000.0,1,0,1
GH,TH,2022.0,1,0,1
DE,DO,1997.0,1,0,1
MY,SK,2017.0,1,0,1
BE,BI,2006.0,2,0,2
SK,ME,2002.0,1,0,1
GE,IE,2017.0,1,0,1
PH,ET,2009.0,1,0,1
MA,RU,2015.0,2,0,2
TJ,EG,2017.0,1,0,1
HK,BD,2021.0,1,0,1
ZM,CZ,2007.0,1,0,1
BE,MQ,1998.0,1,0,1
PG,TR,2021.0,1,0,1
SA,ZA,2001.0,1,0,1
WS,FJ,2018.0,1,0,1
IR,JO,2010.0,1,0,1
IE,BH,2006.0,1,0,1
,AD,2013.0,2,0,2
IN,ET,2006.0,2,0,2
BH,SA,2009.0,1,0,1
CA,GT,2003.0,1,0,1
MY,BG,2017.0,1,0,1
PT,PE,1998.0,1,0,1
LK,NG,2014.0,1,0,1
BE,HK,2007.0,2,0,2
GF,CH,2022.0,1,0,1
IT,BO,2020.0,2,0,2
NC,MC,1997.0,1,0,1
US,KN,2001.0,1,0,1
US,GW,2016.0,1,0,1
TR,BI,2015.0,1,0,1
KH,IR,2010.0,1,0,1
SG,CZ,2011.0,2,0,2
PK,KZ,2021.0,1,0,1
,WS,1997.0,1,0,1
FR,BH,2007.0,1,0,1
ES,SA,2001.0,1,0,1
IN,BZ,2016.0,1,0,1
HR,NO,2018.0,1,0,1
BI,SI,2020.0,1,0,1
CR,AU,2003.0,1,0,1
AZ,EG,2015.0,2,0,2
BZ,GB,2007.0,1,0,1
NL,LV,2020.0,1,0,1
IS,DE,2004.0,2,0,2
YE,CZ,2018.0,1,0,1
SI,LV,2012.0,1,0,1
ID,KR,2005.0,2,0,2
ZW,IT,2012.0,1,0,1
TZ,PG,2011.0,1,0,1
IT,LY,2011.0,1,0,1
SE,SJ,2002.0,1,0,1
NC,,2009.0,4,0,4
LU,GR,2011.0,1,0,1
SG,GR,2013.0,1,4,-3
CN,MN,2008.0,1,2,-1
SA,AU,2003.0,2,4,-2
IL,TW,2014.0,1,1,0
MT,DE,2018.0,1,2,-1
BN,MY,2022.0,4,9,-5
PT,DK,2006.0,1,1,0
IE,EC,2021.0,1,1,0
DE,CW,2007.0,1,3,-2
LV,IT,2015.0,1,4,-3
MD,RU,2005.0,1,3,-2
HR,XK,2020.0,3,3,0
BA,XK,2020.0,1,1,0
CR,IL,2016.0,1,1,0
DK,KR,2007.0,1,1,0
OM,AE,2004.0,1,2,-1
LY,CA,2017.0,1,3,-2
CA,MD,2007.0,1,3,-2
YE,MA,2020.0,2,2,0
IL,EG,2005.0,1,2,-1
ML,KE,2009.0,1,1,0
MZ,US,2010.0,2,3,-1
CL,nan,2002.0,2,1,1
IR,LB,2018.0,2,6,-4
GR,RO,2019.0,2,2,0
CZ,AR,2007.0,1,2,-1
DO,MX,2009.0,3,2,1
NG,JO,2019.0,1,2,-1
IE,RU,2001.0,2,3,-1
OM,IR,2018.0,2,9,-7
CH,CO,2000.0,1,2,-1
EE,ZA,2019.0,2,1,1
ZA,MY,2010.0,2,1,1
MU,GB,2007.0,2,2,0
PE,GB,2006.0,1,5,-4
MV,MY,2018.0,1,1,0
MK,BG,2010.0,1,3,-2
NP,DK,2017.0,1,1,0
ES,IR,2007.0,2,3,-1
AT,BG,2013.0,2,4,-2
SN,GF,2002.0,1,1,0
PK,FR,2008.0,3,3,0
NL,AE,2012.0,2,3,-1
SD,KE,2019.0,1,1,0
IN,LK,2003.0,1,1,0
VE,EC,2009.0,1,2,-1
BE,BA,2015.0,1,1,0
TG,NE,2017.0,1,1,0
AM,RU,1999.0,2,4,-2
ID,GR,2017.0,1,3,-2
PT,CR,2022.0,1,2,-1
LT,PL,2009.0,1,2,-1
MS,GB,2003.0,1,3,-2
LB,AU,2015.0,3,8,-5
GB,PE,2002.0,1,2,-1
KY,CN,2020.0,1,3,-2
ME,FR,2010.0,1,1,0
JP,UA,2011.0,3,5,-2
IE,AE,2008.0,1,1,0
YE,CN,2003.0,1,1,0
RE,FR,1998.0,1,4,-3
SG,ZA,2020.0,1,3,-2
nan,TN,2009.0,1,2,-1
PK,CL,2013.0,1,1,0
NC,GB,2014.0,2,1,1
LB,FI,2020.0,1,1,0
PH,NG,2013.0,1,1,0
BH,EG,2006.0,2,2,0
DE,IR,1999.0,2,1,1
US,GP,2017.0,1,5,-4
KE,ML,2016.0,2,1,1
DK,PE,2019.0,1,1,0
NO,HU,2006.0,3,5,-2
AO,ES,2005.0,1,5,-4
US,SS,2021.0,2,1,1
NO,NP,2005.0,2,1,1
BD,AT,2020.0,1,1,0
BH,JO,2000.0,3,1,2
NL,RS,2007.0,3,3,0
BR,NZ,2004.0,3,1,2
US,GT,2002.0,1,1,0
JP,MM,2003.0,1,2,-1
CO,nan,2006.0,2,2,0
PK,SD,2017.0,1,4,-3
IL,ZA,2016.0,2,5,-3
KH,JP,2005.0,1,8,-7
GE,DE,1997.0,1,4,-3
FI,KR,2011.0,1,2,-1
AU,ID,2023.0,1,2,-1
TH,PH,2016.0,2,7,-5
MD,BE,2001.0,1,2,-1
VN,BN,2017.0,1,1,0
MD,TR,2018.0,1,11,-10
RU,CL,1999.0,2,1,1
SD,AE,2009.0,1,1,0
QA,JO,2011.0,1,4,-3
MY,BH,2014.0,1,2,-1
VE,PY,2015.0,1,2,-1
TH,FI,2019.0,1,3,-2
MX,AM,2003.0,1,1,0
SA,LY,2017.0,2,2,0
HU,AE,2008.0,1,1,0
EG,IS,2018.0,1,1,0
EC,PA,2022.0,1,1,0
TN,ID,2012.0,1,1,0
LB,AR,2018.0,1,1,0
MX,DZ,2005.0,1,1,0
GA,DE,2003.0,2,2,0
UA,ZA,2020.0,1,2,-1
LV,BE,1999.0,1,2,-1
nan,DZ,2008.0,1,2,-1
PA,CU,2010.0,1,1,0
KR,GE,2016.0,1,2,-1
PE,FR,1998.0,1,3,-2
AO,AR,2004.0,1,1,0
CR,CU,2000.0,1,1,0
CO,CZ,2013.0,1,3,-2
MK,IE,2019.0,1,1,0
TR,PE,2016.0,1,1,0
TW,CL,2018.0,1,2,-1
SD,KE,2010.0,1,1,0
HK,SG,2014.0,2,1,1
FI,LU,2013.0,1,4,-3
PG,US,2004.0,1,2,-1
KR,SD,2011.0,1,1,0
RU,MZ,1999.0,1,4,-3
RO,RU,2006.0,1,2,-1
DK,BG,2017.0,1,2,-1
BE,SS,2006.0,1,1,0
ET,AT,2017.0,1,2,-1
CD,FR,2003.0,1,1,0
IN,CL,2004.0,1,1,0
UA,NI,2009.0,1,1,0
IT,BD,2009.0,1,3,-2
TR,BW,2018.0,1,1,0
AU,EE,2016.0,1,7,-6
DK,LU,2005.0,1,1,0
ZA,AT,2019.0,2,5,-3
NG,MX,2019.0,1,2,-1
ZA,MX,2010.0,1,3,-2
UY,PY,2014.0,1,3,-2
AT,VN,2013.0,1,2,-1
LT,CO,2014.0,1,1,0
PS,CN,2022.0,1,1,0
UY,DE,2010.0,1,3,-2
CI,KE,2017.0,1,3,-2
ZA,SG,2005.0,1,3,-2
BD,TW,2014.0,1,1,0
LB,DE,2006.0,2,4,-2
EG,CO,2021.0,1,1,0
RS,RO,2007.0,1,1,0
GH,DK,2014.0,1,3,-2
LY,SA,2017.0,2,2,0
IT,PA,2006.0,1,1,0
SI,nan,2010.0,3,2,1
NG,IE,2021.0,1,2,-1
AT,GH,2019.0,1,1,0
UY,CU,2020.0,3,3,0
MZ,ST,2017.0,1,2,-1
AR,BO,2015.0,2,1,1
FR,GN,2009.0,3,1,2
LV,LT,2012.0,1,2,-1
RU,LU,2015.0,3,1,2
SN,ML,2022.0,1,1,0
NZ,LK,2014.0,1,2,-1
BE,TZ,2016.0,1,4,-3
ZA,SN,2016.0,1,1,0
KE,CH,2009.0,1,1,0
DE,LV,2016.0,2,13,-11
CA,GH,2000.0,1,1,0
PT,RS,2002.0,1,1,0
KR,TR,2022.0,2,3,-1
BY,DK,1999.0,1,2,-1
NO,ID,2013.0,2,1,1
CM,DZ,2020.0,1,1,0
UA,KR,2007.0,1,3,-2
UY,CN,2022.0,1,1,0
CA,YE,2010.0,1,0,1
KH,TH,2014.0,1,0,1
UY,NZ,2022.0,1,0,1
SE,MT,2011.0,1,0,1
MM,NP,2009.0,1,0,1
RS,LT,2021.0,2,0,2
PE,FR,1997.0,1,0,1
BJ,ZA,2022.0,2,0,2
EE,NO,2022.0,1,0,1
FK,,2019.0,1,0,1
ZW,RU,1997.0,1,0,1
MG,GB,2009.0,2,0,2
AZ,IN,2018.0,1,0,1
BI,US,2003.0,2,0,2
NP,DK,2010.0,1,0,1
IL,MA,2011.0,1,0,1
GT,GE,2009.0,1,0,1
SD,SE,2003.0,1,0,1
BF,SN,1998.0,1,0,1
MW,NG,2013.0,1,0,1
VU,WS,2017.0,1,0,1
AM,LT,2019.0,2,0,2
AG,AT,2005.0,1,0,1
AU,PF,2022.0,1,0,1
KR,KH,2018.0,3,0,3
US,GD,2004.0,1,0,1
AR,OM,2009.0,1,0,1
MX,IL,1999.0,1,0,1
PL,SG,2004.0,1,0,1
IN,LY,1998.0,1,0,1
PS,SY,2017.0,1,0,1
MX,BJ,2017.0,1,0,1
RO,PT,2002.0,1,0,1
ID,ZM,2016.0,1,0,1
GR,HU,2004.0,1,0,1
CY,DE,2001.0,1,0,1
GB,MV,2021.0,1,0,1
SG,HR,2012.0,1,0,1
GB,WS,2016.0,1,0,1
QA,nan,2021.0,2,0,2
LV,PL,2007.0,1,0,1
CH,BB,2000.0,1,0,1
NG,KZ,2022.0,1,0,1
,BZ,2016.0,1,0,1
SD,FR,2022.0,2,0,2
CG,TN,2018.0,1,0,1
MX,GE,2022.0,1,0,1
TR,HK,2013.0,1,0,1
PT,CZ,2004.0,1,0,1
nan,AE,2004.0,1,0,1
CN,CM,2010.0,1,0,1
IQ,SE,1998.0,1,0,1
BE,SN,2005.0,1,0,1
PT,AR,1997.0,2,0,2
CI,MY,2010.0,1,0,1
PT,SE,1997.0,2,0,2
RO,KR,2005.0,1,0,1
CA,BW,2005.0,1,0,1
DZ,LY,2011.0,1,0,1
CO,IR,2011.0,1,0,1
FR,ZW,2006.0,2,0,2
ET,VN,2020.0,2,0,2
ID,SD,2003.0,1,0,1
BD,ZM,2020.0,1,0,1
IT,GT,1998.0,2,0,2
IN,HR,2008.0,1,0,1
TZ,NL,2003.0,1,0,1
SE,OM,2000.0,1,0,1
DE,MT,2014.0,2,0,2
IQ,AG,2019.0,1,0,1
AT,BB,2016.0,1,0,1
LB,BJ,2015.0,1,0,1
BE,PE,1997.0,1,0,1
BJ,LA,2016.0,1,0,1
TN,FI,2011.0,1,0,1
CY,CL,2017.0,1,0,1
GR,IS,2012.0,1,0,1
AU,CG,2019.0,2,0,2
EE,IT,2015.0,1,0,1
TW,GE,2005.0,1,0,1
FR,UY,1999.0,1,0,1
BY,VN,2006.0,1,0,1
KZ,BG,2010.0,2,0,2
BB,LC,2020.0,1,0,1
CM,CI,1999.0,1,0,1
DE,ID,1998.0,1,0,1
,SM,2011.0,2,0,2
,ER,2007.0,1,0,1
TW,CO,2008.0,1,0,1
IT,EC,2003.0,1,0,1
BH,TR,2009.0,2,0,2
MZ,CN,2012.0,1,0,1
BG,RO,1998.0,1,0,1
IR,PY,2014.0,1,0,1
NI,VE,1997.0,1,0,1
RU,CR,2007.0,1,0,1
DZ,PT,2007.0,1,0,1
IR,RS,2020.0,1,0,1
LB,SE,2013.0,1,0,1
NC,GF,2003.0,1,0,1
LK,PT,2005.0,1,0,1
TJ,NO,2019.0,1,0,1
EG,CY,2019.0,1,0,1
CO,RO,2005.0,1,0,1
GL,US,2016.0,1,0,1
MD,CA,2018.0,1,0,1
LV,NG,2018.0,1,0,1
MZ,LT,1999.0,1,0,1
AU,SV,2013.0,1,0,1
CY,nan,2007.0,1,0,1
PS,CH,2015.0,1,0,1
ZA,MK,2000.0,1,0,1
KE,PE,2006.0,1,0,1
SG,EG,2004.0,1,0,1
,RW,1997.0,1,0,1
GH,SE,2009.0,1,0,1
ZW,ID,2005.0,1,0,1
FR,TD,2020.0,3,0,3
LT,EG,2022.0,1,0,1
JP,KG,2018.0,1,0,1
JP,BJ,2006.0,1,0,1
MA,GR,2022.0,1,0,1
CM,GH,2021.0,1,0,1
KE,MU,2012.0,1,0,1
MU,IT,2015.0,1,0,1
KW,SE,2020.0,2,0,2
nan,SY,2011.0,1,0,1
AR,IE,2009.0,1,0,1
IQ,QA,2001.0,1,0,1
AT,SN,2007.0,1,0,1
CY,CZ,2015.0,1,0,1
LY,PL,2006.0,1,0,1
ZM,CH,2021.0,1,0,1
ZA,SG,2002.0,3,0,3
HR,PE,2019.0,1,0,1
SV,SE,2014.0,1,0,1
EG,SS,2016.0,1,0,1
SN,SV,2006.0,1,0,1
GL,NL,2019.0,1,0,1
LV,SK,2014.0,1,0,1
IL,BO,2014.0,1,0,1
SA,SG,1999.0,1,0,1
SI,SE,2008.0,1,0,1
ID,US,2023.0,1,0,1
RW,CA,2017.0,1,0,1
RU,TM,2003.0,1,0,1
IN,MU,2002.0,1,0,1
TG,CA,1999.0,1,0,1
NG,CG,2014.0,1,0,1
UA,NG,2016.0,1,0,1
VA,IT,2021.0,2,0,2
PT,IQ,2015.0,1,0,1
BA,,2001.0,2,0,2
FR,LA,2016.0,1,0,1
BY,SK,2010.0,1,0,1
MO,FR,2017.0,1,0,1
NA,,1998.0,1,0,1
TH,MY,2001.0,1,0,1
RO,IE,1998.0,1,0,1
LY,CA,2010.0,1,0,1
CW,CA,2018.0,1,0,1
CG,AU,2017.0,1,0,1
NI,AT,2006.0,1,0,1
RS,PK,2000.0,1,0,1
AZ,GB,2000.0,1,0,1
HU,QA,2009.0,1,0,1
RO,PA,2015.0,1,0,1
MN,AU,2021.0,1,0,1
PK,ZW,2007.0,1,0,1
CW,IR,2019.0,1,0,1
CF,SN,2012.0,1,0,1
SA,LV,2016.0,1,0,1
IL,TH,2014.0,1,0,1
ZA,LV,2008.0,1,0,1
PT,FI,2023.0,1,0,1
nan,SV,2017.0,1,0,1
,RW,1998.0,1,0,1
LA,ZA,2022.0,1,0,1
SN,ES,2012.0,1,0,1
CA,KG,2010.0,1,0,1
TN,NE,2015.0,1,0,1
MC,CA,2014.0,1,0,1
TW,MM,1998.0,1,0,1
CD,SG,2012.0,1,0,1
MX,BD,2021.0,1,0,1
LT,KR,2019.0,1,0,1
HN,IT,2008.0,1,0,1
TR,LY,2000.0,1,0,1
MX,TH,2022.0,1,0,1
CO,AE,2023.0,1,0,1
GB,BF,2000.0,1,0,1
MX,SY,2004.0,1,0,1
CN,UY,2021.0,1,0,1
AZ,AU,2015.0,1,0,1
FI,TW,2004.0,1,0,1
GE,DK,2011.0,1,0,1
ST,FR,2018.0,1,0,1
CH,MG,1997.0,1,0,1
ZA,IM,2020.0,1,0,1
AT,ME,2021.0,1,0,1
GR,CR,2016.0,1,0,1
,LS,2001.0,1,0,1
FI,ZM,2016.0,1,0,1
SA,BN,2016.0,1,0,1
NL,OM,2013.0,1,0,1
HK,NZ,2016.0,1,0,1
CO,AU,2003.0,1,0,1
LY,SG,2007.0,1,0,1
CA,JM,1999.0,1,0,1
DK,DZ,2004.0,1,0,1
SG,KH,2010.0,1,0,1
LK,BE,2020.0,1,0,1
BD,DK,2006.0,1,0,1
KW,MX,2000.0,1,0,1
DE,MM,2020.0,1,0,1
JP,SD,1997.0,1,0,1
CA,VU,2021.0,1,0,1
NZ,HN,2013.0,1,0,1
PK,ER,2019.0,1,0,1
SE,BH,2005.0,1,0,1
CN,ET,2023.0,1,0,1
SI,MA,2021.0,1,0,1
VN,TH,2002.0,1,0,1
CN,MT,2020.0,1,0,1
IR,ZW,2021.0,1,0,1
MX,IN,2023.0,1,0,1
MQ,US,2018.0,1,0,1
SN,BJ,2010.0,1,0,1
MK,RU,2015.0,1,0,1
CA,MQ,2006.0,1,0,1
CZ,ME,2012.0,1,0,1
CN,NA,2021.0,1,0,1
NL,GB,2015.0,401,314,87
US,CN,2008.0,7209,4690,2519
FR,RU,1998.0,41,38,3
IT,US,2022.0,595,496,99
US,AU,2007.0,1853,1660,193
VE,ES,2004.0,59,54,5
TR,CO,2020.0,179,134,45
ES,nan,2019.0,82,68,14
ES,FR,2005.0,134,161,-27
CN,LB,2009.0,12,10,2
CZ,CN,2020.0,22,19,3
PE,DE,2011.0,3,7,-4
CA,US,2001.0,1974,1733,241
US,KR,2004.0,857,724,133
IT,CH,2011.0,278,192,86
AU,US,2009.0,1719,2023,-304
BR,PT,2013.0,942,789,153
DE,US,2012.0,2505,2425,80
IN,US,2003.0,982,763,219
VN,CN,2015.0,23,42,-19
ES,KR,2019.0,22,12,10
JP,SE,2010.0,32,30,2
TR,GB,2020.0,149,121,28
US,DE,2014.0,2537,2461,76
BR,NZ,2014.0,9,13,-4
GB,QA,2020.0,54,26,28
CU,BR,2014.0,39,14,25
CA,GB,2016.0,919,861,58
ZA,BR,2008.0,9,6,3
HR,BE,2019.0,2,2,0
DE,RU,2018.0,240,179,61
AU,SE,2009.0,49,53,-4
MX,CO,2013.0,267,266,1
NO,BR,2009.0,21,20,1
LK,US,2014.0,26,27,-1
CA,ES,2007.0,61,48,13
NL,US,2009.0,616,668,-52
MA,SA,2022.0,4,8,-4
GB,MX,2006.0,48,35,13
US,EG,2007.0,144,71,73
EC,CL,2014.0,18,33,-15
ES,GB,2004.0,180,171,9
CL,VE,2012.0,19,28,-9
CO,BR,2019.0,193,191,2
NZ,AU,2021.0,129,131,-2
CN,ES,2020.0,78,70,8
AU,DE,2011.0,177,243,-66
IE,KR,2004.0,5,3,2
BR,AR,2010.0,117,123,-6
AU,IT,2019.0,79,84,-5
CL,US,2011.0,168,192,-24
EG,DE,2019.0,54,74,-20
GB,NZ,2009.0,273,192,81
IN,IT,2021.0,72,52,20
FI,DE,2012.0,58,59,-1
US,CL,2007.0,131,122,9
KR,JP,2003.0,156,224,-68
US,ET,2017.0,49,45,4
CO,CL,2020.0,221,211,10
ES,US,2009.0,773,854,-81
BR,NL,2000.0,9,7,2
AT,DE,2001.0,219,219,0
MK,AU,2016.0,75,49,26
GB,BD,2004.0,22,21,1
TR,FR,2007.0,13,18,-5
GB,IE,2003.0,176,159,17
TH,KR,2011.0,20,7,13
US,RU,1997.0,125,191,-66
US,CH,2003.0,499,460,39
FR,CN,2012.0,253,153,100
MY,IT,2003.0,36,39,-3
MX,DE,2014.0,49,41,8
NO,ET,2020.0,10,3,7
DO,CO,2010.0,3,2,1
SE,ZA,2020.0,23,28,-5
ET,KR,2003.0,83,71,12
GB,GR,1997.0,49,28,21
CO,BR,2017.0,193,186,7
SG,DK,2013.0,7,4,3
CA,IN,2004.0,111,125,-14
CN,ZA,2017.0,15,20,-5
ZA,IN,2018.0,54,69,-15
CL,PA,2000.0,1,1,0
UY,PE,2016.0,5,3,2
UG,GB,2009.0,7,9,-2
BA,IQ,2017.0,2,4,-2
GB,JP,2013.0,270,316,-46
IR,CA,2017.0,337,182,155
nan,FI,2009.0,20,5,15
DK,FR,2014.0,36,39,-3
AU,KR,2020.0,43,64,-21
DE,AU,2020.0,252,249,3
ES,nan,2017.0,76,60,16
SE,GB,2014.0,190,188,2
TW,AU,2004.0,12,12,0
EG,DE,2017.0,53,59,-6
DK,AR,2016.0,6,5,1
CN,CA,2016.0,521,564,-43
IN,IE,2017.0,42,24,18
IN,DE,2017.0,229,201,28
CZ,AU,2007.0,6,5,1
NZ,JP,2020.0,14,15,-1
AU,IT,2010.0,54,48,6
DE,EE,2007.0,30,19,11
AU,IT,2017.0,52,83,-31
CO,TR,2019.0,60,203,-143
AT,FR,2007.0,32,26,6
EG,ES,2016.0,7,18,-11
CU,DE,2008.0,8,5,3
MX,CA,2015.0,52,41,11
MX,ES,1997.0,86,90,-4
JP,SE,2017.0,36,55,-19
DK,US,2007.0,169,284,-115
RU,NO,2010.0,22,19,3
BR,AR,2017.0,174,178,-4
PE,EC,2020.0,55,61,-6
GB,SE,2007.0,151,153,-2
FR,AU,2001.0,43,49,-6
SE,DE,2008.0,144,148,-4
MY,CN,2015.0,65,114,-49
FR,MA,1998.0,95,69,26
CA,DE,2020.0,246,301,-55
CA,IE,2003.0,55,61,-6
NZ,GB,2014.0,226,275,-49
CH,CN,2022.0,72,57,15
US,SY,2016.0,6,6,0
IN,AU,2022.0,173,92,81
NZ,CA,2017.0,72,73,-1
JP,AU,2020.0,72,83,-11
LB,US,2017.0,95,86,9
SE,AT,2018.0,40,40,0
EG,IN,2002.0,2,2,0
CA,PS,2013.0,2,1,1
IT,DE,2009.0,218,183,35
ES,FR,2002.0,122,128,-6
IT,CZ,2014.0,41,15,26
DE,TH,2009.0,12,14,-2
UA,RU,2016.0,487,318,169
FR,NO,1999.0,12,27,-15
NL,PL,1999.0,4,8,-4
CN,AU,2016.0,451,451,0
NL,CN,2013.0,102,96,6
SK,RO,2017.0,6,1,5
VE,AR,2018.0,25,15,10
FR,NZ,2009.0,13,11,2
ES,PE,2018.0,163,120,43
PK,OM,2014.0,15,5,10
DE,BE,2006.0,108,58,50
SK,GB,2009.0,25,18,7
PK,MA,2013.0,25,11,14
EG,LB,2004.0,4,2,2
KR,ID,2013.0,16,6,10
IN,nan,2012.0,46,37,9
US,TR,2021.0,336,314,22
SK,AT,2012.0,14,11,3
FR,FI,2016.0,29,31,-2
NZ,CL,2020.0,3,5,-2
PT,MX,2004.0,14,6,8
IR,CA,2019.0,434,179,255
CN,ID,2020.0,331,258,73
CO,ES,2011.0,327,354,-27
nan,FR,2021.0,135,105,30
AE,US,2011.0,23,73,-50
SE,NO,2012.0,108,78,30
FR,LU,2009.0,28,14,14
FR,TW,2021.0,16,5,11
IR,TR,2020.0,62,34,28
KR,SE,2007.0,5,2,3
IN,MY,2018.0,151,162,-11
KZ,CN,2008.0,11,6,5
NO,GR,2015.0,7,17,-10
NO,GB,2013.0,72,109,-37
AR,US,2006.0,191,157,34
PT,FR,2017.0,58,78,-20
NL,KR,2016.0,14,7,7
US,BE,2003.0,148,222,-74
NO,DE,1997.0,12,14,-2
IQ,EG,2018.0,47,74,-27
BD,PK,2022.0,27,35,-8
BE,UG,2017.0,16,16,0
IT,CO,2017.0,32,19,13
US,GH,2012.0,34,15,19
TH,JP,2019.0,90,117,-27
CO,VE,2008.0,24,37,-13
DK,CN,2003.0,8,13,-5
US,RO,1999.0,14,37,-23
PT,FR,2010.0,33,59,-26
IR,IT,2014.0,39,25,14
SA,CH,2014.0,4,3,1
GB,CN,2023.0,45,137,-92
GB,AT,2022.0,82,65,17
US,ET,2010.0,24,28,-4
KR,CA,2013.0,51,64,-13
DK,DE,2013.0,130,163,-33
SG,TW,2014.0,41,51,-10
TN,US,2017.0,30,33,-3
IN,DE,2010.0,162,122,40
IT,SA,2019.0,16,12,4
IT,nan,2020.0,98,86,12
TH,JP,2010.0,55,80,-25
US,LU,2014.0,20,22,-2
BR,TR,2011.0,15,33,-18
FI,EG,2015.0,7,3,4
DE,TR,2001.0,18,13,5
FR,CM,2013.0,24,13,11
FR,VN,2007.0,13,9,4
HU,FR,2021.0,21,13,8
IT,BE,2007.0,68,62,6
nan,TR,2019.0,39,24,15
IN,CZ,2013.0,22,15,7
FR,IT,2021.0,335,300,35
JP,FR,2018.0,178,185,-7
AR,NO,2011.0,2,1,1
CA,DZ,2019.0,26,17,9
CO,BR,2010.0,57,85,-28
IT,GB,2004.0,297,233,64
DK,GB,2020.0,129,188,-59
IN,PK,1998.0,9,10,-1
SG,BD,2017.0,6,2,4
IR,CA,2010.0,176,91,85
PK,CH,2020.0,22,23,-1
NL,SE,2016.0,75,75,0
GH,NG,2019.0,16,22,-6
GB,TR,2011.0,87,52,35
IN,DE,2019.0,257,197,60
NG,CA,2020.0,34,15,19
US,RU,1998.0,168,244,-76
PH,BR,2017.0,12,13,-1
RU,KZ,2012.0,26,15,11
ID,IN,2018.0,50,117,-67
NZ,CA,2019.0,79,74,5
PG,CA,2015.0,2,1,1
GB,KE,2020.0,41,48,-7
IR,PT,2017.0,20,15,5
BE,CL,2008.0,5,4,1
SA,SY,2020.0,10,5,5
SE,EE,2016.0,10,9,1
HU,GB,2012.0,49,47,2
IL,SE,2019.0,14,5,9
NL,IN,2014.0,49,48,1
CH,RO,2017.0,14,22,-8
US,CZ,2002.0,62,90,-28
BG,NO,2017.0,6,5,1
ZM,ZA,2018.0,6,14,-8
SE,CH,2003.0,27,21,6
EG,CA,2012.0,45,76,-31
nan,UA,2018.0,38,23,15
PT,nan,2018.0,13,20,-7
EG,AU,2013.0,18,12,6
MX,CU,2007.0,34,27,7
PK,PL,2009.0,5,4,1
SG,DE,2005.0,11,15,-4
MX,TR,2009.0,1,1,0
ES,PA,2021.0,12,9,3
EC,PA,2016.0,1,3,-2
RU,CZ,2016.0,58,71,-13
ID,CN,2012.0,16,19,-3
VN,US,2008.0,20,35,-15
AU,IE,2008.0,62,59,3
CO,RU,2018.0,3,1,2
CZ,VN,2018.0,6,5,1
CO,FR,2009.0,15,21,-6
IT,JP,2003.0,38,43,-5
MV,MY,2019.0,2,1,1
FI,EE,2013.0,11,9,2
FI,NO,2009.0,18,7,11
CH,NZ,2018.0,10,16,-6
SK,CZ,2018.0,134,140,-6
PL,ES,2015.0,22,29,-7
MA,US,2018.0,19,29,-10
DE,SE,2013.0,234,176,58
MX,CR,2018.0,50,58,-8
AE,IN,2022.0,31,79,-48
PL,FR,2021.0,29,38,-9
TR,ID,2019.0,23,18,5
SA,AE,2019.0,53,32,21
US,KH,2003.0,2,1,1
PT,RU,2021.0,15,6,9
GB,IN,2023.0,6,28,-22
CU,CR,2011.0,6,9,-3
MY,PK,2020.0,147,92,55
IT,DK,2016.0,44,31,13
IR,ET,2022.0,3,1,2
CN,IT,2021.0,47,62,-15
PS,GB,2021.0,4,4,0
TH,DE,2016.0,7,25,-18
TW,DE,2011.0,27,24,3
CZ,ES,2020.0,14,27,-13
IT,FI,2020.0,107,22,85
JP,ZA,2013.0,12,3,9
SD,DE,2019.0,4,3,1
AU,RS,2021.0,11,4,7
GB,LU,2018.0,14,14,0
EG,ID,2021.0,40,25,15
AU,JO,2008.0,7,3,4
JP,CH,2023.0,1,1,0
SE,FI,2001.0,47,36,11
LY,IN,2018.0,5,1,4
TW,VN,2023.0,2,1,1
GT,MX,2010.0,6,8,-2
FR,NC,2020.0,17,12,5
RU,ID,2020.0,34,15,19
GH,GB,2014.0,19,40,-21
FR,BG,1999.0,12,11,1
IR,PT,2019.0,14,14,0
PT,IR,2021.0,7,9,-2
IT,SA,2017.0,20,6,14
GB,MW,2017.0,24,20,4
CZ,RU,2020.0,54,67,-13
US,ET,2019.0,69,66,3
TH,JP,2017.0,67,105,-38
IT,PL,2018.0,42,34,8
RU,US,1999.0,301,177,124
AG,JP,2021.0,4,6,-2
nan,TR,2017.0,25,22,3
US,OM,2020.0,21,12,9
RO,GB,2015.0,64,63,1
PK,KH,2021.0,1,1,0
SA,BH,2021.0,15,8,7
TR,AE,2020.0,8,4,4
AU,MW,2018.0,1,4,-3
IT,MA,2018.0,40,26,14
KR,nan,2021.0,23,26,-3
BY,IN,2015.0,5,2,3
ES,CN,2015.0,75,83,-8
TJ,RU,2018.0,35,31,4
SG,TH,2013.0,9,6,3
BJ,FR,2014.0,33,33,0
KW,EG,2018.0,37,31,6
DO,CO,2019.0,5,9,-4
PR,KR,2019.0,42,39,3
IL,NL,2005.0,18,7,11
RW,IN,2019.0,8,7,1
HK,AU,2014.0,4,6,-2
BR,AR,2019.0,208,202,6
MX,ES,1998.0,136,160,-24
ZA,NG,2018.0,117,128,-11
US,EC,2014.0,50,24,26
CA,FR,1998.0,189,226,-37
IL,GB,2011.0,51,55,-4
MY,AU,2015.0,110,127,-17
TR,ES,2021.0,12,13,-1
NG,JP,2022.0,19,10,9
LT,US,2016.0,13,13,0
TR,US,1999.0,132,128,4
IT,RU,2012.0,17,20,-3
PR,ET,2016.0,10,8,2
PT,FR,2019.0,63,69,-6
FR,SE,1998.0,35,22,13
NZ,SG,2015.0,11,12,-1
PT,US,2012.0,144,168,-24
DE,LU,2022.0,19,18,1
RO,US,2019.0,87,127,-40
ID,nan,2022.0,23,38,-15
OM,IQ,2019.0,8,3,5
EC,CU,2020.0,27,22,5
SG,KR,2005.0,17,15,2
VE,US,2020.0,46,24,22
AU,BE,2015.0,33,55,-22
GR,US,1999.0,62,97,-35
AU,PG,2021.0,5,4,1
SG,nan,2017.0,10,5,5
DE,IE,2015.0,85,91,-6
MX,NL,2014.0,13,15,-2
RS,DE,2008.0,7,11,-4
GR,HU,2014.0,2,3,-1
AZ,IT,2019.0,18,15,3
CA,IL,1998.0,21,27,-6
CN,MN,2013.0,3,2,1
TR,JP,2003.0,39,57,-18
KE,GB,2005.0,13,14,-1
CA,IL,1997.0,28,15,13
FR,AR,2001.0,15,26,-11
AR,FR,2005.0,27,27,0
TR,CA,2003.0,7,5,2
ES,PT,2011.0,135,111,24
ES,MA,2013.0,15,4,11
DE,PT,2012.0,38,48,-10
PL,NL,1999.0,8,4,4
MT,DE,2019.0,3,1,2
IN,MX,2013.0,11,10,1
SG,nan,2010.0,8,5,3
ID,AU,2016.0,56,92,-36
RO,US,2017.0,80,115,-35
HU,US,2008.0,102,92,10
US,NE,2015.0,2,2,0
US,BJ,2020.0,2,3,-1
nan,DK,2008.0,13,13,0
BF,CH,2015.0,1,2,-1
FR,CZ,2007.0,22,23,-1
US,GD,2014.0,12,8,4
AU,FR,2003.0,48,62,-14
FR,RU,1997.0,30,40,-10
LU,DE,2016.0,23,42,-19
TR,AT,2005.0,5,4,1
SG,nan,2019.0,13,12,1
HU,RO,2022.0,84,20,64
EC,BR,2011.0,6,8,-2
CU,AR,2020.0,11,13,-2
TH,PH,2022.0,4,4,0
SE,JP,2020.0,48,36,12
JP,BD,2016.0,62,55,7
YE,GB,1998.0,1,1,0
KR,KH,2019.0,4,1,3
FR,MD,2009.0,42,38,4
RS,MK,2015.0,3,4,-1
RU,BG,2020.0,26,35,-9
ID,TR,2020.0,10,22,-12
ID,FR,2011.0,10,22,-12
PR,KR,2010.0,36,17,19
ES,nan,2010.0,38,29,9
NZ,CA,2010.0,70,60,10
US,CZ,2005.0,106,105,1
FR,MA,1997.0,62,54,8
IL,UY,2018.0,2,3,-1
BE,SE,2012.0,32,25,7
IE,NL,2008.0,15,18,-3
CL,AR,1997.0,9,8,1
GB,NG,2009.0,21,26,-5
EG,IN,2005.0,6,4,2
MX,TW,2011.0,3,2,1
LV,EE,2019.0,2,2,0
US,SI,2007.0,23,27,-4
CN,AE,2009.0,3,2,1
AT,CH,2015.0,122,124,-2
PL,CZ,2001.0,16,8,8
RW,IN,2017.0,6,3,3
BD,KR,2021.0,22,29,-7
CH,SG,2016.0,13,19,-6
IR,DK,2014.0,15,7,8
JP,SE,2019.0,52,45,7
SE,MX,2013.0,6,13,-7
ID,SI,2018.0,7,7,0
EC,UA,2014.0,50,29,21
JP,BE,2015.0,39,34,5
ZA,AT,2018.0,7,7,0
RO,AT,2017.0,10,12,-2
AT,CA,2003.0,11,12,-1
LB,CN,2007.0,9,7,2
ET,JP,2020.0,5,8,-3
IN,PL,2018.0,23,17,6
BE,EE,2020.0,5,5,0
ET,BH,2015.0,12,5,7
BR,ET,2017.0,4,1,3
nan,IL,2006.0,16,12,4
ID,US,2000.0,6,9,-3
RU,RO,2007.0,2,1,1
DK,ID,2021.0,4,1,3
CA,MA,2013.0,19,10,9
RO,GR,2016.0,4,2,2
GR,FI,2012.0,5,1,4
US,ZW,2006.0,4,13,-9
GB,AR,2001.0,12,18,-6
UA,FR,2005.0,14,11,3
CA,IT,2004.0,43,65,-22
MM,SG,2022.0,6,2,4
GB,MW,2010.0,9,6,3
SA,AE,2010.0,7,6,1
GH,CA,2007.0,3,3,0
MX,nan,2013.0,29,21,8
PT,DE,2006.0,27,25,2
KH,CH,2020.0,3,1,2
BS,US,2011.0,2,1,1
IT,AZ,2020.0,13,14,-1
BG,RS,2015.0,4,1,3
DK,IN,2006.0,5,8,-3
RU,JP,2014.0,38,52,-14
IT,CL,2013.0,26,30,-4
HR,BE,2017.0,3,5,-2
TW,ES,2009.0,4,7,-3
PL,RS,2019.0,10,7,3
RO,US,2010.0,58,70,-12
BD,SG,2017.0,2,6,-4
CL,CO,1999.0,5,12,-7
SG,NZ,2016.0,12,20,-8
KE,UG,2022.0,14,15,-1
CN,LK,2020.0,12,13,-1
NG,CH,2017.0,3,1,2
LB,GB,2002.0,4,2,2
AR,DE,2018.0,52,48,4
GP,FR,2016.0,24,25,-1
DO,CO,2017.0,5,5,0
JO,FR,2021.0,2,1,1
ID,FI,2015.0,1,4,-3
PK,NO,2011.0,3,4,-1
RU,EG,2019.0,22,14,8
SA,JP,2018.0,11,9,2
SK,CN,2003.0,4,2,2
CN,CH,2022.0,57,72,-15
TR,ID,2017.0,23,8,15
NO,JP,2006.0,9,6,3
NG,MX,2018.0,2,2,0
CN,RU,2008.0,32,74,-42
AL,GR,2016.0,1,2,-1
FI,LT,2015.0,2,4,-2
GT,MX,2017.0,30,25,5
BE,RO,2018.0,16,10,6
ZW,US,2016.0,14,10,4
IL,RU,2011.0,27,19,8
AU,DK,2018.0,77,49,28
DE,HR,2005.0,14,15,-1
BR,MZ,2014.0,5,8,-3
AR,FR,2002.0,22,22,0
US,HU,2015.0,94,124,-30
IQ,SA,2022.0,29,29,0
IT,PT,2013.0,43,25,18
CA,SI,2020.0,6,5,1
MY,IE,2021.0,9,8,1
BE,GB,2000.0,64,46,18
BR,NO,2011.0,14,17,-3
CM,IT,2002.0,2,2,0
FR,BJ,2007.0,25,18,7
MY,GB,2000.0,12,22,-10
AR,PK,2006.0,4,10,-6
CN,CL,2020.0,3,4,-1
FR,SE,1997.0,25,19,6
MA,CA,2016.0,17,17,0
BE,JP,2015.0,34,39,-5
RO,MD,2007.0,1,2,-1
CL,CR,2013.0,19,19,0
TN,US,2019.0,19,21,-2
MN,JP,2006.0,1,1,0
KR,RU,2018.0,37,21,16
US,QA,2016.0,105,51,54
DE,SI,2018.0,18,21,-3
TR,RS,2015.0,54,105,-51
ES,VE,2022.0,14,13,1
DE,HR,2002.0,20,8,12
RU,SE,2006.0,29,26,3
IT,TN,2012.0,6,17,-11
NG,NL,2020.0,11,7,4
AU,nan,2016.0,29,64,-35
US,AZ,2016.0,4,1,3
IL,CA,2014.0,71,62,9
BE,CZ,1999.0,4,3,1
SE,KE,2013.0,8,5,3
TR,DE,2003.0,28,19,9
IT,IL,2001.0,8,11,-3
TR,IL,1999.0,5,3,2
AU,CH,2002.0,28,39,-11
HR,DK,2015.0,4,3,1
RU,AZ,2015.0,10,17,-7
ZA,GR,2006.0,2,1,1
CZ,RS,2013.0,8,10,-2
HU,BG,2014.0,2,1,1
TH,AU,2009.0,21,37,-16
FR,IL,2018.0,33,40,-7
MZ,PL,2004.0,9,2,7
RW,IN,2010.0,5,3,2
CM,JP,2015.0,2,1,1
MY,SA,2013.0,57,23,34
HU,EC,2017.0,2,2,0
KE,BH,1999.0,3,2,1
UA,BE,2008.0,1,1,0
SE,CZ,2014.0,14,17,-3
IN,NZ,2001.0,8,5,3
SK,RO,2019.0,3,6,-3
MY,NG,2011.0,10,10,0
FR,AM,2010.0,8,3,5
DE,BY,2006.0,8,8,0
US,LY,2014.0,3,4,-1
BD,IL,2012.0,4,2,2
CA,FR,1997.0,130,160,-30
IT,LB,2022.0,24,4,20
SI,HR,2021.0,28,23,5
AE,OM,2016.0,6,6,0
AU,CH,2005.0,32,33,-1
RU,LV,2016.0,15,18,-3
US,RE,2010.0,4,2,2
RS,IT,2006.0,6,5,1
NZ,BE,2014.0,7,4,3
LK,JP,2008.0,22,18,4
CN,ZA,2019.0,18,20,-2
IE,ES,2013.0,24,31,-7
CH,AT,1998.0,42,46,-4
CA,LY,2015.0,3,1,2
IN,BR,2002.0,9,8,1
AE,AU,2012.0,6,13,-7
GH,NG,2010.0,6,2,4
BG,US,2020.0,23,30,-7
IS,DE,2014.0,2,4,-2
US,ML,2018.0,4,9,-5
RO,CZ,2008.0,9,4,5
GB,ZM,2009.0,3,1,2
UY,BR,1999.0,10,7,3
JP,NG,2012.0,10,8,2
NO,CH,2016.0,16,34,-18
IN,IL,2007.0,16,14,2
SA,KW,2022.0,16,14,2
OM,MY,2012.0,3,3,0
US,LV,2020.0,8,6,2
ZM,KE,2014.0,2,2,0
TW,JP,2001.0,32,44,-12
CZ,BY,1999.0,1,3,-2
LB,US,2010.0,76,51,25
TN,US,2010.0,13,19,-6
MX,DK,2006.0,3,1,2
IL,SE,2010.0,3,4,-1
ES,BE,2006.0,20,31,-11
JP,AZ,2020.0,2,1,1
RU,IL,2003.0,15,14,1
nan,ES,2001.0,9,12,-3
BR,CU,2005.0,15,7,8
KR,PT,2014.0,8,4,4
IL,CH,2015.0,19,11,8
CN,NZ,2004.0,14,26,-12
FR,KR,2015.0,35,26,9
CH,BR,2007.0,28,22,6
TR,MM,2020.0,10,3,7
VN,FI,2021.0,3,2,1
BR,RO,2009.0,5,1,4
US,UY,2005.0,13,10,3
SA,CN,2016.0,26,46,-20
IN,BD,2023.0,4,4,0
TW,NZ,2001.0,1,2,-1
US,TT,2004.0,3,2,1
DE,CR,2015.0,9,5,4
PH,RU,1997.0,1,1,0
GB,GE,2014.0,9,5,4
US,VN,2008.0,35,20,15
SG,PK,2021.0,10,6,4
PT,CL,2022.0,7,9,-2
CZ,SE,2007.0,8,7,1
KR,GB,2023.0,8,1,7
ES,RO,2013.0,10,21,-11
PK,CA,2002.0,4,2,2
CN,BE,1997.0,6,8,-2
GB,SJ,2015.0,2,1,1
NO,nan,2013.0,28,41,-13
NP,AT,2012.0,1,1,0
IL,NL,2002.0,14,8,6
LU,ES,2015.0,3,4,-1
FI,CA,1997.0,5,8,-3
CH,PT,2009.0,9,14,-5
TR,BE,2003.0,6,10,-4
AR,PT,2013.0,12,12,0
TR,RU,2008.0,3,6,-3
VE,NL,2015.0,6,1,5
ES,NO,2022.0,27,22,5
IN,RU,2016.0,24,23,1
LU,BE,2015.0,15,32,-17
NA,US,2015.0,7,2,5
EG,FR,2004.0,7,6,1
RO,CA,2021.0,5,16,-11
RU,NO,2017.0,12,31,-19
ME,HR,2009.0,3,2,1
MY,US,1997.0,8,5,3
KE,FR,2021.0,4,6,-2
CA,DK,1997.0,12,6,6
PL,HR,2008.0,3,1,2
TN,GB,2013.0,3,7,-4
IN,KR,1999.0,15,13,2
TN,EG,2021.0,21,16,5
JP,CO,2002.0,7,5,2
ID,GB,2015.0,19,79,-60
PK,BR,2017.0,5,9,-4
GH,NG,2017.0,8,18,-10
BE,MD,2009.0,2,3,-1
GH,ID,2014.0,4,4,0
IL,CN,2003.0,12,14,-2
CL,BE,2017.0,6,13,-7
CN,CM,2018.0,6,7,-1
TW,FR,1998.0,4,11,-7
PH,BR,2019.0,15,16,-1
LU,PT,2013.0,3,1,2
EG,DE,2010.0,30,45,-15
CA,ID,2005.0,5,5,0
GR,CA,2016.0,19,8,11
VE,CO,2000.0,9,10,-1
GB,EC,2014.0,9,5,4
AR,CH,2014.0,17,16,1
CA,TW,2016.0,40,47,-7
TR,CN,2006.0,6,12,-6
CA,LB,2015.0,18,11,7
UA,FR,2002.0,8,6,2
PL,MX,2009.0,11,3,8
ES,QA,2014.0,6,5,1
LY,IQ,2020.0,2,5,-3
RO,PL,2014.0,2,11,-9
UY,CL,2011.0,10,7,3
GB,MN,2019.0,3,3,0
IN,LV,2018.0,3,1,2
CH,TN,2013.0,8,8,0
PL,AU,2014.0,14,14,0
CL,MY,2020.0,2,2,0
IN,TH,2023.0,3,1,2
CZ,PT,2016.0,6,4,2
EC,BE,2012.0,4,3,1
CL,PT,2009.0,6,8,-2
RU,FI,1999.0,11,13,-2
CL,FI,2017.0,6,3,3
DE,GE,2009.0,9,3,6
CH,GR,2006.0,13,14,-1
ZW,OM,2022.0,1,1,0
DE,MY,2016.0,19,21,-2
PT,CZ,2014.0,5,1,4
BR,IN,2022.0,16,12,4
US,PY,2020.0,11,12,-1
JP,AT,2009.0,15,11,4
LB,FR,2008.0,28,29,-1
FR,PT,2011.0,59,38,21
MX,HN,2005.0,14,11,3
FI,BE,2005.0,7,6,1
PL,RS,2017.0,8,3,5
PK,FR,2013.0,15,31,-16
TW,TR,2005.0,5,11,-6
nan,DZ,2013.0,4,2,2
NZ,CN,1997.0,8,3,5
KE,DE,2004.0,7,2,5
CA,RO,2006.0,9,4,5
MW,GB,2007.0,7,8,-1
IE,TW,2017.0,1,2,-1
CO,TR,2010.0,2,2,0
IT,CO,2019.0,16,36,-20
BN,MY,2016.0,5,14,-9
JM,US,1998.0,12,3,9
CN,ZA,2010.0,14,10,4
SE,UA,2013.0,5,7,-2
CN,NO,2003.0,8,5,3
IT,AM,2005.0,17,3,14
NO,DE,1998.0,10,22,-12
ET,AT,2018.0,2,8,-6
CA,DZ,2010.0,6,9,-3
NL,SY,2011.0,1,2,-1
US,MG,2013.0,6,2,4
CA,DZ,2017.0,11,15,-4
CM,ZA,2017.0,11,9,2
JP,UZ,2004.0,3,1,2
CR,ES,2001.0,14,8,6
SE,QA,2017.0,4,6,-2
IN,PK,1997.0,8,12,-4
nan,BE,2007.0,26,17,9
ER,IN,2010.0,1,1,0
EG,DK,2018.0,4,7,-3
KR,GH,2017.0,1,1,0
US,BG,2000.0,20,26,-6
IL,AU,2022.0,13,8,5
BE,QA,2018.0,3,2,1
SI,ES,2016.0,14,19,-5
BE,MA,2020.0,10,5,5
CZ,BE,2015.0,10,14,-4
RO,JP,2003.0,5,4,1
BG,NO,2010.0,12,3,9
BE,UG,2010.0,7,4,3
DK,CH,1997.0,7,9,-2
DZ,CA,2004.0,7,1,6
BE,TZ,2022.0,3,1,2
RS,ME,2008.0,5,11,-6
UZ,RS,2012.0,4,1,3
CL,BE,2019.0,15,8,7
ZA,FI,2006.0,3,1,2
RS,SI,2003.0,2,4,-2
GR,MK,2006.0,6,4,2
MA,ET,2019.0,1,2,-1
BE,UG,2019.0,11,9,2
JO,AE,2013.0,17,6,11
UA,EC,2021.0,10,11,-1
CZ,LT,2000.0,1,2,-1
IT,MT,2022.0,5,7,-2
PT,MA,2015.0,6,8,-2
ES,KR,2017.0,8,18,-10
PK,AE,2018.0,17,25,-8
BG,IT,2011.0,4,4,0
MY,ZM,2019.0,3,1,2
SG,NO,2011.0,3,4,-1
GR,NO,2009.0,10,2,8
NZ,EG,2010.0,4,4,0
OM,SA,2021.0,7,8,-1
RO,LT,2000.0,5,3,2
HU,CZ,2005.0,5,6,-1
RS,GB,2011.0,9,22,-13
TR,AT,2002.0,9,2,7
CR,AR,2008.0,7,11,-4
MU,US,2009.0,2,1,1
IT,SA,2010.0,5,1,4
CA,TT,2020.0,4,5,-1
EG,PS,2016.0,13,9,4
nan,TR,2010.0,7,17,-10
DE,TW,2012.0,28,20,8
TH,GB,2006.0,14,50,-36
UY,NL,2003.0,2,2,0
FI,IT,2000.0,4,7,-3
MX,BA,2009.0,5,2,3
RS,NL,2012.0,5,7,-2
AR,CA,2002.0,9,5,4
US,AG,2019.0,7,2,5
UG,NG,2013.0,2,1,1
SK,NL,2013.0,4,9,-5
AU,UA,2002.0,2,1,1
ZA,NL,2000.0,9,13,-4
GR,DK,2002.0,3,4,-1
AT,PL,2016.0,13,19,-6
AU,CZ,2011.0,5,5,0
IL,SE,2017.0,9,10,-1
IL,AT,2016.0,2,3,-1
FR,IR,2005.0,15,10,5
JP,CO,2005.0,7,3,4
ZA,SD,2016.0,4,2,2
SA,AU,2001.0,2,4,-2
ES,ID,2006.0,6,5,1
SG,DE,2002.0,8,8,0
DK,PL,2016.0,14,20,-6
MX,HN,2002.0,8,16,-8
ES,HN,1998.0,2,1,1
CL,AR,1998.0,5,9,-4
VN,MY,2018.0,2,12,-10
US,PR,2015.0,9,5,4
GB,VE,2003.0,8,8,0
PE,HN,2018.0,1,1,0
BJ,ML,2018.0,1,1,0
DE,PY,2021.0,2,2,0
CA,YE,2018.0,1,1,0
DK,GR,2007.0,9,5,4
EE,LV,2017.0,5,1,4
CZ,FR,1999.0,12,23,-11
PT,ST,2015.0,2,1,1
ES,DO,2009.0,1,3,-2
IT,VN,2013.0,2,3,-1
IT,CU,2015.0,2,3,-1
US,UY,2002.0,8,8,0
PT,AU,2004.0,4,5,-1
PH,NL,2012.0,4,3,1
HR,NO,2017.0,2,1,1
MA,nan,2021.0,6,9,-3
JP,SG,1997.0,9,4,5
NZ,EG,2019.0,5,2,3
SG,BD,2019.0,6,5,1
ES,TW,2004.0,2,2,0
DE,CY,2022.0,3,6,-3
NZ,VN,2017.0,4,2,2
GB,BO,2021.0,1,1,0
IE,AU,2023.0,3,2,1
SN,BJ,2018.0,4,1,3
AT,BG,2008.0,6,6,0
ET,US,1997.0,6,4,2
BA,IQ,2019.0,6,3,3
KZ,GB,2009.0,1,1,0
ES,FI,2015.0,28,18,10
LT,GB,2022.0,3,6,-3
GB,FO,2016.0,2,1,1
MX,BO,2020.0,8,10,-2
BE,MX,2021.0,4,8,-4
FR,BO,2020.0,4,3,1
PK,BR,2019.0,3,10,-7
NG,UG,2014.0,3,4,-1
RW,CN,2012.0,1,1,0
ES,PK,2018.0,3,4,-1
TW,TR,2002.0,6,8,-2
TW,CL,2019.0,1,1,0
BO,IR,2014.0,2,1,1
UZ,PL,2012.0,4,3,1
BD,SG,2019.0,5,6,-1
nan,ZA,2014.0,12,4,8
IE,TW,2019.0,5,1,4
ES,KR,2010.0,6,4,2
KR,EC,2019.0,1,3,-2
DE,KZ,2011.0,2,2,0
CY,NG,2016.0,2,1,1
TN,BE,2021.0,5,4,1
RU,EG,2017.0,11,11,0
EC,SV,2016.0,1,2,-1
SA,TH,2019.0,3,7,-4
MY,IN,2008.0,30,42,-12
GH,BR,2020.0,1,3,-2
PS,MY,2011.0,3,1,2
UZ,MZ,2021.0,1,1,0
IQ,DE,2022.0,7,4,3
AR,AT,2018.0,9,3,6
JM,CA,1998.0,1,1,0
RS,ES,2018.0,5,3,2
FI,CH,2005.0,8,6,2
SI,SE,2013.0,4,2,2
BG,NO,2019.0,2,4,-2
AT,CZ,2003.0,5,8,-3
FR,HU,2014.0,22,24,-2
DK,PT,2013.0,10,11,-1
BO,AR,2007.0,5,2,3
BD,FR,2015.0,7,7,0
BE,BD,2012.0,5,2,3
US,MK,2006.0,4,3,1
CH,NO,2006.0,12,7,5
KR,IE,2018.0,6,3,3
JP,SG,1998.0,15,4,11
PT,BE,2023.0,1,1,0
SE,BE,2014.0,25,27,-2
FI,TW,2014.0,2,1,1
CA,DK,1998.0,15,10,5
GN,FR,2019.0,3,7,-4
UG,CH,2012.0,3,2,1
PL,PK,2006.0,6,5,1
MX,UY,2013.0,16,8,8
DK,TW,2021.0,3,2,1
KR,KH,2017.0,2,1,1
RU,EG,2010.0,3,4,-1
CO,BE,2018.0,8,9,-1
PK,MY,2007.0,5,3,2
OM,IQ,2017.0,6,1,5
CL,BE,2010.0,5,6,-1
IE,FI,2012.0,3,1,2
ZW,NG,2017.0,1,1,0
ZA,BW,2020.0,11,13,-2
FR,IR,2002.0,5,3,2
CZ,NL,2008.0,11,13,-2
SE,BG,1998.0,4,4,0
ZM,BR,2009.0,4,1,3
GR,IN,1997.0,1,3,-2
CH,AU,1998.0,22,18,4
KR,TR,2016.0,7,6,1
AE,PK,2003.0,2,2,0
BH,US,1997.0,2,1,1
PK,CA,2005.0,5,7,-2
UZ,KZ,2022.0,10,11,-1
LU,TR,2018.0,2,2,0
SI,FR,2010.0,6,11,-5
AU,PH,1999.0,3,5,-2
NO,AE,2019.0,2,4,-2
AU,EG,2021.0,14,19,-5
FI,CH,2002.0,10,8,2
PK,BR,2010.0,3,2,1
LA,GB,2016.0,1,1,0
ZW,GB,2018.0,7,7,0
FR,SK,1998.0,3,4,-1
SA,IT,2011.0,3,9,-6
NG,ID,2016.0,11,7,4
US,AF,2014.0,1,3,-2
ZA,GH,2016.0,10,16,-6
GR,DK,2005.0,8,1,7
IE,AE,2013.0,6,2,4
SI,nan,2018.0,11,4,7
TZ,IN,2012.0,2,4,-2
NL,PA,2012.0,3,1,2
MN,US,2011.0,6,2,4
RO,AU,2007.0,1,3,-2
US,BW,2021.0,6,8,-2
SI,FR,2017.0,14,6,8
SI,BA,2020.0,4,3,1
RU,NO,2019.0,16,20,-4
nan,AR,1999.0,10,6,4
PL,XK,2009.0,2,2,0
SA,LY,2018.0,3,1,2
RU,EC,2014.0,3,5,-2
ZA,PT,2015.0,3,5,-2
PE,PT,2021.0,6,4,2
GE,IE,2018.0,1,3,-2
MX,SK,2022.0,4,1,3
PL,MZ,2011.0,6,9,-3
CZ,RO,2008.0,4,9,-5
BR,CR,2022.0,9,8,1
nan,PT,2006.0,14,11,3
IN,BR,2005.0,12,15,-3
KW,US,2018.0,23,32,-9
FR,TH,1998.0,1,1,0
PH,ES,2004.0,2,6,-4
PH,DE,2013.0,13,7,6
ES,TH,2014.0,5,2,3
CN,ET,2000.0,1,2,-1
KW,JO,2022.0,3,1,2
SE,VN,1997.0,1,2,-1
KH,FR,2014.0,4,6,-2
ET,NG,2014.0,3,1,2
ID,SE,2011.0,1,4,-3
BE,BF,2019.0,4,5,-1
US,ZM,2003.0,1,2,-1
HR,SE,2013.0,3,2,1
EG,CN,1999.0,1,1,0
HU,RU,2012.0,8,14,-6
SK,HU,2012.0,4,12,-8
IR,BE,2008.0,4,7,-3
BY,SK,2018.0,3,2,1
ID,LB,2020.0,3,1,2
RW,SE,2016.0,1,2,-1
PK,SD,2018.0,5,4,1
CU,PY,2013.0,1,1,0
PE,AU,2014.0,6,2,4
SE,QA,2019.0,4,9,-5
SE,SK,2015.0,1,2,-1
LT,FR,2021.0,3,2,1
TR,AZ,2022.0,7,9,-2
OM,AE,2014.0,5,2,3
CO,IN,2014.0,5,3,2
AR,FI,2016.0,1,3,-2
PY,AR,2012.0,1,2,-1
SI,BE,2021.0,4,3,1
HU,CH,2001.0,4,5,-1
AR,CA,2005.0,16,11,5
FR,EE,1998.0,3,1,2
NL,TW,2022.0,5,4,1
NZ,VN,2019.0,6,5,1
JO,ID,2018.0,5,1,4
SE,LK,2006.0,1,2,-1
DE,KG,2017.0,2,2,0
MY,BE,2014.0,4,2,2
PL,SG,2014.0,5,3,2
SI,FR,2019.0,11,7,4
MK,RS,2004.0,1,1,0
PS,EG,2018.0,11,13,-2
BR,SE,2023.0,3,2,1
AE,LB,2015.0,1,7,-6
RS,CZ,2008.0,9,13,-4
AU,IL,2009.0,6,24,-18
RO,IT,2009.0,6,20,-14
IN,SI,2016.0,1,6,-5
PA,US,2008.0,24,26,-2
MX,VE,2002.0,8,11,-3
LU,GB,2016.0,7,7,0
CH,TR,2001.0,4,6,-2
BE,SG,2020.0,7,2,5
NL,IQ,2020.0,4,1,3
ES,VG,2019.0,1,1,0
HU,TW,2010.0,2,2,0
DZ,DE,2020.0,8,11,-3
RE,US,2014.0,4,3,1
CO,HN,2015.0,7,5,2
BA,SE,2021.0,2,1,1
GA,NL,2021.0,5,5,0
BE,NG,2007.0,2,2,0
NL,NP,2019.0,1,6,-5
TT,JM,2012.0,15,13,2
KZ,TW,2006.0,1,1,0
IT,TW,2008.0,4,2,2
SG,PH,2014.0,8,8,0
US,BH,2009.0,8,7,1
BH,AE,2016.0,2,2,0
AT,MX,2016.0,4,3,1
PE,DO,2021.0,2,1,1
FR,GP,2007.0,10,11,-1
ET,IT,2007.0,4,4,0
GB,MS,2002.0,1,1,0
NL,KE,2021.0,7,10,-3
nan,CL,2012.0,7,5,2
HU,AE,2013.0,5,1,4
TH,AT,2007.0,5,5,0
PL,HK,2020.0,2,4,-2
HR,BE,2010.0,1,2,-1
NZ,EG,2017.0,1,1,0
IT,CO,2010.0,6,7,-1
IQ,MY,2007.0,1,1,0
GH,ZM,2003.0,1,1,0
AL,DE,2015.0,1,1,0
CA,TR,2006.0,15,14,1
LB,SA,2008.0,4,4,0
CN,BE,1998.0,10,10,0
TH,BE,2011.0,1,5,-4
CA,LK,2020.0,6,11,-5
MD,TR,2019.0,2,7,-5
IE,NZ,2015.0,13,17,-4
US,RE,2017.0,5,6,-1
VN,DE,2002.0,2,1,1
BR,EC,2008.0,4,5,-1
PL,IE,2004.0,3,1,2
MZ,US,2018.0,4,10,-6
CO,PT,2002.0,2,1,1
EG,SE,2011.0,4,5,-1
RO,AT,2019.0,5,8,-3
SG,KR,2002.0,12,8,4
IT,ZA,1998.0,3,1,2
NL,NP,2010.0,2,2,0
BJ,US,2002.0,3,1,2
IS,SE,2003.0,7,20,-13
UA,IT,2000.0,6,6,0
BW,KE,2021.0,3,1,2
HK,CN,2003.0,3,3,0
EG,AE,2023.0,6,4,2
SE,IR,2000.0,5,1,4
CU,GB,2000.0,2,1,1
IR,ID,2011.0,2,3,-1
MX,GT,2006.0,2,5,-3
RO,IR,2007.0,1,1,0
CH,ML,2008.0,2,2,0
PL,IQ,2016.0,1,2,-1
IR,AU,1999.0,4,15,-11
PA,CU,2018.0,3,7,-4
nan,GR,2015.0,2,5,-3
BR,UZ,2008.0,1,1,0
MY,AE,2011.0,6,2,4
PL,BR,2003.0,4,1,3
MA,PT,2013.0,10,3,7
AZ,US,2001.0,1,1,0
MD,TR,2017.0,1,2,-1
CO,AU,2001.0,2,3,-1
MA,IQ,2020.0,6,2,4
AG,GB,2021.0,3,3,0
SE,LT,1999.0,2,1,1
MX,IN,2000.0,3,6,-3
DZ,FR,2000.0,7,22,-15
LA,TH,2017.0,2,4,-2
CO,PT,2005.0,3,2,1
NG,CH,2019.0,4,5,-1
NG,CN,2012.0,5,6,-1
AE,NL,2011.0,1,6,-5
NL,NP,2017.0,2,3,-1
CH,PH,2021.0,2,4,-2
SK,IL,2001.0,1,2,-1
AR,AU,2011.0,5,3,2
BB,US,2019.0,2,1,1
SD,DE,2010.0,2,3,-1
NL,RO,2003.0,2,6,-4
CN,VN,1998.0,4,4,0
IE,PL,2000.0,1,1,0
MY,TR,2022.0,6,4,2
AT,ET,2014.0,2,2,0
FR,SK,1997.0,5,4,1
FR,TZ,2013.0,1,2,-1
VN,IN,2011.0,2,3,-1
DE,GA,2022.0,4,2,2
IT,BG,2022.0,3,5,-2
JP,MN,2022.0,5,2,3
HU,IQ,2021.0,3,10,-7
EG,VN,2013.0,2,1,1
PL,UZ,2010.0,4,2,2
MA,IT,1998.0,2,2,0
DZ,nan,2009.0,2,1,1
OM,JO,2000.0,1,1,0
GB,MW,2019.0,17,29,-12
RU,nan,2023.0,1,1,0
ID,GR,2018.0,1,3,-2
nan,PK,2011.0,3,1,2
BG,UA,2015.0,11,8,3
QA,LB,2014.0,2,4,-2
PG,TN,2015.0,2,6,-4
ZA,ID,2011.0,1,1,0
EG,LY,2021.0,9,7,2
IT,AM,2002.0,3,5,-2
US,LT,2022.0,5,4,1
UZ,JP,2006.0,1,6,-5
BA,HR,1999.0,2,1,1
VN,DE,2005.0,7,4,3
GI,CA,2008.0,1,1,0
KZ,KR,2019.0,7,4,3
RU,MA,2012.0,1,2,-1
CO,TR,2017.0,7,67,-60
QA,PT,2019.0,2,1,1
FR,CF,2011.0,3,3,0
MX,SG,2007.0,4,3,1
GE,CZ,2015.0,1,2,-1
IT,NG,2009.0,4,5,-1
IN,KZ,2018.0,4,1,3
AU,GE,2009.0,1,4,-3
BE,BF,2017.0,2,4,-2
MW,NL,2017.0,2,2,0
SG,SA,2009.0,2,2,0
SE,SA,2000.0,1,4,-3
DZ,GB,2011.0,3,4,-1
AE,RO,2017.0,2,2,0
NZ,SK,2011.0,1,2,-1
PT,CO,2013.0,9,7,2
EG,PL,2018.0,3,4,-1
ZA,EE,2017.0,2,1,1
DE,MD,2004.0,2,2,0
GH,BH,2014.0,6,5,1
CZ,UA,2004.0,2,1,1
CA,KW,1998.0,4,1,3
KG,PK,2019.0,1,2,-1
NO,IL,2014.0,1,1,0
BF,TG,2012.0,1,1,0
BR,GR,2006.0,2,1,1
LA,TH,2019.0,2,8,-6
NL,TN,2019.0,2,1,1
GT,CR,2019.0,3,3,0
NL,GA,2011.0,2,2,0
KZ,BG,2018.0,1,4,-3
KW,MA,2022.0,4,6,-2
LB,LT,2017.0,1,1,0
FR,NG,2021.0,9,7,2
HU,TW,2017.0,1,1,0
BD,PL,2008.0,1,4,-3
FI,SG,2016.0,2,6,-4
IL,PL,1999.0,4,4,0
JO,OM,2002.0,3,2,1
NZ,TH,2013.0,4,4,0
PK,IR,2009.0,6,4,2
BO,CO,2022.0,3,10,-7
NO,UG,2007.0,4,2,2
EC,FR,2007.0,4,3,1
ET,ZW,2020.0,1,3,-2
CG,BJ,2008.0,1,2,-1
PH,BR,2010.0,1,5,-4
IE,EG,2012.0,3,4,-1
SG,QA,2014.0,5,1,4
MX,CN,2007.0,6,4,2
TR,JO,2003.0,1,1,0
HR,NO,2019.0,3,2,1
BJ,BE,2011.0,1,5,-4
SD,DE,2017.0,3,2,1
SE,KR,2001.0,2,4,-2
TR,PK,2004.0,3,1,2
CH,BG,2008.0,3,3,0
BE,ID,2022.0,6,5,1
JP,VE,2008.0,1,2,-1
nan,NI,2018.0,2,3,-1
AT,TR,2018.0,5,18,-13
MK,BG,2018.0,4,8,-4
GT,BR,2020.0,5,3,2
JO,OM,2005.0,3,4,-1
TW,FR,1997.0,6,2,4
OM,AU,2011.0,1,3,-2
SE,NP,2017.0,1,2,-1
BD,SG,2010.0,3,3,0
GR,IN,1998.0,3,1,2
NC,US,2015.0,2,3,-1
SE,IL,2005.0,3,1,2
PL,UA,2003.0,7,14,-7
PK,MD,2020.0,2,1,1
SG,KW,2010.0,1,1,0
BY,PL,2011.0,2,1,1
JP,ZM,2022.0,1,2,-1
DK,RU,2008.0,9,5,4
RO,UA,2009.0,1,1,0
OM,IN,2007.0,4,3,1
KE,TZ,2003.0,2,1,1
HU,MX,2018.0,3,3,0
EE,DK,2007.0,1,1,0
JP,SI,2018.0,3,2,1
ES,UA,2001.0,1,3,-2
KH,GB,2009.0,3,1,2
NG,IT,1997.0,1,1,0
TH,SE,2009.0,4,6,-2
IT,SM,2015.0,6,1,5
NG,GH,2012.0,1,3,-2
FR,HR,2006.0,3,7,-4
AE,SA,2001.0,2,7,-5
ZA,nan,2012.0,6,9,-3
NL,OM,2008.0,1,1,0
DK,BG,2018.0,2,1,1
JP,KG,2019.0,5,1,4
SN,ML,2016.0,3,6,-3
nan,GH,2014.0,1,3,-2
AU,CY,2015.0,4,2,2
GB,VN,2000.0,2,2,0
PH,GT,2021.0,1,1,0
KZ,IT,2014.0,3,3,0
KZ,KG,2015.0,1,3,-2
GB,CI,2014.0,1,1,0
KZ,KR,2017.0,1,2,-1
CH,TH,2004.0,2,1,1
BJ,CM,2018.0,3,1,2
ML,GN,2022.0,1,1,0
ZW,CH,2021.0,1,1,0
GB,MS,2005.0,2,1,1
RU,EE,2012.0,10,9,1
TR,EG,2023.0,1,1,0
CA,CD,2013.0,3,1,2
TH,nan,2013.0,3,2,1
GA,US,2017.0,1,2,-1
RS,BG,2011.0,6,5,1
FR,MQ,2001.0,2,3,-1
JP,AM,2000.0,2,6,-4
NO,KE,2005.0,2,1,1
FR,KW,1999.0,2,1,1
GR,TR,2013.0,5,5,0
EC,VE,2015.0,3,24,-21
NO,LU,2020.0,4,2,2
HR,NO,2010.0,2,2,0
AD,ES,2020.0,1,1,0
SY,ET,2011.0,1,1,0
EG,RU,2015.0,2,6,-4
PA,KR,2017.0,1,3,-2
HK,SG,2004.0,1,1,0
PH,CN,2000.0,5,11,-6
CY,AE,2020.0,1,2,-1
GH,VN,2015.0,3,1,2
ZA,ES,2014.0,9,11,-2
EE,NO,2016.0,1,2,-1
SG,GR,2008.0,2,3,-1
CH,GH,2022.0,1,2,-1
NL,BF,2017.0,1,1,0
TZ,NL,2001.0,1,1,0
IL,ZA,2022.0,2,1,1
ES,LT,2011.0,1,1,0
MA,IT,1997.0,1,1,0
ES,CM,2016.0,1,1,0
MY,LK,2015.0,4,2,2
FR,MY,2004.0,2,6,-4
SD,GB,1998.0,1,1,0
PL,PE,2015.0,1,1,0
AT,CN,1999.0,4,1,3
VA,US,2008.0,2,1,1
CR,VE,2012.0,5,7,-2
UA,CA,2022.0,3,3,0
nan,AE,2014.0,2,1,1
PY,FR,2016.0,2,1,1
MY,VN,2022.0,6,4,2
CL,ZA,2016.0,3,4,-1
RS,IE,2021.0,2,2,0
KW,IR,2020.0,3,6,-3
ID,IE,2021.0,1,3,-2
FR,TG,2006.0,4,1,3
NO,PL,1999.0,2,1,1
MA,CH,2001.0,2,1,1
BY,nan,2014.0,2,2,0
KE,IN,2016.0,6,8,-2
AM,KR,2012.0,4,2,2
IQ,GB,2023.0,1,2,-1
GB,SO,2015.0,2,1,1
IE,RO,2021.0,3,1,2
KR,GH,2019.0,4,2,2
BB,US,2017.0,3,3,0
JM,US,1997.0,4,3,1
UA,SD,2021.0,2,3,-1
FR,PK,2005.0,3,1,2
JP,BA,2019.0,1,1,0
IN,HR,2013.0,1,1,0
RU,GE,2004.0,3,3,0
AU,ID,2000.0,6,4,2
IT,ZA,1997.0,1,4,-3
AE,IR,2014.0,2,4,-2
US,GP,2018.0,2,1,1
SK,RU,2006.0,5,10,-5
EG,BR,2014.0,2,2,0
CA,ID,2002.0,1,2,-1
CR,PT,2022.0,2,1,1
AU,ML,2013.0,1,1,0
MW,ZA,2019.0,3,11,-8
QA,RS,2018.0,3,4,-1
AU,SK,2009.0,1,1,0
LV,EE,2017.0,1,5,-4
AM,HU,2013.0,1,1,0
DK,EE,2007.0,1,1,0
EG,ET,2004.0,2,1,1
SE,IL,2002.0,2,4,-2
BG,DK,2014.0,1,1,0
VE,IT,1997.0,1,1,0
FR,AM,2017.0,1,4,-3
MW,NL,2019.0,1,2,-1
SA,ZA,2003.0,2,1,1
BI,IT,2010.0,1,1,0
UA,UZ,2008.0,3,3,0
BE,VE,2007.0,1,1,0
LU,DK,2017.0,1,3,-2
NG,TR,2014.0,3,1,2
LB,JP,2019.0,1,2,-1
AT,CL,2022.0,2,3,-1
GB,US,2018.0,6431,6471,-40
UY,DE,2018.0,7,3,4
NZ,NL,2008.0,10,20,-10
US,SG,2005.0,233,177,56
ZA,US,2012.0,307,351,-44
KR,US,2012.0,1064,1371,-307
TW,CN,2011.0,1352,924,428
MX,EC,2016.0,97,44,53
ES,CR,2020.0,65,59,6
US,ID,2009.0,61,36,25
AR,ES,2004.0,156,144,12
CA,NL,2015.0,82,96,-14
CZ,PL,2013.0,42,48,-6
EG,US,2014.0,168,236,-68
nan,PL,2015.0,15,7,8
CH,DE,2000.0,357,387,-30
DE,JP,2009.0,188,217,-29
CH,DK,2004.0,11,15,-4
SA,AE,2017.0,35,11,24
FR,IN,2007.0,57,114,-57
RU,CN,2009.0,62,60,2
AR,GB,2012.0,39,29,10
HR,JP,2001.0,2,1,1
CL,FI,2019.0,3,1,2
CO,CN,2004.0,8,1,7
AT,GR,2004.0,3,3,0
AR,PE,2021.0,40,41,-1
GT,MX,2019.0,26,43,-17
JP,TH,2016.0,116,86,30
ID,JP,2020.0,185,267,-82
IR,JO,2018.0,3,3,0
ES,PL,2021.0,25,14,11
IN,IE,2019.0,54,46,8
DE,DK,2015.0,182,131,51
LB,US,2019.0,113,83,30
KR,IN,2001.0,23,37,-14
AU,IN,2020.0,213,252,-39
TW,IN,1998.0,6,9,-3
MW,ZA,2017.0,10,9,1
PT,NO,2021.0,9,3,6
JP,SA,2015.0,17,4,13
GB,KW,2013.0,24,5,19
US,TZ,2018.0,27,19,8
GR,NL,2018.0,38,29,9
KR,NL,2018.0,10,10,0
IN,AT,2006.0,11,7,4
MG,FR,2018.0,14,22,-8
BE,PT,2007.0,8,9,-1
GB,BR,2003.0,52,63,-11
IN,IE,2010.0,28,11,17
AU,FI,2021.0,22,14,8
AT,US,2016.0,213,261,-48
BE,DK,2016.0,63,58,5
FR,RE,2007.0,18,12,6
KE,GB,2002.0,10,11,-1
BI,FR,2012.0,25,14,11
CH,AT,1997.0,26,38,-12
GB,GR,1998.0,64,38,26
BO,FR,2015.0,2,3,-1
IE,DK,2006.0,4,4,0
BE,FI,2013.0,5,9,-4
CH,AU,1997.0,13,16,-3
IT,NO,2016.0,37,15,22
QA,CN,2022.0,40,22,18
MX,CH,1999.0,1,1,0
ZA,AU,2001.0,15,22,-7
CG,PK,2021.0,7,2,5
MX,VE,2005.0,25,24,1
US,RE,2019.0,3,1,2
RO,BR,2018.0,8,6,2
AT,SE,2009.0,11,11,0
FR,MC,2015.0,13,3,10
SA,CA,2022.0,37,46,-9
PE,BR,2022.0,25,51,-26
IN,CL,2014.0,6,3,3
AZ,IT,2017.0,11,4,7
MZ,ZA,2013.0,2,1,1
PK,DK,2020.0,8,12,-4
NG,GR,2016.0,1,1,0
MK,GR,2006.0,4,6,-2
FI,ES,2003.0,7,3,4
FR,AM,2019.0,7,3,4
RO,ID,2016.0,3,2,1
MA,KW,2016.0,7,6,1
CA,CO,2014.0,28,14,14
CH,MX,2011.0,11,15,-4
CH,RO,2010.0,8,9,-1
FR,PK,2002.0,4,4,0
MY,US,1998.0,5,17,-12
SE,MZ,2013.0,2,2,0
HU,CZ,2002.0,3,4,-1
CW,NL,2011.0,20,25,-5
CH,RO,2019.0,10,14,-4
NO,EG,2011.0,1,2,-1
CH,LT,2021.0,2,6,-4
FR,IE,2015.0,35,47,-12
FI,CA,1998.0,12,7,5
GE,FI,2013.0,1,1,0
CZ,GB,2004.0,14,16,-2
PL,GR,2015.0,5,2,3
DE,VN,2013.0,6,12,-6
GH,SA,2010.0,2,1,1
TW,IN,1997.0,2,4,-2
BW,ET,2021.0,3,1,2
FR,CG,2006.0,14,13,1
IN,MA,2022.0,7,1,6
FI,BE,2002.0,4,6,-2
NO,IS,2006.0,4,4,0
AT,AR,2021.0,4,6,-2
AU,PF,2016.0,1,2,-1
LB,IQ,2021.0,4,3,1
AZ,AM,2020.0,1,1,0
IN,TZ,2020.0,5,1,4
AR,NZ,2009.0,1,1,0
PH,ID,2021.0,8,4,4
IR,NO,2004.0,1,1,0
SG,ES,2021.0,4,11,-7
TW,IT,2004.0,1,4,-3
EG,nan,2014.0,3,2,1
UY,US,2009.0,22,22,0
UA,JP,1999.0,11,8,3
MM,GB,2020.0,4,5,-1
ZA,MY,2018.0,6,3,3
NZ,CN,1998.0,5,8,-3
DZ,CM,2015.0,1,1,0
IE,CO,2018.0,1,5,-4
CH,DZ,2016.0,3,1,2
ES,LV,2014.0,1,1,0
SE,TZ,2012.0,5,3,2
AT,UY,2018.0,2,2,0
AU,AR,2000.0,3,1,2
FI,LU,2008.0,10,1,9
CA,GA,2014.0,2,1,1
CI,BE,2018.0,3,2,1
GE,UA,2015.0,1,1,0
GB,ET,2011.0,7,8,-1
TH,NO,2019.0,2,1,1
BA,VN,2020.0,1,1,0
SE,CO,2006.0,3,4,-1
AZ,BR,2020.0,1,1,0
PT,CR,2016.0,2,1,1
FI,UG,2020.0,1,2,-1
GR,RO,2018.0,4,3,1
CN,MX,2000.0,2,3,-1
EE,CA,2012.0,5,2,3
KE,BE,2003.0,5,3,2
GE,GB,1999.0,2,2,0
SG,BD,2010.0,3,3,0
TZ,DE,2020.0,2,4,-2
BR,GT,2014.0,1,1,0
AO,IT,2011.0,1,2,-1
FR,PE,1999.0,2,3,-1
PR,JP,2019.0,1,1,0
LB,MY,2013.0,2,1,1
CN,SL,2020.0,1,1,0
HU,SA,2016.0,2,1,1
HN,BR,2011.0,1,1,0
NP,DK,2018.0,2,4,-2
KZ,ES,2021.0,2,3,-1
AR,IN,2013.0,4,1,3
PK,nan,2011.0,1,3,-2
TZ,FR,2005.0,1,1,0
AO,FR,2003.0,2,1,1
BG,AT,2021.0,1,3,-2
CA,SK,2021.0,2,4,-2
MA,NG,2021.0,3,1,2
BF,IT,2020.0,1,2,-1
BE,MY,2003.0,1,1,0
VE,IT,1998.0,2,6,-4
EC,US,1997.0,3,1,2
IT,PK,2000.0,1,1,0
EG,YE,2011.0,2,4,-2
AT,NZ,2003.0,1,5,-4
IR,PT,2010.0,1,1,0
ZA,MX,2018.0,3,2,1
NL,MT,2016.0,1,1,0
GB,CO,2023.0,2,1,1
ZA,IR,2009.0,2,1,1
US,SG,2002.0,164,159,5
GB,nan,2020.0,109,85,24
CH,FR,2009.0,312,351,-39
CH,PL,2013.0,32,29,3
PR,KR,2017.0,34,32,2
ES,ZA,2020.0,7,11,-4
NG,CM,2018.0,3,4,-1
TR,IT,2016.0,14,20,-6
KW,BH,2016.0,6,1,5
DE,LV,2022.0,4,1,3
SE,PT,2008.0,9,7,2
DK,CH,1998.0,6,10,-4
GR,CN,2003.0,5,4,1
IT,TH,2018.0,4,9,-5
PK,RU,2014.0,1,3,-2
CH,KE,2009.0,1,1,0
AU,,2023.0,29796,0,29796
JP,,2021.0,27739,0,27739
IQ,,2024.0,4726,0,4726
,DE,1994.0,51387,0,51387
,VE,2004.0,515,0,515
VE,,2018.0,385,0,385
,BR,2009.0,18491,0,18491
AW,IN,2019.0,1,0,1
,IN,1997.0,6383,0,6383
,PL,2004.0,4143,0,4143
,KR,2005.0,4857,0,4857
,CA,1996.0,10194,0,10194
BR,,2014.0,6278,0,6278
KR,,2007.0,866,0,866
UA,,2016.0,1510,0,1510
,IN,1998.0,6419,0,6419
,PL,1996.0,3791,0,3791
,AR,2006.0,2179,0,2179
IL,,2022.0,4956,0,4956
,CA,2004.0,9625,0,9625
,KR,2002.0,4485,0,4485
FI,,2006.0,642,0,642
,UG,1995.0,67,0,67
FR,,2012.0,8753,0,8753
,FI,1997.0,2002,0,2002
,PK,2007.0,1169,0,1169
,FI,1998.0,1811,0,1811
,CZ,2016.0,1832,0,1832
,BD,1999.0,175,0,175
CI,,2024.0,613,0,613
,LK,2009.0,413,0,413
IR,TH,2001.0,1,0,1
CH,,2016.0,3205,0,3205
IN,,2003.0,1615,0,1615
LU,,2018.0,181,0,181
,VE,1996.0,432,0,432
,HK,2008.0,91,0,91
NP,,2016.0,141,0,141
NO,,2012.0,825,0,825
CR,,2020.0,294,0,294
DK,,2009.0,649,0,649
QA,,2025.0,197,0,197
KE,,2003.0,55,0,55
,TW,2015.0,2719,0,2719
,DZ,2006.0,693,0,693
,CL,2015.0,1921,0,1921
,BG,2000.0,387,0,387
UG,PT,2012.0,1,0,1
,ZM,2013.0,147,0,147
,AT,1999.0,1620,0,1620
PL,,2014.0,1790,0,1790
,CR,2015.0,279,0,279
OM,,2022.0,351,0,351
,PE,1998.0,197,0,197
PE,,2011.0,94,0,94
NG,,2014.0,467,0,467
,SK,1995.0,859,0,859
PK,GR,2013.0,2,0,2
RS,,2016.0,659,0,659
IE,,2004.0,250,0,250
,UA,2003.0,1279,0,1279
,CU,2016.0,425,0,425
,DK,2015.0,2223,0,2223
,LV,2011.0,433,0,433
CM,,2009.0,28,0,28
,LU,1994.0,61,0,61
AZ,,2004.0,12,0,12
SI,,1999.0,42,0,42
AM,,2011.0,61,0,61
,TZ,2010.0,220,0,220
ES,CI,2012.0,1,0,1
,NO,2016.0,1556,0,1556
EE,,2005.0,35,0,35
LY,nan,2004.0,1,0,1
,TJ,2008.0,50,0,50
SJ,,2024.0,38,0,38
TH,MY,2003.0,2,0,2
RE,,2022.0,69,0,69
AZ,GE,2012.0,13,0,13
,PS,2016.0,160,0,160
BJ,,2022.0,270,0,270
,PE,1997.0,200,0,200
MA,,2007.0,152,0,152
CH,VE,2016.0,1,0,1
,BN,2011.0,33,0,33
UA,HU,2000.0,4,0,4
HR,,2004.0,81,0,81
GR,,1999.0,223,0,223
MY,,2006.0,124,0,124
,MD,2012.0,98,0,98
UY,,2005.0,24,0,24
,ZW,2004.0,87,0,87
TR,SG,1997.0,2,0,2
MY,MV,2020.0,3,0,3
,MN,2016.0,121,0,121
GH,TG,2022.0,1,0,1
,NA,1999.0,15,0,15
CO,AZ,2021.0,1,0,1
,TZ,2017.0,313,0,313
CG,NC,2008.0,1,0,1
PR,,2022.0,41,0,41
US,MC,2019.0,2,0,2
GN,BJ,2021.0,1,0,1
,TZ,2019.0,187,0,187
YE,TR,2021.0,2,0,2
CN,BO,1997.0,1,0,1
CR,CH,2021.0,3,0,3
,XK,2005.0,49,0,49
UG,CO,2015.0,1,0,1
,XK,2002.0,16,0,16
,KH,1996.0,21,0,21
,ZW,1996.0,84,0,84
CY,,2021.0,286,0,286
,CY,1996.0,52,0,52
ZA,AZ,2007.0,1,0,1
GE,,2011.0,92,0,92
TH,NO,2010.0,2,0,2
,MG,1994.0,25,0,25
CY,IT,1999.0,2,0,2
LA,,2021.0,50,0,50
MW,FI,2004.0,1,0,1
BW,AE,2001.0,1,0,1
GN,GF,2014.0,1,0,1
MQ,GP,2017.0,2,0,2
ZW,,2025.0,30,0,30
,KH,2004.0,21,0,21
JP,GE,2008.0,2,0,2
AT,HK,2010.0,1,0,1
,CY,2004.0,86,0,86
LA,TH,2010.0,1,0,1
FR,OM,2014.0,3,0,3
GM,TZ,2018.0,2,0,2
ZA,SN,2022.0,2,0,2
,PR,2003.0,21,0,21
SD,PT,2013.0,1,0,1
IL,AE,2022.0,2,0,2
,PF,2014.0,19,0,19
CG,,2008.0,9,0,9
US,AG,2017.0,5,0,5
IN,MZ,2017.0,2,0,2
BR,AF,2020.0,7,0,7
KH,GW,1998.0,3,0,3
AZ,CA,2006.0,2,0,2
JP,UG,2006.0,2,0,2
,MR,2009.0,10,0,10
KH,RU,2020.0,2,0,2
BG,HU,2004.0,1,0,1
CU,IT,2016.0,2,0,2
MC,,2022.0,21,0,21
EE,,2002.0,28,0,28
MK,CY,2012.0,1,0,1
TH,DK,2002.0,1,0,1
BI,,2001.0,2,0,2
CD,,2014.0,18,0,18
PG,AU,2006.0,3,0,3
FR,PS,2009.0,2,0,2
NE,,2006.0,3,0,3
UA,RO,2023.0,2,0,2
IR,SY,2005.0,1,0,1
IS,,1999.0,8,0,8
NP,GM,2016.0,1,0,1
,ST,2010.0,18,0,18
RE,AU,2007.0,1,0,1
,HN,2006.0,14,0,14
NC,DK,2018.0,1,0,1
UA,AZ,2009.0,1,0,1
HK,SY,2014.0,1,0,1
PG,DK,2019.0,1,0,1
GB,BM,2009.0,1,0,1
IQ,SY,2014.0,1,0,1
GF,,2008.0,1,0,1
CD,AZ,2020.0,1,0,1
LS,,2008.0,2,0,2
,CD,2001.0,13,0,13
TW,UA,2004.0,1,0,1
UY,,2002.0,19,0,19
BH,SE,1997.0,1,0,1
CM,ZA,2010.0,3,0,3
US,KZ,2004.0,5,0,5
ME,,2016.0,14,0,14
PY,PT,2000.0,2,0,2
TN,QA,2015.0,5,0,5
PH,AM,2003.0,2,0,2
DE,MZ,2011.0,1,0,1
BW,SE,1998.0,2,0,2
RU,BI,2022.0,1,0,1
NO,ML,2008.0,1,0,1
AU,SI,1999.0,1,0,1
,SJ,2008.0,3,0,3
DK,TZ,2016.0,3,0,3
,MY,2020.0,155,0,155
,LR,2012.0,8,0,8
VN,BY,2021.0,1,0,1
TZ,CY,2022.0,1,0,1
LT,AT,2008.0,1,0,1
,MQ,1998.0,15,0,15
PK,BW,2015.0,1,0,1
LB,IR,2014.0,1,0,1
LU,RW,2011.0,1,0,1
TT,CA,2014.0,2,0,2
NL,TN,2017.0,2,0,2
UG,,2001.0,5,0,5
GN,,2016.0,6,0,6
TR,DZ,2009.0,2,0,2
FJ,BD,2014.0,1,0,1
IE,HU,2021.0,2,0,2
LV,NO,2016.0,3,0,3
PA,CH,2007.0,2,0,2
BR,LA,2017.0,2,0,2
LK,OM,2016.0,3,0,3
TH,DK,2005.0,3,0,3
BE,BF,2010.0,1,0,1
GM,GH,2014.0,1,0,1
CA,BB,2000.0,2,0,2
TW,KP,2006.0,1,0,1
SE,BD,2009.0,3,0,3
JP,MG,2012.0,1,0,1
HU,TH,2014.0,1,0,1
SD,SN,1997.0,1,0,1
GT,RO,2020.0,1,0,1
,MO,2018.0,1,0,1
IT,JO,2001.0,1,0,1
MY,PE,2022.0,1,0,1
BE,SI,1999.0,2,0,2
,MQ,1997.0,3,0,3
AM,MA,2022.0,2,0,2
IS,DK,2023.0,2,0,2
PE,SI,2020.0,3,0,3
JO,DZ,2015.0,1,0,1
MY,BG,2018.0,1,0,1
SE,UY,2021.0,2,0,2
GE,IL,2021.0,1,0,1
CA,ST,2014.0,1,0,1
KR,TZ,2018.0,3,0,3
,ST,2019.0,3,0,3
CL,UA,2015.0,2,0,2
CU,MT,2015.0,1,0,1
JM,MS,2015.0,3,0,3
BR,ET,2019.0,14,0,14
GA,CG,2012.0,1,0,1
LU,KR,2014.0,3,0,3
BA,NZ,2018.0,2,0,2
RO,BH,2012.0,1,0,1
GB,MK,1999.0,2,0,2
MX,MY,2022.0,2,0,2
TZ,BI,2018.0,1,0,1
NZ,AE,1999.0,1,0,1
IN,YE,2007.0,1,0,1
IE,TZ,2010.0,2,0,2
CM,AU,2003.0,1,0,1
HR,IE,2009.0,2,0,2
EC,SE,2022.0,1,0,1
IL,ML,2017.0,1,0,1
NI,,2007.0,3,0,3
GB,PS,2005.0,2,0,2
SY,PS,2018.0,4,0,4
QA,LY,2021.0,1,0,1
GE,FR,2021.0,2,0,2
TH,AE,2004.0,1,0,1
SA,CL,2015.0,1,0,1
GH,ZA,1998.0,2,0,2
IL,MY,2014.0,2,0,2
,LS,2003.0,7,0,7
KR,HR,2017.0,2,0,2
BJ,CH,2020.0,1,0,1
SE,RO,2002.0,2,0,2
CO,VG,2020.0,1,0,1
SY,PK,2016.0,1,0,1
VG,PK,2006.0,1,0,1
IR,MK,2021.0,1,0,1
AE,NP,2020.0,1,0,1
SY,LB,2001.0,2,0,2
PK,LB,2019.0,1,0,1
ME,US,2021.0,2,0,2
KE,EG,2013.0,2,0,2
MD,AT,2002.0,1,0,1
KG,US,2009.0,1,0,1
IL,BG,2014.0,1,0,1
BY,HR,2006.0,1,0,1
GE,HU,2009.0,3,0,3
AL,JP,2016.0,1,0,1
BE,CR,2002.0,1,0,1
TW,SG,2023.0,2,0,2
AM,BR,2021.0,1,0,1
VE,CR,2022.0,2,0,2
MX,GE,2016.0,1,0,1
AT,SG,2022.0,1,0,1
NP,IL,2014.0,1,0,1
ZA,AE,2018.0,4,0,4
AO,PT,2009.0,2,0,2
BA,NO,2016.0,3,0,3
CA,PG,2011.0,1,0,1
IQ,TW,2021.0,3,0,3
MN,NO,2008.0,1,0,1
BN,US,2004.0,1,0,1
FR,TT,2018.0,1,0,1
KZ,VN,2021.0,1,0,1
NG,MY,2006.0,1,0,1
,SC,2011.0,4,0,4
,TG,1994.0,10,0,10
NG,KE,2008.0,3,0,3
SG,KW,2017.0,1,0,1
PA,FR,2002.0,3,0,3
CR,FI,2017.0,1,0,1
CA,GT,2001.0,1,0,1
SD,ET,2016.0,1,0,1
CA,AM,2002.0,1,0,1
nan,SS,2005.0,1,0,1
MT,BR,2014.0,1,0,1
ES,VG,2017.0,1,0,1
AE,BN,2009.0,1,0,1
IN,JO,2005.0,3,0,3
UG,AM,2009.0,1,0,1
BY,IR,2007.0,1,0,1
DE,BN,2013.0,3,0,3
ZM,FR,2018.0,1,0,1
,SL,1999.0,4,0,4
AL,AR,2018.0,2,0,2
CH,IQ,2011.0,1,0,1
BN,,2001.0,8,0,8
BE,ZW,1997.0,1,0,1
IT,BW,2016.0,3,0,3
CA,GM,2008.0,1,0,1
MR,SN,1999.0,1,0,1
CO,CZ,2008.0,1,0,1
GA,US,2019.0,1,0,1
KR,LU,2018.0,1,0,1
NZ,PT,2007.0,1,0,1
BJ,ZA,2016.0,1,0,1
DE,KG,2019.0,3,0,3
SY,HU,2020.0,1,0,1
SA,PL,2011.0,2,0,2
VE,GL,2015.0,1,0,1
AE,IE,2009.0,2,0,2
DZ,ET,2019.0,1,0,1
XK,CA,2018.0,1,0,1
PH,AZ,2018.0,1,0,1
CH,OM,2020.0,1,0,1
SE,EG,2007.0,1,0,1
JO,SD,2006.0,1,0,1
CY,ID,2017.0,2,0,2
JP,LA,2015.0,4,0,4
TH,SK,2013.0,1,0,1
TW,SI,1997.0,2,0,2
SK,HK,2011.0,1,0,1
KR,CY,2005.0,1,0,1
,IM,2012.0,2,0,2
OM,IE,2009.0,1,0,1
TG,,2015.0,8,0,8
HN,JP,1999.0,1,0,1
PG,UY,2013.0,3,0,3
MC,CL,2007.0,1,0,1
UG,BR,2009.0,1,0,1
FR,EE,1997.0,4,0,4
KE,BW,2006.0,1,0,1
SA,UG,2011.0,1,0,1
NO,UY,2018.0,1,0,1
NE,BE,2022.0,1,0,1
KZ,SE,2022.0,1,0,1
FI,ZA,2008.0,4,0,4
NP,BW,2016.0,1,0,1
VG,IN,2009.0,1,0,1
RS,HU,1997.0,1,0,1
ML,NE,2006.0,1,0,1
PH,SY,2012.0,2,0,2
CH,EE,2007.0,5,0,5
UA,KZ,2004.0,1,0,1
ER,CA,2006.0,1,0,1
IE,SK,2011.0,3,0,3
NO,BY,2010.0,1,0,1
AT,UG,2016.0,2,0,2
IT,ML,2009.0,2,0,2
BI,MA,2016.0,1,0,1
BR,PA,2004.0,1,0,1
BB,,2001.0,3,0,3
EE,VN,2020.0,1,0,1
DJ,CA,2018.0,1,0,1
DJ,,2017.0,1,0,1
GE,IN,2013.0,2,0,2
PR,US,2023.0,1,0,1
NL,AM,1999.0,1,0,1
BR,SY,2002.0,1,0,1
ZA,KN,2014.0,1,0,1
RS,AR,2021.0,1,0,1
DK,PE,2018.0,2,0,2
ZW,DE,2021.0,1,0,1
RS,HU,1998.0,2,0,2
JP,LY,2001.0,1,0,1
MN,HU,2011.0,1,0,1
GB,KG,2001.0,1,0,1
HU,TR,1997.0,1,0,1
MY,CL,2023.0,1,0,1
MY,MU,2022.0,1,0,1
MT,CH,2004.0,1,0,1
TN,IE,2020.0,1,0,1
IN,LK,2001.0,3,0,3
DK,MY,2006.0,1,0,1
BY,IT,2007.0,2,0,2
JM,KW,2009.0,1,0,1
CA,HK,2004.0,2,0,2
CN,CI,2002.0,1,0,1
BA,,2003.0,2,0,2
RE,IL,2009.0,1,0,1
PH,NZ,2020.0,5,0,5
SK,CL,2020.0,1,0,1
AU,GM,2015.0,1,0,1
MA,SG,2019.0,1,0,1
,ST,2017.0,5,0,5
BE,LT,2005.0,2,0,2
BO,CA,2013.0,1,0,1
NG,CO,2020.0,1,0,1
DZ,DK,2021.0,1,0,1
CM,CH,2022.0,2,0,2
GT,ES,2023.0,1,0,1
VE,BD,2019.0,1,0,1
SI,NO,2022.0,1,0,1
MG,CH,2006.0,1,0,1
HN,IT,2013.0,1,0,1
CD,GR,2014.0,1,0,1
CM,GB,2005.0,2,0,2
CD,ZA,2007.0,1,0,1
NO,GH,2016.0,1,0,1
,SR,1997.0,1,0,1
LK,SA,2008.0,1,0,1
TH,CD,2018.0,1,0,1
KE,SG,2001.0,1,0,1
GB,LV,2005.0,1,0,1
GT,CR,2010.0,1,0,1
ZW,LS,2015.0,1,0,1
PL,LV,2019.0,2,0,2
AT,LU,2005.0,2,0,2
RO,HK,2023.0,1,0,1
IT,GH,2001.0,1,0,1
PR,SE,2009.0,1,0,1
RE,CM,2001.0,1,0,1
FR,TH,1997.0,1,0,1
EC,CA,2005.0,3,0,3
ID,BD,2008.0,1,0,1
TT,ZA,2016.0,3,0,3
PF,FR,2001.0,6,0,6
IN,AG,2015.0,2,0,2
PH,UG,2021.0,1,0,1
DO,NI,2016.0,1,0,1
IN,BG,2021.0,2,0,2
KR,HR,2010.0,1,0,1
FI,LK,2015.0,1,0,1
ET,LK,2013.0,2,0,2
TW,BG,2008.0,1,0,1
ET,CI,2019.0,3,0,3
AD,,2020.0,4,0,4
EC,AU,2006.0,1,0,1
KR,NP,2003.0,1,0,1
CG,CH,2014.0,2,0,2
AR,RS,2002.0,1,0,1
NI,GB,2011.0,1,0,1
LV,CL,2019.0,1,0,1
IL,PT,2008.0,1,0,1
EC,RW,2019.0,1,0,1
PL,UZ,2019.0,2,0,2
KE,IL,2015.0,1,0,1
MZ,PT,2008.0,1,0,1
NO,AZ,2017.0,1,0,1
ES,VA,2002.0,1,0,1
CH,BO,2008.0,1,0,1
GN,FR,2010.0,2,0,2
BH,IE,2013.0,1,0,1
BW,RW,2019.0,1,0,1
FJ,CA,2011.0,1,0,1
CG,AR,2010.0,1,0,1
ID,ZM,2022.0,2,0,2
ML,GB,2005.0,1,0,1
CW,CA,2017.0,2,0,2
HU,CL,1997.0,1,0,1
WS,,2025.0,1,0,1
AL,ID,2020.0,2,0,2
ET,SA,2013.0,1,0,1
MU,PK,2019.0,1,0,1
MQ,US,2017.0,1,0,1
CF,,2012.0,1,0,1
FR,UG,2006.0,2,0,2
GA,LU,2004.0,1,0,1
EG,TH,2020.0,3,0,3
ST,,2007.0,4,0,4
JP,KG,2017.0,1,0,1
NG,PL,2004.0,1,0,1
UG,FJ,2009.0,1,0,1
BE,ZM,1999.0,1,0,1
SI,TW,2015.0,2,0,2
IS,FI,2014.0,2,0,2
SA,TH,2017.0,1,0,1
MK,IE,2018.0,1,0,1
CO,GR,2021.0,1,0,1
CH,MT,2022.0,1,0,1
PK,CY,2022.0,1,0,1
TW,IE,2002.0,3,0,3
PT,VN,2016.0,1,0,1
AT,SA,2004.0,2,0,2
CR,PE,2004.0,1,0,1
ML,GB,2002.0,1,0,1
IR,LB,2017.0,2,0,2
GR,LK,2016.0,2,0,2
JP,FJ,2020.0,2,0,2
FI,BR,2006.0,1,0,1
NZ,BS,2013.0,1,0,1
UZ,BE,2001.0,1,0,1
AM,NI,2021.0,1,0,1
TW,AE,2013.0,1,0,1
nan,LU,2021.0,1,0,1
nan,RO,2006.0,2,0,2
EG,AF,2014.0,1,0,1
PR,FR,2020.0,2,0,2
LB,CL,2020.0,1,0,1
VN,BN,2018.0,1,0,1
IT,BJ,2018.0,1,0,1
US,PW,2002.0,1,0,1
GH,CG,2005.0,1,0,1
PS,CN,2016.0,1,0,1
CU,YE,2014.0,1,0,1
SE,JO,2004.0,1,0,1
KR,OM,2009.0,1,0,1
IR,ES,2006.0,5,0,5
SK,RO,2010.0,1,0,1
CR,BR,2002.0,1,2,-1
IL,VE,2008.0,1,1,0
BH,US,1998.0,2,6,-4
JP,LU,2006.0,4,1,3
NG,PT,2015.0,1,1,0
AR,BE,2000.0,1,2,-1
MQ,GP,2010.0,1,1,0
SI,AU,2015.0,5,6,-1
PT,FI,2000.0,1,1,0
JP,PT,2007.0,2,3,-1
SI,PL,2011.0,1,3,-2
DE,BF,2015.0,2,1,1
NP,JP,2000.0,1,2,-1
SN,US,2012.0,5,6,-1
EE,LT,2020.0,1,1,0
HR,SK,2009.0,1,1,0
SI,MY,2015.0,1,5,-4
ET,US,1998.0,2,9,-7
GB,MN,2017.0,2,1,1
IE,RU,2003.0,2,4,-2
HU,nan,1998.0,1,1,0
SD,JP,2013.0,1,1,0
CM,ZA,2019.0,7,10,-3
EE,LV,2010.0,1,1,0
NZ,AT,1997.0,2,1,1
RS,KR,2016.0,2,1,1
SD,IR,2018.0,2,3,-1
KR,PH,2006.0,2,3,-1
OM,KW,2007.0,1,1,0
BR,JO,2016.0,1,12,-11
TH,NO,2017.0,2,1,1
YE,SA,2023.0,1,2,-1
NZ,UG,2009.0,1,2,-1
SE,QA,2010.0,1,6,-5
NO,NZ,2014.0,1,6,-5
QA,KW,2015.0,1,3,-2
LU,DK,2010.0,1,1,0
BJ,SN,2011.0,1,2,-1
NP,IN,1998.0,2,6,-4
BR,CU,2002.0,4,4,0
AE,TN,2012.0,1,2,-1
FR,BD,2021.0,4,1,3
NO,SG,2008.0,3,7,-4
LU,DK,2019.0,1,1,0
nan,IQ,2021.0,1,2,-1
GR,KR,2020.0,1,3,-2
LU,DZ,2020.0,1,1,0
VN,XK,2020.0,1,1,0
SA,MA,2018.0,2,12,-10
CO,HU,2014.0,1,1,0
BR,CV,2015.0,1,1,0
PY,PA,2019.0,1,1,0
ID,NL,2003.0,1,3,-2
IL,TW,2004.0,1,2,-1
FI,PT,2007.0,1,2,-1
IS,CA,2022.0,1,1,0
nan,SG,2001.0,1,1,0
CN,AM,2004.0,2,4,-2
IL,CL,2021.0,2,2,0
IQ,IN,2007.0,1,3,-2
MX,PK,2009.0,1,1,0
UG,TH,2018.0,1,1,0
RU,NZ,2021.0,2,3,-1
MA,BE,1999.0,1,3,-2
HU,DK,1997.0,1,3,-2
JP,JO,2022.0,1,3,-2
GB,FK,2009.0,2,2,0
CL,MA,2021.0,1,3,-2
AU,EE,2022.0,3,5,-2
TH,FI,2018.0,1,2,-1
GN,FR,2017.0,2,4,-2
JO,NO,2008.0,1,1,0
LV,EE,2010.0,1,1,0
TR,CY,1999.0,1,2,-1
MQ,GP,2019.0,1,2,-1
MD,TR,2010.0,2,1,1
AL,IT,2012.0,2,4,-2
GB,PS,2002.0,1,1,0
AE,JP,2015.0,1,4,-3
AR,GT,2008.0,1,2,-1
FJ,JP,2021.0,1,1,0
KE,JP,2004.0,1,6,-5
TR,IN,1999.0,1,2,-1
FI,UA,2022.0,1,3,-2
JO,MY,2008.0,1,6,-5
LK,SE,2006.0,2,1,1
VN,CH,2014.0,2,3,-1
ES,PH,2000.0,1,2,-1
LT,HU,2007.0,1,1,0
MZ,ST,2018.0,1,3,-2
RW,CA,2018.0,1,3,-2
DK,MX,1999.0,2,1,1
PT,CY,2015.0,1,1,0
CA,KW,1997.0,2,1,1
CM,IT,2005.0,2,2,0
FO,DK,2012.0,1,2,-1
LB,AR,2019.0,1,1,0
AU,BG,2001.0,1,3,-2
TR,RW,2009.0,1,1,0
GB,NP,1999.0,3,3,0
EE,nan,2019.0,1,4,-3
BG,TR,2008.0,2,1,1
KE,KR,2021.0,1,1,0
BR,ZM,2012.0,1,5,-4
PL,RS,2010.0,1,2,-1
HU,DK,1998.0,1,1,0
DZ,SA,2012.0,5,4,1
AR,RO,2011.0,1,1,0
CN,KW,2020.0,1,2,-1
EE,ZA,2018.0,1,1,0
GH,AU,2012.0,1,2,-1
BY,HU,1997.0,1,2,-1
BG,PT,2013.0,1,1,0
LK,KR,2015.0,3,5,-2
NG,TN,2013.0,1,2,-1
BB,AU,2005.0,1,1,0
LY,DE,2020.0,1,2,-1
CI,KE,2018.0,1,1,0
ES,GR,2006.0,3,8,-5
PL,BD,2013.0,1,4,-3
KR,SK,2012.0,1,2,-1
AZ,DE,2006.0,1,1,0
PA,DE,1999.0,1,1,0
QA,GL,1997.0,1,1,0
EE,LV,2019.0,2,2,0
US,PF,2016.0,1,1,0
TW,IL,2020.0,1,3,-2
HU,NO,2000.0,1,2,-1
nan,EE,2015.0,1,2,-1
EG,TW,2000.0,1,1,0
MX,ID,2013.0,1,1,0
BB,GB,2014.0,2,2,0
RO,AT,2010.0,1,3,-2
IL,MX,2008.0,1,2,-1
HR,CN,2001.0,1,2,-1
HU,TW,2019.0,1,1,0
CR,RU,2021.0,2,3,-1
YE,GB,1997.0,1,1,0
BR,TW,2006.0,2,3,-1
UG,US,2023.0,1,1,0
DO,CR,2018.0,1,1,0
SN,PK,2018.0,1,1,0
OM,ET,2019.0,1,1,0
IR,LB,2019.0,1,1,0
LY,SA,2018.0,1,3,-2
KR,FR,2023.0,1,1,0
CO,RS,2018.0,1,15,-14
KR,HR,2019.0,1,1,0
GB,YE,2000.0,1,1,0
NG,AU,2008.0,1,1,0
SO,GB,2015.0,1,2,-1
BE,IE,2003.0,1,1,0
ER,IN,2019.0,1,2,-1
TZ,KE,2022.0,1,5,-4
AR,ZA,2016.0,1,1,0
LU,FI,2007.0,1,3,-2
AF,IN,2018.0,2,2,0
IN,BW,2001.0,1,1,0
KZ,KR,2010.0,1,1,0
DK,KE,2015.0,1,1,0
LB,GB,2005.0,2,5,-3
PA,ID,2020.0,1,1,0
TW,MY,2004.0,2,1,1
CN,LU,2016.0,2,2,0
NL,NG,2012.0,2,8,-6
LT,NL,2012.0,1,2,-1
MW,ZA,2010.0,2,1,1
ES,SA,2003.0,1,1,0
AZ,UA,2008.0,2,1,1
NO,MK,2007.0,1,1,0
TJ,UA,2016.0,1,2,-1
CL,NL,2004.0,1,2,-1
BE,MW,2014.0,1,2,-1
CA,BO,2003.0,1,1,0
LV,SE,2022.0,1,1,0
BR,RE,2013.0,1,1,0
CU,FR,2011.0,1,4,-3
ZA,EE,2019.0,1,2,-1
BA,ES,2020.0,1,2,-1
DK,LT,1999.0,1,1,0
VN,nan,2016.0,1,4,-3
BN,TH,2002.0,1,0,1
AR,DO,2021.0,2,0,2
TR,BA,2004.0,2,0,2
EG,BN,2014.0,1,0,1
IR,LK,2019.0,1,0,1
CR,PY,2003.0,1,0,1
ET,SY,2013.0,1,0,1
BN,TH,2005.0,1,0,1
UG,CM,2014.0,1,0,1
IE,JM,2020.0,1,0,1
BS,CA,2021.0,1,0,1
BY,NG,2018.0,2,0,2
PA,IR,2020.0,1,0,1
BW,CZ,2018.0,1,0,1
BG,NG,2006.0,1,0,1
IR,CM,2012.0,1,0,1
MW,NL,2010.0,1,0,1
VE,PR,2015.0,1,0,1
PT,SV,2018.0,1,0,1
CO,CV,2019.0,1,0,1
CN,BY,2009.0,1,0,1
FI,GD,2017.0,1,0,1
MA,GA,2014.0,3,0,3
HR,PE,2018.0,1,0,1
EE,nan,2010.0,1,0,1
CY,NO,2015.0,1,0,1
SI,GT,2016.0,1,0,1
KH,MG,2011.0,1,0,1
TJ,,2006.0,3,0,3
ES,ZW,2007.0,1,0,1
PH,GR,2006.0,1,0,1
SJ,IS,2003.0,1,0,1
BN,IT,2019.0,1,0,1
KR,TJ,2022.0,1,0,1
NP,CN,2023.0,1,0,1
CM,nan,2006.0,1,0,1
GH,NO,2007.0,1,0,1
BB,CH,2002.0,1,0,1
RU,BE,2023.0,1,0,1
LB,AR,2017.0,1,0,1
UZ,nan,2010.0,1,0,1
NE,MA,2015.0,1,0,1
MZ,GE,2012.0,1,0,1
CG,CD,2020.0,2,0,2
MV,MY,2017.0,1,0,1
ET,IL,2020.0,1,0,1
TR,BW,2017.0,1,0,1
JP,MD,2005.0,1,0,1
HT,BE,2018.0,2,0,2
,SR,1998.0,1,0,1
CA,ET,2003.0,1,0,1
DK,BI,2012.0,1,0,1
AT,UZ,2013.0,1,0,1
UY,ZA,2010.0,1,0,1
LT,KZ,2019.0,1,0,1
IL,GE,2014.0,1,0,1
GL,,2006.0,1,0,1
DJ,,2019.0,2,0,2
MK,DK,2003.0,1,0,1
FJ,ES,2016.0,1,0,1
GA,,2006.0,1,0,1
US,BS,2000.0,1,0,1
BJ,GE,2001.0,1,0,1
CL,PL,2022.0,3,0,3
GE,MZ,2010.0,1,0,1
SA,ID,2007.0,1,0,1
SA,NO,2009.0,1,0,1
SN,CG,2003.0,1,0,1
GR,NZ,2012.0,1,0,1
DE,KW,2014.0,2,0,2
GP,DZ,2007.0,1,0,1
SK,MX,2007.0,1,0,1
CD,US,2004.0,1,0,1
ST,US,2005.0,2,0,2
UZ,ET,2015.0,2,0,2
MO,AU,2017.0,1,0,1
PL,CG,2007.0,1,0,1
CU,RO,2019.0,1,0,1
BH,SO,2022.0,1,0,1
CY,ID,2019.0,1,0,1
,DE,2021.0,2,0,2
BG,SA,2008.0,1,0,1
IN,NE,2019.0,1,0,1
MT,PL,2007.0,1,0,1
BO,CR,2012.0,1,0,1
US,CV,2015.0,1,0,1
AR,SV,2020.0,1,0,1
CO,GM,2012.0,1,0,1
NO,BY,2017.0,1,0,1
TZ,AU,2007.0,1,0,1
TR,KW,1999.0,1,0,1
IT,GE,2008.0,2,0,2
AU,VG,2022.0,1,0,1
FI,GD,2010.0,1,0,1
GM,NL,2004.0,1,0,1
GB,LS,2013.0,1,0,1
ZM,BD,2014.0,2,0,2
BI,ZA,2017.0,1,0,1
GT,CZ,2017.0,1,0,1
BY,,2026.0,1,0,1
ET,CI,2010.0,1,0,1
MD,BE,2003.0,1,0,1
US,LR,2002.0,1,0,1
ES,SG,2023.0,1,0,1
QA,MY,2007.0,1,0,1
nan,PH,2007.0,1,0,1
MD,CA,2017.0,1,0,1
GH,BO,2015.0,1,0,1
BD,CH,2004.0,1,0,1
MA,JO,2013.0,1,0,1
EG,TR,2001.0,1,0,1
ER,NL,2009.0,1,0,1
TW,RS,2001.0,1,0,1
KR,CO,2005.0,2,0,2
LB,CU,2013.0,1,0,1
BA,IQ,2010.0,1,0,1
MX,AF,1999.0,1,0,1
CL,HR,2015.0,1,0,1
MA,ML,2004.0,1,0,1
CH,BF,2013.0,1,0,1
SM,CH,2001.0,1,0,1
HR,KH,2020.0,1,0,1
GF,RE,2018.0,1,0,1
MK,CN,2015.0,1,0,1
PT,KW,2015.0,1,0,1
KW,OM,2022.0,1,0,1
GH,SA,2019.0,1,0,1
SA,NP,2021.0,1,0,1
GA,NZ,2013.0,1,0,1
KH,LK,2001.0,1,0,1
BG,KR,2018.0,1,0,1
AG,SA,2013.0,1,0,1
PF,NZ,2012.0,1,0,1
GH,DK,2004.0,1,0,1
LB,CH,2006.0,1,0,1
NO,BA,2005.0,1,0,1
PY,NI,2020.0,1,0,1
AR,LB,2013.0,1,0,1
LU,BF,2008.0,1,0,1
NO,BY,2019.0,1,0,1
PS,AT,2010.0,1,0,1
ZW,CN,2011.0,1,0,1
EE,PT,2011.0,1,0,1
MY,KH,2020.0,1,0,1
SO,CH,2019.0,1,0,1
FR,CV,2013.0,1,0,1
PL,SA,2021.0,1,0,1
AZ,RS,2009.0,1,0,1
SA,PS,2023.0,1,0,1
FR,LA,2022.0,1,0,1
QA,SR,2020.0,1,0,1
ZA,IL,2007.0,1,0,1
BY,BE,2010.0,1,0,1
SS,NP,2011.0,1,0,1
MS,US,2001.0,1,0,1
SA,BN,2022.0,1,0,1
FR,EC,2006.0,1,0,1
TR,SD,2000.0,1,0,1
CY,EC,2019.0,1,0,1
BE,CI,2016.0,1,0,1
BB,CH,2005.0,1,0,1
MD,UA,2022.0,1,0,1
TT,SA,2021.0,1,0,1
HU,NG,2015.0,2,0,2
BR,CG,2011.0,1,0,1
TR,CI,2021.0,1,0,1
CN,VN,1997.0,1,0,1
PT,PA,2019.0,1,0,1
MZ,TZ,2021.0,1,0,1
BM,GB,2013.0,1,0,1
HU,TR,1998.0,1,0,1
MM,IR,2013.0,1,0,1
DZ,CH,2001.0,1,0,1
AF,,2009.0,1,0,1
NZ,VN,2010.0,1,0,1
IL,CU,2006.0,1,0,1
TZ,EG,2015.0,1,0,1
MT,RU,2007.0,1,0,1
NE,CA,2004.0,1,0,1
CD,KE,2021.0,1,0,1
TH,GH,2016.0,1,0,1
SA,TN,1999.0,1,0,1
ET,TW,2023.0,2,0,2
UG,ZM,2000.0,1,0,1
IN,JO,2002.0,1,0,1
ST,MZ,2008.0,1,0,1
QA,KZ,2019.0,1,0,1
AR,HU,2006.0,1,0,1
UG,CD,2012.0,1,0,1
IS,SA,2021.0,1,0,1
IE,TZ,2017.0,2,0,2
MN,AE,2010.0,1,0,1
LB,BG,2019.0,1,0,1
NG,CH,2010.0,1,0,1
TG,NE,2018.0,1,0,1
ID,ZW,2021.0,1,0,1
US,MC,2010.0,2,0,2
DE,NE,2005.0,1,0,1
GT,CR,2017.0,1,0,1
BH,ZM,2016.0,1,0,1
JO,CZ,2015.0,1,0,1
SG,KW,2019.0,1,0,1
LT,LV,2006.0,1,0,1
BE,TH,2008.0,1,0,1
PL,LV,2010.0,1,0,1
MX,MA,2016.0,1,0,1
IT,MC,1998.0,1,0,1
CR,nan,2023.0,1,0,1
SD,EG,2023.0,1,0,1
CM,BI,2003.0,1,0,1
NO,CM,2021.0,1,0,1
LB,BA,2021.0,1,0,1
BW,ZM,2016.0,1,0,1
MY,SK,2018.0,1,0,1
HT,,2015.0,1,0,1
GP,IT,2018.0,1,0,1
AR,NG,2015.0,1,0,1
BJ,NL,2022.0,1,0,1
DE,MW,2000.0,1,0,1
BY,HU,1998.0,1,0,1
MS,,2021.0,1,0,1
FI,US,2006.0,124,166,-42
IT,GB,2015.0,707,503,204
SG,AU,2010.0,75,86,-11
US,CA,2001.0,1733,1974,-241
nan,BR,2016.0,113,107,6
US,CN,2007.0,7096,4531,2565
DE,IL,2017.0,65,74,-9
BR,ES,2020.0,376,381,-5
CN,US,2021.0,4053,5667,-1614
CH,IT,2012.0,172,308,-136
US,KR,2015.0,1257,1170,87
CN,GB,2014.0,432,591,-159
US,HU,2004.0,111,80,31
US,FR,2006.0,1145,1223,-78
GB,FR,2002.0,292,335,-43
US,NZ,1999.0,129,156,-27
LB,EG,2018.0,14,23,-9
US,FI,2003.0,96,112,-16
DK,JP,2003.0,9,16,-7
KR,NG,2022.0,11,10,1
HU,ES,2006.0,6,3,3
ES,SK,2012.0,2,1,1
PT,CA,2014.0,19,21,-2
SA,MY,2014.0,24,59,-35
US,TW,2001.0,554,444,110
GB,IT,2001.0,199,241,-42
EG,LB,2015.0,13,17,-4
TH,US,2011.0,126,217,-91
CL,BR,2013.0,89,69,20
VE,MX,2013.0,47,27,20
CN,NZ,2015.0,43,45,-2
JP,GB,2011.0,240,270,-30
US,IT,2013.0,945,1081,-136
NL,BE,2002.0,126,151,-25
FR,GB,2003.0,363,332,31
CU,CO,2022.0,11,7,4
PT,BR,2022.0,562,1031,-469
GB,SE,2008.0,143,154,-11
UZ,FR,2017.0,2,1,1
AU,CA,2002.0,178,142,36
US,KE,2002.0,22,21,1
CN,KR,2014.0,275,301,-26
JP,PH,2005.0,13,12,1
SN,FR,2017.0,36,36,0
US,BR,2020.0,1295,1461,-166
BE,US,2000.0,163,129,34
PK,SA,2016.0,95,84,11
SG,US,2013.0,366,418,-52
EC,MX,2018.0,99,152,-53
DE,IE,2004.0,46,29,17
SA,PK,2018.0,115,113,2
UY,PT,2013.0,10,3,7
AU,CA,2005.0,224,231,-7
SA,EG,2014.0,287,298,-11
VE,ES,2015.0,84,59,25
CO,SE,2014.0,8,5,3
NO,SE,2010.0,66,118,-52
BE,FR,2018.0,355,380,-25
DK,US,2008.0,179,302,-123
CH,NL,2011.0,65,88,-23
LU,FR,2016.0,40,45,-5
DE,DK,2004.0,63,64,-1
TN,DE,2009.0,6,2,4
JP,KR,2013.0,435,306,129
CA,CN,2006.0,385,282,103
CA,IN,2015.0,221,219,2
TN,FR,2009.0,130,166,-36
AU,CL,2012.0,11,10,1
CO,US,2009.0,179,189,-10
IN,GB,2000.0,125,106,19
GB,SG,2003.0,58,42,16
US,MX,2000.0,155,157,-2
NL,ES,2003.0,40,32,8
FI,SE,2011.0,71,82,-11
JP,GR,2010.0,39,59,-20
GR,GB,2009.0,156,179,-23
CU,ES,2014.0,105,77,28
GB,FR,2005.0,320,355,-35
NG,KR,2014.0,9,12,-3
JP,TW,2011.0,74,73,1
IN,IR,2012.0,43,16,27
CN,SG,2000.0,114,85,29
DK,IE,2016.0,10,12,-2
MX,CA,2004.0,15,23,-8
HU,US,2007.0,106,130,-24
HR,BA,2012.0,32,15,17
NO,SE,2019.0,101,123,-22
BD,US,2016.0,152,120,32
NL,CL,2017.0,13,18,-5
GB,CA,2023.0,23,26,-3
CN,FR,2018.0,161,211,-50
IT,CA,2000.0,51,45,6
NL,BE,2005.0,133,162,-29
CH,CL,2016.0,19,14,5
NO,IR,2012.0,9,22,-13
SE,FR,2018.0,79,111,-32
CH,FI,2022.0,15,21,-6
GR,IE,2005.0,4,3,1
PE,AR,2014.0,42,41,1
MY,nan,2018.0,89,58,31
GB,KR,2016.0,90,94,-4
EG,SA,2021.0,413,348,65
RU,VN,2018.0,17,8,9
MX,CL,2012.0,146,155,-9
CH,IN,2018.0,65,71,-6
NO,FR,2013.0,62,65,-3
KW,AE,2005.0,3,2,1
CA,BR,1997.0,33,22,11
GB,PT,2020.0,90,96,-6
JP,SK,2001.0,24,17,7
CN,MY,2009.0,33,24,9
GR,PK,2012.0,2,1,1
DE,SG,2019.0,34,43,-9
CU,PE,2018.0,13,15,-2
US,EG,2008.0,146,88,58
DZ,QA,2020.0,4,2,2
IT,IN,2005.0,50,41,9
IN,CH,2005.0,15,9,6
SI,SK,2014.0,10,3,7
GB,UA,2014.0,16,9,7
XK,MK,2017.0,3,3,0
SE,DE,2007.0,131,142,-11
NL,CH,2020.0,155,122,33
nan,RU,2009.0,54,69,-15
BR,CN,2011.0,45,52,-7
AE,EG,2018.0,50,44,6
FR,DZ,2019.0,210,136,74
CA,JP,2020.0,116,74,42
MY,FR,2011.0,8,10,-2
DE,IL,2019.0,78,86,-8
BR,VE,2011.0,8,11,-3
AR,CO,2022.0,44,55,-11
FI,FR,2020.0,32,34,-2
GB,MY,2021.0,87,88,-1
PK,US,1997.0,20,17,3
MX,SI,2009.0,1,1,0
RS,DE,2007.0,13,20,-7
CA,NL,2004.0,45,49,-4
BE,ES,2002.0,29,13,16
PH,US,2013.0,469,397,72
PK,CN,2003.0,49,25,24
KZ,CN,2007.0,19,8,11
EC,CO,2009.0,10,2,8
CN,IE,2012.0,43,48,-5
CN,RU,2007.0,28,52,-24
BD,CA,2009.0,18,11,7
MM,US,2009.0,3,2,1
PK,JP,2010.0,7,13,-6
ID,PK,2014.0,20,16,4
KR,CN,2022.0,170,212,-42
CN,TH,2021.0,60,47,13
TG,FR,2009.0,1,2,-1
IR,CN,2020.0,90,41,49
GR,JP,2017.0,23,29,-6
BY,DE,2014.0,7,4,3
DE,NO,2013.0,106,56,50
FR,ZA,2022.0,16,21,-5
CA,KR,2013.0,64,51,13
GB,HU,2002.0,27,18,9
RU,DE,2012.0,146,175,-29
FI,AU,2018.0,22,26,-4
ES,CN,2004.0,24,21,3
nan,BE,2008.0,21,21,0
MK,CN,2004.0,8,2,6
CO,VE,2007.0,13,28,-15
PH,SA,2013.0,3,1,2
NO,SE,2017.0,91,99,-8
RU,IR,2006.0,13,5,8
PT,ES,2016.0,176,218,-42
IE,US,2009.0,370,495,-125
SG,AU,2019.0,161,162,-1
AU,SG,2021.0,122,94,28
TN,MA,2001.0,2,1,1
GB,BE,2022.0,96,93,3
RU,FR,2012.0,68,68,0
CL,DE,2021.0,56,30,26
GR,VN,2001.0,5,3,2
BE,IN,2020.0,54,45,9
SA,US,2009.0,50,107,-57
JP,NO,2020.0,6,14,-8
LV,DE,2011.0,3,4,-1
IE,SE,2019.0,13,20,-7
CA,FI,2022.0,20,11,9
IT,AT,2012.0,49,43,6
nan,JP,2016.0,55,53,2
UG,CA,2012.0,3,1,2
LK,CA,2009.0,1,2,-1
NL,GB,2004.0,175,151,24
AT,FR,2008.0,36,43,-7
VE,DE,1997.0,2,1,1
PK,ID,2014.0,16,20,-4
JP,CA,2003.0,111,82,29
EG,JP,2021.0,42,46,-4
AU,QA,2021.0,9,9,0
US,KZ,2015.0,30,16,14
CZ,GB,2015.0,54,48,6
PK,IN,2011.0,121,127,-6
PT,IT,2011.0,21,36,-15
HU,DE,2021.0,47,38,9
SA,NG,2016.0,10,10,0
US,JO,2021.0,49,68,-19
IN,DK,2016.0,24,22,2
VN,JP,2020.0,46,73,-27
JP,ES,2020.0,32,31,1
PK,IT,2021.0,18,10,8
PL,JP,2018.0,18,14,4
ES,CH,2009.0,58,68,-10
BE,PL,2006.0,16,10,6
BR,IR,2016.0,22,12,10
NL,CL,2019.0,9,19,-10
EG,FR,2015.0,21,36,-15
HR,DE,2003.0,23,11,12
PL,US,2002.0,143,141,2
BR,CA,2022.0,261,109,152
nan,IN,2014.0,63,75,-12
PL,US,2005.0,197,166,31
GR,JP,2010.0,59,39,20
FR,CI,1999.0,4,4,0
ET,CN,2019.0,18,17,1
CZ,DE,2018.0,84,82,2
MD,GB,2018.0,4,2,2
PE,PH,2018.0,6,5,1
SE,SG,2016.0,18,18,0
DE,EE,2008.0,44,25,19
US,DK,2001.0,174,171,3
MX,PT,2020.0,31,13,18
MY,BN,2020.0,22,8,14
FI,CN,2018.0,31,32,-1
US,MW,2000.0,4,3,1
TH,TR,2018.0,4,1,3
RS,HR,2018.0,156,143,13
ES,GT,2016.0,14,12,2
LK,IN,2022.0,6,10,-4
EG,IR,2022.0,4,8,-4
IR,MA,2021.0,6,2,4
KW,SA,2021.0,24,23,1
ES,TR,2020.0,21,9,12
BE,NL,2003.0,130,108,22
AT,RO,2017.0,12,10,2
DE,KE,2010.0,13,9,4
CO,KE,2018.0,7,7,0
EE,SE,2020.0,9,14,-5
GB,PK,2018.0,207,137,70
DE,HU,1998.0,22,31,-9
CZ,UA,2015.0,21,21,0
AU,IQ,2021.0,23,12,11
TN,IR,2017.0,9,9,0
SA,SD,2021.0,29,40,-11
EC,PE,2022.0,18,13,5
DE,NL,2001.0,182,117,65
SG,CL,2020.0,2,1,1
CA,IT,2015.0,86,167,-81
DE,SG,2010.0,37,33,4
NA,ZA,2021.0,5,14,-9
FI,IE,2016.0,10,6,4
PS,JO,2018.0,9,12,-3
VN,US,2007.0,29,30,-1
CN,SA,2013.0,22,12,10
MX,SE,2018.0,14,13,1
MA,MX,2020.0,3,1,2
AR,DK,2014.0,4,1,3
KE,ZA,2020.0,34,49,-15
FR,DZ,2010.0,96,69,27
TR,RU,2007.0,3,4,-1
TH,TW,2013.0,5,4,1
JP,LK,2022.0,16,4,12
XK,US,2017.0,1,2,-1
NO,PK,2017.0,12,7,5
RU,RO,2008.0,4,2,2
LK,JP,2007.0,11,17,-6
EC,AR,2021.0,34,38,-4
nan,NO,2019.0,43,18,25
CN,KZ,2020.0,9,14,-5
PH,ES,2015.0,16,25,-9
ZA,DE,2022.0,23,31,-8
IE,SA,2012.0,7,1,6
KN,JP,2018.0,1,2,-1
US,VN,2007.0,30,29,1
JP,IT,2021.0,36,38,-2
ZA,NZ,2022.0,18,9,9
SA,IE,2018.0,5,10,-5
NL,SG,2014.0,24,9,15
PK,QA,2021.0,18,14,4
CH,nan,2020.0,10,21,-11
MK,AT,2018.0,16,12,4
RU,MY,2022.0,21,1,20
MD,TN,2018.0,2,2,0
PH,CA,2021.0,9,6,3
TR,BD,2022.0,2,3,-1
CL,AU,2002.0,1,3,-2
NL,TR,2021.0,30,29,1
DZ,MN,2021.0,5,1,4
US,JP,2009.0,1943,1812,131
GB,KZ,2019.0,8,4,4
OM,IN,2008.0,5,5,0
MA,FR,2009.0,207,228,-21
BE,AU,2020.0,52,43,9
JP,MA,1999.0,1,1,0
SK,NO,2018.0,3,4,-1
CH,ID,2021.0,5,4,1
CO,NL,2018.0,13,19,-6
IE,ID,2020.0,5,4,1
CA,AE,2019.0,35,28,7
IE,IQ,2017.0,3,2,1
US,CL,2008.0,151,128,23
ES,GB,2015.0,551,361,190
FR,PL,2009.0,42,47,-5
GB,CZ,2011.0,44,40,4
FR,DZ,2017.0,193,98,95
AT,CH,2004.0,54,48,6
CH,IS,2018.0,3,5,-2
TZ,RU,2014.0,2,2,0
NO,KR,2013.0,5,6,-1
NL,CL,2010.0,3,5,-2
FR,RO,2012.0,57,38,19
MX,IT,2001.0,13,15,-2
CH,IL,2018.0,28,25,3
SI,AT,2011.0,13,7,6
US,IS,2005.0,14,14,0
US,HT,2014.0,2,2,0
LB,IN,2018.0,7,9,-2
IR,SE,2002.0,1,3,-2
TR,FR,2008.0,23,17,6
MX,SG,2008.0,6,8,-2
SG,MX,2009.0,5,7,-2
MZ,PL,2015.0,25,13,12
PT,MX,2015.0,26,22,4
AT,GR,2015.0,7,10,-3
DK,NL,1999.0,13,18,-5
PT,GB,2013.0,98,90,8
FI,CZ,2013.0,9,13,-4
PK,BD,2011.0,26,25,1
CM,MY,2018.0,2,3,-1
AT,SI,2020.0,9,11,-2
RU,NL,2000.0,21,14,7
NO,PK,2010.0,2,1,1
DE,KE,2017.0,19,14,5
NZ,DE,2011.0,38,38,0
AU,RU,2013.0,20,40,-20
RO,ES,2012.0,10,16,-6
CA,AE,2010.0,20,4,16
BO,ES,2012.0,11,12,-1
CZ,IT,2006.0,12,15,-3
BF,FR,1997.0,3,2,1
CN,PT,2002.0,16,8,8
ES,BR,2023.0,19,15,4
GB,SK,2014.0,15,27,-12
GB,HR,2020.0,13,24,-11
EG,IQ,2016.0,33,18,15
ST,BR,2006.0,29,20,9
BD,nan,2014.0,3,4,-1
IR,AT,2011.0,10,8,2
MD,RO,2019.0,11,22,-11
CZ,NL,2007.0,9,11,-2
NL,LT,2012.0,2,1,1
ZA,CA,2009.0,26,34,-8
BE,CA,2013.0,60,68,-8
DE,SG,2017.0,38,38,0
TH,NZ,2017.0,7,6,1
HU,PL,2003.0,7,3,4
FJ,GB,2020.0,1,3,-2
GL,DK,2013.0,5,1,4
PL,RU,2012.0,22,15,7
MY,NZ,2010.0,9,11,-2
AE,CZ,2014.0,1,1,0
LV,RU,2012.0,22,26,-4
IR,IL,2021.0,2,3,-1
JP,BE,2004.0,16,11,5
MQ,FR,2016.0,12,15,-3
SN,FR,2019.0,40,60,-20
AU,JP,2009.0,53,70,-17
US,CU,1997.0,4,12,-8
CL,FR,2009.0,26,27,-1
SE,GR,2017.0,9,30,-21
EG,KR,2010.0,5,5,0
IT,BE,2008.0,87,93,-6
FR,IN,2008.0,59,128,-69
MY,NZ,2019.0,21,12,9
GH,NL,2017.0,3,3,0
KE,DE,2015.0,8,16,-8
GR,SE,2005.0,2,9,-7
PT,IN,2013.0,14,16,-2
DE,KE,2019.0,19,13,6
US,NE,2004.0,2,1,1
AZ,TR,2012.0,6,1,5
ES,IN,2012.0,19,29,-10
CA,AE,2017.0,30,21,9
PH,BD,2019.0,1,3,-2
RS,RU,1998.0,2,5,-3
RS,SK,2014.0,8,5,3
CO,CN,2015.0,4,3,1
PT,AU,2015.0,16,14,2
CN,NL,2000.0,23,22,1
IL,DE,2001.0,38,33,5
US,VE,2011.0,35,49,-14
GR,FR,1997.0,11,8,3
FR,MY,2015.0,11,8,3
MY,AU,2004.0,10,12,-2
MW,GB,2008.0,12,9,3
AR,EC,2022.0,16,19,-3
CH,BE,2023.0,3,4,-1
GW,DK,2000.0,2,1,1
RU,AZ,2004.0,5,6,-1
DE,JO,2012.0,19,9,10
TW,GB,2011.0,57,71,-14
nan,HR,2010.0,3,5,-2
RO,HU,2002.0,35,6,29
NO,CN,2016.0,34,28,6
FR,HK,2014.0,2,1,1
ZM,US,1997.0,1,2,-1
UA,GB,2017.0,12,17,-5
DE,UA,2006.0,25,40,-15
JP,NL,2020.0,38,30,8
SN,FR,2010.0,27,25,2
EG,TN,2017.0,17,22,-5
CN,HU,2011.0,5,4,1
BJ,MA,2019.0,1,2,-1
KR,PK,2013.0,15,18,-3
DE,EG,2011.0,51,29,22
BG,RU,2000.0,9,7,2
IT,TW,2007.0,2,2,0
RO,DE,2002.0,23,9,14
IE,BR,2017.0,13,18,-5
LK,CN,2018.0,6,11,-5
CN,UA,2020.0,34,28,6
NO,PK,2019.0,8,6,2
FR,VN,2008.0,12,7,5
AU,AE,2018.0,20,8,12
TG,GH,2017.0,3,1,2
SK,HR,2017.0,12,3,9
UA,GB,2019.0,15,21,-6
UZ,ID,2021.0,2,4,-2
CN,DK,2023.0,20,6,14
PL,ES,2004.0,7,6,1
CO,NI,2014.0,8,5,3
UG,KE,2020.0,22,17,5
JO,CN,2019.0,3,3,0
AU,TW,2021.0,35,29,6
JP,RO,2011.0,7,4,3
NZ,KR,2020.0,10,9,1
ET,GB,2016.0,8,14,-6
BR,KE,2021.0,1,4,-3
IR,SG,2006.0,1,1,0
NL,HU,2012.0,10,17,-7
SN,NE,2016.0,3,1,2
MW,UG,2019.0,2,3,-1
PH,KR,2018.0,10,7,3
PS,ES,2021.0,15,11,4
BE,JP,2004.0,11,16,-5
TW,SE,2005.0,2,2,0
JP,NP,2009.0,12,8,4
AT,KR,2010.0,8,2,6
UA,KZ,2015.0,3,2,1
US,PH,1999.0,161,180,-19
ES,SI,2012.0,16,9,7
US,CY,2018.0,19,16,3
CO,NZ,2012.0,1,2,-1
BD,MY,2018.0,55,69,-14
BE,ES,2005.0,34,28,6
IE,BE,2016.0,14,10,4
FI,AT,2014.0,13,4,9
FR,CZ,2008.0,30,18,12
CH,RS,2011.0,7,8,-1
FR,IE,2004.0,15,17,-2
GH,NL,2019.0,6,5,1
PK,MY,2008.0,7,11,-4
IR,GB,2003.0,20,47,-27
CD,US,2015.0,4,3,1
TW,SE,2002.0,3,1,2
AU,IE,2007.0,79,73,6
IR,EG,2014.0,10,10,0
BE,nan,2021.0,15,11,4
CA,BD,2012.0,32,31,1
PK,IE,2019.0,12,25,-13
NO,NL,2014.0,22,38,-16
NO,CZ,2005.0,3,12,-9
DE,CZ,2023.0,3,3,0
PE,SE,2016.0,2,3,-1
GR,AE,2018.0,12,2,10
RO,HU,2005.0,21,31,-10
PL,ZA,2017.0,4,3,1
GB,GM,2006.0,15,8,7
ES,IR,2013.0,11,14,-3
CA,ES,2008.0,56,57,-1
HU,SE,2009.0,20,10,10
PL,HU,2000.0,8,5,3
AU,BE,2004.0,18,23,-5
TR,RS,2004.0,47,46,1
RU,TR,2016.0,3,5,-2
AT,NO,2009.0,5,2,3
DK,CO,2007.0,1,1,0
PL,IL,2021.0,12,8,4
US,KE,2005.0,29,32,-3
DE,HU,1997.0,20,18,2
TR,PL,2006.0,1,1,0
FR,RE,2008.0,18,17,1
IE,SE,2010.0,20,11,9
nan,NO,2017.0,26,21,5
CA,BR,1998.0,46,35,11
MY,CN,2004.0,17,9,8
CZ,DK,2014.0,11,3,8
PL,CH,1999.0,8,13,-5
BE,HU,2011.0,8,13,-5
TW,NP,2021.0,3,1,2
ET,KE,2005.0,3,2,1
ZA,CH,2001.0,6,7,-1
TT,GB,2016.0,5,7,-2
TR,DK,2021.0,17,6,11
RO,DE,2005.0,30,27,3
HR,US,2000.0,17,16,1
KE,JP,2015.0,2,11,-9
GR,IT,2019.0,38,43,-5
HU,JP,2002.0,11,12,-1
CZ,HR,2022.0,5,3,2
BG,CA,2006.0,5,1,4
EG,IT,2005.0,5,1,4
RS,TR,2018.0,67,8,59
NI,UA,2018.0,14,11,3
VE,CA,2021.0,4,1,3
RS,RU,1997.0,1,1,0
CH,EE,2008.0,5,1,4
GB,AF,2017.0,1,1,0
CL,CZ,2016.0,4,1,3
IT,HU,2012.0,10,7,3
IN,GR,2016.0,5,2,3
PT,IE,2013.0,5,7,-2
IN,ES,2018.0,23,33,-10
IL,CH,2004.0,18,5,13
DZ,CA,2015.0,9,15,-6
CH,ZA,2001.0,7,6,1
OM,DE,2012.0,3,3,0
TR,CZ,2010.0,6,5,1
MD,MA,2012.0,4,5,-1
MY,NZ,2017.0,20,21,-1
PH,AU,2006.0,11,6,5
DE,PE,2019.0,11,12,-1
BE,AR,2011.0,5,1,4
DE,AR,1999.0,9,15,-6
SG,BN,2021.0,2,1,1
BF,FR,1998.0,4,5,-1
ID,KW,2021.0,2,4,-2
IN,FI,2005.0,4,3,1
RU,LU,2014.0,1,1,0
SK,US,1998.0,15,20,-5
CR,CL,2011.0,15,13,2
JM,TT,2009.0,8,13,-5
US,CU,1998.0,11,7,4
PT,CH,2022.0,20,21,-1
SY,FR,2011.0,4,16,-12
CN,PH,2006.0,10,25,-15
CL,AU,2005.0,1,4,-3
BR,JP,2003.0,12,38,-26
TW,AU,2015.0,51,40,11
MQ,GB,2001.0,1,1,0
JP,PH,2002.0,14,14,0
GD,GB,2020.0,2,1,1
PK,US,1998.0,28,35,-7
NZ,nan,2016.0,4,4,0
PH,DK,2011.0,2,1,1
JP,TN,2006.0,2,1,1
CL,BO,2014.0,13,4,9
ST,PT,2010.0,2,3,-1
GR,ES,2009.0,12,8,4
AT,KR,2019.0,7,5,2
CY,GB,2001.0,4,4,0
ES,BD,2018.0,16,11,5
FR,KR,2004.0,15,20,-5
NL,MY,2009.0,4,2,2
ZA,HK,2020.0,1,1,0
RS,CN,2021.0,3,6,-3
ES,NI,2016.0,8,8,0
CH,BR,2008.0,23,28,-5
TW,IT,2015.0,3,6,-3
IE,nan,2014.0,3,3,0
KR,BE,2018.0,21,13,8
nan,DK,2007.0,14,19,-5
GB,TZ,2016.0,17,17,0
DE,VE,2005.0,3,6,-3
ZA,NA,2009.0,2,1,1
RU,SK,2005.0,8,6,2
BJ,NG,2014.0,5,1,4
BR,CZ,2014.0,8,4,4
PL,IT,2002.0,14,11,3
NZ,FI,2018.0,3,6,-3
PS,CH,2014.0,1,1,0
UA,nan,2010.0,19,17,2
BA,AU,2013.0,1,1,0
GB,ID,2013.0,31,27,4
SE,GR,2019.0,20,35,-15
PK,SG,2014.0,5,1,4
RS,AT,2014.0,11,8,3
CM,CN,2018.0,7,6,1
LY,EG,2012.0,2,3,-1
RO,GB,2004.0,10,5,5
EG,IT,2002.0,5,1,4
SA,PT,2014.0,1,5,-4
VN,SG,2011.0,3,6,-3
BD,IT,2022.0,3,1,2
PE,VE,2013.0,8,14,-6
TR,CZ,2019.0,7,7,0
IT,KR,2013.0,10,7,3
TW,ET,2021.0,10,5,5
EE,FI,1997.0,6,1,5
SA,GB,2009.0,27,56,-29
JO,GB,2014.0,12,23,-11
nan,NO,2010.0,37,35,2
UA,PL,2000.0,9,8,1
UA,GB,2010.0,14,7,7
IN,CH,2002.0,15,9,6
LB,FR,2007.0,20,34,-14
ZW,FR,2019.0,3,1,2
PR,VN,2006.0,1,3,-2
SV,PE,2019.0,8,1,7
CA,PL,2011.0,33,34,-1
FR,BI,2001.0,6,13,-7
CN,AZ,2018.0,8,1,7
IT,NP,2018.0,4,2,2
NL,RS,2013.0,5,5,0
BE,CU,2018.0,4,2,2
DE,BG,1998.0,10,16,-6
CZ,IN,2006.0,10,18,-8
CI,CM,2018.0,5,3,2
IN,IL,2008.0,20,14,6
BO,PE,2012.0,8,3,5
RU,IN,2000.0,11,7,4
CZ,SG,2014.0,2,2,0
DE,AZ,1999.0,2,1,1
GB,OM,2016.0,16,14,2
nan,CH,2016.0,24,13,11
BA,IT,2017.0,1,1,0
CA,GR,2001.0,13,4,9
FR,SN,2021.0,40,20,20
AT,ES,2020.0,31,47,-16
BE,DZ,2019.0,7,5,2
CA,LB,2004.0,3,6,-3
CM,BE,2011.0,3,5,-2
RU,IT,2023.0,10,3,7
JP,MK,2009.0,1,1,0
LK,NZ,2014.0,2,1,1
SK,US,1997.0,11,21,-10
CH,SK,2003.0,5,9,-4
EE,DE,2009.0,27,38,-11
NZ,SE,2001.0,7,2,5
DE,PE,2010.0,4,6,-2
BD,ES,2014.0,18,17,1
RS,CZ,2007.0,5,12,-7
RO,TR,2022.0,4,1,3
NO,CZ,2002.0,2,6,-4
NO,ZA,2021.0,2,12,-10
LU,SG,2017.0,2,2,0
BR,PK,2001.0,2,1,1
IL,IE,2005.0,2,2,0
CH,TH,2015.0,3,1,2
AU,NO,1998.0,6,4,2
MT,AU,2011.0,4,1,3
SE,AL,2000.0,2,1,1
CL,GB,2000.0,3,3,0
QA,IN,2019.0,16,49,-33
SE,JO,2015.0,2,2,0
IL,DK,2016.0,5,2,3
CA,QA,2006.0,4,2,2
DK,AE,2018.0,4,2,2
PL,IT,2005.0,9,21,-12
SA,KR,2023.0,2,1,1
DE,LT,2012.0,3,6,-3
KW,BD,2006.0,2,2,0
US,TT,2015.0,12,6,6
AR,NL,2009.0,4,4,0
SE,PA,2002.0,3,1,2
TR,RO,2017.0,3,1,2
JP,RU,1999.0,34,31,3
FR,MW,2016.0,3,2,1
PL,IE,2015.0,8,9,-1
CL,PE,2001.0,9,8,1
FI,JP,2003.0,15,9,6
ID,TW,2011.0,9,12,-3
NZ,SG,2004.0,3,5,-2
MX,PA,2003.0,4,2,2
EE,AU,2002.0,2,1,1
DK,HR,2009.0,1,2,-1
OM,NP,2019.0,1,1,0
QA,IN,2017.0,21,24,-3
AZ,EG,2014.0,2,2,0
RU,KG,2008.0,3,1,2
JP,MY,1998.0,11,7,4
AR,nan,1999.0,6,10,-4
MY,IN,2007.0,23,48,-25
AU,PL,2014.0,14,14,0
EC,FR,2008.0,1,3,-2
DE,nan,2000.0,18,17,1
US,SJ,2018.0,3,1,2
FR,ML,2014.0,9,8,1
GB,PH,1997.0,2,6,-4
BF,US,2016.0,5,3,2
UY,JP,2000.0,1,1,0
IR,BE,2007.0,3,3,0
MA,DE,2006.0,5,3,2
nan,SA,2016.0,5,8,-3
IN,TT,2018.0,5,3,2
NZ,ID,2018.0,14,11,3
IT,IN,2002.0,25,42,-17
RU,UZ,2016.0,10,15,-5
RO,MY,2019.0,2,1,1
NG,UA,2020.0,1,2,-1
SE,SK,2004.0,3,6,-3
MX,CZ,2013.0,3,8,-5
NO,BE,2014.0,10,9,1
CL,CH,2021.0,5,6,-1
CA,BY,2002.0,3,1,2
EE,CH,2009.0,4,3,1
KR,ES,2021.0,21,6,15
JO,MY,2007.0,5,1,4
UZ,US,2001.0,7,1,6
PH,SG,2022.0,7,3,4
AE,IT,2020.0,7,9,-2
CL,NL,2015.0,9,20,-11
PK,BE,2019.0,3,12,-9
BD,IN,2003.0,8,16,-8
MN,CN,2000.0,1,1,0
TZ,CN,2012.0,2,3,-1
UA,nan,2019.0,21,25,-4
TH,SG,2021.0,6,11,-5
NZ,ES,2018.0,5,9,-4
VE,GB,2012.0,4,1,3
MY,TW,2002.0,2,5,-3
CZ,IE,2021.0,2,5,-3
GE,AU,2020.0,1,2,-1
AU,GH,2010.0,3,1,2
AT,IE,2013.0,4,12,-8
EG,IE,2011.0,2,2,0
RU,ZW,2014.0,12,11,1
XK,MK,2019.0,4,4,0
CR,PE,2015.0,10,13,-3
CZ,KR,2011.0,6,9,-3
CL,AT,2014.0,2,3,-1
RU,AM,2013.0,4,5,-1
CA,HK,2015.0,5,3,2
BO,MX,2012.0,5,7,-2
TJ,UZ,2018.0,4,2,2
OM,TH,2019.0,1,1,0
DZ,EG,2015.0,5,1,4
MX,PY,2022.0,6,7,-1
NE,US,2021.0,2,1,1
SK,HR,2019.0,6,7,-1
BG,SK,2019.0,1,2,-1
IE,IR,2022.0,3,15,-12
IL,EC,2018.0,6,1,5
SV,BR,2006.0,1,1,0
TH,IT,2020.0,2,6,-4
CZ,FI,2014.0,7,7,0
BE,DZ,2010.0,5,4,1
PK,JP,2019.0,11,15,-4
KW,RS,2019.0,1,1,0
IT,DZ,2009.0,14,8,6
AU,ET,2021.0,11,33,-22
FR,GP,2008.0,13,6,7
US,MT,2018.0,10,5,5
HU,JP,2005.0,9,7,2
GB,MT,2011.0,7,10,-3
PL,ZA,2019.0,5,9,-4
FR,CY,2014.0,7,2,5
TW,MY,2015.0,26,19,7
DK,NZ,2014.0,4,8,-4
SK,BE,2001.0,2,2,0
TZ,US,2018.0,19,27,-8
SE,HU,2014.0,9,15,-6
GR,SE,2002.0,2,6,-4
JP,SA,2004.0,7,1,6
AT,IN,2018.0,14,17,-3
RO,NG,2018.0,2,1,1
SV,CO,2020.0,3,5,-2
AU,GH,2019.0,8,20,-12
KW,IN,2006.0,3,7,-4
MD,RO,2017.0,10,7,3
ET,IT,2008.0,4,2,2
FI,LU,2007.0,3,1,2
PE,RU,2022.0,2,2,0
DK,ES,2006.0,18,60,-42
EG,TN,2010.0,9,7,2
IE,MY,2011.0,6,1,5
FR,VE,2016.0,6,9,-3
AU,JO,2007.0,6,3,3
RU,PT,2003.0,7,6,1
RU,BY,2000.0,15,14,1
MX,FI,2021.0,5,1,4
ZW,ZA,2000.0,3,1,2
ZW,CG,2009.0,1,2,-1
GB,HU,2005.0,32,30,2
CY,nan,2013.0,1,1,0
DE,EC,2015.0,9,2,7
RO,SE,2013.0,9,5,4
IR,TJ,2015.0,2,2,0
IT,BA,2020.0,3,2,1
TR,RO,2019.0,4,6,-2
NO,IN,2003.0,11,24,-13
LK,GR,2017.0,4,7,-3
PK,ZM,2013.0,1,1,0
LU,BE,2004.0,3,11,-8
BE,RU,1999.0,6,11,-5
UG,ID,2018.0,1,1,0
MX,CU,2008.0,32,36,-4
BE,KH,2016.0,2,1,1
CA,LT,2018.0,1,2,-1
AM,JP,2013.0,4,4,0
LU,ES,2004.0,1,1,0
KE,AU,2006.0,7,1,6
NL,EG,2022.0,5,5,0
BF,CD,2020.0,1,1,0
RS,JP,2016.0,7,1,6
NO,MY,2014.0,2,1,1
LT,CN,2011.0,3,44,-41
UY,PY,2015.0,3,2,1
VN,AT,2013.0,2,1,1
AT,EG,2012.0,3,2,1
XK,US,2019.0,5,4,1
SK,FR,2020.0,7,3,4
MY,LY,2015.0,8,2,6
EE,NL,2011.0,1,1,0
PK,JP,2017.0,13,10,3
DE,VG,2015.0,1,1,0
BG,GR,2021.0,3,2,1
KR,FI,2021.0,9,3,6
JP,CL,2000.0,2,1,1
UA,DK,2009.0,1,2,-1
GE,BR,2016.0,4,2,2
BE,KE,1999.0,2,1,1
DE,PE,2017.0,11,9,2
BD,DE,2018.0,14,13,1
TN,nan,2014.0,4,6,-2
AE,NZ,2017.0,2,3,-1
PK,TW,2022.0,7,4,3
SA,IR,2022.0,7,10,-3
PL,GR,2004.0,3,3,0
IL,TW,2015.0,1,4,-3
US,AM,2003.0,4,4,0
CA,PT,1997.0,4,3,1
IL,CZ,2002.0,2,1,1
TW,PL,2013.0,5,2,3
SI,AU,2004.0,4,1,3
ES,CV,2016.0,1,1,0
GB,PH,1998.0,6,8,-2
BE,KR,2012.0,6,11,-5
US,NI,2020.0,3,7,-4
CR,UY,2014.0,3,2,1
MX,IE,2010.0,3,3,0
CH,CY,2021.0,3,1,2
KR,MX,2006.0,2,3,-1
SK,HR,2010.0,5,3,2
CH,DK,2015.0,36,34,2
ZA,QA,2012.0,1,2,-1
SE,AR,1997.0,3,1,2
CR,GB,2019.0,8,9,-1
TR,PK,2015.0,10,18,-8
BR,EC,2007.0,2,3,-1
VN,HU,2010.0,1,2,-1
NL,PH,2012.0,3,4,-1
PT,CN,1999.0,5,8,-3
GR,CH,2023.0,2,2,0
MY,ZA,2019.0,7,6,1
DK,ZA,2012.0,5,7,-2
SG,AE,2015.0,3,1,2
MC,FR,2011.0,3,8,-5
HN,ES,2018.0,5,8,-3
AE,CA,2011.0,4,19,-15
MD,RO,2010.0,3,1,2
CZ,BE,2004.0,2,5,-3
GB,BH,2012.0,3,1,2
CL,CA,2002.0,5,4,1
RU,AR,2009.0,2,1,1
QA,TN,2020.0,5,13,-8
ID,DZ,2020.0,4,5,-1
EE,RU,2011.0,6,3,3
GA,GB,2022.0,1,2,-1
DE,NG,2009.0,7,5,2
nan,VE,2011.0,2,1,1
CA,BF,2014.0,2,1,1
SK,FI,2013.0,2,1,1
LT,DE,2021.0,7,1,6
TH,NZ,2019.0,3,7,-4
IR,TN,2012.0,3,2,1
VG,GB,2016.0,5,5,0
KZ,AZ,2019.0,5,4,1
GB,SI,2012.0,8,7,1
DE,MD,2015.0,4,3,1
MX,IE,2017.0,3,2,1
GF,CA,2020.0,1,1,0
US,BB,2009.0,3,2,1
ZA,CN,2013.0,14,12,2
IR,NO,2015.0,10,11,-1
RS,GR,2014.0,4,4,0
CA,CL,1999.0,1,6,-5
BA,GB,2013.0,4,2,2
YE,MY,2013.0,2,6,-4
ZA,NO,2012.0,9,4,5
IR,BR,2011.0,6,8,-2
UG,IN,2010.0,1,1,0
JO,AU,2006.0,2,4,-2
CO,DE,2009.0,12,11,1
ES,UG,2017.0,1,2,-1
KR,DE,2000.0,13,22,-9
UZ,FR,2019.0,1,1,0
IN,SD,2012.0,2,1,1
CN,RW,2019.0,6,3,3
TR,CZ,2017.0,5,10,-5
TW,nan,2020.0,2,6,-4
nan,GR,2004.0,4,1,3
NZ,NL,2007.0,7,8,-1
CA,AR,2005.0,11,16,-5
RO,AU,2008.0,3,1,2
NL,IS,2019.0,6,1,5
IT,CU,2004.0,4,3,1
nan,CZ,2003.0,4,5,-1
DK,VN,2014.0,2,4,-2
NG,BD,2012.0,1,1,0
AT,RS,2016.0,13,6,7
OM,EG,2009.0,5,4,1
BE,AT,2014.0,15,15,0
TZ,CH,2016.0,5,4,1
SY,GB,2012.0,5,8,-3
VE,PE,2013.0,14,8,6
TW,IR,2022.0,2,3,-1
NO,SK,2012.0,1,2,-1
HU,AU,2020.0,5,7,-2
JM,BB,2001.0,2,2,0
IL,IR,2012.0,2,1,1
QA,FR,2015.0,10,20,-10
BE,TH,2007.0,2,1,1
PL,AT,2014.0,12,17,-5
KN,US,2011.0,3,6,-3
CH,LK,2020.0,3,3,0
IT,BY,1997.0,2,5,-3
IL,SG,2010.0,3,3,0
RU,HR,2022.0,8,3,5
IQ,CA,2022.0,7,2,5
MX,JO,2018.0,1,1,0
TN,CH,2012.0,4,8,-4
CN,SK,2016.0,6,2,4
AR,ID,2008.0,1,1,0
JP,GE,2007.0,1,1,0
ID,IR,2021.0,17,20,-3
PK,CZ,2013.0,2,2,0
IL,FR,2023.0,1,1,0
PY,BR,2011.0,5,3,2
ZA,BR,2007.0,11,5,6
FI,VN,2015.0,1,1,0
IE,HR,2000.0,4,1,3
SE,GR,2010.0,9,10,-1
BE,CL,2007.0,4,6,-2
BG,UA,2004.0,4,1,3
IR,SE,2005.0,5,11,-6
NL,HK,1998.0,3,1,2
PL,BY,2002.0,1,1,0
PL,BY,2005.0,2,7,-5
NG,ZW,1999.0,3,1,2
CL,UY,2022.0,6,3,3
CH,SA,2012.0,4,2,2
US,IS,2002.0,13,7,6
RU,MM,2019.0,4,3,1
RS,nan,2012.0,2,1,1
GB,GH,1999.0,4,3,1
NZ,KE,2014.0,3,2,1
MA,BR,2005.0,3,1,2
LV,NL,2011.0,1,1,0
SD,CN,2017.0,2,8,-6
IQ,CN,2016.0,2,11,-9
RU,CO,2021.0,3,5,-2
KR,TH,2021.0,15,6,9
ZM,NO,2020.0,2,1,1
TT,US,1998.0,3,1,2
SG,IE,2006.0,4,4,0
GB,RO,2000.0,5,8,-3
IE,KR,2015.0,7,9,-2
OM,GB,2022.0,5,3,2
JM,IN,2017.0,2,1,1
EG,TN,2019.0,10,26,-16
SY,NL,2021.0,1,1,0
AT,IL,2014.0,3,7,-4
IE,NZ,2004.0,7,5,2
BE,PS,2019.0,1,1,0
SE,AR,1998.0,3,2,1
PS,PK,2018.0,3,3,0
QA,IE,2019.0,3,2,1
CL,IL,2014.0,3,1,2
UA,BE,2007.0,2,1,1
AE,ES,2012.0,2,3,-1
MY,ZA,2017.0,9,4,5
DK,IL,2022.0,3,3,0
US,SI,2008.0,11,14,-3
AT,RO,2010.0,3,1,2
FR,SI,2009.0,8,8,0
CH,LB,2005.0,1,1,0
AU,KE,1999.0,2,2,0
BR,AE,2013.0,2,5,-3
GH,CA,2008.0,2,1,1
KW,AE,2002.0,3,3,0
MA,ES,2006.0,7,3,4
SK,CH,2011.0,6,5,1
PK,ES,2019.0,2,7,-5
nan,HU,2015.0,3,5,-2
nan,NZ,2001.0,8,7,1
CY,KZ,2018.0,1,1,0
PH,BD,2010.0,2,1,1
HK,JP,2022.0,2,9,-7
ES,HU,2012.0,7,5,2
VE,AU,2006.0,2,2,0
ZA,CL,2014.0,3,3,0
BJ,CA,2020.0,2,4,-2
AU,CO,2021.0,7,14,-7
SA,VN,2017.0,1,1,0
UG,GH,2022.0,2,1,1
NO,UA,2018.0,3,4,-1
BH,GB,2022.0,4,5,-1
TR,OM,2022.0,2,1,1
CU,DE,2007.0,5,2,3
SN,CN,2015.0,3,1,2
CL,HN,2014.0,7,2,5
IE,BR,2019.0,10,25,-15
SA,GH,2018.0,1,1,0
CN,IR,2023.0,2,6,-4
IE,PK,2012.0,9,9,0
IN,UG,2020.0,3,2,1
IR,CY,2022.0,5,5,0
LK,NL,2005.0,1,1,0
PL,LT,2020.0,4,6,-2
IE,BR,2010.0,3,7,-4
FI,ID,2009.0,1,1,0
AT,BG,2007.0,2,1,1
BE,PT,2008.0,8,6,2
GR,SG,2021.0,3,2,1
ES,AU,1999.0,7,8,-1
MN,RU,2021.0,3,2,1
JP,PT,2008.0,4,1,3
BG,RS,2004.0,4,3,1
IL,SG,2019.0,3,8,-5
DE,CW,2013.0,2,2,0
VN,MX,1998.0,1,2,-1
AU,GH,2017.0,12,8,4
ID,PT,2021.0,3,2,1
HR,AT,2006.0,2,3,-1
BF,ML,2020.0,2,4,-2
BD,PL,2007.0,1,3,-2
NG,CY,2016.0,1,2,-1
LK,GR,2019.0,2,1,1
SI,BY,2006.0,1,2,-1
CL,IE,2020.0,3,3,0
PE,UY,2007.0,2,2,0
TR,BA,2015.0,2,3,-1
CH,KR,2000.0,3,5,-2
IT,RO,2003.0,4,8,-4
MW,CA,2008.0,2,1,1
UZ,UA,2016.0,1,9,-8
CI,MA,2015.0,2,2,0
GB,KZ,2017.0,3,5,-2
ES,CZ,1999.0,2,2,0
GB,BN,2006.0,1,3,-2
IE,SE,2017.0,9,12,-3
QA,ID,2020.0,7,4,3
DE,MA,2003.0,4,2,2
SE,LU,2019.0,3,4,-1
HR,CH,2009.0,3,3,0
PA,CA,1997.0,1,2,-1
RU,GE,2015.0,6,5,1
NG,AU,2007.0,2,1,1
CA,AR,2002.0,5,9,-4
GB,JM,1997.0,3,1,2
RS,CL,2016.0,2,1,1
JO,CN,2017.0,3,2,1
AU,SY,2011.0,1,1,0
BW,US,2023.0,2,1,1
JP,SY,2012.0,3,1,2
SD,IT,2021.0,1,2,-1
GB,CM,2022.0,4,5,-1
US,GN,2020.0,4,1,3
AT,MY,2019.0,3,5,-2
DE,MX,2023.0,2,2,0
GH,NL,2010.0,3,5,-2
AT,KR,2017.0,5,4,1
IL,CZ,2005.0,2,4,-2
MA,TG,2018.0,2,1,1
MA,BD,2009.0,1,1,0
GR,IE,2002.0,3,1,2
IT,SE,2023.0,6,3,3
HU,ZA,2013.0,3,1,2
US,VG,1998.0,4,4,0
UG,IN,2019.0,5,5,0
NL,BG,2020.0,3,1,2
NO,MX,2016.0,4,3,1
ID,UA,2018.0,5,3,2
VN,HU,2017.0,4,3,1
CY,NL,2016.0,4,1,3
CN,HR,2018.0,3,1,2
RS,IN,2018.0,1,3,-2
IE,GR,2018.0,4,8,-4
BA,TR,2015.0,3,2,1
PH,IT,2012.0,2,2,0
nan,CU,2001.0,4,1,3
DZ,AE,2015.0,5,1,4
LK,GR,2010.0,4,3,1
ST,PT,2017.0,3,1,2
SK,BA,2020.0,4,2,2
ZA,IT,2012.0,8,15,-7
MY,TW,2005.0,3,8,-5
DE,MK,2005.0,1,2,-1
CR,AR,2007.0,6,3,3
NZ,JM,2010.0,1,1,0
GE,PT,2000.0,1,1,0
BO,JP,2018.0,1,2,-1
GH,MY,2016.0,1,3,-2
PL,ZA,2010.0,4,2,2
PA,CA,1998.0,1,1,0
OM,ZA,1999.0,1,1,0
IN,OM,2006.0,4,3,1
NC,GB,2015.0,1,4,-3
NL,CO,1998.0,1,1,0
KR,SE,2008.0,3,2,1
SY,MX,2013.0,1,1,0
QA,IN,2010.0,3,6,-3
NP,MX,2020.0,1,1,0
JP,AR,2014.0,2,7,-5
SA,MT,2022.0,1,1,0
SE,ET,2006.0,3,2,1
BF,CG,2019.0,1,1,0
TR,BG,2011.0,3,1,2
CR,DE,2009.0,1,2,-1
PH,JP,2003.0,10,14,-4
CU,nan,2014.0,3,1,2
IL,MX,2007.0,3,2,1
MK,US,2022.0,4,5,-1
TH,IR,2016.0,4,5,-1
GB,JM,1998.0,2,3,-1
QA,OM,2019.0,3,9,-6
NI,US,2005.0,1,2,-1
RS,DK,2006.0,4,3,1
BN,IN,2021.0,1,3,-2
CO,DK,2009.0,2,1,1
TN,JO,2022.0,3,1,2
EG,ET,2015.0,6,4,2
DK,CL,2018.0,1,5,-4
NO,SJ,2011.0,3,3,0
BY,EC,2009.0,1,1,0
BO,AR,2008.0,3,1,2
SG,GR,2007.0,3,1,2
IL,CO,2021.0,3,5,-2
SD,CN,2019.0,3,10,-7
NG,PL,2015.0,3,3,0
TW,MX,2003.0,1,1,0
PA,MX,2000.0,2,1,1
PA,AR,2016.0,1,6,-5
CR,MX,1998.0,3,1,2
BF,BE,2021.0,2,4,-2
MA,CN,2016.0,1,3,-2
BE,BG,2022.0,4,2,2
KR,NO,2020.0,9,5,4
CH,BG,2007.0,3,1,2
CD,CH,2015.0,1,2,-1
SS,SD,2013.0,2,1,1
QA,OM,2010.0,1,2,-1
KE,NL,2009.0,4,1,3
MX,PR,2022.0,1,4,-3
KP,US,2021.0,1,2,-1
PL,SK,2012.0,5,7,-2
RU,MD,2016.0,3,10,-7
EG,GH,2016.0,2,7,-5
CZ,GR,2006.0,2,1,1
PK,MX,2009.0,1,1,0
RO,CZ,2007.0,6,3,3
HR,NL,2013.0,7,5,2
LT,CZ,2001.0,3,2,1
SN,CH,2001.0,1,1,0
BR,BJ,2020.0,3,2,1
NL,LK,2014.0,1,1,0
DK,RU,2007.0,7,20,-13
GB,UG,2001.0,1,3,-2
TW,BE,2022.0,3,5,-2
CN,DZ,2022.0,4,2,2
IR,LY,2015.0,1,1,0
IN,QA,2002.0,1,1,0
BJ,DE,2000.0,3,1,2
MA,DZ,2001.0,1,1,0
ES,MZ,2009.0,2,2,0
SE,PT,2007.0,5,1,4
PA,TW,2012.0,1,1,0
CH,EG,2000.0,1,1,0
IN,PS,2015.0,1,1,0
HU,BR,2019.0,4,6,-2
ZA,TH,2014.0,1,3,-2
ES,TW,2015.0,5,6,-1
DE,VE,2002.0,4,3,1
ZA,HU,2022.0,2,4,-2
IE,KW,2022.0,1,1,0
BD,QA,2020.0,2,1,1
CH,CM,2010.0,2,1,1
AL,NL,2013.0,1,1,0
ZA,ZW,2000.0,1,3,-2
SE,AE,2001.0,2,1,1
VE,DE,1998.0,1,4,-3
UG,IN,2017.0,1,4,-3
CA,TZ,2016.0,2,3,-1
IL,TR,2022.0,1,2,-1
CM,US,2001.0,1,1,0
MA,CM,2022.0,1,1,0
NP,EG,2021.0,1,2,-1
JP,BG,2014.0,3,6,-3
LT,RU,1998.0,2,7,-5
US,GA,2003.0,1,2,-1
SI,RU,2018.0,5,3,2
ZA,ZM,2006.0,1,1,0
BR,DZ,2013.0,1,2,-1
AR,BO,2014.0,3,5,-2
SD,CA,2020.0,1,4,-3
JP,VE,2007.0,1,1,0
SA,NZ,2011.0,1,1,0
CA,MD,2013.0,1,2,-1
DE,LB,2011.0,2,5,-3
ML,CI,2022.0,1,5,-4
TN,PG,2017.0,1,3,-2
NL,CR,2016.0,2,2,0
QA,SE,2004.0,1,5,-4
MZ,BE,2014.0,4,4,0
SE,AZ,2017.0,1,1,0
LR,US,2016.0,1,4,-3
RO,MY,2017.0,2,2,0
AE,IQ,2016.0,3,5,-2
RS,FI,2012.0,2,1,1
UY,IE,2018.0,1,1,0
SA,DZ,2012.0,4,5,-1
RU,SK,2002.0,7,15,-8
MX,CN,2008.0,3,5,-2
NG,BJ,2016.0,2,2,0
IR,SK,2022.0,4,1,3
HR,AU,2014.0,1,2,-1
UG,NZ,2014.0,1,3,-2
AR,CN,2020.0,2,5,-3
QA,OM,2017.0,2,5,-3
IL,ID,2021.0,5,4,1
SI,KR,2019.0,1,2,-1
LT,SE,2000.0,5,1,4
ZA,ET,2005.0,2,2,0
SI,TW,2004.0,1,3,-2
ID,IL,2020.0,3,3,0
CL,BG,2003.0,1,1,0
HU,EE,2013.0,1,1,0
CN,RW,2017.0,3,1,2
LB,AU,2014.0,5,4,1
JP,VN,1998.0,1,3,-2
FR,KZ,2014.0,2,2,0
AU,HR,2014.0,2,1,1
IQ,MY,2008.0,1,1,0
TH,AT,2008.0,2,3,-1
FI,LT,2004.0,1,1,0
GR,EG,2020.0,2,2,0
PA,ES,2000.0,2,1,1
BR,RS,2011.0,2,1,1
FI,PT,2008.0,3,2,1
US,DO,2018.0,5,5,0
PK,EG,2005.0,1,1,0
CI,CA,2018.0,3,9,-6
IR,SI,2019.0,2,1,1
HR,BR,2006.0,1,1,0
US,CO,2022.0,173,184,-11
US,AU,2008.0,1874,1758,116
GB,DE,2006.0,485,681,-196
AU,GB,2020.0,1388,1440,-52
DE,SA,2020.0,32,27,5
DE,IT,2018.0,291,379,-88
AR,ES,2015.0,331,387,-56
CN,TW,2006.0,555,1077,-522
DK,SE,2006.0,69,81,-12
US,AR,2021.0,172,272,-100
BR,US,2001.0,355,374,-19
BR,PE,2018.0,95,84,11
CH,UA,2016.0,6,7,-1
ES,CA,2009.0,67,68,-1
CN,IN,2013.0,140,142,-2
AU,NZ,2013.0,134,222,-88
CN,PT,2005.0,14,6,8
NL,ZA,2016.0,57,37,20
NZ,LK,2015.0,4,1,3
CH,GB,2020.0,333,414,-81
JP,GR,2019.0,22,52,-30
AU,CN,2000.0,95,83,12
FR,NL,2005.0,153,163,-10
SY,CN,2013.0,18,26,-8
VN,CN,2004.0,47,23,24
CN,MM,2011.0,4,5,-1
TH,CN,2020.0,60,59,1
RU,UA,2003.0,110,69,41
NL,nan,2014.0,76,86,-10
AR,CL,2021.0,94,120,-26
SG,AU,2017.0,119,143,-24
CL,JP,2012.0,3,8,-5
GB,SA,2021.0,159,99,60
MM,TH,2021.0,10,13,-3
PK,CG,2016.0,2,1,1
IN,ID,2020.0,120,96,24
ID,MY,2012.0,40,75,-35
FR,NL,2002.0,131,95,36
GR,DE,2009.0,57,47,10
IN,JP,2018.0,159,149,10
SG,MY,2018.0,165,128,37
JP,IR,2020.0,25,14,11
JP,GR,2017.0,29,23,6
GR,JP,2019.0,52,22,30
EG,KR,2019.0,8,8,0
GB,CL,2020.0,64,54,10
NG,ZA,2021.0,106,92,14
TN,IR,2019.0,12,10,2
PT,NL,2023.0,3,3,0
EG,GB,2023.0,6,2,4
IE,CA,1999.0,37,52,-15
GB,RU,2018.0,135,91,44
BD,ID,2012.0,5,7,-2
PK,IE,2017.0,11,12,-1
SG,GB,2016.0,134,159,-25
IE,NL,2007.0,12,14,-2
FR,AE,2012.0,9,6,3
CA,nan,2009.0,20,22,-2
UA,BY,2022.0,6,8,-2
MY,PS,2015.0,5,3,2
CN,IL,2003.0,14,12,2
BR,nan,2003.0,24,22,2
IN,NP,2006.0,19,21,-2
CL,CA,2005.0,11,3,8
SK,PL,2020.0,11,12,-1
nan,GB,2003.0,38,84,-46
MZ,BR,2014.0,8,5,3
IR,IE,2011.0,8,3,5
FR,RS,2013.0,7,9,-2
TG,GH,2019.0,1,2,-1
GR,FR,1998.0,15,20,-5
DE,ET,2005.0,6,2,4
UA,SI,2018.0,1,2,-1
DE,IL,2010.0,37,43,-6
CH,CM,2019.0,5,5,0
IE,JP,2014.0,21,24,-3
BR,IE,2018.0,17,16,1
MA,EG,2013.0,6,3,3
ES,BO,2020.0,19,26,-7
CO,GB,1998.0,4,5,-1
DK,AU,2009.0,15,29,-14
nan,PL,2004.0,4,7,-3
TR,KR,2009.0,4,4,0
DE,UY,2020.0,7,2,5
MA,IL,2007.0,1,2,-1
BN,US,2015.0,2,3,-1
IT,AL,2019.0,8,5,3
GR,AU,2018.0,18,8,10
ZW,ZM,2016.0,2,4,-2
NO,IE,2013.0,4,6,-2
DE,BJ,2005.0,4,1,3
BO,FR,2004.0,1,2,-1
GR,IT,2010.0,21,22,-1
FR,BJ,2008.0,19,23,-4
PH,NP,2011.0,1,1,0
MK,RS,2015.0,4,3,1
JO,US,2003.0,13,16,-3
BW,NG,2019.0,3,2,1
CA,MX,2013.0,42,36,6
IT,PH,1999.0,2,2,0
PK,AU,2006.0,4,16,-12
CL,CN,2010.0,3,6,-3
DE,BG,1997.0,8,13,-5
LB,CN,2008.0,4,20,-16
CL,CN,2017.0,4,1,3
GR,ID,2020.0,4,5,-1
SE,EG,2008.0,7,3,4
ET,CN,2017.0,18,5,13
EE,FI,1998.0,3,6,-3
PK,AR,2020.0,7,2,5
CR,GB,2017.0,3,5,-2
KP,CN,2021.0,5,7,-2
GB,BW,2008.0,2,5,-3
CL,CN,2019.0,7,3,4
IN,FI,2002.0,7,2,5
BD,CH,2015.0,2,2,0
FR,MC,2004.0,4,4,0
ID,GB,2004.0,1,6,-5
QA,US,2000.0,7,10,-3
DK,KR,2013.0,2,6,-4
IL,SG,2017.0,4,3,1
RS,CH,2016.0,11,10,1
BD,SA,2016.0,18,25,-7
CH,HR,2022.0,2,4,-2
HU,BR,2017.0,4,3,1
IR,NZ,2013.0,5,2,3
AU,TR,1999.0,2,5,-3
SI,CA,2018.0,3,3,0
TR,IE,2011.0,4,2,2
MZ,RU,2001.0,11,1,10
ML,BF,2012.0,2,2,0
TH,NZ,2010.0,6,3,3
MY,NO,2022.0,2,1,1
MA,MY,2012.0,1,1,0
CZ,EG,2020.0,5,6,-1
BN,CN,2020.0,7,2,5
TN,IT,2001.0,2,1,1
ZW,FR,2010.0,2,1,1
CI,US,2020.0,6,6,0
IT,GE,2007.0,1,2,-1
IT,SI,2023.0,3,1,2
IN,BH,2016.0,1,2,-1
IL,RS,2005.0,1,3,-2
ES,FI,2004.0,3,6,-3
MY,PT,2009.0,3,5,-2
PA,US,2007.0,8,30,-22
DE,NA,2016.0,2,1,1
BR,DK,2003.0,4,5,-1
VN,HU,2019.0,3,2,1
PK,IE,2010.0,6,5,1
OM,SY,2001.0,1,1,0
DE,ET,2002.0,2,2,0
AL,DE,2004.0,1,2,-1
BE,SK,2015.0,4,7,-3
BO,EC,2016.0,4,2,2
NO,RO,2022.0,2,3,-1
CZ,RO,2007.0,3,6,-3
XK,HU,2019.0,1,1,0
HN,MX,2001.0,6,6,0
GR,ZA,2015.0,3,1,2
TZ,TW,2018.0,1,2,-1
LY,MY,2015.0,2,8,-6
CO,GA,2012.0,1,1,0
EG,KR,2017.0,2,12,-10
DK,GR,2008.0,5,7,-2
TH,AE,2015.0,1,1,0
KW,AU,2018.0,1,5,-4
SE,PA,2005.0,2,1,1
CA,ZA,2022.0,23,23,0
DE,CN,2014.0,284,290,-6
UA,nan,2017.0,10,34,-24
TN,PT,2018.0,6,3,3
KR,VN,2020.0,133,61,72
CZ,SE,2008.0,11,10,1
TW,EG,2016.0,18,16,2
AT,RO,2019.0,8,5,3
CO,GB,1997.0,4,2,2
SE,NL,2023.0,3,4,-1
GR,IT,2017.0,31,33,-2
NL,IS,2017.0,1,1,0
BG,BR,2014.0,1,1,0
RS,ME,2007.0,6,3,3
CZ,AU,2008.0,5,8,-3
NO,PT,2009.0,2,4,-2
GB,BD,2015.0,63,47,16
BY,EE,2012.0,1,1,0
,TW,2004.0,5055,0,5055
,JP,2012.0,14683,0,14683
TH,,2014.0,856,0,856
AU,,2024.0,56538,0,56538
,US,2010.0,75987,0,75987
,TW,1996.0,3622,0,3622
,ES,2001.0,10072,0,10072
ES,,2021.0,17928,0,17928
GB,,2018.0,16364,0,16364
,FR,1995.0,24216,0,24216
NL,,2019.0,6571,0,6571
,IT,2011.0,13455,0,13455
US,,2001.0,22044,0,22044
,US,2017.0,69663,0,69663
IT,,2021.0,14938,0,14938
,US,2019.0,39434,0,39434
,CN,2001.0,36609,0,36609
,DK,2004.0,1439,0,1439
,IE,2011.0,1475,0,1475
,PL,2015.0,6232,0,6232
,RO,1998.0,522,0,522
,CL,1996.0,956,0,956
BE,,2022.0,6194,0,6194
NL,,2017.0,5077,0,5077
CH,,2025.0,2281,0,2281
,ID,2013.0,11007,0,11007
,IR,1995.0,554,0,554
,IL,2013.0,2509,0,2509
,CL,2004.0,1421,0,1421
KR,,2008.0,1037,0,1037
NL,,2010.0,2879,0,2879
,SA,1994.0,1516,0,1516
SA,,2022.0,3759,0,3759
DE,BA,2011.0,7,0,7
,DK,1996.0,1784,0,1784
,MA,2010.0,937,0,937
IQ,,2023.0,4362,0,4362
,CA,2015.0,10352,0,10352
,GR,2005.0,2973,0,2973
HR,,2015.0,546,0,546
MX,GI,2020.0,1,0,1
LB,,2022.0,825,0,825
,NL,2014.0,6012,0,6012
,PK,2008.0,1332,0,1332
CU,,2012.0,190,0,190
,GR,2002.0,2616,0,2616
,EE,1994.0,382,0,382
IE,,2015.0,882,0,882
BG,,2001.0,154,0,154
,SI,1994.0,898,0,898
AL,MX,2011.0,1,0,1
,TN,2010.0,1336,0,1336
,NG,2009.0,1912,0,1912
EG,,2018.0,1700,0,1700
AR,,2006.0,405,0,405
,SG,1997.0,826,0,826
,nan,2011.0,863,0,863
UA,,2025.0,347,0,347
SN,,2017.0,72,0,72
,CR,1996.0,71,0,71
,SG,1998.0,880,0,880
RS,,2025.0,497,0,497
,ZW,2015.0,177,0,177
,IS,2012.0,116,0,116
,HU,2012.0,1429,0,1429
,AM,2002.0,121,0,121
,SY,2010.0,116,0,116
ET,,2018.0,224,0,224
,SD,2009.0,123,0,123
,LT,2018.0,498,0,498
,UY,2016.0,308,0,308
,NP,2006.0,170,0,170
UZ,,2000.0,14,0,14
CI,,2023.0,909,0,909
IN,LU,2022.0,10,0,10
,TH,2016.0,2522,0,2522
DK,PS,2011.0,1,0,1
,MA,2019.0,1126,0,1126
,TN,2017.0,1069,0,1069
,HK,2007.0,82,0,82
IQ,AE,2011.0,2,0,2
,VN,2006.0,218,0,218
KZ,,2012.0,41,0,41
,RO,1997.0,508,0,508
,TN,2019.0,602,0,602
,AM,2005.0,172,0,172
,AL,1997.0,19,0,19
,SY,2019.0,118,0,118
ZW,,2016.0,68,0,68
AZ,,2015.0,94,0,94
NP,,2025.0,87,0,87
,VE,2015.0,238,0,238
,KZ,2018.0,980,0,980
BW,,2020.0,108,0,108
,CR,2004.0,131,0,131
MW,,2010.0,14,0,14
,TJ,2007.0,21,0,21
MG,,2019.0,56,0,56
SK,,2014.0,323,0,323
BD,,2013.0,217,0,217
SN,,2019.0,114,0,114
LV,,2012.0,89,0,89
BO,CN,2011.0,5,0,5
,BH,2005.0,36,0,36
SY,,2009.0,23,0,23
LB,SA,2007.0,3,0,3
QA,,2016.0,86,0,86
JM,,2012.0,17,0,17
,GH,2003.0,118,0,118
GB,UZ,2016.0,3,0,3
TN,,2009.0,188,0,188
,KH,2015.0,42,0,42
,CM,2018.0,552,0,552
HU,IR,2012.0,3,0,3
,YE,2001.0,16,0,16
PH,AT,2014.0,3,0,3
,SY,2017.0,165,0,165
MW,,2019.0,78,0,78
CN,BH,2021.0,3,0,3
,SS,2011.0,5,0,5
ZW,FR,2017.0,1,0,1
BW,JP,2022.0,1,0,1
MK,ES,2019.0,1,0,1
,SE,2020.0,175,0,175
ZW,CD,2017.0,2,0,2
RE,MG,2019.0,1,0,1
KZ,EG,2021.0,1,0,1
ME,,2025.0,11,0,11
LV,IT,2014.0,2,0,2
PK,LT,2022.0,2,0,2
,UZ,2012.0,137,0,137
VE,MA,2021.0,1,0,1
,RS,2006.0,889,0,889
,MA,2017.0,1536,0,1536
MA,,2008.0,145,0,145
UZ,RU,2023.0,1,0,1
,CY,2015.0,260,0,260
SN,,2010.0,23,0,23
SI,CO,2011.0,1,0,1
CH,VN,2005.0,1,0,1
BG,HU,2015.0,1,0,1
,GA,2005.0,17,0,17
HR,FI,2008.0,1,0,1
,LY,2000.0,12,0,12
SI,IL,2020.0,2,0,2
MN,,2018.0,48,0,48
,CI,1999.0,38,0,38
DE,QA,2002.0,1,0,1
HN,VE,1998.0,1,0,1
RO,NL,2000.0,5,0,5
LT,LU,2017.0,2,0,2
PT,AT,1997.0,1,0,1
CI,SN,2016.0,1,0,1
GB,JE,2005.0,1,0,1
BB,CN,2008.0,1,0,1
FR,AZ,2015.0,1,0,1
,BO,2003.0,58,0,58
CZ,EC,2021.0,2,0,2
,GY,2018.0,8,0,8
PH,LK,2019.0,1,0,1
TW,HR,2018.0,1,0,1
NC,RE,2018.0,2,0,2
,NZ,2020.0,110,0,110
,MC,1994.0,10,0,10
SY,JP,2017.0,2,0,2
MX,IE,2019.0,8,0,8
NG,LK,2019.0,1,0,1
VN,GB,1999.0,3,0,3
,BH,2002.0,52,0,52
SD,KW,2018.0,1,0,1
GR,ME,2020.0,5,0,5
NP,HT,2015.0,3,0,3
IT,RS,1997.0,1,0,1
MT,,2006.0,5,0,5
KN,ES,2020.0,1,0,1
MG,,2017.0,34,0,34
,VG,2002.0,21,0,21
ID,,2003.0,27,0,27
SG,BE,2001.0,1,0,1
,PG,1999.0,13,0,13
NL,OM,2007.0,2,0,2
PH,PK,2021.0,1,0,1
ZM,IN,2009.0,1,0,1
EG,NC,2016.0,1,0,1
EE,HR,2019.0,1,0,1
SJ,,2023.0,18,0,18
,VU,2014.0,1,0,1
BF,,2013.0,21,0,21
IL,TN,1999.0,1,0,1
CA,GN,2015.0,1,0,1
,GA,2002.0,23,0,23
CH,AL,2012.0,1,0,1
CW,,1998.0,2,0,2
CO,AT,2003.0,1,0,1
HU,AR,2018.0,1,0,1
,VG,2005.0,21,0,21
PW,CH,2015.0,1,0,1
UZ,FR,2010.0,3,0,3
nan,EE,2004.0,1,0,1
KN,AU,2020.0,2,0,2
ER,,2014.0,1,0,1
QA,CZ,1997.0,1,0,1
MG,CM,2017.0,1,0,1
IN,PT,2005.0,5,0,5
ID,BR,2005.0,1,0,1
QA,IE,2017.0,4,0,4
GW,BR,2020.0,1,0,1
AZ,BY,2022.0,1,0,1
KZ,IQ,2012.0,1,0,1
NI,,2008.0,4,0,4
MG,,2010.0,15,0,15
GE,KW,2020.0,1,0,1
RU,BJ,2012.0,1,0,1
CG,,2007.0,4,0,4
SV,US,2001.0,3,0,3
UZ,GB,2008.0,3,0,3
MW,,2017.0,45,0,45
MX,RO,2009.0,1,0,1
CO,HN,2004.0,2,0,2
BF,NE,2015.0,2,0,2
CD,UG,2013.0,1,0,1
EC,,2003.0,7,0,7
UZ,IT,2001.0,2,0,2
MY,AF,2022.0,3,0,3
,AL,1998.0,16,0,16
KE,TR,2016.0,1,0,1
DE,BF,2004.0,1,0,1
TH,ES,2013.0,3,0,3
HK,KR,2005.0,1,0,1
NO,GL,2013.0,1,0,1
KW,NL,2005.0,1,0,1
IN,TR,2003.0,6,0,6
SY,AU,2012.0,1,0,1
DK,BY,2013.0,1,0,1
RW,LU,2009.0,2,0,2
CU,DK,2019.0,1,0,1
GB,GP,2019.0,1,0,1
ZA,DK,1999.0,1,0,1
CO,PY,2003.0,1,0,1
TN,BH,2020.0,2,0,2
UG,MA,1998.0,1,0,1
nan,PH,2008.0,1,0,1
MK,RU,2014.0,2,0,2
PT,AE,2021.0,2,0,2
PY,IR,2020.0,1,0,1
GB,TG,2018.0,1,0,1
US,MZ,1999.0,1,0,1
RE,CA,2006.0,1,0,1
NG,SZ,2006.0,1,0,1
PT,MA,2004.0,2,0,2
BF,JP,2014.0,1,0,1
FJ,ET,2018.0,1,0,1
ZM,SA,2021.0,1,0,1
JP,GT,2006.0,1,0,1
BW,NP,2019.0,1,0,1
MN,IN,2011.0,1,0,1
NA,US,2004.0,2,0,2
NE,RW,2017.0,1,0,1
AX,,2009.0,1,0,1
CZ,LU,2012.0,1,0,1
LY,,2003.0,8,0,8
MG,SA,2014.0,1,0,1
,DJ,1995.0,1,0,1
GR,BN,2018.0,2,0,2
BY,CN,1998.0,1,0,1
DK,JO,2017.0,1,0,1
HR,KG,2018.0,1,0,1
CD,NG,2020.0,3,0,3
SD,MA,2020.0,1,0,1
BY,FR,2022.0,1,0,1
VE,QA,2022.0,1,0,1
NG,FI,2013.0,2,0,2
UA,AU,2003.0,3,0,3
nan,AF,2020.0,1,0,1
BA,US,2005.0,1,0,1
SA,VN,2019.0,1,0,1
CR,HN,2007.0,1,0,1
CI,EG,2017.0,1,0,1
TW,SA,2023.0,1,0,1
,MU,1999.0,14,0,14
PE,CR,2000.0,1,0,1
PY,EC,2012.0,1,0,1
NG,CG,2015.0,1,0,1
CF,IN,2009.0,1,0,1
RO,IS,2010.0,2,0,2
KE,BG,2015.0,1,0,1
BW,UG,2009.0,1,0,1
BA,IT,2010.0,1,0,1
DK,KE,2004.0,1,0,1
NO,PS,2014.0,2,0,2
UZ,CZ,2006.0,6,0,6
SK,YE,2008.0,1,0,1
ZW,nan,2017.0,1,0,1
IN,ML,2020.0,5,0,5
NG,KE,2007.0,2,0,2
AM,FR,2000.0,1,0,1
CY,KR,2020.0,5,0,5
NL,HR,1997.0,1,0,1
PH,PA,2005.0,1,0,1
,KY,2012.0,2,0,2
RS,NZ,2014.0,1,0,1
GE,JP,2022.0,1,0,1
OM,CN,2005.0,1,0,1
BR,PL,2000.0,4,0,4
DE,FJ,2011.0,1,0,1
AM,PE,2004.0,1,0,1
GB,PG,2020.0,1,0,1
BR,SA,2023.0,1,0,1
AR,LT,2008.0,3,0,3
UG,nan,2000.0,1,0,1
BN,LK,2019.0,1,0,1
TW,LY,2018.0,1,0,1
IN,BB,2017.0,1,0,1
BY,LV,2007.0,2,0,2
MM,AU,2013.0,2,0,2
BW,NG,2010.0,4,0,4
SN,MR,2011.0,1,0,1
KG,CH,2019.0,1,0,1
SY,AE,2017.0,3,0,3
PT,ZA,2009.0,4,0,4
SK,ZA,2015.0,1,0,1
SI,XK,2012.0,2,0,2
CI,IN,2019.0,2,0,2
FI,KW,2003.0,1,0,1
TZ,,2000.0,8,0,8
EG,NP,2022.0,2,0,2
AE,,2026.0,3,0,3
TZ,IS,2015.0,1,0,1
BE,PH,2022.0,2,0,2
GD,OM,1999.0,1,0,1
,CV,2018.0,9,0,9
GB,AF,2010.0,1,0,1
MZ,ES,2013.0,1,0,1
KR,BH,2003.0,1,0,1
BF,BJ,2011.0,1,0,1
JP,TZ,2012.0,3,0,3
PK,KR,2001.0,4,0,4
CZ,CM,2019.0,1,0,1
PL,RE,2007.0,1,0,1
DE,UG,2000.0,1,0,1
RO,DK,2011.0,3,0,3
SD,IE,2010.0,2,0,2
NP,NO,1997.0,1,0,1
IT,MG,2012.0,1,0,1
SI,AM,2011.0,1,0,1
AR,PL,2003.0,2,0,2
NC,US,2004.0,3,0,3
RE,MG,2017.0,2,0,2
US,SR,2016.0,1,0,1
RO,ZA,1999.0,1,0,1
KY,,2014.0,3,0,3
MY,MX,2002.0,1,0,1
NP,AU,2006.0,1,0,1
PY,BE,2009.0,1,0,1
NZ,LB,2016.0,2,0,2
TR,PS,2000.0,1,0,1
NG,LK,2010.0,1,0,1
CU,NZ,2009.0,1,0,1
IT,AL,2017.0,9,0,9
CL,SV,2022.0,2,0,2
MW,UG,2010.0,2,0,2
BY,RS,2011.0,1,0,1
KE,BR,2014.0,2,0,2
DE,QA,2005.0,3,0,3
NZ,PG,2011.0,1,0,1
EC,MA,2021.0,1,0,1
NO,ML,2007.0,1,0,1
CM,SN,1999.0,1,0,1
TZ,CD,2020.0,3,0,3
JO,TZ,2010.0,1,0,1
PA,NI,2020.0,1,0,1
MZ,GH,2021.0,1,0,1
LU,ML,2005.0,1,0,1
SD,BR,2021.0,3,0,3
LK,EC,2021.0,1,0,1
BE,CF,2010.0,1,0,1
AR,ME,2016.0,1,0,1
nan,MA,2023.0,1,0,1
IE,JO,2019.0,1,0,1
CA,AZ,1997.0,1,0,1
NL,DZ,2020.0,1,0,1
CA,HT,2021.0,1,0,1
MA,BR,2002.0,1,0,1
BH,CH,2016.0,2,0,2
SV,PE,2010.0,1,0,1
NO,SI,1998.0,1,0,1
PW,,2016.0,1,0,1
IT,SK,2016.0,4,0,4
KW,MY,2012.0,3,0,3
LT,RU,1997.0,1,0,1
SA,IQ,2000.0,2,0,2
SY,AE,2019.0,2,0,2
MA,LV,2017.0,1,0,1
NE,NG,2011.0,1,0,1
BA,SO,2021.0,1,0,1
BO,GE,2019.0,1,0,1
BD,CY,2016.0,1,0,1
LV,BG,2016.0,2,0,2
US,LC,2015.0,1,0,1
SG,NP,2022.0,1,0,1
BA,IT,2019.0,1,0,1
LV,FR,2020.0,1,0,1
KW,NG,2017.0,1,0,1
GR,PT,2016.0,5,0,5
IL,AM,2005.0,1,0,1
MZ,VE,2015.0,1,0,1
CA,UZ,1999.0,3,0,3
BW,NL,2001.0,1,0,1
LK,GH,2017.0,1,0,1
VE,NL,2004.0,2,0,2
AR,PS,2015.0,1,0,1
RO,MY,2010.0,1,0,1
PK,ZW,2013.0,1,0,1
ET,SO,2021.0,1,0,1
RW,BW,2017.0,1,0,1
IN,LB,2002.0,1,0,1
JM,nan,2005.0,2,0,2
QA,KW,2004.0,1,0,1
FR,BH,2013.0,2,0,2
MA,ML,2015.0,1,0,1
DK,SA,2002.0,1,0,1
DE,GF,2009.0,1,0,1
DE,MT,2015.0,1,0,1
NO,VN,2008.0,4,0,4
SJ,CN,2013.0,1,0,1
KW,NG,2019.0,3,0,3
MC,US,2014.0,1,0,1
KY,GB,2011.0,1,0,1
RO,CL,2014.0,2,0,2
BF,CG,2017.0,3,0,3
ET,EG,2003.0,1,0,1
CN,EC,2009.0,1,0,1
OM,SZ,1999.0,1,0,1
UG,NO,2005.0,1,0,1
GE,ES,2021.0,1,0,1
HU,NG,2004.0,2,0,2
nan,TW,2021.0,1,0,1
IR,IS,2021.0,1,0,1
GA,ZM,2021.0,1,0,1
LV,PL,2013.0,2,0,2
SK,CW,2010.0,1,0,1
MK,CA,2002.0,1,0,1
TW,BD,2002.0,1,0,1
SE,PH,2000.0,1,0,1
IT,LU,2002.0,1,0,1
CH,LA,2018.0,1,0,1
PA,EC,2013.0,1,0,1
UG,CY,2006.0,1,0,1
BD,BW,2013.0,1,0,1
EC,PH,2022.0,1,0,1
CM,KE,2007.0,1,0,1
BG,PL,2020.0,1,0,1
NG,MD,2022.0,1,0,1
BJ,CN,1997.0,1,0,1
US,VG,1997.0,3,0,3
BY,IR,2008.0,1,0,1
JO,SY,1998.0,1,0,1
CG,SN,2002.0,1,0,1
SA,RW,2016.0,1,0,1
nan,RE,1999.0,1,0,1
ID,VN,1999.0,1,0,1
BD,AE,2014.0,1,0,1
KP,,2000.0,1,0,1
BG,IE,2000.0,1,0,1
US,SZ,2013.0,1,0,1
TG,,2004.0,5,0,5
LV,PH,2014.0,3,0,3
SE,MN,2014.0,1,0,1
NG,NP,2015.0,1,0,1
SG,CR,2004.0,1,0,1
HR,MY,2022.0,1,0,1
HT,AU,2004.0,1,0,1
BG,ZA,2016.0,2,0,2
CR,PK,2016.0,1,0,1
KZ,LU,2016.0,1,0,1
BG,EE,2010.0,1,0,1
SA,BD,2000.0,2,0,2
BF,CI,2014.0,1,0,1
PE,ME,2016.0,1,0,1
FR,CU,1999.0,1,0,1
GN,LU,2017.0,1,0,1
AW,US,2018.0,1,0,1
LV,CA,2016.0,1,0,1
nan,GE,2006.0,2,0,2
MG,CM,2010.0,1,0,1
GR,SA,2013.0,5,0,5
JP,EE,2016.0,2,0,2
CA,PY,2014.0,2,0,2
JM,IN,2010.0,2,0,2
DO,CU,2009.0,2,0,2
US,GL,2008.0,2,0,2
ID,EE,2016.0,2,0,2
CR,PR,2017.0,1,0,1
LB,SE,2007.0,1,0,1
CO,TW,2021.0,1,0,1
IN,PT,2002.0,2,0,2
IR,CL,2011.0,1,0,1
PT,ST,2004.0,2,0,2
GT,MY,2007.0,1,0,1
GB,AF,2019.0,1,0,1
MX,CY,2018.0,2,0,2
VE,PY,2014.0,1,0,1
KE,BD,2013.0,1,0,1
LK,TW,1997.0,2,0,2
CH,NG,2011.0,4,0,4
,GW,2000.0,6,0,6
KZ,IR,2009.0,1,0,1
PL,MK,2009.0,3,0,3
RU,PK,2003.0,1,0,1
IL,PT,2007.0,2,0,2
TH,ZM,2018.0,1,0,1
ES,AZ,2012.0,1,0,1
GP,SK,1999.0,1,0,1
NO,TH,2016.0,2,0,2
PA,UA,2018.0,1,0,1
AU,MN,2003.0,1,0,1
GB,LT,2000.0,1,0,1
ST,,2008.0,2,0,2
BE,BN,2000.0,1,0,1
MQ,BR,2003.0,1,0,1
AO,nan,2022.0,1,0,1
NO,CU,1999.0,1,0,1
SS,CA,2009.0,1,0,1
US,GM,1999.0,2,0,2
CY,HR,2018.0,1,0,1
TN,NE,2014.0,1,0,1
CR,KE,2006.0,1,0,1
LT,CA,2001.0,1,0,1
CN,SS,2010.0,1,0,1
SD,CN,2010.0,1,0,1
NL,ME,2012.0,1,0,1
GH,KZ,2022.0,1,0,1
ZM,GR,2016.0,1,0,1
BT,PK,2016.0,1,0,1
LT,BY,2013.0,1,0,1
BG,ME,2012.0,1,0,1
ES,NG,2013.0,2,0,2
CO,EG,2006.0,1,0,1
BH,MY,2011.0,2,0,2
EG,CL,2022.0,1,0,1
,ER,2013.0,2,0,2
PH,CZ,2018.0,1,0,1
BW,NP,2017.0,1,0,1
NG,TZ,2013.0,3,0,3
AO,JP,2017.0,1,0,1
GR,EE,2012.0,1,0,1
AM,IT,1997.0,2,0,2
HR,RU,1998.0,1,0,1
AR,CZ,2002.0,1,0,1
ES,NP,2016.0,1,0,1
NZ,BR,2001.0,1,0,1
ES,PY,2003.0,1,0,1
RU,CM,2009.0,1,0,1
BJ,EG,2019.0,1,0,1
TW,BR,2012.0,5,0,5
LK,ZA,2020.0,1,0,1
MY,CG,2019.0,1,0,1
GF,CF,2002.0,1,0,1
PL,CL,2005.0,1,0,1
CH,MA,1998.0,1,0,1
HK,BR,2021.0,1,0,1
SA,CL,2004.0,1,0,1
MY,GT,2008.0,1,0,1
CM,ET,2020.0,1,0,1
CO,GD,2012.0,1,0,1
TD,,2011.0,2,0,2
BM,DE,2021.0,1,0,1
CA,LY,2004.0,1,0,1
AM,GB,2002.0,1,0,1
LS,,2007.0,1,0,1
HR,HK,2004.0,1,0,1
GE,UA,2004.0,1,0,1
NG,ML,2017.0,2,0,2
UA,SG,2002.0,1,0,1
PT,BD,2015.0,2,0,2
AU,BH,2006.0,1,0,1
MK,IT,2018.0,2,0,2
BE,GF,2021.0,1,0,1
CA,PA,2006.0,1,0,1
VE,NZ,2016.0,1,0,1
LK,CH,2002.0,2,0,2
CH,VG,2000.0,2,0,2
DE,AE,2006.0,3,0,3
KW,ES,2019.0,1,0,1
GE,KZ,2016.0,1,0,1
DO,PE,2004.0,2,0,2
KE,NA,2020.0,1,0,1
TN,AE,2011.0,1,0,1
EE,CZ,2021.0,2,0,2
IE,TN,2012.0,1,0,1
BY,IT,2008.0,4,0,4
OM,TH,2017.0,1,0,1
FR,MU,2017.0,1,0,1
FO,SE,2002.0,1,0,1
OM,PH,2019.0,1,0,1
PT,HU,2020.0,2,0,2
GT,SV,2011.0,2,0,2
BN,LK,2017.0,2,0,2
NG,NZ,2011.0,1,0,1
NL,KW,2009.0,1,0,1
DZ,LU,2021.0,1,0,1
LU,MA,2007.0,1,0,1
nan,LV,2010.0,1,0,1
ID,KG,2021.0,1,1,0
DO,US,2005.0,1,5,-4
MY,DK,2022.0,1,1,0
BW,NG,2017.0,1,2,-1
EE,ES,2016.0,1,3,-2
SA,TR,2011.0,4,9,-5
NO,SG,2007.0,1,1,0
CA,UG,2012.0,1,3,-2
NG,IN,1999.0,2,1,1
SA,AT,2020.0,2,1,1
AE,NO,2021.0,3,1,2
TW,UA,2015.0,2,2,0
HR,CZ,2001.0,1,1,0
PH,IE,1999.0,2,1,1
CR,PA,2011.0,1,1,0
QA,DE,2022.0,5,2,3
ZA,PL,2012.0,1,1,0
SK,MX,2008.0,2,1,1
PL,GE,2011.0,3,1,2
FI,ET,2016.0,1,2,-1
nan,HR,2017.0,2,1,1
BJ,CG,2008.0,2,1,1
CG,NC,2007.0,1,2,-1
US,MA,2023.0,1,1,0
FJ,AU,2022.0,1,4,-3
NG,TH,2018.0,3,3,0
PE,CU,1998.0,1,1,0
LU,AU,2012.0,2,1,1
OM,KW,2008.0,2,2,0
PY,PE,2021.0,5,2,3
MK,GB,2009.0,2,5,-3
HK,SG,2015.0,1,3,-2
ZA,CO,2016.0,1,2,-1
CZ,MK,2001.0,1,1,0
GT,CL,2013.0,1,1,0
MY,ZA,2010.0,1,2,-1
BE,DZ,2017.0,2,6,-4
CM,IN,2021.0,2,4,-2
MA,AU,2001.0,2,1,1
NL,HR,1998.0,1,3,-2
HR,nan,2012.0,2,1,1
OM,PH,2017.0,1,1,0
NZ,IQ,2018.0,1,1,0
TR,SI,2013.0,1,1,0
ZA,VN,2017.0,1,1,0
GB,MD,2000.0,1,1,0
MU,GB,2013.0,1,2,-1
nan,CM,2021.0,4,12,-8
ET,DK,2018.0,3,7,-4
CA,HR,2000.0,1,2,-1
FI,nan,2022.0,1,1,0
US,PR,2004.0,1,6,-5
HU,CN,2001.0,1,2,-1
IL,RS,2002.0,1,1,0
TR,SA,1999.0,1,1,0
UG,DE,1998.0,1,1,0
NZ,TR,2012.0,1,4,-3
RS,MK,2004.0,1,1,0
IN,UY,2014.0,1,1,0
UY,PH,2020.0,2,2,0
JO,IT,2018.0,1,4,-3
ET,CN,2010.0,1,1,0
NG,IL,2018.0,1,5,-4
LB,JO,2022.0,1,2,-1
IE,PT,2009.0,4,6,-2
KZ,AM,2022.0,1,1,0
PH,BD,2017.0,2,1,1
GR,RU,1999.0,2,1,1
CN,RO,2000.0,1,2,-1
FR,NE,2009.0,2,3,-1
ES,ME,2019.0,1,1,0
BE,MC,2018.0,1,1,0
ES,RU,2023.0,2,1,1
PE,NZ,2020.0,1,1,0
DE,CR,2004.0,1,2,-1
HR,PT,2018.0,1,1,0
AT,EE,2011.0,1,3,-2
SI,GR,2007.0,1,1,0
IE,ZA,2001.0,1,3,-2
CA,CM,2022.0,1,2,-1
SI,HU,2018.0,1,2,-1
AU,SD,2020.0,1,2,-1
CR,MX,1997.0,2,4,-2
EG,TZ,2012.0,1,1,0
PK,BE,2017.0,1,3,-2
IN,CY,2014.0,1,1,0
AT,BD,2018.0,1,1,0
TR,AU,1998.0,1,3,-2
HU,BR,2010.0,2,2,0
SY,MY,2021.0,1,3,-2
US,FJ,2011.0,2,6,-4
AM,DE,2003.0,3,4,-1
PE,PA,2015.0,2,3,-1
SA,BE,2015.0,1,8,-7
NI,US,2002.0,1,1,0
AM,IT,1998.0,3,2,1
UG,NL,2022.0,1,1,0
KE,NO,2020.0,1,5,-4
ZM,US,1998.0,1,2,-1
KE,ES,2021.0,3,2,1
AU,LY,2009.0,1,1,0
IE,AR,2007.0,2,2,0
CZ,AR,2013.0,1,3,-2
ZA,IL,2008.0,1,1,0
AR,IT,2023.0,1,2,-1
US,UZ,2001.0,1,7,-6
ML,US,2005.0,1,2,-1
PK,ES,2010.0,1,3,-2
PL,KR,2013.0,2,8,-6
HR,CA,1999.0,1,6,-5
EG,NZ,2006.0,1,1,0
CH,BW,2022.0,1,1,0
NO,UG,2008.0,2,1,1
ZM,GB,2009.0,1,3,-2
CL,UA,2004.0,1,2,-1
GB,LA,2013.0,1,2,-1
VN,CA,2000.0,1,1,0
nan,CR,2006.0,1,2,-1
AE,NZ,2019.0,3,2,1
IL,NO,2014.0,1,1,0
EC,NI,2017.0,1,1,0
KH,TH,2015.0,2,1,1
TN,IR,2010.0,1,1,0
CO,IT,2000.0,1,3,-2
TN,OM,2013.0,1,1,0
DE,CO,2023.0,1,1,0
AT,SA,2015.0,2,1,1
KW,SG,2010.0,1,1,0
IR,AR,2011.0,1,1,0
ME,PT,2021.0,1,1,0
IL,BD,2011.0,1,1,0
US,SC,2002.0,1,1,0
DZ,ZA,2013.0,1,1,0
UA,UZ,2007.0,1,4,-3
CR,DO,2018.0,1,1,0
BD,TW,2015.0,1,3,-2
LK,TH,2014.0,1,2,-1
EE,BE,2011.0,1,2,-1
BR,PA,2015.0,2,3,-1
RU,IQ,2016.0,1,2,-1
UY,CA,2009.0,1,3,-2
BY,CA,2018.0,1,1,0
MR,GB,2003.0,1,1,0
MZ,PT,2007.0,2,1,1
RO,BE,2023.0,1,1,0
PH,TW,2023.0,1,1,0
SD,IE,2019.0,1,3,-2
IN,KW,2001.0,1,3,-2
BG,AU,2009.0,1,2,-1
EC,NI,2019.0,2,4,-2
ML,CA,2014.0,1,1,0
MY,KE,2011.0,1,1,0
RO,MD,2008.0,1,4,-3
CA,MW,2018.0,1,1,0
DE,ML,2016.0,1,2,-1
VN,PK,2012.0,1,1,0
HR,QA,2021.0,1,1,0
JM,IN,2019.0,1,3,-2
MX,VN,2023.0,1,1,0
CR,GB,2010.0,1,1,0
LT,IE,2008.0,1,1,0
CZ,BA,2008.0,1,1,0
SY,US,2000.0,1,1,0
KW,FR,2008.0,1,3,-2
VN,NZ,2023.0,1,1,0
ZA,ML,2021.0,1,1,0
MY,IL,2013.0,1,2,-1
JP,MY,1997.0,1,1,0
GR,BE,2023.0,1,2,-1
ET,CH,2011.0,1,1,0
PT,SG,2002.0,1,1,0
BD,IR,2014.0,5,3,2
PK,ES,2017.0,2,5,-3
DZ,SG,2017.0,2,2,0
SE,LU,2017.0,2,1,1
IN,KN,2018.0,1,1,0
QA,CL,2018.0,1,1,0
LU,FI,2008.0,1,10,-9
DZ,SG,2019.0,1,9,-8
NL,TZ,2012.0,2,3,-1
CH,ML,2007.0,1,1,0
KH,AG,2021.0,1,2,-1
SE,DZ,2013.0,1,2,-1
SA,ES,2003.0,1,1,0
IS,IT,2016.0,1,5,-4
CH,CM,2017.0,1,6,-5
QA,NG,2019.0,1,2,-1
BD,BR,2020.0,1,1,0
UA,KR,2013.0,1,2,-1
nan,RS,2014.0,2,1,1
DE,TZ,2014.0,2,5,-3
LA,UZ,2007.0,1,0,1
HK,IN,2020.0,1,0,1
IE,UA,2012.0,1,0,1
CV,RU,2016.0,1,0,1
IR,SI,2017.0,1,0,1
MM,,2012.0,3,0,3
PE,nan,1998.0,1,0,1
LK,GH,2019.0,1,0,1
QA,JP,2021.0,2,0,2
MX,KR,1999.0,1,0,1
ET,ER,2016.0,1,0,1
PH,EG,2019.0,1,0,1
SE,AZ,2019.0,1,0,1
CZ,SA,2023.0,1,0,1
RE,GB,2020.0,3,0,3
AR,CZ,2005.0,1,0,1
GB,MZ,2004.0,2,0,2
QA,MY,2008.0,1,0,1
MY,TH,2007.0,1,0,1
ET,CZ,2014.0,1,0,1
UZ,AU,2016.0,3,0,3
VA,US,2007.0,1,0,1
CG,PE,2010.0,1,0,1
SV,GT,2019.0,1,0,1
ZA,PA,1997.0,2,0,2
PS,AE,2013.0,1,0,1
HN,RU,2019.0,1,0,1
CG,JP,2014.0,1,0,1
SZ,BW,2020.0,1,0,1
RO,IL,2008.0,1,0,1
VN,MM,2017.0,1,0,1
MA,KE,2016.0,1,0,1
BW,ID,2018.0,1,0,1
YE,,2002.0,1,0,1
SY,JP,2019.0,1,0,1
RU,SG,2001.0,2,0,2
AL,XK,2014.0,1,0,1
UY,HU,2009.0,1,0,1
CO,GW,2016.0,1,0,1
IL,CR,2014.0,1,0,1
AF,JP,2007.0,1,0,1
KH,PT,2013.0,1,0,1
AE,YE,1999.0,1,0,1
CG,BJ,2007.0,1,0,1
SX,,2021.0,1,0,1
IT,AE,1997.0,1,0,1
FI,OM,2002.0,1,0,1
GR,nan,2009.0,2,0,2
JO,IR,2014.0,2,0,2
DZ,HU,2017.0,1,0,1
RE,CH,2017.0,1,0,1
DZ,HU,2019.0,1,0,1
XK,MK,2010.0,1,0,1
CM,CF,2018.0,2,0,2
DZ,MR,2017.0,1,0,1
NO,KW,2005.0,1,0,1
VE,AT,2015.0,1,0,1
ZA,BE,2023.0,2,0,2
HR,MX,2016.0,1,0,1
VI,PL,2000.0,3,0,3
CD,ZA,2008.0,2,0,2
UG,BN,2016.0,1,0,1
CI,GH,2022.0,1,0,1
BE,JO,2006.0,1,0,1
GA,AT,2009.0,1,0,1
IL,IE,2002.0,1,0,1
GN,,2025.0,1,0,1
NG,MA,2022.0,1,0,1
GM,UG,2004.0,1,0,1
TG,ZA,2006.0,1,0,1
NG,SY,2007.0,1,0,1
RU,FJ,1999.0,1,0,1
NZ,MX,2009.0,1,0,1
GE,PK,2009.0,1,0,1
GP,,2009.0,3,0,3
ER,QA,2014.0,1,0,1
MZ,NO,2005.0,1,0,1
AU,IS,2023.0,1,0,1
IE,IQ,2010.0,1,0,1
TG,BF,2022.0,1,0,1
CU,CZ,2002.0,1,0,1
CA,IS,2005.0,1,0,1
EE,PL,2023.0,1,0,1
BB,IT,2010.0,1,0,1
GB,BI,2018.0,1,0,1
DK,JO,2019.0,1,0,1
RU,AE,2016.0,1,0,1
GA,PK,2015.0,1,0,1
UA,NO,2016.0,2,0,2
ZA,FJ,2017.0,1,0,1
BE,LY,2014.0,1,0,1
PT,SY,2019.0,1,0,1
BW,NP,2010.0,1,0,1
PL,SY,2008.0,1,0,1
VN,MX,1997.0,1,0,1
US,CR,2023.0,2,0,2
BE,KZ,2008.0,1,0,1
MA,IE,2016.0,1,0,1
TZ,JP,2001.0,1,0,1
IR,MD,2013.0,1,0,1
IE,IQ,2019.0,3,0,3
LK,BN,2010.0,1,0,1
FK,CL,2010.0,1,0,1
DE,JM,2017.0,1,0,1
BN,AE,2018.0,1,0,1
JO,RU,2001.0,1,0,1
LB,CO,2013.0,1,0,1
GF,,2007.0,2,0,2
MW,UG,2017.0,3,0,3
CD,KH,2019.0,1,0,1
SC,US,2012.0,1,0,1
nan,KZ,2018.0,1,0,1
XK,HU,2017.0,1,0,1
LY,FR,2012.0,1,0,1
NO,GR,2004.0,2,0,2
IQ,PK,2009.0,1,0,1
PE,NO,2017.0,2,0,2
GA,ET,2018.0,1,0,1
RU,AF,2022.0,1,0,1
CH,VN,2002.0,1,0,1
MK,NZ,2009.0,1,0,1
PE,EG,2013.0,1,0,1
DK,EE,2008.0,3,0,3
QA,NG,2017.0,1,0,1
LT,PT,2012.0,1,0,1
CU,DK,2017.0,1,0,1
SG,ZM,2020.0,1,0,1
BD,PE,2020.0,1,0,1
DK,CY,2021.0,1,0,1
UG,PG,2021.0,1,0,1
CH,MU,2014.0,1,0,1
LU,UA,2016.0,1,0,1
UZ,TW,2012.0,1,0,1
BG,ZW,2018.0,1,0,1
PW,TW,2020.0,1,0,1
NE,MX,2015.0,1,0,1
TT,CH,2021.0,1,0,1
BJ,TN,2006.0,1,0,1
nan,LA,2019.0,1,0,1
TZ,IR,2020.0,1,0,1
CZ,OM,2010.0,1,0,1
DO,NL,2005.0,1,0,1
BW,ZA,2000.0,2,0,2
AR,BY,2018.0,1,0,1
IE,CZ,1999.0,1,0,1
HR,RO,2009.0,1,0,1
GH,DE,1997.0,3,0,3
AZ,NG,2018.0,1,0,1
PH,MM,2006.0,1,0,1
CA,IS,2002.0,1,0,1
ES,CY,2015.0,2,0,2
IT,MM,2013.0,1,0,1
MK,NL,2012.0,1,0,1
IN,BB,2010.0,1,0,1
BR,LK,2012.0,1,0,1
NG,ES,2012.0,1,0,1
MZ,EG,2022.0,1,0,1
GB,KZ,2010.0,1,0,1
IN,YE,2008.0,1,0,1
GF,AU,2019.0,1,0,1
ME,RS,1999.0,1,0,1
PS,IE,2016.0,1,0,1
BS,GB,2011.0,1,0,1
YE,,2005.0,1,0,1
EC,DK,2009.0,1,0,1
SD,OM,2015.0,1,0,1
CL,PY,2008.0,2,0,2
nan,BG,2021.0,1,0,1
TN,PG,2010.0,2,0,2
AU,PA,1999.0,1,0,1
CN,UG,1999.0,1,0,1
PH,CO,1997.0,1,0,1
NL,BN,2018.0,1,0,1
CU,CN,2022.0,1,0,1
nan,HR,2019.0,1,0,1
IN,BB,2019.0,1,0,1
CD,NP,2021.0,1,0,1
HT,,2004.0,1,0,1
PL,AR,2009.0,1,0,1
MA,UG,2006.0,1,0,1
BF,CH,2004.0,1,0,1
US,ME,2002.0,1,0,1
GY,GF,2018.0,1,0,1
ST,PT,2019.0,1,0,1
SN,IL,2001.0,1,0,1
GH,KE,2003.0,1,0,1
KH,IT,2019.0,1,0,1
IR,CD,2016.0,1,0,1
FR,MU,2019.0,1,0,1
NC,CG,2005.0,1,0,1
UA,EE,2011.0,1,0,1
NL,PS,2009.0,1,0,1
MA,MR,2012.0,1,0,1
EG,EE,2016.0,1,0,1
MX,EG,2022.0,1,0,1
ZA,VN,2019.0,1,0,1
CN,BN,2012.0,1,0,1
AT,VN,2007.0,2,0,2
CN,SI,1999.0,1,0,1
GB,IM,2019.0,1,0,1
PH,BE,2000.0,1,0,1
ES,MC,2009.0,1,0,1
RS,QA,2022.0,1,0,1
BH,RS,2020.0,1,0,1
ID,BD,2007.0,2,0,2
KR,HU,1999.0,1,0,1
KP,SE,2002.0,1,0,1
GE,TR,2000.0,1,0,1
IL,BO,2015.0,1,0,1
AL,CA,2019.0,1,0,1
KZ,AZ,2017.0,1,0,1
RO,IS,2019.0,1,0,1
IT,AL,2010.0,1,0,1
AT,LB,2001.0,1,0,1
BN,FR,2019.0,1,0,1
PK,FJ,2018.0,1,0,1
ME,CZ,2017.0,1,0,1
ZA,FJ,2019.0,1,0,1
FJ,,1999.0,1,0,1
OM,NG,2000.0,1,0,1
PH,OM,2009.0,1,0,1
NO,CD,2005.0,1,0,1
YE,JO,2006.0,1,0,1
GM,US,2011.0,2,0,2
RO,IS,2017.0,1,0,1
SI,CM,2016.0,1,0,1
MZ,DE,2020.0,1,0,1
SA,ID,2008.0,1,0,1
DE,JM,2010.0,1,0,1
IT,ZW,2011.0,1,0,1
AU,MA,2021.0,1,0,1
MU,JE,2014.0,1,0,1
FJ,NO,2022.0,1,0,1
SN,SG,2009.0,1,0,1
AU,ZW,2020.0,1,0,1
RE,NE,2014.0,1,0,1
SN,KE,2014.0,1,0,1
KW,ES,2017.0,1,0,1
IT,TD,2015.0,1,0,1
ER,CN,2021.0,1,0,1
NL,CO,1997.0,1,0,1
AU,LT,2022.0,1,0,1
KH,VN,2014.0,1,0,1
SA,FR,2023.0,1,0,1
GB,BS,2007.0,1,0,1
ZW,GH,2014.0,1,0,1
SK,KE,2006.0,1,0,1
CO,AM,2019.0,1,0,1
PS,TR,2001.0,1,0,1
MT,NL,2022.0,1,0,1
BH,IN,2023.0,1,0,1
,SA,2021.0,1,0,1
ES,KH,2017.0,1,0,1
MD,IE,2017.0,1,0,1
RU,MM,2010.0,1,0,1
FI,EG,2004.0,1,0,1
RO,UY,2020.0,1,0,1
CZ,BH,2011.0,1,0,1
SE,BO,2023.0,1,0,1
GE,AT,2020.0,1,0,1
TM,RU,2015.0,1,0,1
BE,MR,2017.0,1,0,1
US,PT,2011.0,171,148,23
SG,IN,2020.0,165,122,43
US,CL,2013.0,212,214,-2
PK,GB,2020.0,150,210,-60
MD,TN,2010.0,14,7,7
US,CO,2016.0,365,297,68
US,nan,2012.0,291,301,-10
CZ,SE,2013.0,10,12,-2
SE,CZ,2015.0,14,16,-2
ES,MX,2012.0,701,644,57
CL,MX,2012.0,155,146,9
US,TW,2003.0,595,500,95
CH,US,2011.0,667,889,-222
SG,US,2008.0,230,253,-23
BR,FR,2002.0,70,75,-5
US,HU,2014.0,123,84,39
SE,UA,2007.0,10,3,7
GB,SE,2013.0,213,161,52
EG,KR,2018.0,11,11,0
DE,DK,2014.0,175,135,40
BR,IT,2012.0,197,214,-17
DE,CN,2004.0,194,152,42
NZ,GB,2015.0,245,250,-5
DE,ES,1998.0,51,56,-5
UA,US,2021.0,91,79,12
US,CY,2017.0,20,19,1
CH,IN,2010.0,31,46,-15
MX,CO,2007.0,129,113,16
IN,BE,2012.0,36,21,15
BR,PT,2007.0,431,435,-4
PK,OM,2015.0,9,2,7
AU,PK,2012.0,14,22,-8
GB,CA,2000.0,326,417,-91
PT,BR,2016.0,1133,1013,120
CH,CA,1999.0,43,43,0
EG,US,2015.0,219,290,-71
ES,AR,2012.0,336,324,12
KR,CN,2016.0,303,273,30
DE,AT,2021.0,543,488,55
GB,TH,1998.0,20,7,13
MY,ID,2020.0,395,223,172
US,ES,2021.0,742,863,-121
SE,US,2012.0,362,380,-18
PH,CZ,2019.0,4,1,3
SE,BR,2006.0,10,9,1
SG,CN,2006.0,316,198,118
US,PK,2021.0,384,368,16
PK,MY,2013.0,70,32,38
VE,CL,2002.0,8,8,0
NL,CN,2007.0,64,64,0
SE,FR,2010.0,69,56,13
MX,SE,2019.0,12,16,-4
US,IE,2020.0,572,514,58
AU,BR,2002.0,21,23,-2
AU,BE,2014.0,36,57,-21
GB,IT,2003.0,218,245,-27
GB,PK,2019.0,247,175,72
CN,GB,2004.0,301,329,-28
BD,US,2022.0,144,97,47
CA,AU,2012.0,382,318,64
GB,BE,2016.0,141,163,-22
DK,US,2013.0,248,307,-59
NL,GB,2014.0,362,294,68
JP,CN,1998.0,204,191,13
SN,FR,2018.0,40,47,-7
AE,EG,2017.0,32,35,-3
CN,FR,2010.0,198,266,-68
IN,JP,2019.0,149,136,13
RS,HR,2017.0,127,134,-7
BR,US,2003.0,428,484,-56
BR,CA,2016.0,268,315,-47
FI,TW,2015.0,2,1,1
DE,EE,2013.0,55,37,18
PL,DE,2021.0,102,115,-13
ES,CL,2012.0,328,320,8
NL,GR,2021.0,19,20,-1
IN,JP,2010.0,115,120,-5
MX,CA,2014.0,42,50,-8
SE,GB,2015.0,161,254,-93
FR,DE,2009.0,481,487,-6
DE,IT,2019.0,320,428,-108
IT,SE,2000.0,119,28,91
IT,FR,2005.0,243,217,26
CH,IN,2017.0,59,67,-8
VE,CU,2009.0,7,11,-4
SE,FR,2019.0,83,103,-20
PE,ES,2002.0,22,20,2
PE,AR,2004.0,5,7,-2
GB,KR,2022.0,72,78,-6
IT,AR,1997.0,25,16,9
AU,GR,1998.0,2,1,1
SA,PK,2019.0,127,125,2
GB,ES,2009.0,289,311,-22
IR,NL,2012.0,38,27,11
BR,LU,2020.0,5,3,2
MY,CN,2014.0,58,90,-32
FR,VN,2013.0,41,23,18
GB,NO,2021.0,108,56,52
TR,RS,2014.0,78,79,-1
AT,FR,2013.0,44,56,-12
SA,IE,2010.0,2,1,1
VE,BR,2009.0,18,9,9
ES,CO,2020.0,517,553,-36
JP,nan,2012.0,50,42,8
LB,EG,2017.0,19,20,-1
US,AT,2021.0,189,179,10
RS,TR,2010.0,72,92,-20
JP,KR,2008.0,279,240,39
BE,FR,2010.0,292,296,-4
KZ,TR,2020.0,42,59,-17
RU,UA,2001.0,117,58,59
EC,ES,2020.0,196,208,-12
RS,HR,2010.0,59,104,-45
FR,JP,1999.0,87,53,34
CN,HK,2021.0,162,118,44
EC,GB,2021.0,8,6,2
EC,MX,2019.0,112,193,-81
VN,KR,2012.0,26,45,-19
CA,AT,2005.0,20,21,-1
GB,RU,2019.0,149,95,54
ZW,ZA,2023.0,2,1,1
CL,BR,2008.0,38,42,-4
MY,DE,2005.0,4,5,-1
NZ,ES,2010.0,6,4,2
ZA,IE,2011.0,9,9,0
GR,IT,2018.0,30,34,-4
CU,BR,2015.0,37,23,14
BR,JP,2001.0,23,29,-6
US,GE,2009.0,164,137,27
IR,IT,2015.0,40,27,13
GR,JP,2018.0,29,32,-3
JP,CA,2001.0,91,95,-4
IT,FR,2002.0,185,182,3
RU,IT,2000.0,27,22,5
BR,NZ,2015.0,9,7,2
GB,SK,2004.0,18,9,9
IE,ES,2007.0,11,23,-12
AT,IT,2021.0,56,61,-5
SG,NL,2011.0,12,14,-2
RS,HR,2019.0,154,148,6
AE,IR,2015.0,9,5,4
UA,BG,2021.0,13,9,4
PA,AR,2022.0,4,1,3
US,MX,2023.0,10,9,1
JP,DE,2006.0,151,148,3
TH,IN,2021.0,17,25,-8
NZ,TH,2007.0,6,1,5
CN,KR,2004.0,157,169,-12
LK,KR,2014.0,2,2,0
MY,SG,2020.0,178,176,2
FR,GB,2001.0,371,262,109
IN,DK,2022.0,20,15,5
SE,CN,2009.0,82,68,14
US,EG,2013.0,208,150,58
PL,ES,2014.0,22,17,5
KR,CA,2007.0,41,35,6
SG,MY,2019.0,181,166,15
CZ,GH,2011.0,1,1,0
IE,CN,2011.0,47,43,4
LB,EG,2019.0,26,22,4
IN,YE,2013.0,1,1,0
IN,MX,2007.0,11,9,2
IT,BE,2013.0,136,105,31
DE,IT,2010.0,166,270,-104
FR,DZ,2018.0,186,106,80
RO,CH,2020.0,13,16,-3
CU,ES,2004.0,58,59,-1
MX,PY,2016.0,15,6,9
US,UA,1999.0,14,30,-16
BR,MX,2012.0,72,106,-34
SG,CA,2006.0,29,37,-8
MX,CU,2013.0,46,64,-18
BE,FR,2017.0,383,372,11
FJ,AU,2016.0,7,7,0
BE,DZ,2018.0,9,3,6
MX,DE,2015.0,44,41,3
PT,ES,2022.0,112,110,2
AU,NZ,2008.0,102,171,-69
GB,DK,1997.0,31,35,-4
DK,CL,2017.0,7,2,5
PT,GB,2008.0,69,86,-17
CA,NL,2014.0,93,82,11
GB,JP,2007.0,280,286,-6
IE,GR,2017.0,2,13,-11
SE,CL,2009.0,7,6,1
BD,DE,2019.0,16,8,8
VN,GR,1997.0,2,2,0
FR,ZA,2016.0,38,36,2
IN,JP,2017.0,148,146,2
IN,ES,2017.0,22,32,-10
NG,GB,2020.0,128,112,16
IL,DE,2003.0,33,23,10
RO,FI,1999.0,1,2,-1
HN,ES,2017.0,5,11,-6
MX,UY,2007.0,10,4,6
CH,BR,2013.0,50,37,13
PK,DE,2021.0,22,32,-10
AR,CO,2016.0,123,114,9
BR,FR,2005.0,103,98,5
IQ,US,2020.0,70,116,-46
KR,NG,2016.0,7,9,-2
JP,CN,1997.0,126,132,-6
JP,NZ,2011.0,9,8,1
DE,SG,2018.0,40,50,-10
IR,CY,2016.0,8,5,3
ZA,DE,2016.0,64,59,5
RU,JP,2015.0,55,64,-9
RS,AT,2004.0,2,1,1
PK,SA,2022.0,65,64,1
BR,ST,2021.0,22,20,2
CO,NL,2019.0,19,17,2
RO,GB,2014.0,53,34,19
TN,IR,2018.0,8,7,1
AU,MY,2006.0,21,23,-2
US,NP,2021.0,73,74,-1
JP,HK,2020.0,15,14,1
US,EC,2015.0,72,32,40
IL,LU,2012.0,1,2,-1
RO,MD,2013.0,4,2,2
CN,NL,2023.0,21,11,10
DE,PL,2005.0,90,77,13
DK,DE,2007.0,73,115,-42
SG,GB,2022.0,98,89,9
CA,ES,2013.0,72,103,-31
ES,IE,2005.0,16,7,9
NO,AU,2020.0,25,32,-7
ES,FI,2014.0,32,15,17
RU,UZ,2022.0,26,31,-5
ES,QA,2015.0,13,3,10
PH,KR,2019.0,8,14,-6
BE,US,2023.0,9,17,-8
CA,EG,1999.0,9,9,0
MY,nan,2019.0,77,57,20
KR,DE,2023.0,6,2,4
GB,IQ,2021.0,69,42,27
MX,RU,1998.0,5,11,-6
BD,GB,2012.0,42,54,-12
SG,SE,2011.0,10,9,1
AE,EG,2019.0,55,65,-10
HR,FR,1999.0,3,1,2
SG,FR,2020.0,16,32,-16
ES,BR,2000.0,112,96,16
CH,CZ,2021.0,20,26,-6
MY,AU,2014.0,96,153,-57
HN,ES,2019.0,16,10,6
AU,BD,2012.0,18,46,-28
AT,RU,1998.0,6,4,2
BY,RU,2012.0,77,60,17
IQ,MY,2013.0,13,49,-36
DK,FR,2015.0,44,40,4
CH,EE,2013.0,9,8,1
GB,DK,1998.0,49,44,5
IN,ES,2010.0,22,18,4
DE,IE,2014.0,78,84,-6
CH,TN,2007.0,4,5,-1
GB,RU,2017.0,140,81,59
CO,LU,2021.0,4,2,2
BR,GB,2002.0,48,78,-30
GB,RU,2010.0,73,84,-11
GB,ID,2008.0,9,7,2
JP,DK,2011.0,12,16,-4
BR,IE,2017.0,18,13,5
RU,GB,2009.0,82,66,16
US,DK,2003.0,157,160,-3
BD,MY,2019.0,51,74,-23
NI,UA,2019.0,9,21,-12
JP,BR,2002.0,31,27,4
RU,KG,2013.0,4,2,2
HR,NL,2008.0,2,1,1
CA,KR,2008.0,42,28,14
UA,BR,2021.0,15,10,5
BR,PL,2023.0,7,3,4
HR,IT,2020.0,14,11,3
IQ,FR,2015.0,2,6,-4
JP,BG,2004.0,7,3,4
NO,FI,2000.0,4,8,-4
GB,PK,2017.0,188,127,61
BR,MZ,2015.0,20,15,5
GB,IL,1999.0,23,30,-7
NZ,FI,2017.0,10,1,9
FI,EG,2014.0,4,5,-1
SE,FR,2017.0,71,100,-29
MY,CA,2000.0,3,4,-1
TW,RU,2012.0,27,21,6
CA,ZA,2016.0,50,57,-7
CU,CO,2016.0,42,33,9
DE,KE,2018.0,23,14,9
IN,IL,2013.0,31,19,12
MK,CN,2014.0,4,2,2
GB,MA,2021.0,8,12,-4
GB,FI,1999.0,18,23,-5
nan,BR,2022.0,58,56,2
IL,EC,2017.0,5,1,4
BW,GB,2020.0,1,2,-1
MY,AR,2009.0,1,2,-1
NL,RU,2020.0,41,49,-8
IR,GB,2001.0,10,41,-31
TR,MD,2021.0,11,2,9
EG,BR,2015.0,3,3,0
FR,KR,2014.0,34,33,1
nan,BE,2013.0,24,23,1
GR,AU,2017.0,13,10,3
nan,KR,2020.0,30,33,-3
UA,GB,2018.0,23,27,-4
CO,GT,2009.0,2,1,1
BD,SA,2022.0,31,23,8
BG,FR,1997.0,10,6,4
CR,CO,2009.0,13,16,-3
CN,SG,2023.0,112,30,82
ET,CN,2018.0,7,14,-7
TW,EG,2022.0,20,15,5
IT,CA,2023.0,7,15,-8
CN,LT,2021.0,5,1,4
PH,GB,2020.0,20,13,7
IN,AE,2020.0,83,75,8
SD,NG,2021.0,4,1,3
ES,PS,2021.0,11,15,-4
QA,IN,2018.0,22,23,-1
JO,SA,2021.0,41,46,-5
CZ,DE,2019.0,80,88,-8
CN,PK,2020.0,309,288,21
SG,MY,2010.0,75,45,30
DE,SE,2007.0,142,131,11
RS,TR,2017.0,119,22,97
CO,CU,2020.0,33,41,-8
NL,SG,2004.0,4,4,0
ES,CN,2014.0,77,78,-1
BD,CN,2006.0,15,18,-3
CN,FR,2019.0,147,239,-92
JP,PL,1999.0,12,14,-2
SG,TW,2015.0,33,60,-27
MY,SA,2007.0,3,5,-2
CN,FR,2017.0,167,219,-52
IT,CZ,2015.0,28,20,8
IN,TT,2017.0,6,4,2
SA,ID,2013.0,8,6,2
MK,IT,2019.0,2,1,1
BR,PE,2017.0,62,73,-11
NL,AT,2021.0,20,34,-14
PL,SE,1999.0,9,12,-3
IN,PH,1998.0,7,5,2
ES,RO,2007.0,7,8,-1
US,CR,2000.0,8,11,-3
JO,DE,2012.0,9,19,-10
GH,ID,2015.0,11,5,6
US,IQ,2009.0,8,3,5
CU,CN,2016.0,5,1,4
JP,SA,2014.0,21,6,15
MY,nan,2017.0,59,78,-19
FI,JP,2001.0,8,9,-1
DE,ES,1997.0,50,44,6
ZA,BE,2000.0,3,4,-1
AU,NL,2006.0,33,53,-20
JP,BR,2005.0,38,32,6
JP,GH,2001.0,3,2,1
CA,RS,2002.0,5,5,0
BR,SD,2012.0,21,12,9
DE,PL,2002.0,68,75,-7
IR,DE,2011.0,48,32,16
JP,GR,2018.0,32,29,3
PL,AU,2015.0,22,19,3
DE,AM,2006.0,5,1,4
UZ,RU,2000.0,13,5,8
NL,FI,2006.0,44,22,22
nan,MX,1999.0,4,4,0
NG,nan,2021.0,5,13,-8
DE,RO,2006.0,27,23,4
GB,KZ,2018.0,8,6,2
ET,NG,2015.0,5,3,2
KR,BE,2019.0,11,9,2
nan,NO,2018.0,26,17,9
AM,US,2020.0,15,8,7
SK,RS,1999.0,3,2,1
BE,JP,2014.0,39,30,9
SE,BE,2015.0,20,35,-15
CH,IL,2017.0,22,26,-4
AT,HR,2005.0,2,2,0
CA,RU,2012.0,25,20,5
PH,BD,2018.0,1,3,-2
MX,IE,2018.0,6,5,1
NL,JP,2009.0,28,29,-1
IL,CA,2015.0,57,61,-4
UA,DE,2006.0,40,25,15
BD,MY,2017.0,45,74,-29
TR,CZ,2018.0,18,5,13
CA,FI,2016.0,23,14,9
TR,QA,2021.0,9,7,2
SE,EG,2013.0,10,4,6
DE,nan,2023.0,3,3,0
NL,CL,2018.0,20,17,3
BR,PE,2010.0,30,15,15
CA,MX,2008.0,25,41,-16
CH,IE,2011.0,12,12,0
NL,BR,2002.0,14,13,1
LB,CA,2020.0,20,10,10
NG,IL,2017.0,2,2,0
JO,IT,2010.0,4,1,3
FR,CM,2007.0,13,6,7
CH,ES,2020.0,106,141,-35
DZ,IT,2020.0,32,47,-15
BE,CA,2008.0,58,48,10
CA,CO,2015.0,25,40,-15
TZ,US,2019.0,24,22,2
LU,SG,2018.0,3,1,2
US,FI,2001.0,99,104,-5
FI,GB,2012.0,56,67,-11
US,LU,2015.0,24,20,4
US,TN,2021.0,14,17,-3
CA,AE,2018.0,26,24,2
FI,CN,2017.0,48,27,21
MY,NZ,2018.0,13,19,-6
US,MT,2017.0,10,7,3
EC,UA,2015.0,46,16,30
JO,US,2001.0,12,18,-6
EG,BE,2021.0,6,5,1
FR,SA,2011.0,40,7,33
KE,CM,2020.0,2,1,1
JP,RS,2009.0,2,1,1
KR,SE,2013.0,7,12,-5
EG,IR,2016.0,9,19,-10
BE,NL,2001.0,94,97,-3
IN,ES,2019.0,29,25,4
PT,CH,2016.0,24,17,7
RU,BR,1998.0,15,8,7
FR,BF,2012.0,16,11,5
LK,IN,2016.0,8,16,-8
PK,PT,2011.0,3,2,1
FI,nan,2016.0,15,7,8
BE,PT,2013.0,12,9,3
CH,IN,2019.0,67,78,-11
SA,NG,2022.0,7,12,-5
RU,BR,1997.0,7,4,3
NL,BR,2005.0,14,18,-4
BR,IE,2019.0,25,10,15
FR,IE,2014.0,29,39,-10
GH,US,2011.0,7,16,-9
nan,KZ,2017.0,1,1,0
ES,UY,2000.0,9,10,-1
NO,FR,2008.0,36,59,-23
ES,BD,2010.0,20,10,10
NL,ZA,2022.0,22,22,0
RU,PL,2006.0,16,21,-5
PT,NL,2000.0,6,8,-2
EC,NI,2018.0,3,1,2
DE,RS,2005.0,18,22,-4
DE,RS,2002.0,8,11,-3
JP,CZ,2011.0,16,14,2
SE,IN,2009.0,14,42,-28
PT,DZ,2020.0,3,5,-2
SG,LK,2022.0,1,1,0
US,LY,2015.0,5,3,2
PL,JP,2019.0,19,20,-1
FR,RE,2013.0,40,42,-2
SE,HU,2004.0,12,10,2
NL,IT,1998.0,24,37,-13
AU,GH,2018.0,15,19,-4
KR,AE,2020.0,13,4,9
PH,JP,2001.0,9,12,-3
CL,CN,2018.0,8,3,5
JP,LK,2016.0,25,11,14
CN,TR,2009.0,12,7,5
DE,SK,2020.0,29,40,-11
NZ,FI,2019.0,6,6,0
CA,AT,2002.0,14,18,-4
HU,JO,2020.0,2,3,-1
CL,RU,2005.0,8,6,2
LB,EG,2010.0,11,6,5
NL,IT,1997.0,39,17,22
ES,GT,2022.0,4,6,-2
JO,AE,2007.0,7,3,4
US,BY,2021.0,7,14,-7
NO,UA,2017.0,3,3,0
EG,GB,2000.0,5,11,-6
JM,BB,2003.0,2,1,1
CL,IT,2011.0,14,25,-11
SE,PK,2012.0,13,9,4
MX,PH,2012.0,6,5,1
CL,CR,2007.0,9,7,2
BJ,FR,2015.0,30,30,0
NE,BJ,2012.0,1,1,0
CO,NL,2017.0,13,15,-2
BH,GB,2016.0,4,12,-8
SE,PL,2012.0,18,22,-4
IL,CH,2014.0,14,25,-11
US,CY,2019.0,24,19,5
ES,TH,2015.0,3,2,1
US,MT,2019.0,14,4,10
JP,ZA,2007.0,7,8,-1
SI,MY,2014.0,4,5,-1
US,PS,2006.0,10,1,9
DK,HU,2003.0,4,4,0
LK,CN,2017.0,7,11,-4
AT,IN,2019.0,11,18,-7
BW,NG,2018.0,4,1,3
TH,TR,2017.0,3,2,1
SZ,ZA,2012.0,5,1,4
PK,IE,2018.0,16,15,1
JP,CM,2021.0,3,1,2
PE,PH,2019.0,7,7,0
HK,AU,2015.0,3,1,2
CZ,JP,2021.0,14,18,-4
BD,ES,2004.0,3,8,-5
IQ,CA,2016.0,2,4,-2
PH,CH,1998.0,3,1,2
LT,IT,2011.0,1,2,-1
PG,US,2015.0,3,4,-1
CZ,DK,2004.0,4,3,1
ES,UG,2018.0,2,1,1
HU,IN,2005.0,3,8,-5
US,GD,2015.0,12,22,-10
ZA,NZ,2016.0,13,8,5
SK,BE,2003.0,2,3,-1
AM,JP,2008.0,7,2,5
FR,CZ,2013.0,26,36,-10
SK,IT,1998.0,9,3,6
LU,FR,2022.0,13,17,-4
BE,IT,2006.0,56,83,-27
ES,RU,2000.0,9,4,5
NL,nan,2004.0,39,36,3
FR,CO,2012.0,33,36,-3
ET,SE,1999.0,4,4,0
CO,PK,2017.0,1,1,0
NO,KR,2008.0,6,5,1
US,CY,2010.0,29,7,22
FI,SK,2020.0,4,1,3
MD,FR,2006.0,57,53,4
SE,NG,2005.0,2,2,0
PE,ES,2005.0,26,20,6
FI,RU,1999.0,13,11,2
US,SJ,2017.0,5,1,4
PL,BD,2007.0,3,1,2
GB,PK,2010.0,75,59,16
SI,AU,2014.0,7,4,3
US,SI,2013.0,20,25,-5
DE,VN,2007.0,4,7,-3
BR,DK,2001.0,3,4,-1
DE,CZ,2000.0,25,14,11
BD,DE,2017.0,17,15,2
NO,GB,2007.0,39,49,-10
AT,FI,2009.0,9,6,3
UZ,GB,2013.0,1,1,0
SE,RU,1998.0,14,34,-20
CO,CR,2009.0,16,13,3
RS,ZA,2016.0,3,1,2
LT,CZ,2003.0,4,3,1
NZ,ID,2019.0,8,2,6
IT,CL,2007.0,17,19,-2
IE,ZA,2003.0,2,4,-2
IN,SG,1997.0,7,3,4
nan,CH,2022.0,7,11,-4
SE,HR,2000.0,1,1,0
CO,KE,2010.0,4,2,2
PL,ZA,2018.0,6,3,3
CZ,SI,2020.0,5,7,-2
AT,IE,2008.0,6,1,5
RO,PL,2015.0,9,5,4
TR,FR,2013.0,25,29,-4
FI,CN,2019.0,40,29,11
BR,IE,2010.0,7,3,4
NL,ES,2001.0,30,33,-3
CO,IN,2015.0,5,5,0
IN,CZ,2007.0,26,20,6
CH,IS,2019.0,4,1,3
NO,TR,2011.0,2,4,-2
MA,EG,2008.0,2,1,1
RE,US,2015.0,5,3,2
KR,BE,2017.0,21,17,4
KW,AU,2019.0,3,10,-7
SA,EG,2004.0,29,34,-5
NO,CN,2022.0,25,20,5
MX,NL,2015.0,16,8,8
IE,IQ,2018.0,4,3,1
UY,GB,2006.0,3,3,0
LB,CN,2013.0,30,40,-10
SK,HR,2018.0,4,8,-4
MW,GB,2013.0,10,16,-6
CH,IL,2010.0,11,13,-2
NZ,ES,2017.0,10,6,4
MX,CN,2013.0,10,11,-1
CO,CA,2020.0,36,30,6
nan,IN,2004.0,9,7,2
CL,UY,2016.0,15,11,4
GB,SG,2001.0,39,35,4
RU,AT,2020.0,24,22,2
CA,LB,2014.0,11,19,-8
EC,NL,2021.0,4,3,1
FR,GP,2013.0,21,14,7
IT,PT,2007.0,26,10,16
QA,GB,2012.0,15,20,-5
PK,FR,2007.0,5,6,-1
UA,FI,2012.0,5,3,2
AU,AE,2019.0,16,17,-1
CZ,AT,2011.0,16,15,1
nan,NZ,2003.0,6,4,2
BR,KR,2012.0,3,6,-3
NO,GR,2014.0,5,8,-3
SE,SK,2014.0,4,1,3
CA,GR,2003.0,8,6,2
CU,PE,2019.0,33,13,20
DE,MX,2000.0,16,13,3
AR,CR,2006.0,4,1,3
DE,PS,1998.0,2,1,1
NO,nan,2007.0,22,26,-4
RU,CA,2002.0,26,20,6
FI,CN,2010.0,22,16,6
PS,PK,2017.0,4,2,2
PK,KE,2020.0,7,8,-1
CH,IL,2019.0,18,25,-7
FI,AU,2017.0,28,17,11
HR,AU,2004.0,3,3,0
PE,VE,2008.0,2,8,-6
CN,nan,1998.0,5,10,-5
AT,IL,2004.0,4,4,0
GB,EC,2015.0,7,3,4
TT,GB,2022.0,4,2,2
TN,DZ,2011.0,6,10,-4
US,MT,2010.0,4,1,3
IE,AE,2007.0,1,2,-1
AU,CN,2023.0,23,141,-118
GB,GE,2015.0,4,2,2
KR,TW,2009.0,29,34,-5
DK,CL,2019.0,3,3,0
GB,CM,2016.0,5,5,0
CZ,BE,2014.0,11,7,4
NL,IN,2015.0,45,49,-4
NL,IE,2012.0,19,20,-1
TZ,CH,2022.0,5,3,2
MA,IN,2019.0,5,2,3
GR,AU,2010.0,4,6,-2
RU,CA,2005.0,31,17,14
XK,US,2018.0,5,2,3
LU,BE,2014.0,12,28,-16
IL,FR,2000.0,20,22,-2
BG,BR,2004.0,2,2,0
PL,ID,2021.0,5,4,1
MY,JP,2009.0,17,54,-37
IS,FI,2015.0,2,5,-3
BD,MY,2010.0,20,12,8
BD,FR,2014.0,6,4,2
BY,DE,2004.0,8,7,1
KH,FR,2015.0,5,1,4
BG,RU,2023.0,4,1,3
KR,ID,2007.0,3,2,1
CZ,TW,1997.0,1,1,0
MK,AT,2017.0,18,17,1
IQ,SY,2015.0,1,1,0
SA,PK,2010.0,17,21,-4
PS,PK,2019.0,5,1,4
NO,BE,2004.0,3,2,1
GT,DE,2021.0,1,1,0
TZ,SE,2020.0,6,5,1
KR,CH,2006.0,11,3,8
GB,UA,2004.0,5,4,1
CI,FR,2000.0,7,6,1
RU,RO,2013.0,8,5,3
UG,IN,2018.0,5,1,4
EC,CL,2015.0,25,43,-18
CA,OM,2006.0,7,1,6
NG,UG,2015.0,3,3,0
MX,IT,2003.0,22,16,6
nan,PL,2014.0,9,18,-9
CA,MA,2007.0,10,7,3
LK,CN,2019.0,7,16,-9
FI,AU,2010.0,11,8,3
PK,JP,2018.0,13,10,3
SA,IR,2016.0,9,11,-2
NZ,NO,2012.0,9,4,5
SE,GR,2018.0,20,24,-4
FR,OM,2015.0,1,2,-1
CR,GB,2018.0,4,5,-1
MW,US,2009.0,5,6,-1
IN,HR,2007.0,1,1,0
TR,GR,2006.0,4,2,2
SE,LV,2009.0,7,1,6
ZA,ZW,2023.0,1,2,-1
ES,IE,2002.0,9,3,6
IR,NZ,2008.0,2,1,1
CA,TH,2005.0,6,7,-1
GB,TH,1997.0,12,7,5
PL,AZ,2006.0,1,6,-5
ID,FI,2014.0,3,2,1
CI,CA,2010.0,1,3,-2
CO,KE,2019.0,4,5,-1
NL,VN,2012.0,6,5,1
FR,MC,2014.0,7,9,-2
IN,SG,1998.0,17,7,10
IE,JP,2004.0,21,24,-3
FR,SY,2012.0,9,6,3
TW,PL,2008.0,3,2,1
EC,PH,2016.0,2,1,1
RS,SK,2004.0,5,14,-9
TN,PT,2017.0,1,2,-1
IT,AL,2018.0,8,7,1
IT,AR,1998.0,17,28,-11
PL,GR,2014.0,9,6,3
AM,CN,2017.0,1,1,0
IT,IE,2005.0,13,6,7
CN,DZ,2016.0,3,2,1
HK,RO,2021.0,16,4,12
PL,AT,2004.0,8,6,2
FR,ML,2004.0,6,2,4
RU,VN,2017.0,6,1,5
IT,RO,2001.0,5,5,0
GB,JO,2011.0,19,6,13
HR,DE,2001.0,14,16,-2
BR,nan,2001.0,8,9,-1
GH,NL,2018.0,4,7,-3
SG,TH,2007.0,4,3,1
CZ,HR,2016.0,4,14,-10
UA,SE,2011.0,8,3,5
PL,JP,2017.0,23,18,5
nan,ZA,2015.0,4,1,3
DK,JP,2001.0,8,10,-2
DK,IT,1999.0,8,9,-1
MT,FR,2020.0,2,2,0
FR,BI,2003.0,16,14,2
FR,BJ,2013.0,32,37,-5
NO,IE,2008.0,3,2,1
JP,HU,2020.0,7,11,-4
FR,HU,2015.0,24,22,2
SI,CZ,2011.0,9,6,3
TR,RO,2018.0,3,7,-4
CZ,NO,1999.0,3,4,-1
SE,RU,1997.0,15,21,-6
DK,KE,2014.0,1,4,-3
SK,JP,2009.0,11,12,-1
EG,KW,2002.0,4,8,-4
TW,IR,2016.0,3,4,-1
BE,PH,2016.0,4,2,2
AU,HU,2006.0,7,9,-2
DK,BR,2002.0,1,1,0
CH,IS,2010.0,2,1,1
IN,SA,1999.0,6,4,2
NZ,CH,2005.0,9,8,1
CN,nan,1997.0,4,5,-1
CZ,MY,2012.0,3,1,2
LB,IN,2017.0,8,4,4
NO,PK,2018.0,10,5,5
SE,MX,2007.0,5,6,-1
QA,DE,2016.0,5,7,-2
DK,NZ,2004.0,3,3,0
ES,IR,2008.0,2,2,0
PL,JP,2010.0,11,17,-6
PT,CA,2004.0,9,3,6
BD,IN,2001.0,9,10,-1
TR,BD,2016.0,2,2,0
NP,US,2011.0,16,26,-10
US,PR,2014.0,11,5,6
AT,IN,2010.0,9,15,-6
nan,ET,2013.0,4,1,3
IE,SE,2018.0,11,18,-7
GH,CH,2020.0,5,3,2
UA,nan,2018.0,23,38,-15
FR,CD,2003.0,1,1,0
NL,JO,2006.0,3,1,2
BW,US,2000.0,1,1,0
CO,UY,2009.0,2,9,-7
CL,SE,2020.0,7,11,-4
BD,IT,2016.0,4,6,-2
US,MG,2007.0,2,1,1
BR,AT,2011.0,15,8,7
RU,CH,1999.0,13,9,4
LU,ES,2014.0,3,5,-2
CZ,RS,2007.0,12,5,7
SD,CN,2018.0,6,12,-6
FI,CZ,2008.0,4,3,1
CL,SV,2016.0,5,2,3
PH,IN,2020.0,18,30,-12
ID,GB,2014.0,28,63,-35
UG,NL,2016.0,2,7,-5
ID,SG,2000.0,4,1,3
KR,SA,2011.0,9,1,8
ES,MA,2007.0,4,7,-3
MY,SE,2021.0,4,2,2
CA,MT,2003.0,2,1,1
PH,KR,2017.0,9,15,-6
NI,UA,2017.0,15,6,9
QA,HR,2020.0,2,1,1
US,MD,2021.0,3,3,0
IT,NP,2017.0,1,2,-1
PA,BR,2020.0,4,7,-3
RS,QA,2016.0,2,2,0
UA,BY,2016.0,21,10,11
IE,BE,2022.0,7,4,3
SI,RU,2017.0,5,2,3
MY,ZA,2018.0,3,6,-3
MY,DK,2016.0,5,4,1
DK,ET,2020.0,2,1,1
GH,JP,2012.0,1,4,-3
MY,LK,2014.0,2,2,0
SA,CH,2015.0,3,4,-1
IN,NG,2020.0,34,31,3
UA,PL,2023.0,1,2,-1
BE,CW,2020.0,2,5,-3
CN,IL,2001.0,5,15,-10
TN,LY,2016.0,1,1,0
TH,NP,2021.0,4,5,-1
SK,FI,2008.0,8,2,6
NG,SE,2009.0,2,5,-3
EE,US,2006.0,5,13,-8
DE,LI,2009.0,5,5,0
JP,SK,2003.0,20,25,-5
RW,US,2009.0,3,9,-6
NO,BD,2021.0,16,5,11
CH,LU,2009.0,8,3,5
TW,CZ,2012.0,2,1,1
HK,JP,2016.0,8,5,3
TW,BE,2016.0,5,3,2
NL,SN,2015.0,2,1,1
CU,PY,2007.0,6,9,-3
HN,ES,2010.0,5,6,-1
AE,JP,2014.0,2,2,0
GB,LB,2005.0,5,2,3
CH,FI,2016.0,14,29,-15
NZ,ES,2019.0,3,15,-12
TH,CH,2021.0,5,3,2
MX,SE,2010.0,7,2,5
HR,CZ,2003.0,3,3,0
IN,TT,2019.0,8,4,4
ZM,CA,2020.0,1,2,-1
RU,AU,1999.0,4,5,-1
FI,NZ,2005.0,2,3,-1
AU,AE,2017.0,19,18,1
PA,GB,2011.0,3,5,-2
BE,CD,2005.0,2,3,-1
OM,GB,2016.0,14,16,-2
nan,CA,2000.0,6,10,-4
TH,LK,2016.0,1,1,0
CZ,PL,2007.0,20,34,-14
BF,US,2022.0,3,2,1
IT,PE,2005.0,4,1,3
IQ,CN,2022.0,5,8,-3
AR,IL,2021.0,4,2,2
BG,FR,1998.0,9,7,2
RU,TR,2022.0,6,8,-2
SK,NL,2007.0,6,6,0
MZ,RU,2003.0,7,2,5
GR,TR,2007.0,4,10,-6
NL,SD,1997.0,2,1,1
CU,PE,2010.0,3,5,-2
DK,AT,2012.0,10,10,0
RU,PT,2001.0,4,4,0
TZ,NO,2020.0,1,8,-7
CH,PF,2006.0,2,1,1
BG,BE,2006.0,6,7,-1
NO,IN,2001.0,15,35,-20
RU,VN,2019.0,13,9,4
AU,AE,2010.0,5,5,0
GB,BI,2017.0,2,2,0
CO,KE,2017.0,2,5,-3
US,DO,2017.0,4,2,2
SI,IT,2002.0,4,4,0
CH,ZA,2003.0,3,6,-3
CH,PL,2007.0,12,9,3
VN,CH,2015.0,4,3,1
DE,BF,2014.0,2,2,0
ZA,FJ,2018.0,1,1,0
IE,BR,2018.0,16,17,-1
SE,TW,2000.0,6,1,5
CZ,BR,2006.0,6,4,2
RO,AU,2013.0,3,5,-2
RU,IE,2021.0,3,8,-5
DE,PE,2018.0,7,10,-3
EG,TN,2018.0,10,23,-13
FI,NZ,2002.0,3,3,0
PH,DE,2007.0,4,7,-3
IE,NZ,2014.0,13,17,-4
MW,UG,2018.0,1,2,-1
FR,VE,2022.0,2,1,1
RU,MY,2016.0,10,22,-12
CA,CU,2021.0,1,5,-4
IE,IR,2016.0,10,9,1
KW,AU,2010.0,3,1,2
SG,DK,2007.0,4,3,1
OM,IN,2013.0,12,21,-9
DK,KR,2008.0,3,4,-1
CZ,AR,2008.0,4,2,2
LR,US,2022.0,4,2,2
PH,KR,2010.0,5,6,-1
JP,PT,2013.0,5,4,1
IT,IE,2002.0,10,8,2
GB,AF,2018.0,1,1,0
MY,nan,2010.0,12,38,-26
GE,BR,2022.0,1,1,0
US,SJ,2019.0,2,2,0
RU,AM,2008.0,5,4,1
KR,BE,2010.0,8,8,0
CA,CZ,2012.0,9,11,-2
ZA,IL,2013.0,2,3,-1
BR,UA,2006.0,2,4,-2
NZ,CH,2002.0,6,3,3
IS,DE,2015.0,7,10,-3
LK,BN,2018.0,1,1,0
GB,SD,2009.0,3,4,-1
CN,SK,2022.0,2,3,-1
IL,TR,2016.0,7,2,5
MT,NL,2016.0,1,1,0
PK,MA,2007.0,6,3,3
DE,UZ,2006.0,2,4,-2
LK,GR,2018.0,5,2,3
BG,RS,2014.0,2,1,1
VE,PY,2004.0,1,3,-2
GB,RS,1998.0,7,1,6
PT,IN,2008.0,5,10,-5
IL,HU,2005.0,4,5,-1
BG,UA,2014.0,5,6,-1
CA,VN,2009.0,8,2,6
IL,EC,2019.0,1,2,-1
GT,CH,2011.0,1,1,0
CG,CH,2015.0,1,5,-4
KZ,SA,2020.0,1,4,-3
CN,RO,2023.0,4,1,3
nan,JP,2022.0,11,8,3
MD,RO,2018.0,8,15,-7
KE,nan,2020.0,7,3,4
AM,DE,2001.0,3,3,0
LU,CA,2002.0,1,2,-1
CH,CL,2022.0,4,9,-5
NZ,MM,2020.0,1,1,0
IN,GR,2022.0,2,1,1
CA,TH,2002.0,2,3,-1
GR,AE,2017.0,11,5,6
GB,CR,2021.0,2,4,-2
KR,DK,2012.0,5,3,2
NL,RS,2008.0,5,6,-1
NL,GH,2021.0,5,3,2
IE,SI,2021.0,2,1,1
CL,CZ,2022.0,3,1,2
JP,LT,1997.0,3,5,-2
EC,VE,2014.0,4,22,-18
US,DO,2019.0,10,4,6
HN,CO,2012.0,3,2,1
GB,RO,2023.0,2,1,1
US,DZ,1998.0,1,2,-1
FJ,IN,2012.0,3,2,1
JP,AR,2004.0,4,3,1
IQ,IN,2013.0,4,4,0
MD,GB,2017.0,3,2,1
GR,BR,2011.0,4,2,2
ZA,KR,2011.0,3,7,-4
CN,DK,2000.0,8,10,-2
LB,IN,2019.0,3,6,-3
RO,SK,2009.0,2,3,-1
TN,IT,2003.0,3,2,1
CZ,AU,2013.0,9,9,0
XK,MK,2018.0,5,5,0
AT,RU,1997.0,5,6,-1
CH,PE,2006.0,2,2,0
AR,PA,2011.0,2,2,0
MX,SE,2017.0,13,9,4
AR,VE,2006.0,10,13,-3
RO,TR,2016.0,2,4,-2
JP,DZ,2016.0,2,2,0
HU,AE,2007.0,1,3,-2
MM,TR,2020.0,3,10,-7
TH,LA,2015.0,3,2,1
UY,AR,1999.0,2,2,0
BE,FI,2007.0,6,5,1
MK,AT,2019.0,20,37,-17
ET,ZA,2020.0,8,12,-4
PT,IE,2008.0,6,3,3
IN,RW,2020.0,4,5,-1
NO,NL,2004.0,9,27,-18
GB,UG,2003.0,6,4,2
GH,CA,2013.0,4,10,-6
FI,AT,2004.0,2,5,-3
KW,TR,2012.0,7,2,5
AU,HR,2004.0,3,3,0
CO,NL,2010.0,4,7,-3
DK,BR,2005.0,6,6,0
DZ,IR,2012.0,2,1,1
EG,KW,2005.0,9,9,0
FR,EG,2006.0,6,4,2
SD,SA,2005.0,1,3,-2
RO,BE,2000.0,7,3,4
HN,MX,2003.0,12,8,4
BE,AT,2004.0,6,7,-1
AE,NZ,2018.0,4,2,2
CR,CA,2009.0,1,2,-1
KW,AU,2017.0,2,7,-5
CA,RE,2009.0,2,1,1
TR,TZ,2014.0,1,2,-1
IL,BE,1997.0,5,8,-3
HU,PL,2001.0,7,9,-2
DE,CR,2014.0,5,3,2
CO,TN,2017.0,1,1,0
IN,KN,2019.0,1,1,0
CI,CM,2017.0,2,1,1
EC,FR,2013.0,1,2,-1
SD,JP,2007.0,1,2,-1
CA,EE,2020.0,5,4,1
TR,IR,2006.0,2,2,0
CN,MU,2010.0,1,1,0
SV,PE,2018.0,5,3,2
TN,MA,2003.0,5,5,0
US,SN,2002.0,4,3,1
EC,MX,2010.0,8,13,-5
CA,BN,2020.0,2,3,-1
SA,IE,2019.0,5,11,-6
ID,SY,2020.0,2,2,0
MQ,FR,2022.0,5,2,3
GH,VN,2014.0,1,1,0
NZ,IQ,2017.0,2,1,1
SA,GH,2010.0,1,2,-1
DE,TZ,2004.0,1,1,0
ET,BH,2014.0,3,4,-1
LB,IR,2015.0,1,3,-2
SA,BD,2023.0,2,5,-3
FI,IE,2022.0,3,4,-1
DK,IE,2022.0,8,5,3
PG,GB,1997.0,2,2,0
BR,KN,2021.0,1,1,0
FI,EE,2007.0,3,6,-3
IE,IT,2002.0,8,10,-2
SK,KR,2009.0,1,2,-1
NZ,KN,2017.0,2,1,1
CA,RS,2005.0,5,5,0
ZA,ES,2015.0,5,14,-9
HN,US,2020.0,7,5,2
MX,JO,2017.0,1,1,0
PE,AU,2015.0,3,2,1
CM,MY,2017.0,2,2,0
IN,BT,2020.0,4,4,0
IQ,TR,2020.0,13,29,-16
BO,AR,2013.0,2,1,1
IR,AF,2013.0,2,2,0
DZ,CN,2009.0,1,1,0
nan,KZ,2019.0,1,3,-2
GR,PT,2022.0,1,3,-2
SI,RU,2019.0,3,8,-5
KZ,UA,2021.0,7,5,2
FI,PH,2021.0,2,1,1
KR,KP,2021.0,8,6,2
ZA,CZ,2020.0,9,7,2
GT,VE,2021.0,2,3,-1
KZ,NL,2011.0,1,1,0
US,AF,2015.0,1,2,-1
BR,SK,2021.0,3,1,2
PE,SE,2022.0,1,1,0
BZ,FR,2004.0,8,4,4
RU,ZA,2006.0,3,1,2
MK,AT,2010.0,2,2,0
LK,CN,2010.0,4,6,-2
DE,SY,2020.0,1,3,-2
AT,MK,2012.0,5,8,-3
AE,EG,2010.0,11,14,-3
GH,KR,2021.0,1,2,-1
GB,UY,2020.0,1,5,-4
FR,KE,2021.0,6,4,2
IS,CH,2001.0,1,1,0
NZ,FI,2010.0,3,2,1
SG,EG,2015.0,3,2,1
CI,CA,2017.0,3,5,-2
CA,PS,2007.0,1,2,-1
ML,CI,2016.0,4,5,-1
AT,RS,2022.0,1,9,-8
US,SN,2005.0,2,12,-10
CA,LY,2014.0,3,1,2
LB,JO,2016.0,4,6,-2
nan,DZ,2007.0,2,2,0
SE,SG,2022.0,7,6,1
CO,SE,2004.0,1,2,-1
BE,EG,1999.0,1,2,-1
RU,AE,2022.0,3,1,2
DK,SG,2011.0,3,8,-5
GT,IT,2020.0,5,1,4
BR,CZ,2004.0,3,4,-1
AR,JP,2009.0,2,4,-2
NO,NZ,2015.0,5,7,-2
OM,AE,2015.0,4,4,0
FI,IN,2011.0,3,15,-12
PK,BE,2018.0,5,2,3
MX,PR,2016.0,6,6,0
PL,HU,2023.0,1,2,-1
KR,PK,2008.0,2,5,-3
EE,FR,1998.0,1,3,-2
GB,PR,2012.0,1,1,0
AU,NG,2006.0,3,3,0
TZ,CA,2011.0,1,3,-2
SE,RS,2020.0,4,7,-3
GR,HU,2015.0,3,6,-3
IL,JP,2012.0,5,6,-1
NA,US,2014.0,3,1,2
UZ,FR,2018.0,2,1,1
DE,BO,2012.0,1,1,0
SG,NG,2016.0,1,1,0
RU,MD,2022.0,2,4,-2
DK,PT,2007.0,2,2,0
GB,CI,2015.0,2,2,0
PT,MA,2014.0,5,13,-8
CH,HR,2016.0,4,6,-2
SK,NZ,2011.0,2,1,1
SI,SE,2007.0,2,1,1
DZ,BE,2011.0,2,1,1
IN,TT,2010.0,1,4,-3
CM,MY,2019.0,3,4,-1
JO,IT,2019.0,3,4,-1
CH,SK,2001.0,1,9,-8
GB,LB,2002.0,2,4,-2
MX,nan,2007.0,8,10,-2
GR,AE,2019.0,5,2,3
SE,KE,2007.0,1,4,-3
IS,IT,2022.0,1,2,-1
IR,EG,2004.0,1,1,0
HR,PT,2019.0,2,3,-1
PT,BG,2017.0,2,1,1
SE,VE,2005.0,1,1,0
PK,RU,2015.0,2,4,-2
LB,SY,2021.0,3,3,0
YE,TW,2020.0,1,2,-1
SD,SA,2002.0,2,2,0
CI,CM,2019.0,2,1,1
CM,CN,2017.0,3,4,-1
JO,CN,2018.0,4,7,-3
HU,MY,2020.0,1,1,0
SA,DK,2011.0,1,2,-1
TH,AT,2013.0,5,4,1
FR,CR,2006.0,1,1,0
US,EE,2002.0,4,3,1
ZA,CH,2003.0,6,3,3
NG,MA,2016.0,1,3,-2
SD,IN,2009.0,2,1,1
IE,GR,2019.0,3,15,-12
TJ,UZ,2017.0,5,1,4
BW,ID,2019.0,1,1,0
IE,GR,2010.0,3,4,-1
TJ,UZ,2019.0,9,4,5
SL,GB,2020.0,3,1,2
PK,CG,2022.0,11,3,8
EC,JP,2008.0,1,1,0
SN,BF,2006.0,1,1,0
CA,CM,2016.0,2,4,-2
CN,IR,2000.0,3,1,2
IL,BE,1998.0,6,4,2
HU,IN,2002.0,2,5,-3
KR,IR,2021.0,3,15,-12
CM,CN,2019.0,1,3,-2
PK,TH,2012.0,1,2,-1
CH,CD,2016.0,1,1,0
US,EE,2005.0,11,4,7
AT,IN,2017.0,8,16,-8
GE,IN,2007.0,1,1,0
NZ,BR,2003.0,2,4,-2
IE,SG,2009.0,3,5,-2
MK,US,2016.0,7,4,3
AU,PL,2004.0,5,3,2
MY,BE,2015.0,2,7,-5
RS,NO,2016.0,1,2,-1
BE,PS,2018.0,1,2,-1
EG,HU,2012.0,2,4,-2
US,LA,2021.0,1,1,0
CY,ZA,2011.0,2,1,1
PT,MY,2011.0,2,4,-2
SK,NO,2017.0,2,2,0
BG,DK,2015.0,1,4,-3
BW,DE,2002.0,1,1,0
BY,CA,2019.0,1,1,0
FR,ET,2011.0,2,1,1
KR,CZ,2012.0,5,5,0
HU,CN,2003.0,3,1,2
PT,CZ,2015.0,2,4,-2
HU,NZ,2016.0,1,2,-1
NZ,DK,1999.0,3,2,1
KZ,SG,2019.0,1,3,-2
KH,US,2006.0,1,8,-7
MX,ID,2007.0,1,1,0
MA,AT,2010.0,1,1,0
RS,BA,2006.0,5,3,2
RU,AZ,2014.0,5,23,-18
NZ,BE,2015.0,3,3,0
CA,MW,2017.0,2,2,0
PH,IR,2016.0,2,1,1
NL,CR,2022.0,3,2,1
NG,KR,2004.0,3,1,2
ZA,SE,1999.0,1,2,-1
nan,GR,2014.0,1,8,-7
JP,LT,1998.0,4,6,-2
IT,SM,2014.0,3,3,0
NZ,BD,2011.0,2,1,1
PE,BO,2011.0,2,3,-1
AT,ET,2015.0,2,3,-1
CZ,BD,2009.0,1,1,0
NO,TZ,2012.0,3,3,0
MX,LV,2010.0,1,2,-1
CN,AZ,2017.0,2,2,0
CN,AZ,2019.0,3,10,-7
PY,VE,2016.0,1,1,0
nan,AE,2015.0,2,2,0
BE,NG,2013.0,2,1,1
DE,JM,2018.0,1,1,0
SG,QA,2015.0,2,1,1
JP,LA,2014.0,2,1,1
BE,CU,2019.0,3,3,0
ID,DE,1999.0,1,3,-2
JO,GB,2004.0,4,15,-11
KW,PK,2020.0,5,3,2
SE,PE,2012.0,1,3,-2
SR,IN,2020.0,1,1,0
RU,PH,1997.0,1,1,0
CA,GA,2015.0,2,1,1
NO,RO,2016.0,3,1,2
MX,EG,2016.0,2,1,1
ET,CO,2015.0,1,2,-1
PH,AT,2004.0,1,2,-1
QA,LB,2015.0,2,2,0
TZ,TW,2019.0,1,2,-1
MD,GB,2010.0,1,1,0
ID,IT,2011.0,1,7,-6
BD,NL,2021.0,2,3,-1
MY,AF,2016.0,2,1,1
RU,HR,2016.0,3,6,-3
BO,FR,2014.0,3,4,-1
NZ,ID,2017.0,5,5,0
IT,BF,2015.0,1,2,-1
SK,CA,2000.0,1,2,-1
CL,RU,2002.0,2,5,-3
TZ,AU,2013.0,1,1,0
UZ,KR,1998.0,1,3,-2
PS,US,2002.0,3,5,-2
AT,HR,2002.0,2,3,-1
BY,IN,2014.0,2,6,-4
IT,KR,2008.0,6,3,3
AR,ID,2013.0,2,2,0
RU,EC,2015.0,2,6,-4
VE,PT,2012.0,8,3,5
SE,CY,2014.0,1,3,-2
UZ,KG,2013.0,1,1,0
LK,TH,2004.0,1,1,0
TR,MX,2020.0,2,3,-1
GR,BE,2000.0,2,2,0
PS,US,2005.0,2,7,-5
CM,JP,2014.0,1,1,0
CA,BG,2021.0,3,2,1
SK,NO,2019.0,5,2,3
CH,UA,2022.0,1,5,-4
CY,GB,2003.0,1,7,-6
NG,CY,2022.0,2,4,-2
EG,RU,2014.0,3,2,1
RS,GR,2004.0,1,1,0
EG,NP,2016.0,3,3,0
DK,GH,1998.0,1,2,-1
nan,MY,2003.0,3,12,-9
HR,HU,2009.0,2,2,0
ZW,ZM,2022.0,2,1,1
NO,TH,2022.0,2,1,1
CZ,FI,2004.0,5,4,1
CZ,HU,1998.0,4,2,2
CO,PH,2011.0,3,1,2
DE,KW,2015.0,2,2,0
MA,GB,1998.0,1,3,-2
CN,MK,2011.0,2,4,-2
NG,BJ,2022.0,1,3,-2
SI,IT,2005.0,4,9,-5
AU,EC,2021.0,3,4,-1
NE,CN,2019.0,1,1,0
CL,PY,2013.0,1,1,0
TN,CM,2019.0,1,1,0
PL,SY,2013.0,1,1,0
SY,AE,2018.0,3,1,2
IT,NP,2019.0,2,3,-1
IL,UA,2011.0,2,3,-1
SI,CA,2019.0,3,3,0
FR,LK,2002.0,4,2,2
MA,AT,2019.0,1,1,0
PH,VN,2013.0,1,2,-1
TG,GH,2018.0,1,1,0
US,AM,2001.0,2,5,-3
SK,IT,1997.0,1,5,-4
NO,UA,2019.0,2,3,-1
IS,FR,2009.0,1,2,-1
UG,KR,2020.0,2,2,0
UY,PT,2008.0,3,2,1
RO,SE,2008.0,3,7,-4
IL,GE,2015.0,1,1,0
CM,US,2003.0,2,3,-1
IT,VE,2000.0,2,3,-1
CL,AT,2004.0,1,1,0
CY,JO,2014.0,2,1,1
IL,NZ,2020.0,2,1,1
FR,LK,2005.0,1,5,-4
KE,SD,1999.0,1,1,0
JP,US,1999.0,1561,1477,84
US,AU,2013.0,2463,2024,439
TR,FI,2012.0,11,5,6
US,CA,2003.0,2072,2171,-99
US,IT,2008.0,765,958,-193
RS,TR,2019.0,44,2,42
SG,AU,2018.0,149,139,10
FR,ES,2020.0,317,275,42
FR,IN,2013.0,110,125,-15
SA,PK,2017.0,91,92,-1
JP,BE,2014.0,30,39,-9
IR,DK,2015.0,21,5,16
CL,PE,2003.0,12,17,-5
SY,CN,2008.0,18,26,-8
ID,NG,2021.0,16,18,-2
VE,PE,2008.0,8,2,6
DE,IT,2017.0,274,392,-118
PH,US,2008.0,338,362,-24
nan,GB,2001.0,36,56,-20
BR,GB,2005.0,101,97,4
CN,PL,2011.0,31,36,-5
NO,SE,2018.0,93,95,-2
BE,FR,2019.0,374,421,-47
DE,IL,2018.0,68,66,2
AR,MX,2012.0,104,111,-7
AT,CH,2014.0,117,96,21
CN,IN,2008.0,143,176,-33
VE,MX,2008.0,37,43,-6
SG,MY,2017.0,150,143,7
SG,PH,2015.0,8,6,2
DE,NL,2003.0,193,171,22
PK,CN,2001.0,16,16,0
NL,EG,2016.0,12,5,7
BR,PE,2019.0,103,83,20
QA,EG,2021.0,58,68,-10
AR,EC,2016.0,36,16,20
AR,CH,2015.0,18,19,-1
NL,CA,2012.0,100,101,-1
UA,NO,2022.0,2,1,1
IT,MX,2012.0,31,43,-12
ZA,CN,2008.0,11,8,3
NO,CA,2011.0,21,24,-3
EG,IQ,2022.0,56,44,12
PK,ES,2018.0,4,3,1
DE,NO,2008.0,78,33,45
ES,BD,2019.0,20,8,12
NL,IS,2018.0,3,1,2
ES,BD,2017.0,14,15,-1
CU,PE,2017.0,13,5,8
TZ,TR,2020.0,1,2,-1
PS,JO,2019.0,18,12,6
AT,RO,2018.0,7,14,-7
AE,DE,2021.0,6,11,-5
PT,CO,2007.0,6,9,-3
LK,US,2015.0,23,34,-11
SE,NL,2000.0,19,28,-9
ZW,AM,2010.0,1,1,0
EC,MX,2017.0,60,144,-84
IN,GB,2023.0,28,6,22
DZ,SG,2018.0,3,9,-6
GB,TZ,2022.0,11,8,3
US,LK,2020.0,37,31,6
TZ,US,2010.0,6,5,1
CZ,CH,2000.0,10,10,0
CZ,DE,2010.0,49,44,5
ET,GB,2022.0,8,8,0
PH,SG,2016.0,7,15,-8
GH,GB,2015.0,12,28,-16
DK,EE,2013.0,2,1,1
AR,IT,2000.0,30,23,7
DK,GR,2013.0,3,11,-8
FI,DK,2011.0,16,16,0
TH,ID,2011.0,8,2,6
GR,AU,2019.0,14,6,8
AU,BR,2005.0,21,34,-13
KW,FR,2013.0,2,1,1
BD,DE,2010.0,4,7,-3
CN,HR,2019.0,2,2,0
KW,GB,1999.0,2,3,-1
VE,CL,2005.0,8,11,-3
SI,CA,2017.0,4,4,0
BR,ID,2020.0,16,16,0
AE,IQ,2022.0,4,7,-3
GR,CH,2000.0,8,6,2
EC,PE,2016.0,14,42,-28
CH,BE,2000.0,17,28,-11
NL,SS,2015.0,1,1,0
RS,IN,2019.0,4,3,1
NZ,SE,2003.0,3,4,-1
IN,KW,2003.0,10,3,7
BD,NZ,2011.0,1,2,-1
TH,NZ,2018.0,4,3,1
HU,SK,2020.0,7,14,-7
KR,BR,2012.0,6,3,3
IE,IT,2005.0,6,13,-7
SK,AU,2005.0,1,3,-2
GT,US,2012.0,9,8,1
IL,SG,2018.0,4,8,-4
CU,CL,1999.0,5,3,2
IT,UA,1998.0,7,2,5
VN,CN,2014.0,20,45,-25
CN,HR,2010.0,1,3,-2
IN,IS,2020.0,3,3,0
QA,US,2023.0,8,4,4
CA,HU,2000.0,6,9,-3
PL,CO,2011.0,1,1,0
GB,OM,2022.0,3,5,-2
BB,GB,2015.0,8,4,4
BG,CZ,1999.0,1,2,-1
SS,US,2009.0,3,3,0
TW,BN,2020.0,1,1,0
IL,MY,2015.0,2,4,-2
GH,BH,2015.0,8,3,5
SE,LU,2018.0,4,1,3
BG,SE,1998.0,4,4,0
AR,PT,2007.0,8,12,-4
UY,CR,2020.0,1,2,-1
TW,HR,2010.0,2,1,1
JP,CY,2001.0,2,2,0
KR,CL,2012.0,2,1,1
CH,CM,2018.0,5,3,2
NL,VE,2005.0,2,1,1
GB,BW,2013.0,3,1,2
GB,KW,2007.0,8,8,0
AR,BO,2004.0,3,1,2
BN,NL,2017.0,1,1,0
US,MA,2000.0,8,6,2
JO,IT,2017.0,2,3,-1
HU,ZA,2008.0,1,1,0
SD,LB,2021.0,1,1,0
EG,nan,2015.0,5,3,2
AT,CY,2020.0,1,1,0
LU,FI,2013.0,4,1,3
GR,VN,2003.0,2,6,-4
nan,CZ,2001.0,2,7,-5
BF,GH,2021.0,2,2,0
IL,DK,2022.0,3,3,0
BG,MX,2005.0,4,1,3
EE,MX,2020.0,1,1,0
CH,ET,2011.0,1,1,0
NZ,SG,2014.0,9,8,1
ET,PR,2020.0,3,12,-9
ZA,RU,2006.0,1,3,-2
KE,GH,2020.0,5,1,4
AT,IS,2011.0,1,1,0
DE,CO,2000.0,4,1,3
CI,CA,2019.0,2,7,-5
KR,PT,2015.0,1,2,-1
SA,JO,1998.0,2,1,1
CO,HN,2014.0,7,9,-2
CM,GA,2020.0,1,3,-2
BY,FR,2016.0,2,1,1
AE,ZA,2022.0,2,6,-4
US,UZ,2003.0,2,5,-3
RS,CH,2022.0,7,4,3
FR,TZ,2007.0,2,1,1
CY,CN,2013.0,1,2,-1
EG,QA,1998.0,1,3,-2
KZ,MY,2020.0,1,2,-1
JO,DZ,2014.0,1,1,0
NG,IL,2019.0,3,1,2
DE,MA,2001.0,2,1,1
MA,TG,2017.0,2,2,0
EC,CZ,2013.0,1,1,0
RU,IN,2023.0,2,2,0
PS,JO,2017.0,2,5,-3
NL,MX,1999.0,5,1,4
NL,BN,2017.0,1,1,0
TH,TR,2010.0,3,5,-2
BR,GT,2015.0,1,2,-1
EG,VN,2007.0,1,1,0
DE,GB,2006.0,681,485,196
US,DE,2015.0,2512,2505,7
TN,QA,2014.0,7,2,5
CZ,DE,2017.0,82,79,3
DK,nan,2021.0,13,10,3
BO,IR,2015.0,2,3,-1
AU,RU,2008.0,9,19,-10
VN,CA,2023.0,3,1,2
FI,AU,2019.0,20,23,-3
AT,KR,2018.0,5,5,0
TZ,US,2017.0,27,19,8
LU,CH,2011.0,4,7,-3
UZ,US,2003.0,5,2,3
IE,AT,2005.0,4,2,2
EG,OM,2006.0,3,1,2
IT,MY,1999.0,18,16,2
NL,SK,2009.0,6,3,3
,BR,1995.0,8461,0,8461
,CO,2011.0,2638,0,2638
,RU,1994.0,14936,0,14936
US,,2003.0,23370,0,23370
,CN,2003.0,55358,0,55358
,GB,2000.0,15372,0,15372
,NL,1996.0,6359,0,6359
,ID,2008.0,3195,0,3195
GB,,2010.0,9473,0,9473
DE,,2006.0,6595,0,6595
BR,,2015.0,7422,0,7422
,NL,2004.0,5312,0,5312
,JO,2002.0,190,0,190
,SK,2009.0,830,0,830
GB,,2017.0,14725,0,14725
BE,,2016.0,2474,0,2474
,HR,1994.0,1210,0,1210
CO,IT,2023.0,2,0,2
GB,,2019.0,17893,0,17893
,KW,1999.0,142,0,142
KR,,2013.0,2291,0,2291
HU,,2012.0,723,0,723
,ES,2003.0,11030,0,11030
,US,2018.0,65361,0,65361
,EG,2002.0,1070,0,1070
,IL,2008.0,2301,0,2301
,CL,2014.0,1945,0,1945
,JO,2005.0,232,0,232
,BE,2006.0,2960,0,2960
PL,,2015.0,2501,0,2501
,PT,1999.0,942,0,942
,PK,2013.0,2488,0,2488
NL,,2018.0,5912,0,5912
PT,,2021.0,2338,0,2338
,EG,2005.0,1717,0,1717
,DK,2014.0,2259,0,2259
ES,GI,2014.0,1,0,1
EG,,2019.0,2072,0,2072
,SN,2000.0,63,0,63
,LB,1994.0,125,0,125
HR,DK,2014.0,3,0,3
,CM,2010.0,316,0,316
CI,,2000.0,5,0,5
ET,,2017.0,146,0,146
US,BO,1998.0,5,0,5
US,SJ,2010.0,2,0,2
GB,SJ,2014.0,2,0,2
SA,,2016.0,707,0,707
KP,,2023.0,165,0,165
KW,,2021.0,263,0,263
HK,,2021.0,61,0,61
PS,,2020.0,119,0,119
,LT,2010.0,863,0,863
EG,,2017.0,1302,0,1302
,TW,2014.0,3065,0,3065
SK,,2004.0,118,0,118
LB,,2016.0,162,0,162
EG,,2010.0,355,0,355
,LT,2019.0,288,0,288
QA,,2022.0,588,0,588
ZA,,1998.0,233,0,233
IL,,2025.0,1146,0,1146
,KZ,2019.0,554,0,554
,LK,1995.0,101,0,101
,CR,2014.0,349,0,349
TZ,,2023.0,1086,0,1086
,CM,2017.0,558,0,558
LV,PL,2008.0,2,0,2
BO,,2012.0,18,0,18
,MM,2000.0,28,0,28
,KZ,2010.0,339,0,339
,LT,2017.0,578,0,578
,KZ,2017.0,875,0,875
,AZ,1999.0,64,0,64
TH,,2004.0,141,0,141
ET,,2019.0,287,0,287
PA,,2020.0,120,0,120
,TN,2018.0,1045,0,1045
UZ,,2023.0,1324,0,1324
MC,GT,2017.0,1,0,1
,GT,2002.0,28,0,28
,KP,2016.0,46,0,46
MN,,2019.0,60,0,60
,CM,2019.0,313,0,313
,NE,2002.0,15,0,15
,UG,2009.0,292,0,292
MT,JP,2013.0,1,0,1
SI,TW,2014.0,3,0,3
GH,,2011.0,18,0,18
NG,,2015.0,624,0,624
NZ,,1998.0,174,0,174
CN,RW,2018.0,4,0,4
UZ,UA,2022.0,4,0,4
ZW,,2022.0,259,0,259
,MA,2018.0,1735,0,1735
BG,,2003.0,115,0,115
CL,RO,2006.0,1,0,1
BF,,2008.0,8,0,8
,BA,1998.0,37,0,37
MA,,2013.0,284,0,284
SN,TG,2016.0,2,0,2
,CV,2010.0,5,0,5
OM,,2025.0,56,0,56
CH,AF,2008.0,1,0,1
CN,GT,2020.0,1,0,1
,SY,2018.0,166,0,166
RE,,2025.0,13,0,13
MG,,2018.0,46,0,46
PR,,2025.0,2,0,2
IN,KN,2017.0,2,0,2
KN,,2021.0,17,0,17
BR,GH,2021.0,1,0,1
,GD,2011.0,20,0,20
,MX,2020.0,131,0,131
MN,,2010.0,10,0,10
BJ,,2025.0,15,0,15
,ET,2005.0,192,0,192
IN,CL,2015.0,7,0,7
,ET,2002.0,133,0,133
,GY,2017.0,7,0,7
EC,,2001.0,8,0,8
MN,,2017.0,32,0,32
,GH,2001.0,64,0,64
BR,TN,2013.0,1,0,1
,MT,2002.0,19,0,19
,BI,2012.0,15,0,15
MW,,2018.0,54,0,54
CN,,2026.0,32,0,32
CM,BD,2012.0,1,0,1
BD,,2008.0,39,0,39
UG,ID,2017.0,4,0,4
CR,DO,2017.0,3,0,3
FO,,2021.0,11,0,11
CH,GE,2002.0,2,0,2
,TT,1999.0,31,0,31
AR,DK,2004.0,6,0,6
,MT,2005.0,41,0,41
,PY,2016.0,85,0,85
CM,BA,2011.0,1,0,1
,QA,2000.0,67,0,67
CM,CF,2019.0,2,0,2
SR,,2021.0,11,0,11
IN,CY,2004.0,2,0,2
RU,SG,2003.0,1,0,1
,ME,1998.0,14,0,14
EC,NO,2011.0,1,0,1
SN,MA,2020.0,3,0,3
NI,,2013.0,6,0,6
,ZM,2007.0,74,0,74
ML,,2020.0,36,0,36
MZ,FR,2012.0,1,0,1
SI,CA,2010.0,1,0,1
RU,LU,2004.0,1,0,1
SN,,2018.0,105,0,105
LR,,2020.0,8,0,8
CI,UA,2019.0,1,0,1
MQ,,2021.0,26,0,26
IQ,,2000.0,4,0,4
ID,EE,2022.0,1,0,1
BF,EG,2018.0,1,0,1
,NE,2005.0,20,0,20
MK,IT,2017.0,4,0,4
,YE,2003.0,12,0,12
,AO,1998.0,11,0,11
MD,TN,2017.0,8,0,8
ET,,2010.0,35,0,35
NG,TH,2010.0,1,0,1
ET,IQ,2021.0,3,0,3
PL,SI,2002.0,1,0,1
CN,PE,2021.0,4,0,4
FR,BH,2008.0,3,0,3
,AF,2005.0,5,0,5
UG,GH,2016.0,1,0,1
PT,HR,2020.0,2,0,2
BR,VN,2007.0,1,0,1
MX,PA,2001.0,1,0,1
BE,CF,2018.0,1,0,1
DZ,,1999.0,8,0,8
ID,,2001.0,30,0,30
GT,,2006.0,3,0,3
,BA,1997.0,39,0,39
SA,MY,2004.0,5,0,5
CI,BF,2005.0,1,0,1
BJ,CG,2013.0,4,0,4
,GT,2005.0,15,0,15
BD,BN,2003.0,1,0,1
SK,MK,2009.0,1,0,1
PK,KR,2003.0,4,0,4
,RE,2012.0,20,0,20
LS,US,2014.0,1,0,1
HN,,2012.0,5,0,5
,BO,2001.0,23,0,23
LA,DE,2018.0,1,0,1
CH,CR,2023.0,1,0,1
IE,IS,2002.0,2,0,2
LK,MX,2020.0,1,0,1
JP,OM,2016.0,3,0,3
PG,TN,2014.0,2,0,2
CV,,2024.0,15,0,15
,FO,2011.0,1,0,1
US,SV,2000.0,1,0,1
CD,,2015.0,18,0,18
PL,KR,2008.0,3,0,3
ES,NI,2022.0,2,0,2
NO,LK,2014.0,2,0,2
LT,SE,2023.0,1,0,1
,VU,2004.0,1,0,1
NZ,QA,2009.0,1,0,1
PG,BE,2016.0,1,0,1
GR,BN,2019.0,1,0,1
IE,BN,2015.0,1,0,1
,SV,2006.0,9,0,9
UA,PT,2011.0,1,0,1
CO,CI,2018.0,1,0,1
GR,PS,2013.0,1,0,1
PH,MX,2009.0,8,0,8
PL,MN,2020.0,3,0,3
RS,SG,2009.0,1,0,1
,BS,2011.0,7,0,7
,ME,1997.0,9,0,9
IS,BE,2012.0,1,0,1
AT,AZ,2000.0,1,0,1
GL,DK,2008.0,3,0,3
KE,CO,1998.0,1,0,1
AZ,NL,2003.0,2,0,2
GH,CZ,2014.0,1,0,1
,LA,2005.0,10,0,10
PR,AR,2015.0,1,0,1
HR,US,2023.0,1,0,1
CM,CF,2010.0,1,0,1
DK,GH,1997.0,3,0,3
NZ,KZ,2014.0,1,0,1
NZ,HR,2012.0,1,0,1
CN,HR,2017.0,1,0,1
CY,NL,2022.0,3,0,3
BH,OM,2005.0,1,0,1
MA,PT,2007.0,4,0,4
AL,DE,2014.0,1,0,1
TW,LY,2019.0,1,0,1
VG,,1998.0,2,0,2
TW,AR,2000.0,1,0,1
MU,,2005.0,4,0,4
NZ,TN,2013.0,1,0,1
SN,JP,2016.0,1,0,1
SD,MW,2008.0,1,0,1
,TD,2011.0,3,0,3
NG,OM,1997.0,1,0,1
BH,AG,2022.0,1,0,1
GR,SI,2009.0,1,0,1
IR,LV,2020.0,1,0,1
FR,KZ,2004.0,1,0,1
SD,KW,2019.0,3,0,3
BF,NL,2021.0,1,0,1
CD,ES,2019.0,1,0,1
KZ,SG,2017.0,2,0,2
WS,,2022.0,3,0,3
BJ,AU,2010.0,1,0,1
CO,TH,2020.0,1,0,1
EG,TJ,2020.0,1,0,1
KE,SN,2018.0,1,0,1
IR,LT,2016.0,1,0,1
BG,SE,1997.0,1,0,1
BG,SK,2018.0,1,0,1
RO,EE,2009.0,2,0,2
OM,VN,2018.0,1,0,1
TW,MN,2008.0,1,0,1
GB,MZ,2014.0,1,0,1
TN,PT,2010.0,2,0,2
GB,LA,2008.0,1,0,1
TN,NL,2010.0,1,0,1
IE,nan,2004.0,2,0,2
RU,MK,2009.0,1,0,1
IN,MD,2002.0,1,0,1
LY,QA,2020.0,2,0,2
QA,NO,2004.0,3,0,3
JP,PY,2015.0,2,0,2
MC,,2025.0,4,0,4
IN,GT,2014.0,1,0,1
CL,BO,2004.0,2,0,2
BO,CL,2000.0,2,0,2
MA,GP,2020.0,1,0,1
MD,TN,2019.0,6,0,6
LB,MY,2007.0,1,0,1
US,DZ,1997.0,1,0,1
PK,SG,2004.0,1,0,1
IE,CL,2021.0,3,0,3
NL,PG,2013.0,1,0,1
PT,PH,2021.0,1,0,1
BW,NL,2003.0,1,0,1
BI,GB,2006.0,1,0,1
KR,BH,2001.0,1,0,1
RO,NG,2017.0,2,0,2
LV,FI,2018.0,1,0,1
UA,TW,1999.0,1,0,1
GP,JM,2005.0,1,0,1
RU,CR,2008.0,2,0,2
AZ,RU,1998.0,1,0,1
MA,GB,1997.0,2,0,2
PS,FR,2012.0,1,0,1
VE,NI,2020.0,1,0,1
SZ,ET,2022.0,1,0,1
RU,CY,2012.0,1,0,1
JO,BD,2020.0,2,0,2
BE,LS,2015.0,1,0,1
AR,KR,2016.0,1,0,1
CZ,MA,2013.0,1,0,1
MA,MD,2020.0,1,0,1
LK,BR,2002.0,2,0,2
,MS,2005.0,2,0,2
nan,HR,2018.0,3,0,3
nan,BJ,2003.0,1,0,1
MZ,NL,2012.0,1,0,1
ZA,TW,2020.0,4,0,4
UG,CN,2007.0,1,0,1
PK,LT,2016.0,1,0,1
PY,,2012.0,1,0,1
ID,UA,2019.0,9,0,9
CA,TZ,2022.0,2,0,2
VG,NO,2012.0,1,0,1
TW,TH,2009.0,3,0,3
SG,HU,2019.0,2,0,2
JM,PH,2004.0,1,0,1
KE,DK,2002.0,1,0,1
AM,SE,2022.0,1,0,1
MD,AR,2016.0,1,0,1
CZ,PH,1997.0,1,0,1
MM,KR,2009.0,1,0,1
BY,SI,2021.0,1,0,1
IT,EE,2000.0,2,0,2
BR,AE,2008.0,1,0,1
BN,AE,2017.0,1,0,1
LB,MA,2020.0,3,0,3
TR,AR,2011.0,2,0,2
BB,CA,2007.0,2,0,2
MA,IN,2017.0,3,0,3
AU,UY,2023.0,1,0,1
TG,,2014.0,4,0,4
RU,UY,2018.0,1,0,1
BA,nan,2015.0,2,0,2
AM,CN,2010.0,1,0,1
ZA,KN,2015.0,1,0,1
CH,CI,2003.0,2,0,2
RU,IS,2021.0,1,0,1
MY,NO,2016.0,2,0,2
KZ,KG,2014.0,1,0,1
LS,BW,2012.0,1,0,1
MY,JO,1999.0,1,0,1
ES,IQ,2014.0,1,0,1
CZ,IS,2016.0,2,0,2
BO,SV,2010.0,1,0,1
NO,ZM,2021.0,1,0,1
,BY,2020.0,21,0,21
CN,YE,2006.0,1,0,1
ZW,SZ,2011.0,2,0,2
BD,PH,2006.0,1,0,1
SG,LY,2011.0,1,0,1
NI,DE,2002.0,1,0,1
PL,NZ,2005.0,2,0,2
,CV,2017.0,1,0,1
CA,LT,2017.0,3,0,3
NL,ZW,1999.0,1,0,1
UA,NP,2021.0,4,0,4
SG,LI,2017.0,1,0,1
HN,CL,2009.0,1,0,1
SA,JO,1997.0,3,0,3
US,CG,2014.0,1,0,1
IQ,AU,2003.0,1,0,1
VN,KE,2003.0,1,0,1
KE,BI,2006.0,1,0,1
HR,GR,2003.0,1,0,1
RU,IQ,2022.0,5,0,5
GE,NZ,2015.0,2,0,2
BO,CU,2013.0,4,0,4
CH,BW,2016.0,1,0,1
BE,GH,2012.0,1,0,1
CD,DE,2016.0,1,0,1
KY,IN,2013.0,1,0,1
ET,EG,2001.0,2,0,2
MA,BF,2015.0,1,0,1
RS,IR,2019.0,2,0,2
BE,TG,2008.0,2,0,2
TG,BJ,2011.0,1,0,1
EG,BN,2015.0,1,0,1
PK,LY,2022.0,1,0,1
LU,UG,2005.0,1,0,1
CU,BE,2011.0,5,0,5
MU,,2002.0,4,0,4
PE,EG,2008.0,2,0,2
UA,SI,2017.0,2,0,2
PT,RO,2006.0,1,0,1
AR,SD,2007.0,1,0,1
BM,,2011.0,1,0,1
TR,UG,2015.0,1,0,1
SG,PY,2006.0,1,0,1
IL,NO,2004.0,2,0,2
BE,MC,2017.0,1,0,1
,AO,1997.0,4,0,4
ZM,ML,2016.0,1,0,1
,AF,2002.0,2,0,2
CZ,BW,2021.0,1,0,1
ZA,RO,2009.0,2,0,2
TN,AT,2011.0,1,0,1
SK,nan,2021.0,2,0,2
GA,CO,2015.0,1,0,1
VG,VE,2002.0,1,0,1
MW,CH,2014.0,2,0,2
,TM,2005.0,1,0,1
UA,KR,2008.0,4,0,4
DZ,IN,2012.0,1,0,1
BJ,ES,2000.0,1,0,1
EE,BW,2016.0,1,0,1
,PF,2015.0,3,0,3
LU,ME,2019.0,1,0,1
UY,EE,2009.0,1,0,1
,ER,2008.0,2,0,2
LK,EE,2022.0,1,0,1
BE,PK,2011.0,4,0,4
CA,LU,2021.0,3,0,3
RU,NL,2023.0,4,0,4
TZ,ZM,2014.0,3,0,3
MX,VG,2009.0,1,0,1
HR,MD,2020.0,1,0,1
NO,EE,2002.0,1,0,1
PK,BA,2014.0,1,0,1
GR,PL,2020.0,4,0,4
IL,PH,2007.0,2,0,2
KR,YE,2016.0,1,0,1
CA,NC,2011.0,2,0,2
AR,NI,2007.0,1,0,1
HT,,2014.0,3,0,3
DE,GP,2012.0,2,0,2
NO,SA,2012.0,3,0,3
NE,CI,2009.0,1,0,1
EC,IL,2022.0,1,0,1
AU,BS,2012.0,1,0,1
PY,SD,2018.0,1,0,1
LT,CY,2021.0,1,0,1
LT,MZ,2020.0,1,0,1
SE,EC,2016.0,2,0,2
BA,DK,2020.0,1,0,1
CV,PT,2015.0,1,0,1
US,DO,2010.0,2,0,2
BF,CG,2018.0,2,0,2
CO,AM,2018.0,1,0,1
NZ,ID,2010.0,1,0,1
,GY,2010.0,6,0,6
BD,PS,2015.0,2,0,2
BG,TW,2016.0,1,0,1
ML,BE,2014.0,1,0,1
AU,AM,2001.0,1,0,1
ZA,VN,2018.0,2,0,2
AE,KR,2011.0,1,0,1
IR,IN,1999.0,1,0,1
AE,TJ,2020.0,1,0,1
NC,RE,2019.0,5,0,5
LI,HR,2013.0,1,0,1
nan,EE,2014.0,1,0,1
HU,EE,2008.0,1,0,1
ZA,TT,2022.0,1,0,1
LY,,2001.0,3,0,3
MY,DE,2002.0,1,0,1
SA,IQ,2023.0,1,0,1
PG,CA,2014.0,1,0,1
PT,KW,2014.0,2,0,2
TT,BR,2008.0,2,0,2
ZM,SE,2021.0,1,0,1
JE,CO,2014.0,1,0,1
PA,UA,2017.0,1,0,1
AT,BF,2020.0,1,0,1
IQ,VG,2019.0,1,0,1
FR,LY,2016.0,1,0,1
BW,ID,2017.0,1,0,1
AZ,RU,1997.0,1,0,1
VN,GR,1998.0,3,0,3
,LA,2002.0,3,0,3
IQ,VG,2017.0,1,0,1
BR,GF,2006.0,1,0,1
TD,FR,2011.0,1,0,1
SI,RU,2010.0,2,0,2
NG,LB,2017.0,1,0,1
TJ,SE,2009.0,1,0,1
GB,UZ,2022.0,1,0,1
AU,MG,2006.0,1,0,1
ET,MX,2022.0,2,0,2
,MS,2002.0,1,0,1
PA,CH,2013.0,1,0,1
IE,CR,2012.0,1,0,1
SD,CO,1998.0,1,0,1
PT,BG,2019.0,1,0,1
JM,FR,2022.0,1,0,1
FI,KW,2001.0,3,0,3
NO,OM,2013.0,1,0,1
AM,EG,2017.0,1,0,1
OM,TH,2018.0,2,0,2
PK,TW,2016.0,1,0,1
IR,HU,2009.0,2,0,2
JO,PT,2008.0,1,0,1
CR,DO,2019.0,1,0,1
LU,CI,2015.0,1,0,1
MG,BF,2011.0,1,0,1
OM,PH,2018.0,2,0,2
AL,RS,2015.0,1,0,1
MY,CY,2020.0,1,0,1
SI,HU,2019.0,3,0,3
ZM,GR,2022.0,1,0,1
DE,SD,2005.0,2,0,2
UZ,MY,2005.0,2,0,2
CL,NG,2019.0,1,0,1
TT,CU,2015.0,1,0,1
AU,CI,2014.0,2,0,2
TH,ES,2008.0,1,0,1
CM,CG,2011.0,1,0,1
ET,IE,2012.0,1,0,1
PY,GT,2015.0,1,0,1
UG,NZ,2004.0,1,0,1
NL,VE,2002.0,1,0,1
EG,SY,2003.0,1,0,1
BE,BO,2012.0,1,0,1
FR,JM,2016.0,1,0,1
AO,BR,1997.0,2,0,2
CL,EE,2021.0,1,0,1
CA,ZM,2021.0,2,0,2
ST,,2013.0,5,0,5
PE,IL,2006.0,1,0,1
HU,AR,2019.0,2,0,2
MX,CY,2019.0,2,0,2
SZ,,2005.0,1,0,1
PT,TW,2001.0,1,0,1
PK,MT,2020.0,1,0,1
UA,TZ,2017.0,1,0,1
HU,ID,2002.0,1,0,1
GY,GF,2017.0,1,0,1
LK,GH,2018.0,1,0,1
ZA,OM,2002.0,2,0,2
SN,KE,2004.0,1,0,1
NO,BJ,2006.0,1,0,1
BD,AE,2004.0,2,0,2
LV,SI,2021.0,2,0,2
BF,CI,2004.0,1,0,1
GB,GF,2015.0,1,0,1
TW,NG,1999.0,1,0,1
LB,CU,2007.0,1,0,1
TW,RE,2018.0,1,0,1
BW,JP,2016.0,1,0,1
SO,GB,2014.0,1,0,1
MD,FI,2018.0,1,0,1
GB,LS,2007.0,2,0,2
BD,HU,2013.0,1,0,1
CO,NO,2009.0,1,0,1
RS,IN,2010.0,1,0,1
CO,GE,2013.0,1,0,1
DE,MN,2008.0,2,0,2
QA,FI,2021.0,1,0,1
LK,CZ,2020.0,2,0,2
IR,BG,2017.0,2,0,2
TJ,NG,2016.0,1,0,1
NP,IL,2015.0,3,0,3
SE,GE,2006.0,1,0,1
CA,LT,2010.0,3,0,3
GM,MA,2014.0,1,0,1
UG,PE,2016.0,1,0,1
PK,ID,2004.0,2,0,2
BE,IQ,2014.0,1,0,1
DE,CW,2008.0,2,0,2
GB,CU,2021.0,3,0,3
TZ,BR,2014.0,1,0,1
BE,LV,2015.0,2,0,2
ES,LV,2015.0,2,0,2
CZ,TR,2000.0,3,0,3
KE,SA,2006.0,1,0,1
GP,GF,2006.0,1,0,1
,MR,1995.0,2,0,2
BR,HU,2009.0,1,0,1
BG,EE,2018.0,1,0,1
PG,DE,2017.0,1,0,1
GP,CA,1998.0,1,0,1
VE,MY,2006.0,1,0,1
MS,NZ,2011.0,1,0,1
LU,CZ,2015.0,2,0,2
TZ,TW,2017.0,1,1,0
MA,CM,2016.0,1,3,-2
GH,MY,2022.0,2,3,-1
BE,CU,2017.0,1,8,-7
MG,ZA,2014.0,1,1,0
GT,CL,2008.0,1,2,-1
MD,US,2006.0,1,7,-6
SG,MM,2011.0,1,2,-1
IN,PH,1997.0,2,6,-4
CL,SG,2020.0,1,2,-1
NO,AT,1998.0,1,1,0
AL,SE,2009.0,3,1,2
CH,ST,2006.0,1,1,0
QA,MY,2013.0,2,2,0
MX,SG,2013.0,2,6,-4
IE,LB,2016.0,1,1,0
AE,LB,2014.0,1,1,0
TT,CA,2015.0,3,3,0
MX,RU,1997.0,3,7,-4
BY,IT,2013.0,3,1,2
NO,UG,2013.0,2,2,0
AU,GR,1997.0,1,3,-2
SI,SK,2004.0,1,2,-1
BY,CA,2010.0,1,2,-1
PE,ET,2022.0,1,1,0
CL,UA,2014.0,2,1,1
KZ,IT,2015.0,1,4,-3
BE,LU,1999.0,3,2,1
ET,IT,2013.0,1,1,0
ET,DE,2023.0,1,1,0
SN,CI,2021.0,2,3,-1
PL,PT,2021.0,2,6,-4
BE,BG,2016.0,2,4,-2
IN,AG,2014.0,1,1,0
CA,LT,2019.0,1,3,-2
ET,DK,2017.0,2,4,-2
PW,US,1998.0,1,1,0
MW,DE,2020.0,1,2,-1
TZ,BJ,2016.0,2,2,0
PL,RO,1999.0,1,2,-1
RU,VN,2010.0,3,1,2
JP,ET,2002.0,3,1,2
MK,DE,2011.0,2,2,0
SK,AU,2002.0,1,1,0
QA,KW,2014.0,1,1,0
CU,HN,2013.0,2,2,0
RS,RO,2008.0,1,1,0
DE,SD,2002.0,1,1,0
CI,GN,2012.0,1,1,0
ZA,PT,2014.0,1,7,-6
BN,TW,2020.0,1,1,0
BE,IR,2006.0,1,3,-2
HU,BR,2018.0,3,5,-2
ET,ES,2015.0,1,2,-1
NG,TH,2019.0,3,5,-2
DK,CL,2010.0,3,4,-1
BH,PK,2023.0,1,2,-1
YE,MY,2008.0,2,1,1
HR,SE,2007.0,1,1,0
PE,BE,2022.0,2,3,-1
EE,DK,2013.0,1,2,-1
BN,LK,2018.0,1,1,0
RS,CA,2000.0,1,2,-1
MC,US,2004.0,1,1,0
PK,PE,2020.0,1,2,-1
IE,NG,2021.0,2,1,1
HU,XK,2019.0,1,1,0
QA,SE,2014.0,1,1,0
MX,CZ,2008.0,1,2,-1
UG,NG,2007.0,1,1,0
PS,SA,2009.0,2,1,1
NL,UG,1998.0,1,1,0
IT,UA,1997.0,1,4,-3
FI,LT,2014.0,3,2,1
SA,IE,2017.0,4,6,-2
ST,PT,2018.0,2,1,1
IL,HU,2002.0,2,2,0
GL,QA,2005.0,1,1,0
CI,TG,2015.0,1,2,-1
CZ,ZA,2006.0,1,2,-1
TH,IR,2022.0,1,4,-3
RS,MK,2014.0,1,2,-1
BG,PT,2007.0,1,1,0
AU,CY,2014.0,1,1,0
CI,UA,2017.0,1,1,0
NZ,PL,2015.0,1,1,0
LT,NO,2002.0,2,5,-3
PG,GB,1998.0,1,2,-1
VN,SA,2020.0,1,2,-1
BH,KE,2009.0,1,3,-2
GB,RS,1997.0,1,1,0
MN,CA,2019.0,1,1,0
SE,UG,2005.0,1,1,0
LB,AU,2004.0,1,1,0
BR,IR,2022.0,1,6,-5
NC,US,2014.0,1,4,-3
CI,DE,2006.0,1,2,-1
FI,PT,2013.0,2,2,0
US,CI,2021.0,4,4,0
YE,IQ,2021.0,1,1,0
EG,QA,1997.0,3,4,-1
EG,AU,2007.0,2,2,0
MT,US,2021.0,2,9,-7
IT,UG,2005.0,1,2,-1
JO,TR,2016.0,1,1,0
ML,IT,2003.0,1,1,0
NC,RE,2017.0,1,1,0
FR,UZ,2009.0,1,3,-2
CY,AZ,2019.0,1,1,0
EG,CZ,2005.0,2,1,1
CZ,HU,1997.0,1,1,0
AT,BY,2022.0,1,1,0
KE,PH,2011.0,1,1,0
nan,GH,2015.0,2,1,1
CZ,TW,1998.0,1,2,-1
AR,SE,2006.0,1,6,-5
CL,GR,2020.0,1,1,0
PE,PH,2017.0,1,8,-7
SI,HU,2010.0,1,1,0
SK,NO,2010.0,1,1,0
EE,ES,2022.0,1,2,-1
JP,CU,2009.0,1,6,-5
ZW,CD,2018.0,1,1,0
FI,PE,2014.0,1,1,0
DK,CZ,2011.0,1,3,-2
BE,UA,2009.0,1,4,-3
CZ,NG,2012.0,1,1,0
LK,SG,2004.0,1,1,0
MX,VN,2000.0,1,3,-2
IT,SI,2000.0,1,4,-3
SY,DE,2006.0,1,2,-1
TW,SZ,2022.0,1,1,0
CN,SA,2008.0,1,2,-1
IT,SK,2022.0,2,5,-3
JO,IN,2001.0,1,1,0
US,BA,2021.0,2,8,-6
QA,NG,2018.0,1,3,-2
BR,CV,2014.0,1,2,-1
SV,CL,2009.0,1,1,0
NL,SD,1998.0,1,2,-1
GA,CA,2016.0,1,1,0
TH,TR,2019.0,2,2,0
RU,SY,2022.0,1,1,0
KR,AR,2019.0,1,1,0
PL,TR,2011.0,1,4,-3
CN,AZ,2010.0,1,1,0
TN,PT,2019.0,1,4,-3
ZA,BF,2020.0,1,2,-1
QA,OM,2018.0,2,2,0
CN,AT,1999.0,1,4,-3
PL,QA,2020.0,1,1,0
GB,IM,2018.0,1,1,0
RS,PL,2009.0,2,1,1
TN,NL,2019.0,1,2,-1
RS,IN,2017.0,1,3,-2
PK,JO,2021.0,3,3,0
ZM,BD,2015.0,1,2,-1
BE,MW,2015.0,1,1,0
UA,SI,2019.0,3,1,2
FR,RS,2008.0,1,6,-5
NI,UA,2010.0,1,2,-1
DK,IL,2016.0,2,5,-3
BF,CH,2014.0,1,1,0
AT,PT,1999.0,1,1,0
LS,GB,2020.0,1,1,0
LT,BE,2020.0,1,3,-2
NG,PH,2013.0,1,1,0
FR,MU,2018.0,2,0,2
MY,PH,2009.0,1,0,1
SG,CU,2015.0,1,0,1
SG,KN,2018.0,1,0,1
VE,DO,2001.0,1,0,1
BH,CN,2005.0,1,0,1
ID,JO,2013.0,2,0,2
EC,VN,2022.0,1,0,1
RO,IN,2005.0,2,0,2
NG,TR,2015.0,4,0,4
ZA,TR,2021.0,2,0,2
IL,KE,2022.0,1,0,1
BH,IN,2000.0,1,0,1
nan,CU,2003.0,1,0,1
ES,ME,2018.0,1,0,1
US,MW,2023.0,1,0,1
NE,MA,2014.0,1,0,1
MT,BR,2015.0,1,0,1
GR,AE,2010.0,2,0,2
TR,ZA,2005.0,1,0,1
NP,TH,2009.0,2,0,2
CN,DO,2013.0,1,0,1
CF,MA,2009.0,1,0,1
SN,LB,2021.0,1,0,1
ET,PK,2009.0,1,0,1
PA,EC,2008.0,1,0,1
IE,MD,2021.0,1,0,1
PG,AE,2021.0,1,0,1
AM,KZ,2011.0,1,0,1
TW,PR,2016.0,1,0,1
ZA,SA,2023.0,1,0,1
TR,ZA,2002.0,1,0,1
ZA,TG,2015.0,1,0,1
NO,VN,2013.0,2,0,2
UA,SI,2010.0,2,0,2
GF,BR,2016.0,1,0,1
BY,AM,2014.0,1,0,1
ML,UG,2020.0,1,0,1
OM,SE,1999.0,1,0,1
ID,YE,2009.0,1,0,1
CO,LB,2017.0,1,0,1
AT,EC,2021.0,1,0,1
BE,ML,2021.0,1,0,1
DE,AL,2013.0,1,0,1
SK,GH,2005.0,1,0,1
KE,TR,2022.0,1,0,1
OM,SY,2003.0,1,0,1
BE,BW,2019.0,1,0,1
TD,SN,2001.0,1,0,1
DK,JO,2018.0,2,0,2
LA,CN,2016.0,1,0,1
RW,nan,2003.0,1,0,1
TJ,US,2012.0,1,0,1
BE,CD,2002.0,1,0,1
VN,MM,2018.0,1,0,1
PS,TR,2003.0,1,0,1
UZ,GR,2020.0,1,0,1
CM,ES,2009.0,1,0,1
TG,BF,2016.0,3,0,3
AZ,BE,2010.0,1,0,1
RE,CH,2018.0,1,0,1
SJ,,2000.0,1,0,1
MC,LU,2020.0,1,0,1
KZ,FR,2012.0,1,0,1
ZW,RW,2008.0,1,0,1
NO,BH,2006.0,1,0,1
CU,RU,2011.0,1,0,1
JP,HR,2020.0,1,0,1
LC,,2024.0,1,0,1
ET,NP,2017.0,1,0,1
SL,PK,2021.0,2,0,2
AR,SK,1998.0,1,0,1
IS,UA,2018.0,1,0,1
IN,SJ,2016.0,1,0,1
AT,BD,2019.0,1,0,1
BY,PT,1999.0,1,0,1
PH,TR,2020.0,1,0,1
CL,EG,2014.0,1,0,1
AT,LB,2003.0,1,0,1
DK,GE,2006.0,1,0,1
LB,BH,2001.0,1,0,1
IR,SD,2021.0,1,0,1
CM,FI,2017.0,1,0,1
RO,IL,2013.0,1,0,1
ZM,EG,2021.0,1,0,1
MX,KW,2012.0,1,0,1
LT,BG,2006.0,1,0,1
,CV,2019.0,1,0,1
KG,CH,2018.0,1,0,1
ER,ET,2012.0,1,0,1
NZ,EE,2009.0,1,0,1
CN,IS,2011.0,1,0,1
IR,SK,2016.0,2,0,2
SE,SD,2012.0,1,0,1
MY,IR,2000.0,1,0,1
BN,UG,2020.0,1,0,1
TH,TW,2008.0,2,0,2
KE,CD,2008.0,1,0,1
DO,PE,2014.0,1,0,1
NL,EE,1999.0,1,0,1
TZ,HU,2018.0,1,0,1
QA,CL,2019.0,1,0,1
NZ,GA,2012.0,1,0,1
MU,DE,2016.0,1,0,1
AU,MV,2017.0,1,0,1
IE,JO,2018.0,2,0,2
TH,BN,2012.0,1,0,1
HR,PT,2017.0,2,0,2
AM,PT,2014.0,1,0,1
FJ,ZM,2001.0,1,0,1
GM,AU,2016.0,1,0,1
SS,,2012.0,3,0,3
IT,NP,2010.0,1,0,1
UZ,AU,2022.0,1,0,1
YE,LY,2012.0,1,0,1
AR,AE,2011.0,1,0,1
AR,NG,2014.0,1,0,1
DZ,TW,2006.0,1,0,1
KW,ES,2018.0,1,0,1
GB,SY,1999.0,1,0,1
IN,BH,2022.0,3,0,3
DE,OM,1998.0,1,0,1
SE,AE,2003.0,1,0,1
GR,LU,2009.0,1,0,1
NC,RE,2010.0,1,0,1
MD,DK,2019.0,1,0,1
nan,CW,2020.0,1,0,1
GE,MX,2009.0,1,0,1
LY,GR,2010.0,1,0,1
BN,NL,2019.0,1,0,1
RE,AR,2014.0,1,0,1
CN,BA,2009.0,1,0,1
US,LS,1997.0,1,0,1
PA,SV,2017.0,1,0,1
CZ,SG,2004.0,1,0,1
NZ,CD,2004.0,1,0,1
MZ,nan,2008.0,1,0,1
SG,NP,2016.0,1,0,1
GE,CN,2021.0,1,0,1
IT,MW,2021.0,1,0,1
BB,ZA,2014.0,1,0,1
BJ,EG,2018.0,1,0,1
PT,MG,2021.0,1,0,1
CL,LI,2013.0,1,0,1
NC,BJ,2000.0,1,0,1
SL,ZA,2022.0,1,0,1
TT,DE,2001.0,1,0,1
CR,UY,2004.0,1,0,1
UZ,BA,2016.0,1,0,1
LB,AE,2023.0,1,0,1
MN,NP,2019.0,1,0,1
BY,FI,2004.0,1,0,1
,TL,2012.0,1,0,1
ZA,CL,2004.0,1,0,1
GD,TT,2019.0,1,0,1
GR,CL,2013.0,1,0,1
AU,RO,2001.0,1,0,1
SG,IQ,2012.0,1,0,1
GM,DK,2008.0,1,0,1
ID,DJ,2020.0,1,0,1
GT,FR,2009.0,1,0,1
LV,CN,2022.0,1,0,1
MZ,KZ,2018.0,1,0,1
JP,EE,2022.0,1,0,1
DE,UG,2023.0,1,0,1
CD,GH,2016.0,1,0,1
CY,KZ,2019.0,1,0,1
IT,TG,2016.0,1,0,1
TH,ZM,2010.0,1,0,1
NL,GY,1999.0,1,0,1
ES,KH,2018.0,1,0,1
UG,QA,2014.0,1,0,1
PK,GD,2013.0,1,0,1
IT,CU,2014.0,1,0,1
LK,PK,2004.0,1,0,1
PK,JM,2017.0,1,0,1
ID,CR,2016.0,1,0,1
TZ,UA,2001.0,1,0,1
SC,GB,2020.0,1,0,1
SS,RU,2011.0,1,0,1
BD,RU,2008.0,1,0,1
TW,IQ,2009.0,1,0,1
ZA,MT,2013.0,1,0,1
MM,nan,2012.0,1,0,1
CM,CF,2017.0,1,0,1
IL,SY,2007.0,1,0,1
TN,MY,2023.0,1,0,1
NG,LB,2019.0,1,0,1
UG,PH,2016.0,1,0,1
CF,CM,2021.0,1,0,1
AU,MV,2019.0,1,0,1
LK,BW,2017.0,1,0,1
PT,DO,2015.0,1,0,1
GD,HU,2013.0,1,0,1
SI,AZ,2006.0,1,0,1
MS,TT,1998.0,1,0,1
RO,NZ,2007.0,1,0,1
IE,RS,2003.0,1,0,1
BT,IN,2003.0,1,0,1
US,SR,2022.0,1,0,1
TR,IQ,2011.0,1,0,1
BE,NA,2011.0,1,0,1
IT,LV,2023.0,1,0,1
FJ,MW,2021.0,1,0,1
NZ,BN,2015.0,1,0,1
IE,QA,2007.0,1,0,1
BB,IN,2011.0,1,0,1
EE,IT,2004.0,1,0,1
ET,CG,2014.0,1,0,1
US,GA,2001.0,1,0,1
BH,AU,1999.0,1,0,1
DE,BN,2007.0,1,0,1
SA,HU,2014.0,1,0,1
KZ,TJ,2019.0,1,0,1
SD,IE,2018.0,1,0,1
nan,BY,2012.0,1,0,1
,GP,2020.0,1,0,1
MX,BH,2019.0,1,0,1
AU,CW,2013.0,1,0,1
JO,PH,2013.0,1,0,1
KW,SG,2018.0,1,0,1
BE,CG,2005.0,1,0,1
MA,KR,2006.0,1,0,1
MA,TG,2019.0,1,0,1
AL,XK,2004.0,1,0,1
AZ,HU,2020.0,1,0,1
GB,AL,2021.0,1,0,1
JO,AM,2004.0,1,0,1
US,GB,2009.0,5396,5180,216
PT,NL,2018.0,24,23,1
US,CA,1999.0,1489,1845,-356
MX,CO,2020.0,385,360,25
CA,EG,2003.0,14,12,2
DE,US,1997.0,1013,1140,-127
BE,US,2010.0,253,291,-38
FR,SE,2012.0,73,65,8
IN,GB,2017.0,525,522,3
FR,US,2011.0,1474,1379,95
GB,AU,2011.0,1381,1168,213
US,IN,2022.0,1630,2003,-373
US,TW,1999.0,462,327,135
AU,CN,2019.0,582,599,-17
CN,CA,2021.0,446,549,-103
BE,MX,2016.0,17,11,6
IN,GB,2010.0,316,352,-36
CN,JP,2008.0,392,704,-312
ES,PL,2016.0,35,21,14
VE,FR,2006.0,12,11,1
BR,PT,2020.0,1159,1230,-71
AU,CA,2014.0,336,429,-93
GB,JP,2020.0,282,230,52
CO,MX,2009.0,147,162,-15
US,ZA,2015.0,359,347,12
IT,ES,2009.0,225,130,95
DE,SE,2020.0,293,251,42
TW,US,2009.0,697,722,-25
FI,DE,1998.0,14,17,-3
JP,US,2003.0,1970,1662,308
BE,US,2019.0,444,396,48
GB,CA,2018.0,971,974,-3
CL,AT,2005.0,3,1,2
BE,CH,2022.0,55,40,15
DE,CA,2008.0,277,176,101
US,IE,2007.0,383,330,53
CN,SG,2017.0,478,587,-109
DE,US,1998.0,1424,1385,39
CH,KR,2017.0,18,16,2
CH,CA,2003.0,61,49,12
TH,DE,2021.0,17,14,3
CN,DE,2015.0,307,312,-5
nan,IN,2005.0,6,13,-7
CU,ES,2002.0,54,31,23
DE,FR,2011.0,559,508,51
ZA,US,1997.0,87,77,10
CW,US,2012.0,1,1,0
MX,US,2009.0,290,309,-19
CH,JP,2011.0,67,99,-32
NZ,AU,2016.0,208,169,39
DE,MX,2018.0,52,56,-4
KR,US,1998.0,261,468,-207
GB,PK,2023.0,20,13,7
CN,PT,2014.0,9,11,-2
BE,US,2017.0,428,373,55
ES,CO,2007.0,212,207,5
CN,GB,2002.0,251,261,-10
BR,FR,2004.0,89,95,-6
US,MX,2019.0,507,554,-47
CL,CR,2020.0,28,24,4
ES,DE,2009.0,164,189,-25
AU,CN,2010.0,270,281,-11
MX,ES,2012.0,644,701,-57
ES,BR,2018.0,490,394,96
IT,nan,2013.0,318,95,223
GW,DK,2017.0,7,1,6
PH,DE,2020.0,17,10,7
IT,CA,2010.0,81,73,8
CA,DE,2013.0,286,278,8
NL,CN,2020.0,153,159,-6
US,LB,2009.0,32,64,-32
RO,HU,2014.0,37,37,0
CA,SE,2022.0,45,49,-4
SG,CH,2022.0,15,6,9
US,GT,2015.0,15,15,0
IN,CN,2015.0,197,146,51
AT,US,2021.0,179,189,-10
DE,NL,1999.0,141,113,28
BR,PL,2017.0,15,16,-1
TR,NL,2015.0,24,41,-17
AU,RS,2016.0,11,2,9
CN,GB,2005.0,318,404,-86
MZ,RU,1999.0,4,1,3
MX,EC,2021.0,97,104,-7
IN,CA,2015.0,219,221,-2
MY,IR,2018.0,187,71,116
SA,CN,2021.0,50,57,-7
MY,CA,2018.0,63,26,37
CL,GB,2017.0,53,60,-7
US,NG,2015.0,86,83,3
DK,LU,2015.0,4,1,3
IT,CA,2019.0,155,131,24
FR,IT,2016.0,342,457,-115
nan,CN,2006.0,185,149,36
CH,CR,2019.0,6,3,3
BE,SE,1998.0,13,7,6
JP,GR,2000.0,37,37,0
DE,CN,2005.0,198,184,14
ET,US,2012.0,34,19,15
DK,AR,2021.0,4,2,2
IE,JP,2005.0,28,11,17
US,NO,2008.0,143,115,28
JP,IN,2008.0,112,118,-6
HN,US,2007.0,4,2,2
VE,US,2013.0,45,25,20
CZ,SA,2018.0,7,2,5
PA,ES,2010.0,10,13,-3
RU,CZ,2021.0,87,40,47
US,MY,2015.0,198,175,23
NO,GB,2020.0,73,152,-79
AR,PE,2016.0,46,50,-4
US,NZ,2001.0,188,220,-32
ES,IE,2004.0,15,10,5
KR,CA,2020.0,69,57,12
IE,CA,2001.0,29,43,-14
US,SA,2022.0,180,131,49
CN,BD,2015.0,71,118,-47
AU,KR,2013.0,34,46,-12
IL,US,2008.0,473,392,81
SA,IQ,2019.0,52,26,26
ES,NL,2008.0,62,68,-6
AU,LK,2009.0,9,16,-7
DK,TW,2016.0,2,4,-2
NL,FR,2015.0,200,156,44
ES,IT,2022.0,180,183,-3
IR,MY,2014.0,122,167,-45
EG,GB,2018.0,90,111,-21
SE,HR,2018.0,3,5,-2
CH,KR,2010.0,12,8,4
US,PL,2009.0,183,179,4
SY,US,2017.0,11,3,8
MY,US,2012.0,104,152,-48
TW,IN,2012.0,38,43,-5
CN,BE,2012.0,169,34,135
CN,NL,2010.0,88,86,2
PL,HU,2019.0,60,23,37
IL,BR,2009.0,9,4,5
QA,US,2019.0,77,83,-6
DE,GR,2015.0,51,87,-36
SE,TW,2018.0,6,7,-1
nan,DZ,2020.0,12,13,-1
GH,PH,2021.0,32,1,31
MX,PL,2022.0,2,6,-4
CN,DK,2018.0,57,67,-10
GB,FR,2014.0,567,625,-58
NL,SE,2021.0,55,66,-11
US,GR,2006.0,169,133,36
CH,PL,2020.0,27,34,-7
MZ,UA,2003.0,2,1,1
GB,nan,2013.0,71,79,-8
CA,SG,2006.0,37,29,8
BG,RU,2017.0,43,21,22
nan,CA,2018.0,60,27,33
CN,KR,2005.0,163,251,-88
GR,VN,1999.0,4,1,3
UA,RU,2021.0,562,404,158
IT,IN,2014.0,49,63,-14
GB,RO,2019.0,90,76,14
DK,FI,2022.0,17,14,3
PK,MA,2020.0,27,17,10
LY,US,2011.0,3,1,2
US,PH,2001.0,178,196,-18
CH,SG,2021.0,13,13,0
BG,RU,2019.0,50,35,15
FR,SK,2012.0,8,9,-1
DE,nan,2010.0,76,62,14
CN,RO,2010.0,4,4,0
NL,nan,2002.0,40,27,13
CZ,CN,2013.0,30,38,-8
NL,DK,2011.0,27,28,-1
CN,PK,2007.0,30,76,-46
CN,VN,2012.0,35,37,-2
BW,ZA,2017.0,13,17,-4
AU,ES,2008.0,28,31,-3
ZA,BE,2018.0,20,22,-2
NZ,CN,2012.0,35,24,11
GB,GR,2012.0,188,212,-24
JP,TH,2021.0,80,46,34
BR,UY,2006.0,25,30,-5
SE,NO,1998.0,27,35,-8
UZ,RU,2018.0,36,31,5
FR,MX,2008.0,41,34,7
KZ,TR,2007.0,24,28,-4
GB,IL,2003.0,28,42,-14
GR,CH,2018.0,36,36,0
JO,GB,2005.0,8,9,-1
ZW,ZA,2017.0,46,29,17
JP,RU,2001.0,30,41,-11
HU,NL,2006.0,16,9,7
CA,IS,2014.0,2,2,0
IT,DK,2021.0,44,25,19
PE,MX,2011.0,42,70,-28
MX,BR,2015.0,139,125,14
PA,MX,2017.0,5,18,-13
nan,MA,2018.0,15,5,10
FR,DK,2015.0,40,44,-4
EG,LY,2016.0,6,8,-2
BR,CH,2009.0,38,42,-4
ID,KR,2015.0,14,24,-10
IN,PK,2012.0,148,141,7
MM,IQ,2019.0,3,1,2
JP,SG,2012.0,50,31,19
JP,BR,2004.0,35,33,2
DK,CA,2008.0,22,25,-3
MY,BR,2015.0,64,36,28
KR,PR,2022.0,11,14,-3
FR,BR,2006.0,121,102,19
IR,TR,2013.0,32,20,12
IN,JP,2023.0,7,4,3
PT,US,1998.0,34,37,-3
TN,IN,2018.0,9,5,4
PT,CN,2001.0,11,2,9
US,IR,2011.0,228,341,-113
EG,ID,2016.0,21,6,15
PL,nan,2015.0,7,15,-8
MY,PK,2013.0,32,70,-38
RU,BY,2010.0,54,50,4
NZ,NP,2006.0,12,7,5
CA,PK,2022.0,28,36,-8
ES,CR,2013.0,50,43,7
MY,SA,2020.0,84,46,38
IN,FI,2014.0,16,12,4
NO,HU,2011.0,1,3,-2
US,DK,1999.0,122,134,-12
nan,FR,2016.0,238,191,47
CH,TN,2020.0,15,8,7
RS,CA,2018.0,16,9,7
PL,US,2014.0,206,281,-75
PT,US,1997.0,29,43,-14
US,CR,2018.0,44,44,0
DK,PL,2021.0,10,5,5
BE,DK,2021.0,62,54,8
UZ,PL,1997.0,4,4,0
JP,EG,2015.0,63,40,23
CO,IT,2017.0,19,32,-13
RU,NL,2019.0,45,61,-16
CY,NG,2021.0,6,5,1
GB,ZA,2006.0,105,96,9
RU,NL,2010.0,23,37,-14
JO,FR,2016.0,2,3,-1
SL,US,2018.0,3,1,2
CU,ES,2005.0,59,53,6
AR,GB,1998.0,13,13,0
CL,GB,2019.0,59,60,-1
CA,HU,2018.0,11,9,2
BE,GR,2015.0,17,30,-13
ID,EG,2009.0,3,2,1
IT,IE,2004.0,11,8,3
AT,HU,2009.0,24,17,7
BR,PL,2019.0,28,17,11
LB,IQ,2016.0,8,6,2
SA,LB,2009.0,2,5,-3
AU,PG,2016.0,7,7,0
GB,QA,2013.0,31,6,25
DE,ET,2014.0,8,8,0
CA,SI,2013.0,3,1,2
TR,GB,2013.0,84,128,-44
RU,NL,2017.0,51,46,5
CN,KR,2002.0,114,137,-23
NL,KE,2016.0,10,7,3
DE,nan,2017.0,69,82,-13
SA,EG,2005.0,44,48,-4
FR,LB,2011.0,67,25,42
CN,ID,2013.0,29,44,-15
TR,SA,2001.0,1,1,0
BR,LB,2018.0,7,8,-1
GB,HU,2014.0,39,48,-9
BR,MY,2015.0,36,64,-28
RO,NL,2019.0,9,18,-9
CU,US,2009.0,31,21,10
BR,GB,2004.0,97,104,-7
MA,NG,2016.0,3,1,2
GB,MD,2017.0,2,3,-1
RO,CA,2016.0,14,22,-8
KE,US,2015.0,93,82,11
SA,BD,2019.0,31,35,-4
FR,CM,2020.0,25,13,12
ES,UY,2018.0,84,46,38
BE,AT,2005.0,8,8,0
TN,LB,2018.0,3,2,1
CL,CA,2014.0,26,31,-5
CO,CL,2013.0,160,210,-50
BR,DE,2009.0,140,127,13
US,MA,2018.0,29,19,10
ZA,ZW,2019.0,56,50,6
JP,AU,2013.0,85,73,12
SG,IN,2007.0,47,38,9
HU,IL,2009.0,5,5,0
PT,RU,2016.0,11,2,9
IN,RO,2009.0,26,47,-21
BR,AO,2001.0,7,3,4
IT,CL,2020.0,32,24,8
IN,NG,2007.0,2,1,1
NO,IT,2015.0,20,30,-10
CA,IL,2012.0,60,61,-1
EC,US,2012.0,14,28,-14
IT,CA,2017.0,218,119,99
IT,HR,2019.0,12,3,9
UA,EC,2016.0,23,57,-34
CO,IT,2019.0,36,16,20
MX,BO,2013.0,7,6,1
IE,ES,2020.0,32,47,-15
DE,nan,2019.0,66,100,-34
CL,nan,2015.0,12,6,6
CN,NL,2017.0,129,135,-6
AU,IN,2013.0,122,161,-39
LU,DE,2021.0,35,31,4
CA,HR,2017.0,8,8,0
TR,ES,2016.0,10,13,-3
UA,PL,2017.0,48,53,-5
US,SE,2009.0,358,326,32
US,SN,2004.0,9,6,3
SE,BO,2018.0,1,3,-2
SE,NL,2018.0,82,82,0
ZA,ET,2014.0,4,7,-3
NL,SI,2022.0,2,5,-3
RU,NZ,2016.0,3,12,-9
SA,IN,2011.0,25,65,-40
CN,NL,2019.0,153,172,-19
HR,RS,2011.0,126,84,42
ES,PA,2016.0,23,17,6
IE,AE,2020.0,6,3,3
FI,EE,2020.0,24,17,7
TZ,UG,2019.0,8,4,4
GB,CY,2015.0,40,36,4
CN,IR,2018.0,40,77,-37
EC,IT,2017.0,4,9,-5
NG,PK,2022.0,7,7,0
KR,DE,2019.0,63,57,6
DE,PT,1998.0,6,4,2
FI,IR,2022.0,4,35,-31
PK,CH,2013.0,15,10,5
PT,IR,2016.0,13,13,0
SA,FR,2018.0,20,47,-27
US,QA,2021.0,59,76,-17
DZ,MA,2022.0,18,11,7
NG,ID,2021.0,18,16,2
VN,CA,2017.0,13,19,-6
TT,IN,2021.0,4,4,0
GB,FI,2003.0,30,31,-1
PL,FR,2016.0,31,43,-12
IN,QA,2014.0,14,7,7
MX,ID,2020.0,3,3,0
FR,RU,2012.0,68,68,0
TR,IT,2021.0,27,14,13
EG,MA,2019.0,15,7,8
ID,BR,2014.0,8,13,-5
nan,AT,2006.0,12,7,5
FR,JP,2003.0,66,90,-24
DE,CL,2006.0,37,16,21
CN,LK,2013.0,7,3,4
BH,GH,2012.0,3,4,-1
CO,NL,2023.0,2,1,1
ES,SV,2008.0,1,4,-3
CN,CL,2013.0,4,2,2
TN,MY,2010.0,3,1,2
FR,GF,2008.0,9,4,5
US,KE,2014.0,75,63,12
PE,CR,2019.0,16,19,-3
AR,PT,2020.0,19,19,0
IT,SI,2018.0,19,12,7
HU,JP,2014.0,13,6,7
DE,MY,2021.0,8,13,-5
CN,FR,2023.0,11,9,2
BN,GB,2008.0,2,4,-2
GP,FR,2021.0,20,19,1
PH,TW,2018.0,7,6,1
CN,KP,2018.0,8,1,7
UA,PL,2019.0,51,72,-21
IT,FI,2013.0,23,17,6
CN,IT,2016.0,39,48,-9
CA,GB,2021.0,678,695,-17
CN,AU,2021.0,431,552,-121
AU,BR,2004.0,33,24,9
ET,IN,2022.0,20,27,-7
US,TH,2015.0,247,124,123
ES,ZA,2013.0,12,8,4
DE,AU,2013.0,238,225,13
RO,DE,2014.0,43,43,0
ES,RU,2018.0,25,21,4
JM,US,2012.0,20,19,1
NZ,JP,2013.0,11,8,3
SA,IQ,2017.0,35,14,21
BE,ES,2014.0,73,91,-18
GW,DK,2019.0,4,3,1
KZ,RU,2015.0,32,56,-24
US,LK,2007.0,9,19,-10
DK,IS,2010.0,9,4,5
XK,HR,2019.0,4,4,0
AE,GB,2008.0,15,22,-7
RW,SE,2021.0,8,3,5
CA,SN,2019.0,9,3,6
HU,CL,2012.0,2,1,1
SA,BD,2017.0,22,22,0
BH,ET,2018.0,14,28,-14
IN,IT,2016.0,59,59,0
RU,BY,2019.0,86,146,-60
ID,JP,2013.0,65,160,-95
IT,FR,2004.0,206,194,12
JP,MX,2022.0,6,4,2
IE,DE,2009.0,61,85,-24
JP,CL,2010.0,8,3,5
BA,DE,2017.0,6,5,1
SN,FR,2000.0,17,12,5
MY,ID,2007.0,23,11,12
JP,MW,2019.0,3,1,2
RS,SK,2002.0,3,6,-3
NL,RU,2007.0,27,34,-7
CA,RS,2004.0,14,4,10
DZ,US,2008.0,5,8,-3
BG,NL,2008.0,2,2,0
SE,ZA,2013.0,8,17,-9
CU,CL,2003.0,11,7,4
JP,UA,2006.0,5,2,3
DE,VN,2020.0,33,16,17
DE,PL,2004.0,87,74,13
DK,GB,2013.0,105,115,-10
NL,BE,2014.0,303,282,21
IN,CH,2014.0,53,45,8
CH,UY,2015.0,1,1,0
NO,DE,2012.0,54,79,-25
BZ,FR,2005.0,7,8,-1
DE,CZ,2018.0,82,84,-2
CA,KW,2012.0,11,6,5
ML,US,2014.0,7,4,3
PL,SE,2003.0,12,13,-1
DE,IL,2000.0,37,34,3
SI,DE,2011.0,12,14,-2
IT,LU,2014.0,8,3,5
BE,EG,2003.0,4,3,1
AR,IT,2018.0,104,113,-9
NL,ZW,2003.0,2,2,0
IN,BG,2016.0,2,2,0
SI,ES,2021.0,12,10,2
CA,MA,2020.0,22,19,3
GR,IT,2000.0,6,10,-4
DK,IT,2003.0,16,12,4
CA,GR,1999.0,10,7,3
RU,IT,2018.0,55,71,-16
RU,BY,2017.0,69,121,-52
HN,AR,2019.0,7,1,6
IT,HR,2017.0,17,7,10
CA,AR,2014.0,20,18,2
LK,AU,2008.0,8,4,4
AR,FI,2021.0,3,3,0
IT,NO,2021.0,26,22,4
PT,CO,2020.0,19,24,-5
PL,HU,2017.0,36,26,10
SN,US,1998.0,7,3,4
EG,VN,2020.0,7,4,3
DE,SK,2007.0,35,29,6
TR,nan,2015.0,18,17,1
PK,IQ,2022.0,20,22,-2
nan,IR,2006.0,12,1,11
IR,GR,2020.0,4,3,1
MM,JP,2022.0,9,1,8
ET,DE,2017.0,17,10,7
BG,US,2013.0,24,35,-11
NZ,CH,2004.0,6,3,3
US,IS,2014.0,10,18,-8
GB,FJ,2015.0,3,1,2
CN,ES,2013.0,71,57,14
SI,SE,2020.0,3,6,-3
SE,PH,2017.0,3,2,1
GR,JP,2000.0,37,37,0
US,SK,2006.0,31,30,1
JO,PS,2022.0,2,3,-1
ZA,SA,2010.0,9,2,7
EC,ES,2007.0,12,14,-2
DE,UG,2019.0,4,7,-3
GH,CH,2007.0,1,1,0
IQ,JP,2017.0,6,3,3
US,MW,2019.0,22,24,-2
RS,AT,2005.0,3,3,0
IT,PT,2020.0,43,49,-6
ZA,GB,2006.0,96,105,-9
PL,AT,2005.0,10,11,-1
BE,DE,2006.0,58,108,-50
AT,PL,2021.0,15,13,2
CL,AR,2012.0,81,88,-7
UA,NL,2006.0,5,2,3
CL,ZA,2021.0,3,2,1
DE,TW,1998.0,13,13,0
TH,FR,2008.0,6,13,-7
BD,ES,2002.0,3,4,-1
AT,UZ,2020.0,1,1,0
NO,NL,2005.0,15,27,-12
GB,UA,2002.0,5,13,-8
PL,CH,2001.0,6,12,-6
US,MW,2017.0,14,18,-4
FR,BD,2016.0,5,5,0
RU,CH,2003.0,23,14,9
TN,RU,2018.0,5,2,3
TR,KZ,2009.0,38,20,18
ZW,US,2021.0,7,10,-3
PH,BE,2019.0,5,2,3
FI,PL,2011.0,9,6,3
PK,GB,2007.0,38,60,-22
GB,SK,2005.0,16,23,-7
CG,FR,2015.0,18,20,-2
OM,SA,2016.0,12,7,5
FR,CN,1998.0,55,36,19
FI,SG,2021.0,5,4,1
CZ,ES,2013.0,12,17,-5
MA,IT,2012.0,14,19,-5
UG,ZA,2012.0,8,6,2
LI,AT,2022.0,2,4,-2
BA,RS,2022.0,22,25,-3
MA,CA,2021.0,12,18,-6
ID,SG,2018.0,15,40,-25
IS,US,2015.0,14,26,-12
BE,MA,2013.0,6,2,4
GB,IR,2015.0,84,114,-30
CH,DZ,2021.0,1,1,0
TW,FR,2012.0,17,22,-5
FR,TW,2016.0,16,21,-5
IL,AT,2021.0,9,5,4
PE,CR,2017.0,10,16,-6
VN,TW,2011.0,11,9,2
CA,TH,2004.0,6,11,-5
GB,LT,2019.0,7,8,-1
MZ,ZA,2020.0,4,4,0
CA,SN,2017.0,7,8,-1
KR,nan,2016.0,38,23,15
HR,US,2019.0,41,56,-15
PA,ES,2019.0,16,24,-8
CU,PY,2020.0,6,7,-1
SY,US,2019.0,9,8,1
BE,SN,2015.0,3,3,0
SE,UA,2020.0,7,7,0
GR,CA,2021.0,11,12,-1
UA,SA,2020.0,3,3,0
BH,IN,2018.0,2,8,-6
EC,RU,2015.0,6,2,4
IN,HU,2022.0,4,4,0
PE,CR,2010.0,3,3,0
CZ,TR,2018.0,5,18,-13
HR,US,2010.0,40,44,-4
US,CM,2006.0,4,9,-5
IT,VN,2020.0,7,2,5
DK,NL,2001.0,21,12,9
BW,US,2018.0,11,8,3
CN,MD,2019.0,2,4,-2
CL,AU,2014.0,17,14,3
KR,DE,2017.0,65,52,13
IT,AZ,2013.0,4,6,-2
GB,NI,2016.0,2,3,-1
MW,CN,2017.0,1,2,-1
QA,US,2017.0,81,84,-3
FI,DE,1997.0,17,17,0
SE,JP,2013.0,31,35,-4
CZ,CH,2018.0,31,35,-4
AT,SK,2015.0,17,18,-1
GB,LT,2010.0,4,6,-2
ZA,BW,2013.0,6,14,-8
EG,PS,2021.0,13,6,7
PL,AT,2002.0,8,7,1
NP,ID,2019.0,7,1,6
IR,SE,2014.0,50,38,12
BY,DE,2005.0,7,5,2
FR,NC,2013.0,15,13,2
AM,US,2007.0,10,3,7
PS,IL,2022.0,4,5,-1
SG,DK,2020.0,7,4,3
CH,ES,2007.0,65,37,28
RU,LV,2021.0,13,19,-6
CA,SA,2006.0,27,18,9
ZA,CH,1999.0,4,6,-2
RU,AT,2007.0,7,12,-5
CA,CY,2011.0,4,1,3
FR,DZ,2000.0,22,7,15
US,KW,2015.0,28,20,8
ES,ET,2015.0,2,1,1
ID,CZ,2015.0,5,9,-4
MA,PK,2009.0,7,11,-4
GB,RO,2010.0,20,24,-4
AU,TH,2006.0,25,18,7
BG,IE,2017.0,1,1,0
RU,BG,2013.0,32,24,8
PT,TR,2015.0,3,3,0
PT,RS,2015.0,2,1,1
NO,MY,2005.0,1,1,0
NL,BR,2004.0,24,16,8
BO,CL,2018.0,11,4,7
NG,GB,2007.0,15,24,-9
LK,ET,2011.0,2,2,0
JP,PL,2003.0,17,12,5
CA,MY,2009.0,18,7,11
JP,SK,1999.0,10,7,3
ET,CA,2015.0,3,3,0
DZ,IT,2007.0,9,4,5
GB,RO,2017.0,65,77,-12
BE,LU,2003.0,10,1,9
CZ,RU,2013.0,37,41,-4
PK,SG,2002.0,2,1,1
MY,SG,2007.0,32,47,-15
LK,NL,2014.0,1,1,0
BR,FI,2017.0,10,8,2
PS,US,2004.0,3,1,2
TN,MY,2017.0,4,4,0
IN,ZA,2008.0,34,25,9
BY,DE,2002.0,22,4,18
CH,PK,2006.0,10,12,-2
AU,EG,2016.0,20,15,5
DK,TR,2006.0,1,3,-2
IT,AO,2011.0,2,1,1
CH,AU,2012.0,67,65,2
NZ,IR,2006.0,1,4,-3
IT,RU,1998.0,25,22,3
MY,NL,2011.0,6,14,-8
CL,RU,2004.0,9,7,2
KE,FR,2016.0,4,19,-15
MX,nan,2020.0,33,32,1
UA,CN,2006.0,18,10,8
ZA,LK,2011.0,1,2,-1
IL,EG,2015.0,8,6,2
CA,IR,2009.0,74,118,-44
SA,EG,2002.0,25,19,6
PR,ET,2021.0,6,3,3
NZ,FR,2009.0,11,13,-2
FR,KH,2011.0,5,4,1
KR,AT,2011.0,3,5,-2
SG,AU,2000.0,27,36,-9
TT,JM,1998.0,1,1,0
VN,FI,2016.0,1,2,-1
SE,NO,1997.0,23,32,-9
SV,MX,2011.0,3,1,2
PA,MX,2019.0,6,18,-12
DK,CH,2012.0,30,28,2
EG,AU,2020.0,35,23,12
PT,NO,2016.0,9,3,6
CA,HR,2010.0,3,3,0
FI,RU,2003.0,10,22,-12
FR,CN,1997.0,28,28,0
ID,CO,2016.0,6,3,3
SY,US,2010.0,4,4,0
AU,LB,2019.0,5,3,2
PE,CO,2008.0,19,18,1
NI,US,2014.0,7,4,3
OM,NG,2019.0,2,1,1
NG,CA,2013.0,8,10,-2
DE,VE,2014.0,3,5,-2
BR,ZA,2009.0,14,5,9
NG,NO,2009.0,2,1,1
BD,KR,2016.0,36,28,8
BN,MY,2021.0,12,14,-2
VE,IT,2012.0,10,4,6
BE,ZA,2011.0,18,16,2
SK,SG,2000.0,2,1,1
ES,HN,2012.0,4,6,-2
SA,PK,2023.0,13,13,0
ES,EC,2011.0,23,22,1
SK,AT,1997.0,1,5,-4
PL,MY,2019.0,1,3,-2
IL,DE,1999.0,25,29,-4
BE,BR,2006.0,41,35,6
NL,ID,2011.0,17,16,1
nan,MX,2003.0,10,8,2
BG,CN,2008.0,9,10,-1
US,MN,2014.0,10,1,9
CO,IT,2010.0,7,6,1
ET,MY,2018.0,2,4,-2
CN,LU,2021.0,2,1,1
SA,KR,2018.0,12,22,-10
LU,JP,2016.0,5,2,3
JO,PK,2017.0,3,3,0
AO,ES,2015.0,2,2,0
EG,CA,1997.0,4,5,-1
RE,ZA,2013.0,2,1,1
TW,AR,2018.0,8,7,1
CA,SK,2016.0,4,6,-2
AT,nan,2015.0,13,10,3
TZ,UG,2017.0,3,4,-1
nan,IN,2002.0,7,4,3
BE,FI,2020.0,13,10,3
PE,PT,2016.0,9,6,3
IN,CZ,2020.0,27,21,6
SG,KZ,2019.0,3,1,2
MA,PT,2020.0,28,21,7
PH,GB,2007.0,8,6,2
HU,IN,2004.0,5,3,2
DE,PY,2016.0,1,1,0
NO,nan,2020.0,23,32,-9
SE,AU,2008.0,46,37,9
FR,BZ,2007.0,9,1,8
SA,RU,2019.0,5,5,0
FR,TH,2012.0,22,12,10
SE,EE,2021.0,10,8,2
ZA,SA,2017.0,6,3,3
CH,EG,2017.0,6,3,3
BE,RU,2001.0,7,20,-13
CG,SN,2014.0,4,1,3
AT,TW,2015.0,2,2,0
ET,DE,2010.0,4,4,0
PE,AR,2005.0,12,5,7
PH,IN,2007.0,8,10,-2
US,OM,2013.0,12,5,7
AM,FR,2019.0,3,7,-4
CH,SI,2011.0,2,5,-3
CL,CN,2000.0,1,1,0
VG,US,2008.0,7,19,-12
SI,US,2006.0,17,16,1
BR,SA,2018.0,4,3,1
FI,SK,2007.0,2,16,-14
JM,GB,2022.0,4,2,2
PH,TR,2007.0,3,1,2
RO,BE,2018.0,10,16,-6
ES,SE,2009.0,45,35,10
CH,HU,2006.0,9,12,-3
CN,CO,2001.0,2,2,0
EG,PK,2012.0,9,5,4
NZ,TW,2006.0,9,1,8
HR,US,2017.0,51,42,9
US,BW,2016.0,10,9,1
CH,JO,2021.0,2,1,1
HU,PT,2014.0,2,5,-3
PL,CN,2015.0,25,26,-1
DK,NZ,2005.0,4,4,0
NO,SE,2000.0,29,35,-6
KR,DE,2010.0,37,35,2
NL,CZ,2006.0,7,4,3
EE,NO,2021.0,4,3,1
MY,TW,2014.0,14,27,-13
JP,PH,2014.0,31,16,15
RO,NL,2010.0,7,7,0
CZ,FI,2005.0,5,3,2
CA,DK,2012.0,29,34,-5
BD,ES,2005.0,9,4,5
SE,HU,2002.0,9,9,0
AU,PA,2001.0,3,1,2
VE,PY,2002.0,1,1,0
CZ,SI,2007.0,6,10,-4
IS,NO,2011.0,11,5,6
ZA,ZW,2010.0,7,23,-16
CN,BG,2009.0,11,16,-5
NO,NL,2002.0,9,13,-4
IS,GB,2009.0,5,10,-5
TR,SG,2012.0,4,4,0
LU,NL,2011.0,3,3,0
ZA,JP,2009.0,2,7,-5
LK,GR,2000.0,3,1,2
US,UA,2003.0,21,29,-8
BN,AU,2017.0,2,1,1
GR,BE,2018.0,33,23,10
BW,ZA,2010.0,8,4,4
GB,SK,2002.0,12,25,-13
UA,nan,2000.0,9,9,0
HU,GB,1998.0,18,21,-3
US,MG,2020.0,4,10,-6
ET,SE,2003.0,3,1,2
US,LV,2013.0,3,7,-4
IT,RU,1997.0,19,18,1
JP,NG,1998.0,2,1,1
GB,AE,2006.0,15,8,7
PT,TN,2019.0,4,1,3
MG,US,2012.0,1,4,-3
BD,DK,2011.0,2,1,1
CA,PH,2022.0,7,8,-1
BI,FR,1997.0,9,5,4
ZA,SE,2003.0,8,3,5
AU,VN,2006.0,6,1,5
IN,IQ,2018.0,16,4,12
BA,US,2014.0,4,8,-4
UA,LT,2015.0,2,1,1
IN,FJ,2019.0,5,10,-5
ES,MA,2020.0,21,7,14
UZ,PL,1998.0,9,4,5
GB,UG,1999.0,3,1,2
TZ,NG,2019.0,6,3,3
PH,NZ,2013.0,3,3,0
IT,HR,2010.0,9,3,6
NO,CH,2021.0,17,31,-14
DE,AR,2001.0,9,19,-10
BH,IQ,2017.0,6,1,5
AT,BE,2008.0,9,11,-2
CA,UA,2008.0,6,4,2
NL,SG,2005.0,7,5,2
ID,CA,2009.0,5,10,-5
SD,GB,2012.0,2,8,-6
EG,MA,2017.0,7,13,-6
PT,JP,2006.0,4,5,-1
TW,SI,2012.0,2,1,1
CO,BO,2014.0,10,7,3
TN,MA,1999.0,2,1,1
MX,UY,2020.0,14,20,-6
LK,CH,2014.0,2,2,0
EG,IT,2014.0,6,9,-3
NL,MA,2011.0,2,2,0
ES,DK,2011.0,21,23,-2
CU,AR,2013.0,18,14,4
TN,EG,2016.0,13,9,4
DK,IS,2019.0,11,11,0
GB,PE,2015.0,9,11,-2
ET,DE,2019.0,10,14,-4
RU,AU,2003.0,14,8,6
DO,CL,2015.0,3,1,2
KR,MY,2008.0,10,8,2
RS,BE,2009.0,3,3,0
EG,SD,2012.0,7,18,-11
IN,MX,2020.0,12,9,3
CN,RO,2017.0,7,8,-1
NL,SG,2002.0,4,2,2
IT,ZA,2012.0,15,8,7
CH,KR,2019.0,17,29,-12
FR,FI,2021.0,21,15,6
KE,CA,2006.0,3,2,1
JP,BG,2005.0,3,7,-4
DE,TW,1997.0,5,10,-5
JP,HK,2007.0,6,3,3
ES,JO,2005.0,2,2,0
HR,AU,2005.0,2,3,-1
CA,PE,2022.0,4,1,3
BJ,DE,2010.0,2,1,1
AR,GB,1997.0,8,5,3
SE,VN,2012.0,2,2,0
ZW,NL,2015.0,1,1,0
HR,EC,2020.0,1,1,0
KE,IN,2021.0,6,10,-4
PK,DK,2013.0,4,1,3
FR,GA,2011.0,5,4,1
SN,CM,2017.0,3,3,0
PH,IE,2001.0,1,2,-1
UA,PL,2010.0,14,13,1
AU,ZA,2008.0,27,52,-25
SE,VE,2004.0,1,4,-3
CA,NP,2009.0,1,2,-1
PA,MX,2010.0,3,8,-5
GR,TR,2020.0,7,9,-2
nan,CO,2009.0,4,6,-2
SI,BA,2013.0,5,4,1
ET,SY,2020.0,2,2,0
SI,MX,2018.0,6,9,-3
DE,MK,2014.0,4,5,-1
SG,MY,2023.0,3,2,1
IR,CH,2022.0,19,9,10
HK,CA,2015.0,3,5,-2
PK,UG,2018.0,1,3,-2
JP,NG,1997.0,2,2,0
SG,FR,2007.0,6,12,-6
CD,KE,2016.0,2,1,1
IN,PT,2014.0,15,21,-6
PL,HU,2010.0,8,13,-5
PL,BY,2014.0,5,5,0
ZA,HR,2010.0,1,1,0
DK,PT,2020.0,11,13,-2
VG,FR,2012.0,5,2,3
PS,KW,2014.0,2,1,1
SE,MX,2020.0,8,10,-2
PA,ES,2017.0,9,25,-16
AU,UY,2019.0,2,2,0
SK,NL,2020.0,7,1,6
FR,NG,2016.0,7,9,-2
JO,EG,2022.0,13,18,-5
XK,AT,2017.0,5,4,1
AU,KH,2018.0,3,2,1
PH,BE,2017.0,3,1,2
CA,AT,2004.0,22,17,5
VN,IQ,2022.0,1,1,0
TH,NL,2009.0,4,6,-2
QA,PK,2015.0,6,13,-7
CA,PS,2020.0,2,1,1
CO,nan,2011.0,7,5,2
SE,RS,2007.0,2,3,-1
MX,IT,1999.0,5,7,-2
HU,FR,2016.0,17,17,0
AM,FR,2010.0,3,8,-5
RU,ID,2013.0,3,1,2
LB,DE,2011.0,5,2,3
CH,VE,2021.0,2,1,1
PT,CA,2002.0,6,9,-3
CW,BE,2008.0,3,1,2
PT,DK,2011.0,2,2,0
LB,AE,2019.0,5,6,-1
RS,SE,2009.0,3,3,0
SG,NZ,2021.0,13,13,0
NG,BH,2006.0,4,3,1
CH,ZA,1999.0,6,4,2
OM,US,2006.0,8,8,0
LT,US,2021.0,11,8,3
CN,VG,2015.0,1,1,0
GR,LK,2021.0,2,2,0
CO,IL,2022.0,2,1,1
DE,CO,2018.0,30,30,0
BG,AT,2016.0,5,1,4
IE,IT,2004.0,8,11,-3
US,MW,2010.0,6,5,1
GN,BF,2022.0,1,2,-1
BE,AT,2002.0,6,3,3
PS,DE,2011.0,5,7,-2
AU,PL,2002.0,5,6,-1
TH,CO,2019.0,2,1,1
GB,KE,2013.0,30,31,-1
LB,CA,2007.0,13,5,8
HU,EG,2018.0,10,4,6
IN,CO,2022.0,6,2,4
GB,BG,2011.0,11,14,-3
MK,SA,2016.0,2,1,1
DE,LK,2006.0,3,1,2
PK,KZ,2022.0,2,1,1
MT,IT,2022.0,7,5,2
SE,GR,2000.0,2,3,-1
AM,CH,2010.0,3,1,2
BG,ES,2009.0,7,5,2
GE,RU,2022.0,3,1,2
UY,CR,2007.0,1,1,0
nan,NO,2000.0,15,9,6
BE,NO,2006.0,4,3,1
GR,MX,2011.0,4,7,-3
TZ,GB,2006.0,8,6,2
GB,SY,2003.0,2,2,0
SI,BE,2016.0,9,5,4
JP,AR,2005.0,6,2,4
KW,IR,2013.0,1,1,0
BH,IE,2020.0,2,3,-1
IE,HU,2016.0,2,2,0
NO,ET,2013.0,9,6,3
MX,JP,2011.0,7,6,1
FI,CA,2012.0,18,21,-3
BE,SG,2013.0,4,2,2
AT,IR,2009.0,4,5,-1
RU,IN,2010.0,12,13,-1
IR,ZA,2022.0,3,2,1
CN,AR,2015.0,3,2,1
CO,JP,2011.0,11,4,7
KW,GR,2009.0,5,2,3
CA,LK,2013.0,4,5,-1
AU,AE,2023.0,2,1,1
NO,BE,2005.0,2,6,-4
BD,MY,2023.0,5,5,0
VN,PH,2009.0,1,1,0
RW,BE,2015.0,1,1,0
SE,MY,2012.0,6,6,0
EG,KW,2004.0,10,10,0
AR,nan,2001.0,14,8,6
TR,BR,2003.0,4,9,-5
CH,EG,2010.0,2,2,0
MY,NZ,2000.0,1,1,0
RU,LT,2008.0,8,10,-2
IN,KW,1999.0,3,1,2
BA,SI,2006.0,3,2,1
VN,DK,2017.0,5,6,-1
PH,BE,2010.0,3,2,1
FR,SG,2008.0,14,8,6
UG,BE,2012.0,3,6,-3
UA,GB,2000.0,6,6,0
ML,SN,2018.0,4,6,-2
EC,PY,2022.0,1,1,0
CY,IQ,2019.0,2,1,1
HU,RU,1997.0,2,1,1
LV,US,2011.0,2,9,-7
MN,CN,2019.0,5,4,1
BH,IQ,2019.0,4,3,1
UY,PA,2016.0,1,1,0
CN,AT,2003.0,4,4,0
PK,JP,2000.0,2,6,-4
GH,AU,1997.0,1,1,0
JP,ZA,2020.0,5,5,0
SE,TZ,1998.0,2,2,0
AR,IN,2020.0,2,7,-5
PL,CL,2014.0,3,2,1
ZW,CH,2016.0,2,1,1
AF,MX,2022.0,2,1,1
RO,RU,2011.0,2,3,-1
NL,BO,2015.0,1,1,0
IQ,JP,2010.0,6,5,1
EC,IT,2019.0,7,15,-8
LB,AE,2017.0,5,5,0
ZA,SA,2019.0,10,6,4
NL,UA,2015.0,5,12,-7
MA,CL,2019.0,1,1,0
VN,CA,2010.0,4,7,-3
NG,IR,2022.0,3,2,1
ZA,PK,2022.0,1,3,-2
AU,PL,2005.0,7,8,-1
US,CY,2023.0,5,1,4
IT,EG,2015.0,5,10,-5
AU,LB,2017.0,8,5,3
SE,NZ,2009.0,5,7,-2
LT,SE,2017.0,4,6,-2
FR,VG,2009.0,2,2,0
BH,ZW,2017.0,4,2,2
NG,NL,2013.0,12,3,9
AE,HU,2008.0,1,1,0
KW,GB,2003.0,5,9,-4
SG,ES,2016.0,8,6,2
SE,BG,2012.0,5,8,-3
SD,SA,2004.0,4,2,2
CN,FI,2008.0,15,16,-1
RU,IN,2017.0,27,40,-13
GH,ZA,2012.0,7,7,0
AT,CR,2019.0,3,1,2
MY,IE,2016.0,8,8,0
FR,EE,2012.0,3,5,-2
ID,RU,2011.0,1,2,-1
NL,AR,2009.0,4,4,0
ET,KE,2014.0,5,1,4
BA,AT,2019.0,3,2,1
KR,TR,2021.0,9,2,7
DE,PT,1997.0,4,8,-4
IE,HR,2019.0,5,2,3
IN,ET,2011.0,10,4,6
LB,AE,2010.0,2,2,0
FI,AT,2005.0,8,5,3
BR,PL,2010.0,7,3,4
IT,PE,2004.0,3,1,2
AU,FJ,2018.0,7,12,-5
nan,VN,2009.0,2,1,1
BY,KZ,2017.0,3,2,1
NG,TH,2023.0,1,1,0
EG,BD,2012.0,4,6,-2
SN,CM,2010.0,1,1,0
RO,LU,2019.0,1,1,0
RS,HU,2012.0,7,9,-2
RU,GR,2022.0,4,3,1
VE,nan,2009.0,2,1,1
CL,VE,1998.0,1,3,-2
NL,CU,2015.0,1,1,0
RO,CO,2014.0,1,2,-1
GR,IE,2014.0,4,5,-1
SE,KE,2020.0,8,6,2
IE,HR,2010.0,7,7,0
DZ,DE,2013.0,1,6,-5
DE,RS,2004.0,15,18,-3
BG,CZ,2003.0,1,2,-1
nan,YE,2019.0,1,2,-1
GB,UA,2005.0,4,13,-9
XK,AT,2019.0,1,6,-5
NO,LU,2013.0,4,2,2
FR,MG,2006.0,4,5,-1
EG,AT,2011.0,3,5,-2
US,EE,2004.0,9,2,7
TR,CH,2011.0,12,11,1
UG,NO,2014.0,3,3,0
CY,GR,2011.0,17,51,-34
RO,CH,2007.0,3,7,-4
SD,JP,2020.0,2,1,1
PY,CU,2009.0,5,3,2
CZ,FI,2002.0,3,3,0
IT,NZ,2009.0,4,6,-2
ID,BH,2020.0,3,3,0
MA,BR,2014.0,2,1,1
CH,UG,2012.0,2,3,-1
SA,BH,2016.0,6,5,1
CO,CA,2007.0,11,6,5
BR,PY,2009.0,3,3,0
PL,SA,2016.0,3,2,1
PS,GB,2016.0,3,3,0
IE,RO,2016.0,4,5,-1
VN,CA,2019.0,4,29,-25
BH,US,2012.0,6,4,2
US,BM,2018.0,2,5,-3
NZ,DK,2003.0,1,2,-1
JP,HU,2007.0,6,9,-3
nan,RS,2005.0,2,1,1
IN,MU,2015.0,2,1,1
XK,DE,2017.0,2,2,0
CA,CL,2001.0,7,3,4
FR,UA,2006.0,9,12,-3
CH,EG,2019.0,8,8,0
EG,NL,2022.0,5,5,0
MM,GB,2013.0,2,1,1
GR,KR,2013.0,1,4,-3
NL,LK,2005.0,1,1,0
HK,GB,2009.0,2,5,-3
PL,BD,2020.0,5,4,1
EG,ES,2021.0,7,12,-5
LT,SE,2010.0,2,3,-1
LT,SE,2019.0,5,5,0
BW,ZA,2019.0,8,22,-14
PL,BH,2022.0,6,7,-1
AU,UY,2017.0,4,2,2
GB,RU,2023.0,8,6,2
PK,EG,2014.0,13,9,4
BE,KE,2001.0,1,2,-1
IR,CO,2022.0,3,3,0
NG,RO,2020.0,1,1,0
CA,SN,2010.0,2,2,0
CD,CM,2018.0,1,3,-2
AT,CR,2017.0,3,1,2
DO,US,2014.0,6,5,1
ZA,CL,2005.0,1,3,-2
SK,DK,2012.0,8,3,5
PH,NL,1998.0,1,2,-1
NL,EE,2003.0,3,1,2
GB,TT,2009.0,4,3,1
IS,NL,2011.0,2,1,1
MX,BG,2011.0,1,1,0
ET,NL,2011.0,3,1,2
GB,GH,2001.0,3,3,0
US,RW,2011.0,4,3,1
PL,DZ,2012.0,1,2,-1
EE,AU,2014.0,2,2,0
BI,FR,1998.0,7,7,0
CO,IE,2011.0,1,5,-4
HK,NL,2006.0,1,6,-5
DE,TN,2022.0,2,3,-1
CZ,PT,2021.0,1,2,-1
ES,LB,2022.0,1,2,-1
IR,nan,2006.0,1,12,-11
KR,LK,2017.0,4,2,2
BG,MX,2004.0,1,2,-1
QA,SA,2015.0,7,21,-14
PL,FI,2011.0,6,9,-3
IN,AE,2007.0,6,2,4
QA,PS,2015.0,2,2,0
BH,ZW,2019.0,8,6,2
TN,BD,2015.0,2,2,0
PT,TN,2017.0,2,1,1
BR,FI,2010.0,4,4,0
SA,IQ,2010.0,2,1,1
RS,HR,2023.0,6,1,5
PH,ID,2016.0,5,3,2
IQ,US,2007.0,2,5,-3
GA,NL,2016.0,3,5,-2
FR,PA,2012.0,3,1,2
UZ,BY,2021.0,1,6,-5
OM,BH,2015.0,2,1,1
RS,AU,2006.0,3,2,1
DK,BD,2011.0,1,2,-1
ML,FR,2022.0,7,7,0
BH,EG,2011.0,4,3,1
CO,CU,2007.0,14,16,-2
KR,LK,2019.0,7,7,0
AE,QA,2006.0,3,1,2
EC,CH,2019.0,2,7,-5
LT,FR,2016.0,3,4,-1
HU,CN,1999.0,1,2,-1
BO,GB,2018.0,1,3,-2
CM,US,1999.0,3,1,2
LB,ES,2019.0,3,2,1
NG,JM,2010.0,2,1,1
nan,KE,2022.0,3,3,0
CZ,IL,2006.0,2,3,-1
GB,LT,2017.0,8,9,-1
FR,LK,2004.0,1,1,0
CO,PA,2022.0,5,10,-5
PE,SV,2014.0,2,1,1
JO,GB,2002.0,2,8,-6
SA,BD,2010.0,5,2,3
HR,IN,2017.0,1,2,-1
SA,FI,2018.0,1,1,0
RO,NL,2017.0,6,11,-5
SG,TH,2020.0,7,9,-2
PH,CL,2011.0,2,2,0
NG,KR,2002.0,1,1,0
CH,AR,2006.0,4,9,-5
EG,NG,2011.0,1,1,0
OM,CA,2008.0,2,9,-7
RS,SK,2005.0,1,3,-2
LB,MY,2020.0,1,6,-5
AT,PT,2003.0,2,3,-1
QA,KR,2011.0,3,1,2
CZ,NO,2003.0,2,2,0
BJ,DE,2019.0,3,2,1
UA,IN,2011.0,4,10,-6
ET,MA,2022.0,2,1,1
DE,QA,2014.0,10,1,9
NZ,CL,2013.0,5,6,-1
VN,DK,2019.0,1,5,-4
KR,LK,2010.0,1,2,-1
PL,MY,2017.0,1,1,0
EC,PA,2021.0,6,1,5
US,BN,2015.0,3,2,1
NZ,IT,2011.0,3,8,-5
LK,EG,2018.0,2,2,0
ET,FR,2003.0,1,2,-1
MK,CA,2014.0,2,1,1
CH,PH,2016.0,1,5,-4
AE,UA,2020.0,2,2,0
nan,KR,2007.0,9,13,-4
KR,GR,2022.0,2,1,1
FR,ML,2005.0,6,4,2
MA,nan,2016.0,2,1,1
ET,JP,2013.0,1,2,-1
CH,LB,2014.0,1,2,-1
DE,IS,2022.0,2,2,0
SG,PK,2016.0,7,5,2
PE,EC,2013.0,8,6,2
GB,MD,2010.0,1,1,0
RU,ZW,2005.0,3,2,1
UA,CH,2011.0,4,3,1
NO,NP,2015.0,4,1,3
CH,PG,2011.0,1,1,0
SG,UA,2017.0,4,1,3
BZ,FR,2002.0,2,1,1
SI,FI,2014.0,2,1,1
KW,AE,2014.0,1,1,0
IN,FJ,2010.0,2,2,0
TW,SE,2014.0,2,4,-2
AU,LV,2010.0,1,1,0
ZA,SG,2015.0,3,2,1
PE,GB,2011.0,7,8,-1
BY,VN,2011.0,1,2,-1
KR,EG,2008.0,5,2,3
VN,DK,2010.0,3,2,1
JP,AR,2002.0,1,4,-3
LI,DE,2011.0,1,5,-4
BH,AE,2021.0,4,2,2
CM,CA,2022.0,2,1,1
TT,ZA,2021.0,1,1,0
IL,AR,2009.0,3,3,0
SG,TR,2012.0,4,4,0
GE,IN,2020.0,5,3,2
UG,CN,2020.0,1,5,-4
BE,NZ,2011.0,6,7,-1
MA,MD,2007.0,1,6,-5
GR,FI,1997.0,1,1,0
HR,IN,2019.0,2,2,0
NG,KR,2005.0,3,6,-3
GB,EE,2009.0,7,7,0
CH,IN,2023.0,1,5,-4
TR,NO,2022.0,5,8,-3
SE,HU,2005.0,5,6,-1
US,SY,2021.0,4,5,-1
IR,IN,2003.0,2,6,-4
PA,CL,2012.0,4,4,0
SG,UA,2019.0,1,2,-1
AM,FR,2017.0,4,1,3
BA,SE,2016.0,4,1,3
RU,KZ,1998.0,3,8,-5
KR,IT,2008.0,3,6,-3
JO,BR,2014.0,2,16,-14
RE,BR,2013.0,1,1,0
IR,TZ,2014.0,2,1,1
PK,SG,2005.0,1,3,-2
LB,AU,2005.0,1,3,-2
TR,PS,2010.0,3,1,2
RO,KR,2015.0,3,1,2
TW,IL,2013.0,1,2,-1
HU,CO,2017.0,1,1,0
NG,UZ,2020.0,3,1,2
DE,DZ,2008.0,3,3,0
CZ,DK,2005.0,1,4,-3
BN,SG,2017.0,3,2,1
BA,DE,2010.0,2,1,1
TZ,SE,2007.0,2,3,-1
GB,UY,2007.0,2,1,1
ID,CN,1997.0,2,1,1
HR,SE,2020.0,6,6,0
EG,PT,2018.0,1,4,-3
NZ,CO,2018.0,2,4,-2
KE,RO,2016.0,1,1,0
IL,NO,2002.0,3,1,2
TH,VN,2015.0,7,10,-3
DE,CM,2009.0,1,4,-3
IL,GR,2003.0,2,2,0
IE,nan,2005.0,1,1,0
SN,ML,2021.0,2,4,-2
IN,TZ,2013.0,1,2,-1
DO,VE,2021.0,1,1,0
nan,BD,2009.0,1,3,-2
AT,MX,2021.0,5,3,2
AF,US,2015.0,2,1,1
US,SS,2022.0,1,2,-1
PL,IN,2022.0,4,18,-14
CH,BF,2020.0,2,3,-1
NO,CZ,2014.0,3,9,-6
NG,IN,2001.0,3,3,0
CN,MG,2014.0,5,2,3
DE,PE,2000.0,2,1,1
KE,FI,2019.0,1,1,0
LY,LB,2013.0,1,1,0
LU,BR,2012.0,4,3,1
VN,CZ,2022.0,7,7,0
IN,nan,1997.0,3,4,-1
AE,EG,2023.0,4,6,-2
SI,IT,2004.0,3,8,-5
HR,CA,2001.0,1,2,-1
DE,KE,2000.0,3,3,0
KR,MN,2014.0,5,1,4
BD,EG,2022.0,5,5,0
IQ,IT,2022.0,1,2,-1
IN,FJ,2017.0,5,4,1
PA,VE,2009.0,1,1,0
DK,ID,2016.0,3,1,2
CA,AE,2000.0,3,2,1
IR,VN,2011.0,1,1,0
NO,TW,2018.0,4,1,3
VE,JP,2008.0,2,1,1
MM,CN,2022.0,3,2,1
CZ,SG,2005.0,1,1,0
CY,IR,2015.0,4,2,2
MD,RU,2015.0,3,2,1
TW,BD,2014.0,1,1,0
BR,CZ,2002.0,5,1,4
CA,EE,2007.0,2,1,1
ES,EE,2015.0,3,1,2
SJ,SE,2016.0,1,1,0
ID,BN,2021.0,6,3,3
CZ,CO,2012.0,1,5,-4
KR,BG,2009.0,1,3,-2
IN,LB,2014.0,2,2,0
nan,LU,2016.0,1,1,0
TZ,NO,2007.0,3,6,-3
FI,IL,2009.0,3,4,-1
IE,ZA,1999.0,1,3,-2
LT,DK,2006.0,3,2,1
BE,SE,1997.0,3,2,1
AT,KR,2000.0,1,2,-1
AE,KE,2018.0,1,1,0
HK,BE,2017.0,1,3,-2
AT,IL,2002.0,1,2,-1
NZ,SE,1999.0,2,3,-1
AU,LV,2019.0,1,1,0
SG,RO,2019.0,1,1,0
AT,PH,2009.0,3,1,2
TN,MD,2013.0,5,10,-5
GB,LB,2004.0,5,2,3
UY,PE,2021.0,5,2,3
TN,MY,2019.0,3,2,1
SE,PH,2019.0,2,1,1
PE,ES,2004.0,23,27,-4
CA,FR,2012.0,514,603,-89
US,TR,2016.0,486,442,44
BR,US,1999.0,250,309,-59
ES,RO,2020.0,25,19,6
ZA,US,1998.0,122,114,8
FR,MA,2012.0,298,245,53
PL,GB,2022.0,60,51,9
NZ,IE,2015.0,17,13,4
DK,DE,2020.0,166,211,-45
DE,CN,2002.0,168,131,37
AU,CN,2017.0,509,494,15
KR,US,1997.0,223,366,-143
FR,ES,2007.0,243,186,57
CN,SG,2010.0,373,362,11
CN,SG,2019.0,460,624,-164
HN,MX,1999.0,4,5,-1
DK,BR,2004.0,6,4,2
CO,CH,2022.0,6,1,5
FR,NL,2014.0,189,188,1
RU,IN,2019.0,32,43,-11
ZW,ZA,2019.0,50,56,-6
AU,HR,2005.0,3,2,1
BO,US,2015.0,9,8,1
KR,ID,2020.0,50,44,6
JP,BD,2021.0,68,32,36
NP,IN,2012.0,58,73,-15
SN,US,1997.0,1,2,-1
CO,SE,2005.0,5,2,3
NL,nan,2005.0,52,46,6
ZA,GH,2021.0,25,10,15
IL,FR,2018.0,40,33,7
CZ,PL,2020.0,78,97,-19
nan,IT,2015.0,187,122,65
CH,AT,2012.0,97,117,-20
AU,LB,2010.0,3,2,1
IT,SE,2018.0,126,77,49
SI,HR,2016.0,27,22,5
HR,SI,2022.0,14,16,-2
BR,FI,2019.0,21,11,10
NL,KR,2021.0,10,13,-3
JO,AE,2020.0,30,19,11
MK,AU,2021.0,35,24,11
GB,KW,2020.0,32,15,17
CA,BE,2015.0,74,75,-1
DE,SG,2000.0,10,4,6
AR,RU,2019.0,3,3,0
ID,AU,2021.0,53,52,1
GB,PL,2009.0,51,77,-26
US,RU,2012.0,398,377,21
ES,AU,2001.0,10,9,1
IL,KR,2011.0,4,6,-2
BN,AU,2019.0,4,4,0
JP,IL,2008.0,17,13,4
IT,MY,2003.0,39,36,3
US,PA,2015.0,70,54,16
IE,JP,2002.0,34,20,14
PL,BE,2006.0,10,16,-6
CA,TW,2021.0,34,24,10
DK,IS,2017.0,11,6,5
JP,CL,2019.0,13,6,7
DE,PA,2011.0,5,4,1
AU,nan,2021.0,20,22,-2
SE,AL,2019.0,3,2,1
TR,PS,2019.0,2,3,-1
CH,VN,2014.0,3,2,1
ZA,ZW,2017.0,29,46,-17
QA,IQ,2015.0,1,1,0
RU,SK,2014.0,18,14,4
GB,IT,1999.0,135,196,-61
GR,SE,2014.0,23,5,18
NO,AU,2007.0,12,14,-2
PL,IT,2014.0,23,28,-5
BE,TR,2008.0,8,9,-1
QA,US,2010.0,16,46,-30
RS,US,2006.0,30,40,-10
TH,CA,2015.0,14,27,-13
CN,RO,2019.0,13,4,9
SK,RS,2003.0,11,7,4
ZW,ZA,2010.0,23,7,16
VN,TH,2015.0,10,7,3
US,GH,1998.0,7,3,4
UY,IT,2003.0,2,3,-1
ES,AT,2006.0,8,12,-4
nan,NZ,1999.0,5,5,0
JP,ET,2004.0,3,2,1
CL,GB,2010.0,20,27,-7
CI,FR,2018.0,12,33,-21
IN,RU,2021.0,22,29,-7
IE,HR,2017.0,6,6,0
LV,UA,2018.0,2,3,-1
CN,RS,2006.0,10,9,1
UY,AR,2003.0,9,12,-3
AU,FI,2016.0,14,19,-5
NO,FI,2018.0,20,42,-22
CN,KE,2008.0,4,3,1
DE,IT,2023.0,15,11,4
US,RS,2011.0,50,41,9
NG,IT,2012.0,10,9,1
HU,GB,1997.0,20,9,11
IN,SA,2003.0,9,7,2
KR,UA,2004.0,2,2,0
RO,ID,2021.0,2,4,-2
SJ,NO,2022.0,5,2,3
GM,GB,2022.0,15,6,9
TW,SA,2018.0,13,4,9
AE,NZ,2000.0,1,2,-1
TN,GB,2020.0,9,4,5
NP,BW,2021.0,1,1,0
BE,CI,2021.0,2,1,1
AE,OM,2021.0,5,6,-1
LT,MZ,2007.0,6,2,4
RU,RS,2008.0,10,9,1
BG,RU,2010.0,15,22,-7
PA,ID,2013.0,1,2,-1
CZ,CA,2022.0,5,7,-2
IQ,OM,2022.0,5,2,3
TN,SE,2021.0,2,3,-1
DK,HU,1999.0,2,1,1
IL,nan,2008.0,15,20,-5
SK,HU,1998.0,5,2,3
CR,FR,2001.0,2,2,0
MX,VN,2018.0,6,13,-7
UA,ZA,2008.0,2,1,1
SK,AT,1998.0,5,2,3
SK,AU,2004.0,3,1,2
CZ,RS,2020.0,9,14,-5
AF,BR,2018.0,1,5,-4
GB,TN,2009.0,3,4,-1
TN,BE,2016.0,1,9,-8
VE,CL,2004.0,6,11,-5
PA,BR,2007.0,1,1,0
DK,SA,2014.0,3,1,2
IN,nan,1998.0,8,6,2
ET,CN,2000.0,2,1,1
RO,NZ,2020.0,1,1,0
RW,KE,2022.0,2,4,-2
JP,BG,2002.0,4,7,-3
CL,SE,2007.0,4,4,0
IS,ES,2011.0,4,4,0
CG,PK,2016.0,1,2,-1
NG,JM,2017.0,2,1,1
CM,DE,2022.0,3,2,1
ID,DE,2003.0,4,5,-1
LU,GB,2021.0,8,10,-2
nan,PE,2006.0,3,2,1
NZ,AT,2012.0,5,5,0
SK,QA,2017.0,1,1,0
SA,MY,2005.0,2,1,1
NZ,TH,2020.0,4,3,1
NI,CA,2014.0,2,2,0
ES,RS,2015.0,3,3,0
RU,EE,1998.0,2,1,1
BA,DE,2019.0,9,3,6
NC,BJ,2018.0,1,1,0
MA,QA,2022.0,2,4,-2
NL,MX,2003.0,5,4,1
BA,AT,2017.0,2,3,-1
CN,UY,2022.0,1,1,0
OM,LK,2018.0,1,1,0
LS,ZA,2014.0,2,2,0
MZ,BR,2002.0,1,1,0
IN,KH,2016.0,1,1,0
SA,MY,2002.0,1,1,0
DK,PH,2021.0,1,1,0
FI,KR,2006.0,2,5,-3
US,AZ,2021.0,5,5,0
KZ,US,2003.0,4,3,1
IE,SD,2019.0,3,1,2
IQ,IE,2017.0,2,3,-1
LY,JP,2007.0,2,1,1
JM,AU,2016.0,4,4,0
CG,GB,2022.0,1,1,0
US,MX,2010.0,321,292,29
CH,BE,2018.0,80,81,-1
IN,GB,2019.0,689,622,67
US,MX,2017.0,487,459,28
GB,NL,2015.0,314,401,-87
RU,CA,2004.0,35,15,20
TW,ID,2022.0,34,57,-23
IN,SI,2021.0,4,2,2
TZ,DE,2013.0,3,4,-1
AT,AU,2009.0,23,14,9
AT,AR,2016.0,6,3,3
HU,AT,2009.0,17,24,-7
PT,CA,2005.0,8,3,5
DE,TZ,2005.0,1,1,0
GR,AT,2008.0,6,3,3
GB,LS,2020.0,1,1,0
IT,PH,2001.0,2,2,0
KW,BH,2021.0,3,3,0
GB,,2023.0,73182,0,73182
,CZ,1994.0,2944,0,2944
JP,,2016.0,13630,0,13630
,IN,2012.0,29080,0,29080
,US,2000.0,66906,0,66906
US,,1999.0,20062,0,20062
,GB,2018.0,14044,0,14044
CH,,2021.0,6221,0,6221
,FI,2012.0,2047,0,2047
,ES,1999.0,10236,0,10236
,PT,2003.0,1179,0,1179
,CN,1999.0,23865,0,23865
,NL,2002.0,5170,0,5170
IT,,2025.0,11418,0,11418
,NO,1994.0,4172,0,4172
BD,FI,2011.0,3,0,3
,CH,1995.0,5068,0,5068
CZ,,2011.0,796,0,796
ES,,2025.0,7244,0,7244
LU,,2024.0,1129,0,1129
EG,,2023.0,16346,0,16346
,TR,2009.0,5988,0,5988
,MY,2013.0,4989,0,4989
NL,,2000.0,1510,0,1510
,BY,2007.0,305,0,305
,NL,2005.0,5570,0,5570
IR,,2015.0,3053,0,3053
,DE,2016.0,18461,0,18461
CO,,2011.0,344,0,344
,ET,2004.0,172,0,172
,EG,2004.0,1473,0,1473
,GR,2014.0,2324,0,2324
MA,AM,2018.0,2,0,2
,JO,1996.0,178,0,178
,MX,2007.0,4517,0,4517
NP,,2021.0,486,0,486
,KE,2009.0,489,0,489
,CU,1994.0,397,0,397
RO,,2022.0,3213,0,3213
RS,,2021.0,1254,0,1254
,AE,1995.0,120,0,120
PK,,2015.0,356,0,356
,EG,1996.0,1034,0,1034
SN,NC,2008.0,2,0,2
SA,PT,2005.0,1,0,1
UA,,2021.0,4216,0,4216
CR,,2013.0,100,0,100
,PE,2012.0,1312,0,1312
VN,,2015.0,113,0,113
,AM,2014.0,154,0,154
IQ,,2018.0,195,0,195
IE,SD,2017.0,2,0,2
VE,,2024.0,598,0,598
TZ,,2019.0,204,0,204
,ET,1996.0,130,0,130
CL,BO,2005.0,3,0,3
,IQ,2015.0,1104,0,1104
ET,,2023.0,2925,0,2925
FR,,1998.0,1405,0,1405
NL,PE,2008.0,1,0,1
CU,CZ,2014.0,1,0,1
,MA,2000.0,420,0,420
UZ,,2017.0,100,0,100
UZ,,2010.0,75,0,75
,SY,2000.0,38,0,38
CI,,2018.0,170,0,170
,HT,2011.0,6,0,6
,AZ,2003.0,96,0,96
,GA,2014.0,39,0,39
NO,,1998.0,191,0,191
TZ,,2010.0,58,0,58
,TN,2000.0,397,0,397
BG,,1999.0,122,0,122
PH,,2006.0,84,0,84
NZ,GR,2011.0,1,0,1
MN,,2023.0,367,0,367
NE,GN,2020.0,1,0,1
TH,,2005.0,172,0,172
ZA,LS,1999.0,1,0,1
UZ,,2019.0,101,0,101
ME,,2021.0,69,0,69
,MD,1998.0,65,0,65
AE,,2009.0,49,0,49
,MW,2015.0,136,0,136
,MM,2018.0,66,0,66
,QA,2018.0,462,0,462
,MG,2016.0,67,0,67
,EC,2006.0,154,0,154
LA,,2016.0,12,0,12
CH,PR,2007.0,1,0,1
TZ,,2017.0,153,0,153
,SN,2018.0,93,0,93
,LU,2016.0,121,0,121
SV,ES,2012.0,6,0,6
SK,,2005.0,118,0,118
,MD,1997.0,79,0,79
,MQ,2012.0,41,0,41
,KW,2003.0,116,0,116
MK,,2015.0,55,0,55
VN,IT,2003.0,3,0,3
YE,ID,2020.0,3,0,3
,LY,2010.0,41,0,41
,TG,2016.0,57,0,57
HU,SA,2021.0,3,0,3
RU,TZ,2019.0,1,0,1
LK,ID,2015.0,7,0,7
,LY,2019.0,38,0,38
,JO,2004.0,227,0,227
,BH,2014.0,93,0,93
,OM,2008.0,130,0,130
,BW,2015.0,108,0,108
TH,,2002.0,112,0,112
GN,,2021.0,25,0,25
BR,PE,2023.0,2,0,2
,BJ,2006.0,39,0,39
,CW,2009.0,12,0,12
ZA,DK,2001.0,5,0,5
,MN,1994.0,19,0,19
CY,,2016.0,100,0,100
,LA,2004.0,11,0,11
,GP,2007.0,28,0,28
SN,CM,2019.0,4,0,4
IL,PH,2020.0,2,0,2
KH,,2012.0,15,0,15
,MT,1996.0,22,0,22
MY,TD,2017.0,1,0,1
PH,BW,2017.0,1,0,1
SD,YE,2015.0,1,0,1
GB,JE,2014.0,2,0,2
SK,,2002.0,140,0,140
TR,SK,2017.0,1,0,1
,LY,2017.0,64,0,64
TW,NG,2003.0,1,0,1
AR,BO,2002.0,2,0,2
DE,ZW,2018.0,1,0,1
JO,,2009.0,47,0,47
BA,BD,2021.0,1,0,1
AE,JE,2018.0,1,0,1
ML,ZA,2015.0,2,0,2
CA,BW,2015.0,2,0,2
,SO,2011.0,4,0,4
NE,MD,2011.0,2,0,2
,AG,1995.0,1,0,1
EG,RS,2021.0,1,0,1
CA,HR,2019.0,4,0,4
,PS,1994.0,42,0,42
TN,,2026.0,8,0,8
YE,,2014.0,14,0,14
IR,OM,2017.0,5,0,5
FI,CO,2012.0,1,0,1
,TT,2003.0,41,0,41
NG,IE,2022.0,2,0,2
ES,TN,2022.0,2,0,2
CY,VG,2008.0,1,0,1
,MU,2001.0,8,0,8
UZ,FR,2000.0,1,0,1
MY,TD,2019.0,1,0,1
TN,KR,2003.0,1,0,1
JP,MW,2010.0,1,0,1
ES,GE,2018.0,2,0,2
PR,CA,2006.0,1,0,1
ID,AT,2004.0,1,0,1
CA,AL,2009.0,1,0,1
,NE,1996.0,11,0,11
,YE,1999.0,11,0,11
QA,JO,2006.0,2,0,2
AL,,2008.0,5,0,5
,CI,2001.0,39,0,39
TR,GH,2012.0,1,0,1
CZ,UG,2014.0,1,0,1
HU,IS,2013.0,1,0,1
FR,CU,2001.0,2,0,2
NE,CH,2011.0,1,0,1
PK,SE,2008.0,6,0,6
SE,AE,1999.0,1,0,1
TT,PH,2011.0,1,0,1
,NI,2007.0,13,0,13
NP,GM,2021.0,1,0,1
IL,MA,2006.0,1,0,1
IE,SE,2000.0,4,0,4
AU,TR,2001.0,3,0,3
LK,NZ,2005.0,1,0,1
PL,AE,2014.0,2,0,2
VE,GR,2010.0,1,0,1
nan,SC,2015.0,2,0,2
NG,BE,2011.0,2,0,2
ET,ZW,2013.0,1,0,1
LY,OM,2019.0,1,0,1
IT,KH,1997.0,1,0,1
,CF,1995.0,8,0,8
DZ,,2003.0,18,0,18
GE,BE,2016.0,3,0,3
KE,LK,2007.0,2,0,2
BE,LY,2005.0,2,0,2
,MT,2004.0,21,0,21
BH,,2008.0,11,0,11
GM,MW,2019.0,1,0,1
MD,,2009.0,26,0,26
,VA,2013.0,1,0,1
AO,ST,2022.0,1,0,1
TW,KZ,2018.0,2,0,2
SN,KR,2003.0,1,0,1
SG,IR,2003.0,3,0,3
AZ,ID,2022.0,2,0,2
SE,CD,2009.0,1,0,1
FR,HK,2005.0,1,0,1
RU,CI,2008.0,1,0,1
BY,PT,2003.0,5,0,5
SK,HU,1997.0,2,0,2
SL,,2009.0,2,0,2
IT,IQ,2015.0,2,0,2
nan,YE,2010.0,1,0,1
CZ,DK,2002.0,3,0,3
MN,PL,2001.0,1,0,1
UG,MY,2011.0,1,0,1
DZ,BI,2020.0,2,0,2
PK,BE,2000.0,1,0,1
RW,GH,2006.0,1,0,1
CI,AT,2010.0,1,0,1
ES,CZ,2001.0,3,0,3
FJ,NZ,2009.0,2,0,2
CN,MN,2020.0,5,0,5
SE,LU,2000.0,2,0,2
CR,VE,1998.0,2,0,2
NL,MZ,2009.0,1,0,1
DE,BJ,2014.0,2,0,2
AM,IL,2002.0,1,0,1
ET,CU,2013.0,1,0,1
GH,UA,2012.0,4,0,4
,NE,2004.0,13,0,13
JO,BH,2022.0,3,0,3
TW,UZ,2000.0,1,0,1
SI,SK,2005.0,1,0,1
CM,BF,2015.0,1,0,1
IR,EG,2002.0,1,0,1
KE,BF,2019.0,1,0,1
JM,nan,2014.0,1,0,1
NP,ES,2008.0,1,0,1
NG,PG,2009.0,1,0,1
SN,LU,2010.0,1,0,1
,VG,2014.0,11,0,11
IL,IE,2014.0,9,0,9
NL,CW,2022.0,3,0,3
IN,MM,2015.0,1,0,1
nan,IQ,2016.0,2,0,2
KN,CA,2020.0,3,0,3
BR,MD,2011.0,1,0,1
AL,IN,2014.0,2,0,2
SE,ZM,2022.0,1,0,1
VN,IL,2017.0,1,0,1
JP,KZ,2012.0,6,0,6
NZ,SA,2003.0,1,0,1
NI,CU,2006.0,1,0,1
BR,CY,2011.0,1,0,1
SO,ID,2020.0,2,0,2
,PG,2001.0,12,0,12
AO,,2012.0,4,0,4
NG,CZ,2006.0,1,0,1
LT,nan,2022.0,1,0,1
DJ,FR,1998.0,1,0,1
LV,IT,2005.0,3,0,3
BJ,UG,2012.0,1,0,1
TW,HR,2023.0,1,0,1
,GT,1996.0,8,0,8
PG,,2006.0,8,0,8
GR,NZ,1997.0,1,0,1
HU,RU,1998.0,3,0,3
ES,MK,2013.0,2,0,2
JM,BB,1999.0,3,0,3
ZW,BE,2009.0,3,0,3
PL,RO,2003.0,1,0,1
RO,BG,2003.0,1,0,1
PA,KE,2014.0,1,0,1
PS,,2007.0,8,0,8
FI,NZ,2004.0,2,0,2
AU,VE,1997.0,2,0,2
KP,,2019.0,9,0,9
GT,CO,2006.0,1,0,1
ES,PK,2024.0,1,0,1
HU,BR,2000.0,2,0,2
BR,GE,2014.0,1,0,1
JM,BN,2012.0,1,0,1
AM,GB,2014.0,1,0,1
MA,CL,2017.0,1,0,1
DK,NZ,2002.0,2,0,2
HN,EC,1998.0,2,0,2
,LI,2007.0,4,0,4
EE,PL,2018.0,2,0,2
,AF,2004.0,3,0,3
KH,KE,2020.0,1,0,1
ZA,EC,2015.0,1,0,1
ES,BD,2023.0,2,0,2
BH,KW,2006.0,3,0,3
CO,KR,2003.0,1,0,1
AU,SL,2018.0,1,0,1
CU,UY,2008.0,2,0,2
UA,TR,2022.0,3,0,3
BR,VN,2020.0,1,0,1
ER,NO,2011.0,1,0,1
VN,NZ,2018.0,4,0,4
,IM,1997.0,2,0,2
OM,BN,2007.0,1,0,1
RU,PS,2019.0,1,0,1
ZM,MY,2018.0,2,0,2
ZW,UG,2014.0,2,0,2
BE,IS,1999.0,3,0,3
,MS,2004.0,1,0,1
OM,NG,2017.0,2,0,2
PK,GA,2018.0,1,0,1
IE,JM,2013.0,2,0,2
GR,KW,2008.0,3,0,3
AU,SS,2009.0,1,0,1
PK,BH,2014.0,1,0,1
,GW,2017.0,4,0,4
,GW,2019.0,1,0,1
HU,nan,2012.0,6,0,6
GH,BD,2018.0,1,0,1
CH,GP,2004.0,1,0,1
GB,KZ,2000.0,1,0,1
,GW,2010.0,5,0,5
TN,TR,2004.0,1,0,1
US,HT,2005.0,1,0,1
PT,CR,2021.0,3,0,3
MZ,BE,2005.0,3,0,3
LK,PK,2005.0,2,0,2
BR,NG,2003.0,1,0,1
IT,TZ,2019.0,3,0,3
TT,JP,2016.0,2,0,2
IT,TZ,2017.0,4,0,4
KE,IT,2008.0,5,0,5
KZ,AE,2011.0,1,0,1
,SM,2006.0,1,0,1
MS,,2016.0,2,0,2
EG,PH,1997.0,1,0,1
FI,AU,2023.0,3,0,3
ID,PK,2002.0,1,0,1
EE,IT,2002.0,1,0,1
IT,SY,2009.0,2,0,2
NG,ML,2000.0,2,0,2
MX,NZ,2006.0,2,0,2
BH,IQ,2010.0,1,0,1
US,HK,2003.0,5,0,5
EE,AT,2009.0,1,0,1
PA,PK,2012.0,1,0,1
TW,KH,2016.0,1,0,1
NO,BN,2017.0,1,0,1
BW,GB,2007.0,2,0,2
SE,KW,2006.0,1,0,1
UZ,US,1999.0,2,0,2
EE,GR,2006.0,1,0,1
AR,RU,2010.0,2,0,2
PK,ML,2017.0,1,0,1
IE,NP,2016.0,1,0,1
HU,MY,2007.0,1,0,1
SG,ZA,2008.0,2,0,2
ZW,BW,2008.0,3,0,3
PL,ZW,2013.0,1,0,1
ML,CH,2003.0,1,0,1
NZ,KE,2005.0,1,0,1
NZ,NG,2009.0,1,0,1
MY,SD,2006.0,2,0,2
VC,US,2021.0,1,0,1
TG,CF,2019.0,1,0,1
,ZM,2020.0,8,0,8
IL,SK,2021.0,2,0,2
FR,PY,1999.0,1,0,1
CH,QA,2017.0,5,0,5
AU,BA,2015.0,1,0,1
NL,LK,2002.0,1,0,1
IN,IS,2007.0,1,0,1
PG,UY,2020.0,1,0,1
CA,ML,2017.0,3,0,3
IM,US,2018.0,1,0,1
AF,PT,2019.0,1,0,1
GB,HT,2014.0,1,0,1
CY,IQ,2017.0,1,0,1
PK,ID,2005.0,2,0,2
MW,,2000.0,2,0,2
CU,CH,2021.0,2,0,2
US,PY,2013.0,6,0,6
PE,MA,2014.0,1,0,1
TZ,nan,2011.0,1,0,1
UG,nan,2010.0,1,0,1
JO,QA,2001.0,2,0,2
BO,SY,2013.0,1,0,1
MA,BJ,2010.0,1,0,1
FK,,2024.0,5,0,5
OM,CN,2014.0,3,0,3
HU,KW,2002.0,2,0,2
DE,SY,2007.0,2,0,2
NO,KH,2009.0,1,0,1
TH,BT,2012.0,1,0,1
SE,TZ,1997.0,2,0,2
CZ,PK,2009.0,1,0,1
AR,SV,2013.0,1,0,1
KR,PE,2016.0,1,0,1
TH,KZ,2007.0,1,0,1
GA,EG,2013.0,1,0,1
VE,LB,1998.0,1,0,1
ZA,GE,2008.0,1,0,1
LA,CH,2019.0,2,0,2
,AF,1996.0,1,0,1
TR,MX,2007.0,3,0,3
GH,IQ,2015.0,1,0,1
FR,ML,2002.0,4,0,4
LY,OM,2017.0,1,0,1
IT,IS,2006.0,1,0,1
BY,ES,2011.0,2,0,2
KG,,2011.0,2,0,2
DZ,NL,2004.0,1,0,1
CA,BZ,1999.0,1,0,1
SK,MA,2020.0,1,0,1
NL,KH,2022.0,2,0,2
LV,MK,2018.0,1,0,1
FR,XK,2011.0,1,0,1
UG,NZ,2005.0,2,0,2
CW,SK,2011.0,1,0,1
nan,BN,2000.0,1,0,1
AT,RO,2000.0,1,0,1
IE,BR,2000.0,2,0,2
MY,CR,2015.0,2,0,2
PK,AT,2003.0,2,0,2
ET,SG,2008.0,2,0,2
AU,TL,2017.0,1,0,1
SJ,,2018.0,4,0,4
,TM,1996.0,2,0,2
US,SL,2022.0,5,0,5
PL,NZ,2004.0,2,0,2
LA,CH,2017.0,2,0,2
IR,EC,2022.0,1,0,1
BG,MT,2019.0,1,0,1
IT,PA,2011.0,1,0,1
LU,GA,2006.0,1,0,1
IN,KN,2023.0,1,0,1
,GT,2004.0,14,0,14
LU,AT,2006.0,3,0,3
IN,ES,2023.0,3,0,3
IT,UZ,2009.0,1,0,1
RW,FR,2018.0,2,0,2
TW,LB,2016.0,1,0,1
LV,AR,2020.0,1,0,1
IT,BN,2015.0,1,0,1
PE,IT,2001.0,2,0,2
ES,AO,2022.0,1,0,1
EC,IT,2010.0,3,0,3
PT,GR,2009.0,2,0,2
,VU,2005.0,3,0,3
JP,BJ,2011.0,2,0,2
IQ,MX,2020.0,2,0,2
IR,RS,2008.0,1,0,1
MY,TN,2022.0,1,0,1
IS,RU,2020.0,2,0,2
KW,SY,2013.0,1,0,1
TN,IL,2012.0,1,0,1
JP,BT,2007.0,1,0,1
KZ,MD,2010.0,1,0,1
GE,ID,2013.0,1,0,1
BJ,CH,2013.0,1,0,1
SL,GH,2022.0,1,0,1
US,VU,2019.0,1,0,1
CM,NG,2011.0,3,0,3
HU,TR,2012.0,2,0,2
RO,ZA,2001.0,1,0,1
MA,BJ,2017.0,2,0,2
IQ,KW,2002.0,1,0,1
SE,PH,2010.0,2,0,2
PA,,2007.0,5,0,5
ZA,CY,2010.0,1,0,1
IN,BB,2000.0,1,0,1
SK,PT,2021.0,1,0,1
TR,VG,2005.0,1,0,1
AZ,FR,2000.0,1,0,1
IE,nan,2002.0,2,0,2
US,PF,2021.0,1,0,1
LU,AZ,2015.0,1,0,1
LT,CZ,1999.0,3,0,3
UG,GE,2021.0,1,0,1
BZ,,2002.0,1,0,1
GP,PT,2022.0,1,0,1
NG,GR,2021.0,1,0,1
KE,TW,2009.0,1,0,1
GR,RS,2006.0,2,0,2
HR,UZ,2014.0,1,0,1
LT,FI,2019.0,3,0,3
ID,MN,2004.0,1,0,1
CN,ZW,2006.0,1,0,1
LY,CN,2019.0,1,0,1
MW,IQ,2018.0,1,0,1
PK,PE,2007.0,1,0,1
PK,KH,2016.0,1,0,1
KP,,2017.0,1,0,1
EC,SV,2021.0,1,0,1
IT,MK,2001.0,1,0,1
NG,GH,1998.0,1,0,1
BF,CI,2002.0,1,0,1
MD,RO,2000.0,1,0,1
FI,BY,2017.0,2,0,2
SI,RU,2023.0,1,0,1
LK,IT,2009.0,2,0,2
TZ,NG,2010.0,1,0,1
CR,GB,2000.0,1,0,1
ID,ET,2003.0,1,0,1
AT,HR,2004.0,2,0,2
SI,JP,2012.0,5,0,5
NG,CL,2001.0,1,0,1
TR,BH,2011.0,2,0,2
PL,NG,2011.0,1,0,1
CH,CR,2017.0,2,0,2
AF,MY,2012.0,1,0,1
BR,SN,2015.0,1,0,1
CN,SN,2019.0,1,0,1
KW,LB,2003.0,1,0,1
NL,NG,1997.0,1,0,1
TZ,NP,2009.0,1,0,1
NL,IQ,2013.0,1,0,1
GB,MD,2019.0,2,0,2
NO,ZW,2010.0,1,0,1
US,BT,2019.0,2,0,2
CA,KN,2014.0,1,0,1
BN,CA,2001.0,2,0,2
MA,BH,2019.0,1,0,1
GR,AE,2023.0,1,0,1
BF,MG,2017.0,2,0,2
UG,ZW,2007.0,1,0,1
CN,MR,2021.0,1,0,1
,SR,2012.0,9,0,9
AM,KR,1997.0,1,0,1
ID,HU,2004.0,1,0,1
MC,US,2005.0,1,0,1
SA,YE,2009.0,1,0,1
OM,TT,2017.0,1,0,1
MN,KZ,2018.0,1,0,1
JP,FJ,2013.0,1,0,1
BR,ID,2007.0,2,0,2
MY,AL,2020.0,1,0,1
EE,BY,2015.0,1,0,1
UY,UG,2009.0,1,0,1
IT,LV,2019.0,1,0,1
BD,DE,2023.0,1,0,1
GH,GM,2003.0,1,0,1
TR,LU,2014.0,2,0,2
VU,NC,2018.0,1,0,1
PA,TZ,2018.0,1,0,1
LV,AE,2012.0,1,0,1
HR,XK,2008.0,1,0,1
SE,CR,2018.0,2,0,2
FI,AT,2002.0,3,4,-1
IE,BH,2011.0,1,1,0
CL,AT,2002.0,1,1,0
AM,MX,2003.0,1,1,0
RS,VN,2017.0,3,2,1
BE,RS,2022.0,4,6,-2
IR,EG,2005.0,3,1,2
PK,IE,2000.0,1,1,0
QA,CA,2008.0,2,8,-6
AT,LY,2020.0,1,1,0
RS,VN,2019.0,2,1,1
TZ,ZA,2006.0,1,1,0
FR,CI,2001.0,5,5,0
MA,KW,2021.0,2,3,-1
BE,FR,2023.0,5,5,0
AT,IL,2005.0,3,4,-1
NO,GH,2021.0,2,3,-1
SE,SJ,2015.0,1,1,0
FR,KZ,2005.0,1,2,-1
IR,CZ,2008.0,2,2,0
LT,RO,2009.0,2,4,-2
IT,EE,2018.0,3,3,0
HN,AR,2017.0,4,5,-1
GW,DK,2010.0,5,2,3
QA,MA,2022.0,4,2,2
CH,IL,2023.0,1,1,0
UA,SG,2014.0,1,2,-1
AM,CH,2019.0,1,3,-2
SE,GP,2015.0,1,1,0
PH,NL,1997.0,2,1,1
HU,SK,2007.0,4,14,-10
BJ,NG,2002.0,2,1,1
CZ,AE,2011.0,1,1,0
KW,QA,2012.0,2,3,-1
GE,FR,2016.0,1,1,0
ET,NO,2006.0,1,1,0
IL,CZ,2014.0,2,4,-2
ZA,KE,2001.0,1,2,-1
PA,BE,2017.0,1,1,0
UG,RW,2009.0,2,1,1
UA,AR,2018.0,1,2,-1
SE,NG,2004.0,1,3,-2
CU,IT,2021.0,2,2,0
UG,NG,2020.0,4,10,-6
PS,SG,2019.0,1,1,0
TR,PS,2017.0,2,2,0
SA,OM,2008.0,2,2,0
IQ,LY,2012.0,1,3,-2
CU,DO,2021.0,1,1,0
AU,IS,2018.0,4,4,0
IN,HR,2020.0,1,1,0
MA,BJ,2019.0,2,1,1
BJ,ZA,2021.0,1,2,-1
SY,JO,2018.0,2,6,-4
SA,SY,2013.0,1,6,-5
KZ,JP,2022.0,1,2,-1
KE,SD,2003.0,1,7,-6
IE,QA,2020.0,7,3,4
ID,CW,2020.0,1,1,0
YE,GB,2012.0,1,2,-1
CN,UG,2001.0,1,1,0
PK,FR,2020.0,7,19,-12
BE,TW,2001.0,1,2,-1
HU,DK,2012.0,3,3,0
SE,UY,2016.0,3,1,2
IN,SK,2011.0,2,2,0
TR,PH,2009.0,2,2,0
BG,IE,2010.0,1,1,0
UG,KR,2007.0,1,1,0
TR,GE,2014.0,1,3,-2
CZ,DE,2023.0,3,3,0
CL,IN,2009.0,1,2,-1
LK,DE,2015.0,2,2,0
NL,LB,2014.0,1,1,0
CH,LT,2016.0,1,4,-3
JP,CL,2017.0,2,4,-2
KW,PK,2007.0,2,2,0
GB,VG,2008.0,1,1,0
HU,AE,2020.0,1,2,-1
SK,TR,2009.0,1,1,0
MY,ZA,2000.0,1,1,0
FR,CD,1999.0,1,1,0
BH,PK,2019.0,2,3,-1
MY,nan,2023.0,2,2,0
BR,CZ,2005.0,4,1,3
KE,MW,2018.0,2,1,1
KE,EG,2020.0,1,1,0
CM,GH,2022.0,1,1,0
US,TJ,2015.0,2,2,0
KZ,IL,2016.0,2,2,0
NI,HN,2016.0,1,1,0
RS,GR,2005.0,1,1,0
RO,FI,2003.0,1,1,0
AM,TW,2007.0,1,1,0
ID,TR,2013.0,1,1,0
MY,MX,2014.0,1,4,-3
NG,LR,2020.0,1,1,0
RO,MK,2018.0,1,1,0
BG,IL,2021.0,1,1,0
US,MO,2011.0,1,1,0
FR,BO,2013.0,1,7,-6
MA,ZA,2016.0,1,1,0
HU,IQ,2016.0,1,2,-1
QA,NZ,2022.0,1,1,0
BW,TZ,2021.0,1,1,0
GB,BO,2016.0,1,1,0
AE,SE,2011.0,1,1,0
MX,NI,2008.0,2,1,1
CL,PE,1999.0,2,5,-3
SN,ZA,2011.0,1,1,0
CY,GB,1999.0,1,4,-3
TJ,UA,2021.0,1,6,-5
US,SV,2018.0,2,9,-7
JM,ZA,2011.0,1,1,0
ME,US,2016.0,1,3,-2
AT,UG,2021.0,1,1,0
US,BT,2017.0,1,1,0
TZ,JP,1999.0,1,1,0
LU,IN,2012.0,1,3,-2
VE,HN,2009.0,1,2,-1
CA,UY,2011.0,3,4,-1
ZM,CH,2022.0,1,2,-1
LB,IN,2023.0,1,2,-1
LU,ID,2019.0,1,1,0
ET,ZA,2007.0,4,4,0
LT,FI,2017.0,1,2,-1
TR,SK,2019.0,1,1,0
BD,AT,2008.0,2,1,1
LB,ES,2017.0,2,2,0
CA,ML,2019.0,2,1,1
BG,BR,2005.0,1,1,0
MD,CH,2008.0,4,1,3
IN,GE,2009.0,1,1,0
EC,CU,2013.0,1,10,-9
IT,TZ,2010.0,1,1,0
SG,UA,2010.0,1,1,0
NI,DK,2012.0,1,1,0
FI,TN,2012.0,1,1,0
IL,HU,2004.0,1,4,-3
AM,CH,2017.0,1,2,-1
RO,PT,2015.0,2,6,-4
MA,RU,2002.0,1,1,0
RU,KZ,1997.0,1,1,0
IE,BG,2012.0,1,2,-1
PL,IR,2018.0,1,10,-9
HR,IT,2007.0,1,2,-1
BR,AF,2013.0,1,1,0
LB,RU,2018.0,1,1,0
NP,BD,2022.0,2,3,-1
FI,CN,2023.0,2,6,-4
JO,IL,2012.0,2,1,1
PS,IT,2004.0,1,1,0
MZ,BR,2005.0,2,2,0
NP,PH,2011.0,1,1,0
GR,IN,2012.0,1,6,-5
ZW,DE,2016.0,2,1,1
UG,FR,2022.0,1,2,-1
CA,CD,2020.0,1,5,-4
BW,ET,2016.0,1,1,0
US,GH,1997.0,2,1,1
KE,BF,2017.0,1,1,0
GH,HU,2018.0,1,1,0
NL,EC,2018.0,2,4,-2
CL,TW,2006.0,1,2,-1
IS,NZ,2016.0,1,1,0
GB,SC,2013.0,1,1,0
LK,IE,2014.0,1,1,0
GB,MC,2011.0,1,1,0
US,NA,2001.0,2,1,1
JP,HR,2007.0,1,4,-3
BN,SG,2010.0,1,2,-1
SN,GH,2013.0,1,1,0
SG,LT,2011.0,1,1,0
IT,VE,2018.0,1,5,-4
GT,GB,2015.0,1,3,-2
MX,DZ,2015.0,1,2,-1
PL,JP,2023.0,1,1,0
CH,TZ,2006.0,1,1,0
CN,BW,2022.0,1,1,0
UG,TR,2020.0,1,1,0
KE,FI,2017.0,1,1,0
TW,DK,2015.0,1,2,-1
BY,KZ,2019.0,1,2,-1
GR,PL,2007.0,1,4,-3
TR,TW,2022.0,1,5,-4
IL,NO,2005.0,1,1,0
IE,KE,2011.0,1,1,0
AR,CZ,2014.0,1,1,0
KZ,CY,2018.0,1,1,0
KW,SE,2008.0,1,2,-1
CA,CR,2009.0,2,1,1
TR,AE,2013.0,3,4,-1
PE,AR,2002.0,2,5,-3
KZ,ES,2016.0,1,1,0
BN,SG,2019.0,1,3,-2
NZ,RU,2009.0,1,1,0
SE,PA,2014.0,2,3,-1
XK,VN,2020.0,1,1,0
SI,BR,2011.0,1,2,-1
EG,CA,1998.0,3,6,-3
SE,AL,2017.0,1,1,0
MU,AU,2019.0,1,1,0
AL,GR,2021.0,2,2,0
NZ,BR,1999.0,1,2,-1
FR,BI,1999.0,3,7,-4
JM,CA,2012.0,4,2,2
VN,nan,2021.0,1,8,-7
VE,NI,2007.0,1,1,0
TR,SK,2010.0,1,1,0
NG,CI,2006.0,1,1,0
DE,JM,2000.0,1,1,0
MZ,GB,2013.0,1,2,-1
AR,BO,2005.0,1,2,-1
ES,BY,2018.0,1,1,0
SK,CA,2018.0,1,4,-3
CN,MA,2008.0,1,1,0
CH,MD,2006.0,1,2,-1
ML,MR,2020.0,1,1,0
IN,RE,2016.0,1,1,0
US,AO,2021.0,2,4,-2
MU,IT,2005.0,1,1,0
BE,GN,2014.0,1,0,1
SK,PK,2022.0,1,0,1
NL,CG,2018.0,1,0,1
NE,DE,2020.0,1,0,1
BF,nan,2009.0,1,0,1
CR,UY,2005.0,1,0,1
IR,TW,2003.0,1,0,1
IR,MK,2016.0,2,0,2
IT,CG,2019.0,3,0,3
LU,DZ,2013.0,1,0,1
TW,IS,2004.0,1,0,1
MK,MY,2009.0,1,0,1
BH,CZ,2019.0,1,0,1
LT,BE,2007.0,2,0,2
PY,GB,2021.0,1,0,1
ML,,2007.0,2,0,2
RU,GH,2005.0,1,0,1
MK,BE,2014.0,1,0,1
GB,FO,2021.0,1,0,1
DE,AZ,2001.0,1,0,1
NP,MY,2009.0,1,0,1
CH,AM,1999.0,2,0,2
SS,GH,2019.0,1,0,1
ER,,2005.0,1,0,1
BE,CW,2007.0,1,0,1
AT,TN,2008.0,1,0,1
MK,IR,2008.0,1,0,1
SN,,2000.0,8,0,8
BR,VG,2005.0,1,0,1
KE,KR,2016.0,1,0,1
,KN,2016.0,7,0,7
CG,IN,2020.0,1,0,1
CV,BR,2016.0,3,0,3
CL,TR,2001.0,1,0,1
CA,BY,2014.0,1,0,1
CR,SE,2009.0,1,0,1
MD,VN,2007.0,1,0,1
GY,US,2012.0,1,0,1
MX,PS,2001.0,1,0,1
SG,JM,1999.0,1,0,1
CH,BT,2012.0,1,0,1
AG,RU,2020.0,1,0,1
MD,GP,2020.0,2,0,2
IT,BO,2008.0,2,0,2
LS,SZ,2019.0,1,0,1
LU,UY,2016.0,1,0,1
,BM,2003.0,2,0,2
CU,LK,2013.0,1,0,1
ME,CN,2001.0,2,0,2
BE,HN,2012.0,1,0,1
TR,SY,2008.0,1,0,1
VN,CU,2021.0,1,0,1
TZ,MX,2013.0,1,0,1
PL,MY,2010.0,1,0,1
AR,GE,2021.0,1,0,1
IR,OM,2010.0,1,0,1
DZ,SD,2011.0,1,0,1
MY,KZ,2011.0,1,0,1
QA,NP,2021.0,1,0,1
BT,IN,1999.0,1,0,1
DE,TG,2019.0,1,0,1
DZ,MY,2003.0,1,0,1
LY,MD,2005.0,1,0,1
KW,CZ,2019.0,1,0,1
MU,,2004.0,5,0,5
GT,IL,2011.0,1,0,1
PT,HN,2013.0,1,0,1
IN,ME,2021.0,1,0,1
KR,KE,2019.0,2,0,2
MY,FI,2018.0,3,0,3
SN,LU,2019.0,1,0,1
SS,NZ,2007.0,1,0,1
IT,TN,1998.0,1,0,1
MA,GR,2021.0,1,0,1
SN,GP,2022.0,1,0,1
,JE,2006.0,1,0,1
DK,SN,2018.0,1,0,1
BR,RE,2020.0,1,0,1
NL,ZM,2006.0,1,0,1
CA,MG,2015.0,1,0,1
SG,GH,2014.0,1,0,1
ZA,TW,2007.0,1,0,1
GE,IL,2016.0,1,0,1
BY,HU,2012.0,2,0,2
FR,CY,2005.0,1,0,1
LY,PK,2005.0,1,0,1
NZ,BS,2020.0,1,0,1
AM,CZ,2001.0,1,0,1
CL,IL,2002.0,1,0,1
BJ,GF,2014.0,1,0,1
TL,JP,2017.0,1,0,1
KE,nan,2007.0,2,0,2
BY,NO,2012.0,1,0,1
LK,QA,2018.0,1,0,1
BW,LB,2004.0,1,0,1
BI,KE,2019.0,1,0,1
PH,GT,2016.0,1,0,1
NO,PA,2014.0,1,0,1
GN,GB,2012.0,1,0,1
DK,KN,2017.0,1,0,1
NI,GT,2015.0,1,0,1
AU,HR,2002.0,1,0,1
LB,QA,2008.0,1,0,1
RU,SG,1999.0,1,0,1
KZ,HU,2002.0,1,0,1
SD,ET,2021.0,1,0,1
VI,PL,2017.0,1,0,1
TH,MD,2020.0,1,0,1
BD,nan,2005.0,1,0,1
BD,IR,2005.0,2,0,2
KE,MA,2018.0,1,0,1
MA,IS,2022.0,1,0,1
ZA,OM,2004.0,1,0,1
BW,SI,2007.0,1,0,1
LB,DK,2018.0,2,0,2
MG,,2000.0,2,0,2
GM,QA,2018.0,1,0,1
SY,NG,2006.0,1,0,1
HU,MW,2018.0,1,0,1
NO,PS,2005.0,1,0,1
GE,UZ,2005.0,2,0,2
GB,MR,1997.0,1,0,1
GR,RU,2001.0,3,0,3
ZA,KW,2013.0,1,0,1
UZ,CH,2017.0,1,0,1
AE,GR,2009.0,1,0,1
PL,GT,2017.0,1,0,1
AF,LK,2019.0,1,0,1
SE,UG,2004.0,4,0,4
JO,CY,2009.0,1,0,1
KZ,UY,2006.0,1,0,1
RS,GE,2010.0,1,0,1
IL,NZ,2007.0,1,0,1
KE,SO,2022.0,1,0,1
JO,AZ,2007.0,1,0,1
MY,DE,2004.0,1,0,1
ZW,JP,2018.0,1,0,1
GB,ML,2022.0,1,0,1
JO,LU,2021.0,1,0,1
SE,BY,1999.0,1,0,1
GT,IT,2007.0,1,0,1
SA,KZ,2022.0,1,0,1
VE,JO,2005.0,1,0,1
BE,NP,2012.0,1,0,1
UZ,IN,1998.0,1,0,1
MX,BD,2022.0,1,0,1
SL,GB,2007.0,1,0,1
AT,BT,2019.0,2,0,2
ZA,SD,2021.0,2,0,2
YE,BR,2015.0,1,0,1
CN,PR,2020.0,1,0,1
AM,BR,2016.0,1,0,1
SZ,,2004.0,2,0,2
AR,DK,2005.0,1,0,1
JO,PK,2019.0,3,0,3
IR,ZW,2022.0,1,0,1
CL,BD,2015.0,1,0,1
JP,MW,2017.0,1,0,1
RO,MX,2015.0,1,0,1
IE,MN,2017.0,1,0,1
MM,IL,2021.0,1,0,1
CR,RU,2016.0,1,0,1
SY,RU,2019.0,1,0,1
CA,MQ,2011.0,1,0,1
OM,BG,2014.0,1,0,1
ER,,2002.0,1,0,1
PH,KR,2023.0,2,0,2
SK,KZ,2022.0,1,0,1
UG,NZ,2002.0,2,0,2
MU,NZ,2017.0,1,0,1
PA,BE,2010.0,1,0,1
VE,RU,2004.0,1,0,1
CO,SE,2002.0,1,0,1
nan,CG,2022.0,1,0,1
AE,RS,2020.0,1,0,1
UA,MD,1997.0,1,0,1
TH,PT,2017.0,1,0,1
LK,SG,2002.0,1,0,1
CA,SD,2001.0,1,0,1
HU,CO,2019.0,1,0,1
CN,TG,2015.0,1,0,1
NP,SG,2006.0,1,0,1
AU,GY,2016.0,1,0,1
VI,PL,2019.0,1,0,1
MV,DK,2018.0,1,0,1
JO,AF,2017.0,1,0,1
AT,AE,2011.0,1,0,1
GT,QA,2012.0,1,0,1
ZA,CZ,2007.0,1,0,1
CN,SI,2001.0,1,0,1
AM,KR,1998.0,1,0,1
AU,GN,2019.0,1,0,1
MW,NA,2010.0,1,0,1
BD,LT,2020.0,1,0,1
UZ,RS,1998.0,1,0,1
DE,GT,2006.0,1,0,1
NO,CM,2016.0,1,0,1
BD,NG,2004.0,1,0,1
MG,AU,2012.0,1,0,1
NP,NG,2013.0,1,0,1
VE,IL,2012.0,1,0,1
GN,MZ,2006.0,1,0,1
AU,UZ,2021.0,1,0,1
SE,MZ,2020.0,1,0,1
JM,PH,2005.0,1,0,1
AM,DK,2014.0,1,0,1
PY,AR,1997.0,1,0,1
NG,TN,2020.0,1,0,1
AU,AL,2021.0,1,0,1
BT,NZ,2019.0,1,0,1
BG,BY,2008.0,1,0,1
CH,PS,2022.0,3,0,3
MA,WS,2016.0,1,0,1
FJ,,2001.0,1,0,1
SK,BG,2015.0,1,0,1
BJ,CL,2008.0,1,0,1
LU,ML,2014.0,1,0,1
IR,OM,2019.0,2,0,2
SN,CH,1999.0,1,0,1
CO,PL,2018.0,2,0,2
NC,MX,2010.0,1,0,1
RS,GR,2002.0,1,0,1
AM,QA,2012.0,1,0,1
MC,US,2002.0,2,0,2
LS,SZ,2017.0,1,0,1
DE,AO,2012.0,1,0,1
NZ,HU,2004.0,1,0,1
BB,CA,2020.0,1,0,1
HK,PL,2006.0,1,0,1
CO,ID,2015.0,1,0,1
AO,CN,2016.0,1,0,1
AE,AU,1998.0,1,0,1
AM,HU,2020.0,1,0,1
GI,BR,2014.0,1,0,1
LU,BD,2012.0,1,0,1
SI,SK,2002.0,2,0,2
LT,NO,2004.0,1,0,1
AO,MX,2003.0,1,0,1
,MS,1996.0,1,0,1
PG,TR,2022.0,1,0,1
CR,DK,2011.0,1,0,1
BE,AE,1999.0,1,0,1
TH,GH,2021.0,1,0,1
CH,VG,2019.0,1,0,1
MM,AT,2022.0,1,0,1
KH,TL,2014.0,1,0,1
LY,AE,2003.0,1,0,1
IE,FI,1997.0,1,0,1
NZ,PH,2004.0,1,0,1
UG,CZ,2016.0,1,0,1
RO,GR,2021.0,1,0,1
BO,TR,2010.0,1,0,1
MA,MQ,2015.0,1,0,1
BT,GB,2009.0,1,0,1
NG,GH,1997.0,1,0,1
NG,CN,1998.0,1,0,1
IS,PE,2015.0,1,0,1
SA,IE,2023.0,2,0,2
DE,TZ,2002.0,1,0,1
HK,RS,2018.0,1,0,1
BE,IL,2022.0,3,0,3
CO,IR,2006.0,1,0,1
KR,SS,2015.0,1,0,1
CR,GR,2015.0,1,0,1
UY,NO,2007.0,1,0,1
EG,TH,2013.0,1,0,1
PT,AO,1997.0,1,0,1
CA,TT,2013.0,1,0,1
BE,OM,2016.0,1,0,1
CL,UZ,2022.0,1,0,1
LY,CN,2010.0,1,0,1
DE,TG,2010.0,1,0,1
,IM,1998.0,1,0,1
NC,nan,2017.0,1,0,1
KR,HU,2001.0,1,0,1
TR,VN,2020.0,1,0,1
JO,IT,2023.0,1,0,1
XK,AL,2005.0,1,0,1
UG,BD,2015.0,1,0,1
IQ,ID,2012.0,1,0,1
MY,BT,2017.0,1,0,1
LR,,2007.0,1,0,1
JP,LV,2004.0,1,0,1
LK,BE,2008.0,1,0,1
BE,LK,2014.0,1,0,1
SI,AL,2020.0,1,0,1
MA,TW,2001.0,1,0,1
FR,GD,2018.0,1,0,1
AU,GB,2007.0,987,1015,-28
CN,SG,2018.0,432,564,-132
US,CN,2020.0,6423,5032,1391
RU,CA,2014.0,18,31,-13
US,IN,2016.0,2761,2666,95
MX,AR,2009.0,66,69,-3
TW,CA,2009.0,36,30,6
GB,CA,2017.0,888,938,-50
CZ,TR,2010.0,5,6,-1
GB,CA,2019.0,1063,1013,50
LB,BR,2012.0,6,4,2
FR,GB,1999.0,314,225,89
US,PH,2003.0,220,262,-42
CL,ES,2009.0,222,242,-20
IN,AU,2021.0,196,190,6
JP,US,2001.0,1809,1615,194
PT,CN,2003.0,10,11,-1
NL,DE,2012.0,343,337,6
MY,IN,2020.0,150,130,20
US,HU,2005.0,102,105,-3
BR,NO,2006.0,15,23,-8
US,NL,1998.0,314,302,12
US,TR,2022.0,201,226,-25
US,NL,1997.0,220,228,-8
DE,CH,2012.0,959,726,233
TW,CN,2006.0,1077,555,522
US,VN,2020.0,202,115,87
CO,ES,2006.0,146,180,-34
US,MX,2018.0,496,534,-38
US,PE,2009.0,35,52,-17
BR,CL,2009.0,52,67,-15
BR,GB,2014.0,175,191,-16
ES,BR,2017.0,422,350,72
CA,DE,2008.0,176,277,-101
ID,AT,2014.0,2,2,0
nan,US,2009.0,254,246,8
AU,CN,2018.0,549,521,28
MY,IQ,2015.0,78,23,55
CO,CL,2008.0,85,117,-32
MY,IR,2019.0,161,75,86
BR,PL,2018.0,29,22,7
AU,IE,2020.0,133,132,1
US,SG,2015.0,459,388,71
DE,AU,2008.0,184,160,24
GR,BE,2017.0,24,17,7
US,IL,2012.0,461,514,-53
AR,FR,2015.0,91,87,4
ES,BR,2010.0,271,260,11
NL,ES,1999.0,27,30,-3
ES,IT,2016.0,269,283,-14
ES,FR,2015.0,369,289,80
PL,US,2004.0,183,171,12
CN,FR,2000.0,59,80,-21
IT,US,2021.0,802,749,53
JP,CA,1999.0,91,101,-10
NL,AU,2012.0,84,75,9
AT,CH,2005.0,53,66,-13
MY,CA,2019.0,36,32,4
ID,JP,2008.0,36,96,-60
CH,GB,2007.0,208,174,34
DE,MX,2017.0,40,50,-10
DE,CO,2010.0,7,15,-8
NL,BE,2004.0,120,144,-24
EG,MY,2009.0,14,6,8
DE,LU,2021.0,31,35,-4
US,BR,2007.0,781,678,103
IN,ZA,2013.0,68,47,21
IT,CA,2018.0,218,124,94
BR,ES,2007.0,181,208,-27
JO,PS,2016.0,7,3,4
US,HU,2002.0,75,97,-22
ET,UG,2019.0,1,6,-5
CN,JP,2013.0,423,640,-217
CA,NL,2002.0,45,37,8
RO,IN,2014.0,19,16,3
CL,GB,2018.0,75,61,14
VE,US,2008.0,47,59,-12
CN,DK,2017.0,55,48,7
IL,US,2013.0,495,503,-8
CH,CA,2001.0,55,42,13
DE,PL,2014.0,143,135,8
nan,NL,2012.0,76,62,14
SE,DE,2020.0,251,293,-42
AU,CZ,2006.0,3,6,-3
IT,IE,2014.0,34,35,-1
KR,MY,2013.0,41,20,21
ES,PA,2022.0,4,8,-4
ET,JP,2008.0,1,6,-5
FR,CA,1997.0,160,130,30
DE,IT,2000.0,111,126,-15
CI,FR,2019.0,27,37,-10
AR,IT,2017.0,79,119,-40
FR,BE,2009.0,332,254,78
FR,CH,2012.0,430,335,95
BO,CL,2017.0,12,15,-3
CA,AR,2004.0,9,17,-8
SD,SA,2014.0,26,11,15
MY,IR,2017.0,233,61,172
KP,KR,2015.0,1,3,-2
JP,IN,2013.0,118,129,-11
AU,FJ,2019.0,6,9,-3
NL,GB,2002.0,161,154,7
MX,CA,2002.0,15,14,1
ES,NL,2013.0,96,81,15
JP,ES,2007.0,30,27,3
BE,NL,1999.0,93,90,3
VN,US,2020.0,115,202,-87
RS,DE,2020.0,24,34,-10
US,NO,2013.0,161,132,29
CN,NL,2018.0,146,149,-3
TW,CH,2009.0,5,2,3
US,CR,2010.0,35,27,8
AU,CA,2004.0,230,208,22
RU,PT,1999.0,9,2,7
NL,CW,2016.0,6,36,-30
PL,GB,2016.0,105,103,2
IN,CH,2004.0,20,8,12
NO,KE,2015.0,1,1,0
CN,KZ,2007.0,8,19,-11
MX,HN,2015.0,26,25,1
SL,CN,2020.0,1,1,0
FR,CA,1998.0,226,189,37
RO,BE,2017.0,12,10,2
JP,IE,2012.0,20,25,-5
LK,AU,2013.0,21,17,4
JP,PL,2001.0,14,16,-2
BA,RS,2016.0,38,45,-7
AU,CH,2015.0,89,79,10
FR,nan,1998.0,40,27,13
IT,nan,2008.0,103,67,36
JP,ID,2009.0,112,32,80
RU,NL,2018.0,50,64,-14
SG,DE,2015.0,45,39,6
nan,SE,2009.0,62,38,24
LB,FR,2020.0,107,92,15
FR,IT,2022.0,174,214,-40
JP,UG,2011.0,2,1,1
BR,FR,2014.0,189,218,-29
CN,CO,2003.0,3,5,-2
ES,CN,2002.0,27,15,12
TR,CN,2011.0,18,128,-110
RO,CN,2012.0,4,3,1
nan,AU,2012.0,27,34,-7
CN,UA,2007.0,15,17,-2
VN,CN,2002.0,41,27,14
TH,CN,2007.0,11,7,4
ZA,ZW,2018.0,46,55,-9
CR,AR,2020.0,14,13,1
VN,CN,2005.0,54,24,30
CN,KE,2013.0,8,14,-6
CZ,CN,2008.0,59,40,19
CN,ID,2008.0,8,15,-7
DE,BE,2011.0,129,110,19
ES,CN,2005.0,34,23,11
CL,US,2006.0,110,110,0
SK,CA,2019.0,7,3,4
CA,SK,2022.0,1,1,0
RU,BG,2008.0,24,6,18
JP,NL,2007.0,31,25,6
GB,FR,2004.0,329,370,-41
FR,KR,2005.0,24,13,11
DE,DK,2002.0,57,60,-3
AR,IT,2019.0,123,132,-9
SA,CA,2021.0,61,83,-22
EG,KW,2014.0,28,30,-2
RU,MX,2009.0,9,12,-3
CA,HU,2017.0,8,7,1
SE,SK,2005.0,5,3,2
GB,TR,2006.0,48,35,13
RU,IT,2019.0,58,63,-5
CN,DK,2019.0,50,53,-3
IR,OM,2018.0,9,2,7
PT,AR,2012.0,14,11,3
CA,HU,2019.0,13,12,1
CI,FR,2017.0,26,29,-3
CU,MX,2012.0,58,38,20
JP,BE,2002.0,19,22,-3
BE,US,2018.0,416,361,55
RU,BY,2018.0,62,133,-71
LB,ES,2018.0,3,7,-4
CZ,CH,2010.0,28,17,11
DE,CZ,2017.0,79,82,-3
KR,DE,2018.0,68,65,3
ES,RU,2010.0,11,15,-4
FR,nan,1997.0,35,22,13
DZ,MA,2016.0,20,17,3
NL,CH,2007.0,68,50,18
ID,SG,2019.0,27,43,-16
ID,GB,2002.0,3,4,-1
MX,VN,2017.0,19,6,13
IE,DK,2011.0,9,8,1
VN,DE,2015.0,11,16,-5
CA,SE,2016.0,65,41,24
IT,AU,2009.0,50,38,12
JP,BR,2014.0,68,58,10
PT,CL,2021.0,7,12,-5
RU,SE,2011.0,30,25,5
SG,PK,2022.0,5,5,0
RU,IT,2010.0,23,25,-2
MN,JP,2011.0,3,4,-1
IE,IT,2014.0,35,34,1
UZ,RU,2010.0,17,12,5
BR,JP,1999.0,25,23,2
FR,MX,2013.0,53,54,-1
IT,CN,2012.0,46,34,12
IT,BG,2021.0,4,4,0
PL,ES,2005.0,13,9,4
US,CR,2019.0,56,52,4
CA,PK,2016.0,49,33,16
IL,FR,2017.0,36,39,-3
NZ,AU,2022.0,106,86,20
DE,CZ,2019.0,88,80,8
PL,HU,2018.0,35,34,1
ZA,BR,2020.0,11,15,-4
IT,SE,2010.0,91,62,29
PA,US,2020.0,46,41,5
IT,SE,2017.0,94,61,33
ZA,PK,2016.0,4,5,-1
ES,RU,2019.0,27,29,-2
EG,GB,2010.0,38,74,-36
KR,VN,2007.0,11,8,3
BH,ET,2019.0,21,31,-10
BR,FI,2018.0,12,7,5
ES,BE,2011.0,60,54,6
FR,PT,2006.0,28,22,6
IR,MY,2004.0,1,1,0
PT,NL,2017.0,36,19,17
PT,NL,2019.0,35,15,20
TR,GB,2008.0,43,46,-3
DE,IE,2005.0,59,34,25
HU,RO,2021.0,41,30,11
GR,SE,2004.0,4,5,-1
CN,IR,2010.0,24,25,-1
SG,MY,2000.0,4,10,-6
US,CZ,2015.0,194,139,55
DK,GB,2008.0,96,136,-40
RU,CH,2001.0,14,11,3
LB,SA,2020.0,12,8,4
AU,BE,2005.0,7,19,-12
CZ,SK,1997.0,16,11,5
IN,AT,2011.0,17,8,9
AR,CA,2015.0,30,20,10
CN,IR,2017.0,40,57,-17
BG,US,2008.0,25,33,-8
DK,IT,2001.0,13,8,5
IN,JP,2000.0,109,83,26
GB,IL,2001.0,34,27,7
HU,US,2020.0,101,87,14
nan,CA,2017.0,88,42,46
MY,BD,2012.0,23,37,-14
MX,VE,2015.0,36,57,-21
ZA,BE,2019.0,30,22,8
NL,BR,2014.0,64,59,5
MX,PT,2007.0,12,3,9
CI,FR,2010.0,13,23,-10
MX,CA,2005.0,24,22,2
ZA,BE,2017.0,12,21,-9
GB,MX,2011.0,51,43,8
RS,CZ,2020.0,14,9,5
DK,FI,2016.0,20,27,-7
FR,JP,2001.0,64,76,-12
EG,IN,2015.0,19,15,4
SA,FR,2017.0,18,42,-24
SA,IQ,2018.0,39,22,17
CA,ML,2018.0,1,1,0
PK,CA,2015.0,49,48,1
IN,BR,2015.0,41,33,8
ID,BD,2020.0,54,61,-7
US,MW,2018.0,29,26,3
MY,CA,2017.0,46,31,15
BR,PE,2000.0,4,3,1
SA,FR,2010.0,8,12,-4
CA,NO,2012.0,24,24,0
CN,IR,2019.0,49,83,-34
RU,IN,2018.0,22,42,-20
IN,IT,2022.0,70,31,39
AR,US,2011.0,241,219,22
BE,ID,2021.0,13,13,0
CN,RU,2020.0,91,53,38
ES,UY,2017.0,63,54,9
TH,PH,2021.0,6,9,-3
VN,NZ,2017.0,2,4,-2
US,CY,2000.0,8,6,2
GB,nan,2008.0,60,88,-28
TR,PS,2018.0,1,1,0
IL,MX,2020.0,4,3,1
BR,CU,2015.0,23,37,-14
LK,JP,2020.0,14,22,-8
TR,RU,2020.0,18,9,9
ES,NO,2021.0,25,24,1
IR,CH,2016.0,31,15,16
AT,CL,2021.0,1,4,-3
NG,IR,2016.0,2,2,0
EG,GB,2017.0,60,117,-57
PE,BR,2021.0,50,69,-19
PL,FR,2022.0,27,15,12
MM,IQ,2018.0,3,1,2
AU,BR,2014.0,81,134,-53
RU,IT,2017.0,27,59,-32
SE,JP,2008.0,41,44,-3
GM,TW,2021.0,1,1,0
GR,BE,2010.0,18,13,5
SA,KR,2017.0,16,24,-8
TR,RS,2005.0,66,58,8
SJ,NO,2016.0,8,5,3
IR,BE,2020.0,41,15,26
NG,JP,2021.0,32,23,9
CH,RU,2012.0,14,38,-24
BE,FR,2000.0,151,132,19
SY,US,2018.0,14,4,10
IN,IQ,2017.0,23,6,17
CO,IT,2018.0,24,22,2
QA,CN,2021.0,25,47,-22
BD,KR,2022.0,17,19,-2
BO,CO,2021.0,9,8,1
FR,MC,2002.0,5,2,3
KE,FI,2018.0,4,2,2
AU,EG,2022.0,11,16,-5
GB,RO,2018.0,78,56,22
FR,SG,2013.0,22,31,-9
SG,KR,2015.0,35,37,-2
PT,SE,2012.0,8,8,0
AE,IN,2021.0,61,66,-5
IT,VE,2017.0,4,7,-3
CH,SE,2009.0,37,47,-10
FR,NG,2022.0,4,5,-1
ES,UY,2019.0,65,57,8
HR,US,2018.0,36,50,-14
CN,SE,2009.0,68,82,-14
PL,BH,2016.0,9,6,3
PL,IN,2016.0,21,11,10
US,FI,1999.0,98,97,1
UA,PL,2018.0,60,59,1
CA,ID,2015.0,33,9,24
ID,nan,2021.0,75,74,1
FI,FR,2007.0,16,14,2
ES,AE,2015.0,4,4,0
NL,TH,2009.0,6,4,2
US,CR,2017.0,50,45,5
BE,CH,2016.0,67,74,-7
US,UG,2012.0,23,23,0
DE,IL,2023.0,2,3,-1
BG,RU,2018.0,51,31,20
NL,EC,2017.0,5,4,1
HU,EG,2019.0,6,6,0
DE,ID,2012.0,26,12,14
CA,NL,2005.0,54,55,-1
CA,RO,2011.0,17,11,6
AU,KR,2008.0,20,26,-6
MX,FR,2009.0,42,48,-6
CA,AM,2015.0,2,1,1
BG,DE,1997.0,13,8,5
nan,CA,2019.0,50,39,11
UY,AR,2001.0,2,4,-2
DE,PH,2009.0,4,5,-1
SE,IQ,2020.0,4,5,-1
CH,NO,2011.0,11,13,-2
SI,HR,2022.0,16,14,2
DE,VE,2004.0,2,8,-6
FR,IR,2015.0,31,18,13
DK,BR,2014.0,16,13,3
TZ,KE,2021.0,7,6,1
CA,RS,2014.0,11,5,6
NG,AU,2020.0,18,6,12
AU,ZA,2013.0,55,67,-12
RS,HR,2000.0,15,13,2
BW,KE,2022.0,1,1,0
RS,GB,2006.0,21,13,8
IT,VE,2010.0,5,6,-1
US,OM,2008.0,14,4,10
GR,DK,2015.0,10,10,0
NO,IN,1999.0,28,24,4
nan,DK,2020.0,24,13,11
ES,UY,2010.0,28,40,-12
GB,LB,2014.0,12,4,8
FR,NL,2004.0,127,129,-2
SI,MX,2017.0,9,9,0
PK,CH,2008.0,20,8,12
PT,DE,2011.0,28,53,-25
US,IS,2004.0,19,9,10
DE,IE,2002.0,20,26,-6
PK,AR,2007.0,12,7,5
PS,US,2014.0,4,9,-5
IN,EG,2009.0,3,3,0
CO,VE,2020.0,31,63,-32
DK,RU,2020.0,7,10,-3
DE,AR,2003.0,14,28,-14
BE,AU,2007.0,28,15,13
EG,DZ,2011.0,2,4,-2
BR,TR,2006.0,43,10,33
KR,AU,2009.0,24,27,-3
PL,IT,2004.0,7,8,-1
IQ,SA,2021.0,30,33,-3
ET,RU,2021.0,2,2,0
AT,VN,2020.0,4,2,2
PT,RU,2022.0,12,7,5
BE,PE,2012.0,3,1,2
ES,VE,2021.0,22,43,-21
MX,VN,2019.0,7,7,0
HU,ID,2014.0,6,3,3
NG,IN,2003.0,1,1,0
CN,FI,2013.0,24,23,1
BD,EG,2016.0,8,8,0
IR,ES,2011.0,6,9,-3
PT,NL,2010.0,13,24,-11
JP,IL,2013.0,16,4,12
AT,ES,2007.0,8,14,-6
ID,SA,2012.0,2,1,1
IL,CH,2005.0,11,10,1
NO,GR,2002.0,2,1,1
UA,UZ,2020.0,3,3,0
GB,LT,2018.0,9,14,-5
CH,BE,2017.0,83,80,3
DE,nan,2018.0,68,84,-16
TR,TW,2016.0,3,8,-5
IL,nan,2013.0,21,20,1
CN,KP,2019.0,19,4,15
AE,US,2006.0,16,28,-12
UZ,RU,2017.0,34,16,18
ID,GB,2005.0,3,9,-6
RO,CZ,2020.0,6,3,3
GR,CH,2010.0,14,16,-2
CH,GR,2011.0,14,25,-11
MY,DE,2014.0,15,20,-5
LK,EG,2019.0,2,2,0
ZW,BW,2013.0,2,2,0
BR,LB,2019.0,9,8,1
NO,TW,2019.0,2,5,-3
CM,CH,2021.0,5,3,2
BR,AU,1998.0,6,7,-1
GE,RU,2016.0,6,9,-3
ES,AD,2020.0,1,1,0
CZ,CH,2017.0,46,36,10
nan,SI,2009.0,1,4,-3
SE,ES,1997.0,11,12,-1
TZ,FR,2015.0,4,2,2
ET,MY,2010.0,1,1,0
MA,nan,2022.0,2,3,-1
CN,QA,2009.0,14,18,-4
EG,MA,2018.0,9,10,-1
CH,GH,2021.0,1,4,-3
SI,IT,2014.0,13,11,2
NZ,CY,2014.0,1,1,0
BW,US,2019.0,17,15,2
FI,RO,1997.0,3,1,2
IL,EE,2020.0,1,2,-1
NG,PK,2016.0,8,11,-3
CN,IT,2022.0,57,40,17
LK,BR,2014.0,2,1,1
CN,PT,2004.0,8,9,-1
JP,PH,2004.0,11,7,4
IL,GB,2006.0,44,35,9
PH,TW,2017.0,8,12,-4
IN,IQ,2019.0,29,13,16
SI,BE,2022.0,7,3,4
LT,GB,2021.0,6,6,0
KZ,CN,2020.0,14,9,5
KE,UG,2021.0,8,17,-9
AR,AU,2006.0,3,4,-1
AU,ES,2013.0,40,63,-23
GB,LV,2015.0,2,5,-3
CG,PK,2022.0,3,11,-8
SA,KW,2021.0,23,24,-1
BE,IL,2016.0,7,4,3
KW,JO,2021.0,5,9,-4
NL,KE,2022.0,7,5,2
US,EE,2014.0,6,21,-15
BR,EC,2020.0,56,41,15
DE,MX,2010.0,35,37,-2
BR,CR,2021.0,9,13,-4
BE,TH,2020.0,4,2,2
BW,ZA,2018.0,8,23,-15
CO,IL,2016.0,2,2,0
QA,SE,2005.0,6,5,1
PH,PL,1998.0,7,5,2
AU,DE,2006.0,115,158,-43
AR,PK,2011.0,15,14,1
SA,FR,2019.0,18,62,-44
nan,CA,2010.0,32,29,3
MY,TH,2020.0,11,11,0
ES,RU,2017.0,25,30,-5
TW,TR,2015.0,4,5,-1
GB,PK,2000.0,14,14,0
CZ,SK,1998.0,20,24,-4
RU,TW,2009.0,20,23,-3
CA,TR,2011.0,21,21,0
IT,MY,2001.0,35,29,6
MA,SA,2021.0,12,11,1
AZ,ID,2016.0,12,4,8
CN,CH,2021.0,60,84,-24
TW,KR,1998.0,7,6,1
FR,PK,2015.0,21,20,1
UY,MX,2012.0,6,8,-2
BR,SA,2019.0,7,6,1
TW,DE,2006.0,9,21,-12
BH,ET,2017.0,5,17,-12
BR,AO,2003.0,13,3,10
CA,TH,2014.0,18,11,7
TH,GB,2011.0,18,74,-56
RO,GB,2005.0,8,9,-1
IT,AZ,2008.0,2,1,1
DK,CA,2013.0,33,33,0
nan,IL,2011.0,17,12,5
RE,FR,2012.0,21,38,-17
FR,GR,2009.0,29,46,-17
PA,MX,2018.0,9,15,-6
PS,GB,2022.0,4,3,1
IR,ZA,2016.0,9,4,5
CY,RU,2019.0,3,2,1
US,UY,2015.0,26,17,9
NO,LU,2008.0,1,1,0
SE,NL,2010.0,41,47,-6
TH,FR,2013.0,16,29,-13
CZ,RU,2008.0,27,43,-16
OM,JP,2011.0,1,1,0
BE,TR,2013.0,15,10,5
RO,DE,2004.0,25,17,8
MK,GR,2011.0,7,11,-4
OM,CA,2013.0,6,12,-6
CZ,CH,2019.0,38,41,-3
US,MA,2019.0,30,24,6
AU,SA,1998.0,4,1,3
CZ,CA,2016.0,17,21,-4
IR,SE,2004.0,2,5,-3
BG,RS,2005.0,2,3,-1
UA,FR,2015.0,19,12,7
PT,NZ,2017.0,5,2,3
BE,CD,2014.0,18,1,17
NZ,CH,2014.0,18,10,8
CZ,DE,2000.0,14,25,-11
IT,HR,2018.0,11,5,6
SE,IS,2009.0,13,17,-4
NI,US,2004.0,1,2,-1
US,SV,2010.0,2,2,0
SE,UG,2014.0,8,3,5
CA,SI,2008.0,5,3,2
CN,DK,2010.0,30,29,1
MA,ZA,2022.0,2,1,1
SE,PT,2020.0,14,20,-6
MT,GB,1997.0,3,1,2
US,ZW,2011.0,6,7,-1
BE,RU,2003.0,13,15,-2
GB,SG,1999.0,30,17,13
CH,IR,2012.0,11,28,-17
KE,GB,2015.0,28,34,-6
RS,IT,2011.0,4,6,-2
RU,RS,2013.0,5,4,1
IL,CH,2002.0,8,16,-8
LY,DE,2008.0,1,1,0
PT,IR,2022.0,5,12,-7
NO,DK,2009.0,66,67,-1
US,KE,2004.0,27,25,2
GM,GB,2016.0,6,20,-14
IT,LB,2021.0,13,14,-1
PL,CH,2003.0,10,10,0
AR,IT,2010.0,62,86,-24
BJ,DE,2018.0,1,5,-4
TR,ES,2022.0,11,8,3
MY,ES,2015.0,5,6,-1
nan,PT,2011.0,31,26,5
SE,TW,2010.0,4,6,-2
AT,HR,2014.0,4,11,-7
MY,IR,2010.0,25,52,-27
PL,JP,2000.0,12,16,-4
LB,IT,2012.0,11,18,-7
AM,FR,2018.0,4,2,2
RS,CA,2019.0,10,10,0
GR,MK,2011.0,11,7,4
NZ,DK,2001.0,3,1,2
DE,CO,2017.0,40,33,7
JP,SA,2005.0,6,5,1
MK,CN,2002.0,3,2,1
CU,AR,2008.0,10,19,-9
ET,IN,2016.0,15,37,-22
NZ,IN,1998.0,4,4,0
HN,ES,2000.0,5,4,1
ES,CR,2008.0,27,12,15
SE,FR,2000.0,30,38,-8
KE,DK,2014.0,4,1,3
UY,ES,2012.0,32,35,-3
RS,TR,2000.0,12,15,-3
PE,CR,2018.0,12,11,1
GR,CH,2017.0,40,21,19
NL,PT,2012.0,24,29,-5
NZ,SG,2005.0,5,5,0
NL,IL,1997.0,4,5,-1
LK,ES,2012.0,5,6,-1
CA,PH,2016.0,12,13,-1
MY,TR,2021.0,15,3,12
MW,NG,2020.0,2,1,1
FR,CU,2003.0,2,5,-3
SG,PL,2009.0,2,3,-1
JO,OM,2015.0,5,1,4
TW,KR,1997.0,5,4,1
OM,NG,2018.0,1,4,-3
AU,AE,2000.0,1,1,0
NO,FI,2010.0,13,16,-3
MN,CN,2018.0,2,6,-4
PT,PY,2001.0,2,1,1
SE,TW,2019.0,6,12,-6
AT,CO,2013.0,4,2,2
CA,LK,2008.0,3,4,-1
ZA,BE,2010.0,13,9,4
DK,CO,2020.0,4,3,1
BJ,US,2015.0,7,4,3
GB,DZ,2009.0,4,7,-3
SE,TR,1998.0,1,1,0
RO,HU,2004.0,15,17,-2
DE,CY,2021.0,7,6,1
CH,EG,2018.0,8,7,1
IT,SI,2017.0,16,17,-1
SG,CH,2016.0,19,13,6
AR,CN,2007.0,2,5,-3
MK,CN,2005.0,3,5,-2
MY,AU,2005.0,13,12,1
IN,BG,2022.0,1,3,-2
MY,CN,2002.0,8,5,3
GB,BY,2016.0,2,1,1
VN,NL,2009.0,4,4,0
RW,TZ,2018.0,2,1,1
IL,HU,2014.0,2,6,-4
ES,PL,2022.0,11,14,-3
GB,ZW,2009.0,3,7,-4
AE,SG,2011.0,2,3,-1
MX,KE,2020.0,2,2,0
ZA,SN,2021.0,3,5,-2
IN,LY,2012.0,3,4,-1
MZ,UA,2001.0,1,1,0
RS,VN,2018.0,2,1,1
CH,IL,2000.0,6,7,-1
JP,MN,2021.0,6,4,2
IT,SI,2019.0,11,18,-7
MM,SG,2021.0,7,2,5
AU,PG,2022.0,4,6,-2
DK,ID,2022.0,5,2,3
ES,ZA,2008.0,2,4,-2
CN,KP,2017.0,6,5,1
AU,JO,2020.0,18,4,14
IR,ET,2021.0,3,1,2
nan,MA,2017.0,10,2,8
TN,RU,2017.0,4,1,3
TN,RU,2010.0,4,5,-1
UZ,RU,2019.0,31,57,-26
FI,NL,2009.0,40,43,-3
RO,GB,2002.0,15,3,12
PA,JP,2012.0,2,2,0
AU,FI,2022.0,5,8,-3
NG,CA,2008.0,6,5,1
KR,NO,2007.0,2,4,-2
RU,UA,1999.0,53,66,-13
MY,PK,2008.0,11,7,4
GR,BE,2019.0,35,31,4
AR,PE,2022.0,23,27,-4
PL,IR,2017.0,3,4,-1
CN,CL,2008.0,6,1,5
JM,GB,2016.0,7,4,3
CM,CA,2016.0,4,2,2
GB,ET,2006.0,3,1,2
US,CW,2015.0,2,2,0
ES,AO,2016.0,3,2,1
RO,BE,2019.0,13,16,-3
IN,SA,2001.0,5,8,-3
BE,JP,2002.0,22,19,3
FI,LU,2020.0,4,1,3
GB,HU,2004.0,27,43,-16
CH,IS,2000.0,1,1,0
IT,PE,2014.0,6,1,5
DK,NL,2003.0,12,22,-10
ES,TN,2016.0,13,6,7
FI,IR,2016.0,7,15,-8
ZA,SA,2018.0,8,5,3
RS,CA,2017.0,11,9,2
NO,SG,2020.0,3,7,-4
HU,EG,2017.0,5,6,-1
FI,RU,2001.0,7,25,-18
GB,SS,2012.0,7,6,1
FI,TR,2012.0,5,11,-6
CZ,NL,2020.0,16,15,1
IT,TR,2009.0,17,12,5
CA,AT,2014.0,26,26,0
FR,LK,2014.0,4,1,3
SE,SK,2002.0,4,2,2
AT,UA,2009.0,5,6,-1
QA,SE,2002.0,3,1,2
FR,CG,2011.0,18,18,0
HU,CZ,2015.0,12,5,7
CA,PE,2016.0,6,3,3
TR,AT,2015.0,11,7,4
DK,QA,2015.0,2,2,0
CZ,BE,2005.0,3,3,0
UG,KE,2007.0,2,1,1
JP,MX,2016.0,13,6,7
BE,KE,2003.0,3,5,-2
SA,SE,1997.0,5,1,4
JP,IR,2007.0,18,14,4
JO,CA,2009.0,1,7,-6
CN,BW,2016.0,1,2,-1
MY,VN,2021.0,5,7,-2
IT,IN,2004.0,28,52,-24
nan,CZ,1999.0,4,4,0
BG,RO,2012.0,5,1,4
LV,UA,2017.0,3,2,1
HR,SI,2016.0,22,27,-5
SE,ZA,2008.0,11,8,3
FI,CN,2000.0,9,7,2
UY,IT,2001.0,1,2,-1
MT,GB,1998.0,3,1,2
BE,ES,2004.0,25,23,2
BE,MA,2008.0,6,2,4
BW,US,2010.0,9,3,6
IL,RU,2006.0,25,24,1
NO,GR,2005.0,2,1,1
NZ,CL,2008.0,1,2,-1
SE,LK,2011.0,4,1,3
AU,FJ,2010.0,4,5,-1
ES,ID,2011.0,13,9,4
PL,LT,2007.0,3,3,0
HU,JP,2004.0,7,7,0
CD,CM,2019.0,2,1,1
BG,DE,1998.0,16,10,6
TZ,US,2000.0,5,4,1
KW,GB,2001.0,4,9,-5
US,NC,2009.0,2,1,1
TR,RS,2002.0,28,23,5
FI,SA,2015.0,5,1,4
AT,IN,2000.0,16,2,14
BE,SG,2008.0,3,1,2
NZ,CO,2017.0,3,2,1
MX,SV,2012.0,3,3,0
MY,FI,2019.0,4,1,3
BR,IN,2021.0,25,16,9
CN,IL,1999.0,13,4,9
VE,CL,2014.0,24,14,10
SE,ES,1998.0,12,16,-4
DE,UY,2007.0,1,2,-1
LB,DK,2017.0,2,1,1
SE,IE,2009.0,13,6,7
SA,KR,2019.0,10,27,-17
DK,IN,2011.0,13,11,2
FR,GF,2013.0,21,10,11
BE,IN,2007.0,5,6,-1
BR,SG,2012.0,1,1,0
GB,PS,2015.0,6,3,3
IE,NZ,2005.0,4,7,-3
SA,QA,1998.0,1,3,-2
CO,PA,2016.0,13,18,-5
MX,BO,2008.0,5,4,1
PH,TW,2010.0,4,4,0
CO,CH,2016.0,13,13,0
NO,RU,2012.0,15,18,-3
ES,IL,2012.0,10,7,3
HU,AU,2007.0,9,9,0
CA,EG,2001.0,12,3,9
UG,AU,2001.0,1,1,0
CW,NL,2006.0,5,9,-4
SE,CO,2011.0,5,4,1
TW,AR,2010.0,9,10,-1
ML,FR,2016.0,10,9,1
IT,FI,2008.0,13,13,0
CH,KR,2018.0,11,21,-10
KR,CO,2015.0,3,6,-3
AE,EG,2000.0,6,6,0
IL,AU,2021.0,18,15,3
CU,CL,2001.0,7,7,0
CH,nan,2007.0,14,8,6
BD,FR,2005.0,2,4,-2
CA,HU,2010.0,9,12,-3
KR,GR,2016.0,7,1,6
PT,TN,2018.0,3,6,-3
CL,CA,2004.0,11,7,4
TN,LB,2019.0,3,3,0
BE,JP,2005.0,16,14,2
RS,CA,2010.0,6,9,-3
SK,RU,2011.0,17,11,6
ID,MX,2012.0,1,2,-1
EG,NL,2016.0,5,12,-7
NG,FR,2012.0,3,5,-2
TH,IT,2007.0,4,5,-1
DK,MK,2016.0,2,1,1
TW,nan,2007.0,3,9,-6
IR,CN,2007.0,11,14,-3
BT,LK,2019.0,2,2,0
LT,SE,2018.0,9,4,5
LB,GB,2015.0,8,18,-10
EG,IT,2004.0,2,5,-3
BG,CN,2013.0,10,19,-9
BH,IN,2017.0,3,3,0
ID,IE,2022.0,6,1,5
PT,MZ,2009.0,3,4,-1
CZ,TR,2019.0,7,7,0
EC,IT,2018.0,5,10,-5
SL,US,2019.0,5,6,-1
KR,MM,2015.0,2,1,1
SY,JO,2017.0,2,2,0
KE,SE,2021.0,9,3,6
BW,US,2017.0,13,14,-1
KR,PR,2016.0,28,42,-14
IT,SI,2010.0,7,9,-2
IN,FJ,2018.0,5,7,-2
PT,NO,2022.0,3,4,-1
BE,CL,2020.0,12,6,6
SK,AU,2014.0,5,2,3
RS,XK,2009.0,5,3,2
SE,RW,2015.0,1,2,-1
nan,VG,2011.0,2,1,1
BG,UA,2002.0,5,4,1
TW,AR,2017.0,7,11,-4
CG,NC,2020.0,3,1,2
PE,UY,2020.0,6,5,1
PK,CL,2020.0,2,1,1
CZ,NO,2001.0,3,5,-2
CZ,RO,2020.0,3,6,-3
MY,EG,1998.0,2,1,1
DE,TN,2016.0,6,8,-2
PH,ID,2022.0,3,2,1
CO,PT,2015.0,23,13,10
TW,SA,2019.0,7,6,1
JO,MY,2020.0,17,35,-18
PA,ES,2018.0,17,14,3
IL,RS,2004.0,3,4,-1
NZ,NL,2020.0,13,18,-5
IE,CH,2009.0,7,14,-7
SA,BR,2020.0,8,2,6
CR,BR,2015.0,19,12,7
DK,IS,2018.0,8,3,5
FI,AU,2000.0,3,3,0
AT,CH,2002.0,47,58,-11
SA,KR,2010.0,2,9,-7
ES,SN,2015.0,1,1,0
CH,BG,2020.0,6,3,3
BE,TW,2003.0,2,1,1
US,SV,2019.0,5,3,2
NL,TW,2021.0,7,8,-1
FI,CH,2015.0,25,15,10
MY,LK,2005.0,1,1,0
LU,BE,2005.0,5,9,-4
KE,FR,2022.0,1,3,-2
AE,HU,2013.0,1,5,-4
SE,NG,2014.0,1,2,-1
SK,RS,2001.0,12,5,7
VN,NZ,2019.0,5,6,-1
MW,BW,2006.0,1,1,0
PL,BY,2004.0,2,5,-3
FR,CI,2003.0,8,7,1
SG,NO,2006.0,6,3,3
SE,TW,2017.0,3,6,-3
ES,FI,2002.0,4,2,2
ZA,OM,2014.0,1,2,-1
LU,US,2009.0,14,20,-6
CM,DE,2016.0,4,4,0
PG,AU,2011.0,5,5,0
ES,NZ,2009.0,3,2,1
LB,AE,2018.0,10,3,7
UA,BE,2020.0,5,2,3
DK,JP,1999.0,9,4,5
AR,RU,2018.0,5,1,4
NG,MY,2011.0,10,10,0
BG,NL,2013.0,3,5,-2
UG,FR,2016.0,8,7,1
NO,BA,2015.0,1,2,-1
KR,EG,2013.0,7,6,1
AL,US,2015.0,5,8,-3
EE,SE,2007.0,8,8,0
KE,ID,2015.0,8,1,7
nan,MX,2001.0,9,7,2
nan,PL,2002.0,5,2,3
ID,SG,2010.0,4,6,-2
VN,RO,2016.0,5,5,0
NZ,ZA,2009.0,8,12,-4
AU,KH,2019.0,5,3,2
US,HK,2001.0,2,1,1
IT,VE,2019.0,6,4,2
VE,UY,2012.0,4,5,-1
IN,ES,2000.0,3,6,-3
IR,CZ,2013.0,3,2,1
FR,MC,2005.0,6,2,4
US,LR,2015.0,3,2,1
BR,CO,1998.0,4,4,0
LU,BE,2002.0,6,5,1
PL,MZ,2006.0,3,8,-5
SK,FR,2007.0,6,9,-3
BG,UA,2005.0,5,5,0
JP,SA,2002.0,2,2,0
LB,SE,2020.0,2,1,1
MX,MY,2021.0,1,2,-1
HR,CA,2003.0,2,1,1
TN,LB,2017.0,2,3,-1
PK,SE,2013.0,12,15,-3
RO,CA,2022.0,10,10,0
NO,TW,2017.0,4,6,-2
CL,MA,2022.0,2,1,1
IL,QA,2019.0,1,1,0
IE,AT,2014.0,11,6,5
CR,IL,2021.0,2,2,0
VE,BO,2009.0,2,1,1
FR,SC,2013.0,1,1,0
CA,HR,2018.0,1,6,-5
US,SN,2014.0,12,8,4
BE,CG,2014.0,1,1,0
AU,ZW,2007.0,1,2,-1
SG,UA,2018.0,2,1,1
BE,LU,2001.0,9,3,6
AE,GB,2013.0,19,45,-26
IQ,IE,2018.0,3,4,-1
RO,NL,2018.0,7,12,-5
CZ,JO,2019.0,1,1,0
CN,MA,2013.0,1,1,0
CA,CL,2003.0,3,8,-5
BG,TR,2020.0,2,1,1
IN,MA,2021.0,6,4,2
LT,FR,2022.0,1,4,-3
TZ,NG,2018.0,4,1,3
SV,CU,2010.0,1,1,0
IT,TW,2020.0,5,10,-5
nan,IQ,2022.0,2,1,1
JP,NO,2007.0,9,8,1
NO,ET,2008.0,6,3,3
TH,DK,2015.0,1,2,-1
LV,UA,2019.0,5,4,1
PL,HR,2020.0,3,5,-2
NO,IS,2011.0,5,11,-6
IN,IQ,2010.0,6,2,4
MY,TN,2016.0,4,5,-1
nan,GR,2002.0,2,1,1
SG,AU,2023.0,7,5,2
BH,TW,2012.0,2,5,-3
EE,PK,2012.0,1,1,0
PL,GR,2002.0,2,4,-2
XK,nan,2019.0,1,1,0
JP,CO,2015.0,7,7,0
SI,MX,2019.0,5,6,-1
BO,GB,2019.0,2,2,0
SE,UY,2022.0,1,1,0
SI,AU,2005.0,1,2,-1
NZ,KR,2007.0,7,2,5
CH,QA,2018.0,2,2,0
CH,IN,2000.0,12,9,3
CM,IT,2015.0,4,1,3
VG,US,2013.0,4,14,-10
GB,CL,2007.0,15,25,-10
EC,CU,2008.0,1,2,-1
GB,QA,2008.0,6,3,3
LB,IQ,2022.0,3,3,0
CA,SN,2018.0,9,4,5
IT,BA,2007.0,1,1,0
CH,SK,1999.0,5,3,2
SA,PK,2000.0,12,6,6
RO,SI,2012.0,1,1,0
TN,MD,2008.0,6,6,0
CD,JP,2015.0,1,1,0
CZ,ES,2008.0,10,11,-1
ZA,BW,2008.0,2,7,-5
QA,BE,2015.0,1,2,-1
SG,ES,2022.0,5,5,0
NO,CZ,2004.0,2,9,-7
SL,US,2010.0,1,2,-1
MY,CA,2010.0,16,25,-9
TH,BE,2006.0,3,1,2
US,UA,2001.0,15,46,-31
CA,NG,2009.0,1,2,-1
HU,IN,2014.0,3,5,-2
IT,EE,2017.0,10,5,5
DZ,DE,2008.0,3,3,0
PH,KR,2000.0,3,1,2
RS,LY,2014.0,2,1,1
GB,VG,2013.0,9,7,2
AT,SI,2007.0,9,3,6
KZ,JP,2016.0,2,3,-1
EC,AU,2011.0,2,1,1
ME,RS,2003.0,2,3,-1
IT,SG,2009.0,5,3,2
MY,AU,2002.0,8,5,3
AU,IS,2019.0,3,2,1
KR,BE,2000.0,2,1,1
BE,RS,2016.0,4,9,-5
RU,SK,2004.0,4,7,-3
JP,PK,2012.0,10,6,4
LY,CN,2018.0,1,1,0
DE,BY,2011.0,2,8,-6
BB,JM,1998.0,3,1,2
BE,BJ,2011.0,5,1,4
ES,TR,2007.0,5,8,-3
PK,nan,2006.0,5,2,3
XK,RS,2009.0,3,5,-2
JP,FI,1998.0,8,8,0
KR,PH,2011.0,3,7,-4
CA,LB,2002.0,3,5,-2
GR,AU,2000.0,1,6,-5
RU,AZ,2005.0,1,2,-1
PT,MA,2005.0,1,2,-1
GB,SY,2001.0,1,3,-2
NL,SI,2016.0,5,7,-2
CM,KE,2020.0,1,2,-1
CM,CD,2016.0,2,3,-1
EG,LY,2022.0,4,3,1
UA,CA,2021.0,4,2,2
EG,LK,2014.0,1,1,0
SN,CM,2018.0,3,2,1
FI,BE,2015.0,7,10,-3
MX,PL,2016.0,13,7,6
BD,PL,2020.0,4,5,-1
SE,RO,2015.0,5,7,-2
PH,JP,1999.0,2,10,-8
SA,BH,2022.0,8,7,1
TN,IN,2017.0,3,4,-1
PK,SO,2022.0,1,1,0
BH,IN,2010.0,2,1,1
US,BI,2016.0,2,8,-6
EC,BR,2006.0,3,5,-2
FI,ZA,2020.0,4,10,-6
TW,IE,2015.0,3,3,0
IR,TR,2008.0,1,7,-6
FI,SI,2015.0,2,3,-1
BN,PK,2012.0,1,2,-1
AU,BE,2002.0,17,16,1
BY,NL,2009.0,2,1,1
BR,LB,2010.0,3,4,-1
TW,SE,2004.0,2,4,-2
IN,CO,2016.0,5,4,1
IL,CL,2022.0,4,3,1
VN,GB,2003.0,5,4,1
AF,JP,2020.0,3,6,-3
IT,PH,2003.0,6,2,4
IE,NZ,2002.0,5,5,0
NC,FR,1998.0,6,3,3
DE,DZ,2013.0,6,1,5
CN,LK,2008.0,1,2,-1
SA,FI,2017.0,2,2,0
BR,TW,2011.0,2,3,-1
OM,SA,2022.0,6,6,0
US,LT,2021.0,8,11,-3
TR,AZ,2021.0,11,13,-2
TW,AR,2019.0,2,8,-6
FR,EC,2011.0,5,7,-2
US,GA,1999.0,1,1,0
KE,TN,2013.0,1,1,0
IN,KE,2012.0,5,4,1
DZ,TR,2015.0,3,1,2
SK,CA,2017.0,5,3,2
KR,UA,2014.0,1,4,-3
BO,FR,2005.0,2,3,-1
US,XK,2013.0,1,1,0
GE,CZ,2002.0,1,1,0
PH,TW,2019.0,14,3,11
IT,EE,2019.0,7,8,-1
PL,PK,2011.0,2,4,-2
JP,ZM,2021.0,4,4,0
NO,SE,2023.0,5,9,-4
PE,DE,2006.0,1,3,-2
US,MA,2010.0,10,16,-6
GE,DE,2012.0,4,4,0
AM,DE,1999.0,4,3,1
ES,SV,2013.0,5,2,3
HR,FR,2001.0,3,1,2
NL,MX,2001.0,2,2,0
PL,GR,2005.0,2,5,-3
CG,US,2009.0,2,3,-1
EG,JO,2009.0,5,5,0
BR,nan,1999.0,7,5,2
GP,MQ,2010.0,1,1,0
BH,IN,2019.0,5,18,-13
IT,LV,2018.0,1,3,-2
IE,TR,2003.0,2,2,0
LU,CA,2014.0,4,5,-1
ID,TR,2008.0,2,3,-1
HR,DE,1999.0,7,14,-7
CY,FR,2015.0,2,3,-1
NZ,SG,2002.0,3,4,-1
IL,PT,2020.0,2,1,1
BR,GR,2011.0,2,4,-2
DE,SG,2023.0,2,5,-3
AT,DK,1998.0,1,2,-1
MX,NI,2013.0,4,2,2
BO,FR,2002.0,2,1,1
AU,SA,1997.0,2,4,-2
ZA,DK,2003.0,2,5,-3
nan,MA,2019.0,7,13,-6
EG,RU,2002.0,1,1,0
CH,MX,2006.0,2,7,-5
GB,HR,2007.0,4,9,-5
CZ,BE,2002.0,4,4,0
GB,GH,2003.0,3,2,1
JP,KH,1998.0,1,2,-1
GR,EG,2007.0,1,3,-2
AT,DK,1997.0,1,1,0
IT,UG,2014.0,5,2,3
UA,EC,2022.0,6,4,2
IN,HU,2016.0,3,7,-4
FJ,GB,2007.0,1,1,0
BR,SA,2017.0,3,8,-5
KR,KE,2018.0,1,2,-1
DE,GA,2021.0,2,6,-4
CZ,SA,2019.0,4,1,3
KE,ZA,2007.0,5,6,-1
IN,FI,2004.0,4,2,2
IL,ZA,2021.0,4,2,2
BN,GB,2013.0,1,8,-7
QA,CA,2013.0,5,12,-7
SY,QA,2020.0,3,1,2
NO,JP,2011.0,4,16,-12
CA,BY,2004.0,1,1,0
FR,HR,2011.0,1,2,-1
NE,FR,2012.0,3,9,-6
RO,BE,2010.0,7,7,0
NL,PE,2013.0,3,1,2
GB,BS,2020.0,2,1,1
BR,CO,1997.0,1,4,-3
ET,MY,2017.0,3,4,-1
OM,AU,2006.0,2,1,1
SA,AT,2007.0,3,2,1
BH,PK,2018.0,2,1,1
nan,KE,2016.0,4,1,3
ML,SN,2017.0,3,4,-1
LT,FI,2018.0,1,7,-6
LB,DK,2019.0,1,3,-2
BR,LV,2019.0,2,1,1
TN,RU,2019.0,2,7,-5
MY,AT,2014.0,4,5,-1
SE,BO,2017.0,2,1,1
CU,UY,2013.0,3,1,2
VE,JP,2013.0,1,4,-3
XK,HR,2018.0,3,3,0
ET,DE,2018.0,7,19,-12
PH,NG,2020.0,3,3,0
DE,ZW,2019.0,2,1,1
HU,PK,2020.0,3,5,-2
BO,CL,2019.0,6,4,2
SI,MX,2010.0,2,3,-1
CZ,UZ,2008.0,2,2,0
BO,CL,2010.0,4,9,-5
US,MT,2000.0,1,2,-1
CM,GH,2016.0,3,1,2
ES,CZ,2003.0,3,1,2
CL,UA,2005.0,2,1,1
CI,US,2007.0,1,1,0
JP,MW,2018.0,2,2,0
ML,US,2004.0,2,7,-5
CA,UA,2013.0,4,5,-1
JO,PK,2018.0,2,4,-2
IR,GB,1999.0,2,18,-16
MX,PA,1999.0,2,2,0
BG,IE,2018.0,1,5,-4
NL,EC,2019.0,3,5,-2
CM,GB,2015.0,3,5,-2
RU,VN,2000.0,2,1,1
AE,NZ,2023.0,1,2,-1
AT,BG,2020.0,1,5,-4
LU,JP,2022.0,1,1,0
SE,PA,2004.0,1,2,-1
HK,RS,2010.0,2,1,1
DE,IS,2016.0,4,7,-3
VE,NL,2005.0,1,2,-1
MY,FI,2017.0,4,1,3
IT,MT,2021.0,4,2,2
AU,RS,2022.0,3,5,-2
AR,GT,2020.0,4,2,2
EG,SE,2006.0,1,2,-1
SA,IT,2006.0,1,1,0
BR,LB,2017.0,3,4,-1
IN,ID,2007.0,1,1,0
PT,HU,2007.0,1,3,-2
US,MK,2011.0,7,6,1
XK,AT,2018.0,3,2,1
CO,CZ,2020.0,4,2,2
SK,GE,2009.0,2,1,1
AE,IT,2007.0,1,1,0
ES,BD,2000.0,2,3,-1
ID,CO,2022.0,2,1,1
MX,DK,2011.0,2,3,-1
IQ,DE,2021.0,6,9,-3
MY,CH,2012.0,3,7,-4
FR,TD,2013.0,1,1,0
AU,AT,1998.0,1,2,-1
ID,HU,2014.0,3,6,-3
RW,FR,2019.0,1,2,-1
ML,IN,1998.0,2,5,-3
JP,ET,2014.0,3,2,1
NZ,IN,1997.0,3,2,1
IE,AR,2020.0,3,8,-5
AR,IR,2011.0,1,1,0
VN,IT,2001.0,2,1,1
KE,IT,2013.0,2,2,0
JP,CL,2018.0,4,5,-1
AL,RO,2017.0,1,1,0
AF,MX,2016.0,4,4,0
ZA,HK,2007.0,1,1,0
IN,QA,2004.0,2,1,1
BH,ZW,2018.0,2,4,-2
SK,PK,2016.0,1,1,0
TN,IN,2010.0,2,2,0
VN,GH,2014.0,1,1,0
FR,LT,2009.0,2,2,0
BR,PH,2009.0,1,3,-2
ET,DK,2000.0,1,1,0
TN,TR,2014.0,2,2,0
TZ,UG,2018.0,3,3,0
BY,LV,2020.0,1,1,0
PK,EG,2004.0,2,1,1
IN,PT,2004.0,7,1,6
NG,NL,2008.0,2,3,-1
UA,TW,2001.0,2,1,1
HT,CA,2011.0,1,1,0
UA,AR,2017.0,2,1,1
PH,BE,2018.0,2,2,0
IT,RO,1999.0,2,5,-3
TH,TR,2000.0,1,1,0
FR,TW,2022.0,2,8,-6
AM,CH,2018.0,1,1,0
CR,RU,2022.0,3,2,1
GP,MQ,2019.0,2,1,1
ES,BY,2017.0,1,1,0
GR,JP,2023.0,1,1,0
UY,CL,2006.0,3,4,-1
BR,DK,1999.0,2,3,-1
DE,BI,2016.0,1,1,0
RS,LV,2016.0,1,1,0
PT,PE,2012.0,2,1,1
GB,SC,2008.0,1,1,0
MD,DE,2009.0,2,1,1
JP,LU,2011.0,2,1,1
BE,EG,2001.0,1,2,-1
DZ,GB,2006.0,2,8,-6
TR,HU,2014.0,3,2,1
CA,EC,2012.0,3,1,2
AO,IT,2006.0,1,1,0
US,FM,2020.0,1,1,0
QA,IN,2023.0,1,2,-1
VN,DK,2018.0,2,3,-1
DE,BJ,2004.0,1,1,0
TW,KZ,2010.0,1,1,0
KW,AU,2000.0,1,1,0
DK,LV,2017.0,1,2,-1
NC,BJ,2019.0,1,1,0
FI,MY,2021.0,2,3,-1
FI,NZ,2014.0,2,3,-1
TR,KG,2011.0,1,1,0
BR,SI,2015.0,1,4,-3
ME,US,2022.0,1,3,-2
PK,SN,2016.0,1,1,0
IN,JO,2015.0,2,1,1
UA,MZ,2009.0,2,2,0
KE,SD,2001.0,2,2,0
GM,DE,2001.0,1,1,0
GB,MD,2018.0,2,4,-2
IN,BY,2012.0,2,5,-3
PK,IE,2023.0,2,1,1
IE,MX,1998.0,2,1,1
US,BM,2010.0,1,2,-1
BY,PL,2006.0,2,4,-2
SE,GR,2023.0,1,1,0
CN,TN,2019.0,2,8,-6
CA,LB,2005.0,3,2,1
AT,SG,2021.0,3,4,-1
MX,KR,2003.0,2,2,0
SE,BO,2010.0,2,2,0
ID,VE,2009.0,1,6,-5
ID,DE,2001.0,1,4,-3
PL,SI,2014.0,2,7,-5
ES,FI,2005.0,4,7,-3
LK,SE,2011.0,1,4,-3
ZM,MY,2019.0,1,3,-2
AT,PT,2001.0,2,1,1
ZM,JP,2011.0,1,1,0
IT,GT,2012.0,1,1,0
IN,TR,1999.0,2,1,1
ES,BR,2019.0,442,435,7
ZA,KE,2003.0,7,5,2
IN,GB,2018.0,593,590,3
DE,DK,2005.0,75,63,12
AU,AT,1997.0,4,4,0
GB,CA,2010.0,802,809,-7
KR,nan,2022.0,19,10,9
GB,PT,2007.0,59,52,7
ES,PT,2006.0,81,73,8
CA,JP,2007.0,109,110,-1
GB,RU,2000.0,50,74,-24
FI,JP,1999.0,8,7,1
IT,FR,2014.0,415,331,84
NL,GB,2005.0,192,163,29
CH,BE,2010.0,59,64,-5
EG,GB,2019.0,104,131,-27
US,SA,2016.0,232,161,71
DE,CO,2019.0,31,67,-36
NO,FI,2017.0,15,31,-16
US,NZ,2003.0,230,224,6
PE,CO,2013.0,47,70,-23
DK,NO,2012.0,93,57,36
IE,CA,2003.0,61,55,6
AU,IN,2008.0,62,93,-31
CZ,TR,2017.0,10,5,5
AU,IR,2012.0,35,90,-55
CN,ES,2008.0,43,32,11
BN,AU,2018.0,5,6,-1
PE,ES,2014.0,105,164,-59
SE,NL,2019.0,82,90,-8
SE,IL,2015.0,6,6,0
ZW,ZA,2018.0,55,46,9
SA,BD,2018.0,32,23,9
IE,GB,2012.0,340,342,-2
BD,PK,2021.0,31,37,-6
AU,FJ,2017.0,8,6,2
IT,CH,2006.0,176,138,38
QA,US,2018.0,88,77,11
CH,CN,2021.0,84,60,24
IT,SE,2019.0,105,74,31
IE,NL,2020.0,39,23,16
GR,CH,2019.0,42,20,22
US,MA,2017.0,22,19,3
DE,MX,2019.0,46,67,-21
KR,IT,2013.0,7,10,-3
SE,NL,2017.0,65,89,-24
EG,ID,2022.0,49,14,35
DE,CZ,2010.0,44,49,-5
nan,FR,2022.0,80,72,8
HU,FR,2022.0,9,8,1
IL,FR,2010.0,28,29,-1
SE,AU,2013.0,55,47,8
ES,GR,2011.0,15,14,1
CN,RO,2018.0,4,6,-2
NO,FI,2019.0,28,29,-1
GR,AT,2013.0,4,5,-1
NO,ES,2012.0,21,25,-4
CN,TZ,2014.0,5,1,4
BR,BE,2009.0,42,39,3
CH,BE,2019.0,76,101,-25
ET,SE,2001.0,4,4,0
TN,EG,2022.0,14,14,0
JP,AE,2012.0,6,1,5
nan,PL,2005.0,8,1,7
IT,AM,2015.0,17,28,-11
PL,SE,2001.0,21,9,12
IL,FR,2019.0,27,58,-31
AR,UY,2009.0,27,24,3
FR,IE,2002.0,7,12,-5
UZ,KZ,2021.0,9,14,-5
ML,GN,2021.0,3,1,2
PE,DO,2022.0,2,3,-1
HU,IQ,2022.0,4,6,-2
DE,HR,2015.0,19,31,-12
CH,ML,2020.0,4,2,2
RU,LT,2013.0,15,6,9
JO,US,1999.0,8,16,-8
RS,ME,2020.0,17,17,0
GB,FI,2001.0,25,26,-1
JO,EG,2016.0,20,13,7
US,LV,2008.0,6,3,3
NZ,JP,2008.0,9,18,-9
DZ,US,2013.0,21,19,2
ES,HT,2013.0,1,1,0
CN,AT,2001.0,7,7,0
GB,GD,2012.0,3,2,1
SK,IN,2009.0,1,1,0
IT,GR,2009.0,21,10,11
BA,DE,2018.0,6,9,-3
JP,FI,1997.0,6,8,-2
SA,OM,2013.0,4,4,0
RU,AU,2001.0,11,7,4
IL,NL,2015.0,11,14,-3
EC,CA,2015.0,5,1,4
ML,SN,2019.0,7,9,-2
VN,JP,2007.0,13,19,-6
GB,KE,2008.0,11,22,-11
PK,IQ,2016.0,3,2,1
BN,SG,2018.0,1,3,-2
ES,IE,2014.0,34,25,9
FR,IQ,2012.0,1,1,0
DE,SA,2007.0,7,5,2
DE,SD,2014.0,4,1,3
US,BW,2022.0,9,2,7
AT,BE,2013.0,20,14,6
AG,JP,2022.0,10,3,7
ID,FR,2006.0,8,5,3
HU,PL,1999.0,3,10,-7
KW,AE,2004.0,2,2,0
MY,CN,2005.0,24,23,1
TW,SA,2017.0,11,5,6
US,SV,2017.0,7,4,3
DZ,JO,2014.0,1,1,0
DK,PK,2014.0,4,1,3
IR,BO,2014.0,1,2,-1
FR,KR,2002.0,14,19,-5
IE,HR,2018.0,4,5,-1
TZ,DE,2008.0,2,1,1
AR,nan,2003.0,22,18,4
MY,IE,2022.0,3,1,2
nan,GB,1999.0,20,36,-16
PL,ES,2002.0,5,5,0
MZ,PT,2020.0,6,4,2
FR,IS,2013.0,6,2,4
PE,CL,2009.0,31,26,5
ES,AU,2003.0,18,11,7
CM,nan,2011.0,2,1,1
ID,SE,2006.0,1,2,-1
BE,MX,2022.0,6,4,2
AU,KH,2010.0,1,1,0
MX,GT,2011.0,13,2,11
FR,NC,2008.0,12,17,-5
PE,IT,2003.0,4,3,1
EG,CH,2012.0,6,4,2
IN,ML,2007.0,2,1,1
PL,TW,2009.0,2,3,-1
AU,UA,2015.0,1,3,-2
ZA,ET,2004.0,1,1,0
CU,DE,2020.0,4,6,-2
ZA,FI,2011.0,3,2,1
AF,BR,2019.0,1,2,-1
PE,FR,2012.0,3,6,-3
BG,IT,2006.0,1,4,-3
ID,LK,2012.0,6,3,3
FI,MX,2012.0,2,1,1
UG,nan,2018.0,2,1,1
ZW,OM,2021.0,1,2,-1
SI,TW,2005.0,2,2,0
CW,BE,2013.0,1,1,0
TN,IN,2019.0,2,3,-1
FI,BR,2011.0,4,5,-1
CL,PH,2012.0,3,3,0
JP,GR,2023.0,1,1,0
TN,GR,2014.0,1,1,0
LV,SE,2021.0,2,2,0
SE,CR,2010.0,1,1,0
BJ,IN,2021.0,2,2,0
BD,NG,2014.0,2,3,-1
NC,FR,1997.0,3,1,2
MU,AU,2018.0,2,1,1
AE,JO,2009.0,1,6,-5
MM,CN,2016.0,2,2,0
MM,JP,2016.0,3,12,-9
SK,CA,2010.0,2,5,-3
RU,GR,2016.0,2,2,0
GB,MQ,2001.0,1,1,0
NL,IL,1998.0,3,7,-4
JP,AU,2008.0,78,60,18
GB,AT,2021.0,122,80,42
DE,CA,2013.0,278,286,-8
JP,BE,2005.0,14,16,-2
FR,IE,2005.0,25,21,4
JP,RU,2003.0,51,39,12
TW,ID,2016.0,45,24,21
NG,KE,2020.0,5,12,-7
VN,CA,2018.0,14,14,0
ID,SG,2017.0,15,20,-5
TR,NO,2016.0,11,8,3
DE,RS,2014.0,17,24,-7
PK,TR,2009.0,6,8,-2
CA,AE,2023.0,1,1,0
LT,AT,2020.0,2,2,0
AM,MA,2021.0,1,1,0
PK,CN,1999.0,3,2,1
BH,IQ,2018.0,4,2,2
RU,AZ,2002.0,2,1,1
CL,AU,2004.0,3,1,2
,CL,2002.0,1324,0,1324
,AU,1994.0,16611,0,16611
GB,,2000.0,4980,0,4980
,SE,2007.0,4125,0,4125
NL,,2023.0,24037,0,24037
IL,,2021.0,3502,0,3502
JP,,2022.0,37376,0,37376
,CL,2005.0,1441,0,1441
,TW,2002.0,4574,0,4574
,GB,2019.0,8485,0,8485
,PT,2001.0,1139,0,1139
,NZ,2007.0,1135,0,1135
,TW,2005.0,4930,0,4930
,MY,2008.0,3008,0,3008
CN,,2009.0,13864,0,13864
CU,IL,2014.0,3,0,3
,GB,2010.0,18167,0,18167
,KR,2015.0,5038,0,5038
,ZA,2009.0,2448,0,2448
,GR,2004.0,2992,0,2992
PT,,2025.0,2054,0,2054
SG,,2009.0,375,0,375
,CR,2005.0,166,0,166
TR,,2012.0,1473,0,1473
,AR,2011.0,2750,0,2750
,DK,2005.0,1628,0,1628
,GR,1996.0,2013,0,2013
MY,,2011.0,344,0,344
US,BJ,2008.0,1,0,1
TW,,1998.0,398,0,398
PR,,2021.0,21,0,21
RO,,2016.0,1138,0,1138
SN,,2023.0,637,0,637
,EG,2014.0,4563,0,4563
HK,,2025.0,33,0,33
,GB,2017.0,14620,0,14620
,DK,2002.0,1403,0,1403
,ET,2014.0,855,0,855
,AM,2004.0,145,0,145
MY,AE,2006.0,5,0,5
,GH,1999.0,85,0,85
CU,PA,2001.0,1,0,1
US,SJ,2000.0,1,0,1
TZ,,2018.0,140,0,140
HR,UZ,2004.0,1,0,1
FI,,2011.0,1863,0,1863
,MK,2009.0,193,0,193
OM,,2021.0,244,0,244
,PA,1995.0,41,0,41
MX,SE,2000.0,1,0,1
,DZ,2011.0,1441,0,1441
,SN,2010.0,109,0,109
CI,,2019.0,229,0,229
NL,MN,2012.0,1,0,1
,JO,2014.0,430,0,430
,LV,2006.0,195,0,195
,KZ,2000.0,102,0,102
SD,,2012.0,39,0,39
AM,,2006.0,49,0,49
,BH,1996.0,44,0,44
CL,,1998.0,57,0,57
,CR,2002.0,141,0,141
,QA,2010.0,166,0,166
KW,,2025.0,54,0,54
MW,,2023.0,373,0,373
CY,,2022.0,479,0,479
EG,,2000.0,146,0,146
MG,,2023.0,288,0,288
,MT,2014.0,87,0,87
,OM,2013.0,216,0,216
BJ,,2021.0,142,0,142
UY,,2015.0,101,0,101
ZM,MY,2017.0,3,0,3
,PG,2003.0,14,0,14
,KG,2009.0,23,0,23
MA,CG,2020.0,1,0,1
,GE,1995.0,204,0,204
UZ,,2018.0,109,0,109
,AM,1996.0,125,0,125
,GT,2014.0,64,0,64
,MM,2010.0,18,0,18
IQ,,2019.0,271,0,271
,AZ,2001.0,100,0,100
IQ,,2017.0,103,0,103
CG,,2020.0,41,0,41
PE,,2006.0,39,0,39
,SN,2017.0,131,0,131
,NE,2014.0,70,0,70
,TT,2001.0,37,0,37
,KW,2001.0,135,0,135
,MM,2017.0,69,0,69
NI,nan,2021.0,2,0,2
SV,,2009.0,3,0,3
,CM,2000.0,106,0,106
,BH,2004.0,38,0,38
,ML,2009.0,46,0,46
CI,,2017.0,103,0,103
BI,BF,2013.0,1,0,1
ES,AF,2015.0,1,0,1
,LT,2000.0,355,0,355
DK,CL,2000.0,2,0,2
,QA,2017.0,449,0,449
,CI,2003.0,82,0,82
CA,LY,2005.0,1,0,1
AU,SL,2019.0,1,0,1
RE,,2021.0,55,0,55
NE,BE,2021.0,4,0,4
,SN,2019.0,37,0,37
IQ,,2010.0,23,0,23
,JM,1995.0,63,0,63
BR,LV,2017.0,1,0,1
,XK,2015.0,97,0,97
GE,,2006.0,54,0,54
,BN,2006.0,19,0,19
ZW,JP,2017.0,1,0,1
,QA,2019.0,331,0,331
,LY,2018.0,81,0,81
FO,,2025.0,3,0,3
FR,TG,2011.0,2,0,2
KE,NO,2007.0,2,0,2
BH,,2013.0,21,0,21
BH,SG,2016.0,2,0,2
IL,RO,1998.0,1,0,1
,RW,2012.0,90,0,90
UY,MY,2019.0,1,0,1
MD,AT,2015.0,1,0,1
,BO,1999.0,33,0,33
BI,RU,2016.0,1,0,1
LV,FR,2007.0,2,0,2
,BF,1994.0,43,0,43
CL,PL,2021.0,2,0,2
BN,SA,2019.0,1,0,1
MC,,2021.0,21,0,21
GR,IQ,2019.0,2,0,2
BJ,GB,2021.0,3,0,3
,TJ,2020.0,14,0,14
PY,US,2001.0,1,0,1
MX,,1998.0,114,0,114
GF,,2020.0,30,0,30
QA,TN,2007.0,1,0,1
LA,,2022.0,30,0,30
GD,,2012.0,5,0,5
LU,ID,2018.0,1,0,1
,HK,2020.0,6,0,6
CG,GB,2016.0,1,0,1
BE,SY,2006.0,4,0,4
NG,LS,2021.0,1,0,1
MC,DE,2016.0,1,0,1
,GM,2016.0,18,0,18
QA,MT,2020.0,3,0,3
ZW,DE,2022.0,1,0,1
,GW,2018.0,3,0,3
EE,,2015.0,232,0,232
LT,VE,2009.0,1,0,1
,FJ,1995.0,9,0,9
WS,MY,2021.0,1,0,1
CR,,2008.0,35,0,35
GA,,2011.0,8,0,8
TH,KE,2020.0,1,0,1
AL,,2013.0,29,0,29
UY,DK,2006.0,1,0,1
DE,MK,2004.0,2,0,2
KE,SY,2001.0,1,0,1
MU,,2014.0,7,0,7
LB,QA,2013.0,8,0,8
ET,KE,2004.0,1,0,1
NI,SV,2015.0,3,0,3
KE,MA,2010.0,1,0,1
EG,CM,2019.0,3,0,3
SE,TR,1997.0,2,0,2
LK,ZA,2007.0,3,0,3
FJ,,2003.0,1,0,1
,GA,1996.0,21,0,21
LS,,2020.0,12,0,12
,GF,2012.0,18,0,18
ID,,1999.0,12,0,12
SG,RO,2018.0,2,0,2
SK,IR,2013.0,1,0,1
NG,IQ,2015.0,3,0,3
EG,GT,2012.0,1,0,1
UZ,JP,2011.0,7,0,7
LS,ZA,2004.0,2,0,2
CO,GR,2022.0,1,0,1
HR,IL,2011.0,1,0,1
,MU,2003.0,18,0,18
TW,QA,2012.0,3,0,3
HK,NZ,2021.0,1,0,1
EC,PY,2016.0,1,0,1
FJ,SG,2017.0,1,0,1
ES,BY,2019.0,1,0,1
GF,NZ,2020.0,1,0,1
SE,CR,2019.0,1,0,1
TR,MK,2011.0,1,0,1
NL,VE,2014.0,2,0,2
,BB,1994.0,20,0,20
NP,KE,2014.0,2,0,2
ET,,2000.0,9,0,9
AL,CN,2009.0,2,0,2
OM,NL,2004.0,1,0,1
EE,PT,2006.0,1,0,1
TR,AE,2008.0,1,0,1
VE,GT,2005.0,2,0,2
OM,LK,2017.0,2,0,2
SN,GA,2009.0,2,0,2
BT,,2003.0,1,0,1
AU,TL,2018.0,2,0,2
DJ,,2024.0,4,0,4
PL,MD,2020.0,1,0,1
GR,KR,2008.0,8,0,8
SE,AL,2018.0,1,0,1
CI,,2010.0,30,0,30
IL,QA,2010.0,1,0,1
PG,CA,2005.0,1,0,1
,VG,2004.0,17,0,17
EC,SE,2021.0,2,0,2
US,PY,2008.0,2,0,2
DO,US,2004.0,2,0,2
HK,RS,2019.0,2,0,2
,LA,2014.0,11,0,11
MX,AT,1997.0,1,0,1
SE,ID,2009.0,2,0,2
,DO,1994.0,19,0,19
DE,CR,2002.0,2,0,2
,WS,2012.0,4,0,4
MD,CH,2013.0,3,0,3
AU,PA,2003.0,2,0,2
MA,AM,2019.0,4,0,4
HR,AL,2013.0,1,0,1
RO,MK,2019.0,1,0,1
TJ,,2011.0,5,0,5
BG,AT,2022.0,3,0,3
SJ,,2019.0,6,0,6
BW,,2007.0,9,0,9
CH,KW,2001.0,1,0,1
NE,,2011.0,4,0,4
DZ,,2001.0,19,0,19
GB,MS,2015.0,1,0,1
SE,ZM,2016.0,1,0,1
IN,TT,2000.0,3,0,3
MA,BJ,2018.0,4,0,4
JO,QA,2003.0,1,0,1
BW,MX,2018.0,1,0,1
nan,NC,2011.0,1,0,1
HK,MY,2007.0,1,0,1
DK,SC,2015.0,1,0,1
IL,QA,2017.0,2,0,2
,GY,2000.0,1,0,1
GY,,2009.0,2,0,2
IT,XK,2016.0,2,0,2
YE,,2004.0,6,0,6
SA,FI,2019.0,3,0,3
GM,,2012.0,4,0,4
IE,GE,2006.0,1,0,1
BE,SA,1999.0,1,0,1
,AF,2014.0,22,0,22
SZ,,2014.0,4,0,4
ES,PF,2017.0,1,0,1
NG,BF,2012.0,2,0,2
FR,GW,2002.0,2,0,2
,HN,2011.0,27,0,27
OM,LK,2010.0,2,0,2
NL,SA,2009.0,2,0,2
PK,NO,2006.0,1,0,1
CN,UG,2003.0,2,0,2
AM,GB,2004.0,3,0,3
NL,GA,2006.0,3,0,3
JO,FR,2022.0,2,0,2
ID,ZM,2021.0,2,0,2
CA,FJ,2020.0,3,0,3
MD,BR,2016.0,2,0,2
ZA,RE,2020.0,2,0,2
DE,UG,2018.0,6,0,6
DE,DO,2012.0,1,0,1
PL,UY,2017.0,1,0,1
AF,BR,2010.0,1,0,1
,MM,2019.0,19,0,19
FJ,JP,2022.0,1,0,1
FI,GE,2015.0,1,0,1
AU,UY,2018.0,2,0,2
ST,nan,2019.0,1,0,1
nan,EE,2005.0,2,0,2
KP,,2018.0,4,0,4
IS,MX,2016.0,1,0,1
SG,CL,2007.0,1,0,1
BO,nan,2020.0,1,0,1
FR,AL,2012.0,1,0,1
TR,SO,2020.0,6,0,6
PK,NG,2009.0,4,0,4
GB,LY,2009.0,6,0,6
ST,BE,2011.0,1,0,1
JP,LV,2014.0,2,0,2
CA,GM,2020.0,2,0,2
MS,,2022.0,5,0,5
NE,ML,2001.0,1,0,1
SD,DZ,2013.0,1,0,1
AU,BN,2009.0,2,0,2
GT,nan,2012.0,1,0,1
,GL,2007.0,4,0,4
BE,MQ,2012.0,1,0,1
JO,BH,2016.0,2,0,2
RU,TN,2011.0,4,0,4
HN,CH,2001.0,1,0,1
MA,CZ,2011.0,1,0,1
GB,MV,2016.0,1,0,1
CN,CI,2015.0,2,0,2
,VG,1996.0,14,0,14
,GA,2004.0,11,0,11
PE,MA,2004.0,1,0,1
AU,KE,2003.0,4,0,4
NZ,FI,2000.0,1,0,1
US,NI,2007.0,2,0,2
CR,CZ,2022.0,1,0,1
,CG,1995.0,8,0,8
MX,AO,2019.0,2,0,2
JP,SD,2012.0,1,0,1
RS,LT,2016.0,1,0,1
TW,MX,1999.0,1,0,1
CA,BH,1998.0,1,0,1
TJ,LV,2022.0,1,0,1
BM,AU,2011.0,1,0,1
EG,BG,2014.0,1,0,1
CM,TH,2012.0,2,0,2
QA,SD,2009.0,2,0,2
EC,CR,2012.0,3,0,3
CO,AZ,2022.0,1,0,1
BZ,US,2012.0,3,0,3
BJ,BE,2006.0,3,0,3
TH,PT,2018.0,1,0,1
nan,CG,2016.0,1,0,1
NC,KH,2022.0,1,0,1
LT,LV,2011.0,1,0,1
MK,SI,2016.0,4,0,4
SV,AU,2004.0,1,0,1
,SZ,1997.0,5,0,5
FR,BY,2021.0,3,0,3
KR,RO,2014.0,1,0,1
HK,nan,2003.0,2,0,2
PL,VN,2012.0,1,0,1
IE,JM,2008.0,1,0,1
BG,PL,2007.0,1,0,1
PA,ID,2008.0,5,0,5
CI,ZA,2007.0,1,0,1
RU,ID,2008.0,1,0,1
ES,MK,2008.0,1,0,1
GB,AM,2015.0,4,0,4
SY,OM,2013.0,2,0,2
BY,PT,2001.0,4,0,4
KE,BF,2018.0,2,0,2
TG,,2005.0,1,0,1
SE,LB,2011.0,1,0,1
BD,QA,2007.0,1,0,1
BG,CY,1998.0,1,0,1
TG,,2002.0,1,0,1
GE,TR,2018.0,2,0,2
DK,KE,2005.0,1,0,1
SE,BF,2017.0,3,0,3
FI,KW,1999.0,1,0,1
TR,HR,2011.0,2,0,2
RO,KW,2004.0,2,0,2
AT,LU,2015.0,1,0,1
DZ,NO,2009.0,1,0,1
NZ,JO,2016.0,1,0,1
SZ,BW,2007.0,1,0,1
JP,CY,1999.0,1,0,1
MZ,CA,2006.0,1,0,1
UY,IL,2009.0,1,0,1
VN,EG,1998.0,1,0,1
GB,RE,1998.0,1,0,1
YE,PL,2008.0,1,0,1
PE,EC,2008.0,2,0,2
IE,MN,2018.0,1,0,1
MY,VE,1999.0,1,0,1
TZ,NA,2002.0,1,0,1
PS,KW,2004.0,1,0,1
CA,SD,2003.0,2,0,2
LU,MA,2020.0,1,0,1
KZ,ES,2022.0,2,0,2
BJ,ES,2019.0,1,0,1
CA,NE,2016.0,1,0,1
KR,CY,2015.0,1,0,1
BI,VN,2006.0,1,0,1
NG,GA,2021.0,1,0,1
CZ,KW,2008.0,1,0,1
MD,UA,2021.0,2,0,2
NA,,2012.0,7,0,7
ZW,MA,2020.0,1,0,1
BH,LB,2021.0,1,0,1
LK,NL,2004.0,2,0,2
SY,JO,2019.0,3,0,3
KR,ML,2004.0,1,0,1
AR,PL,1999.0,1,0,1
JP,EC,2009.0,1,0,1
NC,CG,2004.0,1,0,1
LY,,1999.0,4,0,4
SD,MA,2007.0,1,0,1
CA,VG,2009.0,3,0,3
IL,SS,2018.0,1,0,1
LB,EG,2000.0,1,0,1
HN,AR,2018.0,4,0,4
JP,GH,1999.0,2,0,2
FR,BD,2022.0,3,0,3
MK,SG,2009.0,1,0,1
SA,PL,2006.0,1,0,1
ES,BT,2019.0,1,0,1
BE,TN,1997.0,1,0,1
ES,GE,2010.0,1,0,1
EG,CZ,2014.0,2,0,2
FR,ZM,2016.0,1,0,1
FI,UY,2017.0,1,0,1
FR,DZ,2023.0,3,0,3
SJ,,2010.0,2,0,2
ML,LU,2019.0,2,0,2
CZ,PG,2023.0,1,0,1
AT,TN,2013.0,1,0,1
TN,SY,2009.0,2,0,2
FR,MR,2011.0,3,0,3
nan,GR,2005.0,1,0,1
CO,PL,2017.0,1,0,1
AU,RO,1999.0,1,0,1
SN,FR,2023.0,4,0,4
KN,,2025.0,7,0,7
AU,KH,2017.0,2,0,2
HK,CW,2011.0,1,0,1
AR,RO,2006.0,1,0,1
IE,GP,2012.0,1,0,1
NO,IQ,2014.0,1,0,1
LB,IE,2014.0,1,0,1
MA,BR,2004.0,5,0,5
NL,GL,2021.0,1,0,1
FI,PE,2005.0,1,0,1
KZ,BA,2019.0,1,0,1
AL,RO,2019.0,2,0,2
CY,IQ,2018.0,2,0,2
KE,IL,2005.0,1,0,1
AT,PK,2001.0,2,0,2
BW,IN,2015.0,2,0,2
HR,DK,2005.0,1,0,1
SI,IL,2007.0,1,0,1
MG,NL,2019.0,1,0,1
ES,PR,1998.0,1,0,1
AG,GB,2022.0,1,0,1
TW,HR,2000.0,1,0,1
IR,TW,2001.0,1,0,1
IL,KW,2012.0,1,0,1
,SZ,1998.0,7,0,7
BY,IN,2005.0,1,0,1
SD,NO,2009.0,1,0,1
EE,PL,2010.0,1,0,1
NA,CA,2009.0,1,0,1
IL,GR,2001.0,1,0,1
CO,MN,2012.0,1,0,1
MW,TZ,2015.0,1,0,1
IS,IN,2001.0,1,0,1
TW,KZ,2017.0,1,0,1
RO,KZ,2014.0,1,0,1
IE,MW,2020.0,1,0,1
VN,IR,2015.0,1,0,1
JM,DE,2021.0,1,0,1
DE,MO,2007.0,1,0,1
PA,MY,2013.0,1,0,1
NP,PK,2011.0,1,0,1
ZA,CY,2018.0,2,0,2
PE,SL,2019.0,1,0,1
BF,AT,2013.0,1,0,1
MG,KH,2020.0,1,0,1
,MS,2014.0,2,0,2
RS,MK,2005.0,1,0,1
NI,SE,2016.0,2,0,2
IT,BO,2013.0,1,0,1
NG,NA,2012.0,2,0,2
ME,BR,2018.0,1,0,1
MY,ZA,2023.0,1,0,1
EC,,1999.0,5,0,5
GB,MZ,2005.0,1,0,1
RE,BR,2008.0,1,0,1
PL,GT,2018.0,1,0,1
GE,AU,2007.0,2,0,2
CU,NI,2011.0,1,0,1
UZ,NL,2002.0,1,0,1
ET,UG,2017.0,2,0,2
GA,CD,2013.0,1,0,1
QA,NZ,2016.0,2,0,2
AT,AZ,2017.0,1,0,1
NI,NG,2020.0,1,0,1
AE,KE,2010.0,1,0,1
IT,EE,2010.0,1,0,1
HN,DE,2003.0,1,0,1
GH,GW,2021.0,1,0,1
CN,SL,2008.0,1,0,1
JO,CR,2021.0,1,0,1
CN,IQ,2003.0,1,0,1
UY,IE,2000.0,1,0,1
BJ,CA,2007.0,2,0,2
US,NA,2003.0,2,0,2
TZ,IT,2014.0,2,0,2
SK,NO,2000.0,1,0,1
ZM,IR,2020.0,2,0,2
IL,CU,2011.0,1,0,1
TT,,1998.0,2,0,2
PE,FI,2012.0,1,0,1
BD,AR,2014.0,1,0,1
SA,SY,2008.0,1,0,1
HU,LT,2008.0,1,0,1
CI,PH,2015.0,1,0,1
CZ,CY,2021.0,2,0,2
EE,IE,2009.0,2,0,2
SJ,,2017.0,1,0,1
ML,SN,2010.0,1,0,1
NL,RW,2014.0,1,0,1
GH,HU,2017.0,1,0,1
MY,LA,2011.0,1,0,1
DZ,GA,2022.0,1,0,1
NZ,SA,2001.0,1,0,1
KW,NO,2007.0,1,0,1
TL,JP,2018.0,1,0,1
GR,IQ,2010.0,1,0,1
IQ,TH,2016.0,1,0,1
HR,MK,2011.0,1,0,1
CN,LV,2007.0,1,0,1
IL,IQ,2003.0,1,0,1
EG,TN,2023.0,1,0,1
KE,TT,1999.0,1,0,1
AO,GB,2015.0,1,0,1
PH,nan,2013.0,1,0,1
FI,EG,2005.0,1,0,1
NL,CL,2023.0,1,0,1
GE,FR,2022.0,2,0,2
TN,BA,2016.0,1,0,1
KE,CN,1998.0,1,0,1
FI,QA,2006.0,1,0,1
ME,CH,2021.0,1,0,1
SA,BN,2021.0,1,0,1
GB,IS,1997.0,2,0,2
CZ,GE,2011.0,1,0,1
AR,BD,2021.0,1,0,1
SO,EG,2020.0,1,0,1
ML,EG,2005.0,1,0,1
KW,PE,2000.0,1,0,1
LT,AR,2011.0,1,0,1
KW,nan,1997.0,1,0,1
CF,AU,2011.0,1,0,1
AE,LB,2005.0,1,0,1
DE,MZ,2006.0,1,0,1
BR,EG,2001.0,1,0,1
NP,NZ,1997.0,1,0,1
KZ,TH,2016.0,1,0,1
FM,US,2018.0,1,0,1
SA,IE,2000.0,1,0,1
ZM,RU,2016.0,1,0,1
LB,RU,2019.0,1,0,1
BF,TW,2014.0,1,0,1
JO,SD,2011.0,2,0,2
FJ,BE,2019.0,1,0,1
IT,BH,2009.0,1,0,1
MA,AM,2017.0,2,0,2
GH,CG,2015.0,1,0,1
CL,EC,1997.0,1,0,1
NP,NI,2017.0,1,0,1
CU,FR,2006.0,2,0,2
LB,CH,2011.0,1,0,1
nan,NE,2015.0,1,0,1
ES,VN,2003.0,1,0,1
PG,NZ,2015.0,1,0,1
IE,IS,2014.0,3,0,3
NP,ID,2018.0,2,0,2
CW,DE,2006.0,2,0,2
NP,FR,2013.0,1,0,1
KZ,TW,2011.0,1,0,1
NZ,CO,2010.0,1,0,1
BF,IT,2008.0,1,0,1
AU,GF,2020.0,1,0,1
NO,LT,2021.0,1,0,1
ID,UA,2000.0,1,0,1
FI,NP,2015.0,1,0,1
MR,US,2010.0,1,0,1
PH,DO,2015.0,1,0,1
KE,ML,2021.0,2,0,2
KH,NL,2013.0,2,0,2
MY,nan,2000.0,1,0,1
NZ,RS,2004.0,2,0,2
UA,TR,2016.0,2,0,2
TR,TZ,2005.0,1,0,1
RO,LU,2018.0,1,0,1
SE,PH,2018.0,1,0,1
VE,RU,2014.0,1,0,1
ID,MA,2006.0,1,0,1
BD,MY,2000.0,1,0,1
IT,PY,2014.0,1,0,1
BF,CH,2005.0,1,0,1
PL,NZ,2014.0,1,0,1
EE,LT,2008.0,1,0,1
LV,LT,1997.0,1,0,1
JP,AZ,2008.0,1,0,1
TW,BG,2020.0,1,0,1
ZA,SE,2001.0,3,0,3
BZ,TH,2018.0,1,0,1
PT,SA,2012.0,3,2,1
JP,KH,1997.0,2,2,0
FI,UA,2021.0,3,3,0
FI,GR,2009.0,4,1,3
BD,IN,1999.0,1,6,-5
CH,LT,2022.0,2,1,1
KW,MA,2021.0,3,2,1
MX,SK,2021.0,1,2,-1
nan,MA,2010.0,2,3,-1
US,BM,2019.0,1,1,0
UY,CU,2013.0,1,3,-2
PT,NZ,2010.0,2,1,1
RU,NZ,2022.0,1,1,0
MT,IT,2016.0,3,6,-3
ET,MY,2019.0,1,5,-4
HR,ES,2009.0,3,1,2
IE,LK,2011.0,1,2,-1
SE,BO,2019.0,2,1,1
ZA,CR,2012.0,2,6,-4
RE,IN,2009.0,1,1,0
CO,SI,2021.0,1,1,0
IQ,OM,2016.0,1,3,-2
NO,CO,2020.0,4,2,2
ES,BO,2007.0,1,9,-8
DE,LV,2021.0,2,4,-2
PK,UA,2020.0,2,5,-3
SA,RU,2018.0,2,7,-5
US,PR,2005.0,3,2,1
EE,PL,2017.0,1,2,-1
PK,UG,2017.0,1,3,-2
IL,CZ,2004.0,2,2,0
SD,US,2012.0,2,7,-5
AU,EE,2021.0,1,4,-3
TN,MY,2018.0,1,1,0
ZA,BD,2009.0,1,2,-1
BA,AT,2018.0,1,2,-1
CN,CR,2021.0,1,2,-1
IT,LT,2003.0,1,1,0
BO,VE,2016.0,1,1,0
SE,CU,2016.0,1,1,0
CN,TN,2010.0,1,1,0
DK,SN,2017.0,1,1,0
US,CG,2002.0,2,1,1
EC,MX,2000.0,1,1,0
KW,IR,2008.0,3,3,0
GR,IL,1998.0,1,2,-1
CA,MK,2009.0,1,2,-1
QA,RU,2015.0,1,1,0
MY,RO,2015.0,3,1,2
GE,KR,2016.0,2,1,1
HU,NG,2002.0,1,1,0
NE,CM,2016.0,1,1,0
nan,PK,2006.0,2,5,-3
EE,PL,2019.0,1,2,-1
CL,RU,2014.0,1,1,0
JP,QA,1998.0,1,2,-1
AT,AR,2022.0,1,3,-2
SE,HR,2017.0,3,4,-1
PT,ST,2002.0,1,2,-1
NP,BD,2016.0,4,8,-4
SI,GR,2020.0,2,1,1
MD,GB,2000.0,1,1,0
BF,ML,2007.0,3,1,2
KZ,PL,2020.0,2,1,1
PY,DE,2016.0,1,1,0
PS,IL,2016.0,2,5,-3
GR,RU,2003.0,1,2,-1
LK,BD,2011.0,1,1,0
CA,IS,2004.0,1,2,-1
TH,CO,2018.0,1,2,-1
CD,KE,2022.0,2,2,0
AU,GH,2023.0,2,1,1
BE,RW,2009.0,1,1,0
MY,TW,2004.0,1,2,-1
PK,HU,2015.0,1,3,-2
SI,PE,2018.0,1,1,0
CR,FR,2003.0,1,2,-1
IN,KH,2022.0,1,2,-1
ES,LU,2009.0,2,1,1
LT,NO,2014.0,1,1,0
IR,CO,2016.0,1,2,-1
AU,IS,2010.0,1,1,0
BD,DE,2000.0,2,2,0
GE,CH,2015.0,1,1,0
EG,PT,2019.0,1,2,-1
NL,BG,2007.0,1,5,-4
GB,IS,1998.0,2,3,-1
PE,PT,2022.0,2,3,-1
MX,VN,2010.0,3,3,0
EG,PT,2017.0,3,4,-1
PT,ST,2005.0,2,1,1
LK,CH,2004.0,1,2,-1
NP,NZ,1998.0,2,3,-1
IR,PK,2001.0,1,1,0
GR,IT,2023.0,1,3,-2
SG,PT,2012.0,1,1,0
FR,BO,2008.0,1,5,-4
PL,EG,1997.0,1,1,0
UA,PK,2009.0,1,1,0
ES,GE,2019.0,2,2,0
TR,SE,1998.0,1,1,0
HK,BE,2018.0,1,1,0
BR,CM,2019.0,1,1,0
FR,UG,2011.0,2,3,-1
BO,GB,2017.0,1,2,-1
RU,QA,2016.0,2,1,1
NL,EE,2001.0,1,1,0
KW,DE,2012.0,1,4,-3
LK,MY,2012.0,1,4,-3
IE,GR,2000.0,1,1,0
SA,KE,2021.0,1,1,0
TR,BR,2001.0,1,3,-2
KR,LK,2018.0,3,2,1
VN,CZ,2016.0,2,3,-1
ES,LB,2016.0,1,1,0
CH,XK,2019.0,1,2,-1
TN,BE,2022.0,1,4,-3
SK,IQ,2020.0,1,1,0
CY,US,1997.0,1,1,0
HU,PT,2004.0,1,1,0
MA,IL,2020.0,2,2,0
CO,BO,2004.0,1,1,0
CY,US,1998.0,2,4,-2
SE,HR,2010.0,2,3,-1
NO,ID,2020.0,1,4,-3
SE,BA,2021.0,1,2,-1
UG,SE,1999.0,2,2,0
ES,PY,1999.0,1,1,0
IT,CU,2005.0,2,5,-3
DE,HN,2016.0,1,2,-1
SL,US,2017.0,1,4,-3
PL,IR,2019.0,1,16,-15
LI,AT,2016.0,1,2,-1
GE,CZ,2005.0,1,2,-1
BE,ET,2009.0,1,3,-2
IT,UY,1998.0,1,2,-1
CU,CR,2006.0,2,2,0
AE,CO,2016.0,1,2,-1
ZA,PT,2005.0,1,1,0
CL,IE,2007.0,1,1,0
ZW,CH,2022.0,1,1,0
AU,IS,2017.0,1,2,-1
BE,TZ,2021.0,1,2,-1
MZ,GB,2008.0,1,1,0
AE,TH,2020.0,1,1,0
CU,AU,2020.0,1,2,-1
PY,SV,2017.0,1,1,0
NZ,MY,1998.0,1,1,0
IE,GD,2021.0,1,2,-1
CN,SN,2018.0,1,2,-1
BD,MA,2009.0,1,1,0
SE,BF,2010.0,1,1,0
PK,UG,2019.0,1,2,-1
DK,KN,2018.0,1,1,0
AU,TR,2003.0,2,6,-4
DE,RW,2011.0,1,1,0
VE,CR,2021.0,1,3,-2
CN,RW,2023.0,1,1,0
HU,AR,2000.0,1,2,-1
CO,PL,2010.0,1,2,-1
DK,MY,2011.0,2,2,0
CN,GR,1997.0,1,1,0
HR,IN,2018.0,1,3,-2
PA,FR,2015.0,1,2,-1
NG,EG,2009.0,1,2,-1
NO,EE,2014.0,1,1,0
PL,SA,2022.0,2,3,-1
EC,CH,2018.0,2,4,-2
TH,KR,2006.0,3,4,-1
GR,KW,2013.0,1,3,-2
AU,LB,2018.0,2,7,-5
IT,GE,2020.0,2,2,0
CO,KE,2000.0,1,1,0
IT,CI,2015.0,1,1,0
US,SL,2016.0,1,5,-4
NZ,CU,2013.0,1,1,0
SZ,TW,2022.0,1,1,0
RW,KE,2016.0,1,1,0
SG,ZA,2013.0,1,2,-1
CA,TT,2008.0,1,1,0
CN,NA,2016.0,3,0,3
CH,PA,2020.0,2,0,2
BW,GH,2012.0,1,0,1
FJ,BH,2011.0,1,0,1
OM,ZA,2003.0,1,0,1
TT,VG,2013.0,1,0,1
LT,IN,2015.0,2,0,2
CO,AO,2011.0,1,0,1
SV,NL,2013.0,1,0,1
NA,US,2005.0,2,0,2
DE,MC,2022.0,1,0,1
VE,TR,2013.0,1,0,1
MY,FI,2010.0,1,0,1
PG,TZ,2018.0,1,0,1
JE,,2013.0,1,0,1
RE,SK,2014.0,1,0,1
FR,CF,2006.0,1,0,1
SG,CY,2005.0,1,0,1
LB,RU,2017.0,1,0,1
BN,PH,2006.0,1,0,1
GA,CN,2011.0,1,0,1
MX,TN,2016.0,2,0,2
UA,NG,2021.0,1,0,1
BO,JP,2000.0,1,0,1
RE,CR,2019.0,1,0,1
SG,KZ,2018.0,1,0,1
GH,BE,2003.0,1,0,1
MQ,,2025.0,1,0,1
VU,NC,2019.0,1,0,1
BM,CA,2016.0,1,0,1
HK,RS,2017.0,1,0,1
NC,US,2002.0,1,0,1
RE,BJ,2016.0,1,0,1
FO,SE,2004.0,1,0,1
AU,SD,2007.0,1,0,1
PH,GR,2011.0,1,0,1
SI,NZ,2014.0,1,0,1
BW,LB,2014.0,1,0,1
NL,LB,2004.0,2,0,2
ZM,NO,2007.0,1,0,1
PR,TH,2008.0,1,0,1
VN,PE,2014.0,1,0,1
MU,NZ,2018.0,2,0,2
MA,LB,2006.0,1,0,1
MN,KZ,2019.0,2,0,2
QA,IE,2023.0,1,0,1
AR,MG,2014.0,1,0,1
US,BM,2017.0,2,0,2
IN,UG,2007.0,1,0,1
UA,CY,2010.0,1,0,1
GF,CM,2003.0,1,0,1
PT,JO,2019.0,1,0,1
FI,UY,2010.0,1,0,1
PH,NZ,2008.0,2,0,2
MQ,IN,2018.0,1,0,1
NO,EG,2006.0,1,0,1
MR,GB,1999.0,1,0,1
BF,CM,2011.0,1,0,1
BG,LV,2011.0,1,0,1
EG,UG,2019.0,1,0,1
UA,DZ,2020.0,1,0,1
ML,CH,2001.0,1,0,1
KE,NG,1997.0,1,0,1
NG,AR,2006.0,1,0,1
BR,UZ,2020.0,1,0,1
PE,MY,2015.0,1,0,1
JP,PS,2012.0,1,0,1
SG,UY,2017.0,1,0,1
ET,UG,2010.0,1,0,1
DK,NP,1998.0,1,0,1
NZ,ES,2000.0,1,0,1
GH,CD,2020.0,1,0,1
OM,TN,2001.0,1,0,1
BA,MK,2021.0,1,0,1
TR,CO,2008.0,2,0,2
CY,SA,2021.0,1,0,1
IN,HK,2003.0,1,0,1
VE,RO,2010.0,1,0,1
RU,TZ,2018.0,1,0,1
BN,BH,2012.0,1,0,1
BG,FI,2009.0,2,0,2
BD,FR,2002.0,1,0,1
ET,AR,2016.0,1,0,1
NZ,TT,2007.0,1,0,1
SA,PH,2022.0,2,0,2
DE,PY,2022.0,1,0,1
CU,UG,2017.0,1,0,1
ES,LT,2006.0,1,0,1
TW,IL,2008.0,1,0,1
nan,NO,2023.0,2,0,2
MA,CL,2018.0,1,0,1
CG,NE,2014.0,2,0,2
ID,UG,2009.0,1,0,1
EG,YE,2006.0,3,0,3
RE,CN,2015.0,1,0,1
UZ,MY,2014.0,1,0,1
UA,GB,2023.0,1,0,1
CR,NZ,2014.0,1,0,1
AU,SV,2020.0,1,0,1
BR,SA,2010.0,1,0,1
BO,GB,2010.0,1,0,1
BE,GT,2020.0,1,0,1
SV,CO,2007.0,1,0,1
KH,SG,2012.0,1,0,1
EG,PT,2010.0,1,0,1
JP,BO,2009.0,1,0,1
AO,CZ,2011.0,1,0,1
TW,BO,2002.0,1,0,1
MX,TW,2006.0,1,0,1
LS,US,2002.0,1,0,1
IN,SS,2019.0,1,0,1
SV,CU,2019.0,1,0,1
DE,RE,2011.0,1,0,1
AF,BR,2017.0,1,0,1
US,BZ,1997.0,1,0,1
ZA,YE,2020.0,1,0,1
US,FK,2001.0,1,0,1
SY,TN,2007.0,1,0,1
BF,DK,2010.0,1,0,1
AM,BI,2004.0,1,0,1
NL,XK,2015.0,1,0,1
MG,ZA,2005.0,1,0,1
HN,PE,2012.0,1,0,1
CA,PG,2006.0,1,0,1
GP,SN,2012.0,1,0,1
NO,TW,2010.0,1,0,1
BE,MT,2012.0,1,0,1
GB,PY,2014.0,1,0,1
GR,PY,2016.0,1,0,1
,GN,1994.0,1,0,1
,BZ,1994.0,1,0,1
PE,IR,2017.0,1,0,1
KE,GM,2018.0,1,0,1
VN,CF,2013.0,1,0,1
FI,CR,2020.0,1,0,1
TZ,TW,2000.0,1,0,1
GL,,2011.0,1,0,1
DE,NE,2015.0,2,0,2
JP,JO,2021.0,2,0,2
PA,LT,2014.0,1,0,1
CH,PS,2016.0,1,0,1
ER,US,2009.0,1,0,1
BY,KZ,2018.0,1,0,1
UA,AU,1999.0,1,0,1
PA,IL,2006.0,1,0,1
IR,SY,2015.0,1,0,1
AR,TH,2014.0,1,0,1
BR,BN,2014.0,1,0,1
VE,LT,1999.0,1,0,1
TJ,LT,2014.0,1,0,1
CZ,AG,2020.0,1,0,1
BN,LK,2023.0,1,0,1
SI,CN,2003.0,1,0,1
CU,FI,2016.0,1,0,1
ZA,NP,2021.0,1,0,1
MN,US,2006.0,1,0,1
CM,BW,2007.0,1,0,1
LK,KR,2005.0,2,0,2
US,BZ,1998.0,1,0,1
MA,QA,2016.0,1,0,1
MT,RS,2019.0,1,0,1
IQ,IS,2014.0,1,0,1
IS,CA,2021.0,1,0,1
NL,GE,2020.0,1,0,1
TR,LB,2012.0,1,0,1
IS,RO,2016.0,1,0,1
CH,LR,2013.0,1,0,1
KZ,CY,2017.0,1,0,1
EC,VE,2002.0,1,0,1
HU,BR,2023.0,1,0,1
ZM,TZ,2005.0,1,0,1
DK,MT,2017.0,1,0,1
RS,KW,2003.0,1,0,1
GB,MG,2015.0,1,0,1
MX,AT,1998.0,1,0,1
ST,UY,2015.0,1,0,1
IE,CZ,2003.0,1,0,1
TZ,ES,2011.0,2,0,2
NA,US,2002.0,1,0,1
SN,ZW,2018.0,1,0,1
IT,ZM,2008.0,1,0,1
RO,KN,2015.0,1,0,1
CL,SI,2007.0,1,0,1
MZ,NO,2004.0,1,0,1
RU,OM,2023.0,1,0,1
PG,TN,2002.0,1,0,1
BF,IN,2013.0,1,0,1
HU,LU,2009.0,1,0,1
UZ,MZ,2022.0,1,0,1
CZ,SA,2010.0,1,0,1
KE,KR,2022.0,1,0,1
SR,,2025.0,1,0,1
CN,KP,2010.0,1,0,1
LK,BJ,2013.0,1,0,1
AF,TR,2017.0,1,0,1
TZ,GH,2020.0,1,0,1
NL,LV,2013.0,1,0,1
NZ,NA,2015.0,1,0,1
PH,RO,2013.0,1,0,1
PK,JP,2023.0,1,0,1
BO,FI,2020.0,1,0,1
US,SS,2016.0,1,0,1
,SJ,2020.0,1,0,1
IE,BR,2023.0,1,0,1
LB,MX,2021.0,1,0,1
DZ,DK,2022.0,1,0,1
YE,TR,2022.0,1,0,1
MU,ID,2020.0,1,0,1
FR,LA,2021.0,1,0,1
IR,MY,2015.0,107,187,-80
IN,SG,2012.0,94,73,21
SG,IN,2013.0,102,86,16
ES,CO,2013.0,431,383,48
CN,nan,2012.0,162,179,-17
SE,JP,2007.0,41,42,-1
JP,EG,2014.0,67,49,18
US,MY,2014.0,171,142,29
US,AU,2020.0,2609,2571,38
US,FR,2011.0,1379,1474,-95
GB,NL,2014.0,294,362,-68
CN,CZ,2019.0,25,22,3
JP,AU,2007.0,64,54,10
CN,US,2022.0,2986,4478,-1492
US,AT,2016.0,261,213,48
GB,CN,2017.0,649,527,122
CA,JP,2008.0,97,130,-33
US,ES,2016.0,844,1166,-322
HK,RO,2016.0,11,16,-5
IN,US,1999.0,557,452,105
CH,DE,2018.0,890,1052,-162
JP,nan,1998.0,80,77,3
PT,BR,2021.0,792,1285,-493
CA,CN,2011.0,505,421,84
PT,BE,2017.0,21,20,1
JP,GB,2006.0,253,255,-2
US,KR,2005.0,903,833,70
CN,TW,2011.0,924,1352,-428
CN,DE,2014.0,290,284,6
GB,IN,2017.0,522,525,-3
MX,RS,2012.0,34,1,33
US,KR,2002.0,642,708,-66
AT,ES,2008.0,19,22,-3
CL,DE,2022.0,26,31,-5
US,TH,2014.0,227,116,111
US,CH,1999.0,409,408,1
US,BR,2008.0,770,739,31
AU,GB,2008.0,965,1185,-220
ID,ES,2012.0,6,10,-4
KR,FI,2022.0,6,7,-1
AR,ES,2002.0,134,118,16
ES,GB,2002.0,123,142,-19
AU,DK,2000.0,12,15,-3
AR,ES,2005.0,178,153,25
JP,CN,2012.0,598,455,143
US,BE,1999.0,125,164,-39
CA,IT,2002.0,60,55,5
DE,ES,2012.0,212,255,-43
IT,GB,2005.0,266,249,17
RU,US,2003.0,363,209,154
IQ,MY,2020.0,48,113,-65
EG,SA,2022.0,317,269,48
US,IE,2013.0,511,472,39
GB,IR,2014.0,107,83,24
IE,AU,2017.0,106,123,-17
US,EG,2020.0,364,296,68
DK,SE,2011.0,89,124,-35
DE,RU,2000.0,80,135,-55
MY,SG,2013.0,69,123,-54
AU,CA,2015.0,337,428,-91
BE,GB,2018.0,191,175,16
MY,NO,2021.0,5,2,3
CL,CA,2015.0,26,25,1
SD,EG,2019.0,39,28,11
NZ,US,2001.0,220,188,32
CA,IE,1999.0,52,37,15
CA,IN,2005.0,114,147,-33
IN,CA,2014.0,203,214,-11
GB,CN,2010.0,547,431,116
CL,MX,1998.0,19,18,1
GB,BR,1999.0,62,55,7
US,HN,2010.0,5,2,3
HN,US,2013.0,5,6,-1
PE,US,2009.0,52,35,17
ES,GB,2005.0,210,218,-8
MX,AU,2017.0,21,13,8
ID,US,2018.0,212,335,-123
CA,AU,1997.0,103,76,27
AR,EC,2021.0,38,34,4
GB,IQ,2016.0,78,23,55
US,ZA,2014.0,405,367,38
CN,ET,2018.0,14,7,7
US,CL,2020.0,259,278,-19
IT,BR,2009.0,156,166,-10
TR,US,2003.0,247,259,-12
KR,KP,2016.0,5,1,4
CN,ID,2007.0,12,11,1
ES,PE,2000.0,15,22,-7
PT,MX,2005.0,6,9,-3
US,AR,2022.0,134,158,-24
AR,CL,2022.0,64,53,11
TZ,NO,2013.0,6,5,1
CA,AU,1998.0,136,94,42
GB,DK,2012.0,116,98,18
KR,GB,2010.0,76,83,-7
KR,NO,2008.0,5,6,-1
GB,BD,2005.0,24,17,7
VE,US,2007.0,65,44,21
DE,FJ,2006.0,1,1,0
FR,IN,2020.0,123,134,-11
IN,CH,2015.0,62,51,11
SE,US,1998.0,250,174,76
VN,DE,2004.0,5,3,2
CO,AR,2010.0,52,63,-11
ES,MX,1998.0,160,136,24
IL,NZ,2013.0,2,3,-1
CA,IS,2015.0,6,2,4
CI,US,2008.0,2,1,1
US,VE,2006.0,35,43,-8
US,CO,2021.0,218,354,-136
IL,IT,2019.0,16,24,-8
AU,KR,2007.0,18,30,-12
IT,GB,2002.0,253,257,-4
BR,VE,2006.0,16,10,6
JP,nan,1997.0,56,43,13
CO,AR,2017.0,134,126,8
GB,NO,2016.0,103,93,10
PK,AU,2011.0,19,18,1
AU,QA,2022.0,5,6,-1
LK,ID,2014.0,2,2,0
JP,TW,2006.0,64,39,25
GB,FR,2015.0,548,652,-104
PL,US,2015.0,206,277,-71
JP,FR,2000.0,68,72,-4
TW,SG,2019.0,71,54,17
GE,GB,2003.0,5,6,-1
PL,CN,2014.0,27,47,-20
ZA,IN,2000.0,8,6,2
CA,DE,2007.0,183,266,-83
US,BD,2001.0,26,14,12
US,CZ,2004.0,109,106,3
AU,IN,2007.0,48,68,-20
TW,TR,2004.0,8,6,2
MX,PT,2008.0,11,10,1
KR,CN,2021.0,261,224,37
NO,IT,2014.0,18,23,-5
ES,CL,1998.0,41,32,9
MA,NL,2019.0,3,2,1
PK,GB,2013.0,95,163,-68
IN,BD,2017.0,127,139,-12
IN,BD,2010.0,40,42,-2
AR,BE,2018.0,14,10,4
ES,MX,1997.0,90,86,4
CA,GH,2017.0,8,8,0
FI,US,2011.0,125,131,-6
US,SG,2004.0,200,193,7
LK,IN,2021.0,18,26,-8
DE,BD,2010.0,7,4,3
MY,GB,2018.0,149,170,-21
DK,GB,2007.0,75,125,-50
AU,CH,2004.0,39,37,2
IN,TH,2017.0,22,11,11
US,PK,2016.0,285,256,29
GB,nan,2007.0,62,95,-33
TH,CN,2008.0,15,7,8
BE,CN,2001.0,26,9,17
CN,CZ,2010.0,43,52,-9
LS,ZA,2015.0,8,1,7
RU,BE,2017.0,15,18,-3
FI,ES,1999.0,4,5,-1
CN,ES,2007.0,39,34,5
TW,NO,2012.0,2,2,0
PK,EG,2015.0,15,12,3
GB,IE,1999.0,121,110,11
PH,IN,2013.0,14,18,-4
CZ,CN,2007.0,55,24,31
DK,US,2020.0,293,318,-25
TW,nan,2008.0,6,5,1
CN,HK,2016.0,101,145,-44
CN,KZ,2008.0,6,11,-5
BR,CN,2006.0,38,26,12
BG,GB,2017.0,20,21,-1
RO,nan,2017.0,3,1,2
IN,BD,2019.0,173,182,-9
ES,AR,1997.0,42,42,0
ID,JP,2007.0,18,79,-61
ES,AR,1998.0,59,69,-10
FI,PT,2020.0,10,6,4
NP,CN,2017.0,22,7,15
CA,ES,2020.0,93,92,1
UA,RO,2019.0,4,11,-7
GB,SE,2020.0,243,193,50
NL,FR,2014.0,188,189,-1
AU,FR,1999.0,32,43,-11
MX,VE,2004.0,24,20,4
SA,ID,2020.0,19,28,-9
JP,CH,2017.0,121,94,27
BR,MY,2014.0,28,72,-44
QA,EG,2016.0,43,30,13
US,NP,2016.0,58,75,-17
SK,PL,2008.0,3,7,-4
IN,KR,2003.0,49,24,25
AR,CA,2004.0,17,9,8
AT,FR,2020.0,52,53,-1
NL,IT,2012.0,88,114,-26
GB,PT,2008.0,86,69,17
IT,BE,2020.0,173,149,24
TR,nan,2014.0,22,16,6
FR,RE,2020.0,74,48,26
JP,IR,2008.0,28,17,11
RU,nan,2017.0,28,66,-38
DE,BD,2017.0,15,17,-2
US,KE,2015.0,82,93,-11
NP,CA,2009.0,2,1,1
MA,NL,2017.0,1,2,-1
IL,EG,2014.0,9,4,5
GB,CR,2016.0,4,4,0
PK,VN,2018.0,4,2,2
RU,SK,2015.0,19,10,9
AR,MX,1998.0,17,20,-3
FR,VN,2020.0,62,22,40
NL,CH,2008.0,85,69,16
DZ,FR,2018.0,106,186,-80
IQ,GB,2019.0,45,175,-130
PH,CN,2018.0,23,19,4
ID,CL,2018.0,13,13,0
CA,BE,2014.0,65,67,-2
US,BA,2016.0,13,8,5
nan,AR,2003.0,18,22,-4
GB,HR,2008.0,5,7,-2
GT,ES,2010.0,4,4,0
IT,AR,2012.0,99,79,20
DE,EE,2020.0,70,52,18
EC,FR,2020.0,12,9,3
RU,IE,2016.0,6,11,-5
BG,GB,2019.0,22,15,7
GB,CO,2010.0,21,16,5
HU,CA,2019.0,12,13,-1
FR,NL,2015.0,156,200,-44
BE,PL,2011.0,20,15,5
UG,US,2017.0,42,47,-5
BR,SE,2019.0,54,31,23
BG,US,2007.0,23,23,0
BE,ES,2015.0,58,106,-48
ES,SG,2019.0,3,4,-1
DK,BE,2009.0,10,18,-8
UY,DE,2000.0,2,1,1
SG,FR,2013.0,31,22,9
DE,IN,2001.0,67,89,-22
TW,SG,2017.0,58,48,10
US,MN,2015.0,6,5,1
AT,SK,2014.0,12,11,1
BF,CA,2017.0,6,4,2
TR,EG,2019.0,11,18,-7
US,NI,2008.0,3,1,2
CA,QA,2011.0,11,3,8
GE,CN,2016.0,4,6,-2
EG,AE,2017.0,35,32,3
TH,CA,2014.0,11,18,-7
CO,CU,2013.0,20,27,-7
SA,SD,2022.0,15,32,-17
EG,TW,2018.0,27,26,1
SE,TN,2018.0,3,3,0
VE,ES,2002.0,47,30,17
BE,AR,2006.0,7,6,1
MY,ID,2013.0,111,67,44
JO,SA,2016.0,46,40,6
KW,US,2000.0,11,16,-5
FR,IL,2000.0,22,20,2
HU,FI,2009.0,8,6,2
CH,BR,2020.0,47,66,-19
LK,CH,2015.0,4,5,-1
EG,AE,2019.0,65,55,10
EC,AR,2022.0,19,16,3
TR,DE,1999.0,18,7,11
AU,ET,2022.0,10,17,-7
RO,CH,2013.0,14,14,0
PT,HR,2013.0,1,1,0
TR,EG,2017.0,9,3,6
MX,SG,2020.0,4,1,3
IN,IL,2020.0,119,82,37
OM,IN,2020.0,23,28,-5
NI,CO,2018.0,8,7,1
TW,VN,2019.0,52,19,33
US,HR,2001.0,16,22,-6
nan,IT,2014.0,132,195,-63
AT,ZA,2016.0,6,6,0
DE,SY,2013.0,5,6,-1
RU,nan,2019.0,43,75,-32
CN,CZ,2017.0,24,27,-3
GB,HU,2015.0,59,65,-6
PT,AU,2002.0,2,2,0
PK,IN,2006.0,47,34,13
TR,PK,2002.0,1,2,-1
IE,AU,2019.0,141,126,15
CA,GH,2019.0,21,13,8
FR,ZA,2021.0,25,19,6
UA,IT,2018.0,48,28,20
PK,MY,2020.0,92,147,-55
TW,GB,2006.0,44,46,-2
GB,SA,2022.0,94,59,35
UA,US,2016.0,67,61,6
IN,AE,2013.0,49,12,37
IN,TW,2001.0,29,10,19
IN,YE,2020.0,11,2,9
NO,CZ,2015.0,5,22,-17
PL,DE,2016.0,137,169,-32
KE,ZA,2008.0,9,6,3
KR,AE,2013.0,3,2,1
KW,CA,2017.0,5,22,-17
UG,US,2019.0,40,58,-18
SN,CA,2017.0,8,7,1
TR,NL,2014.0,31,31,0
CR,CU,2019.0,36,50,-14
HR,AT,2011.0,9,5,4
RO,AU,2020.0,8,4,4
PY,CO,2018.0,4,17,-13
ZA,UG,2018.0,16,18,-2
DE,ET,2015.0,13,7,6
KR,FR,2010.0,30,15,15
PT,CH,2021.0,24,19,5
GB,GM,2011.0,7,12,-5
TW,ET,2022.0,9,4,5
CH,DK,2002.0,9,11,-2
IN,QA,2015.0,20,11,9
RU,KG,2020.0,8,6,2
FI,IT,2018.0,22,33,-11
BR,AR,2023.0,6,2,4
PH,CA,2022.0,8,7,1
CA,AR,2015.0,20,30,-10
AR,CU,2019.0,18,25,-7
ZA,DE,2021.0,61,30,31
ES,CR,2007.0,15,17,-2
NL,TR,2022.0,17,23,-6
BE,HU,2006.0,8,7,1
RO,DE,2015.0,48,26,22
TW,SG,2010.0,39,31,8
ZA,IL,2020.0,4,4,0
GR,US,2003.0,106,141,-35
PS,ES,2022.0,7,8,-1
RU,MY,2021.0,15,11,4
KR,SE,2020.0,13,12,1
HR,ME,2017.0,7,4,3
EG,JP,2022.0,19,30,-11
YE,SA,2017.0,24,4,20
SE,IR,2018.0,35,43,-8
VE,CO,2018.0,87,63,24
BE,AU,2008.0,21,19,2
AU,IQ,2022.0,12,3,9
GR,CZ,2019.0,16,8,8
PK,QA,2022.0,18,14,4
EC,DE,2019.0,12,10,2
BR,NL,2018.0,65,60,5
US,nan,1998.0,94,112,-18
IR,AF,2020.0,11,7,4
CH,GB,2008.0,217,228,-11
FR,BJ,2020.0,25,22,3
IR,US,2001.0,14,18,-4
ES,CL,1997.0,27,29,-2
PL,IL,2022.0,5,15,-10
US,CD,2017.0,5,3,2
RU,DK,2017.0,15,13,2
IT,AM,2004.0,9,6,3
MX,PY,2021.0,15,8,7
US,NG,2014.0,75,65,10
FR,DK,2014.0,39,36,3
IE,AU,2010.0,69,95,-26
PK,BD,2006.0,10,9,1
VE,ES,2005.0,54,54,0
NG,GB,2013.0,48,58,-10
IL,CZ,2015.0,4,5,-1
ZA,NL,2018.0,50,56,-6
DE,AU,2007.0,153,147,6
ID,KR,2014.0,17,16,1
AU,PT,2009.0,15,9,6
MY,NP,2021.0,4,4,0
BR,GH,2016.0,1,2,-1
HU,DE,2022.0,27,29,-2
CN,BD,2014.0,91,90,1
FI,SE,2006.0,58,71,-13
SD,EG,2017.0,29,26,3
KE,CO,2012.0,5,5,0
UG,US,2010.0,20,32,-12
GB,AL,2016.0,3,1,2
DZ,CA,2002.0,6,5,1
PH,CH,2012.0,6,1,5
IS,US,2014.0,18,10,8
AM,US,2013.0,17,7,10
UA,JP,2003.0,9,4,5
RU,BR,2012.0,11,14,-3
FR,SN,2022.0,16,17,-1
IN,OM,2011.0,16,7,9
FR,JO,2019.0,6,1,5
PK,CH,2007.0,12,14,-2
TW,MY,2005.0,8,3,5
ZA,ET,2015.0,7,7,0
JP,HK,2013.0,6,11,-5
IL,IT,2010.0,11,18,-7
ES,PS,2016.0,15,11,4
CZ,ES,2007.0,5,5,0
MY,CZ,2010.0,2,4,-2
NP,CN,2019.0,19,19,0
TW,MY,2002.0,5,2,3
BE,GR,2014.0,14,29,-15
GB,RS,2012.0,34,18,16
US,PA,2014.0,53,51,2
FI,NG,2015.0,2,1,1
BE,PT,2020.0,17,28,-11
SE,CH,1999.0,22,20,2
IR,SE,2015.0,31,41,-10
QA,MY,2020.0,5,16,-11
BR,ST,2016.0,22,43,-21
IT,PL,2000.0,16,8,8
KR,JP,1999.0,82,126,-44
IT,IN,2015.0,49,54,-5
QA,SA,2014.0,6,18,-12
HN,GB,2011.0,1,1,0
JP,HU,2013.0,18,8,10
BG,PL,2008.0,4,2,2
PR,US,2017.0,7,6,1
US,BG,2018.0,41,39,2
EC,DE,2017.0,3,9,-6
KZ,TR,2013.0,29,47,-18
KR,VN,2008.0,12,15,-3
NO,VN,2020.0,4,3,1
GB,CO,2017.0,41,51,-10
CR,ZA,2012.0,6,2,4
LV,GB,2019.0,8,8,0
PL,ET,2018.0,3,1,2
TR,FR,2020.0,32,28,4
RU,DK,2010.0,9,3,6
CH,EE,2020.0,8,9,-1
SE,DK,2009.0,133,70,63
SD,ID,2019.0,4,3,1
LB,CN,2020.0,18,10,8
AR,FR,2004.0,22,19,3
DE,SK,2013.0,39,33,6
AG,US,2018.0,4,4,0
GB,CZ,2006.0,30,29,1
IN,FI,2015.0,21,13,8
FR,CZ,2020.0,49,30,19
IT,PK,2018.0,13,5,8
TH,CH,2016.0,2,6,-4
MY,BR,2014.0,72,28,44
CN,PK,2013.0,49,63,-14
CR,nan,2019.0,2,5,-3
nan,BE,2020.0,16,22,-6
MX,CN,2020.0,12,14,-2
CG,FR,2014.0,23,16,7
NL,GH,2016.0,4,2,2
DE,ZA,2001.0,28,16,12
HU,GR,2019.0,3,3,0
IL,IT,2017.0,17,19,-2
US,JM,2009.0,13,10,3
AT,nan,2014.0,20,16,4
UA,BG,2016.0,10,10,0
UA,OM,2018.0,1,2,-1
MC,FR,2006.0,4,3,1
DK,GR,2020.0,5,15,-10
TH,US,2006.0,76,156,-80
HU,JP,2015.0,13,9,4
FR,KE,2016.0,19,4,15
AU,AR,2018.0,15,9,6
AZ,RU,2012.0,9,8,1
CA,BW,2014.0,2,2,0
US,LV,2007.0,2,4,-2
IN,DE,2023.0,11,5,6
US,LA,2016.0,5,2,3
CZ,SE,2020.0,23,12,11
US,KW,2014.0,26,17,9
CA,IT,2005.0,60,66,-6
SY,FR,2006.0,6,4,2
US,BY,2016.0,8,6,2
PL,UA,1999.0,4,8,-4
NL,RU,2013.0,41,37,4
HU,CZ,2004.0,7,2,5
DK,GW,2001.0,3,2,1
SK,IT,2012.0,9,6,3
BR,SE,2017.0,37,19,18
BD,GB,1997.0,4,13,-9
DK,nan,2016.0,13,28,-15
GR,IE,2015.0,6,5,1
IT,nan,2007.0,81,107,-26
nan,KR,2013.0,20,33,-13
KR,FR,2019.0,41,27,14
GR,CZ,2010.0,2,8,-6
TR,AT,2004.0,4,3,1
US,nan,1997.0,68,92,-24
JP,PH,2015.0,31,26,5
MY,TW,2015.0,19,26,-7
GH,KR,2016.0,2,2,0
IQ,IN,2020.0,15,19,-4
BE,MA,2007.0,6,4,2
SG,JP,2001.0,17,20,-3
EC,PT,2018.0,8,9,-1
DZ,IT,2013.0,20,16,4
US,IS,2015.0,26,14,12
GH,CA,2020.0,12,11,1
JP,SE,2023.0,3,3,0
BO,CN,2006.0,7,1,6
IE,IR,2021.0,6,25,-19
KW,NL,2015.0,1,1,0
CZ,LT,2018.0,2,2,0
GR,SE,2015.0,32,6,26
TW,DK,2014.0,6,1,5
EC,CZ,2020.0,1,1,0
IT,JP,1999.0,32,37,-5
GR,PL,2013.0,5,16,-11
RO,HK,2017.0,16,11,5
GB,PA,2001.0,4,1,3
TH,IN,2016.0,16,20,-4
BD,AU,2009.0,15,4,11
US,JO,2022.0,24,40,-16
MX,RU,2012.0,7,6,1
MY,AF,2021.0,4,3,1
CL,CO,2003.0,32,39,-7
KH,JP,2014.0,2,1,1
TR,MD,2016.0,1,1,0
RO,NO,2017.0,7,2,5
IN,BR,2004.0,17,17,0
IN,TH,2019.0,25,16,9
IQ,CA,2021.0,11,9,2
KW,SA,2022.0,14,16,-2
GB,CM,2021.0,7,3,4
SE,RU,2012.0,23,33,-10
CN,TH,2022.0,42,36,6
EC,PE,2021.0,56,33,23
CA,GH,2010.0,3,4,-1
RU,IL,1999.0,16,7,9
KR,GB,2017.0,98,114,-16
RU,MN,2009.0,2,5,-3
CA,LK,2007.0,2,1,1
JP,NO,2008.0,10,6,4
NG,BW,2017.0,2,1,1
CH,ES,2013.0,77,106,-29
IN,UA,2017.0,6,4,2
IS,DK,2019.0,11,11,0
EG,QA,2012.0,13,18,-5
TH,VN,2014.0,9,7,2
SK,DE,2009.0,32,30,2
AM,DK,2015.0,1,1,0
BR,CU,2004.0,5,15,-10
IQ,GB,2017.0,39,102,-63
PK,TW,2021.0,9,2,7
MY,IT,1999.0,16,18,-2
CR,BR,2004.0,2,2,0
NL,IE,1998.0,3,4,-1
UA,BY,2021.0,15,13,2
RO,MD,2020.0,26,8,18
TW,SE,2015.0,5,4,1
CL,SE,2013.0,7,2,5
ZM,GH,2018.0,40,15,25
ES,BO,2008.0,3,5,-2
DK,ES,2011.0,23,21,2
FI,HU,2010.0,6,7,-1
PK,AR,2008.0,9,9,0
BY,JP,2001.0,3,3,0
PL,nan,2014.0,18,9,9
SK,CZ,2000.0,22,13,9
MX,HN,2004.0,16,13,3
CL,IE,2008.0,2,1,1
GB,BD,2002.0,20,16,4
KG,DE,2017.0,2,2,0
BG,JP,2001.0,4,6,-2
MT,US,2016.0,8,7,1
CU,JP,2012.0,1,1,0
SG,IE,2011.0,5,8,-3
FI,nan,2021.0,7,11,-4
ST,BR,2011.0,29,27,2
ES,TR,2008.0,2,7,-5
GR,BG,2019.0,4,5,-1
CH,CZ,2016.0,34,34,0
IN,NP,2011.0,60,53,7
SK,CH,2006.0,5,4,1
CZ,IT,2011.0,22,24,-2
IL,FI,2009.0,4,3,1
NZ,JP,2007.0,14,17,-3
KE,GB,2004.0,12,12,0
IT,IR,2009.0,10,12,-2
RS,PK,2010.0,2,1,1
KR,ET,2001.0,47,86,-39
FI,CH,2004.0,8,6,2
CZ,JP,2016.0,26,15,11
TR,JP,1999.0,34,32,2
CH,LB,2015.0,4,6,-2
AT,RU,2012.0,15,15,0
MY,CZ,2019.0,10,7,3
GB,VE,1999.0,9,3,6
BH,GB,2021.0,4,6,-2
RU,BE,2010.0,13,13,0
RO,JP,1999.0,7,3,4
LB,JO,2021.0,6,3,3
CN,LK,2007.0,5,2,3
FI,BG,2003.0,2,2,0
BR,KE,2022.0,1,4,-3
BG,FR,2012.0,7,10,-3
ZA,FR,2001.0,5,7,-2
KR,MN,2015.0,5,2,3
RU,CL,2001.0,7,2,5
MA,MD,2013.0,4,9,-5
QA,NL,2017.0,6,6,0
NL,RO,1999.0,2,2,0
DE,GR,2014.0,49,85,-36
TN,JO,2021.0,3,4,-1
JP,RO,2006.0,7,4,3
BE,VN,2012.0,8,7,1
LU,IT,2012.0,6,12,-6
CN,UA,2008.0,16,16,0
IN,PH,2012.0,10,14,-4
AR,CU,2010.0,17,14,3
GB,PE,2014.0,11,9,2
AE,PL,2019.0,3,3,0
FR,IR,2004.0,14,7,7
EG,AE,2010.0,14,11,3
US,AE,2001.0,19,15,4
AU,TW,2022.0,14,34,-20
LB,GB,2004.0,2,5,-3
BR,BG,2009.0,2,4,-2
EE,AU,2015.0,2,4,-2
ZA,BG,2020.0,2,1,1
JO,AU,2011.0,3,8,-5
CO,CA,2013.0,21,17,4
MX,IN,2018.0,13,15,-2
KR,FR,2017.0,34,34,0
AE,MY,2018.0,4,19,-15
SE,LT,2003.0,3,5,-2
IN,JO,2004.0,3,2,1
MW,GB,2020.0,24,25,-1
CN,BR,2009.0,35,39,-4
HU,NO,2018.0,8,2,6
KE,CI,2017.0,3,1,2
KW,EG,2000.0,13,5,8
IL,NL,2004.0,13,3,10
KW,IN,2011.0,8,9,-1
DE,PK,2009.0,23,17,6
GB,BN,2011.0,8,2,6
AR,MY,2017.0,4,1,3
CA,RU,1997.0,17,18,-1
CL,MX,1997.0,13,11,2
IS,SE,1999.0,6,7,-1
PT,FI,2018.0,4,9,-5
AF,US,2014.0,3,1,2
SE,EG,2020.0,8,13,-5
DE,IR,2001.0,6,3,3
KW,FR,2020.0,1,6,-5
RS,IL,2006.0,5,2,3
HU,ES,2011.0,9,4,5
DO,CL,2014.0,1,2,-1
KR,ES,2022.0,11,10,1
CU,AR,2007.0,8,5,3
UA,KZ,2002.0,1,1,0
US,TN,2016.0,26,26,0
GB,BW,2020.0,2,1,1
SK,FR,2008.0,5,8,-3
nan,GE,2011.0,8,4,4
FR,BF,1998.0,5,4,1
KZ,RU,2014.0,27,31,-4
SV,CO,2008.0,3,1,2
AR,CU,2017.0,19,13,6
TR,PT,2010.0,3,2,1
IR,SA,2018.0,13,13,0
UY,BR,2003.0,19,17,2
TW,IT,2002.0,1,4,-3
BO,US,2014.0,5,6,-1
PT,BE,2010.0,6,13,-7
DZ,IQ,2020.0,3,2,1
LB,US,2023.0,5,4,1
RO,HK,2010.0,13,13,0
IT,LU,2015.0,16,3,13
DZ,CA,2005.0,5,2,3
IT,NL,2001.0,52,52,0
ZA,BW,2007.0,4,6,-2
LB,CA,2013.0,9,15,-6
CA,TN,2009.0,9,7,2
IS,DK,2010.0,4,9,-5
CZ,KR,2006.0,7,4,3
US,GT,2014.0,9,9,0
MA,US,2000.0,6,8,-2
KR,RU,2000.0,4,4,0
MX,CH,2003.0,4,5,-1
MX,AU,2019.0,15,18,-3
FI,GB,1998.0,15,27,-12
NO,SJ,2006.0,4,3,1
IN,BE,1998.0,5,2,3
DE,QA,2015.0,11,2,9
CA,VE,2001.0,1,1,0
DE,UA,2011.0,18,27,-9
US,KY,2014.0,1,3,-2
BG,MK,2018.0,8,4,4
CN,PH,2011.0,13,27,-14
EG,BE,2016.0,3,6,-3
AU,CR,2017.0,3,4,-1
MY,EC,2016.0,1,1,0
TH,LK,2021.0,5,2,3
EC,GB,2016.0,10,13,-3
US,SI,2020.0,23,22,1
PL,DK,2017.0,11,14,-3
GB,CL,2008.0,16,33,-17
LV,GB,2017.0,4,3,1
JP,CM,2016.0,3,1,2
EC,ES,2013.0,17,70,-53
PL,CA,2001.0,9,9,0
YE,SA,2019.0,16,21,-5
CN,NZ,2002.0,9,20,-11
DK,SI,2022.0,5,1,4
PL,IT,2015.0,30,27,3
PT,MX,2002.0,3,5,-2
DK,CN,1999.0,6,10,-4
FR,UY,2001.0,3,3,0
SK,CN,1999.0,1,1,0
TR,PL,2011.0,4,1,3
QA,FR,2005.0,3,1,2
PL,DK,2010.0,17,10,7
KE,JP,2002.0,3,6,-3
NO,PL,2003.0,1,2,-1
SE,nan,2001.0,55,30,25
CA,RU,1998.0,8,16,-8
NO,AT,2012.0,6,9,-3
SG,DE,2004.0,14,15,-1
PT,nan,2000.0,7,4,3
BY,RU,1997.0,14,7,7
EG,IT,2015.0,10,5,5
NL,UG,2012.0,5,6,-1
EG,FI,2016.0,5,3,2
AT,SI,2008.0,7,5,2
CZ,UA,2002.0,6,6,0
EG,CN,2003.0,8,1,7
BH,CA,2006.0,1,4,-3
RU,FI,2003.0,22,10,12
CH,nan,2008.0,10,19,-9
US,DZ,2012.0,19,24,-5
NL,GR,2016.0,24,43,-19
BE,IN,2008.0,10,15,-5
AR,DE,2000.0,17,13,4
IN,PT,2015.0,22,13,9
IQ,GB,2010.0,8,3,5
CZ,FR,2003.0,18,18,0
NL,EG,2021.0,6,13,-7
DE,BA,2006.0,2,1,1
RU,HU,2009.0,6,8,-2
KR,IR,2016.0,15,17,-2
OM,JO,2018.0,3,6,-3
CZ,BY,2003.0,3,3,0
IT,IQ,2014.0,2,2,0
FJ,AU,2021.0,3,3,0
MG,FR,2000.0,3,1,2
BR,IT,1997.0,28,42,-14
JP,IT,2022.0,24,30,-6
US,TT,2005.0,6,1,5
IE,PL,2018.0,4,7,-3
IE,FR,2001.0,12,16,-4
MN,DZ,2018.0,4,1,3
SE,ZA,2007.0,10,4,6
TT,FR,2010.0,1,1,0
SD,KE,2000.0,1,5,-4
ML,US,2015.0,7,8,-1
US,BS,2018.0,3,4,-1
AT,TR,2000.0,4,9,-5
FR,MY,2005.0,4,8,-4
DE,SI,2000.0,3,7,-4
SK,BG,2014.0,2,1,1
IR,AU,2003.0,4,17,-13
TW,BE,2021.0,7,6,1
CL,CH,2022.0,9,4,5
DZ,MN,2022.0,4,2,2
SA,JO,2012.0,13,35,-22
NO,ZA,2022.0,10,4,6
GR,BG,2010.0,2,2,0
MZ,PL,2002.0,13,4,9
BR,GE,2015.0,4,2,2
IR,AZ,2011.0,4,2,2
BJ,CM,2000.0,4,1,3
nan,UA,2000.0,9,9,0
IL,JP,1998.0,6,6,0
RU,DK,2019.0,12,10,2
DE,HR,2004.0,14,15,-1
BJ,CH,2007.0,1,3,-2
RO,PT,2014.0,2,5,-3
TW,RU,1997.0,5,2,3
SG,KR,2004.0,10,9,1
CL,nan,2014.0,4,9,-5
CL,NL,2002.0,1,3,-2
GB,MT,2006.0,8,4,4
IT,UA,2012.0,22,14,8
MY,SE,2016.0,9,11,-2
TW,FI,2013.0,2,4,-2
PL,DK,2019.0,11,12,-1
ES,SG,2017.0,6,4,2
CZ,TW,2012.0,1,2,-1
CZ,AU,2020.0,11,10,1
AR,MX,1997.0,8,6,2
GB,MY,2022.0,39,78,-39
PK,DE,2016.0,18,42,-24
CA,FI,2021.0,19,16,3
PY,ES,2009.0,5,2,3
PE,CA,2012.0,6,3,3
NO,HR,2019.0,2,3,-1
GF,FR,2001.0,4,1,3
RO,HU,2015.0,33,29,4
KR,IL,2003.0,1,1,0
IT,SA,2023.0,1,2,-1
ID,IR,2022.0,10,7,3
FR,MY,2002.0,4,3,1
TW,AU,2005.0,11,20,-9
FR,JO,2010.0,5,4,1
CZ,GB,2005.0,20,16,4
ES,MY,2012.0,6,4,2
GB,LU,2000.0,1,1,0
IL,CN,1999.0,4,13,-9
NL,AT,2016.0,31,25,6
CH,DK,2005.0,9,13,-4
SG,BR,2011.0,2,5,-3
BE,NG,2020.0,3,4,-1
US,BO,2012.0,3,9,-6
TR,IL,2003.0,5,7,-2
JP,ES,2008.0,29,33,-4
SI,GB,2009.0,12,6,6
CA,EE,2013.0,2,1,1
GR,CL,2020.0,1,1,0
DO,ES,2019.0,4,12,-8
CN,VG,2014.0,3,3,0
PS,IN,2016.0,3,3,0
KR,NG,2021.0,9,3,6
BE,RE,2016.0,2,1,1
EE,BE,2006.0,1,1,0
GB,MA,2016.0,8,6,2
BJ,BF,2019.0,6,3,3
TZ,FR,2004.0,2,2,0
NA,ZA,2022.0,8,7,1
ZM,CN,2011.0,1,2,-1
GH,RU,2020.0,1,2,-1
DE,CI,2010.0,1,1,0
CA,LU,2016.0,5,4,1
EC,PH,2021.0,3,1,2
AR,LU,2015.0,1,1,0
IN,LU,2021.0,5,6,-1
MM,TH,2022.0,8,2,6
RU,KR,2009.0,9,7,2
ET,IT,2020.0,5,5,0
ID,GH,2019.0,14,12,2
MD,TR,2023.0,2,1,1
VE,CA,2022.0,2,2,0
PH,AU,2011.0,12,10,2
ID,TH,2018.0,16,27,-11
TH,JP,2023.0,2,3,-1
BG,SE,2012.0,8,5,3
HU,CA,2010.0,12,9,3
PE,SV,2015.0,3,1,2
JP,CO,2004.0,5,2,3
TH,IE,2018.0,5,2,3
BD,GB,1998.0,11,4,7
ZA,NZ,2021.0,12,16,-4
SN,CA,2010.0,2,2,0
SD,EG,2010.0,3,9,-6
JP,PT,2020.0,7,2,5
GB,QA,2007.0,5,7,-2
US,TZ,2000.0,4,5,-1
DO,ES,2010.0,3,1,2
IN,LB,2015.0,3,3,0
TR,MX,2013.0,3,6,-3
PR,US,2019.0,10,6,4
SG,VN,2009.0,6,5,1
GB,MK,2003.0,1,2,-1
UA,RO,2010.0,2,2,0
TW,RU,1998.0,12,9,3
MZ,PL,2005.0,11,2,9
ZA,AT,2000.0,1,2,-1
BJ,US,2004.0,1,5,-4
GB,NP,2003.0,3,2,1
NG,HU,2002.0,1,1,0
US,BN,2014.0,5,4,1
NZ,DE,2006.0,18,38,-20
BJ,PK,2020.0,2,1,1
EC,DE,2010.0,2,3,-1
US,ET,2023.0,2,2,0
MX,GB,2009.0,51,41,10
CZ,SI,2013.0,8,10,-2
LB,KW,2018.0,3,3,0
FR,NC,2007.0,12,6,6
CL,PK,2019.0,1,1,0
SA,TN,2003.0,2,1,1
BR,RU,2009.0,4,14,-10
UA,ES,2010.0,3,4,-1
ML,CI,2021.0,4,5,-1
US,CI,2016.0,7,5,2
IT,MA,2000.0,6,2,4
PK,CA,2004.0,10,8,2
IT,MX,1997.0,3,6,-3
ES,IS,2011.0,4,4,0
RW,GB,2019.0,2,3,-1
TW,NP,2022.0,1,1,0
GR,KR,2007.0,1,1,0
ET,KE,2015.0,9,4,5
BR,SE,2010.0,19,19,0
US,UY,2004.0,3,12,-9
SZ,BW,2008.0,2,1,1
RU,BE,2019.0,26,20,6
LV,GB,2010.0,2,2,0
ZW,NL,2014.0,3,2,1
RO,DK,2006.0,4,2,2
NL,IE,1997.0,6,4,2
MX,NO,2009.0,3,1,2
SE,ET,2011.0,7,2,5
MX,AU,2010.0,16,8,8
CA,PL,2006.0,21,23,-2
BE,EC,2009.0,3,2,1
AE,CY,2019.0,3,5,-2
GR,DK,2004.0,1,1,0
PL,NL,2003.0,12,14,-2
KW,CA,2010.0,5,8,-3
NG,SA,2001.0,1,2,-1
IL,BE,2012.0,3,3,0
SE,SA,2018.0,10,8,2
GR,SG,2022.0,1,2,-1
NO,NP,2014.0,2,4,-2
IR,TR,2007.0,4,3,1
SA,PS,2019.0,13,8,5
IE,PH,2012.0,1,1,0
AT,JP,2009.0,11,15,-4
SE,PL,1997.0,5,4,1
QA,IT,2018.0,7,9,-2
CH,CU,2011.0,3,3,0
BE,BG,2021.0,7,5,2
TR,BD,2021.0,3,3,0
TR,CY,2003.0,1,2,-1
AR,CN,2008.0,2,3,-1
SA,PS,2017.0,8,8,0
SR,NL,2017.0,1,4,-3
MW,CA,2020.0,1,1,0
HU,AU,2008.0,12,12,0
BE,IE,1999.0,3,3,0
KE,ID,2004.0,1,1,0
JP,UZ,2002.0,3,3,0
DE,MD,2005.0,3,3,0
FI,AR,2001.0,3,1,2
NZ,IL,2010.0,2,2,0
KR,BR,1998.0,4,1,3
EG,FR,2005.0,7,10,-3
MX,AF,2003.0,3,2,1
TW,AU,2002.0,7,11,-4
CO,BO,2015.0,5,13,-8
DK,LU,2014.0,5,3,2
MY,CZ,2017.0,9,22,-13
RO,PK,2021.0,3,1,2
UY,CR,2013.0,5,1,4
CR,CL,2006.0,5,6,-1
FI,PH,2016.0,2,2,0
MX,IL,2001.0,2,1,1
MK,US,2021.0,3,6,-3
nan,TW,2022.0,1,1,0
CR,CU,2017.0,21,23,-2
AT,ID,2011.0,2,1,1
SY,ES,2019.0,1,1,0
DE,VE,2015.0,3,6,-3
OM,GB,2021.0,4,7,-3
NG,CA,2007.0,4,1,3
JP,LK,2021.0,7,8,-1
nan,SK,2010.0,4,1,3
CM,GA,2013.0,1,1,0
MA,SN,2012.0,3,1,2
ES,MD,1998.0,1,1,0
LK,DE,2014.0,2,2,0
SG,NP,2021.0,1,2,-1
CO,TR,2023.0,8,15,-7
SK,BY,2008.0,1,1,0
ES,KE,2009.0,4,2,2
ET,ID,2017.0,1,4,-3
CZ,IE,2022.0,3,3,0
ID,BR,2015.0,7,10,-3
CL,PA,2018.0,4,4,0
RS,CN,2022.0,3,2,1
AU,PH,2003.0,7,6,1
ET,TW,2017.0,3,3,0
CN,BH,2022.0,3,2,1
BH,DE,2019.0,1,1,0
CN,AR,2014.0,5,8,-3
IR,GE,2011.0,1,1,0
SE,RS,2013.0,6,3,3
US,RO,2003.0,21,43,-22
VN,GR,2012.0,4,5,-1
BR,MX,1998.0,14,21,-7
FJ,GB,2008.0,1,1,0
UA,ES,2017.0,5,3,2
KW,CA,2019.0,8,16,-8
OM,TR,2001.0,1,1,0
FI,FR,2008.0,20,14,6
BA,HR,2003.0,2,3,-1
GB,MW,2023.0,1,1,0
ZA,TZ,2012.0,4,1,3
SA,TR,2006.0,3,4,-1
IN,MY,2000.0,12,2,10
CN,HU,2006.0,2,9,-7
CH,CO,2017.0,13,12,1
AR,CZ,2015.0,3,1,2
TH,IT,2008.0,4,1,3
TZ,SE,2013.0,1,3,-2
BF,CA,2019.0,3,4,-1
CH,FI,2021.0,16,14,2
QA,PK,2014.0,2,6,-4
MX,BO,2007.0,4,3,1
CZ,UA,2005.0,3,1,2
NZ,KR,2008.0,3,2,1
EG,DE,2023.0,4,1,3
ET,AU,2012.0,3,1,2
AT,TW,2014.0,3,2,1
KZ,UA,2016.0,5,4,1
RU,BG,2007.0,14,8,6
IS,TR,2012.0,1,1,0
NL,PL,2003.0,14,12,2
DE,AE,2011.0,5,3,2
CU,CN,2021.0,2,3,-1
KE,BE,1999.0,1,2,-1
US,CD,2019.0,5,9,-4
PT,IT,2006.0,14,15,-1
US,MD,2016.0,5,4,1
FI,HU,2019.0,3,3,0
ID,CZ,2014.0,5,7,-2
DK,MX,2003.0,1,1,0
PL,IE,2005.0,4,1,3
MA,GB,2012.0,4,11,-7
AT,CA,1999.0,10,8,2
FI,BE,2004.0,5,5,0
ET,CA,2014.0,2,2,0
UG,KE,2008.0,4,2,2
RO,NO,2010.0,4,1,3
EE,FR,2012.0,5,3,2
SG,IT,2018.0,12,10,2
PT,BE,2019.0,15,18,-3
CO,AE,2018.0,3,1,2
IS,DK,2017.0,6,11,-5
GA,GB,2021.0,1,1,0
CA,CZ,1997.0,4,2,2
US,KZ,2005.0,4,3,1
HU,BE,2001.0,6,6,0
FR,BG,2003.0,6,5,1
ET,PR,2013.0,2,5,-3
AT,GR,2005.0,2,2,0
YE,US,2009.0,2,3,-1
HU,LT,2007.0,1,1,0
HK,JP,2021.0,12,7,5
PH,ES,2002.0,3,4,-1
CM,BE,2006.0,1,1,0
RU,IR,2011.0,10,7,3
KR,NZ,2009.0,2,5,-3
GB,VN,2018.0,22,10,12
MY,PK,2007.0,3,5,-2
AU,CR,2019.0,4,2,2
UY,SE,2022.0,1,1,0
CL,PY,2020.0,8,7,1
EG,NZ,2011.0,1,1,0
TW,CZ,1998.0,2,1,1
PY,BR,2006.0,3,1,2
US,OM,2007.0,6,15,-9
HR,ME,2019.0,2,8,-6
AT,CZ,1999.0,4,5,-1
HU,GR,2017.0,1,7,-6
FR,GP,2020.0,18,19,-1
UA,GE,2016.0,4,1,3
MC,GB,2016.0,2,1,1
VN,FR,2009.0,10,16,-6
AR,RS,2004.0,1,1,0
DE,BD,2019.0,8,16,-8
BG,CA,2011.0,2,5,-3
KR,CZ,1998.0,2,3,-1
UG,NL,2021.0,3,5,-2
LT,CN,2006.0,2,4,-2
FI,HU,2017.0,4,7,-3
SD,DK,2019.0,1,1,0
DO,US,2015.0,6,6,0
UA,FI,1997.0,1,1,0
AE,CH,2019.0,3,3,0
AT,CN,2003.0,4,4,0
IN,BE,1997.0,3,1,2
FR,SY,1998.0,2,1,1
NG,NL,2007.0,3,1,2
QA,FI,2016.0,2,1,1
CR,nan,2017.0,2,3,-1
UA,KZ,2005.0,3,2,1
LT,BE,2013.0,1,2,-1
BH,QA,2012.0,1,1,0
US,YE,2010.0,3,2,1
BF,ML,2008.0,3,6,-3
FR,CO,1997.0,3,1,2
PT,RS,2014.0,4,2,2
IT,MX,1998.0,4,3,1
UY,FR,2001.0,3,3,0
US,FJ,2006.0,3,4,-1
MY,FR,2006.0,4,6,-2
MX,DZ,2014.0,3,2,1
NP,JP,2018.0,12,20,-8
CN,NG,2009.0,2,1,1
TR,UA,2021.0,2,5,-3
AT,TH,2009.0,3,1,2
GR,BG,2017.0,2,4,-2
TW,PK,2019.0,2,2,0
CR,nan,2010.0,2,3,-1
QA,NL,2019.0,4,5,-1
TW,BD,2015.0,3,1,2
BH,JO,2017.0,4,1,3
TW,IL,2007.0,1,1,0
CZ,HR,2021.0,6,7,-1
LK,NL,2015.0,3,2,1
JP,LT,2012.0,4,8,-4
ES,TW,2005.0,1,1,0
CZ,BA,2020.0,2,1,1
PT,ET,2019.0,1,3,-2
TW,NL,2012.0,7,8,-1
CH,HR,2021.0,5,6,-1
DZ,DE,2007.0,3,3,0
HT,US,2012.0,5,3,2
BH,SD,2018.0,2,2,0
ET,TW,2019.0,5,8,-3
EC,RU,2014.0,5,3,2
ZA,PE,2017.0,1,2,-1
ES,nan,2023.0,2,3,-1
HU,UA,2018.0,5,3,2
VN,TH,2014.0,7,9,-2
NG,BW,2019.0,2,3,-1
RU,EG,2023.0,2,1,1
IT,SN,2010.0,1,1,0
JP,UZ,2005.0,2,1,1
IR,MA,2022.0,2,4,-2
CU,GB,2018.0,4,2,2
RO,nan,2019.0,6,4,2
TR,KE,2020.0,2,1,1
US,PY,2007.0,1,1,0
CO,CN,2002.0,2,1,1
JP,HR,2013.0,2,3,-1
US,HN,2019.0,6,5,1
RS,SI,1999.0,3,1,2
SY,IN,2011.0,2,2,0
KR,DK,1997.0,1,2,-1
EE,SE,2008.0,6,8,-2
IR,PL,2009.0,1,3,-2
TW,UA,2005.0,1,3,-2
LT,DE,2022.0,2,5,-3
CH,NG,2006.0,1,3,-2
CD,ZA,2020.0,4,5,-1
CZ,GB,2002.0,11,13,-2
ZA,KW,2007.0,1,1,0
AM,RU,2001.0,3,4,-1
TR,KW,2003.0,2,1,1
LU,NO,2014.0,1,1,0
ES,HR,2009.0,1,3,-2
ES,ZA,2007.0,1,5,-4
VN,KR,1998.0,1,1,0
SE,OM,2019.0,2,1,1
CN,LT,2016.0,5,2,3
PH,PK,2022.0,2,3,-1
CO,CN,2005.0,3,1,2
ES,SG,2010.0,7,2,5
RO,nan,2010.0,2,2,0
IR,BR,2006.0,3,1,2
KR,NL,2000.0,1,4,-3
IT,AZ,2007.0,1,1,0
CA,SI,2007.0,2,3,-1
GP,CA,2012.0,1,1,0
BE,CW,2013.0,1,1,0
CA,CI,2009.0,1,1,0
TR,EG,2010.0,1,1,0
CO,BR,2023.0,4,1,3
IE,RU,1999.0,2,6,-4
RU,GE,2005.0,1,3,-2
TN,MD,2007.0,2,8,-6
NG,PH,2020.0,3,3,0
GR,RO,2000.0,1,3,-2
RO,NO,2019.0,5,2,3
CN,MX,2018.0,7,17,-10
DK,IL,2021.0,4,3,1
ES,TW,2002.0,6,2,4
KE,MY,2019.0,3,3,0
PH,SG,2021.0,5,5,0
KE,CG,2006.0,1,1,0
FR,SY,1997.0,1,2,-1
NZ,IL,2019.0,2,1,1
BR,SD,1998.0,2,2,0
CR,NL,2003.0,2,1,1
KE,RW,2018.0,5,2,3
IL,JP,1997.0,4,4,0
PT,AU,2005.0,8,5,3
GR,CZ,2017.0,11,2,9
US,HN,2017.0,5,7,-2
MA,DE,2011.0,1,10,-9
US,CD,2010.0,4,1,3
FI,SK,2013.0,1,2,-1
DK,SA,2015.0,3,1,2
CN,DZ,2021.0,2,3,-1
GB,BF,2017.0,1,1,0
SD,QA,2020.0,5,3,2
RU,RO,2020.0,2,11,-9
TH,SG,2022.0,2,6,-4
RU,HR,2021.0,4,2,2
ZA,HU,2021.0,3,1,2
NZ,FJ,2006.0,1,2,-1
SC,GB,2013.0,1,1,0
MX,CR,2000.0,1,6,-5
KE,DE,2005.0,3,6,-3
US,MM,2001.0,1,1,0
TW,IE,2004.0,1,1,0
IN,UA,2010.0,1,6,-5
UA,MX,2009.0,1,5,-4
KE,TZ,1999.0,1,1,0
CY,CN,2020.0,2,4,-2
IT,CY,2009.0,3,1,2
GB,FJ,2014.0,3,1,2
JO,TR,2021.0,3,1,2
MN,RU,2022.0,1,2,-1
KH,IN,2018.0,1,4,-3
BH,DE,2017.0,2,1,1
FR,JM,2021.0,1,1,0
CA,CM,2021.0,1,2,-1
DK,AT,1998.0,2,1,1
NG,nan,2016.0,2,8,-6
CH,NZ,2000.0,4,3,1
SI,FI,2015.0,3,2,1
RO,HK,2019.0,3,7,-4
EG,LB,2005.0,3,1,2
AU,GR,2012.0,4,5,-1
RS,FR,2003.0,1,2,-1
BR,MX,1997.0,7,12,-5
BA,US,2015.0,4,5,-1
FR,BF,1997.0,2,3,-1
nan,HU,2005.0,2,3,-1
BR,DO,2019.0,4,4,0
CA,CZ,1998.0,5,5,0
NO,HR,2010.0,2,2,0
GB,KN,2018.0,2,1,1
KW,BR,2018.0,1,1,0
GR,ZA,2002.0,3,1,2
JO,ES,2010.0,1,1,0
CA,BB,2018.0,2,1,1
AE,CA,2006.0,3,10,-7
TW,PK,2017.0,2,2,0
QA,GB,1997.0,1,1,0
EC,NL,2016.0,1,1,0
JP,SI,2000.0,2,1,1
KZ,AM,2021.0,2,2,0
IR,IL,2022.0,3,2,1
TR,QA,2016.0,2,2,0
CD,JP,2004.0,1,1,0
CZ,HU,2012.0,5,5,0
PL,PT,2016.0,4,5,-1
BE,nan,2022.0,13,11,2
PK,BH,2015.0,1,1,0
PT,TR,2014.0,3,2,1
ZW,ET,2012.0,1,1,0
TR,SD,2018.0,3,3,0
IR,NO,2005.0,2,2,0
IR,CY,2021.0,4,7,-3
NL,VN,1998.0,3,3,0
RU,ME,2019.0,1,1,0
SY,IT,2018.0,1,1,0
HR,ME,2010.0,2,3,-1
HN,VN,2014.0,1,1,0
MA,ES,2011.0,8,10,-2
BD,IT,2021.0,2,6,-4
RS,NO,2021.0,2,1,1
KW,PK,2013.0,3,2,1
PS,ID,2018.0,2,2,0
PH,IL,2008.0,2,2,0
PT,FR,2023.0,1,1,0
SG,RU,2009.0,2,3,-1
TJ,RU,2000.0,2,1,1
PY,PE,2022.0,1,1,0
DE,OM,2012.0,3,3,0
CZ,EC,2022.0,1,2,-1
UG,NO,2015.0,3,7,-4
CN,GE,2022.0,2,3,-1
ID,KG,2022.0,1,2,-1
ID,RO,2019.0,3,9,-6
CN,BI,2015.0,1,1,0
EG,ZA,2018.0,7,5,2
NL,AL,2017.0,1,1,0
KE,AU,2011.0,2,6,-4
IL,ES,2001.0,1,4,-3
NZ,CA,2023.0,2,2,0
IL,PL,2003.0,3,1,2
GM,AU,2021.0,1,1,0
BF,CA,2010.0,3,1,2
SN,MA,2013.0,1,2,-1
BN,US,2002.0,1,1,0
IT,SN,2019.0,1,1,0
ZA,TW,2013.0,1,4,-3
BN,IN,2022.0,3,4,-1
RS,DK,2011.0,2,3,-1
IN,AF,2017.0,1,1,0
TR,PT,2019.0,3,3,0
PS,IR,2018.0,1,2,-1
HK,US,2001.0,1,2,-1
LK,NO,2019.0,1,2,-1
AU,PK,1998.0,3,3,0
UA,IL,2001.0,5,4,1
PT,GT,2016.0,2,1,1
CY,TR,2001.0,2,3,-1
ET,ZA,2013.0,4,4,0
CO,PE,2001.0,1,8,-7
JO,DE,1998.0,1,2,-1
KR,MX,2011.0,4,1,3
TW,AT,2003.0,1,3,-2
CN,MG,2015.0,3,4,-1
GB,UY,2013.0,1,4,-3
DK,EE,2020.0,1,5,-4
RO,US,2023.0,2,3,-1
ZA,MX,2000.0,1,1,0
TN,CZ,2021.0,1,2,-1
DE,MK,2015.0,4,5,-1
IE,ET,2019.0,2,1,1
PH,ES,2005.0,4,8,-4
ES,LK,2014.0,4,7,-3
SA,CZ,2022.0,1,1,0
CL,NL,2005.0,2,5,-3
KH,CN,2017.0,1,1,0
AR,KR,2021.0,2,1,1
JP,BW,2017.0,1,1,0
PR,MX,2015.0,2,7,-5
AU,BD,1998.0,2,4,-2
BB,CN,2020.0,1,2,-1
PA,BR,2013.0,2,4,-2
CN,NO,1999.0,2,2,0
AE,TW,2017.0,2,2,0
PT,CV,2012.0,1,1,0
MX,PR,2021.0,3,5,-2
IN,RW,2013.0,3,6,-3
NZ,PK,2009.0,1,1,0
DK,UA,2018.0,1,6,-5
AF,GB,2017.0,1,1,0
NO,UG,2020.0,2,1,1
BR,LU,2013.0,4,1,3
GB,MS,2004.0,2,2,0
CH,VN,2015.0,3,4,-1
EG,MX,2016.0,1,2,-1
MX,UA,2014.0,3,3,0
CH,ID,2022.0,1,4,-3
IT,ID,2001.0,1,1,0
IN,ML,2008.0,3,4,-1
MA,JP,2018.0,1,1,0
GA,BE,2017.0,2,2,0
RW,GB,2017.0,1,3,-2
SI,CH,2009.0,6,4,2
GB,US,2000.0,3368,3492,-124
CO,CL,2007.0,84,80,4
GB,CN,2019.0,688,645,43
GB,DE,2011.0,817,776,41
GB,IN,2019.0,622,689,-67
DE,AT,2016.0,664,633,31
SE,US,1997.0,201,147,54
CO,AR,2019.0,140,144,-4
AR,CO,2021.0,89,91,-2
JP,CH,2010.0,78,84,-6
DE,EG,2006.0,32,19,13
CA,ZA,2021.0,26,54,-28
MX,BR,2014.0,124,94,30
JP,CH,2019.0,82,116,-34
ES,FR,2004.0,160,158,2
BR,ES,2008.0,212,222,-10
KE,PK,2018.0,28,19,9
GB,BE,2021.0,138,130,8
IR,CA,2023.0,19,2,17
NO,BD,2016.0,6,1,5
CN,NZ,2005.0,16,20,-4
JP,NL,2008.0,31,31,0
ET,KR,1999.0,70,49,21
RU,AT,2013.0,17,13,4
BR,CA,2021.0,273,165,108
NG,DE,2019.0,17,22,-5
IN,CN,2014.0,190,155,35
HK,CA,2014.0,5,1,4
KR,GB,2019.0,144,120,24
CN,NP,2009.0,11,4,7
GB,IN,2010.0,352,316,36
ID,RO,2017.0,3,9,-6
AU,SG,2022.0,62,82,-20
UA,BR,2016.0,8,2,6
GB,CO,2019.0,39,35,4
IQ,US,2013.0,8,12,-4
CL,AU,2015.0,17,26,-9
CH,NL,2006.0,64,72,-8
MX,CU,2020.0,60,65,-5
CH,CO,2010.0,7,6,1
NL,BG,2008.0,2,2,0
GT,ES,2017.0,16,13,3
ES,PH,2018.0,28,18,10
GB,TH,2012.0,85,24,61
CA,NZ,2001.0,26,34,-8
NL,CA,1997.0,34,25,9
CL,SV,2021.0,5,3,2
MY,PR,2018.0,1,2,-1
NG,ZA,2022.0,80,64,16
PL,IE,2002.0,1,1,0
US,LK,2013.0,25,32,-7
GY,CA,2012.0,1,1,0
AT,IT,2016.0,57,73,-16
IT,FI,2007.0,9,16,-7
BR,IT,1998.0,29,43,-14
JO,BR,2015.0,22,1,21
TR,GB,2007.0,38,51,-13
KE,US,2014.0,63,75,-12
QA,AU,2009.0,8,8,0
NG,DE,2017.0,9,8,1
KR,TH,2022.0,4,3,1
FR,NO,2003.0,21,33,-12
PH,GB,2013.0,17,18,-1
QA,JP,2022.0,3,2,1
TW,VN,2017.0,30,15,15
BE,SK,2005.0,5,3,2
DE,KR,2009.0,48,37,11
AU,CO,2022.0,10,3,7
GA,BE,2019.0,2,2,0
AT,KE,2018.0,2,2,0
CL,UY,2021.0,17,12,5
SE,PL,1998.0,8,10,-2
IL,ID,2022.0,3,2,1
UA,ES,2019.0,4,4,0
NO,AU,2013.0,9,28,-19
TH,AT,2020.0,2,3,-1
IR,CN,2008.0,16,20,-4
CR,CU,2010.0,7,6,1
GH,DK,2005.0,1,1,0
KP,CN,2022.0,5,4,1
SA,IR,2021.0,12,12,0
NP,CN,2010.0,7,13,-6
NL,CA,1998.0,33,34,-1
AU,IT,2023.0,6,2,4
PH,TH,2012.0,1,2,-1
NG,DE,2010.0,10,5,5
CA,BG,2016.0,5,2,3
HU,SK,2013.0,7,6,1
US,YE,2017.0,2,4,-2
KR,SG,2001.0,9,12,-3
AE,CH,2017.0,2,1,1
GH,IN,2012.0,5,2,3
FR,PE,2003.0,3,1,2
UA,FR,2004.0,10,10,0
CN,CL,2007.0,1,3,-2
CN,PT,2015.0,9,10,-1
BR,ID,2013.0,4,7,-3
ID,GH,2017.0,10,17,-7
MD,RU,2014.0,6,6,0
GR,NL,2000.0,15,8,7
EE,DK,2020.0,5,1,4
IR,SG,2011.0,15,20,-5
CU,CO,2021.0,23,19,4
FI,GB,1997.0,18,12,6
HU,CA,2017.0,7,8,-1
LT,JP,2001.0,4,2,2
TN,SA,2009.0,8,2,6
CZ,RU,2007.0,13,21,-8
QA,TW,2018.0,3,1,2
UA,HU,2018.0,3,5,-2
LK,GB,2001.0,7,4,3
IE,IN,2009.0,12,20,-8
GT,ES,2019.0,14,14,0
ID,NG,2016.0,7,11,-4
NP,AU,2011.0,6,3,3
nan,SK,2017.0,3,2,1
PL,LT,2008.0,2,2,0
AO,BR,2012.0,20,17,3
TZ,AU,2020.0,3,4,-1
BG,GB,2010.0,13,7,6
CH,CO,2019.0,14,11,3
IN,AF,2019.0,4,3,1
UZ,CZ,2011.0,1,2,-1
GR,CN,1999.0,5,1,4
SE,TH,2009.0,6,4,2
IR,FR,2001.0,3,4,-1
ZW,GB,2000.0,2,2,0
CZ,nan,2001.0,7,2,5
NZ,IE,2014.0,17,13,4
SD,ID,2017.0,1,2,-1
nan,CM,2022.0,6,2,4
TW,VN,2010.0,5,5,0
BY,SI,2016.0,2,1,1
TR,DK,2022.0,8,5,3
NL,FJ,2020.0,1,2,-1
BR,IL,2001.0,4,3,1
BR,DO,2017.0,4,1,3
PK,IT,2022.0,13,13,0
IN,UA,2019.0,6,6,0
BY,RU,1998.0,16,10,6
PK,IL,2022.0,1,1,0
BD,SE,2018.0,5,6,-1
ZA,CZ,2013.0,4,5,-1
CZ,IN,2011.0,11,20,-9
KR,AM,2001.0,8,6,2
IN,NG,2013.0,8,23,-15
NI,PE,2012.0,1,2,-1
BR,BJ,2008.0,1,2,-1
GB,LK,2001.0,4,7,-3
FR,BO,2007.0,5,5,0
VE,AR,2000.0,4,3,1
AR,ID,2020.0,4,3,1
CA,TT,2007.0,1,2,-1
MK,CA,2015.0,1,3,-2
CM,TN,2019.0,1,1,0
AE,DE,2016.0,6,12,-6
UA,LT,2014.0,1,2,-1
EG,IR,2021.0,8,13,-5
IL,LB,2019.0,3,3,0
BO,AR,2020.0,5,6,-1
PT,GE,2013.0,1,2,-1
GH,JP,1998.0,1,5,-4
CL,BD,2014.0,1,1,0
KW,AE,2015.0,3,1,2
PL,BY,2015.0,7,3,4
NI,US,2015.0,2,7,-5
RO,AR,2016.0,1,1,0
RU,IS,2016.0,1,2,-1
DE,LB,2006.0,4,2,2
SA,DE,2001.0,1,4,-3
QA,DE,2021.0,5,7,-2
JO,DE,1997.0,3,3,0
PT,PL,2011.0,3,6,-3
RU,MZ,2001.0,1,11,-10
RW,GB,2010.0,1,2,-1
SN,CA,2019.0,3,9,-6
GH,NO,2020.0,2,5,-3
CU,VE,2001.0,3,2,1
MM,NZ,2018.0,2,2,0
AU,ID,2018.0,148,64,84
FR,ES,2013.0,285,329,-44
NL,BE,2015.0,300,278,22
RU,nan,2010.0,50,48,2
NO,US,2001.0,53,69,-16
GB,CY,2014.0,49,26,23
CA,IN,2002.0,102,90,12
TH,NP,2016.0,4,5,-1
PK,KE,2013.0,16,8,8
VN,JP,2008.0,18,25,-7
DE,BH,2018.0,1,1,0
PH,MY,2018.0,5,2,3
BE,MG,2008.0,1,1,0
IT,EG,2014.0,9,6,3
SE,AT,2000.0,4,6,-2
BE,RO,2000.0,3,7,-4
CH,RS,2006.0,7,1,6
HU,IE,2011.0,2,1,1
BR,KR,1998.0,1,4,-3
CN,MM,2006.0,4,9,-5
NG,MA,2021.0,1,3,-2
GB,KE,2007.0,16,14,2
DE,FI,2001.0,20,28,-8
,CA,2002.0,8776,0,8776
IR,,2014.0,2334,0,2334
,KR,1996.0,3860,0,3860
,CA,2005.0,9764,0,9764
,KR,2004.0,4900,0,4900
AU,,2017.0,5638,0,5638
NL,,2024.0,41142,0,41142
AU,,2010.0,2823,0,2823
,MY,2007.0,2448,0,2448
BE,,2021.0,4430,0,4430
ES,,2022.0,26497,0,26497
KR,,2020.0,5880,0,5880
IT,,2022.0,22339,0,22339
PK,,2014.0,342,0,342
,MX,2013.0,5556,0,5556
IN,,1999.0,1318,0,1318
,TR,1995.0,3156,0,3156
,CH,2009.0,3863,0,3863
,IT,2006.0,11859,0,11859
AR,,2011.0,783,0,783
SE,,2009.0,1568,0,1568
RO,,2025.0,966,0,966
AU,,2019.0,7296,0,7296
PT,,2016.0,911,0,911
,SE,2008.0,2901,0,2901
CA,,2001.0,2249,0,2249
GT,GB,2014.0,2,0,2
,AT,2003.0,1814,0,1814
,UA,1999.0,1514,0,1514
,VE,2002.0,396,0,396
,PL,2005.0,4371,0,4371
NZ,,2012.0,573,0,573
,NZ,2008.0,1247,0,1247
,KH,2005.0,27,0,27
,RU,2016.0,17222,0,17222
,NP,2011.0,460,0,460
,IE,2006.0,1380,0,1380
SA,,2021.0,2261,0,2261
AT,,2009.0,859,0,859
,PL,2002.0,4177,0,4177
,nan,2006.0,854,0,854
,VE,2005.0,518,0,518
,HR,2016.0,752,0,752
LB,,2021.0,536,0,536
,BA,2012.0,319,0,319
ZA,,2012.0,770,0,770
MA,,2020.0,1112,0,1112
,RS,2011.0,1245,0,1245
,BY,2013.0,339,0,339
IE,,2005.0,263,0,263
,VN,2011.0,400,0,400
PA,,2013.0,32,0,32
nan,,2009.0,369,0,369
SN,,2024.0,687,0,687
QA,AE,2003.0,2,0,2
VE,,2000.0,79,0,79
SE,BH,2014.0,1,0,1
HK,,2016.0,62,0,62
GR,,2003.0,418,0,418
MW,,2024.0,559,0,559
,PH,2001.0,280,0,280
,GR,2015.0,2234,0,2234
IE,,2002.0,217,0,217
HR,,2005.0,93,0,93
,IQ,2014.0,899,0,899
,CY,2005.0,117,0,117
PS,,2013.0,25,0,25
,BW,2014.0,100,0,100
RU,PH,2012.0,1,0,1
,ZW,2005.0,89,0,89
VN,,2014.0,109,0,109
,MW,2014.0,107,0,107
,AM,2015.0,139,0,139
ID,DK,2002.0,2,0,2
,LB,2016.0,545,0,545
VE,CH,2011.0,1,0,1
,PK,2020.0,304,0,304
AZ,,2005.0,24,0,24
US,KN,1999.0,1,0,1
,CY,2002.0,65,0,65
HU,,1998.0,173,0,173
,BH,2015.0,102,0,102
,GP,2013.0,37,0,37
PL,NA,2017.0,1,0,1
,ME,2012.0,52,0,52
,GA,2015.0,38,0,38
MG,,2024.0,294,0,294
NZ,MW,2002.0,1,0,1
MY,SI,2011.0,3,0,3
,KE,1995.0,278,0,278
HU,RS,2003.0,6,0,6
,AE,2009.0,253,0,253
NI,,2020.0,44,0,44
BG,NZ,2018.0,1,0,1
BW,,2008.0,16,0,16
LB,nan,2014.0,1,0,1
OM,KW,2020.0,4,0,4
HR,,2002.0,74,0,74
KE,IE,2022.0,2,0,2
NO,PE,2022.0,1,0,1
,BG,2018.0,402,0,402
AT,NZ,1999.0,1,0,1
AZ,,2002.0,6,0,6
FR,AF,2020.0,1,0,1
GA,MA,2012.0,1,0,1
VG,IT,2018.0,2,0,2
nan,PH,2020.0,1,0,1
IL,TR,2021.0,4,0,4
SI,,2003.0,69,0,69
YE,IQ,2016.0,4,0,4
VN,SG,2006.0,3,0,3
,BD,2003.0,239,0,239
TO,,2022.0,2,0,2
RU,,2026.0,29,0,29
MT,EG,2014.0,1,0,1
,ZW,2002.0,62,0,62
UY,,2004.0,23,0,23
EE,,2004.0,29,0,29
LU,TH,2014.0,1,0,1
UA,EE,2006.0,1,0,1
VG,,2012.0,15,0,15
BY,GB,2001.0,3,0,3
ML,,2013.0,11,0,11
,XK,2004.0,50,0,50
CH,RO,2023.0,1,0,1
TN,MX,2010.0,8,0,8
CN,TJ,2020.0,5,0,5
NC,ES,2005.0,1,0,1
SK,nan,2016.0,4,0,4
SG,BH,2020.0,1,0,1
IS,,2003.0,20,0,20
LR,,2013.0,3,0,3
,AO,2012.0,33,0,33
LV,EE,2023.0,1,0,1
ES,MN,2019.0,1,0,1
KW,,2016.0,109,0,109
,BI,1997.0,11,0,11
IN,PS,2002.0,1,0,1
,MZ,2001.0,26,0,26
,RE,1997.0,17,0,17
,RE,1998.0,16,0,16
KE,ES,2022.0,2,0,2
ZA,TR,2016.0,1,0,1
CY,NZ,2016.0,1,0,1
RU,GE,2002.0,3,0,3
MK,,2014.0,46,0,46
,PR,1999.0,21,0,21
BE,UG,2023.0,1,0,1
PA,UY,2020.0,1,0,1
SI,FR,2023.0,1,0,1
NL,QA,2006.0,2,0,2
GT,DE,2016.0,1,0,1
,NI,2013.0,45,0,45
NG,CO,2007.0,2,0,2
LS,DE,2015.0,1,0,1
ST,,2020.0,11,0,11
MT,NL,2021.0,1,0,1
AU,BW,2003.0,2,0,2
GR,AR,2016.0,1,0,1
IR,QA,2009.0,3,0,3
UY,PG,2014.0,1,0,1
MA,GP,2013.0,2,0,2
FI,VN,2005.0,1,0,1
NL,CM,2018.0,3,0,3
NO,RO,2021.0,4,0,4
,CF,2009.0,7,0,7
AU,BB,2010.0,1,0,1
PT,VE,2001.0,2,0,2
BZ,CA,2010.0,1,0,1
KE,,1999.0,33,0,33
CN,ZA,2023.0,5,0,5
MK,SK,2011.0,1,0,1
,PY,1994.0,31,0,31
AU,LT,2021.0,2,0,2
GM,NP,2018.0,1,0,1
AL,US,2004.0,2,0,2
,CW,1995.0,14,0,14
PH,CI,2012.0,1,0,1
GB,GA,1999.0,2,0,2
NO,KE,2004.0,2,0,2
CI,SE,2012.0,1,0,1
IN,IE,2023.0,4,0,4
IN,PL,2000.0,6,0,6
CN,KH,2012.0,1,0,1
IL,BY,2010.0,1,0,1
YE,,2015.0,15,0,15
GB,HT,2015.0,1,0,1
BJ,CG,2020.0,3,0,3
VE,HU,2003.0,1,0,1
AU,MZ,2019.0,1,0,1
PY,QA,2015.0,2,0,2
CH,SL,2020.0,1,0,1
,VG,2015.0,14,0,14
AT,LU,2004.0,1,0,1
,NA,2003.0,9,0,9
PA,AU,2011.0,3,0,3
IE,NG,2016.0,4,0,4
BH,JO,2010.0,1,0,1
NZ,PE,2009.0,1,0,1
TT,FR,2019.0,2,0,2
CR,,2007.0,22,0,22
RO,IL,2020.0,3,0,3
,KH,2002.0,21,0,21
AU,UA,2004.0,1,0,1
AU,ZM,1999.0,1,0,1
,XK,1996.0,4,0,4
PR,US,2010.0,7,0,7
MT,TR,2015.0,1,0,1
,NC,2001.0,7,0,7
CN,AM,2005.0,2,0,2
MD,SE,2003.0,1,0,1
NZ,PR,2008.0,2,0,2
DE,GP,1998.0,1,0,1
CN,AL,2012.0,3,0,3
JP,PE,2012.0,4,0,4
WS,AU,2010.0,1,0,1
IS,BE,1997.0,1,0,1
BA,DK,2013.0,1,0,1
NG,EE,2020.0,2,0,2
BJ,TR,2020.0,2,0,2
UZ,CA,2002.0,1,0,1
QA,IQ,2014.0,3,0,3
nan,ET,2020.0,6,0,6
FO,,2016.0,2,0,2
CM,PK,2013.0,1,0,1
MT,AU,2006.0,1,0,1
PL,BR,1999.0,2,0,2
KR,BO,2019.0,1,0,1
MZ,AM,2022.0,1,0,1
CL,GT,2003.0,2,0,2
PK,BF,2000.0,1,0,1
GT,CA,2006.0,1,0,1
KW,BD,2011.0,2,0,2
HU,BD,2010.0,2,0,2
GE,JP,2021.0,1,0,1
MQ,,2016.0,28,0,28
CU,DZ,2008.0,1,0,1
BJ,GH,2014.0,1,0,1
AT,SA,2005.0,2,0,2
,AG,2009.0,3,0,3
DE,MT,2005.0,2,0,2
OM,NL,2015.0,2,0,2
NZ,OM,2017.0,3,0,3
,GL,2008.0,3,0,3
DE,VG,2005.0,1,0,1
UG,ZW,2013.0,3,0,3
AZ,SI,2014.0,2,0,2
CA,PA,2011.0,1,0,1
PR,VN,2011.0,1,0,1
RE,BE,2017.0,3,0,3
ES,ET,2014.0,5,0,5
CH,NC,2013.0,1,0,1
CA,GD,2009.0,2,0,2
AU,SI,2003.0,2,0,2
CA,KN,2015.0,1,0,1
KG,TW,2016.0,1,0,1
LK,AE,2017.0,1,0,1
MT,,2011.0,7,0,7
BD,BR,2008.0,1,0,1
CZ,MY,1997.0,1,0,1
SS,,1998.0,2,0,2
AO,SE,2007.0,1,0,1
MY,HU,2012.0,1,0,1
AT,EC,2016.0,3,0,3
PH,FI,2018.0,1,0,1
SM,US,2021.0,2,0,2
NZ,BG,2010.0,1,0,1
IE,CL,2016.0,3,0,3
ET,GR,2019.0,1,0,1
MK,SE,2002.0,1,0,1
PT,PH,2016.0,6,0,6
CO,VN,2018.0,2,0,2
VN,UG,2014.0,1,0,1
MM,GB,2007.0,1,0,1
YE,SA,2010.0,2,0,2
ID,KW,2022.0,3,0,3
KI,PK,2018.0,1,0,1
SS,PE,2019.0,1,0,1
CM,IN,2022.0,3,0,3
,SS,2006.0,11,0,11
TZ,QA,2018.0,1,0,1
BE,SG,2007.0,3,0,3
HU,MY,2013.0,2,0,2
PK,PE,2013.0,2,0,2
ID,CH,2012.0,1,0,1
DO,,2009.0,5,0,5
,LI,2013.0,6,0,6
IE,UY,2017.0,2,0,2
CZ,PH,2012.0,1,0,1
PE,EC,2007.0,1,0,1
MD,BG,2021.0,1,0,1
MX,PH,1997.0,1,0,1
DO,RU,2017.0,1,0,1
MU,CA,2002.0,2,0,2
GM,BE,1997.0,1,0,1
BY,IL,2009.0,1,0,1
IL,BY,2017.0,1,0,1
MZ,AU,2016.0,1,0,1
AT,NA,2023.0,1,0,1
AU,NP,2003.0,2,0,2
PE,NL,1999.0,1,0,1
TR,LY,2010.0,1,0,1
MD,RS,2013.0,1,0,1
KR,IE,2000.0,1,0,1
VG,IE,2009.0,1,0,1
BO,BE,2014.0,1,0,1
GR,MT,2014.0,1,0,1
IT,KE,2009.0,2,0,2
,BT,2001.0,2,0,2
BE,JO,2011.0,1,0,1
CU,CZ,2015.0,2,0,2
NE,CA,2002.0,1,0,1
NE,KE,2000.0,1,0,1
IE,ET,2017.0,1,0,1
HR,QA,2022.0,1,0,1
SD,CH,1999.0,1,0,1
BJ,KE,2018.0,2,0,2
BD,NL,2016.0,6,0,6
SL,SA,2015.0,1,0,1
MY,OM,2001.0,1,0,1
CI,MA,2005.0,1,0,1
CH,CD,2021.0,1,0,1
BG,GD,2012.0,1,0,1
PK,LT,2021.0,2,0,2
JP,CI,2021.0,1,0,1
IN,AF,2010.0,2,0,2
US,GY,2016.0,2,0,2
EG,ET,2005.0,1,0,1
PH,BR,2023.0,2,0,2
RO,MX,2014.0,1,0,1
PL,LV,2023.0,1,0,1
DJ,,2023.0,3,0,3
TR,PK,2005.0,2,0,2
SI,BY,2011.0,3,0,3
GH,BF,2018.0,3,0,3
TW,PR,2021.0,1,0,1
HU,PF,2012.0,1,0,1
CL,SG,2013.0,2,0,2
CF,CM,2016.0,1,0,1
EG,AL,2017.0,1,0,1
PK,PH,2001.0,1,0,1
GT,BR,2007.0,1,0,1
IE,KW,2021.0,2,0,2
SK,EG,2010.0,1,0,1
FR,PK,2004.0,6,0,6
TH,ZW,2017.0,1,0,1
CR,PA,2006.0,1,0,1
,BI,1998.0,6,0,6
YE,JO,2011.0,1,0,1
TD,,2006.0,1,0,1
PH,NI,2016.0,1,0,1
BH,TN,2018.0,2,0,2
CN,MW,2019.0,3,0,3
AE,PK,1999.0,1,0,1
AU,EC,2016.0,1,0,1
TN,ET,2012.0,1,0,1
TD,BJ,2019.0,1,0,1
IE,ET,2010.0,1,0,1
GP,IN,2020.0,1,0,1
SY,TN,2008.0,1,0,1
SV,FR,2016.0,2,0,2
US,MQ,2013.0,1,0,1
KN,,2016.0,4,0,4
SD,NG,2016.0,2,0,2
UZ,GB,2020.0,1,0,1
VE,AU,2011.0,2,0,2
SE,PK,1997.0,1,0,1
SD,NL,2013.0,1,0,1
IE,KR,2005.0,1,0,1
SI,BA,2007.0,3,0,3
MA,TZ,2016.0,1,0,1
TW,LT,2013.0,2,0,2
DE,PS,2012.0,6,0,6
ER,EG,2018.0,1,0,1
IR,LT,2021.0,3,0,3
BE,BF,2023.0,1,0,1
LT,IQ,2012.0,1,0,1
,MO,2000.0,2,0,2
SN,CG,1999.0,1,0,1
GE,AU,2008.0,2,0,2
HU,MM,2021.0,1,0,1
MQ,DE,1997.0,1,0,1
YE,KW,2010.0,1,0,1
CD,NO,2021.0,1,0,1
EC,LU,2019.0,1,0,1
SD,ID,2010.0,1,0,1
IR,LB,2023.0,1,0,1
CM,CI,2001.0,1,0,1
PA,DE,2003.0,1,0,1
EG,IS,2023.0,1,0,1
EE,BY,2014.0,1,0,1
CM,GF,2008.0,1,0,1
IN,GY,2019.0,2,0,2
CY,PS,2018.0,2,0,2
UZ,AE,2014.0,1,0,1
TZ,BD,2020.0,2,0,2
BO,BJ,2004.0,1,0,1
TR,OM,2021.0,2,0,2
PF,,2009.0,5,0,5
IL,AM,2015.0,2,0,2
CI,MY,2000.0,1,0,1
IR,GD,2014.0,1,0,1
ID,PT,2022.0,1,0,1
DK,QA,2004.0,1,0,1
DE,EC,2002.0,1,0,1
NA,FR,1997.0,1,0,1
BH,DE,2010.0,2,0,2
PL,QA,2013.0,1,0,1
SD,ES,2017.0,1,0,1
NL,KG,2018.0,1,0,1
IR,UG,2023.0,1,0,1
PL,ZM,2015.0,1,0,1
SG,CO,2022.0,2,0,2
MA,LU,2012.0,1,0,1
CZ,IS,2021.0,1,0,1
MA,TR,2011.0,2,0,2
CR,PE,2002.0,2,0,2
JP,OM,2021.0,1,0,1
DE,GD,2020.0,1,0,1
SN,MY,2011.0,1,0,1
DJ,EG,2011.0,1,0,1
IL,TH,2002.0,1,0,1
AR,SG,2019.0,1,0,1
ZA,PH,2002.0,2,0,2
DZ,FI,2011.0,1,0,1
IL,RS,2015.0,1,0,1
ES,CY,2002.0,1,0,1
SE,SJ,2014.0,1,0,1
CV,,2018.0,3,0,3
EC,BY,2005.0,1,0,1
NL,VG,2013.0,1,0,1
BY,BR,2022.0,1,0,1
ME,PL,2011.0,1,0,1
PS,JP,2013.0,1,0,1
TT,NG,2016.0,1,0,1
KR,GH,2023.0,1,0,1
FJ,IN,1997.0,1,0,1
RO,CO,2015.0,2,0,2
AU,TN,2017.0,2,0,2
AU,TN,2019.0,1,0,1
GR,PS,2020.0,1,0,1
CR,PE,2005.0,2,0,2
AF,CH,2009.0,1,0,1
CD,DE,2021.0,1,0,1
AU,KG,2020.0,1,0,1
AU,SJ,2018.0,1,0,1
SA,MT,2021.0,1,0,1
BH,nan,2014.0,1,0,1
CO,BE,2000.0,1,0,1
TH,MY,1999.0,1,0,1
CA,BN,2013.0,1,0,1
SS,CN,2012.0,2,0,2
MY,UZ,2003.0,1,0,1
NG,TT,1998.0,1,0,1
IR,NL,1998.0,1,0,1
BT,JP,2015.0,1,0,1
MX,ZM,2021.0,1,0,1
TT,GE,1999.0,1,0,1
DK,BG,2000.0,2,0,2
NZ,PG,2006.0,1,0,1
AT,GA,1998.0,1,0,1
UG,AE,2014.0,1,0,1
BJ,BF,2010.0,1,0,1
AE,IL,2019.0,1,0,1
CH,GT,2018.0,1,0,1
MN,CR,2018.0,1,0,1
NC,HU,2012.0,1,0,1
DO,AR,2006.0,1,0,1
BE,EE,2007.0,1,0,1
SN,UA,2019.0,1,0,1
IN,BF,2018.0,1,0,1
SL,BE,2022.0,1,0,1
AT,QA,2018.0,1,0,1
SD,LB,2016.0,1,0,1
AT,DZ,2012.0,1,0,1
BN,CN,2008.0,1,0,1
AT,TJ,2019.0,2,0,2
CL,KW,2005.0,1,0,1
BR,PA,2005.0,1,0,1
PF,US,1998.0,2,0,2
NZ,OM,2019.0,2,0,2
CZ,TH,2012.0,2,0,2
US,BJ,2007.0,2,0,2
CV,PE,2008.0,1,0,1
GT,US,1998.0,1,0,1
AM,UA,2003.0,1,0,1
TW,PK,2010.0,1,0,1
UZ,SE,2018.0,1,0,1
GW,,2009.0,1,0,1
CM,BJ,2001.0,3,0,3
IR,UA,2006.0,1,0,1
EC,FI,2014.0,1,0,1
ES,PK,2000.0,1,0,1
PL,AE,2015.0,1,0,1
ID,SY,2013.0,1,0,1
KW,PS,2018.0,1,0,1
GB,JE,2015.0,1,0,1
RE,NO,2022.0,1,0,1
UA,CZ,1999.0,1,0,1
SD,DE,2023.0,1,0,1
CZ,VN,2000.0,2,0,2
UZ,KG,2020.0,2,0,2
LV,DE,2006.0,3,0,3
RE,AU,2020.0,1,0,1
ML,ZA,2014.0,2,0,2
AE,TW,2019.0,1,0,1
KW,PL,2002.0,1,0,1
RS,PH,2005.0,1,0,1
PH,DK,2006.0,2,0,2
PG,IN,1997.0,1,0,1
JM,MD,2000.0,1,0,1
MX,BJ,2000.0,2,0,2
SS,DE,2009.0,1,0,1
EC,CU,2007.0,1,0,1
TW,GT,2021.0,1,0,1
KR,SN,2007.0,1,0,1
AZ,IN,2023.0,1,0,1
UA,RO,2017.0,3,6,-3
AE,MX,2015.0,2,1,1
BN,ID,2018.0,1,4,-3
SI,AT,2006.0,1,2,-1
LT,CH,2003.0,1,1,0
VE,PA,2011.0,2,2,0
NO,SA,1998.0,1,1,0
TR,BE,1999.0,2,3,-1
KW,JP,1998.0,1,1,0
KE,MY,2010.0,2,1,1
CN,MW,2017.0,2,1,1
ES,RS,2014.0,2,4,-2
TR,IE,2006.0,1,1,0
ES,EE,2014.0,2,2,0
US,TT,2002.0,1,7,-6
KE,GH,2013.0,1,2,-1
CZ,ID,2012.0,2,2,0
KP,US,2022.0,1,2,-1
PY,PT,2018.0,1,3,-2
PL,CL,2015.0,4,5,-1
IL,TW,2005.0,3,1,2
IN,ID,2008.0,1,4,-3
DE,CI,2019.0,2,1,1
EG,IN,2004.0,3,4,-1
ID,JO,2020.0,5,3,2
IN,TH,2010.0,1,5,-4
CG,MA,2019.0,1,3,-2
FR,PH,2001.0,1,4,-3
RE,BE,2019.0,1,2,-1
FR,CO,1998.0,4,1,3
ZA,MY,2000.0,1,1,0
UA,FI,1998.0,1,1,0
MZ,BY,2011.0,1,3,-2
NZ,CL,2007.0,1,1,0
MX,FI,2022.0,2,2,0
PE,RU,2021.0,4,7,-3
ZA,ZM,2011.0,1,3,-2
DK,LT,2003.0,2,1,1
JP,BW,2019.0,1,1,0
TR,AE,2007.0,1,2,-1
HU,GR,2010.0,1,3,-2
AT,BR,2001.0,1,1,0
nan,VE,2006.0,1,1,0
AE,CY,2017.0,1,1,0
SE,OM,2017.0,2,1,1
DE,CI,2017.0,2,2,0
AU,MZ,2017.0,1,1,0
IT,CI,2004.0,1,1,0
EE,RU,2006.0,1,2,-1
SD,JO,2018.0,1,2,-1
MY,MX,2015.0,1,1,0
PK,TH,1998.0,1,1,0
CA,ID,2004.0,1,6,-5
TR,BN,2019.0,1,1,0
TJ,DE,2015.0,1,1,0
AM,TW,2013.0,1,1,0
BE,SN,2014.0,2,3,-1
HN,CU,2012.0,1,2,-1
UA,MY,2009.0,2,1,1
IL,PS,2009.0,1,1,0
IL,SE,2023.0,1,1,0
BH,JO,2019.0,1,3,-2
AR,IL,2016.0,2,6,-4
DK,FO,2020.0,3,2,1
BR,RS,2006.0,1,2,-1
GB,PS,2004.0,1,1,0
HN,CO,1998.0,1,1,0
JP,UY,2000.0,1,1,0
GM,US,2006.0,2,2,0
SA,ZA,1999.0,1,1,0
BO,SE,2012.0,1,3,-2
TR,TH,2006.0,1,2,-1
TR,PT,2017.0,2,2,0
NE,BF,2016.0,1,1,0
UG,IE,2022.0,1,1,0
NO,HR,2017.0,1,2,-1
SE,IL,2004.0,1,2,-1
AE,NO,2022.0,1,1,0
CL,PK,2017.0,1,2,-1
IR,IE,2006.0,1,3,-2
IL,CO,2022.0,1,2,-1
ID,NL,1999.0,1,3,-2
NO,ET,2007.0,2,2,0
MA,BE,2003.0,1,7,-6
RS,ES,2000.0,1,1,0
SA,AE,2023.0,2,2,0
AO,ES,2014.0,2,3,-1
FR,JO,2017.0,3,3,0
CZ,GR,2011.0,2,2,0
AT,GR,2002.0,1,2,-1
KZ,SA,2013.0,1,1,0
TR,CA,1999.0,1,11,-10
PK,DK,2007.0,1,1,0
US,YE,2019.0,3,4,-1
NP,GB,2001.0,1,3,-2
TR,BG,2006.0,1,1,0
KE,JP,2005.0,3,6,-3
BG,HU,2005.0,2,1,1
JO,ES,2017.0,2,2,0
EG,PL,2000.0,1,1,0
CL,VN,2004.0,1,1,0
CZ,EE,2022.0,1,1,0
DK,AT,1997.0,1,1,0
DE,BJ,2015.0,1,2,-1
MW,DE,2013.0,1,1,0
EG,NP,2021.0,2,1,1
NZ,IL,2017.0,1,4,-3
EG,DK,2000.0,1,3,-2
MX,BE,2009.0,4,6,-2
HU,BY,2016.0,3,3,0
EG,BH,2003.0,2,2,0
AF,DE,2020.0,2,1,1
DE,SA,2008.0,3,4,-1
MY,BN,2008.0,1,5,-4
BG,GR,2022.0,1,1,0
KE,BH,2003.0,1,5,-4
RE,GB,2008.0,1,1,0
CA,HK,2005.0,1,3,-2
GB,BB,2001.0,1,1,0
LV,BE,2001.0,1,1,0
BE,CZ,2003.0,2,3,-1
SE,LA,2011.0,1,3,-2
EG,FR,2002.0,2,3,-1
KH,CN,2010.0,2,2,0
ZA,SG,2014.0,2,3,-1
JO,ES,2019.0,1,1,0
IR,RU,2003.0,1,1,0
BW,GB,2013.0,1,3,-2
EE,CZ,2022.0,1,1,0
BF,BE,2022.0,2,9,-7
UG,GH,2021.0,1,2,-1
SG,GH,2015.0,1,1,0
PT,HU,2008.0,1,2,-1
ET,JP,2007.0,1,2,-1
TW,EC,2018.0,1,1,0
AZ,GB,2019.0,1,1,0
AU,MX,2001.0,1,3,-2
MY,DK,2021.0,1,5,-4
nan,HU,2002.0,1,3,-2
AU,CR,2010.0,1,1,0
CO,RO,2014.0,2,1,1
CO,UG,2019.0,1,2,-1
KE,DE,2002.0,1,5,-4
SE,PA,2015.0,1,3,-2
IE,MY,2006.0,1,2,-1
IQ,TR,2013.0,1,1,0
AZ,GB,2017.0,1,4,-3
SA,JP,2000.0,1,1,0
LY,JP,2013.0,1,1,0
BE,VE,2020.0,1,3,-2
PG,GB,2012.0,1,1,0
MD,BE,1999.0,1,1,0
GB,CU,2016.0,1,5,-4
CY,IR,2014.0,1,3,-2
JO,OM,2004.0,1,3,-2
AT,LI,2003.0,1,1,0
AU,PK,1997.0,1,3,-2
NP,NG,2007.0,1,1,0
TH,DK,2004.0,1,1,0
DE,MW,2018.0,1,1,0
NO,RS,2012.0,1,2,-1
DK,CY,2022.0,1,1,0
TN,AE,2006.0,1,1,0
PR,GB,2018.0,1,1,0
US,TJ,2014.0,1,1,0
PT,SG,2015.0,1,1,0
LU,FI,2020.0,1,4,-3
LB,SY,2016.0,1,2,-1
DE,MG,2016.0,1,2,-1
EG,NO,2021.0,1,2,-1
RU,SI,2012.0,1,2,-1
PK,JO,2016.0,1,1,0
KE,MY,2017.0,1,2,-1
NZ,VN,2023.0,1,1,0
nan,TR,2023.0,1,1,0
KZ,BE,2022.0,1,1,0
RO,VN,2018.0,1,2,-1
IN,SY,2022.0,1,2,-1
JP,ZW,2021.0,1,1,0
NG,ZM,2003.0,1,1,0
NL,IR,2003.0,3,3,0
AR,MY,2010.0,1,1,0
US,ZM,1999.0,1,1,0
BJ,BF,2017.0,1,2,-1
nan,SK,2019.0,1,3,-2
DO,ES,2017.0,3,12,-9
BE,CO,2009.0,3,1,2
AE,CH,2010.0,1,1,0
NL,NZ,2001.0,2,8,-6
CI,GH,2021.0,1,1,0
DK,RS,2009.0,1,2,-1
TN,MX,2019.0,1,1,0
BI,CN,2020.0,1,1,0
EG,IE,2006.0,1,1,0
TW,CZ,1997.0,1,1,0
IS,EG,2006.0,1,1,0
KG,TR,2011.0,1,1,0
KE,CM,2013.0,1,3,-2
EC,GR,2009.0,1,4,-3
IR,KW,2012.0,1,2,-1
SD,ES,2019.0,1,2,-1
SR,NL,2019.0,1,4,-3
PT,AE,2022.0,1,2,-1
TW,UA,2002.0,1,3,-2
BA,IN,2015.0,1,0,1
ZM,IT,2003.0,1,0,1
NL,DZ,2008.0,1,0,1
UZ,KR,2012.0,2,0,2
AT,GH,2000.0,1,0,1
BY,IT,2020.0,1,0,1
BJ,MX,2018.0,1,0,1
SA,NZ,2006.0,1,0,1
SE,PY,2021.0,1,0,1
AG,,2012.0,1,0,1
HR,LU,2013.0,1,0,1
BA,TR,2005.0,1,0,1
RO,HR,2003.0,1,0,1
MX,BZ,2011.0,1,0,1
HK,SG,2005.0,1,0,1
MT,ES,2003.0,1,0,1
HU,CW,2010.0,1,0,1
GM,BJ,2014.0,1,0,1
CY,AE,2007.0,1,0,1
KE,TH,2007.0,1,0,1
TN,BD,2014.0,1,0,1
GF,CA,2008.0,1,0,1
GB,BF,2010.0,1,0,1
PT,LT,2018.0,1,0,1
PT,HK,2018.0,1,0,1
ID,KE,2001.0,1,0,1
UY,SA,2019.0,1,0,1
KR,CD,2020.0,1,0,1
RS,MT,2015.0,1,0,1
LY,IQ,2007.0,1,0,1
SV,VE,2003.0,2,0,2
GB,BF,2019.0,1,0,1
BO,,1998.0,1,0,1
DK,BF,2002.0,1,0,1
IR,SK,2021.0,2,0,2
NI,CA,2015.0,1,0,1
ML,CU,2014.0,1,0,1
HN,UY,2019.0,2,0,2
BE,MY,1999.0,1,0,1
NZ,CM,1997.0,1,0,1
UY,AT,2009.0,1,0,1
VN,RU,2004.0,1,0,1
JP,BW,2010.0,1,0,1
CM,IT,2004.0,1,0,1
GR,EG,2008.0,3,0,3
PT,DZ,2013.0,1,0,1
HU,MA,2001.0,1,0,1
SS,AU,2000.0,1,0,1
HU,CU,2016.0,2,0,2
PA,CN,2009.0,1,0,1
BA,,1999.0,1,0,1
KW,NO,2008.0,1,0,1
PL,VI,1998.0,1,0,1
DZ,MX,2018.0,2,0,2
US,TG,2014.0,1,0,1
NG,GD,2018.0,1,0,1
PL,PH,2019.0,1,0,1
LV,DK,1997.0,1,0,1
JO,VN,2019.0,1,0,1
SR,,2016.0,2,0,2
BE,CM,2001.0,1,0,1
CO,TH,2013.0,1,0,1
DZ,GP,2014.0,1,0,1
SA,AZ,2021.0,1,0,1
TN,SG,2020.0,1,0,1
,LS,1999.0,3,0,3
TD,CM,2012.0,1,0,1
GR,UZ,2016.0,1,0,1
ML,MY,2020.0,1,0,1
GH,CH,2013.0,3,0,3
AT,SZ,2006.0,1,0,1
IT,SN,2017.0,1,0,1
BA,FR,2001.0,1,0,1
CL,YE,2012.0,1,0,1
GD,KN,2016.0,1,0,1
LB,OM,1999.0,1,0,1
PY,,1998.0,2,0,2
NI,CR,2011.0,1,0,1
MZ,CZ,2011.0,1,0,1
IE,MU,2014.0,1,0,1
GH,LK,2008.0,1,0,1
UY,KZ,2004.0,1,0,1
HK,IT,2011.0,1,0,1
JP,GT,2011.0,1,0,1
NO,FO,1998.0,1,0,1
NP,ET,2020.0,1,0,1
RU,CU,1999.0,1,0,1
JE,GB,2002.0,1,0,1
TH,FJ,2013.0,1,0,1
UG,JO,2021.0,1,0,1
AT,BS,2019.0,1,0,1
AO,RO,2013.0,1,0,1
DZ,HR,2019.0,1,0,1
KE,LS,2000.0,1,0,1
CL,IS,2012.0,1,0,1
NG,HU,2005.0,1,0,1
KW,DK,2009.0,1,0,1
NE,US,2022.0,1,0,1
CN,TG,2014.0,1,0,1
IL,SV,2018.0,1,0,1
UA,SG,2015.0,1,0,1
PL,MN,2013.0,1,0,1
MY,SN,2017.0,1,0,1
TH,SY,2006.0,1,0,1
IE,KR,2002.0,1,0,1
MM,ZW,2021.0,1,0,1
CA,HK,2002.0,1,0,1
IT,TG,2021.0,1,0,1
MD,JP,2012.0,1,0,1
FI,JO,2001.0,1,0,1
LS,CN,2017.0,1,0,1
GN,NL,2018.0,1,0,1
HU,MT,2019.0,1,0,1
VN,MG,2012.0,1,0,1
NC,BD,2018.0,1,0,1
BJ,TN,2011.0,1,0,1
CO,RU,2000.0,1,0,1
ZA,MK,2010.0,1,0,1
HU,GE,2016.0,1,0,1
SA,SY,2007.0,1,0,1
AT,GT,2000.0,1,0,1
BF,KE,2012.0,1,0,1
BG,MD,2017.0,1,0,1
VN,EC,2020.0,1,0,1
MO,AO,2000.0,1,0,1
NG,MX,2000.0,1,0,1
BS,NZ,2022.0,1,0,1
EG,LT,2023.0,1,0,1
MY,KE,2006.0,1,0,1
MZ,FR,1998.0,1,0,1
FR,MN,1998.0,1,0,1
SY,ES,2017.0,1,0,1
NA,BW,2022.0,1,0,1
TT,EG,1999.0,1,0,1
PK,LB,2023.0,1,0,1
TN,MR,2017.0,1,0,1
HU,LB,2006.0,1,0,1
TM,RU,2002.0,1,0,1
AR,AT,2000.0,2,0,2
ER,BW,2012.0,1,0,1
LT,NZ,2018.0,1,0,1
SN,AT,2000.0,1,0,1
HU,CW,2017.0,1,0,1
PF,NC,2017.0,1,0,1
IN,GY,2017.0,1,0,1
IN,TN,2003.0,1,0,1
GL,DE,2018.0,1,0,1
BR,GP,2020.0,1,0,1
CY,IT,2003.0,1,0,1
BN,US,2005.0,1,0,1
US,LS,2012.0,1,0,1
NG,PL,2002.0,1,0,1
LU,,2000.0,2,0,2
SA,RS,2010.0,1,0,1
SG,CL,2008.0,1,0,1
SY,KZ,2017.0,1,0,1
JP,DZ,2021.0,1,0,1
DE,JE,2013.0,1,0,1
AU,MT,2003.0,2,0,2
DZ,EG,2002.0,1,0,1
US,ME,2015.0,1,0,1
AR,QA,2012.0,1,0,1
PH,HR,2008.0,1,0,1
TW,ZW,2009.0,1,0,1
BE,SI,2003.0,1,0,1
GR,EC,2003.0,1,0,1
CZ,EG,2008.0,1,0,1
NL,GT,2008.0,1,0,1
MG,PT,2018.0,1,0,1
SI,CL,2012.0,1,0,1
EG,FJ,2021.0,1,0,1
GT,HN,2000.0,1,0,1
BW,CA,2001.0,1,0,1
AE,IL,2017.0,1,0,1
KG,DE,2010.0,1,0,1
BJ,KR,2002.0,1,0,1
RS,PT,2003.0,1,0,1
US,KH,1999.0,1,0,1
MG,TN,2019.0,1,0,1
nan,RW,2016.0,1,0,1
ZA,LU,1999.0,1,0,1
RE,CI,2008.0,1,0,1
IL,LV,2014.0,1,0,1
PA,FI,2015.0,1,0,1
US,AG,2023.0,1,0,1
MY,CL,2010.0,1,0,1
AT,CY,2013.0,1,0,1
AO,DE,2013.0,1,0,1
FR,SL,2016.0,1,0,1
MY,MT,2015.0,1,0,1
VN,CO,2001.0,1,0,1
VG,CN,2001.0,1,0,1
IE,BW,2013.0,1,0,1
SS,IL,2012.0,1,0,1
TH,IL,2015.0,1,0,1
ZM,MW,2001.0,1,0,1
MM,IE,2015.0,1,0,1
IE,BB,2019.0,1,0,1
SE,BI,2019.0,1,0,1
TH,FI,2000.0,1,0,1
IE,BD,2001.0,1,0,1
AL,BR,2011.0,1,0,1
NZ,TN,2020.0,1,0,1
SG,JO,2018.0,1,0,1
LT,HU,2020.0,1,0,1
IS,RS,2008.0,1,0,1
CM,NL,2001.0,1,0,1
FI,CL,2009.0,1,0,1
HU,AM,2017.0,1,0,1
CN,LV,2008.0,1,0,1
UY,CO,2003.0,1,0,1
CH,CF,2015.0,1,0,1
US,JE,2010.0,1,0,1
BW,NZ,2000.0,1,0,1
BR,TN,2020.0,1,0,1
LA,SE,2012.0,1,0,1
KE,CI,2019.0,1,0,1
PT,BD,2005.0,1,0,1
MK,BG,2000.0,1,0,1
LB,PK,2012.0,1,0,1
AU,HK,1999.0,1,0,1
KE,AE,2017.0,1,0,1
SN,IR,2009.0,1,0,1
KP,IT,2022.0,1,0,1
KR,LT,2007.0,1,0,1
GE,CH,2004.0,1,0,1
KR,CO,2004.0,1,0,1
UG,BD,2014.0,1,0,1
SG,AR,2006.0,1,0,1
PF,CA,2006.0,1,0,1
NG,NZ,2006.0,1,0,1
TN,KW,2014.0,1,0,1
MX,MC,2009.0,1,0,1
CL,AF,2009.0,1,0,1
HU,CD,2020.0,1,0,1
IQ,ES,2017.0,1,0,1
ES,MD,1997.0,1,0,1
RE,BE,2010.0,1,0,1
JP,FJ,2007.0,1,0,1
BY,IR,2020.0,1,0,1
GT,VE,2016.0,1,0,1
JP,BT,2013.0,1,0,1
MY,BH,2002.0,1,0,1
XK,TR,2022.0,2,0,2
EG,LB,2002.0,1,0,1
RO,UY,2008.0,1,0,1
KR,LV,2012.0,1,0,1
UZ,ID,2022.0,1,0,1
ET,SO,2022.0,1,0,1
TN,US,2023.0,1,0,1
NZ,WS,2020.0,1,0,1
FI,OM,2015.0,1,0,1
PY,CN,2006.0,1,0,1
AO,CO,2009.0,1,0,1
BY,UZ,2008.0,1,0,1
LK,MM,2018.0,1,0,1
BR,FR,2015.0,234,235,-1
BR,ES,2013.0,337,389,-52
CA,US,1999.0,1845,1489,356
IL,US,2007.0,492,387,105
DE,GB,2011.0,776,817,-41
CH,DE,2019.0,914,1062,-148
ES,FR,2014.0,393,290,103
CH,DE,2017.0,750,1085,-335
AR,BE,2017.0,11,7,4
US,IT,2020.0,965,1025,-60
CN,US,2016.0,5042,5697,-655
US,ES,2022.0,600,639,-39
JP,DE,2011.0,210,192,18
US,NO,2007.0,135,77,58
ID,US,2019.0,222,438,-216
GB,US,2023.0,133,188,-55
KR,ES,2016.0,17,7,10
GB,IN,2018.0,590,593,-3
NZ,US,2003.0,224,230,-6
US,PT,2006.0,118,91,27
CN,JP,2007.0,386,690,-304
KR,VN,2013.0,46,26,20
MY,GB,2010.0,46,145,-99
IS,US,2004.0,9,19,-10
SG,BN,2016.0,7,1,6
JP,KR,2020.0,371,374,-3
PH,US,2020.0,339,228,111
JP,VN,2012.0,50,22,28
MX,DE,2005.0,20,18,2
CA,BR,2012.0,299,266,33
GB,MY,2016.0,184,112,72
JP,CH,2018.0,112,102,10
CL,DE,2016.0,53,61,-8
ID,US,2010.0,49,64,-15
FR,AU,1999.0,43,32,11
US,DE,2005.0,1891,1922,-31
AU,GB,2013.0,1138,1511,-373
IN,KR,2001.0,37,23,14
MY,BN,2013.0,4,8,-4
PT,ES,2021.0,154,148,6
US,DE,2002.0,1687,1806,-119
RS,BA,2011.0,18,11,7
NZ,GB,2005.0,153,199,-46
AR,CL,2016.0,114,102,12
DE,AT,2022.0,405,293,112
US,PK,2022.0,221,328,-107
SG,KR,2014.0,35,37,-2
GB,CN,2018.0,726,592,134
FR,MX,2007.0,39,36,3
CH,DE,2010.0,653,874,-221
UY,PT,2020.0,7,2,5
CN,SA,2020.0,65,61,4
KR,GB,2018.0,148,89,59
CN,DE,2004.0,152,194,-42
AT,DE,1999.0,205,225,-20
DE,FI,2003.0,37,31,6
PE,nan,2012.0,10,9,1
DE,RU,2023.0,6,10,-4
BD,SA,2021.0,34,27,7
nan,ZA,2002.0,5,1,4
FR,SN,2016.0,43,34,9
MX,CL,1997.0,11,13,-2
IN,CA,2004.0,125,111,14
ES,IE,2015.0,51,23,28
EG,SA,2016.0,315,403,-88
HU,CA,2018.0,9,11,-2
MY,BR,2004.0,68,71,-3
PT,GB,2020.0,96,90,6
PY,CO,2019.0,11,15,-4
ES,CO,2008.0,220,240,-20
EC,CL,2002.0,2,2,0
CZ,US,2009.0,126,128,-2
JP,IN,2007.0,138,112,26
NL,FI,2011.0,35,30,5
CR,MX,2012.0,27,29,-2
US,IE,2008.0,402,339,63
SE,FI,1999.0,33,47,-14
UA,IT,2010.0,24,9,15
PK,US,2012.0,173,185,-12
nan,TR,2000.0,3,3,0
BD,US,2021.0,135,134,1
SG,US,2020.0,477,500,-23
DE,HR,2014.0,31,22,9
NL,HK,2012.0,11,16,-5
NZ,CH,2015.0,25,11,14
US,SG,2014.0,414,394,20
CR,CU,2018.0,39,19,20
TW,SG,2018.0,51,45,6
PA,GB,2006.0,4,4,0
AU,SG,2016.0,133,111,22
DE,CA,2007.0,266,183,83
TR,IL,2001.0,4,3,1
IN,SE,2009.0,42,14,28
NL,CH,2013.0,120,70,50
GB,PT,2013.0,90,98,-8
EG,US,2002.0,73,60,13
EG,US,2005.0,81,100,-19
BR,AR,2000.0,20,39,-19
JP,NO,2013.0,11,14,-3
SV,CO,2013.0,3,3,0
AU,NZ,2020.0,196,236,-40
BE,GB,2010.0,115,101,14
MX,CZ,2020.0,10,3,7
JP,NZ,2006.0,14,11,3
SG,JP,2003.0,16,19,-3
PL,CZ,1999.0,11,11,0
GB,CL,2013.0,42,38,4
JP,MY,2012.0,59,32,27
MX,BR,2004.0,35,30,5
RU,JP,2002.0,50,39,11
SG,CA,2011.0,32,34,-2
CZ,LT,2010.0,32,4,28
BE,IT,2011.0,66,136,-70
GR,FR,2012.0,37,26,11
KR,ET,2003.0,71,83,-12
CO,GB,2012.0,27,23,4
BR,NL,2019.0,76,63,13
AU,MY,2011.0,80,58,22
PK,SA,2021.0,82,82,0
JP,SE,2000.0,30,25,5
TR,US,2001.0,169,226,-57
GB,NL,2004.0,151,175,-24
IN,BR,2014.0,31,29,2
SG,NL,2006.0,7,4,3
JP,IT,2016.0,58,78,-20
DE,BD,2018.0,13,14,-1
CL,BR,2020.0,121,148,-27
US,AR,2016.0,268,251,17
BE,GB,2019.0,179,186,-7
CN,EG,2012.0,11,33,-22
IN,BD,2018.0,165,158,7
GB,ID,2020.0,89,74,15
PK,CA,2014.0,29,40,-11
ZM,GH,2017.0,29,31,-2
nan,JP,2021.0,27,12,15
DE,NZ,2009.0,39,38,1
DZ,FR,2019.0,136,210,-74
BE,CN,2003.0,78,19,59
CH,GB,2013.0,269,335,-66
ES,IN,1998.0,6,7,-1
KE,PK,2019.0,35,10,25
EC,CL,2005.0,5,3,2
GB,CH,2009.0,208,216,-8
FR,EG,2011.0,27,24,3
DE,MN,2020.0,4,1,3
CN,KZ,2013.0,10,7,3
OM,AE,2002.0,2,3,-1
CN,FI,2007.0,18,16,2
IE,AU,2018.0,119,140,-21
NP,US,2006.0,9,10,-1
CN,PK,2008.0,47,72,-25
IT,AM,2014.0,29,26,3
AT,ES,2013.0,22,31,-9
CN,CI,2014.0,1,1,0
TH,CN,2013.0,19,14,5
PK,AE,2023.0,10,1,9
US,KW,2004.0,19,7,12
RO,US,2000.0,31,20,11
IN,DK,2021.0,21,20,1
PT,AE,2016.0,2,2,0
IT,PK,2019.0,20,16,4
IR,NZ,2020.0,31,8,23
US,CZ,2014.0,179,140,39
BR,GB,2015.0,225,217,8
CN,MK,2006.0,10,2,8
CH,CZ,2022.0,19,12,7
DE,PL,2015.0,146,116,30
BE,nan,2016.0,18,30,-12
NG,AE,2020.0,6,1,5
CH,IT,1997.0,59,67,-8
NZ,GB,2002.0,126,131,-5
NL,TR,2016.0,39,29,10
MX,CL,1998.0,18,19,-1
SG,TW,2005.0,23,28,-5
IT,EG,2004.0,5,2,3
JP,EG,2004.0,46,42,4
MY,GB,2019.0,137,164,-27
IT,FR,2015.0,433,338,95
RO,TW,2021.0,1,1,0
PH,CO,2012.0,4,3,1
US,JO,2016.0,70,53,17
US,MY,2004.0,37,25,12
EG,AE,2018.0,44,50,-6
IR,BO,2015.0,3,2,1
nan,BR,2021.0,106,150,-44
SE,IT,2009.0,69,71,-2
FR,KE,2022.0,3,1,2
KR,IR,2022.0,8,17,-9
SG,GB,2021.0,119,125,-6
GB,TW,2009.0,46,57,-11
ZA,NL,2010.0,36,38,-2
PL,DE,2022.0,69,70,-1
US,BG,2010.0,25,27,-2
VE,CO,2017.0,79,43,36
RO,HK,2018.0,7,12,-5
PA,NI,2013.0,1,1,0
TH,BR,2012.0,3,1,2
BE,CA,2020.0,70,58,12
US,AT,2022.0,136,135,1
BA,SK,2020.0,2,4,-2
PH,IN,2008.0,5,6,-1
TR,AT,2014.0,9,9,0
IN,ZA,2007.0,20,17,3
SA,SD,2016.0,17,40,-23
CA,ID,2014.0,15,13,2
GB,VN,2019.0,22,15,7
IT,NL,2003.0,52,49,3
DZ,FR,2017.0,98,193,-95
JP,BR,2015.0,54,42,12
AR,BE,2019.0,11,14,-3
TR,PT,2018.0,6,3,3
EG,IN,2014.0,8,12,-4
RO,FR,2009.0,36,41,-5
RU,nan,2018.0,42,55,-13
EE,SE,2013.0,8,8,0
GR,US,2001.0,83,103,-20
JP,DK,2006.0,16,13,3
SE,CZ,2005.0,12,3,9
RU,BE,2018.0,21,19,2
ZA,AU,1999.0,24,17,7
SE,IR,2019.0,46,68,-22
NL,TZ,1998.0,5,1,4
FR,RO,1998.0,10,8,2
PE,ES,2015.0,153,113,40
UG,US,2018.0,32,35,-3
CZ,IE,2016.0,5,5,0
FR,DK,2004.0,27,17,10
AE,DE,2022.0,8,4,4
IN,TH,2018.0,28,14,14
EG,IQ,2021.0,94,75,19
SY,ES,2018.0,3,1,2
HU,BE,2003.0,8,5,3
PT,FI,2019.0,7,2,5
ID,BG,2020.0,3,3,0
MA,MX,2013.0,1,1,0
CL,PA,2017.0,8,4,4
AE,CH,2018.0,2,4,-2
IL,HU,2015.0,3,5,-2
IL,PL,2001.0,2,5,-3
FR,ET,2006.0,4,2,2
DE,ZA,2003.0,27,24,3
SE,AU,2007.0,44,48,-4
DE,NO,2020.0,108,77,31
MX,IN,2017.0,16,22,-6
IN,RW,2008.0,5,4,1
PL,DK,2018.0,16,12,4
PS,US,2015.0,13,7,6
JP,CZ,2006.0,17,13,4
DE,BG,2012.0,25,22,3
ES,PS,2022.0,8,7,1
AU,ID,2017.0,128,54,74
NP,EG,2016.0,3,3,0
AR,FR,2014.0,100,92,8
PT,BE,2018.0,24,12,12
PK,GB,2008.0,55,61,-6
IQ,GB,2018.0,29,149,-120
CA,MX,2020.0,37,54,-17
GR,DK,2014.0,17,6,11
LT,DE,2016.0,8,5,3
ZA,CN,2020.0,25,15,10
MX,VE,2014.0,40,46,-6
LR,US,2021.0,3,4,-1
IT,UG,2015.0,2,5,-3
SG,DE,2014.0,43,45,-2
nan,IT,2004.0,63,54,9
CN,HK,2022.0,118,125,-7
nan,TW,2016.0,3,3,0
LV,ZA,2019.0,1,1,0
BF,US,2021.0,7,1,6
RU,UZ,2021.0,49,35,14
SK,FR,2013.0,7,14,-7
BD,CN,2011.0,69,51,18
CO,PT,2014.0,11,16,-5
IN,ID,2013.0,17,13,4
RU,DE,1998.0,118,95,23
MX,AU,2018.0,21,13,8
TR,MD,2022.0,14,1,13
FI,FR,2013.0,23,24,-1
AM,TW,2008.0,2,1,1
TW,VN,2018.0,37,17,20
FI,IT,2017.0,29,28,1
NZ,CA,2000.0,34,35,-1
BJ,KE,2017.0,1,2,-1
CN,ET,2017.0,5,18,-13
YE,SA,2018.0,17,11,6
JO,SA,2022.0,20,24,-4
PS,IR,2019.0,1,1,0
AU,ID,2019.0,126,67,59
RU,IQ,2021.0,6,4,2
AR,CN,2013.0,3,4,-1
IR,SA,2017.0,11,13,-2
EE,FI,2012.0,10,17,-7
ES,SG,2018.0,9,15,-6
TR,DK,2016.0,6,11,-5
ZM,GH,2019.0,44,24,20
UA,US,2022.0,35,38,-3
GB,VN,2017.0,18,13,5
RU,PL,2011.0,22,16,6
ZA,NL,2017.0,55,44,11
BF,FR,2012.0,11,16,-5
CR,nan,2018.0,3,5,-2
KR,KP,2022.0,2,6,-4
CH,IE,2006.0,13,4,9
ID,RW,2021.0,1,1,0
AT,IT,2022.0,48,51,-3
nan,CH,2021.0,19,14,5
TW,EG,2021.0,24,24,0
MY,GB,2017.0,113,163,-50
ET,TW,2018.0,6,6,0
ES,PE,2023.0,3,2,1
IN,UA,2018.0,6,2,4
SD,EG,2018.0,50,20,30
US,NP,2022.0,43,60,-17
NO,TH,2021.0,3,1,2
GB,TZ,2021.0,9,20,-11
MQ,FR,2021.0,8,9,-1
PK,DE,2022.0,24,21,3
GB,CY,2004.0,12,3,9
AE,IQ,2021.0,18,13,5
EG,TW,2019.0,27,28,-1
US,BA,2022.0,5,2,3
PA,EC,2020.0,7,6,1
US,BR,2013.0,1141,952,189
BD,SE,2017.0,11,5,6
ZA,FR,2003.0,9,18,-9
IN,CN,2004.0,69,57,12
JP,ES,2013.0,35,34,1
PH,CN,2017.0,33,17,16
SE,BR,2011.0,13,17,-4
IT,SK,2021.0,6,2,4
SE,SA,2017.0,13,9,4
GB,SA,2016.0,164,75,89
KE,PK,2017.0,21,13,8
TH,TW,2020.0,14,19,-5
DE,RO,2011.0,28,28,0
ES,PH,2019.0,22,19,3
CN,MX,2010.0,4,7,-3
GB,KR,2021.0,76,112,-36
NL,ZA,2021.0,28,44,-16
IQ,CN,2021.0,6,11,-5
BR,NL,2017.0,71,46,25
CH,US,2006.0,554,642,-88
VE,CO,2019.0,76,49,27
CL,PA,2010.0,4,1,3
NO,FR,2020.0,68,59,9
UA,DE,2011.0,27,18,9
AU,CH,2014.0,73,80,-7
BY,US,2009.0,10,8,2
IT,CZ,2005.0,17,15,2
TN,PK,2011.0,2,2,0
IN,NO,2009.0,22,13,9
SK,US,2012.0,32,22,10
IR,US,2003.0,26,55,-29
IE,ET,2018.0,2,1,1
ID,GH,2018.0,23,19,4
IR,CN,2013.0,22,23,-1
FR,RS,2020.0,7,12,-5
US,LK,2008.0,14,11,3
FI,CH,2014.0,22,22,0
PL,AZ,2011.0,1,1,0
FR,PK,2014.0,34,5,29
MY,SG,2008.0,21,51,-30
CN,UA,2013.0,16,17,-1
PL,CN,2004.0,19,10,9
KR,ZA,2012.0,3,6,-3
FR,NO,2001.0,29,21,8
IL,NL,2014.0,6,10,-4
NL,PL,2001.0,4,9,-5
BE,CD,2015.0,11,9,2
PH,CA,2016.0,13,12,1
IT,CZ,2002.0,17,33,-16
BR,IR,2021.0,8,9,-1
DE,SA,2013.0,35,18,17
MX,IN,2010.0,12,8,4
MX,IN,2019.0,17,25,-8
MA,CH,1999.0,1,2,-1
NE,US,2016.0,2,4,-2
BG,BE,2011.0,9,7,2
RU,DE,1997.0,77,86,-9
DZ,US,2007.0,6,7,-1
CO,IN,2005.0,1,1,0
VE,CO,2010.0,53,32,21
NG,GB,2008.0,22,18,4
NO,CN,2021.0,29,23,6
RU,CO,2016.0,3,8,-5
KR,EG,2007.0,6,2,4
UA,IT,2019.0,52,9,43
NL,FR,2004.0,129,127,2
PK,ZA,2001.0,2,2,0
ES,nan,2000.0,8,8,0
NL,IN,2005.0,15,25,-10
GR,NL,2023.0,2,1,1
BG,MK,2017.0,2,2,0
SE,AR,2012.0,7,6,1
GB,LK,2003.0,9,5,4
PE,IL,2011.0,1,1,0
DE,SK,2008.0,38,28,10
IE,IT,2015.0,20,37,-17
ES,BO,2013.0,15,8,7
US,TH,2004.0,140,58,82
NL,RU,2008.0,28,36,-8
FI,BE,2014.0,9,14,-5
XK,PL,2011.0,5,3,2
NG,US,2009.0,35,28,7
IL,IT,2018.0,25,24,1
CO,CA,2008.0,15,7,8
EC,UA,2002.0,7,5,2
FR,BZ,2008.0,8,10,-2
AU,NL,2011.0,56,83,-27
DK,CA,2007.0,25,23,2
TN,CA,2012.0,7,18,-11
ZA,UG,2017.0,13,10,3
KR,IT,2007.0,8,4,4
RU,CA,2015.0,27,38,-11
DE,HU,2012.0,59,60,-1
KE,US,2004.0,25,27,-2
JP,IR,2013.0,23,23,0
MX,PT,2013.0,19,17,2
PL,AU,2005.0,8,7,1
NO,US,2003.0,59,96,-37
SD,MY,2011.0,3,4,-1
TZ,CH,2021.0,7,6,1
ZA,UG,2010.0,4,5,-1
VE,CL,2015.0,29,11,18
IR,FR,2003.0,5,6,-1
JP,FR,2023.0,7,6,1
ID,TH,2017.0,10,15,-5
UY,BR,2001.0,14,12,2
BR,NL,2010.0,41,37,4
GB,CO,2018.0,31,30,1
BJ,FR,2002.0,4,13,-9
FR,HU,2005.0,14,22,-8
GH,US,2006.0,8,8,0
GH,KR,2022.0,1,2,-1
AU,IT,2000.0,16,24,-8
US,BS,2010.0,4,3,1
KR,TH,2016.0,13,18,-5
QA,SA,2004.0,2,5,-3
SI,IT,2015.0,9,11,-2
ZA,IT,1997.0,4,1,3
DE,AM,2011.0,5,9,-4
GB,IQ,2022.0,24,21,3
GB,JO,2006.0,14,9,5
SE,nan,2003.0,38,42,-4
HU,NO,2017.0,6,7,-1
CA,TH,2015.0,27,14,13
MY,IQ,2014.0,48,31,17
VN,RU,2014.0,8,6,2
ID,AZ,2012.0,5,10,-5
RO,VN,2010.0,7,2,5
DE,SD,2015.0,6,4,2
MY,ID,2008.0,18,18,0
NI,CO,2017.0,9,6,3
NA,ZA,2016.0,4,12,-8
NL,RS,2020.0,12,8,4
TR,ZA,2015.0,6,2,4
PK,AR,2013.0,25,16,9
QA,EG,2022.0,36,32,4
TR,GR,2011.0,3,8,-5
GB,NO,2022.0,73,56,17
UA,IT,2017.0,28,38,-10
CA,RS,2015.0,25,4,21
US,TN,2022.0,11,13,-2
CN,ET,2019.0,17,18,-1
PL,IL,2016.0,7,8,-1
SE,IR,2010.0,27,26,1
CY,NL,2021.0,3,1,2
AT,SI,2013.0,11,11,0
BG,MK,2019.0,5,3,2
EE,US,2011.0,7,8,-1
IT,PK,2017.0,20,8,12
AM,US,2008.0,9,5,4
SE,SA,2019.0,8,7,1
SN,SA,2019.0,2,1,1
US,UY,2014.0,27,18,9
GF,BE,2019.0,1,1,0
GB,OM,2021.0,7,4,3
SG,IN,2008.0,42,44,-2
BG,NL,2007.0,5,1,4
NG,nan,2022.0,10,7,3
SE,IR,2017.0,39,45,-6
CH,IT,1998.0,62,96,-34
ET,GB,2021.0,7,14,-7
RU,FR,1998.0,38,41,-3
PR,KR,2000.0,34,12,22
NL,GR,2022.0,15,11,4
NL,BR,2015.0,56,60,-4
EG,KW,2015.0,13,17,-4
ZA,UG,2019.0,16,14,2
MD,FR,2011.0,56,49,7
DK,BR,2015.0,18,28,-10
IE,PL,2019.0,7,7,0
TG,CN,2022.0,2,1,1
GB,HR,2013.0,17,26,-9
HN,US,2008.0,5,1,4
SG,ID,2012.0,7,4,3
BA,GB,2020.0,2,2,0
NO,EE,2015.0,4,3,1
HU,DE,2016.0,75,54,21
US,BY,2022.0,7,7,0
ES,PH,2017.0,15,10,5
JP,CO,2014.0,10,15,-5
VN,MX,2012.0,3,5,-2
PL,NL,2001.0,9,4,5
NO,AU,2008.0,9,10,-1
FR,SA,2006.0,5,2,3
IR,JP,2009.0,20,26,-6
AT,KE,2019.0,1,2,-1
RO,CH,2008.0,3,7,-4
GR,PL,2008.0,10,11,-1
SI,CZ,2006.0,5,5,0
GB,YE,2010.0,3,1,2
FI,IT,2019.0,18,48,-30
AU,CO,2016.0,10,19,-9
TZ,SE,2008.0,8,1,7
LT,BE,2008.0,3,1,2
AT,SK,2004.0,15,10,5
CO,PE,2003.0,6,14,-8
BR,MY,2004.0,71,68,3
DK,FR,2002.0,18,17,1
PL,SI,2015.0,2,9,-7
BG,MK,2010.0,3,1,2
TR,IR,2011.0,6,9,-3
CZ,IR,2009.0,2,2,0
MX,CH,2001.0,2,5,-3
OM,JO,2017.0,5,2,3
PH,GB,2008.0,13,11,2
KE,GB,2014.0,22,47,-25
IQ,US,2008.0,3,3,0
SA,DE,2003.0,4,6,-2
PL,PT,2022.0,5,2,3
TT,US,2012.0,9,4,5
KW,CA,2018.0,14,14,0
UA,IL,2003.0,3,4,-1
CZ,BR,2011.0,6,8,-2
EG,DE,2000.0,5,10,-5
VE,CA,2016.0,8,1,7
DE,MW,2017.0,3,5,-2
SE,SI,2006.0,6,1,5
US,EE,2015.0,13,3,10
MX,NL,2002.0,4,4,0
AU,NO,2012.0,16,21,-5
AE,FR,2012.0,6,9,-3
KR,AM,2003.0,7,2,5
CZ,AR,2020.0,3,2,1
TH,SG,2016.0,4,7,-3
DE,IR,2003.0,7,6,1
CL,CO,2001.0,20,23,-3
MX,UA,2004.0,3,4,-1
PL,RU,1997.0,7,5,2
CG,FR,2004.0,8,12,-4
MT,US,2022.0,3,2,1
KR,SG,2003.0,12,4,8
NZ,IL,2018.0,2,2,0
CN,CZ,2018.0,17,26,-9
FR,AR,1999.0,16,13,3
NO,TR,2006.0,2,2,0
GB,UY,2008.0,2,3,-1
SG,TW,2002.0,12,29,-17
SD,BR,2016.0,13,1,12
GE,AU,2013.0,3,2,1
PE,CO,2007.0,28,12,16
AR,CA,2014.0,18,20,-2
PT,HU,2013.0,1,3,-2
IN,TW,2003.0,16,10,6
LT,RU,2012.0,5,3,2
NO,MX,2021.0,2,5,-3
nan,KR,2008.0,19,15,4
AU,AR,2019.0,8,17,-9
DE,RS,2015.0,21,25,-4
MX,NL,2005.0,9,7,2
JP,NL,2013.0,23,31,-8
US,AE,2003.0,16,7,9
VN,DE,2014.0,10,19,-9
CO,BR,2000.0,13,11,2
JP,IL,2007.0,12,8,4
HU,IT,2009.0,16,13,3
NO,BD,2022.0,14,7,7
NP,JP,2010.0,4,6,-2
NO,NZ,2002.0,2,1,1
NO,KR,2020.0,5,9,-4
NP,JP,2019.0,5,19,-14
MY,DE,2015.0,15,16,-1
MD,CA,2000.0,1,1,0
ID,CL,2019.0,12,25,-13
FI,IT,2010.0,9,21,-12
DK,EG,2009.0,3,1,2
KZ,TR,2008.0,26,30,-4
CO,CU,2008.0,15,17,-2
CH,ID,2016.0,7,6,1
AR,CH,2005.0,5,6,-1
BD,QA,2013.0,2,2,0
AR,CR,2011.0,7,11,-4
AE,IR,2005.0,1,1,0
FJ,US,2009.0,4,3,1
NG,CY,2021.0,5,6,-1
IT,HU,1998.0,6,6,0
IR,CA,2000.0,6,16,-10
CN,UZ,2012.0,18,7,11
US,MM,2003.0,2,2,0
US,LU,2005.0,6,3,3
CM,GB,2014.0,5,8,-3
FR,ID,2009.0,11,4,7
MA,TN,2009.0,10,3,7
PL,ID,2022.0,1,2,-1
HU,MN,2019.0,1,1,0
MY,ES,2014.0,3,8,-5
KE,BH,2001.0,1,2,-1
EC,PT,2019.0,6,6,0
SY,CN,2020.0,16,15,1
SK,CZ,2023.0,3,7,-4
AT,HR,2015.0,4,9,-5
KR,FR,2018.0,21,31,-10
MD,MA,1997.0,2,2,0
NG,BW,2018.0,1,4,-3
SE,LT,2001.0,4,2,2
MA,MD,2008.0,3,5,-2
SI,AZ,2011.0,2,1,1
BY,UZ,2013.0,2,1,1
RU,TR,2021.0,12,6,6
KE,IT,2007.0,2,2,0
MA,EG,2020.0,12,11,1
CA,KE,1999.0,3,1,2
AU,AR,2010.0,5,9,-4
UA,JP,2001.0,9,8,1
IN,NZ,1999.0,5,2,3
TW,nan,2013.0,7,3,4
PH,CN,2019.0,23,19,4
LB,US,2000.0,20,26,-6
SE,SG,2021.0,15,17,-2
NO,IE,2020.0,7,6,1
AU,TW,2016.0,35,43,-8
NL,GH,2022.0,2,4,-2
IT,CO,2000.0,3,1,2
AE,ZA,2021.0,3,4,-1
CM,BF,2004.0,1,1,0
ET,CA,2004.0,1,1,0
FR,VE,2021.0,2,1,1
JP,PA,2011.0,3,2,1
NG,TZ,2020.0,5,6,-1
IL,IN,2009.0,16,23,-7
JO,OM,2014.0,7,1,6
TR,QA,2022.0,2,2,0
ES,NL,2007.0,47,76,-29
JP,HK,2008.0,3,3,0
IR,IT,2005.0,4,2,2
SE,IL,2014.0,6,8,-2
FI,DK,2006.0,6,9,-3
AE,IT,2013.0,2,2,0
FR,GF,2007.0,9,6,3
HU,NO,2010.0,6,1,5
CN,MX,2019.0,9,12,-3
CN,TH,2016.0,28,24,4
US,ET,2000.0,13,8,5
ZA,TR,2022.0,3,2,1
RU,CL,2003.0,11,3,8
PT,IE,2020.0,10,3,7
ES,IR,2020.0,9,28,-19
US,RO,2001.0,25,44,-19
DE,GR,2004.0,30,23,7
SE,BE,2005.0,17,11,6
NL,AT,2022.0,26,13,13
KR,NO,2013.0,6,5,1
IR,DK,2005.0,1,2,-1
IN,DE,2000.0,57,81,-24
DK,nan,2022.0,4,9,-5
BR,AE,2020.0,5,2,3
SD,JO,2017.0,2,2,0
GB,JM,2012.0,8,7,1
RU,FI,2001.0,25,7,18
RO,IN,2015.0,20,29,-9
ZW,ZM,2021.0,2,2,0
NO,IT,2004.0,17,6,11
IE,CN,2006.0,22,17,5
IT,AT,1998.0,16,14,2
AU,ZA,2007.0,30,34,-4
NZ,BE,2005.0,3,6,-3
SG,ZA,2007.0,5,2,3
IR,DE,2006.0,14,18,-4
TR,NL,2004.0,14,10,4
TZ,NO,2008.0,2,7,-5
RU,AT,2008.0,14,8,6
KZ,UZ,2011.0,3,3,0
KZ,RU,2004.0,6,8,-2
CH,AE,2011.0,3,1,2
PH,FR,2009.0,5,11,-6
NL,HR,2012.0,4,1,3
DE,LY,2011.0,5,1,4
MM,TH,2016.0,4,4,0
BJ,FR,2005.0,8,22,-14
CL,IT,2006.0,18,22,-4
AE,MY,2017.0,5,22,-17
AU,AR,2017.0,6,15,-9
CN,IE,1998.0,1,1,0
NO,ZA,2016.0,10,5,5
US,CU,2012.0,32,37,-5
SE,TN,2019.0,3,3,0
CN,MX,2017.0,12,6,6
RU,JP,2005.0,22,42,-20
BE,GR,2004.0,7,8,-1
AR,CH,2002.0,5,2,3
BW,GB,2008.0,5,2,3
ZM,GH,2010.0,6,4,2
TT,CA,2005.0,1,2,-1
SJ,GB,2016.0,3,2,1
KE,DK,2015.0,1,1,0
PY,PE,2016.0,3,6,-3
CR,ES,1999.0,8,7,1
ZW,KE,2020.0,5,1,4
EC,CN,2020.0,3,3,0
LK,US,2002.0,7,11,-4
AE,MY,2010.0,5,1,4
NZ,BE,2002.0,4,1,3
nan,AR,2001.0,8,14,-6
IE,BE,2021.0,11,9,2
ES,TR,2013.0,12,5,7
HU,IN,2015.0,5,14,-9
GB,MK,2001.0,1,1,0
EC,AR,2016.0,16,36,-20
CA,CO,2005.0,6,7,-1
KW,SA,2016.0,19,9,10
UA,FR,2014.0,13,12,1
CN,AR,2004.0,2,2,0
GB,VN,2010.0,10,6,4
HU,AU,2013.0,10,6,4
EG,TW,2017.0,8,18,-10
SD,SA,2015.0,20,18,2
IS,DE,2002.0,1,2,-1
AU,ES,2007.0,25,18,7
NZ,IE,2004.0,5,7,-2
IL,CO,2016.0,2,2,0
TW,PT,2010.0,2,2,0
US,PA,2004.0,9,17,-8
BG,JP,2003.0,4,4,0
FR,RO,1997.0,12,9,3
VE,DE,2012.0,8,3,5
BN,GB,2007.0,2,3,-1
US,HR,2003.0,21,34,-13
GB,AR,1999.0,12,14,-2
BR,AT,2006.0,9,3,6
CH,CO,2018.0,8,18,-10
VE,GB,1998.0,3,4,-1
FI,BG,2001.0,1,3,-2
LV,ES,2014.0,1,1,0
TH,JP,2000.0,15,21,-6
CN,PL,2006.0,12,28,-16
UG,CI,2018.0,1,2,-1
ES,IN,1997.0,5,2,3
PE,VE,2020.0,8,23,-15
YE,MY,2020.0,8,17,-9
CY,FR,2014.0,2,7,-5
MX,HN,2014.0,11,25,-14
IN,AE,2008.0,7,5,2
CA,KR,2020.0,57,69,-12
CZ,EE,2016.0,2,2,0
BI,US,1999.0,2,1,1
SE,SA,2010.0,3,1,2
TN,US,2000.0,4,3,1
IR,RU,2001.0,1,3,-2
TH,ES,2020.0,1,2,-1
TR,HU,2015.0,1,8,-7
HU,ID,2015.0,6,4,2
BE,IN,2013.0,28,31,-3
GH,NP,2017.0,1,2,-1
ZA,CI,2019.0,2,2,0
CN,TZ,2015.0,5,2,3
US,SD,2003.0,3,3,0
TW,IE,2014.0,2,1,1
BR,DO,2018.0,5,3,2
AG,US,2019.0,2,7,-5
EC,ES,2008.0,13,20,-7
CH,nan,2013.0,13,13,0
DZ,IT,2008.0,8,14,-6
BR,CU,2014.0,14,39,-25
SE,CZ,2002.0,7,7,0
CI,BF,2015.0,6,2,4
SK,AU,2015.0,4,1,3
BY,UA,2009.0,9,5,4
UA,KR,2020.0,2,8,-6
BR,ST,2022.0,11,9,2
CZ,FR,2001.0,15,12,3
IN,GR,2021.0,2,2,0
BR,DZ,2020.0,2,1,1
PK,KE,2008.0,5,4,1
HR,EG,2016.0,1,1,0
FI,IE,2021.0,5,2,3
AU,IQ,2016.0,7,10,-3
LK,NO,2018.0,3,3,0
AT,IE,2020.0,15,4,11
PH,SA,2020.0,3,2,1
FR,MQ,1999.0,4,10,-6
AU,EC,2022.0,2,4,-2
FR,SG,2007.0,12,6,6
MY,CZ,2018.0,11,13,-2
CZ,BY,2001.0,6,3,3
IL,nan,2007.0,22,18,4
FR,GM,2001.0,1,1,0
SG,IT,2010.0,2,4,-2
GH,MY,2021.0,2,3,-1
TR,nan,2004.0,3,1,2
NO,NZ,2005.0,2,1,1
PA,SE,2003.0,3,2,1
US,EC,2005.0,7,8,-1
VN,LU,2021.0,1,3,-2
ZA,KR,2006.0,4,3,1
ZA,ES,2002.0,4,1,3
CU,BR,2002.0,4,4,0
ZA,TW,2008.0,2,1,1
AZ,GB,2018.0,2,1,1
ES,GT,2021.0,8,9,-1
BB,GB,2005.0,5,2,3
PL,RU,1998.0,7,11,-4
PH,CN,2010.0,21,23,-2
TT,AU,2011.0,2,1,1
IT,IL,1999.0,5,9,-4
SE,RS,2008.0,4,3,1
PT,FR,2000.0,13,25,-12
HR,NL,2020.0,8,4,4
AU,QA,2016.0,12,15,-3
BN,ID,2017.0,3,1,2
NL,NZ,2003.0,4,2,2
LU,FR,2021.0,21,26,-5
CU,CA,2009.0,1,3,-2
KR,IE,2023.0,1,1,0
EG,BE,2022.0,5,4,1
AU,DK,2023.0,5,7,-2
BN,ID,2019.0,6,5,1
ZA,CZ,2008.0,1,1,0
EG,FI,2022.0,6,3,3
ES,PH,2010.0,10,14,-4
CN,ET,2010.0,1,1,0
VE,PE,2020.0,23,8,15
PK,IT,2016.0,5,12,-7
nan,CM,2016.0,3,4,-1
AT,RS,2021.0,4,5,-1
MY,KR,2009.0,4,9,-5
SG,SE,2006.0,4,6,-2
PT,FI,2017.0,4,6,-2
NO,IL,2005.0,1,1,0
PT,RO,2011.0,2,3,-1
AU,PH,2001.0,9,5,4
BE,IR,2011.0,13,15,-2
NL,HU,1997.0,6,2,4
GR,BG,2018.0,9,2,7
GW,NL,2000.0,4,1,3
VG,US,2007.0,8,14,-6
DK,UA,2017.0,3,3,0
DE,JO,1998.0,2,1,1
IN,ML,2013.0,4,4,0
CH,UA,2021.0,6,12,-6
FR,OM,2005.0,2,1,1
UG,KE,2013.0,11,6,5
CA,JM,2003.0,4,1,3
GB,PH,2012.0,10,9,1
CA,NZ,2003.0,35,41,-6
BE,LT,2014.0,2,2,0
nan,ES,1999.0,3,5,-2
AR,SE,2011.0,6,3,3
MG,TN,2018.0,4,1,3
GR,SG,2016.0,3,2,1
AE,CY,2018.0,3,1,2
BE,MZ,2012.0,3,5,-2
NO,CA,2006.0,14,18,-4
UA,SE,2006.0,5,2,3
PY,CO,2017.0,7,9,-2
AU,MX,2003.0,2,5,-3
MA,NL,2018.0,2,3,-1
US,PS,2011.0,8,2,6
AU,ET,2016.0,2,14,-12
MX,FI,2016.0,3,1,2
US,HN,2018.0,8,7,1
HR,ME,2018.0,4,3,1
CA,LU,2022.0,1,3,-2
US,GT,2004.0,2,2,0
IL,ES,2003.0,7,1,6
IE,PL,2010.0,6,11,-5
AT,QA,2019.0,2,1,1
BG,CN,2007.0,8,17,-9
RU,RS,2007.0,4,5,-1
SA,NG,2021.0,9,15,-6
NO,PL,2001.0,2,8,-6
TT,CU,2002.0,1,1,0
IT,AT,1997.0,4,8,-4
AT,nan,2004.0,10,8,2
BD,SG,2000.0,2,1,1
IT,PY,2015.0,3,1,2
NL,CM,2019.0,3,1,2
CU,VE,2003.0,5,4,1
SE,NG,2015.0,3,2,1
GB,GE,2005.0,4,4,0
UZ,TR,2019.0,1,1,0
PS,BD,2018.0,1,1,0
BN,BD,2019.0,3,4,-1
HU,CZ,2014.0,9,5,4
NI,CO,2019.0,4,3,1
AU,HU,2011.0,8,21,-13
TH,CA,2004.0,11,6,5
EC,GB,2022.0,4,12,-8
TJ,RU,2023.0,10,9,1
SD,JO,2019.0,3,1,2
CA,OM,2011.0,9,4,5
MA,CN,2021.0,2,2,0
HU,UA,2017.0,2,4,-2
CA,CO,2002.0,5,5,0
TW,MN,2020.0,4,1,3
GE,BR,2021.0,2,2,0
LV,GB,2018.0,4,3,1
PK,HU,2014.0,2,3,-1
GE,CN,2022.0,3,2,1
PA,FR,2014.0,1,2,-1
NP,JP,2017.0,5,14,-9
MU,GB,2020.0,2,1,1
OM,PK,2009.0,7,1,6
PT,MY,2006.0,3,1,2
SE,DZ,2020.0,10,5,5
PS,AE,2020.0,1,2,-1
HU,NO,2019.0,4,4,0
EG,GH,2021.0,4,5,-1
NG,FI,2020.0,2,4,-2
GL,DK,2020.0,7,4,3
TH,IT,2013.0,3,5,-2
NI,MY,2012.0,1,1,0
MD,RU,2004.0,2,1,1
CU,BR,2005.0,7,15,-8
CR,BR,2014.0,7,8,-1
PF,FR,1999.0,7,2,5
PY,PT,2010.0,1,1,0
BD,SE,2019.0,5,3,2
PH,MY,2010.0,1,2,-1
PK,NZ,2012.0,7,7,0
AT,CN,2001.0,7,7,0
CN,PG,2011.0,1,1,0
PL,CA,2003.0,14,16,-2
CN,MA,2007.0,1,2,-1
PS,ES,2016.0,11,15,-4
BE,TR,2007.0,5,4,1
CZ,AT,2006.0,5,5,0
CZ,nan,2003.0,5,4,1
KE,ZA,2013.0,25,22,3
MA,BE,2001.0,3,3,0
PK,SE,2007.0,2,3,-1
BE,CW,2008.0,1,3,-2
GB,KH,2009.0,1,3,-2
PK,QA,2016.0,10,7,3
AR,BE,2010.0,6,5,1
RO,RS,2019.0,3,1,2
CA,GH,2018.0,8,8,0
ID,CL,2017.0,6,16,-10
KE,PK,2010.0,10,7,3
BO,US,2004.0,5,4,1
RU,DK,2018.0,11,14,-3
HU,UA,2019.0,3,1,2
BR,NZ,2005.0,4,1,3
TW,PH,2009.0,2,1,1
RO,NO,2018.0,3,3,0
DK,RO,2012.0,4,1,3
IT,PK,2010.0,2,7,-5
UA,AT,2009.0,6,5,1
QA,IT,2019.0,7,7,0
DE,NA,2021.0,3,1,2
AR,MY,2018.0,5,2,3
DE,DZ,2007.0,3,3,0
IT,PL,2023.0,4,2,2
nan,SA,2021.0,4,3,1
DE,LT,1997.0,2,3,-1
AT,EG,1997.0,2,2,0
LB,CA,2008.0,7,1,6
DE,JO,1997.0,3,3,0
AE,MY,2019.0,10,21,-11
UG,DE,2012.0,1,1,0
SE,KR,1999.0,2,6,-4
US,BS,2019.0,5,4,1
CY,CA,2012.0,1,2,-1
KR,MY,2007.0,6,5,1
GB,PS,2014.0,6,1,5
BR,UA,2011.0,4,2,2
NG,IQ,2014.0,2,3,-1
BR,SI,2014.0,2,2,0
VE,JP,2007.0,1,1,0
BF,ML,2013.0,2,3,-1
GB,MA,2022.0,3,4,-1
LV,RU,1998.0,3,7,-4
ID,TH,2019.0,22,28,-6
SD,ID,2018.0,3,1,2
GB,LU,2023.0,1,1,0
IL,UA,2006.0,3,2,1
TR,CY,2001.0,3,2,1
BJ,KE,2019.0,2,2,0
GE,CA,2009.0,1,2,-1
EC,IL,2021.0,5,2,3
TW,PK,2018.0,1,5,-4
US,PG,2009.0,1,3,-2
AF,GB,2018.0,1,1,0
IT,PE,2015.0,6,7,-1
KR,IN,1999.0,13,15,-2
TN,OM,2020.0,5,3,2
TH,CH,2022.0,3,4,-1
GA,BE,2018.0,1,1,0
LK,GB,2003.0,5,9,-4
UA,RO,2018.0,2,10,-8
BE,KR,1998.0,2,2,0
CU,GB,2017.0,5,4,1
FR,UY,2003.0,5,7,-2
LT,MZ,2008.0,4,3,1
BD,PH,2011.0,1,3,-2
TR,LY,2018.0,1,2,-1
KE,BJ,2020.0,2,3,-1
PY,CO,2010.0,3,3,0
AT,PE,2020.0,2,1,1
NZ,KR,2013.0,5,4,1
MN,DZ,2019.0,9,3,6
NL,IN,2002.0,6,15,-9
EG,OM,2011.0,5,4,1
CA,DZ,2000.0,5,1,4
ZA,SG,2004.0,3,1,2
BW,IN,2014.0,1,1,0
IT,RS,2012.0,6,7,-1
SE,TN,2017.0,2,2,0
PT,FI,2010.0,3,2,1
LB,GB,2014.0,4,12,-8
NG,SG,2016.0,1,1,0
TH,FR,2007.0,6,12,-6
ZA,RU,2011.0,5,4,1
MN,DZ,2017.0,6,2,4
IT,KR,2020.0,7,9,-2
SR,NL,2018.0,5,4,1
CI,SN,2021.0,3,2,1
TH,IR,2021.0,1,5,-4
OM,JO,2019.0,4,3,1
CU,GB,2010.0,2,7,-5
XK,BA,2015.0,2,2,0
HK,RO,2022.0,5,8,-3
UA,ES,2018.0,4,5,-1
NG,UA,2013.0,1,1,0
NL,CO,2012.0,3,8,-5
GH,DE,2012.0,2,6,-4
BE,XK,2019.0,2,1,1
CI,US,2013.0,2,3,-1
IN,AF,2018.0,2,2,0
ZA,CM,2009.0,1,5,-4
VN,AT,2020.0,2,4,-2
FI,HU,2018.0,5,2,3
BF,CA,2018.0,4,4,0
LK,US,2005.0,6,11,-5
GF,FR,2003.0,2,6,-4
MM,AU,2020.0,3,6,-3
LU,CA,2015.0,5,4,1
ID,IR,2016.0,5,28,-23
US,CI,2022.0,1,3,-2
SY,DE,2011.0,2,6,-4
TR,EG,2018.0,6,9,-3
GB,VG,2007.0,2,2,0
ML,DE,2019.0,2,1,1
IL,EG,2004.0,1,1,0
NG,BJ,2021.0,2,9,-7
CA,SY,2009.0,2,3,-1
RU,ZA,2011.0,4,5,-1
CO,VN,2017.0,1,1,0
SA,PS,2018.0,4,6,-2
FI,IN,2006.0,5,3,2
BH,JO,2018.0,1,5,-4
DZ,MN,2016.0,6,2,4
AU,SC,2020.0,2,1,1
LT,IT,2006.0,1,3,-2
SA,AT,2013.0,1,6,-5
QA,JP,2016.0,4,4,0
VN,AU,2009.0,7,9,-2
EG,TW,2010.0,3,4,-1
SA,AU,1999.0,2,3,-1
SY,GB,1998.0,2,2,0
CA,BD,1998.0,3,2,1
LU,CH,2006.0,2,6,-4
VE,GB,1997.0,1,1,0
TR,SD,2019.0,2,3,-1
PK,VN,2019.0,3,3,0
NL,PH,1998.0,2,1,1
ZA,IE,2006.0,2,4,-2
ZW,NL,2004.0,4,3,1
GH,GB,2002.0,3,4,-1
CM,IT,2014.0,2,4,-2
PH,TR,2008.0,2,2,0
IN,MY,2023.0,4,4,0
HR,IT,2008.0,6,3,3
IN,IR,1997.0,2,1,1
QA,TN,2013.0,2,5,-3
CL,PA,2019.0,12,10,2
BR,MZ,2005.0,2,2,0
KH,IN,2019.0,2,2,0
DK,IE,2021.0,7,11,-4
CH,CL,2021.0,6,5,1
IT,HU,1997.0,3,4,-1
NL,AL,2018.0,1,1,0
PL,KR,2020.0,3,9,-6
NP,NL,2012.0,2,3,-1
ZA,NC,2013.0,1,1,0
MY,SE,2022.0,1,2,-1
BR,IL,2003.0,5,2,3
EG,CN,2001.0,2,2,0
DE,NP,2001.0,1,1,0
JP,AM,2010.0,4,4,0
BY,GB,2003.0,2,2,0
UA,BR,2022.0,3,1,2
RU,NO,2000.0,7,4,3
PR,US,2018.0,6,10,-4
HU,BG,2005.0,1,2,-1
SG,IT,2017.0,9,8,1
AL,FR,2008.0,1,1,0
OM,BE,2015.0,1,1,0
IQ,ES,2018.0,1,1,0
TR,SI,2020.0,3,2,1
AE,SA,1999.0,3,4,-1
IE,NO,2001.0,5,1,4
DE,UY,2013.0,3,2,1
AE,HU,2007.0,3,1,2
VG,IT,2019.0,1,1,0
CZ,ZA,2011.0,3,1,2
ET,ZA,2008.0,1,2,-1
MY,OM,2003.0,2,1,1
TH,NP,2022.0,3,3,0
US,SN,2015.0,10,7,3
BG,NO,2000.0,2,7,-5
PS,ID,2019.0,2,2,0
GB,EC,2005.0,2,2,0
KP,KR,2014.0,2,1,1
ES,SK,1998.0,2,1,1
BR,SK,2022.0,2,1,1
DE,BH,2017.0,1,2,-1
BD,NL,2022.0,3,1,2
TT,GB,2021.0,3,4,-1
ES,NI,2021.0,2,7,-5
PK,CZ,2020.0,2,20,-18
MX,GR,2012.0,3,6,-3
FR,PE,2001.0,2,2,0
CF,FR,1999.0,2,1,1
GR,SA,2020.0,5,4,1
BO,EC,2021.0,1,4,-3
PY,CL,2011.0,2,1,1
UZ,UA,2021.0,2,2,0
CO,VN,2019.0,1,2,-1
AT,CO,2007.0,1,2,-1
SD,AU,2016.0,3,1,2
IN,NG,2008.0,4,2,2
BY,CN,2012.0,2,3,-1
TH,IE,2010.0,1,1,0
QA,IT,2017.0,2,7,-5
AM,RU,2003.0,8,4,4
SC,AU,2017.0,1,1,0
CZ,CL,2009.0,1,1,0
GT,CL,2020.0,1,3,-2
GB,SI,1998.0,3,1,2
GB,PE,2004.0,1,1,0
NL,UA,2004.0,5,4,1
TW,ET,2016.0,1,2,-1
BR,BO,2012.0,2,1,1
ZA,IT,1998.0,1,3,-2
SY,MY,2016.0,2,1,1
PE,BE,2021.0,3,3,0
PG,US,2005.0,3,1,2
CN,JO,2009.0,3,2,1
SN,CA,2018.0,4,9,-5
VN,TH,2004.0,1,1,0
VN,GH,2015.0,1,3,-2
QA,TW,2019.0,3,3,0
GE,IT,2007.0,2,1,1
CA,BG,2022.0,1,1,0
SI,PT,2012.0,3,1,2
CL,IE,2013.0,1,2,-1
RU,AE,2021.0,1,3,-2
PT,VE,2003.0,1,1,0
BD,NG,2015.0,1,1,0
LB,KW,2017.0,3,2,1
GH,BF,2019.0,3,3,0
CH,MN,2019.0,1,1,0
GB,MW,2000.0,4,5,-1
EC,DE,2018.0,6,12,-6
nan,IE,2009.0,3,1,2
PK,YE,2012.0,1,2,-1
IL,BG,2005.0,2,1,1
TW,TR,2014.0,2,6,-4
HR,RU,2012.0,4,5,-1
DK,UA,2019.0,1,2,-1
PL,UZ,2000.0,5,2,3
BA,HR,2001.0,3,4,-1
PL,PH,2018.0,1,1,0
KE,NO,2013.0,1,4,-3
DZ,QA,2013.0,1,1,0
AT,EC,2022.0,2,1,1
ES,SV,2007.0,2,2,0
NO,SI,2012.0,2,4,-2
CA,AM,2014.0,2,1,1
PK,VN,2017.0,2,1,1
SK,BY,2013.0,3,2,1
CR,GT,2014.0,1,1,0
BY,JP,2003.0,2,1,1
TW,AT,2001.0,1,1,0
CA,JO,2009.0,7,1,6
PL,LT,2013.0,3,1,2
GE,ES,2016.0,1,1,0
CA,CU,2022.0,1,2,-1
BY,BR,2016.0,1,2,-1
IL,LB,2018.0,1,1,0
GA,DE,1999.0,2,1,1
EE,ES,2021.0,2,5,-3
IE,AT,2015.0,5,5,0
BR,GT,2005.0,1,1,0
RU,EC,2002.0,1,1,0
KH,NZ,2016.0,1,1,0
AM,SE,2021.0,1,1,0
ZA,CO,2021.0,3,1,2
MA,BI,2014.0,2,1,1
SI,FR,2000.0,3,2,1
RU,BD,2010.0,1,1,0
MN,RU,2016.0,4,3,1
TN,DZ,2006.0,2,4,-2
FR,PF,1999.0,2,7,-5
BB,IN,2006.0,2,1,1
CL,SE,2008.0,3,4,-1
BR,KN,2022.0,2,1,1
JO,ES,2018.0,3,5,-2
MY,RU,2003.0,2,5,-3
CN,IE,1997.0,1,4,-3
SY,TN,2013.0,2,3,-1
IE,SA,1997.0,1,1,0
CM,BJ,2003.0,1,2,-1
SE,RW,2014.0,2,2,0
GE,GB,2001.0,2,1,1
KR,FI,2016.0,2,4,-2
NG,SA,2003.0,3,4,-1
QA,RU,2014.0,3,2,1
UZ,DE,2009.0,2,2,0
IS,DK,2018.0,3,8,-5
BR,NZ,2002.0,2,3,-1
TT,BR,2020.0,1,1,0
HR,KR,2019.0,1,1,0
RU,CR,2020.0,1,4,-3
GB,PY,2015.0,2,2,0
MY,MA,2011.0,1,1,0
BE,GM,2003.0,1,1,0
JO,SY,2012.0,1,3,-2
SG,PH,2002.0,2,1,1
CU,IL,2015.0,1,2,-1
AM,JP,2020.0,1,1,0
GT,MX,2000.0,2,3,-1
ES,TZ,2010.0,1,1,0
NP,GB,2003.0,2,3,-1
SA,AE,2000.0,2,4,-2
QA,CA,2007.0,2,5,-3
DE,MW,2019.0,4,2,2
IE,PK,1998.0,1,1,0
BW,AU,2009.0,1,2,-1
CH,TW,2009.0,2,5,-3
EC,PT,2017.0,5,10,-5
TH,DK,2014.0,1,2,-1
AO,US,2009.0,1,4,-3
IN,LK,1999.0,1,1,0
SG,BD,2000.0,1,2,-1
CH,GE,2015.0,1,1,0
BD,KE,2012.0,1,2,-1
GB,KN,2017.0,2,1,1
PA,BR,2008.0,2,1,1
HR,ID,2020.0,1,1,0
GB,LV,2014.0,2,5,-3
DK,SG,2006.0,1,8,-7
CL,BE,2000.0,2,2,0
TR,MX,2008.0,1,2,-1
NZ,nan,2021.0,1,2,-1
FI,SI,2014.0,1,2,-1
PK,CG,2021.0,2,7,-5
SE,OM,2018.0,1,1,0
CL,RU,2015.0,1,2,-1
AT,BR,2003.0,3,3,0
ES,TZ,2019.0,1,2,-1
BH,BD,2020.0,1,1,0
MY,MK,2017.0,1,1,0
YE,IQ,2022.0,1,1,0
DK,TH,2009.0,2,1,1
TZ,PK,2013.0,1,1,0
MW,DE,2008.0,1,1,0
ZA,AT,2023.0,1,1,0
BG,BY,2007.0,1,1,0
PK,JO,2022.0,2,2,0
ET,IQ,2022.0,1,1,0
GB,BF,2018.0,2,1,1
RO,RS,2017.0,1,1,0
OM,CA,2007.0,1,5,-4
CA,GA,2005.0,1,1,0
NL,VE,2015.0,1,6,-5
RU,FR,1997.0,40,30,10
SE,GB,2002.0,103,76,27
EG,JP,2016.0,59,76,-17
CA,PT,2012.0,13,10,3
CH,ES,2008.0,55,56,-1
US,ZA,2004.0,194,190,4
FR,IR,2014.0,37,27,10
CA,JP,2013.0,111,103,8
CZ,JP,2022.0,6,9,-3
FR,ES,2008.0,237,240,-3
SE,GB,2005.0,127,115,12
DO,ES,2018.0,8,25,-17
RS,CH,2021.0,7,6,1
RU,US,2001.0,326,233,93
BE,GB,2017.0,194,161,33
CL,CH,2016.0,14,19,-5
GB,GE,2002.0,8,6,2
CO,AR,2018.0,150,125,25
DZ,FR,2010.0,69,96,-27
VN,JP,2013.0,25,51,-26
BG,GB,2018.0,21,19,2
nan,GH,2005.0,3,1,2
VE,MX,2020.0,28,30,-2
ID,US,2017.0,194,294,-100
CN,IN,2020.0,200,292,-92
ZM,US,2012.0,9,9,0
NG,DE,2018.0,8,6,2
NG,ZA,2016.0,86,65,21
CA,BE,2004.0,20,38,-18
JO,IQ,2011.0,6,4,2
AU,RU,2020.0,27,34,-7
GR,CZ,2018.0,9,3,6
GB,IR,2004.0,60,21,39
TH,IN,2022.0,16,29,-13
ZA,NL,2019.0,57,49,8
AU,ID,2010.0,40,12,28
BR,SE,2018.0,38,28,10
SS,GB,2009.0,13,7,6
DK,PK,2015.0,4,5,-1
US,BG,2017.0,34,30,4
IL,CA,2005.0,59,27,32
NP,CN,2018.0,20,23,-3
ID,NG,2022.0,13,6,7
SZ,ET,2021.0,1,1,0
FR,AT,2009.0,34,30,4
AR,CU,2018.0,17,26,-9
AR,VE,2011.0,7,21,-14
SE,CA,2009.0,44,36,8
MX,DE,2002.0,16,15,1
PL,nan,2004.0,7,4,3
PT,IN,2020.0,28,10,18
SE,BE,2002.0,15,12,3
RU,AM,2020.0,13,23,-10
CZ,SI,2008.0,11,6,5
FR,HU,2002.0,15,23,-8
FR,BG,2001.0,8,5,3
AT,BE,2007.0,15,10,5
CA,UA,2007.0,4,3,1
DZ,PT,2020.0,5,3,2
CN,GE,2016.0,6,4,2
SG,IT,2019.0,10,11,-1
UZ,AT,2020.0,1,1,0
TR,AU,2012.0,9,8,1
RU,LT,2007.0,13,6,7
DE,TR,1999.0,7,18,-11
BE,AU,2013.0,38,38,0
SN,NE,2021.0,2,1,1
FI,CZ,2020.0,10,9,1
GB,LB,2015.0,18,8,10
UY,FR,2003.0,7,5,2
AT,KE,2017.0,4,2,2
AE,GB,2007.0,11,24,-13
DE,IN,2003.0,66,127,-61
US,NG,2004.0,13,30,-17
HU,SK,2008.0,6,14,-8
CM,FR,2009.0,10,12,-2
US,VG,2012.0,9,17,-8
MY,AT,2015.0,2,3,-1
AT,ZA,2022.0,7,3,4
SG,FR,2008.0,8,14,-6
GB,CR,2022.0,1,1,0
CH,BD,2012.0,4,1,3
CN,BD,2004.0,6,4,2
nan,BG,2016.0,1,3,-2
SA,TN,2001.0,3,2,1
KE,LK,2008.0,1,1,0
IE,FR,2003.0,11,12,-1
FI,SK,2008.0,2,8,-6
PH,MY,2019.0,5,5,0
GB,NP,2001.0,3,1,2
IR,SA,2019.0,18,15,3
RO,ES,1997.0,2,1,1
RU,MZ,2003.0,2,7,-5
TW,JP,1999.0,26,31,-5
CY,TR,2003.0,2,1,1
IL,DK,2021.0,3,4,-1
US,CD,2018.0,4,5,-1
US,BD,2003.0,16,21,-5
SE,RO,2014.0,8,2,6
ZA,PE,2018.0,2,1,1
BG,CH,2009.0,1,4,-3
BE,CZ,2001.0,3,3,0
RO,SE,2020.0,4,8,-4
CH,LK,2013.0,3,2,1
nan,ZA,2005.0,7,4,3
UZ,MY,2015.0,1,2,-1
PE,CU,2012.0,2,10,-8
KE,AE,2018.0,1,1,0
TW,PL,2020.0,7,3,4
JP,HU,2008.0,7,11,-4
QA,NL,2018.0,3,5,-2
EC,UA,2005.0,9,9,0
EC,CA,2014.0,2,3,-1
IN,UG,2013.0,4,1,3
DK,FR,2005.0,17,29,-12
IR,AU,2001.0,3,14,-11
CD,UG,2020.0,5,6,-1
RS,RU,2012.0,8,15,-7
ES,BG,2009.0,5,7,-2
DK,KR,2020.0,4,11,-7
SK,PL,2013.0,7,3,4
AM,IT,2012.0,11,35,-24
HN,UY,2018.0,1,1,0
UA,HU,2017.0,4,2,2
BH,TN,2017.0,1,1,0
US,EC,2002.0,4,6,-2
GH,GB,2005.0,3,13,-10
BG,nan,2011.0,5,2,3
MD,MA,1998.0,4,8,-4
ID,HU,2015.0,4,6,-2
IN,PL,2023.0,3,1,2
US,YE,2018.0,4,2,2
TH,VN,2004.0,1,1,0
LT,JP,2003.0,6,11,-5
FR,IS,2007.0,1,3,-2
DE,MW,2010.0,1,3,-2
EG,ZA,2019.0,6,7,-1
IQ,KR,2020.0,1,2,-1
IE,PL,2017.0,4,13,-9
IN,BH,2021.0,6,6,0
ZA,NG,2023.0,2,10,-8
RW,GB,2018.0,2,2,0
KE,MY,2018.0,4,4,0
BB,US,2000.0,1,2,-1
SG,CO,2016.0,2,2,0
ES,SK,1997.0,1,2,-1
IR,IL,2016.0,2,2,0
DE,ML,2021.0,1,2,-1
NL,IR,2001.0,2,3,-1
SG,MM,2006.0,1,4,-3
RS,CN,2016.0,8,2,6
US,NI,2013.0,3,5,-2
JP,AO,2016.0,1,2,-1
CZ,EG,2013.0,2,3,-1
ID,AT,2015.0,2,7,-5
RO,nan,2018.0,2,3,-1
BG,PL,2013.0,3,2,1
JP,AM,2019.0,1,2,-1
IE,UY,2018.0,1,1,0
DE,BH,2019.0,1,1,0
IR,MA,2016.0,5,7,-2
PA,AR,2021.0,1,4,-3
PR,GB,2010.0,1,2,-1
SG,CN,2011.0,412,342,70
IT,IE,2015.0,37,20,17
AU,BR,2015.0,109,134,-25
KR,PK,2020.0,72,49,23
US,BG,2019.0,33,34,-1
CA,AT,2015.0,32,31,1
IL,CA,2002.0,28,26,2
SE,UG,2015.0,4,2,2
KR,CH,2011.0,11,10,1
PL,AU,2002.0,6,5,1
HK,AU,2005.0,1,2,-1
PY,PT,2017.0,3,3,0
SY,IT,2019.0,5,2,3
MR,EG,2020.0,1,1,0
GT,ES,2018.0,9,24,-15
NL,BG,2013.0,5,3,2
GB,,2024.0,114687,0,114687
,JP,1997.0,23674,0,23674
,IQ,2004.0,98,0,98
AU,,2018.0,6281,0,6281
,JP,1998.0,21739,0,21739
JP,,2025.0,7269,0,7269
QA,,2021.0,327,0,327
,BG,2019.0,204,0,204
DE,,2011.0,10244,0,10244
,HU,1997.0,1198,0,1198
IT,,2016.0,7628,0,7628
,KR,2014.0,5405,0,5405
EG,,2024.0,22489,0,22489
KW,,2022.0,386,0,386
,BE,2011.0,3399,0,3399
PT,,2022.0,3560,0,3560
,SE,2013.0,3230,0,3230
ES,,2016.0,8947,0,8947
,CO,2006.0,1807,0,1807
,MX,2008.0,4512,0,4512
,ZA,1995.0,1680,0,1680
,NZ,2013.0,1214,0,1214
ET,,2024.0,5617,0,5617
BD,,2020.0,903,0,903
PL,,2002.0,569,0,569
,HU,1998.0,1312,0,1312
,PH,2003.0,346,0,346
,SG,2012.0,1788,0,1788
,AT,2001.0,1704,0,1704
UY,,2014.0,90,0,90
ZW,,2021.0,184,0,184
,RO,2012.0,2567,0,2567
BR,,2005.0,1234,0,1234
,XK,2014.0,109,0,109
PL,,2005.0,754,0,754
VE,,2023.0,907,0,907
EE,,2014.0,172,0,172
CA,,2003.0,2370,0,2370
,SA,2016.0,2855,0,2855
BR,,2002.0,779,0,779
,NI,2008.0,21,0,21
LU,,2023.0,713,0,713
KN,,2022.0,17,0,17
NG,,2005.0,142,0,142
,UZ,1997.0,105,0,105
,UY,1994.0,167,0,167
,EG,2015.0,4529,0,4529
,IS,1997.0,77,0,77
HK,,2022.0,122,0,122
,BG,2010.0,528,0,528
,EE,2016.0,226,0,226
,BY,2008.0,224,0,224
,BG,2017.0,442,0,442
,JO,2015.0,499,0,499
MN,,2024.0,303,0,303
,TH,1994.0,968,0,968
AZ,CO,2016.0,1,0,1
GR,,2001.0,267,0,267
,OM,2007.0,96,0,96
,ET,2015.0,1017,0,1017
,LA,2015.0,29,0,29
,SI,2016.0,458,0,458
,UZ,1998.0,167,0,167
,MT,2015.0,81,0,81
,NE,2015.0,56,0,56
SI,,2001.0,46,0,46
IR,,2004.0,96,0,96
NG,,2002.0,82,0,82
,GE,2009.0,187,0,187
TW,GM,2019.0,4,0,4
KH,FR,2002.0,1,0,1
BF,,2020.0,118,0,118
GB,CI,2005.0,1,0,1
BD,BR,2013.0,2,0,2
,GT,2015.0,70,0,70
CN,EE,2009.0,2,0,2
DE,KP,2015.0,1,0,1
,MW,1996.0,18,0,18
,TZ,2000.0,71,0,71
,IS,1998.0,95,0,95
TT,BI,2012.0,1,0,1
PS,IE,2021.0,1,0,1
AR,RS,2014.0,1,0,1
,ID,2020.0,175,0,175
BN,ID,2010.0,2,0,2
LK,ZM,2022.0,2,0,2
MQ,,2022.0,67,0,67
,JM,2009.0,60,0,60
ES,NP,2021.0,1,0,1
,BD,2001.0,171,0,171
,AL,2012.0,164,0,164
CI,NZ,2022.0,1,0,1
,PA,2009.0,76,0,76
SN,PE,2017.0,1,0,1
,BW,2004.0,55,0,55
VN,,2004.0,23,0,23
,SV,2011.0,19,0,19
IE,SA,1998.0,1,0,1
PK,,2004.0,62,0,62
BR,LT,2020.0,3,0,3
FR,LK,2015.0,3,0,3
,IQ,1996.0,31,0,31
CY,,2025.0,152,0,152
GB,PK,2024.0,3,0,3
TH,ZA,2009.0,4,0,4
FR,GT,2010.0,1,0,1
,IL,2020.0,139,0,139
KZ,RS,2017.0,1,0,1
WS,,2021.0,7,0,7
,MK,1995.0,27,0,27
,GD,2006.0,11,0,11
CZ,EC,2016.0,1,0,1
FO,,2022.0,8,0,8
,PF,2002.0,8,0,8
NO,GL,2020.0,1,0,1
TT,CA,2002.0,1,0,1
BY,,2009.0,191,0,191
,MZ,2003.0,20,0,20
SG,UG,2004.0,1,0,1
SR,,2022.0,18,0,18
TT,NO,2006.0,1,0,1
UA,NO,2021.0,5,0,5
,CG,2009.0,30,0,30
,BS,2006.0,14,0,14
GH,,2006.0,24,0,24
,ML,1995.0,36,0,36
US,SZ,2020.0,2,0,2
CU,,1998.0,9,0,9
IR,EE,2020.0,8,0,8
PW,AU,2008.0,1,0,1
SA,OM,2007.0,2,0,2
,MW,2004.0,44,0,44
PT,LT,2017.0,1,0,1
BR,HK,2022.0,1,0,1
US,GD,2005.0,6,0,6
PK,ZW,2020.0,3,0,3
PS,,2008.0,4,0,4
SY,LB,1999.0,2,0,2
TD,FR,2006.0,1,0,1
AT,IQ,2010.0,1,0,1
,CD,1999.0,5,0,5
LV,BE,2003.0,1,0,1
CO,GA,1997.0,1,0,1
GA,TZ,1999.0,1,0,1
ZM,,2009.0,11,0,11
BE,CM,2003.0,2,0,2
ML,,2008.0,4,0,4
NL,RW,2015.0,4,0,4
MZ,LT,2003.0,5,0,5
HR,BA,1998.0,1,0,1
BW,,2013.0,27,0,27
PA,,2008.0,10,0,10
,NC,2003.0,14,0,14
LI,PL,2014.0,1,0,1
TW,SZ,2021.0,1,0,1
LV,,1998.0,13,0,13
PA,CA,2012.0,5,0,5
,FJ,2009.0,16,0,16
FR,TD,2007.0,1,0,1
IN,BN,1998.0,1,0,1
SA,JP,2023.0,1,0,1
NZ,GE,2002.0,1,0,1
MZ,,2012.0,23,0,23
CN,BH,2016.0,2,0,2
CU,UY,2007.0,2,0,2
SK,SA,2012.0,2,0,2
OM,JO,2010.0,1,0,1
VE,SA,2016.0,1,0,1
,LI,2008.0,4,0,4
ML,GH,2011.0,1,0,1
NO,BY,2000.0,1,0,1
,GL,2013.0,4,0,4
CN,LV,2013.0,2,0,2
TW,ZA,2009.0,4,0,4
SZ,,2015.0,3,0,3
AU,KZ,2012.0,2,0,2
GM,NP,2017.0,1,0,1
SK,VN,2009.0,2,0,2
KZ,,1998.0,3,0,3
CN,MW,2018.0,1,0,1
BB,,1999.0,1,0,1
NL,CM,2010.0,3,0,3
UA,TH,2020.0,1,0,1
PL,ET,2017.0,1,0,1
GF,PK,2020.0,1,0,1
ET,ID,2018.0,2,0,2
MM,CO,2016.0,1,0,1
MU,,2015.0,18,0,18
LK,ZA,2013.0,2,0,2
TH,ID,2006.0,1,0,1
NP,BN,2015.0,1,0,1
PL,SG,2005.0,3,0,3
LK,,2009.0,40,0,40
AU,OM,1999.0,5,0,5
BD,BE,2009.0,1,0,1
FK,,2023.0,4,0,4
GB,KN,2019.0,2,0,2
TR,NZ,2009.0,1,0,1
AM,ID,2003.0,1,0,1
CI,ZA,2013.0,1,0,1
VN,MD,2019.0,1,0,1
ES,PG,2011.0,1,0,1
,PF,2005.0,9,0,9
PH,RO,2007.0,1,0,1
SD,DK,2018.0,1,0,1
TR,IN,2001.0,8,0,8
BG,DK,2002.0,2,0,2
RU,IE,2022.0,10,0,10
TN,ES,2011.0,7,0,7
GB,HK,2003.0,4,0,4
AZ,TR,1998.0,3,0,3
,GP,2008.0,20,0,20
,FO,2006.0,3,0,3
IS,DE,2005.0,1,0,1
NL,PE,2007.0,1,0,1
SY,AU,1997.0,3,0,3
KW,PS,2019.0,1,0,1
IT,JO,1999.0,1,0,1
BR,SY,2014.0,1,0,1
CI,DZ,2017.0,1,0,1
KE,ID,2014.0,4,0,4
LK,BR,2015.0,2,0,2
PT,DZ,2008.0,2,0,2
FI,ET,2021.0,3,0,3
PK,BR,2000.0,1,0,1
CV,PT,2002.0,1,0,1
PK,TN,2001.0,1,0,1
,AF,2015.0,17,0,17
ES,SI,1997.0,1,0,1
,BW,1996.0,34,0,34
LY,JP,2008.0,2,0,2
KW,PS,2017.0,1,0,1
ES,AE,2014.0,4,0,4
MG,JE,2020.0,1,0,1
NG,JO,2023.0,1,0,1
AU,CR,2018.0,2,0,2
UA,GE,2022.0,2,0,2
EC,ZA,2019.0,1,0,1
GH,OM,2019.0,5,0,5
UG,MW,2021.0,2,0,2
FR,QA,2003.0,2,0,2
CA,UG,1997.0,1,0,1
NG,KW,1999.0,1,0,1
ET,BD,2009.0,1,0,1
DE,MG,2022.0,3,0,3
CZ,NP,2022.0,1,0,1
RW,IT,2009.0,1,0,1
EE,HU,2003.0,1,0,1
GR,EG,2013.0,1,0,1
CM,GM,2016.0,1,0,1
DK,BY,2020.0,2,0,2
RS,PT,2001.0,3,0,3
GP,JM,2015.0,3,0,3
RO,MX,2004.0,2,0,2
BH,,2007.0,14,0,14
DK,ZA,1997.0,1,0,1
SN,MA,2008.0,1,0,1
NG,UG,2002.0,1,0,1
IS,,2001.0,7,0,7
GH,NG,2000.0,2,0,2
NO,KE,2014.0,2,0,2
LI,JP,2017.0,1,0,1
BI,GB,2011.0,1,0,1
AL,,2007.0,4,0,4
PH,IL,2013.0,2,0,2
FI,JO,2003.0,1,0,1
DK,LK,2017.0,1,0,1
PH,BR,2000.0,1,0,1
AT,ET,2002.0,2,0,2
GB,GN,2004.0,1,0,1
AU,MU,1997.0,1,0,1
BR,LK,1997.0,1,0,1
NL,VG,2008.0,1,0,1
PH,NO,2009.0,2,0,2
KW,EG,2023.0,2,0,2
IE,TW,2000.0,1,0,1
TH,BD,2001.0,1,0,1
BR,AM,2010.0,1,0,1
AU,CL,1998.0,2,0,2
BI,BE,1997.0,3,0,3
GE,NZ,2005.0,1,0,1
CR,NL,2001.0,2,0,2
MG,BE,2012.0,1,0,1
BJ,NC,2012.0,2,0,2
CO,AE,2019.0,2,0,2
AZ,IR,2009.0,2,0,2
IE,BN,2002.0,1,0,1
TW,HU,2011.0,2,0,2
IL,DO,2018.0,1,0,1
ET,BW,2015.0,2,0,2
NL,LT,1997.0,1,0,1
NZ,AO,2020.0,1,0,1
NP,SA,2020.0,1,0,1
VN,SK,2017.0,1,0,1
TZ,QA,2017.0,2,0,2
GB,FJ,2004.0,1,0,1
GR,PT,2021.0,1,0,1
,KY,1998.0,1,0,1
BA,AU,2020.0,2,0,2
EC,PT,2010.0,2,0,2
LB,TW,2010.0,2,0,2
KR,UZ,2009.0,2,0,2
NL,KG,2017.0,1,0,1
AU,ZW,2013.0,3,0,3
IL,ID,2016.0,4,0,4
KE,BD,2020.0,2,0,2
SK,BA,2013.0,1,0,1
BW,DE,2015.0,1,0,1
DE,CW,2020.0,5,0,5
SD,ES,2018.0,1,0,1
ET,SO,2016.0,1,0,1
NZ,OM,2018.0,1,0,1
ZM,DK,2013.0,1,0,1
,ST,2000.0,8,0,8
IT,BF,2002.0,2,0,2
BY,BE,2000.0,1,0,1
AT,EG,1998.0,1,0,1
KW,BR,2019.0,1,0,1
US,RE,2000.0,1,0,1
AM,GW,2014.0,1,0,1
PH,KE,2008.0,3,0,3
,NA,2001.0,12,0,12
FI,TW,2005.0,2,0,2
PH,UY,2012.0,1,0,1
MR,,2003.0,1,0,1
LB,MA,2008.0,1,0,1
HU,BG,2002.0,3,0,3
DK,MX,2001.0,2,0,2
CM,BW,2013.0,1,0,1
UG,,1999.0,3,0,3
RU,SJ,2022.0,1,0,1
LB,SY,2022.0,2,0,2
RU,GT,2019.0,2,0,2
GR,HU,2002.0,2,0,2
PA,GR,2008.0,1,0,1
RO,PL,2005.0,6,0,6
FR,MW,2021.0,2,0,2
DK,GW,2003.0,5,0,5
SA,PK,2024.0,3,0,3
ML,BJ,2022.0,1,0,1
NO,MA,2015.0,1,0,1
BD,NZ,2006.0,3,0,3
ML,NL,2014.0,1,0,1
CW,,2012.0,4,0,4
SG,BG,2018.0,1,0,1
GR,AR,2022.0,2,0,2
IQ,AT,2018.0,2,0,2
KW,PK,2008.0,3,0,3
PR,AU,2016.0,2,0,2
BW,CM,2015.0,1,0,1
,BT,2003.0,4,0,4
CY,PS,2017.0,2,0,2
NO,ZM,2022.0,1,0,1
JO,SE,2017.0,1,0,1
AU,MA,2016.0,1,0,1
,KG,1995.0,3,0,3
LB,KW,2010.0,2,0,2
AT,VE,2014.0,1,0,1
TR,KW,2001.0,1,0,1
CV,,2019.0,3,0,3
ZW,EG,2018.0,1,0,1
LV,BY,1998.0,1,0,1
LY,EG,1998.0,1,0,1
IE,IS,2015.0,1,0,1
US,GY,2022.0,3,0,3
GR,SK,2015.0,3,0,3
PL,TZ,2002.0,1,0,1
UG,ZM,2017.0,1,0,1
CH,MA,2012.0,3,0,3
NP,KE,2015.0,2,0,2
RU,SY,2021.0,3,0,3
GA,US,2000.0,2,0,2
MK,CZ,2009.0,1,0,1
IT,AE,2012.0,3,0,3
IT,BO,2007.0,1,0,1
ID,BF,2015.0,1,0,1
LI,,2012.0,4,0,4
SK,SE,2009.0,2,0,2
GB,KN,2010.0,1,0,1
RS,JO,2008.0,1,0,1
BE,UG,2000.0,1,0,1
KW,MY,1997.0,1,0,1
CN,PA,1997.0,1,0,1
ZA,ES,2005.0,1,0,1
IS,IT,2021.0,4,0,4
CL,KE,2017.0,1,0,1
NP,NO,2012.0,1,0,1
ER,RO,2011.0,1,0,1
CA,ZM,2022.0,1,0,1
,TD,2006.0,2,0,2
IN,TN,2001.0,2,0,2
FR,GT,2019.0,3,0,3
GH,BF,2017.0,2,0,2
EG,TR,1999.0,1,0,1
CY,BA,2016.0,1,0,1
SZ,ZM,2021.0,1,0,1
CU,GB,2019.0,3,0,3
BD,PS,2005.0,1,0,1
TJ,BE,2001.0,1,0,1
ES,QA,2005.0,2,0,2
MR,BI,2017.0,1,0,1
TN,TR,2015.0,1,0,1
BJ,DK,2005.0,1,0,1
IN,PR,2017.0,1,0,1
MK,,2004.0,3,0,3
KR,SI,2012.0,1,0,1
SK,RO,2000.0,4,0,4
SE,AM,2012.0,1,0,1
KH,BJ,2013.0,1,0,1
HU,MN,2010.0,1,0,1
QA,SK,2019.0,1,0,1
GM,IT,2008.0,1,0,1
PR,JP,2000.0,1,0,1
,MC,2016.0,4,0,4
NO,BF,2019.0,1,0,1
AT,BY,2021.0,1,0,1
PT,nan,2023.0,5,0,5
DZ,ZA,2020.0,1,0,1
PS,JP,2008.0,1,0,1
AM,AU,2016.0,2,0,2
KH,ZA,2016.0,1,0,1
FR,CR,2011.0,4,0,4
ES,AZ,1997.0,1,0,1
IN,KZ,2023.0,2,0,2
ZW,MW,2015.0,3,0,3
ML,AE,2011.0,1,0,1
BF,CN,2021.0,1,0,1
EG,nan,2005.0,1,0,1
BW,CN,2020.0,1,0,1
CA,LV,2022.0,1,0,1
IN,IR,1998.0,1,0,1
CZ,MM,2019.0,3,0,3
CH,NP,2012.0,1,0,1
AE,KW,1997.0,1,0,1
AR,CI,2011.0,1,0,1
JM,MQ,2012.0,1,0,1
BG,SI,2009.0,1,0,1
BY,nan,2002.0,1,0,1
PT,GT,2022.0,1,0,1
KR,GT,2017.0,1,0,1
DE,MM,2007.0,1,0,1
CO,AU,1999.0,1,0,1
US,LY,2002.0,3,0,3
MY,QA,2009.0,4,0,4
KE,NA,2013.0,1,0,1
ZM,NO,2013.0,1,0,1
BE,LB,2009.0,2,0,2
NL,LV,2007.0,1,0,1
CW,NO,2002.0,1,0,1
CR,GR,2004.0,1,0,1
CD,MW,2017.0,1,0,1
LA,,2025.0,1,0,1
RU,NP,2017.0,1,0,1
VE,KR,2018.0,1,0,1
TJ,PK,2006.0,1,0,1
KZ,FI,2007.0,1,0,1
TR,ET,2007.0,1,0,1
IQ,IS,2015.0,1,0,1
JM,PT,2019.0,1,0,1
PS,MA,2015.0,1,0,1
BG,TN,2004.0,1,0,1
PK,OM,2005.0,2,0,2
IE,LY,2016.0,1,0,1
KW,ZW,2019.0,1,0,1
ML,PH,2012.0,1,0,1
PL,SK,1998.0,1,0,1
GB,PA,2003.0,2,0,2
SA,MR,2020.0,1,0,1
IS,nan,2020.0,1,0,1
SK,IL,1999.0,1,0,1
TN,CH,1998.0,1,0,1
HU,CR,2019.0,1,0,1
UG,UY,2013.0,1,0,1
SG,EG,2002.0,1,0,1
MQ,US,2000.0,1,0,1
BR,OM,1999.0,1,0,1
JO,LV,2018.0,1,0,1
CO,AE,2017.0,1,0,1
SG,HK,2001.0,2,0,2
LB,IL,2016.0,3,0,3
HR,XK,2007.0,2,0,2
MD,GF,2020.0,1,0,1
NI,DE,2015.0,1,0,1
AE,PH,2021.0,1,0,1
AU,BT,2012.0,1,0,1
KR,PL,2012.0,4,0,4
LV,FR,2013.0,1,0,1
FJ,SA,2006.0,1,0,1
IT,CM,2001.0,2,0,2
CH,GT,2019.0,1,0,1
LT,EE,2009.0,1,0,1
SN,CV,2021.0,1,0,1
MK,DE,2006.0,1,0,1
UY,NE,2017.0,1,0,1
NE,IR,2012.0,1,0,1
RS,TH,2011.0,1,0,1
RU,EG,2000.0,1,0,1
CD,,2002.0,3,0,3
TT,AR,2012.0,1,0,1
AU,UA,2014.0,1,0,1
PA,DE,2001.0,1,0,1
GE,CH,2014.0,3,0,3
RU,IS,2022.0,3,0,3
US,GN,2013.0,1,0,1
RW,HT,2017.0,1,0,1
TZ,NL,1999.0,1,0,1
CU,AT,2006.0,1,0,1
ZW,NG,2000.0,1,0,1
PE,PL,2012.0,1,0,1
UA,PT,2006.0,1,0,1
PH,CU,2012.0,1,0,1
BD,PE,2013.0,1,0,1
OM,IT,2021.0,1,0,1
DE,BB,2013.0,1,0,1
SV,NL,2007.0,1,0,1
PL,GM,2009.0,1,0,1
JP,SN,2017.0,1,0,1
ES,ET,2004.0,1,0,1
LK,MX,2008.0,1,0,1
KG,DE,2018.0,1,0,1
UA,OM,2017.0,1,0,1
DK,,2026.0,1,0,1
RE,CN,2014.0,1,0,1
NG,GD,2019.0,1,0,1
ID,EE,2021.0,1,0,1
IL,MY,2002.0,1,0,1
PT,SS,2000.0,1,0,1
FI,TW,2002.0,1,0,1
BB,AU,2014.0,1,0,1
ZA,PL,1997.0,2,0,2
CL,EE,2022.0,2,0,2
CU,AO,2016.0,1,0,1
KR,IL,2001.0,2,0,2
KZ,PK,2003.0,1,0,1
LK,AE,2018.0,1,0,1
PH,IT,1998.0,1,0,1
UA,AE,2003.0,1,0,1
SD,GR,2007.0,1,0,1
GE,AM,2019.0,1,0,1
BW,HU,2017.0,1,0,1
GY,NL,2008.0,1,0,1
CG,IT,2003.0,1,0,1
ES,PK,2023.0,1,0,1
AU,SJ,2017.0,1,0,1
QA,FI,2022.0,1,0,1
SK,LT,2004.0,1,0,1
IT,GH,1999.0,1,0,1
AM,UA,2001.0,2,0,2
TN,JP,2001.0,2,0,2
SN,GN,2006.0,2,0,2
CA,NA,2022.0,1,0,1
GN,FR,2000.0,2,0,2
AT,CY,2008.0,1,0,1
CA,BB,2010.0,2,0,2
CA,GE,2003.0,2,0,2
TD,BJ,2018.0,1,0,1
MY,RO,2014.0,1,0,1
HU,GR,2018.0,4,0,4
IE,ID,2013.0,1,0,1
PK,PH,2003.0,1,0,1
UA,OM,2010.0,1,0,1
UY,CZ,2011.0,1,0,1
KN,AU,2013.0,1,0,1
VN,VG,2006.0,1,0,1
CZ,LT,2019.0,3,0,3
ZW,CU,2017.0,1,0,1
CO,UG,2018.0,4,0,4
TW,BR,1998.0,1,0,1
MR,CA,2009.0,1,0,1
ST,IT,2015.0,1,0,1
TM,nan,1999.0,1,0,1
TN,BD,2004.0,1,0,1
ES,SN,2014.0,1,0,1
RS,ZM,2003.0,1,0,1
JM,,1998.0,6,0,6
AE,KW,1998.0,1,0,1
SG,nan,2000.0,1,0,1
AT,LI,2001.0,1,0,1
KZ,NL,2006.0,1,0,1
BG,BD,2016.0,1,0,1
MG,CN,2012.0,4,0,4
QA,BD,2009.0,1,0,1
NC,FJ,2012.0,1,1,0
US,LR,2014.0,1,2,-1
AR,PA,2006.0,3,2,1
SD,LB,2022.0,1,1,0
GB,CU,2022.0,1,1,0
JO,SE,2010.0,2,1,1
UA,HU,2019.0,1,3,-2
BN,BD,2017.0,3,3,0
US,LU,2002.0,3,4,-1
ID,PH,2012.0,1,3,-2
GR,AT,2007.0,2,4,-2
WS,AU,2018.0,1,1,0
IL,BG,2002.0,1,2,-1
JP,BY,1997.0,2,1,1
JP,ET,2015.0,1,4,-3
RO,HR,2001.0,1,1,0
KR,CO,2014.0,1,10,-9
AM,ES,2020.0,1,1,0
SG,IL,2011.0,1,3,-2
JP,BY,1998.0,1,2,-1
FR,PH,2003.0,2,2,0
US,BS,2017.0,4,6,-2
NL,HU,1998.0,5,9,-4
ID,TH,2010.0,1,3,-2
TN,MX,2018.0,1,1,0
BH,DE,2018.0,1,1,0
KH,JP,2004.0,2,2,0
ML,DE,2017.0,2,1,1
RO,RS,2010.0,1,2,-1
EG,ZA,2017.0,6,6,0
BE,RO,2023.0,1,1,0
UY,SE,2016.0,1,3,-2
IT,MM,2020.0,1,1,0
ES,NG,2020.0,1,1,0
CH,TR,1999.0,3,5,-2
DE,UZ,2011.0,1,4,-3
VN,EE,2017.0,1,1,0
DK,ZA,1998.0,1,2,-1
MA,IR,2011.0,6,1,5
HR,JP,1999.0,1,2,-1
PH,PK,2016.0,1,3,-2
FI,NZ,2015.0,3,5,-2
AT,TZ,2011.0,1,1,0
FI,BD,2012.0,2,4,-2
PT,AT,2012.0,4,4,0
PT,CU,2012.0,3,1,2
ZA,TT,2021.0,1,1,0
PG,US,2002.0,1,1,0
KR,MM,2014.0,1,2,-1
EC,NL,2022.0,3,4,-1
BO,ES,1998.0,1,1,0
BG,GR,2016.0,1,4,-3
KR,RO,2015.0,1,3,-2
PH,MY,2017.0,2,5,-3
AT,LU,2014.0,3,2,1
FI,SA,2014.0,2,2,0
CA,MD,2020.0,1,1,0
SY,GB,1997.0,2,1,1
NO,SK,1998.0,1,1,0
QA,BE,2014.0,1,2,-1
AU,NG,2011.0,3,5,-2
SE,GH,2012.0,1,1,0
KW,US,2023.0,1,2,-1
JP,CM,2022.0,1,1,0
FR,BH,2020.0,1,2,-1
DZ,BE,2006.0,1,1,0
BJ,BF,2018.0,1,1,0
LT,BY,2020.0,1,4,-3
NL,MK,2016.0,2,1,1
IR,IQ,2009.0,1,1,0
AE,TW,2018.0,2,1,1
LK,AU,2007.0,1,5,-4
BH,OM,2015.0,1,2,-1
CZ,KE,1997.0,1,1,0
MX,IL,2003.0,1,2,-1
GR,HU,2005.0,3,1,2
ET,MX,2021.0,2,1,1
SG,PH,2005.0,4,4,0
CN,SK,2021.0,2,3,-1
CA,BW,2004.0,1,1,0
KW,SE,2007.0,1,2,-1
QA,TW,2017.0,1,2,-1
AE,PL,2018.0,2,3,-1
KE,ES,2016.0,2,2,0
CZ,TN,2012.0,1,1,0
ZA,IN,2023.0,1,4,-3
GR,IR,2021.0,1,2,-1
MY,IL,2020.0,1,2,-1
MM,RU,2020.0,1,1,0
FR,IL,2023.0,1,1,0
TR,SD,2017.0,1,2,-1
KH,US,2011.0,2,2,0
KZ,RS,2010.0,1,2,-1
LU,UG,2015.0,1,1,0
PT,SI,2012.0,1,3,-2
LY,JO,2017.0,1,2,-1
CL,nan,2004.0,1,3,-2
KR,QA,2011.0,1,3,-2
TW,DK,2004.0,1,1,0
SC,GB,2008.0,1,1,0
TH,IE,2019.0,1,1,0
BE,HK,2020.0,2,1,1
IN,IE,2000.0,1,4,-3
JP,LY,1999.0,1,2,-1
IT,CI,2014.0,1,1,0
OM,AE,2005.0,2,1,1
BR,MZ,2002.0,1,1,0
EC,JP,2020.0,1,3,-2
DZ,MX,2010.0,1,1,0
ZA,NO,1997.0,1,1,0
KE,RW,2017.0,1,4,-3
AT,TW,2004.0,1,1,0
PL,TR,2006.0,1,1,0
SG,LK,2021.0,1,2,-1
JM,FR,2021.0,1,1,0
PL,NZ,2015.0,1,1,0
VN,BE,2009.0,1,3,-2
RU,BD,2019.0,2,1,1
GH,LK,2013.0,1,1,0
AZ,TR,1997.0,1,2,-1
SD,NL,2008.0,1,1,0
ES,KR,2000.0,1,4,-3
SZ,NG,2020.0,2,1,1
KR,RU,2023.0,1,1,0
RU,MD,2021.0,1,4,-3
JO,SE,2019.0,1,2,-1
NO,IL,2002.0,1,3,-2
SD,NG,2022.0,1,4,-3
GR,BR,2006.0,1,2,-1
DE,KW,2002.0,1,1,0
SK,FI,2020.0,1,4,-3
FR,GE,2016.0,1,1,0
MD,US,2011.0,1,3,-2
GB,NC,2019.0,1,1,0
MA,US,2023.0,1,1,0
KE,TR,2021.0,1,2,-1
NL,PH,1997.0,1,2,-1
PK,RU,2005.0,1,1,0
CD,FR,1999.0,1,1,0
MN,DZ,2010.0,1,1,0
BH,TN,2019.0,1,2,-1
KE,CI,2018.0,1,1,0
HU,CH,1999.0,1,2,-1
DK,SK,2012.0,3,8,-5
US,CW,2014.0,2,1,1
EE,CZ,2016.0,2,2,0
BE,CG,2015.0,2,1,1
KE,RW,2019.0,3,3,0
PG,CH,2011.0,1,1,0
RO,VN,2017.0,2,7,-5
EG,CZ,2015.0,1,2,-1
IN,VN,2009.0,1,2,-1
GR,EC,2001.0,1,2,-1
QA,SK,2017.0,1,1,0
JP,HR,2008.0,1,2,-1
FR,JO,2018.0,3,1,2
CU,BE,2006.0,1,2,-1
UY,GB,2011.0,1,3,-2
KR,UA,2015.0,1,4,-3
DK,SI,2016.0,1,2,-1
PT,UY,2001.0,1,1,0
ID,RO,2018.0,1,10,-9
CO,UA,2001.0,2,0,2
KH,GA,2017.0,1,0,1
KE,IE,2016.0,1,0,1
GB,SR,2019.0,1,0,1
NA,SE,2018.0,1,0,1
IL,NZ,2008.0,3,0,3
OM,TR,2003.0,2,0,2
ZM,FI,2021.0,1,0,1
FR,OM,2002.0,2,0,2
VE,PH,2006.0,1,0,1
SA,NL,2006.0,1,0,1
KE,SA,2011.0,1,0,1
DK,LK,2010.0,1,0,1
TZ,CA,2006.0,1,0,1
UA,ZA,2007.0,1,0,1
US,TG,2004.0,1,0,1
BE,CR,2014.0,1,0,1
BD,MX,2003.0,1,0,1
BI,BE,1998.0,1,0,1
IL,HR,2016.0,1,0,1
DE,SI,2023.0,1,0,1
JP,EE,2021.0,1,0,1
JO,TW,2021.0,1,0,1
KH,FR,2005.0,1,0,1
NZ,AE,2001.0,3,0,3
IT,GF,2017.0,1,0,1
LB,JP,2000.0,1,0,1
IT,QA,2012.0,1,0,1
UA,HU,2010.0,1,0,1
DZ,MX,2019.0,1,0,1
ZM,ZA,2023.0,1,0,1
CV,,2017.0,2,0,2
CD,,2005.0,2,0,2
DE,YE,2003.0,1,0,1
RS,RO,2020.0,1,0,1
MG,GP,2011.0,1,0,1
DK,SJ,2019.0,1,0,1
SE,BH,2004.0,1,0,1
RU,TJ,1999.0,1,0,1
PR,GB,2019.0,2,0,2
CA,TZ,2021.0,1,0,1
IN,MD,2015.0,1,0,1
BR,LK,1998.0,1,0,1
GF,nan,2013.0,1,0,1
PS,ID,2017.0,1,0,1
RU,NP,2019.0,1,0,1
RO,KZ,2015.0,1,0,1
AZ,IN,2000.0,1,0,1
ID,KH,2021.0,2,0,2
SC,AU,2019.0,1,0,1
ZA,OM,2015.0,1,0,1
GH,BH,2005.0,5,0,5
LB,TR,2009.0,1,0,1
KR,DZ,2009.0,1,0,1
MG,CG,2022.0,1,0,1
BE,MG,2013.0,1,0,1
FI,IS,2003.0,1,0,1
ES,SI,1998.0,1,0,1
KH,IN,2017.0,2,0,2
ZA,AR,2011.0,1,0,1
RE,US,2002.0,1,0,1
GB,YE,2019.0,1,0,1
US,GD,2002.0,1,0,1
MT,AR,2007.0,1,0,1
BE,PF,2014.0,1,0,1
HK,BR,2016.0,2,0,2
PT,AZ,2020.0,1,0,1
IN,GY,2018.0,1,0,1
BE,GE,2012.0,1,0,1
AE,IR,2002.0,1,0,1
GB,EC,2002.0,1,0,1
FR,KW,2001.0,2,0,2
GB,BB,2003.0,2,0,2
IT,HN,2012.0,1,0,1
SD,SS,2014.0,1,0,1
DO,CL,2004.0,1,0,1
GW,GB,2011.0,1,0,1
GE,MY,2010.0,1,0,1
MW,IN,1997.0,1,0,1
CL,DK,2012.0,1,0,1
SN,IE,2021.0,1,0,1
KZ,RS,2019.0,1,0,1
RU,VG,2001.0,1,0,1
CN,ZA,2000.0,1,0,1
IN,BW,1999.0,1,0,1
IR,IS,2016.0,1,0,1
LK,DE,2004.0,1,0,1
IT,MD,1999.0,1,0,1
SL,NL,2017.0,1,0,1
ZM,BE,2006.0,1,0,1
SG,EE,2021.0,1,0,1
HR,MX,2021.0,1,0,1
CA,BJ,2001.0,1,0,1
GL,QA,2015.0,1,0,1
AU,BB,2018.0,1,0,1
GB,MG,2014.0,1,0,1
FR,CW,1998.0,1,0,1
TH,TZ,2021.0,1,0,1
AZ,TJ,2021.0,1,0,1
JE,,2007.0,1,0,1
ES,TH,2005.0,1,0,1
MT,DK,2018.0,1,0,1
GB,BH,1997.0,1,0,1
NO,CL,2009.0,1,0,1
LU,AU,1997.0,1,0,1
RO,UY,2013.0,1,0,1
MW,IT,2020.0,1,0,1
LU,ET,2016.0,1,0,1
TN,ML,2012.0,1,0,1
ZA,MG,2006.0,1,0,1
MC,GB,2022.0,1,0,1
PK,GH,2018.0,1,0,1
GN,US,2003.0,1,0,1
IN,SD,1997.0,1,0,1
LS,CA,2012.0,1,0,1
MQ,TG,2017.0,1,0,1
CZ,NZ,2006.0,1,0,1
IR,TN,1998.0,1,0,1
BR,BJ,2013.0,1,0,1
GT,RU,2006.0,1,0,1
KH,NL,2007.0,1,0,1
GB,MN,2000.0,1,0,1
AR,IL,2022.0,1,0,1
TH,ET,2008.0,1,0,1
PT,RS,2004.0,1,0,1
UA,PH,2006.0,1,0,1
EG,LK,2015.0,1,0,1
TH,LA,2002.0,1,0,1
RO,LT,2010.0,2,0,2
JP,LV,2015.0,1,0,1
MR,FR,1999.0,1,0,1
AU,CL,1997.0,1,0,1
BN,,1999.0,1,0,1
MA,BF,2002.0,1,0,1
BG,BH,2016.0,1,0,1
MM,ZM,2019.0,1,0,1
RO,PT,2004.0,1,0,1
FR,MT,1999.0,1,0,1
GD,CN,2022.0,1,0,1
MC,AU,1998.0,1,0,1
BR,QA,2011.0,1,0,1
JM,PT,2017.0,1,0,1
IQ,SY,2005.0,1,0,1
nan,MC,2009.0,2,0,2
ET,DZ,2018.0,1,0,1
GT,GB,2004.0,1,0,1
RS,TN,2013.0,1,0,1
MT,BR,2005.0,1,0,1
AT,QA,2010.0,1,0,1
MT,DE,2000.0,1,0,1
BA,PL,2003.0,1,0,1
MY,SN,2018.0,1,0,1
IQ,SG,2015.0,1,0,1
ZW,SZ,2006.0,1,0,1
SE,SJ,2004.0,1,0,1
nan,TG,2014.0,1,0,1
HK,ZA,2016.0,1,0,1
IQ,BA,2012.0,1,0,1
GT,,2011.0,1,0,1
NG,ZM,2001.0,1,0,1
BR,BN,2015.0,1,0,1
GT,JP,2009.0,1,0,1
IN,PR,2019.0,1,0,1
LS,GB,2008.0,1,0,1
IN,MW,2012.0,1,0,1
RU,SA,2009.0,1,0,1
HU,PH,2009.0,1,0,1
IE,LT,2010.0,1,0,1
MX,SY,2005.0,1,0,1
BJ,CN,2012.0,1,0,1
TM,AZ,2002.0,1,0,1
ZA,NO,1998.0,1,0,1
PK,LY,2021.0,1,0,1
LK,ID,2004.0,1,0,1
SI,nan,2023.0,1,0,1
PA,PE,2012.0,1,0,1
CF,JP,2009.0,1,0,1
HR,QA,2016.0,1,0,1
nan,UY,2012.0,2,0,2
KE,SZ,2002.0,1,0,1
SL,NL,2019.0,1,0,1
NE,IT,2009.0,1,0,1
NA,BW,2016.0,1,0,1
MA,MG,2020.0,1,0,1
MQ,GF,2011.0,1,0,1
PR,AR,2005.0,1,0,1
PH,FI,2017.0,1,0,1
ES,EE,2004.0,1,0,1
AU,RE,2022.0,1,0,1
BD,VN,2007.0,1,0,1
MM,DE,2006.0,1,0,1
MA,BF,2005.0,1,0,1
NZ,BW,2017.0,1,0,1
FR,SV,2020.0,1,0,1
GM,PH,2012.0,1,0,1
SN,CI,2022.0,2,0,2
KE,OM,2019.0,1,0,1
KZ,BY,2022.0,1,0,1
US,EG,2014.0,236,168,68
US,DE,2007.0,2056,2224,-168
CO,ES,2016.0,473,648,-175
CO,US,2019.0,451,345,106
CA,GB,2011.0,754,884,-130
US,IT,2004.0,628,639,-11
US,IN,2006.0,1068,1294,-226
SA,IN,2021.0,94,107,-13
IT,DZ,2017.0,56,43,13
US,JP,2019.0,1794,1698,96
CA,NZ,2012.0,46,63,-17
FR,PT,2016.0,62,56,6
US,MY,2020.0,163,150,13
CN,CA,2011.0,421,505,-84
NL,IN,2007.0,29,32,-3
US,GB,2000.0,3492,3368,124
GB,NL,2020.0,396,376,20
US,JP,2010.0,1792,1740,52
SE,GB,2007.0,153,151,2
GB,AU,2021.0,1088,1076,12
US,AU,2014.0,2514,2162,352
IT,CU,2013.0,2,6,-4
PH,US,2004.0,255,279,-24
DE,CN,2008.0,243,208,35
IL,US,2002.0,410,316,94
nan,GB,1997.0,15,17,-2
JP,CN,2001.0,377,327,50
CO,US,2010.0,174,195,-21
US,VG,2003.0,6,3,3
CO,US,2017.0,341,370,-29
FR,US,2021.0,1088,1008,80
AU,ZA,2005.0,23,35,-12
CH,BR,2014.0,51,43,8
US,JP,2017.0,1891,1702,189
JP,KR,2004.0,217,170,47
ES,CA,2010.0,72,68,4
IT,CH,2016.0,420,278,142
IL,US,2005.0,453,317,136
MA,FR,2017.0,239,264,-25
FI,AT,2008.0,7,9,-2
BR,PT,2015.0,1018,1047,-29
CA,ES,2014.0,79,121,-42
DK,DE,2015.0,131,182,-51
EG,AU,2015.0,18,16,2
US,IR,2021.0,371,558,-187
IE,US,2010.0,378,491,-113
KR,CA,2015.0,58,55,3
TW,US,2000.0,368,495,-127
DE,IL,2009.0,46,57,-11
CN,AU,2011.0,313,323,-10
SG,TW,2007.0,31,26,5
FR,DE,2018.0,586,518,68
CN,GB,2008.0,359,489,-130
GB,ES,2018.0,430,541,-111
MA,FR,2019.0,238,304,-66
US,AE,2012.0,87,42,45
DE,FR,2021.0,367,407,-40
IE,AE,2015.0,4,2,2
NZ,US,2012.0,336,390,-54
IE,US,2019.0,536,591,-55
NO,FR,2004.0,38,48,-10
IT,CZ,2007.0,16,14,2
SG,US,2004.0,193,200,-7
DK,HR,2017.0,2,5,-3
AU,ES,2005.0,15,19,-4
SA,US,2019.0,235,363,-128
BE,DE,2022.0,70,79,-9
SE,CN,2018.0,136,103,33
IT,ES,2000.0,64,63,1
US,BD,2012.0,100,84,16
FI,JP,1997.0,8,6,2
AT,nan,2020.0,11,10,1
GB,JP,2015.0,359,279,80
JP,BE,2013.0,26,27,-1
MX,BR,2020.0,166,145,21
US,EC,2007.0,15,9,6
US,ZA,2020.0,313,402,-89
nan,CN,2022.0,80,71,9
SE,RU,2001.0,26,31,-5
DE,SE,2015.0,254,224,30
IR,US,2012.0,447,238,209
NZ,GB,2007.0,189,222,-33
ET,NO,2022.0,4,2,2
GR,GB,2017.0,323,172,151
MA,FR,2010.0,251,236,15
SE,ES,1999.0,27,15,12
MX,US,2000.0,157,155,2
IL,BE,2001.0,6,5,1
DE,SG,2009.0,49,25,24
FR,GB,1998.0,215,185,30
EC,CO,2019.0,145,207,-62
ZA,GB,2022.0,97,86,11
CN,MY,2019.0,127,130,-3
DK,US,2014.0,249,302,-53
IQ,PK,2019.0,27,28,-1
IS,US,2020.0,18,18,0
IE,US,2017.0,578,564,14
CL,BR,2004.0,25,24,1
US,LB,2000.0,26,20,6
NO,KR,2004.0,4,2,2
SE,IN,2018.0,47,74,-27
FR,MX,2005.0,43,28,15
RU,LT,2002.0,1,5,-4
IL,GB,2016.0,84,60,24
GR,GB,2019.0,271,236,35
ES,PT,2016.0,218,176,42
AU,NZ,2004.0,86,97,-11
SG,AU,2009.0,79,74,5
CN,TR,2018.0,17,39,-22
GB,PE,2020.0,19,23,-4
NL,nan,2008.0,46,66,-20
TH,DE,2011.0,14,17,-3
ES,EC,2021.0,153,191,-38
GB,DK,2001.0,54,56,-2
CN,KR,2008.0,217,271,-54
CA,NL,2013.0,85,89,-4
nan,IN,2008.0,21,19,2
SE,EG,2014.0,8,7,1
NZ,IT,2021.0,10,6,4
JP,SA,2013.0,22,4,18
AE,US,2016.0,62,91,-29
DK,CA,2005.0,20,15,5
BE,NL,1997.0,71,83,-12
PE,CO,2002.0,16,8,8
PE,MX,2021.0,73,113,-40
US,FI,1998.0,106,97,9
US,SE,2000.0,220,249,-29
nan,US,2023.0,4,7,-3
IN,CA,2020.0,270,259,11
CN,MY,2017.0,105,92,13
KR,PR,2006.0,35,29,6
AU,JP,2017.0,91,76,15
AU,JP,2019.0,83,85,-2
MY,CN,2013.0,51,64,-13
EG,US,2007.0,71,144,-73
TW,KR,1999.0,15,14,1
HR,RS,2021.0,110,102,8
US,IQ,2018.0,89,39,50
DE,CA,2005.0,193,153,40
ID,KR,2020.0,44,50,-6
CO,GB,2003.0,10,12,-2
IN,CN,2020.0,292,200,92
BD,CA,2019.0,48,46,2
TH,VN,2020.0,26,8,18
SA,GB,2017.0,76,185,-109
CA,nan,2019.0,39,50,-11
IE,NZ,2013.0,20,11,9
CO,CR,2018.0,50,39,11
ES,CH,2019.0,146,96,50
MK,GB,2019.0,4,6,-2
ZA,CA,2019.0,60,51,9
NL,GB,2013.0,325,308,17
KR,ID,2015.0,24,14,10
VN,GR,2001.0,3,5,-2
GR,DE,2019.0,77,66,11
BE,BR,2022.0,27,41,-14
MY,BR,2020.0,29,27,2
FR,LB,2021.0,64,74,-10
GB,TR,2016.0,131,101,30
AR,NL,2017.0,8,7,1
BG,CN,2005.0,6,4,2
US,SY,2011.0,10,7,3
CN,KE,2002.0,3,2,1
MM,CN,2006.0,9,4,5
CN,MN,2015.0,6,6,0
CN,IN,2004.0,57,69,-12
NL,CN,2015.0,126,140,-14
IE,PT,2017.0,9,6,3
UA,RU,2011.0,158,148,10
RU,CL,2012.0,3,6,-3
US,PL,2000.0,124,108,16
IR,ID,2016.0,28,5,23
BE,JP,2013.0,27,26,1
NL,CL,2009.0,5,4,1
BG,CN,2002.0,3,1,2
GR,GB,2010.0,181,169,12
ES,CN,2013.0,57,71,-14
CN,BD,2020.0,39,54,-15
CA,PH,2006.0,4,4,0
US,MM,2012.0,3,3,0
US,NG,2020.0,116,158,-42
AU,VN,2022.0,45,44,1
TN,FR,2017.0,151,223,-72
NL,FR,2020.0,136,154,-18
MX,CO,2015.0,341,335,6
FR,CZ,2014.0,40,26,14
JP,IN,2002.0,88,124,-36
US,SI,2014.0,22,20,2
RS,GB,2016.0,22,21,1
IR,AE,2018.0,16,5,11
ES,CA,2019.0,112,84,28
CO,PE,2012.0,57,43,14
ET,BH,2013.0,7,4,3
JP,ZA,2015.0,15,9,6
CY,GR,2021.0,38,51,-13
TH,SA,2019.0,7,3,4
US,GR,2022.0,72,85,-13
RU,GR,2006.0,7,1,6
CA,LB,2013.0,15,9,6
HU,SE,2019.0,10,13,-3
FR,KR,2013.0,31,37,-6
PL,GR,2013.0,16,5,11
CR,BE,2018.0,3,1,2
RU,UA,1997.0,33,37,-4
CH,SI,2021.0,9,6,3
JP,CA,1997.0,68,77,-9
AU,TH,2022.0,9,13,-4
MX,CA,2013.0,36,42,-6
NO,nan,2015.0,19,24,-5
FR,IE,2013.0,41,32,9
OM,IN,2014.0,22,26,-4
IE,DE,2000.0,14,25,-11
SA,GB,2010.0,30,76,-46
SG,TH,2015.0,6,5,1
IN,ZA,2005.0,18,13,5
FR,IN,2014.0,126,120,6
DE,IN,2012.0,166,175,-9
US,NO,2002.0,74,80,-6
MM,US,2017.0,6,9,-3
SA,ID,2014.0,12,14,-2
CU,CR,2016.0,17,23,-6
CA,KR,2004.0,25,28,-3
GR,ES,2019.0,17,11,6
GB,IR,2020.0,84,128,-44
TN,CA,2003.0,6,1,5
AG,CO,2022.0,19,21,-2
DE,CA,2002.0,155,145,10
BE,CA,2004.0,38,20,18
ZA,ID,2016.0,16,30,-14
AT,NO,2019.0,16,13,3
GR,DE,2017.0,86,40,46
TR,nan,2020.0,23,30,-7
JP,IN,2005.0,112,107,5
SE,CL,2018.0,13,9,4
AT,PL,2011.0,10,11,-1
JP,BG,2008.0,5,5,0
IE,BR,2009.0,13,7,6
EG,YE,2016.0,7,5,2
AU,nan,2011.0,51,32,19
JP,EG,2020.0,54,49,5
DE,ZA,2012.0,61,45,16
BR,MY,2020.0,27,29,-2
RU,GB,2018.0,91,135,-44
ES,CH,2010.0,86,61,25
IT,PT,2015.0,33,37,-4
ES,CH,2017.0,140,75,65
PK,US,2003.0,54,70,-16
TZ,GB,2022.0,8,11,-3
FR,MG,2022.0,4,4,0
CN,AR,2020.0,5,2,3
CH,JO,2011.0,1,2,-1
CZ,AU,2014.0,6,10,-4
LK,US,2007.0,19,9,10
RO,GB,2013.0,24,53,-29
SA,EG,2008.0,65,96,-31
CZ,DK,2008.0,2,4,-2
CR,MX,2003.0,11,9,2
DE,EE,2014.0,57,43,14
ET,IT,2014.0,4,2,2
US,PA,2020.0,41,46,-5
NL,ID,2021.0,47,35,12
CU,ES,2008.0,101,87,14
RU,UA,1998.0,49,55,-6
US,NO,2005.0,101,91,10
AT,CH,2013.0,120,110,10
EC,UA,2007.0,11,13,-2
DK,PT,2015.0,7,11,-4
AU,BE,2013.0,38,38,0
CA,nan,2010.0,29,32,-3
NL,JP,2018.0,41,27,14
MY,AU,2013.0,105,116,-11
RU,BR,2001.0,6,10,-4
MX,nan,2015.0,32,28,4
AU,ES,2002.0,10,14,-4
US,SA,2006.0,64,41,23
TN,FR,2019.0,186,217,-31
IT,NL,2012.0,114,88,26
KZ,RU,2020.0,92,112,-20
IE,nan,2008.0,2,3,-1
ES,IT,2006.0,114,123,-9
SG,JP,2012.0,31,50,-19
HU,PL,1998.0,4,4,0
IN,MX,2015.0,16,16,0
US,HU,2013.0,95,106,-11
CL,FR,2017.0,46,62,-16
PL,nan,2020.0,18,32,-14
EC,CO,2017.0,73,163,-90
SI,DE,2021.0,13,9,4
BE,ZA,2021.0,14,20,-6
CL,CR,2015.0,23,15,8
CR,CO,2018.0,39,50,-11
GB,AE,2022.0,33,28,5
DE,FI,2012.0,59,58,1
HK,US,2012.0,14,12,2
FR,BR,2022.0,79,137,-58
TN,DE,2019.0,9,2,7
EC,DO,2018.0,3,1,2
FR,DK,2020.0,57,41,16
ZA,CA,2010.0,32,33,-1
IQ,MY,2014.0,31,48,-17
ZM,GB,2017.0,5,11,-6
PL,AT,2008.0,18,9,9
GB,ZA,2022.0,86,97,-11
BD,DK,2021.0,4,4,0
ZW,US,2011.0,7,6,1
DE,IE,2013.0,63,76,-13
nan,RU,2010.0,48,50,-2
SK,MK,2018.0,2,1,1
KE,US,2020.0,82,107,-25
JM,TT,2017.0,20,12,8
SI,US,2022.0,15,11,4
KR,TW,2018.0,48,58,-10
FR,FI,2011.0,24,24,0
US,GE,2018.0,150,208,-58
SE,nan,2012.0,34,46,-12
IL,RU,2016.0,29,30,-1
CY,US,1999.0,3,10,-7
DE,IR,2012.0,46,60,-14
FR,MX,2002.0,32,22,10
TW,TH,2018.0,16,11,5
KR,SD,2022.0,15,15,0
AU,PL,2008.0,13,10,3
FR,PL,2019.0,49,38,11
DK,BD,2021.0,4,4,0
SK,US,2003.0,21,18,3
GM,GB,2006.0,8,15,-7
ID,RU,2021.0,14,30,-16
DK,AU,2010.0,28,34,-6
EE,DE,2019.0,58,74,-16
MX,CU,2014.0,53,52,1
CN,RS,2022.0,2,3,-1
BR,UY,2022.0,21,22,-1
CN,SE,2023.0,26,6,20
US,KW,2020.0,31,17,14
TR,NL,2020.0,37,36,1
LV,US,2021.0,4,6,-2
IN,SG,2001.0,19,12,7
BR,IL,2012.0,5,8,-3
EE,CH,2019.0,16,8,8
IN,ET,2021.0,54,27,27
NO,GB,2015.0,73,116,-43
VN,TW,2021.0,24,39,-15
HU,SE,2017.0,11,8,3
ET,NL,2021.0,10,6,4
NG,BE,2021.0,4,3,1
FI,PL,2021.0,10,9,1
BR,TR,2016.0,21,30,-9
FR,GA,2021.0,6,6,0
FR,nan,1999.0,55,32,23
BE,GR,2020.0,21,35,-14
ID,QA,2017.0,5,4,1
AU,CU,2018.0,3,4,-1
AU,JM,2012.0,5,1,4
US,CL,2014.0,247,201,46
TN,FR,2010.0,129,173,-44
EC,UY,2019.0,5,7,-2
DZ,CN,2018.0,7,5,2
AU,JP,2010.0,66,83,-17
MZ,LT,2012.0,12,2,10
CL,FR,2010.0,37,37,0
IE,ES,2015.0,23,51,-28
FR,SI,2017.0,6,14,-8
AU,DE,2016.0,238,251,-13
PK,FR,2015.0,20,21,-1
EE,FI,2003.0,6,9,-3
IN,IL,2014.0,59,17,42
CN,DE,2020.0,424,426,-2
DE,PA,2021.0,4,2,2
GR,ES,2010.0,19,12,7
FR,BJ,2014.0,33,33,0
EG,IL,2018.0,8,7,1
AT,SK,2020.0,19,14,5
CN,FI,2002.0,11,8,3
KH,NL,2002.0,4,1,3
RO,PT,2020.0,6,6,0
CA,nan,2017.0,42,88,-46
JP,UA,2022.0,2,1,1
GB,SE,2014.0,188,190,-2
PK,nan,2016.0,5,8,-3
BR,HU,2018.0,5,3,2
US,QA,2011.0,61,22,39
IT,BE,2014.0,178,120,58
MX,DE,2007.0,30,29,1
DE,BI,2006.0,1,1,0
BR,JP,1997.0,16,17,-1
SE,UA,2015.0,7,10,-3
DE,NG,2017.0,8,9,-1
nan,PK,2016.0,8,5,3
BE,NO,2022.0,9,10,-1
KE,NL,2017.0,9,10,-1
NL,NZ,2012.0,18,11,7
JM,TT,2010.0,17,13,4
US,HR,2012.0,38,55,-17
nan,ET,2014.0,4,3,1
SG,MX,2010.0,9,3,6
TR,TW,2006.0,8,13,-5
US,FI,1997.0,79,89,-10
CA,IR,2000.0,16,6,10
CZ,nan,2012.0,8,12,-4
SA,DE,2012.0,13,35,-22
MX,SI,2010.0,3,2,1
PL,CA,2012.0,20,27,-7
BG,RS,2013.0,6,1,5
FR,VN,2014.0,41,21,20
FI,ID,2017.0,2,5,-3
PL,ES,2013.0,14,17,-3
CZ,RS,2015.0,13,17,-4
BR,AU,1999.0,18,19,-1
CA,SG,2022.0,23,32,-9
EE,DE,2010.0,34,51,-17
PT,CA,2008.0,9,15,-6
MK,GB,2010.0,7,3,4
ES,EE,2020.0,3,3,0
PK,MA,2015.0,23,12,11
GB,SG,1998.0,24,16,8
IL,SI,2019.0,2,1,1
SK,NL,2015.0,7,6,1
AU,CZ,2016.0,9,7,2
ID,CZ,2020.0,15,8,7
DK,AU,2017.0,56,49,7
BE,FI,2015.0,10,7,3
ES,DK,2021.0,40,27,13
DK,AU,2019.0,47,70,-23
IE,PT,2010.0,4,5,-1
PS,CN,2011.0,1,1,0
NO,IT,2020.0,29,39,-10
UA,nan,2009.0,10,18,-8
PT,DK,2021.0,7,10,-3
AO,BR,2001.0,3,7,-4
PH,MX,2018.0,11,15,-4
IT,CL,2015.0,34,25,9
MX,SI,2019.0,6,5,1
VN,RS,2017.0,2,3,-1
IT,DZ,2019.0,58,39,19
MY,PH,2018.0,2,5,-3
PE,DE,2016.0,9,11,-2
IR,GB,1998.0,2,19,-17
AU,ZA,2002.0,28,29,-1
TW,DE,2016.0,29,34,-5
IN,CZ,2015.0,15,16,-1
GB,PL,2000.0,30,18,12
HR,CH,2010.0,6,5,1
JP,IL,2002.0,9,11,-2
GE,RU,2006.0,8,1,7
MX,JP,2021.0,6,5,1
CZ,SK,1999.0,21,26,-5
CD,BE,2018.0,10,10,0
FR,HU,2007.0,21,20,1
FI,ID,2019.0,14,3,11
NZ,QA,2018.0,1,4,-3
CL,FR,2019.0,46,53,-7
TH,CA,2020.0,12,11,1
ES,AT,2022.0,22,13,9
TR,RS,2013.0,72,106,-34
ES,MZ,2010.0,3,2,1
LB,CN,2014.0,48,32,16
KR,AT,2021.0,6,3,3
NO,IN,1998.0,21,15,6
HR,DE,1997.0,14,3,11
BO,FR,2013.0,7,1,6
CN,EC,2019.0,4,1,3
VE,BR,2018.0,36,19,17
FR,GP,2014.0,19,18,1
NO,SE,2009.0,54,103,-49
CO,UY,2018.0,30,12,18
GR,DE,2010.0,58,41,17
CI,ML,2018.0,5,3,2
FR,PL,2010.0,47,41,6
FR,NE,2019.0,37,31,6
RO,MX,2020.0,2,2,0
RU,CZ,2011.0,33,21,12
CY,IR,2020.0,3,9,-6
QA,KR,2021.0,7,1,6
FR,KH,2021.0,2,3,-1
CU,BR,2007.0,19,15,4
AE,GB,2005.0,6,11,-5
ES,SE,2000.0,18,14,4
IR,FR,2012.0,26,46,-20
TR,CH,2021.0,27,17,10
FR,MC,2013.0,12,1,11
FR,CM,2015.0,26,21,5
UY,CL,2016.0,11,15,-4
JP,GR,2009.0,36,44,-8
VN,CN,2013.0,29,22,7
EC,FR,2014.0,5,6,-1
LK,GB,2012.0,15,23,-8
RU,AZ,2013.0,8,8,0
SE,AU,2002.0,23,19,4
GP,FR,2011.0,16,19,-3
FI,EE,2015.0,14,9,5
FR,PL,2017.0,54,46,8
FR,NE,2017.0,34,20,14
BE,PT,2014.0,14,20,-6
NO,NL,2008.0,24,23,1
AU,GR,2001.0,2,5,-3
US,RW,2021.0,17,14,3
nan,GB,1998.0,30,23,7
IL,SG,2009.0,3,1,2
BR,NO,2016.0,13,46,-33
NP,KR,2022.0,6,12,-6
JP,AR,2008.0,7,3,4
IR,VN,2021.0,7,5,2
TN,DE,2017.0,10,8,2
ID,UZ,2019.0,3,2,1
LV,JP,2020.0,1,2,-1
AM,RU,2012.0,7,5,2
UA,CN,2022.0,14,16,-2
IN,CM,2018.0,3,2,1
CA,SA,2022.0,46,37,9
GR,SI,2018.0,1,1,0
GB,TH,2001.0,26,19,7
DE,GR,2020.0,56,99,-43
RS,SK,2008.0,7,6,1
ZA,NA,2019.0,23,8,15
BR,RE,2015.0,2,1,1
LT,RO,2000.0,3,5,-2
BD,CA,2017.0,51,36,15
NO,NP,2020.0,6,2,4
ET,TR,2017.0,2,2,0
US,CG,2013.0,1,1,0
MX,EC,2011.0,14,9,5
ES,CA,2017.0,87,104,-17
NZ,NP,2022.0,29,36,-7
AE,SY,2016.0,1,1,0
MX,AR,2023.0,2,1,1
ZA,NA,2017.0,14,7,7
JP,NP,2019.0,19,5,14
QA,SA,2020.0,17,50,-33
UG,IN,2009.0,1,1,0
NO,US,2012.0,115,165,-50
TR,FR,2014.0,19,28,-9
TH,FR,2005.0,5,8,-3
US,TJ,2020.0,5,1,4
GB,ID,2004.0,6,1,5
AR,AU,2016.0,15,9,6
FR,DZ,2009.0,100,51,49
TG,FR,2017.0,5,3,2
AU,RU,2004.0,13,8,5
DK,NZ,2008.0,7,7,0
GR,ES,2017.0,17,27,-10
GB,UA,2008.0,5,10,-5
TN,IR,2009.0,3,2,1
CZ,SE,2014.0,17,14,3
IT,RO,1998.0,8,6,2
NZ,MX,2017.0,4,3,1
NL,DK,2021.0,42,55,-13
BY,DE,2008.0,8,8,0
nan,NO,2009.0,33,26,7
RU,JP,2007.0,43,30,13
AE,JP,2013.0,3,5,-2
HU,SE,2010.0,11,15,-4
BE,AT,2008.0,11,9,2
AE,GB,2002.0,4,8,-4
SI,PL,2016.0,5,3,2
FI,PT,2014.0,6,7,-1
IQ,PL,2017.0,2,2,0
SI,ES,2011.0,6,11,-5
IR,EG,2008.0,3,3,0
GH,CA,2014.0,5,5,0
TR,SE,1999.0,3,5,-2
IT,AR,2001.0,29,31,-2
DE,NO,2004.0,43,25,18
DK,FI,2006.0,9,6,3
BR,DE,2000.0,33,48,-15
BN,MY,2011.0,2,3,-1
SG,CH,2006.0,5,6,-1
FI,QA,2016.0,1,2,-1
UA,GB,2009.0,12,8,4
GR,CA,2011.0,11,9,2
NL,SG,2008.0,10,6,4
AU,MX,2012.0,11,10,1
ZA,RO,2018.0,4,7,-3
IR,NZ,2004.0,1,1,0
CA,PK,2006.0,11,6,5
ZA,TH,2008.0,3,1,2
CA,MX,2004.0,23,15,8
NO,PT,2010.0,3,4,-1
GR,FR,2003.0,21,27,-6
IL,AR,2000.0,6,3,3
GB,SG,1997.0,15,7,8
PT,MA,2013.0,3,10,-7
MX,SG,2014.0,7,4,3
JP,CU,2018.0,1,2,-1
KR,SG,2012.0,27,41,-14
CN,EG,2003.0,1,8,-7
MW,US,2018.0,26,29,-3
FR,RE,2014.0,38,55,-17
CA,VE,2012.0,4,4,0
AR,NL,2010.0,6,5,1
CG,FR,2020.0,13,14,-1
CA,SE,2006.0,29,38,-9
QA,PK,2020.0,18,21,-3
nan,ZA,2007.0,9,7,2
MX,NI,2005.0,3,1,2
NL,MY,2019.0,11,16,-5
CU,US,2000.0,21,18,3
HK,CA,2020.0,3,3,0
FI,EG,2013.0,4,1,3
EG,SE,2016.0,8,10,-2
BR,CH,2000.0,6,9,-3
BR,CZ,2008.0,7,1,6
NO,PT,2017.0,3,10,-7
GB,HK,2012.0,9,7,2
MX,NL,2007.0,2,5,-3
PE,AR,2008.0,8,12,-4
US,RS,2021.0,41,38,3
KR,IT,2005.0,2,3,-1
LU,DE,2011.0,11,36,-25
BR,CL,2023.0,4,1,3
SE,EE,2011.0,12,4,8
US,MG,2015.0,3,3,0
DE,HU,2003.0,32,44,-12
ZA,JP,2000.0,3,6,-3
FR,SG,2005.0,7,4,3
CA,GE,2012.0,3,1,2
BN,GB,2002.0,1,1,0
HK,AU,2007.0,2,2,0
TN,GB,2015.0,12,4,8
AZ,KG,2020.0,1,2,-1
GB,LK,2012.0,23,15,8
HR,HU,2018.0,4,4,0
CZ,CA,2006.0,18,15,3
CH,PK,2022.0,19,12,7
TN,QA,2013.0,5,2,3
OM,US,2022.0,9,10,-1
FR,QA,2012.0,14,3,11
DK,GW,2012.0,1,4,-3
PT,ZA,2017.0,8,4,4
PH,PL,1999.0,17,1,16
CL,CN,2009.0,3,1,2
RS,US,2022.0,22,30,-8
US,CM,2022.0,5,1,4
MA,PS,2020.0,1,1,0
RW,US,2018.0,9,18,-9
DE,MY,2011.0,15,10,5
BA,SI,2022.0,6,3,3
nan,GR,2013.0,5,2,3
ET,TR,2019.0,2,3,-1
DK,JP,1997.0,9,6,3
IT,NO,2011.0,25,18,7
LK,GR,2009.0,3,7,-4
OM,BH,2020.0,2,2,0
HR,AU,2008.0,6,2,4
BG,SK,2009.0,1,1,0
CO,GT,2018.0,12,6,6
SG,NZ,2011.0,13,11,2
TR,NP,2018.0,3,1,2
AT,BR,2012.0,10,13,-3
TH,KH,2008.0,1,1,0
BY,FI,2008.0,1,3,-2
CL,BO,2008.0,7,5,2
IT,ID,2012.0,4,1,3
IL,KZ,2016.0,2,2,0
IR,DK,2007.0,2,1,1
RU,AM,2004.0,8,2,6
IT,DZ,2010.0,14,13,1
nan,CZ,1997.0,2,1,1
BR,CO,1999.0,11,8,3
NO,BG,2021.0,1,5,-4
CO,ID,2020.0,5,3,2
BO,AR,2014.0,5,3,2
UA,DK,2017.0,3,3,0
BG,ES,2000.0,5,2,3
VE,MX,2004.0,20,24,-4
SA,IT,2016.0,13,19,-6
nan,BE,2014.0,25,22,3
TR,KR,2017.0,8,3,5
ZA,ES,2007.0,5,1,4
CN,QA,2023.0,5,2,3
OM,CA,2002.0,2,2,0
SK,UA,2016.0,5,7,-2
IR,HU,2018.0,5,3,2
EC,RU,2020.0,3,1,2
LU,NL,2021.0,8,7,1
AE,RU,2021.0,3,1,2
FR,TD,2005.0,2,1,1
PL,MZ,2016.0,10,15,-5
AE,JO,2023.0,2,3,-1
US,AZ,2011.0,2,1,1
BZ,FR,2008.0,10,8,2
SI,SE,2015.0,8,2,6
IR,IT,2007.0,8,1,7
AM,JP,2004.0,5,8,-3
GR,JP,2009.0,44,36,8
CZ,BG,2010.0,3,2,1
PH,JP,1998.0,8,4,4
SK,JP,2018.0,7,3,4
SE,TR,1999.0,5,3,2
LU,GB,2011.0,3,12,-9
NO,VN,2014.0,5,3,2
ET,CN,2009.0,3,1,2
CO,HN,2013.0,6,3,3
AT,NO,2017.0,17,11,6
BG,DE,1999.0,20,9,11
MX,RU,2001.0,6,15,-9
GB,ET,2016.0,14,8,6
BE,RS,2006.0,2,1,1
PK,NO,2016.0,4,6,-2
IN,MM,2020.0,3,1,2
NZ,FR,2000.0,6,4,2
HU,PL,1997.0,5,2,3
HU,AT,2000.0,13,8,5
CO,MX,2000.0,21,33,-12
AT,FR,2014.0,37,56,-19
TG,FR,2019.0,3,6,-3
CZ,PT,2011.0,1,3,-2
EE,CH,2017.0,7,21,-14
JP,NP,2017.0,14,5,9
TR,IT,2011.0,14,11,3
SA,CO,2017.0,1,3,-2
LU,NO,2020.0,2,4,-2
GR,AT,2002.0,2,1,1
FI,CZ,2004.0,4,5,-1
CM,CA,2006.0,3,1,2
ZA,SG,2020.0,3,1,2
US,XK,2005.0,3,1,2
ID,FI,2013.0,3,3,0
FR,VG,2000.0,2,1,1
nan,HR,2009.0,3,4,-1
BE,IL,2006.0,4,9,-5
EE,DE,2017.0,46,71,-25
AM,DE,1997.0,1,1,0
MA,CA,2011.0,12,17,-5
nan,PL,2013.0,8,9,-1
CH,EE,2014.0,13,10,3
TZ,ZA,2022.0,8,4,4
MY,OM,2012.0,3,3,0
NL,KR,2011.0,7,8,-1
MA,PT,2015.0,8,6,2
JP,MX,2006.0,9,4,5
BJ,NG,2008.0,2,4,-2
BG,JP,2012.0,3,2,1
BN,GB,2005.0,1,3,-2
HU,NL,2022.0,8,4,4
CH,PL,2015.0,40,30,10
ES,MA,2015.0,20,6,14
IL,CH,2013.0,21,15,6
AR,DK,2008.0,2,2,0
IL,AT,2011.0,5,5,0
CO,DK,2017.0,3,2,1
HK,NL,2022.0,7,17,-10
AT,FI,2018.0,13,18,-5
EC,CO,2010.0,6,8,-2
MX,CN,2014.0,8,10,-2
MX,HU,2018.0,3,3,0
AE,LB,2013.0,5,2,3
IT,UA,2001.0,12,2,10
IR,KZ,2022.0,5,2,3
CY,TR,2012.0,20,39,-19
BO,US,2020.0,10,8,2
IL,nan,2005.0,14,11,3
LY,AU,2009.0,1,1,0
HR,SI,2006.0,12,7,5
LU,ES,2013.0,1,8,-7
NZ,IE,2020.0,15,19,-4
CN,nan,2001.0,29,30,-1
NG,TN,2015.0,1,4,-3
RS,AT,2008.0,8,5,3
KR,PT,2007.0,1,1,0
PH,CO,2003.0,1,1,0
CA,CO,2007.0,6,11,-5
NG,UG,2007.0,1,1,0
PL,EG,1999.0,1,1,0
PE,ID,2020.0,7,3,4
GB,IS,1999.0,3,1,2
SE,HU,2008.0,15,11,4
SE,AU,2005.0,33,25,8
JO,AE,2015.0,14,6,8
GF,FR,2012.0,4,17,-13
BR,BE,2023.0,6,2,4
CZ,MX,2018.0,4,5,-1
IE,JP,2008.0,15,32,-17
LK,CA,2010.0,4,1,3
TW,AE,2015.0,3,1,2
BR,JP,1998.0,18,14,4
CH,TN,2015.0,10,8,2
NO,PT,2019.0,10,4,6
CU,IT,2011.0,4,2,2
CH,SG,2011.0,17,9,8
IQ,PK,2017.0,14,17,-3
BF,PK,2017.0,1,1,0
BE,TR,2002.0,2,4,-2
AU,AT,1999.0,6,7,-1
BD,HU,2014.0,2,1,1
TH,BE,2016.0,6,7,-1
GB,BW,2014.0,5,3,2
NO,CH,2011.0,13,11,2
SE,MX,2015.0,11,9,2
OM,EG,2019.0,10,14,-4
MY,AE,2016.0,26,9,17
CO,DK,2019.0,4,4,0
nan,DZ,2015.0,10,8,2
SE,LV,2018.0,6,3,3
IL,NO,2008.0,4,1,3
MN,US,2016.0,4,4,0
IS,NO,2021.0,10,7,3
NL,ES,1997.0,18,16,2
SY,CN,2004.0,5,7,-2
KE,TW,2000.0,1,1,0
BW,ZW,2019.0,6,3,3
OM,EG,2017.0,19,9,10
FI,RS,2016.0,1,1,0
AE,SE,2021.0,6,5,1
DE,CR,2013.0,7,5,2
CH,MY,2022.0,2,1,1
EC,BO,2021.0,4,1,3
CN,MA,2005.0,2,1,1
US,NE,2013.0,4,1,3
NI,GB,2016.0,3,2,1
CZ,BA,2014.0,2,1,1
NL,SK,2018.0,4,1,3
SA,CN,2011.0,1,19,-18
QA,KW,2013.0,2,1,1
YE,PK,2017.0,3,1,2
SK,FI,2004.0,3,6,-3
TR,KR,2019.0,11,10,1
QA,MY,2014.0,3,7,-4
RW,BE,2020.0,2,5,-3
HR,RO,2019.0,3,1,2
GB,BG,2021.0,9,8,1
CN,IL,1997.0,3,3,0
HU,SI,2022.0,1,1,0
BD,IN,1998.0,5,5,0
AT,NO,2010.0,10,9,1
DE,BG,2003.0,17,18,-1
MW,GB,2014.0,15,13,2
MD,RU,2020.0,9,6,3
MK,AU,2011.0,32,50,-18
UG,NG,2015.0,3,3,0
DZ,US,2005.0,5,5,0
JP,FI,1999.0,7,8,-1
HN,BR,2016.0,4,6,-2
ES,FI,2013.0,22,21,1
TH,NZ,2009.0,4,5,-1
GB,TT,2000.0,3,1,2
RU,LV,2011.0,14,16,-2
CA,MA,2015.0,21,13,8
US,KG,2019.0,8,4,4
AR,NL,2019.0,8,12,-4
CN,FI,2005.0,11,22,-11
RU,PT,1997.0,4,2,2
AE,QA,2022.0,3,11,-8
GB,PA,2012.0,7,1,6
MY,EG,1999.0,2,2,0
MY,RU,2012.0,7,6,1
UY,CA,2017.0,4,5,-1
ZM,IN,2019.0,1,2,-1
LT,US,2011.0,6,18,-12
US,BB,2019.0,1,2,-1
NO,IN,1997.0,17,13,4
BH,KE,2018.0,2,1,1
SE,CZ,2007.0,7,8,-1
ID,QA,2019.0,3,5,-2
MX,IL,2012.0,4,3,1
KE,NL,2019.0,11,12,-1
US,PE,2023.0,2,2,0
VN,IN,2016.0,4,3,1
IN,CL,2007.0,3,1,2
CL,AT,2008.0,1,1,0
BG,SE,2001.0,3,3,0
GR,LU,2018.0,5,2,3
AR,JP,2018.0,4,4,0
GB,SK,2008.0,12,31,-19
GH,IN,2001.0,2,1,1
CR,CA,2018.0,4,7,-3
GH,GB,2007.0,6,6,0
SA,SE,1999.0,1,1,0
DE,KZ,2016.0,6,1,5
MY,PT,2017.0,2,1,1
LK,CA,2019.0,6,12,-6
PS,SA,2018.0,6,4,2
AT,BE,2005.0,8,8,0
MT,GB,1999.0,3,3,0
BG,EG,2012.0,2,2,0
MZ,BE,2008.0,2,5,-3
IT,HK,2015.0,1,1,0
EG,TN,2009.0,6,6,0
AT,KR,2009.0,3,4,-1
DE,BF,2013.0,1,1,0
AR,PT,2015.0,13,16,-3
IN,PH,2001.0,3,6,-3
TT,CA,2007.0,2,1,1
MY,LK,2013.0,4,3,1
PK,ES,2009.0,2,2,0
IN,ZA,2002.0,5,11,-6
TR,KH,2020.0,7,3,4
SE,AR,2003.0,5,5,0
AO,ES,2020.0,2,1,1
PE,GB,2021.0,12,13,-1
ZA,JM,2008.0,3,1,2
CU,PY,2015.0,5,1,4
UY,FR,2012.0,6,7,-1
VE,PE,2004.0,6,2,4
MY,HK,2019.0,1,3,-2
CU,FR,2016.0,7,7,0
RU,RS,2002.0,1,5,-4
CA,MY,2000.0,4,3,1
NZ,GE,2007.0,2,1,1
CO,CH,2006.0,2,2,0
PT,TR,2020.0,3,7,-4
PA,SE,2012.0,2,1,1
CH,MX,2016.0,15,13,2
US,BN,2020.0,5,3,2
LB,MY,2015.0,1,1,0
PE,CO,2005.0,24,11,13
BR,nan,1998.0,6,6,0
TN,IQ,2021.0,4,3,1
IN,HU,2006.0,3,4,-1
NP,GB,2012.0,6,6,0
DK,JP,1998.0,8,8,0
CA,CY,2021.0,1,4,-3
FR,BE,2023.0,5,5,0
CZ,BE,2013.0,7,15,-8
DE,KE,2009.0,6,1,5
JO,US,1998.0,8,17,-9
JM,TT,2019.0,21,10,11
UA,IL,2012.0,5,2,3
nan,PE,2022.0,4,4,0
UY,CA,2019.0,2,3,-1
BO,CA,2015.0,2,1,1
SA,JO,2001.0,3,4,-1
NL,HK,2003.0,7,3,4
HR,CH,2017.0,8,5,3
GB,MU,2016.0,5,2,3
RU,LT,2005.0,6,5,1
LB,DE,2021.0,7,2,5
GB,JM,2003.0,5,2,3
PT,ZA,2019.0,5,4,1
JP,LT,2001.0,2,4,-2
CW,DE,2016.0,1,2,-1
OM,EG,2010.0,9,5,4
US,CU,2003.0,16,14,2
TG,FR,2010.0,6,1,5
SA,PL,2016.0,2,3,-1
HR,CH,2019.0,8,10,-2
ID,TN,2020.0,3,3,0
TZ,RW,2021.0,1,1,0
YE,EG,2022.0,5,10,-5
KG,RU,2018.0,3,7,-4
US,BB,2017.0,3,3,0
ID,PK,2008.0,1,1,0
GR,nan,2019.0,4,7,-3
JP,MY,2003.0,13,7,6
HU,NG,2013.0,3,6,-3
NL,CW,2006.0,9,5,4
MM,KR,2018.0,3,3,0
BJ,BE,2016.0,1,3,-2
IL,nan,2002.0,9,13,-4
NZ,SG,2013.0,8,9,-1
SI,AU,2013.0,4,4,0
FR,NE,2010.0,5,3,2
LK,FR,2010.0,5,1,4
KR,AU,2023.0,5,4,1
MM,US,2019.0,4,22,-18
PT,JP,2022.0,3,3,0
DE,PE,2009.0,5,2,3
AF,MX,2006.0,5,2,3
UA,LT,2020.0,4,1,3
EC,nan,2021.0,7,4,3
GE,KR,2006.0,2,1,1
RS,GR,2008.0,1,3,-2
RU,AR,2019.0,3,3,0
LK,FR,2019.0,4,3,1
DK,CA,2002.0,19,16,3
LB,AU,2008.0,1,1,0
NI,SE,2006.0,1,2,-1
MY,NZ,2009.0,7,6,1
JP,IL,2005.0,12,18,-6
IT,SM,2013.0,3,1,2
TH,KR,2016.0,18,13,5
PH,QA,2018.0,1,1,0
UA,DK,2019.0,2,1,1
MX,RO,2019.0,1,2,-1
BE,CM,2012.0,7,5,2
RU,RO,2014.0,4,7,-3
US,BI,2006.0,2,2,0
TH,AT,2014.0,2,5,-3
IL,SK,2011.0,1,2,-1
CZ,BG,2019.0,3,2,1
SG,MX,2017.0,4,2,2
GB,VG,2005.0,3,3,0
BA,MX,2009.0,2,5,-3
GR,AL,2019.0,1,1,0
EG,KR,2009.0,9,4,5
HR,DE,1998.0,4,8,-4
RU,MZ,2012.0,13,22,-9
JP,VN,2003.0,11,8,3
KR,TR,2011.0,2,9,-7
IS,GB,2000.0,3,3,0
IT,ME,2022.0,1,1,0
TG,CM,2015.0,3,1,2
CH,TZ,2022.0,3,5,-2
BW,NG,2009.0,1,5,-4
FR,UY,2012.0,7,6,1
KR,SE,2014.0,11,5,6
MY,AR,2018.0,2,5,-3
BE,VN,2001.0,2,1,1
EG,AT,2021.0,3,2,1
BD,CA,2010.0,17,18,-1
US,SD,2012.0,7,2,5
CO,nan,2021.0,6,4,2
TW,NL,2001.0,1,3,-2
BR,ZA,2000.0,2,6,-4
KR,AM,2012.0,2,4,-2
PT,CO,2015.0,13,23,-10
CA,PT,2003.0,9,12,-3
RO,MD,2014.0,3,9,-6
BG,IT,2016.0,8,14,-6
MY,NL,2021.0,7,7,0
IE,PT,2019.0,6,12,-6
SE,SK,2013.0,2,5,-3
SG,PH,2007.0,2,2,0
EE,DK,2014.0,2,3,-1
CU,VE,2012.0,5,14,-9
DZ,BI,2015.0,1,1,0
PK,SK,2019.0,1,2,-1
NL,BY,2003.0,1,3,-2
NL,SD,2001.0,2,1,1
CY,JP,2001.0,2,2,0
JP,LB,2019.0,2,1,1
GE,IN,2015.0,6,1,5
MZ,BR,2008.0,3,2,1
FR,GF,2002.0,9,4,5
AT,MY,2009.0,1,1,0
IE,SE,2009.0,6,13,-7
SA,SG,2012.0,2,4,-2
MX,IE,2009.0,4,3,1
MX,CZ,2004.0,2,1,1
SN,ML,2011.0,1,2,-1
BD,FR,2013.0,8,6,2
VG,US,2005.0,8,10,-2
IQ,PL,2019.0,1,6,-5
JP,PT,2014.0,4,2,2
PL,BE,2022.0,13,17,-4
EG,QA,2001.0,4,1,3
NL,CZ,2022.0,2,9,-7
IT,VN,2015.0,2,2,0
RO,RU,2021.0,4,4,0
PK,JP,2009.0,5,12,-7
JP,NP,2010.0,6,4,2
BE,UA,2018.0,5,5,0
RO,PL,2007.0,2,5,-3
NL,GA,2016.0,5,3,2
QA,IR,2019.0,8,9,-1
ID,UZ,2017.0,1,4,-3
JO,GB,2008.0,4,18,-14
GB,SD,2018.0,7,12,-5
KH,BE,2010.0,2,1,1
BH,EG,2021.0,11,3,8
PE,nan,2003.0,2,4,-2
IQ,IN,2014.0,4,7,-3
BE,SN,2020.0,3,1,2
LK,CA,2017.0,4,7,-3
CM,DE,2006.0,1,2,-1
EG,ES,2011.0,4,6,-2
GB,EE,2000.0,1,2,-1
GB,ML,2006.0,1,1,0
LU,AT,2022.0,3,2,1
NG,KR,2008.0,5,3,2
DK,HR,2019.0,1,2,-1
HU,IL,2000.0,1,2,-1
TW,DK,2020.0,2,2,0
AM,DE,1998.0,4,1,3
GE,NZ,2007.0,1,2,-1
SG,NO,2016.0,2,2,0
ST,PT,2009.0,2,1,1
NL,IL,1999.0,6,8,-2
OM,CA,2005.0,2,4,-2
NL,MW,2012.0,2,1,1
CR,DE,2017.0,7,8,-1
BO,VE,2006.0,1,1,0
US,LU,2007.0,9,12,-3
UY,PE,2011.0,2,3,-1
OM,TH,2009.0,1,1,0
GR,LK,2011.0,2,4,-2
TH,NL,2000.0,2,1,1
FR,ML,2008.0,2,5,-3
GB,SL,2012.0,1,1,0
KZ,IR,2019.0,5,2,3
RU,KG,2014.0,2,1,1
ID,FR,2016.0,16,33,-17
LY,US,2021.0,3,5,-2
CM,NG,2021.0,6,2,4
IL,ES,2012.0,7,10,-3
KH,FR,2007.0,4,4,0
FR,UA,2022.0,5,8,-3
DO,CL,2020.0,3,2,1
SG,CZ,2022.0,1,1,0
IR,CH,2006.0,5,2,3
ZA,MU,2014.0,1,2,-1
LK,AU,2005.0,5,3,2
JO,PS,2006.0,2,1,1
LK,SG,2008.0,1,1,0
US,BO,2001.0,4,4,0
NG,PK,2006.0,4,2,2
MA,LB,2016.0,1,2,-1
AT,DK,1999.0,4,1,3
AU,LK,2000.0,4,1,3
SE,BE,2007.0,15,14,1
PH,JP,1997.0,1,6,-5
KZ,AE,2021.0,1,1,0
UY,CA,2010.0,1,3,-2
QA,CA,2005.0,3,1,2
MM,US,2010.0,2,3,-1
CZ,FI,2008.0,3,4,-1
FI,AR,2012.0,1,2,-1
PT,RS,2020.0,3,1,2
JO,US,1997.0,4,10,-6
AR,CH,2007.0,8,5,3
AZ,RU,2001.0,3,4,-1
IN,HR,2015.0,1,1,0
JO,TN,2018.0,1,3,-2
AT,TW,2020.0,4,3,1
RS,BG,2016.0,4,2,2
ZM,AU,2021.0,1,2,-1
AR,ID,2014.0,3,6,-3
PY,CU,2000.0,3,2,1
DK,TR,2022.0,5,8,-3
VN,TH,2020.0,8,26,-18
PT,ZA,2010.0,1,4,-3
GN,CI,2022.0,2,3,-1
KR,EG,2005.0,1,1,0
PT,CZ,2007.0,3,3,0
RO,IR,2014.0,2,1,1
QA,JO,2022.0,8,11,-3
PL,NG,2021.0,2,4,-2
CH,AR,2022.0,4,14,-10
CU,CH,2011.0,3,3,0
CO,RO,2020.0,1,2,-1
CH,HU,2022.0,3,10,-7
SA,CO,2019.0,1,2,-1
US,KY,2020.0,2,1,1
RS,AU,2022.0,5,3,2
BG,UA,2013.0,5,8,-3
GR,MX,2021.0,1,1,0
IT,AL,2009.0,2,1,1
AU,NO,2003.0,1,10,-9
RU,PT,1998.0,1,1,0
AT,RO,2009.0,3,1,2
BY,PL,2016.0,6,2,4
SR,US,2017.0,1,1,0
ID,SE,2016.0,3,12,-9
DZ,GB,2016.0,3,10,-7
ZA,SY,2017.0,1,1,0
TN,BD,2020.0,2,4,-2
NO,GR,2013.0,3,7,-4
AE,AL,2018.0,1,1,0
LU,FI,2014.0,2,4,-2
US,SS,2006.0,1,1,0
ES,SV,2002.0,1,1,0
CW,BE,2005.0,2,1,1
BE,NZ,2021.0,5,3,2
EC,CL,2007.0,6,5,1
NC,FR,1999.0,4,8,-4
DE,MA,1998.0,3,2,1
BR,SN,2020.0,1,1,0
VE,DE,2003.0,3,6,-3
PL,AR,2017.0,1,5,-4
NL,SA,2023.0,1,2,-1
FR,SI,2010.0,11,6,5
DK,PL,2011.0,8,16,-8
nan,GH,2007.0,1,1,0
US,KG,2017.0,4,3,1
PS,MY,2016.0,1,7,-6
FI,IR,2006.0,3,2,1
EC,UY,2017.0,3,3,0
NL,UA,2020.0,3,5,-2
MX,UA,2020.0,2,1,1
BR,NZ,2007.0,3,6,-3
CN,KE,2005.0,2,2,0
AT,AU,2000.0,8,10,-2
SN,DE,2012.0,1,1,0
IT,KR,2004.0,3,2,1
ID,UZ,2010.0,1,2,-1
BH,AE,2011.0,2,2,0
EG,RU,2013.0,7,2,5
AT,IL,2008.0,7,3,4
DK,EE,2014.0,3,2,1
KE,NG,1999.0,2,1,1
ZA,GH,2011.0,2,2,0
XK,US,2009.0,2,1,1
FI,RO,1999.0,2,1,1
NC,US,2013.0,2,1,1
PT,AT,2003.0,3,2,1
CA,PS,2015.0,1,4,-3
PH,CL,2021.0,1,7,-6
CA,RE,2018.0,2,2,0
CA,BW,2020.0,2,1,1
US,BF,2012.0,2,2,0
PL,AU,2007.0,3,8,-5
KH,JP,2020.0,7,10,-3
GH,KE,1998.0,2,1,1
HK,PL,2022.0,1,1,0
DE,NG,2010.0,5,10,-5
ES,JO,2008.0,1,2,-1
CN,EC,2017.0,1,2,-1
NO,BE,2008.0,2,5,-3
PH,VN,2014.0,1,1,0
BY,IN,2013.0,2,6,-4
TN,DE,2010.0,2,4,-2
CD,IT,2018.0,1,2,-1
CL,IL,2008.0,1,1,0
GP,MA,2016.0,1,1,0
PE,CU,2003.0,2,1,1
OM,AU,2016.0,2,6,-4
UY,CU,2005.0,1,2,-1
CN,UZ,2003.0,2,1,1
UZ,FR,2009.0,3,1,2
IR,GB,1997.0,5,7,-2
RS,RU,2003.0,2,2,0
CR,DE,2010.0,3,1,2
BY,IT,2014.0,1,1,0
KH,BE,2017.0,3,2,1
SE,GR,2009.0,4,9,-5
BR,HN,2018.0,2,4,-2
BY,EC,2019.0,3,5,-2
GR,AL,2017.0,1,2,-1
TN,HU,2020.0,2,1,1
SL,JP,2019.0,1,1,0
UA,NL,2022.0,1,1,0
BF,PK,2010.0,1,1,0
ES,RS,2020.0,3,5,-2
NZ,TW,2022.0,2,2,0
DK,PH,2011.0,1,2,-1
QA,ET,2022.0,1,2,-1
EG,NL,2006.0,3,2,1
KE,CA,2022.0,3,6,-3
BG,AU,2017.0,3,1,2
IN,BJ,2021.0,2,2,0
ES,MZ,2017.0,2,3,-1
TR,CZ,2009.0,3,5,-2
MC,US,2008.0,2,1,1
CL,PY,2014.0,3,1,2
DE,LI,2018.0,6,2,4
TT,US,2003.0,6,2,4
ML,TG,2021.0,1,3,-2
NG,SA,2012.0,5,6,-1
CZ,BG,2017.0,1,3,-2
CH,SE,2023.0,2,3,-1
CL,nan,2020.0,2,9,-7
KR,IT,2002.0,2,4,-2
GT,GB,2020.0,3,1,2
ES,TH,2007.0,1,1,0
GB,KZ,2009.0,1,1,0
CH,SK,1998.0,1,2,-1
DE,TZ,2008.0,1,2,-1
MD,CH,2005.0,1,1,0
PK,KW,2021.0,1,8,-7
TH,PK,2012.0,2,1,1
MA,GB,2001.0,2,1,1
VE,FR,2022.0,1,2,-1
HN,CL,2018.0,3,4,-1
BD,IN,1997.0,4,1,3
GT,CO,2022.0,2,2,0
JM,IN,2009.0,2,1,1
ES,SV,2005.0,1,2,-1
IE,SG,2018.0,4,7,-3
ES,QA,2007.0,3,2,1
UZ,AZ,2018.0,1,1,0
UA,IN,2021.0,1,7,-6
QA,PS,2020.0,1,9,-8
LY,TN,2018.0,2,2,0
nan,AT,2022.0,3,1,2
PK,PH,2012.0,1,1,0
ES,AO,2006.0,2,4,-2
SM,IT,2012.0,1,2,-1
DE,CW,2004.0,1,2,-1
NZ,TH,2015.0,5,7,-2
HU,BA,2019.0,2,1,1
PS,DE,2021.0,1,2,-1
IE,CY,2021.0,2,2,0
NG,SE,2018.0,1,1,0
CA,LY,2013.0,2,2,0
NL,RS,2004.0,1,5,-4
BE,TR,2005.0,7,8,-1
NZ,PT,2014.0,3,4,-1
ZA,CL,2008.0,2,2,0
GE,CZ,2013.0,1,4,-3
TR,NO,2006.0,2,2,0
IL,BG,2007.0,1,1,0
ID,ZA,2012.0,4,1,3
nan,CZ,1998.0,1,5,-4
NA,US,2013.0,1,3,-2
NG,ID,2011.0,2,2,0
TR,AU,2003.0,6,2,4
NZ,MX,2019.0,3,5,-2
BG,AU,2010.0,1,2,-1
PH,CH,2001.0,2,1,1
JM,GB,2006.0,3,7,-4
PK,TR,2023.0,3,2,1
SY,NG,2022.0,1,1,0
SR,US,2019.0,1,1,0
PG,TN,2013.0,1,4,-3
ML,FR,2006.0,3,5,-2
IS,DE,2007.0,1,2,-1
SE,KE,2015.0,3,3,0
EE,AT,2000.0,1,3,-2
KE,IT,2005.0,1,1,0
CA,UA,2005.0,1,8,-7
KE,IN,2011.0,2,7,-5
GE,NL,2017.0,1,1,0
CO,JP,2021.0,8,14,-6
SV,MX,2021.0,2,2,0
PT,CU,2003.0,1,1,0
SA,OM,2005.0,3,2,1
CH,BF,2015.0,2,1,1
BG,FR,2001.0,5,8,-3
AE,NL,2016.0,4,7,-3
FR,PR,2000.0,1,1,0
MM,JP,2006.0,1,2,-1
PK,GR,2015.0,6,2,4
PL,IN,2006.0,1,7,-6
PE,CA,2001.0,1,2,-1
GN,CA,2020.0,2,1,1
PE,VN,2020.0,1,1,0
BE,DK,2011.0,20,13,7
DE,DK,2013.0,163,130,33
CL,US,2016.0,223,292,-69
FR,CA,1999.0,232,209,23
CL,ES,2023.0,14,6,8
NL,IT,2001.0,52,52,0
PK,MY,2014.0,54,76,-22
CA,VN,2018.0,14,14,0
US,NL,1999.0,298,315,-17
FR,GB,1997.0,155,143,12
CN,JP,2005.0,379,590,-211
TW,CN,2016.0,1479,842,637
CN,JP,2002.0,305,412,-107
BJ,FR,2007.0,18,25,-7
ZA,CA,2017.0,51,46,5
DE,ES,2001.0,79,72,7
DE,CL,2022.0,31,26,5
CN,MY,2010.0,49,26,23
ES,DE,2000.0,75,63,12
KR,ET,2012.0,100,115,-15
CA,TW,2011.0,41,38,3
AT,US,2011.0,219,233,-14
CH,JP,2021.0,80,59,21
IT,DK,2011.0,43,17,26
BE,CN,2012.0,34,169,-135
CA,BR,2003.0,133,108,25
IR,nan,2022.0,2,1,1
GB,BB,2012.0,6,3,3
CA,BE,2020.0,58,70,-12
nan,RU,2019.0,75,43,32
VG,US,2002.0,6,4,2
IE,FR,2012.0,36,36,0
CO,DE,2019.0,67,31,36
US,TH,2020.0,208,124,84
DK,FR,2007.0,26,44,-18
DE,NG,2019.0,22,17,5
ID,GB,2013.0,27,31,-4
MY,NG,2016.0,91,67,24
PL,GB,2006.0,39,36,3
NL,MY,2017.0,13,13,0
JP,CA,1998.0,78,83,-5
PL,FI,2021.0,9,10,-1
SA,GB,2019.0,117,236,-119
CZ,PL,2015.0,58,50,8
ES,RO,2015.0,21,9,12
ZM,NE,2017.0,1,1,0
RS,MK,2013.0,3,5,-2
BE,NL,1998.0,78,106,-28
NL,ES,1998.0,34,20,14
DE,VN,2015.0,16,11,5
nan,IT,2020.0,86,98,-12
NP,TH,2018.0,5,5,0
SA,US,2017.0,219,287,-68
ES,NL,2002.0,37,36,1
CO,DE,2017.0,33,40,-7
JP,BD,2011.0,84,51,33
SA,US,2010.0,52,122,-70
JP,TH,2011.0,90,55,35
CW,NL,2016.0,36,6,30
PT,GB,2004.0,46,43,3
US,AM,1997.0,4,12,-8
ID,AU,2011.0,17,41,-24
NL,AR,2000.0,3,2,1
CO,DE,2010.0,15,7,8
MA,BD,2019.0,22,24,-2
US,GT,2020.0,6,10,-4
IN,TW,2012.0,43,38,5
IT,EG,2020.0,20,9,11
ET,CA,2020.0,8,8,0
HU,BG,2007.0,1,1,0
MX,SI,2017.0,9,9,0
SN,ZA,2021.0,5,3,2
IL,CA,2007.0,47,37,10
MX,UY,2015.0,17,13,4
IR,KR,2022.0,17,8,9
CN,IL,1998.0,8,10,-2
NL,MY,2010.0,3,5,-2
MA,BD,2017.0,9,9,0
ZA,PT,2013.0,4,2,2
GB,KW,2015.0,19,9,10
ZM,GB,2019.0,9,6,3
DE,DZ,2005.0,1,3,-2
JO,CN,2009.0,2,3,-1
BB,GB,2007.0,2,1,1
EC,BR,2016.0,15,40,-25
FR,SI,2019.0,7,11,-4
LK,ID,2020.0,7,6,1
ES,NL,2005.0,35,53,-18
NL,SE,2011.0,58,46,12
LU,BE,2013.0,13,15,-2
CA,AE,2009.0,17,10,7
HU,BE,2012.0,10,7,3
SG,RS,2017.0,2,1,1
IL,KR,2021.0,7,4,3
SA,MY,2008.0,7,12,-5
VG,CN,2012.0,3,1,2
PL,CN,2020.0,17,25,-8
AR,IN,2015.0,3,3,0
MA,KW,2011.0,9,3,6
CH,LU,2018.0,6,7,-1
SK,IT,2001.0,1,5,-4
NO,OM,2014.0,3,1,2
LK,KR,2013.0,4,1,3
SE,NZ,2000.0,4,4,0
TR,KR,2010.0,4,5,-1
HU,MA,2012.0,7,8,-1
IT,RO,1997.0,3,5,-2
DK,GR,2014.0,6,17,-11
BE,CH,2006.0,47,24,23
NL,UG,2001.0,4,1,3
FR,GF,2005.0,6,5,1
CH,DO,2018.0,1,1,0
BF,FR,2003.0,8,7,1
GR,IT,2009.0,10,21,-11
NO,IE,2004.0,2,1,1
nan,IR,2022.0,1,2,-1
QA,IQ,2020.0,4,12,-8
NZ,IR,2022.0,5,10,-5
EG,PS,2011.0,4,6,-2
AT,HU,2000.0,8,13,-5
GB,CY,2020.0,56,24,32
JP,GH,1998.0,5,1,4
CR,DE,2019.0,3,5,-2
SN,FR,2009.0,29,25,4
NL,SR,2018.0,4,5,-1
UA,CH,2021.0,12,6,6
NO,UG,2014.0,3,3,0
RU,RS,2005.0,6,3,3
US,TG,2020.0,1,1,0
UZ,GB,2014.0,1,2,-1
VE,CU,2018.0,16,12,4
MA,PK,2000.0,3,2,1
FR,PH,2012.0,5,6,-1
LB,nan,2020.0,2,2,0
IT,AU,2023.0,2,6,-4
BE,HR,2018.0,4,6,-2
GB,MZ,2013.0,2,1,1
ID,KE,2012.0,5,2,3
RS,PL,2018.0,8,9,-1
PH,DE,2015.0,8,9,-1
TT,IN,2011.0,1,2,-1
BH,KW,2022.0,3,3,0
CO,SV,2012.0,1,1,0
CU,UY,2005.0,2,1,1
DE,GF,2019.0,1,1,0
CO,IR,2022.0,3,3,0
IQ,IL,2018.0,3,4,-1
FR,SG,2002.0,11,6,5
HU,AE,2015.0,3,2,1
IS,ES,2021.0,2,1,1
NO,PK,2009.0,1,2,-1
FJ,NZ,2000.0,1,1,0
GH,NL,2009.0,2,1,1
VU,CH,2010.0,1,1,0
EE,CH,2010.0,2,7,-5
ZA,CN,2004.0,7,6,1
AF,US,2020.0,3,2,1
US,SK,2022.0,12,10,2
BE,DZ,2009.0,2,1,1
NP,PH,2021.0,2,1,1
AR,NI,2015.0,1,1,0
PL,BD,2015.0,3,1,2
GB,PH,2003.0,6,13,-7
US,DZ,2001.0,1,1,0
CR,CN,2021.0,2,1,1
IT,IS,2022.0,2,1,1
FI,JP,1998.0,8,8,0
PK,SE,2002.0,1,1,0
BJ,SN,2016.0,1,1,0
BD,ES,2008.0,7,12,-5
IE,PH,2001.0,2,1,1
IN,YE,2014.0,3,1,2
EE,IT,2008.0,2,2,0
SV,CL,2018.0,5,3,2
PK,CN,1997.0,4,1,3
IN,SK,2021.0,2,1,1
NO,DK,2023.0,2,7,-5
BA,PK,2020.0,1,1,0
GR,UA,2000.0,1,1,0
EG,NG,2021.0,4,7,-3
MX,TW,2016.0,1,1,0
IT,BY,2003.0,2,2,0
NL,MZ,2000.0,1,1,0
AU,SA,1999.0,3,2,1
AO,IT,2016.0,4,1,3
GR,AT,2005.0,2,2,0
AT,RU,2001.0,4,11,-7
GR,nan,2010.0,2,3,-1
AU,HR,2008.0,2,6,-4
MY,PT,2010.0,3,1,2
MY,SA,2015.0,66,37,29
ZA,FR,2012.0,27,42,-15
TH,FR,2002.0,5,5,0
MY,JP,2018.0,46,80,-34
ZM,GB,2010.0,5,2,3
VN,PL,2023.0,2,2,0
IQ,LB,2016.0,6,8,-2
FR,TZ,2015.0,2,4,-2
OM,PS,2020.0,1,1,0
nan,RU,2017.0,66,28,38
LT,JP,2012.0,8,4,4
CA,,2012.0,5377,0,5377
CN,,2023.0,132521,0,132521
SE,,2024.0,24725,0,24725
,US,2009.0,73589,0,73589
,NL,2008.0,7174,0,7174
,CZ,2011.0,2621,0,2621
NL,,2009.0,2476,0,2476
CO,,2021.0,3895,0,3895
PK,,2020.0,1354,0,1354
PH,,2022.0,1291,0,1291
,TR,2000.0,4035,0,4035
AT,,2024.0,15620,0,15620
CH,,2011.0,2086,0,2086
IR,,2020.0,9478,0,9478
,IL,2004.0,2361,0,2361
KR,,2014.0,2854,0,2854
,TN,2009.0,1244,0,1244
,CU,2011.0,528,0,528
PE,,2016.0,550,0,550
CZ,,2021.0,3185,0,3185
,IL,1996.0,2732,0,2732
SG,,2023.0,6135,0,6135
,RO,2003.0,678,0,678
,PK,2014.0,2761,0,2761
,TW,2013.0,3591,0,3591
SK,,2008.0,163,0,163
,NO,2011.0,1845,0,1845
VN,,2020.0,305,0,305
,VU,2008.0,2,0,2
,SG,2003.0,1112,0,1112
,MA,2009.0,822,0,822
MA,,2014.0,315,0,315
,PH,2012.0,712,0,712
,ID,2004.0,1149,0,1149
,DK,2013.0,2487,0,2487
nan,,2024.0,3153,0,3153
TN,,2019.0,1368,0,1368
,CL,2013.0,1987,0,1987
,NG,2010.0,2354,0,2354
BR,,2007.0,1880,0,1880
NZ,,2001.0,216,0,216
,CR,2013.0,358,0,358
TN,,2017.0,784,0,784
TW,,1999.0,470,0,470
,ID,1996.0,332,0,332
UA,,2011.0,654,0,654
PL,,2007.0,1014,0,1014
SY,,2017.0,100,0,100
,MZ,2012.0,68,0,68
,CW,2000.0,13,0,13
RS,,2011.0,249,0,249
BS,,2017.0,5,0,5
GE,,2016.0,124,0,124
,SK,2018.0,612,0,612
,NG,2019.0,1685,0,1685
TH,,2008.0,311,0,311
,BT,2012.0,6,0,6
GW,,2024.0,15,0,15
ZA,,2001.0,305,0,305
,NG,2017.0,3498,0,3498
MC,IT,2005.0,4,0,4
,PS,2011.0,101,0,101
MD,,2000.0,26,0,26
MX,,1999.0,183,0,183
TN,,2010.0,248,0,248
,MN,2011.0,46,0,46
BD,,2004.0,33,0,33
ES,NG,2004.0,1,0,1
NG,,2007.0,339,0,339
SV,,2023.0,77,0,77
,KE,2000.0,216,0,216
PK,CD,2018.0,1,0,1
AE,,2000.0,18,0,18
,SD,2017.0,146,0,146
VG,BE,2009.0,1,0,1
,SY,2009.0,110,0,110
TR,LV,2014.0,1,0,1
CL,,1999.0,88,0,88
MK,,2020.0,186,0,186
,ZM,2015.0,173,0,173
,OM,2002.0,64,0,64
PF,,2024.0,47,0,47
SY,,2019.0,70,0,70
DO,,2024.0,102,0,102
SI,MY,2013.0,3,0,3
CN,MA,2002.0,1,0,1
,LV,2016.0,288,0,288
RO,,2006.0,125,0,125
ZA,CG,2021.0,2,0,2
AM,,2016.0,111,0,111
,OM,2005.0,112,0,112
DO,PE,2013.0,1,0,1
,BA,2001.0,83,0,83
GY,,2023.0,17,0,17
RO,BD,2020.0,2,0,2
MD,FI,2009.0,2,0,2
KG,,2021.0,61,0,61
IR,LU,2018.0,2,0,2
DE,YE,2012.0,1,0,1
,SD,2010.0,120,0,120
PG,,2022.0,39,0,39
,BN,2016.0,37,0,37
SK,HK,2016.0,1,0,1
US,AO,2011.0,3,0,3
,UG,2018.0,435,0,435
PK,NG,2023.0,1,0,1
BI,CN,2014.0,1,0,1
EG,SG,2023.0,3,0,3
,AO,2001.0,10,0,10
,AL,2003.0,15,0,15
MA,BW,2009.0,1,0,1
BR,KH,2022.0,1,0,1
,SD,2019.0,100,0,100
AG,,2001.0,1,0,1
SN,,2009.0,23,0,23
DE,MA,1997.0,2,0,2
PH,EG,2009.0,2,0,2
BH,,2005.0,6,0,6
JO,PL,2022.0,1,0,1
,GH,1998.0,118,0,118
,GH,1997.0,117,0,117
DE,JM,2009.0,2,0,2
GP,,2019.0,22,0,22
MA,MN,2020.0,1,0,1
NL,KW,2019.0,1,0,1
AR,SA,2022.0,2,0,2
,ME,2001.0,27,0,27
BR,MD,2021.0,1,0,1
GR,MT,2020.0,3,0,3
,BO,1997.0,28,0,28
HN,CU,2001.0,1,0,1
TZ,IL,1999.0,1,0,1
BG,NL,2002.0,6,0,6
,IQ,2020.0,56,0,56
BD,MX,2012.0,2,0,2
BF,,2004.0,4,0,4
ZA,SD,2011.0,2,0,2
BW,TZ,2011.0,1,0,1
AT,AL,2019.0,1,0,1
KE,CN,1999.0,2,0,2
MY,KZ,2021.0,3,0,3
EG,BF,2021.0,1,0,1
RO,SK,2018.0,8,0,8
DE,PS,2001.0,1,0,1
,NC,2012.0,16,0,16
FR,YE,2001.0,1,0,1
BW,UG,2019.0,2,0,2
TG,,2013.0,6,0,6
BH,,2002.0,8,0,8
UY,AU,2003.0,2,0,2
GP,,2017.0,36,0,36
,ER,2004.0,6,0,6
IL,GE,2007.0,1,0,1
NZ,KZ,2013.0,1,0,1
BG,SG,2017.0,1,0,1
VG,PT,2017.0,1,0,1
MX,PA,1998.0,4,0,4
FR,CF,2016.0,3,0,3
VG,,2001.0,4,0,4
MA,GR,2011.0,1,0,1
MA,JO,2015.0,1,0,1
IL,SI,2010.0,1,0,1
BN,KR,2005.0,1,0,1
,GM,2006.0,12,0,12
TH,SA,2010.0,2,0,2
,BO,1998.0,20,0,20
JO,,2000.0,27,0,27
VU,CH,2017.0,1,0,1
TN,TZ,2019.0,1,0,1
NZ,RO,2016.0,1,0,1
IE,EE,2019.0,1,0,1
SY,,2010.0,29,0,29
IE,VN,2017.0,6,0,6
AR,UA,2012.0,3,0,3
SL,,2000.0,1,0,1
CW,,2003.0,6,0,6
TT,,1999.0,4,0,4
RU,AR,2017.0,4,0,4
EC,AO,2019.0,1,0,1
NZ,PL,2007.0,4,0,4
NI,,2014.0,14,0,14
SI,BR,2021.0,1,0,1
RO,NZ,2015.0,1,0,1
DE,SL,1998.0,1,0,1
UG,TZ,2012.0,1,0,1
JP,QA,1999.0,1,0,1
KE,EG,2015.0,3,0,3
NP,,2011.0,36,0,36
RS,SG,2018.0,2,0,2
AT,ET,2007.0,1,0,1
TR,KZ,2000.0,5,0,5
GA,CH,2019.0,1,0,1
UG,LR,2017.0,2,0,2
MW,,2009.0,13,0,13
KR,BN,2017.0,1,0,1
GP,,2010.0,6,0,6
BN,nan,2022.0,1,0,1
MR,,2012.0,1,0,1
GN,,2011.0,4,0,4
SM,,2023.0,6,0,6
ZM,TH,2012.0,1,0,1
MG,,2009.0,7,0,7
ZA,IL,2014.0,2,0,2
GR,CL,2014.0,2,0,2
IN,UY,2008.0,2,0,2
SG,RS,2010.0,1,0,1
GB,GY,2016.0,1,0,1
CA,CR,2000.0,3,0,3
NO,EG,2016.0,2,0,2
TR,PG,2012.0,1,0,1
BN,ES,2014.0,1,0,1
RU,LU,2008.0,2,0,2
CU,DO,2011.0,2,0,2
TZ,IQ,2022.0,1,0,1
HK,UY,2011.0,1,0,1
ML,IN,1999.0,5,0,5
ES,PY,1997.0,1,0,1
CO,PA,2006.0,1,0,1
LV,NO,2011.0,1,0,1
UG,LY,2017.0,1,0,1
SA,BA,2019.0,1,0,1
RO,SE,2004.0,3,0,3
LV,CZ,2003.0,2,0,2
PK,PS,2003.0,1,0,1
PH,nan,2002.0,1,0,1
BG,MY,2020.0,1,0,1
MZ,,2003.0,5,0,5
PK,IE,2009.0,4,0,4
MR,CM,2017.0,1,0,1
PY,BE,2017.0,2,0,2
HU,EE,2004.0,1,0,1
LK,RS,2019.0,2,0,2
SD,FR,2011.0,1,0,1
IE,PG,2001.0,1,0,1
ID,,1998.0,12,0,12
,SO,1994.0,2,0,2
SO,IT,2013.0,1,0,1
IT,SS,2018.0,1,0,1
PL,IS,2021.0,2,0,2
BF,FI,2018.0,1,0,1
BE,LY,2008.0,1,0,1
PL,CG,2014.0,1,0,1
QA,NG,2009.0,1,0,1
,BW,2020.0,3,0,3
BG,DK,2007.0,2,0,2
CO,NO,2018.0,3,0,3
MK,PT,2018.0,1,0,1
OM,CH,2014.0,1,0,1
IN,BB,2009.0,1,0,1
TN,MT,2022.0,1,0,1
JP,LA,2013.0,1,0,1
ID,MA,2016.0,1,0,1
BS,,2010.0,5,0,5
CL,JM,2008.0,1,0,1
IL,RO,1999.0,3,0,3
MX,AT,1999.0,3,0,3
PG,GB,2001.0,3,0,3
MK,ES,2009.0,1,0,1
JP,LB,2010.0,2,0,2
HR,SE,2015.0,4,0,4
CA,ZW,2018.0,1,0,1
,HT,1994.0,1,0,1
ET,NG,2007.0,2,0,2
HR,DK,2013.0,3,0,3
MA,RU,2008.0,2,0,2
,SZ,1999.0,3,0,3
NO,XK,2020.0,2,0,2
UY,CU,2002.0,1,0,1
ES,TN,2006.0,3,0,3
BW,JM,2002.0,1,0,1
MA,BD,2010.0,5,0,5
DK,FO,2014.0,2,0,2
GH,DE,2003.0,2,0,2
IE,KE,2021.0,1,0,1
AT,IE,2004.0,9,0,9
LR,IN,2020.0,2,0,2
TR,SY,2005.0,1,0,1
AU,UZ,2011.0,1,0,1
MX,PA,1997.0,1,0,1
BR,CG,2016.0,1,0,1
BF,MA,2017.0,2,0,2
NG,BH,2022.0,1,0,1
ZW,CG,2010.0,2,0,2
IL,PK,2021.0,1,0,1
CO,AM,2009.0,1,0,1
UG,LR,2019.0,1,0,1
JO,BH,2006.0,2,0,2
,ER,1996.0,4,0,4
JO,NZ,2009.0,1,0,1
SI,SK,2008.0,1,0,1
FR,IS,2002.0,2,0,2
MY,RS,2005.0,1,0,1
DE,TN,2006.0,5,0,5
US,GF,2012.0,1,0,1
ZA,LV,2015.0,1,0,1
FR,ZW,2021.0,1,0,1
CD,ZA,2014.0,1,0,1
BG,CY,1999.0,1,0,1
BA,TH,2010.0,1,0,1
MK,LV,2021.0,1,0,1
AU,LY,2019.0,4,0,4
CU,SE,2005.0,1,0,1
IE,VN,2010.0,2,0,2
BE,CI,2011.0,1,0,1
GR,BD,2011.0,1,0,1
BY,ES,2021.0,1,0,1
IL,ET,2007.0,2,0,2
KR,ZA,2003.0,3,0,3
SD,QA,2014.0,2,0,2
MZ,KG,2021.0,1,0,1
LK,CY,2007.0,1,0,1
BS,,2019.0,6,0,6
IE,GH,2007.0,1,0,1
PL,BH,2006.0,1,0,1
NZ,KG,2018.0,1,0,1
CH,BH,2015.0,2,0,2
NZ,RW,2018.0,1,0,1
EG,JO,2023.0,1,0,1
MW,NO,2012.0,1,0,1
GA,MG,2009.0,1,0,1
PF,ES,2013.0,1,0,1
JP,MK,2017.0,2,0,2
FR,KZ,2008.0,2,0,2
IS,SG,2012.0,2,0,2
PH,nan,2005.0,1,0,1
BN,FJ,2016.0,1,0,1
IR,AF,2014.0,1,0,1
US,BB,2010.0,3,0,3
UY,HN,2022.0,1,0,1
TW,CA,2023.0,1,0,1
JP,PY,2007.0,1,0,1
PW,US,2001.0,1,0,1
GB,NA,2002.0,1,0,1
SD,PE,2007.0,1,0,1
IN,PA,2012.0,4,0,4
NZ,KE,2008.0,1,0,1
SA,SK,2020.0,1,0,1
ME,RU,2008.0,1,0,1
ZW,TH,2022.0,2,0,2
BI,GA,2020.0,1,0,1
UA,HK,2017.0,1,0,1
RO,CY,2018.0,1,0,1
MD,CH,2002.0,3,0,3
LY,,1998.0,2,0,2
PK,IQ,2006.0,1,0,1
PH,MU,2012.0,1,0,1
NG,DZ,2018.0,2,0,2
LU,RU,2016.0,1,0,1
NG,ET,2005.0,1,0,1
NO,SI,2003.0,1,0,1
CA,GA,2007.0,1,0,1
AU,GH,2009.0,3,0,3
JO,CZ,2013.0,1,0,1
ST,,2014.0,4,0,4
PS,AE,2004.0,1,0,1
KW,RS,2009.0,1,0,1
IR,GH,2020.0,1,0,1
UY,PL,2013.0,1,0,1
AL,,2002.0,3,0,3
SG,ID,2003.0,1,0,1
ZM,RW,2021.0,3,0,3
EC,CN,2004.0,1,0,1
MW,CH,2013.0,1,0,1
TR,CU,2017.0,1,0,1
QA,IE,2009.0,1,0,1
NI,EC,1998.0,1,0,1
LB,BH,1997.0,1,0,1
CU,nan,2008.0,1,0,1
UY,CN,2011.0,1,0,1
ZA,GE,2002.0,1,0,1
RS,UA,2000.0,1,0,1
JO,KW,2003.0,2,0,2
ES,LU,2023.0,1,0,1
CU,NZ,2019.0,1,0,1
PK,NL,1999.0,1,0,1
LB,NL,2022.0,2,0,2
NL,HR,2003.0,2,0,2
GW,DE,2011.0,1,0,1
TN,SE,2011.0,2,0,2
NG,MW,2021.0,1,0,1
BI,nan,2017.0,1,0,1
CO,IE,2021.0,2,0,2
SY,PK,2011.0,1,0,1
AM,ID,2012.0,2,0,2
ME,,2011.0,4,0,4
VN,HU,2009.0,1,0,1
HR,RO,2017.0,6,0,6
MX,XK,2018.0,1,0,1
KW,SE,2005.0,1,0,1
CM,ES,2018.0,3,0,3
DK,BY,2004.0,1,0,1
TT,IQ,2021.0,1,0,1
NZ,PK,2024.0,1,0,1
FR,OM,2007.0,1,0,1
EC,AT,2018.0,3,0,3
MA,SY,2010.0,2,0,2
EE,IN,1998.0,1,0,1
GB,VG,2002.0,2,0,2
JM,NZ,1998.0,1,0,1
PK,TZ,2010.0,1,0,1
IN,MU,2020.0,1,0,1
CL,KN,2018.0,1,0,1
PH,TH,2001.0,1,0,1
BY,JP,2012.0,1,0,1
JO,HU,2016.0,1,0,1
CG,MW,2018.0,1,0,1
LI,DE,2021.0,5,0,5
GA,AT,2017.0,1,0,1
RS,BR,2003.0,2,0,2
IS,FI,2007.0,2,0,2
EC,PL,2014.0,1,0,1
AL,XK,2008.0,1,0,1
GM,JP,2000.0,1,0,1
GB,EC,2007.0,2,0,2
KY,,2008.0,1,0,1
NO,MY,2008.0,2,0,2
ET,AU,2001.0,1,0,1
FJ,MY,2018.0,2,0,2
NL,LA,2012.0,1,0,1
FI,LT,2013.0,3,0,3
MY,HK,2017.0,1,0,1
MX,RO,2017.0,2,0,2
BE,PS,2009.0,1,0,1
IE,EE,2017.0,1,0,1
LA,NZ,2012.0,1,0,1
ER,,2008.0,2,0,2
JO,PH,2014.0,1,0,1
VN,CH,2007.0,1,0,1
KR,LV,2001.0,1,0,1
AL,GB,2004.0,1,0,1
MK,NZ,2017.0,1,0,1
LK,TH,2008.0,3,0,3
PE,CL,2023.0,3,0,3
SE,MZ,2015.0,5,0,5
NG,FI,2004.0,1,0,1
PL,AR,2019.0,2,0,2
MK,KZ,2017.0,1,0,1
UG,ET,2016.0,2,0,2
BW,ZW,2017.0,2,0,2
PS,AR,2020.0,1,0,1
IT,MQ,2012.0,1,0,1
NI,PY,2017.0,3,0,3
BR,CV,2013.0,1,0,1
ZA,LY,2021.0,1,0,1
CZ,AE,2021.0,1,0,1
BB,DE,2010.0,1,0,1
SE,IE,2023.0,1,0,1
DE,GD,2014.0,1,0,1
NO,BW,2015.0,1,0,1
PH,CU,2003.0,1,0,1
CR,IE,2019.0,2,0,2
TN,PG,2009.0,1,0,1
DE,DZ,2002.0,2,0,2
BY,EC,2010.0,1,0,1
ML,MX,2006.0,2,0,2
JO,IN,1998.0,1,0,1
CU,MD,2016.0,1,0,1
nan,JM,1998.0,1,0,1
DE,BN,2015.0,2,0,2
,PF,2007.0,10,0,10
ET,SY,2015.0,1,0,1
IR,AL,2010.0,1,0,1
FJ,nan,2018.0,1,0,1
HR,RU,2003.0,1,0,1
UG,DE,2003.0,1,0,1
SK,DO,2019.0,1,0,1
CG,LU,2019.0,1,0,1
BI,NO,2007.0,1,0,1
LU,GN,2018.0,2,0,2
SI,TR,2012.0,3,0,3
MK,PL,2007.0,2,0,2
AL,NL,2004.0,1,0,1
DE,OM,2001.0,2,0,2
BJ,GH,2020.0,1,0,1
IT,NZ,2000.0,2,0,2
FI,MW,2018.0,2,0,2
MW,NZ,2005.0,1,0,1
GR,VE,2011.0,1,0,1
ZM,SG,2017.0,1,0,1
BH,nan,2020.0,2,0,2
FJ,BG,2017.0,1,0,1
AM,PE,2013.0,1,0,1
VN,CF,2005.0,1,0,1
GR,AL,2010.0,1,0,1
MD,BR,2006.0,1,0,1
FI,PG,2016.0,1,0,1
SY,BH,2011.0,1,0,1
GB,IM,2009.0,2,0,2
OM,TR,2012.0,1,0,1
DK,MZ,2002.0,1,0,1
HU,KW,2008.0,1,0,1
TG,CG,2015.0,1,0,1
LU,EE,2018.0,1,0,1
NL,GM,2019.0,1,0,1
CR,SE,2000.0,1,0,1
RO,EE,2018.0,1,0,1
BA,IT,2009.0,1,0,1
AT,IR,2000.0,1,0,1
MT,IT,2006.0,1,0,1
MX,PL,2006.0,2,0,2
NI,GT,2020.0,1,0,1
SA,LB,2000.0,2,0,2
PK,AM,2023.0,1,0,1
NO,AT,2001.0,2,0,2
KR,BG,2000.0,1,0,1
ES,MT,2022.0,2,0,2
US,GA,1998.0,1,0,1
BY,MD,2005.0,1,0,1
BE,IQ,2013.0,1,0,1
RS,AG,2022.0,1,0,1
NG,RW,2022.0,1,0,1
DK,SK,2003.0,1,0,1
PE,PL,2003.0,1,0,1
MY,IL,2004.0,1,0,1
DK,GM,2019.0,1,0,1
UZ,KR,2001.0,2,0,2
MM,AU,2004.0,1,0,1
BR,DK,1997.0,1,0,1
LK,BN,2009.0,1,0,1
SE,BH,2020.0,1,0,1
DE,MZ,2016.0,1,0,1
ME,GB,2018.0,2,0,2
CD,GB,2008.0,1,0,1
LK,ET,2021.0,1,0,1
LV,AT,2021.0,1,0,1
KR,EG,2002.0,2,0,2
BT,CA,2008.0,1,0,1
SV,NL,2002.0,1,0,1
LS,US,2013.0,1,0,1
RS,CO,2020.0,1,0,1
BO,CU,2014.0,1,0,1
PS,NG,2003.0,1,0,1
KR,MY,2005.0,4,2,2
IL,NG,2022.0,2,2,0
KE,NL,2010.0,3,6,-3
NG,SD,2000.0,1,1,0
ZM,US,2003.0,2,1,1
NO,HU,2021.0,3,4,-1
SJ,NO,2006.0,3,4,-1
VE,PY,2008.0,1,2,-1
MY,SD,2022.0,2,6,-4
NZ,GR,2021.0,1,1,0
FI,KR,2022.0,7,6,1
CH,MA,2003.0,1,2,-1
BR,JO,2011.0,1,1,0
MY,ZA,2009.0,1,1,0
PH,SE,2019.0,1,2,-1
PL,MK,2019.0,1,2,-1
KE,BJ,2004.0,1,2,-1
QA,OM,2009.0,2,2,0
PL,ZA,2009.0,1,4,-3
IQ,BH,2021.0,4,6,-2
UG,NZ,2008.0,4,2,2
QA,IR,2010.0,2,1,1
UY,ID,2020.0,1,1,0
JP,ID,2023.0,2,2,0
LV,BE,2012.0,1,1,0
DK,LU,2020.0,2,1,1
TR,BH,2021.0,1,1,0
IR,GR,2015.0,2,2,0
BA,PL,2012.0,2,9,-7
FI,NL,2023.0,1,2,-1
BE,VE,2014.0,1,1,0
ES,LT,2016.0,2,1,1
AT,BE,2002.0,3,6,-3
ES,UG,2009.0,1,1,0
NL,ZM,2022.0,1,1,0
LK,AU,2002.0,2,1,1
IN,SI,2011.0,2,2,0
GB,RS,2001.0,4,6,-2
GH,BH,2007.0,1,1,0
IL,CY,2015.0,1,1,0
MK,CN,2013.0,1,5,-4
PL,AR,2010.0,2,1,1
VN,MX,2003.0,4,2,2
KG,AU,2014.0,1,1,0
EE,NO,2011.0,1,1,0
NG,RO,2015.0,1,1,0
CN,LU,2011.0,1,3,-2
IT,GR,2023.0,3,1,2
CZ,HU,2001.0,2,4,-2
BR,MZ,2007.0,2,1,1
GB,FJ,2020.0,3,1,2
EG,MY,2023.0,1,1,0
MD,IT,2003.0,2,2,0
MW,FR,2017.0,1,2,-1
CZ,BD,2018.0,1,1,0
IE,VN,2019.0,2,1,1
CY,CA,2003.0,1,1,0
BG,AU,2019.0,1,1,0
TW,PL,2004.0,3,3,0
MX,FR,2023.0,1,2,-1
CN,GR,1999.0,1,5,-4
CA,JM,2012.0,2,4,-2
CH,SK,1997.0,4,3,1
BE,SA,1997.0,1,1,0
TH,TW,2004.0,1,1,0
BD,FI,2021.0,3,2,1
PH,SE,2017.0,2,3,-1
BH,ZM,2011.0,1,1,0
PG,US,2007.0,1,4,-3
KR,BD,1997.0,1,1,0
CM,CI,2012.0,2,1,1
LK,DE,2020.0,2,3,-1
PT,VE,2012.0,3,8,-5
IR,DZ,2017.0,1,1,0
AR,BO,2008.0,1,3,-2
IL,EG,2020.0,2,6,-4
UA,KR,2004.0,2,2,0
ZA,BG,2014.0,1,2,-1
IQ,PK,2010.0,1,3,-2
SK,HR,2009.0,1,1,0
DO,CU,2019.0,1,3,-2
KZ,CZ,2018.0,3,2,1
CO,SE,2008.0,1,6,-5
KH,AU,2018.0,2,3,-1
ID,CA,2000.0,1,3,-2
EC,VE,2013.0,4,6,-2
CA,PE,2006.0,2,2,0
PK,ID,2008.0,1,1,0
MA,SY,2017.0,1,1,0
VN,RS,2019.0,1,2,-1
SA,OM,2002.0,2,1,1
CU,HN,2014.0,1,1,0
JO,EG,2006.0,1,2,-1
LK,FR,2017.0,2,1,1
ET,SA,2015.0,2,1,1
EC,DK,2017.0,2,2,0
AE,NZ,2009.0,3,3,0
CO,EC,1999.0,1,1,0
IS,FR,2018.0,3,4,-1
GH,NO,2014.0,1,2,-1
SG,DK,2015.0,2,2,0
BO,DE,2018.0,1,1,0
MZ,ZA,2015.0,1,2,-1
PT,IN,2004.0,1,7,-6
PK,MX,2019.0,2,2,0
IS,NL,2021.0,1,6,-5
HU,PS,2022.0,1,1,0
AG,TR,2016.0,1,31,-30
BG,PT,2015.0,1,2,-1
AE,OM,2011.0,1,5,-4
IR,DZ,2019.0,5,3,2
CR,GB,2009.0,1,3,-2
NZ,IN,1999.0,2,5,-3
BY,GB,2012.0,1,2,-1
MX,ID,2015.0,3,1,2
CM,MA,2022.0,1,1,0
TZ,EG,2013.0,1,1,0
BR,BO,2003.0,1,1,0
NP,nan,2012.0,1,1,0
BS,US,2016.0,2,8,-6
ZA,NA,2010.0,4,3,1
PE,VE,2004.0,2,6,-4
SG,MX,2019.0,1,3,-2
MY,PT,2019.0,1,2,-1
HR,NL,2004.0,1,1,0
SK,PT,2011.0,1,1,0
RO,CL,2008.0,1,1,0
NL,KW,2017.0,1,2,-1
IS,RU,2015.0,1,1,0
GB,BY,2006.0,2,3,-1
VE,nan,2000.0,1,1,0
ZM,MW,2012.0,1,1,0
OM,AE,2007.0,2,2,0
US,AM,1998.0,1,5,-4
US,GD,2007.0,2,4,-2
KR,MY,2002.0,1,2,-1
ZW,AT,2010.0,1,1,0
SS,US,2018.0,2,2,0
GD,IN,2018.0,1,1,0
IE,BH,2021.0,1,1,0
CZ,AM,2013.0,1,2,-1
KE,IT,2002.0,1,1,0
IT,TR,2023.0,2,2,0
KE,PE,2021.0,1,1,0
BR,ZW,2019.0,1,1,0
GR,TR,2015.0,1,4,-3
JP,RS,2018.0,1,3,-2
FR,GR,2023.0,1,2,-1
BJ,BR,2020.0,2,3,-1
nan,EE,2013.0,1,2,-1
VG,ES,2019.0,1,1,0
TW,GE,2020.0,1,1,0
GP,US,2014.0,1,3,-2
UA,GR,2000.0,1,1,0
ME,GR,2021.0,1,3,-2
CO,DK,2010.0,1,1,0
NI,MX,2012.0,1,1,0
DZ,US,2002.0,1,3,-2
DZ,MA,2006.0,1,2,-1
BE,SA,1998.0,1,1,0
LU,PT,2015.0,1,3,-2
QA,SE,2013.0,2,3,-1
FR,UZ,2018.0,1,2,-1
NP,NL,2003.0,1,1,0
CW,BE,2002.0,1,3,-2
CO,IN,2007.0,1,2,-1
PK,RU,2007.0,1,3,-2
PL,TH,2018.0,2,1,1
EC,DK,2019.0,1,1,0
IL,CR,2008.0,1,3,-2
EC,HR,2020.0,1,1,0
CL,HU,2012.0,1,2,-1
CN,BG,2000.0,1,2,-1
DE,LK,2022.0,1,2,-1
CH,MD,2022.0,1,6,-5
CA,GY,2012.0,1,1,0
ZW,NL,2020.0,2,1,1
GB,BJ,2018.0,1,3,-2
nan,BW,2012.0,1,1,0
AR,RO,2016.0,1,1,0
AU,KG,2014.0,1,1,0
NG,TZ,2004.0,1,1,0
AE,MA,2022.0,1,6,-5
CH,UY,2020.0,1,2,-1
GB,RW,2021.0,1,4,-3
GB,AZ,2018.0,1,2,-1
IT,PA,2021.0,1,1,0
ZW,CN,2016.0,1,1,0
AU,TT,2012.0,1,1,0
IL,BR,2000.0,3,2,1
GR,nan,2017.0,4,5,-1
QA,IR,2017.0,1,2,-1
AM,IT,2003.0,3,13,-10
IN,RU,2011.0,5,13,-8
SG,ZA,2005.0,3,1,2
FR,RS,2004.0,2,2,0
QA,DK,2008.0,1,1,0
SD,TR,2022.0,1,1,0
BA,RS,2006.0,3,5,-2
DE,CM,2000.0,1,2,-1
GB,GE,2007.0,2,5,-3
MA,SY,2019.0,2,1,1
RU,VE,2003.0,1,1,0
RU,MK,2018.0,1,6,-5
CO,NI,2008.0,1,1,0
BR,PY,2000.0,1,1,0
RU,NI,2022.0,1,1,0
IT,IQ,2020.0,1,1,0
IL,PH,2015.0,3,2,1
PH,OM,2017.0,1,1,0
NC,AU,2003.0,1,1,0
IN,TR,1998.0,1,1,0
SI,TW,2013.0,1,3,-2
EE,BY,2020.0,1,2,-1
PL,AM,2021.0,1,0,1
AL,,2005.0,5,0,5
NL,TH,2023.0,1,0,1
ML,ZM,2019.0,2,0,2
HT,,2013.0,3,0,3
GR,IL,1999.0,1,0,1
MA,ID,2005.0,1,0,1
PE,SS,2006.0,1,0,1
ZA,DZ,2022.0,1,0,1
PR,BR,2018.0,1,0,1
KW,SE,2002.0,1,0,1
SE,XK,2015.0,2,0,2
NL,PG,2014.0,1,0,1
SE,CY,2013.0,1,0,1
NL,BO,2020.0,1,0,1
GB,LS,2015.0,1,0,1
KW,ES,2009.0,1,0,1
MM,BN,2014.0,1,0,1
BB,GD,2017.0,1,0,1
DE,IS,2006.0,2,0,2
GP,ES,2019.0,1,0,1
nan,UY,2003.0,1,0,1
AT,MX,2011.0,3,0,3
HU,ZA,2004.0,1,0,1
BF,CI,2008.0,1,0,1
MZ,IN,2010.0,1,0,1
IT,LI,2012.0,2,0,2
BE,MU,2005.0,1,0,1
HR,XK,2005.0,1,0,1
PK,BE,2009.0,2,0,2
IE,BD,2012.0,2,0,2
VE,NL,2013.0,1,0,1
JM,ZA,2021.0,1,0,1
GI,GB,2016.0,1,0,1
ET,PK,2018.0,2,0,2
CW,ES,2012.0,1,0,1
SG,CY,2013.0,1,0,1
ZM,SG,2019.0,1,0,1
PK,MK,2008.0,1,0,1
DK,VN,2008.0,1,0,1
GF,BJ,2013.0,1,0,1
UA,TR,2006.0,1,0,1
FR,IS,2005.0,1,0,1
KZ,JP,2006.0,5,0,5
FJ,PK,2021.0,2,0,2
RW,SE,2011.0,1,0,1
AU,LY,2017.0,1,0,1
RU,BA,2004.0,1,0,1
CW,JP,2020.0,5,0,5
AE,AR,2021.0,2,0,2
MU,CH,1999.0,1,0,1
MX,HR,2011.0,1,0,1
AZ,ID,2006.0,1,0,1
UA,CO,1999.0,1,0,1
IT,AE,2003.0,1,0,1
SC,,2018.0,2,0,2
FJ,DE,2008.0,1,0,1
RU,ZW,2008.0,1,0,1
SD,UG,2021.0,1,0,1
MD,LT,2016.0,2,0,2
FI,LY,2018.0,1,0,1
MA,NE,2007.0,1,0,1
BD,BH,1997.0,1,0,1
FR,TJ,2022.0,1,0,1
TR,AM,2006.0,1,0,1
TN,SG,2014.0,1,0,1
DZ,LB,2014.0,2,0,2
JO,IR,2008.0,1,0,1
MX,NZ,2022.0,1,0,1
BB,DE,2019.0,1,0,1
AR,NO,2016.0,2,0,2
ML,CA,2008.0,2,0,2
YE,PK,2010.0,1,0,1
BE,ST,2022.0,1,0,1
SE,KH,2019.0,2,0,2
GE,UA,2013.0,1,0,1
MA,MG,2004.0,1,0,1
IE,JO,2009.0,1,0,1
PH,HK,2020.0,1,0,1
ES,MC,2017.0,1,0,1
GE,JO,2015.0,1,0,1
LY,DZ,2012.0,1,0,1
JO,DZ,2013.0,2,0,2
MT,BR,2007.0,2,0,2
BF,MA,2010.0,1,0,1
AZ,PK,2018.0,1,0,1
MX,TN,2006.0,1,0,1
TH,MW,2016.0,1,0,1
UA,ID,2016.0,1,0,1
FI,SG,2011.0,2,0,2
ML,AR,2018.0,1,0,1
PL,KG,2006.0,1,0,1
KZ,AT,2011.0,1,0,1
SS,CA,2019.0,1,0,1
MY,GM,2021.0,1,0,1
GH,CM,2013.0,1,0,1
IE,QA,2015.0,1,0,1
PH,SA,2004.0,1,0,1
BJ,ZA,2011.0,1,0,1
ZM,CM,2012.0,2,0,2
LB,SK,2022.0,1,0,1
EC,PA,2011.0,1,0,1
CH,DZ,2011.0,2,0,2
HU,SA,2011.0,1,0,1
CD,,2007.0,2,0,2
BE,MW,2007.0,1,0,1
BR,VN,2015.0,1,0,1
BI,RW,2016.0,1,0,1
DZ,SG,2009.0,1,0,1
MA,EG,2004.0,1,0,1
ZM,TZ,2013.0,1,0,1
ES,IR,2004.0,2,0,2
GR,NP,2017.0,1,0,1
NL,SI,2006.0,4,0,4
CW,SE,2015.0,1,0,1
IQ,KW,2008.0,1,0,1
MW,FR,2010.0,1,0,1
EE,IL,2013.0,1,0,1
CL,TW,2022.0,1,0,1
ME,AU,2001.0,2,0,2
JP,LB,2017.0,1,0,1
ML,SD,2017.0,1,0,1
BW,UG,2010.0,1,0,1
ET,UZ,2012.0,1,0,1
KE,AR,2022.0,1,0,1
IN,BA,2019.0,1,0,1
FI,PR,2005.0,1,0,1
DK,MK,2006.0,1,0,1
SE,MT,2022.0,1,0,1
GT,CU,2012.0,1,0,1
IT,MN,2012.0,1,0,1
IN,BA,2017.0,1,0,1
SA,CH,2007.0,1,0,1
IT,UY,1999.0,1,0,1
CZ,AR,2004.0,1,0,1
NP,GE,2018.0,1,0,1
CG,RU,2005.0,1,0,1
LK,TW,2003.0,1,0,1
UG,CO,2013.0,1,0,1
DK,IR,1998.0,1,0,1
MX,BD,2006.0,2,0,2
CA,CD,2015.0,1,0,1
GF,MQ,2022.0,1,0,1
KH,NL,2005.0,1,0,1
BD,SI,2015.0,1,0,1
BF,CG,2009.0,1,0,1
CY,BD,2004.0,1,0,1
UA,AM,2021.0,1,0,1
AR,FI,2011.0,1,0,1
RW,LV,2008.0,1,0,1
HU,TH,2007.0,1,0,1
MX,KZ,2012.0,1,0,1
IL,SI,2017.0,1,0,1
QA,CR,2021.0,1,0,1
PK,TZ,2019.0,1,0,1
PK,ZW,2004.0,2,0,2
RU,UG,1998.0,1,0,1
CW,NO,2007.0,1,0,1
SD,MR,2017.0,1,0,1
AT,KZ,2016.0,1,0,1
IN,CY,2008.0,1,0,1
CL,UA,2013.0,1,0,1
IE,MX,1999.0,1,0,1
GA,UG,1999.0,1,0,1
IN,RO,2000.0,1,0,1
HT,MD,2015.0,1,0,1
MY,TN,2006.0,1,0,1
GF,NC,2006.0,1,0,1
TH,CW,2018.0,1,0,1
ZW,ID,2020.0,1,0,1
GE,IT,2002.0,1,0,1
YE,NO,2013.0,1,0,1
LU,ZA,1998.0,1,0,1
LV,IL,2011.0,1,0,1
CL,TN,2018.0,1,0,1
HN,NL,2019.0,1,0,1
LV,ID,2016.0,1,0,1
CH,MW,2018.0,1,0,1
GE,UG,2017.0,1,0,1
KH,PF,2022.0,1,0,1
DO,FR,2013.0,1,0,1
BE,BI,2021.0,1,0,1
HU,BA,2017.0,1,0,1
,MW,2020.0,1,0,1
IT,BI,2004.0,1,0,1
ID,CM,2001.0,1,0,1
NI,PT,2003.0,1,0,1
ES,LB,2006.0,1,0,1
SA,PT,2008.0,1,0,1
ML,nan,2013.0,1,0,1
CI,AU,2016.0,1,0,1
LK,KW,2022.0,1,0,1
IN,CO,2006.0,2,0,2
SD,ET,2011.0,1,0,1
TN,EE,2019.0,1,0,1
IR,KW,2001.0,1,0,1
JP,GH,1997.0,1,0,1
UA,ZA,2005.0,1,0,1
UY,HU,2017.0,1,0,1
SE,IS,2023.0,1,0,1
KG,AZ,2021.0,1,0,1
NZ,WS,2014.0,1,0,1
nan,AE,2007.0,1,0,1
HU,SG,1998.0,1,0,1
TZ,BB,2011.0,1,0,1
GE,NL,2010.0,1,0,1
BJ,RU,2019.0,1,0,1
DE,MM,2005.0,1,0,1
GE,TT,2021.0,1,0,1
IT,KZ,2021.0,1,0,1
TN,KW,2020.0,1,0,1
PR,PE,2019.0,1,0,1
GB,DZ,2023.0,2,0,2
GR,NP,2019.0,1,0,1
CA,BS,2018.0,1,0,1
MN,ID,2019.0,1,0,1
PT,SN,2005.0,1,0,1
IQ,CM,2014.0,1,0,1
CU,IN,2013.0,1,0,1
SD,IE,2009.0,1,0,1
AT,AE,2021.0,1,0,1
IT,NE,2008.0,1,0,1
FR,LT,2023.0,1,0,1
ZW,PG,2022.0,1,0,1
PA,IL,2016.0,1,0,1
PH,JO,2010.0,1,0,1
MD,IE,2009.0,1,0,1
TR,RO,2009.0,1,0,1
BD,AT,2005.0,1,0,1
SA,ER,2019.0,1,0,1
CR,SV,2018.0,1,0,1
EG,UZ,2020.0,1,0,1
IS,QA,2011.0,1,0,1
nan,SC,2020.0,1,0,1
MX,BG,2021.0,1,0,1
CN,ES,2005.0,23,34,-11
KR,US,1999.0,334,485,-151
FR,BR,2016.0,243,211,32
SG,US,2014.0,394,414,-20
US,CN,2015.0,5701,5101,600
JP,KR,2014.0,424,340,84
SE,NO,1999.0,41,26,15
US,AU,2004.0,1434,1368,66
VE,ES,2007.0,84,63,21
SE,DE,2015.0,224,254,-30
AU,JP,2018.0,82,74,8
DE,IT,2009.0,183,218,-35
US,JP,2018.0,1833,1615,218
US,CA,1998.0,1333,1662,-329
BR,US,1998.0,209,272,-63
US,CA,1997.0,1143,1267,-124
BE,JP,2008.0,18,22,-4
ES,VE,2011.0,71,89,-18
JP,CN,2003.0,467,353,114
TW,MY,2007.0,6,6,0
GB,nan,2005.0,72,62,10
PK,US,2001.0,51,44,7
US,KR,2007.0,1103,920,183
DE,CN,2013.0,271,274,-3
DE,NL,1998.0,123,120,3
KR,TW,2017.0,47,53,-6
GB,ES,2010.0,289,276,13
CL,CO,2012.0,187,151,36
DE,US,1999.0,1548,1401,147
UY,CO,2012.0,8,5,3
CO,US,2018.0,397,393,4
CA,IN,2007.0,94,244,-150
AR,ES,2007.0,241,205,36
JP,AU,2002.0,54,49,5
GB,IT,1997.0,103,116,-13
ES,CA,2018.0,93,107,-14
DE,DK,2008.0,109,78,31
FI,AT,2013.0,13,7,6
EC,MX,2009.0,10,8,2
ES,CN,2008.0,32,43,-11
LA,UZ,2015.0,2,2,0
AR,JP,2017.0,4,6,-2
FR,DE,2017.0,594,546,48
AU,TH,2016.0,34,29,5
NZ,AU,2006.0,143,110,33
GB,ZA,2016.0,153,166,-13
GB,SE,2004.0,96,116,-20
PH,US,2014.0,459,384,75
IN,JP,2009.0,128,104,24
IT,US,2011.0,1062,930,132
TR,US,2012.0,405,424,-19
FR,DE,2010.0,494,494,0
US,GE,2019.0,164,169,-5
VE,MX,2014.0,46,40,6
RU,GB,2010.0,84,73,11
SE,SK,2008.0,6,3,3
AU,NZ,2014.0,156,245,-89
JP,MY,2001.0,12,3,9
US,TW,1997.0,322,236,86
ES,GB,2007.0,217,225,-8
NL,SG,2013.0,13,16,-3
CR,CO,2017.0,61,47,14
CN,GB,2013.0,494,561,-67
DE,BE,2021.0,115,112,3
TR,RS,2008.0,67,63,4
RS,TR,2009.0,95,65,30
ES,PT,2022.0,110,112,-2
US,IT,2014.0,955,1138,-183
AE,EG,2009.0,11,10,1
BD,PK,2011.0,25,26,-1
MX,FR,2000.0,24,24,0
nan,CN,2016.0,103,102,1
SE,CN,2017.0,144,120,24
ID,JP,2002.0,19,25,-6
SE,RU,2003.0,28,41,-13
nan,US,2000.0,96,109,-13
CN,FR,2009.0,201,283,-82
ES,BE,2021.0,93,84,9
JP,BE,2008.0,22,18,4
GB,DK,2003.0,76,74,2
CL,ES,2000.0,54,80,-26
IQ,PK,2018.0,7,27,-20
JM,TT,2018.0,30,12,18
BD,ES,2013.0,13,27,-14
US,GE,2017.0,154,204,-50
DK,GB,2002.0,66,51,15
US,CL,2004.0,93,75,18
SA,US,2018.0,241,364,-123
GB,PK,2009.0,65,77,-12
JO,GB,2013.0,9,31,-22
MY,AU,2008.0,32,40,-8
IN,AU,2011.0,125,103,22
CO,CR,2010.0,15,17,-2
ES,CH,2018.0,148,90,58
GR,DK,2020.0,15,5,10
ES,FR,2020.0,275,317,-42
RU,GB,2017.0,81,140,-59
FR,PE,2012.0,6,3,3
NL,nan,2013.0,81,73,8
GB,AT,2011.0,98,105,-7
NL,GB,2008.0,241,206,35
HU,US,2015.0,124,94,30
PK,CH,2002.0,12,4,8
CO,DE,2018.0,30,30,0
GB,RU,2009.0,66,82,-16
MA,FR,2018.0,193,326,-133
SE,IN,2017.0,49,68,-19
SE,IN,2019.0,54,72,-18
US,HU,2008.0,92,102,-10
CN,IN,2014.0,155,190,-35
TR,CY,2012.0,39,20,19
AE,IN,2011.0,14,31,-17
US,GB,2023.0,188,133,55
BE,PT,2004.0,8,3,5
HU,RO,2011.0,19,30,-11
SE,ZA,2005.0,10,8,2
AE,QA,2016.0,8,10,-2
ES,NO,2011.0,31,15,16
NZ,AE,2012.0,5,10,-5
MX,VE,2020.0,30,28,2
SE,CL,2017.0,5,16,-11
AU,IE,2015.0,101,111,-10
GB,RS,2003.0,11,9,2
RS,DE,2015.0,25,21,4
GB,BD,2007.0,43,28,15
CA,DE,2002.0,145,155,-10
RU,VG,2012.0,2,1,1
MX,BO,2005.0,4,4,0
VN,US,2015.0,77,88,-11
US,IQ,2019.0,108,48,60
AT,NO,2018.0,17,9,8
PL,IE,2007.0,7,2,5
IT,GB,2007.0,336,274,62
AR,US,2021.0,272,172,100
MY,IN,2015.0,132,150,-18
FR,IE,2008.0,34,18,16
US,PL,2023.0,11,8,3
GB,ES,2017.0,391,545,-154
DE,CL,2016.0,61,53,8
CR,CO,2019.0,47,71,-24
FR,CN,1999.0,72,45,27
CO,CL,2005.0,47,74,-27
GR,GB,2018.0,290,217,73
US,CZ,2020.0,172,147,25
nan,IN,2013.0,49,62,-13
GB,ID,2014.0,63,28,35
AT,CH,2008.0,81,78,3
CN,RU,2015.0,54,48,6
DE,ES,2003.0,103,108,-5
CA,MX,2014.0,50,42,8
LB,GB,2020.0,13,14,-1
CU,ES,2013.0,125,91,34
SY,CN,2014.0,19,28,-9
FI,CN,2009.0,21,17,4
PE,UY,2015.0,5,1,4
VE,BR,2017.0,30,15,15
SE,CN,2010.0,86,69,17
CZ,CN,2005.0,44,31,13
CN,TR,2010.0,48,10,38
CN,nan,2003.0,55,61,-6
RU,AM,2014.0,5,12,-7
FR,NO,2012.0,51,78,-27
AR,GB,1999.0,14,12,2
CO,ES,2022.0,227,212,15
IT,UA,2003.0,7,8,-1
US,TR,2006.0,359,284,75
CH,GR,2021.0,24,21,3
TW,CA,2000.0,14,25,-11
DK,LT,2012.0,3,2,1
NO,FR,2014.0,55,77,-22
GR,FR,2001.0,13,15,-2
FR,DE,2019.0,588,530,58
SA,EG,2013.0,215,297,-82
MN,JP,2021.0,4,6,-2
NO,JP,2021.0,7,8,-1
nan,BE,2004.0,19,19,0
PT,CL,2011.0,6,1,5
SE,CN,2019.0,146,117,29
MY,JP,2010.0,20,53,-33
BD,CA,2018.0,37,31,6
PT,US,1999.0,49,34,15
CH,NO,2021.0,31,17,14
MX,CA,2008.0,41,25,16
NG,AU,2015.0,11,4,7
ZA,CA,2018.0,56,54,2
DK,US,2004.0,189,178,11
DE,IE,2008.0,78,59,19
NZ,NP,2016.0,48,50,-2
MY,PH,2010.0,2,1,1
AU,KR,2002.0,8,7,1
RU,EE,1999.0,3,1,2
CO,VE,2015.0,40,77,-37
MY,IQ,2020.0,113,48,65
RO,GB,2008.0,14,22,-8
IE,JP,2013.0,35,15,20
CZ,GB,2007.0,39,17,22
CN,CH,2011.0,76,73,3
AG,TR,2022.0,176,245,-69
PL,FR,2006.0,47,44,3
RU,US,2012.0,377,398,-21
AR,FR,2020.0,82,86,-4
ZA,BR,2015.0,11,6,5
ZA,GB,2016.0,166,153,13
CA,BR,2001.0,86,85,1
HN,CL,2017.0,6,1,5
TN,FR,2018.0,201,233,-32
US,VN,2015.0,88,77,11
IT,CH,2022.0,196,152,44
ES,ID,2021.0,15,11,4
AU,DE,2022.0,144,116,28
AR,NO,2022.0,3,2,1
SK,JP,2010.0,22,24,-2
NL,JP,2010.0,37,30,7
GR,DE,2018.0,89,71,18
CN,SA,2014.0,26,18,8
BE,DE,2016.0,125,144,-19
CA,KR,2014.0,60,62,-2
AU,CH,2020.0,93,80,13
HU,NL,2016.0,14,24,-10
TR,AT,2020.0,12,5,7
GB,IT,1998.0,125,191,-66
SI,US,2016.0,30,21,9
SG,DE,2020.0,44,29,15
NL,JP,2017.0,29,33,-4
CA,IT,2007.0,72,66,6
TW,DE,2022.0,23,32,-9
PL,BE,2016.0,15,15,0
US,SK,2016.0,30,25,5
ID,nan,2011.0,6,8,-2
BG,US,2002.0,34,13,21
US,DK,1998.0,151,121,30
KE,NL,2018.0,15,12,3
CH,SE,2000.0,23,22,1
ZA,ID,2022.0,62,73,-11
NL,MY,2018.0,12,6,6
OM,EG,2018.0,15,10,5
FI,NL,2000.0,15,12,3
LB,NL,2016.0,1,3,-2
BR,NO,2022.0,17,7,10
JO,MY,2015.0,7,15,-8
MX,CH,2012.0,12,13,-1
IN,JO,2020.0,3,5,-2
IN,CM,2019.0,3,4,-1
FR,IN,2004.0,53,74,-21
MY,JP,2017.0,50,69,-19
nan,FR,2006.0,120,146,-26
PE,CL,2000.0,2,5,-3
US,BB,2018.0,6,1,5
CZ,UA,2007.0,15,5,10
KW,AU,2009.0,4,2,2
nan,RU,2018.0,55,42,13
ES,CY,2007.0,2,1,1
US,RO,2012.0,90,56,34
CH,MY,2016.0,5,8,-3
EG,CN,2012.0,33,11,22
CH,TZ,2016.0,4,5,-1
RU,MX,2000.0,10,1,9
AT,CN,2012.0,16,18,-2
ES,AT,2016.0,46,42,4
US,IQ,2017.0,65,37,28
IR,BE,2015.0,18,18,0
DE,HU,2001.0,26,30,-4
UA,CN,2016.0,21,23,-2
ID,BD,2015.0,17,8,9
IN,KR,2012.0,186,111,75
BR,IN,2011.0,20,24,-4
KG,RU,2017.0,4,7,-3
CO,CR,2019.0,71,47,24
CL,FR,2018.0,48,68,-20
PT,ZA,2018.0,7,4,3
RS,HR,2009.0,81,94,-13
NG,IQ,2020.0,8,3,5
SA,TN,2012.0,7,36,-29
FR,IT,2006.0,227,261,-34
MY,JP,2019.0,65,63,2
CR,CO,2010.0,17,15,2
CA,ID,2020.0,86,96,-10
AT,FR,2004.0,18,22,-4
MW,US,2017.0,18,14,4
MX,RS,2003.0,7,16,-9
NO,BE,2013.0,9,8,1
UY,BR,2012.0,34,38,-4
ID,FR,2022.0,19,7,12
PA,US,2015.0,54,70,-16
DK,GB,2005.0,97,78,19
PK,CA,2020.0,51,60,-9
LY,TN,2019.0,1,1,0
US,GR,2016.0,177,181,-4
VE,BR,2019.0,35,29,6
FR,ML,2013.0,10,7,3
IT,nan,2005.0,78,57,21
SE,RW,2020.0,5,2,3
CH,AR,2016.0,13,23,-10
CN,MY,2018.0,101,125,-24
ES,MT,2016.0,4,7,-3
GB,PS,2020.0,7,7,0
MY,PH,2017.0,5,2,3
GB,PL,2023.0,5,3,2
IR,ES,2021.0,22,9,13
BR,EC,2015.0,31,8,23
MX,IT,1997.0,6,3,3
US,CU,2001.0,9,14,-5
NO,NL,2013.0,25,46,-21
UA,NL,2016.0,5,1,4
TH,SA,2018.0,5,6,-1
AU,RU,2014.0,19,39,-20
KR,TW,2010.0,28,44,-16
TH,GB,2021.0,37,40,-3
BR,CU,2020.0,20,25,-5
NO,PH,2021.0,2,1,1
JO,IT,2009.0,3,1,2
FR,KR,2008.0,27,20,7
AU,BE,2008.0,19,21,-2
FI,SA,2020.0,3,5,-2
AU,NP,2012.0,5,5,0
RU,GB,2019.0,95,149,-54
IR,AU,2012.0,90,35,55
AU,IN,2005.0,39,58,-19
PK,CM,2022.0,2,1,1
IT,DZ,2018.0,40,51,-11
CL,BR,2014.0,89,82,7
TR,KG,2021.0,3,8,-5
CZ,DE,2009.0,45,53,-8
CA,TR,2021.0,26,40,-14
KE,GB,2020.0,48,41,7
SG,KR,2020.0,48,50,-2
SA,GB,2018.0,91,197,-106
US,ZW,2021.0,10,7,3
AR,PE,2006.0,7,5,2
HR,NL,2014.0,8,3,5
AE,US,2022.0,64,48,16
BB,AU,2020.0,2,2,0
BR,CR,2011.0,8,10,-2
KR,PH,2021.0,11,12,-1
MY,PH,2019.0,5,5,0
CN,KR,2013.0,255,285,-30
GB,MX,2021.0,58,38,20
CZ,CN,2002.0,13,12,1
US,SG,2020.0,500,477,23
JP,RS,2010.0,2,2,0
EC,CO,2018.0,91,196,-105
JP,AU,2005.0,54,52,2
DE,AU,2005.0,147,109,38
ID,CN,1999.0,3,1,2
IL,GB,2022.0,42,33,9
GR,US,2012.0,188,170,18
JP,NP,2018.0,20,12,8
BD,MY,2009.0,16,8,8
DE,CY,2011.0,1,1,0
VE,US,2005.0,56,42,14
FR,IR,2020.0,41,51,-10
SE,IN,2010.0,29,35,-6
LU,ES,2008.0,1,1,0
MY,SD,2016.0,13,10,3
TW,TH,2019.0,16,15,1
EC,DO,2019.0,3,1,2
DK,AU,2018.0,49,77,-28
SE,JP,2002.0,46,30,16
NO,IS,2021.0,7,10,-3
LK,CA,2018.0,5,9,-4
SE,FR,2009.0,50,74,-24
VE,US,2002.0,43,35,8
VE,CU,2010.0,13,8,5
CA,PT,2001.0,6,6,0
NL,PL,2012.0,22,18,4
IT,BE,2004.0,59,67,-8
JP,PT,2004.0,2,1,1
SI,HR,2006.0,7,12,-5
CZ,SE,2004.0,6,7,-1
FI,CH,2020.0,31,26,5
EE,FR,2003.0,2,1,1
TR,FR,2004.0,13,16,-3
BE,BR,2016.0,95,55,40
NG,JP,2011.0,5,7,-2
BG,UA,2008.0,5,10,-5
US,CY,2009.0,40,11,29
EE,DE,2018.0,33,74,-41
NO,GR,2008.0,6,4,2
MY,CN,2008.0,13,26,-13
CH,MA,2001.0,1,2,-1
AU,PL,2013.0,20,8,12
BO,CO,2011.0,7,4,3
FI,CZ,2014.0,7,7,0
AU,PH,2012.0,14,6,8
LB,EG,2009.0,7,6,1
GB,UA,2013.0,8,6,2
IL,PL,2012.0,6,2,4
BY,DE,2013.0,3,2,1
HU,SE,2018.0,21,12,9
MA,SA,2011.0,2,1,1
GR,RS,2016.0,5,1,4
BR,UY,2016.0,44,57,-13
ZW,CH,2006.0,2,1,1
KR,PK,2014.0,31,26,5
IR,EG,2013.0,5,11,-6
VE,BR,2010.0,22,14,8
CO,CZ,2015.0,3,2,1
PH,MX,2019.0,13,20,-7
AT,IN,2009.0,7,12,-5
BR,PE,2009.0,16,21,-5
FR,PL,2018.0,59,61,-2
EG,YE,2022.0,10,5,5
OM,US,2016.0,7,11,-4
US,PE,2000.0,27,14,13
ZA,CN,2014.0,12,12,0
BF,CI,2013.0,3,1,2
LB,CH,2021.0,5,1,4
KR,TW,2019.0,51,46,5
BE,TH,2015.0,5,2,3
RU,GE,2007.0,3,7,-4
PT,IN,2014.0,21,15,6
IR,AE,2019.0,11,7,4
PH,KR,2009.0,6,2,4
CI,ML,2017.0,7,7,0
ET,IT,2004.0,2,1,1
RU,FI,2012.0,35,22,13
PH,QA,2017.0,3,3,0
GB,AZ,2019.0,1,1,0
CN,TR,2019.0,17,28,-11
UZ,AZ,2017.0,1,1,0
EE,CH,2018.0,17,12,5
HK,NL,2016.0,23,18,5
US,UY,2020.0,32,34,-2
MM,US,2018.0,10,12,-2
BR,IE,2009.0,7,13,-6
MY,AE,2022.0,14,8,6
CA,nan,2018.0,27,60,-33
GB,nan,2002.0,53,35,18
TR,ES,2006.0,4,2,2
GB,TH,2003.0,48,13,35
RS,CZ,2015.0,17,13,4
ZA,RO,2017.0,5,6,-1
VE,CU,2019.0,18,25,-7
RU,AZ,2008.0,10,6,4
BO,FR,2008.0,5,1,4
ES,IR,2014.0,5,13,-8
MD,DE,2000.0,4,2,2
NL,JP,2019.0,43,37,6
GN,CI,2016.0,1,1,0
FR,CZ,2004.0,21,16,5
SG,MY,2009.0,63,34,29
BE,CZ,2012.0,9,11,-2
ZA,SN,2011.0,1,1,0
IT,LB,2011.0,10,5,5
NL,TW,2011.0,7,6,1
US,SI,2004.0,13,10,3
SA,PT,2013.0,3,3,0
FR,PK,2020.0,19,7,12
NO,PT,2018.0,3,10,-7
FI,LT,2008.0,2,1,1
RU,BG,2005.0,12,10,2
IN,AT,2021.0,13,12,1
NL,SR,2019.0,4,1,3
GB,TR,2022.0,69,67,2
NL,SK,2019.0,3,6,-3
QA,CN,2011.0,11,26,-15
TN,DE,2018.0,5,5,0
MX,HN,2020.0,19,24,-5
BE,SI,2012.0,2,6,-4
NG,MY,2021.0,66,80,-14
GB,AE,2016.0,42,34,8
SE,JP,2005.0,33,44,-11
PL,AT,2013.0,12,13,-1
ES,DE,2023.0,9,14,-5
nan,PT,2021.0,10,13,-3
FI,ID,2018.0,9,4,5
SK,RU,2021.0,13,18,-5
AT,FI,2017.0,12,10,2
CA,SG,2016.0,37,56,-19
GB,ET,2022.0,8,8,0
RS,SK,2013.0,5,8,-3
AR,NL,2018.0,7,5,2
AR,JP,2010.0,5,6,-1
VN,IN,2022.0,10,5,5
IR,HU,2019.0,9,2,7
EG,IL,2017.0,7,5,2
VN,ID,2021.0,3,1,2
CR,BR,2020.0,21,15,6
NZ,JP,2002.0,10,12,-2
AR,PK,2021.0,3,4,-1
KR,MM,2020.0,3,2,1
FR,NE,2018.0,30,28,2
CN,AZ,2009.0,1,1,0
CO,CR,2017.0,47,61,-14
KE,ID,2020.0,10,3,7
HN,BR,2022.0,2,2,0
DZ,GB,2022.0,7,5,2
MX,IT,1998.0,3,4,-1
TH,KR,2022.0,3,4,-1
BA,MK,2011.0,1,2,-1
PH,MX,2017.0,12,19,-7
PK,TN,2012.0,1,4,-3
FR,UA,2016.0,13,18,-5
PT,DE,2021.0,42,43,-1
US,SE,2023.0,18,11,7
CN,TR,2017.0,12,51,-39
FR,CG,2021.0,13,14,-1
KR,nan,2006.0,10,9,1
RU,SE,2021.0,26,32,-6
DE,LU,2011.0,36,11,25
TR,CN,2021.0,15,19,-4
PL,JP,2009.0,17,16,1
NP,TH,2019.0,3,4,-1
GB,KE,2005.0,14,13,1
GR,MK,2021.0,6,6,0
IE,ZA,1997.0,1,1,0
CZ,BY,2012.0,20,13,7
SA,MY,2013.0,23,57,-34
CH,TH,2007.0,2,1,1
DE,AU,2002.0,82,97,-15
JP,ID,2000.0,20,8,12
SA,KW,2011.0,17,8,9
JO,OM,2020.0,4,1,3
GB,BW,2004.0,2,2,0
TR,KR,2018.0,8,4,4
FI,BE,2020.0,10,13,-3
LB,SA,2015.0,10,7,3
NL,RS,2014.0,5,5,0
nan,DK,2015.0,24,18,6
AU,AE,2009.0,10,4,6
AT,LU,2020.0,4,2,2
RW,US,2010.0,8,6,2
DE,HR,2020.0,24,23,1
GR,ES,2018.0,16,22,-6
CM,GB,2020.0,10,4,6
IT,AR,2003.0,42,50,-8
AU,IN,2002.0,30,40,-10
IN,ES,2009.0,22,19,3
UA,FR,2020.0,13,12,1
ES,JO,2013.0,2,1,1
NL,CZ,2016.0,16,16,0
JP,UZ,2007.0,3,3,0
FR,NC,2005.0,7,10,-3
NG,SE,2019.0,4,2,2
MA,GB,2003.0,6,1,5
CO,NI,2013.0,4,3,1
TZ,GB,2016.0,17,17,0
CH,BR,2004.0,15,22,-7
CZ,IL,2016.0,6,9,-3
AM,JP,2014.0,2,4,-2
AE,MA,2016.0,3,3,0
SK,UA,2022.0,3,2,1
HU,CZ,2020.0,15,14,1
DK,SK,2001.0,2,2,0
TN,nan,2013.0,2,4,-2
IT,nan,2002.0,53,81,-28
TR,GB,2005.0,27,35,-8
ZM,GB,2018.0,8,6,2
ES,PA,2006.0,3,4,-1
CZ,FR,2012.0,32,21,11
KE,FR,2006.0,4,2,2
DE,EE,2004.0,17,16,1
nan,IL,2021.0,19,22,-3
BR,HU,2019.0,6,4,2
IL,RU,2022.0,23,29,-6
IE,CH,2000.0,4,3,1
ID,JP,2005.0,16,57,-41
CH,IN,2009.0,18,36,-18
ZA,CH,1997.0,5,6,-1
CH,DK,2007.0,24,20,4
US,LT,2011.0,18,6,12
IT,RU,1999.0,15,21,-6
DE,LI,2019.0,3,3,0
CA,GR,1998.0,6,1,5
CA,NL,2008.0,64,73,-9
AT,FI,2019.0,10,13,-3
CN,EG,2001.0,2,2,0
BD,KR,2006.0,4,3,1
NO,KR,2014.0,7,3,4
RU,TW,2000.0,7,6,1
CN,NZ,2007.0,19,18,1
CA,VN,2017.0,19,13,6
MX,RU,2003.0,6,10,-4
MT,ES,2012.0,10,2,8
HU,SI,2016.0,2,1,1
IR,RU,2012.0,6,6,0
TT,US,2001.0,1,7,-6
IN,BR,2020.0,36,31,5
AU,KR,2005.0,18,18,0
CM,MA,2016.0,3,1,2
GE,GB,2012.0,7,3,4
CU,AR,2002.0,7,3,4
CR,AR,2015.0,10,17,-7
IL,DE,1997.0,21,31,-10
CN,CL,2002.0,5,4,1
FR,TW,2006.0,18,12,6
CR,CA,2017.0,5,8,-3
GB,SK,2013.0,19,20,-1
CO,UY,2010.0,6,12,-6
LK,JP,2015.0,18,39,-21
EC,BR,2022.0,23,24,-1
IT,FI,2005.0,14,11,3
IT,MT,2011.0,5,1,4
LB,AU,2013.0,5,3,2
AE,AU,1999.0,2,2,0
GB,PH,2001.0,11,10,1
BG,TR,2015.0,4,1,3
IN,CY,2013.0,1,1,0
MX,AR,2000.0,25,16,9
TW,TH,2017.0,13,9,4
IE,SG,2019.0,7,6,1
US,CM,2016.0,14,8,6
nan,RO,2021.0,1,2,-1
BE,AT,2013.0,14,20,-6
IN,nan,1999.0,7,16,-9
NO,DK,2000.0,27,26,1
CO,DK,2018.0,4,3,1
RU,BR,2003.0,8,2,6
PK,nan,2022.0,9,2,7
CA,VN,2010.0,7,4,3
US,LV,2002.0,2,6,-4
PK,CH,2005.0,19,8,11
ZA,RO,2019.0,7,6,1
MY,nan,2009.0,9,21,-12
SA,PK,2009.0,14,17,-3
CZ,HU,2003.0,4,4,0
FR,EC,2021.0,8,6,2
IT,GR,2000.0,10,6,4
FI,IL,2023.0,1,1,0
DK,TR,2016.0,11,6,5
TW,AU,2007.0,23,26,-3
MA,BD,2018.0,12,8,4
CD,BE,2017.0,8,12,-4
FR,MG,2016.0,11,11,0
BR,TR,2022.0,6,7,-1
RU,KZ,1999.0,6,4,2
IN,IL,2004.0,12,6,6
CM,KE,2015.0,3,2,1
CD,BE,2019.0,5,19,-14
PG,AU,2021.0,4,5,-1
FI,ZA,2015.0,9,1,8
BE,SE,1999.0,8,9,-1
US,LR,2020.0,7,9,-2
TW,TR,2020.0,11,12,-1
CY,FR,2020.0,3,8,-5
MX,NZ,2016.0,6,2,4
CZ,AU,2004.0,3,2,1
SE,IS,2000.0,10,10,0
IT,ES,2023.0,20,14,6
JP,VE,2015.0,1,5,-4
TZ,KE,2011.0,2,4,-2
JP,BG,2013.0,5,6,-1
SE,HU,2013.0,5,15,-10
YE,MY,2014.0,7,10,-3
BH,KW,2016.0,1,6,-5
AU,RS,2006.0,2,3,-1
CO,NO,2019.0,5,3,2
CA,VN,2019.0,29,4,25
ES,MY,2003.0,2,1,1
PH,ES,2007.0,4,7,-3
RO,CZ,2015.0,9,16,-7
BE,CL,2015.0,12,16,-4
FR,BI,1998.0,7,7,0
TT,JM,1999.0,6,3,3
RW,US,2019.0,14,24,-10
NL,SK,2017.0,8,7,1
MW,US,2010.0,5,6,-1
PL,NL,2012.0,18,22,-4
NZ,ES,2009.0,2,3,-1
HR,HU,2019.0,7,6,1
nan,SE,2000.0,42,40,2
ES,CR,2002.0,13,13,0
AU,HR,2013.0,5,2,3
PT,CU,2001.0,2,2,0
SE,IL,2020.0,8,5,3
CO,NO,2010.0,2,1,1
RS,ME,2015.0,24,13,11
CH,BG,2015.0,3,3,0
HR,CH,2018.0,7,4,3
LU,AT,2016.0,3,7,-4
CH,LU,2019.0,6,8,-2
AU,SI,2012.0,4,3,1
CZ,BE,2008.0,5,8,-3
GR,ZA,2007.0,1,3,-2
CO,UY,2017.0,13,8,5
ZA,TZ,2003.0,1,1,0
UZ,AZ,2019.0,3,5,-2
ZA,NA,2018.0,19,10,9
NG,SE,2017.0,4,5,-1
SK,AT,1999.0,11,4,7
nan,AT,2016.0,24,14,10
LT,DK,2016.0,3,2,1
nan,PL,2008.0,5,9,-4
MX,GT,2021.0,25,24,1
IR,NZ,2014.0,8,3,5
IL,BE,2003.0,4,3,1
IT,BG,2011.0,4,4,0
CZ,NL,2015.0,17,20,-3
PT,RU,2006.0,5,12,-7
EG,FR,2007.0,16,24,-8
PT,JP,2016.0,7,2,5
LK,KR,2008.0,1,1,0
GB,AZ,2017.0,4,1,3
US,BW,2006.0,4,5,-1
FI,AU,2009.0,13,7,6
NO,SG,2015.0,3,4,-1
IN,IT,2006.0,41,49,-8
RS,AT,2013.0,8,7,1
DE,LI,2017.0,7,1,6
BE,UA,2019.0,5,4,1
CZ,KW,2005.0,3,1,2
CZ,BD,2019.0,2,2,0
ES,BD,2009.0,12,7,5
UG,ET,2022.0,1,3,-2
CH,HU,2016.0,14,19,-5
TR,IN,2012.0,14,18,-4
IN,CM,2010.0,1,1,0
IT,FI,2002.0,9,6,3
RS,AG,2016.0,8,1,7
CH,ZA,1997.0,6,5,1
FR,MC,2008.0,9,2,7
IN,KW,1998.0,9,3,6
CN,IT,2006.0,28,36,-8
EG,CA,1999.0,9,9,0
RS,RU,2001.0,2,1,1
IT,IS,2016.0,5,1,4
KG,RU,2019.0,6,10,-4
GB,KE,2002.0,11,10,1
SA,YE,2023.0,2,1,1
CN,CL,2005.0,2,7,-5
ID,UZ,2018.0,2,1,1
IE,NZ,2008.0,10,10,0
TW,PL,2014.0,2,8,-6
IN,JM,2016.0,3,2,1
JP,SA,2008.0,6,2,4
DK,HU,1997.0,3,1,2
HN,ES,2009.0,1,3,-2
DE,PT,1999.0,5,9,-4
US,LV,2005.0,4,3,1
CN,ID,2005.0,4,12,-8
CZ,DK,2013.0,7,7,0
NG,KR,2013.0,7,7,0
FR,NG,2006.0,3,6,-3
PT,UY,2012.0,4,1,3
SK,US,2001.0,29,14,15
TW,US,2023.0,30,19,11
AL,US,2020.0,5,3,2
AU,MT,2012.0,2,4,-2
US,MT,2009.0,3,1,2
EC,AT,2019.0,1,2,-1
ES,ZA,2002.0,1,4,-3
CH,IL,2009.0,15,13,2
AU,CZ,2022.0,5,6,-1
GB,SD,2019.0,8,11,-3
ES,FI,2008.0,18,13,5
CO,GB,2001.0,3,10,-7
EG,QA,2003.0,3,3,0
RU,MK,2017.0,4,4,0
HN,CL,2010.0,2,1,1
KE,SE,2011.0,4,5,-1
IN,PH,2003.0,5,3,2
US,LB,2023.0,4,5,-1
CA,GR,1997.0,5,7,-2
DK,CL,2009.0,3,1,2
DK,MX,2012.0,4,7,-3
CO,GT,2019.0,9,8,1
VE,PE,2014.0,17,2,15
CA,NP,2023.0,2,1,1
SE,LB,2021.0,1,3,-2
TW,UA,2007.0,2,2,0
TN,CA,2001.0,1,2,-1
GB,SD,2010.0,5,4,1
JP,UA,2016.0,9,7,2
TN,EG,2006.0,2,4,-2
US,OM,2002.0,6,11,-5
JP,SK,1998.0,8,7,1
BR,DE,2023.0,12,13,-1
BE,MX,2006.0,5,3,2
SN,US,1999.0,2,6,-4
CZ,MX,2019.0,10,3,7
US,GH,1999.0,5,5,0
ES,PL,2006.0,11,10,1
LK,NZ,2013.0,8,2,6
IQ,RU,2012.0,2,1,1
SK,FI,2014.0,2,1,1
DZ,CN,2017.0,4,2,2
UZ,KZ,2011.0,3,3,0
ET,MW,2016.0,2,1,1
QA,AE,2012.0,2,1,1
MN,US,2022.0,3,1,2
UA,KR,2014.0,4,1,3
BA,HR,2012.0,15,32,-17
BJ,BE,2022.0,4,3,1
HN,CL,2019.0,6,7,-1
TG,FR,2018.0,3,16,-13
SD,TR,2016.0,2,1,1
CM,IT,2020.0,7,5,2
GR,AU,2009.0,5,4,1
US,OM,2005.0,12,11,1
DZ,CN,2019.0,6,12,-6
ID,MA,2022.0,3,1,2
RO,SK,2019.0,6,3,3
VE,CU,2017.0,9,9,0
OM,SA,2006.0,1,2,-1
LT,CH,2012.0,2,4,-2
PL,MZ,2022.0,3,3,0
CH,PH,2006.0,3,4,-1
CA,RO,2021.0,16,5,11
BE,LT,2020.0,3,1,2
CA,MW,2009.0,3,1,2
FR,SI,2018.0,16,3,13
CA,BF,2013.0,3,2,1
CA,LY,2008.0,3,1,2
FR,VN,2004.0,6,7,-1
EG,IN,2020.0,23,17,6
DK,VN,2013.0,5,2,3
RU,ZW,2013.0,12,15,-3
HU,PK,2015.0,3,1,2
FI,BR,2021.0,4,22,-18
US,BJ,2002.0,1,3,-2
UZ,KR,2003.0,3,1,2
SA,IE,2009.0,1,2,-1
CZ,UZ,2002.0,3,4,-1
ET,NO,2016.0,14,10,4
NL,TH,2000.0,1,2,-1
KZ,CZ,2019.0,3,2,1
VN,IR,2020.0,4,16,-12
LT,LV,2021.0,1,2,-1
SE,AR,2001.0,2,4,-2
KR,BE,2009.0,4,4,0
IE,GR,2009.0,3,3,0
FR,BJ,2004.0,14,15,-1
OM,IN,2004.0,5,2,3
BE,RW,2000.0,1,1,0
NP,KR,2016.0,10,9,1
US,UZ,1997.0,3,1,2
HU,FR,2006.0,13,19,-6
NL,SK,2010.0,5,6,-1
ID,PK,2013.0,11,16,-5
MZ,PL,2007.0,9,5,4
MX,XK,2019.0,2,1,1
BR,CL,2000.0,13,10,3
JO,FR,2006.0,3,6,-3
FR,RS,2014.0,6,5,1
MD,TN,2009.0,10,9,1
IL,EC,2009.0,2,1,1
IR,nan,2016.0,8,7,1
KH,AU,2019.0,3,5,-2
CA,LB,2008.0,1,7,-6
DE,TZ,2013.0,4,3,1
AU,JO,2015.0,6,5,1
KE,CA,2016.0,10,8,2
GH,CA,2004.0,2,2,0
VN,GR,2003.0,6,2,4
IL,NL,2020.0,7,15,-8
BG,BR,2013.0,3,2,1
CL,PL,2011.0,5,3,2
IS,CA,2011.0,1,1,0
UA,BE,2015.0,3,1,2
DK,QA,2020.0,1,3,-2
SI,BE,2006.0,4,1,3
JP,RS,2017.0,3,4,-1
GR,SI,2017.0,3,1,2
CL,BO,2013.0,3,4,-1
CU,PE,2009.0,2,5,-3
TH,BE,2022.0,3,3,0
GB,MK,2012.0,7,1,6
HR,HU,2017.0,3,4,-1
CZ,RU,2002.0,13,9,4
GB,SD,2017.0,10,5,5
NG,CA,2005.0,4,2,2
UA,EC,2006.0,17,5,12
RU,LU,2013.0,1,1,0
AT,GR,2007.0,4,2,2
MZ,BE,2013.0,2,7,-5
RS,GB,2022.0,15,4,11
KE,JP,2007.0,3,8,-5
IS,FR,2019.0,10,4,6
BA,GB,2014.0,2,1,1
CR,DE,2018.0,3,5,-2
JO,IR,2013.0,2,1,1
CZ,MX,2010.0,1,2,-1
NO,AT,2003.0,2,2,0
CH,DO,2017.0,2,1,1
BD,nan,2013.0,4,3,1
CO,SE,2013.0,5,4,1
BD,DE,2009.0,3,4,-1
CZ,AR,2014.0,1,1,0
US,TT,2007.0,4,6,-2
MX,DK,2021.0,3,4,-1
PL,GR,2008.0,11,10,1
MY,PK,2005.0,2,3,-1
IL,CH,2008.0,15,7,8
IR,DZ,2018.0,2,4,-2
SI,AU,2008.0,3,1,2
FI,DE,1999.0,9,29,-20
LK,CN,2009.0,5,4,1
MW,KE,2012.0,3,1,2
CO,UY,2019.0,14,16,-2
MX,CN,2004.0,5,3,2
BR,HU,2010.0,2,2,0
AM,IT,2001.0,4,6,-2
KR,ZA,2001.0,2,1,1
CL,GT,2012.0,4,1,3
CL,NL,2007.0,4,7,-3
SK,JP,2017.0,10,6,4
PK,HU,2020.0,5,3,2
MX,SI,2018.0,9,6,3
NZ,SG,2008.0,12,13,-1
ZA,CL,2013.0,3,2,1
JP,MN,2011.0,4,3,1
BG,RS,2008.0,2,5,-3
RO,SE,2014.0,2,8,-6
RE,AU,2004.0,1,1,0
TR,TG,2017.0,1,1,0
CO,IR,2016.0,2,1,1
DE,TW,1999.0,9,8,1
DZ,ZA,2014.0,2,1,1
IE,nan,2013.0,4,2,2
TR,MY,2012.0,3,4,-1
SE,CO,2021.0,4,9,-5
PK,NO,2022.0,12,8,4
BR,SI,2020.0,3,1,2
MK,GR,2021.0,6,6,0
AR,AU,2022.0,6,4,2
TH,PG,2018.0,1,1,0
LT,GB,2011.0,6,4,2
IQ,LB,2022.0,3,3,0
AT,BG,2015.0,1,3,-2
MA,EG,2014.0,6,8,-2
RS,FR,2012.0,3,5,-2
NG,NL,2002.0,2,1,1
ZA,FI,2021.0,5,1,4
AR,GT,2015.0,3,1,2
JP,SK,1997.0,12,2,10
BE,SK,2007.0,1,6,-5
CZ,UZ,2005.0,1,4,-3
GR,nan,2018.0,2,4,-2
DE,BG,2001.0,11,21,-10
PT,AT,2001.0,1,2,-1
DK,RU,2015.0,13,8,5
NO,KE,2020.0,5,1,4
nan,NZ,1998.0,7,8,-1
BR,AE,2014.0,3,1,2
VE,NL,2008.0,2,1,1
KZ,CN,2015.0,11,10,1
AU,BW,2012.0,1,2,-1
BR,CZ,2013.0,14,2,12
DE,PH,2000.0,5,3,2
GB,LV,2020.0,6,5,1
FI,KR,2016.0,4,2,2
TR,RU,2015.0,5,2,3
BS,US,2022.0,3,2,1
CO,NL,2009.0,3,3,0
JP,UG,2021.0,2,2,0
MD,CL,2016.0,1,1,0
GT,CO,2016.0,5,4,1
BR,BE,2000.0,12,15,-3
BO,DE,2017.0,1,2,-1
NI,ES,2012.0,5,5,0
SA,BH,2006.0,4,3,1
EC,AT,2017.0,1,1,0
MU,GB,2014.0,1,6,-5
GB,ER,2019.0,1,1,0
KR,AU,2000.0,5,12,-7
CZ,RO,2015.0,16,9,7
LT,NL,1999.0,2,1,1
EG,LY,2006.0,2,1,1
CD,JP,2020.0,3,1,2
US,KG,2018.0,6,3,3
FI,LU,2015.0,3,7,-4
AT,AL,2018.0,1,2,-1
GR,CL,2004.0,1,2,-1
NG,NL,2005.0,1,1,0
MK,CN,2008.0,5,2,3
SG,ES,2006.0,1,2,-1
TR,GB,2002.0,20,55,-35
nan,PE,2016.0,10,8,2
GR,AL,2018.0,3,2,1
DE,LI,2010.0,2,6,-4
NO,ID,2015.0,6,4,2
KG,UZ,2001.0,1,1,0
KE,UG,2011.0,4,4,0
RU,VN,2009.0,1,2,-1
EG,LB,2007.0,2,3,-1
TR,AZ,2011.0,7,1,6
NZ,IR,2016.0,5,14,-9
RS,RO,2014.0,3,1,2
CO,CN,2007.0,2,1,1
FR,BO,2005.0,3,2,1
UG,NZ,2013.0,2,4,-2
PL,AR,2018.0,2,1,1
NZ,SE,1998.0,4,1,3
CL,VE,1999.0,8,2,6
IE,RO,2006.0,2,2,0
SI,CA,2009.0,4,2,2
CZ,RU,2005.0,15,14,1
AU,CU,2010.0,1,2,-1
PL,TW,2000.0,2,1,1
BD,IR,2013.0,4,4,0
DZ,DE,2005.0,3,1,2
BD,FR,2008.0,3,1,2
CA,SK,2006.0,3,4,-1
IT,KR,2014.0,6,6,0
AR,BO,2013.0,1,2,-1
BJ,US,2020.0,3,2,1
DO,CU,2018.0,2,3,-1
NL,UY,2003.0,2,2,0
TR,KW,2012.0,2,7,-5
FR,CY,2013.0,2,1,1
TN,MD,2005.0,1,5,-4
IE,PT,2018.0,6,6,0
EG,ID,2006.0,3,2,1
LU,BE,2008.0,9,15,-6
HU,RS,2012.0,9,7,2
ES,AE,2020.0,6,4,2
IR,ID,2022.0,7,10,-3
VN,LA,2005.0,2,1,1
CA,LT,2009.0,2,1,1
MX,KE,2015.0,2,2,0
BH,KE,2017.0,2,1,1
RU,BG,2002.0,5,9,-4
UY,PT,2014.0,1,4,-3
NZ,TW,2016.0,8,6,2
IR,KZ,2016.0,2,1,1
GR,NZ,1999.0,1,1,0
US,PR,2008.0,3,5,-2
UA,CA,2011.0,2,6,-4
MY,AR,2010.0,1,1,0
AU,LK,2023.0,2,2,0
PT,MX,2007.0,3,12,-9
CH,LU,2010.0,3,5,-2
ES,SE,2023.0,9,2,7
MM,KR,2019.0,2,3,-1
TW,IE,2020.0,2,1,1
FR,RE,2004.0,13,8,5
TZ,US,2009.0,7,7,0
SE,CL,2019.0,4,11,-7
BG,SE,2003.0,5,2,3
SK,IT,2003.0,3,1,2
VN,MX,2001.0,1,6,-5
PE,CZ,2020.0,2,2,0
JP,RS,2019.0,3,4,-1
EG,SE,2022.0,3,5,-2
QA,SE,2008.0,2,2,0
JP,CO,2020.0,9,12,-3
AE,NL,2022.0,6,5,1
NZ,MX,2018.0,3,5,-2
IR,LU,2017.0,2,1,1
YE,EG,2016.0,5,7,-2
CU,DE,2015.0,5,1,4
AE,SG,2021.0,4,5,-1
EE,FI,2001.0,3,2,1
AT,SA,2007.0,2,3,-1
GR,MY,2016.0,1,1,0
DE,LV,2011.0,4,3,1
SK,JP,2019.0,4,4,0
CZ,MX,2017.0,2,11,-9
RS,IT,2021.0,4,9,-5
NL,LK,2013.0,1,1,0
EG,IL,2019.0,2,5,-3
CR,DO,2009.0,1,1,0
RS,MK,2008.0,1,3,-2
UA,DK,2018.0,6,1,5
ET,PK,2017.0,2,2,0
CZ,SG,2013.0,3,4,-1
EC,CA,2020.0,6,4,2
MY,UZ,2012.0,1,2,-1
SA,PL,2022.0,3,2,1
KW,CH,2009.0,1,1,0
PL,TH,2017.0,1,1,0
CH,BD,2001.0,1,1,0
OM,ZW,2021.0,2,1,1
PS,SA,2017.0,8,8,0
MX,CZ,2014.0,2,4,-2
GR,QA,2012.0,3,2,1
BE,NO,2016.0,7,8,-1
CZ,BG,2018.0,5,2,3
RU,KW,2013.0,1,1,0
QA,KW,2008.0,3,1,2
IL,MX,2015.0,4,5,-1
NG,SE,2010.0,2,4,-2
AR,DK,2013.0,4,2,2
BB,FR,2012.0,1,1,0
RO,CA,2006.0,4,9,-5
AO,BR,2003.0,3,13,-10
BN,US,2007.0,2,2,0
CL,AT,2013.0,3,5,-2
PK,NZ,2001.0,1,2,-1
TW,NL,2003.0,2,3,-1
NZ,ZA,2000.0,4,6,-2
KP,KR,2020.0,2,12,-10
EG,BH,2012.0,3,6,-3
EE,GR,2016.0,1,2,-1
BO,AR,2004.0,1,3,-2
HR,AU,2013.0,2,5,-3
VN,NL,2000.0,1,4,-3
VE,FR,2016.0,9,6,3
CD,BE,2010.0,3,4,-1
SK,HU,1999.0,4,3,1
PT,KR,1998.0,1,1,0
GB,NP,2012.0,6,6,0
FR,UZ,2019.0,1,1,0
MW,GB,2004.0,1,5,-4
PL,KR,2014.0,3,1,2
BE,SY,2022.0,1,2,-1
EC,AU,2021.0,4,3,1
NG,AE,2014.0,2,1,1
TH,CL,2021.0,1,1,0
SG,NO,2022.0,4,1,3
KR,CO,2020.0,2,1,1
JO,HU,2022.0,1,3,-2
UY,CL,2022.0,3,6,-3
MX,HU,2017.0,2,3,-1
CD,US,2007.0,1,1,0
BG,AT,2006.0,3,2,1
GE,FR,2006.0,1,2,-1
BR,HN,2019.0,2,5,-3
AT,AR,2006.0,3,3,0
EG,SY,1998.0,1,2,-1
GB,JM,2001.0,5,3,2
LU,US,2000.0,5,2,3
IR,LU,2019.0,2,2,0
RU,TN,2021.0,2,1,1
BR,HN,2017.0,3,1,2
BO,DE,2019.0,2,3,-1
BE,HR,2017.0,5,3,2
CO,MX,2023.0,5,1,4
AZ,IL,2018.0,1,1,0
TN,BR,2003.0,1,1,0
BR,TW,2021.0,2,1,1
RO,SK,2017.0,1,6,-5
BJ,NG,2013.0,2,2,0
PK,ZA,2012.0,2,4,-2
QA,SY,2016.0,1,3,-2
MA,BE,2012.0,3,5,-2
CA,NI,2012.0,1,5,-4
CO,GT,2017.0,2,5,-3
AE,JO,2000.0,2,2,0
BG,AU,2018.0,3,4,-1
TH,ES,2014.0,2,5,-3
DK,EE,2004.0,1,1,0
AR,UY,2000.0,8,2,6
GB,ZW,2000.0,2,2,0
BE,TZ,2011.0,2,1,1
BR,PA,2007.0,1,1,0
SK,KR,2010.0,3,1,2
SE,LK,2021.0,2,1,1
GD,IN,2017.0,2,3,-1
BY,PL,2022.0,4,3,1
MY,VN,2011.0,1,1,0
MY,HK,2018.0,1,1,0
NG,CN,1999.0,1,2,-1
IT,NP,2009.0,1,1,0
HU,ZA,2014.0,1,2,-1
CN,LK,2005.0,1,2,-1
IT,TR,2000.0,5,4,1
IT,CU,2008.0,2,7,-5
JO,SD,2021.0,2,1,1
JP,CU,2017.0,1,3,-2
KE,DE,2007.0,3,11,-8
BR,CH,2023.0,3,2,1
GD,IN,2019.0,1,2,-1
FR,TG,2021.0,2,4,-2
CL,PE,1998.0,3,2,1
MY,PK,2002.0,1,5,-4
LK,TH,2013.0,1,3,-2
RO,IL,2004.0,1,1,0
TW,KE,2013.0,1,1,0
CZ,ES,2002.0,3,1,2
NL,HK,2001.0,5,2,3
NP,PK,2021.0,8,4,4
CY,ES,2007.0,1,2,-1
ET,JP,2002.0,1,3,-2
DE,MD,2007.0,1,1,0
MY,IE,2006.0,2,1,1
PT,IE,2014.0,6,3,3
PK,ET,2014.0,1,1,0
BE,MA,2002.0,1,2,-1
NL,KE,2006.0,3,3,0
US,DO,2009.0,3,1,2
VE,DE,2001.0,3,1,2
DK,NI,2012.0,1,1,0
LK,SG,2013.0,1,3,-2
GR,LU,2019.0,1,2,-1
DE,GA,2011.0,2,8,-6
ID,AE,2021.0,7,9,-2
JP,GE,2015.0,1,1,0
DE,BY,2021.0,3,2,1
IL,TW,2007.0,1,1,0
CR,PE,2007.0,1,4,-3
DE,AL,2004.0,2,1,1
KR,IL,2012.0,3,5,-2
AU,FI,2006.0,6,11,-5
AZ,DE,2021.0,2,2,0
GD,IE,2021.0,2,1,1
GR,VN,1997.0,2,2,0
MK,AT,2009.0,9,2,7
CN,HR,2009.0,2,2,0
NO,ET,2005.0,1,1,0
CN,RS,2016.0,2,8,-6
ZW,MX,2001.0,1,1,0
CA,RE,2019.0,1,2,-1
TH,AT,2004.0,1,1,0
AU,EG,2006.0,1,7,-6
EG,MY,2000.0,1,2,-1
MZ,PT,2015.0,3,4,-1
UY,CA,2018.0,3,1,2
SG,CZ,2016.0,3,3,0
PA,DE,2012.0,3,1,2
GE,DK,2016.0,1,1,0
XK,AL,2013.0,4,2,2
IR,HU,2010.0,1,3,-2
CM,ES,2019.0,1,1,0
ZA,RO,2010.0,2,4,-2
NZ,GH,2021.0,2,2,0
VN,RU,2020.0,10,13,-3
DE,KZ,2022.0,3,2,1
SE,LT,2012.0,4,2,2
GR,SA,2014.0,5,4,1
TZ,DE,2005.0,1,1,0
TR,NP,2019.0,1,3,-2
JP,PE,2003.0,1,1,0
SV,CL,2019.0,3,1,2
BE,ID,2011.0,2,1,1
BH,JP,2021.0,2,2,0
UZ,PL,1999.0,2,1,1
TN,NG,2017.0,2,3,-1
US,KZ,2007.0,2,4,-2
GL,DK,2014.0,3,4,-1
HN,MX,1998.0,3,6,-3
GT,CL,2014.0,3,1,2
TR,HR,2021.0,2,1,1
SN,GB,2012.0,1,1,0
BE,SG,2005.0,1,2,-1
AU,NO,2001.0,5,3,2
PH,AT,2013.0,2,4,-2
NO,MY,2013.0,3,4,-1
TR,KZ,2023.0,5,6,-1
IL,CL,2006.0,1,2,-1
PT,UA,2021.0,1,3,-2
ZA,CH,1998.0,2,5,-3
IL,PT,2015.0,1,3,-2
FR,UG,2021.0,1,3,-2
IR,BH,2007.0,1,1,0
RS,IE,2006.0,1,2,-1
BA,SI,2016.0,2,8,-6
EE,DK,2004.0,1,1,0
DE,CW,2014.0,2,7,-5
SD,IN,2017.0,3,2,1
JM,GP,2020.0,5,6,-1
GB,QA,2002.0,2,2,0
RU,NI,2016.0,1,1,0
TW,TH,2010.0,4,5,-1
NZ,SE,1997.0,3,4,-1
UZ,US,1997.0,1,3,-2
IN,CM,2017.0,1,4,-3
PH,MX,2010.0,3,3,0
VN,RS,2018.0,1,2,-1
IQ,nan,2021.0,2,1,1
VG,RU,2012.0,1,2,-1
NG,NP,2007.0,1,1,0
GB,CG,2022.0,1,1,0
ZA,NE,2021.0,1,1,0
LU,RU,2022.0,1,3,-2
SD,IN,2019.0,2,3,-1
NP,TH,2017.0,3,11,-8
VE,SE,2016.0,1,1,0
RO,CL,2013.0,1,1,0
SE,LV,2017.0,3,3,0
CZ,GE,2021.0,1,3,-2
RU,KG,2004.0,2,1,1
DE,NP,2012.0,3,3,0
DK,HU,1998.0,1,1,0
GH,DK,2007.0,2,1,1
MA,CZ,2021.0,2,1,1
CH,DO,2019.0,1,2,-1
US,UZ,1998.0,1,1,0
GB,BS,2015.0,2,2,0
TH,TW,2014.0,3,11,-8
SN,IT,2010.0,1,1,0
DZ,CA,2007.0,3,8,-5
CR,UY,2013.0,1,5,-4
BE,HR,2010.0,2,1,1
LV,PL,2014.0,3,2,1
TR,TN,2016.0,1,2,-1
LT,RU,2001.0,1,7,-6
CI,CA,2009.0,1,1,0
PK,SG,2013.0,1,5,-4
ES,AF,2020.0,1,2,-1
TH,KH,2013.0,4,2,2
KE,TH,2005.0,1,1,0
CO,GT,2010.0,2,1,1
SE,ZA,2002.0,3,7,-4
NE,CI,2019.0,1,1,0
PK,TR,2000.0,1,1,0
CH,LT,2006.0,1,1,0
TN,MA,1998.0,1,2,-1
BE,HR,2019.0,2,2,0
KZ,PL,2015.0,1,1,0
AM,GR,2012.0,1,2,-1
nan,PK,2022.0,2,9,-7
ID,EG,2023.0,1,5,-4
CA,DE,2005.0,153,193,-40
IE,US,2018.0,574,551,23
FR,BE,2000.0,132,151,-19
TW,CN,2022.0,723,708,15
CN,ES,2002.0,15,27,-12
JP,LT,2003.0,11,6,5
PE,AR,2013.0,33,39,-6
DE,NL,1997.0,101,90,11
CL,US,2022.0,150,141,9
US,EG,2004.0,102,74,28
BR,US,1997.0,171,207,-36
GB,ES,2019.0,448,510,-62
ZA,US,1999.0,123,140,-17
MX,CU,2004.0,26,21,5
CR,CA,2019.0,5,2,3
RS,US,2016.0,70,52,18
US,TW,1998.0,402,294,108
DE,NG,2018.0,6,8,-2
CA,SA,2016.0,107,67,40
nan,AR,2012.0,41,49,-8
HU,GB,1999.0,26,18,8
CH,CN,2011.0,73,76,-3
FR,GR,2000.0,22,12,10
PE,DE,2022.0,8,3,5
BE,CA,2014.0,67,65,2
VN,DE,2020.0,16,33,-17
AU,VN,2016.0,48,34,14
BE,FR,2009.0,254,332,-78
DK,IN,2021.0,20,21,-1
LB,FR,2015.0,43,102,-59
IQ,PL,2018.0,1,4,-3
SA,CA,2011.0,28,77,-49
SE,PT,2015.0,13,18,-5
MW,US,2019.0,24,22,2
AR,CA,2020.0,28,21,7
PT,GB,2014.0,121,84,37
DE,IQ,2012.0,5,1,4
FR,PT,2022.0,28,28,0
CU,CR,2022.0,3,10,-7
FR,NC,2002.0,5,4,1
MY,NG,2022.0,42,38,4
IT,AM,2020.0,32,14,18
QA,IR,2018.0,3,6,-3
FR,HR,2021.0,6,3,3
BG,US,2005.0,28,15,13
PL,PK,2021.0,9,14,-5
RS,PL,2017.0,3,8,-5
VN,CN,2008.0,32,30,2
SA,IT,2022.0,6,14,-8
FR,GP,2004.0,8,5,3
CA,ES,2004.0,41,40,1
AT,IE,2014.0,6,11,-5
NZ,NL,2015.0,15,10,5
US,IQ,2010.0,9,2,7
DE,NO,2014.0,103,68,35
CO,CL,2002.0,32,17,15
AZ,RU,2003.0,3,1,2
US,DK,1997.0,115,103,12
FR,BG,2012.0,10,7,3
LT,IN,2020.0,1,1,0
DK,KR,2014.0,5,11,-6
IE,SG,2017.0,5,3,2
IL,DE,1998.0,36,35,1
PE,BR,2011.0,37,26,11
BI,FR,1999.0,7,3,4
MX,HU,2019.0,3,1,2
IT,AU,2000.0,24,16,8
PS,SA,2019.0,8,13,-5
ZM,JP,2021.0,4,4,0
DK,MY,2021.0,5,1,4
IE,NL,2015.0,18,23,-5
SE,JO,2007.0,4,1,3
AL,XK,2013.0,2,4,-2
CZ,FI,2013.0,13,9,4
PK,ID,2013.0,16,11,5
CU,AR,2005.0,10,8,2
NL,IT,2003.0,49,52,-3
MX,US,2023.0,9,10,-1
JP,ZM,2011.0,1,1,0
ID,ES,2003.0,5,3,2
RE,BR,2005.0,1,1,0
UG,DE,2001.0,1,2,-1
CI,ML,2010.0,4,3,1
CN,SE,2000.0,28,39,-11
CZ,ES,2005.0,6,4,2
nan,IR,2016.0,7,8,-1
NO,PL,2012.0,7,10,-3
IE,DK,2021.0,11,7,4
MY,TH,2015.0,8,5,3
NL,IR,2012.0,27,38,-11
PL,ES,2008.0,19,7,12
ES,CR,2005.0,10,15,-5
AL,SE,2019.0,2,3,-1
PT,CA,2013.0,20,25,-5
BG,FR,2003.0,5,6,-1
CH,ML,2015.0,1,3,-2
RW,US,2017.0,14,14,0
UG,SZ,2019.0,1,1,0
CA,BJ,2012.0,3,1,2
MZ,BR,2013.0,11,12,-1
HK,SG,2007.0,2,1,1
ID,GB,2008.0,7,9,-2
ES,GR,2021.0,13,10,3
NZ,JP,2005.0,8,12,-4
BE,SG,2002.0,2,1,1
AT,RU,2003.0,4,10,-6
MY,RO,2020.0,2,1,1
JP,VN,2001.0,10,3,7
PK,TZ,2018.0,1,1,0
NG,KE,2015.0,4,2,2
CN,ID,2002.0,4,2,2
FR,MY,2007.0,5,4,1
IR,KR,2016.0,17,15,2
BW,IN,2020.0,1,5,-4
US,MK,2021.0,6,3,3
EG,DZ,2021.0,5,2,3
IL,NO,2013.0,2,3,-1
IR,AE,2010.0,3,2,1
NL,SA,2000.0,1,1,0
PH,TH,2003.0,1,1,0
CM,nan,2021.0,12,4,8
IR,AE,2017.0,7,5,2
CA,IR,2023.0,2,19,-17
BE,BJ,2021.0,1,2,-1
CH,ZA,1998.0,5,2,3
IT,TW,2015.0,6,3,3
IN,KW,1997.0,4,1,3
IE,SG,2010.0,4,4,0
LU,BF,2015.0,1,1,0
CR,MX,2001.0,5,4,1
IN,SG,2003.0,21,14,7
PK,MX,2018.0,2,1,1
KZ,CZ,2017.0,1,1,0
IQ,SA,2011.0,3,3,0
TH,TR,2009.0,3,2,1
RS,AU,2016.0,2,11,-9
KR,SD,2016.0,8,2,6
IT,GE,2015.0,2,1,1
FR,BI,1997.0,5,9,-4
JM,BB,1998.0,1,3,-2
CL,HN,2013.0,2,3,-1
QA,BE,2020.0,1,2,-1
KZ,IR,2018.0,2,6,-4
NZ,LK,2007.0,3,1,2
MY,KW,2016.0,4,3,1
CH,PK,2016.0,7,25,-18
GB,MZ,2008.0,1,1,0
PK,MY,2004.0,5,5,0
GB,QA,2005.0,3,5,-2
GR,LU,2010.0,2,1,1
GR,SI,2019.0,2,1,1
BR,GR,2021.0,3,2,1
TR,NP,2017.0,2,3,-1
CI,ML,2019.0,12,4,8
BD,AE,2013.0,2,2,0
UZ,JP,2021.0,2,2,0
CM,UG,2020.0,2,1,1
MZ,RU,1997.0,1,2,-1
MY,PT,2018.0,1,1,0
RS,PL,2010.0,2,1,1
DK,NZ,2013.0,2,8,-6
AR,JP,2019.0,4,3,1
KW,MA,2011.0,3,9,-6
IN,TN,2012.0,4,3,1
NL,SD,2003.0,1,1,0
IE,VN,2018.0,2,2,0
NZ,BR,1998.0,2,1,1
QA,BR,2016.0,3,2,1
ID,SE,2022.0,4,3,1
PH,NL,1999.0,1,1,0
MX,SE,2009.0,1,6,-5
DK,HR,2018.0,1,3,-2
AT,FI,2010.0,3,8,-5
NA,CN,2020.0,1,1,0
AO,IT,2022.0,1,1,0
IT,RS,2001.0,2,1,1
US,GE,2010.0,153,158,-5
IL,AU,2011.0,16,17,-1
BG,IT,2022.0,5,3,2
CO,PT,2020.0,24,19,5
SE,RO,2020.0,8,4,4
LV,SE,2011.0,3,2,1
RS,PL,2019.0,7,10,-3
ET,QA,2022.0,2,1,1
JP,AR,2013.0,4,4,0
MK,NO,2007.0,1,1,0
,MY,2005.0,1246,0,1246
,CN,1998.0,20457,0,20457
,AU,2011.0,7623,0,7623
JP,,2006.0,8079,0,8079
,CN,1997.0,14058,0,14058
LK,,2024.0,1815,0,1815
,ES,1998.0,10469,0,10469
FR,,1999.0,2603,0,2603
GB,,2009.0,9224,0,9224
,DE,2006.0,17485,0,17485
US,,1998.0,16876,0,16876
,TW,2008.0,4940,0,4940
,ES,1997.0,9001,0,9001
,SG,2001.0,1017,0,1017
IL,,2011.0,1396,0,1396
AE,,2023.0,2014,0,2014
,CA,2007.0,10271,0,10271
,AR,1994.0,3572,0,3572
,CL,2008.0,1711,0,1711
,PL,2007.0,4651,0,4651
NO,,1999.0,214,0,214
MY,,2021.0,4302,0,4302
FI,,2021.0,2681,0,2681
GR,,2012.0,1404,0,1404
TN,,2018.0,1104,0,1104
BD,,2014.0,319,0,319
AT,VN,2015.0,1,0,1
,ZA,2000.0,1159,0,1159
,RO,2001.0,646,0,646
CN,,2000.0,1014,0,1014
,AT,2012.0,2489,0,2489
PE,,2022.0,2155,0,2155
KR,,2004.0,524,0,524
JO,DZ,2008.0,2,0,2
,KR,2020.0,1233,0,1233
EG,,2009.0,411,0,411
,MY,2002.0,906,0,906
,UG,2010.0,307,0,307
,VE,2007.0,513,0,513
,NL,2013.0,5977,0,5977
JO,,2023.0,1974,0,1974
,PK,2004.0,684,0,684
MD,,2023.0,355,0,355
PH,,2016.0,335,0,335
GE,,2022.0,453,0,453
,PK,1996.0,354,0,354
IE,NO,2012.0,5,0,5
US,BO,2003.0,9,0,9
TL,BR,2023.0,1,0,1
LK,TW,2001.0,1,0,1
AM,,2022.0,361,0,361
,MD,1999.0,79,0,79
ES,AW,2015.0,2,0,2
,IL,2014.0,2512,0,2512
,LT,2009.0,788,0,788
,ME,2003.0,23,0,23
,CY,2007.0,166,0,166
TH,,2013.0,766,0,766
AU,BN,2000.0,2,0,2
,NG,2018.0,3557,0,3557
,SK,2019.0,346,0,346
CA,LK,2005.0,2,0,2
BY,,2024.0,1683,0,1683
EE,,2020.0,440,0,440
SG,,2000.0,165,0,165
GH,,2025.0,225,0,225
NE,,2021.0,68,0,68
PG,,2016.0,22,0,22
,SK,2010.0,1028,0,1028
SI,,2012.0,214,0,214
,EC,2016.0,1301,0,1301
UY,,2020.0,343,0,343
UA,UZ,2015.0,4,0,4
HR,,2007.0,101,0,101
ZA,,2003.0,335,0,335
ZM,,2024.0,676,0,676
DK,KE,2008.0,2,0,2
,BJ,2016.0,136,0,136
IR,TR,2002.0,3,0,3
LY,NG,2017.0,1,0,1
TJ,,2021.0,31,0,31
SK,,2013.0,308,0,308
GA,,2021.0,49,0,49
,TJ,2015.0,40,0,40
,KZ,2009.0,154,0,154
FR,LT,2000.0,2,0,2
GP,,2018.0,31,0,31
NZ,,2003.0,235,0,235
NG,BH,2016.0,3,0,3
US,BJ,2005.0,1,0,1
BD,MA,2000.0,1,0,1
SY,,2018.0,80,0,80
,BF,2011.0,115,0,115
UG,IT,1997.0,1,0,1
,SK,2017.0,724,0,724
VN,CL,2016.0,1,0,1
MY,LY,2007.0,1,0,1
,CM,2009.0,256,0,256
,CR,2008.0,206,0,206
ID,QA,2018.0,4,0,4
,MG,2006.0,64,0,64
,BA,2003.0,93,0,93
AE,GH,2023.0,1,0,1
,TG,2006.0,31,0,31
,SD,2018.0,146,0,146
,UG,2017.0,386,0,386
PA,ZA,2012.0,2,0,2
ES,NG,2014.0,2,0,2
CO,UA,2012.0,2,0,2
NO,IE,2014.0,4,0,4
SY,ET,2022.0,1,0,1
,LU,2006.0,106,0,106
ZA,RE,2015.0,3,0,3
NA,BE,2021.0,1,0,1
,HK,2015.0,48,0,48
PK,KR,1997.0,1,0,1
,UG,2019.0,265,0,265
CI,CN,2000.0,1,0,1
CI,RU,2021.0,1,0,1
VE,CR,2011.0,6,0,6
RE,PE,2020.0,1,0,1
,DK,2008.0,1888,0,1888
,ID,2014.0,15226,0,15226
DZ,CN,2010.0,1,0,1
,BD,2012.0,1108,0,1108
IE,,2007.0,366,0,366
,DZ,1994.0,168,0,168
,NA,2012.0,41,0,41
SA,TZ,2020.0,2,0,2
IS,,2012.0,40,0,40
HU,LT,2002.0,13,0,13
TN,QA,2008.0,1,0,1
,TZ,1995.0,102,0,102
CA,GP,2011.0,1,0,1
ZW,AT,2018.0,1,0,1
TW,IQ,2017.0,3,0,3
MA,,2004.0,81,0,81
ST,MZ,2015.0,3,0,3
BG,,1998.0,77,0,77
CD,BI,2018.0,1,0,1
,YE,1997.0,9,0,9
IN,EG,2000.0,6,0,6
,YE,1998.0,16,0,16
ET,,2009.0,29,0,29
NO,EG,2022.0,3,0,3
MX,TW,2022.0,1,0,1
,GN,2011.0,12,0,12
KW,TH,2021.0,1,0,1
MM,BR,2022.0,1,0,1
CN,QA,2000.0,1,0,1
BE,NG,2004.0,2,0,2
OM,,2011.0,40,0,40
SO,IQ,2016.0,1,0,1
TZ,ES,2021.0,2,0,2
,GY,2009.0,5,0,5
,ZW,2007.0,44,0,44
,AO,2003.0,17,0,17
SD,TT,2003.0,1,0,1
,MK,2000.0,42,0,42
AZ,,2007.0,30,0,30
CY,,2006.0,13,0,13
CG,,2015.0,17,0,17
RU,RO,2004.0,1,0,1
UG,MG,2014.0,1,0,1
BT,NP,2016.0,1,0,1
CM,CN,2009.0,1,0,1
DZ,SA,1999.0,1,0,1
ZA,BD,2000.0,1,0,1
RE,,2011.0,8,0,8
,KH,2007.0,36,0,36
DK,GH,2003.0,2,0,2
MX,SK,2011.0,2,0,2
HR,DK,2008.0,2,0,2
AM,EE,2005.0,1,0,1
CN,CR,2011.0,3,0,3
,DO,2011.0,27,0,27
KR,LT,2002.0,1,0,1
LB,CN,2004.0,7,0,7
JO,LY,2000.0,1,0,1
CR,PT,2011.0,2,0,2
MC,NO,2010.0,1,0,1
,VU,2013.0,3,0,3
UG,ML,2018.0,1,0,1
CA,LK,2002.0,2,0,2
CR,,2005.0,21,0,21
CN,MU,2009.0,1,0,1
,AL,2001.0,14,0,14
IR,SY,2020.0,3,0,3
CG,PK,2006.0,1,0,1
AM,BE,2016.0,3,0,3
ID,DK,2007.0,2,0,2
VG,,2003.0,7,0,7
CM,TG,2016.0,2,0,2
IT,VA,1998.0,1,0,1
JO,KE,2019.0,2,0,2
CN,CI,2020.0,2,0,2
HU,CN,1998.0,2,0,2
ET,JP,2005.0,2,0,2
SL,,2023.0,36,0,36
,BB,2011.0,7,0,7
,SJ,2015.0,5,0,5
DZ,GR,2003.0,1,0,1
BZ,FR,2013.0,3,0,3
BD,JO,2015.0,1,0,1
,KG,2000.0,10,0,10
KG,RU,2010.0,2,0,2
CH,TD,2011.0,1,0,1
EG,PH,1999.0,1,0,1
NO,BA,2020.0,1,0,1
NO,PS,2013.0,2,0,2
TR,PK,2007.0,6,0,6
MU,NO,2015.0,1,0,1
DE,OM,2003.0,2,0,2
LT,FR,2006.0,2,0,2
SD,ZA,2007.0,1,0,1
SC,,2019.0,3,0,3
PE,CU,2001.0,1,0,1
NG,CI,2016.0,2,0,2
BO,CU,2004.0,1,0,1
,ML,2000.0,28,0,28
AE,LU,2020.0,1,0,1
SS,US,2010.0,3,0,3
KZ,GR,2021.0,2,0,2
DK,UY,2012.0,1,0,1
GI,GB,2022.0,1,0,1
LT,IE,2004.0,1,0,1
IE,MW,2015.0,2,0,2
VG,MX,2001.0,1,0,1
NG,EG,2000.0,1,0,1
CU,AU,2015.0,3,0,3
KW,FR,2004.0,2,0,2
FR,MR,2021.0,1,0,1
,SL,2012.0,6,0,6
TW,BG,2015.0,2,0,2
CW,,2001.0,3,0,3
SI,SK,2013.0,2,0,2
US,DZ,2003.0,4,0,4
JP,CU,2019.0,3,0,3
NL,GA,2022.0,5,0,5
ML,NE,2021.0,1,0,1
SG,MX,2018.0,7,0,7
AL,GB,2014.0,1,0,1
FI,MW,2017.0,1,0,1
TN,NE,2013.0,1,0,1
nan,LU,2006.0,1,0,1
PK,ZM,2014.0,3,0,3
AL,SE,2010.0,1,0,1
BF,,2014.0,24,0,24
CN,EC,2018.0,1,0,1
CO,KE,2009.0,2,0,2
FI,EG,2008.0,2,0,2
TH,ZM,2009.0,1,0,1
HR,CZ,1998.0,1,0,1
,HN,1994.0,11,0,11
BR,BZ,2000.0,1,0,1
ET,ZW,2005.0,2,0,2
CH,MD,2016.0,2,0,2
BE,TD,2016.0,1,0,1
BB,ZA,2008.0,1,0,1
RS,PT,2012.0,2,0,2
MT,SE,2008.0,1,0,1
IS,TZ,2014.0,1,0,1
MW,CA,2004.0,1,0,1
FI,SC,2002.0,1,0,1
BJ,,2011.0,15,0,15
CY,CA,2001.0,1,0,1
CL,PY,2004.0,2,0,2
PE,CN,2001.0,1,0,1
FK,CA,2018.0,1,0,1
PH,NZ,2002.0,1,0,1
,CV,2009.0,2,0,2
AT,LI,2012.0,1,0,1
CO,AF,2011.0,1,0,1
NO,VN,2004.0,1,0,1
KE,AR,2016.0,1,0,1
MX,GR,2001.0,1,0,1
CY,JP,2003.0,3,0,3
CU,TT,2003.0,1,0,1
AU,EE,2011.0,1,0,1
PT,MO,2000.0,1,0,1
VG,NL,1999.0,2,0,2
GH,LR,2017.0,2,0,2
GF,,2015.0,10,0,10
HR,FI,2004.0,1,0,1
NI,NG,2015.0,2,0,2
FI,ZM,2011.0,1,0,1
HU,RU,1999.0,3,0,3
SA,HU,2008.0,1,0,1
CZ,BD,2010.0,1,0,1
TR,LT,2021.0,1,0,1
AR,RS,2020.0,1,0,1
FI,UA,2011.0,1,0,1
EG,TT,2022.0,1,0,1
CH,RW,2021.0,1,0,1
MX,LI,2021.0,1,0,1
EC,VE,2008.0,3,0,3
QA,SO,2016.0,1,0,1
EE,LT,2005.0,2,0,2
FR,BA,2011.0,3,0,3
HR,DZ,2015.0,1,0,1
PA,CR,1999.0,1,0,1
nan,RS,2013.0,2,0,2
ZA,GR,2021.0,2,0,2
NE,TG,2011.0,1,0,1
BR,EE,2022.0,3,0,3
MY,LK,2008.0,2,0,2
DE,MZ,2022.0,1,0,1
GE,MX,2017.0,1,0,1
SZ,AE,2000.0,1,0,1
LB,IN,2009.0,4,0,4
SK,MK,2019.0,3,0,3
CH,MT,2011.0,1,0,1
BH,KE,2019.0,5,0,5
SE,EG,2004.0,2,0,2
CN,UZ,2001.0,2,0,2
TN,MG,2014.0,1,0,1
IQ,,2026.0,8,0,8
nan,GR,2008.0,3,0,3
MW,AU,2011.0,1,0,1
AM,BR,2006.0,1,0,1
GM,UG,2008.0,1,0,1
JO,TN,2010.0,2,0,2
BI,CG,2006.0,1,0,1
AM,PH,2006.0,1,0,1
ET,DK,2009.0,2,0,2
NZ,CL,2005.0,3,0,3
MA,LB,2022.0,2,0,2
HR,MK,2021.0,2,0,2
NG,CU,2006.0,1,0,1
PR,,2011.0,3,0,3
RO,TZ,2017.0,1,0,1
ML,MA,2012.0,1,0,1
,ST,1995.0,1,0,1
BY,IN,2008.0,4,0,4
NC,PF,1998.0,1,0,1
AE,FR,2001.0,1,0,1
US,PY,2005.0,1,0,1
PR,BR,2019.0,2,0,2
CF,MA,2017.0,4,0,4
CR,,2002.0,7,0,7
MM,RU,2014.0,1,0,1
AT,PE,2014.0,1,0,1
SG,PK,2006.0,2,0,2
IQ,TW,2006.0,1,0,1
ID,HK,2021.0,2,0,2
MY,AR,2019.0,3,0,3
PE,EC,2002.0,1,0,1
DK,FJ,2018.0,1,0,1
BB,TT,2005.0,2,0,2
TT,FJ,2010.0,1,0,1
SV,SE,2007.0,1,0,1
BD,RU,2014.0,1,0,1
JP,LU,2021.0,1,0,1
ZA,PT,2008.0,1,0,1
AM,MA,2011.0,4,0,4
NE,MA,2008.0,1,0,1
HR,IL,2021.0,1,0,1
LK,SA,2015.0,1,0,1
ZA,NP,2011.0,2,0,2
JM,CH,2012.0,1,0,1
BS,,2018.0,6,0,6
OM,GH,2017.0,1,0,1
IN,PS,2007.0,1,0,1
ZW,CG,2018.0,2,0,2
RO,TZ,2019.0,2,0,2
NL,ML,1997.0,1,0,1
AM,IL,2013.0,2,0,2
CZ,PE,2022.0,2,0,2
NI,CU,2016.0,2,0,2
CR,SV,2017.0,4,0,4
NP,TH,2010.0,3,0,3
SI,BA,2005.0,2,0,2
UZ,AZ,2010.0,1,0,1
LS,,2015.0,4,0,4
UZ,PK,2018.0,1,0,1
PA,SG,2015.0,3,0,3
IQ,PE,2020.0,1,0,1
DE,XK,2016.0,2,0,2
MA,nan,2006.0,2,0,2
CR,GT,2020.0,1,0,1
MW,GM,2017.0,1,0,1
SC,,2017.0,1,0,1
MN,,2009.0,8,0,8
SL,KR,2019.0,1,0,1
PT,GR,2023.0,1,0,1
MY,SL,2020.0,1,0,1
EC,PL,2004.0,1,0,1
JO,KZ,2019.0,1,0,1
GT,FR,2017.0,1,0,1
SI,GR,2015.0,2,0,2
BY,MY,2016.0,1,0,1
PH,SA,2014.0,2,0,2
FR,SV,2014.0,2,0,2
LU,nan,2012.0,2,0,2
NP,NL,2001.0,1,0,1
BR,ZM,1999.0,1,0,1
MT,KE,2012.0,1,0,1
LA,KW,2014.0,1,0,1
AU,MM,1997.0,1,0,1
CI,CM,2009.0,2,0,2
PG,CA,2008.0,2,0,2
BA,AU,2014.0,1,0,1
CM,US,1998.0,1,0,1
ET,SZ,2020.0,1,0,1
PS,PK,2009.0,1,0,1
UY,HN,2016.0,1,0,1
IR,EE,2014.0,1,0,1
DE,LS,2014.0,1,0,1
CU,FR,2022.0,3,0,3
ID,CA,2023.0,1,0,1
JO,BE,2007.0,2,0,2
UY,CV,2015.0,1,0,1
CN,SL,2005.0,1,0,1
PH,LU,2019.0,3,0,3
DE,BF,2008.0,1,0,1
UY,EE,2017.0,1,0,1
MK,PT,2017.0,1,0,1
MC,CA,2007.0,2,0,2
NP,GE,2019.0,1,0,1
IL,VE,2015.0,2,0,2
nan,LY,2020.0,1,0,1
CG,US,2000.0,2,0,2
LS,CH,2021.0,2,0,2
PG,PT,2008.0,1,0,1
RS,NL,1999.0,3,0,3
IR,LY,2007.0,1,0,1
LK,FI,2017.0,1,0,1
IL,SI,2018.0,1,0,1
FI,LY,2010.0,1,0,1
NL,NG,1999.0,2,0,2
LT,CZ,1997.0,2,0,2
CH,CI,1998.0,1,0,1
DZ,TR,2020.0,2,0,2
TW,IQ,2010.0,1,0,1
TW,MN,2014.0,1,0,1
NG,BG,2017.0,1,0,1
BG,NG,2021.0,1,0,1
NL,SR,2010.0,1,0,1
TH,BD,2012.0,3,0,3
MC,,2011.0,2,0,2
TT,FJ,2017.0,1,0,1
SV,,2000.0,2,0,2
BY,CA,2009.0,1,0,1
GR,NP,2018.0,1,0,1
GE,KE,2004.0,1,0,1
IL,ZA,2011.0,4,0,4
BR,HN,2010.0,1,0,1
GB,LY,2000.0,1,0,1
PY,AR,1999.0,1,0,1
TT,NL,2012.0,1,0,1
ZA,JM,2013.0,1,0,1
PA,NZ,2012.0,1,0,1
BZ,GB,2014.0,1,0,1
PE,PT,2006.0,1,0,1
IE,AR,2015.0,2,0,2
GB,BO,2006.0,1,0,1
CH,EE,2004.0,2,0,2
UA,MD,1999.0,3,0,3
AG,KH,2022.0,4,0,4
CY,GB,1998.0,1,0,1
UA,ID,2022.0,1,0,1
EC,FR,2004.0,2,0,2
AX,,2018.0,2,0,2
PK,PR,2010.0,2,0,2
RW,PK,2011.0,1,0,1
HU,AT,2023.0,3,0,3
nan,VG,2021.0,1,0,1
NZ,QA,2019.0,2,0,2
BE,MA,2005.0,2,0,2
CL,NG,2009.0,1,0,1
IL,CR,2013.0,2,0,2
SJ,SE,2006.0,1,0,1
RO,EE,2019.0,1,0,1
KE,BJ,2014.0,1,0,1
BJ,CI,2012.0,2,0,2
IL,GD,2013.0,1,0,1
MX,ZW,1999.0,1,0,1
PL,NI,2006.0,1,0,1
SY,SA,2012.0,4,0,4
KW,AT,2017.0,1,0,1
PL,PR,2011.0,1,0,1
LA,US,2007.0,1,0,1
IE,SK,2022.0,1,0,1
FI,GE,2020.0,1,0,1
GR,PE,2020.0,1,0,1
ES,SN,2020.0,2,0,2
SY,MX,2014.0,1,0,1
GB,SJ,2008.0,1,0,1
UG,SZ,2017.0,1,0,1
GB,AZ,2010.0,1,0,1
nan,BM,2011.0,1,0,1
IR,NE,2014.0,2,0,2
TL,,2017.0,2,0,2
GB,LA,2014.0,1,0,1
DZ,PT,2014.0,1,0,1
BG,LV,2021.0,1,0,1
KG,TH,2020.0,1,0,1
SA,NP,2006.0,1,0,1
NZ,ID,2009.0,1,0,1
SN,VN,2018.0,1,0,1
CY,TH,2004.0,1,0,1
TZ,GF,2008.0,1,0,1
DZ,SY,2006.0,1,0,1
TL,GB,2021.0,1,0,1
CL,LV,2022.0,1,0,1
GD,IL,2012.0,1,0,1
BE,HK,2014.0,1,0,1
IT,ME,2016.0,4,0,4
KR,PL,2001.0,1,0,1
CI,SA,2017.0,1,0,1
SO,CA,2020.0,1,0,1
LK,RO,2012.0,4,0,4
GE,ZA,2006.0,1,0,1
ZW,RW,2014.0,1,0,1
SE,BY,1997.0,1,0,1
VN,LA,2002.0,1,0,1
,VA,2002.0,1,0,1
CZ,CU,2016.0,1,0,1
SI,PL,2022.0,2,0,2
NL,ZM,2016.0,2,0,2
PH,CH,2003.0,4,0,4
LV,PH,2013.0,1,0,1
,KN,2006.0,2,0,2
CO,TZ,2022.0,1,0,1
CR,HN,2015.0,2,0,2
SA,CO,2018.0,1,0,1
US,FM,2015.0,2,0,2
EC,CN,2014.0,1,0,1
CL,IN,2023.0,2,0,2
NL,XK,2020.0,1,0,1
AU,FK,2002.0,1,0,1
FK,US,2019.0,1,0,1
CM,JP,2008.0,1,0,1
NI,,2004.0,3,0,3
FR,KW,2012.0,1,0,1
AM,ES,2014.0,1,0,1
IE,PH,2003.0,2,0,2
KY,,2013.0,1,0,1
AM,NL,2011.0,1,0,1
AU,CU,2019.0,4,0,4
MW,NG,2015.0,1,0,1
RS,BG,2022.0,1,0,1
ZW,DE,2006.0,1,0,1
SJ,FI,2013.0,1,0,1
AZ,UA,2015.0,1,0,1
US,CG,2008.0,1,0,1
TN,MA,1997.0,1,0,1
HU,HR,1997.0,1,0,1
SS,KR,2001.0,1,0,1
,BZ,2011.0,2,0,2
BY,CH,2011.0,1,0,1
UZ,ES,2015.0,2,0,2
QA,VG,2020.0,1,0,1
IL,KZ,2022.0,1,0,1
IN,BA,2018.0,1,0,1
LA,AU,2014.0,1,0,1
BI,nan,2018.0,1,0,1
GL,,2021.0,6,0,6
TR,MT,2019.0,1,0,1
CN,BF,2004.0,1,0,1
FJ,PF,2004.0,1,0,1
MZ,PY,2018.0,1,0,1
AU,CY,2008.0,1,0,1
GE,UY,2022.0,1,0,1
LU,EE,2019.0,1,0,1
AR,NA,2014.0,1,0,1
EC,DZ,2016.0,1,0,1
KG,KE,2017.0,1,0,1
FI,CR,2015.0,1,0,1
US,CW,2020.0,2,2,0
LU,GR,2016.0,2,4,-2
FR,HK,2013.0,1,1,0
PS,MY,2022.0,2,3,-1
CO,NO,2017.0,2,1,1
SA,BR,2015.0,1,7,-6
GT,BR,2005.0,1,1,0
FI,PT,2004.0,2,1,1
TW,IL,2005.0,1,3,-2
PT,EG,2012.0,3,1,2
NI,UA,2009.0,1,1,0
SG,BE,1998.0,1,2,-1
GR,DZ,2014.0,1,1,0
SE,IQ,2015.0,3,1,2
JP,NG,1999.0,1,3,-2
PT,NO,2006.0,1,5,-4
JP,CU,2010.0,1,2,-1
ET,PK,2019.0,2,1,1
JO,TN,2019.0,2,2,0
MM,SG,2011.0,2,1,1
AL,NL,2014.0,1,1,0
AU,GR,2003.0,1,3,-2
JP,BF,2017.0,4,1,3
NZ,FI,2009.0,1,4,-3
CR,BE,2017.0,1,1,0
MW,FR,2018.0,1,1,0
GH,QA,2021.0,1,1,0
US,NC,2000.0,1,1,0
AU,UA,2020.0,2,2,0
PE,VE,2014.0,2,17,-15
CA,AM,2020.0,2,1,1
HR,PT,2009.0,1,1,0
QA,JO,2016.0,3,7,-4
NL,KW,2018.0,1,1,0
KE,ML,2011.0,1,2,-1
PK,CZ,2014.0,1,1,0
MW,TZ,2020.0,1,3,-2
KE,BW,2021.0,1,3,-2
NE,BE,2011.0,1,1,0
CH,LU,2017.0,3,5,-2
GR,FI,1999.0,2,1,1
QA,RU,2020.0,1,1,0
CH,CG,2003.0,1,1,0
SS,US,2017.0,1,3,-2
UA,MZ,2000.0,2,2,0
JO,ZA,2019.0,1,2,-1
KE,BR,2013.0,1,1,0
SE,MT,2016.0,1,1,0
CA,HK,2007.0,1,2,-1
AE,SY,2022.0,1,2,-1
AT,IL,2013.0,1,11,-10
SK,ZA,2007.0,1,1,0
UZ,US,1998.0,1,1,0
FR,UZ,2017.0,1,2,-1
CA,ZW,2019.0,1,2,-1
TR,IL,2012.0,1,5,-4
AT,UA,2000.0,1,2,-1
RU,MK,2019.0,1,2,-1
US,NE,2008.0,1,1,0
FI,RS,2022.0,1,2,-1
BR,HU,2017.0,3,4,-1
IR,HU,2017.0,2,3,-1
BW,CN,2014.0,1,3,-2
IS,FR,2017.0,1,3,-2
KH,AU,2010.0,1,1,0
BE,UA,2010.0,1,4,-3
EC,DK,2018.0,1,2,-1
BO,DE,2010.0,1,1,0
BR,ZA,2023.0,1,1,0
SI,NO,2011.0,1,1,0
FI,MY,2011.0,1,2,-1
MX,RO,2018.0,1,2,-1
LK,SE,2021.0,1,2,-1
TH,DK,2020.0,1,4,-3
CU,nan,2013.0,3,1,2
HR,HU,2010.0,1,1,0
GR,LU,2017.0,3,1,2
TR,TG,2010.0,1,1,0
TW,GR,2012.0,1,4,-3
NO,CO,2015.0,1,1,0
MY,TR,2011.0,1,9,-8
IT,BY,2001.0,1,1,0
SI,TW,2008.0,1,3,-2
CM,CH,2011.0,1,4,-3
MX,AF,2012.0,1,2,-1
SK,NO,2009.0,2,1,1
SE,CL,2010.0,2,3,-1
BE,VN,2003.0,2,2,0
TZ,ZA,2016.0,2,18,-16
BR,SV,2000.0,1,1,0
CD,CA,2006.0,1,1,0
SA,BA,2018.0,1,1,0
CA,TT,2005.0,2,1,1
DK,GR,2004.0,1,1,0
GE,CH,2020.0,1,2,-1
EG,JO,2000.0,1,2,-1
GR,EC,2012.0,1,3,-2
CL,IR,2018.0,1,1,0
NL,UG,2003.0,1,1,0
BG,HU,2007.0,1,1,0
AU,VG,2011.0,1,1,0
MY,AR,2017.0,1,4,-3
GN,PK,2020.0,1,1,0
RS,SG,2017.0,1,2,-1
HR,RU,2001.0,1,1,0
FR,BH,2014.0,1,1,0
FR,KZ,2013.0,1,2,-1
TN,JP,2012.0,1,1,0
IE,UG,2022.0,1,1,0
IS,FR,2010.0,2,2,0
BG,UZ,2019.0,1,1,0
TN,NG,2019.0,3,3,0
BW,ZW,2018.0,1,2,-1
CM,US,1997.0,1,3,-2
SD,IN,2010.0,1,1,0
IQ,IN,2004.0,1,1,0
BD,PL,2015.0,1,3,-2
IS,AU,2015.0,1,1,0
NL,HR,2001.0,2,4,-2
GL,US,2011.0,1,1,0
RS,RW,2009.0,1,1,0
AE,TH,2015.0,1,1,0
SG,GR,2015.0,1,3,-2
RU,CM,2018.0,1,1,0
KE,BH,2012.0,1,4,-3
MY,ES,2020.0,1,1,0
CH,IS,2009.0,1,1,0
DE,VG,2007.0,1,1,0
CH,MX,2022.0,2,13,-11
TH,PH,2011.0,1,3,-2
BD,TW,2007.0,1,1,0
GP,MG,2022.0,1,1,0
CM,ES,2017.0,1,1,0
IL,JO,2016.0,1,2,-1
DK,CO,2015.0,1,3,-2
BA,SK,2014.0,1,1,0
PT,AU,2007.0,1,10,-9
SA,JO,2003.0,1,3,-2
NG,CA,2002.0,1,1,0
GB,BJ,2017.0,1,1,0
US,VG,2001.0,1,7,-6
MK,GB,2018.0,1,3,-2
CN,ZW,2016.0,1,1,0
PA,IE,2015.0,1,2,-1
IQ,KR,2014.0,1,1,0
KH,PK,2021.0,1,1,0
IL,NG,2016.0,1,2,-1
KW,OM,2011.0,1,2,-1
BJ,RE,2020.0,1,1,0
AL,SE,2017.0,1,1,0
CL,PE,1997.0,1,4,-3
GY,GB,2018.0,1,1,0
UA,JP,2012.0,1,7,-6
AU,SC,2014.0,1,1,0
TW,IQ,2019.0,1,1,0
KR,GE,2011.0,1,3,-2
GB,AM,2020.0,1,4,-3
PT,ST,2008.0,1,1,0
NL,SR,2017.0,4,1,3
TW,AT,2012.0,1,3,-2
BF,FR,2001.0,5,4,1
LI,FR,2019.0,1,1,0
TW,IT,2007.0,2,2,0
FR,BD,2006.0,1,3,-2
IE,ZA,1998.0,1,3,-2
SV,CL,2017.0,1,8,-7
PA,CH,2004.0,1,2,-1
IN,MA,2011.0,1,4,-3
FI,GR,2000.0,1,1,0
ZA,nan,1999.0,1,1,0
SN,IT,2019.0,1,1,0
SK,BE,1997.0,1,1,0
FR,BO,2002.0,1,2,-1
GB,UG,1998.0,2,1,1
RU,AR,2018.0,1,5,-4
PS,JO,2009.0,1,1,0
FI,NP,2020.0,1,1,0
BR,JM,2021.0,1,1,0
TR,SI,2014.0,2,1,1
LU,JP,2006.0,1,4,-3
RO,CY,2019.0,1,1,0
TN,OM,2014.0,3,0,3
TN,IT,1997.0,2,0,2
PE,PA,2007.0,2,0,2
MK,MA,2016.0,1,0,1
CA,KY,2016.0,1,0,1
XK,RS,2000.0,1,0,1
BR,TN,2004.0,1,0,1
TR,EC,2016.0,1,0,1
FR,CD,1998.0,1,0,1
ZA,UA,2001.0,2,0,2
BR,SY,2020.0,1,0,1
PK,ZW,2014.0,1,0,1
nan,TG,2020.0,1,0,1
SX,IN,2013.0,1,0,1
MA,DZ,1998.0,1,0,1
AZ,LV,2011.0,1,0,1
RO,MD,2004.0,3,0,3
NO,TJ,2022.0,1,0,1
EE,PT,2022.0,1,0,1
UG,UZ,2000.0,1,0,1
AU,TZ,2012.0,1,0,1
SE,KH,2018.0,1,0,1
NC,IT,2000.0,1,0,1
TT,ES,2012.0,1,0,1
AT,MN,2012.0,1,0,1
CG,CI,2020.0,1,0,1
CL,KN,2019.0,1,0,1
ZA,MM,2022.0,1,0,1
DK,ID,2006.0,1,0,1
LV,IE,2006.0,2,0,2
IN,TT,2009.0,2,0,2
DZ,EG,2007.0,1,0,1
US,CF,2012.0,1,0,1
PE,PH,2009.0,1,0,1
AM,CN,2009.0,2,0,2
US,PW,2020.0,1,0,1
PH,QA,2019.0,1,0,1
SN,CH,1997.0,1,0,1
PA,GE,2015.0,1,0,1
NO,ML,2015.0,1,0,1
CL,KZ,1998.0,1,0,1
IS,GB,2023.0,1,0,1
HU,PS,2016.0,1,0,1
,AD,2015.0,2,0,2
MM,NO,2021.0,1,0,1
SA,BE,2007.0,1,0,1
ZM,ET,2014.0,1,0,1
OM,KW,2004.0,1,0,1
TR,XK,2012.0,1,0,1
AU,LY,2018.0,3,0,3
CR,BT,2016.0,1,0,1
TG,,2008.0,4,0,4
MM,CZ,2012.0,1,0,1
OM,SY,1998.0,1,0,1
CA,SS,2016.0,1,0,1
SE,BA,2011.0,1,0,1
SV,CL,2010.0,1,0,1
,ER,2014.0,2,0,2
PE,UA,2008.0,1,0,1
PT,MZ,2000.0,1,0,1
GB,WS,2011.0,1,0,1
GH,DE,2001.0,1,0,1
HU,LT,2005.0,1,0,1
nan,BA,2016.0,1,0,1
SK,KR,2019.0,1,0,1
GB,CW,2005.0,1,0,1
NO,LT,2011.0,2,0,2
TW,AM,2016.0,1,0,1
JM,JP,2011.0,1,0,1
LK,BD,2021.0,1,0,1
LI,,2001.0,2,0,2
TW,IL,2002.0,2,0,2
SE,LV,2010.0,2,0,2
FR,LA,2011.0,1,0,1
ET,AE,2022.0,2,0,2
SD,KW,2009.0,1,0,1
PG,DE,2009.0,1,0,1
ER,,2013.0,2,0,2
GB,BI,2009.0,1,0,1
JP,CD,2017.0,1,0,1
SE,TZ,1999.0,1,0,1
NP,SE,2000.0,1,0,1
VE,PY,2013.0,1,0,1
NZ,FR,2023.0,1,0,1
RW,CN,1999.0,1,0,1
BO,IN,2000.0,1,0,1
MZ,,2001.0,1,0,1
PS,CH,2013.0,1,0,1
NE,BR,2020.0,1,0,1
BW,UG,2018.0,1,0,1
PK,MK,2013.0,1,0,1
JP,FJ,2005.0,1,0,1
PK,DK,2002.0,1,0,1
BA,CN,2021.0,1,0,1
SI,BA,2002.0,1,0,1
BH,KE,2010.0,1,0,1
BH,FR,2011.0,1,0,1
NL,BW,2010.0,1,0,1
BG,UZ,2017.0,1,0,1
ZA,BW,2002.0,1,0,1
JP,MT,2004.0,1,0,1
AT,VE,2020.0,1,0,1
CH,GH,2011.0,2,0,2
VA,US,2015.0,1,0,1
BR,MG,2008.0,1,0,1
HK,VN,2017.0,1,0,1
CM,ZW,2011.0,1,0,1
GE,BE,2006.0,1,0,1
UA,SI,2009.0,1,0,1
PS,AE,2014.0,1,0,1
NP,CH,2001.0,1,0,1
CH,SO,2016.0,1,0,1
AO,UG,2017.0,1,0,1
ST,US,2020.0,1,0,1
AZ,SG,2020.0,1,0,1
JM,DE,2011.0,2,0,2
HU,EE,2014.0,2,0,2
DE,RE,2021.0,1,0,1
PA,EC,2014.0,1,0,1
VU,CH,2018.0,1,0,1
CL,DK,2001.0,1,0,1
NO,UA,2009.0,1,0,1
RU,PH,2003.0,1,0,1
NE,CI,2017.0,2,0,2
SG,AE,2007.0,3,0,3
CA,SI,2005.0,1,0,1
SD,SS,2020.0,1,0,1
MC,BR,2000.0,1,0,1
TW,PS,2015.0,1,0,1
ZW,ES,2016.0,1,0,1
,PW,2016.0,1,0,1
FR,NI,2017.0,2,0,2
TW,NO,2003.0,1,0,1
EE,TN,2020.0,1,0,1
PR,TH,2005.0,1,0,1
LT,CA,1998.0,2,0,2
FR,KG,2013.0,1,0,1
EG,HR,2017.0,1,0,1
TR,AE,2005.0,1,0,1
GR,SI,2010.0,1,0,1
GY,nan,2003.0,1,0,1
RO,KN,2020.0,1,0,1
MW,CH,2008.0,1,0,1
SE,MK,2021.0,1,0,1
BF,JP,2013.0,1,0,1
US,GL,2004.0,1,0,1
NZ,CL,2002.0,1,0,1
IN,GE,2023.0,1,0,1
RS,IN,2009.0,1,0,1
PK,MN,2019.0,1,0,1
BN,TR,2021.0,1,0,1
TH,AE,2007.0,1,0,1
DE,MN,2014.0,1,0,1
UA,PA,2012.0,1,0,1
KW,HU,2000.0,1,0,1
RU,NG,2003.0,1,0,1
IT,BI,2014.0,1,0,1
BJ,PE,2011.0,1,0,1
YE,CA,2021.0,1,0,1
JO,KW,2001.0,1,0,1
GW,ID,2014.0,1,0,1
SE,LV,2019.0,1,0,1
IL,PY,2018.0,1,0,1
nan,CL,1999.0,1,0,1
AU,TJ,2015.0,1,0,1
SE,ER,2003.0,1,0,1
ET,CG,2008.0,1,0,1
CN,FO,2021.0,1,0,1
IN,YE,2004.0,1,0,1
LU,MA,2015.0,1,0,1
BY,CN,2001.0,1,0,1
,XK,2020.0,1,0,1
MZ,GB,2002.0,1,0,1
MW,IT,2014.0,1,0,1
PK,LK,2001.0,1,0,1
FJ,MY,2010.0,1,0,1
ZM,BW,2000.0,1,0,1
DE,ER,1999.0,1,0,1
BF,CH,2008.0,1,0,1
SK,AM,2022.0,1,0,1
FJ,MY,2019.0,1,0,1
ES,CN,2007.0,34,39,-5
US,BR,2005.0,631,600,31
US,FR,2021.0,1008,1088,-80
AU,GB,2002.0,714,764,-50
CA,CN,2021.0,549,446,103
US,CN,2004.0,5106,3781,1325
KR,CN,2011.0,371,262,109
US,AU,2015.0,2593,2397,196
IT,DE,2018.0,379,291,88
JP,TW,2022.0,46,29,17
CA,FR,2001.0,219,265,-46
AR,BR,2010.0,123,117,6
CN,US,2006.0,4288,6850,-2562
US,DE,2013.0,2601,2488,113
GB,US,2009.0,5180,5396,-216
CA,US,1998.0,1662,1333,329
US,BR,2002.0,437,410,27
CH,IT,1999.0,85,92,-7
DE,BR,2010.0,174,168,6
CH,US,2016.0,906,979,-73
IE,GB,2003.0,159,176,-17
DK,US,2015.0,290,282,8
US,KR,2008.0,1134,948,186
CA,US,1997.0,1267,1143,124
US,CO,2011.0,239,214,25
DK,DE,2014.0,135,175,-40
HU,US,2004.0,80,111,-31
BR,PT,2014.0,943,991,-48
MX,CO,2014.0,304,270,34
CH,FR,2018.0,402,512,-110
DE,JP,2018.0,239,215,24
MX,CR,2009.0,20,6,14
AU,US,2018.0,2612,2700,-88
GB,JP,2014.0,306,244,62
US,KE,2020.0,107,82,25
US,NZ,2012.0,390,336,54
BR,CA,2011.0,256,265,-9
ES,US,2018.0,1176,947,229
KR,CA,2014.0,62,60,2
KW,EG,2009.0,21,6,15
IT,BE,2015.0,171,105,66
PT,BR,2011.0,629,802,-173
VE,ES,2008.0,102,69,33
PL,US,2020.0,257,210,47
US,UG,2003.0,9,10,-1
KE,DE,2008.0,10,8,2
MX,PE,2019.0,197,118,79
AU,CA,2020.0,406,430,-24
IN,FR,2017.0,145,129,16
FR,CH,2003.0,273,196,77
EG,JP,2006.0,41,53,-12
IN,CH,2020.0,74,72,2
DE,BR,2019.0,277,310,-33
AU,GB,2005.0,791,894,-103
NZ,GB,2013.0,254,272,-18
FR,AU,1998.0,28,43,-15
BR,ES,2005.0,136,174,-38
US,IL,2003.0,335,412,-77
AT,NL,2019.0,40,50,-10
AR,BR,2019.0,202,208,-6
RU,DE,1999.0,138,74,64
CA,CO,2013.0,17,21,-4
TR,AG,2022.0,245,176,69
CA,CH,2017.0,129,122,7
TW,GB,2022.0,30,40,-10
CA,PL,2022.0,12,9,3
DE,BR,2017.0,262,247,15
nan,DE,2017.0,82,69,13
DE,CH,2003.0,479,369,110
LB,MY,2014.0,2,3,-1
IN,FR,2010.0,125,85,40
LB,CN,2015.0,32,31,1
BR,ES,2002.0,122,125,-3
CR,ES,1998.0,4,5,-1
ZA,IN,2009.0,20,32,-12
CR,US,2010.0,27,35,-8
FR,SN,2006.0,23,20,3
FR,CL,2019.0,53,46,7
GE,US,2019.0,169,164,5
JP,FR,2009.0,106,134,-28
US,CL,2015.0,232,241,-9
FI,NO,2018.0,42,20,22
NZ,SG,2007.0,4,9,-5
JP,ES,2005.0,28,19,9
CA,QA,2021.0,11,15,-4
SA,NO,2018.0,2,2,0
FR,AU,1997.0,32,26,6
UZ,CN,2010.0,25,9,16
PK,BH,2020.0,4,2,2
US,RU,2001.0,233,326,-93
SE,GB,2013.0,161,213,-52
IN,NL,2010.0,49,49,0
IT,GB,2008.0,405,268,137
JP,IT,2006.0,64,49,15
CN,VN,2001.0,19,30,-11
ZA,PL,1999.0,1,1,0
FR,IE,2007.0,37,19,18
AR,PT,2014.0,20,11,9
US,ID,2018.0,335,212,123
FR,MA,2001.0,143,121,22
FR,IN,2015.0,146,133,13
US,SI,2015.0,26,17,9
ES,GB,2008.0,233,268,-35
TR,PL,2021.0,9,5,4
PL,CZ,1997.0,2,3,-1
GE,US,2017.0,204,154,50
NL,US,2018.0,985,837,148
RU,ES,2017.0,30,25,5
US,PH,2012.0,396,465,-69
CA,CL,2012.0,21,17,4
AR,CL,2006.0,41,40,1
GB,PT,2002.0,39,20,19
CH,GB,2002.0,126,128,-2
SE,BD,2018.0,6,5,1
PK,IN,2022.0,251,244,7
MX,ES,2001.0,239,210,29
IN,FR,2019.0,136,131,5
IN,NP,2021.0,120,106,14
FR,TN,2017.0,223,151,72
TH,IT,2002.0,2,6,-4
AT,CH,2007.0,70,67,3
AT,NL,2010.0,25,20,5
FR,CI,2012.0,15,11,4
BE,ES,2020.0,108,119,-11
JP,NZ,2016.0,18,8,10
FI,SE,2022.0,58,63,-5
IE,ES,2014.0,25,34,-9
TR,PK,2008.0,10,7,3
PA,CO,2019.0,29,19,10
PT,nan,2009.0,26,20,6
AT,DE,1998.0,162,164,-2
BD,JP,2010.0,47,58,-11
FI,US,2021.0,111,116,-5
DE,SE,2014.0,253,205,48
AT,NL,2017.0,25,37,-12
JP,NL,2002.0,31,31,0
MX,UY,2014.0,15,12,3
IT,IN,2020.0,63,78,-15
AR,nan,2012.0,49,41,8
AT,GB,2019.0,161,148,13
AU,MK,2017.0,49,60,-11
MX,CU,2015.0,53,87,-34
FR,CM,2014.0,14,13,1
IT,CL,2014.0,23,22,1
ET,US,2001.0,15,5,10
CN,RU,2004.0,21,35,-14
CN,BE,2001.0,9,26,-17
TW,BG,2004.0,1,1,0
CA,NL,2007.0,65,66,-1
CZ,GB,2008.0,48,39,9
NZ,CN,2001.0,12,10,2
CO,CN,2008.0,4,2,2
NL,CN,2014.0,97,100,-3
CN,TH,2006.0,8,7,1
GB,SE,2015.0,254,161,93
BE,JP,2007.0,13,22,-9
CN,LB,2018.0,12,30,-18
TW,nan,2005.0,9,4,5
JP,GB,2022.0,121,115,6
NO,UG,2015.0,7,3,4
IR,CN,2005.0,13,6,7
VN,CN,2007.0,29,18,11
MY,CN,2007.0,17,23,-6
IE,CN,2016.0,44,25,19
UY,US,2018.0,27,23,4
IN,SE,2023.0,6,3,3
DE,RU,2009.0,115,176,-61
CA,CH,2010.0,121,102,19
PK,FR,2014.0,5,34,-29
RU,ES,2010.0,15,11,4
MY,TW,2020.0,24,34,-10
CN,IQ,2012.0,4,5,-1
CL,CU,2010.0,12,17,-5
FR,NL,2020.0,154,136,18
FR,TN,2010.0,173,129,44
SK,NL,2014.0,6,5,1
US,LY,2013.0,3,5,-2
GB,CL,2002.0,7,8,-1
CL,CU,2017.0,19,30,-11
BR,MA,2010.0,3,1,2
MX,PE,2010.0,46,37,9
GB,GR,2001.0,90,59,31
ES,JP,2017.0,52,37,15
PK,MY,2015.0,74,98,-24
MY,LB,2017.0,5,2,3
AR,PA,2016.0,6,1,5
IR,AT,2022.0,12,10,2
CN,SD,2019.0,10,3,7
ZA,ET,2020.0,12,8,4
RU,FR,1999.0,50,38,12
SI,CN,2012.0,3,2,1
CA,JP,2005.0,109,128,-19
IN,NZ,1998.0,4,4,0
TH,US,2022.0,60,82,-22
US,HU,2007.0,130,106,24
AU,IE,2004.0,58,43,15
AR,ES,2008.0,229,225,4
UA,EG,2019.0,5,1,4
PL,RU,1999.0,18,11,7
SA,MA,2009.0,1,2,-1
IN,IL,2015.0,66,34,32
ID,TW,2022.0,57,34,23
US,PT,2016.0,175,196,-21
BR,AT,2016.0,20,9,11
CH,NL,2022.0,73,79,-6
GB,EG,2017.0,117,60,57
MX,TR,2018.0,2,2,0
VE,IT,2001.0,2,3,-1
SD,AE,2019.0,13,3,10
PH,AU,2021.0,10,12,-2
SE,DK,2000.0,50,51,-1
CR,US,2019.0,52,56,-4
JP,CZ,2016.0,15,26,-11
AR,DE,2009.0,25,30,-5
MX,CL,1999.0,30,15,15
FR,MD,2018.0,35,41,-6
CA,JP,2002.0,98,114,-16
ZA,MW,2019.0,11,3,8
IN,QA,2020.0,34,21,13
AT,GB,2010.0,93,89,4
AT,FR,2015.0,52,52,0
IN,NL,2017.0,90,53,37
DZ,BI,2014.0,2,2,0
FR,CZ,2015.0,40,33,7
NO,GB,2014.0,72,88,-16
GB,NG,2018.0,139,88,51
GB,HR,2005.0,5,7,-2
CU,EC,2018.0,53,15,38
CN,AE,2018.0,15,8,7
GB,LU,2009.0,5,3,2
ES,EG,2019.0,13,8,5
EE,GB,2010.0,5,7,-2
CN,SD,2017.0,8,2,6
NL,CH,2002.0,38,56,-18
TW,JP,1997.0,27,26,1
AU,TR,2012.0,8,9,-1
TH,AT,2015.0,2,5,-3
CH,GB,2005.0,194,150,44
US,BH,2018.0,8,17,-9
GB,EG,2010.0,74,38,36
AU,SE,2018.0,78,66,12
HU,CH,1998.0,7,7,0
NL,TR,2006.0,12,11,1
TN,DZ,2016.0,24,19,5
SG,TH,2014.0,13,5,8
DE,DK,2007.0,115,73,42
CA,IT,2008.0,66,82,-16
CI,US,2002.0,1,1,0
FR,VN,2015.0,39,22,17
GH,US,2016.0,27,59,-32
CU,MX,2003.0,30,14,16
IE,NZ,2007.0,11,12,-1
nan,DE,2010.0,62,76,-14
IN,NL,2019.0,95,61,34
SK,GB,2018.0,15,19,-4
JP,BY,1999.0,5,5,0
IR,MY,2020.0,55,94,-39
AU,DK,2009.0,29,15,14
BO,IR,2013.0,6,2,4
BR,RU,2000.0,13,5,8
nan,PL,2007.0,10,4,6
NZ,BD,2016.0,3,2,1
DE,IE,2007.0,72,59,13
GB,SA,2006.0,29,18,11
CR,EC,2019.0,33,19,14
RO,AU,2015.0,5,2,3
CL,CA,2020.0,22,28,-6
DE,EE,2015.0,54,51,3
nan,HU,2008.0,3,2,1
IT,MA,2009.0,13,9,4
CU,BR,2013.0,24,18,6
EG,SA,2006.0,41,37,4
IL,CA,2013.0,59,53,6
FR,CL,2017.0,62,46,16
ES,MA,2014.0,13,5,8
CH,NZ,2009.0,6,11,-5
PA,CO,2017.0,18,16,2
FI,TH,1998.0,1,1,0
EC,FR,2015.0,6,9,-3
HR,GB,2017.0,27,19,8
HR,SK,2018.0,8,4,4
GB,CH,2023.0,16,13,3
TR,DZ,2018.0,5,2,3
VE,AR,2009.0,19,15,4
IN,GH,2019.0,11,11,0
MX,SG,2015.0,2,6,-4
TR,FR,2015.0,24,21,3
MA,ES,2021.0,10,11,-1
NP,US,2016.0,75,58,17
VE,EC,2019.0,47,17,30
RU,CN,2018.0,53,79,-26
AU,IL,2018.0,14,27,-13
AR,TW,2017.0,11,7,4
EG,IE,2022.0,6,3,3
AT,GB,2017.0,107,121,-14
AU,PE,2017.0,3,3,0
GH,CA,2015.0,8,3,5
JP,TR,2019.0,31,85,-54
CZ,GR,2021.0,7,6,1
LU,SE,2019.0,4,3,1
LU,CN,2010.0,7,1,6
IQ,IN,2015.0,6,9,-3
UZ,GB,2015.0,4,3,1
MK,SK,2021.0,3,2,1
CR,EC,2017.0,29,13,16
CN,SY,2017.0,9,20,-11
GR,CY,2019.0,73,55,18
SK,CZ,2009.0,78,48,30
CA,IN,2008.0,91,171,-80
PR,MX,2020.0,12,4,8
FI,EE,2014.0,11,17,-6
UA,SE,2016.0,13,11,2
FR,GN,2017.0,4,2,2
CN,PH,2021.0,12,12,0
CZ,VN,2009.0,2,4,-2
MN,DE,2017.0,2,2,0
SE,SK,2007.0,3,5,-2
GB,BN,2021.0,5,1,4
SE,FI,1998.0,31,35,-4
LK,JP,2004.0,10,18,-8
US,AR,2006.0,157,191,-34
GB,MT,2022.0,6,8,-2
AR,CH,2013.0,21,11,10
FR,BJ,2015.0,30,30,0
GA,FR,2019.0,4,17,-13
DK,CH,2001.0,18,11,7
NL,CH,2005.0,69,73,-4
MW,GB,2015.0,14,15,-1
EC,CR,2003.0,1,1,0
TH,AU,2018.0,18,41,-23
IR,PH,2012.0,1,1,0
DE,TH,2018.0,25,18,7
PE,BO,2016.0,4,5,-1
SG,SE,2016.0,18,18,0
ES,CZ,2012.0,17,12,5
IE,IL,2017.0,3,1,2
VN,AU,2023.0,8,3,5
CH,BR,2015.0,52,59,-7
HR,AT,2021.0,9,5,4
GR,NO,2018.0,22,4,18
KZ,GB,2018.0,6,8,-2
GB,GM,2021.0,11,6,5
ZM,BR,2018.0,6,4,2
IQ,JO,2018.0,11,19,-8
CO,FR,2018.0,37,45,-8
BD,CZ,2014.0,2,1,1
PL,IT,2020.0,33,37,-4
MY,FR,2022.0,7,13,-6
PK,BD,2022.0,35,27,8
ES,CU,2010.0,78,123,-45
ES,CU,2017.0,80,113,-33
GE,US,2010.0,158,153,5
NL,IN,2013.0,51,46,5
CN,SY,2010.0,28,32,-4
SK,PL,2002.0,3,1,2
DK,SE,2021.0,111,94,17
CZ,UA,2008.0,16,7,9
CH,RU,2003.0,14,23,-9
nan,NL,2003.0,30,36,-6
ES,CU,2019.0,97,104,-7
TH,ID,2016.0,21,8,13
PK,AU,2021.0,53,43,10
FR,SE,2001.0,40,41,-1
BR,CN,2022.0,17,12,5
GR,CY,2017.0,73,29,44
UA,NI,2019.0,21,9,12
NL,NO,2017.0,49,20,29
AE,KR,2016.0,2,5,-3
DE,UA,2021.0,26,43,-17
IN,MY,2009.0,53,38,15
CL,PT,2018.0,13,7,6
TR,LA,2021.0,10,1,9
CZ,IN,2021.0,13,29,-16
GB,BD,2008.0,30,33,-3
EG,US,2013.0,150,208,-58
AT,SE,2018.0,40,40,0
US,VN,2004.0,14,17,-3
SI,NL,2019.0,8,11,-3
CN,UA,2002.0,6,13,-7
CA,MA,2014.0,11,14,-3
IR,IE,2022.0,15,3,12
MD,MA,1999.0,9,4,5
SI,RS,2010.0,9,9,0
DE,QA,2020.0,6,5,1
FR,AR,1998.0,10,15,-5
CA,IL,2001.0,22,24,-2
EC,UA,2013.0,47,26,21
JP,BE,2007.0,22,13,9
GB,BE,2011.0,131,108,23
KE,CH,2019.0,4,6,-2
AE,CA,2022.0,14,7,7
FR,CL,2010.0,37,37,0
NL,NO,2019.0,48,32,16
NO,IL,2013.0,3,2,1
JP,TR,2017.0,24,38,-14
AT,DE,1997.0,147,118,29
ZA,DE,2011.0,48,41,7
BE,nan,2006.0,24,39,-15
BE,PT,2015.0,14,29,-15
DK,GL,2019.0,7,5,2
JP,NL,2005.0,34,29,5
BG,PT,2014.0,2,2,0
ES,JP,2010.0,27,39,-12
FI,IN,2016.0,13,24,-11
SE,FI,1997.0,27,30,-3
ID,MX,2003.0,1,1,0
GE,DE,2003.0,6,1,5
AT,JP,2000.0,10,3,7
BE,AU,2002.0,16,17,-1
GB,HU,2020.0,41,39,2
FR,ZA,2011.0,37,22,15
IN,GH,2017.0,7,8,-1
EG,AU,2014.0,16,9,7
PL,CL,2020.0,6,5,1
IT,CZ,2013.0,36,15,21
CH,FI,2011.0,15,23,-8
DZ,BE,2016.0,2,8,-6
HR,GB,2019.0,19,19,0
IL,CH,2007.0,12,12,0
GB,CZ,2022.0,28,20,8
IR,BR,2022.0,6,1,5
PT,AU,2008.0,10,6,4
KR,MN,2020.0,5,5,0
DZ,ID,2019.0,9,2,7
RU,ES,2019.0,29,27,2
IQ,MY,2015.0,23,78,-55
CZ,AT,2016.0,27,30,-3
TW,FR,2001.0,23,16,7
CA,DK,2001.0,24,10,14
CL,AR,2001.0,29,22,7
PK,MA,2014.0,17,18,-1
CA,ES,2015.0,99,113,-14
CU,PY,2014.0,2,4,-2
BR,VE,2022.0,6,10,-4
TR,LU,2020.0,1,1,0
DK,GL,2017.0,6,3,3
FR,GP,2015.0,24,20,4
RO,ZA,2012.0,3,1,2
CA,BY,2020.0,2,2,0
ES,RO,2014.0,23,16,7
NO,CZ,2020.0,8,13,-5
HU,CH,1997.0,10,6,4
BO,FR,2007.0,5,5,0
IL,IE,2020.0,2,5,-3
US,JO,2006.0,50,22,28
FR,SA,2016.0,62,20,42
NL,NO,2010.0,39,15,24
DE,ET,2020.0,19,14,5
MA,US,2009.0,13,12,1
HU,DE,2006.0,52,47,5
IT,BR,2000.0,54,55,-1
RU,KR,2000.0,4,4,0
PK,EG,2020.0,25,26,-1
JO,AE,2014.0,22,9,13
EE,BE,2022.0,5,3,2
FR,MY,2008.0,8,9,-1
JP,KE,2019.0,9,7,2
KR,RU,2009.0,7,9,-2
IT,PT,2014.0,47,36,11
KW,IN,2021.0,3,10,-7
KR,PT,2013.0,13,2,11
US,MG,2014.0,7,3,4
CZ,IT,2021.0,27,34,-7
FR,RO,1999.0,9,13,-4
MX,PT,2005.0,9,6,3
CI,US,2005.0,3,3,0
KE,CH,2017.0,6,5,1
BG,DK,2013.0,2,1,1
MX,PE,2017.0,126,84,42
PK,AF,2018.0,1,2,-1
BE,SK,2008.0,1,2,-1
PK,OM,2013.0,7,2,5
EC,GT,2019.0,4,2,2
RE,FR,2003.0,3,14,-11
PK,FI,2021.0,13,6,7
ES,PK,2009.0,2,2,0
BE,RO,2009.0,8,7,1
DK,NL,2012.0,28,32,-4
CZ,AU,2015.0,7,8,-1
KR,IN,1997.0,6,12,-6
SI,RS,2017.0,20,21,-1
DE,AE,2021.0,11,6,5
NO,RU,2003.0,2,6,-4
SE,PT,2004.0,8,5,3
RO,CN,2003.0,6,1,5
ZA,BR,2004.0,6,7,-1
DE,EG,2022.0,44,36,8
CN,SY,2019.0,18,21,-3
IQ,EG,2009.0,5,2,3
KR,SA,2016.0,23,7,16
IR,CN,2002.0,8,3,5
FR,NZ,2018.0,18,23,-5
RS,DE,2004.0,18,15,3
SI,RS,2019.0,20,19,1
EG,LB,2008.0,4,3,1
RO,GB,2007.0,18,10,8
IT,PL,2009.0,23,16,7
SG,DK,2014.0,7,7,0
RU,HR,2011.0,6,6,0
nan,FI,2018.0,5,13,-8
MX,IR,2021.0,3,4,-1
CZ,PL,2014.0,45,41,4
IN,FI,2020.0,20,24,-4
ID,BR,2020.0,16,16,0
FR,RE,2015.0,49,36,13
US,MN,2020.0,12,4,8
RU,AZ,2007.0,4,4,0
SA,ID,2015.0,12,12,0
ZA,ES,2013.0,8,12,-4
DK,NO,2003.0,39,33,6
RO,HU,2020.0,36,56,-20
HR,GB,2010.0,14,9,5
DK,GL,2010.0,5,3,2
PT,IT,2022.0,25,23,2
FR,KR,2007.0,25,21,4
TW,AU,2008.0,35,26,9
DK,ES,2021.0,27,40,-13
FR,TR,2019.0,30,16,14
BA,US,2020.0,11,11,0
RS,CN,2006.0,9,10,-1
MX,nan,2014.0,27,23,4
VN,JP,2005.0,15,13,2
IN,PK,2001.0,15,16,-1
TW,MM,2003.0,1,1,0
BR,NZ,2013.0,8,5,3
FR,BB,2012.0,1,1,0
EE,GB,2019.0,16,9,7
PL,NO,2010.0,6,4,2
JP,ES,2002.0,16,11,5
PL,HR,2004.0,2,1,1
LT,DE,2006.0,6,6,0
FR,HU,2013.0,25,20,5
RU,HU,2000.0,2,2,0
BY,CZ,2019.0,16,16,0
SI,AT,2022.0,6,10,-4
IT,IL,1998.0,11,6,5
KW,US,2009.0,18,16,2
MA,DE,2021.0,6,6,0
SI,JP,2001.0,1,1,0
IL,BD,2022.0,3,2,1
JP,IR,2005.0,20,12,8
CZ,BE,2007.0,3,6,-3
IR,IT,2013.0,32,14,18
KR,IN,1998.0,17,18,-1
PL,NO,2017.0,18,10,8
GB,JO,2016.0,31,15,16
ZA,BG,2015.0,4,2,2
KE,AU,2021.0,4,3,1
BY,IT,2015.0,1,3,-2
DE,AR,2012.0,40,39,1
VN,ES,2018.0,2,4,-2
ES,PE,2009.0,43,44,-1
JP,TR,2010.0,35,33,2
GB,AR,1997.0,5,8,-3
NO,TR,2016.0,8,11,-3
KE,ET,2003.0,2,2,0
BY,CZ,2017.0,20,18,2
EG,FR,2008.0,11,12,-1
BJ,JP,2012.0,2,2,0
IT,BD,2017.0,9,2,7
AT,TR,2009.0,9,11,-2
TR,OM,2011.0,1,3,-2
GH,DK,2008.0,2,2,0
CH,DK,2008.0,27,24,3
JP,KE,2017.0,12,4,8
SK,PL,2005.0,3,3,0
RS,MX,2019.0,4,4,0
RS,MX,2010.0,28,65,-37
BG,UA,2007.0,4,9,-5
EE,SE,2002.0,7,10,-3
SE,CZ,2013.0,12,10,2
CH,TN,2014.0,12,19,-7
US,NI,2005.0,2,1,1
ET,KE,2020.0,7,11,-4
HU,AU,2005.0,7,6,1
DE,SA,2005.0,4,4,0
AU,BE,2007.0,15,28,-13
CA,KW,2001.0,3,1,2
GB,GH,2012.0,22,5,17
CN,PT,2020.0,16,10,6
CH,IE,2016.0,23,20,3
OM,AE,2013.0,11,2,9
AU,MK,2010.0,28,31,-3
HK,JP,2011.0,5,6,-1
GB,PT,2005.0,58,53,5
GR,TR,2014.0,10,2,8
ZA,NG,2009.0,7,21,-14
KZ,CN,2004.0,11,4,7
CN,MM,2022.0,2,3,-1
MX,GB,2000.0,18,35,-17
LK,BT,2016.0,1,3,-2
DO,US,2020.0,8,9,-1
LK,US,2013.0,32,25,7
KR,IE,2009.0,4,3,1
CO,BO,2020.0,12,10,2
CU,DE,2004.0,4,3,1
IN,OM,2021.0,23,11,12
OM,IN,2015.0,21,29,-8
CZ,RS,2014.0,12,16,-4
ES,CY,2008.0,1,1,0
IN,CZ,2014.0,36,14,22
PH,DE,2014.0,9,17,-8
IR,DK,2013.0,14,9,5
JP,LK,2011.0,36,14,22
KE,ZA,2005.0,6,7,-1
CN,NZ,2008.0,15,26,-11
JP,PT,2015.0,3,4,-1
CR,ES,1997.0,6,3,3
CH,BW,2011.0,1,1,0
JP,SG,2001.0,20,17,3
IT,LU,2020.0,22,12,10
EC,CL,2013.0,12,21,-9
AO,PT,2018.0,3,1,2
PE,AU,2013.0,5,1,4
GM,NL,2008.0,3,3,0
PT,MX,2008.0,10,11,-1
CU,PT,2017.0,3,6,-3
ES,EG,2010.0,6,1,5
IT,TH,2009.0,2,2,0
SG,TW,2013.0,29,50,-21
FR,MQ,1997.0,4,2,2
SG,IE,2021.0,6,7,-1
NO,BR,2018.0,23,21,2
SA,AU,1997.0,4,2,2
DK,CZ,2016.0,7,2,5
AT,ES,2002.0,10,6,4
CH,TR,1998.0,6,1,5
FR,MQ,1998.0,4,6,-2
CL,CR,2014.0,28,25,3
RO,IT,2018.0,16,15,1
TR,SA,2012.0,7,8,-1
MY,BD,2003.0,4,1,3
SA,TW,2019.0,6,7,-1
PT,CN,2012.0,8,10,-2
TH,CN,2005.0,7,6,1
TH,CN,2002.0,6,6,0
FI,AE,2019.0,4,2,2
CN,UA,2005.0,13,11,2
LU,BE,2007.0,5,8,-3
MX,AE,2019.0,1,1,0
ZA,NZ,2011.0,15,15,0
PH,PE,2019.0,7,7,0
IQ,AE,2022.0,7,4,3
JP,DK,2016.0,20,16,4
GH,SE,2019.0,3,2,1
IR,GR,2014.0,2,1,1
RU,MY,2011.0,7,5,2
AU,SK,2018.0,4,2,2
LU,CH,2016.0,6,7,-1
AZ,TR,1999.0,1,2,-1
BH,SA,2017.0,11,11,0
SD,US,2003.0,3,3,0
EC,US,2001.0,4,6,-2
BE,FI,2014.0,14,9,5
DK,PT,2014.0,6,3,3
TN,AE,2022.0,6,2,4
DZ,FI,2021.0,1,1,0
GR,CY,2010.0,31,15,16
MX,NL,2013.0,18,13,5
MX,CN,2015.0,17,5,12
US,NI,2002.0,1,1,0
LB,FR,2004.0,17,21,-4
BE,RU,2012.0,10,19,-9
MX,CA,2007.0,23,23,0
CO,VE,2004.0,14,6,8
PY,MX,2012.0,6,3,3
FI,TW,2013.0,4,2,2
KR,UG,2007.0,1,1,0
GR,SE,2020.0,38,22,16
VN,SG,2022.0,8,9,-1
FI,DK,2016.0,27,20,7
BJ,TN,2021.0,1,1,0
DK,SA,2020.0,7,1,6
CL,IT,2016.0,28,38,-10
CH,EE,2015.0,6,13,-7
ID,IT,2016.0,6,9,-3
NO,DE,2001.0,22,17,5
TR,RS,2007.0,54,78,-24
MX,BE,2000.0,2,3,-1
PL,GR,2007.0,4,1,3
NO,CA,2016.0,11,29,-18
IN,MX,2014.0,10,18,-8
JP,AT,2018.0,26,20,6
FR,TR,2017.0,29,23,6
HK,AU,2013.0,6,4,2
PY,BR,2022.0,4,11,-7
CL,PY,2015.0,8,1,7
MA,PT,2014.0,13,5,8
ZA,DK,2012.0,7,5,2
DE,LT,1999.0,6,2,4
FI,nan,2011.0,13,13,0
CA,FI,2011.0,21,14,7
NG,ZA,2006.0,11,3,8
FR,TR,2010.0,22,20,2
CH,PL,2014.0,26,37,-11
US,TZ,2009.0,7,7,0
IN,PL,2009.0,7,2,5
JP,NO,2005.0,6,5,1
IE,TR,2012.0,6,3,3
CA,NO,2003.0,8,15,-7
NO,ES,2003.0,9,7,2
PA,US,2004.0,17,9,8
SI,nan,2009.0,4,1,3
AR,IN,2014.0,5,7,-2
OM,GB,2011.0,6,10,-4
TH,FI,2009.0,1,1,0
CZ,IE,2006.0,1,1,0
ES,SI,1999.0,4,2,2
SG,NL,2016.0,17,22,-5
FR,IL,2009.0,28,32,-4
RO,DE,2020.0,38,32,6
nan,DK,2004.0,13,6,7
ES,TR,2005.0,2,4,-2
PL,IE,2008.0,4,4,0
SG,SA,2018.0,7,7,0
AR,TW,2019.0,8,2,6
UY,ES,2003.0,14,14,0
AU,KE,2012.0,7,5,2
FJ,AU,2011.0,5,5,0
GR,BR,2016.0,4,3,1
CH,TH,2008.0,4,3,1
CU,PT,2010.0,3,5,-2
PH,IT,1999.0,2,2,0
RU,KG,2015.0,5,6,-1
AM,HU,2014.0,1,3,-2
BG,RS,2007.0,10,2,8
DE,SI,2009.0,6,11,-5
CN,PL,2016.0,23,21,2
MY,AU,2007.0,14,19,-5
TW,IR,2011.0,3,3,0
MX,PK,2018.0,1,2,-1
AT,ID,2021.0,3,6,-3
US,IS,2020.0,18,18,0
nan,DZ,2014.0,6,7,-1
UY,DE,2009.0,2,3,-1
PH,SG,2011.0,5,4,1
NL,AU,2003.0,32,47,-15
JP,NO,2002.0,3,6,-3
NI,US,2020.0,7,3,4
AU,QA,2006.0,6,5,1
NA,GB,2003.0,2,1,1
PT,SG,2020.0,3,1,2
CZ,KR,2022.0,3,6,-3
NZ,DE,2022.0,29,20,9
CN,MK,2016.0,2,6,-4
IN,CL,2013.0,2,2,0
BE,IN,2005.0,11,10,1
CL,CU,2019.0,20,37,-17
TH,MM,2017.0,10,8,2
AT,ES,2005.0,7,11,-4
SK,FR,2002.0,9,4,5
NL,BD,2017.0,6,7,-1
TW,SE,2020.0,6,8,-2
IN,VN,2023.0,1,1,0
GA,DE,1998.0,1,1,0
MX,PT,2002.0,5,3,2
US,VE,2022.0,13,17,-4
ZA,IL,2015.0,7,5,2
ZA,SZ,2019.0,9,8,1
FI,FR,2005.0,12,12,0
FR,MC,2007.0,6,1,5
UG,GB,2018.0,19,14,5
KR,SE,2015.0,13,6,7
SD,IQ,2012.0,3,1,2
GB,EC,2013.0,3,2,1
SV,AR,2019.0,1,2,-1
TH,NG,2018.0,3,3,0
JP,PS,2003.0,1,1,0
JP,LY,1998.0,2,3,-1
QA,ES,2012.0,11,5,6
MY,BE,2013.0,2,5,-3
MK,CN,2007.0,3,2,1
JP,SI,2009.0,3,3,0
SG,PH,2013.0,6,10,-4
IN,PG,2017.0,2,1,1
HU,AU,2002.0,7,6,1
DE,MK,2020.0,3,2,1
JO,QA,2012.0,5,1,4
CR,PE,2008.0,3,5,-2
KR,OM,2018.0,3,1,2
AR,IE,2017.0,2,3,-1
IE,NL,2004.0,6,9,-3
EG,IR,2011.0,9,10,-1
LB,PS,2017.0,1,4,-3
BR,AO,2012.0,17,20,-3
GB,TW,2023.0,3,1,2
SK,CH,2022.0,3,3,0
PF,FR,1997.0,2,5,-3
PL,NO,2019.0,14,11,3
ME,RS,2012.0,10,9,1
DE,VE,2020.0,1,5,-4
MC,FR,2022.0,2,9,-7
MY,KR,2023.0,2,2,0
CO,PH,2016.0,4,3,1
SN,TN,2018.0,1,1,0
ES,TR,2002.0,5,6,-1
BH,RU,2020.0,7,1,6
PL,CZ,1998.0,7,10,-3
AR,IE,2019.0,5,4,1
FI,FR,2002.0,4,13,-9
nan,BE,2015.0,19,18,1
LY,IE,2011.0,1,2,-1
SK,FR,2005.0,11,4,7
CA,ZA,2011.0,31,25,6
BR,MZ,2013.0,12,11,1
ES,JP,2019.0,46,36,10
KR,NL,2009.0,4,9,-5
GR,IE,2020.0,9,2,7
AT,GR,2008.0,3,6,-3
MY,NP,2011.0,2,2,0
JM,US,2001.0,13,21,-8
BH,KR,2018.0,3,1,2
PA,GB,2016.0,8,8,0
CH,nan,2002.0,7,3,4
DK,IL,2011.0,6,3,3
EG,nan,2013.0,6,2,4
CR,CL,2022.0,12,4,8
ZA,AU,1997.0,9,2,7
AU,PT,2000.0,2,2,0
ES,BO,2002.0,1,1,0
NG,IN,2012.0,6,13,-7
IL,CZ,2020.0,9,4,5
GB,CL,2005.0,18,19,-1
TG,BJ,2016.0,2,1,1
BH,SA,2019.0,13,16,-3
MA,TR,2021.0,3,3,0
AT,SI,2005.0,5,3,2
MK,US,2011.0,6,7,-1
NZ,KR,2005.0,3,5,-2
SD,AE,2017.0,4,6,-2
AE,JP,2007.0,3,3,0
TW,HK,2010.0,3,2,1
CA,AR,2020.0,21,28,-7
MW,ZM,2018.0,6,2,4
ZM,ZA,2009.0,1,3,-2
SI,NL,2010.0,3,3,0
JP,TZ,1999.0,1,1,0
FI,PT,2015.0,4,3,1
BE,BG,2011.0,7,9,-2
SA,IR,2011.0,2,5,-3
PT,CZ,2013.0,1,1,0
DK,BE,2000.0,7,3,4
TR,IQ,2016.0,12,11,1
JP,SA,2007.0,8,3,5
SE,SI,2016.0,3,7,-4
US,LU,2013.0,17,12,5
LU,ES,2007.0,1,2,-1
GH,BH,2013.0,5,4,1
ES,HN,2001.0,6,3,3
PH,VN,2015.0,1,2,-1
ZA,ZM,2021.0,9,4,5
JP,IR,2002.0,7,7,0
NG,CM,2009.0,4,1,3
PH,CA,2006.0,4,4,0
PL,GE,2022.0,1,1,0
GH,GB,2013.0,7,26,-19
BR,MA,2017.0,2,1,1
PL,IL,2006.0,3,5,-2
RO,PL,2013.0,10,5,5
AE,PS,2020.0,2,1,1
GB,HR,2002.0,8,4,4
CZ,US,2023.0,9,5,4
IT,JO,1998.0,3,1,2
IN,PT,2020.0,10,28,-18
LS,ZA,2020.0,6,2,4
AU,IR,2003.0,17,4,13
CA,PA,2021.0,1,3,-2
NL,EG,2011.0,9,1,8
DO,MX,2019.0,7,7,0
TN,GB,2014.0,2,5,-3
FR,AR,1997.0,9,5,4
GT,PE,2017.0,1,1,0
BH,US,2001.0,5,4,1
AR,CZ,2020.0,2,3,-1
IQ,SY,2013.0,1,1,0
NL,PT,2003.0,9,5,4
MY,MX,2020.0,4,1,3
IN,AR,1998.0,1,1,0
DK,FO,2015.0,2,1,1
AU,TW,2006.0,14,12,2
CH,LI,2010.0,3,4,-1
ID,GB,2007.0,3,10,-7
AT,EG,1999.0,1,1,0
VE,UY,2003.0,3,1,2
PG,CN,2019.0,1,3,-2
SI,GB,2000.0,9,4,5
AE,IR,2013.0,6,4,2
IN,NZ,1997.0,2,3,-1
GA,FR,2017.0,8,2,6
IT,NG,2018.0,5,4,1
DE,PK,2000.0,1,5,-4
LK,IN,2011.0,7,11,-4
GF,US,2010.0,1,1,0
ZA,KR,2016.0,4,9,-5
GT,PE,2019.0,3,3,0
LT,IT,2016.0,3,4,-1
DZ,SE,2018.0,1,15,-14
PH,EC,2017.0,3,2,1
KW,ID,2019.0,3,1,2
VE,AU,2021.0,4,1,3
SE,KE,2014.0,3,4,-1
AZ,PL,2017.0,1,1,0
EE,RU,2022.0,4,9,-5
KE,CH,2010.0,4,6,-2
DE,BF,2007.0,1,1,0
MA,IT,2001.0,4,3,1
RO,TR,2011.0,1,2,-1
CO,IN,2013.0,7,2,5
CA,LB,2007.0,5,13,-8
AE,KZ,2019.0,3,2,1
KR,VN,2005.0,4,9,-5
IE,CZ,2012.0,5,2,3
CL,NL,2008.0,8,5,3
BA,BE,2019.0,2,2,0
nan,AU,2003.0,8,11,-3
GB,CM,2011.0,5,3,2
BG,CA,2021.0,2,3,-1
SK,DE,2000.0,16,10,6
CN,CO,2012.0,7,3,4
NL,HU,1999.0,5,5,0
TW,MY,2008.0,4,6,-2
IR,NG,2020.0,5,4,1
nan,TN,2010.0,3,2,1
VE,CA,2006.0,5,3,2
PL,TR,2016.0,7,1,6
BO,BR,2019.0,2,7,-5
EE,AU,2020.0,2,4,-2
DZ,nan,2018.0,12,15,-3
US,GD,2013.0,10,10,0
TW,IT,2008.0,2,4,-2
nan,PH,2015.0,2,1,1
SE,BE,2013.0,24,36,-12
SA,NL,2016.0,1,10,-9
TW,HK,2017.0,2,6,-4
KW,IQ,2012.0,2,1,1
GM,NG,2022.0,1,2,-1
IS,DE,2013.0,5,5,0
AE,SA,1998.0,1,2,-1
SE,KR,1998.0,5,1,4
IN,KE,2003.0,4,2,2
SA,JP,2009.0,5,15,-10
nan,ES,1998.0,8,3,5
MZ,PL,2008.0,9,3,6
VN,FR,2000.0,1,4,-3
AR,CN,2002.0,1,1,0
EE,SE,2005.0,5,10,-5
MN,DE,2019.0,2,3,-1
IR,AF,2015.0,1,1,0
DK,EE,2015.0,1,2,-1
BA,CH,2012.0,2,1,1
BR,PA,2008.0,1,2,-1
BR,RO,2018.0,6,8,-2
QA,DE,2011.0,4,7,-3
JO,AU,2021.0,3,4,-1
IN,GH,2010.0,3,1,2
PT,CH,2011.0,8,11,-3
KE,IL,2007.0,1,1,0
CH,KE,2018.0,5,7,-2
MY,MM,2021.0,2,7,-5
IT,IL,1997.0,10,8,2
BR,EC,2004.0,2,2,0
JP,ZA,2014.0,7,8,-1
LB,SD,2022.0,1,1,0
SD,GB,2001.0,3,1,2
FI,CA,2001.0,14,15,-1
NP,IN,2001.0,11,12,-1
LU,CN,2017.0,3,4,-1
GM,US,2022.0,1,1,0
LB,IL,2006.0,1,1,0
PK,IR,2018.0,13,27,-14
GE,IN,2014.0,3,3,0
VN,GB,2012.0,1,5,-4
DK,RU,2004.0,6,6,0
UG,NL,2011.0,3,1,2
IT,CU,2007.0,4,2,2
PK,RU,2013.0,1,4,-3
nan,SG,1998.0,1,1,0
PF,FR,1998.0,5,1,4
JO,BE,2008.0,1,1,0
CN,SI,2012.0,2,3,-1
QA,SE,2007.0,6,3,3
RE,US,2013.0,2,4,-2
FR,ET,2016.0,2,1,1
QA,RS,2009.0,1,1,0
PH,PE,2017.0,8,1,7
KG,US,2018.0,3,6,-3
CZ,GH,2016.0,2,3,-1
VE,CH,2021.0,1,2,-1
CN,MN,2014.0,4,4,0
SG,PE,2022.0,1,1,0
LK,CH,2020.0,3,3,0
JO,YE,2021.0,3,4,-1
IR,AZ,2021.0,2,2,0
CZ,NL,2004.0,9,8,1
PL,ES,2007.0,7,14,-7
NZ,PT,2015.0,2,3,-1
CZ,HR,2011.0,3,6,-3
KE,PH,2016.0,2,1,1
FR,PF,1997.0,5,2,3
SK,BR,2012.0,2,1,1
GR,RO,2009.0,3,1,2
NE,DZ,2020.0,1,1,0
BD,NZ,2016.0,2,3,-1
BE,PL,2021.0,9,17,-8
PE,ZA,2017.0,2,1,1
AT,TH,2000.0,2,1,1
ET,LK,2014.0,1,3,-2
DE,VN,2014.0,19,10,9
AU,BG,1998.0,3,2,1
CR,FR,2012.0,6,1,5
KH,FR,2013.0,2,5,-3
CN,MG,2020.0,3,4,-1
SA,TR,2022.0,10,7,3
MK,DE,2016.0,3,1,2
TH,IT,2005.0,3,1,2
HU,ES,2021.0,4,7,-3
GH,ES,2018.0,2,2,0
SE,UA,2014.0,10,8,2
PL,AE,2020.0,5,1,4
TG,CM,2014.0,2,1,1
GH,IT,2016.0,3,1,2
LY,SA,2009.0,1,1,0
nan,ES,1997.0,2,5,-3
BH,GB,2011.0,3,3,0
RO,TN,2022.0,1,1,0
IN,UZ,2011.0,2,2,0
NO,VN,2015.0,3,1,2
BG,CL,2019.0,2,1,1
LV,RU,1999.0,3,5,-2
GT,EC,2021.0,2,5,-3
AU,KW,2017.0,7,2,5
JP,TN,2021.0,2,2,0
IT,IR,2000.0,2,2,0
GP,BE,2017.0,1,2,-1
UA,NI,2010.0,2,1,1
CH,nan,2005.0,7,7,0
AE,IE,2018.0,3,6,-3
TR,RW,2018.0,1,2,-1
CN,BO,2001.0,1,2,-1
IT,TW,2004.0,4,1,3
SE,ET,2021.0,6,3,3
ZA,MZ,2018.0,1,2,-1
ML,US,2020.0,3,6,-3
FR,GE,2006.0,2,1,1
CH,BF,2014.0,1,1,0
ZW,PK,2016.0,1,1,0
QA,JP,2006.0,1,1,0
DE,GE,2018.0,3,6,-3
RU,TJ,1998.0,3,1,2
EE,GB,2017.0,7,14,-7
RU,GE,2008.0,2,1,1
DE,MD,2008.0,2,3,-1
RW,UG,2020.0,1,2,-1
ZW,GB,2009.0,7,3,4
JP,KE,2010.0,8,5,3
SD,BR,2006.0,4,3,1
BD,OM,2019.0,4,2,2
ET,ML,2017.0,1,1,0
BH,SA,2010.0,3,2,1
HR,IE,2018.0,5,4,1
CH,ET,2016.0,2,4,-2
MU,CA,2008.0,1,1,0
SG,QA,2013.0,4,1,3
SI,CH,2000.0,1,1,0
JP,LY,1997.0,1,1,0
AU,PE,2019.0,7,5,2
VN,JP,2002.0,6,5,1
CN,IE,1999.0,3,1,2
BE,HU,2022.0,2,3,-1
FR,GN,2019.0,7,3,4
NP,DE,2022.0,3,3,0
TR,IS,2019.0,3,2,1
MY,LB,2019.0,3,5,-2
US,JM,2000.0,2,8,-6
CL,ID,2012.0,1,1,0
KW,FR,2015.0,3,5,-2
BE,IN,2002.0,6,4,2
FI,TR,2003.0,3,1,2
FR,LY,2011.0,1,2,-1
TR,IE,2022.0,5,5,0
IN,NO,2023.0,2,1,1
CH,RS,2022.0,4,7,-3
BG,HU,2008.0,1,3,-2
MZ,US,2009.0,2,3,-1
JP,GE,2004.0,1,1,0
CH,LI,2017.0,1,3,-2
AU,ZW,2005.0,1,1,0
SA,TW,2017.0,5,11,-6
US,CG,2007.0,2,1,1
HU,nan,2001.0,4,6,-2
PL,AU,2013.0,8,20,-12
PT,PL,2021.0,6,2,4
TH,SE,2018.0,3,6,-3
CZ,UG,2020.0,3,1,2
CU,BE,2016.0,7,2,5
CA,KE,1997.0,1,2,-1
FR,LV,2016.0,4,1,3
CU,LB,2009.0,1,1,0
DE,JO,1999.0,2,1,1
GB,BW,2015.0,2,5,-3
TH,LK,2011.0,2,2,0
KR,NG,2011.0,4,5,-1
US,MZ,2012.0,2,3,-1
SG,BR,2021.0,3,8,-5
CH,ZM,2018.0,2,3,-1
ZA,IR,2018.0,4,8,-4
SI,CZ,2016.0,6,11,-5
VG,CA,2012.0,1,3,-2
AM,CA,2010.0,2,1,1
DO,MX,2017.0,6,7,-1
JP,OM,2011.0,1,1,0
CM,JP,2007.0,2,1,1
PK,AR,2005.0,5,6,-1
DE,KW,2013.0,3,1,2
SI,SE,2014.0,2,2,0
AT,IS,2016.0,2,1,1
IE,KW,2011.0,3,1,2
GB,SS,2003.0,7,6,1
SK,ES,1997.0,2,1,1
IE,IN,2000.0,4,1,3
PL,BY,2020.0,3,4,-1
CH,LB,2020.0,5,3,2
VN,SE,1997.0,2,1,1
KR,TN,2013.0,1,1,0
IN,LK,1998.0,1,2,-1
ZA,HU,2011.0,1,1,0
NE,FR,2003.0,2,2,0
IT,HU,1999.0,4,7,-3
DK,IQ,2018.0,3,1,2
nan,TW,2006.0,3,8,-5
HR,BR,2021.0,1,2,-1
CN,HU,2022.0,5,5,0
MX,ID,2014.0,1,2,-1
SE,CA,2023.0,2,5,-3
SV,BR,2021.0,2,2,0
NG,VN,2020.0,2,1,1
SV,AR,2017.0,1,2,-1
CH,PA,2004.0,2,1,1
NL,QA,2022.0,1,5,-4
SY,FR,2022.0,2,2,0
DE,BA,2022.0,3,3,0
nan,TN,2017.0,8,4,4
CL,CH,2006.0,3,3,0
BD,IT,2011.0,3,2,1
GR,RU,2012.0,5,5,0
AL,TR,2010.0,2,4,-2
IT,KE,2000.0,2,1,1
AM,GB,2020.0,4,1,3
nan,AE,2013.0,2,1,1
IE,CO,2009.0,2,1,1
UG,KE,2005.0,1,4,-3
BE,TW,2012.0,4,3,1
BG,GR,2006.0,2,2,0
JP,UZ,2008.0,3,2,1
QA,MY,2015.0,1,5,-4
SD,IT,2006.0,1,1,0
CM,BE,2022.0,1,6,-5
EG,DK,2009.0,1,3,-2
SD,JP,2014.0,1,2,-1
TH,IL,2020.0,1,1,0
RU,EC,2013.0,1,6,-5
CA,IS,2020.0,3,3,0
YE,JO,2021.0,4,3,1
CR,NI,2018.0,4,1,3
CH,BG,2004.0,3,4,-1
RS,NO,2011.0,4,1,3
NZ,BE,2013.0,4,9,-5
SE,MX,2014.0,10,9,1
DK,BG,2009.0,3,1,2
KH,GB,2018.0,4,3,1
LY,MY,2008.0,1,1,0
CD,ZA,2015.0,1,3,-2
NG,PE,2019.0,1,1,0
DO,IT,2016.0,6,2,4
CZ,BA,2015.0,1,1,0
US,GM,2012.0,2,2,0
SK,ES,1998.0,1,2,-1
TN,CZ,2011.0,1,2,-1
IT,ZA,2001.0,3,4,-1
MY,NI,2012.0,1,1,0
TR,RU,2004.0,1,2,-1
IT,MK,2012.0,2,1,1
CD,US,2008.0,6,1,5
AU,CO,2006.0,1,2,-1
SN,BE,2016.0,2,1,1
BA,CZ,2018.0,1,1,0
BD,SD,2021.0,1,1,0
DO,CR,2009.0,1,1,0
BD,OM,2017.0,2,3,-1
BG,KR,2009.0,3,1,2
NO,SG,2004.0,3,2,1
AM,CA,2019.0,1,1,0
BM,GB,2014.0,1,1,0
PS,BE,2021.0,1,2,-1
FJ,GB,2005.0,1,1,0
SD,QA,2015.0,2,2,0
JP,VE,2004.0,2,2,0
HR,SE,2014.0,1,1,0
PG,US,2013.0,4,5,-1
KE,JP,2008.0,4,5,-1
CH,VN,2020.0,4,6,-2
RS,ES,2009.0,2,1,1
IQ,PS,2018.0,1,1,0
NG,US,2023.0,4,1,3
BH,ID,2021.0,2,2,0
PH,IE,2012.0,1,1,0
UG,NG,2014.0,4,3,1
BO,BR,2010.0,2,3,-1
MX,SY,2013.0,1,1,0
GH,BJ,2021.0,1,2,-1
MY,LY,2008.0,1,1,0
ES,IL,2003.0,1,7,-6
RW,ZA,2021.0,2,4,-2
nan,TZ,2012.0,2,3,-1
ZA,AT,2009.0,1,3,-2
CU,CN,2011.0,1,2,-1
RU,TH,2022.0,1,1,0
CY,ES,2008.0,1,1,0
RS,MX,2017.0,2,7,-5
BF,GN,2021.0,1,1,0
IT,BD,2019.0,7,10,-3
nan,CR,2021.0,1,1,0
LB,PS,2019.0,1,4,-3
NZ,TH,2014.0,5,6,-1
IE,KR,2008.0,5,3,2
CO,EG,2021.0,1,1,0
ES,IN,1999.0,5,4,1
IL,RS,2020.0,1,1,0
EC,AR,2006.0,2,1,1
BI,US,1998.0,2,1,1
HU,QA,2019.0,1,1,0
IE,AE,2014.0,2,4,-2
ML,KE,2019.0,2,4,-2
ID,IN,2009.0,2,8,-6
US,ME,2020.0,1,3,-2
FI,NG,2020.0,4,2,2
BD,FR,2007.0,1,1,0
PA,CO,2010.0,2,6,-4
ES,IS,2021.0,1,2,-1
SA,BE,2008.0,1,1,0
TW,ES,2018.0,3,6,-3
GB,ZM,2018.0,6,8,-2
KZ,NO,2019.0,1,1,0
AR,AT,2009.0,2,3,-1
US,ML,2009.0,1,1,0
EG,CH,2003.0,2,3,-1
MT,AU,2022.0,1,3,-2
UA,SK,2012.0,5,4,1
SE,MY,2001.0,2,2,0
UA,NI,2017.0,6,15,-9
GR,HU,2013.0,3,2,1
NO,GR,2007.0,1,9,-8
MM,TH,2006.0,1,1,0
nan,JO,2021.0,1,1,0
AE,BR,2022.0,2,4,-2
NG,KE,2004.0,1,1,0
PL,LT,2005.0,2,3,-1
UA,BY,2011.0,5,8,-3
US,NA,2012.0,3,1,2
MA,YE,2020.0,2,2,0
ZA,MW,2010.0,1,2,-1
PK,AE,2009.0,5,4,1
DK,SG,2016.0,3,5,-2
AR,LB,2014.0,1,1,0
PL,SG,2013.0,4,5,-1
CA,CM,2011.0,2,3,-1
BR,MA,2019.0,1,3,-2
AT,SI,2002.0,3,3,0
AE,LB,2007.0,1,1,0
TW,HK,2019.0,2,2,0
IN,HR,2014.0,1,1,0
EG,NO,2011.0,2,1,1
OM,CN,2020.0,3,1,2
ET,IT,2015.0,1,6,-5
PH,ES,2008.0,1,8,-7
IE,IL,2019.0,1,3,-2
TR,UA,2011.0,1,1,0
SA,LY,2009.0,1,1,0
IL,TR,2011.0,1,2,-1
IR,JP,2023.0,2,1,1
SV,CO,2005.0,1,1,0
CU,PT,2019.0,1,4,-3
SG,BN,2006.0,1,1,0
HN,PE,2003.0,1,2,-1
NP,DK,2009.0,1,1,0
ZA,KE,2012.0,15,10,5
CN,TW,2021.0,804,925,-121
CU,CO,2011.0,22,23,-1
GB,NZ,2018.0,293,280,13
NL,GB,2007.0,242,174,68
GB,DE,2021.0,753,666,87
NL,BE,2020.0,319,267,52
CH,AT,2001.0,58,44,14
DK,FR,2013.0,38,60,-22
US,EG,2015.0,290,219,71
CH,AU,2001.0,28,25,3
AR,CO,2011.0,69,70,-1
GB,FR,2020.0,561,582,-21
AU,KW,2019.0,10,3,7
TW,JP,1998.0,28,34,-6
IE,CA,2012.0,137,160,-23
GB,EG,2019.0,131,104,27
ST,BR,2021.0,20,22,-2
CA,CH,2019.0,163,126,37
IR,DE,2016.0,117,55,62
NL,DE,2003.0,171,193,-22
HU,JP,2020.0,11,7,4
BD,JP,2019.0,62,91,-29
nan,DE,2019.0,100,66,34
KR,ID,2014.0,16,17,-1
SE,DE,2004.0,103,93,10
AR,BR,2017.0,178,174,4
MY,US,2001.0,21,24,-3
NO,nan,2014.0,14,47,-33
IR,SE,2020.0,67,37,30
MX,DE,2013.0,39,41,-2
BE,AR,2022.0,5,3,2
ES,QA,2013.0,10,5,5
SK,MX,2015.0,6,2,4
CR,US,2017.0,45,50,-5
EG,BR,2013.0,4,2,2
FR,LU,2018.0,49,39,10
NO,SJ,2022.0,2,5,-3
BD,JP,2017.0,63,52,11
CH,PT,2018.0,25,20,5
JP,PH,2020.0,36,27,9
NP,AU,2021.0,17,13,4
US,EC,2013.0,42,22,20
UA,PT,2016.0,3,1,2
BJ,FR,2013.0,37,32,5
TJ,RU,2009.0,8,5,3
FR,TN,2019.0,217,186,31
FR,RU,2001.0,45,45,0
GD,US,2010.0,6,9,-3
KW,SA,2006.0,1,3,-2
CZ,SE,2015.0,16,14,2
MY,DK,2011.0,2,2,0
ES,AU,2012.0,51,34,17
NL,BD,2019.0,7,3,4
CL,AU,2020.0,25,21,4
AU,MK,2019.0,37,49,-12
YE,US,2000.0,1,2,-1
MG,FR,2009.0,6,9,-3
AR,EC,2011.0,6,4,2
PK,IT,2006.0,2,4,-2
IT,CN,2003.0,21,24,-3
GB,AR,1998.0,13,13,0
TW,IN,2001.0,10,29,-19
GB,KW,2014.0,14,6,8
TW,nan,2002.0,4,5,-1
EG,IT,2020.0,9,20,-11
GD,US,2019.0,29,22,7
LY,MA,2021.0,2,1,1
GR,NL,2009.0,18,14,4
PK,PL,2018.0,9,10,-1
RU,JP,2013.0,33,40,-7
PT,SE,2003.0,6,3,3
RS,CZ,2004.0,12,10,2
ZA,IE,2016.0,6,2,4
BY,CZ,2010.0,10,7,3
IT,AT,1999.0,11,16,-5
PE,US,2000.0,14,27,-13
AU,SG,2006.0,42,57,-15
VE,EC,2017.0,54,10,44
BH,TR,2017.0,2,2,0
BE,AU,2005.0,19,7,12
UZ,CN,2019.0,8,12,-4
GB,MY,2006.0,64,29,35
VN,US,2004.0,17,14,3
ES,LV,2013.0,2,1,1
SE,EG,2015.0,3,7,-4
DE,TR,1998.0,10,6,4
ES,EG,2017.0,14,5,9
ES,DO,2018.0,25,8,17
DE,KR,2000.0,22,13,9
GB,GE,2013.0,4,5,-1
MY,IN,2004.0,15,30,-15
DE,TR,1997.0,10,5,5
QA,AU,2000.0,1,2,-1
JP,PK,2003.0,8,6,2
MK,RS,2008.0,3,1,2
ZA,AU,1998.0,10,19,-9
SE,IT,2023.0,3,6,-3
IN,LB,2020.0,5,8,-3
GA,FR,2010.0,5,8,-3
MY,SA,2014.0,59,24,35
PL,CH,2012.0,28,23,5
US,TT,2008.0,9,9,0
LT,PL,2010.0,4,2,2
SK,DK,2001.0,2,2,0
JP,IE,2003.0,12,30,-18
JO,LB,2019.0,5,3,2
SI,NL,2017.0,4,13,-9
AE,PT,2022.0,2,1,1
TH,MM,2019.0,10,11,-1
CN,KZ,2005.0,4,9,-5
KR,TH,2006.0,4,3,1
RU,SK,2020.0,13,12,1
SI,IN,2018.0,5,4,1
IR,SG,2021.0,16,26,-10
BE,KE,2012.0,4,2,2
IN,ML,2002.0,2,2,0
HU,FI,2000.0,1,8,-7
NZ,KR,2002.0,2,1,1
RO,MD,2015.0,6,6,0
LU,FI,2015.0,7,3,4
ZA,MW,2017.0,9,10,-1
SE,BG,2001.0,3,3,0
DE,CR,2007.0,2,1,1
ES,FI,2007.0,13,8,5
NO,NZ,2013.0,2,1,1
PT,CO,2014.0,16,11,5
AU,LT,2011.0,1,1,0
CH,NG,2022.0,2,4,-2
NG,NZ,2022.0,2,2,0
MK,IN,2016.0,3,1,2
BI,CN,2015.0,1,1,0
SI,TW,2007.0,2,1,1
AR,TW,2010.0,10,9,1
nan,TN,2019.0,7,7,0
CN,BR,2000.0,4,7,-3
CH,HR,2011.0,2,7,-5
TZ,AU,2015.0,1,1,0
NZ,NL,2004.0,6,11,-5
RO,UA,2018.0,10,2,8
NP,ZM,2008.0,1,1,0
PT,AR,2003.0,5,4,1
GN,ML,2017.0,2,2,0
IL,PH,2014.0,1,2,-1
DE,ID,2003.0,5,4,1
MZ,BY,2021.0,1,1,0
US,KZ,2008.0,3,5,-2
FR,TH,2001.0,1,2,-1
RO,CO,2020.0,2,1,1
IL,UA,2016.0,2,5,-3
NZ,UG,2018.0,3,2,1
NG,TR,2013.0,4,1,3
SG,MM,2016.0,5,3,2
KR,NO,2002.0,1,5,-4
KR,FI,2006.0,5,2,3
PE,FR,2003.0,1,3,-2
PS,ES,2006.0,2,4,-2
SN,GN,2016.0,2,3,-1
BE,LV,2013.0,1,2,-1
ES,BO,2005.0,3,4,-1
CN,CY,2012.0,1,2,-1
IE,MY,2022.0,1,3,-2
RO,IL,2015.0,3,1,2
TR,DK,2006.0,3,1,2
FR,SK,2001.0,4,7,-3
NL,LT,1999.0,1,2,-1
AZ,UA,2004.0,1,1,0
MA,JO,2014.0,1,2,-1
AU,MA,2006.0,1,1,0
CF,FR,1998.0,1,1,0
CA,PS,2014.0,1,1,0
KW,AE,2020.0,4,2,2
PH,PA,2020.0,1,2,-1
TW,BE,2011.0,3,2,1
HR,BA,1999.0,1,2,-1
UG,BR,2018.0,1,4,-3
ET,ES,2013.0,1,2,-1
LT,PL,2017.0,3,12,-9
nan,UA,2009.0,18,10,8
DK,GR,2015.0,10,10,0
GD,US,2017.0,17,17,0
KE,ZA,2002.0,6,3,3
CL,UY,2011.0,7,10,-3
UZ,CN,2017.0,3,7,-4
RU,IR,2021.0,13,12,1
CL,DE,2006.0,16,37,-21
KG,TR,2021.0,8,3,5
UA,KZ,2008.0,1,1,0
SE,AT,2009.0,11,11,0
IE,IR,2011.0,3,8,-5
LK,NL,2020.0,2,3,-1
EE,DK,2015.0,2,1,1
TH,MM,2010.0,1,1,0
JP,RU,2012.0,28,30,-2
DE,SA,2002.0,4,5,-1
,PK,2015.0,2915,0,2915
,JP,1999.0,19660,0,19660
,IR,2010.0,14075,0,14075
,IN,2001.0,7485,0,7485
AR,,2021.0,3899,0,3899
,NZ,2005.0,1156,0,1156
,US,1995.0,127858,0,127858
,VE,2008.0,390,0,390
ES,,2006.0,2880,0,2880
IT,,2006.0,2892,0,2892
,SE,2002.0,3005,0,3005
RU,,2017.0,6041,0,6041
,TW,2007.0,5324,0,5324
,CO,2016.0,2419,0,2419
,PL,2008.0,4757,0,4757
,CA,2008.0,9990,0,9990
JO,,2024.0,3207,0,3207
,BR,2018.0,18147,0,18147
,FR,2010.0,16307,0,16307
PL,,2013.0,1554,0,1554
,HU,1999.0,1205,0,1205
KR,,2015.0,3180,0,3180
AE,,2024.0,3438,0,3438
BR,,2013.0,5053,0,5053
AT,VN,2004.0,1,0,1
RU,,2010.0,3248,0,3248
BE,,2011.0,1558,0,1558
BO,BR,2017.0,6,0,6
,SE,2005.0,3056,0,3056
,FR,2019.0,5430,0,5430
RU,,2019.0,9737,0,9737
,IR,2017.0,10114,0,10114
DK,,2018.0,1902,0,1902
SE,,2000.0,796,0,796
,NZ,2002.0,874,0,874
RU,CO,2006.0,4,0,4
,CH,2000.0,2883,0,2883
LK,,2023.0,2048,0,2048
MK,CA,2020.0,1,0,1
,CL,2007.0,1578,0,1578
,RS,1994.0,771,0,771
,DK,2007.0,2475,0,2475
CM,,2018.0,212,0,212
PH,,2025.0,141,0,141
QA,ID,2005.0,1,0,1
NG,,2013.0,421,0,421
NI,,2015.0,13,0,13
LB,,2011.0,91,0,91
,SI,2006.0,602,0,602
BY,,2023.0,1451,0,1451
,SA,2006.0,564,0,564
,FI,2001.0,1708,0,1708
IE,,2008.0,377,0,377
SA,,2011.0,215,0,215
,MA,1995.0,350,0,350
,CI,2012.0,253,0,253
,VN,1994.0,138,0,138
,CR,2007.0,249,0,249
LT,,2017.0,671,0,671
,FR,2017.0,10944,0,10944
TR,,2003.0,331,0,331
NC,,2017.0,19,0,19
MA,,2015.0,468,0,468
AT,,2000.0,401,0,401
,ZM,2014.0,135,0,135
LT,,2019.0,739,0,739
GH,,2016.0,88,0,88
,HK,2004.0,35,0,35
,IR,2019.0,4368,0,4368
CZ,EG,2002.0,3,0,3
,CY,2008.0,123,0,123
CU,,1999.0,18,0,18
,UZ,1999.0,154,0,154
DZ,AT,2010.0,1,0,1
,ZW,2008.0,93,0,93
DZ,OM,1999.0,2,0,2
,PE,2001.0,216,0,216
VE,,2009.0,209,0,209
,TJ,2004.0,23,0,23
AZ,,2008.0,30,0,30
,TN,1995.0,250,0,250
HR,,2008.0,131,0,131
,EE,2006.0,308,0,308
ZM,,2023.0,405,0,405
MT,,2021.0,117,0,117
YE,,2020.0,50,0,50
,RW,2003.0,10,0,10
,MU,2012.0,43,0,43
GB,JE,2020.0,3,0,3
,NP,1994.0,38,0,38
SV,ES,2001.0,3,0,3
HK,ES,2006.0,1,0,1
LU,,2009.0,26,0,26
,SY,1995.0,51,0,51
MD,,2024.0,382,0,382
,LK,2018.0,516,0,516
AE,SA,1997.0,1,0,1
BA,PA,2013.0,1,0,1
SD,,2003.0,5,0,5
NC,,2019.0,21,0,21
DZ,CA,2008.0,6,0,6
UY,IN,2019.0,1,0,1
CZ,ET,2021.0,10,0,10
,GR,2020.0,145,0,145
VN,MY,2009.0,1,0,1
nan,,2000.0,105,0,105
LT,,2010.0,158,0,158
,PF,2013.0,17,0,17
,AE,2000.0,77,0,77
CZ,NZ,2016.0,3,0,3
IT,VN,2014.0,4,0,4
,CD,1998.0,8,0,8
IN,YE,2015.0,4,0,4
DK,SI,2006.0,2,0,2
NG,ZW,2012.0,1,0,1
TN,SA,2000.0,4,0,4
,FO,2016.0,7,0,7
IT,BF,2013.0,1,0,1
BW,,2002.0,8,0,8
ET,GH,2019.0,3,0,3
PL,CO,2016.0,1,0,1
ZA,SZ,2017.0,5,0,5
PH,IL,2005.0,1,0,1
PH,ST,2013.0,1,0,1
NG,AL,2015.0,2,0,2
SL,,2024.0,78,0,78
ZA,CR,2003.0,1,0,1
FR,NA,2022.0,1,0,1
GH,AE,2017.0,1,0,1
NE,KE,2009.0,1,0,1
,PY,2011.0,24,0,24
HT,,2007.0,1,0,1
,HK,1996.0,17,0,17
,GD,2016.0,25,0,25
PK,TW,2011.0,1,0,1
,IS,1999.0,99,0,99
SA,SD,2006.0,3,0,3
GR,SR,2020.0,1,0,1
BE,PE,2003.0,1,0,1
CD,,2013.0,13,0,13
IS,FO,2019.0,1,0,1
BJ,CG,2015.0,2,0,2
UA,MX,2000.0,13,0,13
SA,CL,2007.0,1,0,1
,PG,2012.0,28,0,28
SV,NI,2018.0,2,0,2
nan,GH,2013.0,4,0,4
HR,FI,2015.0,1,0,1
KZ,KG,2007.0,2,0,2
MN,PL,2012.0,4,0,4
BW,,2005.0,5,0,5
VE,CN,2009.0,2,0,2
PF,,2000.0,3,0,3
IS,HU,2018.0,1,0,1
,GF,2003.0,7,0,7
SG,KE,2023.0,1,0,1
,KH,2008.0,26,0,26
PH,EC,2019.0,3,0,3
CO,AU,1997.0,1,0,1
nan,ZA,2013.0,12,0,12
GE,AU,2005.0,2,0,2
GR,SN,2012.0,1,0,1
SA,TW,2010.0,1,0,1
BF,BE,2006.0,1,0,1
CG,,2004.0,2,0,2
GB,CD,2018.0,2,0,2
BH,SE,2001.0,1,0,1
ML,BE,2007.0,1,0,1
BR,KE,2006.0,2,0,2
YE,ID,2014.0,1,0,1
ZA,PH,2008.0,3,0,3
NZ,LK,2008.0,2,0,2
,MQ,2001.0,5,0,5
CN,LV,2002.0,1,0,1
CA,KE,1998.0,2,0,2
nan,GT,2000.0,1,0,1
DZ,ID,2017.0,5,0,5
LV,,1999.0,21,0,21
PK,SS,2019.0,1,0,1
PK,SD,2009.0,3,0,3
BJ,PF,2001.0,2,0,2
TW,BD,2020.0,5,0,5
CN,TJ,2015.0,1,0,1
PK,QA,2006.0,2,0,2
RE,DE,2017.0,2,0,2
FI,CL,2000.0,1,0,1
GR,KE,2008.0,1,0,1
HK,DE,2012.0,1,0,1
EC,PK,2019.0,1,0,1
BE,EC,2000.0,2,0,2
SO,,2019.0,4,0,4
ZA,HK,2002.0,1,0,1
HK,ZA,2006.0,2,0,2
NL,ET,1998.0,1,0,1
SA,ZW,2022.0,1,0,1
RE,GB,2005.0,2,0,2
GB,LS,2014.0,1,0,1
BE,UY,2018.0,2,0,2
KR,MX,2021.0,3,0,3
SI,FI,2020.0,3,0,3
BA,BE,2010.0,1,0,1
CH,LI,2019.0,3,0,3
IT,SM,2007.0,1,0,1
AR,LU,2020.0,1,0,1
PA,CH,2015.0,1,0,1
ID,FI,2007.0,1,0,1
PE,PA,2008.0,1,0,1
MD,nan,2000.0,1,0,1
IQ,TZ,2018.0,2,0,2
BD,BE,2023.0,1,0,1
QA,BA,2017.0,1,0,1
PT,MY,2016.0,4,0,4
QA,BA,2010.0,1,0,1
NI,CR,2021.0,1,0,1
ES,HU,1999.0,2,0,2
JM,,1999.0,8,0,8
BE,NA,2016.0,1,0,1
SG,EC,2016.0,1,0,1
HR,CA,2012.0,4,0,4
FR,TZ,2014.0,1,0,1
GE,AT,2002.0,1,0,1
BH,CA,2022.0,2,0,2
PS,TW,2007.0,1,0,1
ST,,2015.0,4,0,4
SG,CY,2007.0,1,0,1
,WS,2003.0,1,0,1
,MC,2006.0,5,0,5
PT,ZW,2021.0,1,0,1
PS,KW,2020.0,2,0,2
AL,IN,2020.0,2,0,2
BO,AU,2019.0,1,0,1
NO,MZ,2021.0,1,0,1
,GL,2005.0,2,0,2
MX,NO,2000.0,1,0,1
RW,CH,2022.0,2,0,2
CA,TN,2000.0,1,0,1
IR,NO,2008.0,4,0,4
SJ,IN,2017.0,1,0,1
HR,TW,2009.0,1,0,1
PF,ES,2007.0,1,0,1
NC,,2010.0,5,0,5
VG,TW,2016.0,1,0,1
JO,KR,2018.0,1,0,1
RW,,2018.0,28,0,28
,CF,2000.0,5,0,5
BF,CH,2007.0,1,0,1
nan,PA,2019.0,2,0,2
JP,AE,2003.0,2,0,2
ID,MY,1999.0,2,0,2
NI,BO,2007.0,1,0,1
ES,AL,2019.0,2,0,2
SI,IR,2006.0,2,0,2
AM,AU,2006.0,3,0,3
BY,FR,2011.0,4,0,4
GP,CG,2013.0,1,0,1
BW,SZ,2006.0,1,0,1
SG,GR,2004.0,4,0,4
IL,PS,2000.0,1,0,1
FR,AL,2003.0,1,0,1
BW,MW,2009.0,1,0,1
IT,JO,1997.0,1,0,1
AG,BR,2012.0,3,0,3
PL,SO,2011.0,1,0,1
GA,DE,1997.0,2,0,2
UZ,OM,2016.0,1,0,1
CL,QA,2016.0,1,0,1
EG,PL,2009.0,4,0,4
BG,PL,2005.0,1,0,1
JP,MM,1998.0,1,0,1
CL,DO,2018.0,3,0,3
GB,SX,2017.0,1,0,1
SE,KR,1997.0,1,0,1
MT,PL,2015.0,2,0,2
TR,NG,2012.0,3,0,3
UG,CN,2014.0,3,0,3
LB,JO,2011.0,1,0,1
EG,SO,2022.0,2,0,2
NP,GW,2017.0,1,0,1
MX,BA,2018.0,2,0,2
KW,NL,2020.0,1,0,1
UY,SE,2006.0,2,0,2
BR,GE,2020.0,3,0,3
NI,IT,2007.0,1,0,1
KN,US,2022.0,4,0,4
LB,SE,2004.0,1,0,1
ET,NG,2013.0,2,0,2
,CD,1997.0,7,0,7
PH,KZ,2018.0,1,0,1
FR,EE,2001.0,2,0,2
DO,,2000.0,4,0,4
IT,MD,1997.0,2,0,2
LT,CN,2022.0,4,0,4
NA,,2003.0,4,0,4
CU,IN,2007.0,1,0,1
SL,NG,2019.0,2,0,2
AU,DZ,2000.0,1,0,1
BE,CY,1998.0,1,0,1
IT,BA,2005.0,1,0,1
JP,SY,1999.0,1,0,1
SK,SE,2023.0,1,0,1
GT,CH,2016.0,2,0,2
BE,KZ,2015.0,1,0,1
ET,LS,2006.0,1,0,1
MY,NO,2011.0,3,0,3
,GL,2002.0,8,0,8
AF,,2018.0,4,0,4
AZ,CN,1997.0,1,0,1
SO,,2017.0,5,0,5
BW,AU,2023.0,1,0,1
LU,ML,2020.0,4,0,4
IN,HK,2012.0,1,0,1
VE,EC,2010.0,3,0,3
AE,IT,2005.0,1,0,1
JP,MA,2012.0,2,0,2
PK,LT,2011.0,6,0,6
MO,,2013.0,1,0,1
LT,AT,2004.0,1,0,1
AR,AE,2016.0,2,0,2
CA,GN,2008.0,1,0,1
AU,JO,2004.0,3,0,3
CN,KZ,2002.0,6,0,6
GR,ME,2002.0,1,0,1
JP,MT,2015.0,1,0,1
TJ,UG,2016.0,1,0,1
nan,ET,2015.0,3,0,3
GB,HN,2014.0,2,0,2
GW,BR,2002.0,1,0,1
DZ,AU,2010.0,2,0,2
DE,BB,2002.0,1,0,1
ZA,KN,2013.0,2,0,2
RO,CZ,2004.0,7,0,7
NZ,FJ,2022.0,1,0,1
BG,PL,2002.0,4,0,4
FJ,,2012.0,12,0,12
AL,NO,2018.0,2,0,2
MA,AR,2017.0,3,0,3
SY,TN,2002.0,1,0,1
MY,LK,2007.0,1,0,1
LU,KR,2013.0,2,0,2
ES,HR,2000.0,2,0,2
VN,MW,2020.0,1,0,1
,MR,2018.0,5,0,5
HU,PK,2004.0,1,0,1
AT,SA,2008.0,2,0,2
AE,LK,2008.0,1,0,1
IE,BA,2012.0,1,0,1
PT,TH,2019.0,1,0,1
GE,ES,2006.0,1,0,1
PA,CU,2009.0,3,0,3
GB,SX,2019.0,1,0,1
NL,SX,2006.0,1,0,1
,TJ,1996.0,9,0,9
KE,KH,2016.0,2,0,2
BR,MH,2019.0,1,0,1
,AD,2004.0,1,0,1
SE,TH,2000.0,3,0,3
NP,PL,2014.0,1,0,1
PK,UZ,2017.0,1,0,1
AU,,2026.0,1,0,1
SI,GR,2004.0,1,0,1
DZ,AU,2019.0,4,0,4
TW,MA,2010.0,1,0,1
ZM,CN,2021.0,3,0,3
RW,CD,2023.0,1,0,1
CD,ID,2021.0,2,0,2
CD,BN,2015.0,1,0,1
KI,,2019.0,1,0,1
HU,BG,2013.0,2,0,2
SG,AE,2008.0,4,0,4
nan,UG,2021.0,2,0,2
AU,CY,2007.0,2,0,2
IL,FI,2000.0,2,0,2
NL,DZ,2005.0,2,0,2
PG,,2025.0,3,0,3
SI,IE,2003.0,1,0,1
nan,PY,2016.0,1,0,1
MY,CH,2003.0,1,0,1
SK,SI,2000.0,1,0,1
BE,KR,1999.0,2,0,2
QA,SG,2003.0,1,0,1
OM,MA,2013.0,2,0,2
FJ,IE,2017.0,1,0,1
ES,VN,2012.0,1,0,1
BY,LT,2012.0,1,0,1
TT,AE,2022.0,1,0,1
AZ,US,1997.0,1,0,1
VN,PK,1999.0,1,0,1
FR,PA,2001.0,2,0,2
PL,MM,2005.0,1,0,1
TD,,2022.0,5,0,5
GE,CZ,2007.0,2,0,2
ME,LU,2018.0,1,0,1
DK,KW,2007.0,1,0,1
AE,MX,2020.0,1,0,1
BY,BR,2006.0,2,0,2
ES,UA,1997.0,2,0,2
PH,DK,2022.0,1,0,1
CA,CI,2000.0,1,0,1
MS,GB,1998.0,7,0,7
KW,LY,2012.0,1,0,1
RW,JP,2015.0,1,0,1
NP,BE,2017.0,1,0,1
MA,GA,2013.0,1,0,1
SI,MK,2000.0,1,0,1
TH,ZA,2023.0,1,0,1
SN,NG,2018.0,3,0,3
FI,OM,2020.0,1,0,1
PA,AU,2021.0,3,0,3
,KP,2011.0,5,0,5
AR,ID,2015.0,1,0,1
RS,QA,2011.0,2,0,2
IN,AL,2012.0,2,0,2
IN,ML,2005.0,7,0,7
TJ,NG,2011.0,1,0,1
,DJ,2019.0,2,0,2
SG,CR,2007.0,1,0,1
MD,KZ,2007.0,1,0,1
NP,CA,2000.0,1,0,1
PH,NP,2022.0,1,0,1
AL,DE,2007.0,1,0,1
LY,ET,2016.0,1,0,1
HR,ZA,2018.0,1,0,1
IT,CY,2000.0,1,0,1
IS,CZ,2018.0,1,0,1
KE,IE,2006.0,1,0,1
BG,LT,2013.0,1,0,1
SC,US,1999.0,1,0,1
VE,PA,2021.0,1,0,1
BI,IN,2011.0,1,0,1
IR,SK,2011.0,2,0,2
KW,ID,2010.0,1,0,1
IN,SL,2017.0,1,0,1
PH,RU,2001.0,1,0,1
VE,GT,2007.0,1,0,1
NZ,PL,2013.0,1,0,1
LK,ZA,2002.0,1,0,1
GN,CN,2010.0,1,0,1
PS,nan,2020.0,1,0,1
JP,DZ,2011.0,2,0,2
LY,NL,2017.0,1,0,1
HT,NE,2019.0,1,0,1
CO,CZ,2004.0,1,0,1
EE,IQ,2020.0,1,0,1
LU,SE,2010.0,2,0,2
NG,CL,2012.0,1,0,1
BM,DE,2006.0,1,0,1
VE,ID,2022.0,1,0,1
TW,MA,2019.0,4,0,4
FI,ZA,2004.0,1,0,1
IR,PS,2017.0,1,0,1
RS,DK,2021.0,4,0,4
IL,CY,2014.0,1,0,1
FI,MA,2019.0,1,0,1
FJ,KZ,2012.0,1,0,1
NG,RO,2014.0,1,0,1
GM,,2003.0,2,0,2
LV,NL,2022.0,1,0,1
RU,SA,2023.0,1,0,1
KZ,,1999.0,5,0,5
NO,HK,2012.0,1,0,1
AZ,PL,2010.0,3,0,3
,SR,2001.0,1,0,1
MT,BR,2013.0,2,0,2
KR,BB,2019.0,1,0,1
SY,UG,2012.0,1,0,1
GT,CA,2022.0,2,0,2
IL,GE,2013.0,1,0,1
NZ,MC,2020.0,1,0,1
IE,LY,2006.0,1,0,1
BR,BJ,2005.0,1,0,1
SY,MY,2006.0,1,0,1
,MV,2003.0,2,0,2
MA,CF,2019.0,2,0,2
PG,TN,2007.0,1,0,1
AT,LT,2003.0,1,0,1
EG,GR,2023.0,1,0,1
GB,BH,1999.0,3,0,3
GB,SJ,2007.0,1,0,1
TH,CM,2008.0,1,0,1
NO,QA,2016.0,2,0,2
NC,US,2007.0,1,0,1
DE,SJ,2021.0,1,0,1
PT,TH,2010.0,1,0,1
PY,IL,2008.0,2,0,2
TH,MD,2014.0,1,0,1
BY,SG,2006.0,1,0,1
JP,MM,1997.0,1,0,1
RE,GP,2020.0,1,0,1
KE,DZ,2011.0,1,0,1
EG,MM,2020.0,1,0,1
MD,AR,2011.0,1,0,1
CA,SM,2018.0,1,0,1
BY,IN,2007.0,3,0,3
BS,GB,2022.0,2,0,2
BD,SY,1999.0,1,0,1
RS,MG,2020.0,1,0,1
JE,GB,2008.0,1,0,1
NO,CD,2020.0,1,0,1
NZ,AZ,2004.0,1,0,1
ET,ML,2019.0,1,0,1
GR,OM,2015.0,2,0,2
TN,CI,2005.0,1,0,1
BH,TZ,2009.0,3,0,3
NL,SS,2013.0,1,0,1
AL,GE,2002.0,1,0,1
GR,CL,2015.0,1,0,1
BR,GT,2013.0,1,0,1
SY,nan,1999.0,1,0,1
SV,CO,2002.0,1,0,1
KW,PL,2008.0,1,0,1
UA,AT,2023.0,2,0,2
BA,JP,2010.0,1,0,1
JP,ST,2010.0,1,0,1
TR,IS,2017.0,2,0,2
GB,ST,2006.0,1,0,1
IT,LT,2012.0,1,0,1
BI,,1998.0,1,0,1
MZ,DE,2002.0,1,0,1
SK,NZ,2016.0,1,0,1
MU,FR,2015.0,1,0,1
DZ,SK,2010.0,1,0,1
RO,IE,2003.0,1,0,1
IL,HK,2021.0,1,0,1
KW,ID,2017.0,2,0,2
NL,GE,2004.0,1,0,1
GW,US,2018.0,1,0,1
PT,HU,2002.0,1,0,1
BF,ML,2005.0,2,0,2
BF,AU,1998.0,1,0,1
TW,BR,1999.0,1,0,1
CH,SA,1999.0,1,0,1
CG,CA,2008.0,1,0,1
FR,BW,2007.0,1,0,1
CM,NO,2013.0,2,0,2
FI,AE,2010.0,1,0,1
FI,EG,2007.0,1,0,1
BI,SE,2009.0,1,0,1
BR,BG,2000.0,1,0,1
SK,IL,1998.0,1,0,1
nan,SG,1997.0,1,0,1
IT,BJ,2009.0,1,0,1
ZA,GF,2014.0,1,0,1
BG,CH,2023.0,1,0,1
GB,HT,2020.0,1,0,1
GP,SE,2012.0,1,0,1
PA,UY,2015.0,1,0,1
VG,SG,2012.0,1,0,1
KR,BF,2006.0,1,0,1
DZ,IQ,2015.0,1,0,1
TW,AE,2014.0,1,0,1
GT,ID,2020.0,1,0,1
CA,GA,2013.0,1,0,1
IL,HR,2006.0,1,0,1
AU,PE,2010.0,2,0,2
PL,OM,2001.0,1,0,1
SD,KE,2009.0,1,0,1
ES,AM,2012.0,1,0,1
JM,CA,2001.0,1,0,1
RS,MK,2007.0,1,0,1
SI,BG,2012.0,1,0,1
SA,AT,2002.0,1,0,1
NZ,AT,2001.0,1,0,1
SS,IT,2003.0,1,0,1
NL,MK,2006.0,1,0,1
ZW,NO,2018.0,1,0,1
ZM,KE,2013.0,1,0,1
BG,TW,2011.0,1,0,1
BZ,MX,2015.0,1,0,1
HU,QA,2017.0,1,2,-1
DZ,EG,2008.0,1,5,-4
UA,EE,2022.0,1,1,0
RO,BR,2009.0,1,5,-4
PL,BG,2008.0,2,4,-2
US,PR,2007.0,5,4,1
ME,HR,2018.0,3,4,-1
BE,PK,2016.0,1,2,-1
SG,PT,2003.0,1,1,0
PE,SV,2020.0,1,3,-2
GH,SE,2017.0,1,3,-2
VE,NL,2007.0,1,2,-1
PE,CH,2019.0,2,5,-3
GB,SI,1999.0,2,6,-4
nan,GE,2021.0,2,2,0
nan,GR,2007.0,2,1,1
NL,MM,2019.0,1,1,0
KH,TH,2008.0,1,1,0
IN,ZW,2016.0,1,1,0
TZ,CA,2016.0,3,2,1
ZM,BE,2016.0,1,2,-1
FR,CU,2012.0,1,7,-6
NG,UG,2013.0,1,2,-1
HU,AE,2014.0,1,1,0
FR,PS,2018.0,3,1,2
SI,IL,2005.0,1,1,0
FR,PF,1998.0,1,5,-4
RU,RO,2015.0,1,3,-2
NG,PE,2017.0,2,1,1
CO,BE,2009.0,1,3,-2
SA,NZ,2022.0,1,2,-1
CR,PA,2022.0,1,2,-1
CU,RU,2016.0,1,3,-2
DE,BJ,2020.0,1,1,0
PE,CH,2017.0,3,4,-1
UG,KE,2002.0,1,1,0
CN,BY,2018.0,1,1,0
IR,PS,2019.0,1,1,0
RO,SA,2016.0,1,1,0
BE,MD,2018.0,1,1,0
LV,DE,2022.0,1,4,-3
IN,EC,2016.0,1,2,-1
AT,BG,2004.0,1,1,0
JP,SD,2003.0,2,1,1
VN,MZ,2016.0,1,1,0
BD,CH,2008.0,1,2,-1
PH,IL,2002.0,1,2,-1
CH,KH,1999.0,1,1,0
CM,FR,2023.0,1,1,0
OM,IE,2018.0,3,4,-1
EE,NL,2022.0,1,1,0
DK,SD,1997.0,1,1,0
SA,AU,1998.0,1,4,-3
VE,GB,1999.0,3,9,-6
EC,GT,2017.0,1,4,-3
IL,MY,2013.0,2,1,1
PR,ES,2018.0,1,1,0
AT,MT,2020.0,1,1,0
IL,AM,2020.0,1,1,0
DE,EC,2008.0,3,2,1
AE,DK,2022.0,2,1,1
CU,AU,2004.0,1,1,0
EE,UA,2016.0,1,1,0
SK,BY,2005.0,3,3,0
TW,UA,2008.0,1,3,-2
MZ,ZA,2014.0,2,2,0
GE,NO,2019.0,1,1,0
BH,MY,2022.0,2,2,0
DE,NZ,2023.0,1,1,0
BA,JP,2019.0,1,1,0
LU,PT,2014.0,2,3,-1
LU,SE,2017.0,1,2,-1
GL,NO,2021.0,1,1,0
TH,LA,2013.0,1,2,-1
RW,TR,2012.0,2,1,1
BD,OM,2010.0,2,1,1
PE,IT,2012.0,2,12,-10
CN,BI,2020.0,1,1,0
HK,KR,2020.0,1,1,0
CZ,EG,2005.0,1,2,-1
ML,KE,2017.0,2,3,-1
HR,DK,2007.0,1,2,-1
DK,CO,2004.0,1,1,0
FI,LT,2007.0,1,3,-2
CH,TR,1997.0,2,3,-1
ZA,PT,2007.0,1,1,0
EC,VE,2007.0,1,1,0
MK,PL,2013.0,1,1,0
LT,PL,2019.0,2,6,-4
KW,BD,2021.0,1,2,-1
NO,ZA,2006.0,1,3,-2
RS,ME,2004.0,2,1,1
PE,PY,2022.0,1,1,0
CV,PT,2013.0,2,2,0
AM,CZ,2012.0,1,1,0
MZ,PT,2004.0,1,1,0
IT,PH,2012.0,2,2,0
IN,PG,2019.0,1,2,-1
NC,CG,2020.0,1,3,-2
DE,AZ,2012.0,1,2,-1
IE,TH,2018.0,2,5,-3
CO,NZ,1999.0,1,1,0
ZA,MY,2009.0,1,1,0
AR,NI,2014.0,1,1,0
IE,IL,2010.0,1,1,0
nan,TH,2018.0,1,2,-1
DE,AL,2015.0,1,1,0
AR,NZ,2018.0,1,2,-1
ML,KE,2010.0,1,1,0
GH,ID,2013.0,1,2,-1
UY,VE,2010.0,1,4,-3
UY,MX,2003.0,1,3,-2
CN,UG,2012.0,1,2,-1
CR,IT,2012.0,1,3,-2
AU,KW,2010.0,1,3,-2
AZ,US,1998.0,1,1,0
MX,KR,2012.0,2,7,-5
VE,FI,2003.0,1,1,0
GR,ZA,2008.0,2,3,-1
SI,AU,2007.0,2,1,1
HK,nan,2012.0,1,1,0
IQ,FR,2013.0,1,2,-1
KZ,NO,2017.0,1,1,0
IL,BG,2013.0,1,1,0
SA,DK,2016.0,1,1,0
BB,CA,2014.0,1,1,0
IL,VE,2004.0,1,1,0
BO,AR,2015.0,1,2,-1
FR,OM,2013.0,2,1,1
UA,BE,2004.0,1,3,-2
EG,RU,2007.0,1,3,-2
MA,BR,2020.0,1,1,0
CG,NG,2022.0,1,2,-1
BG,TR,2004.0,1,1,0
GR,SG,2006.0,1,1,0
UY,VE,2019.0,1,5,-4
ZA,IT,1999.0,1,4,-3
PK,AR,2002.0,1,3,-2
TD,FR,2016.0,1,2,-1
ET,CH,2022.0,1,2,-1
DK,KE,2007.0,1,3,-2
FR,AT,2023.0,1,2,-1
PE,CH,2010.0,1,3,-2
UA,EG,2017.0,1,1,0
NL,LB,2020.0,1,2,-1
UZ,CZ,2021.0,1,2,-1
JO,LB,2017.0,1,1,0
RO,ES,1999.0,1,1,0
TW,PH,2023.0,1,1,0
KE,NO,2005.0,1,2,-1
GR,IN,2001.0,1,5,-4
AU,ML,2014.0,1,1,0
CG,SY,2016.0,1,1,0
MK,BG,2009.0,1,3,-2
IL,IN,2023.0,2,3,-1
LU,CN,2019.0,2,4,-2
PR,PK,2021.0,1,1,0
VG,nan,2011.0,1,2,-1
TZ,NL,1998.0,1,5,-4
PK,ER,2009.0,1,1,0
BB,GB,2013.0,3,2,1
GH,SE,2010.0,1,2,-1
HR,TR,2021.0,1,2,-1
OM,FR,2001.0,1,2,-1
HK,SG,2008.0,1,1,0
PL,MX,2018.0,3,5,-2
NL,PH,1999.0,1,1,0
SE,JO,2008.0,1,2,-1
PL,BD,2014.0,1,5,-4
UG,NO,2020.0,1,2,-1
JP,RO,2022.0,1,1,0
CU,AT,2016.0,1,1,0
US,AF,2013.0,1,2,-1
NA,MX,2007.0,1,0,1
IL,MX,2004.0,1,0,1
NL,MM,2017.0,1,0,1
EC,NO,2016.0,1,0,1
KW,KE,2018.0,1,0,1
MY,TL,2022.0,1,0,1
IS,IQ,2018.0,2,0,2
,BH,2020.0,8,0,8
PS,EG,2009.0,4,0,4
NG,ES,1999.0,1,0,1
NP,IT,2012.0,1,0,1
PR,nan,2021.0,2,0,2
AU,GE,2018.0,3,0,3
SG,RU,2000.0,1,0,1
BB,,1998.0,2,0,2
ZA,AE,2009.0,2,0,2
EC,SG,2011.0,1,0,1
,SJ,1996.0,3,0,3
BR,UG,2013.0,1,0,1
CL,AE,2010.0,1,0,1
HU,KZ,2013.0,1,0,1
PK,PT,2016.0,1,0,1
CA,BD,1999.0,2,0,2
PY,GT,2013.0,1,0,1
EG,NZ,2021.0,1,0,1
ZW,UG,2020.0,1,0,1
BG,ET,2019.0,1,0,1
AT,ET,2013.0,2,0,2
LB,CY,2022.0,1,0,1
,DJ,2010.0,2,0,2
TZ,NL,1997.0,2,0,2
GP,US,2015.0,2,0,2
SG,CL,2005.0,1,0,1
ES,TW,2008.0,4,0,4
AR,JO,2018.0,1,0,1
VG,IN,2018.0,1,0,1
TZ,MY,2021.0,1,0,1
PH,MZ,2020.0,1,0,1
VN,CH,2013.0,1,0,1
SZ,BW,2002.0,1,0,1
AU,BG,1997.0,1,0,1
CL,BW,2011.0,1,0,1
CA,HK,2008.0,2,0,2
CA,CD,2014.0,1,0,1
KR,NO,2005.0,2,0,2
nan,BG,2006.0,1,0,1
BA,SA,2017.0,1,0,1
BY,HU,2001.0,2,0,2
MA,CH,1997.0,1,0,1
NG,AT,2022.0,1,0,1
IR,YE,2018.0,1,0,1
NO,SK,1999.0,1,0,1
UZ,IL,2003.0,1,0,1
MY,KE,2022.0,1,0,1
NG,KW,1998.0,2,0,2
CH,SY,2011.0,1,0,1
BN,,1998.0,1,0,1
CL,IE,2005.0,2,0,2
PH,PE,2010.0,1,0,1
NO,CL,2023.0,1,0,1
UA,UZ,2004.0,2,0,2
FR,BN,2009.0,1,0,1
,SJ,2004.0,2,0,2
DJ,EG,2021.0,1,0,1
CO,HU,2013.0,2,0,2
,BS,2016.0,2,0,2
BJ,DK,2013.0,1,0,1
NG,LR,2014.0,1,0,1
TG,,2007.0,2,0,2
MM,,1999.0,1,0,1
CH,SZ,2016.0,1,0,1
MU,TH,2019.0,1,0,1
JP,BI,2008.0,1,0,1
PE,UY,2004.0,2,0,2
GA,KE,2016.0,1,0,1
NG,AU,2004.0,1,0,1
IN,SY,2006.0,1,0,1
SN,IQ,2022.0,1,0,1
CA,NC,2016.0,1,0,1
ID,IR,2006.0,1,0,1
PT,PS,2020.0,1,0,1
BF,SN,2003.0,1,0,1
MU,ZA,2008.0,1,0,1
BH,TR,2019.0,1,0,1
XK,FR,2009.0,1,0,1
SG,CO,2006.0,1,0,1
PS,YE,2012.0,1,0,1
BG,KZ,2012.0,1,0,1
GM,GH,2013.0,1,0,1
AE,UA,2014.0,1,0,1
IN,LK,1997.0,1,0,1
US,GP,2009.0,1,0,1
GE,NZ,2013.0,1,0,1
BI,BE,1999.0,1,0,1
PA,CL,2001.0,1,0,1
GM,TN,2021.0,1,0,1
BR,BF,2022.0,1,0,1
JP,CI,2011.0,1,0,1
FR,FJ,2022.0,1,0,1
CL,HR,2007.0,1,0,1
MA,PE,2012.0,1,0,1
BE,NG,2015.0,2,0,2
IN,PG,2010.0,1,0,1
CL,LU,2018.0,1,0,1
AR,OM,2017.0,1,0,1
PA,NL,2018.0,1,0,1
BI,EC,2018.0,1,0,1
ET,AT,2009.0,1,0,1
SK,SD,2016.0,1,0,1
ZM,TZ,2007.0,1,0,1
GR,PS,2015.0,1,0,1
VE,PH,2016.0,1,0,1
JP,PR,2018.0,1,0,1
OM,DE,1999.0,1,0,1
LU,IN,2001.0,1,0,1
PT,HU,2005.0,1,0,1
ZM,nan,2003.0,1,0,1
HU,DK,2001.0,1,0,1
ZA,TG,2013.0,1,0,1
RO,FR,2023.0,1,0,1
IE,FJ,2018.0,1,0,1
BM,,2016.0,1,0,1
PE,HR,2021.0,1,0,1
LY,CA,2009.0,1,0,1
CA,TG,2001.0,1,0,1
RU,TJ,1997.0,2,0,2
RS,HU,2001.0,1,0,1
CL,UA,2007.0,1,0,1
JO,MY,2004.0,1,0,1
CZ,SN,2015.0,1,0,1
MG,GB,2017.0,2,0,2
DZ,ES,2003.0,1,0,1
KW,HR,2015.0,1,0,1
nan,VE,2022.0,1,0,1
AW,ES,2018.0,1,0,1
MS,US,1998.0,2,0,2
DZ,IE,2018.0,1,0,1
CM,SN,2012.0,1,0,1
CW,SD,2021.0,1,0,1
CL,SN,2021.0,1,0,1
GF,CF,2020.0,1,0,1
LT,IE,2015.0,1,0,1
NG,SG,2006.0,1,0,1
EE,CN,2012.0,1,0,1
SD,CA,2002.0,1,0,1
AU,OM,1998.0,1,0,1
NL,BG,2005.0,1,0,1
NG,MA,2011.0,1,0,1
TN,AT,2016.0,1,0,1
IL,MT,2013.0,1,0,1
TR,AR,2016.0,1,0,1
IL,CO,2006.0,2,0,2
TZ,TH,2016.0,1,0,1
NE,DE,2014.0,1,0,1
NO,LB,2023.0,1,0,1
CG,ET,2016.0,1,0,1
BG,KW,2007.0,1,0,1
PA,TR,2017.0,1,0,1
MY,TH,2004.0,1,0,1
IR,GE,2021.0,1,0,1
LB,SA,2004.0,1,0,1
FI,CR,2004.0,1,0,1
GH,RU,2015.0,2,0,2
AT,AM,2022.0,1,0,1
ID,SA,2003.0,1,0,1
AU,BH,2021.0,1,0,1
IR,CL,2022.0,1,0,1
BE,QA,2009.0,1,0,1
HN,PY,2016.0,1,0,1
DZ,AT,2019.0,1,0,1
ZA,LB,2016.0,1,0,1
PH,AE,2017.0,2,0,2
GP,BE,2019.0,1,0,1
ZA,SL,2019.0,1,0,1
CH,CD,2011.0,1,0,1
KE,CG,2022.0,1,0,1
GR,AZ,2018.0,1,0,1
NO,ID,2004.0,1,0,1
BO,AU,2010.0,1,0,1
IR,AR,2022.0,1,0,1
CN,SV,2018.0,1,0,1
RS,DZ,2022.0,1,0,1
WS,CY,2015.0,1,0,1
TW,BT,2018.0,1,0,1
IN,SL,2019.0,1,0,1
NL,BD,2010.0,3,0,3
UG,FI,2013.0,1,0,1
FJ,SE,2003.0,1,0,1
AL,DK,2019.0,1,0,1
ZA,NO,1999.0,1,0,1
PK,HR,2019.0,1,0,1
TR,BD,2011.0,1,0,1
IN,CF,2010.0,1,0,1
SK,PH,2015.0,1,0,1
LU,AU,1999.0,1,0,1
ZA,VE,2017.0,1,0,1
TN,CH,1999.0,1,0,1
CG,NA,2012.0,1,0,1
NE,CG,2009.0,1,0,1
AL,TR,2017.0,1,0,1
ST,IL,2013.0,1,0,1
KG,AU,2015.0,1,0,1
CU,HN,2015.0,1,0,1
JP,UY,2009.0,1,0,1
TG,ID,2021.0,1,0,1
CO,MT,2020.0,1,0,1
SY,AU,1999.0,1,0,1
SY,IN,2021.0,1,0,1
LT,KR,2009.0,1,0,1
RE,AR,2007.0,1,0,1
BE,TH,2004.0,1,0,1
LA,US,2008.0,1,0,1
OM,KW,2015.0,1,0,1
GR,BW,2011.0,1,0,1
BY,UZ,2002.0,1,0,1
,GA,2020.0,1,0,1
EC,BY,2008.0,1,0,1
UA,EG,2010.0,1,0,1
AR,HN,1997.0,1,0,1
,AM,2020.0,4,0,4
ES,RE,2017.0,1,0,1
NO,UZ,2021.0,1,0,1
FJ,PH,2020.0,1,0,1
TN,CF,2020.0,1,0,1
DK,TH,2023.0,1,0,1
TR,TH,2022.0,1,0,1
CG,BJ,2004.0,1,0,1
KH,ES,2019.0,1,0,1
PL,NO,2018.0,13,17,-4
JP,US,2012.0,1627,1840,-213
NL,US,2017.0,851,767,84
DE,CH,2001.0,434,364,70
ES,US,2017.0,1076,932,144
GB,JP,2004.0,277,204,73
US,ES,2006.0,661,615,46
AR,ES,2013.0,341,336,5
AU,US,2017.0,2579,2567,12
US,DE,2008.0,2283,2083,200
ES,CO,2005.0,138,126,12
IN,SA,2012.0,99,23,76
DK,CZ,2022.0,3,3,0
AU,US,2010.0,1852,2165,-313
CA,AT,2020.0,23,22,1
NL,DE,2001.0,117,182,-65
NZ,CN,2003.0,17,12,5
NL,US,2010.0,628,685,-57
RO,IT,2010.0,10,22,-12
IN,US,1997.0,360,331,29
CL,AR,2003.0,27,20,7
AU,BR,2020.0,131,164,-33
GB,KR,2011.0,82,88,-6
US,KR,2013.0,1466,1227,239
DE,PL,2020.0,126,121,5
NO,FR,2015.0,59,56,3
IT,JP,1997.0,30,15,15
US,IL,2001.0,307,390,-83
UG,GB,2017.0,10,7,3
IT,PT,2004.0,15,17,-2
NL,US,2019.0,1002,884,118
CH,FR,2010.0,329,383,-54
EG,IQ,2011.0,7,4,3
JP,AT,2017.0,12,20,-8
AU,IE,2014.0,108,119,-11
PH,US,2015.0,454,348,106
IN,US,1998.0,469,433,36
SE,GB,2008.0,154,143,11
MX,ES,2003.0,293,294,-1
SG,US,2015.0,388,459,-71
SG,GB,2011.0,76,124,-48
CU,EC,2019.0,46,22,24
IT,DE,2017.0,392,274,118
HR,SK,2010.0,3,5,-2
DE,GB,2021.0,666,753,-87
AR,BR,2018.0,198,197,1
DE,JP,2010.0,181,200,-19
SE,US,1999.0,239,257,-18
CL,BR,2015.0,84,81,3
ES,AR,1999.0,72,88,-16
RO,IT,2017.0,19,23,-4
ES,US,2019.0,1190,1087,103
JP,DE,2021.0,151,131,20
FR,CL,2018.0,68,48,20
TH,AU,2019.0,18,39,-21
US,IE,2005.0,350,301,49
AU,SE,2019.0,69,53,16
SG,CN,2021.0,571,398,173
ES,US,2010.0,830,909,-79
SA,NG,2011.0,6,3,3
BR,PT,2004.0,254,281,-27
CA,FR,2003.0,261,333,-72
AU,US,2019.0,2583,2756,-173
ES,CU,2018.0,104,139,-35
DE,AT,2006.0,371,319,52
AU,FR,1997.0,26,32,-6
ES,GB,2013.0,459,311,148
CL,SE,2002.0,3,1,2
US,HK,2012.0,12,14,-2
VE,EC,2018.0,45,13,32
BR,GB,2020.0,310,249,61
FR,JP,2012.0,105,123,-18
MX,PE,2018.0,132,115,17
JP,GB,2016.0,311,279,32
US,ID,2019.0,438,222,216
CA,IN,2013.0,213,191,22
EG,US,2008.0,88,146,-58
PT,ES,2011.0,111,135,-24
CU,ES,2007.0,75,80,-5
GB,IE,1998.0,94,93,1
BD,JP,2018.0,77,72,5
ES,CO,2002.0,66,82,-16
US,IT,2015.0,986,1087,-101
MX,DE,2008.0,38,32,6
CN,GB,2007.0,328,461,-133
BR,AR,2009.0,104,130,-26
ES,CL,1999.0,47,43,4
MX,CO,2004.0,85,55,30
IR,DE,2022.0,86,55,31
BR,AE,2015.0,1,2,-1
EC,CL,2008.0,3,8,-5
nan,FI,2010.0,13,8,5
US,ID,2017.0,294,194,100
IT,FR,2020.0,423,382,41
GE,US,2018.0,208,150,58
JP,nan,1999.0,83,77,6
PL,DE,2006.0,100,96,4
CO,FR,2019.0,37,42,-5
US,VE,2016.0,30,53,-23
CN,KR,2007.0,171,234,-63
CL,NL,2013.0,11,8,3
GB,IL,2012.0,44,54,-10
RU,CA,2020.0,38,46,-8
US,AT,2006.0,171,203,-32
BD,US,2011.0,70,88,-18
IN,FR,2018.0,155,119,36
GB,TW,2000.0,28,22,6
IT,GB,2013.0,549,449,100
ES,DO,2019.0,12,4,8
GB,NZ,2010.0,258,215,43
IE,JP,2007.0,26,17,9
NZ,CA,2009.0,72,57,15
PA,CO,2018.0,27,22,5
GB,EG,2018.0,111,90,21
RU,CN,2010.0,58,52,6
FR,PS,2019.0,7,1,6
NO,IE,2015.0,5,9,-4
DE,JP,2017.0,216,185,31
BE,MD,2010.0,1,1,0
AU,NZ,2015.0,179,213,-34
US,IE,2002.0,233,209,24
nan,JP,2011.0,53,47,6
RU,CH,2012.0,38,14,24
MY,IT,1997.0,14,7,7
AU,IL,2017.0,22,24,-2
FR,RU,2003.0,32,54,-22
BE,CA,2015.0,75,74,1
CH,FR,2017.0,381,500,-119
CA,TH,2020.0,11,12,-1
SE,IT,2000.0,28,119,-91
IN,IE,2009.0,20,12,8
GB,GR,2003.0,127,68,59
JP,TW,2016.0,96,95,1
NL,BR,2020.0,61,79,-18
IR,FI,2012.0,7,6,1
CL,CU,2018.0,20,34,-14
US,PK,2006.0,81,70,11
SE,CH,1998.0,23,20,3
PE,ES,2020.0,148,186,-38
CA,IT,2013.0,68,106,-38
NL,IN,2008.0,25,33,-8
BR,MX,1999.0,17,20,-3
US,nan,1999.0,70,108,-38
CA,NO,2001.0,9,7,2
UG,ZA,2003.0,3,2,1
FR,TN,2018.0,233,201,32
MD,FR,2021.0,36,27,9
CH,FR,2019.0,387,550,-163
TN,DZ,2022.0,13,9,4
TR,RU,2014.0,4,3,1
GB,SK,2007.0,12,15,-3
GB,BD,2013.0,54,59,-5
FR,NZ,2019.0,33,29,4
IN,GH,2018.0,12,10,2
RU,ES,2018.0,21,25,-4
PT,GB,2015.0,136,99,37
AU,NL,2021.0,80,76,4
RU,CN,2019.0,59,72,-13
SE,DE,2014.0,205,253,-48
KZ,CN,2014.0,13,9,4
nan,IN,2007.0,23,23,0
CN,PK,2005.0,28,85,-57
DE,NO,2015.0,90,68,22
CM,ZA,2009.0,5,1,4
CN,VN,2003.0,20,63,-43
CN,SY,2018.0,15,17,-2
NO,CN,2011.0,33,35,-2
TW,FR,2003.0,29,23,6
IT,CN,2001.0,20,14,6
PK,IN,2016.0,277,262,15
IE,GB,2001.0,105,171,-66
CN,SD,2018.0,12,6,6
IN,NL,2018.0,56,63,-7
GH,GB,2008.0,9,7,2
TH,MM,2018.0,7,10,-3
US,CH,1997.0,297,306,-9
US,BE,1997.0,101,106,-5
CA,PL,2016.0,27,35,-8
JP,KE,2018.0,12,9,3
CU,MX,2001.0,14,15,-1
CH,US,2022.0,412,443,-31
NZ,DE,2016.0,49,40,9
BG,TR,2014.0,1,2,-1
RO,US,2009.0,51,67,-16
CR,CL,2016.0,25,26,-1
IT,DE,2010.0,270,166,104
BG,NO,2009.0,20,1,19
GB,NO,2006.0,54,39,15
FR,LU,2019.0,59,36,23
GH,US,2022.0,33,28,5
FI,NO,2017.0,31,15,16
FR,MY,2013.0,16,11,5
CN,HK,2006.0,26,12,14
NL,SG,2007.0,8,6,2
SG,NL,2022.0,7,8,-1
CA,MX,2015.0,41,52,-11
CN,SA,2015.0,35,26,9
PE,VE,2015.0,16,9,7
BR,FR,2020.0,216,228,-12
NO,NL,2007.0,15,24,-9
IR,AT,2016.0,14,11,3
PT,AU,2013.0,11,16,-5
IN,SE,2000.0,17,8,9
BY,DE,2007.0,6,6,0
CA,AU,1999.0,147,146,1
CZ,GB,2013.0,37,45,-8
AU,SE,2017.0,67,58,9
BY,CZ,2018.0,24,13,11
PA,US,2014.0,51,53,-2
LK,US,2008.0,11,14,-3
NZ,NL,2014.0,17,12,5
RS,DE,2014.0,24,17,7
DK,CN,1998.0,6,6,0
DE,JP,2019.0,195,224,-29
AT,SE,2019.0,54,34,20
OM,IE,2019.0,3,3,0
KZ,NL,2022.0,1,1,0
SE,CA,2000.0,31,30,1
MQ,FR,2011.0,8,15,-7
US,VN,2014.0,99,48,51
ZM,BR,2019.0,9,4,5
DE,SE,2004.0,93,103,-10
BR,IT,1999.0,37,57,-20
BD,GB,1999.0,17,17,0
BE,HU,2016.0,13,10,3
KR,CH,2021.0,13,22,-9
ES,IE,2020.0,47,32,15
FR,CH,2001.0,229,196,33
CN,LB,2010.0,21,20,1
IL,UA,2022.0,2,2,0
ES,MA,2004.0,7,4,3
TW,MY,2013.0,22,13,9
CH,NL,2016.0,108,127,-19
PR,KR,2009.0,41,22,19
PL,MX,2010.0,4,3,1
GB,ID,2015.0,79,19,60
IT,DE,2019.0,428,320,108
IL,CN,1997.0,3,3,0
AR,PT,2004.0,12,4,8
IN,CZ,2004.0,13,8,5
IN,DE,2009.0,146,127,19
DE,GE,2017.0,3,5,-2
JP,IE,2001.0,26,20,6
JO,GB,2007.0,8,9,-1
CH,PT,2019.0,20,24,-4
HR,UA,2020.0,19,23,-4
SG,CA,2021.0,39,29,10
MX,SV,2001.0,3,2,1
DE,TH,2010.0,17,20,-3
GR,CY,2018.0,81,32,49
RU,AT,2002.0,8,3,5
NL,GR,2006.0,16,13,3
CL,PT,2010.0,9,8,1
CZ,PL,2004.0,16,14,2
GB,IE,1997.0,67,55,12
DE,EG,2016.0,79,53,26
US,KZ,2013.0,14,3,11
US,ID,2010.0,64,49,15
CU,CL,2012.0,19,19,0
GB,MT,2016.0,25,16,9
AO,PT,2017.0,7,3,4
IT,CZ,2008.0,27,24,3
ZA,RU,2021.0,9,5,4
ES,nan,2009.0,25,22,3
NG,AU,2014.0,4,5,-1
CU,PT,2018.0,6,4,2
MX,TR,2017.0,2,2,0
US,UA,2012.0,41,32,9
CH,PT,2017.0,16,29,-13
nan,MX,2012.0,27,23,4
SA,EG,2007.0,49,72,-23
CO,BR,2009.0,64,49,15
UY,AR,2012.0,28,29,-1
GB,NG,2019.0,155,129,26
IE,IT,2020.0,37,57,-20
GB,FI,2012.0,67,56,11
TH,AU,2017.0,16,33,-17
AR,MX,1999.0,22,27,-5
GT,PE,2018.0,2,1,1
IN,PK,2003.0,30,25,5
PK,AF,2019.0,5,1,4
MX,nan,2004.0,15,14,1
VE,MX,2015.0,57,36,21
AU,MY,2021.0,53,65,-12
RU,CN,2017.0,47,56,-9
FR,MA,2003.0,148,126,22
US,PT,2022.0,123,118,5
JP,TR,2018.0,15,71,-56
ML,CM,2020.0,1,2,-1
CZ,AT,2022.0,30,28,2
CO,PH,2022.0,2,1,1
UZ,CN,2018.0,9,12,-3
AZ,IT,2009.0,1,2,-1
IR,CA,2009.0,118,74,44
ZW,KE,2015.0,3,2,1
IR,BD,2012.0,2,4,-2
OM,AE,2008.0,3,2,1
EG,KW,2020.0,14,36,-22
QA,EG,2006.0,10,2,8
RO,CN,2001.0,2,7,-5
LV,DE,2016.0,13,2,11
IE,CN,2022.0,20,22,-2
CH,DK,2013.0,33,42,-9
TH,AU,2010.0,21,32,-11
NL,NO,2018.0,39,37,2
VE,CL,2020.0,30,19,11
TW,GB,2016.0,57,46,11
EE,GB,2018.0,16,13,3
RO,IT,2019.0,17,25,-8
CA,OM,2021.0,7,3,4
TR,IR,2021.0,22,72,-50
FR,TR,2018.0,25,32,-7
GH,UG,2022.0,1,2,-1
BD,CN,2021.0,43,49,-6
SD,SA,2020.0,56,21,35
GB,NG,2017.0,116,68,48
BO,BR,2018.0,4,7,-3
BR,EG,2012.0,3,2,1
CH,ES,2002.0,36,24,12
FI,GB,1999.0,23,18,5
UA,DE,2021.0,43,26,17
AU,IL,2010.0,18,18,0
FI,EE,2004.0,13,5,8
US,SN,2020.0,14,13,1
ID,HU,2020.0,12,16,-4
JP,NZ,2022.0,5,5,0
EE,RU,2016.0,7,9,-2
SY,CN,2015.0,16,16,0
BG,BE,2021.0,5,7,-2
NO,KR,2015.0,4,8,-4
AT,GB,2018.0,114,130,-16
CY,KH,2022.0,2,1,1
CZ,NL,2014.0,13,21,-8
BE,IR,2021.0,19,33,-14
SK,GB,2010.0,18,23,-5
DZ,ID,2018.0,4,1,3
TH,ID,2022.0,14,17,-3
BE,IT,2021.0,101,134,-33
PY,CL,2021.0,6,5,1
GB,JO,2022.0,10,7,3
CN,PK,2002.0,22,29,-7
PE,IL,2021.0,1,1,0
NO,ID,2014.0,7,2,5
KR,UA,2020.0,8,2,6
MY,DE,2020.0,26,12,14
GA,FR,2018.0,7,11,-4
AT,HR,2020.0,6,9,-3
MY,SG,2002.0,14,14,0
AU,FR,1998.0,43,28,15
SA,NL,2022.0,9,6,3
CH,CA,2012.0,93,130,-37
FR,ES,2005.0,161,134,27
TW,HK,2018.0,5,2,3
IR,NO,2013.0,10,4,6
TH,US,2016.0,140,253,-113
PK,BD,2016.0,63,46,17
IR,NZ,2015.0,17,2,15
NO,DE,2003.0,19,38,-19
PT,IT,2016.0,35,55,-20
FR,HU,2008.0,23,23,0
IE,MY,2016.0,8,8,0
DK,PK,2020.0,12,8,4
FR,EG,2021.0,33,22,11
SI,NL,2018.0,14,6,8
UY,US,2017.0,19,30,-11
BR,AT,2022.0,18,11,7
IQ,SG,2020.0,8,7,1
NL,RU,2002.0,14,20,-6
AU,PE,2018.0,3,4,-1
CA,KR,2015.0,55,58,-3
VE,ES,2013.0,88,70,18
RU,PL,2021.0,40,27,13
FR,RS,2015.0,12,14,-2
SA,TR,2016.0,11,12,-1
TH,JP,2009.0,32,74,-42
CN,TZ,2020.0,8,5,3
US,LK,2002.0,11,7,4
SI,AT,2016.0,26,15,11
PT,RO,2021.0,4,3,1
NL,nan,2007.0,44,61,-17
IN,GR,2011.0,8,3,5
IQ,JO,2010.0,2,2,0
FR,MD,2019.0,23,50,-27
CO,VE,2014.0,31,70,-39
GB,CZ,2016.0,57,43,14
KE,CH,2018.0,7,5,2
FR,NZ,2017.0,28,20,8
NE,FR,2001.0,4,3,1
CN,MM,2016.0,2,2,0
FI,NO,2019.0,29,28,1
CH,KE,2017.0,5,6,-1
JP,HU,2002.0,12,11,1
FR,VE,2011.0,8,8,0
PK,SA,2011.0,50,23,27
FR,MD,2010.0,49,63,-14
ZA,PH,2013.0,2,4,-2
ES,JP,2018.0,35,31,4
nan,BR,2011.0,67,64,3
IT,BR,2023.0,6,9,-3
CM,FR,2000.0,4,5,-1
FR,CM,2004.0,10,10,0
KE,DE,2013.0,10,16,-6
LB,US,2009.0,64,32,32
AU,RU,2015.0,38,27,11
TR,BR,2012.0,23,32,-9
BG,IN,2014.0,3,3,0
IE,ES,2004.0,10,15,-5
NL,MX,2012.0,9,14,-5
ES,BG,2000.0,2,5,-3
AR,CH,2008.0,8,8,0
BE,BF,2009.0,4,2,2
HU,US,2014.0,84,123,-39
FI,SE,2016.0,111,87,24
MW,IT,2015.0,1,1,0
BE,AR,2016.0,10,12,-2
CO,DO,2012.0,5,4,1
CU,EC,2017.0,46,20,26
AU,MK,2018.0,41,57,-16
SD,AE,2018.0,6,5,1
SI,CZ,2022.0,2,5,-3
PL,BA,2012.0,9,2,7
FR,MD,2017.0,31,56,-25
HU,ID,2020.0,16,12,4
JP,SE,2009.0,45,35,10
PK,IR,2019.0,20,21,-1
MC,US,2007.0,2,1,1
ET,KR,1997.0,65,31,34
EG,LB,2013.0,13,10,3
GB,CH,2000.0,96,104,-8
HR,NL,2015.0,8,5,3
IR,IN,2012.0,16,43,-27
DK,IT,2012.0,17,31,-14
SG,SA,2017.0,12,5,7
CR,US,2018.0,44,44,0
GR,NO,2019.0,17,8,9
EG,FR,2013.0,18,32,-14
LK,JP,2014.0,21,30,-9
NO,BR,2019.0,26,31,-5
CN,AE,2019.0,14,6,8
NZ,UG,2019.0,3,3,0
FR,ES,2002.0,128,122,6
SK,AU,2020.0,5,2,3
SA,NZ,2016.0,5,4,1
SE,BR,2021.0,21,41,-20
MA,MD,2002.0,4,3,1
AT,GR,2013.0,5,4,1
ES,KR,2009.0,3,7,-4
GR,PL,2005.0,5,2,3
RU,UZ,2011.0,13,15,-2
PH,GB,2002.0,5,10,-5
PL,UA,1998.0,5,7,-2
PT,MX,2013.0,17,19,-2
ET,KR,1998.0,59,42,17
IT,SA,2009.0,4,1,3
PH,NP,2016.0,6,4,2
GB,SS,2001.0,7,4,3
CO,FR,2017.0,38,51,-13
SA,TW,2018.0,4,13,-9
PK,BR,2009.0,4,2,2
RU,AT,2005.0,13,11,2
KG,US,2019.0,4,8,-4
IL,CA,2008.0,56,30,26
SD,MY,2021.0,4,9,-5
PE,FR,2001.0,2,2,0
GB,BR,1997.0,37,29,8
CN,BE,2003.0,19,78,-59
LT,CN,2016.0,2,5,-3
ZA,BR,2014.0,11,8,3
CZ,SI,2005.0,5,8,-3
SG,IR,2012.0,24,31,-7
PA,GB,2022.0,3,2,1
nan,KR,2002.0,15,9,6
UY,ES,2001.0,10,12,-2
nan,FI,2019.0,10,9,1
HR,SE,2004.0,1,1,0
NO,CO,2014.0,2,1,1
NL,PT,2001.0,11,6,5
FR,TH,2003.0,7,8,-1
AR,BO,2007.0,2,5,-3
CR,EC,2018.0,20,18,2
CZ,ZA,2021.0,11,5,6
SE,VN,2003.0,2,2,0
VE,PE,2015.0,9,16,-7
IN,NO,2000.0,25,28,-3
HR,IE,2017.0,6,6,0
GB,OM,2011.0,10,6,4
PS,US,2020.0,17,18,-1
KE,BI,2021.0,1,1,0
IL,IN,2000.0,4,16,-12
RS,BA,2021.0,37,33,4
TW,AU,2013.0,38,30,8
ZA,IE,2022.0,9,4,5
SI,IT,2020.0,10,14,-4
NO,TH,2011.0,1,2,-1
PK,IR,2010.0,6,2,4
PK,GB,2005.0,18,45,-27
nan,TN,2018.0,10,4,6
CN,NZ,2013.0,32,41,-9
DZ,JP,2019.0,3,3,0
FI,DK,2022.0,14,17,-3
NO,GB,2004.0,35,35,0
IT,BD,2018.0,7,9,-2
AT,CA,1997.0,5,4,1
TN,ES,2021.0,8,8,0
US,EE,2020.0,11,16,-5
IR,PS,2018.0,2,1,1
SE,DZ,2015.0,5,3,2
TZ,NO,2005.0,1,1,0
SG,FR,2002.0,6,11,-5
MY,IN,2014.0,96,129,-33
EC,HN,2021.0,3,2,1
SY,DE,2021.0,4,1,3
UA,US,2006.0,48,29,19
MY,ID,2002.0,2,2,0
ME,HR,2019.0,8,2,6
CN,LB,2019.0,10,28,-18
US,PS,2021.0,7,9,-2
SK,CH,2016.0,17,9,8
IR,IT,2008.0,12,2,10
GB,MW,2009.0,13,7,6
AU,SE,2010.0,47,49,-2
TR,HU,2020.0,19,15,4
SK,GB,2019.0,19,20,-1
JO,LB,2018.0,2,5,-3
IT,TW,2014.0,3,6,-3
CZ,US,2000.0,67,47,20
KR,CA,2004.0,28,25,3
nan,SA,2011.0,2,1,1
MZ,BR,2007.0,1,2,-1
CL,IT,2022.0,19,11,8
AU,NG,2021.0,4,15,-11
DK,nan,2006.0,14,6,8
LB,IT,2001.0,3,1,2
UA,NI,2018.0,11,14,-3
US,BH,2019.0,16,9,7
KR,PK,2015.0,31,43,-12
ZA,MZ,2019.0,8,2,6
ID,DE,2012.0,12,26,-14
FR,ML,2007.0,3,2,1
NG,GB,2002.0,7,11,-4
NL,CN,2004.0,47,49,-2
JP,AT,2010.0,10,18,-8
CO,CU,2002.0,6,9,-3
JM,US,2003.0,12,12,0
RU,AU,2012.0,27,14,13
CL,PT,2019.0,14,24,-10
DE,SK,2005.0,22,25,-3
RE,FR,2001.0,8,4,4
CM,KE,2014.0,2,1,1
AT,CZ,1998.0,7,5,2
IQ,KR,2015.0,2,1,1
KZ,UZ,2021.0,14,9,5
US,BE,1998.0,100,125,-25
CD,US,2013.0,3,2,1
TR,CA,1997.0,3,6,-3
PL,NZ,2020.0,2,2,0
AT,IT,2006.0,18,27,-9
RO,CZ,2014.0,18,13,5
RU,IL,1998.0,15,10,5
ET,SE,2012.0,6,5,1
DE,RS,2020.0,34,24,10
LB,SA,2014.0,10,6,4
SI,RS,2018.0,21,14,7
IN,DK,2011.0,11,13,-2
HU,DK,2003.0,4,4,0
TR,BE,1998.0,5,2,3
MY,AT,2020.0,3,2,1
IT,JP,1998.0,32,21,11
TR,CA,1998.0,1,5,-4
FI,NO,2010.0,16,13,3
DK,NO,2001.0,36,30,6
JP,PL,2012.0,12,12,0
MY,LY,2013.0,6,3,3
ZA,IR,2017.0,5,6,-1
CR,AR,2014.0,11,9,2
ET,FR,2012.0,3,5,-2
JP,HK,2002.0,1,12,-11
IE,NL,2014.0,15,17,-2
CH,AU,2003.0,36,27,9
FR,CR,2021.0,8,4,4
KZ,TR,2005.0,19,8,11
GB,LB,2020.0,14,13,1
MY,IT,1998.0,13,25,-12
DE,BA,2016.0,5,2,3
SE,NG,2020.0,4,5,-1
HR,AU,2007.0,4,2,2
MK,SE,2013.0,3,1,2
GM,US,2016.0,1,1,0
NO,CA,2022.0,9,23,-14
SE,CH,1997.0,17,13,4
DE,SK,2002.0,16,22,-6
TR,JP,1997.0,16,17,-1
LU,FR,2011.0,20,43,-23
SG,GR,2014.0,2,3,-1
ME,HR,2010.0,3,2,1
AM,US,2005.0,5,8,-3
BE,EG,2012.0,5,2,3
FR,BZ,2005.0,8,7,1
CO,FR,2010.0,15,25,-10
SG,DK,2004.0,2,5,-3
ZA,RE,2014.0,2,1,1
SE,RS,2005.0,1,4,-3
CA,IE,1998.0,30,27,3
HR,IE,2019.0,2,5,-3
HR,ZA,2010.0,1,1,0
BE,AT,2007.0,10,15,-5
SE,PT,2014.0,11,14,-3
ES,DO,2017.0,12,3,9
BD,PH,2021.0,2,3,-1
HK,SG,2013.0,2,5,-3
TW,RU,1999.0,5,7,-2
IR,PT,2009.0,3,1,2
MY,SG,2005.0,21,23,-2
QA,FR,2013.0,5,19,-14
US,EC,2008.0,14,9,5
AU,BD,1999.0,2,1,1
BD,AU,2023.0,12,2,10
EG,IE,2016.0,5,7,-2
SG,TW,2008.0,27,29,-2
SE,SG,2011.0,9,10,-1
PL,GE,2016.0,2,1,1
US,ET,2009.0,23,33,-10
CZ,RO,2014.0,13,18,-5
CH,RS,2016.0,10,11,-1
NZ,DK,2012.0,8,4,4
CA,RU,1999.0,12,29,-17
DE,VN,2004.0,3,5,-2
CA,RS,2020.0,8,6,2
JP,PR,2019.0,1,1,0
VN,US,2014.0,48,99,-51
CO,CA,2002.0,5,5,0
NZ,CH,2020.0,9,23,-14
DE,EC,2013.0,4,4,0
NO,BR,2010.0,27,12,15
PT,IN,2015.0,13,22,-9
UA,FI,1999.0,2,2,0
DK,CH,2003.0,17,20,-3
BR,CN,2016.0,40,89,-49
ES,GT,2011.0,5,8,-3
CH,CZ,2006.0,21,20,1
PE,AR,2007.0,12,10,2
NP,BE,2018.0,2,1,1
RO,FR,2000.0,13,19,-6
PK,PL,2019.0,15,7,8
BD,ES,2007.0,9,7,2
PA,CL,2003.0,1,1,0
CZ,UA,2013.0,11,24,-13
GN,FR,2009.0,1,3,-2
FR,GN,2018.0,5,3,2
CL,SE,2005.0,4,1,3
AT,PT,2012.0,4,4,0
DZ,IT,2002.0,4,2,2
BW,CN,2015.0,2,1,1
ZA,CN,2015.0,11,10,1
IQ,CN,2011.0,2,7,-5
IT,CO,2009.0,5,7,-2
IE,KR,2013.0,9,5,4
CN,PL,2022.0,9,15,-6
SA,NO,2019.0,4,5,-1
TT,CA,2008.0,1,1,0
ET,GB,2011.0,8,7,1
NG,IT,2003.0,3,3,0
TZ,IT,2020.0,1,1,0
CN,SK,2011.0,1,2,-1
ES,QA,2008.0,3,8,-5
CZ,NO,2012.0,7,8,-1
IE,AR,2014.0,1,1,0
PE,PY,2016.0,6,3,3
SZ,NG,2015.0,1,1,0
CO,KR,2012.0,7,9,-2
TN,AE,2016.0,3,5,-2
MX,CZ,2015.0,3,7,-4
AU,SK,2019.0,5,4,1
LT,IT,2022.0,2,4,-2
IR,BE,2014.0,23,22,1
GB,CD,2019.0,2,2,0
RU,AM,2015.0,4,18,-14
RO,UA,2010.0,2,2,0
CL,BE,2009.0,6,6,0
FI,SK,2002.0,6,1,5
LK,IL,2019.0,1,1,0
NG,TZ,2015.0,3,1,2
IT,NG,2010.0,13,5,8
BJ,FR,2008.0,23,19,4
GR,HU,2008.0,3,3,0
CI,BF,2020.0,9,5,4
AT,PE,2015.0,2,1,1
AU,IT,2009.0,38,50,-12
AE,CA,2016.0,18,38,-20
JP,RO,2016.0,3,3,0
IT,MX,1999.0,7,5,2
TH,IN,2006.0,5,4,1
SG,IN,2005.0,26,27,-1
UY,US,2010.0,12,17,-5
NZ,nan,2011.0,5,20,-15
IE,BE,2011.0,7,8,-1
SA,AE,2009.0,10,7,3
AR,TW,2018.0,7,8,-1
IL,CN,1998.0,10,8,2
JP,CZ,2022.0,9,6,3
HU,BG,2008.0,3,1,2
nan,AU,2001.0,6,8,-2
MZ,PT,2014.0,5,1,4
GM,SN,2001.0,1,1,0
IT,UG,2020.0,5,2,3
GH,DK,2013.0,1,3,-2
JP,ET,2020.0,8,5,3
DK,FR,2008.0,25,35,-10
KH,TH,2013.0,2,4,-2
CO,CU,2005.0,9,14,-5
BR,RO,2017.0,6,3,3
FR,LU,2017.0,57,40,17
MK,RS,2013.0,5,3,2
ZA,MZ,2017.0,7,1,6
PK,PL,2010.0,9,1,8
BR,IR,2011.0,8,6,2
MY,JO,2012.0,7,10,-3
HU,nan,2003.0,7,2,5
KZ,TR,2002.0,4,4,0
DE,RO,2021.0,23,20,3
IR,PK,2012.0,13,7,6
FI,PH,2006.0,2,1,1
GB,NG,2010.0,24,32,-8
SS,GB,2000.0,5,3,2
nan,CH,2011.0,12,11,1
TR,DE,1997.0,5,10,-5
NG,US,2000.0,13,11,2
IS,SE,1997.0,3,9,-6
EC,UA,2008.0,8,10,-2
FR,FJ,2016.0,2,1,1
PT,IE,2015.0,9,6,3
FI,ES,1997.0,3,3,0
CM,TD,2021.0,2,1,1
SG,IN,2002.0,17,25,-8
SK,RS,2012.0,7,5,2
TZ,SE,2005.0,3,2,1
SE,BE,2008.0,12,18,-6
SK,NL,2004.0,8,4,4
NL,FI,2021.0,21,30,-9
NO,RU,2001.0,5,9,-4
DZ,nan,2017.0,7,9,-2
SI,IN,2019.0,4,3,1
LY,MY,2013.0,3,6,-3
nan,ZA,2008.0,15,3,12
RU,NO,2009.0,25,13,12
CA,DK,2003.0,18,21,-3
PH,GB,2005.0,8,12,-4
GR,PL,2002.0,4,2,2
AU,PK,1999.0,3,3,0
TH,SE,2017.0,6,9,-3
OM,SE,2012.0,1,2,-1
BR,NG,2012.0,4,2,2
SE,BD,2019.0,3,5,-2
NL,IE,1999.0,5,1,4
BR,RO,2010.0,2,2,0
JO,SA,2006.0,8,2,6
PK,KE,2005.0,5,4,1
SI,FR,2009.0,8,8,0
AT,IE,2015.0,5,5,0
BG,PT,2004.0,2,1,1
DK,IE,2011.0,8,9,-1
IT,IR,2023.0,1,5,-4
CA,CU,2006.0,1,2,-1
NO,SJ,2016.0,5,8,-3
US,LK,2005.0,11,6,5
TW,PA,2018.0,1,1,0
IT,PE,2020.0,6,9,-3
HU,SK,2005.0,6,10,-4
KR,SA,2022.0,7,2,5
CL,NZ,2012.0,5,1,4
CN,AE,2017.0,11,4,7
NG,KE,2014.0,5,2,3
GL,DK,2015.0,2,8,-6
DK,GL,2018.0,5,2,3
IT,CL,2004.0,9,11,-2
US,ZM,1997.0,2,1,1
IT,KR,2015.0,6,14,-8
NG,KR,2007.0,11,2,9
CA,IL,2003.0,27,33,-6
BR,UA,2021.0,10,15,-5
JP,SG,2003.0,19,16,3
SG,BD,2009.0,1,1,0
PK,DE,2006.0,7,11,-4
DE,PK,2023.0,3,1,2
AU,PL,2007.0,8,3,5
PE,UY,2014.0,3,4,-1
DE,KR,2023.0,2,6,-4
NZ,BE,2008.0,5,2,3
nan,FI,2017.0,8,11,-3
CN,BO,2003.0,7,1,6
UY,US,2019.0,20,24,-4
CO,CN,2013.0,5,1,4
FI,NZ,2020.0,5,3,2
EC,ES,2005.0,8,11,-3
CL,DO,2017.0,1,1,0
TW,IN,2003.0,10,16,-6
BH,OM,2020.0,2,2,0
KE,DK,2020.0,4,1,3
NL,AT,2006.0,16,12,4
IN,MX,2004.0,7,7,0
CH,PL,2004.0,6,8,-2
CH,PT,2010.0,11,8,3
nan,DK,2014.0,20,23,-3
PL,SE,2012.0,22,18,4
FI,TR,2001.0,2,1,1
DZ,EG,2013.0,2,1,1
CR,PE,2013.0,8,6,2
NL,RS,2015.0,10,6,4
PS,JP,2005.0,1,1,0
PT,CA,2007.0,9,14,-5
BR,ST,2006.0,20,29,-9
BR,VE,2016.0,15,24,-9
ZM,BR,2017.0,9,6,3
US,GD,2008.0,3,5,-2
IN,KE,2001.0,1,1,0
JP,DK,2022.0,6,10,-4
SE,MX,2004.0,8,2,6
MX,NL,2008.0,9,8,1
AE,PT,2016.0,2,2,0
SG,SE,2022.0,6,7,-1
NL,QA,2016.0,2,3,-1
PL,AT,2007.0,11,9,2
IL,PT,2014.0,3,2,1
RO,IN,2020.0,7,16,-9
TW,ES,2019.0,4,5,-1
TW,PL,2015.0,4,3,1
HR,SK,2019.0,7,6,1
HR,FR,2012.0,6,1,5
ZA,SZ,2018.0,9,3,6
BH,MY,2016.0,2,3,-1
nan,NL,2001.0,23,27,-4
KH,GB,2017.0,6,6,0
US,TN,2006.0,9,7,2
KW,GB,2012.0,5,14,-9
IS,IT,2011.0,1,1,0
IQ,JO,2019.0,9,19,-10
SE,DK,2023.0,5,8,-3
LV,CH,2021.0,2,1,1
FI,CZ,2015.0,10,5,5
NP,CA,2023.0,1,2,-1
CN,LB,2017.0,16,33,-17
AZ,PL,2018.0,2,1,1
TW,ES,2010.0,9,6,3
FR,AT,2000.0,18,17,1
NO,nan,2004.0,11,9,2
HR,IE,2010.0,7,7,0
EG,OM,2021.0,11,12,-1
CZ,FI,2007.0,2,2,0
ZA,TH,2007.0,3,1,2
TR,JP,1998.0,21,34,-13
CH,SN,2021.0,2,2,0
ES,NG,2015.0,1,2,-1
CL,BO,2007.0,1,1,0
CN,NO,1997.0,1,4,-3
CU,PY,2004.0,2,1,1
PY,BR,2016.0,7,9,-2
BE,CL,2014.0,16,7,9
AU,SK,2017.0,7,3,4
DZ,PT,2015.0,2,1,1
SE,CZ,2008.0,10,11,-1
CZ,AR,2015.0,1,3,-2
DE,TH,2017.0,31,14,17
RO,CH,2005.0,8,2,6
AE,IE,2019.0,6,4,2
BR,RO,2019.0,9,6,3
QA,ZA,2021.0,3,1,2
DZ,nan,2019.0,10,8,2
SG,IL,2021.0,5,1,4
GN,KH,2020.0,1,1,0
CL,MX,1999.0,15,30,-15
PK,ET,2015.0,4,2,2
CH,AE,2021.0,3,2,1
CA,MA,2004.0,7,8,-1
TH,SE,2010.0,5,4,1
FR,PS,2017.0,4,2,2
MA,EG,2015.0,5,8,-3
PH,BR,2009.0,3,1,2
GB,TZ,2011.0,14,12,2
KH,GB,2019.0,3,5,-2
RO,JP,1997.0,5,3,2
TH,NG,2019.0,5,3,2
UA,KR,2015.0,4,1,3
UG,GB,2010.0,6,9,-3
GB,ZM,2010.0,2,5,-3
PK,PL,2017.0,11,11,0
HN,US,2005.0,3,1,2
CZ,BR,2021.0,8,13,-5
AT,SE,2010.0,16,18,-2
RU,HU,2023.0,2,5,-3
BD,IE,1999.0,2,1,1
GR,TR,2004.0,3,1,2
PT,AR,2001.0,3,4,-1
US,BH,2010.0,10,12,-2
AE,DK,2016.0,2,1,1
NG,BJ,2011.0,1,1,0
NG,GB,2005.0,12,10,2
FR,NZ,2010.0,14,16,-2
MX,TR,2010.0,4,4,0
JP,ZA,2004.0,6,2,4
CN,LT,2006.0,4,2,2
GB,BM,2010.0,1,1,0
IT,ZA,2003.0,10,6,4
MW,ZM,2019.0,2,7,-5
JP,LV,2020.0,2,1,1
CN,AT,2012.0,18,16,2
DE,NZ,2000.0,7,19,-12
DE,MN,2015.0,5,1,4
ES,PS,2006.0,4,2,2
BG,BR,2007.0,3,2,1
RO,UA,2019.0,11,4,7
RS,CZ,2014.0,16,12,4
US,BH,2017.0,10,14,-4
TW,IT,2013.0,4,3,1
CZ,RS,2004.0,10,12,-2
BY,SI,2006.0,2,1,1
HU,SK,2002.0,4,4,0
GB,UA,2007.0,5,6,-1
LB,CA,2002.0,5,3,2
PK,IR,2017.0,13,19,-6
AU,PT,2023.0,4,2,2
CH,IE,2022.0,6,11,-5
AR,CR,2021.0,1,8,-7
HU,IN,2020.0,6,9,-3
US,SR,2011.0,1,1,0
CZ,KR,2016.0,10,7,3
US,LU,2008.0,13,11,2
ZA,KR,2022.0,3,1,2
CA,CO,2008.0,7,15,-8
DZ,ZA,2015.0,1,1,0
RU,EC,2008.0,4,1,3
ID,DK,2013.0,3,3,0
MA,MD,2005.0,3,8,-5
IQ,US,2005.0,3,7,-4
JM,CA,2003.0,1,4,-3
MZ,PL,2013.0,6,11,-5
MY,FR,2016.0,13,15,-2
SD,DE,2009.0,1,1,0
LU,CA,2020.0,4,8,-4
FI,ES,1998.0,2,2,0
IN,BE,1999.0,4,2,2
RU,EG,2009.0,1,4,-3
SE,NI,2011.0,3,3,0
GB,CU,2006.0,4,7,-3
DE,GE,2019.0,6,4,2
MY,IL,2015.0,4,2,2
SK,GB,2017.0,10,16,-6
BE,IE,1998.0,6,1,5
BG,DK,2008.0,4,1,3
ID,BD,2014.0,8,12,-4
CA,KW,2003.0,2,1,1
RS,AT,2007.0,5,7,-2
LU,IL,2012.0,2,1,1
SG,SA,2010.0,7,2,5
KN,US,2016.0,8,7,1
HR,SK,2017.0,3,12,-9
BY,HU,2003.0,2,1,1
SG,nan,2009.0,3,8,-5
JO,IQ,2021.0,12,15,-3
AT,IL,2007.0,3,2,1
CH,UA,2011.0,3,4,-1
BH,KR,2017.0,2,1,1
NO,ES,2001.0,9,14,-5
TR,DZ,2019.0,4,2,2
EG,BE,2006.0,2,1,1
JP,AG,2019.0,1,2,-1
GB,VE,1998.0,4,3,1
TW,UA,2013.0,1,1,0
EC,ES,2002.0,1,5,-4
TZ,CH,2011.0,6,2,4
DK,SG,2022.0,2,4,-2
GH,EG,2012.0,5,1,4
IT,NG,2019.0,5,9,-4
FR,SA,2022.0,8,9,-1
CH,PE,2021.0,6,4,2
FR,BH,2015.0,2,1,1
BD,RU,2015.0,2,1,1
GT,MX,2009.0,3,6,-3
NO,SG,2014.0,2,3,-1
SG,FR,2005.0,4,7,-3
IE,nan,2007.0,2,5,-3
US,MD,2006.0,7,1,6
RS,SK,2007.0,3,6,-3
AU,HR,2007.0,2,4,-2
nan,HU,2013.0,4,7,-3
UA,BE,2014.0,2,1,1
IS,SE,1998.0,3,9,-6
CL,RU,2020.0,2,5,-3
SE,QA,2009.0,3,1,2
KH,US,2021.0,4,6,-2
AR,SE,2021.0,9,6,3
IL,KE,2011.0,2,2,0
SE,BD,2017.0,5,11,-6
KZ,GB,2017.0,5,3,2
US,NP,2006.0,10,9,1
LA,TR,2019.0,1,5,-4
GR,IN,2003.0,6,4,2
JO,MY,2014.0,4,19,-15
IT,GE,2014.0,1,1,0
EE,US,2021.0,13,13,0
nan,TR,2009.0,6,7,-1
MC,FR,2016.0,4,9,-5
JP,AT,2019.0,23,15,8
FI,RU,2012.0,22,35,-13
MX,TR,2019.0,3,7,-4
AT,RS,2011.0,4,3,1
NL,LU,2012.0,7,6,1
GR,NO,2010.0,2,3,-1
TR,IQ,2022.0,6,12,-6
RU,TR,2011.0,5,3,2
KW,PK,2005.0,2,1,1
PL,BR,1997.0,4,2,2
TH,ES,2015.0,2,3,-1
UY,IT,2012.0,8,4,4
BD,SA,2011.0,6,4,2
NG,HU,2013.0,6,3,3
TH,TW,2015.0,6,14,-8
TR,MX,2005.0,3,1,2
JO,AE,2004.0,6,1,5
DE,AM,2021.0,4,3,1
DK,NZ,2007.0,7,6,1
NG,CH,2009.0,3,3,0
BB,GB,2008.0,5,3,2
FI,LU,2014.0,4,2,2
RU,GE,2013.0,2,6,-4
TR,RW,2019.0,2,1,1
TR,ZA,2020.0,7,4,3
UZ,UA,2011.0,7,1,6
AU,HU,2021.0,6,5,1
ES,RO,2004.0,2,6,-4
VG,GB,2011.0,5,5,0
MK,PL,2008.0,2,3,-1
PL,RS,2009.0,1,2,-1
CZ,SI,2002.0,1,12,-11
NL,GH,2006.0,1,3,-2
SD,ZA,2013.0,1,4,-3
CY,ES,2013.0,3,3,0
TR,IE,2016.0,4,3,1
PL,BG,2013.0,2,3,-1
MU,CA,2013.0,1,1,0
TR,PK,2013.0,10,10,0
FR,KE,2006.0,2,4,-2
NL,EE,2012.0,1,3,-2
BE,IE,1997.0,3,1,2
RU,MD,2011.0,4,7,-3
SG,TH,2004.0,5,2,3
CN,HU,2016.0,6,4,2
GB,GE,2008.0,3,11,-8
NL,RO,1997.0,2,1,1
CR,NI,2017.0,3,2,1
HU,PK,2014.0,3,2,1
NZ,GE,2008.0,1,1,0
JP,HK,2005.0,3,12,-9
IT,NG,2017.0,3,2,1
KR,QA,2021.0,1,7,-6
CA,CZ,1999.0,4,3,1
IQ,AE,2016.0,5,3,2
AG,IN,2017.0,1,1,0
IT,PY,2020.0,2,1,1
JP,BG,2007.0,7,3,4
AR,GT,2014.0,2,2,0
CU,AU,2014.0,1,3,-2
GB,KW,2004.0,5,3,2
GB,SY,2012.0,8,5,3
DZ,AU,2018.0,2,1,1
PT,MY,2022.0,1,1,0
MX,AE,2018.0,2,2,0
AM,US,2002.0,6,1,5
FR,LK,2020.0,2,2,0
US,BA,2006.0,5,5,0
BY,RU,1999.0,8,18,-10
DZ,AT,2018.0,1,1,0
ZW,PK,2022.0,2,4,-2
DZ,CA,2013.0,5,10,-5
FR,BF,1999.0,2,4,-2
NZ,AT,2003.0,5,1,4
JP,PK,2001.0,9,5,4
BE,UG,2009.0,2,6,-4
MG,US,2003.0,1,2,-1
ZA,ES,2008.0,4,2,2
BD,NG,2020.0,6,2,4
SI,SE,2004.0,2,2,0
PL,SI,2020.0,2,2,0
IE,TH,2010.0,1,1,0
FR,AM,2009.0,2,5,-3
IN,ZW,2022.0,3,2,1
MZ,UA,2012.0,3,2,1
EG,ET,2013.0,4,1,3
IL,TH,2013.0,1,1,0
TR,GR,2021.0,6,7,-1
BD,PL,2014.0,5,1,4
GH,ZA,2003.0,2,1,1
DE,SD,2020.0,2,2,0
US,PG,2000.0,2,3,-1
DK,CN,1997.0,5,6,-1
PE,SE,2011.0,1,2,-1
BD,TW,2013.0,3,4,-1
BY,US,2000.0,4,7,-3
FR,SK,2003.0,6,4,2
PK,BN,2013.0,3,1,2
FI,SK,2005.0,2,11,-9
CH,ET,2022.0,2,1,1
VN,GH,2020.0,4,2,2
PE,US,2023.0,2,2,0
PK,PT,2022.0,1,1,0
AE,KR,2022.0,3,9,-6
PK,KE,2002.0,2,1,1
US,FK,2012.0,1,1,0
BZ,FR,2007.0,1,9,-8
IS,AT,2012.0,3,1,2
AM,IL,2007.0,1,1,0
GH,NG,2009.0,4,2,2
LT,PL,2018.0,3,8,-5
IR,IE,2016.0,9,10,-1
AT,SA,2013.0,6,1,5
MM,AU,2015.0,1,1,0
RE,US,2008.0,2,1,1
ZA,LB,2022.0,2,1,1
RU,IE,2006.0,5,4,1
CM,BE,2016.0,7,6,1
TZ,BH,2003.0,2,2,0
GH,IT,2022.0,1,2,-1
SN,GN,2022.0,1,2,-1
BE,CD,2020.0,9,12,-3
UA,EE,2016.0,1,1,0
SE,TH,2023.0,2,2,0
GB,FK,2017.0,1,1,0
DZ,BE,2022.0,1,2,-1
CU,BR,2008.0,10,11,-1
MT,US,2006.0,1,1,0
ZA,MW,2018.0,17,7,10
EG,CZ,2020.0,6,5,1
PY,US,2012.0,2,3,-1
SI,IN,2010.0,2,3,-1
SG,PH,2008.0,4,5,-1
GR,PT,2011.0,3,2,1
BD,OM,2018.0,4,1,3
FI,YE,2020.0,1,1,0
LK,BT,2022.0,1,3,-2
KR,JO,2017.0,3,1,2
ES,CY,2013.0,3,3,0
DE,CW,2015.0,3,3,0
SK,RO,2009.0,3,2,1
RS,IL,2016.0,1,3,-2
GE,DE,2001.0,2,3,-1
IL,TW,2013.0,2,1,1
BF,SE,2010.0,1,1,0
PH,DE,2004.0,6,4,2
MY,BD,2001.0,4,4,0
NO,IL,2008.0,1,4,-3
ET,US,2003.0,13,11,2
DE,GE,2010.0,7,8,-1
PH,EC,2018.0,3,2,1
DE,MD,2013.0,5,4,1
TW,EG,2011.0,6,9,-3
CL,CR,2004.0,8,10,-2
BD,SG,2009.0,1,1,0
RU,KR,2023.0,1,1,0
UY,MX,2001.0,2,3,-1
SE,IQ,2014.0,1,1,0
US,TT,2013.0,8,12,-4
RU,IL,1997.0,11,10,1
AT,ET,2008.0,2,1,1
PA,EC,2015.0,1,1,0
ID,AT,2020.0,4,5,-1
RO,JP,1998.0,2,1,1
CH,RU,2001.0,11,14,-3
LK,NZ,2007.0,1,3,-2
CN,BY,2019.0,3,4,-1
SE,RS,2002.0,2,2,0
MU,US,2019.0,3,1,2
FR,TZ,2004.0,2,2,0
EG,GH,2011.0,2,1,1
PT,IL,2012.0,1,1,0
CR,NI,2019.0,2,3,-1
RS,CH,2011.0,8,7,1
BE,PK,2022.0,5,1,4
HR,IT,2005.0,2,5,-3
LA,VN,2005.0,1,2,-1
PE,ZA,2018.0,1,2,-1
BH,US,2003.0,7,3,4
AU,KW,2018.0,5,1,4
NO,AU,2005.0,5,13,-8
SN,IN,2010.0,1,1,0
IT,CR,2012.0,3,1,2
US,RE,2009.0,1,3,-2
VG,FR,2003.0,1,2,-1
EE,NL,2016.0,2,1,1
UA,SE,2022.0,2,5,-3
GH,SE,2018.0,3,3,0
US,BY,2006.0,1,13,-12
KW,ID,2018.0,3,2,1
BE,SK,2013.0,3,1,2
RO,CH,2002.0,6,1,5
ZA,CZ,2002.0,1,1,0
ZA,CZ,2005.0,1,1,0
LB,MY,2004.0,1,1,0
BD,NZ,2022.0,4,1,3
IE,TW,2009.0,3,3,0
GB,FK,2010.0,3,1,2
IR,BR,2016.0,12,22,-10
GB,BM,2019.0,1,1,0
NO,MX,2011.0,4,4,0
NP,DE,2016.0,3,4,-1
KZ,GB,2019.0,4,8,-4
NO,TR,2022.0,8,5,3
NO,AU,2002.0,7,4,3
RS,AE,2021.0,2,1,1
BG,CZ,2012.0,2,2,0
KW,PK,2002.0,3,2,1
DE,ID,2001.0,4,1,3
RU,ZA,2021.0,5,9,-4
DZ,IT,2005.0,4,8,-4
BH,SA,2018.0,4,8,-4
TR,FI,1999.0,1,1,0
MA,IT,2003.0,5,10,-5
GT,CL,2015.0,4,3,1
DE,LB,2016.0,5,5,0
DK,RU,2014.0,7,9,-2
HU,IT,2000.0,2,7,-5
CU,EC,2010.0,2,2,0
BD,nan,2007.0,1,1,0
US,ZM,1998.0,2,1,1
BA,CZ,2019.0,1,2,-1
IL,MX,2014.0,2,2,0
ZA,IR,2019.0,2,12,-10
PA,NO,2012.0,1,1,0
NZ,EG,2009.0,3,2,1
NG,AE,2015.0,2,1,1
DO,IT,2022.0,1,2,-1
VN,BE,2000.0,2,3,-1
KE,BD,2015.0,2,1,1
ES,JO,2007.0,1,4,-3
GR,CN,1997.0,1,1,0
SG,AE,2013.0,5,2,3
VN,ES,2019.0,2,2,0
KR,CZ,1999.0,1,2,-1
PL,XK,2017.0,1,2,-1
TN,TR,2020.0,3,1,2
MY,BE,2008.0,1,1,0
PL,IE,2013.0,5,15,-10
IE,RU,1998.0,1,1,0
MT,AU,2016.0,2,5,-3
CN,YE,2021.0,3,6,-3
MY,MA,2021.0,4,1,3
EC,IL,2011.0,1,1,0
SA,MY,2007.0,5,3,2
BD,KW,2019.0,1,3,-2
LB,IE,2020.0,3,1,2
ME,HR,2017.0,4,7,-3
MX,GB,2023.0,2,1,1
AR,IL,2006.0,3,3,0
CN,NO,1998.0,3,2,1
RS,JP,2011.0,3,1,2
MA,IR,2021.0,2,6,-4
GH,CH,2005.0,1,1,0
RS,ME,2014.0,11,19,-8
SN,BE,2022.0,2,1,1
IR,TW,2012.0,3,7,-4
PT,SE,2001.0,1,3,-2
AL,NL,2015.0,1,3,-2
MY,PS,2013.0,2,1,1
FR,MK,2000.0,1,1,0
CA,FJ,2014.0,1,2,-1
AR,NZ,2019.0,3,1,2
UY,PT,2015.0,5,3,2
HK,CN,1998.0,2,1,1
JP,AR,2007.0,3,8,-5
IE,RU,1997.0,1,2,-1
DO,MX,2018.0,4,5,-1
LT,ES,2012.0,1,2,-1
TR,TH,2016.0,2,2,0
SD,OM,2013.0,2,1,1
PK,RU,2008.0,1,1,0
US,MC,2009.0,1,2,-1
RS,MX,2018.0,1,7,-6
KR,UZ,2000.0,2,4,-2
DE,UZ,2021.0,3,1,2
PL,UA,1997.0,3,6,-3
FR,CO,1999.0,5,6,-1
LB,PL,2021.0,1,1,0
TR,DZ,2017.0,3,1,2
CY,QA,2020.0,2,1,1
BS,GB,2016.0,2,1,1
DK,ET,2002.0,1,1,0
ET,CH,2016.0,4,2,2
DK,EG,2000.0,3,1,2
CU,RU,2022.0,1,1,0
ID,IT,2022.0,3,8,-5
DK,AT,1999.0,1,4,-3
IN,CL,2008.0,2,2,0
BR,PA,2013.0,4,2,2
CH,BY,2019.0,1,1,0
QA,GB,1999.0,4,2,2
RE,NC,2017.0,1,1,0
RW,IN,2009.0,2,7,-5
UA,CZ,1997.0,1,4,-3
CN,BR,2023.0,1,1,0
TN,SA,2023.0,5,3,2
MW,NG,2014.0,1,1,0
CZ,NZ,2022.0,1,1,0
MN,DE,2018.0,2,2,0
nan,TH,2010.0,2,1,1
DZ,SE,2017.0,4,6,-2
GB,UY,2005.0,2,2,0
US,AL,2012.0,4,3,1
FR,ID,2000.0,5,1,4
ZA,TW,2005.0,2,5,-3
DO,CO,2009.0,1,1,0
FI,IE,2011.0,2,3,-1
SK,CN,1997.0,1,1,0
BR,MA,2018.0,1,1,0
PR,ES,2019.0,3,1,2
GR,SK,2020.0,1,1,0
PH,PE,2018.0,5,6,-1
PE,CH,2018.0,1,2,-1
DK,KR,2015.0,3,7,-4
BR,CZ,2007.0,1,2,-1
GB,EC,2008.0,3,5,-2
GA,US,2009.0,1,1,0
IQ,TZ,2017.0,1,2,-1
DZ,AE,2013.0,1,1,0
AU,JO,2014.0,4,5,-1
BW,GB,2005.0,1,1,0
SD,GB,2003.0,1,2,-1
AR,DK,2007.0,1,2,-1
IL,JP,1999.0,4,5,-1
SE,BG,2003.0,2,5,-3
IN,AE,2005.0,3,1,2
BE,CW,2005.0,1,2,-1
CH,RO,2009.0,4,3,1
LU,CH,2022.0,2,7,-5
PK,MA,2004.0,1,6,-5
MX,PK,2019.0,2,2,0
RO,BG,2012.0,1,5,-4
PG,US,2008.0,2,1,1
US,CN,2014.0,5959,4918,1041
CN,RU,2014.0,36,49,-13
NP,US,2022.0,60,43,17
CA,CH,2018.0,128,112,16
ES,MX,1999.0,165,175,-10
KR,JP,1997.0,51,92,-41
EG,DE,2009.0,40,32,8
US,CH,1998.0,366,383,-17
FI,IN,2022.0,12,13,-1
GB,NZ,2017.0,274,241,33
DE,CN,2007.0,259,173,86
PT,FR,2009.0,40,33,7
JP,KR,2015.0,408,309,99
GB,NZ,2019.0,309,328,-19
NL,AU,2001.0,31,30,1
ES,EG,2018.0,15,8,7
AU,IL,2019.0,18,29,-11
CN,IN,2015.0,146,197,-51
NL,CA,1999.0,27,25,2
RO,UA,2017.0,6,3,3
US,RU,2003.0,209,363,-154
AT,PK,2012.0,25,2,23
LB,FR,2014.0,43,94,-51
CL,PT,2017.0,9,12,-3
nan,DE,2018.0,84,68,16
NL,ZA,2011.0,32,37,-5
JP,BR,2020.0,46,65,-19
GB,BR,1998.0,67,41,26
SY,FR,2016.0,5,10,-5
ZA,SE,2012.0,18,12,6
DK,BR,2020.0,31,33,-2
CA,IE,1997.0,26,30,-4
RU,JP,2008.0,53,30,23
SE,PL,1999.0,12,9,3
AT,SE,2017.0,36,24,12
CH,AT,2003.0,67,53,14
NL,RU,2005.0,22,31,-9
CH,ES,2005.0,27,35,-8
TH,SE,2019.0,4,11,-7
UG,GB,2019.0,16,29,-13
MY,TH,2014.0,7,10,-3
FR,LU,2010.0,36,30,6
nan,KR,2005.0,14,17,-3
CA,EG,2012.0,76,45,31
SG,SA,2019.0,5,5,0
AR,VE,2021.0,7,19,-12
US,UG,2001.0,7,5,2
HR,GB,2018.0,20,18,2
IT,MY,2012.0,69,37,32
PL,AU,2008.0,10,13,-3
TR,AG,2016.0,31,1,30
BR,NZ,2008.0,4,3,1
FR,SE,2003.0,48,44,4
SG,LK,2011.0,2,3,-1
FI,CA,2003.0,14,9,5
SE,UA,2004.0,5,1,4
MA,KE,2011.0,1,1,0
MZ,BE,2007.0,6,1,5
AT,NL,2018.0,48,39,9
CN,ZA,2009.0,15,13,2
SG,MM,2022.0,2,6,-4
MY,US,2003.0,27,25,2
SE,HU,2007.0,7,20,-13
BE,LU,2012.0,18,12,6
PH,ES,2013.0,11,11,0
DE,TH,2019.0,25,16,9
KR,JP,1998.0,68,124,-56
BR,EC,2014.0,23,14,9
ES,HN,2003.0,3,3,0
BH,CN,2020.0,1,2,-1
PK,GB,2002.0,11,32,-21
TR,DE,1998.0,6,10,-4
CU,DE,2014.0,6,2,4
IT,SK,2011.0,5,6,-1
AE,KZ,2018.0,3,2,1
NO,BR,2017.0,30,25,5
CH,KE,2010.0,6,4,2
UA,BR,2006.0,4,2,2
JP,HU,2005.0,7,9,-2
MA,TN,2000.0,2,3,-1
RO,SE,2015.0,7,5,2
NP,IN,2003.0,9,15,-6
NO,BE,2007.0,9,3,6
KR,BR,1999.0,3,1,2
GP,JM,2020.0,6,5,1
ES,IR,2015.0,8,17,-9
GN,ML,2018.0,5,2,3
NG,CG,2013.0,1,1,0
TW,ES,2017.0,5,4,1
CO,CA,2005.0,7,6,1
BE,TH,2014.0,5,3,2
VN,SG,2016.0,7,16,-9
MD,BE,1998.0,3,3,0
PL,RO,2012.0,7,8,-1
CA,DZ,2009.0,7,4,3
BE,FI,2004.0,5,5,0
EG,BG,2020.0,1,1,0
AO,PT,2019.0,6,3,3
GR,NO,2017.0,9,3,6
CZ,JP,2006.0,13,17,-4
SE,KE,2004.0,3,2,1
MW,ZA,2009.0,2,3,-1
DZ,SE,2019.0,8,9,-1
NL,RO,1998.0,4,6,-2
KE,BE,1997.0,1,4,-3
TN,US,2009.0,11,16,-5
NL,RW,2020.0,5,2,3
IQ,US,2002.0,1,1,0
NL,LK,2007.0,2,1,1
RO,PL,2008.0,2,4,-2
MY,KE,2016.0,4,1,3
MY,SY,2021.0,3,1,2
PL,MX,2019.0,8,7,1
EC,US,2003.0,6,6,0
IQ,JO,2017.0,5,15,-10
CA,HK,2013.0,7,3,4
AL,NO,2017.0,2,1,1
ES,NI,2011.0,6,4,2
ES,IL,2001.0,4,1,3
PL,MX,2017.0,3,8,-5
XK,BA,2020.0,1,1,0
PL,KR,2015.0,2,1,1
MY,ID,2005.0,6,5,1
GB,ZM,2019.0,6,9,-3
CU,BE,2022.0,1,1,0
EC,GT,2018.0,1,4,-3
SE,UG,2020.0,2,3,-1
KE,BE,1998.0,1,5,-4
CD,UG,2015.0,1,1,0
DK,IQ,2019.0,2,1,1
UY,nan,2008.0,3,1,2
NP,VN,2021.0,1,1,0
ES,TW,2013.0,3,11,-8
CH,MK,2021.0,1,1,0
AT,CA,1998.0,5,14,-9
IR,UA,2016.0,1,2,-1
JP,AE,2001.0,2,1,1
DK,BE,2023.0,6,7,-1
GM,NG,2016.0,1,1,0
BR,DZ,2015.0,1,1,0
FR,EE,2003.0,1,2,-1
KZ,US,2012.0,6,10,-4
BA,SA,2018.0,1,1,0
FR,BZ,2002.0,1,2,-1
UA,AZ,2019.0,1,3,-2
BR,MQ,2010.0,1,1,0
LT,AT,2014.0,1,1,0
CR,PA,2016.0,1,1,0
PE,BO,2022.0,2,5,-3
FI,AE,2018.0,2,1,1
NZ,GB,2008.0,199,231,-32
GB,ZM,2017.0,11,5,6
DE,BR,2018.0,280,259,21
IT,IE,2020.0,57,37,20
DK,DE,2004.0,64,63,1
GD,US,2018.0,16,21,-5
ID,TW,2016.0,24,45,-21
AU,IR,2001.0,14,3,11
IL,DK,2011.0,3,6,-3
LB,CA,2005.0,2,3,-1
CH,KE,2019.0,6,4,2
CA,IQ,2012.0,2,1,1
CH,BG,2014.0,4,3,1
NO,IQ,2020.0,1,1,0
EG,BR,2008.0,1,2,-1
CH,CL,2011.0,16,6,10
CN,,2024.0,385165,0,385165
,IN,2003.0,9451,0,9451
DE,,2021.0,27279,0,27279
,CA,2013.0,10984,0,10984
SG,,2024.0,9247,0,9247
RU,,2018.0,7859,0,7859
,MX,2002.0,3099,0,3099
SE,,2023.0,14464,0,14464
,BR,2010.0,20407,0,20407
BR,,2008.0,2300,0,2300
TW,CZ,1999.0,3,0,3
AT,,2023.0,9593,0,9593
,BR,2017.0,18408,0,18408
nan,,2023.0,3060,0,3060
,FI,2003.0,1825,0,1825
DK,,2017.0,1656,0,1656
,ID,2015.0,21496,0,21496
,PL,2013.0,8968,0,8968
,BE,1994.0,8601,0,8601
,PT,2012.0,2104,0,2104
,RU,2006.0,6572,0,6572
IE,,2013.0,715,0,715
IN,,1998.0,1154,0,1154
,NL,2007.0,6063,0,6063
,VE,2013.0,257,0,257
,MX,2005.0,3702,0,3702
,HR,2006.0,1157,0,1157
,SV,1994.0,15,0,15
PF,,2023.0,58,0,58
DZ,,2012.0,134,0,134
,UA,1997.0,1279,0,1279
,HK,2014.0,56,0,56
CM,,2019.0,245,0,245
TR,,2001.0,284,0,284
DK,,2019.0,2298,0,2298
,ZW,2013.0,190,0,190
,IE,2016.0,1269,0,1269
,LK,2010.0,387,0,387
BD,,2015.0,367,0,367
NG,,2008.0,349,0,349
,PE,2003.0,278,0,278
,PA,2000.0,25,0,25
,BR,2019.0,6822,0,6822
DO,,2023.0,161,0,161
DK,,2010.0,811,0,811
PL,,2008.0,1193,0,1193
,UA,1998.0,1578,0,1578
,nan,2016.0,796,0,796
HR,,2013.0,349,0,349
AW,ES,2017.0,1,0,1
,KW,2012.0,148,0,148
,GE,2000.0,124,0,124
,IT,2016.0,9833,0,9833
,FR,2018.0,9839,0,9839
,TH,2011.0,2536,0,2536
,LK,2019.0,243,0,243
,IL,2015.0,2573,0,2573
BO,,1999.0,3,0,3
AZ,,2013.0,79,0,79
SI,UG,2020.0,2,0,2
GH,,2022.0,933,0,933
,EG,2020.0,262,0,262
BA,JP,2018.0,1,0,1
,BY,2005.0,338,0,338
LT,,2018.0,601,0,601
PT,,2006.0,179,0,179
,CY,2013.0,218,0,218
,MR,2017.0,8,0,8
,SJ,2014.0,5,0,5
,KH,2013.0,69,0,69
,TZ,2009.0,164,0,164
,TJ,2014.0,45,0,45
GE,AZ,2006.0,8,0,8
AT,EE,2016.0,13,0,13
VN,CH,2008.0,2,0,2
,CM,1995.0,98,0,98
CL,PH,2001.0,2,0,2
PH,KZ,2019.0,1,0,1
SI,DK,2021.0,3,0,3
,BY,2002.0,328,0,328
PE,,2025.0,206,0,206
GT,,2021.0,74,0,74
,AZ,2012.0,116,0,116
ET,KN,2015.0,1,0,1
IE,CL,2006.0,1,0,1
SD,US,2001.0,3,0,3
CY,BN,2020.0,1,0,1
SV,,2024.0,48,0,48
,PF,2008.0,5,0,5
TH,,2007.0,254,0,254
SV,JP,2012.0,2,0,2
AF,,2017.0,7,0,7
RW,,2010.0,4,0,4
MU,,2020.0,38,0,38
,UY,2011.0,272,0,272
KE,,1998.0,31,0,31
,ZM,2004.0,54,0,54
HU,,1999.0,221,0,221
SZ,,2020.0,6,0,6
GF,,2014.0,3,0,3
,LK,2017.0,463,0,463
ZW,,2011.0,20,0,20
ID,ML,2017.0,3,0,3
AM,,2025.0,25,0,25
,ZM,1996.0,16,0,16
PE,PK,2021.0,1,0,1
CM,EG,2018.0,3,0,3
ID,HR,2012.0,2,0,2
MN,ZW,2021.0,2,0,2
EG,FI,2006.0,4,0,4
AU,GE,2017.0,2,0,2
,IR,2018.0,8578,0,8578
AF,,2019.0,9,0,9
,NI,2002.0,8,0,8
,ST,2009.0,14,0,14
,LB,2006.0,252,0,252
,KZ,1995.0,38,0,38
,LT,1995.0,168,0,168
PW,AU,2005.0,1,0,1
PS,,2005.0,7,0,7
ET,LU,2018.0,1,0,1
MU,MG,2015.0,1,0,1
NC,,2018.0,25,0,25
UG,BE,2003.0,2,0,2
,PR,1997.0,28,0,28
BI,GB,2021.0,1,0,1
IN,NE,2009.0,1,0,1
CV,PT,2008.0,1,0,1
QA,CY,2017.0,2,0,2
,ET,2020.0,110,0,110
SK,,2007.0,160,0,160
NL,TN,2009.0,1,0,1
CM,,2017.0,161,0,161
RW,,2019.0,35,0,35
,TT,2012.0,57,0,57
CM,RO,2017.0,1,0,1
IE,BN,2008.0,1,0,1
CH,NC,2005.0,2,0,2
TH,SN,1999.0,2,0,2
LK,BR,2020.0,1,0,1
PL,VN,2001.0,2,0,2
IT,LK,2011.0,2,0,2
GE,PH,2021.0,1,0,1
VA,,2021.0,1,0,1
LK,,2000.0,16,0,16
,PR,1998.0,20,0,20
SZ,US,2021.0,2,0,2
GE,,2025.0,32,0,32
GW,,2023.0,7,0,7
TW,BT,2019.0,1,0,1
,GF,2001.0,8,0,8
RW,,2017.0,25,0,25
FR,DJ,2000.0,1,0,1
LT,NO,2020.0,2,0,2
CY,ZA,2022.0,2,0,2
ZM,VN,2001.0,1,0,1
CL,DO,2019.0,4,0,4
KW,,2006.0,72,0,72
MK,CH,2019.0,1,0,1
BM,,2022.0,6,0,6
SI,JP,2003.0,1,0,1
CM,,2010.0,38,0,38
CD,,2008.0,4,0,4
IN,RW,2005.0,3,0,3
SN,MR,2016.0,3,0,3
HR,ZA,2019.0,1,0,1
NP,NA,2014.0,1,0,1
MU,ZA,2013.0,2,0,2
QA,,2011.0,33,0,33
IS,EE,2014.0,1,0,1
KR,IR,2006.0,1,0,1
,LS,1998.0,1,0,1
NZ,SA,2012.0,3,0,3
SG,GW,2004.0,1,0,1
BD,BE,2000.0,2,0,2
RO,EC,2020.0,1,0,1
SE,SC,2012.0,1,0,1
DE,KP,2020.0,2,0,2
AU,RE,2006.0,1,0,1
,GP,2005.0,14,0,14
PS,,2002.0,4,0,4
BN,OM,2011.0,1,0,1
BF,,2015.0,31,0,31
UG,CN,2004.0,1,0,1
CU,HT,2012.0,2,0,2
AE,AF,2017.0,1,0,1
,ER,2015.0,8,0,8
GT,PL,2019.0,1,0,1
PS,BH,2019.0,2,0,2
BY,,2000.0,52,0,52
NA,DE,1998.0,1,0,1
RO,KZ,2020.0,2,0,2
JM,FR,2011.0,2,0,2
SI,GR,2014.0,1,0,1
IN,AE,2002.0,3,0,3
JO,PT,2015.0,2,0,2
UZ,ES,2014.0,1,0,1
MY,KR,2000.0,1,0,1
,SS,2016.0,10,0,10
,MR,2010.0,15,0,15
AO,CH,2013.0,1,0,1
SD,,2001.0,11,0,11
PK,AF,2010.0,1,0,1
,JM,2000.0,45,0,45
TR,UZ,2012.0,2,0,2
AM,IE,1997.0,1,0,1
CN,NE,2016.0,1,0,1
MK,FR,2010.0,1,0,1
TR,JO,1998.0,1,0,1
KH,,2003.0,1,0,1
BY,TR,2012.0,1,0,1
MZ,CH,2012.0,1,0,1
,LI,2005.0,7,0,7
SV,EC,2009.0,1,0,1
CY,PL,2000.0,1,0,1
CA,GN,2013.0,1,0,1
SN,MA,2002.0,1,0,1
TL,MY,2020.0,1,0,1
KR,DK,1999.0,3,0,3
CN,BY,2010.0,6,0,6
CH,TW,2000.0,2,0,2
,GP,2002.0,14,0,14
GI,US,2009.0,1,0,1
NO,MA,2020.0,2,0,2
PA,,2005.0,8,0,8
XK,ID,2018.0,1,0,1
OM,IE,2017.0,1,0,1
EE,SG,2013.0,2,0,2
,MQ,2003.0,14,0,14
,RE,1999.0,10,0,10
MA,CN,2011.0,1,0,1
AT,JO,2018.0,1,0,1
MC,MA,2019.0,2,0,2
BE,UY,2010.0,1,0,1
HK,,2006.0,5,0,5
KW,FJ,2003.0,1,0,1
PL,PT,2006.0,4,0,4
XK,,1998.0,1,0,1
BA,CZ,2010.0,3,0,3
PT,CO,2004.0,3,0,3
GR,ZA,2013.0,4,0,4
SM,,2024.0,11,0,11
DK,IQ,2017.0,3,0,3
,MV,2001.0,1,0,1
HK,ID,2019.0,1,0,1
GM,EG,2016.0,2,0,2
BR,UG,2008.0,1,0,1
ID,AM,2007.0,3,0,3
BH,DZ,2020.0,1,0,1
PK,ID,2007.0,3,0,3
MQ,,2006.0,6,0,6
LB,CU,2004.0,5,0,5
CH,ZM,2019.0,2,0,2
US,GY,2006.0,1,0,1
EG,PE,2019.0,1,0,1
,MR,2019.0,2,0,2
GT,CH,2022.0,1,0,1
TM,,2021.0,2,0,2
SE,BD,2010.0,6,0,6
,FJ,2000.0,13,0,13
IS,IQ,2019.0,2,0,2
AT,ZA,2006.0,1,0,1
IL,ET,2008.0,1,0,1
AW,,2024.0,1,0,1
NP,SA,2015.0,2,0,2
EC,GB,2006.0,1,0,1
IL,SE,2009.0,8,0,8
HU,BY,2006.0,2,0,2
ZA,OM,2020.0,1,0,1
PL,CR,2018.0,2,0,2
TH,MN,2001.0,1,0,1
NL,CR,2011.0,3,0,3
,LI,2002.0,3,0,3
GT,JP,2000.0,1,0,1
SD,AT,2016.0,1,0,1
RW,CH,2016.0,1,0,1
TH,NO,2009.0,3,0,3
CU,nan,2007.0,3,0,3
AT,CU,2000.0,2,0,2
AL,HU,2014.0,1,0,1
CA,JO,2000.0,3,0,3
GH,UA,2003.0,1,0,1
MX,PK,2017.0,5,0,5
IQ,NZ,2008.0,1,0,1
IL,VE,2014.0,2,0,2
IL,PH,2004.0,3,0,3
YE,BE,2014.0,1,0,1
AR,GM,2021.0,1,0,1
AM,TW,2005.0,1,0,1
SK,IQ,2014.0,1,0,1
US,HT,2007.0,3,0,3
UY,IN,2018.0,1,0,1
MG,SN,2003.0,2,0,2
BW,ES,2018.0,1,0,1
KE,SD,2012.0,2,0,2
UA,KZ,2013.0,5,0,5
JO,IL,2003.0,2,0,2
NG,NI,2014.0,1,0,1
IT,RE,2006.0,1,0,1
PK,TH,1999.0,3,0,3
FJ,LK,2021.0,1,0,1
RE,MQ,2012.0,1,0,1
FJ,MX,2012.0,1,0,1
,NI,2005.0,13,0,13
MX,BA,2017.0,1,0,1
LV,CO,2018.0,1,0,1
NP,KE,2020.0,1,0,1
IN,SL,2018.0,1,0,1
GY,,2024.0,17,0,17
SY,MX,2015.0,1,0,1
CA,GF,2018.0,1,0,1
LS,,2014.0,1,0,1
VG,BR,2019.0,1,0,1
PT,CZ,2008.0,4,0,4
CG,,2014.0,12,0,12
CH,BY,2017.0,2,0,2
TN,PA,2011.0,2,0,2
FR,SY,1999.0,4,0,4
SN,BF,2021.0,5,0,5
ML,BJ,2006.0,3,0,3
FI,CG,2015.0,1,0,1
AG,CA,2007.0,1,0,1
AL,FR,2002.0,1,0,1
IS,NA,2019.0,1,0,1
LB,IR,2008.0,1,0,1
PH,KW,2004.0,1,0,1
NO,TZ,1999.0,1,0,1
JO,IR,2007.0,6,0,6
,VU,2007.0,1,0,1
PK,JO,2006.0,1,0,1
PL,BD,2004.0,1,0,1
KW,IT,2016.0,1,0,1
ER,,2007.0,4,0,4
GM,GH,2008.0,2,0,2
CH,ZM,2017.0,1,0,1
MY,GH,1997.0,1,0,1
BZ,,2007.0,3,0,3
,BI,1999.0,4,0,4
IL,NO,2007.0,4,0,4
MG,KH,2014.0,1,0,1
JP,KZ,2003.0,1,0,1
TR,IS,2018.0,2,0,2
CZ,DK,2007.0,2,0,2
CA,MU,2012.0,1,0,1
SE,NP,2009.0,1,0,1
VN,FR,2023.0,3,0,3
IS,BR,2017.0,1,0,1
IN,NG,2005.0,4,0,4
LY,JP,2002.0,4,0,4
KW,DE,2001.0,2,0,2
PE,SD,2006.0,1,0,1
EG,LK,2020.0,3,0,3
JP,PR,2010.0,1,0,1
LK,DK,2003.0,1,0,1
BG,SA,2014.0,3,0,3
CN,IS,2022.0,1,0,1
BG,CH,2000.0,4,0,4
CG,CA,2013.0,2,0,2
,WS,2001.0,2,0,2
TR,BE,1997.0,1,0,1
,MT,2020.0,3,0,3
IL,MY,2008.0,1,0,1
FR,AL,2001.0,1,0,1
MA,SI,2022.0,1,0,1
,JO,2020.0,44,0,44
BR,LT,2015.0,1,0,1
VE,ID,2016.0,4,0,4
TR,AR,2022.0,1,0,1
GR,SS,2016.0,1,0,1
CR,HN,2014.0,2,0,2
SG,KY,2018.0,1,0,1
VN,AE,2013.0,1,0,1
SV,AR,2018.0,3,0,3
,GY,1995.0,4,0,4
ML,KE,2018.0,2,0,2
,DJ,2018.0,2,0,2
ZA,MG,2022.0,1,0,1
FR,MW,2011.0,1,0,1
VN,UA,2012.0,1,0,1
UY,ST,2000.0,1,0,1
JP,EE,2011.0,1,0,1
BR,GT,2008.0,3,0,3
HU,ZA,2015.0,3,0,3
RW,NL,2012.0,1,0,1
RO,DK,2016.0,2,0,2
TR,BW,2009.0,1,0,1
CH,TH,2013.0,3,0,3
PS,OM,2021.0,1,0,1
DK,CO,2014.0,3,0,3
,AF,2020.0,3,0,3
ZM,,2000.0,5,0,5
LT,MZ,2002.0,3,0,3
GE,CN,2006.0,3,0,3
nan,UZ,2016.0,1,0,1
CU,PH,1999.0,1,0,1
SE,JO,2013.0,2,0,2
GB,GA,1997.0,1,0,1
BA,BE,2018.0,1,0,1
LU,UA,2011.0,1,0,1
TR,BA,2013.0,2,0,2
,TO,2012.0,1,0,1
LV,GH,2020.0,1,0,1
MG,NE,1998.0,1,0,1
DZ,SE,2010.0,1,0,1
VN,KR,1999.0,1,0,1
UA,NO,2011.0,3,0,3
BD,CH,2013.0,3,0,3
MA,CI,2012.0,2,0,2
BH,SE,2003.0,3,0,3
LY,JP,2005.0,1,0,1
IE,LV,2012.0,2,0,2
KE,EG,2004.0,1,0,1
VG,IN,2019.0,2,0,2
PK,GN,2019.0,1,0,1
YE,OM,2021.0,1,0,1
CY,nan,2015.0,3,0,3
KE,CM,2005.0,1,0,1
AT,CY,2005.0,1,0,1
TT,GP,2014.0,1,0,1
AT,VN,2014.0,1,0,1
GB,BS,2014.0,2,0,2
ZA,CO,2011.0,3,0,3
AZ,TJ,2011.0,2,0,2
SK,FI,2015.0,4,0,4
SY,SD,2014.0,2,0,2
SM,GB,2004.0,1,0,1
KZ,DZ,2019.0,1,0,1
SG,KW,2009.0,1,0,1
FR,PS,2010.0,3,0,3
ET,NZ,2010.0,1,0,1
MY,EC,2006.0,1,0,1
HN,CO,1999.0,1,0,1
LB,BR,2001.0,3,0,3
SG,VN,2023.0,1,0,1
OM,IT,2011.0,1,0,1
GH,MY,2011.0,1,0,1
PT,GE,2005.0,1,0,1
CU,PA,2012.0,3,0,3
,NE,2020.0,1,0,1
MM,DE,2022.0,2,0,2
TO,IT,2021.0,1,0,1
SD,NL,2005.0,2,0,2
AO,,2003.0,3,0,3
BA,,1998.0,1,0,1
ML,SA,2016.0,1,0,1
BG,AM,2017.0,1,0,1
AL,NO,2019.0,1,0,1
GB,MA,2006.0,5,0,5
UY,GB,2021.0,1,0,1
LB,CO,2015.0,2,0,2
VE,PT,1999.0,3,0,3
TN,KR,2012.0,1,0,1
MX,TZ,2020.0,1,0,1
CU,SA,2017.0,1,0,1
IL,ML,2009.0,1,0,1
US,LY,2008.0,2,0,2
HR,BE,2009.0,3,0,3
ZA,AR,2021.0,3,0,3
VN,AU,2000.0,2,0,2
SN,CI,2006.0,1,0,1
TW,ZA,2000.0,1,0,1
PL,HR,2014.0,4,0,4
ES,AD,2014.0,2,0,2
nan,IE,2000.0,4,0,4
MM,VN,2019.0,1,0,1
ZM,IR,2014.0,1,0,1
KE,SY,2012.0,1,0,1
SE,GE,2021.0,1,0,1
ZW,MW,2020.0,1,0,1
ES,AL,2018.0,2,0,2
AR,JO,2019.0,2,0,2
QA,GA,2022.0,1,0,1
KH,PT,2015.0,1,0,1
,CG,2000.0,14,0,14
AU,RW,2019.0,1,0,1
MX,PK,2010.0,1,0,1
BY,AT,2003.0,1,0,1
DE,TJ,2011.0,1,0,1
MD,CA,2009.0,4,0,4
MW,ZM,2017.0,2,0,2
TN,PK,2021.0,6,0,6
CN,MK,2022.0,1,0,1
MX,BA,2010.0,3,0,3
CZ,PS,2018.0,1,0,1
BR,MQ,2017.0,1,0,1
YE,QA,2012.0,2,0,2
ML,,2005.0,3,0,3
LT,MX,2010.0,1,0,1
CG,BJ,2014.0,4,0,4
DZ,RS,2021.0,1,0,1
PA,,2002.0,4,0,4
NG,NA,2001.0,1,0,1
AE,BR,2016.0,3,0,3
PR,AR,2008.0,1,0,1
UZ,DE,2000.0,4,0,4
ES,CV,2011.0,1,0,1
KE,EC,2017.0,1,0,1
GP,GF,2021.0,1,0,1
IS,EG,2016.0,1,0,1
CA,MC,2010.0,2,0,2
CO,FI,2003.0,1,0,1
TR,RW,2010.0,5,0,5
GH,MX,2022.0,1,0,1
CZ,SG,2007.0,1,0,1
PT,MM,2020.0,1,0,1
EG,MK,2003.0,1,0,1
OM,TN,2012.0,1,0,1
RO,FI,2012.0,1,0,1
PH,IN,2002.0,6,0,6
BJ,MG,2014.0,2,0,2
TW,BG,2014.0,1,0,1
PH,NG,2014.0,1,0,1
IL,GE,2008.0,1,0,1
BD,AE,2007.0,1,0,1
DK,ZW,2000.0,1,0,1
MX,PH,1999.0,1,0,1
MW,ML,2001.0,1,0,1
LB,JP,2009.0,1,0,1
CO,SK,2013.0,1,0,1
IR,NE,2015.0,1,0,1
VE,IN,2016.0,1,0,1
IE,DO,2020.0,1,0,1
ZA,MZ,2010.0,2,0,2
GR,IR,2011.0,2,0,2
ES,GW,2015.0,1,0,1
BE,KH,2011.0,1,0,1
PE,BE,2011.0,2,0,2
UA,PT,2022.0,1,0,1
ZM,nan,2001.0,1,0,1
RO,SY,2020.0,1,0,1
TG,NL,2014.0,1,0,1
FR,ET,2022.0,1,0,1
FI,LV,1998.0,1,0,1
TN,nan,2007.0,3,0,3
NL,SV,2004.0,1,0,1
IR,AR,2016.0,1,0,1
PK,CZ,2015.0,4,0,4
IN,LT,2012.0,1,0,1
SC,GB,2005.0,1,0,1
DE,SR,2018.0,1,0,1
AE,NA,2002.0,1,0,1
CL,AT,2007.0,1,0,1
PH,DK,2016.0,3,0,3
PA,nan,2020.0,1,0,1
SV,NI,2019.0,1,0,1
DO,AU,2015.0,1,0,1
SI,PK,2019.0,2,0,2
IL,FI,2023.0,1,1,0
VG,IN,2017.0,2,1,1
BR,KR,1999.0,1,3,-2
UA,BG,2006.0,3,3,0
KE,SA,2021.0,1,1,0
JO,DE,1999.0,1,2,-1
SA,BR,2014.0,2,1,1
AM,JP,2015.0,2,2,0
KG,US,2017.0,3,4,-1
DE,SY,2005.0,1,2,-1
NZ,NO,1999.0,1,1,0
GE,NO,2018.0,1,1,0
HR,IT,2002.0,3,4,-1
FR,KZ,2007.0,1,3,-2
PA,NL,2017.0,3,2,1
AR,PA,2022.0,1,4,-3
KR,OM,2019.0,1,1,0
IE,IL,2018.0,3,5,-2
EG,PK,2003.0,1,2,-1
SE,NA,2013.0,1,1,0
KE,BR,2007.0,1,1,0
GE,NZ,2008.0,1,1,0
BB,US,2009.0,2,3,-1
GN,CN,2018.0,2,3,-1
NG,FI,2015.0,1,2,-1
CI,MA,2013.0,1,1,0
TR,BG,2016.0,1,1,0
NO,EE,2020.0,3,5,-2
AM,KZ,2022.0,1,1,0
NZ,UG,2017.0,6,1,5
PK,AT,2012.0,2,25,-23
FI,ZA,2014.0,3,5,-2
NZ,FJ,2016.0,2,3,-1
JP,VE,2014.0,1,2,-1
PF,US,1999.0,1,1,0
PK,CL,2014.0,1,1,0
IN,NG,2002.0,2,1,1
HN,US,2002.0,1,1,0
YE,MY,2015.0,3,13,-10
MX,KE,2014.0,2,2,0
MY,LB,2018.0,2,4,-2
SK,SE,2000.0,2,4,-2
PA,AR,2011.0,2,2,0
NZ,KE,2007.0,1,1,0
GT,US,1999.0,1,2,-1
NG,NZ,2016.0,3,2,1
GE,HU,2019.0,1,1,0
PS,MA,2020.0,1,1,0
US,FJ,2016.0,2,1,1
VE,IT,2003.0,4,4,0
BE,SD,2012.0,2,1,1
RU,ZW,2007.0,1,1,0
SE,ZW,2017.0,1,1,0
AG,IN,2019.0,1,1,0
CA,TZ,2011.0,3,1,2
CY,SE,2021.0,1,1,0
PK,RO,2021.0,1,3,-2
JP,HR,2005.0,1,3,-2
IE,AT,2020.0,4,15,-11
KZ,UA,2006.0,1,2,-1
GB,CD,2017.0,1,1,0
SE,SI,2022.0,1,1,0
CH,GE,2020.0,2,1,1
AE,IE,2010.0,1,1,0
ZM,BR,2010.0,3,2,1
HK,AU,2008.0,1,2,-1
CH,LI,2018.0,1,1,0
GR,BR,2022.0,1,2,-1
NZ,BD,2022.0,1,4,-3
ET,ZA,2005.0,2,2,0
RS,SI,1998.0,1,1,0
MX,UY,2004.0,3,4,-1
BY,UA,2000.0,2,2,0
CG,NG,2016.0,2,1,1
UA,AT,2000.0,2,1,1
GB,IQ,2006.0,1,1,0
GB,AL,2006.0,1,1,0
IS,CZ,2019.0,1,1,0
ME,BE,2017.0,1,1,0
BF,US,2011.0,1,3,-2
FI,AT,2007.0,1,6,-5
QA,BA,2018.0,1,1,0
UY,VE,2018.0,1,4,-3
AT,NP,2012.0,1,1,0
MK,IN,2022.0,1,1,0
IQ,PS,2019.0,1,2,-1
TN,GR,2020.0,1,1,0
BN,US,2013.0,1,2,-1
nan,TH,2019.0,2,3,-1
SN,NG,2019.0,2,2,0
CO,CZ,2014.0,1,2,-1
CI,SN,2011.0,1,3,-2
GR,SA,2015.0,3,2,1
SO,US,2021.0,1,2,-1
LU,SE,2018.0,1,4,-3
EE,BE,2016.0,3,3,0
PS,IT,2020.0,2,4,-2
KR,OM,2017.0,3,1,2
BB,CA,2004.0,1,1,0
NZ,PL,2008.0,2,3,-1
FJ,US,2000.0,1,1,0
PT,BD,2013.0,2,2,0
ZW,NG,2009.0,1,1,0
KR,PT,2008.0,1,3,-2
CH,NG,2016.0,1,1,0
TW,RO,2021.0,1,1,0
CH,TN,2004.0,1,1,0
KE,JP,2013.0,1,7,-6
VE,UY,2001.0,1,2,-1
AT,NZ,1997.0,1,2,-1
EG,SD,2003.0,1,2,-1
IR,DK,2008.0,2,3,-1
IL,HU,2020.0,1,4,-3
RO,AT,2009.0,1,3,-2
PK,OM,2008.0,1,1,0
KE,BJ,2015.0,1,1,0
ES,DO,2010.0,1,3,-2
ID,BJ,2019.0,1,2,-1
FR,OM,2008.0,1,1,0
GR,LT,2011.0,1,1,0
BF,BJ,2016.0,2,3,-1
JO,KR,2017.0,1,3,-2
MY,BH,2013.0,1,3,-2
IR,JP,2000.0,2,6,-4
DZ,JP,2010.0,1,1,0
QA,AT,2014.0,1,1,0
LB,MA,2005.0,1,1,0
TZ,NO,2002.0,2,3,-1
VE,PY,2007.0,1,1,0
VN,PE,2020.0,1,1,0
ID,MX,2001.0,1,1,0
IQ,ZA,2019.0,1,1,0
PL,CO,2022.0,1,1,0
IS,AU,2014.0,1,1,0
BE,HK,2015.0,1,1,0
ZA,SK,2021.0,1,1,0
PL,TR,2022.0,1,5,-4
CN,NG,2023.0,1,5,-4
CN,AE,2010.0,2,2,0
TW,HU,2021.0,1,1,0
CR,UY,2007.0,1,1,0
TN,OM,2015.0,1,3,-2
MD,US,2021.0,3,3,0
SL,GB,2005.0,1,1,0
UA,UZ,2014.0,1,3,-2
RU,ET,2021.0,2,2,0
MU,US,2017.0,1,2,-1
CZ,GH,2022.0,3,1,2
GB,VE,1997.0,1,1,0
GR,KE,2013.0,1,1,0
MK,DE,2022.0,1,1,0
nan,TH,2017.0,1,2,-1
UG,NZ,2007.0,1,2,-1
IE,TH,2019.0,1,1,0
LU,DK,2009.0,1,1,0
DZ,nan,2010.0,1,8,-7
HU,TR,2003.0,1,1,0
PL,SG,2008.0,1,1,0
IR,RO,2021.0,1,1,0
CN,PF,2019.0,1,1,0
KE,TZ,1998.0,1,1,0
CO,IN,2008.0,1,1,0
VN,IT,2012.0,1,4,-3
IL,NZ,2002.0,1,2,-1
IL,GR,2012.0,1,2,-1
JE,GB,2013.0,1,3,-2
TG,BJ,2022.0,1,2,-1
CA,MC,2019.0,1,1,0
KR,RW,2020.0,1,1,0
BH,CA,2016.0,1,1,0
IQ,YE,2022.0,1,1,0
SI,SK,2007.0,1,1,0
SA,DK,2022.0,1,2,-1
EE,SK,2016.0,1,1,0
LV,PL,2015.0,1,1,0
SA,NO,2017.0,1,1,0
JP,HR,2002.0,1,2,-1
NZ,TH,2004.0,1,3,-2
US,AF,2008.0,3,1,2
NZ,LK,2013.0,2,8,-6
EE,UA,2022.0,1,1,0
DE,CU,1997.0,1,2,-1
LU,CN,2018.0,2,1,1
IS,IN,2012.0,1,1,0
GB,CR,2006.0,1,2,-1
BE,CW,2002.0,3,1,2
NL,BD,2018.0,3,1,2
AT,CZ,1997.0,4,2,2
SN,AU,2012.0,1,1,0
GM,PK,2016.0,1,1,0
PH,IN,2005.0,1,3,-2
SA,BE,2013.0,1,2,-1
CA,BG,2006.0,1,5,-4
BD,KW,2017.0,1,1,0
BR,MZ,2008.0,2,3,-1
CA,ET,1997.0,1,1,0
NL,ZW,2012.0,1,3,-2
AL,TR,2018.0,1,1,0
PK,ZM,2015.0,1,1,0
nan,GH,2008.0,1,1,0
IT,VN,2004.0,1,3,-2
EG,MX,2006.0,1,2,-1
UA,TH,2015.0,1,0,1
SD,BD,2016.0,2,0,2
NG,PL,2013.0,1,0,1
AM,AT,2019.0,1,0,1
IR,EE,2015.0,1,0,1
CY,DE,1998.0,1,0,1
FI,ET,2011.0,2,0,2
TR,MN,2021.0,1,0,1
GH,IL,2021.0,1,0,1
CI,CH,1999.0,1,0,1
GW,US,2017.0,3,0,3
TN,GB,2004.0,2,0,2
US,MG,2004.0,1,0,1
IE,IS,2020.0,1,0,1
NO,BH,2021.0,1,0,1
PH,BN,2004.0,1,0,1
AO,DE,2005.0,1,0,1
LB,CR,2009.0,2,0,2
GW,NL,2009.0,1,0,1
OM,FR,2003.0,1,0,1
NA,,2001.0,3,0,3
AR,AO,2003.0,1,0,1
TN,IL,2003.0,1,0,1
DO,AR,2016.0,2,0,2
BH,KR,2010.0,2,0,2
IT,KP,2018.0,1,0,1
LI,EE,2005.0,1,0,1
CU,CA,2000.0,1,0,1
HR,NZ,2011.0,1,0,1
NL,BF,2009.0,1,0,1
PL,TN,2018.0,1,0,1
ZA,KH,2021.0,1,0,1
AT,BG,2014.0,3,0,3
SE,GW,2016.0,1,0,1
JP,PY,2008.0,1,0,1
TH,IR,2011.0,1,0,1
GM,,2001.0,2,0,2
AU,WS,2014.0,1,0,1
BF,NL,2006.0,2,0,2
CN,ST,2007.0,1,0,1
GB,PY,2020.0,2,0,2
IR,GR,2004.0,1,0,1
ML,CH,2012.0,1,0,1
DE,CU,1998.0,2,0,2
EG,CH,2001.0,1,0,1
CY,NL,2011.0,1,0,1
BF,SN,2001.0,1,0,1
ZA,EE,2009.0,1,0,1
MM,KH,2020.0,1,0,1
NG,TT,1999.0,1,0,1
IQ,LY,2003.0,1,0,1
LY,AE,2012.0,2,0,2
LV,EE,2009.0,1,0,1
ET,MX,2011.0,1,0,1
SY,DZ,2016.0,1,0,1
NO,FO,1999.0,1,0,1
LR,,2002.0,1,0,1
FO,,2006.0,1,0,1
GR,CM,2018.0,1,0,1
NE,GH,2022.0,1,0,1
XK,OM,2018.0,1,0,1
KE,AT,2023.0,1,0,1
US,FO,2001.0,1,0,1
IT,NC,2001.0,1,0,1
MK,FI,2011.0,1,0,1
BA,RO,2021.0,1,0,1
UG,AU,2012.0,1,0,1
CF,CH,2016.0,1,0,1
BN,EG,2021.0,1,0,1
PE,ZM,2021.0,1,0,1
CO,JO,2005.0,1,0,1
BI,CM,2018.0,1,0,1
RS,LU,2016.0,1,0,1
EC,JP,2015.0,1,0,1
GR,CN,1998.0,1,0,1
CU,NO,2005.0,1,0,1
VE,NI,2005.0,1,0,1
CH,BO,2014.0,1,0,1
nan,KW,2013.0,1,0,1
NI,VE,2001.0,1,0,1
UZ,GE,2004.0,2,0,2
ML,,2002.0,3,0,3
ZA,TG,2008.0,1,0,1
BW,NA,2021.0,1,0,1
UG,BR,2019.0,1,0,1
GE,TJ,2022.0,1,0,1
CH,KZ,2016.0,2,0,2
UZ,QA,2018.0,1,0,1
ES,SM,2019.0,1,0,1
CH,JM,2021.0,1,0,1
CY,DE,1997.0,1,0,1
BR,QA,2021.0,3,0,3
GB,HN,2004.0,1,0,1
DE,VG,2013.0,1,0,1
PS,AE,2015.0,1,0,1
AU,JE,2022.0,1,0,1
PK,PY,2018.0,1,0,1
ZA,JM,2007.0,1,0,1
,LS,1997.0,4,0,4
CN,JO,2000.0,1,0,1
AL,AU,2019.0,1,0,1
BY,IL,2023.0,1,0,1
ZM,BE,2022.0,1,0,1
BH,AU,2012.0,1,0,1
GB,NE,1998.0,1,0,1
JO,KR,2019.0,1,0,1
MK,RU,2007.0,2,0,2
NL,MM,2018.0,1,0,1
,BM,2012.0,3,0,3
SE,CW,2010.0,1,0,1
GF,NZ,2014.0,1,0,1
SK,NZ,2022.0,1,0,1
DE,GH,1998.0,3,0,3
BD,LK,2014.0,1,0,1
PR,JP,2009.0,1,0,1
PT,PA,2009.0,1,0,1
NP,CZ,2014.0,1,0,1
IN,PG,2018.0,2,0,2
BA,nan,2008.0,1,0,1
SV,SE,2013.0,1,0,1
SD,MZ,2019.0,1,0,1
DK,MD,2017.0,1,0,1
BR,UZ,2014.0,1,0,1
NO,BD,2006.0,1,0,1
ES,NP,2011.0,1,0,1
MW,DE,2005.0,1,0,1
,RW,2001.0,2,0,2
SI,IN,2017.0,1,0,1
MA,KR,2021.0,1,0,1
KR,TN,2008.0,1,0,1
RO,NZ,2004.0,1,0,1
GA,ZA,2018.0,1,0,1
SD,CY,2021.0,1,0,1
NG,TG,2018.0,1,0,1
VE,PH,2022.0,1,0,1
EG,AU,2004.0,1,0,1
MU,TH,2018.0,1,0,1
ME,AE,2020.0,1,0,1
NE,CA,2013.0,1,0,1
BY,MX,2000.0,1,0,1
PA,BR,2002.0,1,0,1
ZM,EG,2006.0,1,0,1
NE,CD,2019.0,1,0,1
KW,KR,2005.0,1,0,1
UZ,AT,2015.0,1,0,1
RS,AL,2012.0,1,0,1
BW,GB,2002.0,1,0,1
IE,FJ,2010.0,1,0,1
NZ,UG,2010.0,1,0,1
UA,TW,2012.0,1,0,1
SN,KR,2012.0,1,0,1
BE,MY,1997.0,1,0,1
PH,CY,2019.0,1,0,1
UG,MW,2011.0,1,0,1
GW,US,2019.0,1,0,1
,GT,2020.0,1,0,1
TZ,TH,2022.0,1,0,1
nan,RW,2006.0,1,0,1
CH,SM,1997.0,1,0,1
NZ,MW,2013.0,1,0,1
IR,CL,2016.0,1,0,1
PL,QA,2002.0,1,0,1
CG,NC,2014.0,1,0,1
HU,LY,2012.0,1,0,1
nan,EG,2012.0,1,0,1
QA,GL,2003.0,1,0,1
MQ,US,2009.0,1,0,1
IS,BR,2019.0,1,0,1
JO,BE,2013.0,1,0,1
GE,TW,2019.0,1,0,1
BJ,GA,2016.0,1,0,1
DK,AM,2018.0,1,0,1
KP,CO,2014.0,1,0,1
ID,MM,2016.0,1,0,1
KR,MW,2006.0,1,0,1
BF,NE,2013.0,1,0,1
MK,CH,2017.0,2,0,2
SE,MW,2016.0,1,0,1
XK,AL,2007.0,1,0,1
QA,CY,2019.0,1,0,1
IE,TT,1999.0,1,0,1
LB,KH,2021.0,1,0,1
CY,SI,2018.0,1,0,1
HU,PH,2000.0,1,0,1
ET,ZA,2002.0,2,0,2
CM,NE,2018.0,1,0,1
MM,CH,2012.0,1,0,1
GM,KR,2008.0,1,0,1
MZ,AU,2006.0,1,0,1
CN,ZM,2012.0,1,0,1
JM,CU,2012.0,1,0,1
GW,ES,2016.0,1,0,1
TT,SI,2004.0,1,0,1
JM,CO,2009.0,1,0,1
FR,SV,2015.0,1,0,1
TD,,2016.0,1,0,1
AE,BH,2003.0,1,0,1
MO,PT,2011.0,1,0,1
TR,QA,2006.0,1,0,1
SI,AZ,2021.0,1,0,1
NL,VG,2002.0,1,0,1
CU,ID,2013.0,1,0,1
LK,SA,2014.0,1,0,1
ST,MZ,2014.0,1,0,1
PT,KZ,2021.0,1,0,1
US,MQ,2005.0,1,0,1
SI,LT,2013.0,1,0,1
PH,AE,2018.0,1,0,1
RO,BI,2018.0,1,0,1
LB,TR,2000.0,1,0,1
UG,GN,2015.0,1,0,1
SG,TR,2003.0,1,0,1
MW,DE,2002.0,1,0,1
NO,SA,1999.0,1,0,1
RO,BW,2017.0,1,0,1
ET,PR,2005.0,1,0,1
IL,EE,2014.0,2,0,2
MX,ET,2008.0,1,0,1
IN,CY,2007.0,1,0,1
ET,NZ,2019.0,1,0,1
GB,BT,2010.0,1,0,1
UA,AZ,2017.0,1,0,1
FI,DZ,2008.0,1,0,1
CM,NO,2008.0,1,0,1
IN,ER,2012.0,1,0,1
IQ,AL,2012.0,1,0,1
IE,MM,2019.0,1,0,1
CA,BF,2007.0,1,0,1
GE,PL,2009.0,1,0,1
CW,FI,2009.0,1,0,1
KR,RO,2020.0,1,0,1
EE,ME,2018.0,1,0,1
ID,SA,2001.0,1,0,1
DE,FJ,2016.0,1,0,1
IQ,BD,2023.0,1,0,1
US,KN,1997.0,1,0,1
WS,GB,2012.0,1,0,1
FR,SD,2003.0,1,0,1
LK,IL,2010.0,1,0,1
RW,KR,2021.0,1,0,1
ES,SA,1998.0,1,0,1
CZ,MY,1999.0,1,0,1
AT,NG,2012.0,1,0,1
SR,BE,2021.0,2,0,2
BE,MD,2019.0,1,0,1
CA,TN,2023.0,1,0,1
ES,PG,2021.0,1,0,1
SG,ET,2001.0,1,0,1
AM,TR,2018.0,1,0,1
US,JP,2006.0,1795,1894,-99
CA,US,2013.0,3308,3254,54
US,IN,2019.0,3040,3363,-323
GB,US,2021.0,4594,4863,-269
nan,SG,2013.0,18,9,9
ES,IT,2017.0,249,291,-42
DE,CH,2004.0,571,392,179
CN,SG,2022.0,317,454,-137
ES,BR,2016.0,439,324,115
US,CN,2003.0,4608,3440,1168
IN,US,2008.0,1498,1362,136
ES,IT,2010.0,155,247,-92
RO,CA,2018.0,11,15,-4
FR,RO,2005.0,39,33,6
GB,IE,2008.0,272,254,18
TW,JP,2013.0,59,79,-20
AT,DE,2013.0,533,605,-72
MY,IR,2016.0,246,80,166
IT,BR,2011.0,228,189,39
CR,ES,2013.0,43,50,-7
US,IN,2010.0,1838,1776,62
GB,JP,2001.0,239,227,12
KR,JP,2008.0,240,279,-39
EG,US,1997.0,45,39,6
CN,BE,2014.0,75,55,20
US,NZ,2020.0,408,407,1
SA,MA,2021.0,11,12,-1
DK,FR,1997.0,13,16,-3
AU,CN,2022.0,480,332,148
GB,CA,2016.0,861,919,-58
IT,SE,2016.0,116,77,39
PK,CN,2007.0,76,30,46
KR,IN,2013.0,112,186,-74
BE,VN,2015.0,18,2,16
IE,GB,2004.0,152,208,-56
BG,RU,2022.0,21,76,-55
IN,PK,2014.0,216,207,9
PL,US,2012.0,206,240,-34
CA,PH,2017.0,7,10,-3
US,DE,1998.0,1385,1424,-39
FR,MA,2014.0,335,250,85
NZ,CN,2014.0,42,40,2
US,BO,2015.0,8,9,-1
FR,SE,2014.0,80,81,-1
CL,GB,2022.0,30,33,-3
IE,US,2006.0,295,376,-81
HU,US,2003.0,90,81,9
FR,GB,2007.0,527,437,90
FI,US,2009.0,127,233,-106
RU,DE,2002.0,172,107,65
US,IN,2017.0,2664,2901,-237
CN,NA,2017.0,1,1,0
IE,CA,2020.0,147,161,-14
GB,SG,2007.0,89,91,-2
ML,FR,2017.0,12,18,-6
US,CH,2008.0,713,595,118
AE,SD,2013.0,1,2,-1
CN,nan,2015.0,114,132,-18
US,TR,2018.0,449,525,-76
FR,CH,2004.0,280,227,53
ES,UY,2016.0,72,56,16
FR,AR,2013.0,85,84,1
US,FR,2009.0,1253,1308,-55
NL,DE,2004.0,208,203,5
BE,NL,2007.0,199,193,6
NL,BE,2012.0,279,218,61
CN,TW,2009.0,772,1157,-385
GB,GR,2014.0,178,287,-109
DE,TR,2013.0,81,54,27
ZA,NG,2021.0,92,106,-14
IT,CN,2004.0,32,10,22
BR,PT,2001.0,165,203,-38
BE,ES,2012.0,49,66,-17
HR,SI,2017.0,32,34,-2
MG,SN,2014.0,1,1,0
AU,PG,2018.0,8,8,0
AU,CA,2012.0,318,382,-64
DE,nan,2022.0,34,40,-6
IN,SG,2015.0,117,115,2
US,IL,2004.0,283,465,-182
AU,GB,1999.0,571,521,50
CA,PK,2019.0,65,40,25
CA,DK,2014.0,43,30,13
IT,AR,2015.0,116,106,10
GB,RO,2022.0,35,27,8
FR,IT,2018.0,369,483,-114
CA,PK,2017.0,45,45,0
DK,AU,2006.0,21,13,8
IT,CA,2022.0,85,71,14
PH,AU,2009.0,11,8,3
DK,BE,2011.0,13,20,-7
MA,FR,2006.0,187,234,-47
US,MX,2022.0,165,260,-95
PT,BR,2000.0,176,156,20
US,FI,2007.0,157,121,36
IT,CZ,1998.0,21,19,2
SG,CH,2017.0,18,20,-2
CH,TR,2013.0,20,24,-4
NZ,AU,2018.0,230,207,23
KR,PR,2017.0,32,34,-2
ES,RU,2016.0,35,18,17
AT,JP,2011.0,16,17,-1
GR,BE,2016.0,22,14,8
CN,DK,2016.0,45,44,1
CA,CN,2009.0,495,347,148
ES,IT,2019.0,303,295,8
CA,FR,2014.0,559,623,-64
CA,CL,2020.0,28,22,6
NL,CN,2001.0,36,24,12
nan,FR,2018.0,200,183,17
KR,CN,2000.0,73,61,12
CL,AR,2014.0,94,101,-7
NP,IN,2014.0,121,85,36
IE,IN,2011.0,18,19,-1
US,SA,2017.0,287,219,68
CO,DE,2006.0,10,8,2
VE,AR,2021.0,19,7,12
FR,NL,2012.0,175,180,-5
ZA,IN,2021.0,43,47,-4
ZA,ZW,2022.0,26,33,-7
IQ,EG,2021.0,75,94,-19
CN,PH,2009.0,22,25,-3
IR,MY,2012.0,95,105,-10
BR,LB,2016.0,4,2,2
BD,KR,2018.0,36,37,-1
CO,AU,2013.0,11,10,1
KR,NL,2021.0,13,10,3
PL,GB,2017.0,134,124,10
BE,CH,2019.0,101,76,25
IN,GB,2022.0,352,301,51
GH,IN,2015.0,5,11,-6
nan,BR,2023.0,6,4,2
ES,SA,2008.0,4,2,2
CO,US,2006.0,114,157,-43
FR,PL,2006.0,44,47,-3
nan,CA,2016.0,157,43,114
IN,NP,2009.0,43,41,2
SN,BJ,2021.0,3,1,2
NL,IT,2015.0,92,139,-47
NO,DE,2014.0,68,103,-35
IN,PL,2021.0,25,13,12
GB,FR,2012.0,559,523,36
FR,AU,2013.0,140,105,35
US,PH,2020.0,228,339,-111
BH,IN,2016.0,2,1,1
HK,CN,2008.0,50,59,-9
CN,IE,2005.0,18,15,3
RO,CN,2004.0,1,1,0
CN,NO,2008.0,26,29,-3
SE,NL,2016.0,75,75,0
MM,CN,2010.0,7,5,2
FR,CI,2020.0,24,30,-6
ZA,PK,2019.0,5,3,2
CN,NP,2011.0,30,10,20
US,BE,2008.0,247,218,29
JO,EG,2010.0,4,6,-2
PL,GB,2019.0,163,129,34
CL,ID,2020.0,13,15,-2
JP,MM,2013.0,9,3,6
AU,JP,2006.0,54,77,-23
DE,GH,2008.0,1,2,-1
SE,FI,2013.0,91,62,29
BH,ET,2016.0,5,14,-9
BR,AO,2020.0,53,23,30
PK,IQ,2019.0,28,27,1
EG,GB,2016.0,73,107,-34
ES,LB,2019.0,2,3,-1
US,NA,2020.0,7,1,6
ES,IN,2002.0,10,4,6
CH,IT,2002.0,98,114,-16
PS,IL,2017.0,4,3,1
SE,BO,2016.0,1,1,0
PT,NL,2016.0,34,24,10
JP,RU,2020.0,38,30,8
AE,SA,2013.0,16,17,-1
AT,CZ,2008.0,16,9,7
IL,FR,2016.0,38,36,2
IT,IL,2013.0,18,12,6
SE,TH,2011.0,5,6,-1
CN,VN,2014.0,45,20,25
AU,DK,2021.0,42,47,-5
CA,KW,2014.0,18,5,13
NZ,GB,1998.0,76,87,-11
US,BW,2018.0,8,11,-3
KR,PR,2019.0,39,42,-3
AU,OM,2013.0,5,2,3
CA,PK,2010.0,25,17,8
JP,SG,2014.0,44,42,2
TW,SA,2016.0,6,4,2
IT,PL,2021.0,36,38,-2
MK,SI,2017.0,2,3,-1
AR,IT,2016.0,95,116,-21
KR,MX,2009.0,3,1,2
BR,CA,2000.0,81,70,11
nan,ES,2013.0,41,33,8
GB,BY,2017.0,3,5,-2
RU,HU,2011.0,9,8,1
VN,CZ,2019.0,3,6,-3
CH,KR,2022.0,12,6,6
MZ,US,2021.0,2,1,1
EG,NL,2019.0,14,8,6
VE,IT,2014.0,9,2,7
JM,TT,2006.0,14,17,-3
BE,IL,2019.0,10,7,3
CN,IQ,2020.0,10,9,1
GE,FR,2018.0,2,3,-1
CO,PA,2019.0,19,29,-10
PL,CH,2020.0,34,27,7
SK,IT,2015.0,2,6,-4
MY,US,2014.0,142,171,-29
ID,IN,2021.0,91,78,13
HR,SI,2019.0,49,35,14
CA,PE,2010.0,7,2,5
JO,EG,2019.0,33,35,-2
ES,AU,2020.0,75,63,12
ET,DE,2022.0,13,4,9
CN,NL,2022.0,107,117,-10
SE,GB,1997.0,49,49,0
MA,IT,2014.0,38,25,13
GM,GB,2010.0,15,11,4
FR,RU,2014.0,94,74,20
PT,ES,2023.0,15,11,4
DE,MA,2007.0,6,2,4
EG,QA,2015.0,48,32,16
SG,CH,2010.0,12,11,1
LV,RU,2002.0,7,11,-4
OM,SA,2018.0,18,15,3
PA,MX,2022.0,3,5,-2
RU,BY,2022.0,46,33,13
RE,CA,2009.0,1,2,-1
CH,GB,1999.0,92,92,0
IT,JP,2008.0,43,63,-20
UG,FR,2019.0,6,4,2
UG,AT,2013.0,3,1,2
IT,ZA,2014.0,18,9,9
TN,FR,2006.0,84,108,-24
LK,CH,2012.0,5,6,-1
JP,MX,2019.0,11,17,-6
IN,IT,2018.0,65,54,11
CH,AU,2014.0,80,73,7
CH,IT,2005.0,112,158,-46
TW,IN,2014.0,42,57,-15
IQ,OM,2019.0,3,8,-5
RU,TJ,2013.0,28,23,5
HR,US,2022.0,23,18,5
JP,CA,2007.0,110,109,1
BA,RS,2019.0,43,55,-12
CH,NZ,2021.0,7,7,0
DZ,MA,2019.0,39,25,14
CH,AT,2014.0,96,117,-21
GE,RU,2019.0,7,8,-1
SY,JO,2016.0,5,4,1
DK,ES,2009.0,21,37,-16
JO,QA,2020.0,17,10,7
BR,JP,2007.0,36,49,-13
ES,CZ,2020.0,27,14,13
PS,GB,2018.0,4,9,-5
HU,ES,2009.0,6,5,1
CO,AT,2007.0,2,1,1
CN,IR,2016.0,37,49,-12
PS,EG,2021.0,6,13,-7
CA,SE,2017.0,59,49,10
NL,CH,1999.0,41,39,2
SY,US,2022.0,10,3,7
IR,CN,1999.0,2,3,-1
SD,IQ,2020.0,10,8,2
SA,KR,2016.0,7,23,-16
TW,ID,2019.0,60,58,2
PL,FR,2018.0,61,59,2
BE,RU,2020.0,36,24,12
DK,CH,2014.0,35,47,-12
IR,OM,2022.0,10,2,8
TR,JP,2008.0,28,37,-9
NL,EC,2016.0,1,1,0
FI,CA,2014.0,20,21,-1
EG,ID,2018.0,38,22,16
IR,ZA,2019.0,12,2,10
ES,PA,2018.0,14,17,-3
CN,RO,2022.0,13,9,4
CM,CA,2017.0,7,5,2
DK,NL,2020.0,56,72,-16
RU,FR,2005.0,54,44,10
CO,CH,2017.0,12,13,-1
GB,GM,2009.0,11,9,2
CA,SE,2019.0,66,52,14
SA,BH,2018.0,8,4,4
SK,CZ,2021.0,97,100,-3
US,TZ,2021.0,16,11,5
VN,GB,2020.0,17,16,1
ID,SI,2021.0,5,10,-5
ZW,GB,2021.0,7,2,5
GB,HU,2012.0,47,49,-2
SA,LY,2021.0,4,2,2
GB,GH,2020.0,33,32,1
ES,PE,2021.0,129,142,-13
AE,PK,2008.0,4,2,2
PK,IQ,2017.0,17,14,3
MA,US,2021.0,14,14,0
AU,FI,2018.0,26,22,4
TR,PS,2022.0,4,4,0
SG,IE,2009.0,5,3,2
ES,PK,2021.0,5,4,1
GB,BY,2019.0,1,2,-1
ZA,KE,2020.0,49,34,15
PE,HN,2021.0,5,2,3
UZ,RU,2016.0,15,10,5
nan,GB,2007.0,95,62,33
ET,KR,2008.0,131,96,35
US,RU,2014.0,532,386,146
VN,US,2003.0,20,24,-4
CN,RU,2003.0,23,26,-3
DE,MX,2016.0,38,49,-11
ES,CA,2006.0,50,47,3
GB,TH,2015.0,89,33,56
CA,SN,2022.0,2,2,0
IN,CO,2019.0,4,6,-2
RU,UA,2007.0,118,92,26
GE,RU,2017.0,5,10,-5
IR,CH,2019.0,45,19,26
FR,HU,1997.0,10,9,1
SA,IQ,2022.0,29,29,0
EC,US,2014.0,24,50,-26
IT,PT,2001.0,7,2,5
KR,IE,2021.0,5,4,1
KW,EG,2021.0,18,18,0
VN,RO,2017.0,7,2,5
BR,ES,1999.0,81,86,-5
PT,TN,2022.0,2,2,0
AO,BR,2015.0,33,17,16
CA,TN,2011.0,11,13,-2
GB,BE,2000.0,46,64,-18
CN,NG,2011.0,4,6,-2
BE,CH,2010.0,64,59,5
BR,RU,2011.0,8,11,-3
HR,SI,2010.0,16,8,8
SA,US,2006.0,41,64,-23
MX,CO,2001.0,38,33,5
CA,IL,2014.0,62,71,-9
CA,KE,2013.0,10,4,6
DK,NO,2004.0,48,41,7
US,MU,2002.0,1,1,0
AT,CA,2008.0,22,18,4
US,KE,2012.0,57,48,9
DK,SE,2009.0,70,133,-63
NZ,NL,2003.0,2,4,-2
IR,SE,2012.0,43,26,17
GA,DE,2013.0,5,2,3
JM,GB,2010.0,4,6,-2
GR,ES,2006.0,8,3,5
ES,IS,2009.0,2,2,0
NL,KE,2018.0,12,15,-3
NL,CW,2010.0,13,16,-3
SE,ET,2009.0,7,3,4
BH,US,2014.0,9,7,2
GR,SE,2012.0,13,7,6
IT,AT,2005.0,23,24,-1
ST,BR,2009.0,34,22,12
GH,GB,1998.0,6,4,2
TR,BE,2008.0,9,8,1
RS,DE,2003.0,15,14,1
IN,MY,2021.0,79,103,-24
IL,FI,2011.0,2,1,1
GE,KR,2017.0,3,2,1
UA,EC,2018.0,5,46,-41
ET,AU,2015.0,5,6,-1
PL,RU,2002.0,6,15,-9
CO,RU,2021.0,5,3,2
SE,CU,2017.0,3,2,1
KW,IN,2009.0,8,10,-2
RU,IT,2016.0,36,46,-10
TJ,RU,2021.0,27,207,-180
CA,BD,2005.0,5,11,-6
PS,IL,2019.0,3,5,-2
UA,SK,2020.0,9,2,7
SG,VN,2011.0,6,3,3
CA,JP,1999.0,101,91,10
PL,CZ,2013.0,48,42,6
AU,PT,2011.0,14,12,2
EE,SE,1999.0,9,8,1
IT,MA,2021.0,30,23,7
US,IS,2012.0,21,11,10
BE,MX,2018.0,12,11,1
SE,CH,2008.0,39,36,3
CO,CH,2019.0,11,14,-3
MX,BE,2011.0,13,8,5
LU,BR,2014.0,6,7,-1
US,SL,2017.0,4,1,3
CU,MX,2004.0,21,26,-5
RU,NL,2022.0,37,16,21
TW,AR,2016.0,7,10,-3
KR,NZ,2011.0,6,4,2
QA,US,2022.0,69,30,39
EG,PK,2014.0,9,13,-4
AR,CO,2000.0,15,7,8
RU,SK,2012.0,21,16,5
CH,UG,2014.0,5,2,3
RO,ZA,2020.0,7,8,-1
GR,NL,2021.0,20,19,1
DE,PS,2015.0,7,4,3
GB,KW,2001.0,9,4,5
FI,JP,2007.0,17,23,-6
AR,nan,2020.0,41,39,2
FR,ZA,2000.0,13,7,6
RU,PK,2007.0,3,1,2
nan,NL,2004.0,36,39,-3
BE,IL,2017.0,11,14,-3
PL,HU,2022.0,24,14,10
KR,BH,2007.0,1,1,0
IT,AT,2002.0,21,20,1
AU,IE,2003.0,45,38,7
AT,AR,2018.0,3,9,-6
DK,DE,2001.0,50,49,1
NO,IN,2007.0,15,21,-6
KR,PR,2010.0,17,36,-19
DK,JP,2007.0,10,10,0
RU,NZ,2018.0,4,4,0
IT,UA,2015.0,32,22,10
ZA,TZ,2015.0,9,3,6
nan,DK,2003.0,6,11,-5
MX,CL,2005.0,70,51,19
DE,LT,2005.0,9,4,5
BD,TH,2015.0,3,4,-1
TR,TW,2019.0,11,3,8
TR,ES,2018.0,15,6,9
BD,IN,2007.0,19,35,-16
CO,IL,2019.0,7,3,4
SE,DK,2011.0,124,89,35
SI,CN,2020.0,3,4,-1
AR,PE,2018.0,56,57,-1
SE,MY,2014.0,7,4,3
CN,MY,2006.0,20,10,10
US,VN,2003.0,24,20,4
DE,AE,2009.0,5,2,3
IN,IQ,2016.0,17,3,14
ID,TZ,2020.0,2,2,0
TG,FR,2006.0,1,4,-3
NL,UY,2015.0,1,1,0
SG,PK,2018.0,9,4,5
PH,TH,2015.0,3,4,-1
IN,RE,2018.0,1,2,-1
VN,FR,2011.0,14,30,-16
DE,SI,2021.0,9,13,-4
CO,PA,2017.0,16,18,-2
IR,CH,2017.0,31,21,10
CZ,KZ,2019.0,2,3,-1
CA,PA,2009.0,1,2,-1
MM,CN,2019.0,5,6,-1
NL,AU,2004.0,36,40,-4
RO,HU,2012.0,27,29,-2
MX,GB,2011.0,43,51,-8
NL,RO,2008.0,8,15,-7
TR,NO,2017.0,13,11,2
SI,GB,2011.0,9,8,1
LB,AE,2022.0,10,3,7
CO,IT,2022.0,9,8,1
LT,SE,2022.0,3,1,2
PF,FR,2013.0,9,13,-4
nan,UA,2021.0,26,17,9
BD,TR,2014.0,3,2,1
DE,TN,2017.0,8,10,-2
PK,KZ,2019.0,2,1,1
JO,EG,2017.0,20,16,4
BD,EG,2017.0,10,5,5
ET,IN,2019.0,22,65,-43
AZ,RU,2015.0,17,10,7
BW,ZA,2022.0,7,4,3
RU,DE,2005.0,190,142,48
PK,KZ,2017.0,1,1,0
VN,RO,2010.0,2,7,-5
CZ,CH,2016.0,34,34,0
AU,KE,2020.0,10,7,3
GY,US,2014.0,1,2,-1
FI,ES,2008.0,13,18,-5
MX,NO,2011.0,4,4,0
IT,IN,2012.0,63,59,4
GH,ZA,2014.0,11,10,1
CZ,ID,2015.0,9,5,4
GR,CH,2016.0,57,17,40
FI,IR,2017.0,14,22,-8
SK,DE,2011.0,35,37,-2
MT,IT,2019.0,6,10,-4
FI,TH,2013.0,2,3,-1
UG,JP,2007.0,1,1,0
RW,TZ,2022.0,1,2,-1
NZ,CO,2016.0,2,1,1
IN,FI,2012.0,19,11,8
JP,ES,1999.0,16,14,2
AU,IR,2004.0,18,5,13
ET,US,2014.0,29,30,-1
BE,KR,2002.0,2,3,-1
ZA,NO,2005.0,2,3,-1
PL,IT,2012.0,23,26,-3
JP,PH,2012.0,36,15,21
PE,US,2011.0,64,72,-8
RU,JP,1998.0,36,19,17
GR,DE,2006.0,28,29,-1
MX,PL,2010.0,3,4,-1
MX,CR,2021.0,32,28,4
NL,SI,2017.0,13,4,9
SA,FR,2016.0,20,62,-42
FR,NG,2018.0,10,9,1
PL,RU,2005.0,22,10,12
DE,QA,2012.0,4,8,-4
NO,AT,2015.0,3,16,-13
SE,RU,2015.0,27,24,3
IT,MK,2020.0,2,1,1
SG,MX,2006.0,7,3,4
NL,HU,2005.0,9,12,-3
RO,DE,2012.0,30,29,1
HU,JP,2012.0,10,11,-1
MY,IT,2008.0,60,36,24
MX,NL,1998.0,1,6,-5
TR,DE,2008.0,49,42,7
ES,SI,2005.0,4,5,-1
SA,GB,2006.0,18,29,-11
TN,SA,2011.0,19,8,11
DK,FR,1998.0,14,16,-2
CA,NO,2004.0,12,9,3
RS,HU,2014.0,6,6,0
PL,BH,2019.0,15,8,7
CA,nan,2006.0,19,24,-5
EE,CH,2006.0,3,5,-2
CH,EG,2022.0,7,2,5
ML,FR,2019.0,18,13,5
IN,HU,2019.0,21,7,14
DE,AR,2020.0,40,53,-13
IT,CZ,1997.0,8,8,0
RU,IL,2008.0,19,14,5
BA,DE,2022.0,3,3,0
BA,RS,2017.0,29,55,-26
NG,CM,2021.0,2,6,-4
HU,PL,2007.0,17,13,4
FI,LU,2003.0,1,1,0
BR,nan,2007.0,40,31,9
MX,RS,2015.0,9,2,7
JP,MX,2017.0,6,11,-5
IN,NZ,2013.0,18,31,-13
DE,JO,2005.0,6,6,0
SK,NL,2001.0,11,6,5
AT,ES,1999.0,1,7,-6
HU,CH,2013.0,18,15,3
SJ,SE,2018.0,1,1,0
IN,QA,2012.0,13,7,6
RU,KR,2011.0,18,5,13
BW,US,2016.0,9,10,-1
SE,BE,1997.0,2,3,-1
CA,FI,2000.0,16,10,6
NL,ES,2007.0,76,47,29
BR,PL,2022.0,20,19,1
IT,KE,2011.0,4,3,1
DZ,MA,2010.0,8,8,0
IR,GB,2007.0,25,80,-55
LK,NL,2012.0,3,2,1
IN,HU,2017.0,14,5,9
MY,SA,2001.0,4,1,3
CA,QA,2009.0,12,1,11
SK,CA,2016.0,6,4,2
CZ,IN,2009.0,21,20,1
GM,GB,2017.0,10,35,-25
CA,ZA,2000.0,7,11,-4
FR,TW,2018.0,22,21,1
IE,NL,2003.0,6,8,-2
PE,DO,2018.0,2,1,1
EE,DE,2006.0,19,30,-11
AT,EG,2005.0,4,2,2
SG,DK,2001.0,7,3,4
US,LU,1997.0,2,2,0
NG,IT,2014.0,10,7,3
IN,PH,2015.0,22,25,-3
SE,MX,2001.0,2,4,-2
RO,NL,2022.0,3,8,-5
TR,TW,2010.0,12,5,7
MX,UY,2001.0,3,2,1
GB,CL,1999.0,6,3,3
LB,ES,2022.0,2,1,1
TW,SE,2012.0,3,3,0
PA,CL,2014.0,5,6,-1
PK,AU,2009.0,13,10,3
KR,KG,2019.0,1,1,0
IN,TR,2007.0,11,7,4
IR,IT,1998.0,1,1,0
MX,nan,2001.0,7,9,-2
MY,PT,2006.0,1,3,-2
SG,TW,1997.0,4,8,-4
MY,SI,2009.0,1,1,0
ID,ES,2015.0,9,12,-3
BB,GB,1997.0,2,1,1
SG,RU,2011.0,5,3,2
FI,TR,2004.0,2,5,-3
HR,AT,2009.0,6,5,1
FR,SK,2014.0,8,7,1
BH,ZW,2022.0,3,2,1
SG,ES,2018.0,15,9,6
NG,IR,2010.0,10,3,7
KE,AT,2011.0,1,3,-2
PT,RU,2018.0,10,18,-8
CA,SK,2018.0,4,1,3
RU,FR,2002.0,64,36,28
HK,JP,2000.0,6,8,-2
NZ,PK,2011.0,5,3,2
NG,IR,2017.0,4,1,3
CH,CG,2015.0,5,1,4
CN,IL,2007.0,11,18,-7
EG,CY,2021.0,1,1,0
GR,CN,2008.0,17,16,1
IL,CN,2008.0,17,14,3
DK,LV,2016.0,1,2,-1
CN,AL,2015.0,2,3,-1
NO,TW,2016.0,4,1,3
DK,CN,2008.0,23,16,7
CA,BD,2002.0,2,1,1
SA,IL,2020.0,1,3,-2
ES,MY,2015.0,6,5,1
JP,NL,1999.0,30,34,-4
GB,AR,2013.0,29,26,3
IS,AU,2003.0,1,1,0
RU,JP,1997.0,28,21,7
TN,EG,2018.0,23,10,13
AU,GR,2015.0,3,15,-12
DE,JO,2002.0,9,2,7
SK,SI,2011.0,3,1,2
CI,FR,2016.0,9,28,-19
ID,AR,2008.0,1,1,0
HR,CN,2013.0,5,3,2
CO,FI,2014.0,2,1,1
CA,IS,2012.0,2,1,1
CO,BO,2012.0,5,12,-7
US,SS,2017.0,3,1,2
CA,PH,2019.0,18,12,6
HU,DK,2014.0,3,2,1
UG,NO,2012.0,3,4,-1
AE,BH,2014.0,1,2,-1
AT,RU,2015.0,21,14,7
SI,CH,2011.0,5,2,3
PL,BH,2017.0,7,4,3
NG,PK,2010.0,4,5,-1
US,GM,2020.0,2,6,-4
AR,NL,2006.0,8,3,5
GB,RS,2015.0,20,23,-3
SG,TW,1998.0,8,12,-4
JP,LK,2000.0,6,15,-9
MM,IQ,2022.0,3,5,-2
LB,ID,2020.0,1,3,-2
MT,IT,2017.0,2,11,-9
PL,IR,2016.0,4,7,-3
GB,SS,2004.0,11,5,6
JM,GB,2017.0,4,7,-3
SA,AU,2013.0,12,29,-17
CN,UG,2020.0,5,1,4
UZ,KR,2015.0,2,1,1
RU,BR,2015.0,7,10,-3
US,SL,2019.0,6,5,1
CL,JP,2005.0,4,6,-2
BE,RO,2021.0,10,11,-1
nan,AU,2004.0,10,13,-3
SE,SG,2023.0,1,1,0
CH,LT,2018.0,3,3,0
CA,PE,2019.0,9,6,3
GA,GB,2000.0,1,1,0
CZ,NL,2003.0,7,9,-2
NL,BG,1999.0,2,2,0
NO,CZ,2012.0,8,7,1
NO,IR,2005.0,2,2,0
MN,AU,2010.0,1,1,0
PL,AE,2012.0,1,1,0
BA,US,2012.0,3,5,-2
ES,PL,2018.0,38,17,21
DK,FI,2010.0,12,13,-1
UY,ES,2004.0,25,14,11
JP,IR,1999.0,8,1,7
SE,BG,2014.0,4,1,3
EG,SD,2014.0,11,16,-5
KE,CO,2015.0,6,3,3
BA,RS,2010.0,18,15,3
NO,nan,2001.0,12,14,-2
TR,RU,2003.0,3,6,-3
PR,MX,2012.0,4,2,2
PL,IN,2010.0,6,5,1
PK,NP,2013.0,5,1,4
BY,HU,2014.0,3,3,0
IL,CA,1997.0,15,28,-13
FR,MQ,2013.0,19,10,9
GB,VE,2008.0,4,7,-3
SJ,NO,2019.0,11,7,4
US,MW,2022.0,13,9,4
BE,CO,2011.0,7,9,-2
IT,HU,2005.0,15,5,10
UG,ZA,2014.0,14,16,-2
CV,BR,2018.0,3,3,0
AU,EG,2018.0,28,13,15
NL,ET,2013.0,6,1,5
ID,CO,2018.0,2,7,-5
CD,KE,2018.0,1,2,-1
BR,CM,2016.0,3,2,1
PT,CN,2020.0,10,16,-6
BE,RS,2017.0,7,7,0
IT,IR,2011.0,11,18,-7
DE,KW,1997.0,1,1,0
UA,PL,2022.0,46,27,19
CZ,HU,2015.0,5,12,-7
CA,CI,2011.0,2,2,0
AU,RO,2007.0,3,1,2
ZW,CG,2006.0,1,1,0
SA,KZ,2019.0,3,1,2
CL,AU,2012.0,10,11,-1
PG,TR,2019.0,2,1,1
BR,FI,2022.0,8,5,3
TW,BE,2000.0,4,5,-1
NO,GB,2001.0,24,28,-4
ID,BR,2012.0,5,4,1
PT,CH,2000.0,2,1,1
FR,EE,2014.0,10,7,3
EG,IT,2012.0,7,5,2
CR,ZA,2015.0,4,9,-5
LK,US,1997.0,3,2,1
FI,BY,2022.0,1,1,0
MX,PA,2007.0,6,5,1
IE,TR,2020.0,4,4,0
PK,AE,2021.0,26,16,10
ES,PY,2007.0,4,4,0
CM,GH,2017.0,3,3,0
CH,PH,2018.0,6,5,1
BO,MX,2005.0,4,4,0
VE,GB,2002.0,3,7,-4
BD,CA,2006.0,8,4,4
KR,HU,2020.0,1,1,0
IL,CA,1998.0,27,21,6
RW,KE,2017.0,4,1,3
NO,PT,2006.0,5,1,4
FR,BD,2018.0,8,4,4
IE,PK,2005.0,5,2,3
JP,MX,2010.0,8,12,-4
CA,PE,2017.0,5,7,-2
BE,AU,1999.0,13,9,4
CO,VE,2003.0,12,16,-4
AT,BG,2003.0,1,2,-1
MY,TN,2017.0,4,4,0
CZ,IT,2009.0,21,17,4
MX,VN,2016.0,11,1,10
BI,US,2013.0,4,4,0
SE,KR,2013.0,12,7,5
KE,KR,2018.0,2,1,1
BD,AU,2011.0,26,13,13
MX,DE,1998.0,7,7,0
AZ,ID,2017.0,10,2,8
TW,ID,2017.0,38,29,9
NL,PT,2004.0,15,5,10
BG,FR,2015.0,10,6,4
SE,UA,2001.0,4,7,-3
MY,IE,2018.0,10,8,2
CA,CO,1998.0,1,3,-2
BO,ES,2002.0,1,1,0
NL,IN,1998.0,8,10,-2
ES,TN,2010.0,4,3,1
CA,HU,2016.0,7,18,-11
DE,MK,2012.0,4,3,1
CZ,CA,2019.0,7,15,-8
LU,JP,2018.0,1,1,0
CU,BR,1997.0,1,4,-3
CM,DE,2019.0,5,9,-4
ZA,DE,2000.0,14,11,3
LV,RU,2005.0,11,13,-2
IN,HU,2010.0,6,1,5
DZ,MA,2017.0,24,24,0
IN,LB,2012.0,1,5,-4
VN,SE,2013.0,5,6,-1
MX,RU,2015.0,12,6,6
CZ,CA,2017.0,8,26,-18
ZA,AE,2021.0,4,3,1
SI,BE,2018.0,6,8,-2
IS,CN,2017.0,1,1,0
IQ,IT,2017.0,3,6,-3
KW,IQ,2020.0,10,6,4
MY,TW,2012.0,6,20,-14
MD,BR,2017.0,2,1,1
UA,LV,2020.0,4,6,-2
AZ,ID,2019.0,5,3,2
CZ,PL,2001.0,8,16,-8
PL,SA,2018.0,5,1,4
TR,SA,2020.0,8,12,-4
KR,LK,2022.0,4,1,3
CM,DE,2017.0,5,5,0
TN,CH,2005.0,3,1,2
IR,SG,2009.0,9,7,2
DK,IS,2022.0,5,7,-2
BR,SA,2016.0,4,5,-1
NG,PK,2017.0,8,20,-12
ES,UA,2013.0,5,6,-1
RS,CA,2016.0,11,9,2
KR,CA,2001.0,14,13,1
SN,nan,2010.0,1,1,0
IR,ZA,2017.0,6,5,1
PL,VE,2019.0,2,1,1
JP,SI,2021.0,3,1,2
VN,NG,2020.0,1,2,-1
SG,CH,2019.0,22,17,5
TW,NZ,2013.0,11,6,5
LK,JP,2003.0,11,11,0
JM,US,2014.0,14,16,-2
TR,NG,2020.0,6,11,-5
EG,MA,2022.0,7,4,3
PL,EE,2008.0,6,2,4
DO,PA,2015.0,2,1,1
RS,CZ,2003.0,12,9,3
CH,RU,2004.0,14,29,-15
CF,FR,2013.0,2,3,-1
FR,AE,2005.0,4,1,3
IN,AR,2013.0,1,4,-3
KR,nan,2018.0,31,31,0
MM,JP,2017.0,7,8,-1
RO,BE,2016.0,11,12,-1
BE,RS,2019.0,5,2,3
MA,GB,2015.0,5,9,-4
PE,CA,2015.0,3,4,-1
IN,PT,2012.0,22,11,11
UG,FR,2010.0,2,6,-4
NL,IN,1997.0,7,6,1
VE,GB,2005.0,9,6,3
DO,US,2012.0,4,4,0
CG,SN,2012.0,1,1,0
DK,RU,2003.0,4,13,-9
LY,CA,2021.0,2,2,0
PY,MX,2020.0,15,19,-4
RO,BR,2021.0,7,1,6
BE,TW,2020.0,4,11,-7
KW,US,2021.0,14,16,-2
AM,IR,2013.0,2,1,1
HR,CA,2020.0,3,10,-7
DK,FI,2017.0,22,27,-5
FR,RO,2002.0,17,18,-1
GB,HR,1999.0,3,5,-2
US,ML,2021.0,8,6,2
IN,KE,2004.0,3,2,1
CL,CR,2001.0,6,1,5
HR,CH,2006.0,6,2,4
RU,GR,2019.0,5,7,-2
PT,nan,2021.0,13,10,3
SJ,NO,2017.0,6,10,-4
VN,MY,2021.0,7,5,2
GR,IN,2014.0,2,6,-4
IT,CL,2001.0,12,7,5
CZ,BG,2006.0,2,4,-2
HR,BA,2002.0,5,3,2
NL,UG,2015.0,1,3,-2
TR,SG,2014.0,5,6,-1
BH,PL,2020.0,10,9,1
MD,MA,2005.0,8,3,5
ID,SG,2016.0,11,26,-15
IT,RO,2007.0,9,16,-7
MX,DE,1997.0,10,6,4
ES,AM,2020.0,1,1,0
EG,NL,2010.0,4,8,-4
AM,DE,2007.0,3,6,-3
BD,SA,2023.0,5,2,3
IN,IR,2002.0,2,3,-1
BE,FI,2001.0,3,4,-1
GB,SI,2002.0,6,3,3
UG,BE,2014.0,7,7,0
ZA,PK,2017.0,7,8,-1
CR,BO,2014.0,3,2,1
ML,SN,2016.0,6,3,3
EC,PY,2019.0,3,6,-3
RU,GR,2010.0,6,6,0
IL,IQ,2020.0,1,1,0
AR,PT,2001.0,4,3,1
AU,BH,2009.0,1,2,-1
UA,TR,2017.0,2,3,-1
ZA,MX,2021.0,1,2,-1
CO,IL,2010.0,1,3,-2
PT,EC,2015.0,8,3,5
AF,MX,2019.0,2,5,-3
MG,US,2014.0,3,7,-4
CL,CA,2012.0,17,21,-4
CA,NE,2010.0,1,1,0
NP,AU,2009.0,4,1,3
GB,ME,2013.0,1,1,0
MM,JP,2019.0,5,26,-21
nan,NG,2007.0,3,1,2
JO,BH,2019.0,3,1,2
LU,IT,2015.0,3,16,-13
CN,UA,1999.0,11,7,4
SG,GB,2023.0,9,8,1
DE,IS,2019.0,5,6,-1
IT,HU,2002.0,3,11,-8
PH,DE,2001.0,4,2,2
JM,AU,2018.0,2,2,0
CA,MA,2001.0,4,1,3
BJ,JP,2020.0,1,1,0
ZA,MY,2021.0,6,6,0
DE,IS,2017.0,5,3,2
IT,SI,2016.0,5,10,-5
MA,QA,2017.0,2,1,1
UA,TR,2019.0,1,3,-2
TW,BR,2002.0,1,2,-1
PK,IQ,2010.0,3,1,2
ME,US,2018.0,5,1,4
TR,GH,2014.0,3,1,2
SY,EG,2011.0,3,1,2
ET,IN,2017.0,12,53,-41
IR,CH,2010.0,21,9,12
BW,MW,2021.0,1,1,0
EE,FR,2015.0,3,5,-2
ZA,ZM,2009.0,3,1,2
SY,LB,2013.0,2,1,1
PK,TW,2000.0,1,1,0
IT,HR,2022.0,6,3,3
BR,SG,2004.0,1,1,0
PH,ID,2018.0,6,4,2
JO,PS,2019.0,12,18,-6
US,MN,2012.0,4,4,0
GR,IE,2012.0,8,4,4
MY,TN,2010.0,1,3,-2
NI,US,2012.0,5,3,2
ZA,IT,2002.0,4,2,2
ML,FR,2010.0,10,6,4
SG,BR,2009.0,3,2,1
SK,ES,2013.0,4,3,1
CL,FR,2006.0,16,23,-7
KZ,JP,2010.0,1,2,-1
DE,MC,2018.0,4,2,2
JP,PK,2004.0,3,3,0
IT,TW,2003.0,1,3,-2
EC,PY,2017.0,1,5,-4
VN,CA,2022.0,9,17,-8
NI,CA,2012.0,5,1,4
IR,TH,2013.0,1,2,-1
EG,TR,2013.0,3,3,0
RU,GR,2017.0,5,4,1
US,BI,2017.0,2,5,-3
PA,US,2003.0,13,10,3
MC,DE,2010.0,2,1,1
FR,SI,2006.0,5,2,3
AF,MX,2010.0,3,2,1
ID,CH,2015.0,3,5,-2
IT,VE,2016.0,2,4,-2
CH,PL,2001.0,12,6,6
PE,CR,2022.0,6,4,2
IR,NP,2019.0,2,1,1
GM,GB,2019.0,6,28,-22
IN,IR,2005.0,12,3,9
GA,NL,2018.0,8,5,3
PT,SE,2004.0,5,8,-3
CO,BE,2021.0,11,7,4
PT,SG,2012.0,1,1,0
CI,US,1999.0,1,1,0
DO,CR,2021.0,1,1,0
AU,CL,2002.0,3,1,2
CH,nan,1999.0,1,5,-4
DE,ET,2012.0,6,5,1
KE,BE,2008.0,2,2,0
ZA,BE,2016.0,17,20,-3
SE,CU,2010.0,2,1,1
NL,ZA,2023.0,2,1,1
CN,PT,2012.0,10,8,2
MG,FR,2021.0,5,12,-7
FI,IR,2019.0,9,31,-22
nan,KE,2019.0,7,3,4
MA,nan,2018.0,5,15,-10
CA,HR,2022.0,1,2,-1
NZ,AT,2014.0,8,2,6
RO,ES,2002.0,4,1,3
ES,MA,2001.0,6,9,-3
IN,EE,2013.0,4,1,3
IL,MX,2003.0,2,1,1
nan,TZ,2020.0,1,1,0
ID,VN,2020.0,3,2,1
PK,SN,2017.0,2,2,0
CH,TN,2001.0,2,1,1
IE,PT,2006.0,2,2,0
MA,DE,2009.0,5,9,-4
IL,BE,2015.0,6,4,2
JP,KZ,2014.0,4,1,3
FI,IR,2010.0,6,6,0
AR,AT,2021.0,6,4,2
CA,SD,2020.0,4,1,3
BO,CL,2016.0,7,12,-5
BD,EG,2010.0,3,4,-1
ET,IN,2010.0,3,5,-2
HU,CO,2022.0,1,2,-1
ET,nan,2014.0,3,4,-1
ES,HN,2014.0,7,6,1
PL,AU,1997.0,2,3,-1
IN,MX,2001.0,8,6,2
AT,TH,2011.0,5,6,-1
IT,EE,2016.0,4,3,1
BD,EG,2019.0,11,7,4
IE,BG,2014.0,1,1,0
BE,CL,2003.0,1,5,-4
BD,US,2023.0,7,2,5
LI,CH,2008.0,2,1,1
TN,LB,2016.0,3,1,2
MA,ES,2009.0,3,8,-5
ML,US,2012.0,5,2,3
RU,IR,2009.0,9,4,5
DE,IS,2010.0,8,6,2
FI,ZA,2003.0,1,1,0
NL,EG,2000.0,2,1,1
KR,BD,2007.0,1,5,-4
DE,BI,2019.0,2,1,1
DK,TW,2018.0,3,4,-1
JP,CL,2022.0,4,4,0
CN,CM,2021.0,7,3,4
IN,LK,2013.0,5,6,-1
RS,ES,2021.0,7,5,2
CH,FI,2000.0,8,5,3
BW,ZW,2006.0,1,2,-1
GB,NI,2018.0,2,1,1
CH,SK,2007.0,6,7,-1
US,KP,2020.0,3,2,1
NP,BD,2017.0,6,5,1
BE,IL,2010.0,4,4,0
NO,ES,2004.0,8,7,1
SJ,NO,2010.0,5,6,-1
AU,IS,2016.0,1,2,-1
TW,BD,2012.0,2,1,1
BR,DK,2007.0,3,4,-1
PT,TW,2007.0,2,1,1
CY,JP,2015.0,1,1,0
IS,SE,2008.0,6,11,-5
LT,FR,2018.0,3,4,-1
ID,NL,2008.0,6,14,-8
RS,FI,2005.0,2,1,1
AE,KW,2002.0,3,3,0
IN,OM,2009.0,8,4,4
QA,AU,2011.0,5,7,-2
ET,MA,2019.0,2,1,1
CH,BG,2003.0,2,3,-1
LY,SA,2021.0,2,4,-2
PK,EG,2012.0,5,9,-4
LI,AT,2017.0,2,3,-1
CO,NZ,2002.0,1,1,0
KR,KZ,2013.0,1,1,0
EG,NL,2017.0,6,11,-5
SG,TR,2014.0,6,5,1
KR,NP,2008.0,2,4,-2
TZ,NL,2013.0,2,5,-3
AT,TR,2021.0,10,15,-5
IN,CZ,2001.0,3,9,-6
CI,BE,2021.0,1,2,-1
BD,ID,2002.0,1,1,0
NG,PK,2019.0,4,14,-10
LV,BY,2002.0,1,1,0
IT,EC,2013.0,6,7,-1
GB,BY,2010.0,1,1,0
US,ST,2012.0,3,1,2
CN,IE,2002.0,3,10,-7
MK,SI,2019.0,3,2,1
XK,BE,2014.0,1,1,0
NO,CN,2023.0,4,10,-6
FI,FR,1999.0,9,10,-1
DE,VN,2001.0,6,1,5
SE,BE,1998.0,7,13,-6
SK,DK,2014.0,5,4,1
IR,BE,2003.0,1,2,-1
CZ,RS,2001.0,7,6,1
GB,LT,2022.0,6,3,3
BG,PL,1999.0,2,4,-2
HU,AU,1999.0,3,5,-2
CZ,CA,2010.0,6,14,-8
CA,RW,2015.0,1,1,0
RE,FR,2004.0,8,13,-5
HU,IE,2009.0,2,1,1
TZ,NG,2022.0,4,1,3
DE,HN,2017.0,1,1,0
CN,NA,2019.0,2,2,0
BR,EC,2003.0,2,3,-1
NL,OM,2003.0,2,1,1
TW,ID,2010.0,2,3,-1
IL,PS,2011.0,5,1,4
SK,PK,2019.0,2,1,1
BT,LK,2016.0,3,1,2
NL,CW,2019.0,1,18,-17
MX,RO,2006.0,1,1,0
EG,CH,2004.0,1,2,-1
CH,CU,2009.0,2,2,0
GR,RU,2020.0,7,6,1
UA,BY,2000.0,2,2,0
EE,IN,2007.0,2,2,0
MY,BW,2015.0,1,1,0
BE,QA,2021.0,1,2,-1
EG,AU,2001.0,1,2,-1
JO,IE,2006.0,1,1,0
EG,PL,2021.0,1,1,0
CZ,VN,2021.0,5,7,-2
PL,BR,2008.0,2,4,-2
HU,EG,2016.0,5,1,4
MA,TH,2020.0,1,1,0
MX,PL,2019.0,7,8,-1
XK,HR,2022.0,2,2,0
TG,TR,2007.0,2,1,1
TN,CN,2020.0,4,2,2
GR,TR,2001.0,5,3,2
EG,PT,2016.0,2,2,0
HU,SE,2006.0,6,7,-1
SI,BG,2020.0,2,1,1
BG,KZ,2020.0,2,1,1
IQ,ID,2014.0,1,2,-1
UA,CZ,2008.0,7,16,-9
GE,RU,2010.0,3,1,2
ZA,BR,2003.0,3,5,-2
GN,BF,2017.0,2,2,0
IE,RO,2018.0,3,3,0
VE,CN,2021.0,1,1,0
KE,FR,2018.0,5,5,0
JP,OM,2000.0,2,2,0
IQ,IT,2019.0,3,3,0
GB,BZ,2011.0,1,1,0
JP,MA,2020.0,3,1,2
LK,IN,2000.0,1,1,0
BI,BE,2002.0,1,2,-1
KR,PE,2018.0,1,1,0
KZ,JP,2019.0,2,5,-3
CN,SI,2020.0,4,3,1
ES,AO,2019.0,4,2,2
UZ,CZ,2009.0,1,2,-1
JP,LT,2015.0,2,2,0
CN,BW,2019.0,5,1,4
CM,GH,2019.0,4,1,3
US,BI,2019.0,2,4,-2
JP,ZA,2001.0,3,1,2
EE,CN,2020.0,2,4,-2
SE,PH,2022.0,1,1,0
IL,TN,2020.0,1,1,0
AU,CL,2005.0,4,1,3
NP,BD,2019.0,3,6,-3
US,UG,2004.0,6,8,-2
DE,NG,2006.0,3,5,-2
JO,ID,2021.0,2,8,-6
PL,SK,2005.0,3,3,0
PH,CH,2015.0,4,3,1
US,MZ,2020.0,6,3,3
ES,IN,2005.0,4,9,-5
ZA,ES,1998.0,1,1,0
nan,CR,2009.0,2,2,0
BR,BG,2011.0,3,3,0
MX,PT,1999.0,5,2,3
TN,RU,2016.0,1,4,-3
IL,CL,2018.0,1,7,-6
NG,IR,2019.0,4,9,-5
GB,SI,2005.0,4,8,-4
RW,KE,2019.0,3,3,0
AF,MX,2017.0,2,3,-1
IL,IE,2012.0,1,2,-1
IS,PL,2019.0,2,1,1
ES,VN,2020.0,2,1,1
UY,MX,2004.0,4,3,1
KE,NL,2006.0,3,3,0
FR,CM,2001.0,8,11,-3
IN,MK,2013.0,2,1,1
DE,HN,2019.0,1,1,0
IT,VN,2001.0,1,2,-1
EG,DK,2021.0,5,4,1
UA,BE,2003.0,3,2,1
GE,AU,1999.0,2,1,1
HU,nan,2014.0,6,4,2
ID,MY,2002.0,2,2,0
NC,CG,2012.0,2,1,1
DK,BG,2021.0,1,1,0
PA,FI,2012.0,1,1,0
US,SV,2016.0,4,3,1
IR,AM,2011.0,3,1,2
PT,AR,2004.0,4,12,-8
FI,EE,2001.0,2,3,-1
NO,SK,2005.0,1,1,0
UG,CZ,2018.0,2,1,1
CA,CO,1997.0,2,2,0
MX,SV,2004.0,1,2,-1
MA,SN,2015.0,2,1,1
DO,EC,2019.0,1,3,-2
IN,BG,2018.0,1,1,0
BH,PK,2022.0,2,5,-3
EG,NZ,2009.0,2,3,-1
ES,TR,1999.0,2,2,0
CM,DE,2010.0,7,3,4
NG,FR,2004.0,1,2,-1
JP,BY,2005.0,2,4,-2
JO,AE,2001.0,2,2,0
NG,AU,2003.0,1,3,-2
SK,BR,2020.0,3,1,2
TW,KZ,2016.0,2,1,1
QA,IR,2006.0,1,1,0
TW,NL,2015.0,4,8,-4
BW,KE,2018.0,5,2,3
US,BI,2010.0,1,1,0
SA,JP,2021.0,5,10,-5
EC,UA,1998.0,1,4,-3
KR,GR,2019.0,2,5,-3
CN,CY,2020.0,4,2,2
RO,JP,2008.0,1,12,-11
SI,nan,2021.0,1,4,-3
IT,JO,2013.0,3,1,2
GP,CA,2015.0,1,1,0
BE,RS,2010.0,2,4,-2
KZ,DE,2013.0,3,2,1
SE,VN,2014.0,5,2,3
ID,IQ,2013.0,1,1,0
BE,EC,2011.0,6,2,4
CY,UG,2020.0,2,3,-1
AT,EG,2002.0,3,1,2
IN,FJ,2022.0,3,2,1
nan,SV,2021.0,1,1,0
SK,FR,1999.0,3,5,-2
NO,RU,2004.0,2,7,-5
AT,ME,2019.0,2,1,1
DE,LT,2002.0,5,3,2
IN,CO,2010.0,2,1,1
MK,US,2000.0,2,3,-1
ES,GE,2016.0,1,1,0
CF,MG,2008.0,1,1,0
RS,UZ,2013.0,1,1,0
OM,GB,2000.0,2,5,-3
UG,SE,2007.0,3,3,0
GH,ZM,2008.0,4,3,1
KE,GR,2013.0,1,1,0
MT,IT,2010.0,1,3,-2
AT,NO,2006.0,4,5,-1
AR,CH,1998.0,1,3,-2
PT,CO,2001.0,2,2,0
LK,CA,2006.0,2,2,0
TZ,UG,2022.0,1,3,-2
RO,ES,2005.0,3,4,-1
ZA,IT,2005.0,3,7,-4
LK,FR,2006.0,3,2,1
BN,VN,2017.0,1,1,0
CR,IT,2020.0,2,4,-2
PE,PT,2018.0,5,4,1
SA,nan,2013.0,2,3,-1
RU,EC,1997.0,1,1,0
BA,AT,2022.0,1,1,0
EC,IT,2022.0,6,1,5
NO,GE,2019.0,1,1,0
EG,CO,2010.0,1,2,-1
NL,KH,2017.0,1,1,0
MX,TN,2019.0,1,1,0
NG,MX,2021.0,3,1,2
MY,BD,2004.0,3,6,-3
NO,CM,2018.0,1,2,-1
PL,SK,2002.0,1,3,-2
EG,BD,2014.0,4,3,1
NC,BJ,2016.0,1,1,0
FI,CL,2011.0,3,2,1
SN,nan,2019.0,1,2,-1
MM,JP,2010.0,3,10,-7
SK,CN,2008.0,4,5,-1
TW,nan,1999.0,2,3,-1
ZA,PK,2010.0,2,3,-1
AU,JO,2003.0,2,1,1
KZ,JP,2017.0,2,2,0
FI,nan,2000.0,1,2,-1
IQ,RO,2015.0,1,2,-1
CM,CD,2019.0,1,2,-1
ET,AT,2021.0,2,1,1
MA,QA,2019.0,2,2,0
ZM,GB,2006.0,3,1,2
LB,IT,2004.0,1,8,-7
ZA,NO,2002.0,1,2,-1
TR,KR,2006.0,2,6,-4
BN,AU,2022.0,1,2,-1
ZA,ET,2012.0,3,1,2
US,KH,2008.0,2,2,0
AF,BR,2016.0,1,1,0
CM,CA,2010.0,2,1,1
BE,IN,1999.0,2,4,-2
RS,DK,2009.0,2,1,1
ID,GR,2021.0,2,4,-2
FJ,GB,1999.0,1,2,-1
PL,BY,2012.0,1,6,-5
RS,ME,2003.0,3,2,1
UG,FR,2017.0,3,2,1
BG,AT,2018.0,1,2,-1
TR,TW,2017.0,2,6,-4
FR,GH,2013.0,1,1,0
GW,DK,2022.0,3,1,2
LK,US,1998.0,1,2,-1
DE,TT,2008.0,1,1,0
HR,JP,2013.0,3,2,1
FI,CO,2014.0,1,2,-1
nan,CZ,2007.0,1,11,-10
JO,BH,2017.0,1,4,-3
FJ,JP,2018.0,1,1,0
BN,CA,2020.0,3,2,1
US,CO,2000.0,61,45,16
JP,CN,2015.0,590,439,151
MX,ES,2014.0,700,829,-129
US,DE,1997.0,1140,1013,127
US,SA,2010.0,122,52,70
ZA,CA,2006.0,27,18,9
GB,DE,2009.0,709,796,-87
BE,US,2022.0,201,194,7
US,BR,1999.0,309,250,59
SE,DE,2003.0,101,88,13
SA,BD,2022.0,23,31,-8
DE,RU,2021.0,134,141,-7
GB,BR,2008.0,122,121,1
CO,PA,2010.0,6,2,4
DE,CO,2016.0,38,43,-5
US,SA,2019.0,363,235,128
SI,HR,2018.0,42,27,15
PT,IR,2018.0,11,18,-7
MX,CL,2002.0,37,38,-1
DE,KR,2011.0,49,44,5
JP,FR,2021.0,139,113,26
AR,DE,2021.0,59,34,25
AU,FR,2008.0,75,127,-52
GR,GB,2006.0,110,160,-50
FR,TH,2014.0,24,17,7
PE,IT,2020.0,9,6,3
BE,CH,2017.0,80,83,-3
US,DZ,2015.0,34,43,-9
DE,CZ,2016.0,86,83,3
DE,SE,2001.0,92,73,19
FR,PF,2013.0,13,9,4
NL,SI,2019.0,11,8,3
RS,SI,2008.0,5,9,-4
PH,TW,2016.0,5,4,1
PK,SA,2023.0,13,13,0
CA,IE,2008.0,115,105,10
DK,FI,2019.0,23,25,-2
DK,ZA,2005.0,5,5,0
BE,PL,2009.0,17,12,5
IN,CH,2012.0,48,43,5
MY,CA,2016.0,36,43,-7
PT,NO,2018.0,10,3,7
CA,SE,2010.0,36,40,-4
SE,GB,1998.0,60,65,-5
BY,AT,2014.0,1,2,-1
US,CR,2016.0,46,26,20
NZ,GB,1997.0,58,72,-14
KE,AU,2009.0,5,4,1
DE,UA,2009.0,33,35,-2
PH,JP,2007.0,16,23,-7
US,MA,2016.0,15,20,-5
GB,DK,2015.0,133,112,21
CA,AR,2012.0,22,21,1
PL,IN,2017.0,13,13,0
FR,IL,2021.0,31,25,6
CN,IT,2018.0,38,51,-13
EG,US,1998.0,58,56,2
CH,XK,2016.0,1,1,0
CZ,GR,2009.0,7,3,4
NG,IN,2020.0,31,34,-3
PL,UA,2008.0,10,8,2
MD,SK,2021.0,2,1,1
IQ,OM,2017.0,1,6,-5
CG,AU,2021.0,1,1,0
ID,MY,2005.0,5,6,-1
TR,CA,2008.0,27,14,13
IN,KH,2018.0,4,1,3
SE,AT,2021.0,35,23,12
RU,IN,2022.0,15,30,-15
BO,ES,2005.0,4,3,1
PL,IN,2019.0,24,34,-10
LV,UA,2016.0,3,1,2
CO,IL,2017.0,7,4,3
CZ,TR,2016.0,11,13,-2
SV,ES,2014.0,5,5,0
FR,HU,1998.0,17,19,-2
MY,IN,2003.0,10,10,0
GB,LU,2021.0,10,8,2
ES,CH,2006.0,46,60,-14
RS,nan,2005.0,1,2,-1
JP,IE,2004.0,24,21,3
TR,NO,2010.0,2,1,1
RU,NG,2015.0,1,2,-1
BE,IE,2008.0,9,2,7
ES,TN,2017.0,8,7,1
KR,MN,2012.0,4,2,2
GB,PT,1999.0,21,18,3
KR,DE,2022.0,35,42,-7
RU,PT,2007.0,7,3,4
SA,JO,2015.0,33,55,-22
DE,OM,2015.0,4,2,2
SL,US,2016.0,5,1,4
NL,HU,2002.0,9,9,0
VG,KR,2016.0,2,1,1
PA,ES,2022.0,8,4,4
GE,KR,2010.0,1,1,0
FR,NE,2006.0,2,6,-4
MX,PL,2017.0,8,3,5
HU,FI,2011.0,15,3,12
AU,FJ,2016.0,7,7,0
ZW,ZA,2022.0,33,26,7
HR,DE,2007.0,18,14,4
IT,LU,2012.0,12,6,6
BO,VE,2017.0,2,1,1
DE,ID,2004.0,6,3,3
BY,LT,2020.0,4,1,3
FO,NO,2015.0,2,2,0
US,JM,2011.0,16,13,3
BH,GH,2014.0,5,6,-1
CH,QA,2022.0,1,3,-2
JO,US,2007.0,28,47,-19
nan,RU,2006.0,32,45,-13
ZM,ZA,2021.0,4,9,-5
ZA,DK,2020.0,11,11,0
DK,ZA,2002.0,1,2,-1
BY,FR,2000.0,2,1,1
JO,PS,2017.0,5,2,3
SI,MX,2016.0,3,8,-5
AU,TR,2020.0,22,22,0
KR,RU,2021.0,26,17,9
DE,CU,2008.0,5,8,-3
PE,UG,2020.0,1,1,0
CD,CM,2016.0,3,2,1
ES,KE,2011.0,1,2,-1
IE,HU,2018.0,7,3,4
ES,SI,2002.0,6,2,4
AF,IN,2021.0,4,4,0
US,LU,1998.0,1,2,-1
KZ,CN,2003.0,4,6,-2
GB,GE,1998.0,3,3,0
TW,FR,2014.0,12,15,-3
ZA,NZ,2000.0,6,4,2
CR,FR,2020.0,6,8,-2
SD,GB,2014.0,9,5,4
EG,LY,2018.0,8,12,-4
CN,CO,2020.0,3,3,0
ES,HR,2011.0,1,7,-6
NO,FI,2016.0,14,20,-6
ES,IL,2004.0,5,6,-1
VN,JP,1999.0,5,7,-2
BO,GB,2016.0,1,1,0
CA,PH,2010.0,5,10,-5
UA,AU,2007.0,2,3,-1
LB,IQ,2018.0,5,2,3
CO,CH,2010.0,6,7,-1
CG,PK,2018.0,3,5,-2
SI,FI,2012.0,2,1,1
QA,ME,2020.0,1,1,0
NP,TZ,2020.0,1,1,0
NL,CW,2017.0,11,20,-9
JP,CY,2007.0,4,2,2
SD,US,2004.0,3,4,-1
QA,ES,2020.0,7,7,0
MD,MA,2002.0,3,4,-1
TR,NO,2019.0,9,9,0
SA,RU,2022.0,4,2,2
TN,BE,2018.0,4,4,0
PL,AU,1998.0,2,7,-5
IT,LV,2022.0,2,1,1
AU,KH,2016.0,4,3,1
SY,GB,2002.0,2,1,1
FR,PA,2014.0,2,1,1
NI,PE,2015.0,5,4,1
HU,TR,2014.0,2,3,-1
KE,TZ,2008.0,4,3,1
BD,NO,2013.0,2,6,-4
KG,JP,2021.0,1,1,0
ZA,SA,2022.0,1,3,-2
SY,GB,2005.0,1,2,-1
CW,US,2014.0,1,2,-1
IN,BW,2013.0,1,2,-1
DK,RS,2011.0,3,2,1
JO,AU,2009.0,2,7,-5
PA,AU,2009.0,1,1,0
GN,BF,2019.0,1,2,-1
AE,KW,2005.0,2,3,-1
CY,DE,2008.0,2,5,-3
DE,TN,2010.0,4,2,2
BH,IQ,2022.0,1,2,-1
DE,ES,2015.0,201,323,-122
PL,GB,2010.0,80,50,30
CH,BE,2016.0,74,67,7
DE,PK,2011.0,13,16,-3
CN,BR,2011.0,52,45,7
ZA,AU,2013.0,67,55,12
BE,KE,2020.0,6,9,-3
MX,KR,2020.0,2,3,-1
LB,FR,2003.0,18,25,-7
BE,BG,2000.0,3,3,0
VN,DK,2022.0,1,1,0
JO,BR,2012.0,2,5,-3
HU,FR,2018.0,19,26,-7
KW,QA,2014.0,1,1,0
CM,CA,2019.0,8,1,7
AU,RS,2018.0,8,10,-2
JP,TZ,2002.0,3,1,2
ES,TN,2019.0,8,8,0
PT,PL,2009.0,4,2,2
ME,RS,2020.0,17,17,0
MA,CL,2022.0,1,2,-1
JP,,2018.0,15831,0,15831
IN,,2008.0,2572,0,2572
,JP,2005.0,16010,0,16010
,JP,2002.0,18007,0,18007
,CH,2011.0,4174,0,4174
AU,,2025.0,6310,0,6310
CH,,2024.0,28237,0,28237
,SE,1999.0,3031,0,3031
SE,,2011.0,3578,0,3578
TR,,2004.0,410,0,410
CA,GT,2013.0,1,0,1
,IN,2014.0,29309,0,29309
ZW,,2023.0,552,0,552
,DE,2018.0,16160,0,16160
BE,,2000.0,599,0,599
,FI,2014.0,1851,0,1851
SA,,2000.0,153,0,153
RS,,2024.0,5634,0,5634
,NZ,1999.0,880,0,880
,GR,2012.0,2526,0,2526
CH,ZW,2015.0,1,0,1
RO,,2017.0,1442,0,1442
NZ,,2015.0,735,0,735
,PE,2014.0,892,0,892
QA,,2023.0,1521,0,1521
,GB,2016.0,14603,0,14603
LU,,2021.0,252,0,252
VE,,2021.0,414,0,414
,RS,2009.0,1163,0,1163
,AE,2011.0,349,0,349
NP,,2024.0,1700,0,1700
KP,,2022.0,54,0,54
UA,,2024.0,11401,0,11401
AR,,2009.0,591,0,591
,VN,2009.0,327,0,327
BR,,1998.0,251,0,251
,HU,2005.0,1392,0,1392
nan,,2011.0,482,0,482
ZA,,2015.0,1214,0,1214
UY,CA,2006.0,2,0,2
BN,DE,2020.0,1,0,1
RO,,2010.0,305,0,305
RO,,2019.0,1497,0,1497
AT,,2011.0,1071,0,1071
,IS,2005.0,99,0,99
,UA,2008.0,1317,0,1317
ME,,2024.0,212,0,212
,NG,2006.0,1077,0,1077
,ME,2015.0,37,0,37
EC,,2007.0,21,0,21
CU,,2002.0,49,0,49
,IS,2002.0,108,0,108
,HK,2003.0,18,0,18
,HU,2002.0,1119,0,1119
SY,,2006.0,23,0,23
MA,TR,2009.0,1,0,1
GP,,2006.0,9,0,9
,BA,2015.0,268,0,268
TZ,,2022.0,528,0,528
KZ,CH,2000.0,1,0,1
ID,,2007.0,69,0,69
,CF,2011.0,8,0,8
CU,,2005.0,87,0,87
CI,,2016.0,94,0,94
PL,,1998.0,272,0,272
,AM,2012.0,149,0,149
,UZ,2005.0,171,0,171
AO,,2014.0,19,0,19
,GH,2007.0,173,0,173
PL,MS,2011.0,1,0,1
CY,,2018.0,148,0,148
UZ,,2022.0,347,0,347
,CD,2013.0,191,0,191
GN,,2024.0,81,0,81
,NP,2009.0,300,0,300
SD,,2004.0,9,0,9
SV,IN,2013.0,3,0,3
,QA,2016.0,354,0,354
,SN,2016.0,135,0,135
GB,SN,2017.0,3,0,3
IQ,,2016.0,108,0,108
RW,FR,2016.0,1,0,1
TN,,2006.0,61,0,61
LB,,2000.0,10,0,10
BA,,2008.0,17,0,17
KR,TZ,2021.0,5,0,5
,MG,2018.0,70,0,70
,GA,2012.0,33,0,33
GA,MA,2015.0,3,0,3
ER,FI,2020.0,1,0,1
,MM,2016.0,56,0,56
JO,IL,2014.0,2,0,2
,LU,2018.0,134,0,134
LV,,2005.0,37,0,37
,BH,2012.0,64,0,64
PA,CU,2021.0,1,0,1
,BO,2007.0,57,0,57
,TG,2018.0,47,0,47
BG,GD,2015.0,3,0,3
MX,TN,2017.0,2,0,2
NG,IE,2019.0,8,0,8
KE,FI,2022.0,2,0,2
TJ,DE,2012.0,1,0,1
UZ,MZ,2018.0,1,0,1
KZ,,2005.0,17,0,17
,UZ,2002.0,123,0,123
LY,,2007.0,12,0,12
,GM,2017.0,32,0,32
AU,MW,2021.0,2,0,2
nan,BF,2011.0,1,0,1
KE,,2008.0,65,0,65
,LS,2008.0,16,0,16
BH,GB,2000.0,3,0,3
,GF,2004.0,3,0,3
,MQ,2014.0,32,0,32
,SD,2006.0,93,0,93
SA,UY,2018.0,1,0,1
DE,SA,1999.0,5,0,5
GH,CN,2007.0,4,0,4
NO,RS,2015.0,3,0,3
MC,nan,2007.0,1,0,1
FR,OM,1998.0,1,0,1
OM,BD,2007.0,2,0,2
,PR,2008.0,20,0,20
GE,TR,2022.0,2,0,2
nan,GE,2009.0,4,0,4
ZW,CA,2009.0,5,0,5
EE,MY,2017.0,1,0,1
IT,TZ,2022.0,2,0,2
CR,CH,2018.0,2,0,2
MX,BD,2019.0,3,0,3
CH,SA,2005.0,3,0,3
IL,VG,2019.0,1,0,1
UY,PA,2018.0,1,0,1
NG,,1998.0,81,0,81
,GM,2019.0,16,0,16
,KN,2018.0,13,0,13
BY,IL,2011.0,2,0,2
JP,GE,2003.0,3,0,3
LA,,2018.0,9,0,9
,ZM,2001.0,25,0,25
MW,CN,2022.0,2,0,2
RS,LV,2017.0,2,0,2
GE,SA,2012.0,1,0,1
AT,ID,2009.0,2,0,2
CO,DK,2006.0,2,0,2
RO,TR,2000.0,1,0,1
nan,JP,2023.0,1,0,1
VE,GD,2017.0,1,0,1
,VG,2012.0,17,0,17
SA,ZA,2008.0,2,0,2
BN,,2013.0,4,0,4
BN,SG,2022.0,1,0,1
UG,,2013.0,78,0,78
ES,BY,2016.0,1,0,1
,PF,1998.0,7,0,7
CZ,HR,2000.0,3,0,3
EG,UG,2016.0,1,0,1
FJ,,2020.0,20,0,20
CU,BR,1998.0,8,0,8
nan,IS,2007.0,1,0,1
UY,DE,2021.0,3,0,3
MY,CH,2004.0,2,0,2
SA,ES,2007.0,1,0,1
,GL,1999.0,2,0,2
IR,ZA,2010.0,2,0,2
CW,RU,2007.0,1,0,1
LV,,2002.0,28,0,28
RU,MD,2023.0,2,0,2
KH,,2014.0,17,0,17
AZ,CD,2021.0,1,0,1
,SR,2014.0,11,0,11
MZ,CZ,2009.0,1,0,1
WS,,2023.0,8,0,8
CU,DE,2003.0,1,0,1
KZ,,2002.0,7,0,7
VN,RO,2019.0,4,0,4
CD,BR,2022.0,1,0,1
NZ,AL,2018.0,1,0,1
MY,BE,1998.0,1,0,1
,GM,2010.0,10,0,10
PH,IR,2000.0,1,0,1
,RW,2004.0,14,0,14
CI,ES,2013.0,1,0,1
DO,,2011.0,2,0,2
HU,MM,2000.0,1,0,1
AU,PS,2012.0,1,0,1
CL,RS,2008.0,1,0,1
IL,TR,2000.0,6,0,6
UA,DK,2006.0,1,0,1
CN,BW,2017.0,1,0,1
NO,IR,2002.0,2,0,2
NZ,NC,2017.0,1,0,1
MK,AE,2019.0,1,0,1
MZ,SE,2004.0,2,0,2
CZ,RO,2003.0,4,0,4
YE,,2012.0,13,0,13
nan,ZA,1998.0,3,0,3
BH,YE,2012.0,1,0,1
JM,,2002.0,9,0,9
SV,PT,2017.0,1,0,1
VG,,2015.0,17,0,17
ET,KE,2012.0,4,0,4
KR,NG,2000.0,1,0,1
MM,US,2006.0,4,0,4
BG,CA,2009.0,4,0,4
IT,MC,2014.0,3,0,3
NG,ES,2005.0,1,0,1
,GI,2009.0,3,0,3
DE,GL,2011.0,1,0,1
BB,,2013.0,7,0,7
GB,KG,2013.0,1,0,1
PH,UG,2018.0,1,0,1
MA,PT,2001.0,2,0,2
KE,SO,2019.0,2,0,2
LS,SZ,2022.0,1,0,1
ZA,AT,2021.0,6,0,6
NP,FI,2011.0,1,0,1
RW,CA,2021.0,5,0,5
VN,CZ,2010.0,4,0,4
MX,DO,2007.0,1,0,1
KE,GM,2022.0,1,0,1
IN,KZ,2021.0,4,0,4
CL,UZ,2010.0,1,0,1
,PY,2000.0,11,0,11
ZA,SI,2018.0,1,0,1
TH,HU,2018.0,1,0,1
DO,EC,2017.0,1,0,1
XK,ME,2002.0,1,0,1
CG,,2003.0,1,0,1
HR,GE,2004.0,1,0,1
AT,RS,2023.0,1,0,1
TW,EG,2023.0,1,0,1
BO,MX,2002.0,1,0,1
BD,CI,2011.0,1,0,1
KZ,BG,2021.0,1,0,1
IN,LV,2021.0,4,0,4
GE,nan,2013.0,8,0,8
ES,AO,2017.0,3,0,3
BG,SE,2015.0,3,0,3
BE,KR,2005.0,7,0,7
SG,PH,1997.0,1,0,1
ZW,CH,2018.0,2,0,2
PW,,2023.0,9,0,9
KZ,MD,2022.0,3,0,3
NL,TT,2002.0,1,0,1
HU,PT,2012.0,1,0,1
HR,SG,2016.0,1,0,1
UG,NG,2001.0,1,0,1
NO,NA,2008.0,1,0,1
CR,RU,2018.0,4,0,4
DK,HR,2006.0,2,0,2
IR,CO,2019.0,18,0,18
,TJ,2003.0,9,0,9
CY,PK,2011.0,1,0,1
NL,TZ,2005.0,2,0,2
TR,OM,2000.0,1,0,1
CO,FJ,2018.0,1,0,1
TZ,MZ,2012.0,1,0,1
UA,GH,2008.0,1,0,1
MZ,TZ,2018.0,1,0,1
JP,TN,2009.0,2,0,2
CL,JP,2002.0,2,0,2
US,FO,2004.0,2,0,2
,PF,1997.0,7,0,7
IQ,SE,2004.0,1,0,1
CN,KP,2016.0,5,0,5
TW,RS,2013.0,2,0,2
HN,AR,2022.0,2,0,2
NL,PS,2006.0,1,0,1
ZA,LR,2019.0,1,0,1
BB,NZ,1997.0,1,0,1
AR,IN,2001.0,2,0,2
CL,TH,2002.0,1,0,1
SE,BF,2016.0,5,0,5
IT,TH,2021.0,4,0,4
TR,PL,2009.0,3,0,3
KE,IS,2010.0,1,0,1
,GF,1996.0,6,0,6
RS,AR,2018.0,3,0,3
GH,BE,2020.0,1,0,1
AT,SD,2013.0,1,0,1
BF,AU,2013.0,1,0,1
ES,LB,2010.0,1,0,1
IM,US,2016.0,2,0,2
VG,FR,2014.0,3,0,3
AT,VN,2003.0,1,0,1
IR,NP,2017.0,1,0,1
EC,CH,2022.0,1,0,1
PH,RU,2014.0,1,0,1
RU,HR,2000.0,2,0,2
IR,BW,2010.0,1,0,1
ZW,NA,2011.0,2,0,2
EE,ES,2023.0,1,0,1
RE,PL,2005.0,1,0,1
ET,BE,2008.0,2,0,2
MA,RO,2017.0,1,0,1
CO,KP,2008.0,1,0,1
SE,IQ,2003.0,1,0,1
NO,YE,2019.0,1,0,1
NG,SN,2021.0,1,0,1
AR,GR,2013.0,1,0,1
SS,ET,2019.0,1,0,1
KZ,FK,2019.0,1,0,1
IN,VE,2008.0,2,0,2
RS,TW,2016.0,1,0,1
KE,EG,2001.0,1,0,1
SA,BR,2003.0,1,0,1
NE,GB,2011.0,1,0,1
RU,JM,2006.0,1,0,1
JM,NG,2013.0,2,0,2
TZ,DK,2008.0,2,0,2
LU,MW,2007.0,1,0,1
JM,,2005.0,9,0,9
HN,GB,2009.0,1,0,1
EE,AE,2015.0,1,0,1
BH,QA,2015.0,3,0,3
NO,IL,1997.0,1,0,1
KR,NO,1999.0,2,0,2
GR,nan,2006.0,4,0,4
PL,CL,2012.0,4,0,4
FK,GB,2018.0,1,0,1
AT,MM,2017.0,1,0,1
NI,VE,2004.0,1,0,1
TR,JO,2008.0,1,0,1
HR,BA,2005.0,7,0,7
QA,RS,2021.0,3,0,3
CM,ID,2013.0,1,0,1
PK,TJ,2014.0,2,0,2
TH,IT,1999.0,1,0,1
KP,GB,2021.0,1,0,1
nan,ST,2008.0,2,0,2
TT,UY,2019.0,1,0,1
IN,CL,1998.0,1,0,1
JP,AE,2004.0,3,0,3
,AO,2015.0,16,0,16
PG,US,1997.0,1,0,1
IL,ET,1998.0,1,0,1
CO,EG,2009.0,2,0,2
JO,NL,2002.0,2,0,2
KR,MV,2013.0,1,0,1
GT,EC,2009.0,1,0,1
FJ,BR,2003.0,1,0,1
BW,PS,2014.0,1,0,1
RU,MY,2000.0,2,0,2
OM,AE,1998.0,1,0,1
DZ,NG,2015.0,1,0,1
CU,JP,2015.0,1,0,1
VG,LB,2018.0,1,0,1
UG,ES,2013.0,1,0,1
IN,BA,2006.0,1,0,1
BR,LV,2016.0,1,0,1
ID,PL,2008.0,1,0,1
CY,IE,2020.0,4,0,4
VN,GR,2015.0,3,0,3
BO,PE,2002.0,4,0,4
MG,AU,2014.0,1,0,1
AM,FR,2022.0,2,0,2
GM,,2004.0,3,0,3
LS,ZA,2012.0,5,0,5
CA,PF,2009.0,1,0,1
GE,IE,2021.0,2,0,2
TH,AR,2001.0,1,0,1
GH,RS,2016.0,1,0,1
CR,MY,2003.0,1,0,1
SE,EC,2000.0,1,0,1
XK,GB,2008.0,1,0,1
PR,CO,2015.0,1,0,1
TN,GH,2020.0,1,0,1
ID,NE,2020.0,1,0,1
CZ,SA,2016.0,4,0,4
CN,UY,2010.0,1,0,1
ML,MX,2017.0,1,0,1
IL,IR,2005.0,1,0,1
PL,NC,2017.0,1,0,1
US,SS,2019.0,2,0,2
JO,MU,2021.0,1,0,1
KW,AE,2012.0,5,0,5
MT,,2009.0,9,0,9
GP,MQ,2016.0,2,0,2
TT,BS,2020.0,1,0,1
BA,CH,2020.0,3,0,3
US,GA,2007.0,1,0,1
UA,MY,2011.0,2,0,2
CU,PY,2001.0,4,0,4
ES,LV,1997.0,1,0,1
LU,BD,2014.0,1,0,1
RW,ZA,2009.0,1,0,1
CM,SE,2000.0,4,0,4
LK,SI,2016.0,1,0,1
GE,JP,2000.0,1,0,1
RO,AE,2013.0,1,0,1
PH,IT,2005.0,2,0,2
CH,CR,2022.0,3,0,3
ES,BO,1999.0,2,0,2
TH,MY,2008.0,1,0,1
ZW,RU,2004.0,2,0,2
ZM,MY,2016.0,3,0,3
IL,SI,2006.0,1,0,1
XK,,2008.0,3,0,3
MU,nan,2011.0,2,0,2
BG,AU,2006.0,3,0,3
FJ,DK,2008.0,1,0,1
JP,NP,2006.0,2,0,2
BI,,2013.0,5,0,5
IN,BY,2004.0,1,0,1
JO,PS,2010.0,2,0,2
CM,KE,2003.0,2,0,2
TT,CU,1998.0,1,0,1
BJ,DE,2022.0,1,0,1
RS,LT,2010.0,1,0,1
PL,PG,2010.0,1,0,1
UA,MX,2011.0,1,0,1
nan,JM,2007.0,1,0,1
SI,ZA,2011.0,1,0,1
MA,NG,2018.0,3,0,3
XK,FR,2021.0,1,0,1
GE,NP,2020.0,1,0,1
RU,LY,2003.0,3,0,3
PK,FI,2009.0,3,0,3
NL,KW,2006.0,1,0,1
KE,ZA,1999.0,2,0,2
MN,CN,2022.0,1,0,1
GE,NL,2006.0,1,0,1
IL,EE,2003.0,1,0,1
IT,BF,1997.0,1,0,1
PK,AR,1999.0,1,0,1
FR,AL,2004.0,1,0,1
CL,SA,2014.0,1,0,1
BY,UZ,1999.0,1,0,1
AT,GH,2021.0,1,0,1
CN,JM,2009.0,1,0,1
SN,LU,2022.0,1,0,1
NA,,2004.0,5,0,5
RU,EC,1998.0,1,0,1
BY,PK,2022.0,1,0,1
PH,BO,2021.0,1,0,1
IL,VE,2003.0,2,0,2
GE,SK,2007.0,1,0,1
ER,KE,2017.0,1,0,1
BG,PT,2001.0,1,0,1
TH,PT,2022.0,1,0,1
FI,EC,2018.0,1,0,1
PL,VE,2017.0,3,0,3
IE,PH,2015.0,1,0,1
PL,HR,2003.0,1,0,1
RU,CU,2008.0,1,0,1
TR,VE,2000.0,1,0,1
MS,,2018.0,2,0,2
TH,CN,1999.0,2,0,2
DE,UY,1999.0,2,0,2
ZA,CR,2004.0,1,0,1
DZ,TH,2016.0,1,0,1
MA,BH,2022.0,2,0,2
BR,BJ,1999.0,1,0,1
CH,LK,1999.0,1,0,1
PG,TR,2017.0,1,0,1
BI,RU,2017.0,1,0,1
MY,TT,2020.0,1,0,1
GE,AT,1999.0,1,0,1
SG,RO,2022.0,1,0,1
TH,DZ,2018.0,1,0,1
BN,VN,2019.0,2,0,2
AE,YE,2020.0,1,0,1
AR,EC,2000.0,1,0,1
IE,EC,2017.0,2,0,2
MG,NZ,2021.0,1,0,1
IS,NZ,2018.0,1,0,1
SE,UZ,2019.0,1,0,1
CH,IR,2004.0,2,0,2
JP,TZ,2005.0,2,0,2
NL,BT,2012.0,1,0,1
SK,PL,1999.0,1,0,1
SC,CG,2011.0,1,0,1
BG,MT,2022.0,1,0,1
SI,EG,2021.0,1,0,1
UA,SD,2018.0,1,0,1
UG,DK,2013.0,1,0,1
CG,CH,1997.0,1,0,1
LY,IN,2021.0,1,0,1
AU,LV,2022.0,2,0,2
PK,SO,2018.0,1,0,1
GP,RE,2017.0,1,0,1
RU,TR,2023.0,1,0,1
PT,PE,2004.0,1,0,1
IQ,OM,2010.0,1,0,1
AR,CH,1997.0,1,0,1
LU,PE,2018.0,1,0,1
PT,CZ,1997.0,1,0,1
BG,DK,1998.0,1,0,1
NO,MX,2023.0,1,0,1
NO,ME,2019.0,1,0,1
HT,CL,2011.0,1,0,1
IT,CG,2022.0,1,0,1
NG,SY,2003.0,1,0,1
SE,AL,2022.0,2,0,2
KE,MW,2016.0,1,0,1
JP,MQ,2008.0,3,0,3
AU,BO,2018.0,1,0,1
GA,BJ,2020.0,2,0,2
UG,nan,2022.0,1,0,1
GB,CM,2000.0,1,0,1
PK,GR,2001.0,2,0,2
AT,MD,2011.0,1,0,1
UG,CA,2005.0,1,0,1
,KY,2002.0,1,0,1
BF,PK,2006.0,1,0,1
BR,TG,2018.0,1,0,1
PT,MD,2005.0,1,0,1
US,GN,1999.0,1,0,1
SD,CH,2008.0,1,0,1
IL,UY,2021.0,1,0,1
AE,AT,2007.0,1,0,1
GM,KE,2011.0,1,0,1
LU,MK,2018.0,1,0,1
BZ,US,2004.0,1,0,1
NG,ES,2002.0,2,0,2
ZA,GN,2019.0,1,0,1
TG,ML,2020.0,3,0,3
IE,KZ,2015.0,2,0,2
IR,MK,2018.0,1,0,1
NE,CM,2010.0,1,0,1
IE,AR,2003.0,1,0,1
MX,BD,2017.0,1,0,1
MR,FR,2013.0,2,0,2
IL,PT,2003.0,1,0,1
DK,MK,2017.0,1,0,1
SG,PA,2016.0,1,0,1
GH,ML,2002.0,1,0,1
PL,SG,1997.0,1,0,1
CM,CD,2017.0,1,0,1
BW,,1999.0,1,0,1
SK,NG,2021.0,1,0,1
MK,CL,2012.0,1,0,1
PL,KG,2019.0,1,0,1
NZ,PL,1997.0,2,0,2
BF,KE,2015.0,1,0,1
RU,QA,2019.0,1,0,1
PE,TW,2012.0,1,0,1
FI,KE,2013.0,3,0,3
LT,GR,2020.0,1,0,1
BY,KR,2021.0,1,0,1
SK,IL,2013.0,1,0,1
,KY,2005.0,1,0,1
BY,NO,2014.0,1,0,1
SA,PA,2017.0,1,0,1
AT,BN,2015.0,1,0,1
ID,AL,2021.0,2,0,2
LU,ZA,2007.0,2,0,2
GB,AO,2004.0,1,0,1
LY,FR,2005.0,1,0,1
DK,GH,2015.0,1,0,1
NL,NA,2019.0,1,0,1
NL,TT,2005.0,1,0,1
CN,TT,2002.0,1,0,1
CO,PY,2007.0,1,0,1
KE,NA,1999.0,1,0,1
MK,NL,2005.0,1,0,1
BH,RU,2012.0,1,0,1
CG,KE,2001.0,1,0,1
ZM,CG,2011.0,1,0,1
SG,PT,2004.0,2,0,2
IQ,TW,2018.0,1,0,1
IL,QA,2016.0,1,0,1
UZ,LT,2020.0,1,0,1
IL,CZ,2012.0,4,0,4
CA,KN,2012.0,2,0,2
CN,CU,2013.0,1,1,0
JP,NO,1999.0,5,4,1
SE,BW,2020.0,1,2,-1
SE,PT,2003.0,3,6,-3
RS,IE,2018.0,4,1,3
JP,GH,2007.0,2,3,-1
RU,KE,2020.0,1,2,-1
AT,NZ,2008.0,1,1,0
RE,BJ,2019.0,1,1,0
FR,RW,2013.0,3,1,2
GB,BH,2002.0,1,3,-2
NZ,KH,2015.0,1,1,0
CN,KH,2015.0,1,1,0
PT,ID,2005.0,1,1,0
SA,FI,2016.0,1,2,-1
QA,MA,2017.0,1,2,-1
NG,IE,2017.0,2,2,0
NL,CY,2007.0,1,1,0
TH,BT,2014.0,1,1,0
CY,AU,2009.0,2,1,1
KH,LT,2013.0,1,1,0
NP,TW,2013.0,1,2,-1
VN,NZ,2016.0,3,3,0
NL,TZ,2002.0,2,1,1
JO,NL,2005.0,1,2,-1
DE,TN,2019.0,2,9,-7
DZ,CH,2013.0,2,1,1
CU,CO,2000.0,2,6,-4
KR,PT,1998.0,1,1,0
CR,AR,2003.0,1,1,0
NL,SI,2010.0,3,3,0
AU,LB,2022.0,1,1,0
BJ,CM,2021.0,1,3,-2
MY,MX,2012.0,1,2,-1
MK,SI,2010.0,1,1,0
RU,MN,2011.0,1,2,-1
ES,SK,2002.0,2,3,-1
JO,PK,2022.0,2,2,0
EC,CO,2006.0,4,6,-2
IE,RU,2008.0,2,8,-6
AU,CG,2021.0,1,1,0
CZ,CO,2014.0,2,1,1
SE,KE,2001.0,1,6,-5
MY,TN,2019.0,2,3,-1
SE,TW,2016.0,1,12,-11
BE,MY,2008.0,1,1,0
CA,KZ,2011.0,1,1,0
MA,CH,2013.0,1,2,-1
CN,SN,2022.0,1,2,-1
DE,VE,2012.0,3,8,-5
SL,GH,2019.0,1,1,0
GL,NO,2009.0,1,1,0
GB,ML,2019.0,1,1,0
DK,PT,2001.0,3,1,2
AU,PA,2020.0,2,4,-2
AU,HK,2008.0,2,1,1
HU,MX,2021.0,1,4,-3
MT,IE,2021.0,1,1,0
IT,CY,2011.0,2,2,0
RW,ID,2021.0,1,1,0
AR,CZ,2012.0,1,2,-1
nan,IQ,2018.0,1,1,0
RU,SI,2015.0,1,7,-6
JO,nan,2014.0,1,1,0
KZ,ES,2018.0,1,3,-2
GE,DE,2004.0,2,9,-7
DE,ZW,2016.0,1,2,-1
QA,MA,2019.0,2,2,0
LT,FI,2022.0,1,2,-1
CZ,KZ,2017.0,1,1,0
SG,TH,2001.0,2,3,-1
AZ,TR,2005.0,1,3,-2
VA,IT,2019.0,1,2,-1
NO,PA,2012.0,1,1,0
FR,TT,2021.0,2,1,1
JP,VE,2003.0,1,1,0
IT,XK,2017.0,1,1,0
US,ZM,2008.0,1,8,-7
CN,MN,2001.0,1,1,0
MX,SI,2006.0,1,1,0
UG,CN,2001.0,1,1,0
SE,PA,2012.0,1,2,-1
GB,BO,2018.0,3,1,2
MM,CN,2017.0,1,4,-3
IN,CO,2017.0,2,5,-3
OM,EG,2006.0,1,3,-2
IT,PS,2004.0,1,1,0
AE,BD,2011.0,1,1,0
nan,MA,2016.0,1,2,-1
GB,KR,2023.0,1,8,-7
BI,DZ,2018.0,1,2,-1
VE,CH,2009.0,1,2,-1
CH,VN,2012.0,3,1,2
UY,EC,2013.0,1,1,0
BE,AM,2011.0,1,2,-1
IT,DZ,2006.0,1,6,-5
ES,HU,2005.0,1,3,-2
ES,AO,2010.0,2,1,1
AM,CZ,2020.0,2,5,-3
NZ,BE,1997.0,1,1,0
NO,RO,2000.0,1,2,-1
ZW,SE,2011.0,1,2,-1
nan,KE,2017.0,1,8,-7
MK,BG,2021.0,1,2,-1
MY,FI,2016.0,1,6,-5
CG,BE,2007.0,1,3,-2
CR,DE,2006.0,1,1,0
JM,GB,2019.0,3,11,-8
XK,AT,2022.0,1,1,0
PH,SG,2000.0,1,2,-1
CN,MD,2022.0,1,2,-1
MX,BD,2010.0,1,1,0
JO,FR,2018.0,1,3,-2
AT,PS,2013.0,1,1,0
SC,US,2002.0,1,1,0
IT,LT,2020.0,1,3,-2
ID,IE,2018.0,1,1,0
BE,TH,2003.0,1,1,0
SE,HR,2016.0,1,4,-3
CL,UY,2000.0,1,2,-1
NG,SI,2013.0,1,1,0
MY,NI,2020.0,1,3,-2
BW,ET,2018.0,1,3,-2
NZ,TH,2001.0,2,3,-1
NL,PH,2005.0,1,1,0
SE,CZ,1998.0,1,5,-4
US,AM,2007.0,3,10,-7
AL,BE,2014.0,1,1,0
CA,ET,2008.0,1,4,-3
IL,TZ,2018.0,1,1,0
NG,JO,2021.0,2,1,1
MD,BE,2008.0,1,4,-3
UZ,TJ,2014.0,1,2,-1
TN,IN,2016.0,3,8,-5
EE,PL,2016.0,1,1,0
PH,IT,2002.0,1,2,-1
QA,nan,2019.0,1,2,-1
IS,CH,2007.0,1,2,-1
DE,UG,2022.0,1,2,-1
ES,LB,2017.0,2,2,0
JP,LY,2013.0,1,1,0
JP,DZ,2000.0,1,2,-1
UG,NL,2000.0,1,2,-1
DK,SA,2012.0,1,2,-1
MK,GB,2006.0,1,4,-3
JO,CH,2015.0,1,1,0
DE,BW,2018.0,1,2,-1
NZ,BE,1998.0,1,1,0
IR,JO,2021.0,1,1,0
DK,IR,2007.0,1,2,-1
IE,CZ,2020.0,1,2,-1
ES,DZ,2013.0,1,1,0
TT,MS,1999.0,1,1,0
AT,PA,2013.0,1,1,0
PK,UG,2016.0,1,3,-2
IR,KW,2015.0,1,1,0
LI,AT,2019.0,1,3,-2
NL,LT,2002.0,1,1,0
UA,SG,2012.0,1,1,0
PT,ZA,2006.0,1,1,0
SY,RU,2022.0,1,1,0
AE,KE,2016.0,1,1,0
BO,SE,2015.0,1,2,-1
MX,NL,1997.0,1,3,-2
TH,OM,2009.0,1,1,0
AR,DO,2018.0,1,3,-2
IS,PL,2017.0,2,2,0
DK,IL,2000.0,3,2,1
CH,LB,2012.0,1,1,0
IR,PL,2011.0,3,2,1
MY,HU,2015.0,1,1,0
AU,UY,2022.0,1,3,-2
VE,PA,2009.0,1,1,0
US,SL,2010.0,2,1,1
DK,ID,2018.0,2,1,1
MA,ZA,2018.0,1,1,0
YE,US,2011.0,1,3,-2
GH,SN,2013.0,1,1,0
JO,IN,2007.0,1,3,-2
GE,KR,2019.0,1,2,-1
CA,ML,2022.0,1,1,0
ES,RO,2001.0,1,3,-2
BR,NZ,1998.0,1,2,-1
MX,ID,2001.0,1,1,0
US,EC,1997.0,1,3,-2
TR,LU,2012.0,1,0,1
BG,IN,2003.0,1,0,1
BT,,2020.0,5,0,5
AZ,JP,1998.0,2,0,2
,SX,2009.0,1,0,1
RW,BD,2007.0,1,0,1
GR,HU,1997.0,2,0,2
MY,HK,2006.0,1,0,1
FR,AE,2002.0,2,0,2
TN,IL,2014.0,1,0,1
MA,RW,2015.0,1,0,1
,MU,2020.0,1,0,1
PL,BH,2010.0,1,0,1
MY,BN,1999.0,1,0,1
IS,KR,2001.0,1,0,1
ID,CR,2000.0,1,0,1
PL,MA,2010.0,1,0,1
MA,BR,2012.0,2,0,2
LV,PT,2016.0,1,0,1
IR,JM,1999.0,1,0,1
NL,MY,2006.0,1,0,1
SG,PH,1998.0,3,0,3
CL,TR,2020.0,2,0,2
MY,MM,2009.0,1,0,1
NO,NZ,1997.0,1,0,1
SJ,IS,2008.0,1,0,1
DE,PY,2018.0,1,0,1
LK,IE,2012.0,1,0,1
BT,AU,2011.0,2,0,2
HK,BE,2022.0,1,0,1
,VI,1997.0,3,0,3
IE,SA,2005.0,1,0,1
GF,MA,2017.0,1,0,1
KZ,NG,2014.0,1,0,1
ZA,LU,2008.0,1,0,1
RU,AR,2006.0,1,0,1
FJ,AU,2000.0,2,0,2
AU,AM,2007.0,1,0,1
SE,UY,2018.0,2,0,2
EE,NZ,2017.0,1,0,1
DK,NG,2005.0,1,0,1
,SJ,2003.0,2,0,2
CL,NI,2013.0,2,0,2
IR,CO,2017.0,2,0,2
BI,UG,2020.0,1,0,1
CH,TT,2012.0,1,0,1
PA,BE,2022.0,1,0,1
KE,PL,2018.0,1,0,1
PK,MA,2001.0,1,0,1
IE,PK,2002.0,1,0,1
PF,,2011.0,2,0,2
BY,MZ,2008.0,1,0,1
NL,SD,2015.0,1,0,1
BI,CH,2011.0,1,0,1
BJ,UG,2014.0,1,0,1
GB,SM,2019.0,3,0,3
MG,DK,2010.0,1,0,1
nan,LK,2013.0,1,0,1
MY,ML,2012.0,1,0,1
BR,BY,2014.0,1,0,1
RU,QA,2010.0,1,0,1
TW,BJ,2014.0,1,0,1
FI,GH,2007.0,1,0,1
TH,CO,2022.0,1,0,1
SE,KZ,2014.0,2,0,2
SN,CD,2011.0,1,0,1
HU,YE,1998.0,1,0,1
MY,DO,2016.0,1,0,1
nan,YE,2022.0,2,0,2
TN,NO,2020.0,1,0,1
IN,ID,1999.0,2,0,2
MN,GB,2015.0,1,0,1
MX,SY,1998.0,1,0,1
MX,PY,2000.0,1,0,1
US,IM,2005.0,1,0,1
GB,LR,2018.0,1,0,1
MY,RW,2018.0,1,0,1
DK,SD,2013.0,1,0,1
IL,PH,2001.0,1,0,1
IR,QA,2011.0,1,0,1
MM,,2005.0,1,0,1
CZ,ZM,2020.0,2,0,2
CZ,UY,2018.0,1,0,1
DZ,DK,2018.0,2,0,2
GB,PF,2020.0,1,0,1
VE,FI,2004.0,1,0,1
ML,CI,2000.0,1,0,1
US,EC,1998.0,4,0,4
,RW,1996.0,1,0,1
CH,PA,2003.0,1,0,1
AM,GB,2012.0,1,0,1
AZ,CY,2009.0,1,0,1
EG,BR,1998.0,1,0,1
DZ,BD,2020.0,1,0,1
DE,ME,2004.0,1,0,1
IL,MS,2020.0,1,0,1
LK,NP,2015.0,1,0,1
IQ,IT,2010.0,1,0,1
UZ,BE,2013.0,1,0,1
XK,CA,2021.0,1,0,1
RU,SY,2023.0,1,0,1
SI,RO,2008.0,1,0,1
,WS,2004.0,1,0,1
LT,BH,2011.0,1,0,1
NA,IT,2003.0,1,0,1
KR,GR,2010.0,1,0,1
ID,PA,2004.0,1,0,1
SC,SG,2020.0,1,0,1
BW,IT,2020.0,1,0,1
TZ,AT,2015.0,1,0,1
DJ,IS,2011.0,1,0,1
NO,MT,2020.0,2,0,2
GP,GB,2008.0,1,0,1
AO,RU,2005.0,1,0,1
SD,GE,2003.0,1,0,1
SS,BR,1998.0,1,0,1
NA,CH,2018.0,1,0,1
BH,HU,2009.0,1,0,1
ZA,NA,2006.0,1,0,1
BG,TR,2003.0,1,0,1
FI,ID,2006.0,1,0,1
NZ,PL,1998.0,2,0,2
TW,MM,2004.0,1,0,1
DK,CO,2003.0,1,0,1
BR,AL,2017.0,1,0,1
CY,GH,2021.0,1,0,1
TG,DE,2012.0,1,0,1
BE,LV,1998.0,1,0,1
SV,AM,2019.0,1,0,1
SY,AU,2005.0,1,0,1
BY,SK,2021.0,1,0,1
UZ,TW,2002.0,1,0,1
CA,GD,2011.0,1,0,1
KH,PH,2004.0,1,0,1
SE,UZ,2010.0,1,0,1
MA,MY,2005.0,1,0,1
SA,CH,1997.0,1,0,1
IQ,ET,2020.0,2,0,2
GB,GD,2004.0,2,0,2
US,KG,2006.0,1,0,1
FI,MX,2004.0,1,0,1
MA,IL,2003.0,1,0,1
NE,CM,2017.0,1,0,1
SG,GH,2012.0,1,0,1
NL,LB,2012.0,1,0,1
IE,SD,2022.0,1,0,1
CG,PF,2018.0,1,0,1
IS,CN,2019.0,1,0,1
SO,nan,2018.0,1,0,1
AU,DZ,2011.0,1,0,1
EC,CR,2004.0,1,0,1
TZ,TN,2020.0,1,0,1
IS,TR,2015.0,1,0,1
OM,NL,2012.0,1,0,1
MD,BR,2019.0,1,0,1
BR,PG,2016.0,1,0,1
DO,nan,2014.0,1,0,1
AZ,EE,2018.0,1,0,1
DE,BI,2017.0,1,0,1
DZ,SY,2018.0,1,0,1
PA,BN,1998.0,1,0,1
MK,XK,2011.0,1,0,1
CF,IN,2006.0,1,0,1
AG,JP,2018.0,1,0,1
RS,FI,2002.0,1,0,1
ZA,CO,2023.0,1,0,1
ZA,PL,2002.0,1,0,1
IM,GB,2011.0,1,0,1
BN,AT,2020.0,1,0,1
CW,DK,2009.0,1,0,1
PG,US,1998.0,1,0,1
FR,MT,2013.0,1,0,1
BR,AG,2011.0,1,0,1
BI,BE,2005.0,1,0,1
CW,UG,2008.0,1,0,1
SV,PT,2019.0,1,0,1
,MV,2004.0,1,0,1
VE,TH,2013.0,1,0,1
MA,NO,2013.0,1,0,1
PS,SY,2021.0,1,0,1
IQ,TN,2008.0,1,0,1
SD,HU,2021.0,2,0,2
AR,GT,2003.0,1,0,1
,CI,2020.0,2,0,2
RW,TR,2020.0,1,0,1
BY,EC,2006.0,1,0,1
ET,EG,2007.0,1,0,1
HU,BG,1997.0,1,0,1
SG,YE,2016.0,1,0,1
BR,IR,2023.0,1,0,1
NP,IT,2020.0,1,0,1
TR,SK,2022.0,1,0,1
SA,NG,2023.0,1,0,1
SY,IQ,2011.0,1,0,1
KH,CA,2015.0,1,0,1
SK,PK,2017.0,1,0,1
UA,KE,2017.0,1,0,1
DE,AZ,2020.0,1,0,1
CY,IQ,2022.0,1,0,1
TH,CD,2021.0,1,0,1
US,MX,2016.0,456,449,7
US,IN,2018.0,2934,3188,-254
IN,GB,2016.0,475,578,-103
US,CN,2001.0,2897,2501,396
CA,US,2008.0,2825,2829,-4
FR,CH,2014.0,477,385,92
IT,PE,2012.0,12,2,10
KR,IN,2008.0,62,136,-74
KR,PR,2018.0,53,35,18
NO,FI,2022.0,14,17,-3
HK,CN,2013.0,82,140,-58
FR,IT,2017.0,359,458,-99
US,CA,2007.0,2880,2525,355
IT,FR,2012.0,411,278,133
PT,BR,2023.0,83,76,7
DE,GB,2009.0,796,709,87
ES,MX,2002.0,245,276,-31
AU,CN,2016.0,451,451,0
SG,CN,2009.0,317,360,-43
GB,GR,2004.0,117,90,27
CL,MX,2002.0,38,37,1
SE,US,2005.0,336,341,-5
GB,CA,2022.0,500,453,47
IN,US,2013.0,2027,2509,-482
PK,KR,2007.0,6,5,1
NZ,AU,2019.0,233,221,12
CA,AU,2002.0,142,178,-36
nan,ES,2008.0,21,16,5
BR,FR,2012.0,169,176,-7
US,UG,2014.0,34,40,-6
ES,AR,2002.0,118,134,-16
FR,MA,2004.0,207,138,69
CN,SG,2016.0,481,507,-26
US,TW,2007.0,740,593,147
CH,CA,2020.0,120,130,-10
US,CH,2013.0,923,745,178
GB,BR,2013.0,177,163,14
CN,NO,2013.0,28,42,-14
IT,GB,1998.0,191,125,66
SA,IQ,2016.0,18,12,6
US,KR,1997.0,366,223,143
CO,BR,2021.0,141,144,-3
US,KR,1998.0,468,261,207
AU,EG,2019.0,20,32,-12
ES,AR,2005.0,153,178,-25
BR,PT,2003.0,249,238,11
NZ,AU,2017.0,220,197,23
CL,MX,2005.0,51,70,-19
GB,IE,2013.0,323,396,-73
IL,DE,2007.0,42,30,12
DE,CH,2014.0,1018,824,194
FR,IT,2010.0,268,332,-64
BR,US,2007.0,678,781,-103
JP,US,2020.0,1518,1567,-49
CZ,CH,2022.0,12,19,-7
SE,CH,2013.0,59,71,-12
ET,KR,2013.0,145,86,59
CZ,BD,2006.0,1,1,0
GB,CH,2011.0,284,250,34
AR,ES,1998.0,69,59,10
ES,nan,2021.0,63,58,5
IT,JP,2013.0,67,77,-10
AE,PK,2013.0,6,4,2
ES,PA,2019.0,24,16,8
US,nan,2005.0,229,177,52
IR,CH,2018.0,39,21,18
IT,CA,2016.0,227,83,144
GB,ES,2006.0,216,192,24
AU,MY,2009.0,35,52,-17
MX,ES,2004.0,347,323,24
BE,US,2016.0,361,381,-20
CH,UA,2000.0,3,3,0
ES,MX,2005.0,348,361,-13
nan,FR,2010.0,180,229,-49
DE,PL,2012.0,123,113,10
IN,VN,2011.0,3,2,1
US,VG,2015.0,12,13,-1
US,TR,2010.0,395,332,63
GB,TW,2011.0,71,57,14
CZ,US,2011.0,138,150,-12
ES,CO,1999.0,31,45,-14
CN,IT,2010.0,28,35,-7
DK,CN,2013.0,34,46,-12
IT,GB,1997.0,116,103,13
FR,BD,2010.0,6,3,3
NL,DE,2014.0,410,368,42
PL,GB,2018.0,128,123,5
BR,AR,2021.0,130,124,6
DK,NO,2014.0,86,103,-17
BA,IQ,2021.0,3,3,0
JP,nan,2002.0,63,127,-64
CA,BR,2015.0,351,262,89
US,IE,1999.0,202,169,33
IT,RS,2015.0,14,9,5
ZA,BR,2001.0,1,2,-1
CN,DK,2022.0,48,50,-2
nan,NL,2014.0,86,76,10
AR,MX,2005.0,39,67,-28
MA,TN,2011.0,24,26,-2
CH,LU,2006.0,6,2,4
US,IL,2014.0,461,538,-77
SE,CA,2011.0,40,59,-19
AT,DE,2008.0,346,429,-83
US,HK,2020.0,14,12,2
AU,IT,2021.0,53,51,2
CZ,NO,2020.0,13,8,5
US,GE,2006.0,113,117,-4
MY,JO,2020.0,35,17,18
CA,DK,2004.0,11,23,-12
FR,IT,2019.0,424,459,-35
US,BE,2013.0,424,319,105
PE,ES,2012.0,70,110,-40
SE,AR,2015.0,6,10,-4
KR,JP,2013.0,306,435,-129
JP,SK,2007.0,12,13,-1
AU,NL,2009.0,53,73,-20
GB,RO,2016.0,53,55,-2
KR,CH,2009.0,12,19,-7
EE,LV,2021.0,1,5,-4
GB,FI,2020.0,93,68,25
DE,NL,2007.0,264,206,58
CU,CL,2020.0,29,18,11
CA,GR,2007.0,14,6,8
GB,JP,2003.0,263,223,40
ES,CL,2005.0,132,120,12
SD,SA,2012.0,12,6,6
IE,IT,2012.0,23,35,-12
MD,FR,2009.0,38,42,-4
DE,HU,2015.0,44,65,-21
HR,US,2016.0,26,47,-21
IT,MX,2002.0,20,11,9
NL,AU,2014.0,117,87,30
FI,RU,2020.0,31,44,-13
QA,US,2016.0,51,105,-54
US,TR,2017.0,425,528,-103
SK,US,2015.0,34,32,2
RO,US,2021.0,59,87,-28
FR,EG,2009.0,22,16,6
CN,VN,2004.0,23,47,-24
US,SA,2018.0,364,241,123
TW,JP,2008.0,49,67,-18
TH,BR,2015.0,5,4,1
NZ,AU,2010.0,163,130,33
MN,CN,2016.0,2,1,1
GR,CN,2013.0,14,24,-10
ZW,ZA,2016.0,42,24,18
CN,UZ,2015.0,15,13,2
US,UZ,2007.0,4,2,2
CI,FR,2022.0,7,14,-7
CN,RU,2001.0,14,13,1
NZ,CH,2012.0,12,11,1
RO,AT,2021.0,6,8,-2
SE,CN,2006.0,81,42,39
US,DK,2007.0,284,169,115
BD,CN,2009.0,38,57,-19
IT,CN,2014.0,47,38,9
HU,CN,2007.0,9,5,4
MX,CO,2003.0,55,44,11
US,RU,2004.0,249,364,-115
HU,FR,2017.0,19,18,1
FR,JP,2020.0,202,143,59
RU,BY,2016.0,47,106,-59
VN,MX,2015.0,4,10,-6
AU,IR,2014.0,57,127,-70
DE,GH,2013.0,5,8,-3
FR,AT,2011.0,49,40,9
ES,BR,2022.0,130,247,-117
JP,DE,2009.0,217,188,29
CN,NL,2016.0,142,118,24
SE,IT,2011.0,59,82,-23
GB,IL,2020.0,78,68,10
GR,FR,2015.0,51,47,4
EG,ID,2017.0,35,15,20
KR,TW,2006.0,39,34,5
VE,CL,2012.0,28,19,9
US,nan,2002.0,134,124,10
ES,CL,2002.0,84,102,-18
IR,BD,2020.0,8,3,5
nan,FR,2017.0,212,172,40
CU,MX,2014.0,52,53,-1
TH,MY,2013.0,6,6,0
PE,CU,2015.0,15,17,-2
LB,US,2021.0,95,43,52
BE,UG,2021.0,9,6,3
ET,DE,2016.0,4,10,-6
NZ,SA,2020.0,3,3,0
KR,nan,2019.0,23,31,-8
SG,ID,2015.0,19,6,13
ID,DE,2020.0,41,54,-13
IN,BY,2014.0,6,2,4
UA,DE,2009.0,35,33,2
SE,FI,2008.0,78,75,3
DE,nan,2016.0,77,71,6
MN,AU,2018.0,3,3,0
CL,AR,2004.0,33,36,-3
nan,JP,2000.0,80,86,-6
PH,GB,1999.0,8,10,-2
UY,ES,2014.0,41,44,-3
KZ,US,2020.0,13,23,-10
IT,HR,2016.0,10,9,1
BE,MX,2019.0,20,9,11
IS,SE,2013.0,22,15,7
PE,FR,2014.0,6,11,-5
CA,AU,2005.0,231,224,7
CH,RO,2021.0,13,11,2
CH,RU,2014.0,24,40,-16
BE,IL,2018.0,8,8,0
NZ,HU,2012.0,2,1,1
MX,BD,2018.0,2,1,1
CL,FI,2021.0,6,1,5
ZA,AU,2008.0,52,27,25
BY,RU,2005.0,31,31,0
ID,SG,2022.0,12,8,4
AU,FR,2013.0,105,140,-35
NP,CH,2015.0,3,1,2
GB,IT,2007.0,274,336,-62
CA,OM,2009.0,7,4,3
ET,US,2004.0,20,15,5
CO,CR,2006.0,7,14,-7
FR,DE,2006.0,369,418,-49
LB,IQ,2019.0,8,9,-1
BR,IT,2005.0,102,107,-5
VG,AU,2014.0,1,2,-1
DE,ID,2014.0,30,17,13
FR,AU,2008.0,127,75,52
IR,CA,2021.0,338,124,214
TH,JP,2021.0,46,80,-34
AU,NO,2015.0,27,16,11
IT,ZA,2004.0,5,3,2
IT,CL,2003.0,8,11,-3
BE,CH,2018.0,81,80,1
BD,EG,2018.0,11,6,5
MA,ZA,2019.0,1,1,0
BG,AT,2019.0,5,7,-2
VE,CU,2006.0,8,7,1
CH,PH,2010.0,5,3,2
nan,FR,2019.0,203,175,28
MY,US,2004.0,25,37,-12
NL,CO,2015.0,8,13,-5
BA,RS,2018.0,50,59,-9
GH,EG,2020.0,8,7,1
CA,EG,2020.0,113,76,37
RU,CH,2020.0,39,36,3
IN,DE,2021.0,194,171,23
RO,CA,2017.0,12,14,-2
PH,FR,2011.0,8,4,4
LB,TN,2015.0,3,2,1
SG,PK,2017.0,10,5,5
JP,nan,2005.0,53,103,-50
CL,BE,2021.0,18,8,10
VE,ES,1998.0,26,27,-1
IN,IT,2019.0,80,63,17
CN,TR,2006.0,12,6,6
MX,ID,2003.0,1,1,0
CM,ZA,2021.0,6,14,-8
BE,BF,2021.0,4,2,2
BR,IT,2002.0,75,84,-9
SI,HR,2019.0,35,49,-14
TR,ES,2017.0,10,9,1
OM,IQ,2021.0,9,2,7
BH,ZW,2016.0,2,2,0
NL,PT,2014.0,30,22,8
CR,MX,2015.0,36,43,-7
VG,FR,2004.0,2,1,1
ES,PL,2017.0,26,20,6
PT,NO,2017.0,10,3,7
DK,BR,2012.0,8,20,-12
BG,RU,2016.0,41,30,11
AR,CR,2009.0,8,5,3
MY,BD,2014.0,37,52,-15
SG,CA,2009.0,33,35,-2
MM,JP,2018.0,14,21,-7
FR,ES,1999.0,137,101,36
US,UA,2020.0,119,96,23
US,CU,2015.0,29,30,-1
CO,GB,2015.0,32,30,2
MA,nan,2019.0,13,7,6
PA,ES,2016.0,17,23,-6
TW,IN,2004.0,19,32,-13
TW,RU,2002.0,12,10,2
NZ,CA,2021.0,40,53,-13
PL,HU,2016.0,27,22,5
DE,CZ,2022.0,54,49,5
SI,HR,2017.0,34,32,2
JP,MY,2015.0,65,63,2
AR,PE,2019.0,71,54,17
IN,IT,2010.0,56,34,22
TR,DE,2013.0,54,81,-27
RU,NO,2021.0,25,14,11
IR,FI,2020.0,41,13,28
DZ,MA,2018.0,38,32,6
ET,IN,2018.0,25,59,-34
BD,KR,2010.0,17,15,2
PL,FR,2019.0,38,49,-11
CA,SN,2016.0,8,1,7
CO,CH,2018.0,18,8,10
ES,RU,2022.0,9,21,-12
PK,NZ,2015.0,11,11,0
VE,BR,2006.0,10,16,-6
DK,TH,2011.0,1,4,-3
RU,EG,2021.0,26,20,6
US,CO,2023.0,8,8,0
DE,RO,2009.0,38,28,10
GA,NL,2019.0,8,4,4
CZ,PL,2003.0,18,11,7
IE,ZA,2007.0,4,7,-3
CA,SK,2019.0,3,7,-4
SG,ES,2019.0,4,3,1
IT,SE,2022.0,59,43,16
LT,ES,2020.0,7,2,5
NL,HK,2015.0,17,15,2
IT,IE,2012.0,35,23,12
CN,ZM,2020.0,3,3,0
PL,SE,2020.0,28,28,0
BR,NG,2020.0,11,14,-3
UA,EC,2019.0,14,34,-20
RU,IT,2022.0,41,62,-21
MY,CA,2022.0,20,10,10
UY,AR,2020.0,44,38,6
MZ,UA,2020.0,5,3,2
KW,GB,2020.0,15,32,-17
SA,AE,2021.0,30,21,9
HU,US,2001.0,89,94,-5
SG,IR,2020.0,43,35,8
EG,ID,2019.0,43,53,-10
GH,NG,2021.0,13,11,2
CN,AT,2020.0,25,21,4
CA,VN,2006.0,5,1,4
VN,IT,2020.0,2,7,-5
BD,KR,2019.0,29,42,-13
IR,PT,2021.0,9,7,2
MX,TN,2018.0,1,1,0
nan,CA,2022.0,14,14,0
CN,EG,2015.0,29,16,13
PT,NO,2019.0,4,10,-6
DE,MX,2022.0,17,21,-4
CN,IT,2019.0,55,49,6
DE,SE,2003.0,88,101,-13
AR,IT,2022.0,51,40,11
NO,RU,2014.0,19,12,7
US,VN,2001.0,14,15,-1
KR,DE,2016.0,64,46,18
SD,US,2014.0,7,7,0
AR,PE,2017.0,42,45,-3
CA,FR,2004.0,275,364,-89
ZA,SE,2020.0,28,23,5
BH,IQ,2016.0,1,1,0
JP,PL,2020.0,15,11,4
CO,TR,2021.0,120,150,-30
GN,SN,2020.0,4,2,2
TR,ID,2021.0,16,20,-4
VN,UA,2020.0,5,10,-5
UA,TW,2020.0,2,2,0
BR,HU,2006.0,4,1,3
TR,BR,2020.0,18,13,5
EG,NL,2018.0,4,6,-2
CN,BE,2004.0,24,55,-31
IN,IT,2017.0,52,61,-9
US,ET,2021.0,50,44,6
SA,KZ,2018.0,1,3,-2
EG,CZ,2012.0,2,2,0
QA,GB,2005.0,5,3,2
IT,MX,2005.0,20,20,0
PH,IN,1999.0,4,5,-1
nan,MY,2007.0,10,17,-7
PT,NO,2010.0,4,3,1
CH,ES,1999.0,23,25,-2
JP,BR,2012.0,57,43,14
MY,IE,2019.0,14,6,8
DE,MC,2010.0,1,2,-1
ES,GB,1998.0,122,99,23
CA,TH,2012.0,25,9,16
ES,GB,1997.0,69,80,-11
PT,RU,2017.0,9,9,0
CA,IN,1998.0,49,36,13
MX,VN,2022.0,7,4,3
CZ,NL,2001.0,12,5,7
VN,US,2001.0,15,14,1
JP,SG,2004.0,31,11,20
BE,MX,2017.0,17,12,5
NO,SG,2001.0,1,2,-1
HU,IT,2011.0,14,7,7
MX,IT,2007.0,29,21,8
JP,HU,1999.0,9,5,4
CA,IT,1998.0,53,57,-4
PL,BH,2018.0,17,10,7
US,BW,2019.0,15,17,-2
PY,US,2020.0,12,11,1
CH,DK,1997.0,9,7,2
DK,IT,2020.0,47,47,0
NO,GB,2003.0,29,33,-4
NL,RO,2013.0,13,8,5
BH,ET,2022.0,15,31,-16
BR,FI,2016.0,8,11,-3
BG,BE,2009.0,11,8,3
OM,TN,2020.0,3,5,-2
FI,NZ,2012.0,5,2,3
AT,FI,2006.0,4,5,-1
RO,FR,2011.0,48,43,5
SE,NL,2022.0,49,40,9
KR,LK,2016.0,2,1,1
SG,GB,2000.0,21,29,-8
BG,PT,2003.0,4,3,1
CL,GB,2016.0,54,46,8
CA,AT,2012.0,22,25,-3
ZA,ZW,2016.0,24,42,-18
LV,IE,2010.0,4,1,3
DE,CO,2022.0,14,18,-4
EE,FI,2015.0,9,14,-5
CV,BR,2019.0,1,3,-2
JO,PS,2018.0,12,9,3
IN,NZ,2008.0,17,11,6
TR,NO,2018.0,17,10,7
PT,PE,2014.0,6,3,3
TN,EG,2019.0,26,10,16
MY,DE,2012.0,5,15,-10
IN,KW,2007.0,7,3,4
BE,MX,2010.0,7,14,-7
BD,BE,2011.0,2,2,0
RO,IN,2012.0,20,28,-8
BR,MX,2005.0,32,41,-9
SA,BH,2019.0,16,13,3
CH,BE,2022.0,40,55,-15
KE,MW,2022.0,4,1,3
MY,KR,2011.0,6,29,-23
IR,TW,2020.0,9,1,8
NL,VE,2012.0,1,1,0
FR,RU,2004.0,43,49,-6
ML,FR,2018.0,18,14,4
NG,CH,2021.0,6,6,0
TN,EG,2017.0,22,17,5
KZ,IL,2017.0,1,1,0
nan,TR,2021.0,22,14,8
ES,TN,2018.0,11,8,3
NL,JP,2006.0,32,23,9
DE,UZ,2009.0,2,2,0
PT,RU,2010.0,4,6,-2
TW,SA,2022.0,6,3,3
ZW,RU,2014.0,11,12,-1
IN,IE,2021.0,40,34,6
CA,PK,2018.0,63,38,25
LT,FR,2019.0,2,3,-1
JO,EG,2018.0,22,23,-1
EC,PY,2018.0,3,4,-1
US,SS,2018.0,2,2,0
CL,CR,2003.0,6,4,2
UA,BE,2001.0,2,2,0
FJ,US,2011.0,6,2,4
SE,PT,2001.0,3,1,2
nan,DK,2001.0,5,9,-4
RU,NL,2016.0,55,66,-11
AZ,IT,2021.0,11,15,-4
AU,HK,2013.0,4,6,-2
CA,MA,2003.0,5,6,-1
EG,GB,2022.0,81,74,7
LT,SE,2016.0,8,4,4
BE,EG,2020.0,5,5,0
AU,BR,2012.0,56,86,-30
IT,EE,2022.0,6,4,2
BA,DE,2016.0,2,5,-3
AM,IT,2015.0,28,17,11
TN,CA,2015.0,14,11,3
CH,AT,2004.0,48,54,-6
JO,DE,2002.0,2,9,-7
AR,MX,2002.0,34,32,2
RO,CA,2010.0,13,8,5
EG,MA,2016.0,5,14,-9
ES,RO,2003.0,2,1,1
MY,SG,1999.0,8,7,1
CH,PL,2003.0,10,10,0
DE,TN,2018.0,5,5,0
IR,PK,2020.0,23,17,6
DK,ID,2019.0,5,8,-3
QA,LY,2019.0,2,4,-2
NL,SI,2018.0,6,14,-8
TW,RU,2005.0,12,9,3
VE,ES,1997.0,19,16,3
RU,IL,2013.0,20,35,-15
IE,HR,2016.0,6,2,4
GH,ZM,2013.0,17,13,4
CA,DZ,2021.0,8,13,-5
GB,KR,2000.0,32,26,6
TR,CA,2013.0,18,30,-12
AU,IE,2001.0,33,34,-1
US,MW,2016.0,20,15,5
CA,IQ,2020.0,15,3,12
JP,IE,2014.0,24,21,3
LK,ES,2014.0,7,4,3
FR,CO,2005.0,14,13,1
GB,AR,2008.0,16,26,-10
RO,NL,2016.0,10,8,2
DE,TR,2008.0,42,49,-7
DZ,ES,2014.0,2,1,1
nan,MX,2020.0,32,33,-1
AU,FI,2017.0,17,28,-11
NO,DE,2004.0,25,43,-18
FR,BI,2007.0,16,18,-2
TT,US,2015.0,6,12,-6
CL,RU,2012.0,6,3,3
IN,BE,2002.0,4,6,-2
LB,BE,2013.0,3,7,-4
CN,IR,2022.0,15,36,-21
PK,MA,2003.0,3,4,-1
JP,VN,2015.0,59,27,32
ID,HR,2020.0,1,1,0
ES,BG,2011.0,5,3,2
FI,CA,2004.0,25,8,17
AU,RS,2017.0,6,5,1
IR,BO,2012.0,1,1,0
GE,DE,2014.0,6,2,4
BT,LK,2022.0,3,1,2
UY,MX,2014.0,12,15,-3
CR,CH,2019.0,3,6,-3
RU,GB,2006.0,92,56,36
FR,CM,2003.0,14,9,5
PL,UA,2013.0,20,24,-4
NL,CN,2003.0,32,33,-1
JP,SE,2021.0,25,28,-3
SA,BH,2017.0,11,11,0
LB,AE,2016.0,3,3,0
IT,MY,2020.0,47,39,8
CA,CZ,2005.0,9,10,-1
CA,IN,1997.0,38,32,6
RU,NZ,2010.0,2,1,1
PL,RS,2021.0,3,8,-5
SK,CN,2013.0,4,1,3
LI,AT,2018.0,2,3,-1
PS,IL,2018.0,4,8,-4
FR,NG,2019.0,8,8,0
ID,ET,2020.0,5,5,0
NL,NP,2021.0,3,2,1
VN,CZ,2018.0,5,6,-1
MX,UY,2003.0,3,1,2
nan,AU,2014.0,45,27,18
MX,PL,2018.0,5,3,2
ZA,CH,2007.0,12,10,2
GB,PH,2015.0,16,21,-5
RS,CA,2022.0,7,5,2
IT,CO,2021.0,17,25,-8
SK,BE,2007.0,6,1,5
FI,GB,2005.0,51,41,10
CH,DK,1998.0,10,6,4
DE,RS,2012.0,27,22,5
PL,CZ,2008.0,42,25,17
CZ,RS,2003.0,9,12,-3
NG,US,2011.0,33,46,-13
RU,TJ,2008.0,16,2,14
PL,FR,2017.0,46,54,-8
GB,LB,2012.0,8,9,-1
MT,IT,2018.0,4,10,-6
RS,BA,2009.0,16,8,8
EG,HU,2002.0,5,1,4
BY,US,2011.0,8,14,-6
RU,GR,2018.0,5,7,-2
CH,PH,2019.0,6,9,-3
ID,IE,2017.0,1,4,-3
FR,MY,1998.0,4,1,3
RE,FR,2014.0,55,38,17
KE,JP,1998.0,4,2,2
TN,US,2021.0,17,14,3
UY,IT,2020.0,7,1,6
GB,UY,1999.0,3,1,2
FR,CO,2002.0,8,6,2
MZ,PL,1998.0,8,3,5
BH,US,2004.0,6,3,3
NP,IN,2004.0,19,25,-6
CM,US,2007.0,6,3,3
AR,DO,2017.0,5,2,3
GB,KH,2011.0,2,1,1
GM,BE,2005.0,1,1,0
IR,JP,2011.0,14,19,-5
RO,CA,2019.0,11,13,-2
BW,ET,2017.0,2,3,-1
NL,FI,2009.0,43,40,3
SI,MX,2022.0,7,15,-8
TR,RU,2001.0,1,2,-1
CA,IL,2004.0,21,54,-33
IT,JO,2008.0,3,1,2
PS,US,2012.0,9,3,6
RU,TR,2000.0,5,2,3
PT,RU,2019.0,18,43,-25
nan,EG,2020.0,11,3,8
SA,ZA,2013.0,4,2,2
DE,BG,2015.0,17,16,1
EG,KW,2012.0,10,18,-8
NO,TZ,2002.0,3,2,1
BE,UA,2006.0,2,2,0
SE,UG,2012.0,5,3,2
BE,IR,2009.0,10,8,2
NL,CW,2018.0,6,30,-24
NO,SI,2015.0,1,1,0
TR,PS,2016.0,2,1,1
TN,MA,2007.0,14,7,7
AU,UY,2016.0,2,5,-3
IE,AT,2012.0,5,9,-4
NO,nan,2003.0,12,15,-3
HU,CH,2008.0,9,9,0
TR,IR,2009.0,6,2,4
ZA,EG,2011.0,2,1,1
RU,UZ,2000.0,5,13,-8
AU,FI,2019.0,23,20,3
SE,DE,2001.0,73,92,-19
CL,NZ,2020.0,5,3,2
EG,DE,2021.0,47,55,-8
CR,CO,2006.0,14,7,7
GE,CA,2011.0,4,2,2
BE,LU,2020.0,22,16,6
TW,FI,1999.0,3,1,2
PH,BR,2021.0,8,7,1
NZ,NL,2001.0,8,2,6
PL,BR,2013.0,8,7,1
ES,UY,2022.0,24,23,1
PK,GB,1999.0,26,15,11
NO,ES,2014.0,24,30,-6
CH,IR,2014.0,18,24,-6
KR,CA,2003.0,22,19,3
KE,FR,2010.0,9,6,3
ES,IL,2014.0,15,13,2
BR,BO,2015.0,6,1,5
IN,PK,2004.0,38,32,6
NZ,nan,2000.0,8,3,5
IL,HU,2012.0,4,7,-3
SK,ES,2008.0,6,2,4
TR,JP,2013.0,35,18,17
BD,GB,2002.0,16,20,-4
DK,EG,2011.0,3,1,2
CH,QA,2016.0,2,2,0
SE,QA,2021.0,5,1,4
CA,NO,2014.0,20,12,8
nan,KE,2018.0,6,9,-3
IL,CN,2013.0,18,19,-1
PH,ES,1998.0,3,2,1
SE,TW,2022.0,8,3,5
FR,MQ,2008.0,8,7,1
ES,AO,2018.0,2,2,0
KE,FR,2019.0,11,5,6
SS,GB,2011.0,9,10,-1
KR,DK,2002.0,1,1,0
CA,CZ,2002.0,5,6,-1
JP,PK,2014.0,15,6,9
XK,HR,2016.0,5,2,3
VN,CA,2016.0,6,11,-5
PK,SA,2000.0,6,12,-6
CN,MD,2016.0,4,2,2
CN,BO,2004.0,7,5,2
JO,SY,2015.0,2,1,1
AU,EG,2017.0,15,14,1
LU,FR,2000.0,7,2,5
IQ,OM,2018.0,4,6,-2
CZ,GB,1997.0,5,9,-4
OM,SA,2010.0,5,2,3
QA,LY,2017.0,4,2,2
EG,LY,2017.0,11,10,1
ES,LB,2018.0,7,3,4
KE,FR,2017.0,7,8,-1
ZA,BE,2022.0,14,9,5
PL,IN,2018.0,17,23,-6
NO,CL,2011.0,2,4,-2
SE,KE,2003.0,2,2,0
KR,nan,2017.0,28,38,-10
CA,RS,2012.0,16,9,7
DE,BI,2018.0,1,1,0
IR,CY,2023.0,2,1,1
ES,PL,2010.0,12,17,-5
SA,NG,2000.0,3,2,1
RU,IN,2016.0,23,24,-1
BR,MX,2002.0,24,23,1
NL,VN,2005.0,4,2,2
BE,IT,2009.0,77,87,-10
ES,PA,2017.0,25,9,16
EG,SY,2007.0,2,2,0
AE,FR,2015.0,6,25,-19
OM,SA,2019.0,17,19,-2
UZ,MX,2021.0,1,1,0
UA,CZ,2013.0,24,11,13
SK,NL,2003.0,13,4,9
FR,SE,2004.0,41,38,3
MG,RE,2013.0,2,2,0
PT,AU,1998.0,3,1,2
FI,EE,2003.0,9,6,3
GM,GB,2018.0,11,29,-18
DK,CH,2004.0,15,11,4
ZA,PK,2018.0,5,7,-2
IE,NL,2001.0,11,6,5
ID,AR,2013.0,2,2,0
LU,CO,2020.0,1,1,0
RO,BE,2022.0,7,10,-3
BE,PE,2014.0,4,2,2
nan,NZ,2007.0,25,9,16
CA,RU,2002.0,20,26,-6
PT,NL,2022.0,27,24,3
SE,BR,2009.0,15,10,5
AU,EG,2010.0,5,6,-1
SI,BE,2019.0,9,8,1
NE,FR,2014.0,10,34,-24
SD,GB,2004.0,2,1,1
GB,MW,2021.0,24,18,6
FR,TW,2010.0,14,18,-4
US,ZM,2013.0,8,14,-6
JM,GB,2018.0,7,2,5
LK,JP,2001.0,12,4,8
IN,NO,2011.0,18,13,5
US,PS,2009.0,4,6,-2
EG,FR,1998.0,4,5,-1
KE,TZ,2013.0,8,5,3
SE,IN,2006.0,14,24,-10
FR,BD,2017.0,12,7,5
FR,TW,2017.0,17,16,1
IL,SE,2021.0,6,6,0
DK,FI,2018.0,15,32,-17
IT,AE,2015.0,6,5,1
RS,HU,2004.0,2,4,-2
BR,CA,2023.0,14,10,4
PT,IR,2019.0,14,14,0
US,EE,2012.0,10,10,0
CZ,CA,2018.0,9,12,-3
GB,BO,2019.0,2,2,0
EG,ID,2010.0,6,3,3
SG,CH,2018.0,19,15,4
GR,PL,1999.0,11,5,6
NL,BR,2012.0,40,41,-1
BE,IE,2013.0,7,13,-6
ID,NL,2013.0,20,29,-9
QA,NZ,2018.0,4,1,3
TZ,DK,2013.0,2,2,0
NL,KE,2010.0,6,3,3
RS,RU,2015.0,5,11,-6
nan,MA,2022.0,3,2,1
NL,SK,2006.0,7,9,-2
GB,BD,1997.0,13,4,9
US,KH,2013.0,3,4,-1
ZM,US,2015.0,16,24,-8
GA,US,2021.0,3,2,1
FR,BD,2019.0,12,6,6
BE,FI,2003.0,7,5,2
GB,KW,2003.0,9,5,4
GR,IN,2004.0,3,5,-2
AR,PE,2010.0,17,12,5
AR,VE,2009.0,15,19,-4
IR,NL,2005.0,5,2,3
CR,ES,2008.0,12,27,-15
nan,BR,2000.0,13,8,5
PS,GB,2017.0,2,2,0
IE,ES,2003.0,10,9,1
SE,MX,2003.0,6,3,3
BR,EG,2020.0,4,3,1
PT,FR,2021.0,33,49,-16
PA,MX,2016.0,9,10,-1
CH,EG,2016.0,8,9,-1
NO,CN,2000.0,4,5,-1
BE,RS,2018.0,4,1,3
AU,PG,2019.0,5,8,-3
BY,CN,2015.0,3,3,0
NL,RU,1999.0,13,20,-7
CO,CA,1999.0,3,4,-1
PA,IN,2020.0,2,3,-1
KR,NP,2013.0,8,9,-1
TW,AU,1998.0,13,3,10
CL,PE,2007.0,17,24,-7
MW,US,2006.0,6,3,3
AU,BD,2005.0,8,4,4
CO,IT,2016.0,24,20,4
EC,CR,2014.0,4,6,-2
SG,nan,2021.0,6,8,-2
RO,FI,2020.0,2,4,-2
SA,nan,2008.0,2,1,1
CU,CA,2011.0,4,1,3
NL,KE,2017.0,10,9,1
PT,IR,2017.0,15,20,-5
BE,HR,2006.0,1,1,0
PE,FI,2014.0,1,1,0
PT,SE,2014.0,14,11,3
UG,BE,2004.0,1,1,0
DK,TW,2017.0,6,3,3
DK,RU,2001.0,3,3,0
SE,CL,2006.0,6,4,2
IN,RE,2017.0,1,1,0
CA,HR,2016.0,5,7,-2
PT,AR,2014.0,11,20,-9
ID,SA,2014.0,14,12,2
BD,NG,2012.0,1,1,0
KR,nan,2010.0,17,27,-10
AT,HR,2012.0,5,6,-1
ID,PH,2015.0,2,1,1
PH,ID,2017.0,7,2,5
PH,TW,2022.0,5,7,-2
PE,CN,2015.0,3,2,1
IN,DK,2000.0,4,5,-1
CA,JO,2011.0,12,11,1
VE,IT,2004.0,4,1,3
RO,CN,2014.0,4,6,-2
BD,US,2000.0,15,7,8
FI,IR,2018.0,11,22,-11
IN,CZ,2003.0,9,8,1
DK,IS,2016.0,6,12,-6
BD,GB,2005.0,17,24,-7
TR,TW,2018.0,5,8,-3
IL,IN,2011.0,12,23,-11
PS,NO,2009.0,1,1,0
US,IQ,2006.0,5,1,4
MY,UA,2013.0,1,2,-1
ZW,MX,2015.0,1,2,-1
BN,SG,2016.0,1,7,-6
PK,KH,2019.0,2,1,1
OM,PK,2011.0,3,1,2
UA,EC,2017.0,7,61,-54
IT,SA,2021.0,11,11,0
ES,PA,2010.0,13,10,3
IE,HU,2019.0,3,1,2
FR,TW,2019.0,15,14,1
ID,LK,2014.0,2,2,0
HU,FR,2019.0,16,30,-14
NO,CM,2017.0,2,1,1
BO,VE,2018.0,1,1,0
LB,IQ,2017.0,5,3,2
IR,LB,2021.0,2,1,1
US,SV,2022.0,3,1,2
IT,SI,2022.0,10,12,-2
ET,SE,2020.0,11,10,1
SI,BE,2017.0,10,4,6
IN,FJ,2016.0,5,2,3
SN,CG,2013.0,2,1,1
CZ,SI,1999.0,2,1,1
AU,FJ,2022.0,4,1,3
CA,SK,2010.0,5,2,3
SG,TH,2003.0,1,1,0
MZ,PL,1997.0,4,3,1
UY,GB,2009.0,4,4,0
SE,BG,2004.0,3,3,0
ZA,RU,2009.0,3,6,-3
JP,AE,2014.0,2,2,0
BD,IE,2005.0,2,1,1
US,TT,1998.0,1,3,-2
AU,PK,2005.0,13,2,11
VN,BE,2011.0,4,8,-4
MY,JP,2006.0,14,22,-8
KR,BR,2002.0,1,2,-1
FR,PF,2008.0,8,5,3
PF,FR,2008.0,5,8,-3
SE,VE,2012.0,1,1,0
MX,nan,2003.0,8,10,-2
PE,CR,2016.0,15,10,5
AR,PY,2011.0,4,4,0
FR,NG,2017.0,6,2,4
AE,SA,2008.0,2,6,-4
JO,AE,2003.0,5,2,3
TN,ES,2009.0,3,1,2
CA,PT,2015.0,15,17,-2
TW,FR,2004.0,11,14,-3
CM,CD,2018.0,3,1,2
LA,TH,2021.0,3,2,1
AU,BD,2002.0,3,7,-4
ZA,CM,2011.0,4,7,-3
SK,AU,2012.0,3,1,2
VN,KR,2005.0,9,4,5
EG,PT,2022.0,2,2,0
NL,KE,2019.0,12,11,1
IT,PT,2003.0,12,13,-1
HU,IQ,2017.0,1,1,0
BJ,DE,2016.0,2,4,-2
MY,CH,2014.0,4,5,-1
OM,SA,2017.0,4,12,-8
UA,GH,2013.0,8,1,7
XK,IT,2013.0,1,1,0
NG,GB,1999.0,5,6,-1
DK,IE,2000.0,2,4,-2
TW,ZA,2011.0,2,1,1
MY,TN,2018.0,1,1,0
DE,SK,1999.0,19,16,3
AT,NZ,2013.0,1,5,-4
BG,RO,2014.0,3,1,2
LT,FR,2010.0,5,3,2
ES,MA,2003.0,8,9,-1
HR,RU,2015.0,10,6,4
IL,TW,1997.0,1,2,-1
AF,MX,2018.0,6,2,4
ID,MX,2014.0,2,1,1
NO,GE,2018.0,1,1,0
GA,NL,2017.0,7,7,0
CN,TZ,2012.0,3,2,1
PK,KE,1999.0,1,1,0
MY,CM,2007.0,2,1,1
IL,FR,2022.0,12,16,-4
TZ,UG,2016.0,3,3,0
US,AL,2020.0,3,5,-2
IS,IN,2020.0,3,3,0
CN,RO,2016.0,4,10,-6
EE,US,2009.0,4,19,-15
IN,MX,2003.0,4,9,-5
SI,DK,2009.0,1,1,0
ZA,DE,2023.0,7,1,6
GB,BJ,2006.0,1,2,-1
RU,AT,1999.0,4,4,0
TN,MY,2016.0,5,4,1
MY,IN,2001.0,10,8,2
AT,AR,2017.0,2,5,-3
DK,HU,2007.0,3,7,-4
HN,US,1999.0,3,5,-2
KR,DK,2005.0,1,2,-1
CN,NZ,1997.0,3,8,-5
BF,SN,2014.0,2,4,-2
RS,UZ,2008.0,3,2,1
GB,JM,2015.0,6,5,1
KR,QA,2009.0,2,1,1
SE,UY,2017.0,2,3,-1
SE,UA,2003.0,4,12,-8
US,CR,2022.0,14,20,-6
CO,VE,2001.0,3,11,-8
SE,PL,2005.0,19,13,6
BR,SD,2002.0,4,3,1
PA,US,2001.0,5,5,0
MY,IE,2010.0,3,5,-2
US,SL,2018.0,1,3,-2
CN,KP,2022.0,4,5,-1
CH,PH,2017.0,3,3,0
IT,UG,2012.0,1,3,-2
CH,TR,2008.0,10,12,-2
AL,SE,2006.0,2,2,0
TN,IT,2007.0,2,3,-1
SY,JO,2022.0,1,2,-1
AM,FR,2016.0,2,2,0
RU,CU,2013.0,2,1,1
CH,MA,2015.0,4,2,2
NZ,SE,2007.0,3,6,-3
CM,FR,2011.0,13,17,-4
MA,ZA,2017.0,2,2,0
SS,US,2006.0,1,1,0
DE,VN,2003.0,6,7,-1
SI,IT,2012.0,14,11,3
CN,NZ,1998.0,8,5,3
CD,KE,2017.0,1,2,-1
PL,IR,2022.0,7,11,-4
KZ,JP,2018.0,6,4,2
GB,SS,2014.0,9,7,2
TR,BE,2013.0,10,15,-5
LT,TR,2020.0,1,1,0
IN,MW,2015.0,3,1,2
HU,SK,1999.0,3,4,-1
PT,SK,2007.0,1,3,-2
CR,RU,2017.0,3,1,2
ZA,RW,2007.0,1,1,0
UG,CZ,2019.0,4,2,2
GB,BE,2023.0,9,9,0
NL,LU,2020.0,7,9,-2
AZ,ID,2018.0,4,7,-3
ID,CO,2019.0,6,6,0
MD,CA,2021.0,2,1,1
SA,FR,2022.0,9,8,1
AU,KZ,2015.0,2,1,1
NP,BT,2020.0,1,1,0
US,BI,2018.0,3,2,1
PA,CA,2015.0,2,7,-5
BG,CH,2011.0,7,3,4
GR,CH,2022.0,21,14,7
EG,OM,2009.0,4,5,-1
BG,AT,2017.0,2,2,0
JP,HR,1999.0,2,1,1
LT,FR,2017.0,7,6,1
SI,SE,2003.0,2,1,1
CZ,GB,1998.0,12,13,-1
LB,IT,2014.0,9,22,-13
NL,IE,2005.0,9,10,-1
CL,DK,2015.0,3,2,1
TR,FI,2005.0,3,3,0
JP,SD,2014.0,2,1,1
ES,UA,2008.0,2,1,1
BD,KR,2017.0,28,27,1
CH,KR,2016.0,18,19,-1
IE,RS,2007.0,1,1,0
CN,PK,1999.0,2,3,-1
JP,ET,2012.0,2,3,-1
TN,EG,2010.0,7,9,-2
AU,HU,2009.0,8,11,-3
ET,BE,2013.0,2,3,-1
MD,US,2009.0,6,5,1
KR,ZA,2015.0,4,5,-1
NG,IT,2004.0,4,6,-2
JO,FR,2017.0,3,3,0
PH,GT,2019.0,1,1,0
BB,US,2021.0,2,3,-1
IE,RO,2017.0,2,1,1
GR,BE,2022.0,8,12,-4
BA,SE,2019.0,2,1,1
CU,PY,2003.0,3,5,-2
EG,LY,2019.0,12,7,5
IE,RO,2010.0,1,4,-3
UA,FI,2005.0,2,2,0
GE,RU,2018.0,4,6,-2
IT,QA,2015.0,11,1,10
KR,CN,2023.0,14,27,-13
CH,LT,2010.0,2,2,0
IL,PH,2003.0,1,1,0
JM,US,2004.0,8,11,-3
AU,FI,2010.0,8,11,-3
IN,IQ,2022.0,9,11,-2
GB,OM,2000.0,5,2,3
BI,US,2008.0,1,1,0
HU,IN,2012.0,7,4,3
CY,GB,2007.0,8,23,-15
GH,nan,2007.0,1,1,0
MZ,PT,2001.0,3,2,1
ZA,BJ,2008.0,1,2,-1
SE,LV,2006.0,5,1,4
ML,IT,2007.0,1,1,0
NZ,ZM,2006.0,1,1,0
ZM,CH,2018.0,3,2,1
LT,NO,2012.0,2,1,1
GM,DE,2020.0,1,2,-1
CD,BE,2006.0,1,1,0
ET,FR,2020.0,4,5,-1
EG,SD,2004.0,2,4,-2
JP,MW,2016.0,1,1,0
VE,DE,2015.0,6,3,3
PE,nan,2015.0,11,9,2
SV,ES,2004.0,3,2,1
GR,VN,2007.0,6,4,2
CY,EC,2021.0,1,1,0
TR,AU,2015.0,6,17,-11
TW,NZ,2008.0,7,1,6
GB,SD,2006.0,2,3,-1
RO,SK,2006.0,5,2,3
SD,SE,2008.0,1,1,0
PT,MX,1998.0,2,4,-2
TR,ES,2010.0,7,8,-1
CO,DO,2020.0,2,6,-4
AT,AR,2019.0,4,6,-2
FR,BZ,1999.0,2,3,-1
IL,MX,2001.0,1,2,-1
SE,MY,2004.0,1,1,0
PA,KR,2021.0,1,1,0
AT,ME,2018.0,1,1,0
IE,HU,2010.0,2,4,-2
TN,BE,2017.0,3,5,-2
VN,DK,2016.0,3,4,-1
RU,SG,2007.0,3,1,2
EG,GR,2011.0,1,1,0
DK,RO,2015.0,2,1,1
CH,EC,2020.0,3,4,-1
CY,CA,2015.0,1,2,-1
FR,VE,2000.0,4,5,-1
US,PG,2011.0,4,1,3
PK,KH,2017.0,1,1,0
IE,TW,2021.0,2,3,-1
DO,EC,2018.0,1,3,-2
KR,PL,2015.0,1,2,-1
NA,GB,2014.0,4,1,3
nan,KR,1999.0,20,5,15
RS,DE,2001.0,7,5,2
SA,PH,2010.0,1,2,-1
ES,HN,2004.0,5,1,4
IT,EC,2008.0,1,2,-1
CO,IL,2018.0,8,5,3
BE,GE,2015.0,2,1,1
NL,ZW,2020.0,1,2,-1
ML,CH,2020.0,2,4,-2
MX,SV,2014.0,3,1,2
CL,RS,2013.0,2,1,1
nan,SG,2008.0,5,9,-4
SG,ES,2017.0,4,6,-2
TW,PH,2011.0,5,6,-1
US,LK,1999.0,7,2,5
ID,NO,2013.0,1,2,-1
TN,TR,2012.0,1,2,-1
CR,RU,2019.0,7,7,0
PK,AT,2020.0,3,2,1
IN,CO,2018.0,3,5,-2
PK,LB,2021.0,4,2,2
IE,RU,2013.0,9,2,7
GT,US,2002.0,1,1,0
GB,ML,2018.0,2,2,0
IT,IL,2008.0,8,9,-1
TR,SG,2004.0,2,2,0
HU,IQ,2019.0,1,6,-5
SA,AU,2008.0,7,8,-1
CO,AU,2008.0,4,4,0
CA,SK,2017.0,3,5,-2
FI,TR,2014.0,4,5,-1
DE,UG,2016.0,3,4,-1
ES,SA,2013.0,6,2,4
NG,CU,2019.0,2,2,0
GE,FR,2019.0,2,1,1
JP,PS,2014.0,1,1,0
PL,UZ,2021.0,2,1,1
MY,IE,2017.0,7,4,3
QA,IL,2019.0,1,1,0
MM,CN,2018.0,2,4,-2
GA,DE,2008.0,8,1,7
KZ,CN,2001.0,2,1,1
AR,NI,2003.0,1,1,0
LB,RU,2022.0,1,1,0
TW,CZ,2005.0,2,3,-1
DE,IS,2018.0,4,1,3
IN,KH,2019.0,2,2,0
JP,BN,2013.0,2,2,0
CN,LY,2020.0,2,1,1
GW,DK,2016.0,3,3,0
EC,CH,2016.0,2,3,-1
RU,NZ,2019.0,4,9,-5
RS,IE,2017.0,2,1,1
CF,FR,2008.0,2,2,0
FR,NG,2010.0,3,3,0
UA,EC,2010.0,13,16,-3
RU,ZA,2009.0,6,3,3
PH,TR,1999.0,2,1,1
AU,NG,2009.0,2,3,-1
AU,RS,2019.0,4,4,0
AU,LB,2016.0,4,7,-3
SI,JP,2004.0,1,5,-4
KR,GR,2018.0,1,3,-2
TR,GR,2009.0,4,12,-8
KW,LB,2020.0,2,2,0
LB,FR,2001.0,5,11,-6
MX,PH,2005.0,4,3,1
PS,GB,2019.0,6,11,-5
PS,FR,2005.0,2,1,1
VE,UY,2014.0,3,2,1
CA,KW,2004.0,5,3,2
TN,BE,2010.0,2,2,0
CZ,IR,2011.0,4,1,3
GE,BE,2017.0,1,2,-1
LY,JP,1999.0,2,1,1
BG,ID,2020.0,3,3,0
PH,AR,2020.0,3,6,-3
KE,JP,1997.0,1,2,-1
AU,PG,2017.0,6,7,-1
BE,CD,2012.0,4,8,-4
LU,JP,2010.0,1,2,-1
NO,AU,1999.0,6,4,2
UG,ZA,2004.0,2,1,1
PE,PL,2015.0,1,1,0
EG,TR,2008.0,2,1,1
SA,PH,2017.0,2,2,0
PH,CO,2015.0,5,5,0
NO,EE,2012.0,1,3,-2
SI,FR,2021.0,12,6,6
NO,TW,2022.0,1,2,-1
IN,LK,2008.0,3,4,-1
AU,KH,2022.0,2,1,1
IN,LT,2020.0,1,1,0
GT,US,2005.0,4,1,3
SI,HR,2010.0,8,16,-8
CV,BR,2010.0,1,1,0
BE,MZ,2015.0,1,3,-2
UZ,IT,2007.0,2,2,0
VN,AU,2011.0,11,19,-8
AU,PK,2002.0,8,5,3
KH,US,2009.0,2,4,-2
GE,PL,2021.0,1,1,0
SG,IN,1999.0,4,19,-15
AO,BE,2020.0,1,1,0
CL,NO,2007.0,2,1,1
IN,VG,2014.0,1,1,0
PL,LV,2021.0,2,2,0
IS,PL,2018.0,2,1,1
JO,FR,2010.0,4,5,-1
BG,AT,2010.0,5,3,2
MA,QA,2018.0,3,1,2
ZA,CR,2014.0,3,5,-2
MW,ZA,2021.0,9,7,2
BR,KR,2002.0,2,1,1
AU,OM,2008.0,2,4,-2
RW,TZ,2016.0,2,2,0
MX,EE,2020.0,1,1,0
PT,KR,2007.0,1,1,0
IR,ZA,2018.0,8,4,4
AR,PT,2003.0,4,5,-1
IT,VE,2022.0,1,1,0
PG,TR,2018.0,1,2,-1
DE,CU,2013.0,1,5,-4
IE,SG,2006.0,4,4,0
PL,SA,2017.0,1,1,0
DZ,JO,2012.0,1,1,0
NG,FR,2014.0,2,5,-3
SN,NL,2015.0,1,2,-1
IN,GR,2000.0,3,2,1
EC,US,2004.0,6,6,0
JO,KW,2015.0,5,3,2
HR,FR,2020.0,3,10,-7
EG,CH,2014.0,2,7,-5
TN,AU,2020.0,3,1,2
ET,UG,2022.0,3,1,2
MD,TR,2021.0,2,11,-9
SE,HR,2022.0,7,1,6
PE,PT,2017.0,2,9,-7
IN,HR,2003.0,3,2,1
CA,EC,2014.0,3,2,1
CM,DE,2018.0,6,9,-3
BR,SA,2022.0,5,1,4
CH,FI,2023.0,1,2,-1
NL,EC,2022.0,4,3,1
MA,IR,2009.0,2,2,0
PL,NZ,2012.0,3,1,2
PT,MX,1997.0,1,1,0
IE,BE,2000.0,2,4,-2
PS,GB,2010.0,2,4,-2
SG,PK,2019.0,6,4,2
VA,IT,2018.0,2,1,1
IT,SK,2000.0,3,4,-1
NG,IR,2018.0,2,6,-4
KZ,DE,2008.0,1,1,0
MG,CN,2015.0,4,3,1
NL,MX,2020.0,13,13,0
LU,DK,2021.0,4,4,0
GN,BF,2018.0,1,2,-1
AR,JP,2006.0,3,6,-3
SE,NI,2000.0,1,2,-1
LB,BR,2014.0,5,5,0
PT,SI,2015.0,2,1,1
FJ,IN,2005.0,2,3,-1
NG,BR,2007.0,1,1,0
nan,CH,2000.0,4,7,-3
MT,DE,2021.0,1,1,0
DE,AM,2009.0,6,7,-1
IN,HU,2018.0,7,5,2
GB,VE,2013.0,3,5,-2
AU,RS,2010.0,4,3,1
ZA,SA,2016.0,2,3,-1
SE,NG,2012.0,1,4,-3
RS,CH,2000.0,1,1,0
VN,RO,2018.0,2,1,1
AT,MA,2014.0,1,1,0
IL,GR,2020.0,2,1,1
IS,NZ,2019.0,1,1,0
MG,BE,2015.0,1,1,0
MQ,FR,2000.0,1,10,-9
GB,LT,2016.0,2,12,-10
NG,SE,2006.0,1,2,-1
SN,CM,2016.0,1,1,0
ID,IE,2010.0,2,1,1
KE,DE,1998.0,2,1,1
RS,JP,2000.0,3,6,-3
CN,EE,2011.0,1,1,0
SA,BE,1998.0,1,1,0
PT,RO,2009.0,3,1,2
GH,FI,2020.0,1,1,0
PT,IR,2010.0,1,1,0
MC,DE,2018.0,2,4,-2
DZ,MY,2020.0,2,5,-3
CM,CA,2018.0,6,3,3
SE,UY,2010.0,1,1,0
KE,DE,1997.0,1,3,-2
FK,GB,2017.0,1,1,0
HR,IT,1999.0,3,1,2
FR,TH,2004.0,5,3,2
GB,BD,1998.0,4,11,-7
HN,AR,2016.0,1,2,-1
BE,AE,2007.0,1,3,-2
IT,BY,2015.0,3,1,2
AM,CH,2016.0,2,1,1
BE,CL,2001.0,3,1,2
UA,AT,2011.0,3,1,2
BD,KE,2015.0,1,2,-1
AR,KE,2014.0,1,1,0
AT,LT,2014.0,1,1,0
SJ,NO,2018.0,4,3,1
MN,KZ,2022.0,2,1,1
TZ,BH,2004.0,2,1,1
LB,CA,1999.0,3,4,-1
MA,nan,2010.0,3,2,1
IT,TW,2001.0,2,2,0
JO,RU,2007.0,1,1,0
DK,AT,2005.0,5,6,-1
ID,NZ,2020.0,4,10,-6
PT,CH,2023.0,2,2,0
AG,JP,2019.0,2,1,1
PK,BR,2021.0,4,4,0
BR,PK,2007.0,2,1,1
YE,GB,2004.0,1,1,0
AE,TR,2013.0,4,3,1
PT,TN,2016.0,1,1,0
LY,RS,2014.0,1,2,-1
NZ,NO,2002.0,1,2,-1
TR,UZ,2020.0,2,2,0
EE,nan,2021.0,1,1,0
CA,PE,2018.0,3,6,-3
NG,PK,2018.0,6,11,-5
LU,CA,2012.0,1,1,0
LB,CU,2003.0,2,3,-1
CU,PA,2020.0,2,2,0
RU,SA,2011.0,1,1,0
VE,IL,2004.0,1,1,0
SG,TR,2004.0,2,2,0
EG,FR,1997.0,2,4,-2
LV,CZ,2015.0,1,2,-1
IQ,JP,2016.0,4,3,1
AT,PT,2020.0,7,10,-3
KW,TR,2005.0,1,4,-3
TW,EG,2000.0,1,1,0
BW,US,2022.0,2,9,-7
MA,CI,2020.0,2,2,0
FR,LK,2012.0,3,1,2
SK,KR,2006.0,1,1,0
NZ,NO,2005.0,1,2,-1
DK,SK,2015.0,3,4,-1
FK,GB,2010.0,1,3,-2
QA,GB,2002.0,2,2,0
SE,AE,2007.0,2,4,-2
PT,AU,1997.0,2,1,1
JP,MM,2008.0,2,1,1
SY,TW,2021.0,1,1,0
CZ,ZA,2009.0,1,3,-2
BR,TL,2013.0,1,1,0
PH,MX,2006.0,3,2,1
NO,TZ,2005.0,1,1,0
FR,BF,2002.0,5,2,3
QA,CZ,2015.0,1,1,0
AU,BT,2015.0,4,2,2
NL,GW,2000.0,1,4,-3
IN,KE,2014.0,5,4,1
DK,ID,2017.0,3,4,-1
DK,PK,2012.0,5,1,4
FR,MK,2011.0,1,1,0
MY,AT,2012.0,1,1,0
SG,UA,2016.0,2,4,-2
VN,FI,2019.0,2,2,0
IL,CL,2010.0,2,1,1
TW,IT,1998.0,1,4,-3
SA,NP,2019.0,1,2,-1
TR,ZA,2012.0,1,2,-1
IN,AE,1999.0,1,1,0
IN,SA,2020.0,181,112,69
BR,GB,2012.0,149,176,-27
SE,US,2002.0,312,272,40
GT,MX,2021.0,24,25,-1
MY,IT,2013.0,48,55,-7
IE,GB,2014.0,414,368,46
ES,IT,2018.0,287,307,-20
CH,ZA,2007.0,10,12,-2
PT,ES,2000.0,34,41,-7
NL,CA,2005.0,55,54,1
FR,AR,2008.0,41,38,3
US,TR,2019.0,505,468,37
ES,IE,2012.0,26,28,-2
CA,IE,2013.0,142,149,-7
PK,US,2015.0,224,259,-35
CH,TW,2011.0,3,5,-2
RU,CA,2012.0,20,25,-5
AR,ES,1997.0,42,42,0
CN,IT,2017.0,31,72,-41
CN,ZA,2021.0,19,22,-3
RU,PL,2009.0,38,12,26
IT,CR,2020.0,4,2,2
PR,KR,2021.0,40,13,27
CA,SE,2018.0,61,60,1
TW,ID,2018.0,65,37,28
MA,MD,1999.0,4,9,-5
MY,IR,2022.0,25,20,5
HU,FR,2010.0,22,12,10
TR,ES,2019.0,20,18,2
PK,IQ,2018.0,27,7,20
BF,FR,2015.0,17,20,-3
SY,US,2016.0,6,6,0
CA,KE,2008.0,3,3,0
SA,BD,2016.0,25,18,7
EG,BG,2012.0,2,2,0
IR,IN,2020.0,17,37,-20
UA,TR,2018.0,3,1,2
UZ,RU,2022.0,31,26,5
IQ,SE,2014.0,1,1,0
US,AG,2021.0,7,4,3
CA,PH,2018.0,11,5,6
HR,SI,2018.0,27,42,-15
RS,SI,2013.0,16,18,-2
CA,IT,1997.0,62,33,29
RU,AU,2020.0,34,27,7
MA,IT,2004.0,8,2,6
DE,LI,2006.0,9,1,8
NL,HR,2015.0,5,8,-3
AR,SE,2009.0,4,11,-7
US,BW,2017.0,14,13,1
PH,ES,1997.0,2,1,1
FI,ES,2013.0,21,22,-1
PT,AT,2015.0,8,4,4
JO,DE,2005.0,6,6,0
NI,BR,2020.0,1,2,-1
HR,BE,2021.0,2,3,-1
CA,RU,2005.0,17,31,-14
FR,ID,2011.0,22,10,12
ES,PL,2019.0,31,22,9
NL,CA,2002.0,37,45,-8
NZ,VN,2021.0,4,6,-2
SK,JP,2006.0,25,15,10
CO,PA,2018.0,22,27,-5
BY,RU,2002.0,24,15,9
AT,CZ,2013.0,9,20,-11
RU,NZ,2017.0,4,3,1
PL,RO,2020.0,12,13,-1
GH,JP,2002.0,2,1,1
MX,PH,2002.0,3,2,1
CH,AU,2004.0,37,39,-2
IN,SE,2011.0,37,29,8
DE,NZ,2011.0,38,38,0
AT,CA,2013.0,20,27,-7
HN,MX,2007.0,13,26,-13
PK,FR,2003.0,3,3,0
XK,PL,2009.0,2,2,0
JP,HK,1999.0,9,5,4
nan,IE,2011.0,3,6,-3
UA,PL,2016.0,24,28,-4
DK,DE,2003.0,63,66,-3
VE,PT,2002.0,1,1,0
NL,ZA,2000.0,13,9,4
LT,CZ,2007.0,7,5,2
FI,GB,2002.0,36,38,-2
RU,GE,1997.0,5,2,3
GB,UG,2007.0,8,4,4
BW,ZA,2016.0,14,15,-1
NL,IE,2002.0,2,5,-3
OM,IR,2021.0,2,4,-2
AU,BG,2008.0,4,3,1
KE,DK,2012.0,2,3,-1
BR,SD,2005.0,8,5,3
CL,PH,2014.0,1,1,0
IL,JP,2002.0,11,9,2
BN,AU,2016.0,5,7,-2
SA,BE,1997.0,1,1,0
BW,KE,2017.0,2,1,1
PL,SA,2019.0,5,1,4
DK,AT,2002.0,2,3,-1
GB,TZ,2000.0,7,2,5
JP,MX,2018.0,10,11,-1
BO,CL,2022.0,4,2,2
US,SN,2012.0,6,5,1
LV,EE,2021.0,5,1,4
TN,BE,2019.0,9,8,1
SK,RS,2020.0,10,8,2
JP,ZA,2003.0,6,6,0
PH,DE,2003.0,4,6,-2
NZ,DK,2020.0,11,7,4
NZ,BR,2007.0,6,3,3
CL,MA,2019.0,1,1,0
BG,NO,2021.0,5,1,4
KE,ET,2014.0,1,5,-4
CZ,KZ,2018.0,2,3,-1
NL,EE,2020.0,2,4,-2
BE,MY,2013.0,5,2,3
GA,NL,2010.0,3,3,0
IR,NL,2002.0,5,3,2
RS,IE,2010.0,3,1,2
GB,BO,2017.0,2,1,1
NZ,AT,2004.0,3,3,0
IN,BE,2005.0,10,11,-1
ID,AZ,2015.0,1,22,-21
US,KN,2013.0,4,9,-5
NO,AE,2021.0,1,3,-2
CA,HU,2022.0,4,4,0
UG,FR,2018.0,5,9,-4
AR,AO,2004.0,1,1,0
MY,GH,2013.0,2,3,-1
BD,PT,2013.0,2,2,0
BW,KE,2019.0,1,1,0
FR,SK,2004.0,5,3,2
CG,GB,2018.0,2,1,1
TW,AR,2022.0,3,1,2
BR,PL,2016.0,11,11,0
IQ,TW,2019.0,1,1,0
SD,MY,2009.0,4,1,3
SA,BH,2010.0,2,3,-1
LT,RU,2015.0,4,2,2
KR,GH,2021.0,2,1,1
UZ,US,2007.0,2,4,-2
JP,RS,2006.0,3,5,-2
CH,BG,2001.0,2,2,0
nan,LU,2019.0,1,1,0
NZ,CO,2022.0,1,2,-1
GE,FR,2017.0,5,4,1
TW,SI,2004.0,3,1,2
CI,CH,2005.0,1,3,-2
MA,nan,2017.0,2,10,-8
EG,PK,2004.0,1,2,-1
NP,BD,2018.0,7,6,1
NG,DK,2020.0,1,2,-1
VN,SE,2008.0,2,2,0
BY,UA,2011.0,8,5,3
VN,NZ,2022.0,1,5,-4
TH,ZA,2011.0,2,1,1
PK,SN,2018.0,1,1,0
JM,CA,2004.0,1,2,-1
SI,RO,2013.0,4,1,3
CZ,UA,1997.0,4,1,3
HU,EG,2022.0,3,1,2
SK,DK,2004.0,1,4,-3
GN,FR,2021.0,3,4,-1
KY,US,2014.0,3,1,2
GB,MV,2018.0,1,1,0
SE,KR,2008.0,2,3,-1
NZ,CN,2004.0,26,14,12
US,MA,2022.0,10,14,-4
SE,PL,2002.0,10,11,-1
RS,CZ,2001.0,6,7,-1
AR,RU,2016.0,2,3,-1
ES,KR,2021.0,6,21,-15
JO,BH,2018.0,5,1,4
PT,SA,2014.0,5,1,4
NP,NL,2015.0,3,4,-1
FI,SK,1999.0,1,3,-2
PE,NL,2013.0,1,3,-2
MA,CH,2008.0,1,2,-1
FR,BF,2005.0,6,7,-1
PL,FR,2010.0,41,47,-6
IL,JP,2005.0,18,12,6
US,BW,2010.0,3,9,-6
,PL,1997.0,3465,0,3465
,FI,1996.0,2208,0,2208
,CN,2007.0,55527,0,55527
JP,,2019.0,18334,0,18334
US,,2007.0,29940,0,29940
,IN,2004.0,10459,0,10459
JP,,2017.0,15121,0,15121
,CA,1998.0,8116,0,8116
JP,,2010.0,10244,0,10244
,IN,1996.0,6603,0,6603
,DE,2010.0,21148,0,21148
IL,,2024.0,17049,0,17049
DE,,2009.0,8556,0,8556
,AR,1995.0,2546,0,2546
,CA,1997.0,8672,0,8672
,ES,2007.0,12967,0,12967
IN,,2013.0,4794,0,4794
TR,,2014.0,1878,0,1878
,MX,1999.0,2568,0,2568
BE,,2023.0,12668,0,12668
IN,BW,2008.0,3,0,3
SA,,2023.0,8974,0,8974
,BE,2009.0,3190,0,3190
,DE,2017.0,17576,0,17576
,PL,1998.0,3410,0,3410
DZ,,2020.0,1335,0,1335
OM,,2024.0,1093,0,1093
,YE,2007.0,41,0,41
,VE,1997.0,498,0,498
,MG,2017.0,48,0,48
,UA,2013.0,2641,0,2641
IE,,1998.0,123,0,123
,VE,1998.0,476,0,476
,SK,2006.0,646,0,646
IQ,,2022.0,1890,0,1890
BJ,,2024.0,591,0,591
,TH,2000.0,849,0,849
,DE,2019.0,10263,0,10263
,EG,2012.0,4128,0,4128
HU,,2005.0,379,0,379
,UG,2006.0,190,0,190
RO,,2018.0,1488,0,1488
,PE,2004.0,400,0,400
,PA,2011.0,103,0,103
,PE,1996.0,196,0,196
,JO,2012.0,508,0,508
LB,,2023.0,1883,0,1883
,UY,2000.0,160,0,160
RE,,2024.0,185,0,185
,TZ,1994.0,146,0,146
,RO,2015.0,1659,0,1659
,JM,2011.0,46,0,46
,ET,2012.0,718,0,718
,MT,2012.0,90,0,90
,NE,2012.0,41,0,41
CY,,2019.0,222,0,222
,SG,2015.0,1752,0,1752
,RW,2014.0,74,0,74
LK,,2011.0,65,0,65
,BY,1999.0,384,0,384
UZ,,2016.0,92,0,92
BY,,2011.0,191,0,191
,GE,2011.0,218,0,218
CI,,2022.0,476,0,476
,PR,2013.0,23,0,23
HU,,2002.0,281,0,281
,GF,2014.0,17,0,17
,DZ,1995.0,170,0,170
KH,,2004.0,4,0,4
BG,,2007.0,163,0,163
PR,,2024.0,49,0,49
ZW,,2000.0,14,0,14
,MG,2010.0,44,0,44
,RE,2002.0,27,0,27
,TG,2010.0,59,0,59
,LS,2013.0,11,0,11
,AL,2015.0,80,0,80
,CY,1998.0,68,0,68
,LU,2010.0,146,0,146
,HK,2001.0,22,0,22
,PT,2020.0,235,0,235
,RE,2005.0,17,0,17
BO,,2002.0,7,0,7
AO,,2004.0,1,0,1
BN,,2008.0,4,0,4
,HN,1995.0,28,0,28
,ZW,1998.0,76,0,76
BA,AT,2016.0,2,0,2
,SV,2009.0,12,0,12
nan,LU,2017.0,4,0,4
BE,KW,2002.0,1,0,1
IR,MX,2015.0,3,0,3
HR,,1998.0,34,0,34
CY,,2017.0,124,0,124
,ZM,2003.0,30,0,30
KZ,KR,2021.0,4,0,4
,LU,2017.0,140,0,140
,TG,2017.0,44,0,44
SG,BD,2021.0,4,0,4
GE,BE,2019.0,1,0,1
CU,IE,2014.0,1,0,1
,GT,2012.0,45,0,45
,MG,2019.0,40,0,40
,LU,2019.0,90,0,90
,GM,2018.0,28,0,28
,FJ,2011.0,23,0,23
,FI,2004.0,1933,0,1933
TZ,,2016.0,107,0,107
,BI,2005.0,13,0,13
IR,CO,2018.0,6,0,6
,LY,2016.0,80,0,80
KE,,2013.0,95,0,95
,CY,1997.0,55,0,55
GM,,2014.0,5,0,5
OM,QA,2007.0,1,0,1
ET,IE,2002.0,1,0,1
,KH,1997.0,16,0,16
HR,HU,2006.0,2,0,2
,ZW,1997.0,92,0,92
SD,,2014.0,42,0,42
AM,US,1999.0,6,0,6
NL,NA,2018.0,2,0,2
,LA,2012.0,19,0,19
,AF,2012.0,15,0,15
PT,PA,2021.0,2,0,2
,CD,2008.0,66,0,66
PE,IR,2022.0,1,0,1
,CG,2011.0,21,0,21
MX,KE,2001.0,1,0,1
SD,PT,2003.0,2,0,2
,NI,1999.0,8,0,8
HR,CN,2008.0,2,0,2
ZM,,2011.0,13,0,13
JP,CR,2020.0,1,0,1
,MV,2014.0,2,0,2
MV,FR,2019.0,1,0,1
BR,NA,2018.0,2,0,2
NP,ID,2016.0,1,0,1
MC,,2024.0,84,0,84
MA,BJ,2016.0,2,0,2
PA,nan,2012.0,1,0,1
CM,RS,2016.0,1,0,1
KW,JP,2005.0,1,0,1
CY,,2010.0,34,0,34
PL,EE,2013.0,1,0,1
MX,GR,2015.0,4,0,4
,MQ,1996.0,19,0,19
CA,MU,2020.0,2,0,2
BA,,2013.0,46,0,46
ES,GE,2022.0,1,0,1
BD,IT,2023.0,1,0,1
YE,TR,2019.0,1,0,1
QA,,2000.0,8,0,8
IQ,AU,2007.0,1,0,1
LA,,2017.0,9,0,9
HU,TR,2004.0,1,0,1
DZ,MD,2009.0,10,0,10
LA,,2019.0,8,0,8
TN,IN,2022.0,3,0,3
BF,GB,2005.0,1,0,1
PL,TT,2018.0,1,0,1
UA,CL,2000.0,2,0,2
CI,CH,2002.0,1,0,1
QA,YE,2002.0,1,0,1
PE,DO,2019.0,4,0,4
XK,,2013.0,12,0,12
HN,,2005.0,3,0,3
MU,,2012.0,7,0,7
RO,IE,2014.0,3,0,3
FR,GH,2008.0,1,0,1
BR,RE,2003.0,1,0,1
SA,TH,2021.0,2,0,2
CW,,2015.0,22,0,22
MZ,,2015.0,24,0,24
OM,BN,1999.0,1,0,1
SK,SE,2011.0,5,0,5
HN,,2002.0,3,0,3
LK,UZ,2013.0,2,0,2
MQ,GP,2021.0,1,0,1
PK,SY,2012.0,1,0,1
IS,MX,2018.0,5,0,5
UA,HR,2011.0,3,0,3
ET,BW,2012.0,1,0,1
BE,PA,2014.0,3,0,3
US,TT,1997.0,5,0,5
US,VA,2002.0,1,0,1
,TT,2020.0,2,0,2
CH,LT,2017.0,3,0,3
,MQ,2004.0,6,0,6
DK,TW,2010.0,3,0,3
MD,IL,2003.0,1,0,1
IN,PE,2015.0,1,0,1
,GW,2016.0,1,0,1
KH,AU,2006.0,1,0,1
LB,OM,2013.0,1,0,1
AF,BR,2022.0,3,0,3
BJ,TG,2007.0,1,0,1
GB,GD,2014.0,2,0,2
DK,ID,2010.0,1,0,1
HN,BO,2007.0,1,0,1
HK,JP,2023.0,1,0,1
KE,MX,2007.0,1,0,1
PH,RU,2004.0,1,0,1
GR,TR,2003.0,4,0,4
UG,IT,2007.0,2,0,2
AT,GR,1998.0,3,0,3
NZ,QA,2006.0,2,0,2
CA,FI,2023.0,1,0,1
JP,UZ,1997.0,3,0,3
TZ,IT,2012.0,1,0,1
TZ,NG,2016.0,2,0,2
TN,LB,2022.0,2,0,2
GB,AZ,2006.0,2,0,2
NL,KH,2018.0,1,0,1
VE,PT,2005.0,3,0,3
HK,BE,2016.0,1,0,1
PK,EE,2013.0,1,0,1
PK,CV,1999.0,1,0,1
BR,KR,2005.0,2,0,2
MY,FI,2022.0,3,0,3
CL,NI,2008.0,3,0,3
CZ,MK,2007.0,1,0,1
UY,PY,1998.0,1,0,1
IL,BB,2004.0,1,0,1
MA,SD,2011.0,1,0,1
PT,MT,2014.0,1,0,1
IQ,BA,2015.0,1,0,1
BE,BO,2005.0,1,0,1
MR,US,2022.0,3,0,3
CR,SV,2006.0,1,0,1
NP,GH,2019.0,1,0,1
PL,VN,2014.0,4,0,4
KW,CY,2014.0,2,0,2
CD,PG,2011.0,1,0,1
AU,BO,2017.0,1,0,1
DK,UG,2014.0,2,0,2
MW,SZ,2017.0,1,0,1
UZ,AU,2000.0,1,0,1
ME,XK,2019.0,3,0,3
ML,PH,2015.0,3,0,3
nan,CD,2021.0,1,0,1
NZ,TZ,2020.0,3,0,3
TZ,DZ,2021.0,1,0,1
nan,ID,2007.0,2,0,2
nan,IQ,2019.0,4,0,4
CH,GP,2012.0,1,0,1
,BI,2002.0,11,0,11
HN,CO,2005.0,2,0,2
CH,CL,2000.0,2,0,2
PG,PK,2005.0,1,0,1
PK,PS,2015.0,1,0,1
KR,UA,2012.0,4,0,4
ML,,1999.0,5,0,5
,KN,2017.0,11,0,11
,GP,1999.0,11,0,11
BO,,2005.0,13,0,13
JP,DO,2011.0,1,0,1
NO,LB,2011.0,1,0,1
SZ,,2012.0,6,0,6
XK,AT,2016.0,2,0,2
ZA,RO,2006.0,1,0,1
GE,TH,2006.0,1,0,1
NG,NA,2014.0,2,0,2
CZ,MX,2006.0,3,0,3
HR,IN,2016.0,2,0,2
PL,RE,2001.0,1,0,1
BW,GB,1999.0,2,0,2
PL,SJ,2020.0,1,0,1
UG,,2008.0,14,0,14
LI,,2015.0,5,0,5
DE,BW,2010.0,1,0,1
CR,PE,1997.0,1,0,1
DK,VE,2000.0,1,0,1
NZ,NC,2018.0,1,0,1
UA,NO,2000.0,2,0,2
HU,nan,2004.0,5,0,5
WS,FJ,2021.0,2,0,2
PA,,1999.0,3,0,3
FR,AM,2021.0,2,0,2
SE,SD,2005.0,1,0,1
DJ,,2021.0,3,0,3
DE,KP,2012.0,3,0,3
IE,LU,2015.0,2,0,2
PK,NP,2008.0,1,0,1
UY,PA,2010.0,1,0,1
BF,LU,2005.0,1,0,1
MY,ZM,2021.0,2,0,2
MK,SA,2017.0,4,0,4
NO,ID,2001.0,1,0,1
DE,MD,1997.0,1,0,1
CR,RU,2010.0,2,0,2
,KW,2020.0,8,0,8
GB,AO,2014.0,1,0,1
DK,LV,2022.0,1,0,1
HU,AE,2003.0,1,0,1
PY,CL,2009.0,1,0,1
LI,SE,2016.0,1,0,1
ZW,CH,2010.0,2,0,2
NC,CH,2021.0,1,0,1
AU,GT,2022.0,1,0,1
KE,KR,2017.0,3,0,3
GB,MM,2011.0,2,0,2
GB,HN,2003.0,1,0,1
GL,QA,2012.0,1,0,1
HN,ZA,2018.0,1,0,1
,TG,2019.0,37,0,37
,KN,2019.0,6,0,6
MK,RS,1997.0,1,0,1
PK,RO,2009.0,2,0,2
MV,IN,2017.0,1,0,1
GH,MY,2000.0,1,0,1
MM,AT,2018.0,1,0,1
DE,LY,2009.0,2,0,2
GP,AT,2013.0,1,0,1
NO,MA,2012.0,1,0,1
MZ,SE,2014.0,3,0,3
JM,FR,2000.0,1,0,1
ZA,NZ,2023.0,1,0,1
AT,AR,2010.0,2,0,2
NZ,LU,2015.0,2,0,2
AF,JP,2001.0,1,0,1
KE,SG,2008.0,1,0,1
PY,,2002.0,1,0,1
LU,IL,2020.0,1,0,1
KE,TD,2004.0,1,0,1
,TJ,2001.0,12,0,12
UG,CG,2013.0,1,0,1
ZA,CY,2016.0,1,0,1
UG,AU,2020.0,4,0,4
,MS,2012.0,1,0,1
CO,MN,2014.0,1,0,1
DE,PY,2019.0,1,0,1
BE,GA,2013.0,1,0,1
ES,PG,2009.0,1,0,1
FJ,JP,2010.0,1,0,1
NP,KE,2012.0,1,0,1
GP,JM,2012.0,1,0,1
AT,MK,2002.0,2,0,2
PK,UG,2022.0,1,0,1
AM,IR,2008.0,1,0,1
IN,MV,2014.0,1,0,1
GB,UZ,2000.0,2,0,2
PE,TR,2014.0,1,0,1
CH,PY,2007.0,1,0,1
PY,IE,2010.0,1,0,1
KG,KZ,2004.0,1,0,1
BD,PH,2009.0,2,0,2
FO,GB,2014.0,2,0,2
IS,CN,2018.0,1,0,1
PK,LK,2015.0,3,0,3
ST,IT,2012.0,1,0,1
NP,TH,2006.0,1,0,1
ID,CY,2023.0,1,0,1
NL,VN,2002.0,1,0,1
,SR,2004.0,1,0,1
JO,IQ,2009.0,1,0,1
EG,IL,2006.0,1,0,1
OM,NG,2016.0,4,0,4
KR,KH,2021.0,2,0,2
CD,KE,2019.0,1,0,1
LT,CA,2007.0,1,0,1
SI,PE,2016.0,2,0,2
IS,BE,2005.0,1,0,1
PA,SA,2011.0,1,0,1
BE,CW,1999.0,1,0,1
,KN,2010.0,6,0,6
BY,HU,2004.0,1,0,1
TR,PK,1997.0,2,0,2
JP,GM,2003.0,1,0,1
PL,BD,2003.0,1,0,1
DZ,CA,1998.0,1,0,1
VN,KR,2002.0,1,0,1
GT,,2009.0,4,0,4
nan,YE,2016.0,1,0,1
JP,MZ,2004.0,1,0,1
KR,PE,2017.0,2,0,2
FI,IE,2000.0,4,0,4
BH,PH,2014.0,1,0,1
BJ,NC,2015.0,1,0,1
GE,ZA,2010.0,1,0,1
RS,TH,2009.0,1,0,1
IN,MD,2012.0,1,0,1
SN,AU,2020.0,2,0,2
SJ,,2022.0,9,0,9
LB,AT,2013.0,1,0,1
UG,CZ,2017.0,1,0,1
BH,RO,2019.0,1,0,1
ET,CY,2020.0,1,0,1
CN,LR,2020.0,1,0,1
TH,HU,2017.0,1,0,1
GR,GD,2019.0,1,0,1
CR,FI,2021.0,1,0,1
IN,LY,2014.0,4,0,4
JP,PA,2009.0,1,0,1
CR,CA,2006.0,1,0,1
BD,CH,1998.0,1,0,1
PG,IE,2013.0,1,0,1
FR,MT,2008.0,2,0,2
BY,KZ,2016.0,3,0,3
UZ,UA,2000.0,3,0,3
SE,KZ,2004.0,1,0,1
NL,GD,2014.0,1,0,1
AR,CO,2023.0,1,0,1
MG,DE,2005.0,1,0,1
TN,RU,2022.0,1,0,1
BW,KE,2010.0,1,0,1
PY,,2005.0,3,0,3
UA,FI,2002.0,1,0,1
MK,ZA,2007.0,1,0,1
ID,PE,2014.0,2,0,2
MG,NL,2022.0,1,0,1
GE,TR,2016.0,2,0,2
FR,MZ,2020.0,1,0,1
RS,NG,2014.0,1,0,1
KE,SY,2020.0,1,0,1
SS,,2002.0,2,0,2
DK,MT,2022.0,2,0,2
CD,CM,2022.0,1,0,1
BY,PT,2020.0,1,0,1
PA,CL,2004.0,1,0,1
SE,BN,2010.0,1,0,1
NG,GM,2008.0,1,0,1
RS,LV,2018.0,1,0,1
AE,ML,2013.0,1,0,1
JO,MY,2001.0,1,0,1
CD,CA,2010.0,1,0,1
MA,SG,2021.0,1,0,1
LB,PL,2009.0,1,0,1
CU,DE,2001.0,2,0,2
PG,IN,2002.0,1,0,1
NZ,TH,2003.0,2,0,2
,KH,1998.0,5,0,5
ZA,CW,2019.0,1,0,1
JM,BB,2007.0,1,0,1
BZ,US,2014.0,1,0,1
NE,MG,2013.0,1,0,1
FR,AZ,1998.0,1,0,1
SE,ZM,2018.0,1,0,1
ZA,EE,2021.0,1,0,1
PA,BR,1999.0,1,0,1
AR,IN,2003.0,1,0,1
IT,PS,2014.0,1,0,1
nan,IQ,2017.0,3,0,3
VG,TR,2011.0,1,0,1
BE,NP,2004.0,1,0,1
CH,SM,2013.0,1,0,1
HN,CO,2002.0,3,0,3
AO,MX,2020.0,2,0,2
DK,AZ,2018.0,1,0,1
BI,DZ,2019.0,1,0,1
KE,MA,2022.0,1,0,1
ZA,AF,2013.0,1,0,1
IS,AU,2001.0,1,0,1
UA,ZW,2013.0,1,0,1
VE,NZ,2000.0,1,0,1
BM,IN,2016.0,1,0,1
,ST,1994.0,4,0,4
NP,HR,2012.0,1,0,1
PH,CU,2015.0,1,0,1
CZ,UY,2010.0,1,0,1
ID,HU,2012.0,1,0,1
GR,SK,2012.0,1,0,1
RO,LK,2007.0,1,0,1
KR,MD,2019.0,1,0,1
TN,CG,2010.0,3,0,3
IN,BG,2017.0,1,0,1
NA,,2014.0,5,0,5
TR,JO,2013.0,2,0,2
AM,SE,2000.0,1,0,1
DZ,EG,1997.0,1,0,1
BE,SK,1998.0,2,0,2
SG,PT,2014.0,1,0,1
IE,NE,2015.0,1,0,1
FR,CD,2007.0,2,0,2
IN,KH,2010.0,1,0,1
AM,NI,2017.0,1,0,1
JM,ES,2005.0,1,0,1
CW,FR,2009.0,1,0,1
IQ,IL,2006.0,1,0,1
SA,HR,2017.0,1,0,1
KE,ZM,2015.0,1,0,1
NC,NL,2003.0,1,0,1
VE,NO,2013.0,2,0,2
CH,TN,2003.0,2,0,2
SE,PE,2005.0,1,0,1
PH,GW,2015.0,1,0,1
AU,LV,2016.0,2,0,2
CH,VG,2016.0,2,0,2
NA,ID,2021.0,2,0,2
DZ,SY,2019.0,1,0,1
KZ,OM,2015.0,1,0,1
,WS,2014.0,3,0,3
GB,PY,2012.0,1,0,1
DE,HK,2015.0,1,0,1
VI,PL,2016.0,1,0,1
CI,NG,2013.0,1,0,1
TW,QA,2014.0,2,0,2
BB,,2008.0,5,0,5
BM,CA,2018.0,1,0,1
CY,AR,2005.0,1,0,1
ZA,SI,2017.0,1,0,1
MK,SA,2019.0,1,0,1
HR,BG,2006.0,1,0,1
BR,MW,2014.0,1,0,1
KP,,2016.0,2,0,2
NI,HN,2019.0,1,0,1
PL,BA,2020.0,2,0,2
nan,SN,2020.0,2,0,2
SV,US,2007.0,1,0,1
RS,LT,2018.0,1,0,1
CR,CZ,2017.0,2,0,2
FI,KH,2013.0,1,0,1
TW,BE,2023.0,1,0,1
BF,GB,2002.0,2,0,2
NG,BJ,2000.0,2,0,2
EC,RW,2021.0,1,0,1
SC,,2006.0,2,0,2
GM,CH,2009.0,1,0,1
GY,US,2004.0,2,0,2
TW,MY,1998.0,1,0,1
,AZ,2020.0,5,0,5
CZ,RO,2001.0,2,0,2
UZ,TJ,2004.0,1,0,1
IT,MC,2004.0,1,0,1
BY,MX,2011.0,1,0,1
MA,ZA,2010.0,3,0,3
MX,AM,2008.0,1,0,1
UA,IE,2002.0,1,0,1
BH,CN,2012.0,1,0,1
HU,HR,2007.0,1,0,1
SG,LK,2000.0,1,0,1
BZ,AU,2006.0,1,0,1
PA,AR,2000.0,1,0,1
BA,HU,2020.0,1,0,1
GR,PA,2013.0,1,0,1
GB,CV,2015.0,2,0,2
DE,SS,2007.0,1,0,1
SE,BY,2007.0,1,0,1
PK,GA,2022.0,1,0,1
MX,OM,2004.0,2,0,2
UZ,CA,1998.0,1,0,1
CG,MW,2006.0,1,0,1
NO,BW,2003.0,1,0,1
BR,RW,2021.0,1,0,1
DZ,AE,1997.0,1,0,1
DZ,IT,1999.0,4,0,4
PE,PT,2019.0,4,7,-3
CV,BR,2017.0,3,1,2
ES,DZ,2008.0,1,2,-1
HU,TW,2021.0,1,1,0
RS,BR,2015.0,1,3,-2
MU,IN,2015.0,1,2,-1
nan,HU,1998.0,1,1,0
SZ,ZA,2002.0,1,2,-1
PG,CH,2009.0,1,1,0
JP,CU,2006.0,1,1,0
CO,PL,2022.0,1,1,0
PE,JP,2011.0,1,1,0
BH,OM,2012.0,1,1,0
RU,HR,2023.0,2,1,1
SA,FI,2022.0,1,1,0
IQ,QA,2013.0,1,1,0
RU,TZ,2016.0,1,1,0
GE,nan,2008.0,3,4,-1
LI,CH,2013.0,1,2,-1
CG,PK,2019.0,3,4,-1
TH,NO,2021.0,1,3,-2
FR,ZA,2023.0,1,2,-1
ML,AU,2014.0,1,1,0
PL,LU,2015.0,3,4,-1
JM,AU,2017.0,2,2,0
CH,AE,2009.0,1,1,0
SG,AT,2007.0,1,2,-1
LK,MY,2014.0,2,2,0
IL,CL,2017.0,4,2,2
BH,KE,2006.0,3,4,-1
IR,OM,2016.0,1,2,-1
BE,OM,2017.0,1,1,0
TZ,JP,2007.0,2,4,-2
SK,RO,2021.0,2,6,-4
SY,TR,2014.0,1,1,0
CH,BD,2015.0,2,2,0
MZ,RU,2007.0,1,21,-20
AZ,IR,2011.0,2,4,-2
IR,HU,2006.0,2,1,1
KZ,FR,2005.0,2,1,1
BG,nan,2009.0,1,4,-3
GB,BY,2018.0,2,6,-4
ID,AT,2012.0,1,2,-1
KW,PK,1999.0,2,1,1
PH,ID,2019.0,5,7,-2
US,MC,2021.0,2,2,0
GE,BE,2010.0,1,1,0
QA,MA,2018.0,1,3,-2
SA,KR,2022.0,2,7,-5
NG,IE,2018.0,2,10,-8
CY,DE,2013.0,4,5,-1
IN,LS,2016.0,1,1,0
GH,DE,2015.0,1,10,-9
AT,CR,2016.0,1,1,0
KZ,ES,2019.0,1,1,0
PH,BE,2016.0,2,4,-2
IL,DK,2000.0,2,3,-1
MA,DZ,2007.0,2,12,-10
SI,NZ,2012.0,1,1,0
PL,VI,2005.0,1,1,0
IQ,FI,2020.0,1,1,0
UZ,DE,2011.0,4,1,3
AT,BA,2015.0,2,2,0
US,MG,2003.0,2,1,1
CO,UY,2006.0,2,1,1
MW,NG,2001.0,1,1,0
BG,CZ,2020.0,3,3,0
SN,CH,2007.0,1,3,-2
KZ,IL,2019.0,3,2,1
MY,ET,2013.0,1,1,0
CY,IQ,2016.0,2,1,1
DO,CO,2021.0,1,4,-3
PE,BE,2000.0,2,1,1
PL,MY,2016.0,3,1,2
KZ,UZ,2009.0,1,3,-2
CI,BF,2012.0,3,1,2
BR,UA,2009.0,1,2,-1
CA,SY,2011.0,1,3,-2
DZ,DK,2019.0,1,2,-1
BH,AU,2020.0,1,2,-1
JP,CL,2016.0,1,5,-4
TW,CZ,2002.0,3,5,-2
AE,CO,2018.0,1,3,-2
IL,CL,2019.0,1,3,-2
PA,TN,2014.0,1,1,0
SI,PT,2015.0,1,2,-1
SI,ME,2013.0,1,1,0
IQ,IT,2018.0,1,1,0
SK,CA,2022.0,1,1,0
ME,US,2017.0,1,3,-2
MA,NG,2017.0,1,1,0
YE,TR,2017.0,1,1,0
HN,PE,2014.0,1,2,-1
GR,ZA,1998.0,1,2,-1
QA,SG,2014.0,1,5,-4
NP,GH,2017.0,2,1,1
MD,BE,2013.0,2,1,1
ID,PA,2014.0,2,2,0
CO,KR,2020.0,1,2,-1
TR,CL,2011.0,2,2,0
KW,TR,2002.0,2,2,0
ME,US,2019.0,3,2,1
ME,US,2010.0,1,3,-2
LU,JP,2019.0,2,3,-1
IN,MK,2008.0,1,1,0
FI,LU,2001.0,3,1,2
IL,TZ,2017.0,1,1,0
ID,CO,2017.0,1,9,-8
GH,ZA,2004.0,2,1,1
VN,BY,2010.0,1,1,0
TW,TH,2006.0,2,3,-1
KG,PK,2021.0,1,1,0
RU,GE,1998.0,1,3,-2
TR,TG,2006.0,2,2,0
EC,ES,1999.0,1,2,-1
JP,KG,2021.0,1,1,0
SE,AL,2016.0,1,2,-1
UY,CH,2015.0,1,1,0
CO,CU,1999.0,1,3,-2
MY,YE,2007.0,1,1,0
NE,ML,2020.0,1,2,-1
RO,JP,2013.0,1,5,-4
HR,NO,2021.0,3,3,0
SG,ES,2010.0,2,7,-5
SG,DK,2003.0,2,6,-4
SY,DE,2009.0,1,5,-4
GH,TR,2014.0,1,3,-2
RW,DE,2011.0,1,1,0
AR,DO,2019.0,2,2,0
IS,NZ,2017.0,1,1,0
DK,TW,2019.0,3,1,2
PT,CU,2015.0,1,3,-2
AT,NG,2020.0,1,2,-1
BO,CA,2003.0,1,1,0
SE,PK,2002.0,1,1,0
nan,QA,2020.0,2,1,1
FI,MX,2014.0,1,2,-1
TW,AU,1997.0,1,3,-2
GE,FR,2010.0,1,1,0
KZ,nan,2020.0,1,3,-2
IN,BG,2010.0,1,3,-2
KR,RO,2012.0,1,1,0
GH,GM,2020.0,1,2,-1
MW,CN,2016.0,1,1,0
CA,ET,2013.0,2,2,0
TT,GB,2000.0,1,3,-2
CA,TZ,2000.0,1,1,0
ZW,CH,2019.0,1,4,-3
TZ,NL,2008.0,1,2,-1
JP,UZ,1998.0,1,4,-3
BA,SD,2015.0,1,1,0
JM,AU,2010.0,1,4,-3
SI,BE,2010.0,1,3,-2
GB,PR,2005.0,1,1,0
IQ,CA,2023.0,1,1,0
PK,KZ,2018.0,1,1,0
ME,BR,2016.0,1,1,0
CZ,TR,2022.0,2,5,-3
IE,RO,2019.0,1,3,-2
KR,CZ,2002.0,1,3,-2
BW,ET,2019.0,1,4,-3
SJ,SE,2019.0,1,3,-2
nan,LU,2010.0,1,1,0
ME,XK,2010.0,1,1,0
FI,TH,2008.0,1,2,-1
AT,PK,2020.0,2,3,-1
EG,LY,2010.0,1,1,0
CM,ID,2008.0,1,1,0
PA,JP,2014.0,1,2,-1
JO,PK,2016.0,1,1,0
BE,NE,2014.0,1,2,-1
PT,PY,2020.0,1,2,-1
JO,FR,2019.0,1,6,-5
IE,SD,2016.0,1,1,0
CZ,SA,2022.0,1,1,0
IQ,CZ,2020.0,1,1,0
TW,CL,2021.0,1,1,0
ES,GT,2000.0,1,2,-1
NP,NO,2015.0,1,4,-3
PS,LB,2020.0,1,1,0
IE,HU,2017.0,1,3,-2
CH,BF,2003.0,1,1,0
SD,JP,2003.0,1,2,-1
UZ,MY,2012.0,2,1,1
TN,PK,2009.0,1,3,-2
SG,IL,2009.0,1,3,-2
PK,DZ,2020.0,3,3,0
ID,LY,2020.0,1,2,-1
HK,FR,2013.0,1,1,0
SE,SG,2000.0,2,2,0
NI,FR,2013.0,1,1,0
ZW,DE,2019.0,1,2,-1
IN,NG,1999.0,1,2,-1
PA,PE,2015.0,3,2,1
NL,TN,2021.0,1,1,0
QA,nan,2018.0,1,2,-1
ER,IN,2021.0,2,1,1
HR,JP,2008.0,2,1,1
EC,IT,2016.0,1,10,-9
CZ,BR,2009.0,3,3,0
RW,NL,2020.0,2,5,-3
GH,DK,1998.0,2,1,1
GE,KR,2018.0,1,3,-2
RW,KE,2018.0,2,5,-3
ML,SN,2022.0,1,1,0
SK,QA,2016.0,1,1,0
BE,SK,1997.0,1,1,0
SE,UY,2019.0,1,9,-8
LB,ES,2016.0,1,1,0
CA,ZA,2023.0,1,2,-1
BN,US,1998.0,1,1,0
GB,SY,2020.0,3,6,-3
CH,NP,2015.0,1,3,-2
PT,IL,2020.0,1,2,-1
FI,KE,2008.0,1,0,1
nan,UY,2015.0,2,0,2
SV,IT,2004.0,4,0,4
RU,CY,2005.0,1,0,1
LS,,2001.0,1,0,1
SA,UY,2017.0,1,0,1
DE,MC,2017.0,1,0,1
BH,DZ,2012.0,2,0,2
NL,JO,2009.0,1,0,1
NA,NL,2016.0,1,0,1
ES,BY,2022.0,1,0,1
MS,GB,2008.0,1,0,1
HK,SE,2014.0,1,0,1
SK,PK,2018.0,1,0,1
BM,GB,2003.0,1,0,1
GR,IR,2000.0,1,0,1
SJ,SE,2017.0,1,0,1
,TM,2012.0,1,0,1
NL,OM,2001.0,2,0,2
BE,UZ,2007.0,1,0,1
SK,ZA,1997.0,1,0,1
AL,IR,2014.0,1,0,1
SG,KZ,2016.0,1,0,1
BY,MZ,2013.0,1,0,1
SN,LU,2016.0,1,0,1
TW,MY,1997.0,1,0,1
BR,LB,2022.0,3,0,3
MV,IN,2019.0,1,0,1
PE,DO,2017.0,1,0,1
AZ,IN,2021.0,1,0,1
BG,SI,2011.0,1,0,1
IQ,CN,2000.0,1,0,1
UY,FI,2020.0,1,0,1
KE,HU,2020.0,1,0,1
DZ,EG,1998.0,1,0,1
IT,LV,2016.0,2,0,2
EC,PE,2023.0,1,0,1
DE,MC,2019.0,1,0,1
FR,SY,2002.0,2,0,2
IN,RE,2010.0,1,0,1
TR,SK,2016.0,1,0,1
IR,IQ,2011.0,1,0,1
MY,PL,2013.0,1,0,1
TM,RU,1998.0,1,0,1
,LI,1999.0,1,0,1
AF,LB,2019.0,1,0,1
CZ,UA,1998.0,1,0,1
KE,QA,2018.0,2,0,2
NG,HU,1998.0,2,0,2
EE,NZ,2018.0,1,0,1
EC,BD,2015.0,1,0,1
ZA,OM,2012.0,1,0,1
TR,BD,2023.0,1,0,1
NZ,AL,2017.0,1,0,1
NA,ZM,2020.0,1,0,1
KZ,ES,2017.0,1,0,1
IS,HK,2016.0,1,0,1
AZ,,1998.0,2,0,2
CU,LR,2018.0,1,0,1
GB,LR,2019.0,1,0,1
PR,MN,2016.0,1,0,1
IT,HN,2015.0,1,0,1
HK,IS,2019.0,1,0,1
MN,KR,2007.0,1,0,1
TW,RO,2009.0,1,0,1
AU,CU,2006.0,1,0,1
GR,SI,2006.0,1,0,1
IS,LU,2015.0,2,0,2
ZM,NA,1998.0,1,0,1
CH,RE,2019.0,1,0,1
LU,PE,2017.0,1,0,1
TN,KR,2020.0,1,0,1
RE,BJ,2018.0,2,0,2
DZ,TW,2009.0,1,0,1
UA,KE,2018.0,1,0,1
BN,MV,2020.0,2,0,2
GD,,2014.0,3,0,3
NL,UZ,2015.0,1,0,1
CZ,BT,2021.0,1,0,1
EC,JO,2004.0,1,0,1
CI,DE,2009.0,2,0,2
PL,SA,2010.0,1,0,1
PH,LA,2014.0,1,0,1
US,KZ,1997.0,2,0,2
MA,KE,2000.0,1,0,1
BS,CA,2010.0,1,0,1
SS,,2005.0,1,0,1
MK,CZ,2011.0,1,0,1
US,LI,2020.0,1,0,1
MC,NC,2002.0,1,0,1
KZ,EE,2015.0,1,0,1
RS,SS,2005.0,1,0,1
BA,SE,2010.0,1,0,1
IS,FR,2006.0,1,0,1
IR,KH,2014.0,1,0,1
US,BT,2016.0,1,0,1
SD,CM,2015.0,1,0,1
AM,BR,2019.0,1,0,1
IR,EC,2018.0,2,0,2
JP,BH,2007.0,1,0,1
PF,US,2002.0,1,0,1
BW,NL,2007.0,1,0,1
AT,RS,2000.0,1,0,1
BI,,2008.0,2,0,2
PS,IT,2012.0,2,0,2
PG,GH,2012.0,1,0,1
HR,MX,2000.0,1,0,1
AZ,PH,2015.0,1,0,1
SL,ZA,2000.0,1,0,1
IR,AE,2006.0,1,0,1
ID,BF,2012.0,1,0,1
KH,SG,2014.0,1,0,1
SG,ET,2014.0,2,0,2
MN,NG,2018.0,1,0,1
AE,NG,2007.0,1,0,1
CH,AM,2007.0,1,0,1
FM,,2013.0,1,0,1
PL,BG,1997.0,1,0,1
CR,PY,2013.0,1,0,1
BE,CG,2012.0,1,0,1
KZ,MD,2016.0,1,0,1
CH,GE,2012.0,1,0,1
PE,KE,2005.0,1,0,1
MC,CH,2013.0,1,0,1
VE,FI,2014.0,1,0,1
CO,JE,2004.0,1,0,1
CI,SN,2000.0,1,0,1
NP,TW,2008.0,1,0,1
BH,GB,2023.0,1,0,1
BJ,nan,2021.0,1,0,1
NG,FJ,2017.0,1,0,1
ZW,NG,2021.0,2,0,2
PT,LU,2007.0,1,0,1
GH,MZ,2006.0,1,0,1
NL,BI,2013.0,1,0,1
PH,GT,2017.0,1,0,1
PL,IE,1997.0,1,0,1
MZ,KR,2012.0,1,0,1
IT,CG,2016.0,1,0,1
FR,HT,2011.0,1,0,1
nan,CY,2002.0,1,0,1
OM,GB,2023.0,1,0,1
NP,QA,2008.0,1,0,1
LB,DK,2022.0,1,0,1
TN,IL,2004.0,1,0,1
MS,,2010.0,1,0,1
UZ,AZ,2006.0,1,0,1
TR,MX,1999.0,1,0,1
CG,ZW,2008.0,1,0,1
NZ,PH,2012.0,1,0,1
MA,CD,2020.0,1,0,1
ZA,AR,2009.0,1,0,1
ZA,CZ,1999.0,1,0,1
PK,CU,2021.0,1,0,1
IR,BE,2001.0,1,0,1
AZ,CN,2008.0,1,0,1
BW,AU,2011.0,1,0,1
ME,GB,2006.0,1,0,1
BR,AL,2018.0,1,0,1
GT,DO,2020.0,2,0,2
ZW,DE,2010.0,1,0,1
AZ,US,2008.0,1,0,1
CZ,TN,2015.0,1,0,1
ES,HK,2016.0,1,0,1
IN,PS,1997.0,1,0,1
DE,LR,2002.0,1,0,1
SY,SE,2004.0,1,0,1
FK,US,2006.0,1,0,1
MU,BN,2020.0,1,0,1
UG,GA,2008.0,1,0,1
nan,HU,1997.0,1,0,1
,TL,2005.0,1,0,1
TW,BG,2001.0,1,0,1
TR,MA,2007.0,1,0,1
SS,IT,2014.0,1,0,1
AU,ML,2003.0,1,0,1
IN,KY,2015.0,1,0,1
NG,TT,2002.0,1,0,1
AU,ZM,2013.0,1,0,1
TR,CI,2017.0,1,0,1
LB,BD,2018.0,1,0,1
PH,GT,2010.0,1,0,1
LU,SA,2020.0,1,0,1
EG,CM,2022.0,2,0,2
SK,ZA,1998.0,1,0,1
LA,,2010.0,1,0,1
ZA,LV,2003.0,1,0,1
VN,FI,2017.0,1,0,1
IT,GT,2014.0,1,0,1
SY,LB,2008.0,1,0,1
IT,OM,2012.0,1,0,1
IL,QA,2022.0,1,0,1
SK,KZ,2018.0,1,0,1
CH,MW,2006.0,1,0,1
RS,IS,2005.0,1,0,1
PE,KE,2002.0,1,0,1
BJ,IQ,2017.0,1,0,1
GT,FR,2006.0,1,0,1
DE,ME,2014.0,1,0,1
BE,JM,2020.0,1,0,1
IS,RO,2018.0,1,0,1
SE,GH,2015.0,1,0,1
AZ,BG,2021.0,1,0,1
BR,LY,2009.0,1,0,1
CZ,MY,2005.0,1,0,1
PS,,1999.0,1,0,1
ZW,FI,2014.0,1,0,1
RS,ME,2001.0,1,0,1
NI,SE,2018.0,1,0,1
MX,UG,2020.0,1,0,1
VN,BY,2019.0,1,0,1
NG,BF,2014.0,1,0,1
SK,VN,2011.0,1,0,1
CA,ML,2016.0,1,0,1
MK,US,2023.0,1,0,1
CN,ME,2000.0,1,0,1
PR,BR,2006.0,1,0,1
ML,MH,2013.0,1,0,1
BH,NO,2007.0,1,0,1
RO,LU,2016.0,1,0,1
DE,GI,2019.0,1,0,1
IR,TH,2008.0,1,0,1
ES,AG,2009.0,1,0,1
AU,MM,2007.0,1,0,1
CH,RE,2010.0,1,0,1
UA,UZ,2001.0,1,0,1
QA,BD,2011.0,1,0,1
NZ,JO,2018.0,1,0,1
ES,MD,2002.0,1,0,1
BE,AZ,2020.0,1,0,1
LY,AE,2020.0,1,0,1
TT,GH,2020.0,1,0,1
AU,AX,2020.0,1,0,1
IL,LK,2015.0,1,0,1
CU,FI,2018.0,1,0,1
BH,CZ,2016.0,1,0,1
ML,MX,2018.0,1,0,1
LT,SI,2011.0,1,0,1
AL,NG,2013.0,1,0,1
PL,NP,2021.0,1,0,1
IR,GR,2003.0,1,0,1
KR,EC,2021.0,1,0,1
MX,US,2011.0,346,315,31
MX,UA,2012.0,4,4,0
BR,US,2008.0,739,770,-31
BR,NL,2016.0,54,57,-3
CN,US,2017.0,4943,6217,-1274
CN,US,2019.0,5075,6776,-1701
US,NL,2005.0,512,439,73
CA,FR,2015.0,540,591,-51
GE,US,2006.0,117,113,4
US,AR,2019.0,318,341,-23
US,GB,2011.0,5861,5690,171
EG,JP,2017.0,52,72,-20
US,ES,2018.0,947,1176,-229
DE,IN,2020.0,191,234,-43
DE,DK,1997.0,41,34,7
DE,BR,2006.0,111,99,12
DE,NL,2008.0,295,269,26
US,TW,2008.0,732,660,72
GB,SE,2001.0,83,92,-9
US,CA,2008.0,2829,2825,4
TW,US,2011.0,733,769,-36
US,CL,2001.0,80,72,8
DE,FR,2009.0,487,481,6
CN,US,2010.0,5440,6919,-1479
CZ,HU,2014.0,5,9,-4
CN,DE,2012.0,250,279,-29
IE,BR,2021.0,11,17,-6
US,CU,2004.0,18,16,2
GB,CY,2012.0,37,24,13
FR,CA,2005.0,453,317,136
BD,PK,2023.0,12,2,10
CR,US,2006.0,22,18,4
NP,IN,2015.0,107,100,7
GB,MY,2019.0,164,137,27
CA,KE,2007.0,5,2,3
NL,FR,2012.0,180,175,5
CH,DE,2016.0,776,956,-180
GB,AU,2009.0,1189,975,214
US,GT,2012.0,8,9,-1
US,ZA,2012.0,351,307,44
GB,EG,2006.0,35,19,16
US,AR,2010.0,233,181,52
CA,GB,2000.0,417,326,91
VE,EC,2006.0,4,1,3
FR,TN,2006.0,108,84,24
AU,NZ,2003.0,96,111,-15
AT,DE,2007.0,345,387,-42
ID,US,2016.0,138,246,-108
PL,DE,2018.0,149,128,21
ZA,NL,2016.0,37,57,-20
DE,ES,2014.0,202,301,-99
MY,US,2015.0,175,198,-23
IE,AU,2022.0,70,82,-12
JP,CN,2014.0,560,410,150
US,SE,2011.0,423,354,69
FR,US,2009.0,1308,1253,55
CO,AR,2022.0,55,44,11
NO,US,2020.0,136,224,-88
MY,BR,2012.0,117,35,82
ES,DE,2011.0,206,199,7
CN,JP,1999.0,228,256,-28
GB,CN,2022.0,601,411,190
BE,GB,2016.0,163,141,22
CA,MY,2011.0,19,16,3
IL,US,1999.0,356,303,53
DE,AT,2018.0,743,651,92
GB,GR,2015.0,174,309,-135
CO,MX,2011.0,172,232,-60
PK,CN,2013.0,63,49,14
AT,BR,2020.0,12,22,-10
US,NP,2018.0,81,84,-3
DE,NO,2003.0,38,19,19
GB,IQ,2018.0,149,29,120
SE,FI,2007.0,68,68,0
US,MY,2012.0,152,104,48
BE,NL,2013.0,250,311,-61
SE,RU,2014.0,35,28,7
US,DK,2008.0,302,179,123
JP,CA,2013.0,103,111,-8
CR,MX,2004.0,10,7,3
IN,BD,2022.0,102,102,0
TR,NL,2012.0,23,31,-8
AU,MK,2006.0,19,22,-3
DE,LU,2023.0,1,2,-1
JP,KR,2003.0,224,156,68
IR,US,2020.0,700,447,253
BR,CH,2011.0,40,33,7
nan,GB,2013.0,79,71,8
HR,RS,2009.0,94,81,13
US,AR,2017.0,281,257,24
SA,IN,2009.0,13,25,-12
AU,SG,2010.0,86,75,11
PH,US,2003.0,262,220,42
AU,TW,2017.0,41,67,-26
US,IT,2003.0,625,606,19
KR,SE,2001.0,4,2,2
BE,CA,2003.0,36,27,9
BE,ZA,2009.0,17,8,9
US,HU,1998.0,68,62,6
FR,MA,2015.0,304,232,72
JP,VN,2004.0,15,6,9
IE,DE,2011.0,79,69,10
FR,nan,2005.0,115,105,10
TR,IT,2000.0,4,5,-1
CL,AR,2015.0,89,92,-3
CA,CH,2006.0,72,82,-10
AU,SG,2017.0,143,119,24
CH,AT,2015.0,124,122,2
CA,BR,2004.0,131,115,16
FR,MX,1999.0,26,15,11
CA,IR,2011.0,101,169,-68
MY,GB,2016.0,112,184,-72
GB,MY,2017.0,163,113,50
AT,US,2000.0,142,130,12
CL,DE,2019.0,74,63,11
FR,GB,2013.0,554,544,10
CN,HK,2018.0,135,148,-13
GB,NO,2018.0,103,113,-10
JP,IT,2017.0,63,66,-3
RS,MX,2006.0,26,27,-1
KR,IN,2007.0,65,120,-55
DE,HU,2004.0,35,48,-13
SG,AU,2021.0,94,122,-28
GB,SG,2013.0,135,96,39
US,BD,2020.0,175,189,-14
LK,GB,2020.0,21,26,-5
PH,CA,2019.0,12,18,-6
NL,SE,2000.0,28,19,9
JP,GR,2021.0,16,17,-1
IN,NL,2006.0,20,25,-5
NL,GB,1997.0,103,67,36
SG,JP,2020.0,35,36,-1
SK,US,2004.0,34,21,13
RU,UA,2013.0,185,243,-58
JP,IT,2010.0,62,78,-16
GR,FR,2004.0,16,27,-11
BE,SA,2013.0,2,1,1
KR,ES,2017.0,18,8,10
IT,NO,2000.0,20,11,9
IN,TW,2020.0,77,48,29
FR,SE,2015.0,97,64,33
CL,DE,2017.0,56,50,6
CO,FI,2015.0,1,2,-1
IL,DE,2008.0,70,39,31
AU,QA,2019.0,18,11,7
EC,GB,2018.0,8,12,-4
UG,ZA,2015.0,15,14,1
FR,IE,1997.0,6,4,2
SG,ID,2004.0,2,2,0
CN,nan,2014.0,135,126,9
FR,IN,2001.0,132,49,83
CN,BG,2011.0,13,18,-5
DE,IR,2020.0,80,112,-32
CN,GR,2002.0,8,3,5
IN,CN,2012.0,164,154,10
CN,VN,2015.0,42,23,19
US,BA,2018.0,9,6,3
SA,JO,2014.0,24,35,-11
CA,NL,1998.0,34,33,1
SY,CN,2003.0,10,6,4
FR,CA,2002.0,332,249,83
US,RS,2009.0,53,44,9
IE,RS,2008.0,2,3,-1
CN,TH,2019.0,69,46,23
AR,CL,2019.0,147,140,7
US,LB,2011.0,57,52,5
CN,TH,2010.0,16,12,4
AR,CL,2017.0,119,104,15
AU,IQ,2019.0,30,13,17
DE,ZA,2020.0,64,61,3
AT,AU,2011.0,23,27,-4
PT,FI,2016.0,9,4,5
JP,EG,2012.0,89,63,26
GB,TH,2014.0,78,33,45
IR,IL,2019.0,4,3,1
HU,CA,2022.0,4,4,0
BE,JP,1997.0,16,6,10
US,VG,2004.0,5,8,-3
JP,IN,1999.0,77,106,-29
CA,KR,2003.0,19,22,-3
nan,CM,2017.0,6,9,-3
US,JO,2017.0,89,40,49
IN,PK,2015.0,239,226,13
IL,HR,2017.0,2,1,1
MY,RU,2020.0,21,11,10
CH,AU,2015.0,79,89,-10
PS,ES,2017.0,14,6,8
GB,IN,2022.0,301,352,-51
US,SD,2020.0,13,7,6
TN,CA,2004.0,3,4,-1
NO,DE,2015.0,68,90,-22
NL,DK,2009.0,33,22,11
SG,US,2003.0,173,176,-3
FR,SN,2019.0,60,40,20
GW,PT,2013.0,1,1,0
MN,RU,2019.0,3,4,-1
SA,SD,2019.0,31,50,-19
CZ,JP,2018.0,19,22,-3
AM,RU,2020.0,23,13,10
US,JO,2019.0,85,63,22
EG,JP,2019.0,45,58,-13
ZW,TR,2014.0,1,1,0
KE,US,2012.0,48,57,-9
DE,SG,2021.0,28,28,0
IN,RU,2000.0,7,11,-4
BG,FR,2014.0,8,2,6
GB,SA,2019.0,236,117,119
US,IR,2009.0,172,202,-30
DE,IL,2021.0,65,67,-2
NO,SE,2021.0,70,92,-22
NL,TR,2010.0,18,26,-8
BR,nan,2013.0,80,86,-6
AT,IE,2003.0,3,3,0
IT,ID,2020.0,30,16,14
GB,SA,2010.0,76,30,46
HR,GB,2006.0,9,8,1
BG,GR,2019.0,5,4,1
FR,DZ,2021.0,83,85,-2
NL,GR,2018.0,29,38,-9
nan,TW,2010.0,4,2,2
HU,AT,2011.0,25,30,-5
FR,RU,2015.0,99,71,28
GB,EE,2011.0,11,6,5
CN,ET,2016.0,5,6,-1
US,HR,2020.0,25,39,-14
AU,SG,2019.0,162,161,1
CR,ES,2007.0,17,15,2
NZ,FR,2011.0,19,24,-5
AR,CL,2010.0,51,79,-28
IT,ES,2011.0,274,131,143
CO,JP,2009.0,6,9,-3
IN,FR,2006.0,95,46,49
CA,IL,2015.0,61,57,4
ES,PS,2018.0,20,12,8
TW,JP,2007.0,50,68,-18
EG,SA,2010.0,187,85,102
BR,IL,2020.0,13,8,5
CA,KW,2015.0,15,12,3
PK,IT,2019.0,16,20,-4
EG,QA,2014.0,36,29,7
PK,MY,2001.0,3,2,1
RU,BR,2014.0,13,13,0
GB,SA,2017.0,185,76,109
DK,CY,2017.0,1,1,0
IN,TH,2022.0,29,16,13
PY,CO,2016.0,7,7,0
EC,AR,2017.0,18,48,-30
JP,LT,2014.0,9,5,4
GB,CO,2022.0,21,22,-1
IT,BE,2001.0,43,47,-4
DE,CA,1999.0,113,89,24
PL,CZ,2007.0,34,20,14
RU,CZ,2000.0,7,11,-4
UZ,CN,2006.0,6,8,-2
TH,SG,2010.0,6,2,4
US,KW,2012.0,20,15,5
UA,IT,2016.0,35,34,1
GH,ZA,2015.0,15,7,8
SE,IR,2016.0,39,42,-3
IT,AR,2014.0,104,103,1
PH,CH,2014.0,4,5,-1
CA,DK,2015.0,48,32,16
NG,SA,2020.0,15,13,2
CA,MX,2003.0,11,17,-6
TR,DK,2017.0,18,15,3
GB,IR,2012.0,98,79,19
KR,SG,2020.0,50,48,2
JP,IT,2019.0,70,62,8
IE,NG,2018.0,10,2,8
UA,ES,2022.0,1,2,-1
EC,US,2015.0,32,72,-40
UA,US,2018.0,77,86,-9
US,NG,2012.0,61,58,3
CO,AE,2016.0,2,1,1
PK,QA,2017.0,11,10,1
DK,CH,2015.0,34,36,-2
CN,CZ,2022.0,17,14,3
CN,TH,2017.0,32,33,-1
FR,CZ,2001.0,12,15,-3
FR,nan,2002.0,88,60,28
KR,ES,2019.0,12,22,-10
DK,US,2001.0,171,174,-3
MA,IT,2015.0,31,45,-14
SM,IT,2020.0,2,4,-2
MX,AU,2022.0,11,8,3
TW,VN,2022.0,33,22,11
IR,GB,2013.0,91,89,2
QA,EG,2018.0,59,61,-2
SD,EG,2022.0,19,15,4
HU,DE,2019.0,64,59,5
AZ,RU,2014.0,23,5,18
LT,DE,2019.0,10,11,-1
CA,GH,2022.0,7,10,-3
AT,CH,1997.0,38,26,12
JP,SG,2015.0,45,32,13
UG,IE,2017.0,1,1,0
PH,CA,2017.0,10,7,3
HU,DE,2017.0,77,61,16
AU,CO,2017.0,18,17,1
KR,FR,2022.0,17,17,0
UG,TZ,2020.0,5,4,1
RS,CN,2019.0,6,13,-7
GB,VN,2016.0,19,6,13
SG,BN,2019.0,3,1,2
NP,GB,2020.0,12,13,-1
EG,SD,2015.0,20,13,7
CA,ES,2001.0,41,30,11
UA,BR,2018.0,9,10,-1
NA,ZA,2019.0,8,23,-15
GR,IT,2021.0,26,36,-10
ZA,TR,2018.0,3,7,-4
BR,JP,2013.0,43,47,-4
NO,BD,2018.0,10,1,9
MX,IE,2021.0,4,2,2
CZ,IE,2019.0,9,7,2
PK,JP,2021.0,10,11,-1
MM,TH,2019.0,11,10,1
PK,QA,2019.0,19,11,8
CR,CU,2022.0,10,3,7
JO,SA,2018.0,40,59,-19
SN,FR,2021.0,20,40,-20
CA,US,2007.0,2525,2880,-355
US,NL,2002.0,402,405,-3
AU,CO,2019.0,14,21,-7
ES,CU,2006.0,63,58,5
GB,IT,2008.0,268,405,-137
NL,IT,2014.0,74,124,-50
CA,VE,2020.0,6,1,5
PL,CN,2012.0,35,26,9
CN,BE,2015.0,70,51,19
US,FI,2013.0,138,144,-6
AT,IT,2018.0,72,89,-17
SD,CN,2021.0,10,5,5
CH,ID,2019.0,13,8,5
BR,CO,2002.0,21,21,0
IT,NL,2020.0,141,111,30
ET,CN,2021.0,16,29,-13
nan,IT,2012.0,89,172,-83
US,TH,2012.0,206,122,84
UA,RU,2000.0,62,72,-10
UA,AE,2020.0,2,2,0
BN,IN,2019.0,5,2,3
YE,SA,2022.0,17,20,-3
MA,GB,2014.0,3,6,-3
PL,CA,2020.0,26,34,-8
US,RU,2015.0,546,421,125
TW,KR,2005.0,25,20,5
NL,ID,2009.0,17,3,14
BR,ZA,2011.0,7,9,-2
FR,AU,2007.0,83,89,-6
HU,HR,2008.0,2,1,1
PL,NO,2006.0,4,3,1
US,BY,2018.0,10,11,-1
PL,ES,1998.0,2,4,-2
JP,CH,2022.0,34,44,-10
HK,RO,2018.0,12,7,5
CA,NL,1997.0,25,34,-9
IS,US,2012.0,11,21,-10
NG,ZA,2010.0,28,10,18
DZ,MN,2019.0,3,9,-6
FR,SK,2015.0,10,3,7
DE,FI,2020.0,58,71,-13
NL,TR,2019.0,32,58,-26
LU,BE,1998.0,6,2,4
SE,AU,1999.0,28,24,4
AT,GB,2006.0,61,39,22
ZA,TZ,2014.0,7,4,3
US,BG,2016.0,40,29,11
GR,CA,2000.0,6,9,-3
PL,IL,2010.0,4,7,-3
KZ,UA,2018.0,9,4,5
BD,TH,2014.0,4,3,1
NZ,IE,2012.0,17,14,3
GT,ES,2022.0,6,4,2
AR,IL,2018.0,6,4,2
GB,RS,2014.0,20,19,1
IT,ZA,2015.0,20,15,5
KR,KP,2018.0,13,6,7
BG,NL,1999.0,2,2,0
AU,LK,2011.0,17,15,2
KR,GB,2022.0,78,72,6
CY,US,2002.0,8,9,-1
GB,AR,2007.0,19,27,-8
CR,ZA,2014.0,5,3,2
CN,IL,2013.0,19,18,1
CZ,IE,2010.0,5,3,2
EG,TW,2016.0,16,18,-2
TW,KR,2002.0,20,25,-5
PH,CN,2016.0,26,28,-2
IL,ID,2017.0,5,2,3
US,QA,2000.0,10,7,3
HU,PL,2013.0,17,15,2
MX,IN,2016.0,13,23,-10
AO,BR,2014.0,16,27,-11
AE,MY,2016.0,9,26,-17
TR,CZ,2021.0,7,9,-2
IN,IL,2001.0,9,8,1
DK,GL,2006.0,3,3,0
HK,US,2020.0,12,14,-2
HN,MX,2008.0,22,11,11
JP,BD,2000.0,14,9,5
BD,IN,2013.0,105,77,28
MX,CU,2001.0,15,14,1
IE,IQ,2021.0,3,1,2
NL,KR,2000.0,4,1,3
AU,TW,2019.0,36,64,-28
CZ,SK,2005.0,37,51,-14
EG,AE,2022.0,56,32,24
nan,CM,2019.0,11,16,-5
UA,nan,2021.0,17,26,-9
QA,IN,2021.0,21,32,-11
IL,BE,2014.0,8,9,-1
AU,RO,2013.0,5,3,2
US,MM,2020.0,12,17,-5
CN,EG,2004.0,5,5,0
FR,KH,2009.0,4,4,0
SE,BY,2008.0,2,1,1
NA,ZA,2017.0,7,14,-7
PT,VE,2020.0,4,3,1
TR,FR,2001.0,9,12,-3
IL,CH,1997.0,5,3,2
ES,PH,2016.0,16,17,-1
CA,GR,2008.0,10,6,4
CL,PA,2016.0,9,6,3
BG,GB,2022.0,7,4,3
KZ,RU,2012.0,15,26,-11
CZ,SK,2002.0,21,35,-14
DE,PE,2021.0,9,6,3
CA,TW,2000.0,25,14,11
GB,IS,2005.0,4,1,3
ES,DK,2009.0,37,21,16
NL,NO,2006.0,22,15,7
NO,ZA,2010.0,5,9,-4
RW,BE,2012.0,2,4,-2
OM,FR,2015.0,2,1,1
PK,US,2004.0,74,65,9
CN,IN,2003.0,43,68,-25
MX,RU,2014.0,7,6,1
KR,FI,2017.0,7,6,1
nan,NZ,2008.0,40,9,31
IT,RO,2013.0,21,9,12
CF,FR,2007.0,3,3,0
CH,CZ,2018.0,35,31,4
KR,TH,2017.0,10,12,-2
TR,nan,2012.0,25,11,14
MY,EG,2005.0,3,4,-1
HR,CN,2007.0,1,3,-2
KE,CN,2005.0,2,2,0
AR,CU,2022.0,8,7,1
TR,SG,2015.0,10,5,5
MY,NZ,2021.0,9,9,0
PK,JO,2018.0,4,2,2
SA,AU,2007.0,6,6,0
TR,QA,2018.0,9,7,2
IQ,GB,2022.0,21,24,-3
NE,US,2019.0,3,2,1
DE,KE,2021.0,14,5,9
CN,BD,2012.0,66,62,4
MD,RO,2021.0,12,16,-4
BY,GB,2020.0,1,1,0
GR,SG,2019.0,2,2,0
GB,AT,2023.0,8,4,4
ID,CA,2011.0,3,9,-6
IT,CU,1997.0,2,1,1
PK,DE,2018.0,28,43,-15
IT,AL,2021.0,6,5,1
CL,CU,2006.0,10,17,-7
BR,MY,2012.0,35,117,-82
nan,ES,2007.0,26,15,11
NI,CO,2016.0,4,3,1
AR,BE,2016.0,12,10,2
BE,PT,2001.0,2,2,0
ZA,FR,2020.0,43,42,1
US,BO,2014.0,6,5,1
NA,BW,2019.0,1,1,0
CM,BJ,2020.0,3,2,1
CH,JP,2009.0,57,73,-16
FR,DK,2012.0,26,43,-17
FR,AR,2007.0,30,31,-1
IN,PH,2014.0,25,13,12
PT,LU,2008.0,1,1,0
AE,DE,2018.0,10,20,-10
IT,US,2023.0,56,38,18
QA,CN,2023.0,2,5,-3
ID,IR,2019.0,22,47,-25
DE,IE,1998.0,17,16,1
JP,TR,2006.0,30,34,-4
nan,DE,2006.0,30,44,-14
US,JO,2010.0,47,30,17
VE,CO,2016.0,68,42,26
FR,MC,1998.0,3,1,2
HU,DE,2010.0,56,54,2
BH,US,2015.0,7,6,1
BG,ES,2011.0,3,5,-2
BO,FR,1998.0,2,1,1
AT,HU,2011.0,30,25,5
CO,GB,2004.0,16,13,3
TR,EG,2022.0,7,9,-2
UG,US,2022.0,19,24,-5
FR,SN,2017.0,36,36,0
EG,TN,2021.0,16,21,-5
CA,BE,2012.0,59,54,5
ID,KW,2019.0,1,3,-2
BR,SE,2022.0,30,15,15
DE,GR,2012.0,55,75,-20
IT,UA,2014.0,40,17,23
CN,GE,2019.0,5,4,1
KP,CN,2017.0,5,6,-1
ES,MY,2014.0,8,3,5
MK,HR,2020.0,2,3,-1
PT,DK,2009.0,3,1,2
BE,TR,1999.0,3,2,1
TH,NL,2011.0,7,5,2
NZ,AT,2015.0,5,10,-5
MT,GB,2002.0,6,2,4
CZ,EE,2017.0,1,2,-1
AT,FR,2001.0,21,16,5
ES,SE,2011.0,59,45,14
ES,EE,2012.0,1,3,-2
BG,JP,2020.0,1,5,-4
DE,TR,2007.0,34,38,-4
TR,CH,2009.0,15,11,4
GB,LK,2020.0,26,21,5
NO,FR,2003.0,33,21,12
BE,JP,1998.0,13,8,5
US,RW,2009.0,9,3,6
AT,TW,2012.0,3,1,2
JO,US,2013.0,32,61,-29
PL,nan,2012.0,6,8,-2
nan,MY,2008.0,14,15,-1
GB,ID,2003.0,6,2,4
GR,IN,2015.0,7,5,2
RU,CO,2019.0,3,2,1
BE,nan,2010.0,20,9,11
DE,IE,1997.0,15,7,8
ZA,MW,2006.0,4,2,2
ID,GB,1998.0,4,4,0
FR,GE,2017.0,4,5,-1
TR,KZ,2011.0,28,42,-14
TW,SG,2022.0,31,33,-2
GR,CY,2006.0,15,8,7
SJ,US,2019.0,2,2,0
CY,GB,2008.0,7,19,-12
TN,MA,2008.0,12,16,-4
IE,NZ,1997.0,4,3,1
TR,SE,2002.0,4,5,-1
CH,ZA,2008.0,6,13,-7
SG,BN,2010.0,2,1,1
RU,PT,2013.0,5,3,2
KR,BD,2013.0,28,21,7
JP,KE,2006.0,5,4,1
SE,ES,2005.0,18,22,-4
BE,DZ,2021.0,4,2,2
FI,IT,2016.0,15,18,-3
HR,CZ,2008.0,2,5,-3
UG,BE,2015.0,7,4,3
IN,RO,2011.0,41,14,27
NG,IT,2015.0,10,8,2
JP,MY,2004.0,16,8,8
NZ,IN,2005.0,13,9,4
NL,GH,2018.0,7,4,3
MM,ZM,2016.0,1,1,0
JP,TH,2000.0,21,15,6
NO,AT,2014.0,7,6,1
SE,ES,2002.0,20,21,-1
IN,TR,2013.0,18,14,4
FR,KE,2018.0,5,5,0
DK,JP,2013.0,15,19,-4
FR,PH,2020.0,9,5,4
SD,BR,2017.0,6,2,4
KE,PK,2016.0,16,26,-10
GB,PE,2012.0,11,8,3
TR,AL,2013.0,5,2,3
DE,DK,1998.0,43,47,-4
CO,HN,1998.0,1,1,0
NP,CN,2022.0,7,16,-9
AT,IR,2011.0,8,10,-2
PE,VE,2003.0,4,2,2
MX,BR,2012.0,106,72,34
LU,ES,1998.0,1,1,0
IT,KR,2003.0,2,2,0
AU,BE,1997.0,7,5,2
AU,nan,2000.0,7,7,0
FR,IE,1998.0,8,5,3
JP,SK,2008.0,9,22,-13
CL,EC,2002.0,2,2,0
ID,GH,2022.0,8,2,6
TW,PL,2003.0,2,1,1
DK,KR,2003.0,2,2,0
IS,NO,2009.0,5,4,1
JP,IL,1999.0,5,4,1
CN,SY,2006.0,8,14,-6
NO,HU,2009.0,1,1,0
SI,DE,2009.0,11,6,5
SE,NZ,2011.0,7,6,1
KH,JP,2012.0,6,2,4
NA,US,1998.0,1,2,-1
CO,EC,2002.0,2,1,1
UA,GB,2021.0,10,13,-3
PT,PH,2018.0,4,1,3
CU,PT,2006.0,3,2,1
KR,AT,2009.0,4,3,1
SE,EG,2001.0,1,2,-1
OM,SD,2011.0,1,1,0
CZ,AU,2001.0,3,2,1
DK,CA,1999.0,18,17,1
TH,SG,2017.0,8,6,2
SA,SD,2017.0,19,44,-25
FR,VG,2011.0,1,2,-1
BD,JP,2006.0,28,50,-22
PK,PH,2020.0,3,4,-1
SI,RS,2006.0,7,3,4
CZ,ID,2014.0,7,5,2
NZ,IT,2009.0,6,4,2
CN,SA,2003.0,2,3,-1
EE,FR,2014.0,7,10,-3
FR,EE,2015.0,5,3,2
IL,IT,2022.0,10,11,-1
AG,US,2016.0,3,4,-1
IN,NZ,2007.0,13,6,7
ID,TH,2016.0,8,21,-13
FR,MC,1997.0,2,3,-1
JO,CN,2021.0,6,2,4
DE,MY,2000.0,1,1,0
SA,SD,2010.0,4,6,-2
FR,SN,2010.0,25,27,-2
SE,GR,2021.0,16,21,-5
RO,GB,1997.0,3,1,2
EE,AT,2011.0,3,1,2
SD,IT,2010.0,1,1,0
CU,VE,2020.0,13,16,-3
NC,FR,2005.0,10,7,3
GH,NL,2021.0,3,5,-2
TH,PK,2020.0,11,7,4
NZ,SG,1998.0,5,2,3
AU,ET,2019.0,11,16,-5
UZ,US,2008.0,3,5,-2
IS,VN,2014.0,1,1,0
BE,nan,2017.0,16,40,-24
NO,IN,2013.0,13,24,-11
CH,UG,2015.0,6,4,2
SA,PS,2022.0,14,2,12
TR,DK,2019.0,17,6,11
CL,PE,2008.0,20,27,-7
PT,EC,2014.0,4,2,2
KG,KZ,2015.0,3,1,2
BR,DK,2013.0,12,14,-2
RO,SE,2003.0,3,1,2
IS,DK,2022.0,7,5,2
MA,PK,2011.0,30,11,19
PE,CH,2006.0,2,2,0
MX,FI,2019.0,4,2,2
US,MD,2018.0,10,9,1
AT,NL,2006.0,12,16,-4
AU,QA,2010.0,17,7,10
AU,AT,2005.0,10,16,-6
HR,DE,2013.0,26,17,9
EG,BD,2015.0,7,7,0
TR,RS,1997.0,4,7,-3
CN,RW,2021.0,5,6,-1
CN,GR,2005.0,9,9,0
GB,VG,1999.0,7,3,4
CZ,IE,2017.0,3,4,-1
IE,ZA,2008.0,3,5,-2
CZ,LT,2016.0,3,4,-1
IS,GB,2011.0,8,10,-2
ZM,GH,2016.0,39,12,27
KW,SA,2019.0,32,40,-8
SA,ES,2013.0,2,6,-4
IT,RS,2004.0,3,3,0
GB,CU,2018.0,2,4,-2
VE,DE,2004.0,8,2,6
BG,DE,2005.0,25,21,4
FR,VN,2001.0,11,4,7
GY,US,2015.0,2,1,1
KR,ES,2010.0,4,6,-2
IL,ID,2019.0,6,1,5
FR,RE,2001.0,4,8,-4
BN,GB,1999.0,1,4,-3
FR,CL,2006.0,23,16,7
FI,CA,2015.0,20,22,-2
CY,GR,2009.0,14,23,-9
PH,PL,2002.0,6,2,4
CL,CH,2010.0,14,7,7
SK,HR,2021.0,6,6,0
nan,CM,2010.0,3,1,2
GH,CN,2013.0,5,7,-2
BG,GR,2010.0,2,2,0
PL,GR,1998.0,2,2,0
QA,JP,2010.0,1,2,-1
RU,LT,1999.0,3,2,1
FR,GA,2009.0,6,5,1
CA,PT,2004.0,3,9,-6
IE,IL,2006.0,1,2,-1
DE,EE,2001.0,9,11,-2
NO,CH,2000.0,9,10,-1
BY,CZ,2006.0,8,6,2
BH,EG,2009.0,1,3,-2
IL,CH,1998.0,9,3,6
ZA,UG,2016.0,13,12,1
KE,ES,2019.0,1,2,-1
SI,ES,2000.0,4,2,2
NP,JP,2016.0,8,11,-3
ES,JP,2006.0,26,21,5
RO,HK,2022.0,8,5,3
BY,VN,2009.0,6,1,5
EG,FI,2018.0,5,4,1
EG,KR,2021.0,5,7,-2
JP,CM,2018.0,1,2,-1
BG,DE,2002.0,22,14,8
US,AM,2013.0,7,17,-10
IN,SY,2017.0,2,3,-1
PS,DE,2009.0,6,4,2
DE,PS,2014.0,4,4,0
IT,DK,2000.0,7,11,-4
FR,PF,2007.0,11,2,9
TJ,IR,2015.0,2,2,0
LU,GB,2000.0,1,1,0
nan,NG,2013.0,4,3,1
JP,BE,1997.0,6,16,-10
SJ,GB,2010.0,1,2,-1
DE,BD,2022.0,10,11,-1
UZ,ID,2019.0,2,3,-1
ES,EG,2006.0,3,1,2
NO,EC,2017.0,2,3,-1
SG,NZ,2000.0,3,3,0
EG,PK,2015.0,12,15,-3
SA,SG,2020.0,6,5,1
ES,CN,1997.0,6,5,1
NG,nan,2018.0,10,3,7
RS,CN,2010.0,11,7,4
CL,CH,2017.0,16,15,1
PH,BD,2021.0,3,2,1
GB,JM,2004.0,3,8,-5
HU,MA,2020.0,1,2,-1
MU,GB,2003.0,1,1,0
NL,AR,2011.0,7,9,-2
TT,US,2004.0,2,3,-1
AO,ES,2012.0,3,3,0
CA,UY,2009.0,3,1,2
AU,SA,2005.0,1,3,-2
IE,FR,2020.0,42,33,9
CO,nan,2009.0,6,4,2
MX,IT,2008.0,29,28,1
CL,BR,2003.0,17,25,-8
VE,CA,2019.0,5,2,3
TH,NP,2018.0,5,5,0
IE,SE,2021.0,14,6,8
CU,US,2011.0,22,25,-3
ES,PR,2005.0,1,1,0
ES,HN,2015.0,11,13,-2
RU,DK,2022.0,12,3,9
IL,ES,2020.0,9,16,-7
GB,PH,2004.0,8,9,-1
JP,FI,2002.0,10,6,4
nan,BE,2001.0,13,6,7
AT,SK,2012.0,11,14,-3
MN,DZ,2016.0,2,6,-4
PK,KR,2008.0,5,2,3
JO,NZ,2021.0,1,1,0
GE,SK,2013.0,3,4,-1
NL,UG,2014.0,5,1,4
IT,PK,2016.0,12,5,7
SE,SK,1998.0,2,2,0
NL,IS,2021.0,6,1,5
AU,MX,2020.0,12,20,-8
SV,GB,2013.0,1,2,-1
MD,CH,1999.0,1,1,0
US,CI,2018.0,10,6,4
UZ,ID,2010.0,2,1,1
PK,IE,2021.0,13,10,3
KE,CN,2002.0,2,3,-1
CO,TW,2017.0,2,2,0
DK,nan,2018.0,20,11,9
IL,nan,1999.0,12,6,6
ID,IR,2017.0,7,20,-13
SK,DK,2015.0,4,3,1
AR,TW,2006.0,5,9,-4
MX,FI,2017.0,2,7,-5
RU,RO,2001.0,1,1,0
NL,UY,2014.0,1,2,-1
IL,AR,2011.0,3,2,1
ES,EC,2009.0,20,17,3
IL,EG,2012.0,3,1,2
UA,BG,2018.0,9,5,4
ZW,NL,2012.0,3,1,2
NP,EG,2019.0,1,1,0
PT,TW,2013.0,1,1,0
LT,PL,2006.0,3,1,2
GR,CZ,2022.0,7,5,2
XK,MK,2021.0,4,4,0
EG,AT,2009.0,2,3,-1
GB,PA,2020.0,7,12,-5
PT,BE,2022.0,15,7,8
SA,DE,2020.0,27,32,-5
AU,QA,2017.0,13,11,2
PL,ID,2018.0,9,4,5
SV,US,2008.0,2,2,0
BG,SK,2021.0,2,1,1
KZ,AZ,2021.0,2,1,1
FR,FI,2000.0,10,12,-2
FR,TR,2006.0,10,16,-6
RU,ES,2006.0,8,7,1
ES,RS,2012.0,2,3,-1
SE,nan,2020.0,16,18,-2
JM,US,2015.0,17,20,-3
NL,AT,2018.0,39,48,-9
IR,SA,2016.0,11,9,2
AE,NO,2019.0,4,2,2
NO,PK,2021.0,8,4,4
CH,BR,2001.0,7,3,4
DK,HU,2008.0,4,2,2
EG,BE,2018.0,10,7,3
QA,PK,2012.0,1,3,-2
NE,BF,2018.0,2,2,0
VE,MX,2003.0,18,16,2
NI,CL,2005.0,2,1,1
LV,BE,2020.0,3,3,0
ET,AU,2014.0,6,3,3
ID,AU,2000.0,4,6,-2
CH,ID,2017.0,15,3,12
AT,DK,2005.0,6,5,1
RU,PK,2013.0,4,1,3
DK,SK,2004.0,4,1,3
JP,KH,2005.0,8,1,7
PL,IL,2017.0,7,5,2
KW,SA,2017.0,32,16,16
ES,CN,1998.0,9,16,-7
LB,DE,2009.0,1,1,0
NZ,SE,2008.0,7,9,-2
CO,SV,2020.0,5,3,2
PK,IT,2017.0,8,20,-12
ES,NL,1999.0,30,27,3
CM,US,2008.0,7,7,0
PL,GR,1997.0,3,2,1
UY,SE,2010.0,1,1,0
TZ,JP,2008.0,2,2,0
AU,ES,1999.0,8,7,1
GB,BB,2020.0,3,4,-1
TW,NL,2014.0,7,9,-2
NZ,IN,2002.0,5,9,-4
DE,MA,2013.0,8,3,5
ES,SG,2022.0,5,5,0
BO,SE,2014.0,2,1,1
MX,PA,2013.0,5,8,-3
VG,JP,2017.0,1,2,-1
HU,NO,2016.0,8,7,1
GA,FR,2006.0,7,5,2
GH,KE,2013.0,2,1,1
LT,DE,2010.0,5,6,-1
BE,DK,2000.0,3,7,-4
AZ,PL,2006.0,6,1,5
DE,BG,2004.0,10,21,-11
CA,LU,2018.0,7,9,-2
KW,GR,2011.0,3,2,1
KR,IR,2018.0,10,16,-6
DK,PL,2000.0,3,3,0
RU,SI,2014.0,3,1,2
IL,RO,2002.0,1,1,0
MY,ZA,2021.0,6,6,0
PE,CO,1999.0,8,6,2
GB,UG,2008.0,10,4,6
GE,CN,2018.0,4,4,0
MX,CA,1997.0,5,7,-2
IN,KW,2008.0,8,10,-2
nan,CO,2011.0,5,7,-2
RU,CL,2020.0,5,2,3
ES,FI,1998.0,2,2,0
MK,AU,2000.0,2,6,-4
BR,CO,2005.0,22,34,-12
SE,TR,2005.0,5,3,2
UY,SE,2019.0,9,1,8
BF,FR,2004.0,5,1,4
DK,SI,2019.0,2,5,-3
PA,VE,2011.0,2,2,0
MY,EG,2002.0,6,1,5
BE,VN,2014.0,17,6,11
MX,AT,2002.0,2,1,1
KH,NL,1999.0,4,4,0
AE,CY,2022.0,3,3,0
IT,MU,2005.0,1,1,0
AT,PL,2000.0,5,6,-1
GB,CR,2018.0,5,4,1
IN,AU,2023.0,12,4,8
AU,AT,2002.0,8,14,-6
KR,TH,2019.0,12,16,-4
CN,GE,2017.0,5,6,-1
EC,NL,2018.0,4,2,2
NL,CL,2021.0,5,13,-8
CL,nan,2012.0,5,7,-2
AU,ZA,1999.0,17,24,-7
BG,UA,1998.0,2,3,-1
KW,CA,2022.0,5,6,-1
MX,IL,2020.0,3,4,-1
MX,DO,2013.0,4,2,2
JP,KZ,2015.0,6,5,1
SA,CZ,2019.0,1,4,-3
IE,SI,2018.0,2,2,0
IR,MA,2019.0,10,6,4
VE,IT,2015.0,5,4,1
nan,BD,2011.0,2,2,0
CN,MX,2016.0,11,11,0
UG,SE,2013.0,4,4,0
BE,PS,2021.0,2,1,1
US,SY,2000.0,1,1,0
SY,AE,2021.0,2,2,0
AU,GH,2021.0,13,19,-6
PT,KR,2008.0,3,1,2
NL,UA,2012.0,5,9,-4
UG,DE,2004.0,2,1,1
nan,CZ,2013.0,6,8,-2
ZA,VN,2021.0,1,2,-1
NL,TR,2017.0,29,28,1
CM,IN,2019.0,4,3,1
GB,HK,2020.0,5,5,0
TH,NZ,2021.0,3,6,-3
CL,IN,2011.0,3,2,1
PE,CA,2014.0,4,9,-5
GB,MA,2018.0,13,8,5
TN,IR,2021.0,3,4,-1
IR,IL,2010.0,1,1,0
PY,PE,2017.0,2,4,-2
LT,DE,2017.0,6,9,-3
OM,KW,2001.0,1,1,0
SE,SA,2016.0,10,3,7
AF,US,2012.0,2,2,0
MW,GB,2001.0,2,5,-3
FR,GP,2001.0,9,7,2
SD,GB,2015.0,4,7,-3
MY,AU,1997.0,2,3,-1
KE,IT,1999.0,3,1,2
TH,IN,2018.0,14,28,-14
EC,PT,2016.0,3,11,-8
LU,BR,2015.0,4,3,1
ES,PY,2013.0,8,1,7
ZA,MA,2020.0,4,1,3
RO,VN,2016.0,5,5,0
IE,PL,2016.0,13,4,9
LT,CZ,2008.0,9,3,6
AT,MX,2000.0,4,2,2
CH,SK,2013.0,7,12,-5
AM,IT,2004.0,6,9,-3
ID,KE,2020.0,3,10,-7
DE,PA,2009.0,4,2,2
DK,IR,2013.0,9,14,-5
LI,DE,2009.0,5,5,0
RS,CN,2017.0,8,9,-1
MY,SE,2018.0,3,7,-4
MS,GB,2007.0,1,1,0
PE,nan,2004.0,2,1,1
NO,BG,2009.0,1,20,-19
CM,IN,2017.0,4,1,3
PL,IL,2019.0,11,14,-3
HU,CH,2007.0,12,6,6
GB,BG,2009.0,10,8,2
PK,NL,2005.0,5,1,4
CH,LI,2006.0,2,2,0
RU,IS,2018.0,3,2,1
HU,nan,2015.0,5,3,2
CU,AO,2019.0,3,1,2
KE,CO,2014.0,4,4,0
ZA,LS,2008.0,3,2,1
XK,US,2021.0,2,3,-1
EC,DE,2022.0,6,4,2
UZ,GB,2001.0,1,1,0
RU,MZ,2020.0,17,28,-11
PH,nan,1999.0,1,1,0
UA,RO,2022.0,1,8,-7
CH,SI,2009.0,4,6,-2
TW,NZ,2007.0,4,2,2
IR,SD,2018.0,3,2,1
AT,KE,2016.0,2,3,-1
JO,IN,2013.0,1,2,-1
YE,IQ,2018.0,2,2,0
KR,LV,2014.0,1,2,-1
FR,GF,1999.0,3,3,0
GB,BA,2013.0,2,4,-2
JO,GR,2005.0,5,4,1
QA,JP,2017.0,2,5,-3
SG,TR,2015.0,5,10,-5
BR,PY,2011.0,3,5,-2
US,PR,1997.0,2,7,-5
HU,BR,2021.0,4,4,0
FI,CZ,2003.0,3,2,1
BR,DO,2022.0,2,2,0
UY,VE,2006.0,1,1,0
MY,AU,1998.0,4,4,0
AU,IQ,2010.0,1,1,0
AU,AR,2016.0,9,15,-6
OM,JO,2016.0,3,3,0
ZA,CI,2016.0,2,1,1
NG,RU,2020.0,3,2,1
IT,UZ,2011.0,2,3,-1
SE,EE,2000.0,6,11,-5
CH,TR,2007.0,10,4,6
NL,MW,2020.0,1,1,0
TH,SG,2019.0,8,5,3
NO,ZA,2017.0,3,5,-2
MZ,RU,2008.0,1,41,-40
RU,TJ,2007.0,2,2,0
CM,IN,2010.0,1,1,0
IQ,IR,2013.0,1,1,0
ZA,CH,2008.0,13,6,7
AE,NZ,2021.0,1,4,-3
VN,MX,2004.0,1,2,-1
BR,TH,2011.0,5,1,4
MT,US,2018.0,5,10,-5
ID,CL,2016.0,7,14,-7
DZ,TN,2005.0,3,2,1
PE,GB,2009.0,11,1,10
PS,ID,2016.0,1,1,0
TW,DK,2012.0,4,1,3
LU,IT,2014.0,3,8,-5
BJ,TG,2008.0,2,1,1
CM,CI,2020.0,3,2,1
RU,BD,2016.0,1,1,0
TL,AU,2013.0,1,1,0
SV,ES,2015.0,4,10,-6
TW,NO,2014.0,2,1,1
US,BS,2016.0,8,2,6
EC,RU,2012.0,3,1,2
VN,NP,2020.0,1,1,0
NO,IT,2012.0,13,24,-11
IT,IL,2007.0,6,10,-4
ES,FI,1997.0,3,3,0
TH,FR,1999.0,1,1,0
TR,MD,2018.0,11,1,10
RU,AM,2003.0,4,8,-4
BN,IN,2017.0,1,4,-3
FI,AR,2020.0,2,4,-2
RO,AR,2018.0,1,1,0
AU,EC,2018.0,6,4,2
BN,BD,2016.0,1,3,-2
BR,SK,2018.0,3,2,1
EG,ZA,2016.0,4,6,-2
ES,IR,2003.0,1,1,0
DE,BF,1998.0,1,1,0
BH,GH,2015.0,3,8,-5
GB,NC,2016.0,2,1,1
AT,KR,2021.0,3,6,-3
AZ,US,2007.0,1,1,0
CN,CH,2023.0,13,5,8
RU,IE,2018.0,9,16,-7
MY,YE,2008.0,1,2,-1
BR,GH,2018.0,3,1,2
AU,ET,2017.0,8,15,-7
RS,BE,2011.0,3,6,-3
VE,CA,2010.0,5,6,-1
RO,NO,2022.0,3,2,1
RS,UZ,2007.0,1,1,0
IN,GH,2006.0,1,2,-1
UA,GE,2018.0,1,2,-1
GR,SG,2010.0,1,1,0
QA,NG,2021.0,2,4,-2
UA,IL,2020.0,5,4,1
KR,FI,2019.0,4,3,1
NL,RS,2003.0,1,3,-2
GE,CZ,1998.0,2,1,1
BW,NP,2021.0,1,1,0
ET,TW,2022.0,4,9,-5
GB,TN,2011.0,3,4,-1
TH,CH,2018.0,2,6,-4
ET,NL,2009.0,5,4,1
PK,IL,2019.0,2,2,0
HK,GB,2011.0,8,7,1
DO,ES,2022.0,3,6,-3
CL,CN,2021.0,2,3,-1
MY,NL,2009.0,2,4,-2
IN,UA,2022.0,2,3,-1
AE,CH,2022.0,1,5,-4
AT,DK,2002.0,3,2,1
DK,GH,2014.0,3,1,2
SJ,US,2017.0,1,5,-4
PL,ES,1997.0,4,6,-2
QA,SK,2016.0,1,1,0
CN,LT,2018.0,4,4,0
LY,US,2009.0,2,1,1
BE,SN,2012.0,2,3,-1
CO,AT,2013.0,2,4,-2
NL,CY,2013.0,3,1,2
AT,AE,2009.0,2,1,1
MX,FI,2010.0,2,3,-1
CR,AU,2007.0,1,1,0
MK,MY,2011.0,2,1,1
KE,CH,2006.0,2,2,0
US,UZ,2008.0,5,3,2
GH,nan,2008.0,1,1,0
TR,AU,2004.0,2,7,-5
CA,CU,2018.0,2,10,-8
MM,TH,2017.0,8,10,-2
RO,PT,2012.0,4,3,1
nan,BG,2010.0,3,3,0
AT,MY,2021.0,1,2,-1
NG,SD,2011.0,1,1,0
GT,GB,2012.0,1,1,0
NP,MY,2011.0,2,2,0
SK,FI,2003.0,5,3,2
nan,TW,2019.0,3,5,-2
SE,VN,2015.0,5,1,4
BG,RS,1997.0,1,1,0
SN,ZA,2009.0,2,1,1
BG,GR,2017.0,4,2,2
IN,EE,2007.0,2,2,0
SD,BR,2010.0,3,6,-3
TW,ET,2019.0,8,5,3
PH,CL,2009.0,1,5,-4
ZA,VE,2006.0,1,1,0
ZM,MW,2020.0,3,2,1
UG,IN,2021.0,1,6,-5
RS,UA,2011.0,1,2,-1
ML,IN,2002.0,2,2,0
PK,BE,2021.0,6,4,2
IE,BG,2015.0,2,1,1
BD,SE,2016.0,4,3,1
NL,HR,2004.0,1,1,0
RU,BE,2022.0,11,10,1
HU,BE,2020.0,7,11,-4
GB,AL,2018.0,1,1,0
BG,SE,2014.0,1,4,-3
CA,JM,2020.0,4,5,-1
BW,NG,2021.0,1,2,-1
BE,CM,2020.0,7,6,1
SK,ES,2007.0,4,1,3
AU,OM,2007.0,1,4,-3
NC,FR,2002.0,4,5,-1
ZW,AU,2009.0,2,1,1
RO,BD,2012.0,1,2,-1
PG,TH,2018.0,1,1,0
AE,GB,1999.0,6,8,-2
AU,JM,2020.0,2,1,1
ML,DE,2016.0,2,1,1
CZ,nan,2020.0,2,5,-3
QA,JP,2019.0,2,4,-2
AE,IN,2023.0,5,4,1
NI,MX,2020.0,7,4,3
MX,RS,2014.0,6,2,4
BG,UA,1997.0,1,3,-2
EE,CZ,2017.0,2,1,1
ID,KR,2012.0,5,17,-12
IQ,ID,2015.0,2,2,0
ID,CH,2014.0,7,1,6
DZ,SG,2021.0,3,1,2
ME,IT,2020.0,2,1,1
VN,CO,2020.0,1,1,0
CO,IE,2009.0,1,2,-1
US,BF,2020.0,2,3,-1
ZA,CN,2003.0,4,2,2
UA,CH,2009.0,2,2,0
DZ,MN,2017.0,2,6,-4
MN,RU,2017.0,2,5,-3
NL,CO,2004.0,1,1,0
NO,GR,1998.0,3,2,1
VN,PH,2011.0,1,1,0
GR,AR,2018.0,1,1,0
CA,LV,2018.0,1,2,-1
NA,ZA,2010.0,3,4,-1
JP,PE,2014.0,2,2,0
JP,MM,2007.0,5,3,2
KR,TR,2000.0,2,1,1
EC,FR,2001.0,2,2,0
AE,SA,2007.0,3,8,-5
BH,SA,2006.0,3,4,-1
BH,TN,2016.0,1,2,-1
BH,NG,2005.0,6,1,5
JP,LY,2007.0,1,2,-1
KR,TH,2010.0,4,8,-4
IR,MA,2010.0,2,1,1
TR,SE,2005.0,3,5,-2
BG,IL,2000.0,2,3,-1
EC,NI,2021.0,1,2,-1
CR,BO,2015.0,2,1,1
PY,PT,2016.0,2,4,-2
CZ,XK,2020.0,3,2,1
MY,CZ,2022.0,4,3,1
nan,TW,2017.0,1,5,-4
DK,LK,2016.0,2,1,1
LK,ID,2012.0,3,6,-3
CH,CY,2019.0,3,1,2
LB,IL,2019.0,3,3,0
PL,EG,2005.0,2,2,0
SN,CA,2022.0,2,2,0
MD,RU,2012.0,4,5,-1
EE,GB,2006.0,4,3,1
TR,LY,2022.0,2,1,1
RS,RU,2004.0,2,2,0
SG,CO,2017.0,1,2,-1
ID,AZ,2004.0,1,1,0
MK,CN,1998.0,2,1,1
GR,VN,2008.0,7,5,2
BG,MK,2016.0,5,8,-3
OM,QA,2008.0,1,1,0
CH,CM,2021.0,3,5,-2
HR,JP,2007.0,4,1,3
PS,TR,2008.0,1,3,-2
KR,ZA,2004.0,1,1,0
SE,LU,2021.0,5,3,2
LT,US,2000.0,2,2,0
MR,ML,2020.0,1,1,0
PS,AE,2003.0,2,1,1
KP,CN,2019.0,4,19,-15
IE,MX,2002.0,1,1,0
CY,US,2005.0,2,24,-22
LB,SY,2018.0,1,3,-2
KE,NG,2002.0,3,2,1
RO,RS,2016.0,1,2,-1
ES,TZ,2016.0,1,1,0
KE,ES,2017.0,1,3,-2
GB,KZ,2021.0,5,10,-5
VE,nan,2011.0,1,2,-1
CL,NI,2007.0,2,1,1
PE,NI,2013.0,1,1,0
IL,SK,2000.0,1,1,0
CO,AU,2007.0,4,1,3
IN,PA,2020.0,3,2,1
MA,CH,2007.0,4,3,1
IR,IS,2019.0,1,3,-2
SK,BE,2008.0,2,1,1
KH,IN,2016.0,1,1,0
MC,GB,2018.0,1,2,-1
LT,HU,2001.0,1,4,-3
NO,ZA,2019.0,3,9,-6
IQ,NL,2020.0,1,4,-3
PH,PK,2017.0,2,2,0
nan,SG,2007.0,2,8,-6
GH,CA,2001.0,1,1,0
FI,IL,2011.0,1,2,-1
BE,TN,2002.0,1,2,-1
QA,GR,2011.0,1,1,0
NP,TR,2018.0,1,3,-2
BR,KE,2017.0,3,2,1
GR,MX,2009.0,8,4,4
ZA,JP,2011.0,4,12,-8
HK,BR,2017.0,1,1,0
EG,TR,2007.0,3,1,2
PY,PE,2019.0,3,2,1
AM,ID,2020.0,2,4,-2
SI,JP,2015.0,6,1,5
CZ,SE,2001.0,2,4,-2
CN,GE,2010.0,2,3,-1
EE,IN,2013.0,1,4,-3
MZ,ES,2003.0,2,1,1
DK,RO,2004.0,2,2,0
DZ,LU,2017.0,2,2,0
SN,CI,2018.0,1,1,0
AE,BH,2015.0,1,2,-1
PA,CL,2015.0,2,3,-1
CH,CN,2023.0,5,13,-8
SE,MY,2015.0,5,7,-2
FI,PK,2013.0,2,3,-1
RU,CR,2003.0,1,1,0
FI,PL,2009.0,1,10,-9
AM,DE,2013.0,3,5,-2
BH,NG,2002.0,2,2,0
IT,UY,2005.0,2,4,-2
QA,IS,2018.0,1,1,0
UG,ES,2007.0,1,1,0
NP,NZ,2002.0,4,2,2
HK,BR,2019.0,1,2,-1
NE,US,2017.0,2,3,-1
UA,AU,2013.0,2,1,1
BR,KE,2019.0,2,1,1
UZ,IT,2008.0,1,1,0
SI,QA,2014.0,2,2,0
QA,OM,2021.0,2,4,-2
JO,ES,2022.0,1,1,0
MA,JP,2016.0,2,2,0
FR,SS,2015.0,1,1,0
US,GA,2013.0,1,2,-1
IE,BD,2020.0,1,2,-1
PL,PT,2018.0,1,5,-4
GA,DE,2007.0,1,8,-7
GN,US,2020.0,1,4,-3
HN,CU,2014.0,1,1,0
NL,HK,2004.0,3,3,0
IN,SG,2014.0,110,108,2
TW,FR,2015.0,14,6,8
GB,MY,2010.0,145,46,99
AR,BR,2006.0,70,95,-25
CN,AU,2000.0,83,95,-12
US,AU,2001.0,1178,1211,-33
MX,ES,2015.0,827,935,-108
US,PL,2011.0,210,183,27
US,PK,2018.0,362,384,-22
US,NO,1999.0,67,63,4
BR,DE,2011.0,167,196,-29
CA,NZ,2020.0,81,74,7
IN,CA,2012.0,178,190,-12
VN,TH,2012.0,3,3,0
US,HU,1997.0,65,71,-6
KR,ET,2020.0,86,100,-14
FR,LB,2009.0,49,21,28
NZ,US,2020.0,407,408,-1
EG,SA,2017.0,383,408,-25
CN,FI,1999.0,4,7,-3
GB,NL,2012.0,258,273,-15
ID,ZA,2020.0,213,160,53
CW,US,2015.0,2,2,0
BR,ST,2018.0,28,32,-4
US,AE,2020.0,103,83,20
GB,DK,2014.0,151,121,30
US,AT,2018.0,251,273,-22
CN,CA,2000.0,131,182,-51
nan,NO,2021.0,16,12,4
US,BN,2012.0,3,1,2
AU,ID,2016.0,92,56,36
AU,IQ,2017.0,16,5,11
EG,JP,2010.0,50,70,-20
EG,SA,2019.0,450,452,-2
US,EG,2001.0,62,72,-10
DZ,FR,2016.0,106,187,-81
NL,GB,1998.0,107,98,9
BR,AU,2005.0,34,21,13
PS,ES,2019.0,15,17,-2
EC,AR,2019.0,45,57,-12
BE,nan,2019.0,20,17,3
US,DZ,2014.0,40,35,5
BF,BE,2019.0,5,4,1
NL,ES,2013.0,81,96,-15
NG,ZA,2017.0,125,88,37
CL,DE,2010.0,42,36,6
FR,QA,2020.0,12,6,6
IR,FR,2020.0,51,41,10
nan,ID,2008.0,2,2,0
TW,IN,2015.0,54,56,-2
CO,PE,2020.0,107,83,24
FI,JP,2013.0,12,17,-5
TN,IT,2008.0,4,5,-1
IT,NZ,2011.0,8,3,5
BF,BE,2017.0,4,2,2
ET,US,2015.0,28,46,-18
GB,PL,2011.0,71,90,-19
TT,NG,2018.0,1,1,0
CY,TR,2020.0,63,74,-11
HK,CA,2012.0,4,1,3
ZA,AU,2007.0,34,30,4
ID,NG,2018.0,11,22,-11
EC,AR,2010.0,12,2,10
AU,TW,2010.0,33,30,3
MY,OM,2020.0,13,7,6
ZM,US,2004.0,4,4,0
GR,JP,2021.0,17,16,1
NL,IL,2002.0,8,14,-6
BE,GR,2012.0,19,29,-10
PH,CA,2010.0,10,5,5
MX,PE,2006.0,30,22,8
FR,MQ,2007.0,10,6,4
FR,TH,2015.0,16,13,3
US,TN,2018.0,32,18,14
CA,BG,2018.0,6,2,4
IL,CO,2019.0,3,7,-4
PL,DK,2022.0,12,6,6
CL,CH,2019.0,12,13,-1
UY,FR,2020.0,3,4,-1
GE,ES,2019.0,2,2,0
VN,SE,2007.0,2,1,1
QA,SA,2012.0,10,7,3
PH,JP,2013.0,20,37,-17
LT,JP,2020.0,2,8,-6
PT,GB,2003.0,22,47,-25
SJ,GB,2017.0,2,1,1
CL,EC,2005.0,3,5,-2
ES,DZ,2007.0,1,3,-2
SG,IT,2016.0,14,12,2
FR,RS,2003.0,2,1,1
GF,FR,2020.0,17,35,-18
HU,DK,2015.0,6,2,4
DK,SI,2010.0,3,4,-1
PE,MX,2009.0,36,40,-4
ZW,US,2000.0,5,5,0
RS,HU,2015.0,6,6,0
JP,GH,2013.0,3,4,-1
VN,CN,1998.0,4,4,0
HU,CN,2008.0,5,2,3
FI,CO,2015.0,2,1,1
LV,FI,2021.0,1,2,-1
QA,NL,2022.0,5,1,4
TW,ET,2017.0,3,3,0
AU,BA,2012.0,2,1,1
IN,SY,2010.0,2,2,0
CZ,BE,1997.0,5,4,1
KW,QA,2015.0,3,1,2
BR,AU,2002.0,23,21,2
TR,RS,1998.0,17,7,10
FR,BJ,2001.0,7,3,4
NZ,BR,2008.0,3,4,-1
HU,TR,2015.0,8,1,7
DE,CM,2011.0,8,3,5
SE,TR,2002.0,5,4,1
AT,nan,2012.0,16,9,7
CR,GB,2021.0,4,2,2
CA,AE,2021.0,21,22,-1
ID,ES,2014.0,8,10,-2
AT,RO,2021.0,8,6,2
RO,GB,1998.0,5,6,-1
MX,ZA,2008.0,3,1,2
IN,SK,2009.0,1,1,0
AM,JP,2003.0,4,5,-1
EG,AZ,2010.0,1,1,0
US,PA,2012.0,44,44,0
FR,KR,1998.0,2,8,-6
DZ,MN,2010.0,1,1,0
PL,FI,2009.0,10,1,9
AT,ZA,2018.0,7,7,0
SA,CA,2023.0,4,3,1
CG,FR,2012.0,15,21,-6
FI,IS,2020.0,2,1,1
BE,GF,2019.0,1,1,0
BB,JM,2005.0,3,2,1
ES,LK,2012.0,6,5,1
JP,BE,1998.0,8,13,-5
SD,YE,2012.0,1,1,0
SR,NL,2022.0,1,1,0
IL,CO,2017.0,4,7,-3
SE,AR,2004.0,4,2,2
MA,CA,2000.0,5,6,-1
MX,JP,2009.0,11,6,5
AU,BE,1998.0,11,14,-3
MX,CN,2001.0,2,4,-2
NG,DE,2022.0,10,9,1
SE,AE,2008.0,3,2,1
RO,GR,2000.0,3,1,2
MX,CA,1998.0,10,10,0
KW,SA,2010.0,10,9,1
MW,DK,2001.0,1,1,0
ML,BJ,2018.0,1,1,0
LU,NL,2009.0,2,6,-4
BO,US,2012.0,9,3,6
RU,RS,1999.0,2,2,0
AU,RU,2003.0,8,14,-6
PK,ES,2021.0,4,5,-1
EE,FI,2004.0,5,13,-8
IR,MA,2017.0,5,5,0
PK,IT,2010.0,7,2,5
CA,RW,2014.0,1,1,0
ID,TN,2012.0,1,1,0
GH,KR,2018.0,4,3,1
SE,KR,2007.0,2,5,-3
GP,FR,2000.0,4,7,-3
HU,RO,2023.0,3,4,-1
AU,UG,2009.0,2,2,0
TH,CA,2012.0,9,25,-16
PT,SK,2008.0,2,1,1
NL,IL,2005.0,7,18,-11
AU,GR,2014.0,9,20,-11
IR,IL,2017.0,1,2,-1
IL,KR,2009.0,2,4,-2
AU,SA,2002.0,5,3,2
CO,LU,2018.0,1,1,0
UZ,ID,2017.0,4,1,3
BW,CA,2020.0,1,2,-1
DE,YE,2020.0,2,3,-1
ES,ET,2012.0,1,2,-1
KZ,EG,2010.0,1,1,0
KR,AM,2020.0,3,2,1
VN,HU,2021.0,2,2,0
TW,PK,2022.0,4,7,-3
CN,LU,2000.0,2,1,1
IS,ES,2009.0,2,2,0
CU,GB,2016.0,5,1,4
IN,ET,2009.0,1,2,-1
SA,SE,2005.0,1,1,0
JP,KH,2002.0,3,6,-3
FR,GE,2019.0,1,2,-1
CA,BH,2005.0,1,1,0
ID,IR,2010.0,1,2,-1
CN,VG,2012.0,1,3,-2
BR,HK,2018.0,1,1,0
NO,AR,2020.0,2,5,-3
FR,PA,2015.0,2,1,1
LU,FI,2001.0,1,3,-2
FR,GE,2010.0,1,1,0
IE,NZ,1998.0,1,3,-2
NG,ZA,2019.0,157,103,54
NZ,CN,2015.0,45,43,2
IL,BR,2011.0,8,5,3
RU,nan,2022.0,21,15,6
BE,CN,2020.0,59,61,-2
JP,FI,2005.0,17,19,-2
NL,NZ,2020.0,18,13,5
AU,NO,2004.0,11,5,6
FR,UY,2020.0,4,3,1
EE,BY,2012.0,1,1,0
AT,RU,2014.0,16,19,-3
FR,BI,2008.0,19,21,-2
CZ,TW,2014.0,2,1,1
SA,TW,2006.0,1,1,0
ET,EG,2013.0,1,4,-3
AT,CH,1998.0,46,42,4
,US,1994.0,273335,0,273335
ES,,2019.0,13879,0,13879
IT,,2017.0,8805,0,8805
SD,NG,2018.0,8,0,8
,IN,2015.0,26099,0,26099
,CN,2008.0,51134,0,51134
BE,,2024.0,20110,0,20110
US,,2008.0,35146,0,35146
,ES,2008.0,13474,0,13474
LB,,2024.0,2268,0,2268
IT,,2010.0,4793,0,4793
IL,,2023.0,10860,0,10860
ES,,2017.0,10800,0,10800
,SG,1996.0,816,0,816
,TR,2011.0,7255,0,7255
HK,,2018.0,50,0,50
,TW,1998.0,3711,0,3711
,IR,2006.0,6976,0,6976
,TW,1997.0,3465,0,3465
CA,,2020.0,12264,0,12264
IT,,2019.0,11344,0,11344
,FR,2006.0,15130,0,15130
SA,,2024.0,15636,0,15636
RU,,2006.0,3064,0,3064
NZ,,2014.0,667,0,667
,CL,1998.0,1135,0,1135
,SA,2010.0,1390,0,1390
ES,,2010.0,4556,0,4556
IR,,2012.0,1288,0,1288
PT,,2018.0,1413,0,1413
AU,,2022.0,13923,0,13923
TW,,2005.0,781,0,781
,PS,2000.0,33,0,33
,SG,2004.0,1179,0,1179
NL,,2021.0,8791,0,8791
OM,,2023.0,851,0,851
,CR,1997.0,71,0,71
,PK,2001.0,467,0,467
,DK,1998.0,1376,0,1376
,OM,1999.0,85,0,85
PK,,2012.0,224,0,224
,DK,1997.0,1408,0,1408
CH,,2000.0,908,0,908
,CL,1997.0,922,0,922
,ID,2003.0,1031,0,1031
,IL,2003.0,2271,0,2271
ZA,,2014.0,921,0,921
,NO,2000.0,1203,0,1203
,CZ,2000.0,1210,0,1210
,BG,2016.0,526,0,526
,RO,2004.0,967,0,967
,SY,1994.0,63,0,63
MA,,2001.0,53,0,53
CL,,2002.0,103,0,103
PA,UY,2001.0,1,0,1
ID,,2013.0,214,0,214
MX,,2002.0,303,0,303
,IQ,2012.0,561,0,561
,CR,1998.0,108,0,108
KR,,2001.0,291,0,291
,KE,2011.0,563,0,563
UA,,2000.0,211,0,211
,VN,1995.0,89,0,89
,RU,2018.0,17380,0,17380
,GH,2013.0,507,0,507
CA,NP,2011.0,1,0,1
SN,,2021.0,189,0,189
,PE,2015.0,1019,0,1019
CO,,2009.0,245,0,245
,FI,2015.0,1794,0,1794
AE,,2011.0,59,0,59
BJ,,2023.0,532,0,532
MX,,2005.0,480,0,480
,BA,2014.0,258,0,258
ME,PT,2019.0,1,0,1
,CU,2000.0,353,0,353
,SI,2010.0,613,0,613
,EE,2010.0,393,0,393
SZ,BE,2002.0,1,0,1
CZ,,2009.0,626,0,626
PH,ZW,2014.0,3,0,3
CN,GH,2002.0,1,0,1
,BW,2012.0,93,0,93
VN,,2012.0,56,0,56
LT,,2006.0,83,0,83
,RO,1996.0,565,0,565
MG,,2021.0,77,0,77
CL,,2005.0,197,0,197
,SA,2017.0,2723,0,2723
TW,CM,2019.0,2,0,2
,MZ,2020.0,2,0,2
,TN,1994.0,274,0,274
MW,,2021.0,100,0,100
,CW,2011.0,11,0,11
,LB,2018.0,580,0,580
MD,,2011.0,43,0,43
AO,,2015.0,8,0,8
,MN,2000.0,19,0,19
IE,LY,2019.0,2,0,2
,SA,2019.0,2054,0,2054
SD,JO,2016.0,2,0,2
,MA,1994.0,411,0,411
,EE,2019.0,137,0,137
AL,DE,1998.0,1,0,1
,NP,1995.0,42,0,42
MM,ID,2020.0,3,0,3
JO,,2011.0,78,0,78
PT,BR,2024.0,7,0,7
KW,,2018.0,142,0,142
,YE,2008.0,43,0,43
PR,,2023.0,40,0,40
RS,,2000.0,31,0,31
,SI,2017.0,456,0,456
KW,PS,2016.0,1,0,1
,MQ,2015.0,21,0,21
,EE,2017.0,237,0,237
TZ,,2025.0,69,0,69
ZW,BH,2013.0,1,0,1
UZ,,2025.0,25,0,25
PE,NO,2021.0,1,0,1
MR,,2020.0,9,0,9
EC,,2013.0,44,0,44
HR,QA,2019.0,3,0,3
RE,,2023.0,155,0,155
,CD,2007.0,29,0,29
,SI,2019.0,251,0,251
ES,UG,2021.0,7,0,7
EE,HU,2020.0,1,0,1
CA,ZM,2018.0,1,0,1
MC,,2023.0,52,0,52
GM,CN,2020.0,1,0,1
,BO,2013.0,61,0,61
BA,IT,2021.0,2,0,2
NO,LT,2023.0,1,0,1
TW,,2002.0,568,0,568
GT,VE,2018.0,2,0,2
,RS,1995.0,545,0,545
,PH,2020.0,32,0,32
,HR,2018.0,627,0,627
AU,KW,2006.0,2,0,2
BD,FR,1998.0,1,0,1
MQ,,2018.0,24,0,24
GD,ZA,2018.0,1,0,1
BG,,2008.0,170,0,170
LU,IN,2015.0,2,0,2
LY,,2013.0,22,0,22
BD,,2003.0,16,0,16
CH,ZW,2014.0,1,0,1
TT,,2002.0,12,0,12
PH,UY,2004.0,1,0,1
KN,,2018.0,7,0,7
,MW,2012.0,96,0,96
QA,CZ,2004.0,1,0,1
KH,,2015.0,22,0,22
HU,IL,2011.0,5,0,5
,US,2021.0,25,0,25
,ME,2014.0,32,0,32
AZ,FR,2021.0,1,0,1
HN,SV,2012.0,2,0,2
,AO,2014.0,11,0,11
LK,NO,2022.0,3,0,3
UG,NA,2018.0,1,0,1
KE,IR,2021.0,1,0,1
HU,UA,2016.0,4,0,4
HR,FI,2001.0,1,0,1
,AL,1996.0,13,0,13
IT,BD,2006.0,1,0,1
SR,,2018.0,12,0,12
UG,,2007.0,17,0,17
TO,,2019.0,1,0,1
NL,AE,2002.0,3,0,3
SK,TR,2011.0,2,0,2
RU,TM,2007.0,1,0,1
PH,PL,2005.0,2,0,2
MX,DZ,2012.0,3,0,3
GB,BW,2001.0,5,0,5
TZ,NL,2007.0,3,0,3
OM,TR,2020.0,2,0,2
CH,CI,2008.0,2,0,2
QA,FI,2018.0,2,0,2
AR,AO,2015.0,4,0,4
ZA,LK,2009.0,2,0,2
BR,SM,2013.0,1,0,1
GR,IL,2005.0,8,0,8
IL,HR,2010.0,1,0,1
BD,KE,2004.0,1,0,1
PH,TT,2015.0,1,0,1
FR,KR,1997.0,6,0,6
FJ,NZ,2011.0,1,0,1
NG,NO,2011.0,1,0,1
IS,CH,2013.0,2,0,2
nan,LK,2007.0,1,0,1
MT,JP,2001.0,1,0,1
HK,ZA,2019.0,1,0,1
TN,BR,2014.0,2,0,2
BH,,1999.0,3,0,3
GR,HR,2009.0,1,0,1
AR,IE,2006.0,2,0,2
CO,LK,2018.0,1,0,1
BI,CI,2021.0,1,0,1
TH,AT,2001.0,1,0,1
,MC,2017.0,9,0,9
SJ,GB,2019.0,3,0,3
CO,MM,2018.0,1,0,1
HR,PL,2005.0,3,0,3
BN,,2007.0,3,0,3
HK,EE,2001.0,1,0,1
CY,IR,2012.0,4,0,4
MA,DZ,2008.0,15,0,15
AU,LU,2011.0,3,0,3
SI,CL,2014.0,1,0,1
IQ,LY,2015.0,1,0,1
SY,NL,2010.0,2,0,2
AR,UA,2020.0,1,0,1
MZ,,2004.0,6,0,6
SK,MX,2001.0,1,0,1
NL,ET,2007.0,5,0,5
,SZ,2002.0,7,0,7
HR,GR,2008.0,1,0,1
IE,PH,2014.0,1,0,1
TG,CN,2018.0,1,0,1
CW,,2004.0,6,0,6
LK,BE,1999.0,1,0,1
PK,QA,2010.0,1,0,1
AE,PL,2022.0,5,0,5
HU,SG,2013.0,2,0,2
ZA,PG,2010.0,5,0,5
PT,LT,2016.0,1,0,1
FI,TH,2007.0,1,0,1
MX,GR,2004.0,1,0,1
VG,,2014.0,20,0,20
EG,ES,2000.0,4,0,4
AR,PH,2002.0,1,0,1
MZ,IS,2005.0,2,0,2
TR,RO,2021.0,4,0,4
ML,SE,2011.0,2,0,2
BB,,2007.0,2,0,2
DE,CW,2003.0,3,0,3
QA,PS,2012.0,2,0,2
NC,,2006.0,3,0,3
,AL,2004.0,19,0,19
RU,HK,2009.0,1,0,1
TG,CR,2014.0,1,0,1
VE,JP,1999.0,5,0,5
IS,NL,2009.0,3,0,3
HN,SE,2011.0,1,0,1
LU,CN,2006.0,2,0,2
LV,LT,2005.0,1,0,1
BN,LK,2021.0,1,0,1
US,TG,2012.0,2,0,2
KE,BD,2003.0,1,0,1
AU,ET,2010.0,1,0,1
JM,IN,2021.0,1,0,1
ZA,AO,2020.0,1,0,1
EE,CZ,2019.0,3,0,3
CH,SG,2000.0,5,0,5
US,YE,2022.0,1,0,1
SD,BR,2019.0,2,0,2
KW,ID,2006.0,1,0,1
BF,,2003.0,4,0,4
FO,,2018.0,3,0,3
TN,MN,2017.0,1,0,1
AE,NO,2017.0,2,0,2
JO,nan,2015.0,6,0,6
RW,BW,2021.0,1,0,1
BH,CM,2021.0,1,0,1
nan,LT,2007.0,1,0,1
,ER,2003.0,9,0,9
IN,MU,2012.0,1,0,1
BR,SN,2012.0,1,0,1
FR,SG,1999.0,3,0,3
,SZ,2005.0,3,0,3
CY,EE,2014.0,1,0,1
nan,BG,2019.0,1,0,1
MK,,2012.0,20,0,20
,MC,2010.0,4,0,4
CV,PK,1997.0,1,0,1
DE,OM,2014.0,4,0,4
MA,SN,2014.0,2,0,2
IN,GE,2011.0,1,0,1
PY,CU,2011.0,6,0,6
RU,KP,2018.0,1,0,1
TZ,AU,2001.0,1,0,1
MX,SA,2009.0,1,0,1
KE,PR,2017.0,1,0,1
EG,CU,2014.0,1,0,1
FI,RO,2005.0,1,0,1
PE,AT,2007.0,1,0,1
CL,EE,2018.0,2,0,2
VN,MM,2021.0,1,0,1
OM,NP,2021.0,1,0,1
BE,MZ,2004.0,1,0,1
RS,MK,1998.0,1,0,1
GM,FR,2012.0,1,0,1
PK,IL,2017.0,1,0,1
AR,FI,2000.0,2,0,2
LB,KW,2016.0,4,0,4
JP,PT,2001.0,3,0,3
CA,CY,2009.0,2,0,2
PE,CU,2004.0,1,0,1
BO,CZ,2019.0,1,0,1
BY,SI,2018.0,2,0,2
CZ,EC,2019.0,2,0,2
FR,ZW,2009.0,3,0,3
KP,,2025.0,5,0,5
CN,OM,2013.0,3,0,3
KZ,RS,2016.0,1,0,1
TT,,2005.0,5,0,5
MD,DZ,2011.0,6,0,6
GP,VN,2006.0,1,0,1
VG,QA,2019.0,1,0,1
RE,CH,2021.0,1,0,1
SD,TZ,2020.0,2,0,2
CY,BE,2013.0,1,0,1
nan,AM,2019.0,1,0,1
MX,LU,2015.0,1,0,1
NL,LV,1999.0,1,0,1
SJ,DK,2005.0,1,0,1
SE,PG,2018.0,1,0,1
IT,ET,2002.0,3,0,3
PK,NL,2002.0,2,0,2
EG,SY,2008.0,2,0,2
TH,TW,2003.0,2,0,2
DK,EC,2020.0,1,0,1
LR,NG,2018.0,2,0,2
SA,OM,1999.0,2,0,2
FR,YE,2014.0,1,0,1
nan,HR,2021.0,1,0,1
CH,CY,2017.0,4,0,4
CH,VE,2000.0,1,0,1
AR,PL,2013.0,2,0,2
ES,SV,1999.0,2,0,2
DO,MX,2006.0,2,0,2
MX,SN,2021.0,1,0,1
,GQ,2011.0,1,0,1
OM,VN,2021.0,1,0,1
CZ,TH,2014.0,1,0,1
JP,IS,2009.0,1,0,1
CY,UA,2014.0,1,0,1
FR,SD,2015.0,4,0,4
VN,GR,2014.0,6,0,6
LK,NP,2014.0,1,0,1
IE,CL,2018.0,2,0,2
SK,nan,2018.0,4,0,4
ID,MD,2020.0,2,0,2
PA,CA,2004.0,3,0,3
ZA,GH,2000.0,1,0,1
XK,DK,2013.0,1,0,1
KH,NZ,2019.0,1,0,1
AU,MM,2008.0,1,0,1
SG,MA,2002.0,1,0,1
IT,CU,1998.0,2,0,2
DE,BH,2016.0,1,0,1
NP,NL,2004.0,2,0,2
BO,AR,2001.0,1,0,1
NO,GR,1997.0,3,0,3
MW,TW,2008.0,1,0,1
nan,PH,2001.0,1,0,1
BJ,BR,2012.0,2,0,2
MT,TW,2010.0,1,0,1
CA,LB,1998.0,2,0,2
IL,AT,2000.0,4,0,4
PL,EG,2002.0,3,0,3
CZ,EC,2017.0,2,0,2
BE,ML,2018.0,1,0,1
NL,MA,2009.0,1,0,1
CG,BE,2013.0,1,0,1
ZW,EG,2022.0,1,0,1
SE,SJ,2012.0,1,0,1
NO,ZM,2018.0,4,0,4
SV,GT,2021.0,2,0,2
BE,IS,2008.0,1,0,1
LK,AE,2022.0,1,0,1
BF,ZA,2013.0,1,0,1
SI,LV,2002.0,1,0,1
MW,CH,1997.0,1,0,1
RE,BE,2022.0,1,0,1
PH,LK,2021.0,4,0,4
AL,,1999.0,6,0,6
HR,RU,2004.0,1,0,1
SL,,2011.0,1,0,1
TO,,2017.0,2,0,2
SE,TN,2016.0,1,0,1
NL,SZ,2020.0,1,0,1
SD,IE,2021.0,1,0,1
GF,CH,2000.0,1,0,1
US,GY,2018.0,3,0,3
GB,TT,2011.0,8,0,8
NE,MD,2009.0,1,0,1
GB,IS,2002.0,5,0,5
QA,HU,2008.0,1,0,1
HT,PK,2021.0,1,0,1
BE,AE,2008.0,1,0,1
UA,KG,2020.0,3,0,3
CY,NZ,2018.0,3,0,3
AE,GE,2019.0,1,0,1
PS,AR,2012.0,1,0,1
GE,IT,1999.0,2,0,2
PT,AE,2019.0,2,0,2
CO,RO,2012.0,1,0,1
KR,BG,2011.0,1,0,1
DZ,CH,2007.0,2,0,2
CU,DO,2000.0,1,0,1
UZ,TJ,2015.0,3,0,3
,SO,2009.0,1,0,1
CZ,OM,2021.0,1,0,1
CH,ME,2020.0,1,0,1
AU,MA,2010.0,1,0,1
HK,ES,2010.0,2,0,2
AZ,UZ,2013.0,2,0,2
PK,VN,2016.0,2,0,2
SD,MW,2003.0,1,0,1
KE,MX,2008.0,1,0,1
SE,MQ,2017.0,1,0,1
NG,BR,2008.0,2,0,2
IT,GP,2013.0,1,0,1
AE,JP,1998.0,1,0,1
CO,SG,2011.0,1,0,1
EG,MD,2010.0,1,0,1
RU,NG,2014.0,2,0,2
IT,VG,2002.0,1,0,1
ST,GW,2002.0,1,0,1
IN,MM,2012.0,1,0,1
AZ,NO,2020.0,1,0,1
BF,TR,2019.0,1,0,1
CM,GR,2006.0,1,0,1
KZ,DE,2007.0,2,0,2
FJ,PT,2014.0,1,0,1
PG,GB,2014.0,1,0,1
TZ,HU,2021.0,1,0,1
IN,ZA,1999.0,3,0,3
ST,EC,2015.0,1,0,1
BY,BR,2019.0,1,0,1
UG,CO,1998.0,1,0,1
TW,JM,2008.0,1,0,1
MX,TH,2000.0,1,0,1
,SR,2015.0,10,0,10
GE,KE,2001.0,1,0,1
SD,AU,2010.0,1,0,1
FJ,TO,2021.0,1,0,1
CO,SI,2023.0,1,0,1
CY,LT,2022.0,1,0,1
GM,BD,2018.0,1,0,1
ID,NI,2017.0,1,0,1
TH,AM,2020.0,1,0,1
CZ,CM,2021.0,1,0,1
SD,AU,2019.0,3,0,3
GB,FJ,2012.0,1,0,1
RE,DE,2006.0,1,0,1
NE,SD,2017.0,1,0,1
BE,NZ,2009.0,3,0,3
ZA,PE,2022.0,1,0,1
SY,MY,2017.0,2,0,2
CR,PL,2021.0,1,0,1
GB,MC,2009.0,2,0,2
EE,DK,2001.0,1,0,1
ZM,CL,2020.0,1,0,1
LS,NG,2015.0,2,0,2
GF,KH,1999.0,1,0,1
IE,KE,2009.0,1,0,1
PA,MA,2017.0,1,0,1
WS,AU,2022.0,1,0,1
TW,MX,2013.0,2,0,2
TW,GE,2012.0,1,0,1
BB,JM,2002.0,1,0,1
CR,MQ,2006.0,1,0,1
ET,GH,2006.0,1,0,1
,DJ,2006.0,1,0,1
IL,PK,2009.0,2,0,2
NP,EG,2010.0,1,0,1
GE,HK,2015.0,1,0,1
PT,CV,2014.0,2,0,2
AU,CY,1998.0,1,0,1
DE,CR,1998.0,2,0,2
LT,TW,2018.0,2,0,2
DE,HK,2004.0,2,0,2
MG,LU,2020.0,1,0,1
GR,ZM,2015.0,1,0,1
CV,,2016.0,1,0,1
GR,LS,2005.0,1,0,1
SA,QA,2005.0,4,0,4
UA,GR,2011.0,1,0,1
CD,TH,2013.0,1,0,1
SD,IT,2017.0,2,0,2
NP,CH,2004.0,1,0,1
GE,SE,2009.0,1,0,1
GB,RW,2009.0,1,0,1
IN,PR,2016.0,1,0,1
NG,BE,2009.0,1,0,1
TR,PT,2022.0,4,0,4
BJ,KE,2016.0,2,0,2
CD,EG,2013.0,1,0,1
ET,RU,2023.0,2,0,2
MT,BG,2020.0,1,0,1
PE,ID,2012.0,1,0,1
CA,HT,2010.0,1,0,1
PH,EG,2021.0,2,0,2
SD,SY,2015.0,1,0,1
PY,BO,2007.0,1,0,1
SG,CO,2010.0,1,0,1
GN,IN,2016.0,1,0,1
IT,MR,2006.0,2,0,2
SX,,2017.0,1,0,1
BS,NZ,2019.0,1,0,1
BY,JP,2020.0,3,0,3
QA,SE,1997.0,1,0,1
ML,BE,1998.0,2,0,2
LU,ZA,2013.0,1,0,1
ID,nan,2023.0,1,0,1
YE,GH,2015.0,1,0,1
VG,CH,2010.0,1,0,1
QA,IQ,2012.0,1,0,1
UA,LT,2012.0,1,0,1
CL,BG,2013.0,1,0,1
,HT,2009.0,5,0,5
BF,NL,2018.0,1,0,1
MQ,BR,2013.0,1,0,1
SA,SI,2007.0,1,0,1
GH,BF,2016.0,1,0,1
LV,PL,2003.0,2,0,2
LY,AU,2021.0,1,0,1
HU,CL,2015.0,2,0,2
CZ,AR,2003.0,1,0,1
ZW,AE,1998.0,1,0,1
UY,PG,2012.0,3,0,3
MY,TR,2023.0,1,0,1
SA,CZ,2017.0,3,0,3
CM,ID,2007.0,1,0,1
TZ,RW,2009.0,1,0,1
DZ,AU,2006.0,1,0,1
SY,BE,2009.0,1,0,1
NI,AE,2018.0,1,0,1
IQ,ES,2022.0,1,0,1
CA,LB,1997.0,3,0,3
PK,SV,2011.0,1,0,1
ZA,IL,2001.0,4,0,4
BH,QA,2014.0,1,0,1
SE,TJ,2022.0,1,0,1
AD,US,2010.0,1,0,1
TW,BF,2015.0,1,0,1
SG,VE,2006.0,1,0,1
CA,ME,2016.0,1,0,1
FI,JO,2020.0,1,0,1
RO,PY,2015.0,1,0,1
BE,MU,1999.0,1,0,1
IS,TH,2017.0,2,0,2
,FK,2000.0,1,0,1
DE,MG,2018.0,3,0,3
NL,CD,2019.0,1,0,1
MY,SN,2022.0,1,0,1
LT,GB,2023.0,2,0,2
BH,AT,2011.0,1,0,1
US,AO,2000.0,1,0,1
BD,TR,2015.0,2,0,2
ZA,GE,1999.0,1,0,1
BO,CH,2021.0,1,0,1
PE,CN,2004.0,1,0,1
ZA,ML,2017.0,2,0,2
NL,LY,2011.0,1,0,1
VG,FR,2015.0,3,0,3
MA,EG,2003.0,3,2,1
ZM,KR,2018.0,1,1,0
IL,CO,2010.0,3,1,2
LU,DE,2000.0,4,6,-2
MT,GB,2005.0,3,5,-2
PH,MY,2016.0,1,4,-3
BY,BR,2010.0,1,1,0
MX,BG,2009.0,1,4,-3
IT,ET,2005.0,1,1,0
IQ,DZ,2019.0,4,4,0
PL,ZA,2021.0,4,7,-3
JO,SE,2016.0,1,4,-3
DK,GR,2001.0,3,2,1
CU,IT,2000.0,2,3,-1
TH,DE,2000.0,1,3,-2
AE,TW,2022.0,1,1,0
JM,ZA,2009.0,2,1,1
TR,DK,2010.0,2,2,0
QA,IT,2016.0,1,8,-7
IT,EG,2012.0,5,7,-2
EG,NG,2009.0,2,1,1
ID,EG,2011.0,3,3,0
IL,AU,2023.0,3,1,2
AR,ZA,2000.0,1,1,0
DZ,GR,2014.0,1,1,0
NP,nan,2020.0,2,7,-5
SI,IR,2019.0,1,2,-1
GR,NG,2009.0,1,1,0
TH,VN,2012.0,3,3,0
CO,ID,2012.0,2,1,1
UY,AU,2004.0,1,1,0
KR,KZ,2007.0,1,1,0
RO,KR,2012.0,1,1,0
SA,LB,2011.0,2,4,-2
CO,PY,2013.0,1,1,0
AE,CN,2005.0,2,2,0
NZ,GR,2009.0,1,1,0
PA,IT,2013.0,1,1,0
UG,JP,2013.0,1,1,0
KZ,CA,2011.0,1,1,0
KE,NG,2005.0,2,2,0
GA,CM,2020.0,3,1,2
FI,HU,2022.0,3,3,0
BR,PK,2008.0,1,2,-1
SI,TR,2020.0,2,3,-1
SN,DE,2020.0,2,1,1
UY,SE,2017.0,3,2,1
LK,GR,2021.0,2,2,0
QA,TR,2011.0,1,1,0
DO,CH,2002.0,1,2,-1
PS,ES,2010.0,2,13,-11
PH,FI,2016.0,2,2,0
IN,BW,2007.0,1,1,0
CY,EG,2021.0,1,1,0
SY,JP,2021.0,1,1,0
GR,LK,2000.0,1,3,-2
CZ,CO,2015.0,2,3,-1
KE,IE,2019.0,1,3,-2
ZM,TH,2020.0,1,1,0
US,LA,2018.0,3,1,2
IN,LK,2007.0,1,2,-1
UZ,KG,2001.0,1,1,0
RS,SE,2011.0,2,3,-1
NG,SG,2019.0,1,1,0
PF,FR,2007.0,2,11,-9
ZM,AU,2009.0,1,1,0
DE,MW,2016.0,1,1,0
CA,CR,2011.0,1,1,0
RW,GB,2022.0,2,2,0
RO,PH,2019.0,1,1,0
VN,TW,2009.0,2,2,0
AU,MA,2019.0,2,2,0
KR,IT,1999.0,1,4,-3
CO,VN,2016.0,1,1,0
NL,CD,2017.0,1,1,0
TR,SD,2016.0,1,2,-1
CH,PG,2009.0,1,1,0
SD,QA,2001.0,1,1,0
PT,IE,2003.0,2,3,-1
MM,TH,2010.0,1,1,0
GR,SG,2017.0,2,1,1
VG,US,1999.0,2,9,-7
TW,UZ,2021.0,1,1,0
CN,AR,2012.0,3,1,2
SG,BN,2017.0,2,3,-1
DK,LU,2012.0,1,3,-2
BE,BI,2009.0,1,1,0
US,CD,2022.0,3,4,-1
AU,CO,2010.0,2,10,-8
SG,BE,2008.0,1,3,-2
CY,IN,2013.0,1,1,0
ID,AF,2020.0,1,1,0
ZW,BE,2011.0,1,1,0
BY,HU,2015.0,1,2,-1
LV,US,2009.0,4,12,-8
CM,NG,2009.0,1,4,-3
PT,GR,2011.0,2,3,-1
KW,BR,2016.0,1,1,0
NZ,SG,1997.0,3,1,2
LT,RU,2004.0,2,4,-2
ET,CA,2012.0,1,4,-3
PT,TR,2012.0,1,3,-2
VE,CA,2017.0,1,2,-1
AE,AT,2013.0,1,3,-2
OM,IN,2001.0,2,6,-4
SY,NL,2017.0,1,1,0
CH,CO,2022.0,1,6,-5
MA,HU,2008.0,2,1,1
HK,CH,2007.0,1,1,0
NZ,IL,2022.0,1,1,0
CL,NO,2008.0,1,3,-2
HR,ME,2022.0,2,1,1
TR,PG,2020.0,2,1,1
KR,FI,2010.0,2,11,-9
ZM,PK,2011.0,1,1,0
PK,RS,2009.0,1,1,0
NC,MY,2011.0,1,1,0
PT,CU,2004.0,1,3,-2
ET,ID,2022.0,1,5,-4
OM,BH,2012.0,1,1,0
US,SI,2001.0,4,20,-16
GB,SL,2020.0,1,3,-2
MN,DE,2006.0,1,1,0
CY,CH,2020.0,1,2,-1
RO,RU,2009.0,1,5,-4
LA,IN,2019.0,1,1,0
SV,PE,2021.0,1,3,-2
nan,OM,2011.0,1,2,-1
KE,VN,2019.0,1,1,0
SG,CO,2019.0,1,1,0
ID,KG,2019.0,1,1,0
VE,PE,2003.0,2,4,-2
BR,MA,2006.0,1,3,-2
HT,US,2014.0,2,2,0
MX,EC,2000.0,1,1,0
JP,QA,2002.0,1,1,0
SG,ZA,1999.0,1,2,-1
DK,CY,2019.0,1,2,-1
NO,RS,2014.0,1,7,-6
UZ,FR,2021.0,1,1,0
IR,KW,2014.0,1,1,0
NP,NZ,2005.0,1,9,-8
CN,UZ,2004.0,1,4,-3
IT,PA,2009.0,1,1,0
ID,PT,2019.0,1,5,-4
IT,UY,2002.0,1,3,-2
CH,DZ,2000.0,1,1,0
UA,IN,2009.0,1,3,-2
PT,IN,2003.0,1,4,-3
AU,TT,2020.0,1,2,-1
JP,SA,1998.0,1,2,-1
TN,IL,2015.0,1,2,-1
SD,ID,2022.0,1,2,-1
DO,nan,2015.0,1,1,0
ES,NO,2023.0,2,2,0
LK,DE,2012.0,1,2,-1
LK,AU,1999.0,1,2,-1
IL,SG,2021.0,1,5,-4
BD,NL,2018.0,1,3,-2
TW,RS,2007.0,1,1,0
GR,TW,2005.0,1,2,-1
ID,NI,2019.0,1,2,-1
PH,CU,2004.0,1,1,0
LT,CA,2008.0,2,2,0
TW,JO,2015.0,1,1,0
SD,PK,2008.0,1,1,0
ZW,CD,2021.0,1,1,0
IE,MX,2005.0,1,2,-1
XK,TR,2017.0,1,1,0
DK,GW,2020.0,1,6,-5
CD,CN,2020.0,1,1,0
TH,MM,2006.0,1,1,0
ID,PT,2017.0,1,2,-1
BG,EG,2020.0,1,1,0
ID,CZ,2012.0,2,2,0
GP,nan,2007.0,1,1,0
LU,NO,2012.0,2,2,0
NL,PK,2005.0,1,5,-4
AT,BE,1999.0,2,5,-3
GR,BG,2022.0,1,1,0
nan,PL,1998.0,2,1,1
QA,KR,2009.0,1,2,-1
MG,US,2015.0,3,3,0
BY,IT,2001.0,1,1,0
RU,LV,2000.0,1,17,-16
LT,UA,2007.0,1,1,0
LV,AT,2009.0,1,1,0
IE,ET,2022.0,1,2,-1
EG,MX,2018.0,1,2,-1
DE,AL,2001.0,1,2,-1
CA,UA,1999.0,1,1,0
KE,RW,2016.0,1,1,0
HU,SY,2018.0,1,1,0
CH,MA,2004.0,1,1,0
GD,US,2006.0,1,5,-4
US,PR,1998.0,1,2,-1
PH,TH,2014.0,1,4,-3
CZ,PH,2014.0,1,1,0
PH,PE,2006.0,1,0,1
BY,CH,2023.0,1,0,1
GP,IL,2020.0,1,0,1
KZ,AU,2002.0,1,0,1
IL,MW,2015.0,1,0,1
TR,EE,2020.0,2,0,2
FR,TD,1999.0,1,0,1
JM,PT,2016.0,1,0,1
SE,SK,1997.0,1,0,1
SN,BO,2007.0,1,0,1
IE,PY,2019.0,1,0,1
CA,GE,2020.0,1,0,1
SY,CY,2011.0,1,0,1
GT,AU,2011.0,1,0,1
NZ,MY,2005.0,1,0,1
SN,LB,2018.0,1,0,1
DO,CH,2005.0,1,0,1
NL,AE,2005.0,1,0,1
KP,IT,2017.0,1,0,1
PK,LR,2018.0,1,0,1
BJ,UG,2015.0,1,0,1
BN,ID,2016.0,1,0,1
ST,PT,2021.0,1,0,1
KH,IT,2021.0,1,0,1
CH,GN,2015.0,2,0,2
NG,BW,2022.0,3,0,3
CA,AL,2011.0,1,0,1
LU,KE,2019.0,1,0,1
IE,BY,2021.0,1,0,1
MA,PS,2012.0,1,0,1
KH,ID,2012.0,1,0,1
IL,ID,2010.0,1,0,1
EC,MD,2020.0,1,0,1
CY,PH,2020.0,1,0,1
SK,CU,2008.0,1,0,1
ZM,CZ,2003.0,1,0,1
ZA,SO,2022.0,1,0,1
CY,MW,2012.0,1,0,1
HK,ES,2019.0,1,0,1
UG,LS,2022.0,1,0,1
CR,SG,2021.0,1,0,1
SV,MX,2009.0,3,0,3
BI,,2007.0,2,0,2
TW,NP,2010.0,1,0,1
MA,SA,2023.0,1,0,1
PH,PK,2019.0,2,0,2
PK,UZ,2006.0,1,0,1
DZ,PK,2008.0,1,0,1
CU,CH,2000.0,1,0,1
LS,ZW,2013.0,1,0,1
PT,HK,2016.0,1,0,1
ER,CN,2019.0,1,0,1
DK,SJ,2016.0,2,0,2
MG,CN,2004.0,1,0,1
BW,SZ,2019.0,1,0,1
PH,CO,2004.0,1,0,1
CA,CG,2007.0,1,0,1
SS,FR,2019.0,1,0,1
ZW,KR,2020.0,1,0,1
ME,CA,2019.0,1,0,1
TH,QA,2016.0,1,0,1
KZ,BR,2019.0,1,0,1
DK,TZ,2000.0,1,0,1
CH,JO,2000.0,1,0,1
BD,MX,2020.0,1,0,1
EC,JP,2003.0,1,0,1
GF,PF,2010.0,1,0,1
CO,HN,1997.0,1,0,1
BM,US,2002.0,1,0,1
SC,FR,2015.0,2,0,2
MO,CN,2011.0,1,0,1
MD,IR,2010.0,1,0,1
RO,CU,2009.0,1,0,1
PG,JP,1999.0,1,0,1
JO,IL,2015.0,1,0,1
BD,FI,2009.0,1,0,1
BH,DE,2022.0,1,0,1
GE,ES,2017.0,1,0,1
CA,BM,2017.0,1,0,1
IQ,BN,2021.0,1,0,1
BY,SG,2010.0,1,0,1
IS,GR,2011.0,1,0,1
EC,nan,2009.0,1,0,1
NG,GM,2007.0,1,0,1
BH,TR,2006.0,1,0,1
SN,PA,2021.0,1,0,1
KG,,2009.0,2,0,2
PG,PL,2020.0,1,0,1
AR,SG,2022.0,1,0,1
NP,OM,2011.0,1,0,1
IE,OM,2014.0,2,0,2
GP,BF,2016.0,1,0,1
,MC,2019.0,2,0,2
TZ,ZW,2018.0,1,0,1
TZ,BH,2015.0,1,0,1
IN,ZM,2005.0,1,0,1
US,KY,2012.0,1,0,1
SA,nan,2007.0,1,0,1
ZW,CZ,2020.0,1,0,1
JO,CH,2014.0,1,0,1
AZ,SI,2012.0,1,0,1
BR,KN,2018.0,1,0,1
PK,CY,2023.0,2,0,2
NO,IE,2003.0,1,0,1
TZ,AT,2014.0,1,0,1
SA,SE,2002.0,2,0,2
LT,NZ,2016.0,1,0,1
NZ,BW,2016.0,1,0,1
ZW,ID,2012.0,1,0,1
CU,ZW,2013.0,1,0,1
UA,KR,2003.0,1,0,1
TN,BD,2012.0,1,0,1
BR,CR,2023.0,1,0,1
EE,CL,2020.0,1,0,1
VG,CH,2017.0,1,0,1
ST,CH,2016.0,1,0,1
PR,IN,2010.0,1,0,1
ID,FI,1998.0,1,0,1
GB,DO,2017.0,1,0,1
SN,CZ,2014.0,1,0,1
PF,GP,2018.0,1,0,1
PT,AE,2017.0,1,0,1
MZ,IT,2013.0,1,0,1
ZW,CM,2009.0,1,0,1
CH,UY,2012.0,1,0,1
NG,JP,2023.0,1,0,1
ST,AO,2009.0,1,0,1
BJ,RO,2012.0,1,0,1
FO,US,2002.0,1,0,1
AT,PE,2003.0,1,0,1
CG,VE,2017.0,1,0,1
NL,MK,2017.0,1,0,1
LI,,2004.0,2,0,2
nan,PL,1997.0,1,0,1
CL,PY,2001.0,1,0,1
TJ,TW,2009.0,1,0,1
MY,CN,1997.0,3,0,3
SD,TT,2014.0,1,0,1
VN,IS,2018.0,1,0,1
RU,OM,2021.0,1,0,1
TW,KW,2021.0,1,0,1
GB,IM,2021.0,1,0,1
ZA,PG,2019.0,1,0,1
AT,PS,2007.0,2,0,2
MW,KR,2018.0,2,0,2
GN,,2000.0,1,0,1
IN,AZ,2015.0,1,0,1
AU,CY,1997.0,1,0,1
KH,DE,2014.0,1,0,1
CR,EC,2006.0,1,0,1
QA,BG,2021.0,1,0,1
CA,BW,2012.0,1,0,1
BY,TJ,2016.0,1,0,1
DZ,NG,2014.0,1,0,1
IN,BS,2016.0,1,0,1
nan,EE,1998.0,1,0,1
JP,AO,2010.0,1,0,1
HU,GE,2018.0,1,0,1
US,BZ,2005.0,1,0,1
BA,PK,2012.0,1,0,1
BY,GR,2018.0,1,0,1
BF,MD,2011.0,1,0,1
BO,GE,2021.0,1,0,1
MG,CG,2018.0,1,0,1
CN,KH,2014.0,1,0,1
IT,IQ,2012.0,2,0,2
PH,AO,2013.0,1,0,1
LV,IL,2000.0,1,0,1
MW,CH,1998.0,1,0,1
KE,SN,2021.0,1,0,1
NP,GM,2000.0,1,0,1
EG,PS,2000.0,1,0,1
SG,ZW,2006.0,1,0,1
IN,PE,2004.0,1,0,1
TG,TR,2013.0,1,0,1
BY,CN,2004.0,1,0,1
AE,BF,2018.0,1,0,1
NP,QA,2007.0,1,0,1
DK,BY,2003.0,1,0,1
NP,,2000.0,1,0,1
IL,LV,2012.0,1,0,1
IT,BY,2004.0,1,0,1
NL,SD,2014.0,1,0,1
CA,BA,2005.0,1,0,1
ME,,2000.0,1,0,1
SD,IT,2019.0,1,0,1
QA,GH,2020.0,1,0,1
IS,AR,2020.0,1,0,1
SN,CH,2008.0,1,0,1
TW,NP,2019.0,1,0,1
SI,TW,1998.0,1,0,1
KH,CN,2022.0,1,0,1
KR,KW,2009.0,1,0,1
VN,DZ,2019.0,1,0,1
KE,ZM,2004.0,1,0,1
IR,TT,2006.0,1,0,1
FR,GH,2007.0,1,0,1
TR,AZ,2023.0,1,0,1
GY,CA,2014.0,1,0,1
UA,OM,2016.0,1,0,1
MS,US,2007.0,1,0,1
PF,NL,2013.0,1,0,1
DO,BR,2005.0,1,0,1
IT,CD,2019.0,1,0,1
FI,BD,2004.0,1,0,1
CF,PK,2016.0,1,0,1
NE,US,2010.0,1,0,1
RW,CO,2020.0,1,0,1
BF,CA,2022.0,1,0,1
SL,PK,2018.0,1,0,1
PK,SE,1999.0,1,0,1
RU,MM,2021.0,1,0,1
MK,JP,2018.0,1,0,1
SV,FR,2018.0,1,0,1
IT,MT,2023.0,1,0,1
JO,DK,2020.0,1,0,1
EC,ZA,2016.0,1,0,1
NO,PE,2019.0,1,0,1
AZ,CN,2007.0,1,0,1
KH,AG,2019.0,1,0,1
BR,GW,2009.0,1,0,1
GE,CZ,1997.0,1,0,1
SK,AF,2020.0,1,0,1
PK,GH,2022.0,1,0,1
IN,GY,2022.0,1,0,1
LT,TH,2020.0,1,0,1
BI,ET,2022.0,1,0,1
PH,WS,2019.0,1,0,1
CN,ES,1999.0,17,6,11
DE,AU,1999.0,83,72,11
DE,US,2005.0,1922,1891,31
SG,US,2001.0,146,124,22
EG,CA,2002.0,12,6,6
EG,CA,2005.0,16,16,0
GB,IN,2016.0,578,475,103
US,ES,2019.0,1087,1190,-103
US,CZ,2012.0,169,123,46
BR,US,2013.0,952,1141,-189
JP,CN,2004.0,522,339,183
US,AU,2003.0,1324,1250,74
SE,FR,2021.0,63,76,-13
GB,SG,2008.0,93,81,12
FI,TR,2015.0,7,8,-1
ES,US,2006.0,615,661,-46
AR,US,2009.0,183,234,-51
KR,US,2005.0,833,903,-70
SN,CH,2013.0,4,3,1
KR,US,2002.0,708,642,66
AU,US,2006.0,1510,1743,-233
HU,CZ,2012.0,5,5,0
US,CA,2013.0,3254,3308,-54
CN,US,2018.0,5094,6489,-1395
IE,GB,2015.0,426,414,12
AU,NZ,2001.0,68,74,-6
AU,CH,2012.0,65,67,-2
IN,JP,2021.0,90,81,9
US,NP,2019.0,62,121,-59
US,DK,2013.0,307,248,59
US,BE,2007.0,214,232,-18
PT,US,2005.0,96,90,6
GB,IT,2013.0,449,549,-100
US,FI,2008.0,187,102,85
TR,US,2020.0,418,407,11
NG,CN,2005.0,3,1,2
US,IT,2001.0,592,577,15
CL,ES,2011.0,293,296,-3
CU,MX,2015.0,87,53,34
DE,US,2002.0,1806,1687,119
FI,CN,2021.0,44,36,8
EC,AR,2018.0,29,44,-15
ES,FR,2012.0,285,256,29
PH,JP,2008.0,22,17,5
US,ES,2017.0,932,1076,-144
IN,US,2007.0,1343,1249,94
KR,JP,2007.0,229,254,-25
MY,IT,2007.0,24,53,-29
CN,nan,2004.0,75,78,-3
KR,GB,2016.0,94,90,4
ET,KR,2007.0,109,105,4
CA,BR,2014.0,289,259,30
US,ES,2010.0,909,830,79
CL,VE,2005.0,11,8,3
CH,FR,2006.0,267,317,-50
US,CU,2014.0,25,43,-18
DE,AT,2019.0,796,677,119
KE,GB,2012.0,20,35,-15
CH,DE,2022.0,458,486,-28
CN,GB,1998.0,95,129,-34
US,AR,2018.0,321,297,24
MT,US,2017.0,7,10,-3
US,CH,2007.0,674,569,105
FI,ES,2007.0,8,13,-5
PE,nan,2014.0,10,6,4
NL,US,2006.0,531,525,6
GB,SA,2018.0,197,91,106
NL,DE,2015.0,400,356,44
DK,JP,2008.0,14,20,-6
TN,IT,2013.0,14,11,3
NL,AT,2017.0,37,25,12
DE,AT,2017.0,690,650,40
HU,GB,2002.0,18,27,-9
GB,BR,2007.0,121,111,10
DE,CH,2015.0,961,820,141
JP,MY,2014.0,100,34,66
FR,CN,2002.0,207,144,63
nan,SI,2011.0,4,2,2
FR,IN,2003.0,53,69,-16
BE,NL,2008.0,199,208,-9
JP,CA,2008.0,130,97,33
US,PK,2019.0,436,523,-87
IE,ZA,2013.0,13,8,5
PT,US,2002.0,53,67,-14
TT,JM,2005.0,13,7,6
JP,CH,2016.0,112,87,25
CH,ZA,2013.0,9,18,-9
CL,CO,2020.0,211,221,-10
FR,GB,2008.0,532,485,47
JO,IT,2021.0,4,3,1
FI,DE,2002.0,26,23,3
AR,CL,2018.0,139,120,19
JP,VN,2014.0,44,28,16
GB,IE,2007.0,279,203,76
PL,NL,2020.0,29,26,3
CN,HK,2019.0,144,137,7
PH,US,2001.0,196,178,18
TR,DE,2007.0,38,34,4
BR,ST,2019.0,23,30,-7
DK,GB,1999.0,51,53,-2
JP,KR,2001.0,167,121,46
PL,DE,2017.0,148,122,26
EC,MX,2021.0,104,97,7
BE,nan,2018.0,21,27,-6
US,AT,2019.0,274,228,46
GB,KE,1999.0,11,6,5
IT,nan,1999.0,56,47,9
CO,CL,1999.0,12,5,7
IR,SA,2022.0,10,7,3
IT,AU,2011.0,70,37,33
US,PK,2010.0,150,138,12
nan,AU,2015.0,63,41,22
DE,AT,2010.0,499,445,54
PL,JP,2021.0,11,9,2
PT,GB,2001.0,30,47,-17
CH,CO,2016.0,13,13,0
US,TW,2013.0,734,764,-30
VG,AU,2015.0,3,1,2
FR,BE,2011.0,318,309,9
ES,VE,2000.0,40,47,-7
IT,US,2000.0,574,485,89
JP,AU,1999.0,47,42,5
RS,HR,2021.0,102,110,-8
FR,CH,2015.0,535,357,178
QA,EG,2017.0,71,69,2
CL,PH,2015.0,4,7,-3
TR,CA,2007.0,17,13,4
DK,UY,2020.0,1,1,0
IN,AU,2000.0,32,27,5
EG,SA,2018.0,405,395,10
GB,MY,2018.0,170,149,21
RU,UA,2008.0,167,94,73
US,TN,2010.0,19,13,6
IN,KR,2020.0,245,169,76
IT,RU,2002.0,14,20,-6
CU,ES,1998.0,24,27,-3
NL,GR,2019.0,44,29,15
GR,US,2020.0,166,138,28
MX,AR,2011.0,109,70,39
EG,AE,2016.0,36,36,0
RU,US,2020.0,551,583,-32
BR,PE,2021.0,69,50,19
MY,BD,2015.0,41,58,-17
TR,JP,2007.0,43,26,17
KR,PH,2009.0,2,6,-4
US,AT,2017.0,275,236,39
UY,MX,2015.0,13,17,-4
MX,CH,2020.0,29,13,16
IE,AU,2016.0,101,101,0
LU,FI,2003.0,1,1,0
GE,GB,2020.0,5,1,4
GB,SE,2003.0,99,113,-14
CN,HK,2010.0,93,69,24
FR,CN,2005.0,309,180,129
DK,CN,2007.0,18,20,-2
nan,US,2011.0,300,290,10
CN,KR,1997.0,24,12,12
IT,CN,2015.0,50,33,17
CN,QA,2011.0,26,11,15
CN,UZ,2014.0,11,5,6
NO,DK,2011.0,85,76,9
AT,CA,2007.0,20,14,6
PK,CN,2008.0,72,47,25
GR,FR,2014.0,58,51,7
CN,SE,2011.0,84,83,1
PL,DE,2010.0,119,104,15
PL,DE,2019.0,147,157,-10
US,PK,2017.0,308,341,-33
FR,PK,2012.0,23,10,13
nan,PT,2009.0,20,26,-6
IT,JP,2007.0,58,54,4
RU,IE,2010.0,6,6,0
NG,nan,2019.0,9,8,1
KW,CA,2016.0,11,15,-4
GB,DK,2004.0,73,83,-10
AU,FR,2007.0,89,83,6
RU,nan,2016.0,43,76,-33
CN,HK,2017.0,136,144,-8
LB,IN,2021.0,10,6,4
ES,BE,2009.0,43,55,-12
GB,NP,2020.0,13,12,1
ES,ID,2009.0,7,12,-5
GB,NO,2010.0,84,41,43
GB,NO,2019.0,128,98,30
CN,FR,2021.0,143,141,2
AU,SE,2006.0,36,53,-17
US,BS,2022.0,2,3,-1
MY,GB,2022.0,78,39,39
GB,IQ,2019.0,175,45,130
AU,QA,2018.0,11,8,3
TH,SE,2006.0,3,7,-4
SK,GB,2006.0,22,15,7
ES,GR,2009.0,8,12,-4
SN,US,2005.0,12,2,10
BR,CL,2011.0,71,73,-2
CL,DE,2018.0,84,64,20
MA,DZ,2013.0,14,8,6
IL,DE,2013.0,56,58,-2
CZ,DE,2021.0,74,72,2
FR,NO,2020.0,59,68,-9
BE,DK,2023.0,7,6,1
DK,NO,2015.0,110,84,26
IT,DE,2006.0,160,172,-12
CZ,BY,2020.0,17,9,8
AU,SG,2018.0,139,149,-10
JP,IE,2015.0,24,24,0
AU,MT,2020.0,5,2,3
CA,GH,2016.0,9,8,1
DE,HU,2014.0,46,72,-26
CN,CH,2000.0,22,23,-1
IN,TH,2016.0,20,16,4
CL,PE,2013.0,64,39,25
IE,JP,1997.0,14,6,8
UA,US,2010.0,32,52,-20
CN,LT,2019.0,9,5,4
SE,NO,2002.0,51,40,11
UY,ES,2015.0,43,62,-19
VE,CO,2022.0,11,8,3
TH,GB,2009.0,23,53,-30
RU,CN,2006.0,33,27,6
MW,KE,2020.0,2,3,-1
BR,NL,2022.0,50,22,28
TW,ET,2018.0,6,6,0
BD,MY,2021.0,37,42,-5
AR,GB,2002.0,24,9,15
GB,CU,2010.0,7,2,5
HU,CA,2016.0,18,7,11
CN,ET,2022.0,19,14,5
US,ID,2006.0,45,24,21
SG,KR,2012.0,41,27,14
IT,PK,2022.0,13,13,0
EG,JO,2011.0,11,12,-1
NP,CN,2016.0,24,19,5
CO,AR,2016.0,114,123,-9
nan,ID,2013.0,17,13,4
FR,LU,2006.0,28,6,22
US,RO,2020.0,99,70,29
nan,BE,2003.0,16,12,4
HU,RO,2000.0,31,80,-49
TN,MA,2013.0,21,34,-13
BR,KE,2018.0,1,1,0
IT,AR,2004.0,42,45,-3
NL,PT,2015.0,25,22,3
TH,IN,2019.0,16,25,-9
QA,EG,2019.0,83,79,4
NA,GB,2015.0,1,4,-3
CO,NL,2021.0,27,14,13
CM,MY,2021.0,2,2,0
DE,MA,2008.0,9,7,2
NG,MY,2009.0,5,1,4
NL,AT,2019.0,50,40,10
CA,NO,2015.0,26,31,-5
RE,FR,2015.0,36,49,-13
DE,BE,2009.0,106,82,24
US,AT,2010.0,221,168,53
GB,MA,2017.0,13,5,8
AE,EG,2021.0,39,54,-15
BD,NL,2017.0,7,6,1
GB,MX,2009.0,41,51,-10
DE,CN,1997.0,48,49,-1
MX,RS,2004.0,11,16,-5
BA,HR,2020.0,42,45,-3
US,NP,2017.0,79,89,-10
IN,ES,2021.0,22,13,9
ID,US,2022.0,150,100,50
UA,US,2017.0,98,80,18
MY,SE,2019.0,10,6,4
BR,CU,2012.0,9,21,-12
MK,AT,2021.0,4,27,-23
MX,IT,2013.0,29,37,-8
AR,CA,2012.0,21,22,-1
US,CL,2003.0,87,76,11
CZ,IE,2018.0,5,6,-1
TR,CY,2020.0,74,63,11
CY,GB,2013.0,17,41,-24
IN,BD,2016.0,122,116,6
NL,nan,1997.0,14,8,6
AT,BA,2014.0,2,1,1
CH,IN,2021.0,49,45,4
IN,EG,2011.0,4,4,0
RS,NL,2005.0,2,3,-1
AT,ZA,2017.0,8,4,4
UY,BR,2020.0,50,57,-7
PE,CL,2011.0,19,45,-26
KG,DE,2016.0,1,2,-1
PK,DE,2019.0,36,45,-9
GR,CN,2007.0,14,14,0
GA,BE,2016.0,1,1,0
NG,FR,2015.0,5,5,0
EC,NL,2019.0,5,3,2
ZA,PA,2014.0,2,3,-1
IR,GB,2008.0,36,66,-30
EE,CZ,2018.0,4,4,0
BD,IN,2008.0,24,31,-7
SA,EG,1998.0,18,20,-2
EG,TW,2022.0,15,20,-5
RU,TW,2011.0,19,19,0
GB,JM,2014.0,5,5,0
AT,RU,2004.0,8,7,1
CH,RU,2015.0,30,29,1
FR,PE,2020.0,16,12,4
HN,GT,2020.0,2,1,1
MM,TH,2018.0,10,7,3
CH,CZ,2017.0,36,46,-10
RS,PT,2020.0,1,3,-2
PT,FI,2022.0,4,1,3
SG,MY,2021.0,138,128,10
VE,DE,2014.0,5,3,2
GB,NO,2017.0,139,89,50
KR,AR,2021.0,1,2,-1
FR,GR,2011.0,32,47,-15
SA,TN,2020.0,73,118,-45
NG,TH,2021.0,3,3,0
BR,nan,2008.0,56,42,14
HU,DE,2018.0,69,57,12
PH,CA,2018.0,5,11,-6
NO,RU,2015.0,18,12,6
IS,AE,2013.0,1,1,0
JP,IT,2018.0,57,66,-9
JP,SK,2013.0,10,26,-16
CH,BJ,2000.0,1,1,0
US,UY,2012.0,27,16,11
SD,EG,2016.0,26,23,3
RU,SE,2009.0,29,17,12
AE,DE,2017.0,11,7,4
BR,IE,2021.0,17,11,6
PT,PH,2019.0,3,3,0
ZM,GH,2022.0,9,45,-36
JO,SY,2014.0,3,2,1
TR,IN,2020.0,19,20,-1
CO,PT,2012.0,6,5,1
EG,JP,2018.0,36,68,-32
CN,TH,2018.0,42,37,5
SI,RU,2021.0,5,4,1
MY,nan,2021.0,35,46,-11
DK,UG,2015.0,3,1,2
CR,CU,2016.0,23,17,6
HK,RO,2017.0,11,16,-5
US,JO,2018.0,71,57,14
AO,BR,2004.0,7,14,-7
IN,UA,2016.0,3,2,1
US,EG,2003.0,94,55,39
GB,CN,2016.0,576,534,42
US,IL,2015.0,540,552,-12
DE,NL,2013.0,363,352,11
GB,CO,2016.0,38,27,11
NL,AU,2015.0,128,82,46
DZ,FR,2022.0,55,46,9
FR,SN,2018.0,47,40,7
UA,US,2019.0,113,116,-3
SA,SD,2018.0,29,40,-11
MX,PA,2008.0,7,7,0
ID,ES,2004.0,4,3,1
CZ,JP,2017.0,27,21,6
ID,PA,2015.0,3,2,1
US,CD,2016.0,8,4,4
TR,KW,2020.0,9,9,0
BF,SN,2015.0,1,4,-3
ES,IL,2015.0,19,11,8
AT,IT,2017.0,61,97,-36
AU,IR,2015.0,47,151,-104
CH,SE,2011.0,35,43,-8
JO,SA,2017.0,42,39,3
JO,SA,2019.0,54,67,-13
CL,CH,2018.0,26,22,4
CN,CA,2023.0,90,20,70
SE,HU,1997.0,6,3,3
FI,IT,2022.0,19,21,-2
CI,CM,2021.0,3,6,-3
MK,IT,2021.0,2,1,1
TH,NP,2017.0,11,3,8
RU,FI,2020.0,44,31,13
PK,QA,2018.0,11,7,4
NO,BD,2019.0,23,8,15
SK,US,2014.0,29,33,-4
ES,PS,2017.0,6,14,-8
ES,SG,2016.0,6,8,-2
AU,NP,2020.0,10,30,-20
RU,MX,2011.0,8,5,3
BG,FR,2004.0,8,7,1
ES,ZA,1999.0,2,2,0
GB,RS,2004.0,10,7,3
SE,NO,2005.0,65,45,20
JO,KW,2014.0,6,3,3
GR,DK,2012.0,5,2,3
MA,HU,2013.0,7,3,4
NG,nan,2017.0,10,4,6
MY,IQ,2012.0,20,11,9
CH,CZ,2019.0,41,38,3
ID,AZ,2014.0,9,12,-3
GR,SG,2018.0,5,2,3
NO,NL,1998.0,3,9,-6
FR,IR,2012.0,46,26,20
AR,FR,2012.0,61,133,-72
RU,IL,2007.0,31,23,8
RS,FR,2020.0,12,7,5
CN,EG,2014.0,19,16,3
US,UG,2015.0,23,41,-18
BE,SE,2005.0,11,17,-6
AR,UY,2011.0,20,21,-1
RS,NL,2002.0,5,1,4
LB,GB,2012.0,9,8,1
CM,US,2013.0,17,11,6
DE,ES,2004.0,79,74,5
TH,AU,2006.0,18,25,-7
FR,RE,2003.0,14,3,11
GB,TH,2004.0,53,18,35
AT,IT,2019.0,58,87,-29
IN,BR,2012.0,11,28,-17
IN,KW,2013.0,8,8,0
DE,JP,2006.0,148,151,-3
UA,BG,2019.0,8,19,-11
EC,GB,2019.0,14,15,-1
MX,SE,2021.0,9,7,2
EG,QA,2004.0,7,5,2
DE,ID,2015.0,40,16,24
DE,BD,2016.0,11,11,0
NL,GR,2010.0,16,15,1
BE,IE,2007.0,7,7,0
NO,JP,2009.0,7,7,0
IQ,GB,2016.0,23,78,-55
VE,US,1999.0,25,22,3
UY,US,2006.0,17,16,1
NL,AT,2010.0,20,25,-5
QA,EG,2010.0,16,10,6
SE,RO,2012.0,10,5,5
BR,SK,2019.0,6,4,2
GB,CR,2017.0,5,3,2
nan,IL,2009.0,19,17,2
RS,RU,2014.0,9,8,1
GR,AE,2021.0,3,7,-4
TN,CA,2014.0,10,16,-6
CA,PT,2014.0,21,19,2
JP,NG,2005.0,4,9,-5
CN,LT,2010.0,17,1,16
AR,CU,2016.0,20,23,-3
AT,EC,2019.0,2,1,1
CN,LB,2006.0,7,4,3
ID,IR,2018.0,13,39,-26
MX,SV,2015.0,8,3,5
KR,ES,2018.0,18,15,3
IS,SE,2007.0,11,18,-7
KR,AU,2011.0,37,24,13
PT,PE,2015.0,6,8,-2
SE,RU,2004.0,18,37,-19
HR,NL,2001.0,4,2,2
PT,DE,2009.0,31,44,-13
US,TN,2019.0,21,19,2
IT,AM,2012.0,35,11,24
LB,IT,2015.0,21,16,5
SA,CN,2023.0,4,5,-1
BG,GR,2018.0,2,9,-7
AU,IN,1999.0,28,32,-4
IS,DK,2016.0,12,6,6
NO,FR,2001.0,21,29,-8
UG,US,2016.0,36,36,0
JO,SA,2010.0,28,8,20
FR,KE,2019.0,5,11,-6
KW,DE,2015.0,2,2,0
CH,CZ,2010.0,17,28,-11
CO,GB,2014.0,26,20,6
ZA,UG,2022.0,3,8,-5
FO,GB,2015.0,1,2,-1
ID,TH,2022.0,17,14,3
TR,MY,2020.0,8,13,-5
CN,IL,2008.0,14,17,-3
FR,BI,2013.0,17,20,-3
ZM,US,2014.0,23,17,6
AU,KZ,2014.0,2,1,1
BE,CZ,2020.0,11,11,0
CR,NL,2020.0,3,3,0
CA,KR,2001.0,13,14,-1
AE,DE,2010.0,6,8,-2
AU,ID,2022.0,30,42,-12
TW,AT,2020.0,3,4,-1
US,BY,2017.0,9,9,0
IL,ID,2018.0,9,2,7
AR,GB,2005.0,18,17,1
JP,LT,2004.0,12,5,7
CA,IE,2007.0,102,86,16
PT,BE,2016.0,22,23,-1
LB,EG,2021.0,31,16,15
RU,DK,2016.0,13,8,5
NG,BR,2013.0,3,5,-2
RO,IT,2006.0,10,9,1
BR,ST,2010.0,26,34,-8
KR,IR,2017.0,9,15,-6
US,DZ,2004.0,4,5,-1
SK,nan,2010.0,1,4,-3
KR,IL,2020.0,7,5,2
FI,DE,2005.0,21,40,-19
UG,ID,2021.0,1,2,-1
VN,MX,2014.0,10,3,7
SG,AT,2013.0,5,5,0
PK,DE,2017.0,32,38,-6
TH,CH,2019.0,5,6,-1
UY,CO,2020.0,14,15,-1
KW,SA,2018.0,33,28,5
IT,CD,2018.0,2,1,1
CA,ES,2003.0,27,26,1
AT,LI,2020.0,7,3,4
MY,ES,2012.0,4,6,-2
NO,BR,2006.0,23,15,8
TZ,US,2021.0,11,16,-5
RO,AR,2017.0,4,1,3
CN,MX,2022.0,11,13,-2
PT,AR,2015.0,16,13,3
SA,IE,2021.0,10,10,0
CH,IR,2015.0,21,38,-17
FI,BE,2012.0,18,6,12
NO,ZA,2018.0,4,7,-3
IE,NO,2020.0,6,7,-1
ES,BD,2021.0,12,14,-2
US,PE,2011.0,72,64,8
DK,NZ,1998.0,4,1,3
SE,HU,1998.0,6,17,-11
CH,SK,2008.0,6,10,-4
AU,KR,1999.0,9,7,2
PE,CU,2014.0,8,12,-4
FR,GP,2003.0,4,6,-2
NL,IT,2004.0,45,62,-17
KR,IR,2019.0,13,26,-13
nan,GB,2008.0,88,60,28
NL,GH,2017.0,3,3,0
GR,AU,2021.0,5,9,-4
GB,nan,1999.0,36,20,16
GH,DE,2014.0,8,6,2
nan,AR,2020.0,39,41,-2
JP,PK,2015.0,19,3,16
US,NP,2010.0,18,26,-8
ES,PS,2010.0,13,2,11
CH,IL,2021.0,19,19,0
BR,BE,2011.0,49,62,-13
KR,FR,2016.0,30,29,1
SE,AR,2014.0,13,4,9
IN,SG,2004.0,39,15,24
PS,JO,2021.0,10,7,3
EG,PH,2005.0,1,1,0
EC,CR,2015.0,6,9,-3
BE,GB,2022.0,93,96,-3
YE,IQ,2019.0,7,2,5
TW,VN,2016.0,22,8,14
GB,MG,2012.0,1,1,0
SE,IE,2011.0,16,10,6
FR,JO,2016.0,3,2,1
HU,RS,2020.0,13,7,6
US,BA,2019.0,9,5,4
HN,MX,2013.0,23,17,6
IT,BE,2003.0,53,45,8
IE,RU,2007.0,3,8,-5
SA,KW,2000.0,1,1,0
CN,MW,2016.0,1,1,0
ZW,RU,2015.0,15,19,-4
RU,BG,1999.0,6,13,-7
MN,KR,2013.0,1,6,-5
PL,DK,2016.0,20,14,6
US,AM,2008.0,5,9,-4
KE,ET,2015.0,4,9,-5
AT,IT,2010.0,41,38,3
MX,AU,2016.0,23,20,3
JP,CM,2017.0,5,3,2
ES,NZ,2011.0,7,4,3
RS,SI,2007.0,5,10,-5
IN,AT,2009.0,12,7,5
SE,ID,2011.0,4,1,3
BJ,BF,2016.0,3,2,1
CA,TR,2009.0,13,13,0
US,KH,2007.0,2,5,-3
UZ,KR,2004.0,2,2,0
AU,SK,2006.0,2,1,1
US,SI,2003.0,10,8,2
CA,GB,2023.0,26,23,3
TR,MD,2019.0,7,2,5
ZA,NL,2022.0,22,22,0
IT,BY,2014.0,1,1,0
AU,IQ,2018.0,21,15,6
DE,BG,2014.0,21,27,-6
MK,GR,2009.0,6,5,1
BG,GB,2016.0,12,15,-3
BE,RE,2019.0,2,1,1
US,VG,2014.0,18,16,2
GB,ZW,2011.0,4,4,0
IL,CN,2007.0,18,11,7
CA,BG,2017.0,2,3,-1
AT,FR,2003.0,17,21,-4
ZA,TH,1998.0,1,1,0
BD,MA,2011.0,4,10,-6
SE,IS,2011.0,12,22,-10
nan,SE,2011.0,46,44,2
AM,IT,2014.0,26,29,-3
RU,KZ,2002.0,11,11,0
VE,MX,2001.0,21,11,10
CZ,SE,2003.0,7,5,2
IT,RU,2005.0,15,31,-16
UA,BG,2017.0,10,10,0
CH,CN,2000.0,23,22,1
GB,SK,1998.0,19,20,-1
RU,PT,2008.0,3,7,-4
MY,CZ,2016.0,19,20,-1
OM,UA,2018.0,2,1,1
RS,CN,2018.0,5,6,-1
MY,YE,2013.0,6,2,4
CR,BR,2012.0,10,8,2
PK,DE,2010.0,18,12,6
CH,GR,2009.0,7,13,-6
RO,SE,2001.0,5,1,4
UZ,IN,2002.0,1,1,0
NL,HK,2014.0,16,13,3
DE,PT,2005.0,28,16,12
SK,IT,2004.0,2,4,-2
DE,BY,2009.0,4,13,-9
TR,DK,2018.0,16,8,8
JP,CO,2012.0,14,7,7
AM,KR,2002.0,10,9,1
KR,KP,2019.0,18,2,16
IE,DK,2009.0,7,5,2
BG,US,1999.0,26,13,13
DK,IR,2008.0,3,2,1
CN,GE,2018.0,4,4,0
GE,CN,2019.0,4,5,-1
AU,CO,2018.0,13,17,-4
TW,CH,2011.0,5,3,2
NO,KR,2001.0,1,3,-2
CL,PA,2022.0,3,7,-4
AT,CN,2020.0,21,25,-4
CU,AR,1999.0,6,6,0
ZA,CH,2013.0,18,9,9
DE,EE,2003.0,11,9,2
UA,AU,2008.0,4,1,3
AU,GE,2006.0,2,1,1
PT,SE,2015.0,18,13,5
BD,DE,2021.0,13,19,-6
PT,SA,2015.0,5,2,3
NZ,ZA,2011.0,15,15,0
GH,ZM,2007.0,4,2,2
CN,KR,1998.0,25,24,1
NO,IN,2008.0,12,23,-11
RS,SK,1997.0,4,1,3
BR,RO,2006.0,1,3,-2
DE,PT,2002.0,11,8,3
RS,IT,2009.0,6,6,0
SE,LT,2020.0,6,5,1
IN,KE,2015.0,6,11,-5
PK,CA,2012.0,27,18,9
FI,GR,2011.0,3,3,0
NO,ES,2015.0,26,24,2
ID,CN,2005.0,12,4,8
HN,ES,2021.0,6,8,-2
NL,PL,2020.0,26,29,-3
QA,PL,2020.0,1,1,0
IT,GR,2011.0,23,23,0
VN,GR,2004.0,3,2,1
EG,CH,2015.0,4,11,-7
TR,CN,2009.0,7,12,-5
NG,CN,2002.0,1,3,-2
FI,AT,1997.0,4,1,3
BD,NP,2011.0,5,2,3
ID,CN,2002.0,2,4,-2
CN,NO,2007.0,25,18,7
GB,AL,2019.0,3,3,0
FI,AU,2021.0,14,22,-8
US,CI,2019.0,6,5,1
CA,BG,2019.0,2,6,-4
AU,AE,2021.0,18,9,9
RO,IE,2015.0,4,2,2
PH,PK,2018.0,1,4,-3
TW,CA,2011.0,38,41,-3
MY,CH,2015.0,3,4,-1
GH,OM,2022.0,5,7,-2
NP,TR,2017.0,3,2,1
CZ,JP,2019.0,24,25,-1
UA,BR,2010.0,4,4,0
RO,CN,2015.0,3,11,-8
PK,CH,1999.0,5,3,2
KR,BE,2021.0,7,4,3
PL,UA,2007.0,7,17,-10
ME,DE,2011.0,1,2,-1
CZ,HU,2004.0,2,7,-5
EG,FI,2019.0,4,3,1
GH,KR,2017.0,1,1,0
NG,IL,2021.0,1,2,-1
AR,IL,2019.0,4,2,2
ID,SA,2015.0,12,12,0
CZ,JP,2010.0,16,9,7
IT,RS,2014.0,7,10,-3
PL,PT,2019.0,8,6,2
PL,PT,2017.0,4,9,-5
nan,CZ,2008.0,14,9,5
SA,CY,2015.0,1,2,-1
US,MT,2021.0,9,2,7
MX,GT,2009.0,6,3,3
AE,AU,2005.0,2,7,-5
SE,JP,1999.0,31,21,10
MW,GB,2003.0,8,3,5
KR,KP,2017.0,13,3,10
EC,DE,2016.0,6,6,0
HK,CN,2007.0,11,53,-42
LU,US,2011.0,10,16,-6
nan,NZ,2013.0,7,1,6
NI,ES,2020.0,4,10,-6
GR,JO,2005.0,4,5,-1
HU,GR,2016.0,3,4,-1
IN,PE,2014.0,3,1,2
IT,TR,2011.0,11,14,-3
MY,UA,2007.0,2,1,1
FR,BG,2020.0,7,1,6
FI,JP,2008.0,14,15,-1
TR,FR,2003.0,11,12,-1
FI,NL,2011.0,30,35,-5
GB,UA,1997.0,2,7,-5
IL,NL,2012.0,13,15,-2
ID,RO,2016.0,2,3,-1
BD,KW,2006.0,2,2,0
AT,SE,2006.0,10,14,-4
MX,FR,2011.0,52,44,8
US,MK,2009.0,9,8,1
US,CI,2017.0,7,5,2
NO,BD,2017.0,9,1,8
UA,FR,2012.0,12,12,0
BE,MD,2006.0,4,2,2
UG,NZ,1997.0,2,1,1
GR,CZ,2016.0,14,6,8
MT,JP,2003.0,1,2,-1
US,BY,2010.0,15,11,4
HR,ME,2016.0,6,1,5
AE,JO,2011.0,4,10,-6
CA,LU,2010.0,2,1,1
CL,DK,2014.0,2,9,-7
AM,JP,2001.0,4,3,1
EG,ZA,2022.0,4,6,-2
US,TN,2017.0,33,30,3
CN,CZ,2016.0,15,23,-8
MX,RU,2004.0,10,13,-3
CA,MT,2013.0,1,1,0
GE,DE,2015.0,3,3,0
DK,MX,2020.0,5,14,-9
GB,SK,1997.0,17,14,3
NL,nan,1998.0,18,19,-1
UA,BR,2017.0,7,4,3
RU,KZ,2005.0,10,5,5
CH,NO,2009.0,21,17,4
RO,HK,2016.0,16,11,5
ET,TZ,2020.0,2,2,0
JO,US,2008.0,25,65,-40
EG,MY,2011.0,22,16,6
NO,IS,2009.0,4,5,-1
CH,MA,2014.0,5,2,3
AE,MY,2022.0,8,14,-6
NL,GR,2017.0,32,40,-8
RU,SG,2013.0,3,4,-1
BR,JP,2008.0,34,49,-15
XK,RS,2011.0,5,5,0
RU,BD,2022.0,1,1,0
DE,NO,2001.0,17,22,-5
KH,CH,1999.0,1,1,0
CA,RO,2009.0,12,10,2
RO,nan,2016.0,1,2,-1
GB,UA,1998.0,3,6,-3
SK,AT,2002.0,4,12,-8
YE,DE,2020.0,3,2,1
UG,GB,2006.0,8,6,2
BR,CZ,1998.0,1,5,-4
BE,LT,2012.0,3,3,0
NE,US,2018.0,3,3,0
SI,SK,1998.0,1,1,0
IS,CH,2008.0,3,1,2
US,GA,2008.0,1,2,-1
CO,FR,2006.0,12,9,3
CZ,AU,2003.0,3,6,-3
CZ,RU,1999.0,9,6,3
AU,PL,1998.0,7,2,5
DE,SS,2013.0,1,1,0
RU,BE,2016.0,22,24,-2
AT,ZA,2010.0,3,3,0
PL,ID,2017.0,6,1,5
nan,MD,2001.0,1,1,0
NZ,JP,1999.0,13,13,0
CA,CU,2010.0,1,5,-4
NP,NL,2014.0,2,5,-3
US,BY,2019.0,8,16,-8
PK,NZ,2014.0,6,6,0
EG,IN,2012.0,9,4,5
GB,VN,2022.0,11,14,-3
CM,CN,2021.0,3,7,-4
FR,EC,2009.0,4,2,2
AE,FR,2014.0,5,12,-7
BE,PE,2015.0,6,4,2
CU,PE,2021.0,11,15,-4
PL,AT,1997.0,4,3,1
NE,FR,2015.0,16,22,-6
DE,TW,2005.0,13,14,-1
JP,ZM,2000.0,2,2,0
UA,RS,2011.0,2,1,1
RU,VG,2020.0,1,1,0
GB,MA,2010.0,5,5,0
CN,IN,2001.0,20,32,-12
CH,BR,2003.0,13,12,1
CZ,GE,2009.0,1,2,-1
ET,TW,2016.0,2,1,1
AT,UA,2011.0,1,3,-2
SG,IT,2022.0,4,9,-5
DK,SK,2014.0,4,5,-1
BR,SK,2017.0,2,2,0
MX,AF,2020.0,2,3,-1
BJ,CI,2020.0,1,3,-2
PT,IN,2001.0,1,2,-1
SK,HU,2005.0,10,6,4
SK,CN,2007.0,4,1,3
MU,CN,2014.0,1,2,-1
AU,VG,2000.0,1,1,0
US,DO,2021.0,4,3,1
LV,PL,2001.0,1,2,-1
IN,RU,2023.0,2,2,0
JP,AE,2015.0,4,1,3
DE,TW,2002.0,10,14,-4
MN,RU,2018.0,5,6,-1
NL,CO,2014.0,13,8,5
DE,NP,2020.0,6,4,2
GB,LV,2012.0,3,1,2
CH,PT,2006.0,9,7,2
NL,HR,2014.0,3,8,-5
ID,MX,2015.0,1,3,-2
PL,ID,2019.0,4,7,-3
EG,BE,2019.0,5,13,-8
BE,SI,2020.0,6,6,0
UA,RU,2023.0,4,1,3
DO,DE,2013.0,1,1,0
UA,RO,2016.0,5,3,2
EG,RO,2021.0,1,1,0
JP,TH,2023.0,3,2,1
IT,UA,2004.0,8,12,-4
US,OM,1999.0,6,1,5
CN,BY,2006.0,1,5,-4
SK,GE,2011.0,8,1,7
TJ,UZ,2021.0,9,4,5
US,BG,2022.0,13,10,3
RS,GR,1998.0,1,1,0
GR,NO,2006.0,3,1,2
TR,AU,2014.0,15,10,5
GR,MK,2009.0,5,6,-1
VE,BE,2011.0,1,1,0
DK,nan,2010.0,11,20,-9
BE,PT,2003.0,3,7,-4
US,ZW,2009.0,6,8,-2
PK,TR,2011.0,7,5,2
FR,CZ,2003.0,18,18,0
DK,IN,2009.0,5,15,-10
SA,MY,1997.0,1,1,0
ZA,TR,2017.0,3,6,-3
AL,AE,2018.0,1,1,0
IN,GY,2016.0,1,1,0
EG,FI,2017.0,4,1,3
NL,TR,2018.0,35,50,-15
TH,SG,2018.0,4,7,-3
FI,NO,2006.0,7,9,-2
PL,IL,2018.0,14,10,4
TR,PT,2016.0,3,5,-2
BE,IS,2013.0,2,3,-1
VN,RU,2012.0,4,7,-3
OM,IN,2003.0,4,3,1
CU,ES,1997.0,15,12,3
SE,IL,2012.0,6,7,-1
TH,IN,2010.0,5,1,4
UA,BR,2019.0,5,13,-8
PK,ZA,2020.0,1,9,-8
SI,HU,2021.0,1,2,-1
AT,CZ,2007.0,6,16,-10
IL,AU,2000.0,10,6,4
QA,NL,2016.0,3,2,1
AE,TR,2007.0,2,1,1
MN,DZ,2022.0,2,4,-2
PK,PL,2006.0,5,6,-1
LT,DE,2018.0,10,7,3
NO,SI,2014.0,2,4,-2
TT,JM,2002.0,4,5,-1
IN,nan,2005.0,13,6,7
BH,TN,2022.0,3,1,2
HK,RO,2019.0,7,3,4
ZA,GH,2023.0,2,1,1
JO,CA,2011.0,11,12,-1
NG,JP,2000.0,3,1,2
CA,BG,2010.0,1,4,-3
RS,SK,1998.0,4,6,-2
MZ,RU,2013.0,13,10,3
RU,EE,2005.0,1,6,-5
CZ,NP,2019.0,1,1,0
BE,AT,1998.0,6,4,2
KR,CO,2012.0,9,7,2
IN,IL,2003.0,11,12,-1
AE,DE,2019.0,10,14,-4
BF,GH,2019.0,3,3,0
UZ,JP,2009.0,5,5,0
nan,FI,2006.0,7,8,-1
US,BH,2006.0,10,8,2
AU,RU,2001.0,7,11,-4
AU,SI,2020.0,4,4,0
RU,IS,2010.0,1,1,0
IN,TR,2008.0,9,12,-3
SE,SA,2022.0,11,4,7
SN,CG,2007.0,1,2,-1
CZ,FI,1997.0,1,1,0
HU,HR,2013.0,3,3,0
SK,nan,2019.0,3,1,2
DK,nan,2017.0,28,15,13
CM,GB,2012.0,9,1,8
LT,RU,2014.0,4,6,-2
BF,CA,2016.0,2,4,-2
BE,RW,2011.0,6,5,1
HU,PL,2008.0,11,18,-7
LK,CN,2021.0,3,9,-6
NL,GH,2010.0,5,3,2
ZA,nan,2002.0,1,5,-4
BR,GH,2017.0,3,1,2
AR,PK,2009.0,13,5,8
AT,IN,2021.0,12,13,-1
NO,ZM,2019.0,2,2,0
PL,PT,2010.0,4,4,0
IT,DK,2023.0,1,3,-2
US,CW,2012.0,1,1,0
LB,SY,2017.0,2,2,0
CA,LU,2019.0,5,6,-1
CL,PT,2006.0,7,3,4
nan,IN,1998.0,6,8,-2
NA,ZA,2018.0,10,19,-9
PE,VE,2001.0,1,2,-1
QA,JP,2018.0,5,1,4
ZA,FI,2009.0,2,1,1
PE,BR,2000.0,3,4,-1
BD,NL,2019.0,3,7,-4
IL,PL,2020.0,4,15,-11
PH,CN,2022.0,10,23,-13
SA,CA,2000.0,6,16,-10
RS,XK,2011.0,5,5,0
JP,PR,2006.0,5,1,4
AE,PK,2007.0,4,4,0
AU,ET,2018.0,7,20,-13
UA,JP,2020.0,5,4,1
nan,CM,2018.0,10,10,0
US,LA,2019.0,1,1,0
KR,BD,2008.0,7,8,-1
AU,PL,1997.0,3,2,1
TZ,ZW,2019.0,3,2,1
PG,AU,2009.0,3,5,-2
TH,CH,2010.0,2,1,1
SG,ID,2014.0,9,5,4
US,UZ,2013.0,5,4,1
AL,US,2012.0,3,4,-1
BR,PK,2013.0,6,1,5
RU,IE,2017.0,8,4,4
VN,DE,2012.0,5,13,-8
BR,GH,2019.0,2,4,-2
OM,JO,2022.0,1,5,-4
PK,IR,2006.0,1,3,-2
DE,HK,2014.0,2,1,1
HK,SE,2015.0,1,1,0
HK,BR,2018.0,1,1,0
GB,ID,2001.0,4,1,3
KH,IN,2022.0,2,1,1
CA,ID,2012.0,10,8,2
ID,KW,2018.0,2,3,-1
US,BA,2017.0,7,6,1
KZ,UA,2019.0,10,9,1
NO,PL,2020.0,6,17,-11
CH,ID,2018.0,4,4,0
JP,GH,2008.0,3,1,2
PT,CA,1997.0,3,4,-1
nan,TW,2018.0,2,4,-2
IL,BE,2004.0,1,4,-3
PL,VN,2015.0,5,5,0
AU,EC,2019.0,6,4,2
GR,AR,2019.0,1,1,0
SJ,US,2018.0,1,3,-2
ES,CR,1999.0,7,8,-1
CL,VE,2002.0,8,8,0
MX,CN,2003.0,6,5,1
SK,IN,2011.0,2,2,0
DK,nan,2019.0,15,29,-14
NZ,SE,2013.0,11,4,7
JP,NG,2002.0,6,4,2
GR,BG,2016.0,4,1,3
BR,ST,2017.0,16,26,-10
FR,PS,2006.0,1,1,0
PA,CA,2014.0,5,10,-5
IN,LY,2015.0,2,1,1
AU,nan,2023.0,1,1,0
IE,CL,2010.0,2,3,-1
GR,QA,2020.0,4,4,0
TR,AT,2012.0,5,10,-5
PA,DE,2020.0,4,6,-2
ES,PY,2008.0,5,2,3
DZ,MN,2018.0,1,4,-3
HU,RU,2002.0,3,4,-1
PE,CN,2014.0,2,2,0
EG,BE,2010.0,6,2,4
HR,CZ,2013.0,8,7,1
AM,DE,2008.0,3,1,2
FI,SA,2012.0,1,1,0
SG,PL,2011.0,3,2,1
UA,CZ,2007.0,5,15,-10
KR,TH,2018.0,13,15,-2
TN,PT,2021.0,4,4,0
YE,IQ,2017.0,2,2,0
BY,DE,1998.0,6,2,4
ID,GH,2016.0,6,13,-7
SA,EG,1997.0,8,10,-2
TR,AZ,2000.0,4,2,2
VN,NL,2011.0,5,3,2
AE,MN,2011.0,1,1,0
KR,ZA,2014.0,6,5,1
IN,TN,2020.0,2,2,0
CL,BR,2001.0,10,14,-4
ES,LU,2011.0,3,1,2
GB,MA,2019.0,10,7,3
NP,NO,2014.0,4,2,2
NZ,LU,2014.0,1,1,0
CR,DO,2021.0,1,1,0
PR,US,2016.0,7,1,6
EG,BH,2020.0,7,11,-4
BR,SG,2015.0,6,4,2
DE,CU,2007.0,2,5,-3
PH,MY,2022.0,3,1,2
PH,CH,2004.0,1,3,-2
HU,SA,2023.0,1,1,0
PY,CO,2022.0,3,5,-2
BY,IT,2003.0,2,2,0
FR,BY,2000.0,1,2,-1
IE,SI,2019.0,1,1,0
IL,ZA,2000.0,1,1,0
TH,CH,2017.0,4,5,-1
MD,BE,2007.0,6,1,5
UA,KR,2001.0,1,1,0
JP,BG,1998.0,1,3,-2
ZM,BR,2006.0,2,2,0
GB,VE,2007.0,11,7,4
PF,BE,2019.0,3,1,2
NO,BD,2010.0,2,2,0
GR,VN,2013.0,2,11,-9
TR,IL,2020.0,2,4,-2
GB,UG,2013.0,9,9,0
NL,GH,2019.0,5,6,-1
LY,JO,2022.0,1,2,-1
UA,GE,2019.0,3,1,2
RU,VN,2021.0,6,8,-2
LB,SY,2019.0,5,4,1
TH,NP,2019.0,4,3,1
LU,GB,2023.0,1,1,0
BE,MA,1999.0,3,1,2
BR,DO,2016.0,2,3,-1
IT,KR,2001.0,2,5,-3
PL,TW,2011.0,1,1,0
IT,QA,2014.0,1,1,0
DE,LV,2000.0,3,4,-1
PK,IT,2018.0,5,13,-8
SK,HU,2002.0,4,4,0
AR,MY,2016.0,6,1,5
SD,ID,2016.0,3,2,1
AU,IL,2006.0,10,11,-1
UG,SE,2008.0,2,2,0
FR,IQ,2015.0,6,2,4
ET,NP,2021.0,1,1,0
US,LA,2017.0,3,1,2
SK,nan,2017.0,2,3,-1
AR,BE,2022.0,3,5,-2
AT,US,2023.0,7,8,-1
MN,JP,2009.0,1,2,-1
DO,ES,2016.0,3,8,-5
BD,PK,2000.0,3,2,1
IE,SI,2017.0,1,5,-4
RU,MA,2002.0,1,1,0
MA,GB,2004.0,4,2,2
JO,OM,2012.0,2,4,-2
IR,ES,2009.0,5,3,2
GH,CA,2003.0,1,1,0
KE,CO,2004.0,2,1,1
IN,SY,2018.0,6,2,4
BY,CN,2014.0,9,1,8
CA,GR,2013.0,7,18,-11
FR,LT,2011.0,4,2,2
MA,IN,2021.0,4,6,-2
DK,RO,2014.0,4,4,0
FR,VN,2003.0,7,8,-1
AZ,GB,2016.0,1,3,-2
MX,ZA,2013.0,1,1,0
VE,CA,2018.0,8,2,6
BR,PH,2011.0,3,2,1
CO,PK,2021.0,1,2,-1
KE,PK,2022.0,4,4,0
IE,CL,2017.0,5,4,1
UA,ES,2016.0,3,1,2
PK,NG,2011.0,3,7,-4
BE,MZ,2014.0,4,4,0
NO,NL,1997.0,6,10,-4
GB,NG,2006.0,6,20,-14
MX,SG,2003.0,5,5,0
VG,JP,2018.0,2,2,0
NO,CH,2023.0,1,3,-2
US,BA,2010.0,5,1,4
US,CY,2021.0,9,13,-4
KH,NZ,2018.0,2,1,1
CZ,DK,1998.0,1,2,-1
US,GH,2005.0,5,3,2
BG,SE,2004.0,3,3,0
ID,NG,2010.0,1,1,0
QA,AE,2020.0,9,6,3
MU,GB,2001.0,1,2,-1
US,BJ,1999.0,1,2,-1
SE,BD,2006.0,4,2,2
PE,CA,2004.0,2,2,0
ES,NO,2000.0,6,12,-6
HU,GE,2019.0,1,1,0
BR,IN,2000.0,5,7,-2
UZ,PL,2005.0,7,2,5
MX,IN,2022.0,8,8,0
SE,LK,2009.0,4,1,3
IS,LU,2014.0,4,1,3
US,CI,2010.0,1,1,0
EE,KR,2021.0,1,1,0
NZ,BR,2013.0,5,8,-3
LI,CH,2007.0,1,1,0
TW,IE,2012.0,2,3,-1
CH,BD,2014.0,3,3,0
FR,BO,1999.0,1,1,0
IN,VG,2015.0,2,1,1
SD,NG,2019.0,3,8,-5
LB,CN,2003.0,2,2,0
MD,DE,2011.0,3,2,1
AZ,RU,2004.0,6,5,1
PT,KR,2013.0,2,13,-11
PH,CU,2014.0,1,1,0
GH,CN,2008.0,1,1,0
LT,NL,2002.0,1,1,0
JP,LU,2009.0,3,1,2
IN,TT,2021.0,4,4,0
CA,CU,2017.0,2,8,-6
NG,GH,2002.0,2,1,1
AU,TN,2016.0,2,1,1
CA,LU,2017.0,2,8,-6
TR,JO,2007.0,2,3,-1
NG,GH,2005.0,2,1,1
CA,VG,2011.0,2,1,1
nan,IN,1997.0,4,3,1
DK,CL,2021.0,3,3,0
RS,PK,2016.0,1,3,-2
CN,AZ,2021.0,3,2,1
CN,LT,2017.0,4,4,0
SA,CZ,2018.0,2,7,-5
BF,BE,2018.0,3,4,-1
US,LT,2000.0,2,2,0
BG,BR,1998.0,2,1,1
CZ,CN,1999.0,4,3,1
HK,TW,2020.0,3,1,2
JP,CM,2010.0,1,1,0
SE,CO,2009.0,3,1,2
GE,CN,2017.0,6,5,1
TH,BD,2020.0,4,4,0
NL,RO,2007.0,9,2,7
EE,IT,1997.0,1,1,0
SN,CI,2019.0,4,2,2
MX,FI,2018.0,2,3,-1
CH,EE,2003.0,1,2,-1
CA,AM,2012.0,1,1,0
KE,TZ,2007.0,2,2,0
SE,GH,2014.0,1,2,-1
EG,SY,2013.0,1,1,0
MX,TR,2006.0,4,2,2
JM,BB,2013.0,4,7,-3
LV,SE,2000.0,1,3,-2
AR,IL,2010.0,2,3,-1
ST,US,2012.0,1,3,-2
BE,VN,2004.0,4,1,3
RO,NO,2016.0,1,3,-2
IN,MW,2014.0,1,1,0
SN,CA,2016.0,1,8,-7
MY,SE,2017.0,7,9,-2
SA,ES,2008.0,2,4,-2
SG,BE,2013.0,2,4,-2
GB,CU,2017.0,4,5,-1
JP,AR,1997.0,2,3,-1
SY,CN,2001.0,3,3,0
RU,BR,2004.0,6,6,0
AL,AT,2018.0,2,1,1
PY,PE,2018.0,3,4,-1
TR,QA,2017.0,4,3,1
FI,BD,2014.0,3,2,1
PT,SK,2013.0,3,1,2
MN,CH,2019.0,1,1,0
FR,KW,2020.0,6,1,5
GB,KN,2022.0,2,1,1
ZA,CI,2022.0,1,1,0
ZA,CD,2015.0,3,1,2
IL,LK,2014.0,2,1,1
IE,PL,2022.0,2,3,-1
DE,AL,2003.0,2,1,1
JP,CY,2008.0,1,2,-1
CA,MD,2001.0,1,1,0
BY,DE,1997.0,4,2,2
ID,AU,2023.0,2,1,1
NL,NG,2005.0,1,1,0
CR,VE,2005.0,2,2,0
BN,IN,2018.0,2,5,-3
BA,CZ,2006.0,1,1,0
NO,BE,1998.0,3,5,-2
GE,CN,2010.0,3,2,1
AT,EC,2017.0,1,1,0
FR,AL,2015.0,1,1,0
CN,ID,1999.0,1,3,-2
BI,FR,2002.0,4,14,-10
DK,SI,2018.0,2,5,-3
MT,ES,2020.0,1,1,0
VG,RU,2020.0,1,1,0
IN,DZ,2020.0,2,1,1
VE,UY,2015.0,5,2,3
RU,CZ,2023.0,3,3,0
CA,MW,2021.0,1,1,0
DE,DO,2015.0,1,1,0
UY,PT,2001.0,1,1,0
SD,ES,2016.0,1,2,-1
SG,BN,2018.0,3,1,2
GR,FI,2005.0,3,1,2
PH,NL,2005.0,1,1,0
ID,CH,2004.0,1,1,0
KZ,BY,2019.0,2,1,1
PL,PK,2009.0,4,5,-1
CY,IT,2020.0,3,7,-4
ID,JP,1999.0,3,16,-13
EC,GB,2017.0,3,13,-10
DK,GR,2003.0,2,2,0
JP,SV,2006.0,2,1,1
HN,CA,2017.0,1,1,0
IT,NG,2006.0,3,8,-5
EC,PT,2022.0,2,4,-2
NZ,ID,2021.0,7,6,1
KE,MY,2016.0,1,4,-3
SA,JO,2004.0,3,2,1
UA,IT,2022.0,9,4,5
SE,ZA,1999.0,2,1,1
BE,BJ,2009.0,3,1,2
UZ,PL,2002.0,1,3,-2
nan,CU,2013.0,1,3,-2
AU,VE,2005.0,2,1,1
NP,SE,2011.0,2,2,0
AU,RO,2008.0,1,3,-2
nan,CL,2002.0,1,2,-1
RU,IS,2019.0,2,2,0
CU,GB,2022.0,1,1,0
US,MD,2019.0,5,7,-2
ZA,LS,2013.0,3,1,2
AU,HK,2007.0,2,2,0
PG,GB,2004.0,2,3,-1
TR,QA,2019.0,5,4,1
PA,JP,2015.0,1,2,-1
KW,IE,2011.0,1,3,-2
AU,AM,2008.0,1,2,-1
TH,DK,2012.0,1,1,0
IE,EG,2005.0,1,1,0
DE,GA,2000.0,1,2,-1
GL,DK,2001.0,1,1,0
RS,IN,2021.0,2,3,-1
UZ,US,2013.0,4,5,-1
KR,IR,2010.0,1,3,-2
KR,FI,2018.0,3,2,1
IE,GR,2021.0,3,7,-4
CY,CA,2014.0,1,1,0
CM,BI,2007.0,1,1,0
LB,KW,2022.0,1,1,0
AE,DZ,2013.0,1,1,0
KZ,BY,2017.0,2,3,-1
IN,PH,2004.0,1,4,-3
MY,SE,2010.0,1,5,-4
BN,MY,2023.0,1,2,-1
UG,JP,2008.0,1,1,0
PK,JO,2017.0,3,3,0
HU,ZA,2001.0,1,1,0
AE,AU,2002.0,1,1,0
IT,BG,2000.0,1,5,-4
ZW,MX,2014.0,3,1,2
JP,PT,2003.0,2,4,-2
MA,PL,2020.0,1,1,0
TN,JP,2020.0,2,1,1
PL,AT,1998.0,1,3,-2
GR,SD,2010.0,1,1,0
AU,RE,2019.0,1,1,0
ES,AE,2012.0,3,2,1
EC,NL,2017.0,4,5,-1
GE,AZ,2010.0,1,7,-6
FR,UG,2009.0,1,3,-2
TR,MD,2010.0,1,2,-1
MT,US,2019.0,4,14,-10
LK,BD,2009.0,1,1,0
NZ,PT,2003.0,1,2,-1
AE,TW,2016.0,2,1,1
US,NC,2011.0,3,3,0
IN,BY,2015.0,2,5,-3
ID,CL,2022.0,5,1,4
TT,NG,2019.0,1,1,0
NL,SE,2023.0,4,3,1
CA,NG,2011.0,4,13,-9
BY,NL,2011.0,2,3,-1
VN,EE,2022.0,1,1,0
NZ,FI,2021.0,2,3,-1
AU,VE,2002.0,1,2,-1
QA,SG,2015.0,1,2,-1
MX,GR,2014.0,5,3,2
IL,IT,2016.0,6,18,-12
LK,SE,2009.0,1,4,-3
SV,US,2013.0,2,1,1
GB,DZ,2011.0,4,3,1
BR,HK,2019.0,2,1,1
AU,BW,2020.0,3,2,1
PS,ID,2022.0,2,1,1
JP,AR,1998.0,2,4,-2
FI,CZ,2001.0,3,2,1
ES,DO,2006.0,1,3,-2
CN,PE,2019.0,2,2,0
UZ,RS,2005.0,4,1,3
TW,QA,2015.0,3,1,2
RO,LK,2013.0,1,1,0
SE,CH,2007.0,55,45,10
US,SG,2012.0,383,303,80
ZA,US,2005.0,201,204,-3
YE,SA,2016.0,19,7,12
DK,US,2003.0,160,157,3
BI,FR,2005.0,19,14,5
PK,US,2014.0,203,235,-32
HU,GB,2005.0,30,32,-2
IE,CH,2011.0,12,12,0
AU,TZ,2020.0,4,3,1
nan,NL,2015.0,87,73,14
GB,PK,2021.0,137,178,-41
PT,PH,2017.0,1,2,-1
ID,NG,2017.0,6,16,-10
US,BO,2004.0,4,5,-1
MX,CU,2003.0,14,30,-16
FR,MD,2006.0,53,57,-4
IE,JP,1998.0,10,15,-5
DE,IT,2021.0,291,301,-10
NG,ZA,2018.0,128,117,11
JP,ID,2011.0,127,44,83
ES,PH,2022.0,14,12,2
SG,DE,2012.0,28,36,-8
SA,PK,2021.0,82,82,0
GB,IQ,2017.0,102,39,63
CA,MX,2001.0,16,14,2
CR,MX,2014.0,32,23,9
FI,CH,2012.0,25,20,5
HU,CU,2019.0,1,1,0
TT,US,2014.0,8,6,2
BE,SE,2002.0,12,15,-3
CR,nan,2016.0,3,3,0
DE,CN,1998.0,57,71,-14
nan,MY,2013.0,75,48,27
RU,IE,2019.0,5,14,-9
TW,SG,2016.0,63,38,25
ID,NG,2019.0,20,26,-6
GB,QA,1999.0,2,4,-2
BE,CA,2001.0,35,21,14
IT,FI,1999.0,8,5,3
EG,CN,2020.0,46,47,-1
NL,IR,2020.0,28,62,-34
ZA,US,2002.0,180,136,44
PS,ES,2018.0,12,20,-8
NI,UA,2021.0,23,15,8
IR,MA,2018.0,19,8,11
CN,AU,2023.0,141,23,118
EE,FI,2014.0,17,11,6
GB,PH,2014.0,19,17,2
GB,NZ,2006.0,205,171,34
CZ,FR,2020.0,30,49,-19
SE,IR,2022.0,8,26,-18
FR,NC,1999.0,8,4,4
DE,HR,2012.0,18,13,5
GB,AT,2000.0,24,34,-10
AU,AR,2022.0,4,6,-2
GH,KR,2019.0,2,4,-2
FR,CG,2009.0,12,18,-6
IT,RO,2008.0,17,10,7
FR,KE,2017.0,8,7,1
NL,ES,2008.0,68,62,6
CZ,EE,2018.0,4,4,0
HK,RO,2010.0,13,13,0
CN,GB,1997.0,59,101,-42
IN,nan,2002.0,4,7,-3
PK,KR,2013.0,18,15,3
NG,DE,2016.0,4,8,-4
AU,TW,2018.0,37,48,-11
PH,KR,2021.0,12,11,1
BR,SE,2016.0,34,30,4
PT,AT,2014.0,10,2,8
ZA,CR,2015.0,9,4,5
IR,RU,2020.0,13,10,3
MX,VE,2012.0,40,40,0
GB,SS,2015.0,5,6,-1
BR,SI,2012.0,1,2,-1
US,GH,2002.0,7,6,1
FR,HR,2009.0,2,1,1
SA,PS,2016.0,4,2,2
DE,PH,2011.0,10,3,7
FR,KE,2010.0,6,9,-3
ZM,JP,2009.0,2,5,-3
FI,MX,2015.0,4,3,1
RE,BE,2016.0,1,2,-1
SD,US,2015.0,12,11,1
EG,MX,2019.0,1,2,-1
LU,DE,2023.0,2,1,1
US,QA,2023.0,4,8,-4
HR,DE,2008.0,17,25,-8
BF,FR,2014.0,9,15,-6
ML,BJ,2019.0,1,2,-1
ES,PS,2019.0,17,15,2
NL,TW,2000.0,1,1,0
SK,RU,2009.0,8,13,-5
SK,AT,2005.0,13,7,6
IL,CO,2018.0,5,8,-3
CA,BJ,2020.0,4,2,2
NL,TH,2011.0,5,7,-2
PT,MZ,2011.0,3,3,0
BR,TW,2009.0,1,2,-1
BW,IN,2012.0,3,2,1
JP,AT,2006.0,8,8,0
PE,FR,2015.0,12,10,2
RU,PK,2008.0,1,1,0
TR,GB,1999.0,14,51,-37
FR,BJ,2003.0,5,8,-3
SY,SA,2020.0,5,10,-5
KE,RW,2022.0,4,2,2
AU,PH,2020.0,11,27,-16
BR,DK,2008.0,6,4,2
QA,CL,2021.0,1,1,0
TR,BE,2007.0,4,5,-1
SG,PT,2015.0,1,1,0
NZ,AE,2020.0,6,1,5
NL,LK,1998.0,2,1,1
GT,ES,2016.0,12,14,-2
IT,CM,2020.0,5,7,-2
CM,IN,2018.0,2,3,-1
EC,FR,2003.0,2,3,-1
MW,KR,2019.0,1,1,0
NC,AU,2014.0,2,1,1
AU,NO,2014.0,22,17,5
ID,NL,2007.0,4,8,-4
HR,RU,2014.0,4,2,2
CA,ET,2007.0,2,2,0
NP,JP,2022.0,7,3,4
DE,IQ,2020.0,9,11,-2
CY,RO,2019.0,1,1,0
FI,HU,2016.0,9,14,-5
AE,nan,2020.0,3,6,-3
AU,EC,2017.0,2,3,-1
SN,US,2002.0,3,4,-1
UA,MZ,2011.0,2,5,-3
KE,ZM,2014.0,2,2,0
RU,AM,2001.0,4,3,1
IL,EC,2021.0,2,5,-3
HR,ES,2011.0,7,1,6
GB,ZM,2006.0,1,3,-2
TZ,MW,2008.0,1,1,0
GB,BW,2003.0,2,3,-1
KW,AU,2021.0,3,1,2
ZA,nan,2005.0,4,7,-3
HU,CN,2013.0,2,9,-7
JO,GB,1997.0,2,2,0
AU,GR,2004.0,4,3,1
MC,GB,2010.0,1,1,0
BD,TH,2004.0,1,1,0
TZ,JP,2013.0,2,3,-1
BD,SE,2022.0,5,3,2
NL,SG,1998.0,1,3,-2
DK,UA,2022.0,1,2,-1
IT,TN,2005.0,1,4,-3
CL,GT,2020.0,3,1,2
LK,MY,2015.0,2,4,-2
VE,PE,2001.0,2,1,1
BY,SI,2010.0,1,1,0
FO,DK,2002.0,1,1,0
GB,RU,2021.0,90,109,-19
CA,DE,1999.0,89,113,-24
IR,AU,2020.0,190,83,107
BE,FR,2021.0,247,307,-60
MX,HN,2012.0,18,14,4
TH,IN,2017.0,11,22,-11
PE,PH,2021.0,5,4,1
AM,KR,2005.0,10,3,7
DE,TH,2006.0,14,9,5
GB,CR,2019.0,9,8,1
BY,SI,2017.0,1,2,-1
IT,SG,2011.0,7,3,4
AT,ZA,2019.0,5,2,3
FR,NZ,2006.0,15,9,6
MA,BE,2020.0,5,10,-5
CY,FR,2012.0,2,6,-4
GH,NO,2003.0,1,1,0
BJ,US,2012.0,2,2,0
,RU,2010.0,8044,0,8044
,AU,2000.0,4936,0,4936
,ES,2013.0,13721,0,13721
AU,,2016.0,4797,0,4797
IT,,2018.0,10419,0,10419
,BR,2006.0,15751,0,15751
CN,,2011.0,27530,0,27530
,KR,2012.0,5865,0,5865
,NL,1998.0,4913,0,4913
,BE,1995.0,3901,0,3901
PT,,2019.0,1614,0,1614
,NL,1997.0,5233,0,5233
TR,,2015.0,2364,0,2364
ZW,,2024.0,828,0,828
US,,2013.0,47749,0,47749
,CN,2013.0,39316,0,39316
CH,,2023.0,17589,0,17589
GB,,2021.0,24428,0,24428
,AR,2009.0,2759,0,2759
FR,,2002.0,4092,0,4092
,SG,2014.0,1866,0,1866
QA,,2024.0,2490,0,2490
IL,,2000.0,568,0,568
PT,,2017.0,1185,0,1185
DK,,2006.0,434,0,434
ES,,2018.0,12281,0,12281
,RU,2017.0,19015,0,19015
EG,,2021.0,4357,0,4357
KR,,2003.0,466,0,466
FR,,2005.0,4347,0,4347
,ZA,2011.0,2787,0,2787
EE,,2012.0,162,0,162
RS,,2023.0,4011,0,4011
,IL,2001.0,2161,0,2161
,RO,2014.0,1789,0,1789
,HR,2010.0,1017,0,1017
UA,,2023.0,14072,0,14072
,ID,2001.0,549,0,549
GR,,2020.0,2851,0,2851
IN,,2007.0,2331,0,2331
LV,CZ,2014.0,3,0,3
,PK,2003.0,605,0,605
,MY,1999.0,531,0,531
SK,,1998.0,77,0,77
NO,,2005.0,301,0,301
ET,,2021.0,632,0,632
NO,,2002.0,305,0,305
,YE,2013.0,50,0,50
,BO,2008.0,56,0,56
FI,,2009.0,966,0,966
SG,,2011.0,471,0,471
DE,ME,2015.0,1,0,1
,DZ,2009.0,842,0,842
AU,NC,2005.0,2,0,2
PT,,2010.0,351,0,351
IT,LB,2000.0,3,0,3
MY,,2009.0,202,0,202
,HN,2009.0,33,0,33
NP,,2023.0,1626,0,1626
,MD,2002.0,101,0,101
SI,,2020.0,601,0,601
,RU,2019.0,8225,0,8225
ME,,2023.0,172,0,172
,MK,2011.0,254,0,254
,MD,2005.0,96,0,96
,HR,2017.0,725,0,725
CO,VN,2022.0,2,0,2
BG,,2013.0,245,0,245
,AL,2014.0,102,0,102
,KZ,1994.0,66,0,66
KW,,2017.0,127,0,127
CW,,2014.0,9,0,9
UY,,2012.0,65,0,65
IS,,2020.0,188,0,188
HK,,2017.0,82,0,82
,GH,2008.0,219,0,219
,UA,2007.0,1361,0,1361
,LB,2010.0,343,0,343
MQ,,2019.0,33,0,33
CI,,2025.0,9,0,9
,HR,2019.0,351,0,351
,SA,2018.0,3307,0,3307
,LB,2017.0,600,0,600
,LK,2006.0,270,0,270
HK,,2019.0,52,0,52
RU,CU,2007.0,1,0,1
PK,LR,2019.0,1,0,1
ET,MM,2018.0,2,0,2
IQ,,2025.0,200,0,200
,SV,1995.0,14,0,14
,LT,1994.0,257,0,257
MN,,2021.0,134,0,134
TJ,,2009.0,3,0,3
ZA,,2004.0,354,0,354
SG,HK,2020.0,3,0,3
NZ,,2004.0,242,0,242
,SI,2018.0,425,0,425
KE,,2007.0,71,0,71
,RW,2015.0,102,0,102
ML,TR,2021.0,1,0,1
,XK,2012.0,101,0,101
RU,SI,2004.0,2,0,2
ID,,2008.0,93,0,93
TW,CM,2018.0,1,0,1
KW,,2010.0,61,0,61
DK,LK,2022.0,1,0,1
KW,,2019.0,151,0,151
BA,,2007.0,10,0,10
MQ,,2017.0,30,0,30
SI,CA,2021.0,3,0,3
,BA,1996.0,24,0,24
CO,NG,2002.0,1,0,1
NL,SA,2011.0,7,0,7
,MV,2015.0,5,0,5
,LB,2019.0,304,0,304
BF,NL,2019.0,2,0,2
SD,NG,2017.0,3,0,3
TT,MX,2020.0,2,0,2
HK,,2010.0,25,0,25
,BA,2004.0,106,0,106
,EE,2018.0,203,0,203
BD,,2001.0,18,0,18
CV,,2022.0,4,0,4
CO,AT,2008.0,4,0,4
AT,KE,2022.0,3,0,3
GN,,2023.0,78,0,78
,CM,1994.0,118,0,118
RU,JO,2021.0,1,0,1
,AT,2020.0,150,0,150
PW,,2024.0,6,0,6
FR,FI,2023.0,2,0,2
BI,DE,2008.0,2,0,2
,BF,2000.0,34,0,34
BR,HR,2011.0,3,0,3
NZ,KE,1998.0,1,0,1
CA,SI,1999.0,2,0,2
MA,,2003.0,79,0,79
BW,SZ,2018.0,1,0,1
,ME,1996.0,7,0,7
TH,,1998.0,46,0,46
MA,TZ,2019.0,2,0,2
DE,RW,2009.0,1,0,1
,KG,2011.0,25,0,25
BY,CA,2021.0,2,0,2
GF,CG,2007.0,1,0,1
CU,nan,1998.0,1,0,1
PR,,2000.0,2,0,2
UG,MA,2014.0,1,0,1
WS,,2024.0,21,0,21
NL,DO,2013.0,1,0,1
AM,BG,2013.0,1,0,1
SD,BR,2018.0,6,0,6
EE,IT,1998.0,1,0,1
EC,,2008.0,23,0,23
KZ,EG,2018.0,4,0,4
PA,TN,2015.0,3,0,3
IR,IS,2018.0,3,0,3
LA,CO,2018.0,1,0,1
SA,PT,1997.0,1,0,1
SD,KW,2021.0,1,0,1
,ME,2004.0,19,0,19
HU,UA,2022.0,1,0,1
NI,MY,2014.0,3,0,3
UY,CH,2014.0,4,0,4
MZ,,2014.0,30,0,30
SD,,2015.0,50,0,50
IR,MX,2014.0,2,0,2
,ML,2011.0,61,0,61
,BD,2020.0,92,0,92
FR,CD,2013.0,2,0,2
MD,UA,2000.0,2,0,2
CU,GF,2016.0,1,0,1
BF,,2001.0,5,0,5
CZ,MM,2022.0,20,0,20
UZ,SY,2019.0,1,0,1
CM,,2006.0,29,0,29
AL,ZA,2003.0,1,0,1
KZ,BY,2010.0,1,0,1
NP,TR,2010.0,1,0,1
BA,GB,2001.0,2,0,2
KE,SE,2000.0,2,0,2
BR,GR,2009.0,3,0,3
JP,CM,2019.0,5,0,5
MX,SK,2000.0,2,0,2
IE,RS,2013.0,5,0,5
FO,,2017.0,4,0,4
NA,,2015.0,22,0,22
CL,PY,2003.0,3,0,3
,AO,1996.0,11,0,11
GD,,2015.0,6,0,6
,MR,2006.0,3,0,3
MX,PK,2006.0,2,0,2
BO,CZ,2018.0,1,0,1
PK,DK,1999.0,1,0,1
SG,SA,2006.0,1,0,1
AR,MT,2009.0,1,0,1
CH,ZW,2004.0,1,0,1
DE,CY,2000.0,1,0,1
SJ,GB,2018.0,1,0,1
CZ,LT,2022.0,1,0,1
KR,JM,2016.0,1,0,1
CG,MX,2010.0,1,0,1
ZA,BD,2011.0,3,0,3
GR,UZ,2017.0,3,0,3
LY,,2008.0,2,0,2
CH,NP,2014.0,2,0,2
,BZ,2000.0,4,0,4
NI,UY,2011.0,1,0,1
GE,SK,2008.0,3,0,3
SV,,2011.0,5,0,5
,VU,1997.0,2,0,2
US,SJ,2021.0,1,0,1
KN,,2017.0,5,0,5
VG,,2004.0,3,0,3
BE,ML,2019.0,3,0,3
JO,SD,2009.0,1,0,1
BR,SK,2010.0,1,0,1
,GF,2015.0,34,0,34
HU,LU,2011.0,1,0,1
MD,IT,2014.0,2,0,2
CR,NI,2006.0,1,0,1
NL,CY,2008.0,1,0,1
,LS,2007.0,9,0,9
OM,NZ,2007.0,2,0,2
SI,RO,2007.0,1,0,1
BH,ZA,2005.0,3,0,3
CM,AU,2007.0,1,0,1
GB,LY,2011.0,8,0,8
MA,SN,2004.0,1,0,1
SD,IT,2018.0,1,0,1
SK,TW,2008.0,2,0,2
MA,EG,2001.0,2,0,2
TT,BR,2001.0,1,0,1
LB,BR,2015.0,6,0,6
,CV,1994.0,1,0,1
SN,NL,2014.0,1,0,1
ZA,BW,1999.0,1,0,1
SR,,2010.0,5,0,5
TG,US,2011.0,3,0,3
GT,CL,2001.0,1,0,1
BE,TZ,2000.0,1,0,1
KN,,2019.0,4,0,4
US,LR,2012.0,1,0,1
DE,MG,2019.0,4,0,4
ZA,PE,2016.0,3,0,3
NG,BF,2015.0,1,0,1
PT,GP,1998.0,1,0,1
,PR,2007.0,12,0,12
UZ,MM,2001.0,1,0,1
CR,,1999.0,7,0,7
NZ,UA,2015.0,1,0,1
PK,SG,1997.0,2,0,2
ZW,IL,2000.0,1,0,1
PS,IN,2019.0,2,0,2
TH,GN,2019.0,1,0,1
MG,CG,2019.0,1,0,1
ID,SO,2019.0,1,0,1
MK,AU,2023.0,3,0,3
EC,BE,2002.0,2,0,2
MW,SL,2010.0,1,0,1
TW,NP,2018.0,1,0,1
AU,HR,1997.0,1,0,1
PT,SD,2005.0,1,0,1
PT,CA,1998.0,4,0,4
GP,US,2003.0,1,0,1
,WS,2015.0,3,0,3
SE,KG,2015.0,1,0,1
GE,AZ,2019.0,1,0,1
CA,ZM,2010.0,1,0,1
AE,IL,2016.0,2,0,2
,BB,2000.0,9,0,9
LT,US,2023.0,2,0,2
FI,PK,2008.0,2,0,2
FR,CY,1997.0,2,0,2
HR,SK,2006.0,1,0,1
GB,GT,2011.0,1,0,1
KG,TW,2019.0,1,0,1
TW,IL,1999.0,1,0,1
HK,MA,2010.0,2,0,2
BE,EE,1999.0,1,0,1
MA,LU,2004.0,1,0,1
IN,YE,2003.0,1,0,1
LK,ES,2015.0,6,0,6
SR,,2017.0,3,0,3
AT,MA,2015.0,1,0,1
SX,CM,2018.0,1,0,1
GH,SG,2011.0,1,0,1
,AO,2004.0,11,0,11
DZ,DE,1999.0,4,0,4
AR,KE,2015.0,1,0,1
JO,KR,2006.0,1,0,1
SE,EG,2003.0,1,0,1
BY,MZ,2007.0,2,0,2
BG,BR,1997.0,1,0,1
AT,CL,2000.0,2,0,2
HU,BY,2019.0,3,0,3
KW,CN,2011.0,1,0,1
CZ,UZ,1999.0,2,0,2
ZM,nan,2015.0,2,0,2
SK,SA,2014.0,1,0,1
SR,,2019.0,8,0,8
BD,BN,2013.0,1,0,1
PF,IN,2004.0,1,0,1
,DO,2000.0,8,0,8
ZA,RW,2013.0,4,0,4
SK,MY,2008.0,1,0,1
NL,CD,2018.0,1,0,1
DE,MG,2010.0,1,0,1
LU,PL,2007.0,1,0,1
HU,NO,2022.0,2,0,2
TN,MD,1999.0,1,0,1
PT,CM,2011.0,1,0,1
ZA,UA,2014.0,1,0,1
,NA,2020.0,1,0,1
GD,NO,2011.0,1,0,1
NG,ZM,2020.0,2,0,2
NG,LB,2021.0,1,0,1
GB,FK,2006.0,1,0,1
AT,LU,2012.0,1,0,1
JO,JP,2020.0,3,0,3
KR,UY,2019.0,1,0,1
UZ,GB,2003.0,2,0,2
DK,AE,2021.0,2,0,2
PT,PH,2010.0,1,0,1
CA,HT,2018.0,2,0,2
BY,SI,2019.0,1,0,1
QA,SI,2002.0,1,0,1
EG,SG,2011.0,3,0,3
KR,LA,2011.0,1,0,1
MY,UZ,2020.0,5,0,5
US,KN,2007.0,2,0,2
EG,PH,2002.0,1,0,1
FI,PT,2003.0,1,0,1
MQ,,2010.0,7,0,7
DZ,SA,2002.0,2,0,2
nan,MT,2020.0,1,0,1
BH,SD,2022.0,1,0,1
ET,ID,2016.0,1,0,1
PG,TH,2019.0,1,0,1
NI,SV,2012.0,1,0,1
GP,FR,2023.0,1,0,1
KG,KH,2021.0,2,0,2
SA,MY,1998.0,1,0,1
MG,BE,2014.0,1,0,1
TN,CM,2021.0,1,0,1
GR,PA,2007.0,1,0,1
PT,BG,2021.0,1,0,1
IT,MW,2019.0,1,0,1
PE,AR,1997.0,1,0,1
DE,FK,2000.0,1,0,1
ET,EG,2008.0,2,0,2
US,GY,2010.0,1,0,1
CY,RO,2017.0,1,0,1
BJ,,2000.0,4,0,4
DZ,SA,2005.0,3,0,3
PS,PK,2021.0,3,0,3
KR,CY,2012.0,2,0,2
XK,,2007.0,2,0,2
GR,AR,2010.0,1,0,1
RE,IN,2011.0,2,0,2
US,GI,2007.0,1,0,1
BR,CR,2000.0,2,0,2
HR,AU,1998.0,1,0,1
IN,AF,2016.0,2,0,2
OM,,2000.0,14,0,14
SS,ID,2019.0,1,0,1
GA,MD,2011.0,1,0,1
CN,SA,2001.0,1,0,1
,ER,2001.0,3,0,3
MG,TN,2016.0,1,0,1
UZ,SY,2010.0,2,0,2
NO,EC,2018.0,1,0,1
PA,HN,2012.0,2,0,2
AL,UA,2002.0,1,0,1
ZA,BN,2015.0,1,0,1
MW,BH,2018.0,1,0,1
KW,PS,2022.0,1,0,1
CA,SR,2018.0,1,0,1
AM,IL,1997.0,1,0,1
KE,IE,2018.0,2,0,2
PA,CR,2005.0,1,0,1
ET,PH,2020.0,3,0,3
BA,SD,2014.0,1,0,1
GM,,2015.0,2,0,2
FR,PY,2013.0,1,0,1
AL,IT,2005.0,2,0,2
MN,CH,2017.0,1,0,1
PY,PT,2022.0,1,0,1
AT,NZ,2007.0,4,0,4
FI,PH,2019.0,2,0,2
CW,RU,2008.0,1,0,1
BN,PK,2015.0,2,0,2
ER,NL,2006.0,2,0,2
HU,BY,2010.0,4,0,4
CO,NE,2018.0,1,0,1
CU,TT,2004.0,1,0,1
VE,PY,1997.0,1,0,1
BA,QA,2013.0,1,0,1
CA,NI,2020.0,1,0,1
GR,MZ,2007.0,1,0,1
TZ,FR,2012.0,4,0,4
NO,UG,2003.0,1,0,1
DZ,ES,2015.0,2,0,2
RU,EE,2002.0,3,0,3
EE,FR,2004.0,3,0,3
SG,CO,2018.0,3,0,3
MY,KY,2017.0,2,0,2
TH,PH,2000.0,1,0,1
IT,PS,2015.0,3,0,3
AU,MA,2018.0,1,0,1
SE,AE,2013.0,3,0,3
AM,NE,2016.0,1,0,1
GB,NE,2007.0,1,0,1
KR,SK,2002.0,1,0,1
DZ,TR,2012.0,2,0,2
BY,CH,2000.0,1,0,1
DE,CI,2016.0,2,0,2
NE,,2009.0,1,0,1
QA,MK,2022.0,1,0,1
IS,CZ,2006.0,1,0,1
ZM,KR,2019.0,1,0,1
TT,NL,2020.0,1,0,1
BE,AO,2019.0,1,0,1
US,HT,1997.0,2,0,2
AR,ID,2003.0,1,0,1
AU,RW,2006.0,1,0,1
TZ,BW,2013.0,2,0,2
SI,SK,1997.0,2,0,2
SG,LU,2011.0,1,0,1
GD,ZA,2010.0,1,0,1
nan,RO,2009.0,4,0,4
BE,ID,2000.0,1,0,1
BE,CR,2012.0,1,0,1
FO,,2019.0,6,0,6
GB,PS,2012.0,3,0,3
HN,BO,2013.0,1,0,1
CZ,NP,2017.0,1,0,1
PG,LK,2006.0,1,0,1
AR,NZ,2006.0,1,0,1
BJ,PK,2003.0,1,0,1
nan,BR,2024.0,5,0,5
TH,IE,2022.0,1,0,1
,MC,2018.0,6,0,6
MX,NG,2013.0,1,0,1
LK,PK,1997.0,1,0,1
GR,PS,2003.0,1,0,1
KR,HK,2014.0,1,0,1
ZM,IT,2020.0,1,0,1
AU,PW,2020.0,1,0,1
LT,NL,2005.0,3,0,3
SY,TR,2015.0,1,0,1
TZ,SZ,2012.0,1,0,1
PK,JM,2021.0,1,0,1
VE,FI,2015.0,1,0,1
AE,TT,2014.0,1,0,1
UG,IT,2013.0,2,0,2
OM,CO,2011.0,2,0,2
PH,NZ,1999.0,1,0,1
BH,TW,2015.0,1,0,1
PK,JO,2010.0,2,0,2
NZ,MT,2022.0,1,0,1
NG,LU,2013.0,1,0,1
GW,US,2006.0,1,0,1
DE,GH,2007.0,2,0,2
CF,MG,2007.0,1,0,1
BI,CN,2003.0,1,0,1
MT,LU,2018.0,1,0,1
IE,LU,2014.0,2,0,2
ZW,MY,2015.0,1,0,1
PK,AM,2011.0,1,0,1
LI,,2014.0,4,0,4
PE,AR,1998.0,1,0,1
,GY,1994.0,3,0,3
RO,UA,2006.0,2,0,2
IN,VE,2007.0,2,0,2
FR,MR,2009.0,1,0,1
AT,MX,2023.0,1,0,1
MZ,AM,2018.0,2,0,2
UA,PK,2011.0,1,0,1
BD,KE,2014.0,1,0,1
AU,MN,2008.0,1,0,1
SE,EE,2023.0,1,0,1
CH,PY,2013.0,1,0,1
NG,NA,2015.0,1,0,1
ZA,MZ,2006.0,1,0,1
MC,,2000.0,2,0,2
TR,AE,1999.0,1,0,1
EC,BE,2005.0,1,0,1
MU,JP,2017.0,1,0,1
DE,PS,2004.0,1,0,1
AU,BT,2014.0,2,0,2
HR,FI,2003.0,1,0,1
BD,ES,1997.0,2,0,2
TW,CR,2007.0,1,0,1
MQ,GB,2013.0,1,0,1
BW,ID,2021.0,1,0,1
SE,TZ,2002.0,2,0,2
SN,QA,2010.0,1,0,1
VG,CH,2018.0,1,0,1
PL,KZ,2013.0,1,0,1
MX,CY,2021.0,1,0,1
HU,GE,2010.0,1,0,1
HT,CA,2009.0,1,0,1
DK,PL,2023.0,1,0,1
PS,MX,2011.0,1,0,1
CA,MV,2017.0,1,0,1
KP,AU,2000.0,1,0,1
BF,NL,2010.0,1,0,1
BA,PT,2013.0,1,0,1
SS,SG,2018.0,1,0,1
ES,MY,2004.0,1,0,1
LC,,2022.0,1,0,1
MY,CL,2016.0,2,0,2
IL,HR,2018.0,2,0,2
ER,CA,2009.0,1,0,1
SA,SY,1999.0,1,0,1
SN,QA,2017.0,1,0,1
LK,TW,2014.0,1,0,1
MA,SE,2011.0,4,0,4
DZ,SL,2017.0,2,0,2
OM,CH,2003.0,1,0,1
UA,OM,2022.0,1,0,1
MX,EC,2023.0,1,0,1
KW,OM,2000.0,1,0,1
GE,AZ,2017.0,1,0,1
IS,CG,2016.0,1,0,1
TN,BJ,2014.0,2,0,2
BE,BA,1997.0,1,0,1
FI,GE,2012.0,1,0,1
PE,HU,2011.0,1,0,1
NC,FJ,2014.0,1,0,1
PK,IL,2018.0,2,0,2
PT,AO,2005.0,2,0,2
TW,PT,2022.0,1,0,1
AT,OM,2013.0,1,0,1
BE,DJ,2014.0,1,0,1
IR,MM,2010.0,1,0,1
KE,VN,2018.0,2,0,2
HU,SG,2008.0,1,0,1
GB,GW,2004.0,1,0,1
LT,CL,2021.0,1,0,1
AR,CY,2007.0,1,0,1
BF,GH,2010.0,1,0,1
VN,ES,2006.0,1,0,1
HR,VE,2000.0,1,0,1
NL,BA,2014.0,1,0,1
IE,CU,2019.0,1,0,1
SD,NG,2010.0,1,0,1
CZ,FI,1998.0,1,0,1
YE,IQ,2010.0,1,0,1
XK,GB,2007.0,1,0,1
,MH,2004.0,2,0,2
UG,DE,2014.0,1,0,1
SG,VG,2009.0,1,0,1
GA,,2009.0,6,0,6
LU,BY,2013.0,1,0,1
PH,CO,2014.0,5,4,1
MX,CZ,2001.0,1,2,-1
CZ,ES,1999.0,2,2,0
CN,PE,2010.0,2,1,1
CN,MU,2021.0,2,1,1
EC,GB,2010.0,1,4,-3
ZW,IN,2020.0,2,1,1
UG,NZ,1998.0,1,1,0
NP,TR,2019.0,3,1,2
IQ,SE,2015.0,1,3,-2
IE,nan,1998.0,2,1,1
EC,CA,2012.0,1,3,-2
SA,NO,2006.0,1,1,0
IN,JO,2012.0,1,3,-2
BF,NL,2017.0,1,1,0
FR,GE,2018.0,3,2,1
UA,MD,2005.0,1,3,-2
DE,LU,2000.0,6,4,2
US,MD,2010.0,4,8,-4
PT,LU,2013.0,1,3,-2
NZ,ES,2021.0,5,6,-1
TR,IT,2023.0,2,2,0
CO,KE,2021.0,2,4,-2
IT,NO,2023.0,2,5,-3
CH,KE,2006.0,2,2,0
CR,GT,2012.0,1,2,-1
TZ,DE,1999.0,2,1,1
RS,TR,2021.0,5,2,3
IQ,AU,2013.0,1,2,-1
ID,PK,1998.0,1,1,0
nan,CL,2005.0,3,1,2
NO,HR,2016.0,3,4,-1
CA,LK,1999.0,1,3,-2
TR,EG,2016.0,3,5,-2
NO,BE,1997.0,2,1,1
AT,PL,2023.0,1,1,0
AO,FR,2007.0,2,1,1
SG,FI,2005.0,1,2,-1
AM,CN,2021.0,2,1,1
ZM,NL,2020.0,1,4,-3
TR,MD,2017.0,2,1,1
JP,BD,2023.0,2,5,-3
QA,IT,2022.0,2,5,-3
EG,BE,2017.0,3,7,-4
DE,TZ,1998.0,2,4,-2
SD,AU,2018.0,1,1,0
TR,XK,2020.0,3,2,1
KR,SE,2003.0,3,5,-2
ZA,TR,2019.0,1,3,-2
KH,CN,2016.0,1,3,-2
CD,IN,2015.0,1,1,0
TH,DE,2023.0,1,1,0
PT,CU,2014.0,3,4,-1
AR,PL,2008.0,3,2,1
AT,IL,1997.0,1,3,-2
IR,IL,2018.0,1,2,-1
TW,ES,2006.0,1,1,0
JM,DE,2000.0,1,1,0
BE,ET,2011.0,3,4,-1
NL,UG,2004.0,1,1,0
SV,VE,2020.0,1,1,0
US,HN,2016.0,2,2,0
SE,TZ,2005.0,2,3,-1
CR,PH,2022.0,1,2,-1
PK,HU,2012.0,1,1,0
ZM,EG,2019.0,1,1,0
KZ,UA,2017.0,4,10,-6
SG,ET,2015.0,1,2,-1
FR,TG,2009.0,2,1,1
IE,NG,2017.0,2,2,0
HU,LT,1999.0,1,2,-1
GT,DE,2017.0,1,1,0
SY,MA,2020.0,3,3,0
UA,SI,2021.0,1,1,0
UA,CA,2000.0,1,2,-1
BD,ES,1998.0,1,4,-3
CL,RS,2007.0,1,1,0
ET,BE,2007.0,3,3,0
OM,QA,2013.0,3,1,2
AU,BN,2011.0,2,1,1
LB,IL,2018.0,1,1,0
HU,BY,2017.0,4,1,3
TW,NL,2004.0,1,6,-5
NG,SG,2018.0,1,1,0
PA,FR,2012.0,1,3,-2
DE,GE,2006.0,2,4,-2
BR,BO,2014.0,2,4,-2
NL,NG,2002.0,1,2,-1
BG,FI,2011.0,1,1,0
IT,AE,2014.0,4,2,2
US,JE,2016.0,1,2,-1
PT,IE,2001.0,2,1,1
ES,NG,2001.0,1,1,0
CN,PE,2017.0,3,3,0
FI,BR,2009.0,1,4,-3
EC,JP,2001.0,1,1,0
MG,CN,2014.0,2,5,-3
GB,AL,2017.0,1,2,-1
AZ,SA,2012.0,1,1,0
RS,IR,2021.0,1,1,0
SA,ZA,2007.0,1,1,0
TN,NL,2021.0,1,1,0
QA,HU,2013.0,1,2,-1
BE,SA,2008.0,1,1,0
PK,GE,2015.0,1,1,0
NG,nan,2010.0,4,3,1
KE,AE,2016.0,1,1,0
CA,LV,2019.0,2,1,1
IQ,RU,2020.0,2,1,1
LA,NL,2015.0,1,1,0
NO,AT,2004.0,1,3,-2
HU,SY,2017.0,3,3,0
NO,ZM,2010.0,1,2,-1
CH,IS,2021.0,1,1,0
TW,TR,2012.0,2,2,0
HR,IE,2006.0,1,10,-9
DK,LT,2020.0,1,5,-4
UY,IL,2011.0,1,1,0
HR,QA,2018.0,1,2,-1
LT,AU,2011.0,1,1,0
DE,OM,2004.0,1,1,0
KR,PL,2014.0,1,3,-2
PK,MY,2003.0,1,6,-5
RO,JP,2007.0,1,2,-1
GR,FI,2002.0,2,2,0
AU,CR,2016.0,2,3,-1
ZA,TR,2010.0,1,3,-2
BR,TN,2003.0,1,1,0
IT,NP,2021.0,1,1,0
FI,SD,2020.0,1,1,0
RU,TN,2009.0,1,1,0
GR,LY,2014.0,2,1,1
PL,BR,2007.0,2,6,-4
SK,BE,2013.0,1,3,-2
KR,MW,2019.0,1,1,0
LV,GB,2016.0,2,4,-2
AG,US,2022.0,1,5,-4
JP,MT,2003.0,2,1,1
CZ,DK,1997.0,1,2,-1
PT,CL,2000.0,1,3,-2
AU,UA,2012.0,1,2,-1
KH,PK,2009.0,1,2,-1
ET,DK,2021.0,1,2,-1
ID,PT,2018.0,1,5,-4
RO,HR,2020.0,1,2,-1
IE,CL,2019.0,2,1,1
GB,CR,2010.0,1,1,0
CA,CU,2019.0,1,9,-8
KE,BH,2020.0,1,2,-1
CO,TW,2018.0,1,1,0
GB,MK,2020.0,2,5,-3
CA,LT,2021.0,1,1,0
RU,CO,2018.0,1,3,-2
ET,IQ,2019.0,2,1,1
NG,EG,2011.0,1,1,0
RW,GB,2016.0,1,2,-1
AT,IL,1998.0,1,3,-2
DK,MY,2009.0,1,1,0
NG,BW,2016.0,1,2,-1
MT,US,2010.0,1,4,-3
IE,FI,2002.0,1,1,0
LB,SY,2010.0,1,1,0
RU,LV,2023.0,1,1,0
FI,SI,2012.0,1,2,-1
MR,SN,2020.0,1,2,-1
TG,CN,2019.0,1,2,-1
TR,SD,2022.0,1,1,0
NP,PK,2009.0,1,1,0
CU,AO,2018.0,1,1,0
BE,AT,1997.0,1,4,-3
IL,BY,2016.0,1,3,-2
SY,MY,2018.0,1,2,-1
BJ,CH,1999.0,1,1,0
MU,US,2006.0,1,3,-2
MZ,AU,2017.0,1,1,0
IR,SY,2012.0,1,2,-1
PK,ID,1998.0,1,1,0
UZ,ID,2018.0,1,2,-1
BE,CU,2021.0,1,2,-1
PK,TN,2020.0,2,2,0
BN,ID,2022.0,1,3,-2
US,ZM,2007.0,2,3,-1
SI,ES,2023.0,1,2,-1
NO,IE,2001.0,1,5,-4
CN,HR,2021.0,1,2,-1
NA,CN,2012.0,1,1,0
CA,EC,2015.0,1,5,-4
TH,TW,2001.0,2,1,1
NI,CO,2022.0,1,2,-1
GH,PH,2023.0,1,1,0
DE,MY,2023.0,1,1,0
TT,DE,2008.0,1,1,0
BH,NO,2013.0,1,1,0
IT,TN,2002.0,1,2,-1
KE,ID,2012.0,2,5,-3
UA,BG,2010.0,3,9,-6
BE,AE,2013.0,1,1,0
US,MD,2017.0,4,3,1
PL,LU,2014.0,3,3,0
nan,KZ,2021.0,1,2,-1
GB,IQ,2010.0,3,8,-5
BE,NE,2015.0,2,1,1
PT,UY,2020.0,2,7,-5
BO,CR,2002.0,1,1,0
US,YE,2016.0,2,1,1
DK,NZ,1997.0,1,3,-2
BZ,FR,1998.0,1,2,-1
PT,EG,2020.0,2,2,0
BZ,US,2015.0,1,1,0
BR,HK,2017.0,1,1,0
MA,NL,2016.0,1,1,0
AF,GB,2016.0,1,2,-1
CL,NO,2013.0,1,2,-1
ZA,CN,2001.0,2,1,1
CY,DE,2007.0,1,2,-1
KP,CN,2018.0,1,8,-7
SK,FI,2001.0,3,2,1
SI,SG,2012.0,2,0,2
CF,GA,2019.0,1,0,1
TR,KG,2009.0,1,0,1
EG,PE,2006.0,1,0,1
NZ,MK,2010.0,1,0,1
FI,SJ,2020.0,1,0,1
QA,VG,2012.0,1,0,1
CA,ZM,2017.0,1,0,1
NZ,UG,2006.0,1,0,1
GN,RW,2020.0,1,0,1
TR,GL,2021.0,1,0,1
BR,KN,2019.0,1,0,1
CH,NA,2016.0,1,0,1
ET,IT,2003.0,1,0,1
MC,IL,1998.0,1,0,1
MA,JP,2022.0,1,0,1
GW,MZ,2014.0,1,0,1
CO,UG,2016.0,1,0,1
QA,TW,2022.0,3,0,3
CZ,ID,2004.0,2,0,2
GD,ES,2013.0,1,0,1
GY,ZA,2015.0,1,0,1
BO,NL,2002.0,1,0,1
SR,NL,2016.0,1,0,1
CL,PK,2016.0,1,0,1
,VU,1998.0,1,0,1
CO,SE,1997.0,2,0,2
PA,PE,2014.0,3,0,3
CA,GP,2000.0,1,0,1
TO,,2018.0,2,0,2
ZA,JO,2020.0,2,0,2
MQ,BE,2007.0,1,0,1
TH,IS,2020.0,1,0,1
DK,AR,2023.0,1,0,1
HN,QA,2004.0,1,0,1
FR,ML,1998.0,1,0,1
NI,,2003.0,1,0,1
ME,RU,1998.0,1,0,1
MK,JP,2019.0,1,0,1
US,AO,2023.0,1,0,1
AT,SG,2000.0,1,0,1
CI,IT,2013.0,1,0,1
MG,CA,2011.0,1,0,1
CZ,EC,2018.0,1,0,1
UG,SG,2006.0,1,0,1
TW,HR,2021.0,1,0,1
RU,ZW,1998.0,1,0,1
UY,SA,2016.0,1,0,1
BE,BA,1998.0,1,0,1
PR,ES,2006.0,1,0,1
MM,ZM,2022.0,1,0,1
ZW,US,2023.0,1,0,1
UG,PG,2018.0,1,0,1
MY,CM,2013.0,1,0,1
SN,TN,2006.0,1,0,1
ET,JP,1999.0,3,0,3
AM,AU,2018.0,1,0,1
KZ,TJ,2021.0,1,0,1
ET,AU,2004.0,1,0,1
MT,CO,2011.0,1,0,1
GB,AL,2010.0,1,0,1
NA,AU,2009.0,1,0,1
IT,PR,2012.0,1,0,1
PK,CR,2009.0,1,0,1
ID,MK,2021.0,1,0,1
GR,NZ,2005.0,1,0,1
LB,AT,2007.0,1,0,1
BR,ZM,2002.0,1,0,1
RW,RO,2018.0,1,0,1
SD,MW,2001.0,1,0,1
AL,BG,2018.0,1,0,1
GB,MR,2002.0,1,0,1
MA,SA,2000.0,1,0,1
BO,CR,2005.0,1,0,1
CO,LU,2017.0,1,0,1
PA,MA,2018.0,1,0,1
DE,GD,2003.0,1,0,1
OM,IL,2016.0,1,0,1
NL,ML,2013.0,1,0,1
HU,KE,2013.0,1,0,1
HR,PT,2021.0,2,0,2
RS,BR,2014.0,1,0,1
GP,GB,2007.0,1,0,1
AE,LT,2019.0,1,0,1
BD,SO,2019.0,1,0,1
BE,ZM,2020.0,1,0,1
SE,AM,2014.0,1,0,1
BI,NL,2018.0,2,0,2
ZA,IR,2006.0,1,0,1
TN,MR,2016.0,1,0,1
ES,AF,2012.0,1,0,1
ES,TZ,2022.0,1,0,1
BB,FR,2020.0,1,0,1
IE,SN,2020.0,1,0,1
XK,CH,2013.0,1,0,1
BW,GH,2015.0,1,0,1
TG,CN,2017.0,1,0,1
AR,HU,2009.0,1,0,1
QA,KE,2020.0,1,0,1
IE,LY,2018.0,1,0,1
NL,AZ,2015.0,1,0,1
TH,MN,2015.0,1,0,1
IQ,MY,2003.0,1,0,1
PA,ZA,2020.0,1,0,1
TH,TR,2021.0,2,0,2
CF,,2005.0,1,0,1
PT,GT,2010.0,1,0,1
SY,IT,2022.0,1,0,1
SX,US,2020.0,2,0,2
IE,ET,2016.0,1,0,1
TR,VG,1997.0,1,0,1
MM,UG,2004.0,1,0,1
AL,IR,2015.0,1,0,1
ER,US,2011.0,1,0,1
EE,DK,2003.0,1,0,1
SS,BS,2008.0,1,0,1
CM,MD,2003.0,1,0,1
CO,LU,2019.0,1,0,1
TN,KE,2016.0,2,0,2
BF,SE,2006.0,1,0,1
MD,GF,2001.0,1,0,1
EC,CU,1999.0,1,0,1
BD,AE,1997.0,1,0,1
AU,EE,2000.0,1,0,1
SN,SE,2016.0,1,0,1
IN,SZ,2016.0,1,0,1
KZ,GB,2006.0,1,0,1
CZ,PT,2023.0,2,0,2
ZM,WS,2002.0,1,0,1
CY,NZ,2019.0,1,0,1
MR,JP,2014.0,1,0,1
NL,SD,2004.0,1,0,1
MY,PR,2022.0,1,0,1
PG,FJ,2008.0,1,0,1
US,FO,2015.0,1,0,1
PA,IT,2008.0,2,0,2
AM,AT,2006.0,1,0,1
ET,NZ,2006.0,1,0,1
ME,CA,2018.0,1,0,1
CD,LU,2020.0,1,0,1
LU,MX,2008.0,1,0,1
ID,NI,2018.0,1,0,1
AL,GB,2001.0,1,0,1
UG,IR,2010.0,1,0,1
LT,AR,2009.0,1,0,1
AU,LA,2008.0,1,0,1
FR,RS,2001.0,3,0,3
CA,NA,2010.0,1,0,1
IL,SD,2012.0,1,0,1
UZ,IN,2005.0,1,0,1
KN,JP,2021.0,1,0,1
PT,BS,2015.0,1,0,1
UZ,IT,2013.0,1,0,1
UA,MD,2002.0,1,0,1
SM,CZ,2016.0,1,0,1
MW,KR,2010.0,1,0,1
QA,CH,2007.0,1,0,1
CN,OM,2008.0,1,0,1
HR,ZA,2006.0,1,0,1
BY,AU,2008.0,1,0,1
BE,MC,2021.0,1,0,1
AR,DK,1997.0,1,0,1
HK,ZA,2018.0,1,0,1
IE,PG,2004.0,1,0,1
CI,ZW,2015.0,1,0,1
CO,TN,2021.0,1,0,1
PG,IE,2007.0,1,0,1
NZ,UY,2013.0,1,0,1
RO,AU,2003.0,1,0,1
RU,CR,2001.0,1,0,1
UZ,IL,2015.0,1,0,1
HR,BW,2010.0,1,0,1
SV,FR,2019.0,1,0,1
ID,SO,2017.0,1,0,1
MU,IN,2014.0,1,0,1
IQ,DE,2000.0,1,0,1
PK,PS,2014.0,2,0,2
GR,UZ,2010.0,2,0,2
GB,BF,2016.0,1,0,1
RU,KG,2003.0,1,0,1
VN,CW,2020.0,1,0,1
GH,KE,2008.0,1,0,1
GR,LB,2008.0,1,0,1
MT,DK,2016.0,1,0,1
CA,BF,1998.0,1,0,1
GB,CD,2006.0,1,0,1
BD,PT,2007.0,1,0,1
GR,UZ,2019.0,1,0,1
DE,TZ,1997.0,1,0,1
BA,JO,2013.0,1,0,1
UG,BO,2018.0,1,0,1
VN,AO,2018.0,1,0,1
SG,NZ,2023.0,1,0,1
QA,UG,2005.0,1,0,1
CL,IL,1997.0,1,0,1
SD,PK,2013.0,1,0,1
MH,,2017.0,1,0,1
CN,CI,2012.0,1,0,1
CL,BO,1998.0,1,0,1
VU,FJ,2015.0,1,0,1
LU,IT,2004.0,2,0,2
RO,AR,2010.0,1,0,1
SL,PK,2017.0,1,0,1
SA,MD,2016.0,1,0,1
AM,AZ,2005.0,1,0,1
AZ,KR,2021.0,1,0,1
CN,SO,2020.0,1,0,1
NO,JO,2009.0,1,0,1
AR,ZA,2023.0,1,0,1
BH,LB,2000.0,1,0,1
KZ,OM,2014.0,1,0,1
nan,RW,2017.0,1,0,1
CY,NG,2023.0,2,0,2
SJ,,2025.0,1,0,1
CO,GP,2020.0,1,0,1
MZ,BR,1998.0,1,0,1
MV,AU,2018.0,1,0,1
MM,NZ,2022.0,1,0,1
PK,ZW,2001.0,1,0,1
nan,RW,2019.0,1,0,1
FI,KG,2007.0,1,0,1
CA,AU,2013.0,426,337,89
CO,CR,2016.0,44,38,6
BR,UY,2010.0,37,45,-8
SE,NO,2007.0,78,68,10
DE,US,2007.0,2224,2056,168
TW,CN,2018.0,1681,756,925
GB,DK,2020.0,188,129,59
AR,MX,2013.0,119,125,-6
AT,FR,2012.0,48,53,-5
CA,CN,2000.0,182,131,51
US,AU,2012.0,2356,1999,357
US,GR,2017.0,157,187,-30
US,KR,1999.0,485,334,151
ES,CL,2013.0,343,333,10
ES,FR,2003.0,131,126,5
AT,nan,2001.0,8,7,1
AU,JP,2022.0,27,41,-14
CN,DE,2001.0,146,110,36
US,CH,2005.0,549,503,46
GB,IE,2002.0,203,132,71
nan,AR,2004.0,18,18,0
BE,US,2006.0,246,203,43
IT,GB,1999.0,196,135,61
IT,IS,2017.0,1,1,0
CL,US,2018.0,264,278,-14
GB,BR,2005.0,97,101,-4
AO,BR,2020.0,23,53,-30
CL,MX,2013.0,158,134,24
IN,US,2005.0,1152,1058,94
IT,JP,2005.0,60,41,19
US,EG,2012.0,235,153,82
AT,FI,2016.0,11,9,2
GB,TR,2018.0,136,157,-21
US,JP,2022.0,788,769,19
KR,US,2007.0,920,1103,-183
GB,ES,2016.0,359,584,-225
CH,PK,2010.0,13,10,3
AU,FR,2005.0,73,63,10
NZ,US,2014.0,376,369,7
NO,US,2014.0,149,170,-21
FR,CN,2007.0,352,176,176
BD,AU,2021.0,58,61,-3
PL,CA,2014.0,25,22,3
CZ,PH,2020.0,2,1,1
HN,CL,2016.0,6,2,4
CN,DZ,2009.0,1,1,0
CH,IT,2008.0,151,231,-80
US,AE,2014.0,87,52,35
MX,KR,2015.0,6,6,0
GB,IR,2001.0,41,10,31
ZA,US,2007.0,232,230,2
SG,JP,2014.0,42,44,-2
CN,KH,2020.0,2,1,1
IN,nan,2007.0,23,23,0
IT,AR,2020.0,95,112,-17
US,CL,2012.0,212,231,-19
IN,GB,2006.0,241,203,38
PT,BR,2009.0,542,608,-66
CL,JP,2008.0,6,4,2
AU,VN,2017.0,48,37,11
DE,IN,2014.0,185,194,-9
US,SG,2003.0,176,173,3
US,CH,2002.0,488,441,47
JP,UA,2010.0,6,2,4
GB,SE,2012.0,192,143,49
BR,IT,2013.0,194,267,-73
IT,BR,2021.0,197,247,-50
JP,LK,2009.0,26,17,9
IT,CH,2018.0,405,277,128
ES,AR,2013.0,336,341,-5
KR,JP,2002.0,154,186,-32
BR,UY,2019.0,63,62,1
US,ZA,2001.0,165,160,5
US,PH,2015.0,348,454,-106
DE,CL,2010.0,36,42,-6
EC,CO,2022.0,39,50,-11
CL,FR,2022.0,24,13,11
CO,ES,2018.0,623,650,-27
US,BE,2002.0,138,176,-38
MY,BR,2001.0,29,27,2
ET,KR,2005.0,85,96,-11
US,nan,2013.0,262,285,-23
BR,AO,2015.0,17,33,-16
KR,ET,2014.0,104,146,-42
QA,GB,2013.0,6,31,-25
FR,ES,1997.0,73,84,-11
ZA,GB,2017.0,164,193,-29
BE,BR,2010.0,65,54,11
IN,KR,2004.0,52,52,0
ET,NO,2019.0,9,11,-2
IR,NL,2013.0,34,34,0
PL,CH,2015.0,30,40,-10
BD,GB,2013.0,59,54,5
US,FR,2000.0,744,925,-181
BE,DE,2017.0,142,140,2
MX,CL,2008.0,89,69,20
CN,NL,2006.0,61,58,3
ES,AU,2015.0,96,52,44
HK,NL,2010.0,16,11,5
HK,NL,2019.0,15,25,-10
IE,US,2022.0,285,307,-22
CA,SG,2019.0,59,62,-3
KE,US,2001.0,27,16,11
MX,PH,2013.0,9,8,1
US,MX,2006.0,212,248,-36
GB,SI,2008.0,11,9,2
BE,GR,2001.0,6,3,3
IQ,MY,2012.0,11,20,-9
EG,CA,2007.0,20,22,-2
AR,ES,1999.0,88,72,16
IR,US,2014.0,625,360,265
CO,US,2022.0,184,173,11
IE,IN,2021.0,34,40,-6
AE,US,2018.0,81,105,-24
nan,CN,2019.0,137,116,21
ZA,ID,2018.0,61,109,-48
nan,BE,2012.0,25,20,5
IE,CA,2015.0,154,181,-27
US,TH,2001.0,77,34,43
RU,US,2004.0,364,249,115
PH,MX,2016.0,9,5,4
CL,CO,2004.0,59,44,15
SG,IN,1998.0,7,17,-10
IN,MY,2011.0,96,60,36
ES,CA,2022.0,59,47,12
AU,PK,2013.0,30,30,0
BE,VN,2020.0,18,9,9
ZA,DE,2009.0,37,40,-3
ES,PE,2011.0,72,52,20
ZA,GB,2019.0,191,185,6
UY,DK,2018.0,1,2,-1
CA,IE,2002.0,54,38,16
BR,MY,2001.0,27,29,-2
GB,AE,2019.0,75,44,31
PT,US,2007.0,100,118,-18
US,BF,2014.0,1,4,-3
IT,NL,2014.0,124,74,50
IT,RU,2007.0,19,29,-10
HU,NL,2017.0,20,12,8
DE,IR,2014.0,58,92,-34
BE,IT,2023.0,1,6,-5
KR,CN,2009.0,265,229,36
PE,US,2021.0,124,110,14
NL,IT,2020.0,111,141,-30
TN,SA,2021.0,75,62,13
IT,MX,2013.0,37,29,8
CA,SA,2019.0,149,96,53
CH,FI,2009.0,18,21,-3
DE,EE,2012.0,48,28,20
US,GR,2010.0,181,196,-15
PY,ES,2021.0,18,22,-4
GB,TH,2020.0,81,43,38
AU,DE,2018.0,281,290,-9
CA,ES,2012.0,69,77,-8
FR,BR,2010.0,163,165,-2
nan,CN,2017.0,114,100,14
nan,CN,2010.0,207,185,22
GR,CN,2005.0,9,9,0
MN,CN,2006.0,1,1,0
MX,CN,2012.0,11,3,8
CN,nan,2020.0,117,115,2
CN,BD,2001.0,3,1,2
US,BE,2005.0,189,217,-28
BE,DE,2010.0,110,120,-10
AU,TH,2017.0,33,16,17
IR,FR,2014.0,27,37,-10
DE,ES,2020.0,246,270,-24
KR,DK,2013.0,6,2,4
BE,NO,2017.0,16,9,7
GB,DE,2000.0,339,402,-63
US,HR,2014.0,25,51,-26
MW,GB,2012.0,12,11,1
JM,TT,2022.0,7,11,-4
RU,HU,2021.0,17,24,-7
CH,HU,2019.0,16,22,-6
GB,LK,2014.0,18,18,0
DE,KR,2021.0,46,59,-13
CN,NP,2021.0,16,12,4
SK,DE,2021.0,64,12,52
NL,CZ,2019.0,13,14,-1
ZA,NA,2022.0,7,8,-1
DE,ZA,2014.0,76,63,13
JP,RU,2015.0,64,55,9
CA,ZA,2009.0,34,26,8
US,RO,2004.0,40,37,3
BE,CN,2014.0,55,75,-20
IT,BE,2012.0,152,88,64
MX,CH,2004.0,5,6,-1
SG,CN,2023.0,30,112,-82
US,SK,2017.0,33,32,1
TR,JP,2002.0,45,46,-1
TR,KR,2022.0,3,2,1
ZA,GB,2010.0,137,165,-28
nan,UA,2011.0,25,15,10
SE,US,2013.0,371,382,-11
US,IE,1998.0,149,140,9
CH,EE,2012.0,18,6,12
US,SK,2010.0,33,29,4
CA,RU,2013.0,23,23,0
GB,ZA,2010.0,165,137,28
JP,EG,2001.0,34,16,18
ES,PT,2018.0,204,166,38
IT,AM,2003.0,13,3,10
IN,CN,2001.0,32,20,12
CA,SA,2010.0,74,28,46
AR,CA,2003.0,13,9,4
ES,CH,2022.0,84,71,13
US,MM,2014.0,4,3,1
KR,SG,2014.0,37,35,2
US,IQ,2016.0,59,22,37
SI,US,2019.0,23,22,1
ES,CO,1997.0,29,16,13
PK,MY,2012.0,48,31,17
BE,KE,2015.0,6,4,2
MK,US,2009.0,8,9,-1
JP,CO,2003.0,7,6,1
SE,CN,2016.0,91,109,-18
GH,CA,2012.0,4,6,-2
GR,US,2004.0,110,163,-53
ES,GB,1999.0,126,108,18
NL,NZ,2014.0,12,17,-5
FR,BR,2017.0,245,250,-5
PL,BE,2017.0,15,18,-3
AU,VN,2019.0,71,36,35
SA,GB,2022.0,59,94,-35
SK,IT,2020.0,8,3,5
IQ,PK,2022.0,22,20,2
JP,PE,2020.0,1,3,-2
LB,CN,2012.0,31,31,0
DE,GB,2023.0,39,29,10
IT,CA,2006.0,56,62,-6
SE,PL,2013.0,19,16,3
CN,ZW,2019.0,3,1,2
IN,BR,2003.0,15,9,6
NZ,ZM,2016.0,1,2,-1
US,GE,2016.0,169,164,5
GB,NL,2001.0,142,170,-28
MA,FR,2022.0,75,112,-37
IQ,LB,2018.0,2,5,-3
QA,AU,2021.0,9,9,0
RU,GB,2016.0,106,129,-23
FR,BR,2019.0,285,272,13
PK,nan,2018.0,14,12,2
SY,EG,2021.0,4,6,-2
FR,ES,1998.0,104,124,-20
IN,SG,2020.0,122,165,-43
US,CZ,2003.0,88,77,11
MY,JP,2016.0,55,87,-32
ZA,NZ,2009.0,12,8,4
NL,JP,2016.0,19,30,-11
NZ,NP,2019.0,68,67,1
LU,AT,2017.0,8,4,4
DK,US,2012.0,222,295,-73
SE,DK,2021.0,94,111,-17
RU,BR,2020.0,11,21,-10
GT,CO,2019.0,8,9,-1
SV,CL,2016.0,2,5,-3
FR,RO,2008.0,35,27,8
CA,CL,2015.0,25,26,-1
ES,CZ,2015.0,37,6,31
GB,ZA,2017.0,193,164,29
RU,AT,1997.0,6,5,1
BE,CM,2014.0,6,4,2
CO,PE,2014.0,89,71,18
PA,CU,2011.0,2,2,0
AR,GB,2007.0,27,19,8
ES,CO,1998.0,33,33,0
NZ,TW,2010.0,4,5,-1
IE,CO,2011.0,5,1,4
CY,TR,2014.0,43,50,-7
IT,ID,2014.0,11,4,7
FR,IN,2012.0,88,107,-19
FR,PL,2022.0,15,27,-12
GR,NL,2011.0,21,15,6
AU,CZ,2018.0,14,8,6
AR,nan,2015.0,41,31,10
FR,SY,2013.0,12,7,5
TR,JP,2005.0,54,34,20
CR,CO,2016.0,38,44,-6
AU,TH,2019.0,39,18,21
FR,CI,2015.0,33,13,20
EG,SE,2018.0,12,4,8
KH,AU,2016.0,3,4,-1
BE,BR,2017.0,94,86,8
CA,NZ,2014.0,66,76,-10
CA,IE,2005.0,69,78,-9
SE,nan,2014.0,59,49,10
SI,GB,2021.0,13,16,-3
BE,BR,2019.0,104,86,18
GH,IN,2020.0,8,7,1
TZ,ZA,2019.0,11,11,0
BR,UY,2017.0,64,51,13
US,IE,1997.0,129,89,40
SI,CN,2015.0,7,5,2
IL,BE,2020.0,10,9,1
CU,CO,2009.0,22,26,-4
MY,IT,2002.0,30,34,-4
HU,GB,2007.0,44,38,6
NL,FR,2001.0,96,127,-31
CN,IE,2008.0,40,33,7
CH,AR,2019.0,16,22,-6
CA,IT,1999.0,60,65,-5
RO,ES,2008.0,8,10,-2
nan,AT,2019.0,20,10,10
AU,FR,2002.0,34,66,-32
SA,US,2022.0,131,180,-49
BE,IR,2023.0,1,1,0
CN,MY,2022.0,74,89,-15
FR,ZA,2009.0,28,17,11
BG,SE,2020.0,4,3,1
EG,YE,2018.0,8,7,1
CO,BE,2011.0,9,7,2
CH,LU,2016.0,7,6,1
GR,nan,2022.0,2,4,-2
MX,BE,2021.0,8,4,4
TN,FR,2022.0,73,55,18
RU,KR,2021.0,17,26,-9
GB,GH,2015.0,28,12,16
TW,NL,2020.0,9,10,-1
AU,DK,2011.0,34,32,2
DK,BE,2021.0,54,62,-8
SE,CH,2005.0,28,28,0
OM,US,2010.0,7,12,-5
NZ,PK,2021.0,4,12,-8
CH,MX,2018.0,15,16,-1
LU,GR,2010.0,1,2,-1
FR,UY,2014.0,5,2,3
YE,EG,2017.0,6,11,-5
KR,NL,2011.0,8,7,1
MX,NO,2021.0,5,2,3
AU,PT,2021.0,14,19,-5
FR,BJ,2012.0,28,28,0
DE,RU,2011.0,148,167,-19
SD,TR,2017.0,2,1,1
FI,GB,2013.0,55,59,-4
AZ,RU,2020.0,30,20,10
BY,RU,2013.0,80,60,20
UA,MY,2021.0,9,5,4
CU,CR,2018.0,19,39,-20
IN,PH,2020.0,30,18,12
CH,AR,2010.0,10,8,2
IT,IR,2021.0,22,69,-47
VN,FR,2021.0,31,39,-8
AR,JP,2016.0,4,3,1
TR,US,2004.0,243,266,-23
DK,NL,2015.0,37,45,-8
CA,VN,2016.0,11,6,5
SE,IN,2016.0,43,60,-17
FR,CZ,2012.0,21,32,-11
VE,BR,2016.0,24,15,9
GB,AE,2017.0,80,33,47
NO,AT,2020.0,14,16,-2
CN,NZ,1999.0,11,10,1
CA,SA,2017.0,134,68,66
IT,AT,2008.0,31,29,2
TH,PK,2014.0,6,2,4
TW,DE,2018.0,38,32,6
EG,QA,2020.0,79,107,-28
IL,RU,2018.0,62,29,33
US,NZ,2015.0,385,407,-22
FR,DE,2016.0,530,567,-37
TZ,GB,2019.0,22,25,-3
RO,MD,2012.0,3,3,0
CH,AR,2017.0,21,27,-6
CN,TW,2000.0,273,400,-127
GB,ZA,2019.0,185,191,-6
NZ,IE,2001.0,3,4,-1
SI,US,2017.0,26,17,9
FI,DE,2007.0,25,54,-29
MY,IT,2005.0,48,30,18
FR,NO,2004.0,48,38,10
ID,NL,2002.0,5,2,3
KE,GB,2003.0,13,16,-3
PL,RU,2008.0,17,35,-18
ES,AT,2010.0,22,25,-3
JP,HU,1998.0,8,13,-5
PT,JP,2010.0,4,9,-5
AT,TR,2011.0,4,10,-6
IR,KR,2019.0,26,13,13
PL,BE,2010.0,22,17,5
AU,TH,2010.0,32,21,11
RO,JP,2002.0,5,3,2
FR,UA,2010.0,10,20,-10
GB,GM,2000.0,13,3,10
RU,DE,2008.0,205,131,74
CN,NO,2005.0,14,9,5
CW,NL,2018.0,30,6,24
EC,BR,2018.0,46,66,-20
CZ,FR,2004.0,16,21,-5
OM,US,2017.0,10,13,-3
US,GH,2007.0,5,7,-2
AU,BD,2013.0,23,47,-24
NZ,PT,2012.0,6,2,4
NZ,IR,2019.0,10,26,-16
DE,PT,2007.0,38,18,20
BR,IL,2014.0,7,9,-2
JP,HK,1998.0,11,4,7
RS,FR,2004.0,2,2,0
CN,TR,2016.0,16,64,-48
GR,RS,2019.0,3,1,2
ZA,NG,2011.0,13,22,-9
nan,AT,2017.0,17,18,-1
GB,VE,2005.0,6,9,-3
RU,EE,2007.0,9,3,6
BD,TH,2020.0,4,4,0
ID,IN,2011.0,3,11,-8
DE,nan,2006.0,44,30,14
CO,CA,1998.0,3,1,2
VN,KR,2013.0,26,46,-20
US,BO,2020.0,8,10,-2
CH,IQ,2018.0,1,2,-1
VE,ES,1999.0,28,32,-4
DK,GW,2014.0,1,4,-3
US,GT,2001.0,3,2,1
CZ,AU,2012.0,8,6,2
SA,JO,2020.0,60,56,4
ES,AT,2017.0,39,31,8
VE,CU,2016.0,9,15,-6
BR,NO,2018.0,21,23,-2
ID,MY,2008.0,18,18,0
BR,MX,2013.0,95,90,5
IT,DZ,2022.0,35,10,25
LK,GB,2014.0,18,18,0
CZ,ID,2020.0,8,15,-7
OM,US,2019.0,15,13,2
ZA,IN,2011.0,26,38,-12
MX,SI,2022.0,15,7,8
SK,CZ,2011.0,88,49,39
IL,CN,2005.0,15,8,7
DE,JO,2008.0,13,7,6
BW,ZA,2006.0,6,4,2
nan,PE,2019.0,14,12,2
TW,RU,2013.0,14,10,4
KE,JP,1999.0,2,2,0
HU,SE,2022.0,13,6,7
QA,US,2006.0,8,11,-3
FI,BE,2003.0,5,7,-2
GR,GB,2022.0,88,125,-37
IN,JM,2017.0,1,2,-1
MM,US,2022.0,8,6,2
HN,US,1998.0,3,3,0
KR,DE,2006.0,17,37,-20
NG,SA,2014.0,9,9,0
GR,LU,2016.0,4,2,2
ZA,FR,2014.0,32,41,-9
PK,GB,1997.0,11,17,-6
US,MZ,2015.0,4,2,2
BH,GB,2009.0,2,2,0
GB,RS,2020.0,17,16,1
NP,KR,2017.0,7,13,-6
PT,CH,2009.0,14,9,5
CN,NG,2021.0,43,35,8
ET,KR,2002.0,76,55,21
BE,SI,2004.0,2,1,1
IR,ID,2018.0,39,13,26
TR,CA,2005.0,13,8,5
DK,IS,2006.0,7,4,3
BO,ES,2008.0,5,3,2
OM,IN,2012.0,12,13,-1
AT,CA,2005.0,21,20,1
BO,AR,2012.0,4,3,1
RS,GB,2018.0,30,19,11
DE,PK,2021.0,32,22,10
CL,VE,2007.0,21,16,5
SA,DE,2014.0,13,39,-26
BG,RU,2006.0,14,19,-5
nan,PE,2017.0,10,6,4
EG,NO,2009.0,1,2,-1
ZA,TZ,2020.0,10,8,2
HR,BA,2008.0,15,6,9
DK,CN,2002.0,13,9,4
BD,CN,2023.0,3,1,2
NP,KR,2019.0,20,6,14
BA,SI,2017.0,7,6,1
PL,AR,2022.0,4,1,3
OM,AU,2018.0,2,13,-11
EE,DE,2022.0,20,32,-12
MX,HN,2003.0,8,12,-4
ZM,ZW,2015.0,1,4,-3
FI,CL,2021.0,1,6,-5
JP,UA,2017.0,4,3,1
KZ,FR,2013.0,2,1,1
KW,EG,2011.0,17,9,8
NO,PL,2004.0,2,2,0
IL,TR,2009.0,8,3,5
FR,NE,2022.0,12,17,-5
AE,QA,2019.0,7,13,-6
IE,CZ,2015.0,9,6,3
NP,CA,2021.0,6,3,3
MX,NZ,2019.0,5,3,2
MY,AE,2018.0,19,4,15
NZ,NP,2017.0,37,43,-6
PK,CA,2003.0,8,6,2
BE,NO,2019.0,18,14,4
KZ,IR,2022.0,2,5,-3
PL,HU,2006.0,11,19,-8
KE,CA,2017.0,10,13,-3
LK,CA,2022.0,4,2,2
NG,RW,2019.0,2,1,1
GB,BE,2009.0,114,100,14
BR,AG,2021.0,4,1,3
NL,RU,1998.0,22,8,14
DE,UG,2006.0,1,2,-1
AM,US,1997.0,12,4,8
DE,SK,1997.0,23,12,11
JO,QA,2015.0,6,3,3
DE,AR,2015.0,34,43,-9
JP,FR,2011.0,129,127,2
IL,GB,2018.0,88,80,8
MX,GB,2021.0,38,58,-20
FR,IL,2011.0,30,21,9
JP,HU,1997.0,8,13,-5
CH,HU,2017.0,13,26,-13
CU,VE,2014.0,13,14,-1
KR,SD,2019.0,14,12,2
IN,IR,2008.0,23,5,18
US,KW,2001.0,11,15,-4
IE,FR,2014.0,39,29,10
HR,US,2006.0,18,43,-25
MA,US,2011.0,12,13,-1
JP,SI,2011.0,5,4,1
ES,HR,2021.0,9,4,5
MW,US,2016.0,15,20,-5
TR,DE,2002.0,17,24,-7
IN,PL,2011.0,5,7,-2
CZ,HR,2009.0,9,3,6
IT,PL,2011.0,23,29,-6
NL,IE,2013.0,18,24,-6
NL,PL,2004.0,13,13,0
MV,NZ,2019.0,1,1,0
nan,AT,2010.0,9,18,-9
PA,MX,2006.0,2,4,-2
CA,BD,2008.0,23,7,16
ES,AT,2019.0,38,32,6
MY,NO,2009.0,2,1,1
RW,US,2016.0,20,12,8
SG,CZ,2017.0,4,3,1
FR,RE,2012.0,38,21,17
IS,SE,2002.0,5,10,-5
FR,UA,2017.0,13,18,-5
PL,MZ,2018.0,6,17,-11
IL,PS,2021.0,5,3,2
UG,CH,2007.0,2,1,1
TW,SD,2019.0,1,1,0
BE,RU,2015.0,23,10,13
AR,FR,2003.0,17,16,1
ET,DE,2006.0,5,3,2
BE,PT,2012.0,9,13,-4
BE,PL,2000.0,7,5,2
MX,RU,2020.0,12,9,3
VN,GB,2015.0,15,11,4
SE,CH,2002.0,29,17,12
US,SK,2019.0,36,42,-6
ML,BF,2008.0,6,3,3
AU,MX,2014.0,12,21,-9
GT,US,2013.0,14,8,6
EG,IR,2009.0,5,2,3
nan,PE,2010.0,8,7,1
CH,ES,1997.0,19,17,2
nan,IR,2017.0,4,4,0
DE,CL,2019.0,63,74,-11
IS,SE,2005.0,9,6,3
MY,RU,2014.0,21,16,5
RU,HR,2009.0,4,5,-1
NG,CI,2019.0,3,3,0
US,MY,2001.0,24,21,3
GB,CY,2001.0,4,4,0
BT,NP,2019.0,3,1,2
TR,SA,2015.0,10,9,1
RU,IL,2005.0,13,14,-1
GB,LU,2011.0,12,3,9
SY,US,2006.0,3,5,-2
US,JM,2021.0,13,13,0
CL,GB,2006.0,15,31,-16
IT,MK,2015.0,2,1,1
UY,CL,2018.0,18,16,2
PL,nan,2001.0,2,2,0
RO,AU,2012.0,2,4,-2
CL,UY,2009.0,4,7,-3
CH,BR,2012.0,38,50,-12
RU,IL,2002.0,23,9,14
TW,AU,1999.0,10,12,-2
AR,AU,2018.0,9,15,-6
FR,BF,2013.0,15,15,0
TR,DE,2005.0,24,32,-8
VN,DE,2003.0,7,6,1
nan,KR,1998.0,9,9,0
DE,SI,2011.0,14,12,2
PL,BR,2002.0,2,2,0
CH,DK,1999.0,14,8,6
BR,TZ,2020.0,1,3,-2
VE,PT,2013.0,10,2,8
CZ,SE,2012.0,9,11,-2
OM,DE,2008.0,3,2,1
LU,IT,2020.0,12,22,-10
ZW,ZA,2006.0,19,3,16
RU,AT,1998.0,4,6,-2
CR,CA,2016.0,2,3,-1
VE,AR,2011.0,21,7,14
DK,TR,2019.0,6,17,-11
DE,TW,2007.0,17,13,4
TR,BE,2005.0,8,7,1
ES,PK,2011.0,4,1,3
nan,KR,1997.0,7,1,6
LT,DK,2019.0,3,3,0
NG,GB,1998.0,9,11,-2
FI,RS,2018.0,2,1,1
GR,DE,2022.0,31,36,-5
JP,PT,2012.0,7,2,5
RO,BR,2011.0,2,1,1
GB,SD,2016.0,8,4,4
RO,KR,2001.0,1,1,0
TN,CN,2015.0,1,1,0
IE,PK,2008.0,4,1,3
TW,NO,2020.0,5,2,3
MY,SD,2019.0,13,7,6
NP,TH,2016.0,5,4,1
ID,SE,2018.0,4,12,-8
BH,PL,2015.0,6,10,-4
NZ,TW,2019.0,8,5,3
GH,JP,2013.0,4,3,1
ES,SK,2008.0,2,6,-4
TR,FR,2012.0,16,24,-8
SD,QA,2012.0,2,4,-2
KR,NZ,2021.0,6,3,3
VE,FR,2019.0,7,3,4
CH,NZ,2011.0,13,16,-3
ID,ZA,2014.0,6,8,-2
CZ,BY,2004.0,10,2,8
US,CM,2019.0,21,20,1
AU,TR,2015.0,17,6,11
PK,NO,2018.0,5,10,-5
ZW,ET,2020.0,3,1,2
AU,CU,2016.0,1,3,-2
NO,PT,2022.0,4,3,1
CN,RS,2019.0,13,6,7
KR,CZ,2013.0,9,10,-1
CZ,IL,2019.0,9,6,3
BH,KE,2016.0,4,3,1
CO,UY,2016.0,15,17,-2
AU,NL,2023.0,4,4,0
GR,RU,2015.0,9,1,8
IR,PL,2021.0,17,1,16
JP,DE,2023.0,8,7,1
VN,IN,2018.0,4,8,-4
ET,AU,2020.0,23,17,6
ES,IN,2008.0,9,22,-13
CH,TZ,2017.0,2,7,-5
YE,EG,2019.0,6,16,-10
CZ,IL,2017.0,6,11,-5
IS,US,2001.0,12,19,-7
NL,UG,2020.0,8,2,6
DE,KZ,2018.0,6,7,-1
JP,IQ,2007.0,2,2,0
NZ,NP,2010.0,9,17,-8
AT,SK,2001.0,9,7,2
DE,LT,2008.0,10,6,4
KR,RU,2011.0,5,18,-13
CN,RS,2017.0,9,8,1
AT,CZ,2005.0,12,7,5
US,PA,2001.0,5,5,0
AT,BR,2014.0,16,16,0
DK,AU,2022.0,33,39,-6
IT,JP,2002.0,28,40,-12
DE,CU,2002.0,1,3,-2
HR,HU,2016.0,3,1,2
CO,DE,2022.0,18,14,4
PK,GB,1998.0,15,19,-4
GR,FI,2007.0,4,2,2
CA,TN,2021.0,10,13,-3
SE,CL,2016.0,8,9,-1
NG,CZ,2019.0,4,1,3
DE,GR,2001.0,26,19,7
TR,AT,2003.0,4,4,0
IN,IL,2012.0,18,27,-9
FR,MG,2017.0,20,18,2
BD,CO,2021.0,3,6,-3
ZA,KE,2015.0,22,22,0
AU,CM,2019.0,1,1,0
QA,JO,2019.0,7,20,-13
CA,CZ,2013.0,14,11,3
ID,QA,2022.0,3,2,1
US,SD,2014.0,7,7,0
IN,BE,2013.0,31,28,3
CH,ES,1998.0,15,19,-4
NL,CZ,2010.0,19,14,5
HR,CA,2015.0,3,7,-4
BG,CA,2000.0,2,2,0
AU,GR,2020.0,8,7,1
SE,AT,2011.0,24,22,2
SI,US,2010.0,11,22,-11
PE,CA,2020.0,10,3,7
RS,BG,2018.0,2,3,-1
PL,CN,2001.0,4,4,0
NG,BH,2019.0,7,3,4
CH,PK,2019.0,8,23,-15
RU,NL,2006.0,23,30,-7
PH,GB,1998.0,8,6,2
IT,MA,2011.0,12,13,-1
DK,AT,2013.0,10,18,-8
AU,PH,2004.0,8,7,1
HK,NL,2017.0,22,24,-2
AT,CZ,2002.0,7,6,1
GF,FR,2014.0,7,17,-10
PL,BE,2019.0,18,17,1
ZA,RO,2016.0,3,11,-8
AL,SE,2016.0,2,1,1
FR,AE,2008.0,5,2,3
SE,TZ,2007.0,3,2,1
AT,CA,2002.0,18,14,4
RS,NO,2009.0,1,1,0
US,SI,2012.0,25,22,3
JO,OM,2003.0,1,1,0
IT,UA,2020.0,15,20,-5
CZ,IT,2000.0,13,21,-8
AM,RU,2014.0,12,5,7
AT,RU,2020.0,22,24,-2
NO,TZ,2013.0,5,6,-1
UZ,KR,2020.0,3,4,-1
TH,BE,2018.0,9,3,6
TJ,RU,2011.0,16,19,-3
ZW,GB,2011.0,4,4,0
BE,EC,2021.0,4,9,-5
LV,RU,2008.0,27,12,15
GP,SE,2015.0,1,1,0
FR,CU,2015.0,7,6,1
MW,NO,2014.0,3,1,2
ID,NL,2005.0,11,11,0
BG,JP,2014.0,6,3,3
MZ,PL,1999.0,13,11,2
NL,VN,2013.0,8,3,5
FI,nan,2009.0,5,20,-15
MX,HU,2016.0,2,2,0
SD,TR,2019.0,3,2,1
QA,SY,2017.0,2,3,-1
ES,MT,2019.0,2,2,0
HU,NL,2010.0,12,16,-4
CZ,GB,1999.0,9,7,2
VN,CA,2006.0,1,5,-4
BS,US,2018.0,4,3,1
RS,SI,2005.0,7,7,0
JP,HK,1997.0,4,4,0
FJ,AU,2009.0,5,2,3
BD,IT,2009.0,3,1,2
ZA,ZW,2006.0,3,19,-16
KE,ZW,2017.0,2,1,1
IE,MT,2021.0,1,1,0
SG,HK,2004.0,1,1,0
PL,BR,2005.0,3,2,1
DK,CN,2005.0,14,6,8
KR,NP,2005.0,2,2,0
IE,BD,2014.0,6,2,4
UY,BR,2004.0,14,30,-16
SD,IQ,2015.0,9,4,5
MY,OM,2014.0,7,3,4
PH,IN,1998.0,5,7,-2
SG,FR,1998.0,1,4,-3
BJ,US,2003.0,1,5,-4
TW,TR,2003.0,4,2,2
CN,RS,2010.0,7,11,-4
US,UY,2003.0,8,13,-5
SG,MX,2022.0,2,4,-2
BE,TW,2015.0,2,2,0
DE,SK,1998.0,13,17,-4
TZ,IQ,2017.0,2,1,1
PH,SG,2009.0,5,5,0
KW,BD,2000.0,1,1,0
RU,MK,2016.0,1,3,-2
AM,US,1998.0,5,1,4
SE,AL,2006.0,2,2,0
UY,FR,2014.0,2,5,-3
CN,SI,2015.0,5,7,-2
RS,ES,2011.0,1,6,-5
BF,DE,2015.0,1,2,-1
PA,SE,2014.0,3,2,1
nan,SY,2019.0,1,1,0
MA,LB,2018.0,3,1,2
GT,CO,2010.0,1,2,-1
RU,BY,2006.0,25,32,-7
TR,CY,2004.0,2,2,0
VE,GB,2008.0,7,4,3
GB,VE,2002.0,7,3,4
IN,NP,2000.0,11,10,1
KR,SE,2012.0,8,11,-3
ET,NO,2017.0,8,13,-5
MX,VE,2003.0,16,18,-2
IQ,NL,2014.0,2,1,1
NG,GB,1997.0,6,2,4
MZ,FR,2013.0,2,1,1
BE,KR,2008.0,6,4,2
IE,RU,2002.0,6,2,4
ZA,NO,2008.0,5,5,0
MY,ES,2003.0,1,2,-1
BY,SK,2011.0,2,2,0
VE,FR,2017.0,9,6,3
IL,NG,2017.0,2,2,0
AU,PA,2015.0,5,3,2
DK,LT,2004.0,3,1,2
CO,IT,2006.0,4,3,1
IQ,NG,2021.0,4,6,-2
PT,CN,2015.0,10,9,1
CI,ML,2016.0,5,4,1
DK,GH,2020.0,5,1,4
CH,KR,2006.0,3,11,-8
IR,nan,2019.0,11,5,6
GR,PL,1998.0,2,2,0
CA,HR,2006.0,5,1,4
CH,MD,2010.0,3,1,2
BR,RU,2021.0,6,18,-12
CZ,IN,2000.0,5,5,0
PE,IT,2015.0,7,6,1
GR,ES,2022.0,13,8,5
KG,RU,2016.0,5,5,0
QA,JO,2017.0,2,7,-5
MY,SD,2017.0,9,4,5
PK,AU,2000.0,2,5,-3
BE,CO,2021.0,7,11,-4
IL,ES,2014.0,13,15,-2
KE,TZ,2005.0,5,3,2
TH,KR,2018.0,15,13,2
US,CM,2017.0,17,16,1
UG,TZ,2014.0,5,2,3
RU,NI,2017.0,2,1,1
GB,GY,2018.0,1,1,0
NL,RU,1997.0,7,19,-12
GB,BN,2000.0,1,5,-4
KW,TR,2013.0,2,9,-7
IR,KR,2017.0,15,9,6
GR,PS,2012.0,2,1,1
AU,CH,2003.0,27,36,-9
SI,CH,2021.0,6,9,-3
CZ,MY,2013.0,5,5,0
TT,JM,2007.0,7,19,-12
DZ,GB,2018.0,7,10,-3
CA,FI,2009.0,23,12,11
ES,HU,2008.0,3,6,-3
UA,FR,2003.0,13,8,5
KR,SD,2017.0,12,1,11
IL,JO,2017.0,2,1,1
BR,CU,2003.0,8,4,4
CO,CU,1998.0,2,4,-2
GB,NP,2004.0,2,6,-4
BE,CZ,2004.0,5,2,3
NO,IT,2001.0,16,10,6
PT,JP,2019.0,2,5,-3
CG,FR,2001.0,6,3,3
AT,EG,2008.0,5,4,1
AT,JP,2021.0,14,12,2
IE,HR,2006.0,10,1,9
PE,DE,2018.0,10,7,3
HK,CN,2005.0,9,14,-5
US,LK,1997.0,2,3,-1
RW,BE,2001.0,1,1,0
JP,MA,2015.0,1,1,0
CU,FR,2018.0,12,5,7
FR,UA,2019.0,17,22,-5
BH,QA,2020.0,2,4,-2
GB,AZ,2016.0,3,1,2
FI,KR,2017.0,6,7,-1
LU,FI,2012.0,5,2,3
SA,IT,2018.0,11,8,3
PH,CH,2020.0,2,3,-1
FI,CH,2003.0,11,12,-1
MA,ES,2000.0,2,2,0
IE,SG,2016.0,7,8,-1
HU,BE,2014.0,9,8,1
LB,NL,2019.0,8,3,5
BO,MX,2008.0,4,5,-1
MK,XK,2021.0,4,4,0
SG,RU,2021.0,7,2,5
LK,NP,2020.0,2,2,0
NL,CZ,2017.0,20,11,9
FR,VN,2012.0,26,23,3
AU,VN,2010.0,26,11,15
NG,BH,2010.0,5,3,2
IT,HU,2008.0,5,21,-16
CZ,IL,2010.0,2,4,-2
KR,BR,2013.0,6,3,3
HK,JP,2009.0,4,4,0
US,TZ,2011.0,16,17,-1
IQ,CA,2009.0,2,1,1
HK,PL,2017.0,2,2,0
RS,AG,2019.0,12,1,11
IE,OM,2020.0,2,2,0
CN,PH,2000.0,11,5,6
GB,AE,2010.0,27,12,15
PS,EG,2011.0,6,4,2
QA,ES,2015.0,3,13,-10
nan,IR,2019.0,5,11,-6
NL,HU,2008.0,5,14,-9
MG,DE,2013.0,1,3,-2
KW,PK,1998.0,1,1,0
NO,UG,2012.0,4,3,1
NG,SE,2016.0,5,3,2
BR,TR,2018.0,10,23,-13
IR,RU,2004.0,6,1,5
AU,MY,2023.0,6,1,5
TH,DK,2003.0,2,1,1
TR,CA,2002.0,9,5,4
ID,MA,2018.0,3,7,-4
CH,MY,2019.0,4,7,-3
GB,BB,2014.0,2,2,0
ES,MT,2010.0,2,3,-1
PL,UA,2005.0,6,19,-13
BA,HR,2004.0,5,7,-2
CH,HR,2009.0,3,3,0
BR,PL,2006.0,1,7,-6
AR,NO,2018.0,3,2,1
UY,DE,2011.0,1,4,-3
UA,IL,2014.0,4,5,-1
BE,NO,2010.0,11,10,1
KE,BE,2005.0,3,1,2
DE,OM,2020.0,3,2,1
PS,SA,2016.0,2,4,-2
QA,MY,2012.0,2,4,-2
IT,TH,2011.0,5,3,2
nan,CL,2007.0,4,2,2
KE,BE,2002.0,4,4,0
CO,CU,1997.0,1,3,-2
TH,CA,2001.0,5,3,2
GT,CO,2017.0,5,2,3
SZ,ZA,2013.0,4,2,2
CL,ID,2015.0,6,2,4
CN,NO,2002.0,10,8,2
NL,TZ,2008.0,2,1,1
KW,IN,2000.0,4,4,0
IL,JP,2013.0,4,16,-12
HR,IT,1997.0,3,1,2
ES,SA,2002.0,1,1,0
MK,GB,2022.0,4,1,3
FR,IR,2003.0,6,5,1
IR,KW,2020.0,6,3,3
RU,CL,2014.0,1,1,0
ZA,AT,2011.0,4,1,3
TW,IT,1999.0,2,1,1
SE,TH,2021.0,4,3,1
UZ,CZ,2000.0,2,1,1
UA,ID,2018.0,3,5,-2
DE,UA,2000.0,15,27,-12
RO,SK,2016.0,6,1,5
KZ,RU,2001.0,6,8,-2
TR,IN,2004.0,2,6,-4
JP,NP,2022.0,3,7,-4
NI,MX,2014.0,4,4,0
JP,UA,2019.0,6,6,0
US,ML,2011.0,4,2,2
RU,SI,2020.0,6,1,5
AG,CO,2019.0,13,11,2
ID,CH,2020.0,7,12,-5
SG,NO,2018.0,2,2,0
GB,RO,2006.0,11,15,-4
AM,FR,2006.0,3,3,0
GR,EE,2008.0,1,1,0
KE,CA,2019.0,8,14,-6
IL,PL,2004.0,5,1,4
HU,NL,2019.0,13,18,-5
JP,NG,2007.0,3,4,-1
JO,DE,2013.0,11,12,-1
SG,IN,1997.0,3,7,-4
AT,CN,2004.0,6,13,-7
NG,IN,2015.0,8,12,-4
SG,DE,2003.0,6,14,-8
VN,MY,2011.0,1,1,0
KR,NP,2002.0,1,1,0
SY,IQ,2021.0,4,7,-3
CN,CO,2015.0,3,4,-1
BJ,BE,2018.0,4,5,-1
AM,LT,2011.0,1,2,-1
NO,RS,2020.0,1,3,-2
TN,DE,2022.0,3,2,1
SD,NL,1998.0,2,1,1
AE,MA,2017.0,2,3,-1
BI,FR,2007.0,18,16,2
MY,SD,2010.0,4,3,1
EG,CN,2004.0,5,5,0
NP,IR,2019.0,1,2,-1
FR,MG,2010.0,3,10,-7
UA,FI,2013.0,5,1,4
MY,SG,1997.0,7,1,6
BE,IE,2002.0,1,3,-2
OM,EG,2022.0,7,12,-5
AT,NO,2022.0,11,7,4
MD,RU,2001.0,2,1,1
IT,TN,2007.0,3,2,1
JP,LT,2020.0,8,2,6
UA,JP,2004.0,3,2,1
CH,HU,2010.0,9,21,-12
NP,GB,2014.0,6,8,-2
SK,BG,2001.0,1,1,0
BA,SI,2019.0,8,2,6
HU,FI,2021.0,5,6,-1
RS,QA,2009.0,1,1,0
MY,SG,1998.0,6,3,3
BY,GB,2014.0,1,1,0
DE,HR,2003.0,11,23,-12
TG,FR,2022.0,1,2,-1
SK,HU,2007.0,14,4,10
AE,PK,2005.0,1,5,-4
NL,PH,2008.0,4,5,-1
UY,CO,2004.0,3,1,2
BG,FR,2020.0,1,7,-6
HU,RS,2004.0,4,2,2
MG,FR,2011.0,8,10,-2
IN,NG,1998.0,2,1,1
JP,CL,2006.0,5,4,1
RS,SI,2002.0,4,2,2
MX,PY,2009.0,1,1,0
IR,DZ,2022.0,1,2,-1
PH,AU,2000.0,3,8,-5
CN,ZW,2017.0,1,3,-2
NZ,NO,2013.0,1,2,-1
HR,CH,2022.0,4,2,2
NL,EG,2009.0,2,7,-5
ES,SI,2008.0,4,4,0
AU,CL,2008.0,3,4,-1
NO,VN,2012.0,3,4,-1
CA,KZ,2021.0,5,2,3
LY,IN,2011.0,8,1,7
IN,JM,2019.0,3,1,2
IL,UY,2011.0,1,1,0
UG,NL,2009.0,1,3,-2
RO,CH,1998.0,2,1,1
IR,AU,2004.0,5,18,-13
MA,BE,2004.0,5,1,4
CO,CA,1997.0,2,2,0
BE,BO,2013.0,4,1,3
IL,NL,2003.0,7,8,-1
MA,MD,1998.0,8,4,4
PL,IE,1999.0,1,1,0
IR,TN,2008.0,2,3,-1
KE,DE,1999.0,2,1,1
US,MW,2006.0,3,6,-3
PT,AU,1999.0,2,2,0
KE,ZW,2019.0,2,3,-1
CZ,nan,2014.0,1,2,-1
PT,JP,2017.0,3,4,-1
NZ,IR,2017.0,7,14,-7
CL,PY,2012.0,3,4,-1
AR,RO,2018.0,1,1,0
ID,CM,2020.0,1,3,-2
BT,AU,2021.0,2,3,-1
TR,BE,2002.0,4,2,2
PT,PK,2013.0,1,1,0
BE,RO,2011.0,15,14,1
CZ,HU,2020.0,14,15,-1
IR,QA,2021.0,8,1,7
CR,VE,2007.0,3,1,2
IN,OM,2000.0,6,1,5
NL,FI,2023.0,2,1,1
TH,LK,2009.0,2,1,1
MY,PT,2022.0,1,1,0
LU,AT,2010.0,1,3,-2
DZ,SA,2007.0,4,3,1
AR,EC,2009.0,4,6,-2
NL,TT,2008.0,1,1,0
AT,NZ,2005.0,2,1,1
AE,KW,2008.0,2,3,-1
PL,SK,2008.0,7,3,4
CR,BR,2003.0,2,1,1
AE,AU,2007.0,1,8,-7
ES,KZ,2021.0,3,2,1
BJ,SN,2018.0,1,4,-3
GR,ZA,1999.0,1,1,0
SG,CZ,2019.0,2,1,1
LK,IN,2009.0,9,4,5
MX,SG,2012.0,4,6,-2
CN,VE,2017.0,1,2,-1
CY,CH,2014.0,3,2,1
PL,NL,2004.0,13,13,0
TN,AR,2013.0,2,1,1
UZ,IN,2007.0,1,2,-1
ES,CD,2011.0,1,1,0
ZW,ML,2016.0,1,1,0
HK,PL,2019.0,4,3,1
NG,BH,2017.0,1,3,-2
PH,IR,2009.0,1,1,0
SY,GB,2008.0,2,2,0
CZ,ZA,2023.0,1,1,0
DE,LK,2017.0,3,2,1
GD,CA,2021.0,1,1,0
GR,DK,2003.0,2,2,0
IR,nan,2010.0,4,4,0
MN,US,2018.0,2,3,-1
PK,CM,2018.0,2,2,0
DZ,IT,1997.0,1,2,-1
TW,TH,2016.0,19,7,12
CN,IQ,2015.0,7,2,5
SI,nan,2011.0,2,4,-2
BE,UA,2016.0,3,4,-1
PL,BG,1999.0,4,2,2
AU,HK,2005.0,2,1,1
BD,CH,1999.0,1,2,-1
EC,FR,2012.0,3,5,-2
TR,PK,1999.0,1,3,-2
GB,LT,2006.0,4,4,0
CZ,MX,2016.0,6,7,-1
JP,TZ,2008.0,2,2,0
VN,TH,2001.0,1,1,0
DK,GR,2012.0,2,5,-3
PH,NL,2007.0,2,2,0
RO,ZA,2015.0,3,5,-2
RS,AU,2019.0,4,4,0
ZA,nan,2007.0,7,9,-2
FI,ES,2005.0,7,4,3
IE,RU,2005.0,5,7,-2
BN,JP,2018.0,2,2,0
IE,TR,2015.0,3,4,-1
TW,SY,2021.0,1,1,0
NG,TT,2013.0,1,1,0
GB,HK,2014.0,9,5,4
KZ,PK,2014.0,2,1,1
MY,DK,2009.0,1,1,0
DE,CU,2005.0,5,6,-1
SI,PL,2018.0,4,3,1
PL,UA,2002.0,4,17,-13
TW,BE,2009.0,4,6,-2
UA,CZ,2002.0,6,6,0
MD,MA,2008.0,5,3,2
TR,TN,2017.0,2,1,1
RU,IN,2006.0,9,7,2
CA,VE,2014.0,2,6,-4
QA,IR,2022.0,4,4,0
DK,QA,2003.0,1,1,0
QA,JO,2010.0,2,5,-3
FR,SI,2022.0,1,3,-2
UA,DK,2022.0,2,1,1
RS,SG,2016.0,1,1,0
RU,IR,2000.0,1,3,-2
MX,IL,2014.0,2,2,0
GB,MU,2018.0,7,1,6
SA,MA,2011.0,1,2,-1
EG,FR,1999.0,7,1,6
GR,SI,2016.0,1,1,0
PA,ES,2006.0,4,3,1
TR,IL,2004.0,1,5,-4
ZA,MY,2011.0,5,3,2
BA,DE,2006.0,1,2,-1
SE,EC,2009.0,2,1,1
BR,KR,2013.0,3,6,-3
RS,AU,2010.0,3,4,-1
NZ,IR,2010.0,2,4,-2
MA,BD,2022.0,10,17,-7
NP,SG,2019.0,1,2,-1
ME,QA,2021.0,1,1,0
GR,CN,2002.0,3,8,-5
DE,AZ,2015.0,3,1,2
TH,BD,2004.0,1,1,0
LI,CH,2005.0,1,1,0
CN,VE,2019.0,2,1,1
LT,JP,2014.0,5,9,-4
HN,CO,2013.0,3,6,-3
KR,IE,2011.0,6,2,4
KR,CL,2013.0,3,1,2
HU,RU,2007.0,8,9,-1
OM,GB,2009.0,8,8,0
HU,SI,2010.0,1,1,0
KE,BH,2004.0,4,4,0
KE,CO,2020.0,6,3,3
OM,KW,2012.0,1,2,-1
CO,NO,2016.0,1,1,0
RU,KZ,2007.0,8,9,-1
BA,CA,2019.0,2,1,1
IL,JO,2019.0,2,3,-1
PH,GB,1997.0,6,2,4
US,CM,2010.0,7,9,-2
KE,NL,2022.0,5,7,-2
TZ,ZA,2017.0,5,8,-3
JP,BF,2016.0,2,1,1
SK,UA,2018.0,7,6,1
HT,US,2020.0,2,2,0
SM,IT,2014.0,3,3,0
VG,CN,2014.0,3,3,0
DE,NP,2004.0,2,1,1
DE,LK,2019.0,3,3,0
BE,BD,2007.0,2,1,1
RO,PT,2001.0,1,1,0
AU,SI,2004.0,1,4,-3
CA,RW,2020.0,1,3,-2
BO,DE,2016.0,2,1,1
GB,UY,1998.0,2,1,1
US,BB,2022.0,2,3,-1
AT,TW,2001.0,1,1,0
SE,LT,2004.0,6,2,4
CH,CG,2020.0,2,4,-2
CD,BE,2016.0,5,12,-7
DE,IQ,2004.0,1,1,0
PK,AE,2011.0,4,5,-1
IN,UZ,2009.0,1,2,-1
EG,DK,2011.0,1,3,-2
EE,FR,2020.0,4,7,-3
SE,EG,2012.0,6,6,0
UG,CA,2008.0,1,1,0
PK,PH,2014.0,2,1,1
NI,CU,2010.0,1,1,0
FI,PT,2012.0,4,4,0
SE,LV,2016.0,2,4,-2
KE,AR,2019.0,1,2,-1
ET,NO,2010.0,3,3,0
PT,EC,2020.0,6,7,-1
AE,SY,2018.0,1,3,-2
SK,SI,2021.0,2,3,-1
TZ,ZA,2010.0,4,2,2
CN,AR,2001.0,2,2,0
SG,FR,1997.0,3,2,1
CZ,SI,1998.0,1,1,0
PH,ES,1999.0,2,6,-4
ES,MT,2017.0,5,2,3
SA,SG,2014.0,3,6,-3
NI,GB,2018.0,1,2,-1
BW,CA,2014.0,2,2,0
CH,MW,2016.0,1,1,0
AR,SA,2017.0,3,1,2
CM,KR,2019.0,1,2,-1
CO,UA,2004.0,2,2,0
SK,BR,2015.0,5,3,2
CR,FR,2015.0,3,5,-2
IR,KZ,2019.0,2,5,-3
TW,BR,2008.0,1,1,0
IT,KE,2021.0,4,8,-4
QA,ET,2019.0,1,1,0
EC,UY,2022.0,5,1,4
FR,MY,1999.0,3,2,1
IS,TR,2020.0,2,2,0
DE,LK,2010.0,2,1,1
IL,NZ,1998.0,2,1,1
JP,BY,2008.0,2,1,1
CH,EG,2006.0,1,2,-1
TZ,GB,2010.0,6,17,-11
BR,HU,2016.0,3,4,-1
CU,JP,2020.0,1,2,-1
PT,MX,1999.0,2,5,-3
PR,CN,2018.0,1,1,0
UA,NL,2010.0,3,5,-2
CR,IT,2015.0,4,4,0
DK,FO,2012.0,2,1,1
NL,UA,2001.0,3,1,2
HU,SK,1998.0,2,5,-3
IQ,BD,2021.0,6,3,3
IS,SG,2014.0,1,2,-1
NZ,TW,2017.0,8,7,1
CM,SN,2015.0,2,2,0
SI,TR,2014.0,1,2,-1
LB,BE,2005.0,1,1,0
NL,RO,2005.0,2,7,-5
RU,PL,2023.0,1,3,-2
CZ,TH,2020.0,1,1,0
CZ,GR,2000.0,1,1,0
ZM,GB,2022.0,3,2,1
nan,IR,2010.0,4,4,0
IS,BE,2013.0,3,2,1
JO,AU,2000.0,1,2,-1
EE,CH,2022.0,2,1,1
PT,VE,2014.0,3,5,-2
GB,BH,2008.0,3,2,1
FJ,IN,2013.0,4,1,3
PT,ZA,2022.0,4,6,-2
VE,SE,2010.0,1,1,0
CU,HN,2012.0,2,1,1
IT,EG,2001.0,2,1,1
TW,AT,2004.0,1,1,0
SK,IE,2017.0,1,2,-1
IR,JO,2011.0,1,2,-1
UG,GM,2017.0,1,1,0
FI,ES,2002.0,2,4,-2
CH,MY,2017.0,6,7,-1
CH,MY,2010.0,1,1,0
SG,KR,2003.0,4,12,-8
SV,BR,2000.0,1,1,0
IE,FI,2007.0,1,1,0
IR,AE,2016.0,2,5,-3
CR,NL,2004.0,1,1,0
FR,PK,2003.0,3,3,0
AZ,GE,2007.0,1,8,-7
DZ,CN,2016.0,2,3,-1
MK,BG,2011.0,3,1,2
TH,VN,2001.0,1,1,0
RO,JP,2005.0,3,4,-1
TW,IR,2009.0,1,3,-2
LY,JP,1998.0,3,2,1
CO,RU,2011.0,1,1,0
KR,NG,2009.0,4,11,-7
MA,DE,2000.0,4,1,3
CL,TR,2015.0,2,2,0
US,NA,2015.0,2,7,-5
IE,SK,2018.0,1,2,-1
RU,NG,2020.0,2,3,-1
CA,SN,2006.0,1,1,0
BE,NG,2012.0,2,3,-1
US,GM,2015.0,1,2,-1
GB,SL,2014.0,1,1,0
CH,ME,2014.0,1,2,-1
CY,CN,2012.0,2,1,1
NP,nan,2014.0,1,3,-2
NZ,AE,2004.0,3,4,-1
CH,ZW,2020.0,2,1,1
TH,AT,2012.0,2,10,-8
GB,MS,2003.0,3,1,2
RS,ZA,2009.0,1,2,-1
CN,SG,2006.0,198,316,-118
AU,CN,2006.0,183,142,41
GB,US,2011.0,5690,5861,-171
IR,KR,2010.0,3,1,2
US,BD,2014.0,99,116,-17
MY,NG,2018.0,140,73,67
FR,PT,2018.0,51,48,3
DK,SE,2000.0,51,50,1
ES,MX,2013.0,756,721,35
IN,US,2002.0,921,649,272
FI,KR,2010.0,11,2,9
KR,JP,2005.0,191,257,-66
US,CO,2009.0,189,179,10
JP,CN,2020.0,552,465,87
nan,IT,2001.0,79,62,17
BR,CA,2009.0,225,227,-2
AR,CO,2009.0,44,57,-13
FR,CO,2013.0,28,31,-3
MX,CU,2012.0,38,58,-20
MX,BR,2001.0,30,18,12
RS,US,2017.0,67,64,3
BD,CA,2022.0,32,15,17
DE,AL,2012.0,3,1,2
BE,SE,2007.0,14,15,-1
IN,TW,2014.0,57,42,15
TZ,GB,2017.0,15,19,-4
JP,nan,2013.0,35,45,-10
FR,GP,2012.0,23,11,12
CA,SG,2017.0,52,47,5
ID,ES,2020.0,21,16,5
FI,US,2000.0,109,94,15
MY,PH,2016.0,4,1,3
TW,MY,1999.0,2,1,1
KR,TW,2016.0,46,54,-8
PT,nan,2011.0,26,31,-5
US,DZ,2020.0,70,72,-2
GB,BR,2002.0,78,48,30
IN,CA,2001.0,80,101,-21
DE,FI,2014.0,74,58,16
DK,TR,2017.0,15,18,-3
MX,CR,2011.0,37,26,11
US,GR,2019.0,170,167,3
GB,ET,2018.0,9,11,-2
ET,TR,2022.0,2,2,0
nan,RU,2022.0,15,21,-6
CN,BR,2021.0,35,29,6
BR,HN,2016.0,6,4,2
AR,NL,2022.0,7,4,3
GB,IE,2005.0,236,175,61
LY,TN,2016.0,1,1,0
FR,DK,2001.0,16,12,4
AG,TR,2018.0,36,265,-229
RU,FR,2008.0,71,53,18
BE,DE,2019.0,162,165,-3
AE,QA,2017.0,18,12,6
BR,SD,2013.0,11,11,0
DE,CL,2017.0,50,56,-6
FR,MG,2019.0,20,12,8
CA,IN,1999.0,80,48,32
GH,ZM,2005.0,2,5,-3
CA,SG,2010.0,40,41,-1
ID,FR,2018.0,33,62,-29
RS,US,2019.0,58,66,-8
AR,DE,2011.0,41,23,18
IL,CN,2002.0,16,9,7
BO,US,2001.0,4,4,0
NO,AU,1998.0,4,6,-2
NL,CA,2013.0,89,85,4
BG,IT,2018.0,13,12,1
ES,KE,2021.0,2,3,-1
UA,CN,2019.0,34,23,11
FR,BG,2004.0,7,8,-1
SG,VN,2021.0,13,3,10
RU,MZ,2014.0,6,12,-6
CH,PK,2017.0,18,16,2
US,NG,2001.0,13,15,-2
SE,RU,2020.0,39,38,1
NL,SK,2016.0,4,7,-3
PH,IN,1997.0,6,2,4
GE,GB,2004.0,3,2,1
SA,JP,2011.0,5,19,-14
ID,CN,2007.0,11,12,-1
UA,CN,2010.0,16,16,0
HK,US,2014.0,15,13,2
MA,GB,2020.0,10,8,2
UA,BY,2009.0,5,9,-4
HU,CZ,2003.0,4,4,0
SE,PK,2013.0,15,12,3
RS,US,2010.0,53,43,10
RS,NL,2007.0,3,3,0
nan,PK,2018.0,12,14,-2
BD,IE,2013.0,2,2,0
DK,ZA,2008.0,3,6,-3
HR,IN,2006.0,1,1,0
IQ,EG,2011.0,4,7,-3
CH,TZ,2019.0,6,10,-4
DK,IL,2009.0,2,5,-3
ZM,ZA,2011.0,3,1,2
VE,FR,2010.0,14,13,1
AM,KR,2007.0,11,7,4
ZA,IT,2008.0,10,5,5
NL,MY,2022.0,3,11,-8
FR,QA,2014.0,18,7,11
AU,KE,2015.0,6,6,0
GR,PL,1997.0,2,3,-1
KW,US,2011.0,10,15,-5
RU,FI,2004.0,17,24,-7
NP,KR,2010.0,4,2,2
US,ZM,2005.0,7,2,5
HN,BR,2018.0,4,2,2
UZ,RS,2007.0,1,1,0
CA,BE,2001.0,21,35,-14
AT,NZ,2002.0,5,1,4
SN,BJ,2011.0,2,1,1
GP,US,2012.0,1,1,0
DK,ES,2000.0,16,16,0
EG,IL,2016.0,4,6,-2
SK,JP,2016.0,9,1,8
CO,GT,2016.0,4,5,-1
UA,PL,2006.0,13,17,-4
RW,NG,2019.0,1,2,-1
SK,AT,2007.0,13,14,-1
IE,GE,2018.0,3,1,2
UA,CZ,2005.0,1,3,-2
RU,RO,2012.0,5,3,2
IE,KZ,2020.0,1,1,0
AE,NL,2018.0,3,4,-1
RS,AU,2017.0,5,6,-1
CN,RO,2006.0,1,2,-1
NL,GA,2018.0,5,8,-3
NO,EG,2018.0,1,4,-3
FI,BG,2004.0,1,1,0
IN,VE,2005.0,1,1,0
FR,PH,2014.0,3,10,-7
PY,MX,2015.0,6,8,-2
MY,KW,2019.0,6,3,3
SN,US,2007.0,3,9,-6
DE,NG,2022.0,9,10,-1
NI,ES,2004.0,2,5,-3
SE,BR,2023.0,2,3,-1
RU,MY,2009.0,7,7,0
MY,KW,2017.0,5,2,3
CA,ID,2003.0,3,2,1
BO,PE,2008.0,1,2,-1
BA,CA,2017.0,1,1,0
TR,KW,2004.0,2,1,1
DK,NG,2008.0,2,1,1
IQ,QA,2005.0,1,1,0
QA,BR,2019.0,1,3,-2
RO,NL,2006.0,3,7,-4
DE,PS,2020.0,6,3,3
HN,AR,2006.0,1,1,0
QA,BR,2017.0,2,1,1
YE,IN,2013.0,1,1,0
FR,BZ,1998.0,2,1,1
EC,PE,2009.0,2,2,0
UA,KZ,1999.0,2,1,1
IR,HU,2016.0,1,4,-3
LV,JP,2001.0,1,1,0
ZA,DK,2015.0,1,6,-5
PK,TW,2009.0,2,1,1
KW,PK,1997.0,2,1,1
SA,TN,2004.0,3,1,2
GB,BD,1999.0,17,17,0
HU,MA,2014.0,9,4,5
ZA,CA,2022.0,23,23,0
CA,nan,2022.0,14,14,0
ME,RS,2015.0,13,24,-11
BE,BG,2009.0,8,11,-3
PA,PH,2013.0,1,1,0
US,MU,2008.0,1,2,-1
RS,PL,2016.0,4,3,1
UA,CN,2017.0,32,15,17
TR,FI,2013.0,2,5,-3
NL,IR,2004.0,4,3,1
KR,AM,2014.0,2,2,0
DE,XK,2017.0,2,2,0
CO,,2024.0,9523,0,9523
,CH,1994.0,9919,0,9919
DE,,2023.0,74905,0,74905
,KR,2003.0,4462,0,4462
,NO,1995.0,2213,0,2213
,JP,2008.0,15078,0,15078
CZ,,2024.0,13337,0,13337
TN,,2022.0,2444,0,2444
AT,,2021.0,3226,0,3226
IN,,2005.0,1959,0,1959
,BD,2004.0,270,0,270
SE,,2021.0,4951,0,4951
FR,,2007.0,5215,0,5215
KR,,2012.0,2124,0,2124
GT,,2023.0,247,0,247
CA,,2014.0,6307,0,6307
,MX,1998.0,2585,0,2585
BE,,2009.0,1266,0,1266
IN,,2002.0,1464,0,1464
ZA,,2020.0,2455,0,2455
,AT,2004.0,1855,0,1855
,CA,1999.0,7452,0,7452
,HU,2008.0,1192,0,1192
,PL,1999.0,3373,0,3373
GR,,2004.0,449,0,449
,UA,2005.0,1575,0,1575
,CZ,1995.0,1870,0,1870
,RS,2000.0,874,0,874
NZ,,2020.0,1363,0,1363
NO,,2007.0,426,0,426
JP,PG,2010.0,2,0,2
,VN,2000.0,148,0,148
PH,,2017.0,412,0,412
RU,,2025.0,5213,0,5213
,PK,2012.0,2414,0,2414
,AT,1996.0,1997,0,1997
,VE,1999.0,399,0,399
VE,,2011.0,273,0,273
nan,,2021.0,1210,0,1210
,PR,2002.0,19,0,19
IQ,JP,2006.0,1,0,1
LT,,2025.0,243,0,243
,CU,1995.0,273,0,273
DO,,2021.0,69,0,69
LU,,2011.0,48,0,48
PE,,2018.0,585,0,585
PH,,2010.0,120,0,120
,EC,2010.0,269,0,269
PH,BO,2011.0,1,0,1
VN,,2001.0,13,0,13
,ZW,1999.0,73,0,73
PH,KE,1998.0,1,0,1
,EC,2017.0,1011,0,1011
,PH,2014.0,740,0,740
PH,,2019.0,557,0,557
,PR,2005.0,16,0,16
,UA,2002.0,1374,0,1374
MA,,2012.0,248,0,248
,BD,1996.0,151,0,151
,BY,1998.0,446,0,446
,UG,2016.0,417,0,417
TZ,,2006.0,19,0,19
EE,,2003.0,27,0,27
SY,,2022.0,199,0,199
VE,DK,1998.0,1,0,1
,AE,1994.0,223,0,223
BY,KR,2011.0,2,0,2
UZ,PL,2007.0,2,0,2
IE,,1999.0,138,0,138
,SK,2016.0,804,0,804
IR,,2001.0,48,0,48
KE,,2005.0,32,0,32
KZ,,2008.0,35,0,35
,BT,2014.0,20,0,20
,LY,2006.0,31,0,31
PK,,2001.0,46,0,46
AR,,2000.0,160,0,160
GE,,2018.0,180,0,180
PG,,2010.0,6,0,6
,BY,1997.0,300,0,300
PA,,1998.0,2,0,2
,BJ,2010.0,125,0,125
,NI,1998.0,9,0,9
,CI,2015.0,230,0,230
,PG,2015.0,28,0,28
,BJ,2019.0,66,0,66
,LV,2018.0,295,0,295
,IQ,2001.0,33,0,33
SN,GB,2004.0,2,0,2
CU,,2008.0,115,0,115
BE,IE,2005.0,6,0,6
BS,,2022.0,16,0,16
,BW,2001.0,41,0,41
UY,,2003.0,15,0,15
KG,,2024.0,321,0,321
EG,NP,2009.0,1,0,1
PG,,2019.0,31,0,31
MV,IT,2018.0,1,0,1
nan,HU,1999.0,3,0,3
VG,,2020.0,32,0,32
JP,MD,2003.0,1,0,1
CI,ID,2021.0,1,0,1
,MD,2007.0,103,0,103
,SM,2017.0,2,0,2
,EC,2019.0,365,0,365
SC,IN,2019.0,1,0,1
,RE,2013.0,26,0,26
,BJ,2017.0,159,0,159
OM,ID,2019.0,2,0,2
,BN,2018.0,37,0,37
,IS,2008.0,131,0,131
CY,PK,2021.0,4,0,4
PG,,2017.0,17,0,17
,MZ,2014.0,61,0,61
SA,,2009.0,171,0,171
HR,,1999.0,57,0,57
AM,,2018.0,112,0,112
,MX,1997.0,2518,0,2518
HU,,2013.0,684,0,684
,NP,2000.0,65,0,65
,LI,1998.0,3,0,3
LY,SA,2011.0,2,0,2
,GP,1998.0,11,0,11
RS,BA,2023.0,2,0,2
,PW,2010.0,3,0,3
,MW,2001.0,32,0,32
,UZ,2008.0,114,0,114
SN,BR,2008.0,1,0,1
IQ,GR,2018.0,2,0,2
DE,XK,2019.0,4,0,4
MN,CZ,2018.0,1,0,1
,XK,2003.0,15,0,15
GP,,2022.0,52,0,52
UZ,,2006.0,44,0,44
LB,,2009.0,69,0,69
BE,PH,2009.0,4,0,4
BI,CL,2015.0,1,0,1
VE,AU,2000.0,2,0,2
NG,PL,1999.0,1,0,1
SI,,2004.0,90,0,90
ZA,BG,2012.0,1,0,1
CN,PK,1998.0,2,0,2
YE,IT,2017.0,2,0,2
RS,AG,2017.0,26,0,26
JP,KP,2021.0,3,0,3
,MU,2015.0,35,0,35
PF,,2021.0,31,0,31
,MN,1995.0,10,0,10
VN,CG,2018.0,1,0,1
OM,ID,2017.0,1,0,1
KW,IQ,2015.0,4,0,4
,SC,2018.0,3,0,3
,CY,1999.0,60,0,60
NO,TJ,2018.0,1,0,1
EG,SN,2019.0,1,0,1
nan,GT,2021.0,1,0,1
,BI,2013.0,14,0,14
AU,CM,2017.0,1,0,1
TN,ES,2023.0,1,0,1
LR,MY,2021.0,1,0,1
PH,IT,2008.0,5,0,5
UY,CA,2022.0,3,0,3
SE,KW,2017.0,3,0,3
,NC,2014.0,11,0,11
JP,OM,2009.0,3,0,3
,AG,1994.0,10,0,10
MZ,BY,2000.0,1,0,1
IL,TH,1999.0,1,0,1
FO,NO,2020.0,1,0,1
SG,IL,2023.0,1,0,1
KE,,2002.0,27,0,27
FJ,,2015.0,7,0,7
UZ,GB,2012.0,4,0,4
ES,VN,2015.0,2,0,2
BN,NP,2019.0,1,0,1
PK,KE,1998.0,2,0,2
IN,AL,2015.0,1,0,1
DK,LU,2001.0,1,0,1
,PY,2009.0,40,0,40
MH,NC,2010.0,1,0,1
NC,MX,2006.0,1,0,1
JP,VG,2007.0,1,0,1
TZ,IQ,2019.0,2,0,2
CL,TW,2017.0,3,0,3
CL,RS,2005.0,3,0,3
SC,,2016.0,1,0,1
SV,PY,2021.0,1,0,1
,NA,1996.0,15,0,15
NI,FR,2002.0,1,0,1
US,KH,2005.0,4,0,4
CZ,CU,2017.0,1,0,1
MY,BW,2020.0,1,0,1
LB,AT,2002.0,2,0,2
SK,CN,2002.0,2,0,2
,LS,2005.0,6,0,6
QA,ZA,2023.0,1,0,1
DE,GT,2019.0,1,0,1
UG,CG,2005.0,2,0,2
VN,RU,2003.0,1,0,1
NZ,MW,1999.0,1,0,1
AL,QA,2019.0,1,0,1
KR,IQ,2018.0,2,0,2
ZA,PL,2008.0,4,0,4
CY,TW,2012.0,1,0,1
CN,BA,2016.0,3,0,3
BR,TN,2012.0,2,0,2
AG,,2020.0,47,0,47
HN,,2013.0,16,0,16
LV,,2008.0,53,0,53
IR,SK,2009.0,1,0,1
GF,RE,2011.0,1,0,1
MD,NC,2020.0,1,0,1
,NA,2004.0,13,0,13
UA,DE,2023.0,3,0,3
JO,NL,2008.0,1,0,1
VN,IR,2003.0,1,0,1
,KH,1999.0,7,0,7
FR,LY,2009.0,1,0,1
NZ,TR,2008.0,1,0,1
MM,ID,2014.0,1,0,1
BY,KZ,2006.0,2,0,2
AR,HR,2001.0,1,0,1
AT,GR,1999.0,2,0,2
FR,SM,2010.0,1,0,1
BY,IT,2012.0,1,0,1
BS,ES,2022.0,1,0,1
OM,NZ,2005.0,1,0,1
,SL,1996.0,2,0,2
ES,SN,2003.0,1,0,1
ZA,HU,2009.0,1,0,1
BO,,2013.0,29,0,29
CM,AU,2005.0,1,0,1
TT,RO,2010.0,1,0,1
TN,NG,2016.0,1,0,1
MA,PE,2015.0,1,0,1
PY,,2013.0,6,0,6
IN,BN,2008.0,1,0,1
MA,UG,2000.0,1,0,1
LU,TR,2011.0,1,0,1
,NI,1997.0,10,0,10
EC,SG,2009.0,1,0,1
PF,BR,2009.0,1,0,1
CM,IT,2003.0,1,0,1
TW,SN,2012.0,1,0,1
JM,,2008.0,14,0,14
MR,,2014.0,1,0,1
AU,JM,2014.0,1,0,1
BJ,DE,2006.0,3,0,3
CZ,BR,2023.0,3,0,3
CR,ZA,2020.0,1,0,1
BA,,2005.0,6,0,6
ZW,PT,2023.0,1,0,1
AT,TH,2021.0,2,0,2
VN,TN,2017.0,1,0,1
GB,KY,2008.0,1,0,1
LU,SN,2002.0,1,0,1
OM,TZ,2023.0,1,0,1
MW,CZ,2017.0,1,0,1
MD,ID,2017.0,1,0,1
MN,PL,2015.0,1,0,1
AZ,,1999.0,3,0,3
KR,TZ,2011.0,2,0,2
US,SM,2014.0,1,0,1
CA,ET,2002.0,1,0,1
GN,DE,2021.0,2,0,2
BD,PG,2015.0,1,0,1
CO,PT,2003.0,1,0,1
TM,,2023.0,4,0,4
,JE,2017.0,2,0,2
MZ,US,2011.0,5,0,5
CO,DK,2022.0,2,0,2
MY,ID,1997.0,1,0,1
CG,IT,2014.0,1,0,1
FR,PE,2004.0,4,0,4
CA,ZW,2016.0,1,0,1
,PS,1995.0,21,0,21
AL,ES,2011.0,1,0,1
NO,HK,2015.0,1,0,1
MM,UG,2020.0,2,0,2
RS,nan,2008.0,1,0,1
TZ,CN,2008.0,2,0,2
LU,GA,2010.0,1,0,1
,LR,2007.0,8,0,8
BH,LR,2022.0,1,0,1
NL,PG,2012.0,1,0,1
PE,RU,2009.0,1,0,1
GB,BW,2012.0,2,0,2
ZA,DZ,2010.0,1,0,1
IL,KZ,2018.0,1,0,1
MV,SA,2018.0,1,0,1
PA,NZ,2004.0,1,0,1
UZ,CH,2006.0,1,0,1
VE,DK,1997.0,1,0,1
SV,CR,2022.0,1,0,1
NI,,2012.0,8,0,8
IL,AL,2017.0,2,0,2
ZA,TW,1997.0,1,0,1
AE,YE,2015.0,3,0,3
CA,AF,2019.0,2,0,2
LY,EG,2008.0,1,0,1
EG,ET,1999.0,1,0,1
TW,OM,2008.0,1,0,1
JP,YE,2010.0,1,0,1
MM,,2008.0,6,0,6
PR,CA,2017.0,3,0,3
EG,IN,2003.0,3,0,3
PH,BE,2006.0,1,0,1
VN,CL,2019.0,2,0,2
,IM,2007.0,1,0,1
PH,ZW,2020.0,1,0,1
NE,GB,2021.0,2,0,2
IR,AL,2022.0,1,0,1
GF,MQ,2017.0,1,0,1
TR,GP,2016.0,1,0,1
FR,CF,2018.0,3,0,3
BA,,2002.0,2,0,2
GB,PE,2001.0,1,0,1
NL,VG,1997.0,1,0,1
,KY,2008.0,4,0,4
SD,MN,2018.0,1,0,1
IS,,2004.0,22,0,22
IE,HK,2003.0,1,0,1
PG,GD,2017.0,1,0,1
,PW,2019.0,1,0,1
PA,GR,1997.0,1,0,1
KW,FI,2004.0,2,0,2
CD,ZA,2012.0,3,0,3
MT,ES,2004.0,2,0,2
IL,NG,2010.0,2,0,2
IT,LV,2006.0,2,0,2
IN,TN,2004.0,2,0,2
SE,ET,2000.0,2,0,2
ML,ID,2019.0,1,0,1
CU,CN,2009.0,2,0,2
FR,TT,2011.0,1,0,1
NO,MD,2014.0,1,0,1
GA,NG,2020.0,1,0,1
DO,PT,2000.0,1,0,1
MT,JP,2012.0,1,0,1
BE,SJ,2005.0,1,0,1
MX,NZ,2010.0,5,0,5
DZ,BD,2015.0,2,0,2
EE,CN,2015.0,3,0,3
PK,ER,2011.0,1,0,1
AT,MK,2013.0,6,0,6
XK,,2002.0,1,0,1
US,KN,2005.0,1,0,1
RW,CN,2007.0,1,0,1
CA,MN,2014.0,1,0,1
MZ,LT,2014.0,1,0,1
BE,GM,2014.0,1,0,1
ET,BE,2002.0,1,0,1
YE,AE,2018.0,1,0,1
DE,MU,2015.0,1,0,1
ZW,NL,2001.0,1,0,1
IN,NI,2018.0,1,0,1
IN,YE,2012.0,4,0,4
ID,NO,2002.0,1,0,1
ZM,CD,2009.0,1,0,1
UZ,AZ,2016.0,3,0,3
JM,SG,2009.0,1,0,1
BD,LY,2015.0,1,0,1
IN,MU,2001.0,1,0,1
GW,DK,2006.0,5,0,5
GR,RO,2011.0,4,0,4
MD,LT,2018.0,2,0,2
,MO,2011.0,1,0,1
LU,VE,2017.0,1,0,1
OM,TR,2014.0,2,0,2
FJ,AE,2016.0,1,0,1
TN,JO,2009.0,1,0,1
GH,ZW,2019.0,2,0,2
ML,,1998.0,3,0,3
CZ,VN,2011.0,2,0,2
MD,PL,2015.0,1,0,1
,GP,1997.0,7,0,7
BW,UG,2022.0,1,0,1
GM,CA,2014.0,1,0,1
RU,KE,2015.0,2,0,2
MX,PR,2009.0,1,0,1
GQ,TZ,2020.0,1,0,1
AM,BE,2017.0,1,0,1
EC,DK,2022.0,1,0,1
DO,CU,2022.0,1,0,1
AR,RS,2003.0,1,0,1
BH,KW,2010.0,1,0,1
BY,IR,2012.0,1,0,1
FR,BZ,1997.0,2,0,2
CM,TG,2017.0,2,0,2
SG,PR,2018.0,1,0,1
NC,,2025.0,3,0,3
PT,HR,1998.0,1,0,1
TN,LU,2022.0,2,0,2
VE,DZ,2011.0,1,0,1
IT,HR,2006.0,1,0,1
GR,QA,2004.0,1,0,1
MG,GE,2014.0,1,0,1
IN,DO,2014.0,3,0,3
LY,FI,2017.0,1,0,1
SS,,2013.0,4,0,4
HR,IR,2012.0,2,0,2
HU,IR,2008.0,3,0,3
IQ,US,1998.0,1,0,1
UG,KR,1998.0,1,0,1
DE,GH,2002.0,3,0,3
KZ,IN,2008.0,1,0,1
CD,US,1999.0,2,0,2
GT,PH,2020.0,2,0,2
CU,PH,2013.0,2,0,2
IN,CM,2016.0,2,0,2
EG,TZ,2008.0,1,0,1
DE,SY,1998.0,1,0,1
EC,CA,2003.0,1,0,1
CN,VE,2010.0,2,0,2
YE,AU,2021.0,2,0,2
nan,ET,2012.0,2,0,2
MN,TR,2007.0,2,0,2
UZ,GR,1998.0,1,0,1
FI,LY,2016.0,2,0,2
FR,JM,2009.0,1,0,1
BJ,JP,2015.0,2,0,2
MW,SD,2000.0,1,0,1
KZ,CZ,2016.0,1,0,1
AE,JM,2005.0,1,0,1
HR,RO,2022.0,1,0,1
EE,DK,2012.0,2,0,2
SE,CM,2021.0,1,0,1
PK,PR,2016.0,1,0,1
AE,PK,2002.0,1,0,1
CZ,SI,1997.0,2,0,2
NG,RW,2010.0,1,0,1
AU,ZM,2002.0,1,0,1
KW,LY,2015.0,2,0,2
HN,CU,2020.0,1,0,1
VE,ZA,2008.0,1,0,1
,JE,2010.0,2,0,2
RE,AU,2012.0,1,0,1
SE,KW,2010.0,2,0,2
LK,TZ,2019.0,1,0,1
CM,RW,2007.0,1,0,1
CL,nan,2001.0,2,0,2
MA,GP,1997.0,1,0,1
NI,AR,2010.0,1,0,1
AT,MO,2008.0,1,0,1
MT,,2000.0,2,0,2
CH,SA,2008.0,2,0,2
TT,GD,2011.0,1,0,1
DE,CF,2009.0,1,0,1
US,ZM,2002.0,2,0,2
SA,IQ,2006.0,2,0,2
LY,IR,2021.0,1,0,1
BY,MN,2018.0,1,0,1
BN,PH,2018.0,1,0,1
UA,LV,2015.0,2,0,2
PF,US,2013.0,2,0,2
AU,DZ,2021.0,1,0,1
CI,AU,2018.0,2,0,2
DE,SV,2008.0,1,0,1
SN,CD,2021.0,1,0,1
YE,RU,2019.0,1,0,1
UA,IE,2013.0,1,0,1
CI,AR,2017.0,1,0,1
CN,EC,2022.0,2,0,2
RU,AR,2022.0,1,0,1
KW,DK,2021.0,1,0,1
SN,DZ,2016.0,1,0,1
PT,EG,2004.0,1,0,1
RU,MA,2007.0,1,0,1
ST,,2012.0,1,0,1
VA,,2023.0,1,0,1
PS,JP,1998.0,1,0,1
NC,CA,2009.0,1,0,1
CN,MD,2006.0,1,0,1
DE,BO,2013.0,2,0,2
NO,OM,2012.0,1,0,1
HU,NZ,2009.0,1,0,1
MN,nan,2019.0,1,0,1
BY,FR,2009.0,1,0,1
ET,GE,2007.0,1,0,1
MT,IE,2011.0,2,0,2
nan,SD,2005.0,1,0,1
ME,IT,2014.0,3,0,3
JO,BN,2021.0,1,0,1
YE,US,2021.0,3,0,3
CA,PG,2018.0,1,0,1
SI,KW,2021.0,1,0,1
NG,CZ,2017.0,2,0,2
GF,CG,2002.0,1,0,1
BR,ZM,2007.0,3,0,3
PK,HU,2003.0,1,0,1
CA,JM,2014.0,3,0,3
CA,SD,2015.0,1,0,1
UG,ET,2018.0,1,0,1
MD,BE,2002.0,1,0,1
DZ,LY,2019.0,1,0,1
PT,UY,2004.0,2,0,2
EG,MA,2006.0,1,0,1
,BA,2020.0,5,0,5
PH,JM,2016.0,1,0,1
SK,CN,2005.0,1,0,1
IL,IQ,2015.0,1,0,1
DE,TT,2002.0,1,0,1
TR,BD,2009.0,1,0,1
SA,SK,2001.0,1,0,1
CL,GT,2004.0,1,0,1
BY,SN,2010.0,1,0,1
IT,MN,2014.0,1,0,1
MR,IT,2005.0,1,0,1
UG,SY,2014.0,1,0,1
IQ,PL,2022.0,2,0,2
PS,,1998.0,2,0,2
PT,PL,2000.0,2,0,2
BF,LU,2013.0,2,0,2
GW,PH,2017.0,1,0,1
ZA,RU,2023.0,1,0,1
IE,KW,2009.0,1,0,1
SA,IL,2015.0,1,0,1
SD,IN,2016.0,1,0,1
GD,PK,2019.0,1,0,1
GD,IN,2016.0,1,0,1
NL,AM,2004.0,1,0,1
ZA,CZ,1998.0,1,0,1
BD,ET,2021.0,1,0,1
UY,BO,2003.0,1,0,1
EG,SI,2018.0,2,0,2
DE,CD,2023.0,1,0,1
ML,CI,2009.0,3,0,3
KY,IN,2012.0,5,0,5
LB,PK,2020.0,2,0,2
BY,ZW,2017.0,1,0,1
SL,GB,1998.0,1,0,1
IT,IS,2010.0,1,0,1
nan,BF,2021.0,3,0,3
AE,QA,2010.0,1,0,1
AU,MT,2004.0,1,0,1
NO,SA,2013.0,3,0,3
TN,SG,2012.0,1,0,1
SK,IE,2010.0,1,0,1
KG,AU,2012.0,1,0,1
PL,MK,2022.0,1,0,1
TR,YE,2020.0,1,0,1
GB,GA,2005.0,1,0,1
SK,KH,2006.0,1,0,1
GE,BG,2021.0,1,0,1
VE,SE,2019.0,2,0,2
SI,SG,2003.0,1,0,1
DJ,CN,2016.0,1,0,1
BO,IT,2018.0,1,0,1
HK,BG,2011.0,1,0,1
SE,PH,2006.0,1,0,1
NL,FJ,2012.0,1,0,1
,KP,2009.0,2,0,2
BE,CW,1997.0,1,0,1
DE,NI,2020.0,1,0,1
LT,BE,1998.0,1,0,1
,LS,2002.0,3,0,3
CA,ET,2005.0,1,0,1
PL,KW,2006.0,1,0,1
DE,GP,2013.0,2,0,2
SE,KW,2019.0,2,0,2
ZW,NA,2021.0,3,0,3
CZ,SS,2018.0,1,0,1
IN,AM,2014.0,1,0,1
KR,PG,2020.0,1,0,1
TH,GR,2012.0,1,0,1
AO,nan,2009.0,1,0,1
MD,SE,2004.0,3,0,3
LT,DK,2017.0,3,0,3
RO,CH,1997.0,1,0,1
AL,KZ,2010.0,1,0,1
IL,JO,2010.0,1,0,1
TZ,ID,2013.0,1,0,1
DE,YE,2014.0,2,0,2
BA,PL,2014.0,1,2,-1
BY,PL,2018.0,4,3,1
KE,CA,2010.0,2,1,1
LA,JP,2021.0,1,1,0
SA,PL,2018.0,1,5,-4
DK,TR,2010.0,2,2,0
LY,SE,2016.0,1,2,-1
MX,RS,2020.0,3,5,-2
ET,MW,2017.0,1,2,-1
ZA,IL,2012.0,2,1,1
MU,FR,2012.0,1,1,0
DZ,CA,1999.0,1,1,0
ES,LT,2018.0,3,1,2
AZ,TR,2008.0,3,5,-2
LU,GR,2019.0,2,1,1
MY,AR,2016.0,1,6,-5
LU,HU,2019.0,1,1,0
ID,BE,2013.0,1,2,-1
UA,NL,2017.0,4,5,-1
NL,UY,2020.0,1,5,-4
MY,HK,2022.0,1,1,0
IT,CY,2021.0,1,7,-6
GB,CM,2009.0,1,5,-4
MX,TW,2018.0,3,3,0
DE,LI,2016.0,1,1,0
IR,nan,2017.0,4,4,0
MY,HU,2020.0,1,1,0
ZW,TZ,2019.0,2,3,-1
DE,SN,2021.0,1,2,-1
TN,CH,2008.0,4,6,-2
AR,AT,2011.0,2,2,0
EG,PL,2011.0,1,1,0
SN,DE,2014.0,1,1,0
TR,NL,2001.0,5,9,-4
IT,PH,2015.0,3,5,-2
IQ,KZ,2021.0,1,1,0
GB,PA,2014.0,6,2,4
PK,MX,2022.0,1,1,0
IL,TN,2015.0,2,1,1
NP,SG,2017.0,1,1,0
KH,JP,2001.0,2,4,-2
TR,PL,2000.0,1,1,0
UA,NL,2019.0,1,7,-6
CR,DE,2022.0,2,1,1
JO,IE,2022.0,1,1,0
NL,LT,2008.0,3,2,1
UA,MD,2007.0,1,1,0
BO,SE,2020.0,1,4,-3
SK,MK,2016.0,1,1,0
CY,IL,2019.0,3,2,1
MM,KR,2016.0,1,2,-1
CR,SV,2016.0,1,1,0
IL,EG,2001.0,1,1,0
SY,NG,2019.0,1,1,0
MA,SY,2022.0,1,7,-6
RU,MN,2021.0,2,3,-1
KE,GH,1998.0,1,2,-1
DE,MD,1999.0,1,4,-3
CM,BF,2001.0,1,1,0
FI,KR,2019.0,3,4,-1
GN,CI,2019.0,1,2,-1
LB,NL,2017.0,1,1,0
LT,SE,2006.0,3,4,-1
BY,EC,2022.0,1,2,-1
PH,SE,2022.0,1,1,0
ES,MY,2020.0,1,1,0
GH,ZM,2002.0,2,2,0
MA,MD,1997.0,2,2,0
NZ,SK,2018.0,1,1,0
US,LK,1998.0,2,1,1
HU,MX,2011.0,2,1,1
RW,TR,2015.0,2,2,0
NO,AR,2014.0,1,3,-2
HK,CN,2002.0,2,3,-1
PH,PT,2007.0,1,1,0
JP,UZ,1999.0,1,4,-3
CZ,TW,2020.0,1,2,-1
RU,GE,1999.0,2,2,0
CM,ES,2016.0,1,1,0
nan,CY,2013.0,1,1,0
AT,ID,2000.0,2,1,1
EE,CA,2007.0,1,2,-1
LT,NL,2007.0,1,4,-3
CA,UG,2008.0,1,1,0
CH,MD,2019.0,5,1,4
CH,MD,2017.0,2,3,-1
BH,ZW,2006.0,1,1,0
GR,RS,2010.0,1,1,0
GN,CI,2017.0,1,2,-1
IT,LT,2015.0,1,3,-2
BR,BG,2021.0,2,3,-1
IL,BW,2015.0,1,1,0
BE,HR,2016.0,1,4,-3
YE,EG,2010.0,1,3,-2
EC,BE,2007.0,1,2,-1
BH,KW,2017.0,2,2,0
TJ,US,2013.0,1,1,0
BN,AU,2006.0,1,2,-1
LB,GB,2003.0,1,2,-1
GR,MY,2010.0,1,1,0
BO,CU,2012.0,1,2,-1
ET,AE,2018.0,1,2,-1
DK,BG,2011.0,1,1,0
TR,PS,2006.0,1,1,0
LT,FI,2006.0,1,2,-1
NG,OM,2020.0,1,2,-1
NZ,RO,2018.0,1,2,-1
SD,NL,1997.0,1,2,-1
SA,DZ,2008.0,1,7,-6
MK,KZ,2022.0,1,1,0
FI,MW,2016.0,1,3,-2
AU,LB,2006.0,1,1,0
ZA,DZ,2019.0,1,3,-2
IE,EG,2007.0,1,1,0
SG,BR,2000.0,1,2,-1
ST,BR,2000.0,1,8,-7
CN,PK,1997.0,1,4,-3
EC,ES,1998.0,1,1,0
PT,BY,2004.0,1,2,-1
NE,SN,2021.0,1,2,-1
DE,GT,2017.0,1,1,0
GM,FR,2001.0,1,1,0
US,GP,2011.0,1,1,0
NP,IT,2015.0,1,1,0
NL,RO,2002.0,1,7,-6
CA,GD,2021.0,1,1,0
ME,TR,2021.0,1,2,-1
PT,CV,2020.0,1,2,-1
NG,GH,2007.0,1,1,0
SA,ID,2012.0,1,2,-1
JP,RS,2016.0,1,7,-6
CO,SV,2014.0,1,4,-3
IN,FJ,2006.0,1,1,0
BN,SG,2006.0,1,1,0
SG,CA,2023.0,1,2,-1
LU,AT,2019.0,1,3,-2
RU,NI,2019.0,1,1,0
BG,AU,2022.0,1,1,0
UA,SK,2015.0,2,3,-1
LY,JP,1997.0,1,1,0
IL,FI,2021.0,1,1,0
BH,KW,2019.0,1,5,-4
LU,GR,2017.0,1,3,-2
AR,SA,2019.0,1,1,0
IQ,IN,2012.0,1,7,-6
YE,PK,2022.0,1,2,-1
NL,NG,2007.0,1,3,-2
FR,UZ,2016.0,1,1,0
SE,MT,2017.0,1,1,0
IL,NG,2019.0,1,3,-2
IR,AM,2021.0,1,1,0
NO,SK,2008.0,1,2,-1
GN,US,2014.0,1,2,-1
GB,CG,2018.0,1,2,-1
PH,QA,2016.0,1,1,0
SE,RO,2003.0,1,3,-2
IQ,RO,2020.0,1,2,-1
TZ,SE,1998.0,2,2,0
PH,TH,2020.0,1,9,-8
CL,SV,2009.0,1,1,0
MZ,CA,2018.0,1,1,0
MD,BE,2005.0,1,2,-1
MX,NZ,2017.0,3,4,-1
NI,PE,2020.0,1,2,-1
FI,ID,2022.0,2,3,-1
AE,ES,2008.0,1,2,-1
IE,NO,2004.0,1,2,-1
IE,PT,2022.0,1,5,-4
EG,HR,2016.0,1,1,0
CL,TW,2019.0,1,1,0
EE,US,2023.0,1,1,0
GB,PR,2013.0,2,0,2
FJ,MY,2016.0,1,0,1
CZ,CR,2003.0,1,0,1
LB,ID,2015.0,1,0,1
ER,NA,2012.0,1,0,1
CZ,BG,2022.0,2,0,2
CH,AL,2008.0,1,0,1
KG,TR,2000.0,1,0,1
TW,IQ,2016.0,1,0,1
HK,BE,2006.0,1,0,1
MX,EG,2009.0,1,0,1
CO,JM,2010.0,1,0,1
ST,CA,2009.0,2,0,2
SI,DK,2023.0,1,0,1
KE,ID,2003.0,1,0,1
NG,JM,2006.0,1,0,1
GH,AU,2007.0,1,0,1
EC,CH,2006.0,1,0,1
AE,CL,2023.0,1,0,1
NC,PT,2011.0,1,0,1
TH,OM,2000.0,2,0,2
MD,MX,2014.0,1,0,1
,CF,1994.0,1,0,1
IE,UA,2008.0,2,0,2
JM,GP,2003.0,1,0,1
SA,SS,2009.0,1,0,1
HK,QA,2014.0,1,0,1
NG,HU,1999.0,1,0,1
HN,PT,2014.0,1,0,1
SL,KH,2021.0,1,0,1
,ME,2020.0,1,0,1
GB,LV,2003.0,2,0,2
GB,UY,1997.0,1,0,1
MR,ET,2020.0,1,0,1
PK,CO,2008.0,1,0,1
BA,AL,2015.0,2,0,2
AO,ES,2001.0,2,0,2
PA,AT,2015.0,1,0,1
CZ,CU,2019.0,1,0,1
CR,BE,2016.0,2,0,2
GR,NP,2022.0,1,0,1
TZ,SD,2019.0,1,0,1
NO,AU,1997.0,1,0,1
NG,TW,2021.0,1,0,1
NZ,HR,2013.0,2,0,2
CU,PL,2008.0,1,0,1
SD,LY,2013.0,1,0,1
BY,SE,2000.0,1,0,1
ZA,SA,2006.0,2,0,2
KE,ZW,2010.0,2,0,2
BI,UG,2015.0,1,0,1
MN,BE,2017.0,1,0,1
VN,TN,2019.0,1,0,1
PA,UY,2012.0,1,0,1
JP,DZ,2009.0,1,0,1
US,KZ,1999.0,1,0,1
JM,KR,2009.0,1,0,1
LR,TZ,2016.0,1,0,1
MK,,2001.0,5,0,5
NG,RW,2017.0,2,0,2
BD,FJ,2012.0,1,0,1
DE,AE,2000.0,1,0,1
CD,RU,2021.0,1,0,1
IL,IR,2008.0,1,0,1
CN,JM,2000.0,1,0,1
SE,MT,2019.0,1,0,1
PE,BW,2018.0,1,0,1
TN,MT,2017.0,1,0,1
SN,TG,2009.0,1,0,1
KZ,CH,2009.0,2,0,2
FI,SK,1997.0,1,0,1
GW,,2021.0,1,0,1
AZ,CH,2009.0,1,0,1
AM,TW,1997.0,1,0,1
MA,AL,2013.0,1,0,1
SO,MY,1998.0,1,0,1
VN,GR,2020.0,1,0,1
,TL,2013.0,3,0,3
AT,LI,2004.0,1,0,1
BG,BE,2023.0,1,0,1
CR,TW,2020.0,1,0,1
MX,ZW,2007.0,1,0,1
JM,IE,2015.0,1,0,1
SK,ZA,1999.0,1,0,1
SG,IQ,2013.0,1,0,1
DK,SR,2014.0,1,0,1
GB,GL,2019.0,1,0,1
CY,JP,2020.0,1,0,1
BH,PS,2018.0,1,0,1
ES,AM,2015.0,1,0,1
CN,AL,2020.0,1,0,1
KE,TZ,2002.0,1,0,1
PF,MQ,2013.0,1,0,1
NA,LS,2020.0,1,0,1
BA,CA,2010.0,1,0,1
JO,HU,2018.0,1,0,1
AR,TN,2014.0,1,0,1
IN,MM,2001.0,1,0,1
EC,IT,2006.0,1,0,1
MS,TT,2020.0,1,0,1
PE,GH,2014.0,1,0,1
IE,LI,2018.0,1,0,1
MW,IR,2020.0,1,0,1
TR,KE,2012.0,1,0,1
SI,ZA,2021.0,2,0,2
TM,RU,1999.0,1,0,1
VG,RU,2004.0,1,0,1
KW,CZ,2006.0,1,0,1
RS,OM,2015.0,1,0,1
BE,ZM,2004.0,1,0,1
XK,GB,2005.0,1,0,1
HN,DE,2015.0,1,0,1
MN,NL,2018.0,1,0,1
US,CW,2003.0,2,0,2
PH,SI,2022.0,1,0,1
GR,OM,2012.0,1,0,1
CI,KE,2011.0,1,0,1
ML,LR,2018.0,1,0,1
MX,ME,2015.0,1,0,1
KE,CL,2009.0,1,0,1
CZ,MA,2012.0,1,0,1
SD,TR,2010.0,1,0,1
DZ,LB,2012.0,2,0,2
PA,AU,2000.0,1,0,1
TJ,SE,2016.0,1,0,1
AE,BD,2021.0,1,0,1
CA,RE,2016.0,1,0,1
MA,CL,2006.0,1,0,1
CO,NA,2010.0,1,0,1
SS,AU,2011.0,1,0,1
,SM,2010.0,1,0,1
LA,CN,2009.0,1,0,1
CZ,AO,2013.0,1,0,1
ER,ET,2013.0,1,0,1
LB,JO,2009.0,1,0,1
GE,JP,2009.0,1,0,1
VG,CA,2015.0,1,0,1
OM,FI,2012.0,1,0,1
BE,TT,2015.0,1,0,1
LK,PT,2001.0,1,0,1
GA,CM,2014.0,1,0,1
EE,GR,2019.0,1,0,1
SG,MK,2020.0,1,0,1
KR,PA,2018.0,1,0,1
MA,AE,2007.0,1,0,1
CN,TJ,2012.0,1,0,1
CH,DO,2016.0,1,0,1
ZA,LU,2005.0,1,0,1
MW,DE,1998.0,1,0,1
PG,IN,2013.0,2,0,2
PT,BO,2010.0,1,0,1
BR,ID,1998.0,1,0,1
MZ,IN,2022.0,1,0,1
FK,US,2016.0,1,0,1
,GW,2006.0,1,0,1
JM,IT,2017.0,1,0,1
BF,FI,2016.0,1,0,1
LB,DZ,2013.0,1,0,1
TW,FI,1997.0,1,0,1
ZW,CO,2007.0,1,0,1
GY,NL,1997.0,1,0,1
BR,UA,2023.0,1,0,1
CH,KH,2008.0,1,0,1
PT,ME,2022.0,1,0,1
FI,FJ,2020.0,1,0,1
UY,HN,2017.0,1,0,1
RU,PF,2019.0,1,0,1
ZA,AE,2011.0,1,0,1
BG,IE,2006.0,1,0,1
RU,KH,2007.0,1,0,1
LU,GA,2019.0,1,0,1
PR,BR,2016.0,1,0,1
DZ,XK,2015.0,1,0,1
KW,MM,2020.0,1,0,1
,LI,1997.0,1,0,1
CM,GB,2003.0,1,0,1
AE,AM,2021.0,1,0,1
MY,ET,2005.0,1,0,1
nan,ME,2018.0,1,0,1
RO,KE,2008.0,1,0,1
PT,AO,2007.0,1,0,1
CU,GT,2008.0,1,0,1
AU,TL,2006.0,1,0,1
SS,CA,2022.0,1,0,1
BE,KZ,2012.0,1,0,1
TL,,2016.0,1,0,1
MA,BI,2003.0,1,0,1
BE,QA,2011.0,1,0,1
EC,IN,2002.0,1,0,1
TR,TN,2010.0,1,0,1
NE,CI,2016.0,1,0,1
MW,BD,2015.0,1,0,1
LK,FI,2016.0,1,0,1
TN,PS,2020.0,1,0,1
BD,DZ,2008.0,1,0,1
GY,NL,1998.0,1,0,1
ET,EC,2008.0,1,0,1
ZA,PH,1999.0,1,0,1
UZ,HR,2009.0,1,0,1
GP,GB,2005.0,1,0,1
MX,AF,2004.0,2,0,2
BT,PG,2008.0,1,0,1
NC,DE,2021.0,1,0,1
NA,DE,2002.0,1,0,1
CL,IS,2020.0,2,0,2
KR,MX,2000.0,1,0,1
MQ,DE,2013.0,1,0,1
BE,HT,2008.0,1,0,1
GB,PF,2015.0,1,0,1
PS,IQ,2013.0,1,0,1
BN,CA,2015.0,1,0,1
RS,KW,2015.0,1,0,1
OM,NG,2006.0,1,0,1
BY,CL,2005.0,1,0,1
JP,WS,2011.0,1,0,1
CZ,PE,2018.0,1,0,1
IT,BN,2001.0,1,0,1
EG,TT,2018.0,1,0,1
CL,SE,1998.0,1,0,1
BE,SK,1999.0,1,0,1
IE,TT,2013.0,1,0,1
AM,CZ,2015.0,1,0,1
NG,MX,2011.0,1,0,1
PL,CM,2021.0,1,0,1
GE,QA,2010.0,1,0,1
EG,NZ,2000.0,1,0,1
TN,TH,2015.0,1,0,1
TN,PK,2023.0,1,0,1
MC,PL,2021.0,1,0,1
CI,CH,2013.0,1,0,1
GL,CA,2017.0,1,0,1
TZ,CI,2011.0,1,0,1
LT,IE,2012.0,1,0,1
NO,UY,2011.0,1,0,1
KR,CH,2023.0,1,0,1
MW,CD,2018.0,1,0,1
NZ,PE,2021.0,1,0,1
BT,,2015.0,1,0,1
SN,CZ,2020.0,1,0,1
DZ,GR,2020.0,1,0,1
IR,KZ,2017.0,1,0,1
OM,MY,2007.0,1,0,1
DZ,IR,2013.0,1,0,1
SO,,2025.0,1,0,1
BY,MY,2017.0,1,0,1
AM,TW,1998.0,1,0,1
KZ,DK,2019.0,1,0,1
DE,GB,2000.0,402,339,63
UA,CN,2018.0,39,17,22
TW,CN,2017.0,1481,805,676
US,DE,1999.0,1401,1548,-147
AG,TR,2019.0,118,301,-183
CA,US,2005.0,2322,2494,-172
NZ,CA,2011.0,54,66,-12
GB,AE,2018.0,73,38,35
NZ,US,2004.0,245,261,-16
US,RO,2014.0,94,64,30
IE,US,2016.0,492,545,-53
AT,DE,2005.0,280,346,-66
MY,NG,2017.0,105,65,40
TW,CN,2019.0,1628,837,791
CA,US,2002.0,2052,1899,153
NO,US,2004.0,85,87,-2
GB,TR,2019.0,169,170,-1
SA,GB,2016.0,75,164,-89
IN,SA,2015.0,174,57,117
US,JP,2016.0,1751,1758,-7
AU,GB,1997.0,360,390,-30
AU,DE,2017.0,256,256,0
IN,TW,2004.0,32,19,13
AU,NO,2020.0,32,25,7
IT,CH,2017.0,413,274,139
SG,GB,2009.0,67,99,-32
ES,CA,2016.0,126,72,54
ES,PT,2019.0,208,187,21
NP,NZ,2007.0,9,8,1
US,IT,2012.0,914,1062,-148
NO,FR,2012.0,78,51,27
AU,GB,1998.0,441,497,-56
CO,ES,2019.0,646,601,45
IN,BE,2008.0,15,10,5
CZ,US,2021.0,113,135,-22
PH,US,2012.0,465,396,69
ZA,GB,2018.0,176,167,9
ES,CL,2008.0,208,191,17
CO,DK,2016.0,3,1,2
SE,US,2008.0,351,364,-13
JP,US,2015.0,1688,1658,30
MX,CL,2013.0,134,158,-24
CL,US,2017.0,251,317,-66
ES,AR,2008.0,225,229,-4
NL,FI,2000.0,12,15,-3
ES,MX,2008.0,435,487,-52
ZA,CA,2016.0,57,50,7
GR,GB,2016.0,302,185,117
AE,US,2017.0,82,79,3
NZ,GB,1999.0,101,110,-9
IR,IN,2015.0,27,53,-26
TR,AU,2020.0,22,22,0
RU,DE,2013.0,142,178,-36
CN,DE,2003.0,128,177,-49
JP,CR,2015.0,5,1,4
CO,ES,2010.0,272,292,-20
BE,CZ,2014.0,7,11,-4
US,CZ,2001.0,61,67,-6
CL,CO,2014.0,230,199,31
SE,FI,2002.0,48,48,0
CN,DK,2006.0,15,16,-1
GB,TW,2021.0,56,34,22
BR,CO,2007.0,49,29,20
IT,CH,2010.0,270,160,110
GB,PH,2020.0,13,20,-7
TR,CY,2014.0,50,43,7
BR,MY,2003.0,65,19,46
KR,ET,2004.0,65,82,-17
BE,DE,2018.0,163,139,24
FR,DK,2003.0,20,20,0
AE,US,2019.0,95,130,-35
GB,ZA,2018.0,167,176,-9
SG,US,2012.0,303,383,-80
CO,PE,2004.0,8,28,-20
EE,DE,2016.0,50,58,-8
GB,TR,2017.0,127,132,-5
CA,AU,2008.0,294,268,26
HU,IT,2021.0,11,8,3
BR,AE,2012.0,1,1,0
CL,EC,2007.0,5,6,-1
SE,nan,2004.0,40,42,-2
AT,FI,2022.0,11,1,10
US,NL,2007.0,545,552,-7
ES,BR,2006.0,173,195,-22
IT,MY,2015.0,55,46,9
RS,RU,2020.0,18,20,-2
RO,ES,2013.0,21,10,11
SE,CN,2022.0,107,61,46
nan,BR,2009.0,66,64,2
AU,CM,2018.0,1,1,0
GT,US,2008.0,5,3,2
IN,KR,2014.0,203,142,61
BR,AR,2011.0,113,133,-20
FR,AR,2005.0,27,27,0
GE,GB,2014.0,5,9,-4
VE,MX,2012.0,40,40,0
CA,BR,2020.0,259,304,-45
CA,JP,1998.0,83,78,5
JP,ES,1998.0,11,18,-7
GB,NL,2003.0,155,156,-1
CZ,MX,2022.0,3,5,-2
EC,CO,2016.0,60,113,-53
AU,NL,2000.0,29,19,10
NL,HU,2013.0,17,21,-4
SA,US,2016.0,161,232,-71
MD,FR,2000.0,61,28,33
CA,VE,2004.0,4,1,3
DE,CL,2018.0,64,84,-20
TH,JP,2011.0,55,90,-35
RU,US,2014.0,386,532,-146
FR,PT,2017.0,78,58,20
GB,KR,2009.0,68,78,-10
US,BR,1998.0,272,209,63
FR,NO,2014.0,77,55,22
ES,FR,2001.0,123,129,-6
JP,KR,2012.0,379,305,74
FR,BR,2018.0,285,224,61
AU,DE,2010.0,172,204,-32
GB,ES,2022.0,270,209,61
FR,JP,2015.0,142,134,8
IR,IQ,2021.0,24,18,6
NL,MX,2015.0,8,16,-8
CO,GB,2020.0,36,36,0
CU,CL,2015.0,29,11,18
MX,CH,2014.0,16,11,5
US,nan,2008.0,241,219,22
AT,DE,2002.0,234,260,-26
SK,ES,2002.0,3,2,1
BE,CN,2004.0,55,24,31
SG,JP,2004.0,11,31,-20
CW,DE,2017.0,1,1,0
ES,PT,2010.0,136,113,23
DE,TR,2002.0,24,17,7
DK,IT,2015.0,21,62,-41
IR,AU,2014.0,127,57,70
IT,AT,2013.0,53,40,13
IT,CH,2019.0,435,280,155
PT,GB,2012.0,79,91,-12
TW,IE,2001.0,2,1,1
FR,AT,2021.0,52,38,14
IL,IN,2021.0,67,82,-15
AU,RU,2012.0,14,27,-13
YE,PK,2016.0,1,1,0
IR,CA,2011.0,169,101,68
US,SZ,2012.0,1,2,-1
BR,IT,2008.0,131,167,-36
PT,NL,2006.0,9,15,-6
RU,FR,2013.0,69,83,-14
IL,GB,2019.0,79,63,16
TW,PH,2021.0,12,7,5
KE,NL,2016.0,7,10,-3
JP,NL,1998.0,19,27,-8
ES,CH,2016.0,138,85,53
EE,SE,1998.0,6,9,-3
CN,BD,2003.0,3,2,1
US,GR,2018.0,157,179,-22
NO,CN,2009.0,25,38,-13
CN,IE,2013.0,28,32,-4
CN,IN,2012.0,154,164,-10
NL,CH,1997.0,46,28,18
GR,US,2014.0,224,163,61
GR,DE,2016.0,80,56,24
IN,CN,2003.0,68,43,25
IN,DE,2011.0,164,141,23
SI,US,2018.0,24,20,4
ID,SD,2005.0,1,1,0
IQ,CN,2009.0,2,2,0
US,MY,2003.0,25,27,-2
VN,AU,2021.0,41,65,-24
IR,US,2004.0,38,55,-17
FR,RO,2013.0,50,39,11
MX,BR,2003.0,27,30,-3
UA,AT,2021.0,13,1,12
FR,DE,2022.0,247,260,-13
RU,GB,2022.0,83,69,14
IR,ID,2019.0,47,22,25
GB,MW,2011.0,11,15,-4
nan,IT,2003.0,93,47,46
GB,TR,2010.0,55,85,-30
MM,AU,2012.0,3,2,1
CH,IT,2013.0,184,311,-127
PL,IR,2006.0,9,2,7
SG,IR,2015.0,50,42,8
nan,CN,2018.0,137,101,36
BR,MX,2008.0,44,62,-18
CL,US,2010.0,154,198,-44
SE,ES,2007.0,41,33,8
RO,AT,2011.0,8,6,2
IL,RU,2010.0,29,25,4
AU,TH,2018.0,41,18,23
NL,CO,2020.0,19,22,-3
AU,CZ,2010.0,8,3,5
GB,CH,2021.0,295,265,30
TR,IR,2000.0,3,2,1
CA,KR,2012.0,62,48,14
IE,FR,2004.0,17,15,2
AU,DE,2019.0,258,264,-6
ID,MY,2013.0,67,111,-44
JP,MY,2020.0,51,46,5
PT,ES,2009.0,115,104,11
SK,CA,2006.0,4,3,1
EG,CN,2014.0,16,19,-3
US,UA,2015.0,64,73,-9
EG,US,1999.0,47,53,-6
IL,GB,2010.0,49,30,19
AZ,IT,2011.0,1,1,0
CN,UA,1998.0,4,8,-4
SA,IT,2017.0,6,20,-14
TN,FR,2016.0,166,258,-92
CA,EG,2015.0,95,66,29
US,SK,2018.0,47,37,10
BY,RU,2008.0,36,74,-38
nan,JP,2009.0,60,41,19
IT,NL,2004.0,62,45,17
FR,NE,2016.0,28,26,2
ZA,FR,2004.0,6,15,-9
BR,UY,2018.0,71,56,15
TW,PL,2012.0,6,4,2
NL,JP,2022.0,14,16,-2
HU,SE,2016.0,24,12,12
NO,PL,2014.0,8,10,-2
MY,NG,2019.0,167,77,90
AR,IT,2006.0,45,59,-14
MD,IT,2020.0,2,3,-1
US,CM,2018.0,21,11,10
CL,MX,2008.0,69,89,-20
NG,US,2021.0,143,82,61
BA,HR,2014.0,38,26,12
DE,IQ,2014.0,10,1,9
CH,AR,2018.0,22,20,2
CL,FR,2016.0,56,65,-9
DE,NP,2014.0,2,4,-2
FR,nan,2007.0,174,166,8
CH,GB,1997.0,83,70,13
NZ,NP,2018.0,58,62,-4
ID,QA,2016.0,1,1,0
FR,ID,2021.0,35,20,15
nan,MX,2015.0,28,32,-4
PL,AR,2016.0,1,4,-3
nan,RU,2016.0,76,43,33
KR,IN,2005.0,49,72,-23
MA,FR,2016.0,216,266,-50
CZ,SK,2007.0,48,55,-7
CI,ML,2022.0,5,1,4
JP,UA,2018.0,11,2,9
IE,BE,2009.0,7,8,-1
EC,BR,2019.0,58,90,-32
DE,NG,2016.0,8,4,4
AG,TR,2017.0,10,153,-143
CA,JP,1997.0,77,68,9
VN,KR,2008.0,15,12,3
EG,GB,2006.0,19,35,-16
ID,FR,2017.0,15,59,-44
ID,FR,2019.0,25,45,-20
CN,AT,2015.0,22,13,9
PL,NL,2014.0,26,24,2
BE,NO,2018.0,12,6,6
BE,BR,2018.0,88,109,-21
DK,KR,2012.0,3,5,-2
BE,LU,2015.0,32,15,17
CH,CA,2015.0,113,138,-25
US,SD,2004.0,4,3,1
US,MA,2006.0,14,7,7
ML,BF,2013.0,3,2,1
GB,IL,2015.0,58,74,-16
NL,PL,2014.0,24,26,-2
JP,TZ,2013.0,3,2,1
nan,PK,2017.0,12,12,0
SG,CN,2000.0,85,114,-29
IN,NO,2021.0,35,25,10
FI,ID,2016.0,2,4,-2
ZA,IT,2013.0,11,22,-11
EC,BR,2017.0,33,59,-26
HR,RU,2020.0,15,8,7
SG,CA,2000.0,11,12,-1
FR,UA,2018.0,14,12,2
FI,RU,2015.0,36,24,12
AT,CN,2014.0,16,20,-4
MN,US,2019.0,5,3,2
CA,NI,2014.0,2,2,0
US,FR,2023.0,29,52,-23
AM,IT,2020.0,14,32,-18
CU,CA,2021.0,5,1,4
NL,FR,2003.0,104,159,-55
SK,FI,2012.0,3,3,0
MA,CI,2015.0,2,2,0
GR,FR,2020.0,45,31,14
RU,TR,2009.0,8,3,5
ZA,ID,2017.0,41,44,-3
US,SG,2001.0,124,146,-22
SD,UA,2020.0,2,2,0
DK,FR,1999.0,18,20,-2
NL,ZA,2009.0,31,32,-1
AR,VE,2000.0,3,4,-1
TW,EG,2009.0,2,5,-3
ZA,ID,2019.0,92,164,-72
BD,CA,2016.0,41,37,4
NZ,TW,2018.0,7,4,3
MY,AE,2019.0,21,10,11
UY,CL,2019.0,23,19,4
UZ,AZ,2022.0,2,3,-1
RO,FI,2015.0,4,2,2
MY,KW,2018.0,7,4,3
CN,IR,2006.0,16,7,9
LK,CA,2016.0,5,4,1
KR,PL,2020.0,9,3,6
IL,ES,2004.0,6,5,1
AU,NZ,2012.0,127,225,-98
PT,JP,2018.0,5,3,2
CW,NL,2010.0,16,13,3
US,TH,2003.0,104,67,37
TR,KW,2014.0,8,5,3
nan,PK,2010.0,5,4,1
PK,nan,2017.0,12,12,0
AU,JP,2016.0,112,100,12
FI,US,2023.0,11,7,4
nan,CA,2006.0,24,19,5
ET,NO,2018.0,11,15,-4
CN,UZ,2020.0,18,11,7
TN,CH,2013.0,8,8,0
RW,US,2022.0,12,7,5
BE,KR,2013.0,8,9,-1
IL,RU,2019.0,63,47,16
ZM,US,2020.0,16,18,-2
RU,FI,2014.0,39,32,7
KR,TW,2022.0,27,32,-5
ES,AT,2018.0,34,34,0
CA,CN,2023.0,20,90,-70
RO,FR,2021.0,33,25,8
TT,US,2020.0,18,10,8
AU,IT,2011.0,37,70,-33
BA,SI,2018.0,5,5,0
US,CU,2020.0,30,77,-47
NG,CZ,2018.0,5,1,4
IN,SE,2021.0,53,46,7
ZA,CM,2021.0,14,6,8
TH,KR,2017.0,12,10,2
YE,EG,2018.0,7,8,-1
TR,BR,2015.0,33,14,19
BF,FR,2020.0,26,11,15
CA,SG,2018.0,65,58,7
SI,ID,2021.0,10,5,5
CN,SA,2012.0,22,10,12
DK,SE,2023.0,8,5,3
JP,VN,2020.0,73,46,27
TW,TH,2022.0,13,3,10
CO,BR,2011.0,100,74,26
PE,DE,2019.0,12,11,1
BR,TR,2010.0,10,30,-20
QA,BR,2018.0,2,1,1
GB,MM,2021.0,4,1,3
SI,FR,2011.0,7,10,-3
FI,CH,2001.0,11,6,5
AR,NO,2019.0,5,2,3
BY,US,2021.0,14,7,7
BY,UA,2021.0,13,15,-2
GB,KH,2021.0,8,12,-4
UY,CL,2010.0,1,11,-10
AR,MX,2008.0,69,66,3
GB,PT,1998.0,33,22,11
JP,EG,2003.0,33,20,13
CA,MX,2012.0,40,50,-10
SE,CA,2021.0,43,61,-18
IL,NL,2001.0,8,8,0
IE,PK,2013.0,12,2,10
CA,SA,2018.0,123,85,38
PT,FR,2011.0,38,59,-21
UY,AR,2015.0,40,35,5
RU,CH,2015.0,29,30,-1
CZ,IR,2021.0,6,10,-4
CH,PK,2018.0,17,12,5
BW,ZW,2016.0,2,3,-1
CA,RU,2008.0,17,29,-12
KR,SG,2004.0,9,10,-1
RS,CA,2006.0,9,8,1
BJ,CI,2014.0,2,3,-1
LK,US,1999.0,2,7,-5
MA,TN,2021.0,28,24,4
CA,NZ,2004.0,36,45,-9
EE,FI,2020.0,17,24,-7
IT,KR,2012.0,11,6,5
TW,CZ,2008.0,3,1,2
TW,KR,2007.0,23,29,-6
RS,GB,2017.0,25,28,-3
EG,YE,2017.0,11,6,5
UG,ET,2019.0,6,1,5
AU,CZ,2019.0,11,9,2
NL,MY,2016.0,12,15,-3
DE,IN,2004.0,90,123,-33
IT,HU,2013.0,11,8,3
GB,DE,2023.0,29,39,-10
NG,CI,2018.0,2,1,1
AT,NO,2016.0,12,13,-1
VN,JP,1998.0,3,1,2
DK,AT,2008.0,5,9,-4
RU,NO,2011.0,12,23,-11
LB,US,2011.0,52,57,-5
BE,IT,2000.0,43,37,6
JM,TT,2016.0,37,10,27
BE,GR,2003.0,9,5,4
IR,PK,2015.0,16,13,3
nan,TR,2011.0,11,9,2
CN,TW,2023.0,63,18,45
CI,US,1998.0,1,1,0
MY,QA,2021.0,9,5,4
LK,GB,2004.0,4,4,0
JO,DE,2008.0,7,13,-6
JP,nan,2008.0,36,59,-23
TW,JP,2005.0,45,50,-5
RU,JP,1999.0,31,34,-3
FR,PT,2010.0,59,33,26
US,HR,2004.0,22,25,-3
RS,GB,2019.0,17,17,0
CA,CO,1999.0,4,3,1
FR,MQ,2002.0,8,6,2
ZA,AU,2005.0,35,23,12
SD,TR,2018.0,3,3,0
IL,CA,1999.0,31,17,14
ES,GT,2009.0,4,4,0
DE,CZ,2006.0,44,52,-8
NZ,IN,2007.0,6,13,-7
PK,nan,2019.0,15,15,0
RO,US,2011.0,65,78,-13
NZ,IR,2018.0,6,22,-16
BO,DE,2022.0,1,1,0
ZA,UA,2020.0,2,1,1
DE,KZ,2019.0,10,6,4
HU,CH,2005.0,5,13,-8
GB,IR,2003.0,47,20,27
nan,IR,2018.0,8,4,4
NG,BJ,2009.0,3,1,2
ES,IN,2013.0,31,24,7
ES,IR,2012.0,10,10,0
ZA,BE,2006.0,22,2,20
JP,IR,1997.0,4,1,3
US,BR,1997.0,207,171,36
IR,KR,2018.0,16,10,6
TW,DE,2019.0,35,34,1
DE,MX,2006.0,32,26,6
FR,PF,2005.0,2,4,-2
IR,ID,2017.0,20,7,13
PL,SE,2015.0,29,17,12
VN,MX,2020.0,25,13,12
MY,JO,2015.0,15,7,8
nan,AT,2018.0,17,6,11
BE,EG,2015.0,7,2,5
AU,VN,2018.0,59,42,17
SK,RS,2015.0,8,6,2
MX,SI,2016.0,8,3,5
GB,FI,2015.0,66,71,-5
SE,FI,2005.0,64,37,27
ZM,GB,2016.0,8,8,0
FR,PL,2016.0,43,31,12
BR,NO,2017.0,25,30,-5
BR,TR,2017.0,20,24,-4
BR,ES,1997.0,40,57,-17
CA,VN,2022.0,17,9,8
JP,PL,2015.0,18,21,-3
OM,PK,2021.0,6,10,-4
JP,SE,2011.0,52,33,19
IT,MX,2008.0,28,29,-1
IT,CO,2011.0,12,8,4
BR,ES,1998.0,51,78,-27
VN,SE,2002.0,2,1,1
NO,IR,2013.0,4,10,-6
MY,AE,2017.0,22,5,17
TZ,ZA,2018.0,7,12,-5
CZ,NO,2015.0,22,5,17
SE,NL,2006.0,29,32,-3
ID,FR,2010.0,3,11,-8
CN,ZA,2011.0,16,17,-1
MZ,UA,2015.0,1,2,-1
SG,BD,2011.0,8,1,7
IR,FI,2015.0,16,8,8
ZA,EG,2021.0,8,3,5
CU,CR,2017.0,23,21,2
RS,BG,2017.0,6,4,2
TW,DE,2017.0,43,26,17
BR,NO,2010.0,12,27,-15
BE,MZ,2020.0,6,6,0
RS,GB,2010.0,13,17,-4
nan,PE,2018.0,10,16,-6
CN,EG,2020.0,47,46,1
SK,US,2020.0,33,29,4
NO,TZ,2008.0,7,2,5
CA,BD,2013.0,33,34,-1
AU,HU,2000.0,7,6,1
SA,QA,2007.0,3,3,0
SE,TW,2006.0,2,2,0
TN,CA,2020.0,15,12,3
UA,HR,2021.0,10,14,-4
BR,NO,2019.0,31,26,5
CL,AM,2019.0,1,1,0
OM,AU,2019.0,6,9,-3
BW,US,2006.0,5,4,1
HU,RS,2014.0,6,6,0
RU,NI,2018.0,4,1,3
CH,MX,2019.0,12,18,-6
DE,BG,2020.0,15,18,-3
JP,NL,1997.0,15,21,-6
AU,CH,2001.0,25,28,-3
VE,GB,2013.0,5,3,2
FR,HU,1999.0,21,18,3
SA,IT,2019.0,12,16,-4
CH,LU,2022.0,7,2,5
ET,GB,2009.0,8,4,4
ES,SI,2013.0,14,11,3
NL,IL,2007.0,13,13,0
CZ,CH,2006.0,20,21,-1
DE,HU,2020.0,48,72,-24
US,AE,2004.0,30,13,17
IT,DZ,2016.0,40,32,8
VN,BE,2021.0,7,13,-6
BD,SA,2009.0,6,5,1
DE,JO,2013.0,12,11,1
IT,QA,2020.0,6,4,2
JP,FI,2007.0,23,17,6
CW,NL,2017.0,20,11,9
EG,SE,2019.0,11,11,0
RU,PL,2000.0,22,11,11
IR,NZ,2012.0,9,2,7
JP,DE,2000.0,124,131,-7
PL,CN,2003.0,8,4,4
AR,NL,2016.0,12,6,6
US,KW,2003.0,16,8,8
RU,MZ,2004.0,4,2,2
AR,AU,2019.0,17,8,9
IN,NZ,2005.0,9,13,-4
FR,MG,2018.0,22,14,8
MX,UA,2003.0,2,6,-4
CZ,BY,2014.0,10,20,-10
FR,UY,2004.0,2,1,1
IR,NL,2008.0,10,13,-3
IT,SI,2006.0,7,10,-3
CN,GR,2007.0,14,14,0
BG,DE,2007.0,23,21,2
SA,TN,2014.0,14,40,-26
PL,CZ,2005.0,22,24,-2
CA,CZ,2008.0,8,11,-3
TH,IT,1998.0,2,2,0
HU,NL,2018.0,22,13,9
KE,BD,2012.0,2,1,1
VE,FR,2018.0,6,7,-1
IE,SA,2013.0,4,3,1
FR,AU,2005.0,63,73,-10
CZ,FR,2014.0,26,40,-14
ES,RU,2006.0,7,8,-1
MR,SN,2014.0,1,1,0
IN,IR,2013.0,41,34,7
KZ,US,2015.0,16,30,-14
SI,PL,2017.0,4,9,-5
PL,SK,2013.0,3,7,-4
HR,FR,2015.0,4,7,-3
KE,US,2003.0,30,22,8
GH,GB,1999.0,3,4,-1
IL,FR,2006.0,27,27,0
DK,RO,2020.0,3,3,0
IT,IL,2002.0,6,7,-1
AT,IE,2012.0,9,5,4
CW,NL,2019.0,18,1,17
CH,MX,2017.0,15,16,-1
DE,NO,2012.0,79,54,25
AR,FR,2001.0,26,15,11
NL,LU,2015.0,11,4,7
IN,VN,2021.0,5,8,-3
HU,AU,1997.0,5,4,1
DE,HR,2001.0,16,14,2
IT,IL,2005.0,6,9,-3
IR,KZ,2018.0,6,2,4
AU,AT,2007.0,11,18,-7
IQ,IL,2022.0,2,1,1
UY,AU,2020.0,1,1,0
PY,UY,2021.0,5,1,4
PL,CA,2004.0,11,11,0
PT,VE,2004.0,2,1,1
BG,IT,2019.0,8,10,-2
KW,GB,2015.0,9,19,-10
ES,nan,2011.0,31,19,12
HK,NL,2018.0,17,14,3
CR,DE,2016.0,7,7,0
CA,DZ,2011.0,8,7,1
SG,KR,2001.0,12,9,3
PT,ZA,2016.0,1,3,-2
FI,CZ,2012.0,10,7,3
BG,AU,2016.0,1,4,-3
UY,BR,2014.0,50,38,12
SE,GB,1999.0,68,65,3
MY,JP,2022.0,31,21,10
IL,RU,2017.0,31,31,0
nan,ES,2005.0,22,18,4
IL,GB,2017.0,75,74,1
TW,AT,2014.0,2,3,-1
nan,ES,2002.0,10,5,5
ES,SK,2013.0,3,4,-1
SE,KR,2002.0,5,2,3
SG,nan,2011.0,12,5,7
GB,ET,2019.0,14,11,3
BH,AU,2015.0,1,1,0
BD,GB,2008.0,33,30,3
UG,DE,2020.0,5,6,-1
CU,CR,2019.0,50,36,14
HU,BE,2004.0,8,9,-1
BS,US,2010.0,3,4,-1
AG,CO,2018.0,5,1,4
DE,IR,2004.0,10,7,3
CR,CO,2022.0,23,12,11
AZ,TR,2013.0,4,9,-5
LU,AU,2013.0,1,3,-2
AU,PH,2014.0,18,17,1
US,HK,2015.0,9,12,-3
MX,VE,2001.0,11,21,-10
BA,PL,2004.0,1,2,-1
AU,CL,2013.0,13,20,-7
KR,PA,2017.0,3,1,2
IR,AE,2022.0,3,1,2
TW,TR,2001.0,4,6,-2
GF,GP,2014.0,2,1,1
CH,MX,2010.0,6,10,-4
SK,UA,2019.0,4,8,-4
AT,PK,2015.0,12,5,7
ZA,NA,2016.0,12,4,8
MQ,FR,2009.0,13,13,0
DK,TR,2018.0,8,16,-8
CL,JP,2013.0,4,4,0
CA,BE,2003.0,27,36,-9
RS,FR,2014.0,5,6,-1
NZ,RO,2019.0,1,2,-1
GR,RS,2018.0,2,1,1
EG,IN,2001.0,2,2,0
KR,IN,2002.0,21,58,-37
IN,GR,2009.0,6,7,-1
DZ,NE,2020.0,1,1,0
NP,GB,2004.0,6,2,4
DK,MX,2014.0,5,6,-1
PL,MZ,2010.0,8,6,2
DK,IE,2009.0,5,7,-2
TW,DE,2010.0,23,16,7
CH,HU,2018.0,12,19,-7
PK,NZ,2020.0,12,16,-4
AT,EG,2013.0,3,2,1
KR,PK,2012.0,15,22,-7
EC,UA,1999.0,4,7,-3
AE,nan,2014.0,1,2,-1
LU,GR,2018.0,2,5,-3
DE,KZ,2017.0,5,7,-2
ZA,SE,2015.0,21,16,5
FR,HT,2021.0,1,3,-2
CN,ZM,2015.0,3,1,2
UA,FR,2001.0,7,9,-2
BR,CG,2010.0,2,1,1
IQ,LB,2019.0,9,8,1
UA,DE,2000.0,27,15,12
KR,ZA,2020.0,4,6,-2
CH,TW,2021.0,8,7,1
IN,NP,2023.0,4,1,3
ID,SE,2019.0,4,15,-11
NL,HK,2020.0,9,20,-11
US,NG,2003.0,18,19,-1
LV,RU,2013.0,24,32,-8
MD,MA,2013.0,9,4,5
SE,BR,2000.0,7,13,-6
TR,IN,2014.0,16,22,-6
GR,ES,2016.0,21,18,3
AR,AU,2017.0,15,6,9
BE,AU,1998.0,14,11,3
AT,DK,2007.0,6,3,3
GB,CY,2003.0,7,1,6
LU,FR,2009.0,14,28,-14
CA,HU,2006.0,7,18,-11
TW,JP,2002.0,29,51,-22
US,ET,2011.0,28,25,3
LT,JP,2004.0,5,12,-7
DE,LI,2022.0,4,1,3
GB,AR,2005.0,17,18,-1
IT,CR,2015.0,4,4,0
GB,TZ,2009.0,11,2,9
CM,ZA,2011.0,7,4,3
AR,AU,2010.0,9,5,4
TN,US,2011.0,19,10,9
IT,VE,2006.0,5,4,1
NL,IN,1999.0,11,16,-5
SG,ID,2020.0,16,19,-3
TH,TW,2012.0,3,6,-3
IS,US,2003.0,6,13,-7
NZ,AE,2014.0,2,8,-6
FI,BE,2001.0,4,3,1
MN,HU,2019.0,1,1,0
ZA,CN,2012.0,11,11,0
PY,US,2015.0,5,8,-3
RU,IT,2006.0,12,27,-15
BR,AU,2007.0,41,38,3
AR,SE,2000.0,3,3,0
EE,nan,2011.0,6,1,5
VU,CH,2016.0,1,1,0
CL,FI,2011.0,2,3,-1
AU,PK,2008.0,10,10,0
AT,SK,2003.0,4,12,-8
AE,US,2010.0,37,51,-14
DE,TR,2005.0,32,24,8
IT,SA,2011.0,9,3,6
HU,CH,2002.0,8,6,2
CL,BE,2011.0,7,10,-3
AE,QA,2018.0,12,12,0
NL,IE,2008.0,18,15,3
MT,ES,2014.0,5,1,4
FR,CO,2008.0,22,13,9
MY,EG,2007.0,8,6,2
IN,BR,2001.0,8,6,2
RS,UZ,2005.0,1,4,-3
CH,nan,1998.0,4,8,-4
ID,DE,2015.0,16,40,-24
NL,GA,2017.0,7,7,0
QA,JO,2018.0,8,10,-2
FR,BF,2008.0,17,8,9
SG,CZ,2018.0,9,1,8
UA,JP,2014.0,6,4,2
AT,LI,2014.0,2,2,0
PE,DE,2017.0,9,11,-2
DE,KZ,2010.0,1,1,0
ES,MZ,2016.0,1,3,-2
nan,EG,2015.0,3,5,-2
RU,UZ,2009.0,13,13,0
SE,LT,2014.0,3,1,2
SK,IE,2018.0,2,1,1
IR,LB,2011.0,2,1,1
FR,AM,2011.0,2,3,-1
KE,CA,2018.0,7,10,-3
MA,BD,2016.0,4,22,-18
BR,SD,2008.0,7,5,2
DE,LK,2018.0,5,2,3
CO,EC,2007.0,4,5,-1
CU,FR,2019.0,5,1,4
GA,DE,2005.0,4,4,0
IE,BD,2004.0,1,2,-1
IT,UY,2007.0,4,2,2
RS,AU,2018.0,10,8,2
PA,IN,2015.0,2,4,-2
CU,VE,2004.0,11,4,7
PE,DE,2010.0,6,4,2
PK,DZ,2015.0,2,1,1
US,VG,2020.0,5,7,-2
BO,CL,2006.0,1,1,0
NZ,nan,2009.0,7,86,-79
VE,PE,2012.0,17,4,13
BE,AU,1997.0,5,7,-2
CU,FR,2017.0,7,7,0
FI,FR,1997.0,9,10,-1
IN,NZ,2002.0,9,5,4
NL,PK,2007.0,2,3,-1
NC,FR,2007.0,6,12,-6
PH,CO,2020.0,7,14,-7
GF,FR,2004.0,9,4,5
US,IQ,2022.0,29,36,-7
KG,RU,2022.0,7,6,1
NI,BR,2015.0,3,3,0
GB,MK,2014.0,7,3,4
MK,GB,2016.0,7,1,6
BG,IT,2017.0,6,7,-1
SE,BE,1999.0,9,8,1
BW,IN,2001.0,1,1,0
MX,HN,2001.0,6,6,0
MX,TW,2017.0,2,1,1
HU,AU,1998.0,2,6,-4
SA,AE,2011.0,6,10,-4
JO,SY,2020.0,5,4,1
MT,DE,2011.0,2,1,1
BE,LB,2021.0,4,11,-7
CR,ES,2005.0,15,10,5
GB,GE,1999.0,2,2,0
IT,CZ,1999.0,12,12,0
ET,HU,2020.0,2,1,1
ID,PH,2020.0,8,6,2
PH,IT,2013.0,4,9,-5
BY,PL,2017.0,3,4,-1
MY,BR,2003.0,19,65,-46
CA,JM,2004.0,2,1,1
ES,HU,2013.0,8,9,-1
GR,QA,2014.0,6,1,5
SG,MX,2016.0,4,6,-2
BE,IN,1997.0,1,3,-2
CH,MY,2018.0,4,5,-1
UY,IT,2015.0,10,7,3
GB,SI,2013.0,7,18,-11
ES,LT,2019.0,3,2,1
AT,TW,2003.0,3,1,2
ES,KR,2011.0,8,4,4
BE,HR,2022.0,2,1,1
EG,YE,2019.0,16,6,10
LB,NL,2018.0,2,3,-1
BR,BO,2020.0,10,4,6
IR,BD,2015.0,6,7,-1
CN,TR,2022.0,9,13,-4
CI,SN,2009.0,2,1,1
IT,EG,2003.0,3,3,0
BO,ES,2013.0,8,15,-7
TR,AT,2001.0,2,5,-3
ID,MA,2019.0,6,6,0
MM,US,2016.0,7,7,0
CY,US,2007.0,8,20,-12
SI,PL,2010.0,4,1,3
RU,EG,2011.0,3,5,-2
MY,IR,2006.0,2,2,0
JO,KW,2020.0,5,5,0
TZ,GB,2018.0,11,11,0
UY,CL,2017.0,10,13,-3
MG,CN,2020.0,4,3,1
NZ,CZ,2013.0,2,2,0
DZ,BR,2013.0,2,1,1
SS,GB,2021.0,5,4,1
NP,KR,2018.0,11,16,-5
VG,RU,2014.0,2,3,-1
IQ,BA,2020.0,5,11,-6
AU,BD,2008.0,14,10,4
MM,MY,2021.0,7,2,5
SK,UA,2017.0,5,3,2
LT,RU,2020.0,14,7,7
CN,TN,2006.0,1,1,0
DK,ZA,2013.0,9,7,2
LV,CZ,2020.0,2,2,0
DE,ZA,2004.0,21,20,1
BY,GB,2004.0,4,1,3
ZA,RO,2022.0,3,6,-3
PS,CA,2007.0,2,1,1
AU,BG,2002.0,1,1,0
PL,CZ,2002.0,11,11,0
AE,NL,2010.0,9,4,5
NL,NZ,2004.0,11,6,5
BE,BO,2008.0,2,1,1
SE,AR,2020.0,7,9,-2
GB,AR,2002.0,9,24,-15
NZ,DK,2015.0,5,7,-2
UY,CA,2016.0,4,8,-4
NL,GA,2019.0,4,8,-4
PL,RU,2013.0,25,35,-10
HN,BR,2019.0,5,2,3
TN,DE,2016.0,8,6,2
CO,UY,2022.0,7,3,4
CM,FR,2021.0,9,12,-3
IT,AM,2001.0,6,4,2
KR,IQ,2019.0,2,1,1
DE,CO,2006.0,8,10,-2
AE,NL,2019.0,4,9,-5
EG,BH,2014.0,4,3,1
KW,LB,2015.0,1,1,0
SE,IN,2022.0,27,47,-20
CD,ZM,2020.0,2,2,0
GN,SN,2015.0,3,2,1
CN,UA,1997.0,9,5,4
SK,RO,2011.0,5,5,0
IR,PT,2011.0,7,1,6
BY,PL,2019.0,4,6,-2
nan,CH,2009.0,13,13,0
TH,BE,2010.0,3,2,1
PE,BE,2009.0,1,2,-1
NG,UG,1999.0,1,2,-1
TR,KR,2016.0,6,7,-1
PH,BR,2011.0,2,3,-1
IL,PL,2014.0,5,6,-1
NO,PT,2016.0,3,9,-6
GB,IS,2007.0,9,4,5
DE,GR,2003.0,28,22,6
CN,RS,2018.0,6,5,1
HR,JP,2002.0,2,1,1
AR,NO,2017.0,4,2,2
MX,NZ,2018.0,5,3,2
OM,AU,2017.0,4,6,-2
UZ,BE,2005.0,1,1,0
SA,NG,2009.0,3,1,2
NL,PH,2013.0,5,4,1
FI,FR,1998.0,2,9,-7
UZ,PK,2016.0,1,2,-1
PL,EG,2007.0,3,4,-1
NL,CZ,2018.0,14,7,7
CA,JO,2021.0,10,11,-1
TH,CA,2003.0,5,11,-6
IN,IE,2011.0,19,18,1
GA,US,2011.0,2,1,1
KR,SD,2018.0,11,5,6
UY,GB,2000.0,1,2,-1
KZ,RU,2003.0,6,4,2
DE,CW,2012.0,4,2,2
XK,ME,2013.0,2,1,1
CZ,PE,2019.0,2,2,0
MX,CZ,2012.0,6,2,4
KR,DK,2008.0,4,3,1
BF,US,2009.0,3,2,1
KR,AM,2004.0,11,10,1
AM,JP,2012.0,6,2,4
BR,TR,2019.0,14,13,1
KE,ZA,1998.0,5,1,4
ZA,DZ,2018.0,1,2,-1
US,BD,2004.0,20,20,0
BB,US,2011.0,2,3,-1
CZ,AR,2012.0,2,1,1
NL,EE,2015.0,5,6,-1
IE,GE,2019.0,1,1,0
ML,CH,2015.0,3,1,2
GB,PG,1997.0,2,2,0
PG,US,1999.0,2,1,1
US,PG,2021.0,3,1,2
GB,PT,1997.0,17,15,2
EC,BR,2010.0,4,5,-1
TR,NL,2003.0,11,9,2
MX,PH,2008.0,4,2,2
DE,SA,1997.0,1,1,0
BO,MX,2013.0,6,7,-1
US,PA,2003.0,10,13,-3
MA,LB,2017.0,3,3,0
ES,MT,2018.0,3,15,-12
KR,SI,2020.0,1,1,0
CU,BR,1999.0,9,2,7
NL,VN,2008.0,3,4,-1
IR,TN,2013.0,7,4,3
AR,PY,2021.0,8,5,3
ES,UY,2006.0,19,23,-4
GE,PL,2011.0,1,3,-2
KW,MY,2013.0,3,2,1
ZW,CN,2017.0,3,1,2
BD,ID,2013.0,5,7,-2
GF,MQ,2018.0,1,2,-1
SA,AU,2005.0,3,1,2
HR,CH,2016.0,6,4,2
IN,LK,2005.0,1,1,0
SK,BG,2003.0,1,2,-1
AR,CA,2001.0,5,7,-2
CR,ES,2002.0,13,13,0
DK,EG,2021.0,4,5,-1
US,RE,2011.0,1,4,-3
KR,CH,2000.0,5,3,2
QA,BD,2021.0,5,3,2
GR,CH,2006.0,14,13,1
VN,IN,2019.0,4,7,-3
PA,CA,2020.0,4,2,2
FR,PE,2014.0,11,6,5
NL,ZW,2015.0,1,1,0
CH,BD,2020.0,6,5,1
TR,PL,2023.0,4,1,3
BE,BF,2011.0,3,3,0
FR,EG,2000.0,6,3,3
UZ,RU,2006.0,7,16,-9
SE,GH,2020.0,2,2,0
AT,nan,2003.0,8,8,0
JP,IR,1998.0,2,9,-7
FR,PF,2002.0,7,3,4
HK,US,2004.0,5,3,2
JP,ES,1997.0,9,9,0
TW,AR,2006.0,9,5,4
AO,US,2021.0,4,2,2
PS,MY,2017.0,1,6,-5
SG,TW,1999.0,8,11,-3
UY,CO,2014.0,5,6,-1
IE,MX,2007.0,2,5,-3
PH,MX,2022.0,2,6,-4
CI,FR,2006.0,12,15,-3
PE,nan,2020.0,9,12,-3
BH,KW,2018.0,4,1,3
IR,RU,2014.0,9,11,-2
MX,NL,1999.0,1,5,-4
IN,RS,2021.0,3,2,1
SE,HR,2006.0,3,1,2
IR,MX,2020.0,7,1,6
PT,AT,2020.0,10,7,3
GB,BH,2013.0,7,2,5
IN,ML,1998.0,5,2,3
GB,MU,2019.0,3,1,2
GB,CL,1997.0,5,4,1
US,CR,2006.0,18,22,-4
FR,VE,2009.0,11,8,3
RW,IN,2011.0,6,7,-1
DE,LT,2013.0,10,7,3
QA,GB,2008.0,3,6,-3
OM,GH,2022.0,7,5,2
GR,AL,2016.0,2,1,1
IR,EE,2012.0,1,1,0
MY,RU,2004.0,2,4,-2
CO,NO,2022.0,4,1,3
PT,EG,2014.0,3,2,1
VE,BR,2022.0,10,6,4
IQ,LB,2017.0,3,5,-2
ID,KE,2004.0,1,1,0
VN,UA,2015.0,3,4,-1
KE,ZA,1997.0,2,1,1
SK,FR,1998.0,4,3,1
CH,TR,2005.0,2,7,-5
FR,CF,2010.0,3,3,0
GT,MX,2011.0,2,13,-11
YE,MY,2012.0,3,8,-5
MX,AT,2007.0,1,3,-2
RW,CD,2021.0,2,1,1
NL,SK,2022.0,5,4,1
GR,BE,2006.0,7,10,-3
HR,BG,2022.0,1,1,0
NP,NO,2020.0,2,6,-4
SE,KR,2005.0,5,2,3
SE,TR,2007.0,5,1,4
JP,KH,2007.0,5,4,1
FR,IR,2001.0,4,3,1
CO,CR,2022.0,12,23,-11
CO,KR,2015.0,6,3,3
IE,SG,2022.0,3,4,-1
RU,VG,2014.0,3,2,1
VN,EG,2007.0,1,1,0
US,UY,2001.0,5,4,1
AU,SA,2007.0,6,6,0
EG,YE,2010.0,3,1,2
NZ,IE,2003.0,5,5,0
KH,BE,2016.0,1,2,-1
AU,FJ,2006.0,1,2,-1
GB,OM,2009.0,8,8,0
AT,KZ,2019.0,1,1,0
PK,NL,2007.0,3,2,1
NP,NL,2020.0,3,2,1
VN,DE,2001.0,1,6,-5
MW,ZA,2011.0,1,6,-5
JP,NO,1998.0,6,8,-2
NG,TZ,2012.0,1,1,0
NO,IT,2003.0,16,11,5
CH,RO,2011.0,5,7,-2
UA,TW,2015.0,2,2,0
GP,MA,2017.0,1,1,0
GB,CL,1998.0,5,4,1
GB,PG,1998.0,2,1,1
CH,TR,2002.0,5,3,2
PT,CU,2020.0,2,8,-6
UG,AU,2015.0,3,2,1
BE,TN,2007.0,1,1,0
CU,PA,2015.0,1,1,0
BY,EC,2016.0,2,2,0
TW,RU,2008.0,14,15,-1
HU,CZ,2001.0,4,2,2
SG,DE,2001.0,11,10,1
HR,NL,2012.0,1,4,-3
AU,NP,2014.0,4,9,-5
HR,MX,2009.0,3,1,2
SY,GB,2013.0,5,10,-5
AU,SI,2014.0,4,7,-3
NO,CL,2021.0,2,4,-2
TN,IN,2006.0,3,1,2
OM,TN,2015.0,3,1,2
TW,NZ,2005.0,3,1,2
IQ,PK,2016.0,2,3,-1
PL,RO,2015.0,5,9,-4
DE,UY,1997.0,3,1,2
BE,IN,1998.0,2,5,-3
MT,GB,2007.0,4,7,-3
KZ,IN,2013.0,1,2,-1
NG,QA,2021.0,4,2,2
NZ,MX,2016.0,2,6,-4
MW,FR,2016.0,2,3,-1
SI,PL,2019.0,5,4,1
MN,US,2010.0,2,2,0
BJ,BE,2019.0,3,3,0
SA,DZ,2013.0,5,5,0
CO,DO,2015.0,2,8,-6
NL,GA,2010.0,3,3,0
US,PS,2000.0,7,2,5
ID,SG,2006.0,1,1,0
ER,PK,2009.0,1,1,0
IN,LK,2002.0,2,1,1
GH,CI,2014.0,1,1,0
PA,IL,2017.0,1,1,0
NZ,QA,2022.0,1,1,0
NG,BH,2018.0,5,3,2
MA,EG,2012.0,3,6,-3
PL,LU,2020.0,5,4,1
FR,MQ,2005.0,4,7,-3
PS,MY,2010.0,1,1,0
VG,GB,2009.0,6,5,1
AU,NG,2000.0,1,2,-1
CN,SK,2009.0,6,4,2
CH,MA,2020.0,3,2,1
DZ,GB,2017.0,7,8,-1
NE,IT,2021.0,1,2,-1
GB,NP,2014.0,8,6,2
PS,MY,2019.0,6,9,-3
HN,BR,2017.0,1,3,-2
ET,QA,2019.0,1,1,0
RS,RO,2012.0,2,2,0
ID,SE,2017.0,3,18,-15
AT,ES,1997.0,6,5,1
KH,AU,2022.0,1,2,-1
AR,JP,2022.0,4,4,0
PT,IL,2015.0,3,1,2
BR,IR,2009.0,7,3,4
PL,UZ,2011.0,1,2,-1
GR,nan,2016.0,2,2,0
MK,CZ,2021.0,3,1,2
LY,EG,2013.0,5,2,3
MA,CH,2005.0,2,1,1
NI,MY,2020.0,3,1,2
CZ,IT,2023.0,1,4,-3
BR,IL,2004.0,6,2,4
TH,SA,2016.0,2,2,0
EG,SE,2017.0,8,17,-9
CY,IT,2014.0,3,4,-1
FR,SY,2008.0,7,7,0
PL,LV,2011.0,2,2,0
IL,SE,2011.0,5,1,4
RS,PT,2014.0,2,4,-2
IE,PT,2016.0,4,6,-2
UA,IL,2004.0,3,3,0
VE,DE,2020.0,5,1,4
LB,GB,2001.0,2,6,-4
AU,KZ,2020.0,3,2,1
UZ,UA,2009.0,2,4,-2
MZ,LT,2004.0,1,3,-2
CZ,IL,2018.0,2,5,-3
BO,PE,2013.0,2,3,-1
CM,MA,2018.0,2,3,-1
CZ,NG,2008.0,1,1,0
GE,AU,1998.0,1,1,0
CW,DE,2010.0,1,3,-2
SD,IN,2022.0,1,1,0
CL,CZ,2009.0,1,1,0
NZ,SK,2010.0,1,1,0
PE,VE,2012.0,4,17,-13
PT,IE,2012.0,3,2,1
NI,MX,2004.0,1,1,0
PK,NO,2019.0,6,8,-2
DZ,GB,2010.0,3,6,-3
CL,nan,2003.0,3,3,0
PK,CA,2001.0,4,1,3
UA,NL,2018.0,3,4,-1
NZ,TR,2013.0,1,4,-3
AT,RS,2009.0,4,2,2
TN,JP,2014.0,2,4,-2
TW,DK,2003.0,2,2,0
EG,SE,2010.0,3,2,1
MX,GR,2020.0,2,2,0
SN,GB,2014.0,4,1,3
ES,BO,1998.0,1,1,0
RU,TJ,2002.0,1,3,-2
BS,US,2017.0,6,4,2
CH,NP,2020.0,2,1,1
ET,SE,2015.0,5,13,-8
CL,NZ,2015.0,7,8,-1
IE,UG,2017.0,1,1,0
PE,CN,2020.0,2,4,-2
IS,IN,2015.0,2,1,1
HK,TW,2014.0,4,2,2
BJ,SN,2017.0,2,4,-2
JP,NO,1997.0,4,4,0
PK,TZ,2016.0,1,1,0
AU,MX,2004.0,4,6,-2
BG,CH,2021.0,4,2,2
JP,CO,2001.0,5,3,2
CD,BE,2022.0,5,7,-2
TW,ZA,2021.0,2,1,1
ID,NZ,2015.0,4,3,1
PH,BH,2020.0,1,1,0
GH,EG,2015.0,6,5,1
RU,AR,2016.0,3,2,1
TR,ID,2011.0,3,5,-2
nan,SG,2005.0,5,9,-4
TW,KZ,2006.0,1,1,0
AO,IT,2010.0,2,1,1
MX,EE,2015.0,1,1,0
ML,MA,2014.0,2,2,0
PF,FR,2005.0,4,2,2
CA,MD,2012.0,2,1,1
NP,CH,2020.0,1,2,-1
GH,NG,2011.0,3,2,1
DZ,CN,2022.0,2,4,-2
SG,NO,2017.0,4,1,3
PH,PL,2007.0,1,2,-1
UY,CH,2020.0,2,1,1
US,LU,1999.0,2,2,0
UA,VN,2021.0,1,6,-5
FI,KR,2018.0,2,3,-1
PA,PE,2020.0,3,4,-1
CL,SK,2021.0,1,1,0
CL,DK,2020.0,5,5,0
PK,ZA,2014.0,6,3,3
SA,PL,2019.0,1,5,-4
SA,AU,2002.0,3,5,-2
JP,MM,2002.0,2,2,0
TH,CN,1998.0,2,1,1
GB,HK,2004.0,2,3,-1
CH,nan,1997.0,5,2,3
PK,BR,2011.0,5,3,2
SE,CZ,1999.0,3,2,1
PK,nan,2010.0,4,5,-1
AT,ES,1998.0,7,2,5
CA,KE,2005.0,2,4,-2
JP,QA,2007.0,2,3,-1
BG,CZ,2015.0,5,4,1
IL,GR,2015.0,1,2,-1
MD,RU,2003.0,2,1,1
BH,IN,2006.0,2,1,1
AT,BR,2004.0,3,3,0
BR,EG,2015.0,3,3,0
GB,PE,2003.0,2,5,-3
SY,SA,2014.0,3,1,2
GL,DK,2012.0,2,6,-4
FJ,IN,2008.0,1,2,-1
IT,GH,2002.0,3,1,2
AR,NO,2010.0,2,1,1
KW,TR,2008.0,5,1,4
CD,ZW,2021.0,1,1,0
QA,SY,2018.0,1,1,0
TW,BR,2013.0,1,2,-1
SA,SE,2007.0,2,2,0
PK,NO,2010.0,1,2,-1
PT,PY,2015.0,2,1,1
TW,NZ,2002.0,2,3,-1
EE,IR,2022.0,1,7,-6
ET,MW,2018.0,2,3,-1
MY,IL,2012.0,1,3,-2
MX,PT,1998.0,4,2,2
NO,KR,2012.0,2,5,-3
IR,FR,2004.0,7,14,-7
ID,PS,2020.0,1,2,-1
PA,TW,2013.0,2,1,1
AR,SI,2021.0,1,1,0
PL,AZ,2000.0,2,3,-1
MD,CA,2011.0,3,1,2
RU,MD,2009.0,5,3,2
KR,NO,1997.0,1,1,0
CZ,BG,2016.0,1,1,0
TH,ES,2012.0,1,1,0
IT,RS,2020.0,5,12,-7
BE,UA,2022.0,2,1,1
IR,IT,1999.0,3,2,1
PS,FR,2008.0,2,1,1
LT,DK,2018.0,4,4,0
IN,TN,2014.0,3,7,-4
GR,DK,2001.0,2,3,-1
BE,UG,2011.0,4,5,-1
IL,DK,2009.0,5,2,3
SZ,ZA,2008.0,1,3,-2
SA,DE,2004.0,2,7,-5
FJ,GB,1997.0,1,2,-1
BJ,BE,2010.0,2,5,-3
IR,nan,2018.0,4,8,-4
DK,GW,2004.0,1,4,-3
TH,BE,2019.0,2,8,-6
TH,BE,2017.0,3,5,-2
VN,IT,2015.0,2,2,0
CA,IQ,2015.0,2,4,-2
EC,RU,2003.0,1,1,0
SE,SD,2008.0,1,1,0
GB,MU,2017.0,3,3,0
NG,DK,2015.0,1,1,0
NG,RW,2018.0,1,1,0
ID,MA,2017.0,3,4,-1
CH,MD,2018.0,2,6,-4
PF,FR,2002.0,3,7,-4
GE,NL,2016.0,1,1,0
IR,DZ,2016.0,4,3,1
NO,NZ,1999.0,1,1,0
NI,ES,2014.0,4,8,-4
FI,RS,2017.0,1,1,0
PA,DE,2014.0,3,6,-3
NL,AE,2007.0,1,1,0
BE,GE,2020.0,3,1,2
HR,JP,2005.0,3,1,2
YE,AE,2019.0,1,2,-1
KZ,DE,2005.0,3,3,0
LT,ES,2015.0,2,2,0
FI,RS,2010.0,1,1,0
ZW,CG,2016.0,1,3,-2
BH,NG,2007.0,3,1,2
AU,MY,2000.0,3,4,-1
PT,ID,2013.0,1,1,0
CO,ZA,2007.0,2,1,1
FI,IE,2009.0,1,4,-3
BO,IT,2019.0,1,2,-1
CF,FR,2005.0,2,2,0
MW,KE,2014.0,1,2,-1
CZ,TN,2020.0,3,3,0
EE,SE,1997.0,2,3,-1
MA,MY,2013.0,3,3,0
CH,UA,2009.0,2,2,0
CH,TZ,2018.0,3,9,-6
ID,BE,2008.0,2,4,-2
MX,PT,1997.0,1,1,0
ZA,ES,1999.0,2,2,0
GB,LK,2004.0,4,4,0
SD,DE,2011.0,1,2,-1
FJ,GB,1998.0,1,2,-1
MX,DE,1999.0,5,15,-10
KE,ZW,2018.0,1,2,-1
VN,IN,2017.0,1,6,-5
LU,AT,2018.0,1,3,-2
BR,EE,2019.0,3,1,2
ES,TR,1998.0,1,3,-2
PA,SE,2004.0,2,1,1
PT,NZ,2006.0,2,1,1
IN,AR,2005.0,3,1,2
PK,YE,2020.0,1,5,-4
HU,EG,2006.0,2,1,1
FR,SI,2016.0,7,8,-1
RO,HR,2014.0,1,4,-3
HN,GT,2014.0,1,1,0
NI,CL,2007.0,1,2,-1
BY,PL,2010.0,2,5,-3
CW,DE,2019.0,1,5,-4
SI,AR,2015.0,2,1,1
RO,BE,2006.0,2,8,-6
RO,PL,1999.0,2,1,1
RU,TJ,2005.0,2,6,-4
GN,FR,2011.0,1,3,-2
BR,HU,2022.0,4,4,0
IL,AL,2018.0,1,1,0
AT,PT,2015.0,4,8,-4
PK,AU,2023.0,5,7,-2
RU,AM,2012.0,5,7,-2
IN,BH,2009.0,2,2,0
NL,TZ,2013.0,5,2,3
EE,LV,2011.0,1,1,0
CG,FR,2003.0,7,7,0
QA,IR,2016.0,1,6,-5
SI,IL,1997.0,1,1,0
RU,SA,2021.0,3,5,-2
NZ,MY,2007.0,2,4,-2
IN,SD,2013.0,1,2,-1
PK,TN,2014.0,2,3,-1
BD,SG,2011.0,1,8,-7
NL,UA,2003.0,2,6,-4
SG,RS,2016.0,1,1,0
DZ,GB,2019.0,3,14,-11
ES,MD,2008.0,1,2,-1
GH,MW,2017.0,2,1,1
ES,UA,2002.0,2,1,1
EG,IL,2022.0,3,3,0
ES,BG,2021.0,3,2,1
AT,BA,2020.0,2,4,-2
KZ,IR,2016.0,1,2,-1
AU,MT,2014.0,1,4,-3
MY,PH,2022.0,1,3,-2
BE,SI,2014.0,4,3,1
CZ,nan,2004.0,2,5,-3
CO,ES,2017.0,565,664,-99
CL,US,2019.0,279,272,7
FI,GB,2008.0,56,50,6
US,ZA,2003.0,181,188,-7
GB,CA,2006.0,718,615,103
MY,KR,2021.0,20,17,3
FR,CA,2007.0,423,410,13
ES,PT,2017.0,227,166,61
KR,CZ,2008.0,2,11,-9
PH,AR,2015.0,4,1,3
PK,US,2020.0,468,424,44
SE,IL,2001.0,6,4,2
GT,CO,2018.0,6,12,-6
IN,CA,2003.0,120,89,31
CH,GB,1998.0,93,86,7
SY,CN,2012.0,27,37,-10
CR,MX,2020.0,42,41,1
CO,US,2016.0,297,365,-68
NL,CH,1998.0,36,27,9
PL,BE,2018.0,18,21,-3
PL,RS,2011.0,4,1,3
FR,PT,2019.0,69,63,6
DK,AU,2016.0,55,60,-5
EE,US,2000.0,6,5,1
FR,RS,2012.0,5,3,2
CA,PT,2020.0,16,24,-8
AE,FR,2020.0,7,16,-9
CA,nan,2016.0,43,157,-114
RS,US,2018.0,66,55,11
CL,BR,2012.0,71,54,17
SE,RO,2001.0,1,5,-4
CH,BE,2006.0,24,47,-23
JP,NP,2016.0,11,8,3
IT,SE,2006.0,61,64,-3
DE,NZ,2021.0,36,38,-2
HU,VN,2021.0,2,2,0
TR,US,2014.0,407,504,-97
CN,MY,2016.0,86,54,32
SE,PL,2008.0,20,25,-5
nan,AR,2014.0,59,39,20
BE,CA,2012.0,54,59,-5
SE,IT,2021.0,66,61,5
BS,US,2019.0,4,5,-1
NL,IR,2014.0,26,36,-10
GH,DE,2020.0,12,22,-10
EG,DE,2011.0,29,51,-22
PK,NO,2017.0,7,12,-5
CO,DE,2016.0,43,38,5
PE,CU,2020.0,13,15,-2
PK,SA,2009.0,17,14,3
US,GE,2022.0,38,93,-55
MW,NL,2011.0,4,1,3
ZA,AU,2002.0,29,28,1
BJ,BE,2017.0,3,5,-2
RU,CL,2004.0,7,9,-2
ID,AZ,2020.0,4,2,2
TH,KR,2019.0,16,12,4
PR,KR,2011.0,36,27,9
MY,SD,2018.0,13,11,2
FR,AU,2002.0,66,34,32
GB,HR,1997.0,2,2,0
PL,AU,1999.0,8,6,2
AU,CZ,2017.0,14,10,4
TR,FI,2008.0,7,7,0
IR,JP,2021.0,14,8,6
HR,BA,2013.0,32,16,16
FR,AR,2002.0,22,22,0
RS,CH,2009.0,3,3,0
BD,US,2009.0,40,71,-31
IT,ET,2007.0,4,4,0
NO,EG,2019.0,6,3,3
BR,CU,2001.0,6,6,0
CH,CL,2009.0,6,6,0
DE,RO,2000.0,13,12,1
IT,AE,2020.0,9,7,2
RU,AU,2015.0,27,38,-11
OM,US,2018.0,13,15,-2
RO,SE,2012.0,5,10,-5
PL,MZ,2017.0,13,21,-8
MA,BE,2014.0,6,3,3
NL,HR,2020.0,4,8,-4
IR,LU,2022.0,2,1,1
IS,FR,2022.0,3,2,1
GB,ET,2017.0,12,7,5
TR,MY,2014.0,17,5,12
IN,DK,2009.0,15,5,10
nan,IE,2021.0,4,4,0
KR,HK,2020.0,1,1,0
OM,EG,2016.0,6,9,-3
GB,JM,2020.0,4,6,-2
TH,KR,2010.0,8,4,4
nan,PK,2019.0,15,15,0
HU,SI,2018.0,2,1,1
ES,UA,2005.0,4,5,-1
BD,IE,2008.0,1,1,0
ZW,NL,2003.0,2,2,0
KE,GB,2001.0,8,13,-5
FR,AE,2013.0,10,1,9
US,AL,2015.0,8,5,3
SE,SG,2009.0,14,9,5
SK,FR,1997.0,4,5,-1
GB,ID,2012.0,19,20,-1
BG,IT,2010.0,3,6,-3
CO,GT,2022.0,2,2,0
VE,PT,2008.0,5,3,2
NL,RS,2012.0,7,5,2
MY,CA,2006.0,7,6,1
ZA,NO,2013.0,5,6,-1
JO,TN,2022.0,1,3,-2
PS,SA,2022.0,2,14,-12
BR,UA,2000.0,2,3,-1
SS,US,2022.0,2,1,1
BE,SY,2010.0,1,1,0
NO,FI,2006.0,9,7,2
IL,NG,2018.0,5,1,4
IR,HU,2022.0,3,4,-1
FR,BG,2014.0,2,8,-6
EG,IQ,2009.0,2,5,-3
PT,IN,2012.0,11,22,-11
MY,NG,2010.0,2,5,-3
PA,AR,2009.0,7,2,5
UG,GM,2018.0,1,1,0
PL,VI,2008.0,1,1,0
BR,NG,2015.0,6,12,-6
TT,GB,2009.0,3,4,-1
BF,GB,2008.0,1,2,-1
TH,ZA,2021.0,1,2,-1
PT,UY,2014.0,4,1,3
CA,GE,2004.0,3,1,2
LU,RU,2019.0,3,1,2
DK,ES,2023.0,2,4,-2
ML,IN,2007.0,1,2,-1
BG,BE,2000.0,3,3,0
TH,BD,2014.0,3,4,-1
CA,UG,2013.0,4,1,3
NO,MX,2009.0,1,3,-2
AO,ES,2003.0,3,4,-1
FJ,US,2021.0,2,2,0
GM,MY,2018.0,1,2,-1
LU,IE,2021.0,1,2,-1
MD,US,2000.0,3,2,1
BG,JP,2004.0,3,7,-4
CA,PG,2019.0,2,1,1
UG,CA,2013.0,1,4,-3
EG,TR,2005.0,2,1,1
NL,SY,2017.0,1,1,0
NL,CA,2008.0,73,64,9
IT,SK,2009.0,3,8,-5
DE,FI,2004.0,26,26,0
IL,JP,2008.0,13,17,-4
IT,CM,2014.0,4,2,2
SA,IT,2010.0,1,5,-4
MW,US,2022.0,9,13,-4
BR,HN,2022.0,2,2,0
RS,PL,2022.0,5,4,1
NG,SE,2022.0,5,1,4
PK,CG,2009.0,1,1,0
SY,MX,2012.0,1,1,0
TW,CN,2010.0,1207,913,294
MY,,2024.0,16943,0,16943
,SE,1997.0,3427,0,3427
,JP,2013.0,14173,0,14173
,SE,1998.0,3103,0,3103
FI,,2024.0,13687,0,13687
CA,,2004.0,2413,0,2413
,ID,2012.0,7658,0,7658
,KR,2001.0,4339,0,4339
,AU,1995.0,8736,0,8736
,GB,2006.0,17300,0,17300
AR,,2023.0,12458,0,12458
DK,,2025.0,1765,0,1765
DE,,2000.0,4993,0,4993
BD,,2012.0,154,0,154
,NZ,1998.0,935,0,935
,PH,1996.0,350,0,350
MT,,2023.0,326,0,326
SI,,2014.0,269,0,269
,IL,2012.0,2385,0,2385
,GE,1994.0,259,0,259
,BE,2000.0,2413,0,2413
,BD,2014.0,1082,0,1082
,PT,2015.0,1756,0,1756
,TH,2009.0,2272,0,2272
TN,,2016.0,642,0,642
TW,,2007.0,1013,0,1013
,NZ,1997.0,1036,0,1036
,PH,2004.0,350,0,350
CU,,2013.0,241,0,241
PE,,2019.0,790,0,790
MX,,2007.0,652,0,652
CL,,2007.0,278,0,278
,HU,2013.0,1257,0,1257
,AT,2014.0,2436,0,2436
MX,AL,2010.0,1,0,1
,SV,2000.0,17,0,17
DZ,,2015.0,300,0,300
,BW,2003.0,54,0,54
PE,,2017.0,544,0,544
JM,,2013.0,37,0,37
,NG,2016.0,3453,0,3453
GR,,2014.0,1483,0,1483
BR,KH,2018.0,1,0,1
,UY,2009.0,301,0,301
BR,,1999.0,370,0,370
,SN,2006.0,105,0,105
AM,,2010.0,82,0,82
,EC,2018.0,1024,0,1024
GE,,2017.0,136,0,136
,JM,1994.0,97,0,97
,LV,2010.0,392,0,392
HU,,2008.0,481,0,481
,GN,1995.0,6,0,6
TH,CR,2015.0,1,0,1
SY,,2016.0,82,0,82
AU,TZ,2014.0,2,0,2
DK,UY,2014.0,4,0,4
TJ,,2024.0,725,0,725
LK,,2021.0,618,0,618
ES,BO,1997.0,1,0,1
NE,,2024.0,148,0,148
BJ,SN,2019.0,1,0,1
,BI,2008.0,17,0,17
BY,,2021.0,507,0,507
IS,,2014.0,60,0,60
,UZ,2013.0,148,0,148
,IS,2013.0,147,0,147
PH,,2018.0,454,0,454
GE,,2019.0,198,0,198
AM,,2017.0,111,0,111
AM,,2019.0,126,0,126
,TZ,2011.0,235,0,235
QA,,2009.0,34,0,34
VN,CL,2018.0,1,0,1
,BN,2019.0,30,0,30
ZM,,2021.0,118,0,118
,NA,2014.0,33,0,33
,KW,2015.0,170,0,170
OM,IQ,2011.0,2,0,2
,PA,1994.0,53,0,53
PL,,1999.0,364,0,364
,SG,2020.0,144,0,144
EE,,2001.0,28,0,28
PK,GM,2007.0,1,0,1
,LV,2017.0,315,0,315
,LV,2019.0,164,0,164
,AZ,2015.0,179,0,179
CM,,2025.0,77,0,77
,IQ,2003.0,67,0,67
,QA,2006.0,101,0,101
,MZ,1996.0,25,0,25
BR,MZ,1999.0,2,0,2
,RO,2020.0,144,0,144
IR,,2003.0,75,0,75
,TT,2015.0,50,0,50
PL,BA,2015.0,3,0,3
,BJ,2018.0,126,0,126
LY,AE,2015.0,2,0,2
PK,,2003.0,45,0,45
GA,AT,2016.0,2,0,2
MZ,,2020.0,66,0,66
UA,CO,2007.0,2,0,2
,SD,2016.0,136,0,136
ML,ID,2018.0,6,0,6
GP,MG,2017.0,1,0,1
,JE,2018.0,2,0,2
TH,GM,2020.0,1,0,1
GA,,2024.0,165,0,165
ZW,,2009.0,21,0,21
VN,MK,2021.0,1,0,1
AT,SI,1997.0,3,0,3
,NC,1996.0,17,0,17
MM,,2013.0,10,0,10
NP,LU,2008.0,2,0,2
KZ,,2013.0,45,0,45
GB,GL,2018.0,1,0,1
SE,TT,2015.0,1,0,1
EG,CI,2021.0,1,0,1
PG,,2018.0,23,0,23
PA,IL,2019.0,2,0,2
US,MC,2011.0,1,0,1
LV,,2013.0,66,0,66
HU,IR,2013.0,5,0,5
GL,,2024.0,36,0,36
ZA,SG,2003.0,4,0,4
,SL,2014.0,17,0,17
PH,SE,2016.0,4,0,4
IT,IS,2018.0,4,0,4
UG,,2002.0,13,0,13
VN,,2003.0,12,0,12
IN,EE,2005.0,1,0,1
PL,nan,2003.0,2,0,2
GP,,2016.0,42,0,42
IN,DJ,2020.0,1,0,1
PK,CO,2013.0,2,0,2
CG,AR,2011.0,2,0,2
UG,,2005.0,21,0,21
BS,,2016.0,5,0,5
,CD,2005.0,44,0,44
AT,GP,2018.0,1,0,1
MG,BE,2020.0,1,0,1
,MM,2006.0,19,0,19
AF,,2025.0,9,0,9
,BN,2017.0,38,0,38
IL,LK,2020.0,2,0,2
,PF,1999.0,6,0,6
CA,CG,2002.0,1,0,1
,MW,2003.0,44,0,44
PE,,2010.0,61,0,61
,CD,2002.0,25,0,25
TN,MG,2012.0,1,0,1
ML,DK,2013.0,3,0,3
EE,ES,2009.0,3,0,3
IQ,,2006.0,8,0,8
UY,,2001.0,12,0,12
PK,MX,2016.0,4,0,4
RO,PT,2003.0,2,0,2
HN,,2008.0,11,0,11
SN,NE,2009.0,1,0,1
RS,AG,2018.0,26,0,26
GR,LT,2009.0,1,0,1
JO,GR,2007.0,2,0,2
MW,NO,2004.0,1,0,1
,BF,1995.0,37,0,37
GE,,2010.0,52,0,52
,NC,2004.0,11,0,11
HR,BE,2011.0,5,0,5
NZ,NO,2008.0,5,0,5
BO,GT,2012.0,1,0,1
GA,CH,2016.0,1,0,1
BF,,2012.0,27,0,27
RO,ZM,2014.0,1,0,1
,MZ,2004.0,38,0,38
NL,ME,2013.0,1,0,1
CA,CG,2005.0,1,0,1
SK,ES,2005.0,3,0,3
ME,NO,2013.0,1,0,1
HR,LV,2017.0,1,0,1
AE,GD,1997.0,1,0,1
NG,,1999.0,93,0,93
,BB,1995.0,8,0,8
SG,LK,2009.0,1,0,1
CH,SA,2013.0,6,0,6
,BN,2010.0,25,0,25
TT,,2007.0,12,0,12
AO,MX,2015.0,2,0,2
MZ,BF,2019.0,1,0,1
DK,LI,2012.0,1,0,1
BG,NO,2011.0,13,0,13
MM,KR,2022.0,2,0,2
UA,ID,2017.0,1,0,1
IS,AT,2015.0,2,0,2
nan,BA,2018.0,2,0,2
JP,LB,2016.0,1,0,1
DZ,IR,2008.0,1,0,1
,SC,2017.0,3,0,3
ZW,CN,2010.0,1,0,1
DO,CU,2016.0,4,0,4
GB,BJ,2022.0,1,0,1
SK,MK,2022.0,1,0,1
AL,NL,2012.0,1,0,1
AZ,JP,1999.0,1,0,1
GB,HR,1998.0,1,0,1
JO,AU,2023.0,1,0,1
,ST,2011.0,15,0,15
CG,TN,2011.0,5,0,5
IE,EE,2016.0,3,0,3
SD,SE,2002.0,1,0,1
GB,AZ,2022.0,1,0,1
GP,FI,2017.0,1,0,1
PE,JP,2021.0,4,0,4
nan,LK,2005.0,1,0,1
AE,NE,2018.0,1,0,1
YE,FI,2018.0,1,0,1
MA,SG,2011.0,1,0,1
GM,FR,2003.0,1,0,1
SE,GP,2003.0,2,0,2
ET,MY,2006.0,1,0,1
AU,LY,2016.0,3,0,3
ES,DZ,2005.0,2,0,2
IT,JO,2002.0,2,0,2
TG,JP,2019.0,1,0,1
CM,BD,2008.0,1,0,1
PA,PH,2008.0,1,0,1
SK,EE,2014.0,3,0,3
CR,CA,2022.0,4,0,4
PR,CN,2017.0,1,0,1
EC,CL,1999.0,1,0,1
CO,AU,2005.0,2,0,2
PH,SA,2012.0,1,0,1
CO,AU,2002.0,3,0,3
CO,NZ,2013.0,3,0,3
IN,JM,2018.0,4,0,4
,RE,2008.0,18,0,18
SC,,2022.0,9,0,9
TW,nan,1997.0,1,0,1
MA,SD,2021.0,1,0,1
SD,KR,2007.0,6,0,6
AM,BE,2018.0,1,0,1
,CG,1994.0,18,0,18
,TO,2015.0,1,0,1
CW,,2020.0,6,0,6
SD,RU,2021.0,1,0,1
JO,HU,2017.0,1,0,1
DE,XK,2018.0,1,0,1
RU,IQ,2009.0,3,0,3
,AW,2015.0,1,0,1
PG,CH,2000.0,1,0,1
MA,AM,2006.0,1,0,1
nan,UY,2020.0,1,0,1
MN,NL,2019.0,2,0,2
NL,TT,2013.0,1,0,1
PL,LT,1998.0,1,0,1
JO,OM,2001.0,7,0,7
ZW,PL,2019.0,1,0,1
DZ,LY,2018.0,1,0,1
FI,RS,2019.0,1,0,1
RO,TT,2012.0,1,0,1
MT,GI,2012.0,1,0,1
UY,DK,2017.0,1,0,1
FR,TJ,2018.0,1,0,1
SG,TN,2018.0,1,0,1
KE,CD,2012.0,2,0,2
,KY,2013.0,2,0,2
BW,SA,2016.0,1,0,1
BO,,2008.0,10,0,10
,GL,1997.0,3,0,3
KH,MY,2021.0,3,0,3
PH,LU,2022.0,1,0,1
,FJ,1994.0,13,0,13
CH,GA,2004.0,1,0,1
AT,XK,2007.0,1,0,1
AO,IN,2004.0,1,0,1
NA,ZM,2015.0,1,0,1
MG,DE,2008.0,1,0,1
MK,,2003.0,9,0,9
CZ,GR,2023.0,1,0,1
ET,TZ,2014.0,1,0,1
GR,LU,2022.0,4,0,4
BI,,2005.0,2,0,2
RO,EE,2022.0,1,0,1
KE,CN,2007.0,3,0,3
EC,TH,2015.0,1,0,1
IL,UZ,2019.0,1,0,1
HU,ZA,2012.0,1,0,1
CZ,EG,1997.0,1,0,1
KR,GH,2011.0,2,0,2
HU,TH,1999.0,1,0,1
,SZ,2007.0,6,0,6
JP,MK,2016.0,1,0,1
VN,PR,1998.0,1,0,1
CU,FR,2010.0,5,0,5
LA,NZ,2004.0,1,0,1
PR,BR,2022.0,1,0,1
PS,LB,2015.0,2,0,2
TN,KR,2015.0,1,0,1
CN,ER,2015.0,2,0,2
LI,,2020.0,9,0,9
,XK,2001.0,9,0,9
ZA,RU,2000.0,3,0,3
NO,SA,2008.0,1,0,1
BI,US,2005.0,2,0,2
IN,OM,2023.0,1,0,1
CH,EC,2015.0,2,0,2
CZ,MY,2008.0,1,0,1
GB,LA,2012.0,1,0,1
LR,US,2009.0,2,0,2
RO,MX,2003.0,1,0,1
TN,GF,2020.0,2,0,2
CI,US,1997.0,1,0,1
,SC,2010.0,3,0,3
TW,IQ,2022.0,1,0,1
GP,nan,2005.0,1,0,1
BR,SR,2016.0,1,0,1
MA,CN,2009.0,3,0,3
PS,AE,2012.0,1,0,1
,DO,1995.0,18,0,18
HK,CH,2005.0,2,0,2
TL,,2022.0,10,0,10
CN,EC,2016.0,2,0,2
KG,MZ,2017.0,1,0,1
UY,ST,2021.0,1,0,1
IL,UZ,2010.0,1,0,1
LT,TR,2015.0,1,0,1
KH,CM,2015.0,1,0,1
PL,PK,2024.0,1,0,1
TN,AR,2008.0,1,0,1
BW,NA,2000.0,1,0,1
FR,KW,2014.0,3,0,3
ES,LT,2010.0,1,0,1
BE,SN,2003.0,3,0,3
CA,SS,2018.0,1,0,1
AE,VN,2020.0,2,0,2
LK,PH,2018.0,2,0,2
CM,AT,2015.0,1,0,1
AO,IT,2019.0,4,0,4
ME,AT,2008.0,1,0,1
LK,RO,2014.0,1,0,1
ML,CN,2007.0,1,0,1
PK,NP,2005.0,1,0,1
BE,TG,2012.0,1,0,1
TT,MS,1997.0,3,0,3
IL,KE,2009.0,1,0,1
CA,MU,2015.0,1,0,1
BR,NP,1998.0,1,0,1
PA,KR,2011.0,4,0,4
VN,JP,1997.0,4,0,4
CF,BE,2011.0,1,0,1
BR,EE,2017.0,2,0,2
IT,MQ,2004.0,1,0,1
CW,IE,2020.0,1,0,1
US,MR,2019.0,1,0,1
QA,TN,1998.0,1,0,1
VE,RO,2006.0,1,0,1
GR,DZ,2012.0,2,0,2
BD,CY,2009.0,2,0,2
KR,PA,2019.0,4,0,4
CG,ML,2012.0,1,0,1
GB,KY,2013.0,1,0,1
GR,SA,2012.0,4,0,4
EG,TD,2018.0,1,0,1
MX,RO,2016.0,1,0,1
AM,MY,2020.0,2,0,2
BD,HK,2015.0,1,0,1
CY,CH,2004.0,1,0,1
ES,NC,2017.0,1,0,1
LY,SG,2012.0,1,0,1
AR,RO,2019.0,1,0,1
MA,MG,2012.0,1,0,1
BE,KH,2009.0,1,0,1
LB,CD,2020.0,1,0,1
CI,,2006.0,13,0,13
HR,PL,2007.0,1,0,1
CL,RO,2000.0,1,0,1
CG,BO,2002.0,1,0,1
PY,,2008.0,4,0,4
SG,SK,2001.0,2,0,2
NP,LK,2023.0,1,0,1
NG,GM,2005.0,2,0,2
RW,,2025.0,13,0,13
,SC,2019.0,3,0,3
BR,LB,2006.0,3,0,3
US,LI,2015.0,2,0,2
IQ,NP,2015.0,1,0,1
YE,AE,2010.0,1,0,1
NG,DZ,2022.0,1,0,1
PT,BF,2016.0,1,0,1
NP,SN,2018.0,1,0,1
ML,RU,2005.0,1,0,1
PS,PL,2017.0,1,0,1
IN,BW,2002.0,1,0,1
AT,KZ,2017.0,1,0,1
FI,TH,2002.0,1,0,1
EC,BJ,2008.0,1,0,1
GT,GB,2003.0,1,0,1
GT,CU,2004.0,1,0,1
LV,JP,2003.0,2,0,2
PT,TR,2003.0,2,0,2
SI,XK,2013.0,1,0,1
AR,HN,2002.0,4,0,4
BG,ID,2015.0,2,0,2
TW,LV,2015.0,1,0,1
MD,EG,2002.0,1,0,1
FI,JO,2004.0,1,0,1
HR,LT,2009.0,1,0,1
ML,RU,2002.0,1,0,1
LB,TR,2021.0,1,0,1
PK,CM,2019.0,2,0,2
,PW,2018.0,1,0,1
TH,BF,2015.0,1,0,1
KR,CM,2021.0,2,0,2
DZ,CH,2005.0,1,0,1
nan,ZW,2000.0,1,0,1
PL,MK,2016.0,3,0,3
TT,BB,2019.0,1,0,1
LT,BR,2021.0,1,0,1
,BT,2004.0,5,0,5
GT,,2000.0,3,0,3
PT,HU,1997.0,1,0,1
CO,GA,2013.0,1,0,1
BR,LT,2012.0,1,0,1
LK,VN,2021.0,1,0,1
US,SV,2006.0,2,0,2
BY,EE,2013.0,1,0,1
SC,BJ,2012.0,1,0,1
BR,PR,2013.0,1,0,1
NL,PS,2016.0,2,0,2
CW,RO,2009.0,1,0,1
GW,IT,2018.0,1,0,1
DJ,,2011.0,1,0,1
DE,GT,2018.0,1,0,1
FI,BG,2014.0,3,0,3
ET,TR,2016.0,1,0,1
AU,PW,2014.0,1,0,1
PF,JP,2022.0,1,0,1
CN,CU,2005.0,1,0,1
KR,KH,2011.0,2,0,2
IL,RE,2008.0,1,0,1
AE,SA,2002.0,1,0,1
IL,LY,2003.0,1,0,1
CD,,1999.0,3,0,3
PK,FI,2023.0,1,0,1
SE,LY,2013.0,2,0,2
RS,SG,2022.0,1,0,1
IE,MU,2003.0,1,0,1
TR,BY,2013.0,1,0,1
QA,MX,2002.0,1,0,1
CO,OM,2020.0,1,0,1
BD,CN,2000.0,2,0,2
GB,MG,2001.0,1,0,1
BB,,2002.0,3,0,3
IN,MZ,2011.0,1,0,1
IT,LR,2013.0,1,0,1
UZ,BE,2002.0,1,0,1
KE,SG,2005.0,1,0,1
US,IM,2013.0,1,0,1
AZ,AT,2014.0,1,0,1
UZ,TW,2013.0,1,0,1
MG,MA,2001.0,1,0,1
MR,FR,2002.0,1,0,1
ET,QA,2017.0,1,0,1
PK,NI,2015.0,1,0,1
KR,CO,2001.0,1,0,1
PK,OM,1999.0,1,0,1
HU,BG,1999.0,2,0,2
KZ,DK,2018.0,1,0,1
FR,VU,2005.0,1,0,1
MW,TH,2017.0,1,0,1
BY,TR,2015.0,1,0,1
BE,PL,2023.0,1,0,1
BJ,NC,2020.0,1,0,1
CF,FR,2002.0,1,0,1
NG,XK,2011.0,1,0,1
nan,SN,2015.0,1,0,1
TN,FI,2018.0,1,0,1
JM,NL,2009.0,1,0,1
IL,KZ,2010.0,1,0,1
BG,ZA,2009.0,1,0,1
GW,NL,2011.0,1,0,1
US,BN,2003.0,1,0,1
JP,ML,2005.0,2,0,2
GR,IR,2009.0,1,0,1
PR,PL,2012.0,1,0,1
CZ,LK,2002.0,1,0,1
GE,DK,2018.0,2,0,2
VC,,2019.0,1,0,1
TR,MT,2022.0,1,0,1
KE,AR,2018.0,1,0,1
OM,ID,2018.0,3,0,3
NO,TW,2006.0,2,0,2
ZA,CO,2009.0,1,0,1
SI,ET,2020.0,1,0,1
BY,JP,2004.0,2,0,2
TT,NA,2020.0,1,0,1
KH,FR,1999.0,1,0,1
JP,KG,2011.0,1,0,1
EE,PL,2006.0,2,0,2
UA,LT,2003.0,2,0,2
PK,ET,2012.0,1,0,1
PH,SD,2005.0,1,0,1
KZ,CZ,2022.0,1,0,1
TH,GE,2013.0,1,0,1
UY,GT,2020.0,1,0,1
GB,MQ,2015.0,1,0,1
CA,KE,2002.0,2,0,2
IR,AL,2016.0,1,0,1
AU,MU,2013.0,1,0,1
ES,DZ,2002.0,2,0,2
AR,PH,2007.0,3,0,3
NC,VU,2016.0,1,0,1
BG,PL,1998.0,3,0,3
MD,EE,2015.0,1,0,1
NG,FI,2012.0,1,0,1
ES,AZ,2013.0,1,0,1
CA,BH,2007.0,1,0,1
MD,SE,2014.0,1,0,1
FI,QA,2019.0,1,0,1
US,MV,2014.0,1,0,1
GB,FJ,2003.0,1,0,1
VA,ES,2009.0,1,0,1
AR,CM,2016.0,1,0,1
PS,QA,2007.0,2,0,2
GM,DE,2015.0,1,0,1
NO,FO,2008.0,1,0,1
BE,CM,2004.0,1,0,1
IT,BS,2020.0,1,0,1
MT,IN,2005.0,1,0,1
FI,TH,2005.0,1,0,1
JP,TO,2006.0,1,0,1
BN,,2005.0,1,0,1
IE,SK,2019.0,1,0,1
HR,CN,2002.0,1,0,1
UY,PG,2003.0,1,0,1
BY,PT,2015.0,1,0,1
ID,LY,2015.0,1,0,1
UA,DK,2016.0,1,0,1
MG,BJ,2004.0,1,0,1
,FM,2006.0,3,0,3
DO,BO,2000.0,1,0,1
AU,UA,2001.0,1,0,1
RS,BR,2020.0,2,0,2
SA,ET,2007.0,2,0,2
nan,MD,2012.0,1,0,1
MY,OM,2004.0,2,0,2
IQ,KE,2015.0,1,0,1
PG,KR,2018.0,1,0,1
NL,EC,2006.0,1,0,1
KE,HU,2015.0,1,0,1
AZ,US,2005.0,2,0,2
BM,FR,2011.0,1,0,1
EE,PT,2019.0,3,0,3
NL,BF,2011.0,1,0,1
UA,TH,2012.0,1,0,1
FI,PG,2017.0,1,0,1
MD,CN,2005.0,1,0,1
NG,KW,2002.0,2,0,2
FI,TZ,2021.0,2,0,2
CO,PT,2001.0,2,2,0
TR,XK,2014.0,2,1,1
PL,MZ,2019.0,4,6,-2
EE,CH,2016.0,7,17,-10
FR,CF,2017.0,1,2,-1
EG,TZ,2013.0,1,1,0
CU,CR,2010.0,6,7,-1
MS,GB,2005.0,1,2,-1
SE,PE,2008.0,1,2,-1
TR,NZ,2021.0,3,3,0
SK,UA,2010.0,2,4,-2
NI,AR,2018.0,3,2,1
MT,CA,2013.0,1,1,0
AR,CH,1999.0,4,2,2
MW,SE,2009.0,1,1,0
US,BB,2016.0,3,1,2
NP,TH,2022.0,3,3,0
UY,HN,2018.0,1,1,0
BA,CA,2018.0,1,2,-1
PT,PL,2023.0,1,1,0
US,GT,2003.0,2,1,1
GE,nan,2005.0,2,1,1
MX,TW,2010.0,2,2,0
CL,NI,2005.0,1,2,-1
JP,MM,2005.0,3,1,2
OM,AU,2010.0,2,4,-2
KR,IL,2014.0,3,5,-2
IQ,PL,2016.0,2,1,1
TW,SD,2018.0,1,1,0
MW,BW,2019.0,1,1,0
AM,RU,2004.0,2,8,-6
AR,RO,2017.0,1,4,-3
NZ,SA,2015.0,3,2,1
SA,CO,2016.0,2,1,1
KH,JP,2003.0,3,3,0
UY,PT,2012.0,1,4,-3
FI,BD,2020.0,4,5,-1
TR,SE,2007.0,1,5,-4
EG,HU,2008.0,2,3,-1
AE,SA,2005.0,2,4,-2
US,EC,1999.0,2,3,-1
IT,JO,2005.0,1,1,0
MV,NZ,2018.0,1,1,0
MN,US,2017.0,2,5,-3
MZ,ES,2012.0,1,3,-2
NL,LT,2013.0,1,1,0
AT,MN,2014.0,1,1,0
SE,LV,2022.0,1,1,0
NG,AR,2019.0,1,1,0
AR,HN,2005.0,1,5,-4
AO,IT,2017.0,2,1,1
BG,nan,2000.0,1,2,-1
PK,AT,2015.0,5,12,-7
GB,SD,2022.0,4,10,-6
US,VA,2008.0,1,2,-1
PK,PS,2020.0,2,1,1
TG,FR,2016.0,4,11,-7
IR,ID,2010.0,2,1,1
CY,CA,2020.0,2,1,1
TR,TN,2018.0,3,3,0
CL,TW,2018.0,2,1,1
TW,SA,2006.0,1,1,0
TH,NO,2011.0,2,1,1
CR,NL,2014.0,1,2,-1
TZ,CH,2009.0,3,1,2
CN,LY,2015.0,1,1,0
AT,PE,2012.0,2,1,1
MU,GB,2012.0,1,2,-1
KR,UZ,2021.0,1,3,-2
BR,KR,2008.0,1,1,0
AE,BE,2013.0,1,1,0
MN,AE,2011.0,1,1,0
MX,AF,2014.0,3,3,0
PH,FR,2021.0,2,9,-7
HK,CA,2003.0,3,3,0
AU,BG,2005.0,1,2,-1
TW,GR,2014.0,1,1,0
RW,NG,2018.0,1,1,0
AT,GA,2008.0,1,1,0
NL,BG,1998.0,1,2,-1
CY,TR,2004.0,2,2,0
AU,BT,2020.0,2,5,-3
JO,JP,2014.0,1,6,-5
PA,ZA,2014.0,3,2,1
SV,CR,2016.0,1,1,0
AE,ES,2013.0,1,3,-2
BW,CA,2004.0,1,1,0
ZW,NG,2011.0,1,1,0
DO,CO,2011.0,4,2,2
RU,CR,2012.0,1,1,0
DE,AM,2000.0,2,1,1
TZ,CN,2013.0,2,3,-1
MA,LB,2019.0,2,1,1
OM,AE,1999.0,1,3,-2
IL,KZ,2019.0,2,3,-1
EG,SK,2009.0,1,1,0
ZM,TH,2004.0,1,1,0
ML,SN,2006.0,1,1,0
AT,SI,1998.0,1,2,-1
BA,AU,2012.0,1,2,-1
CN,PA,2013.0,1,1,0
BY,CN,2020.0,2,3,-1
CZ,TR,2006.0,1,4,-3
SA,FR,2006.0,2,5,-3
TH,BR,2020.0,1,6,-5
ET,FR,2015.0,1,4,-3
BE,ZM,2014.0,1,1,0
BD,ZA,2013.0,1,2,-1
ZA,PL,2013.0,1,2,-1
QA,AE,2014.0,1,11,-10
CO,UA,2014.0,2,1,1
GT,CL,2012.0,1,4,-3
LV,EE,2011.0,1,1,0
IE,TW,2011.0,2,2,0
DK,TH,2021.0,2,3,-1
BE,LV,1999.0,2,1,1
CH,IQ,2017.0,1,1,0
NZ,SK,2019.0,1,1,0
KE,SD,2015.0,1,1,0
DZ,TN,2007.0,1,1,0
IL,KZ,2017.0,1,1,0
BR,NZ,1999.0,2,1,1
CN,JO,2021.0,2,6,-4
SI,MX,2006.0,1,1,0
IS,IT,2009.0,1,2,-1
TR,GR,2000.0,1,3,-2
BO,IT,2010.0,1,1,0
UG,IL,2018.0,1,1,0
EC,IL,2009.0,1,2,-1
IT,ME,2018.0,2,1,1
ES,TR,1997.0,2,2,0
SK,IL,2002.0,1,3,-2
IN,JO,2001.0,1,1,0
PH,TW,2006.0,1,4,-3
MG,MC,2013.0,1,2,-1
SG,HK,2014.0,1,2,-1
KH,US,2000.0,1,2,-1
ES,NI,2009.0,2,3,-1
GH,JP,2008.0,1,3,-2
NL,BJ,2007.0,1,1,0
TW,nan,1998.0,1,3,-2
KR,VN,1998.0,1,1,0
NL,SR,2022.0,1,1,0
SG,NO,2019.0,2,5,-3
BH,KE,2022.0,1,1,0
MS,GB,2002.0,1,1,0
BR,CG,2017.0,2,1,1
SK,MD,2021.0,1,2,-1
PH,IL,1998.0,1,1,0
RS,JP,2009.0,1,2,-1
AE,MA,2018.0,1,3,-2
CA,ID,2001.0,1,2,-1
SG,IE,2023.0,1,1,0
TR,nan,2003.0,1,2,-1
SK,SE,2021.0,1,1,0
UY,EC,2005.0,1,1,0
PT,CZ,1999.0,1,2,-1
UZ,DE,2021.0,1,3,-2
SY,ET,2019.0,1,3,-2
TZ,NL,2002.0,1,2,-1
UY,FR,2004.0,1,2,-1
PE,PL,2020.0,1,1,0
RS,BG,2019.0,1,5,-4
NZ,EG,2011.0,1,1,0
SA,PL,2017.0,1,1,0
DE,MQ,2015.0,1,1,0
PT,RO,2000.0,1,1,0
LT,CH,2014.0,1,3,-2
LT,KH,2017.0,2,1,1
HR,RO,2016.0,1,4,-3
KG,ID,2021.0,1,1,0
SE,CL,2022.0,1,9,-8
CA,QA,2023.0,1,2,-1
SA,BA,2016.0,1,2,-1
RO,SK,2022.0,1,8,-7
BB,GB,1999.0,1,2,-1
ZM,IN,2016.0,1,1,0
NP,SA,2012.0,1,1,0
DK,LT,2014.0,1,1,0
MY,AE,2010.0,1,5,-4
BW,MY,2015.0,1,1,0
NI,CU,2018.0,1,1,0
JP,CD,2022.0,1,2,-1
DK,VE,2009.0,1,1,0
EC,AT,2022.0,1,2,-1
ET,CD,2020.0,1,2,-1
GB,PA,2004.0,1,2,-1
MX,TW,2019.0,1,2,-1
HR,nan,2013.0,1,1,0
ZA,AR,2000.0,1,1,0
CA,BA,2007.0,1,2,-1
LT,EE,2021.0,1,1,0
PH,IL,1997.0,1,1,0
MD,LT,2010.0,1,1,0
SE,KW,2018.0,1,3,-2
SY,LB,2005.0,1,2,-1
GE,CA,2021.0,1,7,-6
PK,SK,2016.0,1,1,0
DE,MZ,2019.0,1,1,0
AZ,IR,2021.0,2,2,0
LV,CA,2009.0,1,3,-2
IQ,DK,2021.0,2,1,1
SE,NP,2011.0,2,2,0
PH,UY,2020.0,2,2,0
ES,LT,2017.0,1,3,-2
nan,ZA,1999.0,1,1,0
ID,SE,2010.0,1,4,-3
LY,FR,2013.0,1,1,0
CL,GT,2014.0,1,3,-2
IE,SK,2017.0,2,1,1
SE,DZ,2012.0,1,1,0
FI,TW,1999.0,1,3,-2
ZW,CN,2019.0,1,3,-2
VN,SE,2005.0,1,2,-1
GB,SY,2015.0,2,4,-2
DE,UY,1998.0,1,2,-1
HN,CL,2022.0,1,3,-2
NO,EG,2010.0,2,2,0
PK,LK,2020.0,1,2,-1
PH,NO,2021.0,1,2,-1
KE,ZM,2020.0,1,2,-1
KR,BR,2008.0,1,1,0
DO,CH,2007.0,1,0,1
BG,SI,2021.0,1,0,1
DO,TZ,2014.0,1,0,1
GP,MG,2019.0,1,0,1
TG,RO,2022.0,1,0,1
SY,nan,2013.0,1,0,1
TR,CL,2021.0,1,0,1
VE,SE,2018.0,1,0,1
NC,FJ,2020.0,1,0,1
CO,ZM,1999.0,1,0,1
IR,CN,1998.0,1,0,1
CZ,BD,2022.0,1,0,1
PE,SE,2009.0,1,0,1
PK,NA,2015.0,1,0,1
AT,NG,2015.0,1,0,1
UG,MM,2011.0,2,0,2
HU,EE,2012.0,1,0,1
CR,BR,2001.0,1,0,1
EC,CN,2012.0,1,0,1
nan,SA,2009.0,2,0,2
CZ,CL,2021.0,2,0,2
AT,AL,2016.0,1,0,1
NZ,SK,2017.0,1,0,1
BR,MO,2013.0,2,0,2
RO,BA,2011.0,1,0,1
AO,GB,2001.0,1,0,1
FI,HR,2005.0,1,0,1
DK,SD,2002.0,1,0,1
NL,ZM,2018.0,4,0,4
CL,MD,2011.0,1,0,1
PT,UG,2008.0,1,0,1
IN,ER,2015.0,1,0,1
TZ,PH,2021.0,1,0,1
,BT,1996.0,1,0,1
LK,SI,2006.0,1,0,1
SY,DE,2000.0,1,0,1
IT,CI,2001.0,1,0,1
IN,PE,2020.0,1,0,1
IL,SI,2016.0,1,0,1
EG,OM,2000.0,1,0,1
FI,IS,2004.0,1,0,1
CM,CI,2004.0,1,0,1
HN,CO,2008.0,1,0,1
GF,MG,2008.0,1,0,1
TD,BF,2016.0,1,0,1
MR,FR,2005.0,1,0,1
ET,AE,2019.0,1,0,1
SE,SJ,2003.0,1,0,1
MW,BW,2010.0,1,0,1
IL,RO,2007.0,1,0,1
CN,EE,2021.0,2,0,2
BB,,2005.0,1,0,1
AT,NP,2015.0,1,0,1
AM,GR,2014.0,2,0,2
,SM,2018.0,1,0,1
SK,TH,2005.0,1,0,1
SO,PL,2014.0,1,0,1
NP,BR,2020.0,1,0,1
GR,SI,2022.0,1,0,1
IN,IQ,2006.0,1,0,1
ZA,BI,2010.0,1,0,1
MR,DZ,2014.0,1,0,1
LV,GE,2012.0,1,0,1
ET,MX,2009.0,2,0,2
BW,,1998.0,3,0,3
BI,ZA,2011.0,1,0,1
AR,SA,2018.0,1,0,1
SS,,2008.0,1,0,1
BD,BR,1998.0,1,0,1
MO,BR,2009.0,1,0,1
NZ,VN,2011.0,1,0,1
NZ,MV,2013.0,1,0,1
KZ,AU,2007.0,1,0,1
ZW,DZ,2018.0,1,0,1
UZ,MX,2011.0,1,0,1
LK,DE,2003.0,1,0,1
IE,LV,2015.0,3,0,3
LV,FR,1997.0,1,0,1
IN,KY,2020.0,1,0,1
ES,AE,2001.0,1,0,1
HR,AE,2008.0,1,0,1
CO,RE,2001.0,1,0,1
SN,DE,2004.0,1,0,1
AR,CN,1997.0,1,0,1
ZW,TH,2018.0,1,0,1
AU,OM,2002.0,1,0,1
NI,GB,2017.0,1,0,1
SE,CR,2006.0,2,0,2
BT,NP,2018.0,3,0,3
JM,IT,2018.0,1,0,1
SM,NZ,2020.0,1,0,1
MK,KZ,2016.0,1,0,1
ZA,JO,2014.0,1,0,1
GP,MA,2010.0,1,0,1
DO,SE,1998.0,1,0,1
HU,OM,2003.0,1,0,1
PR,CN,2019.0,1,0,1
NL,GM,2016.0,1,0,1
FJ,MY,2022.0,2,0,2
BG,TN,2003.0,1,0,1
,BZ,1995.0,1,0,1
IM,US,2006.0,1,0,1
RE,US,1999.0,1,0,1
NL,CU,2003.0,1,0,1
BG,CU,2013.0,1,0,1
DE,SA,1998.0,3,0,3
PL,LT,1997.0,1,0,1
LK,PT,2003.0,1,0,1
PT,PA,2011.0,1,0,1
BJ,CN,2020.0,3,0,3
IN,MW,2020.0,1,0,1
FR,PK,2001.0,1,0,1
KW,JM,2001.0,1,0,1
HR,EE,2010.0,2,0,2
FI,MN,2018.0,1,0,1
NZ,PL,1999.0,1,0,1
MN,ET,2018.0,1,0,1
UA,KW,2011.0,1,0,1
US,TO,2014.0,1,0,1
GE,CH,2001.0,1,0,1
GE,AU,1997.0,1,0,1
GH,GM,2015.0,1,0,1
BJ,CA,1998.0,1,0,1
FJ,SG,2006.0,1,0,1
IL,HK,2023.0,1,0,1
SN,TW,2018.0,1,0,1
SN,IT,2022.0,1,0,1
PW,,2009.0,1,0,1
FI,SJ,2014.0,1,0,1
NP,AU,2023.0,1,0,1
BI,CA,2016.0,1,0,1
AT,CG,2013.0,1,0,1
UY,LU,2013.0,1,0,1
HU,IE,2023.0,1,0,1
UG,MW,2009.0,1,0,1
BI,IT,2011.0,1,0,1
GT,CR,2011.0,1,0,1
QA,AR,2015.0,1,0,1
CF,CA,2019.0,1,0,1
XK,DZ,2014.0,1,0,1
SA,UG,2019.0,1,0,1
TD,SA,2018.0,1,0,1
TM,UZ,2005.0,1,0,1
NI,NO,2006.0,1,0,1
ES,BY,2006.0,1,0,1
DE,MN,2012.0,1,0,1
BW,UG,2016.0,1,0,1
CF,JP,2021.0,1,0,1
CY,ID,2011.0,2,0,2
CH,PE,2000.0,1,0,1
GP,GF,2000.0,2,0,2
,GL,1998.0,2,0,2
RO,BG,2015.0,1,0,1
ID,ET,2015.0,1,0,1
ES,GW,2012.0,1,0,1
DE,AE,2023.0,1,0,1
XK,IE,2012.0,1,0,1
FR,MZ,2015.0,1,0,1
SO,NG,2017.0,1,0,1
NZ,SL,2019.0,1,0,1
CM,BW,1998.0,1,0,1
IE,ID,1998.0,1,0,1
FR,CR,2000.0,1,0,1
BJ,BR,2003.0,1,0,1
GB,CG,2019.0,1,0,1
ID,YE,2022.0,1,0,1
LV,ID,2019.0,1,0,1
MT,NZ,2013.0,1,0,1
US,BM,2006.0,2,0,2
TR,BO,2019.0,1,0,1
NZ,PA,2021.0,1,0,1
NI,GB,2010.0,1,0,1
RW,DE,2021.0,1,0,1
ID,UZ,2016.0,1,0,1
BN,,2002.0,1,0,1
KR,GD,2021.0,1,0,1
FR,MT,2005.0,1,0,1
ID,MW,2019.0,1,0,1
DZ,ZA,2012.0,1,0,1
BE,CY,2002.0,1,0,1
CZ,PE,2017.0,1,0,1
FI,QA,2010.0,1,0,1
ZA,RS,2015.0,1,0,1
TN,BG,2017.0,1,0,1
KR,IQ,2017.0,1,0,1
RS,UZ,2002.0,1,0,1
MY,AR,2022.0,1,0,1
GB,RE,2007.0,1,0,1
AU,BY,2022.0,1,0,1
MW,IN,2013.0,1,0,1
CW,FI,2011.0,1,0,1
LK,GI,2008.0,1,0,1
TT,CA,1999.0,1,0,1
MD,NL,2014.0,1,0,1
TN,LB,2006.0,1,0,1
GB,AM,2001.0,1,0,1
BY,SE,2023.0,1,0,1
NG,ZM,2014.0,1,0,1
JP,EE,2009.0,1,0,1
DK,BB,2009.0,1,0,1
DZ,PT,2012.0,1,0,1
IL,MA,2018.0,1,0,1
PH,GM,2011.0,1,0,1
GN,CA,2003.0,1,0,1
ID,NP,2021.0,1,0,1
CN,PH,2023.0,1,0,1
HU,AG,2021.0,1,0,1
TH,VN,2003.0,1,0,1
PS,KR,2018.0,1,0,1
MZ,CN,2007.0,1,0,1
TN,PA,2009.0,1,0,1
CH,MC,2014.0,1,0,1
GB,JP,2012.0,313,272,41
JP,US,2004.0,1959,1754,205
MX,US,2021.0,388,293,95
NO,US,2015.0,161,164,-3
KR,US,2013.0,1227,1466,-239
NG,SD,2021.0,1,4,-3
US,GB,2021.0,4863,4594,269
ES,US,2016.0,1166,844,322
US,CA,2005.0,2494,2322,172
CA,GB,2009.0,732,836,-104
ZA,US,2013.0,304,390,-86
US,CA,2002.0,1899,2052,-153
US,TW,2002.0,650,441,209
BR,PT,2012.0,865,658,207
DE,US,2013.0,2488,2601,-113
CA,AU,2007.0,269,237,32
AR,MX,2007.0,61,81,-20
CO,MX,2021.0,297,238,59
BR,US,2005.0,600,631,-31
US,NZ,2014.0,369,376,-7
NZ,US,2015.0,407,385,22
NL,US,2016.0,819,772,47
FR,US,2000.0,925,744,181
US,VE,2019.0,25,65,-40
AU,US,2016.0,2467,2584,-117
JP,TW,2010.0,76,63,13
GB,CN,2006.0,407,333,74
GB,MT,2017.0,23,14,9
US,SE,2021.0,370,349,21
ES,MX,2007.0,453,423,30
FR,CA,2008.0,499,425,74
PK,IN,2017.0,300,343,-43
JP,GB,2019.0,256,296,-40
AU,MK,2022.0,43,13,30
US,TW,2005.0,659,569,90
FR,CN,2013.0,231,166,65
FI,CA,2020.0,21,24,-3
TW,US,2021.0,439,512,-73
BE,CN,2015.0,51,70,-19
AU,SE,2016.0,63,47,16
BR,IT,2007.0,124,142,-18
GB,AU,2000.0,598,555,43
PK,IN,2019.0,395,510,-115
IE,FR,2015.0,47,35,12
UG,US,2006.0,10,13,-3
US,DK,2002.0,149,169,-20
GB,MT,2019.0,25,23,2
GB,nan,1998.0,23,30,-7
BR,VE,2017.0,15,30,-15
GB,FR,2001.0,262,371,-109
JP,TW,2017.0,103,100,3
AU,nan,2009.0,33,18,15
RO,HU,2001.0,92,17,75
SE,PL,2007.0,15,11,4
DE,SE,2012.0,207,156,51
MY,FR,2019.0,13,16,-3
DE,AU,1998.0,74,53,21
CL,MX,2007.0,65,81,-16
US,ID,2016.0,246,138,108
CN,CA,2009.0,347,495,-148
US,PH,2014.0,384,459,-75
FR,JP,2004.0,86,106,-20
MX,ES,2020.0,1033,881,152
CA,CL,2014.0,31,26,5
BR,DE,2021.0,210,162,48
US,NL,2008.0,594,621,-27
IR,BR,2017.0,13,13,0
TH,US,2019.0,134,196,-62
CN,ES,1997.0,5,6,-1
CN,GB,1999.0,127,159,-32
CR,CL,2019.0,33,41,-8
NO,SE,2011.0,72,77,-5
CN,AT,2004.0,13,6,7
GB,GR,2020.0,208,230,-22
TW,GB,2010.0,57,57,0
US,QA,2009.0,24,20,4
US,nan,2007.0,240,252,-12
JP,BR,2003.0,38,12,26
CO,FR,2016.0,37,44,-7
IR,US,2015.0,740,368,372
KR,GB,2006.0,61,55,6
AE,BR,2017.0,3,1,2
US,BD,2015.0,107,138,-31
PK,BD,2017.0,42,61,-19
CZ,KR,2010.0,6,7,-1
CH,US,2018.0,942,1008,-66
AU,AT,2008.0,20,21,-1
LT,CN,2017.0,4,4,0
CO,AR,2006.0,23,34,-11
NL,nan,1999.0,20,16,4
CL,EC,2008.0,8,3,5
SN,FR,2011.0,25,32,-7
SG,AU,2011.0,109,74,35
ES,SE,2021.0,73,59,14
SE,US,2007.0,331,392,-61
GB,NG,2016.0,89,72,17
ES,DO,2016.0,8,3,5
TR,IT,2009.0,12,17,-5
BR,MX,2007.0,44,56,-12
AR,nan,2014.0,39,59,-20
SI,AT,2017.0,28,15,13
AR,PT,2012.0,11,14,-3
CN,VN,2020.0,54,18,36
JP,nan,2007.0,42,98,-56
CN,PL,2018.0,26,28,-2
IT,FR,2003.0,178,207,-29
CH,CA,2004.0,58,63,-5
CA,DE,1997.0,77,67,10
US,PT,2018.0,200,187,13
US,UA,2004.0,19,37,-18
IT,PT,2012.0,44,27,17
FI,NO,2016.0,20,14,6
ES,MA,2012.0,8,4,4
CH,NL,2019.0,115,151,-36
NL,BE,2001.0,97,94,3
IT,ZA,2020.0,19,20,-1
PT,US,2013.0,145,198,-53
TW,GB,2019.0,83,44,39
IT,FI,1998.0,7,6,1
JP,SG,2020.0,36,35,1
CU,CL,2004.0,10,13,-3
PT,BE,2006.0,7,10,-3
JP,GB,2010.0,299,272,27
US,VE,2017.0,27,46,-19
JP,CH,2006.0,50,34,16
ES,CL,2007.0,179,178,1
FR,DZ,2011.0,147,71,76
ES,AR,2007.0,205,241,-36
BD,ES,1999.0,2,1,1
IT,ES,2021.0,267,210,57
NO,BR,2016.0,46,13,33
VE,IT,2020.0,9,5,4
GR,JP,2011.0,42,47,-5
AU,IN,1998.0,23,36,-13
KR,ET,2015.0,99,109,-10
IN,TW,2015.0,56,54,2
IN,PK,2020.0,458,376,82
MX,UY,2012.0,8,6,2
DE,PL,2003.0,59,68,-9
PL,US,2001.0,122,109,13
FI,SE,2017.0,120,91,29
CA,NZ,2015.0,78,75,3
IE,SE,2011.0,10,16,-6
CH,AU,2020.0,80,93,-13
MX,CO,2012.0,238,221,17
ZA,MW,2022.0,5,8,-3
TH,NL,2021.0,3,6,-3
GB,IN,2006.0,203,241,-38
HR,RS,2000.0,13,15,-2
BY,RU,2007.0,51,32,19
JM,US,2020.0,14,13,1
BD,GB,2007.0,28,43,-15
DE,IN,2015.0,192,219,-27
AR,BR,2022.0,68,81,-13
SI,AT,2019.0,21,16,5
AU,IL,2016.0,13,27,-14
RU,CN,2016.0,43,55,-12
JP,SK,2002.0,24,12,12
TW,FR,2020.0,6,12,-6
CN,LB,2016.0,11,38,-27
HU,JP,2001.0,9,9,0
CN,KR,1999.0,41,39,2
IE,AU,2006.0,70,59,11
IR,FR,2015.0,18,31,-13
IE,CA,2014.0,151,163,-12
CN,MM,2010.0,5,7,-2
CN,CZ,2006.0,30,60,-30
nan,MY,2005.0,8,10,-2
GB,PL,2021.0,106,74,32
ES,DE,2021.0,202,228,-26
JP,AU,1997.0,31,29,2
NL,DK,2000.0,18,12,6
CH,KE,2016.0,3,5,-2
US,AE,2015.0,86,58,28
FR,nan,2008.0,157,197,-40
TN,DZ,2018.0,42,34,8
IN,NL,2022.0,35,22,13
CH,NL,2017.0,118,144,-26
TH,US,2017.0,136,227,-91
CH,FR,2016.0,384,531,-147
BR,SE,2006.0,9,10,-1
HR,PL,2008.0,1,3,-2
US,PL,2021.0,188,207,-19
RU,BG,1998.0,7,8,-1
NG,NZ,2017.0,5,2,3
NO,GB,2012.0,59,87,-28
TR,GH,2020.0,3,1,2
TW,SG,2006.0,20,33,-13
AM,RU,2015.0,18,4,14
DE,BR,2022.0,90,166,-76
FR,CU,2014.0,3,6,-3
TR,TH,2010.0,5,3,2
BR,US,2002.0,410,437,-27
JP,AU,1998.0,30,41,-11
CH,AT,2020.0,122,145,-23
ES,CZ,2014.0,31,15,16
PK,BD,2019.0,47,62,-15
EC,US,2020.0,123,105,18
UA,RU,2009.0,135,133,2
IN,nan,2013.0,62,49,13
SA,NZ,2019.0,4,4,0
SA,YE,2021.0,17,17,0
BR,FR,2003.0,70,96,-26
GB,CZ,2017.0,56,44,12
DE,CN,1999.0,73,67,6
SE,NG,2003.0,4,1,3
GR,TR,2012.0,7,2,5
CL,PT,2016.0,10,13,-3
PT,IT,2010.0,20,28,-8
CA,EG,2004.0,11,14,-3
HU,BR,2011.0,4,1,3
AT,HU,2021.0,21,17,4
JP,NZ,2018.0,13,16,-3
NL,CN,2012.0,92,92,0
PL,CA,2015.0,32,36,-4
IR,DE,2018.0,148,73,75
IL,UA,2018.0,10,9,1
FI,SE,2019.0,118,112,6
NP,DE,2017.0,1,6,-5
FR,SA,2018.0,47,20,27
US,BH,2016.0,14,11,3
IT,VN,2012.0,4,1,3
NI,MX,2015.0,3,4,-1
CM,BE,2019.0,8,9,-1
DE,ZA,2015.0,67,68,-1
SK,CH,2017.0,12,10,2
FR,MD,2016.0,35,41,-6
IT,NL,2015.0,139,92,47
DE,IL,2011.0,34,52,-18
US,HK,2004.0,3,5,-2
BF,BJ,2017.0,2,1,1
DE,PT,2013.0,43,26,17
BR,AO,2014.0,27,16,11
DE,EG,2010.0,45,30,15
MY,US,2020.0,150,163,-13
CH,JP,2000.0,44,40,4
PL,TR,2018.0,3,5,-2
ID,CA,2021.0,40,60,-20
DE,RS,2003.0,14,15,-1
US,VE,2010.0,56,45,11
IE,DE,2021.0,71,68,3
TR,TH,2017.0,2,3,-1
IL,BR,2021.0,6,7,-1
GB,GH,2014.0,40,19,21
IE,CZ,2014.0,3,3,0
SG,SE,2018.0,24,22,2
KR,CA,2012.0,48,62,-14
CN,BE,2020.0,61,59,2
nan,DE,2022.0,40,34,6
NZ,DE,2010.0,30,34,-4
DK,GB,1997.0,35,31,4
FR,MA,2020.0,249,203,46
KR,SG,2015.0,37,35,2
CA,IL,2020.0,71,66,5
AT,NL,2022.0,13,26,-13
MA,AE,2013.0,2,1,1
DE,KE,2011.0,17,9,8
CO,PE,2015.0,62,96,-34
TR,FI,2007.0,5,4,1
NP,IN,2020.0,169,160,9
ID,TW,2019.0,58,60,-2
ZA,KE,2014.0,31,17,14
TR,GB,1997.0,15,27,-12
PA,CL,2020.0,7,6,1
CZ,PL,2012.0,37,33,4
NG,GH,2013.0,12,3,9
EG,AE,2006.0,6,13,-7
BR,CO,2008.0,55,53,2
MA,PK,2021.0,17,19,-2
ES,CU,2022.0,27,38,-11
US,HR,2015.0,53,29,24
DE,SG,2011.0,50,17,33
NZ,DE,2019.0,42,49,-7
FR,TH,2020.0,15,18,-3
PA,GB,2018.0,8,12,-4
FR,CM,2012.0,15,19,-4
TR,AG,2017.0,153,10,143
CA,TW,2009.0,30,36,-6
DE,TH,2016.0,25,7,18
ID,TW,2017.0,29,38,-9
US,LB,2021.0,43,95,-52
BE,HU,2010.0,7,8,-1
NL,SG,1999.0,3,3,0
PE,BO,2018.0,5,16,-11
TH,PK,2015.0,5,4,1
HR,FR,2004.0,2,7,-5
CZ,AT,2018.0,36,28,8
AU,IN,1997.0,12,31,-19
AT,US,2009.0,224,190,34
SK,GB,2016.0,15,11,4
VE,EC,2022.0,8,6,2
ID,EG,2021.0,25,40,-15
CN,BG,2021.0,5,5,0
MT,AU,2019.0,3,2,1
ES,RO,2012.0,16,10,6
FR,FI,2009.0,17,15,2
CO,AG,2020.0,21,8,13
QA,GB,2007.0,7,5,2
US,RS,2000.0,31,26,5
DK,GW,2015.0,3,3,0
HU,AT,2021.0,17,21,-4
NL,NO,2022.0,30,23,7
AU,KR,1998.0,6,6,0
NZ,FJ,2017.0,1,2,-1
GB,PA,2015.0,9,4,5
JP,ZA,2012.0,9,7,2
GH,US,2018.0,65,56,9
CA,DE,1998.0,95,97,-2
SA,TR,2010.0,11,7,4
CN,SD,2022.0,10,5,5
DE,EG,2019.0,74,54,20
NP,US,2018.0,84,81,3
TR,KZ,2021.0,48,31,17
DK,CH,2020.0,54,46,8
MG,US,2020.0,10,4,6
FI,GB,2007.0,46,41,5
IR,SE,2001.0,4,4,0
JP,RU,2014.0,52,38,14
SG,JP,2015.0,32,45,-13
RU,CH,2004.0,29,14,15
CH,PT,2016.0,17,24,-7
FR,TN,2022.0,55,73,-18
SE,JP,1998.0,27,29,-2
IR,AT,2019.0,20,10,10
IQ,AE,2019.0,14,14,0
EG,IE,2010.0,3,3,0
CA,CH,2022.0,76,61,15
PK,IN,2010.0,100,104,-4
CZ,CO,2020.0,2,4,-2
IN,FR,2022.0,70,74,-4
TH,ID,2018.0,27,16,11
AT,BR,2015.0,12,9,3
MX,PE,2022.0,58,48,10
BR,CH,2021.0,56,42,14
RS,IL,2019.0,1,2,-1
PK,MA,2012.0,23,13,10
ZA,IE,2018.0,9,10,-1
CZ,RU,1998.0,9,11,-2
GE,US,2022.0,93,38,55
ID,CN,2013.0,44,29,15
MY,EG,2008.0,5,9,-4
BE,AR,2019.0,14,11,3
MK,DE,2018.0,4,2,2
CR,US,2022.0,20,14,6
DE,JP,2016.0,217,214,3
nan,NO,2011.0,45,38,7
FR,BI,2002.0,14,4,10
NZ,UG,2016.0,6,4,2
CN,AU,2009.0,236,227,9
JP,GB,2017.0,278,314,-36
CH,NL,2010.0,76,88,-12
DE,NL,2002.0,194,169,25
CA,IR,2021.0,124,338,-214
FR,SE,2020.0,109,70,39
FR,NL,2001.0,127,96,31
SY,FR,2017.0,11,10,1
SK,PT,2009.0,1,2,-1
US,DK,2005.0,175,164,11
CN,LU,2009.0,6,2,4
UZ,CN,2022.0,8,10,-2
GB,CZ,2019.0,75,68,7
CA,PL,2017.0,43,27,16
CA,MA,2012.0,24,8,16
GB,LK,2015.0,31,23,8
EG,SD,2020.0,23,37,-14
RS,MX,2022.0,1,2,-1
IT,MY,2004.0,43,42,1
SI,UA,1999.0,1,2,-1
SE,KE,2012.0,8,5,3
NO,TR,2018.0,10,17,-7
SE,nan,2015.0,68,50,18
CA,PL,2019.0,35,40,-5
RU,EE,2013.0,12,6,6
PT,IT,2017.0,47,44,3
DE,NL,2005.0,216,182,34
BE,ZA,2000.0,4,3,1
CA,GE,2015.0,1,3,-2
DE,IR,2015.0,53,116,-63
LK,GB,2015.0,23,31,-8
TR,IE,2019.0,7,3,4
EG,IE,2019.0,10,10,0
JP,NG,2013.0,8,3,5
JP,GR,2011.0,47,42,5
TW,KR,2008.0,32,23,9
ZA,GH,2009.0,1,2,-1
SA,EG,1999.0,18,16,2
NZ,IN,2008.0,11,17,-6
JP,SK,2005.0,31,14,17
ZA,CH,2005.0,11,5,6
FI,DE,2013.0,69,62,7
GB,IT,2002.0,257,253,4
IN,CH,2001.0,9,10,-1
MY,TW,2001.0,2,1,1
IN,MX,2012.0,9,3,6
CA,TH,2003.0,11,5,6
IL,DE,2005.0,37,33,4
AU,SA,2008.0,8,7,1
RU,CA,2003.0,28,15,13
VE,US,1998.0,25,17,8
IE,ZA,2005.0,1,7,-6
DK,NL,2014.0,37,49,-12
EE,RU,2010.0,3,2,1
GB,JO,2018.0,35,24,11
BM,GB,2012.0,1,2,-1
BE,RU,2014.0,17,17,0
ZA,FR,2015.0,46,45,1
BR,VE,2010.0,14,22,-8
GT,CA,2017.0,1,1,0
SE,HU,1999.0,6,11,-5
CL,PE,2002.0,12,11,1
KW,TR,2007.0,2,7,-5
GH,AU,2013.0,4,3,1
PT,CN,2014.0,11,9,2
RS,NL,2013.0,5,5,0
US,FJ,2017.0,6,4,2
CM,BE,2017.0,4,4,0
GR,CA,2009.0,8,14,-6
CU,VE,2015.0,14,19,-5
US,IS,2001.0,19,12,7
SE,NO,2013.0,94,75,19
JP,BD,2009.0,64,40,24
UZ,TJ,2020.0,3,4,-1
BE,BD,2013.0,3,3,0
IR,AT,2017.0,22,9,13
IE,JP,1999.0,8,24,-16
nan,VN,2021.0,8,1,7
SK,HU,2013.0,6,7,-1
KR,FR,2006.0,28,24,4
PT,IT,2019.0,46,55,-9
BD,NZ,2018.0,7,1,6
AE,CA,2010.0,4,20,-16
nan,IN,1999.0,16,7,9
CY,US,2008.0,16,24,-8
DZ,nan,2016.0,4,14,-10
EG,CA,2013.0,35,53,-18
UA,NI,2022.0,7,10,-3
CU,ES,1999.0,30,31,-1
US,AO,2009.0,4,1,3
FI,SE,2010.0,92,92,0
JP,TW,2019.0,82,104,-22
FR,BI,2005.0,14,19,-5
SK,AT,2013.0,14,16,-2
HK,DE,2014.0,1,2,-1
GR,IT,2011.0,23,23,0
NZ,RU,2021.0,3,2,1
GB,FI,2004.0,38,38,0
LU,CN,2022.0,3,2,1
GB,KW,2012.0,14,5,9
LU,DE,2009.0,12,30,-18
NL,VN,2007.0,2,3,-1
US,IR,2000.0,18,13,5
IE,CN,2018.0,41,35,6
FR,NC,1997.0,1,3,-2
IT,CL,2012.0,16,19,-3
EE,GB,2022.0,6,6,0
IT,ID,2015.0,19,3,16
AE,BH,2020.0,4,5,-1
AT,GB,2022.0,65,82,-17
AE,IE,2016.0,3,5,-2
BD,JP,2022.0,35,35,0
EG,PK,2020.0,26,25,1
CN,GR,2008.0,16,17,-1
RS,HU,2020.0,7,13,-6
NP,GB,2015.0,11,9,2
IN,RU,2009.0,13,15,-2
NZ,MY,2008.0,8,4,4
ZA,IR,2016.0,4,9,-5
DK,AR,2009.0,3,1,2
AU,GH,2011.0,2,2,0
CA,AE,2011.0,19,4,15
BH,IE,2012.0,2,2,0
nan,TH,2016.0,3,3,0
TR,IQ,2018.0,18,5,13
ID,ZA,2015.0,9,12,-3
BG,GB,2006.0,9,5,4
CA,RS,2003.0,12,5,7
TH,DE,2009.0,14,12,2
VN,SG,2019.0,9,28,-19
GB,nan,1997.0,17,15,2
GB,EG,2022.0,74,81,-7
NL,QA,2017.0,6,6,0
BH,US,2020.0,11,17,-6
FR,QA,2015.0,20,10,10
GB,IL,2004.0,33,40,-7
MY,DZ,2021.0,3,4,-1
TH,NG,2016.0,3,3,0
CA,NP,2021.0,3,6,-3
SI,IN,2016.0,6,1,5
PT,CA,1999.0,6,2,4
IQ,ID,2020.0,18,5,13
EE,NL,2017.0,3,3,0
PY,AR,2013.0,1,2,-1
KW,CA,2006.0,7,6,1
SI,CZ,2018.0,9,6,3
DZ,BE,2018.0,3,9,-6
SI,ES,2009.0,5,7,-2
NE,NG,2019.0,5,2,3
CL,CR,2012.0,10,17,-7
PL,SE,2004.0,18,11,7
FR,TR,2022.0,12,14,-2
SA,DE,2015.0,29,25,4
BG,DE,2008.0,36,19,17
PL,IT,2001.0,10,10,0
TH,US,2010.0,106,183,-77
JP,TR,2022.0,39,42,-3
FR,CI,2014.0,31,10,21
RU,DK,2006.0,10,4,6
JP,DK,2018.0,16,16,0
UY,FR,2015.0,1,8,-7
PL,CH,2014.0,37,26,11
BD,IL,2013.0,4,2,2
GM,US,2019.0,2,3,-1
AE,CA,2019.0,28,35,-7
AT,SE,2016.0,48,27,21
JO,AE,2012.0,11,7,4
VG,CN,2015.0,1,1,0
TW,RU,2007.0,14,15,-1
IR,IE,2019.0,21,12,9
BG,ES,2021.0,2,3,-1
SK,RS,2004.0,14,5,9
BH,GH,2020.0,25,21,4
BR,AT,2018.0,15,24,-9
IL,DE,2002.0,44,28,16
NL,NG,2013.0,3,12,-9
AT,EE,2019.0,8,5,3
BR,CN,2019.0,41,59,-18
RU,ES,2022.0,21,9,12
RO,IT,2016.0,22,18,4
SE,ES,2008.0,46,36,10
IS,GB,2021.0,4,6,-2
NO,JP,2023.0,2,1,1
UA,MD,2013.0,1,1,0
MX,IT,2005.0,20,20,0
TR,BR,2004.0,6,17,-11
IT,LT,2014.0,4,2,2
IT,nan,1998.0,68,36,32
NL,SE,2009.0,32,28,4
LT,CN,2010.0,1,17,-16
HN,MX,2005.0,11,14,-3
CN,MN,2012.0,2,2,0
GB,ZM,2016.0,8,8,0
CZ,RU,1997.0,5,9,-4
FR,JO,2006.0,6,3,3
NO,nan,2012.0,24,45,-21
RS,IL,2010.0,3,10,-7
CH,PL,2012.0,23,28,-5
SK,CH,2019.0,14,7,7
CZ,SK,2008.0,48,67,-19
NZ,CH,2003.0,5,7,-2
TR,RO,2011.0,2,1,1
NO,CH,2009.0,17,21,-4
AT,DK,2008.0,9,5,4
NL,BR,2003.0,21,19,2
AU,PE,2022.0,1,3,-2
SE,JP,1997.0,13,15,-2
DE,BA,2019.0,3,9,-6
PK,BD,2010.0,27,10,17
DE,VE,2001.0,1,3,-2
AU,MX,2015.0,23,20,3
RU,KZ,2013.0,31,16,15
FR,MZ,2004.0,2,1,1
DE,AU,1997.0,45,39,6
IN,KW,2005.0,6,7,-1
DK,IT,2004.0,11,14,-3
GM,NG,2017.0,2,2,0
TN,MA,2005.0,8,6,2
GR,UA,2021.0,1,2,-1
JP,CZ,2018.0,22,19,3
PL,BD,2012.0,2,2,0
UA,SK,2014.0,6,7,-1
US,GH,2013.0,36,16,20
RO,DK,2019.0,3,3,0
BE,ES,2001.0,15,12,3
MY,RU,2015.0,18,10,8
NP,DE,2010.0,1,4,-3
TR,SE,2008.0,5,1,4
GR,NO,2016.0,11,6,5
ES,JP,2022.0,17,18,-1
HN,MX,2002.0,16,8,8
CA,KW,2020.0,20,12,8
JO,LB,2022.0,2,1,1
QA,IN,2011.0,6,8,-2
JP,TH,2009.0,74,32,42
GB,SK,1999.0,11,31,-20
UA,SE,2018.0,15,8,7
PE,MX,2000.0,8,9,-1
NO,SJ,2019.0,7,11,-4
nan,MX,2004.0,14,15,-1
AU,BR,2003.0,23,16,7
IS,HU,2016.0,1,2,-1
CA,GR,2005.0,15,14,1
TR,SA,2014.0,10,17,-7
JP,PH,2001.0,12,9,3
IE,BR,2011.0,4,8,-4
PT,VE,2015.0,2,4,-2
CL,IN,2021.0,5,6,-1
IN,BD,2006.0,28,7,21
RU,BE,2006.0,19,14,5
CL,PE,2005.0,17,17,0
CA,GR,2002.0,10,5,5
FR,CL,2022.0,13,24,-11
MU,US,2016.0,2,1,1
IT,NG,2016.0,4,12,-8
PT,PY,2004.0,3,3,0
SG,BE,2005.0,2,1,1
PK,KR,2002.0,4,7,-3
CL,VE,2013.0,19,24,-5
MK,AU,2009.0,20,28,-8
AR,GB,2013.0,26,29,-3
GB,HK,2015.0,8,7,1
NZ,JP,1997.0,11,6,5
US,SD,2015.0,11,12,-1
MX,AT,2008.0,4,1,3
IE,IT,2003.0,6,11,-5
IE,ES,2012.0,28,26,2
GE,IN,2012.0,5,3,2
PK,ES,2011.0,1,4,-3
PY,CU,2021.0,6,2,4
DK,PL,2009.0,9,15,-6
NO,CA,2018.0,22,34,-12
VN,SG,2017.0,7,13,-6
CA,AR,2001.0,7,5,2
TN,CN,2014.0,3,1,2
GB,CO,2006.0,16,11,5
IT,MX,2007.0,21,29,-8
ID,IT,2018.0,4,32,-28
HU,IN,2003.0,3,7,-4
AE,TN,2013.0,3,4,-1
AE,AU,2013.0,7,14,-7
CM,BE,2010.0,3,4,-1
JP,AR,1999.0,4,1,3
UG,TZ,2015.0,5,2,3
PL,DK,2006.0,5,6,-1
MX,AU,2006.0,10,4,6
DE,LB,2017.0,8,11,-3
TW,CZ,2007.0,3,1,2
CH,NG,2019.0,5,4,1
HK,US,2015.0,12,9,3
CN,AO,2015.0,5,1,4
GT,US,2007.0,6,3,3
PK,KR,2005.0,1,2,-1
AT,RO,2011.0,6,8,-2
AT,AU,2021.0,16,26,-10
CM,CI,2015.0,1,3,-2
NG,NZ,2019.0,7,6,1
GH,ZA,2020.0,19,27,-8
SG,SA,2016.0,7,6,1
KZ,GB,2016.0,7,17,-10
CN,HU,2017.0,6,6,0
CN,SY,2022.0,16,10,6
AT,KR,2011.0,5,3,2
AT,IL,1999.0,3,2,1
PK,GR,2012.0,1,2,-1
nan,NZ,2002.0,2,8,-6
EE,RU,2019.0,9,13,-4
TZ,JP,2002.0,1,3,-2
AT,EE,2017.0,8,7,1
FR,LB,2000.0,18,3,15
CH,NG,2017.0,1,3,-2
CO,FI,2020.0,3,2,1
UA,GB,2011.0,14,10,4
BE,SE,2013.0,36,24,12
RO,ZA,2014.0,4,3,1
RO,TN,2019.0,2,1,1
CN,BY,2016.0,6,1,5
GB,KZ,2011.0,2,1,1
TZ,IN,2013.0,2,1,1
PY,BR,2010.0,6,6,0
CL,CN,2011.0,3,2,1
BE,AR,2010.0,5,6,-1
IT,DK,2009.0,25,23,2
JP,PL,2004.0,12,19,-7
UG,BE,2020.0,14,6,8
BE,DK,2009.0,18,10,8
NG,SA,2015.0,10,12,-2
SA,IN,2000.0,6,3,3
HR,GB,2022.0,4,11,-7
ZA,CH,2002.0,7,6,1
CU,BE,2018.0,2,4,-2
GF,FR,2015.0,13,10,3
EG,BD,2020.0,11,11,0
FI,IN,2018.0,17,22,-5
AU,SK,2016.0,5,1,4
UY,US,2016.0,26,23,3
CN,AE,2016.0,10,5,5
SK,HR,2011.0,3,2,1
CN,ES,1998.0,16,9,7
MY,FR,2010.0,4,13,-9
BH,NG,2008.0,6,2,4
PK,FR,2012.0,10,23,-13
CH,TN,2012.0,8,4,4
NL,CL,2011.0,3,8,-5
CA,CZ,2007.0,13,13,0
CR,CL,2010.0,15,10,5
JM,CA,2020.0,5,4,1
BE,AR,2017.0,7,11,-4
GB,CZ,2010.0,36,45,-9
LU,GB,2009.0,3,5,-2
SI,AT,2010.0,8,8,0
CL,IT,2018.0,29,39,-10
PK,IE,2011.0,7,3,4
UZ,PL,2013.0,1,2,-1
FI,RU,2004.0,24,17,7
MZ,RU,2002.0,5,2,3
SD,SA,2003.0,2,1,1
CZ,KR,2019.0,10,10,0
BE,FI,2012.0,6,18,-12
RU,CZ,2009.0,33,22,11
DK,GB,1998.0,44,49,-5
IE,BG,2020.0,1,1,0
AR,CU,2006.0,12,18,-6
QA,DZ,2013.0,1,1,0
DE,TW,2013.0,21,30,-9
EE,RU,2017.0,14,8,6
FR,GN,2022.0,6,3,3
HU,CN,2002.0,4,2,2
ID,JP,1998.0,5,11,-6
CZ,CN,1997.0,4,2,2
NG,IT,2020.0,13,3,10
DK,SG,2018.0,3,5,-2
PL,MX,2016.0,7,13,-6
IT,TN,2013.0,11,14,-3
UA,IL,2015.0,7,4,3
GB,IS,2008.0,10,11,-1
FI,DK,2018.0,32,15,17
CA,BH,2008.0,2,1,1
KR,TR,2009.0,4,4,0
TR,IE,2010.0,1,2,-1
HU,GR,2006.0,4,4,0
SG,TR,2020.0,4,17,-13
BR,IL,2015.0,10,9,1
DK,PK,2003.0,1,2,-1
NL,IE,2007.0,14,12,2
MY,OM,2015.0,12,4,8
CZ,KR,2017.0,11,10,1
FR,PH,2015.0,4,6,-2
DE,GE,2016.0,4,7,-3
GB,MT,2010.0,14,6,8
PH,DE,2012.0,9,11,-2
FR,BF,2007.0,12,10,2
HU,GB,2013.0,50,52,-2
GB,RE,2008.0,1,1,0
CA,PL,2010.0,22,27,-5
CA,RU,2007.0,20,21,-1
MY,NZ,2011.0,6,15,-9
CA,AT,2003.0,12,11,1
BY,DE,1999.0,8,5,3
nan,NZ,2005.0,5,16,-11
PH,NP,2010.0,2,1,1
FI,SG,2009.0,2,2,0
BE,PY,2013.0,1,1,0
US,OM,1998.0,4,3,1
CH,SG,2009.0,6,6,0
IE,FI,2013.0,6,3,3
AT,PL,2009.0,13,18,-5
SA,SE,2008.0,3,2,1
IN,CZ,2012.0,27,15,12
EG,TN,2011.0,6,6,0
CZ,NO,2004.0,9,2,7
MX,KR,2014.0,4,5,-1
TZ,DE,1998.0,4,2,2
IQ,YE,2018.0,2,2,0
TN,GB,2012.0,4,5,-1
SE,AE,2005.0,2,1,1
SN,GN,2018.0,4,2,2
JM,IN,2011.0,1,1,0
IN,PA,2015.0,4,2,2
DE,LB,2019.0,6,7,-1
AT,EE,2010.0,2,2,0
TG,ML,2014.0,2,1,1
IT,NO,2009.0,14,8,6
NO,CZ,2001.0,5,3,2
IE,BD,2015.0,2,3,-1
MX,PH,2007.0,3,2,1
AZ,GE,2013.0,7,3,4
FR,CO,2007.0,23,10,13
KR,SA,2018.0,22,12,10
RW,TR,2014.0,1,1,0
GT,ES,2006.0,4,3,1
IE,BA,2014.0,2,1,1
KE,CH,2022.0,2,1,1
DK,BR,2003.0,5,4,1
UG,ZA,2020.0,13,17,-4
BW,SE,2020.0,2,1,1
SE,VN,2020.0,5,3,2
LT,CN,2019.0,5,9,-4
MA,IT,2020.0,18,43,-25
NZ,DK,2004.0,3,3,0
IL,GR,2004.0,3,1,2
NO,SJ,2017.0,10,6,4
UA,FI,2007.0,2,3,-1
BE,TW,2014.0,5,5,0
IE,EG,2013.0,5,3,2
CR,BO,2020.0,1,1,0
ES,IE,2003.0,9,10,-1
CO,EC,2008.0,6,11,-5
JP,AT,2016.0,14,28,-14
SN,US,2013.0,6,5,1
NL,IS,2011.0,1,2,-1
SG,NZ,2009.0,6,9,-3
KW,NG,2011.0,1,1,0
JP,RO,2010.0,6,3,3
FI,HU,2006.0,7,3,4
CH,RS,2019.0,10,12,-2
GR,FI,2013.0,7,4,3
US,UZ,2002.0,2,2,0
KR,ID,2012.0,17,5,12
KZ,FR,2007.0,3,1,2
TW,VN,2006.0,3,1,2
NG,IN,2014.0,12,15,-3
GP,FR,2009.0,7,18,-11
US,MZ,2014.0,2,5,-3
BG,CZ,2004.0,1,2,-1
DO,ES,2006.0,3,1,2
HU,CN,2005.0,6,5,1
AU,KW,2022.0,3,2,1
IT,NZ,2021.0,6,10,-4
HU,nan,2020.0,3,2,1
GM,US,2017.0,1,6,-5
RO,ID,2009.0,3,1,2
NI,RU,2021.0,3,2,1
IS,NO,2000.0,4,1,3
PK,IR,2016.0,13,10,3
KE,CG,2019.0,1,1,0
GB,TN,2021.0,3,3,0
HU,IL,2021.0,2,2,0
IQ,JO,2016.0,15,10,5
SE,TZ,2013.0,3,1,2
IT,nan,1997.0,33,37,-4
OM,MY,2013.0,6,6,0
GB,UG,2005.0,6,8,-2
FR,NZ,2016.0,14,13,1
TT,JM,2013.0,19,24,-5
IT,UY,2008.0,5,8,-3
IR,IE,2017.0,10,6,4
PL,EG,2008.0,7,3,4
IN,KW,2002.0,1,6,-5
ER,ET,2007.0,1,1,0
DE,VN,2012.0,13,5,8
IL,LB,2006.0,1,1,0
IL,IT,2006.0,6,10,-4
TN,IR,2011.0,5,4,1
TW,ES,2016.0,4,5,-1
CN,SI,2014.0,6,2,4
MN,IN,2010.0,1,1,0
CN,MM,2019.0,6,5,1
AL,IT,2013.0,1,1,0
TN,IT,2002.0,2,1,1
BI,FR,2013.0,20,17,3
DO,AR,2019.0,2,2,0
SI,CN,2014.0,2,6,-4
GB,TT,2021.0,4,3,1
AE,KR,2018.0,5,12,-7
IQ,LY,2020.0,5,2,3
CA,IS,2001.0,5,1,4
EG,HU,2007.0,2,5,-3
CZ,nan,2015.0,7,7,0
ML,US,2001.0,3,2,1
LU,BR,2020.0,3,5,-2
UG,GB,2016.0,18,13,5
CM,SN,2014.0,3,3,0
DZ,SA,2013.0,5,5,0
SA,TR,2019.0,19,13,6
nan,FI,2016.0,7,15,-8
IQ,AE,2010.0,3,2,1
DE,CI,2006.0,2,1,1
IT,PE,2003.0,3,4,-1
GB,BB,2015.0,4,8,-4
SA,TR,2017.0,14,20,-6
IE,TR,2014.0,2,4,-2
US,KE,2001.0,16,27,-11
MY,FR,2017.0,6,15,-9
SG,TH,2012.0,7,8,-1
PL,NO,2022.0,11,7,4
MX,LU,2020.0,1,2,-1
LV,GB,2006.0,1,2,-1
UZ,FR,2011.0,1,1,0
TR,CH,2000.0,7,1,6
IN,RO,2021.0,4,3,1
GR,VN,2002.0,4,5,-1
SE,GR,2011.0,6,24,-18
CH,DZ,2009.0,3,1,2
SE,SI,2018.0,4,2,2
JP,FI,2008.0,15,14,1
NZ,SE,2002.0,4,5,-1
AE,OM,2009.0,3,2,1
ME,RS,2014.0,19,11,8
NO,BG,2000.0,7,2,5
HR,SE,2012.0,1,2,-1
CY,CH,2015.0,2,1,1
CZ,PT,2009.0,4,2,2
FI,AT,1999.0,1,2,-1
RU,BG,1997.0,4,3,1
PS,DE,2000.0,1,2,-1
PK,CH,1997.0,5,4,1
DK,NZ,1999.0,2,3,-1
PT,AO,2013.0,3,3,0
MT,GB,2008.0,6,8,-2
CO,PH,2018.0,8,8,0
CO,CL,1998.0,6,12,-6
PK,JP,2011.0,6,14,-8
MK,FR,2016.0,3,2,1
VE,US,1997.0,21,21,0
EG,IE,2017.0,5,4,1
BE,MA,1998.0,5,1,4
MX,IT,2002.0,11,20,-9
GR,BG,2006.0,2,2,0
NP,NZ,2008.0,5,7,-2
SA,TW,2022.0,3,6,-3
SE,ZA,1998.0,1,2,-1
EG,KR,2011.0,6,6,0
GB,EE,2021.0,10,8,2
BF,CI,1999.0,1,1,0
PE,GB,2000.0,1,3,-2
VN,GB,2014.0,13,15,-2
GB,UA,1999.0,7,7,0
MY,DE,2003.0,2,4,-2
IN,TH,2006.0,4,5,-1
US,HN,2006.0,2,3,-1
NZ,SE,2005.0,6,10,-4
NL,MX,2004.0,5,4,1
SA,CN,2009.0,3,6,-3
IT,IE,2003.0,11,6,5
KE,IN,2009.0,3,5,-2
KN,US,2017.0,7,3,4
CZ,DK,1999.0,3,2,1
DK,CZ,2018.0,4,6,-2
NZ,FJ,2019.0,4,1,3
HU,RU,2013.0,7,8,-1
AR,IN,2012.0,1,2,-1
UA,GR,2021.0,2,1,1
UG,IT,2005.0,2,1,1
CN,MM,2017.0,4,1,3
QA,TR,2021.0,7,9,-2
TR,PT,2006.0,3,4,-1
UA,EE,2019.0,3,5,-2
CH,CM,2011.0,4,1,3
TH,UG,2018.0,1,1,0
NZ,BR,2005.0,1,4,-3
FR,FJ,2019.0,1,2,-1
PE,CH,2022.0,2,2,0
ET,CH,2019.0,6,2,4
KG,KZ,2020.0,5,8,-3
LU,IN,2020.0,3,3,0
CY,GR,2000.0,2,6,-4
CM,US,2005.0,6,5,1
IL,IS,2013.0,2,1,1
US,MG,2012.0,4,1,3
TN,AE,2019.0,9,3,6
SG,DK,2012.0,4,5,-1
MA,DZ,2002.0,1,1,0
BR,PY,2021.0,9,14,-5
AU,PA,2014.0,2,1,1
US,SY,2009.0,7,6,1
IT,IN,2001.0,25,23,2
IE,MX,2008.0,4,5,-1
EG,AU,2012.0,10,9,1
GR,IN,2020.0,3,6,-3
TG,BJ,2018.0,2,2,0
LT,US,2009.0,9,13,-4
CU,AR,1998.0,1,3,-2
DE,BA,2010.0,1,2,-1
SD,GB,2020.0,8,7,1
SE,UA,2012.0,4,9,-5
ZA,SZ,2022.0,6,2,4
NO,NL,1999.0,6,11,-5
BE,HU,2019.0,10,9,1
UG,NG,2012.0,3,1,2
ID,JP,1997.0,2,2,0
EE,NL,2019.0,2,5,-3
PK,AT,2004.0,2,2,0
NG,BW,2006.0,2,2,0
IE,MY,2019.0,6,14,-8
BO,CR,2013.0,2,1,1
nan,VE,2017.0,4,1,3
BF,DE,2014.0,2,2,0
NO,SJ,2010.0,6,5,1
BE,CM,2015.0,8,1,7
FR,UY,2015.0,8,1,7
AO,PT,2016.0,4,4,0
PK,PH,2015.0,1,2,-1
TH,SE,2016.0,4,6,-2
DO,MX,2022.0,2,1,1
UY,AR,2004.0,7,11,-4
CA,GH,2006.0,4,3,1
TN,IT,2005.0,4,1,3
JP,RO,2019.0,6,5,1
BE,HU,2017.0,8,13,-5
FR,LV,2018.0,3,1,2
MX,IL,2015.0,5,4,1
SI,JP,2020.0,4,3,1
GM,US,2010.0,2,1,1
JM,BB,2005.0,2,3,-1
FI,NZ,2003.0,2,2,0
HU,DK,2020.0,6,6,0
PK,PT,2018.0,1,1,0
RO,UA,2016.0,3,5,-2
PE,PY,2019.0,2,3,-1
CY,GB,2002.0,3,6,-3
GY,US,2020.0,3,3,0
CL,DO,2016.0,1,4,-3
MX,EC,2009.0,8,10,-2
QA,ES,2014.0,5,6,-1
PH,NL,2013.0,4,5,-1
IN,PT,2001.0,2,1,1
SD,EG,2006.0,4,4,0
BE,AT,1999.0,5,2,3
TW,PK,2006.0,3,2,1
SK,NL,2012.0,5,9,-4
DE,FJ,2017.0,1,1,0
AU,PK,2007.0,8,7,1
AE,NZ,2011.0,3,2,1
IN,GH,2022.0,10,3,7
SE,PE,2007.0,2,1,1
PH,PL,2008.0,2,1,1
US,FJ,2019.0,4,6,-2
BA,FR,2015.0,2,2,0
GR,SE,2001.0,2,9,-7
DK,PT,2012.0,3,6,-3
PL,RO,2004.0,1,5,-4
TH,nan,2012.0,1,3,-2
CH,BI,2010.0,1,1,0
SE,EE,2009.0,14,2,12
BR,SD,2007.0,5,6,-1
ES,MD,2007.0,2,1,1
CH,VE,2009.0,2,1,1
CH,CI,2005.0,3,1,2
ES,CR,1998.0,5,4,1
CU,CH,2009.0,2,2,0
ZA,KR,2018.0,8,2,6
RO,DK,2017.0,5,2,3
CW,US,2020.0,2,2,0
AU,KR,1997.0,6,6,0
CZ,PK,2021.0,5,3,2
MX,TR,2016.0,1,2,-1
NL,AE,2008.0,1,1,0
CL,ID,2014.0,5,3,2
CG,NG,2019.0,2,7,-5
EE,UA,2018.0,3,2,1
RU,SG,2005.0,2,1,1
PT,CO,2012.0,5,6,-1
VE,PH,2018.0,1,1,0
CR,EC,2022.0,7,5,2
MY,ZA,2011.0,3,5,-2
BR,ZM,2013.0,3,5,-2
BF,TG,2013.0,2,1,1
NZ,BR,2002.0,3,2,1
AE,BR,2019.0,2,5,-3
ID,DE,2004.0,3,6,-3
NG,CA,1997.0,1,2,-1
CR,PA,2019.0,4,1,3
ZA,MZ,2016.0,1,1,0
UZ,US,2005.0,3,1,2
ES,VN,2014.0,3,2,1
RU,CL,2015.0,2,1,1
NP,MY,2021.0,4,4,0
IN,BE,2007.0,6,5,1
KN,US,2019.0,5,5,0
ET,CN,2011.0,4,2,2
TN,MA,2002.0,1,5,-4
GM,NG,2019.0,2,1,1
IT,AL,2011.0,2,1,1
SI,RS,2022.0,7,15,-8
LK,GR,2011.0,4,2,2
NO,TZ,2007.0,6,3,3
UZ,IT,2002.0,1,2,-1
ES,EG,2022.0,7,4,3
ET,CH,2017.0,6,6,0
nan,IL,2023.0,1,1,0
VN,IT,2004.0,3,1,2
PT,DE,2023.0,3,1,2
US,EE,2003.0,6,9,-3
RO,GR,2009.0,1,3,-2
AU,PL,1999.0,6,8,-2
DE,BD,2006.0,4,2,2
UA,CH,2000.0,3,3,0
ZM,MW,2015.0,1,1,0
SI,NL,2022.0,5,2,3
ZA,LB,2018.0,1,1,0
SI,IT,2003.0,5,3,2
AR,NI,2012.0,1,1,0
VN,EG,2008.0,2,1,1
GR,LK,2009.0,7,3,4
CV,US,2021.0,1,1,0
CN,GN,2018.0,3,2,1
EG,IT,2001.0,1,2,-1
MG,GB,2022.0,2,1,1
BW,TR,2018.0,1,1,0
AE,IS,2013.0,1,1,0
HK,GB,2021.0,3,6,-3
TH,UA,2021.0,1,1,0
PT,DK,2000.0,1,4,-3
IL,SK,2009.0,2,1,1
LT,CZ,2005.0,4,3,1
SN,DE,2015.0,1,2,-1
PL,ZA,2011.0,4,3,1
GB,LB,2003.0,2,1,1
KW,LB,2004.0,1,1,0
LT,NO,2003.0,2,2,0
HR,SK,2016.0,7,2,5
IL,AT,2009.0,7,6,1
PY,BR,2017.0,5,15,-10
CH,GR,2023.0,2,2,0
LU,CH,2018.0,7,6,1
CA,LK,1998.0,1,1,0
KW,QA,2020.0,4,7,-3
nan,VE,2019.0,2,5,-3
CN,CO,2014.0,2,6,-4
US,MM,2015.0,7,9,-2
DK,IQ,2016.0,2,1,1
nan,CO,2021.0,4,6,-2
ES,EC,2000.0,1,2,-1
NG,NO,2021.0,4,2,2
HR,CA,2014.0,5,5,0
VE,CL,2003.0,7,5,2
NL,LA,2015.0,1,1,0
DE,LB,2010.0,4,1,3
BR,ZA,2021.0,11,6,5
SK,BE,2005.0,3,5,-2
US,SN,2003.0,5,4,1
ZW,US,2009.0,8,6,2
BO,BR,2022.0,5,3,2
AU,BD,2007.0,7,4,3
FO,US,2008.0,1,1,0
ID,TW,2010.0,3,2,1
IR,AR,2019.0,1,1,0
GR,VN,2005.0,2,2,0
FI,RO,2008.0,2,1,1
CZ,FI,1999.0,2,1,1
JO,IL,2020.0,2,3,-1
IE,MY,2010.0,5,3,2
MZ,RU,2005.0,3,4,-1
US,UZ,2005.0,1,3,-2
PA,SE,2015.0,3,1,2
AR,PA,2018.0,4,8,-4
CZ,ES,1998.0,2,6,-4
CO,AM,2011.0,1,1,0
CL,ZA,2009.0,1,3,-2
AU,JM,2015.0,1,3,-2
CH,ZA,2002.0,6,7,-1
NO,PK,2011.0,4,3,1
PH,NP,2017.0,4,4,0
CN,GH,2008.0,1,1,0
SI,BG,2014.0,1,1,0
NG,CN,2013.0,5,6,-1
ES,CR,1997.0,3,6,-3
JO,nan,2020.0,3,7,-4
UG,RW,2021.0,4,4,0
CG,SN,2001.0,1,1,0
SE,BD,2016.0,3,4,-1
CU,PA,2004.0,1,1,0
NZ,BG,2006.0,1,1,0
TN,AE,2017.0,4,1,3
NZ,NG,2021.0,1,8,-7
BJ,IT,2017.0,1,1,0
US,LV,1998.0,2,9,-7
LV,US,2000.0,5,1,4
CN,ID,1997.0,1,2,-1
LB,PS,2022.0,2,1,1
MY,KE,2019.0,3,3,0
ML,IN,2008.0,4,3,1
KH,GB,2016.0,2,7,-5
HU,LB,2019.0,1,1,0
TN,IL,2020.0,1,1,0
IQ,GB,2006.0,1,1,0
EC,DE,2006.0,1,1,0
SG,AT,2002.0,2,1,1
BZ,FR,1999.0,3,2,1
TR,IE,2017.0,7,6,1
IT,PH,2014.0,4,2,2
nan,DZ,2012.0,5,3,2
EE,CN,2014.0,3,3,0
IL,HU,2003.0,3,3,0
AE,GR,2021.0,7,3,4
OM,ZA,2014.0,2,1,1
IT,BD,2022.0,1,3,-2
DO,IT,2018.0,1,11,-10
AE,FI,2021.0,1,2,-1
GB,SL,2015.0,1,1,0
nan,CL,2013.0,5,8,-3
CO,SV,2015.0,5,2,3
MX,ID,2012.0,2,1,1
DE,CM,2021.0,3,7,-4
BY,PT,2004.0,2,1,1
BN,MY,2009.0,1,2,-1
MW,ZM,2016.0,1,2,-1
RS,SE,2021.0,3,5,-2
CN,HU,2019.0,5,8,-3
DO,AR,2017.0,2,5,-3
CN,PT,2001.0,2,11,-9
SN,CA,2006.0,1,1,0
IT,FI,1997.0,1,2,-1
NL,IL,2008.0,7,14,-7
UZ,US,2002.0,2,2,0
BE,NP,2020.0,1,2,-1
PK,CH,1998.0,2,6,-4
BH,MY,2019.0,1,7,-6
nan,BD,2021.0,4,1,3
CO,JP,2000.0,5,4,1
BE,SG,1998.0,2,1,1
SZ,ZA,2007.0,1,2,-1
MY,KE,2017.0,2,1,1
BR,PK,2002.0,2,1,1
BY,GB,2015.0,1,3,-2
IE,RS,2002.0,1,1,0
DE,SD,2003.0,1,1,0
RU,MZ,2015.0,7,19,-12
SE,TR,2008.0,1,5,-4
DK,AT,2007.0,3,6,-3
US,FJ,2010.0,5,8,-3
IL,AR,2021.0,2,4,-2
CH,LI,2022.0,1,3,-2
PR,ES,2016.0,1,1,0
PE,PY,2017.0,4,2,2
BD,OM,2022.0,3,3,0
PH,DK,2019.0,3,2,1
FI,AR,2015.0,1,2,-1
MY,AT,2003.0,1,1,0
TR,RW,2016.0,2,1,1
UG,CN,2012.0,2,1,1
PS,US,2003.0,2,2,0
SE,BG,2020.0,3,4,-1
LT,CZ,2002.0,4,1,3
SI,CO,2019.0,1,1,0
TN,PG,2011.0,2,1,1
MX,IE,2011.0,3,3,0
EE,NL,2010.0,1,3,-2
CL,CA,2001.0,3,7,-4
CU,PT,2022.0,2,1,1
CU,IT,2009.0,3,3,0
SY,FR,2019.0,3,11,-8
CH,CO,2006.0,2,2,0
JP,KZ,2020.0,3,4,-1
ME,HR,2016.0,1,6,-5
NL,BJ,2008.0,1,1,0
GB,BM,2016.0,2,1,1
SA,SG,2015.0,1,11,-10
SV,MX,2000.0,1,2,-1
KW,GR,2021.0,3,7,-4
JO,QA,2014.0,5,4,1
MC,FR,2017.0,4,9,-5
GA,FR,2022.0,2,1,1
KE,EG,2012.0,1,1,0
GB,QA,1997.0,1,1,0
BD,TR,2020.0,1,3,-2
BH,MY,2017.0,4,5,-1
KN,GB,2020.0,3,1,2
CR,NI,2016.0,1,2,-1
BH,CA,2017.0,1,2,-1
GH,IT,2018.0,2,3,-1
FR,SK,2020.0,3,7,-4
EC,GT,2022.0,1,1,0
DZ,ID,2022.0,3,2,1
US,GF,2015.0,1,1,0
RU,SK,2001.0,9,5,4
RS,SK,1999.0,2,3,-1
JP,KE,2022.0,6,2,4
FI,IS,2015.0,5,2,3
BY,CZ,2022.0,5,10,-5
GB,KE,1997.0,4,7,-3
BN,LK,2011.0,1,1,0
UY,IT,2004.0,1,4,-3
DZ,JP,2016.0,2,2,0
GH,JP,2007.0,3,2,1
HU,LT,1998.0,1,1,0
JO,DE,2007.0,3,10,-7
IE,AT,2003.0,3,3,0
NL,ZW,2004.0,3,4,-1
TR,BG,2017.0,3,2,1
SA,LB,2021.0,2,8,-6
KR,HU,2014.0,1,3,-2
SA,NZ,2017.0,5,5,0
CN,PR,2012.0,1,2,-1
AU,BB,2006.0,2,2,0
IN,GE,2021.0,3,1,2
IN,EC,2018.0,1,1,0
CL,AU,2001.0,1,1,0
PH,ET,2022.0,1,1,0
CN,MK,2018.0,3,3,0
GR,IE,2001.0,1,1,0
CZ,CN,1998.0,2,1,1
PK,AF,2016.0,1,3,-2
KR,CZ,2007.0,4,3,1
FR,PS,2016.0,4,1,3
VG,CA,2014.0,3,2,1
EG,SY,2002.0,2,1,1
GR,BR,2018.0,3,4,-1
NL,QA,2019.0,5,4,1
NG,GR,2009.0,1,1,0
VN,nan,2009.0,1,2,-1
nan,MY,2002.0,1,11,-10
CR,nan,2006.0,2,1,1
KN,BR,2021.0,1,1,0
GB,HN,2012.0,1,1,0
nan,ID,2005.0,1,1,0
SG,FI,2013.0,1,2,-1
GR,CZ,2006.0,1,2,-1
PL,AT,1999.0,4,7,-3
KZ,NL,2018.0,1,4,-3
NE,ZA,2021.0,1,1,0
CY,GB,2005.0,1,10,-9
CG,CM,2020.0,2,1,1
PL,LB,2021.0,1,1,0
CN,NE,2019.0,1,1,0
JP,IQ,2013.0,3,4,-1
AU,MM,2005.0,1,1,0
BG,MX,2003.0,1,2,-1
NO,QA,2018.0,3,1,2
NZ,CN,2020.0,69,60,9
DK,DE,2012.0,125,140,-15
PH,NP,2019.0,8,2,6
AU,CA,2001.0,162,158,4
ES,HN,2020.0,11,5,6
GB,HU,2001.0,26,22,4
GB,NZ,2016.0,286,227,59
TR,AG,2019.0,301,118,183
IT,DE,2016.0,391,277,114
DE,EG,2017.0,59,53,6
US,RU,2020.0,583,551,32
CA,FR,2020.0,584,582,2
GB,IT,2005.0,249,266,-17
MY,SA,2012.0,24,16,8
GR,CY,2022.0,39,29,10
CY,TR,2015.0,28,54,-26
CL,AR,2020.0,122,107,15
CR,VE,2013.0,3,6,-3
FR,LU,2016.0,45,40,5
ES,DK,2000.0,16,16,0
TW,GB,2017.0,58,54,4
JP,RO,2017.0,7,1,6
DE,MY,2009.0,6,6,0
MX,nan,2012.0,23,27,-4
ES,AU,2014.0,75,43,32
DE,FR,2000.0,253,269,-16
RU,nan,2006.0,45,32,13
NL,CA,2007.0,66,65,1
SG,NL,2018.0,18,23,-5
IL,JP,2007.0,8,12,-4
CU,EC,2016.0,55,9,46
NO,DE,2020.0,77,108,-31
CU,US,2021.0,69,46,23
BR,RO,2016.0,6,4,2
ID,MM,2019.0,3,2,1
PE,ES,2003.0,25,24,1
FI,EE,2012.0,17,10,7
TH,AU,2016.0,29,34,-5
UA,nan,2011.0,15,25,-10
NZ,JP,1998.0,13,7,6
RU,LV,2009.0,19,8,11
CA,DK,2020.0,56,47,9
IN,SA,2004.0,11,20,-9
CR,CL,2017.0,29,43,-14
TW,IN,2020.0,48,77,-29
BR,CN,2017.0,50,60,-10
BR,GB,2003.0,63,52,11
OM,KR,2021.0,2,1,1
NZ,DE,2017.0,50,54,-4
HU,BE,2015.0,9,3,6
ID,AU,2009.0,12,29,-17
IR,BR,2019.0,16,17,-1
US,OM,1997.0,2,2,0
DE,FI,2015.0,91,73,18
NC,FR,2008.0,17,12,5
SI,DE,2000.0,7,3,4
SV,ES,2020.0,9,2,7
ET,US,2020.0,50,78,-28
SA,NL,2018.0,10,14,-4
AT,IR,2021.0,5,21,-16
KZ,CA,2021.0,2,5,-3
IL,ES,2015.0,11,19,-8
SA,QA,2008.0,3,2,1
TR,SG,2020.0,17,4,13
SD,AE,2022.0,7,4,3
DE,BA,2017.0,5,6,-1
CH,IE,2018.0,16,20,-4
SK,CH,2010.0,8,3,5
NL,AR,2021.0,6,9,-3
BR,AU,2008.0,57,47,10
AU,TR,2014.0,10,15,-5
EE,BE,2019.0,2,2,0
BE,KE,2014.0,7,6,1
RU,AU,2004.0,8,13,-5
NL,NZ,2015.0,10,15,-5
TR,GB,1998.0,13,23,-10
IT,RU,2013.0,20,13,7
PL,XK,2016.0,3,1,2
CA,MY,2021.0,19,26,-7
AU,KE,2014.0,7,6,1
FR,EE,2020.0,7,4,3
DE,AR,2014.0,37,40,-3
IT,AO,2000.0,3,4,-1
BR,CN,2010.0,45,46,-1
GB,KE,1998.0,9,8,1
KE,CN,2008.0,3,4,-1
EG,KW,2003.0,4,6,-2
HU,TR,2020.0,15,19,-4
GB,BG,2000.0,5,9,-4
IQ,AE,2017.0,7,14,-7
PL,BA,2004.0,2,1,1
VN,KR,2007.0,8,11,-3
NO,AR,2015.0,1,1,0
RO,DE,2001.0,23,8,15
BR,VE,2019.0,29,35,-6
CA,SD,2014.0,1,1,0
MA,KW,2009.0,6,5,1
LV,DE,2010.0,4,3,1
NO,BE,1999.0,3,6,-3
CL,NZ,2004.0,3,4,-1
BF,BJ,2019.0,3,6,-3
DE,BE,2023.0,1,6,-5
BG,US,1998.0,20,7,13
ZA,DK,2014.0,4,8,-4
AU,NC,2013.0,1,1,0
UG,CH,2013.0,7,4,3
LV,DE,2019.0,2,7,-5
TH,MM,2022.0,2,8,-6
CZ,RS,2012.0,17,12,5
NZ,FR,2021.0,16,29,-13
AU,LK,2021.0,28,43,-15
IR,AT,2010.0,9,7,2
BG,US,1997.0,15,14,1
BD,IE,2007.0,2,1,1
IL,SG,2011.0,3,1,2
SE,NZ,2021.0,8,12,-4
SE,MA,2021.0,3,1,2
RU,SE,2023.0,3,1,2
CU,RU,2018.0,2,5,-3
BE,LU,2004.0,11,3,8
PY,BR,2019.0,16,17,-1
EG,ES,2009.0,2,3,-1
CL,CU,2022.0,5,10,-5
CH,RS,2010.0,6,8,-2
IR,NL,2007.0,6,9,-3
AR,US,2023.0,5,10,-5
ZA,SE,2004.0,7,6,1
CH,ZA,2005.0,5,11,-6
CZ,ES,1997.0,1,3,-2
ZM,BR,2016.0,7,4,3
HU,MA,2015.0,5,2,3
PA,CO,2022.0,10,5,5
CH,RS,2017.0,9,10,-1
UA,CO,2008.0,1,2,-1
NL,KR,2009.0,9,4,5
CN,HU,2010.0,6,10,-4
TZ,CA,2018.0,1,2,-1
VN,SG,2010.0,6,9,-3
MC,FR,2019.0,12,9,3
ZA,SC,2018.0,1,2,-1
BE,UZ,2005.0,1,1,0
IL,SA,2013.0,1,2,-1
PK,PL,2016.0,9,7,2
DE,PE,2011.0,7,3,4
PH,VE,2019.0,2,1,1
PH,BD,2011.0,3,1,2
GH,UG,2018.0,2,1,1
NG,DE,2006.0,5,3,2
MW,NO,2015.0,3,1,2
IS,DK,2006.0,4,7,-3
KW,GB,2004.0,3,5,-2
UZ,RS,2013.0,1,1,0
SA,IL,2014.0,1,1,0
BR,RS,2019.0,2,2,0
PE,AR,1999.0,3,3,0
NL,PK,2008.0,2,1,1
CO,BO,2001.0,1,2,-1
PH,PE,2022.0,1,5,-4
BG,JP,2015.0,2,9,-7
CH,NO,2023.0,3,1,2
NL,MW,2015.0,3,1,2
RU,TH,2019.0,4,2,2
ID,KE,2015.0,1,8,-7
MA,CA,2009.0,8,15,-7
IT,ET,2008.0,2,4,-2
SK,BR,2014.0,6,3,3
BH,SA,2022.0,7,8,-1
ZW,PK,2018.0,1,1,0
ES,BE,2023.0,2,1,1
CU,AR,1997.0,1,3,-2
CR,CU,2006.0,2,2,0
JO,GB,1999.0,2,10,-8
SG,BE,2002.0,1,2,-1
MA,PT,2012.0,5,5,0
BE,DZ,2011.0,1,2,-1
TR,CZ,2011.0,4,4,0
KR,DK,2007.0,1,1,0
NG,TN,2012.0,1,1,0
IR,GR,2012.0,2,3,-1
IL,PH,2012.0,2,3,-1
NZ,AR,2008.0,1,1,0
MX,HR,2009.0,1,3,-2
NG,RU,2015.0,2,1,1
NO,HU,2000.0,2,1,1
AE,CA,2017.0,21,30,-9
FR,RU,2020.0,120,80,40
GD,US,2022.0,9,3,6
SG,MM,2018.0,9,5,4
HU,CA,2006.0,18,7,11
US,BZ,2008.0,1,1,0
BT,GB,2021.0,1,1,0
MX,JP,2000.0,4,9,-5
CA,CR,2021.0,2,2,0
,CN,2002.0,52588,0,52588
,US,2011.0,76030,0,76030
US,,2002.0,23498,0,23498
,CN,2005.0,58340,0,58340
US,,2005.0,24404,0,24404
,IT,2010.0,12570,0,12570
MY,,2023.0,12906,0,12906
,ES,2002.0,10588,0,10588
,TR,1994.0,4622,0,4622
,TN,2011.0,1408,0,1408
CA,,2015.0,7105,0,7105
,IE,2019.0,766,0,766
,BR,2016.0,19966,0,19966
FI,,2023.0,8337,0,8337
TW,,2008.0,1211,0,1211
,IE,2010.0,1494,0,1494
,IT,2017.0,10454,0,10454
,CO,2018.0,1975,0,1975
AR,,2024.0,12452,0,12452
,ES,2005.0,11678,0,11678
,CU,2009.0,479,0,479
MX,,2008.0,723,0,723
NL,,2011.0,3136,0,3136
,NO,2009.0,1872,0,1872
UG,NZ,1999.0,2,0,2
,NL,1999.0,4654,0,4654
RU,,2022.0,29724,0,29724
FR,,2013.0,8367,0,8367
IR,CL,2017.0,1,0,1
,PY,1995.0,13,0,13
AU,,2006.0,1663,0,1663
CL,,2008.0,314,0,314
,IT,2019.0,6893,0,6893
,CZ,2009.0,2240,0,2240
,GR,2001.0,2426,0,2426
CH,,2009.0,1648,0,1648
,MA,2011.0,1050,0,1050
BG,,2005.0,148,0,148
LT,,2022.0,1318,0,1318
,MY,1997.0,487,0,487
DK,,2016.0,1395,0,1395
,PT,1996.0,1015,0,1015
NE,,2023.0,184,0,184
,MZ,2015.0,109,0,109
TN,,2025.0,199,0,199
AE,,2021.0,519,0,519
,nan,2010.0,903,0,903
,PT,2004.0,1435,0,1435
,MY,1998.0,528,0,528
AO,,2020.0,22,0,22
,IN,2020.0,1554,0,1554
,EG,2003.0,1209,0,1209
,PH,2015.0,699,0,699
,KE,1994.0,419,0,419
,SY,2011.0,119,0,119
,JO,2003.0,176,0,176
NO,,2013.0,947,0,947
US,KP,2014.0,1,0,1
JO,,2021.0,495,0,495
HU,,2007.0,419,0,419
ME,,2009.0,4,0,4
CL,HN,1999.0,1,0,1
SD,BH,2020.0,3,0,3
,KW,2004.0,134,0,134
CZ,,2000.0,182,0,182
,CI,2014.0,323,0,323
,SS,2010.0,7,0,7
MT,,2024.0,435,0,435
UA,,2009.0,611,0,611
TJ,,2023.0,228,0,228
CN,LA,2005.0,1,0,1
CN,NE,2017.0,1,0,1
,AZ,2004.0,104,0,104
,AM,2001.0,155,0,155
,KW,1996.0,200,0,200
,ZM,2012.0,119,0,119
,ET,2003.0,125,0,125
KR,JO,2016.0,1,0,1
KH,,2020.0,63,0,63
RW,,2016.0,24,0,24
GA,,2023.0,134,0,134
TH,,1999.0,74,0,74
MD,,2021.0,88,0,88
NI,PA,2011.0,1,0,1
,nan,2017.0,710,0,710
,LK,2016.0,537,0,537
ZA,LV,2012.0,1,0,1
BG,,2002.0,150,0,150
,MN,2009.0,57,0,57
MW,,2011.0,14,0,14
GL,,2023.0,23,0,23
AE,MX,2001.0,1,0,1
DZ,,2004.0,21,0,21
PH,AR,2004.0,1,0,1
RW,SA,2021.0,1,0,1
CN,TZ,2003.0,1,0,1
NC,,2022.0,40,0,40
,SS,2017.0,2,0,2
,MU,2014.0,27,0,27
,nan,2019.0,295,0,295
ID,ML,2016.0,1,0,1
nan,HR,2011.0,4,0,4
,AZ,1996.0,71,0,71
,GA,2001.0,13,0,13
,GD,2018.0,26,0,26
IR,CL,2019.0,6,0,6
SY,,2025.0,31,0,31
,FO,2018.0,4,0,4
,IE,2017.0,1171,0,1171
GH,,2018.0,209,0,209
,MD,2013.0,102,0,102
KZ,DZ,2016.0,1,0,1
CN,GM,2021.0,1,0,1
RW,CH,2017.0,1,0,1
IT,ZW,2017.0,1,0,1
,VG,2001.0,20,0,20
,PS,2009.0,60,0,60
,NE,2003.0,17,0,17
CM,,2016.0,102,0,102
,SZ,2008.0,4,0,4
IE,IL,2022.0,2,0,2
NG,AT,2019.0,5,0,5
SK,,1999.0,92,0,92
RS,,2009.0,164,0,164
,PG,2014.0,26,0,26
CO,,2000.0,47,0,47
,MT,2003.0,27,0,27
IL,BD,2010.0,3,0,3
FI,RW,2020.0,1,0,1
,NC,2015.0,17,0,17
FR,BO,1997.0,1,0,1
CA,TT,1998.0,1,0,1
KW,nan,2008.0,1,0,1
TN,AE,2010.0,1,0,1
TT,AE,2010.0,2,0,2
IE,QA,2012.0,2,0,2
ES,UG,2011.0,3,0,3
YE,GB,2020.0,3,0,3
,PE,2020.0,41,0,41
PK,UZ,2022.0,2,0,2
LB,MY,2012.0,1,0,1
,MR,2016.0,19,0,19
,TD,2018.0,5,0,5
,TT,2004.0,25,0,25
DE,CG,2015.0,3,0,3
PF,RE,2016.0,2,0,2
BT,BE,2021.0,1,0,1
,LR,2013.0,6,0,6
,YE,2005.0,24,0,24
GB,TL,2012.0,1,0,1
PK,SS,2022.0,2,0,2
PK,RW,2009.0,1,0,1
,BH,2001.0,37,0,37
ML,MR,2012.0,1,0,1
NO,MW,2008.0,2,0,2
MG,,2011.0,23,0,23
SV,NI,2016.0,3,0,3
,RE,2007.0,22,0,22
GT,EG,2011.0,1,0,1
BW,NG,2011.0,2,0,2
GT,BE,2018.0,2,0,2
LI,DK,2018.0,1,0,1
HT,ES,2014.0,1,0,1
,BI,2007.0,15,0,15
,GT,2003.0,29,0,29
VU,US,2011.0,1,0,1
nan,HK,2000.0,1,0,1
SE,AE,2002.0,2,0,2
KR,AM,2015.0,2,0,2
MC,BE,2010.0,1,0,1
AF,AR,2014.0,1,0,1
MT,SG,2019.0,1,0,1
CA,LK,1997.0,2,0,2
MD,SN,2000.0,2,0,2
RO,BG,2004.0,1,0,1
ZW,NZ,2015.0,1,0,1
CA,JM,2015.0,3,0,3
KZ,AU,2008.0,1,0,1
,CW,1994.0,21,0,21
CN,CL,1998.0,2,0,2
,YE,2002.0,23,0,23
IR,PS,2022.0,3,0,3
ME,IT,2015.0,7,0,7
TW,JO,2020.0,1,0,1
ZA,SD,2009.0,1,0,1
RW,NZ,2020.0,1,0,1
TD,,2010.0,1,0,1
ZA,MK,2006.0,1,0,1
BE,AZ,2004.0,1,0,1
,LA,2003.0,8,0,8
CN,ZM,2004.0,1,0,1
GB,QA,1998.0,5,0,5
SL,,2021.0,7,0,7
PL,FI,2000.0,3,0,3
NP,,2009.0,29,0,29
CU,PY,2012.0,5,0,5
SI,TR,2015.0,4,0,4
SN,,2011.0,17,0,17
ID,MM,2017.0,1,0,1
JP,QA,2008.0,1,0,1
RO,HK,2006.0,9,0,9
MZ,UA,2004.0,5,0,5
BY,ES,2000.0,2,0,2
,TT,1996.0,27,0,27
CH,LB,2001.0,1,0,1
BR,MR,2015.0,1,0,1
MY,YE,2005.0,1,0,1
AU,LU,2021.0,4,0,4
MX,PF,2020.0,1,0,1
CU,MY,2011.0,1,0,1
ML,SE,2021.0,1,0,1
ZW,SZ,2018.0,1,0,1
EG,SO,2017.0,2,0,2
DK,HU,2005.0,1,0,1
SM,BR,1997.0,1,0,1
TR,BG,2019.0,1,0,1
LU,TW,2003.0,1,0,1
FR,SY,2007.0,7,0,7
TD,,2019.0,11,0,11
CZ,NG,2007.0,1,0,1
IN,SN,2012.0,1,0,1
CA,SI,1998.0,2,0,2
BO,CN,2010.0,4,0,4
BR,CY,2000.0,1,0,1
ZA,VN,2011.0,1,0,1
BS,GB,2019.0,2,0,2
,BT,2015.0,12,0,12
BG,CL,2022.0,4,0,4
GB,SX,2022.0,1,0,1
ES,OM,2022.0,1,0,1
FJ,,2014.0,6,0,6
SY,TJ,2017.0,1,0,1
TD,,2017.0,5,0,5
BH,CA,2019.0,3,0,3
US,LV,1997.0,3,0,3
AZ,AU,1999.0,1,0,1
,FI,2020.0,96,0,96
IT,MC,2020.0,1,0,1
IM,TN,2010.0,1,0,1
LK,OM,2009.0,1,0,1
VG,IN,2016.0,4,0,4
NC,SN,2004.0,1,0,1
NO,GH,2009.0,2,0,2
NL,LK,1999.0,1,0,1
DZ,TN,2008.0,2,0,2
AT,MY,2011.0,6,0,6
BE,SG,1997.0,2,0,2
HU,AE,2012.0,1,0,1
AM,KZ,2018.0,2,0,2
QA,DK,1999.0,1,0,1
NL,QA,2010.0,3,0,3
FO,DK,2013.0,2,0,2
IN,LR,2019.0,1,0,1
BO,,2007.0,5,0,5
LB,CU,2012.0,1,0,1
ET,JP,1997.0,1,0,1
MX,LK,2016.0,1,0,1
PK,AL,2019.0,2,0,2
PA,NL,2016.0,3,0,3
AR,TN,2015.0,1,0,1
IT,,2026.0,3,0,3
ZW,FR,2011.0,2,0,2
PH,CL,2000.0,1,0,1
LA,KH,2020.0,1,0,1
MA,DZ,2005.0,2,0,2
NG,LR,2012.0,1,0,1
GB,GP,2011.0,1,0,1
,AF,2003.0,4,0,4
AL,AU,2016.0,1,0,1
NZ,KE,1999.0,1,0,1
,SS,2019.0,1,0,1
PS,GD,2019.0,1,0,1
AE,DK,2017.0,1,0,1
NP,BH,2021.0,1,0,1
PA,ZW,2018.0,1,0,1
SK,UZ,2019.0,1,0,1
GM,BE,2007.0,1,0,1
PL,GE,2017.0,1,0,1
nan,VE,2010.0,1,0,1
SD,IQ,2014.0,3,0,3
MC,BE,2019.0,2,0,2
MY,KH,1998.0,1,0,1
GT,AU,2021.0,1,0,1
ER,DK,2020.0,1,0,1
AT,PT,2004.0,1,0,1
SE,LU,2011.0,5,0,5
ET,FR,2004.0,3,0,3
SE,VE,2003.0,1,0,1
BM,,2018.0,5,0,5
ST,PT,2011.0,2,0,2
nan,LA,2011.0,1,0,1
HN,PY,2018.0,1,0,1
ZM,ZW,2014.0,3,0,3
BG,GE,2008.0,1,0,1
LT,GR,2014.0,1,0,1
LT,CA,2005.0,2,0,2
CR,FR,2014.0,5,0,5
nan,ID,2002.0,2,0,2
CN,ID,1998.0,2,0,2
GM,NG,2010.0,1,0,1
MA,GH,2019.0,1,0,1
IE,nan,1999.0,1,0,1
VE,ID,2010.0,1,0,1
AF,,2016.0,5,0,5
SG,AT,2005.0,1,0,1
AM,KR,2013.0,2,0,2
PT,LU,2005.0,1,0,1
KE,PE,2000.0,1,0,1
TW,UZ,2011.0,3,0,3
ET,SD,2015.0,1,0,1
MY,PK,1998.0,1,0,1
FJ,NZ,2021.0,1,0,1
LU,SE,2022.0,3,0,3
,HT,2000.0,2,0,2
TT,,2008.0,8,0,8
BW,IE,2010.0,1,0,1
CO,QA,2014.0,1,0,1
AT,IS,2018.0,1,0,1
GP,MD,2019.0,2,0,2
HN,,2007.0,5,0,5
SN,MR,2010.0,1,0,1
AE,DK,2019.0,2,0,2
GH,ET,2021.0,1,0,1
TH,MD,2012.0,1,0,1
GN,CN,2022.0,2,0,2
AT,MX,2009.0,2,0,2
BE,MA,1997.0,2,0,2
EC,ID,2021.0,5,0,5
CA,BT,2020.0,2,0,2
ME,AT,2007.0,1,0,1
CN,RW,2011.0,2,0,2
ET,GH,2022.0,1,0,1
RS,CY,2018.0,3,0,3
CH,KZ,2017.0,2,0,2
BD,KW,2016.0,3,0,3
PE,CG,2015.0,1,0,1
LU,UG,2003.0,1,0,1
FI,OM,2001.0,1,0,1
IE,AE,2012.0,3,0,3
MX,AE,2022.0,2,0,2
BS,,2025.0,2,0,2
BH,AE,2009.0,4,0,4
MU,,2003.0,4,0,4
IS,NA,2016.0,1,0,1
MK,VN,2020.0,1,0,1
,BS,2018.0,6,0,6
CH,BI,2017.0,1,0,1
UG,BJ,2019.0,2,0,2
MN,IN,2019.0,1,0,1
ID,PK,1999.0,2,0,2
KR,CI,2006.0,3,0,3
BE,PS,2011.0,1,0,1
SA,MX,2021.0,3,0,3
IN,SI,2009.0,1,0,1
CA,RO,2023.0,1,0,1
KW,ES,2011.0,1,0,1
MR,,2015.0,3,0,3
US,AZ,2009.0,2,0,2
BW,BN,2010.0,1,0,1
FR,FJ,2017.0,1,0,1
CH,VN,2001.0,1,0,1
IR,ES,2023.0,5,0,5
HU,ID,2003.0,2,0,2
MR,nan,2017.0,1,0,1
CF,,2013.0,6,0,6
KW,ZA,2004.0,1,0,1
LV,NO,2009.0,1,0,1
IT,HK,2012.0,1,0,1
KP,SE,2001.0,1,0,1
AU,AF,2018.0,2,0,2
MY,LB,2022.0,3,0,3
GR,RU,2014.0,4,0,4
BR,KR,2007.0,1,0,1
SI,KR,2011.0,1,0,1
NL,MT,2009.0,1,0,1
MY,PK,1997.0,1,0,1
US,BJ,1997.0,1,0,1
VE,IN,2019.0,2,0,2
EC,TR,2012.0,1,0,1
LU,NL,2000.0,1,0,1
NL,AF,2017.0,1,0,1
BW,NL,2005.0,1,0,1
PH,PT,2013.0,3,0,3
CZ,UZ,1998.0,1,0,1
CO,NP,2019.0,1,0,1
NO,BW,2012.0,2,0,2
LK,IT,2021.0,1,0,1
MK,IN,2018.0,3,0,3
LS,NG,2020.0,1,0,1
YE,,2001.0,4,0,4
DZ,DE,1997.0,2,0,2
LB,LU,2019.0,1,0,1
MX,BA,2016.0,1,0,1
BG,EG,2015.0,2,0,2
CY,LY,2021.0,2,0,2
CO,ZA,2008.0,2,0,2
AE,PT,2010.0,1,0,1
MN,DE,2022.0,1,0,1
PS,CA,2008.0,2,0,2
BE,CI,2009.0,3,0,3
PL,NZ,2003.0,1,0,1
RO,FI,2004.0,2,0,2
BB,JM,2008.0,4,0,4
US,MN,2001.0,1,0,1
RU,KE,2014.0,1,0,1
SC,BE,2015.0,1,0,1
HK,PH,2010.0,1,0,1
TR,AE,1998.0,1,0,1
SK,BE,2002.0,1,0,1
nan,BO,2021.0,1,0,1
SD,IE,2011.0,2,0,2
AE,CM,2020.0,1,0,1
PG,IT,2018.0,1,0,1
PK,TH,2007.0,1,0,1
DK,HU,2002.0,2,0,2
LY,PL,2000.0,1,0,1
BW,NP,2011.0,1,0,1
ET,IE,2007.0,1,0,1
IE,UY,2006.0,2,0,2
HU,CW,2006.0,1,0,1
AM,HU,2012.0,1,0,1
PT,PK,2007.0,1,0,1
IE,TH,2016.0,1,0,1
UZ,SK,2020.0,1,0,1
PE,KR,2013.0,4,0,4
CH,JO,2009.0,1,0,1
PH,RU,2020.0,2,0,2
OM,SD,2021.0,2,0,2
TL,BR,2021.0,1,0,1
ZA,FI,2023.0,1,0,1
NO,SD,2000.0,1,0,1
TR,PG,2015.0,1,0,1
GA,CM,2015.0,2,0,2
SN,KH,2009.0,1,0,1
HU,PT,2001.0,1,0,1
IE,BH,2000.0,1,0,1
nan,BY,2007.0,1,0,1
NA,SE,2006.0,1,0,1
SY,CA,2005.0,1,0,1
VE,ID,2019.0,1,0,1
MY,FJ,2017.0,1,0,1
KR,OM,2016.0,2,0,2
PH,KZ,2016.0,1,0,1
IR,PE,2021.0,2,0,2
RW,CH,2010.0,1,0,1
JM,ES,2007.0,1,0,1
SI,BA,1998.0,1,0,1
GE,SE,2000.0,1,0,1
GT,PL,2016.0,1,0,1
PK,GH,2006.0,1,0,1
TH,IL,2001.0,1,0,1
SA,GM,2022.0,1,0,1
MY,BS,2018.0,1,0,1
CR,,1998.0,3,0,3
LB,SD,2017.0,2,0,2
ES,MN,2006.0,1,0,1
PY,,2007.0,3,0,3
,TO,2004.0,1,0,1
EE,KZ,2021.0,2,0,2
OM,FR,2020.0,1,0,1
ML,KE,2022.0,1,0,1
MG,AU,2020.0,1,0,1
CI,BF,2003.0,1,0,1
NP,nan,2015.0,3,0,3
CI,GN,2007.0,1,0,1
AO,JP,2011.0,3,0,3
CO,nan,2000.0,1,0,1
FR,CY,1999.0,1,0,1
BR,MA,2022.0,2,0,2
QA,NO,1999.0,2,0,2
PY,ZA,2002.0,1,0,1
SO,,2022.0,5,0,5
PH,AT,1999.0,1,0,1
BR,NG,2004.0,2,0,2
CO,ET,2008.0,1,0,1
ET,LK,2012.0,1,0,1
JP,MA,2014.0,1,0,1
BT,US,2007.0,1,0,1
,VC,2012.0,1,0,1
DO,VE,2009.0,1,0,1
SL,NG,2022.0,1,0,1
QA,GH,2015.0,1,0,1
JP,MU,2008.0,1,0,1
EE,SK,2017.0,1,0,1
BR,BF,2019.0,1,0,1
BG,BR,1999.0,2,0,2
DE,MU,2014.0,1,0,1
UA,PG,2021.0,1,0,1
CH,OM,1998.0,1,0,1
ID,VN,2014.0,2,0,2
MU,IT,1999.0,1,0,1
GH,nan,2002.0,1,0,1
PH,AE,2022.0,1,0,1
LK,IL,2016.0,3,0,3
PH,PA,2001.0,1,0,1
CA,UY,2000.0,1,0,1
SE,MW,2010.0,1,0,1
OM,ZW,2023.0,1,0,1
TR,AR,2018.0,2,0,2
SG,AR,2017.0,1,0,1
GN,AU,2017.0,1,0,1
PH,LK,2011.0,1,0,1
PR,SE,2016.0,1,0,1
BE,AL,2017.0,2,0,2
MY,CL,2006.0,1,0,1
TR,LT,2023.0,1,0,1
IR,TR,1998.0,1,0,1
CM,US,2002.0,2,0,2
GN,,2009.0,1,0,1
PA,IN,2004.0,1,0,1
DE,KH,2019.0,1,0,1
BO,PT,2008.0,1,0,1
NG,BE,2000.0,1,0,1
KR,BG,2021.0,1,0,1
NI,US,2001.0,1,0,1
IE,IS,2003.0,1,0,1
ZA,BY,2002.0,1,0,1
MG,ES,2007.0,1,0,1
TJ,PK,2018.0,1,0,1
BJ,NG,1999.0,1,0,1
HU,BD,2006.0,1,0,1
HR,ME,2006.0,2,0,2
RU,SG,2002.0,3,0,3
ZW,IE,2017.0,1,0,1
BD,LU,2019.0,1,0,1
IN,QA,2001.0,1,0,1
ZA,JM,1999.0,1,0,1
AU,ME,2012.0,1,0,1
PA,DK,2021.0,1,0,1
NC,PF,2002.0,1,0,1
ZM,CL,2015.0,1,0,1
,IM,2013.0,1,0,1
CW,SE,2012.0,1,0,1
NO,EE,2003.0,2,0,2
KZ,SK,2019.0,1,0,1
FI,AE,2022.0,1,0,1
AU,CR,2006.0,1,0,1
NZ,PG,2017.0,1,0,1
MY,NL,2000.0,2,0,2
ES,,2026.0,1,0,1
PS,QA,2008.0,1,0,1
CY,FI,2014.0,1,0,1
NI,CG,2021.0,1,0,1
KE,EC,2016.0,2,0,2
ZA,BH,2013.0,1,0,1
MY,CM,2002.0,1,0,1
UG,SG,2016.0,1,0,1
SE,MX,2012.0,5,7,-2
MX,ZW,2013.0,2,1,1
BE,GM,2015.0,1,2,-1
PL,PK,2023.0,1,3,-2
AT,PK,2004.0,2,2,0
NP,CN,2006.0,1,2,-1
GP,BE,2022.0,1,1,0
GH,NL,2011.0,1,1,0
IR,UA,2019.0,2,1,1
NG,AT,2010.0,1,1,0
UA,SA,2012.0,1,1,0
FI,IL,2021.0,1,1,0
CA,TR,2023.0,2,2,0
NL,ID,2000.0,2,2,0
CL,AT,1999.0,1,1,0
SK,NZ,2018.0,1,1,0
US,YE,2006.0,1,1,0
CA,PS,2012.0,1,1,0
TW,IL,1997.0,2,1,1
KR,AT,2000.0,2,1,1
LV,DE,2017.0,5,3,2
FR,LK,2003.0,1,1,0
ME,SI,2021.0,1,1,0
HR,IE,2016.0,2,6,-4
ET,CM,2021.0,1,1,0
CZ,GH,2018.0,2,2,0
VE,RU,2003.0,1,1,0
IE,ZA,2002.0,1,5,-4
CN,CD,2020.0,1,1,0
EE,BE,2017.0,2,1,1
MX,ZA,2005.0,2,2,0
ES,ZA,1998.0,1,1,0
EE,AT,2021.0,1,5,-4
FI,MA,2022.0,1,6,-5
CZ,XK,2015.0,1,1,0
KZ,NO,2022.0,1,2,-1
CR,IT,2014.0,1,5,-4
FR,SD,2020.0,1,2,-1
ET,SE,2004.0,1,3,-2
BW,TZ,2009.0,1,1,0
UA,PT,2018.0,2,4,-2
GT,CU,2015.0,1,2,-1
NZ,TH,2012.0,2,2,0
GN,ML,2022.0,1,1,0
LV,NL,2017.0,1,1,0
SE,MY,2020.0,2,11,-9
MY,KE,2010.0,1,2,-1
JP,BG,1999.0,3,7,-4
AU,GE,2016.0,2,5,-3
IS,SG,2015.0,1,2,-1
CR,GB,2011.0,1,2,-1
PL,DZ,2020.0,1,1,0
EE,NO,2009.0,1,1,0
CO,CL,1997.0,1,3,-2
GT,CA,2019.0,1,2,-1
EE,CA,2013.0,1,2,-1
KE,CG,2017.0,2,1,1
GH,AT,2019.0,1,1,0
IR,IN,2004.0,1,7,-6
IE,MY,2017.0,4,7,-3
BE,TN,2008.0,1,2,-1
BA,IT,2011.0,2,1,1
NG,CA,1998.0,1,1,0
BR,RS,2010.0,1,1,0
AR,NZ,2016.0,3,2,1
IL,BD,2017.0,1,1,0
PL,SI,2003.0,1,3,-2
CR,PA,2017.0,1,2,-1
NP,DE,2019.0,5,5,0
QA,OM,2011.0,1,5,-4
SA,NO,2016.0,1,3,-2
AE,KZ,2022.0,1,1,0
SE,ZW,2016.0,1,1,0
LT,JP,2015.0,2,2,0
PK,NL,2008.0,1,2,-1
FR,BO,1998.0,1,2,-1
ID,BE,2007.0,1,1,0
IL,CZ,2001.0,2,2,0
LT,PL,2022.0,1,2,-1
GR,IL,2008.0,2,1,1
US,NA,2014.0,1,3,-2
JO,CO,2018.0,2,2,0
SE,ZA,1997.0,1,1,0
SA,NZ,2010.0,1,1,0
CH,SI,2000.0,1,1,0
KE,PH,2018.0,1,2,-1
IN,FI,2001.0,1,4,-3
BE,PK,2018.0,2,5,-3
AT,HR,2003.0,2,4,-2
GB,SY,2004.0,1,1,0
CL,QA,2018.0,1,1,0
UA,LV,2014.0,1,2,-1
SI,SE,2012.0,1,3,-2
GB,MX,2023.0,1,2,-1
MX,KZ,2015.0,1,1,0
NZ,IL,2006.0,1,1,0
BA,US,2001.0,1,4,-3
CH,HK,2007.0,1,1,0
CL,RU,2003.0,3,11,-8
UA,ES,2006.0,2,4,-2
NZ,AT,2020.0,2,8,-6
SM,IT,2015.0,1,6,-5
CH,UG,2020.0,1,4,-3
ES,SG,2006.0,2,1,1
BY,HU,2020.0,1,2,-1
CL,NO,2005.0,1,1,0
KW,AE,2001.0,2,1,1
BM,US,2008.0,1,4,-3
GH,FR,2013.0,1,1,0
IR,BR,2010.0,3,3,0
TR,NG,2014.0,1,3,-2
ZA,BW,1998.0,1,1,0
SY,FR,2010.0,2,13,-11
BR,RS,2017.0,1,4,-3
ZW,BE,2021.0,1,2,-1
VG,DE,2015.0,1,1,0
RO,DK,2010.0,1,1,0
NG,ZW,2014.0,1,1,0
IQ,ZA,2016.0,1,1,0
KE,SD,2004.0,1,4,-3
CZ,NZ,2018.0,1,2,-1
MW,ET,2014.0,1,1,0
ID,AF,2015.0,2,1,1
RS,BE,2021.0,1,7,-6
ZA,JP,2021.0,1,3,-2
BE,EG,2004.0,2,3,-1
UY,IN,2022.0,1,1,0
JP,KH,2008.0,1,6,-5
AT,GA,2007.0,1,2,-1
QA,GR,2021.0,1,3,-2
MT,AU,2017.0,1,2,-1
MD,RO,2011.0,1,2,-1
AR,TW,2022.0,1,3,-2
TR,HU,2003.0,1,1,0
PH,VE,2017.0,1,2,-1
CH,BI,2019.0,1,1,0
PT,MY,2018.0,1,1,0
SA,DK,2018.0,1,3,-2
RS,KZ,2015.0,1,5,-4
LU,PT,2012.0,1,1,0
ET,CH,2010.0,1,1,0
TR,TH,2019.0,2,2,0
GB,BF,2006.0,1,1,0
SE,BY,2005.0,1,1,0
FI,CO,2020.0,2,3,-1
BR,JO,2009.0,1,1,0
UY,PE,2009.0,1,2,-1
PE,IT,2014.0,1,6,-5
LV,NL,2010.0,1,1,0
SE,PK,2007.0,3,2,1
LT,NL,2013.0,1,1,0
FJ,IN,2007.0,1,1,0
MC,FR,2010.0,1,8,-7
DK,GL,2022.0,1,3,-2
NL,BD,2022.0,1,3,-2
nan,TN,2022.0,1,2,-1
NG,MY,2023.0,1,2,-1
TR,PH,2021.0,1,1,0
GB,UG,2002.0,1,5,-4
GH,SE,2022.0,1,1,0
RW,CH,2019.0,1,1,0
AU,RW,2016.0,1,1,0
TH,GB,2023.0,1,2,-1
CH,BA,2021.0,1,1,0
GH,nan,2005.0,1,3,-2
PL,TN,2022.0,1,1,0
CA,SI,1997.0,1,1,0
TR,EG,2006.0,2,1,1
VE,PT,2007.0,2,3,-1
NZ,BD,2018.0,1,7,-6
DZ,SE,2016.0,2,5,-3
FR,NC,1998.0,3,6,-3
FR,GA,2000.0,2,1,1
TH,BT,2020.0,6,2,4
KE,KH,2018.0,1,1,0
GT,PE,2022.0,2,2,0
DE,AZ,2014.0,2,1,1
LK,BN,2011.0,1,1,0
DE,TZ,1999.0,1,2,-1
SD,BD,2019.0,1,1,0
UZ,BY,2009.0,1,0,1
SK,MT,2007.0,1,0,1
MQ,AU,2014.0,1,0,1
IN,ER,2004.0,1,0,1
NC,CG,2001.0,1,0,1
IR,CM,2013.0,1,0,1
ID,BN,2009.0,1,0,1
IT,AZ,1997.0,1,0,1
JO,CN,2011.0,1,0,1
CA,BA,2008.0,1,0,1
AE,DZ,2005.0,1,0,1
VE,nan,2021.0,1,0,1
IN,ZW,2018.0,2,0,2
BY,LT,2014.0,1,0,1
BD,nan,1999.0,1,0,1
KW,IQ,2014.0,2,0,2
IL,CY,2012.0,1,0,1
TR,MK,2023.0,1,0,1
RS,KW,2014.0,3,0,3
OM,AR,2016.0,1,0,1
NE,GA,2011.0,1,0,1
KZ,TW,2023.0,1,0,1
RS,IL,2017.0,1,0,1
BY,NO,2020.0,1,0,1
RO,SG,2021.0,1,0,1
SN,CH,2005.0,1,0,1
GF,US,2022.0,1,0,1
AT,LV,2015.0,1,0,1
BH,ZM,2009.0,1,0,1
VG,BR,2016.0,3,0,3
BD,LU,2017.0,1,0,1
EC,PA,2009.0,1,0,1
US,PF,2009.0,1,0,1
EE,HU,2015.0,1,0,1
AM,CZ,2014.0,2,0,2
LB,CY,2017.0,1,0,1
SI,UZ,2021.0,1,0,1
NG,ID,2009.0,1,0,1
PT,KR,2005.0,1,0,1
AF,TH,2022.0,1,0,1
SD,FR,2009.0,1,0,1
VG,FR,2020.0,2,0,2
CO,IE,2000.0,1,0,1
BR,MD,2000.0,1,0,1
IS,NL,2000.0,1,0,1
RS,GR,1999.0,1,0,1
LY,ET,2018.0,1,0,1
TR,IS,2022.0,1,0,1
BE,GH,2007.0,1,0,1
MX,MZ,2021.0,1,0,1
VN,TW,2000.0,1,0,1
MT,NO,2019.0,1,0,1
GF,GB,2020.0,1,0,1
BJ,JP,2014.0,2,0,2
nan,NA,2011.0,1,0,1
PK,EG,2001.0,1,0,1
DZ,BI,2012.0,3,0,3
BA,BG,2017.0,1,0,1
AL,NO,2016.0,1,0,1
IQ,FI,2004.0,1,0,1
NP,BE,2022.0,1,0,1
ZA,KW,1997.0,1,0,1
CA,MU,2004.0,1,0,1
ET,SA,2012.0,2,0,2
LU,AE,2014.0,1,0,1
GB,BT,2016.0,1,0,1
BF,GB,2007.0,1,0,1
nan,LV,2011.0,1,0,1
UZ,BR,2015.0,1,0,1
NG,NL,1998.0,1,0,1
DZ,MK,2016.0,1,0,1
SI,AR,2004.0,1,0,1
DZ,PL,2021.0,1,0,1
LK,BR,2003.0,1,0,1
MX,NG,2005.0,1,0,1
ML,NO,2011.0,1,0,1
ZA,CL,1999.0,1,0,1
PL,GE,2010.0,2,0,2
MZ,LT,2015.0,2,0,2
BE,SR,2017.0,1,0,1
MZ,GE,2013.0,1,0,1
TR,BG,2010.0,1,0,1
MQ,CA,2008.0,1,0,1
UZ,IT,2005.0,1,0,1
AU,UZ,2009.0,2,0,2
BJ,CH,1998.0,1,0,1
QA,KR,2000.0,1,0,1
AU,VE,2013.0,2,0,2
SE,MZ,2012.0,1,0,1
GH,UA,2020.0,3,0,3
MY,AM,2015.0,1,0,1
MX,MK,2011.0,1,0,1
PT,CR,2009.0,1,0,1
PK,SL,2020.0,1,0,1
BD,MX,2015.0,1,0,1
LB,SD,2019.0,1,0,1
GH,BW,2013.0,1,0,1
RU,KH,2013.0,1,0,1
DE,ET,2001.0,1,0,1
VE,PY,1999.0,1,0,1
MT,AU,2010.0,1,0,1
PH,TT,2020.0,1,0,1
AZ,ES,2021.0,1,0,1
BH,TR,2022.0,1,0,1
OM,PH,2011.0,1,0,1
ES,ZA,1997.0,1,0,1
CY,MY,2021.0,1,0,1
BY,RS,2010.0,1,0,1
GR,JO,2013.0,1,0,1
ZW,MW,2003.0,1,0,1
DE,FJ,2010.0,1,0,1
nan,SK,2006.0,2,0,2
NP,UA,2022.0,1,0,1
HN,CO,2007.0,2,0,2
BJ,PF,2020.0,1,0,1
ZA,KW,1998.0,1,0,1
PL,AM,2000.0,1,0,1
NZ,PG,2010.0,1,0,1
LK,BT,2018.0,2,0,2
DO,IL,2013.0,1,0,1
AT,OM,2005.0,1,0,1
GB,PF,2014.0,1,0,1
FR,PA,2020.0,1,0,1
TW,SE,2001.0,1,0,1
IT,MZ,2015.0,1,0,1
AL,TR,2022.0,1,0,1
OM,TR,2015.0,1,0,1
EE,HR,2011.0,2,0,2
BD,ZW,2013.0,1,0,1
PS,BR,2013.0,1,0,1
VG,NO,2007.0,1,0,1
LT,PK,2009.0,1,0,1
KR,MZ,2014.0,1,0,1
VE,BJ,2021.0,1,0,1
MT,NO,2017.0,1,0,1
BE,AE,2005.0,1,0,1
ME,SK,2006.0,1,0,1
PK,KW,2000.0,1,0,1
FR,BB,2014.0,1,0,1
RU,GN,2001.0,1,0,1
CU,DK,2011.0,1,0,1
IS,EG,2019.0,1,0,1
IQ,CH,2012.0,1,0,1
GH,GM,2004.0,1,0,1
TZ,IT,2003.0,1,0,1
SS,,2007.0,1,0,1
AR,CZ,2001.0,1,0,1
BA,SA,2022.0,1,0,1
IN,AT,2023.0,1,0,1
IS,UG,2010.0,1,0,1
MK,ES,2011.0,1,0,1
KE,MX,2005.0,1,0,1
MA,AU,2002.0,1,0,1
MA,AU,2005.0,1,0,1
NL,SZ,2015.0,1,0,1
BH,AU,2004.0,1,0,1
SY,VN,2018.0,1,0,1
CN,NE,2010.0,1,0,1
FR,NA,2017.0,1,0,1
BY,TR,2004.0,1,0,1
BF,LU,2007.0,1,0,1
VN,NG,2014.0,1,0,1
,MS,2003.0,1,0,1
IR,FJ,2016.0,1,0,1
MR,SA,2021.0,1,0,1
SA,MY,1999.0,1,0,1
CN,CY,2014.0,1,0,1
AT,PH,2021.0,2,0,2
BA,CZ,2016.0,2,0,2
CL,PS,2008.0,1,0,1
TH,PL,2020.0,1,0,1
MC,ES,2001.0,1,0,1
UZ,PT,2007.0,1,0,1
GW,ES,2019.0,1,0,1
IN,DO,2015.0,1,0,1
IS,IQ,2016.0,1,0,1
ME,BE,2016.0,1,0,1
CA,MC,2016.0,2,0,2
YE,FR,2000.0,1,0,1
AU,ML,2012.0,1,0,1
BF,JP,1999.0,1,0,1
CR,UY,1999.0,1,0,1
CU,nan,1999.0,1,0,1
RO,TN,2017.0,1,0,1
GL,GB,2022.0,1,0,1
TN,SE,2009.0,1,0,1
BR,NI,2002.0,1,0,1
GB,MC,2000.0,1,0,1
SD,BD,2017.0,1,0,1
MH,US,2019.0,1,0,1
IT,ZW,2019.0,1,0,1
MY,CO,2008.0,1,0,1
SK,EG,2006.0,1,0,1
HK,nan,2014.0,1,0,1
NZ,NO,2007.0,1,0,1
RU,MA,2013.0,1,0,1
LU,BD,2020.0,1,0,1
PE,QA,2018.0,1,0,1
CZ,AL,2021.0,1,0,1
MX,MO,2020.0,1,0,1
NA,KW,2008.0,1,0,1
PF,CA,2019.0,1,0,1
TR,BH,2000.0,1,0,1
PH,MT,2020.0,1,0,1
LB,PH,2009.0,1,0,1
EG,LK,2003.0,1,0,1
UA,EE,2010.0,1,0,1
BR,AZ,2021.0,1,0,1
LT,LV,2023.0,1,0,1
LB,CY,2019.0,1,0,1
FI,BR,2023.0,1,0,1
DZ,AU,2022.0,1,0,1
GR,TW,2008.0,1,0,1
NO,IS,2023.0,1,0,1
TR,CN,2023.0,1,0,1
MK,ME,2018.0,1,0,1
CM,AT,2004.0,1,0,1
KN,CN,2012.0,1,0,1
ZA,MA,2015.0,1,0,1
LK,NO,2006.0,1,0,1
BE,NA,2018.0,1,0,1
,SR,2020.0,1,0,1
IN,KG,2023.0,1,0,1
CO,NG,2013.0,1,0,1
DJ,FR,2013.0,1,0,1
BJ,PL,2022.0,1,0,1
CF,CH,2017.0,1,0,1
JO,RU,2002.0,1,0,1
SA,UA,2021.0,1,0,1
IE,GB,2020.0,428,499,-71
RU,US,2015.0,421,546,-125
US,NL,2013.0,727,705,22
US,PT,2017.0,182,174,8
GB,NZ,2022.0,123,133,-10
US,CN,2012.0,6254,5335,919
TR,AG,2018.0,265,36,229
CH,US,2017.0,983,978,5
DK,CZ,2019.0,9,11,-2
FR,CA,2013.0,631,543,88
AU,CA,2003.0,182,176,6
AU,US,2022.0,1437,1566,-129
IL,AU,2009.0,24,6,18
US,NZ,2004.0,261,245,16
BE,NL,2002.0,151,126,25
CN,JP,1998.0,191,204,-13
AE,EG,2011.0,16,13,3
IR,GB,2002.0,11,47,-36
FR,NL,2003.0,159,104,55
MX,AR,2021.0,119,128,-9
CH,US,2010.0,593,779,-186
NP,US,2017.0,89,79,10
US,IL,2020.0,553,541,12
DE,US,2008.0,2083,2283,-200
CL,CO,2015.0,241,232,9
GB,SG,2005.0,58,55,3
FI,IN,2017.0,18,24,-6
PK,IN,2018.0,299,427,-128
BR,NL,2006.0,23,32,-9
PK,CN,2002.0,29,22,7
LK,JP,2012.0,15,20,-5
TW,GB,2018.0,68,48,20
US,FI,2005.0,112,126,-14
PL,US,2003.0,185,140,45
GB,FR,2003.0,332,363,-31
MX,CA,1999.0,12,13,-1
TH,GB,2000.0,6,22,-16
IT,MY,2014.0,61,43,18
DE,CA,1998.0,97,95,2
IN,KR,2015.0,234,143,91
BO,BR,2016.0,5,4,1
nan,AU,2020.0,30,25,5
CH,US,2019.0,950,981,-31
NL,US,2022.0,389,558,-169
FR,BE,2021.0,307,247,60
IT,US,2009.0,984,842,142
IR,DE,2017.0,111,85,26
CL,ES,2021.0,348,308,40
FR,CN,2008.0,319,201,118
GB,RU,2011.0,95,65,30
IR,AU,2015.0,151,47,104
FR,SA,2019.0,62,18,44
IR,PK,2014.0,14,10,4
NL,ES,2005.0,53,35,18
CA,PL,2018.0,47,30,17
RS,TR,2011.0,87,63,24
BR,CL,2021.0,101,83,18
SE,SI,2019.0,3,8,-5
DE,CH,2020.0,1041,857,184
RU,UA,2005.0,99,86,13
CH,FR,2022.0,180,209,-29
GB,MX,2000.0,35,18,17
CN,PL,2010.0,40,34,6
GB,SG,2002.0,58,45,13
BE,NL,2005.0,162,133,29
UY,MX,2020.0,20,14,6
GR,US,2015.0,212,154,58
BR,JP,2002.0,27,31,-4
QA,AE,2015.0,7,10,-3
IN,FR,2016.0,125,131,-6
BA,HR,2015.0,28,31,-3
AU,IR,2020.0,83,190,-107
US,PH,2004.0,279,255,24
BE,FR,2011.0,309,318,-9
FR,GB,2002.0,335,292,43
RS,HR,2011.0,84,126,-42
CL,VE,2008.0,13,21,-8
IN,JP,2011.0,134,133,1
AU,IL,2022.0,8,13,-5
BR,CO,2013.0,101,114,-13
IN,SA,2014.0,125,53,72
MX,FR,2021.0,41,49,-8
JP,GB,2018.0,276,381,-105
FI,DE,2008.0,43,45,-2
PE,BR,2009.0,21,16,5
AT,GB,2016.0,127,105,22
JP,CA,2005.0,128,109,19
GB,JO,2017.0,32,16,16
CN,JP,1997.0,132,126,6
NZ,IN,2013.0,31,18,13
AR,BR,2016.0,173,164,9
JP,RU,2004.0,40,42,-2
JP,BR,2001.0,29,23,6
MY,GB,2006.0,29,64,-35
TR,CY,2015.0,54,28,26
NL,GB,1999.0,135,124,11
CR,AR,2012.0,12,10,2
nan,GB,2002.0,35,53,-18
DE,EG,2018.0,80,60,20
JP,TW,2018.0,85,100,-15
JP,IN,1998.0,70,79,-9
CA,IS,2003.0,4,1,3
NL,ES,2002.0,36,37,-1
IN,AU,2009.0,108,69,39
PT,US,2008.0,100,141,-41
FR,JP,2014.0,136,120,16
VE,CO,2006.0,18,20,-2
BR,DK,2005.0,6,6,0
NL,DE,2020.0,410,421,-11
CN,QA,2021.0,47,25,22
RU,CH,2014.0,40,24,16
RU,DE,2007.0,143,132,11
GB,HU,2003.0,27,32,-5
EG,BH,2015.0,6,8,-2
AE,IN,2009.0,10,19,-9
nan,DE,2016.0,71,77,-6
CZ,AT,2010.0,12,16,-4
ES,VE,2009.0,74,97,-23
IT,FR,2001.0,153,186,-33
JP,IN,1997.0,43,41,2
IE,NL,2012.0,20,19,1
CH,IL,2011.0,11,19,-8
CZ,SK,2013.0,96,121,-25
BN,BD,2006.0,1,1,0
NZ,CH,2001.0,5,6,-1
BO,ES,2007.0,9,1,8
CH,DE,2006.0,404,663,-259
CN,PL,2017.0,18,27,-9
ES,US,2022.0,639,600,39
CH,IT,2007.0,117,234,-117
CH,CA,2014.0,120,146,-26
GB,EG,2016.0,107,73,34
BT,CN,2018.0,1,2,-1
HU,US,2012.0,115,95,20
SE,DE,2012.0,156,207,-51
AR,PA,2019.0,5,5,0
PK,CN,2005.0,85,28,57
RO,HU,2003.0,39,19,20
AT,PK,2014.0,11,8,3
CA,CH,2016.0,151,121,30
IL,US,1998.0,303,301,2
FI,SE,2018.0,114,109,5
NO,DK,2021.0,119,87,32
CN,GR,2013.0,24,14,10
CN,FR,2011.0,186,245,-59
QA,CN,2009.0,18,14,4
IE,CN,2010.0,32,39,-7
CN,IE,2007.0,34,27,7
IR,DE,2019.0,176,90,86
nan,US,2021.0,205,201,4
ES,BD,2011.0,39,7,32
CN,PT,2003.0,11,10,1
FR,GB,2005.0,355,320,35
SA,CA,2009.0,29,65,-36
CN,RU,2012.0,58,53,5
CN,GH,2013.0,7,5,2
DE,BR,2016.0,273,239,34
FR,CH,2020.0,507,366,141
CN,IL,2005.0,8,15,-7
US,LT,2009.0,13,9,4
MX,PE,2016.0,103,123,-20
FR,nan,2013.0,154,220,-66
NP,NZ,2013.0,27,28,-1
TR,IQ,2019.0,22,10,12
SI,AT,2018.0,40,9,31
CR,CL,2018.0,36,34,2
VE,LT,2005.0,3,1,2
IN,KE,2020.0,11,9,2
PH,PE,2016.0,3,2,1
FI,IN,2019.0,14,40,-26
AT,NL,2016.0,25,31,-6
US,UA,2014.0,59,57,2
TR,BG,2018.0,1,1,0
CH,CN,2009.0,60,67,-7
BE,EG,2014.0,8,8,0
CH,ET,2017.0,6,6,0
GE,US,2016.0,164,169,-5
CH,NL,2018.0,104,125,-21
US,PE,2021.0,110,124,-14
CH,SE,2021.0,80,64,16
MY,DE,2001.0,5,1,4
GB,AU,2023.0,75,62,13
AU,SA,2013.0,29,12,17
GE,DE,2020.0,8,6,2
FR,SA,2010.0,12,8,4
CZ,NL,2012.0,18,26,-8
US,VE,2018.0,27,54,-27
FI,CN,2011.0,29,20,9
SE,FR,2011.0,50,56,-6
JP,CA,2002.0,114,98,16
LT,ES,2014.0,3,1,2
JP,TR,2016.0,27,23,4
IL,US,1997.0,240,259,-19
IN,MV,2020.0,3,1,2
MY,EG,2013.0,36,29,7
IL,UA,2019.0,9,6,3
IT,AT,2007.0,23,30,-7
RU,ES,2016.0,18,35,-17
PA,US,2012.0,44,44,0
CH,RU,2020.0,36,39,-3
AR,nan,2004.0,18,18,0
GB,CZ,2018.0,55,50,5
DE,PL,2001.0,50,59,-9
HU,NO,2006.0,5,3,2
AT,DK,2013.0,18,10,8
DE,IT,2011.0,204,278,-74
AU,IE,2012.0,88,106,-18
BR,CN,2018.0,49,109,-60
CN,SE,2021.0,88,122,-34
GH,SE,2016.0,1,2,-1
SA,PK,2011.0,23,50,-27
IE,CN,2019.0,47,26,21
ID,IT,2019.0,17,15,2
TW,KR,2013.0,50,29,21
EG,CH,2020.0,5,3,2
CU,MX,2020.0,65,60,5
JP,NZ,2019.0,11,11,0
IT,CN,2020.0,51,53,-2
ID,LK,2020.0,6,7,-1
TR,BR,2014.0,39,19,20
LB,FR,2012.0,32,84,-52
PK,PL,2022.0,5,10,-5
TR,SE,2013.0,17,11,6
PE,FR,2020.0,12,16,-4
GB,FI,2014.0,73,79,-6
NL,AU,2020.0,112,105,7
NE,FR,2020.0,25,20,5
US,BG,2006.0,25,32,-7
NO,JP,2000.0,7,4,3
ES,EG,2016.0,18,7,11
SK,RU,2000.0,5,5,0
PE,CL,2021.0,51,55,-4
US,FI,2002.0,120,109,11
NI,ES,2015.0,6,6,0
GH,US,2019.0,52,61,-9
NZ,MY,2013.0,29,7,22
IN,NL,2016.0,66,60,6
DE,DK,1999.0,62,53,9
US,UG,2020.0,38,34,4
CR,EC,2016.0,27,3,24
NL,BE,2003.0,108,130,-22
ID,SA,2020.0,28,19,9
UY,BR,2015.0,49,32,17
ID,US,2006.0,24,45,-21
BR,BF,2018.0,1,1,0
LV,RU,2007.0,8,10,-2
NO,IN,2002.0,12,35,-23
nan,DK,2012.0,13,18,-5
JP,DK,2019.0,13,8,5
GR,AU,2011.0,8,6,2
CN,IL,2002.0,9,16,-7
CU,CL,2014.0,22,15,7
AT,BE,1998.0,4,6,-2
CN,CH,2009.0,67,60,7
EC,CR,2020.0,22,27,-5
CA,EG,2014.0,84,45,39
EG,CN,2015.0,16,29,-13
US,VN,2012.0,65,43,22
BR,GB,2001.0,64,76,-12
CA,BH,2013.0,4,2,2
MX,TR,2022.0,1,3,-2
DK,NO,2020.0,137,107,30
GB,NG,2022.0,41,78,-37
FR,TN,2016.0,258,166,92
RU,FR,2007.0,67,42,25
PT,PE,2020.0,5,8,-3
DK,BR,2001.0,4,3,1
TH,US,2018.0,146,235,-89
FR,CL,2016.0,65,56,9
IR,AT,2018.0,14,12,2
RS,XK,2021.0,11,6,5
SG,NL,2019.0,25,21,4
KE,ET,2020.0,11,7,4
TR,AZ,2009.0,6,7,-1
DE,TH,2022.0,16,2,14
SG,EC,2017.0,2,1,1
US,CY,2011.0,23,16,7
NP,US,2019.0,121,62,59
US,HK,2014.0,13,15,-2
DE,ID,2020.0,54,41,13
US,NO,1998.0,56,48,8
US,ID,2022.0,100,150,-50
IT,RO,2005.0,8,8,0
GB,AT,2009.0,70,97,-27
PA,GB,2019.0,9,5,4
CZ,BE,1999.0,3,4,-1
CH,ET,2019.0,2,6,-4
PH,CN,2006.0,25,10,15
GB,PK,2011.0,109,82,27
GB,JO,2019.0,55,12,43
NO,SJ,2018.0,3,4,-1
NP,US,2010.0,26,18,8
BR,EC,2012.0,9,10,-1
BE,TR,1998.0,2,5,-3
DZ,TN,2013.0,11,28,-17
RU,CA,2001.0,34,16,18
MY,IN,2012.0,82,105,-23
ID,TW,2018.0,37,65,-28
PT,IT,2018.0,43,50,-7
NZ,DK,2014.0,8,4,4
CO,FR,2022.0,18,16,2
LK,CN,2011.0,10,8,2
CH,IR,2020.0,28,41,-13
NO,TR,2019.0,9,9,0
DZ,ES,2020.0,5,3,2
MY,BD,2020.0,69,44,25
SE,IR,2006.0,9,3,6
SA,NZ,2018.0,6,3,3
VE,EC,2016.0,50,5,45
IN,BY,2020.0,11,4,7
IT,DE,2022.0,192,238,-46
GH,NZ,2015.0,3,1,2
AU,NP,2015.0,6,10,-4
UY,ES,2020.0,52,49,3
DK,NL,2004.0,23,22,1
ZA,DK,2004.0,1,3,-2
EG,MY,2021.0,39,35,4
RU,TW,2021.0,7,4,3
TZ,CA,2019.0,1,1,0
CA,TH,2001.0,3,5,-2
PT,CN,2004.0,9,8,1
TR,IE,2018.0,11,1,10
RE,FR,2020.0,48,74,-26
JO,LY,2021.0,3,1,2
VN,US,2012.0,43,65,-22
CH,PT,2022.0,21,20,1
NO,CA,2019.0,28,41,-13
JO,CA,2021.0,11,10,1
EE,RU,2018.0,11,10,1
DK,IQ,2022.0,1,2,-1
EG,JO,2021.0,33,31,2
TH,ID,2017.0,15,10,5
UA,PK,2021.0,4,9,-5
US,NO,1997.0,48,54,-6
SE,ID,2021.0,7,8,-1
IQ,JO,2022.0,11,8,3
ES,PH,2006.0,6,9,-3
ID,DE,2014.0,17,30,-13
KH,GB,2022.0,9,1,8
SA,QA,2013.0,13,4,9
CA,TR,2000.0,11,8,3
BE,ET,2021.0,11,13,-2
KR,US,2008.0,948,1134,-186
SE,NO,2008.0,99,83,16
TR,US,2015.0,449,491,-42
BD,IN,2002.0,12,8,4
JP,ID,2021.0,164,157,7
ES,CN,1999.0,6,17,-11
BR,AT,2017.0,21,16,5
PA,CO,2016.0,18,13,5
GH,US,2017.0,43,70,-27
PT,UY,2015.0,3,5,-2
ZA,US,2008.0,214,282,-68
ZA,SZ,2016.0,5,2,3
JP,NG,2008.0,3,2,1
IL,ZA,2009.0,3,2,1
AR,US,2000.0,118,79,39
HR,PT,2011.0,2,2,0
IQ,AE,2018.0,9,13,-4
IR,TW,2014.0,5,3,2
nan,TN,2016.0,3,2,1
BE,JP,1999.0,17,11,6
DZ,BE,2019.0,5,7,-2
DE,JP,2022.0,80,91,-11
JP,PK,2020.0,17,9,8
AR,UY,2021.0,37,22,15
CZ,AT,2019.0,48,24,24
NL,PK,2013.0,7,6,1
IE,MY,2018.0,8,10,-2
ZA,IE,2017.0,14,8,6
FI,JP,2005.0,19,17,2
FR,US,2023.0,52,29,23
CA,NO,2020.0,39,34,5
ET,SE,2014.0,4,6,-2
IR,BE,2012.0,20,20,0
AM,CA,2016.0,1,3,-2
BD,JP,2016.0,55,62,-7
MX,CL,2007.0,81,65,16
PL,RO,2014.0,11,2,9
DK,RU,2012.0,12,8,4
UG,CH,2008.0,2,2,0
PE,UY,2012.0,2,3,-1
KE,CH,2016.0,5,3,2
SE,IS,2021.0,21,12,9
SG,MY,2011.0,129,51,78
IT,IN,2003.0,31,41,-10
DZ,SA,2008.0,7,1,6
CA,AT,2001.0,16,13,3
CH,IE,2019.0,10,23,-13
AM,DE,2005.0,6,2,4
MM,SG,2009.0,1,1,0
EG,CA,2008.0,32,26,6
DE,JO,2007.0,10,3,7
SG,IR,2014.0,26,31,-5
SI,CN,2004.0,4,1,3
GB,GH,2004.0,12,5,7
NL,BR,2001.0,7,16,-9
NO,RU,2020.0,22,14,8
FI,BG,2015.0,1,1,0
TR,TH,2018.0,1,4,-3
US,KE,2003.0,22,30,-8
IN,EG,2021.0,17,14,3
VE,GB,2007.0,7,11,-4
EE,UA,2019.0,5,3,2
SI,CZ,2017.0,5,8,-3
FI,AE,2016.0,3,2,1
FI,DK,2010.0,13,12,1
CO,VE,2012.0,40,66,-26
DE,BE,2000.0,59,57,2
IR,BR,2018.0,15,14,1
CU,PE,2011.0,7,5,2
MY,FR,2018.0,9,13,-4
ZA,KR,2017.0,3,7,-4
CZ,AT,2017.0,33,23,10
IR,IN,2014.0,18,48,-30
DO,IT,2017.0,3,2,1
NG,EG,2021.0,7,4,3
DK,IT,2014.0,27,51,-24
LB,IT,2020.0,11,22,-11
NL,QA,2018.0,5,3,2
LV,DE,2018.0,4,9,-5
PL,GE,2018.0,1,1,0
IT,UY,2013.0,15,9,6
CH,IE,2017.0,19,25,-6
AU,ES,1998.0,8,7,1
SK,GB,2022.0,7,1,6
JP,CZ,2010.0,9,16,-7
PK,TR,2021.0,11,12,-1
IE,CN,2017.0,32,29,3
BE,CZ,2015.0,14,10,4
NO,IS,2000.0,1,4,-3
nan,IL,2000.0,11,9,2
JP,TZ,2007.0,4,2,2
IQ,YE,2017.0,2,2,0
CA,CL,2004.0,7,11,-4
RU,CN,2022.0,35,33,2
IR,IE,2018.0,16,15,1
HN,PE,2020.0,4,1,3
DE,BA,2018.0,9,6,3
BR,AT,2010.0,7,7,0
BE,ES,2003.0,20,22,-2
PL,JP,2011.0,18,15,3
BD,PK,2009.0,14,17,-3
DK,CZ,2017.0,4,10,-6
AU,BR,2001.0,21,17,4
BR,FR,2001.0,44,81,-37
DE,CA,1997.0,67,77,-10
DE,NP,2015.0,4,1,3
nan,MX,2014.0,23,27,-4
IR,DE,2010.0,45,40,5
TH,AU,2022.0,13,9,4
EE,BE,2018.0,3,4,-1
IN,TR,2002.0,5,2,3
JP,DK,2017.0,15,15,0
SK,NZ,2019.0,1,1,0
IT,TR,2021.0,14,27,-13
NO,IN,2005.0,13,13,0
JO,US,2005.0,17,47,-30
US,BH,2022.0,11,10,1
SI,RS,2016.0,24,20,4
KE,CN,2013.0,14,8,6
RO,CN,2020.0,10,10,0
SI,CZ,2010.0,5,7,-2
DE,GA,2009.0,1,6,-5
US,FO,2020.0,2,1,1
TH,ID,2019.0,28,22,6
TH,NG,2022.0,2,8,-6
NL,NO,2016.0,50,34,16
HU,RO,2009.0,30,24,6
KR,AU,2021.0,34,27,7
FR,RO,2007.0,31,25,6
FR,MD,2022.0,19,19,0
MD,TN,2011.0,13,11,2
FR,GR,2021.0,38,27,11
FR,IQ,2020.0,15,1,14
CN,LB,2022.0,34,12,22
FR,LU,2022.0,17,13,4
DZ,SE,2022.0,3,2,1
AE,JO,2021.0,15,25,-10
ZA,MW,2016.0,8,10,-2
DK,JP,2002.0,8,8,0
IT,AU,2021.0,51,53,-2
US,ZW,2000.0,5,5,0
CA,NG,2021.0,14,18,-4
ES,JP,2016.0,67,33,34
AT,EG,2007.0,3,3,0
UA,SE,2010.0,9,6,3
UY,AR,2014.0,34,37,-3
ZA,IT,2007.0,8,8,0
FR,IE,1999.0,10,5,5
FR,NO,2015.0,56,59,-3
BE,RU,2004.0,14,22,-8
US,IR,2023.0,8,26,-18
FR,SA,2017.0,42,18,24
AT,PT,2014.0,2,10,-8
KR,IL,2015.0,8,9,-1
SA,NL,2019.0,8,16,-8
CU,BE,2017.0,8,1,7
CN,PL,2019.0,25,22,3
FI,NL,2021.0,30,21,9
VN,PK,2007.0,1,1,0
RS,ME,2012.0,9,10,-1
CH,GH,2009.0,1,1,0
PT,AR,2020.0,19,19,0
UA,SE,2019.0,5,9,-4
DK,CA,1998.0,10,15,-5
NL,TW,2009.0,6,8,-2
BB,JM,2013.0,7,4,3
AT,EE,2018.0,4,2,2
PY,US,2014.0,4,6,-2
ES,NZ,2021.0,6,5,1
MX,QA,2016.0,1,1,0
NO,CA,2010.0,16,21,-5
BY,CZ,2016.0,12,22,-10
HU,RU,2008.0,5,7,-2
IR,GB,2005.0,18,67,-49
GM,US,2018.0,3,2,1
AE,KW,2007.0,6,1,5
LU,US,2021.0,16,23,-7
SK,CH,2018.0,12,9,3
CY,US,2013.0,17,26,-9
DK,MX,2015.0,6,6,0
AU,ZA,1998.0,19,10,9
AT,CH,1999.0,35,42,-7
JP,AM,2006.0,9,6,3
PT,SE,2020.0,20,14,6
IL,CZ,2003.0,4,1,3
PL,TR,2019.0,8,5,3
US,AM,2005.0,8,5,3
RU,UA,2002.0,69,90,-21
CZ,LT,2006.0,5,2,3
MY,CH,2020.0,3,3,0
FI,JP,2002.0,6,10,-4
RS,DE,2012.0,22,27,-5
FI,MX,2020.0,1,5,-4
TW,GR,2015.0,4,2,2
MD,MA,2007.0,6,1,5
DK,GL,2016.0,8,3,5
CZ,BY,2015.0,15,15,0
DE,PT,2008.0,36,27,9
AT,BG,2012.0,2,2,0
SI,NL,2016.0,7,5,2
SI,CO,2018.0,2,3,-1
nan,SI,2021.0,4,1,3
TW,CA,2021.0,24,34,-10
NL,PT,2020.0,32,22,10
ES,ID,2000.0,2,2,0
RU,MX,2021.0,8,13,-5
KE,PK,2006.0,6,6,0
IN,nan,2008.0,19,21,-2
JP,CZ,2017.0,21,27,-6
ES,NO,2009.0,18,16,2
AR,GB,2008.0,26,16,10
FR,BG,2015.0,6,10,-4
PE,GB,2023.0,1,2,-1
RO,UA,2022.0,8,1,7
MY,nan,2011.0,34,50,-16
US,HU,1999.0,61,83,-22
TR,MY,2015.0,10,17,-7
HR,SK,2022.0,3,5,-2
NZ,SA,2014.0,4,2,2
FR,KW,2015.0,5,3,2
RU,PT,2002.0,10,4,6
NL,HU,2007.0,10,6,4
IT,HU,2007.0,7,9,-2
DE,LB,2018.0,8,8,0
BE,SI,2015.0,4,8,-4
NL,SA,2021.0,6,6,0
RS,NL,2008.0,6,5,1
SE,SK,1999.0,2,3,-1
ZA,NL,2006.0,20,26,-6
IL,nan,1998.0,11,8,3
RU,LT,1998.0,7,2,5
BR,JP,2005.0,32,38,-6
JP,NZ,2010.0,21,10,11
KR,SA,2017.0,24,16,8
NO,PL,2015.0,7,14,-7
CM,SN,2004.0,2,2,0
SA,NL,2017.0,3,8,-5
BD,IN,2005.0,20,16,4
ID,PE,2020.0,3,7,-4
CA,BD,2007.0,13,4,9
IT,PK,2006.0,4,2,2
GH,US,2010.0,6,26,-20
NZ,ZA,2021.0,16,12,4
NZ,BD,2017.0,2,5,-3
ZA,MZ,2022.0,1,2,-1
CN,IS,2017.0,1,1,0
IN,GH,2016.0,4,7,-3
VE,JP,1998.0,2,1,1
MT,GB,2013.0,9,16,-7
US,NC,2021.0,2,4,-2
ID,MX,2020.0,3,3,0
TT,JM,2008.0,15,16,-1
AU,PH,2015.0,12,16,-4
TW,CH,2021.0,7,8,-1
TN,CH,2007.0,5,4,1
AU,MK,2016.0,49,75,-26
CN,ET,2006.0,1,1,0
BE,HU,2018.0,10,16,-6
ES,IL,2020.0,16,9,7
ML,IN,2013.0,4,4,0
PE,CO,1998.0,4,5,-1
FR,SG,1997.0,2,3,-1
SG,SE,2017.0,15,26,-11
IR,FI,2014.0,9,5,4
AT,IN,2011.0,8,17,-9
TR,IL,2015.0,1,4,-3
IE,CH,2021.0,12,13,-1
AU,JO,2012.0,10,5,5
US,RS,2023.0,1,3,-2
AU,AT,2013.0,25,23,2
PS,JO,2011.0,1,3,-2
UY,US,2022.0,15,13,2
BZ,US,2020.0,1,2,-1
MX,SE,2011.0,7,4,3
BD,MA,2021.0,17,18,-1
GB,MT,2018.0,19,17,2
IN,CH,2003.0,19,14,5
IT,SG,2021.0,6,5,1
FR,LV,2019.0,2,1,1
CL,PT,2022.0,9,7,2
IQ,SE,2020.0,5,4,1
TR,RS,1999.0,11,14,-3
IN,FI,2003.0,6,1,5
HR,FR,2014.0,8,4,4
CA,UA,1998.0,2,2,0
GB,IL,2014.0,56,63,-7
MD,UA,2009.0,2,1,1
TR,CN,2000.0,4,4,0
NL,TH,2021.0,6,3,3
AE,CA,2018.0,24,26,-2
PT,MY,2017.0,1,2,-1
KR,SA,2019.0,27,10,17
GB,NP,2015.0,9,11,-2
HR,GB,2016.0,18,23,-5
PA,DE,2015.0,5,4,1
JO,NL,2007.0,5,2,3
BR,SG,2020.0,2,4,-2
BE,AR,2018.0,10,14,-4
GB,SY,2014.0,10,2,8
LB,EG,2011.0,4,4,0
HU,RS,2015.0,6,6,0
JP,CZ,2019.0,25,24,1
FI,IT,2006.0,4,7,-3
ZW,RU,2020.0,17,30,-13
LA,TR,2022.0,4,3,1
JO,MY,2012.0,10,7,3
GH,IT,2019.0,6,1,5
CR,US,2016.0,26,46,-20
IT,PS,2020.0,4,2,2
SY,SA,2015.0,4,5,-1
GR,NO,2022.0,4,4,0
RU,FI,2015.0,24,36,-12
SE,ES,2013.0,42,78,-36
ES,BE,2000.0,15,15,0
BG,DE,2013.0,18,23,-5
CL,IT,2010.0,15,16,-1
FR,TR,2016.0,27,25,2
AU,SK,2022.0,1,1,0
KR,BD,2005.0,2,3,-1
BE,GB,2006.0,95,93,2
JP,PL,2014.0,29,23,6
CA,RS,2001.0,4,4,0
ZA,BR,2012.0,9,7,2
TW,BR,2007.0,3,3,0
BE,LU,2014.0,28,12,16
MX,IN,2006.0,6,9,-3
NO,TR,2010.0,1,2,-1
AU,SE,2022.0,33,34,-1
AU,ID,2006.0,21,5,16
AM,KR,2008.0,8,9,-1
TZ,CA,2010.0,3,2,1
DE,TW,2008.0,15,21,-6
GB,JO,2010.0,23,7,16
RO,DE,2003.0,27,14,13
FI,DK,2017.0,27,22,5
CR,NL,2015.0,4,2,2
ES,NL,1997.0,16,18,-2
CN,SY,2016.0,14,12,2
JP,AG,2022.0,3,10,-7
NL,LT,2007.0,4,1,3
DE,IE,1999.0,15,10,5
SI,LV,2013.0,5,1,4
PL,IT,2003.0,7,18,-11
GB,SS,2020.0,6,7,-1
ES,NL,1998.0,20,34,-14
DE,IQ,2015.0,9,3,6
PL,NL,2015.0,15,22,-7
AR,PA,2017.0,7,3,4
ID,nan,2009.0,11,1,10
DE,GE,2022.0,3,1,2
DK,CZ,2010.0,5,2,3
ES,IN,2007.0,10,14,-4
CU,DE,2012.0,5,2,3
TZ,US,2011.0,17,16,1
NP,DE,2018.0,4,5,-1
AT,SE,2022.0,19,23,-4
RS,CZ,2012.0,12,17,-5
IE,IT,2001.0,5,1,4
GH,UG,2019.0,4,2,2
JP,RO,2018.0,4,2,2
PA,GB,2017.0,9,11,-2
VG,US,1998.0,4,4,0
SK,AT,2008.0,6,14,-8
NL,PL,2015.0,22,15,7
IT,TN,2008.0,5,4,1
NZ,BD,2010.0,2,4,-2
IL,RS,2003.0,4,2,2
LV,SE,2009.0,1,7,-6
SA,IE,2011.0,2,2,0
NO,MW,2013.0,3,1,2
FR,EC,2000.0,3,2,1
UA,EE,2018.0,2,3,-1
CZ,RO,2012.0,16,7,9
JP,IE,2020.0,27,30,-3
CH,SK,2002.0,6,7,-1
TN,DZ,2017.0,27,18,9
FI,DK,2019.0,25,23,2
SE,AU,1998.0,13,21,-8
EG,TW,2006.0,2,1,1
CZ,NO,2014.0,9,3,6
SG,NL,2010.0,8,9,-1
GB,DZ,2021.0,5,11,-6
AU,KW,2016.0,3,1,2
CH,SK,2005.0,5,7,-2
SN,GN,2019.0,4,1,3
GR,SE,2003.0,4,7,-3
nan,SE,2021.0,18,11,7
CL,CU,2016.0,15,26,-11
AR,TW,2016.0,10,7,3
KW,GB,2014.0,6,14,-8
NG,KE,2012.0,3,4,-1
PL,ES,1999.0,3,3,0
BR,EG,2014.0,2,2,0
AU,TZ,2015.0,1,1,0
BO,MX,2007.0,3,4,-1
US,FJ,2018.0,4,5,-1
CH,NO,2000.0,10,9,1
KR,PH,2000.0,1,3,-2
PT,SA,2020.0,4,2,2
PH,KR,2011.0,7,3,4
IE,NZ,1999.0,5,2,3
FI,ZA,2012.0,2,4,-2
FR,MX,1997.0,11,13,-2
DK,SG,2010.0,3,3,0
OM,JP,2000.0,2,2,0
SJ,DK,2013.0,4,1,3
IL,CH,1999.0,5,11,-6
ES,AU,2004.0,16,16,0
BR,AT,2019.0,30,11,19
BR,VE,2018.0,19,36,-17
ES,FI,1999.0,5,4,1
BD,OM,2016.0,3,1,2
PL,TR,2010.0,3,3,0
PE,BO,2017.0,10,5,5
NO,CZ,2003.0,2,2,0
DE,VE,2003.0,6,3,3
CH,BG,2012.0,2,1,1
ZA,KR,2019.0,5,6,-1
MX,CH,2015.0,14,13,1
AT,HR,2001.0,3,2,1
HU,IN,2001.0,5,17,-12
DK,JP,2005.0,13,11,2
NL,IL,2013.0,11,12,-1
CZ,KR,2018.0,6,10,-4
HR,RS,2023.0,1,6,-5
KR,UA,2001.0,1,1,0
PT,DE,2000.0,10,6,4
RO,GB,1999.0,9,2,7
GB,SI,2007.0,11,12,-1
CL,JP,2007.0,2,2,0
TN,DZ,2010.0,7,5,2
IN,TN,2015.0,8,2,6
PL,TR,2017.0,3,8,-5
CN,HU,2018.0,9,8,1
JO,US,2002.0,6,21,-15
MY,TR,2009.0,2,2,0
JP,IL,1998.0,6,6,0
NL,ZW,2014.0,2,3,-1
ID,BD,2012.0,7,5,2
SE,TR,2013.0,11,17,-6
AT,UA,2021.0,1,13,-12
BR,PH,2021.0,7,8,-1
KY,US,2020.0,1,2,-1
SG,MM,2019.0,6,4,2
PT,MZ,2021.0,5,8,-3
MT,AU,2018.0,2,3,-1
TN,ID,2013.0,2,1,1
SK,IN,2021.0,1,2,-1
FR,NZ,2022.0,3,9,-6
ES,LU,2021.0,6,3,3
TR,DZ,2022.0,1,3,-2
BG,NL,1998.0,2,1,1
CG,NG,2018.0,2,1,1
RU,SE,2000.0,27,26,1
BD,PL,2012.0,2,2,0
JP,KE,2016.0,11,5,6
AT,BE,1997.0,4,1,3
IN,IR,2007.0,8,10,-2
UA,BE,2012.0,2,4,-2
RU,TH,2018.0,4,1,3
EE,GB,2016.0,10,9,1
SA,TR,2018.0,18,21,-3
GB,IS,2013.0,6,7,-1
PL,CH,2004.0,8,6,2
FR,GF,1997.0,3,1,2
RO,FI,2014.0,2,3,-1
CO,KR,2014.0,10,1,9
NO,TR,2017.0,11,13,-2
FI,RU,2014.0,32,39,-7
EG,IE,2018.0,7,7,0
HR,BA,2007.0,4,10,-6
ZA,KR,2010.0,5,2,3
ZA,KE,2004.0,3,5,-2
PL,RU,2007.0,20,16,4
CA,BJ,2015.0,4,1,3
PE,PY,2018.0,4,3,1
IE,MX,2013.0,1,1,0
ET,GH,2016.0,1,1,0
CN,AT,2014.0,20,16,4
CA,NL,1999.0,25,27,-2
GB,MK,2015.0,4,8,-4
TZ,KE,2009.0,3,3,0
NO,BR,2022.0,7,17,-10
ZA,CD,2020.0,5,4,1
NZ,ES,2011.0,4,7,-3
CO,PH,2017.0,6,6,0
BE,KR,2007.0,2,4,-2
PK,PT,2010.0,2,1,1
TR,RU,2012.0,6,7,-1
VE,PH,2017.0,2,1,1
FI,KW,2005.0,1,2,-1
SE,PT,2012.0,8,8,0
IN,PT,2003.0,4,1,3
AZ,TR,2007.0,6,1,5
MA,PL,2015.0,1,1,0
MX,GT,2000.0,3,2,1
EC,BE,2008.0,1,2,-1
RO,IT,2022.0,6,8,-2
MT,ES,2015.0,2,4,-2
IN,ZA,1997.0,3,2,1
MN,DE,2016.0,1,3,-2
UA,IT,2006.0,9,11,-2
KE,NG,2013.0,2,1,1
BE,CL,2012.0,7,8,-1
ZA,IE,2010.0,6,8,-2
CL,AU,2003.0,5,3,2
CR,PA,2018.0,3,2,1
DE,CY,2009.0,4,1,3
ZA,UG,2006.0,2,3,-1
CO,NL,2011.0,7,4,3
LT,IT,2017.0,3,3,0
RO,SA,2017.0,2,1,1
ML,US,2003.0,2,3,-1
AE,AU,2008.0,3,13,-10
PL,NO,2016.0,15,3,12
FR,GN,2016.0,3,4,-1
MX,PA,2002.0,1,1,0
BN,GB,1998.0,2,1,1
CH,RS,2018.0,6,11,-5
AR,PL,2005.0,1,1,0
DK,SG,2017.0,1,7,-6
PH,CZ,2011.0,2,1,1
EE,NL,2018.0,5,7,-2
PK,IR,2022.0,8,9,-1
HR,DE,2002.0,8,20,-12
CH,JP,2023.0,1,1,0
ES,DO,2022.0,6,3,3
NL,LU,2014.0,5,1,4
ZA,IR,2022.0,2,3,-1
ZA,nan,2008.0,3,15,-12
HT,FR,2019.0,1,5,-4
KR,BE,2011.0,4,7,-3
CO,PH,2019.0,8,10,-2
SA,IN,2023.0,10,9,1
PE,BO,2010.0,5,2,3
RO,CZ,2012.0,7,16,-9
GH,AU,2008.0,2,2,0
IN,TR,2005.0,2,4,-2
SG,SE,2010.0,8,14,-6
BO,CN,2018.0,1,2,-1
CM,BE,2018.0,6,3,3
nan,CL,2008.0,4,5,-1
PH,NP,2018.0,4,8,-4
MZ,PT,2012.0,3,2,1
KE,BH,2015.0,3,5,-2
ES,DK,2023.0,4,2,2
DZ,BE,2010.0,4,5,-1
nan,VE,2018.0,2,1,1
SG,HU,2011.0,3,1,2
BE,TH,2012.0,2,3,-1
MK,IN,2017.0,2,2,0
DZ,NO,2021.0,2,1,1
AU,NC,2008.0,2,1,1
BD,NZ,2017.0,5,2,3
AU,AE,2011.0,8,6,2
JP,IQ,2008.0,2,2,0
ID,NZ,2014.0,5,5,0
RS,IT,2000.0,3,1,2
HN,ES,2011.0,5,4,1
SG,SA,2022.0,4,2,2
DK,SG,2019.0,4,8,-4
EG,KW,2001.0,5,8,-3
US,IS,2003.0,13,6,7
LK,MY,2020.0,4,8,-4
SD,KW,2011.0,1,1,0
SD,US,2020.0,7,13,-6
BH,IR,2019.0,1,3,-2
HU,PL,2002.0,9,11,-2
nan,FI,2022.0,1,1,0
FR,LB,2023.0,2,3,-1
RU,EE,2008.0,8,8,0
LT,NL,2008.0,2,3,-1
GR,RU,2004.0,3,2,1
MK,DE,2019.0,2,2,0
FI,TR,2020.0,6,13,-7
AE,BE,2007.0,3,1,2
NL,BJ,2013.0,3,3,0
IN,ZA,1998.0,2,4,-2
AE,KR,2019.0,5,8,-3
CD,ES,2011.0,1,1,0
VE,CR,2009.0,2,3,-1
CA,EC,2020.0,4,6,-2
PL,TW,2021.0,2,2,0
FR,LT,2021.0,2,3,-1
PH,ET,2016.0,1,1,0
IT,NG,2022.0,5,1,4
NG,AU,2012.0,4,2,2
NZ,FJ,2018.0,3,4,-1
PK,EG,2003.0,2,1,1
CN,FI,1998.0,6,8,-2
UA,SE,2017.0,8,10,-2
JP,QA,2013.0,6,2,4
JP,AT,2022.0,4,10,-6
TH,MM,2016.0,4,4,0
AT,CN,2015.0,13,22,-9
NO,CA,2017.0,15,40,-25
GB,ZM,2022.0,2,3,-1
HU,PL,2005.0,9,18,-9
ID,MY,2007.0,11,23,-12
SG,MM,2017.0,9,2,7
KE,SE,2009.0,1,4,-3
MY,TH,2012.0,3,5,-2
CA,AR,2003.0,9,13,-4
GT,AR,2021.0,2,4,-2
LV,KR,2021.0,1,2,-1
TZ,ET,2020.0,2,2,0
IE,GR,2011.0,5,1,4
BG,UA,1999.0,7,2,5
nan,PT,2000.0,4,7,-3
CL,NZ,2014.0,8,3,5
AR,BE,2006.0,6,7,-1
SE,TZ,2008.0,1,8,-7
IE,PK,2007.0,1,2,-1
IN,ES,2011.0,16,27,-11
PK,ZA,2015.0,2,3,-1
GN,SN,2014.0,4,3,1
BF,SN,2020.0,2,5,-3
SI,NO,2009.0,2,1,1
ZA,IE,2019.0,12,9,3
BD,IL,2008.0,1,3,-2
IL,UA,2017.0,4,7,-3
LK,AU,1997.0,1,2,-1
DO,AR,2018.0,3,1,2
SA,TN,2015.0,19,70,-51
AU,CL,2007.0,4,8,-4
JP,NZ,2017.0,5,14,-9
TZ,CA,2017.0,3,3,0
VE,UY,2020.0,3,3,0
IE,EG,2008.0,3,2,1
UZ,RS,2008.0,2,3,-1
AE,GB,1998.0,8,3,5
GT,PE,2016.0,3,1,2
TJ,PK,2017.0,1,1,0
CO,KE,2011.0,3,4,-1
AU,BE,1999.0,9,13,-4
US,GM,2004.0,2,1,1
FR,SG,1998.0,4,1,3
CN,MM,2018.0,4,2,2
EC,SE,2009.0,1,2,-1
PK,NL,2013.0,6,7,-1
JP,KH,2013.0,3,5,-2
ZA,SE,2014.0,11,14,-3
LU,CH,2019.0,8,6,2
BD,SE,2006.0,2,4,-2
BR,ZM,2008.0,2,2,0
PG,AU,2000.0,3,3,0
IE,IL,2016.0,3,5,-2
AU,VE,2008.0,3,1,2
AE,BR,2018.0,2,5,-3
DE,LT,2007.0,2,5,-3
UY,CO,2015.0,7,13,-6
SK,RS,2014.0,5,8,-3
IN,AT,2000.0,2,16,-14
ID,UG,2021.0,2,1,1
NG,JP,2009.0,3,1,2
SI,IT,2001.0,2,5,-3
FR,ET,2017.0,3,1,2
LT,IT,2010.0,1,1,0
SE,LT,2015.0,6,4,2
AM,ZW,2010.0,1,1,0
BE,NE,2020.0,4,1,3
SA,DK,2017.0,4,3,1
NO,ID,2012.0,1,4,-3
TN,PT,2011.0,1,1,0
DK,IR,2005.0,2,1,1
KZ,CN,2012.0,11,13,-2
CN,SD,2016.0,4,6,-2
PH,EC,2016.0,1,2,-1
BA,HU,2014.0,2,1,1
AR,GT,2012.0,3,1,2
PK,NG,2021.0,4,11,-7
IT,LB,2009.0,8,3,5
UA,JP,2015.0,3,10,-7
IL,PL,2015.0,6,6,0
BH,CA,2018.0,2,1,1
VN,PL,2021.0,1,3,-2
MK,AT,2011.0,3,4,-1
DE,RS,2001.0,5,7,-2
TD,FR,2017.0,3,5,-2
KZ,US,2014.0,8,21,-13
PK,PT,2019.0,2,2,0
IR,SE,2003.0,2,4,-2
NL,NG,2008.0,3,2,1
BA,US,2003.0,1,4,-3
CR,VE,2008.0,2,1,1
CH,IE,2010.0,16,13,3
LT,PL,2016.0,4,2,2
JP,MA,2004.0,1,2,-1
CM,AT,2014.0,1,1,0
RO,ES,2007.0,8,7,1
IT,RO,2002.0,5,4,1
SA,TW,2016.0,4,6,-2
JP,MN,2009.0,2,1,1
IS,CA,2009.0,2,2,0
MA,IN,2011.0,4,1,3
NG,GH,2008.0,4,3,1
CL,LU,2022.0,2,2,0
DO,MX,2016.0,2,2,0
IR,CL,2018.0,1,1,0
KR,RO,2001.0,1,1,0
BR,IE,2011.0,8,4,4
AU,TR,2004.0,7,2,5
ZM,NG,2003.0,1,1,0
OM,JO,2006.0,3,1,2
IL,nan,1997.0,7,8,-1
UZ,ES,2012.0,1,1,0
LT,IT,2019.0,3,1,2
PA,CR,2008.0,1,1,0
CO,DO,2014.0,3,4,-1
HK,TW,2015.0,3,2,1
AU,SI,2015.0,6,5,1
DE,BY,2000.0,4,6,-2
IR,RU,2015.0,14,9,5
CU,PT,2016.0,2,1,1
RU,KZ,2008.0,9,18,-9
ES,EC,2023.0,2,1,1
TR,IS,2016.0,2,2,0
PH,FI,2006.0,1,2,-1
MC,BE,2018.0,1,1,0
IE,AR,2012.0,1,1,0
IT,ET,2013.0,1,1,0
nan,EG,2014.0,2,3,-1
FR,MC,1999.0,2,2,0
SI,CA,2011.0,1,2,-1
KN,US,2018.0,4,5,-1
NO,LT,2009.0,2,1,1
FR,CG,2000.0,3,8,-5
AL,IT,2008.0,2,1,1
FI,IN,2010.0,2,12,-10
SI,BG,2004.0,1,1,0
CN,AE,2022.0,8,8,0
CA,IQ,2014.0,5,1,4
MY,AU,1999.0,5,10,-5
BR,CR,2009.0,4,4,0
NZ,BD,2019.0,1,4,-3
JP,ZM,2009.0,5,2,3
UA,CA,2009.0,5,3,2
FR,PS,2022.0,2,3,-1
ML,KE,2016.0,1,2,-1
BE,PK,2017.0,3,1,2
ZA,PL,2007.0,3,5,-2
KE,UG,2009.0,3,4,-1
ET,FR,2014.0,3,2,1
PK,AF,2022.0,3,1,2
ID,IT,2010.0,1,7,-6
DE,PH,2021.0,9,6,3
JP,GH,2002.0,1,2,-1
HU,UA,2006.0,1,2,-1
NG,CN,2008.0,3,4,-1
CU,BE,2019.0,3,3,0
LB,BR,2020.0,7,5,2
GA,FR,2016.0,6,7,-1
nan,CZ,2002.0,3,1,2
FR,KR,1999.0,8,6,2
PH,NL,2008.0,5,4,1
UY,IN,2016.0,1,1,0
UA,TJ,2021.0,6,1,5
IT,DO,2013.0,3,2,1
PL,GR,1999.0,5,11,-6
MY,KE,2018.0,4,4,0
PE,PH,2011.0,1,3,-2
CA,LB,1999.0,4,3,1
GH,EG,2014.0,2,1,1
CO,CZ,2012.0,5,1,4
SA,CY,2020.0,2,1,1
LT,NO,2001.0,2,3,-1
FR,CI,2004.0,3,7,-4
MK,DE,2017.0,1,3,-2
ZA,ET,2003.0,2,2,0
CY,KH,2019.0,3,1,2
FI,AU,2011.0,11,8,3
CO,PY,2005.0,1,1,0
CN,MK,2017.0,7,1,6
TH,BD,2015.0,4,3,1
NZ,AR,2013.0,2,1,1
CU,EC,2022.0,3,1,2
IT,CR,2014.0,5,1,4
RE,NC,2022.0,3,1,2
MW,KE,2015.0,1,1,0
FR,TG,2000.0,3,1,2
MX,SV,2020.0,3,9,-6
RO,IE,2020.0,4,7,-3
GB,VN,2006.0,8,3,5
PA,GB,2010.0,4,2,2
ST,CH,2006.0,1,1,0
nan,QA,2014.0,1,1,0
PE,IT,2004.0,1,3,-2
CH,NG,2018.0,3,4,-1
GR,IL,2013.0,3,1,2
TW,YE,2020.0,2,1,1
DK,CO,2012.0,1,1,0
EG,SG,2021.0,5,4,1
US,EE,2001.0,4,8,-4
FR,ET,2019.0,4,6,-2
CH,GR,2000.0,6,8,-2
IT,GT,2020.0,1,5,-4
CH,ZM,2022.0,2,1,1
UY,IT,2014.0,2,10,-8
BJ,CI,2015.0,3,1,2
BE,ID,2009.0,4,1,3
LU,SA,2014.0,1,1,0
IE,FI,2008.0,3,1,2
IT,PH,2004.0,2,1,1
NL,AE,2013.0,6,2,4
NZ,ID,2011.0,2,1,1
QA,SE,1999.0,1,1,0
DO,IT,2019.0,2,4,-2
KZ,NL,2017.0,1,3,-2
PY,AR,2008.0,1,1,0
IL,EC,2011.0,1,1,0
AU,ES,1997.0,3,9,-6
US,AM,2002.0,1,6,-5
PE,CO,1997.0,2,3,-1
KE,KH,2019.0,2,1,1
AR,IE,2016.0,3,1,2
PE,CH,2016.0,5,2,3
CN,SI,2004.0,1,4,-3
PT,CL,2009.0,8,6,2
IL,HU,2001.0,1,5,-4
SN,BE,2019.0,1,3,-2
UA,UZ,2012.0,1,1,0
PL,BA,2014.0,2,1,1
SA,SE,2013.0,3,10,-7
DE,MA,2005.0,4,6,-2
NG,FR,2020.0,11,10,1
BR,HR,2021.0,2,1,1
MA,CI,2014.0,1,1,0
RU,PT,2005.0,4,9,-5
MA,JP,2006.0,1,2,-1
SG,IT,2006.0,4,3,1
SA,BR,2012.0,2,1,1
BR,SV,2021.0,2,2,0
ID,PA,2020.0,1,1,0
IR,SA,2006.0,1,1,0
MD,DE,2021.0,2,3,-1
BN,PK,2020.0,1,1,0
ET,KE,2003.0,2,2,0
BF,BJ,2018.0,1,1,0
SI,CZ,2019.0,4,6,-2
PT,TW,2002.0,1,1,0
SK,HU,2008.0,14,6,8
PT,IL,2014.0,2,3,-1
AM,DE,2002.0,3,3,0
HR,CA,2004.0,2,1,1
TW,SE,2003.0,2,1,1
AE,KR,2017.0,2,5,-3
BD,NZ,2019.0,4,1,3
BD,NZ,2010.0,4,2,2
LT,CH,2015.0,4,1,3
BJ,GA,2018.0,2,1,1
LU,CH,2010.0,5,3,2
NZ,FI,2011.0,3,2,1
CO,PH,2010.0,2,2,0
VE,CL,2001.0,4,5,-1
CN,MX,2006.0,5,7,-2
DK,IN,2000.0,5,4,1
CL,PL,2009.0,1,1,0
CN,CO,2004.0,1,8,-7
MX,JP,2023.0,1,1,0
TH,ID,2010.0,3,1,2
SN,GB,2015.0,2,4,-2
ZA,BD,2021.0,2,1,1
UZ,CN,2016.0,4,1,3
XK,SI,2021.0,1,1,0
AO,PT,2022.0,3,4,-1
IR,BD,2014.0,3,5,-2
TH,FR,1998.0,1,1,0
LB,IN,2011.0,2,2,0
SE,BD,2022.0,3,5,-2
BE,TZ,2009.0,1,2,-1
AU,PE,2016.0,1,4,-3
SA,DK,2019.0,3,2,1
RS,MX,2016.0,3,5,-2
FI,LU,2012.0,2,5,-3
VN,GB,2004.0,4,5,-1
NC,RE,2011.0,1,1,0
SE,SA,2006.0,1,2,-1
US,MK,2000.0,3,2,1
GE,IR,2011.0,1,1,0
CG,NC,2012.0,1,2,-1
SG,HK,2015.0,3,1,2
XK,RS,2021.0,6,11,-5
GM,NG,2018.0,2,6,-4
GE,SK,2002.0,2,1,1
JP,BY,2007.0,1,1,0
MX,PA,2005.0,2,6,-4
CH,IS,2011.0,1,1,0
LT,SG,2011.0,1,1,0
PS,CA,2013.0,1,2,-1
TR,SA,2004.0,3,3,0
IT,CU,1999.0,1,1,0
FO,GB,2020.0,1,1,0
DZ,US,1998.0,2,1,1
BY,NL,2021.0,1,1,0
nan,CZ,2005.0,3,6,-3
AE,IE,2022.0,2,2,0
FR,LK,2001.0,2,1,1
AE,PS,2003.0,1,2,-1
PT,EG,2015.0,2,1,1
ZM,JP,2000.0,2,2,0
IR,TN,2007.0,1,5,-4
PT,MY,2019.0,2,1,1
IT,MT,2009.0,1,2,-1
CM,CG,2017.0,1,1,0
MY,CN,1999.0,2,3,-1
BE,TW,2004.0,1,1,0
TW,AT,2015.0,2,2,0
ES,GR,2000.0,1,4,-3
NZ,SG,1999.0,4,3,1
AU,BN,2021.0,1,1,0
TR,KW,2015.0,3,3,0
LK,BT,2019.0,2,2,0
RU,SK,2003.0,3,6,-3
RO,IN,2001.0,1,1,0
CH,KE,2022.0,1,2,-1
IQ,DE,2009.0,1,2,-1
MX,KR,2004.0,1,1,0
BE,PE,2020.0,3,3,0
AE,DK,2018.0,2,4,-2
DK,LT,2015.0,3,4,-1
RS,RW,2011.0,1,2,-1
EE,PK,2020.0,1,4,-3
LV,LT,2013.0,3,1,2
JP,IL,1997.0,4,4,0
MA,BE,2015.0,5,8,-3
GH,TR,2020.0,1,3,-2
EG,IT,2003.0,3,3,0
ME,HR,2022.0,1,2,-1
CZ,NZ,2010.0,1,1,0
CZ,NZ,2019.0,2,3,-1
SD,SA,2001.0,1,1,0
IQ,SD,2013.0,1,2,-1
UA,HU,2006.0,2,1,1
BD,JO,2012.0,1,1,0
SV,AR,2016.0,1,2,-1
HU,GB,2008.0,65,30,35
JP,US,2014.0,1587,1818,-231
CL,EC,2013.0,21,12,9
IE,CA,2004.0,72,62,10
BR,AO,2004.0,14,7,7
PK,AT,2014.0,8,11,-3
CL,IT,2017.0,29,32,-3
BR,BE,2021.0,74,60,14
nan,GB,2005.0,62,72,-10
VN,CN,1999.0,3,9,-6
CZ,FR,2015.0,33,40,-7
BR,nan,2005.0,33,42,-9
DE,FR,2023.0,14,19,-5
GE,GB,2015.0,2,4,-2
BR,IN,2009.0,15,15,0
TR,IN,2015.0,13,18,-5
BR,AU,2013.0,105,89,16
IT,TW,2012.0,4,1,3
US,RO,2015.0,104,69,35
US,PT,2019.0,199,204,-5
TN,DZ,2019.0,39,31,8
NL,IR,2015.0,26,31,-5
BE,SE,2008.0,18,12,6
CO,EC,2013.0,45,13,32
GR,CY,2016.0,51,35,16
BD,MY,2011.0,31,12,19
IT,GR,2021.0,36,26,10
PE,ES,2001.0,23,13,10
BR,PE,2011.0,26,37,-11
ES,CU,2016.0,81,109,-28
US,PT,2010.0,143,123,20
nan,AR,2015.0,31,41,-10
MY,TW,2003.0,1,2,-1
AT,LT,2020.0,2,2,0
RU,AU,2014.0,39,19,20
JP,PH,2003.0,14,10,4
GD,US,2016.0,26,12,14
RO,LT,2006.0,7,2,5
VN,SG,2018.0,9,19,-10
FR,MX,1998.0,25,19,6
CL,CA,2003.0,8,3,5
NZ,DE,2018.0,45,60,-15
LB,SA,2012.0,6,7,-1
PH,JP,2002.0,14,14,0
SY,FR,2018.0,7,13,-6
PH,JP,2005.0,12,13,-1
CH,IN,2011.0,21,41,-20
MY,JO,2014.0,19,4,15
CL,IT,2019.0,37,46,-9
BR,nan,2002.0,14,8,6
EC,MX,2011.0,9,14,-5
GB,ZW,2021.0,2,7,-5
IT,RU,2008.0,17,25,-8
ID,CN,2008.0,15,8,7
ID,IT,2017.0,5,22,-17
SG,NL,2017.0,13,22,-9
LU,BE,1999.0,2,3,-1
HR,DE,2005.0,15,14,1
NO,ES,2020.0,26,43,-17
GR,BR,2017.0,5,1,4
BE,PK,2019.0,12,3,9
LT,GB,2009.0,4,2,2
DZ,BE,2017.0,6,2,4
IE,NO,2015.0,9,5,4
US,GH,2008.0,11,9,2
GB,LB,2001.0,6,2,4
PL,SE,2014.0,23,22,1
HU,JP,2003.0,15,5,10
SG,SE,2019.0,25,24,1
SG,PL,2021.0,2,2,0
CU,GB,2006.0,7,4,3
FI,NO,2022.0,17,14,3
NC,FR,2013.0,13,15,-2
NG,NZ,2018.0,5,4,1
BH,SA,2016.0,5,6,-1
BI,FR,2008.0,21,19,2
NZ,NL,2012.0,11,18,-7
VE,PH,2019.0,1,2,-1
DE,LU,2009.0,30,12,18
JP,DK,2010.0,15,10,5
FR,PE,2015.0,10,12,-2
JP,BE,1999.0,11,17,-6
SE,IE,2021.0,6,14,-8
LK,NL,2003.0,1,2,-1
CL,PH,2020.0,4,3,1
PL,CO,2010.0,2,1,1
KR,SA,2010.0,9,2,7
SE,AU,1997.0,14,7,7
AE,CN,2013.0,4,5,-1
DE,LV,2009.0,7,3,4
JP,FI,2013.0,17,12,5
SN,US,2008.0,6,13,-7
GR,BR,2019.0,2,6,-4
GR,QA,2015.0,5,1,4
IL,GR,2014.0,3,4,-1
NL,MX,2014.0,15,13,2
BM,US,2013.0,1,2,-1
RS,FR,2015.0,14,12,2
SA,DZ,2007.0,3,4,-1
JO,LB,2016.0,6,4,2
ES,SI,2007.0,5,5,0
KW,MA,2009.0,5,6,-1
PH,VE,2018.0,1,1,0
IN,ZW,2017.0,4,1,3
PE,BO,2019.0,7,12,-5
ME,RS,2004.0,1,2,-1
UG,GB,2022.0,18,10,8
SA,NO,2022.0,5,1,4
BE,KE,2004.0,6,1,5
US,PR,1999.0,1,7,-6
IL,MX,2012.0,3,4,-1
IL,UA,2010.0,4,1,3
IT,BG,2009.0,5,2,3
UA,NI,2016.0,5,5,0
TH,UG,2010.0,1,1,0
KE,KH,2017.0,1,1,0
AR,PA,2010.0,5,4,1
KE,NP,2013.0,1,1,0
GH,UG,2017.0,1,1,0
UG,SE,2005.0,1,1,0
MA,SA,2009.0,2,1,1
UA,PT,2019.0,6,1,5
DK,CA,1997.0,6,12,-6
NA,GB,2020.0,2,3,-1
BD,DE,2011.0,10,8,2
SA,KW,2009.0,4,8,-4
LT,CN,2018.0,4,4,0
NE,NG,2018.0,2,1,1
AU,AR,2006.0,4,3,1
MX,AT,2013.0,6,3,3
RU,RS,1997.0,1,1,0
SD,AE,2016.0,2,4,-2
BR,DK,2002.0,1,1,0
VN,TW,2023.0,1,2,-1
LU,CH,2017.0,5,3,2
TR,LB,2020.0,2,2,0
MX,PK,2022.0,1,1,0
US,MT,2011.0,5,3,2
MA,SE,2021.0,1,3,-2
TW,BD,2003.0,2,4,-2
LU,SE,2016.0,3,2,1
IT,CM,2015.0,1,4,-3
TN,JP,2015.0,1,3,-2
DZ,nan,2022.0,3,9,-6
HU,TN,2020.0,1,2,-1
IQ,YE,2019.0,2,7,-5
AE,nan,2015.0,2,2,0
CN,ZM,2014.0,3,2,1
KH,SG,2020.0,2,2,0
SV,VE,2015.0,1,2,-1
IE,DK,2000.0,4,2,2
TR,AR,2010.0,1,1,0
SK,NZ,2010.0,1,1,0
NL,PH,2007.0,2,2,0
AR,HU,2000.0,2,1,1
ZA,NO,2007.0,2,4,-2
US,SN,2001.0,4,2,2
MC,FR,2018.0,3,12,-9
FR,HR,2000.0,1,1,0
JP,GE,2012.0,1,1,0
BA,SA,2016.0,2,1,1
MD,CH,1997.0,2,1,1
PT,MY,2010.0,1,3,-2
CG,US,2021.0,2,5,-3
GE,IT,1998.0,1,1,0
PK,BD,2018.0,51,55,-4
nan,NL,2020.0,76,66,10
BR,NG,2014.0,3,2,1
DE,AR,2004.0,12,21,-9
ES,CZ,2004.0,1,5,-4
CZ,DE,2011.0,48,58,-10
TR,IQ,2017.0,12,8,4
PL,MX,2022.0,6,2,4
TH,SE,2022.0,2,4,-2
PY,BR,2018.0,7,16,-9
GR,TW,2013.0,1,1,0
CN,MK,2019.0,2,4,-2
nan,PL,1999.0,1,3,-2
RU,RS,1998.0,5,2,3
DZ,FR,2006.0,37,62,-25
EC,NO,2017.0,3,2,1
DE,,2024.0,115953,0,115953
,JP,2007.0,15304,0,15304
CN,,2021.0,36003,0,36003
CO,,2023.0,9850,0,9850
,CL,1999.0,1048,0,1048
TR,,2020.0,5503,0,5503
,CO,2010.0,2552,0,2552
,HU,2007.0,1271,0,1271
,AR,2000.0,1753,0,1753
FR,,2008.0,6191,0,6191
TW,,2013.0,2730,0,2730
,UY,1995.0,164,0,164
IL,,2009.0,1162,0,1162
FI,,2000.0,356,0,356
,EG,2001.0,1073,0,1073
,AU,2009.0,6913,0,6913
CZ,,2023.0,9196,0,9196
GB,,2011.0,9406,0,9406
,TW,1999.0,4075,0,4075
RU,,2016.0,4791,0,4791
DK,,2022.0,4307,0,4307
,PT,2014.0,1792,0,1792
,ZA,1994.0,2946,0,2946
,GT,2001.0,27,0,27
,GR,2003.0,2703,0,2703
,KZ,2011.0,517,0,517
SG,,2021.0,1986,0,1986
,CR,1999.0,113,0,113
ET,EG,2002.0,3,0,3
MX,,2013.0,1484,0,1484
CL,,2013.0,691,0,691
,GD,2010.0,23,0,23
ET,,2011.0,45,0,45
,IS,2007.0,117,0,117
,DK,1999.0,1285,0,1285
,IR,2016.0,10844,0,10844
,CO,2017.0,2189,0,2189
,ET,2001.0,95,0,95
,OM,1998.0,98,0,98
,BD,2015.0,1018,0,1018
KW,MY,2007.0,2,0,2
,BF,2009.0,102,0,102
,LT,2011.0,871,0,871
CM,,2022.0,855,0,855
,BG,2006.0,411,0,411
DZ,,2014.0,198,0,198
,DZ,2000.0,271,0,271
NO,,2008.0,501,0,501
,FR,2016.0,11942,0,11942
,CI,1996.0,45,0,45
,AT,2015.0,2305,0,2305
MY,,2000.0,65,0,65
SD,,2020.0,109,0,109
EG,,2011.0,538,0,538
GR,,2015.0,1826,0,1826
PR,,2009.0,7,0,7
NZ,UG,2022.0,33,0,33
GH,,2017.0,159,0,159
,PG,1996.0,19,0,19
,AM,2003.0,136,0,136
GD,,2020.0,28,0,28
,IT,2018.0,11190,0,11190
,MT,2001.0,36,0,36
SI,,2015.0,368,0,368
,FO,2017.0,11,0,11
,BO,2002.0,26,0,26
GH,CN,2005.0,2,0,2
ES,VN,2004.0,3,0,3
,TH,1995.0,687,0,687
,KW,2014.0,181,0,181
,CO,2019.0,802,0,802
,GH,2005.0,134,0,134
,AZ,2014.0,160,0,160
GY,,2021.0,8,0,8
,HK,2012.0,60,0,60
KG,,2023.0,252,0,252
PL,SK,2007.0,5,0,5
BE,PK,2010.0,2,0,2
RW,,2022.0,146,0,146
GH,,2019.0,209,0,209
,CM,2011.0,388,0,388
,UZ,2007.0,123,0,123
,BH,2003.0,28,0,28
TJ,KZ,2014.0,2,0,2
,SL,2015.0,19,0,19
,VG,2003.0,21,0,21
,MD,2008.0,77,0,77
IR,VN,2023.0,1,0,1
,nan,2018.0,579,0,579
NA,,2020.0,41,0,41
,DO,2009.0,12,0,12
PA,IN,2014.0,4,0,4
AF,,2022.0,52,0,52
US,AL,2014.0,3,0,3
AU,BW,2015.0,5,0,5
,OM,1997.0,60,0,60
BR,RO,2022.0,4,0,4
SG,OM,2013.0,1,0,1
CU,,2007.0,86,0,86
CN,MK,2010.0,5,0,5
,SS,2018.0,3,0,3
,TT,2014.0,35,0,35
,TD,2019.0,4,0,4
MA,BY,2007.0,1,0,1
FI,CD,2021.0,1,0,1
NL,MD,2019.0,1,0,1
,GD,2017.0,20,0,20
LT,,2016.0,518,0,518
GT,,2024.0,191,0,191
,NA,2015.0,46,0,46
,IE,2018.0,1130,0,1130
,JO,2001.0,159,0,159
XK,IN,2020.0,1,0,1
PK,TN,2015.0,1,0,1
ZW,PK,2010.0,1,0,1
BH,IT,2008.0,1,0,1
PK,NI,2014.0,1,0,1
KW,TN,2015.0,2,0,2
ID,,2005.0,49,0,49
,GH,2002.0,124,0,124
CU,PK,2005.0,1,0,1
,GY,2011.0,4,0,4
,HN,2000.0,28,0,28
GM,,2020.0,12,0,12
NO,MM,2020.0,1,0,1
,BO,2005.0,40,0,40
RU,AZ,1999.0,2,0,2
BD,NI,2020.0,1,0,1
KZ,PL,2012.0,1,0,1
,BS,2010.0,4,0,4
KR,OM,2022.0,3,0,3
SY,QA,2012.0,1,0,1
ID,,2002.0,34,0,34
SN,GA,2021.0,1,0,1
RO,SI,2020.0,3,0,3
,DJ,2016.0,2,0,2
,TO,2014.0,1,0,1
NL,DK,2023.0,8,0,8
NL,EE,2014.0,2,0,2
AM,ZW,2019.0,2,0,2
NG,IL,2011.0,1,0,1
ZA,GR,2000.0,1,0,1
BW,CH,2014.0,1,0,1
,MK,1994.0,39,0,39
,CI,2004.0,82,0,82
CH,LA,2011.0,1,0,1
CM,EG,2016.0,1,0,1
SY,BR,2009.0,1,0,1
RS,IN,2011.0,2,0,2
ZA,FI,2000.0,2,0,2
CG,ET,2019.0,1,0,1
IS,,2015.0,80,0,80
AT,XK,2013.0,1,0,1
GP,JM,2001.0,1,0,1
UA,AU,2005.0,1,0,1
PH,PL,2013.0,2,0,2
NC,,2016.0,14,0,14
DZ,MX,2006.0,1,0,1
TZ,CO,2019.0,1,0,1
SZ,,2001.0,3,0,3
CH,NE,2013.0,3,0,3
MN,,2011.0,17,0,17
NG,DK,2014.0,1,0,1
,GN,2009.0,9,0,9
DE,MQ,2014.0,1,0,1
AT,NP,2014.0,2,0,2
BH,NG,2013.0,1,0,1
KW,ID,2016.0,2,0,2
KP,JP,2000.0,2,0,2
NO,MC,2006.0,1,0,1
VE,FI,2020.0,1,0,1
,ML,1994.0,30,0,30
KZ,,2007.0,27,0,27
,MU,2004.0,13,0,13
NG,ZM,2015.0,1,0,1
,GD,2019.0,20,0,20
VE,IE,2015.0,1,0,1
KW,JO,2009.0,2,0,2
FR,KP,2016.0,1,0,1
MT,NG,2015.0,1,0,1
SV,,2021.0,31,0,31
UA,RS,2021.0,4,0,4
LS,,2012.0,4,0,4
TT,,2013.0,19,0,19
JM,,2007.0,9,0,9
GH,,2010.0,19,0,19
NL,MM,2016.0,1,0,1
,BB,2009.0,10,0,10
SE,LY,2007.0,1,0,1
CH,KZ,2018.0,1,0,1
LK,RU,2010.0,1,0,1
LK,KE,2015.0,1,0,1
VA,,2024.0,3,0,3
GR,BR,2010.0,4,0,4
CO,ZA,2013.0,3,0,3
JO,BR,2003.0,1,0,1
RO,TN,2018.0,1,0,1
TN,CN,2004.0,2,0,2
MX,CY,2011.0,2,0,2
SN,MR,2018.0,2,0,2
EC,,2005.0,19,0,19
AL,DE,1999.0,1,0,1
US,BS,2006.0,4,0,4
MC,,2009.0,3,0,3
IE,AT,2001.0,1,0,1
HU,SG,2002.0,2,0,2
KE,CG,2018.0,1,0,1
,GA,2003.0,21,0,21
,MU,1996.0,16,0,16
UA,PT,2010.0,1,0,1
ML,CH,2014.0,3,0,3
,KY,2007.0,4,0,4
GA,BJ,2004.0,1,0,1
GT,CH,2010.0,1,0,1
KZ,NL,2010.0,1,0,1
LV,,2007.0,37,0,37
EE,AU,2003.0,1,0,1
SY,TR,2020.0,3,0,3
,SJ,2012.0,6,0,6
PT,DK,2023.0,1,0,1
IN,EC,2019.0,2,0,2
VE,ID,2018.0,2,0,2
OM,,2009.0,29,0,29
BN,DE,2004.0,2,0,2
FR,BB,2004.0,1,0,1
,TJ,2012.0,17,0,17
SE,IQ,2012.0,1,0,1
BM,,2019.0,4,0,4
AU,KE,2004.0,5,0,5
BG,RO,2020.0,1,0,1
HU,QA,2016.0,3,0,3
ET,RW,2022.0,1,0,1
MY,PE,2009.0,1,0,1
,LR,2008.0,1,0,1
CN,KE,1997.0,2,0,2
VE,IN,2018.0,2,0,2
TD,,2018.0,7,0,7
CI,NC,2013.0,1,0,1
KP,GH,2022.0,1,0,1
MD,CH,1998.0,2,0,2
SM,,2021.0,2,0,2
TM,,2024.0,6,0,6
ZM,IT,2015.0,1,0,1
IT,ML,2022.0,1,0,1
BG,FI,2021.0,2,0,2
UA,SG,2003.0,2,0,2
KW,AU,2011.0,3,0,3
PT,TH,2016.0,1,0,1
LK,AU,1998.0,1,0,1
LV,TR,2015.0,1,0,1
US,NE,1999.0,2,0,2
YE,,2003.0,7,0,7
AM,CN,2011.0,2,0,2
CA,UZ,2004.0,1,0,1
ZW,AM,2011.0,1,0,1
,PG,2004.0,16,0,16
RW,AU,1999.0,1,0,1
MT,CA,2007.0,1,0,1
LT,TR,2014.0,1,0,1
DE,DO,2020.0,1,0,1
PL,CO,2019.0,3,0,3
IS,EE,2012.0,1,0,1
GR,AE,2011.0,1,0,1
LU,IQ,2016.0,1,0,1
BE,CG,2001.0,1,0,1
BG,MK,2006.0,1,0,1
MW,AU,2009.0,2,0,2
,CV,2011.0,9,0,9
OM,MY,2008.0,2,0,2
MX,LV,2011.0,3,0,3
FI,PK,2005.0,1,0,1
GB,BA,2002.0,1,0,1
JM,NZ,2005.0,1,0,1
BJ,,2009.0,12,0,12
SE,BA,2009.0,1,0,1
SN,GM,2019.0,1,0,1
GB,YE,2006.0,2,0,2
LB,DE,2023.0,1,0,1
LT,RS,2017.0,1,0,1
IN,SD,2007.0,1,0,1
KW,AE,2003.0,4,0,4
CI,BF,2001.0,3,0,3
PE,QA,2017.0,1,0,1
TH,GA,2010.0,1,0,1
NE,CN,2011.0,2,0,2
JO,CO,2010.0,1,0,1
nan,BM,2009.0,1,0,1
LU,MW,2005.0,1,0,1
QA,CA,1997.0,1,0,1
GB,LY,2021.0,7,0,7
PL,BY,2003.0,3,0,3
KE,PH,2017.0,3,0,3
ME,CN,2004.0,1,0,1
TH,PE,2019.0,3,0,3
GE,RO,2022.0,1,0,1
SL,CN,2012.0,1,0,1
IR,UA,2018.0,2,0,2
CN,GN,2019.0,4,0,4
CU,ZW,2005.0,1,0,1
ID,BJ,2022.0,1,0,1
AZ,DE,2000.0,1,0,1
FI,RO,2013.0,2,0,2
DK,KE,1999.0,1,0,1
CG,,2012.0,9,0,9
KZ,RO,2012.0,2,0,2
CG,PT,2018.0,1,0,1
ET,UA,2017.0,1,0,1
MY,BZ,2014.0,1,0,1
FI,CR,2012.0,1,0,1
VN,ZA,2002.0,1,0,1
TZ,ES,2000.0,2,0,2
GN,CN,2016.0,1,0,1
,LA,2001.0,5,0,5
PH,IE,2004.0,1,0,1
GF,,2012.0,1,0,1
PA,JP,2020.0,1,0,1
PT,FI,2006.0,3,0,3
TR,AR,2019.0,2,0,2
RE,,2009.0,8,0,8
CI,TN,2006.0,1,0,1
MW,ZM,2022.0,2,0,2
BR,KW,2005.0,1,0,1
CR,NO,2018.0,1,0,1
NO,IR,2007.0,3,0,3
BO,NO,2014.0,1,0,1
KR,SK,2008.0,1,0,1
BE,PY,2008.0,1,0,1
AF,FR,2018.0,1,0,1
CO,BO,2003.0,3,0,3
JP,CY,2005.0,3,0,3
GB,VG,1998.0,1,0,1
BO,CR,2008.0,1,0,1
EC,GT,2016.0,2,0,2
AR,BY,2011.0,1,0,1
ET,SG,1998.0,1,0,1
CY,AT,2021.0,1,0,1
,KG,1994.0,6,0,6
ML,GN,2009.0,1,0,1
SK,GH,2001.0,1,0,1
LI,GB,2010.0,1,0,1
LY,,2002.0,8,0,8
IT,LU,2003.0,1,0,1
NG,NA,2020.0,1,0,1
SL,LB,2017.0,1,0,1
MM,TZ,2020.0,2,0,2
ET,CH,2018.0,2,0,2
MW,nan,2019.0,1,0,1
CU,LU,2021.0,1,0,1
LK,SA,2012.0,1,0,1
BH,KR,2022.0,1,0,1
MY,CO,2013.0,2,0,2
LU,AU,2007.0,1,0,1
AU,MN,2002.0,1,0,1
NO,TN,2012.0,2,0,2
HR,nan,2007.0,1,0,1
,NE,2001.0,6,0,6
CU,BE,2010.0,6,0,6
CN,VU,2007.0,1,0,1
BA,AE,2020.0,1,0,1
SA,OM,1998.0,4,0,4
AL,CO,2015.0,1,0,1
CM,CG,2019.0,1,0,1
FR,ET,2010.0,2,0,2
TN,DK,2009.0,1,0,1
HR,IE,2022.0,1,0,1
IN,VG,2020.0,2,0,2
TW,DZ,2015.0,2,0,2
JP,GH,2005.0,2,0,2
IN,EC,2017.0,2,0,2
FR,CU,2004.0,5,0,5
CY,GR,2023.0,3,0,3
SK,AU,2001.0,1,0,1
UA,AZ,2022.0,2,0,2
CH,SZ,2017.0,1,0,1
,GF,2020.0,1,0,1
IN,CW,2020.0,2,0,2
US,CG,1999.0,1,0,1
IS,NL,2023.0,1,0,1
,BS,2017.0,1,0,1
LB,PS,2016.0,1,0,1
KH,ES,2016.0,1,0,1
,FO,2019.0,4,0,4
nan,NG,2002.0,2,0,2
CM,CH,2009.0,1,0,1
SN,MD,1998.0,1,0,1
PE,HU,2021.0,1,0,1
SA,GH,2011.0,1,0,1
AR,AM,2016.0,1,0,1
EE,CA,2008.0,3,0,3
TW,GH,2016.0,1,0,1
DK,NP,2013.0,2,0,2
CA,LI,1998.0,1,0,1
UZ,IN,2008.0,2,0,2
ES,IE,2001.0,3,0,3
SG,ZA,1997.0,1,0,1
LK,BT,2017.0,2,0,2
BD,FR,1999.0,2,0,2
PL,EC,2021.0,1,0,1
UG,ID,2011.0,2,0,2
SK,NO,2011.0,2,0,2
KR,AR,2011.0,1,0,1
ZM,TZ,1999.0,1,0,1
AE,AT,2005.0,1,0,1
TR,CH,2023.0,2,0,2
EG,AG,2021.0,1,0,1
BJ,TZ,2021.0,2,0,2
IQ,KE,2014.0,1,0,1
BA,ME,2013.0,1,0,1
IT,VG,2013.0,2,0,2
AM,MA,2009.0,1,0,1
AZ,UZ,2005.0,1,0,1
PY,NL,2012.0,1,0,1
DE,DZ,1998.0,2,0,2
RE,JP,2018.0,1,0,1
AR,NZ,2022.0,2,0,2
NZ,IT,2023.0,1,0,1
IS,CH,2002.0,1,0,1
CZ,ZM,2004.0,1,0,1
IN,MN,2008.0,1,0,1
AT,BB,2009.0,1,0,1
LY,,2005.0,4,0,4
HN,PH,2014.0,1,0,1
MZ,UA,2014.0,3,0,3
,FO,2010.0,3,0,3
JO,JP,2015.0,3,0,3
KE,NE,2008.0,1,0,1
NE,TZ,2017.0,1,0,1
JP,AE,2020.0,3,0,3
BD,NP,2021.0,2,0,2
IN,LR,2018.0,1,0,1
KR,AT,2023.0,1,0,1
VG,IN,2022.0,1,0,1
PY,CO,2006.0,1,0,1
ZA,OM,2001.0,1,0,1
IN,MA,2009.0,1,0,1
CU,AT,2019.0,2,0,2
NE,ML,2014.0,2,0,2
PH,DK,2018.0,1,0,1
PG,FJ,2005.0,1,0,1
CG,RU,1998.0,1,0,1
PK,PT,2017.0,2,0,2
nan,LS,2021.0,1,0,1
,SZ,2013.0,7,0,7
TH,LT,2022.0,1,0,1
NG,HR,2008.0,1,0,1
ZA,UY,2016.0,1,0,1
KE,FJ,2020.0,2,0,2
BD,FI,2023.0,1,0,1
LV,NL,2018.0,1,0,1
FR,BA,2009.0,3,0,3
GH,BN,2013.0,1,0,1
MM,,2007.0,1,0,1
BN,CA,2004.0,1,0,1
IN,MT,2021.0,1,0,1
CY,ZA,2017.0,1,0,1
FI,NZ,2001.0,2,0,2
ST,MZ,2012.0,4,0,4
ET,TZ,2015.0,2,0,2
SA,ES,2005.0,1,0,1
AU,GD,2010.0,1,0,1
US,ME,2003.0,1,0,1
PK,SE,1998.0,1,0,1
CM,KE,2012.0,3,0,3
EC,,2002.0,7,0,7
NO,GR,1999.0,2,0,2
,BM,2014.0,1,0,1
BH,IR,2017.0,1,0,1
JP,NC,2009.0,1,0,1
,TM,2001.0,1,0,1
CN,CY,2004.0,2,0,2
EE,UA,2017.0,1,0,1
MG,KH,2012.0,1,0,1
MY,LB,2016.0,2,0,2
KW,OM,2009.0,2,0,2
TR,XK,2015.0,1,0,1
ZM,BW,2021.0,1,0,1
SK,ET,1997.0,1,0,1
GE,AE,2007.0,1,0,1
RS,CY,2017.0,2,0,2
MA,GF,2007.0,1,0,1
FI,EG,1999.0,1,0,1
RU,KH,2008.0,2,0,2
GB,NA,1998.0,1,0,1
CG,SC,2014.0,1,0,1
FR,AL,2020.0,1,0,1
IE,PE,2007.0,1,0,1
JP,SY,2007.0,1,0,1
BH,,1998.0,9,0,9
DZ,BR,2007.0,1,0,1
NG,BD,2007.0,3,0,3
CA,BI,2021.0,1,0,1
GT,PT,2021.0,1,0,1
SG,CI,2019.0,1,0,1
CU,RU,2017.0,3,0,3
LV,AU,2013.0,2,0,2
EG,RU,1999.0,1,0,1
LT,AT,2012.0,1,0,1
ID,SK,2013.0,1,0,1
US,MU,2007.0,1,0,1
TZ,CO,2017.0,1,0,1
JP,BO,2021.0,1,0,1
AR,PK,2000.0,2,0,2
NE,,2000.0,1,0,1
AM,NL,2009.0,1,0,1
NO,CO,2012.0,1,0,1
US,ER,2002.0,1,0,1
GM,DE,2014.0,1,0,1
AE,HU,1997.0,1,0,1
IT,KW,2021.0,1,0,1
AE,SG,2000.0,1,0,1
KR,MY,1998.0,1,0,1
BY,CA,2011.0,2,0,2
,AF,2001.0,2,0,2
NZ,CZ,2007.0,1,0,1
BG,CN,1998.0,2,0,2
SE,NG,2001.0,1,0,1
MK,CN,1999.0,1,0,1
AT,MA,2020.0,1,0,1
GB,BH,2007.0,3,0,3
BO,AU,2016.0,1,0,1
AT,GM,2013.0,1,0,1
SG,AM,2009.0,1,0,1
DK,NG,2007.0,2,0,2
EE,CO,2013.0,1,0,1
AD,IR,2014.0,1,0,1
CG,GH,2014.0,1,0,1
CN,BN,2007.0,1,0,1
RS,IL,2018.0,1,0,1
CN,GP,2014.0,1,0,1
AM,KZ,2017.0,1,0,1
JP,PS,2020.0,1,0,1
JP,CR,2014.0,3,0,3
VE,SG,2005.0,1,0,1
GW,PT,2005.0,1,0,1
NG,BF,2020.0,2,0,2
SO,KE,2021.0,1,0,1
US,ST,2003.0,1,0,1
NL,MN,2020.0,2,0,2
TH,BG,2019.0,1,0,1
PL,PE,1999.0,1,0,1
IE,GM,2000.0,1,0,1
TW,HR,2011.0,1,0,1
SG,ET,2020.0,1,0,1
CY,OM,2021.0,1,0,1
SK,DZ,2014.0,1,0,1
VN,LK,2019.0,1,0,1
SJ,IT,2013.0,1,0,1
BI,BE,2007.0,1,0,1
CY,KH,2017.0,1,0,1
RS,VE,2020.0,1,0,1
TW,GA,1997.0,1,0,1
MZ,NO,2003.0,1,0,1
NL,AM,2015.0,1,0,1
KR,KW,2023.0,1,0,1
SA,OM,1997.0,2,0,2
AT,AM,2018.0,1,0,1
IS,AU,2012.0,2,0,2
LK,ES,2020.0,3,0,3
NI,CO,2006.0,1,0,1
MW,QA,2018.0,1,0,1
ZA,GE,1997.0,2,0,2
MK,LU,2013.0,1,0,1
NI,AU,2009.0,1,0,1
TW,MX,2005.0,1,0,1
LY,FR,2007.0,1,0,1
TT,ID,2018.0,1,0,1
SN,BE,2017.0,2,0,2
EE,IN,2002.0,2,0,2
DE,ZM,2015.0,1,0,1
BA,CO,2010.0,1,0,1
CZ,YE,2015.0,1,0,1
DZ,MY,2014.0,2,0,2
VE,BE,2021.0,1,0,1
LS,ZA,2003.0,1,0,1
CN,IS,2010.0,1,0,1
KG,US,2022.0,2,0,2
BO,NL,2008.0,1,0,1
TR,MW,2016.0,1,0,1
EC,VE,1999.0,1,0,1
TJ,EE,2003.0,1,0,1
NL,CY,2002.0,1,0,1
MC,AT,2011.0,1,0,1
JP,PR,2022.0,1,0,1
ET,SG,1997.0,2,0,2
DK,SL,2020.0,1,0,1
,AD,2012.0,2,0,2
GT,nan,2020.0,2,0,2
KE,HU,2014.0,1,0,1
ZW,MY,2020.0,1,0,1
CN,KG,2018.0,1,0,1
CR,FR,2004.0,2,3,-1
MY,UZ,2015.0,2,1,1
PK,UZ,2016.0,2,1,1
PY,PT,2006.0,1,1,0
IT,NP,2011.0,1,2,-1
NO,SG,2012.0,1,3,-2
IE,CZ,2004.0,1,1,0
HR,ES,2021.0,4,9,-5
FI,GR,2021.0,4,3,1
QA,SG,2020.0,2,2,0
FR,MZ,2014.0,1,1,0
IN,ET,2023.0,2,2,0
NZ,AE,2015.0,3,8,-5
CN,HR,2011.0,2,4,-2
IT,BD,2016.0,6,4,2
SA,NL,2010.0,1,2,-1
EG,KE,2021.0,1,1,0
DZ,EC,2015.0,2,1,1
IT,IE,2001.0,1,5,-4
PT,SG,2003.0,1,1,0
AU,ZA,1997.0,2,9,-7
CU,PA,2014.0,1,3,-2
CA,UA,1997.0,1,1,0
BH,PH,2020.0,1,1,0
LU,CN,2016.0,2,2,0
BE,RW,2021.0,1,2,-1
MX,AF,2015.0,2,4,-2
PL,CY,2015.0,2,1,1
MA,BR,2003.0,2,1,1
AT,CW,2011.0,1,1,0
TW,ES,2022.0,1,2,-1
PT,BG,2011.0,2,2,0
IE,SA,2007.0,1,1,0
VN,NL,2021.0,4,6,-2
KR,BH,2002.0,1,1,0
JP,SD,2020.0,1,2,-1
SA,ES,2002.0,1,1,0
BR,RS,2018.0,1,2,-1
SN,ES,2013.0,1,2,-1
CL,GT,2015.0,3,4,-1
GB,GD,2020.0,1,2,-1
ML,BF,2007.0,1,3,-2
ES,SK,2007.0,1,4,-3
OM,BD,2005.0,1,2,-1
IN,ZW,2019.0,1,2,-1
CH,ET,2010.0,1,1,0
KH,NL,1998.0,1,1,0
CI,CA,2011.0,2,2,0
ZM,NL,2015.0,1,2,-1
SN,GN,2017.0,1,3,-2
UZ,KZ,2009.0,3,1,2
FI,PL,2023.0,1,1,0
ZW,PK,2019.0,1,3,-2
IQ,CY,2021.0,2,2,0
GB,GT,2021.0,1,1,0
TW,HK,2016.0,1,3,-2
KR,IT,1997.0,1,2,-1
VN,UA,2014.0,1,1,0
ES,PY,2005.0,1,1,0
BJ,NE,2019.0,2,1,1
AT,SG,2009.0,1,2,-1
US,MZ,2004.0,1,1,0
TR,AR,2017.0,1,1,0
RU,PK,2005.0,1,1,0
BG,CZ,2014.0,2,3,-1
SE,SI,2017.0,3,3,0
HU,PT,2003.0,2,1,1
QA,PL,2015.0,1,1,0
CU,AT,2017.0,1,1,0
UG,AU,2014.0,2,1,1
DE,MW,2006.0,1,1,0
JO,IT,2011.0,2,1,1
DK,ZA,2007.0,2,4,-2
CZ,GH,2019.0,1,7,-6
ES,HU,2007.0,3,3,0
IL,PT,2012.0,1,1,0
FR,UG,2000.0,2,1,1
NG,TH,2011.0,1,2,-1
ZM,GH,2006.0,3,3,0
XK,ID,2016.0,1,1,0
BR,MA,2016.0,1,4,-3
SE,SI,2010.0,1,1,0
IS,EG,2018.0,1,1,0
RO,BG,2014.0,1,3,-2
CH,MG,2020.0,1,2,-1
AR,PL,2002.0,1,1,0
MX,DO,2002.0,1,1,0
CZ,GE,2000.0,1,3,-2
BG,NZ,2006.0,1,1,0
RU,VN,2011.0,2,3,-1
ES,PR,2013.0,1,1,0
CN,FI,1997.0,1,2,-1
DK,CL,2011.0,1,3,-2
AR,PH,2013.0,1,3,-2
NO,QA,2019.0,1,3,-2
DE,MK,2003.0,1,1,0
TT,AE,2018.0,1,1,0
BO,CO,2009.0,2,8,-6
IE,TR,2004.0,1,2,-1
TW,QA,2020.0,2,1,1
QA,SD,2021.0,1,4,-3
UA,AU,2002.0,1,2,-1
IN,TT,2011.0,2,1,1
GE,SK,2005.0,1,1,0
US,DO,2011.0,1,3,-2
RS,PT,2015.0,1,2,-1
BJ,NE,2017.0,1,1,0
IL,SA,2008.0,1,1,0
RU,BH,2017.0,1,1,0
CZ,NZ,2017.0,1,3,-2
GR,FI,2008.0,1,2,-1
RO,DK,2018.0,1,1,0
PL,EG,2013.0,1,1,0
NZ,TR,2007.0,1,1,0
SD,KR,2013.0,1,1,0
ZA,SN,2009.0,1,2,-1
IS,CH,2005.0,1,1,0
TH,ZM,2011.0,1,2,-1
TG,BJ,2019.0,1,2,-1
LU,nan,2015.0,1,2,-1
DZ,ID,2016.0,1,1,0
OM,NL,2003.0,1,2,-1
NG,TG,2016.0,1,1,0
KE,ML,2009.0,1,1,0
RO,HR,2015.0,1,1,0
PS,LB,2014.0,1,1,0
CN,BY,2022.0,1,2,-1
CI,CN,2021.0,1,1,0
KW,DE,2020.0,2,2,0
AZ,GE,2008.0,1,11,-10
QA,BA,2016.0,1,2,-1
SG,MM,2010.0,2,1,1
CM,CG,2010.0,1,1,0
VG,RU,2015.0,1,1,0
PT,UA,2000.0,1,1,0
GB,VG,1997.0,1,1,0
CL,KR,2013.0,1,3,-2
EG,VE,2009.0,1,1,0
JP,LV,2001.0,1,1,0
IS,IN,2014.0,1,3,-2
BG,TR,2012.0,1,3,-2
FI,SJ,2015.0,1,3,-2
ID,GB,1999.0,1,2,-1
BO,FR,1999.0,1,1,0
RU,VG,2015.0,1,1,0
RU,BH,2019.0,2,3,-1
NL,MD,2017.0,1,1,0
CA,LT,2011.0,1,1,0
BE,TN,2013.0,1,2,-1
HU,PK,2012.0,1,1,0
CM,NE,2016.0,1,1,0
FR,GA,2023.0,1,1,0
UA,MZ,2021.0,1,4,-3
TN,SY,2021.0,1,1,0
CH,LI,2016.0,1,2,-1
NO,QA,2017.0,1,3,-2
SE,PA,2003.0,2,3,-1
SI,HU,2011.0,2,1,1
CU,RU,2019.0,2,3,-1
JP,SA,1999.0,1,2,-1
AT,IS,2010.0,1,1,0
CL,RU,2001.0,2,7,-5
DE,ET,2003.0,1,1,0
MK,IN,2019.0,1,1,0
US,BZ,2013.0,1,1,0
BJ,NL,2009.0,1,1,0
PL,FI,2023.0,1,1,0
GN,ML,2016.0,1,2,-1
VN,EG,2013.0,1,2,-1
CA,NC,2010.0,1,1,0
SG,PT,2020.0,1,3,-2
PL,VN,2020.0,1,2,-1
TH,PH,2009.0,2,0,2
ZM,SZ,2020.0,1,0,1
FR,AE,2007.0,5,0,5
GW,US,2022.0,1,0,1
nan,VG,2000.0,1,0,1
IN,LT,2014.0,4,0,4
UA,ZA,1998.0,1,0,1
CW,BR,2019.0,1,0,1
SG,EC,2019.0,1,0,1
ZW,UG,2003.0,1,0,1
SY,MA,2015.0,1,0,1
MK,HU,2008.0,1,0,1
IT,SV,2013.0,1,0,1
CU,IE,2020.0,1,0,1
CA,BY,2003.0,1,0,1
FR,IS,1998.0,1,0,1
CL,AE,2016.0,1,0,1
LT,RS,2019.0,3,0,3
TR,HU,2001.0,2,0,2
PH,PT,2008.0,1,0,1
RE,TH,2016.0,1,0,1
IS,IE,2012.0,1,0,1
JP,JO,2009.0,1,0,1
SO,IT,1999.0,1,0,1
TZ,TH,2017.0,1,0,1
MU,,2001.0,2,0,2
KR,EG,1998.0,1,0,1
JP,ET,2001.0,1,0,1
PS,DE,2023.0,1,0,1
VE,RU,2001.0,1,0,1
MZ,IT,2005.0,1,0,1
ET,IR,1997.0,1,0,1
MK,ME,2017.0,1,0,1
SN,AE,2016.0,1,0,1
ES,KW,2021.0,2,0,2
AL,,1998.0,2,0,2
JP,VE,2012.0,1,0,1
NP,SE,2021.0,1,0,1
LK,BW,2011.0,1,0,1
AU,VG,2009.0,1,0,1
IS,UG,2018.0,2,0,2
JP,MG,2008.0,1,0,1
PH,AE,2016.0,1,0,1
DE,QA,2003.0,2,0,2
IN,QA,2003.0,1,0,1
VU,MY,2013.0,1,0,1
DK,UG,2020.0,1,0,1
LS,UG,2015.0,1,0,1
CD,MD,2020.0,1,0,1
LV,nan,2009.0,1,0,1
AL,MA,2014.0,1,0,1
SN,TD,2002.0,1,0,1
UG,CA,2007.0,1,0,1
TH,TR,2011.0,2,0,2
FJ,,2004.0,1,0,1
BG,CL,2016.0,1,0,1
ZA,CI,2006.0,1,0,1
AE,PT,2018.0,1,0,1
GA,,2000.0,3,0,3
MD,GB,2011.0,1,0,1
HR,PL,2013.0,1,0,1
BW,IT,2004.0,1,0,1
GR,AM,2009.0,1,0,1
BO,BI,2005.0,1,0,1
IS,CL,2013.0,1,0,1
BJ,GB,2009.0,1,0,1
PS,SE,2015.0,1,0,1
IL,EE,2012.0,1,0,1
NL,LI,2007.0,1,0,1
BH,CN,2001.0,1,0,1
GB,MC,2023.0,1,0,1
TH,IE,2006.0,2,0,2
BH,TW,2020.0,1,0,1
,TD,2010.0,1,0,1
BN,ZA,2002.0,1,0,1
PK,TT,2022.0,1,0,1
SD,NO,2021.0,2,0,2
IN,DZ,2015.0,1,0,1
KR,BD,2002.0,1,0,1
GD,CH,2019.0,1,0,1
,TD,2017.0,2,0,2
MM,CA,2021.0,1,0,1
MA,RE,2018.0,1,0,1
NL,AZ,2020.0,1,0,1
LI,GB,2017.0,1,0,1
BB,FR,2015.0,1,0,1
PT,ST,1999.0,1,0,1
BT,BD,2016.0,1,0,1
BR,XK,2016.0,1,0,1
UA,OM,2006.0,1,0,1
SE,LK,2000.0,2,0,2
OM,RU,2013.0,1,0,1
UG,SE,2002.0,1,0,1
BY,BG,2009.0,1,0,1
PA,SG,2012.0,1,0,1
DK,NA,2021.0,1,0,1
GB,CD,2022.0,1,0,1
CG,BE,2002.0,1,0,1
GR,MK,2000.0,1,0,1
BH,SD,2006.0,1,0,1
HU,SG,2005.0,1,0,1
BH,TR,2016.0,1,0,1
AZ,KZ,2014.0,1,0,1
SN,CF,2013.0,1,0,1
CO,SI,2009.0,1,0,1
GH,KE,2005.0,1,0,1
MD,BF,2013.0,3,0,3
HR,KW,2016.0,1,0,1
LT,CR,2018.0,1,0,1
VA,US,2012.0,1,0,1
SN,NG,2022.0,1,0,1
FR,LA,2009.0,1,0,1
MD,DK,2011.0,1,0,1
AE,JP,1999.0,1,0,1
ID,VE,2021.0,1,0,1
RU,PE,2002.0,1,0,1
BE,SA,2005.0,1,0,1
NE,LU,1999.0,1,0,1
CR,SI,2020.0,1,0,1
PK,AL,2018.0,1,0,1
PL,IS,2023.0,1,0,1
AL,KW,2021.0,1,0,1
MY,UG,2021.0,1,0,1
LY,ET,2019.0,1,0,1
PL,TJ,2019.0,1,0,1
ET,SK,2010.0,1,0,1
FI,KW,2002.0,1,0,1
GR,TH,2021.0,1,0,1
BN,CH,2017.0,1,0,1
AZ,PL,2016.0,1,0,1
KR,BA,2018.0,1,0,1
GT,PK,2001.0,1,0,1
PL,TJ,2017.0,1,0,1
SI,NG,2010.0,1,0,1
CF,,2008.0,1,0,1
AE,SK,2018.0,1,0,1
PL,BN,2023.0,1,0,1
nan,EC,2013.0,2,0,2
FI,GM,2019.0,1,0,1
TZ,TW,2011.0,1,0,1
SK,GE,2021.0,1,0,1
ID,SN,2020.0,1,0,1
ZM,BE,2019.0,1,0,1
SS,NG,2009.0,1,0,1
BY,BO,2008.0,1,0,1
,BZ,2009.0,1,0,1
AL,PK,2020.0,1,0,1
AR,BG,2009.0,1,0,1
PL,PK,2000.0,1,0,1
RU,PK,2002.0,1,0,1
TG,BJ,2017.0,1,0,1
BM,,2010.0,3,0,3
QA,ES,2004.0,1,0,1
BB,SA,2012.0,1,0,1
SI,AM,2018.0,1,0,1
MN,AT,2018.0,1,0,1
AE,LB,1999.0,1,0,1
GL,US,2009.0,1,0,1
GF,US,2016.0,1,0,1
LB,CY,2018.0,1,0,1
GM,PK,2018.0,1,0,1
RO,SA,2019.0,1,0,1
NO,HN,2017.0,1,0,1
BJ,BI,2020.0,1,0,1
NP,TZ,2004.0,1,0,1
PG,IT,2019.0,1,0,1
GH,UG,2010.0,1,0,1
BJ,GF,2003.0,1,0,1
UY,CU,1998.0,1,0,1
MG,BF,2019.0,1,0,1
CN,GN,2017.0,1,0,1
BG,LY,2016.0,1,0,1
UZ,ZA,2021.0,1,0,1
NZ,UA,2020.0,1,0,1
CG,ET,2010.0,1,0,1
HK,nan,2004.0,1,0,1
GL,,2000.0,1,0,1
ZW,PK,2017.0,1,0,1
CG,ET,2017.0,1,0,1
ZM,BE,2017.0,1,0,1
RU,CG,2022.0,1,0,1
CG,NA,2004.0,1,0,1
AU,BF,2018.0,1,0,1
AM,IS,2015.0,1,0,1
NP,CO,2017.0,1,0,1
CO,NZ,2007.0,1,0,1
TH,PS,2020.0,1,0,1
NA,US,1999.0,1,0,1
RS,CY,2010.0,1,0,1
TD,FR,2010.0,1,0,1
HR,IL,2000.0,1,0,1
SN,GM,2017.0,1,0,1
GE,IT,1997.0,1,0,1
CN,NE,2018.0,1,0,1
,RW,2020.0,2,0,2
KZ,NL,2019.0,1,0,1
GR,LB,2005.0,1,0,1
KE,NZ,2021.0,1,0,1
ZW,SZ,2019.0,1,0,1
CR,EG,2020.0,1,0,1
GB,AU,2003.0,765,836,-71
GB,PK,2014.0,159,83,76
GB,CA,2002.0,505,492,13
CN,US,1997.0,751,1045,-294
DE,JO,2016.0,16,14,2
US,AR,1998.0,79,86,-7
CA,US,2006.0,2522,2634,-112
AT,DE,2006.0,319,371,-52
PH,US,2009.0,411,359,52
nan,IN,2018.0,95,116,-21
CU,PE,2014.0,12,8,4
NL,GB,2010.0,270,243,27
FR,SN,1998.0,8,9,-1
CN,GB,2018.0,592,726,-134
FR,US,2003.0,1093,903,190
NZ,CH,2000.0,3,4,-1
DE,FR,2003.0,304,314,-10
DE,DK,2019.0,224,180,44
EG,JP,1998.0,18,17,1
MY,JO,2011.0,10,5,5
CA,NL,2017.0,84,87,-3
CA,NL,2019.0,141,89,52
CO,BR,2015.0,160,128,32
IE,US,2013.0,472,511,-39
US,JP,2013.0,1757,1641,116
CH,IT,2016.0,278,420,-142
CN,FR,2014.0,174,201,-27
US,CR,2002.0,15,13,2
JP,KR,2009.0,348,262,86
EG,GB,2002.0,14,15,-1
SA,EG,2018.0,395,405,-10
GB,CH,2020.0,414,333,81
GB,TZ,2012.0,13,13,0
GB,KR,2012.0,96,97,-1
GT,MX,2015.0,7,12,-5
DE,CN,2018.0,376,369,7
CZ,US,2020.0,147,172,-25
CL,MX,2022.0,85,70,15
GB,ES,2008.0,268,233,35
FR,IE,2010.0,39,34,5
IN,FR,2007.0,114,57,57
GB,CA,2005.0,634,621,13
CA,AU,2022.0,248,227,21
IN,IR,2016.0,50,30,20
BD,MY,2014.0,52,37,15
GB,RU,2014.0,90,92,-2
ES,MX,2022.0,400,440,-40
CA,HU,2002.0,6,11,-5
PE,AR,2018.0,57,56,1
US,nan,2022.0,115,133,-18
NL,ZA,2012.0,45,35,10
RS,MX,2007.0,18,41,-23
TR,RS,2010.0,92,72,20
ES,FI,2019.0,24,26,-2
SG,AU,2004.0,45,34,11
AU,CL,2016.0,23,34,-11
IN,BE,2022.0,30,18,12
ES,JP,2007.0,27,30,-3
NO,SE,2004.0,57,54,3
CU,ES,2018.0,139,104,35
PK,US,2021.0,368,384,-16
AR,US,2001.0,121,100,21
CO,US,2013.0,264,277,-13
FI,AT,2018.0,18,13,5
PT,ES,2012.0,139,174,-35
CN,HR,2014.0,3,3,0
ES,CH,2013.0,106,77,29
BF,US,2012.0,2,2,0
GB,SK,2018.0,19,15,4
US,AR,1997.0,61,59,2
IR,CA,2015.0,316,177,139
DE,DK,2017.0,202,172,30
JO,GB,2018.0,24,35,-11
FR,JP,2011.0,127,129,-2
RO,GB,2019.0,76,90,-14
VE,MX,2009.0,43,33,10
CH,US,1999.0,408,409,-1
FR,CO,2022.0,16,18,-2
BR,MX,2022.0,58,50,8
VN,CN,2019.0,23,50,-27
DE,BR,2007.0,104,123,-19
RU,DE,2016.0,183,172,11
CN,MY,2013.0,64,51,13
US,GE,2008.0,121,153,-32
GB,MX,2001.0,42,24,18
NO,NL,2018.0,37,39,-2
BR,IT,2022.0,166,95,71
MY,AU,2019.0,159,136,23
IN,SA,2011.0,65,25,40
US,IT,2009.0,842,984,-142
FI,CN,2014.0,30,27,3
SA,AE,2015.0,31,12,19
BE,FR,2014.0,357,388,-31
MX,CA,2010.0,31,23,8
DE,BE,2001.0,60,55,5
GR,GB,2013.0,205,168,37
FJ,US,2020.0,8,7,1
AU,PK,2022.0,29,33,-4
VN,KR,2022.0,56,60,-4
IR,EG,2018.0,22,16,6
ES,CN,2019.0,74,98,-24
HU,DE,1998.0,31,22,9
SG,MY,2014.0,130,95,35
BH,IN,2002.0,2,3,-1
ES,BR,2005.0,174,136,38
MY,KR,2020.0,27,25,2
AE,EG,2014.0,31,31,0
GB,ID,2009.0,17,5,12
CH,IN,2014.0,45,53,-8
CN,KR,2018.0,275,331,-56
BR,KR,2022.0,6,3,3
LU,BE,2010.0,12,13,-1
PE,CH,2007.0,1,1,0
SA,NG,2012.0,6,5,1
RU,AU,2011.0,19,19,0
CA,BR,2021.0,165,273,-108
DE,DK,2010.0,140,117,23
UZ,CN,2007.0,12,10,2
NL,GB,2017.0,400,355,45
EE,DE,2013.0,37,55,-18
CO,CR,2008.0,13,14,-1
CR,MX,2021.0,28,32,-4
IE,SA,2016.0,5,4,1
US,JO,1998.0,17,8,9
ES,GR,2001.0,6,5,1
AT,CH,2019.0,145,145,0
BD,US,2012.0,84,100,-16
nan,BR,2012.0,78,88,-10
AU,IT,2015.0,68,77,-9
VN,AT,2009.0,1,2,-1
DE,CO,2002.0,5,10,-5
ES,BE,2001.0,12,15,-3
DE,IE,2010.0,88,79,9
VN,CN,2010.0,30,25,5
SY,CN,2009.0,34,32,2
CN,IN,2009.0,151,190,-39
BE,JP,2010.0,30,13,17
AE,IQ,2012.0,3,2,1
CA,BD,2016.0,37,41,-4
CN,TR,2008.0,7,9,-2
FR,DE,2008.0,470,526,-56
GB,AR,2006.0,22,17,5
NG,US,2020.0,158,116,42
AU,JP,2013.0,73,85,-12
CA,MX,2009.0,34,21,13
AT,GB,2007.0,60,50,10
GB,MW,2015.0,15,14,1
BR,AR,2015.0,112,183,-71
RU,ZW,2018.0,16,17,-1
FR,AU,2006.0,88,75,13
NL,GB,2019.0,383,420,-37
CN,DK,2002.0,9,13,-4
ZA,CA,2013.0,48,39,9
nan,JP,2012.0,42,50,-8
CA,EG,2011.0,31,43,-12
SE,US,2022.0,225,244,-19
GB,IL,2011.0,55,51,4
BD,ID,2016.0,28,17,11
AT,PK,2011.0,11,9,2
NO,BG,2003.0,6,4,2
FR,VE,2012.0,14,12,2
NO,GR,2017.0,3,9,-6
CN,EG,2021.0,58,45,13
MX,PE,2007.0,41,24,17
SA,GB,2013.0,43,110,-67
PL,JP,2014.0,23,29,-6
ET,BH,2019.0,31,21,10
nan,RU,2013.0,87,37,50
BR,GB,2000.0,39,74,-35
IN,JP,2014.0,123,142,-19
PT,GB,2009.0,58,53,5
JP,TR,2007.0,26,43,-17
IT,QA,2021.0,7,5,2
IN,NO,2020.0,45,34,11
IT,JO,2006.0,7,1,6
MA,TN,2020.0,40,37,3
nan,DE,2007.0,33,60,-27
TW,JP,2006.0,39,64,-25
BY,IN,2019.0,12,4,8
DE,NZ,2020.0,43,49,-6
CO,AU,2006.0,2,1,1
CO,HN,2017.0,5,7,-2
TT,US,2021.0,10,8,2
US,IR,2003.0,55,26,29
IT,DZ,2013.0,16,20,-4
FR,TN,2007.0,141,112,29
BR,HU,2008.0,7,4,3
IL,IN,2020.0,82,119,-37
PK,ID,2018.0,55,23,32
IR,PT,2015.0,18,2,16
BG,RS,2017.0,4,6,-2
AU,BE,2017.0,42,44,-2
RU,UZ,2012.0,13,18,-5
SE,HU,2018.0,12,21,-9
NZ,SG,2010.0,8,9,-1
ID,PK,2018.0,23,55,-32
ES,CA,2013.0,103,72,31
JP,BR,2000.0,22,19,3
PL,RU,2016.0,60,32,28
IR,TN,2016.0,13,11,2
IE,JP,2018.0,39,24,15
NL,PH,2016.0,8,4,4
DE,NO,2009.0,82,48,34
NO,FI,2005.0,12,4,8
PL,SK,2016.0,13,11,2
CM,FR,2020.0,13,25,-12
QA,KW,2019.0,3,5,-2
BD,ES,2018.0,11,16,-5
CZ,FI,2018.0,12,6,6
MA,EG,2009.0,2,2,0
SE,FR,2014.0,81,80,1
MY,QA,2020.0,16,5,11
RO,GB,2017.0,77,65,12
ID,DE,2011.0,11,20,-9
CL,CU,2007.0,15,14,1
SI,CA,2014.0,4,2,2
AT,CH,2010.0,81,77,4
DE,PL,2000.0,65,56,9
US,HU,2017.0,103,111,-8
FR,ID,2020.0,38,29,9
IN,SE,2020.0,82,53,29
BG,RS,2019.0,5,1,4
IN,NL,2007.0,32,29,3
JP,nan,2022.0,8,11,-3
FR,AT,2020.0,53,52,1
SE,SG,2012.0,11,15,-4
BD,GB,2022.0,35,25,10
DE,IE,2019.0,101,90,11
JP,VN,2021.0,66,29,37
IT,SE,2002.0,65,31,34
BD,CA,2013.0,34,33,1
EG,DE,2015.0,51,78,-27
PL,RS,2015.0,12,3,9
TR,CN,2001.0,9,14,-5
CR,GB,2004.0,2,1,1
SG,GB,2012.0,77,132,-55
DE,HU,2021.0,38,47,-9
IT,CU,2017.0,5,4,1
FI,RU,2011.0,14,15,-1
ID,MY,2016.0,104,342,-238
SE,IT,2020.0,65,91,-26
CA,LT,2014.0,2,1,1
CA,nan,2013.0,36,34,2
SE,FI,2006.0,71,58,13
SE,NL,2002.0,30,22,8
BY,UA,2020.0,19,21,-2
US,HU,2019.0,82,93,-11
HR,RS,2003.0,26,22,4
AR,IT,2002.0,35,36,-1
CM,CN,2014.0,3,2,1
PL,AT,2018.0,13,16,-3
SA,PK,2014.0,38,64,-26
NZ,CA,2015.0,75,78,-3
IT,IN,2023.0,4,7,-3
SE,CA,2020.0,56,54,2
AU,BE,2019.0,45,53,-8
ZM,TZ,2019.0,4,2,2
SA,IN,2003.0,7,9,-2
FR,HT,2020.0,4,2,2
BD,IR,2018.0,7,13,-6
TW,SA,2002.0,1,3,-2
BD,FR,2019.0,6,12,-6
GB,TW,2020.0,61,52,9
EG,GB,2005.0,19,27,-8
DK,AT,2022.0,17,12,5
SG,ID,2021.0,16,12,4
ES,CN,2010.0,49,68,-19
PK,SA,2012.0,50,28,22
CZ,NO,2011.0,7,13,-6
QA,SE,2010.0,6,1,5
DK,KE,2017.0,5,1,4
IR,IQ,2020.0,33,25,8
IN,GR,2012.0,6,1,5
LV,RU,2016.0,18,15,3
MY,AU,2017.0,166,154,12
AU,PL,2018.0,19,16,3
GH,DE,2021.0,16,12,4
AT,CH,2017.0,126,110,16
UA,VN,2020.0,10,5,5
PE,VE,2009.0,7,9,-2
US,UA,2011.0,35,52,-17
IR,NL,2022.0,46,20,26
BR,CV,2017.0,1,3,-2
TH,JP,2015.0,61,108,-47
CN,UZ,2021.0,8,11,-3
SK,JP,2008.0,22,9,13
NE,MA,2017.0,1,3,-2
SE,CN,2008.0,86,59,27
NL,CO,2021.0,14,27,-13
IE,nan,2018.0,3,4,-1
RU,ES,2007.0,13,12,1
MX,PH,2022.0,6,2,4
BY,IN,2017.0,13,6,7
ID,AM,2018.0,1,2,-1
SA,MY,2018.0,39,89,-50
VN,AU,2020.0,58,82,-24
UA,HR,2020.0,23,19,4
FR,IE,2019.0,44,34,10
CZ,TR,2005.0,6,5,1
CZ,CH,2005.0,21,20,1
MX,CL,2016.0,201,179,22
CH,BE,2005.0,27,34,-7
NL,nan,2018.0,97,68,29
HR,BA,2016.0,36,30,6
RU,GB,2008.0,90,58,32
BE,nan,1997.0,7,4,3
GR,FR,2021.0,27,38,-11
ES,DK,2003.0,16,21,-5
IT,RS,2021.0,9,4,5
ES,CU,2007.0,80,75,5
MK,AT,2014.0,9,19,-10
OM,EG,2013.0,7,6,1
EG,RU,2017.0,11,11,0
QA,SE,2019.0,9,4,5
ES,HU,2016.0,8,6,2
US,CU,2021.0,46,69,-23
LB,US,2015.0,69,79,-10
GB,UA,2018.0,27,23,4
MA,FR,2013.0,202,310,-108
CA,KR,2009.0,52,51,1
PE,CU,2021.0,15,11,4
FR,SI,2013.0,9,13,-4
RU,SE,2001.0,31,26,5
MX,CA,2017.0,44,60,-16
JP,MY,2021.0,46,26,20
LU,FR,2012.0,30,49,-19
SI,AU,2010.0,4,3,1
CH,NO,2001.0,8,11,-3
IN,AT,2001.0,11,18,-7
PT,MA,2019.0,35,26,9
RO,AT,2015.0,12,6,6
RU,FR,2016.0,73,111,-38
GR,DE,2013.0,90,57,33
DK,KE,2019.0,3,3,0
nan,ES,2006.0,15,5,10
NL,TZ,2016.0,4,3,1
FR,TR,2007.0,18,13,5
AU,RU,2009.0,9,19,-10
LI,DE,2003.0,3,2,1
NL,DK,2003.0,22,12,10
CA,AE,2004.0,11,5,6
IN,NZ,2006.0,16,9,7
TR,BR,2011.0,33,15,18
HU,DE,1997.0,18,20,-2
IT,SE,2005.0,54,52,2
IT,FR,2000.0,168,155,13
nan,CA,2005.0,19,10,9
BE,JP,2019.0,30,28,2
US,HU,2010.0,87,128,-41
FR,RO,2016.0,48,62,-14
GR,JP,2004.0,46,27,19
RS,HR,2014.0,92,141,-49
RO,SE,2009.0,7,5,2
FR,PL,2013.0,53,39,14
BE,nan,1998.0,7,14,-7
SN,FR,2004.0,13,18,-5
IN,IE,2015.0,35,22,13
PH,KR,2014.0,10,8,2
TN,QA,2019.0,12,3,9
VE,CL,2000.0,3,5,-2
CN,AT,2011.0,16,11,5
ID,GB,2017.0,48,93,-45
BO,ES,2016.0,21,20,1
ZA,IT,2016.0,16,31,-15
US,PT,1999.0,34,49,-15
CL,BE,2015.0,16,12,4
CA,CH,2007.0,72,97,-25
BR,IR,2012.0,4,14,-10
GB,BI,2014.0,2,2,0
DK,AU,2013.0,41,32,9
ID,GB,2019.0,72,121,-49
SE,CL,2008.0,4,3,1
CZ,BE,2019.0,12,10,2
SA,US,2013.0,91,208,-117
TW,BR,2016.0,3,2,1
PK,TH,2022.0,9,4,5
RO,BE,2002.0,7,10,-3
BG,CZ,2011.0,4,2,2
AE,LB,2019.0,6,5,1
IL,CH,2019.0,25,18,7
nan,PL,2019.0,14,27,-13
ES,SK,2016.0,3,4,-1
PT,FR,2015.0,66,47,19
AU,MK,2007.0,21,18,3
SG,IR,2011.0,20,15,5
GR,IT,2004.0,9,12,-3
DE,IT,2014.0,231,345,-114
MY,CA,2002.0,4,1,3
nan,MX,2011.0,17,21,-4
TR,RS,2017.0,22,119,-97
AT,PT,2011.0,4,3,1
IL,CH,2017.0,26,22,4
PK,SG,2018.0,4,9,-5
LK,KR,2010.0,2,1,1
BR,FR,2000.0,45,55,-10
CH,JP,2003.0,49,33,16
nan,IL,2001.0,17,8,9
GB,MY,1998.0,19,9,10
DZ,BR,2016.0,3,2,1
DE,CO,2005.0,5,7,-2
US,RS,2003.0,39,29,10
GR,AE,2014.0,8,2,6
MY,nan,2014.0,52,72,-20
UG,DE,2021.0,3,4,-1
TW,NZ,2006.0,1,9,-8
PL,NO,2007.0,7,2,5
AZ,TR,2016.0,7,9,-2
PK,FJ,2014.0,2,1,1
CN,IE,2016.0,25,44,-19
IN,GH,2007.0,3,4,-1
IS,NO,2003.0,3,1,2
ES,CN,2017.0,75,72,3
MX,JP,2003.0,8,5,3
LS,US,2019.0,1,4,-3
PL,SE,2011.0,20,26,-6
NL,SG,2018.0,23,18,5
NL,CA,2022.0,53,43,10
MZ,BE,2018.0,16,4,12
BE,CA,2009.0,52,47,5
CO,DE,2013.0,37,27,10
BD,FR,2017.0,7,12,-5
JP,CZ,1999.0,6,10,-4
NO,FR,2009.0,46,47,-1
RO,ES,2016.0,20,9,11
AU,BR,2000.0,16,9,7
FR,CL,2007.0,28,33,-5
FR,BF,2022.0,12,12,0
LT,DE,1997.0,3,2,1
TR,CH,2003.0,4,3,1
GB,FR,2023.0,18,13,5
DE,CZ,2002.0,22,33,-11
CA,LB,2019.0,23,18,5
PA,KR,2015.0,3,2,1
PR,KR,2015.0,38,32,6
SE,PE,2022.0,1,1,0
JM,TT,2013.0,24,19,5
IL,FR,2002.0,27,25,2
CL,FR,2013.0,39,55,-16
nan,EE,2019.0,4,1,3
CZ,CL,2020.0,3,2,1
ZM,GB,2013.0,5,11,-6
CZ,DE,2014.0,56,84,-28
NZ,ID,2014.0,5,5,0
FR,BW,2019.0,1,1,0
GB,KZ,2004.0,1,3,-2
BE,LB,2020.0,5,5,0
FR,DZ,2004.0,30,33,-3
PH,IT,2016.0,4,3,1
ID,GB,2010.0,12,17,-5
DE,CZ,2005.0,32,42,-10
FR,AR,2006.0,22,32,-10
ID,BE,2022.0,5,6,-1
UY,IT,2011.0,5,6,-1
CU,CA,2020.0,8,3,5
IQ,CN,2012.0,5,4,1
MX,CA,2019.0,47,36,11
EC,CO,2013.0,13,45,-32
TG,NG,2016.0,1,1,0
FR,SN,1997.0,2,9,-7
BE,JP,2017.0,20,27,-7
SE,PK,2022.0,6,16,-10
IE,IT,2000.0,7,3,4
MZ,BR,2018.0,13,21,-8
DE,LT,2016.0,5,8,-3
MM,MY,2020.0,3,4,-1
BR,BO,2021.0,6,7,-1
MD,TN,2014.0,18,5,13
LK,KR,2019.0,7,7,0
PY,UY,2020.0,3,2,1
IT,MY,2011.0,47,34,13
NG,TH,2014.0,4,3,1
HU,CH,2006.0,12,9,3
JP,SA,2019.0,15,9,6
KW,GB,2011.0,13,6,7
RU,AZ,2017.0,20,24,-4
US,VG,2021.0,3,1,2
EG,IQ,2012.0,15,5,10
GB,JM,2021.0,4,5,-1
CN,IR,2005.0,6,13,-7
DE,MX,2005.0,18,20,-2
FR,MC,2019.0,9,12,-3
TR,FI,2022.0,6,4,2
BR,PE,2014.0,40,56,-16
FI,GB,2022.0,45,38,7
NL,MY,2013.0,11,4,7
RO,HU,2023.0,4,3,1
PT,CA,2018.0,17,20,-3
GB,PH,2021.0,11,16,-5
AU,NO,2021.0,19,13,6
IT,CO,2015.0,26,21,5
IT,VE,2005.0,5,4,1
RO,US,2015.0,69,104,-35
CN,JO,2020.0,8,3,5
CY,JO,2017.0,1,2,-1
ES,FI,2010.0,10,19,-9
TH,GB,2001.0,19,26,-7
EE,FI,2021.0,11,14,-3
QA,IR,2013.0,2,3,-1
AU,SG,1997.0,13,12,1
AT,NL,2007.0,21,10,11
TN,US,2015.0,15,26,-11
EE,IL,2017.0,3,1,2
FR,SY,2022.0,2,2,0
AR,NL,2013.0,12,12,0
JP,BE,2019.0,28,30,-2
CO,SE,2018.0,11,5,6
IR,IN,2011.0,27,43,-16
SI,TW,2019.0,3,1,2
CL,AT,2018.0,8,3,5
CM,ZA,2015.0,7,8,-1
RU,AZ,2019.0,21,28,-7
KR,IN,2006.0,47,82,-35
NL,HR,2021.0,5,3,2
EC,VE,2019.0,17,47,-30
BE,MZ,2021.0,11,3,8
BF,CM,2001.0,1,1,0
HU,IN,2000.0,3,13,-10
IL,CH,2010.0,13,11,2
IT,AT,2016.0,73,57,16
PE,nan,2021.0,10,7,3
IE,BE,2012.0,8,13,-5
IR,PK,2011.0,6,6,0
SK,RU,2001.0,5,9,-4
ES,FI,2017.0,21,23,-2
RO,GB,2010.0,24,20,4
HU,SE,2013.0,15,5,10
BG,UA,2019.0,19,8,11
GR,CY,2007.0,24,9,15
KZ,KG,2019.0,8,4,4
ET,FR,2011.0,1,2,-1
SK,RO,2015.0,6,4,2
UA,AT,2020.0,5,11,-6
NO,IR,2016.0,12,15,-3
JP,GR,2004.0,27,46,-19
FR,LB,2003.0,25,18,7
GB,EG,2007.0,49,26,23
PK,CG,2012.0,1,1,0
NO,PH,2001.0,3,1,2
CH,LU,2008.0,5,1,4
CH,IL,2014.0,25,14,11
PT,IN,2009.0,9,10,-1
JP,BE,2010.0,13,30,-17
ET,GB,2012.0,8,8,0
SE,GR,2004.0,5,4,1
NL,JP,2008.0,31,31,0
SA,FR,2002.0,2,3,-1
FI,AU,2014.0,18,20,-2
CY,GR,2003.0,10,6,4
AT,EG,2016.0,9,5,4
DE,MX,2002.0,15,16,-1
CA,LB,2010.0,12,6,6
RU,SA,2020.0,4,3,1
IR,JP,2020.0,14,25,-11
DE,BG,2021.0,10,15,-5
TN,AU,2011.0,1,1,0
LU,ES,2019.0,8,14,-6
PL,ES,2010.0,17,12,5
CU,nan,2018.0,9,2,7
nan,PL,2017.0,15,16,-1
ES,UA,2006.0,4,2,2
HR,DK,2019.0,2,1,1
TN,CA,2021.0,13,10,3
PL,US,2023.0,8,11,-3
HU,EE,2009.0,2,1,1
GB,FI,2011.0,64,48,16
IT,HU,2016.0,11,8,3
UA,nan,2004.0,7,10,-3
nan,NO,2004.0,9,11,-2
PL,BA,2011.0,5,2,3
TR,CZ,2004.0,5,2,3
CZ,CH,2002.0,20,15,5
IN,CY,2018.0,4,2,2
TR,RO,2004.0,1,2,-1
UZ,RU,2002.0,9,9,0
RS,CA,2005.0,5,5,0
TZ,CN,2016.0,6,4,2
NL,BE,2023.0,10,10,0
BR,TW,2001.0,1,2,-1
LU,BE,2017.0,18,18,0
AG,HU,1998.0,3,2,1
BH,SA,2007.0,2,2,0
DE,SG,2004.0,15,14,1
OM,DE,2016.0,1,6,-5
SI,MY,2019.0,8,1,7
nan,CA,2002.0,14,7,7
CU,CL,2011.0,13,13,0
TW,PL,2009.0,3,2,1
AE,FR,2021.0,5,23,-18
US,MA,2005.0,6,9,-3
EG,SA,1997.0,10,8,2
BY,RU,2022.0,33,46,-13
JP,NZ,1999.0,13,13,0
RU,CA,2000.0,21,21,0
JP,IT,1998.0,21,32,-11
BO,MX,2016.0,15,8,7
NL,NP,2015.0,4,3,1
VE,PT,2022.0,1,1,0
AR,NG,2019.0,1,1,0
SE,SK,2010.0,5,2,3
AU,CA,2023.0,19,16,3
FI,EG,2017.0,1,4,-3
BO,PE,2016.0,5,4,1
HN,ES,2014.0,6,7,-1
BD,JP,2007.0,25,56,-31
IQ,BA,2021.0,3,3,0
EC,MX,2014.0,15,44,-29
IN,CH,2023.0,5,1,4
CH,RO,2015.0,9,14,-5
RS,MK,2017.0,2,4,-2
MX,SI,2013.0,5,2,3
CN,ZA,2015.0,10,11,-1
GB,OM,2012.0,15,7,8
SA,TW,2007.0,2,1,1
LB,EG,2014.0,10,11,-1
ZA,CM,2020.0,6,5,1
ID,AZ,2021.0,2,3,-1
CN,SA,2009.0,6,3,3
BI,BE,2016.0,2,3,-1
CL,NZ,2011.0,3,5,-2
LU,ES,2010.0,3,2,1
IL,CR,2018.0,2,6,-4
BG,UA,2010.0,9,3,6
MQ,FR,2012.0,16,17,-1
AT,IN,2014.0,11,17,-6
SG,BD,2015.0,2,2,0
BY,US,2020.0,11,16,-5
SI,FR,2015.0,8,11,-3
AR,PY,2020.0,10,16,-6
SY,GB,2016.0,7,6,1
EE,LV,2015.0,5,3,2
ID,NZ,2011.0,1,2,-1
CR,ES,2006.0,18,14,4
KR,TW,2008.0,23,32,-9
CZ,DK,2018.0,6,4,2
RS,RU,2021.0,11,18,-7
BY,CN,2021.0,4,2,2
MW,US,2008.0,6,4,2
LK,NZ,2018.0,6,2,4
AU,BE,2010.0,20,28,-8
TW,PH,2020.0,4,13,-9
EC,VE,2017.0,10,54,-44
CH,GR,2001.0,10,4,6
IQ,KW,2018.0,5,8,-3
BD,SG,2015.0,2,2,0
BE,ZA,2003.0,6,5,1
GR,ES,2013.0,23,16,7
US,MT,2014.0,6,2,4
AR,BR,2007.0,120,84,36
IL,FR,2005.0,28,21,7
JP,PL,2011.0,15,18,-3
NL,NO,2007.0,24,15,9
BE,LU,2011.0,24,8,16
FR,KR,2010.0,15,30,-15
CH,BE,2002.0,25,40,-15
NO,IS,2001.0,2,1,1
NO,UA,2014.0,2,1,1
SA,DZ,2016.0,7,6,1
EG,SA,1998.0,20,18,2
EG,AT,2003.0,1,2,-1
IE,NZ,2019.0,13,22,-9
PE,ES,2000.0,22,15,7
CN,PL,1999.0,1,5,-4
DK,SG,1999.0,8,2,6
GH,US,1999.0,5,5,0
FR,IE,2017.0,40,26,14
NO,BE,2018.0,6,12,-6
AR,CL,1997.0,8,9,-1
BF,FR,2021.0,16,20,-4
MY,AU,2010.0,49,50,-1
BE,IQ,2019.0,1,1,0
SG,nan,2015.0,7,14,-7
PE,MX,2003.0,9,10,-1
GB,MM,2020.0,5,4,1
DO,CO,2015.0,8,2,6
RS,CA,2002.0,5,5,0
GB,SA,1998.0,13,15,-2
BE,AT,2018.0,15,30,-15
PK,AT,2011.0,9,11,-2
BG,NO,2015.0,8,6,2
GT,US,2022.0,6,4,2
US,CY,2014.0,22,15,7
TZ,US,2014.0,14,25,-11
LT,PL,2007.0,3,3,0
JP,NP,2013.0,14,3,11
nan,MM,2019.0,4,2,2
CL,HR,2019.0,2,2,0
PT,MA,2017.0,27,10,17
ZA,PT,2010.0,4,1,3
ES,UY,2005.0,13,24,-11
MK,NL,2016.0,1,2,-1
CO,UY,2008.0,4,6,-2
CH,MA,2021.0,5,3,2
CZ,BE,2017.0,15,13,2
IT,IL,2006.0,10,6,4
CL,IL,2018.0,7,1,6
CH,CL,2012.0,10,12,-2
NO,KR,2009.0,4,3,1
DK,AE,2014.0,1,1,0
EE,CH,2013.0,8,9,-1
CA,AT,2000.0,7,6,1
BG,UA,2017.0,10,10,0
TN,DE,2013.0,2,9,-7
CR,US,2007.0,17,27,-10
CL,BO,2018.0,4,11,-7
TW,KE,2018.0,2,1,1
ID,AT,2000.0,1,2,-1
SI,DE,2003.0,8,5,3
FR,AE,2016.0,16,5,11
KR,CZ,2022.0,6,3,3
IT,AE,2021.0,7,6,1
PL,FI,2003.0,4,1,3
LB,AU,2018.0,7,2,5
EG,UA,2021.0,1,2,-1
HR,IL,2001.0,1,1,0
ZM,US,2021.0,14,14,0
SA,IE,2014.0,8,9,-1
AT,FI,2008.0,9,7,2
CA,TR,2001.0,12,10,2
US,CG,2017.0,2,3,-1
KZ,KG,2017.0,2,3,-1
ZA,NA,2013.0,10,3,7
FI,DK,1999.0,10,10,0
PT,DE,2001.0,8,6,2
FR,HR,2001.0,1,3,-2
BE,ES,2023.0,1,2,-1
MY,LK,2019.0,10,4,6
NO,AE,2015.0,2,3,-1
CI,CA,2014.0,6,1,5
NZ,DK,2011.0,7,7,0
RS,FI,2016.0,1,1,0
RU,IT,2002.0,20,14,6
ZA,PL,2016.0,2,6,-4
IN,TT,2014.0,4,2,2
GD,US,2007.0,4,2,2
AE,SG,2001.0,1,1,0
FI,CZ,2009.0,9,8,1
PS,FR,2022.0,3,2,1
NO,TZ,2022.0,2,1,1
MT,CA,2016.0,3,1,2
DK,KE,2010.0,2,1,1
NL,MX,2011.0,12,11,1
PK,NZ,2021.0,12,4,8
BD,FR,2010.0,3,6,-3
NC,US,2010.0,2,3,-1
KR,BR,2022.0,3,6,-3
VE,CU,2008.0,10,10,0
BG,BR,2018.0,6,6,0
LU,AU,2016.0,2,1,1
SE,BO,2005.0,1,1,0
IT,SA,2015.0,20,2,18
AR,TW,2007.0,5,5,0
NO,IE,2009.0,2,4,-2
PE,SE,2012.0,3,1,2
NZ,nan,2012.0,3,12,-9
DK,CL,2014.0,9,2,7
MK,RU,2018.0,6,1,5
JP,SA,2010.0,6,7,-1
nan,SG,2006.0,8,10,-2
BD,RO,2019.0,1,2,-1
FR,RS,2009.0,5,4,1
KR,ZA,2021.0,5,4,1
HR,CH,2013.0,7,5,2
US,HK,2011.0,11,13,-2
NO,PT,2013.0,3,5,-2
EG,RU,2010.0,4,3,1
VN,CN,2017.0,11,29,-18
US,PR,2017.0,6,7,-1
FR,MQ,2006.0,11,6,5
TW,AR,2005.0,8,1,7
CH,TR,2006.0,7,8,-1
GB,SA,1997.0,9,7,2
IT,CU,2010.0,2,3,-1
AE,ES,2016.0,1,8,-7
TR,ID,2015.0,6,4,2
CA,PT,2021.0,12,14,-2
US,MA,2002.0,13,13,0
NO,PS,2018.0,3,2,1
LK,TH,2018.0,2,4,-2
IT,IE,2000.0,3,7,-4
PH,FR,2020.0,5,9,-4
DK,IN,2001.0,2,5,-3
OM,PK,2020.0,15,4,11
GR,AU,2014.0,20,9,11
PE,GB,2003.0,5,2,3
US,ET,2015.0,46,28,18
IR,TH,2006.0,2,1,1
MY,JP,2008.0,19,42,-23
IN,DK,2012.0,15,17,-2
SK,US,2021.0,28,17,11
IT,SK,2012.0,6,9,-3
PT,MA,2010.0,2,1,1
ES,NI,2012.0,5,5,0
QA,IN,2004.0,1,2,-1
DK,VN,2018.0,3,2,1
CR,UY,2018.0,5,2,3
SI,SK,2018.0,2,3,-1
LT,RU,2021.0,11,6,5
DK,KR,2009.0,3,4,-1
LK,PK,2018.0,1,2,-1
IE,AT,2000.0,3,1,2
VE,BR,2008.0,21,10,11
PL,RO,2011.0,12,5,7
FI,EG,2019.0,3,4,-1
KG,UZ,2021.0,4,3,1
EG,RU,2019.0,14,22,-8
ET,CZ,2018.0,1,1,0
CU,PT,2007.0,3,2,1
AO,US,2020.0,1,3,-2
SE,AR,2021.0,6,9,-3
FI,ID,2013.0,3,3,0
IE,PK,2016.0,11,4,7
IE,IL,2007.0,4,2,2
DE,CR,2017.0,8,7,1
SI,RS,2007.0,10,5,5
ES,EG,2007.0,3,4,-1
CN,TH,1998.0,1,2,-1
AT,RO,2004.0,2,3,-1
NO,JP,2001.0,3,8,-5
GA,FR,2007.0,4,3,1
CA,DZ,2015.0,15,9,6
UY,AR,2011.0,21,20,1
NZ,SG,2017.0,14,17,-3
NZ,PH,2000.0,1,1,0
US,CG,2019.0,3,2,1
IR,FI,2011.0,7,2,5
FI,BD,2021.0,2,3,-1
CR,CO,2008.0,14,13,1
TN,BJ,2021.0,1,1,0
AU,SG,1998.0,20,16,4
AT,KR,2004.0,2,5,-3
CL,FI,2015.0,6,3,3
AR,DK,2018.0,5,5,0
DE,IL,2004.0,25,36,-11
BD,nan,2018.0,3,5,-2
RW,IN,2015.0,12,12,0
TW,EG,2012.0,6,11,-5
SG,NL,1999.0,3,3,0
NG,BD,2016.0,4,2,2
ET,HU,2021.0,2,2,0
BD,SA,2012.0,3,9,-6
SG,SE,1999.0,1,3,-2
CA,LB,2017.0,11,15,-4
NZ,IT,2003.0,4,4,0
IN,EE,2006.0,5,1,4
RS,SK,2018.0,11,10,1
VN,BE,2020.0,9,18,-9
CN,SK,2012.0,5,6,-1
IN,LB,2023.0,2,1,1
GH,NG,2015.0,13,3,10
CR,DE,2013.0,5,7,-2
MD,GB,2014.0,2,2,0
CA,RU,2022.0,18,28,-10
US,AL,2011.0,6,4,2
BE,KR,2016.0,16,13,3
CH,CM,2004.0,2,2,0
CZ,BE,2010.0,11,7,4
EE,ES,2012.0,3,1,2
LU,BE,2019.0,17,25,-8
CN,MU,2014.0,2,1,1
MD,MA,2016.0,3,2,1
BR,NG,2011.0,1,1,0
ZA,PT,2019.0,4,5,-1
AT,IE,2009.0,3,4,-1
CA,VN,2008.0,5,1,4
RS,CH,2012.0,10,5,5
GR,IR,2012.0,3,2,1
PL,CZ,2006.0,31,21,10
JO,DZ,2017.0,4,2,2
SE,SK,2019.0,1,4,-3
RS,IN,2014.0,5,2,3
UA,CH,2003.0,3,3,0
BR,MA,2007.0,3,1,2
TN,CH,2016.0,6,6,0
AR,CL,1998.0,9,5,4
DE,TR,2006.0,24,34,-10
IE,NZ,2010.0,10,15,-5
AU,KZ,2021.0,2,3,-1
BY,VN,2003.0,2,1,1
MA,AT,2014.0,1,1,0
KW,TR,2022.0,3,5,-2
CR,CN,2003.0,1,4,-3
US,BB,2013.0,4,3,1
RU,TR,2012.0,7,6,1
PG,AU,2001.0,3,3,0
QA,BD,2020.0,1,2,-1
PT,NL,2002.0,8,14,-6
IR,BD,2011.0,3,2,1
DE,LI,2008.0,3,2,1
CN,DK,2005.0,6,14,-8
IN,QA,2023.0,2,1,1
IE,NZ,2017.0,17,18,-1
RS,RO,2009.0,1,1,0
IR,TW,2011.0,3,3,0
NL,IE,2022.0,8,14,-6
HR,NL,2009.0,5,5,0
LK,CA,2013.0,5,4,1
ES,GT,2012.0,7,9,-2
CZ,MY,2022.0,3,4,-1
US,HT,2018.0,6,3,3
CH,TW,2020.0,5,8,-3
GB,KH,2020.0,7,7,0
IN,VN,2020.0,7,11,-4
IR,LB,2015.0,3,1,2
nan,RS,2018.0,1,1,0
VE,NL,2019.0,1,4,-3
MY,LK,2017.0,6,7,-1
DK,BR,2000.0,3,2,1
BF,NG,2021.0,2,3,-1
LV,IT,2018.0,3,1,2
IQ,PK,2013.0,2,5,-3
IE,TW,2015.0,3,3,0
US,KE,2023.0,3,2,1
IE,SG,2008.0,1,3,-2
QA,SE,2017.0,6,4,2
CY,JO,2019.0,4,3,1
NL,BR,2000.0,7,9,-2
MW,IN,2016.0,1,1,0
CN,ZM,2011.0,2,1,1
LK,SG,2018.0,3,6,-3
HN,CO,2022.0,1,2,-1
NL,HK,2021.0,18,12,6
JP,AR,2018.0,4,4,0
MW,ZA,2015.0,6,7,-1
IT,NE,2018.0,2,1,1
NO,LK,2019.0,2,1,1
SD,UA,2021.0,3,2,1
TH,NZ,2004.0,3,1,2
ET,SE,2011.0,2,7,-5
ES,RU,2002.0,5,17,-12
GR,BE,2005.0,9,11,-2
RO,FI,2011.0,2,3,-1
nan,CH,2012.0,17,11,6
FR,CY,2018.0,6,3,3
LV,FI,2004.0,1,1,0
UA,KR,2009.0,1,2,-1
DK,IE,2012.0,2,8,-6
BR,IE,2014.0,8,9,-1
JP,IT,1997.0,15,30,-15
MY,CA,2005.0,5,3,2
JP,BY,2016.0,2,1,1
IN,RS,2020.0,2,3,-1
KR,CL,2022.0,1,2,-1
MK,GR,2001.0,2,1,1
ZA,PT,2017.0,4,8,-4
CO,JP,2003.0,6,7,-1
SA,FR,2005.0,3,1,2
PH,BR,2015.0,6,9,-3
BE,DZ,2004.0,2,2,0
MA,BD,2013.0,6,6,0
IE,GR,2014.0,5,4,1
ES,RU,2005.0,4,4,0
EE,GB,2007.0,5,3,2
PF,FR,2006.0,3,3,0
GB,BH,2016.0,12,4,8
SA,CL,2019.0,1,1,0
PT,AT,2021.0,4,8,-4
ID,FI,2017.0,5,2,3
ZA,BE,2005.0,7,8,-1
DO,CU,2013.0,1,2,-1
SE,CY,2019.0,3,3,0
VN,IT,2011.0,1,3,-2
DK,NZ,2018.0,5,13,-8
FI,IE,2012.0,1,3,-2
VE,PE,2009.0,9,7,2
SK,AU,2000.0,4,2,2
RU,NO,2015.0,12,18,-6
MY,NZ,2004.0,1,2,-1
NZ,ES,2014.0,7,13,-6
SD,DE,2015.0,4,6,-2
DZ,IR,2022.0,2,1,1
PG,TN,2017.0,3,1,2
PH,MX,2008.0,2,4,-2
ZA,CL,2018.0,3,3,0
FR,KZ,2018.0,3,2,1
VN,MX,2021.0,9,9,0
SE,AM,2021.0,1,1,0
US,NE,2019.0,2,3,-1
PK,IT,1998.0,1,1,0
CO,TR,2015.0,3,10,-7
AU,CY,2017.0,3,5,-2
RU,AM,2009.0,5,10,-5
LU,CH,1999.0,1,1,0
UZ,RU,2005.0,5,9,-4
US,JO,1997.0,10,4,6
SE,PL,2022.0,13,20,-7
CA,BF,2018.0,4,4,0
DK,MY,2001.0,1,1,0
ZA,NO,2016.0,5,10,-5
MG,CN,2021.0,8,1,7
KW,MY,2016.0,3,4,-1
GB,MY,1997.0,14,9,5
BD,DZ,2016.0,1,1,0
KE,ZM,2021.0,2,1,1
FR,GE,1997.0,2,2,0
FR,CG,2001.0,3,6,-3
AU,CY,2010.0,3,2,1
IE,LU,2021.0,2,1,1
TR,KR,2013.0,3,6,-3
FR,AM,2015.0,2,3,-1
BH,KE,2008.0,4,2,2
KE,BR,2018.0,1,1,0
IT,AO,2003.0,1,2,-1
IT,MG,2016.0,2,2,0
ES,JO,2018.0,5,3,2
CM,NG,2003.0,1,2,-1
SS,GB,2020.0,7,6,1
NO,FI,2002.0,3,12,-9
CM,JP,2017.0,3,5,-2
nan,PL,2010.0,4,8,-4
RU,VN,2014.0,6,8,-2
GH,JP,2022.0,3,5,-2
SE,CR,2005.0,3,2,1
PA,CA,2021.0,3,1,2
RS,CL,2012.0,2,1,1
SE,SK,2017.0,1,3,-2
NZ,EG,2015.0,1,5,-4
TZ,ID,2022.0,1,2,-1
VE,NL,2010.0,1,1,0
TG,FR,2013.0,4,3,1
MK,GB,2013.0,6,2,4
SE,TW,2005.0,2,2,0
JO,SY,2021.0,3,5,-2
BN,NL,2014.0,2,1,1
GE,CZ,2010.0,3,1,2
CI,FR,2005.0,3,6,-3
LV,EE,2015.0,3,5,-2
nan,EG,2011.0,4,1,3
BD,DE,2014.0,13,7,6
ID,PH,2021.0,4,8,-4
TZ,CH,2012.0,4,2,2
ES,IR,2009.0,3,5,-2
ID,FJ,2016.0,1,1,0
CA,HU,2005.0,6,10,-4
KR,ES,1998.0,3,3,0
AG,HU,1997.0,3,1,2
TR,NZ,2020.0,4,3,1
MK,CN,2019.0,4,2,2
GM,UG,2017.0,1,1,0
CH,BD,2021.0,2,2,0
CI,FR,2002.0,4,9,-5
SG,MX,2013.0,6,2,4
BD,IE,2022.0,2,3,-1
MA,LY,2021.0,1,2,-1
SK,NO,2014.0,2,1,1
FR,NL,2023.0,1,4,-3
US,CR,2005.0,8,15,-7
GB,SY,2011.0,10,2,8
IL,IR,2016.0,2,2,0
CH,UA,2012.0,2,7,-5
GR,MK,2001.0,1,2,-1
US,MK,2001.0,2,3,-1
SE,IN,2008.0,13,27,-14
PL,GR,2010.0,8,6,2
DO,FR,2017.0,1,1,0
RO,BE,2005.0,5,9,-4
TN,PL,2022.0,1,1,0
QA,KW,2017.0,3,4,-1
HU,IT,2020.0,7,13,-6
BD,BE,2020.0,2,4,-2
ZM,TZ,2017.0,2,1,1
IN,AG,2019.0,1,1,0
PT,PK,2022.0,1,1,0
ID,NP,2020.0,1,3,-2
RU,AZ,2010.0,10,11,-1
ZA,IQ,2019.0,1,1,0
SG,IQ,2022.0,1,1,0
TZ,ZM,2019.0,2,4,-2
SE,TW,2002.0,1,3,-2
RS,MK,2019.0,1,6,-5
IE,BR,2004.0,1,2,-1
SE,CY,2017.0,2,4,-2
KG,RU,2008.0,1,3,-2
KR,PL,2021.0,4,4,0
JP,EE,2012.0,2,1,1
CO,HN,2010.0,3,2,1
CN,EE,2020.0,4,2,2
IL,SE,2015.0,6,6,0
UG,CO,2019.0,2,1,1
CL,HN,2018.0,4,3,1
GH,VN,2019.0,1,1,0
ID,CD,2020.0,1,1,0
GR,CH,2002.0,5,8,-3
BE,UG,2015.0,4,7,-3
SI,AU,2017.0,7,2,5
CL,DK,2021.0,3,3,0
CN,PA,2016.0,1,1,0
TJ,UZ,2014.0,2,1,1
DK,GL,2007.0,1,7,-6
DE,BF,2017.0,2,1,1
IS,AT,2011.0,1,1,0
UZ,JP,2001.0,3,1,2
IL,NO,2018.0,1,1,0
SK,MK,2008.0,2,1,1
UA,SE,1999.0,2,1,1
PL,KR,2009.0,1,1,0
HR,HU,2008.0,1,2,-1
KR,DK,2022.0,4,2,2
BR,LB,2005.0,2,1,1
EE,IL,2019.0,1,2,-1
PH,AR,2011.0,2,1,1
DE,RS,2000.0,3,5,-2
UA,GB,2004.0,4,5,-1
FI,LT,2017.0,2,1,1
PT,IE,2009.0,6,4,2
NG,QA,2020.0,2,2,0
CZ,BG,2013.0,4,2,2
CL,JP,2016.0,5,1,4
SE,LY,2016.0,2,1,1
PH,CA,1998.0,4,3,1
GH,CM,2017.0,3,3,0
ET,BD,2020.0,1,1,0
SK,HR,2004.0,2,1,1
NL,TR,1997.0,1,1,0
TN,nan,2018.0,4,10,-6
DE,BY,2001.0,4,9,-5
IT,SI,2002.0,4,4,0
TZ,CA,1999.0,1,1,0
CL,IT,1999.0,4,2,2
TH,NO,2015.0,3,4,-1
SK,ES,2006.0,5,1,4
LY,ID,2020.0,2,1,1
JP,PH,2023.0,2,1,1
TW,RU,2022.0,4,3,1
CO,HN,2019.0,5,9,-4
AU,HR,2018.0,4,2,2
HU,VN,2020.0,3,1,2
MY,AR,2008.0,2,4,-2
JO,IT,2014.0,1,2,-1
CA,RO,2001.0,7,12,-5
PT,ST,2017.0,1,3,-2
IL,KR,2003.0,1,1,0
AZ,IR,2020.0,1,1,0
LA,TH,2015.0,2,3,-1
PL,MK,2013.0,1,1,0
CA,LY,2017.0,3,1,2
CZ,TN,2021.0,2,1,1
BH,EG,2003.0,2,2,0
SA,TH,2015.0,2,3,-1
CO,DO,2011.0,2,4,-2
RU,IQ,2012.0,1,2,-1
PK,ES,2004.0,2,1,1
CN,IR,2002.0,3,8,-5
BE,CU,2014.0,1,2,-1
ZA,EG,2020.0,3,4,-1
MZ,DK,2012.0,1,2,-1
ZA,IE,1999.0,3,1,2
AR,BO,2018.0,3,4,-1
GR,SE,2023.0,1,1,0
RU,TJ,2006.0,4,3,1
ET,IE,2022.0,2,1,1
YE,IN,2022.0,1,3,-2
BF,CI,2018.0,5,5,0
SE,KR,2006.0,2,2,0
PA,AR,2012.0,2,3,-1
NL,CL,2004.0,2,1,1
PH,CZ,2014.0,1,1,0
UG,CA,2016.0,3,1,2
MU,CN,2021.0,1,2,-1
NZ,FI,2014.0,3,2,1
PE,PH,2014.0,3,1,2
BF,CH,2019.0,3,1,2
RU,AR,2013.0,1,1,0
CH,SA,2016.0,4,4,0
TN,QA,2017.0,5,5,0
nan,GR,2010.0,3,2,1
LK,KR,2017.0,2,4,-2
US,RE,2015.0,3,5,-2
JO,DZ,2010.0,1,1,0
LB,TN,2021.0,2,1,1
CL,DE,1997.0,4,7,-3
RO,BG,2011.0,1,1,0
EG,KW,2000.0,5,13,-8
BI,US,2006.0,2,2,0
PS,US,2000.0,2,7,-5
ZM,JP,2001.0,1,1,0
KZ,IR,2013.0,2,1,1
NZ,CO,2002.0,1,1,0
JO,CN,2004.0,1,2,-1
JO,CZ,2019.0,1,1,0
CN,BN,2016.0,1,3,-2
SE,LV,2008.0,3,2,1
IT,SM,2019.0,3,3,0
MY,PT,2013.0,3,1,2
CI,SN,2012.0,1,1,0
DE,TZ,2018.0,1,6,-5
CL,EG,2019.0,2,1,1
JP,DK,1999.0,4,9,-5
ES,KR,2015.0,9,10,-1
CH,MU,2018.0,1,2,-1
AU,BT,2021.0,3,2,1
SK,CA,2002.0,6,2,4
BW,US,2005.0,3,4,-1
CZ,TR,2002.0,2,2,0
FR,NP,2016.0,1,1,0
PT,ZA,2013.0,2,4,-2
NG,SE,2008.0,6,2,4
TZ,KR,2020.0,3,2,1
SK,NZ,1999.0,1,1,0
IL,UA,1999.0,1,2,-1
HU,EG,2002.0,1,5,-4
BB,US,2015.0,4,4,0
IE,PT,2013.0,7,5,2
NL,LT,2016.0,2,2,0
BG,SI,2020.0,1,2,-1
CI,GN,2022.0,3,2,1
KE,NL,2013.0,2,14,-12
CL,DE,1998.0,9,13,-4
SD,BR,1998.0,2,2,0
DE,BF,2019.0,2,1,1
PT,ST,2010.0,3,2,1
CO,NZ,2016.0,1,2,-1
PK,JP,2004.0,3,3,0
SV,JP,2011.0,1,2,-1
nan,SA,2012.0,1,1,0
NL,ID,2003.0,3,1,2
BE,NZ,2003.0,3,1,2
AU,TW,1998.0,3,13,-10
GR,BE,2002.0,3,8,-5
ZA,MW,2007.0,1,3,-2
AE,JP,2019.0,1,11,-10
BR,LK,2016.0,3,3,0
SA,PT,2018.0,5,1,4
CA,TZ,2012.0,2,1,1
JP,MM,2006.0,2,1,1
GH,SD,2015.0,1,1,0
NP,NO,2021.0,3,3,0
BW,CH,2011.0,1,1,0
GN,FR,2015.0,3,2,1
US,EE,2000.0,5,6,-1
CG,ZW,2006.0,1,1,0
GE,UA,2019.0,1,3,-2
US,PG,2020.0,1,2,-1
RU,MD,2012.0,5,4,1
FR,GA,2003.0,3,5,-2
TZ,BR,2017.0,1,1,0
BD,AE,2018.0,2,2,0
IS,IT,2012.0,1,2,-1
US,ZW,2001.0,3,10,-7
VE,PY,2018.0,2,3,-1
SV,CL,2008.0,3,1,2
AR,JP,2008.0,3,7,-4
nan,PT,2001.0,6,3,3
MY,DE,2000.0,1,1,0
JM,BS,2016.0,1,1,0
LB,IN,2014.0,2,2,0
GB,LB,2000.0,3,3,0
KR,FI,1998.0,1,1,0
MK,CN,2017.0,1,7,-6
PK,KW,2003.0,1,2,-1
FR,DJ,2020.0,1,4,-3
PA,IN,2011.0,1,1,0
PL,IT,2023.0,2,4,-2
NP,NL,2021.0,2,3,-1
IN,AR,2006.0,1,3,-2
IR,MX,2021.0,4,3,1
IE,SE,2004.0,1,10,-9
AT,BA,2021.0,2,1,1
MW,NL,2015.0,1,3,-2
MN,TW,2018.0,2,4,-2
IT,KR,2009.0,3,8,-5
PE,PL,2021.0,1,2,-1
AU,KW,2007.0,1,2,-1
GW,NP,2020.0,1,1,0
SI,IT,2000.0,4,1,3
PK,BH,2023.0,2,1,1
UY,CA,2013.0,2,1,1
DE,ET,2023.0,1,1,0
IT,SM,2010.0,2,1,1
RS,IT,2001.0,1,2,-1
NG,TZ,2009.0,1,1,0
TT,GB,2012.0,1,4,-3
NO,SK,2016.0,1,1,0
TR,RS,2019.0,2,44,-42
US,CG,2010.0,1,1,0
NZ,VN,2015.0,1,2,-1
GH,SA,2015.0,1,2,-1
PL,PE,2010.0,1,1,0
SS,US,2008.0,1,5,-4
GE,CZ,2019.0,1,3,-2
CU,NZ,2013.0,1,1,0
RS,GR,2018.0,1,2,-1
CA,TH,2000.0,2,1,1
MZ,UA,2011.0,5,2,3
GB,SJ,2010.0,2,1,1
MX,BG,2003.0,2,1,1
ES,DZ,2006.0,2,1,1
FI,ET,2012.0,1,1,0
IQ,DK,2020.0,1,1,0
SA,HU,2019.0,2,3,-1
AE,KW,2016.0,3,5,-2
JP,US,2011.0,1758,1881,-123
CN,US,1998.0,1252,1214,38
DE,IE,2017.0,88,87,1
ES,BR,2002.0,125,122,3
AU,BD,2022.0,33,60,-27
ES,AR,2022.0,180,176,4
IT,MX,2022.0,17,15,2
TN,FR,2013.0,141,211,-70
RS,TR,2014.0,79,78,1
GE,US,2007.0,157,110,47
ES,BD,2014.0,17,18,-1
GR,PT,2012.0,5,1,4
EG,JP,1997.0,7,5,2
CL,BR,2009.0,67,52,15
AR,MX,2022.0,65,59,6
CH,CA,2011.0,105,117,-12
RU,IT,2005.0,31,15,16
IN,DE,2015.0,219,192,27
ES,CL,2022.0,210,249,-39
ZA,CN,2009.0,13,15,-2
CN,SY,2007.0,20,17,3
MY,CN,2010.0,26,49,-23
ZA,AU,2006.0,42,34,8
MY,CN,2017.0,92,105,-13
QA,GB,2022.0,17,16,1
FR,KR,2019.0,27,41,-14
US,IQ,2008.0,3,3,0
SG,US,2009.0,256,313,-57
SI,MY,2017.0,10,1,9
JP,BE,2017.0,27,20,7
CO,NL,2014.0,8,13,-5
NL,HU,2016.0,24,14,10
DE,CR,2019.0,5,3,2
MM,US,2013.0,3,2,1
CO,KE,2014.0,4,4,0
CL,CN,2004.0,3,2,1
BY,DE,2018.0,4,9,-5
nan,GR,2019.0,7,4,3
AR,IT,2005.0,61,50,11
ES,IN,2016.0,24,22,2
ES,EC,2003.0,6,8,-2
nan,IE,2020.0,4,3,1
ET,BH,2017.0,17,5,12
NO,CA,1999.0,3,11,-8
JP,SY,2016.0,1,2,-1
GH,CZ,2019.0,7,1,6
CA,NL,2010.0,83,84,-1
DE,NG,2013.0,6,8,-2
SI,ID,2020.0,12,10,2
FR,NE,2013.0,14,4,10
IN,ES,2014.0,35,31,4
JP,SE,2015.0,36,31,5
FR,KR,2017.0,34,34,0
AT,NO,2013.0,12,5,7
SK,RS,2011.0,5,8,-3
TH,KH,2018.0,5,2,3
RU,CH,2011.0,21,12,9
MA,CN,2012.0,2,3,-1
ES,nan,2015.0,47,47,0
nan,TR,2015.0,17,18,-1
NZ,SG,2019.0,20,13,7
AE,NZ,2004.0,4,3,1
US,NE,2017.0,3,2,1
AU,AE,2014.0,15,10,5
NO,CN,2012.0,30,54,-24
DK,IT,2011.0,17,43,-26
MU,GB,2009.0,2,3,-1
GR,CH,2005.0,2,17,-15
SE,NL,2005.0,32,28,4
CU,PA,2011.0,2,2,0
GA,DE,2006.0,4,5,-1
LV,US,2003.0,3,3,0
BY,CZ,2007.0,8,3,5
FR,MC,2010.0,8,1,7
FR,MC,2017.0,9,4,5
CA,JO,2020.0,18,19,-1
ZA,BE,2002.0,7,7,0
ES,SI,2016.0,19,14,5
RO,FR,2020.0,30,59,-29
HU,IR,2016.0,4,1,3
NG,KR,2018.0,15,8,7
UY,AU,2021.0,2,3,-1
AU,TW,1997.0,3,1,2
NO,GR,2019.0,8,17,-9
NL,ZW,2011.0,2,2,0
TR,AU,2021.0,12,7,5
PL,ES,2017.0,20,26,-6
CA,RS,2000.0,2,1,1
VE,GB,2016.0,2,5,-3
AM,IT,2021.0,30,35,-5
nan,TW,1998.0,3,1,2
CO,KR,2011.0,6,3,3
CZ,MX,2008.0,2,1,1
PK,BR,2015.0,8,9,-1
AZ,IT,2015.0,1,4,-3
CU,NG,2019.0,2,2,0
NG,PT,2019.0,2,2,0
KR,BE,2014.0,9,11,-2
NO,KZ,2022.0,2,1,1
GR,nan,2013.0,2,5,-3
HR,GB,2007.0,9,4,5
CZ,AT,1999.0,5,4,1
CH,ET,1999.0,1,1,0
KR,UZ,2020.0,4,3,1
ES,UY,2002.0,12,14,-2
VE,DE,2021.0,5,3,2
BJ,NG,2018.0,12,10,2
PY,BE,2013.0,1,1,0
JP,SA,2017.0,13,12,1
GT,CL,2009.0,1,5,-4
AL,XK,2018.0,10,1,9
MX,SE,2014.0,9,10,-1
JP,CU,2008.0,4,1,3
GB,JO,1999.0,10,2,8
MA,MY,2016.0,6,1,5
RU,EG,2015.0,6,2,4
FR,ML,2018.0,14,18,-4
PL,IL,1998.0,1,5,-4
LU,ES,2017.0,2,12,-10
NL,SK,2008.0,7,9,-2
UZ,AU,2012.0,2,2,0
US,DO,2014.0,5,6,-1
AM,JP,2009.0,6,4,2
JO,KW,2021.0,9,5,4
VN,TW,2003.0,2,1,1
IT,PE,2000.0,1,1,0
US,PR,2019.0,6,10,-4
LY,EG,2016.0,8,6,2
JO,IR,2018.0,3,3,0
nan,GR,2017.0,5,4,1
CO,NI,2018.0,7,8,-1
PL,ZA,2004.0,1,3,-2
NL,LU,2011.0,3,3,0
AR,PK,2001.0,3,1,2
PH,CA,1997.0,2,3,-1
DE,CW,2009.0,3,2,1
MX,VN,2005.0,1,5,-4
EE,IT,2018.0,3,3,0
BR,CZ,2018.0,6,10,-4
ZA,SE,2011.0,8,14,-6
IT,SI,2005.0,9,4,5
BG,CH,2020.0,3,6,-3
PG,CA,2019.0,1,2,-1
CA,LY,2019.0,1,1,0
VG,GB,2012.0,3,4,-1
BR,CV,2019.0,3,1,2
AT,RS,2012.0,8,6,2
BW,AU,2020.0,2,3,-1
CY,CA,2021.0,4,1,3
IL,JP,2022.0,5,1,4
CO,BD,2022.0,1,1,0
GB,MZ,2019.0,1,2,-1
ZA,RO,2008.0,2,1,1
HR,BE,2015.0,2,4,-2
SK,CA,2005.0,4,2,2
BO,FR,2017.0,1,2,-1
CA,KE,2006.0,2,3,-1
TH,ZA,2020.0,1,4,-3
SZ,ZA,2022.0,2,6,-4
PK,MX,2013.0,3,2,1
FJ,IN,2022.0,2,3,-1
DK,TH,2020.0,4,1,3
NE,MA,2019.0,1,2,-1
SD,SA,2000.0,1,2,-1
DK,ZA,2016.0,7,15,-8
JP,KE,2007.0,8,3,5
SA,HU,2017.0,3,2,1
LT,EE,2020.0,1,1,0
IT,SD,2006.0,1,1,0
MX,IE,2004.0,2,2,0
CL,CA,2023.0,1,3,-2
BY,IN,2010.0,1,4,-3
PT,CU,2021.0,1,4,-3
PL,IL,1997.0,3,3,0
DK,EG,2020.0,3,3,0
NO,GR,2010.0,3,2,1
MS,GB,2006.0,1,1,0
AU,NZ,2009.0,128,183,-55
FI,TH,2006.0,1,3,-2
GB,SI,2016.0,10,21,-11
MY,CN,2019.0,130,127,3
CO,GB,2021.0,24,21,3
AE,LB,2017.0,5,5,0
CA,CZ,2022.0,7,5,2
PL,ES,2019.0,22,31,-9
NO,CL,2020.0,5,3,2
QA,JP,1998.0,2,1,1
PT,NL,2005.0,9,7,2
IR,DE,1999.0,1,2,-1
IL,DK,2012.0,4,2,2
HR,DK,2017.0,5,2,3
MX,VN,2002.0,2,4,-2
NO,GL,2009.0,1,1,0
NZ,KE,2018.0,2,1,1
HR,nan,2016.0,4,1,3
AM,CA,2007.0,4,1,3
,GB,2002.0,15517,0,15517
GB,,2014.0,10719,0,10719
ES,,1998.0,655,0,655
,US,2004.0,75797,0,75797
,US,1996.0,91680,0,91680
,SI,1997.0,435,0,435
NL,,2004.0,1771,0,1771
,CL,2010.0,1737,0,1737
,GB,2005.0,17736,0,17736
FR,,2025.0,4590,0,4590
,JP,2016.0,15071,0,15071
BO,,2022.0,128,0,128
,IR,2007.0,8193,0,8193
,TW,2010.0,4724,0,4724
CU,,2016.0,322,0,322
HU,,2022.0,2981,0,2981
,RO,1994.0,1135,0,1135
,DK,2010.0,2238,0,2238
,FR,2007.0,14689,0,14689
,CO,1999.0,808,0,808
EG,,2014.0,661,0,661
,PT,2011.0,2328,0,2328
,IL,2009.0,2276,0,2276
,SK,2008.0,769,0,769
,CR,2010.0,226,0,226
,TT,2011.0,45,0,45
,SG,1994.0,1637,0,1637
UY,,2024.0,1365,0,1365
QA,PT,2015.0,2,0,2
,TN,2004.0,977,0,977
,ID,2009.0,3715,0,3715
,AR,2001.0,1752,0,1752
MM,NL,2022.0,2,0,2
RU,,2007.0,3185,0,3185
SK,,2018.0,713,0,713
,NL,2018.0,4813,0,4813
,EG,2000.0,1090,0,1090
SS,,2022.0,12,0,12
,NG,2013.0,2748,0,2748
MZ,,2021.0,70,0,70
EE,,2024.0,1947,0,1947
,CM,2014.0,519,0,519
,CL,2017.0,1639,0,1639
YE,,2023.0,203,0,203
,SI,1998.0,448,0,448
PY,,2022.0,220,0,220
SZ,,2000.0,2,0,2
,TN,1996.0,227,0,227
IT,,1998.0,1332,0,1332
NC,SN,2011.0,1,0,1
LV,,2016.0,194,0,194
,QA,2005.0,94,0,94
,MA,2004.0,571,0,571
,JO,2000.0,154,0,154
,MA,1996.0,345,0,345
BY,,2020.0,355,0,355
PA,CO,2007.0,5,0,5
,SA,1998.0,438,0,438
FI,,2001.0,422,0,422
,TH,2012.0,2544,0,2544
,SD,2013.0,152,0,152
MY,,2001.0,72,0,72
,TW,2017.0,2397,0,2397
,TW,2019.0,1664,0,1664
,SN,2002.0,79,0,79
LK,,2020.0,478,0,478
,CL,2019.0,644,0,644
CN,BT,2021.0,1,0,1
,KZ,2014.0,733,0,733
,LT,2014.0,684,0,684
TN,,2013.0,388,0,388
TH,,2018.0,1664,0,1664
,ET,2000.0,142,0,142
QA,,2012.0,49,0,49
,MM,2002.0,27,0,27
SY,,2013.0,66,0,66
,ER,2009.0,1,0,1
LT,,2007.0,84,0,84
,QA,2002.0,68,0,68
MM,,2016.0,8,0,8
,KW,2011.0,208,0,208
JM,,2016.0,65,0,65
,HU,2016.0,1390,0,1390
MN,,2014.0,25,0,25
,DZ,2001.0,266,0,266
ZM,,2020.0,109,0,109
ET,,2014.0,78,0,78
CW,,2021.0,11,0,11
,UG,2008.0,259,0,259
,DK,2017.0,1874,0,1874
,AZ,2011.0,142,0,142
,HN,2001.0,21,0,21
HN,CL,2008.0,3,0,3
PH,CL,2003.0,1,0,1
DZ,,2011.0,144,0,144
,SY,1996.0,40,0,40
,UZ,2016.0,134,0,134
,SN,2005.0,76,0,76
,CR,2017.0,261,0,261
HN,,2022.0,55,0,55
,EE,1998.0,189,0,189
,TZ,2015.0,305,0,305
,SA,1997.0,490,0,490
,DK,2019.0,1170,0,1170
,IS,2016.0,111,0,111
LI,,2021.0,17,0,17
BY,SG,1998.0,1,0,1
CZ,,2003.0,277,0,277
,CR,2019.0,102,0,102
GP,,2013.0,18,0,18
CO,,2003.0,88,0,88
ZA,RS,2011.0,3,0,3
LU,CN,2007.0,1,0,1
KZ,,2016.0,146,0,146
NZ,NO,2022.0,4,0,4
,ST,2015.0,11,0,11
KZ,CZ,2008.0,1,0,1
BD,,2009.0,58,0,58
LB,ZA,2017.0,1,0,1
,NE,2000.0,4,0,4
BI,MG,2019.0,1,0,1
IN,BN,2016.0,2,0,2
NO,,2025.0,1142,0,1142
,UY,2012.0,302,0,302
,CV,2014.0,5,0,5
,GY,2014.0,5,0,5
,GT,2000.0,22,0,22
PL,IR,2005.0,3,0,3
BF,,2009.0,12,0,12
IR,MY,2023.0,1,0,1
PG,TN,2019.0,4,0,4
,CD,2006.0,48,0,48
BO,CL,2002.0,1,0,1
EC,BD,2021.0,1,0,1
SK,PS,2007.0,1,0,1
JP,LA,2019.0,4,0,4
EG,KR,2004.0,3,0,3
UG,MA,2021.0,1,0,1
,MC,1998.0,1,0,1
TR,TZ,2017.0,3,0,3
NE,,2001.0,2,0,2
TG,,2019.0,51,0,51
,EE,1997.0,174,0,174
,BM,2011.0,3,0,3
,SY,2004.0,56,0,56
TW,CL,2015.0,1,0,1
NC,CH,2015.0,1,0,1
KR,HK,2021.0,2,0,2
,VU,2018.0,1,0,1
,KY,2016.0,2,0,2
US,AG,2015.0,4,0,4
HT,,2019.0,9,0,9
IQ,PL,2013.0,1,0,1
CL,CH,1997.0,2,0,2
JP,BG,2018.0,5,0,5
GE,MX,2008.0,1,0,1
IT,CR,2011.0,2,0,2
IN,LT,2011.0,6,0,6
EE,PL,2005.0,2,0,2
,TM,2000.0,3,0,3
IQ,,2005.0,8,0,8
TG,,2017.0,32,0,32
IE,EE,2013.0,1,0,1
MG,MN,2012.0,1,0,1
,MT,2000.0,21,0,21
AM,MZ,2008.0,1,0,1
BN,IN,1997.0,1,0,1
ET,CN,2004.0,1,0,1
NZ,GF,2018.0,1,0,1
SN,,2004.0,14,0,14
CA,FK,2012.0,1,0,1
BE,TG,2009.0,1,0,1
CN,AZ,2014.0,2,0,2
SI,MY,2010.0,1,0,1
,MM,2005.0,10,0,10
ZW,CG,2013.0,1,0,1
ES,IQ,2019.0,2,0,2
CI,IQ,2018.0,1,0,1
VE,KZ,2020.0,1,0,1
AZ,PL,2007.0,4,0,4
EG,TZ,2016.0,1,0,1
,HK,1995.0,27,0,27
KY,JM,2014.0,1,0,1
RS,CN,1997.0,1,0,1
MA,RU,2018.0,1,0,1
CU,GT,2016.0,5,0,5
ZM,LK,2010.0,3,0,3
SS,IN,2004.0,1,0,1
NL,ME,2016.0,1,0,1
HR,NO,2015.0,2,0,2
UA,QA,2016.0,2,0,2
CR,ID,2006.0,2,0,2
KR,BN,2013.0,1,0,1
ET,NL,2003.0,2,0,2
MZ,CH,2011.0,1,0,1
SN,NE,2012.0,3,0,3
ML,BE,2017.0,2,0,2
HT,,2010.0,2,0,2
AU,FJ,2005.0,4,0,4
LT,LV,2001.0,2,0,2
IN,SK,2003.0,2,0,2
TW,LU,2012.0,1,0,1
NG,FI,2009.0,1,0,1
BD,RO,2017.0,3,0,3
CD,FR,2006.0,2,0,2
SY,LB,2006.0,2,0,2
IT,MD,2006.0,4,0,4
DK,KW,2019.0,1,0,1
DZ,PT,2009.0,2,0,2
CU,ET,2006.0,1,0,1
MY,PH,2008.0,2,0,2
CA,RE,2008.0,2,0,2
ID,SG,2002.0,2,0,2
PK,BA,2017.0,1,0,1
GL,,2001.0,1,0,1
DK,NG,2016.0,1,0,1
NZ,GH,2001.0,1,0,1
NE,US,1998.0,1,0,1
TN,ZA,2022.0,1,0,1
MW,CH,2017.0,3,0,3
NE,EG,2018.0,1,0,1
AE,SD,2006.0,2,0,2
SO,GB,2017.0,1,0,1
BR,CY,2003.0,1,0,1
NG,ES,2016.0,5,0,5
UA,AR,2002.0,1,0,1
DZ,NE,2021.0,1,0,1
GH,,1999.0,7,0,7
PE,YE,2016.0,1,0,1
IT,HN,2021.0,2,0,2
LK,SI,2005.0,2,0,2
ZW,,2012.0,19,0,19
KG,,2003.0,2,0,2
IL,CO,1998.0,2,0,2
CI,,2005.0,4,0,4
TR,IS,2007.0,2,0,2
NA,US,2017.0,4,0,4
BF,CG,2004.0,1,0,1
PH,PE,2007.0,1,0,1
TJ,CN,2017.0,2,0,2
AU,GM,2019.0,2,0,2
CR,CA,2008.0,1,0,1
JP,ML,2006.0,1,0,1
FR,MZ,2011.0,1,0,1
MW,,2004.0,4,0,4
LT,NO,2000.0,1,0,1
ZW,LS,2019.0,2,0,2
NC,,2007.0,5,0,5
EC,NZ,2017.0,1,0,1
HR,DK,2010.0,2,0,2
LY,TN,2008.0,1,0,1
CU,AT,1999.0,1,0,1
BB,,2006.0,5,0,5
TN,PA,2012.0,2,0,2
EE,UA,1999.0,1,0,1
AU,FJ,2002.0,2,0,2
UG,,2006.0,16,0,16
AE,SO,2011.0,1,0,1
LR,KE,2016.0,1,0,1
ET,DK,2014.0,2,0,2
TH,SG,1998.0,1,0,1
KY,SA,2009.0,1,0,1
PL,CO,1999.0,1,0,1
NC,NZ,2020.0,1,0,1
KR,RO,2000.0,1,0,1
GH,NL,2004.0,1,0,1
KZ,DE,2006.0,4,0,4
CY,NO,2019.0,4,0,4
CA,LA,2010.0,1,0,1
GR,GH,2010.0,1,0,1
BR,CM,2005.0,1,0,1
GB,MZ,2017.0,1,0,1
PT,TZ,2013.0,1,0,1
AT,PE,2009.0,1,0,1
IT,NP,2014.0,4,0,4
KW,DZ,2011.0,1,0,1
KE,SD,2011.0,2,0,2
LU,CG,2017.0,1,0,1
BG,MX,2000.0,4,0,4
VE,GT,2017.0,1,0,1
SN,BE,1999.0,2,0,2
TG,,2010.0,7,0,7
AL,SE,2008.0,3,0,3
GE,BR,2012.0,2,0,2
MD,EG,2006.0,1,0,1
ER,,2018.0,6,0,6
MM,PK,2005.0,1,0,1
FR,KH,2003.0,3,0,3
SI,ET,2021.0,2,0,2
SK,VN,2020.0,1,0,1
FJ,AT,2020.0,1,0,1
SE,QA,2015.0,6,0,6
,AL,1994.0,20,0,20
NL,MQ,2020.0,1,0,1
CU,IN,2019.0,3,0,3
PK,BW,2010.0,1,0,1
SA,AU,2006.0,2,0,2
PG,CA,2010.0,1,0,1
PH,JM,2008.0,1,0,1
,HT,2003.0,1,0,1
AM,ES,2009.0,1,0,1
PT,TH,2007.0,2,0,2
RS,MK,2010.0,1,0,1
,MC,1997.0,6,0,6
DK,SK,2021.0,2,0,2
MW,FR,2013.0,1,0,1
AE,KZ,2007.0,1,0,1
PG,GH,2000.0,1,0,1
LV,CN,2012.0,3,0,3
IN,PT,2023.0,1,0,1
CA,MW,2014.0,2,0,2
CN,PT,2023.0,7,0,7
CO,SA,2011.0,1,0,1
BH,TR,2007.0,1,0,1
PH,PK,1998.0,1,0,1
SE,MN,2018.0,1,0,1
TN,CO,2019.0,1,0,1
FJ,DE,2018.0,1,0,1
IN,LK,2006.0,3,0,3
BR,MT,2006.0,2,0,2
SI,TW,2017.0,1,0,1
BS,,2013.0,1,0,1
CL,DZ,2017.0,1,0,1
FR,UG,2001.0,1,0,1
EE,IL,2010.0,1,0,1
ER,PK,2012.0,2,0,2
BE,MC,2014.0,1,0,1
LS,IE,2011.0,1,0,1
AU,KH,2002.0,2,0,2
IE,VN,2013.0,1,0,1
GB,AZ,2008.0,1,0,1
MX,AE,2007.0,1,0,1
IN,IQ,2005.0,1,0,1
SE,LK,2001.0,3,0,3
PS,LU,2019.0,1,0,1
PK,LB,2015.0,1,0,1
NI,US,2023.0,1,0,1
SG,HU,2014.0,1,0,1
SV,MX,2003.0,2,0,2
ZM,NP,2011.0,3,0,3
JM,CU,2011.0,1,0,1
ES,MC,2013.0,1,0,1
GB,PY,2000.0,1,0,1
XK,ME,2016.0,1,0,1
JM,MQ,2021.0,1,0,1
nan,MA,2005.0,2,0,2
BY,ES,2003.0,1,0,1
IQ,,2002.0,4,0,4
NC,BJ,2005.0,1,0,1
DE,BM,2019.0,1,0,1
CY,CZ,2018.0,1,0,1
PK,CD,2008.0,1,0,1
CZ,AM,2010.0,2,0,2
SV,AR,2007.0,1,0,1
IS,FR,2008.0,1,0,1
CU,HU,2020.0,1,0,1
US,CV,2017.0,1,0,1
HU,EG,2005.0,4,0,4
PT,KW,2017.0,1,0,1
CN,BS,2023.0,1,0,1
ET,BH,2010.0,2,0,2
GE,CZ,2017.0,1,0,1
HT,,2017.0,4,0,4
GM,UG,2019.0,1,0,1
AM,AU,1998.0,1,0,1
BD,CY,2012.0,1,0,1
ZA,VE,2007.0,1,0,1
,GE,2020.0,6,0,6
AL,DE,2019.0,2,0,2
BI,,2006.0,2,0,2
PE,IE,2022.0,1,0,1
MO,BR,2012.0,1,0,1
IT,EE,2005.0,1,0,1
PH,CU,2021.0,1,0,1
BE,BF,2015.0,2,0,2
nan,EE,2017.0,1,0,1
BG,RS,2010.0,6,0,6
AZ,CA,2001.0,2,0,2
IL,KE,2012.0,2,0,2
SE,LU,2004.0,2,0,2
ZW,MX,2021.0,2,0,2
UZ,AZ,2008.0,1,0,1
NG,ZA,1998.0,3,0,3
CH,SC,2006.0,1,0,1
IT,MV,2002.0,1,0,1
BH,SY,2019.0,1,0,1
LU,NL,2003.0,1,0,1
IN,MC,2011.0,1,0,1
PH,PK,1997.0,1,0,1
PT,IQ,2018.0,2,0,2
RE,MQ,2011.0,1,0,1
TN,NE,2018.0,1,0,1
FR,LV,1999.0,3,0,3
DE,GN,2018.0,2,0,2
SD,IN,2008.0,1,0,1
NG,ZA,1997.0,1,0,1
KR,TH,1998.0,2,0,2
BF,PK,2013.0,1,0,1
AR,SI,2020.0,1,0,1
ML,EG,2019.0,1,0,1
SK,SA,2021.0,1,0,1
ZW,AU,2003.0,1,0,1
BF,BE,1998.0,1,0,1
NL,GP,2014.0,1,0,1
KH,NZ,1997.0,1,0,1
NI,IT,2019.0,1,0,1
MM,PL,2006.0,1,0,1
PT,PA,2015.0,2,0,2
,TJ,1995.0,2,0,2
,MS,2000.0,2,0,2
AZ,KZ,2011.0,2,0,2
TW,ET,1998.0,2,0,2
BG,GR,1998.0,7,0,7
TZ,EG,2019.0,1,0,1
SE,CR,2002.0,1,0,1
SI,AR,2011.0,1,0,1
AE,KE,2002.0,1,0,1
TH,SA,2013.0,1,0,1
ZM,AU,2003.0,1,0,1
LU,IE,2020.0,4,0,4
DZ,NL,2000.0,1,0,1
AU,UG,2003.0,1,0,1
ZA,LT,2018.0,1,0,1
,PA,2020.0,4,0,4
IS,PK,2018.0,1,0,1
LT,SK,2020.0,2,0,2
PA,UA,2014.0,2,0,2
MM,TW,2007.0,1,0,1
RU,CR,2009.0,1,0,1
MQ,US,2015.0,1,0,1
SA,GY,2017.0,1,0,1
BE,AZ,2011.0,1,0,1
RU,CY,2022.0,2,0,2
CZ,IE,1998.0,2,0,2
BR,SD,2022.0,2,0,2
CH,NP,2021.0,3,0,3
IL,MD,2006.0,1,0,1
EG,PT,2005.0,1,0,1
BE,PK,1999.0,2,0,2
MG,,2004.0,5,0,5
CZ,NG,2022.0,2,0,2
TW,RS,2006.0,1,0,1
PT,EE,2020.0,1,0,1
GB,XK,2003.0,1,0,1
MA,SG,2015.0,1,0,1
CN,GE,1998.0,1,0,1
GB,SD,2008.0,4,0,4
CZ,PY,2015.0,1,0,1
BG,AU,2013.0,1,0,1
PK,LK,2021.0,3,0,3
FI,PE,2010.0,1,0,1
EG,TN,2004.0,2,0,2
BO,CH,2004.0,1,0,1
FR,MK,2020.0,1,0,1
MN,VN,2008.0,1,0,1
TW,PA,2007.0,1,0,1
CI,,2002.0,4,0,4
BJ,nan,2015.0,1,0,1
MY,HK,2013.0,2,0,2
IN,KY,2021.0,1,0,1
PS,ES,1997.0,1,0,1
BR,ML,2008.0,1,0,1
CL,ST,2014.0,1,0,1
TT,LK,2019.0,1,0,1
EG,CM,2002.0,1,0,1
BJ,UY,2018.0,1,0,1
AE,TT,2021.0,2,0,2
LB,ZA,2010.0,1,0,1
KE,IL,2019.0,1,0,1
FR,MM,2018.0,1,0,1
FR,UZ,2008.0,2,0,2
MX,CZ,2009.0,2,0,2
NC,US,2017.0,5,0,5
NL,TR,1998.0,1,0,1
MW,ID,2021.0,1,0,1
ZW,UG,2023.0,1,0,1
VN,PA,1998.0,1,0,1
ML,DZ,2018.0,1,0,1
JO,NG,2006.0,1,0,1
LY,AU,2004.0,1,0,1
RU,SK,2023.0,1,0,1
ET,CI,2015.0,1,0,1
,SJ,1995.0,1,0,1
MA,NO,2006.0,1,0,1
CM,CF,2014.0,1,0,1
PG,CA,2017.0,1,0,1
ZA,GR,2001.0,2,0,2
BY,FI,2018.0,2,0,2
BR,ZW,2013.0,1,0,1
JM,PH,2018.0,1,0,1
IE,GM,2001.0,1,0,1
CZ,KE,2016.0,1,0,1
AR,AM,2007.0,1,0,1
RO,DE,2023.0,2,0,2
CU,IN,2010.0,1,0,1
NO,SI,2021.0,1,0,1
LV,BG,2012.0,1,0,1
PG,PK,2022.0,1,0,1
UG,MW,2012.0,1,0,1
TH,BR,2021.0,3,0,3
LB,DE,2003.0,2,0,2
LT,DE,1998.0,1,0,1
FR,GE,1998.0,2,0,2
ZW,BR,2003.0,1,0,1
KE,HU,2011.0,1,0,1
ST,nan,2005.0,1,0,1
GB,PR,2022.0,1,0,1
SE,GT,2006.0,1,0,1
NG,PT,2017.0,3,0,3
GE,SA,2023.0,1,0,1
EE,PL,2002.0,1,0,1
PK,IE,2004.0,4,0,4
LV,CA,2012.0,1,0,1
KE,VN,1998.0,1,0,1
TR,LT,2001.0,1,0,1
,AF,2000.0,1,0,1
CY,NO,2017.0,3,0,3
DZ,AT,2007.0,1,0,1
SG,BN,1997.0,1,0,1
NP,GW,2007.0,1,0,1
AU,JE,1999.0,1,0,1
KR,KZ,2006.0,1,0,1
CO,PS,2011.0,1,0,1
PS,DE,2003.0,1,0,1
DE,BM,2017.0,1,0,1
PL,NG,2003.0,1,0,1
CA,KN,2023.0,1,0,1
BN,GR,2020.0,1,0,1
MX,JO,2014.0,1,0,1
AU,QA,1997.0,1,0,1
SI,TW,2010.0,2,0,2
nan,MM,2010.0,1,0,1
MR,US,2005.0,1,0,1
PH,LK,2004.0,1,0,1
EG,KZ,2022.0,1,0,1
SE,SI,1999.0,1,0,1
CH,KW,2011.0,2,0,2
SG,MM,1999.0,1,0,1
CH,IS,2014.0,2,0,2
MT,SA,2018.0,1,0,1
PE,EG,2009.0,2,0,2
BE,JM,2011.0,1,0,1
BJ,NC,2021.0,1,0,1
AG,NL,2000.0,1,0,1
PT,QA,2012.0,1,0,1
UA,SI,2014.0,1,0,1
NG,AE,2009.0,1,0,1
TW,NP,1998.0,1,0,1
SE,NG,2000.0,1,0,1
JM,TR,2013.0,1,0,1
TZ,BR,2019.0,1,0,1
AO,ZA,2006.0,1,0,1
ML,SN,2005.0,2,0,2
ZA,IQ,2017.0,1,0,1
FJ,NL,2016.0,1,0,1
TR,BI,2018.0,1,0,1
NO,BY,2015.0,1,0,1
NZ,IQ,2014.0,1,0,1
RS,TW,2002.0,1,0,1
BR,IS,2022.0,1,0,1
NE,US,1997.0,1,0,1
MA,TG,2014.0,2,0,2
ML,nan,2019.0,1,1,0
NG,BJ,2012.0,1,3,-2
NO,MY,2018.0,3,3,0
KR,GH,2015.0,2,2,0
OM,IR,2015.0,1,4,-3
ID,FI,2019.0,3,14,-11
SE,HR,2005.0,2,2,0
GF,BJ,2017.0,2,1,1
ID,PS,2021.0,2,1,1
HR,AU,2018.0,2,4,-2
EG,CZ,2000.0,1,1,0
BF,CH,2010.0,1,2,-1
IT,SM,2017.0,2,1,1
BE,EG,2011.0,1,3,-2
GB,BJ,2008.0,1,1,0
DE,KE,2004.0,2,7,-5
SI,AU,2019.0,1,3,-2
FI,PL,2003.0,1,4,-3
MA,CH,2006.0,3,2,1
FR,EC,2001.0,2,2,0
DE,CR,2010.0,1,3,-2
KR,AT,2003.0,2,2,0
AE,LB,2010.0,2,2,0
UZ,UA,2012.0,1,1,0
KE,SG,2006.0,1,2,-1
US,SN,2000.0,3,2,1
AT,IL,2018.0,3,4,-1
CO,GT,2008.0,2,1,1
HU,NG,2019.0,2,2,0
CL,CH,1998.0,2,1,1
UG,NZ,2018.0,2,3,-1
EG,IL,2008.0,1,2,-1
AR,IE,2007.0,2,2,0
HR,FR,2011.0,2,1,1
BW,US,2002.0,3,3,0
TR,SI,2009.0,1,1,0
TN,QA,2010.0,1,2,-1
PH,GH,2022.0,3,7,-4
PL,LV,2015.0,1,1,0
CN,SD,2007.0,1,1,0
SK,FI,2009.0,3,1,2
KR,PK,2009.0,4,7,-3
PE,JP,2020.0,3,1,2
KZ,SG,2014.0,1,1,0
YE,MY,2009.0,2,1,1
PL,TR,1999.0,1,1,0
FR,GN,2007.0,2,2,0
NL,RS,2009.0,1,5,-4
CA,CY,2003.0,1,1,0
EG,TR,2006.0,1,2,-1
UA,FI,2022.0,3,1,2
PL,PK,2001.0,1,3,-2
HR,RU,2021.0,2,4,-2
LK,FR,2013.0,1,4,-3
PK,TZ,2013.0,1,1,0
UZ,DE,2020.0,1,4,-3
PK,UZ,2007.0,1,1,0
CG,TN,2015.0,1,1,0
BO,FR,2019.0,1,1,0
PS,JO,2014.0,1,4,-3
GD,AU,2012.0,1,1,0
MT,SE,2017.0,1,1,0
GR,EE,2016.0,2,1,1
BR,MD,2003.0,1,1,0
PL,LU,2021.0,4,1,3
NZ,TR,2016.0,2,2,0
JP,TZ,2016.0,2,5,-3
SE,NI,2012.0,2,1,1
NO,MX,2012.0,2,1,1
IE,LV,2011.0,1,2,-1
KW,SA,1998.0,1,1,0
CZ,LU,2016.0,1,2,-1
RS,JP,2012.0,1,3,-2
NC,US,2019.0,2,2,0
RS,PL,2008.0,1,1,0
CM,ML,2020.0,2,1,1
ES,IE,2000.0,2,2,0
KZ,US,2011.0,3,8,-5
JO,DE,2022.0,3,4,-1
CW,AT,2011.0,1,1,0
NO,ZA,1997.0,1,1,0
CA,MU,2011.0,1,2,-1
GH,EG,2011.0,1,2,-1
DE,BO,2022.0,1,1,0
CH,SI,2003.0,1,5,-4
CL,HR,2017.0,1,4,-3
PT,BG,2014.0,2,2,0
KR,DZ,2020.0,1,3,-2
PH,CO,2021.0,1,15,-14
LK,CN,2014.0,3,8,-5
PT,PY,2011.0,2,1,1
ZA,OM,2000.0,1,1,0
BR,ET,2015.0,1,1,0
QA,NO,2018.0,1,3,-2
EG,HU,2022.0,1,3,-2
ZA,SZ,2007.0,2,1,1
BH,IN,2005.0,1,2,-1
QA,DK,2018.0,1,3,-2
PY,US,2011.0,1,3,-2
KW,AU,2014.0,3,1,2
NA,US,2019.0,1,6,-5
BE,UA,2008.0,1,1,0
TN,PT,2014.0,1,1,0
MA,SY,2013.0,1,1,0
CZ,SG,2018.0,1,9,-8
nan,BY,2022.0,1,1,0
ML,CA,2018.0,1,1,0
CZ,EE,1998.0,1,1,0
BW,ZW,2013.0,2,2,0
CM,JP,2010.0,1,1,0
VE,EC,2007.0,1,1,0
JP,LA,2017.0,2,1,1
CA,UG,2016.0,1,3,-2
SI,UA,2018.0,2,1,1
PH,TW,2002.0,1,1,0
IL,HU,2000.0,2,1,1
NZ,SA,2011.0,1,1,0
RS,RW,2014.0,1,1,0
US,MU,2016.0,1,2,-1
GH,CM,2019.0,1,4,-3
EG,GR,2020.0,2,2,0
OM,TN,2011.0,1,1,0
EE,CZ,1998.0,1,1,0
EE,nan,2015.0,2,1,1
TH,TZ,2012.0,1,1,0
SE,GH,2021.0,2,1,1
JO,NL,2016.0,1,4,-3
TN,CO,2017.0,1,1,0
RO,KE,2016.0,1,1,0
AZ,US,2006.0,1,1,0
JP,ET,2000.0,1,2,-1
NG,CH,2015.0,2,2,0
SI,NL,2007.0,1,3,-2
LY,GR,2014.0,1,2,-1
MX,GR,2021.0,1,1,0
RW,NL,2011.0,1,1,0
NG,KW,2006.0,1,1,0
SI,CZ,1999.0,1,2,-1
SA,CL,2017.0,1,2,-1
NO,SA,2022.0,1,5,-4
KG,GB,2012.0,1,4,-3
TJ,US,2022.0,1,4,-3
EC,UY,2013.0,1,1,0
GB,SJ,2017.0,1,2,-1
ES,BG,2020.0,1,2,-1
XK,AL,2018.0,1,10,-9
MZ,ES,2009.0,2,2,0
KH,AU,2008.0,1,2,-1
IN,PE,2021.0,1,1,0
LU,DK,2015.0,1,4,-3
IT,BD,2007.0,1,2,-1
IQ,UA,2019.0,1,1,0
KR,PH,2001.0,1,1,0
CD,RW,2019.0,1,3,-2
UZ,NL,2019.0,1,1,0
SI,RU,2014.0,1,3,-2
SA,KR,2005.0,1,1,0
HU,VE,1997.0,1,1,0
DK,RO,2021.0,1,4,-3
LT,ES,2011.0,1,1,0
IL,GR,2011.0,1,2,-1
AR,HN,2006.0,1,1,0
PE,BE,2012.0,1,3,-2
UA,IQ,2016.0,1,1,0
UY,PT,2009.0,1,2,-1
IE,CN,1999.0,1,3,-2
NL,BN,2014.0,1,2,-1
AE,BE,2016.0,1,3,-2
NL,BY,2021.0,1,1,0
AL,DE,2017.0,1,1,0
FI,IN,1999.0,1,3,-2
GL,DK,2009.0,1,4,-3
CH,LI,2007.0,1,1,0
BI,CM,2007.0,1,1,0
KE,MZ,2020.0,1,1,0
HU,LV,2021.0,1,2,-1
IN,BH,2012.0,1,3,-2
RS,AT,2018.0,4,11,-7
AL,DE,2010.0,1,2,-1
TZ,ZM,2017.0,1,2,-1
NL,EE,2011.0,1,1,0
ZA,TH,2018.0,3,2,1
SK,SE,2020.0,4,4,0
SG,LK,2012.0,1,1,0
BR,CV,2010.0,1,1,0
AU,OM,2006.0,1,2,-1
UA,TW,2011.0,1,1,0
DK,CZ,1999.0,2,3,-1
BO,BR,2007.0,1,4,-3
EG,ZM,2019.0,1,1,0
FR,PF,2006.0,3,3,0
AU,CY,2019.0,2,4,-2
VE,CA,1998.0,1,1,0
SV,EC,2015.0,2,1,1
BD,ZA,2016.0,1,1,0
ET,GH,2007.0,1,1,0
NL,VN,2022.0,2,5,-3
GB,BG,2003.0,1,10,-9
CD,BE,2008.0,1,2,-1
IN,AG,2017.0,1,1,0
CA,SY,2020.0,1,3,-2
GB,MZ,2010.0,1,1,0
EG,GH,2012.0,1,5,-4
LB,TR,2020.0,2,2,0
AT,MK,2022.0,1,9,-8
CZ,IR,2020.0,3,14,-11
PH,AT,2018.0,2,1,1
TR,LU,2023.0,1,0,1
MK,IT,2014.0,1,0,1
JP,LB,2013.0,2,0,2
IE,PE,2016.0,1,0,1
UY,CH,2021.0,2,0,2
PT,NZ,2005.0,1,0,1
AR,ET,2020.0,1,0,1
PK,NP,2006.0,2,0,2
KY,CA,2021.0,1,0,1
CH,CY,1998.0,1,0,1
ZA,QA,2016.0,2,0,2
SS,SD,2009.0,1,0,1
FR,TG,2001.0,2,0,2
ID,FI,2010.0,1,0,1
AM,IL,2018.0,1,0,1
ZA,JM,2018.0,1,0,1
KE,IL,2010.0,3,0,3
PT,TL,2017.0,1,0,1
UA,NO,2012.0,3,0,3
nan,QA,2011.0,1,0,1
ZM,IN,2013.0,1,0,1
US,SZ,2009.0,1,0,1
nan,MM,2017.0,1,0,1
BN,NG,2020.0,2,0,2
GE,PL,2015.0,1,0,1
US,LI,2011.0,1,0,1
BF,ET,2016.0,1,0,1
MZ,FR,2022.0,1,0,1
BO,DE,2008.0,1,0,1
nan,UY,2021.0,1,0,1
BR,GR,2001.0,2,0,2
PT,CY,2017.0,1,0,1
VE,CA,1997.0,3,0,3
NZ,CM,2022.0,1,0,1
LV,AT,2003.0,1,0,1
BG,CO,2021.0,2,0,2
GY,GB,2013.0,1,0,1
NA,ZA,1998.0,1,0,1
GE,AR,2016.0,1,0,1
KR,CM,2020.0,1,0,1
ZW,KE,2009.0,1,0,1
,TD,1999.0,1,0,1
PT,ID,2016.0,2,0,2
VE,NL,2017.0,2,0,2
US,IS,2023.0,3,0,3
OM,DZ,2020.0,1,0,1
,GD,1999.0,1,0,1
IR,NZ,2009.0,2,0,2
TN,MG,2009.0,2,0,2
TZ,EG,2017.0,2,0,2
LY,PK,2018.0,1,0,1
TZ,ZM,2010.0,1,0,1
CY,LB,2016.0,1,0,1
CU,NL,2006.0,2,0,2
PT,CY,2019.0,1,0,1
PK,VE,2009.0,1,0,1
NO,LB,2020.0,1,0,1
PL,AE,2023.0,1,0,1
RO,RU,2003.0,1,0,1
SK,IL,2006.0,1,0,1
FI,LK,2019.0,2,0,2
DO,SV,2020.0,1,0,1
CA,IQ,2011.0,2,0,2
IT,LK,2012.0,1,0,1
RO,EG,2009.0,1,0,1
GT,FR,2008.0,1,0,1
IR,AE,2008.0,1,0,1
SY,GH,2012.0,1,0,1
AM,PT,2010.0,1,0,1
MQ,DK,2015.0,1,0,1
BA,AU,2009.0,1,0,1
SN,SL,2017.0,1,0,1
MX,AD,2014.0,1,0,1
VG,AR,2011.0,1,0,1
BS,AE,2015.0,1,0,1
SS,SK,2001.0,1,0,1
ZW,ZM,2012.0,2,0,2
SZ,ZM,2012.0,1,0,1
KH,PK,2001.0,1,0,1
DK,CU,2020.0,1,0,1
CM,ES,2008.0,1,0,1
CI,CM,2014.0,1,0,1
NI,BO,2010.0,1,0,1
KR,KH,2015.0,1,0,1
ZA,ET,2023.0,1,0,1
KY,,2018.0,1,0,1
NI,BO,2019.0,1,0,1
TN,UA,2016.0,1,0,1
TJ,,2001.0,1,0,1
BT,US,2022.0,1,0,1
SI,PT,2021.0,1,0,1
CH,LA,2014.0,1,0,1
AU,ET,1997.0,1,0,1
RU,LU,2018.0,2,0,2
FI,BR,2001.0,1,0,1
RO,VE,2012.0,1,0,1
GR,SI,2008.0,2,0,2
KZ,IQ,2016.0,1,0,1
UG,ES,2006.0,1,0,1
TR,TG,2008.0,1,0,1
AU,PY,2020.0,1,0,1
RO,AO,1998.0,1,0,1
CN,BA,2008.0,1,0,1
MT,SE,2010.0,1,0,1
HK,AE,2020.0,1,0,1
SI,LU,2016.0,1,0,1
LK,TW,2021.0,1,0,1
JP,CW,2016.0,1,0,1
FI,MZ,2014.0,1,0,1
CO,BO,2023.0,1,0,1
KW,AT,2008.0,1,0,1
IN,MW,2021.0,1,0,1
MT,ID,2021.0,1,0,1
UA,PT,1999.0,2,0,2
AU,GH,2004.0,1,0,1
KW,NG,2004.0,1,0,1
ME,AT,2022.0,1,0,1
,LA,2000.0,2,0,2
GH,CZ,2017.0,2,0,2
KE,IR,2004.0,1,0,1
PG,VU,2019.0,1,0,1
BA,IR,2016.0,1,0,1
SI,HU,2014.0,2,0,2
AT,HR,2000.0,2,0,2
KE,BD,2009.0,1,0,1
BE,BJ,2001.0,1,0,1
JP,MK,2013.0,1,0,1
LT,GE,2021.0,1,0,1
AM,CN,2014.0,1,0,1
BE,LY,2018.0,1,0,1
ZA,UY,2007.0,1,0,1
GN,SN,2011.0,1,0,1
CL,AO,2017.0,1,0,1
IL,SG,2004.0,1,0,1
US,MC,2015.0,1,0,1
NG,SO,2022.0,1,0,1
PK,BE,2004.0,1,0,1
UA,KW,2015.0,1,0,1
NE,ML,2011.0,1,0,1
SY,KE,2022.0,1,0,1
UZ,SG,2017.0,1,0,1
MM,NP,2007.0,1,0,1
LS,AU,2000.0,1,0,1
RE,AR,2017.0,1,0,1
FK,PL,2008.0,1,0,1
MK,CZ,2020.0,1,0,1
DJ,,2015.0,1,0,1
CA,BS,2008.0,1,0,1
SA,RW,2012.0,2,0,2
BR,CM,2002.0,1,0,1
CG,AR,2015.0,1,0,1
EE,CZ,1997.0,1,0,1
BA,MX,2004.0,1,0,1
ES,GI,2017.0,1,0,1
SE,KH,2013.0,1,0,1
LK,FJ,2014.0,1,0,1
NL,PS,2013.0,1,0,1
NO,LV,2020.0,1,0,1
FR,ET,1999.0,1,0,1
HU,TW,2015.0,1,0,1
PS,CH,2018.0,2,0,2
PG,ET,2015.0,1,0,1
SA,GH,2014.0,1,0,1
SD,TN,2021.0,1,0,1
RW,AU,2017.0,1,0,1
CM,NE,2007.0,1,0,1
CO,WS,2018.0,1,0,1
CG,RE,2018.0,1,0,1
MG,JE,2009.0,1,0,1
CI,CH,2022.0,1,0,1
FR,SA,1999.0,1,0,1
UA,CL,2012.0,1,0,1
SY,AU,2016.0,1,0,1
PK,YE,2021.0,2,0,2
GE,SE,2003.0,1,0,1
CW,FI,2015.0,1,0,1
BG,KW,2010.0,1,0,1
KE,IL,2017.0,1,0,1
PH,NO,2020.0,1,0,1
CU,BE,1999.0,1,0,1
MR,FR,2006.0,1,0,1
IR,SE,2023.0,1,0,1
TW,CZ,2022.0,1,0,1
IT,KZ,2003.0,1,0,1
RO,IS,2004.0,1,0,1
MT,NZ,2016.0,1,0,1
PL,AL,2017.0,1,0,1
NL,IS,2004.0,1,0,1
GR,MX,2003.0,1,0,1
UZ,NL,2017.0,1,0,1
FI,GD,2015.0,1,0,1
MK,DE,1999.0,1,0,1
TT,BR,2009.0,1,0,1
GB,MC,2003.0,1,0,1
IT,IM,2014.0,1,0,1
HR,AR,2004.0,1,0,1
UZ,MM,2009.0,1,0,1
FI,LT,2010.0,2,0,2
CZ,GH,1999.0,1,0,1
AM,AU,1997.0,1,0,1
JP,BF,2008.0,1,0,1
CM,PH,2016.0,1,0,1
CN,TN,2002.0,1,0,1
IE,ZW,2018.0,1,0,1
OM,LB,2012.0,1,0,1
US,BM,2005.0,1,0,1
CR,EC,2007.0,1,0,1
NO,TW,2002.0,1,0,1
AU,CI,2017.0,1,0,1
CG,TG,2020.0,1,0,1
CA,MQ,2003.0,1,0,1
MD,CA,2015.0,1,0,1
JP,NI,2006.0,1,0,1
ID,BR,2023.0,1,0,1
SK,ID,2016.0,1,0,1
LS,ZA,2023.0,1,0,1
KH,ES,2007.0,1,0,1
LB,DZ,2022.0,1,0,1
VE,ZA,2016.0,1,0,1
GB,KY,2016.0,1,0,1
RU,AE,2012.0,1,0,1
IN,ET,2003.0,1,0,1
,CG,2020.0,1,0,1
CO,PL,2002.0,1,0,1
SY,AT,2006.0,1,0,1
GA,,2001.0,2,0,2
CD,TN,2019.0,1,0,1
SN,EG,2006.0,1,0,1
BZ,,2018.0,1,0,1
TZ,NA,2017.0,1,0,1
CG,MD,2020.0,1,0,1
ZA,FI,2001.0,1,0,1
,FJ,2020.0,1,0,1
MD,IT,2021.0,1,0,1
IL,HR,1998.0,1,0,1
PH,ZA,2003.0,1,0,1
MW,CH,2019.0,1,0,1
VE,AO,2004.0,1,0,1
NP,TW,2006.0,1,0,1
MU,,2000.0,1,0,1
AU,MU,2016.0,1,0,1
SC,,2008.0,1,0,1
UY,RO,2021.0,1,0,1
NO,JO,2001.0,1,0,1
CY,PL,2020.0,1,0,1
MZ,NL,2022.0,1,0,1
MM,TH,1997.0,1,0,1
CA,SO,2019.0,1,0,1
GR,GH,2017.0,1,0,1
KR,UG,2017.0,1,0,1
PG,IN,2022.0,1,0,1
TH,ZM,2014.0,1,0,1
ML,KE,2007.0,1,0,1
MC,US,2018.0,1,0,1
NC,FJ,2021.0,1,0,1
BR,CA,2012.0,266,299,-33
IN,US,2006.0,1294,1068,226
ZA,IN,2015.0,36,101,-65
IN,GB,2005.0,207,174,33
ES,US,2007.0,712,719,-7
GB,NZ,2007.0,222,189,33
US,ES,1998.0,374,318,56
AR,MX,2016.0,144,170,-26
GB,US,2015.0,6083,6092,-9
US,AU,2009.0,2023,1719,304
US,CH,2006.0,642,554,88
CL,MX,2016.0,179,201,-22
CN,SG,2005.0,210,264,-54
TR,FI,2016.0,9,3,6
KW,US,2015.0,20,28,-8
NL,nan,2010.0,55,73,-18
SE,DK,2020.0,149,134,15
NL,GB,2018.0,395,359,36
US,ES,1997.0,326,279,47
NG,KR,2019.0,15,6,9
AU,CN,2005.0,159,186,-27
IN,JP,2004.0,160,108,52
CN,KR,2017.0,237,337,-100
AU,US,2007.0,1660,1853,-193
US,AT,1997.0,99,102,-3
SK,HR,2014.0,3,5,-2
DE,EE,2009.0,38,27,11
US,IS,2000.0,15,8,7
CO,US,2008.0,157,161,-4
PT,BR,2012.0,658,865,-207
VN,CN,2018.0,17,54,-37
US,JP,2008.0,1798,1930,-132
CN,KR,2010.0,259,313,-54
PK,ID,2019.0,62,33,29
NO,MY,2017.0,6,5,1
GB,NG,2007.0,24,15,9
FR,BJ,2009.0,20,25,-5
ES,AR,2016.0,420,342,78
DE,AT,1998.0,164,162,2
NL,IT,2021.0,108,125,-17
BE,FR,2004.0,200,187,13
DE,CN,2010.0,246,252,-6
FR,US,2001.0,975,790,185
PT,CN,2011.0,7,4,3
US,PH,2011.0,383,465,-82
US,NZ,2011.0,377,335,42
GB,BR,2006.0,112,98,14
JM,TT,2008.0,16,15,1
MX,CL,2022.0,70,85,-15
DE,CN,2017.0,371,340,31
US,CO,2012.0,276,237,39
DE,CN,2019.0,451,354,97
IN,SG,2021.0,120,112,8
FR,DE,2013.0,515,538,-23
IN,BE,2016.0,55,53,2
BR,AO,2011.0,17,12,5
US,MX,2002.0,196,192,4
US,CL,2009.0,162,141,21
UY,US,2007.0,14,15,-1
GB,PK,2004.0,30,32,-2
IE,JP,2019.0,44,24,20
BE,US,2005.0,217,189,28
RU,GB,2013.0,104,93,11
JP,CN,2021.0,497,355,142
JP,CL,2005.0,6,4,2
ZA,NG,2015.0,64,62,2
DK,CN,2006.0,16,15,1
KR,CN,2012.0,346,265,81
DE,IL,2014.0,75,59,16
ET,KR,2006.0,101,89,12
AU,SE,2007.0,48,44,4
CN,GB,2017.0,527,649,-122
MX,CU,2009.0,23,56,-33
CU,ES,2017.0,113,80,33
TN,FR,2008.0,114,138,-24
US,BE,2006.0,203,246,-43
ES,MX,2016.0,966,855,111
IE,SG,2013.0,8,4,4
US,EG,2009.0,141,117,24
BE,JP,2018.0,29,23,6
PA,MX,2005.0,6,2,4
CN,GB,2019.0,645,688,-43
DE,RU,2015.0,169,158,11
UA,CH,2001.0,8,2,6
CZ,JP,1998.0,5,10,-5
SA,EG,2017.0,408,383,25
IT,HU,2022.0,5,5,0
CA,AU,2016.0,455,369,86
IE,US,2008.0,339,402,-63
GB,FR,2000.0,234,300,-66
SE,CN,2013.0,87,90,-3
CN,SG,2002.0,139,140,-1
GB,IE,2006.0,264,207,57
SE,US,2016.0,477,487,-10
KR,JP,2006.0,174,270,-96
ES,AU,2011.0,44,23,21
GB,ES,2013.0,311,459,-148
JP,nan,2016.0,53,55,-2
FR,CO,2016.0,44,37,7
DE,AR,2011.0,23,41,-18
US,GE,2013.0,140,167,-27
AR,CO,2012.0,86,89,-3
TN,SA,2020.0,118,73,45
CA,IE,2006.0,75,89,-14
JP,AT,2007.0,15,12,3
TR,JP,2006.0,34,30,4
FI,NO,2007.0,13,4,9
CU,ES,2010.0,123,78,45
DE,nan,2002.0,24,22,2
DE,IT,2004.0,141,138,3
CU,ES,2019.0,104,97,7
MX,GB,2020.0,61,53,8
US,IQ,2013.0,12,8,4
ES,PE,2015.0,113,153,-40
DE,ES,2021.0,228,202,26
FR,ML,2017.0,18,12,6
DE,nan,2005.0,63,34,29
AT,CH,2018.0,130,125,5
NL,CA,2016.0,100,102,-2
CH,BR,2009.0,42,38,4
CH,FR,2007.0,297,403,-106
IN,GB,2002.0,162,135,27
GR,DE,2008.0,46,46,0
KR,NG,2012.0,5,4,1
ZW,TW,2002.0,1,1,0
UG,NZ,2017.0,1,6,-5
SN,FR,2014.0,28,36,-8
US,nan,2016.0,294,244,50
JP,GB,1999.0,216,197,19
LK,NZ,2019.0,5,11,-6
DE,AT,1997.0,118,147,-29
CA,NL,2018.0,105,112,-7
GB,BE,2012.0,133,121,12
CR,CO,2013.0,28,21,7
AU,IL,2007.0,18,13,5
SG,AU,2014.0,109,127,-18
BE,US,2002.0,176,138,38
CD,BE,2013.0,8,7,1
NL,nan,2017.0,76,98,-22
RU,DE,2022.0,113,70,43
TR,CN,2003.0,21,9,12
CA,TN,2020.0,12,15,-3
PT,CA,2017.0,33,20,13
FR,MD,2007.0,37,89,-52
NO,BE,2019.0,14,18,-4
SK,CZ,2015.0,153,125,28
IL,TR,2012.0,5,1,4
CN,TR,2013.0,90,76,14
DE,JP,2007.0,162,190,-28
AT,IL,2019.0,6,9,-3
IE,CA,2011.0,126,153,-27
CN,BR,2020.0,47,44,3
CN,NL,2005.0,49,58,-9
PL,ES,2018.0,17,38,-21
CN,MY,2008.0,26,13,13
GB,RU,2004.0,52,80,-28
IL,CN,2006.0,19,16,3
PE,AR,2017.0,45,42,3
ES,CA,2008.0,57,56,1
JP,GR,2014.0,14,39,-25
GB,MX,2003.0,41,39,2
AR,US,2003.0,175,134,41
RU,NL,2005.0,31,22,9
SK,DE,2020.0,40,29,11
PE,US,2020.0,130,130,0
BR,IT,2016.0,270,298,-28
NL,SK,2013.0,9,4,5
SE,RU,2021.0,32,26,6
FR,RO,2022.0,22,20,2
FR,IL,2015.0,37,23,14
AU,CN,2002.0,118,114,4
PL,AT,2010.0,17,8,9
AU,JP,2008.0,60,78,-18
KR,BE,2004.0,7,2,5
RU,BY,2005.0,31,31,0
BY,RU,2016.0,106,47,59
SY,GB,2022.0,5,3,2
GR,RU,2011.0,2,3,-1
CO,BE,2015.0,8,7,1
IT,MA,2015.0,45,31,14
US,MX,2005.0,228,216,12
ES,HU,2022.0,6,6,0
ID,ES,2021.0,11,15,-4
IE,JP,2017.0,27,38,-11
SA,LY,2015.0,2,1,1
SI,CH,2020.0,12,10,2
NO,IR,2022.0,7,14,-7
nan,NO,2014.0,47,14,33
CH,CZ,1998.0,9,7,2
IR,PL,2020.0,16,7,9
BR,PE,2004.0,7,9,-2
JP,FR,2015.0,134,142,-8
CA,ES,2009.0,68,67,1
ES,CN,2018.0,95,86,9
PL,AT,2017.0,16,16,0
BY,DE,2010.0,12,7,5
QA,US,2005.0,12,13,-1
AO,BR,2021.0,39,47,-8
BD,GB,2016.0,48,63,-15
FI,AT,2010.0,8,3,5
ID,GB,2018.0,63,103,-40
IN,FJ,2005.0,3,2,1
DK,US,2009.0,186,293,-107
FI,GB,2016.0,76,81,-5
DE,FR,2001.0,296,293,3
IL,NO,2019.0,5,3,2
RU,AZ,2018.0,17,23,-6
DE,DK,2018.0,195,194,1
LV,US,2001.0,6,4,2
GB,DK,2021.0,168,108,60
PK,AE,2015.0,11,19,-8
ZA,CA,2008.0,20,20,0
BD,AU,2020.0,69,76,-7
GR,NL,2015.0,38,21,17
nan,RU,2008.0,43,93,-50
FR,NL,2000.0,116,67,49
VN,FR,2020.0,22,62,-40
PH,VN,2009.0,1,1,0
FR,VN,2009.0,16,10,6
MA,FR,2008.0,268,234,34
EE,IT,2017.0,5,10,-5
PL,DE,1998.0,54,45,9
US,JM,2020.0,13,14,-1
KR,DE,2005.0,37,34,3
NO,BE,2010.0,10,11,-1
IR,NL,2016.0,43,33,10
AU,PT,2020.0,26,6,20
RO,GB,2018.0,56,78,-22
PK,IE,2014.0,5,3,2
US,ZW,2003.0,2,12,-10
SA,EG,2010.0,85,187,-102
BE,PT,2009.0,11,9,2
CA,ZA,2012.0,41,38,3
IT,FR,2023.0,14,9,5
US,AT,1998.0,115,107,8
JP,BG,2017.0,3,1,2
ES,EC,2001.0,2,1,1
NO,NL,2017.0,20,49,-29
EG,RU,2018.0,12,22,-10
DE,GH,2006.0,3,4,-1
MX,JP,2001.0,5,6,-1
CH,KR,2005.0,7,4,3
US,IR,2001.0,18,14,4
IE,JP,2010.0,21,24,-3
FR,DZ,2014.0,201,80,121
ET,AU,2021.0,33,11,22
NO,PK,2014.0,6,5,1
CO,GT,2013.0,3,4,-1
LB,AU,2010.0,2,3,-1
RU,ZW,2019.0,23,16,7
AR,nan,2011.0,42,55,-13
DE,KR,2020.0,64,81,-17
TH,US,1999.0,29,49,-20
PH,MX,2013.0,8,9,-1
MX,CN,2009.0,11,10,1
nan,IN,2017.0,77,76,1
NL,nan,2019.0,77,77,0
KE,CO,2021.0,4,2,2
US,HU,2018.0,97,105,-8
CZ,HR,2012.0,4,6,-2
MX,CA,2018.0,57,34,23
DK,AT,2016.0,18,17,1
DE,PL,2023.0,7,5,2
IL,CH,2018.0,25,28,-3
CA,CL,2011.0,16,22,-6
DK,NZ,2017.0,15,5,10
ES,IN,2022.0,17,13,4
SD,IQ,2011.0,4,1,3
US,DZ,2021.0,40,52,-12
IN,PL,2015.0,21,12,9
DE,TZ,2019.0,11,4,7
RS,HR,2004.0,37,23,14
UY,DE,2015.0,7,1,6
TN,nan,2019.0,7,7,0
HR,BA,2022.0,25,24,1
nan,IN,2019.0,106,138,-32
IE,IN,2020.0,30,51,-21
CN,nan,2021.0,96,114,-18
GB,GH,2011.0,21,14,7
IT,CA,2005.0,66,60,6
SA,JO,2021.0,46,41,5
MX,CR,2015.0,43,36,7
BY,DE,2019.0,8,10,-2
PH,TH,2021.0,9,6,3
JP,RU,2011.0,33,26,7
CL,HN,2019.0,7,6,1
RU,HU,2020.0,25,19,6
BE,VN,2021.0,13,7,6
SE,BD,2007.0,2,2,0
RO,AU,2009.0,4,2,2
ID,IN,2015.0,22,31,-9
PE,AR,2019.0,54,71,-17
IT,AR,2021.0,56,92,-36
FR,PL,2008.0,38,47,-9
US,VE,1999.0,22,25,-3
ID,MY,2022.0,157,100,57
QA,NO,2019.0,3,1,2
UZ,KR,2021.0,3,1,2
NL,BE,2000.0,88,113,-25
US,PR,2018.0,10,6,4
ES,FI,2018.0,27,22,5
PK,IN,1999.0,11,16,-5
PE,MX,2001.0,16,8,8
EC,MX,2004.0,3,1,2
SA,MY,2017.0,43,93,-50
AU,BD,2016.0,56,70,-14
MN,TW,2019.0,1,1,0
ES,BE,2003.0,22,20,2
EG,QA,2021.0,68,58,10
MZ,BR,2019.0,20,30,-10
KR,TW,2013.0,29,50,-21
VE,NL,2018.0,3,2,1
ID,PK,2017.0,23,51,-28
KE,AT,2020.0,4,3,1
FR,ZA,2012.0,42,27,15
CA,CZ,2016.0,21,17,4
IN,IR,2022.0,11,15,-4
FR,IE,2018.0,36,38,-2
BG,BR,2019.0,5,4,1
CZ,DK,2017.0,10,4,6
RU,SE,2003.0,41,28,13
NO,SE,2014.0,74,96,-22
QA,US,2002.0,7,8,-1
JP,RO,1999.0,3,7,-4
IT,BJ,2015.0,1,2,-1
LU,ES,2018.0,3,8,-5
ZA,TZ,2021.0,8,8,0
PK,MY,2009.0,13,8,5
BT,AU,2020.0,5,2,3
MX,BE,2020.0,10,8,2
CN,CO,2011.0,4,5,-1
KR,LV,2021.0,2,1,1
KE,TZ,2006.0,2,1,1
LK,NZ,2017.0,5,5,0
HR,US,2005.0,23,21,2
CO,FR,2007.0,10,23,-13
AU,GR,2021.0,9,5,4
NO,NL,2010.0,15,39,-24
FR,LU,2007.0,19,17,2
IT,JP,2006.0,49,64,-15
ID,SI,2015.0,4,4,0
CH,FI,2012.0,20,25,-5
SA,MY,2019.0,53,88,-35
AT,SE,2007.0,17,13,4
nan,IL,2003.0,9,11,-2
UA,MX,2020.0,1,2,-1
IN,AT,2003.0,32,11,21
MZ,BE,2017.0,8,5,3
FR,HK,2010.0,4,4,0
UA,BG,1997.0,3,1,2
CH,NL,1999.0,39,41,-2
AT,CA,2006.0,21,13,8
MX,RU,2021.0,13,8,5
FI,AT,2019.0,13,10,3
HU,JP,2000.0,10,4,6
RU,ZW,2017.0,12,23,-11
IT,IN,2000.0,16,33,-17
PT,IT,1999.0,7,13,-6
ES,GR,2003.0,4,8,-4
IT,MX,2016.0,57,30,27
RU,FR,2022.0,48,38,10
CZ,FI,2017.0,6,15,-9
DK,AU,2008.0,17,26,-9
MG,FR,2015.0,9,12,-3
SA,US,2008.0,52,81,-29
CY,GR,2001.0,5,2,3
JP,BE,2018.0,23,29,-6
ES,MY,2021.0,3,7,-4
IN,FI,2000.0,2,1,1
MY,IT,2006.0,32,29,3
PT,BG,2004.0,1,2,-1
DE,TH,2007.0,12,11,1
QA,EG,1997.0,4,3,1
HR,US,2002.0,22,32,-10
SA,BD,2002.0,2,3,-1
SA,GB,2008.0,27,40,-13
IT,PL,2015.0,27,30,-3
IT,BE,2009.0,87,77,10
PL,HU,2002.0,11,9,2
SE,CY,2018.0,3,2,1
BN,AU,2005.0,1,1,0
RO,DE,2000.0,12,13,-1
US,RS,2001.0,21,23,-2
LK,IN,2012.0,12,7,5
TN,nan,2017.0,4,8,-4
QA,KW,2018.0,4,7,-3
BR,RU,2020.0,21,11,10
AU,PK,2016.0,40,50,-10
IE,CO,2015.0,5,6,-1
NZ,PK,2020.0,16,12,4
IR,EG,2019.0,27,15,12
IE,nan,2019.0,4,8,-4
NL,EG,2012.0,7,3,4
NZ,DE,1999.0,17,10,7
SE,CH,2006.0,35,38,-3
BD,ID,2022.0,19,24,-5
PL,RU,2022.0,19,31,-12
NL,IE,2016.0,24,18,6
US,ID,2007.0,39,34,5
TN,NG,2013.0,2,1,1
GB,SK,2017.0,16,10,6
SE,EG,2009.0,3,2,1
CL,BO,2019.0,4,6,-2
RU,IL,2006.0,24,25,-1
GR,JP,2014.0,39,14,25
TR,DE,2006.0,34,24,10
CO,SE,2017.0,5,5,0
RU,GH,2019.0,1,2,-1
DE,PE,2014.0,6,7,-1
OM,TH,2014.0,1,2,-1
nan,IN,2010.0,24,31,-7
IN,IL,2009.0,23,16,7
KP,SE,2000.0,6,1,5
QA,ES,2011.0,4,5,-1
CN,DZ,2012.0,2,2,0
JO,DE,2016.0,14,16,-2
CL,HN,2017.0,1,6,-5
SE,AT,2015.0,19,34,-15
FI,SE,1999.0,47,33,14
VN,KR,2016.0,46,81,-35
RO,HU,2000.0,80,31,49
CA,VN,2013.0,9,1,8
IL,PS,2020.0,12,6,6
NA,US,2018.0,5,4,1
RS,MK,2018.0,4,5,-1
CO,CR,2013.0,21,28,-7
RU,SI,2021.0,4,5,-1
KR,BR,2016.0,8,5,3
JP,TW,1999.0,31,26,5
CZ,MY,2016.0,20,19,1
IT,AT,2022.0,51,48,3
MW,US,2013.0,12,16,-4
GB,UA,2019.0,21,15,6
BR,MX,2016.0,135,127,8
SG,MY,2004.0,23,24,-1
ES,CH,2008.0,56,55,1
DK,BG,2015.0,4,1,3
ES,BD,2004.0,8,3,5
PT,CH,2012.0,9,15,-6
US,PK,1998.0,35,28,7
CH,IN,2004.0,8,20,-12
CU,nan,2010.0,1,2,-1
NO,NL,2019.0,32,48,-16
VE,BR,2013.0,20,17,3
GB,LU,2015.0,22,11,11
ID,CH,2021.0,4,5,-1
RO,IT,2007.0,16,9,7
DK,IS,2002.0,5,2,3
AT,JP,2020.0,21,14,7
RS,AT,2019.0,15,10,5
SE,IN,2013.0,40,64,-24
TW,GB,1999.0,15,26,-11
PK,ID,2017.0,51,23,28
FI,CN,2004.0,11,7,4
GB,SK,2010.0,23,18,5
RU,KR,2020.0,28,27,1
BE,KR,2022.0,5,10,-5
ET,CN,2014.0,5,1,4
GR,ES,2008.0,12,9,3
GB,NO,1998.0,22,17,5
PY,IT,2020.0,1,2,-1
FR,CI,2011.0,27,4,23
KE,BR,2017.0,2,3,-1
HR,HU,2013.0,3,3,0
CN,LB,2007.0,7,9,-2
MY,NZ,2014.0,19,25,-6
CH,NZ,2015.0,11,25,-14
CN,RO,2005.0,2,2,0
IT,IR,2020.0,36,79,-43
FR,ML,2019.0,13,18,-5
MY,nan,2004.0,13,6,7
FR,AE,2022.0,10,4,6
NL,AT,1997.0,11,5,6
RO,NL,2005.0,7,2,5
SK,SI,2020.0,6,3,3
BE,EC,2020.0,5,6,-1
DE,KE,2014.0,19,11,8
RU,NG,2021.0,4,4,0
BN,AU,2002.0,1,1,0
IT,UA,2021.0,7,16,-9
BF,CI,2019.0,12,8,4
LK,NZ,2010.0,4,1,3
AZ,RU,2021.0,20,17,3
IR,EG,2017.0,19,13,6
EE,FR,2021.0,6,3,3
BD,ES,2017.0,15,14,1
AT,FR,2009.0,30,34,-4
JP,SA,2018.0,9,11,-2
IT,HR,2002.0,4,3,1
US,SI,2009.0,24,21,3
GB,SE,2009.0,171,151,20
LU,BE,2018.0,14,20,-6
ZA,PT,2018.0,4,7,-3
AR,PK,2003.0,4,3,1
AU,GH,2014.0,7,4,3
CA,AE,2014.0,29,14,15
BG,RU,2005.0,10,12,-2
CO,HN,2018.0,8,3,5
CA,CI,2020.0,5,3,2
TR,CZ,2014.0,10,5,5
IN,PH,2021.0,14,11,3
QA,AU,2020.0,14,8,6
EG,TN,2014.0,16,13,3
KR,DE,2002.0,22,19,3
PE,AR,2010.0,12,17,-5
GB,AZ,2013.0,3,5,-2
GB,SD,2013.0,9,3,6
ZA,AT,2015.0,9,10,-1
MA,US,2015.0,24,31,-7
NG,KR,2017.0,10,11,-1
JO,GB,2017.0,16,32,-16
CN,NP,2020.0,22,27,-5
PL,US,2000.0,108,124,-16
DK,NL,2011.0,28,27,1
BA,MY,2020.0,2,2,0
IE,NZ,2018.0,23,22,1
GB,MT,1999.0,3,3,0
PL,IT,2000.0,8,16,-8
ES,DK,2001.0,17,21,-4
HR,SK,2007.0,3,2,1
FR,CY,2019.0,8,2,6
PL,MX,2007.0,3,5,-2
IL,JP,2016.0,11,11,0
EE,DE,2008.0,25,44,-19
JP,OM,2012.0,2,1,1
FR,CZ,2009.0,28,24,4
PK,JP,2014.0,6,15,-9
AT,IT,1998.0,14,16,-2
RS,nan,2022.0,1,1,0
UA,nan,2014.0,18,20,-2
IT,DZ,2008.0,14,8,6
GR,CN,2006.0,15,9,6
NO,UG,2009.0,3,1,2
BG,RU,2002.0,9,5,4
JP,NP,2008.0,5,1,4
PA,ES,2002.0,18,4,14
SE,HU,2019.0,13,10,3
TJ,RU,2015.0,39,23,16
TR,CA,2006.0,14,15,-1
ES,PK,2015.0,5,6,-1
ID,NL,2006.0,4,7,-3
CZ,SG,2019.0,1,2,-1
CM,JP,2018.0,2,1,1
US,TZ,2015.0,24,23,1
PL,MK,2008.0,3,2,1
DK,NZ,2019.0,7,9,-2
BR,KR,2016.0,5,8,-3
LK,FR,2008.0,2,3,-1
UA,PL,2005.0,19,6,13
TH,NZ,2014.0,6,5,1
UA,FI,2016.0,6,2,4
TZ,US,2004.0,4,3,1
GB,MA,1998.0,3,1,2
CH,CZ,1997.0,7,2,5
BE,AT,2017.0,15,13,2
HR,AU,2019.0,5,7,-2
CH,HR,2012.0,6,6,0
RS,TR,2004.0,46,47,-1
ZW,ZA,2005.0,17,1,16
SE,HU,2010.0,15,11,4
AL,XK,2017.0,8,1,7
NL,SG,2019.0,21,25,-4
RO,NL,2002.0,7,1,6
LY,IN,2015.0,1,2,-1
NO,JP,2003.0,9,11,-2
DE,BY,2003.0,7,11,-4
DE,RS,2023.0,3,1,2
JP,PH,2000.0,11,12,-1
CN,HU,1999.0,2,1,1
PL,DE,1997.0,36,41,-5
BG,AU,2008.0,3,4,-1
MX,RS,2021.0,3,2,1
IT,HR,2005.0,5,2,3
TR,RS,2018.0,8,67,-59
XK,AL,2019.0,4,7,-3
AU,PL,2017.0,21,15,6
LT,GR,2011.0,1,1,0
VE,PT,2016.0,3,2,1
ZM,GB,2008.0,2,1,1
BO,AR,2009.0,5,2,3
US,NA,2011.0,1,1,0
AU,CL,2022.0,5,7,-2
AU,HK,2006.0,3,1,2
NO,AT,2021.0,11,15,-4
AU,MW,2015.0,2,3,-1
PK,SD,2015.0,5,2,3
AE,SE,2001.0,1,2,-1
RO,BR,2015.0,4,6,-2
LB,JO,2012.0,1,3,-2
GB,UA,2017.0,17,12,5
CH,JP,2001.0,42,43,-1
CA,FI,2012.0,21,18,3
DE,OM,2021.0,1,4,-3
CL,GB,2002.0,8,7,1
CA,BD,2022.0,15,32,-17
FI,EG,2018.0,4,5,-1
CA,RU,2016.0,46,29,17
SE,HU,2017.0,8,11,-3
BE,HU,1999.0,4,7,-3
NZ,IT,2001.0,4,2,2
CZ,FI,2019.0,6,10,-4
PT,DK,2001.0,1,3,-2
CL,UY,2012.0,7,11,-4
nan,BE,2009.0,21,17,4
SA,IN,2001.0,8,5,3
NL,DK,2001.0,12,21,-9
GE,JP,2012.0,1,1,0
MX,PH,2016.0,5,9,-4
AU,DK,2015.0,34,50,-16
FJ,AU,2012.0,7,1,6
IE,MT,2020.0,1,1,0
VE,CU,2013.0,11,9,2
CL,JP,2022.0,4,4,0
BE,MD,2007.0,1,6,-5
DE,BE,2003.0,63,64,-1
FR,GP,2009.0,18,7,11
EC,CO,2008.0,11,6,5
HK,DE,2011.0,1,1,0
ML,CI,2012.0,5,3,2
SE,LV,2013.0,5,3,2
FI,AT,2017.0,10,12,-2
AU,PL,2010.0,10,15,-5
nan,FI,2007.0,8,11,-3
BO,MX,2022.0,3,5,-2
PT,DE,2003.0,7,18,-11
RO,JP,2006.0,4,7,-3
UA,GB,2014.0,9,16,-7
HK,CN,2006.0,12,26,-14
BE,GH,2016.0,1,3,-2
CN,NO,2006.0,11,20,-9
GB,RO,2002.0,3,15,-12
HR,DK,2018.0,3,1,2
BE,TW,2011.0,2,3,-1
US,KH,2006.0,8,1,7
CN,NG,2020.0,27,45,-18
LU,IT,2021.0,13,12,1
FR,SI,2008.0,9,5,4
IT,AL,2014.0,4,6,-2
MC,FR,1999.0,2,2,0
US,HT,2017.0,4,1,3
RU,BR,2021.0,18,6,12
PL,UA,2006.0,17,13,4
FR,BF,2016.0,16,13,3
SG,VN,2020.0,21,12,9
ZA,NZ,2012.0,8,13,-5
FI,PL,2001.0,6,2,4
GD,IN,2013.0,1,3,-2
UA,PL,2002.0,17,4,13
MX,NO,2020.0,9,4,5
BD,ES,2019.0,8,20,-12
SK,BR,2011.0,4,1,3
TH,AU,2007.0,14,30,-16
BF,CG,2014.0,2,1,1
QA,GB,2016.0,24,58,-34
PT,CA,2010.0,16,13,3
DZ,IR,2016.0,3,4,-1
SE,PH,2005.0,2,1,1
AU,LB,2005.0,3,1,2
CO,DE,2008.0,12,15,-3
ME,RS,2011.0,8,15,-7
DE,LI,2013.0,6,5,1
CZ,DE,2004.0,22,44,-22
MY,NP,2012.0,1,2,-1
YE,IN,2016.0,3,1,2
VE,PY,2019.0,5,2,3
CA,RO,2003.0,5,7,-2
SE,FR,2004.0,38,41,-3
AU,HR,2017.0,2,8,-6
TR,CH,2001.0,6,4,2
CZ,HU,2021.0,8,9,-1
SE,PL,2016.0,30,17,13
PY,ES,2020.0,23,18,5
PL,CH,2011.0,25,17,8
ZA,FI,2003.0,1,1,0
BD,FR,2018.0,4,8,-4
TR,MK,2003.0,1,1,0
CA,HR,2002.0,2,3,-1
IR,TN,2022.0,5,2,3
AT,IT,1997.0,8,4,4
IL,CZ,2000.0,3,1,2
CH,LU,2013.0,8,5,3
KR,TZ,2015.0,3,1,2
RU,MY,2012.0,6,7,-1
nan,UA,2015.0,17,17,0
JP,BG,2010.0,5,3,2
HR,AU,2010.0,2,4,-2
KR,NL,2015.0,11,10,1
ZA,NO,2022.0,4,10,-6
QA,DK,2017.0,1,2,-1
IE,SE,2014.0,22,12,10
CA,LB,2018.0,17,20,-3
NL,HU,2022.0,4,8,-4
CA,RE,2013.0,1,1,0
US,MT,2004.0,5,3,2
OM,GB,2012.0,7,15,-8
JP,AR,2010.0,6,5,1
SI,DE,2001.0,6,4,2
GR,SE,2000.0,3,2,1
DE,PK,2020.0,35,35,0
NL,GR,1998.0,5,5,0
PT,CA,2019.0,20,14,6
NL,CL,2014.0,8,12,-4
PA,ES,2005.0,9,2,7
CZ,BG,2008.0,4,2,2
BR,CZ,2019.0,14,7,7
RS,SK,2017.0,10,11,-1
RU,BY,2002.0,15,24,-9
MK,RU,2019.0,2,1,1
KR,DK,2016.0,8,3,5
BR,CN,1999.0,6,2,4
LV,RU,2022.0,10,8,2
MN,PL,2011.0,2,1,1
HU,SE,2008.0,11,15,-4
ET,DE,2005.0,2,6,-4
CU,CO,2012.0,42,23,19
AU,TR,2011.0,7,8,-1
ES,CZ,2011.0,11,5,6
IL,FI,2020.0,7,2,5
PG,AU,2003.0,4,1,3
NE,SN,2020.0,2,1,1
CA,AR,2000.0,5,5,0
AU,HR,2019.0,7,5,2
MX,SG,2009.0,7,5,2
PK,BE,2014.0,2,2,0
SD,KE,2015.0,1,1,0
HR,AU,2017.0,8,2,6
SA,DZ,2022.0,6,3,3
DE,NG,2008.0,7,10,-3
SI,GB,2020.0,14,19,-5
DK,KE,2018.0,2,7,-5
FR,RE,2009.0,18,14,4
SE,PK,2016.0,15,9,6
SA,PK,2004.0,9,8,1
IE,IR,2012.0,5,5,0
BE,AT,2019.0,19,25,-6
KR,IE,2015.0,9,7,2
BE,AR,1999.0,3,2,1
FR,CG,2003.0,7,7,0
IE,DK,2003.0,3,2,1
nan,NI,2015.0,2,1,1
VN,CA,2005.0,2,3,-1
SA,PT,2019.0,2,4,-2
IE,IT,2023.0,4,1,3
RU,NL,2002.0,20,14,6
BG,BR,2017.0,2,5,-3
JP,BG,2019.0,3,1,2
EG,IR,2012.0,5,7,-2
TW,BR,2022.0,2,1,1
QA,NO,2017.0,3,1,2
HR,RS,2001.0,26,17,9
US,MW,2005.0,7,4,3
LK,CN,2004.0,2,2,0
AT,KR,2014.0,5,7,-2
LY,PK,2019.0,2,1,1
CZ,DK,2010.0,2,5,-3
IQ,EG,2015.0,9,21,-12
nan,PT,2003.0,10,6,4
IN,ES,2004.0,6,3,3
CY,PK,2020.0,1,2,-1
LY,AU,2014.0,1,3,-2
US,BO,2021.0,6,7,-1
LU,SG,2014.0,2,1,1
IN,LU,2012.0,3,1,2
DK,VN,2019.0,5,1,4
BR,CV,2018.0,3,3,0
GB,HU,2000.0,28,25,3
CZ,SE,2009.0,10,14,-4
MY,DK,2012.0,6,1,5
DK,IN,2003.0,7,11,-4
ZW,GB,2015.0,7,3,4
FR,CY,2017.0,5,3,2
ZM,ZA,2015.0,6,8,-2
AR,EC,2012.0,7,5,2
EG,IL,2013.0,2,2,0
TR,RO,2014.0,2,2,0
PE,NL,2006.0,1,1,0
MT,TN,2020.0,3,1,2
PE,CA,2021.0,7,11,-4
NZ,ES,2004.0,1,1,0
SY,EG,2020.0,9,10,-1
MD,RO,2014.0,9,3,6
IL,NO,2010.0,1,4,-3
JO,GB,2019.0,12,55,-43
AU,PL,2019.0,10,23,-13
AR,NL,2008.0,5,11,-6
CL,CA,2000.0,3,5,-2
KW,IQ,2011.0,1,1,0
CL,AT,2017.0,6,4,2
TH,GB,2003.0,13,48,-35
CN,PT,2000.0,4,4,0
IQ,NG,2020.0,3,8,-5
SY,IQ,2020.0,3,4,-1
GB,UA,2010.0,7,14,-7
AT,IL,2017.0,4,4,0
ZA,ZW,2002.0,2,6,-4
LS,BW,2016.0,1,1,0
SZ,ZA,2016.0,2,5,-3
FR,SY,2016.0,10,5,5
CL,GB,2005.0,19,18,1
CI,ML,2013.0,2,3,-1
KR,NZ,2020.0,9,10,-1
CR,UY,2019.0,2,1,1
CL,TR,2011.0,2,2,0
PT,MA,2018.0,27,18,9
IT,CY,2020.0,7,3,4
AT,RO,2014.0,5,9,-4
GE,CZ,2018.0,3,1,2
BE,IE,2006.0,4,5,-1
IE,CZ,2011.0,4,3,1
TR,FR,2009.0,16,24,-8
BE,KE,2011.0,3,4,-1
KW,TR,2016.0,7,11,-4
UZ,JP,2003.0,5,3,2
RU,IN,2002.0,4,4,0
PL,BR,2006.0,7,1,6
PK,PL,2007.0,2,4,-2
PA,MX,2002.0,1,1,0
GR,AU,2004.0,3,4,-1
KR,RU,2015.0,21,8,13
VE,AR,2015.0,16,12,4
IT,PH,2011.0,5,6,-1
GB,IQ,1998.0,1,1,0
PK,BF,2015.0,1,1,0
VN,MY,2015.0,3,3,0
CO,SE,2019.0,10,6,4
TW,NL,2021.0,8,7,1
BD,AE,2019.0,3,1,2
RS,NO,2012.0,2,1,1
DE,JO,2022.0,4,3,1
LU,IR,2020.0,4,3,1
DK,nan,1997.0,5,5,0
PL,GR,2018.0,4,4,0
CZ,FI,2010.0,9,8,1
JO,GB,2010.0,7,23,-16
CH,SA,2022.0,7,4,3
UG,CA,2022.0,1,1,0
CA,BG,1998.0,6,3,3
AE,EG,2004.0,9,8,1
KZ,IN,2022.0,3,2,1
IT,TH,2015.0,4,2,2
NZ,UG,2007.0,2,1,1
PK,ID,2010.0,5,2,3
CO,UY,2013.0,12,13,-1
US,MK,2003.0,2,1,1
MX,HU,2013.0,1,3,-2
RW,US,2013.0,15,6,9
UA,US,1997.0,19,5,14
CA,TR,2003.0,5,7,-2
KR,SE,2009.0,7,7,0
NL,RO,2006.0,7,3,4
SA,IR,2012.0,5,3,2
VN,GB,2011.0,3,10,-7
BD,IR,2019.0,3,6,-3
CA,nan,2008.0,19,21,-2
DK,IS,2005.0,9,4,5
FR,UZ,2013.0,1,2,-1
CA,SN,2005.0,2,1,1
DE,PS,2021.0,2,1,1
GB,CZ,1999.0,7,9,-2
DE,TZ,2017.0,9,4,5
TN,CZ,2012.0,1,1,0
MA,GB,2021.0,12,8,4
FR,NZ,2007.0,17,11,6
QA,DK,2019.0,1,1,0
ZW,ZA,2002.0,6,2,4
MN,TW,2010.0,1,1,0
AE,CZ,2019.0,2,2,0
CL,BO,2010.0,9,4,5
GA,MA,2021.0,2,1,1
MY,NI,2011.0,1,1,0
ZA,CL,2019.0,5,4,1
IT,KE,2020.0,2,8,-6
CL,HR,2018.0,1,1,0
nan,PL,2018.0,14,20,-6
MK,RU,2017.0,4,4,0
GB,CM,2012.0,1,9,-8
SK,GB,2007.0,15,12,3
SA,AZ,2012.0,1,1,0
NZ,NO,2016.0,6,1,5
DZ,CN,2013.0,3,5,-2
BE,ES,2000.0,15,15,0
CA,PL,1999.0,8,6,2
QA,DE,2012.0,8,4,4
IS,SE,2006.0,18,13,5
RU,HR,2012.0,5,4,1
LT,SE,2002.0,4,1,3
BE,AT,2010.0,16,12,4
RW,TR,2011.0,4,1,3
CO,JP,2001.0,3,5,-2
MZ,US,2015.0,2,4,-2
AT,NO,2008.0,9,5,4
BH,KR,2007.0,1,1,0
CL,DO,2007.0,1,1,0
NL,SG,2010.0,9,8,1
BE,NZ,2001.0,2,1,1
US,HT,2019.0,5,9,-4
BO,ES,2022.0,4,6,-2
CZ,BE,2018.0,14,17,-3
KR,CZ,2016.0,7,10,-3
ZA,KE,2011.0,9,7,2
US,ZM,2006.0,3,4,-1
NZ,PE,2020.0,1,1,0
IS,NO,2001.0,1,2,-1
GR,LU,2013.0,2,3,-1
CL,AU,2000.0,3,1,2
IN,CH,2000.0,9,12,-3
CO,NL,2004.0,1,1,0
DE,TZ,2010.0,4,1,3
TZ,EG,2018.0,2,2,0
NO,SA,2016.0,3,1,2
BE,ZA,2001.0,8,5,3
TH,SE,2007.0,1,7,-6
FI,nan,2012.0,7,4,3
US,CI,1998.0,1,1,0
BE,PH,2012.0,5,2,3
IQ,KW,2017.0,1,9,-8
YE,SD,2012.0,1,1,0
TN,CH,2022.0,1,6,-5
SE,TH,2020.0,4,8,-4
IQ,KW,2019.0,5,9,-4
MK,XK,2020.0,3,3,0
GB,KZ,2014.0,7,3,4
RW,CA,2015.0,1,1,0
SK,CW,2014.0,1,1,0
CU,nan,2019.0,8,4,4
TN,IR,2014.0,5,10,-5
PK,BD,1999.0,5,3,2
BE,CO,2020.0,8,15,-7
MN,CN,2005.0,3,4,-1
LU,FI,2009.0,4,5,-1
BE,RO,2015.0,14,10,4
SE,CO,2003.0,1,3,-2
BI,CA,2008.0,2,1,1
ZA,DK,2011.0,9,4,5
MY,ZA,2014.0,6,6,0
BR,VE,1999.0,5,12,-7
SG,MX,2008.0,8,6,2
CH,SI,2001.0,1,3,-2
PK,DE,1997.0,1,2,-1
FI,CL,2020.0,1,3,-2
AT,NZ,2006.0,2,1,1
LB,AU,2019.0,3,5,-2
HK,JP,2012.0,6,6,0
BR,CZ,2017.0,6,7,-1
GB,AF,2014.0,1,1,0
QA,OM,2014.0,1,5,-4
HU,IR,2022.0,4,3,1
NP,FI,2020.0,1,1,0
NL,AT,1998.0,5,9,-4
ZA,IT,2022.0,13,9,4
PS,EG,2015.0,5,6,-1
BR,RO,2007.0,2,2,0
RS,IL,1999.0,2,1,1
DE,EG,1999.0,9,9,0
MK,PT,2013.0,1,1,0
BR,GB,2023.0,16,6,10
TW,IR,2012.0,7,3,4
PL,ZA,2014.0,5,4,1
DE,LT,2022.0,5,2,3
BF,CI,2017.0,4,3,1
PK,TH,2016.0,3,5,-2
TR,SA,2011.0,9,4,5
LY,EG,2022.0,3,4,-1
BD,IR,2017.0,2,9,-7
BD,nan,2010.0,4,1,3
UG,GB,2007.0,4,8,-4
NL,GR,1997.0,5,2,3
IL,SG,2014.0,4,6,-2
PL,HU,2005.0,18,9,9
BA,IT,2014.0,1,1,0
CH,IL,2004.0,5,18,-13
BE,HR,2013.0,6,3,3
ET,DE,2002.0,2,2,0
CA,KZ,2020.0,2,2,0
BE,BG,2012.0,7,3,4
NO,BE,2017.0,9,16,-7
DK,IL,2012.0,2,4,-2
FI,ES,2006.0,6,6,0
LK,TH,2017.0,1,2,-1
BD,NL,1997.0,1,1,0
SD,SA,2023.0,1,2,-1
BY,SK,2015.0,2,2,0
IM,GB,2020.0,1,2,-1
GB,RO,2005.0,9,8,1
TW,SE,2000.0,1,6,-5
PL,AR,2008.0,2,3,-1
PY,VE,2012.0,1,1,0
MX,PY,2012.0,3,6,-3
BD,nan,2019.0,1,5,-4
SD,IN,2013.0,2,1,1
CU,MY,2014.0,2,1,1
SE,GR,2014.0,5,23,-18
OM,EG,2008.0,3,4,-1
CL,IL,2017.0,2,4,-2
nan,RS,2019.0,2,3,-1
FR,NE,2008.0,4,2,2
HR,CH,2008.0,4,5,-1
FI,AU,2004.0,6,7,-1
NG,IN,2011.0,5,9,-4
SK,CN,2006.0,2,4,-2
BO,FR,2018.0,3,1,2
UA,BY,2012.0,3,4,-1
BR,HU,2013.0,2,2,0
DK,VN,2017.0,6,5,1
IR,KW,2021.0,1,1,0
CR,GB,2014.0,4,5,-1
CH,GR,2003.0,8,9,-1
IR,JO,2015.0,2,5,-3
JO,IR,2019.0,6,3,3
AE,NZ,2014.0,8,2,6
RS,SK,2010.0,2,8,-6
NO,GR,2018.0,4,22,-18
UG,NL,2012.0,6,5,1
CN,MM,1999.0,4,1,3
ES,AM,2011.0,1,1,0
CD,RW,2018.0,1,1,0
PK,SG,2017.0,5,10,-5
BY,IN,2018.0,7,5,2
MK,CN,2018.0,3,3,0
LK,SG,2019.0,4,3,1
DE,CU,2006.0,3,3,0
CZ,AU,2009.0,11,7,4
BJ,NG,2017.0,4,4,0
NO,MY,2010.0,2,4,-2
AU,UG,2001.0,1,1,0
CL,BO,2017.0,15,12,3
AT,MY,2014.0,5,4,1
UA,BG,1998.0,3,2,1
KW,FR,2009.0,2,1,1
ID,FI,2018.0,4,9,-5
ES,KZ,2020.0,3,1,2
FR,CY,2010.0,2,1,1
EG,PL,2015.0,2,2,0
DE,GE,2007.0,2,6,-4
IE,BR,2014.0,9,8,1
FI,PT,2009.0,1,3,-2
CZ,KR,1999.0,2,1,1
NL,VN,2016.0,9,4,5
PK,ES,2014.0,5,2,3
BR,PL,2005.0,2,3,-1
NL,LK,2010.0,2,2,0
GB,GA,2006.0,1,1,0
XK,AL,2017.0,1,8,-7
BD,IT,2012.0,7,5,2
NG,KR,2010.0,6,4,2
AR,DK,2017.0,5,6,-1
PT,ST,2018.0,1,2,-1
US,ML,2015.0,8,7,1
MX,PR,2012.0,2,4,-2
DZ,nan,2007.0,2,2,0
ID,PK,2010.0,2,5,-3
SI,nan,2015.0,2,3,-1
BG,UA,2018.0,5,9,-4
AE,JP,2018.0,3,4,-1
SA,MY,2010.0,13,14,-1
TZ,CN,2022.0,4,7,-3
CA,UG,2022.0,1,1,0
NL,LK,2019.0,4,1,3
IQ,BD,2020.0,4,7,-3
NL,UG,2021.0,5,3,2
CA,AT,2023.0,3,1,2
LB,EG,2004.0,2,4,-2
AU,KE,2011.0,6,2,4
GR,RO,2015.0,5,2,3
BY,FR,2012.0,1,4,-3
FR,ML,2010.0,6,10,-4
KG,US,2007.0,1,1,0
BH,KE,2013.0,6,1,5
ZA,NA,2008.0,3,1,2
MA,BR,2000.0,1,1,0
CL,IL,2019.0,3,1,2
ZA,PL,2022.0,2,2,0
CH,EE,2009.0,3,4,-1
CZ,SG,2017.0,3,4,-1
EG,AT,2001.0,2,1,1
ZA,GD,2015.0,1,1,0
HU,BY,1997.0,2,1,1
GT,US,2016.0,9,5,4
ID,BE,2016.0,4,16,-12
EC,FR,2009.0,2,4,-2
TH,KH,2010.0,1,1,0
BG,RS,2018.0,3,2,1
EG,HU,2016.0,1,5,-4
BR,GR,2003.0,2,2,0
RU,IN,2005.0,6,5,1
ES,JO,2010.0,1,1,0
BJ,MA,2014.0,3,1,2
RU,IE,1998.0,1,1,0
AE,CA,1999.0,3,9,-6
SI,CA,2004.0,1,3,-2
FJ,IN,2016.0,2,5,-3
US,TN,1997.0,3,1,2
HN,CL,2013.0,3,2,1
VN,HN,2014.0,1,1,0
MW,GB,2009.0,7,13,-6
RU,SK,2000.0,5,5,0
CL,IL,2010.0,1,2,-1
BE,QA,2015.0,2,1,1
LB,DE,2001.0,1,1,0
CD,GB,2019.0,2,2,0
NO,IS,2003.0,1,3,-2
MK,US,2012.0,7,8,-1
JP,LA,2018.0,2,2,0
TZ,BJ,2012.0,1,1,0
SI,MK,2020.0,1,3,-2
KW,CZ,2005.0,1,3,-2
NP,TH,2013.0,2,5,-3
BR,CZ,2010.0,2,4,-2
LK,PK,2019.0,5,1,4
JP,PT,2009.0,3,4,-1
CN,CY,2011.0,1,1,0
DO,FR,2018.0,1,2,-1
BD,TH,2021.0,3,2,1
US,NE,2018.0,3,3,0
IR,QA,2020.0,7,6,1
BG,IE,2005.0,1,1,0
HU,MX,2015.0,3,2,1
OM,JP,2003.0,1,2,-1
IS,TR,2021.0,3,1,2
TN,QA,2018.0,9,4,5
SA,JP,2015.0,4,17,-13
PT,TN,2005.0,2,1,1
CH,CM,2014.0,3,4,-1
BY,CA,2004.0,1,1,0
PK,MX,2008.0,1,4,-3
EG,BE,1998.0,2,1,1
BR,FI,2005.0,1,2,-1
BR,HN,2013.0,1,4,-3
CL,AT,2019.0,3,7,-4
KE,BR,2019.0,1,2,-1
RS,FI,2022.0,2,1,1
SE,CL,2013.0,2,7,-5
MY,AR,2013.0,2,4,-2
LB,CN,2009.0,10,12,-2
LK,KR,2018.0,2,3,-1
NL,UY,2021.0,2,2,0
TW,OM,2022.0,1,2,-1
ET,AT,2015.0,3,2,1
IS,IR,2019.0,3,1,2
IE,HR,2002.0,2,5,-3
BD,RO,2018.0,3,2,1
IE,nan,2017.0,4,8,-4
HU,FI,2020.0,2,5,-3
ZW,ET,2021.0,1,3,-2
AE,ES,2022.0,2,4,-2
CL,PT,2007.0,6,8,-2
CO,SE,2010.0,2,2,0
MD,AR,2012.0,2,1,1
AT,IN,2004.0,2,43,-41
NP,IT,2011.0,2,1,1
IQ,JO,2007.0,3,1,2
IT,CU,2018.0,4,6,-2
QA,SE,2018.0,3,6,-3
IE,PT,2008.0,3,6,-3
PH,SG,2012.0,6,8,-2
RU,MN,2020.0,5,4,1
CA,BF,2019.0,4,3,1
EG,KR,2014.0,3,5,-2
MA,GN,2017.0,1,1,0
ZA,MX,2015.0,2,3,-1
IT,ML,2007.0,1,1,0
AT,TR,2015.0,7,11,-4
NL,PH,2022.0,3,2,1
AR,BO,2017.0,2,4,-2
US,CG,2018.0,4,3,1
IN,SD,2022.0,1,1,0
GR,MK,2003.0,3,2,1
IQ,MY,2009.0,4,1,3
EE,IT,2019.0,8,7,1
GH,ZM,2006.0,3,3,0
TR,KR,2008.0,4,4,0
CN,LT,1998.0,1,1,0
NC,US,2018.0,3,4,-1
ZA,RO,2013.0,4,3,1
DK,VN,2010.0,2,3,-1
RO,SK,2013.0,1,4,-3
CH,KR,2002.0,5,4,1
OM,IN,2009.0,4,8,-4
NL,TZ,2022.0,3,1,2
GB,CU,1997.0,3,1,2
ES,SA,2006.0,1,2,-1
DK,GH,2021.0,1,1,0
NO,MY,2019.0,1,7,-6
AM,CN,2004.0,4,2,2
TG,NE,2015.0,1,1,0
ID,CM,2021.0,2,2,0
NL,BR,2023.0,1,3,-2
DE,BO,2016.0,1,2,-1
ES,HR,2020.0,5,4,1
AR,AT,2015.0,5,5,0
CO,IT,2005.0,2,3,-1
CA,CM,2012.0,2,3,-1
SA,PT,2017.0,1,2,-1
AZ,TR,2022.0,9,7,2
IE,PK,2022.0,5,11,-6
LT,CN,1999.0,2,3,-1
PH,CH,2021.0,4,2,2
JO,CH,2021.0,1,2,-1
GB,BH,2022.0,5,4,1
NO,SJ,1999.0,1,3,-2
MT,IE,2015.0,1,1,0
BR,FR,2023.0,6,5,1
CH,CG,2021.0,4,2,2
FI,LT,2018.0,7,1,6
NO,LK,2018.0,3,3,0
PY,EC,2022.0,1,1,0
NO,PH,2003.0,1,1,0
TH,IN,1998.0,2,2,0
DK,NZ,2010.0,4,12,-8
ZA,TH,2019.0,3,1,2
TW,BE,2012.0,3,4,-1
BD,ET,2020.0,1,1,0
NO,RS,2021.0,1,2,-1
PY,BR,1999.0,6,1,5
US,MD,1998.0,2,1,1
PH,IT,2022.0,2,1,1
SI,UA,2019.0,1,3,-2
NG,SE,2013.0,2,4,-2
KZ,KG,2018.0,4,6,-2
NG,ZW,2011.0,1,1,0
SI,SK,2010.0,1,2,-1
ZA,ZW,2005.0,1,17,-16
AT,FI,2013.0,7,13,-6
AT,IL,2010.0,1,2,-1
IS,FR,2013.0,2,6,-4
MY,NO,2012.0,4,2,2
NO,PT,2008.0,3,2,1
NO,PS,2019.0,3,2,1
LB,DZ,2016.0,1,1,0
IR,SE,2000.0,1,5,-4
RU,LU,2019.0,1,3,-2
DE,VE,2000.0,1,1,0
MY,PH,2013.0,5,2,3
PK,KW,2001.0,2,1,1
GH,NL,2014.0,3,3,0
ZA,IL,2009.0,2,3,-1
CZ,TH,2021.0,1,1,0
PF,US,2016.0,1,1,0
EE,RU,1999.0,1,3,-2
QA,EG,1998.0,3,1,2
FR,KZ,2017.0,2,2,0
RS,SK,2019.0,6,15,-9
IT,LT,2011.0,2,1,1
CZ,VN,2015.0,3,1,2
DE,BJ,2000.0,1,3,-2
RS,PL,2013.0,1,1,0
IT,LU,2000.0,1,1,0
BR,IE,2004.0,2,1,1
SK,RU,2003.0,6,3,3
HT,US,2021.0,2,3,-1
UA,CZ,2006.0,5,4,1
US,TN,1998.0,4,2,2
VN,TW,2001.0,2,3,-1
nan,GR,2018.0,4,2,2
SI,AU,2018.0,7,1,6
HU,NG,2018.0,1,3,-2
BG,KR,2015.0,2,1,1
JO,SA,1998.0,1,2,-1
CO,NO,2013.0,3,4,-1
GW,DK,2005.0,3,4,-1
ID,AE,2003.0,1,1,0
BJ,NG,2019.0,4,5,-1
CI,BE,2015.0,1,5,-4
PL,FI,2001.0,2,6,-4
SA,CL,2018.0,1,1,0
GB,CU,1998.0,1,1,0
FR,KZ,2019.0,2,2,0
MD,GB,2004.0,3,1,2
NP,AE,2016.0,1,1,0
VN,CA,2002.0,1,4,-3
CN,CM,2015.0,2,4,-2
IE,HR,2005.0,4,2,2
LK,CH,2000.0,1,1,0
CY,NO,2018.0,2,3,-1
IN,YE,2009.0,2,1,1
LU,AU,2022.0,1,1,0
RS,SI,2006.0,3,7,-4
RU,IE,1997.0,2,1,1
ME,GB,2013.0,1,1,0
ME,HR,2007.0,2,1,1
DK,ZA,2022.0,1,2,-1
GM,UG,2018.0,1,1,0
MA,BD,2008.0,3,2,1
CN,SI,2011.0,2,3,-1
CL,EG,2018.0,1,1,0
NI,PE,2021.0,2,1,1
FR,NP,2022.0,2,3,-1
LI,CH,2006.0,2,2,0
NZ,QA,2013.0,2,1,1
BR,SD,2016.0,1,13,-12
DE,SN,2020.0,1,2,-1
ZW,SE,2020.0,1,1,0
MZ,BE,2019.0,4,10,-6
IN,BN,2022.0,4,3,1
AE,KW,2022.0,1,3,-2
ZW,nan,2014.0,1,1,0
CH,EG,2002.0,3,1,2
US,MW,2002.0,2,5,-3
CN,FR,2004.0,179,232,-53
AU,FR,2006.0,75,88,-13
CN,GB,2010.0,431,547,-116
ES,CL,2016.0,512,336,176
FR,IN,2009.0,63,136,-73
GB,AU,2001.0,683,658,25
GR,GB,2008.0,116,206,-90
BO,PE,2022.0,5,2,3
IT,CA,2002.0,55,60,-5
CN,KR,2019.0,246,368,-122
PT,nan,2015.0,22,31,-9
AU,CA,2000.0,131,147,-16
US,KE,2000.0,17,15,2
AR,DK,2019.0,8,2,6
MY,CN,2018.0,125,101,24
GB,VE,2006.0,3,5,-2
SK,JP,2013.0,26,10,16
MY,AU,2018.0,151,125,26
SA,EG,2019.0,452,450,2
IT,BR,2020.0,298,315,-17
CZ,MX,2013.0,8,3,5
AU,BE,2018.0,50,40,10
NL,JP,2013.0,31,23,8
CO,NI,2017.0,6,9,-3
AR,JP,2013.0,4,4,0
DK,BE,2020.0,76,73,3
US,PK,1997.0,17,20,-3
ZA,DE,2012.0,45,61,-16
MY,DE,2023.0,1,1,0
AT,MK,2016.0,12,11,1
DE,CR,2018.0,5,3,2
DE,IE,2018.0,96,105,-9
NL,SG,2017.0,22,13,9
AR,DE,2015.0,43,34,9
ID,PK,2019.0,33,62,-29
BD,CA,2008.0,7,23,-16
GB,TH,2021.0,40,37,3
FR,KR,2018.0,31,21,10
PL,AT,2019.0,23,25,-2
GH,IN,2021.0,7,10,-3
ET,BH,2018.0,28,14,14
IT,DE,2007.0,189,152,37
MZ,BR,2017.0,19,18,1
KW,EG,2015.0,17,13,4
CH,IT,2022.0,152,196,-44
MY,JP,2013.0,41,98,-57
DE,SG,2014.0,45,43,2
HN,AR,2005.0,5,1,4
US,BY,1998.0,2,16,-14
CA,BF,2017.0,4,6,-2
CZ,ID,2021.0,18,6,12
HN,CO,2016.0,6,6,0
JP,LK,2012.0,20,15,5
IL,IR,2022.0,2,3,-1
IR,AE,2013.0,4,6,-2
CN,IQ,2011.0,7,2,5
UA,US,1998.0,21,14,7
GB,RS,2021.0,16,11,5
US,BY,1997.0,4,1,3
PK,SG,2019.0,4,6,-2
BE,RU,2011.0,16,15,1
SI,MY,2018.0,11,4,7
CN,IE,2022.0,22,20,2
FR,MC,2018.0,12,3,9
US,CY,2004.0,22,11,11
SA,MA,2015.0,5,6,-1
SN,BJ,2015.0,4,2,2
NO,TZ,2016.0,4,5,-1
CH,PT,2007.0,7,7,0
CL,FR,2008.0,33,22,11
JO,QA,2011.0,4,1,3
GR,IT,2014.0,33,23,10
AT,RU,2021.0,12,34,-22
ES,SI,2022.0,7,5,2
EC,VE,2018.0,13,45,-32
RU,CN,2007.0,52,28,24
NO,BG,2001.0,11,6,5
CH,NO,2003.0,17,8,9
TW,RU,2016.0,13,9,4
DK,nan,1998.0,11,4,7
NZ,PT,2009.0,2,4,-2
QA,IN,2014.0,7,14,-7
LT,SE,2005.0,4,4,0
GB,SI,2022.0,8,7,1
TW,TH,2013.0,4,5,-1
NO,CZ,2000.0,4,2,2
TW,KE,2019.0,3,1,2
NO,BR,2007.0,17,15,2
CL,RS,2006.0,4,2,2
IT,SM,2018.0,4,1,3
GR,NO,2007.0,9,1,8
PK,IR,2007.0,3,2,1
LK,CA,2008.0,4,3,1
RU,RO,2009.0,5,1,4
CN,RO,2002.0,3,8,-5
GB,NO,1997.0,15,15,0
BD,nan,2017.0,4,4,0
PH,BD,2014.0,4,1,3
IQ,KZ,2020.0,1,1,0
AU,UY,2005.0,2,2,0
DE,SI,2015.0,11,23,-12
DK,PE,2015.0,2,1,1
JP,AR,2017.0,6,4,2
FR,CU,2011.0,4,1,3
IL,BE,2021.0,6,3,3
AL,DE,2018.0,2,1,1
ZA,TH,2017.0,2,1,1
NZ,SG,2018.0,18,23,-5
AL,XK,2019.0,7,4,3
JP,AR,2019.0,3,4,-1
FR,LB,2001.0,11,5,6
CZ,DK,2019.0,11,9,2
SI,SK,2019.0,7,4,3
BD,ES,2010.0,10,20,-10
BD,MY,2004.0,6,3,3
AT,CZ,2006.0,5,5,0
CO,NI,2019.0,3,4,-1
AU,HR,2010.0,4,2,2
GB,SK,2019.0,20,19,1
SG,RU,2020.0,6,7,-1
IE,RU,2006.0,4,5,-1
SV,MX,2001.0,2,3,-1
SE,SK,2018.0,2,3,-1
AT,EG,2022.0,4,2,2
SE,PE,2016.0,3,2,1
PL,JP,2004.0,19,12,7
PE,ES,2023.0,2,3,-1
AE,BD,2020.0,4,4,0
ES,UG,2014.0,3,1,2
PT,EC,2021.0,9,7,2
GB,BG,2001.0,6,18,-12
NP,CA,2020.0,14,5,9
SV,CL,2013.0,1,2,-1
MY,LK,2018.0,4,6,-2
LY,SA,2015.0,1,2,-1
VI,PL,2005.0,1,1,0
TN,nan,2010.0,2,3,-1
LB,AU,2017.0,5,8,-3
LK,SG,2017.0,4,1,3
MK,GR,2003.0,2,3,-1
BE,PS,2014.0,3,1,2
TZ,NA,2018.0,1,1,0
IL,CR,2010.0,2,2,0
TR,BE,2006.0,4,7,-3
AE,LB,2018.0,3,10,-7
IE,SA,2022.0,5,10,-5
BE,BA,2019.0,2,2,0
HN,ES,2004.0,1,5,-4
DO,PE,2018.0,1,2,-1
MY,PT,2008.0,2,4,-2
BD,IR,2010.0,3,1,2
EC,PE,2012.0,3,4,-1
EG,IT,2000.0,1,7,-6
SI,CN,2011.0,3,2,1
IL,AZ,2018.0,1,1,0
ZA,CL,2017.0,2,2,0
NL,GM,2008.0,3,3,0
GH,CZ,2018.0,2,2,0
IE,TR,2011.0,2,4,-2
AE,IE,2007.0,2,1,1
PH,KR,2004.0,3,3,0
NL,US,2007.0,552,545,7
CN,NL,2002.0,31,27,4
IN,MY,2015.0,150,132,18
US,BH,2007.0,8,5,3
RS,AT,2017.0,10,9,1
MT,SA,2019.0,2,2,0
UA,MY,2020.0,4,9,-5
CL,CN,2014.0,3,1,2
ES,ID,2003.0,3,5,-2
MZ,BR,2010.0,3,8,-5
MA,MY,2022.0,1,3,-2
PH,EG,2014.0,2,1,1
HR,CA,2011.0,1,2,-1
PK,,2024.0,14461,0,14461
,NL,2010.0,6622,0,6622
GB,,2004.0,6056,0,6056
TW,,2025.0,1878,0,1878
IR,,2024.0,49794,0,49794
,PK,2009.0,1452,0,1452
,US,2014.0,73719,0,73719
SE,,2020.0,3913,0,3913
NZ,,2021.0,1606,0,1606
,BR,2007.0,16813,0,16813
,IT,1999.0,9523,0,9523
,RU,1997.0,6805,0,6805
AT,,2020.0,2546,0,2546
,HR,1997.0,581,0,581
VN,,2024.0,5062,0,5062
SK,,2017.0,610,0,610
,NG,2008.0,1546,0,1546
KR,,2009.0,1127,0,1127
nan,,2020.0,907,0,907
CL,,2025.0,651,0,651
,AR,2003.0,1916,0,1916
IN,,2006.0,2045,0,2045
,LB,1998.0,123,0,123
,IE,1999.0,827,0,827
HU,,2016.0,981,0,981
MK,,2024.0,555,0,555
,RU,1998.0,9654,0,9654
ZA,,2021.0,3155,0,3155
,NL,2017.0,5136,0,5136
LB,,2012.0,95,0,95
BE,,2012.0,2286,0,2286
VE,,2015.0,340,0,340
NL,,2014.0,3482,0,3482
DK,,2007.0,489,0,489
FI,,2003.0,580,0,580
CO,,2001.0,54,0,54
,TW,2018.0,2263,0,2263
,GR,2000.0,2116,0,2116
SD,CZ,2014.0,3,0,3
,SK,2013.0,1048,0,1048
TH,,2019.0,2163,0,2163
CM,,2007.0,38,0,38
CU,,2022.0,934,0,934
,HN,2003.0,37,0,37
,TN,2014.0,1670,0,1670
,LT,1996.0,175,0,175
MX,,2025.0,1601,0,1601
IE,GR,2004.0,2,0,2
,LK,2007.0,358,0,358
,NL,2019.0,2944,0,2944
KZ,,2022.0,1137,0,1137
,MA,2014.0,1521,0,1521
,HR,1998.0,538,0,538
,nan,1999.0,627,0,627
,LB,1997.0,123,0,123
LV,,2022.0,620,0,620
,SY,2014.0,138,0,138
MM,,2022.0,149,0,149
AG,,2021.0,57,0,57
TH,,2017.0,1375,0,1375
,DK,2018.0,1732,0,1732
,CI,2011.0,192,0,192
HN,,2016.0,45,0,45
TH,,2010.0,429,0,429
,AE,2020.0,56,0,56
,KZ,2004.0,109,0,109
,CR,2018.0,221,0,221
MT,CN,2002.0,1,0,1
,LY,2005.0,30,0,30
,LT,2004.0,617,0,617
JM,KE,2022.0,1,0,1
MU,,2023.0,103,0,103
,UG,2013.0,395,0,395
SN,,2014.0,34,0,34
,UA,2006.0,1419,0,1419
KW,,1998.0,21,0,21
TZ,,2005.0,27,0,27
DO,,2020.0,26,0,26
SK,,2010.0,213,0,213
EG,,2004.0,217,0,217
SA,,2012.0,227,0,227
FR,KH,2001.0,1,0,1
,CL,2018.0,1410,0,1410
CZ,,2001.0,228,0,228
TN,,2008.0,145,0,145
SY,,2008.0,17,0,17
,DZ,2003.0,412,0,412
CH,CR,2002.0,1,0,1
MA,,2009.0,182,0,182
SZ,,2023.0,56,0,56
HU,ZM,2011.0,1,0,1
,LY,2002.0,8,0,8
,SD,2008.0,92,0,92
BN,CA,2011.0,1,0,1
MA,GN,2019.0,1,0,1
RU,CY,2016.0,1,0,1
CM,AU,2006.0,2,0,2
,RE,2016.0,17,0,17
nan,CY,2016.0,1,0,1
,CM,2004.0,149,0,149
JM,,2022.0,93,0,93
TZ,HU,2014.0,1,0,1
TT,,2025.0,15,0,15
MY,,2003.0,95,0,95
PK,LT,2012.0,7,0,7
,PG,2011.0,24,0,24
,CH,2020.0,228,0,228
,CM,1996.0,65,0,65
PS,RU,2016.0,1,0,1
,KZ,1996.0,51,0,51
VG,,2021.0,28,0,28
BG,PE,2016.0,1,0,1
KE,FI,2005.0,3,0,3
SK,,2019.0,938,0,938
CL,SV,2012.0,4,0,4
CR,DE,2008.0,3,0,3
MG,,2014.0,22,0,22
SD,KW,2004.0,1,0,1
MW,,2014.0,21,0,21
MC,PA,2022.0,1,0,1
ET,,2004.0,17,0,17
LU,,2015.0,98,0,98
PY,,2016.0,9,0,9
ES,KE,2020.0,5,0,5
IN,TT,2004.0,1,0,1
DE,JM,2014.0,3,0,3
UZ,,2005.0,44,0,44
nan,VE,1999.0,1,0,1
MM,HU,1999.0,3,0,3
DK,CL,2004.0,2,0,2
,PR,2006.0,19,0,19
AU,AE,2004.0,5,0,5
PT,,1998.0,42,0,42
BW,ZA,2005.0,6,0,6
BO,,2016.0,24,0,24
EC,nan,2001.0,2,0,2
BR,LK,2022.0,1,0,1
CH,KH,2022.0,1,0,1
CH,KE,2007.0,2,0,2
RU,LU,2017.0,3,0,3
HR,nan,2022.0,1,0,1
AT,DZ,2021.0,2,0,2
AT,GT,2015.0,1,0,1
,BI,2016.0,20,0,20
MY,KP,2021.0,2,0,2
UA,SI,2004.0,2,0,2
GH,JP,2016.0,5,0,5
,BH,2000.0,40,0,40
,AM,2000.0,139,0,139
MA,CM,2012.0,2,0,2
KE,,2006.0,42,0,42
,ZM,1995.0,40,0,40
LT,FI,2005.0,1,0,1
IL,SI,2008.0,2,0,2
,VU,2017.0,3,0,3
BD,YE,2020.0,1,0,1
TH,MY,2006.0,1,0,1
,PY,2012.0,56,0,56
TR,TZ,2018.0,1,0,1
KG,BD,2019.0,1,0,1
,MR,2007.0,4,0,4
CZ,CM,2014.0,1,0,1
ER,,2017.0,1,0,1
NO,FO,2016.0,1,0,1
HT,,2018.0,8,0,8
JO,BR,2000.0,1,0,1
LK,GH,2014.0,1,0,1
NL,LK,2017.0,4,0,4
PG,TN,2018.0,3,0,3
TH,BN,2016.0,1,0,1
ET,IT,2009.0,4,0,4
SK,nan,1997.0,1,0,1
RS,ZA,2012.0,2,0,2
TG,,2018.0,44,0,44
NA,AU,2003.0,1,0,1
BR,BH,2020.0,2,0,2
RS,SG,2013.0,1,0,1
BE,MC,2004.0,1,0,1
MZ,NA,2011.0,1,0,1
ET,KE,2000.0,1,0,1
ER,,2010.0,1,0,1
NZ,HK,2012.0,1,0,1
JP,SY,2022.0,1,0,1
IN,UY,2017.0,1,0,1
IE,VE,2011.0,1,0,1
,MU,2011.0,30,0,30
PF,,2020.0,16,0,16
KY,,2019.0,2,0,2
TZ,RU,2017.0,1,0,1
IN,SK,2001.0,1,0,1
,BA,1994.0,17,0,17
TZ,ID,2016.0,1,0,1
CN,RW,2014.0,1,0,1
CA,LY,2018.0,3,0,3
LB,SY,1998.0,2,0,2
LK,SG,2010.0,3,0,3
BG,IE,2002.0,2,0,2
SA,SO,2020.0,1,0,1
TR,TH,1999.0,2,0,2
,GW,2002.0,2,0,2
,LS,2006.0,6,0,6
LK,NP,2021.0,3,0,3
AL,AR,2015.0,1,0,1
GR,SI,2013.0,3,0,3
IN,AL,2011.0,1,0,1
TR,NG,2011.0,4,0,4
UG,SD,2016.0,1,0,1
HK,FR,2006.0,1,0,1
DE,AL,2009.0,2,0,2
JP,DZ,2012.0,2,0,2
UZ,,2002.0,28,0,28
PK,DE,1998.0,2,0,2
SG,KH,2015.0,1,0,1
GB,IM,2014.0,1,0,1
IL,IE,2000.0,2,0,2
ZW,ML,2013.0,1,0,1
,ME,1994.0,9,0,9
nan,RS,2010.0,2,0,2
BR,ST,1998.0,2,0,2
IQ,PL,2008.0,2,0,2
,KP,2012.0,14,0,14
UA,BR,1998.0,1,0,1
BO,SE,2021.0,2,0,2
ZA,VN,2014.0,3,0,3
OM,DE,2022.0,1,0,1
AE,PK,2006.0,3,0,3
NA,DE,2006.0,1,0,1
RS,GR,2017.0,4,0,4
FJ,,2011.0,4,0,4
GA,,2003.0,4,0,4
TW,HR,2004.0,1,0,1
HN,CU,2021.0,2,0,2
PS,PK,2004.0,1,0,1
GP,MD,1999.0,1,0,1
US,BB,2008.0,4,0,4
RU,ZW,2010.0,5,0,5
TW,ES,2007.0,3,0,3
CZ,AZ,2021.0,1,0,1
GP,,2008.0,5,0,5
SD,NG,1997.0,1,0,1
LK,PK,2017.0,2,0,2
NP,DK,2015.0,2,0,2
NG,SN,2015.0,1,0,1
FR,MN,2016.0,3,0,3
BJ,DE,2002.0,2,0,2
SY,RU,2002.0,1,0,1
NE,,2003.0,1,0,1
PT,CI,2015.0,1,0,1
PG,IE,2006.0,1,0,1
UA,IE,2016.0,2,0,2
JP,CD,2013.0,1,0,1
SN,CD,2020.0,1,0,1
IL,BW,2011.0,1,0,1
AU,MU,2022.0,1,0,1
KY,,2017.0,1,0,1
DZ,BH,2021.0,1,0,1
RE,LB,2015.0,1,0,1
HK,BG,2015.0,1,0,1
ES,SK,2022.0,3,0,3
IQ,RO,2021.0,1,0,1
BD,LB,2019.0,1,0,1
LK,BN,2014.0,2,0,2
CU,GT,2022.0,1,0,1
GB,CR,1998.0,1,0,1
JO,NL,2022.0,1,0,1
AT,CI,2016.0,1,0,1
NO,KZ,2016.0,1,0,1
CY,BR,2002.0,2,0,2
BW,KZ,2018.0,1,0,1
CY,BR,2005.0,1,0,1
SN,KE,2019.0,1,0,1
SA,BD,2005.0,5,0,5
GH,CM,2018.0,2,0,2
CA,BG,1997.0,1,0,1
ZM,JP,2003.0,2,0,2
MA,IN,2004.0,3,0,3
JP,LB,2008.0,1,0,1
AT,FJ,2003.0,1,0,1
TJ,HU,2020.0,1,0,1
LK,ML,2014.0,2,0,2
SG,RS,2008.0,1,0,1
SG,HU,2004.0,2,0,2
SN,KE,2010.0,1,0,1
AT,MT,2000.0,1,0,1
MT,AT,2006.0,1,0,1
JM,IE,2011.0,1,0,1
LY,NG,2013.0,1,0,1
TZ,ES,2003.0,1,0,1
CH,PG,2001.0,1,0,1
KW,NG,2014.0,2,0,2
VE,CL,2023.0,1,0,1
SG,SA,2007.0,4,0,4
ST,,2009.0,3,0,3
NO,HU,2001.0,1,0,1
CR,IE,2008.0,1,0,1
BH,CA,1999.0,1,0,1
IN,NC,2006.0,1,0,1
CR,UY,2017.0,3,0,3
TW,NO,2021.0,3,0,3
ER,,2019.0,1,0,1
ZA,SA,2002.0,1,0,1
TN,MY,2002.0,1,0,1
RU,KG,2009.0,2,0,2
TH,KH,2017.0,1,0,1
HU,CU,1998.0,2,0,2
KW,HR,2009.0,1,0,1
IQ,PH,2009.0,1,0,1
CZ,SY,2011.0,1,0,1
DZ,JP,2007.0,1,0,1
CZ,GE,2003.0,1,0,1
JP,KP,2020.0,1,0,1
BA,,2006.0,8,0,8
,VU,2019.0,1,0,1
IS,IR,2017.0,1,0,1
SA,HU,2018.0,6,0,6
JO,ID,2015.0,2,0,2
MM,nan,2016.0,1,0,1
NI,KR,2020.0,1,0,1
RS,IN,2004.0,1,0,1
MK,ES,2014.0,4,0,4
BD,CO,2020.0,2,0,2
GW,,2020.0,6,0,6
MU,FR,2009.0,3,0,3
ES,VN,2011.0,2,0,2
TR,BD,2012.0,2,0,2
IE,MY,1999.0,2,0,2
,GW,2005.0,4,0,4
UA,SK,2011.0,3,0,3
TR,ST,2013.0,1,0,1
NI,,2009.0,3,0,3
NG,JM,2005.0,1,0,1
DK,RS,2020.0,2,0,2
,VG,2000.0,12,0,12
GF,CL,2020.0,1,0,1
AL,CA,2014.0,2,0,2
CZ,RW,2019.0,1,0,1
VA,AR,2011.0,1,0,1
PH,BE,2002.0,1,0,1
PL,XK,2007.0,2,0,2
,VU,2010.0,3,0,3
ML,BF,2022.0,2,0,2
NP,PK,2003.0,1,0,1
DE,PR,2014.0,1,0,1
VE,PY,2017.0,1,0,1
KR,AT,2001.0,1,0,1
GB,KP,2018.0,1,0,1
SY,KR,2014.0,2,0,2
PY,MX,2011.0,2,0,2
ZA,FJ,2014.0,1,0,1
KY,BR,2012.0,1,0,1
TZ,AT,2021.0,1,0,1
KH,BE,2008.0,1,0,1
BD,AE,2017.0,5,0,5
PH,AT,2017.0,2,0,2
CN,HK,1997.0,3,0,3
IL,LU,2016.0,1,0,1
TN,MY,2005.0,1,0,1
KW,CZ,2002.0,1,0,1
ME,AT,2016.0,1,0,1
TZ,,2002.0,16,0,16
IQ,CO,2014.0,1,0,1
RO,CY,2013.0,1,0,1
KR,HU,2011.0,2,0,2
PH,UZ,2019.0,2,0,2
SJ,FI,2017.0,1,0,1
CY,CZ,2019.0,2,0,2
EG,MA,2002.0,4,0,4
PT,LV,2019.0,2,0,2
GH,VN,2018.0,2,0,2
KR,NP,2006.0,1,0,1
IN,ET,2001.0,2,0,2
BE,BY,2002.0,1,0,1
NP,GE,2013.0,1,0,1
IT,UG,2023.0,1,0,1
PK,AZ,2019.0,1,0,1
TR,JO,2006.0,2,0,2
,GA,2000.0,8,0,8
,AO,1994.0,9,0,9
ZM,ZW,2011.0,2,0,2
AZ,MA,2021.0,1,0,1
KE,GM,2002.0,1,0,1
SY,US,2005.0,4,0,4
CY,JP,2021.0,1,0,1
OM,NZ,2006.0,1,0,1
BO,JP,2004.0,1,0,1
BN,CD,2016.0,1,0,1
BZ,,2019.0,4,0,4
PL,PE,2018.0,1,0,1
GT,CN,2016.0,1,0,1
BW,JP,2012.0,1,0,1
JO,DZ,2018.0,1,0,1
BY,VN,2001.0,1,0,1
FR,YE,2021.0,1,0,1
PS,JO,2004.0,1,0,1
MD,RE,2021.0,1,0,1
FR,MM,2017.0,1,0,1
ML,CA,2010.0,2,0,2
XK,MK,2014.0,1,0,1
LB,RO,2021.0,1,0,1
ES,DO,2007.0,3,0,3
BE,BJ,2003.0,1,0,1
BE,LY,2019.0,2,0,2
GT,GA,2015.0,1,0,1
GM,SL,2018.0,1,0,1
CY,UG,2011.0,1,0,1
UY,NL,2006.0,1,0,1
JP,UG,2003.0,1,0,1
ZM,FR,2015.0,1,0,1
IS,ES,2001.0,2,0,2
PS,IQ,2016.0,3,0,3
NG,CM,2015.0,2,0,2
,SS,1999.0,4,0,4
FI,BY,2005.0,1,0,1
BD,HU,2009.0,2,0,2
EE,DK,2009.0,1,0,1
EG,IE,1999.0,1,0,1
KW,SG,2014.0,1,0,1
IN,LS,2005.0,1,0,1
ST,PT,2014.0,2,0,2
MN,,2004.0,3,0,3
KE,FI,2002.0,1,0,1
BZ,FR,2010.0,7,0,7
LB,ES,2005.0,1,0,1
MG,NE,2006.0,2,0,2
NP,UY,1998.0,1,0,1
UG,HT,2020.0,1,0,1
BZ,,2010.0,2,0,2
AR,SK,2021.0,1,0,1
BI,MG,2018.0,1,0,1
NG,TH,2004.0,1,0,1
CL,ID,2011.0,1,0,1
BB,JP,2012.0,1,0,1
NG,MD,2012.0,4,0,4
PK,SG,2010.0,2,0,2
IQ,PT,2019.0,2,0,2
CA,LT,2004.0,2,0,2
SJ,UA,2020.0,1,0,1
KH,VN,2017.0,1,0,1
CW,GB,2011.0,1,0,1
KR,CL,2016.0,2,0,2
EC,GB,1998.0,1,0,1
JM,BS,2022.0,1,0,1
JP,TZ,2022.0,3,0,3
BE,BY,2005.0,1,0,1
RO,MD,2009.0,1,0,1
NL,MG,2021.0,1,0,1
IL,UG,2016.0,4,0,4
ES,IE,2023.0,2,0,2
CD,MA,2015.0,1,0,1
JP,CU,2013.0,1,0,1
RE,IL,2007.0,1,0,1
FI,BY,2002.0,1,0,1
MC,US,2017.0,3,0,3
PS,RO,2018.0,1,0,1
IN,TG,2020.0,1,0,1
GM,PL,2018.0,1,0,1
,TL,2016.0,5,0,5
AR,NG,2018.0,1,0,1
TH,LK,2012.0,1,0,1
IN,CY,2017.0,2,0,2
DK,NG,2022.0,1,0,1
PH,QA,2013.0,1,0,1
US,KP,2011.0,2,0,2
MX,SI,2008.0,1,0,1
NL,BI,2006.0,1,0,1
SE,LU,2014.0,1,0,1
GB,ZM,2007.0,2,0,2
MS,TT,2021.0,1,0,1
BD,KW,2007.0,2,0,2
GF,BR,2012.0,1,0,1
IN,FJ,2002.0,2,0,2
FR,HR,2003.0,2,0,2
ZW,PH,2011.0,1,0,1
BY,IR,2009.0,1,0,1
AT,ZW,2012.0,2,0,2
EC,PH,2012.0,1,0,1
CN,BY,2007.0,2,0,2
CM,CN,2004.0,1,0,1
GB,TJ,2020.0,1,0,1
JO,PK,2005.0,2,0,2
IE,VN,2008.0,1,0,1
KG,JP,2015.0,1,0,1
AO,KE,2014.0,1,0,1
ID,BR,2000.0,1,0,1
LU,LB,2020.0,1,0,1
AR,ID,2009.0,2,0,2
ML,BR,2006.0,1,0,1
AU,LB,2002.0,1,0,1
MV,IQ,2018.0,1,0,1
XK,FR,2015.0,1,0,1
KE,BW,2003.0,1,0,1
TH,CD,2015.0,1,0,1
YE,,2000.0,4,0,4
FI,PE,2018.0,3,0,3
SN,KE,2017.0,1,0,1
CO,IT,2002.0,2,0,2
KW,MY,2022.0,3,0,3
GT,FR,2013.0,1,0,1
KH,AU,2013.0,1,0,1
ZW,AT,2008.0,1,0,1
BB,MX,2016.0,1,0,1
JP,BJ,2001.0,1,0,1
AZ,FR,2014.0,3,0,3
SK,NO,2004.0,1,0,1
SS,,2016.0,3,0,3
FI,NZ,2023.0,1,0,1
DZ,IN,2016.0,2,0,2
GE,SE,2001.0,1,0,1
LK,PK,2010.0,1,0,1
AL,SE,2013.0,2,0,2
GE,PK,2008.0,2,0,2
PS,PT,2003.0,1,0,1
BW,CZ,2015.0,1,0,1
,HT,2001.0,1,0,1
ET,CZ,2019.0,5,0,5
ML,US,2000.0,2,0,2
PL,MY,2002.0,1,0,1
AF,,2007.0,1,0,1
CA,UY,2001.0,1,0,1
PL,SL,2019.0,1,0,1
MZ,NL,2016.0,1,0,1
PK,BJ,2017.0,1,0,1
MX,BG,2001.0,1,0,1
MN,GB,2021.0,1,0,1
BF,SE,2007.0,1,0,1
GE,HU,2007.0,2,0,2
DE,GN,2010.0,1,0,1
FI,PA,2008.0,1,0,1
NI,NZ,2012.0,1,0,1
GB,IQ,1997.0,1,0,1
DE,MK,2000.0,1,0,1
TG,GH,2014.0,1,0,1
JO,MK,2005.0,1,0,1
IT,NE,2017.0,1,0,1
AO,MZ,2020.0,1,0,1
GB,SO,2018.0,1,0,1
EG,AM,2011.0,1,0,1
LB,BE,2006.0,1,0,1
AO,FR,2006.0,2,0,2
CY,JO,2018.0,2,0,2
PE,AE,2022.0,1,0,1
MA,RU,2017.0,2,0,2
NZ,EE,2013.0,2,0,2
FR,MR,2003.0,2,0,2
SE,LK,2003.0,1,0,1
ID,AM,2019.0,5,0,5
IQ,AE,1999.0,1,0,1
CA,SO,2018.0,1,0,1
PS,CH,2019.0,2,0,2
AM,NO,2020.0,1,0,1
,CV,2004.0,2,0,2
RW,BW,2014.0,1,0,1
MV,GB,2011.0,1,0,1
IN,AG,2018.0,3,0,3
LU,AE,2011.0,1,0,1
ES,GI,2018.0,1,0,1
MK,IT,2004.0,1,0,1
FR,KE,1998.0,1,0,1
JP,BN,2006.0,1,0,1
SG,MT,2007.0,1,0,1
SA,ID,2009.0,1,0,1
RS,AT,2010.0,1,0,1
AF,IQ,2021.0,1,0,1
NG,ES,2022.0,1,0,1
KR,LU,2015.0,1,0,1
HU,PT,2000.0,1,0,1
FJ,WS,2022.0,1,0,1
EC,UY,2008.0,2,0,2
CA,ZM,1998.0,1,0,1
NG,OM,2021.0,3,0,3
HN,PR,2005.0,1,0,1
HR,AE,2016.0,1,0,1
TW,SY,2020.0,1,0,1
IQ,BE,2021.0,1,0,1
UZ,GB,2009.0,2,0,2
NE,BF,1997.0,1,0,1
TH,KH,2019.0,1,5,-4
ZA,MY,2015.0,3,5,-2
BE,DZ,2014.0,4,3,1
ES,JO,2019.0,1,1,0
EE,CH,2008.0,1,5,-4
AT,TH,2020.0,3,2,1
LB,ZA,2018.0,1,1,0
MZ,BE,2010.0,3,4,-1
BJ,DE,2005.0,1,4,-3
MN,JP,2003.0,1,2,-1
JP,RS,2013.0,6,1,5
RO,ES,2022.0,4,10,-6
NG,MY,2003.0,1,2,-1
IN,KZ,2015.0,1,1,0
US,EE,2023.0,1,1,0
ZA,QA,2022.0,1,1,0
IL,NO,2017.0,1,6,-5
SY,US,2002.0,2,1,1
BJ,NG,2010.0,2,3,-1
DK,FO,2009.0,2,2,0
CL,HN,2010.0,1,2,-1
LV,DK,2016.0,2,1,1
IR,SI,2014.0,1,1,0
ET,CH,1999.0,1,1,0
CH,RS,1999.0,2,2,0
NL,MY,2008.0,1,5,-4
BD,IE,2016.0,3,2,1
FR,GA,2001.0,4,6,-2
IQ,CA,2012.0,1,2,-1
KG,RU,2013.0,2,4,-2
FR,EC,2003.0,3,2,1
TN,DE,2008.0,2,5,-3
LK,GR,2014.0,1,4,-3
ZA,TH,2010.0,1,1,0
DK,GR,2009.0,5,12,-7
AR,IL,1998.0,1,5,-4
ZW,AU,2001.0,1,1,0
AE,BE,2022.0,2,2,0
US,MD,1997.0,1,1,0
PL,PK,2003.0,1,2,-1
MD,BE,2006.0,2,4,-2
MA,SY,2008.0,1,1,0
CM,ZM,2023.0,1,1,0
LA,JP,2020.0,1,4,-3
CI,NG,2006.0,1,1,0
SS,US,2013.0,2,1,1
ES,JO,2017.0,2,2,0
TG,BF,2012.0,1,1,0
AR,IL,1997.0,2,1,1
PL,BY,2000.0,1,3,-2
IL,PE,2011.0,1,1,0
NE,GB,2020.0,2,2,0
GB,BW,2009.0,3,4,-1
CO,NZ,2022.0,2,1,1
MK,GB,2008.0,2,2,0
SK,IT,2021.0,2,6,-4
RO,ZA,2011.0,1,2,-1
CU,CN,2012.0,1,2,-1
UG,NZ,2019.0,3,3,0
PA,CU,2015.0,1,1,0
LY,CA,2015.0,1,3,-2
nan,MM,2018.0,1,1,0
MX,DK,2003.0,1,1,0
BR,PL,2002.0,2,2,0
HU,NZ,2012.0,1,2,-1
BG,SK,2014.0,1,2,-1
BG,FR,2021.0,1,2,-1
SD,CN,2014.0,3,6,-3
GE,UA,2018.0,2,1,1
AR,BO,2019.0,2,2,0
TH,ZM,2004.0,1,1,0
HR,IN,2005.0,2,1,1
CD,GB,2017.0,1,1,0
KE,BE,2006.0,1,3,-2
GH,CA,2009.0,2,2,0
GT,PH,2021.0,1,1,0
BY,IL,2020.0,2,1,1
MG,DE,2016.0,2,1,1
JP,SI,2015.0,1,6,-5
BY,IT,2009.0,1,1,0
CL,AT,2010.0,2,2,0
NZ,TR,2022.0,1,2,-1
IN,CY,2019.0,1,7,-6
BD,DE,2004.0,2,4,-2
RS,ES,2015.0,3,3,0
IR,ES,2003.0,1,1,0
KZ,CZ,2013.0,1,1,0
RS,GR,2010.0,1,1,0
BR,TN,2009.0,1,1,0
AU,BR,2023.0,3,3,0
RO,UA,2007.0,1,1,0
AU,CY,2018.0,3,1,2
NG,BD,2022.0,2,1,1
FR,UG,2003.0,1,2,-1
CH,BY,2007.0,1,1,0
IT,NG,2007.0,1,4,-3
BA,DE,2005.0,1,2,-1
BF,ID,2017.0,1,1,0
CO,KE,2004.0,1,2,-1
SI,SK,2017.0,1,3,-2
MK,FR,2007.0,1,1,0
AU,CU,2013.0,2,1,1
MW,CA,2009.0,1,3,-2
CI,GN,2016.0,1,1,0
JP,MA,2011.0,1,2,-1
CI,KE,2015.0,1,3,-2
TH,AT,2009.0,1,3,-2
LY,PK,2017.0,1,1,0
PE,KE,2016.0,2,5,-3
NO,RO,2012.0,2,1,1
FR,NI,2013.0,1,1,0
MX,IE,2014.0,1,3,-2
SV,PE,2014.0,1,2,-1
PH,IR,2012.0,1,1,0
MX,KR,2011.0,1,4,-3
KW,AU,2004.0,1,1,0
CI,CH,2016.0,1,2,-1
NZ,CZ,2022.0,1,1,0
TN,BF,2018.0,1,1,0
CA,BF,2010.0,1,3,-2
UG,IN,2014.0,1,1,0
BH,GB,2012.0,1,3,-2
MX,SE,2004.0,2,8,-6
TH,IN,1997.0,1,1,0
EG,TZ,2022.0,1,1,0
BR,BG,2020.0,1,4,-3
BE,MY,2006.0,1,1,0
ME,QA,2020.0,1,1,0
AT,ZA,1998.0,1,3,-2
UY,CA,2008.0,1,1,0
PL,SK,2022.0,1,6,-5
IT,IE,2023.0,1,4,-3
ZW,NA,2020.0,1,1,0
CH,ZW,2021.0,1,1,0
RO,RU,2001.0,1,1,0
SN,CM,2002.0,1,1,0
FJ,DE,2017.0,1,1,0
KR,PH,2003.0,1,2,-1
NL,IS,2014.0,1,1,0
NG,MW,2001.0,1,1,0
AR,CZ,2000.0,1,1,0
BH,QA,2021.0,1,1,0
YE,US,2020.0,3,3,0
TD,CM,2021.0,1,2,-1
nan,EE,2018.0,1,1,0
GA,AT,2008.0,1,1,0
MY,FR,1999.0,2,3,-1
CA,HR,2005.0,1,2,-1
SI,ZA,2020.0,1,3,-2
MM,US,2008.0,1,4,-3
IS,PK,2019.0,1,2,-1
LK,TH,2019.0,1,1,0
SA,TR,1999.0,1,1,0
ES,IQ,2018.0,1,1,0
RU,CA,2023.0,1,1,0
GB,BJ,2013.0,1,1,0
LB,PK,2021.0,2,4,-2
KW,AE,2000.0,1,1,0
SA,IL,2011.0,1,1,0
PS,FR,2016.0,1,4,-3
SI,IT,2023.0,1,3,-2
ME,RU,2019.0,1,1,0
TN,NE,2019.0,1,1,0
MX,RO,2008.0,1,1,0
MA,MR,2022.0,1,1,0
CU,nan,2017.0,3,3,0
MX,BA,2007.0,1,2,-1
US,NP,1998.0,1,1,0
SY,JP,2014.0,1,1,0
AU,SK,2007.0,1,1,0
IL,CR,2019.0,4,1,3
ZA,AE,2015.0,3,1,2
SK,CH,1999.0,3,5,-2
ML,CA,2019.0,1,2,-1
CZ,JP,1997.0,4,6,-2
EG,DK,2015.0,1,5,-4
CN,PA,2022.0,1,2,-1
AZ,EG,2010.0,1,1,0
VG,CA,2011.0,1,2,-1
GR,IE,2000.0,1,1,0
CN,HK,1998.0,1,2,-1
RS,GR,2019.0,1,3,-2
NZ,KE,2010.0,2,3,-1
LY,US,2001.0,2,1,1
BY,DE,2017.0,2,6,-4
TH,FI,2015.0,1,1,0
GB,MZ,2018.0,2,1,1
BF,JP,2017.0,1,4,-3
ZA,CL,2010.0,2,2,0
NG,PT,2018.0,1,2,-1
LB,ES,2002.0,1,1,0
EE,CN,2011.0,1,1,0
KZ,IE,2020.0,1,1,0
SE,BW,2011.0,1,0,1
ZA,LT,2019.0,2,0,2
MY,SK,2015.0,1,0,1
SY,AU,2022.0,1,0,1
EG,VC,2015.0,1,0,1
HR,IL,2003.0,1,0,1
SN,IN,2007.0,1,0,1
VN,BN,2015.0,1,0,1
IN,HK,2011.0,1,0,1
JO,UA,2008.0,1,0,1
VC,EG,2017.0,1,0,1
BI,TR,2017.0,1,0,1
BF,JP,2010.0,1,0,1
BT,,2011.0,4,0,4
PH,LK,2014.0,2,0,2
SO,SE,2021.0,1,0,1
ZM,IN,2008.0,2,0,2
FO,SE,2000.0,1,0,1
IR,BR,1999.0,1,0,1
LK,NL,2000.0,2,0,2
NZ,ZM,2013.0,1,0,1
MT,US,1997.0,1,0,1
CH,DO,2013.0,1,0,1
US,KN,2006.0,1,0,1
NE,EG,2019.0,1,0,1
SE,SD,2016.0,1,0,1
ZA,JM,2010.0,1,0,1
CO,NI,2010.0,2,0,2
MN,TW,2017.0,1,0,1
SI,AT,1999.0,4,0,4
CA,ET,2006.0,1,0,1
IL,NP,2011.0,1,0,1
MX,MK,2014.0,1,0,1
DE,SV,2022.0,1,0,1
KZ,AM,2012.0,1,0,1
SY,KE,2016.0,1,0,1
BZ,,2017.0,1,0,1
HR,TH,2016.0,1,0,1
BE,LK,2000.0,1,0,1
JP,KW,2020.0,1,0,1
PA,PH,2016.0,1,0,1
IE,MV,2018.0,1,0,1
CH,BW,2012.0,1,0,1
CO,BO,2000.0,1,0,1
PH,SE,2008.0,2,0,2
TR,BH,2001.0,1,0,1
DZ,SS,2022.0,1,0,1
NZ,SI,2013.0,2,0,2
NG,TW,2020.0,2,0,2
FI,LY,2013.0,1,0,1
BF,CI,2010.0,1,0,1
,AG,2020.0,6,0,6
CL,TH,2022.0,1,0,1
SN,CG,2006.0,1,0,1
EE,ZA,2015.0,1,0,1
PG,DE,2004.0,1,0,1
CA,RS,2023.0,1,0,1
ZA,MZ,2007.0,2,0,2
SY,IL,2020.0,1,0,1
DE,ET,2000.0,2,0,2
LV,DE,1999.0,2,0,2
FR,BW,2018.0,1,0,1
LB,AE,2002.0,1,0,1
BE,GN,2000.0,1,0,1
AE,SN,2017.0,1,0,1
SN,TG,2012.0,1,0,1
DO,US,2000.0,1,0,1
HN,FR,2021.0,1,0,1
CO,HR,2020.0,1,0,1
PL,LK,2017.0,1,0,1
,GY,2004.0,2,0,2
RO,PK,2012.0,2,0,2
RE,CH,2014.0,1,0,1
nan,VG,2003.0,1,0,1
CA,CU,1997.0,1,0,1
CI,nan,1999.0,1,0,1
FR,HK,2019.0,1,0,1
IE,SY,2022.0,2,0,2
TN,ZA,2016.0,1,0,1
CR,CL,1999.0,1,0,1
TH,GE,2022.0,1,0,1
GB,LT,2002.0,1,0,1
BE,UY,2007.0,1,0,1
OM,ZA,2011.0,1,0,1
TJ,,2003.0,1,0,1
FR,KE,1997.0,1,0,1
IM,,2021.0,1,0,1
FR,BT,2021.0,2,0,2
SE,PH,2002.0,2,0,2
LK,TR,2019.0,1,0,1
NZ,TO,2008.0,1,0,1
SZ,TT,2010.0,1,0,1
BJ,CG,2009.0,2,0,2
FO,IS,2006.0,1,0,1
GB,PR,2016.0,1,0,1
PT,PH,1998.0,1,0,1
BE,KZ,2009.0,1,0,1
CZ,SG,2010.0,1,0,1
LV,IT,2010.0,1,0,1
IE,TH,2007.0,1,0,1
GF,BJ,2018.0,1,0,1
nan,TH,2007.0,1,0,1
MK,IE,2015.0,1,0,1
MS,JM,2014.0,1,0,1
UG,nan,2005.0,1,0,1
ZM,CG,2020.0,1,0,1
MY,NL,2001.0,1,0,1
GP,SE,2011.0,1,0,1
BE,ML,1997.0,1,0,1
BE,CD,2023.0,1,0,1
SA,IQ,2005.0,1,0,1
NI,BO,2018.0,1,0,1
TN,AR,2016.0,1,0,1
CL,SD,2019.0,1,0,1
DE,LR,2016.0,1,0,1
AO,RU,2022.0,1,0,1
PT,LV,2017.0,1,0,1
PE,SG,2020.0,1,0,1
CL,BI,2012.0,1,0,1
UZ,AM,2022.0,1,0,1
UA,SG,2000.0,1,0,1
UZ,FR,2014.0,1,0,1
DE,LB,1999.0,1,0,1
CR,DK,2001.0,1,0,1
PL,LY,2001.0,1,0,1
CG,JP,2010.0,1,0,1
MY,TW,2000.0,1,0,1
CA,BO,2006.0,1,0,1
IE,NG,1997.0,1,0,1
CI,IN,2014.0,1,0,1
BR,VG,2010.0,1,0,1
BS,,2008.0,1,0,1
ES,BF,2018.0,1,0,1
EC,BJ,2016.0,1,0,1
MY,HU,2021.0,1,0,1
TN,CN,2011.0,1,0,1
NE,KE,2015.0,1,0,1
US,MS,2020.0,2,0,2
XK,AL,2010.0,1,0,1
FI,PH,1998.0,1,0,1
BF,JP,2019.0,1,0,1
BD,ZA,2022.0,1,0,1
CH,MU,2019.0,1,0,1
FR,MV,2021.0,1,0,1
CY,HU,2023.0,1,0,1
CA,BY,2000.0,1,0,1
NZ,ID,2004.0,1,0,1
JP,MW,2005.0,1,0,1
AU,ZM,2006.0,1,0,1
SN,CI,1997.0,1,0,1
MV,PK,2020.0,1,0,1
SY,KW,2020.0,1,0,1
EC,IT,2005.0,1,0,1
nan,LV,2014.0,1,0,1
CG,RE,2019.0,1,0,1
TR,UA,2012.0,1,0,1
CH,HK,2016.0,1,0,1
BA,US,2000.0,1,0,1
PS,IN,1998.0,1,0,1
SE,AL,2002.0,2,0,2
US,SC,2000.0,1,0,1
nan,CI,2010.0,1,0,1
PY,CN,1999.0,1,0,1
ME,BA,2006.0,1,0,1
IQ,JP,2005.0,1,0,1
GR,CL,2009.0,1,0,1
GH,RW,2019.0,1,0,1
TW,MD,2011.0,1,0,1
KR,UG,2018.0,1,0,1
GD,RU,2018.0,1,0,1
CY,ZW,2022.0,1,0,1
ES,NE,2017.0,1,0,1
NE,NC,2009.0,1,0,1
NL,SR,2013.0,1,0,1
BY,MZ,2006.0,1,0,1
GL,,2003.0,1,0,1
PE,HN,2015.0,1,0,1
PH,ZA,2001.0,1,0,1
BR,AG,2020.0,1,0,1
BE,MR,2014.0,1,0,1
CR,AT,2021.0,1,0,1
SC,US,2022.0,1,0,1
PK,MG,2022.0,1,0,1
SY,AE,2014.0,1,0,1
FR,BN,2015.0,1,0,1
EE,NE,2019.0,1,0,1
IS,NL,2001.0,2,0,2
NL,SD,2021.0,2,0,2
EE,GE,2017.0,1,0,1
BA,CN,2003.0,1,0,1
CA,ZW,2013.0,1,0,1
RU,SO,2020.0,1,0,1
ME,UA,2008.0,1,0,1
CU,DK,2014.0,1,0,1
JP,SV,2007.0,1,0,1
RU,LU,2010.0,1,0,1
EG,NO,2012.0,1,0,1
ET,PK,2013.0,1,0,1
EG,PE,2007.0,1,0,1
RO,DK,1999.0,1,0,1
SI,XK,2022.0,1,0,1
PA,NL,2007.0,1,0,1
NG,JO,2015.0,1,0,1
TJ,US,2016.0,1,0,1
BE,VE,2009.0,1,0,1
TR,SK,2005.0,1,0,1
FR,KG,2019.0,1,0,1
PK,CR,2003.0,1,0,1
TH,PT,2005.0,1,0,1
GP,JM,2023.0,1,0,1
TZ,DK,2006.0,1,0,1
DK,BD,2001.0,1,0,1
MW,JP,2021.0,1,0,1
SG,UA,2005.0,1,0,1
RU,PH,2021.0,1,0,1
XK,SE,2023.0,1,0,1
HU,ID,2023.0,1,0,1
GM,KE,2020.0,1,0,1
LB,IE,2023.0,1,0,1
SA,UZ,2020.0,1,0,1
BF,KE,2021.0,1,0,1
ML,ZW,2020.0,1,0,1
MX,XK,2013.0,1,0,1
KE,BR,2010.0,1,0,1
CN,CG,2018.0,1,0,1
AZ,EG,2019.0,1,0,1
HK,AT,2019.0,1,0,1
CI,ID,2020.0,1,0,1
RS,IT,2003.0,1,0,1
CN,NZ,2018.0,56,66,-10
US,CN,2009.0,6927,5136,1791
US,SG,2000.0,108,112,-4
DE,US,2022.0,1281,1303,-22
GB,RU,2015.0,135,83,52
GB,US,2004.0,4274,3955,319
US,DE,2019.0,2771,2662,109
SD,US,2021.0,15,8,7
US,DE,2010.0,2363,2308,55
RU,US,2011.0,347,368,-21
ES,US,2008.0,706,731,-25
CA,IT,2018.0,124,218,-94
DE,IT,2015.0,241,345,-104
US,DE,2017.0,2690,2505,185
PT,FR,2014.0,55,51,4
KR,US,2022.0,854,819,35
JP,CA,2006.0,131,97,34
CO,US,2007.0,156,160,-4
DE,GB,2001.0,437,371,66
NO,BR,2008.0,25,6,19
EC,CL,2017.0,43,87,-44
US,IN,1998.0,433,469,-36
US,EC,2017.0,95,55,40
AU,US,2008.0,1758,1874,-116
US,JP,2007.0,1835,1867,-32
CU,BR,2010.0,18,14,4
BE,GB,2005.0,79,82,-3
IT,AU,2020.0,73,62,11
AR,ES,2018.0,354,443,-89
US,NL,2016.0,772,819,-47
CH,CN,2012.0,64,70,-6
SG,BD,2014.0,5,1,4
CR,US,2013.0,24,39,-15
ES,VE,2012.0,53,115,-62
US,SA,1998.0,27,21,6
SG,CN,2001.0,116,135,-19
NZ,GB,2019.0,328,309,19
AU,CH,2000.0,30,30,0
CA,IN,2018.0,211,287,-76
US,IN,1997.0,331,360,-29
EG,US,2010.0,121,176,-55
BE,NL,2006.0,161,164,-3
MX,DE,2019.0,67,46,21
CN,TW,2003.0,526,951,-425
EC,MX,2015.0,29,79,-50
GB,NZ,2008.0,231,199,32
ZA,US,2022.0,203,195,8
UY,ES,2021.0,30,32,-2
TR,IN,2011.0,17,13,4
IN,KR,2011.0,142,119,23
SE,GB,2010.0,170,159,11
FI,CN,2015.0,25,33,-8
NZ,LK,2018.0,2,6,-4
FR,CA,2016.0,612,617,-5
CZ,DE,2015.0,72,72,0
ES,GB,2018.0,541,430,111
US,EC,2010.0,21,16,5
TW,CN,1999.0,257,174,83
SG,MY,2015.0,142,100,42
CL,EC,2016.0,76,27,49
ES,nan,2014.0,58,41,17
JP,LB,2007.0,2,1,1
CA,CN,2003.0,294,222,72
NZ,GB,2017.0,241,274,-33
IT,US,2012.0,1062,914,148
CL,PH,2021.0,7,1,6
BR,CL,2020.0,148,121,27
EG,US,2019.0,296,365,-69
GB,DE,2003.0,434,502,-68
FI,US,2003.0,112,96,16
GB,SG,2006.0,71,61,10
MY,EG,2016.0,50,40,10
GR,ZA,2018.0,4,5,-1
DE,BR,2013.0,215,173,42
BR,NZ,2019.0,21,15,6
CA,CH,2013.0,111,106,5
NL,US,2008.0,621,594,27
DE,TW,2022.0,32,23,9
FR,TR,2013.0,29,25,4
CL,ES,2020.0,450,400,50
TW,MY,2018.0,31,29,2
CU,BR,2019.0,46,22,24
JP,SE,2014.0,38,34,4
CN,PH,2003.0,19,17,2
SG,TW,2019.0,54,71,-17
TW,CA,2020.0,42,30,12
SE,FR,2015.0,64,97,-33
CH,FR,2008.0,361,347,14
FR,CF,1999.0,1,2,-1
US,PE,2020.0,130,130,0
EG,US,2017.0,266,303,-37
DE,LU,2012.0,43,23,20
FR,BE,2020.0,354,359,-5
JM,TT,2007.0,19,7,12
NL,PL,2011.0,27,25,2
MD,TN,2015.0,9,6,3
VE,CO,2002.0,14,3,11
TR,US,2011.0,366,441,-75
SA,BR,2009.0,1,3,-2
BE,FR,2015.0,427,375,52
CO,VE,2009.0,25,43,-18
IN,FR,2013.0,125,110,15
TR,SE,2016.0,19,13,6
BR,CO,2016.0,143,168,-25
EC,CL,2010.0,9,9,0
SE,NO,2022.0,88,57,31
IE,US,2007.0,330,383,-53
LT,GB,2012.0,9,9,0
RU,JP,2010.0,37,39,-2
MX,DE,2010.0,37,35,2
DE,JP,2008.0,158,190,-32
CO,NL,2015.0,13,8,5
CN,FR,2015.0,160,203,-43
CO,EC,2016.0,113,60,53
US,FI,2006.0,166,124,42
NZ,GB,2010.0,215,258,-43
PL,RS,2014.0,13,8,5
JP,DE,2001.0,133,145,-12
ES,PT,1999.0,33,27,6
US,IL,2021.0,405,380,25
DK,FR,2019.0,54,56,-2
CO,BR,2014.0,145,129,16
RU,EC,2019.0,4,4,0
RW,IN,2014.0,6,9,-3
IN,NL,2013.0,46,51,-5
DE,CH,2021.0,719,675,44
LV,LT,2016.0,2,1,1
AT,GB,2013.0,104,94,10
EC,CL,2019.0,92,88,4
PE,CL,2020.0,61,88,-27
ES,FR,2000.0,110,119,-9
IT,GB,2018.0,740,510,230
AU,AE,2015.0,15,12,3
GR,ES,2007.0,15,8,7
IR,NO,2018.0,17,17,0
IT,CO,2014.0,20,22,-2
SE,GB,2019.0,217,244,-27
IL,RU,1999.0,7,16,-9
ZA,CA,2007.0,32,16,16
CI,CM,2015.0,3,1,2
NZ,AR,2016.0,2,3,-1
JP,FR,2004.0,106,86,20
CM,CH,2012.0,4,1,3
NL,DE,2021.0,322,344,-22
ET,NG,2017.0,6,7,-1
nan,AR,2011.0,55,42,13
RO,PL,2019.0,11,10,1
US,SA,1997.0,29,23,6
IT,DE,2008.0,267,155,112
SA,US,2007.0,39,73,-34
NG,NA,2021.0,2,1,1
SE,DE,2009.0,148,172,-24
BR,AU,2016.0,142,134,8
MX,AR,2020.0,158,157,1
BR,AR,2014.0,144,141,3
nan,US,2020.0,268,281,-13
EG,DE,2014.0,36,73,-37
CN,CH,2012.0,70,64,6
PK,CN,2006.0,72,39,33
US,TT,2018.0,14,10,4
CN,MY,2007.0,23,17,6
QA,CN,2012.0,11,15,-4
DK,AU,2007.0,31,24,7
SG,TW,2017.0,48,58,-10
GH,ID,2017.0,17,10,7
EG,LB,2018.0,23,14,9
IE,NL,2009.0,19,20,-1
GR,GB,2007.0,114,157,-43
AT,UA,2020.0,11,5,6
MX,SE,2015.0,9,11,-2
IL,AU,2012.0,17,18,-1
IR,IT,2010.0,10,13,-3
FR,nan,2016.0,191,238,-47
CH,RU,2021.0,23,32,-9
ID,FR,1999.0,4,4,0
IQ,SY,2017.0,2,1,1
IL,CA,2017.0,90,57,33
PL,JP,2015.0,21,18,3
MX,FR,2020.0,69,72,-3
MX,PE,2013.0,97,61,36
AR,BR,2013.0,160,123,37
RU,UA,2006.0,107,118,-11
DE,ZM,2011.0,1,1,0
ES,NZ,2020.0,11,10,1
SE,TR,2016.0,13,19,-6
IQ,FR,2017.0,3,11,-8
BR,MZ,2010.0,8,3,5
TW,DE,1999.0,8,9,-1
CY,US,2016.0,25,20,5
CN,SE,2020.0,126,128,-2
MY,TH,2009.0,4,1,3
SE,IS,2020.0,21,26,-5
UY,DE,2004.0,2,1,1
NL,IN,2010.0,49,49,0
MY,IN,2009.0,38,53,-15
BR,PE,2015.0,55,49,6
BG,DE,2016.0,23,28,-5
nan,GB,2006.0,67,86,-19
RU,KZ,2022.0,52,29,23
DK,FR,2017.0,34,47,-13
CM,ZA,2014.0,10,3,7
IN,BY,2021.0,9,6,3
US,EC,2019.0,116,109,7
NL,TH,2020.0,13,7,6
FR,PL,2007.0,39,49,-10
AR,UY,2020.0,38,44,-6
PL,TW,2020.0,3,7,-4
ZA,BR,2009.0,5,14,-9
MW,ZA,2014.0,11,4,7
KE,CH,2013.0,8,2,6
FR,CN,2022.0,127,113,14
FR,MD,2008.0,34,63,-29
AR,CH,2019.0,22,16,6
BE,IT,2001.0,47,43,4
JO,EG,1997.0,4,1,3
FR,CL,2013.0,55,39,16
AR,CA,2000.0,5,5,0
SE,BE,2010.0,23,21,2
NL,IN,2017.0,53,90,-37
DZ,TN,2016.0,19,24,-5
NP,NZ,2016.0,50,48,2
ES,NO,2012.0,25,21,4
SG,TW,2010.0,31,39,-8
ES,PE,2004.0,27,23,4
NL,FR,2023.0,4,1,3
SK,CZ,2004.0,40,41,-1
BR,EC,2009.0,9,1,8
MY,nan,2015.0,53,90,-37
GB,EG,2013.0,88,57,31
RS,HR,2015.0,123,141,-18
IL,CA,2010.0,72,40,32
FR,NZ,2008.0,13,12,1
BR,MZ,2017.0,18,19,-1
nan,SE,2020.0,18,16,2
CG,CH,2019.0,2,2,0
GB,PK,2015.0,170,106,64
XK,RS,2020.0,22,21,1
UA,DE,2001.0,43,16,27
AR,BE,2005.0,6,3,3
GR,NL,2004.0,12,19,-7
AT,IN,2015.0,8,16,-8
ID,CN,2022.0,118,84,34
PK,NL,2016.0,10,7,3
nan,CR,2003.0,3,2,1
SE,AT,2004.0,9,9,0
RU,JP,2019.0,37,60,-23
NL,IN,2019.0,61,95,-34
BD,MY,2015.0,58,41,17
AU,SE,2008.0,37,46,-9
PH,AU,2003.0,6,7,-1
TR,CY,2011.0,19,18,1
CO,IN,2017.0,5,2,3
TW,KR,2016.0,54,46,8
FR,HU,2017.0,18,19,-1
BR,PH,2020.0,16,9,7
NL,AU,2021.0,76,80,-4
CA,nan,2007.0,19,19,0
IN,EG,2020.0,17,23,-6
GD,US,2013.0,10,10,0
CA,LT,2015.0,2,1,1
RU,EC,2010.0,3,1,2
BR,NL,2002.0,13,14,-1
EC,UA,2017.0,61,7,54
GH,GB,2019.0,22,45,-23
SE,BA,2012.0,1,1,0
SA,QA,2016.0,26,14,12
HK,SG,2018.0,3,2,1
JP,NG,2022.0,10,19,-9
TW,AU,2018.0,48,37,11
PR,KR,2014.0,30,38,-8
IT,RU,2022.0,62,41,21
SD,KR,2016.0,2,8,-6
IN,KN,2015.0,2,2,0
CZ,UA,2018.0,39,32,7
CU,MX,2021.0,37,26,11
GB,EC,2019.0,15,14,1
GR,US,2011.0,176,177,-1
CH,IN,2015.0,51,62,-11
SE,ID,2020.0,8,10,-2
EG,CH,2021.0,6,6,0
CN,DE,2023.0,47,27,20
NZ,MY,2016.0,23,21,2
HR,GB,2013.0,26,17,9
MX,NL,2019.0,31,15,16
AR,CH,2017.0,27,21,6
AU,ID,2005.0,16,3,13
SG,DE,2000.0,4,10,-6
PH,JP,2006.0,15,18,-3
UA,IT,2005.0,7,10,-3
UA,FR,2000.0,10,8,2
DZ,FR,2005.0,50,40,10
CH,DK,2018.0,55,44,11
JP,PK,2021.0,11,10,1
GB,AT,2012.0,108,76,32
AE,IR,2019.0,7,11,-4
US,ET,2014.0,30,29,1
KZ,CN,2009.0,4,5,-1
MY,BE,2019.0,11,1,10
ID,SA,2021.0,22,18,4
MA,ES,2003.0,9,8,1
AU,IR,2021.0,66,137,-71
RS,IN,2015.0,2,4,-2
GE,US,2013.0,167,140,27
IT,LB,2012.0,18,11,7
KE,NG,2016.0,5,3,2
IT,TR,2020.0,17,21,-4
ID,UA,2015.0,1,1,0
MY,BD,2021.0,42,37,5
MY,UG,2020.0,1,1,0
SA,AE,2014.0,24,12,12
CZ,IT,2003.0,17,14,3
BD,JP,2013.0,44,73,-29
DK,SE,2003.0,52,51,1
NI,UA,2015.0,4,2,2
UY,MX,2021.0,10,9,1
nan,AE,2019.0,3,4,-1
US,UG,2021.0,28,38,-10
RE,FR,2021.0,31,50,-19
AE,EG,2015.0,36,26,10
IT,CZ,2019.0,43,30,13
IN,IE,2014.0,22,32,-10
PL,IE,2018.0,7,4,3
TN,KW,2023.0,1,1,0
RU,GE,2018.0,6,4,2
PK,RU,2019.0,9,13,-4
TR,BA,2018.0,5,4,1
NZ,CA,2014.0,76,66,10
BE,RW,2020.0,5,2,3
GH,BH,2019.0,29,21,8
NZ,BE,2010.0,5,4,1
BR,JP,2006.0,37,39,-2
PT,US,2022.0,118,123,-5
nan,AU,2021.0,22,20,2
EE,GB,2013.0,9,5,4
TN,FR,2007.0,112,141,-29
IN,AU,2012.0,131,115,16
CO,ES,1999.0,45,31,14
BR,BE,2020.0,68,94,-26
ES,CU,2013.0,91,125,-34
DK,NO,2021.0,87,119,-32
IR,IT,2017.0,41,24,17
RU,CN,2008.0,74,32,42
IR,DK,2017.0,19,13,6
SE,GB,2017.0,190,226,-36
PL,AU,2019.0,23,10,13
PL,GB,1997.0,22,21,1
IT,CN,2021.0,62,47,15
VE,ES,2018.0,75,53,22
BN,PK,2021.0,3,1,2
AU,NL,2001.0,30,31,-1
FR,BG,2011.0,14,11,3
US,TH,2023.0,6,6,0
AU,IT,2014.0,42,62,-20
GB,NG,2008.0,18,22,-4
US,LY,2019.0,10,4,6
CH,SE,2020.0,120,64,56
FI,DE,2022.0,34,44,-10
BJ,FR,2010.0,33,32,1
nan,NL,2021.0,65,55,10
JP,AT,2008.0,13,18,-5
IR,PT,2014.0,10,5,5
GH,ID,2019.0,12,14,-2
KE,CN,2016.0,7,12,-5
PL,NL,2011.0,25,27,-2
BE,GB,2002.0,67,54,13
GB,GE,2017.0,5,7,-2
AR,FR,2000.0,21,20,1
BD,PL,2009.0,4,1,3
US,LU,2017.0,29,25,4
DK,ES,2003.0,21,16,5
FR,HU,2010.0,12,22,-10
MQ,GP,2014.0,1,1,0
UY,BR,2011.0,50,33,17
NL,CW,1998.0,4,5,-1
HU,LU,2020.0,1,2,-1
BG,IT,1999.0,8,10,-2
BA,HR,2011.0,21,27,-6
FI,JP,2006.0,13,11,2
CA,PH,1997.0,3,2,1
HR,AT,2003.0,4,2,2
CU,PE,2015.0,17,15,2
JP,KH,2016.0,5,4,1
EG,CA,2022.0,46,53,-7
BR,PA,2018.0,7,5,2
NL,PT,2021.0,17,27,-10
GB,MK,2011.0,7,2,5
IR,DK,2019.0,39,13,26
PT,AR,2021.0,14,15,-1
PS,AT,2014.0,2,1,1
LB,EG,2015.0,17,13,4
SE,IE,2020.0,12,13,-1
IE,FI,2022.0,4,3,1
SE,TZ,2022.0,7,2,5
ES,IT,1997.0,39,36,3
RS,TR,2015.0,105,54,51
CN,GH,2016.0,15,19,-4
IN,JP,2015.0,104,159,-55
CL,CO,2011.0,156,155,1
CZ,SK,2016.0,103,160,-57
MX,CR,2004.0,7,10,-3
JM,DE,2012.0,1,1,0
BJ,FR,2017.0,17,32,-15
RO,US,2014.0,64,94,-30
TW,GR,2011.0,4,2,2
BO,CO,2012.0,12,5,7
NO,ES,2021.0,24,25,-1
IL,GB,1999.0,30,23,7
SA,TN,2011.0,8,19,-11
BD,PK,2012.0,33,26,7
ZA,ES,2017.0,7,18,-11
CN,ZA,2014.0,12,12,0
LK,US,2019.0,33,53,-20
BD,IL,2022.0,2,3,-1
TR,ID,2014.0,5,3,2
IT,CZ,2017.0,34,30,4
AU,NP,2011.0,3,6,-3
PL,AU,2010.0,15,10,5
CY,IT,2011.0,2,2,0
SE,BE,2017.0,28,34,-6
KR,AU,2020.0,64,43,21
SG,IT,2005.0,2,1,1
KR,RU,2004.0,7,8,-1
nan,FI,2008.0,13,8,5
NL,IL,2016.0,14,15,-1
RS,DE,2009.0,13,21,-8
GB,GE,2019.0,7,7,0
PT,MX,2018.0,17,21,-4
ES,LU,2020.0,12,8,4
AT,NL,2013.0,28,22,6
US,LU,2019.0,28,17,11
KH,FR,2010.0,6,7,-1
UA,TR,1997.0,1,2,-1
IN,ES,2015.0,25,24,1
FI,AU,2015.0,22,15,7
CH,PT,2008.0,9,9,0
RU,PT,2006.0,12,5,7
nan,RU,2007.0,35,51,-16
IN,BR,2000.0,7,5,2
CA,NO,2021.0,22,17,5
MX,DE,2017.0,50,40,10
GH,BH,2017.0,25,15,10
IN,CN,2023.0,12,9,3
GR,CY,2013.0,68,22,46
KR,PR,1997.0,10,16,-6
US,GD,2010.0,9,6,3
US,BH,2008.0,9,11,-2
BE,PL,2003.0,15,12,3
CN,QA,2020.0,31,37,-6
LB,BR,2021.0,11,3,8
AE,JO,2020.0,19,30,-11
IE,CH,2020.0,14,20,-6
BE,SE,2022.0,11,21,-10
OM,AE,2019.0,15,10,5
nan,ZA,2010.0,10,6,4
IL,CA,2019.0,47,73,-26
GT,MX,2014.0,13,9,4
ES,IT,1998.0,47,60,-13
AU,DK,2004.0,14,25,-11
BY,CZ,2013.0,7,22,-15
KH,FR,2019.0,10,11,-1
SI,nan,2004.0,1,1,0
FR,IL,2004.0,30,25,5
EC,CO,2007.0,5,4,1
IT,MT,2012.0,4,1,3
BD,DE,2015.0,10,8,2
SG,ET,2021.0,1,2,-1
DZ,FR,2002.0,17,28,-11
GH,AU,2022.0,12,13,-1
MX,ET,2017.0,2,5,-3
NG,EG,2020.0,6,10,-4
ID,US,2005.0,22,29,-7
EG,CN,2011.0,18,13,5
NL,PK,2016.0,7,10,-3
ZA,NL,2002.0,18,13,5
IL,NL,2000.0,11,7,4
GB,EC,2010.0,4,1,3
DK,DZ,2019.0,2,1,1
DZ,SA,2022.0,3,6,-3
US,GD,2019.0,22,29,-7
NG,UG,2019.0,13,7,6
UA,PK,2020.0,5,2,3
CA,CO,2019.0,35,28,7
VN,US,2009.0,21,38,-17
BE,CH,1997.0,17,18,-1
PH,ES,2018.0,18,28,-10
GB,NL,2023.0,23,10,13
FR,GR,2020.0,31,45,-14
BW,GH,2021.0,2,1,1
KE,SE,2012.0,5,8,-3
BE,CH,1998.0,19,22,-3
CO,CN,2018.0,5,4,1
BR,NZ,2017.0,13,1,12
ZA,CD,2021.0,1,2,-1
MA,IN,2015.0,3,3,0
DE,EC,2018.0,12,6,6
BE,PE,2021.0,3,3,0
OM,MY,2022.0,6,11,-5
FI,TR,2021.0,11,12,-1
DZ,ES,2021.0,7,4,3
QA,FR,2018.0,9,9,0
CU,CR,1999.0,2,1,1
ES,CH,2007.0,37,65,-28
PA,CO,2013.0,14,9,5
SI,FR,2014.0,8,8,0
ZA,ES,2019.0,17,7,10
MY,GB,2005.0,33,52,-19
RU,MX,2020.0,9,12,-3
NL,IR,2011.0,20,31,-11
SA,CA,2012.0,36,92,-56
ZA,AT,2004.0,3,1,2
NC,FR,2016.0,11,23,-12
GR,AU,2015.0,15,3,12
TH,JP,2014.0,51,88,-37
DK,FR,2010.0,22,32,-10
SA,ES,2006.0,2,1,1
FR,OM,2010.0,3,2,1
GB,MW,2014.0,13,15,-2
ZA,NL,2005.0,26,20,6
CZ,FR,2011.0,29,45,-16
AT,CN,2011.0,11,16,-5
KH,TH,2018.0,2,5,-3
US,MT,2015.0,11,4,7
NO,IL,2019.0,3,5,-2
KW,EG,2004.0,10,10,0
GR,HU,2010.0,3,1,2
ID,PE,2021.0,5,5,0
nan,DE,2013.0,84,81,3
NL,MY,2007.0,5,4,1
SI,RS,2013.0,18,16,2
FR,PK,2000.0,5,1,4
CZ,IN,2003.0,8,9,-1
BE,RO,2004.0,5,9,-4
GR,AE,2015.0,3,2,1
UA,HU,2005.0,2,1,1
AU,MK,2013.0,55,55,0
US,ML,2004.0,7,2,5
SI,HU,2015.0,2,2,0
EE,DE,2007.0,19,30,-11
ES,CA,2007.0,48,61,-13
JP,SI,2004.0,5,1,4
DZ,CA,2018.0,21,16,5
GB,GD,2021.0,3,3,0
EC,UA,2010.0,16,13,3
IS,DE,2019.0,6,5,1
GB,EC,2017.0,13,3,10
RS,FR,2011.0,8,6,2
nan,UA,2004.0,10,7,3
PK,OM,2017.0,7,12,-5
PK,UA,2009.0,1,1,0
SN,US,2022.0,3,5,-2
nan,DK,2009.0,24,17,7
BE,TZ,2012.0,3,4,-1
EG,FR,2018.0,21,47,-26
CG,NC,2009.0,1,1,0
GH,GB,2017.0,19,34,-15
IE,GH,2019.0,3,1,2
CL,FR,2007.0,33,28,5
AU,SA,2016.0,47,29,18
GR,nan,2007.0,1,2,-1
FI,IT,2002.0,6,9,-3
CN,ET,2002.0,3,1,2
NO,IL,2017.0,6,1,5
CA,SE,1998.0,26,20,6
RO,IT,2008.0,10,17,-7
PL,AU,2017.0,15,21,-6
CA,NG,2020.0,15,34,-19
KE,JP,2018.0,9,12,-3
BE,IL,1997.0,8,5,3
DE,HR,2000.0,18,8,10
GM,GB,1997.0,3,6,-3
IT,AM,2000.0,4,2,2
FR,PT,1999.0,26,14,12
GB,GM,2003.0,10,7,3
SG,nan,2014.0,11,9,2
AU,IE,2009.0,82,71,11
IT,BG,2012.0,4,10,-6
HR,DE,2006.0,17,13,4
RS,CZ,2009.0,17,13,4
CA,DZ,2014.0,11,7,4
KW,MA,2012.0,5,8,-3
CH,IL,2015.0,11,19,-8
HU,RO,2012.0,29,27,2
NO,RU,2021.0,14,25,-11
IN,CA,2023.0,11,2,9
KR,IL,2011.0,6,4,2
LK,CN,2015.0,5,5,0
KR,IE,2004.0,3,5,-2
DK,MX,2011.0,3,2,1
FR,LU,2008.0,25,12,13
ES,QA,2017.0,12,5,7
SG,CA,2001.0,19,18,1
VE,DO,2006.0,1,1,0
CA,HK,2018.0,6,4,2
CL,PT,2008.0,7,8,-1
FI,TW,2010.0,2,4,-2
AE,US,1999.0,13,14,-1
BB,GB,2019.0,3,3,0
CU,BR,2017.0,40,22,18
IT,GR,2020.0,24,34,-10
PL,IN,1998.0,2,1,1
CA,CO,2017.0,33,33,0
SE,IR,2002.0,3,1,2
CA,PK,1997.0,1,2,-1
NZ,FI,2015.0,5,3,2
AU,JO,2009.0,7,2,5
IT,SG,2020.0,5,6,-1
RS,PT,2011.0,2,2,0
AU,UA,2000.0,2,2,0
JP,NP,2007.0,8,6,2
NL,TW,2012.0,8,7,1
SE,ES,2016.0,50,93,-43
RO,BR,2004.0,1,2,-1
CL,CU,2013.0,10,23,-13
SE,BR,2001.0,12,9,3
FI,NO,2008.0,21,9,12
PE,BR,2012.0,32,38,-6
EG,SE,1999.0,1,2,-1
US,KZ,2018.0,13,16,-3
ES,TH,2019.0,4,7,-3
FR,NO,2011.0,44,59,-15
nan,CZ,2006.0,4,6,-2
US,ID,2008.0,50,39,11
UA,DK,2007.0,1,1,0
MX,NL,2010.0,12,4,8
FR,HU,2019.0,30,16,14
FR,EG,2001.0,5,5,0
LB,SA,2009.0,5,2,3
VN,CH,2019.0,2,6,-4
PK,OM,2019.0,18,13,5
SA,GB,2007.0,21,31,-10
IT,RO,2006.0,9,10,-1
UA,IT,2002.0,8,7,1
US,RE,2014.0,3,4,-1
PL,SG,2019.0,7,3,4
NL,NP,2014.0,5,2,3
AU,PH,2011.0,10,12,-2
RO,IE,2021.0,1,3,-2
AT,NO,2007.0,6,2,4
GA,FR,2013.0,8,12,-4
GR,NO,2008.0,4,6,-2
RU,TW,2020.0,15,9,6
PH,CN,2005.0,18,11,7
SG,KR,2000.0,5,12,-7
CN,IL,2006.0,16,19,-3
AE,CN,2016.0,5,10,-5
FI,UA,2012.0,3,5,-2
PH,NL,2022.0,2,3,-1
DK,FI,1997.0,2,2,0
MK,RS,2018.0,5,4,1
US,BB,2007.0,3,2,1
SG,EG,2019.0,5,2,3
MX,NL,2017.0,17,19,-2
TR,KR,2007.0,4,3,1
DE,PT,2022.0,25,25,0
FI,NL,2020.0,42,21,21
BR,NZ,2010.0,10,5,5
ID,DK,2018.0,1,2,-1
CO,PK,2015.0,1,1,0
EG,ET,2018.0,11,4,7
BE,MD,2008.0,4,1,3
CA,EC,2021.0,10,6,4
AL,IT,2022.0,4,1,3
MG,FR,2004.0,2,4,-2
PT,CZ,2017.0,3,1,2
US,GD,2017.0,17,17,0
JP,IE,2021.0,14,27,-13
EG,BR,2019.0,3,8,-5
BI,FR,2022.0,16,20,-4
GB,ZW,2020.0,11,12,-1
MY,LY,2018.0,18,1,17
MK,AT,2015.0,14,5,9
IN,NP,2003.0,15,9,6
CD,CH,2018.0,2,1,1
AT,SE,2008.0,13,15,-2
ZA,SZ,2013.0,2,4,-2
US,CZ,2000.0,47,67,-20
PY,PT,2005.0,3,1,2
CO,DE,2007.0,12,15,-3
ES,PH,2005.0,8,4,4
UY,CO,2011.0,10,7,3
NG,CG,2018.0,1,2,-1
IT,DZ,2007.0,4,9,-5
CN,BY,2008.0,3,4,-1
PE,PA,2018.0,5,2,3
OM,IQ,2014.0,2,3,-1
QA,SD,2020.0,3,5,-2
NZ,PL,2019.0,2,4,-2
MX,VE,2000.0,11,9,2
AE,MY,2002.0,2,3,-1
US,ZA,2023.0,15,15,0
BD,NP,2020.0,3,2,1
HU,PL,2006.0,19,11,8
ES,EG,2013.0,5,4,1
CZ,LT,2005.0,3,4,-1
NO,IN,2006.0,19,21,-2
PA,DE,2011.0,4,5,-1
JP,TR,2013.0,18,35,-17
AL,TR,2013.0,2,5,-3
GM,GB,1998.0,6,3,3
US,KG,2007.0,1,1,0
BR,NL,2005.0,18,14,4
ID,US,2002.0,15,14,1
DK,JP,2006.0,13,16,-3
BE,CZ,2011.0,9,11,-2
DE,TH,2008.0,14,5,9
NL,AE,2016.0,7,4,3
JP,FI,2016.0,20,15,5
AR,SE,2001.0,4,2,2
IR,DK,2010.0,13,7,6
IT,ET,2016.0,4,8,-4
GH,SE,2013.0,2,2,0
IQ,FR,2019.0,4,14,-10
US,LT,2012.0,17,6,11
TH,AU,2008.0,12,27,-15
KR,BE,2015.0,9,16,-7
EG,JO,2020.0,24,28,-4
TT,JM,2022.0,11,7,4
UZ,KZ,2012.0,2,4,-2
IT,NG,2008.0,3,6,-3
AR,BE,2002.0,4,1,3
IL,MY,2019.0,3,4,-1
BE,TN,2016.0,9,1,8
PL,LV,2014.0,2,3,-1
EG,BH,2011.0,3,4,-1
LY,MY,2018.0,1,18,-17
BE,IL,1998.0,4,6,-2
SE,IR,2005.0,11,5,6
NO,MW,2016.0,4,1,3
BR,nan,2006.0,43,62,-19
US,AF,2017.0,5,5,0
US,BG,2002.0,13,34,-21
IN,MY,2004.0,30,15,15
PK,TR,2020.0,14,19,-5
DO,MX,2013.0,2,4,-2
nan,TR,2014.0,16,22,-6
SA,BE,2018.0,3,3,0
KR,PR,1998.0,14,19,-5
DE,KW,2010.0,2,3,-1
DE,UA,2003.0,16,29,-13
FI,LU,2009.0,5,4,1
CA,BJ,2011.0,1,1,0
AZ,IT,2014.0,2,5,-3
BR,NO,1999.0,3,5,-2
TT,CA,2010.0,2,2,0
GH,GB,2010.0,5,13,-8
MA,SA,2012.0,3,5,-2
VE,PL,2003.0,2,1,1
NO,NZ,2019.0,6,4,2
HU,RS,2011.0,11,5,6
CZ,NL,2009.0,8,12,-4
JP,AM,2002.0,7,6,1
AU,IL,2008.0,10,13,-3
PH,KR,2015.0,6,8,-2
ID,MK,2015.0,3,5,-2
MY,CH,2021.0,2,4,-2
US,UY,2000.0,7,5,2
AT,CL,2012.0,4,3,1
FR,PE,2011.0,8,2,6
IS,DE,2010.0,6,8,-2
NG,TR,2010.0,2,1,1
NG,TR,2019.0,7,5,2
PL,GB,1998.0,16,29,-13
PT,PE,2021.0,4,6,-2
JP,MD,2000.0,1,1,0
SA,CH,2019.0,10,7,3
ZM,BR,2008.0,2,2,0
NP,JP,2005.0,5,4,1
ES,IL,2021.0,10,14,-4
US,GH,2022.0,28,33,-5
IT,UY,2016.0,9,12,-3
SE,PT,2009.0,4,6,-2
SI,RU,2015.0,7,1,6
AU,MY,2001.0,5,7,-2
ES,BD,2015.0,17,12,5
ES,QA,2010.0,7,3,4
NZ,ZA,2020.0,17,26,-9
EG,NL,1998.0,6,2,4
HU,SE,2007.0,20,7,13
RO,AT,2014.0,9,5,4
MX,IN,2005.0,10,5,5
NZ,BE,2019.0,15,5,10
DE,MA,2006.0,3,5,-2
IN,HU,1998.0,7,5,2
US,BI,1998.0,1,2,-1
PE,AU,2019.0,5,7,-2
GB,PE,2023.0,2,1,1
NO,IL,2010.0,4,1,3
RU,EE,2022.0,9,4,5
IT,PL,2004.0,8,7,1
IN,OM,2003.0,3,4,-1
IT,TW,2009.0,5,2,3
CA,CO,2010.0,10,13,-3
BR,UA,2001.0,4,4,0
TN,ID,2016.0,3,2,1
US,NC,2020.0,3,2,1
MZ,PT,2009.0,4,3,1
BJ,FR,2019.0,26,33,-7
FR,DK,2023.0,4,1,3
UZ,CZ,2003.0,4,2,2
SG,QA,2017.0,7,2,5
PH,PE,2013.0,5,4,1
DK,BG,2004.0,2,6,-4
MX,AF,2011.0,6,3,3
IT,CZ,2010.0,25,15,10
DZ,RU,2018.0,1,3,-2
LB,FR,2009.0,21,49,-28
CA,PH,1998.0,3,4,-1
FR,SI,2007.0,4,6,-2
TW,CH,2020.0,8,5,3
DE,NG,2007.0,7,6,1
JE,GB,2018.0,1,1,0
FI,IT,2005.0,11,14,-3
ZA,PH,2018.0,2,1,1
FR,MY,2018.0,13,9,4
MA,NE,2019.0,2,1,1
CO,IN,2019.0,6,4,2
TR,MY,2011.0,9,1,8
BR,DK,2006.0,7,4,3
VE,EC,2013.0,6,4,2
DE,UZ,2001.0,1,1,0
BG,NO,2014.0,4,4,0
SE,CZ,2019.0,24,25,-1
JP,KE,2013.0,7,1,6
UY,US,2008.0,14,19,-5
BD,MA,2020.0,15,11,4
SE,CZ,2010.0,11,4,7
PT,nan,2004.0,7,7,0
RS,ME,2009.0,8,4,4
SD,AE,2013.0,2,1,1
NG,TR,2017.0,2,6,-4
KW,BD,2003.0,1,2,-1
IN,CL,2017.0,10,6,4
IN,CL,2019.0,12,4,8
SE,CZ,2017.0,13,22,-9
IN,KE,2021.0,10,6,4
SE,BD,2008.0,2,6,-4
CR,PE,2018.0,11,12,-1
GR,IL,2016.0,2,4,-2
ID,nan,2012.0,5,10,-5
PK,PL,2008.0,1,6,-5
RO,PL,2017.0,7,9,-2
MA,ML,2018.0,4,1,3
EC,CR,2021.0,12,12,0
RW,CN,2022.0,2,2,0
RU,PL,2001.0,7,17,-10
AU,ID,2002.0,10,6,4
BG,BE,2001.0,4,4,0
LU,CN,2013.0,4,2,2
AR,NZ,2008.0,1,1,0
RU,FI,2011.0,15,14,1
SK,AT,2022.0,7,5,2
RU,NO,2014.0,12,19,-7
SI,IE,2021.0,1,2,-1
PA,US,2009.0,23,39,-16
MX,HN,2000.0,9,6,3
MZ,US,2004.0,1,1,0
GE,GB,2011.0,6,4,2
AU,AR,2005.0,4,3,1
NZ,NL,2009.0,4,12,-8
PK,CA,2000.0,4,2,2
CH,TH,2018.0,6,2,4
JP,MN,2012.0,7,4,3
MY,BE,2010.0,3,3,0
SA,GH,2015.0,2,1,1
PT,AU,2018.0,18,12,6
CR,DE,2007.0,1,2,-1
FR,CR,2001.0,2,2,0
AU,RO,2006.0,2,1,1
KE,UG,2012.0,5,4,1
AR,NL,2007.0,4,2,2
BR,HR,2020.0,4,3,1
AU,HU,2001.0,4,9,-5
TG,TR,2006.0,2,2,0
ES,TZ,2002.0,1,2,-1
PK,TN,2011.0,2,2,0
DE,GR,2023.0,3,6,-3
GB,IS,2016.0,4,9,-5
IT,TN,2022.0,12,12,0
TW,IT,2018.0,4,5,-1
DE,GA,2012.0,5,3,2
PA,CR,2022.0,2,1,1
IQ,SY,2019.0,9,1,8
nan,SI,2020.0,9,4,5
NO,NZ,2017.0,1,4,-3
IL,MX,2009.0,4,4,0
KE,GB,2000.0,8,9,-1
CH,ML,2009.0,1,1,0
KR,PT,2010.0,5,3,2
CU,DE,2009.0,4,1,3
NI,ES,2011.0,4,6,-2
PK,AE,2004.0,1,3,-2
UA,KZ,2018.0,4,9,-5
DE,PH,2020.0,10,17,-7
KW,US,2004.0,7,19,-12
US,LY,2017.0,5,3,2
TR,nan,2023.0,1,1,0
SA,CH,2017.0,5,6,-1
VG,RU,2011.0,1,1,0
CR,EC,2013.0,2,3,-1
ST,BR,2003.0,7,13,-6
BE,ET,2020.0,14,10,4
nan,AE,2017.0,3,1,2
RE,US,2017.0,6,5,1
GR,FI,2022.0,3,2,1
PH,BR,2014.0,5,4,1
ZW,RU,2021.0,9,47,-38
TR,RU,2009.0,3,8,-5
nan,GH,2019.0,6,5,1
PT,AO,2022.0,4,3,1
EG,BR,2017.0,3,5,-2
MX,PA,2006.0,4,2,2
MU,US,2008.0,2,1,1
SG,CH,1997.0,1,1,0
MX,BA,2008.0,2,1,1
ZA,nan,2022.0,2,4,-2
FR,IR,2000.0,3,2,1
NL,SA,2020.0,5,6,-1
LB,IT,2021.0,14,13,1
NG,BF,2021.0,3,2,1
GT,AR,2020.0,2,4,-2
EG,SG,2020.0,6,2,4
MY,BE,2017.0,8,9,-1
VE,CR,2012.0,7,5,2
SI,NO,2012.0,4,2,2
FR,BY,2012.0,4,1,3
NL,FI,2001.0,16,13,3
ZA,IN,2004.0,8,10,-2
MT,ES,2011.0,7,3,4
DZ,KR,2020.0,3,1,2
US,MY,2023.0,5,8,-3
SA,KW,2012.0,2,12,-10
DE,RO,2001.0,8,23,-15
PE,HU,2020.0,3,1,2
AT,TR,2004.0,3,4,-1
RO,CZ,2009.0,10,1,9
JM,GB,1998.0,3,2,1
FI,CH,2000.0,5,8,-3
VN,CZ,1998.0,1,2,-1
BA,CZ,2008.0,1,1,0
JP,EC,2020.0,3,1,2
PY,AR,2022.0,5,6,-1
TR,TW,1998.0,5,1,4
PE,PH,2015.0,1,3,-2
GB,DZ,2020.0,7,10,-3
MD,US,2001.0,2,2,0
PK,NG,2020.0,9,5,4
RO,IQ,2020.0,2,1,1
NZ,BW,2005.0,1,1,0
PE,FR,2021.0,6,8,-2
NG,UG,2017.0,6,3,3
EG,BN,2019.0,3,3,0
IT,BF,2019.0,4,1,3
CD,US,2018.0,5,4,1
GB,NP,2011.0,6,7,-1
SN,CN,2018.0,2,1,1
GH,TR,2021.0,2,1,1
LV,EE,2014.0,2,2,0
VE,CO,2005.0,10,7,3
MX,IN,2002.0,8,7,1
CM,CN,2015.0,4,2,2
GB,IR,2023.0,2,4,-2
CN,GR,2016.0,8,7,1
IL,PL,2011.0,2,3,-1
BE,SK,2018.0,2,2,0
BB,GB,2010.0,2,3,-1
BG,LT,2010.0,1,1,0
AE,MY,2005.0,2,2,0
BG,DK,2017.0,2,1,1
AE,IN,2012.0,10,15,-5
ZM,GH,2005.0,5,2,3
SJ,NO,1998.0,3,3,0
GA,AT,2007.0,2,1,1
BG,DK,2019.0,3,3,0
BD,LK,2009.0,1,1,0
BH,SA,2013.0,3,3,0
HN,ES,2015.0,13,11,2
SG,PH,2017.0,9,17,-8
AU,NA,2012.0,2,1,1
PK,RU,2017.0,8,6,2
DK,CO,2009.0,1,2,-1
NZ,ES,2015.0,4,4,0
LA,US,2018.0,1,3,-2
CO,FR,2008.0,13,22,-9
KR,NL,2004.0,5,3,2
BO,IR,2019.0,3,2,1
CA,ID,2000.0,3,1,2
ES,PH,2002.0,4,3,1
CZ,CA,1998.0,5,5,0
ZM,KE,2019.0,3,8,-5
PA,KR,2014.0,1,6,-5
CN,CR,2012.0,4,4,0
IT,BD,2013.0,5,5,0
PT,BG,2015.0,2,1,1
DE,MD,2018.0,3,3,0
CO,HU,2017.0,1,1,0
GR,QA,2011.0,1,1,0
NZ,BE,2017.0,5,6,-1
SN,CF,2016.0,1,1,0
CH,RO,2014.0,7,14,-7
TR,AT,2000.0,9,4,5
CL,FI,2014.0,10,4,6
ZA,MW,2013.0,1,2,-1
VN,CH,2017.0,2,8,-6
AE,IR,2017.0,5,7,-2
MX,PL,1998.0,2,1,1
NG,FR,2021.0,7,9,-2
SG,PL,2020.0,4,1,3
ET,NG,2019.0,10,15,-5
nan,HU,2018.0,3,4,-1
JP,UZ,2018.0,2,1,1
KZ,RU,2023.0,1,2,-1
TH,SE,2008.0,6,4,2
AE,KZ,2013.0,2,2,0
JP,CY,2006.0,2,2,0
NO,NZ,2010.0,2,6,-4
IL,BG,2017.0,1,2,-1
ET,ES,2017.0,3,1,2
TZ,ET,2021.0,3,1,2
DE,LV,2012.0,1,1,0
ES,KR,2014.0,8,7,1
TH,LA,2017.0,4,2,2
PH,CN,2002.0,10,14,-4
PT,FI,2005.0,3,3,0
HU,ES,2003.0,5,3,2
SK,IN,2020.0,2,5,-3
KW,OM,2012.0,2,1,1
NL,BD,2013.0,5,4,1
TH,LA,2019.0,8,2,6
KR,KH,2014.0,2,1,1
PT,UY,2011.0,1,2,-1
NP,JP,2002.0,2,4,-2
SG,PH,2010.0,3,4,-1
RS,DK,2003.0,3,2,1
PT,PA,2014.0,2,1,1
JP,AM,2005.0,5,6,-1
DE,GM,2001.0,1,1,0
RO,PL,2010.0,10,7,3
MM,SG,2012.0,2,1,1
HR,SK,2008.0,1,2,-1
MA,US,2004.0,10,11,-1
CZ,CA,1997.0,2,4,-2
IE,MX,2016.0,2,1,1
UZ,PK,2007.0,1,1,0
JP,QA,2016.0,4,4,0
PT,CZ,2019.0,3,4,-1
HR,IE,2008.0,3,2,1
MX,MY,2012.0,2,1,1
PT,SA,2021.0,2,2,0
BD,TW,2018.0,3,2,1
PT,MZ,2020.0,4,6,-2
IQ,SE,2021.0,3,3,0
TZ,CM,2020.0,1,1,0
IE,EG,2022.0,3,6,-3
MA,GA,2019.0,1,2,-1
nan,ZA,2017.0,7,5,2
ES,QA,2019.0,4,10,-6
ZA,UG,2005.0,4,2,2
US,SJ,2015.0,3,2,1
IS,FI,2019.0,1,2,-1
GB,BY,1998.0,1,2,-1
GR,HU,2019.0,3,3,0
IQ,CY,2020.0,3,2,1
GR,HU,2017.0,7,1,6
MY,TZ,2020.0,5,1,4
HU,QA,2013.0,2,1,1
GR,DK,2000.0,1,3,-2
BG,CA,2003.0,10,1,9
GE,RU,1998.0,3,1,2
FI,RO,2016.0,2,3,-1
OM,EG,2007.0,1,2,-1
DK,FI,1998.0,4,12,-8
FR,LT,2020.0,3,5,-2
HU,BG,2017.0,1,1,0
BG,HU,2018.0,1,1,0
CH,MX,1999.0,1,1,0
TR,GR,2001.0,3,5,-2
ZA,BD,2020.0,2,2,0
EE,US,2001.0,8,4,4
HU,NO,2005.0,3,1,2
EE,PK,2021.0,3,1,2
NL,OM,2009.0,1,3,-2
UY,VE,2013.0,2,4,-2
QA,SG,2021.0,3,3,0
TW,TR,2000.0,3,2,1
PK,AU,2003.0,5,3,2
JP,MX,1998.0,2,1,1
GB,VN,2002.0,4,7,-3
NZ,UG,2008.0,2,4,-2
IN,TR,2006.0,2,7,-5
UG,CD,2022.0,1,1,0
BE,GR,2023.0,2,1,1
BE,UG,2014.0,7,7,0
AT,ET,2017.0,2,1,1
AR,TW,2013.0,8,13,-5
HU,UA,2005.0,1,2,-1
EE,CA,2022.0,3,3,0
UA,IR,2016.0,2,1,1
EE,IN,2006.0,1,5,-4
PK,RU,2010.0,1,1,0
IE,IL,2013.0,2,3,-1
CH,LI,2013.0,2,1,1
JP,CO,2000.0,4,5,-1
BN,US,2018.0,3,6,-3
BR,CU,2000.0,2,7,-5
EG,nan,2019.0,8,11,-3
IE,KR,2018.0,3,6,-3
PS,JO,2015.0,3,4,-1
PS,CA,2016.0,1,4,-3
UG,GB,2008.0,4,10,-6
LK,MY,2021.0,2,4,-2
NG,GH,2022.0,6,2,4
BD,SE,2005.0,1,3,-2
BZ,US,2021.0,1,2,-1
CZ,VN,2004.0,1,1,0
AE,ID,2022.0,1,2,-1
SY,TR,2021.0,2,2,0
AR,CH,2010.0,8,10,-2
FR,PS,2008.0,1,2,-1
NG,AU,2009.0,3,2,1
SE,KP,2000.0,1,6,-5
BB,JM,2016.0,5,8,-3
FI,TW,2017.0,2,1,1
CW,IN,2017.0,1,1,0
BR,CR,2012.0,8,10,-2
RE,US,2010.0,2,4,-2
SG,QA,2019.0,5,1,4
ET,ES,2010.0,1,1,0
BD,CA,2007.0,4,13,-9
UA,UZ,2009.0,4,2,2
PT,CL,2012.0,3,17,-14
NZ,BN,2017.0,1,1,0
PL,BG,2018.0,4,2,2
IE,GR,2015.0,5,6,-1
CN,BD,2023.0,1,3,-2
CH,BG,2009.0,4,1,3
SG,SK,2000.0,1,2,-1
GB,CY,2023.0,1,2,-1
HR,NO,2014.0,1,1,0
HR,ES,2020.0,4,5,-1
nan,GH,2010.0,2,1,1
NG,UG,2010.0,5,2,3
NG,CM,2004.0,2,3,-1
DZ,AE,2018.0,2,1,1
IR,RU,2011.0,7,10,-3
AU,SI,2011.0,1,2,-1
DK,HR,2007.0,2,1,1
AT,VN,2009.0,2,1,1
IQ,NZ,2017.0,1,2,-1
FI,KZ,2006.0,1,1,0
MA,AE,2022.0,6,1,5
TR,NL,2023.0,2,1,1
KE,US,2023.0,2,3,-1
SK,HU,2022.0,7,9,-2
IS,DE,2017.0,3,5,-2
MX,PK,2008.0,4,1,3
ID,LK,2021.0,4,7,-3
CL,BE,2014.0,7,16,-9
VN,EG,2016.0,1,1,0
HR,CH,2007.0,2,4,-2
BA,TR,2018.0,4,5,-1
UA,MZ,2020.0,3,5,-2
PT,RO,2001.0,1,1,0
NG,HU,2018.0,3,1,2
ES,MZ,2007.0,1,1,0
CG,US,2020.0,4,3,1
BY,nan,2019.0,3,2,1
EE,IE,2020.0,2,1,1
KE,NL,2007.0,2,4,-2
nan,EC,2016.0,1,4,-3
SY,SA,2011.0,1,1,0
nan,GH,2017.0,5,5,0
IT,CM,2011.0,4,3,1
ZA,NA,2007.0,2,3,-1
US,TZ,2004.0,3,4,-1
CZ,RO,2009.0,1,10,-9
SG,MX,2007.0,3,4,-1
JP,MX,1997.0,3,5,-2
MY,LB,2013.0,1,2,-1
LU,DK,2014.0,3,5,-2
LV,SE,2012.0,3,1,2
TR,KW,2011.0,2,4,-2
CW,NL,1999.0,5,2,3
UA,NI,2013.0,1,1,0
PE,AU,2017.0,3,3,0
BD,SG,2014.0,1,5,-4
HR,PT,2015.0,1,1,0
RU,EC,2017.0,3,12,-9
MA,DE,2003.0,2,4,-2
ML,IN,2016.0,4,3,1
IT,DO,2016.0,2,6,-4
FR,KW,2011.0,4,2,2
ZA,ES,2010.0,3,9,-6
IL,PT,2009.0,2,3,-1
BO,BR,2013.0,3,3,0
LB,IN,2015.0,3,3,0
UY,CL,1999.0,1,2,-1
IN,HU,1997.0,3,2,1
NL,SI,1997.0,1,2,-1
BR,IE,2015.0,3,11,-8
HR,BE,2014.0,2,1,1
GB,GT,2020.0,1,3,-2
IL,RO,2016.0,1,2,-1
IQ,DE,2012.0,1,5,-4
MA,NE,2017.0,3,1,2
VE,AR,2004.0,6,11,-5
AR,PH,2016.0,1,1,0
CI,BE,2004.0,1,2,-1
AU,AR,2002.0,2,1,1
AU,BN,2020.0,1,3,-2
CU,GB,2002.0,1,2,-1
TW,PA,2013.0,1,2,-1
JP,SD,2021.0,1,2,-1
PL,MX,2008.0,1,5,-4
PL,EG,2016.0,3,2,1
TR,TW,1997.0,3,1,2
KR,BD,2006.0,3,4,-1
RO,NG,2015.0,1,1,0
KR,PT,2019.0,3,2,1
ID,PA,2021.0,3,1,2
AU,PE,2013.0,1,5,-4
IS,FI,2017.0,1,2,-1
CH,SK,2006.0,4,5,-1
US,AF,2019.0,4,3,1
EG,DK,2004.0,3,2,1
ZW,GB,2004.0,2,3,-1
VE,UY,2021.0,1,1,0
US,KW,2023.0,2,1,1
JP,AE,2021.0,1,1,0
BJ,GB,2012.0,3,1,2
TZ,KE,2012.0,4,3,1
NZ,VN,2014.0,2,3,-1
UA,AZ,2008.0,1,2,-1
SD,DE,2014.0,1,4,-3
SA,GR,2022.0,1,4,-3
US,BZ,2016.0,1,2,-1
CH,NZ,2004.0,3,6,-3
PE,CH,2013.0,1,3,-2
KH,CY,2019.0,1,3,-2
ZW,BH,2006.0,1,1,0
GB,FK,2008.0,2,1,1
CH,CU,2003.0,1,4,-3
AR,AT,2004.0,2,1,1
VE,BE,2020.0,3,1,2
RU,VG,2011.0,1,1,0
UA,TR,1998.0,1,1,0
LU,CZ,2017.0,1,1,0
SK,NO,2015.0,1,1,0
EG,KE,2020.0,1,1,0
MX,ET,2019.0,4,1,3
SI,NL,2013.0,3,3,0
BB,US,2014.0,5,3,2
KZ,GB,2008.0,2,1,1
CG,CH,2017.0,3,4,-1
MX,SV,2021.0,2,2,0
IN,TT,2015.0,2,2,0
CL,GT,2011.0,1,3,-2
CZ,GR,2003.0,1,1,0
JO,AU,2003.0,1,2,-1
ZM,GH,2002.0,2,2,0
AT,SK,2023.0,1,1,0
IR,BE,2009.0,8,10,-2
CU,EC,2008.0,2,1,1
DK,CL,2015.0,2,3,-1
FR,OM,2017.0,1,1,0
MX,BR,2023.0,1,2,-1
SE,RO,2000.0,1,5,-4
HU,CZ,2000.0,3,3,0
CO,CH,1998.0,1,1,0
IE,PL,2005.0,1,4,-3
BD,CH,2018.0,1,9,-8
PA,CU,2004.0,1,1,0
IN,PL,2004.0,2,3,-1
IT,NP,2015.0,1,1,0
KZ,IT,2019.0,2,3,-1
NL,KH,1998.0,1,1,0
NO,VG,2020.0,1,1,0
VN,PL,2020.0,2,1,1
NZ,MX,2007.0,2,1,1
QA,PK,2023.0,2,1,1
IN,DE,2014.0,194,185,9
FR,GB,2006.0,417,361,56
TZ,US,2015.0,23,24,-1
CH,DE,2005.0,407,524,-117
SA,PK,2015.0,55,76,-21
IE,GB,2021.0,345,329,16
FR,TN,2013.0,211,141,70
IR,CA,2014.0,283,139,144
FR,CH,2021.0,344,293,51
AU,DE,1999.0,72,83,-11
UA,JP,2011.0,5,3,2
US,LU,2010.0,18,8,10
US,FR,2003.0,903,1093,-190
SE,ET,2003.0,1,3,-2
LB,US,2014.0,71,75,-4
CH,DE,2002.0,358,440,-82
MA,FR,2007.0,215,239,-24
NZ,IS,2016.0,1,1,0
LK,US,2017.0,37,38,-1
CN,SY,2013.0,26,18,8
NO,DK,2020.0,107,137,-30
US,VN,2009.0,38,21,17
CN,MX,2005.0,3,9,-6
DE,RU,2004.0,114,195,-81
TH,FI,2004.0,2,1,1
RU,JP,2017.0,52,52,0
DE,ID,2021.0,33,36,-3
NZ,IN,2016.0,32,38,-6
NL,NO,2013.0,46,25,21
HU,US,2009.0,105,100,5
NL,ES,2006.0,64,58,6
TN,US,2014.0,34,18,16
CN,RU,2009.0,60,62,-2
MX,CH,2011.0,15,11,4
CL,US,1999.0,37,54,-17
IR,IT,2019.0,78,37,41
NG,CN,2022.0,35,30,5
EG,nan,2017.0,8,5,3
KE,DE,2018.0,14,23,-9
US,RO,2011.0,78,65,13
SA,IE,2015.0,5,8,-3
RO,CN,2021.0,9,8,1
KZ,IT,2017.0,3,6,-3
IT,CH,1999.0,92,85,7
HU,GB,2022.0,27,31,-4
JO,CA,2020.0,19,18,1
DO,BR,2016.0,3,2,1
IN,nan,2022.0,44,53,-9
IS,CA,2012.0,1,2,-1
JP,ID,2020.0,267,185,82
IR,AU,2011.0,76,60,16
CZ,GB,2018.0,50,55,-5
BR,IN,2012.0,28,11,17
DE,MT,2018.0,2,1,1
KH,FR,2017.0,10,8,2
MD,FR,2001.0,41,39,2
RS,XK,2020.0,21,22,-1
QA,LB,2017.0,4,1,3
AT,GR,2018.0,11,5,6
EC,UA,2019.0,34,14,20
CA,SE,1997.0,15,19,-4
SK,GB,2008.0,31,12,19
GB,TR,1999.0,51,14,37
AU,JP,2007.0,54,64,-10
DK,RU,2009.0,4,3,1
CR,AR,2009.0,5,8,-3
PL,SG,2017.0,3,4,-1
NE,FR,2021.0,23,16,7
GB,BD,2018.0,52,69,-17
AT,SG,2012.0,4,3,1
US,CY,2015.0,23,12,11
SE,BE,2019.0,28,47,-19
GB,LY,2020.0,20,5,15
CH,IR,2021.0,16,31,-15
DZ,EG,2018.0,14,7,7
SA,SE,2016.0,3,10,-7
UY,PY,2018.0,6,6,0
AR,GB,2022.0,17,19,-2
MU,ZA,2018.0,2,1,1
GR,DE,2007.0,54,41,13
PL,MZ,1999.0,11,13,-2
IR,GB,2006.0,24,64,-40
GB,GE,2010.0,12,3,9
LK,JP,2009.0,17,26,-9
KE,ET,2021.0,4,10,-6
BR,MZ,2019.0,30,20,10
MK,GB,2007.0,4,3,1
KR,MX,2003.0,2,2,0
GE,DE,2021.0,2,3,-1
LK,US,2010.0,24,17,7
FI,DZ,2019.0,1,1,0
ES,JP,2013.0,34,35,-1
NO,IT,2023.0,5,2,3
MZ,PL,2018.0,17,6,11
PL,NO,2013.0,8,4,4
UA,BE,2009.0,4,1,3
AM,MA,2012.0,1,1,0
OM,JO,2002.0,2,3,-1
NO,PL,2011.0,5,8,-3
BE,SI,2011.0,7,5,2
IN,CL,2010.0,4,1,3
BE,CL,2009.0,6,6,0
TH,MM,2013.0,6,1,5
AU,AT,2016.0,32,30,2
MT,GB,2016.0,16,25,-9
FI,MY,2012.0,3,2,1
AM,CA,2013.0,4,1,3
KW,IN,2003.0,3,10,-7
MX,TR,2008.0,2,1,1
MY,GB,2002.0,9,38,-29
OM,JO,2005.0,4,3,1
OM,AE,2017.0,11,3,8
ES,TW,2018.0,6,3,3
DE,GE,2008.0,6,4,2
FI,GR,2020.0,3,5,-2
HK,AU,2010.0,4,3,1
RS,MX,2013.0,1,12,-11
US,BG,2005.0,15,28,-13
VN,NL,2020.0,6,13,-7
IT,SA,2014.0,15,6,9
HU,RU,2022.0,8,19,-11
SG,PH,2019.0,16,9,7
CA,PK,1998.0,4,4,0
CW,DE,1999.0,1,1,0
MD,DE,2020.0,1,4,-3
NA,TZ,2020.0,1,1,0
PL,SG,2010.0,3,1,2
SG,AE,2018.0,3,4,-1
KE,PK,2002.0,1,2,-1
IL,SE,2014.0,8,6,2
SI,CA,2015.0,3,7,-4
GR,AM,2012.0,2,1,1
CA,BH,2016.0,1,1,0
TR,IL,2011.0,2,1,1
DK,AE,2015.0,1,1,0
MY,TR,2012.0,4,3,1
CN,LB,2008.0,20,4,16
AT,DK,2016.0,17,18,-1
US,AM,2006.0,3,13,-10
PK,BR,2014.0,5,5,0
TG,US,2020.0,1,1,0
DZ,nan,2008.0,2,1,1
CL,VE,2022.0,5,5,0
NP,SE,2020.0,1,1,0
GA,US,2014.0,1,1,0
GB,ZM,2008.0,1,2,-1
CO,DK,2007.0,1,1,0
AR,VE,2001.0,4,9,-5
IQ,SA,2012.0,6,6,0
DK,NP,2016.0,3,1,2
nan,TN,2013.0,4,2,2
US,BN,2023.0,1,1,0
EG,nan,2010.0,4,3,1
US,DO,2015.0,6,6,0
ET,NG,2010.0,4,1,3
MA,JP,2005.0,1,3,-2
BD,IN,2006.0,7,28,-21
NG,JP,2012.0,8,10,-2
UG,FI,2019.0,1,2,-1
CZ,BY,2011.0,18,11,7
CL,NL,2018.0,17,20,-3
PL,VN,2021.0,3,1,2
NZ,ID,2015.0,3,4,-1
CZ,LT,2002.0,1,4,-3
HU,BG,2019.0,2,1,1
ZA,AE,2004.0,3,2,1
CO,KE,2015.0,3,6,-3
DE,CY,2012.0,7,3,4
VN,RU,2000.0,1,2,-1
PT,SE,2021.0,12,10,2
IL,TW,2018.0,4,4,0
BR,RO,2008.0,2,2,0
QA,LB,2019.0,5,9,-4
SA,TW,2013.0,3,3,0
CZ,BR,2001.0,2,2,0
MX,AT,2016.0,3,4,-1
SS,BE,2006.0,1,1,0
DE,AM,2001.0,3,3,0
BE,BD,2022.0,2,1,1
GB,VN,2005.0,3,8,-5
CO,BE,2004.0,1,1,0
FR,NE,2007.0,6,1,5
CU,PT,2013.0,2,2,0
OM,AE,2010.0,1,3,-2
IT,MA,2004.0,2,8,-6
KE,PK,2005.0,4,5,-1
DO,CO,2014.0,4,3,1
ES,PR,2016.0,1,1,0
IL,ZA,2012.0,1,2,-1
CU,GB,2005.0,2,2,0
MK,PL,2019.0,2,1,1
MY,PT,2007.0,1,2,-1
AF,MX,1997.0,1,1,0
US,KR,2018.0,1345,1339,6
LU,US,2020.0,24,29,-5
JO,US,2006.0,22,50,-28
AR,DE,2004.0,21,12,9
TW,PT,2002.0,1,1,0
RU,ES,2013.0,11,24,-13
PG,US,2010.0,5,1,4
UZ,CN,2013.0,9,5,4
AE,AU,2022.0,6,10,-4
SK,GE,2020.0,2,3,-1
GH,NG,2014.0,2,6,-4
NL,CY,2006.0,1,1,0
EC,BE,2022.0,3,4,-1
TR,PK,2018.0,18,20,-2
BR,SG,2021.0,8,3,5
EG,MY,2020.0,47,40,7
BA,ME,2016.0,3,2,1
NO,,2022.0,4014,0,4014
MX,,2016.0,2408,0,2408
SG,,2020.0,1628,0,1628
,NG,2007.0,1264,0,1264
FR,,2022.0,31378,0,31378
BR,,2017.0,10527,0,10527
,KR,2000.0,4201,0,4201
,BR,2008.0,17518,0,17518
BR,,2019.0,16360,0,16360
PK,,2023.0,9675,0,9675
,BG,2002.0,466,0,466
PL,,2017.0,4286,0,4286
,BG,2005.0,492,0,492
CL,,2016.0,1052,0,1052
IR,,2023.0,39050,0,39050
TW,,2016.0,3704,0,3704
GB,,2015.0,12248,0,12248
RU,,2013.0,3824,0,3824
AR,,2003.0,289,0,289
CN,,2020.0,25294,0,25294
,AU,2012.0,7608,0,7608
,HK,2009.0,69,0,69
,FR,2013.0,14744,0,14744
BR,,2010.0,3461,0,3461
,IL,1995.0,4152,0,4152
PL,,2019.0,6698,0,6698
,IR,2013.0,14266,0,14266
TR,,2021.0,6877,0,6877
DE,,2001.0,5785,0,5785
VN,,2023.0,2592,0,2592
GR,,2011.0,1450,0,1450
IL,,2012.0,1389,0,1389
NG,,2017.0,1016,0,1016
,BE,2001.0,2411,0,2411
HR,,2018.0,604,0,604
,LK,2008.0,370,0,370
NG,,2019.0,1475,0,1475
,AT,2011.0,2431,0,2431
MU,,2024.0,149,0,149
PL,,2010.0,1320,0,1320
,VN,2003.0,147,0,147
,RS,2003.0,790,0,790
EG,,2015.0,865,0,865
,SD,2007.0,93,0,93
MD,BR,1997.0,1,0,1
BI,MX,2016.0,1,0,1
,DO,2012.0,27,0,27
IE,,2018.0,1226,0,1226
,CA,2018.0,9024,0,9024
TN,DE,2007.0,2,0,2
IS,,2011.0,69,0,69
MN,,2015.0,17,0,17
DK,,2008.0,527,0,527
,LT,2015.0,596,0,596
ZA,SL,2013.0,1,0,1
MK,,2023.0,579,0,579
,SJ,2009.0,7,0,7
,PL,2018.0,3675,0,3675
,TZ,2014.0,298,0,298
HU,,2025.0,604,0,604
ET,,2015.0,77,0,77
CD,,2019.0,124,0,124
ID,TH,2005.0,1,0,1
,ID,1995.0,336,0,336
TN,,2007.0,81,0,81
CO,TN,2015.0,1,0,1
CM,TW,2020.0,1,0,1
,CM,2015.0,546,0,546
,GH,2006.0,137,0,137
MV,,2019.0,3,0,3
,SL,2011.0,9,0,9
,KZ,2015.0,754,0,754
,BF,2012.0,158,0,158
MA,GA,2017.0,2,0,2
SI,,2011.0,213,0,213
,NP,2003.0,141,0,141
CO,IL,1997.0,1,0,1
,LV,1999.0,141,0,141
GA,CO,2019.0,1,0,1
KW,JO,2012.0,1,0,1
SZ,,2024.0,54,0,54
,CV,2015.0,7,0,7
OM,,2012.0,37,0,37
,PF,2019.0,3,0,3
NI,CO,2005.0,1,0,1
IL,EC,2015.0,2,0,2
UA,LT,2023.0,1,0,1
CM,,2008.0,38,0,38
,TJ,2009.0,23,0,23
,BN,1999.0,5,0,5
MX,SK,2012.0,1,0,1
SD,,2021.0,183,0,183
NG,,2010.0,259,0,259
,CY,2018.0,256,0,256
IN,MV,2021.0,1,0,1
EC,,2006.0,18,0,18
ID,,2006.0,48,0,48
GD,,2021.0,34,0,34
BO,IR,2017.0,3,0,3
AZ,,2018.0,123,0,123
BJ,,2012.0,8,0,8
MD,UA,2012.0,1,0,1
,VE,2018.0,141,0,141
UA,RS,2020.0,4,0,4
AZ,MY,2020.0,1,0,1
,ZA,2020.0,106,0,106
,BD,2011.0,1301,0,1301
LT,,2013.0,235,0,235
GM,,2021.0,35,0,35
,ZW,2018.0,150,0,150
UA,SI,2015.0,1,0,1
TT,,2016.0,30,0,30
ZW,IT,2016.0,1,0,1
UA,CA,2012.0,3,0,3
JP,JO,2012.0,2,0,2
NA,,2021.0,42,0,42
UG,SE,2006.0,5,0,5
CD,,2017.0,98,0,98
UG,SG,2008.0,1,0,1
VE,,2004.0,99,0,99
AZ,AF,2017.0,1,0,1
DJ,DE,2004.0,1,0,1
,NA,2011.0,49,0,49
TN,JP,2011.0,2,0,2
NO,AE,2014.0,4,0,4
CI,TZ,2018.0,1,0,1
GE,SK,2006.0,5,0,5
,SV,2001.0,16,0,16
RU,VN,2015.0,5,0,5
CH,ZM,2008.0,1,0,1
,BO,2006.0,62,0,62
,SZ,2016.0,14,0,14
ET,DK,2015.0,2,0,2
,GY,2015.0,7,0,7
FR,AZ,2018.0,1,0,1
,PF,2017.0,9,0,9
SM,,2020.0,2,0,2
,KH,2018.0,58,0,58
BT,CO,2020.0,1,0,1
PL,AZ,2001.0,2,0,2
KH,ID,2023.0,1,0,1
AU,VG,2012.0,1,0,1
OM,IE,2008.0,2,0,2
TN,TT,2018.0,1,0,1
IS,IQ,2008.0,1,0,1
AO,AR,2010.0,1,0,1
BB,NZ,2010.0,1,0,1
,ST,2014.0,14,0,14
KR,LA,2020.0,1,0,1
JP,GH,2006.0,2,0,2
RU,ZA,2001.0,6,0,6
PK,IR,2008.0,5,0,5
HU,UA,2002.0,2,0,2
,BB,2012.0,13,0,13
CZ,TZ,2008.0,1,0,1
GB,NC,2005.0,1,0,1
EE,,2000.0,19,0,19
GR,TW,2016.0,4,0,4
GR,KE,2018.0,1,0,1
MW,NG,2009.0,2,0,2
,PF,2010.0,11,0,11
JP,PY,2019.0,1,0,1
PY,,2025.0,8,0,8
GM,CH,2001.0,1,0,1
DE,NP,2011.0,3,0,3
JM,GP,2000.0,3,0,3
LU,,2004.0,9,0,9
CD,,2010.0,9,0,9
GE,,1999.0,26,0,26
PE,,1999.0,12,0,12
VU,,2021.0,5,0,5
SG,SY,2020.0,1,0,1
PH,CR,2017.0,1,0,1
,GM,1998.0,5,0,5
DK,UA,2005.0,1,0,1
IT,KW,2020.0,1,0,1
PR,GB,2002.0,2,0,2
CL,PA,2002.0,1,0,1
SY,,2007.0,14,0,14
GH,CN,2006.0,3,0,3
,GM,1997.0,8,0,8
SV,,2020.0,38,0,38
MC,,2012.0,7,0,7
AM,,1999.0,10,0,10
RU,GR,1998.0,1,0,1
PE,NI,2006.0,1,0,1
BO,PT,2016.0,2,0,2
ZA,UG,2002.0,2,0,2
IR,UG,2014.0,1,0,1
DE,BI,1998.0,1,0,1
IQ,HU,2018.0,2,0,2
BF,SE,2008.0,2,0,2
BA,MK,2012.0,2,0,2
CY,ID,2014.0,1,0,1
IN,MU,2023.0,1,0,1
KE,NP,2016.0,1,0,1
BE,ID,2012.0,6,0,6
CF,,2022.0,11,0,11
AZ,GR,2016.0,1,0,1
CH,IS,2015.0,4,0,4
BJ,CI,2011.0,2,0,2
BO,,2025.0,9,0,9
RO,,1998.0,39,0,39
TZ,AE,2012.0,1,0,1
UY,,2000.0,10,0,10
TZ,CG,2018.0,1,0,1
IN,GH,2013.0,2,0,2
NL,GA,1999.0,2,0,2
,GN,2012.0,16,0,16
IT,BJ,2004.0,2,0,2
LT,MK,2007.0,1,0,1
,XK,2000.0,3,0,3
AF,MX,1998.0,2,0,2
RS,GB,1999.0,12,0,12
RW,,2008.0,4,0,4
BF,PK,2007.0,3,0,3
GB,CI,2017.0,2,0,2
IL,ET,2017.0,3,0,3
LB,JP,2014.0,2,0,2
ZA,MX,2004.0,2,0,2
BM,US,2016.0,3,0,3
SG,PT,2021.0,3,0,3
AR,CR,2001.0,3,0,3
SN,TH,2007.0,1,0,1
ES,TN,1998.0,1,0,1
TH,KR,1999.0,3,0,3
DK,LK,2005.0,2,0,2
CH,NE,2016.0,1,0,1
NA,CA,2020.0,2,0,2
SV,CH,2018.0,1,0,1
CN,PG,2001.0,1,0,1
CA,GN,2018.0,1,0,1
FI,SJ,2011.0,1,0,1
IL,GE,2019.0,2,0,2
NO,AM,2012.0,2,0,2
CN,AZ,2015.0,3,0,3
MN,IT,2021.0,1,0,1
GH,ID,2010.0,3,0,3
GP,,2007.0,1,0,1
IE,GH,2010.0,1,0,1
GY,,2020.0,4,0,4
UA,TJ,2020.0,5,0,5
FO,DK,2022.0,3,0,3
KW,SD,2017.0,1,0,1
CD,MD,2021.0,1,0,1
UZ,TR,2002.0,1,0,1
UZ,IL,2021.0,2,0,2
FR,GN,2013.0,3,0,3
LK,RO,2011.0,1,0,1
GB,YE,2005.0,2,0,2
PR,ES,2008.0,2,0,2
FI,VN,2018.0,2,0,2
CM,NE,2013.0,1,0,1
IR,PY,2018.0,1,0,1
,RW,1994.0,17,0,17
AM,IN,2019.0,1,0,1
CZ,IQ,2018.0,2,0,2
RO,RS,2002.0,1,0,1
MY,PS,2018.0,8,0,8
KZ,NZ,2016.0,1,0,1
RE,,2012.0,12,0,12
,GF,1994.0,4,0,4
IS,EE,2009.0,2,0,2
SG,GR,2009.0,2,0,2
BE,TH,2009.0,3,0,3
NC,,2013.0,5,0,5
BW,MW,2004.0,1,0,1
GP,ES,2007.0,1,0,1
IE,TH,2008.0,1,0,1
HU,TW,2014.0,2,0,2
BE,LV,2017.0,2,0,2
DK,QA,2000.0,2,0,2
,SX,2003.0,1,0,1
IE,GH,2017.0,1,0,1
AR,PL,2006.0,2,0,2
NL,CW,1997.0,2,0,2
KP,CO,2009.0,1,0,1
PR,JP,2014.0,1,0,1
US,AF,2010.0,4,0,4
BE,MC,2015.0,1,0,1
ZW,NP,2006.0,1,0,1
IT,EG,2023.0,1,0,1
RS,NL,2022.0,4,0,4
BD,EG,1998.0,2,0,2
PH,AO,2006.0,1,0,1
NL,KH,1997.0,4,0,4
NZ,EG,2014.0,3,0,3
UY,IN,2013.0,1,0,1
AU,KW,2013.0,3,0,3
PH,CR,2019.0,1,0,1
RO,CM,2018.0,1,0,1
SK,EE,2011.0,1,0,1
BY,nan,2010.0,1,0,1
CY,KZ,2015.0,1,0,1
CH,BO,2009.0,1,0,1
SE,KH,2007.0,1,0,1
MZ,UY,2013.0,1,0,1
LS,,2009.0,4,0,4
BY,CH,2012.0,1,0,1
UZ,IN,2022.0,2,0,2
ML,CN,2016.0,1,0,1
JP,TN,2003.0,3,0,3
MX,SY,2017.0,1,0,1
SE,MD,2020.0,1,0,1
AL,LT,2019.0,1,0,1
JP,PS,2021.0,1,0,1
DK,BF,2018.0,1,0,1
LU,KR,2019.0,1,0,1
RO,LT,2002.0,2,0,2
MA,SY,2007.0,1,0,1
SJ,CA,2014.0,1,0,1
AG,US,2002.0,1,0,1
IN,PF,2003.0,1,0,1
IN,CR,2005.0,2,0,2
EC,UY,2007.0,1,0,1
ZA,BH,2022.0,3,0,3
VE,BO,2020.0,4,0,4
BD,KW,2008.0,1,0,1
NP,ZA,2001.0,1,0,1
RU,PK,2006.0,1,0,1
JP,PY,2017.0,1,0,1
CU,AU,2009.0,2,0,2
IL,VE,2009.0,2,0,2
MX,QA,2013.0,1,0,1
DZ,SO,2021.0,1,0,1
LY,IN,2004.0,1,0,1
PL,TZ,2019.0,1,0,1
IL,GE,2010.0,2,0,2
MK,FR,2008.0,1,0,1
GH,KE,2006.0,1,0,1
NC,ES,2018.0,1,0,1
RS,BA,2001.0,3,0,3
SZ,CA,2002.0,1,0,1
AU,VE,2022.0,1,0,1
KR,IQ,1999.0,1,0,1
BG,AU,2007.0,3,0,3
TR,IS,2013.0,1,0,1
SI,MA,1998.0,2,0,2
BD,OM,2013.0,2,0,2
RS,ES,2004.0,2,0,2
SG,SA,2008.0,1,0,1
PR,VN,2003.0,1,0,1
JO,IQ,2001.0,1,0,1
ES,PG,2001.0,1,0,1
US,MR,1999.0,1,0,1
JO,JP,2011.0,3,0,3
JP,SN,2005.0,1,0,1
CI,TG,2017.0,1,0,1
ES,PY,2006.0,2,0,2
ML,NG,2001.0,1,0,1
CG,,2009.0,13,0,13
FR,OM,2019.0,3,0,3
MY,BH,2018.0,5,0,5
MN,DE,2013.0,1,0,1
BG,LB,2021.0,2,0,2
SS,,2025.0,2,0,2
HU,SG,2006.0,1,0,1
MT,,2003.0,3,0,3
SG,FI,2022.0,4,0,4
RO,VN,2005.0,3,0,3
KH,US,2001.0,3,0,3
DE,IQ,2011.0,1,0,1
ZA,MY,2004.0,1,0,1
UZ,KH,2010.0,1,0,1
BI,ID,2019.0,1,0,1
PK,OM,2010.0,6,0,6
NG,SY,2009.0,1,0,1
DE,TN,1997.0,1,0,1
TJ,GB,2009.0,1,0,1
CH,BJ,2012.0,3,0,3
IE,VN,2007.0,1,0,1
IT,ML,2008.0,1,0,1
GI,US,2014.0,3,0,3
SG,HK,2011.0,1,0,1
ES,LB,1998.0,1,0,1
DK,SJ,2002.0,1,0,1
RU,LK,2014.0,1,0,1
BI,ZA,2014.0,1,0,1
AT,ET,2019.0,4,0,4
BD,BF,2004.0,1,0,1
GH,BH,2010.0,3,0,3
KZ,KR,2014.0,1,0,1
KR,TN,2019.0,1,0,1
,DJ,2013.0,1,0,1
,MR,2008.0,9,0,9
,MO,2004.0,3,0,3
LT,NL,2022.0,2,0,2
FR,IQ,2021.0,6,0,6
AZ,AE,2022.0,1,0,1
VN,QA,2021.0,2,0,2
MV,,2017.0,1,0,1
PR,DE,2018.0,2,0,2
RU,JO,2015.0,1,0,1
CN,AE,2008.0,2,0,2
GR,GA,2021.0,1,0,1
RW,QA,2020.0,1,0,1
BA,JP,2013.0,1,0,1
ML,GN,2012.0,2,0,2
BA,IQ,2014.0,1,0,1
TJ,TR,2016.0,1,0,1
ID,TH,2002.0,1,0,1
BE,SY,1999.0,1,0,1
VN,DE,2000.0,3,0,3
GB,BM,2008.0,2,0,2
AM,CN,2015.0,2,0,2
AE,CR,2021.0,1,0,1
CO,SI,2012.0,1,0,1
AG,EG,2022.0,1,0,1
TG,GB,2011.0,1,0,1
RU,GR,1997.0,1,0,1
GE,HU,2008.0,1,0,1
BE,BF,2014.0,3,0,3
HN,,2025.0,4,0,4
CZ,ZA,2001.0,1,0,1
ZA,EE,2014.0,1,0,1
US,GA,2006.0,2,0,2
IE,GD,2012.0,1,0,1
nan,NG,2006.0,1,0,1
KR,AR,2015.0,1,0,1
AL,KW,2020.0,1,0,1
PS,SE,2011.0,1,0,1
TN,DK,2012.0,1,0,1
HU,MX,2004.0,1,0,1
VE,CH,2003.0,1,0,1
CZ,CY,2012.0,1,0,1
BJ,CM,2004.0,1,0,1
BG,NZ,2005.0,2,0,2
ES,OM,2013.0,1,0,1
BE,LV,2019.0,2,0,2
CW,IN,2019.0,1,0,1
BJ,TW,2020.0,1,0,1
BR,ZM,2022.0,1,0,1
CD,IN,2021.0,1,0,1
PK,CY,2012.0,1,0,1
ZA,ZM,2003.0,1,0,1
LY,,2006.0,6,0,6
BH,TW,2021.0,2,0,2
SJ,IT,2016.0,1,0,1
LB,BD,1998.0,1,0,1
AZ,PL,2013.0,2,0,2
CN,SR,2014.0,1,0,1
IR,CH,1998.0,2,0,2
OM,YE,2019.0,1,0,1
PA,FR,2000.0,2,0,2
VU,SE,2011.0,1,0,1
PK,RO,2001.0,1,0,1
CV,ES,2020.0,1,0,1
BE,MW,2010.0,1,0,1
PF,CH,2016.0,1,0,1
PL,CU,2016.0,1,0,1
BH,ER,2019.0,1,0,1
BA,EG,2016.0,1,0,1
RO,SI,2021.0,3,0,3
ME,IE,2022.0,1,0,1
MT,IT,1998.0,1,0,1
ET,NP,2015.0,1,0,1
SG,MA,2016.0,1,0,1
IQ,EG,2004.0,1,0,1
BR,GT,2019.0,5,0,5
ZM,NA,2018.0,1,0,1
BY,KR,2004.0,1,0,1
ZA,KN,2017.0,3,0,3
GE,NZ,2010.0,1,0,1
MX,JO,2015.0,2,0,2
TW,UA,2018.0,1,0,1
PH,FI,2005.0,1,0,1
NL,KZ,2016.0,2,0,2
CY,AU,2003.0,1,0,1
CH,GH,2012.0,2,0,2
GF,,2009.0,3,0,3
GB,LU,2004.0,1,0,1
CO,PA,1998.0,1,0,1
NG,PE,2013.0,1,0,1
ID,VE,2020.0,2,0,2
PH,KH,2018.0,2,0,2
CU,IE,2021.0,3,0,3
IN,CF,2013.0,1,0,1
NG,LS,2012.0,1,0,1
BR,TR,1999.0,2,0,2
GP,GF,2001.0,1,0,1
ID,UG,2020.0,2,0,2
PK,MX,2007.0,1,0,1
NZ,BN,2019.0,1,0,1
MW,ZM,2008.0,1,0,1
AU,MV,2015.0,1,0,1
ML,KE,2013.0,1,0,1
BG,SA,2009.0,2,0,2
MW,KE,2011.0,2,0,2
DE,MZ,1999.0,1,0,1
PT,FI,2002.0,1,0,1
DJ,FR,2022.0,2,0,2
SE,CU,1998.0,1,0,1
NZ,BN,2010.0,1,0,1
EG,TW,2002.0,3,0,3
US,AG,2014.0,1,0,1
MD,CA,2014.0,2,0,2
NZ,LA,1998.0,1,0,1
KH,IN,2005.0,1,0,1
VE,AU,2003.0,1,0,1
BY,AE,2014.0,1,0,1
IR,CH,1997.0,2,0,2
LK,NG,2018.0,2,0,2
AT,LT,2021.0,1,0,1
MY,BR,2023.0,2,0,2
US,SO,2018.0,2,0,2
BR,ET,2014.0,3,0,3
KW,TN,2011.0,2,0,2
DE,KG,2014.0,1,0,1
CI,TG,2019.0,1,0,1
PA,PY,2022.0,1,0,1
AM,AT,2008.0,1,0,1
MY,NG,1999.0,1,0,1
MK,PL,2017.0,2,0,2
US,ER,2006.0,1,0,1
US,PS,2001.0,2,0,2
TH,ZM,2015.0,1,0,1
AR,BD,2012.0,1,0,1
TH,MG,2007.0,1,0,1
ZA,KN,2010.0,1,0,1
IE,SN,2011.0,1,0,1
NC,CH,2014.0,1,0,1
IL,AE,2012.0,1,0,1
DE,AE,2003.0,1,0,1
AU,TZ,2011.0,1,0,1
PT,MT,2021.0,2,0,2
MA,NE,2010.0,1,0,1
ES,AD,2009.0,2,0,2
SG,OM,2016.0,1,0,1
RE,nan,2019.0,1,0,1
MW,CY,2016.0,1,0,1
TR,RW,2008.0,2,0,2
EG,PL,2004.0,2,0,2
BA,RS,1997.0,2,0,2
BJ,KE,2005.0,1,0,1
NP,UA,2013.0,1,0,1
TZ,TW,2015.0,1,0,1
AU,NC,2022.0,1,0,1
TW,QA,2021.0,2,0,2
ME,DE,2020.0,1,0,1
PK,VN,2002.0,1,0,1
MM,CZ,2011.0,1,0,1
AL,GH,2022.0,3,0,3
VN,PT,2013.0,1,0,1
MV,KE,2021.0,1,0,1
PH,PT,2022.0,2,0,2
AE,TH,2009.0,1,0,1
PT,PL,2003.0,1,0,1
EE,KR,2015.0,1,0,1
PT,BY,2011.0,1,0,1
NP,IL,2010.0,1,0,1
AF,SE,2000.0,1,0,1
FI,MD,2000.0,2,0,2
ES,GN,2019.0,2,0,2
AR,IE,2013.0,1,0,1
AM,SG,2012.0,2,0,2
SA,IT,1999.0,1,0,1
AM,IN,2017.0,1,0,1
IL,TH,2018.0,1,0,1
ER,CH,2005.0,1,0,1
DK,GL,2013.0,1,5,-4
ZM,nan,2021.0,1,2,-1
PY,CR,2018.0,1,1,0
FI,ZA,2009.0,1,2,-1
HK,TW,2011.0,3,4,-1
nan,ZA,2019.0,7,9,-2
SD,KE,2004.0,4,1,3
BF,NE,2018.0,2,2,0
PT,ZA,2007.0,1,1,0
KW,AU,2015.0,2,7,-5
BD,SE,2002.0,1,1,0
BR,MA,2013.0,1,2,-1
TT,ES,2011.0,1,1,0
PR,GB,2005.0,1,1,0
CA,GP,2012.0,1,1,0
US,LY,2010.0,2,2,0
AU,CZ,1999.0,1,2,-1
CV,PT,2017.0,4,1,3
ID,IN,2004.0,1,1,0
FI,MX,2021.0,1,5,-4
BJ,NL,2012.0,1,3,-2
HU,TN,2021.0,1,1,0
MK,IT,2015.0,1,2,-1
TN,ES,2001.0,1,1,0
JO,LB,2013.0,1,6,-5
BJ,MG,2009.0,1,1,0
TJ,RU,2004.0,2,6,-4
ZA,NG,2004.0,2,5,-3
BG,TR,2009.0,2,1,1
EG,BR,2010.0,1,2,-1
LK,FJ,2015.0,1,1,0
SE,LT,2011.0,3,2,1
CN,ET,2005.0,2,2,0
TR,XK,2011.0,1,1,0
CO,ZA,2016.0,2,1,1
HU,DZ,2020.0,1,1,0
GB,CI,2019.0,1,3,-2
CY,IR,2023.0,1,2,-1
AE,TN,2022.0,2,6,-4
ES,PK,2004.0,1,2,-1
EG,NL,1997.0,3,5,-2
NG,KE,2009.0,2,1,1
BD,CN,2001.0,1,3,-2
HR,SI,1998.0,2,1,1
DE,SI,2004.0,4,3,1
GB,SS,2021.0,4,5,-1
MT,CH,2018.0,1,1,0
CA,GA,2019.0,1,1,0
MY,NC,2011.0,1,1,0
LB,GB,2000.0,3,3,0
CY,AT,2020.0,1,1,0
US,SS,1997.0,1,2,-1
MA,TG,2015.0,1,1,0
MX,PL,1997.0,1,4,-3
JP,BO,2020.0,1,2,-1
ZM,KE,2017.0,1,4,-3
AE,IR,2010.0,2,3,-1
NO,NP,2023.0,1,1,0
ET,ES,2019.0,1,7,-6
GH,IE,2022.0,2,1,1
BH,TR,2013.0,1,1,0
PK,ZA,2011.0,1,2,-1
ES,TH,2017.0,2,2,0
TG,FR,2007.0,1,3,-2
SD,ZA,2018.0,1,5,-4
NO,UA,2015.0,2,1,1
RO,LT,2005.0,3,3,0
BR,GT,2010.0,1,4,-3
NG,CH,2014.0,1,2,-1
nan,CL,2022.0,2,1,1
NZ,AE,2011.0,2,3,-1
IE,NO,2011.0,2,4,-2
PT,DO,2019.0,1,1,0
IL,BG,2019.0,1,3,-2
FI,BG,2011.0,1,1,0
SE,SA,2005.0,1,1,0
KW,IE,2020.0,2,1,1
KH,GB,2008.0,1,3,-2
MA,SE,2020.0,2,2,0
BE,CU,2015.0,1,1,0
EG,BN,2017.0,2,1,1
DE,KW,2017.0,4,1,3
nan,TH,2008.0,1,1,0
JO,MY,2009.0,2,7,-5
TT,CA,2017.0,2,4,-2
GE,PL,2014.0,1,2,-1
HK,SE,2021.0,1,1,0
CL,PA,2005.0,1,2,-1
IQ,SD,2016.0,1,6,-5
HN,PE,2021.0,2,5,-3
PG,US,2017.0,1,2,-1
IT,GT,2021.0,1,2,-1
HU,PK,2009.0,2,1,1
TH,BE,1999.0,1,1,0
HK,AU,2019.0,3,3,0
AO,IT,1999.0,2,2,0
SG,EG,2017.0,2,5,-3
NL,MN,2021.0,1,1,0
GE,RU,1997.0,2,5,-3
BH,IT,2022.0,1,1,0
TR,NO,1998.0,1,2,-1
AU,MT,2011.0,1,4,-3
PL,UZ,2014.0,1,4,-3
CM,NO,2017.0,1,2,-1
SE,NP,2014.0,1,1,0
GT,CR,2014.0,1,1,0
US,SS,1998.0,1,1,0
SN,ES,2016.0,1,1,0
JO,BH,1997.0,1,1,0
SA,JP,2004.0,1,7,-6
IE,PT,2007.0,3,4,-1
NG,PL,2018.0,1,1,0
BH,TZ,2004.0,1,2,-1
AE,IE,2008.0,1,1,0
IN,MZ,2014.0,1,1,0
PL,IN,1997.0,1,1,0
IE,PL,2002.0,1,1,0
HK,AU,2017.0,3,2,1
CZ,BG,2007.0,1,2,-1
NO,PT,2007.0,1,2,-1
HR,PL,2016.0,3,2,1
QA,AE,2011.0,1,8,-7
CA,BE,2023.0,1,2,-1
EE,LV,2014.0,2,2,0
SO,KE,2020.0,1,1,0
TZ,IN,2022.0,1,5,-4
UG,CM,2019.0,1,1,0
BB,GB,2017.0,1,3,-2
KE,BH,2011.0,1,2,-1
EE,BG,2020.0,1,1,0
FI,TW,2019.0,2,6,-4
CH,SN,2001.0,1,1,0
MT,BR,2010.0,1,3,-2
AT,SA,2018.0,1,2,-1
GH,AL,2020.0,1,2,-1
NZ,SK,1999.0,1,1,0
TW,AT,2011.0,1,1,0
PK,GM,2016.0,1,1,0
FO,US,2016.0,1,1,0
DZ,MX,2005.0,1,1,0
JP,PR,2008.0,2,3,-1
FR,GT,2005.0,1,2,-1
CF,SN,2016.0,1,1,0
LB,IR,2019.0,1,1,0
JM,GB,1997.0,1,3,-2
PA,IT,2006.0,1,1,0
MC,AT,2015.0,1,1,0
LK,CA,2007.0,1,2,-1
CN,MX,2002.0,2,3,-1
IN,MA,2012.0,1,2,-1
US,NG,2023.0,1,4,-3
CM,DE,1998.0,1,1,0
BR,PS,2017.0,1,1,0
NZ,PL,2017.0,1,2,-1
JO,IN,2006.0,1,1,0
ES,KW,2020.0,1,1,0
ID,KR,2023.0,2,5,-3
PH,SE,2007.0,1,1,0
JO,OM,2000.0,1,1,0
IN,ZM,2016.0,1,1,0
PT,TH,2013.0,1,1,0
PY,CO,2005.0,1,1,0
NO,ID,2009.0,1,1,0
TR,AZ,2012.0,1,6,-5
MT,BR,2017.0,1,1,0
NL,SI,1998.0,1,2,-1
nan,GE,2003.0,1,1,0
IT,PK,2005.0,1,1,0
AM,DE,2006.0,1,5,-4
GH,FR,2022.0,1,4,-3
LB,AR,2014.0,1,1,0
ZW,NO,2008.0,1,1,0
MM,US,2007.0,1,4,-3
GN,FR,2014.0,2,3,-1
CI,MA,2018.0,1,2,-1
IL,MY,2017.0,1,2,-1
IT,PK,2002.0,1,2,-1
IN,TN,2011.0,4,3,1
ZW,NG,2014.0,1,1,0
RU,EG,2014.0,2,3,-1
IE,TW,2014.0,1,2,-1
SE,QA,2014.0,1,1,0
RE,US,2019.0,1,3,-2
US,PA,2023.0,2,1,1
JP,ZM,2012.0,3,3,0
KW,CN,2020.0,2,1,1
RU,IR,2003.0,1,1,0
BE,MW,2017.0,1,1,0
NO,SG,2009.0,2,2,0
MT,BR,2019.0,2,5,-3
BI,DE,2006.0,1,1,0
CH,LV,2016.0,1,2,-1
PE,UY,2009.0,2,1,1
PT,CZ,2010.0,1,2,-1
SD,OM,2018.0,1,1,0
CH,KE,2008.0,1,3,-2
NO,LT,2012.0,1,2,-1
PT,EG,2011.0,1,4,-3
TH,PH,2012.0,2,1,1
CO,IN,2010.0,1,2,-1
LT,PL,2013.0,1,3,-2
SG,DZ,2022.0,2,1,1
AR,AU,1999.0,1,3,-2
IT,BF,2010.0,1,0,1
JP,EG,2023.0,2,0,2
LK,KE,2011.0,1,0,1
SG,EG,2010.0,1,0,1
MM,CN,1997.0,1,0,1
AR,UG,2018.0,1,0,1
GE,CH,2000.0,2,0,2
CY,KW,2017.0,1,0,1
EE,GH,2015.0,1,0,1
BR,UZ,2009.0,1,0,1
ZM,BH,2008.0,1,0,1
DK,LT,2011.0,2,0,2
BR,KZ,2018.0,1,0,1
MY,GR,2021.0,1,0,1
IE,EE,2007.0,1,0,1
IE,CO,2004.0,2,0,2
ZM,CN,2003.0,1,0,1
GB,YE,2002.0,1,0,1
AE,PE,2012.0,1,0,1
GP,MA,1999.0,1,0,1
ZA,CR,2021.0,1,0,1
SE,MM,2020.0,1,0,1
MX,CG,2005.0,1,0,1
PG,NG,2016.0,2,0,2
HN,nan,2003.0,1,0,1
ZM,ID,2019.0,4,0,4
GT,,2001.0,1,0,1
ES,TZ,2005.0,1,0,1
PH,PL,2016.0,1,0,1
NE,CA,2018.0,1,0,1
MN,US,1999.0,1,0,1
AZ,RS,2008.0,2,0,2
HU,IE,2003.0,2,0,2
CL,NG,2015.0,1,0,1
PL,AG,2020.0,1,0,1
ML,AU,2021.0,1,0,1
PL,CY,2011.0,1,0,1
MY,MW,2000.0,1,0,1
NE,BE,2012.0,1,0,1
ID,CZ,2023.0,1,0,1
LY,JO,2005.0,1,0,1
CL,MT,2009.0,1,0,1
MA,ZW,2016.0,1,0,1
BE,BW,2015.0,1,0,1
PR,,2012.0,1,0,1
JO,IE,2007.0,1,0,1
AO,CA,2014.0,1,0,1
UG,FR,1997.0,1,0,1
TM,TR,2003.0,1,0,1
JO,AR,2021.0,1,0,1
AM,KR,2022.0,2,0,2
CA,FJ,2009.0,1,0,1
KZ,ID,2022.0,2,0,2
SE,ZW,2008.0,1,0,1
DE,VG,2018.0,1,0,1
KG,ES,2017.0,1,0,1
US,BS,2002.0,1,0,1
ET,BR,2022.0,1,0,1
FJ,TR,2019.0,1,0,1
FR,AL,2021.0,2,0,2
SL,LA,2020.0,1,0,1
AT,BD,2015.0,2,0,2
LU,BJ,2019.0,1,0,1
CO,UA,2011.0,3,0,3
JO,UA,2007.0,1,0,1
KG,US,2008.0,1,0,1
UY,GB,2001.0,1,0,1
ZM,ID,2010.0,1,0,1
IN,JO,2000.0,1,0,1
TW,DZ,2011.0,1,0,1
GB,SN,1998.0,1,0,1
RW,ZW,2011.0,1,0,1
IN,NE,2014.0,1,0,1
LU,KR,2017.0,1,0,1
ZW,IN,2011.0,1,0,1
BE,ZM,2011.0,2,0,2
VG,IN,2008.0,1,0,1
ZA,TG,2017.0,1,0,1
MC,BR,2020.0,1,0,1
LU,BJ,2017.0,2,0,2
IT,IQ,2023.0,1,0,1
IN,MT,2020.0,1,0,1
PK,NO,1999.0,2,0,2
KZ,TN,2023.0,1,0,1
KR,PT,2017.0,2,0,2
LB,IR,2010.0,1,0,1
TZ,EE,2015.0,1,0,1
AT,CM,2016.0,1,0,1
GE,BD,2011.0,1,0,1
HR,NG,2006.0,1,0,1
FI,SI,2000.0,1,0,1
VE,IR,2015.0,1,0,1
BG,RO,2021.0,2,0,2
NL,BN,2015.0,2,0,2
AR,RS,2000.0,1,0,1
AZ,CY,2003.0,1,0,1
EE,ZA,2004.0,1,0,1
BJ,BE,1999.0,1,0,1
GB,SV,2003.0,1,0,1
GD,UG,2013.0,1,0,1
SD,JO,2005.0,2,0,2
BR,GT,2017.0,1,0,1
NI,AU,2012.0,1,0,1
SY,IT,2002.0,1,0,1
MD,TR,2014.0,1,0,1
VG,PT,2007.0,1,0,1
TH,BD,2011.0,2,0,2
VA,US,2009.0,1,0,1
MY,PR,2005.0,1,0,1
RE,NC,2008.0,1,0,1
FR,AM,2014.0,1,0,1
AU,CG,2004.0,1,0,1
ML,FR,1997.0,1,0,1
BE,LV,2010.0,1,0,1
DK,LU,2023.0,1,0,1
IQ,GH,2022.0,1,0,1
BG,FI,2020.0,1,0,1
IN,PS,2018.0,1,0,1
NG,PK,1998.0,1,0,1
ES,IS,2003.0,1,0,1
JO,PS,1998.0,1,0,1
ZM,BJ,2013.0,1,0,1
TZ,PY,2014.0,1,0,1
AR,RE,2021.0,1,0,1
PA,,2026.0,1,0,1
SE,ZM,1998.0,1,0,1
AM,UA,2011.0,1,0,1
OM,RU,2016.0,2,0,2
MX,SI,2007.0,1,0,1
IL,EE,2009.0,2,0,2
AT,ET,2010.0,2,0,2
AU,NG,2001.0,1,0,1
TH,AF,2017.0,2,0,2
AO,PT,2008.0,1,0,1
AR,BY,2015.0,1,0,1
BJ,DK,2019.0,1,0,1
KR,GE,2012.0,1,0,1
NO,RW,2020.0,1,0,1
BN,JP,1999.0,1,0,1
MY,VN,2012.0,1,0,1
XK,SI,2020.0,1,0,1
CL,BG,2006.0,1,0,1
,AD,2009.0,1,0,1
GD,TT,2015.0,1,0,1
BE,SA,2006.0,1,0,1
SG,LU,2020.0,1,0,1
IN,MN,2022.0,1,0,1
HU,AR,2015.0,1,0,1
DK,DZ,2017.0,1,0,1
PE,DK,2022.0,1,0,1
BY,CA,2015.0,1,0,1
CG,DE,2021.0,1,0,1
IQ,NZ,2019.0,1,0,1
KZ,CO,2016.0,1,0,1
KW,FI,2011.0,1,0,1
RW,PK,2012.0,1,0,1
QA,PL,2011.0,1,0,1
ZM,MM,2017.0,2,0,2
AO,AR,2019.0,1,0,1
SE,IL,2000.0,1,0,1
CM,KE,2009.0,1,0,1
SG,BR,2003.0,1,0,1
JO,SG,2022.0,1,0,1
IR,PS,2013.0,1,0,1
nan,GA,2013.0,1,0,1
GH,SI,2016.0,1,0,1
CA,QA,2003.0,1,0,1
SY,DE,2001.0,1,0,1
MO,US,2008.0,1,0,1
MX,BD,1998.0,1,0,1
TW,HK,2013.0,2,0,2
SI,CW,2018.0,1,0,1
IT,PS,2021.0,2,0,2
KH,CZ,2020.0,1,0,1
RU,CM,2007.0,1,0,1
ZA,IR,2008.0,1,0,1
DE,GF,2007.0,1,0,1
CR,FI,2014.0,1,0,1
NC,RE,2015.0,1,0,1
CR,IL,2012.0,1,0,1
BR,BS,2018.0,1,0,1
ZA,KG,2018.0,1,0,1
BG,BA,2012.0,1,0,1
AM,NL,2012.0,1,0,1
SD,NZ,2017.0,1,0,1
UG,CH,2022.0,1,0,1
NL,BJ,2016.0,1,0,1
KW,SD,2010.0,1,0,1
PA,UA,2015.0,1,0,1
LY,AT,2022.0,1,0,1
AM,TH,1999.0,1,0,1
NL,PS,2007.0,1,0,1
GM,GH,2019.0,1,0,1
GE,NZ,2019.0,1,0,1
PE,GT,2006.0,1,0,1
PH,EE,2013.0,1,0,1
QA,KZ,2014.0,1,0,1
BY,SE,2003.0,1,0,1
KZ,NO,2013.0,1,0,1
TT,MY,2018.0,1,0,1
NZ,IQ,2015.0,1,0,1
FR,MS,1997.0,1,0,1
AU,XK,2009.0,1,0,1
HR,BR,2003.0,1,0,1
,MK,2020.0,2,0,2
LK,IL,2008.0,1,0,1
CA,PE,1998.0,1,0,1
SJ,DE,2015.0,1,0,1
SS,AU,2004.0,1,0,1
NL,NG,2022.0,1,0,1
EG,NE,2012.0,1,0,1
SE,JO,2018.0,1,0,1
CM,IL,2020.0,1,0,1
BY,EC,2007.0,1,0,1
,KG,2020.0,1,0,1
CN,SD,2013.0,1,0,1
NG,PS,2020.0,1,0,1
BR,CG,1999.0,1,0,1
NO,US,2011.0,114,156,-42
GB,DE,2001.0,371,437,-66
US,CA,2006.0,2634,2522,112
DE,US,2016.0,2508,2636,-128
US,DE,2018.0,2790,2571,219
GB,IN,2002.0,135,162,-27
GB,JP,2009.0,290,276,14
US,KR,2010.0,1298,1090,208
FR,CN,2016.0,232,135,97
IT,TN,2016.0,22,23,-1
IT,DE,2013.0,345,226,119
CA,IN,2019.0,276,304,-28
GB,US,2014.0,6158,6006,152
US,KR,2019.0,1305,1357,-52
AU,US,2013.0,2024,2463,-439
CA,TW,2012.0,36,59,-23
DE,BR,2008.0,141,127,14
US,TW,2006.0,679,540,139
IN,nan,2016.0,70,60,10
RU,CN,2013.0,34,49,-15
US,KR,2017.0,1256,1332,-76
US,BD,2011.0,88,70,18
CA,GB,2012.0,870,868,2
US,GB,2020.0,6121,6003,118
TW,IN,2021.0,48,72,-24
US,ID,2013.0,90,72,18
US,NL,2022.0,558,389,169
US,PL,2020.0,210,257,-47
KR,US,2016.0,1276,1286,-10
ES,US,2013.0,987,1008,-21
GB,ES,2007.0,225,217,8
TW,GE,2000.0,1,1,0
CH,TH,2017.0,5,4,1
DE,JP,2013.0,176,197,-21
AT,NL,2008.0,14,21,-7
GB,EG,2008.0,47,32,15
ES,DE,2020.0,270,246,24
GB,NZ,2013.0,272,254,18
BE,IT,2003.0,45,53,-8
BR,PT,2009.0,608,542,66
CN,NZ,2010.0,35,27,8
TW,SG,2005.0,28,23,5
DK,DE,2009.0,95,135,-40
NZ,US,2011.0,335,377,-42
ZA,US,2016.0,364,345,19
CA,FR,2021.0,383,454,-71
FI,US,2001.0,104,99,5
IR,US,2011.0,341,228,113
GB,BD,2019.0,53,70,-17
JP,DE,2003.0,172,133,39
MX,CO,2009.0,162,147,15
MX,EC,2012.0,19,10,9
AR,ES,2017.0,396,407,-11
NL,AE,2022.0,5,6,-1
AT,US,2012.0,220,225,-5
AR,BR,2008.0,99,93,6
PT,MX,2017.0,22,27,-5
DE,GB,2003.0,502,434,68
BN,US,2019.0,4,3,1
GB,CN,2002.0,261,251,10
IN,PK,2021.0,354,348,6
AU,IT,2004.0,27,19,8
GB,CN,2005.0,404,318,86
VE,ES,2019.0,89,51,38
US,LU,2018.0,35,18,17
MX,ES,2021.0,792,593,199
EC,CL,2018.0,72,104,-32
IT,GB,2019.0,687,595,92
AU,GH,2015.0,5,4,1
KR,ET,2011.0,89,152,-63
CA,CH,2008.0,84,95,-11
ES,JP,2008.0,33,29,4
JP,CH,2005.0,49,56,-7
US,FR,2001.0,790,975,-185
ES,SE,2020.0,94,72,22
SE,ES,2022.0,40,58,-18
BR,US,2006.0,611,619,-8
US,DK,2006.0,206,188,18
PK,AE,2014.0,18,11,7
IE,AU,2005.0,43,64,-21
CA,IT,2017.0,119,218,-99
CA,AE,2015.0,28,15,13
CA,IN,2010.0,143,154,-11
CA,IN,2017.0,222,266,-44
CN,AU,2012.0,348,314,34
SE,CN,2007.0,78,53,25
US,SE,2020.0,493,475,18
CZ,RS,2009.0,13,17,-4
FR,IT,1998.0,108,157,-49
GB,IN,2005.0,174,207,-33
SG,CN,2003.0,137,171,-34
NZ,AU,1997.0,44,49,-5
CN,TW,2001.0,443,578,-135
ZA,IN,2014.0,56,61,-5
CH,DK,2019.0,58,62,-4
MX,US,2020.0,542,379,163
CO,AR,2005.0,22,35,-13
ID,CN,2016.0,107,215,-108
GB,PL,2020.0,107,125,-18
SI,RS,2008.0,9,5,4
VE,ES,2010.0,99,56,43
CN,CZ,2005.0,31,44,-13
KR,GB,2005.0,55,59,-4
ID,CA,2020.0,96,86,10
IN,RO,2020.0,16,7,9
GB,GR,2021.0,172,150,22
TW,AU,2019.0,64,36,28
GR,NL,2014.0,42,20,22
GB,NL,2000.0,141,138,3
DE,TH,2013.0,24,15,9
MX,BR,2000.0,20,24,-4
DE,NL,2006.0,249,230,19
DE,IN,2011.0,141,164,-23
CU,VE,2011.0,11,14,-3
HK,SG,2010.0,1,3,-2
CZ,IT,2001.0,18,21,-3
EG,SD,2021.0,30,27,3
nan,IT,2000.0,63,60,3
CN,IT,1998.0,11,9,2
IT,EG,2000.0,7,1,6
RU,GB,2007.0,84,52,32
EG,LB,2017.0,20,19,1
BR,AU,2022.0,80,57,23
IT,GB,2010.0,456,347,109
FR,CA,2022.0,275,264,11
US,SY,2012.0,14,7,7
IT,CZ,2018.0,34,37,-3
GB,IT,2006.0,289,309,-20
NZ,BE,2018.0,9,12,-3
NL,JP,2007.0,25,31,-6
DK,FR,2018.0,52,54,-2
JP,FR,2014.0,120,136,-16
JP,AT,2013.0,26,15,11
FI,HU,2005.0,5,1,4
GB,EC,2018.0,12,8,4
CN,BE,2021.0,48,56,-8
DZ,CA,2010.0,9,6,3
SE,NO,2016.0,125,82,43
IN,BD,2002.0,8,12,-4
DE,MY,2012.0,15,5,10
JP,SG,2021.0,24,27,-3
NZ,CN,2021.0,74,59,15
KE,US,2000.0,15,17,-2
TR,CZ,2015.0,10,7,3
UA,RU,2012.0,169,184,-15
PT,MX,2010.0,7,8,-1
LB,US,2004.0,31,30,1
CL,AR,2021.0,120,94,26
CA,NZ,2011.0,66,54,12
BR,DE,2020.0,289,247,42
NO,IT,2000.0,11,20,-9
JP,GR,2015.0,24,31,-7
FR,MY,2017.0,15,6,9
IT,GB,2017.0,706,477,229
IN,CA,2000.0,54,92,-38
AR,ES,2019.0,433,427,6
NO,DE,2021.0,75,98,-23
CO,FR,2013.0,31,28,3
ES,GB,2010.0,276,289,-13
US,UZ,2006.0,2,4,-2
AU,NL,2003.0,47,32,15
FR,PH,2011.0,4,8,-4
FR,DE,2007.0,407,494,-87
BE,CN,2011.0,38,95,-57
CN,CZ,2002.0,12,13,-1
CO,CN,2010.0,2,2,0
AT,HU,2020.0,39,27,12
GB,HK,2011.0,7,8,-1
IT,PT,2009.0,26,12,14
IN,CN,2000.0,20,13,7
CA,CN,2001.0,192,173,19
nan,UA,2014.0,20,18,2
AR,GB,2016.0,28,36,-8
TW,MY,2019.0,31,30,1
JP,BD,2012.0,79,35,44
SK,CZ,2014.0,132,106,26
ZM,ZA,2014.0,5,7,-2
MY,US,2021.0,130,136,-6
GE,US,2008.0,153,121,32
EG,ET,2017.0,9,1,8
EG,LB,2010.0,6,11,-5
PL,CA,2011.0,34,33,1
CH,AT,2021.0,94,100,-6
QA,FR,2019.0,7,14,-7
JP,TH,2012.0,89,65,24
RU,ES,2008.0,19,12,7
BJ,FR,2018.0,20,30,-10
FR,TN,2008.0,138,114,24
IE,AU,2002.0,33,55,-22
FR,MA,2021.0,168,138,30
BE,SE,2016.0,24,36,-12
SE,GB,2018.0,224,232,-8
DE,FI,2011.0,56,55,1
TH,JP,2004.0,33,61,-28
NP,NZ,2022.0,36,29,7
NL,NO,2008.0,23,24,-1
CH,FR,2013.0,325,452,-127
TW,AU,2017.0,67,41,26
UA,CN,1999.0,7,11,-4
TW,MY,2010.0,18,6,12
DK,SE,2001.0,40,44,-4
FI,CA,2021.0,16,19,-3
HU,AT,2020.0,27,39,-12
KZ,IT,2018.0,2,10,-8
SG,AU,2015.0,129,115,14
FR,TW,1998.0,11,4,7
DE,SE,2009.0,172,148,24
FR,JO,2005.0,5,1,4
FR,SE,2021.0,76,63,13
IN,KW,2006.0,7,3,4
IT,ES,2020.0,283,292,-9
NL,CN,2009.0,80,83,-3
JP,SK,2006.0,15,25,-10
IR,IT,2018.0,64,41,23
CZ,GB,2019.0,68,75,-7
BR,CH,2020.0,66,47,19
IE,EG,2016.0,7,5,2
AT,GR,2017.0,6,7,-1
RO,BR,2014.0,7,3,4
CZ,SK,2022.0,69,80,-11
NG,CN,2016.0,18,13,5
TR,KZ,2020.0,59,42,17
CA,IR,2020.0,172,469,-297
SG,TR,2021.0,13,3,10
EG,DE,2004.0,17,33,-16
DK,CH,2021.0,36,47,-11
AT,GB,2008.0,54,75,-21
ES,TW,2019.0,5,4,1
FR,IL,2014.0,37,32,5
CU,US,2020.0,77,30,47
MA,DE,2001.0,1,2,-1
IE,DE,2020.0,86,101,-15
US,MY,2000.0,20,19,1
EC,US,2021.0,96,73,23
US,GE,2007.0,110,157,-47
TR,BA,2019.0,4,3,1
EE,US,2003.0,9,6,3
FR,CM,2009.0,12,10,2
UA,AZ,2013.0,1,3,-2
RU,nan,2005.0,36,51,-15
CN,DE,2000.0,100,84,16
BE,RO,2014.0,15,17,-2
NO,nan,2009.0,26,33,-7
AU,LK,2020.0,41,48,-7
SA,MX,2020.0,3,8,-5
GH,GB,2018.0,20,34,-14
IE,FR,2011.0,37,29,8
SE,CZ,2018.0,18,15,3
GB,LK,2011.0,18,9,9
FI,DE,2016.0,79,68,11
NO,SE,2015.0,70,116,-46
NG,IT,2021.0,8,7,1
KR,SG,2011.0,27,25,2
ZA,CH,2006.0,4,3,1
CA,MY,2020.0,23,46,-23
CL,EC,2022.0,26,28,-2
FR,EE,2021.0,3,6,-3
ZA,VN,2015.0,1,2,-1
IL,CA,2018.0,68,65,3
NZ,FR,2020.0,24,21,3
JP,KE,2008.0,5,4,1
UA,KZ,2019.0,9,10,-1
AU,TH,1999.0,12,5,7
MY,JP,2007.0,21,20,1
CH,KE,2013.0,2,8,-6
AU,MY,2003.0,9,9,0
ZA,NG,2014.0,31,64,-33
CN,GH,2022.0,40,22,18
LK,US,2018.0,34,44,-10
US,ZA,2000.0,133,136,-3
BD,CH,2017.0,5,1,4
EG,FR,2017.0,29,33,-4
CH,SG,2012.0,14,10,4
CY,GB,2006.0,7,11,-4
TZ,IN,2016.0,3,1,2
GR,IT,2015.0,40,33,7
CZ,PT,2012.0,5,2,3
CH,PL,2009.0,17,22,-5
ES,DO,2013.0,5,2,3
SN,US,2016.0,8,12,-4
IL,SG,2015.0,3,4,-1
FJ,NZ,2020.0,4,3,1
HK,SG,2019.0,6,1,5
CY,TR,2011.0,18,19,-1
ID,EG,2020.0,68,41,27
AU,nan,2012.0,34,27,7
RU,KZ,2016.0,50,46,4
PT,AU,2017.0,17,11,6
CH,CO,2005.0,3,3,0
CM,NO,2018.0,2,1,1
IT,NL,2011.0,114,65,49
CA,HK,2010.0,5,4,1
NO,CH,2012.0,24,26,-2
KR,TR,2012.0,6,6,0
BH,US,2021.0,13,13,0
JO,RU,2006.0,1,1,0
BE,DE,1999.0,51,49,2
KE,NG,2022.0,7,7,0
SE,VN,2021.0,3,2,1
CA,IT,2019.0,131,155,-24
SG,QA,2018.0,1,4,-3
MX,DE,2018.0,56,52,4
FR,TH,2021.0,22,10,12
NZ,UG,2013.0,4,2,2
CN,NZ,2019.0,68,77,-9
CL,PE,2006.0,23,26,-3
DE,SI,2014.0,15,21,-6
KE,DE,2019.0,13,19,-6
NG,UG,2018.0,5,3,2
BD,CH,2019.0,7,5,2
KH,TH,2019.0,5,1,4
AU,SA,2022.0,53,20,33
NZ,GB,2018.0,280,293,-13
BR,TH,2020.0,6,1,5
SE,MA,2020.0,2,2,0
DE,GR,2000.0,21,19,2
ES,PE,2014.0,164,105,59
BR,MZ,2018.0,21,13,8
PH,ES,2010.0,14,10,4
IN,DE,2004.0,123,90,33
SE,MY,2021.0,2,4,-2
CR,VE,2016.0,2,7,-5
TW,AU,2010.0,30,33,-3
nan,FR,1997.0,22,35,-13
CN,NZ,2017.0,65,52,13
PT,US,2016.0,196,175,21
VE,ES,2017.0,66,53,13
FR,DZ,2015.0,191,100,91
NO,BR,2013.0,17,33,-16
SN,FR,2015.0,39,38,1
DK,PT,2009.0,1,3,-2
US,AE,2011.0,73,23,50
US,RU,2021.0,460,453,7
MD,RO,2015.0,6,6,0
US,LB,2020.0,76,122,-46
TW,MY,2017.0,37,30,7
TW,KR,2022.0,32,27,5
IR,NO,2010.0,7,6,1
SE,LU,2015.0,3,3,0
SA,YE,2020.0,18,20,-2
CZ,PK,2020.0,20,2,18
IE,MX,2022.0,2,2,0
CR,PE,2019.0,19,16,3
GR,JP,2015.0,31,24,7
IR,NO,2019.0,13,9,4
GB,ZA,1999.0,55,56,-1
AM,RU,2011.0,5,7,-2
DZ,CA,2017.0,15,11,4
SG,AE,2017.0,6,2,4
IR,NO,2017.0,16,3,13
FR,FI,2012.0,28,19,9
EG,US,2018.0,257,339,-82
IT,RU,2016.0,46,36,10
FR,LU,2013.0,52,26,26
MA,CA,2012.0,8,24,-16
PA,SE,2011.0,3,1,2
MD,FR,2003.0,51,45,6
FR,MY,2019.0,16,13,3
EC,UA,2018.0,46,5,41
NO,GB,2009.0,49,72,-23
HU,BE,2011.0,13,8,5
AU,DK,2014.0,41,38,3
BE,PL,2001.0,9,13,-4
SK,HU,2016.0,11,14,-3
AT,SE,2013.0,22,24,-2
AE,NZ,2015.0,8,3,5
HU,GB,2016.0,44,49,-5
IS,US,2000.0,8,15,-7
CR,US,2008.0,25,17,8
LT,US,2012.0,6,17,-11
GB,NG,2013.0,58,48,10
FR,BR,1999.0,55,36,19
SA,MA,2014.0,3,3,0
MY,DZ,2020.0,5,2,3
TN,PG,2015.0,6,2,4
IN,TW,2011.0,53,37,16
BR,NZ,2018.0,15,14,1
US,TR,1997.0,81,58,23
ES,PL,1997.0,6,4,2
FR,RU,2021.0,74,72,2
KE,DE,2017.0,14,19,-5
AR,CH,2018.0,20,22,-2
ML,KE,2008.0,1,1,0
CZ,UA,2019.0,30,37,-7
ZA,FR,2011.0,22,37,-15
DE,PT,2016.0,42,44,-2
EG,ET,2019.0,9,7,2
IT,NG,2013.0,7,8,-1
PH,TZ,2017.0,1,1,0
CA,SG,1999.0,20,11,9
AE,BH,2021.0,2,4,-2
nan,CO,2020.0,10,9,1
US,MC,2004.0,1,1,0
MA,IT,2021.0,23,30,-7
BB,GB,2018.0,3,4,-1
PT,AU,2010.0,8,10,-2
ID,IN,2014.0,17,22,-5
SG,NZ,2012.0,10,7,3
GB,SD,2007.0,4,8,-4
DK,PL,2012.0,11,8,3
US,KZ,2017.0,20,20,0
HU,RU,2016.0,10,17,-7
MY,LY,2019.0,21,4,17
CA,NP,2020.0,5,14,-9
RU,CZ,2012.0,28,32,-4
IT,PL,2014.0,28,23,5
IT,ID,2011.0,7,1,6
nan,VN,2020.0,7,5,2
GH,ID,2018.0,19,23,-4
HU,FR,1998.0,19,17,2
US,GH,2016.0,59,27,32
MX,PE,2008.0,28,36,-8
VE,AR,2014.0,18,10,8
CZ,UA,2017.0,29,22,7
FR,CL,2008.0,22,33,-11
BR,PY,2020.0,20,10,10
UA,IL,2011.0,3,2,1
LT,JP,2011.0,8,5,3
CN,ZA,2004.0,6,7,-1
RU,JP,2018.0,26,67,-41
EG,PK,2021.0,21,20,1
JP,EG,2000.0,22,20,2
NL,IN,2018.0,63,56,7
GB,EE,2020.0,13,10,3
TR,BA,2017.0,7,2,5
HU,CN,2006.0,9,2,7
PT,AU,2019.0,17,9,8
GH,AU,2016.0,15,9,6
CO,CN,2019.0,8,5,3
DE,IL,2015.0,58,55,3
ID,DK,2019.0,8,5,3
PR,KR,2004.0,31,17,14
EG,CA,2016.0,66,90,-24
NL,FR,2000.0,67,116,-49
UA,EC,1998.0,4,1,3
GB,CO,2005.0,16,13,3
nan,CL,2016.0,10,6,4
MX,IT,2006.0,28,24,4
CH,DK,2017.0,46,39,7
RO,PL,2018.0,10,10,0
IS,DK,2005.0,4,9,-5
AU,AT,2022.0,19,14,5
UA,DE,2003.0,29,16,13
BE,TN,2022.0,4,1,3
DE,EC,2019.0,10,12,-2
nan,NO,2015.0,24,19,5
CA,CO,2018.0,24,38,-14
UG,ZA,2021.0,13,16,-3
CO,EC,2022.0,50,39,11
RU,NO,2004.0,7,2,5
TR,PK,2019.0,20,18,2
US,QA,2012.0,51,47,4
RS,US,1999.0,20,21,-1
HU,FR,1997.0,9,10,-1
CA,KW,2021.0,8,9,-1
AE,CN,2022.0,8,8,0
HR,GB,2008.0,7,5,2
UZ,CN,2008.0,13,16,-3
TZ,NP,2020.0,1,1,0
ES,FR,2023.0,7,15,-8
NO,IL,2018.0,1,1,0
NZ,MY,2022.0,8,7,1
GH,DK,2017.0,1,2,-1
CH,DK,2010.0,24,26,-2
ZA,LS,2006.0,2,1,1
ES,PK,2014.0,2,5,-3
IE,RS,2006.0,2,1,1
JM,US,2021.0,13,13,0
DE,KE,2015.0,16,8,8
AT,AU,2020.0,33,35,-2
IQ,ID,2021.0,5,15,-10
nan,MY,2006.0,19,12,7
BI,FR,2016.0,13,17,-4
GB,CO,2002.0,11,7,4
US,PA,2000.0,13,10,3
IQ,HU,2019.0,6,1,5
BR,AR,2004.0,42,64,-22
MX,NL,2018.0,17,17,0
UG,BE,2021.0,6,9,-3
DE,SG,2015.0,39,45,-6
AT,IR,2020.0,16,28,-12
US,GD,2018.0,21,16,5
ID,AU,2012.0,21,44,-23
ZA,JP,2020.0,5,5,0
SG,JP,2011.0,25,43,-18
EG,FR,2019.0,15,47,-32
SG,PH,2018.0,12,6,6
CA,DK,2021.0,44,34,10
RO,US,2004.0,37,40,-3
DZ,EG,2019.0,13,6,7
BY,nan,2018.0,2,1,1
CY,ES,2019.0,1,3,-2
IT,CL,2009.0,21,12,9
DK,ES,2001.0,21,17,4
TN,IR,2015.0,7,9,-2
KW,EG,2014.0,30,28,2
GB,IR,2000.0,24,4,20
ET,US,2021.0,44,50,-6
nan,DE,2008.0,62,52,10
CO,AG,2021.0,40,28,12
DZ,AE,2017.0,2,1,1
nan,NZ,2006.0,15,18,-3
AF,MY,2021.0,3,4,-1
DE,IR,2011.0,32,48,-16
EG,BD,2021.0,10,12,-2
ET,CN,2015.0,5,5,0
CH,TN,2009.0,8,5,3
KW,US,2014.0,17,26,-9
KR,TW,2007.0,29,23,6
BE,SK,2010.0,4,3,1
SE,BD,2013.0,5,4,1
IN,CZ,2009.0,20,21,-1
SK,HR,2015.0,6,6,0
CA,MA,2009.0,15,8,7
SD,CN,2015.0,5,6,-1
NL,SK,2007.0,6,6,0
CZ,PL,2009.0,29,29,0
US,ML,2014.0,4,7,-3
TH,DE,2012.0,18,21,-3
NL,SE,2012.0,45,52,-7
US,TT,2017.0,12,4,8
ES,AT,1999.0,7,1,6
CN,IT,1997.0,11,10,1
TJ,RU,2014.0,33,25,8
CG,FR,2000.0,8,3,5
BE,LV,2018.0,2,1,1
LU,BR,2021.0,3,9,-6
SE,TZ,2016.0,3,2,1
BD,JP,2008.0,35,69,-34
MY,ZA,2015.0,5,3,2
UG,US,2005.0,4,15,-11
FR,DK,2000.0,19,9,10
MZ,PL,2019.0,6,4,2
MY,BR,2000.0,13,24,-11
GB,KW,2009.0,12,3,9
NL,CL,2015.0,20,9,11
HN,MX,2006.0,8,9,-1
US,SG,2023.0,16,13,3
NG,SE,2007.0,2,2,0
FR,UA,1999.0,8,15,-7
AT,GR,2019.0,11,9,2
IR,CA,2004.0,26,40,-14
IT,DK,2012.0,31,17,14
MZ,PL,2010.0,6,8,-2
DE,CL,1999.0,12,11,1
SA,QA,2022.0,21,18,3
FR,HU,2018.0,26,19,7
KR,CH,2003.0,3,4,-1
MX,TR,2013.0,6,3,3
UA,ES,2005.0,5,4,1
MY,BH,2017.0,5,4,1
NZ,CA,2004.0,45,36,9
RU,BE,2002.0,19,16,3
GB,LU,2014.0,9,6,3
CA,HK,2017.0,5,4,1
SI,SE,2009.0,1,2,-1
GR,CY,2008.0,18,10,8
SK,GB,2013.0,20,19,1
HU,MA,2011.0,5,1,4
nan,ZA,2018.0,9,9,0
IE,SE,2015.0,11,7,4
AU,CH,2023.0,6,4,2
KR,GB,2002.0,50,44,6
FR,QA,2011.0,11,2,9
SI,IN,2013.0,1,1,0
CN,BY,2013.0,3,2,1
CL,CR,2009.0,12,12,0
GB,TT,2020.0,4,3,1
BG,GB,2005.0,8,10,-2
CA,SA,1999.0,9,6,3
SE,JO,2019.0,2,1,1
IN,BD,2005.0,16,20,-4
PK,IE,2015.0,7,8,-1
LU,DE,2012.0,23,43,-20
BR,GT,2018.0,3,6,-3
ML,IN,2022.0,2,6,-4
AR,CU,2005.0,8,10,-2
AU,BB,2005.0,1,1,0
FR,MY,2010.0,13,4,9
AT,DK,2022.0,12,17,-5
MX,CR,2014.0,23,32,-9
AU,FI,1998.0,3,2,1
JP,CH,2002.0,55,52,3
FR,PA,2021.0,1,2,-1
PT,VE,2011.0,5,5,0
SE,BE,2018.0,26,32,-6
FR,EG,2003.0,5,1,4
IT,NO,2012.0,24,13,11
FI,HU,2002.0,6,3,3
CL,NL,2019.0,19,9,10
FR,BI,2006.0,18,10,8
KR,nan,1998.0,9,9,0
BR,MY,2000.0,24,13,11
JP,SE,2004.0,42,23,19
LY,AU,2015.0,1,2,-1
CU,BR,2018.0,33,22,11
GB,UG,2006.0,6,8,-2
SA,CN,2012.0,10,22,-12
NG,CM,2014.0,3,1,2
PT,BE,2002.0,3,4,-1
SG,SA,2013.0,8,2,6
US,SK,1999.0,26,26,0
MA,DZ,2006.0,2,1,1
IN,IE,2004.0,8,4,4
NL,IL,2022.0,6,5,1
SE,GR,2015.0,6,32,-26
FI,TW,2018.0,2,2,0
TW,IT,2010.0,4,1,3
CH,PK,1999.0,3,5,-2
UG,CH,2016.0,7,2,5
CN,AE,2013.0,5,4,1
CA,JM,2011.0,5,2,3
nan,AT,1999.0,7,13,-6
CN,VN,2021.0,21,18,3
BH,KE,2007.0,8,3,5
MY,NZ,2015.0,18,35,-17
GR,LK,2012.0,4,1,3
IR,SI,2015.0,1,1,0
ID,ZA,2011.0,1,1,0
PT,MX,2019.0,25,33,-8
TW,ES,2013.0,11,3,8
KZ,RU,2000.0,6,3,3
RU,nan,2002.0,35,10,25
BH,ZA,2016.0,4,1,3
TW,IT,2019.0,6,5,1
UZ,US,2006.0,4,2,2
CA,SK,1998.0,3,2,1
PG,US,2018.0,1,3,-2
FI,CO,2021.0,3,3,0
AT,SA,2019.0,7,2,5
RS,MX,2008.0,26,50,-24
EG,PS,2012.0,3,1,2
AR,PT,2009.0,8,6,2
AR,SE,2003.0,5,5,0
TR,PK,2017.0,9,22,-13
KR,AM,2011.0,2,8,-6
DZ,CA,2019.0,17,26,-9
IT,ZA,2021.0,19,18,1
CZ,nan,2011.0,5,12,-7
BG,NO,2004.0,6,7,-1
NO,HR,2002.0,4,3,1
RU,SG,2006.0,3,2,1
FR,MD,2013.0,41,64,-23
MK,AU,2012.0,37,42,-5
IS,GB,2020.0,7,10,-3
NZ,IE,2000.0,6,2,4
SK,JP,2007.0,13,12,1
TR,NL,2000.0,5,10,-5
NL,NZ,2011.0,9,16,-7
PH,ES,2019.0,19,22,-3
CA,BE,2000.0,20,20,0
BE,DK,2012.0,33,13,20
CL,VE,2016.0,21,28,-7
DE,ZA,2011.0,41,48,-7
CN,LU,2012.0,5,1,4
TW,HK,2008.0,5,1,4
SD,KR,2022.0,15,15,0
OM,TR,2011.0,3,1,2
TT,IN,2012.0,5,3,2
PL,IE,2017.0,13,4,9
SI,FR,2004.0,5,2,3
FR,NZ,2013.0,15,20,-5
CR,CO,2007.0,7,8,-1
PK,JP,2015.0,3,19,-16
GR,CZ,2005.0,8,2,6
CH,AU,2021.0,72,66,6
RU,LV,2012.0,26,22,4
RO,AT,2004.0,3,2,1
IT,MA,2014.0,25,38,-13
GR,TR,2009.0,12,4,8
CI,KE,2014.0,1,2,-1
US,TT,2019.0,13,9,4
TW,CL,2004.0,1,1,0
US,CM,1999.0,1,3,-2
NG,CG,2019.0,7,2,5
KR,RU,2014.0,18,9,9
BE,SK,2019.0,2,1,1
nan,FI,2013.0,17,8,9
IN,PL,2014.0,12,16,-4
GB,ZM,2013.0,11,5,6
VE,BR,2007.0,17,14,3
SE,BR,2003.0,8,10,-2
CD,BE,2007.0,1,1,0
IL,ES,2011.0,14,4,10
KW,CA,2005.0,5,1,4
BY,CZ,2008.0,16,7,9
KE,JP,2017.0,4,12,-8
FI,NO,2013.0,14,12,2
KE,DE,2010.0,9,13,-4
KE,JP,2010.0,5,8,-3
IT,NZ,2020.0,7,10,-3
MG,US,2021.0,2,2,0
TH,NZ,2015.0,7,5,2
US,TZ,2014.0,25,14,11
BG,BE,2003.0,8,1,7
PL,AU,2018.0,16,19,-3
NZ,SE,2006.0,1,5,-4
SE,AT,2014.0,25,33,-8
AT,ET,2018.0,8,2,6
PT,BE,2005.0,3,5,-2
DE,UA,2001.0,16,43,-27
HU,SA,2012.0,1,1,0
SE,ET,2001.0,4,4,0
SA,DE,2011.0,7,22,-15
CH,HU,1999.0,2,1,1
DE,MD,2019.0,4,6,-2
JP,IQ,2016.0,3,4,-1
DE,PE,2015.0,10,12,-2
NG,DE,2005.0,5,6,-1
BR,SE,2005.0,11,23,-12
SE,MX,2009.0,6,1,5
SI,HR,1998.0,1,2,-1
PT,RU,1997.0,2,4,-2
AR,TW,2008.0,11,4,7
SD,ZA,2017.0,4,2,2
PT,CO,2009.0,6,7,-1
MX,nan,2009.0,15,13,2
EG,ES,2012.0,5,9,-4
CO,FI,2021.0,3,3,0
AU,IL,2013.0,11,18,-7
AT,KR,2015.0,11,6,5
BE,NO,1999.0,6,3,3
MA,US,2014.0,19,22,-3
SD,ZA,2019.0,2,3,-1
GT,MX,2004.0,4,4,0
ES,PL,1998.0,4,2,2
MX,PK,2013.0,2,3,-1
SI,ES,2012.0,9,16,-7
CA,CR,2020.0,6,2,4
EG,AU,2009.0,7,7,0
HK,US,2011.0,13,11,2
SE,IN,2007.0,14,18,-4
JP,TR,2008.0,37,28,9
PK,OM,2018.0,7,8,-1
CU,IT,2012.0,6,2,4
MY,LY,2017.0,8,3,5
TW,IT,2017.0,5,6,-1
TR,SE,2022.0,13,11,2
AT,SA,2017.0,4,5,-1
AU,MK,2008.0,26,16,10
ZA,PH,2017.0,2,2,0
UA,nan,2015.0,17,17,0
SA,CH,2018.0,4,10,-6
US,CZ,2023.0,5,9,-4
CO,AR,2002.0,12,19,-7
US,NG,2000.0,11,13,-2
US,AF,2018.0,3,4,-1
GR,ZA,2017.0,4,3,1
FI,IL,2020.0,2,7,-5
KR,FR,2002.0,19,14,5
EG,TN,2015.0,9,17,-8
IN,MX,2009.0,10,7,3
UG,GB,2013.0,9,9,0
MA,PT,2009.0,2,1,1
FI,EE,2009.0,7,6,1
ID,KE,2011.0,1,4,-3
RU,EE,2016.0,9,7,2
PL,RS,2004.0,4,1,3
MY,EG,2022.0,19,18,1
CH,TH,2019.0,6,5,1
DE,EC,2017.0,9,3,6
HR,ZA,2013.0,1,1,0
IE,FI,2016.0,6,10,-4
KW,GR,2020.0,4,3,1
RS,NL,2016.0,3,3,0
IT,ET,2022.0,4,5,-1
IE,BR,2015.0,11,3,8
CH,AR,1999.0,2,4,-2
ES,QA,2018.0,8,12,-4
NZ,LK,2017.0,5,5,0
NP,TH,2007.0,1,3,-2
TR,PT,2005.0,2,2,0
GB,MW,2004.0,5,1,4
AU,UZ,2012.0,2,2,0
LY,GB,2020.0,5,20,-15
IN,RU,2012.0,9,20,-11
MG,FR,2014.0,8,11,-3
LY,MY,2017.0,3,8,-5
PL,BD,2009.0,1,4,-3
RO,UA,2013.0,3,5,-2
IR,DK,2018.0,30,15,15
DE,MT,2019.0,1,3,-2
SI,BE,1998.0,2,3,-1
CH,LV,2022.0,1,1,0
MK,BG,2014.0,2,1,1
SA,SE,2022.0,4,11,-7
ES,RS,2000.0,1,1,0
OM,MY,2016.0,4,6,-2
TH,NL,2020.0,7,13,-6
NE,CA,2010.0,1,1,0
NG,GR,2012.0,2,3,-1
ES,SG,2002.0,3,2,1
BE,UG,2004.0,1,1,0
EG,BR,2018.0,5,6,-1
PK,BN,2017.0,3,1,2
NL,KR,2012.0,11,7,4
HK,AU,2018.0,9,2,7
TR,TG,2007.0,1,2,-1
US,BW,1998.0,1,1,0
LU,SE,2008.0,2,1,1
US,KW,2000.0,16,11,5
GH,BW,2016.0,1,2,-1
QA,OM,2015.0,4,4,0
RS,HU,2021.0,5,4,1
PE,HN,2014.0,2,1,1
IL,BR,2020.0,8,13,-5
GR,BG,2002.0,2,3,-1
JO,CY,2020.0,2,4,-2
PT,TR,2000.0,1,1,0
JM,IN,2015.0,2,3,-1
UZ,TJ,2021.0,4,9,-5
PA,CL,2021.0,3,6,-3
NL,FI,2003.0,16,21,-5
BH,GH,2021.0,25,8,17
MD,US,2003.0,6,2,4
TN,MA,2006.0,6,14,-8
IN,NP,2001.0,12,11,1
GH,DK,2019.0,2,1,1
RE,US,2018.0,2,2,0
US,LY,2018.0,5,3,2
BO,IR,2018.0,2,4,-2
SA,TW,2008.0,3,1,2
CN,GR,2022.0,6,5,1
PK,PL,2013.0,5,7,-2
UY,FR,2011.0,4,5,-1
IN,GH,2008.0,1,4,-3
AM,LT,2014.0,2,2,0
IE,IL,2008.0,2,6,-4
HR,NO,2004.0,2,1,1
AR,JP,2007.0,8,3,5
SE,AE,2006.0,3,1,2
ZA,ES,2018.0,7,15,-8
CH,CM,2015.0,3,3,0
PH,NL,2016.0,4,8,-4
CZ,UA,2010.0,13,5,8
AU,GE,2013.0,2,3,-1
AU,NC,2016.0,2,4,-2
TN,US,2004.0,5,10,-5
PL,DK,2005.0,4,3,1
AT,PL,2012.0,14,18,-4
CA,GR,2006.0,10,7,3
PL,PH,2002.0,2,6,-4
BA,TR,2019.0,3,4,-1
JM,BB,2006.0,2,3,-1
CO,BR,2004.0,14,31,-17
RS,BA,2003.0,3,1,2
AL,SE,2007.0,2,2,0
KR,NL,2014.0,8,11,-3
SE,TR,2022.0,11,13,-2
BD,TR,2021.0,3,3,0
ES,PA,1997.0,2,1,1
NL,AR,2020.0,6,13,-7
IE,KR,2019.0,4,7,-3
ES,HN,2021.0,8,6,2
IL,IT,2002.0,7,6,1
PH,DE,2009.0,5,4,1
PK,ES,2015.0,6,5,1
EC,RU,2000.0,2,1,1
SG,CA,2003.0,18,22,-4
IL,ET,2018.0,1,2,-1
TR,IT,2012.0,10,21,-11
IN,IT,1997.0,12,21,-9
ZA,SZ,2008.0,3,1,2
SD,OM,2019.0,4,1,3
PY,CR,2019.0,2,4,-2
nan,LB,2020.0,2,2,0
RS,SE,2020.0,7,4,3
PE,PA,2017.0,4,2,2
NZ,LK,2019.0,11,5,6
BD,CN,2003.0,2,3,-1
US,PS,2003.0,2,2,0
MW,US,2007.0,2,7,-5
HU,CA,2002.0,11,6,5
CL,KR,2022.0,2,1,1
KZ,GB,2013.0,3,3,0
MY,BE,2018.0,4,2,2
AT,SA,2010.0,2,1,1
TR,RO,2015.0,3,4,-1
RS,BE,2020.0,5,2,3
GB,GE,2018.0,3,7,-4
AE,OM,2012.0,1,1,0
AM,KR,2016.0,2,1,1
NG,DE,2002.0,3,6,-3
MZ,LT,2011.0,9,1,8
RO,PT,2000.0,1,1,0
BE,QA,2014.0,2,1,1
PY,FR,2012.0,2,1,1
BE,MX,1997.0,2,3,-1
TN,IT,2006.0,2,4,-2
CH,CO,2002.0,2,1,1
VE,FR,1999.0,2,8,-6
CN,TR,2007.0,3,11,-8
DE,CM,2020.0,8,11,-3
HR,IE,2013.0,7,8,-1
BO,US,2000.0,4,2,2
BN,US,2017.0,5,3,2
PK,IR,2013.0,10,8,2
LK,GB,2011.0,9,18,-9
AR,CU,2002.0,3,7,-4
CI,MA,2017.0,2,2,0
ST,PT,2015.0,1,2,-1
HU,IL,2020.0,4,1,3
JP,FI,2022.0,6,7,-1
PT,nan,2014.0,13,29,-16
BG,JP,2011.0,3,1,2
IQ,MM,2022.0,5,3,2
MY,IQ,2023.0,3,1,2
UG,TH,2014.0,1,1,0
PK,NL,2022.0,5,4,1
NL,KZ,2022.0,1,1,0
PS,CA,2022.0,1,2,-1
BR,AZ,2020.0,1,1,0
JP,NG,2016.0,14,14,0
BE,FI,2009.0,8,9,-1
SV,ES,2021.0,4,1,3
BW,NG,2015.0,2,3,-1
NL,NG,2016.0,5,6,-1
CH,ZA,2006.0,3,4,-1
SI,LT,2017.0,2,1,1
JP,KZ,2021.0,4,3,1
CR,CU,2005.0,1,4,-3
ES,nan,2004.0,11,7,4
PL,nan,2000.0,2,2,0
PL,IE,2019.0,7,7,0
GT,ES,2005.0,3,4,-1
KE,CA,1999.0,1,3,-2
VN,AE,2019.0,2,1,1
MY,ES,2023.0,2,1,1
PK,KR,2006.0,3,3,0
US,TT,2010.0,9,9,0
SE,KE,2009.0,4,1,3
EC,BE,2016.0,3,7,-4
RU,MZ,2011.0,10,20,-10
GB,PE,2000.0,3,1,2
RU,GE,2017.0,10,5,5
ES,PA,1998.0,2,4,-2
CL,CN,2015.0,5,4,1
GH,BH,2018.0,9,20,-11
ID,SI,2014.0,3,4,-1
IT,DO,2022.0,2,1,1
PL,FR,1998.0,24,22,2
nan,HU,2019.0,6,5,1
US,IQ,2007.0,5,2,3
nan,HU,2017.0,6,7,-1
CL,NL,2010.0,5,3,2
SI,JP,2021.0,1,3,-2
ES,CY,2019.0,3,1,2
CU,EC,2013.0,10,1,9
FR,UY,2011.0,5,4,1
EE,AT,2020.0,4,6,-2
NC,FR,2022.0,6,8,-2
GH,NL,2015.0,3,5,-2
FR,TW,1997.0,2,6,-4
DO,ES,2002.0,1,1,0
PL,DK,2002.0,5,5,0
DE,VN,2009.0,8,6,2
CH,LU,2007.0,3,3,0
PL,BG,2010.0,3,2,1
IS,DK,2002.0,2,5,-3
CI,IT,2006.0,1,1,0
LV,LT,2022.0,1,1,0
RU,BE,2005.0,11,12,-1
SG,DK,2009.0,8,3,5
AR,NZ,2013.0,1,2,-1
EG,OM,2003.0,2,2,0
BE,IR,2003.0,2,1,1
UA,ES,2002.0,1,2,-1
HK,GB,2020.0,5,5,0
BD,PS,2018.0,1,1,0
UY,PE,2012.0,3,2,1
RS,AU,1999.0,1,1,0
HU,CA,2005.0,10,6,4
CN,PH,2001.0,8,8,0
CH,UG,2021.0,4,2,2
BE,SK,2017.0,2,2,0
TT,JM,2016.0,10,37,-27
RU,DK,2002.0,7,4,3
AL,IT,2016.0,1,6,-5
ST,BR,2001.0,6,6,0
DE,MD,2010.0,2,3,-1
KW,NG,2015.0,1,1,0
NL,CI,2012.0,1,1,0
GB,GM,2001.0,2,7,-5
nan,CU,2006.0,1,2,-1
IL,TH,2010.0,2,1,1
RW,CN,2016.0,2,1,1
DZ,EG,2017.0,4,6,-2
QA,GR,2020.0,4,4,0
TW,FR,2021.0,5,16,-11
BR,UY,1999.0,7,10,-3
CN,BG,2020.0,3,7,-4
BR,ZM,2016.0,4,7,-3
JP,UZ,2017.0,2,4,-2
SA,UA,2020.0,3,3,0
SK,NL,2009.0,3,6,-3
LU,IN,2021.0,6,5,1
DZ,TN,2022.0,9,13,-4
BE,DZ,2015.0,3,6,-3
NO,PK,2015.0,6,7,-1
DE,MD,2017.0,1,5,-4
HU,BR,2015.0,4,2,2
UA,RO,2002.0,2,3,-1
KE,CH,2008.0,3,1,2
EG,BN,2018.0,2,1,1
SA,ET,2022.0,3,1,2
SG,FI,2016.0,6,2,4
TW,PK,2005.0,1,4,-3
AT,MY,2015.0,3,2,1
MX,UY,2009.0,4,6,-2
RU,PL,2003.0,16,11,5
FI,VN,2019.0,2,2,0
MX,ZA,2006.0,3,2,1
CR,PE,2010.0,3,3,0
IL,AR,2020.0,1,5,-4
EC,BY,2019.0,5,3,2
HR,SK,2013.0,3,2,1
AT,SK,2000.0,8,4,4
IL,IT,2005.0,9,6,3
nan,KW,2019.0,1,1,0
RU,GE,2019.0,8,7,1
KN,BR,2020.0,2,1,1
IT,TH,2014.0,3,6,-3
RU,EC,2018.0,4,9,-5
LB,IR,2018.0,6,2,4
GF,FR,2011.0,10,9,1
BG,GB,2002.0,6,7,-1
FR,CR,2003.0,2,1,1
CU,CH,2012.0,3,1,2
BR,ZA,2020.0,15,11,4
LY,MY,2019.0,4,21,-17
GW,NL,2004.0,1,1,0
HU,NL,1999.0,5,5,0
NO,AR,2011.0,1,2,-1
DZ,SA,2016.0,6,7,-1
MK,RS,2017.0,4,2,2
MC,CA,2019.0,1,1,0
AE,IE,2013.0,2,6,-4
SA,BH,1997.0,1,1,0
SN,BJ,2014.0,1,3,-2
PK,AU,2001.0,7,1,6
BD,TW,2019.0,2,1,1
BR,SE,2002.0,6,8,-2
RU,IR,2001.0,3,1,2
NP,GB,2011.0,7,6,1
UY,PY,2019.0,4,2,2
SA,LB,2020.0,8,12,-4
BR,UG,2018.0,4,1,3
IQ,FR,2018.0,2,14,-12
KG,KZ,2021.0,1,12,-11
GR,IN,2021.0,2,2,0
QA,LB,2018.0,6,4,2
SI,US,1999.0,14,8,6
HN,EC,2016.0,3,1,2
RU,GE,2010.0,1,3,-2
ZA,GH,2012.0,7,7,0
MX,IE,2015.0,3,5,-2
IL,TW,2019.0,5,1,4
GR,CZ,2002.0,2,3,-1
GB,CY,2000.0,4,2,2
MY,PS,2010.0,1,1,0
CN,CM,2014.0,2,3,-1
SA,AM,2020.0,1,1,0
NZ,NG,2020.0,4,7,-3
KR,TZ,2014.0,2,1,1
SV,CL,2007.0,2,1,1
CY,ES,2017.0,1,1,0
SG,AE,2019.0,2,3,-1
VE,SE,1999.0,2,4,-2
EE,NO,2012.0,3,1,2
VN,HU,2015.0,1,1,0
MW,NO,2011.0,1,2,-1
US,GT,2000.0,2,2,0
CU,PT,2008.0,2,4,-2
PL,BE,1999.0,3,5,-2
GR,SI,2007.0,1,1,0
US,BF,2011.0,3,1,2
FR,NG,1998.0,2,1,1
RO,GR,2012.0,2,2,0
PK,BE,2015.0,4,4,0
MY,OM,2011.0,3,4,-1
AE,TN,2016.0,5,3,2
RO,MY,2015.0,1,3,-2
MY,AR,2007.0,1,2,-1
PA,AU,2001.0,1,3,-2
IT,MC,2021.0,1,1,0
DK,AR,2012.0,3,1,2
EG,AE,2002.0,7,8,-1
MT,BR,2018.0,1,3,-2
PE,PA,2019.0,5,5,0
AT,BR,2011.0,8,15,-7
AU,TT,2011.0,1,2,-1
RO,IT,2013.0,9,21,-12
AU,SK,2013.0,3,3,0
JP,KH,2022.0,2,3,-1
CL,CU,2008.0,10,20,-10
BE,BR,1999.0,13,9,4
LU,GB,2012.0,4,12,-8
RU,DK,2005.0,6,7,-1
SA,BE,2019.0,1,5,-4
VN,CH,2018.0,3,6,-3
GB,TN,2020.0,4,9,-5
SA,JP,2014.0,6,21,-15
TN,GB,2009.0,4,3,1
NG,SA,2011.0,3,6,-3
IS,FR,2007.0,3,1,2
PT,VN,2012.0,1,1,0
FR,SK,2021.0,2,6,-4
BB,US,2004.0,1,1,0
SA,GR,2016.0,2,7,-5
MX,AT,2022.0,3,1,2
IE,ZA,2006.0,4,2,2
NI,MX,2011.0,2,2,0
ZA,MW,2008.0,2,2,0
FO,DK,2016.0,1,2,-1
LT,CA,2006.0,1,1,0
DK,HU,2006.0,1,2,-1
MA,ML,2017.0,2,2,0
JM,CA,2021.0,2,4,-2
GT,HN,2014.0,1,1,0
HU,nan,2021.0,3,3,0
RW,CA,2014.0,1,1,0
SA,BE,2017.0,2,7,-5
BR,PA,2017.0,3,13,-10
GR,ZA,2010.0,2,2,0
SE,UA,2009.0,5,6,-1
PH,BD,2015.0,3,3,0
CH,LI,2008.0,1,2,-1
DE,BD,2005.0,2,2,0
PK,BR,2004.0,2,3,-1
BE,CM,2011.0,5,3,2
IT,CO,2004.0,2,1,1
DZ,SE,2013.0,2,1,1
TR,DZ,2013.0,1,2,-1
ES,CY,2017.0,1,1,0
AE,LY,2009.0,1,1,0
ES,TH,2018.0,4,2,2
MY,RU,2011.0,5,7,-2
CZ,ZW,2019.0,1,3,-2
PH,MX,2007.0,2,3,-1
HR,SE,2009.0,2,2,0
US,KZ,2010.0,2,4,-2
PL,SG,2018.0,4,1,3
QA,BH,2022.0,2,1,1
KH,JP,2000.0,1,3,-2
BE,MX,1998.0,3,1,2
VN,nan,2012.0,1,3,-2
AT,RO,2015.0,6,12,-6
PR,VN,2001.0,1,1,0
GN,US,2011.0,1,1,0
SE,QA,2004.0,5,1,4
PA,CU,2014.0,3,1,2
DZ,CN,2007.0,1,2,-1
KE,CN,2022.0,8,6,2
PS,HU,2022.0,1,1,0
SG,KR,2023.0,6,2,4
TR,SG,2021.0,3,13,-10
VN,MY,2014.0,3,3,0
DK,BG,2014.0,1,1,0
KE,IN,2012.0,4,5,-1
MZ,US,2014.0,5,2,3
AE,FI,2020.0,2,4,-2
ES,KR,2004.0,3,7,-4
ZA,MY,2014.0,6,6,0
RW,SA,2020.0,1,4,-3
TH,BT,2021.0,2,1,1
SK,BE,2006.0,3,4,-1
BG,DE,2022.0,8,14,-6
CG,CA,2010.0,1,1,0
MY,SA,2009.0,8,11,-3
UG,US,2002.0,5,5,0
MZ,RU,2006.0,2,13,-11
NZ,LK,2010.0,1,4,-3
SI,NL,2008.0,2,2,0
LA,US,2019.0,1,1,0
RO,nan,2002.0,2,1,1
HU,GR,2005.0,1,3,-2
KR,ID,2009.0,3,3,0
SN,CA,2005.0,1,2,-1
JO,ES,2005.0,2,2,0
TW,TR,2023.0,1,1,0
BN,US,2010.0,1,3,-2
TH,CA,2000.0,1,2,-1
GR,NO,2013.0,7,3,4
TW,VN,2005.0,2,5,-3
ES,RO,2009.0,10,9,1
US,MM,2011.0,2,2,0
ZA,PH,2010.0,2,1,1
IT,BJ,2014.0,1,2,-1
LT,CZ,2006.0,2,5,-3
IR,BH,2019.0,3,1,2
UG,RW,2020.0,2,1,1
IL,SE,2004.0,2,1,1
SG,TH,2009.0,2,2,0
TH,PK,2011.0,2,1,1
EE,HU,2011.0,1,2,-1
CI,DE,2003.0,1,1,0
CO,IN,2018.0,5,3,2
EG,AE,2005.0,7,11,-4
MA,AE,2016.0,3,3,0
CH,TH,2010.0,1,2,-1
DZ,AE,2019.0,3,1,2
IR,PS,2008.0,1,1,0
BR,PA,2019.0,1,5,-4
UZ,PL,2016.0,1,2,-1
IQ,GB,2005.0,2,1,1
CM,NE,2008.0,2,1,1
CA,PS,2009.0,1,1,0
CD,US,2017.0,3,5,-2
KH,FR,2018.0,5,13,-8
NL,CZ,1999.0,4,4,0
GE,FR,1997.0,2,2,0
AU,FI,1997.0,1,2,-1
IL,AT,2012.0,5,3,2
FR,TZ,2009.0,1,3,-2
ET,ES,2018.0,2,3,-1
SA,MK,2020.0,1,4,-3
CA,DZ,2004.0,1,7,-6
CA,HK,2019.0,5,4,1
PT,AO,2016.0,4,4,0
PE,AU,2018.0,4,3,1
SE,CL,2007.0,4,4,0
JP,UZ,2019.0,2,1,1
PT,JP,1999.0,3,1,2
LT,PL,2008.0,2,2,0
BG,AT,1998.0,2,2,0
TH,SE,2013.0,1,7,-6
KG,UA,2021.0,1,2,-1
QA,FR,2010.0,1,9,-8
IL,PH,2009.0,1,1,0
NG,NO,2020.0,2,2,0
SI,EG,2014.0,1,1,0
PY,CU,2020.0,7,6,1
LB,CU,2009.0,1,1,0
IL,SA,2016.0,1,2,-1
AT,GR,2010.0,2,5,-3
VN,NO,2022.0,2,4,-2
DE,AM,2003.0,4,3,1
ZA,AT,2014.0,5,2,3
PR,US,2005.0,2,3,-1
CZ,CO,2021.0,1,4,-3
nan,AE,2018.0,2,8,-6
DE,EC,2010.0,3,2,1
PL,MX,2013.0,6,8,-2
CR,GB,2015.0,1,6,-5
CG,CA,2019.0,1,2,-1
TH,AE,2017.0,1,2,-1
SA,RO,2016.0,1,1,0
BW,ZM,2012.0,2,1,1
SI,BY,2001.0,1,2,-1
AZ,JP,2018.0,1,4,-3
SK,AT,2016.0,12,17,-5
DE,LI,2007.0,5,1,4
AU,VN,1999.0,2,2,0
AT,TR,2014.0,9,9,0
AR,AT,2014.0,4,3,1
TR,ES,1997.0,2,2,0
PS,EG,2014.0,3,3,0
PL,CN,2000.0,2,4,-2
BD,KR,1997.0,1,1,0
SE,LV,2007.0,2,1,1
PA,CO,2008.0,2,4,-2
IS,DE,2018.0,1,4,-3
AR,FR,2023.0,1,3,-2
CA,VE,2011.0,2,7,-5
GA,FR,2008.0,3,7,-4
LT,NL,2016.0,2,2,0
GE,IN,2009.0,1,1,0
SV,PE,2015.0,1,3,-2
IT,UY,2022.0,2,5,-3
BR,ME,2016.0,1,1,0
PL,ZA,2015.0,2,7,-5
HR,AT,2001.0,2,3,-1
BE,ZW,2021.0,2,1,1
DK,GW,2011.0,3,1,2
RS,DK,2001.0,1,1,0
SM,IT,2011.0,2,3,-1
LT,DK,1999.0,1,1,0
SD,EG,2002.0,1,1,0
CO,BE,2014.0,2,5,-3
PL,XK,2013.0,3,1,2
TW,VN,2002.0,2,7,-5
JP,QA,2022.0,2,3,-1
PH,KZ,2013.0,1,1,0
FR,NG,1997.0,1,1,0
CH,ZM,2013.0,1,1,0
TR,ES,1998.0,3,1,2
IQ,HU,2017.0,1,1,0
PK,RU,2018.0,2,10,-8
TW,UA,2017.0,1,1,0
CN,SD,2008.0,2,1,1
HR,PL,2022.0,2,2,0
KH,TH,2010.0,1,1,0
VE,nan,2020.0,2,1,1
NZ,PL,2018.0,1,2,-1
OM,FR,2021.0,1,1,0
MK,FR,2013.0,1,2,-1
BG,ES,2020.0,2,1,1
RS,PL,2007.0,1,1,0
NZ,AT,2021.0,4,4,0
ET,AT,2014.0,2,2,0
LA,US,2017.0,1,3,-2
EE,GB,2008.0,3,8,-5
SE,GL,2006.0,1,1,0
FI,RO,2022.0,1,1,0
AU,NG,2003.0,3,1,2
NL,MW,2011.0,1,4,-3
BE,MD,2013.0,1,2,-1
CH,MD,1999.0,1,1,0
SE,JO,2010.0,1,2,-1
DO,BR,2022.0,2,2,0
CN,CA,2012.0,392,516,-124
NL,US,2013.0,705,727,-22
ES,GB,2017.0,545,391,154
BR,CO,2022.0,79,66,13
GB,BD,2010.0,48,39,9
CO,MX,2020.0,360,385,-25
DE,RU,2014.0,176,129,47
FR,TR,2008.0,17,23,-6
TW,US,2020.0,608,616,-8
CZ,GB,2010.0,45,36,9
ES,GB,2019.0,510,448,62
KR,CA,2009.0,51,52,-1
VE,CU,2007.0,13,10,3
IE,CO,2014.0,5,4,1
CO,PE,2011.0,32,26,6
US,EC,2018.0,115,71,44
CL,PT,2013.0,10,9,1
IN,MY,2014.0,129,96,33
GB,BD,2017.0,39,50,-11
CN,SY,2008.0,26,18,8
NP,IN,2021.0,106,120,-14
PK,MA,2009.0,11,7,4
NG,HU,2019.0,2,2,0
PL,IE,2010.0,11,6,5
FR,nan,2022.0,72,80,-8
US,ET,2004.0,15,20,-5
MT,GB,2022.0,8,6,2
IR,FR,2011.0,27,35,-8
MY,PS,2017.0,6,1,5
UA,MD,2016.0,1,2,-1
CD,US,2019.0,9,5,4
AR,DE,2014.0,40,37,3
IN,NL,2008.0,33,25,8
AR,ES,2010.0,265,284,-19
CH,NZ,2014.0,10,18,-8
TW,SG,2002.0,29,12,17
CY,US,2022.0,15,11,4
CZ,IN,2001.0,9,3,6
PH,ES,2017.0,10,15,-5
CA,IL,2021.0,54,41,13
CL,NL,2017.0,18,13,5
GB,PA,2011.0,5,3,2
GB,KZ,2015.0,10,2,8
US,KZ,2019.0,28,30,-2
PT,FR,2004.0,22,30,-8
AU,MX,2011.0,10,10,0
MA,PK,2020.0,17,27,-10
CR,PE,2017.0,16,10,6
CO,CN,2017.0,6,4,2
ES,CU,2008.0,87,101,-14
US,TR,1998.0,114,102,12
NZ,AU,1998.0,57,53,4
CA,IT,2010.0,73,81,-8
UA,GB,2015.0,18,10,8
US,TH,2000.0,60,20,40
HU,TR,2021.0,11,14,-3
US,BH,2013.0,13,8,5
US,HR,2011.0,44,42,2
IE,ES,2009.0,16,15,1
CZ,GB,2017.0,44,56,-12
IN,CL,2018.0,10,12,-2
CN,LB,2013.0,40,30,10
GP,FR,2012.0,11,23,-12
GD,US,2008.0,5,3,2
SE,nan,2011.0,44,46,-2
CH,PT,2013.0,15,19,-4
IN,OM,2001.0,6,2,4
ID,DK,2017.0,4,3,1
GB,AE,1999.0,8,6,2
nan,CN,1999.0,8,12,-4
IL,DE,2006.0,34,29,5
ZA,GB,1999.0,56,55,1
VE,IT,2021.0,6,3,3
CO,CR,2007.0,8,7,1
FR,IT,1997.0,120,96,24
IN,GE,2020.0,3,5,-2
MY,PS,2019.0,9,6,3
US,GR,1999.0,97,62,35
TR,nan,2000.0,3,3,0
MA,KW,2012.0,8,5,3
ZW,US,2012.0,7,7,0
PL,FR,1997.0,22,21,1
TH,AU,2013.0,24,40,-16
QA,FR,2017.0,10,15,-5
IE,KR,2010.0,3,11,-8
SV,NI,2013.0,2,3,-1
BR,IL,2011.0,5,8,-3
PK,FR,2009.0,9,8,1
nan,FR,1998.0,27,40,-13
AE,IR,2018.0,5,16,-11
CL,IN,2020.0,10,17,-7
UA,NL,1999.0,3,3,0
HU,DK,2021.0,6,3,3
IQ,EG,2014.0,12,11,1
LK,GR,2015.0,9,3,6
NL,PK,2022.0,4,5,-1
MZ,PL,2017.0,21,13,8
MX,AU,2005.0,4,2,2
AR,FI,2012.0,2,1,1
JP,ZA,2009.0,7,2,5
SE,NZ,2020.0,5,8,-3
PY,AR,2016.0,13,10,3
MK,RS,2019.0,6,1,5
JP,CU,2007.0,2,1,1
DE,RO,2003.0,14,27,-13
nan,TH,2013.0,2,3,-1
RS,ES,2014.0,4,2,2
ZM,BR,2013.0,5,3,2
EG,FR,2010.0,17,21,-4
AE,AU,2016.0,12,31,-19
ES,MA,2009.0,8,3,5
DE,TW,2016.0,34,29,5
CM,US,2006.0,9,4,5
MA,ES,2001.0,9,6,3
QA,IN,2015.0,11,20,-9
EG,LB,2019.0,22,26,-4
IE,KR,2017.0,7,6,1
SE,EE,2012.0,4,5,-1
OM,US,1999.0,1,6,-5
SA,AE,2004.0,3,1,2
AT,FI,2007.0,6,1,5
BR,JO,2012.0,5,2,3
JP,UA,1999.0,8,11,-3
NZ,IN,2022.0,24,22,2
SD,GB,2021.0,3,3,0
KR,IE,2014.0,3,6,-3
NG,GH,2016.0,14,5,9
AR,CR,2003.0,1,1,0
EG,KR,2015.0,9,6,3
GR,CA,2012.0,14,9,5
IT,AL,2015.0,5,4,1
SG,AE,2010.0,5,1,4
HU,CL,2021.0,1,2,-1
KW,IN,2001.0,3,1,2
CZ,IL,1999.0,3,2,1
PK,SD,2014.0,2,2,0
KE,JP,2019.0,7,9,-2
PL,EG,2022.0,1,3,-2
BE,GR,2000.0,2,2,0
OM,AE,2018.0,8,10,-2
KR,FR,2005.0,13,24,-11
UA,KZ,2017.0,10,4,6
JO,AE,2009.0,6,1,5
AU,EG,1997.0,2,1,1
UY,DE,2014.0,3,3,0
PH,AU,2001.0,5,9,-4
DJ,FR,2016.0,1,2,-1
CN,YE,2003.0,1,1,0
BF,CG,2015.0,3,3,0
AE,GR,2020.0,4,3,1
LY,CA,2014.0,1,3,-2
MY,BH,2019.0,7,1,6
NG,PL,2019.0,4,1,3
CO,UY,2007.0,4,4,0
NO,NZ,2018.0,5,12,-7
PT,GH,2020.0,1,1,0
NZ,TH,2009.0,5,4,1
BR,RO,2013.0,1,4,-3
NG,TR,2018.0,3,4,-1
CA,GE,2011.0,2,4,-2
PS,TR,2006.0,1,1,0
PL,BG,2019.0,1,1,0
CU,PY,2009.0,3,5,-2
FR,MG,1999.0,1,2,-1
AU,PG,1998.0,2,1,1
EG,DK,2014.0,3,6,-3
NL,UA,2000.0,2,5,-3
DZ,nan,2013.0,2,4,-2
CH,PH,1998.0,1,3,-2
JO,nan,2021.0,1,1,0
TR,EG,2005.0,1,2,-1
GR,ZA,2019.0,3,1,2
HR,CZ,2006.0,5,2,3
ZA,MX,2014.0,2,1,1
PS,GB,1998.0,1,1,0
VN,ES,2013.0,2,1,1
BE,BD,2016.0,3,3,0
EE,JP,2012.0,1,2,-1
IN,FR,2008.0,128,59,69
AU,SE,2013.0,47,55,-8
ET,NG,2018.0,12,10,2
TR,PK,2010.0,5,3,2
GR,RO,2014.0,4,3,1
SG,TW,2018.0,45,51,-6
US,GP,2014.0,3,1,2
ES,TW,2010.0,6,9,-3
AU,HU,2003.0,6,5,1
SG,DE,2023.0,5,2,3
GH,ZA,2021.0,10,25,-15
nan,GH,2018.0,5,2,3
UY,US,2013.0,15,26,-11
PL,NO,2008.0,4,3,1
IN,IT,1998.0,17,26,-9
nan,BD,2020.0,3,6,-3
nan,EC,2022.0,1,4,-3
GB,IS,2022.0,8,5,3
nan,ID,2006.0,3,1,2
,US,2015.0,73172,0,73172
,ES,2006.0,12023,0,12023
,CN,2006.0,59031,0,59031
TW,,2022.0,6719,0,6719
NG,,2018.0,1286,0,1286
,DE,1998.0,16657,0,16657
,DE,1997.0,17578,0,17578
,PE,1994.0,295,0,295
RU,,2008.0,3583,0,3583
,PL,2010.0,6438,0,6438
,IN,1994.0,14879,0,14879
US,,2006.0,27068,0,27068
,BR,2013.0,21622,0,21622
VE,,2014.0,328,0,328
NL,,2015.0,4113,0,4113
,CA,2010.0,11171,0,11171
JO,,2020.0,340,0,340
BR,,2018.0,12952,0,12952
UY,,2023.0,1381,0,1381
CL,,2022.0,4596,0,4596
JP,,1998.0,4301,0,4301
,FR,2008.0,14684,0,14684
MX,,2022.0,11744,0,11744
,PL,2017.0,4553,0,4553
IE,,2019.0,1448,0,1448
AU,,2005.0,1511,0,1511
,IR,2008.0,9331,0,9331
FR,,2016.0,12179,0,12179
,BE,2003.0,2677,0,2677
,CA,2019.0,5421,0,5421
DK,,2013.0,863,0,863
CA,,2011.0,5081,0,5081
,FI,1994.0,6073,0,6073
PA,VE,2020.0,2,0,2
PL,,2018.0,5221,0,5221
AE,,2020.0,371,0,371
DE,,2003.0,6046,0,6046
HR,,2019.0,842,0,842
,CZ,2012.0,2670,0,2670
CH,,2012.0,2278,0,2278
IE,,2010.0,483,0,483
,NO,2012.0,1982,0,1982
HR,,2017.0,518,0,518
CA,SK,1997.0,2,0,2
NO,,2016.0,1269,0,1269
AU,SS,2020.0,2,0,2
,CA,2017.0,9702,0,9702
,VE,2010.0,290,0,290
,TN,2015.0,1494,0,1494
IE,,2017.0,1064,0,1064
,PH,2011.0,676,0,676
,EC,1999.0,55,0,55
,UG,2007.0,221,0,221
TN,MR,2005.0,1,0,1
TR,ID,2004.0,1,0,1
TT,,2022.0,118,0,118
AZ,,2017.0,86,0,86
AR,,2001.0,237,0,237
EE,,2023.0,1350,0,1350
,VN,2001.0,164,0,164
,LU,1998.0,42,0,42
,RS,2001.0,843,0,843
,MA,2015.0,1490,0,1490
UA,,2012.0,781,0,781
,ZW,2010.0,190,0,190
AU,,2002.0,1378,0,1378
DK,PH,2012.0,3,0,3
,ZW,2017.0,152,0,152
,LK,2013.0,607,0,607
,CY,2010.0,202,0,202
,NC,2011.0,13,0,13
,PK,1995.0,377,0,377
,CU,2012.0,578,0,578
,PS,2012.0,71,0,71
YE,,2024.0,328,0,328
CU,,2025.0,17,0,17
NP,CN,2005.0,3,0,3
NZ,MW,2017.0,1,0,1
AZ,,2019.0,149,0,149
,NP,2001.0,179,0,179
LT,,2008.0,118,0,118
KH,,2021.0,105,0,105
,BJ,1999.0,20,0,20
,CY,2017.0,215,0,215
,PL,2019.0,2060,0,2060
,VE,2019.0,57,0,57
,SK,2007.0,670,0,670
,VE,2017.0,158,0,158
,MW,2000.0,33,0,33
AF,,2013.0,2,0,2
IE,IQ,2015.0,4,0,4
AZ,ES,2020.0,1,0,1
KW,BD,2001.0,2,0,2
MG,,2015.0,24,0,24
MA,NE,2018.0,2,0,2
,BT,2011.0,6,0,6
,KH,2017.0,54,0,54
,ZM,2009.0,76,0,76
,SY,2015.0,99,0,99
,PW,1999.0,1,0,1
CU,GR,2019.0,2,0,2
RS,,2012.0,274,0,274
KZ,,2025.0,133,0,133
TN,SE,2012.0,1,0,1
IT,TD,2019.0,1,0,1
CM,,2013.0,62,0,62
,TR,2020.0,719,0,719
TN,SD,2019.0,1,0,1
,ZW,2019.0,88,0,88
,CY,2019.0,155,0,155
IR,YE,2013.0,1,0,1
,MD,2016.0,69,0,69
PE,NO,2015.0,1,0,1
LV,,2025.0,106,0,106
BG,,2006.0,155,0,155
SL,,2020.0,11,0,11
IT,UZ,2020.0,2,0,2
,MN,2012.0,106,0,106
EC,IE,2022.0,2,0,2
DE,AE,2001.0,2,0,2
FR,PK,2023.0,3,0,3
AZ,,2010.0,37,0,37
SI,PK,2013.0,1,0,1
CN,PS,2021.0,3,0,3
CD,,2018.0,91,0,91
CW,US,2021.0,3,0,3
MD,,2020.0,85,0,85
,TZ,2004.0,180,0,180
PK,,2000.0,49,0,49
HR,,2010.0,209,0,209
,MZ,2011.0,50,0,50
AL,GH,2016.0,2,0,2
,TZ,1996.0,83,0,83
GR,VN,2006.0,9,0,9
BE,PS,2015.0,4,0,4
LU,,2014.0,56,0,56
CZ,VN,2014.0,4,0,4
CM,BO,2007.0,1,0,1
SN,,2015.0,54,0,54
CY,,1998.0,7,0,7
,MQ,1994.0,21,0,21
NP,,2012.0,47,0,47
SN,PT,2012.0,1,0,1
AO,,2021.0,28,0,28
MX,NG,2006.0,1,0,1
ZW,BE,2020.0,1,0,1
,KH,2010.0,65,0,65
BA,GR,2015.0,1,0,1
CI,ML,2007.0,1,0,1
IL,ZM,2014.0,1,0,1
IR,,2000.0,32,0,32
NE,RU,2017.0,1,0,1
CH,RE,1997.0,1,0,1
ZW,FR,2015.0,1,0,1
VG,NL,2016.0,1,0,1
DE,YE,2011.0,1,0,1
PH,,1999.0,55,0,55
TH,NO,2004.0,1,0,1
PS,CN,2012.0,1,0,1
MA,ML,2019.0,6,0,6
,LU,1997.0,27,0,27
SE,BG,2021.0,4,0,4
,PF,2018.0,3,0,3
JM,,2025.0,6,0,6
,LR,2016.0,4,0,4
,BW,2000.0,45,0,45
FR,SD,2021.0,2,0,2
,MR,2013.0,6,0,6
,ST,1996.0,10,0,10
BE,CI,2012.0,6,0,6
CM,BF,2000.0,1,0,1
NG,CZ,1999.0,1,0,1
GE,TH,2007.0,1,0,1
RW,,2013.0,12,0,12
DE,MT,2017.0,2,0,2
CO,SG,2020.0,3,0,3
ES,UG,2015.0,1,0,1
MD,NG,2018.0,2,0,2
,IQ,2000.0,40,0,40
TH,GH,2012.0,1,0,1
TR,NP,2007.0,1,0,1
,MG,1997.0,27,0,27
AZ,GE,2016.0,2,0,2
ZM,MM,2018.0,2,0,2
,YE,2006.0,30,0,30
VG,GR,2001.0,1,0,1
IN,TH,2002.0,1,0,1
IL,RO,2022.0,1,0,1
UY,PK,2017.0,2,0,2
,SV,2003.0,10,0,10
JO,SG,2016.0,1,0,1
DO,CO,2004.0,2,0,2
ZW,CH,1997.0,1,0,1
CZ,XK,2011.0,1,0,1
CA,VN,2007.0,6,0,6
UG,IN,2015.0,3,0,3
GF,SN,1999.0,1,0,1
OM,YE,2018.0,1,0,1
CM,MG,2019.0,1,0,1
IQ,SD,2022.0,8,0,8
CH,DZ,2012.0,1,0,1
ZA,ZM,2001.0,2,0,2
CM,NL,2011.0,3,0,3
,KH,2019.0,21,0,21
TN,PK,2003.0,1,0,1
TM,RU,2019.0,2,0,2
MX,LT,2021.0,1,0,1
RO,NO,2005.0,2,0,2
BG,CA,2001.0,6,0,6
HK,SG,2017.0,4,0,4
ID,BN,2012.0,1,0,1
MX,OM,2021.0,1,0,1
LK,IL,2013.0,2,0,2
CA,QA,2001.0,1,0,1
CL,NO,2006.0,1,0,1
AE,PL,2005.0,1,0,1
CY,MX,2013.0,2,0,2
GR,MT,2000.0,1,0,1
FI,SG,2012.0,2,0,2
nan,ZW,2003.0,1,0,1
MW,,2015.0,21,0,21
CA,GA,2018.0,1,0,1
,MG,1998.0,31,0,31
MY,LY,2010.0,1,0,1
ME,XK,1998.0,1,0,1
LB,NZ,2011.0,1,0,1
SI,KR,2015.0,1,0,1
OM,BH,2000.0,2,0,2
BY,DK,2011.0,1,0,1
NG,HU,2010.0,6,0,6
PA,NL,2013.0,1,0,1
CF,,2016.0,7,0,7
NL,IS,2015.0,1,0,1
GR,TW,2022.0,1,0,1
NG,HU,2017.0,3,0,3
PL,UZ,2004.0,3,0,3
DE,MT,2010.0,2,0,2
VN,TH,2000.0,1,0,1
LA,NZ,2011.0,1,0,1
ET,CA,2000.0,1,0,1
UY,PY,2017.0,3,0,3
AR,UA,2011.0,3,0,3
,TG,1998.0,7,0,7
VN,PH,2020.0,3,0,3
IN,BR,2023.0,3,0,3
KR,BG,2020.0,1,0,1
IN,NA,2020.0,1,0,1
AE,PA,2016.0,1,0,1
GB,AG,2017.0,1,0,1
HK,RU,2020.0,1,0,1
KE,CZ,2020.0,2,0,2
BE,BF,2004.0,2,0,2
TR,IS,2008.0,1,0,1
AM,HU,2009.0,1,0,1
VE,AT,2019.0,1,0,1
MA,AR,2008.0,1,0,1
KN,GB,2021.0,3,0,3
CA,OM,2003.0,4,0,4
PK,CD,2007.0,1,0,1
BB,JM,2022.0,3,0,3
nan,GW,2016.0,1,0,1
QA,RS,2014.0,3,0,3
PG,,1999.0,3,0,3
RU,EG,2004.0,2,0,2
ST,GW,2022.0,1,0,1
MY,MN,2012.0,1,0,1
KZ,BG,2014.0,1,0,1
MK,,2000.0,3,0,3
BE,AE,2006.0,3,0,3
DO,RU,2002.0,1,0,1
,KE,2020.0,13,0,13
HU,AE,2009.0,2,0,2
TZ,SN,2019.0,1,0,1
SL,IT,2018.0,1,0,1
NG,SL,2006.0,1,0,1
CU,ID,2010.0,1,0,1
CU,MY,2015.0,2,0,2
KE,EG,2009.0,1,0,1
MX,ET,2018.0,2,0,2
EE,CA,2016.0,2,0,2
CV,PT,2018.0,2,0,2
CN,CD,2021.0,6,0,6
KN,IE,2020.0,1,0,1
CR,CU,2002.0,2,0,2
CO,GT,2007.0,1,0,1
SG,JM,2006.0,1,0,1
ZA,RW,2006.0,1,0,1
IQ,SK,2017.0,1,0,1
BR,PK,2006.0,1,0,1
ET,PG,2008.0,1,0,1
RU,ZA,2003.0,4,0,4
VN,,2000.0,4,0,4
SK,RO,2004.0,4,0,4
,JE,1999.0,1,0,1
GB,AG,2019.0,3,0,3
ME,,2012.0,5,0,5
KR,EE,2017.0,1,0,1
IL,GE,2018.0,1,0,1
SR,ID,2022.0,1,0,1
BJ,CM,2014.0,2,0,2
ET,RW,2013.0,1,0,1
EE,RO,2006.0,1,0,1
BY,BE,2004.0,2,0,2
BA,IT,2015.0,2,0,2
PT,CZ,2018.0,9,0,9
IN,UA,2002.0,1,0,1
SE,UY,1997.0,1,0,1
ZA,GD,2014.0,1,0,1
NP,AU,2001.0,2,0,2
SD,nan,2016.0,1,0,1
TZ,IL,2022.0,1,0,1
RW,SE,2012.0,1,0,1
BN,LK,2015.0,1,0,1
MM,,2025.0,7,0,7
HR,BR,2001.0,1,0,1
nan,LV,2015.0,1,0,1
,TG,1997.0,13,0,13
AM,TR,2008.0,1,0,1
KE,ZW,1999.0,2,0,2
BD,GE,2017.0,1,0,1
MU,CA,2019.0,1,0,1
AE,BN,2013.0,1,0,1
IQ,LY,2021.0,1,0,1
US,BN,2000.0,1,0,1
MD,CA,2004.0,2,0,2
,ST,2004.0,12,0,12
XK,MK,2015.0,3,0,3
FI,NA,2006.0,1,0,1
SI,DK,2003.0,1,0,1
PL,BG,2017.0,3,0,3
MO,FR,2014.0,1,0,1
PS,TN,2007.0,1,0,1
IN,PS,2017.0,1,0,1
SD,MY,2003.0,1,0,1
GB,GP,2015.0,1,0,1
SG,nan,2004.0,7,0,7
SI,nan,2014.0,3,0,3
LA,US,2010.0,2,0,2
EG,SY,2006.0,1,0,1
AU,KW,2008.0,2,0,2
DZ,AE,2010.0,2,0,2
CL,BE,2004.0,1,0,1
AZ,GB,2002.0,1,0,1
BD,EC,2020.0,2,0,2
PT,NO,1997.0,2,0,2
FR,PS,2013.0,3,0,3
ZM,MA,2022.0,1,0,1
CA,MT,2006.0,2,0,2
JE,US,2021.0,1,0,1
GH,LY,2017.0,1,0,1
NZ,IS,2022.0,3,0,3
CH,JM,2003.0,1,0,1
IN,KZ,2014.0,1,0,1
GH,SA,2004.0,1,0,1
SA,NE,2020.0,1,0,1
NC,GB,2017.0,1,0,1
TH,CM,2019.0,1,0,1
EG,LY,1997.0,1,0,1
FK,US,2007.0,1,0,1
UZ,BY,2012.0,2,0,2
MR,ML,2011.0,1,0,1
GB,RE,2022.0,2,0,2
GY,US,2021.0,3,0,3
NZ,TW,1999.0,1,0,1
DO,CH,2022.0,1,0,1
JO,ID,2014.0,2,0,2
UZ,BG,2012.0,1,0,1
XK,CN,2020.0,2,0,2
,GI,2001.0,1,0,1
MK,SE,2017.0,1,0,1
LA,AM,2014.0,1,0,1
BY,ZA,2011.0,1,0,1
UG,CI,2005.0,1,0,1
NP,HT,2017.0,1,0,1
AL,GR,2012.0,1,0,1
CH,BF,2009.0,1,0,1
FI,SA,2023.0,1,0,1
HK,ID,2013.0,1,0,1
AR,PH,2022.0,1,0,1
MX,BA,2013.0,1,0,1
MD,TR,2004.0,2,0,2
HU,IE,2001.0,1,0,1
IR,HU,2007.0,2,0,2
LB,PH,2012.0,1,0,1
GD,AT,2021.0,1,0,1
AE,CY,2002.0,1,0,1
SE,KZ,2021.0,1,0,1
IQ,NL,2011.0,2,0,2
ES,CM,2012.0,1,0,1
UY,nan,2018.0,3,0,3
EC,DE,2005.0,3,0,3
RE,CA,2001.0,1,0,1
,IN,2021.0,5,0,5
CY,LY,2020.0,2,0,2
GN,CH,2018.0,3,0,3
,IM,2016.0,1,0,1
IN,SI,2012.0,2,0,2
RE,BE,2005.0,1,0,1
TH,LA,2018.0,3,0,3
BE,IS,2006.0,1,0,1
GT,,2003.0,4,0,4
nan,SK,2005.0,1,0,1
YE,BD,2022.0,1,0,1
BF,NE,2017.0,2,0,2
OM,RU,2022.0,2,0,2
JM,AU,1998.0,1,0,1
US,CD,2005.0,1,0,1
RS,AR,1997.0,1,0,1
NZ,EG,2004.0,1,0,1
QA,IQ,2000.0,1,0,1
BW,NZ,2014.0,1,0,1
ME,US,1998.0,1,0,1
NC,,2008.0,2,0,2
TN,IL,2021.0,1,0,1
SL,CM,2019.0,1,0,1
DZ,MD,2003.0,1,0,1
CR,NI,2013.0,1,0,1
MT,,2001.0,1,0,1
SV,IT,2021.0,1,0,1
CU,LB,2014.0,1,0,1
DO,MX,2008.0,1,0,1
US,SO,2019.0,1,0,1
AU,PF,2012.0,1,0,1
BJ,UG,2021.0,1,0,1
NG,MX,2014.0,1,0,1
BN,QA,2011.0,1,0,1
KG,US,2013.0,1,0,1
CM,TN,2005.0,1,0,1
BD,TW,2017.0,2,0,2
CM,PE,2007.0,1,0,1
PL,TH,2007.0,1,0,1
MV,,2018.0,1,0,1
CL,ZA,2012.0,2,0,2
AE,LK,2010.0,1,0,1
CR,CA,2007.0,2,0,2
ZA,RO,2007.0,2,0,2
AT,GT,2014.0,1,0,1
LB,NG,2022.0,1,0,1
IE,UY,2002.0,1,0,1
UA,NI,2008.0,1,0,1
LV,SA,2020.0,1,0,1
LU,DK,2004.0,1,0,1
IE,BG,2021.0,1,0,1
BG,KR,2014.0,2,0,2
ZM,MW,2011.0,2,0,2
NG,BH,1999.0,1,0,1
TW,DK,2000.0,2,0,2
SI,BE,1997.0,3,0,3
GH,PH,2012.0,1,0,1
MW,FI,2019.0,1,0,1
AT,SY,2012.0,2,0,2
IE,FJ,2013.0,1,0,1
LV,BE,2011.0,3,0,3
UZ,IT,2006.0,1,0,1
nan,KW,2017.0,1,0,1
SE,NA,2010.0,1,0,1
NL,AL,2002.0,1,0,1
NC,PF,2006.0,1,0,1
KN,EG,2022.0,1,0,1
IL,CY,2009.0,2,0,2
FI,VN,2010.0,2,0,2
HU,ES,2001.0,2,0,2
GM,NL,2010.0,1,0,1
LB,GB,2023.0,1,0,1
BA,TW,2017.0,1,0,1
DE,BN,2009.0,1,0,1
JO,BE,2010.0,1,0,1
LB,GF,2018.0,2,0,2
ER,IT,2010.0,1,0,1
SE,BN,1998.0,1,0,1
RO,JO,2004.0,1,0,1
IL,BO,2017.0,1,0,1
SD,KE,2014.0,2,0,2
BJ,BF,2005.0,1,0,1
RS,SA,2016.0,1,0,1
AU,MW,2014.0,2,0,2
US,LC,2019.0,1,0,1
CI,TZ,2019.0,2,0,2
IT,YE,2011.0,2,0,2
TJ,TR,2022.0,1,0,1
NP,BW,2012.0,2,0,2
PT,TH,2008.0,1,0,1
IE,SG,2007.0,2,0,2
BH,MA,2018.0,1,0,1
PR,US,2002.0,4,0,4
BI,CM,2008.0,1,0,1
UZ,CA,2017.0,1,0,1
KR,OM,2013.0,1,0,1
BY,HU,2021.0,1,0,1
MD,RU,2000.0,1,0,1
KE,MY,2005.0,1,0,1
BY,GB,2011.0,2,0,2
CD,CN,2011.0,2,0,2
CO,ZA,2022.0,3,0,3
UZ,RS,2016.0,1,0,1
SE,KW,1999.0,2,0,2
CO,NO,2007.0,1,0,1
CZ,IQ,2019.0,1,0,1
MX,MA,2012.0,1,0,1
GR,KE,2010.0,1,0,1
MQ,GF,2003.0,1,0,1
SS,AU,2014.0,2,0,2
SI,LV,2022.0,1,0,1
GB,ER,2007.0,1,0,1
ES,EG,2008.0,3,0,3
OM,AF,2020.0,1,0,1
RO,DZ,2019.0,1,0,1
SD,OM,2017.0,3,0,3
AR,LB,2009.0,1,0,1
KR,MX,2001.0,1,0,1
CH,CU,2001.0,1,0,1
PE,PT,1997.0,1,0,1
AU,VE,2016.0,1,0,1
MW,FI,2010.0,1,0,1
CL,LU,2013.0,1,0,1
PH,ID,1998.0,1,0,1
RW,SI,2020.0,1,0,1
MG,BJ,2011.0,1,0,1
CO,RS,2014.0,1,0,1
HK,BG,2014.0,1,0,1
CL,NC,2019.0,1,0,1
MK,CH,2013.0,2,0,2
BO,CA,2009.0,2,0,2
CR,SV,2007.0,1,0,1
ES,PR,2022.0,1,0,1
SI,TR,2011.0,1,0,1
MT,CH,2019.0,1,0,1
MY,CZ,2002.0,1,0,1
SV,GT,2015.0,1,0,1
CH,GA,2011.0,1,0,1
NE,AU,2013.0,1,0,1
DZ,KE,2016.0,1,0,1
NZ,NP,1999.0,1,0,1
CZ,TJ,2022.0,1,0,1
GE,ZA,1998.0,1,0,1
KZ,MX,2020.0,1,0,1
MX,AZ,2002.0,1,0,1
MX,HU,2007.0,1,0,1
DZ,RU,2019.0,2,0,2
MT,DK,2002.0,1,0,1
MA,nan,1998.0,1,0,1
BG,HU,2017.0,1,1,0
HU,BG,2018.0,1,1,0
BG,HU,2019.0,1,2,-1
BO,CR,2016.0,2,2,0
AR,VE,2003.0,3,3,0
CL,nan,2000.0,2,1,1
IL,TW,2017.0,2,4,-2
BA,PL,2011.0,2,5,-3
MX,ZW,2016.0,1,2,-1
ZA,IR,2013.0,1,6,-5
EG,nan,2018.0,2,15,-13
TZ,JP,2006.0,1,4,-3
TZ,GB,1999.0,1,3,-2
RO,CA,1998.0,2,2,0
TW,UA,2010.0,2,1,1
AT,XK,2022.0,1,1,0
PS,QA,2022.0,2,2,0
QA,TR,2020.0,4,7,-3
TW,SI,2021.0,1,2,-1
IN,TH,2005.0,2,2,0
GM,GH,2018.0,1,3,-2
NZ,IL,2002.0,2,1,1
CO,RU,2014.0,1,3,-2
BN,MY,2012.0,5,5,0
IT,VN,2009.0,1,2,-1
ZW,GB,2014.0,2,5,-3
EG,ET,2010.0,1,3,-2
FR,GN,2008.0,1,2,-1
LY,SA,2014.0,1,1,0
ZA,MZ,2013.0,1,2,-1
NC,GB,2019.0,1,1,0
IQ,JO,2013.0,2,2,0
BA,EG,2022.0,1,1,0
RO,SK,2007.0,1,3,-2
DE,GE,2013.0,3,3,0
MX,AU,2002.0,2,4,-2
ZA,BH,2016.0,1,4,-3
IE,TW,2004.0,1,1,0
BE,UA,2007.0,1,2,-1
CL,DO,2013.0,2,3,-1
PK,CA,2023.0,1,3,-2
DZ,EG,2010.0,1,6,-5
PT,LU,2006.0,2,1,1
AE,ID,2016.0,2,1,1
PT,GR,2020.0,1,2,-1
AT,AR,1998.0,2,1,1
SD,ID,2005.0,1,1,0
SD,IR,2014.0,2,2,0
FI,CH,2023.0,2,1,1
PA,CR,2016.0,1,1,0
ZM,TH,2011.0,2,1,1
FR,UZ,2007.0,1,1,0
CN,AR,2000.0,1,1,0
ZA,nan,2016.0,3,7,-4
PL,LB,2020.0,1,1,0
BR,PA,2010.0,1,1,0
US,SD,2011.0,2,2,0
GR,NZ,2016.0,1,1,0
MY,PH,2007.0,1,1,0
SN,ML,2012.0,2,1,1
CD,US,2010.0,1,4,-3
NG,SD,2020.0,3,8,-5
GT,ES,2002.0,1,1,0
CU,DO,2012.0,2,1,1
DE,UZ,2003.0,1,3,-2
ES,TW,2017.0,4,5,-1
BE,HR,2007.0,1,2,-1
UG,NG,2009.0,1,3,-2
XK,US,2015.0,4,2,2
AO,PT,2013.0,3,3,0
SD,JP,2009.0,2,2,0
RS,AR,1998.0,1,1,0
US,HN,2002.0,1,1,0
ZM,KE,2018.0,2,1,1
EC,RO,2022.0,1,1,0
GH,ET,2020.0,1,4,-3
BR,MA,2008.0,1,1,0
SA,PS,2005.0,1,1,0
DE,HR,2023.0,1,1,0
nan,HU,2010.0,1,4,-3
HK,NL,1999.0,1,2,-1
JE,GB,2010.0,1,1,0
UY,VE,2008.0,2,1,1
PR,JP,2004.0,1,1,0
DO,ES,2005.0,1,1,0
NG,ID,2012.0,1,1,0
MA,AU,2006.0,1,1,0
NP,DK,2014.0,1,1,0
EG,PL,2014.0,2,5,-3
GH,DK,2010.0,1,1,0
PR,ES,2013.0,1,1,0
MK,TR,2003.0,1,1,0
MX,IL,2011.0,1,5,-4
CA,GH,2002.0,1,2,-1
nan,DZ,2009.0,1,2,-1
GB,BB,2011.0,3,4,-1
BG,DK,2018.0,1,2,-1
IL,BY,2002.0,1,1,0
BD,CZ,2009.0,1,1,0
MA,PH,2021.0,1,1,0
ID,GR,2014.0,1,3,-2
US,AO,2012.0,1,2,-1
TL,BR,2020.0,1,2,-1
BH,SA,2008.0,1,1,0
NL,KE,1998.0,2,2,0
GT,CU,2011.0,1,1,0
GB,BJ,2007.0,1,1,0
PT,PL,2001.0,1,3,-2
SK,ZA,2019.0,1,1,0
TN,ES,2003.0,1,1,0
BA,TR,2017.0,2,7,-5
EG,PH,2016.0,1,1,0
ET,nan,2021.0,1,2,-1
KH,US,2003.0,1,2,-1
SA,LY,2014.0,1,1,0
DZ,PL,2020.0,1,1,0
CO,SV,2011.0,1,2,-1
BH,JO,2005.0,1,3,-2
BR,HU,2007.0,1,2,-1
LU,PT,2009.0,1,1,0
HR,ME,2002.0,1,1,0
SA,BH,1998.0,1,1,0
AR,IN,2009.0,1,1,0
GA,US,2004.0,1,1,0
SG,EG,2018.0,1,6,-5
CU,SV,2010.0,1,1,0
KW,QA,2021.0,1,4,-3
IQ,NZ,2018.0,1,1,0
TW,TH,2007.0,1,3,-2
FR,AM,2004.0,1,2,-1
RW,US,2007.0,1,1,0
IL,MY,2018.0,1,3,-2
SY,CA,2006.0,1,1,0
NZ,BR,2006.0,1,2,-1
UA,PE,2016.0,1,1,0
LV,CH,2003.0,1,1,0
UZ,CZ,2001.0,2,5,-3
PH,KH,2017.0,1,1,0
FR,IR,2023.0,1,1,0
TR,GH,2021.0,1,2,-1
NZ,RU,2020.0,1,4,-3
PK,BN,2019.0,2,1,1
AU,RS,1998.0,1,2,-1
VN,EG,2022.0,1,4,-3
BD,BN,2006.0,1,1,0
nan,TR,2004.0,1,3,-2
AU,LU,2020.0,3,4,-1
AT,nan,2000.0,3,7,-4
IN,PA,2011.0,1,1,0
RW,BE,2000.0,1,1,0
SY,ID,2020.0,2,2,0
GR,FI,2016.0,4,8,-4
AR,ZA,2012.0,1,1,0
BO,BR,2008.0,3,2,1
KZ,CA,2020.0,2,2,0
CZ,BR,2003.0,3,2,1
US,HN,2005.0,1,3,-2
SE,IL,2023.0,1,1,0
PT,RU,1998.0,1,1,0
CH,RO,2004.0,2,4,-2
CN,AM,2017.0,1,1,0
TR,IR,2003.0,2,1,1
IQ,SY,2018.0,1,5,-4
KR,nan,1997.0,1,7,-6
GR,BG,2005.0,2,2,0
SG,AT,2006.0,1,1,0
CD,CH,2019.0,1,1,0
YE,NL,2020.0,1,0,1
TM,RU,2017.0,1,0,1
CZ,TL,2009.0,1,0,1
LV,EE,2004.0,1,0,1
TJ,JP,2012.0,1,0,1
BD,KR,1998.0,1,0,1
RU,CL,2011.0,1,0,1
SN,AE,2008.0,1,0,1
BH,ZM,2012.0,1,0,1
ZM,BH,2013.0,1,0,1
nan,GP,1998.0,1,0,1
CH,PE,2003.0,1,0,1
CH,GN,2021.0,1,0,1
GA,BE,2002.0,1,0,1
IL,TW,2010.0,4,0,4
US,YE,2005.0,1,0,1
CR,LU,2022.0,1,0,1
BE,PY,2016.0,1,0,1
RO,NO,2002.0,1,0,1
CA,TG,2021.0,1,0,1
UA,GR,2020.0,1,0,1
NE,CA,2019.0,1,0,1
VN,BY,1997.0,1,0,1
KR,EE,2010.0,1,0,1
JO,GE,2016.0,1,0,1
VE,CH,2001.0,1,0,1
SC,,2007.0,1,0,1
IL,UY,2014.0,2,0,2
MU,US,2013.0,2,0,2
MA,BF,2018.0,2,0,2
IN,PS,2010.0,1,0,1
HU,KZ,2018.0,1,0,1
BJ,DK,2018.0,1,0,1
ZM,ID,2018.0,2,0,2
NI,RU,2020.0,2,0,2
AT,CD,2016.0,1,0,1
MX,AE,2008.0,1,0,1
PA,FR,2023.0,1,0,1
WS,US,2020.0,1,0,1
RO,EE,2007.0,1,0,1
SK,ZA,2017.0,1,0,1
NZ,AF,2022.0,1,0,1
IN,UA,2005.0,2,0,2
NG,ML,2015.0,1,0,1
CR,BO,2021.0,1,0,1
SD,DE,2004.0,1,0,1
GN,,2012.0,1,0,1
UA,IR,2022.0,1,0,1
MX,ID,2009.0,1,0,1
TH,HU,1998.0,1,0,1
JM,AF,2005.0,1,0,1
IL,NL,2023.0,1,0,1
PH,GT,1997.0,1,0,1
NC,PK,2018.0,1,0,1
GB,BT,2013.0,1,0,1
KR,SK,2016.0,3,0,3
LU,HT,2016.0,1,0,1
CF,TN,2019.0,1,0,1
BF,nan,2020.0,2,0,2
UZ,ZW,2022.0,1,0,1
MG,SN,2021.0,1,0,1
TZ,BW,2006.0,1,0,1
DO,DE,2006.0,1,0,1
OM,IE,2013.0,1,0,1
IR,LY,2019.0,2,0,2
PK,SI,2006.0,1,0,1
ID,CO,1998.0,1,0,1
SK,PT,2012.0,1,0,1
RO,ID,2012.0,2,0,2
SG,IE,2001.0,1,0,1
BH,AT,2020.0,1,0,1
TW,SK,2006.0,1,0,1
TT,NZ,2006.0,1,0,1
UG,GE,2012.0,1,0,1
AT,LU,2023.0,1,0,1
SA,LK,2011.0,1,0,1
SD,PK,2006.0,1,0,1
BE,UY,2013.0,1,0,1
CL,FI,2004.0,1,0,1
MA,CF,2008.0,1,0,1
MX,MO,2021.0,1,0,1
EC,BY,2017.0,1,0,1
CM,CI,2011.0,1,0,1
,DJ,2008.0,1,0,1
GB,IM,2015.0,1,0,1
IT,SS,2007.0,1,0,1
SE,ZW,2013.0,1,0,1
CR,nan,2002.0,2,0,2
AT,GH,2014.0,1,0,1
LV,SK,2017.0,1,0,1
FI,JO,2011.0,1,0,1
PK,KG,2006.0,1,0,1
ME,GB,2007.0,1,0,1
SE,AZ,2015.0,1,0,1
nan,TN,2008.0,1,0,1
MW,MY,2020.0,1,0,1
RO,DZ,2017.0,1,0,1
KW,ES,2015.0,1,0,1
GA,CI,2011.0,1,0,1
TN,MC,2011.0,1,0,1
DE,CD,2003.0,1,0,1
PK,PH,2011.0,1,0,1
CA,GH,2005.0,1,0,1
GN,ML,2008.0,1,0,1
GT,FR,2007.0,1,0,1
GB,MN,2004.0,1,0,1
RO,nan,2005.0,1,0,1
NI,CL,2022.0,1,0,1
DK,PE,2014.0,1,0,1
NG,JO,2014.0,1,0,1
UY,ZA,2004.0,1,0,1
FR,JO,2002.0,1,0,1
JP,BF,2007.0,1,0,1
KZ,AZ,2015.0,1,0,1
TR,EG,2002.0,1,0,1
MR,,2011.0,2,0,2
KW,BH,2012.0,1,0,1
BR,UA,2003.0,1,0,1
DE,CG,2011.0,1,0,1
CY,ES,2010.0,1,0,1
NE,JP,2017.0,1,0,1
SV,UY,2019.0,1,0,1
PT,SV,2014.0,1,0,1
KG,DE,2005.0,1,0,1
TH,MM,2008.0,2,0,2
LK,IT,2020.0,1,0,1
CA,PA,2001.0,1,0,1
CA,MC,2013.0,1,0,1
BD,SG,2004.0,3,0,3
NE,CA,2017.0,1,0,1
DZ,LV,2015.0,1,0,1
TJ,UA,2012.0,1,0,1
FI,IS,2011.0,1,0,1
SN,CN,2017.0,1,0,1
TW,UZ,2015.0,1,0,1
TH,SO,2022.0,1,0,1
JP,SI,2014.0,1,0,1
RS,LB,2021.0,1,0,1
GR,IL,2022.0,1,0,1
AT,AR,1997.0,1,0,1
ET,NO,1999.0,1,0,1
UG,LU,2020.0,1,0,1
IT,MZ,2011.0,1,0,1
SG,IL,2003.0,1,0,1
GP,GF,2003.0,1,0,1
IR,BH,2010.0,1,0,1
JP,CO,2023.0,1,0,1
BA,NZ,2014.0,1,0,1
TN,CL,2012.0,1,0,1
BY,SE,2001.0,1,0,1
GH,UA,2021.0,1,0,1
nan,HR,2015.0,1,0,1
HU,KR,2003.0,1,0,1
PE,PA,2010.0,1,0,1
BD,EE,2016.0,1,0,1
BY,SK,2014.0,1,0,1
LB,MY,2009.0,1,0,1
DZ,JP,2013.0,1,0,1
TH,EC,2016.0,1,0,1
HU,BN,2018.0,1,0,1
SG,ES,1998.0,1,0,1
NG,NP,2010.0,1,0,1
CZ,BD,2007.0,1,0,1
SV,CA,2003.0,1,0,1
LB,JP,2004.0,1,0,1
TT,MY,2010.0,1,0,1
AR,AO,2021.0,1,0,1
BY,LK,2021.0,1,0,1
KE,SN,2015.0,1,0,1
AR,SD,2009.0,1,0,1
BO,CH,2015.0,1,0,1
MN,AE,2004.0,1,0,1
HR,CL,2020.0,1,0,1
MO,US,2013.0,1,0,1
SY,AE,2015.0,1,0,1
BE,MW,2018.0,1,0,1
TM,,2003.0,1,0,1
JO,TN,2007.0,1,0,1
SN,IN,2013.0,1,0,1
AR,IE,2008.0,1,0,1
TH,SD,2012.0,1,0,1
CZ,ME,2022.0,1,0,1
NL,BD,2008.0,1,0,1
SI,LT,2010.0,1,0,1
DZ,SG,2015.0,1,0,1
BY,SA,2021.0,1,0,1
JP,ID,2014.0,202,67,135
RU,GB,2002.0,70,36,34
CA,GB,2003.0,498,554,-56
CN,SG,2013.0,425,426,-1
JP,GB,1998.0,194,184,10
PR,KR,2020.0,58,31,27
US,PK,1999.0,39,39,0
FR,CO,2006.0,9,12,-3
CU,AR,2017.0,13,19,-6
DE,RO,2012.0,29,30,-1
TW,US,2004.0,533,641,-108
IN,GB,2013.0,347,493,-146
CH,SN,2012.0,5,2,3
CA,US,2022.0,1900,1874,26
CL,ES,2014.0,290,400,-110
DK,GB,2017.0,158,140,18
IT,US,2001.0,577,592,-15
IN,SA,2021.0,107,94,13
BR,GB,2009.0,130,146,-16
BR,MX,2006.0,43,43,0
CN,ES,2019.0,98,74,24
ES,CL,2006.0,138,130,8
PE,CL,2014.0,50,64,-14
AU,FR,2016.0,143,157,-14
PY,BR,1998.0,4,5,-1
IT,FR,2009.0,352,224,128
JO,ES,2007.0,4,1,3
CO,CL,2010.0,118,155,-37
JP,DE,2012.0,217,171,46
US,GB,2004.0,3955,4274,-319
GB,IE,2016.0,418,443,-25
US,NO,2018.0,207,172,35
ZA,AU,2022.0,31,44,-13
JP,US,2021.0,1143,1164,-21
NL,BR,2009.0,33,44,-11
SG,CN,2012.0,401,414,-13
IN,US,2016.0,2666,2761,-95
MA,TN,2015.0,55,26,29
TR,GB,2017.0,132,127,5
AU,IN,2019.0,195,262,-67
CN,SE,2014.0,92,90,2
MY,KR,2015.0,29,30,-1
JP,AU,2010.0,83,66,17
US,ES,1999.0,370,405,-35
FR,AU,2022.0,56,58,-2
PK,AT,2021.0,4,5,-1
JP,GB,1997.0,128,161,-33
US,BE,2016.0,381,361,20
CA,DE,2019.0,320,296,24
DE,CA,2018.0,290,286,4
GB,nan,2010.0,58,65,-7
AU,CN,2013.0,315,391,-76
DE,AU,2010.0,204,172,32
AU,KR,2019.0,54,81,-27
IN,DE,2020.0,234,191,43
SE,FI,2022.0,63,58,5
CH,SE,2014.0,60,63,-3
CN,QA,2014.0,19,11,8
FR,DE,2002.0,319,256,63
FI,GB,2006.0,42,39,3
IE,DE,2004.0,29,46,-17
ES,MX,2006.0,391,414,-23
VE,US,2017.0,46,27,19
JP,MY,2011.0,61,17,44
FI,SE,1998.0,35,31,4
SE,CN,2002.0,39,40,-1
IL,US,2018.0,653,537,116
DE,nan,2013.0,81,84,-3
AU,NZ,2000.0,69,80,-11
LU,DE,2003.0,9,7,2
JP,IN,2018.0,149,159,-10
US,AU,2023.0,109,80,29
AU,IT,2020.0,62,73,-11
US,CH,2016.0,979,906,73
AE,GB,2018.0,38,73,-35
VE,US,2019.0,65,25,40
AR,MX,2006.0,56,63,-7
US,GE,2005.0,109,120,-11
US,PE,2014.0,106,89,17
KR,IN,2022.0,75,175,-100
CL,MX,2006.0,53,76,-23
HU,IT,2015.0,10,13,-3
CO,CL,2019.0,286,260,26
TN,MD,2010.0,7,14,-7
DE,AT,1999.0,225,205,20
FR,BE,2014.0,388,357,31
CA,BR,2011.0,265,256,9
US,nan,2006.0,245,229,16
MY,IT,2016.0,62,48,14
AT,AU,2004.0,14,9,5
CO,BR,2020.0,163,193,-30
PH,US,2000.0,187,189,-2
UG,PK,2016.0,3,1,2
CA,IE,2016.0,147,153,-6
HK,CN,2016.0,145,101,44
HR,US,2013.0,47,43,4
ID,NL,2016.0,30,58,-28
GB,LT,2013.0,7,5,2
MD,FR,2012.0,65,35,30
IE,AU,2007.0,73,79,-6
BR,CL,2014.0,82,89,-7
nan,ES,2022.0,41,32,9
MX,US,2004.0,213,229,-16
AU,RU,2000.0,9,5,4
GB,CN,2007.0,461,328,133
DE,MX,2008.0,32,38,-6
CA,AU,2006.0,233,230,3
DK,CN,2016.0,44,45,-1
IN,IE,2020.0,51,30,21
ES,AR,2006.0,171,214,-43
AU,IN,2017.0,177,233,-56
ES,CR,2019.0,71,59,12
GB,PL,2004.0,27,38,-11
CA,DE,2017.0,295,310,-15
ES,NZ,2014.0,13,7,6
BR,DE,2004.0,71,83,-12
BR,FR,2009.0,117,149,-32
CA,MX,2000.0,11,4,7
IS,CA,2001.0,1,5,-4
JP,TW,1998.0,34,28,6
PK,US,2011.0,129,180,-51
RS,BA,2012.0,26,21,5
DE,AU,2017.0,256,256,0
CO,MX,2004.0,55,85,-30
KR,AU,2014.0,47,42,5
NO,FI,2008.0,9,21,-12
ES,DE,2004.0,74,79,-5
DE,HU,2011.0,45,60,-15
FR,NC,2017.0,15,10,5
ES,IE,2009.0,15,16,-1
KR,JP,2016.0,370,371,-1
SE,JP,2010.0,30,32,-2
US,MX,2013.0,361,355,6
SY,US,2013.0,20,4,16
JP,TW,1997.0,26,27,-1
AR,SE,2012.0,6,7,-1
GB,nan,2017.0,108,84,24
TR,JP,2016.0,23,27,-4
AU,ZA,2018.0,58,100,-42
CA,IR,2004.0,40,26,14
US,IT,2000.0,485,574,-89
KR,GB,2007.0,62,63,-1
CO,CL,2017.0,255,264,-9
KR,MY,2018.0,47,43,4
VE,SK,2004.0,1,1,0
NL,AT,1999.0,10,11,-1
NO,DK,2014.0,103,86,17
JP,CH,2007.0,76,45,31
ES,RU,2008.0,12,19,-7
nan,US,2014.0,260,279,-19
BE,IT,2012.0,88,152,-64
PL,CZ,2022.0,35,48,-13
IR,CA,2020.0,469,172,297
IT,IE,2009.0,31,19,12
GB,KE,2017.0,36,40,-4
GB,LB,2009.0,5,6,-1
OM,PK,2015.0,2,9,-7
JP,KR,2000.0,126,96,30
GB,ES,2002.0,142,123,19
ID,JP,2019.0,177,255,-78
CN,AU,2003.0,108,144,-36
SG,CA,2012.0,47,48,-1
BE,ET,2014.0,12,3,9
GB,IN,2007.0,236,275,-39
AT,CZ,2016.0,30,27,3
GR,CH,2008.0,18,9,9
SE,CH,2016.0,66,76,-10
SE,IE,2014.0,12,22,-10
EG,JO,2014.0,5,18,-13
AU,ES,2018.0,68,68,0
KE,BE,2016.0,2,8,-6
DE,PL,2009.0,85,112,-27
AU,BR,2009.0,46,62,-16
TR,GB,2019.0,170,169,1
IR,FI,2021.0,34,5,29
NL,CA,2006.0,65,48,17
CN,TR,2005.0,4,13,-9
NL,TW,2001.0,3,1,2
GB,nan,2019.0,133,98,35
BD,CN,2012.0,62,66,-4
CN,ES,2010.0,68,49,19
ZA,CM,2015.0,8,7,1
SE,CN,2005.0,74,52,22
CN,CZ,2007.0,24,55,-31
RU,NL,2013.0,37,41,-4
nan,IE,2015.0,2,3,-1
AT,US,2003.0,147,152,-5
CN,NL,2013.0,96,102,-6
PE,ES,2009.0,44,43,1
CN,TR,2002.0,9,10,-1
CZ,CN,2010.0,52,43,9
CA,VN,2002.0,4,1,3
BR,VE,1997.0,2,1,1
RU,GB,2005.0,69,65,4
VE,MX,2000.0,9,11,-2
AU,IN,2010.0,82,121,-39
ZA,RU,2012.0,11,5,6
RU,ID,2019.0,27,30,-3
CR,MX,2011.0,26,37,-11
IR,TR,2019.0,50,30,20
IT,SA,2020.0,16,7,9
GB,BR,2016.0,194,232,-38
GB,RO,2013.0,53,24,29
RU,BY,2013.0,60,80,-20
MY,ZM,2020.0,11,2,9
ES,SA,2016.0,13,5,8
IL,IN,2015.0,34,66,-32
AU,FJ,2008.0,5,6,-1
LB,ES,2013.0,3,1,2
GB,SY,2021.0,5,3,2
DE,TR,2022.0,65,65,0
DK,GB,2010.0,92,113,-21
IT,nan,2017.0,127,106,21
FR,AT,2015.0,52,52,0
AU,KR,2010.0,27,35,-8
DK,GB,2019.0,152,166,-14
AT,DE,2022.0,293,405,-112
CN,LK,2017.0,11,7,4
TH,JP,2020.0,77,130,-53
IL,CN,2016.0,20,15,5
BE,US,2013.0,319,424,-105
KR,DE,2013.0,49,49,0
CN,ES,2017.0,72,75,-3
ES,ZA,2010.0,9,3,6
RU,TJ,2022.0,375,30,345
CZ,ES,2017.0,16,23,-7
IN,BW,2022.0,2,3,-1
GB,QA,2019.0,78,19,59
AE,CA,1998.0,2,1,1
US,EG,2023.0,16,25,-9
KR,EG,2018.0,11,11,0
SE,CA,2015.0,57,57,0
RO,FR,2015.0,44,51,-7
SG,IR,2021.0,26,16,10
TR,CA,2016.0,26,31,-5
JP,AU,2019.0,85,83,2
FI,HU,2007.0,6,3,3
BR,AR,2020.0,143,176,-33
BE,UG,2020.0,6,14,-8
CA,DE,2010.0,247,251,-4
HU,AT,2004.0,17,15,2
AE,SA,2022.0,15,33,-18
HR,XK,2018.0,3,3,0
TR,KZ,2004.0,13,5,8
JP,BR,2009.0,41,45,-4
FR,SG,2018.0,40,26,14
NG,US,2015.0,83,86,-3
FR,MX,2018.0,66,68,-2
IR,PT,2020.0,19,8,11
TR,CO,2019.0,203,60,143
IT,CO,2020.0,17,29,-12
ZA,ZW,2013.0,27,24,3
ZW,BW,2018.0,2,1,1
MY,PK,2010.0,13,26,-13
AE,PK,2016.0,19,8,11
IT,AZ,2019.0,15,18,-3
TN,MY,2013.0,3,1,2
EC,CU,2019.0,22,46,-24
CO,GB,2011.0,16,17,-1
CZ,NO,2021.0,3,6,-3
CU,AR,2010.0,14,17,-3
IN,NZ,2022.0,22,24,-2
TW,SG,2007.0,26,31,-5
FR,AR,2022.0,46,42,4
CZ,RU,2019.0,75,72,3
LV,EE,2020.0,1,5,-4
CN,ID,2017.0,268,141,127
ES,NL,2018.0,103,86,17
GB,QA,2017.0,40,30,10
CN,ZA,2020.0,15,25,-10
AR,IT,2008.0,67,68,-1
BE,SG,2017.0,8,4,4
CN,LK,2019.0,16,7,9
RO,SK,2002.0,3,1,2
IN,LK,2022.0,10,6,4
RS,XK,2014.0,12,9,3
SK,IN,2014.0,2,2,0
CH,BE,2008.0,43,44,-1
DZ,US,2018.0,50,88,-38
NZ,JP,2017.0,14,5,9
MX,FR,2014.0,55,70,-15
GB,CO,2007.0,23,24,-1
PH,NZ,2019.0,7,3,4
RU,EG,2020.0,34,29,5
TR,AU,2011.0,8,7,1
RU,BG,2019.0,35,50,-15
FR,LT,2014.0,5,1,4
TN,US,2020.0,22,21,1
SE,NL,2008.0,36,38,-2
RU,IN,2013.0,21,11,10
US,IQ,2005.0,7,3,4
NL,KR,2003.0,5,5,0
KR,FR,2007.0,21,25,-4
LB,US,2020.0,122,76,46
TW,PH,2015.0,9,3,6
ES,CR,2017.0,54,71,-17
PE,EC,2019.0,58,66,-8
CZ,ES,2019.0,22,26,-4
DE,NZ,2015.0,37,44,-7
IR,PK,2021.0,18,12,6
NL,SE,2003.0,30,40,-10
TH,FR,2018.0,14,27,-13
CZ,US,2015.0,139,194,-55
GB,KE,2019.0,44,48,-4
IT,nan,2010.0,80,116,-36
RU,NO,2020.0,14,22,-8
BE,LU,2021.0,13,10,3
MX,BO,2019.0,11,6,5
IT,CA,2013.0,106,68,38
KW,GB,2021.0,8,20,-12
IN,ZA,2018.0,69,54,15
PK,NG,2014.0,13,3,10
OM,IQ,2020.0,4,6,-2
JP,KG,2020.0,3,1,2
CH,KR,2013.0,14,12,2
AT,CA,2016.0,32,39,-7
SG,US,2000.0,112,108,4
ET,SE,2021.0,3,6,-3
FR,NC,2019.0,10,23,-13
NL,JP,2002.0,31,31,0
LK,AU,2018.0,52,28,24
CA,RU,2006.0,16,33,-17
ET,KR,2016.0,128,116,12
MM,GB,2017.0,1,1,0
CA,AT,2009.0,17,36,-19
RS,SI,2016.0,20,24,-4
EC,CU,2017.0,20,46,-26
DE,AU,2019.0,264,258,6
CO,CR,2005.0,9,6,3
EG,DE,2020.0,66,58,8
IN,SE,2015.0,63,45,18
PL,UA,2016.0,28,24,4
US,UA,2021.0,79,91,-12
EG,GB,2008.0,32,47,-15
VN,UA,2021.0,6,1,5
SE,ZA,2019.0,17,28,-11
UA,RU,2003.0,69,110,-41
KE,IT,2018.0,5,3,2
AU,NL,2012.0,75,84,-9
SK,JP,2005.0,14,31,-17
CN,IR,2008.0,20,16,4
IT,FI,2019.0,48,18,30
CA,EG,2021.0,68,79,-11
DO,CO,2020.0,6,2,4
PA,ID,2017.0,4,1,3
JP,SE,2020.0,36,48,-12
SG,ID,2011.0,10,5,5
GB,TW,2015.0,62,57,5
CU,CL,2021.0,27,13,14
RU,ZA,2012.0,5,11,-6
CU,UY,2018.0,3,2,1
CU,US,2004.0,16,18,-2
IT,MY,2021.0,32,37,-5
TR,BR,2021.0,10,11,-1
RU,CH,2021.0,32,23,9
IL,FR,2008.0,35,30,5
AZ,IT,2020.0,14,13,1
SA,AE,2020.0,41,36,5
CI,CN,2014.0,1,1,0
US,AG,2020.0,7,4,3
CA,CZ,2006.0,15,18,-3
CR,CU,2007.0,4,6,-2
MY,JO,2021.0,13,11,2
KZ,US,2021.0,13,19,-6
CN,FI,2018.0,32,31,1
AZ,US,2022.0,3,4,-1
DE,GB,2012.0,821,840,-19
MY,PK,2017.0,135,73,62
CO,AR,2007.0,40,34,6
MX,AR,2014.0,111,163,-52
IT,AU,2014.0,62,42,20
PE,EC,2017.0,53,29,24
BR,BE,2014.0,60,79,-19
IT,nan,2019.0,98,158,-60
GB,PH,2011.0,14,16,-2
CO,TR,2020.0,134,179,-45
MY,PK,2019.0,189,87,102
EG,GR,2015.0,2,1,1
US,GE,2002.0,80,83,-3
CN,CH,2001.0,23,36,-13
JP,IL,2018.0,6,16,-10
DE,CZ,2008.0,56,59,-3
ES,SE,2004.0,21,26,-5
IT,SG,2014.0,8,5,3
BF,FR,2011.0,11,10,1
NL,RO,2016.0,8,10,-2
JP,PA,2012.0,2,2,0
CZ,CN,2017.0,27,24,3
UA,CZ,2016.0,21,30,-9
PT,FR,2020.0,46,68,-22
PE,CO,2018.0,100,134,-34
FI,RU,2021.0,20,33,-13
NG,CA,2019.0,30,23,7
JP,VN,2011.0,41,21,20
US,ET,2020.0,78,50,28
IT,JP,2016.0,78,58,20
nan,MX,2021.0,32,22,10
DK,CA,2018.0,38,49,-11
JP,PL,2021.0,9,11,-2
DE,NO,2000.0,23,19,4
US,OM,2017.0,13,10,3
RU,BG,2010.0,22,15,7
ES,nan,2020.0,88,80,8
UA,VN,2015.0,4,3,1
GH,NG,2020.0,13,12,1
GB,FI,2021.0,71,65,6
UA,DE,2012.0,37,28,9
MA,CI,2021.0,1,1,0
BY,US,2015.0,19,4,15
SE,PL,2006.0,12,16,-4
CN,KE,2018.0,19,8,11
CU,AR,2019.0,25,18,7
JP,TH,2003.0,40,24,16
NZ,JP,2010.0,10,21,-11
AR,UY,2014.0,37,34,3
PK,CH,2010.0,10,13,-3
US,PL,2004.0,171,183,-12
SA,OM,2018.0,15,18,-3
VN,IT,2021.0,4,1,3
SE,IT,2015.0,66,108,-42
SD,MY,2012.0,3,6,-3
KE,TZ,2016.0,7,12,-5
EG,IL,2005.0,2,1,1
LV,GB,2007.0,2,2,0
NL,NP,2020.0,2,3,-1
IT,FI,2010.0,21,9,12
RO,IN,2009.0,47,26,21
CA,JO,2015.0,14,6,8
PK,CH,2019.0,23,8,15
NL,FI,2012.0,34,40,-6
SE,BR,2012.0,18,12,6
IE,CH,2014.0,14,12,2
SE,JP,2019.0,45,52,-7
DE,BG,2011.0,21,19,2
BR,IT,2006.0,118,119,-1
EG,TR,2022.0,9,7,2
BR,FI,2013.0,5,8,-3
CH,RO,2020.0,16,13,3
CA,OM,2012.0,14,4,10
UA,AT,2015.0,9,3,6
CA,VG,2014.0,2,3,-1
NL,IE,2006.0,13,15,-2
RU,nan,2007.0,51,35,16
NG,ET,2018.0,10,12,-2
CH,NL,1998.0,27,36,-9
US,AT,1999.0,121,144,-23
ID,JP,2010.0,38,131,-93
DE,PH,2014.0,17,9,8
US,LB,2004.0,30,31,-1
TR,CO,2017.0,67,7,60
NG,NL,2010.0,7,4,3
CA,PT,2011.0,12,19,-7
RU,BG,2017.0,21,43,-22
PT,GB,2000.0,30,37,-7
NO,ET,2010.0,3,3,0
SY,FR,1997.0,2,1,1
PA,MX,2013.0,8,5,3
TW,AR,2008.0,4,11,-7
TR,GB,2010.0,85,55,30
DZ,DE,2010.0,4,6,-2
RO,US,2020.0,70,99,-29
ZA,BW,2019.0,22,8,14
CO,DO,2021.0,4,1,3
GB,AT,2001.0,27,31,-4
TR,DE,2016.0,89,70,19
VN,IE,2019.0,1,2,-1
LT,SE,2013.0,8,3,5
JP,RS,2005.0,6,4,2
JO,DE,2006.0,9,11,-2
PK,MY,2023.0,9,9,0
CU,IT,2003.0,2,4,-2
GT,MX,2020.0,28,27,1
IT,GR,2014.0,23,33,-10
TR,IR,2012.0,8,8,0
US,PG,2015.0,4,3,1
RU,TW,2014.0,26,11,15
MC,FR,1997.0,3,2,1
NL,HR,2011.0,4,5,-1
ES,SV,2018.0,6,9,-3
AU,LB,2013.0,3,5,-2
RU,IL,2016.0,30,29,1
SG,nan,2020.0,8,8,0
MD,US,2012.0,7,2,5
IL,JP,2006.0,7,5,2
CA,UA,2018.0,15,7,8
AR,VE,2012.0,12,19,-7
CZ,RU,2010.0,27,19,8
SE,JP,2017.0,55,36,19
BG,US,2017.0,30,34,-4
CN,NO,2016.0,28,34,-6
CZ,JP,1999.0,10,6,4
GB,LY,2014.0,15,2,13
ES,KR,2020.0,12,22,-10
BA,IQ,2020.0,11,5,6
BR,PL,2013.0,7,8,-1
TW,CH,2014.0,14,3,11
BG,RU,2013.0,24,32,-8
AE,JO,2014.0,9,22,-13
ID,IQ,2022.0,6,4,2
PH,FR,2015.0,6,4,2
RU,DK,2007.0,20,7,13
GR,FR,2011.0,47,32,15
ER,US,2014.0,1,1,0
AU,CU,2002.0,1,3,-2
TW,JP,2022.0,29,46,-17
XK,RS,2014.0,9,12,-3
NL,SA,2014.0,8,3,5
KR,NP,2016.0,9,10,-1
NZ,JP,2019.0,11,11,0
PT,AT,2011.0,3,4,-1
CA,RS,2009.0,28,3,25
KW,SE,2018.0,3,1,2
KR,TW,2005.0,20,25,-5
ZA,BE,2008.0,14,10,4
US,QA,2003.0,8,3,5
SD,SA,2009.0,4,4,0
IS,SE,2016.0,13,20,-7
IT,ES,2004.0,96,97,-1
AD,ES,2019.0,2,3,-1
IN,AU,2001.0,30,34,-4
SE,IS,2014.0,17,26,-9
SE,AU,2018.0,66,78,-12
RU,PL,2012.0,15,22,-7
FI,NL,2014.0,34,34,0
GB,KE,2010.0,22,22,0
US,LV,2019.0,5,14,-9
CH,EG,2013.0,7,6,1
VE,CL,2009.0,21,12,9
GR,CZ,2007.0,4,6,-2
KR,TW,2002.0,25,20,5
SI,ID,2015.0,4,4,0
US,EE,2009.0,19,4,15
GH,ZM,2016.0,12,39,-27
BE,IE,2016.0,10,14,-4
CN,UZ,2011.0,14,9,5
AU,nan,2003.0,11,8,3
BA,DE,2013.0,6,1,5
NG,EG,2014.0,5,4,1
FI,SE,1997.0,30,27,3
US,KN,2016.0,7,8,-1
TH,US,1998.0,31,45,-14
NZ,SA,2021.0,6,4,2
MW,ZA,2020.0,7,14,-7
EG,KW,2009.0,6,21,-15
ID,TR,2017.0,8,23,-15
GB,ID,2000.0,3,3,0
US,LV,2017.0,6,12,-6
IR,IN,2021.0,27,17,10
FR,GR,2014.0,51,58,-7
CL,GB,2013.0,38,42,-4
BE,MA,2017.0,10,2,8
AU,KR,2017.0,46,72,-26
SA,IQ,2013.0,8,6,2
BR,NG,2021.0,8,7,1
ID,DE,2021.0,36,33,3
ET,JP,2019.0,4,12,-8
NZ,DE,1997.0,4,7,-3
NZ,CA,2020.0,74,81,-7
BD,NO,2022.0,7,14,-7
BG,US,2019.0,34,33,1
PL,DE,1999.0,58,55,3
BE,DK,2003.0,14,2,12
UY,AR,2021.0,22,37,-15
DE,CO,2008.0,15,12,3
GR,KW,2018.0,2,3,-1
CH,CN,2001.0,36,23,13
GB,MW,2020.0,25,24,1
NG,CA,2017.0,17,15,2
CZ,CN,2019.0,22,25,-3
GR,BE,2008.0,14,12,2
SA,SY,2019.0,11,8,3
SI,ME,2016.0,2,1,1
SD,DE,2020.0,2,2,0
IR,IQ,2015.0,5,5,0
IN,BE,2006.0,13,6,7
ID,TR,2019.0,18,23,-5
BH,IN,2008.0,1,4,-3
RO,BE,2008.0,6,12,-6
NL,SK,2002.0,5,6,-1
GB,ZW,2014.0,5,2,3
FR,ID,2015.0,38,14,24
BD,GB,2006.0,22,27,-5
ZA,BW,2017.0,17,13,4
TR,CO,2010.0,2,2,0
US,ZM,2016.0,13,20,-7
ES,BG,2015.0,4,3,1
GB,AR,2022.0,19,17,2
CA,TH,2009.0,12,11,1
BE,EE,2017.0,1,2,-1
HR,ES,2014.0,5,6,-1
AU,NO,2011.0,19,9,10
SK,RS,2021.0,7,5,2
IE,RU,2016.0,11,6,5
NL,JP,2005.0,29,34,-5
IE,IT,2009.0,19,31,-12
SN,GH,2019.0,1,1,0
JO,CA,2014.0,7,8,-1
RO,SE,2000.0,5,1,4
BD,PK,2001.0,5,1,4
AT,UA,2014.0,5,7,-2
QA,ZA,2012.0,2,1,1
NP,TW,2022.0,1,1,0
VE,BR,2002.0,8,8,0
TR,IT,2003.0,7,12,-5
US,CU,2011.0,25,22,3
MX,GR,2011.0,7,4,3
RS,RU,2011.0,11,16,-5
NZ,CH,2009.0,11,6,5
NG,DE,2007.0,6,7,-1
NG,CA,2010.0,7,5,2
IR,AE,2005.0,1,1,0
TN,CA,2011.0,13,11,2
GB,IL,2021.0,58,56,2
BG,BE,2012.0,3,7,-4
SE,EE,2003.0,10,5,5
CY,CA,2011.0,1,4,-3
IT,DK,2003.0,12,16,-4
AT,BE,2018.0,30,15,15
SE,HR,2008.0,3,3,0
ZA,JP,2004.0,2,6,-4
ES,ZA,2017.0,18,7,11
HR,ME,2007.0,1,2,-1
JP,RS,2002.0,4,2,2
BR,QA,2012.0,2,1,1
GB,QA,2010.0,19,2,17
FI,ES,2016.0,21,31,-10
DE,RS,2009.0,21,13,8
CY,DE,2016.0,6,7,-1
UA,CA,2001.0,4,2,2
KR,CH,2012.0,9,12,-3
ZA,HR,2013.0,1,1,0
DK,IS,2013.0,6,6,0
LT,US,2003.0,6,5,1
MY,JP,2005.0,13,10,3
CA,KR,2000.0,22,9,13
PT,NL,2008.0,16,16,0
PE,CR,2013.0,6,8,-2
VN,AU,2015.0,33,35,-2
PK,SE,2018.0,17,18,-1
MY,CA,2008.0,7,13,-6
DZ,MY,2021.0,4,3,1
QA,EG,1999.0,4,1,3
HU,CH,2022.0,10,3,7
TW,GB,1997.0,9,13,-4
US,AO,2003.0,1,1,0
NZ,DK,2021.0,6,2,4
FR,NC,2010.0,15,14,1
TR,AE,2019.0,6,3,3
CN,DK,2008.0,16,23,-7
PY,BR,1997.0,2,2,0
BR,CH,2004.0,22,15,7
CN,CL,2010.0,6,3,3
AU,PK,2006.0,16,4,12
RU,IT,2008.0,25,17,8
PK,NP,2022.0,5,2,3
UY,IT,2021.0,8,9,-1
GB,CZ,1998.0,13,12,1
LU,US,2014.0,22,20,2
PE,BR,2001.0,4,2,2
ZW,ZA,2013.0,24,27,-3
HU,IL,2004.0,4,1,3
CA,HU,2008.0,14,7,7
NZ,DE,1998.0,10,10,0
SK,CA,2008.0,8,4,4
GW,DK,2013.0,3,3,0
VE,US,2010.0,45,56,-11
TW,TH,2002.0,1,1,0
PL,HK,2017.0,2,2,0
CO,IT,2013.0,16,15,1
OM,CA,2018.0,11,8,3
NL,MX,2021.0,6,17,-11
IR,TH,2022.0,4,1,3
CL,NZ,2021.0,2,4,-2
PL,RO,2021.0,4,7,-3
IT,RS,2011.0,6,4,2
LB,JP,2020.0,1,2,-1
SN,CA,2007.0,3,1,2
AT,FI,2005.0,5,8,-3
NL,CO,2011.0,4,7,-3
BY,RU,2006.0,32,25,7
ES,CR,2010.0,30,24,6
US,KH,2016.0,5,3,2
TZ,DE,2017.0,4,9,-5
ZM,US,2011.0,13,10,3
PT,RO,2012.0,3,4,-1
TN,PK,2012.0,4,1,3
AT,CO,2018.0,3,1,2
RU,AM,2000.0,5,4,1
PS,FR,2006.0,1,1,0
CA,MY,2004.0,8,4,4
UG,US,2007.0,14,15,-1
LB,BE,2016.0,5,7,-2
TN,ES,2012.0,3,6,-3
GR,AT,2018.0,5,11,-6
NL,HK,2011.0,13,5,8
AU,HK,2016.0,7,5,2
AU,NG,2012.0,2,4,-2
CA,LK,2017.0,7,4,3
JP,BD,2003.0,19,17,2
BE,UA,2005.0,7,1,6
MZ,GB,2010.0,1,1,0
DE,EG,1997.0,7,6,1
ES,NO,2001.0,14,9,5
SY,HU,2017.0,3,3,0
NO,ET,2019.0,11,9,2
FR,SY,2006.0,4,6,-2
SI,BA,2017.0,6,7,-1
CZ,BR,2012.0,9,3,6
NO,FR,2000.0,14,28,-14
UZ,RU,2008.0,4,27,-23
TW,CA,2014.0,45,40,5
SA,TH,2020.0,1,1,0
AT,IT,1999.0,16,11,5
LV,DE,1997.0,1,1,0
CN,LT,1999.0,3,2,1
SA,FR,2008.0,4,11,-7
AR,IL,1999.0,5,3,2
CH,CZ,1999.0,3,8,-5
CN,ID,2010.0,8,14,-6
NL,TH,2014.0,11,6,5
FR,EG,2012.0,32,23,9
CA,TT,2017.0,4,2,2
GB,CZ,1997.0,9,5,4
CZ,ES,2010.0,11,17,-6
GB,NO,1999.0,22,23,-1
PL,SE,2021.0,25,14,11
CA,PL,1998.0,9,8,1
IT,AE,2011.0,4,1,3
KE,IN,2003.0,2,4,-2
AR,CU,2007.0,5,8,-3
SK,US,2011.0,31,37,-6
ES,UY,2008.0,32,29,3
BW,US,2008.0,7,7,0
BG,ES,2004.0,7,4,3
SA,BD,2013.0,9,11,-2
SE,ID,2014.0,4,3,1
MA,KW,2003.0,2,2,0
EE,FI,2011.0,11,14,-3
US,MA,2008.0,9,9,0
TZ,UG,2013.0,4,2,2
IT,NZ,2004.0,3,2,1
CZ,CH,2008.0,11,26,-15
US,PY,2019.0,12,11,1
IT,IL,2022.0,11,10,1
MX,BO,2017.0,13,15,-2
RS,PL,2005.0,2,3,-1
ID,AU,2003.0,11,7,4
CH,CO,2007.0,3,7,-4
FR,IS,2018.0,4,3,1
AM,JP,2000.0,6,2,4
VN,NL,2014.0,5,5,0
AT,NZ,2016.0,5,8,-3
PL,KR,2000.0,2,2,0
PA,ES,2013.0,11,7,4
nan,SK,2007.0,3,4,-1
NZ,ZA,2014.0,11,10,1
FR,BY,2001.0,2,3,-1
LV,DE,1998.0,4,3,1
RO,NL,2013.0,8,13,-5
DE,LI,2005.0,8,3,5
TR,AZ,2001.0,1,2,-1
KE,DK,2009.0,4,1,3
TT,US,2011.0,7,7,0
CA,LK,2019.0,12,6,6
QA,US,2013.0,23,58,-35
KR,TR,2003.0,9,5,4
KR,UZ,2015.0,1,2,-1
IL,AU,2001.0,12,7,5
SE,KR,2022.0,5,10,-5
AU,HU,2012.0,2,7,-5
PA,PE,2011.0,1,1,0
PK,BR,2020.0,5,8,-3
TW,GB,1998.0,19,18,1
CN,AT,2021.0,18,21,-3
ET,JP,2010.0,4,4,0
BE,IR,2012.0,20,20,0
GE,CA,2015.0,3,1,2
KR,BR,2006.0,6,2,4
TR,MM,2019.0,8,2,6
IL,AR,2004.0,4,1,3
IL,SE,2020.0,5,8,-3
MX,AU,2007.0,8,8,0
ES,LU,2014.0,5,3,2
DK,US,2023.0,7,13,-6
EE,LV,2020.0,5,1,4
NO,CH,2003.0,8,17,-9
US,VE,1998.0,17,25,-8
BE,CA,2000.0,20,20,0
CA,NG,2014.0,7,11,-4
PL,DK,2007.0,15,8,7
BD,PH,2012.0,2,1,1
SE,AR,2011.0,3,6,-3
GH,BR,2019.0,4,2,2
VN,BA,2022.0,1,2,-1
MC,IT,2018.0,1,1,0
PK,TR,2014.0,11,17,-6
AZ,IR,2015.0,2,2,0
JO,IQ,2012.0,7,1,6
SE,ZA,2017.0,15,17,-2
BR,CN,1998.0,3,3,0
KR,KH,2020.0,3,1,2
IN,TH,2007.0,3,6,-3
MY,KH,2019.0,3,1,2
CH,TR,2022.0,8,23,-15
CA,SI,2017.0,4,4,0
EC,IN,2016.0,2,1,1
NL,ZW,2021.0,3,2,1
ET,FR,2021.0,1,5,-4
BH,KE,2002.0,4,1,3
KZ,UZ,2012.0,4,2,2
RU,CZ,2003.0,10,10,0
MD,CH,2018.0,6,2,4
CN,IN,2000.0,13,20,-7
BE,EG,2021.0,5,6,-1
BD,SG,2020.0,4,2,2
CA,ET,2016.0,4,4,0
BO,CL,2008.0,5,7,-2
AR,SV,2019.0,2,1,1
MT,IN,2022.0,2,1,1
MW,GB,2023.0,1,1,0
DE,CM,2004.0,4,5,-1
MW,US,2002.0,5,2,3
MW,US,2005.0,4,7,-3
DE,DZ,2018.0,7,8,-1
VE,CU,2005.0,6,9,-3
MY,MV,2019.0,1,2,-1
JO,SA,1999.0,1,1,0
LV,IN,2022.0,9,2,7
US,VE,1997.0,21,21,0
DK,PL,2003.0,9,5,4
ET,DE,2013.0,3,10,-7
IN,EE,2022.0,7,7,0
CA,KE,2022.0,6,3,3
BR,SE,2007.0,12,11,1
UA,PL,2013.0,24,20,4
SE,IN,2005.0,17,23,-6
KR,IT,2018.0,8,5,3
MA,IQ,2019.0,3,3,0
RU,CA,2009.0,17,30,-13
BG,ID,2021.0,3,2,1
TW,NZ,2022.0,2,2,0
PK,CH,2017.0,16,18,-2
FR,FI,2003.0,10,11,-1
FR,AM,2020.0,5,4,1
HU,EG,2008.0,3,2,1
TW,RU,2006.0,15,13,2
EG,AE,2007.0,9,7,2
RU,LT,2018.0,8,7,1
CH,SG,2003.0,4,2,2
AR,PY,2015.0,8,7,1
TW,CZ,2006.0,2,2,0
IT,MX,2006.0,24,28,-4
SI,AT,1998.0,2,1,1
US,CR,2008.0,17,25,-8
CL,FI,2020.0,3,1,2
IR,JP,2015.0,16,22,-6
FR,RS,2000.0,2,3,-1
SI,BA,2019.0,2,8,-6
AT,IE,2000.0,1,3,-2
IT,PE,2009.0,4,4,0
US,HK,2021.0,8,13,-5
MA,ID,2018.0,7,3,4
KH,US,2012.0,2,4,-2
VE,CU,2002.0,3,2,1
PE,NL,2016.0,2,3,-1
RU,CU,2016.0,3,1,2
VE,DE,2011.0,7,4,3
SA,AU,2022.0,20,53,-33
IT,EE,2008.0,2,2,0
CZ,ZA,2012.0,7,5,2
IE,HR,2013.0,8,7,1
IT,TR,2014.0,24,16,8
ID,VE,2014.0,1,1,0
EE,US,2012.0,10,10,0
ET,JP,2017.0,2,5,-3
DE,LV,2001.0,4,5,-1
AR,JP,2002.0,4,1,3
ZW,US,2003.0,12,2,10
NO,ET,2017.0,13,8,5
AE,FR,2011.0,7,11,-4
OM,IR,2020.0,2,16,-14
AO,US,2015.0,1,4,-3
MQ,GP,2020.0,4,3,1
GH,DE,2011.0,3,8,-5
RW,US,2005.0,1,1,0
GB,DZ,2014.0,8,10,-2
BO,CO,2001.0,2,1,1
nan,SG,2022.0,4,7,-3
HR,RU,2011.0,6,6,0
AT,PT,2021.0,8,4,4
DE,LU,2001.0,10,3,7
ET,BE,2016.0,2,10,-8
BE,SG,2010.0,4,3,1
FR,GF,2018.0,12,17,-5
RU,MX,2014.0,6,7,-1
FR,KE,1999.0,2,1,1
AT,PA,2022.0,1,1,0
KW,CA,2007.0,5,6,-1
MY,UG,2014.0,2,1,1
GB,VE,2016.0,5,2,3
IR,NL,2006.0,3,5,-2
AU,BD,2006.0,6,10,-4
IQ,JP,2013.0,4,3,1
TH,BR,2011.0,1,5,-4
nan,CO,2004.0,2,2,0
LU,CA,2009.0,3,3,0
CO,CR,2002.0,3,2,1
MA,CA,2003.0,6,5,1
US,PY,2010.0,1,4,-3
AM,EE,2017.0,1,1,0
PS,US,2009.0,6,4,2
FI,NZ,2009.0,4,1,3
HU,CA,2007.0,9,9,0
GA,DE,2022.0,2,4,-2
IR,TR,2010.0,7,7,0
CR,CL,1997.0,1,1,0
AZ,KZ,2021.0,1,2,-1
CO,AU,2022.0,3,10,-7
CL,RS,2016.0,1,2,-1
CL,IN,2004.0,1,1,0
BG,MX,2009.0,4,1,3
ID,NZ,2021.0,6,7,-1
RE,ZA,2017.0,2,1,1
HR,IN,2013.0,1,1,0
BE,MA,2019.0,10,7,3
JO,SY,2011.0,2,1,1
NG,BW,2007.0,2,1,1
BF,IT,2019.0,1,4,-3
PH,MX,2005.0,3,4,-1
NL,GR,1999.0,3,2,1
BR,VE,1998.0,2,7,-5
NG,NL,2017.0,7,7,0
SV,CL,2002.0,1,1,0
SI,AR,2021.0,1,1,0
TH,NO,2020.0,1,2,-1
CN,CL,2019.0,3,7,-4
IQ,QA,2016.0,5,5,0
GN,SN,2021.0,3,7,-4
PH,BR,2020.0,9,16,-7
PE,CU,2011.0,5,7,-2
DK,BR,2009.0,11,7,4
MK,AU,2003.0,7,11,-4
KE,SE,2001.0,6,1,5
SG,PL,2014.0,3,5,-2
NZ,CL,2017.0,4,5,-1
IN,TZ,2017.0,6,2,4
GT,US,2006.0,4,3,1
TR,AE,2017.0,10,1,9
DE,EG,1998.0,10,8,2
NZ,FR,2004.0,1,10,-9
NO,NG,2016.0,3,3,0
US,BM,2008.0,4,1,3
AR,RU,2013.0,1,1,0
KR,CZ,2006.0,4,7,-3
YE,MA,2018.0,1,1,0
TH,MY,2016.0,9,9,0
EC,IT,2013.0,7,6,1
SE,IN,2002.0,11,8,3
CA,HR,2013.0,2,3,-1
BD,MA,2014.0,5,2,3
HR,NL,2000.0,2,2,0
ES,ZA,2019.0,7,17,-10
CR,SE,2004.0,1,1,0
KR,GH,2020.0,8,4,4
MD,DE,2014.0,3,3,0
BY,UA,2015.0,9,13,-4
IN,RS,2015.0,4,2,2
SI,DK,2012.0,2,1,1
CI,FR,2008.0,11,22,-11
GR,KR,2019.0,5,2,3
RS,CA,2008.0,10,20,-10
CR,CO,2005.0,6,9,-3
NZ,CL,2019.0,4,6,-2
CN,LK,2010.0,6,4,2
PH,TW,2008.0,2,2,0
FI,TH,2022.0,1,1,0
PT,GR,2004.0,1,1,0
US,VG,2011.0,11,10,1
SZ,US,2012.0,2,1,1
BE,LB,2015.0,5,6,-1
ES,SG,2007.0,1,4,-3
OM,TN,2021.0,1,3,-2
GP,FR,2003.0,6,4,2
ID,AZ,2011.0,5,4,1
MX,EE,2021.0,2,1,1
SE,TW,2008.0,2,2,0
LB,QA,2018.0,4,6,-2
KE,UG,2001.0,1,1,0
US,SN,2009.0,5,8,-3
SG,LU,2014.0,1,2,-1
IN,VN,2015.0,3,4,-1
BR,PY,2004.0,1,5,-4
KW,JP,2006.0,2,1,1
DE,SD,2009.0,1,1,0
BE,SG,2019.0,3,2,1
EG,OM,2012.0,8,3,5
SA,CN,2003.0,3,2,1
SA,SY,2017.0,1,9,-8
MA,IQ,2017.0,3,2,1
MY,QA,2015.0,5,1,4
BR,UA,2012.0,4,3,1
PK,DK,2017.0,8,8,0
UY,GB,2012.0,4,3,1
FR,BO,2017.0,2,1,1
CA,LK,2010.0,1,4,-3
ET,TH,2009.0,1,1,0
PY,UY,2015.0,2,3,-1
SK,CH,1997.0,3,4,-1
SK,RO,2020.0,4,2,2
SY,DE,2012.0,3,10,-7
CZ,PT,2003.0,2,1,1
UY,CU,2018.0,2,3,-1
CH,BD,2011.0,4,2,2
CM,ID,2022.0,2,2,0
YE,CN,2022.0,2,8,-6
BD,BE,2015.0,4,3,1
MD,CN,2022.0,2,1,1
PK,IN,1997.0,12,8,4
SS,GB,2015.0,6,5,1
EG,ES,2003.0,3,3,0
DK,AR,2003.0,1,2,-1
TZ,KR,2015.0,1,3,-2
BD,NP,2014.0,4,5,-1
BE,HU,1997.0,6,1,5
IN,EG,2014.0,12,8,4
MX,PH,2006.0,2,3,-1
MY,UA,2016.0,2,5,-3
GA,US,2020.0,1,2,-1
SV,EC,2020.0,1,2,-1
PL,RS,2020.0,3,9,-6
KR,KE,2013.0,2,1,1
GB,NA,2018.0,4,2,2
CM,ZA,2020.0,5,6,-1
IL,HU,2009.0,5,5,0
GB,SD,2002.0,3,3,0
CU,CA,2015.0,6,1,5
CA,ES,2023.0,2,2,0
US,LT,2001.0,4,7,-3
GN,FR,2020.0,5,3,2
IL,AT,2003.0,3,2,1
UA,RO,2007.0,1,1,0
ET,KW,2016.0,1,1,0
LA,TH,2020.0,1,2,-1
NL,SK,2005.0,5,3,2
MX,CZ,2000.0,1,1,0
DK,AT,2006.0,6,4,2
NL,EE,2021.0,5,1,4
GB,SD,2005.0,6,2,4
MY,DE,2009.0,6,6,0
KR,ZA,2011.0,7,3,4
PT,IT,1998.0,6,2,4
TH,NL,2004.0,2,4,-2
PY,US,2021.0,7,9,-2
BA,XK,2018.0,1,2,-1
IN,TZ,2019.0,4,1,3
DE,GH,2016.0,10,9,1
IS,IN,2021.0,2,4,-2
CD,FR,2022.0,2,3,-1
FR,MQ,2022.0,2,5,-3
DE,BD,2007.0,3,3,0
SD,EG,2007.0,1,2,-1
CL,RU,2009.0,3,4,-1
KW,IR,2017.0,3,2,1
ES,UA,2022.0,2,1,1
SD,TW,2019.0,1,1,0
DZ,DE,2017.0,5,6,-1
MZ,GB,2019.0,2,1,1
CH,AE,2012.0,2,1,1
MA,SE,2014.0,2,1,1
US,SY,2003.0,1,4,-3
SI,ES,2003.0,3,5,-2
LV,SE,2001.0,3,2,1
MM,MY,2015.0,5,2,3
ME,BA,2016.0,2,3,-1
NO,LT,2001.0,3,2,1
ID,ET,2021.0,6,2,4
SA,CA,2001.0,8,24,-16
BR,HR,2014.0,1,1,0
AT,PK,2021.0,5,4,1
FI,HR,2022.0,1,2,-1
KZ,UA,1999.0,1,2,-1
GB,SE,2023.0,4,8,-4
IN,FJ,2013.0,1,4,-3
GH,SA,2020.0,2,2,0
KR,QA,2012.0,7,2,5
FR,MK,2015.0,2,1,1
CO,UY,2002.0,2,1,1
SG,BD,2020.0,2,4,-2
VE,BO,2014.0,1,1,0
IN,RU,2003.0,3,5,-2
IR,LB,2020.0,2,2,0
TR,HU,2009.0,4,4,0
SA,KW,2001.0,6,2,4
US,BY,1999.0,4,5,-1
GH,GM,2021.0,1,1,0
JP,RO,1997.0,3,5,-2
AT,BA,2011.0,1,2,-1
BH,KE,2005.0,3,1,2
IN,AR,2022.0,2,2,0
HU,VN,2015.0,1,1,0
BF,GB,2006.0,1,1,0
MY,AT,2009.0,1,1,0
IT,CR,2021.0,1,4,-3
AU,BG,2022.0,1,1,0
CH,TW,2015.0,5,16,-11
SK,CH,1998.0,2,1,1
IT,EC,2022.0,1,6,-5
PH,NZ,2017.0,3,2,1
CW,BE,2018.0,3,1,2
MA,SG,2020.0,1,1,0
IE,AT,2009.0,4,3,1
IL,BR,2004.0,2,6,-4
VN,SE,2022.0,2,1,1
SE,ZA,2010.0,11,8,3
EE,LT,2017.0,1,1,0
FI,CZ,2000.0,1,1,0
AO,FR,2016.0,1,1,0
CA,SN,2013.0,2,4,-2
KR,PK,2000.0,3,5,-2
CA,MD,2000.0,1,1,0
ID,CA,2004.0,6,1,5
HK,FR,2016.0,2,3,-1
PL,IR,2008.0,3,7,-4
GE,MX,2005.0,1,2,-1
SI,IT,2009.0,7,10,-3
NO,SI,2011.0,1,1,0
NZ,CL,2010.0,2,4,-2
MY,JP,2002.0,10,18,-8
BR,ET,2020.0,3,1,2
MY,SY,2012.0,1,2,-1
IQ,GB,2007.0,3,2,1
AU,BN,2014.0,2,4,-2
AE,SD,2022.0,4,7,-3
KW,IR,2019.0,4,5,-1
US,PS,2012.0,3,9,-6
BR,IN,2001.0,6,8,-2
MA,IR,2012.0,3,4,-1
BE,EE,2019.0,2,2,0
CH,BR,2023.0,2,3,-1
RW,IN,2020.0,5,4,1
PL,TW,2014.0,8,2,6
US,SV,2008.0,2,2,0
BN,EG,2012.0,1,2,-1
ID,AR,2016.0,2,3,-1
BN,AU,2013.0,2,2,0
QA,GB,2006.0,5,5,0
KH,TR,2022.0,1,9,-8
EE,RU,1998.0,1,2,-1
CZ,TN,2011.0,2,1,1
US,NC,2014.0,4,1,3
CA,GH,2007.0,3,3,0
PL,HK,2019.0,3,4,-1
BJ,DE,2013.0,1,1,0
CA,CR,2004.0,2,2,0
LT,BG,2012.0,1,1,0
GB,KH,2015.0,3,4,-1
NZ,EG,2020.0,2,2,0
PK,NZ,2011.0,3,5,-2
TR,ZA,2009.0,1,2,-1
VN,CA,2013.0,1,9,-8
PT,CU,2011.0,5,3,2
JP,CL,2013.0,4,4,0
IT,VE,2008.0,3,6,-3
MC,FR,1998.0,1,3,-2
NG,NL,2019.0,5,6,-1
PH,AR,2021.0,1,7,-6
JP,NA,2018.0,1,1,0
TW,IL,2017.0,4,2,2
IR,BD,2021.0,6,1,5
FR,GH,2022.0,4,1,3
DZ,DE,2019.0,3,5,-2
BR,SD,2006.0,3,4,-1
TZ,DE,2010.0,1,4,-3
RU,SA,2015.0,2,3,-1
PT,HN,2019.0,1,1,0
KE,TH,2017.0,1,4,-3
AE,TR,2016.0,7,5,2
MX,EC,2003.0,3,2,1
BE,BF,2020.0,5,4,1
AT,FI,2002.0,4,3,1
MY,GH,2016.0,3,1,2
DE,CU,2016.0,2,11,-9
AT,HR,2009.0,5,6,-1
KE,MW,2008.0,1,1,0
LT,AU,2014.0,1,1,0
US,BJ,2019.0,5,4,1
LT,NO,2009.0,1,2,-1
CH,DO,2002.0,2,1,1
FR,CZ,2023.0,2,1,1
BG,NL,2018.0,6,2,4
BG,GB,2007.0,7,7,0
KR,DK,2006.0,1,1,0
HR,NO,2020.0,2,3,-1
GT,BR,2010.0,4,1,3
BR,AF,2019.0,2,1,1
US,CL,2023.0,3,6,-3
NZ,VN,2020.0,5,5,0
MM,GB,2019.0,4,8,-4
CA,BG,1999.0,1,2,-1
GB,JM,2011.0,3,5,-2
SK,SE,2015.0,2,1,1
AT,CR,2013.0,1,2,-1
SG,NZ,2003.0,3,9,-6
FJ,US,2015.0,2,2,0
ID,HR,2021.0,1,2,-1
NP,NO,2011.0,2,1,1
TH,RU,2022.0,1,1,0
SE,NG,2009.0,5,2,3
CZ,TR,2008.0,2,3,-1
PK,LK,2011.0,1,1,0
AR,JP,2005.0,2,6,-4
BR,ST,1999.0,4,3,1
FI,UG,2019.0,2,1,1
PY,CL,2012.0,4,3,1
BB,US,2020.0,3,6,-3
ID,NO,2016.0,3,4,-1
CI,NE,2019.0,1,1,0
SA,TR,1998.0,2,3,-1
PH,MX,2002.0,2,3,-1
SE,VE,2009.0,2,2,0
IT,BG,2001.0,2,7,-5
CI,ML,2005.0,1,1,0
MY,MA,2012.0,1,1,0
FR,DJ,2015.0,3,2,1
TR,PT,2007.0,1,1,0
TR,GR,2012.0,2,7,-5
IS,DK,2007.0,3,7,-4
CU,CH,2003.0,4,1,3
GT,FR,2005.0,2,1,1
IQ,NO,2016.0,1,2,-1
SG,IL,2012.0,1,5,-4
MK,DK,2016.0,1,2,-1
NL,VN,2006.0,4,3,1
US,AL,2021.0,2,2,0
CA,SI,2019.0,3,3,0
BD,KZ,2017.0,1,1,0
SK,AU,2009.0,1,1,0
NZ,NG,2004.0,1,1,0
US,PY,2017.0,5,5,0
NA,NL,2013.0,1,2,-1
FR,BF,2006.0,9,9,0
TH,IN,1999.0,1,1,0
US,RE,2020.0,3,2,1
SE,UG,2009.0,2,1,1
LU,PL,2016.0,5,4,1
NL,BY,2011.0,3,2,1
PY,CU,2004.0,1,2,-1
QA,PT,2020.0,1,1,0
US,TN,1999.0,3,5,-2
IN,MK,2022.0,1,1,0
SE,LV,2005.0,3,2,1
RU,IE,1999.0,6,2,4
CZ,CL,2015.0,3,1,2
LT,RO,2004.0,3,2,1
DK,TH,2015.0,2,1,1
SE,NP,2020.0,1,1,0
IN,IL,2023.0,3,2,1
KW,IR,2010.0,1,1,0
SK,CN,2016.0,2,6,-4
ZA,GH,2003.0,1,2,-1
NG,DK,2021.0,1,1,0
PK,DK,2010.0,1,4,-3
VN,LA,2019.0,1,1,0
SN,ML,2003.0,1,1,0
LT,RU,2011.0,2,20,-18
LU,GB,2003.0,1,3,-2
BG,IE,2013.0,1,1,0
NL,AR,2004.0,2,4,-2
ML,CH,2021.0,1,4,-3
GB,MD,2013.0,1,3,-2
BR,EG,2021.0,3,2,1
SE,QA,2020.0,2,3,-1
RO,FI,2021.0,1,1,0
HR,CN,2022.0,2,1,1
FJ,IN,2006.0,1,1,0
UA,BG,1999.0,2,7,-5
CZ,KR,1998.0,3,2,1
MX,NI,2018.0,2,4,-2
VE,BE,2014.0,1,1,0
JP,ZM,2001.0,1,1,0
GH,BR,2017.0,1,3,-2
EE,PL,2008.0,2,6,-4
IN,LA,2019.0,1,1,0
CZ,IR,2015.0,3,5,-2
KH,CH,2017.0,1,1,0
HK,RS,2008.0,1,1,0
SE,CL,2005.0,1,4,-3
CA,VN,2005.0,3,2,1
LT,ES,2021.0,1,1,0
SA,ZA,2016.0,3,2,1
DE,UZ,2012.0,1,4,-3
SA,VG,2009.0,1,2,-1
TW,IL,2019.0,1,5,-4
TW,SA,2008.0,1,3,-2
DK,SK,2011.0,2,7,-5
IQ,MY,2023.0,1,3,-2
NI,MY,2011.0,1,1,0
NA,DE,2016.0,1,2,-1
GB,CA,2008.0,769,749,20
SE,US,2006.0,329,292,37
ES,BR,2008.0,222,212,10
BN,GB,2018.0,4,12,-8
GB,ES,2005.0,218,210,8
CN,CA,2003.0,222,294,-72
TR,BE,2016.0,18,17,1
NO,SJ,1998.0,3,3,0
CN,JP,2018.0,436,542,-106
GB,CH,2015.0,307,330,-23
nan,SE,2014.0,49,59,-10
US,SE,2004.0,307,315,-8
CN,ID,2019.0,366,222,144
JP,AU,2017.0,76,91,-15
FR,JP,2021.0,113,139,-26
RO,JP,2016.0,3,3,0
FR,DE,2005.0,353,380,-27
IT,SE,2008.0,87,53,34
ID,JP,2017.0,99,199,-100
CN,EG,2011.0,13,18,-5
CA,TW,2003.0,31,28,3
IT,FI,2017.0,28,29,-1
IN,NO,2015.0,22,22,0
CH,LU,2005.0,8,2,6
TZ,DE,2019.0,4,11,-7
RO,AT,2020.0,7,4,3
AU,MY,2012.0,101,77,24
CA,DZ,2020.0,13,17,-4
PL,BR,2016.0,11,11,0
ES,VE,2001.0,33,43,-10
PR,US,2007.0,4,5,-1
CM,FR,2015.0,21,26,-5
GE,nan,2022.0,2,1,1
UA,US,1999.0,30,14,16
CZ,RU,2017.0,88,59,29
PT,BE,2007.0,9,8,1
CH,NL,1997.0,28,46,-18
NL,ET,2022.0,7,4,3
CA,IQ,2021.0,9,11,-2
BG,US,2010.0,27,25,2
CH,CA,2021.0,90,108,-18
CL,BE,2020.0,6,12,-6
TR,ID,2020.0,22,10,12
BR,PH,2014.0,4,5,-1
PL,HU,2013.0,15,17,-2
nan,CA,2008.0,21,19,2
ZA,SE,2021.0,20,10,10
VG,US,2018.0,17,8,9
BW,ZA,2013.0,14,6,8
EG,MY,2014.0,36,34,2
US,OM,2010.0,12,7,5
CR,CO,2002.0,2,3,-1
DK,IT,2021.0,25,44,-19
CA,SY,2015.0,3,2,1
BE,MA,2010.0,4,5,-1
US,XK,2018.0,2,5,-3
GH,EG,2021.0,5,4,1
PK,DK,2019.0,9,12,-3
AT,HU,2004.0,15,17,-2
IT,NO,2003.0,11,16,-5
IR,TR,2017.0,50,26,24
MA,PK,2004.0,6,1,5
BE,HU,1998.0,2,5,-3
US,MW,2013.0,16,12,4
BE,TR,2018.0,17,23,-6
HU,RO,2001.0,17,92,-75
RU,LV,2003.0,14,8,6
DK,EG,2015.0,5,1,4
GR,CA,2003.0,6,8,-2
CR,ES,2022.0,23,19,4
PK,IN,1998.0,10,9,1
GE,TR,2013.0,2,1,1
MY,IR,2008.0,6,16,-10
GR,CN,2016.0,7,8,-1
VN,KR,2006.0,6,4,2
CA,PL,1997.0,10,7,3
GB,TT,2004.0,1,2,-1
SI,FR,2020.0,6,9,-3
BE,MZ,2011.0,2,2,0
nan,TR,2020.0,30,23,7
HK,GB,2004.0,3,2,1
RU,AU,2021.0,26,25,1
VE,BR,2005.0,10,10,0
EG,MA,2013.0,3,6,-3
NO,LV,2015.0,1,1,0
US,OM,2019.0,13,15,-2
SK,JP,2002.0,12,24,-12
KW,TR,2006.0,3,1,2
RU,ID,2017.0,12,11,1
DE,AM,2012.0,5,4,1
IL,IT,2007.0,10,6,4
RU,BE,2007.0,17,16,1
PA,ID,2019.0,2,2,0
CN,BG,2004.0,1,4,-3
LU,CO,2021.0,2,4,-2
RU,RS,2018.0,12,12,0
CZ,UZ,2017.0,3,1,2
AM,IT,2011.0,8,28,-20
LU,DZ,2017.0,2,2,0
UG,ES,2022.0,4,2,2
DE,MY,2003.0,4,2,2
EG,BE,1999.0,2,1,1
UG,DE,2011.0,1,3,-2
MZ,UA,2021.0,4,1,3
KZ,nan,2021.0,2,1,1
SY,FR,1998.0,1,2,-1
BG,CH,2015.0,3,3,0
PE,nan,2011.0,5,8,-3
NZ,NO,2006.0,6,2,4
TH,PT,2013.0,1,1,0
TW,ZA,2015.0,2,3,-1
EC,CU,2010.0,2,2,0
PE,EC,2010.0,4,3,1
ID,SD,2022.0,2,1,1
NP,SE,2014.0,1,1,0
GB,VG,2018.0,6,6,0
IS,GB,2004.0,2,1,1
NG,SE,2005.0,2,2,0
KH,CN,2007.0,1,1,0
BR,ZA,2004.0,7,6,1
US,HN,2007.0,2,4,-2
PL,SI,2009.0,3,1,2
QA,CH,2016.0,2,2,0
UY,EC,2022.0,1,5,-4
US,LV,2010.0,6,9,-3
US,FJ,1998.0,1,1,0
CH,CR,2013.0,2,1,1
SK,nan,1999.0,1,1,0
DE,UG,2013.0,3,2,1
FR,IN,2023.0,1,4,-3
CY,AE,2019.0,5,3,2
XK,GB,2016.0,1,1,0
KR,UA,2009.0,2,1,1
IN,ER,2021.0,1,2,-1
TR,JO,2016.0,1,1,0
nan,EG,2021.0,2,6,-4
US,MC,2020.0,1,2,-1
CZ,UZ,2010.0,2,1,1
LV,KR,2014.0,2,1,1
KE,NZ,2014.0,2,3,-1
JP,RO,1998.0,1,2,-1
ZA,BD,2014.0,1,1,0
GB,MA,1999.0,1,1,0
AT,PH,2004.0,2,1,1
BR,LB,2008.0,5,3,2
KW,SY,2019.0,2,3,-1
AU,CR,2007.0,1,1,0
AU,TL,2013.0,1,1,0
BG,CN,2018.0,2,11,-9
GB,MT,1998.0,1,3,-2
AU,LK,2004.0,1,4,-3
IT,SI,2008.0,7,7,0
AR,CR,2012.0,10,12,-2
JP,nan,2006.0,49,104,-55
IN,BD,2007.0,35,19,16
QA,CA,2018.0,17,18,-1
IL,nan,2018.0,24,27,-3
AT,PL,2003.0,10,3,7
TH,US,1997.0,14,27,-13
ZA,SA,2013.0,2,4,-2
CD,BE,2005.0,3,2,1
ZA,BW,2010.0,4,8,-4
GT,AR,2014.0,2,2,0
CO,UY,2005.0,1,4,-3
SA,TR,1997.0,1,1,0
HU,IN,2009.0,6,3,3
KW,GR,2004.0,1,2,-1
NL,LU,2021.0,7,8,-1
CL,BR,2000.0,10,13,-3
US,AZ,2003.0,1,3,-2
,NO,2003.0,1606,0,1606
IN,,2016.0,9461,0,9461
,GB,2008.0,17326,0,17326
KR,,2023.0,20775,0,20775
CN,,2014.0,66812,0,66812
,RU,1999.0,9556,0,9556
,AU,2001.0,4902,0,4902
DE,,2012.0,12997,0,12997
,KR,1995.0,4401,0,4401
CR,,2017.0,178,0,178
,IT,1997.0,10492,0,10492
,IT,1998.0,10329,0,10329
,IL,2000.0,2080,0,2080
,PT,1994.0,1898,0,1898
,MY,2010.0,5155,0,5155
,EG,2009.0,2898,0,2898
,CU,2003.0,413,0,413
,TR,1996.0,2900,0,2900
,SG,2011.0,1730,0,1730
,IE,1998.0,841,0,841
UA,,2003.0,417,0,417
,nan,1998.0,618,0,618
,UG,2005.0,172,0,172
,TR,2004.0,5200,0,5200
,UA,2016.0,5785,0,5785
,ZA,2014.0,2693,0,2693
AU,,2007.0,1873,0,1873
,IE,1997.0,787,0,787
,BE,2012.0,3456,0,3456
SG,,2014.0,675,0,675
PT,,1999.0,62,0,62
CR,,2010.0,30,0,30
DZ,,2021.0,1873,0,1873
,CZ,2003.0,1545,0,1545
,DO,2001.0,11,0,11
,nan,1997.0,583,0,583
,ML,2014.0,79,0,79
,SK,2005.0,617,0,617
US,SX,2004.0,1,0,1
,ID,2000.0,455,0,455
,MY,2017.0,3019,0,3019
,KE,2004.0,261,0,261
ID,,2025.0,836,0,836
,JO,2009.0,406,0,406
,MT,2009.0,66,0,66
,KW,1994.0,386,0,386
CH,,2003.0,1127,0,1127
LK,,2015.0,151,0,151
,RO,2011.0,2605,0,2605
AE,,2004.0,29,0,29
,KE,1996.0,181,0,181
,SK,2002.0,495,0,495
CG,,2024.0,206,0,206
OM,SD,2004.0,1,0,1
HU,,2006.0,359,0,359
,HR,1999.0,480,0,480
,MK,2014.0,220,0,220
IL,,2001.0,617,0,617
,LB,1999.0,174,0,174
,ET,2009.0,278,0,278
BI,,2022.0,47,0,47
,SN,2008.0,99,0,99
BY,,2015.0,226,0,226
,AL,2011.0,274,0,274
AL,CN,2014.0,4,0,4
KE,,2016.0,209,0,209
MW,NZ,2018.0,1,0,1
UZ,,2013.0,96,0,96
,QA,2008.0,196,0,196
EC,,2025.0,173,0,173
CR,,2019.0,320,0,320
,PR,2016.0,27,0,27
,AF,2009.0,12,0,12
MD,,2004.0,22,0,22
,RE,2006.0,21,0,21
,MY,2019.0,1480,0,1480
,GW,2013.0,6,0,6
UG,,2022.0,553,0,553
,OM,2018.0,173,0,173
,GE,2015.0,234,0,234
XK,,2016.0,35,0,35
AL,,2018.0,106,0,106
SG,BY,2003.0,1,0,1
NZ,CR,2011.0,1,0,1
BA,,2016.0,105,0,105
,CG,2015.0,52,0,52
OM,,2001.0,12,0,12
,FJ,2015.0,24,0,24
,LY,2013.0,63,0,63
,JM,2015.0,30,0,30
MD,DZ,2004.0,3,0,3
NI,,2023.0,163,0,163
PH,HU,2018.0,2,0,2
IT,AZ,2010.0,2,0,2
JP,AF,2018.0,7,0,7
VE,JP,2018.0,4,0,4
BN,NG,2015.0,1,0,1
PA,KR,2020.0,3,0,3
BN,,2022.0,72,0,72
GF,,2024.0,101,0,101
SV,,2014.0,7,0,7
IR,CZ,2018.0,11,0,11
AT,SG,2001.0,1,0,1
HR,JP,2022.0,1,0,1
,BB,2001.0,8,0,8
MA,,2023.0,5044,0,5044
TH,IQ,2014.0,1,0,1
,AZ,1994.0,72,0,72
CM,ML,2015.0,1,0,1
PS,AT,2020.0,2,0,2
UY,CH,2011.0,1,0,1
BF,NL,1999.0,2,0,2
MY,UY,2017.0,1,0,1
,UG,2002.0,141,0,141
,CW,2004.0,18,0,18
TZ,,2013.0,61,0,61
,MM,2008.0,18,0,18
,PA,2015.0,102,0,102
JO,,2004.0,33,0,33
,SV,2012.0,24,0,24
ES,MO,2004.0,1,0,1
AO,MX,2021.0,2,0,2
PF,CL,2004.0,1,0,1
LS,,2024.0,26,0,26
EG,DJ,2015.0,1,0,1
SK,TR,2004.0,1,0,1
MY,FR,1997.0,6,0,6
,LS,2016.0,6,0,6
LV,IL,2003.0,2,0,2
SI,BA,2010.0,2,0,2
AM,CH,2013.0,2,0,2
UA,BR,1999.0,1,0,1
KR,EC,2020.0,1,0,1
UZ,BY,2003.0,1,0,1
US,CN,2024.0,2,0,2
TN,IE,2019.0,3,0,3
AU,BB,2007.0,1,0,1
JE,CA,2007.0,1,0,1
PE,CN,2011.0,1,0,1
TN,TG,2021.0,1,0,1
CN,LU,2003.0,3,0,3
SA,YE,2004.0,1,0,1
MZ,,2011.0,21,0,21
CG,ZW,2022.0,2,0,2
JP,BN,2016.0,2,0,2
ET,FJ,2022.0,1,0,1
BW,NA,2012.0,1,0,1
QA,MY,2023.0,2,0,2
PE,PS,2018.0,1,0,1
UY,NL,2016.0,3,0,3
JO,PK,2013.0,3,0,3
SK,MD,2015.0,1,0,1
,PS,2003.0,31,0,31
BR,OM,2022.0,1,0,1
JP,BO,2014.0,1,0,1
PF,FR,2022.0,6,0,6
BG,CZ,2021.0,3,0,3
CU,SE,2018.0,3,0,3
,BF,2001.0,47,0,47
BB,,2022.0,21,0,21
,LA,2009.0,12,0,12
BH,,2018.0,55,0,55
GH,PH,2003.0,1,0,1
PH,GH,2006.0,1,0,1
,GT,2009.0,36,0,36
MX,MA,2003.0,1,0,1
BD,,2000.0,17,0,17
RS,,2003.0,28,0,28
FR,LK,2009.0,5,0,5
,XK,1995.0,2,0,2
,TT,1994.0,52,0,52
,CW,1996.0,17,0,17
PE,VE,2000.0,1,0,1
BR,HU,2002.0,1,0,1
SA,FI,2008.0,2,0,2
CM,AU,2016.0,1,0,1
HU,CI,2011.0,1,0,1
ST,,2023.0,25,0,25
PH,BE,2013.0,1,0,1
PR,JP,2020.0,2,0,2
AR,MK,2016.0,1,0,1
AE,NP,2019.0,1,0,1
PH,NZ,2010.0,3,0,3
JO,KW,2011.0,3,0,3
MY,AR,2005.0,4,0,4
ID,SG,2008.0,4,0,4
KW,,1999.0,28,0,28
JP,DO,2015.0,1,0,1
HR,HU,2005.0,1,0,1
IT,HR,2013.0,4,0,4
SY,IR,2018.0,1,0,1
IE,VU,2007.0,1,0,1
EG,KE,2014.0,1,0,1
LT,ET,2012.0,1,0,1
NP,,2003.0,9,0,9
BY,CN,2011.0,8,0,8
CN,SL,2019.0,2,0,2
CN,RO,2013.0,3,0,3
JP,MN,2001.0,5,0,5
MG,BE,2011.0,2,0,2
IT,ZM,2010.0,1,0,1
VE,PT,2006.0,5,0,5
,MN,2003.0,22,0,22
SK,GE,2014.0,6,0,6
SN,LU,2013.0,1,0,1
HU,IS,2017.0,1,0,1
NO,SJ,1997.0,2,0,2
DZ,CH,2022.0,3,0,3
FR,BO,2010.0,6,0,6
IQ,,2008.0,13,0,13
LT,IL,2016.0,3,0,3
HR,FK,2020.0,1,0,1
MU,,2009.0,5,0,5
NG,AT,1997.0,1,0,1
,NE,2009.0,23,0,23
BE,CD,2009.0,3,0,3
ZM,,2015.0,23,0,23
CI,CH,2006.0,1,0,1
,SS,1997.0,4,0,4
IL,DZ,2014.0,1,0,1
RO,VG,2006.0,1,0,1
TZ,IT,2009.0,1,0,1
CN,YE,2012.0,1,0,1
BF,,2000.0,3,0,3
BE,RW,2014.0,2,0,2
YE,QA,2021.0,1,0,1
GP,GF,2012.0,3,0,3
,VA,2017.0,1,0,1
SN,BF,2012.0,1,0,1
SK,KR,2005.0,2,0,2
GI,IT,2018.0,1,0,1
RS,VN,2013.0,1,0,1
US,GI,2016.0,2,0,2
TN,KR,2021.0,2,0,2
GR,KR,2017.0,6,0,6
BG,BW,2007.0,1,0,1
KZ,MX,2004.0,1,0,1
AT,ZA,1999.0,4,0,4
TR,TG,2005.0,2,0,2
NG,SI,2022.0,1,0,1
ID,RO,2007.0,1,0,1
MZ,TD,2015.0,1,0,1
TR,MM,2017.0,6,0,6
AU,IS,2008.0,2,0,2
NI,IL,2009.0,1,0,1
BJ,,2001.0,2,0,2
CW,,2011.0,10,0,10
,KG,2014.0,33,0,33
MQ,IN,2013.0,2,0,2
CH,OM,2010.0,1,0,1
PL,BA,2021.0,1,0,1
UG,DK,2022.0,1,0,1
GT,,2012.0,9,0,9
AT,MC,2004.0,3,0,3
LU,FI,2023.0,1,0,1
CH,HK,2006.0,2,0,2
NL,RS,2000.0,1,0,1
SM,,2014.0,1,0,1
GM,US,1998.0,1,0,1
CL,MY,2017.0,2,0,2
RO,HK,2007.0,9,0,9
PK,UG,2008.0,1,0,1
GB,MM,2015.0,2,0,2
IE,SG,2002.0,3,0,3
BO,,2006.0,6,0,6
MX,MY,2001.0,2,0,2
PT,VN,2003.0,1,0,1
IT,ZW,1997.0,1,0,1
,PT,2021.0,1,0,1
FR,TD,2018.0,1,0,1
SD,PL,2016.0,1,0,1
SE,LV,2002.0,1,0,1
JP,EC,2014.0,1,0,1
nan,RW,1999.0,1,0,1
GY,,2014.0,6,0,6
US,NP,1999.0,3,0,3
PR,BR,2005.0,1,0,1
BE,CI,2003.0,1,0,1
FI,BY,2013.0,1,0,1
KE,SA,2012.0,2,0,2
GW,NP,2015.0,1,0,1
LB,TR,2015.0,3,0,3
TR,AE,2010.0,3,0,3
DE,BO,2006.0,3,0,3
DE,LY,2012.0,2,0,2
MT,US,1999.0,1,0,1
FM,,2016.0,1,0,1
AO,SE,2010.0,1,0,1
CH,PE,2012.0,1,0,1
FR,RE,2023.0,3,0,3
NC,nan,2013.0,1,0,1
EE,VN,2019.0,2,0,2
SG,ZA,2018.0,7,0,7
BG,BY,2018.0,1,0,1
ES,GE,2008.0,3,0,3
ML,BJ,1999.0,1,0,1
MY,KH,2017.0,2,0,2
HN,,2006.0,8,0,8
,ER,2000.0,5,0,5
MC,DZ,2008.0,1,0,1
XK,HR,2013.0,2,0,2
ZA,PA,2011.0,2,0,2
CI,VN,2020.0,1,0,1
PR,FR,2010.0,1,0,1
ET,IL,2019.0,1,0,1
LT,SI,2015.0,1,0,1
CN,HK,1999.0,2,0,2
GH,CA,2023.0,1,0,1
OM,UZ,2017.0,1,0,1
PR,BR,2002.0,1,0,1
CM,ES,2005.0,1,0,1
RO,EE,2005.0,1,0,1
IR,OM,2013.0,3,0,3
US,FJ,1997.0,1,0,1
RW,TZ,2013.0,1,0,1
JP,BA,2020.0,1,0,1
BJ,GB,2001.0,1,0,1
IN,TZ,2010.0,5,0,5
CM,DZ,2018.0,1,0,1
IR,RO,2012.0,1,0,1
MY,ET,2016.0,3,0,3
IR,TW,2021.0,9,0,9
BW,FR,2014.0,1,0,1
BJ,CH,2010.0,3,0,3
MO,NO,2011.0,2,0,2
AR,MD,2015.0,1,0,1
,BZ,2001.0,4,0,4
IE,SG,2005.0,2,0,2
LI,,2011.0,2,0,2
AL,GR,2003.0,1,0,1
TN,AE,1997.0,1,0,1
KR,CM,2015.0,1,0,1
PG,CO,2014.0,1,0,1
VE,TH,2022.0,2,0,2
MD,UA,2001.0,2,0,2
BG,NO,2020.0,4,0,4
EC,GB,1999.0,2,0,2
MM,AU,2000.0,1,0,1
BJ,TZ,2014.0,1,0,1
PT,NZ,2008.0,1,0,1
UA,ES,2007.0,3,0,3
EE,NL,1997.0,1,0,1
EE,DK,2023.0,2,0,2
MA,AM,2008.0,3,0,3
CN,SA,2000.0,2,0,2
NO,TZ,2006.0,2,0,2
IT,PY,2009.0,2,0,2
IR,LK,2020.0,2,0,2
,BI,2006.0,15,0,15
GM,DE,2021.0,1,0,1
ID,LY,2021.0,2,0,2
IT,SY,2004.0,2,0,2
PA,IR,2019.0,8,0,8
,SS,1998.0,1,0,1
AE,NP,2017.0,2,0,2
HN,CL,2002.0,3,0,3
AL,NG,2016.0,1,0,1
ID,nan,2001.0,1,0,1
NL,RE,2004.0,1,0,1
IN,KY,2011.0,4,0,4
CZ,MX,2002.0,1,0,1
EG,CI,2015.0,1,0,1
TR,ET,2018.0,4,0,4
BH,JO,2007.0,1,0,1
BJ,CN,2011.0,1,0,1
ML,LU,2008.0,1,0,1
UG,LU,2004.0,3,0,3
GB,GA,2016.0,1,0,1
BE,GE,2011.0,2,0,2
PG,CH,2012.0,2,0,2
GP,AT,2016.0,1,0,1
DE,MM,2018.0,1,0,1
CA,ZW,2005.0,3,0,3
TW,IQ,2005.0,1,0,1
BE,RE,1999.0,1,0,1
CA,PR,2015.0,1,0,1
MD,BE,2016.0,1,0,1
SE,PS,2009.0,2,0,2
SY,AT,2022.0,1,0,1
TW,PK,2007.0,3,0,3
NO,VG,2014.0,1,0,1
EG,SG,2014.0,2,0,2
CN,SN,2013.0,2,0,2
VN,LA,2017.0,1,0,1
AE,RO,2020.0,1,0,1
CZ,MY,2006.0,1,0,1
DZ,PL,2004.0,1,0,1
CO,NO,2002.0,1,0,1
PA,IN,2021.0,2,0,2
LY,,2025.0,3,0,3
FR,RW,2022.0,1,0,1
CN,HU,1997.0,1,0,1
SA,AF,2018.0,1,0,1
NP,NL,2011.0,3,0,3
HN,CL,2005.0,1,0,1
SK,QA,2013.0,2,0,2
GM,JP,2004.0,1,0,1
HU,BD,2007.0,1,0,1
AL,SE,2005.0,1,0,1
RS,SE,2004.0,3,0,3
GA,BE,2007.0,1,0,1
VE,CR,2001.0,2,0,2
UZ,AZ,2002.0,1,0,1
BW,PL,2011.0,1,0,1
SK,PT,2003.0,2,0,2
CA,TT,2019.0,5,0,5
IT,UZ,2004.0,1,0,1
LB,DK,2008.0,1,0,1
KZ,CA,2004.0,1,0,1
SC,,2002.0,1,0,1
CI,BF,2009.0,3,0,3
AU,SY,1998.0,1,0,1
BN,IT,2020.0,1,0,1
CO,BZ,2018.0,1,0,1
ID,PL,2016.0,1,0,1
SL,GM,2020.0,1,0,1
IT,LV,2013.0,1,0,1
KR,DZ,2015.0,1,0,1
DE,AG,2017.0,2,0,2
MC,,2001.0,2,0,2
HU,PH,2015.0,1,0,1
BT,LK,2008.0,1,0,1
ET,HU,2011.0,1,0,1
IE,MY,1997.0,1,0,1
MX,HU,2005.0,2,0,2
DE,GA,2001.0,1,0,1
PA,BE,2013.0,1,0,1
CI,,2008.0,19,0,19
BY,MZ,2016.0,1,0,1
CH,MA,2011.0,5,0,5
GE,PL,2020.0,1,0,1
CH,MK,2012.0,1,0,1
MY,KH,2010.0,2,0,2
RW,KR,2012.0,1,0,1
LK,UZ,2016.0,1,0,1
BD,GM,2017.0,1,0,1
SV,MN,2015.0,1,0,1
PT,IE,2000.0,1,0,1
NO,CG,2008.0,1,0,1
SA,KR,2008.0,1,0,1
ES,MK,2017.0,1,0,1
IN,MC,2021.0,1,0,1
IL,RE,2006.0,1,0,1
HK,,1999.0,1,0,1
AT,MX,2003.0,2,0,2
HU,LY,2021.0,1,0,1
DK,TZ,2003.0,1,0,1
NP,QA,2022.0,1,0,1
IE,LU,2011.0,1,0,1
UY,PE,2003.0,3,0,3
LV,CH,2012.0,1,0,1
UA,HR,2015.0,3,0,3
EE,ID,2014.0,1,0,1
AG,AU,2006.0,1,0,1
OM,CO,2014.0,1,0,1
IT,HN,2011.0,1,0,1
NO,CW,2000.0,2,0,2
PH,CU,2011.0,1,0,1
IN,SC,2016.0,1,0,1
PT,IN,2000.0,1,0,1
BE,TZ,2001.0,1,0,1
MY,SE,1999.0,1,0,1
BJ,ID,2018.0,2,0,2
PF,NE,2012.0,2,0,2
NL,VE,2009.0,1,0,1
DK,KR,2000.0,1,0,1
GB,ME,2022.0,2,0,2
MA,BJ,2013.0,2,0,2
TM,,2012.0,2,0,2
CA,BO,2016.0,2,0,2
GR,BD,2003.0,1,0,1
GL,DK,2000.0,2,0,2
PE,JP,2015.0,5,0,5
LY,IQ,2017.0,2,0,2
SE,PH,2013.0,3,0,3
DZ,NO,2014.0,1,0,1
SN,CG,2016.0,3,0,3
GP,JM,2009.0,2,0,2
PE,SI,2010.0,1,0,1
IT,KR,2000.0,2,0,2
DE,EE,2023.0,1,0,1
BR,SV,2014.0,1,0,1
US,JE,2007.0,1,0,1
LA,GB,2003.0,1,0,1
,TL,2006.0,1,0,1
LB,RU,2008.0,1,0,1
NG,QA,2015.0,1,0,1
FR,AO,2004.0,1,0,1
CR,AU,2022.0,3,0,3
CZ,MX,2005.0,2,0,2
SE,AX,2010.0,1,0,1
SA,SY,2010.0,2,0,2
PL,BW,2002.0,1,0,1
MK,SG,2014.0,1,0,1
CL,MY,2019.0,2,0,2
RE,,2001.0,4,0,4
AU,VG,2001.0,1,0,1
CI,JP,2007.0,1,0,1
HR,HU,2002.0,2,0,2
GH,BR,2010.0,1,0,1
DE,KH,1998.0,1,0,1
CG,MK,2004.0,1,0,1
VE,NO,2016.0,1,0,1
SV,nan,2019.0,1,0,1
HU,ID,2009.0,1,0,1
AZ,GB,2007.0,1,0,1
CU,NL,2022.0,1,0,1
PH,nan,2018.0,1,0,1
NL,BF,2020.0,1,0,1
BR,RW,2020.0,1,0,1
nan,MU,2014.0,1,0,1
MY,CZ,2007.0,2,0,2
DZ,ET,2020.0,1,0,1
MX,CU,2023.0,1,0,1
GB,BJ,2005.0,1,0,1
IL,ML,2020.0,2,0,2
CM,SA,2016.0,1,0,1
CH,MW,2002.0,1,0,1
PL,HK,2010.0,2,0,2
PR,,2001.0,1,0,1
PY,PA,2020.0,1,0,1
BF,DK,2008.0,1,0,1
CA,ML,2013.0,1,0,1
LU,TW,2009.0,1,0,1
AR,SV,2010.0,1,0,1
KR,SN,2017.0,2,0,2
PT,PK,2006.0,2,0,2
HN,AR,2013.0,3,0,3
HU,SA,2003.0,1,0,1
ZW,MW,2009.0,2,0,2
TR,FR,2023.0,2,0,2
MU,IN,2011.0,1,0,1
KR,KZ,2022.0,1,0,1
KH,AU,2005.0,2,0,2
CA,TD,1999.0,1,0,1
AL,MY,2010.0,1,0,1
PL,SD,2012.0,1,0,1
FR,BJ,2023.0,1,0,1
DE,MN,2000.0,1,0,1
US,VA,2006.0,1,0,1
DZ,IR,2006.0,1,0,1
AU,OM,2022.0,2,0,2
SY,PT,2015.0,1,0,1
ZW,BE,2004.0,1,0,1
ET,PA,2010.0,1,0,1
BR,LV,2008.0,1,0,1
AE,BR,1998.0,1,0,1
AZ,IN,2020.0,1,0,1
BO,DE,2005.0,1,0,1
CU,VN,2015.0,1,0,1
CM,PT,2018.0,1,0,1
IR,CL,1998.0,3,0,3
DZ,PT,2000.0,1,0,1
BY,PK,2013.0,1,0,1
NO,AE,2020.0,1,0,1
IL,GR,2021.0,2,0,2
EC,DE,2007.0,2,0,2
FR,LA,2001.0,1,0,1
BY,RO,2018.0,1,0,1
UG,AU,2021.0,6,0,6
CN,MD,2013.0,2,0,2
IE,JM,2017.0,2,0,2
NL,LY,2004.0,1,0,1
SK,GR,2022.0,1,0,1
ID,UG,2014.0,1,0,1
ZA,KW,2019.0,1,0,1
CN,KW,2010.0,2,0,2
GN,PG,2013.0,1,0,1
ET,CU,2019.0,1,0,1
SZ,,2009.0,2,0,2
ET,MY,2008.0,1,0,1
IN,IQ,2008.0,1,0,1
CU,PH,2006.0,1,0,1
QA,UA,2014.0,1,0,1
BH,CN,2009.0,1,0,1
VU,NC,2008.0,1,0,1
SK,FI,2000.0,1,0,1
ZW,ML,2005.0,1,0,1
TR,SK,2013.0,1,0,1
DE,LI,2002.0,1,0,1
MN,CN,2013.0,2,3,-1
CZ,SE,2023.0,1,1,0
IQ,CZ,2021.0,3,1,2
HR,BE,2020.0,3,6,-3
MD,TR,2020.0,5,10,-5
SS,US,2005.0,1,1,0
SS,US,2002.0,1,1,0
PT,IT,1997.0,3,14,-11
IT,AZ,2017.0,4,11,-7
IT,BE,2023.0,6,1,5
AT,FR,2023.0,2,1,1
CH,RS,1997.0,1,2,-1
AM,FR,2013.0,1,4,-3
PK,AM,2014.0,1,1,0
NP,CN,2007.0,2,1,1
AR,MY,2007.0,2,1,1
GB,EE,2004.0,1,4,-3
LB,AE,2013.0,2,5,-3
BE,PT,2023.0,1,1,0
US,BJ,2010.0,1,2,-1
SI,RO,2016.0,1,1,0
PL,LU,2011.0,1,1,0
PL,PH,2007.0,2,1,1
AT,NG,2021.0,1,1,0
TR,CL,2015.0,2,2,0
CR,CA,2002.0,1,2,-1
PH,CO,2011.0,1,3,-2
GH,ET,2004.0,1,1,0
US,CI,1999.0,1,1,0
BD,KE,2011.0,1,1,0
CN,MA,2018.0,3,4,-1
TR,EG,2007.0,1,3,-2
BE,GA,2016.0,1,1,0
AU,KH,2008.0,2,1,1
PL,UZ,2020.0,1,2,-1
RS,BE,2004.0,1,2,-1
US,IQ,2002.0,1,1,0
BJ,NC,2011.0,1,1,0
HR,FR,2021.0,3,6,-3
TW,PL,2000.0,1,2,-1
AE,DE,1999.0,1,1,0
TW,HU,2012.0,2,1,1
VN,BE,2015.0,2,18,-16
TW,CL,2020.0,1,1,0
TR,UZ,2021.0,1,1,0
CA,TT,2010.0,2,2,0
LI,CH,2016.0,2,1,1
MA,SA,2001.0,1,1,0
NO,KR,2000.0,1,2,-1
CA,MK,2014.0,1,2,-1
NG,GM,2022.0,2,1,1
PT,CL,2001.0,1,3,-2
LY,IQ,2019.0,1,1,0
SN,CM,2013.0,2,1,1
NI,BR,2021.0,1,2,-1
NG,JP,2001.0,2,3,-1
GB,MT,1997.0,1,3,-2
BI,GB,2012.0,1,1,0
RU,ID,2010.0,4,1,3
ZM,BW,2014.0,1,1,0
DE,KG,2020.0,1,3,-2
LY,GB,2004.0,1,2,-1
HU,EC,2020.0,1,2,-1
KZ,LV,2021.0,1,2,-1
KW,CN,2014.0,1,1,0
ET,IR,2018.0,1,3,-2
GE,PT,2013.0,2,1,1
ID,LB,2017.0,1,3,-2
DK,nan,1999.0,2,6,-4
US,SI,2023.0,1,1,0
MX,BO,2010.0,1,2,-1
IT,JO,2022.0,2,2,0
LY,AE,2021.0,1,1,0
CG,CD,2017.0,2,1,1
BD,AT,2018.0,1,1,0
BE,HR,2005.0,1,1,0
SE,NZ,2004.0,3,3,0
SN,GH,2017.0,1,1,0
LT,UA,2022.0,2,4,-2
TR,SY,2018.0,1,1,0
ZA,AR,2012.0,1,1,0
SL,US,2008.0,1,2,-1
KW,OM,2001.0,1,1,0
UA,FI,2006.0,1,1,0
GE,CN,1999.0,1,1,0
TN,IN,2008.0,1,5,-4
LT,GB,2001.0,1,1,0
IT,GH,2022.0,2,1,1
GP,MQ,2008.0,1,1,0
EG,HU,2006.0,1,2,-1
NO,EE,2009.0,1,1,0
PS,SA,2005.0,1,1,0
UZ,DE,2015.0,2,5,-3
AR,SV,2017.0,2,1,1
PT,NG,2022.0,1,2,-1
US,CD,2007.0,1,1,0
JP,MM,2022.0,1,9,-8
EE,VN,2017.0,1,1,0
LU,DK,2020.0,1,2,-1
EE,AT,2004.0,1,2,-1
BN,SG,2013.0,2,1,1
KZ,DE,2022.0,2,3,-1
IQ,MA,2018.0,2,1,1
US,BA,1999.0,1,1,0
SE,CL,2002.0,1,3,-2
RO,SG,2004.0,1,1,0
BR,KR,2006.0,2,6,-4
FR,HT,2015.0,2,1,1
CL,ZA,2003.0,1,2,-1
CN,CL,2017.0,1,4,-3
NG,CH,2020.0,1,5,-4
BR,CN,1997.0,1,4,-3
FR,BO,2019.0,1,1,0
GB,SC,2010.0,1,2,-1
GB,SC,2019.0,2,2,0
FR,VG,2004.0,1,2,-1
JP,ET,2009.0,1,2,-1
MD,CA,2020.0,1,1,0
PK,DE,1999.0,1,5,-4
DK,BY,2000.0,1,1,0
NL,TN,2020.0,1,2,-1
SG,UA,2013.0,1,1,0
KR,LK,2013.0,1,4,-3
VN,MX,2011.0,1,6,-5
TT,AU,2012.0,1,1,0
JO,NG,2022.0,1,1,0
NO,CL,2015.0,1,1,0
HU,TW,2020.0,1,1,0
LY,DE,2017.0,1,2,-1
NO,SA,2006.0,1,1,0
MW,NL,2020.0,1,1,0
MY,PL,2016.0,1,3,-2
IL,BY,2007.0,1,1,0
DE,HK,2011.0,1,1,0
AU,ZM,2016.0,1,1,0
CZ,AR,2000.0,1,1,0
FR,CR,2012.0,1,6,-5
TN,RU,2008.0,1,1,0
AT,IR,2004.0,1,2,-1
BA,AT,2013.0,1,2,-1
IT,QA,2011.0,1,1,0
TH,DE,2003.0,2,7,-5
LT,CN,1998.0,1,1,0
MG,CN,2011.0,1,6,-5
TW,VN,2007.0,1,1,0
EG,UA,2011.0,1,1,0
CY,PL,2015.0,1,2,-1
TZ,NL,2022.0,1,3,-2
GR,LK,2003.0,1,6,-5
XK,DE,2013.0,1,1,0
PT,MZ,2014.0,1,5,-4
CY,TZ,2019.0,1,1,0
VN,DK,2013.0,2,5,-3
CL,DK,2011.0,3,1,2
CY,AE,2017.0,1,1,0
KZ,KR,2020.0,2,2,0
TZ,BE,2022.0,1,3,-2
GB,NE,2016.0,2,1,1
EE,LT,2019.0,2,1,1
RS,BR,2011.0,1,2,-1
AR,SI,2015.0,1,2,-1
QA,BD,2015.0,1,2,-1
MY,FR,1998.0,1,4,-3
PL,EE,2016.0,1,1,0
NO,GH,2003.0,1,1,0
IT,LB,2001.0,1,3,-2
TN,SY,2014.0,1,3,-2
IE,TW,2020.0,1,2,-1
LT,EE,2015.0,1,1,0
NP,ES,2018.0,1,1,0
PG,ZA,1999.0,1,0,1
ER,IN,2020.0,1,0,1
MG,NL,2008.0,1,0,1
IR,BO,2009.0,1,0,1
ZA,KH,2012.0,1,0,1
SC,ET,2022.0,1,0,1
BD,NL,1999.0,1,0,1
TR,NZ,2015.0,2,0,2
PF,NC,2007.0,1,0,1
CZ,LK,2022.0,1,0,1
IS,LU,2011.0,1,0,1
UZ,MY,2009.0,1,0,1
JP,CU,2002.0,2,0,2
TT,FR,2007.0,1,0,1
,TZ,2020.0,12,0,12
MO,CN,2004.0,1,0,1
HU,GR,2007.0,2,0,2
HR,VE,2001.0,1,0,1
DO,VE,2003.0,1,0,1
MY,UY,2010.0,1,0,1
GP,NC,2005.0,1,0,1
AU,LU,2004.0,1,0,1
PT,HN,2017.0,1,0,1
KH,SE,2022.0,1,0,1
FI,TJ,2019.0,1,0,1
CA,BI,2014.0,1,0,1
BR,CD,2018.0,1,0,1
NA,UG,2022.0,1,0,1
PG,GH,2009.0,1,0,1
FI,TZ,2015.0,1,0,1
YE,OM,2012.0,1,0,1
MA,NL,2007.0,1,0,1
BA,ES,2017.0,1,0,1
PK,BD,1998.0,1,0,1
MY,VN,2001.0,1,0,1
SK,DZ,2021.0,1,0,1
TH,ZA,2015.0,3,0,3
CZ,KW,2010.0,1,0,1
VI,PL,2013.0,1,0,1
JM,GF,2019.0,1,0,1
AT,GA,2006.0,1,0,1
NC,CH,2020.0,1,0,1
VN,XK,2019.0,1,0,1
MU,AE,2012.0,1,0,1
SE,OM,2007.0,2,0,2
IT,ZM,2017.0,1,0,1
MR,CA,2015.0,1,0,1
BG,IL,2003.0,1,0,1
XK,SI,2014.0,1,0,1
PY,,2006.0,1,0,1
MD,IN,2016.0,1,0,1
OM,ET,2020.0,1,0,1
JM,BW,2016.0,1,0,1
SS,,2006.0,1,0,1
OM,SE,2021.0,1,0,1
CG,MD,2015.0,1,0,1
SJ,,2008.0,1,0,1
IT,UG,2009.0,1,0,1
QA,PH,2012.0,1,0,1
CM,TW,2014.0,1,0,1
ME,,2003.0,3,0,3
PH,BJ,2012.0,1,0,1
BA,GB,2000.0,1,0,1
CH,PF,2012.0,1,0,1
KR,LT,2010.0,1,0,1
PL,GE,1998.0,1,0,1
MT,AU,1997.0,1,0,1
YE,KW,2007.0,1,0,1
SV,IL,2019.0,1,0,1
PR,TH,2010.0,1,0,1
SO,CH,2020.0,1,0,1
PA,SA,2015.0,1,0,1
SY,MX,2000.0,1,0,1
FI,SG,2003.0,2,0,2
BF,IT,2017.0,1,0,1
GB,MN,2020.0,1,0,1
MT,AR,2018.0,1,0,1
KH,RU,2010.0,1,0,1
AE,CL,2012.0,2,0,2
UA,PS,2014.0,1,0,1
OM,HU,2007.0,1,0,1
TR,PS,2013.0,1,0,1
RS,ID,2018.0,1,0,1
BE,CY,2022.0,1,0,1
PA,HU,2019.0,1,0,1
ZA,LU,2016.0,1,0,1
SZ,ZA,2006.0,2,0,2
SD,ML,2016.0,1,0,1
BW,CH,2021.0,1,0,1
UY,PT,2000.0,2,0,2
GB,BJ,2002.0,1,0,1
CH,RS,1998.0,2,0,2
BH,IQ,2013.0,1,0,1
AT,EE,1998.0,1,0,1
NL,UZ,2011.0,1,0,1
KP,,2013.0,1,0,1
ZM,SD,2000.0,1,0,1
RS,RO,2000.0,1,0,1
CA,LV,1999.0,1,0,1
IT,TZ,2013.0,1,0,1
NL,JO,2012.0,1,0,1
DK,GE,2012.0,1,0,1
KR,HK,2011.0,1,0,1
CF,FR,2022.0,1,0,1
LA,AU,2000.0,1,0,1
LV,MA,2018.0,1,0,1
HU,LT,2017.0,1,0,1
SL,ID,2018.0,1,0,1
GH,FI,2021.0,1,0,1
RO,CY,2005.0,1,0,1
RO,NO,2007.0,1,0,1
EC,FR,2023.0,2,0,2
MA,EG,2000.0,1,0,1
TN,IE,2010.0,1,0,1
SE,GH,2011.0,1,0,1
ME,ES,2012.0,1,0,1
WS,AU,2007.0,1,0,1
MW,NA,2013.0,1,0,1
DJ,,2020.0,1,0,1
BA,NO,2003.0,1,0,1
PH,LB,2015.0,1,0,1
EE,JP,2003.0,4,0,4
BJ,VN,2019.0,1,0,1
IR,CL,1997.0,1,0,1
CH,QA,2013.0,3,0,3
CG,NG,1997.0,1,0,1
NZ,LU,2011.0,1,0,1
RU,PS,2013.0,1,0,1
JP,JO,2001.0,1,0,1
TR,BG,1997.0,1,0,1
BI,IT,2020.0,1,0,1
NP,BT,2021.0,1,0,1
EG,MR,2022.0,1,0,1
DZ,BF,2017.0,1,0,1
CZ,MA,2023.0,1,0,1
NZ,PH,2009.0,1,0,1
LT,SK,2015.0,1,0,1
AT,NP,2021.0,1,0,1
ES,KW,2014.0,2,0,2
NO,VN,2023.0,1,0,1
BN,MY,2003.0,1,0,1
UG,CG,2016.0,1,0,1
UG,SS,2018.0,1,0,1
BD,NG,2009.0,1,0,1
MR,FR,2022.0,1,0,1
BF,NG,2011.0,1,0,1
LU,GH,2022.0,1,0,1
,FK,2003.0,1,0,1
SA,AR,2016.0,1,0,1
TR,LY,2007.0,1,0,1
SI,PT,2011.0,1,0,1
PL,LV,2020.0,2,0,2
CD,AR,2011.0,1,0,1
SR,NL,2007.0,1,0,1
BG,AZ,2018.0,1,0,1
MA,CD,2021.0,1,0,1
ID,PS,2011.0,1,0,1
KR,GD,2015.0,1,0,1
RU,CY,2006.0,1,0,1
HN,CO,2006.0,2,0,2
MY,GN,2022.0,1,0,1
DE,TG,2013.0,1,0,1
TN,GR,2009.0,1,0,1
IN,PE,2011.0,1,0,1
NG,SE,2002.0,1,0,1
KH,RU,2017.0,1,0,1
LR,GB,2013.0,1,0,1
CZ,QA,2012.0,1,0,1
FI,IL,2004.0,1,0,1
SA,AM,2004.0,1,0,1
OM,NZ,2016.0,2,0,2
SY,CH,2016.0,1,0,1
VN,GH,2009.0,1,0,1
NO,HR,2007.0,1,0,1
HU,LU,2014.0,1,0,1
NI,FR,2016.0,1,0,1
KW,SK,2011.0,1,0,1
RE,AM,2020.0,1,0,1
GB,MQ,2021.0,1,0,1
HU,GE,1999.0,1,0,1
VN,MK,2015.0,2,0,2
ES,BA,2018.0,1,0,1
PE,SI,2019.0,1,0,1
MM,FR,2002.0,1,0,1
AG,AR,2012.0,1,0,1
CV,US,2004.0,1,0,1
SE,PE,2006.0,1,0,1
AU,AZ,2018.0,1,0,1
ET,IT,2023.0,2,0,2
NL,SL,2020.0,1,0,1
KG,RU,2005.0,1,0,1
ES,ZM,2017.0,1,0,1
KG,ID,2015.0,1,0,1
RE,BR,2019.0,1,0,1
MQ,US,2020.0,1,0,1
IL,LK,2011.0,1,0,1
nan,LB,2004.0,1,0,1
SC,,2005.0,1,0,1
CY,IQ,2013.0,1,0,1
IN,YE,2023.0,1,0,1
,ST,2020.0,1,0,1
AG,AL,2020.0,1,0,1
ID,LT,2022.0,1,0,1
IR,MY,2009.0,32,5,27
GB,US,2020.0,6003,6121,-118
US,NO,2010.0,140,128,12
US,GB,2014.0,6006,6158,-152
RU,MX,2004.0,13,10,3
US,BE,2022.0,194,201,-7
GB,CA,2013.0,861,890,-29
CA,US,2016.0,3714,3304,410
IT,US,2003.0,606,625,-19
FI,US,2012.0,110,126,-16
MD,CN,2016.0,2,4,-2
GB,IE,2022.0,237,229,8
ES,VE,2003.0,36,54,-18
GB,DE,2012.0,840,821,19
US,AU,2000.0,1073,1103,-30
JP,CN,2011.0,646,428,218
FR,MX,2017.0,81,62,19
CN,US,1999.0,1538,1550,-12
CN,JP,2017.0,426,541,-115
US,SE,2014.0,454,424,30
CN,SG,2008.0,253,353,-100
CA,CN,2012.0,516,392,124
CH,US,1997.0,306,297,9
US,JP,2002.0,1707,1956,-249
KR,EG,2017.0,12,2,10
AU,ZA,2010.0,42,51,-9
US,NO,2017.0,196,152,44
JP,DK,1998.0,8,8,0
DE,CA,2019.0,296,320,-24
GB,SE,2000.0,69,67,2
CO,CL,2018.0,307,244,63
US,CH,2022.0,443,412,31
MA,FR,2005.0,168,159,9
KR,EG,2019.0,8,8,0
IN,US,2022.0,2003,1630,373
AR,IT,2013.0,95,88,7
ZA,AU,2016.0,82,60,22
AU,ZA,2017.0,62,71,-9
US,JM,2015.0,20,17,3
MY,PK,2018.0,158,66,92
LK,FR,2005.0,5,1,4
CH,US,1998.0,383,366,17
JP,IN,2010.0,120,115,5
SE,AU,2017.0,58,67,-9
TH,FR,2017.0,12,19,-7
IL,AU,2003.0,13,4,9
US,FR,2012.0,1459,1542,-83
DK,GB,2018.0,156,144,12
DE,nan,2008.0,52,62,-10
DK,US,2000.0,152,150,2
ES,NL,2017.0,127,95,32
PT,nan,2020.0,18,31,-13
MG,FR,2020.0,7,7,0
ES,BR,2013.0,389,337,52
TR,KZ,2014.0,46,65,-19
VE,US,2018.0,54,27,27
TW,US,2014.0,718,751,-33
CN,FI,2010.0,16,22,-6
IE,US,2005.0,301,350,-49
CN,JP,2010.0,438,603,-165
KR,MY,2019.0,30,34,-4
IT,nan,2018.0,108,104,4
BR,CH,2014.0,43,51,-8
DE,AU,2018.0,290,281,9
FR,NL,2009.0,150,203,-53
CG,ZW,2016.0,3,1,2
BE,TR,2017.0,18,25,-7
DE,CA,2010.0,251,247,4
IT,BR,2015.0,292,231,61
CA,IS,2009.0,2,2,0
MX,BE,2015.0,16,19,-3
CA,GB,2001.0,421,458,-37
AU,IN,2018.0,200,230,-30
ES,NL,2019.0,107,107,0
GB,MY,1999.0,33,14,19
CN,TW,2012.0,878,1372,-494
ZA,NL,2007.0,24,29,-5
IT,ES,2014.0,251,291,-40
ES,CR,2018.0,62,52,10
EG,GB,2013.0,57,88,-31
AU,CA,2009.0,315,312,3
AT,DE,2016.0,633,664,-31
DE,CA,2017.0,310,295,15
TN,DE,2005.0,2,2,0
PE,US,2015.0,97,92,5
PE,CO,2019.0,92,170,-78
CN,QA,2004.0,2,4,-2
BR,DE,2014.0,199,218,-19
BE,US,2008.0,218,247,-29
NL,IT,2011.0,65,114,-49
TW,CA,2004.0,26,31,-5
MX,FR,2004.0,27,35,-8
GR,DE,2005.0,33,32,1
TN,SA,2015.0,70,19,51
PH,CN,2007.0,29,12,17
AU,TW,1999.0,12,10,2
US,MX,2008.0,310,291,19
nan,US,2004.0,190,148,42
TR,JP,2022.0,42,39,3
PA,ES,2008.0,11,5,6
NL,BE,2009.0,210,219,-9
PE,CO,2017.0,67,110,-43
AU,ZA,2019.0,56,93,-37
US,PL,2014.0,281,206,75
GB,nan,2018.0,127,94,33
US,PT,1997.0,43,29,14
IN,AU,2003.0,48,48,0
US,IS,2009.0,25,17,8
RU,RS,2019.0,20,20,0
AU,CN,2008.0,238,249,-11
FR,IN,2000.0,122,29,93
CN,CR,2003.0,4,1,3
DK,CA,2017.0,36,47,-11
CU,AR,2018.0,26,17,9
DK,CA,2019.0,54,41,13
PL,IT,2009.0,16,23,-7
FR,BE,2004.0,187,200,-13
BE,ES,2009.0,55,43,12
BR,AO,2021.0,47,39,8
KR,IN,2016.0,163,241,-78
PH,MY,2007.0,1,1,0
KR,JP,2022.0,264,188,76
GB,BR,2022.0,117,186,-69
AU,ES,2010.0,32,43,-11
JP,BD,2001.0,16,9,7
LK,AU,2017.0,34,28,6
TR,CO,2018.0,147,20,127
MX,US,2014.0,418,396,22
nan,ES,2016.0,52,104,-52
IL,US,2019.0,596,593,3
MY,IR,2013.0,125,104,21
CO,US,2002.0,81,52,29
JP,FR,2020.0,143,202,-59
IE,CA,2021.0,114,157,-43
CN,FI,2017.0,27,48,-21
AE,SA,2016.0,19,37,-18
IN,GB,2008.0,297,258,39
BR,TL,2022.0,1,2,-1
JP,TN,2012.0,1,1,0
US,NZ,2021.0,326,259,67
SE,DK,2015.0,155,133,22
HK,CN,2022.0,125,118,7
CN,BR,2015.0,70,56,14
JP,PH,2009.0,15,14,1
JP,AU,2018.0,74,82,-8
SA,AU,2016.0,29,47,-18
CN,CH,2003.0,33,54,-21
PE,EC,2018.0,41,37,4
CH,SE,2004.0,26,35,-9
RS,SI,2022.0,15,7,8
DE,ES,2011.0,199,206,-7
CH,DE,2007.0,485,714,-229
HU,AT,2014.0,43,29,14
AT,US,2001.0,139,173,-34
US,AR,1999.0,83,104,-21
DK,SE,2012.0,91,108,-17
FR,AR,2016.0,108,91,17
ES,PE,2020.0,186,148,38
AU,ID,2007.0,17,18,-1
BE,RO,2020.0,12,9,3
CN,JP,2019.0,446,596,-150
MX,AR,2004.0,48,39,9
IN,SG,2011.0,87,66,21
DE,TR,2016.0,70,89,-19
IN,NP,2012.0,73,58,15
MX,CR,2020.0,41,42,-1
AU,nan,2001.0,8,6,2
DZ,FR,2007.0,53,55,-2
EC,CU,2018.0,15,53,-38
CN,ID,2018.0,361,166,195
CN,SE,2004.0,45,60,-15
AU,FJ,2013.0,3,7,-4
CN,MY,2002.0,5,8,-3
CH,SG,2001.0,7,2,5
CN,NP,2015.0,13,11,2
FR,AU,2016.0,157,143,14
SK,IT,2011.0,6,5,1
RU,TW,2004.0,11,12,-1
ES,NL,2010.0,66,65,1
CO,US,2005.0,91,124,-33
IT,JP,2022.0,30,24,6
NO,DK,2004.0,41,48,-7
QA,ES,2021.0,3,5,-2
CN,ES,2018.0,86,95,-9
CA,DE,2018.0,286,290,-4
ST,BR,2012.0,41,21,20
IE,US,2002.0,209,233,-24
nan,CA,2013.0,34,36,-2
DK,CN,2022.0,50,48,2
CN,PH,2012.0,24,21,3
CN,NO,2022.0,20,25,-5
CN,CA,2001.0,173,192,-19
IR,CZ,2019.0,17,1,16
DK,NL,2021.0,55,42,13
CY,DE,2022.0,6,3,3
ZA,NG,2020.0,134,134,0
BD,AU,2015.0,66,57,9
IT,AT,2006.0,27,18,9
IL,FR,2013.0,36,33,3
AU,JP,2002.0,49,54,-5
DZ,US,2017.0,41,60,-19
CN,CU,2016.0,1,5,-4
GR,ES,2002.0,8,3,5
BR,CL,2004.0,24,25,-1
US,LB,2014.0,75,71,4
ES,SE,2014.0,72,39,33
CO,MX,2014.0,270,304,-34
US,EG,2000.0,58,44,14
PE,CO,2010.0,27,24,3
US,NO,2019.0,177,186,-9
GR,CH,2013.0,29,10,19
ZW,BW,2019.0,3,6,-3
TW,JP,2016.0,95,96,-1
CH,CN,2003.0,54,33,21
US,KE,2009.0,48,34,14
JP,IN,2019.0,136,149,-13
GR,NL,2020.0,44,35,9
GR,AT,2019.0,9,11,-2
IE,CZ,2021.0,5,2,3
BG,US,2018.0,39,41,-2
DE,KR,2015.0,54,56,-2
nan,RU,2005.0,51,36,15
EG,JP,1999.0,9,20,-11
GR,GB,2002.0,54,131,-77
VE,AR,2020.0,20,10,10
MY,TW,2009.0,11,8,3
GB,PL,2014.0,83,95,-12
CN,NL,2008.0,62,77,-15
GR,AT,2017.0,7,6,1
ID,US,2007.0,34,39,-5
SK,CZ,2020.0,150,146,4
PE,CA,2011.0,5,6,-1
FR,MX,2010.0,48,43,5
CR,ES,2016.0,63,58,5
BR,NL,2007.0,33,24,9
FR,SG,2010.0,22,12,10
RU,IL,2022.0,29,23,6
IN,ZA,2019.0,86,67,19
ZA,IN,2020.0,54,65,-11
ID,JP,2018.0,137,231,-94
DE,CZ,2013.0,64,51,13
ZA,CA,2005.0,27,15,12
AU,DK,2020.0,73,62,11
TZ,CA,1997.0,5,1,4
FR,IL,2020.0,42,31,11
nan,UA,2020.0,45,23,22
IQ,QA,2022.0,4,12,-8
nan,NI,2020.0,1,1,0
GB,DK,2011.0,128,89,39
KW,US,2020.0,17,31,-14
FR,SG,2019.0,28,36,-8
CH,IT,2006.0,138,176,-38
IT,BJ,2020.0,2,1,1
ID,IN,2020.0,96,120,-24
US,PH,2021.0,159,227,-68
KR,DE,2008.0,36,28,8
IT,SE,2013.0,85,73,12
FR,PL,2002.0,28,24,4
DE,AR,2021.0,34,59,-25
SA,GB,2002.0,18,18,0
NG,CM,2020.0,9,6,3
TN,CH,2006.0,6,4,2
PL,US,2009.0,179,183,-4
IS,SE,2022.0,9,7,2
FR,MX,2019.0,74,80,-6
TJ,RU,2020.0,34,122,-88
MY,MV,2018.0,1,1,0
SE,AU,2019.0,53,69,-16
SG,VN,2015.0,16,5,11
KR,NL,2020.0,12,10,2
SE,CH,2022.0,50,33,17
AT,BE,2017.0,13,15,-2
IN,PL,2020.0,27,13,14
QA,US,2008.0,12,31,-19
EG,QA,2011.0,19,17,2
NL,RO,2022.0,8,3,5
SK,DE,2015.0,33,37,-4
US,GM,2021.0,3,3,0
BE,VN,2011.0,8,4,4
CN,FI,2019.0,29,40,-11
CI,FR,2013.0,13,39,-26
IT,PL,2020.0,37,33,4
DZ,US,2019.0,73,93,-20
SY,IR,2019.0,2,3,-1
GB,LY,2004.0,2,1,1
TR,ET,2017.0,2,2,0
CG,CD,2018.0,2,1,1
MY,CA,2013.0,31,34,-3
TN,FR,2002.0,31,39,-8
DE,GH,2022.0,12,4,8
PL,CZ,2016.0,52,61,-9
UA,IT,2007.0,9,19,-10
KW,MA,2003.0,2,2,0
SG,US,2023.0,13,16,-3
AE,GB,2019.0,44,75,-31
ME,RS,2021.0,17,27,-10
ID,SD,2016.0,2,3,-1
QA,AU,2015.0,19,14,5
SE,IR,2007.0,16,11,5
TR,CA,2022.0,24,20,4
ID,ES,2011.0,9,13,-4
ID,NL,2022.0,28,27,1
FR,GR,2004.0,27,16,11
VN,FR,2015.0,22,39,-17
TZ,DE,2018.0,6,1,5
CL,FR,2005.0,17,19,-2
AT,BE,2019.0,25,19,6
NZ,FR,2014.0,17,19,-2
GB,TN,2014.0,5,2,3
SA,OM,2019.0,19,17,2
NZ,PK,2015.0,11,11,0
AE,TR,2022.0,4,6,-2
PS,EG,2020.0,14,19,-5
VN,GB,2021.0,15,20,-5
IR,TH,2016.0,5,4,1
OM,CA,2019.0,10,10,0
IT,MA,2020.0,43,18,25
IN,ZA,2017.0,75,50,25
JP,CZ,1997.0,6,4,2
GB,KE,2018.0,31,35,-4
KW,EG,2020.0,36,14,22
KR,MY,2017.0,42,31,11
MX,NI,2019.0,8,4,4
SE,ZA,2018.0,19,20,-1
ZA,DK,2021.0,4,7,-3
GB,QA,2018.0,60,26,34
IL,SI,2005.0,1,1,0
CN,ET,2007.0,4,2,2
RU,LT,2010.0,20,6,14
CN,AU,2001.0,78,143,-65
ES,CA,2002.0,29,23,6
JP,KR,2023.0,16,34,-18
DE,PK,2015.0,35,33,2
RU,TJ,2016.0,15,50,-35
GB,EE,2014.0,10,7,3
BE,KR,2006.0,10,3,7
BE,RU,2021.0,11,26,-15
AU,ES,2017.0,59,80,-21
RO,BE,2013.0,12,9,3
CZ,CN,2018.0,26,17,9
LB,QA,2019.0,9,5,4
RU,LV,2001.0,9,11,-2
GR,BE,2013.0,37,14,23
ES,CZ,2021.0,24,17,7
ET,KR,2022.0,77,73,4
JP,ID,2004.0,37,13,24
IL,US,2017.0,560,511,49
DE,DZ,2017.0,6,5,1
CZ,RU,2018.0,77,53,24
SE,PA,2009.0,4,7,-3
BE,MA,2018.0,9,5,4
CA,AR,2009.0,22,20,2
nan,SG,2016.0,11,12,-1
AR,UY,2004.0,11,7,4
DK,ES,2012.0,24,25,-1
IT,FI,2018.0,33,22,11
RU,NL,2008.0,36,28,8
SE,AU,2010.0,49,47,2
ET,DE,2008.0,5,3,2
RU,FR,2006.0,48,43,5
RS,CA,2013.0,12,18,-6
CA,HU,2013.0,12,10,2
HR,BR,2012.0,4,2,2
IT,VE,2013.0,3,4,-1
QA,CA,2017.0,13,16,-3
IE,HR,2008.0,2,3,-1
SA,US,2002.0,34,46,-12
AU,ES,2019.0,64,73,-9
KE,IT,2010.0,6,3,3
BR,FI,2008.0,5,4,1
DE,AE,2012.0,9,7,2
RO,DE,2009.0,28,38,-10
CA,IE,2022.0,71,78,-7
CR,AU,2016.0,3,2,1
BE,TR,2010.0,9,11,-2
BR,RU,2015.0,10,7,3
AU,JP,2005.0,52,54,-2
KR,RU,2020.0,27,28,-1
IT,GR,2004.0,12,9,3
IT,DK,2001.0,8,13,-5
SE,NL,2013.0,44,70,-26
CH,BE,2013.0,73,93,-20
SA,BD,2008.0,7,2,5
IQ,EG,2020.0,74,97,-23
IL,AR,2014.0,6,2,4
DE,NO,2023.0,8,6,2
CZ,LT,2007.0,5,7,-2
RU,RS,2017.0,11,10,1
RO,ES,2006.0,8,4,4
TN,MD,2018.0,2,2,0
ES,CH,2002.0,24,36,-12
SD,IQ,2021.0,11,10,1
HU,CH,2016.0,19,14,5
RU,KR,2015.0,8,21,-13
GR,DE,2002.0,25,32,-7
ES,AU,2021.0,44,53,-9
GB,HU,2009.0,40,48,-8
SE,JP,2018.0,41,30,11
DK,AU,2005.0,19,22,-3
OM,CA,2017.0,14,7,7
BD,CA,2005.0,11,5,6
RU,BG,2018.0,31,51,-20
CA,CL,2021.0,21,28,-7
AR,CL,1999.0,13,13,0
SE,FI,2016.0,87,111,-24
KR,EG,2010.0,5,5,0
RO,ZA,2021.0,12,2,10
AT,IR,2014.0,12,14,-2
FR,GF,2017.0,24,15,9
SK,CA,2013.0,10,3,7
KR,MY,2010.0,15,15,0
JP,MN,2003.0,2,1,1
TZ,NL,2016.0,3,4,-1
IN,NZ,2016.0,38,32,6
JP,TH,2001.0,26,19,7
HU,IL,2014.0,6,2,4
MX,NO,2015.0,5,3,2
RU,BY,2008.0,74,36,38
SE,TH,2015.0,10,11,-1
DE,LU,2003.0,7,9,-2
US,TZ,2020.0,28,20,8
DZ,DE,2018.0,8,7,1
AT,FR,2000.0,17,18,-1
IE,IN,2015.0,22,35,-13
PK,SE,2017.0,9,16,-7
ES,CA,2005.0,46,43,3
PL,RU,2006.0,21,16,5
US,PY,2018.0,10,2,8
CN,PL,1997.0,4,1,3
FR,SG,2017.0,31,21,10
GB,AR,2016.0,36,28,8
CU,US,2014.0,43,25,18
JP,CZ,1998.0,10,5,5
IE,TR,2021.0,6,6,0
US,NA,2021.0,5,6,-1
PK,CH,2018.0,12,17,-5
US,PE,2004.0,29,30,-1
AU,FR,2022.0,58,56,2
GB,RO,2008.0,22,14,8
nan,SE,2004.0,42,40,2
CH,CU,2012.0,1,3,-2
RO,HU,2009.0,24,30,-6
FR,CZ,2000.0,19,12,7
NZ,RU,2014.0,10,3,7
CN,DK,2013.0,46,34,12
ZW,ZA,2008.0,19,1,18
FR,BJ,2000.0,6,3,3
ZA,IE,1998.0,3,1,2
DE,JO,2006.0,11,9,2
VG,US,2017.0,31,4,27
IT,AZ,2018.0,10,16,-6
AE,GB,2010.0,12,27,-15
ES,SV,2017.0,11,7,4
CN,NG,2015.0,9,18,-9
NL,IQ,2018.0,5,1,4
MK,ID,2015.0,5,3,2
EG,MY,2004.0,4,2,2
AU,KR,2018.0,43,65,-22
JP,MM,2016.0,12,3,9
AU,SG,1999.0,27,24,3
PH,NZ,2018.0,6,4,2
KR,IT,2019.0,14,7,7
MA,ID,2017.0,4,3,1
ES,KE,2015.0,3,2,1
IE,CO,2020.0,4,3,1
KR,NP,2022.0,12,6,6
AU,AR,2007.0,7,5,2
TH,FR,2019.0,16,20,-4
JO,ID,2020.0,3,5,-2
FR,GF,2019.0,28,17,11
SE,NZ,2014.0,8,9,-1
PT,NL,2013.0,25,25,0
CN,MA,2017.0,1,2,-1
PF,FR,2016.0,13,10,3
CN,IQ,2021.0,11,6,5
IE,DE,2014.0,84,78,6
SG,ZA,2019.0,5,1,4
NP,IT,2021.0,1,1,0
TW,NL,2011.0,6,7,-1
ES,SI,2006.0,3,5,-2
IR,TR,2018.0,38,29,9
BR,PY,2014.0,12,3,9
MA,ID,2019.0,6,6,0
PK,SD,2020.0,3,5,-2
ID,MY,2006.0,6,17,-11
PE,IT,2021.0,11,7,4
DE,SI,2020.0,17,8,9
IT,CA,2008.0,82,66,16
CZ,CH,2013.0,26,27,-1
UZ,CZ,2012.0,2,4,-2
FR,MQ,2016.0,15,12,3
MA,CH,2016.0,6,4,2
US,CL,2000.0,61,58,3
ZA,CA,2002.0,18,10,8
RU,RS,2010.0,12,5,7
DE,MX,2013.0,41,39,2
CN,KE,2019.0,20,13,7
CN,LK,2018.0,11,6,5
VE,CO,2007.0,28,13,15
AR,AT,2020.0,11,3,8
AE,GB,2017.0,33,80,-47
PT,GR,2014.0,4,1,3
NZ,JP,2018.0,16,13,3
MX,CN,2000.0,3,2,1
IL,CN,2022.0,26,18,8
NL,PE,2017.0,4,2,2
ZW,GB,2020.0,12,11,1
FR,PL,2005.0,48,45,3
US,MA,2013.0,14,17,-3
GH,ZM,2022.0,45,9,36
CL,AU,2009.0,10,8,2
CA,YE,2020.0,1,1,0
MX,VN,2013.0,5,5,0
AR,nan,2021.0,32,36,-4
AZ,RU,2011.0,10,7,3
CH,EE,2000.0,4,1,3
NL,ET,2016.0,13,2,11
HU,RO,2003.0,19,39,-20
CZ,TR,2013.0,4,5,-1
ES,ZA,2018.0,15,7,8
ES,GE,2013.0,1,1,0
GE,nan,2016.0,2,3,-1
MA,US,2020.0,22,27,-5
FI,NL,2004.0,23,22,1
NO,ET,2018.0,15,11,4
IL,FI,2015.0,3,1,2
AU,GR,2011.0,6,8,-2
BW,ZA,2008.0,7,2,5
BH,PL,2021.0,12,9,3
UA,ZA,2019.0,2,5,-3
HN,CU,2011.0,1,1,0
IQ,JP,2008.0,2,2,0
CA,UA,2017.0,10,7,3
CO,RU,2020.0,4,4,0
PE,AT,2016.0,1,1,0
FR,SA,1998.0,3,2,1
GB,VG,2010.0,2,3,-1
CA,UA,2019.0,6,5,1
CL,DE,1999.0,11,12,-1
DK,GR,2000.0,3,1,2
CN,MY,2005.0,23,24,-1
CA,TW,2001.0,21,24,-3
SI,nan,2020.0,4,9,-5
DE,NG,2005.0,6,5,1
FR,SN,1999.0,13,10,3
AT,CO,2019.0,7,4,3
GB,DZ,2004.0,1,1,0
GR,AT,2010.0,5,2,3
SA,GB,2005.0,12,24,-12
SA,MA,2020.0,11,9,2
IT,UA,2011.0,9,12,-3
IT,BE,2000.0,37,43,-6
CL,FR,2002.0,16,12,4
DK,UA,2007.0,1,1,0
VG,US,2010.0,12,18,-6
CH,BR,2000.0,9,6,3
NL,AR,2014.0,10,10,0
HR,US,2008.0,35,49,-14
DK,BG,2020.0,6,4,2
PT,CN,2021.0,13,10,3
AM,FR,2008.0,2,1,1
CZ,IT,2012.0,25,14,11
IT,NO,2001.0,10,16,-6
GP,FR,2001.0,7,9,-2
IT,AU,2004.0,19,27,-8
FI,DK,1998.0,12,4,8
nan,CO,2014.0,7,4,3
ZA,KE,2021.0,25,22,3
IN,RO,2014.0,16,19,-3
ES,CH,2005.0,35,27,8
BE,nan,1999.0,18,8,10
US,DZ,2011.0,20,17,3
NG,NL,2018.0,7,7,0
GB,VG,2017.0,3,3,0
ES,UY,2013.0,40,56,-16
CL,IT,1997.0,3,5,-2
CH,TR,2016.0,15,18,-3
FI,ES,2022.0,12,17,-5
CN,CO,2021.0,2,2,0
US,PT,1998.0,37,34,3
BT,LK,2013.0,1,1,0
CO,DE,2005.0,7,5,2
DK,CA,2010.0,20,33,-13
BR,AF,2018.0,5,1,4
PL,SK,2006.0,5,5,0
GB,AT,2003.0,42,36,6
PL,TW,2004.0,3,3,0
PH,CA,1999.0,4,1,3
BE,TR,2019.0,13,26,-13
JP,NZ,1998.0,7,13,-6
SA,KR,2013.0,4,13,-9
IT,NZ,2014.0,10,4,6
AE,OM,2001.0,1,3,-2
MX,EC,2001.0,1,2,-1
IR,CZ,2017.0,4,2,2
TN,FR,2005.0,64,110,-46
JP,RU,2021.0,23,32,-9
NO,LT,2003.0,2,2,0
nan,RU,2002.0,10,35,-25
KE,NL,2002.0,1,1,0
LS,ZA,2009.0,3,2,1
RU,LT,2019.0,8,7,1
IN,EG,2004.0,4,3,1
TR,SA,2021.0,12,11,1
SA,KW,2003.0,2,1,1
BR,ZA,2014.0,8,11,-3
AT,JP,2015.0,14,23,-9
CN,MX,2007.0,4,6,-2
PY,MX,2021.0,8,15,-7
CN,PT,2009.0,12,8,4
BN,GB,2010.0,1,4,-3
AU,OM,2016.0,6,2,4
SY,IR,2017.0,4,1,3
CR,ZA,2011.0,3,2,1
RU,ID,2018.0,16,17,-1
CN,IR,2013.0,23,22,1
SE,TW,2013.0,7,3,4
TR,AE,2018.0,8,6,2
KR,PK,2023.0,3,6,-3
NG,IN,2021.0,24,29,-5
ES,PK,2020.0,10,5,5
CA,NP,2014.0,4,6,-2
SG,RU,2015.0,10,8,2
SY,LB,2016.0,2,1,1
FR,GF,2010.0,11,7,4
ZA,TZ,2011.0,5,3,2
US,BG,2007.0,23,23,0
SA,OM,2017.0,12,4,8
ID,CH,2011.0,1,1,0
PK,DK,2018.0,5,7,-2
CZ,GR,2012.0,3,3,0
DE,PH,2004.0,4,6,-2
GB,NA,2019.0,1,3,-2
PK,SE,2019.0,10,15,-5
EE,CH,2005.0,1,4,-3
SA,US,2005.0,43,58,-15
JP,TZ,2006.0,4,1,3
AT,RU,2011.0,7,12,-5
IN,IL,2000.0,16,4,12
IR,TN,2006.0,1,1,0
RS,DK,2012.0,2,4,-2
SA,JO,2011.0,9,40,-31
BG,ES,2014.0,2,3,-1
nan,PS,2017.0,2,1,1
IT,IR,2015.0,27,40,-13
US,OM,2018.0,15,13,2
BG,FI,2004.0,1,1,0
CZ,IN,2012.0,15,27,-12
EE,AT,2014.0,5,2,3
SG,MX,2005.0,6,5,1
NL,TR,1999.0,4,4,0
DK,SG,1997.0,3,1,2
LY,GB,2014.0,2,15,-13
BI,US,2016.0,8,2,6
OM,EG,2005.0,1,4,-3
NL,SE,2001.0,29,29,0
DK,AU,2002.0,19,25,-6
SA,FR,2013.0,8,41,-33
CZ,VN,2020.0,9,5,4
BE,TW,2021.0,6,7,-1
US,MW,2008.0,4,6,-2
HU,DE,1999.0,22,26,-4
EG,SA,1999.0,16,18,-2
IR,QA,2015.0,3,2,1
ZA,MY,2020.0,5,10,-5
PL,HU,2008.0,18,11,7
CN,KE,2017.0,16,16,0
SE,RU,2011.0,25,30,-5
RW,SA,2014.0,1,1,0
GB,GH,2021.0,22,30,-8
CA,QA,2012.0,12,7,5
IN,IR,2006.0,9,5,4
NO,LU,2018.0,3,2,1
RU,BR,2011.0,11,8,3
ID,CA,2014.0,13,15,-2
NO,FI,2013.0,12,14,-2
US,LT,2003.0,5,6,-1
PK,MX,2005.0,2,1,1
IT,LT,2021.0,3,1,2
JP,IL,2019.0,11,11,0
IN,PH,2011.0,9,10,-1
nan,BE,2000.0,11,11,0
CA,LK,2018.0,9,5,4
nan,UG,2012.0,4,1,3
NL,TH,2004.0,4,2,2
FI,IL,2014.0,2,2,0
UA,MY,2015.0,3,11,-8
TH,DE,2001.0,5,4,1
ZA,JP,2014.0,8,7,1
SI,CZ,1998.0,1,1,0
DZ,US,2010.0,11,12,-1
ZA,IT,2006.0,11,14,-3
CA,nan,2002.0,7,14,-7
TH,FR,2010.0,11,17,-6
CA,MY,2014.0,27,36,-9
KE,NL,2005.0,4,2,2
AT,TH,2015.0,5,2,3
DE,CM,2014.0,7,5,2
IT,TR,2004.0,15,7,8
SG,BR,2012.0,1,1,0
US,JO,1999.0,16,8,8
DE,NG,2002.0,6,3,3
SI,GB,2015.0,16,11,5
DK,PL,2001.0,1,5,-4
FR,PF,2016.0,10,13,-3
PK,NP,2016.0,3,3,0
NP,CA,2015.0,3,6,-3
PE,CL,2004.0,16,16,0
IE,CN,1997.0,4,1,3
JM,TT,2005.0,7,13,-6
US,ML,2020.0,6,3,3
MX,IN,2007.0,9,11,-2
MD,MA,2006.0,7,2,5
FR,SI,2005.0,4,8,-4
NG,SD,2014.0,3,3,0
LI,CH,2022.0,3,1,2
BR,PL,2008.0,4,2,2
KR,MX,2012.0,7,2,5
CA,nan,2005.0,10,19,-9
AU,TR,2021.0,7,12,-5
SY,JO,2013.0,3,3,0
HK,GB,2014.0,5,9,-4
US,MU,2006.0,3,1,2
SG,NL,1998.0,3,1,2
BE,EC,2015.0,10,1,9
DE,GA,2003.0,2,2,0
HR,TR,2012.0,5,1,4
JP,AZ,2018.0,4,1,3
NO,CH,2001.0,11,8,3
LT,US,2001.0,7,4,3
AT,CO,2017.0,3,2,1
TR,KR,2005.0,10,1,9
JP,LT,2011.0,5,8,-3
AG,BR,2021.0,1,4,-3
MM,US,2005.0,5,2,3
CA,CR,2014.0,2,1,1
DE,VE,2009.0,5,7,-2
NZ,CL,2018.0,8,6,2
SA,ZA,2022.0,3,1,2
ZA,BE,2013.0,13,30,-17
LU,AE,2021.0,1,1,0
CH,KR,2008.0,9,10,-1
ZW,US,2001.0,10,3,7
MA,PK,2014.0,18,17,1
KR,LU,2020.0,4,1,3
IT,BO,2019.0,2,1,1
MY,GB,2007.0,25,82,-57
FI,DK,1997.0,2,2,0
PT,PL,2012.0,3,4,-1
SY,EG,2015.0,5,3,2
AE,JO,2004.0,1,6,-5
IT,SI,2013.0,13,16,-3
UY,CU,2019.0,5,2,3
RU,SK,2009.0,13,8,5
BG,FR,2011.0,11,14,-3
UG,CG,2022.0,1,1,0
KR,AU,2004.0,10,19,-9
ET,MY,2013.0,1,1,0
NG,CD,2016.0,1,1,0
PL,UA,2022.0,27,46,-19
LK,AU,2010.0,14,8,6
BO,CL,2013.0,4,3,1
MZ,GB,2018.0,1,2,-1
HU,ES,2012.0,5,7,-2
CM,SN,2021.0,2,1,1
TW,AR,2013.0,13,8,5
MD,CH,2017.0,3,2,1
NL,LV,2010.0,1,1,0
VE,CA,1999.0,1,4,-3
PT,CV,2011.0,1,1,0
DK,ZA,2006.0,4,5,-1
PK,NG,2004.0,1,2,-1
MX,BO,2018.0,14,7,7
JO,QA,2021.0,15,5,10
NG,ET,2019.0,15,10,5
FR,TD,2017.0,5,3,2
GB,LU,2020.0,10,13,-3
CA,GD,2015.0,3,1,2
IL,IE,2009.0,3,2,1
ZM,ZW,2021.0,2,2,0
RU,LT,2017.0,9,10,-1
ID,SI,2020.0,10,12,-2
nan,CR,2012.0,4,1,3
CL,CA,2009.0,16,13,3
CH,NZ,2020.0,23,9,14
GR,KW,2017.0,4,2,2
NL,PE,2010.0,2,2,0
ID,EG,2014.0,7,8,-1
CN,PL,1998.0,3,1,2
PA,MX,2008.0,7,7,0
SA,CA,2003.0,14,13,1
AU,KE,2021.0,3,4,-1
AT,CA,2022.0,18,11,7
OM,CA,2010.0,4,7,-3
CZ,ES,2018.0,21,29,-8
SG,ZA,2017.0,2,2,0
GR,KW,2019.0,6,1,5
NG,ET,2017.0,7,6,1
MZ,US,2020.0,3,6,-3
BG,SE,2011.0,4,6,-2
VN,MY,2020.0,2,12,-10
KW,IQ,2021.0,14,10,4
SE,AT,2020.0,25,44,-19
IT,EC,2016.0,10,1,9
NZ,NG,2014.0,4,1,3
BO,ES,2006.0,3,4,-1
AU,SN,2016.0,1,1,0
CR,IT,2021.0,4,1,3
ET,BE,2022.0,8,6,2
PH,nan,2017.0,3,2,1
GR,KW,2010.0,3,4,-1
SE,EE,2001.0,6,7,-1
RU,IN,2008.0,20,11,9
LU,US,2004.0,2,7,-5
FR,NC,2018.0,26,14,12
FR,SC,2017.0,1,1,0
PL,IL,1999.0,4,4,0
KR,IT,2010.0,6,7,-1
RO,JP,2022.0,1,1,0
IR,DE,1997.0,2,1,1
SA,JP,2020.0,5,16,-11
JP,IL,2017.0,5,12,-7
TH,AT,2000.0,1,2,-1
CZ,UZ,2018.0,2,6,-4
FR,GP,2000.0,7,4,3
GH,IN,2011.0,3,1,2
KZ,BG,2020.0,1,2,-1
ES,IN,2006.0,10,12,-2
JO,SE,2007.0,1,4,-3
GB,GA,2022.0,2,1,1
IN,KZ,2020.0,2,2,0
QA,CH,2022.0,3,1,2
EE,DE,2005.0,14,21,-7
IN,MA,2003.0,1,1,0
MK,AU,2001.0,5,4,1
JP,IL,2010.0,10,13,-3
ES,DZ,2016.0,5,3,2
ET,JP,2018.0,4,7,-3
KW,BD,2012.0,3,3,0
RO,LT,2007.0,6,2,4
ID,AU,2001.0,5,7,-2
QA,RS,2020.0,1,1,0
AZ,TR,2006.0,6,3,3
NL,TW,2003.0,3,2,1
AT,NO,2005.0,8,5,3
YE,US,2015.0,2,2,0
JP,NZ,1997.0,6,11,-5
CN,SA,2023.0,5,4,1
TW,IL,2018.0,4,4,0
AU,NZ,2023.0,10,9,1
CH,EG,2008.0,2,1,1
PE,CR,2008.0,5,3,2
IT,PK,2007.0,3,1,2
JP,AM,2007.0,7,6,1
JO,AU,2012.0,5,10,-5
IL,BE,2011.0,2,5,-3
GH,BR,2018.0,1,3,-2
BW,US,2013.0,10,10,0
IT,RW,2019.0,1,1,0
EG,IT,2009.0,5,4,1
PL,TR,1998.0,1,1,0
ES,SV,2010.0,4,5,-1
FI,TH,2016.0,3,1,2
BH,IN,2013.0,1,1,0
JP,CL,2008.0,4,6,-2
AO,BR,2011.0,12,17,-5
PK,SE,2010.0,9,7,2
NL,KR,2001.0,3,3,0
nan,SI,2004.0,1,1,0
LK,FR,2002.0,2,4,-2
AE,SD,2016.0,4,2,2
GT,HN,2020.0,1,2,-1
TH,NL,2014.0,6,11,-5
IT,HU,2006.0,8,16,-8
UA,CZ,2022.0,11,13,-2
MA,IQ,2018.0,1,2,-1
QA,GR,2014.0,1,6,-5
QA,MX,2016.0,1,1,0
BE,PL,2012.0,14,18,-4
AR,HN,2016.0,2,1,1
PH,RO,2019.0,1,1,0
KH,NL,2017.0,1,1,0
TW,BR,2006.0,3,2,1
US,BJ,2018.0,3,6,-3
BE,DK,2001.0,5,4,1
UA,PL,2008.0,8,10,-2
HR,XK,2019.0,4,4,0
FR,RE,2000.0,8,4,4
JO,IE,2005.0,2,1,1
ZM,ZA,2020.0,8,16,-8
MX,NI,2010.0,4,1,3
CG,BF,2014.0,1,2,-1
LY,IQ,2018.0,3,2,1
TZ,BE,2016.0,4,1,3
ID,GR,2020.0,5,4,1
QA,CA,2010.0,2,7,-5
NO,CZ,2009.0,8,18,-10
BJ,CM,2020.0,2,3,-1
ID,CM,2011.0,1,1,0
BE,SG,2018.0,5,6,-1
DE,ET,2009.0,3,7,-4
SN,GH,2018.0,5,1,4
US,ZM,2022.0,7,13,-6
AE,GR,2014.0,2,8,-6
GB,YE,2007.0,2,1,1
IN,ZW,1997.0,1,1,0
UG,NO,2009.0,1,3,-2
BR,BG,2015.0,9,4,5
AT,BE,2010.0,12,16,-4
MA,DE,2012.0,5,6,-1
SG,KH,2020.0,2,2,0
CU,IT,2001.0,2,2,0
HU,JP,2009.0,4,13,-9
KR,SE,2000.0,2,4,-2
PH,AU,2012.0,6,14,-8
IE,PK,2006.0,2,1,1
CN,SL,2018.0,1,2,-1
IS,CA,2003.0,1,4,-3
IN,LK,2016.0,16,8,8
KW,IN,2012.0,6,4,2
IR,PL,2015.0,5,4,1
MY,UA,2022.0,3,2,1
MX,RO,2005.0,3,1,2
BT,AU,2015.0,2,4,-2
OM,JO,2007.0,4,2,2
SI,MK,2015.0,3,3,0
KE,CO,2011.0,4,3,1
CU,GB,2007.0,3,4,-1
ID,AR,2022.0,3,1,2
PH,US,2023.0,8,8,0
SD,TW,2018.0,1,1,0
MA,TW,2021.0,1,1,0
IN,MK,2016.0,1,3,-2
KZ,FI,2017.0,1,2,-1
UA,SK,2021.0,6,1,5
CN,IN,2023.0,9,12,-3
BG,AU,2005.0,2,1,1
TN,RU,2013.0,2,3,-1
IL,UA,1998.0,2,2,0
GR,CN,2022.0,5,6,-1
KW,AE,2009.0,3,3,0
HR,CH,2005.0,2,2,0
DE,OM,2011.0,4,1,3
AM,CZ,2021.0,5,2,3
GB,VN,2007.0,6,4,2
BF,KE,2011.0,1,1,0
JP,NP,2002.0,4,2,2
AT,ID,2012.0,2,1,1
GB,TT,2014.0,4,6,-2
PK,EG,2009.0,2,4,-2
CR,FR,2021.0,4,8,-4
FR,IS,2019.0,4,10,-6
US,QA,2001.0,7,3,4
CU,UY,2019.0,2,5,-3
BG,CA,2012.0,7,1,6
CD,FR,2016.0,2,6,-4
EC,IT,2008.0,2,1,1
EG,TR,2016.0,5,3,2
US,SY,2001.0,8,3,5
CH,VN,2009.0,2,2,0
CA,KE,2016.0,8,10,-2
JP,SL,2019.0,1,1,0
SE,SA,2007.0,2,2,0
KR,NZ,2015.0,6,6,0
TR,MM,2018.0,5,1,4
SG,IT,2007.0,5,2,3
US,LV,2018.0,11,6,5
CO,IT,2008.0,3,4,-1
RU,MN,2015.0,4,3,1
UZ,RU,2013.0,6,12,-6
HU,IE,2012.0,7,4,3
SK,ES,2016.0,4,3,1
RS,ES,2020.0,5,3,2
SE,IS,2004.0,10,3,7
CZ,AT,1998.0,5,7,-2
FR,GE,1999.0,2,2,0
HU,MX,2020.0,4,2,2
IT,TH,2020.0,6,2,4
MX,NI,2017.0,5,4,1
PT,GB,2023.0,11,6,5
RS,SE,2014.0,4,3,1
UY,DE,2020.0,2,7,-5
JP,NP,2005.0,4,5,-1
NL,PE,2019.0,2,4,-2
ET,AT,2020.0,2,2,0
NP,JP,2007.0,6,8,-2
ID,PL,2022.0,2,1,1
ES,IS,2012.0,6,3,3
DE,DZ,2019.0,5,3,2
IT,MD,2016.0,3,2,1
NL,LV,2017.0,1,1,0
TR,AZ,2003.0,3,1,2
MM,US,2002.0,2,2,0
VN,GR,2011.0,4,2,2
SE,IE,2004.0,10,1,9
FI,PT,2000.0,1,1,0
RO,CO,2009.0,1,1,0
PK,MY,2000.0,3,2,1
US,KH,2022.0,6,8,-2
CN,MA,2019.0,3,4,-1
CL,JP,2006.0,4,5,-1
PL,AR,2002.0,1,1,0
JP,PT,2000.0,3,2,1
RU,IT,2013.0,13,20,-7
SY,US,2008.0,4,3,1
HU,IR,2006.0,1,2,-1
JO,CH,2011.0,2,1,1
RE,CA,2012.0,2,1,1
IN,AR,2016.0,2,3,-1
SA,nan,2016.0,8,5,3
BN,GB,2019.0,4,3,1
BE,CA,2023.0,2,1,1
OM,NL,2009.0,3,1,2
AE,IN,2003.0,3,2,1
SA,IL,2021.0,3,1,2
CI,BE,2020.0,2,5,-3
AE,BD,2015.0,3,4,-1
UG,DK,2016.0,1,3,-2
CW,BE,2010.0,2,3,-1
GB,GM,2012.0,5,15,-10
PL,CL,2009.0,1,1,0
CA,BD,2006.0,4,8,-4
DE,DZ,2010.0,6,4,2
IR,HR,2021.0,1,1,0
VN,PH,2014.0,1,1,0
GT,BR,2018.0,6,3,3
PH,TW,2013.0,3,6,-3
FR,VN,2000.0,4,1,3
FR,IS,2010.0,2,2,0
VN,IE,2018.0,2,2,0
PY,IT,2015.0,1,3,-2
NO,CA,1997.0,4,4,0
IL,AT,2001.0,2,2,0
BE,CO,2015.0,7,8,-1
LV,SE,2003.0,3,5,-2
HR,AT,2012.0,6,5,1
FR,FI,2001.0,4,9,-5
CZ,ID,2011.0,1,3,-2
RU,CZ,2001.0,8,11,-3
TR,SY,2019.0,1,1,0
SE,KR,2016.0,8,15,-7
SA,NL,1997.0,1,2,-1
AU,BN,2004.0,1,1,0
VE,GB,2006.0,5,3,2
MY,PT,2005.0,2,1,1
ZM,GB,2005.0,2,2,0
IT,KE,2015.0,1,4,-3
CZ,HU,2011.0,5,4,1
FI,BY,2008.0,3,1,2
CO,BO,2009.0,8,2,6
JP,PF,2014.0,1,1,0
ES,HR,2015.0,8,4,4
GR,nan,2002.0,1,2,-1
CN,LU,2001.0,1,2,-1
KR,IE,2020.0,7,7,0
ES,SK,2006.0,1,5,-4
CZ,SE,2000.0,5,3,2
DE,SN,2015.0,2,1,1
CN,KW,2018.0,2,3,-1
AR,BE,2007.0,3,5,-2
FR,CU,2021.0,1,3,-2
CA,SI,2018.0,3,3,0
GR,ES,2005.0,3,9,-6
CL,ZA,2001.0,1,1,0
ZA,IL,2000.0,1,1,0
BE,AM,2015.0,1,2,-1
US,BO,2011.0,7,9,-2
TW,PT,2007.0,1,2,-1
SG,NZ,2001.0,1,3,-2
PH,CH,2011.0,3,2,1
SK,CN,2022.0,3,2,1
KE,BE,2022.0,3,2,1
BG,NL,2019.0,5,5,0
LY,CA,2020.0,2,3,-1
ZA,MX,2020.0,2,3,-1
US,XK,2017.0,2,1,1
EG,PL,2020.0,3,6,-3
PE,SI,2018.0,1,1,0
LB,AT,2022.0,2,1,1
EG,TW,2007.0,1,3,-2
IT,PH,2021.0,2,4,-2
CN,CM,2020.0,3,2,1
DE,LT,2006.0,6,6,0
BE,CY,2016.0,1,1,0
KE,IT,2019.0,5,4,1
NZ,ZA,2004.0,4,8,-4
TR,FR,2000.0,2,3,-1
BJ,KE,2007.0,1,1,0
FR,MT,2016.0,2,2,0
IN,GE,2014.0,3,3,0
IN,FJ,2008.0,2,1,1
HN,GB,2012.0,1,1,0
RU,IR,2012.0,6,6,0
GT,AU,2014.0,1,1,0
KR,LK,2008.0,1,1,0
BF,PK,2002.0,1,1,0
MN,CN,2008.0,2,1,1
SY,HU,2018.0,1,1,0
IL,PE,2021.0,1,1,0
TW,SE,2009.0,4,4,0
NO,NG,2022.0,2,4,-2
AU,BG,2016.0,4,1,3
US,KP,2021.0,2,1,1
SA,OM,2010.0,2,5,-3
ES,NO,2003.0,7,9,-2
IR,CZ,2010.0,3,4,-1
BH,ET,2013.0,4,7,-3
MW,GB,2000.0,5,4,1
IT,HR,2008.0,3,6,-3
BA,US,2009.0,2,9,-7
SI,CN,2021.0,2,2,0
JP,SI,2020.0,3,4,-1
ET,IL,2018.0,2,1,1
GH,BE,2021.0,2,1,1
EE,DE,2002.0,3,12,-9
ZA,AT,2020.0,9,4,5
IE,PL,2007.0,2,7,-5
CH,CR,2008.0,2,1,1
TN,LB,2013.0,1,2,-1
QA,TR,2014.0,1,5,-4
CA,UA,2010.0,3,6,-3
NG,JP,2003.0,2,4,-2
FR,SA,1997.0,2,1,1
JP,RW,2019.0,1,1,0
IN,GD,2021.0,1,1,0
TR,ET,2019.0,3,2,1
YE,MA,2019.0,1,5,-4
PY,ES,2015.0,8,16,-8
BA,NL,2017.0,2,3,-1
MY,KH,2018.0,2,1,1
CN,CY,2021.0,2,2,0
VE,ZA,2006.0,1,1,0
IE,CH,2004.0,8,5,3
CY,IE,2021.0,2,2,0
EG,ZA,2007.0,2,1,1
IT,GH,2016.0,1,3,-2
DE,LV,2003.0,3,2,1
MK,GB,2002.0,2,2,0
HK,RS,2013.0,1,1,0
NL,MY,2002.0,1,1,0
NL,MY,2005.0,2,3,-1
BO,DK,2015.0,1,1,0
NO,IR,2006.0,1,2,-1
UY,CU,2010.0,1,1,0
SI,BA,2018.0,5,5,0
CA,SN,2008.0,1,3,-2
CN,SI,2021.0,2,2,0
NL,PH,2006.0,2,2,0
LY,IR,2015.0,1,1,0
ES,SV,2019.0,2,6,-4
KE,IT,2017.0,3,4,-1
KE,TZ,2022.0,5,1,4
GH,CA,2000.0,1,1,0
EC,CH,2008.0,1,1,0
SA,LY,2020.0,2,3,-1
EC,FR,2000.0,2,3,-1
PK,TR,2004.0,1,3,-2
NO,ZW,2008.0,1,1,0
PK,FI,2012.0,1,2,-1
DE,MY,2001.0,1,5,-4
BD,PK,2003.0,3,5,-2
KH,RU,2018.0,2,1,1
TR,PS,2008.0,3,1,2
CL,CH,1999.0,1,1,0
NA,NG,2021.0,1,2,-1
GR,IE,2009.0,3,3,0
IL,PS,2015.0,1,4,-3
NP,US,1998.0,1,1,0
HU,FI,2015.0,4,5,-1
SA,YE,2014.0,3,5,-2
GH,US,1997.0,1,2,-1
KE,IN,2001.0,1,1,0
HR,CN,2016.0,4,5,-1
JP,SY,2006.0,1,1,0
TN,IN,2013.0,1,6,-5
TW,SA,2013.0,3,3,0
SD,GR,2010.0,1,1,0
JM,TT,2002.0,5,4,1
BD,GR,2014.0,4,2,2
MT,IE,2020.0,1,1,0
nan,BG,1999.0,2,2,0
YE,MY,2023.0,1,2,-1
ZA,NO,2006.0,3,1,2
AF,BR,2013.0,1,1,0
CN,UG,2021.0,2,2,0
TH,MY,2022.0,1,8,-7
nan,BD,2014.0,4,3,1
SY,IQ,2015.0,1,1,0
BD,CA,2002.0,1,2,-1
BG,CN,2019.0,3,6,-3
GA,DE,2016.0,5,5,0
AT,UA,2004.0,4,4,0
BO,MX,2006.0,5,2,3
NL,MD,1997.0,1,1,0
JP,AF,2019.0,7,1,6
MD,CH,2019.0,1,5,-4
nan,TW,1999.0,3,2,1
GB,ZW,2004.0,3,2,1
GD,CA,2015.0,1,3,-2
GR,CA,2001.0,4,13,-9
DE,UG,2008.0,3,2,1
CZ,PH,2011.0,1,2,-1
HR,CH,2002.0,3,2,1
KE,AU,2012.0,5,7,-2
JP,PE,2011.0,1,1,0
SK,NZ,1998.0,1,1,0
DK,RS,2015.0,1,4,-3
IT,BG,2003.0,3,5,-2
LK,CH,2009.0,1,1,0
ML,US,2009.0,1,1,0
GR,KR,2018.0,3,1,2
LU,PL,2022.0,2,2,0
BI,CH,2015.0,1,1,0
SE,BO,2013.0,3,3,0
FR,BO,2018.0,1,3,-2
ES,NZ,2004.0,1,1,0
DE,AZ,2021.0,2,2,0
LT,ID,2019.0,1,1,0
AT,TR,2020.0,5,12,-7
VN,NZ,2013.0,1,1,0
BO,SE,2011.0,2,1,1
JO,BR,2009.0,1,1,0
GR,CO,2014.0,1,1,0
CL,IT,1998.0,3,3,0
OM,AT,2016.0,1,1,0
LB,ID,2021.0,3,5,-2
FR,IS,2017.0,3,1,2
PA,CU,2020.0,2,2,0
CA,ET,2022.0,4,2,2
BG,NL,2010.0,3,1,2
MC,IT,2010.0,1,2,-1
TR,KR,2002.0,3,1,2
DK,PE,2020.0,2,2,0
BG,CN,2017.0,7,6,1
BG,NL,2017.0,2,5,-3
IR,DE,1998.0,1,2,-1
IE,PT,2002.0,2,2,0
MD,DE,2004.0,2,2,0
PK,EE,2022.0,1,1,0
CA,SD,2021.0,2,3,-1
MD,CH,2010.0,1,3,-2
ZA,NA,2005.0,1,1,0
PA,GB,1997.0,1,2,-1
GM,TZ,2020.0,2,1,1
BR,SA,2013.0,1,3,-2
RS,BE,2014.0,3,6,-3
BR,LB,2013.0,2,2,0
AR,NL,2002.0,3,3,0
DK,AR,2001.0,1,2,-1
SI,MX,2013.0,2,5,-3
AR,NL,2005.0,3,2,1
LY,DE,2018.0,1,3,-2
PT,FI,2007.0,2,1,1
ET,IR,2019.0,1,3,-2
PL,AR,2005.0,1,1,0
LT,SE,2008.0,3,3,0
GP,MQ,2013.0,2,2,0
MK,BG,2020.0,4,3,1
EG,ES,2001.0,3,1,2
CZ,BG,2002.0,1,2,-1
PT,CL,2003.0,2,3,-1
LB,LY,2013.0,1,1,0
NG,KW,2016.0,1,2,-1
SK,BR,2021.0,1,3,-2
US,AZ,2001.0,1,1,0
DE,BJ,2009.0,1,3,-2
LT,FI,2008.0,1,2,-1
MA,BR,2009.0,1,1,0
IT,BO,2010.0,1,1,0
VN,CA,2008.0,1,5,-4
BG,IL,2001.0,1,2,-1
BG,GR,1999.0,1,4,-3
IQ,MA,2019.0,3,3,0
US,MZ,2021.0,1,2,-1
DK,SG,1998.0,3,1,2
US,JP,2005.0,1833,1958,-125
JP,IN,2017.0,146,148,-2
US,CR,2013.0,39,24,15
IN,MY,2020.0,130,150,-20
CL,GB,2008.0,33,16,17
SG,IE,2012.0,7,7,0
GB,FR,2009.0,499,534,-35
IL,nan,2019.0,22,30,-8
ES,DE,2014.0,301,202,99
IT,AR,2011.0,86,86,0
LK,AU,2019.0,70,47,23
NL,HU,2006.0,9,16,-7
CO,BE,2020.0,15,8,7
UA,RU,2001.0,58,117,-59
AR,FI,2001.0,1,3,-2
GR,GB,2005.0,106,138,-32
CN,IE,2006.0,17,22,-5
CN,nan,2011.0,214,236,-22
ZA,BW,2018.0,23,8,15
BG,RU,2008.0,6,24,-18
AT,HU,2014.0,29,43,-14
AT,CZ,2022.0,28,30,-2
TR,GB,2018.0,157,136,21
RU,DE,2006.0,159,136,23
GR,RU,2021.0,2,5,-3
NG,CA,2018.0,19,17,2
TR,DE,2022.0,65,65,0
IR,SG,2012.0,31,24,7
BE,GB,2007.0,87,81,6
IN,CH,2009.0,36,18,18
FR,RO,2006.0,30,27,3
CA,TN,2015.0,11,14,-3
MA,FR,2002.0,132,99,33
IT,IN,2009.0,47,60,-13
RW,CA,2020.0,3,1,2
ID,TR,2018.0,13,27,-14
PL,BR,2022.0,19,20,-1
HU,SE,2002.0,9,9,0
CL,ID,2021.0,22,4,18
PK,AE,2020.0,29,32,-3
GB,TH,2011.0,74,18,56
IL,US,2010.0,487,399,88
TR,BE,2022.0,13,10,3
MX,GB,2015.0,74,69,5
MX,RS,2011.0,91,4,87
HT,US,2011.0,1,1,0
DE,UA,2012.0,28,37,-9
US,IT,2023.0,38,56,-18
IT,IL,2016.0,18,6,12
IN,ZA,2010.0,59,28,31
SI,CH,2015.0,9,2,7
LU,DE,2001.0,3,10,-7
DK,BE,2015.0,55,70,-15
IL,nan,2010.0,20,26,-6
BG,CN,2010.0,10,11,-1
IR,SE,2009.0,17,21,-4
VN,NL,2004.0,3,2,1
CU,UY,2010.0,1,1,0
IL,nan,2017.0,28,27,1
ID,SG,2013.0,4,9,-5
MM,GB,2018.0,3,1,2
TG,ML,2021.0,3,1,2
LB,BE,2022.0,6,2,4
DE,PS,2011.0,7,5,2
RO,NL,2008.0,15,8,7
AU,LK,2014.0,19,26,-7
DE,EE,2000.0,4,6,-2
AU,PT,2015.0,14,16,-2
VG,US,2019.0,10,9,1
BR,IN,2003.0,9,15,-6
FI,IT,2007.0,16,9,7
MX,CL,2006.0,76,53,23
JP,IT,1999.0,37,32,5
QA,CA,2019.0,12,23,-11
IN,OM,2012.0,13,12,1
UA,SE,1998.0,8,1,7
AE,PK,2022.0,14,28,-14
IL,RS,2009.0,11,1,10
IN,FI,2009.0,7,5,2
CA,ES,2000.0,23,27,-4
MY,IT,2022.0,9,35,-26
SA,LB,2014.0,6,10,-4
BR,BE,2004.0,33,24,9
nan,VN,2014.0,2,2,0
LV,RU,2006.0,12,3,9
PK,AU,2012.0,22,14,8
BE,EE,2018.0,4,3,1
CZ,AU,2000.0,3,2,1
CN,RO,2008.0,4,1,3
IT,DZ,2005.0,8,4,4
HR,CA,2021.0,3,4,-1
BE,KE,2021.0,6,4,2
ES,MY,2011.0,2,3,-1
HU,SE,2005.0,6,5,1
BD,SE,2007.0,2,2,0
MY,GH,2022.0,3,2,1
EG,DK,2020.0,3,3,0
CL,IN,2014.0,3,6,-3
RU,HU,2015.0,7,11,-4
JP,FJ,2018.0,1,1,0
PY,CU,2014.0,4,2,2
UY,CA,2005.0,1,1,0
LU,TR,2020.0,1,1,0
HR,JP,2016.0,2,2,0
ES,RU,2013.0,24,11,13
MX,CU,2000.0,10,15,-5
IT,JO,2016.0,4,4,0
PK,VN,2007.0,1,1,0
US,XK,2019.0,4,5,-1
US,SI,2000.0,9,5,4
MX,RU,2011.0,5,8,-3
CO,DE,2002.0,10,5,5
IN,RU,2001.0,11,1,10
IL,CZ,2009.0,4,7,-3
SE,ET,2012.0,5,6,-1
DK,CZ,1997.0,2,1,1
GR,SE,2009.0,9,4,5
CA,CG,2016.0,1,1,0
FR,CI,2021.0,17,15,2
IN,PT,2009.0,10,9,1
GB,SA,1999.0,10,10,0
DE,CO,2013.0,27,37,-10
CY,MY,2014.0,1,2,-1
IN,LV,2020.0,3,3,0
NO,FR,2023.0,1,2,-1
CZ,BG,2005.0,3,3,0
NO,CA,1998.0,6,5,1
BE,IE,2022.0,4,7,-3
ES,SA,2022.0,3,4,-1
SA,SY,2018.0,4,6,-2
PK,IT,1999.0,2,1,1
BE,QA,2020.0,2,1,1
ES,PH,2007.0,7,4,3
GH,US,1998.0,3,7,-4
FR,NE,2005.0,3,3,0
GB,BH,2006.0,3,1,2
MA,GB,2011.0,3,5,-2
JO,CA,2004.0,5,6,-1
IS,GB,2014.0,5,13,-8
LU,CH,1998.0,1,1,0
GW,DK,2008.0,3,1,2
ZA,AE,2020.0,6,4,2
JP,DK,1997.0,6,9,-3
EE,CH,2002.0,2,2,0
NI,ID,2019.0,2,1,1
TR,IT,2001.0,12,7,5
IN,IQ,2013.0,4,4,0
ES,HU,2006.0,3,6,-3
CL,PA,2007.0,2,1,1
IR,JO,2020.0,1,1,0
CN,GE,1999.0,1,1,0
LA,SE,2011.0,3,1,2
EE,FR,2011.0,3,10,-7
UA,CA,2003.0,1,2,-1
HR,BA,2006.0,7,4,3
MA,ES,2012.0,4,8,-4
JO,NL,2006.0,1,3,-2
US,SV,2013.0,1,2,-1
MK,CA,2009.0,2,1,1
ID,VN,2021.0,1,3,-2
FI,CL,2015.0,3,6,-3
RO,AE,2016.0,1,1,0
JO,CY,2014.0,1,2,-1
GB,JO,1997.0,2,2,0
ET,SG,2019.0,1,1,0
CA,IR,2014.0,139,283,-144
DE,RU,2020.0,203,187,16
CN,BG,2014.0,20,14,6
CL,ES,2004.0,121,115,6
IL,BR,2014.0,9,7,2
AT,AU,2014.0,31,26,5
CO,AU,2016.0,19,10,9
GB,SI,2006.0,7,4,3
GB,RS,2011.0,22,9,13
PL,CH,2021.0,25,22,3
AR,DE,2020.0,53,40,13
NP,AU,2012.0,5,5,0
LY,SA,2020.0,3,2,1
ZA,PL,2006.0,3,2,1
AU,RU,2023.0,3,1,2
CN,CL,2018.0,3,8,-5
BD,NO,2016.0,1,6,-5
US,,2025.0,36391,0,36391
,JP,2006.0,15025,0,15025
IN,,2022.0,37117,0,37117
VE,,2020.0,404,0,404
,GB,2013.0,17637,0,17637
CN,,2004.0,2255,0,2255
,ZA,2004.0,1525,0,1525
IT,,1999.0,1905,0,1905
,AU,2003.0,5565,0,5565
NZ,,2011.0,489,0,489
,VN,2012.0,472,0,472
,HU,2006.0,1205,0,1205
,MY,2018.0,2660,0,2660
,CO,1997.0,564,0,564
,ZA,1996.0,1410,0,1410
,TR,2014.0,7329,0,7329
JO,,2014.0,122,0,122
,SA,1999.0,379,0,379
,CZ,2001.0,1361,0,1361
,NO,2001.0,1215,0,1215
CR,,2018.0,324,0,324
,RS,2012.0,1067,0,1067
,OM,2010.0,156,0,156
KE,,2022.0,1220,0,1220
,AE,2015.0,502,0,502
,PK,2000.0,401,0,401
,CO,1998.0,726,0,726
BD,,2023.0,3572,0,3572
AT,,2015.0,1473,0,1473
,NG,2005.0,1009,0,1009
,GR,2009.0,2857,0,2857
ES,,1999.0,971,0,971
DE,MM,2019.0,1,0,1
IL,,2003.0,712,0,712
SE,,2015.0,2160,0,2160
,CI,1994.0,35,0,35
ZA,,2011.0,662,0,662
CH,,2001.0,1035,0,1035
,NG,2002.0,1304,0,1304
AR,,2012.0,859,0,859
,NP,2012.0,416,0,416
nan,,2015.0,681,0,681
,CH,2015.0,4134,0,4134
,CU,2001.0,365,0,365
UG,,2016.0,119,0,119
,SI,1999.0,466,0,466
SN,CG,2022.0,4,0,4
,BG,2007.0,485,0,485
,AM,2009.0,127,0,127
BR,CD,2019.0,1,0,1
TG,NE,2020.0,1,0,1
,SD,2005.0,82,0,82
,ME,2011.0,41,0,41
,KE,2014.0,699,0,699
BA,,2022.0,548,0,548
CU,,2006.0,65,0,65
,MC,1999.0,6,0,6
BF,,2023.0,455,0,455
,QA,2013.0,333,0,333
BT,,2021.0,11,0,11
,SN,2013.0,151,0,151
,EE,1999.0,196,0,196
LV,,2006.0,39,0,39
,IQ,1995.0,41,0,41
BN,,2016.0,22,0,22
UA,,2001.0,236,0,236
RS,,2001.0,47,0,47
BB,,2016.0,8,0,8
,MK,1996.0,24,0,24
,ML,2004.0,36,0,36
,IS,2006.0,119,0,119
,MN,2001.0,16,0,16
,LY,2008.0,67,0,67
TN,,2002.0,27,0,27
LU,,2020.0,172,0,172
,AO,2011.0,25,0,25
LS,PL,2002.0,1,0,1
XK,,2022.0,189,0,189
BH,,2019.0,50,0,50
,BA,2011.0,324,0,324
,CF,2015.0,4,0,4
TN,,2005.0,50,0,50
BF,IT,2018.0,3,0,3
SG,,2004.0,237,0,237
CY,JP,2011.0,2,0,2
,MW,1995.0,31,0,31
,BF,2003.0,50,0,50
SY,,2002.0,7,0,7
UZ,,2008.0,50,0,50
CY,GH,2020.0,2,0,2
AL,,2017.0,95,0,95
,BW,1995.0,35,0,35
AL,,2019.0,93,0,93
IQ,,2013.0,30,0,30
,GA,2009.0,17,0,17
AE,,2014.0,118,0,118
CM,PT,2019.0,1,0,1
MD,,2014.0,36,0,36
SK,IR,2017.0,3,0,3
ST,CH,2007.0,3,0,3
,OM,2017.0,144,0,144
,MM,2013.0,46,0,46
BH,,2017.0,32,0,32
,CD,2016.0,188,0,188
MD,ES,2014.0,1,0,1
KW,CN,2004.0,1,0,1
BW,CZ,2020.0,1,0,1
IR,PH,2021.0,2,0,2
KR,,2000.0,275,0,275
,UZ,2006.0,113,0,113
BG,,2025.0,208,0,208
CI,,2013.0,38,0,38
,MK,2004.0,89,0,89
FR,YE,2011.0,1,0,1
PG,GB,2011.0,1,0,1
BR,TH,2014.0,3,0,3
SI,ME,2022.0,2,0,2
UY,EC,2016.0,5,0,5
AO,CO,2015.0,2,0,2
RU,AR,2002.0,2,0,2
LB,QA,2010.0,3,0,3
CA,HR,2008.0,6,0,6
IL,UY,2020.0,2,0,2
IT,CY,2015.0,4,0,4
BZ,ES,2012.0,1,0,1
,KG,2004.0,20,0,20
MT,,2012.0,17,0,17
TZ,,2008.0,43,0,43
SY,,2005.0,15,0,15
nan,GE,2012.0,5,0,5
CZ,MW,2007.0,1,0,1
,SD,2002.0,52,0,52
BO,TW,2010.0,1,0,1
FJ,,2021.0,27,0,27
BI,IL,2018.0,1,0,1
,CW,2014.0,13,0,13
UZ,CL,2021.0,1,0,1
,GN,2003.0,6,0,6
MY,RS,2019.0,2,0,2
CN,KE,2010.0,6,0,6
,OM,2019.0,123,0,123
,PG,1994.0,60,0,60
,VG,2009.0,20,0,20
,MU,1994.0,11,0,11
RW,RS,2010.0,1,0,1
KE,AT,2015.0,1,0,1
LB,DK,2013.0,1,0,1
ID,VE,2004.0,1,0,1
,PS,2001.0,35,0,35
DO,,2015.0,10,0,10
UA,SE,1997.0,3,0,3
GP,AR,2014.0,1,0,1
GB,GI,2014.0,1,0,1
KZ,,2006.0,28,0,28
IT,LU,2009.0,7,0,7
LT,AU,2004.0,1,0,1
,BH,2009.0,48,0,48
KW,BH,2001.0,2,0,2
MX,AO,2013.0,3,0,3
JE,,2010.0,1,0,1
DE,MM,2010.0,1,0,1
IL,IQ,2021.0,1,0,1
AT,EG,2006.0,6,0,6
UY,AT,2015.0,2,0,2
PH,BE,2008.0,1,0,1
ST,nan,2013.0,2,0,2
KE,PK,2007.0,14,0,14
SL,,2014.0,1,0,1
CA,GL,2022.0,1,0,1
BN,IN,1999.0,1,0,1
CO,BZ,2019.0,1,0,1
NC,EG,2015.0,1,0,1
LK,IE,2009.0,1,0,1
US,GW,2003.0,1,0,1
NE,BE,2003.0,1,0,1
BH,,2010.0,17,0,17
MX,MY,2003.0,1,0,1
MA,,2000.0,34,0,34
PL,CO,1998.0,1,0,1
LV,IN,2016.0,2,0,2
CA,CI,2015.0,5,0,5
BI,,2016.0,10,0,10
BR,NC,2020.0,1,0,1
CH,GF,2019.0,1,0,1
NZ,MX,2005.0,3,0,3
VG,,2011.0,11,0,11
AU,VG,2003.0,1,0,1
CA,KZ,2015.0,4,0,4
nan,JO,2012.0,4,0,4
BH,BR,2022.0,1,0,1
BF,DJ,2017.0,1,0,1
IR,NZ,2023.0,1,0,1
LB,RO,2011.0,1,0,1
JP,MW,2008.0,1,0,1
RS,XK,2004.0,1,0,1
UA,OM,2007.0,3,0,3
BN,KR,2019.0,1,0,1
CO,PL,2013.0,1,0,1
,VA,2018.0,1,0,1
CM,HU,2011.0,1,0,1
CR,DE,2005.0,1,0,1
,ML,1996.0,15,0,15
IL,ZA,2003.0,3,0,3
ES,KZ,2015.0,2,0,2
FR,BY,2003.0,2,0,2
PR,,2003.0,1,0,1
BE,PK,1998.0,1,0,1
UA,SG,2009.0,2,0,2
CI,UG,2015.0,1,0,1
CO,CF,2009.0,1,0,1
HN,FR,2011.0,1,0,1
EC,IN,2022.0,1,0,1
GH,TZ,2014.0,1,0,1
PA,AU,2012.0,4,0,4
DK,SJ,2007.0,2,0,2
SA,NL,1998.0,1,0,1
MW,IN,2006.0,3,0,3
BZ,BR,2002.0,1,0,1
KE,NZ,2004.0,1,0,1
LY,KR,2009.0,1,0,1
RE,ZA,2018.0,1,0,1
DK,EE,2000.0,1,0,1
JO,NG,2016.0,2,0,2
UA,DK,2002.0,1,0,1
IL,NP,2021.0,1,0,1
CU,AT,1997.0,2,0,2
,BZ,2003.0,2,0,2
HT,PE,2020.0,1,0,1
JE,,2017.0,5,0,5
AE,AM,2015.0,1,0,1
HR,ES,2004.0,1,0,1
VG,CA,2021.0,2,0,2
,AG,2015.0,21,0,21
DE,MM,2017.0,4,0,4
NO,PR,1999.0,1,0,1
ES,HK,2008.0,1,0,1
CN,AF,2022.0,2,0,2
OM,,2003.0,17,0,17
TT,BE,2016.0,1,0,1
ID,BR,2009.0,2,0,2
AF,TR,2013.0,1,0,1
CA,TT,2018.0,4,0,4
IE,PA,2012.0,1,0,1
CN,AL,2011.0,5,0,5
MS,GB,2016.0,1,0,1
RS,KR,2001.0,1,0,1
CZ,TW,2011.0,6,0,6
ZA,KR,1998.0,1,0,1
NL,CM,2007.0,1,0,1
HN,SE,2014.0,2,0,2
BR,PH,2004.0,1,0,1
AZ,PT,2017.0,1,0,1
SE,SI,1997.0,2,0,2
BE,TZ,2003.0,1,0,1
BY,IT,2000.0,1,0,1
VE,RO,2013.0,1,0,1
BY,LT,2021.0,4,0,4
OM,SG,2004.0,2,0,2
IN,NA,2014.0,2,0,2
PA,AT,2021.0,1,0,1
MA,TH,2021.0,1,0,1
PA,ID,2018.0,2,0,2
SA,DK,1997.0,1,0,1
UZ,KR,2011.0,3,0,3
ES,ST,2006.0,1,0,1
VE,nan,2014.0,4,0,4
BY,MZ,2022.0,2,0,2
BD,AT,2010.0,2,0,2
nan,BI,2021.0,1,0,1
IN,QA,2009.0,2,0,2
GR,UA,2014.0,2,0,2
GB,JE,2009.0,3,0,3
CO,BZ,2010.0,1,0,1
VE,AU,2012.0,2,0,2
BF,IN,2017.0,1,0,1
NP,,2001.0,4,0,4
HR,XK,2010.0,1,0,1
IT,EE,2013.0,5,0,5
LV,RO,2023.0,1,0,1
CZ,LK,2016.0,3,0,3
RE,,2003.0,4,0,4
EG,PS,2001.0,1,0,1
LV,SA,2014.0,1,0,1
CM,CH,2003.0,2,0,2
RO,GE,2021.0,1,0,1
BO,IL,2020.0,1,0,1
GB,LT,2008.0,6,0,6
SK,CL,2018.0,1,0,1
ID,TZ,2021.0,5,0,5
MZ,ID,2020.0,1,0,1
NL,EC,2013.0,2,0,2
BY,PK,2008.0,1,0,1
HU,PT,2009.0,2,0,2
AE,HU,2010.0,1,0,1
SG,SI,2020.0,1,0,1
JM,,2006.0,11,0,11
,BB,2003.0,8,0,8
MY,PL,2022.0,1,0,1
GB,JO,1998.0,6,0,6
BD,NE,2022.0,1,0,1
AU,LU,2014.0,1,0,1
NL,KW,2002.0,1,0,1
MK,DE,1998.0,1,0,1
GP,,2002.0,6,0,6
TH,,2026.0,10,0,10
LT,GB,2003.0,1,0,1
,BS,1997.0,1,0,1
PL,EE,2022.0,1,0,1
SE,BT,2019.0,1,0,1
GR,AL,2005.0,1,0,1
NO,TR,1997.0,1,0,1
IE,LT,2007.0,1,0,1
,KG,1996.0,6,0,6
,KY,2006.0,3,0,3
NP,FR,2017.0,1,0,1
ML,BF,2006.0,1,0,1
NG,ZA,1999.0,1,0,1
TH,OM,2012.0,1,0,1
PE,SV,2009.0,1,0,1
HU,EG,2013.0,2,0,2
JP,JO,2003.0,2,0,2
CU,NZ,2005.0,1,0,1
ID,TH,2007.0,1,0,1
IT,ST,2018.0,1,0,1
VU,NC,2013.0,1,0,1
GH,,1998.0,7,0,7
BN,SA,2013.0,1,0,1
DE,QA,2009.0,3,0,3
RS,CN,1999.0,3,0,3
HR,nan,2006.0,3,0,3
KE,TH,2018.0,4,0,4
FI,IN,1997.0,2,0,2
GH,IT,1997.0,1,0,1
CM,AU,2022.0,2,0,2
ZA,GM,2022.0,2,0,2
ZA,KR,1997.0,1,0,1
NG,PA,2019.0,1,0,1
DK,SD,2016.0,1,0,1
DE,MK,2009.0,1,0,1
PF,,2015.0,6,0,6
BH,ID,2012.0,1,0,1
FI,UG,2018.0,3,0,3
BR,SR,2002.0,2,0,2
GR,PK,2006.0,1,0,1
MD,EG,2016.0,1,0,1
IQ,PK,2005.0,1,0,1
SA,AF,2019.0,2,0,2
PY,GB,2001.0,1,0,1
MR,US,2013.0,1,0,1
RS,FI,2006.0,1,0,1
JP,NA,2019.0,1,0,1
CL,RS,2022.0,1,0,1
SD,DZ,2017.0,1,0,1
,GW,2008.0,2,0,2
DK,PH,2001.0,2,0,2
UA,PK,2004.0,1,0,1
UA,HU,2007.0,1,0,1
JM,NG,2016.0,1,0,1
OM,SD,2014.0,1,0,1
SK,FI,2023.0,1,0,1
,FM,2013.0,2,0,2
SD,KE,2020.0,1,0,1
ID,NO,2022.0,5,0,5
JP,LY,2016.0,1,0,1
CM,BI,2022.0,1,0,1
,TD,1998.0,3,0,3
VE,CH,2012.0,1,0,1
SK,TH,2016.0,1,0,1
ET,PL,2022.0,4,0,4
JP,NA,2017.0,1,0,1
UA,ZW,2022.0,1,0,1
BR,HT,2014.0,1,0,1
LY,CY,2019.0,1,0,1
UZ,KZ,2003.0,1,0,1
RS,UA,2014.0,1,0,1
EE,AU,2009.0,1,0,1
CH,IE,1998.0,4,0,4
CV,UY,2017.0,1,0,1
BB,TT,2018.0,1,0,1
AT,CO,2010.0,1,0,1
EC,CO,2005.0,1,0,1
DE,MW,2007.0,2,0,2
PE,NL,2022.0,2,0,2
JE,EC,2013.0,1,0,1
IR,NG,2009.0,6,0,6
AU,GT,2013.0,1,0,1
SI,CL,2011.0,1,0,1
BF,GN,2012.0,2,0,2
MA,JP,2007.0,1,0,1
DK,FJ,2002.0,1,0,1
,FO,1997.0,3,0,3
US,GP,2020.0,2,0,2
YE,BH,2015.0,1,0,1
JM,BE,2009.0,1,0,1
KZ,MD,2008.0,1,0,1
SD,BR,1999.0,5,0,5
IT,BO,2017.0,1,0,1
JE,,2019.0,1,0,1
CU,SE,2019.0,2,0,2
PA,CN,2015.0,1,0,1
MM,DE,1998.0,1,0,1
MM,LA,2022.0,2,0,2
KR,FI,1999.0,2,0,2
ET,KE,2009.0,1,0,1
,FO,1998.0,2,0,2
IN,LS,2008.0,1,0,1
IN,BF,2007.0,1,0,1
NL,TZ,2006.0,5,0,5
ZA,ZM,2012.0,4,0,4
FM,,2022.0,3,0,3
BD,CO,2015.0,1,0,1
KE,TN,2017.0,2,0,2
CA,ER,2003.0,1,0,1
CO,DK,2005.0,1,0,1
CN,ML,2022.0,1,0,1
GE,IT,2019.0,3,0,3
CZ,DZ,2018.0,1,0,1
SN,GN,1998.0,1,0,1
,DO,2003.0,8,0,8
SV,BR,2012.0,2,0,2
SC,US,2006.0,2,0,2
PT,GH,2014.0,1,0,1
AT,PS,2016.0,1,0,1
AD,ES,2018.0,2,0,2
BI,NL,1999.0,1,0,1
OM,IS,2013.0,1,0,1
GR,RO,2020.0,3,0,3
NP,QA,2016.0,1,0,1
MK,IE,2020.0,1,0,1
VN,LA,2018.0,1,0,1
KH,LT,2016.0,1,0,1
BD,VN,2019.0,2,0,2
TG,BR,2013.0,1,0,1
ZA,GE,2019.0,2,0,2
EE,VN,2018.0,2,0,2
AT,IE,2023.0,2,0,2
EG,UG,2013.0,1,0,1
TW,LK,1998.0,1,0,1
TZ,DK,2022.0,1,0,1
IN,CU,1998.0,1,0,1
AD,,2018.0,3,0,3
AM,nan,2003.0,1,0,1
IT,LB,2003.0,2,0,2
MU,FR,2000.0,1,0,1
IT,KR,2023.0,2,0,2
ML,DE,2007.0,1,0,1
XK,CA,2020.0,2,0,2
LI,AU,2015.0,1,0,1
JP,RW,2017.0,1,0,1
NP,FR,2010.0,2,0,2
GL,SE,2009.0,1,0,1
FR,ET,1997.0,1,0,1
PA,HU,2018.0,1,0,1
NP,ES,2017.0,1,0,1
AR,KZ,2021.0,1,0,1
BO,GB,2013.0,2,0,2
nan,HT,2003.0,1,0,1
PF,BF,2011.0,1,0,1
HN,nan,2012.0,1,0,1
AM,PK,2012.0,1,0,1
AR,GE,2001.0,1,0,1
YE,,2009.0,3,0,3
GR,IQ,2013.0,1,0,1
XK,NG,2010.0,1,0,1
AE,FI,2014.0,1,0,1
IN,BN,2006.0,1,0,1
SJ,,2013.0,3,0,3
ML,ET,2016.0,1,0,1
AL,,2010.0,6,0,6
BG,AZ,2019.0,1,0,1
RO,AL,2016.0,1,0,1
nan,TZ,2021.0,1,0,1
BJ,,2003.0,4,0,4
TN,IE,2018.0,1,0,1
MX,SG,2000.0,3,0,3
BR,ZW,2002.0,1,0,1
TN,DZ,1998.0,1,0,1
FR,LV,1998.0,2,0,2
ER,US,2004.0,1,0,1
OM,CH,2000.0,1,0,1
PK,ZW,2023.0,2,0,2
nan,GT,2015.0,1,0,1
AR,CZ,2009.0,2,0,2
DK,LV,2013.0,2,0,2
RU,KG,2000.0,1,0,1
KE,IE,1999.0,1,0,1
CF,IN,2005.0,1,0,1
US,XK,2010.0,2,0,2
MY,ET,2022.0,2,0,2
HR,NP,2006.0,1,0,1
CN,MK,1997.0,2,0,2
AL,MY,2018.0,1,0,1
BY,CH,2003.0,2,0,2
MT,AR,2019.0,2,0,2
PT,EC,2011.0,1,0,1
CA,VG,2004.0,1,0,1
SE,DZ,2023.0,1,0,1
US,SX,2014.0,1,0,1
CU,UY,2017.0,6,0,6
VE,PH,1997.0,1,0,1
UG,RW,2014.0,1,0,1
CI,DZ,2007.0,1,0,1
TT,GD,2020.0,1,0,1
PT,NZ,2013.0,1,0,1
ZA,GH,2001.0,1,0,1
JP,MK,2002.0,1,0,1
KN,ZA,2012.0,2,0,2
IQ,IN,2000.0,1,0,1
SA,CM,2014.0,1,0,1
AU,ZM,2022.0,1,0,1
BJ,NL,2003.0,1,0,1
OM,BJ,2014.0,1,0,1
SD,IT,1999.0,1,0,1
GB,BW,2000.0,2,0,2
,FK,2001.0,1,0,1
VE,HN,2014.0,2,0,2
BE,GP,2012.0,1,0,1
PT,ZA,2002.0,1,0,1
SG,BN,1999.0,1,0,1
ES,BA,2019.0,1,0,1
NE,GB,2015.0,1,0,1
NP,SE,2004.0,1,0,1
HU,NO,2007.0,1,0,1
IR,RS,2017.0,1,0,1
,BS,1998.0,1,0,1
CG,AU,2020.0,2,0,2
KE,GM,2008.0,1,0,1
CR,PH,2007.0,1,0,1
BS,,2005.0,1,0,1
GW,,2015.0,2,0,2
MX,NP,2016.0,1,0,1
NZ,MX,2002.0,1,0,1
UA,HK,2005.0,1,0,1
IT,SG,2004.0,2,0,2
VE,CR,2003.0,1,0,1
ML,WS,2014.0,1,0,1
BF,DK,2013.0,1,0,1
DK,BA,2017.0,1,0,1
FR,NP,2006.0,1,0,1
BD,GD,2017.0,1,0,1
ZA,HR,2008.0,1,0,1
CI,ID,2015.0,1,0,1
MM,PK,2013.0,1,0,1
EE,NO,2001.0,1,0,1
BH,LV,2021.0,1,0,1
LY,IN,2020.0,2,0,2
DE,CY,2003.0,1,0,1
NG,BN,2016.0,2,0,2
TG,FR,2005.0,3,0,3
HK,BE,2008.0,2,0,2
BA,XK,2017.0,2,0,2
NP,CM,2021.0,1,0,1
NO,MN,2021.0,1,0,1
MX,PS,2021.0,1,0,1
GL,NO,2012.0,1,0,1
KH,NL,2019.0,1,0,1
MK,IR,2010.0,1,0,1
NG,SZ,2012.0,1,0,1
MX,SK,2003.0,1,0,1
AM,KZ,1998.0,1,0,1
EG,CM,2013.0,2,0,2
UA,JO,2012.0,1,0,1
SA,NE,2014.0,1,0,1
CZ,EE,1999.0,2,0,2
CU,JP,2011.0,1,0,1
FR,BN,2020.0,1,0,1
GE,TR,2008.0,1,0,1
UA,KR,2023.0,1,0,1
BN,MY,2001.0,2,0,2
SD,DZ,2019.0,2,0,2
EE,LT,2018.0,2,0,2
AM,GB,2009.0,1,0,1
HU,RE,2007.0,1,0,1
CH,BA,2014.0,1,0,1
VE,TR,2019.0,1,0,1
JP,SL,2017.0,1,0,1
JM,IE,2021.0,1,0,1
EG,CY,2020.0,1,0,1
LT,UA,2016.0,1,0,1
KH,DK,2004.0,1,0,1
KZ,FI,2010.0,1,0,1
EC,QA,2022.0,1,0,1
BS,DK,2009.0,1,0,1
BY,BR,1999.0,2,0,2
ML,SN,2013.0,6,0,6
LB,AE,2008.0,1,0,1
RW,AT,2019.0,1,0,1
BD,VN,2010.0,1,0,1
AL,AR,2020.0,1,0,1
DK,MT,2013.0,1,0,1
PW,US,2011.0,2,0,2
BE,PT,2000.0,2,2,0
NL,LT,2006.0,2,2,0
SE,HR,2013.0,2,3,-1
TN,CN,2021.0,2,4,-2
SL,US,2013.0,1,2,-1
ET,IR,2017.0,2,1,1
IQ,MA,2017.0,2,3,-1
CU,SE,2017.0,2,3,-1
NA,ZA,1999.0,1,2,-1
ZA,NA,2002.0,1,1,0
AE,HU,2019.0,1,3,-2
RO,GR,2001.0,3,1,2
DE,CU,2022.0,1,1,0
TW,NZ,2016.0,6,8,-2
VI,PL,2008.0,1,1,0
LT,HU,2000.0,1,1,0
JP,AF,2017.0,2,1,1
CZ,AT,1997.0,2,4,-2
PE,BR,2003.0,1,7,-6
MY,FI,2013.0,1,3,-2
TR,PH,2014.0,1,1,0
TH,PH,2003.0,1,1,0
IE,MT,2015.0,1,1,0
UG,ES,2016.0,1,1,0
OM,IN,2000.0,1,6,-5
GB,BN,2012.0,4,3,1
BG,AU,2002.0,1,1,0
AU,HK,2022.0,4,3,1
SK,SI,2015.0,2,4,-2
KR,IT,2017.0,2,14,-12
NO,PT,2005.0,1,4,-3
SE,MA,2014.0,1,2,-1
LU,GB,2001.0,1,2,-1
NO,PT,2002.0,2,1,1
CA,KG,2020.0,1,1,0
NP,DK,2020.0,3,1,2
RU,PH,2011.0,2,1,1
LK,NL,2009.0,1,1,0
NO,TR,1998.0,2,1,1
ZA,IE,1997.0,1,1,0
ET,ZW,2018.0,1,2,-1
BD,PT,2022.0,1,1,0
SK,GR,2016.0,1,1,0
NG,GM,2016.0,1,1,0
OM,NO,2014.0,1,3,-2
KW,IR,2018.0,1,7,-6
BJ,ID,2019.0,2,1,1
RO,VN,2007.0,1,2,-1
PT,ZA,2005.0,1,1,0
EC,CO,2002.0,1,2,-1
NC,CG,2009.0,1,1,0
IR,KW,2011.0,1,3,-2
SY,IN,2012.0,1,1,0
MC,IT,2017.0,1,2,-1
AE,KW,2006.0,2,1,1
ZM,GH,2007.0,2,4,-2
PA,PT,2012.0,1,1,0
CA,KR,2023.0,2,6,-4
NL,UG,2011.0,1,3,-2
VN,nan,2001.0,1,1,0
IN,SY,1999.0,1,1,0
PT,NG,2016.0,1,2,-1
LK,BE,2019.0,2,1,1
SE,CR,2013.0,1,1,0
PL,IR,2013.0,1,5,-4
LB,FI,2017.0,2,1,1
TW,NO,2011.0,1,1,0
BE,ID,2003.0,1,1,0
US,MN,2009.0,1,2,-1
BR,AT,1998.0,1,1,0
NG,ET,2010.0,1,4,-3
PH,IT,2006.0,1,3,-2
ES,UA,2016.0,1,3,-2
NO,AT,2011.0,2,7,-5
LB,QA,2017.0,1,4,-3
RU,CU,2022.0,1,1,0
SG,ZA,2010.0,1,2,-1
ES,LU,2004.0,1,1,0
LT,DE,1999.0,2,6,-4
SK,IN,2004.0,1,3,-2
KG,JP,2020.0,1,3,-2
IL,SK,2001.0,2,1,1
CU,SE,2010.0,1,2,-1
SY,GB,2006.0,1,1,0
TH,SG,1999.0,1,1,0
DK,IS,2008.0,1,5,-4
AU,CL,2006.0,2,9,-7
CY,AU,2012.0,1,3,-2
LU,IT,2011.0,1,7,-6
TZ,KE,2003.0,1,2,-1
MA,CA,2001.0,1,4,-3
RO,RS,2007.0,1,1,0
nan,OM,2014.0,1,2,-1
NI,US,2009.0,3,1,2
AZ,US,2016.0,1,4,-3
BA,CH,2021.0,1,1,0
AT,PL,2001.0,1,8,-7
IN,TZ,2018.0,1,2,-1
IT,DZ,2002.0,2,4,-2
NO,RS,2011.0,1,4,-3
KZ,DE,2016.0,1,6,-5
IE,CN,1998.0,1,1,0
EG,PT,2013.0,1,2,-1
SE,EG,2000.0,2,1,1
KZ,FI,2019.0,2,1,1
QA,ME,2021.0,1,1,0
IT,MK,2021.0,1,2,-1
TR,NG,2021.0,3,7,-4
NO,MT,2021.0,1,1,0
KG,CA,2019.0,1,1,0
PT,MZ,2004.0,1,1,0
JP,BY,2006.0,1,1,0
BN,GB,2017.0,1,7,-6
ZA,LU,2022.0,1,2,-1
TZ,MY,2012.0,1,1,0
TZ,AT,2011.0,1,1,0
SE,SI,1998.0,1,2,-1
CL,BR,2023.0,1,4,-3
RW,UG,2009.0,1,2,-1
NI,RU,2014.0,1,1,0
BF,AT,2017.0,1,1,0
MD,DZ,2014.0,1,1,0
FR,SI,2002.0,2,4,-2
VN,BN,2020.0,1,1,0
IN,BW,2016.0,1,1,0
FI,LV,2022.0,1,1,0
LK,BE,2010.0,1,1,0
TH,FI,2020.0,1,3,-2
US,BB,2002.0,1,1,0
PH,HU,2019.0,1,1,0
EC,UY,2005.0,1,1,0
DK,BO,2015.0,1,1,0
CI,KE,2020.0,1,1,0
MK,MY,2014.0,1,2,-1
DO,US,2009.0,1,3,-2
RW,FR,2013.0,1,3,-2
EG,MA,2008.0,1,2,-1
ZW,NA,2015.0,2,1,1
MY,MM,2012.0,1,1,0
CZ,ZM,2021.0,1,1,0
ZA,ZW,2008.0,1,19,-18
nan,LK,2016.0,1,1,0
FR,SC,2019.0,1,1,0
VE,JP,2010.0,1,2,-1
LY,EG,2006.0,1,2,-1
DZ,CH,2016.0,1,3,-2
KR,TZ,2020.0,2,3,-1
PH,TH,2011.0,3,1,2
US,BM,2013.0,2,1,1
PH,SE,2005.0,1,2,-1
CZ,PK,2014.0,1,1,0
KE,SE,2003.0,2,2,0
KW,GR,2014.0,1,3,-2
TG,FR,2002.0,1,1,0
CN,MK,1998.0,1,2,-1
SI,ES,2001.0,2,1,1
GA,BJ,2021.0,1,1,0
IE,PT,2005.0,1,1,0
BR,CR,2003.0,1,2,-1
CY,AE,2018.0,1,3,-2
SE,ID,2004.0,1,1,0
VN,NG,2021.0,1,1,0
CN,TN,2013.0,1,2,-1
PE,HN,2020.0,1,4,-3
DK,CZ,1998.0,2,1,1
AU,LB,2008.0,1,1,0
CN,KH,2011.0,1,2,-1
FI,GR,2004.0,2,1,1
IN,LA,2018.0,1,0,1
IQ,PH,2000.0,1,0,1
ID,CL,2007.0,1,0,1
LI,US,2014.0,2,0,2
DZ,BE,1997.0,1,0,1
MA,BD,2005.0,1,0,1
GR,BR,1997.0,2,0,2
IS,VN,2011.0,2,0,2
JP,NC,2003.0,1,0,1
AE,HU,2017.0,2,0,2
NO,KW,2009.0,1,0,1
ES,MK,2018.0,2,0,2
PL,MK,2002.0,1,0,1
TR,SI,2023.0,1,0,1
CG,ZA,2012.0,1,0,1
GA,AT,2005.0,1,0,1
CZ,PT,2001.0,1,0,1
SK,XK,2014.0,1,0,1
GB,ME,2016.0,1,0,1
UA,LV,2021.0,1,0,1
JP,LB,2002.0,1,0,1
PT,KE,2017.0,1,0,1
NP,US,1997.0,1,0,1
IT,BW,2001.0,1,0,1
AU,UY,2008.0,2,0,2
LB,OM,2022.0,2,0,2
JP,MK,2005.0,1,0,1
IL,IR,2006.0,1,0,1
BA,XK,2019.0,1,0,1
MX,FK,2018.0,1,0,1
JP,WS,2020.0,1,0,1
GN,CM,2019.0,1,0,1
DZ,PE,2015.0,1,0,1
CG,US,2004.0,1,0,1
NG,JM,2008.0,1,0,1
KW,OM,2003.0,1,0,1
BD,ID,2006.0,1,0,1
BT,GB,2014.0,1,0,1
NI,CO,2007.0,3,0,3
MS,TT,2011.0,1,0,1
PR,IN,1999.0,1,0,1
CL,NI,2016.0,1,0,1
ME,QA,2015.0,1,0,1
IT,MT,2003.0,1,0,1
NE,IN,2018.0,1,0,1
TR,JO,2022.0,1,0,1
ST,,2000.0,1,0,1
IE,VN,2002.0,1,0,1
TR,SY,2010.0,1,0,1
AM,CH,2008.0,1,0,1
AF,BD,2019.0,1,0,1
AM,IR,2016.0,4,0,4
VN,BG,2014.0,1,0,1
AL,ID,2018.0,3,0,3
YE,HU,2000.0,1,0,1
BE,MU,2010.0,1,0,1
LB,ES,2008.0,1,0,1
SD,CH,2022.0,1,0,1
FJ,NZ,2014.0,1,0,1
NG,PG,2014.0,1,0,1
LA,ZM,2015.0,1,0,1
CY,UG,2021.0,3,0,3
TH,RU,2016.0,1,0,1
IT,SD,2016.0,1,0,1
FR,TD,2019.0,4,0,4
HU,AZ,2021.0,1,0,1
JP,AL,2004.0,1,0,1
MD,PL,2021.0,1,0,1
RE,CM,2016.0,1,0,1
TH,CO,2008.0,1,0,1
PL,AE,2009.0,1,0,1
HU,TG,2019.0,1,0,1
CH,QA,2008.0,1,0,1
NI,TR,2012.0,1,0,1
BD,SD,2012.0,1,0,1
UA,PT,1997.0,1,0,1
nan,GF,2009.0,1,0,1
BR,MU,1999.0,1,0,1
RU,ML,2021.0,1,0,1
OM,EG,2002.0,1,0,1
IL,SI,2002.0,1,0,1
PT,JO,2013.0,1,0,1
BF,TN,2011.0,1,0,1
QA,SL,2019.0,1,0,1
MX,GE,2001.0,1,0,1
IN,PR,2007.0,1,0,1
AM,EE,2018.0,1,0,1
PG,CZ,2000.0,1,0,1
ZW,CA,2012.0,1,0,1
CU,GQ,2020.0,1,0,1
UG,PY,2017.0,1,0,1
CZ,TH,2011.0,1,0,1
HR,SG,2013.0,1,0,1
SE,CM,2015.0,1,0,1
SV,CU,2013.0,1,0,1
AF,OM,2017.0,1,0,1
GA,CD,2019.0,1,0,1
AT,SG,2003.0,2,0,2
KH,NL,2010.0,1,0,1
CW,BE,2017.0,2,0,2
SE,TN,2007.0,1,0,1
BY,GE,2013.0,1,0,1
NE,CG,2020.0,1,0,1
BF,AT,2019.0,2,0,2
,SX,2012.0,1,0,1
PH,AF,2020.0,1,0,1
BD,ZM,2019.0,1,0,1
FR,GH,2016.0,2,0,2
KW,FR,2000.0,1,0,1
NO,QA,1998.0,2,0,2
SG,SE,1997.0,1,0,1
HR,XK,2017.0,2,0,2
,GD,1998.0,1,0,1
FI,JM,2001.0,1,0,1
RU,JM,2002.0,1,0,1
MZ,NO,2009.0,1,0,1
SK,GE,2004.0,1,0,1
PS,CR,2012.0,1,0,1
NI,PE,2011.0,1,0,1
VN,MG,2011.0,1,0,1
ID,LA,2021.0,1,0,1
AE,EE,2020.0,1,0,1
HR,CL,2014.0,1,0,1
GH,OM,2007.0,1,0,1
RS,ID,2017.0,1,0,1
BN,AU,2008.0,1,0,1
GY,CA,2011.0,1,0,1
AT,MC,2014.0,1,0,1
AU,IS,2013.0,1,0,1
KW,MY,2006.0,1,0,1
YE,CN,2016.0,2,0,2
SY,AT,2016.0,1,0,1
BR,AG,2015.0,1,0,1
CU,JM,2018.0,1,0,1
LV,BY,2006.0,1,0,1
GP,GB,2022.0,1,0,1
US,KG,2002.0,1,0,1
IQ,BS,2019.0,1,0,1
GH,HU,2013.0,1,0,1
ZA,TN,2012.0,1,0,1
RU,RO,2000.0,1,0,1
BB,DE,2005.0,1,0,1
CI,TR,2022.0,1,0,1
SK,NZ,1997.0,1,0,1
IT,LV,2008.0,1,0,1
NG,SS,2010.0,1,0,1
FO,IS,2022.0,1,0,1
GE,NL,2005.0,1,0,1
SV,HN,2019.0,1,0,1
PH,MZ,2009.0,1,0,1
LY,PH,2012.0,1,0,1
KR,LT,2018.0,1,0,1
MN,RU,1999.0,1,0,1
NL,SA,2004.0,1,0,1
GF,RE,2020.0,1,0,1
GE,PT,2008.0,1,0,1
AU,MA,1999.0,1,0,1
SV,CR,2005.0,1,0,1
BA,DE,2008.0,1,0,1
KR,ES,1999.0,1,0,1
UA,PT,1998.0,2,0,2
MW,RO,2012.0,1,0,1
KR,LV,2011.0,1,0,1
UA,MX,2015.0,1,0,1
TH,IL,2009.0,1,0,1
BA,VN,2018.0,1,0,1
SS,CA,2002.0,1,0,1
BR,AE,2023.0,1,0,1
BF,AU,2016.0,1,0,1
GT,AR,2004.0,1,0,1
GP,US,2000.0,1,0,1
ZM,FR,2020.0,1,0,1
JP,KW,2015.0,1,0,1
ZW,CG,2005.0,1,0,1
BR,HR,2004.0,1,0,1
DE,BZ,2014.0,1,0,1
CG,GN,2020.0,1,0,1
PG,IE,2022.0,1,0,1
ZM,PT,2018.0,1,0,1
PL,HK,2018.0,1,0,1
LU,CH,1997.0,1,0,1
MM,,2006.0,1,0,1
BY,MD,2010.0,1,0,1
KR,MN,2009.0,1,0,1
ES,MM,2012.0,1,0,1
CM,PT,2017.0,1,0,1
GA,CD,2017.0,1,0,1
MN,PL,2021.0,1,0,1
RU,CI,2010.0,1,0,1
NG,PA,2017.0,1,0,1
CL,MY,2018.0,1,0,1
ET,IT,2000.0,1,0,1
ES,CO,2019.0,601,646,-45
CH,DE,2008.0,558,740,-182
US,CA,2016.0,3304,3714,-410
CH,FR,2005.0,240,300,-60
US,CN,2000.0,2060,1847,213
HU,US,2000.0,79,102,-23
ES,US,2002.0,475,443,32
US,TR,1999.0,128,132,-4
AU,US,2005.0,1462,1555,-93
PT,DE,2012.0,48,38,10
US,TW,2016.0,623,774,-151
ES,US,2005.0,520,606,-86
DE,IT,2020.0,333,388,-55
MX,AR,2015.0,133,138,-5
BR,US,2016.0,1301,1255,46
RU,US,2021.0,453,460,-7
NL,DE,2011.0,322,309,13
nan,US,2015.0,236,290,-54
FR,ES,2019.0,337,334,3
JP,CH,2013.0,92,75,17
DE,nan,2007.0,60,33,27
GB,PK,2020.0,210,150,60
SE,CA,2014.0,58,55,3
KR,US,2006.0,906,1011,-105
BR,CU,2009.0,13,17,-4
CL,PE,2016.0,58,73,-15
IN,AE,2017.0,82,58,24
GB,IT,2016.0,417,702,-285
LB,EG,2020.0,26,24,2
AU,GB,2018.0,1552,1655,-103
BR,NL,2008.0,22,26,-4
FR,CH,2011.0,424,341,83
KR,GB,2013.0,90,99,-9
CN,NG,2004.0,2,6,-4
CA,JP,2018.0,109,110,-1
NL,US,2005.0,439,512,-73
IT,BR,2004.0,102,72,30
BD,US,2001.0,14,26,-12
CL,ES,2015.0,349,471,-122
RS,JP,2001.0,5,8,-3
FR,ES,2017.0,303,374,-71
BE,IN,2018.0,54,61,-7
DE,US,2006.0,2124,1986,138
BE,NL,2022.0,174,166,8
GB,CH,2014.0,302,308,-6
US,BR,2018.0,1515,1529,-14
IN,ES,2020.0,22,34,-12
TR,US,2021.0,314,336,-22
KZ,TR,2019.0,40,56,-16
SA,PK,2020.0,110,97,13
VN,BE,2014.0,6,17,-11
SG,IN,2019.0,160,156,4
IT,AU,2015.0,77,68,9
EC,CR,2011.0,1,1,0
MY,SG,2010.0,45,75,-30
VE,CO,2008.0,37,24,13
BE,FR,2020.0,359,354,5
CL,CO,2021.0,155,191,-36
RO,HK,2013.0,11,36,-25
PT,BR,2003.0,238,249,-11
CO,CU,2019.0,46,36,10
GB,KR,2001.0,41,36,5
FR,BR,1998.0,61,32,29
MY,ID,2017.0,383,151,232
CU,MX,2011.0,53,45,8
SI,CA,2020.0,5,6,-1
US,DK,2016.0,299,259,40
US,IE,2017.0,564,578,-14
GB,ZA,1997.0,39,44,-5
ZA,GB,1998.0,45,52,-7
BR,PE,2020.0,90,62,28
PH,GB,2017.0,27,12,15
FI,CN,2020.0,36,65,-29
FR,BR,1997.0,41,24,17
ES,BE,2012.0,66,49,17
CN,SG,2007.0,224,315,-91
CZ,US,2014.0,140,179,-39
FI,NL,2015.0,38,37,1
US,IE,2019.0,591,536,55
CH,SE,2015.0,71,83,-12
US,MX,2007.0,295,284,11
ZA,CH,2016.0,23,19,4
SG,MY,2020.0,176,178,-2
IE,GB,2011.0,284,338,-54
FR,ZA,2003.0,18,9,9
CH,ZA,2016.0,19,23,-4
UA,IT,2008.0,15,18,-3
US,CZ,2009.0,128,126,2
SN,MG,2014.0,1,1,0
VN,AU,2014.0,16,26,-10
CL,PH,2011.0,2,2,0
EC,ES,2010.0,28,17,11
US,IE,2010.0,491,378,113
AR,CO,2003.0,18,22,-4
SD,EG,2013.0,15,12,3
NG,GB,2019.0,129,155,-26
RS,HR,2020.0,140,127,13
EG,CA,2006.0,19,23,-4
BD,IN,2022.0,102,102,0
AR,US,2012.0,240,235,5
AU,SE,2002.0,19,23,-4
AR,CA,2009.0,20,22,-2
UZ,JP,2012.0,3,1,2
IE,AU,2013.0,111,107,4
IT,DE,2005.0,171,154,17
ES,FR,2009.0,208,250,-42
FR,ES,2010.0,315,235,80
US,SG,2009.0,313,256,57
CZ,DE,2020.0,80,93,-13
CR,nan,2013.0,1,7,-6
VE,FR,1998.0,2,6,-4
CH,ES,2019.0,96,146,-50
PT,PE,2011.0,4,2,2
AU,NP,2021.0,13,17,-4
PE,US,2004.0,30,29,1
CH,ES,2010.0,61,86,-25
AU,CN,2007.0,215,183,32
BR,CA,2003.0,108,133,-25
KR,CN,2003.0,166,136,30
PT,ES,2001.0,51,52,-1
DE,CH,2011.0,943,659,284
HU,NO,2008.0,3,2,1
GE,GB,2021.0,4,4,0
MY,YE,2016.0,19,6,13
GB,SG,2022.0,89,98,-9
nan,NL,2011.0,65,61,4
ZA,GB,1997.0,44,39,5
SG,KR,2009.0,21,27,-6
NL,IR,2021.0,28,50,-22
GB,ZW,2015.0,3,7,-4
CN,NL,2007.0,64,64,0
BR,PT,2023.0,76,83,-7
AU,IE,2000.0,27,39,-12
IN,SE,2014.0,50,44,6
NO,DK,2015.0,84,110,-26
nan,GB,2022.0,46,33,13
FR,GB,2022.0,260,259,1
EC,ES,2019.0,210,259,-49
FR,GR,2015.0,47,51,-4
MY,CZ,2013.0,5,5,0
CN,PK,2019.0,246,325,-79
BE,AU,2018.0,40,50,-10
IT,GR,2015.0,33,40,-7
BR,HR,2015.0,5,4,1
BR,CL,2015.0,81,84,-3
US,GR,1997.0,66,62,4
AU,BN,2015.0,4,3,1
ID,US,2008.0,39,50,-11
DE,NL,2016.0,407,387,20
IT,TR,2015.0,28,18,10
SE,DK,2004.0,66,52,14
RS,PK,2013.0,2,1,1
SK,GB,2005.0,23,16,7
BR,nan,2022.0,56,58,-2
PK,CN,2022.0,245,215,30
US,PE,2015.0,92,97,-5
IN,ID,2018.0,117,50,67
DE,SA,2018.0,37,26,11
FR,MD,2002.0,60,55,5
FR,BE,2015.0,375,427,-52
MA,DZ,2016.0,17,20,-3
NG,GB,2017.0,68,116,-48
NZ,KR,2018.0,12,11,1
CH,ES,2017.0,75,140,-65
RU,CN,2002.0,24,13,11
RU,CN,2005.0,54,20,34
NP,CN,2013.0,25,20,5
FR,CN,2006.0,309,194,115
TR,CN,2012.0,51,104,-53
CN,PK,2017.0,141,202,-61
FR,NO,2021.0,60,49,11
CN,RO,2007.0,3,3,0
NG,BR,2016.0,8,10,-2
DE,BE,2012.0,131,116,15
CN,CZ,2013.0,38,30,8
IR,CN,2018.0,77,40,37
SA,TN,2021.0,62,75,-13
nan,JP,2001.0,136,70,66
IE,PL,2008.0,4,4,0
KE,nan,2017.0,8,1,7
IN,BD,2013.0,77,105,-28
US,CY,2020.0,31,12,19
US,IL,2011.0,474,466,8
PK,GB,2017.0,127,188,-61
IN,GB,2007.0,275,236,39
GB,NZ,2002.0,131,126,5
MY,SG,2019.0,166,181,-15
AZ,IR,2014.0,3,1,2
EC,MX,2020.0,131,141,-10
SK,BA,2018.0,2,3,-1
IR,RU,2021.0,12,13,-1
CN,SE,2015.0,101,90,11
GB,TW,2014.0,68,63,5
LB,CA,2019.0,18,23,-5
BR,UY,1998.0,8,2,6
FR,LT,2015.0,2,6,-4
IE,RO,1999.0,2,1,1
DK,NO,2011.0,76,85,-9
GR,PL,2010.0,6,8,-2
DE,TW,2006.0,21,9,12
IN,NO,2014.0,28,15,13
DE,SK,2010.0,41,32,9
KE,ZA,2018.0,33,48,-15
DZ,IT,2017.0,43,56,-13
BE,US,2007.0,232,214,18
IQ,US,2019.0,48,108,-60
TW,SG,2013.0,50,29,21
NL,ES,2022.0,56,67,-11
PL,TW,2015.0,3,4,-1
RU,TR,2001.0,2,1,1
FR,IT,1999.0,163,172,-9
MX,IT,2016.0,30,57,-27
CL,SE,2017.0,16,5,11
JP,NO,2018.0,11,7,4
GB,UY,2010.0,4,1,3
PK,GB,2019.0,175,247,-72
PL,DK,2013.0,17,13,4
JP,GH,2022.0,5,3,2
IN,TH,2013.0,8,8,0
AU,ID,2008.0,37,10,27
CL,GR,2017.0,2,3,-1
AR,CU,2013.0,14,18,-4
HU,GB,2006.0,34,34,0
MY,SG,2017.0,143,150,-7
DZ,IT,2019.0,39,58,-19
GR,US,2021.0,116,106,10
SE,NO,2006.0,86,31,55
GB,BE,2003.0,60,76,-16
IN,KR,2021.0,184,142,42
UG,KE,2018.0,23,15,8
KE,GH,2019.0,6,2,4
MX,SE,2020.0,10,8,2
US,BG,2008.0,33,25,8
CO,CA,2019.0,28,35,-7
AU,IR,2011.0,60,76,-16
GB,NP,2021.0,14,10,4
nan,FI,2005.0,11,8,3
ET,ZA,2017.0,11,19,-8
SS,GB,2014.0,7,9,-2
FR,ID,2014.0,39,19,20
TH,TR,2020.0,2,1,1
IN,JP,2020.0,139,126,13
CH,HU,1998.0,7,7,0
KZ,TR,2017.0,61,27,34
SG,IN,2017.0,121,165,-44
IN,KW,2016.0,13,15,-2
RO,FR,2014.0,42,70,-28
AE,EG,2020.0,53,65,-12
KR,FR,2013.0,37,31,6
nan,FR,1999.0,32,55,-23
CO,CA,2017.0,33,33,0
CO,AR,2013.0,81,101,-20
CH,LK,2018.0,7,2,5
DK,CL,2020.0,5,5,0
AT,SE,2005.0,8,14,-6
IE,CH,2015.0,22,13,9
nan,MY,2016.0,41,104,-63
FI,BE,2009.0,9,8,1
VG,GB,2001.0,4,2,2
NL,RU,2017.0,46,51,-5
nan,KR,2019.0,31,23,8
GB,CL,2018.0,61,75,-14
MX,FR,2015.0,65,68,-3
TH,AU,2002.0,6,15,-9
HR,IT,2017.0,7,17,-10
BR,BE,2015.0,71,84,-13
OM,PK,2014.0,5,15,-10
CM,FR,2014.0,13,14,-1
BD,MY,2020.0,44,69,-25
PT,US,2006.0,91,118,-27
PE,CL,2015.0,72,58,14
NL,CH,2018.0,125,104,21
SE,IT,2014.0,62,100,-38
BR,IE,2020.0,24,13,11
PT,DZ,2019.0,6,2,4
IQ,AU,2016.0,10,7,3
HR,CZ,2016.0,14,4,10
BA,HR,2021.0,34,27,7
CH,CO,2013.0,9,11,-2
DZ,FR,2008.0,51,75,-24
PH,IL,2018.0,1,3,-2
CU,PE,2020.0,15,13,2
PK,GB,2010.0,59,75,-16
IQ,US,2017.0,37,65,-28
EG,JO,2015.0,6,12,-6
SD,US,2011.0,2,2,0
US,UY,2009.0,22,22,0
CH,IN,2020.0,72,74,-2
RU,NL,2007.0,34,27,7
CZ,PL,2023.0,4,5,-1
SK,PL,2018.0,9,15,-6
HU,HR,2016.0,1,3,-2
DK,IN,2012.0,17,15,2
BJ,CA,2018.0,5,2,3
OM,GB,2003.0,7,6,1
JP,HK,2019.0,13,15,-2
NO,AU,2019.0,27,21,6
CY,GB,2016.0,31,41,-10
US,HN,2013.0,6,5,1
NI,UA,2020.0,23,13,10
CA,SN,2007.0,1,3,-2
GB,PT,2018.0,103,152,-49
HR,DE,2022.0,9,14,-5
TH,CN,2018.0,37,42,-5
AT,SI,2018.0,9,40,-31
PL,FR,1999.0,30,34,-4
UG,SE,2022.0,2,3,-1
CH,CI,2016.0,2,1,1
EG,AE,2013.0,19,26,-7
IR,GB,2022.0,90,32,58
CH,GR,2012.0,20,30,-10
MA,TN,2014.0,34,43,-9
US,DO,2020.0,9,8,1
RU,EE,2006.0,2,1,1
CM,GA,2019.0,2,2,0
RU,AT,2017.0,18,19,-1
KR,VN,2018.0,112,63,49
RU,UA,2022.0,220,187,33
KE,CM,2019.0,5,2,3
nan,KZ,2020.0,3,1,2
IQ,IR,2022.0,19,14,5
ZA,BR,2000.0,6,2,4
VN,PL,2015.0,5,5,0
US,FI,2022.0,87,72,15
nan,CN,1998.0,10,5,5
IT,CA,2007.0,66,72,-6
AU,VN,1997.0,3,1,2
JP,CA,2022.0,44,49,-5
IN,NG,2019.0,43,30,13
RU,nan,2013.0,37,87,-50
NL,PL,2021.0,12,16,-4
RU,VN,2020.0,13,10,3
MY,ID,2019.0,534,213,321
IT,CN,2011.0,43,42,1
NO,BR,2005.0,18,11,7
CL,VE,2006.0,18,15,3
GB,NZ,2005.0,199,153,46
AR,GB,2006.0,17,22,-5
CN,FR,2020.0,131,239,-108
ZA,NZ,2003.0,11,7,4
IS,DK,2013.0,6,6,0
DE,SK,2017.0,46,24,22
RS,US,1998.0,24,14,10
ZW,BH,2022.0,2,3,-1
MY,nan,2020.0,53,62,-9
JP,HU,2017.0,23,8,15
nan,BR,2001.0,9,8,1
NO,ES,2011.0,15,31,-16
LT,CH,2021.0,6,2,4
US,UG,2011.0,24,19,5
SG,IN,2010.0,33,75,-42
IT,TN,2006.0,4,2,2
FR,PK,2009.0,8,9,-1
IN,DK,2001.0,5,2,3
UA,JP,2021.0,3,2,1
ES,GR,2012.0,14,15,-1
BE,DE,1997.0,41,41,0
FR,IR,2009.0,31,13,18
AU,SE,2005.0,25,33,-8
PK,TR,2015.0,18,10,8
BY,US,2014.0,12,9,3
DE,JP,2002.0,120,148,-28
SE,SA,2008.0,2,3,-1
FI,CH,2009.0,21,18,3
UA,FR,2009.0,17,12,5
PK,MT,2019.0,1,1,0
CU,GB,2008.0,6,4,2
TR,AT,2009.0,11,9,2
BR,SE,2013.0,22,21,1
NO,CN,2001.0,9,4,5
RU,FI,2021.0,33,20,13
FI,BR,2012.0,7,6,1
CH,nan,2018.0,16,25,-9
AT,BD,2020.0,1,1,0
AU,CH,2009.0,59,62,-3
GR,NO,2005.0,1,2,-1
US,CO,2003.0,88,81,7
EG,BH,2021.0,3,11,-8
MX,ZA,2016.0,5,2,3
BR,ID,2017.0,21,10,11
ES,BO,2018.0,24,23,1
NG,DE,2013.0,8,6,2
GB,RU,2020.0,132,113,19
ZA,CR,2011.0,2,3,-1
MY,BN,2018.0,13,10,3
nan,PT,2012.0,50,27,23
NO,IS,2012.0,8,3,5
BE,CZ,2021.0,16,4,12
KE,BF,2007.0,1,1,0
FI,AU,2020.0,16,23,-7
CN,BR,2004.0,23,15,8
BR,LU,2010.0,4,4,0
DK,MX,2021.0,4,3,1
TW,CH,2015.0,16,5,11
SI,ID,2014.0,4,3,1
NG,GB,2010.0,32,24,8
CN,MX,2008.0,5,3,2
CZ,EG,2018.0,4,4,0
RU,UZ,2001.0,6,10,-4
CO,CA,2010.0,13,10,3
DK,RU,2000.0,7,4,3
NL,TH,2015.0,13,2,11
RE,FR,2011.0,22,44,-22
TZ,PK,2018.0,1,1,0
TZ,NO,2019.0,3,12,-9
IR,JP,2014.0,17,26,-9
AU,AR,2008.0,4,7,-3
TJ,UZ,2020.0,4,3,1
IQ,JP,2007.0,2,2,0
IL,IN,2014.0,17,59,-42
CI,CD,2019.0,1,1,0
CA,SG,1998.0,21,10,11
AR,FR,2009.0,32,38,-6
MY,KR,2014.0,25,33,-8
FR,LU,2002.0,12,8,4
FR,LU,2005.0,21,14,7
US,ID,2005.0,29,22,7
AU,PH,2021.0,12,10,2
CA,TR,2012.0,29,25,4
FR,MD,2005.0,54,56,-2
AU,PG,1999.0,4,3,1
BI,FR,2006.0,10,18,-8
UY,CO,2021.0,8,13,-5
BE,DE,1998.0,38,38,0
UA,ES,2013.0,6,5,1
nan,KR,2010.0,27,17,10
RS,FR,2021.0,8,5,3
CH,AM,2016.0,1,2,-1
nan,SE,2015.0,50,68,-18
UY,BR,2021.0,34,44,-10
AF,PK,2016.0,3,1,2
JP,OM,2003.0,2,1,1
IN,BR,2009.0,15,15,0
UG,US,2013.0,26,29,-3
SE,DE,2000.0,58,86,-28
NO,IN,2022.0,18,32,-14
GW,DK,2007.0,3,2,1
IT,RO,2022.0,8,6,2
PH,CN,2008.0,28,11,17
IT,RU,2006.0,27,12,15
TR,CY,2021.0,55,61,-6
PH,GB,2019.0,21,26,-5
PK,KR,2016.0,35,41,-6
DE,ID,2011.0,20,11,9
AU,RO,2022.0,5,4,1
RS,TR,2020.0,24,4,20
CH,RU,2011.0,12,21,-9
RS,DE,2000.0,5,3,2
BR,JP,2022.0,17,16,1
DZ,IT,2010.0,13,14,-1
AT,CN,2021.0,21,18,3
SE,ID,2015.0,12,5,7
CL,GB,2007.0,25,15,10
JP,PK,2011.0,14,6,8
VN,NL,2015.0,3,12,-9
TH,ZA,2014.0,3,1,2
NZ,NL,2000.0,4,6,-2
TZ,SE,2017.0,1,6,-5
FR,UA,1998.0,8,5,3
ZA,CZ,2017.0,4,5,-1
IN,nan,2006.0,17,10,7
FI,FR,2018.0,30,25,5
EG,AU,2023.0,1,3,-2
IN,RW,2019.0,7,8,-1
JP,HU,2010.0,5,5,0
CO,FR,2005.0,13,14,-1
nan,RO,2012.0,2,1,1
nan,AR,2021.0,36,32,4
CN,KZ,2018.0,5,8,-3
IN,DZ,2021.0,3,1,2
HU,CA,2013.0,10,12,-2
BD,DE,2020.0,15,12,3
MY,ID,2010.0,21,34,-13
SG,FR,2019.0,36,28,8
CL,PK,2013.0,1,1,0
RU,BY,2007.0,32,51,-19
KR,BD,2022.0,19,17,2
GH,CN,2022.0,22,40,-18
SV,CO,2018.0,10,2,8
ID,CN,2006.0,10,4,6
IL,PL,2021.0,8,12,-4
AL,MK,2021.0,2,2,0
TN,NL,2020.0,2,1,1
TR,IN,2021.0,21,18,3
US,AM,2022.0,15,8,7
MY,GB,2008.0,53,103,-50
DK,BE,2004.0,9,6,3
MN,KR,2016.0,4,12,-8
TH,BD,2021.0,2,3,-1
CA,GH,2013.0,10,4,6
nan,KR,2017.0,38,28,10
KZ,TR,2010.0,24,28,-4
UA,EC,1999.0,7,4,3
ZW,ZA,2007.0,14,7,7
IT,DE,2002.0,125,118,7
IN,NG,2017.0,23,17,6
JO,US,2022.0,40,24,16
CH,PT,2005.0,2,8,-6
ET,PT,2019.0,3,1,2
US,RO,2021.0,87,59,28
nan,CN,1997.0,5,4,1
NZ,SE,2016.0,9,6,3
PH,IN,2019.0,18,20,-2
BR,PK,2016.0,9,9,0
BY,UA,2014.0,9,15,-6
RS,US,1997.0,11,10,1
IL,DE,2016.0,63,66,-3
CM,US,2016.0,8,14,-6
BF,CA,2013.0,2,3,-1
CN,PK,2010.0,42,64,-22
VN,DE,2009.0,6,8,-2
JP,IE,2011.0,23,23,0
FR,NZ,2002.0,6,5,1
SK,DE,2004.0,42,22,20
AU,TH,1998.0,9,4,5
UA,AU,2022.0,1,1,0
CH,SK,2022.0,3,3,0
US,CM,1997.0,3,1,2
AT,JP,2004.0,5,6,-1
SI,US,1998.0,8,6,2
LK,JP,2000.0,15,6,9
HR,US,2007.0,37,34,3
GB,LT,2007.0,5,5,0
AR,MY,2013.0,4,2,2
NZ,ES,2020.0,10,11,-1
PK,PL,2005.0,3,5,-2
RU,DK,2013.0,4,10,-6
DE,TH,2002.0,7,6,1
AU,SK,2005.0,3,1,2
RO,CA,1999.0,5,2,3
UA,MX,2004.0,4,3,1
BR,LU,2019.0,2,5,-3
GB,RO,2007.0,10,18,-8
AT,SE,2002.0,9,6,3
UA,PL,2007.0,17,7,10
IT,NG,2005.0,8,5,3
DE,NZ,2014.0,45,46,-1
DE,GE,2002.0,6,6,0
MY,IN,2000.0,2,12,-10
US,SK,1998.0,20,15,5
DE,HR,2009.0,22,16,6
LY,QA,2017.0,2,4,-2
IT,SK,2001.0,5,1,4
JP,ES,2018.0,31,35,-4
TH,GB,2012.0,24,85,-61
MA,IN,2020.0,8,5,3
ID,TH,2008.0,2,1,1
TZ,NO,2010.0,4,10,-6
AZ,GB,2013.0,5,3,2
SE,IR,2008.0,21,13,8
CA,SA,1997.0,8,4,4
RU,BE,2013.0,17,15,2
KE,ET,2011.0,5,3,2
GB,DZ,2015.0,13,4,9
BR,ID,2019.0,25,20,5
SG,FR,2017.0,21,31,-10
NL,RU,2010.0,37,23,14
HU,IT,2014.0,12,5,7
ES,AT,1997.0,5,6,-1
BE,BD,2006.0,2,1,1
MY,BD,2011.0,12,31,-19
CI,US,2018.0,6,10,-4
JP,CO,2009.0,9,6,3
IN,LY,2011.0,1,8,-7
MX,VE,2009.0,33,43,-10
US,SK,1997.0,21,11,10
AU,UA,2009.0,1,1,0
GB,MX,2012.0,79,44,35
GR,MK,2012.0,8,13,-5
CH,IL,2020.0,22,21,1
TT,JM,2006.0,17,14,3
SE,AE,2016.0,10,7,3
NL,AL,2013.0,1,1,0
AU,IL,2005.0,9,13,-4
DK,IR,2022.0,6,31,-25
JP,UA,1998.0,4,4,0
MX,GB,2004.0,39,32,7
QA,US,2007.0,10,19,-9
GB,UG,2016.0,13,18,-5
US,MW,2007.0,7,2,5
DE,CL,1998.0,13,9,4
MD,GB,2020.0,2,1,1
IL,TR,2003.0,7,5,2
DE,KR,2004.0,29,26,3
AM,KR,2006.0,14,4,10
ES,LU,2015.0,4,3,1
MX,HN,2009.0,12,15,-3
CA,RO,2012.0,14,11,3
NL,CZ,1997.0,7,2,5
ZA,NL,2008.0,25,30,-5
CA,SG,1997.0,6,11,-5
ET,PR,2019.0,8,4,4
TW,TR,2009.0,8,13,-5
AU,FI,1999.0,9,7,2
TW,FI,2019.0,6,2,4
SK,RU,2012.0,16,21,-5
IT,NG,2002.0,3,2,1
SG,FR,2010.0,12,22,-10
IN,TT,2020.0,4,2,2
VE,DO,2022.0,1,1,0
MA,MD,2019.0,6,1,5
FR,NZ,2005.0,9,5,4
CZ,FR,2021.0,30,26,4
NO,JP,2012.0,9,10,-1
JP,LK,2003.0,11,11,0
FR,VE,2001.0,2,6,-4
ZA,FI,2012.0,4,2,2
FI,DE,2006.0,43,36,7
AE,nan,2021.0,2,2,0
MQ,FR,2001.0,3,2,1
CO,CU,2017.0,31,37,-6
IE,DK,2012.0,8,2,6
PL,NL,2021.0,16,12,4
PL,QA,2019.0,3,1,2
PL,BE,1998.0,3,8,-5
RO,UA,2002.0,3,2,1
FR,HR,2012.0,1,6,-5
KR,ID,2023.0,5,2,3
PA,US,2000.0,10,13,-3
HU,NL,1998.0,9,5,4
US,VN,2000.0,16,12,4
VN,US,2000.0,12,16,-4
FR,CM,2023.0,1,1,0
GB,LY,2015.0,11,7,4
AR,PE,1999.0,3,3,0
MM,MY,2014.0,2,2,0
SI,HR,1999.0,1,3,-2
SI,CH,2004.0,4,5,-1
PE,JP,2014.0,2,2,0
DE,IQ,2021.0,9,6,3
IE,NL,2000.0,7,10,-3
ID,UA,2020.0,9,1,8
NO,AU,2010.0,15,22,-7
PH,KR,2020.0,9,10,-1
IT,AM,2009.0,13,29,-16
IN,IS,2019.0,3,1,2
CA,JO,2014.0,8,7,1
ES,DO,2002.0,1,1,0
PL,LT,2018.0,8,3,5
HN,MX,2016.0,31,19,12
AE,IT,2018.0,5,11,-6
NL,EG,2003.0,4,2,2
JP,HK,2017.0,11,8,3
MX,DK,2012.0,7,4,3
BY,CA,2020.0,2,2,0
DE,SE,2023.0,16,8,8
QA,AU,2004.0,3,2,1
EG,MY,2015.0,38,44,-6
LK,CN,2020.0,13,12,1
ET,PR,2017.0,9,11,-2
CL,SE,2019.0,11,4,7
NO,GB,2023.0,4,5,-1
ES,ID,2012.0,10,6,4
IN,AT,2012.0,17,13,4
CA,GR,2016.0,8,19,-11
SE,PT,2000.0,4,2,2
SK,GE,2015.0,3,1,2
IL,IT,2013.0,12,18,-6
LB,CA,2017.0,15,11,4
CA,ID,2009.0,10,5,5
RU,SE,2012.0,33,23,10
KE,GB,2009.0,22,22,0
RU,MX,2015.0,6,12,-6
FI,TR,2011.0,7,3,4
MW,DE,2019.0,2,4,-2
FR,JO,2013.0,4,5,-1
BG,CH,2014.0,3,4,-1
JP,AT,2005.0,9,11,-2
MZ,RU,2016.0,19,6,13
UY,ES,2011.0,38,36,2
NZ,BR,2016.0,8,8,0
US,JM,2004.0,11,8,3
KR,DE,2007.0,23,36,-13
SE,CO,2012.0,6,4,2
IN,VN,2014.0,2,1,1
US,YE,2013.0,4,1,3
PH,IN,2017.0,25,18,7
DE,UY,2018.0,3,7,-4
IN,RS,2014.0,2,5,-3
AZ,UZ,2022.0,3,2,1
RU,PK,2022.0,6,5,1
SY,SA,2021.0,4,4,0
RS,IT,2012.0,7,6,1
JP,HU,2019.0,13,15,-2
NO,HR,2013.0,2,5,-3
MK,GR,2012.0,13,8,5
SK,GB,2002.0,25,12,13
IQ,GB,2013.0,9,30,-21
HU,SK,2017.0,8,8,0
NO,RU,2011.0,23,12,11
GR,DK,2009.0,12,5,7
ZA,ZW,2007.0,7,14,-7
CZ,BY,2021.0,9,21,-12
LT,FI,2007.0,3,1,2
SN,US,2006.0,7,8,-1
GR,CZ,2013.0,10,2,8
GB,UY,2019.0,6,6,0
GB,HR,2018.0,18,20,-2
FR,CG,2012.0,21,15,6
US,ZW,2012.0,7,7,0
CN,RU,2000.0,13,10,3
JP,AT,2002.0,8,4,4
OM,JO,2008.0,1,4,-3
LY,QA,2019.0,4,2,2
CA,EC,2011.0,1,2,-1
FR,PE,2021.0,8,6,2
PK,PG,2014.0,1,1,0
QA,AE,2021.0,13,10,3
BW,GB,2010.0,2,2,0
KE,NZ,2015.0,2,4,-2
CO,IT,2007.0,5,8,-3
NZ,nan,2001.0,7,8,-1
ZA,nan,2006.0,4,8,-4
US,MT,2020.0,9,6,3
AM,US,2017.0,13,15,-2
LB,CH,2012.0,1,1,0
PA,BR,2017.0,13,3,10
PA,FR,2009.0,3,1,2
LT,MZ,2010.0,2,2,0
BE,BR,1998.0,16,14,2
SK,BE,2016.0,5,3,2
DK,IS,2007.0,7,3,4
HU,SK,2010.0,16,8,8
AU,IL,2002.0,13,10,3
NZ,ID,2020.0,10,4,6
CZ,SI,2017.0,8,5,3
LB,BR,2011.0,3,3,0
RU,MD,2001.0,1,2,-1
RO,CN,2011.0,3,2,1
CO,PT,2009.0,7,6,1
OM,US,1998.0,3,4,-1
nan,DK,2000.0,4,1,3
IE,NO,2021.0,6,6,0
TZ,KR,2014.0,1,2,-1
CZ,CL,2014.0,3,4,-1
ZA,DE,2003.0,24,27,-3
ET,ZA,2019.0,10,23,-13
AL,FR,2017.0,1,1,0
FR,BI,2016.0,17,13,4
SA,ES,2022.0,4,3,1
UY,US,2002.0,8,8,0
BD,IQ,2016.0,4,1,3
PH,IN,2010.0,7,11,-4
DK,DE,2023.0,5,8,-3
TW,GR,2021.0,1,1,0
NZ,NP,1998.0,3,2,1
IN,BT,2019.0,5,1,4
SA,NG,2001.0,2,1,1
CH,UA,2001.0,2,8,-6
GW,BR,2018.0,1,1,0
KR,AE,2019.0,8,5,3
FR,CD,2016.0,6,2,4
US,LK,2010.0,17,24,-7
HR,IT,2019.0,3,12,-9
IE,IN,2004.0,4,8,-4
KW,PK,2010.0,5,2,3
BR,PL,2007.0,6,2,4
NP,JP,2008.0,1,5,-4
SE,BD,2002.0,1,1,0
ZA,EG,2014.0,6,1,5
EC,DE,2013.0,4,4,0
AU,AE,2020.0,14,14,0
JM,BB,2016.0,8,5,3
DE,TH,2005.0,8,8,0
PK,NG,2015.0,12,8,4
DK,HU,2016.0,2,11,-9
PS,JO,2020.0,14,11,3
MX,PT,2018.0,21,17,4
ES,BD,2020.0,14,15,-1
RS,XK,2015.0,8,10,-2
SE,RS,2010.0,4,1,3
LB,GB,2009.0,6,5,1
JP,NL,2018.0,27,41,-14
RU,IN,2007.0,14,2,12
CH,MD,1997.0,1,2,-1
CN,OM,2022.0,1,2,-1
KR,NZ,2004.0,3,2,1
SE,BD,2005.0,3,1,2
CH,PK,1998.0,6,2,4
SK,SI,2004.0,2,1,1
TW,nan,2018.0,4,2,2
PK,TW,2003.0,2,1,1
CA,MT,2016.0,1,3,-2
BR,ZM,2006.0,2,2,0
CH,PT,2002.0,7,6,1
CH,PK,1997.0,4,5,-1
RU,AT,2019.0,15,23,-8
HN,ES,2020.0,5,11,-6
RU,TW,2015.0,13,5,8
HR,ES,2015.0,4,8,-4
LK,MY,2011.0,1,1,0
MX,CH,2021.0,8,13,-5
ES,NZ,2015.0,4,4,0
KR,CA,2023.0,6,2,4
IQ,TR,2019.0,10,22,-12
CY,IT,2021.0,7,1,6
IN,TR,2022.0,19,17,2
BE,MX,1999.0,3,2,1
NG,TH,2020.0,4,2,2
ET,TZ,2021.0,1,3,-2
HR,IT,2010.0,3,9,-6
CZ,SI,2010.0,7,5,2
nan,FI,2002.0,12,6,6
BE,AE,2016.0,3,1,2
NO,AU,2017.0,15,25,-10
AR,PK,2012.0,11,23,-12
LB,FR,2000.0,3,18,-15
nan,SI,2015.0,3,2,1
CN,IL,2022.0,18,26,-8
LB,AE,2007.0,1,1,0
AM,US,2010.0,18,6,12
BW,GB,2019.0,3,10,-7
BD,SE,2008.0,6,2,4
IL,NL,2009.0,18,14,4
HU,FR,1999.0,18,21,-3
AU,JO,2000.0,2,1,1
US,BH,2005.0,11,7,4
UZ,PL,2006.0,1,2,-1
PA,BR,2019.0,5,1,4
HN,US,2017.0,7,5,2
FR,IQ,2011.0,1,2,-1
HU,FI,2004.0,6,6,0
UY,MX,2011.0,7,9,-2
MX,GT,2012.0,11,8,3
RO,CH,2010.0,9,8,1
RO,VN,2008.0,1,5,-4
CN,EE,2014.0,3,3,0
FJ,AU,2003.0,2,2,0
KE,CM,2017.0,1,3,-2
KR,IL,2021.0,4,7,-3
NZ,FI,2020.0,3,5,-2
ES,DO,2005.0,1,1,0
BE,SE,2006.0,12,25,-13
SA,IE,2020.0,4,20,-16
KR,NO,2018.0,9,9,0
OM,US,1997.0,2,2,0
DK,JP,2022.0,10,6,4
EG,DZ,2012.0,8,1,7
AO,US,2014.0,2,3,-1
TH,IT,2018.0,9,4,5
AT,IN,2020.0,8,18,-10
TW,VN,2013.0,12,5,7
BD,NP,2015.0,5,5,0
AE,JO,2015.0,6,14,-8
CG,UG,2022.0,1,1,0
KZ,GB,2005.0,1,1,0
FI,nan,2003.0,3,8,-5
UA,SI,2020.0,1,3,-2
ID,LK,2011.0,1,1,0
SA,BH,1999.0,2,1,1
UA,CN,1998.0,8,4,4
EE,SE,2018.0,6,7,-1
FJ,US,2014.0,5,3,2
JP,BT,2017.0,1,1,0
BG,GB,2013.0,7,11,-4
TH,AU,2005.0,7,24,-17
AM,DE,2022.0,2,5,-3
RU,KR,2004.0,8,7,1
GB,NG,2002.0,11,7,4
FR,MR,2012.0,2,2,0
GB,BA,2022.0,2,1,1
MA,MD,2017.0,3,1,2
US,MK,2012.0,8,7,1
KE,GH,2017.0,1,3,-2
NL,BG,2018.0,2,6,-4
IN,GR,2001.0,5,1,4
TR,EG,2013.0,3,3,0
TW,FI,2010.0,4,2,2
PK,SA,2001.0,6,3,3
TZ,SE,2010.0,1,7,-6
FR,UA,1997.0,5,7,-2
UA,RO,2013.0,5,3,2
JP,AL,2015.0,2,1,1
CH,PH,1999.0,1,4,-3
CH,FI,2003.0,12,11,1
CL,UY,2003.0,3,3,0
GB,AE,1998.0,3,8,-5
SG,BE,2016.0,7,4,3
PA,JP,2011.0,2,3,-1
SE,RS,2017.0,3,5,-2
FI,HU,2013.0,6,4,2
EC,AU,2012.0,2,1,1
GB,OM,2001.0,3,4,-1
ZA,BF,2017.0,1,2,-1
FR,HT,2014.0,2,2,0
SA,BD,2007.0,4,3,1
SI,HU,2020.0,1,2,-1
CY,KR,2018.0,3,1,2
nan,AT,1997.0,2,1,1
CA,ZA,2003.0,17,28,-11
TN,IT,2016.0,23,22,1
DE,MA,2022.0,2,7,-5
BD,BE,2014.0,3,2,1
BW,ZA,2007.0,6,4,2
AE,TN,2006.0,1,1,0
NO,BR,2002.0,6,12,-6
KW,AU,2020.0,6,4,2
BH,KR,2002.0,1,1,0
CH,AR,1998.0,3,1,2
BG,AT,1999.0,4,1,3
SI,RU,2020.0,1,6,-5
GB,UZ,2001.0,1,1,0
GR,AU,2020.0,7,8,-1
US,GA,2022.0,2,1,1
IE,ID,2018.0,1,1,0
ET,DE,2007.0,6,5,1
nan,CZ,2022.0,1,3,-2
RU,MY,2003.0,5,2,3
PT,MZ,2015.0,4,3,1
MX,AF,2021.0,1,1,0
GT,AR,2015.0,1,3,-2
NL,NG,2006.0,2,1,1
EG,IN,2009.0,3,3,0
IT,BH,2015.0,1,1,0
TN,JP,2021.0,2,2,0
MX,BE,2004.0,9,4,5
UG,GB,2002.0,5,1,4
FI,IT,2008.0,13,13,0
JO,SE,2008.0,2,1,1
GB,JP,2023.0,7,14,-7
KR,BE,2020.0,16,12,4
PT,SE,2011.0,3,13,-10
AU,VE,2006.0,2,2,0
UG,GB,2005.0,8,6,2
CI,CM,2020.0,2,3,-1
CO,CU,2010.0,16,30,-14
TR,KW,2021.0,3,2,1
AU,SI,2021.0,4,4,0
RU,AT,2010.0,14,11,3
TR,MX,2010.0,4,4,0
MY,TZ,2015.0,1,1,0
BD,SA,2001.0,5,2,3
KW,KR,2019.0,1,1,0
NZ,ZA,2015.0,10,10,0
BR,DK,2022.0,24,17,7
GB,FK,2005.0,2,1,1
HN,US,2019.0,5,6,-1
ZA,TW,2017.0,3,3,0
TR,MX,2019.0,7,3,4
PE,CR,2007.0,4,1,3
IN,FJ,2007.0,1,1,0
SE,SG,2001.0,1,1,0
ZM,JP,2012.0,3,3,0
FI,SK,2017.0,1,2,-1
nan,IE,2014.0,3,3,0
IQ,TR,2017.0,8,12,-4
MW,TZ,2009.0,2,1,1
PA,ES,2007.0,4,10,-6
PH,JP,2022.0,8,12,-4
VE,FR,1997.0,2,2,0
LB,IT,2011.0,5,10,-5
US,BH,2002.0,5,2,3
BE,NE,2011.0,1,1,0
AR,CN,2018.0,5,1,4
LA,VN,2019.0,1,1,0
NO,SG,2000.0,1,1,0
FR,DJ,2014.0,2,1,1
IE,LT,2008.0,1,1,0
SE,RS,2019.0,4,3,1
HU,CZ,2009.0,4,3,1
BR,FI,2007.0,6,2,4
HU,AU,2018.0,4,14,-10
SE,PH,2007.0,1,1,0
UA,BY,2003.0,4,3,1
DK,EG,2014.0,6,3,3
RS,CZ,2000.0,6,6,0
US,BW,1999.0,3,2,1
NG,FR,2011.0,5,5,0
AM,US,2019.0,12,18,-6
IE,FI,2006.0,4,2,2
IT,HR,2007.0,2,1,1
SE,IE,2015.0,7,11,-4
KR,AE,2017.0,5,2,3
LB,CA,2010.0,6,12,-6
GR,FI,2006.0,1,3,-2
PK,AR,2018.0,5,4,1
BE,CU,2020.0,3,4,-1
BW,GB,2017.0,6,7,-1
DE,BD,2013.0,9,8,1
MY,QA,2014.0,7,3,4
BR,BG,2004.0,2,2,0
EE,IN,2022.0,7,7,0
MX,IN,2008.0,7,12,-5
MX,TR,2005.0,1,3,-2
GB,PG,2018.0,2,3,-1
PL,HU,2007.0,13,17,-4
IN,NG,2010.0,5,5,0
PY,PT,2008.0,4,1,3
IN,EG,2015.0,15,19,-4
AM,CN,2020.0,1,1,0
nan,NZ,2016.0,4,4,0
BG,PL,2018.0,2,4,-2
NZ,BG,2013.0,1,1,0
NL,SA,2015.0,4,8,-4
RS,PT,2021.0,1,3,-2
UG,NG,2023.0,1,1,0
PK,HU,2009.0,1,2,-1
PT,RU,1999.0,2,9,-7
JP,HR,2010.0,3,4,-1
FR,EC,2012.0,5,3,2
ES,PH,2008.0,8,1,7
ES,SG,2013.0,7,6,1
TW,PH,2014.0,4,5,-1
PT,JP,1998.0,2,1,1
PT,FI,2008.0,2,3,-1
KE,PK,2008.0,4,5,-1
IT,PK,2008.0,3,3,0
LT,LV,2012.0,2,1,1
GE,FR,1999.0,2,2,0
PA,DE,2021.0,2,4,-2
TR,MY,2021.0,3,15,-12
IL,EC,2020.0,1,1,0
GB,MK,2021.0,1,2,-1
BR,GR,2012.0,2,4,-2
NL,CN,2023.0,11,21,-10
SK,AT,2006.0,7,11,-4
ME,HR,2002.0,1,1,0
DK,IL,2003.0,2,2,0
TN,MX,2013.0,3,2,1
BR,SG,2011.0,5,2,3
AR,BE,2008.0,6,6,0
TR,MX,2017.0,2,2,0
KW,PK,2017.0,7,1,6
NG,MY,2012.0,20,11,9
US,GN,2018.0,1,3,-2
BJ,TG,2016.0,1,2,-1
PE,FI,2011.0,1,2,-1
CA,SA,1998.0,11,9,2
FI,GR,2015.0,3,6,-3
PH,GB,2010.0,7,14,-7
FI,JP,2022.0,7,6,1
PE,GT,2022.0,2,2,0
CY,IN,2022.0,2,3,-1
CU,CA,2014.0,4,2,2
IE,GR,2020.0,2,9,-7
TH,DK,2009.0,1,2,-1
ZA,CM,2014.0,3,10,-7
LT,MZ,2019.0,2,2,0
ES,TR,2018.0,6,15,-9
CH,KE,2002.0,2,1,1
HK,TW,2021.0,1,1,0
CY,AZ,2020.0,1,1,0
AU,TH,1997.0,4,1,3
GH,nan,2016.0,5,3,2
JP,CL,2007.0,2,2,0
CN,AE,2005.0,2,2,0
FJ,GB,2018.0,1,3,-2
VN,FR,2004.0,7,6,1
TZ,JP,2016.0,5,2,3
BG,SI,2014.0,1,1,0
IL,DK,2001.0,1,3,-2
CZ,GE,2012.0,3,2,1
ZA,IR,2002.0,1,1,0
CZ,LT,2008.0,3,9,-6
SD,CA,2018.0,1,3,-2
BE,NO,1998.0,5,3,2
ZA,GR,2012.0,1,2,-1
SG,AT,2016.0,5,3,2
nan,NP,2016.0,1,5,-4
JP,AM,2008.0,2,7,-5
RU,SA,2014.0,3,1,2
DO,ES,2013.0,2,5,-3
TN,SY,2015.0,3,2,1
CI,CA,2020.0,3,5,-2
PL,PK,2012.0,4,5,-1
ID,RO,2013.0,2,3,-1
TW,IE,2009.0,3,3,0
PR,ES,2005.0,1,1,0
ES,PL,1999.0,3,3,0
PE,PH,2020.0,7,9,-2
CL,PT,2005.0,3,5,-2
IE,UY,2013.0,1,1,0
UG,CH,2006.0,1,1,0
AU,UY,2007.0,1,1,0
AU,VN,1998.0,3,1,2
ES,PA,1999.0,2,4,-2
ZW,IN,2021.0,1,3,-2
FR,TG,2012.0,2,3,-1
RS,CH,2001.0,2,2,0
US,CW,2009.0,1,3,-2
MD,DE,2015.0,3,4,-1
RU,KZ,2006.0,3,6,-3
PY,UY,2014.0,3,1,2
GH,CH,2017.0,3,3,0
RS,NL,2006.0,5,3,2
KW,PK,2019.0,2,3,-1
MX,NZ,1998.0,1,1,0
XK,RS,2015.0,10,8,2
AU,EG,1999.0,2,1,1
CA,HR,2007.0,3,5,-2
DE,PK,2004.0,6,8,-2
MW,DE,2017.0,5,3,2
SV,US,2016.0,3,4,-1
IN,KE,2011.0,7,2,5
DE,NP,2021.0,3,3,0
GH,NZ,2021.0,2,2,0
SY,MA,2021.0,4,3,1
LU,FR,2001.0,7,6,1
AE,DZ,2016.0,2,1,1
HR,IE,2002.0,5,2,3
ZA,TW,2019.0,1,5,-4
GB,TZ,2001.0,1,1,0
TR,NZ,2014.0,2,2,0
SK,FR,2018.0,6,5,1
KW,CA,2013.0,4,11,-7
GB,MM,2014.0,1,1,0
JO,CA,2015.0,6,14,-8
SI,GB,2004.0,4,7,-3
IN,BT,2017.0,2,1,1
CA,MK,2015.0,3,1,2
FR,UG,2012.0,3,6,-3
CA,LT,2020.0,2,3,-1
UY,US,2005.0,10,13,-3
DE,GE,2005.0,1,2,-1
CO,KE,2020.0,3,6,-3
ID,CL,2008.0,1,2,-1
PE,NZ,2018.0,2,2,0
KW,DE,2011.0,1,2,-1
BH,JP,2012.0,2,1,1
CM,CN,2020.0,2,3,-1
GT,ES,2013.0,5,14,-9
AE,AT,2022.0,2,1,1
IN,UA,2013.0,3,8,-5
ZA,UG,2008.0,4,6,-2
DE,SY,2010.0,3,1,2
QA,SD,2015.0,2,2,0
MY,CH,2011.0,2,5,-3
IE,ZA,2016.0,2,6,-4
JP,CY,2022.0,1,1,0
PE,FR,2011.0,2,8,-6
SA,AT,2018.0,2,1,1
CL,PA,2008.0,2,2,0
FI,MX,2011.0,2,2,0
KR,SK,2006.0,1,1,0
ID,GH,2013.0,2,1,1
MX,PK,2005.0,1,2,-1
CO,FR,2002.0,6,8,-2
NZ,IL,2013.0,3,2,1
IN,ML,2018.0,2,7,-5
PH,CZ,2020.0,1,2,-1
YE,TW,2019.0,1,1,0
CN,LB,2005.0,4,7,-3
CG,MA,2013.0,2,1,1
GR,RS,1998.0,1,1,0
GH,CI,2021.0,1,1,0
US,NI,2018.0,6,7,-1
nan,CL,2006.0,1,1,0
PT,CM,2015.0,1,2,-1
CM,GB,2009.0,5,1,4
KR,PH,2012.0,2,6,-4
PY,VE,2003.0,1,3,-2
CM,IT,2009.0,1,2,-1
ZM,GH,2008.0,3,4,-1
SN,CA,2013.0,4,2,2
GB,GT,2015.0,3,1,2
NI,CO,2008.0,1,1,0
US,FO,2011.0,1,1,0
FR,PY,2016.0,1,2,-1
LU,ZA,2022.0,2,1,1
RO,NO,2013.0,1,4,-3
LS,GB,2017.0,1,1,0
DK,ET,2017.0,4,2,2
SK,NO,2020.0,3,1,2
JO,ES,2013.0,1,2,-1
UA,TJ,2015.0,4,1,3
RO,NL,2007.0,2,9,-7
PA,MX,2007.0,5,6,-1
PL,MN,2019.0,2,1,1
MT,FR,2017.0,2,3,-1
PS,IR,2008.0,1,1,0
MA,GP,2017.0,1,1,0
ET,EG,2022.0,2,3,-1
SK,BY,2018.0,2,3,-1
ZA,TW,2010.0,3,3,0
UA,AT,2014.0,7,5,2
OM,BD,2022.0,3,3,0
CA,BJ,2021.0,2,2,0
FR,BG,2021.0,2,1,1
CL,PT,2002.0,1,3,-2
CL,GR,2019.0,1,1,0
DE,BW,1999.0,1,1,0
MA,MD,2010.0,4,8,-4
PG,AU,2012.0,9,9,0
PT,HR,2019.0,3,2,1
RO,IT,2005.0,8,8,0
BE,CW,2010.0,3,2,1
NA,SE,2013.0,1,1,0
AU,RS,1999.0,1,1,0
EG,TW,2008.0,1,2,-1
BR,NI,2016.0,2,3,-1
TW,PK,2013.0,3,1,2
CA,TN,2004.0,4,3,1
BR,RU,2004.0,6,6,0
NA,AU,2012.0,1,2,-1
BJ,US,2009.0,3,1,2
ZW,RU,2011.0,3,9,-6
PT,NO,1999.0,2,1,1
AT,UA,2015.0,3,9,-6
nan,AT,1998.0,3,7,-4
NL,VG,2017.0,1,1,0
VN,RU,2009.0,2,1,1
DK,AE,2020.0,2,2,0
PH,SG,2003.0,2,4,-2
HU,CN,2016.0,4,6,-2
TW,ES,2005.0,1,1,0
TZ,ES,2012.0,1,1,0
CL,SV,2003.0,1,1,0
GH,CH,2019.0,2,2,0
IN,UG,2018.0,1,5,-4
SK,SE,2014.0,1,4,-3
ZA,RW,2016.0,5,6,-1
NG,EG,2015.0,5,3,2
FI,SK,2010.0,1,1,0
BO,JP,2020.0,2,1,1
ID,DZ,2018.0,1,4,-3
CU,DE,2000.0,1,3,-2
AT,BF,2017.0,1,1,0
NG,BW,2013.0,3,1,2
DE,ME,2011.0,2,1,1
MK,US,2003.0,1,2,-1
AL,FR,2019.0,1,3,-2
BA,IE,2014.0,1,2,-1
SC,GB,2010.0,2,1,1
IQ,RU,2021.0,4,6,-2
FR,NG,1999.0,1,1,0
CA,BB,2008.0,1,1,0
PE,NI,2022.0,1,1,0
PK,PL,2002.0,1,1,0
CN,ET,2008.0,4,3,1
AR,PY,2014.0,7,4,3
US,NC,2015.0,3,2,1
FI,KR,1998.0,1,1,0
NZ,AE,2021.0,4,1,3
CN,MO,2010.0,1,1,0
HK,NL,1998.0,1,3,-2
PH,HR,2018.0,1,1,0
LK,ES,2011.0,1,5,-4
CA,SK,1999.0,1,3,-2
PH,NL,2006.0,2,2,0
GH,SG,2015.0,1,1,0
GB,KH,2014.0,1,2,-1
PT,CH,2003.0,2,7,-5
RO,nan,2013.0,2,1,1
PS,SD,2016.0,1,1,0
IQ,SE,2011.0,1,5,-4
BE,SI,2021.0,3,4,-1
nan,CU,2016.0,1,4,-3
BR,UY,1997.0,2,5,-3
CR,JP,2015.0,1,5,-4
BY,UZ,2018.0,1,2,-1
PK,IR,2005.0,2,1,1
BE,NO,1997.0,1,2,-1
SE,LK,2012.0,6,1,5
PH,TR,2010.0,2,1,1
GB,VN,2008.0,1,7,-6
DE,BY,2012.0,6,5,1
AE,NG,2016.0,1,1,0
AU,SK,2002.0,1,1,0
MA,NL,2013.0,1,2,-1
RU,SG,2016.0,2,7,-5
TZ,SE,2019.0,4,6,-2
VN,ZA,2022.0,1,1,0
PT,EG,2021.0,4,1,3
CH,CL,2001.0,3,1,2
MY,GR,2011.0,1,2,-1
HR,IE,2005.0,2,4,-2
DK,LT,2021.0,5,2,3
MY,BA,2016.0,3,2,1
CH,EG,2007.0,2,2,0
PT,LU,2016.0,1,1,0
RO,IQ,2015.0,2,1,1
IN,IS,2017.0,1,2,-1
GB,CN,2013.0,561,494,67
FR,AT,2014.0,56,37,19
DE,PH,2015.0,9,8,1
NL,AU,2011.0,83,56,27
CH,GB,2018.0,378,342,36
NZ,AU,1999.0,62,56,6
TN,MA,2016.0,44,34,10
GB,IN,2013.0,493,347,146
ES,CO,2017.0,664,565,99
IN,AE,2019.0,118,58,60
KR,nan,1999.0,5,20,-15
AU,US,2002.0,1302,1123,179
BR,ES,2018.0,394,490,-96
HU,SK,2019.0,17,12,5
ZA,US,2006.0,202,254,-52
JP,ID,2015.0,215,63,152
LU,US,2015.0,20,24,-4
EC,ES,2017.0,107,222,-115
ES,CO,2010.0,292,272,20
NG,US,2014.0,65,75,-10
DE,JP,2005.0,156,144,12
GB,ZA,1998.0,52,45,7
NL,ZA,2001.0,15,9,6
IN,AE,2010.0,16,7,9
US,LK,2019.0,53,33,20
IR,AU,2021.0,137,66,71
CZ,SI,2019.0,6,4,2
CN,UA,2018.0,17,39,-22
DE,SY,2017.0,2,2,0
PK,PE,2017.0,1,2,-1
BG,RU,2007.0,8,14,-6
DE,SK,2019.0,47,36,11
VN,JP,2018.0,40,87,-47
AT,ES,2018.0,34,34,0
GB,NG,2005.0,10,12,-2
SE,IS,2015.0,25,15,10
RO,CH,2017.0,22,14,8
FI,NO,2002.0,12,3,9
NL,US,2002.0,405,402,3
TW,CA,2015.0,44,38,6
IN,RW,2010.0,3,5,-2
PK,KE,2019.0,10,35,-25
AR,UY,2015.0,35,40,-5
CR,CU,2013.0,22,16,6
IT,CM,2021.0,8,4,4
CO,NL,2020.0,22,19,3
ES,PY,2022.0,10,8,2
JP,IR,2018.0,23,19,4
NL,PT,2011.0,21,17,4
CO,AT,2022.0,1,1,0
EG,CN,2021.0,45,58,-13
TR,RU,2000.0,2,5,-3
MN,JP,2012.0,4,7,-3
NL,RU,2019.0,61,45,16
IL,NZ,2017.0,4,1,3
CA,NG,2015.0,12,5,7
HK,JP,2003.0,16,2,14
US,GR,1998.0,106,68,38
QA,TN,2018.0,4,9,-5
IT,IR,2004.0,5,2,3
IT,SG,2015.0,18,7,11
FI,PK,2022.0,4,4,0
PK,KE,2010.0,7,10,-3
nan,IL,2012.0,24,15,9
TZ,US,2020.0,20,28,-8
CO,VE,2000.0,10,9,1
IR,ES,2012.0,10,10,0
AT,LI,2021.0,2,4,-2
CN,QA,2015.0,29,16,13
JP,NG,2006.0,7,2,5
SG,DE,2009.0,25,49,-24
IT,PT,2023.0,4,2,2
CU,CO,2003.0,17,8,9
PL,JP,2020.0,11,15,-4
SG,GB,2001.0,35,39,-4
ZA,CZ,2019.0,7,7,0
KR,AU,2015.0,48,41,7
HU,RS,2021.0,4,5,-1
AU,PT,2004.0,5,4,1
RU,JO,2020.0,2,1,1
CA,FI,2003.0,9,14,-5
PK,ZA,2021.0,5,8,-3
HU,PL,2022.0,14,24,-10
IN,IT,1999.0,19,24,-5
SE,FR,2020.0,70,109,-39
BE,GB,2008.0,103,116,-13
IL,NZ,2010.0,2,2,0
DE,PT,2006.0,25,27,-2
RS,IN,2020.0,3,2,1
MK,IT,2020.0,1,2,-1
MX,AU,2013.0,17,12,5
AE,AU,2006.0,5,4,1
US,GH,2006.0,8,8,0
CA,NO,2011.0,24,21,3
US,LK,2017.0,38,37,1
DK,TH,2014.0,2,1,1
JP,UA,1997.0,4,3,1
NI,ES,2021.0,7,2,5
GE,DE,2011.0,5,6,-1
LV,FR,2018.0,1,3,-2
nan,ID,2016.0,69,29,40
CZ,NL,2000.0,3,4,-1
SN,CH,2016.0,4,2,2
PK,CA,2009.0,17,17,0
HU,GR,2013.0,2,3,-1
MK,AT,2020.0,11,22,-11
PT,BE,2013.0,9,12,-3
DE,SY,2019.0,6,8,-2
CH,IR,2011.0,13,17,-4
PK,KE,2017.0,13,21,-8
CH,NO,2012.0,26,24,2
US,ID,2002.0,14,15,-1
CH,HU,1997.0,6,10,-4
LT,NL,2006.0,2,2,0
HU,AM,2013.0,1,1,0
LT,CZ,2016.0,4,3,1
MY,ES,2009.0,2,2,0
IL,NZ,2019.0,1,2,-1
ES,AT,1998.0,2,7,-5
RO,NG,2020.0,1,1,0
BR,PH,2015.0,9,6,3
CH,KR,2007.0,9,8,1
GR,KZ,2016.0,3,1,2
JO,AE,2023.0,3,2,1
TW,ES,2002.0,2,6,-4
HU,RU,2006.0,7,8,-1
BG,MK,2008.0,4,1,3
LB,IN,2020.0,8,5,3
MA,BE,2021.0,3,7,-4
BD,AU,2004.0,7,3,4
nan,NG,2022.0,7,10,-3
BE,ET,2015.0,9,7,2
OM,QA,2016.0,3,2,1
AZ,DE,2012.0,2,1,1
SE,RO,2009.0,5,7,-2
CL,SE,2010.0,3,2,1
PH,FR,2014.0,10,3,7
KE,nan,2019.0,3,7,-4
BE,BR,1997.0,11,7,4
PA,BR,2010.0,1,1,0
IE,BE,2001.0,4,2,2
NL,CZ,1998.0,4,5,-1
SK,HU,2006.0,7,9,-2
BD,BN,2016.0,3,1,2
ET,BD,2014.0,1,1,0
FR,PS,2005.0,1,2,-1
GB,SS,2011.0,10,9,1
nan,CH,2001.0,4,7,-3
EE,KR,2020.0,1,4,-3
CR,BR,2009.0,4,4,0
DE,CL,1997.0,7,4,3
EG,SY,2016.0,4,5,-1
TR,PT,2013.0,2,5,-3
KW,CN,2015.0,1,1,0
BF,ML,2018.0,5,7,-2
ES,AE,2009.0,2,1,1
LU,VN,2021.0,3,1,2
CM,CF,2020.0,1,1,0
MM,TR,2019.0,2,8,-6
MM,CA,2015.0,1,1,0
AR,PL,2022.0,1,4,-3
CL,NO,2016.0,3,3,0
LT,SE,2007.0,1,4,-3
FI,NO,2005.0,4,12,-8
US,CD,2013.0,2,3,-1
SC,GB,2019.0,2,2,0
MA,MX,2018.0,3,1,2
VE,UY,2011.0,2,1,1
MW,KE,2021.0,3,1,2
DZ,QA,2018.0,2,1,1
UG,NL,2003.0,1,1,0
BE,RW,2015.0,1,1,0
NG,GH,2006.0,2,1,1
AT,OM,2016.0,1,1,0
KZ,SA,2019.0,1,3,-2
MW,DE,2010.0,3,1,2
GR,QA,2021.0,3,1,2
SI,US,1997.0,5,14,-9
RO,LK,2016.0,1,1,0
NP,PK,2012.0,3,2,1
EG,SG,2015.0,2,3,-1
CH,TW,2014.0,3,14,-11
BR,LU,2017.0,1,5,-4
GB,UY,2017.0,4,5,-1
CH,FR,2002.0,204,237,-33
AL,CN,2015.0,3,2,1
UA,CN,1997.0,5,9,-4
GB,CO,2013.0,24,27,-3
RO,CH,2019.0,14,10,4
nan,AU,2011.0,32,51,-19
CN,IT,1999.0,9,17,-8
RU,PT,2022.0,7,12,-5
VN,SA,2017.0,1,1,0
EG,CH,2011.0,4,6,-2
SE,LT,2021.0,7,9,-2
FR,TW,1999.0,10,6,4
NO,PL,2021.0,4,10,-6
US,,2016.0,61730,0,61730
CN,,2015.0,62891,0,62891
,DE,1999.0,15414,0,15414
GB,,2020.0,19413,0,19413
,AT,1994.0,5393,0,5393
EG,,2020.0,2958,0,2958
,MX,2010.0,5022,0,5022
,CN,2016.0,43084,0,43084
,BR,2005.0,14742,0,14742
BE,,2003.0,698,0,698
,BR,2002.0,11282,0,11282
,MD,2006.0,84,0,84
,CH,2004.0,3283,0,3283
,KR,2009.0,5868,0,5868
JP,,1999.0,5004,0,5004
ID,,2022.0,24346,0,24346
SG,,2015.0,797,0,797
GR,,2021.0,3506,0,3506
EC,,2022.0,1971,0,1971
,UY,2001.0,191,0,191
FR,,2006.0,4736,0,4736
,AR,2012.0,2538,0,2538
,EG,1995.0,1281,0,1281
NI,NL,2016.0,1,0,1
ET,,2020.0,458,0,458
DK,,2002.0,331,0,331
AU,,2013.0,3391,0,3391
BR,,2026.0,402,0,402
BD,,2024.0,5489,0,5489
,JO,1995.0,202,0,202
,CH,1996.0,3828,0,3828
LK,LA,2012.0,1,0,1
DK,,2005.0,410,0,410
,ES,2016.0,10692,0,10692
TR,,2011.0,1463,0,1463
,BD,1994.0,236,0,236
,DZ,2012.0,1479,0,1479
AT,,2004.0,552,0,552
JP,AE,2011.0,3,0,3
FI,,2012.0,1117,0,1117
MY,,2012.0,402,0,402
,AE,2004.0,121,0,121
,BY,2010.0,313,0,313
,RW,2011.0,65,0,65
SE,,2004.0,956,0,956
,MX,2017.0,4910,0,4910
VE,NI,2017.0,1,0,1
,BG,2008.0,445,0,445
LK,,2014.0,122,0,122
,TH,2001.0,1032,0,1032
,ET,1995.0,174,0,174
AT,BG,2000.0,2,0,2
HU,VN,2014.0,2,0,2
,LK,2002.0,109,0,109
PA,HN,2009.0,6,0,6
RW,DE,2014.0,1,0,1
,ZA,2015.0,2578,0,2578
,MK,2015.0,161,0,161
,GP,2010.0,35,0,35
,LY,2007.0,25,0,25
,HN,2012.0,54,0,54
BW,,2018.0,68,0,68
,GE,2014.0,248,0,248
BG,,2016.0,374,0,374
,SE,2018.0,2238,0,2238
MN,,2020.0,100,0,100
,CG,2014.0,51,0,51
SI,,2021.0,799,0,799
UG,,2025.0,86,0,86
BF,,2024.0,506,0,506
nan,,2004.0,166,0,166
LT,VE,2015.0,3,0,3
TH,ET,2019.0,2,0,2
ML,,2017.0,24,0,24
,PA,2014.0,89,0,89
ZM,,2014.0,23,0,23
PA,,2010.0,20,0,20
AE,QA,1998.0,1,0,1
SA,,2003.0,132,0,132
NI,VE,2011.0,1,0,1
,FJ,2014.0,46,0,46
LY,,2022.0,177,0,177
BN,,2025.0,31,0,31
ML,,2019.0,44,0,44
RW,GB,2013.0,2,0,2
IN,TN,2021.0,5,0,5
UY,,2009.0,46,0,46
BY,,2014.0,211,0,211
LK,NO,2013.0,4,0,4
LB,,2003.0,28,0,28
,MG,1999.0,24,0,24
,MX,2019.0,1771,0,1771
PA,,2017.0,56,0,56
,LK,2005.0,189,0,189
,ML,2015.0,61,0,61
PA,,2019.0,95,0,95
BJ,CI,2021.0,3,0,3
ZA,HR,2007.0,1,0,1
PS,JP,2017.0,2,0,2
GB,BI,2020.0,1,0,1
MY,CM,2016.0,5,0,5
,AE,1996.0,108,0,108
CY,DK,2015.0,1,0,1
ZW,,2001.0,15,0,15
,BY,2017.0,481,0,481
,YE,2016.0,66,0,66
TN,CI,2018.0,1,0,1
,JM,2014.0,50,0,50
AU,GE,2002.0,1,0,1
TJ,,2012.0,19,0,19
PS,,2019.0,91,0,91
,NA,1994.0,7,0,7
,NI,2019.0,13,0,13
LY,GR,2020.0,3,0,3
,KZ,2020.0,31,0,31
UG,DZ,2016.0,1,0,1
,GP,2017.0,10,0,10
NO,,2006.0,332,0,332
,KG,2015.0,45,0,45
,BY,2019.0,252,0,252
,NZ,2018.0,919,0,919
IS,,2021.0,201,0,201
,NI,2017.0,129,0,129
CA,TZ,2001.0,1,0,1
IS,CH,2022.0,2,0,2
NG,,2026.0,4,0,4
,AG,1996.0,6,0,6
GR,BG,2013.0,4,0,4
BA,PT,2016.0,1,0,1
,MT,1995.0,27,0,27
EE,,2009.0,105,0,105
CA,MM,2017.0,2,0,2
PS,,2017.0,49,0,49
,PW,1997.0,3,0,3
KE,AE,2013.0,2,0,2
LR,,2019.0,9,0,9
GY,,2015.0,2,0,2
JP,BO,2015.0,3,0,3
PK,PE,2019.0,1,0,1
CM,KE,2000.0,1,0,1
MY,CY,2017.0,3,0,3
NI,EC,2022.0,1,0,1
,EC,1997.0,45,0,45
,GF,2011.0,14,0,14
UZ,,2007.0,37,0,37
,EC,1998.0,75,0,75
,NE,1995.0,20,0,20
CY,,1999.0,7,0,7
CA,MA,2023.0,1,0,1
AU,AM,2022.0,1,0,1
CM,BW,2018.0,3,0,3
SY,PL,2020.0,1,0,1
CN,JO,2014.0,2,0,2
,TG,1999.0,14,0,14
PY,CO,2008.0,2,0,2
,PY,2003.0,24,0,24
PT,GE,2019.0,1,0,1
LB,TR,2014.0,2,0,2
ET,PH,2021.0,2,0,2
TR,LT,2012.0,2,0,2
GR,EG,2018.0,4,0,4
SD,,2011.0,30,0,30
,HK,2000.0,15,0,15
CM,,2005.0,11,0,11
KE,FI,2007.0,1,0,1
TT,TR,2019.0,1,0,1
,GP,2019.0,5,0,5
,GL,2018.0,3,0,3
GE,CH,2009.0,1,0,1
AR,NZ,2002.0,2,0,2
FJ,ZM,2022.0,1,0,1
,LU,1999.0,29,0,29
AU,CR,2013.0,1,0,1
KE,NO,2018.0,3,0,3
,XK,2009.0,79,0,79
,TJ,2000.0,17,0,17
FR,GM,2021.0,3,0,3
CA,PR,2014.0,1,0,1
DZ,SA,2006.0,2,0,2
PH,,1998.0,45,0,45
RE,GB,2018.0,1,0,1
HR,ZA,2005.0,1,0,1
TZ,,2007.0,24,0,24
BR,ID,2010.0,3,0,3
MY,SA,2023.0,4,0,4
AR,GH,2014.0,1,0,1
EC,CA,2009.0,1,0,1
,NI,2010.0,20,0,20
SD,ID,2013.0,1,0,1
NO,NI,2010.0,1,0,1
CN,SK,2001.0,3,0,3
FR,MK,2014.0,1,0,1
EC,CH,2007.0,1,0,1
MN,CN,2007.0,3,0,3
CZ,CU,1998.0,1,0,1
RO,HR,2021.0,1,0,1
JM,BH,2015.0,1,0,1
PL,VN,2011.0,2,0,2
CN,LB,2002.0,1,0,1
PS,,2010.0,12,0,12
AE,ID,2006.0,1,0,1
OM,MM,2020.0,1,0,1
AU,BO,1999.0,1,0,1
IT,TW,2000.0,2,0,2
PL,EC,2015.0,1,0,1
VA,US,2000.0,1,0,1
AG,DE,2022.0,2,0,2
,LI,2019.0,5,0,5
BE,LT,2009.0,1,0,1
IR,BE,2000.0,2,0,2
VE,PK,2015.0,1,0,1
NZ,PA,2014.0,1,0,1
,BJ,1998.0,28,0,28
SG,KZ,2007.0,1,0,1
PG,,1998.0,6,0,6
VE,BE,2015.0,4,0,4
CR,NL,2021.0,3,0,3
IS,IE,2000.0,1,0,1
GR,MA,2012.0,1,0,1
MD,nan,2004.0,1,0,1
AT,CY,2010.0,1,0,1
SI,IN,2002.0,2,0,2
DE,CI,2013.0,2,0,2
AM,FR,2007.0,3,0,3
QA,UA,2015.0,1,0,1
IT,SN,2013.0,1,0,1
KR,LK,2007.0,2,0,2
GA,,2012.0,13,0,13
OM,SG,2015.0,2,0,2
TN,PT,2020.0,3,0,3
,CM,2020.0,23,0,23
PA,AR,2001.0,3,0,3
ES,TZ,2008.0,1,0,1
BE,IS,2016.0,2,0,2
KW,CZ,2007.0,1,0,1
,GT,1995.0,13,0,13
,AF,1995.0,2,0,2
RS,BY,2014.0,1,0,1
nan,MC,2014.0,1,0,1
BG,NZ,2008.0,2,0,2
AT,LU,2009.0,1,0,1
SG,CL,2018.0,3,0,3
SV,,2015.0,11,0,11
DK,LB,2015.0,1,0,1
CF,CO,2006.0,1,0,1
OM,IE,2005.0,1,0,1
RS,NO,2003.0,1,0,1
ZM,BR,2005.0,5,0,5
IQ,JO,2005.0,1,0,1
KH,PH,2011.0,1,0,1
AR,RU,2007.0,1,0,1
QA,,2001.0,6,0,6
ES,MT,1997.0,1,0,1
JO,BD,2019.0,1,0,1
CM,,2002.0,8,0,8
IL,LB,2013.0,1,0,1
GD,,2011.0,4,0,4
HN,AR,2007.0,2,0,2
BR,EC,2000.0,2,0,2
HR,ME,2013.0,2,0,2
CI,CD,2017.0,2,0,2
AW,US,2020.0,1,0,1
,LT,2020.0,26,0,26
BD,BH,2022.0,1,0,1
LB,KR,2022.0,1,0,1
DK,ET,2019.0,6,0,6
,MR,2005.0,8,0,8
CH,IS,2020.0,3,0,3
IT,GT,2011.0,1,0,1
,LI,2010.0,8,0,8
PR,US,2013.0,3,0,3
KR,CO,2009.0,7,0,7
TR,MA,2016.0,2,0,2
TT,VE,2004.0,1,0,1
,BJ,1997.0,14,0,14
SG,SY,2015.0,1,0,1
BA,DK,2019.0,1,0,1
,LI,2017.0,7,0,7
AU,MM,2016.0,3,0,3
ES,KE,2004.0,2,0,2
BF,CM,2012.0,1,0,1
YE,BH,2004.0,1,0,1
CA,AM,2009.0,1,0,1
SI,IE,2011.0,1,0,1
IL,PS,2004.0,2,0,2
CH,TZ,1998.0,1,0,1
SG,PL,2015.0,8,0,8
,SJ,2000.0,3,0,3
LA,NL,2011.0,1,0,1
RS,AU,1997.0,1,0,1
BE,BJ,2012.0,2,0,2
IT,TZ,2007.0,1,0,1
FI,LU,2000.0,1,0,1
DE,UG,2007.0,1,0,1
CM,UG,2009.0,1,0,1
GB,AE,1997.0,2,0,2
NA,,2011.0,7,0,7
IT,LK,2001.0,1,0,1
,CF,2004.0,7,0,7
GL,,2012.0,2,0,2
NE,SN,2004.0,2,0,2
EC,PH,2003.0,1,0,1
UY,IL,2015.0,2,0,2
CU,NI,2012.0,1,0,1
GE,IL,1999.0,1,0,1
NL,GD,2011.0,1,0,1
DK,UG,2011.0,1,0,1
LK,MX,2017.0,1,0,1
LT,IN,2009.0,2,0,2
JO,MY,2000.0,2,0,2
AU,BW,2021.0,1,0,1
NP,SE,2015.0,1,0,1
BH,KR,2005.0,1,0,1
ID,MX,2011.0,3,0,3
VE,BO,2015.0,2,0,2
GP,BR,2014.0,1,0,1
LV,CA,2001.0,1,0,1
BO,CR,2006.0,2,0,2
DO,,2004.0,4,0,4
GT,IT,2019.0,1,0,1
BF,BI,2022.0,1,0,1
LA,LU,2020.0,1,0,1
ZW,PA,2016.0,1,0,1
CA,BI,2015.0,1,0,1
NG,GY,2023.0,1,0,1
PH,NO,2014.0,1,0,1
NG,VG,2019.0,1,0,1
BF,AE,2017.0,1,0,1
IS,AU,2000.0,1,0,1
PL,ET,2008.0,1,0,1
ML,,2010.0,12,0,12
JP,VG,2006.0,1,0,1
AR,SI,2014.0,2,0,2
BE,CW,2019.0,1,0,1
BW,AU,2014.0,2,0,2
FR,MG,1997.0,1,0,1
PF,,2004.0,1,0,1
MR,SN,2021.0,1,0,1
TH,KE,2000.0,3,0,3
KE,LK,2017.0,1,0,1
DZ,MC,2019.0,1,0,1
CU,EC,2005.0,1,0,1
ML,MW,2013.0,1,0,1
PH,PT,2006.0,1,0,1
MO,PT,2001.0,1,0,1
XK,SI,2015.0,2,0,2
LR,,2010.0,2,0,2
MD,SE,2021.0,1,0,1
ER,SE,2006.0,1,0,1
AR,VA,2009.0,1,0,1
UZ,RS,2006.0,5,0,5
VN,ES,2005.0,1,0,1
,LR,2006.0,3,0,3
,MR,2002.0,3,0,3
IR,IQ,2014.0,7,0,7
JP,HK,2010.0,12,0,12
LU,CL,2019.0,1,0,1
FI,BY,2007.0,1,0,1
NO,KE,2009.0,2,0,2
HN,PE,2011.0,1,0,1
FR,BZ,2017.0,1,0,1
LV,KR,2015.0,1,0,1
,LA,1995.0,2,0,2
ER,NL,2005.0,1,0,1
KE,BW,2012.0,1,0,1
MY,RO,2009.0,1,0,1
IL,DZ,2015.0,1,0,1
FI,NA,2016.0,1,0,1
LT,CA,2016.0,2,0,2
PG,MY,2016.0,1,0,1
MY,SD,1998.0,2,0,2
BE,BW,2020.0,2,0,2
BE,LB,2014.0,6,0,6
ZW,SE,2004.0,2,0,2
BR,AM,2008.0,1,0,1
DK,ET,2010.0,2,0,2
US,MQ,2019.0,2,0,2
PH,GT,1999.0,3,0,3
BD,KR,1999.0,2,0,2
ML,GR,2007.0,1,0,1
VG,BR,2002.0,1,0,1
BR,RO,2005.0,1,0,1
KE,NA,2018.0,2,0,2
RU,TN,2012.0,2,0,2
BD,TZ,2010.0,1,0,1
,AG,2004.0,2,0,2
IL,KW,2011.0,1,0,1
AU,ZW,2018.0,3,0,3
CI,AT,2007.0,1,0,1
RW,CN,2006.0,2,0,2
NE,,2012.0,3,0,3
AZ,HU,2019.0,2,0,2
TR,KG,2012.0,2,0,2
GN,BD,2019.0,1,0,1
CN,GT,2017.0,1,0,1
VN,BY,1999.0,2,0,2
SN,IN,2002.0,1,0,1
TH,LK,2003.0,1,0,1
BG,IE,2007.0,2,0,2
BO,BJ,2009.0,1,0,1
KH,GT,2014.0,1,0,1
BE,KH,2001.0,1,0,1
LY,TR,2019.0,1,0,1
PG,JM,2001.0,1,0,1
GR,PL,2019.0,6,0,6
NG,CN,2006.0,4,0,4
KW,KG,2023.0,1,0,1
DZ,MM,2014.0,1,0,1
VN,ID,2012.0,1,0,1
QA,PL,2021.0,1,0,1
NG,GN,2018.0,2,0,2
CN,LS,2018.0,1,0,1
FR,PS,2002.0,1,0,1
AM,AR,2015.0,1,0,1
TH,EG,2018.0,1,0,1
BA,CA,1997.0,1,0,1
,JE,1997.0,2,0,2
JP,SD,2011.0,3,0,3
DE,JE,2010.0,1,0,1
IT,FJ,2017.0,1,0,1
IT,FJ,2019.0,1,0,1
MX,ID,2023.0,1,0,1
TZ,GB,1998.0,3,0,3
ZA,KZ,2017.0,1,0,1
CU,VN,2014.0,1,0,1
NO,PH,2012.0,1,0,1
PT,SA,2011.0,2,0,2
ES,CI,2006.0,1,0,1
KE,GH,2010.0,2,0,2
BH,PK,2007.0,1,0,1
GM,AU,2003.0,1,0,1
EE,MX,2017.0,1,0,1
GR,PL,2017.0,5,0,5
DK,MW,2010.0,1,0,1
IT,VA,2016.0,2,0,2
BF,ZA,2022.0,1,0,1
DE,GY,2018.0,1,0,1
CR,YE,2016.0,1,0,1
GR,RS,1997.0,2,0,2
IE,HR,2007.0,5,0,5
EC,IT,2007.0,2,0,2
CU,NO,2017.0,1,0,1
BW,GH,2011.0,1,0,1
BN,AU,2007.0,1,0,1
SY,IE,2018.0,1,0,1
AT,CU,2014.0,1,0,1
IL,VE,2000.0,1,0,1
SE,MT,1997.0,1,0,1
LR,,2017.0,1,0,1
BN,CN,2018.0,1,0,1
,MS,1995.0,9,0,9
HR,MX,2001.0,1,0,1
KE,AT,2004.0,1,0,1
SE,ZW,2002.0,1,0,1
ET,GB,2001.0,1,0,1
BR,BJ,2018.0,2,0,2
DK,IE,2001.0,2,0,2
UA,NL,1998.0,2,0,2
NG,ZM,2021.0,3,0,3
SA,IQ,2007.0,4,0,4
CN,MU,2020.0,2,0,2
SY,US,2007.0,3,0,3
BD,QA,2018.0,3,0,3
PT,BY,2021.0,1,0,1
MX,PK,2002.0,2,0,2
HK,HU,2016.0,2,0,2
FI,VE,2010.0,1,0,1
GE,TW,2002.0,1,0,1
RE,IL,2005.0,1,0,1
OM,BN,2017.0,1,0,1
PF,DE,2018.0,1,0,1
US,VU,2007.0,1,0,1
NZ,MD,2021.0,3,0,3
PF,SN,1997.0,1,0,1
TZ,TR,2019.0,1,0,1
GM,,2011.0,3,0,3
LT,NZ,2008.0,1,0,1
GH,AU,2006.0,1,0,1
,GW,2007.0,5,0,5
VN,DK,2007.0,2,0,2
AT,BF,2010.0,1,0,1
ZA,CI,2008.0,1,0,1
MY,UG,2015.0,1,0,1
KE,AR,1997.0,1,0,1
GE,CA,2014.0,2,0,2
ZW,QA,2017.0,1,0,1
VE,DK,2019.0,1,0,1
,CF,1996.0,2,0,2
IQ,TR,2010.0,1,0,1
EG,RO,2020.0,2,0,2
BD,TZ,2019.0,2,0,2
ML,UG,2019.0,1,0,1
MY,SN,2013.0,1,0,1
IN,BH,2001.0,3,0,3
NP,RS,2007.0,1,0,1
FI,IE,2001.0,1,0,1
CM,PK,2017.0,1,0,1
AR,PT,2023.0,2,0,2
,SL,1994.0,9,0,9
JO,BD,2010.0,1,0,1
ID,AE,2012.0,2,0,2
GR,NZ,2006.0,1,0,1
PK,IR,2002.0,1,0,1
JP,PS,2011.0,2,0,2
DE,ML,2001.0,1,0,1
JO,MK,2007.0,1,0,1
BE,EC,2004.0,1,0,1
TT,CN,2018.0,1,0,1
KW,PS,2008.0,1,0,1
FI,KR,1997.0,1,0,1
US,BS,2008.0,2,0,2
DE,NC,2008.0,1,0,1
AU,LB,2007.0,1,0,1
BI,,2025.0,1,0,1
JP,CI,2003.0,1,0,1
NZ,GM,2019.0,1,0,1
GM,NZ,2020.0,1,0,1
BN,CZ,2016.0,1,0,1
DK,UA,2008.0,1,0,1
SE,CF,2014.0,1,0,1
US,UZ,2016.0,2,0,2
VN,MK,2014.0,1,0,1
SE,MX,2023.0,1,0,1
ID,MK,2020.0,1,0,1
PT,CD,2018.0,1,0,1
AM,GR,2021.0,1,0,1
CD,EG,2022.0,1,0,1
IE,IR,2003.0,2,0,2
MC,JO,2001.0,1,0,1
MG,MY,2008.0,1,0,1
SE,SZ,2020.0,1,0,1
CG,,2000.0,1,0,1
DE,TG,2007.0,1,0,1
SV,NI,2005.0,1,0,1
GE,BE,1999.0,1,0,1
NG,SL,2016.0,1,0,1
CD,ZW,2014.0,1,0,1
KW,HU,2015.0,1,0,1
GH,CH,2010.0,1,0,1
HU,TZ,2017.0,1,0,1
BR,DO,2013.0,2,0,2
IT,PS,2011.0,2,0,2
KW,NO,2018.0,1,0,1
VN,KH,2018.0,2,0,2
LS,,2000.0,1,0,1
BH,ZW,2007.0,1,0,1
OM,BR,2013.0,1,0,1
AR,VN,2016.0,2,0,2
KR,NG,2003.0,2,0,2
KR,AE,2010.0,1,0,1
MW,SZ,1999.0,1,0,1
GT,IT,2010.0,1,0,1
PL,MX,2002.0,1,0,1
GB,GD,2011.0,1,0,1
,JE,1998.0,1,0,1
KP,DE,2009.0,1,0,1
MM,PH,2021.0,1,0,1
EE,LK,2018.0,1,0,1
ML,NE,2012.0,1,0,1
PL,MY,2007.0,2,0,2
BH,DE,2013.0,1,0,1
nan,SY,1998.0,1,0,1
HK,IN,2018.0,1,0,1
NG,SY,2000.0,1,0,1
MA,HU,2016.0,2,0,2
VU,HK,2011.0,1,0,1
MS,,1999.0,1,0,1
AR,JO,2005.0,1,0,1
PE,PT,1999.0,1,0,1
GB,CD,2005.0,1,0,1
TD,BJ,2013.0,1,0,1
MW,IL,2016.0,1,0,1
BF,GA,2012.0,2,0,2
SI,IN,2005.0,1,0,1
HK,PT,2015.0,2,0,2
AE,CY,2013.0,1,0,1
SE,TZ,2006.0,1,0,1
CL,ZM,2014.0,1,0,1
IN,CZ,2023.0,2,0,2
CZ,IR,2014.0,2,5,-3
nan,SK,2013.0,2,2,0
TN,SA,2004.0,1,3,-2
BE,CO,2004.0,1,1,0
MA,JP,2008.0,1,2,-1
ID,IL,2018.0,2,9,-7
GB,LV,2009.0,2,1,1
GR,ID,2018.0,3,1,2
GR,AE,2020.0,3,4,-1
PS,PK,2020.0,1,2,-1
RO,LT,2008.0,1,5,-4
LS,GB,2019.0,1,1,0
EG,MA,2007.0,1,2,-1
JP,HR,2019.0,1,2,-1
XK,CH,2016.0,1,1,0
CA,EE,2017.0,1,4,-3
AR,MT,2012.0,2,1,1
NL,KE,1999.0,1,1,0
GH,AL,2015.0,1,2,-1
RO,IT,2002.0,4,5,-1
SD,PK,2016.0,2,1,1
SG,ES,1999.0,1,1,0
PT,KR,2016.0,1,3,-2
GR,TN,2016.0,1,2,-1
SE,AL,2007.0,2,2,0
LT,BE,2017.0,3,1,2
EE,IE,2015.0,1,1,0
SE,TH,2004.0,1,2,-1
TH,SE,2005.0,3,4,-1
SD,NL,2019.0,2,1,1
MX,ZW,2006.0,1,1,0
LV,GB,2013.0,2,1,1
IN,RW,2017.0,3,6,-3
KE,RU,2022.0,2,3,-1
CL,GT,2021.0,5,4,1
TZ,FR,2009.0,3,1,2
GP,SN,2011.0,1,1,0
UA,HU,2008.0,1,1,0
LT,BE,2019.0,1,1,0
ZM,NL,2021.0,1,1,0
ZA,CZ,2010.0,3,1,2
UG,IT,2016.0,1,3,-2
ES,IL,2011.0,4,14,-10
BE,MD,2005.0,2,1,1
BD,MA,2015.0,4,11,-7
PT,JP,1997.0,2,2,0
KZ,SG,2020.0,2,3,-1
MX,SV,2011.0,1,3,-2
AE,ZA,2001.0,1,1,0
TZ,NO,2017.0,2,11,-9
KE,MY,2013.0,1,1,0
VG,AU,2011.0,1,1,0
HU,UA,2008.0,1,1,0
JO,TR,2003.0,1,1,0
KE,FR,1999.0,1,2,-1
CU,HU,2014.0,1,1,0
AU,MT,2021.0,1,3,-2
LT,AM,2017.0,1,1,0
TR,SK,2007.0,1,2,-1
NC,RE,2020.0,3,3,0
JO,OM,2009.0,1,3,-2
IN,BY,2011.0,1,4,-3
NG,KE,2000.0,1,1,0
SN,MA,2017.0,1,1,0
MX,PA,2022.0,5,3,2
JP,SK,2016.0,1,9,-8
LT,EE,2014.0,1,1,0
KE,ID,2009.0,1,3,-2
IN,IS,2010.0,1,3,-2
NG,IL,2020.0,3,2,1
BA,QA,2016.0,2,1,1
BJ,TZ,2015.0,1,1,0
BG,RO,2011.0,1,1,0
AU,TZ,2021.0,1,3,-2
BG,FI,2015.0,1,1,0
GB,PS,2009.0,2,1,1
ZA,CO,2001.0,1,1,0
CO,PY,2022.0,5,3,2
CA,EE,2019.0,1,5,-4
JP,LU,2012.0,1,2,-1
SG,PT,2011.0,1,1,0
SK,IN,2015.0,2,2,0
ES,BG,2014.0,3,2,1
HU,MY,2019.0,1,1,0
NG,AU,2000.0,2,1,1
UA,MZ,2015.0,2,1,1
HN,US,2010.0,2,5,-3
TR,ES,1999.0,2,2,0
SA,GH,2020.0,2,2,0
BN,SG,2007.0,1,1,0
PL,BE,1997.0,2,6,-4
CO,TH,2019.0,1,2,-1
TH,ZM,2020.0,1,1,0
RO,RS,2008.0,1,1,0
BE,CL,2000.0,2,2,0
NO,CL,2014.0,2,1,1
HU,NL,1997.0,2,6,-4
IQ,US,2010.0,2,9,-7
PL,MN,2017.0,1,1,0
TZ,GB,1997.0,1,2,-1
NL,GW,2001.0,1,1,0
JP,MW,2007.0,1,1,0
GY,IN,2016.0,1,1,0
SN,MA,2019.0,2,2,0
OM,JP,2012.0,1,2,-1
RU,PE,2022.0,2,2,0
AU,SD,2018.0,1,1,0
JO,BD,2017.0,1,1,0
ZA,BD,2015.0,1,2,-1
AE,SG,2012.0,2,5,-3
PT,UY,2021.0,2,3,-1
MX,DO,2022.0,1,2,-1
ZA,LS,2016.0,2,5,-3
HU,SI,1998.0,1,1,0
GB,YE,2008.0,1,1,0
LK,SE,2012.0,1,6,-5
IE,HU,1999.0,1,1,0
PT,UA,2012.0,1,4,-3
AE,MY,2008.0,1,2,-1
UG,ZW,2017.0,1,1,0
MA,PT,2023.0,2,3,-1
LK,IN,2003.0,1,1,0
RS,AU,1998.0,2,1,1
SN,NE,2001.0,1,2,-1
UA,BE,2000.0,1,1,0
SG,IT,2008.0,1,2,-1
PS,TR,2016.0,1,2,-1
TR,HR,2012.0,1,5,-4
UA,VN,2014.0,1,1,0
CA,MW,2020.0,1,1,0
DZ,nan,2005.0,1,2,-1
ET,ZA,2010.0,1,1,0
BE,BG,2003.0,1,8,-7
YE,SA,2013.0,1,3,-2
UY,CR,2019.0,1,2,-1
UG,JP,2022.0,1,1,0
SG,FI,2006.0,2,2,0
IE,EG,2006.0,1,1,0
CY,OM,2015.0,1,1,0
DK,RS,2004.0,1,4,-3
GT,BO,2022.0,1,1,0
GB,BM,2005.0,1,1,0
ET,DK,2020.0,1,2,-1
TW,BE,2003.0,1,2,-1
MY,IQ,2009.0,1,4,-3
HR,IN,2007.0,1,1,0
SE,ZW,2005.0,1,1,0
CL,SG,2017.0,1,3,-2
MU,US,2002.0,1,1,0
GB,ZM,2005.0,2,2,0
CH,HR,2003.0,1,7,-6
JO,IT,2020.0,2,3,-1
TN,KE,2013.0,1,1,0
TT,FR,2013.0,1,1,0
IR,SA,2008.0,1,1,0
MA,PL,2021.0,1,1,0
HN,NI,2016.0,1,1,0
PK,TT,2002.0,1,1,0
BW,IN,2009.0,1,4,-3
DE,MW,2008.0,1,1,0
NE,FR,2011.0,2,3,-1
NO,CY,2009.0,1,1,0
ZA,SA,2007.0,1,1,0
PT,DZ,2017.0,1,1,0
MW,BE,2016.0,1,1,0
MT,ES,2021.0,1,2,-1
IL,BY,2013.0,1,1,0
IT,KE,2004.0,1,1,0
ID,VE,2015.0,1,2,-1
AT,GE,2018.0,1,1,0
TW,FI,2017.0,1,2,-1
GE,AT,2018.0,1,1,0
JP,KW,2004.0,2,1,1
LB,MA,2017.0,3,3,0
JM,FR,2001.0,1,2,-1
LB,MA,2019.0,1,2,-1
BD,BR,2018.0,1,2,-1
HK,MY,2018.0,1,1,0
BI,CH,2004.0,1,1,0
MX,CO,2023.0,1,5,-4
LK,ZA,2018.0,1,3,-2
SG,TH,2023.0,1,1,0
GR,NO,2002.0,1,2,-1
UG,UY,2018.0,1,1,0
PT,AR,2011.0,4,11,-7
SY,TN,2018.0,1,1,0
CM,MY,2020.0,1,1,0
AT,TH,2004.0,1,1,0
PH,BE,2007.0,1,1,0
EC,BE,2006.0,1,1,0
RU,HU,2004.0,1,9,-8
KE,CA,1997.0,2,1,1
CZ,HR,2003.0,3,3,0
TZ,NG,2007.0,2,1,1
DK,MY,2012.0,1,6,-5
IL,JO,1998.0,1,0,1
HU,SG,2022.0,1,0,1
DZ,JP,2002.0,1,0,1
CD,TZ,2022.0,2,0,2
FR,BZ,2019.0,1,0,1
TW,ZA,2014.0,3,0,3
SK,IE,1997.0,1,0,1
CO,PK,2020.0,1,0,1
DE,ZM,2021.0,2,0,2
UY,CR,2010.0,1,0,1
TH,MO,2011.0,1,0,1
HR,LT,2001.0,2,0,2
TH,KZ,2017.0,1,0,1
PA,GR,2017.0,1,0,1
DE,SL,2022.0,1,0,1
VE,SE,1997.0,1,0,1
FI,EE,2023.0,1,0,1
CH,MC,2021.0,2,0,2
SG,HU,2020.0,1,0,1
IE,BW,2017.0,1,0,1
HU,MY,2010.0,1,0,1
GR,JO,2006.0,5,0,5
UY,SA,2013.0,1,0,1
ZM,HU,2020.0,1,0,1
ZM,UG,2021.0,1,0,1
CF,RE,2012.0,1,0,1
NG,SK,2016.0,1,0,1
CI,ZA,2018.0,1,0,1
IT,BA,2018.0,2,0,2
UA,PK,2015.0,1,0,1
HR,MK,2012.0,1,0,1
GT,nan,2011.0,1,0,1
SE,YE,2014.0,1,0,1
VE,SE,1998.0,2,0,2
ET,GY,2018.0,1,0,1
TW,AE,2023.0,1,0,1
ZW,BJ,2009.0,1,0,1
LY,JP,2019.0,1,0,1
CM,GA,2017.0,1,0,1
US,PG,2014.0,2,0,2
EE,BA,2009.0,1,0,1
KZ,TW,2012.0,2,0,2
AT,KE,2008.0,1,0,1
VE,KR,2013.0,2,0,2
BH,TW,2011.0,1,0,1
BJ,SC,2018.0,1,0,1
BN,GR,2014.0,1,0,1
DE,RE,2012.0,1,0,1
BN,BD,2008.0,1,0,1
AM,AZ,2006.0,1,0,1
NA,CA,2015.0,2,0,2
QA,TW,2008.0,1,0,1
GA,BF,2016.0,2,0,2
,TM,1995.0,3,0,3
DZ,UA,2016.0,2,0,2
CL,SI,2018.0,1,0,1
MT,FI,2020.0,1,0,1
IT,GE,2000.0,2,0,2
KP,,2007.0,1,0,1
NZ,TW,1997.0,1,0,1
GB,MD,2007.0,1,0,1
IR,KR,1998.0,2,0,2
MT,LV,2023.0,1,0,1
LB,MW,2018.0,1,0,1
PL,CY,2021.0,1,0,1
BF,MG,2007.0,1,0,1
MZ,DE,2018.0,2,0,2
AZ,HU,2017.0,1,0,1
NG,LT,2019.0,1,0,1
GR,EC,2021.0,2,0,2
DK,CO,2000.0,1,0,1
JO,PL,1998.0,1,0,1
BD,MK,2014.0,2,0,2
TT,NL,2021.0,1,0,1
ZM,CA,2019.0,1,0,1
JP,BW,2013.0,1,0,1
ET,SL,2017.0,1,0,1
CL,CR,2023.0,1,0,1
KR,RS,2014.0,1,0,1
JE,CU,2009.0,1,0,1
AR,NZ,2005.0,1,0,1
IL,CL,1999.0,2,0,2
KZ,GB,2002.0,1,0,1
RW,CD,2014.0,1,0,1
QA,BD,2014.0,1,0,1
CL,SK,2014.0,1,0,1
MA,FI,2010.0,1,0,1
KE,RW,2008.0,1,0,1
NC,NZ,2014.0,1,0,1
TR,LK,2012.0,1,0,1
TZ,UG,2007.0,1,0,1
MT,NL,2003.0,1,0,1
PH,ID,1999.0,1,0,1
BG,TR,2000.0,1,0,1
CU,AU,2000.0,1,0,1
ES,GT,2001.0,1,0,1
SD,NL,2010.0,1,0,1
DE,VN,2023.0,2,0,2
SX,US,2021.0,1,0,1
NO,VG,2015.0,2,0,2
KH,GB,2002.0,1,0,1
SE,LB,2012.0,2,0,2
IQ,VN,2018.0,1,0,1
AM,AT,2005.0,1,0,1
TW,PW,2019.0,1,0,1
TW,AT,2021.0,2,0,2
CI,JP,2013.0,1,0,1
FI,SK,2019.0,1,0,1
US,MQ,2010.0,1,0,1
NO,LB,2014.0,1,0,1
US,JE,2013.0,1,0,1
MD,DK,2020.0,1,0,1
CR,GT,2009.0,1,0,1
IS,AE,2016.0,1,0,1
MR,BI,2008.0,1,0,1
CH,GD,2018.0,1,0,1
CL,SG,2019.0,1,0,1
BE,BN,2007.0,1,0,1
PY,AR,2006.0,1,0,1
KW,IE,2015.0,1,0,1
JP,PG,1997.0,1,0,1
NP,CA,2004.0,3,0,3
MX,AD,2020.0,1,0,1
RS,TN,2018.0,2,0,2
KE,BH,2021.0,1,0,1
VE,KZ,2014.0,1,0,1
CU,NO,2019.0,1,0,1
AU,MV,2020.0,2,0,2
NL,GE,2000.0,1,0,1
TG,GB,2021.0,1,0,1
BE,FI,2023.0,1,0,1
AE,QA,1997.0,1,0,1
CZ,IL,1997.0,2,0,2
CZ,MM,2008.0,1,0,1
LT,BE,2010.0,1,0,1
DZ,NO,2015.0,2,0,2
GE,TR,2007.0,1,0,1
PK,MA,2023.0,1,0,1
TZ,MW,2022.0,1,0,1
EG,IR,2003.0,1,0,1
OM,MY,2006.0,1,0,1
BE,MC,2020.0,1,0,1
EG,GR,2014.0,1,0,1
,WS,2011.0,1,0,1
PR,CR,2015.0,1,0,1
BN,TH,2009.0,2,0,2
SV,CN,2021.0,1,0,1
KZ,SA,2017.0,1,0,1
CN,VE,1997.0,1,0,1
AT,VN,2000.0,1,0,1
MR,LU,2010.0,1,0,1
DK,NI,2021.0,1,0,1
CI,NL,2018.0,1,0,1
MK,FR,2002.0,1,0,1
RO,UA,2005.0,2,0,2
FI,GH,2022.0,1,0,1
VE,CZ,2022.0,1,0,1
MD,AR,2003.0,1,0,1
GN,HR,2019.0,1,0,1
DE,RW,2012.0,1,0,1
SN,SE,2013.0,1,0,1
IT,LV,2007.0,2,0,2
MN,DZ,2008.0,2,0,2
AL,CM,2007.0,1,0,1
JP,EE,2001.0,1,0,1
HR,ZA,2002.0,1,0,1
CZ,RO,2000.0,1,0,1
SA,TZ,2009.0,1,0,1
ET,PR,2010.0,1,0,1
AT,LB,2016.0,1,0,1
BA,CN,2012.0,2,0,2
IT,CY,2004.0,2,0,2
LT,DK,1998.0,1,0,1
PT,EE,2014.0,1,0,1
BD,CZ,2023.0,1,0,1
PL,MX,2005.0,1,0,1
IT,CL,2023.0,1,0,1
RO,IE,2011.0,1,0,1
SN,ZW,2007.0,1,0,1
BB,,2025.0,1,0,1
PH,KE,2019.0,2,0,2
EE,EG,2018.0,1,0,1
CG,US,2015.0,1,0,1
LK,CZ,2017.0,2,0,2
PE,BD,2018.0,1,0,1
GA,CG,2006.0,1,0,1
RS,ZA,2003.0,1,0,1
IE,KN,2014.0,2,0,2
ZW,SS,2016.0,1,0,1
MY,UZ,2021.0,1,0,1
LT,DK,1997.0,1,0,1
FJ,EG,2019.0,1,0,1
CL,TW,1997.0,1,0,1
DZ,EC,2021.0,1,0,1
GW,NO,2005.0,1,0,1
TT,SD,2016.0,1,0,1
FO,GB,2011.0,1,0,1
ID,IE,1999.0,1,0,1
LB,ES,2007.0,1,0,1
PF,NC,2013.0,1,0,1
ZA,HU,2003.0,2,0,2
KR,UZ,2014.0,1,0,1
NE,EE,2021.0,1,0,1
ET,TW,2013.0,1,0,1
NZ,MM,2019.0,1,0,1
BE,ZM,2021.0,1,0,1
PL,QA,2010.0,1,0,1
AM,TW,2010.0,1,0,1
SL,GB,2017.0,2,0,2
BA,AT,2007.0,1,0,1
BN,UG,2019.0,1,0,1
HU,JO,2019.0,1,0,1
SG,RO,2007.0,1,0,1
RU,NZ,1999.0,1,0,1
NC,ID,2019.0,1,0,1
CA,CI,2004.0,1,0,1
AL,PL,2018.0,1,0,1
LV,AM,2016.0,1,0,1
EG,ZA,2008.0,1,0,1
UG,KR,2019.0,1,0,1
PS,PT,2012.0,1,0,1
,KP,2003.0,1,0,1
MA,AF,2019.0,1,0,1
GH,PT,2016.0,1,0,1
NO,GM,2010.0,1,0,1
AZ,AT,2021.0,1,0,1
AR,IN,2023.0,1,0,1
PH,LB,2014.0,1,0,1
GB,NI,1999.0,1,0,1
MY,CY,2019.0,1,0,1
RO,SI,2011.0,1,0,1
SE,GL,2016.0,1,0,1
CH,LA,2020.0,1,0,1
PL,MD,2000.0,1,0,1
FI,TZ,2014.0,1,0,1
,SM,1998.0,1,0,1
PK,MT,2017.0,1,0,1
BN,TW,2017.0,1,0,1
CN,MD,2007.0,1,0,1
DK,SJ,2008.0,1,0,1
HR,CY,2022.0,1,0,1
BN,TW,2010.0,1,0,1
UA,MD,2006.0,1,0,1
PA,IT,2022.0,1,0,1
QA,KE,2021.0,1,0,1
UZ,IN,2006.0,1,0,1
CM,TW,2015.0,1,0,1
TH,KZ,2019.0,1,0,1
KZ,GH,2018.0,1,0,1
MX,nan,2023.0,1,0,1
IS,RU,2023.0,1,0,1
ZM,BW,2015.0,1,0,1
NL,BN,2020.0,2,0,2
ME,DK,2019.0,1,0,1
CY,FR,2009.0,1,0,1
AU,LV,2007.0,1,0,1
PH,CY,2005.0,1,0,1
PL,GH,2019.0,1,0,1
US,BR,2010.0,966,885,81
SG,IN,2018.0,141,176,-35
US,IN,1999.0,452,557,-105
US,CA,2022.0,1874,1900,-26
DZ,IT,2018.0,51,40,11
TW,CN,1997.0,186,114,72
NZ,CN,2011.0,36,24,12
GB,NL,2009.0,243,256,-13
IR,GB,2016.0,107,102,5
AU,GB,2019.0,1471,1657,-186
FR,GB,2016.0,647,571,76
GB,AU,2012.0,1466,1148,318
EC,ES,2018.0,145,243,-98
FR,US,2012.0,1542,1459,83
MX,BE,2014.0,9,11,-2
nan,CH,2003.0,13,10,3
MX,PT,2019.0,33,25,8
CA,FI,2001.0,15,14,1
DE,SK,2018.0,36,38,-2
BR,US,2022.0,873,565,308
SA,TW,2002.0,3,1,2
RU,HU,2014.0,14,7,7
ES,SE,2015.0,104,46,58
CN,BD,2009.0,57,38,19
SG,JP,2021.0,27,24,3
US,CR,2007.0,27,17,10
CN,BR,2014.0,65,47,18
CH,GB,2019.0,339,433,-94
US,ZA,2009.0,276,283,-7
CA,FR,2011.0,493,545,-52
GB,SG,2016.0,159,134,25
US,CN,2023.0,192,865,-673
US,IR,2012.0,238,447,-209
GB,CA,2007.0,703,647,56
GB,KR,2003.0,48,44,4
KR,GB,2008.0,66,89,-23
ES,PH,2013.0,11,11,0
US,RU,2011.0,368,347,21
IT,RO,2016.0,18,22,-4
NP,NZ,2006.0,7,12,-5
US,BR,2019.0,1463,1604,-141
AU,GB,2010.0,1169,1240,-71
ES,CO,2018.0,650,623,27
CA,CH,2002.0,51,44,7
RU,UA,2016.0,318,487,-169
GB,JP,2000.0,194,220,-26
MY,SG,2018.0,128,165,-37
CH,DE,2013.0,711,977,-266
BE,IN,2017.0,40,58,-18
CA,JP,2017.0,114,98,16
CL,AR,2011.0,62,84,-22
US,BR,2017.0,1388,1275,113
DE,BD,2008.0,5,4,1
MX,ES,2011.0,626,604,22
CN,PK,2018.0,202,295,-93
BR,MY,2009.0,59,304,-245
TW,DE,1997.0,10,5,5
GE,US,2002.0,83,80,3
CA,IR,2015.0,177,316,-139
JP,CA,2016.0,122,109,13
SJ,NO,1999.0,3,1,2
NO,US,2021.0,130,169,-39
SE,HR,2007.0,1,1,0
NG,BJ,2003.0,1,2,-1
TR,CH,2012.0,13,16,-3
US,DK,2022.0,180,168,12
FR,CA,2006.0,431,370,61
US,MY,2009.0,112,52,60
SN,FR,2020.0,34,40,-6
SG,GB,2003.0,42,58,-16
IT,ES,2015.0,245,241,4
SV,PE,2020.0,3,1,2
MX,US,2015.0,421,445,-24
nan,IT,2009.0,92,110,-18
MA,IT,2011.0,13,12,1
EC,US,2011.0,19,14,5
BO,US,2009.0,10,6,4
CH,JP,2012.0,71,107,-36
GB,CN,2008.0,489,359,130
FR,MA,2011.0,275,271,4
IL,DE,2022.0,38,33,5
GB,BG,2012.0,10,11,-1
PT,BR,2001.0,203,165,38
BE,IL,1999.0,5,7,-2
BR,ES,2010.0,260,271,-11
CA,SE,1999.0,23,23,0
US,PL,2015.0,277,206,71
DK,BE,2014.0,35,54,-19
GB,TR,1997.0,27,15,12
GB,PT,2010.0,112,65,47
AR,CO,2001.0,17,8,9
CL,US,1997.0,25,39,-14
HR,RS,2012.0,141,105,36
MX,PT,2017.0,27,22,5
ES,DE,2015.0,323,201,122
GB,CL,2019.0,60,59,1
FR,LB,2012.0,84,32,52
US,NL,2006.0,525,531,-6
GB,CL,2017.0,60,53,7
CZ,US,2004.0,106,109,-3
GB,VN,2013.0,7,6,1
BR,nan,2016.0,107,113,-6
BR,PT,2000.0,156,176,-20
IT,VE,2007.0,5,5,0
GB,UY,2018.0,9,6,3
IT,BR,2014.0,289,215,74
KR,VN,2019.0,144,34,110
TW,CN,1998.0,254,150,104
JP,NO,2017.0,14,13,1
IN,AE,2018.0,107,55,52
US,TW,2022.0,367,403,-36
CO,PE,2021.0,82,50,32
MQ,FR,2003.0,5,8,-3
DE,FR,2012.0,523,496,27
US,AE,2021.0,78,75,3
FR,DZ,2020.0,146,124,22
KR,ET,2021.0,100,72,28
HK,US,2021.0,13,8,5
GB,IT,2022.0,379,342,37
BE,NL,2016.0,286,329,-43
IE,FR,2021.0,24,33,-9
PA,CL,2011.0,4,4,0
CH,AU,2011.0,73,85,-12
MY,GB,2013.0,78,207,-129
US,CO,2001.0,57,52,5
ZA,NL,2013.0,31,39,-8
GB,IN,2008.0,258,297,-39
DE,SE,2000.0,86,58,28
MY,ID,2018.0,470,171,299
ES,EC,2012.0,30,26,4
CA,JP,2010.0,117,114,3
VG,GB,2003.0,3,1,2
GB,UG,2022.0,10,18,-8
GE,CA,2004.0,1,3,-2
DE,NL,2022.0,266,227,39
GB,KZ,2020.0,12,3,9
BE,CN,2021.0,56,48,8
BE,GB,2013.0,130,139,-9
ES,JP,2005.0,19,28,-9
US,RS,2012.0,61,39,22
IR,US,2021.0,558,371,187
GB,CH,2004.0,164,133,31
NO,SE,2020.0,104,110,-6
SE,NL,2007.0,47,29,18
CZ,SK,2006.0,30,47,-17
US,NG,2009.0,28,35,-7
US,LB,2015.0,79,69,10
SE,DK,2014.0,127,126,1
PL,CN,2009.0,28,35,-7
DE,SG,2020.0,29,44,-15
CU,VE,2021.0,13,14,-1
BD,IN,2016.0,116,122,-6
CY,TR,2021.0,61,55,6
FR,DK,2009.0,39,30,9
GB,TN,2015.0,4,12,-8
TH,NL,2015.0,2,13,-11
FI,FR,2010.0,23,16,7
RS,MX,2005.0,22,23,-1
GB,PT,2019.0,101,106,-5
PT,ES,2003.0,55,54,1
AU,ID,2013.0,66,30,36
DE,SA,2010.0,20,4,16
GR,JP,2020.0,32,27,5
IT,NL,2021.0,125,108,17
CN,CZ,2008.0,40,59,-19
NL,FR,2009.0,203,150,53
TN,SA,2014.0,40,14,26
CN,VN,2011.0,40,46,-6
HR,GB,2002.0,4,8,-4
PE,US,2014.0,89,106,-17
KR,CN,2001.0,105,79,26
CN,SY,2005.0,16,12,4
ID,ZA,2021.0,127,174,-47
CN,SY,2002.0,2,4,-2
CN,DE,2009.0,218,230,-12
NG,GB,2018.0,88,139,-51
FR,TH,2011.0,21,11,10
IN,ID,2017.0,70,36,34
FR,ID,2004.0,6,2,4
AT,AU,2015.0,46,25,21
JP,IR,2010.0,25,21,4
IQ,TR,2018.0,5,18,-13
GM,GB,1999.0,6,2,4
AE,US,1997.0,5,3,2
GR,ID,2017.0,3,1,2
CY,GR,2012.0,25,50,-25
DE,MA,2016.0,11,4,7
CN,BG,2015.0,20,7,13
CH,LK,2017.0,3,7,-4
PH,GB,2018.0,29,20,9
MX,BR,2009.0,56,55,1
ES,IT,1999.0,61,54,7
NL,DK,2012.0,32,28,4
JP,ES,2017.0,37,52,-15
BR,SE,2008.0,19,12,7
CR,US,2002.0,13,15,-2
RU,nan,2008.0,93,43,50
SE,nan,2021.0,11,18,-7
TW,IN,2011.0,37,53,-16
TW,SG,2008.0,29,27,2
HU,PL,2016.0,22,27,-5
GB,BA,2016.0,8,2,6
IN,CA,2009.0,143,124,19
SD,CA,2019.0,1,2,-1
CA,JP,2019.0,98,118,-20
DE,SA,2019.0,42,26,16
SI,JP,2011.0,4,5,-1
FR,AT,2004.0,22,18,4
NZ,SE,2022.0,7,4,3
BE,AU,2010.0,28,20,8
SA,DE,2021.0,30,30,0
HU,nan,2011.0,2,1,1
ES,TR,2019.0,18,20,-2
PK,CN,2016.0,126,116,10
HU,AT,2015.0,30,30,0
DE,IL,2020.0,78,71,7
QA,TN,2017.0,5,5,0
CO,ES,1998.0,33,33,0
ID,US,2013.0,72,90,-18
CH,ES,2018.0,90,148,-58
GB,PL,2015.0,112,106,6
IL,FR,2007.0,32,29,3
DE,PE,2020.0,10,13,-3
HU,BE,2021.0,8,10,-2
FR,PH,2021.0,9,2,7
PH,BD,2020.0,4,3,1
IN,TW,2021.0,72,48,24
FR,TN,2005.0,110,64,46
BY,IL,2014.0,3,2,1
UA,IL,2021.0,5,2,3
MA,MX,2019.0,4,1,3
IE,BH,2012.0,2,2,0
KR,NO,2019.0,16,3,13
GB,CO,2008.0,23,20,3
DE,MX,2007.0,29,30,-1
BR,DE,2015.0,213,263,-50
AR,CN,2017.0,5,1,4
TR,CZ,2020.0,14,13,1
ET,CN,2020.0,17,23,-6
DK,CH,2011.0,28,36,-8
IN,ID,2019.0,145,72,73
CR,CU,2008.0,8,4,4
DE,FI,2021.0,56,54,2
KZ,TR,2018.0,49,32,17
IN,PK,2011.0,127,121,6
NZ,KR,2019.0,7,11,-4
IT,SE,2007.0,68,68,0
KW,ES,2020.0,1,1,0
DK,DE,2000.0,47,56,-9
IN,RO,2015.0,29,20,9
JP,NL,2019.0,37,43,-6
KE,ZA,2017.0,28,42,-14
AT,HU,2015.0,30,30,0
CI,FR,2007.0,5,12,-7
JP,EG,2009.0,71,55,16
CN,BE,2011.0,95,38,57
MY,CM,2022.0,2,3,-1
CH,AT,2011.0,80,84,-4
SG,FR,2018.0,26,40,-14
IN,FR,2005.0,85,41,44
TR,KZ,2015.0,42,64,-22
BE,IN,2019.0,44,58,-14
US,VN,2023.0,4,7,-3
DE,CZ,2007.0,62,40,22
CH,SK,2016.0,9,17,-8
IQ,US,2018.0,39,89,-50
UA,IT,2013.0,11,32,-21
IE,IN,2014.0,32,22,10
IT,ZA,2011.0,14,9,5
TR,MX,2018.0,2,2,0
FR,nan,2006.0,146,120,26
ES,PY,2016.0,28,9,19
DE,IR,2021.0,63,136,-73
MA,DZ,2022.0,11,18,-7
SE,GR,2020.0,22,38,-16
DE,ZA,2021.0,30,61,-31
AT,SI,2019.0,16,21,-5
FR,TN,2002.0,39,31,8
NL,ES,2016.0,91,142,-51
MY,OM,2021.0,13,3,10
BR,NL,2013.0,53,39,14
TR,PH,2015.0,3,2,1
SA,IN,2012.0,23,99,-76
MD,RO,2020.0,8,26,-18
KR,FR,2008.0,20,27,-7
PE,MX,2012.0,52,86,-34
JO,US,2016.0,53,70,-17
CH,nan,2019.0,20,25,-5
CM,GA,2018.0,6,1,5
DE,SA,2017.0,45,23,22
BF,ML,2017.0,3,5,-2
ZM,MW,2021.0,4,3,1
PL,MN,2018.0,5,2,3
EG,NL,1999.0,2,1,1
AT,ES,2017.0,31,39,-8
BR,JP,2016.0,44,72,-28
RO,CH,2018.0,15,17,-2
NL,CH,2010.0,88,76,12
nan,HR,2020.0,1,1,0
MY,YE,2022.0,10,10,0
CN,KZ,2019.0,10,8,2
BR,DK,2016.0,30,18,12
PK,KR,2022.0,34,23,11
AM,RU,2021.0,12,14,-2
NZ,RU,2015.0,3,3,0
MX,JP,2012.0,13,5,8
CU,US,2015.0,30,29,1
MX,IL,2021.0,5,5,0
US,SD,2021.0,8,15,-7
ES,UY,2007.0,30,20,10
SN,CA,2008.0,3,1,2
IT,CH,1998.0,96,62,34
RU,TR,2003.0,6,3,3
GB,PT,2017.0,106,133,-27
AE,FI,2015.0,1,2,-1
JP,ES,2019.0,36,46,-10
ZA,UG,2013.0,8,9,-1
GR,IT,2020.0,34,24,10
NO,AU,2018.0,22,21,1
CN,NP,2014.0,13,18,-5
IT,CH,1997.0,67,59,8
AT,nan,2009.0,5,10,-5
US,AM,2016.0,17,17,0
SK,PL,2019.0,13,19,-6
SA,QA,2006.0,3,1,2
CA,AE,2020.0,33,24,9
VN,TH,2009.0,2,8,-6
IR,CN,2010.0,25,24,1
SG,AU,2020.0,165,139,26
SD,EG,2008.0,9,5,4
CO,CU,2018.0,32,33,-1
RU,PR,2017.0,1,1,0
ID,KE,2021.0,9,2,7
CZ,EG,2017.0,3,3,0
AT,IR,2015.0,8,7,1
GR,CY,2002.0,3,6,-3
nan,GB,2016.0,98,107,-9
VE,IT,2011.0,9,6,3
UA,nan,2020.0,23,45,-22
LB,CA,2018.0,20,17,3
RU,PK,2016.0,4,5,-1
HN,MX,2022.0,8,5,3
IN,NG,2018.0,23,16,7
MY,RU,2021.0,11,15,-4
QA,ID,2019.0,5,3,2
LB,FR,2023.0,3,2,1
NG,RU,2021.0,4,4,0
CA,IL,2011.0,53,74,-21
FR,SE,2011.0,56,50,6
VE,CO,2013.0,70,40,30
NZ,US,2021.0,259,326,-67
DZ,FR,2013.0,75,137,-62
JM,US,2011.0,13,16,-3
US,LK,2018.0,44,34,10
IN,CN,2009.0,190,151,39
MA,TN,2004.0,10,3,7
SE,CA,2004.0,38,25,13
EG,BD,2011.0,5,3,2
BR,AU,2006.0,35,47,-12
BE,AU,2019.0,53,45,8
RU,MZ,2021.0,20,8,12
IR,CN,2017.0,57,40,17
JP,SN,2013.0,4,1,3
IT,IR,2014.0,25,39,-14
JP,IR,2017.0,38,26,12
IN,BD,2008.0,31,24,7
CZ,SI,2018.0,6,9,-3
MY,BR,2009.0,304,59,245
TR,nan,2009.0,7,6,1
US,PA,2009.0,39,23,16
LY,GB,2015.0,7,11,-4
ES,PT,1997.0,19,14,5
FR,RU,2011.0,51,74,-23
RU,BE,2008.0,17,16,1
BE,IN,2010.0,10,30,-20
AZ,PL,2005.0,6,2,4
SE,IT,2004.0,33,58,-25
BE,AU,2017.0,44,42,2
DK,JP,2016.0,16,20,-4
IE,AU,2008.0,59,62,-3
SK,FR,2010.0,7,8,-1
AR,BR,2002.0,38,37,1
TZ,NO,2018.0,4,11,-7
AR,BE,2013.0,12,6,6
SG,IT,2013.0,8,12,-4
DK,IE,2003.0,2,3,-1
DE,NZ,2004.0,21,10,11
UG,US,2008.0,9,24,-15
ET,GB,2003.0,5,3,2
AU,LK,2015.0,27,39,-12
FI,CL,2014.0,4,10,-6
ES,EG,2005.0,3,4,-1
BD,JP,2002.0,17,19,-2
MX,PE,2005.0,26,19,7
IE,ZA,2022.0,4,9,-5
NP,JP,2013.0,3,14,-11
MY,IR,2007.0,4,6,-2
nan,CA,2007.0,19,19,0
NG,US,2004.0,30,13,17
SK,PL,2017.0,10,8,2
GB,KW,2000.0,7,7,0
HU,AU,2017.0,14,11,3
JP,SG,2011.0,43,25,18
CA,BE,2009.0,47,52,-5
CA,DK,2011.0,41,37,4
DE,KR,2014.0,48,66,-18
RU,ES,2002.0,17,5,12
GR,NG,2012.0,3,2,1
CA,MY,2015.0,38,44,-6
IN,DK,2003.0,11,7,4
VN,AU,2004.0,4,6,-2
CH,MX,1997.0,4,1,3
NG,DE,2008.0,10,7,3
IN,FR,2002.0,72,88,-16
DE,KE,2020.0,21,18,3
AE,GR,2015.0,2,3,-1
IN,NO,2004.0,18,28,-10
PL,GB,1999.0,23,26,-3
JP,CH,2008.0,83,61,22
NO,PK,2020.0,6,7,-1
HR,CZ,2022.0,3,5,-2
PH,JP,2016.0,24,28,-4
CA,NZ,2021.0,53,40,13
LU,FR,2003.0,9,12,-3
DE,PK,2014.0,38,18,20
PA,VE,2015.0,2,5,-3
RU,AT,2018.0,21,29,-8
CI,US,2017.0,5,7,-2
BW,US,2007.0,9,3,6
JP,HU,2018.0,11,9,2
ES,DK,2012.0,25,24,1
ZA,BE,2007.0,10,14,-4
SD,CN,2020.0,5,21,-16
IT,SI,2007.0,10,5,5
CA,CH,2005.0,50,73,-23
AU,AR,2013.0,7,8,-1
NG,SA,2021.0,15,9,6
CN,UA,2017.0,15,32,-17
OM,FR,2011.0,6,1,5
IN,GE,2015.0,1,6,-5
FI,FR,2017.0,24,42,-18
CA,GH,2008.0,1,2,-1
ES,PT,1998.0,25,23,2
GE,US,2005.0,120,109,11
US,BG,2013.0,35,24,11
ZW,AU,2012.0,2,1,1
CA,JO,2004.0,6,5,1
EE,AT,2015.0,7,5,2
ET,PR,2018.0,3,14,-11
CN,ET,2013.0,3,2,1
nan,MY,2022.0,36,31,5
PL,CA,2021.0,16,19,-3
NP,IN,2011.0,53,60,-7
GR,CY,2005.0,5,5,0
EG,AE,2008.0,12,9,3
CO,CA,2018.0,38,24,14
RO,HK,2008.0,21,1,20
BR,IL,2021.0,7,6,1
TW,DE,1998.0,13,13,0
NG,NO,2015.0,4,1,3
GH,CN,2016.0,19,15,4
GB,BE,2001.0,52,62,-10
PT,HU,2019.0,5,2,3
KR,SG,2021.0,27,22,5
CG,BF,2015.0,3,3,0
CN,PS,2011.0,1,1,0
SA,SG,2021.0,3,7,-4
CN,SK,2003.0,2,4,-2
FR,PT,1998.0,12,11,1
CA,GE,2021.0,7,1,6
UA,GB,2020.0,12,19,-7
TH,CA,2009.0,11,12,-1
GR,CH,2007.0,15,12,3
VU,US,2020.0,1,1,0
UG,ZA,2011.0,7,4,3
LU,CN,2005.0,3,1,2
BY,US,2004.0,9,6,3
ZA,FR,2021.0,19,25,-6
JP,FI,2006.0,11,13,-2
nan,NO,2020.0,32,23,9
GH,PT,2022.0,2,1,1
ES,BO,2019.0,13,23,-10
GB,TW,2004.0,44,27,17
HU,AU,2019.0,15,15,0
NZ,FR,2015.0,22,14,8
MY,CA,2007.0,6,8,-2
nan,KR,2018.0,31,31,0
UZ,US,2022.0,11,2,9
TZ,SE,2018.0,7,3,4
TH,CN,2017.0,33,32,1
TH,CN,2010.0,12,16,-4
BR,ID,2018.0,29,16,13
US,MM,2021.0,12,15,-3
EC,NI,2020.0,3,5,-2
NO,HU,2012.0,2,7,-5
AT,JP,2014.0,20,17,3
FR,QA,2021.0,11,6,5
ID,CA,2015.0,9,33,-24
NP,nan,2021.0,6,1,5
CH,BE,2007.0,39,46,-7
PL,LT,2019.0,6,2,4
VN,FR,2014.0,21,41,-20
US,NI,2019.0,6,4,2
CA,ZA,2001.0,10,11,-1
SK,CA,2007.0,8,3,5
NO,GB,2000.0,27,23,4
BD,SA,2003.0,1,3,-2
AU,DE,1997.0,39,45,-6
FR,TR,2005.0,13,15,-2
IT,ID,2021.0,14,20,-6
IT,UY,2006.0,7,1,6
RU,IT,2007.0,29,19,10
PL,LT,2017.0,12,3,9
GB,IR,2009.0,71,56,15
ES,BO,2010.0,7,8,-1
MA,MD,2018.0,3,2,1
IN,TR,2016.0,28,18,10
SY,BE,2012.0,1,2,-1
JP,LK,2001.0,4,12,-8
FR,TR,2002.0,7,7,0
CI,ZA,2019.0,2,2,0
IL,AR,2015.0,3,6,-3
BR,ZA,2015.0,6,11,-5
ES,CU,2005.0,53,59,-6
ES,CU,2002.0,31,54,-23
GF,FR,2021.0,14,12,2
IS,NL,2012.0,5,1,4
IN,HU,1999.0,5,2,3
JP,TR,2005.0,34,54,-20
HR,GB,2005.0,7,5,2
JP,NL,2010.0,30,37,-7
EG,GB,2007.0,26,49,-23
GR,MX,2012.0,6,3,3
CN,IL,2016.0,15,20,-5
IN,SE,2004.0,16,9,7
TH,VN,2009.0,8,2,6
DE,UY,2017.0,5,12,-7
SK,FR,2017.0,8,5,3
SI,RS,2005.0,7,7,0
FI,AR,2021.0,3,3,0
PL,LT,2010.0,2,4,-2
CA,PR,2004.0,2,1,1
IN,GR,2003.0,4,6,-2
MK,US,2001.0,3,2,1
SI,NL,2005.0,2,2,0
HU,AU,2010.0,11,10,1
XK,MK,2020.0,3,3,0
DE,CO,2007.0,15,12,3
PK,JP,2020.0,9,17,-8
nan,NG,2016.0,8,2,6
DE,CM,2015.0,4,2,2
CH,FI,2001.0,6,11,-5
QA,SA,2009.0,2,5,-3
JP,TR,2002.0,46,45,1
LV,FR,2019.0,1,2,-1
NO,IN,2016.0,24,18,6
MX,GB,2014.0,72,68,4
KE,AT,2014.0,1,4,-3
MX,IT,2022.0,15,17,-2
AT,NL,2005.0,11,18,-7
AR,AU,1998.0,4,1,3
CL,US,1998.0,45,51,-6
AT,NL,2002.0,11,16,-5
ZA,CH,2022.0,13,8,5
AU,MX,2021.0,13,12,1
JP,AM,2013.0,4,4,0
US,MA,2007.0,13,6,7
FI,JP,2016.0,15,20,-5
KR,BD,2016.0,28,36,-8
SI,DE,2012.0,13,13,0
JP,GR,2020.0,27,32,-5
TR,EG,2008.0,1,2,-1
CA,GR,2022.0,7,7,0
CA,BH,2006.0,4,1,3
CO,AR,2008.0,42,43,-1
BH,US,2011.0,11,9,2
CH,LK,2019.0,4,7,-3
HU,GR,2008.0,3,3,0
KE,NO,2017.0,4,1,3
AU,DE,1998.0,53,74,-21
GB,HR,2019.0,19,19,0
PK,SA,2003.0,5,9,-4
RS,JP,2003.0,9,3,6
ET,ZA,2018.0,7,14,-7
JP,KE,2005.0,6,3,3
GB,CY,2009.0,27,8,19
SA,FR,2007.0,3,12,-9
AR,BR,2005.0,51,72,-21
BE,GR,2009.0,15,10,5
CZ,CH,2007.0,16,21,-5
LU,NL,2012.0,6,7,-1
nan,DE,2002.0,22,24,-2
MY,NL,2012.0,3,7,-4
HU,EG,2007.0,5,2,3
DK,FI,1999.0,10,10,0
SE,ES,2006.0,40,26,14
MY,BN,2019.0,13,12,1
TH,IT,2017.0,3,5,-2
SA,NG,2003.0,4,3,1
IT,SK,2003.0,1,3,-2
BE,CH,1999.0,17,18,-1
GB,TZ,2003.0,3,3,0
IN,ET,2012.0,11,2,9
KR,CA,2000.0,9,22,-13
IL,ES,2021.0,14,10,4
PK,AR,2019.0,9,10,-1
AU,MK,2002.0,7,10,-3
TR,SE,2006.0,9,3,6
CO,ES,1997.0,16,29,-13
KR,VN,2010.0,29,19,10
VN,TW,2012.0,5,5,0
nan,DE,2005.0,34,63,-29
CL,IE,2017.0,4,5,-1
AT,GB,2002.0,42,37,5
MX,PA,2016.0,10,9,1
PE,GB,2012.0,8,11,-3
AR,IT,2007.0,59,58,1
PH,CL,2012.0,3,3,0
NZ,BR,2022.0,8,11,-3
AT,GB,2005.0,60,48,12
HK,JP,2001.0,9,2,7
GB,EG,2005.0,27,19,8
BR,CO,2006.0,39,32,7
HU,NO,2013.0,7,6,1
US,UZ,2022.0,2,11,-9
EG,SD,2011.0,10,8,2
BD,US,2003.0,21,16,5
NL,IL,2006.0,8,18,-10
PL,DK,2008.0,8,9,-1
FR,CM,2000.0,5,4,1
CR,US,2005.0,15,8,7
ZA,JP,2015.0,9,15,-6
CO,JP,2012.0,7,14,-7
PT,VE,2021.0,1,3,-2
GR,IN,2011.0,3,8,-5
CA,CR,2015.0,3,1,2
CO,EC,2006.0,6,4,2
VN,US,2023.0,7,4,3
NO,IT,2009.0,8,14,-6
ES,BO,2017.0,22,17,5
CO,JO,2018.0,2,2,0
KR,NZ,2014.0,10,9,1
CR,SE,2015.0,4,1,3
EG,TN,2020.0,20,28,-8
BE,CO,2014.0,5,2,3
UG,KE,2017.0,12,13,-1
KE,SN,2020.0,1,1,0
BE,CM,2021.0,6,5,1
FR,GA,2012.0,8,7,1
IT,PA,2012.0,3,2,1
ES,JP,2002.0,11,16,-5
MX,nan,2000.0,6,3,3
CN,AR,2009.0,5,6,-1
SE,DE,2023.0,8,16,-8
US,BN,2009.0,1,3,-2
FI,CA,2011.0,14,21,-7
SA,LB,2015.0,7,10,-3
IE,IQ,2020.0,4,3,1
BN,CN,2019.0,3,2,1
BR,PK,2022.0,3,3,0
TN,IR,2020.0,10,8,2
BW,NG,2020.0,5,1,4
UZ,CN,2005.0,3,4,-1
VE,nan,2015.0,3,1,2
CL,CU,2005.0,13,10,3
SE,IR,2013.0,41,56,-15
BE,EC,2014.0,2,2,0
MG,US,2011.0,3,1,2
KR,AE,2018.0,12,5,7
IL,PS,2014.0,7,6,1
ES,BG,2004.0,4,7,-3
CU,PT,2002.0,2,2,0
NL,NO,2002.0,13,9,4
nan,CO,2015.0,13,12,1
CN,UA,2019.0,23,34,-11
PK,NO,1998.0,1,1,0
SK,DK,2011.0,7,2,5
BG,DE,2006.0,22,13,9
DE,UY,2010.0,3,1,2
IL,GB,1998.0,25,26,-1
DE,BR,2002.0,42,55,-13
AT,SI,2017.0,15,28,-13
QA,TW,2013.0,2,1,1
TW,KR,2006.0,34,39,-5
IT,AO,2012.0,3,2,1
IE,BR,2020.0,13,24,-11
IL,BR,2015.0,9,10,-1
ID,CZ,2009.0,1,3,-2
SE,SA,2013.0,10,3,7
JP,NL,2017.0,33,29,4
GR,ID,2019.0,5,2,3
IT,ET,2006.0,5,2,3
US,RW,2012.0,8,4,4
GB,EG,2002.0,15,14,1
NL,CW,1999.0,2,5,-3
HU,BR,2020.0,6,8,-2
SK,DE,2014.0,38,37,1
CH,HR,2001.0,3,2,1
DE,GR,2009.0,47,57,-10
ET,US,2011.0,25,28,-3
CZ,TR,2007.0,2,2,0
AU,GH,2020.0,18,14,4
DK,IR,2016.0,6,27,-21
AT,BR,2021.0,12,24,-12
KE,GH,2018.0,5,7,-2
HR,DE,2016.0,28,19,9
BD,BH,2016.0,1,2,-1
CY,GB,2022.0,16,28,-12
RU,PT,2016.0,2,11,-9
AE,US,1998.0,7,4,3
IN,NL,2005.0,25,15,10
CI,US,2019.0,5,6,-1
ID,EG,2015.0,8,18,-10
KE,TW,2015.0,1,2,-1
IT,PK,2013.0,10,4,6
SE,SG,2003.0,4,2,2
ES,TR,2017.0,9,10,-1
BY,UA,2004.0,7,1,6
RS,DE,2023.0,1,3,-2
IL,GB,1997.0,18,26,-8
CY,US,2006.0,13,21,-8
PL,MZ,1997.0,3,4,-1
DE,SY,2018.0,2,1,1
HU,DK,2011.0,6,1,5
GB,IS,2006.0,3,6,-3
NO,DE,2011.0,53,79,-26
TW,nan,2017.0,5,1,4
BH,EG,2012.0,6,3,3
PH,IN,2018.0,15,21,-6
NL,BG,2019.0,5,5,0
FI,nan,2001.0,7,4,3
GD,GB,2010.0,2,2,0
NC,FR,2006.0,7,14,-7
AT,SK,2009.0,9,10,-1
CH,SI,2012.0,2,8,-6
BF,ML,2010.0,2,1,1
NG,UA,2017.0,2,1,1
US,CD,2008.0,1,6,-5
VN,JP,2010.0,18,33,-15
IL,RU,1997.0,10,11,-1
JO,AE,2000.0,2,2,0
FR,EE,2011.0,10,3,7
JM,GB,1999.0,4,1,3
CL,NO,2022.0,3,1,2
NO,nan,2000.0,9,15,-6
NZ,nan,2003.0,4,6,-2
PK,nan,1998.0,1,1,0
AU,MK,2005.0,22,15,7
AT,TW,2009.0,2,1,1
SS,GB,2004.0,5,11,-6
NL,NZ,2021.0,8,13,-5
IT,CY,2014.0,4,3,1
CA,VE,2021.0,1,4,-3
MN,KR,2022.0,2,1,1
RS,BE,2015.0,7,6,1
NL,CN,2000.0,22,23,-1
EE,SE,2010.0,8,18,-10
RS,CH,2003.0,1,5,-4
CU,CO,2001.0,6,3,3
SE,TR,2006.0,3,9,-6
JP,MX,1999.0,5,3,2
ES,RU,2007.0,12,13,-1
ID,FR,1998.0,3,8,-5
CH,nan,2017.0,29,22,7
GH,NL,2020.0,5,4,1
CA,CY,2012.0,2,1,1
UA,MY,2014.0,1,2,-1
TR,SG,2011.0,2,2,0
IL,PH,2000.0,2,2,0
HU,IL,2015.0,5,3,2
CL,GR,2018.0,1,1,0
BR,RU,2014.0,13,13,0
ZA,NZ,2001.0,9,4,5
NP,PH,2012.0,3,1,2
DK,ET,2018.0,7,3,4
BD,BR,2017.0,4,2,2
ES,LK,2009.0,2,1,1
JO,BD,2018.0,1,1,0
nan,VN,2015.0,3,1,2
SK,FR,2019.0,5,8,-3
PE,GT,2016.0,1,3,-2
FR,CL,2002.0,12,16,-4
SY,EG,2014.0,3,3,0
AU,BB,2008.0,1,1,0
NZ,MM,2018.0,2,2,0
KE,RW,2013.0,1,1,0
RU,MN,2014.0,3,7,-4
KW,CA,2008.0,2,9,-7
AU,MM,2022.0,2,3,-1
AM,US,2018.0,9,15,-6
CY,CH,2021.0,1,3,-2
PT,CH,2001.0,5,4,1
LB,DE,2012.0,5,2,3
SG,BE,2022.0,7,1,6
NI,CO,2013.0,3,4,-1
US,BF,2021.0,1,7,-6
EG,TW,2013.0,11,5,6
SA,MK,2015.0,1,1,0
BE,SA,2016.0,3,2,1
PK,BE,2020.0,6,6,0
CO,RO,2009.0,1,1,0
BR,EC,2023.0,2,1,1
GR,BE,2007.0,10,10,0
VN,NP,2021.0,1,1,0
HU,US,2023.0,3,2,1
HU,IT,2004.0,10,3,7
BG,GB,2008.0,7,6,1
RS,HU,2011.0,5,11,-6
HU,CN,2022.0,5,5,0
BY,CZ,2002.0,7,4,3
LK,GB,2021.0,20,20,0
SV,CO,2017.0,3,4,-1
IN,ID,2010.0,7,9,-2
DK,HU,2022.0,3,5,-2
ZM,GH,2013.0,13,17,-4
SG,RU,2014.0,7,8,-1
BJ,CA,2017.0,3,4,-1
AE,IT,2017.0,4,14,-10
SG,VN,2014.0,8,6,2
IN,NL,2002.0,15,6,9
KR,NO,2017.0,5,6,-1
CA,UY,2012.0,4,5,-1
MX,PE,2002.0,12,17,-5
CO,nan,2012.0,6,7,-1
CU,PT,2005.0,3,2,1
PK,AR,2017.0,13,3,10
AU,IE,2023.0,2,3,-1
BB,JM,2006.0,3,2,1
IR,PL,2014.0,4,7,-3
US,NI,2017.0,6,10,-4
HU,CA,2008.0,7,14,-7
RO,nan,2008.0,3,1,2
UY,FR,2021.0,3,1,2
CR,GB,2020.0,5,9,-4
BG,MK,2013.0,9,2,7
HU,SK,2018.0,11,8,3
NL,ID,2012.0,18,15,3
CN,DK,2007.0,20,18,2
BE,ZA,2012.0,21,15,6
RO,VN,2013.0,6,7,-1
KE,CN,2006.0,4,1,3
HN,US,2018.0,7,8,-1
KR,NO,2010.0,8,2,6
QA,IN,2020.0,21,34,-13
DZ,TN,2006.0,4,2,2
US,SA,1999.0,33,31,2
IT,CL,2000.0,4,4,0
CN,KZ,2010.0,11,6,5
PY,PT,2013.0,1,3,-2
AE,NG,2022.0,3,5,-2
TN,MA,2022.0,16,19,-3
NZ,AT,2011.0,5,4,1
CN,LV,2017.0,1,1,0
AR,CU,2008.0,19,10,9
FI,PL,2012.0,10,5,5
FR,BI,2022.0,20,16,4
TZ,nan,2012.0,3,2,1
IL,RU,1998.0,10,15,-5
PL,IR,2007.0,4,1,3
SE,TH,2014.0,6,2,4
GR,CZ,2008.0,3,3,0
BY,FR,2001.0,3,2,1
UZ,RU,2007.0,17,9,8
PK,NL,2006.0,3,2,1
RO,BE,2007.0,6,3,3
EE,SE,2019.0,7,4,3
PT,BE,2008.0,6,8,-2
GB,TR,1998.0,23,13,10
NL,BG,2017.0,5,2,3
CH,CO,2008.0,4,4,0
ES,MA,2000.0,2,2,0
TN,BH,2019.0,2,1,1
UY,PH,2019.0,1,1,0
NO,FI,2007.0,4,13,-9
GB,BF,2008.0,2,1,1
SE,UA,2000.0,6,7,-1
IQ,NG,2014.0,3,2,1
ES,HN,2011.0,4,5,-1
BD,QA,2019.0,2,2,0
MY,IN,2023.0,4,4,0
CL,CU,2002.0,3,6,-3
HK,IN,2017.0,1,1,0
BF,ZA,2016.0,2,1,1
PT,NL,2007.0,6,19,-13
RU,DK,2008.0,5,9,-4
IE,ID,2010.0,1,2,-1
JP,KH,2006.0,4,5,-1
KR,PR,1999.0,11,29,-18
NZ,KR,2017.0,6,13,-7
UG,FR,1999.0,1,2,-1
PY,CO,2013.0,1,1,0
FJ,NZ,2015.0,4,3,1
SG,OM,2006.0,1,1,0
PK,FR,2000.0,1,5,-4
MX,IN,2013.0,10,11,-1
BJ,CA,2019.0,2,4,-2
SA,AT,2017.0,5,4,1
BO,CL,2007.0,1,1,0
DE,UY,2019.0,2,5,-3
NP,GB,2021.0,10,14,-4
AR,AU,1997.0,2,2,0
SE,CR,2007.0,2,2,0
IN,MX,2000.0,6,3,3
IL,TR,2001.0,3,4,-1
FR,CD,2022.0,3,2,1
PL,FI,2012.0,5,10,-5
BD,IQ,2022.0,2,9,-7
IN,IS,2018.0,6,1,5
IN,ML,2019.0,3,5,-2
SA,SE,2006.0,2,1,1
SE,RS,2018.0,4,10,-6
nan,PK,1998.0,1,1,0
CH,CL,2003.0,4,7,-3
GB,EE,2015.0,8,7,1
CZ,EG,2019.0,5,2,3
FR,PT,1997.0,9,7,2
KZ,RU,2009.0,10,9,1
QA,ID,2017.0,4,5,-1
SV,CO,2019.0,7,5,2
IN,UG,2019.0,5,5,0
IN,ML,2017.0,2,10,-8
CM,BJ,2021.0,3,1,2
FJ,FR,2016.0,1,2,-1
TW,FI,2018.0,2,2,0
HK,GB,2015.0,7,8,-1
KE,ZA,2019.0,25,46,-21
CI,US,2010.0,1,1,0
BE,DZ,2020.0,7,10,-3
DK,SJ,2013.0,1,4,-3
BG,IT,1997.0,4,1,3
PT,DK,2012.0,6,3,3
PL,IN,1999.0,1,1,0
BR,PY,2015.0,7,9,-2
SE,MY,2011.0,1,3,-2
HU,FI,2014.0,3,6,-3
EG,SY,2022.0,6,3,3
SV,ES,2011.0,3,1,2
NO,CN,2003.0,5,8,-3
AE,MY,2013.0,4,6,-2
CH,UG,2011.0,1,2,-1
GR,PL,2018.0,4,4,0
BD,JP,2005.0,16,35,-19
CA,HU,2007.0,9,9,0
AU,KW,2005.0,3,1,2
PA,BR,2018.0,5,7,-2
CN,NG,2014.0,3,5,-2
UA,AU,2016.0,3,2,1
PK,TW,2001.0,1,1,0
NP,CA,2014.0,6,4,2
QA,GR,2015.0,1,5,-4
ZM,PK,2015.0,1,1,0
ZM,AU,2012.0,1,3,-2
XK,US,2020.0,3,4,-1
AR,IE,2005.0,2,2,0
BD,SE,2013.0,4,5,-1
nan,CZ,2016.0,9,6,3
US,KW,2009.0,16,18,-2
US,BI,1999.0,1,2,-1
SK,BA,2019.0,2,4,-2
BE,NZ,2012.0,6,4,2
NL,ZA,2003.0,11,17,-6
SE,BG,2011.0,6,4,2
IS,DK,2008.0,5,1,4
ES,TR,2010.0,8,7,1
FJ,AU,2001.0,2,4,-2
CA,MA,2000.0,6,5,1
CM,DK,2010.0,1,1,0
BG,NZ,2013.0,1,1,0
RS,CA,2007.0,9,10,-1
TW,nan,2019.0,5,3,2
PL,NO,2005.0,3,1,2
DK,IL,2001.0,3,1,2
BG,PL,2010.0,2,3,-1
BA,IT,2020.0,2,3,-1
PS,TR,2022.0,4,4,0
BR,KW,2016.0,1,1,0
SA,KR,2007.0,1,1,0
NZ,PK,2014.0,6,6,0
RU,MD,2003.0,1,2,-1
IL,IT,2008.0,9,8,1
SY,IT,2013.0,2,2,0
AT,ES,2010.0,25,22,3
MY,BN,2010.0,1,3,-2
TR,PT,2008.0,3,1,2
FI,HU,2008.0,4,5,-1
CL,SE,2018.0,9,13,-4
BE,AE,2022.0,2,2,0
CH,nan,2010.0,8,9,-1
NO,NP,2009.0,2,1,1
AR,MY,2008.0,4,2,2
QA,TN,2010.0,2,1,1
KE,ZA,2010.0,8,15,-7
FI,EE,2000.0,3,4,-1
UA,IN,2012.0,6,8,-2
CL,IE,2010.0,3,2,1
BD,FI,2012.0,4,2,2
IN,UA,2008.0,1,1,0
CH,PL,2000.0,12,9,3
PL,nan,2009.0,5,4,1
FR,SK,2011.0,5,10,-5
DK,LU,2009.0,1,1,0
NZ,IE,2009.0,8,11,-3
BG,CH,2004.0,4,3,1
FR,ZA,2001.0,7,5,2
IN,TH,2008.0,3,4,-1
IT,KE,2014.0,5,2,3
TZ,MW,2016.0,2,1,1
SA,VN,2020.0,2,1,1
ID,DZ,2019.0,2,9,-7
BW,GB,2018.0,4,8,-4
KE,nan,2018.0,9,6,3
AO,IT,1998.0,1,2,-1
RU,ES,2005.0,4,4,0
CU,PY,2000.0,2,3,-1
IL,KR,2012.0,5,3,2
FJ,ZA,2018.0,1,1,0
BH,GH,2011.0,3,1,2
CR,BO,2011.0,3,1,2
RS,TW,2007.0,1,1,0
PL,KZ,2022.0,2,8,-6
IT,EG,2009.0,4,5,-1
IQ,GB,2008.0,2,3,-1
CZ,PL,2000.0,3,9,-6
DK,GL,2005.0,2,3,-1
AT,DK,2006.0,4,6,-2
CL,CR,2000.0,4,3,1
ES,EG,2002.0,4,1,3
SK,HR,2020.0,5,5,0
GB,HK,2021.0,6,3,3
SE,PT,2023.0,1,2,-1
GB,FJ,2009.0,1,1,0
IE,BE,2003.0,1,1,0
LA,JP,2014.0,1,2,-1
MX,UA,2009.0,5,1,4
BE,MG,2017.0,1,1,0
UZ,DE,2004.0,3,3,0
HU,UA,2013.0,2,1,1
JO,EG,1999.0,1,1,0
GH,ZA,2011.0,2,2,0
NZ,IT,2012.0,8,6,2
KR,UZ,2004.0,2,2,0
IN,CZ,2000.0,5,5,0
TW,SA,2007.0,1,2,-1
IN,KW,2022.0,8,4,4
HU,SG,2016.0,2,1,1
BG,JP,2021.0,1,1,0
SD,CA,2017.0,3,3,0
UA,KG,2021.0,2,1,1
US,GN,2019.0,1,1,0
ID,FR,1997.0,1,2,-1
CO,AT,2016.0,2,4,-2
GB,TT,2015.0,8,5,3
IE,BG,2011.0,1,5,-4
NP,CN,2008.0,2,5,-3
IT,MZ,2021.0,1,1,0
IS,CH,2016.0,2,1,1
SV,US,2022.0,1,3,-2
MZ,RU,2022.0,11,17,-6
MX,AT,2006.0,3,2,1
SG,CL,2017.0,3,1,2
TR,RO,2020.0,4,2,2
AE,BH,2011.0,2,2,0
MX,IE,2020.0,5,1,4
IE,ID,2017.0,4,1,3
CA,NP,2015.0,6,3,3
AZ,PL,2002.0,1,2,-1
FI,RO,2006.0,2,1,1
CZ,nan,2021.0,4,5,-1
ET,NL,2012.0,4,2,2
LU,CN,2002.0,5,2,3
GE,SK,2016.0,1,1,0
SE,TW,2007.0,3,4,-1
SY,TN,2017.0,2,1,1
GB,PA,2021.0,7,3,4
FR,VE,2003.0,4,5,-1
nan,BD,2015.0,4,4,0
VN,MM,2020.0,1,3,-2
UY,VE,2002.0,1,1,0
US,PG,2004.0,2,1,1
SI,KR,2020.0,1,1,0
ZM,NO,2010.0,2,1,1
CL,nan,2009.0,4,1,3
ES,HR,2014.0,6,5,1
UG,LU,2015.0,1,1,0
NZ,SK,1998.0,1,1,0
TW,PH,2004.0,1,2,-1
AO,IT,1997.0,1,1,0
BD,ET,2014.0,1,1,0
BH,NG,2006.0,3,4,-1
CH,UA,2003.0,3,3,0
UG,SE,2016.0,4,3,1
GB,YE,2013.0,2,2,0
SI,BR,2012.0,2,1,1
PE,NI,2016.0,2,2,0
CL,UY,2001.0,3,5,-2
GE,RU,1999.0,2,2,0
SA,ES,2016.0,5,13,-8
IS,NO,2012.0,3,8,-5
CM,PK,2018.0,2,2,0
TW,MX,2016.0,1,1,0
ZA,BF,2018.0,2,1,1
MX,NO,2014.0,5,5,0
PK,AR,2010.0,10,14,-4
SI,TR,2021.0,3,1,2
HR,SI,1999.0,3,1,2
IS,GB,2015.0,4,9,-5
AT,SI,2010.0,8,8,0
AE,CH,2008.0,1,1,0
QA,AU,2014.0,3,12,-9
ID,TH,2013.0,4,5,-1
CM,FR,2004.0,10,10,0
QA,TR,2015.0,1,3,-2
KE,NO,2010.0,1,1,0
GB,IM,2020.0,2,1,1
SK,BE,2022.0,1,1,0
US,BS,2013.0,2,7,-5
NG,BR,2022.0,3,4,-1
CA,PK,1999.0,3,6,-3
IL,SG,2020.0,4,8,-4
KR,AT,2012.0,6,3,3
AR,PL,2016.0,4,1,3
SV,MX,2012.0,3,3,0
BG,IT,1998.0,7,4,3
GR,IL,2006.0,2,2,0
TH,PK,2021.0,6,3,3
CR,CN,2012.0,4,4,0
NZ,NG,2015.0,4,1,3
CL,EC,2006.0,7,5,2
CH,MX,1998.0,4,1,3
VG,FR,2011.0,2,1,1
AM,DE,2016.0,2,7,-5
SE,AE,2022.0,6,1,5
IQ,AU,2022.0,3,12,-9
VN,ZA,2016.0,2,1,1
IT,NZ,2015.0,6,7,-1
FJ,GB,2017.0,1,2,-1
FJ,GB,2019.0,3,3,0
GH,nan,2022.0,2,2,0
CM,US,2022.0,1,5,-4
BR,MA,2005.0,1,3,-2
FI,IL,2015.0,1,3,-2
NG,BE,2012.0,3,2,1
ET,EG,2016.0,3,7,-4
BH,SA,2002.0,1,1,0
IL,FI,2014.0,2,2,0
NL,PK,2006.0,2,3,-1
FJ,US,2004.0,1,4,-3
OM,GB,2001.0,4,3,1
IN,UG,2010.0,1,1,0
PT,LU,2022.0,2,1,1
MY,SA,2000.0,1,1,0
GT,CU,2021.0,2,1,1
IN,RW,2018.0,5,8,-3
BF,ML,2019.0,4,3,1
AT,KR,2020.0,5,5,0
CI,IN,2020.0,1,1,0
BY,PL,1997.0,2,1,1
PT,SK,2022.0,1,2,-1
SG,KE,2004.0,1,1,0
KR,BG,2015.0,1,2,-1
ZA,LS,2022.0,1,1,0
SK,BG,2009.0,1,1,0
AE,IT,2019.0,3,10,-7
FJ,GB,2010.0,2,1,1
CW,NL,1998.0,5,4,1
JO,ES,2008.0,2,1,1
GT,ES,2008.0,2,1,1
NL,AR,2015.0,5,12,-7
ID,KR,2009.0,3,3,0
BR,IR,2003.0,1,1,0
JP,ZA,2000.0,6,3,3
KW,QA,2011.0,2,1,1
BR,TH,2015.0,4,5,-1
IT,IQ,2009.0,1,1,0
IN,ML,2010.0,3,6,-3
ML,IN,2006.0,4,1,3
NL,MA,2012.0,1,1,0
SK,SE,2004.0,6,3,3
AT,MC,2015.0,1,1,0
CH,LK,2010.0,2,2,0
GA,FR,2005.0,4,2,2
PH,TW,2007.0,2,1,1
PH,DE,2000.0,3,5,-2
EE,GB,2005.0,3,8,-5
UZ,LA,2010.0,1,1,0
RO,TR,2001.0,1,1,0
BD,DK,2012.0,2,1,1
RO,RU,2012.0,3,5,-2
LB,TW,2013.0,1,2,-1
IR,QA,2014.0,1,2,-1
CN,MN,2000.0,1,1,0
BG,SI,2004.0,1,1,0
LY,IR,2014.0,1,1,0
SA,YE,2015.0,2,15,-13
QA,GH,2021.0,1,1,0
SE,BO,2007.0,1,1,0
AU,ZW,2019.0,1,3,-2
SK,PL,2010.0,5,2,3
IL,DK,2003.0,2,2,0
BD,BR,2019.0,2,3,-1
ID,IL,2019.0,1,6,-5
ID,AF,2021.0,1,1,0
CY,BE,2016.0,1,1,0
CA,CI,2014.0,1,6,-5
AF,PK,2022.0,1,3,-2
PT,DZ,2018.0,1,3,-2
ZA,SZ,2002.0,2,1,1
NP,MX,2019.0,2,1,1
MY,KR,2004.0,4,3,1
GT,IT,2018.0,1,2,-1
GB,OM,2003.0,6,7,-1
GH,KE,2016.0,3,1,2
JP,QA,2006.0,1,1,0
IL,IN,2004.0,6,12,-6
QA,NG,2020.0,2,2,0
GR,TR,2000.0,3,1,2
GB,PE,2009.0,1,11,-10
LT,PL,2005.0,3,2,1
PL,NO,2002.0,2,6,-4
ZW,BH,2016.0,2,2,0
IQ,BD,2014.0,1,1,0
FI,IE,2003.0,2,3,-1
CN,JO,2004.0,2,1,1
PH,KE,2018.0,2,1,1
ID,IL,2017.0,2,5,-3
NO,HR,2008.0,1,2,-1
MA,HU,2022.0,1,3,-2
SN,MA,2018.0,6,2,4
TW,SI,2011.0,1,2,-1
BD,OM,2005.0,2,1,1
BW,nan,2012.0,1,1,0
SG,TR,2011.0,2,2,0
RO,MY,2020.0,1,2,-1
BR,TR,1998.0,1,1,0
SN,DE,2021.0,2,1,1
KE,CM,2018.0,1,2,-1
UG,TZ,2021.0,2,5,-3
AU,RO,2016.0,1,3,-2
PY,CU,2015.0,1,5,-4
GB,PG,2019.0,1,2,-1
IN,SK,2012.0,3,2,1
CZ,EG,2010.0,2,1,1
UY,VE,2005.0,1,1,0
RU,KR,2014.0,9,18,-9
DO,MX,2002.0,1,1,0
CO,SV,2021.0,1,2,-1
PR,US,2008.0,5,3,2
nan,IS,2016.0,1,2,-1
AR,CN,2010.0,2,3,-1
MA,NL,2008.0,1,1,0
MY,CY,2018.0,1,1,0
PK,MA,2000.0,2,3,-1
BE,CW,2018.0,1,3,-2
ZA,VN,2020.0,3,4,-1
MT,FR,2018.0,1,1,0
SE,VN,2011.0,2,1,1
NL,CR,2003.0,1,2,-1
PL,PH,2008.0,1,2,-1
HU,MY,2018.0,2,1,1
TW,VN,2008.0,3,1,2
PL,ZA,2020.0,4,7,-3
KE,NG,2006.0,1,2,-1
TZ,CD,2019.0,1,1,0
SE,TN,2013.0,1,1,0
SM,IT,2021.0,2,3,-1
AT,RO,2020.0,4,7,-3
CN,OM,2016.0,2,1,1
CL,HU,2021.0,2,1,1
LU,BR,2011.0,3,5,-2
US,TJ,2009.0,2,2,0
DK,RS,2014.0,1,2,-1
VN,PH,2015.0,2,1,1
GB,ET,1998.0,1,1,0
AM,ID,2021.0,2,5,-3
GR,EG,2019.0,2,1,1
CO,TH,2018.0,2,1,1
EG,PK,2011.0,5,3,2
ES,RS,2009.0,1,2,-1
EC,DE,2008.0,2,3,-1
MX,ZA,2022.0,1,1,0
YE,AE,1998.0,1,1,0
GD,GB,2017.0,1,5,-4
AE,NZ,2020.0,1,6,-5
PA,US,2023.0,1,2,-1
IE,BD,2021.0,1,5,-4
ME,SI,2015.0,1,1,0
CY,PH,2021.0,1,1,0
DE,SN,2014.0,1,1,0
BJ,BF,2008.0,1,2,-1
UG,IN,2020.0,2,3,-1
AR,CN,2019.0,2,6,-4
OM,QA,2022.0,1,4,-3
KZ,SA,2018.0,3,1,2
AO,US,2004.0,1,1,0
DK,BD,2012.0,1,2,-1
IL,NZ,2018.0,2,2,0
AT,TH,2014.0,5,2,3
PT,FI,2013.0,2,2,0
QA,KR,2012.0,2,7,-5
GB,LK,2021.0,20,20,0
BR,ES,2017.0,350,422,-72
US,GB,2015.0,6092,6083,9
MY,US,2011.0,78,138,-60
CL,PE,2022.0,21,35,-14
nan,JP,2003.0,97,76,21
TH,IR,2003.0,1,1,0
US,GT,2009.0,5,3,2
BR,ES,2019.0,435,442,-7
ES,BR,2007.0,208,181,27
CO,MX,2015.0,335,341,-6
DE,IN,2021.0,171,194,-23
BR,CA,2001.0,85,86,-1
US,IE,2018.0,551,574,-23
US,BD,2021.0,134,135,-1
NZ,IN,2006.0,9,16,-7
KR,VN,2017.0,82,54,28
FR,ES,2018.0,346,380,-34
US,SE,2015.0,491,399,92
US,FI,2016.0,137,164,-27
AU,GB,2017.0,1377,1541,-164
JP,IR,2019.0,17,30,-13
DE,BR,2005.0,81,78,3
PK,GB,2018.0,137,207,-70
NL,CH,2019.0,151,115,36
EE,SE,2017.0,16,5,11
GB,GR,2011.0,173,192,-19
PK,KE,2018.0,19,28,-9
GB,HR,2010.0,9,14,-5
CN,GR,2006.0,9,15,-6
JP,NO,2010.0,9,6,3
CN,RW,2020.0,5,4,1
PH,CN,2013.0,21,22,-1
NL,RU,2018.0,64,50,14
IE,DE,2015.0,91,85,6
SK,SI,2014.0,3,10,-7
MX,CO,2000.0,33,21,12
IR,FR,2021.0,31,20,11
TH,CN,2019.0,46,69,-23
CH,ZA,2022.0,8,13,-5
IR,CN,2019.0,83,49,34
US,HR,2021.0,29,39,-10
CH,GB,2010.0,214,317,-103
AU,LU,2015.0,2,3,-1
MY,ZA,2020.0,10,5,5
nan,ID,2022.0,38,23,15
AT,ES,2019.0,32,38,-6
IE,SE,2020.0,13,12,1
BD,AU,2014.0,67,33,34
CO,PY,2016.0,7,7,0
NL,NO,2005.0,27,15,12
BR,CH,2015.0,59,52,7
NL,CY,2016.0,1,4,-3
NL,CH,2017.0,144,118,26
NG,IT,2011.0,10,10,0
GR,EG,2017.0,2,3,-1
FI,FR,2019.0,25,46,-21
JP,NO,2019.0,18,8,10
CG,FR,2009.0,18,12,6
AT,RS,2003.0,4,3,1
ZA,CZ,2018.0,9,2,7
NL,KH,1999.0,4,4,0
SI,GB,2014.0,12,9,3
RO,FR,2004.0,32,17,15
VN,JP,2017.0,37,73,-36
CA,KW,2011.0,12,4,8
IT,AL,2020.0,3,3,0
UG,KE,2019.0,13,20,-7
VN,JP,2019.0,33,87,-54
IS,US,2009.0,17,25,-8
CZ,RS,2000.0,6,6,0
nan,BR,2003.0,22,24,-2
CN,KZ,2017.0,4,3,1
PK,ES,2020.0,5,10,-5
CN,RU,2023.0,3,5,-2
KE,PK,2013.0,8,16,-8
JP,ES,2010.0,39,27,12
KE,US,2009.0,34,48,-14
TW,FR,2011.0,19,25,-6
TR,NL,2009.0,26,15,11
MX,AU,2008.0,13,4,9
HR,IT,2018.0,5,11,-6
TH,IT,2010.0,3,3,0
ZA,TW,2018.0,7,1,6
CU,GB,2013.0,6,4,2
IQ,IR,2016.0,4,10,-6
QA,IE,2020.0,3,7,-4
SD,MA,2017.0,3,2,1
MA,PK,2015.0,12,23,-11
CN,IR,2007.0,14,11,3
GB,HR,2017.0,19,27,-8
CA,TN,2014.0,16,10,6
JP,BJ,2012.0,2,2,0
AU,AT,2006.0,16,19,-3
IR,SA,2013.0,5,13,-8
PL,MZ,1998.0,3,8,-5
FI,IT,2013.0,17,23,-6
PK,KW,2012.0,4,2,2
MY,NZ,2020.0,13,10,3
SI,CH,2014.0,3,7,-4
QA,HR,2018.0,2,1,1
SK,NL,2000.0,6,15,-9
BY,CZ,2005.0,4,4,0
CN,UA,2010.0,16,16,0
EG,KR,2020.0,11,11,0
UG,BE,2011.0,5,4,1
MT,GB,2006.0,4,8,-4
TW,AR,2007.0,5,5,0
PA,CN,2014.0,4,1,3
JM,CA,2011.0,2,5,-3
SE,NZ,2015.0,12,8,4
CM,CI,2021.0,6,3,3
NI,EC,2016.0,1,1,0
IN,UG,2017.0,4,1,3
DK,GL,2002.0,1,1,0
MX,PT,2010.0,8,7,1
TN,IT,2022.0,12,12,0
ID,SG,2007.0,2,4,-2
IE,PL,2013.0,15,5,10
FR,JO,2008.0,3,3,0
MY,LB,2002.0,1,1,0
MX,DO,2016.0,2,2,0
LK,ID,2009.0,3,1,2
NO,BG,2012.0,5,9,-4
FR,JM,2001.0,2,1,1
IT,PT,2000.0,7,4,3
NZ,KR,2010.0,4,3,1
SG,DK,2000.0,2,2,0
CA,JM,2021.0,4,2,2
FI,PK,2016.0,4,4,0
MD,RU,2009.0,3,5,-2
ZA,BR,2023.0,1,1,0
AR,PT,2000.0,5,2,3
IE,MX,2006.0,2,2,0
TW,PK,2008.0,1,4,-3
DK,EG,2004.0,2,3,-1
CZ,CA,1999.0,3,4,-1
RO,PT,2009.0,1,3,-2
IR,BY,2016.0,1,2,-1
HK,MY,2019.0,3,1,2
JP,KE,2002.0,6,3,3
UA,MX,2014.0,3,3,0
IN,IQ,2007.0,3,1,2
MZ,DE,2019.0,1,1,0
SE,CM,2014.0,1,1,0
SK,BY,2017.0,4,1,3
DK,PT,2000.0,4,1,3
TW,DK,2009.0,1,2,-1
BE,BG,2001.0,4,4,0
RS,GB,1997.0,1,1,0
CG,IT,2021.0,1,1,0
RU,UZ,2003.0,3,6,-3
TW,PT,2013.0,1,1,0
HR,SE,2000.0,1,1,0
KW,PK,2018.0,4,3,1
ES,SG,2008.0,4,2,2
US,HN,2008.0,1,5,-4
LV,US,2012.0,9,6,3
BG,ES,2015.0,3,4,-1
TW,nan,2010.0,2,4,-2
BJ,TG,2022.0,2,1,1
GH,CH,2018.0,2,4,-2
UA,AT,2004.0,4,4,0
VG,DE,2021.0,1,1,0
SD,GB,2011.0,4,10,-6
AE,DZ,2022.0,3,2,1
nan,SK,2008.0,2,1,1
LB,MA,2018.0,1,3,-2
SS,NL,2015.0,1,1,0
OM,JO,2013.0,2,5,-3
BY,UZ,2010.0,2,2,0
QA,OM,2020.0,3,5,-2
UA,CH,2012.0,7,2,5
DE,PA,2012.0,1,3,-2
UA,CL,2003.0,1,2,-1
TW,US,2015.0,742,731,11
JP,HK,2018.0,11,6,5
US,TH,2009.0,165,98,67
PK,IE,2020.0,16,15,1
ZA,DE,2001.0,16,28,-12
FR,CL,2005.0,19,17,2
US,JM,2014.0,16,14,2
NL,CL,2020.0,18,20,-2
RU,SG,2022.0,3,3,0
CN,MX,2013.0,11,10,1
MY,BN,2017.0,7,9,-2
GB,CL,2010.0,27,20,7
US,GA,2016.0,2,2,0
AU,PT,2014.0,7,16,-9
RS,SE,2015.0,4,2,2
DZ,SG,2020.0,5,2,3
PF,CH,2006.0,1,2,-1
CL,CN,2020.0,4,3,1
UG,JP,2016.0,2,2,0
CH,GB,2017.0,281,362,-81
,IN,2011.0,26612,0,26612
SE,,2014.0,1978,0,1978
KR,,2024.0,44002,0,44002
,FR,2002.0,14642,0,14642
US,,2022.0,155440,0,155440
,IR,2005.0,5679,0,5679
CA,,2021.0,15446,0,15446
,NZ,2010.0,1322,0,1322
CO,,2012.0,434,0,434
,PE,2011.0,864,0,864
TW,,2006.0,925,0,925
,GB,2007.0,16984,0,16984
,FR,2005.0,14536,0,14536
IN,,2025.0,6535,0,6535
,US,2020.0,5314,0,5314
NL,,2020.0,6987,0,6987
,TR,2015.0,5801,0,5801
BR,LB,2007.0,3,0,3
MX,,2006.0,563,0,563
,SE,2010.0,3370,0,3370
,SE,2017.0,2443,0,2443
,MX,2018.0,3894,0,3894
AU,,2008.0,2027,0,2027
,AE,2014.0,427,0,427
,IR,2002.0,2462,0,2462
BE,,2001.0,642,0,642
RU,,2005.0,3065,0,3065
ID,,2016.0,583,0,583
,LV,1998.0,126,0,126
MA,,2024.0,7152,0,7152
,FI,2011.0,2062,0,2062
AT,,2014.0,1363,0,1363
,TH,2003.0,1281,0,1281
,UY,2003.0,176,0,176
,CH,2014.0,4111,0,4111
RU,,2002.0,1660,0,1660
,IQ,2009.0,260,0,260
,GR,1995.0,2480,0,2480
CL,,2006.0,198,0,198
,SE,2019.0,1403,0,1403
CU,BO,2006.0,1,0,1
BW,,2010.0,20,0,20
BG,,2022.0,1228,0,1228
,PA,2004.0,46,0,46
,PH,1994.0,614,0,614
,MZ,1994.0,45,0,45
IR,,2009.0,508,0,508
JO,IN,2016.0,4,0,4
,MW,2009.0,78,0,78
GH,TZ,2015.0,1,0,1
GF,,2023.0,72,0,72
,QA,2007.0,128,0,128
SN,,2020.0,145,0,145
,FJ,2004.0,23,0,23
PS,,2018.0,59,0,59
,BG,2013.0,537,0,537
,KE,2015.0,705,0,705
BW,,2019.0,73,0,73
,SN,2007.0,88,0,88
nan,,2014.0,590,0,590
MG,,2020.0,75,0,75
PK,,2009.0,114,0,114
SA,,2001.0,144,0,144
VN,,2009.0,44,0,44
,NZ,2017.0,1006,0,1006
LB,,2001.0,12,0,12
KE,,2025.0,104,0,104
LT,,2002.0,29,0,29
,GE,1996.0,175,0,175
,GH,2016.0,636,0,636
NA,PL,2016.0,1,0,1
BW,,2017.0,70,0,70
BY,,2004.0,141,0,141
GN,GB,2011.0,1,0,1
RO,,1999.0,57,0,57
NI,,2024.0,122,0,122
,BN,1998.0,10,0,10
ST,,2024.0,41,0,41
CG,,2023.0,222,0,222
SD,PK,2022.0,2,0,2
CI,,2007.0,18,0,18
PH,FR,2004.0,7,0,7
,GE,2004.0,183,0,183
IT,VN,2000.0,3,0,3
,PA,1996.0,30,0,30
,JM,1996.0,50,0,50
PE,,1998.0,18,0,18
NO,SD,2012.0,2,0,2
EC,,2016.0,86,0,86
GN,NL,2013.0,1,0,1
TN,RU,2007.0,1,0,1
ES,UG,2020.0,2,0,2
,NZ,2019.0,588,0,588
nan,MK,2016.0,1,0,1
,BY,2018.0,409,0,409
,NI,2018.0,63,0,63
DZ,UZ,2018.0,1,0,1
,GP,2018.0,11,0,11
RE,CI,2019.0,1,0,1
TZ,CD,2010.0,1,0,1
CZ,,2012.0,999,0,999
IT,LI,2021.0,3,0,3
,AM,1995.0,148,0,148
JO,,2015.0,145,0,145
AE,,2015.0,144,0,144
GB,DJ,2012.0,1,0,1
,LV,1997.0,134,0,134
MO,PL,2001.0,1,0,1
CA,PS,2000.0,1,0,1
ML,,2018.0,29,0,29
GE,SE,2012.0,3,0,3
,MQ,2011.0,19,0,19
BA,,2025.0,28,0,28
PW,,2003.0,1,0,1
,JM,2004.0,49,0,49
GE,AU,2010.0,2,0,2
QA,,2003.0,9,0,9
PA,,2018.0,91,0,91
TH,ET,2018.0,2,0,2
LV,TJ,2018.0,1,0,1
GE,JP,2001.0,1,0,1
ZW,,2003.0,17,0,17
KZ,AZ,2020.0,7,0,7
nan,MC,2004.0,1,0,1
MA,AU,2022.0,4,0,4
CO,UG,2008.0,3,0,3
,BO,2016.0,35,0,35
,AG,2014.0,12,0,12
,CG,1996.0,8,0,8
SM,US,2001.0,1,0,1
MN,DE,2005.0,2,0,2
CA,TZ,2003.0,4,0,4
,CG,2004.0,26,0,26
CZ,LT,2013.0,14,0,14
KE,MX,2022.0,2,0,2
,TN,2020.0,34,0,34
WS,PH,2021.0,1,0,1
BF,CG,2020.0,2,0,2
BE,SN,2009.0,2,0,2
LS,,2023.0,40,0,40
,BW,2009.0,66,0,66
UA,AE,2021.0,1,0,1
IQ,VN,2019.0,1,0,1
,PY,2001.0,15,0,15
BY,ES,2012.0,4,0,4
ZA,PK,1999.0,1,0,1
LK,,2004.0,21,0,21
BE,FI,2000.0,1,0,1
,HT,2012.0,9,0,9
BF,US,2003.0,2,0,2
HN,SE,2015.0,1,0,1
BR,NI,2022.0,1,0,1
MW,,2020.0,93,0,93
TH,AL,2013.0,1,0,1
PH,IR,2001.0,1,0,1
LT,,2005.0,44,0,44
VE,IL,2011.0,1,0,1
TZ,CZ,2009.0,1,0,1
NL,RE,2015.0,1,0,1
LY,,2016.0,42,0,42
ZA,MA,2021.0,5,0,5
SA,PL,1997.0,1,0,1
,VG,1995.0,21,0,21
,BH,1995.0,37,0,37
GM,ML,2018.0,1,0,1
UZ,LA,2019.0,2,0,2
JM,FR,2003.0,2,0,2
FR,AG,2018.0,1,0,1
NC,,2002.0,2,0,2
,GA,1995.0,22,0,22
SD,IL,2014.0,1,0,1
CL,PA,2013.0,7,0,7
YE,SA,2008.0,4,0,4
MR,,2021.0,20,0,20
DO,BR,2006.0,1,0,1
RU,CL,2021.0,2,0,2
FI,VE,2018.0,1,0,1
,SR,2011.0,10,0,10
MK,,2009.0,13,0,13
AO,,2011.0,9,0,9
KR,GR,1999.0,1,0,1
PL,MM,2017.0,2,0,2
BF,CA,2008.0,1,0,1
HR,ME,2008.0,3,0,3
AU,TN,2008.0,1,0,1
ZA,HK,2017.0,3,0,3
AT,KE,2013.0,3,0,3
LV,CN,2003.0,1,0,1
PT,EE,2004.0,1,0,1
nan,LB,2015.0,1,0,1
ZM,,2004.0,5,0,5
LB,MY,2000.0,1,0,1
NG,ML,2020.0,2,0,2
KZ,NZ,2006.0,1,0,1
AG,SE,2021.0,1,0,1
NC,ID,2018.0,1,0,1
MZ,CN,2006.0,1,0,1
MD,,2015.0,45,0,45
JP,KW,2014.0,1,0,1
UG,CN,2000.0,1,0,1
,NC,1994.0,20,0,20
IQ,,2007.0,6,0,6
CM,ET,2017.0,2,0,2
PT,HU,2017.0,3,0,3
AT,BG,2023.0,1,0,1
TR,UA,2001.0,2,0,2
AU,SS,2015.0,2,0,2
PR,IT,2014.0,3,0,3
PH,PL,2006.0,4,0,4
RS,MX,2002.0,4,0,4
CZ,CM,2020.0,1,0,1
ST,PH,2016.0,1,0,1
ES,KE,2014.0,3,0,3
NZ,OM,2008.0,2,0,2
AL,FI,2016.0,1,0,1
KH,,2011.0,8,0,8
AF,GB,2008.0,2,0,2
DO,,2014.0,9,0,9
ML,TH,2020.0,1,0,1
,BN,1997.0,20,0,20
SD,KR,2006.0,2,0,2
TT,,2006.0,8,0,8
CA,BB,2013.0,3,0,3
CA,SY,2004.0,1,0,1
DE,NA,2003.0,2,0,2
BE,BH,2006.0,1,0,1
BW,AU,2004.0,1,0,1
DE,BN,2000.0,1,0,1
AM,,1998.0,8,0,8
TR,GH,2011.0,2,0,2
GP,DE,1997.0,1,0,1
SE,CU,1999.0,1,0,1
UZ,TR,2013.0,1,0,1
BE,PS,2020.0,1,0,1
GF,CA,2019.0,4,0,4
PH,SX,2019.0,1,0,1
PH,CM,2020.0,1,0,1
BN,TW,2018.0,1,0,1
IE,CY,2012.0,1,0,1
RW,BW,2020.0,1,0,1
,KP,2001.0,1,0,1
IR,SI,2020.0,2,0,2
KG,,2012.0,8,0,8
MA,AM,2007.0,2,0,2
TJ,CA,2014.0,1,0,1
VN,PT,2005.0,1,0,1
RU,BD,2013.0,1,0,1
CO,VN,2013.0,1,0,1
EE,GB,2002.0,2,0,2
UG,RW,2015.0,3,0,3
,ZM,2000.0,31,0,31
,MA,2020.0,78,0,78
AU,TT,2021.0,3,0,3
LT,EE,2004.0,1,0,1
CN,EE,2004.0,3,0,3
TO,NC,2013.0,1,0,1
IT,UZ,2015.0,5,0,5
,GL,2017.0,3,0,3
AL,UG,2015.0,1,0,1
SJ,,2007.0,2,0,2
CI,TN,2013.0,4,0,4
,MM,2007.0,16,0,16
,SZ,2006.0,10,0,10
UA,NO,2003.0,2,0,2
VE,HN,2015.0,1,0,1
LT,CA,2022.0,1,0,1
BG,PH,2006.0,1,0,1
DO,CL,2009.0,2,0,2
US,KY,2009.0,1,0,1
MW,TW,2022.0,1,0,1
PH,EC,2002.0,1,0,1
LB,CU,2000.0,1,0,1
JP,NE,2012.0,1,0,1
IL,EG,2009.0,1,0,1
IN,SS,2007.0,1,0,1
HU,TR,2011.0,4,0,4
,FJ,1996.0,8,0,8
UG,BF,2021.0,1,0,1
YE,FR,2012.0,1,0,1
BE,MG,2019.0,2,0,2
OM,RU,2006.0,1,0,1
LR,US,2003.0,2,0,2
NI,MX,2021.0,4,0,4
KG,FR,2015.0,1,0,1
CU,SR,2018.0,1,0,1
JP,BT,2018.0,3,0,3
CL,KR,2006.0,1,0,1
JP,GA,2011.0,1,0,1
DK,GW,2021.0,1,0,1
CU,CA,2004.0,2,0,2
UA,GR,2015.0,1,0,1
,LI,2018.0,14,0,14
AE,GD,2019.0,1,0,1
VN,PS,2020.0,1,0,1
IE,NL,2023.0,2,0,2
CO,TZ,1998.0,1,0,1
NL,CU,2009.0,1,0,1
CM,NE,2002.0,1,0,1
GE,GR,1997.0,1,0,1
ES,TN,1999.0,1,0,1
FO,US,2006.0,2,0,2
JP,CY,2016.0,4,0,4
CH,NC,2018.0,1,0,1
UZ,AU,2003.0,1,0,1
PF,,2014.0,12,0,12
MZ,DE,2017.0,1,0,1
EG,ZA,2013.0,4,0,4
BE,TN,2006.0,1,0,1
MG,CM,2020.0,1,0,1
MX,BG,2012.0,2,0,2
UZ,CN,2002.0,1,0,1
,GL,2010.0,5,0,5
BE,PH,2001.0,1,0,1
BN,NZ,2004.0,1,0,1
MD,IE,2020.0,1,0,1
FI,IS,2021.0,2,0,2
NO,TH,2003.0,1,0,1
AZ,TW,2015.0,1,0,1
SN,MG,2004.0,1,0,1
JO,SK,2020.0,1,0,1
PE,VN,2009.0,1,0,1
GN,CA,2009.0,1,0,1
SL,ES,2017.0,1,0,1
ZM,DE,2006.0,1,0,1
MY,DZ,2015.0,6,0,6
BF,BD,2008.0,1,0,1
,CW,2015.0,6,0,6
SK,BY,2019.0,2,0,2
TW,MW,2006.0,1,0,1
MD,SN,2012.0,1,0,1
FI,QA,1998.0,1,0,1
GF,nan,2019.0,1,0,1
,CF,2014.0,8,0,8
CO,CH,1999.0,1,0,1
XK,HU,2020.0,1,0,1
PH,HR,2019.0,2,0,2
PH,IL,2019.0,4,0,4
ID,RU,2012.0,1,0,1
JP,OM,2001.0,3,0,3
ZW,NL,2009.0,2,0,2
EE,IN,2016.0,4,0,4
IN,BT,2018.0,4,0,4
LB,NZ,2021.0,2,0,2
,GM,1999.0,7,0,7
SD,IE,2020.0,4,0,4
KW,NO,2017.0,1,0,1
MM,TW,2002.0,3,0,3
ID,OM,2008.0,1,0,1
NG,TW,2014.0,2,0,2
EC,BR,1998.0,1,0,1
NL,SI,1999.0,4,0,4
SI,NL,2002.0,4,0,4
ES,KH,2020.0,1,0,1
AE,CN,2006.0,2,0,2
AE,PL,2008.0,1,0,1
CU,CR,1998.0,1,0,1
RU,MY,2001.0,2,0,2
EC,BO,2012.0,2,0,2
AR,BI,2013.0,1,0,1
GB,XK,2012.0,1,0,1
LS,MY,2008.0,1,0,1
GE,,1998.0,16,0,16
MT,BG,2021.0,1,0,1
SE,CD,2015.0,1,0,1
UG,GR,2018.0,2,0,2
LB,KR,2016.0,1,0,1
RS,CL,2003.0,3,0,3
FR,GN,2005.0,1,0,1
TH,EG,2019.0,1,0,1
nan,MA,2007.0,1,0,1
MO,BR,2003.0,1,0,1
SX,GD,2014.0,1,0,1
TW,SK,2022.0,1,0,1
PS,CA,2006.0,1,0,1
SL,,2015.0,2,0,2
BH,IL,2014.0,1,0,1
MX,TW,1997.0,1,0,1
SC,FR,2011.0,1,0,1
SC,CH,2007.0,1,0,1
EC,RU,2009.0,2,0,2
JO,nan,2011.0,1,0,1
PA,NI,2019.0,2,0,2
PL,IS,2012.0,1,0,1
IN,VN,2004.0,1,0,1
CN,AO,2021.0,1,0,1
MX,SA,2012.0,1,0,1
PE,NZ,2017.0,1,0,1
WS,nan,2016.0,1,0,1
RE,MA,2021.0,1,0,1
KE,OM,2013.0,1,0,1
GE,AU,2019.0,1,0,1
KG,IN,2020.0,1,0,1
PA,CO,2005.0,2,0,2
RE,BE,2008.0,1,0,1
BE,AM,2014.0,1,0,1
TJ,AZ,2014.0,1,0,1
SK,TW,2016.0,1,0,1
IL,KE,2003.0,1,0,1
MW,UG,2020.0,4,0,4
VN,KH,2010.0,1,0,1
NL,BJ,2006.0,3,0,3
PH,BG,2012.0,1,0,1
TZ,PK,2017.0,2,0,2
ST,PT,2020.0,3,0,3
NE,MR,2005.0,1,0,1
PL,VE,1999.0,1,0,1
LV,GB,2008.0,2,0,2
BO,CH,2020.0,1,0,1
BY,PL,1998.0,2,0,2
NC,DE,2014.0,1,0,1
NI,CL,2006.0,2,0,2
GY,JM,2002.0,1,0,1
,DJ,2005.0,1,0,1
RO,NO,2008.0,1,0,1
NZ,NL,2023.0,1,0,1
IE,ID,2019.0,3,0,3
BW,CA,2021.0,1,0,1
,GL,2019.0,1,0,1
MK,SI,1999.0,1,0,1
DE,IS,1999.0,1,0,1
IS,MT,2018.0,1,0,1
AU,SD,2017.0,1,0,1
SA,TW,2005.0,1,0,1
CZ,XK,2021.0,1,0,1
HU,MA,2021.0,2,0,2
PW,AU,2018.0,1,0,1
BE,UZ,2022.0,2,0,2
TT,BB,1997.0,1,0,1
BY,UZ,2017.0,1,0,1
TW,UZ,2020.0,1,0,1
UA,RO,2008.0,3,0,3
ER,BH,2018.0,1,0,1
KE,PE,2012.0,1,0,1
JO,NZ,2020.0,2,0,2
KH,ES,2002.0,1,0,1
GB,MC,2012.0,1,0,1
QA,IQ,2009.0,1,0,1
MD,DZ,2015.0,1,0,1
MK,AL,2016.0,2,0,2
EG,ZW,2010.0,1,0,1
,SO,2012.0,1,0,1
GT,BO,2016.0,1,0,1
LT,JP,2021.0,3,0,3
CI,SN,2003.0,1,0,1
ES,TZ,2013.0,2,0,2
NP,SD,2019.0,1,0,1
PK,VN,2013.0,1,0,1
KE,RU,2016.0,1,0,1
CY,PS,2013.0,1,0,1
IN,CD,2016.0,1,0,1
FR,XK,2012.0,2,0,2
NG,SV,2013.0,1,0,1
TH,EG,2017.0,1,0,1
IE,MT,2014.0,2,0,2
PH,IL,2017.0,3,0,3
LV,SA,2015.0,2,0,2
BG,CL,2002.0,1,0,1
KW,NZ,2003.0,1,0,1
LU,SE,2005.0,1,0,1
BT,FR,2019.0,1,0,1
XK,,2025.0,8,0,8
TW,HK,2005.0,1,0,1
TR,BH,2012.0,2,0,2
NZ,SX,2013.0,1,0,1
LS,NG,2011.0,1,0,1
GM,CA,2021.0,1,0,1
AO,ES,2009.0,1,0,1
AU,MC,2016.0,1,0,1
TH,LK,2001.0,2,0,2
MW,NO,2021.0,1,0,1
AZ,HU,2018.0,1,0,1
MK,ID,2014.0,1,0,1
BA,BE,2002.0,1,0,1
BR,BJ,2010.0,1,0,1
JO,PS,1999.0,1,0,1
CR,DK,2012.0,2,0,2
RO,PG,2012.0,1,0,1
AM,TR,2002.0,1,0,1
BY,JP,2021.0,2,0,2
LV,BE,2021.0,1,0,1
NZ,TT,2017.0,1,0,1
AR,MC,2006.0,1,0,1
RS,UA,2015.0,1,0,1
LU,SE,2002.0,1,0,1
CM,BW,2017.0,1,0,1
GD,CA,2014.0,2,0,2
ZM,RW,2012.0,2,0,2
NZ,PE,2014.0,3,0,3
PH,LV,2006.0,1,0,1
NL,SV,2000.0,1,0,1
PE,IN,2019.0,2,0,2
CH,TW,2004.0,3,0,3
PE,CV,2007.0,1,0,1
BR,GW,2012.0,1,0,1
BR,MD,2012.0,2,0,2
CI,IT,2022.0,1,0,1
TH,KZ,2018.0,2,0,2
IE,RS,2022.0,1,0,1
BY,UZ,2019.0,2,0,2
IR,AD,2013.0,2,0,2
IN,WS,2019.0,1,0,1
NL,BD,2005.0,1,0,1
CH,NA,2008.0,1,0,1
ER,GB,2010.0,1,0,1
CO,LV,2021.0,1,0,1
ZA,SG,2009.0,1,0,1
NG,BW,2008.0,2,0,2
,SY,2020.0,17,0,17
IT,MC,2011.0,1,0,1
IQ,SD,2006.0,1,0,1
MZ,IT,2016.0,2,0,2
PK,BT,2014.0,1,0,1
HK,HR,2007.0,1,0,1
ZW,CD,2020.0,2,0,2
KR,LB,2012.0,1,0,1
BI,CM,2005.0,1,0,1
US,GN,2017.0,3,0,3
SS,PE,2008.0,1,0,1
NP,FI,2014.0,1,0,1
IE,SK,1998.0,2,0,2
GE,AM,2013.0,1,0,1
EC,PT,2013.0,1,0,1
AT,JO,2005.0,1,0,1
CY,MY,2015.0,1,0,1
NZ,TT,2019.0,2,0,2
SI,BI,2019.0,1,0,1
AL,FR,2018.0,1,0,1
BO,BR,2002.0,1,0,1
FI,JO,2021.0,1,0,1
EG,PT,2007.0,1,0,1
MD,GP,2000.0,1,0,1
US,TG,2009.0,1,0,1
FI,KZ,2016.0,1,0,1
CI,GB,2012.0,4,0,4
GA,KH,2016.0,1,0,1
BA,FR,2021.0,1,0,1
KW,RS,2020.0,1,0,1
EG,SE,1998.0,1,0,1
ZA,SZ,2005.0,1,0,1
MK,CZ,2004.0,1,0,1
SG,CL,2010.0,1,0,1
US,SL,1999.0,1,0,1
BB,BR,2012.0,1,0,1
NL,MW,2021.0,2,0,2
CA,GF,2005.0,1,0,1
AT,AE,2012.0,1,0,1
NL,DZ,2019.0,1,0,1
SD,ID,2008.0,1,0,1
FJ,TO,2020.0,1,0,1
HK,IN,2019.0,1,0,1
DZ,PL,2015.0,1,0,1
MY,QA,2004.0,1,0,1
SD,BJ,2007.0,1,0,1
BG,SK,2020.0,1,0,1
PE,IN,2017.0,1,3,-2
CH,TN,2000.0,2,3,-1
JO,CN,2020.0,3,8,-5
NP,MY,2015.0,1,2,-1
SL,GB,2018.0,1,1,0
UY,CL,1998.0,3,2,1
SI,RS,2002.0,2,4,-2
NL,UA,2009.0,2,6,-4
DZ,QA,2019.0,1,1,0
KZ,RS,2013.0,1,7,-6
IS,ES,2012.0,3,6,-3
UA,HU,2013.0,1,2,-1
TR,TW,1999.0,2,3,-1
PT,HU,2010.0,1,2,-1
KR,AM,2021.0,2,1,1
UG,NL,2001.0,1,4,-3
BG,PL,2019.0,1,1,0
AT,MY,2020.0,2,3,-1
CO,ZA,2006.0,1,1,0
TH,IT,2019.0,3,4,-1
GA,CM,2021.0,1,1,0
EG,NG,2012.0,2,7,-5
MW,DE,2018.0,1,1,0
BR,LU,2018.0,5,3,2
RU,GR,1999.0,1,2,-1
MX,VN,2007.0,1,1,0
AE,IT,2010.0,1,1,0
LY,TR,2018.0,2,1,1
IE,IL,2005.0,2,2,0
FR,UY,2021.0,1,3,-2
AT,PH,2015.0,1,1,0
VE,NI,2018.0,1,1,0
EG,AT,2012.0,2,3,-1
CA,EE,2018.0,1,2,-1
QA,NL,2008.0,1,3,-2
EG,AU,2000.0,1,1,0
IR,JP,2004.0,2,8,-6
AR,TW,2005.0,1,8,-7
IE,ES,2000.0,2,2,0
NL,IS,2020.0,2,4,-2
UA,ES,2008.0,1,2,-1
VN,HU,2020.0,1,3,-2
ZM,NO,2019.0,2,2,0
PL,QA,2018.0,1,2,-1
PH,NO,2004.0,2,1,1
ES,GT,2003.0,1,3,-2
SY,AE,2020.0,2,2,0
MK,MY,2015.0,2,1,1
PE,BD,2017.0,1,1,0
TH,NZ,2020.0,3,4,-1
BD,PE,2017.0,1,1,0
EG,IQ,2003.0,1,1,0
UG,ZW,2018.0,1,1,0
SY,TN,2019.0,2,2,0
PT,HR,2018.0,1,1,0
RW,BE,2009.0,1,1,0
SA,AT,2010.0,1,2,-1
HN,CR,2016.0,1,1,0
DE,MW,2013.0,1,1,0
LT,BE,2018.0,2,2,0
SI,IL,2019.0,1,2,-1
BE,NP,2011.0,1,2,-1
CH,CM,2020.0,2,7,-5
MY,MK,2013.0,1,2,-1
ZA,RW,2022.0,2,4,-2
TN,KW,2009.0,2,1,1
US,NI,2010.0,1,1,0
TR,OM,2001.0,1,1,0
IL,BY,2008.0,1,1,0
CZ,HR,2001.0,1,1,0
UY,CR,2018.0,2,5,-3
BH,GB,2001.0,1,4,-3
PH,MY,2013.0,2,5,-3
KE,CH,2002.0,1,2,-1
FR,KH,2012.0,2,5,-3
OM,BD,2016.0,1,3,-2
nan,HK,2012.0,1,1,0
GB,MU,1998.0,1,2,-1
CZ,AE,2012.0,1,2,-1
BY,VN,2012.0,1,1,0
TW,ZA,2004.0,1,1,0
UA,BY,2001.0,1,3,-2
UG,KE,2010.0,2,5,-3
LY,US,2012.0,2,1,1
IT,BA,2017.0,1,1,0
GB,BY,1999.0,2,2,0
US,BZ,2006.0,1,1,0
UA,LT,2009.0,1,1,0
VN,BE,2004.0,1,4,-3
NZ,MY,2006.0,2,2,0
DZ,HU,2020.0,1,1,0
ZA,HU,2001.0,1,1,0
BI,DE,2016.0,1,1,0
NL,DZ,2010.0,1,1,0
MM,TR,2018.0,1,5,-4
NL,BG,2010.0,1,3,-2
BR,BG,2014.0,1,1,0
CM,DE,1999.0,1,2,-1
BE,ZW,2011.0,1,1,0
BJ,CA,2010.0,1,2,-1
BR,BJ,2017.0,2,1,1
PH,RU,2011.0,1,2,-1
AE,AR,2012.0,1,1,0
CR,nan,2008.0,2,1,1
SA,AT,2019.0,2,7,-5
FR,CF,1998.0,1,1,0
MY,EG,2006.0,1,11,-10
ID,CL,2013.0,2,2,0
GA,FR,2002.0,1,2,-1
MX,PL,1999.0,1,2,-1
SY,JP,2020.0,1,1,0
IR,BE,2023.0,1,1,0
AT,CY,2018.0,1,2,-1
ES,ME,2020.0,1,2,-1
TW,BE,2001.0,2,1,1
GB,PG,2010.0,2,1,1
DZ,QA,2017.0,1,1,0
KH,JP,2009.0,2,3,-1
PT,GR,2015.0,2,1,1
GB,RW,2012.0,1,1,0
AT,LB,2022.0,1,2,-1
RU,HR,2001.0,1,1,0
MY,DK,2001.0,1,1,0
DK,TH,2004.0,1,1,0
RS,GB,1998.0,1,7,-6
QA,TN,2019.0,3,12,-9
BG,EE,2020.0,1,1,0
NO,TW,2007.0,1,1,0
LK,ZA,2010.0,1,1,0
DZ,GB,1998.0,1,3,-2
LK,ZA,2017.0,1,2,-1
CH,LI,2005.0,1,1,0
UA,TR,1999.0,1,2,-1
US,JE,2008.0,1,1,0
RE,GB,2017.0,1,2,-1
CA,BW,2009.0,1,2,-1
KE,NO,2019.0,1,4,-3
LK,GR,2020.0,2,4,-2
RS,PK,2008.0,1,1,0
AR,TN,2021.0,1,1,0
ER,GB,2019.0,1,1,0
CA,PH,1999.0,1,4,-3
PK,RS,2012.0,1,2,-1
EE,MX,2018.0,1,3,-2
PY,ES,2014.0,1,13,-12
ML,DE,2013.0,1,1,0
IT,BD,2005.0,1,1,0
SK,BA,2017.0,1,1,0
IE,JO,2020.0,1,5,-4
CL,IE,2019.0,1,2,-1
KZ,MX,2015.0,1,1,0
CY,KR,2017.0,1,1,0
TN,BH,2017.0,1,1,0
PE,NO,2020.0,1,1,0
PH,TR,2018.0,1,1,0
SI,SE,2000.0,1,4,-3
AU,ZW,2017.0,1,1,0
BY,HU,2011.0,2,1,1
KZ,MN,2022.0,1,2,-1
RS,BG,1997.0,1,1,0
RU,MM,2020.0,1,1,0
LV,FI,2020.0,3,2,1
US,GF,2021.0,2,1,1
SE,OM,2008.0,1,1,0
PA,IT,2016.0,1,2,-1
MM,CN,1999.0,1,4,-3
LK,ZA,2019.0,2,2,0
PH,EG,2020.0,1,5,-4
ZW,nan,2020.0,1,1,0
HR,NG,2016.0,1,0,1
KZ,BH,2022.0,1,0,1
IE,UY,2008.0,1,0,1
MT,PS,2011.0,1,0,1
BD,OM,2002.0,2,0,2
BG,PT,2000.0,2,0,2
CN,LA,2022.0,1,0,1
DZ,SD,2012.0,1,0,1
KE,MW,2007.0,1,0,1
SD,BE,2013.0,1,0,1
XK,ZA,2016.0,1,0,1
SN,TD,2016.0,1,0,1
UG,IT,2022.0,4,0,4
HR,MX,2003.0,1,0,1
VN,NO,2006.0,1,0,1
FR,PA,2011.0,2,0,2
UY,MY,2007.0,1,0,1
KE,NA,2019.0,4,0,4
IS,FO,2005.0,1,0,1
TH,BE,1997.0,1,0,1
US,MG,2000.0,1,0,1
SK,CY,2019.0,1,0,1
TN,CI,2019.0,1,0,1
NL,GT,2019.0,1,0,1
AU,PE,2002.0,1,0,1
SO,MY,2018.0,1,0,1
PA,RU,2016.0,1,0,1
AL,SI,2018.0,1,0,1
JP,KZ,2011.0,6,0,6
SI,LB,2015.0,1,0,1
LK,PT,2009.0,1,0,1
AT,BF,2018.0,2,0,2
UY,CI,2004.0,1,0,1
KY,DE,2021.0,1,0,1
DK,BJ,2012.0,1,0,1
LR,,2018.0,1,0,1
RO,TW,2003.0,1,0,1
UA,AM,2012.0,2,0,2
DE,BB,2017.0,2,0,2
MD,ES,2015.0,1,0,1
HN,RU,2020.0,1,0,1
MA,KE,2003.0,1,0,1
UZ,LV,2019.0,1,0,1
MX,UY,2000.0,1,0,1
TN,CI,2010.0,1,0,1
NE,TH,2015.0,1,0,1
HR,AR,2020.0,1,0,1
BY,NO,2011.0,1,0,1
MN,DZ,2013.0,2,0,2
GE,RS,2011.0,1,0,1
PT,RS,2009.0,3,0,3
ZM,NO,2017.0,1,0,1
AL,PL,2019.0,1,0,1
SO,SY,2020.0,1,0,1
LK,IT,2015.0,1,0,1
SE,TJ,2008.0,1,0,1
SI,ZA,2014.0,1,0,1
AU,PE,2005.0,1,0,1
AT,GE,2017.0,1,0,1
FI,AE,2005.0,1,0,1
CO,PL,2007.0,2,0,2
LK,DE,2009.0,2,0,2
UZ,TJ,2011.0,1,0,1
GR,HR,2012.0,1,0,1
BE,MG,2010.0,1,0,1
UG,UY,2017.0,1,0,1
PS,ID,2013.0,1,0,1
SV,AR,2002.0,2,0,2
SV,AR,2005.0,1,0,1
TR,NZ,2004.0,1,0,1
BE,GM,2021.0,1,0,1
YE,AE,1997.0,1,0,1
UG,UY,2019.0,1,0,1
TR,NO,1999.0,1,0,1
GB,NC,2013.0,1,0,1
SD,SG,2022.0,1,0,1
BY,AU,2016.0,1,0,1
GR,BG,2008.0,2,0,2
AU,CZ,1998.0,4,0,4
RO,LT,2013.0,1,0,1
FR,HT,2004.0,1,0,1
GN,ML,2002.0,1,0,1
BO,GB,2007.0,1,0,1
GL,GB,2005.0,1,0,1
PT,CO,2000.0,1,0,1
MZ,CA,1998.0,1,0,1
CH,BA,2015.0,1,0,1
BY,SA,2011.0,1,0,1
CH,LI,2002.0,1,0,1
IQ,BH,2012.0,1,0,1
ZW,PL,1997.0,1,0,1
MD,MG,2000.0,1,0,1
IN,HR,2000.0,1,0,1
JP,MR,2012.0,1,0,1
BE,BI,2012.0,1,0,1
DO,CH,2006.0,1,0,1
US,BM,2007.0,2,0,2
AR,PR,2018.0,1,0,1
KE,MY,2008.0,1,0,1
ES,RE,2005.0,1,0,1
PY,CA,2021.0,1,0,1
PE,DE,1998.0,1,0,1
MY,CO,2006.0,1,0,1
YE,SD,2001.0,1,0,1
VE,EC,2005.0,1,0,1
AR,NO,1998.0,1,0,1
CZ,PG,2020.0,1,0,1
LV,FR,2017.0,1,0,1
NG,TN,2000.0,1,0,1
ZW,NA,2014.0,1,0,1
VN,KE,2022.0,1,0,1
AU,IS,2007.0,1,0,1
DK,RU,2023.0,1,0,1
OM,NO,2015.0,1,0,1
SE,MA,2015.0,1,0,1
GP,RU,2012.0,1,0,1
MX,AE,2005.0,1,0,1
BO,EC,2003.0,1,0,1
GR,ME,2019.0,1,0,1
DK,LA,2018.0,1,0,1
GB,SM,1999.0,1,0,1
SM,GB,2000.0,1,0,1
LB,PS,2005.0,1,0,1
AZ,FR,2020.0,1,0,1
FR,BZ,2018.0,1,0,1
PK,UG,2007.0,1,0,1
HN,BR,1998.0,1,0,1
DO,ES,2008.0,2,0,2
HU,BD,2008.0,1,0,1
JP,SK,2022.0,1,0,1
DK,AM,2005.0,1,0,1
BR,WS,2015.0,1,0,1
FI,CO,2011.0,1,0,1
ES,GE,2007.0,1,0,1
IN,CO,1999.0,1,0,1
CA,KZ,2014.0,1,0,1
GW,PT,2016.0,1,0,1
CN,SS,2020.0,1,0,1
LV,CM,2020.0,1,0,1
DZ,GF,2019.0,1,0,1
US,ER,2016.0,1,0,1
MW,MY,2015.0,1,0,1
BE,NC,2016.0,1,0,1
NL,AE,2006.0,1,0,1
ZA,BI,1998.0,1,0,1
DZ,CZ,2021.0,1,0,1
IR,CH,1999.0,1,0,1
EG,UG,2007.0,1,0,1
MA,FI,2018.0,1,0,1
EG,ZW,2019.0,1,0,1
BR,DO,2008.0,1,0,1
RO,RS,2013.0,1,0,1
TL,BR,2015.0,1,0,1
PK,MT,2018.0,1,0,1
TH,EG,2010.0,1,0,1
NI,RU,2015.0,1,0,1
DE,AF,2006.0,1,0,1
AO,NG,2005.0,1,0,1
CA,MT,2022.0,1,0,1
MA,LV,2020.0,1,0,1
LK,SY,2012.0,1,0,1
CL,SI,2019.0,1,0,1
EG,SE,1997.0,1,0,1
CO,AE,2013.0,1,0,1
AR,SG,2008.0,1,0,1
UZ,UA,2003.0,1,0,1
GE,KW,2017.0,1,0,1
PS,GR,2018.0,1,0,1
ML,ES,2012.0,1,0,1
SN,SA,2013.0,1,0,1
LV,FR,2010.0,1,0,1
GT,PE,2005.0,1,0,1
nan,TN,2005.0,1,0,1
GH,SE,2005.0,1,0,1
RU,OM,2020.0,2,0,2
LB,TR,2004.0,1,0,1
NL,GT,2017.0,1,0,1
ES,KZ,2014.0,1,0,1
SD,AE,2005.0,1,0,1
IE,LT,2013.0,1,0,1
BD,QA,2010.0,1,0,1
SG,NO,1998.0,1,0,1
GI,LK,2009.0,1,0,1
TZ,IL,2006.0,1,0,1
FR,ZM,1999.0,1,0,1
FI,SK,2018.0,1,0,1
NG,AU,2023.0,1,0,1
AU,MZ,2008.0,1,0,1
GE,BR,2003.0,1,0,1
AR,VN,2022.0,1,0,1
IQ,NL,2021.0,1,0,1
CL,RE,2022.0,1,0,1
GH,BF,2013.0,1,0,1
,PH,2021.0,1,0,1
TN,CI,2017.0,1,0,1
AF,JP,2023.0,1,0,1
MX,ML,2004.0,1,0,1
MZ,PT,2023.0,1,0,1
CO,CL,2006.0,55,92,-37
GB,NZ,1999.0,110,101,9
AR,US,2020.0,285,269,16
AU,PK,2017.0,43,38,5
ES,CL,2017.0,445,369,76
RU,US,2009.0,447,304,143
CL,MX,2010.0,120,120,0
ES,FR,2021.0,243,240,3
RO,CA,2005.0,9,3,6
CH,IT,2018.0,277,405,-128
BE,HU,2007.0,8,10,-2
JP,UA,2013.0,10,8,2
NZ,AU,2002.0,84,68,16
DE,CN,2016.0,327,326,1
BR,SE,1998.0,5,7,-2
nan,CN,2013.0,140,136,4
GB,BE,2004.0,68,66,2
SE,US,2019.0,573,533,40
US,TR,2005.0,326,235,91
ES,AT,2013.0,31,22,9
ES,AR,2019.0,427,433,-6
US,nan,2010.0,268,229,39
US,SG,2021.0,411,409,2
GB,KR,2014.0,92,115,-23
GB,AT,2015.0,112,126,-14
AU,US,1999.0,987,1107,-120
GB,ZA,2013.0,147,157,-10
GT,US,2010.0,7,6,1
SA,EG,2016.0,403,315,88
BR,IT,2017.0,288,279,9
ID,FR,2008.0,6,9,-3
ES,AR,2010.0,284,265,19
CA,AU,2010.0,354,310,44
ES,MX,2017.0,997,880,117
US,CZ,2021.0,135,113,22
CL,MX,2017.0,213,233,-20
ES,US,1999.0,405,370,35
DE,BE,2020.0,148,157,-9
IN,SE,2001.0,16,16,0
ES,BE,2020.0,119,108,11
NL,US,1999.0,315,298,17
CN,GB,2016.0,534,576,-42
CL,MX,2019.0,232,268,-36
BR,MX,2019.0,182,187,-5
NL,CA,2017.0,87,84,3
FR,IT,2005.0,217,243,-26
ZA,GB,2013.0,157,147,10
BR,IT,2010.0,162,216,-54
IN,BE,2010.0,30,10,20
SE,DK,2003.0,51,52,-1
ES,MX,2019.0,988,1089,-101
SE,FR,2012.0,65,73,-8
ES,IN,2018.0,33,23,10
ES,CL,2010.0,247,253,-6
CL,PT,1999.0,2,1,1
QA,CN,2015.0,16,29,-13
SE,US,2017.0,539,526,13
TW,CN,2008.0,1098,702,396
nan,PE,2013.0,10,7,3
CA,ZA,2004.0,19,23,-4
ZA,GR,2020.0,2,4,-2
ES,SI,2018.0,14,12,2
AU,SE,1999.0,24,28,-4
GB,IN,1997.0,57,70,-13
NL,ZA,2014.0,67,43,24
US,nan,2017.0,294,273,21
nan,IN,2016.0,60,70,-10
ES,MX,2010.0,558,603,-45
MX,CL,2018.0,219,216,3
AE,KW,2018.0,5,6,-1
EC,US,2023.0,3,1,2
SE,CA,2001.0,35,20,15
CA,AU,2019.0,474,429,45
HK,NL,2013.0,15,11,4
CL,CO,2009.0,127,114,13
CA,AU,2017.0,418,373,45
ZA,FI,2020.0,10,4,6
FR,TW,2005.0,20,17,3
PK,ID,2016.0,43,12,31
BR,CN,2007.0,37,16,21
PG,AU,2020.0,8,4,4
US,TR,2002.0,236,202,34
nan,NL,2000.0,26,21,5
TH,GB,2020.0,43,81,-38
DE,IT,2012.0,211,324,-113
IE,IN,2003.0,5,7,-2
GB,CN,1997.0,101,59,42
UY,US,1999.0,8,5,3
IN,ES,2012.0,29,19,10
IN,IT,2002.0,42,25,17
NL,nan,2016.0,73,69,4
VN,KR,2017.0,54,82,-28
FR,MD,1999.0,45,47,-2
IT,LB,2015.0,16,21,-5
IT,nan,2006.0,93,69,24
FR,IT,2002.0,182,185,-3
CN,RU,2011.0,65,48,17
FI,SE,2007.0,68,68,0
ID,MY,2018.0,171,470,-299
FR,SY,2017.0,10,11,-1
FR,IE,2022.0,18,15,3
DE,JP,1999.0,110,131,-21
GB,RU,2012.0,70,88,-18
FR,VE,2014.0,6,9,-3
IT,DE,1999.0,124,94,30
TW,SG,1998.0,12,8,4
CO,ES,2008.0,240,220,20
AU,IE,2011.0,92,104,-12
US,nan,2019.0,330,288,42
US,LR,2021.0,4,3,1
VE,US,2006.0,43,35,8
AT,CN,2009.0,13,11,2
MY,IN,2011.0,60,96,-36
CL,BO,2016.0,12,7,5
AE,IN,2015.0,37,60,-23
NO,CN,2014.0,37,42,-5
ES,VE,2015.0,59,84,-25
BD,MY,2012.0,37,23,14
nan,FI,1999.0,5,1,4
BD,GB,2010.0,39,48,-9
AR,MX,2010.0,80,96,-16
BR,RU,2003.0,2,8,-6
SE,US,2010.0,366,364,2
HR,BA,2018.0,46,50,-4
DK,IN,2020.0,19,32,-13
RU,FR,2018.0,77,101,-24
JP,AU,2006.0,77,54,23
GB,CN,1998.0,129,95,34
KR,CN,2004.0,169,157,12
ES,AR,2017.0,407,396,11
LV,RU,2018.0,23,12,11
BD,GB,2019.0,70,53,17
US,CO,2004.0,87,94,-7
RU,DE,2018.0,179,240,-61
ID,GB,2022.0,40,27,13
BR,MX,2017.0,149,151,-2
GB,CH,2001.0,115,142,-27
RS,DE,2011.0,21,20,1
BO,CN,2007.0,4,3,1
CO,VE,2011.0,40,48,-8
CU,CO,2004.0,4,3,1
CN,FR,2012.0,153,253,-100
CN,NP,2003.0,2,1,1
DE,CH,2000.0,387,357,30
CN,CH,2015.0,78,83,-5
CZ,CN,2006.0,60,30,30
RU,BG,2006.0,19,14,5
BE,DE,2013.0,112,135,-23
AU,PK,2019.0,49,69,-20
TR,CN,2020.0,30,17,13
FR,CH,2000.0,202,173,29
GB,AE,2013.0,45,19,26
LT,LV,2020.0,2,1,1
IE,GB,2000.0,113,117,-4
AR,MX,2017.0,197,147,50
IN,KR,2009.0,134,90,44
CH,BG,2011.0,3,7,-4
BE,FR,2012.0,279,318,-39
SE,JP,2006.0,44,29,15
IT,CH,2008.0,231,151,80
LK,CN,2012.0,6,5,1
ES,PT,2008.0,103,82,21
CH,CN,2015.0,83,78,5
PT,ES,2014.0,162,174,-12
SE,DE,2011.0,161,223,-62
JP,BG,2016.0,6,3,3
IR,BE,2011.0,15,13,2
EG,IN,2021.0,14,17,-3
BY,RU,2019.0,146,86,60
SA,MY,2016.0,33,81,-48
FI,GB,2017.0,89,66,23
BR,CA,2004.0,115,131,-16
CH,MY,2013.0,6,4,2
CN,IE,2018.0,35,41,-6
IN,AT,2020.0,18,8,10
CA,SA,2013.0,101,44,57
GB,nan,2006.0,86,67,19
NL,CZ,2013.0,17,15,2
EG,IQ,2014.0,11,12,-1
IN,BE,2019.0,58,44,14
GH,JP,2017.0,4,6,-2
CA,RU,2017.0,43,19,24
NL,AU,2000.0,19,29,-10
AR,FR,2021.0,65,67,-2
EC,BR,2008.0,5,4,1
RU,SE,2020.0,38,39,-1
AU,BD,2019.0,72,122,-50
AU,JO,2011.0,8,3,5
CN,KR,2016.0,273,303,-30
FR,CO,2017.0,51,38,13
MY,IQ,2021.0,69,40,29
PK,CA,2021.0,53,22,31
NZ,AU,2005.0,135,99,36
DE,DK,2022.0,110,95,15
CH,HU,2013.0,15,18,-3
JP,nan,2017.0,37,71,-34
CZ,LV,2015.0,2,1,1
US,IL,2000.0,315,340,-25
CA,NL,2022.0,43,53,-10
BE,BJ,2020.0,7,3,4
NZ,DE,2007.0,29,32,-3
CA,RU,2010.0,16,21,-5
DK,AT,2010.0,8,8,0
CA,SG,2013.0,42,33,9
TW,EG,2014.0,16,6,10
IE,SA,2018.0,10,5,5
NO,SA,2019.0,5,4,1
TJ,US,2017.0,2,1,1
PK,IN,2007.0,49,48,1
CA,ID,2021.0,60,40,20
DE,EG,2007.0,32,25,7
AR,MX,2019.0,184,208,-24
MX,CA,2022.0,31,17,14
CO,AR,1998.0,9,5,4
ZA,BW,2006.0,4,6,-2
DE,AU,2006.0,158,115,43
BE,AT,2016.0,18,15,3
JP,CO,2021.0,14,8,6
MX,PH,2019.0,20,13,7
ZA,NO,2018.0,7,4,3
MY,TH,2011.0,2,2,0
TR,AZ,2015.0,12,8,4
BD,GB,2017.0,50,39,11
UG,NZ,2016.0,4,6,-2
SA,NG,2014.0,9,9,0
CZ,ES,2006.0,6,2,4
CH,CL,2014.0,17,10,7
nan,IL,2020.0,32,19,13
HU,FR,2005.0,22,14,8
IR,ES,2020.0,28,9,19
JP,nan,2010.0,44,44,0
nan,JP,2014.0,43,39,4
JP,nan,2019.0,46,43,3
AT,CH,2022.0,60,62,-2
JP,TW,2007.0,68,50,18
AU,CH,2021.0,66,72,-6
PE,AR,2016.0,50,46,4
SG,DE,2021.0,28,28,0
CZ,US,2001.0,67,61,6
CA,BF,2016.0,4,2,2
SE,PE,2017.0,3,1,2
JO,MY,2011.0,5,10,-5
IT,AM,2021.0,35,30,5
TR,MY,2009.0,2,2,0
DE,LU,2015.0,37,22,15
CN,BR,2003.0,16,10,6
SZ,ZA,2019.0,8,9,-1
IL,CH,2022.0,8,9,-1
PK,SA,2014.0,64,38,26
IE,NZ,2022.0,12,9,3
LB,CH,2020.0,3,5,-2
SE,SG,2014.0,15,10,5
AR,CO,2004.0,24,17,7
AU,DE,2008.0,160,184,-24
MD,TN,2012.0,17,4,13
DE,IQ,2009.0,2,1,1
GB,MK,2009.0,5,2,3
nan,FR,2002.0,60,88,-28
IT,MX,2017.0,47,39,8
IE,NO,2009.0,4,2,2
LT,GB,2015.0,3,8,-5
BR,KR,2019.0,9,11,-2
BD,ID,2018.0,54,34,20
US,VN,2011.0,59,34,25
IT,AT,2018.0,89,72,17
NL,DE,2000.0,143,152,-9
RO,ES,2018.0,20,14,6
NL,IE,2017.0,27,16,11
NL,IE,2019.0,30,33,-3
CH,RU,2000.0,15,17,-2
CH,UA,2014.0,4,10,-6
PL,FR,2005.0,45,48,-3
BY,RU,2010.0,50,54,-4
NG,MY,2020.0,65,138,-73
KE,CA,2013.0,4,10,-6
FI,BE,2021.0,8,15,-7
CR,AR,2011.0,11,7,4
BR,VE,2007.0,14,17,-3
BO,ES,2018.0,23,24,-1
ES,CN,2022.0,36,52,-16
DE,CR,2022.0,1,2,-1
GB,PK,2012.0,139,79,60
FR,BF,2019.0,21,29,-8
NG,JP,2015.0,18,13,5
NG,IQ,2021.0,6,4,2
GR,EC,2009.0,4,1,3
TN,NL,2012.0,1,2,-1
FR,TW,2002.0,24,10,14
IR,NL,2010.0,30,15,15
GB,QA,2006.0,5,5,0
US,CM,2013.0,11,17,-6
NO,NL,2016.0,34,50,-16
GB,IN,1998.0,68,97,-29
BE,BR,2013.0,98,55,43
AR,DK,2016.0,5,6,-1
DE,IE,2022.0,51,43,8
IN,PK,2023.0,25,2,23
EG,RU,2022.0,10,22,-12
PT,CH,2004.0,5,4,1
MY,VN,2015.0,3,3,0
FR,NO,2009.0,47,46,1
CI,CH,2017.0,2,2,0
CA,TR,2020.0,23,49,-26
CH,NL,2007.0,50,68,-18
NO,GR,2022.0,4,4,0
LB,GB,2021.0,11,8,3
EE,RU,2007.0,3,9,-6
BR,PE,2012.0,38,32,6
DZ,IR,2019.0,3,5,-2
US,JM,2003.0,12,12,0
HN,CO,2017.0,7,5,2
VN,KR,2019.0,34,144,-110
SE,RW,2021.0,3,8,-5
SG,KR,2021.0,22,27,-5
CA,IL,2023.0,3,5,-2
FI,SI,2021.0,1,2,-1
AT,IN,2012.0,13,17,-4
TZ,CN,2018.0,6,8,-2
RS,HR,2012.0,105,141,-36
FR,BF,2017.0,23,11,12
IR,NL,2019.0,65,45,20
DZ,TR,2021.0,5,1,4
RU,AZ,2022.0,11,9,2
GH,JP,2019.0,8,9,-1
VN,CN,2022.0,34,24,10
MX,ES,2023.0,12,25,-13
ES,ID,2020.0,16,21,-5
NL,PL,2009.0,14,17,-3
KR,CZ,2019.0,10,10,0
CA,DE,2006.0,166,206,-40
NO,JP,2020.0,14,6,8
nan,BR,2014.0,100,82,18
FI,GB,2019.0,55,98,-43
PR,US,1997.0,7,2,5
SE,PL,2019.0,22,39,-17
NL,GB,2022.0,190,244,-54
BO,MX,2018.0,7,14,-7
NL,VN,2010.0,4,2,2
IL,CR,2016.0,1,1,0
IN,IR,2018.0,40,31,9
CZ,MY,2019.0,7,10,-3
ES,GR,2020.0,17,15,2
PL,SK,2018.0,15,9,6
BR,KR,2017.0,6,5,1
DE,HR,2021.0,15,18,-3
VN,RU,2021.0,8,6,2
IL,NL,2021.0,16,11,5
FR,PT,2008.0,47,37,10
DE,CL,2013.0,43,42,1
CZ,IL,2013.0,2,3,-1
KR,CL,2019.0,5,3,2
CU,ES,2016.0,109,81,28
KE,SE,2015.0,3,3,0
IN,GR,2014.0,6,2,4
US,SK,2013.0,34,27,7
RS,US,2013.0,57,67,-10
IL,AU,2015.0,20,17,3
ID,PK,2016.0,12,43,-31
BG,BR,2016.0,1,4,-3
AT,MK,2017.0,17,18,-1
VN,DE,2021.0,16,23,-7
AE,MA,2013.0,1,2,-1
DE,GA,2015.0,9,4,5
CZ,DE,2012.0,49,67,-18
TR,CY,2009.0,10,10,0
NG,KR,2016.0,9,7,2
NO,TZ,2019.0,12,3,9
FR,CO,2010.0,25,15,10
CW,NL,2008.0,11,4,7
NL,CA,2010.0,84,83,1
CN,SK,2014.0,4,1,3
MX,GB,2003.0,39,41,-2
NL,HU,2018.0,13,22,-9
US,HU,2022.0,42,49,-7
SK,GB,1999.0,31,11,20
LB,FR,2011.0,25,67,-42
CH,GR,2020.0,21,34,-13
CA,CZ,2010.0,14,6,8
ES,FI,2022.0,17,12,5
PK,CH,2006.0,12,10,2
CA,CZ,2017.0,26,8,18
DE,LK,2013.0,2,3,-1
CN,ES,2006.0,32,41,-9
IR,EG,2016.0,19,9,10
DZ,IN,2017.0,3,2,1
GB,MX,2020.0,53,61,-8
AE,EG,2012.0,25,18,7
FI,GB,2010.0,46,57,-11
GB,TW,2001.0,33,23,10
CZ,MY,2017.0,22,9,13
CN,NG,2003.0,2,3,-1
IR,NL,2017.0,42,33,9
BO,PA,2017.0,1,1,0
VN,KR,2010.0,19,29,-10
ES,NO,2015.0,24,26,-2
PE,BR,2015.0,49,55,-6
EC,MX,2012.0,10,19,-9
BD,DE,2012.0,10,14,-4
JP,CH,1997.0,25,37,-12
VE,PT,2010.0,2,5,-3
SI,AU,2022.0,3,2,1
FI,BR,2020.0,11,18,-7
GB,SK,2016.0,11,15,-4
US,UY,2021.0,23,20,3
CI,CA,2012.0,1,4,-3
IT,HU,2018.0,10,11,-1
NO,IR,2018.0,17,17,0
MX,PH,2017.0,19,12,7
BE,KR,2018.0,13,21,-8
FR,LU,1999.0,12,3,9
RU,DK,1997.0,9,7,2
RS,ME,2011.0,15,8,7
CZ,FR,2009.0,24,28,-4
TW,SG,1997.0,8,4,4
RU,KR,2003.0,11,7,4
NL,TZ,2018.0,5,3,2
BO,CO,2015.0,13,5,8
HU,NL,2013.0,21,17,4
GB,OM,2014.0,21,10,11
FR,IR,2021.0,20,31,-11
US,UG,2000.0,4,3,1
SA,DZ,2018.0,10,14,-4
IN,DK,2014.0,19,19,0
AE,IQ,2014.0,5,4,1
PL,JP,2012.0,12,12,0
RS,SK,2016.0,11,12,-1
IN,NO,2001.0,35,15,20
MY,FR,2007.0,4,5,-1
NZ,NP,2013.0,28,27,1
HU,US,2011.0,102,114,-12
BR,KR,2010.0,5,2,3
CL,JP,2018.0,5,4,1
KE,FR,2002.0,6,2,4
PF,US,2010.0,2,1,1
KE,GB,2021.0,29,32,-3
MM,NL,2019.0,1,1,0
US,RO,2009.0,67,51,16
NZ,JP,2006.0,11,14,-3
FR,CO,2019.0,42,37,5
JO,DE,2010.0,8,10,-2
AZ,TR,2018.0,14,7,7
FI,TR,2000.0,3,2,1
KR,CZ,2010.0,7,6,1
FR,HR,2020.0,10,3,7
CN,IT,2002.0,20,24,-4
ZA,DE,2004.0,20,21,-1
PL,RU,2018.0,44,36,8
FI,CN,2012.0,17,24,-7
KR,NZ,2003.0,1,1,0
IR,KR,2013.0,15,6,9
PL,AT,2016.0,19,13,6
US,ZW,2020.0,14,7,7
CA,RU,2019.0,53,36,17
TW,GB,2007.0,44,63,-19
SA,CA,2015.0,57,110,-53
NO,TZ,2017.0,11,2,9
nan,PT,2020.0,31,18,13
DE,BY,2020.0,6,8,-2
IE,BE,2014.0,18,9,9
NL,VN,2019.0,10,5,5
IT,IR,2003.0,2,4,-2
IL,GB,2008.0,51,30,21
TZ,CH,2014.0,2,2,0
CU,MX,2000.0,15,10,5
TR,AT,2021.0,15,10,5
MK,GR,2020.0,7,2,5
SE,PK,2019.0,15,10,5
TW,RU,2010.0,14,14,0
MY,TR,2015.0,17,10,7
UA,FI,2019.0,6,1,5
IT,MX,2019.0,50,38,12
GR,DK,2021.0,8,9,-1
SG,IQ,2019.0,4,5,-1
EC,VE,2022.0,6,8,-2
IQ,SA,2015.0,8,16,-8
BR,IE,2012.0,12,5,7
NL,PH,2018.0,9,4,5
IE,PK,2018.0,15,16,-1
TW,IN,2023.0,3,4,-1
US,RU,2023.0,20,29,-9
CA,FR,2023.0,16,15,1
HU,FR,2002.0,23,15,8
TR,UA,2004.0,5,2,3
QA,GB,2019.0,19,78,-59
RS,CZ,2011.0,2,11,-9
CZ,FI,2016.0,5,13,-8
SG,GB,2014.0,94,165,-71
CA,SK,2002.0,2,6,-4
IE,AU,1998.0,21,34,-13
RS,TR,2012.0,82,83,-1
PT,IT,2007.0,10,26,-16
PT,BE,1998.0,3,6,-3
US,LT,2015.0,13,10,3
BO,PE,2018.0,16,5,11
JP,IE,2000.0,24,9,15
LU,FR,2014.0,35,51,-16
PT,RU,2005.0,9,4,5
NE,BJ,2019.0,1,2,-1
BR,MX,2010.0,64,77,-13
GB,TZ,2014.0,17,12,5
DE,LV,2015.0,2,4,-2
BE,BG,2004.0,7,6,1
UY,BR,2009.0,33,31,2
DK,NZ,2016.0,8,11,-3
SE,IT,2001.0,29,79,-50
NZ,nan,2014.0,8,8,0
AU,IR,2000.0,11,3,8
EC,HU,2017.0,2,2,0
DK,GB,2006.0,71,106,-35
RO,FR,2001.0,20,11,9
NG,AU,2011.0,5,3,2
ID,SE,2008.0,4,1,3
PA,US,2011.0,33,66,-33
SI,CH,2003.0,5,1,4
IN,IT,2005.0,41,50,-9
QA,JO,2013.0,1,5,-4
SK,NO,2012.0,2,1,1
SE,IQ,2011.0,5,1,4
BE,MA,2006.0,4,1,3
HR,IE,1999.0,2,1,1
KR,BR,2017.0,5,6,-1
US,MK,2020.0,8,4,4
MQ,FR,2014.0,9,22,-13
nan,PL,2022.0,6,2,4
PS,FR,2017.0,2,4,-2
ES,HU,2018.0,7,7,0
DE,BO,2017.0,2,1,1
RU,UZ,2014.0,7,19,-12
FR,ZA,2004.0,15,6,9
NZ,NO,2017.0,4,1,3
CU,CR,2008.0,4,8,-4
GB,KE,2006.0,18,17,1
FI,AT,2016.0,9,11,-2
BG,IT,2008.0,6,3,3
SI,BE,2005.0,1,2,-1
DK,AT,2019.0,20,21,-1
DK,AT,2017.0,18,20,-2
HR,AU,2016.0,5,4,1
BD,nan,2016.0,1,1,0
MX,SK,2015.0,2,6,-4
SA,KW,2015.0,15,16,-1
EG,HU,2019.0,6,6,0
KW,TR,2017.0,7,13,-6
FR,BY,2015.0,2,2,0
IE,JP,2016.0,28,29,-1
GB,TR,2008.0,46,43,3
PT,MA,2022.0,14,19,-5
ET,JP,2006.0,4,3,1
BR,SD,2010.0,6,3,3
AR,PE,2005.0,5,12,-7
LB,SA,2011.0,4,2,2
BR,CU,2021.0,21,10,11
AT,SE,1999.0,2,6,-4
FR,KR,2022.0,17,17,0
CA,TN,2003.0,1,6,-5
ID,BD,2011.0,6,1,5
KR,GB,1997.0,10,10,0
NO,PL,2009.0,4,7,-3
MT,ES,2009.0,2,3,-1
AT,CL,2015.0,7,3,4
DE,KR,2003.0,26,19,7
FR,NZ,1999.0,7,5,2
PH,KR,2012.0,6,2,4
BD,PK,2015.0,49,45,4
UY,ES,2000.0,10,9,1
HU,CZ,2021.0,9,8,1
NA,US,2022.0,2,1,1
TT,GB,2014.0,6,4,2
GB,ET,2008.0,3,6,-3
SY,GB,2018.0,8,2,6
KR,DK,2019.0,10,4,6
TZ,US,2012.0,18,16,2
PE,US,2003.0,14,25,-11
MX,CH,2009.0,6,6,0
nan,AR,2009.0,38,31,7
IT,CN,2000.0,17,20,-3
PK,BD,2007.0,13,5,8
MX,VE,2021.0,20,16,4
ZA,PL,2018.0,3,6,-3
HU,FI,2003.0,9,3,6
MZ,BE,2016.0,5,3,2
PT,ID,2018.0,5,1,4
FI,AU,2012.0,22,13,9
SA,PK,2012.0,28,50,-22
ZA,PT,2022.0,6,4,2
NL,SG,2016.0,22,17,5
FR,BD,2005.0,4,2,2
MY,NG,2008.0,3,3,0
AU,BD,2010.0,14,21,-7
SK,DE,2003.0,20,19,1
SE,PK,2017.0,16,9,7
IN,BE,2017.0,58,40,18
CM,FR,2001.0,11,8,3
BY,DE,2016.0,5,1,4
BE,CZ,2009.0,6,6,0
TR,ES,2002.0,6,5,1
TR,FI,2017.0,5,4,1
nan,GR,2022.0,4,2,2
NG,KE,2011.0,2,1,1
CH,IN,2012.0,43,48,-5
SA,KE,2015.0,2,2,0
LY,EG,2018.0,12,8,4
BJ,US,2021.0,4,1,3
CO,FR,1999.0,6,5,1
VN,US,2011.0,34,59,-25
MN,JP,2020.0,7,10,-3
CN,HU,2007.0,5,9,-4
US,ID,1999.0,13,9,4
FR,ML,2016.0,9,10,-1
SI,HR,2005.0,7,2,5
FR,JM,2004.0,2,2,0
FR,MG,2013.0,13,8,5
AE,CA,2007.0,8,8,0
MT,GR,2018.0,2,1,1
XK,AL,2016.0,3,6,-3
BR,CR,2015.0,12,19,-7
NP,PK,2020.0,6,2,4
SE,IL,2021.0,6,6,0
TN,CH,2018.0,10,10,0
CA,TZ,2014.0,2,1,1
MM,nan,2019.0,2,4,-2
FR,MC,2022.0,9,2,7
JP,AT,1999.0,2,5,-3
IT,MX,2010.0,24,26,-2
FI,LU,2011.0,5,1,4
TR,TH,2007.0,3,2,1
JO,DE,2019.0,8,11,-3
DE,NZ,2001.0,17,9,8
AU,EG,2002.0,1,2,-1
GT,US,2017.0,12,9,3
CA,RO,2020.0,16,13,3
US,VE,2007.0,44,65,-21
LK,JP,2011.0,14,36,-22
CN,IT,2005.0,20,21,-1
MX,GT,2020.0,27,28,-1
KR,GB,1998.0,13,23,-10
UY,CL,2008.0,12,5,7
ID,nan,2015.0,11,53,-42
IE,DK,2020.0,10,13,-3
TW,RU,2017.0,9,12,-3
PA,PH,2017.0,1,2,-1
CA,NO,2000.0,14,9,5
FI,CH,2021.0,14,16,-2
IN,BR,2021.0,16,25,-9
CL,UY,2004.0,4,1,3
ZA,NZ,2004.0,8,4,4
BY,US,2001.0,12,4,8
BG,US,2006.0,32,25,7
BR,GR,2020.0,5,2,3
PY,EC,2018.0,4,3,1
CO,NL,2012.0,8,3,5
RO,CA,2002.0,4,4,0
CU,AR,2006.0,18,12,6
RU,FI,2009.0,13,16,-3
NZ,ES,2012.0,10,17,-7
FR,MA,2023.0,4,2,2
ZA,BR,2011.0,9,7,2
GB,BH,2018.0,9,5,4
CZ,RU,2006.0,13,39,-26
AE,JP,2022.0,2,2,0
BE,NO,2013.0,8,9,-1
HU,IT,2001.0,3,6,-3
PY,VE,2004.0,3,1,2
BE,CL,2011.0,10,7,3
TN,BE,2002.0,2,1,1
RU,BE,1998.0,13,9,4
MK,RO,2018.0,1,1,0
KW,TR,2019.0,5,8,-3
BE,MD,1999.0,1,1,0
PG,IN,2019.0,2,1,1
DE,BD,1998.0,1,1,0
CO,KE,2012.0,5,5,0
IE,NL,2011.0,18,16,2
PA,PH,2010.0,1,1,0
CH,PH,2005.0,2,3,-1
AU,VG,2015.0,1,3,-2
CI,CH,2019.0,2,5,-3
NL,KE,2002.0,1,1,0
CH,NG,2007.0,1,1,0
ML,BF,2018.0,7,5,2
AM,PL,2004.0,1,1,0
SE,PL,2017.0,21,23,-2
TZ,ES,2020.0,1,1,0
AT,RS,2014.0,8,11,-3
AU,CZ,2008.0,8,5,3
NZ,IL,1998.0,1,2,-1
PL,PK,2020.0,4,8,-4
SG,HU,2012.0,1,2,-1
BR,TR,2008.0,17,41,-24
IL,ZA,2015.0,5,7,-2
IE,AU,1997.0,20,13,7
CA,LK,2006.0,2,2,0
IQ,DE,2015.0,3,9,-6
US,HT,2016.0,3,3,0
CH,TZ,2013.0,4,4,0
nan,AT,2013.0,16,10,6
SE,HU,2016.0,12,24,-12
GE,DE,2000.0,5,1,4
AU,PK,2010.0,15,18,-3
MZ,NL,2019.0,1,1,0
AT,AR,2002.0,1,1,0
BD,ES,2016.0,13,21,-8
AU,VN,2013.0,19,19,0
AU,FI,2005.0,9,3,6
JO,NL,2018.0,1,1,0
DO,PE,2022.0,3,2,1
FR,CG,2020.0,14,13,1
JP,BE,2022.0,13,8,5
DE,PK,2003.0,4,5,-1
US,FJ,2007.0,5,1,4
CO,PT,2021.0,18,13,5
RO,CN,2000.0,2,1,1
TR,IN,2009.0,15,7,8
TW,CZ,2010.0,3,1,2
BR,SD,2017.0,2,6,-4
DE,LB,2007.0,5,2,3
BR,TW,2020.0,4,2,2
NO,SG,2011.0,4,3,1
US,CY,2012.0,31,13,18
ES,PL,2002.0,5,5,0
PT,NO,2005.0,4,1,3
ES,PL,2005.0,9,13,-4
ES,PA,2002.0,4,18,-14
AU,PT,2003.0,3,3,0
DE,CY,2015.0,1,3,-2
PH,DK,2007.0,2,1,1
SE,PE,2019.0,1,1,0
BJ,IT,2007.0,2,2,0
RO,GB,2022.0,27,35,-8
AR,CA,2021.0,26,21,5
DK,RS,2003.0,2,3,-1
FR,SY,2010.0,13,2,11
DK,ZA,2018.0,8,10,-2
VG,RU,2009.0,2,1,1
RU,TN,2020.0,5,2,3
CA,FI,2004.0,8,25,-17
RU,DK,1998.0,7,12,-5
RE,FR,2000.0,4,8,-4
PA,AR,2014.0,4,6,-2
CA,SK,2005.0,2,4,-2
VE,CR,2015.0,5,4,1
VN,BE,2001.0,1,2,-1
CN,CI,2021.0,1,1,0
IR,SY,2021.0,2,1,1
NZ,CZ,2018.0,2,1,1
BD,IR,2016.0,7,2,5
JP,BY,2018.0,1,1,0
CN,RS,2013.0,8,4,4
UA,FI,2010.0,3,2,1
FR,SY,2019.0,11,3,8
NO,MX,2014.0,5,5,0
RU,HU,2003.0,4,4,0
PT,UY,2009.0,2,1,1
NL,GA,2008.0,3,3,0
RS,FI,2018.0,1,2,-1
AU,FI,2002.0,7,3,4
RU,CY,2019.0,2,3,-1
MZ,NL,2017.0,1,1,0
CH,RS,2007.0,2,5,-3
CZ,SG,2016.0,3,3,0
ES,GT,2014.0,5,12,-7
MM,SG,2015.0,3,4,-1
FR,UG,2020.0,6,4,2
MA,SA,2015.0,6,5,1
SG,ES,2002.0,2,3,-1
PL,GR,2022.0,3,3,0
PK,TH,2017.0,7,6,1
KW,TN,2009.0,1,2,-1
TW,RU,2019.0,10,11,-1
ES,SK,2018.0,5,3,2
NZ,TR,2018.0,1,4,-3
IN,JO,2021.0,3,1,2
TW,TR,2021.0,5,10,-5
CO,HN,2022.0,2,1,1
DE,LT,2018.0,7,10,-3
ES,BD,2012.0,29,23,6
AU,MU,2018.0,1,2,-1
NZ,FI,2012.0,2,5,-3
SI,US,2013.0,25,20,5
TZ,GB,2013.0,10,16,-6
TR,ES,2005.0,4,2,2
NG,NL,2006.0,1,2,-1
KW,MA,2015.0,12,7,5
UA,IE,2017.0,1,1,0
IE,UA,2018.0,3,2,1
PL,DK,1997.0,2,2,0
MD,MA,2018.0,2,3,-1
GB,NG,1999.0,6,5,1
IT,MT,2015.0,2,3,-1
TJ,US,2010.0,2,1,1
NL,TW,2015.0,8,4,4
SG,NO,2008.0,7,3,4
US,MT,2012.0,3,3,0
IL,TR,2004.0,5,1,4
LV,CN,2014.0,2,2,0
NL,LK,2016.0,3,1,2
AU,AE,2012.0,13,6,7
DK,IE,2014.0,5,11,-6
RU,MD,2014.0,6,6,0
IR,AU,2009.0,33,39,-6
KR,CZ,2017.0,10,11,-1
CZ,MY,2010.0,4,2,2
OM,AU,2008.0,4,2,2
OM,US,2013.0,5,12,-7
JO,GB,2016.0,15,31,-16
GT,US,2019.0,15,9,6
NO,PS,2016.0,1,1,0
NO,EG,2008.0,3,2,1
US,DO,2012.0,4,4,0
TH,AU,1999.0,5,12,-7
NG,US,2001.0,15,13,2
CN,VN,2023.0,3,3,0
DK,TR,2013.0,3,6,-3
CH,AT,2023.0,5,4,1
nan,AU,2000.0,7,7,0
AU,PL,2016.0,9,15,-6
SK,CH,2007.0,7,6,1
DK,LT,2009.0,3,2,1
TH,DK,2021.0,3,2,1
IS,DK,1998.0,2,2,0
BE,AR,2007.0,5,3,2
ET,NO,2013.0,6,9,-3
NL,IE,2010.0,21,19,2
IL,RU,2008.0,14,19,-5
SE,RO,2021.0,2,3,-1
SE,TH,2003.0,5,3,2
GB,CZ,2007.0,17,39,-22
GB,CO,1998.0,5,4,1
FR,CF,2008.0,2,2,0
CH,HR,2004.0,2,3,-1
BA,HR,2009.0,14,25,-11
FI,UA,2015.0,3,4,-1
NO,SK,2018.0,4,3,1
AT,JP,2003.0,5,15,-10
SE,PK,2010.0,7,9,-2
SE,PL,2010.0,14,20,-6
LV,MX,2010.0,2,1,1
US,BW,2002.0,3,3,0
CZ,BY,2009.0,7,8,-1
UA,EC,2002.0,5,7,-2
TN,MD,2006.0,9,6,3
NO,BE,2016.0,8,7,1
KR,nan,2002.0,9,15,-6
KR,IL,2009.0,4,2,2
TW,CZ,2017.0,3,1,2
UY,DO,2017.0,1,1,0
GB,MT,2007.0,7,4,3
KR,BE,2012.0,11,6,5
NL,PT,2000.0,8,6,2
PT,SE,2000.0,2,4,-2
CH,PK,2013.0,10,15,-5
CL,TH,2018.0,1,1,0
FR,EC,2020.0,9,12,-3
AU,KR,2006.0,15,23,-8
PT,CA,2016.0,18,22,-4
DE,TZ,2016.0,8,3,5
UA,CN,2013.0,17,16,1
IR,nan,2013.0,3,4,-1
FI,MY,2015.0,4,4,0
VN,FR,2003.0,8,7,1
BE,PE,2000.0,1,2,-1
UA,CA,2015.0,8,1,7
KZ,CN,2011.0,7,9,-2
MX,BO,2006.0,2,5,-3
TW,AM,2013.0,1,1,0
VE,FR,2013.0,8,7,1
GB,SS,2000.0,3,5,-2
SS,GB,2001.0,4,7,-3
IN,UY,2016.0,1,1,0
EC,AU,2020.0,6,3,3
PK,NO,2008.0,2,2,0
LR,US,2014.0,2,1,1
IT,SM,2022.0,3,1,2
KW,CA,1997.0,1,2,-1
CZ,BE,2022.0,13,6,7
JO,FR,2005.0,1,5,-4
QA,GB,2010.0,2,19,-17
KZ,TW,2020.0,2,1,1
AU,IL,1999.0,7,5,2
MX,HN,2021.0,10,9,1
KE,FR,2005.0,3,5,-2
MA,IN,2012.0,2,1,1
NL,EG,2004.0,3,1,2
TR,FI,2019.0,13,7,6
MX,DK,2020.0,14,5,9
BY,PL,2008.0,3,2,1
HK,TW,2009.0,1,1,0
RS,GR,2016.0,1,5,-4
PH,SG,2004.0,3,3,0
PE,UY,2011.0,3,2,1
OM,DE,2018.0,3,2,1
LU,ES,2022.0,6,6,0
TH,PH,2015.0,4,3,1
AU,SI,2009.0,3,1,2
HU,NG,2022.0,7,1,6
FR,BG,2009.0,8,9,-1
FJ,AU,2004.0,2,2,0
KZ,PL,2011.0,2,1,1
LU,BE,2022.0,3,13,-10
SA,BH,2002.0,1,1,0
NZ,IR,2013.0,2,5,-3
CO,NI,2016.0,3,4,-1
NO,CY,2021.0,1,1,0
BE,JP,2022.0,8,13,-5
IR,IE,2007.0,2,1,1
BD,IE,2010.0,1,1,0
FR,BF,2010.0,9,6,3
MZ,PT,2011.0,3,3,0
TZ,KE,2015.0,4,11,-7
CH,FI,2004.0,6,8,-2
LK,IN,2004.0,2,4,-2
DK,RU,2011.0,6,9,-3
FI,LB,2017.0,1,2,-1
BD,SA,2014.0,19,8,11
EG,HU,2017.0,6,5,1
BE,GH,2019.0,3,1,2
BE,TH,2011.0,5,1,4
RU,ZW,2016.0,5,16,-11
UA,JP,2009.0,4,7,-3
TR,KW,2009.0,4,4,0
BG,CH,2001.0,2,2,0
RO,IT,1999.0,5,2,3
AU,CL,2018.0,26,27,-1
IN,TH,1997.0,1,1,0
BH,KW,2013.0,1,1,0
PT,NO,2002.0,1,2,-1
PA,FR,2021.0,2,1,1
PL,BE,2013.0,15,18,-3
FI,KR,2013.0,2,2,0
CA,LB,2022.0,6,21,-15
ZA,CL,2016.0,4,3,1
PT,PK,2010.0,1,2,-1
nan,IR,2013.0,4,3,1
US,SJ,2012.0,2,2,0
TR,FI,2010.0,5,8,-3
SI,HR,2002.0,6,3,3
SD,DK,1997.0,1,1,0
SE,LK,2020.0,3,2,1
RS,IL,2007.0,8,7,1
NZ,AE,2009.0,3,3,0
BE,MX,2002.0,1,4,-3
FR,ID,2001.0,2,2,0
PT,PK,2019.0,2,2,0
RS,FR,2009.0,4,5,-1
FR,TG,2020.0,5,6,-1
ES,CR,2006.0,14,18,-4
PY,BR,2007.0,2,1,1
IL,JP,2019.0,11,11,0
FI,HU,1997.0,4,1,3
KP,KR,2021.0,6,8,-2
GE,GB,2009.0,2,5,-3
IT,FI,2006.0,7,4,3
TW,BH,2007.0,3,2,1
CZ,RO,2011.0,9,5,4
CO,SE,2016.0,3,3,0
SE,ZA,2006.0,6,11,-5
PE,PH,2012.0,1,1,0
BT,TH,2018.0,2,3,-1
IL,EE,2011.0,1,1,0
HU,PK,2011.0,4,1,3
BJ,IN,2015.0,1,2,-1
TR,RU,2011.0,3,5,-2
MK,US,2004.0,5,4,1
GR,AU,2012.0,5,4,1
IN,BD,1998.0,5,5,0
PR,US,1998.0,2,1,1
FI,NO,1999.0,4,7,-3
DE,BW,2002.0,1,1,0
ML,GN,2015.0,3,1,2
RU,MY,2004.0,4,2,2
TW,VN,1997.0,1,1,0
AR,CU,1998.0,3,1,2
CH,CO,1998.0,1,1,0
DZ,IN,2019.0,3,4,-1
CM,JP,2022.0,1,1,0
CZ,DK,2016.0,2,7,-5
PL,HR,2011.0,1,1,0
KR,BR,2010.0,2,5,-3
BF,CI,2016.0,3,2,1
PT,RU,2002.0,4,10,-6
LK,KR,2022.0,1,4,-3
AL,US,2021.0,2,2,0
ZA,IT,2018.0,18,27,-9
SA,BR,2011.0,1,4,-3
MA,TN,2001.0,1,2,-1
EE,IT,2016.0,3,4,-1
AU,EE,2015.0,4,2,2
VG,AU,2000.0,1,1,0
AR,CU,1997.0,3,1,2
AU,GE,1999.0,1,2,-1
IN,BH,2014.0,3,3,0
LU,HU,2013.0,2,1,1
KR,DK,2010.0,3,4,-1
SE,LT,2009.0,4,2,2
RS,AT,2016.0,6,13,-7
ID,MK,2012.0,2,2,0
PT,CL,2015.0,11,11,0
KR,BR,2019.0,11,9,2
PG,PK,2019.0,1,1,0
RS,AU,2013.0,3,9,-6
PK,HU,2021.0,2,6,-4
MY,PK,2006.0,6,6,0
JM,AU,2005.0,1,2,-1
RO,CZ,2011.0,5,9,-4
nan,PK,2008.0,4,3,1
CD,BJ,2020.0,1,1,0
CU,DE,2011.0,3,3,0
IQ,nan,2020.0,1,1,0
DK,KE,2022.0,4,1,3
SY,NG,2013.0,1,1,0
CA,JO,2001.0,2,2,0
MK,RU,2016.0,3,1,2
IT,CM,2009.0,2,1,1
BD,IE,2019.0,3,1,2
ME,AT,2019.0,1,2,-1
ES,ZA,2006.0,3,1,2
CM,GB,2021.0,3,7,-4
US,BW,2005.0,4,3,1
IT,TW,2011.0,4,1,3
CG,BJ,2011.0,2,1,1
PK,TH,2019.0,4,10,-6
AF,IR,2020.0,7,11,-4
UA,UZ,2011.0,1,7,-6
EG,YE,2008.0,2,1,1
EG,AE,1998.0,3,4,-1
UZ,UA,2014.0,3,1,2
NP,SG,2013.0,2,1,1
RS,IN,2012.0,2,3,-1
CN,ID,2006.0,4,10,-6
VN,IR,2021.0,5,7,-2
UA,BY,2004.0,1,7,-6
IR,KZ,2013.0,1,2,-1
CM,nan,2020.0,6,16,-10
ES,IL,2000.0,8,7,1
RU,CN,1999.0,9,5,4
SG,GR,2011.0,1,1,0
nan,RO,2020.0,4,2,2
PH,IT,2018.0,4,6,-2
IN,TT,2012.0,3,5,-2
EG,SE,2008.0,3,7,-4
UA,NG,2015.0,1,1,0
CL,CZ,2014.0,4,3,1
BE,MX,2005.0,7,2,5
TW,IE,2021.0,3,2,1
AU,RS,2005.0,3,2,1
DK,BE,2003.0,2,14,-12
GB,NP,2009.0,7,2,5
BY,IN,2022.0,1,3,-2
FR,PE,2009.0,3,6,-3
TZ,ZA,2013.0,6,10,-4
SY,SA,2009.0,1,1,0
CZ,GE,2020.0,3,1,2
SI,BA,2006.0,2,3,-1
DZ,GB,2008.0,4,5,-1
TN,EG,2005.0,2,3,-1
NO,ES,2000.0,12,6,6
NG,FR,2000.0,2,1,1
MX,AU,1997.0,2,2,0
LK,TH,2016.0,1,1,0
IL,DK,2014.0,5,5,0
OM,SA,2005.0,2,3,-1
DE,GE,1999.0,2,2,0
FI,EG,2022.0,3,6,-3
KZ,GR,2020.0,2,1,1
US,LV,2006.0,6,2,4
IL,IT,1998.0,6,11,-5
MY,SD,2013.0,8,5,3
UG,US,1998.0,3,4,-1
VE,PT,2017.0,5,3,2
NG,DE,1998.0,2,2,0
AU,EG,2005.0,1,1,0
IL,IT,1997.0,8,10,-2
TW,AT,2009.0,1,2,-1
PT,BE,1997.0,1,3,-2
RU,VN,2012.0,7,4,3
CO,NZ,2018.0,4,2,2
KN,IN,2019.0,1,1,0
CU,PH,2019.0,2,1,1
BJ,SN,2008.0,1,1,0
CN,CZ,1997.0,2,4,-2
IS,IT,2014.0,2,1,1
CA,SI,2006.0,3,1,2
VN,SG,2007.0,1,3,-2
CR,CL,2007.0,7,9,-2
TN,nan,2016.0,2,3,-1
PT,JP,2013.0,4,5,-1
NI,nan,2015.0,1,2,-1
IT,BG,2015.0,6,9,-3
MZ,FR,2019.0,3,2,1
AR,PE,2002.0,5,2,3
KR,DK,2017.0,3,9,-6
KW,MY,2018.0,4,7,-3
TW,CZ,2019.0,6,1,5
BF,US,2014.0,4,1,3
DE,ID,2000.0,2,2,0
BY,UA,2001.0,3,1,2
FR,AE,2018.0,14,15,-1
IE,GR,2012.0,4,8,-4
MX,SE,2012.0,7,5,2
VN,IN,2008.0,1,1,0
AU,PH,2009.0,8,11,-3
BF,CH,2022.0,1,2,-1
CN,CL,2006.0,2,2,0
LT,FR,2005.0,2,4,-2
FR,CY,2016.0,2,3,-1
LT,FR,2002.0,2,2,0
DE,BO,2019.0,3,2,1
PH,AT,2016.0,2,2,0
KR,PH,2020.0,10,9,1
IL,IR,2018.0,2,1,1
IN,TH,1998.0,2,2,0
NG,ES,2018.0,1,4,-3
PH,FR,2001.0,4,1,3
CL,AT,2016.0,6,7,-1
AU,RS,2002.0,2,1,1
HU,CA,1997.0,3,5,-2
IT,GE,2011.0,1,1,0
LB,EG,2012.0,5,11,-6
IR,RU,2009.0,4,9,-5
PE,KE,2017.0,3,2,1
AU,PG,2002.0,2,3,-1
CI,SN,2014.0,1,3,-2
DE,NP,2009.0,2,3,-1
SI,UA,2016.0,2,1,1
KZ,KG,2022.0,2,6,-4
UZ,DE,2001.0,1,1,0
AR,BO,2016.0,4,3,1
AR,MY,1997.0,2,3,-1
ET,RU,2015.0,2,1,1
CI,BJ,2015.0,1,3,-2
AE,LB,2022.0,3,10,-7
YE,CA,2020.0,1,1,0
EG,TZ,2018.0,2,2,0
EC,CA,2021.0,6,10,-4
BR,NO,2008.0,6,25,-19
CM,IT,2021.0,4,8,-4
IE,AR,2011.0,1,2,-1
NO,BR,1999.0,5,3,2
NG,PT,2022.0,2,1,1
DK,CH,2023.0,1,2,-1
ER,ET,2019.0,2,1,1
GH,CM,2022.0,1,1,0
TH,TR,2012.0,3,1,2
DK,IL,2004.0,1,4,-3
PL,PH,1998.0,5,7,-2
NZ,CL,2006.0,2,2,0
DK,MY,2020.0,3,2,1
BE,CU,2012.0,4,2,2
NP,DE,2007.0,2,4,-2
NL,CR,2014.0,2,1,1
SA,TN,2009.0,2,8,-6
BE,KH,2014.0,1,1,0
GH,ML,2018.0,1,1,0
CH,MX,2008.0,2,8,-6
ZA,TH,2016.0,4,2,2
FJ,IN,2017.0,4,5,-1
DK,AE,2012.0,1,1,0
TN,QA,2022.0,7,4,3
GM,BE,2019.0,1,2,-1
BR,CZ,2016.0,5,12,-7
MX,MY,2015.0,1,1,0
BE,LT,2021.0,1,1,0
RU,nan,1998.0,4,5,-1
ZA,EG,2001.0,1,1,0
DE,ML,2014.0,1,4,-3
AU,UA,2021.0,2,3,-1
US,PG,2001.0,2,1,1
JP,SA,2022.0,3,4,-1
PA,DE,2009.0,2,4,-2
BH,JP,2020.0,2,1,1
CO,AG,2023.0,1,1,0
NL,OM,2011.0,1,1,0
AU,HR,2016.0,4,5,-1
IL,MX,2011.0,5,1,4
GT,CO,2013.0,4,3,1
GR,MK,2020.0,2,7,-5
BE,CO,2003.0,3,3,0
FI,nan,2004.0,5,7,-2
IT,IS,2013.0,2,1,1
MX,AF,2009.0,2,2,0
RS,JP,2014.0,1,4,-3
JP,LU,2020.0,3,2,1
SD,LY,2019.0,2,1,1
US,PY,2006.0,1,2,-1
VE,PT,2019.0,5,5,0
KR,SD,2013.0,1,1,0
IR,TR,2006.0,2,2,0
CL,HN,2016.0,2,6,-4
GH,CZ,2022.0,1,3,-2
SI,GB,2003.0,3,6,-3
JP,AE,2000.0,1,1,0
BD,LK,2011.0,1,1,0
UG,GB,1999.0,1,3,-2
CU,PE,2012.0,10,2,8
GR,IR,2014.0,1,2,-1
RO,TR,2004.0,2,1,1
FR,DO,2017.0,1,1,0
AE,BE,2018.0,3,4,-1
RS,MK,2022.0,1,2,-1
PA,ID,2006.0,2,1,1
BE,EE,2006.0,1,1,0
IT,NG,1999.0,2,1,1
IR,BR,2007.0,2,2,0
BY,BG,2015.0,2,1,1
US,BJ,2006.0,3,1,2
KW,CA,1998.0,1,4,-3
BD,IE,2017.0,2,1,1
IQ,GB,1998.0,1,1,0
PG,IN,2017.0,1,2,-1
KW,TR,2010.0,3,1,2
TH,KR,2008.0,2,9,-7
BE,BO,2010.0,2,1,1
DZ,ES,2000.0,1,1,0
QA,DK,2016.0,1,2,-1
JP,RO,2007.0,2,1,1
TN,SA,2003.0,1,2,-1
NL,LT,2018.0,1,4,-3
SG,PK,2005.0,3,1,2
RU,BE,1997.0,7,10,-3
AU,BW,2009.0,2,1,1
GB,UZ,2014.0,2,1,1
GB,BI,2012.0,1,1,0
AM,MA,2015.0,1,1,0
BD,AU,2003.0,4,1,3
LK,SE,2020.0,2,3,-1
AR,MY,1998.0,3,1,2
BG,TR,2011.0,1,3,-2
GB,CO,1997.0,2,4,-2
EG,KH,2022.0,1,1,0
MY,LK,2022.0,3,3,0
BG,ZA,2014.0,2,1,1
BE,TZ,2015.0,3,2,1
NG,TT,2019.0,1,1,0
AE,nan,2009.0,1,1,0
IR,AT,2007.0,2,5,-3
CH,PH,2002.0,2,2,0
IL,NO,2016.0,4,1,3
KE,ML,2015.0,1,1,0
AR,AU,2008.0,7,4,3
CZ,HR,2004.0,1,2,-1
FR,NG,2005.0,1,5,-4
GR,AE,2012.0,4,1,3
RU,VG,2009.0,1,2,-1
AT,MK,2010.0,2,2,0
BG,AT,2002.0,1,1,0
nan,IE,2001.0,2,1,1
HU,RS,2009.0,2,1,1
KZ,FR,2017.0,2,2,0
CR,PT,2015.0,2,2,0
TR,LT,2020.0,1,1,0
LU,AT,2013.0,2,1,1
NP,IN,2023.0,1,4,-3
MY,KW,2013.0,2,3,-1
UA,CL,2014.0,1,2,-1
EE,ES,2014.0,2,2,0
LT,DK,2013.0,4,2,2
LK,PH,2013.0,1,1,0
FI,HU,1998.0,1,4,-3
CM,CH,2015.0,3,3,0
nan,CY,2017.0,1,1,0
ES,AE,2021.0,3,1,2
GE,JP,2004.0,1,1,0
MA,MY,2018.0,2,6,-4
CZ,KR,2007.0,3,4,-1
EG,AE,1997.0,3,1,2
DE,XK,2013.0,1,1,0
RU,TR,2014.0,3,4,-1
LU,GR,2013.0,3,2,1
TW,BE,2004.0,1,1,0
ES,PA,2005.0,2,9,-7
MZ,CA,2008.0,1,1,0
US,CN,2011.0,6996,5304,1692
IT,US,2015.0,1087,986,101
CL,US,2008.0,128,151,-23
BR,IT,2019.0,376,360,16
JP,AR,2016.0,3,4,-1
CA,BD,2018.0,31,37,-6
NZ,TW,2013.0,6,11,-5
BR,IN,2015.0,33,41,-8
AU,IN,2006.0,57,66,-9
KR,nan,2005.0,17,14,3
CH,FR,1999.0,151,187,-36
BD,US,2014.0,116,99,17
YE,EG,2013.0,8,7,1
IN,AU,2015.0,194,164,30
NL,IR,2009.0,8,26,-18
AU,CY,2022.0,2,2,0
NL,CA,2019.0,89,141,-52
MY,nan,2012.0,39,64,-25
FR,BR,2013.0,214,154,60
PT,BR,2004.0,281,254,27
AU,TH,2013.0,40,24,16
GR,US,2009.0,163,170,-7
BY,RU,2017.0,121,69,52
TH,US,2007.0,97,159,-62
ES,CL,2019.0,469,445,24
FI,LT,2022.0,2,1,1
AT,EG,2018.0,7,5,2
QA,GB,2017.0,30,40,-10
IN,JP,2012.0,118,118,0
CA,TT,2006.0,2,2,0
MY,CN,2022.0,89,74,15
FR,AT,2001.0,16,21,-5
PK,nan,2008.0,3,4,-1
BA,SI,2013.0,4,5,-1
ID,JP,2006.0,25,57,-32
JP,CH,1998.0,41,51,-10
EG,CN,2009.0,12,15,-3
ES,NI,2014.0,8,4,4
AU,GL,2018.0,1,1,0
ID,FI,2022.0,3,2,1
RS,IT,2020.0,12,5,7
CH,AR,2013.0,11,21,-10
US,GR,2013.0,156,200,-44
CY,SA,2015.0,2,1,1
MY,AU,2022.0,59,39,20
ID,BE,2019.0,3,9,-6
UA,FI,2017.0,2,6,-4
CH,SA,2018.0,10,4,6
JO,IR,2016.0,1,1,0
DE,JO,2018.0,11,8,3
JO,OM,2021.0,2,1,1
TR,KG,2020.0,7,2,5
AU,BE,2022.0,25,19,6
TR,US,2009.0,342,361,-19
JP,GB,2007.0,286,280,6
QA,BE,2021.0,2,1,1
FR,PK,2021.0,12,11,1
IT,BR,2003.0,98,76,22
CA,PL,2007.0,30,23,7
TR,GB,2006.0,35,48,-13
HU,RO,2015.0,29,33,-4
NZ,NL,2011.0,16,9,7
GB,UA,2016.0,17,10,7
IN,BN,2018.0,5,2,3
HR,MK,2020.0,3,2,1
IN,MA,2015.0,3,3,0
VE,GB,2018.0,9,2,7
AE,US,2008.0,23,55,-32
ML,NE,2020.0,2,1,1
CH,IL,2012.0,13,22,-9
SE,PT,2011.0,13,3,10
MZ,BR,2016.0,19,17,2
BE,ID,2015.0,3,6,-3
NO,DE,2023.0,6,8,-2
PE,KE,2019.0,2,2,0
ET,BH,2022.0,31,15,16
ID,BE,2017.0,8,11,-3
PL,ES,2022.0,14,11,3
AT,MK,2019.0,37,20,17
HU,IR,2018.0,3,5,-2
CH,NO,2020.0,25,20,5
FR,UA,2013.0,19,21,-2
AT,SG,2015.0,5,3,2
nan,DK,2011.0,12,11,1
GB,CG,2008.0,1,1,0
LT,CN,2007.0,3,3,0
BD,PL,2011.0,3,3,0
HK,JP,2004.0,8,5,3
NO,IS,2020.0,6,4,2
JP,PK,2000.0,6,2,4
BR,UY,2013.0,35,56,-21
ET,GB,2014.0,8,4,4
RS,CH,2014.0,10,8,2
GB,LV,2021.0,6,1,5
KW,JO,2015.0,3,5,-2
GB,SI,2018.0,16,19,-3
OM,GB,2004.0,5,4,1
KR,FR,1998.0,8,2,6
KE,BH,2009.0,3,1,2
CU,FR,2008.0,6,3,3
IL,IN,2001.0,8,9,-1
BR,EC,2011.0,8,6,2
CR,BR,2021.0,13,9,4
NP,KR,2013.0,9,8,1
UA,EC,2005.0,9,9,0
FR,RO,2018.0,51,34,17
IL,JP,2010.0,13,10,3
IS,CA,2015.0,2,6,-4
MY,ES,2021.0,7,3,4
RS,BG,2008.0,5,2,3
MK,IT,2012.0,1,2,-1
IL,JP,2017.0,12,5,7
UA,NL,2013.0,8,7,1
CA,CZ,2019.0,15,7,8
KW,JP,2017.0,1,2,-1
TW,DE,2008.0,21,15,6
SE,CO,2020.0,5,8,-3
IL,PL,2009.0,6,3,3
DK,NO,2000.0,26,27,-1
nan,CH,2014.0,23,25,-2
AU,BD,2017.0,54,73,-19
AE,QA,2013.0,5,4,1
US,OM,2006.0,8,8,0
NG,CA,2006.0,3,3,0
PL,NL,2009.0,17,14,3
NO,TZ,2010.0,10,4,6
NZ,NO,2010.0,6,2,4
LB,IN,2012.0,5,1,4
EC,PE,2004.0,2,1,1
MY,US,2023.0,8,5,3
GB,PS,2021.0,4,4,0
CZ,NL,2011.0,14,19,-5
FJ,IN,2019.0,10,5,5
UA,MX,2003.0,6,2,4
MW,AU,2015.0,3,2,1
BG,AT,2005.0,3,2,1
FR,HK,2016.0,3,2,1
SK,RU,2020.0,12,13,-1
KE,UG,2015.0,8,7,1
NO,RU,2000.0,4,7,-3
SI,AT,2007.0,3,9,-6
SI,SK,2016.0,1,2,-1
UY,CO,2009.0,9,2,7
NL,VN,2017.0,11,4,7
ID,AE,2020.0,8,6,2
HN,ES,2012.0,6,4,2
SI,CA,2012.0,2,1,1
NZ,NO,2019.0,4,6,-2
NO,KZ,2017.0,1,1,0
PL,FR,2002.0,24,28,-4
SG,PK,2002.0,1,2,-1
KZ,FR,2019.0,2,2,0
JP,LK,2004.0,18,10,8
US,HN,1998.0,3,3,0
HU,CA,1998.0,5,4,1
TR,IE,2007.0,1,1,0
CL,PL,2015.0,5,4,1
EG,BH,2009.0,3,1,2
GB,GR,2023.0,6,4,2
MX,SV,2000.0,2,1,1
EG,DZ,2020.0,5,11,-6
CA,LT,2012.0,1,1,0
GE,FR,2005.0,4,1,3
UA,FR,2021.0,6,10,-4
LK,NZ,2016.0,4,6,-2
IR,TN,2018.0,7,8,-1
NE,TG,2015.0,1,1,0
UY,IE,2012.0,1,1,0
DK,VN,2016.0,4,3,1
JO,DE,2017.0,4,17,-13
BD,KR,2005.0,3,2,1
CH,GH,2015.0,2,6,-4
RS,CL,2014.0,1,1,0
IN,BD,1997.0,1,4,-3
VN,ID,2020.0,2,3,-1
NO,SA,2017.0,1,1,0
KR,MM,2021.0,2,1,1
nan,BY,2019.0,2,3,-1
VN,PK,2018.0,2,4,-2
IT,ME,2013.0,2,3,-1
SG,CZ,2013.0,4,3,1
AE,SG,2020.0,2,4,-2
NI,ES,2009.0,3,2,1
SA,TR,2007.0,2,2,0
RO,DK,2007.0,3,1,2
EG,CH,2000.0,1,1,0
MX,PH,2010.0,3,3,0
BJ,NG,2016.0,2,2,0
NZ,MV,2018.0,1,1,0
RU,nan,1997.0,5,4,1
nan,FR,2005.0,105,115,-10
SG,MY,2012.0,89,62,27
PT,DE,2020.0,44,44,0
AL,XK,2016.0,6,3,3
RS,GB,2008.0,9,20,-11
NZ,SG,2022.0,4,11,-7
HN,CO,2019.0,9,5,4
ZA,QA,2018.0,4,1,3
PK,SG,2016.0,5,7,-2
CU,nan,2016.0,4,1,3
LB,AU,2016.0,7,4,3
MK,AT,2012.0,8,5,3
FR,NC,2006.0,14,7,7
ES,BG,2001.0,3,8,-5
PT,BY,2009.0,2,2,0
TR,IL,2009.0,3,8,-5
EG,IR,2004.0,1,1,0
BR,,2025.0,7957,0,7957
,DE,2002.0,15647,0,15647
JP,,2005.0,7896,0,7896
,KR,1994.0,6623,0,6623
,BR,1999.0,8572,0,8572
IL,,2015.0,1656,0,1656
,DE,2005.0,17075,0,17075
JP,,2002.0,6800,0,6800
,AT,2009.0,2355,0,2355
,IT,2007.0,11957,0,11957
AU,,1998.0,879,0,879
MY,,2020.0,3946,0,3946
GB,,2012.0,10383,0,10383
,MY,2006.0,1796,0,1796
HU,,2010.0,561,0,561
FI,,2020.0,2185,0,2185
,nan,2007.0,919,0,919
,PT,1995.0,1208,0,1208
PL,,2025.0,4128,0,4128
,CH,2003.0,3156,0,3156
,KZ,2012.0,759,0,759
,NL,2016.0,5370,0,5370
HU,,2017.0,1052,0,1052
EG,,2012.0,647,0,647
PT,QA,2014.0,2,0,2
NG,,2025.0,398,0,398
,BD,2009.0,875,0,875
CU,,2018.0,421,0,421
SE,,2003.0,1004,0,1004
OM,,2015.0,78,0,78
LB,,2004.0,35,0,35
,JP,2018.0,10997,0,10997
BE,,2004.0,746,0,746
,AU,2015.0,7115,0,7115
,IE,2007.0,1333,0,1333
,AE,2003.0,103,0,103
MZ,,2024.0,274,0,274
GR,,2009.0,1082,0,1082
CR,CU,1997.0,2,0,2
,UY,2014.0,289,0,289
HN,,2010.0,11,0,11
SZ,ZA,2010.0,2,0,2
,LT,2012.0,1039,0,1039
UY,,2021.0,433,0,433
LV,,2018.0,254,0,254
KH,,2023.0,192,0,192
,FJ,2001.0,11,0,11
,LU,2002.0,64,0,64
AT,,2003.0,518,0,518
TH,,2016.0,1218,0,1218
,TH,2014.0,2549,0,2549
,JM,2001.0,33,0,33
nan,,2003.0,131,0,131
PH,,2013.0,175,0,175
HN,,2019.0,40,0,40
,EC,2013.0,651,0,651
KZ,,2018.0,275,0,275
TN,AE,2007.0,3,0,3
DK,,1999.0,233,0,233
,PA,2001.0,45,0,45
HU,,2019.0,1233,0,1233
SJ,DE,2012.0,1,0,1
KR,BY,2000.0,2,0,2
,HU,2018.0,1152,0,1152
,RE,2010.0,33,0,33
,BJ,2013.0,156,0,156
SK,VN,2001.0,1,0,1
SK,,2016.0,547,0,547
QA,,2014.0,95,0,95
PY,,2017.0,20,0,20
,HK,2011.0,95,0,95
TJ,,2020.0,31,0,31
,CM,2012.0,460,0,460
IQ,CN,2014.0,9,0,9
,LV,2008.0,215,0,215
TR,,2000.0,211,0,211
,KW,1995.0,206,0,206
MN,,2012.0,13,0,13
EE,,2021.0,503,0,503
BO,,2017.0,46,0,46
,DO,2015.0,24,0,24
BY,,2001.0,62,0,62
BO,,2019.0,73,0,73
BD,KW,1999.0,1,0,1
LI,,2024.0,54,0,54
,UZ,2018.0,579,0,579
TG,,2022.0,116,0,116
IT,SK,2014.0,8,0,8
,GE,2001.0,146,0,146
EG,ID,2002.0,1,0,1
PY,,2019.0,66,0,66
,PY,2004.0,15,0,15
AO,,2023.0,97,0,97
ET,,2012.0,52,0,52
ZM,HU,2012.0,4,0,4
CU,HU,2001.0,2,0,2
,BI,2010.0,15,0,15
SI,,2009.0,166,0,166
,LK,1999.0,78,0,78
,IS,2018.0,92,0,92
CR,,2006.0,13,0,13
,BF,2015.0,116,0,116
BR,MO,2018.0,1,0,1
MY,RO,2021.0,2,0,2
NE,,2020.0,48,0,48
ML,BE,2022.0,1,0,1
NL,IQ,2006.0,1,0,1
CW,,2024.0,39,0,39
BD,RO,2022.0,4,0,4
,TJ,2011.0,35,0,35
FJ,JP,2002.0,1,0,1
,RE,2017.0,19,0,19
LB,CY,2007.0,1,0,1
PE,GE,2017.0,1,0,1
PG,,2013.0,12,0,12
FR,NP,2018.0,1,0,1
BJ,CH,2006.0,1,0,1
TR,AF,2019.0,3,0,3
PE,,2008.0,48,0,48
PE,CZ,2021.0,2,0,2
nan,NE,2021.0,1,0,1
CR,CH,2005.0,1,0,1
MM,,2018.0,18,0,18
CM,MA,2013.0,1,0,1
TN,PL,2017.0,1,0,1
,SM,2013.0,1,0,1
HN,,2017.0,37,0,37
,LU,2005.0,96,0,96
FR,MR,2020.0,6,0,6
BI,PK,2005.0,1,0,1
GE,EG,2017.0,1,0,1
KE,AT,2003.0,1,0,1
MX,NZ,2013.0,4,0,4
JM,,2018.0,54,0,54
AM,,2008.0,63,0,63
SS,,2019.0,5,0,5
PY,,2010.0,4,0,4
,MG,2002.0,35,0,35
GL,,2020.0,14,0,14
CY,,2005.0,5,0,5
ZW,,2014.0,23,0,23
PR,,2015.0,10,0,10
PE,JP,2001.0,3,0,3
GA,,2020.0,34,0,34
GE,,2008.0,69,0,69
,BB,2015.0,6,0,6
LA,,2005.0,2,0,2
SI,BE,2002.0,1,0,1
SN,BR,2018.0,3,0,3
,BI,2017.0,21,0,21
PS,IQ,2017.0,6,0,6
,SC,2008.0,4,0,4
,GN,2015.0,15,0,15
,CV,2012.0,5,0,5
LK,,2001.0,17,0,17
,AR,2020.0,65,0,65
PT,BG,2012.0,2,0,2
JP,MN,2015.0,8,0,8
,PY,1996.0,23,0,23
,RE,2019.0,9,0,9
BG,UA,2022.0,4,0,4
SA,,2004.0,147,0,147
FJ,US,2001.0,1,0,1
RS,IE,2005.0,6,0,6
DK,ML,2014.0,2,0,2
FR,DO,2019.0,1,0,1
,MG,2005.0,43,0,43
MD,CZ,2017.0,1,0,1
VE,ID,2007.0,3,0,3
,AZ,1995.0,44,0,44
,NA,2009.0,30,0,30
,TG,2005.0,27,0,27
AZ,CA,2020.0,2,0,2
EE,IS,2018.0,1,0,1
JO,IT,2012.0,2,0,2
GD,VE,2020.0,1,0,1
IS,,2009.0,35,0,35
RE,,2015.0,28,0,28
BE,SG,2006.0,4,0,4
BN,OM,2014.0,1,0,1
GB,CM,2004.0,2,0,2
IR,ET,2015.0,1,0,1
KW,TH,2020.0,1,0,1
AR,EC,2004.0,1,0,1
AR,GT,2011.0,1,0,1
,BN,2008.0,16,0,16
CO,AR,1997.0,5,0,5
MX,BY,2008.0,1,0,1
HR,PT,2012.0,3,0,3
JP,GE,2011.0,1,0,1
BO,,2010.0,11,0,11
QA,SE,2022.0,3,0,3
SA,HU,2022.0,2,0,2
PS,PK,2012.0,1,0,1
FJ,BH,2020.0,1,0,1
SG,HK,2009.0,1,0,1
LK,TR,2016.0,1,0,1
BB,FR,2009.0,1,0,1
,JE,2013.0,2,0,2
UA,ES,1998.0,1,0,1
QA,MT,2011.0,1,0,1
CM,,1999.0,7,0,7
CI,CH,2010.0,1,0,1
,TG,2002.0,17,0,17
NG,AF,2022.0,1,0,1
BI,CH,2003.0,2,0,2
OM,ZW,2020.0,5,0,5
BE,BO,2017.0,1,0,1
GR,KR,2006.0,1,0,1
VE,HU,2009.0,1,0,1
UG,IL,2013.0,1,0,1
BJ,,2015.0,34,0,34
FR,KZ,2016.0,2,0,2
BY,EE,2018.0,2,0,2
,TT,1995.0,18,0,18
GB,MU,2008.0,2,0,2
SA,BH,2005.0,4,0,4
PF,,2003.0,4,0,4
IL,TZ,2005.0,1,0,1
GD,,2000.0,1,0,1
HU,SI,2013.0,2,0,2
,PW,2013.0,4,0,4
RE,HR,2020.0,1,0,1
CA,CM,2004.0,2,0,2
RU,IQ,2014.0,4,0,4
SE,PE,2010.0,2,0,2
SE,CM,2003.0,1,0,1
BY,FR,2004.0,4,0,4
GF,SN,2013.0,1,0,1
CH,ML,2011.0,2,0,2
JP,SY,2018.0,2,0,2
CH,MT,2015.0,1,0,1
IE,nan,2016.0,2,0,2
VN,FO,2006.0,1,0,1
KE,ZW,2013.0,2,0,2
JP,ZM,2015.0,3,0,3
IE,LK,2020.0,1,0,1
,KP,1996.0,2,0,2
ES,MT,2013.0,4,0,4
TW,FR,2023.0,2,0,2
GI,CA,2011.0,1,0,1
nan,LU,2005.0,1,0,1
,CG,2001.0,23,0,23
DZ,BJ,2020.0,3,0,3
ML,CO,2005.0,2,0,2
SA,BW,2018.0,1,0,1
CM,PH,2018.0,1,0,1
TW,HR,2012.0,1,0,1
CY,JO,2022.0,2,0,2
TD,,2007.0,1,0,1
PE,DO,2002.0,1,0,1
PA,PH,2019.0,1,0,1
HT,,2022.0,18,0,18
XK,ME,2018.0,1,0,1
ML,GB,2021.0,1,0,1
NA,AU,2020.0,1,0,1
,DZ,2020.0,35,0,35
BR,AF,2006.0,1,0,1
DE,RE,2020.0,1,0,1
CY,,2002.0,8,0,8
LT,AT,2011.0,1,0,1
IL,AE,2015.0,1,0,1
ES,KE,2003.0,2,0,2
AU,MT,2009.0,3,0,3
ID,IE,2002.0,1,0,1
DK,QA,2021.0,2,0,2
BE,BO,2019.0,1,0,1
GB,KY,2018.0,2,0,2
,XK,1994.0,5,0,5
UA,IE,2010.0,2,0,2
ML,nan,2022.0,4,0,4
JO,DZ,2022.0,2,0,2
CG,PL,2015.0,1,0,1
JP,TZ,2018.0,6,0,6
MZ,NL,2010.0,1,0,1
ZM,TZ,2022.0,2,0,2
LV,BY,2018.0,1,0,1
IL,JO,2013.0,2,0,2
MG,DE,2017.0,1,0,1
CZ,MN,2003.0,3,0,3
IS,BE,2017.0,4,0,4
CG,RE,2016.0,3,0,3
GE,OM,2001.0,1,0,1
SV,RU,2011.0,2,0,2
NO,FO,2017.0,1,0,1
JP,KP,2003.0,2,0,2
JP,UG,2020.0,6,0,6
GH,BR,2006.0,1,0,1
UZ,ES,2011.0,1,0,1
FK,GB,2002.0,2,0,2
QA,BR,2013.0,2,0,2
ZA,CO,2014.0,1,0,1
SA,IR,2004.0,1,0,1
TN,BE,2005.0,2,0,2
FR,GM,2009.0,1,0,1
ES,JO,2016.0,2,0,2
EG,PK,2023.0,4,0,4
PL,PH,1997.0,3,0,3
TZ,IQ,2013.0,1,0,1
SD,,2000.0,13,0,13
ZW,NA,2003.0,1,0,1
KH,MY,2001.0,1,0,1
MC,,2015.0,9,0,9
CZ,LU,2018.0,3,0,3
TN,TW,2020.0,1,0,1
PS,RU,2010.0,1,0,1
KW,MW,1997.0,1,0,1
IN,DZ,2009.0,1,0,1
DO,,2003.0,4,0,4
ES,RW,2021.0,1,0,1
HR,DK,2022.0,5,0,5
,TL,2017.0,3,0,3
SG,IQ,2017.0,2,0,2
BJ,TH,2009.0,1,0,1
RU,CW,2015.0,1,0,1
KR,CL,2010.0,1,0,1
CZ,AM,2022.0,1,0,1
,BI,2019.0,11,0,11
GR,IN,2023.0,1,0,1
SY,MA,2009.0,2,0,2
CD,,2025.0,12,0,12
RW,IQ,2021.0,1,0,1
TW,PK,1998.0,1,0,1
KR,CY,2021.0,2,0,2
MA,ZA,2005.0,1,0,1
DE,PY,2005.0,1,0,1
MY,NO,2004.0,2,0,2
CY,PT,2014.0,2,0,2
AU,BS,2017.0,1,0,1
,SS,2007.0,7,0,7
TR,BG,2007.0,2,0,2
,BZ,2015.0,3,0,3
BB,AU,2021.0,1,0,1
TR,TN,2013.0,1,0,1
PR,ES,1999.0,2,0,2
SE,SD,2010.0,1,0,1
MQ,IT,2005.0,1,0,1
IL,PT,2011.0,1,0,1
CO,IR,2013.0,1,0,1
NZ,OM,1998.0,2,0,2
GM,,2000.0,8,0,8
KE,BW,2020.0,1,0,1
SG,LK,2014.0,5,0,5
IE,IR,2004.0,1,0,1
MA,CO,2011.0,2,0,2
CY,NL,2014.0,2,0,2
DZ,DE,2006.0,5,0,5
,VU,2016.0,2,0,2
IN,SD,2018.0,3,0,3
SS,BD,2015.0,1,0,1
KW,IR,2006.0,5,0,5
KR,PA,2008.0,2,0,2
ER,NL,1999.0,1,0,1
SE,SD,2017.0,1,0,1
AO,CN,2005.0,1,0,1
CN,BE,2023.0,6,0,6
BT,ID,2018.0,1,0,1
JP,DZ,2004.0,3,0,3
JM,ES,2010.0,1,0,1
,TL,2010.0,3,0,3
HR,AE,2019.0,2,0,2
AM,UG,2008.0,1,0,1
SN,MG,2001.0,1,0,1
JO,TR,2004.0,2,0,2
NZ,ID,2012.0,4,0,4
IL,BD,2007.0,1,0,1
UZ,KZ,2015.0,11,0,11
EG,LY,2002.0,1,0,1
SS,,2017.0,3,0,3
IM,IN,2013.0,1,0,1
LV,DK,2019.0,4,0,4
LY,KE,2003.0,1,0,1
MN,IN,2007.0,2,0,2
AR,NO,2008.0,1,0,1
PF,BR,2004.0,1,0,1
UG,US,1997.0,5,0,5
AF,ID,2017.0,1,0,1
BE,SY,2008.0,1,0,1
,GY,2012.0,5,0,5
NZ,CM,2010.0,1,0,1
KZ,CH,2004.0,1,0,1
BA,LY,2020.0,1,0,1
PW,,2014.0,1,0,1
MT,SA,2016.0,1,0,1
BA,IR,2018.0,1,0,1
MW,CH,2022.0,2,0,2
ZM,GR,2014.0,1,0,1
,SJ,2011.0,2,0,2
UG,ZA,2023.0,1,0,1
AZ,BE,2012.0,1,0,1
NE,BR,2021.0,8,0,8
CO,MY,2019.0,2,0,2
nan,RS,2016.0,2,0,2
TW,BJ,2023.0,1,0,1
IR,QA,2003.0,1,0,1
GB,TG,2012.0,1,0,1
RU,CY,2010.0,2,0,2
CD,LU,2009.0,1,0,1
RW,GB,1997.0,2,0,2
RW,AU,2022.0,1,0,1
RW,,1999.0,1,0,1
AR,PY,2001.0,3,0,3
CH,KE,1999.0,2,0,2
MY,QA,2001.0,1,0,1
US,PR,2022.0,3,0,3
GT,ES,1997.0,1,0,1
CG,,2011.0,5,0,5
GF,,2011.0,8,0,8
AT,EE,2007.0,2,0,2
TH,SN,2010.0,1,0,1
NO,BA,2021.0,1,0,1
IM,IT,2019.0,1,0,1
TJ,CA,2003.0,1,0,1
,SL,2009.0,4,0,4
SD,EG,1998.0,1,0,1
HR,NZ,2014.0,1,0,1
CA,MW,2012.0,1,0,1
MN,US,2008.0,1,0,1
EG,HU,2010.0,1,0,1
AO,VE,2005.0,1,0,1
SO,ET,2019.0,1,0,1
MX,KW,2010.0,1,0,1
BR,BD,2015.0,2,0,2
UA,NZ,2021.0,1,0,1
LU,PH,2018.0,1,0,1
IN,JM,2013.0,2,0,2
CM,BE,2007.0,2,0,2
SY,AU,2018.0,2,0,2
FI,MX,2000.0,1,0,1
PK,MK,2016.0,1,0,1
CL,LB,2007.0,1,0,1
AR,DO,2002.0,1,0,1
JO,AT,2019.0,1,0,1
IL,RE,2010.0,1,0,1
UG,CA,2018.0,3,0,3
GM,NO,2020.0,1,0,1
KR,CM,2001.0,1,0,1
SS,,2010.0,6,0,6
BJ,CI,2009.0,1,0,1
PT,UA,2020.0,2,0,2
nan,SA,2014.0,4,0,4
FI,CO,2023.0,1,0,1
MD,PK,2017.0,1,0,1
UG,KH,2016.0,2,0,2
GB,AM,2021.0,1,0,1
SG,LB,2011.0,1,0,1
IL,EC,2012.0,2,0,2
NC,CA,2004.0,1,0,1
CY,IL,2013.0,1,0,1
PE,KE,2010.0,1,0,1
MD,PK,2019.0,2,0,2
CR,IL,2015.0,2,0,2
CN,VE,2013.0,1,0,1
EG,ID,2005.0,1,0,1
GE,DK,2013.0,1,0,1
LU,CG,2022.0,1,0,1
KE,BR,2016.0,3,0,3
BR,KH,2013.0,1,0,1
MD,CU,2003.0,1,0,1
TN,EG,2002.0,1,0,1
ET,ZW,2006.0,2,0,2
ZW,CN,2008.0,1,0,1
,MR,1999.0,3,0,3
TW,IL,2006.0,3,0,3
TN,PL,2019.0,1,0,1
UA,SI,2012.0,5,0,5
TH,CY,1999.0,1,0,1
IN,UZ,2004.0,1,0,1
NL,QA,2007.0,1,0,1
AM,TH,2008.0,1,0,1
TH,SE,1999.0,1,0,1
AO,US,2001.0,1,0,1
OM,TW,2016.0,1,0,1
PL,VN,2000.0,1,0,1
ZM,,2001.0,5,0,5
IN,AG,2022.0,1,0,1
GT,ES,1998.0,2,0,2
RO,NO,1997.0,1,0,1
SL,DZ,2015.0,1,0,1
PT,ST,2022.0,1,0,1
GR,BG,1997.0,2,0,2
MM,PH,2009.0,1,0,1
AU,TN,1997.0,1,0,1
SE,BD,1999.0,1,0,1
GE,CA,2001.0,3,0,3
KE,PL,2002.0,1,0,1
BD,ZA,2018.0,2,0,2
ZW,NE,2012.0,1,0,1
LK,PK,2016.0,1,0,1
IM,GB,2003.0,1,0,1
HK,PL,2013.0,3,0,3
MX,BI,2000.0,1,0,1
TH,KE,2011.0,1,0,1
LS,,2011.0,1,0,1
LU,NP,2007.0,1,0,1
TW,BR,2018.0,1,0,1
NA,,2000.0,2,0,2
MW,TZ,2021.0,3,0,3
BH,KR,1999.0,1,0,1
MY,SO,2016.0,1,0,1
FI,HN,2019.0,1,0,1
LU,AU,2018.0,2,0,2
ES,AZ,2018.0,1,0,1
BI,ZW,2019.0,1,0,1
LK,SG,2016.0,3,0,3
MW,KE,2009.0,1,0,1
AT,TH,2003.0,3,0,3
IL,ZW,2018.0,1,0,1
AE,ZA,2014.0,3,0,3
CH,CD,2004.0,1,0,1
RO,nan,1998.0,1,0,1
VE,UY,2000.0,1,0,1
AU,CR,1997.0,1,0,1
NZ,GH,2020.0,4,0,4
GB,KH,2001.0,2,0,2
DE,BM,2022.0,1,0,1
PK,CM,2008.0,2,0,2
JP,CW,2018.0,2,0,2
SK,IQ,2011.0,1,0,1
TH,BD,2009.0,1,0,1
CL,IL,2016.0,2,0,2
TZ,ID,2017.0,1,0,1
BY,CA,2012.0,1,0,1
MN,CA,2012.0,1,0,1
GP,CN,2013.0,1,0,1
NZ,IL,1997.0,1,0,1
BJ,NO,2005.0,1,0,1
ME,AT,2010.0,1,0,1
SN,SE,1997.0,1,0,1
PG,PK,2017.0,1,0,1
GE,ZA,2005.0,1,0,1
AR,KR,2004.0,1,0,1
SK,SE,2001.0,2,0,2
CO,MY,2010.0,1,0,1
BA,CZ,1999.0,1,0,1
GB,SC,2006.0,1,0,1
MX,TW,2008.0,1,0,1
KW,JP,2010.0,1,0,1
FI,NP,2021.0,2,0,2
UY,DO,2019.0,1,0,1
BR,RS,2007.0,2,0,2
MY,KE,2007.0,1,0,1
,RW,2000.0,2,0,2
CD,NL,2015.0,1,0,1
CO,MK,2010.0,1,0,1
CU,ZA,2015.0,1,0,1
,TL,2019.0,1,0,1
CN,BJ,2021.0,1,0,1
GR,BH,2017.0,1,0,1
DE,TJ,2014.0,2,0,2
TR,HK,2011.0,1,0,1
FJ,TW,2020.0,1,0,1
KZ,FR,2010.0,2,0,2
KZ,GE,2009.0,1,0,1
NZ,ET,2013.0,1,0,1
GR,MY,2013.0,1,0,1
AU,BO,2002.0,1,0,1
SE,LY,2018.0,1,0,1
KW,CH,2012.0,1,0,1
AO,CO,2003.0,1,0,1
MK,NL,2018.0,1,0,1
PK,CO,2018.0,2,0,2
ML,DK,2018.0,1,0,1
GB,BO,2005.0,1,0,1
AT,GL,2013.0,1,0,1
UY,AT,2003.0,1,0,1
IL,MA,2013.0,1,0,1
US,HN,1997.0,1,0,1
NZ,RO,2008.0,1,0,1
DE,NA,2014.0,1,0,1
JP,VE,2011.0,1,3,-2
NG,BD,2018.0,2,1,1
JM,AU,2002.0,1,1,0
AT,IL,2016.0,3,2,1
AT,BY,2014.0,2,1,1
BG,GB,1998.0,2,5,-3
AT,LU,2021.0,2,2,0
CH,AU,2023.0,4,6,-2
KE,ID,2021.0,2,9,-7
AE,ES,2018.0,1,5,-4
TH,ZA,2001.0,2,1,1
HN,CO,2010.0,2,3,-1
DK,VE,2014.0,1,1,0
NO,KE,2021.0,4,4,0
SD,US,2000.0,2,5,-3
GB,MG,2021.0,1,3,-2
PS,GB,2002.0,1,1,0
GB,ZM,1999.0,1,1,0
KW,DE,2000.0,2,1,1
MG,CH,2020.0,2,1,1
KR,CL,2017.0,1,3,-2
BJ,BE,2008.0,2,3,-1
CN,CR,2015.0,1,3,-2
AE,NL,2008.0,1,1,0
VE,SV,2015.0,2,1,1
FI,IE,2014.0,1,1,0
CL,AR,2023.0,1,3,-2
CR,UY,2016.0,1,4,-3
GA,NL,2002.0,2,1,1
KZ,IN,2018.0,1,4,-3
LV,DE,2007.0,2,5,-3
MK,CZ,2001.0,1,1,0
BH,JO,1997.0,1,1,0
AU,NP,2009.0,1,4,-3
SI,NO,2015.0,1,1,0
CI,GN,2019.0,2,1,1
PE,DE,2008.0,1,2,-1
PK,TN,2009.0,3,1,2
MC,FR,2007.0,1,6,-5
BG,IQ,2014.0,1,1,0
BR,LK,2018.0,2,3,-1
KR,GE,2015.0,1,2,-1
NZ,KE,2016.0,1,1,0
PS,IQ,2019.0,2,1,1
CU,PL,2018.0,1,1,0
NO,ET,2006.0,1,1,0
NL,KE,2005.0,2,4,-2
SI,RU,2012.0,2,1,1
MD,UA,2015.0,1,1,0
BT,US,2017.0,1,1,0
GH,JP,2010.0,1,4,-3
BG,GB,1997.0,3,1,2
PT,AR,2000.0,2,5,-3
GH,AT,2007.0,1,1,0
SK,IE,2013.0,1,1,0
CZ,NG,2019.0,1,4,-3
PE,BE,2014.0,2,4,-2
FR,BA,2015.0,2,2,0
LB,DZ,2019.0,2,1,1
KW,AU,2012.0,2,2,0
GB,PR,2010.0,2,1,1
BG,TW,2004.0,1,1,0
IT,ZA,2023.0,1,2,-1
CN,CZ,1998.0,1,2,-1
NZ,CN,2023.0,1,11,-10
DZ,IR,2017.0,1,1,0
BR,SE,1997.0,1,10,-9
FI,ZA,2011.0,2,3,-1
CA,GP,2015.0,1,1,0
LB,ZA,2022.0,1,2,-1
UY,DK,2008.0,2,2,0
NP,CA,2003.0,1,2,-1
ET,SZ,2021.0,1,1,0
CN,MM,2007.0,3,9,-6
EG,GH,2014.0,1,2,-1
NE,BJ,2017.0,1,1,0
ZM,JP,2020.0,1,5,-4
VG,GB,2014.0,1,7,-6
FK,GB,2005.0,1,2,-1
PL,MZ,2008.0,3,9,-6
PS,CY,2015.0,1,1,0
AR,PK,2020.0,2,7,-5
IR,JP,2001.0,2,6,-4
AU,PG,2005.0,1,3,-2
PL,MX,1999.0,2,1,1
US,VA,2017.0,1,1,0
PL,DK,1998.0,1,2,-1
UA,NO,2014.0,1,2,-1
BR,IR,2014.0,1,16,-15
GH,VN,2022.0,1,1,0
VE,SE,2013.0,1,1,0
ES,SY,2019.0,1,1,0
nan,VG,2020.0,1,1,0
BR,SG,2000.0,2,1,1
CI,GN,2017.0,2,1,1
PA,TW,2018.0,1,1,0
DE,KZ,2008.0,1,1,0
SA,RW,2014.0,1,1,0
UA,RO,1997.0,1,1,0
DE,BO,2010.0,1,1,0
TH,IR,2014.0,1,4,-3
TZ,RU,2016.0,1,1,0
VN,AU,2001.0,1,1,0
CY,IT,2009.0,1,3,-2
RE,AR,2022.0,1,1,0
FR,MK,2001.0,2,1,1
TH,LK,2004.0,1,1,0
TZ,EG,2022.0,1,1,0
RS,nan,2018.0,1,1,0
EG,IE,2007.0,1,1,0
SE,CY,2022.0,1,2,-1
MX,AU,1998.0,1,5,-4
EG,KZ,2010.0,1,1,0
AU,NA,2015.0,1,2,-1
GR,MA,2020.0,1,1,0
FR,RU,2023.0,1,9,-8
BD,DZ,2018.0,1,2,-1
AE,LU,2021.0,1,1,0
MY,AE,2008.0,2,1,1
JM,GP,2021.0,1,1,0
PS,JO,2012.0,1,3,-2
MX,BE,2003.0,1,7,-6
SD,LY,2017.0,1,1,0
CH,IS,2012.0,1,1,0
GE,FR,2002.0,1,1,0
PK,ZA,2009.0,1,1,0
FJ,IN,2010.0,2,2,0
CN,FO,2020.0,1,1,0
SA,IE,2012.0,1,7,-6
FR,BO,2006.0,1,2,-1
CI,CM,2012.0,1,2,-1
NE,ZM,2017.0,1,1,0
PH,GH,2019.0,1,4,-3
SE,LB,2020.0,1,2,-1
BW,IN,2021.0,2,3,-1
ET,US,2023.0,2,2,0
LV,DK,2017.0,2,1,1
GR,PT,2014.0,1,4,-3
TN,PA,2014.0,1,1,0
TH,KH,2016.0,1,2,-1
PH,NO,2001.0,1,3,-2
ZA,DZ,2013.0,1,1,0
TZ,DE,2006.0,1,2,-1
OM,SA,2002.0,1,2,-1
RS,IE,2002.0,1,1,0
NE,FR,2000.0,2,1,1
SE,SK,2022.0,1,2,-1
BH,FR,2015.0,1,2,-1
TW,GR,2009.0,1,2,-1
FR,KW,2009.0,1,2,-1
MX,PK,1999.0,1,2,-1
KR,NG,2004.0,1,3,-2
NE,BE,2015.0,1,2,-1
SN,KE,2016.0,2,1,1
UA,IE,2019.0,1,1,0
ET,IE,2019.0,1,2,-1
BF,GB,2017.0,1,1,0
PF,US,2019.0,1,3,-2
XK,IR,2021.0,1,1,0
NO,KZ,2019.0,1,1,0
BE,SI,2009.0,2,6,-4
VE,PY,2016.0,1,1,0
CL,GT,2009.0,5,1,4
PE,PT,2002.0,1,2,-1
ES,MD,2010.0,1,1,0
CA,AM,2021.0,1,3,-2
GE,CZ,2022.0,1,2,-1
CH,PT,1999.0,1,1,0
UA,BE,2011.0,3,3,0
IN,TN,2009.0,1,2,-1
PR,CN,2008.0,1,1,0
UG,NL,2004.0,1,1,0
BF,JP,2016.0,1,2,-1
CM,CN,2012.0,1,2,-1
CH,LT,2005.0,1,1,0
DK,CO,2011.0,2,1,1
FJ,PG,2015.0,1,1,0
NG,BJ,2014.0,1,5,-4
GH,ZA,2023.0,1,2,-1
LK,nan,2015.0,1,1,0
PS,FR,2019.0,1,7,-6
CN,ZW,2013.0,2,0,2
KH,MG,2008.0,1,0,1
TL,CZ,2010.0,1,0,1
KR,VE,2009.0,1,0,1
AL,DE,2022.0,1,0,1
EG,CW,2005.0,1,0,1
GA,CN,2020.0,1,0,1
LV,GB,1998.0,3,0,3
TZ,MG,2019.0,1,0,1
DK,MX,2009.0,1,0,1
CO,UA,2009.0,1,0,1
TG,TZ,2020.0,1,0,1
,CF,2003.0,2,0,2
UZ,PT,2010.0,2,0,2
EE,NL,2007.0,1,0,1
AT,VN,2011.0,1,0,1
PT,UG,2017.0,1,0,1
GP,MA,2008.0,2,0,2
GB,SO,2022.0,2,0,2
JE,MX,2009.0,1,0,1
CA,GM,2011.0,1,0,1
MO,BR,2014.0,1,0,1
EE,TJ,2000.0,1,0,1
ES,CV,2014.0,1,0,1
PT,OM,2011.0,1,0,1
ES,MV,2019.0,1,0,1
CA,LY,2022.0,1,0,1
MY,EE,2014.0,1,0,1
LK,BD,2020.0,1,0,1
UZ,JP,2020.0,1,0,1
GH,NA,2014.0,1,0,1
AM,UA,2009.0,3,0,3
IN,CY,2016.0,3,0,3
KE,BO,2009.0,2,0,2
BE,GH,2010.0,1,0,1
JP,TL,2020.0,1,0,1
JO,CZ,2022.0,1,0,1
ER,ET,2017.0,3,0,3
ID,CU,2021.0,1,0,1
EC,HU,2019.0,1,0,1
CU,CN,2004.0,1,0,1
NO,HR,1998.0,1,0,1
nan,SK,1998.0,2,0,2
MA,CZ,2020.0,1,0,1
SE,MY,2023.0,1,0,1
DK,UG,2000.0,1,0,1
MA,KE,2014.0,1,0,1
BE,CR,2021.0,2,0,2
SX,US,2009.0,1,0,1
IQ,JO,1999.0,1,0,1
CH,KZ,2007.0,1,0,1
UA,IQ,2018.0,1,0,1
CN,LK,2006.0,1,0,1
CY,AE,2006.0,1,0,1
BF,CM,2020.0,1,0,1
CM,TG,2013.0,1,0,1
ZA,SO,1997.0,1,0,1
ZW,DE,2002.0,1,0,1
,AD,2011.0,1,0,1
FR,FJ,2007.0,1,0,1
PK,AZ,2016.0,1,0,1
GR,AM,2015.0,1,0,1
MA,BI,2021.0,3,0,3
QA,DE,2004.0,1,0,1
ZA,SN,2015.0,1,0,1
BO,PA,2010.0,1,0,1
SI,IS,2018.0,1,0,1
NP,GR,2020.0,1,0,1
OM,JP,2020.0,1,0,1
SI,GR,2011.0,2,0,2
EC,CU,2006.0,1,0,1
SI,XK,2018.0,1,0,1
RS,AG,2013.0,1,0,1
QA,SY,2013.0,1,0,1
HU,PE,2015.0,1,0,1
ET,CZ,2016.0,1,0,1
MA,nan,2002.0,1,0,1
DE,LA,2014.0,1,0,1
BJ,NL,2015.0,1,0,1
NG,IT,2023.0,1,0,1
DE,MC,2002.0,1,0,1
DZ,JP,1999.0,3,0,3
FR,SE,2023.0,1,0,1
BW,ET,2002.0,1,0,1
AE,BW,2019.0,1,0,1
QA,YE,2017.0,1,0,1
UG,EG,2017.0,1,0,1
GB,BM,1999.0,1,0,1
TN,AR,2019.0,1,0,1
DE,BA,2007.0,1,0,1
PA,IE,2011.0,1,0,1
GA,NL,2005.0,1,0,1
KY,,2016.0,2,0,2
CD,JP,2021.0,1,0,1
BS,CA,2005.0,1,0,1
PE,PT,2005.0,1,0,1
KE,MY,1997.0,1,0,1
nan,MC,2001.0,1,0,1
SG,TR,2023.0,1,0,1
PE,PR,2016.0,1,0,1
LA,UZ,2011.0,1,0,1
VG,NO,2010.0,1,0,1
FI,BA,2014.0,1,0,1
ES,LT,2008.0,1,0,1
UZ,AU,2014.0,1,0,1
HT,CA,2020.0,1,0,1
BI,ZW,2017.0,1,0,1
GB,BZ,2003.0,1,0,1
MT,NL,2004.0,1,0,1
BH,JO,1998.0,1,0,1
MY,PG,2014.0,1,0,1
JP,TT,2015.0,1,0,1
BY,AR,2019.0,1,0,1
CM,FI,2012.0,1,0,1
DK,CM,2018.0,1,0,1
JM,FR,2014.0,1,0,1
NP,CN,1998.0,1,0,1
MA,RE,2007.0,1,0,1
SK,MZ,2016.0,1,0,1
EG,LY,2005.0,2,0,2
ZA,NE,2020.0,1,0,1
UA,MY,2003.0,1,0,1
CH,LT,2002.0,1,0,1
PK,CG,2014.0,1,0,1
KZ,SE,2015.0,1,0,1
AE,ET,2009.0,1,0,1
NZ,FJ,2007.0,1,0,1
LK,MY,2000.0,1,0,1
SE,SN,2014.0,1,0,1
NZ,HR,2010.0,1,0,1
SE,UY,2002.0,2,0,2
DZ,AZ,2018.0,1,0,1
LY,PK,2016.0,1,0,1
ZA,NP,2015.0,1,0,1
DE,ME,2000.0,1,0,1
MY,CH,2000.0,1,0,1
VU,AU,2009.0,1,0,1
OM,AR,1999.0,1,0,1
TR,AE,2006.0,1,0,1
RU,TH,2007.0,2,0,2
SD,FI,2019.0,1,0,1
IS,DK,1997.0,1,0,1
DE,PY,2002.0,1,0,1
LT,IN,2021.0,1,0,1
US,VA,2010.0,1,0,1
GA,CA,2004.0,1,0,1
PK,EC,2016.0,1,0,1
BY,LV,2011.0,1,0,1
ET,MX,2014.0,2,0,2
NI,AR,2013.0,1,0,1
ET,MW,2013.0,1,0,1
BF,ET,2018.0,1,0,1
CL,HR,2022.0,1,0,1
MS,CA,2006.0,1,0,1
RS,NZ,2016.0,1,0,1
FR,NG,2002.0,1,0,1
JM,DE,2015.0,1,0,1
PH,GH,2017.0,1,0,1
KW,IT,2007.0,1,0,1
AR,SA,2013.0,1,0,1
MG,NG,2017.0,1,0,1
nan,CY,2019.0,2,0,2
SK,AE,2019.0,1,0,1
JP,ME,2004.0,1,0,1
SK,EG,1998.0,1,0,1
ZW,JO,2019.0,1,0,1
AE,BR,2007.0,1,0,1
CZ,CR,2021.0,1,0,1
MU,US,1999.0,1,0,1
IT,MG,2018.0,1,0,1
IL,SD,2021.0,1,0,1
LY,GR,2012.0,1,0,1
CR,NO,2007.0,1,0,1
RS,IS,2010.0,1,0,1
CH,IR,2000.0,1,0,1
MD,SE,2009.0,1,0,1
GT,BR,2006.0,1,0,1
CM,BT,2021.0,1,0,1
CU,GT,2018.0,1,0,1
ZW,GR,2005.0,1,0,1
NO,TH,2014.0,1,0,1
IL,FI,2003.0,1,0,1
MW,EC,2015.0,1,0,1
GR,RS,2013.0,1,0,1
TZ,VN,2019.0,1,0,1
CU,AU,2011.0,1,0,1
PK,DK,2006.0,1,0,1
GW,PK,2012.0,1,0,1
MG,IT,2020.0,1,0,1
ID,KH,2014.0,1,0,1
IN,RE,2005.0,1,0,1
PT,MD,2018.0,1,0,1
MX,NO,2003.0,1,0,1
BN,,2026.0,1,0,1
CH,UZ,2015.0,1,0,1
QA,AU,2003.0,2,0,2
WS,,2014.0,1,0,1
NZ,CM,2017.0,1,0,1
AF,CN,2015.0,1,0,1
MA,NL,1998.0,1,0,1
KZ,SK,2007.0,1,0,1
CA,PY,2016.0,1,0,1
BR,CG,2008.0,1,0,1
CL,TW,2013.0,1,0,1
TH,CL,2020.0,1,0,1
BO,CG,2000.0,1,0,1
MV,TH,2008.0,1,0,1
TT,ES,2009.0,1,0,1
AU,BS,2019.0,1,0,1
TT,IR,2009.0,1,0,1
,GF,2000.0,1,0,1
RS,MY,2017.0,1,0,1
AZ,AU,2016.0,1,0,1
CG,BH,2017.0,1,0,1
IL,KE,2014.0,1,0,1
KN,DK,2019.0,1,0,1
LK,NO,1997.0,1,0,1
BA,PH,2016.0,1,0,1
NG,BY,2021.0,1,0,1
CO,BD,2017.0,1,0,1
FI,PE,2022.0,1,0,1
AT,YE,2014.0,1,0,1
SG,ES,2005.0,1,0,1
MA,IT,2023.0,1,0,1
KZ,FJ,2018.0,1,0,1
HR,IL,2020.0,1,0,1
SC,NL,2018.0,1,0,1
,KP,2004.0,1,0,1
CN,DE,2021.0,334,378,-44
DE,CN,2022.0,325,273,52
CA,GB,2015.0,947,903,44
BR,PT,2011.0,802,629,173
KR,CN,2014.0,301,275,26
FR,PT,2013.0,43,49,-6
CL,MX,2018.0,216,219,-3
TW,CN,2013.0,1278,928,350
MX,CL,2017.0,233,213,20
CN,AU,2015.0,501,405,96
NO,US,2009.0,111,171,-60
RO,ES,2019.0,12,24,-12
ES,CL,2018.0,493,379,114
GB,AU,2020.0,1440,1388,52
ES,AR,2018.0,443,354,89
ES,MX,2018.0,1104,926,178
BR,MX,2018.0,176,155,21
FI,CA,2000.0,10,16,-6
IR,US,2009.0,202,172,30
SE,US,2018.0,549,554,-5
US,CO,2014.0,309,300,9
NL,CA,2018.0,112,105,7
US,NO,2006.0,124,108,16
NL,GB,2016.0,384,311,73
BE,DE,2008.0,81,91,-10
KE,US,2021.0,77,62,15
FR,US,2020.0,1440,1302,138
CN,JP,2006.0,387,605,-218
ES,EC,2020.0,208,196,12
MX,CL,2019.0,268,232,36
NZ,US,2009.0,321,333,-12
US,ZA,2021.0,234,313,-79
DE,FR,2020.0,503,527,-24
ES,IN,2019.0,25,29,-4
CN,GB,2022.0,411,601,-190
US,HR,2009.0,48,32,16
MY,SA,2011.0,17,10,7
ZA,DE,2014.0,63,76,-13
ES,CN,2016.0,74,59,15
PT,BR,2014.0,991,943,48
US,IN,2002.0,649,921,-272
ES,AT,2008.0,22,19,3
AU,DE,2013.0,225,238,-13
IR,DE,2007.0,23,27,-4
CH,IT,2017.0,274,413,-139
GB,IR,2021.0,63,115,-52
GB,TR,2013.0,128,84,44
KR,ET,2009.0,111,112,-1
BE,GR,2021.0,19,18,1
ES,IT,2005.0,89,116,-27
CA,AU,2018.0,436,419,17
CO,ES,2013.0,383,431,-48
MX,CO,2011.0,232,172,60
AR,MX,2018.0,192,201,-9
US,SK,2008.0,39,29,10
JP,IN,2006.0,120,109,11
MX,ES,2000.0,202,200,2
MX,GB,2001.0,24,42,-18
GR,JP,2012.0,68,28,40
GB,JP,2011.0,270,240,30
FR,IE,2016.0,46,32,14
PK,nan,2013.0,9,6,3
SG,AU,2012.0,86,116,-30
GB,ZA,2008.0,118,120,-2
GB,KR,2004.0,55,51,4
BE,IL,2002.0,9,4,5
NL,CN,2011.0,97,105,-8
LT,JP,2009.0,28,6,22
PE,MX,2020.0,126,183,-57
GB,BE,2014.0,141,162,-21
CA,BD,2017.0,36,51,-15
AR,CO,2014.0,93,92,1
NO,TZ,2018.0,11,4,7
DE,SE,2011.0,223,161,62
nan,JP,2004.0,96,50,46
CN,CA,2015.0,494,553,-59
ZA,FR,2009.0,17,28,-11
IT,DK,2015.0,62,21,41
US,IR,2020.0,447,700,-253
MX,UY,2011.0,9,7,2
MK,AU,2015.0,73,51,22
CH,IT,2010.0,160,270,-110
ID,MY,2019.0,213,534,-321
IR,NL,2018.0,52,44,8
CU,CR,2013.0,16,22,-6
IE,FR,2009.0,30,40,-10
CA,CH,1999.0,43,43,0
IN,CZ,2011.0,20,11,9
JP,nan,2018.0,43,54,-11
DE,KR,2001.0,18,9,9
ES,JP,1999.0,14,16,-2
DE,DK,2016.0,206,153,53
RU,DE,2019.0,201,237,-36
PT,ES,2004.0,46,55,-9
GB,CH,2003.0,136,146,-10
CH,US,2007.0,569,674,-105
IN,BN,2017.0,4,1,3
IN,IR,2010.0,27,16,11
GB,NL,2021.0,354,256,98
CA,BE,2021.0,42,50,-8
HK,US,2009.0,6,11,-5
GB,CY,2021.0,32,19,13
EG,ES,2015.0,14,16,-2
CA,TW,2015.0,38,44,-6
RU,HR,2014.0,2,4,-2
US,RU,2000.0,206,322,-116
US,nan,2018.0,313,307,6
CN,IE,2017.0,29,32,-3
BR,CA,2014.0,259,289,-30
US,RS,2020.0,54,53,1
TW,BE,2014.0,5,5,0
US,PT,2007.0,118,100,18
AU,nan,2015.0,41,63,-22
NL,SE,2015.0,77,42,35
FI,KR,2008.0,26,5,21
PL,CN,2021.0,16,23,-7
CA,SG,2008.0,33,32,1
JP,MX,2005.0,9,16,-7
ES,PT,2013.0,202,129,73
SA,EG,2022.0,269,317,-48
CZ,US,2003.0,77,88,-11
nan,BR,2004.0,17,27,-10
MX,CA,2016.0,39,39,0
NL,HU,2019.0,18,13,5
QA,GB,2018.0,26,60,-34
FR,CO,2018.0,45,37,8
HR,RS,2020.0,127,140,-13
LV,RU,2019.0,21,18,3
US,SA,2005.0,58,43,15
NO,SE,2012.0,78,108,-30
ID,KR,2021.0,54,42,12
TH,NZ,2012.0,2,2,0
IN,IR,2017.0,38,25,13
nan,CN,2008.0,226,203,23
DE,IE,2016.0,101,99,2
SK,DE,2001.0,15,15,0
BD,GB,2018.0,69,52,17
IE,IR,2014.0,7,18,-11
IE,CN,2007.0,27,34,-7
GB,TW,2003.0,42,38,4
CA,FR,2000.0,212,254,-42
TN,CH,2010.0,9,5,4
KR,CA,2011.0,54,47,7
CH,DE,1998.0,260,318,-58
GR,IT,2012.0,20,21,-1
DE,CL,2008.0,24,29,-5
BE,DK,2015.0,70,55,15
TW,DE,2013.0,30,21,9
SE,BG,2000.0,3,7,-4
US,NE,2016.0,4,2,2
MX,BR,2021.0,112,105,7
FR,DZ,2012.0,146,61,85
BY,RU,2018.0,133,62,71
AU,TH,2008.0,27,12,15
KG,AZ,2020.0,2,1,1
BE,AT,2022.0,6,16,-10
RU,DE,2017.0,170,206,-36
SE,CA,2003.0,36,42,-6
NL,DK,2020.0,72,56,16
NO,GB,2011.0,55,91,-36
NO,nan,2011.0,38,45,-7
NL,DE,2023.0,17,23,-6
DE,SG,2012.0,36,28,8
US,HU,2016.0,107,94,13
NL,FR,2021.0,95,131,-36
FR,DK,2021.0,43,39,4
LY,US,2020.0,4,10,-6
AR,IN,2011.0,5,4,1
SA,DZ,2017.0,6,6,0
FR,MX,2006.0,41,33,8
DZ,US,2006.0,7,9,-2
NG,ID,2015.0,9,4,5
PK,FR,2011.0,7,21,-14
OM,GB,2014.0,10,21,-11
PT,CO,2011.0,8,11,-3
CN,KR,2022.0,212,170,42
JO,DE,2018.0,8,11,-3
CH,IT,2019.0,280,435,-155
IT,NL,2009.0,81,57,24
LY,EG,2019.0,7,12,-5
MA,TN,2003.0,5,5,0
AM,RU,2009.0,10,5,5
GH,JP,2018.0,3,5,-2
IT,AT,2019.0,87,58,29
ZA,GB,2008.0,120,118,2
CA,SA,2008.0,42,20,22
AT,CH,2016.0,127,114,13
SA,IN,2020.0,112,181,-69
BR,IL,2009.0,4,9,-5
RU,FR,2019.0,93,84,9
MY,AU,2016.0,143,129,14
CA,RU,2018.0,42,39,3
IT,EG,2021.0,11,9,2
FR,KR,2016.0,29,30,-1
nan,PL,2016.0,17,20,-3
UA,nan,2012.0,18,20,-2
ES,IT,2002.0,74,66,8
DE,CA,2006.0,206,166,40
VN,CN,2016.0,14,26,-12
PL,FI,2020.0,11,18,-7
ID,MY,2017.0,151,383,-232
VN,KR,2018.0,63,112,-49
IT,BR,2001.0,58,53,5
EC,PE,2014.0,15,12,3
RU,FR,2017.0,80,110,-30
MX,PH,2018.0,15,11,4
MY,BR,2021.0,13,19,-6
NL,EG,2014.0,9,7,2
IN,IR,2019.0,47,25,22
IN,CA,2021.0,211,176,35
JP,TH,2015.0,108,61,47
LK,ID,2021.0,7,4,3
BR,TR,2013.0,19,30,-11
DE,ZA,2009.0,40,37,3
BD,ID,2019.0,63,45,18
FR,RO,2017.0,63,39,24
IE,IL,1999.0,1,1,0
EG,NL,2005.0,3,3,0
LK,GB,2009.0,11,21,-10
IR,VN,2020.0,16,4,12
TN,GB,2011.0,4,3,1
FI,PL,2020.0,18,11,7
BR,MY,2021.0,19,13,6
AE,NL,2013.0,2,6,-4
IN,ET,2020.0,64,29,35
nan,IT,2021.0,63,36,27
US,BD,2009.0,71,40,31
JP,BE,2016.0,24,31,-7
ML,BF,2017.0,5,3,2
HR,BA,2019.0,60,46,14
AT,BE,2006.0,10,9,1
FR,PH,2009.0,11,5,6
US,SA,2002.0,46,34,12
MY,NG,2013.0,25,24,1
AU,BE,2016.0,44,53,-9
FR,RU,2000.0,43,36,7
CN,BE,2000.0,24,10,14
CH,DE,1997.0,204,201,3
US,RW,2020.0,24,19,5
UA,IT,1998.0,2,7,-5
NG,US,2003.0,19,18,1
SN,FR,2012.0,33,45,-12
RU,CZ,2015.0,42,54,-12
nan,IN,2022.0,53,44,9
RU,ZW,2022.0,62,7,55
CM,NG,2020.0,6,9,-3
JP,BD,2015.0,57,38,19
TZ,RW,2020.0,7,2,5
PH,CN,1997.0,4,4,0
IL,GB,2013.0,47,70,-23
US,QA,2015.0,95,50,45
IE,SE,2012.0,20,9,11
IN,PK,2000.0,17,10,7
VN,TH,2021.0,12,13,-1
nan,PE,2008.0,4,8,-4
KR,MY,2006.0,4,4,0
IN,BE,2018.0,61,54,7
CA,BD,2010.0,18,17,1
FR,MA,2000.0,117,96,21
TR,TW,2005.0,11,5,6
DK,VN,2022.0,1,1,0
KR,DK,2018.0,3,1,2
US,TH,2021.0,128,100,28
TR,CH,2020.0,29,27,2
TR,NL,2021.0,29,30,-1
TR,FI,2018.0,9,4,5
RO,MX,2021.0,1,2,-1
NL,KR,2015.0,10,11,-1
CA,FI,2014.0,21,20,1
UA,CN,2008.0,16,16,0
BN,GB,2006.0,3,1,2
NO,IR,2010.0,6,7,-1
US,KW,2021.0,16,14,2
TH,CA,2021.0,8,10,-2
MD,nan,2001.0,1,1,0
HN,CO,2018.0,3,8,-5
FR,MG,2008.0,13,6,7
CA,PK,2002.0,2,4,-2
DK,AR,2015.0,3,1,2
AU,PL,2022.0,12,7,5
AT,US,2015.0,244,264,-20
ZA,ID,2013.0,5,3,2
AU,CL,2017.0,28,24,4
CL,HN,2022.0,3,1,2
KR,CZ,2018.0,10,6,4
ZA,IT,2017.0,18,27,-9
SK,SE,2003.0,5,1,4
QA,SA,2021.0,17,29,-12
FR,ZA,2014.0,41,32,9
BE,JP,2016.0,31,24,7
SG,IQ,2018.0,4,8,-4
SE,DK,2001.0,44,40,4
LY,EG,2017.0,10,11,-1
PT,CH,2014.0,27,16,11
CL,CU,1999.0,3,5,-2
SY,GB,2017.0,5,2,3
OM,TW,2022.0,2,1,1
KR,AM,2009.0,6,12,-6
NO,NP,2021.0,3,3,0
GB,BG,2020.0,13,16,-3
KZ,RU,2021.0,73,73,0
DE,JO,2019.0,11,8,3
UG,CA,2019.0,3,3,0
QA,KR,2020.0,4,4,0
PS,IQ,2018.0,1,1,0
ZW,NL,2021.0,2,3,-1
PL,RU,2019.0,61,47,14
TW,CZ,2018.0,3,1,2
FI,GB,2018.0,75,89,-14
CN,VN,2000.0,14,5,9
US,SD,2009.0,4,7,-3
CA,BD,2019.0,46,48,-2
IE,GB,2023.0,17,15,2
JP,EG,2021.0,46,42,4
US,PA,2021.0,32,42,-10
FR,LB,2020.0,92,107,-15
PL,GB,2002.0,22,45,-23
US,MY,2021.0,136,130,6
IT,HU,2017.0,13,13,0
HR,BA,2017.0,56,41,15
MY,US,2000.0,19,20,-1
VG,US,2006.0,9,7,2
CH,JP,2020.0,105,93,12
CA,DK,2000.0,21,10,11
PT,DK,2020.0,13,11,2
NL,ID,2020.0,51,45,6
AU,BD,2018.0,61,91,-30
LU,FR,2004.0,9,20,-11
FR,FI,2015.0,34,24,10
UA,BY,2014.0,15,9,6
MX,nan,2011.0,21,17,4
AT,MK,2018.0,12,16,-4
FR,UA,2008.0,8,13,-5
ID,PK,2022.0,47,13,34
RU,DE,2010.0,162,133,29
MD,RO,2012.0,3,3,0
EC,BO,2020.0,5,5,0
CN,BD,2021.0,49,43,6
IN,CN,2021.0,238,208,30
VN,TW,2020.0,24,39,-15
NL,nan,2022.0,22,69,-47
PE,UA,2016.0,1,1,0
TR,KH,2021.0,3,1,2
GB,TZ,2004.0,4,3,1
IT,ZA,2000.0,4,4,0
ES,RO,2011.0,19,7,12
IL,CH,2016.0,16,10,6
TR,IT,2015.0,18,28,-10
BE,GB,1997.0,34,36,-2
CR,US,1999.0,8,10,-2
AT,JP,2001.0,7,11,-4
CH,PK,2008.0,8,20,-12
SE,AU,2006.0,53,36,17
IN,SI,2015.0,3,2,1
PT,MA,2016.0,10,14,-4
BE,BR,2008.0,34,37,-3
CM,FR,2003.0,9,14,-5
SE,GR,2012.0,7,13,-6
AL,XK,2022.0,2,3,-1
CA,IL,2000.0,32,22,10
ID,US,1998.0,11,9,2
GB,LK,2009.0,21,11,10
VE,FR,2008.0,13,4,9
TH,KR,2013.0,6,16,-10
NL,MT,2015.0,2,1,1
IN,SE,2003.0,22,13,9
BG,PT,2011.0,2,2,0
DE,FI,2009.0,41,48,-7
IT,AT,2017.0,97,61,36
CA,CZ,2018.0,12,9,3
ZA,GH,2015.0,7,15,-8
BO,ES,2019.0,23,13,10
PG,TN,2016.0,2,4,-2
MA,KW,2015.0,7,12,-5
IN,RU,2015.0,20,24,-4
GB,GR,2000.0,103,48,55
DK,SG,2007.0,3,4,-1
NL,SG,2022.0,8,7,1
DK,PL,2015.0,9,13,-4
PH,SG,2014.0,8,8,0
GB,BH,2019.0,8,6,2
RU,AZ,2016.0,13,10,3
RS,GB,2013.0,18,19,-1
CA,ZA,2014.0,49,45,4
DK,KE,2016.0,10,2,8
PT,VE,2009.0,6,2,4
AU,ES,2006.0,18,16,2
ID,GB,2016.0,16,86,-70
ES,FI,2016.0,31,21,10
US,AE,2009.0,48,22,26
FR,AT,2003.0,21,17,4
GB,FJ,2021.0,1,1,0
AU,ZA,2006.0,34,42,-8
CA,LB,2016.0,12,15,-3
IT,NO,2015.0,30,20,10
DK,DE,2011.0,127,146,-19
FR,AE,2019.0,18,9,9
IL,RU,2013.0,35,20,15
DE,JO,2017.0,17,4,13
US,AO,2015.0,4,1,3
NO,IT,2021.0,22,26,-4
IL,JP,2018.0,16,6,10
FR,BR,2008.0,144,133,11
FR,TN,1999.0,27,22,5
EG,PS,2015.0,6,5,1
DK,CH,2000.0,16,13,3
SK,ID,2019.0,4,1,3
RO,GB,2016.0,55,53,2
ES,DK,2020.0,64,42,22
CH,TN,2011.0,10,9,1
ES,IN,2017.0,32,22,10
FR,CH,2023.0,15,11,4
BD,JP,1999.0,13,10,3
SI,US,2008.0,14,11,3
GP,FR,2015.0,20,24,-4
CZ,nan,2009.0,9,9,0
SG,NZ,2015.0,12,11,1
DE,VN,2011.0,16,7,9
ML,FR,2005.0,4,6,-2
ES,NL,2006.0,58,64,-6
AT,PL,2015.0,20,15,5
SI,ES,2015.0,13,11,2
ES,SI,2017.0,12,15,-3
CO,NZ,2017.0,2,3,-1
ML,BF,2019.0,3,4,-1
CY,TR,2009.0,10,10,0
HR,SE,2011.0,2,1,1
ES,EE,2021.0,5,2,3
FR,ID,2003.0,5,2,3
MD,MA,2019.0,1,6,-5
CZ,DK,2022.0,3,3,0
MM,CN,2005.0,7,7,0
NO,RO,2014.0,4,2,2
NL,VN,2018.0,15,5,10
RO,RU,2020.0,11,2,9
IL,IR,2010.0,1,1,0
NP,US,2007.0,15,8,7
JP,SG,2000.0,15,9,6
AT,IL,2022.0,7,4,3
PK,ES,2012.0,3,2,1
PE,AR,2022.0,27,23,4
BE,CH,2005.0,34,27,7
JO,BH,2005.0,3,1,2
IT,SM,2016.0,1,3,-2
IL,ES,2009.0,24,7,17
PK,JP,2012.0,6,10,-4
CL,JP,2019.0,6,13,-7
TH,VN,2021.0,13,12,1
RU,KR,2001.0,8,1,7
RO,ES,2017.0,15,21,-6
RU,LV,2015.0,21,18,3
BD,ID,2017.0,46,25,21
US,GT,2021.0,12,5,7
KE,BR,2022.0,4,1,3
RS,HU,2000.0,1,1,0
BG,UA,2016.0,10,10,0
DE,TZ,2022.0,1,2,-1
BE,DZ,2012.0,5,2,3
CY,GR,2020.0,47,91,-44
LU,PT,2011.0,1,1,0
AR,PT,2011.0,11,4,7
JP,SA,2016.0,14,9,5
CA,AE,2012.0,25,14,11
YE,IN,2018.0,1,5,-4
GB,AE,2008.0,22,15,7
BO,US,2021.0,7,6,1
BD,FR,2016.0,5,5,0
IN,SK,2020.0,5,2,3
PY,EC,2019.0,6,3,3
KR,PR,2002.0,21,30,-9
AE,NZ,2012.0,10,5,5
BO,MX,2019.0,6,11,-5
ID,MY,2010.0,34,21,13
PH,IT,2017.0,1,6,-5
ID,AU,2015.0,42,99,-57
JP,TZ,2019.0,5,5,0
TR,nan,2021.0,14,22,-8
LV,RU,2017.0,21,20,1
MZ,BR,2022.0,8,9,-1
FI,DK,2007.0,13,12,1
MY,BD,2023.0,5,5,0
RO,ES,2010.0,7,11,-4
JP,CZ,2007.0,17,15,2
US,CG,2016.0,4,2,2
BD,US,2004.0,20,20,0
IT,AT,2010.0,38,41,-3
FR,CL,1999.0,13,7,6
KR,ID,2011.0,11,7,4
CO,PE,2009.0,16,20,-4
CA,NZ,2009.0,57,72,-15
PH,DE,2011.0,3,10,-7
CH,PL,2011.0,17,25,-8
IN,HU,2005.0,8,3,5
TH,DE,2015.0,12,33,-21
KR,TR,2015.0,2,6,-4
SE,nan,2009.0,38,62,-24
NL,TZ,2019.0,4,5,-1
IE,ES,2011.0,21,18,3
OM,AU,2013.0,2,5,-3
OM,US,2008.0,4,14,-10
IN,HU,2002.0,5,2,3
nan,NO,2012.0,45,24,21
DE,BR,1999.0,43,24,19
RU,FR,2010.0,71,58,13
ET,LK,2011.0,2,2,0
BY,UA,2003.0,3,4,-1
TW,IN,2000.0,7,13,-6
DE,KE,2012.0,11,12,-1
HR,nan,2010.0,5,3,2
ES,HU,2010.0,3,8,-5
MK,US,2014.0,12,9,3
LU,BE,2016.0,15,25,-10
GB,BH,2010.0,1,5,-4
RS,US,2008.0,31,61,-30
EG,NG,2020.0,10,6,4
BE,KR,2019.0,9,11,-2
FR,ML,2022.0,7,7,0
ID,FR,2013.0,14,23,-9
RU,ES,1999.0,14,7,7
SG,TH,2011.0,4,6,-2
DK,CA,2006.0,22,21,1
PL,RU,2010.0,16,15,1
US,CM,2008.0,7,7,0
FI,IT,1997.0,2,1,1
PL,nan,2021.0,8,10,-2
nan,BY,2018.0,1,2,-1
FR,AE,2010.0,12,3,9
CO,BD,2018.0,2,1,1
CH,AT,2000.0,39,48,-9
IE,SA,2019.0,11,5,6
SE,HU,2022.0,6,13,-7
RU,RS,2006.0,7,4,3
PL,SK,2019.0,19,13,6
PL,GB,2005.0,36,33,3
BW,NG,2012.0,5,3,2
US,IL,2023.0,9,15,-6
CN,VE,2008.0,1,1,0
NL,IE,2018.0,28,21,7
CA,SE,2002.0,28,33,-5
SE,IT,2003.0,33,56,-23
CI,CH,2018.0,4,2,2
NL,CW,2005.0,4,13,-9
PE,GB,2020.0,23,19,4
JP,TR,1999.0,32,34,-2
BR,UY,2008.0,30,32,-2
NO,CH,2015.0,12,27,-15
SG,NL,2007.0,6,8,-2
BF,CG,2012.0,1,1,0
BE,CH,2002.0,40,25,15
US,BG,1997.0,14,15,-1
BE,GB,1998.0,41,31,10
GB,SJ,2016.0,2,3,-1
KW,BH,2015.0,1,1,0
TZ,CN,2010.0,1,2,-1
LU,GB,2015.0,11,22,-11
PE,ID,2021.0,5,5,0
DZ,FR,1998.0,16,15,1
BO,ES,2017.0,17,22,-5
NE,CH,2020.0,4,1,3
AE,ES,2019.0,3,8,-5
GR,BR,2007.0,5,2,3
BY,FR,2014.0,2,1,1
AU,CL,2019.0,23,26,-3
MT,CA,2017.0,4,2,2
MT,CA,2019.0,1,1,0
IR,FR,2009.0,13,31,-18
AR,BR,1999.0,26,15,11
AR,EC,2014.0,21,9,12
CN,IE,2019.0,26,47,-21
EG,AU,2011.0,8,13,-5
NZ,NP,2008.0,7,5,2
DK,NG,2017.0,2,2,0
AE,ES,2017.0,5,3,2
FR,CM,2011.0,17,13,4
SG,DK,2011.0,8,3,5
NZ,MV,2019.0,1,1,0
CU,ES,2022.0,38,27,11
IN,FR,1999.0,23,53,-30
IT,CL,2011.0,25,14,11
KW,MY,2017.0,2,5,-3
BE,CN,2009.0,46,46,0
NO,CN,2004.0,11,4,7
CH,AU,2000.0,30,30,0
PA,PH,2018.0,1,1,0
ES,SI,2019.0,15,13,2
MD,MA,2017.0,1,3,-2
IE,PK,2019.0,25,12,13
BR,KR,2018.0,6,2,4
CA,PH,2005.0,7,3,4
GF,FR,2009.0,12,13,-1
RU,HU,2001.0,8,2,6
FR,BF,2018.0,18,17,1
GE,US,1999.0,82,77,5
LB,AU,2022.0,1,1,0
PE,CO,2006.0,16,8,8
NO,SA,2018.0,2,2,0
nan,PK,2013.0,6,9,-3
PK,GR,2011.0,2,2,0
RS,NO,2014.0,7,1,6
GM,GB,2005.0,10,8,2
TR,TW,2002.0,8,6,2
CA,VE,2009.0,5,4,1
BD,FI,2020.0,5,4,1
MY,GB,1998.0,9,19,-10
CA,UG,2019.0,3,3,0
NO,NL,2022.0,23,30,-7
CZ,CA,2005.0,10,9,1
CL,JP,2010.0,3,8,-5
IN,MX,2011.0,13,11,2
CZ,AT,2007.0,16,6,10
KW,TR,2018.0,7,13,-6
AZ,TR,2019.0,5,20,-15
AU,CY,2016.0,3,3,0
DZ,FR,1997.0,5,7,-2
US,BN,2021.0,5,1,4
KW,NG,2012.0,2,1,1
IT,SK,2004.0,4,2,2
DK,GW,2009.0,3,2,1
CA,PH,2002.0,6,1,5
MY,RU,2009.0,7,7,0
VN,FR,2001.0,4,11,-7
SI,MY,2016.0,1,2,-1
RU,MZ,2009.0,10,11,-1
AU,GH,2012.0,2,1,1
IS,US,2021.0,9,19,-10
GR,TR,2011.0,8,3,5
PL,SK,2017.0,8,10,-2
JP,ZA,2011.0,12,4,8
LK,OM,2015.0,1,2,-1
VN,BE,2003.0,2,2,0
DK,NO,2023.0,7,2,5
HR,AU,2022.0,6,2,4
CL,UY,2014.0,5,8,-3
DE,IR,2009.0,28,36,-8
SE,PL,2018.0,24,37,-13
HK,NL,2008.0,11,21,-10
BR,NO,2013.0,33,17,16
PH,CL,2020.0,3,4,-1
LU,NL,2020.0,9,7,2
GT,US,2018.0,16,18,-2
TN,CH,2019.0,12,9,3
LK,IN,2014.0,6,12,-6
FR,AE,2017.0,13,3,10
VE,GB,2019.0,8,1,7
MD,RU,2021.0,4,1,3
CZ,BE,2016.0,8,12,-4
GH,US,2007.0,7,5,2
SA,DZ,2019.0,7,15,-8
QA,PK,2021.0,14,18,-4
GB,EG,1999.0,6,15,-9
FI,EE,2011.0,14,11,3
GM,GB,2002.0,2,5,-3
BG,CN,2006.0,7,4,3
HR,SI,2002.0,3,6,-3
SK,NL,2011.0,8,3,5
NL,NO,1999.0,11,6,5
TR,NO,2002.0,2,2,0
SA,OM,2006.0,2,1,1
IR,EG,2022.0,8,4,4
AT,BR,2009.0,10,13,-3
UY,CL,2013.0,9,21,-12
SE,NI,2004.0,2,3,-1
GB,OM,2004.0,4,5,-1
FJ,AU,2014.0,6,6,0
CO,JP,2020.0,12,9,3
CH,SG,2015.0,15,11,4
XK,AL,2022.0,3,2,1
IN,SD,2019.0,3,2,1
ES,ET,2021.0,1,2,-1
PL,MZ,2013.0,11,6,5
nan,PR,2020.0,2,1,1
FI,IT,1998.0,6,7,-1
CL,IT,2007.0,19,17,2
CA,SE,2005.0,35,43,-8
ID,CZ,2021.0,6,18,-12
NO,SK,2019.0,2,5,-3
CH,SA,2019.0,7,10,-3
CN,FI,2006.0,9,16,-7
NO,DE,2000.0,19,23,-4
IT,HU,2010.0,7,14,-7
FR,SA,2007.0,12,3,9
DK,AT,2018.0,13,26,-13
CR,GB,2012.0,3,4,-1
RU,MY,2014.0,16,21,-5
IN,NO,2003.0,24,11,13
FR,TR,1999.0,4,2,2
ID,US,1997.0,7,6,1
CH,SI,2020.0,10,12,-2
LT,US,2015.0,10,13,-3
CZ,HR,2014.0,4,11,-7
EC,BR,2013.0,7,7,0
JO,EG,2002.0,5,2,3
TR,CZ,2012.0,5,9,-4
BW,CA,2009.0,2,1,1
TZ,GB,2008.0,3,8,-5
SE,SG,2004.0,5,3,2
MQ,FR,2004.0,6,4,2
QA,DK,2022.0,2,2,0
CZ,RS,2011.0,11,2,9
NL,TZ,2017.0,5,1,4
DE,LT,2017.0,9,6,3
AU,ID,1998.0,3,1,2
NP,KR,2008.0,4,2,2
BE,TR,2006.0,7,4,3
JP,GR,2012.0,28,68,-40
ZA,IT,2019.0,17,36,-19
NZ,NO,2018.0,12,5,7
BD,IR,2022.0,3,3,0
BA,RS,2005.0,5,4,1
AR,PA,2007.0,2,2,0
NL,HU,2017.0,12,20,-8
CH,MX,2013.0,11,8,3
CZ,PL,2011.0,41,45,-4
KR,EG,2006.0,5,2,3
SA,IR,2014.0,5,6,-1
PL,IN,2002.0,4,6,-2
DE,JO,2010.0,10,8,2
GA,CA,2014.0,1,2,-1
NP,GB,2009.0,2,7,-5
EG,YE,2013.0,7,8,-1
AE,GB,2006.0,8,15,-7
JP,TZ,2010.0,4,1,3
CH,IE,2007.0,6,4,2
NG,SA,2009.0,1,3,-2
LT,KH,2013.0,1,1,0
AZ,TR,2017.0,12,18,-6
JP,NZ,2007.0,17,14,3
GB,KW,2011.0,6,13,-7
US,JM,2001.0,21,13,8
PT,CA,2022.0,8,13,-5
NO,BE,2022.0,10,9,1
SY,nan,2019.0,1,1,0
CA,JO,2003.0,5,2,3
FR,SG,2006.0,11,7,4
SI,CZ,2007.0,10,6,4
SA,IT,2013.0,3,19,-16
LU,AU,2010.0,2,2,0
AU,IR,2023.0,2,6,-4
UY,CU,2006.0,2,1,1
NZ,IE,2021.0,12,14,-2
BO,MX,2010.0,2,1,1
JP,OM,2014.0,1,1,0
HU,NG,2016.0,1,1,0
IN,DK,2004.0,6,7,-1
TW,BR,2010.0,2,2,0
HN,BR,2013.0,4,1,3
CG,FR,2021.0,14,13,1
DK,ZA,2010.0,6,4,2
SG,CH,2002.0,2,1,1
GR,RS,2008.0,3,1,2
MY,GB,1997.0,9,14,-5
TN,CH,2017.0,13,15,-2
BE,KR,2017.0,17,21,-4
IN,NL,1999.0,16,11,5
BE,PH,2014.0,2,1,1
DK,NZ,2022.0,5,3,2
KR,PR,2005.0,19,21,-2
FR,SY,2018.0,13,7,6
TW,RU,2018.0,14,15,-1
AT,NL,1999.0,11,10,1
ES,HN,2000.0,4,5,-1
DE,NZ,2003.0,20,20,0
GB,PR,2018.0,1,1,0
DZ,BE,2007.0,3,2,1
SE,XK,2011.0,1,2,-1
GB,CM,2014.0,8,5,3
IS,NO,2020.0,4,6,-2
IN,ZA,2006.0,16,17,-1
BO,PE,2010.0,2,5,-3
KR,UZ,2003.0,1,3,-2
MM,CN,2002.0,13,5,8
SE,MX,2011.0,4,7,-3
GR,KW,2006.0,2,1,1
IE,BE,2004.0,3,2,1
BE,ZA,2020.0,22,25,-3
MM,JP,2005.0,1,3,-2
IT,HU,2019.0,9,12,-3
GB,YE,1997.0,1,1,0
BR,CZ,2022.0,15,4,11
VE,PT,2018.0,4,4,0
IE,JP,2022.0,10,22,-12
NG,PT,2016.0,2,1,1
NE,MA,2016.0,2,1,1
ZW,US,2015.0,14,6,8
SY,IT,1998.0,1,2,-1
PK,TH,2018.0,8,13,-5
GB,UA,2022.0,6,11,-5
CL,IL,2022.0,3,4,-1
PK,KW,2020.0,3,5,-2
FR,QA,2009.0,8,2,6
ML,CI,2014.0,2,2,0
CH,SA,2017.0,6,5,1
TH,KH,2022.0,5,4,1
AT,EG,2019.0,7,4,3
EC,RU,2021.0,1,1,0
RS,nan,2019.0,3,2,1
BO,PE,2019.0,12,7,5
SI,DE,2020.0,8,17,-9
AE,KW,2019.0,5,8,-3
ZA,PT,2016.0,3,1,2
AT,GB,1999.0,20,20,0
SE,UA,2011.0,3,8,-5
AU,JM,2009.0,1,2,-1
CH,FI,2014.0,22,22,0
AE,ZA,2004.0,2,3,-1
HU,FI,2001.0,5,8,-3
IL,UA,2007.0,1,3,-2
CO,MY,2018.0,3,1,2
IL,AT,2015.0,5,4,1
HR,BA,2010.0,19,12,7
PK,IE,2012.0,9,9,0
NZ,PK,2001.0,2,1,1
BN,JP,2013.0,2,2,0
DK,ZA,2017.0,9,7,2
SG,SE,2007.0,3,6,-3
ET,US,2000.0,8,13,-5
JO,EG,2005.0,2,2,0
MY,DK,2014.0,5,4,1
EG,TN,2012.0,12,8,4
NL,CZ,2008.0,13,11,2
ZA,SG,2021.0,3,3,0
NL,LT,2010.0,2,3,-1
US,PR,2016.0,1,7,-6
KR,NG,2014.0,12,9,3
BG,CH,2003.0,3,2,1
AR,AU,2013.0,8,7,1
LV,RU,2010.0,10,22,-12
JP,DK,2007.0,10,10,0
GE,UA,2016.0,1,4,-3
AT,EG,2017.0,6,4,2
MA,MY,2019.0,2,6,-4
PK,SA,2004.0,8,9,-1
ET,CA,2021.0,8,4,4
ID,FI,2016.0,4,2,2
GE,RU,2005.0,3,1,2
GE,SE,2020.0,1,1,0
FR,KH,2020.0,7,12,-5
ZA,IT,2010.0,9,10,-1
TT,IN,2015.0,2,2,0
IR,TN,2010.0,1,1,0
BE,FI,2011.0,7,8,-1
ID,RU,2020.0,15,34,-19
AT,SK,2021.0,9,8,1
EE,IT,2022.0,4,6,-2
NZ,SG,2016.0,20,12,8
EE,JP,2015.0,2,2,0
ET,BH,2016.0,14,5,9
KW,MY,2019.0,3,6,-3
NG,ES,2017.0,3,1,2
CL,nan,2021.0,3,2,1
DK,RS,2001.0,1,1,0
JP,KE,1999.0,2,2,0
JP,MX,2002.0,9,5,4
MA,PT,2011.0,4,1,3
PL,GR,2016.0,1,1,0
SA,NL,2007.0,3,4,-1
GH,NL,2012.0,3,1,2
LT,DK,2008.0,2,1,1
UA,IL,2009.0,2,1,1
NL,LT,2019.0,3,2,1
GR,LK,2015.0,3,9,-6
JP,UA,2008.0,4,7,-3
GR,PT,2004.0,1,1,0
QA,JO,2008.0,3,3,0
DK,BE,2001.0,4,5,-1
nan,DE,1999.0,8,18,-10
SE,SI,2007.0,1,2,-1
DK,FI,2005.0,6,9,-3
RS,CH,2004.0,5,3,2
BH,GB,2014.0,5,6,-1
NG,TT,2018.0,1,1,0
UG,NL,2014.0,1,5,-4
RS,SK,2022.0,3,4,-1
PT,RS,2021.0,3,1,2
IE,BR,2012.0,5,12,-7
IT,VN,2011.0,3,1,2
NL,SI,2005.0,2,2,0
BJ,GH,2021.0,2,1,1
UZ,FR,2012.0,1,1,0
ZA,HU,2014.0,2,1,1
RW,AU,2016.0,1,1,0
NL,PH,2017.0,3,10,-7
EG,RU,2016.0,7,7,0
nan,DZ,2011.0,4,4,0
QA,SE,2016.0,5,1,4
UA,CH,2020.0,4,4,0
NL,GA,2013.0,3,5,-2
FR,ET,2007.0,1,1,0
nan,AT,2008.0,6,13,-7
NZ,LA,2002.0,3,1,2
NO,IR,2017.0,3,16,-13
GB,ET,2013.0,9,5,4
CN,BR,2001.0,6,14,-8
CO,CH,2005.0,3,3,0
ES,KE,2001.0,1,1,0
BR,BY,2000.0,2,1,1
AU,MK,1999.0,3,4,-1
RU,CL,2009.0,4,3,1
US,SY,2015.0,6,9,-3
NZ,nan,2004.0,13,5,8
CA,UY,2020.0,2,4,-2
IR,CH,2005.0,2,1,1
ZA,IE,2007.0,7,4,3
SE,MY,2000.0,1,2,-1
GR,AT,2006.0,3,2,1
SG,NO,2013.0,2,1,1
IE,BD,2009.0,2,1,1
GB,JO,2007.0,9,8,1
AF,MX,2005.0,1,3,-2
AR,IE,1999.0,2,1,1
PK,NO,2013.0,9,6,3
IN,SD,2017.0,2,3,-1
CN,BO,2000.0,3,1,2
BO,MX,2017.0,15,13,2
SE,KE,2011.0,5,4,1
PL,BD,2011.0,3,3,0
BY,FI,2022.0,1,1,0
NG,PK,2005.0,1,1,0
JP,AR,2022.0,4,4,0
EG,HU,2018.0,4,10,-6
ER,ET,2018.0,1,1,0
IQ,BH,2020.0,3,3,0
ZA,NO,2019.0,9,3,6
NO,PK,2012.0,6,1,5
MA,IT,2000.0,2,6,-4
SK,HR,2012.0,3,4,-1
BE,KR,2010.0,8,8,0
DK,TR,2008.0,1,1,0
FR,GA,2020.0,6,7,-1
IS,NL,2020.0,4,2,2
MD,MA,2010.0,8,4,4
PT,CR,2015.0,2,2,0
KZ,FR,2018.0,2,3,-1
PS,MY,2013.0,1,2,-1
TN,QA,2016.0,5,4,1
NL,CW,2002.0,3,7,-4
NO,SK,2017.0,2,2,0
PT,ID,2017.0,2,1,1
JP,IL,2006.0,5,7,-2
CO,nan,2020.0,9,10,-1
PK,ID,2022.0,13,47,-34
SV,MX,2020.0,9,3,6
IR,ID,2013.0,5,3,2
MY,NL,2020.0,11,12,-1
BB,CA,2011.0,2,1,1
CH,HR,2014.0,3,11,-8
LK,DE,2021.0,3,1,2
PL,IN,2005.0,7,3,4
JM,CA,2000.0,1,1,0
MM,JP,2002.0,2,2,0
CU,CH,2015.0,4,1,3
IE,NZ,2016.0,17,15,2
IE,PK,2010.0,5,6,-1
ES,NI,2004.0,5,2,3
DE,BO,2018.0,1,1,0
PL,BE,2008.0,17,7,10
LK,KR,2016.0,1,2,-1
MY,AE,2013.0,6,4,2
LU,AU,2017.0,1,3,-2
QA,IQ,2021.0,8,16,-8
RU,LT,2006.0,6,10,-4
EE,IS,2010.0,1,1,0
IN,CO,2005.0,1,1,0
JO,GB,2022.0,7,10,-3
AE,BE,2017.0,1,1,0
BR,LK,2019.0,6,2,4
KW,JP,2018.0,1,1,0
BD,IT,2014.0,10,9,1
ES,RS,2021.0,5,7,-2
SI,CH,2001.0,3,1,2
DK,FI,2002.0,11,6,5
IE,IQ,2012.0,1,2,-1
DE,PE,2012.0,7,3,4
ES,HU,2019.0,8,7,1
OM,DE,2017.0,2,4,-2
LB,DE,2020.0,7,5,2
GB,PE,2021.0,13,12,1
KH,JP,2021.0,5,8,-3
GB,HN,2011.0,1,1,0
RS,JP,2004.0,5,3,2
VE,JP,2006.0,1,1,0
BR,AT,2007.0,5,8,-3
BE,NZ,2020.0,3,4,-1
SA,PT,2022.0,4,2,2
HU,nan,2000.0,4,1,3
EG,SE,2013.0,4,10,-6
AL,DE,2016.0,1,1,0
MY,LK,2016.0,4,4,0
SE,LU,2012.0,2,1,1
BA,PL,2009.0,4,1,3
NZ,CN,2000.0,12,16,-4
BH,US,2000.0,3,4,-1
XK,ME,2010.0,1,1,0
RO,GR,2015.0,2,5,-3
IL,DK,2004.0,4,1,3
AU,MX,2009.0,8,6,2
MW,CH,2016.0,1,1,0
AE,ES,2010.0,1,1,0
QA,DE,2014.0,1,10,-9
FI,nan,2014.0,9,9,0
NG,BH,2008.0,2,6,-4
IL,PH,2011.0,1,1,0
NG,TN,2011.0,2,4,-2
GB,PA,2009.0,4,3,1
NG,BD,2017.0,1,3,-2
TZ,CN,2017.0,6,3,3
AT,nan,2021.0,9,8,1
VE,CO,1997.0,4,6,-2
SG,CH,2005.0,2,6,-4
BY,US,2003.0,11,6,5
SE,VN,2000.0,3,1,2
DK,ZA,2019.0,5,8,-3
MY,NZ,2012.0,18,20,-2
ES,SK,2019.0,4,6,-2
CA,PE,2002.0,1,2,-1
BE,NO,2008.0,5,2,3
AO,IT,2013.0,2,3,-1
MX,SA,2020.0,8,3,5
TW,IR,2014.0,3,5,-2
NO,ES,2023.0,2,2,0
JO,NL,2017.0,1,1,0
NO,CA,2007.0,11,14,-3
RO,PT,2021.0,3,4,-1
FR,CF,2013.0,3,2,1
DZ,IR,2018.0,4,2,2
KN,IN,2018.0,1,1,0
DE,TN,2005.0,2,2,0
VE,IT,2000.0,3,2,1
GB,KH,2003.0,1,1,0
JO,CN,2012.0,1,3,-2
CA,PS,2011.0,2,2,0
CA,GE,2009.0,2,1,1
SA,DE,2009.0,4,13,-9
BR,NL,1997.0,5,8,-3
IL,EG,2021.0,4,4,0
NG,ES,2019.0,3,4,-1
ZA,PL,2019.0,9,5,4
PT,ID,2019.0,5,1,4
CN,RS,2008.0,9,1,8
MT,CA,2010.0,1,2,-1
BE,BG,2014.0,1,5,-4
MX,EG,2014.0,1,2,-1
QA,KW,2016.0,3,6,-3
ES,CU,1999.0,31,30,1
KR,CL,2018.0,2,3,-1
IS,ES,2020.0,2,2,0
ZA,NL,1998.0,2,3,-1
DK,IL,2014.0,5,5,0
SD,PT,2011.0,1,1,0
EE,IL,2016.0,1,1,0
NG,BD,2019.0,3,1,2
MD,CH,2006.0,2,1,1
TZ,ZA,2008.0,1,3,-2
ZA,QA,2017.0,3,1,2
TJ,US,2018.0,2,1,1
VE,GB,2017.0,8,2,6
AE,JP,2016.0,1,5,-4
EC,PH,2014.0,1,1,0
EC,nan,2020.0,3,8,-5
CN,KE,2006.0,1,4,-3
PL,AT,2022.0,10,5,5
RS,FI,2010.0,1,1,0
GA,GB,2014.0,1,1,0
JP,BY,2017.0,1,1,0
CU,HU,2003.0,1,2,-1
PA,SE,2009.0,7,4,3
NA,JP,2018.0,1,1,0
IT,ID,2009.0,2,1,1
IT,KZ,2020.0,1,1,0
LU,CH,2007.0,3,3,0
ES,AO,2005.0,5,1,4
ML,ZA,2021.0,1,1,0
FR,MC,2016.0,9,4,5
PH,IT,2019.0,5,7,-2
KZ,FI,2006.0,1,1,0
FI,IQ,2020.0,1,1,0
ZA,NO,2010.0,9,5,4
GR,MX,2020.0,2,2,0
EC,SV,2015.0,1,2,-1
AZ,TR,2010.0,7,9,-2
PK,SG,2022.0,5,5,0
SI,GB,2001.0,3,5,-2
UY,ID,2021.0,1,2,-1
MT,SE,2016.0,1,1,0
RU,TR,2004.0,2,1,1
XK,US,2012.0,1,3,-2
PL,VN,2023.0,2,2,0
PY,GB,2015.0,2,2,0
JM,US,2000.0,8,2,6
NZ,KE,2022.0,1,1,0
RS,MK,2016.0,5,2,3
IE,UA,2017.0,1,1,0
AT,SY,2015.0,1,1,0
UA,SE,2007.0,3,10,-7
SE,KW,2008.0,2,1,1
FJ,US,2003.0,1,1,0
RW,SE,2015.0,2,1,1
BG,NL,2006.0,2,3,-1
ZA,PL,2010.0,2,4,-2
NG,ET,2006.0,1,1,0
IE,SA,2010.0,1,2,-1
FJ,CA,2013.0,1,1,0
CZ,CA,2002.0,6,5,1
ES,SV,2006.0,1,2,-1
GB,BY,2002.0,1,6,-5
AU,VN,2008.0,8,8,0
PT,TR,2021.0,1,3,-2
ET,GB,2004.0,4,4,0
EC,VE,2016.0,5,50,-45
MY,NO,2014.0,1,2,-1
US,MM,2009.0,2,3,-1
nan,CY,2018.0,1,1,0
IT,AL,2012.0,4,2,2
VN,AU,2003.0,3,4,-1
GB,YE,1998.0,1,1,0
FR,TZ,2011.0,1,9,-8
GB,RW,2020.0,5,1,4
NZ,TW,2008.0,1,7,-6
AE,SE,2020.0,2,4,-2
UG,NG,2011.0,1,4,-3
SZ,ZA,2018.0,3,9,-6
PH,NO,2003.0,1,1,0
ZA,NO,2017.0,5,3,2
MK,CN,2016.0,6,2,4
NL,CL,2012.0,7,5,2
MX,BE,2001.0,2,1,1
HU,BR,2012.0,2,2,0
RU,UZ,2004.0,8,18,-10
DE,ML,2004.0,1,1,0
NI,MX,2009.0,3,1,2
BA,RS,2002.0,2,1,1
NZ,TR,2017.0,3,3,0
FR,DO,2018.0,2,1,1
MY,KR,2003.0,2,2,0
SN,BR,2019.0,2,1,1
HU,DK,2000.0,3,1,2
NZ,IR,2008.0,1,2,-1
IQ,KW,2022.0,2,2,0
RS,AU,2008.0,8,4,4
CU,BE,2007.0,3,1,2
BG,IT,2013.0,5,8,-3
CA,NO,2023.0,2,2,0
GE,IT,2006.0,1,3,-2
RO,LT,1997.0,1,1,0
DK,LU,2021.0,4,4,0
BH,IE,2011.0,1,1,0
BY,DE,2022.0,3,4,-1
ZW,SE,2001.0,1,1,0
GB,BY,2005.0,1,1,0
PY,EC,2017.0,5,1,4
DE,KZ,2013.0,2,3,-1
KR,SA,2007.0,1,1,0
AT,AE,2020.0,2,1,1
DK,BD,2020.0,1,1,0
BD,AE,2022.0,1,2,-1
PE,DE,2013.0,4,4,0
VN,PK,2019.0,3,3,0
QA,PS,2021.0,1,1,0
PT,SE,2023.0,2,1,1
CO,SE,2022.0,2,5,-3
PH,CN,1998.0,5,5,0
TH,LK,2014.0,2,1,1
KR,BR,2018.0,2,6,-4
LV,NO,2015.0,1,1,0
NG,BE,2020.0,4,3,1
DE,PA,2020.0,6,4,2
CM,JP,2016.0,1,3,-2
BH,KW,2008.0,1,1,0
nan,GR,2016.0,2,2,0
KR,AT,2020.0,5,5,0
NP,PH,2020.0,5,10,-5
SI,RS,1999.0,1,3,-2
UA,IQ,2019.0,1,1,0
CO,IE,2020.0,3,4,-1
NO,GR,2016.0,6,11,-5
BD,IE,2018.0,3,1,2
BY,IN,2016.0,7,6,1
US,MG,2011.0,1,3,-2
EE,HU,2009.0,1,2,-1
DZ,MA,2002.0,1,1,0
PT,MY,2007.0,2,1,1
IL,KR,2020.0,5,7,-2
US,UG,2023.0,1,1,0
CU,UY,2006.0,1,2,-1
BE,SN,2021.0,3,4,-1
IT,CN,2023.0,6,4,2
GB,VG,2006.0,3,2,1
UG,IN,2012.0,2,1,1
UA,IN,2020.0,8,4,4
FI,IR,2005.0,1,1,0
IN,BN,2019.0,2,5,-3
CN,AR,2021.0,2,1,1
NL,SY,2013.0,2,1,1
SI,SK,2022.0,2,5,-3
AT,RO,2012.0,3,8,-5
IR,TN,2017.0,9,9,0
SI,JP,2000.0,1,2,-1
DZ,GB,2013.0,4,7,-3
ES,PH,1998.0,2,3,-1
FJ,IN,2018.0,7,5,2
ID,KE,2009.0,3,1,2
ZA,KR,2007.0,2,2,0
FR,GF,2006.0,3,8,-5
LV,BE,2009.0,1,1,0
MX,PE,1999.0,9,8,1
BH,IR,2007.0,1,1,0
TW,FR,2000.0,6,11,-5
ET,IN,2005.0,1,5,-4
FR,CY,2022.0,1,5,-4
AR,ZA,2015.0,1,1,0
EG,NP,2014.0,1,3,-2
UA,IT,1997.0,4,1,3
EG,NL,2002.0,1,3,-2
AU,HR,2022.0,2,6,-4
TZ,CA,2007.0,2,5,-3
NZ,CZ,2010.0,1,1,0
NZ,SK,2013.0,1,5,-4
LB,DZ,2018.0,1,1,0
AU,CL,2010.0,7,3,4
PL,SK,2010.0,2,5,-3
CU,GB,1997.0,1,3,-2
LK,PK,2022.0,2,1,1
SS,GB,2003.0,6,7,-1
FR,EE,2000.0,3,1,2
CN,LU,2015.0,4,2,2
ES,JO,2022.0,1,1,0
LU,NO,2021.0,2,1,1
GB,BB,2009.0,2,2,0
MC,US,2022.0,2,2,0
ES,SK,2017.0,5,7,-2
TR,BD,2014.0,2,3,-1
IT,AO,2020.0,2,3,-1
UA,NL,2008.0,4,3,1
PH,FR,2003.0,2,2,0
NL,CU,2021.0,2,1,1
RS,BG,2013.0,1,6,-5
NZ,TR,2019.0,1,3,-2
RU,LU,2022.0,3,1,2
UA,AT,2003.0,2,2,0
NL,PH,2010.0,3,4,-1
BD,ID,2010.0,2,2,0
BR,RU,2001.0,10,6,4
CU,FR,2013.0,5,3,2
IE,SK,2013.0,1,1,0
CZ,FI,2022.0,6,2,4
FR,LY,2014.0,2,1,1
PH,ZA,2020.0,1,5,-4
MZ,BE,2022.0,2,11,-9
MX,IL,2009.0,4,4,0
FR,UY,2009.0,3,2,1
US,SS,2005.0,1,1,0
ML,CA,2022.0,1,1,0
TZ,nan,2020.0,1,1,0
CZ,PT,2015.0,4,2,2
TN,IQ,2020.0,4,1,3
SD,IE,2012.0,1,2,-1
IN,CY,2022.0,3,2,1
LK,SG,2022.0,1,1,0
NZ,CZ,2019.0,3,2,1
CN,MK,2007.0,2,3,-1
AE,KW,2010.0,2,2,0
CA,TN,2001.0,2,1,1
FI,EG,2016.0,3,5,-2
IT,KE,2001.0,1,3,-2
BE,CM,2009.0,1,2,-1
UY,FR,2009.0,2,3,-1
NO,HU,2020.0,3,3,0
OM,JO,1997.0,1,2,-1
YE,EG,2008.0,1,2,-1
KR,IT,2006.0,6,2,4
SK,UA,2013.0,1,1,0
BJ,BE,2013.0,1,1,0
JP,AM,1998.0,1,21,-20
BD,ZA,2017.0,2,1,1
CH,CL,2004.0,1,5,-4
CM,CA,2005.0,1,1,0
ME,AT,2018.0,1,1,0
DZ,BR,2017.0,1,1,0
nan,RS,2022.0,1,1,0
CH,CM,2012.0,1,4,-3
RW,BE,2021.0,2,1,1
UY,PE,2015.0,1,5,-4
SN,ZA,2020.0,2,3,-1
BR,JO,2015.0,1,22,-21
US,IN,2005.0,1058,1152,-94
IN,TW,2009.0,58,29,29
IL,US,2006.0,477,348,129
MX,EC,2015.0,79,29,50
MX,CL,2010.0,120,120,0
UA,RU,2015.0,411,239,172
DE,IN,2009.0,127,146,-19
TR,RS,2016.0,53,91,-38
LU,DE,2015.0,22,37,-15
AE,US,2013.0,42,74,-32
CW,NL,2013.0,23,17,6
CN,IE,2010.0,39,32,7
AR,DK,2022.0,5,3,2
BR,IT,2018.0,298,369,-71
SA,MY,2022.0,16,39,-23
IL,IN,2003.0,12,11,1
nan,CH,2004.0,6,6,0
DE,GR,2021.0,55,45,10
JP,LK,2014.0,30,21,9
DE,IL,2012.0,48,62,-14
IT,PT,2011.0,36,21,15
US,NG,2021.0,82,143,-61
FR,RO,2010.0,60,38,22
FR,RO,2019.0,55,34,21
SA,CN,2015.0,26,35,-9
IR,TN,2019.0,10,12,-2
CU,VE,2009.0,11,7,4
CL,AR,2000.0,14,23,-9
GB,BH,2017.0,12,3,9
PL,RU,2017.0,43,33,10
IT,CH,2013.0,311,184,127
LK,AU,2006.0,4,2,2
CA,CM,2014.0,5,2,3
BO,ES,2010.0,8,7,1
CA,KW,2000.0,3,3,0
SE,SK,2016.0,3,2,1
DE,LT,2019.0,11,10,1
ET,NL,2020.0,13,15,-2
CA,NL,2016.0,102,100,2
HK,JP,2014.0,12,18,-6
IL,IR,2017.0,2,1,1
US,GR,2008.0,178,170,8
NG,KR,2022.0,10,11,-1
CY,IR,2021.0,7,4,3
KE,CA,2008.0,3,3,0
BH,EG,2020.0,11,7,4
PL,ZA,2012.0,1,1,0
AU,PK,2018.0,52,60,-8
SE,PK,2018.0,18,17,1
CN,PL,2007.0,26,37,-11
EG,IR,2014.0,10,10,0
KR,SG,2009.0,27,21,6
IL,nan,2006.0,12,16,-4
RO,FR,2003.0,30,25,5
NO,IR,2019.0,9,13,-4
IE,SA,2017.0,6,4,2
HU,NL,2008.0,14,5,9
EG,KR,2012.0,5,8,-3
IE,BH,2020.0,3,2,1
BH,AE,2015.0,2,1,1
GR,CA,2015.0,13,10,3
TJ,UA,2015.0,1,4,-3
HU,IR,2010.0,3,1,2
GB,SI,2017.0,8,15,-7
NL,AU,2023.0,4,4,0
FR,SE,2000.0,38,30,8
CH,RU,2023.0,4,3,1
IT,MX,2018.0,41,53,-12
BO,PE,2017.0,5,10,-5
UA,FI,2018.0,4,3,1
PL,CA,2009.0,17,27,-10
UG,MY,2020.0,1,1,0
GR,IN,2000.0,2,3,-1
JO,AE,2011.0,10,4,6
AE,OM,2015.0,4,4,0
HU,BE,2009.0,10,6,4
UG,FR,2005.0,2,1,1
BR,NL,1998.0,4,10,-6
US,BG,1998.0,7,20,-13
IL,SG,2012.0,5,1,4
FI,IN,2007.0,4,4,0
CU,CO,2014.0,31,15,16
CA,MA,2011.0,17,12,5
nan,IR,2008.0,6,1,5
NO,TR,2007.0,4,4,0
CL,CR,2011.0,13,15,-2
AT,EG,2010.0,3,5,-2
DE,CH,2023.0,20,18,2
ES,HU,2017.0,8,8,0
NZ,CZ,2017.0,3,1,2
SG,GB,2004.0,44,60,-16
LV,US,2020.0,6,8,-2
ES,MA,2011.0,10,8,2
HR,GB,1999.0,5,3,2
GB,SI,2010.0,11,8,3
CA,PK,2005.0,7,5,2
PL,ES,2016.0,21,35,-14
GB,SI,2019.0,13,17,-4
NL,HU,2010.0,16,12,4
UA,GB,2012.0,8,10,-2
BA,NO,2015.0,2,1,1
DE,MY,2015.0,16,15,1
AU,CZ,2013.0,9,9,0
AT,LV,2009.0,1,1,0
GH,CM,2016.0,1,3,-2
JM,GB,2005.0,5,5,0
ES,SI,2010.0,12,12,0
ES,IN,2010.0,18,22,-4
PE,US,2001.0,22,14,8
NL,NZ,2009.0,12,4,8
SY,JP,2012.0,1,3,-2
BY,PL,2013.0,6,4,2
BS,US,2013.0,7,2,5
MX,JP,2020.0,8,6,2
CH,AR,2008.0,8,8,0
LU,ES,2016.0,4,8,-4
CN,BN,2019.0,2,3,-1
NL,ZA,2004.0,23,15,8
PK,MA,2011.0,11,30,-19
CL,CN,2012.0,6,4,2
CZ,MY,2018.0,13,11,2
NZ,IT,2020.0,10,7,3
MA,CA,2015.0,13,21,-8
TW,DK,2021.0,2,3,-1
MX,IN,1998.0,4,1,3
NP,IN,2000.0,10,11,-1
SE,IR,1998.0,3,3,0
MY,KZ,2020.0,2,1,1
BE,IL,2005.0,4,9,-5
SG,JP,2009.0,36,38,-2
DE,CR,2016.0,7,7,0
HU,IT,2003.0,7,10,-3
UA,TR,2002.0,1,1,0
nan,AU,2023.0,1,1,0
EC,GR,2001.0,2,1,1
QA,IN,2012.0,7,13,-6
RS,AT,2022.0,9,1,8
JP,BJ,2020.0,1,1,0
IQ,CA,2014.0,1,5,-4
NL,UA,2021.0,1,3,-2
DK,PT,2011.0,2,2,0
RU,GR,2005.0,1,3,-2
LU,AU,2019.0,6,1,5
BI,BE,2019.0,1,1,0
PS,DE,2020.0,3,6,-3
GB,XK,2020.0,6,1,5
TW,BR,2017.0,4,1,3
IT,PK,1998.0,1,1,0
GB,KZ,2012.0,4,1,3
FI,AT,2022.0,1,11,-10
VG,FR,2000.0,1,2,-1
BE,GH,2018.0,2,2,0
AT,MX,2015.0,1,7,-6
SY,GB,2010.0,2,9,-7
US,PG,2003.0,2,3,-1
GB,VN,1997.0,1,2,-1
MY,LB,1999.0,1,1,0
SY,GB,2019.0,6,5,1
GR,HR,2020.0,1,1,0
PR,ET,2015.0,7,12,-5
CN,SK,2004.0,2,1,1
SI,TR,2009.0,1,1,0
IL,IR,2019.0,3,4,-1
HU,IR,2019.0,2,9,-7
UA,IE,2018.0,2,3,-1
UA,CL,2004.0,2,1,1
BJ,NG,2022.0,3,1,2
IR,CY,2014.0,3,1,2
QA,OM,2012.0,2,4,-2
GB,MU,2013.0,2,1,1
JP,AM,1997.0,5,9,-4
ES,HR,2001.0,1,2,-1
GB,FO,2015.0,2,1,1
PE,JP,2003.0,1,1,0
UY,VE,1999.0,1,1,0
CL,US,2013.0,214,212,2
ZA,NZ,2014.0,10,11,-1
IE,PK,2017.0,12,11,1
MY,CN,2016.0,54,86,-32
UZ,DE,2003.0,3,1,2
CH,HU,2008.0,9,9,0
BN,MY,2015.0,5,10,-5
AE,QA,2008.0,4,3,1
SE,EE,2015.0,8,19,-11
KE,IN,2015.0,11,6,5
SI,PL,2013.0,4,5,-1
BD,ES,2022.0,10,4,6
NC,US,2016.0,4,4,0
HU,IR,2017.0,3,2,1
IR,JP,2003.0,5,13,-8
ZW,BW,2006.0,2,1,1
TW,BR,2019.0,1,6,-5
ID,BE,2018.0,7,8,-1
CO,NI,2022.0,2,1,1
,US,2012.0,76079,0,76079
TR,,2023.0,24226,0,24226
SD,,2023.0,503,0,503
RS,,2015.0,601,0,601
,FR,1999.0,12519,0,12519
,TW,2016.0,2411,0,2411
,IN,2000.0,7036,0,7036
,TN,2012.0,1498,0,1498
,JP,2010.0,14881,0,14881
NL,,2012.0,4359,0,4359
NZ,,2024.0,8222,0,8222
AG,,2024.0,685,0,685
CO,,2020.0,3065,0,3065
,FI,2000.0,1735,0,1735
CZ,,2020.0,2595,0,2595
SK,,2022.0,1683,0,1683
IR,,2021.0,12883,0,12883
BE,,2014.0,1835,0,1835
JM,,2019.0,65,0,65
,CU,2015.0,486,0,486
ZA,,2024.0,13576,0,13576
CU,,2010.0,159,0,159
,CH,2001.0,2868,0,2868
,PH,2009.0,483,0,483
,MA,2012.0,1450,0,1450
CH,,2015.0,2781,0,2781
,JP,2017.0,13020,0,13020
,JP,2019.0,6198,0,6198
,UY,2004.0,186,0,186
ZA,TH,2022.0,1,0,1
,CG,2003.0,31,0,31
,LV,2013.0,562,0,562
KZ,,2019.0,295,0,295
,HU,2010.0,1297,0,1297
CA,,2009.0,4043,0,4043
,EC,2008.0,170,0,170
PK,,2021.0,1959,0,1959
IE,,2025.0,704,0,704
SE,,2001.0,873,0,873
HR,DK,2016.0,2,0,2
HU,,2018.0,1143,0,1143
AM,,2013.0,85,0,85
,BG,1997.0,485,0,485
,CZ,2015.0,2104,0,2104
PH,,2008.0,110,0,110
VN,,2021.0,532,0,532
,CO,2007.0,1959,0,1959
,PE,2000.0,253,0,253
,NO,2015.0,1822,0,1822
,IR,1999.0,973,0,973
BY,,2003.0,94,0,94
TH,,2022.0,4223,0,4223
MX,PY,2014.0,10,0,10
,HU,2017.0,1278,0,1278
CU,,2019.0,493,0,493
MM,,2019.0,31,0,31
KZ,,2017.0,166,0,166
,BN,2013.0,40,0,40
CN,BN,2017.0,4,0,4
PY,,2018.0,41,0,41
RO,,2005.0,96,0,96
UY,DK,2013.0,5,0,5
,JM,2003.0,50,0,50
,PA,2003.0,31,0,31
,TH,1996.0,664,0,664
nan,,2001.0,149,0,149
CU,nan,2022.0,1,0,1
,GE,2003.0,167,0,167
,DK,2016.0,1994,0,1994
,BG,1998.0,438,0,438
,CR,2016.0,261,0,261
MK,,2021.0,267,0,267
,TH,2004.0,1595,0,1595
RU,,1999.0,959,0,959
,PY,2014.0,121,0,121
,PS,2015.0,153,0,153
,KP,2014.0,26,0,26
,MN,2015.0,104,0,104
,OM,2006.0,117,0,117
,AE,2001.0,96,0,96
NA,,2023.0,169,0,169
KG,,2020.0,31,0,31
LV,,2019.0,355,0,355
,CL,2016.0,1710,0,1710
AT,,2001.0,428,0,428
PE,,2013.0,139,0,139
MM,,2017.0,11,0,11
UA,,2015.0,1226,0,1226
PR,GB,1997.0,1,0,1
AU,MU,2017.0,4,0,4
CU,,2017.0,394,0,394
CN,TT,2017.0,1,0,1
KW,QA,2000.0,1,0,1
RO,,2002.0,92,0,92
,UZ,2017.0,385,0,385
,IQ,1994.0,39,0,39
MA,MY,2010.0,2,0,2
HR,,2025.0,469,0,469
LV,,2017.0,281,0,281
LV,,2010.0,51,0,51
HN,,2018.0,32,0,32
SA,,2014.0,316,0,316
,BJ,2008.0,61,0,61
CO,LT,2015.0,2,0,2
LB,,2014.0,108,0,108
TR,SG,2000.0,2,0,2
FR,SK,2000.0,5,0,5
GE,,2013.0,81,0,81
NP,,2015.0,132,0,132
QA,,2004.0,8,0,8
MG,,2012.0,15,0,15
JM,ZA,2020.0,1,0,1
LK,,2003.0,30,0,30
,IS,2017.0,122,0,122
ER,,2022.0,14,0,14
MW,,2012.0,19,0,19
ZM,,2003.0,6,0,6
BO,,2018.0,56,0,56
,KY,2017.0,2,0,2
,BI,2018.0,20,0,20
BR,MO,2019.0,1,0,1
,UZ,2019.0,329,0,329
,RE,2018.0,23,0,23
,UZ,2010.0,113,0,113
DO,,2001.0,4,0,4
ZM,AU,2020.0,3,0,3
,TL,2018.0,1,0,1
,ZM,2011.0,81,0,81
,IS,2010.0,146,0,146
GM,,2023.0,123,0,123
KZ,,2010.0,32,0,32
NE,BJ,2018.0,1,0,1
SN,GN,2007.0,2,0,2
,HU,2019.0,685,0,685
,SY,2012.0,107,0,107
,IS,2019.0,63,0,63
CN,AO,2009.0,3,0,3
PH,IR,2014.0,4,0,4
TN,KW,2021.0,2,0,2
,UY,1996.0,93,0,93
MY,LR,2022.0,1,0,1
PL,PG,2002.0,1,0,1
NG,CI,2008.0,2,0,2
BE,PS,2012.0,1,0,1
GH,,2007.0,27,0,27
,FO,2007.0,3,0,3
ZW,,2004.0,24,0,24
TN,UA,2019.0,1,0,1
MT,GR,2019.0,3,0,3
ES,LT,2013.0,2,0,2
SN,,2012.0,31,0,31
,GM,2005.0,12,0,12
ME,,2015.0,11,0,11
GD,,2023.0,76,0,76
GW,,2001.0,1,0,1
CL,TH,2017.0,1,0,1
PL,NG,2020.0,2,0,2
,NC,2009.0,7,0,7
,MZ,2009.0,53,0,53
CY,ET,2021.0,1,0,1
MM,,2010.0,3,0,3
PH,AT,2022.0,2,0,2
FR,HK,2022.0,3,0,3
PH,RU,2000.0,1,0,1
,GD,2007.0,16,0,16
JM,,2010.0,27,0,27
IN,CO,2002.0,1,0,1
LK,CG,2016.0,1,0,1
MX,GD,2017.0,1,0,1
CA,MG,2021.0,1,0,1
FR,KZ,2022.0,2,0,2
IL,KZ,2013.0,1,0,1
PA,IL,2013.0,2,0,2
LT,,1999.0,17,0,17
VU,,2023.0,5,0,5
SI,LU,2017.0,1,0,1
SE,LY,2017.0,2,0,2
BA,BS,2019.0,1,0,1
GR,MT,2021.0,3,0,3
TH,nan,2011.0,3,0,3
GH,TH,2015.0,4,0,4
CZ,KZ,2002.0,2,0,2
CY,NL,2004.0,1,0,1
,BW,1994.0,44,0,44
CM,CG,2007.0,1,0,1
JM,,2017.0,64,0,64
VG,NO,2018.0,1,0,1
SN,NC,2006.0,1,0,1
KW,MY,2010.0,6,0,6
IT,TG,2014.0,1,0,1
SY,IR,2006.0,1,0,1
TG,,2016.0,20,0,20
FI,LT,2016.0,2,0,2
CA,BB,1997.0,3,0,3
RS,CL,2004.0,3,0,3
SE,BH,2021.0,1,0,1
ES,MT,2008.0,4,0,4
BH,,2006.0,15,0,15
GN,,2015.0,3,0,3
CU,PT,1999.0,4,0,4
VE,NL,2016.0,4,0,4
,BS,2007.0,3,0,3
UG,EG,2018.0,2,0,2
ES,LK,2021.0,2,0,2
CH,MY,2008.0,1,0,1
AE,BE,2010.0,2,0,2
HR,EE,2013.0,1,0,1
PG,,2008.0,6,0,6
TN,IL,2000.0,1,0,1
SA,NG,2004.0,2,0,2
BR,VN,2011.0,1,0,1
SS,,2018.0,3,0,3
MD,LT,2013.0,2,0,2
IE,PE,2019.0,1,0,1
LK,GH,2012.0,1,0,1
SK,ME,2021.0,1,0,1
GR,PK,2010.0,3,0,3
AU,BS,2018.0,1,0,1
RS,CY,2007.0,1,0,1
IN,,2026.0,5,0,5
IT,LY,2008.0,1,0,1
,MW,1994.0,49,0,49
TR,LB,2023.0,4,0,4
US,TG,2021.0,3,0,3
ZA,CL,2022.0,3,0,3
AR,LB,2011.0,1,0,1
MA,MN,2021.0,2,0,2
CN,FJ,2020.0,1,0,1
BD,SE,1998.0,1,0,1
ZM,FJ,2021.0,1,0,1
GF,BR,2014.0,1,0,1
TR,CM,2018.0,1,0,1
AE,HU,2006.0,2,0,2
BD,TR,2000.0,1,0,1
LY,IE,2014.0,1,0,1
AR,RO,2013.0,2,0,2
PT,KW,2016.0,1,0,1
BD,DZ,2017.0,2,0,2
UA,SA,2011.0,3,0,3
JO,BH,2002.0,4,0,4
PT,FI,1997.0,2,0,2
GE,AM,1998.0,2,0,2
TN,BD,2021.0,1,0,1
KR,AZ,2014.0,2,0,2
NO,FO,2018.0,3,0,3
SI,SE,2011.0,6,0,6
OM,nan,2010.0,1,0,1
IR,SI,2012.0,2,0,2
IN,JM,2008.0,2,0,2
JM,IN,2012.0,2,0,2
QA,NO,2022.0,1,0,1
BD,AU,2001.0,2,0,2
SI,TW,2016.0,2,0,2
MY,PR,1998.0,1,0,1
,KY,2010.0,1,0,1
SJ,NO,2005.0,2,0,2
CH,PS,2002.0,1,0,1
TH,PL,2000.0,1,0,1
,SC,2013.0,2,0,2
MX,DZ,2021.0,1,0,1
ZA,PK,2005.0,2,0,2
JO,CO,2007.0,1,0,1
GY,US,2000.0,1,0,1
CM,NA,2021.0,1,0,1
NG,BD,2010.0,1,0,1
TG,CA,2009.0,1,0,1
ZA,QA,2019.0,2,0,2
,JE,2008.0,2,0,2
DE,BF,2016.0,1,0,1
PY,ES,2001.0,2,0,2
LK,TH,2022.0,3,0,3
YE,SD,2014.0,2,0,2
IT,RW,2006.0,1,0,1
RS,MY,2018.0,2,0,2
LV,CA,2004.0,2,0,2
,PG,1995.0,21,0,21
KY,,2022.0,3,0,3
MA,LB,2013.0,1,0,1
ZA,MW,1999.0,1,0,1
GN,MA,2015.0,2,0,2
NO,BW,2011.0,1,0,1
KR,LB,2020.0,1,0,1
CU,SE,2006.0,2,0,2
VG,,2024.0,15,0,15
SD,UG,2020.0,1,0,1
DK,JO,2012.0,1,0,1
IL,NI,2008.0,1,0,1
MA,MR,2019.0,2,0,2
CM,PH,2019.0,1,0,1
AU,TT,2009.0,1,0,1
,CI,1995.0,34,0,34
,GM,2002.0,5,0,5
HR,MX,2004.0,2,0,2
SE,FJ,2018.0,1,0,1
CZ,LU,2019.0,2,0,2
BE,KW,2018.0,1,0,1
AU,CM,2008.0,1,0,1
SE,CY,2016.0,2,0,2
BG,IL,2015.0,4,0,4
CN,DZ,2014.0,2,0,2
SI,LU,2010.0,1,0,1
LU,RS,2011.0,1,0,1
MD,MG,2011.0,1,0,1
IL,TR,2014.0,3,0,3
UG,FR,2002.0,2,0,2
CZ,KE,2017.0,1,0,1
BH,SE,2000.0,2,0,2
CH,ET,2007.0,1,0,1
AT,BW,2012.0,1,0,1
BR,MD,2020.0,1,0,1
CO,NZ,2019.0,5,0,5
RO,VN,1998.0,1,0,1
RS,GR,2022.0,3,0,3
IQ,OM,2005.0,1,0,1
nan,HK,2020.0,1,0,1
HU,PS,2008.0,1,0,1
ZA,SD,2015.0,2,0,2
TW,SD,2008.0,1,0,1
SN,SV,2020.0,1,0,1
NG,IT,2000.0,1,0,1
SA,EC,2022.0,1,0,1
AR,BO,2022.0,4,0,4
GE,AR,2017.0,1,0,1
GB,MZ,2016.0,2,0,2
KE,PH,2007.0,1,0,1
CN,JO,2003.0,2,0,2
MY,OM,2009.0,2,0,2
KZ,CH,2014.0,1,0,1
CN,PA,2010.0,2,0,2
CN,ET,1998.0,2,0,2
GB,UZ,2004.0,1,0,1
JP,BG,2022.0,3,0,3
CO,ID,2021.0,3,0,3
SG,NG,2014.0,1,0,1
UA,PT,2007.0,4,0,4
VN,RO,2002.0,1,0,1
HU,SA,2015.0,1,0,1
,SR,2000.0,4,0,4
CG,GB,2005.0,1,0,1
HU,VN,2003.0,2,0,2
AE,KR,2007.0,1,0,1
CA,KY,2008.0,1,0,1
US,MU,2010.0,2,0,2
CZ,LY,2010.0,1,0,1
AE,MA,2008.0,1,0,1
ES,MD,2018.0,2,0,2
LT,PT,2010.0,1,0,1
,SM,2008.0,3,0,3
ES,EG,1999.0,3,0,3
BG,ZA,2004.0,3,0,3
SG,SN,2015.0,2,0,2
TJ,PK,2007.0,1,0,1
MD,BR,2002.0,2,0,2
,FJ,2003.0,15,0,15
SE,SA,1998.0,4,0,4
AU,PE,1999.0,1,0,1
,MU,1995.0,7,0,7
MX,TN,2005.0,2,0,2
DE,XK,2008.0,2,0,2
MR,,2009.0,3,0,3
MA,CN,2004.0,2,0,2
FI,AR,2009.0,2,0,2
MN,AU,2005.0,1,0,1
RS,CO,2021.0,2,0,2
DE,YE,2009.0,1,0,1
RO,LT,1998.0,6,0,6
NP,GM,2015.0,1,0,1
IE,UG,2013.0,1,0,1
MG,GM,2021.0,1,0,1
DK,IE,2004.0,5,0,5
UY,ES,2023.0,4,0,4
JP,IS,2020.0,1,0,1
UA,EG,1999.0,1,0,1
CA,BB,1998.0,3,0,3
PT,VN,2015.0,2,0,2
ZW,ZM,2004.0,1,0,1
IL,LY,2021.0,1,0,1
CU,PL,2019.0,1,0,1
SY,LY,2018.0,2,0,2
HK,UA,2011.0,1,0,1
HT,,2016.0,3,0,3
UG,ET,2013.0,1,0,1
MA,RU,2022.0,2,0,2
IN,LU,2014.0,5,0,5
UA,MX,2001.0,2,0,2
ML,NO,2012.0,1,0,1
FI,RS,2013.0,1,0,1
MD,AR,2014.0,1,0,1
UA,HR,2003.0,1,0,1
CA,UG,2017.0,6,0,6
KR,IQ,2013.0,1,0,1
HU,NZ,2014.0,4,0,4
BR,IR,2004.0,2,0,2
LK,BN,2012.0,1,0,1
IE,QA,2011.0,1,0,1
HN,PA,2014.0,1,0,1
NO,KZ,2018.0,1,0,1
PG,PK,2018.0,1,0,1
AF,PS,2020.0,1,0,1
UG,GH,2014.0,1,0,1
AZ,MD,2019.0,1,0,1
AZ,,2025.0,14,0,14
SE,MZ,2011.0,1,0,1
GR,EE,2010.0,1,0,1
NZ,TH,2011.0,2,0,2
CH,SA,2010.0,3,0,3
XK,ME,2017.0,1,0,1
BN,LS,2018.0,1,0,1
TN,CZ,2014.0,2,0,2
AU,UZ,2015.0,1,0,1
LT,RS,2007.0,1,0,1
CY,SG,2014.0,1,0,1
SG,CY,2016.0,1,0,1
GR,LV,2009.0,2,0,2
CR,AE,2020.0,1,0,1
RS,MZ,2011.0,1,0,1
QA,nan,2002.0,1,0,1
ID,MA,2013.0,1,0,1
PH,HU,2006.0,1,0,1
NP,nan,2009.0,2,0,2
NL,ZM,2008.0,1,0,1
SI,LK,2002.0,1,0,1
CZ,AE,2020.0,2,0,2
BE,SC,2018.0,1,0,1
TN,JO,2014.0,1,0,1
NE,CO,2020.0,1,0,1
PR,CH,2002.0,1,0,1
TR,IQ,2007.0,1,0,1
FI,CL,2001.0,3,0,3
UY,NZ,2015.0,1,0,1
NZ,ET,2008.0,1,0,1
ZW,FJ,2002.0,1,0,1
IE,nan,2022.0,4,0,4
CU,CA,2003.0,2,0,2
BR,LK,2010.0,1,0,1
PT,SA,2023.0,2,0,2
LV,IL,2015.0,2,0,2
NI,AR,2008.0,1,0,1
ET,UZ,2009.0,3,0,3
US,BI,2002.0,1,0,1
BW,KZ,2016.0,2,0,2
IE,KE,2020.0,1,0,1
HR,AE,2018.0,2,0,2
CI,GB,2020.0,2,0,2
JP,DZ,2014.0,3,0,3
HU,BH,2005.0,1,0,1
SK,CW,2012.0,1,0,1
SD,LY,2018.0,1,0,1
UZ,CN,1999.0,1,0,1
MD,LV,2013.0,1,0,1
MX,NO,2001.0,1,0,1
QA,IT,1997.0,1,0,1
EG,CH,2023.0,2,0,2
AE,UA,2011.0,1,0,1
SY,AU,2010.0,1,0,1
IN,UZ,2014.0,1,0,1
IR,GH,2021.0,1,0,1
SY,IT,1997.0,1,0,1
PA,CN,2001.0,1,0,1
KR,MK,2018.0,1,0,1
CN,TT,2010.0,1,0,1
KE,CL,2014.0,1,0,1
US,AZ,2015.0,2,0,2
SE,CM,2001.0,2,0,2
DE,ST,2012.0,3,0,3
GF,BJ,2016.0,1,0,1
BH,nan,2021.0,1,0,1
MZ,LT,2009.0,4,0,4
IT,IQ,2021.0,2,0,2
BR,LK,2017.0,2,0,2
US,XK,2006.0,2,0,2
FR,MW,2004.0,1,0,1
LB,MY,2011.0,2,0,2
US,HT,2022.0,2,0,2
TG,NG,2017.0,1,0,1
SY,AU,2017.0,2,0,2
OM,RW,2018.0,1,0,1
SN,IE,2004.0,1,0,1
CG,RE,2022.0,1,0,1
JO,DZ,2016.0,1,0,1
HR,NP,2010.0,1,0,1
nan,PS,2006.0,1,0,1
NA,FR,2018.0,1,0,1
PG,CA,2016.0,1,0,1
CA,PY,2022.0,1,0,1
ET,CN,2012.0,6,0,6
ML,KE,1999.0,1,0,1
DK,GL,1999.0,3,0,3
VE,GH,2018.0,1,0,1
VN,PK,2010.0,1,0,1
PK,TW,2014.0,2,0,2
VN,CZ,2002.0,1,0,1
IN,MU,2021.0,1,0,1
LV,BY,2017.0,2,0,2
,HT,2020.0,1,0,1
MK,NL,2019.0,2,0,2
BR,RE,2011.0,1,0,1
TW,OM,2010.0,1,0,1
MG,CF,2001.0,1,0,1
JO,PS,2002.0,1,0,1
MD,CZ,2018.0,1,0,1
SA,BW,2019.0,1,0,1
,BT,2009.0,6,0,6
GP,CH,2016.0,1,0,1
CH,PS,2005.0,1,0,1
SE,SD,2018.0,1,0,1
CH,CD,2014.0,1,0,1
HU,AE,2011.0,1,0,1
PK,SE,2006.0,2,0,2
NC,VN,2018.0,1,0,1
BE,BA,2022.0,1,0,1
SG,CZ,2008.0,1,0,1
AR,PY,2003.0,5,0,5
BJ,MA,2012.0,3,0,3
NP,BW,2015.0,1,0,1
MY,ZA,2012.0,2,0,2
NG,ES,2010.0,1,0,1
ML,DE,1997.0,1,0,1
JM,MY,2012.0,1,0,1
MY,NP,2014.0,2,0,2
NP,AE,2018.0,1,0,1
AU,ID,1997.0,2,0,2
NO,GH,2015.0,1,0,1
MY,QA,2003.0,1,0,1
NG,IE,2005.0,1,0,1
TW,ID,2005.0,1,0,1
MN,NL,2013.0,1,0,1
BD,nan,2022.0,1,0,1
ZA,BB,2013.0,1,0,1
IL,UZ,2013.0,1,0,1
JP,BY,2019.0,2,0,2
NZ,MT,1998.0,1,0,1
UA,IQ,2017.0,1,0,1
CN,EE,2003.0,1,0,1
PE,BO,2007.0,1,0,1
TW,TZ,2020.0,1,0,1
GR,NG,2020.0,1,0,1
EG,CO,2005.0,1,0,1
KE,AT,2001.0,1,0,1
AR,GE,2015.0,2,0,2
IL,TT,2015.0,1,0,1
GB,KY,2017.0,2,0,2
GB,VN,1998.0,1,0,1
HK,MK,2010.0,1,0,1
TW,SI,2000.0,2,0,2
MQ,HT,2018.0,1,0,1
CA,GY,2009.0,1,0,1
AE,RS,2011.0,1,0,1
BI,MA,2015.0,4,0,4
CA,MQ,2020.0,1,0,1
JE,CH,2002.0,1,0,1
IN,PA,2009.0,2,0,2
AT,CO,2006.0,1,0,1
KZ,NO,1999.0,1,0,1
SE,ZM,2002.0,1,0,1
CA,TZ,2004.0,4,0,4
CU,PL,2017.0,1,0,1
UG,TZ,2009.0,1,0,1
YE,US,2001.0,1,0,1
FR,TH,2000.0,2,0,2
ZA,CG,2020.0,1,0,1
BF,ET,2019.0,1,0,1
MX,MA,2015.0,1,0,1
UA,QA,2017.0,1,0,1
NO,SD,2020.0,1,0,1
GE,LB,2015.0,1,0,1
AU,MU,2010.0,1,0,1
IT,SZ,2019.0,1,0,1
ES,SK,2010.0,4,0,4
GB,SO,2016.0,1,0,1
DK,EG,2003.0,1,1,0
TW,ZA,2003.0,1,2,-1
CH,VE,2015.0,1,2,-1
SI,AU,2016.0,2,4,-2
NP,JP,1997.0,1,3,-2
CL,SV,2014.0,3,1,2
VG,GB,2004.0,1,2,-1
ET,NO,2008.0,3,6,-3
QA,AU,2001.0,1,1,0
VN,PK,2017.0,1,2,-1
BE,CO,2001.0,3,2,1
SK,BG,2021.0,1,2,-1
ZA,NL,1997.0,6,1,5
TT,GB,2004.0,2,1,1
HR,SI,2005.0,2,7,-5
CH,DZ,2015.0,1,2,-1
QA,YE,2018.0,1,1,0
CW,DE,2013.0,2,2,0
AE,RU,2020.0,2,1,1
OM,BH,2021.0,3,3,0
CH,MD,2008.0,1,4,-3
ZA,PL,2017.0,3,4,-1
EE,NO,2015.0,3,4,-1
PH,IT,2010.0,1,3,-2
IN,GR,2004.0,5,3,2
NO,EG,2013.0,1,2,-1
HU,NO,1998.0,2,2,0
TZ,CN,2019.0,3,14,-11
JO,PS,2005.0,1,1,0
JP,TZ,2017.0,1,1,0
GB,HK,2009.0,5,2,3
GH,CZ,2016.0,3,2,1
PH,GH,2018.0,1,1,0
JP,SN,1998.0,1,1,0
GB,AF,2012.0,1,1,0
YE,AE,2013.0,1,1,0
AE,KW,2017.0,2,3,-1
BD,SE,1997.0,1,3,-2
IT,PA,2020.0,1,2,-1
NL,PH,2019.0,4,3,1
IS,IL,2014.0,1,1,0
IE,IN,2001.0,5,5,0
BM,GB,2011.0,1,1,0
CO,HN,2016.0,6,6,0
DO,CL,2021.0,3,1,2
JM,GB,2002.0,2,2,0
ET,SY,2011.0,1,1,0
VN,nan,2015.0,1,3,-2
YE,GB,2000.0,1,1,0
MZ,ZA,2011.0,1,2,-1
ES,PH,1997.0,1,2,-1
RS,FI,2017.0,1,1,0
BE,CI,2015.0,5,1,4
CU,IT,2015.0,3,2,1
CL,AT,2022.0,3,2,1
TN,nan,2022.0,2,1,1
RO,ID,2015.0,2,1,1
GB,SK,2022.0,1,7,-6
NL,IS,2012.0,1,5,-4
AE,LB,2016.0,3,3,0
NE,SN,2001.0,2,1,1
FR,VE,2004.0,3,5,-2
RO,TR,2014.0,2,2,0
KZ,IN,2017.0,3,1,2
SE,TH,2001.0,2,1,1
HU,GH,2020.0,2,3,-1
MN,TW,2022.0,1,1,0
SA,HU,2016.0,1,2,-1
CM,CA,2002.0,1,1,0
SY,AE,2012.0,1,1,0
NO,AR,2009.0,1,2,-1
BW,TZ,2015.0,1,1,0
BD,EG,2005.0,2,3,-1
TN,DZ,2007.0,1,1,0
SJ,NO,2002.0,2,2,0
LV,IT,2022.0,1,2,-1
NP,JP,1998.0,1,1,0
OM,DE,2019.0,3,2,1
PK,BE,2012.0,4,3,1
MG,BJ,2009.0,1,1,0
IL,UG,2018.0,1,1,0
VE,GB,2010.0,2,3,-1
IE,UA,2019.0,1,1,0
DE,PK,2001.0,2,4,-2
UG,AE,2021.0,1,1,0
KN,DK,2018.0,1,1,0
MY,SD,2008.0,2,2,0
CL,TH,2019.0,2,1,1
NL,GW,2004.0,1,1,0
CH,GM,2015.0,1,1,0
MT,SA,2022.0,1,1,0
BF,GB,2018.0,1,2,-1
MC,IT,2006.0,1,1,0
CZ,NG,2018.0,1,5,-4
ES,SY,2018.0,1,3,-2
IT,MG,2017.0,1,1,0
RU,MD,2004.0,1,2,-1
TR,BH,2020.0,1,1,0
IS,RU,2011.0,1,2,-1
TN,SA,2001.0,2,3,-1
AU,LT,2014.0,1,1,0
ID,IT,2007.0,1,3,-2
PL,IS,2020.0,2,1,1
ES,LB,2002.0,1,1,0
PT,PK,2018.0,1,1,0
IE,AE,2011.0,2,1,1
CM,DE,2005.0,2,1,1
GR,CY,1999.0,1,1,0
JP,SN,1997.0,1,1,0
US,BF,2009.0,2,3,-1
CH,TW,2003.0,2,1,1
EC,PA,2015.0,1,1,0
AR,FI,2015.0,2,1,1
AT,RS,2004.0,1,2,-1
ID,SE,2013.0,2,6,-4
NO,MY,2022.0,1,2,-1
RO,CN,2023.0,1,4,-3
VE,SE,2008.0,1,1,0
LY,EG,2010.0,1,1,0
BI,BE,2017.0,1,1,0
AE,IQ,2004.0,1,1,0
MA,RO,2005.0,1,1,0
BD,DK,2020.0,1,1,0
US,TJ,2021.0,1,2,-1
DE,LK,2008.0,1,1,0
OM,DE,2010.0,3,1,2
ES,BG,2003.0,1,3,-2
CL,JP,2017.0,4,2,2
ZM,RW,2020.0,2,2,0
NA,US,2016.0,1,3,-2
DE,JM,2012.0,1,1,0
BO,PA,2018.0,1,1,0
TH,BE,2013.0,1,5,-4
IN,SD,2010.0,1,1,0
AT,MY,2012.0,1,1,0
BT,TH,2019.0,2,1,1
MW,IN,2019.0,1,1,0
AL,JP,2015.0,1,2,-1
DK,PH,2015.0,1,1,0
ML,BF,2010.0,1,2,-1
SG,MM,2007.0,1,1,0
NL,KH,2002.0,1,4,-3
ET,IE,2018.0,1,2,-1
DK,TH,2003.0,1,2,-1
BY,CZ,1999.0,3,1,2
SN,ML,2015.0,2,4,-2
TN,IR,2012.0,2,3,-1
MM,nan,2018.0,1,1,0
PA,CL,2000.0,1,1,0
FI,QA,2013.0,1,3,-2
EE,GR,2008.0,1,1,0
IR,nan,2008.0,1,6,-5
NL,TZ,2010.0,1,1,0
CM,SE,2014.0,1,1,0
NG,MW,2020.0,1,2,-1
QA,CA,2006.0,2,4,-2
CU,CN,2014.0,1,1,0
GM,BE,2018.0,1,2,-1
CH,TZ,2008.0,1,2,-1
OM,CA,2006.0,1,7,-6
IR,CH,2002.0,1,1,0
HU,NO,1997.0,1,2,-1
FI,SG,2015.0,2,5,-3
CZ,LU,2017.0,1,1,0
AT,KR,2012.0,3,6,-3
TH,FR,2006.0,3,12,-9
AF,US,2021.0,1,5,-4
AE,BE,2019.0,1,2,-1
UA,LT,2021.0,1,3,-2
HR,nan,2017.0,1,2,-1
KZ,KG,2016.0,1,2,-1
NZ,BD,2007.0,1,1,0
US,PF,2015.0,1,4,-3
AZ,PL,1999.0,1,3,-2
BH,SA,1999.0,1,2,-1
PL,NO,1999.0,1,2,-1
GA,FR,1999.0,1,3,-2
FJ,NL,2017.0,1,1,0
CH,KH,2017.0,1,1,0
BO,FR,2016.0,2,2,0
EC,US,2000.0,2,1,1
TN,ZA,2018.0,1,2,-1
US,MU,2019.0,1,3,-2
LI,DE,2020.0,1,5,-4
GT,CO,2008.0,1,2,-1
LB,JO,2014.0,1,6,-5
NL,MA,2020.0,1,1,0
BD,NZ,2007.0,1,1,0
SG,LK,2004.0,1,1,0
AU,AR,1997.0,2,2,0
IR,LT,2014.0,1,1,0
nan,NL,2023.0,1,1,0
IN,UY,2022.0,1,1,0
MZ,FR,2018.0,1,1,0
LK,NZ,2022.0,1,2,-1
CA,CY,2020.0,1,2,-1
NL,PE,2006.0,1,1,0
JM,FR,2004.0,2,2,0
CZ,SG,2022.0,1,1,0
NZ,GR,2020.0,1,1,0
IR,ZA,2002.0,1,1,0
DK,CM,2010.0,1,1,0
CO,SV,2009.0,1,2,-1
BT,TH,2017.0,1,1,0
US,SS,2002.0,1,1,0
ZA,IQ,2016.0,1,1,0
AU,MU,2019.0,1,1,0
AO,US,2003.0,1,1,0
KE,SK,2014.0,1,1,0
SK,PT,2015.0,1,2,-1
SA,DZ,2010.0,1,6,-5
PK,CO,2017.0,1,1,0
GT,GB,2021.0,1,1,0
PS,FR,2018.0,1,3,-2
CU,GT,2010.0,1,1,0
PH,BD,2012.0,1,2,-1
TN,HU,2021.0,1,1,0
DE,LT,2010.0,6,5,1
BD,EG,2002.0,1,1,0
US,MU,2017.0,2,1,1
nan,HR,2012.0,1,2,-1
NL,CR,2004.0,1,1,0
BG,RS,2016.0,2,4,-2
DE,IS,2002.0,2,1,1
CH,JO,2015.0,1,1,0
NG,CZ,2008.0,1,1,0
SE,PE,2018.0,2,1,1
CN,MN,2011.0,3,4,-1
FR,MU,2012.0,1,1,0
CN,SY,1999.0,1,1,0
CI,GH,2014.0,1,1,0
TW,AM,2008.0,1,2,-1
CW,BE,2006.0,1,2,-1
CU,GB,1998.0,1,1,0
CN,MX,1998.0,1,1,0
SE,SA,1997.0,1,5,-4
PT,JP,2008.0,1,4,-3
KH,KR,2020.0,1,3,-2
KZ,PH,2013.0,1,1,0
SA,SG,2009.0,2,2,0
SI,BR,2020.0,1,3,-2
NO,DZ,2021.0,1,2,-1
CN,RW,2012.0,1,1,0
LU,RU,2013.0,1,1,0
CD,RW,2016.0,1,3,-2
CL,BO,2022.0,2,4,-2
LK,GR,2012.0,1,4,-3
AU,AR,1998.0,1,4,-3
CO,CH,2002.0,1,2,-1
NL,PT,2023.0,3,3,0
NO,SK,2010.0,1,1,0
PE,RU,2014.0,1,1,0
NA,ZW,2019.0,1,1,0
IT,IR,2001.0,1,5,-4
IQ,UA,2016.0,1,1,0
LY,FR,2010.0,1,1,0
RU,GR,2002.0,2,3,-1
EG,AT,2020.0,2,9,-7
CH,IR,2023.0,1,1,0
CL,HR,2016.0,1,1,0
JP,KZ,2000.0,1,1,0
SE,UZ,2005.0,1,0,1
ZA,EG,2003.0,1,0,1
SD,YE,2021.0,1,0,1
NO,MX,2004.0,1,0,1
UG,ZA,2000.0,1,0,1
AR,TW,1999.0,1,0,1
MN,DE,1999.0,1,0,1
MY,CH,2023.0,1,0,1
KW,BG,2006.0,1,0,1
SI,LU,2019.0,1,0,1
ZA,LT,2022.0,2,0,2
ZA,BN,2023.0,1,0,1
RU,KW,2022.0,1,0,1
BY,GB,2009.0,2,0,2
JO,HU,2013.0,1,0,1
BD,RO,2016.0,3,0,3
,BW,2021.0,1,0,1
RO,MY,2012.0,1,0,1
RO,BD,2021.0,1,0,1
BZ,,2022.0,5,0,5
MY,KW,2008.0,1,0,1
SE,FO,2001.0,1,0,1
PK,BW,2016.0,1,0,1
IN,GH,1999.0,1,0,1
,TD,2007.0,2,0,2
AO,SI,2014.0,1,0,1
ZW,SN,2017.0,1,0,1
BG,TH,1998.0,1,0,1
ML,nan,2016.0,1,0,1
ZW,CD,2012.0,1,0,1
RS,ID,2006.0,1,0,1
GR,VE,2015.0,1,0,1
PE,CH,1999.0,1,0,1
PF,BR,2014.0,1,0,1
FJ,DE,2022.0,1,0,1
ZA,VN,2012.0,1,0,1
BG,SK,2012.0,2,0,2
BA,SI,2008.0,2,0,2
IE,KW,2014.0,1,0,1
FJ,PK,2020.0,1,0,1
PE,FR,2023.0,1,0,1
IQ,BY,2019.0,1,0,1
UG,BD,2021.0,1,0,1
ST,PT,2012.0,1,0,1
ZM,SL,2013.0,1,0,1
DK,LK,1998.0,1,0,1
TH,MW,2013.0,1,0,1
HN,SV,2021.0,1,0,1
DK,CF,2019.0,1,0,1
DK,CR,2021.0,1,0,1
BR,PR,2017.0,1,0,1
NP,GY,2019.0,1,0,1
IE,GE,2013.0,1,0,1
RS,KZ,2009.0,2,0,2
JP,CW,2017.0,1,0,1
BF,US,2004.0,1,0,1
CH,KH,2010.0,1,0,1
AE,LY,2011.0,1,0,1
PL,NC,2005.0,1,0,1
AE,CZ,2022.0,2,0,2
CZ,LY,2019.0,1,0,1
FR,NP,2019.0,1,0,1
MY,GM,2020.0,1,0,1
KZ,JP,2002.0,1,0,1
BF,ET,2010.0,1,0,1
KZ,AE,2020.0,2,0,2
CZ,AM,2016.0,2,0,2
CR,CN,2020.0,2,0,2
TR,CL,2003.0,1,0,1
ID,TN,2021.0,1,0,1
ZA,BA,2021.0,1,0,1
FR,MM,2022.0,1,0,1
PR,CA,2008.0,1,0,1
IT,BO,2006.0,1,0,1
KE,ZW,2008.0,1,0,1
IN,KE,2023.0,2,0,2
AE,SN,2022.0,1,0,1
CG,MG,2008.0,1,0,1
VN,ET,2017.0,1,0,1
SG,SD,2019.0,1,0,1
BR,IS,2018.0,1,0,1
SV,GT,2012.0,1,0,1
HU,TR,2000.0,2,0,2
GN,US,2009.0,1,0,1
GR,BD,2015.0,1,0,1
PG,FR,2001.0,1,0,1
nan,KE,2005.0,1,0,1
SE,LY,2019.0,1,0,1
IE,JO,2012.0,1,0,1
SA,DK,2007.0,1,0,1
TZ,ZM,2016.0,1,0,1
NG,FR,2023.0,1,0,1
GI,GB,2013.0,1,0,1
MC,AU,2019.0,1,0,1
DK,MK,2002.0,1,0,1
HU,AL,2015.0,1,0,1
HU,UA,1997.0,1,0,1
CI,GP,2015.0,1,0,1
JO,NL,2010.0,2,0,2
US,CV,2016.0,1,0,1
SK,NZ,2007.0,1,0,1
LB,TR,2003.0,2,0,2
ID,BN,2015.0,1,0,1
SN,MD,2006.0,1,0,1
SA,TW,1999.0,1,0,1
TW,LK,2007.0,1,0,1
AR,BE,1998.0,2,0,2
LB,IT,2023.0,1,0,1
ES,TN,2005.0,3,0,3
FR,ZW,2020.0,1,0,1
MX,PR,2014.0,2,0,2
JP,KW,2001.0,1,0,1
CY,NO,2016.0,1,0,1
PK,PH,2009.0,1,0,1
BN,FJ,2013.0,1,0,1
nan,ME,2013.0,1,0,1
CA,LR,2017.0,1,0,1
CU,NG,2016.0,1,0,1
KE,SL,2018.0,1,0,1
LT,PL,1999.0,1,0,1
SS,DE,2001.0,1,0,1
ES,AO,2002.0,1,0,1
IL,CY,2011.0,1,0,1
TW,CO,2011.0,1,0,1
JP,AE,2023.0,1,0,1
JO,SE,1997.0,1,0,1
DE,TN,2002.0,1,0,1
ID,AG,2020.0,1,0,1
BM,,2007.0,1,0,1
MA,GN,2022.0,1,0,1
UA,AM,2020.0,1,0,1
SA,SN,2021.0,1,0,1
NA,ZW,2017.0,1,0,1
ES,BA,2006.0,1,0,1
LT,ZW,2019.0,1,0,1
SE,IR,1997.0,1,0,1
CU,GT,2017.0,1,0,1
CO,GA,2017.0,1,0,1
CU,PH,2018.0,1,0,1
PH,IQ,2020.0,1,0,1
BB,TR,2011.0,1,0,1
BA,PK,2021.0,1,0,1
GR,PK,2017.0,1,0,1
MK,RO,2017.0,1,0,1
UZ,ET,2016.0,1,0,1
PK,CO,2010.0,1,0,1
BI,BE,2010.0,1,0,1
VE,UG,2011.0,1,0,1
TG,NG,2019.0,1,0,1
SN,TG,2014.0,2,0,2
SD,LK,2008.0,1,0,1
TH,AR,2011.0,1,0,1
KR,KW,2020.0,1,0,1
BN,PK,2023.0,1,0,1
LR,US,2004.0,1,0,1
GR,UY,2009.0,1,0,1
MV,MZ,2017.0,1,0,1
CR,DK,2020.0,1,0,1
GB,SL,2009.0,1,0,1
AU,KW,1999.0,1,0,1
JM,EG,2016.0,1,0,1
IE,PL,1998.0,1,0,1
JP,EE,2004.0,3,0,3
MW,NO,2009.0,1,0,1
PL,KE,2009.0,1,0,1
NA,CO,2007.0,1,0,1
HU,NP,2012.0,1,0,1
BT,ID,2019.0,2,0,2
EE,UA,2007.0,1,0,1
CH,TG,2015.0,1,0,1
BH,PS,2013.0,1,0,1
IN,CI,2013.0,1,0,1
UA,TR,2005.0,1,0,1
CA,SY,2003.0,1,0,1
GH,MY,2004.0,1,0,1
KR,NZ,2001.0,1,0,1
IT,CY,2001.0,1,0,1
FI,BF,2013.0,1,0,1
IR,PL,2001.0,1,0,1
BG,EC,2015.0,1,0,1
UA,NO,2004.0,1,0,1
LT,IT,2007.0,2,0,2
RO,TW,2004.0,1,0,1
AR,KR,2014.0,2,0,2
MG,SN,2000.0,1,0,1
LB,ET,2021.0,1,0,1
AU,PR,2008.0,1,0,1
BY,EG,2020.0,1,0,1
CL,EG,2016.0,1,0,1
LV,CN,2004.0,1,0,1
KE,PE,2020.0,1,0,1
TR,AR,2007.0,1,0,1
PK,MG,2017.0,1,0,1
DZ,BR,2010.0,1,0,1
JP,KP,2001.0,1,0,1
IM,,2024.0,2,0,2
GA,CM,2009.0,1,0,1
AF,ID,2018.0,2,0,2
HU,UA,1998.0,1,0,1
UZ,SK,2000.0,1,0,1
ZW,SN,2010.0,1,0,1
CN,MA,2006.0,1,0,1
LK,TR,2022.0,1,0,1
KZ,HU,2022.0,2,0,2
AR,BE,1997.0,1,0,1
KH,NL,2006.0,1,0,1
PR,GB,1998.0,1,0,1
BO,CA,2011.0,1,0,1
LV,BY,2010.0,1,0,1
JP,CW,2019.0,1,0,1
CN,TG,2021.0,1,0,1
CL,BW,2014.0,1,0,1
MX,UA,2021.0,1,0,1
ZM,GH,1998.0,1,0,1
DK,UA,1997.0,1,0,1
CN,CG,2016.0,1,0,1
BR,MW,2023.0,1,0,1
,CF,2001.0,2,0,2
NO,LK,2016.0,1,0,1
NP,BD,2002.0,1,0,1
IQ,BN,2012.0,1,0,1
SK,SI,2001.0,2,0,2
ET,SD,2009.0,1,0,1
ES,NE,2022.0,1,0,1
UG,GE,2015.0,1,0,1
RU,MN,2001.0,1,0,1
IL,LT,2011.0,1,0,1
EC,HR,2021.0,1,0,1
GM,NP,1998.0,1,0,1
BY,JP,2009.0,1,0,1
SZ,CA,1997.0,1,0,1
HU,BH,2002.0,1,0,1
SV,BE,2021.0,1,0,1
HR,LT,2004.0,1,0,1
MU,JE,2022.0,1,0,1
TZ,PL,2021.0,1,0,1
US,BS,1998.0,1,0,1
SK,IE,2008.0,1,0,1
BG,BY,2006.0,1,0,1
RS,ZA,2014.0,1,0,1
BD,CZ,2011.0,1,0,1
,PW,2008.0,1,0,1
MK,IN,2007.0,1,0,1
BY,EE,2019.0,1,0,1
MG,ZA,2016.0,1,0,1
UG,CA,2010.0,1,0,1
BF,LU,2018.0,1,0,1
DK,OM,2019.0,1,0,1
TH,VE,2020.0,1,0,1
MA,MY,2017.0,1,0,1
RU,GH,2022.0,1,0,1
AU,DZ,2001.0,1,0,1
SK,IR,2006.0,1,0,1
BT,US,2018.0,1,0,1
DK,CD,2010.0,1,0,1
MM,MY,2003.0,1,0,1
LK,ET,2020.0,1,0,1
JM,BJ,2018.0,1,0,1
EG,UZ,2021.0,1,0,1
MY,CU,2020.0,1,0,1
DE,GL,2001.0,1,0,1
BJ,ZA,2015.0,1,0,1
PL,AL,2016.0,1,0,1
NP,CA,2001.0,1,0,1
GB,SS,2023.0,1,0,1
DZ,ES,2023.0,1,0,1
GT,NI,2021.0,1,0,1
LV,AT,2020.0,1,0,1
AM,JO,2001.0,1,0,1
DE,US,2019.0,2662,2771,-109
US,KR,2016.0,1286,1276,10
JP,KR,2011.0,363,319,44
SG,CN,2020.0,590,525,65
US,GB,2003.0,3854,4104,-250
DE,US,2017.0,2505,2690,-185
KR,US,2017.0,1332,1256,76
US,NL,2018.0,837,985,-148
US,IT,2011.0,930,1062,-132
US,SE,2003.0,279,317,-38
IN,GB,1998.0,97,68,29
DE,EG,2013.0,84,39,45
KR,US,2010.0,1090,1298,-208
FR,CN,2010.0,266,198,68
IT,GB,2016.0,702,417,285
CN,AU,2004.0,128,169,-41
TW,US,2003.0,500,595,-95
US,ES,2002.0,443,475,-32
MT,GB,2018.0,17,19,-2
DE,US,2010.0,2308,2363,-55
EG,LB,2016.0,15,16,-1
MX,US,2003.0,195,226,-31
US,DE,2022.0,1303,1281,22
IN,AU,2014.0,193,161,32
AR,ES,2016.0,342,420,-78
FI,DE,2017.0,77,62,15
IT,US,2014.0,1138,955,183
SE,ES,2018.0,55,106,-51
IE,BE,2015.0,11,13,-2
CO,BR,2012.0,112,87,25
IT,RU,2019.0,63,58,5
TT,GB,2015.0,5,8,-3
BR,CN,2013.0,62,62,0
ZA,US,2019.0,375,327,48
ZA,US,2010.0,317,287,30
SG,GB,2015.0,136,186,-50
KR,US,2019.0,1357,1305,52
PK,US,2000.0,40,36,4
US,AT,2002.0,134,170,-36
FR,JP,2009.0,134,106,28
CA,GB,2004.0,466,620,-154
US,ES,2005.0,606,520,86
nan,BR,2015.0,122,119,3
FR,BR,2007.0,120,111,9
MX,DE,2022.0,21,17,4
BR,AU,2018.0,164,117,47
BE,DE,2007.0,77,105,-28
FR,ES,2006.0,183,172,11
US,PT,2008.0,141,100,41
LT,MZ,2006.0,7,4,3
CA,SG,2007.0,29,29,0
MX,NL,2022.0,9,7,2
NZ,GB,2022.0,133,123,10
DE,GB,2020.0,920,982,-62
US,MX,1998.0,122,130,-8
FI,DE,2010.0,68,35,33
SE,GB,2022.0,105,107,-2
IN,DE,2012.0,175,166,9
DE,AT,2002.0,260,234,26
SG,US,2011.0,290,345,-55
PL,DE,2002.0,75,68,7
CA,IN,2016.0,233,239,-6
PH,US,2011.0,465,383,82
BR,FR,2021.0,214,150,64
CA,PL,2013.0,42,37,5
AU,BR,2021.0,94,129,-35
EG,FR,2016.0,28,31,-3
ZA,US,2017.0,387,385,2
ES,GB,2016.0,584,359,225
CH,ES,2006.0,60,46,14
US,PK,2002.0,53,55,-2
ES,VE,2014.0,49,75,-26
PL,BA,2009.0,1,4,-3
ID,CN,2010.0,14,8,6
AE,BR,2013.0,5,2,3
US,EC,2022.0,39,63,-24
TT,JM,2010.0,13,17,-4
JP,IQ,2010.0,5,6,-1
BR,DE,2003.0,62,74,-12
CN,NZ,2016.0,51,53,-2
nan,US,2001.0,113,121,-8
US,IE,2006.0,376,295,81
AU,NL,2020.0,105,112,-7
UY,AR,2009.0,24,27,-3
CL,EC,2018.0,104,72,32
GB,AT,2014.0,102,111,-9
NO,KR,2011.0,6,8,-2
PK,SA,2015.0,76,55,21
EG,DE,2012.0,39,52,-13
PE,BR,2014.0,56,40,16
BR,AR,2012.0,103,140,-37
CU,CL,2009.0,15,8,7
BR,GB,2021.0,259,201,58
DE,NO,2011.0,79,53,26
CN,SG,1997.0,38,30,8
PT,ES,2015.0,180,187,-7
JP,NZ,2008.0,18,9,9
US,AT,2005.0,168,179,-11
PT,CL,2014.0,16,9,7
CN,SG,1998.0,62,37,25
ES,nan,2012.0,38,29,9
CH,PK,2007.0,14,12,2
IR,CA,2012.0,210,117,93
FR,CA,2018.0,654,588,66
FR,BE,2001.0,199,167,32
JP,GB,2013.0,316,270,46
US,CU,2000.0,18,21,-3
US,VG,2000.0,6,3,3
CA,MX,2011.0,33,33,0
PT,US,2017.0,174,182,-8
NZ,BE,2022.0,3,3,0
GB,KR,2015.0,118,94,24
US,SK,2007.0,37,27,10
GB,EC,2022.0,12,4,8
PE,CL,2001.0,8,9,-1
TW,CA,2001.0,24,21,3
NG,UG,2022.0,7,5,2
AT,US,2004.0,187,149,38
CN,PL,2008.0,31,30,1
SG,TW,2022.0,33,31,2
IT,CZ,2022.0,38,21,17
TH,US,2013.0,126,205,-79
SK,HU,2010.0,8,16,-8
nan,PE,2007.0,6,5,1
IT,HR,1997.0,1,3,-2
GH,GB,2022.0,12,13,-1
MY,ID,2006.0,17,6,11
TZ,IN,2017.0,2,6,-4
DE,RO,2020.0,32,38,-6
IN,BH,2015.0,6,3,3
CN,IN,2011.0,165,196,-31
GB,CZ,2013.0,45,37,8
IE,CN,2008.0,33,40,-7
NL,NP,2012.0,3,2,1
PT,US,2019.0,204,199,5
SY,CN,2011.0,34,36,-2
CN,PK,2006.0,39,72,-33
CN,RS,2007.0,7,2,5
CH,NL,2013.0,70,120,-50
BE,SE,2019.0,47,28,19
US,PK,2005.0,92,77,15
JP,DE,2020.0,182,187,-5
IN,nan,2019.0,138,106,32
SD,SA,2021.0,40,29,11
EG,CA,2019.0,84,95,-11
PT,US,2010.0,123,143,-20
EG,IQ,2015.0,21,9,12
UA,BG,2002.0,4,5,-1
EG,US,2022.0,218,181,37
JP,BR,2021.0,24,45,-21
BE,IT,2020.0,149,173,-24
FR,nan,2018.0,183,200,-17
EE,US,2020.0,16,11,5
DZ,SA,2019.0,15,7,8
MY,EG,2018.0,47,33,14
GB,ES,1999.0,108,126,-18
US,GE,1999.0,77,82,-5
TR,HU,2021.0,14,11,3
SK,CH,2013.0,12,7,5
HU,GB,2017.0,56,58,-2
BD,CH,2016.0,4,5,-1
US,LT,2014.0,19,15,4
UA,RU,2004.0,91,83,8
SG,NL,2008.0,6,10,-4
HU,RO,2014.0,37,37,0
BG,NO,2012.0,9,5,4
TW,RO,2020.0,1,1,0
NL,GR,2005.0,9,13,-4
BI,FR,2019.0,25,23,2
FR,CN,2017.0,219,167,52
TN,US,2012.0,12,18,-6
SA,KW,2014.0,6,17,-11
CM,TZ,2020.0,1,1,0
DE,PT,2017.0,41,52,-11
CN,CH,2014.0,69,88,-19
TR,GR,2020.0,9,7,2
AT,IT,2002.0,20,21,-1
RO,US,2012.0,56,90,-34
MA,AE,2017.0,3,2,1
JP,NG,2019.0,28,31,-3
JP,TH,2004.0,61,33,28
SA,NG,2015.0,12,10,2
FR,DE,1999.0,242,218,24
DE,PT,2019.0,59,51,8
NG,CN,2017.0,20,10,10
BR,ZM,2017.0,6,9,-3
KZ,UZ,2020.0,11,7,4
DE,PT,2010.0,21,35,-14
TH,JP,2012.0,65,89,-24
RU,GE,2016.0,9,6,3
JP,SE,2012.0,29,25,4
NP,NZ,2018.0,62,58,4
AT,GR,2016.0,2,8,-6
NL,RU,2006.0,30,23,7
ID,CN,2019.0,222,366,-144
SA,SE,2018.0,8,10,-2
IT,ES,2003.0,101,77,24
SE,NO,2017.0,99,91,8
FI,SE,2013.0,62,91,-29
IL,AU,2014.0,21,11,10
IT,FR,2021.0,300,335,-35
CA,IT,2016.0,83,227,-144
FR,LA,2014.0,2,2,0
US,PL,2003.0,140,185,-45
HU,RU,2019.0,20,28,-8
CL,BR,2011.0,73,71,2
CN,CA,2004.0,256,282,-26
IR,DK,2022.0,31,6,25
NL,ZA,2015.0,47,46,1
TW,GB,2013.0,45,68,-23
CZ,JP,2002.0,7,9,-2
RU,ZA,2020.0,7,10,-3
QA,EG,2002.0,5,6,-1
RU,PL,2020.0,46,50,-4
IT,DO,2018.0,11,1,10
ID,TW,2013.0,13,12,1
AR,CR,2020.0,13,14,-1
GB,ZA,2007.0,117,120,-3
MM,IT,2018.0,1,1,0
NP,SA,2011.0,1,1,0
OM,MY,2017.0,6,12,-6
SA,ET,2018.0,2,2,0
PE,PA,2016.0,2,1,1
IQ,SA,2014.0,8,7,1
RU,CA,2021.0,31,30,1
JP,DK,2008.0,20,14,6
IE,EG,2017.0,4,5,-1
IE,KR,2016.0,5,7,-2
LT,CN,2013.0,4,8,-4
IT,IE,2021.0,36,31,5
HR,US,1997.0,14,12,2
AT,HR,2021.0,5,9,-4
SA,QA,2018.0,28,14,14
DE,PL,2021.0,115,102,13
PH,ES,2016.0,17,16,1
HR,UA,2021.0,14,10,4
SN,BF,2020.0,5,2,3
AR,GB,2017.0,34,39,-5
PT,CZ,2022.0,2,2,0
FR,FI,2004.0,13,9,4
AE,CN,2018.0,8,15,-7
US,GH,2019.0,61,52,9
US,PS,2020.0,18,17,1
RS,BA,2020.0,42,51,-9
LV,BR,2019.0,1,2,-1
KR,QA,2020.0,4,4,0
NO,CN,2015.0,48,32,16
CH,CN,2014.0,88,69,19
NG,HU,2016.0,1,1,0
NZ,CH,2021.0,7,7,0
BE,SE,2017.0,34,28,6
FR,EG,2020.0,34,33,1
TT,JM,2019.0,10,21,-11
NL,BR,2021.0,46,75,-29
IT,KR,2011.0,5,9,-4
PL,DE,2005.0,77,90,-13
CH,DK,2016.0,35,53,-18
BR,IN,2014.0,29,31,-2
TW,AM,2007.0,1,1,0
ES,DE,2003.0,108,103,5
AE,DE,2002.0,1,2,-1
CH,CL,2015.0,13,18,-5
CZ,JP,2005.0,14,8,6
BE,BR,2007.0,48,35,13
AU,NZ,2011.0,145,230,-85
ES,NO,2014.0,30,24,6
SG,DZ,2017.0,2,2,0
CU,BR,2022.0,5,4,1
SG,FI,2010.0,5,1,4
KR,CH,2020.0,24,26,-2
SE,EE,2004.0,12,2,10
BE,IR,2020.0,15,41,-26
MA,IR,2020.0,8,14,-6
SK,AT,2010.0,14,13,1
BR,PA,2016.0,7,2,5
BR,ID,2006.0,3,1,2
MY,MA,2020.0,8,6,2
TR,AZ,2014.0,12,2,10
FI,RU,2009.0,16,13,3
AR,SE,2020.0,9,7,2
RU,KZ,2019.0,72,99,-27
ID,HU,2021.0,16,15,1
TR,IR,2020.0,34,62,-28
AT,ET,2022.0,2,1,1
CD,US,2016.0,4,8,-4
HU,GB,2019.0,55,54,1
ET,NG,2022.0,6,7,-1
GH,AU,2019.0,20,8,12
BD,US,2015.0,138,107,31
FR,CN,2019.0,239,147,92
CH,IE,2008.0,13,2,11
AU,IT,2012.0,58,54,4
PE,ES,2021.0,142,129,13
GB,FI,2009.0,48,60,-12
BD,SA,2015.0,20,17,3
ID,CN,2017.0,141,268,-127
CH,RS,2013.0,7,9,-2
TZ,CH,2015.0,6,5,1
CO,ZA,2018.0,3,4,-1
PL,IE,2016.0,4,13,-9
KW,MA,2014.0,10,3,7
GH,AU,2017.0,8,12,-4
BG,BA,2014.0,1,1,0
NL,IL,2018.0,13,17,-4
IQ,SG,2021.0,3,5,-2
DE,BG,2000.0,12,21,-9
FI,NL,2001.0,13,16,-3
BR,MZ,2022.0,9,8,1
DZ,TN,2018.0,34,42,-8
TW,AU,2016.0,43,35,8
IR,LY,2016.0,1,1,0
GB,PL,2003.0,30,35,-5
ZA,ES,2022.0,6,9,-3
GB,AE,2007.0,24,11,13
TZ,CA,2008.0,2,1,1
SK,US,2000.0,22,30,-8
SE,BR,2020.0,27,35,-8
RS,US,2007.0,33,48,-15
LB,US,2012.0,40,73,-33
IT,RU,2017.0,59,27,32
PL,BE,2007.0,33,11,22
BG,DE,2018.0,14,26,-12
ZA,GB,2007.0,120,117,3
NO,DK,2001.0,30,36,-6
US,GH,2010.0,26,6,20
EG,CA,2010.0,32,38,-6
IT,TR,2001.0,7,12,-5
IR,BR,2013.0,12,4,8
NO,FR,2011.0,59,44,15
DE,LU,2014.0,44,33,11
CH,RO,2012.0,11,5,6
IT,CO,2012.0,15,15,0
BB,JM,2018.0,7,2,5
US,KZ,2016.0,20,13,7
CZ,UA,2016.0,30,21,9
JP,CZ,2008.0,18,10,8
PL,SE,2009.0,19,13,6
CA,EG,2009.0,35,29,6
GB,JO,2008.0,18,4,14
TT,JM,2017.0,12,20,-8
GB,NO,2005.0,49,35,14
AU,TH,2007.0,30,14,16
FI,DE,2019.0,76,86,-10
FR,GR,2001.0,15,13,2
SE,BE,2022.0,21,11,10
NO,IE,2011.0,4,2,2
DE,TW,2017.0,26,43,-17
PT,FR,2012.0,39,58,-19
MY,SG,2006.0,24,30,-6
SE,SG,2015.0,13,20,-7
HR,US,1998.0,25,14,11
BE,SE,2010.0,21,23,-2
NL,SE,2004.0,37,30,7
AU,CN,1997.0,44,39,5
JO,BE,2016.0,1,1,0
GB,MT,2013.0,16,9,7
IN,nan,2010.0,31,24,7
SG,nan,2012.0,8,10,-2
BI,FR,2017.0,22,20,2
MD,FR,2020.0,33,34,-1
NZ,CA,2012.0,63,46,17
GR,ZA,2016.0,7,3,4
RU,KZ,2017.0,63,74,-11
JO,CA,2001.0,2,2,0
IT,TN,2010.0,7,5,2
BR,IR,2015.0,6,18,-12
CN,AT,2009.0,11,13,-2
US,TT,2016.0,10,15,-5
SG,IR,2009.0,7,9,-2
AT,HU,2003.0,6,13,-7
BD,IL,2017.0,1,1,0
CA,KR,2011.0,47,54,-7
NZ,DK,2009.0,7,11,-4
GB,DK,2023.0,6,6,0
PH,PT,2019.0,3,3,0
AU,NC,2017.0,3,1,2
BM,US,2018.0,5,2,3
GT,MX,2012.0,8,11,-3
EG,KW,2021.0,18,18,0
PK,NL,2018.0,6,11,-5
UG,CH,2010.0,3,1,2
KR,PL,2000.0,2,2,0
NL,AT,2002.0,16,11,5
GB,IL,2009.0,43,52,-9
TR,PK,2016.0,18,26,-8
RU,CH,2009.0,19,18,1
RU,CZ,2004.0,12,10,2
LU,FR,2015.0,34,53,-19
GH,US,2008.0,9,11,-2
CN,ZA,2012.0,11,11,0
MZ,ES,2011.0,1,3,-2
SK,FI,2011.0,7,1,6
CZ,ZA,2020.0,7,9,-2
BR,BE,2001.0,10,21,-11
US,CI,2005.0,3,3,0
PT,IT,2013.0,25,43,-18
AR,GB,2019.0,55,46,9
US,GD,2022.0,3,9,-6
FR,MZ,2009.0,1,1,0
PT,RO,2020.0,6,6,0
CL,VE,2019.0,18,47,-29
ZW,US,2004.0,9,5,4
TW,PL,2011.0,1,1,0
VE,CL,2021.0,15,14,1
IT,RU,2010.0,25,23,2
IT,CA,1998.0,57,53,4
IT,AU,2001.0,19,24,-5
SE,KW,2007.0,2,1,1
nan,KR,2006.0,9,10,-1
RU,EE,2017.0,8,14,-6
GW,DK,1998.0,1,1,0
ZA,RU,2020.0,10,7,3
CN,SE,2001.0,25,37,-12
BE,ID,2014.0,8,2,6
BA,ME,2018.0,4,2,2
AT,PT,2009.0,4,1,3
PK,DE,2002.0,2,3,-1
NG,GB,2006.0,20,6,14
CZ,KR,2013.0,10,9,1
SG,FR,2006.0,7,11,-4
SG,FI,2019.0,8,3,5
NL,FI,2020.0,21,42,-21
ET,GB,2015.0,5,12,-7
QA,CN,2014.0,11,19,-8
CN,SA,2011.0,19,1,18
GB,ID,2011.0,34,10,24
JO,IQ,2020.0,20,19,1
BE,CD,2021.0,10,6,4
AT,DK,2018.0,26,13,13
US,QA,2004.0,13,6,7
TR,BA,2016.0,6,4,2
CH,TH,2016.0,6,2,4
IN,DK,2015.0,30,24,6
GH,ID,2022.0,2,8,-6
IR,IN,2009.0,24,28,-4
TR,SE,2018.0,24,6,18
AU,SA,2018.0,52,35,17
NL,KZ,2018.0,4,1,3
EC,BE,2019.0,13,7,6
RO,PL,2022.0,8,4,4
GB,LB,2021.0,8,11,-3
VG,NL,2017.0,1,1,0
BH,OM,2021.0,3,3,0
NO,MW,2018.0,1,2,-1
BR,CL,2001.0,14,10,4
IL,HU,2021.0,2,2,0
BR,UA,2020.0,9,15,-6
KH,TH,2016.0,2,1,1
OM,US,2007.0,15,6,9
NL,JP,1999.0,34,30,4
SE,NO,2019.0,123,101,22
LT,SE,1998.0,5,3,2
IT,MY,2009.0,30,32,-2
HU,GB,2010.0,46,50,-4
AU,nan,2004.0,13,10,3
TW,MY,2016.0,35,23,12
JP,JO,2014.0,6,1,5
NL,TW,2014.0,9,7,2
JP,CN,2023.0,13,41,-28
DE,ES,2023.0,14,9,5
EE,RU,2013.0,6,12,-6
VE,MX,2011.0,44,40,4
MY,FR,2013.0,11,16,-5
ES,SE,2003.0,22,20,2
BG,ZA,2015.0,2,4,-2
IL,CA,2022.0,39,32,7
DK,FR,2022.0,24,26,-2
AT,SG,2014.0,3,6,-3
LT,SE,1997.0,2,1,1
CH,HU,2007.0,6,12,-6
TW,KR,2018.0,58,48,10
DK,PK,2021.0,14,10,4
PS,US,2021.0,9,7,2
ZA,nan,2010.0,6,10,-4
SG,CA,2020.0,46,45,1
HU,RU,2017.0,21,13,8
IR,NO,2016.0,15,12,3
OM,MY,2019.0,9,20,-11
AT,PK,2009.0,11,7,4
CH,CZ,2005.0,20,21,-1
AR,IL,2002.0,3,2,1
MZ,PL,2016.0,15,10,5
SK,RO,2012.0,5,2,3
CA,TH,2021.0,10,8,2
CA,IR,2003.0,39,32,7
RU,IE,2005.0,7,5,2
GB,RO,1997.0,1,3,-2
CA,SA,2007.0,33,24,9
SI,US,2007.0,27,23,4
US,PE,2001.0,14,22,-8
RU,EE,2010.0,2,3,-1
US,LB,2003.0,32,16,16
SE,RU,2023.0,1,3,-2
TN,ES,2020.0,12,5,7
DK,IT,2009.0,23,25,-2
CN,LT,2002.0,14,3,11
CY,US,2018.0,16,19,-3
CH,SE,2001.0,27,16,11
NL,GR,2002.0,12,7,5
DE,nan,1997.0,12,19,-7
RS,SE,2003.0,3,2,1
TZ,ZA,2007.0,3,2,1
PK,GB,2006.0,42,48,-6
NP,US,2008.0,19,14,5
RU,GB,1999.0,63,39,24
AE,AU,2019.0,17,16,1
US,UA,2009.0,30,47,-17
GB,TZ,2015.0,16,17,-1
NL,NG,2019.0,6,5,1
NZ,DE,2013.0,38,29,9
NZ,FR,2003.0,5,5,0
DK,PL,2004.0,4,4,0
HK,NL,2007.0,11,17,-6
IQ,DE,2014.0,1,10,-9
TR,PH,2003.0,1,1,0
BR,UY,2007.0,22,24,-2
GB,MA,2005.0,3,3,0
CA,AT,2021.0,25,25,0
SG,IN,2006.0,22,35,-13
SK,AT,2017.0,13,17,-4
AT,SA,2016.0,7,2,5
BE,CA,2011.0,69,49,20
GR,NZ,2019.0,2,1,1
GR,BR,2008.0,2,4,-2
CA,BH,2018.0,1,2,-1
IS,GB,2003.0,4,2,2
CA,BG,2005.0,3,1,2
SI,AT,2013.0,11,11,0
IE,AT,2021.0,5,3,2
IN,SG,2023.0,4,2,2
LV,PL,2011.0,2,2,0
FR,SA,2008.0,11,4,7
SE,TR,2018.0,6,24,-18
SI,NO,2014.0,4,2,2
JP,PL,2009.0,16,17,-1
RU,NL,1998.0,8,22,-14
GR,CA,2004.0,4,5,-1
JP,MY,2000.0,8,7,1
PL,AU,2022.0,7,12,-5
CH,SG,2004.0,4,4,0
BR,NZ,2022.0,11,8,3
SA,NZ,2013.0,2,3,-1
FR,MG,2007.0,8,7,1
BR,QA,2020.0,5,2,3
CL,GB,1997.0,4,5,-1
RO,NL,1998.0,6,4,2
ES,NI,2015.0,6,6,0
BE,LU,2009.0,18,13,5
BR,VE,2013.0,17,20,-3
PY,CL,2020.0,7,8,-1
NL,TN,2012.0,2,1,1
RU,NO,2012.0,18,15,3
DE,nan,1998.0,17,12,5
MX,AR,2001.0,41,23,18
MD,DE,2001.0,6,1,5
US,NP,2005.0,6,14,-8
MK,AU,2004.0,12,14,-2
EC,RO,2018.0,1,1,0
PE,BE,2015.0,4,6,-2
MY,JP,1999.0,5,8,-3
ZA,CN,2011.0,17,16,1
JP,KH,2018.0,8,2,6
EC,GB,2005.0,2,2,0
ZA,ZW,1998.0,1,1,0
MX,MY,2014.0,4,1,3
SE,IS,2001.0,8,4,4
FR,MY,2016.0,15,13,2
SE,CN,1999.0,27,26,1
CO,CA,2006.0,12,7,5
AT,IR,2003.0,2,2,0
US,SN,2021.0,14,9,5
BO,CR,2010.0,1,2,-1
nan,CL,2019.0,12,8,4
DE,TW,2019.0,34,35,-1
MY,AT,2021.0,2,1,1
EC,CL,2022.0,28,26,2
DE,RS,2021.0,17,20,-3
MY,DE,2021.0,13,8,5
AU,AT,2018.0,42,29,13
AT,IE,2011.0,6,7,-1
IN,AE,2006.0,5,4,1
LU,DE,2004.0,7,8,-1
IT,NZ,2003.0,4,4,0
UA,CN,2007.0,17,15,2
US,BY,2005.0,7,7,0
CH,PE,2020.0,5,2,3
GR,FI,2017.0,6,4,2
AU,CN,1998.0,64,61,3
CH,AR,2007.0,5,8,-3
CH,LV,2018.0,2,7,-5
CR,CL,2013.0,19,19,0
PK,DE,2005.0,12,5,7
US,HK,2009.0,11,6,5
NG,GH,2019.0,22,16,6
NL,KR,2004.0,3,5,-2
MY,PS,2016.0,7,1,6
LV,CN,2015.0,2,6,-4
nan,SE,2001.0,30,55,-25
ES,GT,2015.0,6,9,-3
MW,ZA,2012.0,6,7,-1
CR,VE,2010.0,3,3,0
UA,DE,2020.0,29,29,0
CN,HU,2013.0,9,2,7
AU,NG,2020.0,6,18,-12
IN,RU,2004.0,10,1,9
BE,HU,2013.0,10,8,2
NL,NG,2017.0,7,7,0
TZ,KE,2014.0,6,5,1
CA,NC,2008.0,2,1,1
PT,IN,2011.0,7,16,-9
DK,IE,2015.0,6,11,-5
IT,TN,2019.0,17,25,-8
PL,UZ,2012.0,3,4,-1
ZA,BH,2017.0,1,2,-1
TW,EG,2015.0,10,12,-2
SA,CH,2022.0,4,7,-3
TG,BJ,2008.0,1,2,-1
NO,EE,2021.0,3,4,-1
SI,IT,2021.0,11,15,-4
nan,MX,2009.0,13,15,-2
KR,DE,1997.0,2,4,-2
VE,PE,2011.0,13,4,9
VE,BR,1999.0,12,5,7
DZ,EG,2016.0,7,8,-1
PT,AO,2019.0,3,6,-3
KR,TW,1999.0,14,15,-1
ES,KR,2012.0,8,6,2
KE,NG,2018.0,11,5,6
IN,GR,2015.0,5,7,-2
JP,HU,2006.0,10,7,3
AT,IT,2005.0,24,23,1
HU,RU,2010.0,10,9,1
RU,NL,1997.0,19,7,12
PT,GB,2011.0,66,94,-28
SY,MX,2011.0,1,1,0
IT,NO,2004.0,6,17,-11
IR,DE,2008.0,24,24,0
CN,NL,1998.0,16,17,-1
CH,GH,2014.0,5,1,4
KZ,TR,2006.0,18,21,-3
PT,MX,2016.0,29,15,14
RU,LV,2004.0,22,3,19
SE,IN,1999.0,5,5,0
FI,IE,2015.0,5,5,0
BI,FR,2010.0,19,30,-11
SD,MY,2020.0,2,10,-8
SD,KR,2018.0,5,11,-6
EG,ET,2016.0,7,3,4
AE,IQ,2015.0,5,3,2
SA,GR,2017.0,2,7,-5
FO,DK,2019.0,2,4,-2
MY,LY,2016.0,6,5,1
AM,US,2006.0,13,3,10
KH,US,2020.0,13,7,6
GH,BH,2022.0,5,12,-7
FR,CR,2020.0,8,6,2
HU,SK,2006.0,9,7,2
NG,CN,2010.0,4,11,-7
IT,CA,1997.0,33,62,-29
CZ,GB,2016.0,43,57,-14
EG,GH,2015.0,5,6,-1
nan,AT,2007.0,11,8,3
HN,US,2006.0,3,2,1
SI,CZ,2008.0,6,11,-5
BE,TN,2018.0,4,4,0
NL,CZ,2007.0,11,9,2
FR,RS,2011.0,6,8,-2
BE,UG,2012.0,6,3,3
MW,FI,2016.0,3,1,2
PH,NP,2013.0,1,2,-1
UZ,KZ,2014.0,4,9,-5
RS,AU,2007.0,5,5,0
RU,TW,2001.0,11,7,4
BR,ST,2005.0,13,13,0
RU,EE,2019.0,13,9,4
SN,US,2019.0,8,11,-3
NL,NG,2010.0,4,7,-3
CL,IT,2008.0,14,18,-4
GB,PH,2000.0,11,9,2
SG,OM,2018.0,1,2,-1
ZW,ZM,2015.0,4,1,3
GB,OM,2015.0,11,8,3
NO,SJ,2013.0,7,12,-5
IR,PT,2012.0,14,4,10
RU,AE,2015.0,2,1,1
IR,AT,2013.0,10,8,2
RO,SE,2011.0,9,4,5
PH,GB,2006.0,10,7,3
ET,BW,2021.0,1,3,-2
SK,AT,2019.0,15,14,1
BW,GB,2006.0,3,7,-4
BS,AU,2020.0,2,1,1
QA,JO,2007.0,1,1,0
HU,ZA,2011.0,1,1,0
PT,AU,2016.0,22,7,15
EE,CA,2019.0,5,1,4
RU,KZ,2010.0,15,14,1
YE,MY,2011.0,4,5,-1
GB,MW,2012.0,11,12,-1
LT,RO,2003.0,2,1,1
IS,IT,2015.0,2,3,-1
NZ,MY,2018.0,19,13,6
TN,ID,2018.0,8,2,6
NL,RS,2011.0,8,8,0
LY,AE,2009.0,1,1,0
CN,LU,2004.0,3,2,1
CA,CU,2005.0,1,3,-2
CR,PE,2016.0,10,15,-5
PR,KR,2012.0,33,21,12
SK,HU,2017.0,8,8,0
UY,IT,2009.0,3,6,-3
PH,BR,2012.0,5,6,-1
VE,CU,1999.0,2,1,1
ES,AT,2007.0,14,8,6
GH,IE,2019.0,1,3,-2
CU,US,2003.0,14,16,-2
AR,VE,2020.0,10,20,-10
NG,TZ,2011.0,1,3,-2
nan,CL,2017.0,6,4,2
DZ,IT,2006.0,6,1,5
KW,SD,2022.0,2,2,0
VN,SG,2013.0,5,9,-4
CN,YE,2020.0,5,8,-3
KR,DE,1998.0,6,16,-10
BR,AT,2008.0,6,9,-3
PT,PA,2012.0,1,1,0
IL,AE,2014.0,3,2,1
QA,EG,2005.0,3,4,-1
DK,nan,2002.0,7,11,-4
PK,BD,2013.0,22,40,-18
UY,PT,2011.0,2,1,1
TR,IT,2004.0,7,15,-8
ES,PS,2002.0,4,2,2
NZ,NP,2007.0,8,9,-1
CA,GI,2008.0,1,1,0
RU,BY,1998.0,10,16,-6
KE,CN,2018.0,8,19,-11
PK,OM,2022.0,8,2,6
IL,JO,2007.0,2,1,1
PK,RU,2022.0,5,6,-1
KR,PK,2011.0,11,12,-1
SE,TZ,2010.0,7,1,6
UZ,PL,2010.0,2,4,-2
NO,TH,2015.0,4,3,1
DE,CL,2007.0,28,24,4
LT,DK,2007.0,4,1,3
GB,RO,1998.0,6,5,1
TZ,GB,2007.0,5,5,0
FR,UA,2007.0,10,6,4
IT,GR,2001.0,9,7,2
AU,RU,2011.0,19,19,0
TR,TH,2013.0,4,2,2
BR,PL,1997.0,2,4,-2
UA,KR,2011.0,2,1,1
RS,NL,2019.0,11,10,1
AU,HU,2020.0,7,5,2
BG,RU,1998.0,8,7,1
nan,TR,2012.0,11,25,-14
MY,VN,2014.0,3,3,0
NE,BE,2014.0,2,1,1
VN,GH,2021.0,2,2,0
SG,AE,2016.0,7,1,6
QA,ZA,2020.0,2,8,-6
IT,MT,2014.0,1,4,-3
EE,NL,2013.0,2,4,-2
GR,IR,2015.0,2,2,0
SN,US,2017.0,12,10,2
IN,PS,2016.0,3,3,0
US,MW,1998.0,4,1,3
US,TN,2005.0,7,6,1
CG,CH,2022.0,3,1,2
NL,SK,1999.0,8,9,-1
CA,CO,2022.0,13,10,3
MA,PK,2003.0,4,3,1
DZ,SA,2017.0,6,6,0
VN,EG,2018.0,10,4,6
AE,IR,2022.0,1,3,-2
nan,AE,2022.0,5,1,4
LB,IR,2022.0,2,4,-2
MM,IN,2017.0,1,1,0
HU,ID,2021.0,15,16,-1
LK,US,2022.0,18,18,0
CA,ZW,1999.0,1,2,-1
LA,TH,2012.0,2,1,1
US,LK,2006.0,13,17,-4
IT,LB,2014.0,22,9,13
HU,AT,2003.0,13,6,7
RU,AU,2009.0,19,9,10
RU,IN,1998.0,7,6,1
IE,FI,2010.0,4,1,3
NL,IT,2023.0,8,8,0
GN,SN,2009.0,1,1,0
AU,VN,2007.0,3,7,-4
BR,CR,2014.0,8,7,1
DK,BR,2021.0,19,43,-24
FJ,NZ,2003.0,1,2,-1
PH,IN,2006.0,5,4,1
PE,VE,2011.0,4,13,-9
IT,ET,2018.0,4,4,0
KE,IN,2004.0,2,3,-1
NG,GH,2017.0,18,8,10
CN,TZ,2021.0,10,6,4
PY,BR,2013.0,3,4,-1
EG,MY,2001.0,4,3,1
GB,IS,2018.0,5,4,1
LV,DE,2013.0,3,7,-4
HR,ES,2001.0,2,1,1
BB,US,2012.0,4,3,1
EG,JO,2001.0,2,3,-1
LB,SY,2005.0,2,1,1
CO,CU,2006.0,12,8,4
DE,EC,2016.0,6,6,0
FR,KE,2005.0,5,3,2
VE,CR,2014.0,3,2,1
CL,BE,2012.0,8,7,1
SE,MA,2003.0,1,1,0
MA,CA,2004.0,8,7,1
SE,LV,1999.0,3,4,-1
CG,CA,2016.0,1,1,0
SG,SE,2008.0,6,5,1
KW,JO,2014.0,3,6,-3
JP,MN,2014.0,13,4,9
AT,PL,2004.0,6,8,-2
CH,UA,2015.0,6,11,-5
MW,NL,2012.0,1,2,-1
RU,JP,2022.0,14,12,2
CO,GB,2000.0,7,3,4
RO,CH,2006.0,4,4,0
JP,FI,2018.0,16,18,-2
CM,CH,2014.0,4,3,1
DE,HU,2000.0,25,43,-18
CN,GH,2018.0,16,28,-12
US,BZ,2018.0,3,1,2
PL,RO,2009.0,7,3,4
BA,CA,2007.0,2,1,1
CZ,NO,2009.0,18,8,10
IE,GH,2022.0,1,2,-1
PA,ES,1998.0,4,2,2
TZ,IN,2019.0,1,4,-3
NL,MX,2009.0,11,4,7
NL,LU,2009.0,6,2,4
IE,FI,2019.0,7,3,4
TH,TW,2011.0,4,2,2
BH,KE,1999.0,2,3,-1
LU,DK,2012.0,3,1,2
RO,NL,1997.0,1,2,-1
PH,BE,1997.0,2,2,0
RS,NL,2010.0,6,3,3
GN,FR,2012.0,4,3,1
QA,US,1997.0,4,4,0
AE,CA,2013.0,13,22,-9
RS,CH,2015.0,15,11,4
SE,RS,2006.0,3,1,2
EC,ES,2006.0,8,15,-7
KR,AU,2001.0,13,13,0
AR,CH,2022.0,14,4,10
AE,DE,2005.0,3,1,2
IE,EG,2019.0,10,10,0
PY,AR,2019.0,13,10,3
IL,BR,2003.0,2,5,-3
PL,CU,2018.0,1,1,0
PE,PK,2020.0,2,1,1
LT,US,2004.0,8,5,3
KN,US,2013.0,9,4,5
CR,VE,2017.0,5,3,2
RO,IN,2021.0,3,4,-1
DK,nan,2005.0,9,9,0
GB,LT,1998.0,3,1,2
CL,VE,2010.0,11,29,-18
AU,NC,2010.0,2,3,-1
ZA,JP,2003.0,6,6,0
GB,JM,2000.0,4,5,-1
CA,PT,2000.0,7,4,3
PT,MY,2008.0,4,2,2
SE,TZ,2019.0,6,4,2
ZA,SE,2009.0,9,6,3
FO,DK,2017.0,3,4,-1
NL,AR,2003.0,3,6,-3
GE,BR,2015.0,2,4,-2
RW,ZM,2020.0,2,2,0
CL,SE,2006.0,4,6,-2
nan,CL,2010.0,5,3,2
ME,ES,2020.0,2,1,1
JP,RO,2013.0,5,1,4
RO,BG,2009.0,3,4,-1
KE,JP,2016.0,5,11,-6
RU,AT,2006.0,5,9,-4
AU,VE,2019.0,4,1,3
CN,GR,2018.0,11,10,1
UG,CD,2019.0,2,4,-2
SK,RS,2009.0,3,3,0
EG,BE,2005.0,1,2,-1
PH,PL,2018.0,1,1,0
AU,RE,2005.0,1,1,0
GH,DK,2016.0,1,3,-2
BR,ZM,2019.0,4,9,-5
NZ,LK,2016.0,6,4,2
BE,EG,2009.0,2,2,0
EG,BE,2002.0,2,3,-1
DE,CY,2014.0,5,7,-2
AT,PE,2011.0,1,1,0
nan,EC,2018.0,4,1,3
UA,SE,2008.0,6,7,-1
FI,CZ,2011.0,8,9,-1
UG,AU,2009.0,2,2,0
DJ,FR,2019.0,1,2,-1
BE,AR,2013.0,6,12,-6
DE,UZ,2020.0,4,1,3
TT,AU,2020.0,2,1,1
GR,PL,2006.0,10,11,-1
FI,MY,2014.0,6,1,5
PK,KE,2006.0,6,6,0
ID,AU,2004.0,7,12,-5
CU,CH,2004.0,2,1,1
BF,FR,2000.0,4,3,1
MM,IN,2019.0,2,2,0
NZ,PL,2022.0,3,2,1
AM,JP,2011.0,4,1,3
PT,JP,2007.0,3,2,1
IT,UY,2018.0,9,11,-2
SA,BE,2016.0,2,3,-1
DE,LB,2013.0,4,3,1
JO,TW,2015.0,1,1,0
EC,UA,2022.0,4,6,-2
GP,FR,2004.0,5,8,-3
AT,FI,1999.0,2,1,1
KZ,UA,2005.0,2,3,-1
IT,PE,2021.0,7,11,-4
KR,TR,2004.0,3,6,-3
NG,NE,2020.0,4,1,3
UG,CD,2017.0,1,1,0
IR,TW,2009.0,3,1,2
GT,CL,2011.0,3,1,2
MN,TR,2019.0,1,2,-1
ID,nan,2014.0,23,24,-1
ML,IN,2018.0,7,2,5
HR,PL,2018.0,5,4,1
CA,MY,2003.0,4,1,3
ID,DE,2009.0,3,16,-13
MZ,KE,2020.0,1,1,0
BE,DK,2004.0,6,9,-3
EG,OM,2020.0,13,18,-5
MX,NZ,2007.0,1,2,-1
UA,PL,1997.0,6,3,3
IT,SK,2015.0,6,2,4
CA,BA,2018.0,2,1,1
QA,FR,2016.0,5,14,-9
CZ,SI,2006.0,5,5,0
LT,GB,2014.0,6,4,2
CN,MK,2008.0,2,5,-3
HK,SG,2016.0,2,4,-2
BG,BE,2020.0,2,1,1
AT,RS,2015.0,4,8,-4
RO,AT,2012.0,8,3,5
IT,SA,2012.0,11,6,5
NZ,VN,2012.0,1,1,0
PH,PT,2017.0,2,1,1
AT,ZA,2005.0,2,1,1
PL,PT,2005.0,3,1,2
EC,BE,2017.0,3,5,-2
US,NP,2002.0,6,4,2
IE,EG,2010.0,3,3,0
ZA,CZ,2006.0,2,1,1
IT,BG,2014.0,5,5,0
PT,MZ,2001.0,2,3,-1
BE,KH,2015.0,1,1,0
DE,AM,2020.0,6,2,4
RU,IE,2002.0,2,6,-4
PR,JP,2012.0,1,1,0
BD,NG,2021.0,2,7,-5
PH,TR,2006.0,1,1,0
BR,ST,2002.0,5,10,-5
MQ,FR,2015.0,10,15,-5
KE,BD,2011.0,1,1,0
ES,TH,2022.0,1,1,0
ZA,nan,2019.0,9,7,2
IQ,US,2006.0,1,5,-4
GB,ZW,2001.0,4,3,1
TW,UA,2016.0,1,2,-1
PE,BO,2008.0,2,1,1
CL,KR,2018.0,3,2,1
IQ,MM,2018.0,1,3,-2
UA,CA,2014.0,7,6,1
RU,UZ,2015.0,10,23,-13
NO,CH,2004.0,6,16,-10
DK,NP,2018.0,4,2,2
ML,GN,2014.0,3,1,2
IE,CH,2001.0,5,4,1
IR,NZ,2011.0,3,7,-4
US,MD,2002.0,3,1,2
BE,NO,2007.0,3,9,-6
GR,IL,2018.0,6,3,3
FI,UA,2014.0,3,4,-1
US,BY,2002.0,4,19,-15
FI,KR,2007.0,9,10,-1
SE,CZ,2022.0,10,11,-1
NZ,ZA,2001.0,4,9,-5
BD,PH,2020.0,3,4,-1
CL,NZ,2009.0,1,3,-2
US,SY,2004.0,7,2,5
TH,NL,2003.0,2,2,0
CU,IT,2004.0,3,4,-1
AM,FR,1998.0,3,1,2
VN,NO,2018.0,3,9,-6
BJ,FR,2022.0,7,6,1
RU,BY,1997.0,7,14,-7
JP,NG,2010.0,7,3,4
UG,CH,2019.0,3,2,1
ID,AT,2021.0,6,3,3
JP,RS,1999.0,5,1,4
SA,TR,2013.0,5,13,-8
IE,MY,2013.0,10,5,5
QA,SD,2001.0,1,1,0
DZ,SA,2010.0,6,1,5
FR,VE,2015.0,5,13,-8
CZ,BR,2020.0,5,9,-4
IQ,IS,2021.0,1,1,0
GR,FR,2000.0,12,22,-10
JP,IQ,2017.0,3,6,-3
IE,TW,2012.0,3,2,1
IQ,SY,2022.0,3,5,-2
LA,FR,2020.0,1,4,-3
CR,SE,2003.0,3,1,2
SN,US,2010.0,10,9,1
GR,FI,2010.0,5,4,1
MY,JO,2009.0,7,2,5
PA,AR,2015.0,3,9,-6
US,MW,1997.0,3,1,2
PK,AT,2009.0,7,11,-4
IE,HR,1998.0,1,1,0
HU,NL,2007.0,6,10,-4
KW,GB,2009.0,3,12,-9
TR,KZ,2003.0,7,4,3
SI,ES,2004.0,7,6,1
SE,JO,2016.0,4,1,3
HR,BE,2012.0,1,1,0
BA,EG,2018.0,1,2,-1
PH,NL,2017.0,10,3,7
IL,SA,2019.0,3,2,1
MQ,GF,2020.0,3,1,2
JO,SA,2005.0,5,4,1
BE,CW,2006.0,2,1,1
ES,MY,2023.0,1,2,-1
HU,IN,2021.0,9,9,0
SG,DZ,2019.0,9,1,8
GR,NZ,2017.0,3,1,2
ET,CH,2013.0,2,1,1
DZ,AE,2016.0,1,2,-1
DE,UG,1998.0,1,1,0
PH,CR,2022.0,2,1,1
ES,TW,2016.0,5,4,1
SN,ES,2018.0,3,1,2
JP,ET,2021.0,3,1,2
HU,CU,2002.0,1,2,-1
CA,RS,2021.0,9,3,6
CA,BG,2002.0,3,4,-1
ES,QA,2022.0,3,2,1
ZA,nan,2017.0,5,7,-2
DE,LV,2014.0,2,2,0
DE,ML,2015.0,3,2,1
PA,CR,2017.0,2,1,1
IR,FI,2009.0,2,3,-1
AZ,GE,2010.0,7,1,6
NL,AT,2005.0,18,11,7
TR,IE,2013.0,2,2,0
ES,PS,2005.0,4,2,2
GB,CU,2002.0,2,1,1
CL,VE,2017.0,12,40,-28
BA,TR,2016.0,4,6,-2
MY,BH,2016.0,3,2,1
US,RE,2012.0,4,2,2
IN,NG,2006.0,2,9,-7
VE,FR,2007.0,5,6,-1
PL,HU,1998.0,4,4,0
SG,FI,2017.0,1,5,-4
KZ,UA,2002.0,1,1,0
AT,EE,2013.0,2,3,-1
FI,RO,2018.0,3,1,2
RS,JP,2015.0,2,3,-1
UA,NL,2007.0,6,2,4
SY,FR,2013.0,7,12,-5
AT,XK,2018.0,2,3,-1
CL,GB,1998.0,4,5,-1
DK,IS,1998.0,2,2,0
BG,RU,1997.0,3,4,-1
LY,MY,2016.0,5,6,-1
NG,TR,2022.0,5,2,3
AE,TN,2019.0,3,9,-6
CH,LU,1999.0,1,1,0
UY,GB,2020.0,5,1,4
ZA,AR,2020.0,3,2,1
EE,CA,2017.0,4,1,3
CH,KW,2009.0,1,1,0
PE,AU,2022.0,3,1,2
US,MC,2012.0,1,1,0
MW,DE,2006.0,1,1,0
NG,CG,2016.0,1,2,-1
US,FJ,2013.0,2,6,-4
JP,UA,2007.0,2,7,-5
BO,CO,2014.0,7,10,-3
BE,TZ,2014.0,4,1,3
PL,TR,2008.0,1,1,0
ES,CY,2016.0,3,1,2
RU,AM,2011.0,7,5,2
GR,TW,2018.0,1,2,-1
BH,AU,2009.0,2,1,1
DE,GA,2014.0,9,1,8
IL,AT,2004.0,4,4,0
FI,SK,2006.0,2,18,-16
GR,FI,2019.0,4,10,-6
nan,SA,2015.0,5,2,3
NO,AU,2006.0,8,9,-1
EG,CZ,2021.0,2,10,-8
AR,JP,1999.0,1,4,-3
NG,NP,2016.0,1,1,0
MD,US,2020.0,2,4,-2
GB,CR,2005.0,2,4,-2
BH,MY,2013.0,3,1,2
RU,IN,1997.0,3,5,-2
nan,ZM,2021.0,2,1,1
DO,BR,2018.0,3,5,-2
NL,HK,2000.0,4,7,-3
PA,GB,2008.0,1,1,0
NL,AE,2018.0,4,3,1
PL,NZ,2021.0,3,2,1
CN,MM,2013.0,2,4,-2
TH,IR,2015.0,2,5,-3
CN,TR,1999.0,4,2,2
US,TN,2002.0,2,3,-1
SY,DE,2020.0,3,1,2
DE,PH,2001.0,2,4,-2
UA,KZ,2016.0,4,5,-1
RS,NL,2017.0,6,10,-4
PA,CR,2019.0,1,4,-3
AU,BN,2001.0,2,2,0
FR,LT,2001.0,1,1,0
JP,EC,2001.0,1,1,0
NG,GH,2010.0,2,6,-4
ML,CN,2018.0,1,2,-1
ET,SE,2009.0,3,7,-4
MX,EC,2004.0,1,3,-2
MM,SG,2014.0,2,2,0
GE,CN,2005.0,2,3,-1
GB,TH,2023.0,2,1,1
GB,UY,2006.0,3,3,0
AU,NC,2019.0,1,1,0
BY,SI,2005.0,1,2,-1
LT,NL,2019.0,2,3,-1
JP,HK,2006.0,3,10,-7
PT,IL,2009.0,3,2,1
AE,DK,2013.0,1,1,0
JP,VN,2000.0,7,4,3
LV,EE,2012.0,1,1,0
BD,TW,2016.0,2,1,1
ML,CH,2009.0,1,1,0
SD,ZA,2016.0,2,4,-2
JP,UZ,2016.0,1,1,0
JP,ZM,2014.0,4,1,3
CY,SE,2020.0,3,1,2
LT,BE,2006.0,2,1,1
FI,SG,2004.0,2,2,0
LY,GB,2003.0,2,2,0
QA,PH,2020.0,1,1,0
AE,AU,2010.0,5,5,0
PL,RS,2012.0,1,3,-2
IR,KR,2007.0,2,2,0
GB,CU,2005.0,2,2,0
US,CI,2002.0,1,1,0
TT,US,2000.0,2,2,0
EC,BE,2010.0,2,7,-5
UA,PL,1998.0,7,5,2
AE,TN,2017.0,1,4,-3
RO,DK,2013.0,2,3,-1
IR,EE,2011.0,1,1,0
BG,FI,2001.0,3,1,2
SE,QA,2012.0,1,1,0
nan,VE,2013.0,1,6,-5
EG,IE,2013.0,3,5,-2
BE,BD,2010.0,3,2,1
BR,ZA,2003.0,5,3,2
HU,KR,2020.0,1,1,0
PL,HU,1997.0,2,5,-3
AE,JO,2001.0,2,2,0
CO,HU,2022.0,2,1,1
DZ,BE,2008.0,1,1,0
GP,JM,2021.0,1,1,0
AU,EE,2014.0,2,2,0
RU,MD,2015.0,2,3,-1
FI,NZ,2021.0,3,2,1
US,CM,2007.0,3,6,-3
CY,ES,2016.0,1,3,-2
SG,ID,2000.0,1,4,-3
SN,CI,2005.0,1,1,0
DE,GM,2020.0,2,1,1
DK,KR,2011.0,2,4,-2
OM,AE,2022.0,3,3,0
DE,CM,2003.0,3,4,-1
QA,US,1998.0,2,6,-4
KG,RU,1999.0,1,1,0
LB,CA,2006.0,6,3,3
IR,ET,2014.0,1,1,0
IQ,SD,2018.0,3,7,-4
EC,HN,2020.0,1,3,-2
PS,JP,2006.0,1,1,0
EE,LV,2012.0,1,1,0
ET,ZA,2006.0,1,1,0
AM,IT,2000.0,2,4,-2
IN,MN,2010.0,1,1,0
FI,TW,2022.0,2,1,1
LA,US,2016.0,2,5,-3
IL,AR,2003.0,1,3,-2
TW,MN,2011.0,1,1,0
CO,IN,2022.0,2,6,-4
RW,CN,2017.0,1,3,-2
PH,NL,2019.0,3,4,-1
IN,EG,2001.0,2,2,0
DE,LY,2020.0,2,1,1
US,LY,2022.0,3,1,2
BH,FR,2014.0,1,1,0
CY,NL,2015.0,1,4,-3
TZ,IL,2018.0,1,1,0
AR,IL,2005.0,3,2,1
KZ,US,2009.0,2,3,-1
MM,KH,2021.0,1,1,0
IE,SI,2005.0,1,1,0
MU,CH,2018.0,2,1,1
TR,BG,2013.0,3,1,2
BR,ZM,2010.0,2,3,-1
AM,FR,1997.0,1,2,-1
EE,FI,2000.0,4,3,1
LT,NL,2010.0,3,2,1
KH,FR,2022.0,1,5,-4
SA,GR,2019.0,1,10,-9
SG,QA,2022.0,1,3,-2
CI,BJ,2014.0,3,2,1
SG,NZ,2004.0,5,3,2
FR,AM,2012.0,4,1,3
SG,BD,2012.0,3,3,0
BY,PT,2009.0,2,2,0
BR,EG,2009.0,1,1,0
CA,CU,2002.0,1,1,0
IL,SE,2012.0,7,6,1
TR,MX,2006.0,2,4,-2
CA,NG,2001.0,1,1,0
FR,BZ,2006.0,2,7,-5
BG,nan,2020.0,2,1,1
BH,CA,2013.0,2,4,-2
IL,BD,2013.0,2,4,-2
LV,SE,2014.0,4,6,-2
KR,GE,2014.0,2,3,-1
CO,CN,2016.0,5,4,1
PL,EG,2018.0,4,3,1
HR,NL,2011.0,5,4,1
IN,SI,2004.0,2,1,1
nan,HU,2016.0,4,6,-2
MT,US,2002.0,2,1,1
ML,GH,2020.0,1,2,-1
FR,BY,2014.0,1,2,-1
VE,DE,2000.0,1,1,0
KR,SK,2010.0,1,3,-2
MN,AE,2012.0,1,2,-1
PE,DK,2017.0,1,2,-1
CI,BF,2021.0,2,6,-4
MX,ZW,2019.0,2,1,1
MD,CA,2012.0,1,2,-1
FI,VN,2016.0,2,1,1
JP,US,2009.0,1812,1943,-131
CO,MX,2003.0,44,55,-11
IE,DE,2003.0,23,43,-20
CH,US,2008.0,595,713,-118
BR,CO,2018.0,216,237,-21
GB,NO,2002.0,29,29,0
CL,ES,2001.0,78,87,-9
US,GR,2007.0,175,139,36
nan,CN,2007.0,238,146,92
BD,CN,2020.0,54,39,15
CO,EC,2018.0,196,91,105
IT,TN,2017.0,15,23,-8
DE,AT,2005.0,346,280,66
BE,US,1997.0,106,101,5
US,MX,1997.0,98,82,16
CN,NL,1997.0,15,9,6
JP,TW,2013.0,79,59,20
CA,BR,2000.0,70,81,-11
AT,AU,2003.0,20,13,7
SA,CA,2014.0,55,118,-63
JP,NG,2017.0,13,24,-11
IN,IE,2012.0,21,21,0
BE,US,1998.0,125,100,25
VE,ES,2016.0,88,63,25
IN,GB,1997.0,70,57,13
IN,CL,2022.0,4,3,1
US,VE,2013.0,25,45,-20
UA,US,2002.0,37,19,18
BD,PK,2014.0,39,26,13
DZ,CA,2016.0,11,12,-1
CA,TW,2004.0,31,26,5
ES,IE,2021.0,34,35,-1
JP,ID,2001.0,29,13,16
nan,JP,2015.0,43,59,-16
US,GH,2017.0,70,43,27
NL,IN,2022.0,22,35,-13
CZ,SK,2018.0,140,134,6
CH,CZ,2002.0,15,20,-5
DO,CO,2012.0,4,5,-1
HU,IL,2003.0,3,3,0
IN,SA,2009.0,25,13,12
GB,BD,2016.0,63,48,15
ES,IR,2011.0,9,6,3
NL,PK,2018.0,11,6,5
IE,IT,2021.0,31,36,-5
IR,IT,2022.0,52,16,36
IS,DE,2022.0,2,2,0
nan,GH,2022.0,2,2,0
IN,nan,2017.0,76,77,-1
NC,FR,2018.0,14,26,-12
US,ET,2012.0,19,34,-15
SE,NO,2010.0,118,66,52
nan,ZA,2022.0,4,2,2
AE,AU,2017.0,18,19,-1
SE,TZ,2017.0,6,1,5
IQ,CN,2015.0,2,7,-5
AR,GB,2010.0,23,20,3
TR,BR,2009.0,47,13,34
NG,CN,2019.0,44,30,14
NZ,IN,2018.0,41,53,-12
US,LU,2022.0,12,10,2
BE,BD,2019.0,2,4,-2
PL,BG,2016.0,2,4,-2
UA,US,2005.0,46,32,14
CL,NL,2016.0,12,11,1
JP,BD,2004.0,24,23,1
DE,SK,2006.0,25,30,-5
IT,DK,2004.0,14,11,3
RU,MX,2001.0,15,6,9
CR,MX,2000.0,6,1,5
PT,AO,2017.0,3,7,-4
NG,JP,2014.0,12,15,-3
BE,SK,2016.0,3,5,-2
KE,DE,2016.0,11,16,-5
KE,UG,2014.0,13,11,2
CL,PL,2014.0,2,3,-1
SD,OM,2016.0,1,1,0
BR,CH,2003.0,12,13,-1
PK,BR,2012.0,6,8,-2
TH,IN,2005.0,2,2,0
SA,JO,2023.0,2,1,1
IT,AR,2023.0,2,1,1
AL,IT,2019.0,5,8,-3
MA,MD,2006.0,2,7,-5
TN,AE,2013.0,4,3,1
AE,ID,2017.0,5,1,4
FR,HU,2022.0,8,9,-1
CA,HK,2016.0,4,4,0
SG,IL,2020.0,8,4,4
MY,TR,2014.0,5,17,-12
TH,DE,2004.0,8,11,-3
BZ,GB,2011.0,1,1,0
IR,PK,2009.0,4,6,-2
SA,AE,2012.0,10,14,-4
CN,HK,2005.0,14,9,5
SG,PH,2022.0,3,7,-4
BE,BD,2017.0,4,5,-1
nan,CH,2015.0,11,23,-12
FI,DK,2008.0,16,9,7
DE,TW,2010.0,16,23,-7
ET,NO,2007.0,2,2,0
US,EE,2021.0,13,13,0
GM,US,2013.0,1,2,-1
SK,JP,1999.0,7,10,-3
MX,AT,2018.0,9,5,4
IR,IE,2013.0,4,2,2
DK,CZ,2008.0,4,2,2
PY,AR,2010.0,5,3,2
AE,IN,2014.0,18,50,-32
RU,TR,2015.0,2,5,-3
LU,US,2001.0,2,3,-1
MA,SA,2014.0,3,3,0
MA,EG,2011.0,3,3,0
UA,EE,2013.0,2,1,1
CN,nan,2023.0,11,2,9
SE,NZ,2003.0,4,3,1
IE,MX,2018.0,5,6,-1
ET,FR,2009.0,2,2,0
CH,SN,2020.0,9,2,7
DO,CH,2018.0,1,1,0
HK,AU,2022.0,3,4,-1
SI,FR,2012.0,9,26,-17
UA,BG,2005.0,5,5,0
BG,DK,2022.0,2,2,0
HU,EE,2011.0,2,1,1
EE,ES,2015.0,1,3,-2
PE,DK,2019.0,1,1,0
PK,CG,2015.0,1,3,-2
KE,CA,2007.0,2,5,-3
CR,VE,2019.0,2,5,-3
AR,PH,2018.0,3,3,0
AZ,IT,2012.0,2,2,0
TH,PH,2014.0,4,1,3
ET,BR,2017.0,1,4,-3
NL,PA,2017.0,2,3,-1
PT,IE,2011.0,2,6,-4
KW,PK,2006.0,3,2,1
FI,IN,2008.0,4,5,-1
CA,DZ,2012.0,8,6,2
CZ,AT,2008.0,9,16,-7
CN,HK,2002.0,3,2,1
AE,ID,2019.0,8,8,0
JO,SA,2002.0,5,5,0
DE,MT,2016.0,2,1,1
GT,CR,2012.0,2,1,1
NZ,TW,2007.0,2,4,-2
CM,BE,2013.0,2,3,-1
IL,DK,2015.0,3,4,-1
AR,UY,2001.0,4,2,2
BH,NG,2018.0,3,5,-2
KH,CY,2022.0,1,2,-1
TN,OM,2011.0,1,1,0
LT,ES,2009.0,2,1,1
RW,IN,2012.0,6,7,-1
SE,NG,2021.0,1,4,-3
DK,TR,2007.0,1,2,-1
CN,SK,2015.0,1,2,-1
KE,SE,2014.0,4,3,1
IE,FI,2017.0,4,4,0
TH,ID,2008.0,1,2,-1
ZA,RS,2009.0,2,1,1
PL,SI,2021.0,4,2,2
GH,AU,2010.0,1,3,-2
MY,KE,2013.0,1,1,0
PK,IN,2013.0,195,154,41
MX,FR,2001.0,22,32,-10
AU,MY,2020.0,96,106,-10
CH,CA,2009.0,110,98,12
EG,CA,2017.0,65,111,-46
ES,CO,2006.0,180,146,34
NO,CA,2008.0,14,14,0
CA,OM,2020.0,8,9,-1
ZA,IE,2008.0,5,3,2
PY,AR,2017.0,5,15,-10
SK,HU,2019.0,12,17,-5
AE,OM,2004.0,2,1,1
LV,LT,2018.0,2,3,-1
,TR,2003.0,5107,0,5107
FR,,2010.0,7459,0,7459
DE,,2020.0,22937,0,22937
BR,,2022.0,45678,0,45678
,SG,2000.0,920,0,920
NZ,,2023.0,4931,0,4931
,PT,2009.0,1922,0,1922
,NO,2004.0,1676,0,1676
,AT,1995.0,2745,0,2745
MX,,2018.0,3910,0,3910
TR,,2024.0,51299,0,51299
,RU,2002.0,6388,0,6388
FR,,2019.0,17026,0,17026
AG,,2023.0,384,0,384
PL,,2022.0,12342,0,12342
NO,,2019.0,1922,0,1922
,CA,2016.0,9864,0,9864
,RU,2005.0,8791,0,8791
ZA,,2023.0,9519,0,9519
,CZ,2004.0,1847,0,1847
TW,,2018.0,3952,0,3952
FR,,2017.0,13056,0,13056
,IT,2013.0,12029,0,12029
,ZA,2001.0,1152,0,1152
IE,,2016.0,935,0,935
,CO,2008.0,2131,0,2131
,ID,2011.0,7397,0,7397
NO,,2010.0,687,0,687
,EG,1994.0,2040,0,2040
CL,,2018.0,1535,0,1535
,CU,1996.0,342,0,342
,MX,2006.0,4016,0,4016
,CU,2004.0,413,0,413
,IL,2011.0,2468,0,2468
,PL,2016.0,5439,0,5439
IL,,2014.0,1365,0,1365
PT,,2002.0,144,0,144
,RO,2000.0,577,0,577
,ET,1994.0,232,0,232
NG,,2022.0,5676,0,5676
NO,,2017.0,1426,0,1426
,IE,2013.0,1417,0,1417
SD,,2024.0,522,0,522
GD,,2024.0,77,0,77
,TH,2015.0,2644,0,2644
,nan,2013.0,874,0,874
PT,,2005.0,162,0,162
,NO,1996.0,1662,0,1662
,HR,2005.0,945,0,945
CN,,2001.0,1048,0,1048
,HR,2002.0,646,0,646
HR,,2016.0,471,0,471
,GT,1994.0,21,0,21
WS,,2015.0,2,0,2
CH,,2004.0,1182,0,1182
,AU,2014.0,7235,0,7235
BD,,2011.0,119,0,119
,BY,2006.0,259,0,259
,JO,1994.0,280,0,280
AE,QA,2007.0,3,0,3
TH,CH,2002.0,2,0,2
UA,,2004.0,411,0,411
,SK,1999.0,429,0,429
,CZ,1996.0,1331,0,1331
QA,,2015.0,84,0,84
JO,,2003.0,32,0,32
VN,nan,2004.0,1,0,1
AE,,2003.0,35,0,35
,BD,1995.0,180,0,180
SD,TR,2007.0,1,0,1
TR,IQ,2008.0,1,0,1
,LB,2002.0,193,0,193
,AZ,2009.0,174,0,174
,KE,2003.0,228,0,228
KW,,2002.0,41,0,41
,CY,2016.0,249,0,249
,SS,2013.0,6,0,6
,VE,2016.0,172,0,172
CD,,2022.0,253,0,253
,UY,2015.0,288,0,288
SG,,2001.0,184,0,184
GT,,2020.0,61,0,61
AZ,,2016.0,95,0,95
,KW,2009.0,149,0,149
NO,IL,2022.0,3,0,3
EE,SG,2016.0,1,0,1
PH,,2007.0,99,0,99
,EC,2007.0,140,0,140
,BF,2014.0,120,0,120
,BE,2020.0,155,0,155
NP,DE,2013.0,1,0,1
MU,,2021.0,38,0,38
GR,HU,2022.0,1,0,1
,LB,2005.0,248,0,248
RE,,2014.0,20,0,20
,MN,1996.0,10,0,10
,TZ,2012.0,297,0,297
VU,,2024.0,10,0,10
GM,,2024.0,139,0,139
MG,FI,2019.0,1,0,1
BJ,,2014.0,16,0,16
MW,US,1999.0,4,0,4
,NE,1994.0,13,0,13
,GP,2006.0,11,0,11
SV,QA,2000.0,1,0,1
OM,,2014.0,63,0,63
BO,NL,2019.0,1,0,1
ID,,2026.0,7,0,7
BA,PA,2022.0,1,0,1
,TT,2009.0,40,0,40
AM,TW,2006.0,4,0,4
,MD,2017.0,85,0,85
GB,SY,2009.0,5,0,5
KE,DK,2021.0,4,0,4
,PS,2004.0,50,0,50
AM,KR,2010.0,9,0,9
VN,CH,2022.0,3,0,3
UA,PE,2017.0,1,0,1
,KH,2016.0,60,0,60
VN,CA,1998.0,1,0,1
,GD,2008.0,15,0,15
US,SX,2003.0,1,0,1
,BB,2014.0,7,0,7
,MD,2010.0,88,0,88
RS,,2004.0,52,0,52
ET,TH,2021.0,1,0,1
NA,,2024.0,197,0,197
,MD,2019.0,70,0,70
,ZW,2016.0,163,0,163
GH,,2008.0,52,0,52
ID,SK,2018.0,2,0,2
TZ,ZW,2005.0,1,0,1
PG,,2007.0,2,0,2
,UG,1999.0,74,0,74
,AL,2000.0,24,0,24
DZ,,2009.0,72,0,72
ZW,,2015.0,55,0,55
TZ,UG,1998.0,1,0,1
AT,CR,1997.0,1,0,1
,DO,2014.0,22,0,22
,MK,2001.0,37,0,37
,BJ,2007.0,60,0,60
MV,,2022.0,10,0,10
,ST,2012.0,11,0,11
HK,NZ,2014.0,1,0,1
,GN,2014.0,29,0,29
KR,PT,2022.0,2,0,2
NL,GH,2005.0,1,0,1
SZ,,2021.0,16,0,16
MD,,2003.0,17,0,17
,NI,2006.0,27,0,27
PT,JM,2008.0,1,0,1
JP,PG,2007.0,1,0,1
ZM,ET,2011.0,1,0,1
NL,QA,2013.0,4,0,4
,KG,2001.0,9,0,9
VG,,2023.0,40,0,40
SE,PS,2021.0,3,0,3
IL,ET,2022.0,1,0,1
,SZ,2018.0,16,0,16
KW,,2005.0,48,0,48
BE,BY,1997.0,1,0,1
SZ,PH,2019.0,1,0,1
CN,EG,2000.0,3,0,3
GB,IQ,2002.0,1,0,1
CO,TR,2012.0,2,0,2
VG,IL,2008.0,2,0,2
,ER,2011.0,3,0,3
,CW,2003.0,13,0,13
BF,BJ,2013.0,1,0,1
,JE,2007.0,3,0,3
EE,BE,2013.0,2,0,2
,MT,1994.0,31,0,31
IR,LB,2012.0,1,0,1
GN,KH,2021.0,1,0,1
DK,BF,2016.0,1,0,1
ES,MW,2020.0,3,0,3
UZ,RS,2010.0,11,0,11
BD,EE,2019.0,2,0,2
NZ,FJ,2013.0,1,0,1
TH,NP,2005.0,2,0,2
TT,,2018.0,49,0,49
ET,VG,2015.0,1,0,1
SA,TH,2012.0,2,0,2
KR,TN,2022.0,1,0,1
AM,KR,2017.0,1,0,1
JP,CL,1998.0,2,0,2
BE,ML,2005.0,1,0,1
NP,,2004.0,14,0,14
GB,CR,2002.0,2,0,2
,MN,2004.0,32,0,32
SY,PK,2004.0,1,0,1
UG,CH,2017.0,6,0,6
ST,IE,2021.0,1,0,1
PK,ZW,2011.0,1,0,1
RS,BR,2000.0,2,0,2
YE,OM,2020.0,1,0,1
AM,UY,2017.0,1,0,1
NZ,EG,2012.0,2,0,2
GR,LK,2004.0,5,0,5
RO,GR,2004.0,3,0,3
RU,LK,2012.0,2,0,2
SN,NE,2015.0,1,0,1
IS,UG,2013.0,1,0,1
SN,BE,2008.0,4,0,4
CA,TZ,2015.0,4,0,4
,LY,1997.0,17,0,17
BF,,2011.0,18,0,18
,PS,1996.0,23,0,23
ID,IT,2008.0,1,0,1
TD,,2013.0,1,0,1
KW,AT,1999.0,1,0,1
,SM,2007.0,2,0,2
,NA,1995.0,8,0,8
MN,IN,2013.0,2,0,2
GT,VE,2002.0,2,0,2
NO,BI,2003.0,1,0,1
LI,DK,2008.0,1,0,1
GH,UG,2008.0,1,0,1
BE,HR,1999.0,1,0,1
UA,BR,2002.0,3,0,3
,FO,2008.0,5,0,5
LT,PK,2004.0,3,0,3
CG,ID,2021.0,1,0,1
US,BO,2023.0,2,0,2
IN,JM,2007.0,2,0,2
IR,KE,2010.0,1,0,1
RS,BE,2003.0,2,0,2
MM,EG,2021.0,1,0,1
CI,CO,2016.0,1,0,1
,GW,1998.0,4,0,4
CA,LU,2005.0,2,0,2
MZ,CH,2009.0,1,0,1
JO,GE,2010.0,1,0,1
BI,IT,2012.0,1,0,1
RS,KR,2004.0,1,0,1
PK,MM,2010.0,1,0,1
KE,CD,2011.0,1,0,1
NI,nan,2014.0,7,0,7
CN,LY,2009.0,1,0,1
,BS,2008.0,3,0,3
PG,ZA,2005.0,1,0,1
AT,BA,2000.0,1,0,1
IN,RW,2006.0,3,0,3
,LY,1998.0,24,0,24
nan,HT,2014.0,1,0,1
CN,CR,2014.0,10,0,10
HK,,2002.0,3,0,3
ID,EC,2020.0,2,0,2
,GW,1997.0,6,0,6
GB,TT,2003.0,4,0,4
PA,KR,2012.0,4,0,4
BE,FJ,2001.0,1,0,1
PT,AO,2010.0,2,0,2
PL,CO,2008.0,1,0,1
KR,LY,2011.0,1,0,1
CO,NG,2010.0,2,0,2
IQ,GH,2019.0,3,0,3
OM,IT,2015.0,3,0,3
SA,CN,2004.0,1,0,1
CH,SV,2017.0,1,0,1
EE,CA,2010.0,1,0,1
BD,CY,2015.0,1,0,1
IS,ZW,2021.0,1,0,1
AM,KR,2019.0,1,0,1
NL,RW,2021.0,3,0,3
CF,,2019.0,7,0,7
TH,AE,2016.0,1,0,1
MA,AE,2019.0,2,0,2
KZ,IT,2022.0,1,0,1
MO,BR,2015.0,2,0,2
VN,PE,2021.0,2,0,2
ZA,HR,1998.0,1,0,1
HU,TH,2022.0,1,0,1
JO,SG,2017.0,3,0,3
KR,NA,2009.0,1,0,1
TZ,,1998.0,8,0,8
AT,BY,2015.0,1,0,1
,ML,2001.0,20,0,20
MY,PE,2014.0,1,0,1
FI,ET,2015.0,2,0,2
SL,AU,2022.0,1,0,1
BE,BF,2012.0,1,0,1
PT,PY,2009.0,3,0,3
VE,LB,2019.0,1,0,1
MC,,2014.0,16,0,16
CF,CH,2013.0,1,0,1
MX,TZ,2021.0,1,0,1
AM,ZW,2008.0,1,0,1
ML,,2006.0,4,0,4
NP,AW,2017.0,1,0,1
MA,NZ,2010.0,1,0,1
IT,TZ,1998.0,1,0,1
SG,HR,2018.0,1,0,1
RO,DZ,2016.0,1,0,1
PS,,2006.0,5,0,5
CA,BI,2001.0,1,0,1
OM,IR,2012.0,3,0,3
,LR,2010.0,6,0,6
JP,CM,2005.0,2,0,2
JP,IQ,2019.0,5,0,5
TW,BN,2006.0,1,0,1
SI,AR,2009.0,1,0,1
CR,SV,1999.0,1,0,1
PL,TW,2001.0,4,0,4
CH,BA,2003.0,1,0,1
IL,RO,2018.0,3,0,3
MX,EE,2009.0,1,0,1
KR,EE,2016.0,1,0,1
UY,nan,2022.0,1,0,1
VN,CA,1997.0,1,0,1
CL,FI,2012.0,3,0,3
CF,,2017.0,9,0,9
CM,MA,2007.0,1,0,1
JO,AL,2014.0,1,0,1
LA,AU,2011.0,1,0,1
FR,ET,2008.0,1,0,1
CM,CZ,2017.0,1,0,1
VG,HU,2008.0,1,0,1
BY,BG,2014.0,2,0,2
GT,DE,2005.0,1,0,1
BR,FI,1997.0,1,0,1
DE,CW,2011.0,7,0,7
XK,ES,2018.0,1,0,1
GB,SD,1999.0,1,0,1
MK,HU,2019.0,1,0,1
NP,ZA,2020.0,5,0,5
DJ,FR,2017.0,1,0,1
IE,IS,2021.0,1,0,1
,TO,2009.0,1,0,1
US,BA,2002.0,1,0,1
XK,BA,2021.0,3,0,3
US,SR,2015.0,1,0,1
BY,KZ,1997.0,1,0,1
TH,MA,2014.0,1,0,1
MK,NO,2016.0,1,0,1
BD,NL,2002.0,2,0,2
GB,WS,2014.0,1,0,1
PK,PS,2000.0,1,0,1
BR,PL,1998.0,1,0,1
IR,KE,2019.0,2,0,2
IN,ZM,2018.0,3,0,3
OM,PL,2005.0,1,0,1
LA,VN,2006.0,1,0,1
HR,NZ,2015.0,1,0,1
ZM,FI,2015.0,4,0,4
RS,UA,2003.0,2,0,2
GE,MA,2020.0,1,0,1
FR,MW,2015.0,3,0,3
GH,GM,2009.0,1,0,1
DK,PH,2004.0,1,0,1
EG,IL,1999.0,1,0,1
SA,RW,2015.0,2,0,2
NP,BR,2000.0,1,0,1
TW,NG,2009.0,2,0,2
nan,IR,2007.0,6,0,6
nan,CO,2003.0,1,0,1
LU,CO,2009.0,1,0,1
CH,EG,1998.0,4,0,4
CY,SA,2014.0,2,0,2
EC,CH,1998.0,1,0,1
XK,RS,2001.0,2,0,2
CH,CR,1998.0,1,0,1
KZ,NL,2008.0,1,0,1
ZA,TW,2006.0,2,0,2
UZ,,1998.0,10,0,10
PE,CU,2000.0,1,0,1
MY,IL,2011.0,1,0,1
GP,GF,2020.0,4,0,4
LV,BG,2015.0,1,0,1
CO,LU,2002.0,1,0,1
AM,FI,2021.0,1,0,1
IS,FI,2022.0,1,0,1
MK,DE,2008.0,3,0,3
ML,BJ,2005.0,2,0,2
,AF,1994.0,3,0,3
VE,BE,2001.0,1,0,1
CH,KR,1997.0,2,0,2
SG,MM,2008.0,1,0,1
PH,UA,2007.0,1,0,1
IN,PH,2023.0,1,0,1
RU,KH,2019.0,1,0,1
PA,PL,2016.0,1,0,1
NL,SS,2022.0,1,0,1
LT,IT,2008.0,1,0,1
,LR,2017.0,8,0,8
VE,AM,2015.0,1,0,1
SD,DE,2012.0,2,0,2
MX,CZ,2011.0,4,0,4
CY,SD,2006.0,1,0,1
,LI,2006.0,7,0,7
BA,CL,2017.0,1,0,1
RE,NL,2002.0,1,0,1
IL,SA,2017.0,1,0,1
CA,AF,2007.0,1,0,1
IN,MA,2014.0,6,0,6
,FK,2004.0,1,0,1
,SL,1995.0,2,0,2
LK,OM,2004.0,1,0,1
KW,SK,2000.0,1,0,1
ET,BR,2010.0,1,0,1
TZ,IT,2021.0,1,0,1
QA,RW,2021.0,1,0,1
KR,UA,2021.0,1,0,1
PL,NP,2012.0,1,0,1
LB,GN,2018.0,1,0,1
,LA,1994.0,1,0,1
PH,DK,2013.0,2,0,2
OM,RU,2018.0,2,0,2
VN,UA,2009.0,2,0,2
MX,SK,2014.0,3,0,3
LU,CZ,2022.0,2,0,2
ZA,KR,2008.0,1,0,1
RO,SK,1999.0,1,0,1
IT,KW,2001.0,1,0,1
MZ,,2000.0,3,0,3
SK,KW,2014.0,1,0,1
PE,nan,2000.0,1,0,1
PL,KR,2011.0,2,0,2
ZA,SA,1997.0,3,0,3
DE,SC,2015.0,1,0,1
PH,SY,2010.0,1,0,1
HR,MX,2015.0,1,0,1
NG,FI,2011.0,1,0,1
AT,NP,2009.0,2,0,2
UY,AU,2000.0,1,0,1
UZ,RS,2017.0,1,0,1
TW,MW,2018.0,1,0,1
SJ,DK,2018.0,1,0,1
NE,NG,2013.0,1,0,1
VA,,2020.0,2,0,2
IM,,2023.0,3,0,3
NG,CY,2015.0,2,0,2
GR,SA,2011.0,2,0,2
CI,DE,2020.0,1,0,1
PT,AM,2021.0,1,0,1
,BZ,2014.0,1,0,1
BF,RO,2015.0,1,0,1
BE,BH,2018.0,1,0,1
ZM,KE,2022.0,1,0,1
CU,NO,2006.0,1,0,1
,TD,2008.0,1,0,1
CA,MK,2001.0,1,0,1
KE,ZW,2007.0,1,0,1
CN,SJ,2014.0,1,0,1
GE,CN,2002.0,1,0,1
EC,CN,2011.0,1,0,1
CD,ET,2015.0,2,0,2
GH,EG,2009.0,2,0,2
SY,ZA,2021.0,1,0,1
IR,RO,2020.0,3,0,3
GA,US,2012.0,2,0,2
AR,FI,2004.0,2,0,2
ZM,BE,2008.0,1,0,1
LU,CU,2005.0,1,0,1
MU,GB,2011.0,1,0,1
OM,ES,2012.0,2,0,2
HT,FR,2008.0,2,0,2
IS,FR,1999.0,2,0,2
BG,CZ,2009.0,2,0,2
KZ,CZ,1999.0,1,0,1
IR,KE,2017.0,1,0,1
UG,FI,2022.0,1,0,1
AT,HK,2012.0,1,0,1
FI,GR,2001.0,1,0,1
GR,CR,2014.0,1,0,1
PA,BR,2006.0,2,0,2
UY,ZA,2012.0,1,0,1
UA,PE,2019.0,1,0,1
ZW,MW,2021.0,1,0,1
BJ,SK,2001.0,1,0,1
CO,NG,2017.0,1,0,1
ZA,TT,2015.0,2,0,2
,LR,2019.0,3,0,3
FI,XK,2018.0,1,0,1
UZ,PL,2017.0,1,0,1
GB,LY,2001.0,1,0,1
MY,BE,2022.0,3,0,3
CR,IN,2017.0,1,0,1
AM,SE,2015.0,1,0,1
SA,NL,2008.0,1,0,1
UA,GR,2003.0,2,0,2
,BM,2009.0,1,0,1
US,SZ,2011.0,1,0,1
ID,ES,2023.0,1,0,1
CA,VN,1999.0,1,0,1
MM,DE,2008.0,1,0,1
LV,CH,2020.0,3,0,3
TH,CH,2005.0,1,0,1
NZ,HU,2021.0,1,0,1
CZ,CD,2015.0,1,0,1
DE,XK,2007.0,2,0,2
IR,CL,2013.0,1,0,1
TR,AR,2008.0,1,0,1
TN,BY,2019.0,1,0,1
SE,CL,1999.0,1,0,1
SE,NI,2015.0,2,0,2
SG,AR,2013.0,1,0,1
MY,ZM,2012.0,2,0,2
DE,SD,2021.0,1,0,1
CA,EE,2006.0,2,0,2
GH,MY,2015.0,1,0,1
NP,NO,2000.0,2,0,2
AU,LK,2003.0,1,0,1
GB,TN,2003.0,1,0,1
JP,PF,2003.0,1,0,1
TH,BR,2000.0,1,0,1
LV,CA,2015.0,3,0,3
JP,HR,2006.0,2,0,2
ET,DE,1997.0,2,0,2
TG,,2025.0,5,0,5
ID,EE,2015.0,1,0,1
ZA,BH,2019.0,2,0,2
CH,MY,2007.0,2,0,2
PA,,2006.0,8,0,8
CY,IL,2007.0,1,0,1
GF,CH,2004.0,1,0,1
PH,TZ,2016.0,1,0,1
LU,AT,2007.0,1,0,1
NP,NL,2000.0,1,0,1
IL,SK,2004.0,1,0,1
LB,NL,2007.0,1,0,1
DK,GE,2020.0,1,0,1
GB,GT,2001.0,1,0,1
LV,AU,2018.0,1,0,1
MK,JO,2018.0,1,0,1
AO,FI,2010.0,1,0,1
AM,AZ,2019.0,1,0,1
NL,BF,2012.0,1,0,1
JO,KH,2009.0,1,0,1
CH,MA,2000.0,1,0,1
RO,SG,2003.0,1,0,1
MC,GB,2005.0,1,0,1
CH,ET,2008.0,1,0,1
HU,LY,2009.0,1,0,1
IT,HR,1998.0,3,0,3
NL,GH,2002.0,3,0,3
MQ,,2002.0,5,0,5
IT,KH,2017.0,1,0,1
EG,BT,2019.0,1,0,1
MT,US,2005.0,1,0,1
BH,KW,2007.0,2,0,2
SS,US,1999.0,2,0,2
BW,ZA,1997.0,1,0,1
IN,PE,2000.0,2,0,2
BE,LV,2022.0,1,0,1
ID,RS,2020.0,2,0,2
KW,BH,2004.0,1,0,1
GT,RU,2008.0,1,0,1
XK,KE,2021.0,1,0,1
SK,IE,2007.0,2,0,2
HT,,2025.0,1,0,1
SE,AL,1998.0,1,0,1
UA,GE,2002.0,1,0,1
LA,CZ,2009.0,1,0,1
CH,MW,1999.0,1,0,1
SS,SA,2013.0,1,0,1
ZA,OM,2021.0,1,0,1
NI,DE,2021.0,1,0,1
PT,GE,2006.0,1,0,1
SI,EE,2018.0,1,0,1
DE,OM,2023.0,1,0,1
AF,KR,2022.0,3,0,3
CR,PT,2014.0,1,0,1
IL,NG,2007.0,2,0,2
RO,ML,2011.0,1,0,1
BH,IT,2010.0,2,0,2
BN,AU,1998.0,2,0,2
ID,SR,2019.0,2,0,2
NG,NO,2003.0,1,0,1
AM,MA,2014.0,3,0,3
CA,CR,2003.0,1,0,1
NO,IQ,2021.0,2,0,2
BA,nan,2022.0,1,0,1
RU,DZ,2009.0,1,0,1
BH,IR,2008.0,1,0,1
EG,BR,2022.0,2,0,2
DE,LI,1999.0,1,0,1
AR,RU,1997.0,1,0,1
AM,CH,1998.0,2,0,2
BO,PT,2018.0,1,0,1
AM,MX,2009.0,1,0,1
ET,BF,2020.0,1,0,1
JO,SG,2019.0,1,0,1
UZ,nan,2012.0,1,0,1
HU,CY,2009.0,1,0,1
GR,LT,2015.0,1,0,1
LB,IE,2021.0,1,0,1
SV,,2001.0,1,0,1
KN,,2005.0,1,0,1
PK,CZ,2011.0,2,0,2
NP,KR,2007.0,2,0,2
BJ,DE,1998.0,3,0,3
LI,,2000.0,1,0,1
ES,NZ,2001.0,1,0,1
IL,GE,2022.0,1,0,1
MN,TR,2017.0,1,0,1
UZ,ZA,2001.0,1,0,1
XK,PL,2020.0,1,0,1
CY,AM,2004.0,1,0,1
EE,NO,2004.0,2,0,2
LU,HT,2017.0,1,0,1
TG,CD,2015.0,1,0,1
SE,MD,2001.0,1,0,1
MM,AU,2011.0,1,0,1
CY,PT,2015.0,1,1,0
JP,EE,2015.0,2,2,0
IL,GR,2009.0,1,1,0
ME,CH,2014.0,2,1,1
PA,ES,1997.0,1,2,-1
CZ,MX,1999.0,1,1,0
FR,AO,2003.0,1,2,-1
NP,VN,2020.0,1,1,0
KZ,AU,2018.0,1,2,-1
TR,ID,2012.0,1,2,-1
AR,PA,2008.0,3,1,2
BH,ZA,2017.0,2,1,1
EC,MY,2020.0,1,2,-1
RW,CN,2019.0,3,6,-3
VN,IT,2009.0,2,1,1
ZA,GH,2004.0,1,2,-1
NZ,nan,2015.0,1,9,-8
CN,LT,2005.0,2,6,-4
GB,UZ,2015.0,3,4,-1
AT,CL,2014.0,3,2,1
SI,DK,2020.0,3,2,1
CA,MD,2011.0,1,3,-2
NO,MX,2015.0,3,5,-2
BG,ES,2003.0,3,1,2
DK,SG,2008.0,1,5,-4
LT,RU,2000.0,4,2,2
CH,NG,2013.0,4,2,2
NZ,AR,2018.0,2,1,1
LU,CH,2008.0,1,5,-4
MC,FR,2013.0,1,12,-11
NP,ZM,2016.0,1,1,0
KE,CM,2006.0,1,1,0
QA,DZ,2017.0,1,1,0
GH,NG,2012.0,3,1,2
PY,CU,2003.0,5,3,2
US,AF,2022.0,2,1,1
SA,KE,2014.0,1,2,-1
BO,EC,2015.0,3,2,1
JE,GB,2016.0,1,1,0
AL,GB,2011.0,1,1,0
PF,CA,2013.0,1,1,0
HN,EC,2017.0,2,2,0
PS,BR,2017.0,1,1,0
RU,ET,2020.0,3,1,2
BD,TN,2020.0,4,2,2
MA,CN,2015.0,2,1,1
PH,NL,2010.0,4,3,1
NG,BJ,2015.0,3,5,-2
TN,PK,2020.0,2,2,0
NL,CR,2015.0,2,4,-2
ZM,US,2000.0,1,2,-1
BE,CI,2004.0,2,1,1
FR,KE,2002.0,2,6,-4
LR,US,2015.0,2,3,-1
FR,VG,2003.0,2,1,1
TW,IT,2016.0,5,4,1
VE,nan,2003.0,1,2,-1
PA,PY,2019.0,1,1,0
ZM,DE,2018.0,1,3,-2
IS,CA,2014.0,2,2,0
HN,EC,2019.0,2,1,1
EC,BY,2016.0,2,2,0
UA,MD,2017.0,1,2,-1
BF,TG,2017.0,1,1,0
JP,VG,2017.0,2,1,1
NI,CL,2018.0,1,6,-5
PK,ZM,2011.0,1,1,0
MZ,UA,2009.0,2,2,0
ID,DK,2016.0,1,3,-2
nan,ZW,2020.0,1,1,0
IL,MA,2007.0,2,1,1
NL,EE,2009.0,2,1,1
CN,PG,2020.0,1,1,0
PS,CA,2018.0,2,5,-3
LU,RO,2019.0,1,1,0
CU,BE,2008.0,1,3,-2
NL,BJ,2018.0,2,2,0
IQ,YE,2008.0,1,1,0
GT,IT,2006.0,1,2,-1
ET,ES,2022.0,1,1,0
VN,MX,2000.0,3,1,2
ID,CA,2003.0,2,3,-1
BW,ZA,1998.0,1,1,0
CH,KR,1998.0,1,3,-2
BD,SG,2012.0,3,3,0
IS,AT,2009.0,1,1,0
IQ,FR,2022.0,2,3,-1
ZA,CO,2015.0,1,1,0
DE,MD,2016.0,1,3,-2
RU,CR,2011.0,1,1,0
NL,HR,2000.0,2,2,0
CL,CZ,2015.0,1,3,-2
AU,NO,2000.0,2,8,-6
UA,MZ,2001.0,1,1,0
FO,DK,2010.0,1,4,-3
NG,CH,2012.0,2,1,1
SN,ML,2004.0,1,1,0
CH,AE,2020.0,3,4,-1
MY,CO,2018.0,1,3,-2
IE,DZ,2020.0,1,1,0
CG,NG,2013.0,1,1,0
IL,NZ,2006.0,1,1,0
DE,BA,2013.0,1,6,-5
CM,ZA,2012.0,1,2,-1
GL,DK,2011.0,1,4,-3
MY,AR,1999.0,1,1,0
CZ,IL,2007.0,1,2,-1
MX,ZW,2010.0,1,2,-1
IT,RS,2000.0,1,3,-2
MY,SD,2007.0,1,2,-1
PE,SE,2015.0,1,3,-2
GB,LT,1997.0,1,3,-2
LB,PL,2020.0,1,1,0
QA,DZ,2019.0,1,1,0
GR,PT,2015.0,1,2,-1
RS,CL,2015.0,1,4,-3
BR,PH,2001.0,1,1,0
NO,LT,2014.0,1,1,0
KE,NP,2018.0,1,1,0
MK,RS,2016.0,2,5,-3
CA,NP,2003.0,2,1,1
MK,IN,2008.0,1,1,0
AE,ZA,2015.0,1,3,-2
CI,SN,2015.0,1,5,-4
LY,SD,2019.0,1,2,-1
TW,HU,2020.0,1,1,0
AU,VE,2010.0,1,2,-1
BE,UA,1999.0,1,3,-2
AU,EC,2005.0,1,1,0
UY,PY,2016.0,1,2,-1
DE,SY,2006.0,2,1,1
IE,SG,1999.0,2,1,1
RU,EG,2012.0,2,2,0
OM,MY,2010.0,2,1,1
CU,BO,2018.0,1,2,-1
SE,AR,2000.0,3,3,0
KW,HU,2001.0,1,1,0
EG,nan,2022.0,2,2,0
PK,LK,2000.0,1,1,0
HU,TW,2012.0,1,2,-1
IQ,HU,2016.0,2,1,1
NL,SA,2001.0,1,3,-2
UA,NO,2015.0,1,2,-1
MC,MG,2013.0,2,1,1
TN,TR,2021.0,1,2,-1
GB,GE,2022.0,1,4,-3
NC,GB,2016.0,1,2,-1
QA,LB,2022.0,1,8,-7
GB,IQ,2005.0,1,2,-1
PT,CR,2004.0,1,3,-2
US,AO,2004.0,1,1,0
LY,SD,2017.0,1,1,0
EE,nan,2012.0,1,1,0
CA,IQ,2009.0,1,2,-1
TR,AU,2000.0,1,3,-2
HR,FR,2009.0,1,2,-1
MC,RO,2017.0,1,1,0
CA,AL,2003.0,1,1,0
JP,QA,2018.0,1,5,-4
BY,nan,2022.0,1,1,0
PE,CA,2023.0,1,1,0
NP,AT,2019.0,1,1,0
SE,GE,2020.0,1,1,0
ES,PR,2018.0,1,1,0
US,PF,2004.0,1,1,0
AM,ES,2011.0,1,1,0
PS,OM,2020.0,1,1,0
BN,US,2016.0,1,6,-5
BE,RW,2001.0,1,1,0
CL,IN,2003.0,1,3,-2
DE,TJ,2015.0,1,1,0
NG,BH,2007.0,1,3,-2
BF,NE,2016.0,1,1,0
UA,MD,2010.0,1,4,-3
ES,NP,2015.0,1,1,0
PL,PT,2002.0,1,3,-2
LU,NZ,2014.0,1,1,0
UA,BR,2005.0,1,3,-2
AU,VG,2014.0,2,1,1
ZW,ZA,1998.0,1,1,0
CA,LU,2002.0,2,1,1
CD,CH,2016.0,1,1,0
RW,KR,2020.0,1,1,0
CO,DO,2009.0,1,1,0
SA,RO,2017.0,1,2,-1
SN,GN,2008.0,1,1,0
NO,AT,2023.0,1,2,-1
GB,MA,2002.0,1,2,-1
GR,BD,2004.0,1,0,1
NO,KG,2017.0,1,0,1
ZA,SA,1998.0,2,0,2
CH,MD,2007.0,1,0,1
HR,ID,2011.0,1,0,1
BW,BN,2013.0,1,0,1
GH,BW,2010.0,1,0,1
RW,US,1999.0,1,0,1
TL,PT,2018.0,1,0,1
ZA,DO,2021.0,1,0,1
AE,CL,2020.0,1,0,1
LA,GB,2004.0,1,0,1
LK,CZ,2006.0,1,0,1
PG,US,2022.0,3,0,3
BO,UY,2020.0,1,0,1
US,DZ,2023.0,2,0,2
IT,IS,2007.0,1,0,1
IR,BH,2016.0,1,0,1
UG,IS,2022.0,1,0,1
IL,BE,2023.0,1,0,1
CI,MA,2016.0,2,0,2
DE,GT,2007.0,1,0,1
SE,PH,1997.0,1,0,1
OM,TZ,2020.0,1,0,1
AT,MX,2004.0,1,0,1
MY,SY,2020.0,3,0,3
MU,BE,2004.0,1,0,1
MY,FJ,2013.0,1,0,1
SL,,2003.0,2,0,2
HK,,2005.0,2,0,2
TH,EC,2019.0,1,0,1
NL,UY,2023.0,1,0,1
LB,CY,2013.0,1,0,1
TN,SD,2016.0,2,0,2
KR,FJ,2020.0,1,0,1
GA,CG,2019.0,1,0,1
TH,NO,2012.0,1,0,1
AG,NL,2021.0,1,0,1
UA,TW,2009.0,1,0,1
GA,CG,2010.0,1,0,1
,TM,1994.0,1,0,1
IE,MA,2020.0,1,0,1
PK,LY,2015.0,2,0,2
SY,US,1998.0,3,0,3
SE,VE,2021.0,1,0,1
BD,PS,2022.0,2,0,2
US,AL,2009.0,2,0,2
AG,IT,2021.0,1,0,1
JP,MG,2017.0,1,0,1
IS,SK,2020.0,1,0,1
CF,,2010.0,1,0,1
SA,BD,1998.0,1,0,1
AU,NA,2014.0,2,0,2
AL,UZ,2006.0,1,0,1
DK,SK,2000.0,2,0,2
BE,PR,2014.0,1,0,1
RU,BI,2014.0,1,0,1
BE,SM,2013.0,1,0,1
HN,ET,2020.0,1,0,1
MK,FI,2015.0,1,0,1
BO,CR,2017.0,2,0,2
GE,PT,1998.0,1,0,1
LK,BR,2021.0,1,0,1
CO,PH,2008.0,1,0,1
AT,EC,2005.0,1,0,1
JP,VG,2010.0,1,0,1
NA,QA,2018.0,1,0,1
ET,AU,2023.0,1,0,1
CV,AO,2018.0,1,0,1
AM,KZ,2008.0,1,0,1
KZ,SK,2013.0,1,0,1
HN,VE,2000.0,2,0,2
PT,KZ,2020.0,1,0,1
PT,HR,2006.0,1,0,1
KW,KR,2006.0,1,0,1
ES,FJ,2015.0,1,0,1
IS,SJ,2020.0,1,0,1
GM,CH,2020.0,1,0,1
PS,CN,2004.0,1,0,1
IN,GE,2003.0,1,0,1
GE,DK,2007.0,1,0,1
GH,BW,2017.0,1,0,1
BR,LU,2006.0,1,0,1
PA,PY,2017.0,1,0,1
PK,JO,2002.0,1,0,1
MW,BN,1999.0,1,0,1
IN,VU,2020.0,1,0,1
PR,,2014.0,2,0,2
,EG,2021.0,1,0,1
SA,BD,1997.0,1,0,1
VE,IN,2013.0,1,0,1
AT,BH,2018.0,1,0,1
PS,HU,2018.0,1,0,1
NO,GL,2011.0,1,0,1
AU,GR,2023.0,2,0,2
TR,UZ,2009.0,1,0,1
IS,nan,2011.0,1,0,1
IN,MN,2017.0,1,0,1
NL,CO,2000.0,1,0,1
CU,SV,2016.0,2,0,2
BF,US,2015.0,1,0,1
MT,CN,1998.0,1,0,1
BE,SD,2009.0,1,0,1
IT,CR,2009.0,2,0,2
DE,TG,1998.0,1,0,1
BR,RS,2013.0,1,0,1
DZ,KE,2017.0,1,0,1
RU,MA,2019.0,1,0,1
MA,GB,2023.0,1,0,1
BO,GH,2017.0,1,0,1
CH,DO,1999.0,1,0,1
NO,BD,2002.0,1,0,1
RS,SA,2017.0,1,0,1
MD,IT,2000.0,1,0,1
RW,CN,2010.0,1,0,1
DZ,KE,2019.0,2,0,2
BR,ET,2012.0,1,0,1
MU,IN,2000.0,2,0,2
TR,MD,2005.0,1,0,1
LA,KW,2011.0,1,0,1
GR,SI,1999.0,1,0,1
AR,GE,2004.0,1,0,1
NL,PA,2019.0,1,0,1
SV,CA,2020.0,1,0,1
MM,CA,2001.0,1,0,1
FR,LV,2008.0,1,0,1
PL,FK,2002.0,1,0,1
CW,IN,2022.0,1,0,1
RO,CM,2016.0,1,0,1
KE,GE,2006.0,1,0,1
PS,MA,2021.0,2,0,2
GH,FR,2010.0,1,0,1
SK,PT,2004.0,1,0,1
MX,GE,2004.0,1,0,1
JP,LV,2021.0,2,0,2
NA,PK,2022.0,1,0,1
NC,PL,2015.0,1,0,1
ZA,EE,2012.0,1,0,1
MQ,GP,2012.0,2,0,2
ZA,SK,2020.0,1,0,1
CA,GP,2014.0,2,0,2
CO,CR,1999.0,1,0,1
BR,DZ,2011.0,1,0,1
SA,LB,2003.0,1,0,1
VE,SE,2007.0,1,0,1
MA,NE,2022.0,1,0,1
LB,AR,2012.0,1,0,1
ET,LB,2019.0,2,0,2
CA,SS,2007.0,1,0,1
MW,CY,2018.0,1,0,1
PK,SY,2021.0,1,0,1
LR,DE,2005.0,1,0,1
DZ,JO,2021.0,2,0,2
SK,GE,2001.0,1,0,1
MG,JE,2011.0,1,0,1
BY,CH,2014.0,1,0,1
GB,MR,2010.0,1,0,1
AT,BJ,2013.0,1,0,1
PK,CU,2012.0,1,0,1
NL,ZM,2007.0,1,0,1
AR,CD,2009.0,1,0,1
UG,MW,2015.0,1,0,1
RW,DK,2016.0,1,0,1
NL,VE,2021.0,1,0,1
ID,LV,2013.0,1,0,1
BY,NL,2001.0,1,0,1
BA,MK,2014.0,1,0,1
NG,HR,2017.0,1,0,1
GR,RS,2007.0,1,0,1
DO,BO,2020.0,1,0,1
CN,KG,2013.0,1,0,1
BR,AE,2011.0,1,0,1
KE,SY,2009.0,1,0,1
BD,LU,2013.0,1,0,1
JP,MG,2019.0,1,0,1
NC,EC,2015.0,1,0,1
EC,IT,1998.0,1,0,1
NZ,BD,2008.0,1,0,1
ZW,SZ,2008.0,1,0,1
NG,ER,2003.0,1,0,1
CW,,2000.0,1,0,1
PS,BR,2019.0,1,0,1
TH,MV,2017.0,1,0,1
GN,AR,2020.0,1,0,1
EC,IE,2018.0,1,0,1
BR,PY,2003.0,1,0,1
SE,ID,2001.0,1,0,1
BO,BD,2020.0,1,0,1
FJ,EE,2018.0,1,0,1
FR,BA,2014.0,1,0,1
AU,SY,2013.0,1,0,1
ZA,KN,2022.0,1,0,1
UG,SN,2019.0,1,0,1
BO,CN,2013.0,1,0,1
NZ,IR,2007.0,1,0,1
BN,CH,2008.0,1,0,1
CG,BR,2001.0,1,0,1
CD,CI,2018.0,1,0,1
KE,AR,2007.0,1,0,1
MA,ML,2016.0,1,0,1
AU,SS,2003.0,1,0,1
GB,DZ,2001.0,1,0,1
PG,NG,2018.0,1,0,1
SI,LT,2016.0,1,0,1
MX,RU,2023.0,1,0,1
GH,IN,2023.0,1,0,1
BB,GB,2022.0,1,0,1
MD,CI,2011.0,1,0,1
GR,ET,2020.0,1,0,1
CZ,HU,2023.0,1,0,1
IE,HR,1997.0,1,0,1
GB,US,2012.0,5658,5828,-170
IN,RU,2014.0,23,16,7
US,KR,2022.0,819,854,-35
CN,US,2002.0,3084,3701,-617
PE,IT,2009.0,4,4,0
US,DE,2016.0,2636,2508,128
FR,CA,2017.0,657,538,119
US,CO,2015.0,329,280,49
CZ,TW,2000.0,2,2,0
JP,GB,2008.0,321,276,45
US,GB,2001.0,3628,3585,43
DE,US,2018.0,2571,2790,-219
TW,US,2001.0,444,554,-110
TW,CN,2007.0,1114,591,523
US,AU,2011.0,2333,1961,372
LB,CN,2011.0,18,20,-2
KR,US,2018.0,1339,1345,-6
MX,AR,2003.0,46,42,4
BR,AU,2017.0,135,103,32
AU,GB,2006.0,911,1053,-142
AT,US,2014.0,246,263,-17
US,NL,2010.0,685,628,57
KR,CN,2015.0,281,288,-7
IT,US,2004.0,639,628,11
US,PH,2009.0,359,411,-52
US,JP,1999.0,1477,1561,-84
ES,BR,1997.0,57,40,17
BR,BE,2003.0,18,16,2
GB,FR,2021.0,429,399,30
PT,US,2018.0,187,200,-13
AR,ES,2022.0,176,180,-4
RU,JP,2016.0,53,67,-14
JP,CN,2000.0,313,268,45
ES,CH,1999.0,25,23,2
CA,GB,2014.0,884,927,-43
CA,CN,2020.0,698,494,204
AU,CA,2021.0,345,312,33
CU,CR,2007.0,6,4,2
BR,AU,2010.0,79,63,16
CN,TW,2020.0,889,1382,-493
FR,SA,2013.0,41,8,33
GB,DE,2020.0,982,920,62
FR,CN,2018.0,211,161,50
IT,SE,1997.0,25,45,-20
CL,UY,2015.0,10,18,-8
BR,CL,2003.0,25,17,8
CH,US,2013.0,745,923,-178
CU,CO,2015.0,48,22,26
US,JO,2005.0,47,17,30
FI,NL,2003.0,21,16,5
US,FR,2020.0,1302,1440,-138
AT,ES,2006.0,12,8,4
SK,CA,1998.0,2,3,-1
GB,ET,2007.0,4,3,1
CO,ES,2007.0,207,212,-5
GB,CA,1998.0,386,383,3
CN,CA,2014.0,453,555,-102
CA,IN,2022.0,123,161,-38
ES,DE,2001.0,72,79,-7
DE,EG,2008.0,49,28,21
CN,AU,2014.0,413,427,-14
ES,GB,2022.0,209,270,-61
GH,BH,2016.0,16,11,5
CL,DE,2005.0,18,28,-10
US,CL,2011.0,192,168,24
BR,CA,2015.0,262,351,-89
TW,KR,2017.0,53,47,6
AR,EC,2015.0,36,17,19
SE,ES,2017.0,64,105,-41
FR,MY,2022.0,13,7,6
ZA,US,2018.0,403,353,50
GR,GB,1999.0,53,59,-6
US,BR,2006.0,619,611,8
GR,ZA,2022.0,2,2,0
HU,IL,2001.0,5,1,4
FR,CZ,2011.0,45,29,16
PK,BN,2022.0,2,1,1
FR,NL,2021.0,131,95,36
IT,MA,2012.0,19,14,5
IN,FI,2021.0,36,19,17
GB,HU,2021.0,28,40,-12
IE,CA,2009.0,118,130,-12
FR,CA,2010.0,536,486,50
JP,IT,2005.0,41,60,-19
IT,GB,2022.0,342,379,-37
BB,JM,2010.0,6,7,-1
CL,EC,2019.0,88,92,-4
ES,PE,2012.0,110,70,40
CZ,UA,2022.0,13,11,2
SE,NL,1998.0,13,26,-13
ES,PT,2007.0,88,93,-5
CR,PT,2004.0,3,1,2
JP,TW,2008.0,67,49,18
EG,US,2016.0,226,277,-51
US,PT,2013.0,198,145,53
CN,NZ,2022.0,43,58,-15
KE,NG,2017.0,7,5,2
BR,ES,2006.0,195,173,22
US,EG,2011.0,218,122,96
BR,AU,2019.0,181,158,23
DK,US,2011.0,235,258,-23
BR,CO,2017.0,186,193,-7
US,NZ,2009.0,333,321,12
US,NL,2019.0,884,1002,-118
GR,BE,1997.0,3,5,-2
NZ,IN,2010.0,18,22,-4
BR,CO,2019.0,191,193,-2
BE,ES,2021.0,84,93,-9
VN,JP,2006.0,10,13,-3
FR,BE,2003.0,205,145,60
BE,HU,2008.0,7,6,1
IN,AU,2004.0,41,42,-1
IT,TR,2003.0,12,7,5
IT,TN,2018.0,20,25,-5
BR,DE,2001.0,42,51,-9
SE,GB,2016.0,207,212,-5
CL,ES,2003.0,125,94,31
FR,CA,2019.0,681,544,137
KR,AU,2003.0,16,14,2
AU,JP,1999.0,42,47,-5
US,IS,2021.0,19,9,10
US,NL,2017.0,767,851,-84
AU,nan,2014.0,27,45,-18
GB,CA,1997.0,277,322,-45
EG,CA,2018.0,79,77,2
HU,DE,2002.0,39,32,7
UY,CL,2007.0,9,5,4
IT,AU,2003.0,36,25,11
NZ,GB,2016.0,227,286,-59
US,JO,2002.0,21,6,15
NL,CH,2006.0,72,64,8
CZ,IT,2020.0,39,38,1
GB,MY,2002.0,38,9,29
CH,nan,2006.0,11,13,-2
IE,US,1999.0,169,202,-33
PH,ES,2022.0,12,14,-2
ST,BR,2020.0,32,23,9
CO,EC,2019.0,207,145,62
SK,CZ,2012.0,82,92,-10
TH,SG,2005.0,1,2,-1
ES,VE,2004.0,54,59,-5
TW,GB,2008.0,39,53,-14
SA,QA,2017.0,25,15,10
AR,CO,2015.0,105,112,-7
FI,SE,2008.0,75,78,-3
PK,OM,2016.0,13,8,5
SG,SE,2013.0,10,13,-3
CA,ZA,2015.0,43,45,-2
CA,ES,2011.0,70,76,-6
ZA,DE,2015.0,68,67,1
IT,DK,2014.0,51,27,24
CN,CH,2004.0,39,40,-1
SK,AT,2018.0,19,12,7
CN,GR,2010.0,31,19,12
CH,CN,2004.0,40,39,1
GB,CL,2006.0,31,15,16
FR,VN,2011.0,30,14,16
CN,nan,2000.0,13,13,0
US,EC,2016.0,85,34,51
DE,RU,2012.0,175,146,29
PL,US,2021.0,207,188,19
FR,LT,2003.0,4,2,2
KW,EG,2012.0,18,10,8
MT,GB,2019.0,23,25,-2
BR,AT,2013.0,13,17,-4
GB,BE,2015.0,166,149,17
EG,SA,2002.0,19,25,-6
SA,QA,2019.0,51,26,25
SI,CN,2009.0,4,1,3
nan,US,2003.0,143,148,-5
FR,GR,2003.0,27,21,6
CZ,SK,2017.0,157,137,20
TR,SE,2017.0,24,6,18
HU,GB,2018.0,65,49,16
IT,CZ,2016.0,33,26,7
FR,IL,2012.0,28,30,-2
JP,IT,2002.0,40,28,12
CN,GH,2019.0,30,27,3
TH,US,2008.0,96,175,-79
CU,CN,2015.0,2,1,1
NL,BE,2021.0,212,249,-37
MX,EC,2014.0,44,15,29
SE,BE,2016.0,36,24,12
ES,SE,2001.0,20,19,1
TH,ID,2013.0,5,4,1
IN,nan,2018.0,116,95,21
JP,FR,2012.0,123,105,18
BH,NG,2017.0,3,1,2
US,AR,2005.0,131,194,-63
LU,DE,2014.0,33,44,-11
JP,TH,2014.0,88,51,37
JP,LK,2015.0,39,18,21
IR,MY,2021.0,33,55,-22
BA,US,2021.0,8,2,6
JP,ID,2003.0,44,16,28
CY,US,2017.0,19,20,-1
HU,PT,2021.0,3,1,2
NZ,BE,2016.0,5,8,-3
AT,TR,2012.0,10,5,5
KE,DE,2022.0,8,2,6
LB,JO,2015.0,3,3,0
NG,GH,2018.0,23,18,5
NL,SE,2014.0,68,51,17
SE,TR,2017.0,6,24,-18
HR,AT,2020.0,9,6,3
RU,KZ,2018.0,93,76,17
DZ,TN,2019.0,31,39,-8
CH,SE,2003.0,21,27,-6
EC,BR,2007.0,3,2,1
MY,DK,2015.0,3,2,1
SG,NL,2013.0,16,13,3
TR,DK,2002.0,4,1,3
ZA,ZM,2020.0,16,8,8
IL,CA,2016.0,59,61,-2
MA,FR,1999.0,92,126,-34
RU,IR,2020.0,10,13,-3
IT,LU,2021.0,12,13,-1
IN,MY,2012.0,105,82,23
GB,DK,2000.0,56,54,2
CL,EC,2017.0,87,43,44
MX,CU,2011.0,45,53,-8
CO,EC,2017.0,163,73,90
FR,RE,2011.0,44,22,22
GB,SE,2011.0,177,161,16
PK,FI,2020.0,5,6,-1
US,SI,2011.0,26,14,12
CA,BH,2017.0,2,1,1
NG,ZA,2005.0,7,9,-2
TT,JM,2018.0,12,30,-18
ID,CN,2018.0,166,361,-195
ID,AU,2014.0,35,74,-39
FR,nan,2019.0,175,203,-28
FR,nan,2017.0,172,212,-40
IT,IN,2021.0,52,72,-20
DE,EC,2022.0,4,6,-2
FI,nan,2015.0,16,11,5
VN,EG,2019.0,3,2,1
EG,FR,2022.0,18,10,8
GB,GM,2020.0,12,8,4
CA,nan,1999.0,6,5,1
KW,AE,2021.0,7,1,6
GR,FI,2018.0,8,5,3
EG,LB,2022.0,14,16,-2
IT,RU,2018.0,71,55,16
CA,IT,2022.0,71,85,-14
DE,TW,2018.0,32,38,-6
MT,GB,2010.0,6,14,-8
CU,BR,2016.0,43,16,27
EC,CL,2016.0,27,76,-49
nan,BE,2011.0,23,26,-3
IN,QA,2021.0,32,21,11
LS,ZA,2021.0,2,8,-6
DK,ES,2020.0,42,64,-22
AU,AT,2017.0,31,39,-8
MY,EG,2017.0,56,37,19
UA,CO,2017.0,1,1,0
RO,HU,2021.0,30,41,-11
NL,IT,2000.0,41,51,-10
BE,BG,2015.0,7,2,5
NL,IL,2017.0,10,19,-9
GB,BD,2022.0,25,35,-10
AR,GB,2018.0,45,24,21
KE,CN,2019.0,13,20,-7
SE,NZ,2001.0,2,7,-5
NO,TR,2013.0,4,14,-10
IN,OM,2020.0,28,23,5
CA,CL,2009.0,13,16,-3
SG,TW,2016.0,38,63,-25
MX,DE,2016.0,49,38,11
GB,AT,2004.0,32,53,-21
MA,DE,2020.0,7,12,-5
LK,NL,2021.0,3,2,1
AE,CN,2019.0,6,14,-8
ZA,ET,2021.0,14,14,0
CO,US,1999.0,43,33,10
MX,FR,2003.0,20,35,-15
PA,GB,2013.0,8,1,7
AU,SG,2002.0,36,21,15
TR,BA,2022.0,1,2,-1
IT,SE,1998.0,45,61,-16
CL,CA,2021.0,28,21,7
CZ,SK,2019.0,142,190,-48
VN,EG,2017.0,4,5,-1
ES,AU,2009.0,31,30,1
DK,NL,2009.0,22,33,-11
EG,ET,2022.0,3,2,1
SE,NO,2018.0,95,93,2
NZ,LK,2022.0,2,1,1
TW,AU,2022.0,34,14,20
CN,GH,2017.0,15,26,-11
CO,GB,2023.0,1,2,-1
ID,DK,2022.0,2,5,-3
MY,BH,2022.0,2,2,0
LT,CN,2008.0,11,4,7
FR,BJ,2011.0,25,21,4
KR,MN,2021.0,11,1,10
GH,US,2013.0,16,36,-20
CL,AU,2021.0,24,20,4
JO,AU,2020.0,4,18,-14
IL,CZ,2021.0,1,4,-3
US,KZ,2022.0,6,13,-7
ZA,BE,1998.0,7,2,5
PK,US,2023.0,19,26,-7
FI,DE,2018.0,78,72,6
UA,RU,2014.0,296,229,67
DK,FR,2016.0,44,59,-15
US,TT,2022.0,7,10,-3
MX,AT,2017.0,9,3,6
IL,GB,2007.0,44,30,14
AE,NL,2007.0,1,1,0
GB,PT,2006.0,59,48,11
US,VE,2008.0,59,47,12
MK,US,2015.0,4,14,-10
IN,CH,2021.0,45,49,-4
ES,BR,1998.0,78,51,27
MD,JP,2000.0,1,1,0
AU,SA,2019.0,61,40,21
CN,SE,2003.0,30,72,-42
PL,IT,2021.0,38,36,2
DK,SE,2020.0,134,149,-15
IE,FI,2018.0,6,7,-1
NL,IL,2019.0,20,25,-5
TW,KR,2019.0,46,51,-5
IR,NO,2022.0,14,7,7
NO,SJ,2008.0,7,3,4
AU,SG,2005.0,43,55,-12
PK,EG,2021.0,20,21,-1
GB,LY,2003.0,2,2,0
SE,RU,2000.0,26,27,-1
GB,TR,2007.0,51,38,13
AT,FR,2011.0,40,49,-9
FR,CI,2009.0,16,16,0
AR,nan,2009.0,31,38,-7
GB,IS,2019.0,16,8,8
PH,NL,2018.0,4,9,-5
SE,ES,2019.0,60,98,-38
RU,MX,2003.0,10,6,4
JP,RO,2008.0,12,1,11
IN,SG,2000.0,18,9,9
EG,JP,2005.0,36,51,-15
RU,IT,1997.0,18,19,-1
EG,PL,2012.0,4,3,1
KR,NG,2015.0,10,11,-1
NG,TR,2016.0,3,3,0
RS,GB,2007.0,16,7,9
AU,TW,2005.0,20,11,9
US,AR,2002.0,122,137,-15
ZA,nan,2018.0,9,9,0
BY,FR,2015.0,2,2,0
IT,PL,2012.0,26,23,3
GH,CA,2011.0,1,2,-1
PL,CH,2009.0,22,17,5
CW,NL,2007.0,10,11,-1
nan,SE,2003.0,42,38,4
NP,NZ,2019.0,67,68,-1
PE,BR,2004.0,9,7,2
AU,AT,2010.0,21,26,-5
FR,FI,2014.0,24,30,-6
BR,CO,2010.0,85,57,28
NP,IL,2016.0,1,1,0
MA,AE,2018.0,3,1,2
PK,AR,2006.0,10,4,6
NC,FR,2019.0,23,10,13
PK,BD,2008.0,21,12,9
CN,PH,2020.0,24,22,2
EC,UA,2016.0,57,23,34
CH,EE,2011.0,7,6,1
BR,JO,2014.0,16,2,14
HU,JP,2021.0,16,5,11
JP,BD,2014.0,69,48,21
AU,DE,2007.0,147,153,-6
FR,SN,2002.0,15,7,8
JP,IR,2006.0,27,7,20
ZA,CA,1999.0,12,11,1
EG,NZ,2020.0,2,2,0
IE,CZ,2009.0,2,3,-1
CV,PT,2016.0,1,1,0
CA,FI,2015.0,22,20,2
SA,QA,2010.0,7,1,6
LT,US,2014.0,15,19,-4
IL,RU,2007.0,23,31,-8
DK,SA,2021.0,1,5,-4
BR,NZ,2016.0,8,8,0
NZ,DE,2008.0,29,41,-12
FR,OM,2016.0,4,1,3
AE,IR,2016.0,5,2,3
PS,QA,2019.0,2,3,-1
NZ,MY,2010.0,11,9,2
NO,GH,2014.0,2,1,1
NL,PK,2019.0,10,7,3
NZ,MY,2017.0,21,20,1
MX,PR,2015.0,7,2,5
GH,AU,2018.0,19,15,4
JP,FI,2010.0,15,11,4
US,QA,2014.0,63,57,6
EC,BE,2018.0,7,2,5
JP,RU,2009.0,58,26,32
CH,BE,1998.0,22,19,3
RU,EE,2018.0,10,11,-1
DE,AE,2020.0,13,12,1
TR,LA,2020.0,7,3,4
CH,ZW,2000.0,2,1,1
IL,FR,1997.0,14,20,-6
RU,RO,2011.0,3,2,1
BR,BJ,2006.0,2,2,0
AR,CL,2005.0,32,29,3
TW,CA,2003.0,28,31,-3
SA,CA,2004.0,12,16,-4
SA,NL,2013.0,4,8,-4
NG,CN,2018.0,24,19,5
MW,GB,2011.0,15,11,4
GB,CZ,2008.0,39,48,-9
AT,ID,2020.0,5,4,1
SA,US,1999.0,31,33,-2
NP,NZ,2017.0,43,37,6
MT,GB,2017.0,14,23,-9
MC,FR,2008.0,2,9,-7
DE,SA,2006.0,9,4,5
RO,GR,2014.0,3,4,-1
GB,SA,2002.0,18,18,0
RU,LV,2014.0,35,20,15
BI,FR,2018.0,25,21,4
UG,CH,2018.0,8,3,5
KW,SA,2002.0,2,1,1
MA,ES,2020.0,7,21,-14
FR,PT,2007.0,37,22,15
AU,AT,2019.0,37,24,13
ML,CI,2015.0,2,6,-4
SE,ES,2010.0,41,40,1
CH,MX,2007.0,6,3,3
UA,SE,2013.0,7,5,2
RU,EC,2016.0,5,8,-3
KW,US,2012.0,15,20,-5
AU,SA,2017.0,69,25,44
IQ,HU,2022.0,6,4,2
CA,QA,2020.0,18,12,6
AT,DK,2017.0,20,18,2
EG,IT,2021.0,9,11,-2
HR,CA,2009.0,5,2,3
JP,FI,2019.0,27,24,3
SE,TW,1997.0,1,3,-2
NP,US,2013.0,51,40,11
US,PE,2003.0,25,14,11
BH,ZA,2018.0,1,2,-1
CH,DK,2022.0,41,28,13
NL,NG,2018.0,7,7,0
IL,SA,2018.0,3,1,2
TW,MY,2022.0,33,14,19
IR,LY,2022.0,5,1,4
PT,PL,2020.0,9,6,3
NA,ZA,2002.0,1,1,0
CY,US,2019.0,19,24,-5
MY,EG,2019.0,66,38,28
nan,UA,2012.0,20,18,2
PT,MX,2022.0,10,6,4
PT,IT,2008.0,19,30,-11
GR,NL,2012.0,29,23,6
FR,ZA,2015.0,45,46,-1
IR,CY,2015.0,2,4,-2
BR,AO,2009.0,11,22,-11
MX,ZW,2018.0,2,1,1
TW,KR,2010.0,44,28,16
ZA,IE,2013.0,8,13,-5
AU,DK,2012.0,42,52,-10
AE,CN,2010.0,2,2,0
HR,PL,2019.0,6,9,-3
CO,ZA,2019.0,4,4,0
CD,US,2022.0,4,3,1
DZ,AE,2022.0,2,3,-1
NO,DK,2003.0,33,39,-6
NZ,MY,2019.0,12,21,-9
BE,DK,2014.0,54,35,19
CL,VE,2018.0,17,42,-25
BE,BD,2018.0,6,5,1
DE,PH,2003.0,6,4,2
DE,CZ,1998.0,20,19,1
FR,PL,1999.0,34,30,4
TR,SE,2019.0,35,16,19
GB,HR,2006.0,8,9,-1
NO,CH,2014.0,13,17,-4
JP,KH,2019.0,13,8,5
MK,AU,2014.0,66,45,21
GB,MU,2007.0,2,2,0
GR,BE,1998.0,4,7,-3
NO,CA,2013.0,26,24,2
GB,PL,2001.0,37,23,14
IR,IE,2008.0,3,2,1
SE,CZ,2016.0,13,19,-6
PH,DK,2008.0,4,1,3
ZA,MX,2012.0,2,1,1
HU,RO,2004.0,17,15,2
SG,PH,2016.0,15,7,8
DE,AR,2009.0,30,25,5
TR,PL,2020.0,7,4,3
CH,NZ,2012.0,11,12,-1
GB,MY,2005.0,52,33,19
JP,NL,2006.0,23,32,-9
NL,PK,2010.0,5,4,1
NO,ZA,2002.0,2,1,1
CZ,AT,2013.0,20,9,11
IT,ES,2001.0,71,68,3
CO,DE,1999.0,1,2,-1
KR,VN,2006.0,4,6,-2
BG,DE,2010.0,32,20,12
NC,FR,2010.0,14,15,-1
nan,CA,1997.0,3,1,2
GR,SY,2017.0,1,1,0
GB,LU,2012.0,12,4,8
RU,CZ,2014.0,38,41,-3
AE,US,2007.0,18,38,-20
HU,ES,2020.0,7,2,5
NG,JO,2012.0,1,1,0
GB,JO,2013.0,31,9,22
MX,PY,2015.0,8,6,2
SA,SD,2002.0,2,2,0
TR,KZ,2001.0,4,6,-2
AR,IT,1998.0,28,17,11
US,SY,2014.0,6,11,-5
SE,AT,2012.0,17,29,-12
RO,PL,2016.0,8,3,5
CA,HU,1997.0,5,3,2
GB,GE,2016.0,6,8,-2
HU,DE,2005.0,47,34,13
BO,AR,2011.0,3,1,2
IT,LB,2004.0,8,1,7
LU,CZ,2016.0,2,1,1
BG,ES,2001.0,8,3,5
AR,IT,1997.0,16,25,-9
HK,JP,2015.0,11,7,4
BR,ZA,2001.0,2,1,1
BE,AU,2006.0,24,17,7
CN,UA,2006.0,10,18,-8
MX,PT,2006.0,12,6,6
DE,SI,2012.0,13,13,0
DE,CZ,1997.0,8,8,0
IT,VE,1998.0,6,2,4
NL,PK,2017.0,12,7,5
SE,EG,2011.0,5,4,1
GB,EC,2016.0,13,10,3
JP,DK,2013.0,19,15,4
NP,NZ,2010.0,17,9,8
AR,AT,2012.0,3,1,2
GB,MT,2008.0,8,6,2
EC,PE,2015.0,8,31,-23
AT,PL,2014.0,17,12,5
US,AO,2014.0,3,2,1
PT,CH,2015.0,25,15,10
CL,SV,2015.0,5,4,1
EG,QA,2000.0,2,2,0
AE,ID,2018.0,6,1,5
SI,ES,2014.0,11,18,-7
nan,RU,1999.0,8,1,7
IR,DK,2016.0,27,6,21
GB,IS,2017.0,12,5,7
BR,IN,2004.0,17,17,0
CL,CH,2002.0,2,4,-2
AR,CH,2016.0,23,13,10
DK,AU,1999.0,15,8,7
FJ,NZ,2001.0,1,1,0
ML,IN,2017.0,10,2,8
DZ,TN,2017.0,18,27,-9
MY,FR,2008.0,9,8,1
AR,CL,2002.0,16,26,-10
RU,MY,2015.0,10,18,-8
BE,VN,2000.0,3,2,1
CA,AR,2021.0,21,26,-5
TH,KR,2007.0,6,2,4
BY,NL,2003.0,3,1,2
KR,TR,2014.0,8,3,5
IE,CN,2013.0,32,28,4
IT,GR,2003.0,8,11,-3
US,CR,1998.0,4,7,-3
ZA,KE,2009.0,10,6,4
DE,MY,2014.0,20,15,5
IT,UY,2019.0,8,6,2
GB,RE,2017.0,2,1,1
NL,KZ,2017.0,3,1,2
CA,CO,2016.0,20,25,-5
LV,LT,2019.0,2,2,0
GB,TH,2000.0,22,6,16
BR,CN,2008.0,35,34,1
KE,IN,2014.0,4,5,-1
NL,TR,2005.0,12,8,4
VE,CA,2002.0,5,3,2
NL,IL,2010.0,9,15,-6
CH,BE,1997.0,18,17,1
VN,CH,2016.0,2,4,-2
TH,CN,2006.0,7,8,-1
HU,RU,2018.0,10,28,-18
CN,PL,2013.0,40,28,12
SE,IE,2003.0,4,5,-1
IT,NO,2014.0,23,18,5
BD,PK,2004.0,2,5,-3
AL,IT,2018.0,7,8,-1
LK,CA,1999.0,3,1,2
ID,FR,2007.0,6,4,2
CR,VE,2018.0,6,9,-3
IR,CN,2006.0,7,16,-9
BE,AR,2008.0,6,6,0
CH,HR,2015.0,4,6,-2
SY,FR,2008.0,7,7,0
SA,SD,2005.0,3,1,2
GR,LK,2014.0,4,1,3
GR,FR,2023.0,2,1,1
ZA,BH,2018.0,2,1,1
CU,US,2001.0,14,9,5
LK,US,2016.0,25,38,-13
MY,TW,2021.0,17,22,-5
JP,PT,2011.0,6,5,1
IL,RO,2019.0,1,1,0
UG,KE,2006.0,4,2,2
CZ,KR,2008.0,11,2,9
CN,HU,2008.0,2,5,-3
IN,PL,2012.0,13,8,5
TW,nan,2006.0,8,3,5
CL,IT,2013.0,30,26,4
SE,NL,1997.0,15,16,-1
FI,FR,2006.0,11,17,-6
PK,NL,2017.0,7,12,-5
KR,SA,2013.0,13,4,9
KW,IN,2020.0,14,5,9
BD,IT,2015.0,10,9,1
PE,AU,2016.0,4,1,3
AU,QA,2005.0,6,4,2
TR,PK,2022.0,8,17,-9
KE,CN,2017.0,16,16,0
GR,CH,1997.0,1,3,-2
nan,GH,2016.0,3,5,-2
DZ,CA,2022.0,7,13,-6
RU,GE,2022.0,1,3,-2
KE,JP,2022.0,2,6,-4
US,LT,2004.0,5,8,-3
IL,AU,2004.0,14,3,11
UA,CA,2004.0,7,6,1
BJ,FR,2016.0,20,22,-2
BE,SE,2018.0,32,26,6
BG,DE,2019.0,27,39,-12
nan,AE,2016.0,1,3,-2
MA,GB,2000.0,2,2,0
EE,DK,2011.0,1,2,-1
ZA,GH,2014.0,10,11,-1
IE,MX,2010.0,3,3,0
PT,nan,2012.0,27,50,-23
ES,CA,1999.0,19,19,0
ZA,NG,2012.0,28,27,1
IQ,MM,2019.0,1,3,-2
HU,SE,1999.0,11,6,5
KR,ES,2005.0,2,4,-2
FI,TW,2016.0,3,3,0
BH,NG,2019.0,3,7,-4
KR,SE,2011.0,8,11,-3
AE,IN,2004.0,6,6,0
ET,KE,2021.0,10,4,6
TR,IT,2014.0,16,24,-8
CO,BE,2012.0,4,10,-6
TW,BD,2021.0,1,2,-1
BR,MZ,2016.0,17,19,-2
SA,IR,2015.0,7,7,0
CU,DO,2014.0,3,1,2
KW,BD,2020.0,1,4,-3
CZ,SE,2011.0,8,5,3
UG,CY,2020.0,3,2,1
SG,DZ,2018.0,9,3,6
BB,JM,2017.0,4,3,1
CN,CM,2012.0,2,1,1
RU,IT,1998.0,22,25,-3
AR,CZ,2021.0,2,1,1
NL,TR,2002.0,7,12,-5
GR,TW,2010.0,2,2,0
QA,JP,2002.0,1,1,0
KH,TH,2022.0,4,5,-1
nan,JO,2020.0,7,3,4
NL,EG,2015.0,8,4,4
PL,TR,2013.0,3,4,-1
ES,RU,1998.0,9,12,-3
ES,RU,1997.0,11,5,6
AU,TR,2009.0,5,5,0
NL,AR,2001.0,3,3,0
NL,AE,2010.0,4,9,-5
SD,BR,2002.0,3,4,-1
ID,PT,2005.0,1,1,0
SE,ET,2020.0,10,11,-1
AU,PA,2009.0,1,1,0
ME,RS,2009.0,4,8,-4
SN,US,2018.0,12,16,-4
JP,KH,2010.0,5,5,0
BE,PL,2020.0,17,20,-3
NL,TH,2003.0,2,2,0
LY,MY,2022.0,1,2,-1
GP,FR,2014.0,18,19,-1
GB,SA,2005.0,24,12,12
OM,GB,2015.0,8,11,-3
SE,IS,2003.0,20,7,13
IT,UA,2000.0,6,6,0
PK,BH,2021.0,4,2,2
PK,IN,2008.0,65,77,-12
NP,DE,2008.0,1,1,0
GB,IS,2010.0,5,4,1
RO,DE,2021.0,20,23,-3
DK,TZ,2014.0,2,1,1
CH,IE,2013.0,11,19,-8
GB,GH,2009.0,11,10,1
QA,FR,2022.0,4,5,-1
US,LB,2001.0,26,23,3
NG,IN,2009.0,5,2,3
IT,NZ,2001.0,2,4,-2
ZW,US,2014.0,8,11,-3
SA,SE,2017.0,9,13,-4
SA,GR,2018.0,1,3,-2
IN,PT,2021.0,10,8,2
EG,ES,2014.0,6,9,-3
BJ,SN,2007.0,1,1,0
EG,NO,2015.0,2,1,1
NG,UG,2016.0,8,5,3
RO,AU,2011.0,2,1,1
CZ,CH,1997.0,2,7,-5
JP,FI,2017.0,14,20,-6
CA,TW,2014.0,40,45,-5
CZ,GR,2020.0,4,8,-4
BE,nan,2005.0,15,38,-23
AU,TW,2002.0,11,7,4
SA,CH,2016.0,4,4,0
RO,BR,2012.0,1,2,-1
PK,NO,2007.0,1,1,0
EG,BR,2016.0,2,5,-3
MY,CA,1998.0,3,1,2
SE,TW,1998.0,3,2,1
CN,DK,1998.0,6,6,0
IL,AT,2014.0,7,3,4
SA,CN,2014.0,18,26,-8
ZA,ES,2016.0,14,16,-2
TN,ID,2019.0,8,3,5
nan,CL,2018.0,7,8,-1
CH,FI,2015.0,15,25,-10
FI,RO,2019.0,3,3,0
IT,ET,2010.0,2,3,-1
ET,IT,2011.0,1,1,0
CZ,CH,1998.0,7,9,-2
SK,BR,2009.0,2,2,0
PK,RU,2016.0,5,4,1
NZ,PT,2011.0,2,1,1
SA,SE,2019.0,7,8,-1
NZ,BD,2013.0,1,2,-1
CA,IR,2001.0,22,7,15
AE,OM,2014.0,2,5,-3
JP,KH,2017.0,6,2,4
SK,CH,2008.0,10,6,4
IE,PH,2000.0,1,1,0
DE,NG,1999.0,3,2,1
PL,IL,2005.0,5,4,1
KW,BH,2014.0,1,3,-2
DE,MX,1997.0,6,10,-4
SE,CR,1997.0,1,1,0
EG,nan,2016.0,4,3,1
US,ML,2012.0,2,5,-3
NL,TW,2004.0,6,1,5
RO,TR,2015.0,4,3,1
CA,NG,2003.0,2,2,0
AR,CN,2006.0,1,2,-1
nan,TW,2002.0,5,4,1
CN,GH,2010.0,2,1,1
TH,DE,2014.0,16,23,-7
US,MZ,2009.0,3,2,1
SK,PL,2006.0,5,5,0
DE,QA,2021.0,7,5,2
ZA,NZ,2015.0,10,10,0
CN,GR,2019.0,6,10,-4
BH,GB,2015.0,5,5,0
HK,SG,2022.0,3,1,2
MZ,PL,2022.0,3,3,0
BA,ME,2019.0,2,3,-1
TW,BE,2015.0,2,2,0
JP,CZ,2013.0,22,6,16
GR,IL,2017.0,1,3,-2
PT,CZ,2016.0,4,6,-2
SN,GN,2013.0,4,1,3
MX,NL,2016.0,15,16,-1
QA,CN,2004.0,4,2,2
PH,AU,2020.0,27,11,16
EG,PS,2014.0,3,3,0
PL,AU,2016.0,15,9,6
CY,AU,2020.0,1,3,-2
NG,PL,2022.0,4,1,3
SG,FI,2018.0,2,6,-4
BB,GB,2016.0,5,2,3
JP,VN,2023.0,2,5,-3
IT,ET,2019.0,9,1,8
BR,TR,2007.0,12,74,-62
BH,ID,2020.0,3,3,0
CZ,BA,2011.0,4,1,3
BE,TN,2017.0,5,3,2
KE,NG,2019.0,7,8,-1
IL,FR,1998.0,17,23,-6
RS,BG,2007.0,2,10,-8
CA,PL,2008.0,19,24,-5
SI,CZ,2013.0,10,8,2
FI,DK,2013.0,10,22,-12
UZ,RU,1998.0,14,6,8
GH,ID,2016.0,13,6,7
SE,TR,2019.0,16,35,-19
ML,US,2021.0,6,8,-2
PY,BR,2008.0,3,3,0
DZ,SA,2018.0,14,10,4
TN,FR,1999.0,22,27,-5
VN,NO,2017.0,3,4,-1
TN,DZ,2013.0,28,11,17
DZ,BE,2013.0,2,8,-6
FJ,AU,2015.0,4,8,-4
SD,BR,2005.0,5,8,-3
BG,SE,2000.0,7,3,4
GH,GB,2016.0,18,29,-11
ZM,CN,2020.0,3,3,0
IT,UY,2017.0,13,9,4
SE,TZ,2018.0,3,7,-4
HU,AT,2001.0,15,6,9
CA,BA,2019.0,1,2,-1
VN,NO,2019.0,4,1,3
CA,MY,2001.0,7,1,6
DK,PL,2014.0,13,7,6
CN,EG,2023.0,2,3,-1
ES,PR,2019.0,1,3,-2
KR,TH,2005.0,4,1,3
ET,NG,2016.0,6,9,-3
SY,IN,2020.0,4,1,3
FR,SN,2005.0,21,18,3
US,MN,2021.0,3,1,2
AE,KR,2013.0,2,3,-1
TW,DE,2007.0,13,17,-4
AE,CN,2017.0,4,11,-7
ES,QA,2016.0,16,3,13
IN,LB,2021.0,6,10,-4
IT,VG,2019.0,1,1,0
NZ,ZA,2003.0,7,11,-4
AT,HU,2001.0,6,15,-9
RS,ES,2012.0,3,2,1
TZ,MY,2020.0,1,5,-4
PE,CL,2003.0,17,12,5
BI,MA,2014.0,1,2,-1
IT,TH,2012.0,5,3,2
IT,DO,2019.0,4,2,2
GB,BW,2011.0,4,4,0
VN,GB,2009.0,3,10,-7
NL,KR,2014.0,11,8,3
EE,CA,2018.0,2,1,1
PT,BD,2022.0,1,1,0
RW,SE,2014.0,2,2,0
GR,RU,2009.0,1,3,-2
BB,JM,2019.0,5,8,-3
AE,PS,2021.0,1,2,-1
AU,BH,2020.0,2,1,1
NO,UG,2011.0,3,3,0
EE,RU,2008.0,8,8,0
AT,UG,2014.0,2,2,0
LU,GB,2014.0,6,9,-3
UG,NL,2015.0,3,1,2
PL,IL,2002.0,4,3,1
AT,AU,2001.0,9,9,0
LU,CH,2013.0,5,8,-3
BA,TR,2022.0,2,1,1
NL,SA,2003.0,3,1,2
PH,TW,1998.0,4,1,3
NL,UG,2000.0,2,1,1
JP,LT,2000.0,6,4,2
CH,SG,2014.0,19,23,-4
PH,IL,2006.0,2,3,-1
DE,CM,2001.0,1,2,-1
HU,AU,2006.0,9,7,2
SK,FR,2006.0,10,11,-1
ES,TH,2016.0,5,1,4
IR,SK,2015.0,1,1,0
TR,DK,2005.0,2,3,-1
IN,IL,2011.0,23,12,11
CZ,ET,2020.0,1,6,-5
FO,DK,2018.0,4,4,0
NO,CZ,2021.0,6,3,3
CN,CO,2009.0,2,2,0
MY,EG,2010.0,5,22,-17
DE,ET,2021.0,13,7,6
CL,ZA,2014.0,3,3,0
AT,UA,2003.0,2,2,0
SK,UA,2007.0,1,1,0
BR,VE,2008.0,10,21,-11
KR,FI,2005.0,6,6,0
CA,HU,1998.0,4,5,-1
PT,NL,1997.0,5,5,0
AE,MX,2021.0,2,2,0
HN,EC,2018.0,3,2,1
MX,RU,2000.0,1,10,-9
BH,CA,2008.0,1,2,-1
LT,NL,2018.0,4,1,3
IR,AT,2008.0,5,2,3
IL,BR,2001.0,3,4,-1
FI,IN,2013.0,13,16,-3
CL,DE,2002.0,6,15,-9
LT,DE,2002.0,3,5,-2
CL,EC,2010.0,9,9,0
BE,RO,2012.0,8,13,-5
ID,IT,2013.0,4,5,-1
CN,SI,2009.0,1,4,-3
ZA,DK,2009.0,6,1,5
PS,EG,2012.0,1,3,-2
BE,LV,2016.0,1,1,0
nan,PK,2007.0,2,1,1
RO,ID,2014.0,2,1,1
CN,GR,2017.0,5,12,-7
IQ,SD,2019.0,6,16,-10
MY,PS,2022.0,3,2,1
NG,HU,2022.0,1,7,-6
IT,EE,1997.0,1,1,0
JP,PH,2021.0,23,20,3
PK,NL,2019.0,7,10,-3
KW,NL,2021.0,1,1,0
TW,IT,2022.0,5,5,0
CL,KR,2017.0,3,1,2
CZ,IE,2005.0,1,1,0
PK,NL,2010.0,4,5,-1
BN,MY,2014.0,4,10,-6
ML,IN,2019.0,5,3,2
BG,IT,2007.0,7,11,-4
NO,FI,1997.0,5,6,-1
CN,KZ,2006.0,8,6,2
MD,DE,2003.0,2,2,0
BG,FI,2003.0,2,2,0
US,CR,1997.0,3,3,0
IE,MY,2008.0,2,1,1
BO,CR,2018.0,4,3,1
IE,MX,2017.0,2,3,-1
NI,US,2021.0,4,8,-4
AT,DK,2010.0,8,8,0
PL,LT,2006.0,1,3,-2
IE,IR,2015.0,5,9,-4
FR,NE,1999.0,2,2,0
IR,NG,2021.0,3,4,-1
ID,BR,2021.0,17,17,0
BF,BE,2005.0,1,1,0
DE,LU,2004.0,8,7,1
JP,NO,2006.0,6,9,-3
JP,QA,2017.0,5,2,3
IQ,SY,2016.0,1,4,-3
MX,CN,2011.0,12,8,4
NP,IT,2009.0,1,1,0
UY,PE,2014.0,4,3,1
NZ,KR,2006.0,4,3,1
IL,TR,2015.0,4,1,3
NG,ID,2014.0,3,1,2
KR,MX,2020.0,3,2,1
GP,US,2011.0,1,1,0
FR,SI,1999.0,2,4,-2
BG,DE,2017.0,25,26,-1
DO,BR,2019.0,4,4,0
EE,SE,2006.0,2,14,-12
IQ,MY,2011.0,7,8,-1
BH,NG,2010.0,3,5,-2
DK,BG,2012.0,2,2,0
LV,SE,2004.0,4,6,-2
GA,CA,2015.0,1,2,-1
LK,IN,2015.0,6,15,-9
VE,AR,2012.0,19,12,7
BE,SK,2022.0,1,1,0
DK,AR,2014.0,1,4,-3
ES,CY,2022.0,1,1,0
KR,PT,2016.0,3,1,2
RU,HR,2015.0,6,10,-4
TR,NG,2009.0,1,3,-2
CH,VN,2021.0,1,3,-2
BG,GR,2002.0,3,2,1
DK,CZ,2013.0,7,7,0
ES,NO,2004.0,7,8,-1
DE,BG,2023.0,3,1,2
IN,PK,2024.0,1,1,0
MA,US,2012.0,11,16,-5
SV,CO,2006.0,1,1,0
PE,SV,2021.0,3,1,2
IL,BE,2000.0,7,3,4
LV,DE,2008.0,3,3,0
SG,NZ,2014.0,8,9,-1
NO,FI,1998.0,2,2,0
RO,BE,1998.0,2,2,0
US,GD,2016.0,12,26,-14
EG,GB,1998.0,7,9,-2
YE,JO,2020.0,5,2,3
FI,NG,2021.0,3,3,0
AM,KR,2018.0,2,1,1
OM,IN,2011.0,7,16,-9
IQ,EG,2012.0,5,15,-10
MK,RS,2022.0,2,1,1
NO,PT,1999.0,1,2,-1
CA,HK,2022.0,5,2,3
IN,YE,2011.0,2,1,1
BR,ZM,2018.0,4,6,-2
SA,MA,2012.0,5,3,2
KR,NL,2012.0,7,11,-4
KE,AU,2020.0,7,10,-3
SG,EG,2016.0,2,4,-2
RS,NL,2018.0,9,9,0
IQ,CA,2015.0,4,2,2
IS,DE,2016.0,7,4,3
CH,LV,2019.0,3,3,0
BH,RU,2021.0,8,1,7
TH,AT,2011.0,6,5,1
ES,CZ,2009.0,10,14,-4
CM,CH,2004.0,2,2,0
EC,BY,2022.0,2,1,1
SE,HR,1997.0,3,1,2
DE,MX,1998.0,7,7,0
KZ,AU,2019.0,1,6,-5
PH,CA,2005.0,3,7,-4
IE,CH,2003.0,3,8,-5
MG,FR,2012.0,9,9,0
AT,RU,2000.0,10,4,6
GR,IE,2021.0,7,3,4
EG,JO,2003.0,1,1,0
SA,IT,2007.0,2,1,1
PG,GB,2000.0,1,1,0
HR,PL,2017.0,5,1,4
LU,IT,2000.0,1,1,0
NZ,FR,2001.0,9,9,0
IT,SG,2003.0,4,1,3
CN,MM,2008.0,3,13,-10
PT,CN,2009.0,8,12,-4
nan,TW,2005.0,4,9,-5
PR,MX,2021.0,5,3,2
BM,US,2019.0,1,1,0
OM,AE,2016.0,6,6,0
BA,ME,2017.0,4,1,3
HK,AU,2016.0,5,7,-2
JP,MN,2004.0,3,1,2
KR,FI,2002.0,6,1,5
MY,SI,2020.0,1,3,-2
SG,IE,2020.0,5,4,1
IL,RO,2017.0,4,1,3
CL,CH,2005.0,4,4,0
CL,ID,2009.0,2,2,0
NG,CG,2022.0,2,1,1
CN,PT,2021.0,10,13,-3
ES,GM,2022.0,1,1,0
nan,ZA,2016.0,7,3,4
ES,TW,2022.0,2,1,1
PL,IE,2022.0,3,2,1
MY,MX,2021.0,2,1,1
BJ,BE,2007.0,1,4,-3
CH,LB,2021.0,1,5,-4
CN,MY,1999.0,3,2,1
SG,QA,2016.0,6,5,1
RU,BR,2000.0,5,13,-8
SA,KW,2004.0,2,3,-1
CY,ES,2022.0,1,1,0
MY,MM,2020.0,4,3,1
CH,LV,2017.0,3,1,2
NZ,AR,2019.0,1,3,-2
TR,SA,2009.0,4,3,1
CR,PA,2008.0,1,1,0
CU,HN,2011.0,1,1,0
KE,UG,2004.0,1,2,-1
RS,IL,2008.0,5,9,-4
TH,SG,2002.0,2,1,1
SA,SE,2010.0,1,3,-2
AR,PA,2013.0,3,5,-2
BE,ID,2004.0,2,1,1
LT,RO,2001.0,3,1,2
AE,IT,2006.0,1,1,0
TR,SE,2010.0,6,3,3
ES,IS,2020.0,2,2,0
CL,KR,2019.0,3,5,-2
AR,AU,2007.0,5,7,-2
MX,KR,2009.0,1,3,-2
MM,IN,2018.0,1,1,0
LK,BT,2013.0,1,1,0
DZ,TN,2010.0,5,7,-2
BY,CH,2004.0,3,2,1
BJ,CG,2011.0,1,2,-1
CH,CU,2020.0,1,2,-1
ID,CA,2001.0,2,1,1
AU,KE,2009.0,4,5,-1
JP,OM,2015.0,2,1,1
RS,RU,2023.0,2,1,1
nan,EC,2019.0,3,11,-8
HR,RU,2023.0,1,2,-1
CN,DK,1997.0,6,5,1
ES,NZ,2003.0,1,2,-1
DE,VE,2021.0,3,5,-2
BH,AE,2014.0,2,1,1
LV,LT,2017.0,5,2,3
TR,AZ,2004.0,3,4,-1
nan,CA,1998.0,5,5,0
AU,NO,2023.0,2,1,1
NO,VN,2011.0,3,4,-1
MY,CA,1997.0,1,4,-3
FI,QA,2007.0,2,1,1
SA,ET,2019.0,2,1,1
NZ,RU,2001.0,2,3,-1
AE,AU,2018.0,8,20,-12
CD,ID,2020.0,1,1,0
BG,GR,2005.0,2,2,0
AR,PH,2010.0,1,2,-1
SK,NZ,2013.0,5,1,4
CN,GE,2005.0,3,2,1
OM,AU,2007.0,4,1,3
CO,BO,2021.0,8,9,-1
NO,AT,2000.0,1,1,0
LU,US,2003.0,3,1,2
MA,CM,2015.0,1,2,-1
SG,AE,2022.0,4,3,1
DK,IL,2015.0,4,3,1
SN,MR,2008.0,1,1,0
ZA,BE,1997.0,2,7,-5
DK,NP,2019.0,1,5,-4
IQ,SD,2017.0,5,9,-4
IT,ET,2017.0,3,7,-4
AT,SA,2022.0,1,3,-2
IT,DO,2017.0,2,3,-1
EE,CH,1999.0,3,1,2
BE,IN,2006.0,6,13,-7
IT,SI,1997.0,3,2,1
KH,FR,2016.0,5,6,-1
UY,DE,2012.0,3,5,-2
UA,SK,2009.0,2,9,-7
GR,TW,2019.0,1,3,-2
EE,FR,2000.0,1,3,-2
AU,ZW,2006.0,1,2,-1
JP,VG,2018.0,2,2,0
LB,IR,2016.0,1,3,-2
SI,nan,2012.0,1,2,-1
PL,EG,2019.0,2,3,-1
NZ,IS,2017.0,1,1,0
MA,TR,2020.0,2,5,-3
IN,PH,2000.0,3,4,-1
MK,BG,2012.0,1,2,-1
SG,BR,2020.0,4,2,2
PK,MX,1999.0,2,1,1
JP,AO,2005.0,2,3,-1
CO,IN,2016.0,4,5,-1
BR,CR,2004.0,2,2,0
VN,GR,2000.0,4,5,-1
GR,IL,2010.0,2,3,-1
CZ,HU,2000.0,3,3,0
GH,BW,2018.0,2,1,1
CR,PE,2022.0,4,6,-2
AT,XK,2019.0,6,1,5
PA,CR,2018.0,2,3,-1
DE,BJ,2021.0,1,1,0
FR,CU,2009.0,4,5,-1
US,GL,2011.0,1,1,0
UA,IR,2019.0,1,2,-1
CZ,AU,2011.0,5,5,0
BR,PY,2001.0,2,3,-1
BR,CH,2001.0,3,7,-4
CU,BO,2019.0,1,1,0
nan,CR,2020.0,1,2,-1
TZ,IL,2017.0,1,1,0
HK,DE,2009.0,1,1,0
DZ,EG,2022.0,2,9,-7
NL,LB,2021.0,4,7,-3
BG,PL,2006.0,4,3,1
BO,CN,2008.0,3,7,-4
VN,IN,2007.0,2,3,-1
ZM,KE,2016.0,1,3,-2
RW,UG,2021.0,4,4,0
QA,BH,2019.0,1,2,-1
PK,AE,2012.0,5,5,0
US,PF,2014.0,1,1,0
CU,CH,2014.0,2,1,1
QA,DZ,2018.0,1,2,-1
VN,nan,2014.0,2,2,0
IR,PH,2009.0,1,1,0
UA,CO,2019.0,1,2,-1
DZ,RU,2022.0,1,3,-2
SI,FI,2021.0,2,1,1
CA,PF,2020.0,2,1,1
IL,MY,2016.0,3,2,1
PK,IT,2005.0,1,1,0
AU,CZ,2007.0,5,6,-1
GR,CH,1998.0,2,3,-1
RO,MD,2011.0,2,1,1
MX,SG,2011.0,2,5,-3
VE,CA,2005.0,6,2,4
VN,NL,2003.0,2,2,0
SN,ML,2014.0,3,2,1
PT,NL,1998.0,1,4,-3
IE,EG,2018.0,7,7,0
MY,NP,2015.0,2,1,1
GR,HU,2016.0,4,3,1
SG,NO,2007.0,1,1,0
LT,DE,2005.0,4,9,-5
NO,RO,2015.0,1,3,-2
CA,CM,2015.0,2,2,0
PE,DE,2007.0,1,3,-2
PL,MZ,2007.0,5,9,-4
IN,ML,2006.0,1,4,-3
KW,nan,2019.0,1,1,0
KE,ZA,2006.0,3,6,-3
NO,ZA,2005.0,3,2,1
CW,DE,2007.0,3,1,2
BD,LY,2009.0,1,1,0
KR,IE,2012.0,3,10,-7
CL,PY,2011.0,1,2,-1
LV,AU,2010.0,1,1,0
PS,nan,2021.0,1,1,0
IR,BR,2008.0,1,2,-1
OM,KW,2011.0,2,1,1
ZA,JP,2001.0,1,3,-2
KW,SA,2005.0,2,11,-9
CA,PA,2020.0,2,4,-2
PE,BO,2013.0,3,2,1
DK,GR,2011.0,2,6,-4
UG,NO,2021.0,2,5,-3
ZA,KR,2013.0,1,1,0
JO,QA,2009.0,2,2,0
DE,HU,2023.0,2,1,1
EE,AU,2021.0,4,1,3
UZ,KR,2000.0,4,2,2
CM,RU,2021.0,1,1,0
SN,ES,2019.0,2,1,1
CZ,NZ,2013.0,2,2,0
IN,SY,2005.0,1,1,0
SA,LY,2012.0,2,2,0
BE,PH,2015.0,4,3,1
CL,FR,1999.0,7,13,-6
NG,ZW,2009.0,1,1,0
GR,TW,2017.0,3,1,2
MK,IN,2013.0,1,2,-1
CU,BE,2013.0,3,4,-1
CU,RU,2013.0,1,2,-1
TR,UA,2015.0,1,1,0
AT,MX,2014.0,2,2,0
DK,NP,2017.0,1,1,0
SN,CN,2022.0,2,1,1
BW,ZM,2014.0,1,1,0
NP,LK,2020.0,2,2,0
KR,RU,2012.0,8,10,-2
SE,SI,2013.0,2,4,-2
ZA,AT,2012.0,2,5,-3
CH,RS,2008.0,4,5,-1
GT,EC,2020.0,2,4,-2
CA,GN,2022.0,1,3,-2
ID,SK,2019.0,1,4,-3
JP,QA,2019.0,4,2,2
IS,FI,2016.0,1,2,-1
IL,BD,2008.0,3,1,2
US,FJ,2008.0,2,3,-1
NI,CL,2017.0,2,1,1
AT,SI,2006.0,2,1,1
TH,LA,2016.0,2,2,0
IT,PH,2009.0,2,4,-2
PK,IT,2002.0,2,1,1
PT,CL,2004.0,2,1,1
GR,BR,2013.0,2,4,-2
DE,PS,2000.0,2,1,1
IL,IS,2018.0,1,1,0
QA,DE,2015.0,2,11,-9
IS,CA,2004.0,2,1,1
IT,BG,2004.0,4,7,-3
VE,AU,2020.0,1,2,-1
SG,NP,2015.0,2,2,0
GH,FR,2018.0,1,5,-4
MD,BF,2019.0,1,1,0
TW,CH,2003.0,1,2,-1
EG,MY,2003.0,1,3,-2
NL,BT,2021.0,1,1,0
ES,TR,2006.0,2,4,-2
SD,IR,2012.0,1,1,0
BW,US,1998.0,1,1,0
CR,SE,2001.0,1,4,-3
PS,QA,2017.0,3,1,2
CD,CI,2019.0,1,1,0
BF,BJ,2008.0,2,1,1
AT,CL,2004.0,1,1,0
AE,JO,2003.0,2,5,-3
HR,BR,2020.0,3,4,-1
PS,ES,2002.0,2,4,-2
TW,NL,2000.0,1,1,0
AE,CA,2008.0,1,15,-14
SE,TR,2010.0,3,6,-3
CH,CD,2015.0,2,1,1
JP,ZW,2015.0,2,1,1
IL,AR,2001.0,1,3,-2
CO,LT,2014.0,1,1,0
SN,BJ,2012.0,1,2,-1
TD,FR,2013.0,1,1,0
CG,CH,2016.0,1,2,-1
DO,US,2021.0,3,4,-1
BG,CA,2020.0,1,4,-3
MX,EG,2015.0,2,1,1
BM,US,2010.0,2,1,1
LK,CH,2021.0,1,1,0
JO,YE,2020.0,2,5,-3
BN,US,2022.0,2,2,0
VN,SG,2008.0,3,3,0
BJ,IT,2008.0,1,1,0
CN,IQ,2009.0,2,2,0
ZA,NA,1999.0,2,1,1
IL,RS,2021.0,1,2,-1
CL,US,2007.0,122,131,-9
PT,BR,2015.0,1047,1018,29
CN,US,2005.0,4003,6046,-2043
PK,AU,2020.0,55,49,6
FR,IN,2011.0,92,142,-50
VE,ES,2022.0,13,14,-1
DE,ES,2000.0,63,75,-12
SA,GB,1999.0,10,10,0
CH,GB,2006.0,181,190,-9
NL,AE,2019.0,9,4,5
MX,CR,2012.0,29,27,2
CO,MX,2001.0,33,38,-5
US,SE,2001.0,255,318,-63
FR,nan,2010.0,229,180,49
IT,CH,2007.0,234,117,117
NL,IN,2016.0,60,66,-6
IR,DE,2013.0,75,49,26
MX,US,2001.0,169,153,16
DE,PT,2018.0,46,59,-13
IR,IT,2016.0,44,24,20
MN,US,2007.0,3,1,2
IN,NP,2020.0,160,169,-9
AR,DE,2012.0,39,40,-1
AT,XK,2017.0,4,5,-1
CH,BR,2011.0,33,40,-7
EG,GB,1997.0,2,7,-5
FI,US,2020.0,133,161,-28
NZ,IN,2019.0,43,46,-3
CZ,IN,2020.0,21,27,-6
CZ,SK,2010.0,51,70,-19
US,GH,2018.0,56,65,-9
IE,DE,2001.0,29,19,10
BE,PT,2011.0,13,8,5
ID,IN,2012.0,5,9,-4
CA,JP,2006.0,97,131,-34
US,KE,2021.0,62,77,-15
NC,FR,2017.0,10,15,-5
CZ,HR,2015.0,8,7,1
CH,NL,2008.0,69,85,-16
IR,SE,2021.0,57,17,40
CR,CL,2008.0,13,7,6
AT,DK,2019.0,21,20,1
CN,TH,2002.0,6,6,0
AR,PH,2017.0,2,2,0
ZA,IN,2012.0,40,41,-1
GR,CA,2014.0,15,13,2
EG,SA,2005.0,48,44,4
AR,NL,1999.0,2,5,-3
DE,EE,2011.0,43,34,9
OM,MY,2018.0,3,13,-10
EG,JP,2002.0,12,33,-21
JP,ES,2006.0,21,26,-5
QA,LB,2016.0,3,5,-2
BG,FR,2000.0,10,7,3
FR,HU,2016.0,17,17,0
RU,TW,2003.0,12,9,3
CO,EC,2010.0,8,6,2
CL,NL,2022.0,9,9,0
AU,SA,2010.0,14,4,10
US,TZ,2012.0,16,18,-2
CA,BR,2023.0,10,14,-4
IT,AR,2000.0,23,30,-7
PT,AU,2022.0,12,10,2
JP,MY,2023.0,2,2,0
UA,BY,2015.0,13,9,4
US,PL,2001.0,109,122,-13
PK,MY,2011.0,43,17,26
FR,GP,2011.0,19,16,3
NZ,IN,2017.0,32,46,-14
AR,UY,2003.0,12,9,3
BE,TN,2019.0,8,9,-1
TJ,RU,2012.0,17,29,-12
NP,AU,2020.0,30,10,20
CN,TH,2005.0,6,7,-1
SI,AT,2008.0,5,7,-2
CI,FR,1997.0,2,2,0
EC,FR,2011.0,7,5,2
IR,AZ,2020.0,1,1,0
CZ,BG,1999.0,2,1,1
US,LY,2016.0,5,1,4
RU,SK,2021.0,18,13,5
US,BO,2000.0,2,4,-2
GR,DE,1999.0,15,27,-12
IN,CL,2016.0,3,8,-5
TR,FR,2011.0,25,19,6
BE,TW,2009.0,6,4,2
DE,UA,2020.0,29,29,0
GR,RO,2012.0,2,2,0
MZ,US,2012.0,3,2,1
ES,UY,1998.0,8,6,2
GB,RS,2000.0,5,5,0
PR,ET,2014.0,6,6,0
PL,SG,2016.0,6,6,0
CY,CN,2011.0,1,1,0
SK,HU,2018.0,8,11,-3
CO,PH,2013.0,4,7,-3
BR,NO,2007.0,15,17,-2
CM,BE,2008.0,1,2,-1
DK,EE,2011.0,2,1,1
CY,US,2010.0,7,29,-22
ML,IN,2010.0,6,3,3
IL,UA,2013.0,5,4,1
SD,KR,2019.0,12,14,-2
PY,AR,2018.0,5,22,-17
PA,AU,2020.0,4,2,2
CZ,GB,2022.0,20,28,-8
SA,JP,2012.0,7,9,-2
SE,EE,2014.0,7,10,-3
US,GP,2012.0,1,1,0
RW,ZA,2020.0,3,8,-5
SK,IT,2000.0,4,3,1
FR,ET,2013.0,7,1,6
NG,JP,2004.0,4,8,-4
MA,CA,2014.0,14,11,3
nan,EC,2017.0,5,6,-1
JP,NZ,2013.0,8,11,-3
BR,GT,2016.0,5,3,2
IN,ID,2006.0,2,1,1
AZ,CY,2020.0,1,1,0
TH,FI,2012.0,4,3,1
CO,ZA,2017.0,3,6,-3
MX,AT,2019.0,4,5,-1
PS,ES,2005.0,2,4,-2
FR,CF,2007.0,3,3,0
LY,SA,2012.0,2,2,0
IL,IE,2021.0,2,1,1
PL,EG,2010.0,5,4,1
DZ,FI,2020.0,3,1,2
PH,SG,2015.0,6,8,-2
BD,NZ,2013.0,2,1,1
nan,GE,2020.0,3,2,1
PE,KR,2018.0,1,1,0
JM,TT,1999.0,3,6,-3
ES,BO,2006.0,4,3,1
NL,QA,2008.0,3,1,2
US,NI,2006.0,4,1,3
UG,CD,2018.0,2,1,1
CA,GA,2016.0,1,1,0
CN,MG,2021.0,1,8,-7
TW,SE,2021.0,5,5,0
DO,BR,2017.0,1,4,-3
JP,QA,2010.0,2,1,1
MX,VN,1998.0,2,1,1
BO,CO,2004.0,1,1,0
GB,CM,2015.0,5,3,2
EE,DE,1999.0,4,6,-2
GM,US,2008.0,3,1,2
DE,LV,2004.0,1,3,-2
SD,KR,2017.0,1,12,-11
CH,TH,2022.0,4,3,1
US,LU,2016.0,28,24,4
AU,GR,2000.0,6,1,5
IR,SG,2020.0,35,43,-8
IT,BE,2011.0,136,66,70
JP,NG,2018.0,26,23,3
CN,MK,2013.0,5,1,4
LY,IN,2012.0,4,3,1
GR,SE,2021.0,21,16,5
EG,IR,2015.0,5,4,1
CZ,IQ,2022.0,2,2,0
MY,NO,2015.0,3,2,1
BE,nan,2002.0,9,12,-3
BE,RU,2009.0,12,20,-8
AR,PH,2019.0,2,2,0
PF,CH,2017.0,1,1,0
FR,LY,2015.0,2,1,1
,GB,1997.0,18540,0,18540
KR,,2011.0,1607,0,1607
,AU,1996.0,6636,0,6636
BR,,2016.0,8570,0,8570
,IT,2008.0,11735,0,11735
MX,,2017.0,3154,0,3154
VE,,2012.0,283,0,283
,GB,1998.0,18198,0,18198
IT,,2005.0,2560,0,2560
CL,,2019.0,1870,0,1870
,AM,1994.0,266,0,266
PL,,2016.0,3135,0,3135
TW,,2017.0,4017,0,4017
,nan,2008.0,857,0,857
NO,,2018.0,1528,0,1528
BE,,2015.0,2249,0,2249
IT,,2002.0,2302,0,2302
CH,,2014.0,2554,0,2554
TW,,2019.0,4031,0,4031
FR,,2018.0,14750,0,14750
,TR,2001.0,4453,0,4453
ES,,2005.0,2517,0,2517
IL,,2004.0,761,0,761
MX,,2010.0,977,0,977
,SI,2005.0,570,0,570
TW,,2010.0,1656,0,1656
ES,,2002.0,1728,0,1728
,AU,2004.0,5940,0,5940
,IE,2008.0,1380,0,1380
,CO,2013.0,3020,0,3020
,PK,2011.0,2064,0,2064
,NZ,2006.0,1055,0,1055
ZA,,2000.0,267,0,267
CL,,2010.0,417,0,417
MX,,2019.0,4858,0,4858
CL,,2017.0,1230,0,1230
,ZA,2003.0,1477,0,1477
,GR,1994.0,4103,0,4103
,SE,2006.0,3093,0,3093
NG,,2016.0,868,0,868
UA,,2014.0,933,0,933
CN,,2003.0,1722,0,1722
KH,,2024.0,256,0,256
AR,,2020.0,2931,0,2931
,SA,2005.0,514,0,514
,NO,2014.0,1814,0,1814
HR,,2022.0,1948,0,1948
,CU,2014.0,519,0,519
,VN,2020.0,101,0,101
NZ,,2000.0,230,0,230
,CZ,2014.0,2488,0,2488
IE,,2022.0,2713,0,2713
IN,GE,2001.0,3,0,3
,SI,2002.0,501,0,501
RS,,2014.0,367,0,367
MT,,2020.0,64,0,64
,SA,2002.0,462,0,462
,PH,1995.0,431,0,431
AE,,2001.0,24,0,24
SK,,2025.0,326,0,326
,SN,1998.0,62,0,62
,PY,2015.0,99,0,99
PK,RW,2014.0,1,0,1
,GD,2013.0,17,0,17
,EE,2002.0,209,0,209
TH,,2025.0,947,0,947
MA,,2011.0,276,0,276
NP,,2014.0,105,0,105
,MM,1998.0,18,0,18
LB,,2015.0,129,0,129
GH,,2013.0,54,0,54
YE,,2021.0,91,0,91
,LV,2007.0,217,0,217
,NG,1999.0,517,0,517
SG,,2003.0,231,0,231
LI,,2023.0,32,0,32
,PS,2014.0,116,0,116
SA,,2015.0,470,0,470
OM,,2004.0,37,0,37
SL,DE,2015.0,1,0,1
,MN,2014.0,85,0,85
DE,UY,2006.0,3,0,3
TT,,2010.0,14,0,14
PR,AU,2005.0,1,0,1
UA,MD,2018.0,2,0,2
AZ,,2022.0,391,0,391
,CI,2009.0,153,0,153
,KE,2001.0,190,0,190
,SD,1999.0,36,0,36
,QA,1998.0,50,0,50
JO,,2001.0,26,0,26
,BS,2013.0,6,0,6
CD,,2016.0,36,0,36
VE,CH,2020.0,5,0,5
AM,,2007.0,54,0,54
LU,,2012.0,60,0,60
MZ,,2023.0,252,0,252
,SN,1997.0,60,0,60
HR,TR,2020.0,2,0,2
,MZ,1995.0,47,0,47
,GN,2004.0,11,0,11
,BA,2000.0,66,0,66
,LR,2018.0,7,0,7
KY,,2025.0,1,0,1
MY,MT,2021.0,1,0,1
QA,TN,2006.0,1,0,1
,KP,2015.0,36,0,36
AF,DE,2011.0,1,0,1
CN,QA,2003.0,4,0,4
,MK,2003.0,50,0,50
AO,,2024.0,103,0,103
IQ,MM,2017.0,4,0,4
TT,,2017.0,27,0,27
TN,BY,2018.0,1,0,1
,MD,2018.0,111,0,111
GR,SY,2010.0,1,0,1
US,,2026.0,16,0,16
PT,ZA,1999.0,1,0,1
GR,PS,2011.0,2,0,2
,NP,2020.0,23,0,23
TJ,DE,2021.0,1,0,1
,EE,2005.0,291,0,291
TW,IR,2015.0,3,0,3
,RS,2020.0,62,0,62
SJ,US,2002.0,1,0,1
,BF,2004.0,71,0,71
CN,IR,1997.0,1,0,1
,GA,1994.0,23,0,23
KW,UA,2017.0,1,0,1
BR,MC,2021.0,1,0,1
MY,AE,2007.0,5,0,5
MW,BW,2007.0,2,0,2
TZ,KE,2004.0,1,0,1
,AO,2000.0,13,0,13
CO,RU,2012.0,2,0,2
PE,,2007.0,30,0,30
nan,VE,2008.0,1,0,1
ES,NC,2007.0,1,0,1
PA,PT,2020.0,2,0,2
GH,IE,2018.0,3,0,3
TT,,2019.0,54,0,54
,BH,1994.0,58,0,58
,BB,1996.0,11,0,11
OM,RU,2017.0,1,0,1
TN,,1999.0,15,0,15
,ML,2003.0,37,0,37
IE,GH,2016.0,1,0,1
,QA,1997.0,33,0,33
GH,NO,2011.0,2,0,2
MA,UG,2020.0,1,0,1
AT,ML,1999.0,1,0,1
DE,KW,2016.0,3,0,3
UA,KZ,2022.0,8,0,8
ME,PT,2005.0,1,0,1
SE,EC,2015.0,5,0,5
AM,PK,2020.0,2,0,2
,BB,2004.0,12,0,12
CN,BI,2021.0,4,0,4
,MU,2009.0,23,0,23
FI,VN,2022.0,3,0,3
,FO,2013.0,9,0,9
RS,CA,1998.0,3,0,3
MM,IT,2017.0,1,0,1
MD,,2001.0,18,0,18
,SZ,2017.0,13,0,13
ID,nan,2004.0,1,0,1
GE,,2007.0,43,0,43
SE,JO,2022.0,1,0,1
SY,NL,2005.0,1,0,1
,TD,2013.0,9,0,9
GH,IT,2013.0,1,0,1
BG,BH,2005.0,1,0,1
nan,MV,2014.0,1,0,1
,MM,1997.0,21,0,21
BY,nan,2016.0,2,0,2
NL,BJ,2010.0,1,0,1
FI,IL,2001.0,2,0,2
,VG,1994.0,20,0,20
,BF,1996.0,41,0,41
IT,MK,2009.0,1,0,1
AT,UY,2012.0,1,0,1
NP,CH,2023.0,1,0,1
SY,,1999.0,5,0,5
GE,ES,2005.0,1,0,1
BJ,,2004.0,6,0,6
LY,BN,2009.0,1,0,1
IQ,BE,2000.0,1,0,1
AZ,GR,2010.0,1,0,1
CM,MG,2022.0,1,0,1
AM,DK,2021.0,1,0,1
CW,,2023.0,24,0,24
TR,LU,2021.0,1,0,1
,MC,2002.0,14,0,14
,PG,2009.0,27,0,27
BW,,2006.0,6,0,6
BJ,CM,2012.0,1,0,1
LK,RU,2013.0,2,0,2
IQ,,1998.0,6,0,6
,MC,2005.0,8,0,8
NL,HK,2023.0,1,0,1
AU,QA,2002.0,2,0,2
NA,PK,2016.0,1,0,1
KH,TW,2019.0,1,0,1
UZ,GB,2011.0,1,0,1
,ME,2000.0,11,0,11
CU,BO,2017.0,2,0,2
TL,PT,2019.0,2,0,2
FI,MT,2011.0,1,0,1
RE,,2004.0,7,0,7
EC,AR,2005.0,2,0,2
JO,ID,2012.0,2,0,2
,DO,1996.0,20,0,20
VG,,2000.0,4,0,4
AU,LK,2001.0,3,0,3
LK,OM,2014.0,2,0,2
OM,UA,2005.0,1,0,1
IE,LY,2002.0,1,0,1
EG,CY,2012.0,1,0,1
,KG,2003.0,17,0,17
ES,UY,1997.0,6,0,6
NE,US,2002.0,2,0,2
TW,ET,2002.0,1,0,1
NO,MW,2019.0,6,0,6
,CW,2001.0,12,0,12
BY,RS,2008.0,1,0,1
,SZ,2010.0,5,0,5
HK,RS,1997.0,1,0,1
CR,IN,2018.0,1,0,1
AO,IT,2007.0,3,0,3
,DO,2004.0,14,0,14
NG,SG,2002.0,1,0,1
BJ,TN,2020.0,3,0,3
SJ,DK,2010.0,1,0,1
FJ,BE,1998.0,1,0,1
BW,US,1997.0,1,0,1
PS,KW,2021.0,1,0,1
MM,BD,2021.0,1,0,1
HN,GB,2020.0,2,0,2
NG,CM,2012.0,4,0,4
VE,BE,2003.0,1,0,1
HR,TN,2019.0,1,0,1
KW,MA,2004.0,3,0,3
KZ,NZ,2019.0,1,0,1
GB,BN,2020.0,5,0,5
MK,DE,2013.0,1,0,1
SN,TG,2015.0,3,0,3
MD,PL,2009.0,2,0,2
CZ,UG,2021.0,1,0,1
US,AF,2016.0,2,0,2
QA,MY,2011.0,2,0,2
AU,YE,2007.0,1,0,1
SA,RO,2018.0,2,0,2
AM,ZW,2013.0,1,0,1
SL,,2001.0,2,0,2
PH,PA,2021.0,1,0,1
FJ,,2009.0,10,0,10
ME,DE,2003.0,1,0,1
GB,PH,2023.0,3,0,3
HR,PL,2010.0,1,0,1
MX,AT,2010.0,5,0,5
HU,IE,2020.0,3,0,3
ZW,CA,2020.0,3,0,3
NO,HK,2009.0,1,0,1
HN,BR,2007.0,1,0,1
TH,OM,2020.0,1,0,1
NL,AE,2017.0,8,0,8
MX,ET,2016.0,4,0,4
EE,CZ,2002.0,2,0,2
IT,VG,2017.0,1,0,1
HN,SE,2001.0,1,0,1
SD,CI,2013.0,3,0,3
US,MA,1997.0,3,0,3
LU,BJ,2016.0,1,0,1
TD,,2008.0,2,0,2
ES,LU,2003.0,1,0,1
,NC,1995.0,15,0,15
GB,CI,2016.0,3,0,3
NI,,2011.0,5,0,5
SV,,2003.0,1,0,1
GR,SG,2005.0,4,0,4
MW,CA,2011.0,4,0,4
IE,CO,2012.0,3,0,3
RS,QA,2015.0,5,0,5
KE,NA,2006.0,1,0,1
BA,BG,2008.0,1,0,1
,BN,2007.0,6,0,6
MY,BE,2016.0,7,0,7
,GL,2006.0,3,0,3
GN,,2014.0,7,0,7
NC,CG,2021.0,1,0,1
,SZ,2019.0,3,0,3
CM,ZW,2004.0,1,0,1
KZ,AU,2017.0,3,0,3
IL,CO,2005.0,2,0,2
TH,LK,2015.0,2,0,2
CA,BH,2010.0,2,0,2
ES,CM,2014.0,1,0,1
PH,MM,2020.0,1,0,1
TW,UA,2022.0,1,0,1
RS,CY,2013.0,2,0,2
PA,ZW,2013.0,1,0,1
MG,CN,2023.0,1,0,1
PK,NG,2003.0,1,0,1
ST,,2011.0,10,0,10
PH,LV,2010.0,2,0,2
AR,LU,2021.0,2,0,2
HU,EG,1997.0,1,0,1
IR,KE,2018.0,1,0,1
CR,NO,2008.0,1,0,1
SA,TJ,2017.0,1,0,1
BR,SV,2003.0,1,0,1
TW,KZ,1997.0,1,0,1
RE,GB,2006.0,1,0,1
PG,US,2016.0,6,0,6
MX,FI,2005.0,2,0,2
US,ST,2021.0,2,0,2
KH,AT,2021.0,1,0,1
BD,IL,2018.0,2,0,2
MS,ES,2009.0,1,0,1
EE,SK,2008.0,1,0,1
DK,FO,2011.0,4,0,4
GA,AT,1999.0,2,0,2
GB,EE,2001.0,3,0,3
MG,PF,1999.0,1,0,1
AT,CM,2017.0,1,0,1
BG,AU,1999.0,2,0,2
GA,BJ,2009.0,1,0,1
MK,SE,2022.0,1,0,1
BH,IR,2013.0,1,0,1
NL,UY,2000.0,1,0,1
JP,IQ,2018.0,4,0,4
PA,CH,2011.0,1,0,1
NL,MT,2014.0,1,0,1
ZW,BE,2001.0,1,0,1
IL,UZ,2007.0,1,0,1
IQ,SA,2004.0,1,0,1
TH,MK,2012.0,1,0,1
TT,ZA,2014.0,1,0,1
JP,DZ,2015.0,3,0,3
SA,ID,2011.0,6,0,6
KE,NP,2010.0,1,0,1
SA,BE,2022.0,8,0,8
CR,FR,2009.0,2,0,2
nan,GF,2021.0,1,0,1
MY,TR,2004.0,1,0,1
QA,BH,2017.0,1,0,1
BE,PK,2013.0,3,0,3
,PF,2016.0,8,0,8
DE,SJ,2020.0,1,0,1
NL,PF,2018.0,1,0,1
ZA,SC,2013.0,1,0,1
SG,ID,2023.0,1,0,1
BA,CH,2009.0,1,0,1
GB,TT,2001.0,7,0,7
SI,BY,2020.0,1,0,1
TW,BH,2008.0,2,0,2
BF,KE,2000.0,1,0,1
SD,QA,2011.0,1,0,1
BE,CI,2014.0,5,0,5
UZ,LA,2006.0,1,0,1
CU,FR,2007.0,1,0,1
BB,IN,2013.0,1,0,1
BE,DO,2022.0,1,0,1
JP,JO,2004.0,2,0,2
AT,EE,2008.0,2,0,2
LU,ML,2021.0,1,0,1
TG,EG,2022.0,1,0,1
IL,RO,2010.0,1,0,1
KZ,BR,2002.0,1,0,1
IL,SI,1999.0,1,0,1
KE,NG,2010.0,1,0,1
TG,BF,2015.0,2,0,2
LB,ID,2009.0,1,0,1
KZ,NZ,2017.0,1,0,1
HK,BG,2012.0,1,0,1
CH,LK,2006.0,1,0,1
TN,JO,2015.0,2,0,2
LU,HT,2018.0,1,0,1
BO,IR,2016.0,1,0,1
IT,SI,1998.0,7,0,7
KH,HK,2000.0,1,0,1
CI,TG,2016.0,1,0,1
SN,MQ,2021.0,1,0,1
CO,MG,2003.0,1,0,1
IL,BG,2016.0,2,0,2
SK,BY,2006.0,3,0,3
nan,TZ,2009.0,1,0,1
RU,SI,2000.0,1,0,1
RU,CW,2004.0,1,0,1
MV,IT,2007.0,1,0,1
NP,AT,2018.0,1,0,1
TR,UY,2006.0,1,0,1
AT,SG,2004.0,2,0,2
FI,UA,2004.0,1,0,1
MY,CO,2017.0,2,0,2
AU,FJ,1998.0,1,0,1
ME,,2014.0,8,0,8
BG,CY,2017.0,1,0,1
PK,NZ,2023.0,1,0,1
CI,CG,2015.0,2,0,2
PT,GR,2001.0,1,0,1
PF,FJ,2016.0,1,0,1
AZ,TW,2001.0,1,0,1
FR,VG,2001.0,1,0,1
PS,CA,2017.0,4,0,4
CZ,AZ,2000.0,1,0,1
IR,GE,2020.0,2,0,2
CN,DZ,2015.0,3,0,3
RS,MC,2020.0,1,0,1
PG,NL,2001.0,2,0,2
SJ,IT,2017.0,1,0,1
CF,,2018.0,3,0,3
NP,BW,2014.0,2,0,2
RO,PH,2002.0,1,0,1
VE,ID,2008.0,2,0,2
BR,TN,2011.0,1,0,1
EG,PK,2024.0,1,0,1
KW,KZ,2018.0,1,0,1
NG,PH,2011.0,1,0,1
JO,TR,2015.0,2,0,2
IE,LB,2015.0,1,0,1
SD,PY,2017.0,1,0,1
KR,HU,2009.0,1,0,1
NL,HR,2023.0,1,0,1
,SS,2008.0,8,0,8
QA,JP,2005.0,1,0,1
SA,DK,2013.0,2,0,2
KW,IT,2008.0,1,0,1
HU,EG,1998.0,2,0,2
RO,DZ,2022.0,1,0,1
GA,TT,2015.0,1,0,1
TG,ID,2020.0,1,0,1
AU,VG,2004.0,1,0,1
JP,CI,2015.0,1,0,1
PH,PL,2010.0,3,0,3
AM,AU,2005.0,1,0,1
AG,HU,2002.0,1,0,1
GT,RE,2013.0,1,0,1
GR,SS,2008.0,1,0,1
ZW,CN,2007.0,2,0,2
IT,MT,2004.0,1,0,1
RS,UA,2001.0,2,0,2
KH,MG,2007.0,1,0,1
MY,GT,2011.0,1,0,1
NL,DZ,2006.0,1,0,1
MW,FI,2022.0,1,0,1
SD,FR,2014.0,2,0,2
CH,KZ,2008.0,1,0,1
IN,HK,2009.0,1,0,1
SI,LV,2017.0,1,0,1
GQ,,2025.0,1,0,1
BI,CO,2020.0,1,0,1
PK,BF,2012.0,1,0,1
NG,ZA,2002.0,3,0,3
SE,CR,1998.0,2,0,2
ML,SN,1997.0,1,0,1
DE,CO,1997.0,2,0,2
CA,NC,2013.0,1,0,1
KR,NO,2006.0,1,0,1
PK,LT,2015.0,2,0,2
VN,KH,2006.0,1,0,1
CN,UG,2009.0,1,0,1
KE,ML,2004.0,1,0,1
CY,ZA,2013.0,2,0,2
AR,FI,2014.0,1,0,1
CH,GM,2014.0,1,0,1
FR,MO,2005.0,1,0,1
FJ,EE,2019.0,1,0,1
DO,VE,2014.0,1,0,1
MQ,CA,2017.0,1,0,1
GF,LA,2021.0,1,0,1
CY,NG,2014.0,1,0,1
CN,JM,2020.0,1,0,1
BM,,2013.0,1,0,1
SN,JP,2015.0,1,0,1
TM,RU,2022.0,1,0,1
EG,YE,2007.0,2,0,2
RO,SA,2013.0,1,0,1
ZA,BG,2011.0,1,0,1
GB,PG,2006.0,1,0,1
CO,ET,2017.0,1,0,1
NO,RS,2000.0,1,0,1
KE,TW,2001.0,1,0,1
NZ,IS,2010.0,1,0,1
SN,CF,2010.0,2,0,2
UG,AF,2019.0,1,0,1
CI,GH,2015.0,1,0,1
TW,LK,2013.0,1,0,1
BE,SR,2008.0,1,0,1
KE,CG,2008.0,1,0,1
EC,IE,2019.0,3,0,3
AT,ET,2016.0,1,0,1
NL,MY,1999.0,1,0,1
TN,ID,2017.0,1,0,1
IT,DO,2010.0,2,0,2
AT,LK,2011.0,1,0,1
SL,US,1998.0,2,0,2
MD,PG,2015.0,1,0,1
NI,CR,2020.0,2,0,2
NO,OM,2011.0,1,0,1
UG,FI,2016.0,1,0,1
CO,ZA,2010.0,1,0,1
SK,KW,2004.0,1,0,1
VG,DK,2015.0,1,0,1
IQ,SD,2010.0,1,0,1
RO,DK,2008.0,1,0,1
EE,BE,2008.0,3,0,3
BJ,OM,2012.0,1,0,1
PT,VN,2014.0,2,0,2
SY,PK,2014.0,1,0,1
CA,BM,2005.0,1,0,1
CR,DE,1999.0,2,0,2
MX,TW,2007.0,1,0,1
SG,HR,2019.0,1,0,1
GD,CH,2013.0,1,0,1
GP,PF,2021.0,1,0,1
IR,BH,2022.0,1,0,1
ID,SR,2018.0,1,0,1
KN,ZA,2020.0,1,0,1
LY,IL,2004.0,1,0,1
SA,LB,2001.0,2,0,2
GR,IL,2019.0,3,0,3
DE,VG,2022.0,1,0,1
MA,RE,2008.0,1,0,1
BY,SE,2020.0,1,0,1
UY,CA,1999.0,1,0,1
NP,CO,2013.0,1,0,1
AU,NI,2006.0,1,0,1
MM,DE,2013.0,1,0,1
IM,,2000.0,2,0,2
ET,TR,1999.0,1,0,1
BJ,ZA,2014.0,1,0,1
AU,SY,2008.0,1,0,1
MO,,2016.0,1,0,1
DE,AL,2011.0,3,0,3
BR,UG,2016.0,1,0,1
CI,BJ,2004.0,1,0,1
SN,ES,2017.0,1,0,1
NG,KH,2020.0,1,0,1
NZ,SY,2015.0,1,0,1
AE,SY,2007.0,1,0,1
UA,JO,2020.0,2,0,2
JP,MA,2009.0,2,0,2
TZ,BI,2012.0,1,0,1
nan,CO,2001.0,1,0,1
RS,TW,1998.0,1,0,1
RE,CG,2010.0,1,0,1
SD,IQ,2009.0,1,0,1
ES,PR,2010.0,1,0,1
IT,ZW,2008.0,1,0,1
IL,ZA,2004.0,1,0,1
BN,JP,2007.0,1,0,1
PK,TW,2015.0,3,0,3
BY,IT,2011.0,1,0,1
,GN,1996.0,2,0,2
BY,PL,2007.0,7,0,7
GR,JO,2018.0,1,0,1
ML,IE,2016.0,1,0,1
IE,PT,1999.0,1,0,1
CR,MX,2023.0,1,0,1
NZ,PL,2016.0,1,0,1
SE,CI,2014.0,1,0,1
DE,MD,2022.0,2,0,2
US,NA,2009.0,1,0,1
ID,IL,2006.0,1,0,1
HK,BR,2002.0,3,0,3
BE,MZ,2023.0,1,0,1
IT,QA,2023.0,1,0,1
KN,US,2008.0,1,0,1
ES,GD,2012.0,1,0,1
ME,AR,2019.0,1,0,1
NI,CL,2010.0,2,0,2
HU,BG,2016.0,1,0,1
AU,IS,1998.0,1,0,1
LV,AU,2017.0,1,0,1
TN,LY,2015.0,1,0,1
IR,AF,2011.0,1,0,1
UY,PY,2022.0,1,0,1
HK,ZA,2005.0,1,0,1
KZ,ID,2018.0,1,0,1
MC,,2004.0,2,0,2
BY,IE,2003.0,1,0,1
PA,PY,2018.0,1,0,1
MT,TR,2021.0,1,0,1
DO,CH,2010.0,1,0,1
NL,BJ,2017.0,3,0,3
TR,VE,2015.0,1,0,1
BE,GP,2020.0,1,0,1
TW,ET,2005.0,2,0,2
JO,TG,2021.0,1,0,1
UA,PT,2013.0,2,2,0
nan,PH,2011.0,1,2,-1
EG,IE,2008.0,2,3,-1
LK,nan,2004.0,1,1,0
TR,TH,2008.0,3,1,2
PT,AO,2018.0,1,3,-2
US,BB,1999.0,2,3,-1
PK,nan,2007.0,1,2,-1
AU,NC,2018.0,2,2,0
IN,ZM,2019.0,2,1,1
RS,HK,2012.0,1,4,-3
US,NC,2003.0,1,1,0
JO,CA,2003.0,2,5,-3
CN,LU,2014.0,2,3,-1
CI,FR,1998.0,1,2,-1
BE,MW,2016.0,1,1,0
FI,PT,2011.0,2,2,0
MY,LY,2022.0,2,1,1
ZW,GB,2012.0,2,3,-1
GH,BE,2009.0,1,1,0
MX,IR,2020.0,1,7,-6
BA,EG,2019.0,1,1,0
ZM,DE,2017.0,1,1,0
CZ,PT,2014.0,1,5,-4
PL,TW,2003.0,1,2,-1
FI,DZ,2016.0,1,1,0
TR,IE,2008.0,3,3,0
MM,IT,2019.0,1,1,0
NO,NZ,2016.0,1,6,-5
IT,AE,2023.0,1,1,0
TZ,IN,2018.0,2,1,1
US,DZ,2000.0,3,3,0
NL,BG,2006.0,3,2,1
NP,NO,2023.0,1,1,0
JP,NP,1999.0,2,2,0
ZM,DE,2019.0,1,2,-1
TH,IT,2006.0,2,3,-1
ZA,PH,2022.0,1,2,-1
EE,NL,2008.0,1,1,0
SG,MM,2013.0,3,1,2
IL,TW,2022.0,2,1,1
SI,NG,2013.0,1,1,0
DK,SG,2013.0,4,7,-3
BE,KE,2009.0,1,2,-1
MA,NE,2016.0,1,2,-1
CA,BA,2017.0,1,1,0
BE,TN,2010.0,2,2,0
DE,CO,1998.0,2,5,-3
RE,US,2016.0,1,5,-4
KR,TH,2002.0,3,2,1
RU,KH,2018.0,1,2,-1
DO,IT,2013.0,2,3,-1
CG,BR,2003.0,1,1,0
RS,BE,2001.0,1,1,0
NL,BJ,2019.0,1,1,0
JP,TN,2020.0,1,2,-1
KE,SE,2004.0,2,3,-1
MY,BN,2006.0,1,2,-1
CH,DZ,2014.0,1,1,0
EC,CO,1999.0,1,1,0
GE,AU,2006.0,1,2,-1
TT,IN,2014.0,2,4,-2
IE,KR,2022.0,1,4,-3
SA,TR,2008.0,3,6,-3
VN,PR,2006.0,3,1,2
KR,LU,2012.0,1,1,0
KE,CO,2000.0,1,1,0
PL,EG,2017.0,4,1,3
nan,UG,2020.0,1,2,-1
IL,ET,2016.0,1,2,-1
KW,FR,2011.0,2,4,-2
TW,MW,2019.0,1,1,0
GB,DZ,2003.0,2,2,0
PY,VE,2015.0,2,1,1
BE,VE,2011.0,1,1,0
BF,FR,2023.0,1,1,0
IN,RO,2001.0,1,1,0
NC,CA,2015.0,1,1,0
HU,MX,2012.0,1,1,0
PH,PK,2002.0,1,2,-1
TZ,BJ,2015.0,1,1,0
MT,IE,2012.0,1,2,-1
SA,FR,1998.0,2,3,-1
ZA,TN,2020.0,1,4,-3
NL,CO,2023.0,1,2,-1
ES,PK,2012.0,2,3,-1
MT,NL,2015.0,1,2,-1
SA,ET,2017.0,1,3,-2
FR,GE,2002.0,1,1,0
ZM,GB,1999.0,1,1,0
IT,UY,2010.0,2,6,-4
KW,HU,2003.0,1,3,-2
EE,NO,2014.0,1,1,0
IT,VE,1997.0,1,1,0
VN,NO,2010.0,1,1,0
IQ,FR,2016.0,2,7,-5
UA,GR,2001.0,1,1,0
DO,CH,2017.0,1,2,-1
ZA,KN,2016.0,1,1,0
DK,PH,2014.0,1,1,0
AT,NO,1999.0,1,1,0
LU,FI,2011.0,1,5,-4
NO,IL,2016.0,1,4,-3
LT,GB,2004.0,2,3,-1
BE,SY,2007.0,1,1,0
NG,SZ,2020.0,1,2,-1
TR,BG,2008.0,1,2,-1
KZ,AM,2015.0,2,1,1
CN,CR,2004.0,1,5,-4
TG,ZA,2020.0,1,1,0
GH,DE,2023.0,1,2,-1
LV,AU,2019.0,1,1,0
GR,UA,2001.0,1,1,0
PT,AT,2023.0,1,1,0
TH,UG,2013.0,1,1,0
DO,CH,2019.0,2,1,1
KG,TR,2020.0,2,7,-5
SA,FR,1997.0,1,2,-1
RS,CN,2002.0,1,5,-4
PH,PT,2018.0,1,4,-3
GE,JP,2015.0,1,1,0
AR,ID,2011.0,2,2,0
RW,TR,2009.0,1,1,0
US,BZ,2019.0,1,3,-2
EG,CM,1997.0,1,1,0
IQ,DE,2004.0,1,1,0
PH,CA,2002.0,1,6,-5
MA,SE,2003.0,1,1,0
DZ,GB,2007.0,1,4,-3
FR,GE,2005.0,1,4,-3
MX,FI,2002.0,2,2,0
KE,NL,1999.0,1,1,0
CM,SN,2009.0,1,1,0
TN,SE,2014.0,1,1,0
PL,AE,2021.0,1,3,-2
MM,SG,2004.0,1,1,0
MA,BR,2021.0,1,2,-1
nan,VN,2001.0,1,1,0
ZM,MM,2016.0,1,1,0
CH,ET,2013.0,1,2,-1
IS,GB,2001.0,1,5,-4
MK,SK,2020.0,1,1,0
PY,MX,2009.0,1,1,0
AO,AR,2016.0,1,1,0
PT,MY,2013.0,1,3,-2
EE,UA,2013.0,1,2,-1
NG,VN,2021.0,1,1,0
PK,PT,2013.0,1,1,0
TH,BE,2007.0,1,2,-1
VN,MX,2023.0,1,1,0
SG,NG,2015.0,1,1,0
JM,BR,2021.0,1,1,0
KZ,IT,2016.0,2,2,0
US,AZ,2014.0,2,1,1
PE,RU,2015.0,1,1,0
UZ,PL,2018.0,1,2,-1
LY,CA,2012.0,1,1,0
BR,GE,2021.0,2,2,0
GR,BD,2014.0,2,4,-2
CU,JP,2000.0,1,2,-1
MA,KW,2014.0,3,10,-7
UA,MZ,2003.0,1,2,-1
PR,nan,2020.0,1,2,-1
NZ,BN,2016.0,1,3,-2
NA,ZA,2005.0,1,1,0
FI,SG,2014.0,2,1,1
LT,IT,2013.0,1,1,0
PH,VN,2011.0,1,1,0
ID,ES,2000.0,2,2,0
NZ,IS,2019.0,1,1,0
BR,RS,2008.0,1,2,-1
VE,CR,2004.0,2,1,1
TR,IQ,2013.0,1,1,0
PK,GM,2019.0,1,0,1
GL,IN,2002.0,1,0,1
CU,ML,2015.0,1,0,1
VE,SV,2004.0,1,0,1
VN,EG,2010.0,1,0,1
KW,nan,2010.0,1,0,1
HR,TN,2017.0,1,0,1
KR,PL,2023.0,1,0,1
PH,VE,2008.0,1,0,1
MX,SK,2004.0,1,0,1
NO,UZ,2020.0,4,0,4
IR,MA,2005.0,2,0,2
KR,TZ,2012.0,1,0,1
KW,JO,2004.0,1,0,1
RO,CI,2014.0,1,0,1
KW,NO,2006.0,1,0,1
SN,GM,2013.0,1,0,1
UY,nan,2016.0,1,0,1
IQ,NZ,2016.0,2,0,2
SI,NO,2004.0,1,0,1
SJ,DK,2017.0,1,0,1
NC,JP,2019.0,1,0,1
RE,IT,2017.0,1,0,1
PL,JO,2019.0,1,0,1
MN,RU,2002.0,1,0,1
PL,SO,2015.0,3,0,3
ES,BZ,2011.0,1,0,1
AZ,OM,2008.0,1,0,1
IE,HN,2014.0,1,0,1
MW,RW,2010.0,1,0,1
TZ,MM,2013.0,2,0,2
RW,IR,2010.0,2,0,2
CZ,EG,2006.0,1,0,1
TW,HN,2016.0,1,0,1
JO,GR,2010.0,2,0,2
AT,CM,2010.0,1,0,1
SA,TT,2019.0,1,0,1
DO,PT,2020.0,1,0,1
MZ,IN,1999.0,1,0,1
MV,,2016.0,3,0,3
TG,BE,2015.0,1,0,1
NI,TH,2020.0,1,0,1
UG,BJ,2008.0,2,0,2
BJ,HT,2020.0,1,0,1
AM,CL,2015.0,1,0,1
KE,MA,1997.0,1,0,1
FR,BA,2004.0,1,0,1
CO,CN,2022.0,1,0,1
AU,SS,2001.0,1,0,1
KE,KH,2013.0,1,0,1
MA,BF,2016.0,1,0,1
LB,SD,2008.0,1,0,1
MX,MW,2017.0,1,0,1
MC,RW,2019.0,1,0,1
MA,UY,2003.0,1,0,1
PE,CA,2000.0,1,0,1
LK,IE,2021.0,1,0,1
TH,GF,2005.0,1,0,1
NG,LV,2017.0,1,0,1
MD,SA,2015.0,1,0,1
MA,DK,2008.0,1,0,1
NE,BE,2004.0,1,0,1
BD,PS,2016.0,1,0,1
CD,IR,2019.0,2,0,2
OM,CY,2020.0,1,0,1
MK,SD,2011.0,1,0,1
BZ,,2025.0,1,0,1
PK,GM,2017.0,1,0,1
PH,CH,2000.0,1,0,1
DE,LB,2008.0,1,0,1
RU,CO,2005.0,1,0,1
RO,IL,2011.0,1,0,1
AE,CD,2020.0,1,0,1
JO,SX,2019.0,1,0,1
SE,ER,2000.0,2,0,2
SA,TT,2017.0,1,0,1
KW,GR,2001.0,1,0,1
LK,ZA,2006.0,1,0,1
CZ,ZM,2009.0,1,0,1
UG,UY,2006.0,1,0,1
SA,JO,2000.0,1,0,1
JP,UZ,2022.0,1,0,1
AU,FJ,1997.0,1,0,1
AT,GT,2012.0,1,0,1
BF,PK,1999.0,1,0,1
ES,BY,1998.0,1,0,1
DE,AF,2010.0,1,0,1
AG,,2000.0,1,0,1
MA,SA,2004.0,1,0,1
AU,IQ,2005.0,1,0,1
PK,TR,2003.0,2,0,2
MY,NA,2006.0,1,0,1
ES,CI,2018.0,2,0,2
ES,MY,2000.0,1,0,1
DE,AF,2019.0,2,0,2
DZ,KE,2018.0,1,0,1
RW,FR,1998.0,1,0,1
AR,NO,2007.0,2,0,2
GE,NL,1999.0,1,0,1
SG,HR,2010.0,1,0,1
SG,OM,2017.0,1,0,1
IE,ID,2006.0,1,0,1
CI,,1998.0,1,0,1
UY,SE,2005.0,1,0,1
KE,DZ,2015.0,1,0,1
SI,MX,1998.0,1,0,1
UA,PS,2003.0,1,0,1
IR,TJ,2022.0,1,0,1
MY,HU,2000.0,1,0,1
BJ,NE,2013.0,1,0,1
CI,US,2006.0,2,0,2
GR,AM,2004.0,1,0,1
AE,TN,2018.0,2,0,2
CH,BA,2001.0,1,0,1
DK,SK,2023.0,2,0,2
NZ,RS,2021.0,1,0,1
EG,BJ,2021.0,1,0,1
KE,PH,2013.0,1,0,1
QA,AF,2020.0,1,0,1
NG,AT,2008.0,1,0,1
IQ,YE,2013.0,1,0,1
AU,BN,2003.0,1,0,1
CO,HU,2016.0,1,0,1
IN,PS,2022.0,1,0,1
UG,CM,2016.0,1,0,1
SV,PA,2020.0,1,0,1
DE,AZ,2009.0,1,0,1
NO,MZ,2020.0,1,0,1
TW,AR,1997.0,1,0,1
AM,IT,2023.0,1,0,1
ET,NE,2018.0,1,0,1
ID,TW,2008.0,1,0,1
PR,,2004.0,1,0,1
KZ,KH,2019.0,1,0,1
US,SC,2021.0,2,0,2
NA,IR,2022.0,1,0,1
RO,CO,2021.0,1,0,1
BA,UA,2012.0,1,0,1
EE,JP,2014.0,1,0,1
BR,NP,2006.0,1,0,1
AU,GD,2013.0,1,0,1
IT,SV,2017.0,1,0,1
LT,RS,2013.0,1,0,1
CH,NI,2022.0,1,0,1
TR,LV,2011.0,1,0,1
OM,NL,2021.0,1,0,1
PE,TW,2021.0,1,0,1
UG,JO,2015.0,1,0,1
PS,HU,2017.0,1,0,1
UG,TH,2012.0,1,0,1
,BZ,1996.0,2,0,2
GD,GB,2006.0,1,0,1
PL,JO,2017.0,1,0,1
ZW,IE,2008.0,1,0,1
CI,MA,2022.0,1,0,1
GB,RE,2010.0,2,0,2
SA,IL,2009.0,1,0,1
PH,PG,2016.0,1,0,1
XK,CZ,2017.0,1,0,1
TN,CN,2009.0,1,0,1
SG,PE,2008.0,1,0,1
AU,PS,2021.0,2,0,2
XK,FI,2013.0,1,0,1
TZ,NP,2001.0,1,0,1
XK,CZ,2019.0,2,0,2
JO,KW,2023.0,1,0,1
CH,CY,2005.0,1,0,1
IN,GD,2009.0,1,0,1
MX,RO,1999.0,1,0,1
UG,IE,2002.0,1,0,1
BW,PK,2019.0,1,0,1
CO,PL,1997.0,1,0,1
MA,GA,2016.0,1,0,1
KE,NE,2018.0,1,0,1
MW,LS,2019.0,1,0,1
NZ,HK,2015.0,1,0,1
GB,TN,2001.0,1,0,1
NG,MA,2015.0,1,0,1
BD,GE,2022.0,2,0,2
SV,BR,2020.0,1,0,1
AU,LU,2001.0,1,0,1
GE,NZ,2016.0,1,0,1
VG,JP,2002.0,1,0,1
CY,UZ,2019.0,1,0,1
ZM,US,2023.0,1,0,1
ZW,SZ,2013.0,1,0,1
CD,SG,2019.0,1,0,1
CD,ZA,2011.0,1,0,1
IN,ZM,2017.0,1,0,1
EG,PH,2018.0,1,0,1
BY,IR,2011.0,1,0,1
KZ,BR,2005.0,1,0,1
SE,AR,2023.0,1,0,1
IR,MX,2023.0,2,0,2
HR,CH,1999.0,1,0,1
JP,MU,2010.0,1,0,1
GB,CG,2007.0,1,0,1
SA,CO,1999.0,1,0,1
CG,CA,2022.0,1,0,1
BF,DE,2009.0,1,0,1
MZ,ID,2012.0,1,0,1
SE,MA,2001.0,1,0,1
AE,FR,2023.0,1,0,1
NC,GB,2022.0,1,0,1
AL,PL,2006.0,1,0,1
LB,GF,2016.0,1,0,1
TG,BJ,2013.0,1,0,1
MM,TH,2002.0,1,0,1
ZM,FR,2012.0,1,0,1
CH,CF,2021.0,1,0,1
MD,BY,2008.0,1,0,1
US,PE,2012.0,107,65,42
US,NO,2016.0,190,154,36
CA,US,2010.0,3039,3045,-6
CA,US,2017.0,3752,3415,337
IN,US,2018.0,3188,2934,254
TW,JP,2019.0,104,82,22
GB,US,2003.0,4104,3854,250
CN,US,2007.0,4531,7096,-2565
GB,IE,2018.0,532,458,74
NZ,AU,2008.0,171,102,69
US,CH,2018.0,1008,942,66
US,CN,2021.0,5667,4053,1614
AR,BR,1998.0,30,22,8
PL,CZ,2017.0,86,56,30
DK,CA,2016.0,49,38,11
NL,DE,2009.0,291,294,-3
DE,GB,2014.0,923,981,-58
IL,GB,2005.0,44,34,10
CA,US,2019.0,3985,3614,371
CR,ES,2019.0,59,71,-12
FR,IT,2008.0,220,315,-95
JP,IE,2009.0,26,25,1
AT,DE,2019.0,677,796,-119
AU,FR,2018.0,136,127,9
NL,PE,2016.0,3,2,1
BE,IE,2018.0,27,16,11
GB,BR,2018.0,233,296,-63
SG,CN,2014.0,485,457,28
US,IL,2009.0,390,494,-104
VN,US,2021.0,121,155,-34
DE,CA,2016.0,287,319,-32
KR,IN,2010.0,109,140,-31
BR,AR,2001.0,40,32,8
BR,CL,2012.0,54,71,-17
CN,TW,2004.0,622,1006,-384
CR,ES,2017.0,71,54,17
TW,CN,2005.0,1096,578,518
KR,IN,2017.0,177,248,-71
US,IN,2013.0,2509,2027,482
CL,ES,2012.0,320,328,-8
HK,CN,2018.0,148,135,13
KR,JP,2018.0,386,399,-13
GB,DE,2004.0,473,536,-63
CN,JP,2016.0,396,528,-132
BE,TR,2016.0,17,18,-1
GB,nan,2022.0,33,46,-13
ES,PT,2005.0,63,57,6
MX,GT,2015.0,12,7,5
ES,VE,2020.0,49,67,-18
CA,DE,2022.0,136,155,-19
nan,ES,2017.0,60,76,-16
US,FR,2004.0,918,1038,-120
TW,CN,2002.0,816,563,253
ES,FI,2006.0,6,6,0
AT,DE,2010.0,445,499,-54
US,TR,2008.0,337,318,19
CA,IE,2018.0,166,178,-12
CW,NL,2002.0,7,3,4
CW,NL,2005.0,13,4,9
NL,CW,2013.0,17,23,-6
CN,PG,2014.0,1,1,0
CL,DE,2007.0,24,28,-4
IL,US,2016.0,574,532,42
AR,FR,2011.0,47,135,-88
SA,KW,2020.0,31,38,-7
FI,BE,2011.0,8,7,1
BR,NO,2002.0,12,6,6
FR,PT,2002.0,26,17,9
BE,IT,2014.0,120,178,-58
SE,DE,2021.0,214,190,24
CR,PY,2018.0,1,1,0
ID,JP,2022.0,87,78,9
US,SG,2011.0,345,290,55
CO,CL,2022.0,96,92,4
SE,FI,2019.0,112,118,-6
ES,CR,2022.0,19,23,-4
DE,LU,2020.0,51,37,14
CO,ES,2005.0,126,138,-12
IT,EC,2019.0,15,7,8
IS,SE,2018.0,28,18,10
IE,DK,2015.0,11,6,5
AR,AU,2002.0,1,2,-1
AR,BR,1997.0,25,14,11
FR,BE,2012.0,318,279,39
TW,ID,2013.0,12,13,-1
PE,BR,2020.0,62,90,-28
KE,GB,2011.0,21,27,-6
IE,GB,2009.0,259,313,-54
IL,AU,2020.0,14,17,-3
SG,BR,2004.0,1,1,0
TH,JP,2001.0,19,26,-7
JP,IT,2007.0,54,58,-4
TW,JP,2017.0,100,103,-3
DE,TR,2010.0,59,65,-6
NL,AU,2009.0,73,53,20
ES,IT,2013.0,236,251,-15
KR,IN,2019.0,181,272,-91
UY,GB,2014.0,6,4,2
FR,TR,1997.0,6,1,5
ES,PE,2003.0,24,25,-1
US,AR,2007.0,174,205,-31
PT,nan,2003.0,6,10,-4
JP,IN,2016.0,135,150,-15
RU,US,2000.0,322,206,116
TW,NZ,2017.0,7,8,-1
FR,MT,2017.0,3,2,1
US,CZ,2011.0,150,138,12
GB,TR,2005.0,35,27,8
JP,ID,2012.0,131,43,88
EG,JP,2007.0,31,60,-29
LB,FR,2021.0,74,64,10
ET,KR,2018.0,125,87,38
ES,UA,2010.0,4,3,1
BD,EG,2013.0,3,3,0
DE,CH,2009.0,813,651,162
US,HU,2006.0,92,95,-3
SE,FI,2010.0,92,92,0
MY,IN,2021.0,103,79,24
AU,DE,2005.0,109,147,-38
ID,nan,2020.0,78,92,-14
FR,AU,2019.0,137,129,8
SA,AU,2019.0,40,61,-21
MX,HN,2011.0,11,18,-7
DE,TR,2019.0,84,132,-48
CN,CH,2020.0,93,100,-7
PE,EC,2022.0,13,18,-5
TR,DE,2018.0,122,79,43
GB,VE,2018.0,2,9,-7
ES,FR,2011.0,274,268,6
IN,TZ,2022.0,5,1,4
PL,NL,2000.0,6,4,2
US,VN,2021.0,155,121,34
DK,CN,2018.0,67,57,10
AT,DE,2017.0,650,690,-40
EG,NL,2013.0,6,6,0
LU,US,2012.0,15,19,-4
AU,TW,2007.0,26,23,3
JP,BE,2006.0,24,22,2
AR,US,2015.0,215,280,-65
IR,TR,2022.0,38,12,26
PL,FR,2008.0,47,38,9
GB,AT,2020.0,144,113,31
FR,AR,2017.0,86,105,-19
DK,IN,2015.0,24,30,-6
GB,AR,2019.0,46,55,-9
ES,GR,2015.0,17,22,-5
IN,LK,2019.0,36,34,2
PR,KR,2001.0,38,19,19
AR,CL,2007.0,37,44,-7
IT,US,2020.0,1025,965,60
MX,AR,2012.0,111,104,7
IN,AU,2020.0,252,213,39
CH,CN,2020.0,100,93,7
AU,IE,2021.0,105,82,23
FR,EG,2014.0,26,19,7
TR,CN,2015.0,107,30,77
CN,QA,2012.0,15,11,4
nan,FR,2008.0,197,157,40
FR,CH,2009.0,351,312,39
DE,IR,2023.0,2,2,0
ZA,SN,2020.0,3,2,1
VN,CN,2006.0,44,12,32
FR,TN,1998.0,42,12,30
FR,TR,1998.0,7,2,5
GB,NA,2016.0,2,3,-1
CA,CN,2004.0,282,256,26
EG,JO,2012.0,3,11,-8
IN,ZA,2016.0,89,66,23
DE,AU,2022.0,116,144,-28
BE,ID,2020.0,10,9,1
JP,DE,2014.0,201,207,-6
TR,JP,2018.0,71,15,56
IT,CU,2006.0,3,3,0
BG,CN,2016.0,9,6,3
CN,ES,2022.0,52,36,16
CH,TR,2017.0,19,24,-5
ES,BE,2015.0,106,58,48
CA,NO,2009.0,24,6,18
NL,GB,2006.0,229,186,43
CN,NO,2018.0,34,37,-3
UY,BR,2000.0,12,10,2
MX,VE,2011.0,40,44,-4
IL,CU,2015.0,2,1,1
AT,CA,2018.0,23,32,-9
CH,GR,2015.0,24,48,-24
HU,RO,2020.0,56,36,20
GB,EG,1998.0,9,7,2
BD,NO,2019.0,8,23,-15
TR,MM,2022.0,12,7,5
FR,AR,2019.0,131,109,22
EG,MY,2012.0,24,20,4
ZA,AU,2019.0,93,56,37
CR,PT,2020.0,3,2,1
DE,BE,2015.0,154,135,19
FR,IL,2003.0,20,29,-9
GR,CN,2018.0,10,11,-1
PK,IQ,2013.0,5,2,3
PL,GB,2013.0,91,85,6
KR,CH,2014.0,17,15,2
GR,US,2000.0,80,114,-34
AU,SG,2007.0,53,71,-18
VG,US,2016.0,21,7,14
CO,VE,2021.0,19,27,-8
NG,JP,2020.0,26,22,4
IT,AU,2012.0,54,58,-4
LV,SE,2020.0,2,4,-2
RS,DE,2021.0,20,17,3
AU,DE,2002.0,97,82,15
GR,AT,2016.0,8,2,6
KE,SE,2020.0,6,8,-2
IN,NZ,2017.0,46,32,14
AF,JP,2021.0,4,1,3
ID,NL,2018.0,35,63,-28
CA,ID,2011.0,9,3,6
ES,PT,2002.0,67,41,26
ID,IQ,2010.0,3,1,2
IR,US,2023.0,26,8,18
PL,CZ,2019.0,105,86,19
BA,RS,2013.0,31,35,-4
FI,NL,2012.0,40,34,6
UG,FR,2013.0,3,7,-4
BD,PL,2021.0,4,3,1
MX,PE,1998.0,13,18,-5
IT,FI,2022.0,21,19,2
AE,JO,2012.0,7,11,-4
BE,CL,2021.0,8,18,-10
DK,GB,2022.0,78,108,-30
NL,RO,2018.0,12,7,5
DE,CR,2006.0,1,1,0
nan,SG,2017.0,5,10,-5
IT,CN,2009.0,43,29,14
ZW,CH,2008.0,3,1,2
CM,KE,2021.0,5,6,-1
CA,RO,2015.0,14,15,-1
NG,MY,2015.0,45,81,-36
PL,CZ,2010.0,37,31,6
IT,CH,2005.0,158,112,46
TW,JP,2010.0,63,76,-13
AU,IN,2022.0,92,173,-81
FI,TR,2009.0,3,3,0
JP,ZM,2020.0,5,1,4
IN,IE,2001.0,5,5,0
IE,NZ,2006.0,9,11,-2
LI,CH,2018.0,1,1,0
nan,US,2012.0,301,291,10
PL,UA,2018.0,59,60,-1
PH,CN,1999.0,15,2,13
GB,MX,2015.0,69,74,-5
AU,PH,2000.0,8,3,5
RU,TJ,2019.0,72,42,30
CH,ML,2021.0,4,1,3
US,SA,2013.0,208,91,117
CA,CH,1998.0,48,38,10
FI,ES,2018.0,22,27,-5
LK,JP,2021.0,8,7,1
AU,KR,2022.0,37,32,5
RU,LT,2016.0,6,11,-5
HU,CH,2019.0,22,16,6
CN,ML,2018.0,2,1,1
PF,FR,2017.0,13,7,6
JP,MN,2020.0,10,7,3
KR,NP,2018.0,16,11,5
QA,CN,2020.0,37,31,6
LT,UA,2019.0,3,2,1
JP,AU,2022.0,41,27,14
ES,NL,2016.0,142,91,51
UA,FR,2011.0,16,14,2
TH,FR,2016.0,18,19,-1
BE,CZ,2000.0,5,2,3
BI,GB,2014.0,2,2,0
GB,MY,2007.0,82,25,57
GB,TR,2002.0,55,20,35
CN,PH,2004.0,11,15,-4
NL,FI,2014.0,34,34,0
KR,PR,2013.0,38,26,12
AE,GB,2016.0,34,42,-8
IN,NZ,2019.0,46,43,3
IT,AM,2011.0,28,8,20
BR,BE,2012.0,54,77,-23
GB,BN,2004.0,5,1,4
SE,IS,2012.0,19,12,7
IN,NL,1998.0,10,8,2
IQ,SA,2020.0,43,43,0
PE,CO,2016.0,80,83,-3
JO,IQ,2014.0,5,4,1
BR,MT,2019.0,5,2,3
TR,GB,2022.0,67,69,-2
AU,OM,2017.0,6,4,2
CZ,RU,2022.0,28,72,-44
KR,QA,2014.0,1,2,-1
MY,TR,2020.0,13,8,5
MY,TH,2021.0,9,4,5
UA,DE,2014.0,38,19,19
IT,nan,2022.0,40,23,17
RU,SE,2015.0,24,27,-3
CO,ES,2002.0,82,66,16
BE,JP,2006.0,22,24,-2
RU,IL,2018.0,29,62,-33
DE,GH,2018.0,18,13,5
CN,RU,2021.0,49,70,-21
CA,KE,2017.0,13,10,3
SE,FI,2017.0,91,120,-29
JO,MY,2021.0,11,13,-2
ES,ZA,2022.0,9,6,3
TW,CA,2012.0,59,36,23
CO,PA,2013.0,9,14,-5
RU,BG,2022.0,76,21,55
PA,US,2021.0,42,32,10
TH,MY,2018.0,11,18,-7
BE,MX,2008.0,10,2,8
VE,US,2022.0,17,13,4
TW,DE,2002.0,14,10,4
MY,IT,2018.0,48,47,1
AZ,CN,2019.0,10,3,7
TW,DE,2005.0,14,13,1
RS,ME,2021.0,27,17,10
CL,CH,2007.0,6,5,1
DE,RU,2003.0,124,186,-62
RS,BA,2014.0,23,33,-10
TH,GB,2015.0,33,89,-56
DE,ID,2009.0,16,3,13
CN,ID,2022.0,84,118,-34
FR,MQ,2019.0,19,17,2
GB,KE,2022.0,28,24,4
IN,MY,2003.0,10,10,0
CU,MX,2009.0,56,23,33
RS,IT,2015.0,9,14,-5
FR,SG,2016.0,45,23,22
KZ,PL,2021.0,7,1,6
RU,TN,2015.0,5,1,4
CZ,CN,2022.0,14,17,-3
SA,CA,2020.0,75,126,-51
ZA,AU,2017.0,71,62,9
MY,PK,2022.0,68,75,-7
BD,KR,2008.0,8,7,1
PK,NP,2019.0,4,3,1
TZ,KE,2020.0,10,15,-5
FR,AR,2010.0,92,39,53
EG,SA,2007.0,72,49,23
IT,NL,2023.0,8,8,0
TZ,DE,2022.0,2,1,1
NG,KE,2021.0,14,2,12
BD,CN,2014.0,90,91,-1
CA,TR,2015.0,29,20,9
NG,CA,2022.0,17,7,10
AT,CZ,2018.0,28,36,-8
FI,IR,2013.0,7,10,-3
SY,DE,2014.0,2,5,-3
CH,PH,2008.0,3,3,0
FR,MX,2016.0,58,53,5
TR,NO,2013.0,14,4,10
FR,GR,2012.0,26,37,-11
AR,CA,2011.0,18,21,-3
BE,nan,2007.0,17,26,-9
HR,SI,2013.0,36,17,19
NO,ES,2009.0,16,18,-2
NO,DK,2012.0,57,93,-36
PL,GR,2006.0,11,10,1
DE,DZ,2016.0,7,3,4
NZ,CA,2001.0,34,26,8
RU,TJ,2017.0,25,35,-10
BD,MA,2012.0,8,4,4
KR,ET,2023.0,31,15,16
HU,FR,2008.0,23,23,0
DE,TR,2017.0,75,112,-37
IL,NL,2011.0,13,14,-1
BD,PK,2020.0,58,46,12
NO,RU,2009.0,13,25,-12
RS,GB,2002.0,7,5,2
OM,SA,2008.0,2,2,0
KR,AU,2012.0,37,35,2
DE,GA,2020.0,3,5,-2
NL,NA,2013.0,2,1,1
AR,PK,2015.0,13,20,-7
IN,AT,2015.0,16,8,8
AT,TR,2003.0,4,4,0
MX,TN,2013.0,2,3,-1
CA,SK,2008.0,4,8,-4
DE,HR,2011.0,17,12,5
GR,NL,2003.0,10,8,2
FR,IE,2006.0,34,23,11
US,ZW,2015.0,6,14,-8
PL,IL,2007.0,8,1,7
SE,IQ,2021.0,3,3,0
PY,CL,2014.0,1,3,-2
DK,FI,2013.0,22,10,12
SK,CN,2018.0,6,4,2
RS,SI,2018.0,14,21,-7
CR,ES,2010.0,24,30,-6
EG,KE,2012.0,1,1,0
CZ,NL,2021.0,15,9,6
CA,NG,2012.0,5,5,0
RU,PL,2014.0,20,32,-12
FR,PK,2011.0,21,7,14
HU,CH,2017.0,26,13,13
GE,RU,2013.0,6,2,4
MX,KE,2021.0,1,1,0
RU,ES,1998.0,12,9,3
IN,BR,2011.0,24,20,4
FR,IR,2011.0,35,27,8
AU,ZA,2016.0,60,82,-22
DE,CU,2018.0,5,6,-1
KR,PH,2015.0,8,6,2
RW,ZM,2014.0,3,1,2
CN,IT,2008.0,31,41,-10
ES,SV,2016.0,8,2,6
SJ,NO,2013.0,12,7,5
TZ,NL,2019.0,5,4,1
AT,CO,2016.0,4,2,2
PK,CA,2011.0,21,25,-4
AU,ES,2016.0,49,89,-40
QA,JP,2007.0,3,2,1
TR,TW,2013.0,7,2,5
SG,CA,2014.0,44,50,-6
SG,DE,2011.0,17,50,-33
IT,AZ,2022.0,7,4,3
DE,LV,2020.0,4,4,0
FR,EC,2015.0,9,6,3
FI,CH,2011.0,23,15,8
RS,XK,2012.0,11,10,1
KW,IN,2004.0,9,8,1
nan,PT,2015.0,31,22,9
CO,AU,2010.0,10,2,8
RU,AZ,2006.0,6,5,1
AE,PK,2018.0,25,17,8
UA,CZ,2018.0,32,39,-7
DE,SI,2003.0,5,8,-3
US,KH,2018.0,5,4,1
IN,JO,2011.0,1,1,0
DE,UA,2004.0,21,39,-18
RU,ZA,2014.0,8,5,3
EG,DE,2001.0,12,18,-6
SG,ES,2008.0,2,4,-2
GE,nan,2010.0,6,9,-3
PH,NG,2021.0,2,1,1
BE,MY,2018.0,2,4,-2
DK,MY,2015.0,2,3,-1
BR,IN,2020.0,31,36,-5
GB,EG,1997.0,7,2,5
LB,GB,2011.0,4,6,-2
TR,AE,2022.0,6,4,2
PT,FR,2001.0,16,26,-10
CD,FR,2019.0,7,8,-1
IN,HU,2013.0,9,8,1
UA,CA,2020.0,9,6,3
IT,TR,2012.0,21,10,11
AT,BE,2016.0,15,18,-3
SE,JP,2022.0,21,19,2
KE,UG,2020.0,17,22,-5
CH,SE,2012.0,67,46,21
TR,CA,2018.0,35,24,11
DZ,FR,1999.0,9,20,-11
ES,CN,2006.0,41,32,9
nan,ES,2019.0,68,82,-14
KR,EG,2016.0,15,6,9
FI,HR,2017.0,6,3,3
PK,UA,2021.0,9,4,5
ID,IQ,2019.0,11,11,0
AR,AU,2005.0,3,4,-1
NL,SI,2013.0,3,3,0
TZ,FR,2011.0,9,1,8
DK,SE,2004.0,52,66,-14
CA,KE,2019.0,14,8,6
BE,IL,2013.0,6,4,2
UG,ES,2017.0,2,1,1
LU,PL,2018.0,3,4,-1
IQ,DE,2020.0,11,9,2
RS,CZ,2021.0,7,6,1
BG,IT,2005.0,9,6,3
AE,SA,2019.0,32,53,-21
AU,HU,2014.0,6,9,-3
ID,IQ,2017.0,7,3,4
KR,RU,2003.0,7,11,-4
US,JO,2007.0,47,28,19
SE,CH,2018.0,65,93,-28
TW,IE,2011.0,2,2,0
ID,TR,2022.0,12,5,7
ID,LB,2022.0,4,3,1
JP,MM,2019.0,26,5,21
ES,NO,2020.0,43,26,17
nan,DE,1998.0,12,17,-5
ES,SA,2018.0,14,2,12
ES,DZ,2019.0,6,4,2
CZ,CA,2013.0,11,14,-3
GB,QA,2022.0,16,17,-1
AU,EE,2020.0,4,2,2
MA,SA,2020.0,9,11,-2
IE,NL,2021.0,31,26,5
NO,ID,2021.0,1,3,-2
nan,IL,2015.0,30,25,5
BE,CH,2013.0,93,73,20
AU,CH,2011.0,85,73,12
GH,SN,2019.0,1,1,0
KE,BE,2018.0,6,5,1
US,LV,2022.0,5,7,-2
CO,AU,2017.0,17,18,-1
nan,SG,2019.0,12,13,-1
IT,GR,2012.0,21,20,1
JP,IL,2016.0,11,11,0
BR,EC,2021.0,34,43,-9
NL,ET,2019.0,17,11,6
FR,CG,2015.0,20,18,2
IL,GB,2002.0,33,26,7
CH,RU,2009.0,18,19,-1
PL,TW,2012.0,4,6,-2
MD,FR,2014.0,47,42,5
FR,MC,2006.0,3,4,-1
AE,SA,2017.0,11,35,-24
NG,ZA,2007.0,10,13,-3
CA,CH,1997.0,30,25,5
FR,PF,2019.0,20,7,13
ID,BD,2021.0,49,41,8
MY,ET,2018.0,4,2,2
DZ,US,2016.0,31,59,-28
CM,ID,2017.0,3,2,1
IQ,QA,2018.0,2,10,-8
UA,UZ,2021.0,2,2,0
TR,US,2000.0,164,194,-30
NL,IQ,2022.0,1,2,-1
IN,BW,2019.0,3,4,-1
DK,ES,2004.0,20,30,-10
CZ,BY,2000.0,4,5,-1
BG,AT,2008.0,6,6,0
IL,CH,2006.0,12,4,8
BE,PL,2004.0,16,11,5
CN,MX,1999.0,2,2,0
FR,NC,2022.0,8,6,2
UY,CL,2005.0,5,7,-2
CZ,LV,2020.0,2,2,0
DE,DK,2006.0,83,63,20
SI,NL,1997.0,2,1,1
GB,SA,2007.0,31,21,10
IN,DE,2001.0,89,67,22
CA,PK,2013.0,39,28,11
US,MK,2015.0,14,4,10
BE,RS,2013.0,6,6,0
GH,SN,2017.0,1,1,0
SE,BR,2014.0,11,25,-14
ET,IR,2016.0,2,1,1
IR,ET,2020.0,3,3,0
CM,DE,2013.0,4,2,2
IQ,IT,2013.0,2,2,0
SK,RU,2015.0,10,19,-9
CZ,BR,2014.0,4,8,-4
CN,MA,2016.0,3,1,2
GM,GB,2013.0,12,5,7
KE,PK,1999.0,1,1,0
IL,RU,2002.0,9,23,-14
AR,SE,2014.0,4,13,-9
CZ,RO,2021.0,5,1,4
US,RO,2000.0,20,31,-11
RO,US,2001.0,44,25,19
MK,GR,2015.0,12,7,5
TR,ES,2008.0,7,2,5
US,UY,2011.0,21,11,10
AT,GB,1998.0,22,20,2
nan,SE,2012.0,46,34,12
EE,US,2014.0,21,6,15
IT,BG,2020.0,6,6,0
CA,SE,2013.0,57,52,5
TW,NZ,2019.0,5,8,-3
JP,MM,2010.0,10,3,7
ES,JP,1997.0,9,9,0
SK,IN,2012.0,2,3,-1
ES,PA,2008.0,5,11,-6
NO,JP,2015.0,11,11,0
BE,GB,1999.0,57,57,0
BD,JP,1997.0,2,6,-4
MX,FR,2012.0,39,55,-16
nan,ES,2010.0,29,38,-9
AU,BE,2006.0,17,24,-7
GB,AR,2010.0,20,23,-3
LB,CH,2015.0,6,4,2
PF,FR,2019.0,7,20,-13
FI,BR,2015.0,8,5,3
BR,TL,2018.0,3,1,2
IN,KE,2009.0,5,3,2
MY,IQ,2011.0,8,7,1
nan,AU,2009.0,18,33,-15
CL,PH,2009.0,5,1,4
IE,CH,2012.0,12,11,1
DE,BR,1998.0,39,26,13
JP,TR,1998.0,34,21,13
PK,NP,2017.0,4,5,-1
CO,AU,2019.0,21,14,7
HU,US,2021.0,58,57,1
IN,NZ,2010.0,22,18,4
ZA,NL,1999.0,8,10,-2
RS,FR,2000.0,3,2,1
BD,FR,2006.0,3,1,2
MA,CH,2017.0,5,4,1
GB,SS,2009.0,7,13,-6
AR,VE,2014.0,10,18,-8
VN,NL,2012.0,5,6,-1
TN,ES,2014.0,3,7,-4
AO,IT,2002.0,3,5,-2
SK,ES,2017.0,7,5,2
AU,DK,2003.0,11,17,-6
MY,AE,2002.0,3,2,1
IN,NL,1997.0,6,7,-1
BR,CR,2020.0,15,21,-6
KR,NL,2003.0,5,5,0
PK,AE,2003.0,2,2,0
NP,PK,2015.0,4,11,-7
BR,NL,1999.0,10,13,-3
VN,SE,2019.0,4,4,0
UA,ZA,2016.0,2,1,1
GR,MK,2015.0,7,12,-5
IE,FR,2023.0,4,1,3
IN,NP,2004.0,25,19,6
BG,IT,2002.0,3,5,-2
CZ,UZ,2022.0,1,3,-2
JP,LU,2015.0,2,1,1
NO,GR,2006.0,1,3,-2
IN,LK,2017.0,25,13,12
NL,PL,2000.0,4,6,-2
PK,nan,2005.0,1,1,0
MX,BO,2022.0,5,3,2
MX,MY,2020.0,1,4,-3
NZ,US,2023.0,10,14,-4
PK,nan,2002.0,2,2,0
KR,ES,2007.0,2,1,1
GE,US,1997.0,40,50,-10
CN,LK,2022.0,4,7,-3
US,AE,2023.0,5,3,2
CL,CO,2000.0,14,16,-2
UY,EC,2017.0,3,3,0
ID,PL,2018.0,4,9,-5
HU,CH,2010.0,21,9,12
MY,GB,1999.0,14,33,-19
IL,ZA,2020.0,4,4,0
ES,CU,1998.0,27,24,3
AT,CH,2006.0,65,52,13
nan,AR,2000.0,8,13,-5
AU,IR,2009.0,39,33,6
PK,CH,2022.0,12,19,-7
AR,BE,1999.0,2,3,-1
NG,AU,2021.0,15,4,11
ES,JP,1998.0,18,11,7
PT,RU,2008.0,7,3,4
AE,SD,2017.0,6,4,2
UA,JP,2000.0,5,5,0
BR,SI,2011.0,2,1,1
RU,NO,2001.0,9,5,4
GT,AR,2012.0,1,3,-2
FR,PF,2017.0,7,13,-6
AE,SD,2019.0,3,13,-10
SE,ZA,2022.0,10,18,-8
CA,PH,2013.0,13,10,3
TH,DK,2011.0,4,1,3
MY,BD,2009.0,8,16,-8
CA,NZ,2023.0,2,2,0
RU,TW,2012.0,21,27,-6
BD,PH,2014.0,1,4,-3
PL,BH,2013.0,5,2,3
RE,FR,2009.0,14,18,-4
NG,PK,2013.0,11,13,-2
US,BG,1999.0,13,26,-13
FR,PF,2010.0,12,7,5
ID,FR,2002.0,2,3,-1
AU,ID,1999.0,7,1,6
ES,DZ,2017.0,10,4,6
TR,AZ,2020.0,27,15,12
CZ,IT,2004.0,10,6,4
IR,CA,2001.0,7,22,-15
BO,FR,2006.0,2,1,1
MX,NI,2016.0,4,7,-3
BE,SY,2005.0,1,1,0
NZ,ZA,2012.0,13,8,5
nan,UA,2003.0,18,14,4
FI,LT,2006.0,2,1,1
FR,GF,2016.0,21,18,3
RU,FI,2000.0,16,14,2
IT,MD,2017.0,3,2,1
US,UG,2009.0,22,26,-4
PH,AU,2004.0,7,8,-1
EC,CA,2011.0,2,1,1
IL,RU,2005.0,14,13,1
CU,CR,2005.0,4,1,3
IE,HU,2008.0,3,2,1
CH,GH,2020.0,3,5,-2
US,BW,2008.0,7,7,0
nan,DK,2021.0,10,13,-3
DE,CY,2020.0,11,4,7
NO,IS,2015.0,8,6,2
GB,LY,2012.0,10,1,9
BI,US,2017.0,5,2,3
CG,BJ,2021.0,2,2,0
CZ,IN,2004.0,8,13,-5
US,ET,2001.0,5,15,-10
IR,CH,2013.0,34,11,23
DE,IS,2013.0,5,5,0
GB,VG,2016.0,5,5,0
MW,BW,2005.0,1,1,0
IN,FR,1997.0,11,21,-10
FR,NG,2008.0,5,3,2
ES,PL,2008.0,7,19,-12
KZ,JP,2013.0,1,3,-2
CZ,FR,2000.0,12,19,-7
HU,CZ,2011.0,4,5,-1
FR,SN,2007.0,24,25,-1
MY,VN,2020.0,12,2,10
ES,UA,2019.0,4,4,0
DE,RO,2014.0,43,43,0
CZ,IE,2007.0,5,2,3
LB,BE,2018.0,8,7,1
CO,IL,2013.0,1,2,-1
RU,RS,2016.0,8,9,-1
SE,PT,2021.0,10,12,-2
UA,IT,1999.0,2,5,-3
KH,PK,2015.0,2,1,1
TW,NZ,2010.0,5,4,1
nan,RO,2015.0,2,1,1
JP,AM,1999.0,7,9,-2
IL,CN,2018.0,17,23,-6
DE,BR,1997.0,29,19,10
KZ,DE,2019.0,6,10,-4
DZ,ES,2009.0,2,2,0
US,PS,2014.0,9,4,5
MT,IT,2013.0,2,2,0
AU,QA,2007.0,5,6,-1
ES,NZ,2012.0,17,10,7
TZ,NL,2010.0,1,1,0
NG,CM,2003.0,2,1,1
SE,ET,2004.0,3,1,2
KR,GR,2013.0,4,1,3
nan,SG,2010.0,5,8,-3
SD,BR,2007.0,6,5,1
nan,PL,2006.0,6,6,0
CR,US,1997.0,3,3,0
JO,EG,2013.0,14,10,4
NG,ET,2016.0,9,6,3
PE,CL,2012.0,20,61,-41
ES,IL,2009.0,7,24,-17
SG,PL,2012.0,3,3,0
FR,MQ,2017.0,12,24,-12
PT,CL,2020.0,10,15,-5
ID,US,1999.0,9,13,-4
BA,NL,2016.0,4,1,3
LB,BR,2009.0,5,3,2
ZW,RU,2009.0,5,3,2
BR,UA,2014.0,3,8,-5
TR,AT,2011.0,10,4,6
KR,IT,2016.0,7,13,-6
US,BI,2013.0,4,4,0
PH,CA,2007.0,6,7,-1
IN,KR,2000.0,27,16,11
BO,CO,2020.0,10,12,-2
IS,CA,2020.0,3,3,0
TN,PK,2014.0,3,2,1
BG,CA,2004.0,5,3,2
HU,KR,2014.0,3,1,2
EC,AU,2015.0,1,4,-3
FR,NO,2000.0,28,14,14
VE,BO,2012.0,2,1,1
SA,JP,2003.0,2,3,-1
AT,VN,2021.0,4,5,-1
CN,FI,2016.0,20,40,-20
JP,UY,2003.0,1,1,0
PE,DE,2002.0,4,3,1
AT,SG,2020.0,2,4,-2
PL,PK,2015.0,11,11,0
RS,DK,2004.0,4,1,3
SA,AU,2010.0,4,14,-10
MA,US,2003.0,11,6,5
TR,IN,2000.0,2,3,-1
BY,CZ,1997.0,4,2,2
LB,SA,2021.0,8,2,6
NZ,SG,2006.0,3,8,-5
GR,CY,1998.0,4,2,2
NL,NO,1997.0,10,6,4
BD,JP,1998.0,5,13,-8
MM,CN,2013.0,4,2,2
ET,JP,2022.0,2,5,-3
CN,GE,2007.0,5,1,4
CH,AE,2014.0,1,1,0
HR,TW,2003.0,3,1,2
ME,BA,2018.0,2,4,-2
EG,OM,2014.0,7,7,0
MD,CN,2019.0,4,2,2
IT,SG,2012.0,7,2,5
FR,BG,2000.0,7,10,-3
IT,LB,2020.0,22,11,11
TR,GR,2014.0,2,10,-8
NZ,NL,2021.0,13,8,5
DK,RU,2021.0,12,12,0
NO,US,2023.0,1,13,-12
TH,PH,2020.0,9,1,8
FR,BY,2020.0,3,1,2
NG,IR,2013.0,6,5,1
HU,PE,2020.0,1,3,-2
RO,GB,2006.0,15,11,4
CO,BG,2018.0,1,1,0
AL,US,2011.0,4,6,-2
BE,IR,2014.0,22,23,-1
SG,CH,2013.0,14,13,1
FR,CL,1997.0,5,6,-1
MZ,PT,2021.0,8,5,3
PE,UY,2021.0,2,5,-3
AU,OM,2019.0,9,6,3
RU,ES,1997.0,5,11,-6
LV,IN,2017.0,1,2,-1
AT,GB,1997.0,13,18,-5
JO,CA,2012.0,7,17,-10
SK,CZ,2003.0,41,26,15
FI,SI,2011.0,3,1,2
IN,BW,2010.0,3,3,0
JP,SD,2009.0,2,2,0
SE,SK,2006.0,4,1,3
CA,PE,2013.0,4,5,-1
GR,CY,1997.0,2,1,1
DE,IN,2023.0,5,11,-6
ML,FR,2013.0,7,10,-3
KR,FI,2007.0,10,9,1
TZ,BE,2019.0,3,4,-1
ES,ID,2015.0,12,9,3
ES,PH,1999.0,6,2,4
ZA,BW,2022.0,4,7,-3
EC,BR,2005.0,1,5,-4
FR,RW,2019.0,2,1,1
GA,FR,1997.0,2,3,-1
SA,SY,2022.0,5,3,2
DZ,DE,2022.0,2,2,0
IN,EG,2012.0,4,9,-5
BR,MT,2010.0,3,1,2
BY,PL,2005.0,7,2,5
ES,LU,2012.0,6,1,5
SA,AE,2001.0,7,2,5
BG,BE,2014.0,5,1,4
AU,JO,2021.0,4,3,1
BE,ET,2012.0,2,3,-1
IN,EE,2017.0,6,2,4
IT,EC,2017.0,9,4,5
IT,JO,2019.0,4,3,1
OM,JP,2015.0,1,2,-1
AZ,ID,2013.0,8,7,1
BR,PH,2012.0,6,5,1
CZ,BE,2006.0,6,4,2
MM,JP,2013.0,3,9,-6
BE,CY,2017.0,2,1,1
CF,FR,2017.0,2,1,1
NO,ZA,2007.0,4,2,2
US,NC,2012.0,1,2,-1
AU,IT,2001.0,24,19,5
MD,US,2014.0,4,4,0
KZ,CN,2021.0,7,9,-2
SG,GR,2021.0,2,3,-1
LU,BE,2006.0,7,9,-2
RU,TJ,2010.0,15,8,7
DE,KZ,2005.0,3,3,0
SE,AT,2003.0,6,13,-7
SA,SD,2007.0,5,4,1
ZA,AT,2003.0,1,2,-1
DZ,MA,2013.0,8,14,-6
PK,NG,2012.0,6,11,-5
IL,PL,2000.0,2,1,1
AU,CZ,2005.0,3,5,-2
LB,QA,2016.0,5,3,2
MX,PL,2013.0,8,6,2
KW,EG,2003.0,6,4,2
FI,MX,2009.0,1,3,-2
BD,SG,2001.0,1,1,0
QA,CA,2016.0,9,28,-19
EG,ID,2008.0,1,4,-3
MY,UA,2018.0,4,11,-7
PT,SE,2009.0,6,4,2
ST,BR,2004.0,12,22,-10
PK,NO,2002.0,2,1,1
MS,US,2017.0,1,2,-1
TN,BE,2008.0,2,1,1
SE,KR,2017.0,7,13,-6
PK,SE,2016.0,9,15,-6
IN,AR,2019.0,4,4,0
NP,BD,2013.0,6,9,-3
SG,IL,2014.0,6,4,2
FI,IT,1999.0,5,8,-3
GR,DK,2011.0,6,2,4
SG,BD,2001.0,1,1,0
IL,MX,2021.0,5,5,0
AU,OM,2010.0,4,2,2
SA,ZA,2018.0,5,8,-3
UA,TR,2013.0,1,3,-2
CR,BR,2011.0,10,8,2
NE,BE,2020.0,1,4,-3
CH,PE,2014.0,4,4,0
US,ZM,2018.0,13,16,-3
UY,EC,2019.0,7,5,2
CZ,GR,2004.0,2,2,0
ID,SD,2017.0,2,1,1
GA,DE,2017.0,5,4,1
US,LT,2020.0,6,8,-2
GB,MU,2005.0,3,2,1
KH,PH,2009.0,1,2,-1
LT,LV,2015.0,4,1,3
FR,TN,1997.0,11,10,1
GB,MU,2002.0,1,1,0
HU,UA,1999.0,2,1,1
AE,US,2002.0,10,23,-13
IN,LK,2010.0,8,6,2
TR,JO,2018.0,1,2,-1
CN,SL,2022.0,1,1,0
CY,TR,2023.0,2,4,-2
HU,PK,2021.0,6,2,4
US,OM,2022.0,10,9,1
CG,US,2012.0,1,1,0
nan,HN,2019.0,1,1,0
NI,nan,2020.0,1,1,0
JP,MX,2013.0,12,8,4
SK,ES,2019.0,6,4,2
HR,CN,2019.0,2,2,0
SI,AU,2006.0,3,1,2
PL,ES,2006.0,10,11,-1
IT,TW,2021.0,8,1,7
DZ,CH,2010.0,4,1,3
CY,AE,2022.0,3,3,0
TH,MA,2020.0,1,1,0
KW,SA,2007.0,1,4,-3
RO,CZ,2021.0,1,5,-4
SI,BA,2022.0,3,6,-3
VE,CO,1999.0,7,5,2
KZ,DE,2017.0,7,5,2
QA,ZA,2014.0,1,2,-1
TN,EG,2008.0,4,6,-2
IT,JO,2010.0,1,4,-3
CR,AU,2017.0,4,3,1
MX,PE,1997.0,3,4,-1
SA,nan,2017.0,3,5,-2
EC,AR,2007.0,2,5,-3
NL,NO,1998.0,9,3,6
AT,NZ,2018.0,2,6,-4
BG,NL,2016.0,1,5,-4
FR,CL,1998.0,7,7,0
BE,ZM,2000.0,1,1,0
CA,OM,2014.0,9,3,6
IT,MD,2010.0,5,1,4
TH,RU,2019.0,2,4,-2
FR,LT,2012.0,5,1,4
ID,AE,2015.0,2,3,-1
SA,AU,2017.0,25,69,-44
EG,SE,2002.0,1,2,-1
NL,TW,2020.0,10,9,1
SE,LI,2015.0,2,1,1
MS,GB,2010.0,1,1,0
KR,MY,2016.0,31,36,-5
SE,IE,2012.0,9,20,-11
AR,PE,2008.0,12,8,4
FR,BW,2006.0,2,1,1
PL,HK,2022.0,1,1,0
ES,AO,2013.0,1,1,0
UY,CL,2002.0,4,2,2
BE,TH,2021.0,3,2,1
IR,ZA,2013.0,6,1,5
RS,CN,2007.0,2,7,-5
EG,RU,2006.0,1,1,0
MK,CN,2006.0,2,10,-8
BG,UA,2006.0,3,3,0
BR,HR,2012.0,2,4,-2
US,KN,2018.0,5,4,1
IL,MD,2019.0,1,1,0
IR,AU,2000.0,3,11,-8
ES,UA,2017.0,3,5,-2
PG,CH,2014.0,1,3,-2
FR,HR,2015.0,7,4,3
AZ,US,2010.0,2,2,0
AR,GR,2019.0,1,1,0
SY,LB,2019.0,4,5,-1
RU,CU,2018.0,5,2,3
IN,AR,2010.0,1,2,-1
NO,CO,2021.0,1,5,-4
SY,LB,2017.0,2,2,0
BR,SG,2009.0,2,3,-1
OM,CA,2016.0,3,8,-5
NL,PT,2009.0,12,20,-8
NG,EG,2012.0,7,2,5
AU,AR,1999.0,3,1,2
CR,US,1998.0,7,4,3
IN,PL,2003.0,4,2,2
PT,MZ,2012.0,2,3,-1
MX,DK,2015.0,6,6,0
NA,GB,2009.0,1,1,0
MX,IN,1999.0,1,7,-6
CA,ET,2018.0,8,8,0
ZW,CN,2002.0,5,2,3
AT,NL,1998.0,9,5,4
PK,NP,2010.0,1,2,-1
IR,RO,2014.0,1,2,-1
RU,CO,2007.0,1,1,0
HR,JP,2010.0,4,3,1
AR,NO,2002.0,1,1,0
DE,FI,2023.0,3,5,-2
IN,EE,2019.0,2,6,-4
KR,TH,2007.0,2,6,-4
IT,MA,2003.0,10,5,5
MD,DE,2012.0,4,2,2
BD,NP,2012.0,8,3,5
LT,FR,2008.0,2,3,-1
GB,MW,2001.0,5,2,3
CN,ZA,2001.0,1,2,-1
AE,HU,2016.0,2,2,0
GE,nan,2019.0,3,6,-3
EG,PL,2003.0,2,1,1
CU,UY,2016.0,2,2,0
KE,ML,2020.0,3,2,1
LB,SE,2021.0,3,1,2
JP,AE,2009.0,2,3,-1
BA,MK,2020.0,1,2,-1
AT,AR,2008.0,1,3,-2
PT,NG,2019.0,2,2,0
SE,KR,2010.0,5,2,3
ZA,NG,2003.0,3,3,0
AZ,US,2019.0,6,1,5
SN,BF,2014.0,4,2,2
FR,TW,2008.0,19,13,6
PL,IN,2013.0,6,13,-7
PE,FR,2009.0,6,3,3
MX,CR,2003.0,9,11,-2
PT,RO,2014.0,5,2,3
UA,EC,2008.0,10,8,2
UG,PK,2018.0,3,1,2
UA,MZ,2012.0,2,3,-1
GH,ZM,2018.0,15,40,-25
RU,ID,2022.0,9,9,0
ES,LB,2013.0,1,3,-2
IT,XK,2013.0,1,1,0
SE,CO,2015.0,4,7,-3
US,PY,2022.0,3,10,-7
CI,NG,2018.0,1,2,-1
KH,US,2014.0,4,3,1
BE,BJ,2015.0,3,3,0
ET,IN,2013.0,7,17,-10
TW,CH,2012.0,9,2,7
IN,MK,2019.0,1,1,0
CM,ID,2019.0,4,3,1
MM,SG,2020.0,3,10,-7
ID,LU,2019.0,1,1,0
KE,TZ,2018.0,9,10,-1
NL,ET,2010.0,4,5,-1
AF,IR,2015.0,1,1,0
PS,GB,2008.0,2,1,1
CR,AR,2021.0,8,1,7
BH,FR,2020.0,2,1,1
PF,FR,2010.0,7,12,-5
KR,KZ,2010.0,1,1,0
RO,BR,2003.0,1,1,0
ID,FR,2005.0,1,5,-4
NL,TR,2007.0,11,10,1
JO,PS,2013.0,1,1,0
BR,GR,2015.0,3,6,-3
IR,RU,2000.0,3,1,2
LT,GB,2020.0,8,8,0
MA,CH,2019.0,4,5,-1
PL,VE,2013.0,2,1,1
PL,MZ,2005.0,2,11,-9
YE,CN,2019.0,2,2,0
KW,MA,2020.0,3,3,0
EC,VE,2006.0,1,4,-3
JO,NG,2019.0,2,1,1
nan,TW,2007.0,9,3,6
IL,CO,2007.0,2,1,1
UA,BE,2021.0,3,3,0
GF,FR,2023.0,1,2,-1
SE,UY,2008.0,2,2,0
ZA,BR,2021.0,6,11,-5
SG,NO,2005.0,2,2,0
AE,SA,2010.0,6,7,-1
KR,CY,2011.0,1,1,0
KE,FR,2008.0,3,6,-3
BW,KE,2008.0,2,1,1
MG,FR,2003.0,3,2,1
CI,DE,2014.0,1,2,-1
BY,PL,2002.0,1,1,0
GB,DZ,2012.0,4,2,2
JP,MM,2017.0,8,7,1
CW,BE,2016.0,1,2,-1
PH,BJ,2014.0,1,2,-1
BH,TZ,2003.0,2,2,0
NP,JP,1999.0,2,2,0
ID,GB,2006.0,3,7,-4
HR,XK,2016.0,2,5,-3
NL,SA,2012.0,3,1,2
CZ,ES,2022.0,15,10,5
US,ML,2003.0,3,2,1
CO,PT,2011.0,11,8,3
GB,LU,2003.0,3,1,2
SI,HR,2008.0,14,15,-1
IR,FR,2023.0,1,1,0
MX,CH,2000.0,4,2,2
VN,RU,2011.0,3,2,1
SA,KZ,2013.0,1,1,0
ZA,PK,2013.0,4,4,0
CM,GB,2011.0,3,5,-2
CA,VG,2012.0,3,1,2
AO,IT,2005.0,2,1,1
AR,GT,2021.0,4,2,2
BH,SA,1998.0,1,1,0
NG,IE,2013.0,2,3,-1
AU,BG,2010.0,2,1,1
CL,RS,2018.0,1,1,0
PK,HU,2011.0,1,4,-3
AZ,PL,1998.0,1,2,-1
KE,BW,2015.0,1,1,0
TJ,RU,2003.0,3,3,0
AU,NG,2014.0,5,4,1
JP,PS,2009.0,2,1,1
CI,BJ,2020.0,3,1,2
RO,AL,2017.0,1,1,0
ES,DZ,2010.0,2,1,1
RS,IE,2008.0,3,2,1
CA,LB,2006.0,3,6,-3
FR,UG,2015.0,4,5,-1
GB,ET,2005.0,1,1,0
RO,CA,2008.0,3,9,-6
AR,CR,2014.0,9,11,-2
AT,NL,1997.0,5,11,-6
CU,AR,2022.0,7,8,-1
CR,AU,2019.0,2,4,-2
PR,JP,2001.0,1,1,0
JP,CO,2011.0,4,11,-7
IN,BW,2017.0,2,2,0
CF,FR,2010.0,3,3,0
SY,AT,2017.0,1,1,0
EG,TR,2017.0,3,9,-6
BE,SG,2022.0,1,7,-6
JO,NG,2017.0,2,1,1
LT,DE,2007.0,5,2,3
ES,IS,2004.0,1,2,-1
TZ,BE,2010.0,1,3,-2
KE,CH,1998.0,2,1,1
NE,FR,2009.0,3,2,1
nan,SI,2012.0,2,1,1
FI,TH,2019.0,3,1,2
CA,LK,2022.0,2,4,-2
CL,BE,2001.0,1,3,-2
AZ,CN,2017.0,2,2,0
IT,PK,1999.0,1,2,-1
BE,MA,2022.0,4,4,0
DK,SD,2019.0,1,1,0
FR,TG,2015.0,6,3,3
UZ,KZ,2020.0,7,11,-4
HR,JP,2019.0,2,1,1
SN,CG,2018.0,2,1,1
MX,FI,2007.0,1,1,0
IN,OM,2004.0,2,5,-3
LB,MX,2020.0,1,1,0
ID,AR,2018.0,3,3,0
CL,CU,1997.0,1,1,0
AU,FI,2008.0,6,15,-9
SE,LT,2000.0,1,5,-4
EG,MR,2019.0,1,1,0
SD,US,2009.0,7,4,3
BJ,BE,2002.0,1,1,0
KR,MX,2004.0,1,1,0
MD,BE,2018.0,1,1,0
CL,NI,2017.0,1,2,-1
JP,BN,2018.0,2,2,0
PH,BR,2001.0,1,1,0
HR,NO,2001.0,1,1,0
SG,nan,2001.0,1,1,0
DE,BY,2015.0,5,4,1
MA,IR,2014.0,4,10,-6
AO,CN,2008.0,2,1,1
BF,BE,2007.0,1,2,-1
AE,TR,2018.0,6,8,-2
NG,CH,2001.0,1,1,0
CH,LT,2008.0,1,1,0
SG,ZA,2016.0,1,3,-2
ET,BE,2018.0,3,15,-12
SK,GR,2019.0,2,1,1
ZW,BW,2016.0,3,2,1
IE,AR,2021.0,1,2,-1
BR,CU,2011.0,6,27,-21
GE,DE,2009.0,3,9,-6
LI,AT,2013.0,1,3,-2
BE,LT,2011.0,2,1,1
NZ,JP,2022.0,5,5,0
CZ,ZA,2014.0,4,2,2
KZ,DE,2010.0,1,1,0
BD,NO,2017.0,1,9,-8
nan,DO,2018.0,1,2,-1
ID,SD,2019.0,3,4,-1
DE,TN,2013.0,9,2,7
TZ,NL,2017.0,1,5,-4
AT,BG,2021.0,3,1,2
MY,ES,2011.0,3,2,1
BE,RO,2003.0,1,5,-4
ZM,BW,2012.0,1,2,-1
LK,ES,2009.0,1,2,-1
AU,BG,2017.0,1,3,-2
CR,ID,2019.0,1,1,0
VE,AR,2003.0,3,3,0
ES,AD,2021.0,3,1,2
IN,CO,2013.0,2,7,-5
AU,RS,2008.0,4,8,-4
EG,DK,2003.0,1,1,0
UZ,IL,2009.0,1,1,0
CR,AU,2010.0,1,1,0
MY,AE,2005.0,2,2,0
UY,CU,2016.0,2,2,0
ZA,CR,2009.0,1,1,0
SE,ID,2012.0,3,2,1
US,TZ,2003.0,6,3,3
IT,GH,2019.0,1,6,-5
BH,SA,1997.0,1,1,0
TR,KG,2015.0,1,5,-4
TH,KR,2005.0,1,4,-3
AU,KW,1998.0,1,2,-1
SG,NO,2002.0,1,1,0
EC,SE,2020.0,1,3,-2
QA,SD,2012.0,4,2,2
SA,nan,2010.0,2,5,-3
ID,CO,2008.0,1,2,-1
IN,SY,2007.0,1,1,0
BG,RO,2009.0,4,3,1
AU,BG,2019.0,1,1,0
NA,ZA,2007.0,3,2,1
CY,SE,2014.0,3,1,2
CN,TH,2007.0,7,11,-4
GB,SN,2013.0,2,3,-1
VG,SA,2009.0,2,1,1
ET,RU,2020.0,1,3,-2
RS,BG,2005.0,3,2,1
MX,NP,2019.0,1,2,-1
ZA,FR,2023.0,2,1,1
SA,nan,2019.0,3,6,-3
nan,PK,2002.0,2,2,0
CU,NL,2019.0,2,2,0
BJ,NL,2020.0,3,2,1
IN,MK,2017.0,2,2,0
ZM,CH,2013.0,1,1,0
PG,AU,2015.0,5,5,0
KR,CO,2011.0,3,6,-3
RW,KE,2013.0,1,1,0
CW,DE,2005.0,1,1,0
GB,LV,2011.0,2,4,-2
NA,AU,2015.0,2,1,1
EE,GB,1998.0,1,2,-1
GB,GM,2004.0,5,6,-1
CA,GT,2017.0,1,1,0
CA,KE,2010.0,1,2,-1
MT,IN,2017.0,1,2,-1
GE,GB,2000.0,5,2,3
KE,CH,1997.0,3,1,2
AU,MK,1998.0,5,1,4
VE,SV,2020.0,1,1,0
GN,FR,2001.0,1,2,-1
EG,IN,2011.0,4,4,0
LV,IN,2019.0,1,2,-1
PL,PE,2006.0,1,1,0
GE,nan,2017.0,4,2,2
FI,KE,2019.0,1,1,0
JM,AU,2008.0,2,2,0
SG,BN,2007.0,1,1,0
CM,nan,2015.0,3,1,2
PK,DK,2022.0,6,4,2
NP,FR,2016.0,1,1,0
AM,IR,2019.0,5,2,3
CM,CA,2013.0,1,3,-2
SK,UA,2005.0,3,2,1
AR,AT,2003.0,1,2,-1
MA,NO,2019.0,2,2,0
BE,GA,2018.0,1,1,0
BS,AU,2014.0,1,1,0
JO,FR,2008.0,3,3,0
PK,BR,2001.0,1,2,-1
MT,IN,2019.0,1,1,0
EE,VN,2022.0,1,1,0
US,CG,2006.0,1,1,0
IR,CZ,2016.0,2,4,-2
GE,FR,2008.0,2,2,0
GA,DE,2010.0,1,4,-3
PT,NO,2008.0,2,3,-1
VN,IR,2011.0,1,1,0
TZ,DK,2018.0,1,1,0
MC,CH,2018.0,1,1,0
JM,NG,2010.0,1,2,-1
IT,MT,2020.0,2,7,-5
BR,CG,2005.0,1,1,0
QA,SE,2006.0,2,5,-3
BF,GA,2015.0,2,1,1
SN,nan,2013.0,1,1,0
CA,CG,2010.0,1,1,0
BA,HR,2000.0,3,3,0
PA,BO,2017.0,1,1,0
AT,CN,2000.0,3,6,-3
JP,AF,2016.0,2,1,1
FR,HN,2017.0,1,1,0
CO,PE,2023.0,1,1,0
IQ,TN,2018.0,1,2,-1
CM,EG,1997.0,1,1,0
CR,CH,2008.0,1,2,-1
nan,PK,2005.0,1,1,0
KE,BH,2000.0,1,1,0
CM,SA,2018.0,1,1,0
GB,AM,2011.0,2,4,-2
PE,PT,2008.0,1,1,0
FI,HR,2019.0,1,1,0
PE,HN,2003.0,2,1,1
FK,GB,2008.0,1,2,-1
SE,BA,2020.0,1,3,-2
BF,AT,2016.0,3,1,2
HR,ES,2012.0,2,4,-2
CL,US,2005.0,112,98,14
FR,AU,2010.0,126,117,9
AU,MY,2014.0,153,96,57
US,BE,2018.0,361,416,-55
PL,BR,2018.0,22,29,-7
CN,SE,2012.0,89,81,8
nan,NL,2009.0,62,45,17
IN,FR,1998.0,22,31,-9
AE,IN,2020.0,75,83,-8
JP,FR,2003.0,90,66,24
ZA,AU,2010.0,51,42,9
VE,CA,2007.0,5,3,2
FR,MQ,2010.0,22,10,12
HU,RS,2000.0,1,1,0
CH,NZ,2003.0,7,5,2
CH,DE,1999.0,300,345,-45
IT,JP,2018.0,66,57,9
FI,US,2004.0,119,143,-24
RO,CN,2009.0,3,1,2
LB,US,2001.0,23,26,-3
IT,PL,2003.0,18,7,11
CL,US,2002.0,64,99,-35
GB,BY,2013.0,3,2,1
IT,CH,2002.0,114,98,16
KZ,UZ,2014.0,9,4,5
AU,NL,2014.0,87,117,-30
ZA,IN,2003.0,13,13,0
TR,IR,2014.0,19,35,-16
TR,CO,2022.0,89,101,-12
DK,NO,2009.0,67,66,1
GB,AR,2017.0,39,34,5
CH,IR,2009.0,6,15,-9
IN,IT,2008.0,71,65,6
FR,AU,2017.0,160,112,48
FR,PT,2005.0,33,26,7
SG,KR,2011.0,25,27,-2
IT,IL,2019.0,24,16,8
CH,NO,2015.0,27,12,15
VE,CR,2020.0,2,1,1
CN,CL,2022.0,5,4,1
IT,IL,2017.0,19,17,2
PK,TR,2012.0,9,9,0
XK,RS,2012.0,10,11,-1
TR,BE,2018.0,23,17,6
AT,CL,2020.0,7,8,-1
ZA,RU,2014.0,5,8,-3
CH,TR,2019.0,27,36,-9
RS,GB,2005.0,12,12,0
IT,IL,2010.0,18,11,7
BR,TR,2005.0,37,5,32
CA,NL,2006.0,48,65,-17
IE,RU,2018.0,16,9,7
SE,AU,2016.0,47,63,-16
PT,DE,2015.0,50,47,3
AR,UY,2012.0,29,28,1
IN,MA,2020.0,5,8,-3
BI,US,2010.0,1,1,0
CO,BE,2003.0,3,3,0
BA,VN,2022.0,2,1,1
TR,RU,2021.0,6,12,-6
NL,ET,2017.0,8,8,0
BY,BG,2020.0,1,3,-2
MY,GH,2018.0,5,3,2
CM,CH,2020.0,7,2,5
AE,US,2005.0,13,23,-10
VN,DE,2011.0,7,16,-9
UY,MX,2009.0,6,4,2
CA,UA,2016.0,13,5,8
MR,FR,2019.0,4,4,0
TR,RS,2006.0,61,56,5
nan,DE,1997.0,19,12,7
MX,CA,2006.0,28,20,8
IE,TW,2001.0,1,2,-1
UY,ES,2009.0,30,32,-2
CO,CH,2013.0,11,9,2
GE,US,1998.0,58,83,-25
AE,MN,2012.0,2,1,1
BR,NO,2005.0,11,18,-7
ES,nan,2001.0,12,9,3
EG,TR,2019.0,18,11,7
VN,RO,2013.0,7,6,1
CM,IT,2011.0,3,4,-1
IR,ES,2015.0,17,8,9
SE,KR,2019.0,10,10,0
IR,BE,2021.0,33,19,14
IR,TH,2019.0,4,5,-1
PL,LV,2001.0,2,1,1
LA,FR,2014.0,2,2,0
CY,DE,2018.0,6,7,-1
MA,DE,2004.0,5,1,4
FR,CF,2005.0,2,2,0
AR,DE,2003.0,28,14,14
RU,MX,2012.0,6,7,-1
DZ,CH,2017.0,4,3,1
BG,NO,2001.0,6,11,-5
KR,KZ,2019.0,4,7,-3
KE,ID,2011.0,4,1,3
NG,GM,2017.0,2,2,0
DK,BG,2003.0,1,1,0
JP,TR,1997.0,17,16,1
ES,TN,2013.0,6,5,1
JP,PK,2009.0,12,5,7
DE,PH,2012.0,11,9,2
SE,RO,2011.0,4,9,-5
DK,GL,1998.0,1,1,0
TH,SG,2007.0,3,4,-1
CN,KE,2016.0,12,7,5
UG,AT,2019.0,1,1,0
SA,OM,2016.0,7,12,-5
ES,CU,1997.0,12,15,-3
BD,NO,2010.0,2,2,0
CU,SE,2016.0,1,1,0
BG,US,2022.0,10,13,-3
JO,OM,2011.0,6,1,5
HK,ZA,2007.0,1,1,0
KW,US,2003.0,8,16,-8
TH,KR,2002.0,2,3,-1
IE,RO,2008.0,4,1,3
SD,MY,2014.0,9,10,-1
VE,AU,2004.0,2,2,0
BI,US,2019.0,4,2,2
IN,TW,2023.0,4,3,1
SD,KE,2003.0,7,1,6
GA,NL,2008.0,3,3,0
PL,MZ,2002.0,4,13,-9
KR,KZ,2017.0,2,1,1
AZ,UA,2021.0,3,2,1
CH,MX,2005.0,3,3,0
CH,TR,2010.0,8,17,-9
AE,SG,2015.0,1,3,-2
NL,TH,2012.0,8,9,-1
CH,MX,2002.0,2,3,-1
MA,ES,2004.0,4,7,-3
KE,IT,2016.0,4,3,1
EG,CH,2009.0,6,2,4
IT,JO,2017.0,3,2,1
JP,SA,2006.0,3,7,-4
BE,RW,2012.0,4,2,2
CH,SN,2014.0,1,2,-1
BE,EE,2022.0,3,5,-2
QA,AE,2000.0,1,1,0
GB,ZW,2012.0,3,2,1
SI,BE,2008.0,4,4,0
HR,CN,2010.0,3,1,2
BN,GB,2016.0,4,9,-5
PS,ES,2007.0,6,5,1
CO,BR,2001.0,6,11,-5
KW,JO,2020.0,5,5,0
RO,JP,2018.0,2,4,-2
GR,KW,2016.0,3,2,1
MY,TN,2013.0,1,3,-2
BR,MT,2017.0,1,1,0
PK,AU,2004.0,5,3,2
UA,NG,2020.0,2,1,1
PT,AR,2009.0,6,8,-2
NO,ET,2022.0,2,4,-2
BJ,CM,2003.0,2,1,1
RU,GR,2013.0,1,1,0
BE,TZ,2020.0,1,1,0
AR,HN,2017.0,5,4,1
CL,CU,1998.0,3,3,0
US,BD,2023.0,2,7,-5
SI,RS,1998.0,1,1,0
HR,GB,1997.0,2,2,0
BY,CZ,1998.0,2,6,-4
CL,PL,2020.0,5,6,-1
EC,IN,2018.0,1,1,0
CN,CU,2019.0,4,5,-1
CZ,GE,2015.0,2,1,1
ZA,PT,2006.0,1,1,0
CN,KW,2022.0,1,2,-1
LB,IT,2009.0,3,8,-5
FI,KE,2017.0,1,1,0
RO,AE,2017.0,2,2,0
CO,CZ,2021.0,4,1,3
MY,NG,2005.0,1,2,-1
NZ,GH,2015.0,1,3,-2
DZ,MD,2014.0,1,1,0
MY,CN,2006.0,10,20,-10
DE,IE,2006.0,71,39,32
LK,AU,2016.0,28,28,0
JM,GB,2013.0,2,5,-3
CA,CG,2019.0,2,1,1
KR,nan,2008.0,15,19,-4
NO,PL,2000.0,5,4,1
FR,KR,2006.0,24,28,-4
IL,nan,2016.0,22,30,-8
SA,BR,2021.0,1,6,-5
MY,AU,2006.0,23,21,2
JP,SE,2001.0,32,27,5
TH,FI,2003.0,2,2,0
HU,DE,2007.0,43,45,-2
ZA,GR,2015.0,1,3,-2
,DK,2006.0,1890,0,1890
,FR,1998.0,13191,0,13191
CA,,2023.0,43286,0,43286
,DE,2008.0,20130,0,20130
,FR,1997.0,14467,0,14467
,CR,2006.0,174,0,174
CN,,2012.0,39691,0,39691
IN,,2018.0,15478,0,15478
,KR,2011.0,6105,0,6105
,TW,2006.0,5339,0,5339
,XK,2011.0,106,0,106
MY,,2015.0,1079,0,1079
DE,,2014.0,12057,0,12057
IT,,2007.0,3136,0,3136
JP,,2008.0,9045,0,9045
,IR,1997.0,667,0,667
IL,,2020.0,2735,0,2735
,CL,2006.0,1445,0,1445
ES,,2007.0,3257,0,3257
,AR,2015.0,2399,0,2399
,AT,2000.0,1652,0,1652
SG,,2012.0,562,0,562
GE,,2005.0,48,0,48
,BD,2000.0,159,0,159
FI,,2015.0,1383,0,1383
UG,,2019.0,214,0,214
CR,,2022.0,663,0,663
,SG,1995.0,1000,0,1000
RO,,2013.0,557,0,557
BN,,2019.0,34,0,34
,BG,1999.0,389,0,389
AM,MA,2020.0,3,0,3
,IR,1998.0,897,0,897
PE,,2005.0,44,0,44
TR,,2009.0,1131,0,1131
,RO,1995.0,798,0,798
,BE,2014.0,3121,0,3121
DZ,,2024.0,4698,0,4698
,EE,2007.0,357,0,357
,DZ,2015.0,1470,0,1470
,ZA,2012.0,2900,0,2900
CG,,2021.0,88,0,88
,SA,2007.0,727,0,727
BN,,2017.0,10,0,10
KE,,2018.0,355,0,355
AR,,2004.0,306,0,306
PR,,2020.0,30,0,30
RU,ET,2014.0,1,0,1
,RS,1996.0,473,0,473
,UA,2018.0,4674,0,4674
,GM,2013.0,11,0,11
,OM,2016.0,171,0,171
AM,,2002.0,38,0,38
,TZ,2001.0,77,0,77
OM,,2020.0,164,0,164
SG,LU,2012.0,1,0,1
,VN,1996.0,113,0,113
GE,,2002.0,36,0,36
TW,TR,2011.0,6,0,6
RU,,1998.0,710,0,710
,SI,2007.0,583,0,583
,VN,2004.0,201,0,201
BJ,,2020.0,118,0,118
BJ,XK,2020.0,1,0,1
MR,,2023.0,47,0,47
RE,,2020.0,33,0,33
,CD,2010.0,102,0,102
TZ,GH,2021.0,2,0,2
TO,US,2016.0,1,0,1
,LV,2005.0,202,0,202
NG,BN,2017.0,1,0,1
,MK,2012.0,237,0,237
,NP,2004.0,160,0,160
MC,,2020.0,13,0,13
MZ,US,2003.0,1,0,1
LS,,2021.0,12,0,12
VE,,2003.0,81,0,81
,AL,1995.0,12,0,12
GR,,2000.0,251,0,251
,HN,2015.0,51,0,51
MX,IS,2019.0,6,0,6
,LU,2008.0,106,0,106
US,PR,2006.0,1,0,1
CA,SI,2022.0,3,0,3
,ML,2012.0,42,0,42
MD,NO,2018.0,1,0,1
EE,,2011.0,101,0,101
,CD,2017.0,126,0,126
PA,,2025.0,28,0,28
XK,GB,2018.0,3,0,3
,LS,2018.0,9,0,9
,ST,2001.0,11,0,11
FI,UA,2020.0,6,0,6
CA,GF,1997.0,1,0,1
,BN,2005.0,13,0,13
BJ,MG,2021.0,1,0,1
,AU,2020.0,676,0,676
AL,,2016.0,116,0,116
FR,MT,2019.0,4,0,4
,RS,2004.0,815,0,815
,CD,2019.0,71,0,71
UG,,2017.0,130,0,130
,HK,1994.0,25,0,25
TW,PE,2009.0,1,0,1
PS,,2025.0,35,0,35
,MG,2008.0,53,0,53
,TG,2008.0,26,0,26
IS,,2000.0,11,0,11
PW,JP,2014.0,1,0,1
BI,,2017.0,8,0,8
,SV,2014.0,26,0,26
FR,IS,2016.0,5,0,5
,LV,2002.0,104,0,104
BB,US,2001.0,5,0,5
US,LR,2011.0,2,0,2
AD,,2022.0,1,0,1
UG,,2010.0,34,0,34
GT,,2014.0,7,0,7
,RW,2009.0,52,0,52
,NP,1996.0,45,0,45
IT,KP,1998.0,1,0,1
BA,,2018.0,167,0,167
nan,HN,2017.0,1,0,1
GF,,2021.0,28,0,28
JO,NO,2021.0,1,0,1
UG,ES,2019.0,2,0,2
JP,ML,2019.0,1,0,1
FR,PE,2000.0,2,0,2
,SX,2004.0,4,0,4
ET,SG,2016.0,1,0,1
,PR,2018.0,12,0,12
MX,NP,2010.0,1,0,1
CL,NI,2019.0,2,0,2
SG,KW,2001.0,1,0,1
IQ,NO,2018.0,1,0,1
,KG,2012.0,23,0,23
HU,,2026.0,4,0,4
XK,,2018.0,48,0,48
PE,,2002.0,30,0,30
CH,ID,2007.0,2,0,2
AM,,2005.0,57,0,57
BY,IE,2012.0,1,0,1
TW,RO,2014.0,1,0,1
US,MR,2002.0,1,0,1
GP,MA,2005.0,2,0,2
MZ,GB,2022.0,1,0,1
BF,IT,2022.0,1,0,1
UY,,2011.0,46,0,46
QA,MX,2017.0,2,0,2
CY,,2008.0,22,0,22
SV,,2012.0,3,0,3
GL,,2015.0,2,0,2
BH,,2016.0,30,0,30
SI,,2000.0,39,0,39
nan,UG,2004.0,1,0,1
TM,,2014.0,2,0,2
TJ,,2015.0,19,0,19
,SC,2005.0,5,0,5
AT,PA,2010.0,1,0,1
SG,IE,2004.0,2,0,2
NL,CM,1999.0,1,0,1
PE,DO,2008.0,1,0,1
LV,CH,2014.0,3,0,3
CR,IL,2020.0,1,0,1
BI,,2019.0,15,0,15
FR,GH,2017.0,1,0,1
MZ,AM,2007.0,1,0,1
IL,SD,2011.0,1,0,1
LU,NG,2001.0,1,0,1
BN,,2010.0,5,0,5
BB,,2010.0,5,0,5
BE,CY,2019.0,2,0,2
BR,CG,2002.0,2,0,2
NL,KE,2008.0,7,0,7
NP,ZA,2014.0,2,0,2
FI,SA,2011.0,3,0,3
YE,OM,2014.0,2,0,2
NE,,2015.0,9,0,9
ES,KR,2001.0,4,0,4
BW,LS,2004.0,1,0,1
MN,US,2002.0,1,0,1
nan,PS,2016.0,2,0,2
KH,NL,2016.0,2,0,2
,MC,2007.0,8,0,8
VE,JP,2016.0,1,0,1
JM,BW,2018.0,1,0,1
ES,AE,2011.0,1,0,1
,SJ,1994.0,4,0,4
SD,,2009.0,28,0,28
GH,BR,2022.0,1,0,1
SG,PK,2008.0,3,0,3
,GF,2009.0,12,0,12
YE,AE,2002.0,1,0,1
PL,AZ,2014.0,1,0,1
RU,BD,1999.0,1,0,1
IE,LY,2007.0,2,0,2
MG,CH,2015.0,1,0,1
TT,BE,2019.0,1,0,1
KG,SE,2009.0,1,0,1
JP,NI,2017.0,1,0,1
AE,NO,2007.0,2,0,2
LU,,2003.0,9,0,9
DK,SD,2017.0,1,0,1
AU,CZ,2002.0,1,0,1
ES,EG,1998.0,1,0,1
,BN,2002.0,9,0,9
SD,SE,2019.0,1,0,1
ML,ET,2010.0,1,0,1
nan,KE,2013.0,3,0,3
PL,RS,2001.0,3,0,3
US,TL,2019.0,2,0,2
MD,BR,2013.0,2,0,2
IS,AU,2021.0,4,0,4
JM,MX,2009.0,1,0,1
,NA,2000.0,12,0,12
PS,IL,2013.0,4,0,4
AT,BB,2020.0,1,0,1
BE,UG,2001.0,1,0,1
GE,CZ,2006.0,5,0,5
KR,IL,2000.0,2,0,2
PY,BO,2019.0,1,0,1
DK,UA,1999.0,1,0,1
JO,BH,2013.0,1,0,1
BR,LY,2014.0,1,0,1
IN,LY,2009.0,4,0,4
GH,NZ,2000.0,1,0,1
TR,EE,2023.0,1,0,1
ML,RU,2017.0,4,0,4
PE,NL,2018.0,1,0,1
CY,FR,2011.0,2,0,2
UA,DZ,2021.0,1,0,1
PT,KE,2016.0,1,0,1
,KN,2008.0,4,0,4
ZA,SZ,1997.0,1,0,1
LY,IN,2003.0,2,0,2
LB,OM,2018.0,2,0,2
NP,QA,2019.0,2,0,2
nan,TR,2001.0,2,0,2
,TJ,1994.0,12,0,12
HN,,2026.0,1,0,1
MV,IT,2005.0,1,0,1
LY,KW,2019.0,2,0,2
AE,LB,2006.0,1,0,1
NO,LU,2022.0,2,0,2
MX,TW,2002.0,2,0,2
NL,IR,2000.0,1,0,1
UG,CG,2018.0,1,0,1
JP,TN,2004.0,4,0,4
LU,MA,2021.0,1,0,1
NG,KW,2010.0,1,0,1
IT,GH,2010.0,1,0,1
RO,LV,2021.0,2,0,2
ML,TZ,2021.0,1,0,1
,MV,2009.0,3,0,3
CA,MK,2012.0,2,0,2
BR,QA,2014.0,4,0,4
PH,ID,2008.0,1,0,1
TW,EE,2017.0,1,0,1
ST,US,2011.0,1,0,1
NO,PE,2007.0,1,0,1
ZA,AE,2003.0,2,0,2
AU,NP,2000.0,1,0,1
GB,MS,2011.0,1,0,1
CU,DE,2021.0,7,0,7
GT,BR,2022.0,1,0,1
PY,PT,1999.0,4,0,4
FI,MD,2011.0,2,0,2
DK,MM,2020.0,1,0,1
LT,BG,2014.0,1,0,1
CA,BO,2018.0,1,0,1
IL,ID,2007.0,1,0,1
NE,MG,2018.0,1,0,1
NI,ES,2000.0,3,0,3
BG,JP,2023.0,1,0,1
LY,LB,2022.0,1,0,1
BG,GR,2007.0,1,0,1
EG,YE,2002.0,1,0,1
EC,PY,2013.0,1,0,1
RO,SI,2009.0,1,0,1
GE,PL,2001.0,2,0,2
GB,ET,2002.0,3,0,3
SD,SS,2011.0,3,0,3
IE,IL,1998.0,2,0,2
TW,ET,2007.0,5,0,5
FJ,AG,2021.0,1,0,1
RU,TM,2010.0,1,0,1
LT,,1998.0,11,0,11
HN,PE,2009.0,1,0,1
BB,,2017.0,7,0,7
OM,AU,2005.0,2,0,2
US,FO,2009.0,3,0,3
MD,CN,2017.0,3,0,3
nan,GE,2004.0,1,0,1
CA,AM,2011.0,2,0,2
BG,RS,2006.0,2,0,2
GN,UG,2016.0,2,0,2
CL,MK,2021.0,1,0,1
GA,,2015.0,10,0,10
CU,PT,1998.0,1,0,1
IN,MK,2010.0,1,0,1
BR,MU,2007.0,1,0,1
BI,,2010.0,7,0,7
OM,JO,1999.0,2,0,2
MN,AU,2013.0,1,0,1
CM,TD,2014.0,1,0,1
AU,SZ,2018.0,1,0,1
RS,MK,2006.0,1,0,1
BJ,NO,2008.0,1,0,1
PE,BH,2010.0,1,0,1
CG,ZA,2004.0,1,0,1
GB,GY,2005.0,1,0,1
CH,OM,2022.0,1,0,1
JO,JP,2000.0,1,0,1
DK,MX,2000.0,2,0,2
UZ,JP,2015.0,2,0,2
LU,NZ,2020.0,1,0,1
MA,nan,2008.0,4,0,4
DE,BW,2008.0,1,0,1
GH,NE,2018.0,1,0,1
LB,IQ,2008.0,1,0,1
UY,VE,1997.0,1,0,1
HR,CO,2014.0,1,0,1
GE,IT,2016.0,1,0,1
CZ,LK,2019.0,1,0,1
AT,ME,2013.0,1,0,1
ES,KW,2012.0,1,0,1
HK,CH,2017.0,2,0,2
ZW,GB,2003.0,3,0,3
IR,SY,2011.0,1,0,1
LS,CH,2015.0,1,0,1
PT,ZM,2004.0,1,0,1
DK,SD,2010.0,1,0,1
SA,NP,2008.0,1,0,1
NL,AM,2000.0,1,0,1
MD,CN,2010.0,2,0,2
SV,BR,2004.0,2,0,2
nan,LU,2008.0,3,0,3
ZA,GE,2016.0,1,0,1
GP,GB,2018.0,1,0,1
PK,LU,2021.0,3,0,3
GP,NE,2017.0,1,0,1
VE,NL,2006.0,1,0,1
ID,VE,2012.0,4,0,4
MY,PL,2018.0,3,0,3
UZ,ZA,2012.0,1,0,1
TZ,RO,2018.0,1,0,1
NA,,2009.0,3,0,3
SS,FR,2007.0,1,0,1
QA,IL,2008.0,1,0,1
HK,GR,2015.0,1,0,1
GF,KH,2016.0,2,0,2
CH,CY,2007.0,1,0,1
ER,US,2012.0,2,0,2
,MO,2003.0,1,0,1
XK,IT,2018.0,1,0,1
GR,BJ,2021.0,3,0,3
GD,BE,2019.0,1,0,1
FR,GH,2019.0,3,0,3
DK,PE,2003.0,1,0,1
NP,MM,2018.0,1,0,1
US,NE,2006.0,1,0,1
IL,UZ,2002.0,1,0,1
LK,MY,2009.0,1,0,1
HU,IE,2004.0,3,0,3
,WS,2009.0,2,0,2
SI,nan,2003.0,1,0,1
TN,RO,2021.0,1,0,1
YE,CN,2017.0,2,0,2
AG,CH,2020.0,1,0,1
HR,MK,2015.0,2,0,2
IQ,NL,2023.0,1,0,1
US,XK,2016.0,6,0,6
ML,NL,2011.0,1,0,1
IN,PA,2023.0,1,0,1
UA,MM,2018.0,2,0,2
NO,BJ,2014.0,1,0,1
UZ,BE,2010.0,1,0,1
MT,,2004.0,2,0,2
NL,LV,2016.0,2,0,2
NP,QA,2017.0,2,0,2
FR,RW,2017.0,3,0,3
EC,FJ,2017.0,1,0,1
KE,IE,2007.0,1,0,1
IN,DO,2023.0,1,0,1
ZA,ZM,2004.0,1,0,1
CY,AU,2004.0,1,0,1
IT,MO,2010.0,1,0,1
GR,RO,2003.0,2,0,2
US,CW,2011.0,1,0,1
ML,,2025.0,3,0,3
SY,MY,2007.0,1,0,1
TW,AT,2000.0,1,0,1
KZ,SE,2020.0,1,0,1
ZA,MY,2003.0,1,0,1
ML,DE,1999.0,1,0,1
LU,JP,2008.0,1,0,1
AF,CA,2012.0,1,0,1
MX,BY,2005.0,1,0,1
RU,XK,2020.0,1,0,1
DE,AE,2004.0,2,0,2
AG,PK,2020.0,1,0,1
AM,CM,2022.0,1,0,1
GD,,2009.0,1,0,1
CA,QA,2004.0,1,0,1
TG,,2006.0,3,0,3
AR,MA,2013.0,2,0,2
NG,NE,2014.0,2,0,2
TT,AU,2014.0,1,0,1
FI,LU,2021.0,2,0,2
IN,BG,2008.0,1,0,1
SY,HU,2022.0,3,0,3
AU,SN,2019.0,2,0,2
NZ,CL,2022.0,1,0,1
BR,IL,2023.0,2,0,2
AM,PE,2006.0,1,0,1
FR,MR,2015.0,3,0,3
nan,NC,2015.0,1,0,1
MX,IS,2017.0,1,0,1
CN,BW,2013.0,1,0,1
SY,IT,1999.0,2,0,2
BB,,2019.0,4,0,4
RS,BG,2002.0,2,0,2
BE,MU,2016.0,1,0,1
GM,,2009.0,3,0,3
KR,MM,2011.0,3,0,3
SY,CH,2018.0,1,0,1
SA,LU,2015.0,1,0,1
JP,VE,2021.0,1,0,1
EE,BG,2012.0,1,0,1
AE,JM,2018.0,1,0,1
NO,AG,2019.0,1,0,1
ET,UZ,2023.0,1,0,1
IT,SM,2006.0,1,0,1
SD,JO,1999.0,2,0,2
NZ,NA,2011.0,1,0,1
,SC,2002.0,5,0,5
ID,ZA,2023.0,1,0,1
AR,GR,2017.0,1,0,1
nan,BG,2007.0,3,0,3
AZ,PL,1997.0,1,0,1
IN,PG,1998.0,1,0,1
AR,HN,2010.0,1,0,1
SA,SG,2023.0,2,0,2
VN,NC,2019.0,1,0,1
FR,PH,2023.0,1,0,1
DK,CO,2021.0,1,0,1
RW,PK,2020.0,1,0,1
IE,BF,2014.0,1,0,1
BE,GF,2007.0,1,0,1
UY,IL,2012.0,1,0,1
VN,IE,2022.0,4,0,4
AL,DE,2006.0,2,0,2
MK,TR,2014.0,1,0,1
EG,NE,2020.0,1,0,1
PK,IL,2007.0,1,0,1
LY,SA,2003.0,1,0,1
VN,LA,2022.0,1,0,1
TR,GN,2021.0,1,0,1
US,MC,2001.0,4,0,4
GA,TZ,2017.0,1,0,1
YE,CN,2010.0,1,0,1
TZ,ES,2015.0,1,0,1
HR,IL,2015.0,2,0,2
BE,CY,2010.0,2,0,2
FI,BG,2000.0,1,0,1
IT,KG,2019.0,1,0,1
CO,MN,2009.0,1,0,1
MT,CZ,2015.0,1,0,1
BW,IN,2011.0,2,0,2
MM,BW,2017.0,1,0,1
ID,IR,2007.0,2,0,2
GN,BJ,2008.0,1,0,1
MD,SE,2000.0,1,0,1
SK,TH,2017.0,1,0,1
UY,FR,2023.0,1,0,1
GM,UG,2006.0,1,0,1
GE,BE,2008.0,2,0,2
LB,KW,1999.0,1,0,1
BY,MD,2016.0,1,0,1
MS,US,2019.0,1,0,1
JP,EC,2012.0,1,0,1
LU,LT,2005.0,1,0,1
SY,IN,2004.0,1,0,1
DK,ID,2008.0,1,0,1
CM,DZ,2016.0,1,0,1
UY,NL,2018.0,3,0,3
AU,BW,2000.0,2,0,2
IE,SK,2005.0,2,0,2
TN,SY,2012.0,2,0,2
JP,LY,2017.0,1,0,1
TZ,BR,2006.0,1,0,1
NZ,BW,1999.0,1,0,1
NL,PY,2014.0,1,0,1
IR,ID,2005.0,1,0,1
AE,SD,2010.0,1,0,1
EG,CD,2020.0,1,0,1
CF,FR,2019.0,1,0,1
CA,CG,2017.0,3,0,3
NP,SE,2012.0,1,0,1
RW,EC,2020.0,1,0,1
ES,MK,2022.0,2,0,2
JP,NI,2019.0,1,0,1
PA,ID,2022.0,2,0,2
DE,UZ,2014.0,2,0,2
VE,UY,2009.0,2,0,2
ZW,CA,2004.0,1,0,1
LU,ES,2006.0,1,0,1
DE,LY,2014.0,1,0,1
CU,FR,2002.0,1,0,1
TH,RU,2017.0,1,0,1
BJ,CH,2022.0,1,0,1
IT,SA,2001.0,1,0,1
RU,QA,2013.0,3,0,3
BR,TR,2002.0,2,0,2
MD,IN,2018.0,1,0,1
MN,NL,2002.0,1,0,1
SE,LB,2015.0,1,0,1
VG,QA,2007.0,1,0,1
UZ,CN,1997.0,1,0,1
QA,KW,2006.0,3,0,3
PE,AT,2017.0,2,0,2
BJ,GB,2020.0,1,0,1
BG,PK,2018.0,1,0,1
GP,MA,2002.0,1,0,1
TJ,NL,2012.0,1,0,1
UA,ID,2002.0,1,0,1
CG,GB,2013.0,1,0,1
NG,SY,2021.0,1,0,1
TW,RS,2010.0,1,0,1
ZA,AR,2014.0,1,0,1
NP,KN,2020.0,1,0,1
SO,,1998.0,1,0,1
NO,KE,2011.0,3,0,3
SA,KE,2020.0,1,0,1
YE,IR,2016.0,2,0,2
LU,BF,2021.0,2,0,2
SI,PL,2005.0,1,0,1
DK,KG,2007.0,1,0,1
nan,LK,2019.0,1,0,1
HR,JP,2017.0,2,0,2
SJ,IS,2018.0,1,0,1
GB,MK,2000.0,2,0,2
CM,NZ,2013.0,1,0,1
NO,CY,2011.0,1,0,1
KE,SG,2019.0,1,0,1
BD,VN,2016.0,2,0,2
BH,TH,2019.0,1,0,1
KZ,KR,2001.0,1,0,1
VE,CH,2004.0,1,0,1
BD,PT,2018.0,1,0,1
GR,UG,2009.0,1,0,1
CH,GF,2016.0,1,0,1
NP,PT,2020.0,1,0,1
MA,CG,2021.0,1,0,1
NL,BD,1997.0,1,1,0
NZ,AE,2000.0,2,1,1
CA,GT,2019.0,2,1,1
RU,IR,2004.0,1,6,-5
BJ,TZ,2012.0,1,1,0
TR,DK,2007.0,2,1,1
CA,DZ,2001.0,2,4,-2
CH,BG,2021.0,2,4,-2
ET,FI,2012.0,1,1,0
DZ,GB,2005.0,4,2,2
FI,RS,2005.0,1,2,-1
AR,IE,1997.0,1,1,0
IR,TH,2017.0,2,5,-3
MA,CH,2010.0,1,4,-3
JP,PA,2014.0,2,1,1
TW,IL,2022.0,1,2,-1
CD,FR,2017.0,1,2,-1
GA,DE,2019.0,5,2,3
BY,MZ,2018.0,1,1,0
IT,TH,2003.0,1,4,-3
IL,CL,2008.0,1,1,0
AU,UA,2011.0,1,2,-1
UA,HU,1999.0,1,2,-1
MK,BG,2003.0,1,1,0
VN,SE,2010.0,1,2,-1
GR,SG,2007.0,1,3,-2
SI,DK,2014.0,1,1,0
JP,KE,1998.0,2,4,-2
KH,TR,2019.0,1,3,-2
LT,UA,2017.0,1,4,-3
ZA,FI,2015.0,1,9,-8
FR,LA,2020.0,4,1,3
PK,CY,2020.0,2,1,1
GR,KR,2022.0,1,2,-1
BY,SK,2003.0,1,2,-1
PT,PL,2004.0,1,2,-1
AT,UA,2012.0,2,4,-2
EC,CR,2009.0,1,1,0
FR,IQ,2009.0,1,3,-2
MN,RU,2007.0,1,4,-3
LK,nan,2020.0,1,1,0
PH,HU,2016.0,1,1,0
ET,PL,2018.0,1,3,-2
ML,GN,2020.0,1,3,-2
IN,AR,2017.0,2,2,0
HU,ES,2004.0,2,4,-2
FR,BD,2008.0,1,3,-2
BD,AT,2016.0,1,1,0
AU,MK,1997.0,1,1,0
EC,BR,2002.0,1,1,0
SI,NL,1998.0,2,1,1
BE,PE,2009.0,2,1,1
TN,US,2001.0,1,5,-4
ID,LT,2019.0,1,1,0
GB,MG,2011.0,1,1,0
PT,BY,2000.0,1,3,-2
KR,GE,2020.0,1,1,0
GA,FR,1998.0,1,1,0
SE,HK,2017.0,1,1,0
SI,TW,2006.0,1,2,-1
AU,CO,2007.0,1,4,-3
IL,UZ,2005.0,1,1,0
AF,MX,2013.0,1,1,0
KE,ES,2007.0,1,1,0
PT,PE,2009.0,1,1,0
QA,NZ,2013.0,1,2,-1
LY,BD,2009.0,1,1,0
KE,SA,2014.0,2,1,1
SG,IT,1999.0,1,1,0
MA,JP,1999.0,1,1,0
BR,BD,2020.0,1,1,0
ML,ET,2017.0,1,1,0
BR,KE,2007.0,1,1,0
KW,IR,2022.0,1,3,-2
CU,NL,2017.0,1,1,0
GP,GF,2014.0,1,2,-1
DE,AM,2014.0,1,9,-8
US,SL,2013.0,2,1,1
QA,CH,2018.0,2,2,0
TR,MK,2015.0,1,1,0
NG,FR,2009.0,2,1,1
GB,NP,2000.0,1,3,-2
DE,ZA,2023.0,1,7,-6
GW,NL,2001.0,1,1,0
IE,PL,1999.0,1,1,0
FI,ZA,2021.0,1,5,-4
PL,CA,2023.0,1,1,0
FR,GE,2007.0,1,1,0
ID,LK,2009.0,1,3,-2
CZ,KZ,2013.0,1,1,0
CH,CU,2004.0,1,2,-1
SY,LB,2010.0,1,1,0
MD,CA,2001.0,1,1,0
PK,BF,2003.0,1,1,0
ID,NO,2018.0,5,11,-6
TR,SY,2016.0,1,3,-2
FI,GR,2012.0,1,5,-4
MA,BE,2000.0,1,3,-2
GR,MD,2019.0,1,1,0
CY,SA,2020.0,1,2,-1
SE,IR,1999.0,1,1,0
DZ,CH,2019.0,2,5,-3
SY,IR,2016.0,1,1,0
nan,LK,2017.0,1,1,0
IT,GE,2021.0,1,1,0
MY,TZ,2012.0,1,1,0
IT,SD,2010.0,1,1,0
nan,ZW,2014.0,1,1,0
ZM,CM,2023.0,1,1,0
GB,GT,2012.0,1,1,0
MY,IE,2008.0,1,2,-1
CN,CU,2017.0,1,7,-6
NL,GA,2002.0,1,2,-1
AU,BN,2012.0,1,2,-1
MM,GB,2022.0,2,1,1
GB,BS,2021.0,1,1,0
ID,ZM,2020.0,1,1,0
AF,CN,2020.0,1,2,-1
SA,BH,2008.0,1,1,0
AU,HK,2018.0,2,9,-7
CM,AU,2018.0,1,1,0
RO,IE,2009.0,1,2,-1
AZ,DE,2015.0,1,3,-2
KH,LT,2017.0,1,2,-1
SE,SA,1999.0,1,1,0
IQ,EG,2003.0,1,1,0
SL,CN,2021.0,1,4,-3
EG,DZ,2015.0,1,5,-4
IQ,OM,2013.0,1,1,0
CG,CD,2022.0,1,1,0
FR,TD,2016.0,2,1,1
NG,GM,2019.0,1,2,-1
EC,CU,2022.0,1,3,-2
VN,SE,2017.0,1,4,-3
AR,HN,2019.0,1,7,-6
PK,IT,2007.0,1,3,-2
GB,PS,2011.0,4,4,0
AZ,US,2017.0,1,2,-1
CH,RO,2001.0,2,4,-2
CU,LB,2003.0,3,2,1
JM,NG,2017.0,1,2,-1
NO,SG,2021.0,2,3,-1
JP,KE,1997.0,2,1,1
SE,IL,2011.0,1,5,-4
KR,SG,2023.0,2,6,-4
MA,LB,2005.0,1,1,0
IL,SE,2001.0,4,6,-2
US,SS,2013.0,1,2,-1
AZ,CN,2010.0,1,1,0
SK,IL,2019.0,1,1,0
ZA,BJ,2019.0,1,1,0
CZ,CY,2020.0,1,1,0
EG,TR,2010.0,1,1,0
BR,TW,2015.0,1,1,0
JM,GP,2011.0,1,0,1
CM,NE,1997.0,1,0,1
AU,MA,2007.0,1,0,1
UG,IE,2007.0,1,0,1
SG,VG,2015.0,1,0,1
SK,TH,2019.0,1,0,1
SY,OM,2016.0,1,0,1
ZM,SZ,2009.0,2,0,2
GB,KG,2019.0,1,0,1
UY,LK,2009.0,1,0,1
IE,UG,2005.0,1,0,1
HU,MX,2003.0,1,0,1
VE,EC,1998.0,1,0,1
TH,BH,2017.0,1,0,1
BD,UG,2020.0,1,0,1
IQ,nan,2015.0,2,0,2
CN,GA,2012.0,1,0,1
MW,BR,2018.0,1,0,1
NO,PH,2015.0,3,0,3
MK,DK,2018.0,1,0,1
TN,NZ,2016.0,1,0,1
LA,,2008.0,2,0,2
QA,MA,2013.0,1,0,1
AU,ET,2007.0,1,0,1
PE,SI,2022.0,1,0,1
CA,GP,2020.0,1,0,1
PL,HR,2021.0,2,0,2
KZ,LT,2021.0,1,0,1
PK,RO,2014.0,2,0,2
MA,NG,2008.0,1,0,1
FI,ZM,2020.0,1,0,1
nan,MU,2012.0,2,0,2
TH,HU,2008.0,1,0,1
SE,LK,2015.0,2,0,2
PA,BO,2019.0,1,0,1
SY,NP,2012.0,1,0,1
EC,HN,2014.0,1,0,1
ES,SN,2011.0,1,0,1
TJ,AU,2020.0,1,0,1
BW,FR,2012.0,1,0,1
MW,KE,2000.0,1,0,1
PY,NL,2021.0,1,0,1
MY,RU,2023.0,1,0,1
GY,,2012.0,1,0,1
GB,ME,2019.0,1,0,1
nan,EE,2006.0,1,0,1
BG,FI,2012.0,2,0,2
FR,TT,2003.0,1,0,1
MM,NO,2015.0,1,0,1
CO,SI,2020.0,1,0,1
PE,IL,2014.0,1,0,1
US,BS,1999.0,1,0,1
TR,MY,2000.0,1,0,1
BA,CN,2015.0,2,0,2
CN,CI,2011.0,1,0,1
KP,ET,2015.0,1,0,1
MV,CA,2019.0,1,0,1
IN,EE,2010.0,1,0,1
RS,ET,2017.0,1,0,1
IT,PS,2009.0,1,0,1
SE,CU,2013.0,1,0,1
BD,ZM,2016.0,1,0,1
AR,CY,2018.0,2,0,2
LS,TZ,2022.0,1,0,1
MX,SK,2020.0,1,0,1
BI,BJ,2021.0,1,0,1
CO,TW,2007.0,1,0,1
MQ,GF,2014.0,1,0,1
ML,NG,2014.0,1,0,1
BY,SE,2004.0,1,0,1
KE,PA,2009.0,1,0,1
VN,IN,2005.0,1,0,1
BN,QA,2023.0,1,0,1
TN,BG,2005.0,1,0,1
KZ,BR,2007.0,1,0,1
IL,EE,2021.0,1,0,1
OM,SG,2012.0,1,0,1
PT,LK,2014.0,1,0,1
BJ,SN,2002.0,1,0,1
CA,BJ,2000.0,1,0,1
ID,KE,2023.0,1,0,1
TR,SO,2021.0,2,0,2
ZA,MX,2003.0,1,0,1
CU,BF,2020.0,1,0,1
FR,QA,2023.0,1,0,1
NZ,BH,2017.0,1,0,1
ES,BA,2016.0,2,0,2
FR,AL,2009.0,2,0,2
IN,AG,2006.0,1,0,1
KE,PL,2008.0,2,0,2
BH,TW,2009.0,2,0,2
HK,SE,2009.0,1,0,1
FI,CY,2009.0,1,0,1
CF,GF,2018.0,1,0,1
IN,CG,2015.0,1,0,1
PT,MA,2006.0,1,0,1
DE,BI,2013.0,1,0,1
MA,BI,2011.0,1,0,1
TT,NL,2000.0,1,0,1
BI,RO,2017.0,1,0,1
GM,BR,2002.0,1,0,1
DZ,MN,2007.0,1,0,1
PT,UA,2015.0,1,0,1
PH,FJ,2015.0,1,0,1
HK,US,2023.0,1,0,1
IS,CN,2013.0,1,0,1
PK,EE,2018.0,2,0,2
SY,AT,2019.0,1,0,1
KH,MG,2005.0,1,0,1
NP,AU,2004.0,1,0,1
AL,LK,2003.0,1,0,1
VE,CN,2003.0,1,0,1
LU,SN,2018.0,1,0,1
KR,CR,2000.0,1,0,1
BT,CH,2020.0,1,0,1
JE,,2016.0,1,0,1
MA,IQ,2022.0,1,0,1
PA,DE,2000.0,2,0,2
PT,PA,2001.0,1,0,1
ZA,RE,2021.0,1,0,1
LK,UZ,2018.0,1,0,1
IN,LA,2022.0,1,0,1
BJ,IN,2020.0,1,0,1
KW,DE,2009.0,1,0,1
CZ,EE,2007.0,1,0,1
BR,OM,2010.0,1,0,1
MR,FR,2010.0,1,0,1
FI,PE,2006.0,1,0,1
HK,CH,2019.0,2,0,2
TR,HR,2015.0,1,0,1
AM,IR,2010.0,1,0,1
SK,GE,2012.0,2,0,2
ZW,LS,2006.0,1,0,1
SN,PK,2003.0,1,0,1
CY,JO,2006.0,1,0,1
RE,ZA,2022.0,1,0,1
BG,AZ,2016.0,1,0,1
KG,FI,2010.0,2,0,2
NG,IQ,2011.0,1,0,1
DE,KZ,2002.0,1,0,1
GB,GY,2002.0,1,0,1
GT,MX,2001.0,1,0,1
GH,TG,2020.0,1,0,1
ID,MV,2020.0,1,0,1
DE,BF,2006.0,1,0,1
TH,RU,2010.0,1,0,1
AM,RU,2023.0,1,0,1
CH,MN,1999.0,1,0,1
AU,SV,2021.0,1,0,1
LB,AT,2018.0,1,0,1
TJ,BY,2017.0,1,0,1
,GI,2004.0,1,0,1
MW,NO,2023.0,1,0,1
SI,RO,2018.0,1,0,1
TN,CG,2008.0,1,0,1
KW,IE,2012.0,1,0,1
UY,DE,2003.0,1,0,1
PE,AT,2019.0,1,0,1
CZ,nan,2023.0,2,0,2
SE,GE,2014.0,1,0,1
PA,AU,2004.0,1,0,1
LV,CI,2017.0,1,0,1
CL,UA,2006.0,1,0,1
MW,AU,2020.0,1,0,1
ZW,DE,2008.0,1,0,1
IL,PT,2021.0,2,0,2
IR,AZ,2004.0,1,0,1
IR,TH,2010.0,1,0,1
BB,AU,2011.0,1,0,1
DE,RE,2015.0,1,0,1
SG,JP,2023.0,1,0,1
IE,GE,2005.0,1,0,1
GP,BJ,2017.0,1,0,1
IE,TZ,2001.0,1,0,1
VN,ID,2015.0,1,0,1
CN,JM,2004.0,1,0,1
TT,GE,2018.0,1,0,1
RE,IN,2012.0,1,0,1
BG,BY,2016.0,1,0,1
PT,HN,2022.0,1,0,1
JM,CH,2000.0,1,0,1
HU,VE,2007.0,1,0,1
UG,QA,2006.0,1,0,1
IE,NO,2000.0,1,0,1
NI,FR,2018.0,1,0,1
ID,SE,2002.0,1,0,1
SY,NL,2007.0,1,0,1
EG,SE,2005.0,1,0,1
VE,TH,2017.0,1,0,1
US,GW,2020.0,1,0,1
AR,BD,2020.0,1,0,1
SG,PT,2009.0,1,0,1
NO,NA,2018.0,1,0,1
ME,XK,2008.0,1,0,1
BD,CD,2021.0,1,0,1
GB,MZ,2006.0,1,0,1
DE,HN,2013.0,1,0,1
PK,HR,1997.0,1,0,1
,BF,2020.0,1,0,1
ZM,MW,2023.0,1,0,1
NG,CD,2019.0,2,0,2
TG,ZW,2015.0,1,0,1
nan,LT,2017.0,1,0,1
CG,ZW,2019.0,1,0,1
PT,KZ,2014.0,1,0,1
CI,ES,2017.0,1,0,1
CH,JM,2014.0,1,0,1
TM,UZ,2017.0,1,0,1
FM,,2018.0,1,0,1
MN,NG,2013.0,1,0,1
EC,BG,2020.0,1,0,1
ET,TG,2022.0,1,0,1
MQ,BE,2018.0,1,0,1
CO,AF,2020.0,1,0,1
MY,OM,2023.0,1,0,1
GB,IE,2019.0,477,427,50
IE,JP,2006.0,16,18,-2
US,ZA,2011.0,306,246,60
US,GB,2012.0,5828,5658,170
US,CH,2017.0,978,983,-5
KR,JP,2017.0,406,358,48
GB,US,2001.0,3585,3628,-43
GB,DE,2014.0,981,923,58
IL,US,2022.0,264,262,2
US,TR,2013.0,428,411,17
ES,US,1997.0,279,326,-47
CN,TW,2014.0,891,1408,-517
SG,CN,2004.0,237,196,41
FR,US,2015.0,1529,1556,-27
US,KW,2011.0,15,10,5
CA,GB,2020.0,956,933,23
CH,JP,2015.0,95,103,-8
IN,US,2017.0,2901,2664,237
BR,PT,2021.0,1285,792,493
GB,ZA,2002.0,60,64,-4
CN,DE,2011.0,256,285,-29
GB,NL,2011.0,282,279,3
FR,AR,2018.0,105,108,-3
CA,US,2018.0,3840,3548,292
SE,BR,2004.0,13,14,-1
GB,IR,2011.0,97,64,33
AU,US,1997.0,692,763,-71
GB,AU,2015.0,1519,1257,262
GB,PL,2012.0,105,86,19
DE,GB,2004.0,536,473,63
ZA,GB,2002.0,64,60,4
KR,JP,2010.0,308,350,-42
CN,GB,2006.0,333,407,-74
US,FR,2014.0,1345,1629,-284
AU,VN,2005.0,2,4,-2
NZ,CN,2009.0,25,29,-4
US,IN,2008.0,1362,1498,-136
NL,US,1997.0,228,220,8
IN,NP,2014.0,85,121,-36
KR,JP,2019.0,368,395,-27
MY,IT,2010.0,38,52,-14
NP,GB,2000.0,3,1,2
SA,AU,2018.0,35,52,-17
US,ES,2007.0,719,712,7
LB,QA,2022.0,8,1,7
US,BE,2010.0,291,253,38
CZ,IN,2014.0,14,36,-22
OM,US,2002.0,11,6,5
AT,DE,2018.0,651,743,-92
CO,CL,2016.0,234,256,-22
AT,CA,2010.0,33,27,6
DE,JP,1997.0,100,78,22
US,BE,2017.0,373,428,-55
AU,FR,2019.0,129,137,-8
HK,CN,2017.0,144,136,8
AU,US,1998.0,904,951,-47
NZ,CA,2003.0,41,35,6
US,CH,2010.0,779,593,186
CN,BD,2011.0,51,69,-18
GB,IE,2017.0,439,396,43
ES,US,1998.0,318,374,-56
US,QA,2020.0,85,85,0
JP,SG,2009.0,38,36,2
ES,EC,2015.0,148,35,113
ES,AT,2005.0,11,7,4
DE,CN,2006.0,239,147,92
GB,nan,2016.0,107,98,9
MY,BR,2011.0,135,47,88
QA,KR,2015.0,6,2,4
FR,BR,2002.0,75,70,5
MX,US,2012.0,359,343,16
ET,KR,2010.0,139,101,38
ET,KR,2019.0,119,98,21
ES,SE,2012.0,43,51,-8
ES,DE,2012.0,255,212,43
JP,UA,2005.0,6,6,0
DE,AU,2016.0,251,238,13
DE,TN,2008.0,5,2,3
GB,JP,2021.0,218,163,55
SI,ES,2020.0,16,8,8
KR,IN,2018.0,178,229,-51
DE,AT,2007.0,387,345,42
IN,IE,2003.0,7,5,2
AT,BE,2022.0,16,6,10
AU,FR,2017.0,112,160,-48
FR,MA,2009.0,228,207,21
KR,ET,2000.0,44,74,-30
ET,KR,2017.0,120,94,26
GB,QA,2016.0,58,24,34
TW,US,2012.0,743,745,-2
CZ,RU,2016.0,71,58,13
MX,ES,2009.0,554,492,62
MX,CO,2021.0,238,297,-59
ES,NL,2022.0,67,56,11
US,NO,2022.0,122,96,26
GB,NZ,1998.0,87,76,11
AU,nan,2020.0,25,30,-5
PH,AU,2014.0,17,18,-1
PE,MX,2015.0,135,95,40
AU,PG,2013.0,4,4,0
QA,CA,2022.0,17,6,11
FR,MX,2022.0,31,27,4
JM,GB,2008.0,9,3,6
CN,ID,2016.0,215,107,108
CN,CA,2020.0,494,698,-204
SE,ZA,2016.0,16,8,8
KR,CA,2021.0,49,51,-2
BR,DE,2012.0,167,230,-63
MY,PK,2016.0,102,86,16
AU,ZA,2022.0,44,31,13
FR,IT,2013.0,326,423,-97
GB,IE,2010.0,341,261,80
AR,PE,2013.0,39,33,6
ES,PE,2001.0,13,23,-10
CA,IE,2017.0,169,130,39
US,PK,2007.0,116,92,24
GB,BR,2017.0,227,254,-27
MY,IT,2017.0,46,35,11
FI,US,2014.0,127,137,-10
AU,KR,2016.0,34,68,-34
RS,US,2005.0,42,39,3
HR,RS,2015.0,141,123,18
CA,IE,2019.0,170,186,-16
FR,SE,2009.0,74,50,24
DK,CN,2017.0,48,55,-7
NZ,AU,2013.0,222,134,88
CU,ES,2006.0,58,63,-5
GB,NO,2007.0,49,39,10
CO,AU,2018.0,17,13,4
HK,NL,2002.0,5,5,0
US,CH,2019.0,981,950,31
AU,IN,2016.0,189,219,-30
KR,GB,1999.0,30,27,3
HK,CN,2019.0,137,144,-7
CL,AR,2009.0,48,59,-11
CN,NO,2019.0,32,40,-8
DE,FR,2015.0,529,576,-47
GB,ZA,2005.0,89,98,-9
IN,NZ,2018.0,53,41,12
JP,AU,2016.0,100,112,-12
IT,JP,2019.0,62,70,-8
BE,MX,2013.0,9,7,2
DE,JP,1998.0,108,118,-10
US,SY,2020.0,8,9,-1
CN,JP,2022.0,254,365,-111
SA,CN,2020.0,61,65,-4
IN,CA,2011.0,192,154,38
RS,SK,2006.0,7,2,5
SG,CH,2008.0,5,13,-8
KW,IR,2016.0,5,2,3
GB,BR,2019.0,289,337,-48
IT,DE,1997.0,87,79,8
IT,JP,2017.0,66,63,3
PL,DE,2007.0,104,88,16
SE,FI,2018.0,109,114,-5
ES,nan,2003.0,11,12,-1
US,BE,2019.0,396,444,-48
AT,SK,2011.0,16,12,4
CN,AU,2020.0,541,597,-56
TH,DE,2020.0,19,16,3
NO,DE,2009.0,48,82,-34
NL,ID,2015.0,37,18,19
CA,LU,2007.0,2,1,1
FR,AU,2018.0,127,136,-9
DK,SE,2014.0,126,127,-1
NL,GR,2007.0,15,10,5
GB,IN,1999.0,98,125,-27
GB,BR,2010.0,152,135,17
CH,PL,2021.0,22,25,-3
nan,ES,2018.0,58,81,-23
CA,LK,2016.0,4,5,-1
PE,EC,2016.0,42,14,28
IR,CH,2008.0,17,5,12
FR,LB,2015.0,102,43,59
CH,AT,2009.0,71,99,-28
MD,FR,2004.0,57,47,10
CA,FR,2009.0,468,525,-57
AU,FR,2010.0,117,126,-9
US,SE,2012.0,380,362,18
CN,NO,2010.0,33,28,5
CN,VN,2009.0,20,46,-26
HK,CN,2010.0,69,93,-24
PL,CN,2011.0,36,31,5
CN,IT,2013.0,29,49,-20
CN,BE,2009.0,46,46,0
CN,BG,2012.0,18,15,3
CZ,CN,2016.0,23,15,8
IL,CN,2010.0,22,19,3
JP,DE,2004.0,167,150,17
MM,CN,2008.0,13,3,10
GB,MA,2007.0,7,9,-2
CN,KR,2006.0,165,219,-54
GB,GR,2009.0,179,156,23
CN,ES,2016.0,59,74,-15
TR,CA,2019.0,46,21,25
MX,BR,2011.0,79,87,-8
GR,CN,2010.0,19,31,-12
TH,AU,1998.0,4,9,-5
BD,CN,2004.0,4,6,-2
QA,SA,2011.0,12,4,8
nan,IT,2011.0,83,133,-50
NL,US,1998.0,302,314,-12
GB,CN,1999.0,159,127,32
FI,TH,2018.0,2,1,1
DE,UA,2014.0,19,38,-19
MY,SA,2021.0,52,28,24
SG,JP,2000.0,9,15,-6
JP,CH,1999.0,43,50,-7
IT,NL,2000.0,51,41,10
CO,nan,2015.0,12,13,-1
IT,ES,2012.0,248,214,34
SE,JP,2016.0,43,39,4
NL,CN,2021.0,166,126,40
JP,TH,2020.0,130,77,53
nan,FR,2013.0,220,154,66
NL,DK,2015.0,45,37,8
RU,US,2023.0,29,20,9
DK,GB,2016.0,143,129,14
ES,DK,2015.0,52,32,20
AE,SA,2018.0,19,46,-27
JP,FR,2001.0,76,64,12
IN,ET,2015.0,27,11,16
JP,MM,2018.0,21,14,7
QA,EG,2007.0,5,6,-1
TR,DE,2017.0,112,75,37
IN,IT,2013.0,81,63,18
CA,MA,2021.0,18,12,6
JP,BD,2020.0,82,51,31
ES,CR,2016.0,58,63,-5
MY,ET,2017.0,4,3,1
US,IR,2015.0,368,740,-372
JP,IN,2022.0,58,72,-14
DE,RU,2001.0,78,162,-84
DE,VN,2021.0,23,16,7
TR,DE,2019.0,132,84,48
GR,TR,2021.0,7,6,1
US,AT,2007.0,191,167,24
BR,CH,2012.0,50,38,12
CN,NO,2017.0,27,32,-5
RO,JP,2017.0,1,7,-6
TW,SI,2009.0,1,4,-3
CZ,JP,2007.0,15,17,-2
TR,TW,2008.0,13,7,6
NO,IT,2011.0,18,25,-7
SG,NZ,2020.0,19,27,-8
DE,TR,2018.0,79,122,-43
CH,FR,1997.0,115,100,15
PL,FI,2015.0,11,7,4
CA,DE,2016.0,319,287,32
MX,JP,2015.0,9,10,-1
JP,EG,2011.0,87,46,41
BE,DE,2005.0,72,62,10
IT,PT,2021.0,42,35,7
RO,ID,2020.0,6,4,2
SA,IN,2015.0,57,174,-117
CU,AR,2016.0,23,20,3
SI,HR,2013.0,17,36,-19
DK,CN,2010.0,29,30,-1
EG,ES,2020.0,6,8,-2
IT,DK,2020.0,47,47,0
PL,CZ,2018.0,100,87,13
CA,SE,2008.0,50,32,18
ES,IT,2008.0,147,190,-43
OM,US,2005.0,11,12,-1
IN,EE,2018.0,4,6,-2
PL,UA,2017.0,53,48,5
BG,US,2016.0,29,40,-11
US,PA,2011.0,66,33,33
IT,nan,2016.0,95,132,-37
ID,AU,2020.0,67,77,-10
FI,ES,2017.0,23,21,2
SG,PK,2013.0,5,1,4
GR,IN,2009.0,7,6,1
GA,DE,2018.0,8,5,3
PR,KR,2003.0,22,21,1
LB,US,2003.0,16,32,-16
BR,MY,2011.0,47,135,-88
DE,SE,2021.0,190,214,-24
CM,AU,2019.0,1,1,0
HU,NL,2005.0,12,9,3
DE,AE,2014.0,6,3,3
PE,CO,2022.0,28,37,-9
nan,UA,2001.0,11,5,6
DK,DE,2021.0,146,160,-14
FR,TH,2009.0,10,13,-3
TR,IT,2020.0,21,17,4
CH,CZ,2007.0,21,16,5
TR,CH,2015.0,16,20,-4
CN,MN,2021.0,4,3,1
AT,HU,2012.0,29,36,-7
ES,SV,2022.0,3,3,0
SK,CZ,2001.0,30,28,2
ES,CM,2020.0,3,1,2
JP,SE,2003.0,37,36,1
CH,TR,2018.0,14,27,-13
BE,AT,2006.0,9,10,-1
US,OM,2016.0,11,7,4
BG,JP,2000.0,7,1,6
PL,GB,2008.0,84,28,56
BE,BR,2005.0,35,34,1
CH,AR,2005.0,6,5,1
AT,CZ,2017.0,23,33,-10
CA,NZ,2000.0,35,34,1
KR,nan,2013.0,33,20,13
CO,BR,2003.0,16,15,1
IL,ES,2000.0,7,8,-1
ET,BE,2019.0,9,6,3
US,TH,2011.0,217,126,91
CA,SG,2005.0,24,27,-3
NL,nan,2006.0,60,46,14
DZ,JP,1998.0,1,2,-1
ID,NL,2017.0,33,44,-11
LU,GB,2020.0,13,10,3
SI,US,2005.0,17,18,-1
UA,EC,2013.0,26,47,-21
ZA,GB,2005.0,98,89,9
RU,IL,2019.0,47,63,-16
TR,JP,2017.0,38,24,14
CA,SG,2002.0,20,22,-2
IN,RU,2020.0,35,20,15
IT,DE,1998.0,127,93,34
MY,GH,2019.0,5,4,1
ES,PA,2013.0,7,11,-4
DE,GH,2017.0,10,10,0
IN,LK,2018.0,25,21,4
RU,CZ,2020.0,67,54,13
BG,CN,2022.0,2,4,-2
BE,CN,2000.0,10,24,-14
TR,JP,2010.0,33,35,-2
MX,EC,2020.0,141,131,10
NG,ID,2020.0,33,19,14
SE,CH,2019.0,83,83,0
US,SA,2008.0,81,52,29
SK,ES,2018.0,3,5,-2
FR,FI,2020.0,34,32,2
NL,SE,2020.0,80,72,8
BO,US,2011.0,9,7,2
AR,IN,2021.0,7,2,5
SK,CN,2019.0,5,4,1
HU,ES,2014.0,9,4,5
IN,RO,2012.0,28,20,8
JO,AE,2021.0,25,15,10
BE,IE,2017.0,7,5,2
AE,SD,2018.0,5,6,-1
CA,QA,2014.0,26,6,20
CA,MY,2012.0,23,37,-14
MY,US,2009.0,52,112,-60
ZA,GH,2020.0,27,19,8
NL,SG,2006.0,4,7,-3
GB,UA,2006.0,12,8,4
IN,PK,2009.0,81,80,1
RU,BE,1999.0,11,6,5
VE,US,2016.0,53,30,23
CL,NI,2018.0,6,1,5
TW,JP,2018.0,100,85,15
SI,DE,2015.0,23,11,12
CH,SG,2020.0,24,21,3
NL,ET,2018.0,21,7,14
SE,KE,2021.0,3,9,-6
EC,PA,2020.0,6,7,-1
PR,ET,2020.0,12,3,9
MA,PT,2021.0,35,30,5
CU,CH,2020.0,2,1,1
UA,CZ,2019.0,37,30,7
IN,MX,2021.0,12,6,6
GB,KW,2021.0,20,8,12
FR,GF,2022.0,9,14,-5
US,PY,2016.0,6,8,-2
MD,CH,2022.0,6,1,5
IN,TW,2000.0,13,7,6
PA,BO,2018.0,1,1,0
IT,VN,2021.0,1,4,-3
CN,LT,2007.0,3,3,0
BE,TR,2022.0,10,13,-3
CN,FI,2022.0,30,40,-10
KE,US,2011.0,46,49,-3
CA,IE,2010.0,152,112,40
IT,FI,2016.0,18,15,3
SG,IE,2014.0,6,6,0
FI,KE,2018.0,2,4,-2
BE,DK,2020.0,73,76,-3
US,SS,2008.0,5,1,4
ID,EG,2012.0,4,4,0
SE,MX,2021.0,7,9,-2
US,ZM,2019.0,19,14,5
KR,EG,2022.0,7,6,1
CO,MX,2012.0,221,238,-17
HR,SI,2008.0,15,14,1
CA,IR,2012.0,117,210,-93
UA,RU,2020.0,696,545,151
AU,NL,2004.0,40,36,4
IN,CN,2011.0,196,165,31
US,RU,2009.0,304,447,-143
ID,JP,2016.0,78,226,-148
US,PL,2012.0,240,206,34
GR,KR,2016.0,1,7,-6
ID,NL,2019.0,45,50,-5
CN,PH,2014.0,24,16,8
ZA,AU,2018.0,100,58,42
IE,AU,1999.0,34,42,-8
NL,RO,2017.0,11,6,5
RU,IL,2017.0,31,31,0
GR,LK,2020.0,4,2,2
DE,GR,2011.0,63,66,-3
IT,NO,2020.0,39,29,10
NG,CA,2016.0,8,13,-5
NL,FR,2011.0,162,168,-6
IL,CN,2019.0,21,21,0
CA,BE,2011.0,49,69,-20
TZ,GB,2005.0,8,4,4
ES,IS,2014.0,7,4,3
IS,ES,2015.0,4,7,-3
US,SK,2002.0,18,38,-20
PT,IR,2013.0,3,15,-12
SI,BY,2014.0,1,1,0
IN,DE,2003.0,127,66,61
US,RS,2015.0,65,54,11
DK,ES,2014.0,27,41,-14
HU,CA,1999.0,7,9,-2
CA,SA,2005.0,21,19,2
UA,US,2007.0,40,32,8
AU,IT,2003.0,25,36,-11
GB,KE,2016.0,33,21,12
NZ,US,2000.0,172,173,-1
NO,CH,2020.0,20,25,-5
KE,BE,2017.0,4,5,-1
NL,GH,2007.0,3,1,2
GP,FR,2020.0,19,18,1
nan,CN,2002.0,45,38,7
TH,CA,2011.0,14,9,5
FR,BD,2013.0,6,8,-2
TR,KZ,2012.0,44,44,0
BR,AR,2003.0,36,47,-11
SA,EG,2006.0,37,41,-4
TR,JP,2019.0,85,31,54
BE,ZA,2015.0,24,24,0
TR,DE,2010.0,65,59,6
CZ,CA,2008.0,11,8,3
AU,PL,2006.0,4,12,-8
EG,AU,2021.0,19,14,5
IS,SE,2010.0,16,18,-2
GH,ZM,2019.0,24,44,-20
PL,UA,2010.0,13,14,-1
GH,ZM,2017.0,31,29,2
SG,TH,2021.0,11,6,5
GB,NG,1998.0,11,9,2
VE,SE,2005.0,1,1,0
DK,CN,2019.0,53,50,3
UA,CH,2015.0,11,6,5
RO,US,2003.0,43,21,22
FR,NC,2016.0,23,11,12
NO,US,2000.0,68,65,3
KW,TN,2023.0,1,1,0
AR,PT,2021.0,15,14,1
CA,TW,2020.0,30,42,-12
FR,PF,2018.0,29,6,23
MK,AU,2020.0,55,28,27
KR,PR,2008.0,15,32,-17
PK,DE,2007.0,10,10,0
NZ,AE,2023.0,2,1,1
EG,PS,2020.0,19,14,5
SK,IR,2022.0,1,4,-3
DK,PT,2021.0,10,7,3
FR,SG,2022.0,15,21,-6
IR,TR,2016.0,48,26,22
BR,ZA,2012.0,7,9,-2
RO,JP,2019.0,5,6,-1
IN,OM,2014.0,26,22,4
UZ,CZ,2014.0,4,6,-2
SN,ML,2020.0,3,3,0
PT,DK,2015.0,11,7,4
US,MY,2011.0,138,78,60
KR,CH,2004.0,4,4,0
IR,CA,2003.0,32,39,-7
TR,US,2023.0,22,13,9
FI,ES,2010.0,19,10,9
US,BW,2013.0,10,10,0
DK,FI,2008.0,9,16,-7
DE,CL,2005.0,28,18,10
DE,PA,2015.0,4,5,-1
KW,IN,2014.0,12,9,3
AU,ES,2022.0,42,34,8
PL,BR,2017.0,16,15,1
DE,FI,2000.0,24,24,0
EC,CU,2016.0,9,55,-46
IQ,TN,2019.0,3,4,-1
OM,FR,2009.0,3,4,-1
UG,PK,2019.0,2,1,1
BE,DE,2002.0,65,58,7
EC,RU,2011.0,1,7,-6
DE,GH,2019.0,21,21,0
CN,LU,2020.0,4,1,3
CH,BA,2012.0,1,2,-1
PT,FR,2003.0,20,36,-16
KR,AT,2015.0,6,11,-5
CA,IL,2009.0,38,56,-18
LU,JP,2013.0,3,1,2
AT,AR,2013.0,1,2,-1
FR,GA,2015.0,13,5,8
NP,IN,2009.0,41,43,-2
ME,BA,2019.0,3,2,1
GB,AE,2002.0,8,4,4
AT,CZ,2019.0,24,48,-24
IL,IT,1999.0,9,5,4
JP,BG,2006.0,5,5,0
CL,CR,2021.0,30,27,3
US,ID,1998.0,9,11,-2
FR,MQ,2018.0,21,11,10
ID,KR,2011.0,7,11,-4
GR,CN,2017.0,12,5,7
ES,MA,2021.0,11,10,1
KR,NL,2001.0,3,3,0
IT,IL,2018.0,24,25,-1
IR,TH,2018.0,3,4,-1
ES,SA,2017.0,13,8,5
AT,CA,2019.0,27,25,2
ES,ZA,2016.0,16,14,2
TR,CA,2017.0,34,27,7
ZM,CN,2014.0,2,3,-1
UG,NG,2021.0,5,11,-6
DK,ID,2013.0,3,3,0
MY,IT,2019.0,46,47,-1
CZ,PL,2021.0,73,87,-14
ID,TR,2016.0,6,15,-9
KR,NP,2017.0,13,7,6
CH,HU,2005.0,13,5,8
DK,PL,2020.0,14,8,6
RS,SI,2019.0,19,20,-1
DZ,US,2022.0,23,18,5
NL,KE,2013.0,14,2,12
CA,PK,2008.0,13,12,1
ID,IQ,2018.0,9,5,4
ES,RO,2021.0,11,12,-1
PK,CH,2016.0,25,7,18
BN,MY,2020.0,8,22,-14
NL,RO,2019.0,18,9,9
IN,CZ,2021.0,29,13,16
CA,KE,2018.0,10,7,3
AU,BG,2018.0,4,3,1
IS,US,2011.0,17,14,3
BE,IE,2019.0,9,13,-4
DK,CA,2022.0,18,42,-24
FR,MD,1998.0,34,60,-26
AT,IT,2007.0,30,23,7
BR,SE,1999.0,5,9,-4
FI,ES,2019.0,26,24,2
CU,US,2012.0,37,32,5
FI,EE,2021.0,14,11,3
TT,IN,2020.0,2,4,-2
GR,US,2023.0,9,4,5
GN,MA,2020.0,1,1,0
IE,DE,2012.0,65,67,-2
MA,GR,2020.0,1,1,0
AT,CA,2017.0,23,37,-14
VE,IT,2009.0,14,3,11
NO,GB,2021.0,56,108,-52
ET,JP,2016.0,7,4,3
CG,FR,2011.0,18,18,0
CZ,ES,2016.0,14,25,-11
BE,PL,2014.0,18,17,1
UA,CI,2017.0,1,1,0
TR,CO,2016.0,23,7,16
CN,KE,2022.0,6,8,-2
PK,SE,2022.0,16,6,10
AR,VE,2004.0,11,6,5
CA,NP,2012.0,3,2,1
HR,AT,2014.0,11,4,7
TH,JP,2003.0,24,40,-16
PL,CA,2000.0,8,10,-2
NZ,AT,2009.0,4,4,0
US,NP,2007.0,8,15,-7
NL,IR,2023.0,1,3,-2
BE,FI,2021.0,15,8,7
IE,RU,2019.0,14,5,9
BE,IT,2004.0,67,59,8
AU,OM,2018.0,13,2,11
SI,BE,2013.0,3,3,0
FR,NO,2023.0,2,1,1
CA,SA,2002.0,21,5,16
FR,IL,2001.0,30,32,-2
CY,GR,2015.0,27,60,-33
AU,TH,2002.0,15,6,9
AU,TH,2005.0,24,7,17
AT,NZ,2019.0,4,5,-1
RO,CA,2013.0,11,12,-1
BG,BE,2004.0,6,7,-1
GB,BG,2015.0,17,17,0
AU,RS,2013.0,9,3,6
UA,DE,2004.0,39,21,18
HU,AT,2012.0,36,29,7
nan,IR,2005.0,2,3,-1
GM,GB,2008.0,12,9,3
NG,PK,2008.0,3,1,2
AO,ES,2011.0,4,1,3
RS,SI,2017.0,21,20,1
DE,GE,1997.0,4,1,3
UG,PK,2017.0,3,1,2
CM,BJ,2000.0,1,4,-3
RO,UA,1997.0,1,1,0
SK,CN,2010.0,8,2,6
US,LV,2016.0,8,3,5
NG,NL,2016.0,6,5,1
IT,AO,2015.0,3,1,2
MX,nan,2021.0,22,32,-10
ZM,AU,2015.0,1,1,0
TN,GB,2021.0,3,3,0
HK,NL,2005.0,10,2,8
TW,AE,2021.0,3,1,2
TR,ES,2013.0,5,12,-7
GR,RS,2005.0,1,1,0
CA,SI,2016.0,2,3,-1
DE,CL,2002.0,15,6,9
ES,PL,2013.0,17,14,3
PL,BE,2002.0,14,11,3
DK,NZ,2006.0,3,4,-1
IL,AT,2020.0,16,8,8
EG,DE,2003.0,20,19,1
IT,CL,2021.0,15,31,-16
CA,BG,2007.0,4,3,1
BR,SK,2007.0,1,1,0
ET,NL,2015.0,6,5,1
NL,AR,2012.0,6,8,-2
NO,NL,2006.0,15,22,-7
SE,nan,2000.0,40,42,-2
DE,SI,2001.0,4,6,-2
CH,PK,2005.0,8,19,-11
IE,FR,2000.0,10,4,6
US,GT,2011.0,10,2,8
FR,TW,2013.0,15,15,0
DE,MY,2020.0,12,26,-14
IR,US,2000.0,13,18,-5
CH,NZ,2001.0,6,5,1
RU,BG,2016.0,30,41,-11
CN,LK,2016.0,8,9,-1
NP,KR,2002.0,1,1,0
IN,ZA,2022.0,35,29,6
SE,KR,2018.0,5,8,-3
US,TZ,2001.0,4,3,1
ZA,FR,2000.0,7,13,-6
SA,LB,2012.0,7,6,1
NZ,IE,2011.0,8,17,-9
NL,KR,2020.0,10,12,-2
IN,BJ,2015.0,2,1,1
MA,US,2001.0,11,8,3
EC,US,2009.0,19,19,0
RU,NO,2003.0,6,2,4
RO,JP,2010.0,3,6,-3
ZA,IN,2001.0,11,3,8
FJ,NZ,2012.0,3,2,1
BE,BR,2002.0,20,17,3
CA,DK,2009.0,34,21,13
GB,AR,2018.0,24,45,-21
BY,ES,2015.0,1,1,0
GB,PE,2011.0,8,7,1
FI,KR,2005.0,6,6,0
FR,KE,2007.0,2,4,-2
FR,LU,1998.0,7,7,0
ID,PL,2019.0,7,4,3
FI,SG,2020.0,4,2,2
IT,NZ,2012.0,6,8,-2
ES,LK,2011.0,5,1,4
HK,GB,2012.0,7,9,-2
MX,BO,2016.0,8,15,-7
NZ,JP,2016.0,8,18,-10
BE,CH,2008.0,44,43,1
US,ZM,2017.0,22,11,11
NL,AT,2007.0,10,21,-11
TW,SG,1999.0,11,8,3
PT,RU,2013.0,3,5,-2
SJ,NO,2008.0,3,7,-4
nan,AT,2005.0,15,6,9
TZ,DE,2016.0,3,8,-5
TN,US,2003.0,3,8,-5
TN,EG,2013.0,8,10,-2
BH,AE,2020.0,5,4,1
AE,PK,2017.0,8,13,-5
GE,PL,2003.0,2,1,1
RW,BE,2011.0,5,6,-1
KE,TZ,2017.0,9,8,1
nan,PE,2005.0,4,4,0
RU,IL,2010.0,25,29,-4
CU,PY,2021.0,2,6,-4
RU,NZ,2013.0,10,3,7
nan,DZ,2021.0,10,4,6
TW,NZ,2018.0,4,7,-3
AT,nan,2011.0,11,5,6
CZ,RS,2021.0,6,7,-1
NZ,FR,2012.0,21,27,-6
BE,BI,2015.0,4,2,2
FR,CM,2021.0,12,9,3
nan,SG,2018.0,4,17,-13
HU,CH,2018.0,19,12,7
GB,EE,2012.0,12,6,6
BE,IE,2010.0,7,8,-1
UA,IN,2015.0,3,5,-2
ET,US,2009.0,33,23,10
BR,ST,2007.0,12,17,-5
DE,CU,2019.0,3,6,-3
NO,nan,2021.0,12,16,-4
EE,NO,2020.0,5,3,2
ID,NO,2017.0,2,3,-1
US,KH,2010.0,3,2,1
FR,UY,2000.0,5,2,3
GR,CA,2020.0,15,14,1
AU,LK,2012.0,9,18,-9
RU,LV,2020.0,14,18,-4
ID,PL,2017.0,1,6,-5
RU,CU,2019.0,3,2,1
LK,DE,2011.0,2,1,1
SY,LB,2018.0,3,1,2
RS,US,2002.0,20,21,-1
SI,JP,2009.0,3,3,0
IS,SE,2019.0,14,30,-16
IT,IQ,2011.0,2,1,1
KW,GR,2012.0,5,2,3
AR,SE,2004.0,2,4,-2
HK,CA,2011.0,3,2,1
TH,NL,2012.0,9,8,1
GB,CY,2011.0,38,17,21
BE,CI,2020.0,5,2,3
GB,AE,2005.0,11,6,5
VN,TW,2015.0,13,21,-8
TH,VN,2011.0,2,2,0
AU,GE,1998.0,1,1,0
TR,NL,2011.0,31,19,12
US,TN,2007.0,6,11,-5
PH,DE,2021.0,6,9,-3
GB,GM,2014.0,11,7,4
IE,ES,2021.0,35,34,1
HU,IL,2012.0,7,4,3
SN,CG,2010.0,1,2,-1
KH,US,2004.0,1,2,-1
VN,nan,2020.0,5,7,-2
RS,DK,2014.0,2,1,1
PT,PL,2014.0,6,5,1
FR,SK,2009.0,9,10,-1
AU,IL,1997.0,4,4,0
GT,BR,2016.0,3,5,-2
BE,MA,2016.0,7,5,2
FR,DK,2011.0,43,37,6
CA,ET,2017.0,4,3,1
DO,VE,2020.0,1,1,0
UG,CN,2021.0,2,2,0
TH,MY,2019.0,4,14,-10
BG,CA,2014.0,3,6,-3
BZ,FR,2006.0,7,2,5
CN,CZ,1999.0,3,4,-1
SK,NL,2021.0,3,2,1
BG,GB,1999.0,8,5,3
FR,EE,2009.0,2,10,-8
AU,DK,2001.0,25,18,7
VE,FR,2005.0,6,3,3
MY,SI,2014.0,5,4,1
US,AE,2000.0,24,5,19
NG,IT,2009.0,5,4,1
AU,FI,2013.0,19,16,3
LT,FR,2013.0,5,2,3
PL,IN,2008.0,4,3,1
FR,GH,2018.0,5,1,4
AT,IR,2012.0,7,11,-4
KE,KR,2013.0,1,2,-1
BE,BF,2003.0,1,2,-1
NP,MY,2012.0,2,1,1
PL,BE,2005.0,14,6,8
ID,NL,2010.0,16,22,-6
NO,ET,2016.0,10,14,-4
nan,IN,2006.0,10,17,-7
CH,PT,1997.0,4,2,2
AU,SE,1998.0,21,13,8
nan,TR,2003.0,2,1,1
FR,NZ,1997.0,5,4,1
FR,MG,2002.0,5,3,2
RO,IT,1998.0,6,8,-2
AE,PK,2019.0,14,36,-22
HR,TR,2014.0,1,3,-2
UA,BG,2007.0,9,4,5
JO,AU,2014.0,5,4,1
SG,BD,2003.0,1,1,0
SN,CI,2007.0,1,1,0
TH,MY,2010.0,3,5,-2
IT,ZA,2009.0,9,8,1
DE,RO,2004.0,17,25,-8
GB,MW,2003.0,3,8,-5
UG,GB,1998.0,1,2,-1
US,BY,2007.0,12,7,5
RU,IE,2007.0,8,3,5
US,KH,2019.0,9,4,5
NL,CZ,2002.0,6,7,-1
GB,VE,2010.0,3,2,1
DK,CH,2009.0,20,38,-18
EE,AT,2012.0,2,7,-5
RO,KR,2011.0,2,1,1
PT,CA,2006.0,14,11,3
PE,NL,2019.0,4,2,2
CH,HU,2002.0,6,8,-2
CA,PH,2008.0,6,6,0
IR,FR,2000.0,2,3,-1
ES,SG,1999.0,1,1,0
RS,BA,2004.0,4,1,3
ES,RS,2011.0,6,1,5
VG,US,2022.0,2,2,0
PL,FR,2013.0,39,53,-14
JP,MX,2008.0,5,7,-2
ES,KR,2003.0,1,5,-4
KE,BE,2019.0,5,7,-2
AZ,US,2018.0,2,1,1
ST,BR,2014.0,36,24,12
BE,MD,1998.0,3,3,0
AU,HU,2004.0,6,16,-10
IN,MY,2001.0,8,10,-2
CZ,BR,2004.0,4,3,1
AU,IL,1998.0,6,5,1
PA,PT,2014.0,1,2,-1
GB,NG,1997.0,2,6,-4
HK,FR,2010.0,4,4,0
PE,AR,2006.0,5,7,-2
nan,FI,1997.0,4,2,2
AU,SE,1997.0,7,14,-7
NO,GH,2020.0,5,2,3
AR,CU,1999.0,6,6,0
DK,nan,2007.0,19,14,5
US,ET,2003.0,11,13,-2
ID,CA,2012.0,8,10,-2
ES,HN,2009.0,3,1,2
AT,AU,2012.0,25,23,2
BE,NZ,2015.0,3,3,0
ES,SA,2019.0,4,10,-6
IL,NO,2006.0,2,1,1
KR,AM,2000.0,4,2,2
nan,LK,2018.0,4,1,3
IS,NO,2015.0,6,8,-2
US,HN,1999.0,5,3,2
EC,TW,2018.0,1,1,0
HU,IS,2016.0,2,1,1
nan,GE,2014.0,6,3,3
LB,BE,2019.0,9,11,-2
CO,SE,2006.0,4,3,1
US,ZM,2010.0,11,4,7
CR,PY,2019.0,4,2,2
TZ,NL,2018.0,3,5,-2
ID,AR,2017.0,2,7,-5
MX,UY,2021.0,9,10,-1
VN,SE,2018.0,2,3,-1
GR,CN,2019.0,10,6,4
EG,TR,2018.0,9,6,3
LT,JP,2000.0,4,6,-2
PY,nan,2020.0,2,1,1
IL,CN,2017.0,16,21,-5
US,RW,2015.0,10,9,1
SE,HU,2006.0,7,6,1
DK,PH,2020.0,2,1,1
KR,ID,2021.0,42,54,-12
IR,AU,2023.0,6,2,4
ID,CW,2021.0,1,3,-2
IN,BD,1999.0,6,1,5
ID,NO,2019.0,5,8,-3
CZ,IL,2005.0,4,2,2
UG,BE,2009.0,6,2,4
QA,GR,2012.0,2,3,-1
SE,VN,2009.0,4,1,3
TR,JO,2019.0,2,3,-1
JM,US,2009.0,10,13,-3
UA,CN,2005.0,11,13,-2
SG,CA,2004.0,19,17,2
ZA,AE,2001.0,1,1,0
MY,NL,2015.0,10,12,-2
NL,CW,2008.0,4,11,-7
IN,TH,1999.0,1,1,0
EG,CN,2023.0,3,2,1
FR,UA,2002.0,6,8,-2
UY,US,1998.0,6,6,0
FR,NG,2013.0,5,6,-1
DE,ZA,2000.0,11,14,-3
IT,EG,2011.0,9,8,1
KE,AU,2014.0,6,7,-1
ZA,ZM,2014.0,7,5,2
KH,TR,2018.0,1,2,-1
CN,ZW,2002.0,2,5,-3
XK,IT,2017.0,1,1,0
IR,AZ,2014.0,1,3,-2
ID,BH,2021.0,2,2,0
CZ,FI,2006.0,5,4,1
ES,AT,2002.0,6,10,-4
GB,VE,2017.0,2,8,-6
OM,SA,2013.0,4,4,0
IT,PL,2001.0,10,10,0
JP,AR,2006.0,6,3,3
AE,TR,2019.0,3,6,-3
AR,FI,2020.0,4,2,2
GH,ZA,2009.0,2,1,1
PT,NG,2018.0,2,1,1
IT,GH,2018.0,3,2,1
FI,PL,2015.0,7,11,-4
TN,MD,2016.0,3,7,-4
CY,DE,2017.0,7,2,5
FR,MD,1997.0,21,42,-21
AT,NZ,2010.0,3,4,-1
BR,UY,2002.0,11,21,-10
SE,NZ,2012.0,8,11,-3
TR,ET,2022.0,2,2,0
PL,AT,2006.0,9,9,0
PS,DE,2015.0,4,7,-3
RO,IT,1997.0,5,3,2
RU,FI,2023.0,3,3,0
SA,BH,2013.0,3,3,0
MA,DE,2014.0,4,9,-5
CY,DE,2019.0,9,9,0
BA,RS,2008.0,8,7,1
MZ,ZA,2021.0,3,1,2
IN,HU,2008.0,3,3,0
BE,GA,2017.0,2,2,0
FI,CA,2009.0,12,23,-11
IQ,QA,2019.0,9,12,-3
RS,AU,2005.0,2,3,-1
HK,US,2000.0,2,3,-1
EG,AE,1999.0,9,4,5
NZ,CL,2016.0,9,3,6
KR,KZ,2018.0,7,3,4
US,HR,2000.0,16,17,-1
NG,ET,2022.0,7,6,1
nan,AT,2002.0,5,7,-2
AU,HK,2010.0,3,4,-1
KR,TR,2020.0,5,9,-4
SG,ES,2013.0,6,7,-1
US,ML,2001.0,2,3,-1
BY,DE,2006.0,8,8,0
PL,DK,1999.0,1,8,-7
AU,MX,2000.0,4,3,1
JO,SA,2007.0,4,4,0
JO,EG,2008.0,3,3,0
AU,EG,2013.0,12,18,-6
SA,NO,1998.0,1,1,0
KR,SG,2000.0,12,5,7
AU,MY,2004.0,12,10,2
MX,CR,2001.0,4,5,-1
FI,NO,1998.0,2,2,0
CO,PE,2000.0,3,8,-5
DK,TR,2002.0,1,4,-3
TR,nan,2011.0,9,11,-2
MD,RU,2011.0,7,4,3
GE,IN,2021.0,1,3,-2
IN,CO,2008.0,1,1,0
US,KN,2017.0,3,7,-4
US,MG,2021.0,2,2,0
US,BD,2000.0,7,15,-8
GH,BR,2016.0,2,1,1
BD,NO,2018.0,1,10,-9
PT,JP,2005.0,3,2,1
BT,NL,2021.0,1,1,0
CO,IE,2015.0,6,5,1
ES,GH,2018.0,2,2,0
UA,ZA,2022.0,1,2,-1
FR,CR,2004.0,3,2,1
NP,AU,2014.0,9,4,5
US,BH,1998.0,6,2,4
NO,HU,2015.0,3,3,0
NZ,IT,2015.0,7,6,1
GA,CM,2000.0,1,1,0
PR,JP,2003.0,1,1,0
IT,JO,2018.0,4,1,3
DE,CU,2017.0,1,4,-3
PK,FR,2021.0,11,12,-1
ES,PK,2001.0,2,1,1
VG,FR,2009.0,2,2,0
RU,RS,2022.0,2,14,-12
PF,FR,2018.0,6,29,-23
ID,BN,2020.0,4,5,-1
RO,PT,2011.0,3,2,1
KZ,RU,2011.0,9,15,-6
SA,ZA,2017.0,3,6,-3
ET,BE,2017.0,9,8,1
GB,BB,2000.0,1,2,-1
OM,CA,2022.0,2,7,-5
SE,BD,1997.0,3,1,2
CH,TN,2021.0,3,5,-2
PE,AT,2018.0,2,1,1
IN,SK,2015.0,2,2,0
PH,CL,2015.0,7,4,3
NG,GM,2018.0,6,2,4
IQ,QA,2017.0,5,11,-6
CM,ID,2018.0,6,2,4
CY,CH,2000.0,1,1,0
VN,RO,2008.0,5,1,4
SE,AT,2001.0,6,7,-1
CH,KE,1998.0,1,2,-1
NP,FR,2022.0,3,2,1
JP,AT,1997.0,3,1,2
SK,GB,1998.0,20,19,1
KY,CN,2022.0,1,2,-1
GR,NL,2001.0,8,6,2
NO,NG,2019.0,2,4,-2
MY,SD,2005.0,2,1,1
ID,RU,2015.0,2,3,-1
ZA,LK,2015.0,2,1,1
CR,CN,2015.0,3,1,2
SG,DK,2021.0,5,1,4
TH,FR,2022.0,8,5,3
PL,RS,2003.0,4,1,3
KE,CA,2005.0,4,2,2
SI,BR,2015.0,4,1,3
BG,AT,2013.0,4,2,2
ME,BA,2017.0,1,4,-3
LB,AT,2019.0,2,1,1
ZA,SD,2020.0,4,3,1
BR,PY,2012.0,3,3,0
IN,AR,2018.0,5,1,4
nan,CO,2012.0,7,6,1
PT,nan,2001.0,3,6,-3
FR,IS,2022.0,2,3,-1
MX,PL,2008.0,5,1,4
KZ,AT,2020.0,2,1,1
MA,ES,2014.0,5,13,-8
GB,TN,2012.0,5,4,1
SI,FR,2003.0,3,7,-4
HU,BE,2000.0,4,6,-2
NL,CZ,2005.0,8,10,-2
FR,EG,2004.0,6,7,-1
ZA,BJ,2018.0,2,2,0
RS,SI,2010.0,9,9,0
PL,BD,2021.0,3,4,-1
ID,CZ,2011.0,3,1,2
KH,JP,2011.0,4,8,-4
NG,BH,2002.0,2,2,0
CM,DE,2008.0,5,3,2
DE,CM,2012.0,9,4,5
CA,KW,2009.0,9,2,7
PL,nan,2011.0,5,5,0
AT,TR,2001.0,5,2,3
CZ,FR,2023.0,1,2,-1
UY,FR,2000.0,2,5,-3
CL,CO,2023.0,2,5,-3
SV,MX,2015.0,3,8,-5
LY,IQ,2016.0,2,1,1
UY,CU,2022.0,1,1,0
CL,IL,2006.0,2,1,1
nan,FI,1998.0,4,3,1
US,BN,2011.0,2,4,-2
KW,BH,2020.0,2,3,-1
RU,CN,1997.0,1,2,-1
KE,EG,2021.0,1,1,0
CO,AR,1999.0,9,12,-3
CO,BG,2017.0,1,2,-1
CZ,PT,2020.0,6,7,-1
PK,EE,2017.0,1,1,0
IN,GE,2012.0,3,5,-2
LY,US,2015.0,3,5,-2
CH,PT,1998.0,2,1,1
FI,NO,1997.0,6,5,1
KR,NP,2010.0,2,4,-2
HR,IE,1998.0,1,1,0
US,SD,2000.0,5,2,3
US,BJ,2016.0,2,4,-2
EG,ID,2013.0,5,3,2
EG,PK,2009.0,4,2,2
RU,IR,2014.0,11,9,2
PK,FI,2014.0,7,6,1
IE,HU,2013.0,1,2,-1
AU,VN,2002.0,3,1,2
UA,CZ,2010.0,5,13,-8
RS,SE,2012.0,4,5,-1
MT,PT,2019.0,1,1,0
AT,ZA,2007.0,4,6,-2
PL,MX,1997.0,4,1,3
KE,IT,2022.0,3,3,0
ET,IL,2016.0,2,1,1
TN,SE,2020.0,5,2,3
KZ,CA,2012.0,1,1,0
MY,KH,2016.0,2,1,1
TZ,RW,2015.0,1,1,0
ZA,GM,2017.0,1,1,0
BE,RO,2001.0,3,9,-6
ES,UA,2018.0,5,4,1
KZ,DE,2018.0,7,6,1
RE,CA,2014.0,3,1,2
GB,CO,1999.0,7,5,2
TW,FR,2009.0,10,19,-9
AT,SE,1998.0,2,9,-7
LB,OM,2019.0,1,2,-1
MA,IT,2009.0,9,13,-4
EG,LY,2013.0,2,5,-3
CL,BO,2006.0,1,1,0
QA,FI,2007.0,1,2,-1
HR,SE,2021.0,5,6,-1
CN,ZA,2003.0,2,4,-2
MR,FR,2018.0,3,2,1
CH,SI,2015.0,2,9,-7
CL,nan,2011.0,6,6,0
JP,TN,2014.0,4,2,2
DZ,PL,2012.0,2,1,1
CO,JP,2015.0,7,7,0
AM,PK,2014.0,1,1,0
NG,DE,1999.0,2,3,-1
CL,RS,2010.0,1,1,0
ID,AR,2019.0,2,8,-6
PT,TR,2011.0,2,1,1
AU,UG,2015.0,2,3,-1
TR,GR,2004.0,1,3,-2
GA,NL,2013.0,5,3,2
BE,JO,2014.0,1,1,0
BR,IL,2000.0,2,3,-1
CA,CU,2007.0,4,4,0
AM,SA,2020.0,1,1,0
NP,QA,2018.0,1,1,0
IT,TH,2001.0,3,3,0
DK,GW,2000.0,1,2,-1
JP,AT,1998.0,4,7,-3
AF,MX,2008.0,5,2,3
AR,MY,1999.0,1,1,0
MY,PL,2019.0,3,1,2
AT,NZ,2017.0,6,8,-2
SK,GR,2018.0,1,1,0
PS,GB,2013.0,3,2,1
JO,IQ,2004.0,1,1,0
TR,CY,2023.0,4,2,2
US,AO,2020.0,3,1,2
AT,CN,2023.0,1,3,-2
TH,NP,2007.0,3,1,2
IT,AZ,2016.0,2,7,-5
RS,AU,2002.0,1,2,-1
BR,UA,2004.0,3,1,2
TR,IN,2023.0,2,2,0
NG,BH,2005.0,1,6,-5
KR,IT,2022.0,4,6,-2
MA,KW,2020.0,3,3,0
US,BI,2008.0,1,1,0
NZ,NG,2012.0,1,2,-1
CA,SK,2013.0,3,10,-7
ES,SA,2010.0,3,1,2
NL,PL,2023.0,2,4,-2
LY,DE,2016.0,1,3,-2
ME,SI,2012.0,2,1,1
PE,NL,2017.0,2,4,-2
PT,IS,2014.0,1,1,0
CD,FR,2018.0,1,6,-5
SK,DK,2009.0,3,4,-1
RS,AT,2006.0,5,5,0
PS,BE,2014.0,1,3,-2
TN,BE,2013.0,2,1,1
DE,IR,2000.0,4,1,3
MY,MM,2014.0,2,2,0
KE,BE,2010.0,2,2,0
PL,AZ,2004.0,1,10,-9
DE,DZ,2022.0,2,2,0
nan,VN,2012.0,3,1,2
BR,AF,2016.0,1,1,0
MY,GH,2017.0,3,4,-1
IT,KZ,2015.0,4,1,3
SK,GB,1997.0,14,17,-3
MA,CH,2018.0,4,6,-2
LU,PL,2019.0,3,1,2
CL,AT,2006.0,1,5,-4
FI,HR,2018.0,3,3,0
BH,EG,2015.0,8,6,2
PK,KW,2015.0,5,2,3
MY,IE,2013.0,5,10,-5
CL,BE,2003.0,5,1,4
AT,TW,2011.0,1,1,0
EG,NL,2008.0,4,6,-2
DE,GH,2010.0,6,4,2
FR,NZ,1998.0,7,5,2
SA,ZA,2019.0,6,10,-4
TH,RU,2018.0,1,4,-3
GB,LU,2001.0,2,1,1
CG,KE,2021.0,1,1,0
ML,FR,2008.0,5,2,3
FJ,NC,2012.0,1,1,0
ES,PS,2007.0,5,6,-1
PL,MX,1998.0,1,2,-1
AU,LU,2012.0,1,2,-1
NL,RO,2010.0,7,7,0
FR,VG,2012.0,2,5,-3
RU,GR,2008.0,2,2,0
SE,UA,2021.0,3,11,-8
NZ,NP,2002.0,2,4,-2
LI,CH,2017.0,3,1,2
AE,TR,2017.0,1,10,-9
AR,GR,2018.0,1,1,0
BY,JP,2000.0,2,2,0
ZW,US,2020.0,7,14,-7
DE,UZ,2004.0,3,3,0
DE,TZ,2006.0,2,1,1
GB,IQ,2007.0,2,3,-1
GF,SN,2002.0,1,1,0
KW,CA,1999.0,2,3,-1
LY,GB,2012.0,1,10,-9
NZ,RU,2012.0,6,2,4
PT,GR,2012.0,1,5,-4
CA,UY,2015.0,2,2,0
SA,AR,2019.0,1,1,0
LB,DE,2015.0,5,9,-4
ZA,JP,2012.0,7,9,-2
HU,NL,2002.0,9,9,0
IS,DK,1999.0,1,2,-1
AT,IL,2006.0,1,10,-9
US,BA,2007.0,7,3,4
CW,US,2009.0,3,1,2
TH,MY,2017.0,4,14,-10
IE,RU,2017.0,4,8,-4
CA,ET,2019.0,9,6,3
ID,CO,2013.0,1,1,0
EG,VN,2021.0,1,4,-3
ES,DZ,2018.0,6,4,2
AR,IL,2007.0,1,3,-2
CA,CY,2015.0,2,1,1
GE,AZ,2007.0,8,1,7
MA,ID,2022.0,1,3,-2
MQ,BE,2017.0,1,1,0
DO,UY,2017.0,1,1,0
ET,IR,2022.0,1,3,-2
NZ,TH,2021.0,6,3,3
AF,US,2011.0,1,3,-2
PK,DK,2016.0,7,9,-2
IN,TZ,2016.0,1,3,-2
JP,AF,2022.0,2,2,0
PT,RS,2011.0,2,2,0
GE,nan,2018.0,1,3,-2
SD,JP,2021.0,2,1,1
GE,CN,2007.0,1,5,-4
CG,BF,2012.0,1,1,0
BY,VN,2015.0,2,1,1
US,RO,2023.0,3,2,1
US,KN,2019.0,5,5,0
HU,BY,2007.0,1,1,0
JP,CM,2007.0,1,2,-1
CY,NG,2020.0,7,10,-3
MY,SD,2002.0,1,1,0
IN,PL,2001.0,3,1,2
HR,CN,2018.0,1,3,-2
CA,ET,2010.0,1,3,-2
RU,LT,2022.0,2,1,1
VE,PY,2006.0,1,1,0
MM,JP,2008.0,1,2,-1
GB,CU,2007.0,4,3,1
PR,US,1999.0,7,1,6
UA,NL,2002.0,1,5,-4
AU,HK,2019.0,3,3,0
PT,CR,2020.0,2,3,-1
IQ,QA,2010.0,2,1,1
GR,BG,1999.0,4,1,3
CA,UA,2022.0,3,3,0
LU,NL,2015.0,4,11,-7
CN,RS,2002.0,5,1,4
GH,ZM,2010.0,4,6,-2
PS,IL,2008.0,1,3,-2
CY,AU,2014.0,1,1,0
FI,HU,1999.0,5,4,1
MD,BE,2010.0,1,1,0
MT,US,2007.0,1,3,-2
IR,nan,2005.0,3,2,1
IN,SI,2020.0,4,3,1
CA,VE,2000.0,2,1,1
GB,BN,2014.0,7,3,4
GR,UA,2012.0,1,2,-1
TT,ZA,2020.0,1,1,0
US,CM,2005.0,5,6,-1
IT,MD,2018.0,2,1,1
KH,KE,2021.0,2,1,1
SK,nan,2007.0,4,3,1
SA,nan,2018.0,2,5,-3
PL,NL,2023.0,4,2,2
ID,SD,2018.0,1,3,-2
NO,BG,2015.0,6,8,-2
NL,MA,2015.0,1,5,-4
LB,AU,2006.0,1,1,0
LK,GB,2000.0,2,5,-3
FI,IL,2012.0,2,3,-1
AT,ID,2014.0,2,2,0
MY,ET,2010.0,1,1,0
TH,OM,2014.0,2,1,1
DE,BD,1999.0,1,5,-4
US,KH,2017.0,8,10,-2
EG,NG,2015.0,3,5,-2
SA,ZA,2010.0,2,9,-7
IT,PA,2015.0,1,3,-2
SE,QA,2003.0,4,2,2
PH,NZ,2016.0,1,2,-1
UA,NL,2005.0,6,1,5
BE,MY,2010.0,3,3,0
BH,IE,2021.0,1,1,0
GB,TT,2012.0,4,1,3
RS,BE,2012.0,2,2,0
NL,NZ,2000.0,6,4,2
IN,BG,2013.0,1,1,0
MX,AU,1999.0,4,3,1
BY,DK,2000.0,1,1,0
IT,MA,2001.0,3,4,-1
SA,UA,2012.0,1,1,0
UA,BR,2007.0,1,1,0
AU,HK,2017.0,2,3,-1
AE,OM,2020.0,5,7,-2
KR,NP,2019.0,6,20,-14
SN,CG,2017.0,1,2,-1
CH,AR,2002.0,2,5,-3
US,AZ,2020.0,1,7,-6
RS,HU,2009.0,1,2,-1
MW,ZA,2003.0,1,1,0
AM,RU,2000.0,4,5,-1
UG,ES,2018.0,1,2,-1
ET,IN,2008.0,2,6,-4
IE,AE,2021.0,4,1,3
LU,PL,2017.0,2,5,-3
nan,LU,2013.0,1,1,0
CZ,BY,2023.0,2,1,1
BE,SG,2016.0,4,7,-3
DK,AR,2020.0,2,4,-2
GB,FJ,2011.0,2,1,1
ES,AO,2008.0,1,2,-1
AE,DE,2007.0,1,7,-6
CA,LV,2007.0,1,1,0
CZ,nan,2000.0,2,2,0
AZ,CN,2018.0,1,8,-7
JM,AU,2013.0,1,2,-1
ES,TN,2008.0,3,1,2
SA,YE,2012.0,2,1,1
AD,ES,2016.0,2,3,-1
FR,MG,2005.0,2,5,-3
TR,AE,2016.0,5,7,-2
GB,NA,2022.0,2,3,-1
PL,UZ,2003.0,3,1,2
ZA,AT,2001.0,1,2,-1
CI,GB,2015.0,2,2,0
RO,AT,2003.0,4,2,2
SA,AR,2017.0,1,3,-2
SI,RO,2017.0,1,2,-1
PH,MA,2021.0,1,1,0
nan,CR,2014.0,1,4,-3
NG,SD,2012.0,2,1,1
JP,SI,2001.0,1,1,0
CN,AR,2011.0,4,5,-1
DE,LK,2005.0,1,1,0
EC,SV,2020.0,2,1,1
IN,US,2019.0,3363,3040,323
DE,CA,2022.0,155,136,19
IN,US,2010.0,1776,1838,-62
CA,CN,2014.0,555,453,102
KR,MY,2022.0,9,14,-5
TR,BE,2017.0,25,18,7
DE,IN,2000.0,81,57,24
US,LB,2012.0,73,40,33
BR,UY,2005.0,16,37,-21
TR,BE,2019.0,26,13,13
IL,BR,2012.0,8,5,3
JO,GB,2006.0,9,14,-5
CH,FR,1998.0,124,172,-48
SE,CH,2017.0,62,67,-5
IT,JP,2010.0,78,62,16
CN,HK,2007.0,53,11,42
US,GR,2002.0,139,97,42
BH,US,2009.0,7,8,-1
GB,NZ,1997.0,72,58,14
BE,IL,2008.0,4,5,-1
TH,IN,2007.0,6,3,3
KR,MX,2014.0,5,4,1
AT,US,2020.0,240,238,2
PT,CO,2021.0,13,18,-5
IN,KR,2023.0,17,12,5
LT,US,2020.0,8,6,2
SI,BA,2016.0,8,2,6
SA,OM,2022.0,6,6,0
RU,TJ,2018.0,31,35,-4
KE,TZ,2019.0,12,13,-1
PK,NP,2018.0,5,6,-1
IR,SG,2014.0,31,26,5
CI,NG,2019.0,3,3,0
TH,AU,1997.0,1,4,-3
LB,BE,2017.0,8,10,-2
BD,KR,2013.0,21,28,-7
TR,GB,2016.0,101,131,-30
TR,CA,2010.0,21,20,1
PT,JP,2002.0,3,1,2
SD,KE,2001.0,2,2,0
SE,AU,2022.0,34,33,1
CH,RO,2003.0,1,2,-1
NL,FI,2004.0,22,23,-1
EG,OM,2004.0,3,2,1
AT,BR,2000.0,2,2,0
CR,ES,2018.0,52,62,-10
SE,ET,2014.0,6,4,2
UA,CZ,2017.0,22,29,-7
MY,UA,2019.0,13,2,11
FR,RU,2009.0,49,71,-22
SA,TN,2023.0,3,5,-2
BD,ES,2006.0,5,6,-1
FR,BR,2005.0,98,103,-5
IL,KR,2015.0,9,8,1
ZA,BW,2016.0,15,14,1
HU,TR,2009.0,4,4,0
PK,MA,2021.0,19,17,2
RU,CN,1998.0,9,4,5
LV,US,2015.0,9,8,1
MY,ET,2019.0,5,1,4
BE,MY,2017.0,9,8,1
IS,SE,2017.0,17,19,-2
US,NG,2011.0,46,33,13
JP,UA,2002.0,12,5,7
US,ID,1997.0,6,7,-1
BD,AT,2022.0,1,1,0
TW,IN,2009.0,29,58,-29
AT,CZ,2010.0,16,12,4
IL,EG,2011.0,4,2,2
NL,UA,2011.0,5,3,2
HU,FR,2013.0,20,25,-5
MA,CA,2020.0,19,22,-3
NZ,NP,2005.0,9,1,8
MA,PK,2012.0,13,23,-10
PL,BR,2019.0,17,28,-11
SI,US,2002.0,13,17,-4
CH,AU,2009.0,62,59,3
AE,GB,2022.0,28,33,-5
MY,UA,2017.0,4,6,-2
BE,NO,2005.0,6,2,4
SE,CH,2010.0,42,49,-7
AR,DE,2001.0,19,9,10
UA,CN,2002.0,13,6,7
PE,PT,2013.0,4,7,-3
US,SK,2005.0,16,43,-27
FR,UA,2005.0,11,14,-3
GB,SK,2006.0,15,22,-7
KW,EG,2001.0,8,5,3
AT,MX,2020.0,4,11,-7
RU,DK,1999.0,7,4,3
BE,GR,2011.0,17,25,-8
PK,AU,2014.0,32,32,0
BI,US,2018.0,2,3,-1
CZ,UZ,2016.0,3,10,-7
IS,GB,2012.0,5,8,-3
RU,PL,2004.0,19,9,10
CZ,IT,2014.0,15,41,-26
IR,GR,2021.0,2,1,1
CN,CL,2016.0,5,3,2
UG,US,1999.0,3,8,-5
PL,BR,2010.0,3,7,-4
CO,PA,2008.0,4,2,2
FI,IR,2008.0,2,3,-1
RU,ID,2016.0,9,6,3
CN,BO,2009.0,1,4,-3
KE,IN,2020.0,9,11,-2
CH,PK,2002.0,4,12,-8
VE,AR,2001.0,9,4,5
SA,JP,2001.0,3,3,0
JP,ZA,2021.0,3,1,2
EE,US,2004.0,2,9,-7
LI,CH,2010.0,4,3,1
US,XK,2022.0,1,2,-1
BR,CZ,2006.0,4,6,-2
YE,ID,2021.0,3,1,2
AE,SE,2015.0,3,5,-2
IT,EC,2018.0,10,5,5
PT,NO,2013.0,5,3,2
CN,KY,2020.0,3,1,2
AT,PL,2020.0,22,29,-7
SA,DE,2000.0,3,3,0
US,MM,2000.0,3,1,2
KR,FR,1999.0,6,8,-2
CU,IT,2020.0,5,1,4
NP,KR,2005.0,2,2,0
FI,AT,2006.0,5,4,1
RO,RU,2015.0,3,1,2
NZ,TW,2002.0,3,2,1
ZW,NL,2011.0,2,2,0
FR,ML,2006.0,5,3,2
CY,DE,2010.0,3,4,-1
PL,PT,2007.0,3,6,-3
LK,TH,2006.0,1,2,-1
SE,ZW,1998.0,1,1,0
VN,TH,2011.0,2,2,0
BY,SE,2014.0,2,1,1
BR,MT,2018.0,3,1,2
LB,MY,2021.0,2,4,-2
BD,EG,2008.0,1,1,0
BY,GB,2000.0,1,1,0
NZ,UG,1997.0,1,2,-1
GR,NO,1998.0,2,3,-1
KW,US,2001.0,15,11,4
NG,KR,2006.0,1,3,-2
UY,PE,2020.0,5,6,-1
NP,NG,2016.0,1,1,0
JO,FR,2013.0,5,4,1
CH,PH,2013.0,6,4,2
AO,CN,2013.0,1,1,0
CA,GH,1999.0,1,2,-1
US,CI,2007.0,1,1,0
BR,TH,2012.0,1,3,-2
CO,CH,2008.0,4,4,0
US,SL,2008.0,2,1,1
PT,BE,1999.0,3,3,0
EG,SD,2009.0,2,7,-5
IT,CO,2003.0,1,2,-1
SD,DE,2003.0,1,1,0
PL,EE,2017.0,2,1,1
UA,GR,2012.0,2,1,1
SD,GB,2009.0,4,3,1
HR,BR,2014.0,1,1,0
LU,BR,2009.0,1,1,0
NO,MY,2006.0,1,1,0
LU,DE,2020.0,37,51,-14
nan,CN,2005.0,134,105,29
PL,UA,2019.0,72,51,21
LK,AU,2022.0,33,19,14
TR,BE,2010.0,11,9,2
IE,RU,2010.0,6,6,0
UG,ZA,2009.0,4,9,-5
AU,ZM,2017.0,2,2,0
CA,PA,2014.0,10,5,5
ZA,SG,2011.0,2,1,1
IL,nan,2022.0,7,22,-15
PE,GB,2015.0,11,9,2
NE,CM,2008.0,1,2,-1
DE,AM,2004.0,2,1,1
BG,NO,2003.0,4,6,-2
BY,MZ,2019.0,1,2,-1
US,GR,2005.0,143,135,8
SE,EE,2020.0,14,9,5
KE,TZ,2010.0,2,6,-4
BE,GA,2019.0,2,2,0
,BR,1998.0,8243,0,8243
,IN,2009.0,19886,0,19886
,RU,2007.0,6541,0,6541
IN,,2017.0,12244,0,12244
JP,,2013.0,11354,0,11354
AU,,1999.0,1027,0,1027
,TR,2012.0,7905,0,7905
CO,,2015.0,844,0,844
IN,,2019.0,18400,0,18400
,DE,2013.0,20435,0,20435
MD,,2012.0,45,0,45
BD,FI,2015.0,2,0,2
,BR,1997.0,8089,0,8089
,HR,2007.0,1169,0,1169
CH,,2020.0,4977,0,4977
,NL,2006.0,5822,0,5822
CO,RO,2011.0,1,0,1
DE,,2004.0,6354,0,6354
,BE,2004.0,2783,0,2783
,FI,2009.0,1959,0,1959
UA,,2020.0,3016,0,3016
DK,,1998.0,232,0,232
IN,,2010.0,3266,0,3266
CA,,2000.0,2247,0,2247
,UA,2010.0,2261,0,2261
,LB,2007.0,238,0,238
BA,,2019.0,218,0,218
AR,,2014.0,1085,0,1085
SI,,2023.0,2513,0,2513
TH,KH,2006.0,2,0,2
,PH,2000.0,306,0,306
PT,,2007.0,187,0,187
,BE,1996.0,3049,0,3049
RS,,2020.0,928,0,928
GR,,2023.0,9631,0,9631
,PE,2009.0,677,0,677
BD,PT,2017.0,3,0,3
IR,,2011.0,932,0,932
,MY,2016.0,3765,0,3765
XK,,2010.0,7,0,7
,UA,2019.0,1695,0,1695
CZ,,2015.0,1183,0,1183
,IQ,2011.0,552,0,552
IR,CZ,2022.0,7,0,7
KW,,2007.0,51,0,51
FJ,,2024.0,167,0,167
,UA,2017.0,6126,0,6126
BH,,2022.0,159,0,159
IL,SE,2003.0,3,0,3
,RS,2014.0,936,0,936
,NP,2014.0,467,0,467
,BW,2011.0,105,0,105
CR,,2016.0,158,0,158
,PR,2017.0,17,0,17
,VN,2014.0,499,0,499
,EC,2002.0,63,0,63
RO,,2008.0,143,0,143
KE,,2019.0,440,0,440
NP,,2020.0,449,0,449
,BA,1995.0,14,0,14
VE,,2001.0,78,0,78
VN,,2011.0,56,0,56
,EC,2005.0,119,0,119
PK,,2011.0,170,0,170
TH,,2006.0,192,0,192
,KE,2012.0,688,0,688
KE,,2017.0,272,0,272
IS,,2023.0,670,0,670
AE,,2012.0,68,0,68
MA,JO,2021.0,1,0,1
SK,,2006.0,166,0,166
XK,,2019.0,81,0,81
KE,,2010.0,71,0,71
BA,,2017.0,141,0,141
PH,,2005.0,84,0,84
CM,,1998.0,7,0,7
,CD,2018.0,154,0,154
BI,,2018.0,10,0,10
,TZ,2003.0,87,0,87
GP,BJ,2018.0,1,0,1
,LK,1997.0,118,0,118
AL,,2022.0,178,0,178
XK,,2017.0,36,0,36
,TG,2013.0,87,0,87
PR,CH,2008.0,1,0,1
,SV,1996.0,10,0,10
LA,,2013.0,6,0,6
MK,,2011.0,18,0,18
SA,NP,2013.0,1,0,1
UG,,2018.0,175,0,175
,HT,2015.0,12,0,12
MG,US,2009.0,4,0,4
QA,LY,2013.0,1,0,1
,MW,2011.0,94,0,94
LT,UA,2018.0,5,0,5
IN,SC,2017.0,1,0,1
,ZM,1994.0,34,0,34
GT,,2004.0,4,0,4
CY,,2013.0,45,0,45
BT,,2024.0,66,0,66
BW,,2025.0,15,0,15
LA,GB,2020.0,2,0,2
,LU,2013.0,143,0,143
PA,ID,2016.0,8,0,8
,BJ,2005.0,60,0,60
,GM,2008.0,11,0,11
BG,JO,1998.0,1,0,1
AT,PS,2018.0,2,0,2
SA,AE,2003.0,7,0,7
,LK,1998.0,96,0,96
MD,CN,2018.0,4,0,4
EG,BH,2023.0,1,0,1
PH,,2002.0,74,0,74
,MG,2013.0,79,0,79
JO,,2012.0,101,0,101
BN,,2018.0,22,0,22
GH,PH,2020.0,13,0,13
MW,SN,2016.0,1,0,1
BW,nan,2015.0,2,0,2
CG,MX,2007.0,2,0,2
,CZ,2020.0,87,0,87
KH,,2009.0,7,0,7
TR,NO,2008.0,3,0,3
CL,PF,2015.0,1,0,1
,LS,2017.0,12,0,12
MC,CH,2019.0,2,0,2
CM,BR,2015.0,4,0,4
TW,ES,1997.0,1,0,1
,SV,2004.0,19,0,19
LU,,2001.0,8,0,8
SK,LT,2011.0,1,0,1
NA,DE,2017.0,3,0,3
JP,AZ,2016.0,2,0,2
,MQ,2009.0,15,0,15
CA,SJ,2019.0,1,0,1
PG,,2005.0,5,0,5
,AO,1995.0,15,0,15
PL,SA,2013.0,3,0,3
AU,HR,2006.0,3,0,3
CM,NL,2000.0,1,0,1
LY,PK,2006.0,1,0,1
VE,AU,2014.0,3,0,3
PS,AU,2014.0,1,0,1
ES,JO,2006.0,3,0,3
KZ,BD,2014.0,1,0,1
VN,IE,2016.0,1,0,1
SY,IN,2014.0,2,0,2
JO,MA,2017.0,1,0,1
ME,,2020.0,30,0,30
GT,MX,2003.0,3,0,3
SG,TR,2009.0,3,0,3
BS,CA,2013.0,1,0,1
ET,BE,2010.0,3,0,3
,VU,2006.0,1,0,1
NO,NG,2010.0,3,0,3
BA,,2010.0,35,0,35
,ME,1995.0,13,0,13
,LS,2010.0,9,0,9
IL,CL,2013.0,5,0,5
US,KN,2010.0,8,0,8
MX,ID,2021.0,4,0,4
,KN,2013.0,8,0,8
IE,QA,2021.0,3,0,3
CO,ID,2011.0,3,0,3
SK,BG,2011.0,2,0,2
CH,JO,2020.0,1,0,1
nan,LT,2018.0,1,0,1
CH,PS,2008.0,1,0,1
AO,PE,2017.0,3,0,3
,ST,2003.0,21,0,21
CR,ID,2018.0,1,0,1
CY,TR,2000.0,1,0,1
GR,CZ,1999.0,4,0,4
BE,SN,2011.0,5,0,5
CA,CD,2021.0,2,0,2
BZ,,2006.0,1,0,1
IR,KR,2005.0,2,0,2
NG,CM,2001.0,2,0,2
IR,RU,2023.0,1,0,1
LK,UZ,2019.0,2,0,2
BD,KW,1997.0,1,0,1
VE,PA,2014.0,4,0,4
,PW,2005.0,1,0,1
,BJ,2002.0,60,0,60
,NC,2000.0,8,0,8
KN,NG,2017.0,1,0,1
IL,JO,2005.0,3,0,3
BW,SE,2009.0,1,0,1
CR,DK,2015.0,2,0,2
IR,PE,2012.0,1,0,1
,MR,1997.0,3,0,3
BN,KR,2022.0,1,0,1
IE,RO,2013.0,4,0,4
SE,ZW,1997.0,1,0,1
AM,GE,2001.0,1,0,1
SN,GF,2011.0,1,0,1
,PR,2010.0,18,0,18
MY,KW,2002.0,2,0,2
LK,NZ,2006.0,2,0,2
SM,BR,2016.0,1,0,1
GL,NO,2014.0,1,0,1
US,MC,2003.0,1,0,1
LU,RS,2021.0,1,0,1
UG,GB,1997.0,2,0,2
PK,AE,2001.0,2,0,2
MX,SA,2015.0,1,0,1
GN,,2020.0,12,0,12
EE,nan,2003.0,1,0,1
PA,RO,2012.0,1,0,1
SD,CH,2019.0,1,0,1
KH,BR,2012.0,1,0,1
BB,,2018.0,9,0,9
IE,JM,2016.0,1,0,1
JO,BH,2008.0,1,0,1
AO,ZA,2018.0,1,0,1
NG,RO,2021.0,1,0,1
LS,ES,2000.0,1,0,1
NO,BR,1997.0,2,0,2
HR,TW,2001.0,2,0,2
JO,IL,2009.0,1,0,1
NP,KH,2019.0,2,0,2
,NO,2020.0,97,0,97
SN,CG,2019.0,3,0,3
UG,CY,2014.0,2,0,2
IQ,TN,2010.0,1,0,1
MO,ES,2021.0,1,0,1
,CW,2012.0,8,0,8
CZ,ZA,2004.0,1,0,1
TH,GH,2020.0,3,0,3
,LS,2019.0,5,0,5
XK,IT,2019.0,1,0,1
GB,MN,2003.0,1,0,1
JM,CA,2009.0,7,0,7
MT,,2014.0,11,0,11
AU,UZ,2020.0,1,0,1
CN,RS,2005.0,7,0,7
DE,IS,2008.0,5,0,5
LU,VN,2023.0,1,0,1
HK,,2007.0,5,0,5
EG,BD,2009.0,3,0,3
TH,HU,2013.0,1,0,1
KZ,FI,2022.0,2,0,2
JE,,2022.0,6,0,6
CY,RO,2007.0,1,0,1
,MZ,2000.0,23,0,23
SE,ML,2013.0,2,0,2
PK,ID,2006.0,1,0,1
,PR,2019.0,6,0,6
BW,KE,2013.0,4,0,4
US,GI,2010.0,1,0,1
VU,NZ,2009.0,1,0,1
PH,BR,2003.0,1,0,1
JO,nan,2009.0,1,0,1
DK,BD,2015.0,3,0,3
TZ,PR,2015.0,1,0,1
SE,MA,2012.0,1,0,1
LY,LB,2016.0,1,0,1
UG,CG,2017.0,1,0,1
RO,SG,2012.0,1,0,1
NG,CH,2003.0,2,0,2
CO,SG,2012.0,1,0,1
IE,CY,2015.0,2,0,2
KY,,2006.0,1,0,1
LT,KR,2001.0,1,0,1
IE,nan,2006.0,1,0,1
CV,US,2012.0,1,0,1
BE,BZ,2007.0,1,0,1
BE,IR,2004.0,2,0,2
GB,RW,2015.0,4,0,4
BH,KR,1998.0,1,0,1
MU,IT,2006.0,1,0,1
AM,CO,2010.0,1,0,1
PT,EG,2023.0,1,0,1
VE,NO,2019.0,1,0,1
FR,AM,2003.0,2,0,2
FR,TZ,2021.0,2,0,2
SN,TN,1998.0,1,0,1
PA,VE,2012.0,1,0,1
KZ,,2026.0,2,0,2
CN,MA,2022.0,3,0,3
PE,HN,2001.0,1,0,1
PG,,2002.0,9,0,9
LK,DK,2009.0,1,0,1
NI,SE,2008.0,2,0,2
GB,NE,2019.0,2,0,2
MD,BE,2017.0,1,0,1
BI,MA,2020.0,2,0,2
CM,CA,2008.0,3,0,3
CI,NG,2017.0,3,0,3
KG,,2015.0,12,0,12
NZ,IL,1999.0,1,0,1
MZ,TZ,2013.0,1,0,1
UZ,BG,2020.0,2,0,2
CN,BW,2008.0,1,0,1
QA,CH,2019.0,3,0,3
DO,ES,1999.0,1,0,1
CA,AL,2012.0,1,0,1
ES,BA,2022.0,1,0,1
,PW,2002.0,4,0,4
RW,,1998.0,6,0,6
JP,FJ,2016.0,2,0,2
NG,BW,1999.0,1,0,1
MU,NL,2008.0,1,0,1
GR,PA,2010.0,1,0,1
NO,MZ,2014.0,1,0,1
MG,ID,2014.0,1,0,1
MY,NE,2019.0,2,0,2
FI,IQ,2015.0,1,0,1
PK,TJ,2009.0,2,0,2
FJ,DK,2019.0,1,0,1
JO,PS,2008.0,2,0,2
ES,EE,2011.0,2,0,2
SE,GT,2018.0,1,0,1
RO,UA,1998.0,6,0,6
nan,HN,2018.0,1,0,1
TR,SY,2022.0,3,0,3
IR,nan,2002.0,1,0,1
CL,PT,1997.0,1,0,1
NO,DZ,2011.0,1,0,1
IQ,JO,1998.0,1,0,1
NO,AR,2000.0,1,0,1
NO,NG,2017.0,2,0,2
NG,KW,2018.0,1,0,1
CF,MG,2017.0,1,0,1
SK,TZ,2020.0,1,0,1
BG,NL,2022.0,3,0,3
MY,OM,2000.0,1,0,1
PL,IQ,2020.0,2,0,2
,SO,2015.0,5,0,5
HU,AE,2021.0,1,0,1
DZ,BF,2016.0,1,0,1
KE,TH,2016.0,1,0,1
CN,SL,2016.0,2,0,2
MD,NO,2017.0,1,0,1
NZ,OM,1999.0,3,0,3
JM,BW,2010.0,1,0,1
BB,US,2003.0,3,0,3
AM,IR,2018.0,3,0,3
SG,BR,2014.0,4,0,4
MV,NP,2014.0,1,0,1
CU,BD,2007.0,1,0,1
nan,ST,2010.0,1,0,1
TN,CL,2020.0,1,0,1
BN,GB,2022.0,2,0,2
GB,GA,2019.0,2,0,2
MD,DZ,2012.0,7,0,7
ZW,NG,2003.0,1,0,1
JP,PR,1997.0,1,0,1
SD,LB,2007.0,1,0,1
DK,VN,2006.0,1,0,1
IT,SY,2012.0,1,0,1
KW,QA,2009.0,3,0,3
SK,CN,2017.0,5,0,5
DE,LK,2002.0,3,0,3
BD,LT,2021.0,1,0,1
NE,SA,2022.0,1,0,1
UG,PK,2010.0,3,0,3
NG,BN,2018.0,1,0,1
ER,,2006.0,1,0,1
EE,MD,2019.0,1,0,1
ZA,TN,2014.0,1,0,1
IE,BS,2020.0,2,0,2
JO,IS,2022.0,1,0,1
KN,PK,2020.0,1,0,1
CU,DO,2020.0,4,0,4
IQ,BH,2015.0,2,0,2
QA,TR,2012.0,4,0,4
PL,HK,2016.0,2,0,2
DZ,BI,2021.0,1,0,1
NO,AG,2018.0,2,0,2
TR,MM,2016.0,2,0,2
MY,KZ,2015.0,2,0,2
AE,HU,2022.0,2,0,2
GB,KG,2018.0,2,0,2
CA,CG,2018.0,3,0,3
KZ,JP,2008.0,1,0,1
BG,HR,2003.0,1,0,1
CZ,CU,2005.0,2,0,2
DE,MG,2007.0,1,0,1
BO,CA,2021.0,2,0,2
AR,CR,2004.0,2,0,2
NO,SD,2015.0,1,0,1
GE,ZA,2013.0,1,0,1
YE,EG,2005.0,3,0,3
MX,IL,2000.0,3,0,3
MA,IR,2004.0,1,0,1
SA,NO,1997.0,1,0,1
TR,JO,2017.0,1,0,1
NG,IE,2008.0,1,0,1
FM,,2010.0,2,0,2
UA,ES,1999.0,1,0,1
SA,JM,2019.0,1,0,1
GR,BD,2020.0,1,0,1
SE,LA,2014.0,1,0,1
NG,CD,2018.0,2,0,2
BY,FI,2006.0,1,0,1
PK,PH,2000.0,1,0,1
NA,nan,2010.0,2,0,2
PG,ZA,2007.0,1,0,1
FR,PH,2000.0,2,0,2
CM,BI,2017.0,2,0,2
ZA,RU,2004.0,1,0,1
ZA,JM,2006.0,2,0,2
ZM,BR,1997.0,1,0,1
BH,TH,2018.0,1,0,1
EC,nan,2015.0,2,0,2
ML,ET,2018.0,1,0,1
ZA,TH,2006.0,2,0,2
MY,MA,2004.0,2,0,2
TW,IL,2016.0,1,0,1
DK,LU,2011.0,1,0,1
CR,PY,2017.0,2,0,2
CN,MT,2022.0,2,0,2
SE,UY,2013.0,2,0,2
CA,GL,2010.0,1,0,1
KH,RU,2016.0,3,0,3
IN,BW,2018.0,2,0,2
MY,MV,2016.0,1,0,1
MC,GB,2007.0,2,0,2
AT,UZ,2021.0,1,0,1
UY,BE,2002.0,1,0,1
ZW,BE,2012.0,1,0,1
AR,BO,2006.0,3,0,3
OM,AT,2018.0,1,0,1
ET,TZ,2023.0,1,0,1
ET,VN,2022.0,2,0,2
PA,DE,2023.0,1,0,1
GB,AL,2007.0,1,0,1
SD,NE,2015.0,1,0,1
HR,LI,2012.0,1,0,1
NZ,IR,2002.0,2,0,2
KR,SD,2005.0,1,0,1
KR,FO,2013.0,1,0,1
MQ,,2007.0,6,0,6
LK,PK,2006.0,1,0,1
UG,BF,2000.0,1,0,1
BE,MD,1997.0,1,0,1
SN,PT,2020.0,1,0,1
AO,,2009.0,3,0,3
NO,NA,2019.0,2,0,2
KZ,UA,2007.0,1,0,1
YE,SE,2016.0,1,0,1
MT,nan,2021.0,1,0,1
SE,XK,2021.0,2,0,2
TW,AM,2002.0,2,0,2
,MR,1998.0,2,0,2
KR,BG,2012.0,1,0,1
PK,BR,2003.0,2,0,2
JO,NG,2018.0,4,0,4
SE,PG,2007.0,1,0,1
PF,AU,2011.0,1,0,1
NP,MM,2017.0,1,0,1
MQ,IT,2013.0,1,0,1
ZW,DE,2013.0,2,0,2
GA,IT,2018.0,1,0,1
YE,CZ,2003.0,1,0,1
GW,NL,2003.0,1,0,1
UA,IL,2000.0,3,0,3
FR,QA,2000.0,1,0,1
RU,CU,2010.0,1,0,1
KW,MX,1999.0,1,0,1
SD,MY,2004.0,1,0,1
MX,BD,2008.0,2,0,2
BJ,BR,2011.0,1,0,1
TN,IQ,2015.0,2,0,2
MY,TN,2008.0,2,0,2
OM,IR,2003.0,1,0,1
NO,BR,1998.0,2,0,2
IR,UZ,2020.0,2,0,2
BD,PT,2010.0,1,0,1
AO,CL,2018.0,2,0,2
BF,IT,2016.0,1,0,1
CN,AE,1998.0,1,0,1
NO,BW,2021.0,1,0,1
KE,CR,2009.0,1,0,1
LY,BG,2013.0,1,0,1
MM,PL,2018.0,1,0,1
MA,ET,2003.0,1,0,1
ET,MA,2008.0,1,0,1
AU,ME,2021.0,1,0,1
NZ,NE,2020.0,1,0,1
NL,LY,2012.0,1,0,1
SN,BF,2004.0,2,0,2
FR,ZM,2008.0,1,0,1
CA,SX,2019.0,1,0,1
nan,BD,2012.0,3,0,3
QA,SN,2020.0,1,0,1
IE,PA,2014.0,1,0,1
NG,MX,2001.0,1,0,1
CH,BF,2021.0,1,0,1
SY,PK,2020.0,1,0,1
UA,RO,1999.0,2,0,2
BY,SI,2007.0,1,0,1
VE,CH,2014.0,1,0,1
US,JE,1999.0,1,0,1
LK,PH,2005.0,1,0,1
SI,RO,2019.0,1,0,1
ME,IL,2005.0,1,0,1
CV,CO,2013.0,1,0,1
SK,IE,2002.0,1,0,1
BE,NO,2002.0,3,0,3
CZ,PK,2012.0,1,0,1
SE,BH,2011.0,1,0,1
VE,NO,2010.0,1,0,1
BF,GN,2014.0,1,0,1
YE,IQ,2007.0,1,0,1
BH,nan,2011.0,1,0,1
FI,EC,2013.0,2,0,2
SS,PK,2018.0,1,0,1
TW,JO,2009.0,1,0,1
NL,BH,2022.0,2,0,2
TN,IL,2009.0,1,0,1
LT,DK,2002.0,2,0,2
IL,NG,2005.0,1,0,1
BD,SI,2021.0,1,0,1
BW,TZ,2020.0,1,0,1
TT,SA,2013.0,2,0,2
EG,MR,2018.0,1,0,1
EG,DK,2001.0,1,0,1
CL,RO,2004.0,1,0,1
RU,CL,2000.0,3,0,3
BH,ZM,2020.0,1,0,1
JP,BN,2019.0,1,0,1
GM,FR,2011.0,1,0,1
nan,OM,2012.0,3,0,3
MU,BW,2019.0,1,0,1
NC,CL,2021.0,1,0,1
SI,ME,2019.0,1,0,1
SD,NG,2007.0,1,0,1
GR,MY,2005.0,1,0,1
IE,TW,2003.0,4,0,4
SN,MX,2019.0,1,0,1
AU,SK,1998.0,2,0,2
PE,NL,2010.0,2,2,0
NO,NP,2011.0,1,2,-1
NO,BE,2006.0,3,4,-1
PL,NG,2015.0,3,3,0
CH,CU,2014.0,1,2,-1
GF,FR,2000.0,2,8,-6
AE,LY,2021.0,1,1,0
MM,GB,2016.0,1,4,-3
MX,MA,2020.0,1,3,-2
HU,DK,2009.0,4,1,3
DZ,DE,2016.0,3,7,-4
AE,NP,2016.0,1,1,0
KR,IR,2007.0,2,2,0
AR,ZA,2020.0,2,3,-1
MY,PL,2017.0,1,1,0
HU,IE,2014.0,2,3,-1
PA,CL,2009.0,2,3,-1
DK,TR,2005.0,3,2,1
RW,SE,2020.0,2,5,-3
CU,nan,2006.0,2,1,1
NL,SI,2008.0,2,2,0
CN,CU,2018.0,2,5,-3
TH,CH,2007.0,1,2,-1
CU,VE,2000.0,4,4,0
CH,KE,1997.0,1,3,-2
AR,NI,2021.0,1,3,-2
GE,FR,2013.0,1,3,-2
ET,SY,2021.0,2,1,1
KE,FR,2013.0,2,9,-7
FR,BO,2016.0,2,2,0
CD,CA,2013.0,1,3,-2
RW,ZA,2014.0,3,1,2
SD,FR,2020.0,2,1,1
GB,SC,2016.0,2,1,1
PA,AU,2014.0,1,2,-1
IL,AR,2012.0,3,4,-1
FR,MT,2018.0,1,1,0
MT,AT,2019.0,1,2,-1
AT,SE,1997.0,2,7,-5
IT,MC,2009.0,3,1,2
AE,PK,2010.0,4,6,-2
PT,PH,2007.0,1,1,0
SK,TR,2012.0,3,2,1
IQ,TN,2017.0,2,5,-3
KR,RU,2001.0,1,8,-7
CU,NL,2018.0,1,2,-1
nan,SK,1999.0,1,1,0
SA,MA,2001.0,1,1,0
CO,FR,1997.0,1,3,-2
LB,BE,2010.0,1,2,-1
EC,BO,2015.0,2,3,-1
ZW,GB,2001.0,3,4,-1
NZ,UG,1998.0,1,1,0
BE,RS,2008.0,2,1,1
NG,SA,2000.0,2,3,-1
AO,FR,2019.0,1,1,0
IE,BG,2009.0,1,1,0
GB,GA,2017.0,1,1,0
SK,KE,2014.0,1,1,0
ES,BJ,2014.0,1,1,0
NL,LK,2006.0,1,1,0
UG,FR,2008.0,1,3,-2
IE,CL,2007.0,1,1,0
MD,US,2004.0,2,2,0
IT,UZ,2012.0,1,1,0
GB,LK,2000.0,5,2,3
AE,RU,2015.0,1,2,-1
NP,PH,2015.0,2,2,0
LU,IS,2014.0,1,4,-3
ZW,CH,2013.0,1,1,0
FR,PA,2009.0,1,3,-2
CO,FR,1998.0,1,4,-3
HU,nan,2009.0,1,3,-2
YE,CN,2018.0,1,2,-1
ET,SA,2021.0,1,1,0
VE,FR,2002.0,2,5,-3
IT,NG,1997.0,1,1,0
NL,NP,2003.0,1,1,0
SV,ES,2009.0,1,4,-3
GB,ZM,1998.0,1,2,-1
CL,ZA,2020.0,1,3,-2
US,MD,2007.0,1,7,-6
CU,UY,2022.0,1,1,0
LI,DE,2015.0,1,5,-4
DK,PA,2017.0,2,1,1
GB,FO,2020.0,1,1,0
BE,MY,2019.0,1,11,-10
TR,IR,2004.0,1,1,0
JP,KZ,2009.0,2,1,1
AE,GR,2012.0,1,4,-3
AT,CO,2022.0,1,1,0
MX,HR,2020.0,1,1,0
LT,RO,2012.0,1,7,-6
ZA,LU,2017.0,1,1,0
IQ,NO,2019.0,1,2,-1
DZ,CH,2018.0,1,3,-2
LV,IN,2018.0,1,3,-2
SA,SY,2016.0,1,2,-1
US,BH,1997.0,1,2,-1
TN,ES,2004.0,1,2,-1
nan,JO,2014.0,1,1,0
DE,GE,1998.0,2,4,-2
MC,US,2006.0,1,1,0
GR,RO,2001.0,1,3,-2
MY,UA,2010.0,1,2,-1
ZA,LU,2019.0,1,3,-2
FI,KR,2002.0,1,6,-5
CH,MD,2005.0,1,1,0
HR,XK,2022.0,2,2,0
TW,LB,2013.0,2,1,1
AR,SV,2016.0,2,1,1
NL,MT,2020.0,2,1,1
CG,GB,2008.0,1,1,0
SI,SE,2021.0,1,3,-2
KN,CN,2021.0,1,1,0
AU,SI,2023.0,1,1,0
BE,EE,2016.0,3,3,0
RU,nan,1999.0,1,8,-7
CM,SA,2019.0,1,1,0
ET,CA,2011.0,1,3,-2
NG,nan,2007.0,1,3,-2
MZ,BR,2006.0,2,1,1
SD,BA,2015.0,1,1,0
EE,JP,2020.0,1,1,0
SE,MY,2009.0,1,2,-1
BD,SG,2003.0,1,1,0
ME,XK,2013.0,1,2,-1
CO,GR,2013.0,1,1,0
CA,PS,2021.0,1,1,0
IE,NG,2007.0,1,1,0
GR,CO,2012.0,1,1,0
TG,MA,2015.0,1,1,0
TZ,DK,2019.0,1,1,0
CO,BE,2001.0,2,3,-1
CH,DZ,2020.0,2,2,0
BJ,ZA,2020.0,1,1,0
CA,JM,2000.0,1,1,0
FR,KH,2015.0,1,5,-4
AZ,SI,2011.0,1,2,-1
NZ,TW,2005.0,1,3,-2
AL,GR,2020.0,1,3,-2
GB,VE,2019.0,1,8,-7
QA,IQ,2011.0,2,1,1
SA,PH,2013.0,1,3,-2
CR,CH,2013.0,1,2,-1
IM,IN,2002.0,1,1,0
PL,PH,1999.0,1,17,-16
CR,CU,1999.0,1,2,-1
GE,RU,2008.0,1,2,-1
ET,NO,2005.0,1,1,0
SI,ME,2010.0,1,1,0
AE,RS,2021.0,1,2,-1
KG,TR,2014.0,1,4,-3
PL,EE,2019.0,2,1,1
EG,AT,2015.0,5,6,-1
BG,ES,2012.0,3,4,-1
CH,LT,2013.0,2,3,-1
JP,IL,2022.0,1,5,-4
LV,IE,2013.0,1,2,-1
MA,ZA,2013.0,1,2,-1
GA,US,2003.0,2,1,1
BD,CZ,2021.0,2,4,-2
BJ,NG,2006.0,1,2,-1
SG,CZ,2005.0,1,1,0
US,PS,2004.0,1,3,-2
CZ,IL,2002.0,1,2,-1
QA,JO,2005.0,1,2,-1
IE,KE,2015.0,1,1,0
AR,DK,2006.0,1,3,-2
TZ,BE,2018.0,1,4,-3
EG,BE,2007.0,1,4,-3
LK,ID,2011.0,1,1,0
AE,QA,2005.0,1,1,0
CA,DZ,2003.0,1,9,-8
FJ,DE,2006.0,1,1,0
CH,SN,2004.0,1,1,0
nan,XK,2019.0,1,1,0
EE,LT,2016.0,1,2,-1
GH,SN,2018.0,1,5,-4
GR,KW,2022.0,2,0,2
nan,DO,2019.0,1,0,1
KN,CA,2021.0,1,0,1
NL,RE,2012.0,1,0,1
VN,NA,2021.0,1,0,1
GR,AT,2022.0,2,0,2
BG,TN,2011.0,1,0,1
HR,JP,2018.0,1,0,1
LB,FI,2022.0,1,0,1
ES,DO,1998.0,1,0,1
PG,MA,2014.0,1,0,1
IS,CN,2008.0,2,0,2
CN,VE,2002.0,2,0,2
YE,MA,2022.0,1,0,1
LI,AT,2008.0,1,0,1
HU,GR,1999.0,2,0,2
ML,ZA,2011.0,1,0,1
FI,LV,2010.0,1,0,1
nan,CG,2008.0,1,0,1
MX,TH,2020.0,2,0,2
FR,AO,2012.0,1,0,1
GT,EC,2014.0,4,0,4
CR,CZ,2013.0,1,0,1
TH,BD,2023.0,2,0,2
NL,BF,2003.0,1,0,1
OM,PL,2007.0,1,0,1
IN,JM,2002.0,1,0,1
UY,NL,2017.0,1,0,1
LK,HR,2007.0,1,0,1
TZ,CI,2001.0,1,0,1
MZ,BY,2014.0,1,0,1
TJ,RU,2001.0,3,0,3
KE,SG,2018.0,1,0,1
MX,NP,2018.0,1,0,1
KR,LB,2015.0,1,0,1
PA,IR,2016.0,1,0,1
HU,SD,2014.0,1,0,1
KW,BD,2014.0,1,0,1
,PS,2020.0,8,0,8
NP,MM,2010.0,1,0,1
TW,CR,2019.0,1,0,1
KE,CZ,2012.0,1,0,1
KW,SE,2022.0,2,0,2
MD,ES,2012.0,1,0,1
NG,UZ,2021.0,1,0,1
CU,ET,2018.0,1,0,1
FI,LV,2017.0,2,0,2
PA,NL,1998.0,1,0,1
NC,CH,2003.0,1,0,1
NO,PL,2023.0,1,0,1
SA,SG,2000.0,2,0,2
MK,PH,2017.0,1,0,1
BY,SK,2001.0,1,0,1
SE,CI,2020.0,2,0,2
GF,CG,2019.0,1,0,1
HU,HK,2013.0,1,0,1
SA,LK,2000.0,1,0,1
PH,ID,2013.0,2,0,2
JO,ES,1999.0,1,0,1
LV,JP,2011.0,1,0,1
LV,GB,1999.0,1,0,1
TG,ZA,2014.0,1,0,1
MY,CI,2014.0,1,0,1
HR,TZ,2020.0,1,0,1
PG,BW,1999.0,1,0,1
UZ,TJ,2009.0,1,0,1
TM,,2004.0,1,0,1
QA,ZA,2004.0,1,0,1
SE,CU,2008.0,1,0,1
CN,VG,2011.0,1,0,1
PH,BN,2021.0,1,0,1
JO,MA,2019.0,2,0,2
KG,CA,2022.0,1,0,1
BJ,CH,2016.0,1,0,1
UG,DK,2018.0,1,0,1
PL,LY,2015.0,1,0,1
MZ,US,2001.0,1,0,1
ZW,CA,2014.0,1,0,1
BA,FR,2000.0,1,0,1
KZ,UZ,2004.0,1,0,1
VE,nan,2012.0,1,0,1
AF,AE,2021.0,1,0,1
BA,ID,2020.0,1,0,1
BY,ZA,2000.0,1,0,1
HK,LK,2013.0,1,0,1
IS,QA,2020.0,1,0,1
VN,RW,2018.0,1,0,1
TN,CG,2013.0,1,0,1
MG,RE,2010.0,1,0,1
CL,CY,2019.0,1,0,1
AU,PH,2023.0,1,0,1
MA,nan,2013.0,1,0,1
HR,BE,2003.0,1,0,1
PT,LK,2004.0,1,0,1
MY,GH,2010.0,1,0,1
JO,YE,2014.0,1,0,1
SD,ET,2020.0,1,0,1
UZ,BY,2020.0,1,0,1
BG,BY,2022.0,1,0,1
TW,VN,1999.0,1,0,1
QA,AE,2023.0,1,0,1
KR,IE,2001.0,1,0,1
SY,HU,2016.0,2,0,2
IR,GH,2011.0,1,0,1
RO,CI,2020.0,1,0,1
MX,GE,2020.0,2,0,2
CD,NE,2016.0,1,0,1
IN,CY,2006.0,2,0,2
MW,MY,2012.0,1,0,1
ZA,GE,2022.0,1,0,1
BI,CD,2017.0,1,0,1
CO,EG,2014.0,2,0,2
NO,LU,2016.0,1,0,1
CL,LT,2016.0,1,0,1
LB,IQ,2013.0,1,0,1
SI,GT,2020.0,1,0,1
nan,AR,2023.0,1,0,1
AL,CZ,2014.0,1,0,1
ZW,BW,2022.0,1,0,1
RO,BJ,2015.0,1,0,1
SG,CZ,2002.0,1,0,1
IN,VE,2017.0,1,0,1
RS,NZ,2006.0,1,0,1
NL,BI,2017.0,1,0,1
DO,PF,2010.0,1,0,1
SN,DE,2000.0,1,0,1
NG,TN,2021.0,1,0,1
XK,GB,2019.0,2,0,2
MC,CH,2017.0,1,0,1
JE,US,2009.0,2,0,2
BR,JO,2020.0,1,0,1
VE,CN,2001.0,2,0,2
CN,VE,2005.0,1,0,1
IN,JM,2005.0,1,0,1
WS,FJ,2003.0,1,0,1
GE,PH,2004.0,1,0,1
MX,TR,1997.0,1,0,1
CA,BT,2009.0,1,0,1
PS,CN,2020.0,1,0,1
NO,HR,1999.0,1,0,1
ML,RU,2018.0,1,0,1
NZ,ET,2005.0,1,0,1
IT,HK,2021.0,1,0,1
GP,MX,2010.0,1,0,1
JP,BN,2017.0,1,0,1
AR,LB,2021.0,1,0,1
GB,HK,2000.0,1,0,1
RE,BJ,2008.0,1,0,1
KR,LU,2001.0,1,0,1
PR,CZ,2002.0,1,0,1
US,GI,2019.0,1,0,1
ID,PL,2010.0,1,0,1
MX,NI,2022.0,1,0,1
nan,XK,2017.0,1,0,1
MG,JP,2002.0,1,0,1
QA,JO,2002.0,1,0,1
KG,DE,1999.0,1,0,1
MW,NL,2003.0,1,0,1
AU,SK,1997.0,1,0,1
PL,MA,2008.0,1,0,1
DE,AG,2016.0,1,0,1
CA,PE,2008.0,2,0,2
CW,SK,2015.0,1,0,1
RE,NC,1998.0,1,0,1
,BT,2000.0,1,0,1
CZ,DK,2006.0,1,0,1
NO,YE,2008.0,1,0,1
TR,TN,2005.0,1,0,1
GR,MT,2011.0,1,0,1
nan,IQ,2013.0,1,0,1
NI,FR,2019.0,1,0,1
SG,SN,2020.0,1,0,1
HN,nan,2014.0,1,0,1
MY,GM,2015.0,1,0,1
IL,CR,2006.0,1,0,1
ZM,TR,2015.0,1,0,1
ID,TN,2011.0,1,0,1
DK,TZ,2020.0,1,0,1
LU,NO,2011.0,1,0,1
AE,AR,2015.0,1,0,1
CL,FI,2003.0,1,0,1
SD,UG,2015.0,1,0,1
AZ,BR,2016.0,1,0,1
MQ,US,2003.0,1,0,1
NP,SG,2002.0,1,0,1
RS,FR,2023.0,1,0,1
LV,DZ,2017.0,1,0,1
YE,OM,2004.0,1,0,1
ZA,LU,2010.0,1,0,1
JP,LY,2018.0,1,0,1
UY,EC,2018.0,2,0,2
nan,RS,2006.0,1,0,1
RU,LK,2003.0,1,0,1
IL,MA,2002.0,1,0,1
CZ,VN,2001.0,1,0,1
SA,MY,2006.0,4,0,4
UG,HU,2011.0,1,0,1
,JE,2002.0,1,0,1
IL,CY,2021.0,2,0,2
SI,SK,2006.0,1,0,1
SI,DK,2004.0,1,0,1
MD,BR,2008.0,1,0,1
DE,XK,2005.0,1,0,1
TD,IT,2020.0,1,0,1
TR,VN,2021.0,1,0,1
NE,GN,2021.0,1,0,1
LK,SY,2015.0,1,0,1
JM,NG,2018.0,1,0,1
LU,GH,2018.0,1,0,1
GA,TZ,2018.0,1,0,1
SG,PS,2020.0,1,0,1
IN,PA,2000.0,1,0,1
BR,RO,1997.0,1,0,1
UG,RW,2012.0,1,0,1
JO,KR,1997.0,1,0,1
CH,LS,2013.0,1,0,1
IS,KR,2021.0,1,0,1
MA,NO,2018.0,1,0,1
SK,IL,2018.0,1,0,1
EC,RS,2017.0,1,0,1
AE,MT,2018.0,1,0,1
NZ,EG,2003.0,1,0,1
NA,CG,2006.0,1,0,1
IQ,JO,1997.0,1,0,1
TR,PH,2012.0,1,0,1
EG,SN,2005.0,1,0,1
IL,TZ,2013.0,2,0,2
MG,NE,2017.0,1,0,1
CO,RU,2001.0,1,0,1
BD,NL,2007.0,1,0,1
GT,ES,1999.0,1,0,1
,CU,2020.0,1,0,1
nan,SD,2019.0,1,0,1
CA,TT,2016.0,2,0,2
JP,RW,2022.0,1,0,1
RE,BR,2016.0,1,0,1
LT,IL,2017.0,1,0,1
CD,KE,2013.0,1,0,1
ZM,NL,2023.0,1,0,1
SK,MA,2021.0,1,0,1
MG,SN,2009.0,1,0,1
RO,BD,2011.0,1,0,1
LV,HU,2018.0,1,0,1
PK,EE,2019.0,1,0,1
MV,US,2021.0,1,0,1
GE,SE,2015.0,1,0,1
OM,CZ,2020.0,1,0,1
US,CA,2018.0,3548,3840,-292
US,ES,2008.0,731,706,25
NZ,GB,2006.0,171,205,-34
CN,US,2013.0,4715,6041,-1326
US,DE,2006.0,1986,2124,-138
AU,BR,2011.0,61,67,-6
US,BR,2016.0,1255,1301,-46
ES,CH,1998.0,19,15,4
IT,FR,2011.0,415,260,155
AR,CL,2013.0,91,74,17
BR,US,2018.0,1529,1515,14
AU,GB,2016.0,1441,1407,34
KR,AE,2022.0,9,3,6
GB,SA,2013.0,110,43,67
BR,MD,2004.0,3,1,2
JP,CA,2019.0,118,98,20
ES,BE,2014.0,91,73,18
NO,IN,2010.0,15,20,-5
IN,NO,2012.0,29,14,15
GB,IT,2018.0,510,740,-230
BE,NL,2010.0,242,263,-21
CN,FR,2001.0,114,155,-41
PK,SA,2020.0,97,110,-13
GB,SG,2010.0,119,71,48
SG,CN,2015.0,492,469,23
IS,IT,2020.0,1,6,-5
GB,AU,2004.0,952,835,117
US,TW,2018.0,652,764,-112
CA,JP,2016.0,109,122,-13
CN,IN,2021.0,208,238,-30
GB,CA,1999.0,352,404,-52
US,AT,2008.0,201,162,39
DE,GB,2015.0,903,899,4
BE,FR,2001.0,167,199,-32
CH,GB,2016.0,311,348,-37
FR,US,2004.0,1038,918,120
JO,US,2019.0,63,85,-22
BD,IN,2019.0,182,173,9
US,CU,2009.0,21,31,-10
US,AR,2013.0,244,235,9
PK,CN,2019.0,325,246,79
DE,FR,2004.0,372,332,40
ES,GT,2020.0,9,11,-2
nan,JP,2020.0,32,47,-15
EG,SA,2013.0,297,215,82
US,IN,2007.0,1249,1343,-94
FR,GB,2017.0,648,586,62
PE,nan,2009.0,7,6,1
JP,HK,2022.0,9,2,7
CL,PE,2018.0,91,75,16
JP,NZ,2005.0,12,8,4
PT,IN,2021.0,8,10,-2
CZ,EG,2016.0,5,5,0
nan,GB,2019.0,98,133,-35
US,IT,2021.0,749,802,-53
PH,GB,2022.0,8,12,-4
CH,US,2002.0,441,488,-47
US,JP,1997.0,1127,1063,64
BE,NL,2017.0,310,328,-18
IN,JP,2001.0,137,83,54
DK,FR,2006.0,28,38,-10
DK,FI,2007.0,12,13,-1
FR,GB,2010.0,507,558,-51
ZA,TW,2022.0,3,3,0
AT,ZA,2008.0,5,2,3
ZA,CH,2018.0,24,31,-7
JP,NO,2016.0,13,14,-1
FI,JP,2019.0,24,27,-3
JP,DE,2015.0,228,207,21
NL,GR,2008.0,10,12,-2
SY,CN,2021.0,11,12,-1
JP,DK,2002.0,8,8,0
BR,DK,2019.0,34,20,14
BR,FR,2011.0,167,167,0
RU,UA,2010.0,137,123,14
PG,AU,2014.0,12,6,6
US,DK,2018.0,322,334,-12
IE,US,1998.0,140,149,-9
CR,CN,2004.0,5,1,4
SG,US,2021.0,409,411,-2
CA,BR,2009.0,227,225,2
GB,SG,2019.0,166,149,17
SG,GB,2020.0,172,151,21
nan,ID,2018.0,92,65,27
IN,SE,2012.0,44,25,19
GR,JP,2003.0,44,29,15
VE,CL,2011.0,19,25,-6
KR,VN,2016.0,81,46,35
BE,NL,2019.0,338,319,19
GB,MX,2014.0,68,72,-4
GB,KR,2020.0,105,118,-13
CA,PT,2009.0,16,5,11
PK,US,2009.0,116,132,-16
AR,IT,1999.0,32,31,1
GB,MY,2013.0,207,78,129
DE,NO,2021.0,98,75,23
NZ,KR,2016.0,9,12,-3
BJ,FR,2006.0,16,22,-6
PK,GB,2022.0,110,98,12
JP,MY,2009.0,54,17,37
US,NP,2008.0,14,19,-5
SE,GB,2006.0,135,119,16
GB,PK,2001.0,35,20,15
FR,AT,2012.0,53,48,5
GB,CH,2012.0,316,230,86
JP,CA,2010.0,114,117,-3
FI,DK,2002.0,6,11,-5
KR,PK,2021.0,59,39,20
FR,EG,2015.0,36,21,15
NL,BR,2011.0,34,40,-6
GB,SG,2017.0,166,131,35
nan,BR,2020.0,130,156,-26
US,FI,2010.0,215,112,103
NO,CN,2020.0,50,33,17
LT,LV,2014.0,4,4,0
US,PT,2002.0,67,53,14
HN,MX,2018.0,21,22,-1
PH,JP,2010.0,15,25,-10
FR,GB,2019.0,643,569,74
AT,RS,2020.0,8,8,0
KR,BD,2019.0,42,29,13
NG,US,2012.0,58,61,-3
NZ,CH,2011.0,16,13,3
NO,CA,2002.0,14,8,6
BR,JP,2019.0,73,58,15
GR,FR,2009.0,46,29,17
CN,PK,2022.0,215,245,-30
CH,IN,2001.0,10,9,1
nan,GB,2017.0,84,108,-24
SE,BE,2006.0,25,12,13
IT,SE,1999.0,86,28,58
MX,PA,2017.0,18,5,13
DE,PL,2011.0,126,113,13
CO,IL,2007.0,1,2,-1
LK,CA,1998.0,1,1,0
DE,BE,2014.0,116,132,-16
EE,ES,2020.0,3,3,0
FR,ES,2022.0,174,184,-10
ES,EC,2004.0,10,11,-1
BR,GB,2011.0,144,171,-27
GB,PT,2016.0,98,133,-35
BD,CN,2015.0,118,71,47
TR,CN,2014.0,107,66,41
DE,IT,2001.0,136,136,0
IE,CN,2005.0,15,18,-3
DE,UY,2016.0,6,5,1
MM,CN,2007.0,9,3,6
DE,NL,2018.0,454,436,18
KH,US,2015.0,10,7,3
US,PK,2008.0,126,93,33
IE,CN,2002.0,10,3,7
KE,NL,1998.0,2,2,0
AR,US,2014.0,235,274,-39
FR,ID,2012.0,18,17,1
nan,TW,2013.0,3,7,-4
RU,UA,2019.0,594,755,-161
AZ,UZ,2017.0,1,1,0
BR,nan,2010.0,48,84,-36
RO,FR,2012.0,38,57,-19
EG,US,2006.0,75,109,-34
DE,RO,2015.0,26,48,-22
AU,CO,2013.0,10,11,-1
HR,DE,2017.0,26,17,9
MA,CN,2020.0,7,7,0
GH,DE,2009.0,3,5,-2
GB,OM,2020.0,25,11,14
PS,ES,2013.0,13,6,7
BE,IT,2015.0,105,171,-66
GB,RU,2001.0,33,80,-47
GB,NO,2008.0,63,45,18
PK,KR,2018.0,53,63,-10
FR,HU,2006.0,19,13,6
HR,DE,2019.0,31,20,11
FR,JP,2000.0,72,68,4
US,IR,2004.0,55,38,17
JP,BR,2011.0,53,52,1
NL,CY,2019.0,4,6,-2
JP,GH,2019.0,9,8,1
NL,ES,2010.0,65,66,-1
JO,US,2010.0,30,47,-17
CN,DK,1999.0,10,6,4
nan,GB,2010.0,65,58,7
BD,US,2020.0,189,175,14
DK,IR,2019.0,13,39,-26
CL,CH,2013.0,13,14,-1
GR,GB,1997.0,28,49,-21
JP,NL,2016.0,30,19,11
AT,IN,2001.0,18,11,7
FI,PL,2004.0,6,2,4
FR,CG,2014.0,16,23,-7
EG,JP,2013.0,45,80,-35
FR,SN,2013.0,42,34,8
SG,IN,2022.0,82,71,11
PE,VE,2021.0,6,3,3
RU,UA,2017.0,419,543,-124
SG,AT,2018.0,4,6,-2
CO,GB,2009.0,10,18,-8
KR,PR,2007.0,24,31,-7
GR,CH,1999.0,2,11,-9
QA,EG,2008.0,9,9,0
SA,ES,2017.0,8,13,-5
TH,CN,2016.0,24,28,-4
IN,GR,2020.0,6,3,3
PH,FR,2012.0,6,5,1
BR,nan,2019.0,161,154,7
TW,NP,2013.0,2,1,1
DZ,IT,2022.0,10,35,-25
RU,UZ,2020.0,65,28,37
ZA,CN,2021.0,22,19,3
CH,BE,1999.0,18,17,1
AZ,UZ,2019.0,5,3,2
HU,DE,2013.0,65,50,15
CL,IT,2005.0,5,12,-7
MX,IT,2018.0,53,41,12
CA,MX,2021.0,32,41,-9
UA,nan,2003.0,14,18,-4
IR,GB,2010.0,64,104,-40
LK,US,2006.0,17,13,4
US,FI,2017.0,124,164,-40
nan,RU,1997.0,4,5,-1
AU,MY,2015.0,127,110,17
BD,SA,2020.0,33,31,2
nan,IL,2014.0,18,25,-7
BR,JP,2017.0,66,59,7
IN,ID,2016.0,66,28,38
ES,BR,1999.0,86,81,5
BR,SK,2008.0,1,1,0
NL,ES,2019.0,107,107,0
CA,BG,2008.0,3,3,0
GB,TW,2012.0,67,67,0
JP,IT,2013.0,77,67,10
UG,KE,2016.0,8,9,-1
BE,AU,2016.0,53,44,9
IR,DE,2005.0,12,18,-6
US,MK,2014.0,9,12,-3
CZ,US,2012.0,123,169,-46
PK,CN,2017.0,202,141,61
IR,GB,2019.0,133,110,23
MA,IR,2015.0,5,5,0
GH,KE,2019.0,2,6,-4
PK,OM,2006.0,2,1,1
CN,SA,2021.0,57,50,7
CH,CZ,2008.0,26,11,15
AE,AT,2019.0,2,1,1
AE,IQ,2020.0,22,16,6
CM,FR,2012.0,19,15,4
MA,DZ,2018.0,32,38,-6
DE,SL,2019.0,1,1,0
NL,HR,2009.0,5,5,0
IN,NG,2022.0,19,17,2
EC,ES,2022.0,98,79,19
SE,BR,2015.0,17,23,-6
IR,GB,2017.0,88,111,-23
MA,FR,1998.0,69,95,-26
EG,IQ,2020.0,97,74,23
CL,BR,2021.0,83,101,-18
CH,ID,2013.0,7,3,4
CN,IL,2017.0,21,16,5
KR,BD,2017.0,27,28,-1
GB,BA,2017.0,5,6,-1
MX,GT,2014.0,9,13,-4
NA,ZA,2013.0,3,10,-7
PL,DE,2008.0,129,102,27
PL,KR,2021.0,4,4,0
CN,UA,2016.0,23,21,2
CA,AT,2011.0,27,21,6
CH,JP,2004.0,43,46,-3
ES,CO,2022.0,212,227,-15
IR,DE,2002.0,5,5,0
PT,ES,2020.0,180,194,-14
JO,US,2017.0,40,89,-49
IE,US,1997.0,89,129,-40
DE,BG,2009.0,27,21,6
CM,US,2018.0,11,21,-10
RS,CH,2020.0,10,10,0
VN,JP,2016.0,39,73,-34
PT,GB,2021.0,80,92,-12
GH,CH,2022.0,2,1,1
NO,FR,2021.0,49,60,-11
CO,CH,2007.0,7,3,4
DE,NA,2020.0,2,2,0
HR,CZ,2018.0,9,16,-7
BF,US,2020.0,3,2,1
PL,PK,2014.0,16,7,9
BR,KE,2013.0,1,1,0
IT,MY,2000.0,26,14,12
GB,ID,2021.0,71,72,-1
NL,ZA,2020.0,38,65,-27
MQ,FR,2020.0,18,21,-3
CH,GR,2014.0,21,45,-24
IQ,IR,2017.0,8,22,-14
UA,GB,2003.0,20,5,15
AR,NL,1998.0,5,1,4
SI,CZ,2002.0,12,1,11
TH,TW,2021.0,12,13,-1
SG,FR,2022.0,21,15,6
GH,nan,2018.0,2,5,-3
ES,UY,1999.0,6,11,-5
IQ,IR,2019.0,15,31,-16
US,PH,2023.0,8,8,0
RU,PL,2015.0,26,32,-6
RU,CR,2021.0,3,2,1
IE,IT,2011.0,16,29,-13
SA,SD,2013.0,9,26,-17
BR,ST,2008.0,30,25,5
BO,EC,2020.0,5,5,0
PK,ZW,2021.0,3,7,-4
BR,GR,2014.0,4,5,-1
JP,KR,2021.0,296,290,6
US,NZ,2023.0,14,10,4
US,FI,2019.0,160,174,-14
CA,TR,2014.0,33,18,15
CL,DE,2013.0,42,43,-1
US,PT,2005.0,90,96,-6
JO,IQ,2015.0,4,7,-3
IL,SI,1997.0,1,1,0
AU,RU,2021.0,25,26,-1
ZM,KE,2006.0,3,2,1
PL,AU,2006.0,12,4,8
DK,nan,2008.0,13,13,0
DK,AU,1997.0,7,14,-7
ZA,LS,2018.0,6,2,4
BR,AE,2021.0,8,2,6
NG,GB,2022.0,78,41,37
TH,GB,2014.0,33,78,-45
BR,DK,2017.0,27,25,2
AU,JP,1998.0,41,30,11
ID,AZ,2009.0,3,2,1
AU,SG,2013.0,83,107,-24
FI,AU,2001.0,6,7,-1
ZA,IE,2005.0,7,1,6
IE,BE,2020.0,8,12,-4
CA,PH,2007.0,7,6,1
NG,ZA,2013.0,42,36,6
EG,GB,1999.0,15,6,9
PK,CG,2020.0,4,4,0
CN,PL,2005.0,14,10,4
NL,IN,2006.0,25,20,5
ET,ZA,2022.0,7,9,-2
IT,RO,2019.0,25,17,8
SE,CA,2012.0,46,55,-9
nan,CZ,2010.0,10,4,6
nan,MY,2018.0,58,89,-31
NL,RU,2022.0,16,37,-21
DE,MA,2017.0,12,7,5
PK,AR,2016.0,13,8,5
DK,IT,2000.0,11,7,4
FI,BR,2014.0,11,7,4
GE,RU,2007.0,7,3,4
NL,ES,2017.0,95,127,-32
HU,SE,1997.0,3,6,-3
CZ,JP,2008.0,10,18,-8
MA,FR,1997.0,54,62,-8
SE,UG,2011.0,5,5,0
GR,AU,2001.0,5,2,3
JP,GR,2003.0,29,44,-15
IR,CN,2016.0,49,37,12
BD,IN,2017.0,139,127,12
TR,GR,2015.0,4,1,3
HU,SE,1998.0,17,6,11
VN,BE,2012.0,7,8,-1
IQ,US,2022.0,36,29,7
UA,DE,2015.0,35,25,10
CN,TH,2013.0,14,19,-5
CL,FR,1998.0,7,7,0
UA,US,2008.0,43,35,8
LB,CA,2022.0,21,6,15
NZ,SE,2018.0,15,10,5
NL,FI,2015.0,37,38,-1
NI,EC,2019.0,4,2,2
PH,IL,2016.0,3,4,-1
KR,PH,2014.0,8,10,-2
CH,NO,2014.0,17,13,4
FJ,GB,2016.0,4,1,3
CH,ZA,2018.0,31,24,7
SS,GB,2012.0,6,7,-1
US,VG,2009.0,12,10,2
PH,JP,2019.0,29,26,3
IT,CZ,2006.0,15,12,3
VE,LT,2010.0,1,1,0
RS,BA,2015.0,39,35,4
IS,CH,2010.0,1,2,-1
IS,CH,2019.0,1,4,-3
UG,SE,2019.0,3,3,0
ES,GR,2014.0,10,16,-6
HU,PL,2017.0,26,36,-10
PK,DE,2008.0,7,10,-3
IN,AT,2014.0,17,11,6
ES,BO,2016.0,20,21,-1
NO,IN,2019.0,26,36,-10
BE,IR,2015.0,18,18,0
RU,PT,2010.0,6,4,2
BD,IN,2010.0,42,40,2
EG,OM,2015.0,9,9,0
TR,IR,2015.0,24,41,-17
RU,JP,2006.0,25,37,-12
EG,CZ,2011.0,4,3,1
GR,GB,1998.0,38,64,-26
EC,CN,2021.0,3,2,1
GB,BY,2007.0,2,4,-2
IN,KW,2018.0,11,17,-6
SE,FR,2001.0,41,40,1
FR,OM,2006.0,1,1,0
CA,KR,2021.0,51,49,2
SG,MY,2001.0,14,8,6
ES,DK,2004.0,30,20,10
nan,ZA,2006.0,8,4,4
MY,YE,2018.0,22,10,12
IN,CO,2007.0,2,1,1
CA,OM,2015.0,10,3,7
NO,GL,2021.0,1,1,0
IT,RO,2017.0,23,19,4
SK,FR,2016.0,9,11,-2
RU,SE,2014.0,28,35,-7
CA,TH,2011.0,9,14,-5
CO,US,1997.0,21,36,-15
BE,CA,2021.0,50,42,8
IN,HU,2007.0,6,3,3
BR,JP,2010.0,49,56,-7
EG,DZ,2014.0,3,6,-3
IR,NZ,2021.0,14,9,5
DE,UZ,2015.0,5,2,3
CO,US,1998.0,33,41,-8
NP,US,2005.0,14,6,8
CY,nan,2021.0,1,1,0
CY,GB,2018.0,35,52,-17
MX,DK,2014.0,6,5,1
DE,RS,2011.0,20,21,-1
BR,IR,2020.0,7,8,-1
CM,DE,2007.0,4,3,1
AM,DE,2019.0,4,2,2
KR,CH,2015.0,18,7,11
RU,MD,2020.0,6,9,-3
ET,GB,2020.0,24,12,12
RU,AT,2022.0,13,12,1
SA,NG,2020.0,13,15,-2
GR,SA,2021.0,3,3,0
TW,EG,2020.0,36,17,19
GH,CN,2019.0,27,30,-3
LT,BE,2022.0,1,2,-1
EG,GH,2020.0,7,8,-1
IQ,TR,2022.0,12,6,6
LR,US,2020.0,9,7,2
MN,KR,2018.0,5,9,-4
ET,EG,2019.0,7,9,-2
ZM,GB,1998.0,2,1,1
FI,RU,2000.0,14,16,-2
NG,BR,2018.0,7,15,-8
CY,IN,2019.0,7,1,6
JO,EG,2007.0,2,3,-1
MM,AU,2021.0,3,4,-1
GB,TZ,2020.0,14,18,-4
EC,GB,2008.0,5,3,2
VN,AT,2021.0,5,4,1
EG,KW,2011.0,9,17,-8
SK,RU,2014.0,14,18,-4
JP,MX,2007.0,7,14,-7
ES,PY,2019.0,35,17,18
CZ,DE,2001.0,28,18,10
JP,ES,2016.0,33,67,-34
IT,BY,2009.0,1,1,0
IN,TR,2017.0,16,18,-2
DK,BR,2011.0,15,11,4
HR,IL,2014.0,1,1,0
ES,TR,2016.0,13,10,3
TN,IT,2018.0,25,20,5
KR,TH,2013.0,16,6,10
DE,HU,2009.0,46,57,-11
MD,FR,2015.0,53,39,14
PH,JP,2017.0,24,30,-6
NO,BG,2004.0,7,6,1
JP,CZ,2005.0,8,14,-6
MG,IT,2014.0,2,3,-1
SK,PL,2016.0,11,13,-2
CN,LT,2008.0,4,11,-7
IL,CA,2006.0,56,22,34
DE,NZ,2012.0,34,39,-5
MK,DE,2005.0,2,1,1
PL,PT,2008.0,2,2,0
LV,CH,2015.0,4,3,1
GB,BA,2010.0,2,1,1
SG,CA,2015.0,42,51,-9
BR,LU,2022.0,2,3,-1
US,CY,2001.0,6,5,1
NL,AT,2008.0,21,14,7
HU,PL,2010.0,13,8,5
BY,US,2012.0,7,9,-2
UA,AU,2019.0,5,5,0
RU,AU,2000.0,5,9,-4
EG,SY,2018.0,5,14,-9
NO,SE,2003.0,37,60,-23
MX,PA,2010.0,8,3,5
GB,IL,2000.0,22,20,2
PL,TR,2002.0,1,1,0
CZ,CA,2007.0,13,13,0
BR,NI,2018.0,2,3,-1
VN,AU,2012.0,16,20,-4
HR,DE,2010.0,19,17,2
UA,AT,2012.0,4,2,2
CO,AT,2019.0,4,7,-3
TR,TW,2007.0,9,7,2
FR,LB,2004.0,21,17,4
SK,FI,2021.0,2,1,1
US,AM,2017.0,15,13,2
RS,RU,2009.0,5,15,-10
GB,HR,2016.0,23,18,5
HU,HR,2018.0,4,4,0
BY,UA,2012.0,4,3,1
BE,CH,2007.0,46,39,7
HU,IT,2012.0,7,10,-3
DK,SK,2009.0,4,3,1
HU,AU,2016.0,13,7,6
ES,IE,2011.0,18,21,-3
ES,IR,2021.0,9,22,-13
FR,SI,1997.0,2,1,1
BF,ZA,2017.0,2,1,1
IT,RS,2009.0,6,6,0
RS,IT,2014.0,10,7,3
SK,BE,2018.0,2,2,0
AO,US,2012.0,2,1,1
GR,SG,2013.0,4,1,3
GE,AZ,2008.0,11,1,10
JM,BB,2018.0,2,7,-5
nan,PT,2014.0,29,13,16
MZ,RU,2018.0,15,12,3
SE,IT,2012.0,59,83,-24
AU,QA,2013.0,6,8,-2
MK,GR,2014.0,6,14,-8
RU,IE,2008.0,8,2,6
FR,DZ,2003.0,36,20,16
DZ,MA,2007.0,12,2,10
CA,GR,2018.0,9,14,-5
DK,JP,2010.0,10,15,-5
GR,MK,2014.0,14,6,8
MX,PT,2016.0,15,29,-14
US,PS,2015.0,7,13,-6
GB,IQ,2008.0,3,2,1
IT,RO,2010.0,22,10,12
CZ,BR,2015.0,7,3,4
IE,CA,2023.0,7,2,5
DE,CZ,1999.0,21,23,-2
GT,CL,2021.0,4,5,-1
IN,BH,2020.0,7,2,5
US,SA,2007.0,73,39,34
DK,HU,2018.0,3,9,-6
PE,MX,2004.0,16,21,-5
SV,US,2018.0,9,2,7
US,MA,1999.0,6,5,1
PT,LU,2018.0,4,1,3
ES,CH,1997.0,17,19,-2
NL,TR,2013.0,29,28,1
GB,LB,2011.0,6,4,2
FR,RS,2021.0,5,8,-3
RS,TR,2001.0,19,19,0
FI,JP,2010.0,11,15,-4
GH,US,2002.0,6,7,-1
NG,MY,2014.0,35,37,-2
MY,KR,2012.0,14,22,-8
IN,TR,2019.0,20,22,-2
CH,SK,2010.0,3,8,-5
NZ,nan,2020.0,5,5,0
MX,DE,2006.0,26,32,-6
RU,PK,2019.0,13,9,4
DE,SK,2022.0,11,25,-14
CA,RO,2014.0,14,15,-1
CZ,AT,2005.0,7,12,-5
EG,nan,2006.0,3,2,1
HR,RS,2004.0,23,37,-14
TH,SG,2013.0,6,9,-3
JP,NP,1998.0,1,1,0
UZ,RU,1999.0,12,9,3
AM,IT,2009.0,29,13,16
GB,FI,2000.0,25,22,3
ZW,BH,2019.0,6,8,-2
CZ,BG,1998.0,2,2,0
HU,IN,2011.0,7,8,-1
PT,IE,2021.0,4,8,-4
GB,PH,2009.0,8,15,-7
FI,IN,2002.0,2,7,-5
FI,IN,2005.0,3,4,-1
US,EE,2011.0,8,7,1
IL,FR,1999.0,23,25,-2
ZA,RU,2015.0,7,6,1
SE,CO,2014.0,5,8,-3
BE,AE,2018.0,4,3,1
DE,CO,1999.0,2,1,1
FR,GE,2013.0,3,1,2
JP,GH,2010.0,4,1,3
UG,IT,2018.0,5,1,4
DK,IR,2010.0,7,13,-6
RU,PK,2017.0,6,8,-2
IN,TR,2010.0,22,19,3
AU,NO,2009.0,15,12,3
RS,HR,2001.0,17,26,-9
GR,IR,2020.0,3,4,-1
RO,IN,2011.0,14,41,-27
SG,AU,2003.0,31,48,-17
GH,MY,2020.0,2,8,-6
DK,IE,2020.0,13,10,3
BF,FR,2009.0,14,6,8
ZM,JP,2014.0,1,4,-3
VE,MX,2021.0,16,20,-4
SN,BF,2015.0,4,1,3
CO,PY,2017.0,9,7,2
NL,DK,2004.0,22,23,-1
nan,KR,2022.0,10,19,-9
BI,DE,2019.0,1,2,-1
CN,OM,2019.0,4,5,-1
ES,PY,2017.0,19,19,0
PK,IT,2013.0,4,10,-6
UZ,UA,2020.0,3,3,0
KR,GR,2007.0,1,1,0
SA,ES,2019.0,10,4,6
KR,ES,2013.0,5,2,3
CL,NO,2018.0,6,1,5
CO,PY,2019.0,15,11,4
CN,SK,2020.0,3,5,-2
DK,IN,2014.0,19,19,0
ES,IT,2007.0,108,169,-61
CD,NG,2016.0,1,1,0
TN,ES,2015.0,7,11,-4
RU,CH,2000.0,17,15,2
PL,GB,2007.0,64,38,26
EC,CL,2006.0,5,7,-2
NZ,BR,2018.0,14,15,-1
BE,IN,2016.0,53,55,-2
FI,FR,2016.0,31,29,2
AR,CH,2006.0,9,4,5
EE,IN,2019.0,6,2,4
ES,ID,2014.0,10,8,2
EG,NL,2007.0,4,2,2
SY,TN,2016.0,4,3,1
DK,AU,1998.0,11,11,0
GR,DE,1997.0,11,13,-2
SA,IN,2004.0,20,11,9
NL,HK,2009.0,16,11,5
KR,NO,2016.0,1,4,-3
UA,SE,2005.0,6,1,5
GB,JM,2009.0,9,6,3
IN,ML,2016.0,3,4,-1
TN,CA,2009.0,7,9,-2
SA,ES,2010.0,1,3,-2
CZ,EE,2013.0,1,3,-2
ID,PH,2009.0,2,1,1
JP,CZ,2002.0,9,7,2
CH,IE,2002.0,6,4,2
US,HK,2000.0,3,2,1
FR,PL,1997.0,21,22,-1
CL,FR,1997.0,6,5,1
CN,PL,2002.0,7,8,-1
BE,IL,2007.0,2,6,-4
CH,AE,2015.0,1,3,-2
CH,IL,2001.0,4,13,-9
FR,HR,2014.0,4,8,-4
LB,CH,2014.0,2,1,1
CN,IL,2010.0,19,22,-3
FI,JP,2017.0,20,14,6
CN,JO,2012.0,3,1,2
SI,DK,2015.0,1,4,-3
ES,PS,2008.0,4,7,-3
MD,US,2015.0,5,6,-1
PS,US,2011.0,2,8,-6
SG,SE,2005.0,11,2,9
BR,NZ,2006.0,2,1,1
FJ,FR,2019.0,2,1,1
GB,UG,2018.0,14,19,-5
RU,CA,2011.0,23,18,5
ZA,FI,2014.0,5,3,2
NL,SI,2007.0,3,1,2
CN,EG,2009.0,15,12,3
UG,FR,2007.0,2,4,-2
CA,RS,2011.0,7,11,-4
OM,BD,2019.0,2,4,-2
CZ,IE,2013.0,3,2,1
PS,AE,2021.0,2,1,1
MX,NL,2006.0,7,5,2
MX,PA,2019.0,18,6,12
PK,KW,2004.0,2,1,1
IT,UG,2011.0,2,4,-2
UG,SE,2010.0,2,3,-1
US,RS,2004.0,37,33,4
BR,AT,2005.0,4,6,-2
BE,CD,2011.0,8,5,3
IR,CH,2007.0,8,6,2
IT,AE,2009.0,3,1,2
AR,CR,2015.0,17,10,7
GB,JO,2002.0,8,2,6
TW,PL,2021.0,2,2,0
BW,AU,2012.0,2,1,1
DE,IL,2003.0,23,33,-10
PK,BE,2003.0,1,1,0
MX,BG,2004.0,2,1,1
FR,PL,1998.0,22,24,-2
SD,SA,2011.0,9,2,7
MY,DE,2011.0,10,15,-5
ES,AU,2023.0,2,1,1
BE,nan,2013.0,23,24,-1
FR,BI,2018.0,21,25,-4
TN,FR,1998.0,12,42,-30
SA,US,1998.0,21,27,-6
SA,US,1997.0,23,29,-6
IL,DK,2020.0,10,3,7
IR,ES,2014.0,13,5,8
GR,IT,2003.0,11,8,3
FR,KE,2008.0,6,3,3
DE,SD,2011.0,2,1,1
JP,VN,2009.0,34,14,20
MM,MY,2012.0,1,1,0
CA,JO,2012.0,17,7,10
HU,SK,2022.0,9,7,2
BG,CH,2012.0,1,2,-1
BR,DK,2010.0,15,4,11
SN,GM,2002.0,2,1,1
PT,NL,1999.0,5,3,2
NO,AU,2022.0,9,18,-9
CH,IS,2001.0,1,1,0
NP,US,2002.0,4,6,-2
BD,PH,2015.0,3,3,0
AR,PA,2005.0,2,1,1
LT,DE,2013.0,7,10,-3
BR,BO,2009.0,3,1,2
MX,JP,2004.0,4,8,-4
UG,JP,2017.0,1,2,-1
DE,MX,1999.0,15,5,10
DZ,PT,2021.0,5,2,3
CA,nan,1998.0,5,5,0
CI,SN,2020.0,3,4,-1
DK,JP,2019.0,8,13,-5
SY,DE,2015.0,2,1,1
BD,DE,2001.0,1,1,0
CH,LK,2016.0,6,7,-1
RS,CN,2013.0,4,8,-4
CN,IR,1999.0,3,2,1
SV,MX,2004.0,2,1,1
RU,SG,2018.0,16,6,10
CA,HU,1999.0,9,7,2
ES,CA,1997.0,9,12,-3
CN,HR,2001.0,2,1,1
CH,CL,2020.0,13,10,3
nan,NP,2018.0,5,1,4
CZ,AT,2002.0,6,7,-1
MX,DO,2019.0,7,7,0
UY,GB,2015.0,3,6,-3
RU,ZA,2015.0,6,7,-1
PY,DO,2020.0,1,1,0
HU,ID,2011.0,1,1,0
IR,IT,2006.0,2,4,-2
CO,CA,2022.0,10,13,-3
NP,BD,2007.0,3,2,1
AR,SE,2015.0,10,6,4
US,PG,2012.0,4,1,3
VN,GB,2023.0,3,3,0
AE,DZ,2018.0,1,2,-1
CN,BB,2020.0,2,1,1
TR,ZA,2011.0,4,4,0
TZ,CH,2020.0,9,8,1
ID,BG,2021.0,2,3,-1
LT,RU,2009.0,12,12,0
CO,CU,2022.0,7,11,-4
SE,CZ,2006.0,9,7,2
EE,FI,2009.0,6,7,-1
NL,CL,2003.0,2,1,1
SE,AR,2009.0,11,4,7
DZ,BE,2005.0,1,3,-2
GH,CN,2017.0,26,15,11
ET,NL,2004.0,2,1,1
SE,GR,2003.0,7,4,3
AU,RO,2017.0,5,3,2
MY,IL,2021.0,2,1,1
HR,ID,2021.0,2,1,1
ZA,CA,1998.0,11,5,6
KW,GB,2000.0,7,7,0
PH,CA,2013.0,10,13,-3
NO,MX,2020.0,4,9,-5
GL,DK,2021.0,4,9,-5
VE,EG,2009.0,1,1,0
AR,IL,2008.0,3,2,1
AR,PK,2014.0,5,18,-13
IL,IN,2012.0,27,18,9
SE,NL,1999.0,10,19,-9
IR,IN,2000.0,2,2,0
FR,UG,2014.0,5,5,0
RO,TW,2020.0,1,1,0
SG,PH,2006.0,2,8,-6
PE,BE,2020.0,3,3,0
GR,HU,2006.0,4,4,0
AE,IT,2016.0,3,16,-13
RU,IT,1999.0,21,15,6
US,BA,2008.0,4,2,2
CA,AE,2003.0,10,2,8
LU,CH,2005.0,2,8,-6
AU,IQ,2013.0,2,1,1
IE,SE,2003.0,5,4,1
TR,CH,2004.0,5,6,-1
TZ,US,2001.0,3,4,-1
KR,SA,2005.0,1,1,0
FR,SI,1998.0,3,2,1
CM,PK,2022.0,1,2,-1
AE,FR,2009.0,2,3,-1
MY,MA,2015.0,3,2,1
KZ,TR,2022.0,30,76,-46
PK,JP,2003.0,6,8,-2
AE,NG,2018.0,4,3,1
AT,SI,2016.0,15,26,-11
PT,RO,2015.0,6,2,4
SG,CO,2013.0,1,2,-1
nan,MX,2000.0,3,6,-3
BG,SK,2003.0,2,1,1
BE,MG,2016.0,2,3,-1
DZ,BE,2002.0,3,2,1
PL,IL,2013.0,5,4,1
UG,SE,2017.0,3,3,0
BE,BJ,2014.0,6,1,5
AU,RO,2010.0,5,4,1
NP,NO,2009.0,1,2,-1
CM,NG,2004.0,3,2,1
TN,BH,2016.0,2,1,1
CH,UA,2020.0,4,4,0
SE,AE,2018.0,3,1,2
TR,AU,2009.0,5,5,0
RU,PT,2017.0,9,9,0
CU,BR,2006.0,13,9,4
CZ,BG,1997.0,1,1,0
CH,BD,2009.0,2,1,1
LU,CA,2011.0,2,3,-1
MM,JP,2007.0,3,5,-2
BD,IQ,2018.0,6,2,4
DK,SG,2002.0,1,6,-5
DK,SG,2005.0,4,4,0
PK,QA,2013.0,5,6,-1
UY,nan,2006.0,1,2,-1
GB,CR,2008.0,3,2,1
MY,NL,2004.0,2,1,1
VE,DE,2009.0,7,5,2
nan,NZ,2018.0,5,3,2
BE,LU,2000.0,3,3,0
SG,NL,2005.0,5,7,-2
GM,GB,2007.0,5,6,-1
GB,BG,2004.0,5,7,-2
PE,NI,2019.0,3,3,0
IL,CO,2013.0,2,1,1
US,MD,2008.0,6,7,-1
NL,ID,2004.0,6,2,4
ZM,US,2009.0,6,10,-4
US,CR,1999.0,10,8,2
GR,EG,2016.0,4,2,2
IN,SK,2004.0,3,1,2
MM,TR,2022.0,7,12,-5
SG,CL,2016.0,1,2,-1
IN,ET,2004.0,4,1,3
CH,SK,2017.0,10,12,-2
JP,DK,2005.0,11,13,-2
GB,BA,2019.0,5,4,1
BN,CN,2016.0,3,1,2
KW,SA,2013.0,13,8,5
AT,PE,2021.0,1,1,0
TZ,SE,2022.0,2,7,-5
UZ,DE,2012.0,4,1,3
ZA,GR,2014.0,2,3,-1
CN,KZ,2016.0,5,6,-1
IN,ES,2001.0,4,3,1
ZA,CA,1997.0,10,5,5
IE,BR,2003.0,2,4,-2
CA,CL,2023.0,3,1,2
PL,KZ,2018.0,4,2,2
SE,SG,2020.0,11,26,-15
CH,CI,2018.0,2,4,-2
BJ,TG,2018.0,2,2,0
CH,SK,2019.0,7,14,-7
SE,SI,2005.0,2,1,1
PG,US,2006.0,1,1,0
MN,JP,2014.0,4,13,-9
BD,BE,2012.0,2,5,-3
IT,KR,2021.0,4,11,-7
CL,SE,2022.0,9,1,8
KW,PK,2022.0,5,2,3
ES,RU,1999.0,7,14,-7
BR,PE,2001.0,2,4,-2
nan,NO,2003.0,15,12,3
AM,DE,2010.0,5,2,3
DK,TH,2012.0,1,1,0
IT,BA,2016.0,3,1,2
CO,nan,2004.0,2,2,0
KR,BD,2010.0,15,17,-2
GR,BR,2005.0,1,1,0
nan,NG,2017.0,4,10,-6
NL,GH,2008.0,1,1,0
CR,MX,2009.0,6,20,-14
PH,IN,2022.0,8,13,-5
CU,CA,2012.0,7,1,6
MK,AL,2017.0,3,2,1
MK,AL,2019.0,2,2,0
TT,US,2009.0,6,6,0
EE,DE,1998.0,5,9,-4
PA,IT,2019.0,3,2,1
DK,KR,2021.0,5,6,-1
SI,CZ,2005.0,8,5,3
TR,KG,2014.0,4,1,3
DE,MA,2019.0,11,5,6
MM,TH,2013.0,1,6,-5
EE,SE,2016.0,9,10,-1
GB,JO,2005.0,9,8,1
US,BY,2008.0,3,10,-7
SA,PK,2001.0,3,6,-3
NL,CO,2009.0,3,3,0
CY,GR,2004.0,4,9,-5
DE,HK,2009.0,1,1,0
FI,PK,2017.0,8,4,4
US,TN,2008.0,6,11,-5
CN,AT,2000.0,6,3,3
NG,TZ,2021.0,3,2,1
CH,SI,2004.0,5,4,1
AM,US,2022.0,8,15,-7
SD,PK,2018.0,4,5,-1
EC,AR,2013.0,4,13,-9
MY,CA,1999.0,6,2,4
DE,RE,2014.0,1,1,0
RS,CA,1999.0,2,7,-5
RU,AM,2021.0,14,12,2
MX,SE,2001.0,4,2,2
SG,LK,2020.0,4,3,1
RU,TN,2014.0,1,1,0
YE,IQ,2008.0,1,1,0
MV,AU,2013.0,1,1,0
CZ,MK,2018.0,2,1,1
NL,DZ,2016.0,3,1,2
CA,CO,2006.0,7,12,-5
AE,EG,2001.0,5,3,2
ID,HU,2011.0,1,1,0
DZ,PK,2018.0,2,1,1
UA,AU,2017.0,1,5,-4
CM,nan,2014.0,3,2,1
BG,PL,2016.0,4,2,2
PT,AT,2009.0,1,4,-3
AR,PY,2012.0,2,1,1
AT,KR,2003.0,2,2,0
JP,NP,1997.0,3,1,2
SE,TW,1999.0,5,2,3
ID,IR,2013.0,3,5,-2
US,SN,2011.0,7,6,1
TR,NZ,2012.0,4,1,3
TR,AL,2010.0,4,2,2
DE,NG,1998.0,2,2,0
PL,IN,2007.0,3,5,-2
UY,PT,2021.0,3,2,1
NL,CY,2017.0,4,4,0
EC,UA,2006.0,5,17,-12
FI,PK,2010.0,3,1,2
PL,SE,2000.0,7,14,-7
PS,IL,2007.0,1,2,-1
MY,CM,2018.0,3,2,1
IE,DK,2014.0,11,5,6
TW,PH,2012.0,4,3,1
DK,IR,2017.0,13,19,-6
NO,TR,2002.0,2,2,0
JO,IN,2017.0,3,4,-1
NL,CW,2007.0,11,10,1
CN,GE,2013.0,1,2,-1
nan,CA,1999.0,5,6,-1
GB,GE,2006.0,6,5,1
SK,SE,2012.0,2,2,0
AE,UG,2021.0,1,1,0
PT,DZ,2022.0,1,2,-1
UA,TH,2021.0,1,1,0
LT,CZ,2018.0,2,2,0
CH,TW,2012.0,2,9,-7
MA,FI,2022.0,6,1,5
MA,EG,2021.0,7,15,-8
PA,AR,2020.0,2,3,-1
LU,CL,2022.0,2,2,0
SG,IL,2015.0,4,3,1
SA,RW,2020.0,4,1,3
JP,NZ,2002.0,12,10,2
SE,RS,2022.0,2,4,-2
NO,IS,2014.0,7,8,-1
GR,PT,2020.0,2,1,1
CA,TZ,2020.0,4,1,3
TR,DK,2013.0,6,3,3
PL,LT,2016.0,2,4,-2
UA,IN,2004.0,1,2,-1
NG,IE,2007.0,1,1,0
SD,BR,2013.0,11,11,0
AR,PL,2010.0,1,2,-1
SY,NL,2013.0,1,2,-1
nan,SA,2020.0,5,1,4
AF,PK,2018.0,2,1,1
CA,nan,1997.0,1,3,-2
NL,MD,2005.0,1,1,0
LV,PL,2021.0,2,2,0
SN,NE,2020.0,1,2,-1
PE,CU,2009.0,5,2,3
SG,ID,2009.0,2,2,0
CN,MK,2005.0,5,3,2
IE,AT,2011.0,7,6,1
nan,NG,2019.0,8,9,-1
RU,GR,2007.0,2,2,0
IS,ES,2004.0,2,1,1
LU,IL,2000.0,1,1,0
TR,HR,2014.0,3,1,2
KE,SD,2000.0,5,1,4
SI,DE,2004.0,3,4,-1
FR,KH,2004.0,3,3,0
JP,HU,2022.0,2,3,-1
RS,CL,2020.0,1,2,-1
CU,NI,2014.0,1,1,0
SG,BE,2018.0,6,5,1
PT,HU,2016.0,3,1,2
NZ,MX,1998.0,1,1,0
ZW,BH,2017.0,2,4,-2
US,EC,2006.0,9,8,1
TT,GB,2020.0,3,4,-1
HR,CH,1998.0,2,2,0
TR,CZ,2003.0,1,1,0
KE,TR,2020.0,1,2,-1
JO,IN,2019.0,3,4,-1
UA,BR,2008.0,5,1,4
JM,GB,2007.0,4,11,-7
YE,MY,2021.0,6,18,-12
VN,RO,2007.0,2,1,1
TW,FI,2022.0,1,2,-1
TR,MX,2022.0,3,1,2
SD,CA,2016.0,1,5,-4
JP,SK,2018.0,3,7,-4
TW,MX,2019.0,2,1,1
NO,CA,2005.0,13,7,6
FR,CR,2015.0,5,3,2
AM,DE,2017.0,2,4,-2
NG,IN,2023.0,2,2,0
FI,IE,2020.0,6,7,-1
UY,AR,2000.0,2,8,-6
CO,AT,2017.0,2,3,-1
HN,CR,2019.0,3,3,0
MX,NG,2018.0,2,2,0
HT,FR,2005.0,1,1,0
nan,CZ,2017.0,5,9,-4
BE,ZA,2004.0,11,10,1
FR,EC,2014.0,6,5,1
FR,SA,2002.0,3,2,1
GR,ES,1998.0,1,4,-3
BE,SA,2019.0,5,1,4
BF,BE,2013.0,3,1,2
FI,KZ,2019.0,1,2,-1
TR,BR,2000.0,3,1,2
AT,NO,1998.0,1,1,0
QA,TN,2016.0,4,5,-1
ID,PT,2013.0,1,1,0
SG,CH,2007.0,6,10,-4
FR,GA,2004.0,3,1,2
NO,IE,2021.0,6,6,0
CH,nan,2016.0,13,24,-11
BE,CU,2001.0,1,1,0
ZA,SE,2000.0,2,6,-4
US,LU,2006.0,4,6,-2
US,AM,2010.0,6,18,-12
TH,IN,2008.0,4,3,1
TH,CH,2008.0,3,4,-1
GH,CN,2010.0,1,2,-1
SK,CA,1999.0,3,1,2
US,CI,2008.0,1,2,-1
SN,FR,2003.0,15,16,-1
IS,NO,2004.0,4,2,2
ES,NG,2021.0,1,2,-1
FI,GH,2019.0,2,3,-1
KZ,UA,2008.0,1,1,0
MY,NZ,2003.0,1,1,0
GR,BE,1999.0,3,5,-2
NO,KR,2021.0,6,7,-1
US,GD,2006.0,5,1,4
VN,MX,2009.0,3,4,-1
GB,GH,2023.0,1,1,0
NG,UG,2006.0,1,1,0
RU,IQ,2020.0,1,2,-1
HU,ZA,2021.0,1,3,-2
ZW,KE,2021.0,1,1,0
ID,AE,2014.0,1,2,-1
nan,CU,2018.0,2,9,-7
NO,EE,2011.0,1,1,0
BY,PT,2000.0,3,1,2
VN,CH,2006.0,1,2,-1
ES,BD,2001.0,4,1,3
GH,GB,2006.0,8,8,0
GW,BR,2016.0,1,1,0
OM,EG,1998.0,3,1,2
GR,BR,2002.0,2,1,1
ZA,PK,2007.0,1,2,-1
TR,NO,2007.0,4,4,0
US,NI,2016.0,5,2,3
RU,ET,2015.0,1,2,-1
IN,SA,2000.0,3,6,-3
MX,PL,2007.0,5,3,2
CZ,IR,2012.0,3,1,2
NL,BY,2009.0,1,2,-1
EG,GR,2012.0,2,4,-2
GH,KE,2017.0,3,1,2
EE,US,2015.0,3,13,-10
GE,AU,2016.0,5,2,3
HR,SI,2007.0,7,8,-1
NP,PK,2014.0,4,3,1
UA,BG,2008.0,10,5,5
RO,FI,2000.0,2,1,1
PL,SI,2011.0,3,1,2
DZ,ZA,2021.0,1,1,0
NG,FI,2021.0,3,3,0
US,UZ,2018.0,2,3,-1
OM,BD,2010.0,1,2,-1
VE,PE,2021.0,3,6,-3
SG,NL,2002.0,2,4,-2
SV,CO,2016.0,3,6,-3
FI,NZ,2011.0,2,3,-1
EC,IL,2020.0,1,1,0
CH,AM,2018.0,1,1,0
AT,HR,2011.0,5,9,-4
RO,PL,2006.0,2,3,-1
TZ,IR,2016.0,1,1,0
MX,ZA,2018.0,2,3,-1
FJ,US,2012.0,5,6,-1
SK,RS,2000.0,3,5,-2
FR,NE,1997.0,1,2,-1
ET,EG,2010.0,3,1,2
MY,QA,2012.0,4,2,2
PL,NZ,2011.0,2,1,1
ZA,KR,2005.0,2,2,0
EC,MX,2001.0,2,1,1
NO,IL,2006.0,1,2,-1
ES,NI,2020.0,10,4,6
OM,BD,2017.0,3,2,1
RO,SE,2021.0,3,2,1
BD,BR,2016.0,2,4,-2
CA,MD,2021.0,1,2,-1
ZA,AR,2015.0,1,1,0
NZ,IT,2004.0,2,3,-1
GM,CH,2015.0,1,1,0
TW,MX,2017.0,1,2,-1
NL,VE,2011.0,2,2,0
CZ,AR,2021.0,1,2,-1
BA,QA,2018.0,1,1,0
PE,GT,2019.0,3,3,0
FR,LK,2011.0,5,1,4
RO,IS,2003.0,1,1,0
CO,DE,1998.0,5,2,3
NO,FI,1999.0,7,4,3
AU,NG,2015.0,4,11,-7
IL,UA,2005.0,5,4,1
HK,AU,2006.0,1,3,-2
BG,BE,2015.0,2,7,-5
FI,CZ,2021.0,6,5,1
CN,MK,2002.0,2,3,-1
PE,GT,2017.0,1,1,0
DK,MY,2014.0,4,5,-1
AL,CA,2003.0,1,1,0
MA,HU,2018.0,2,2,0
FR,VE,2020.0,3,3,0
PT,CU,2009.0,1,5,-4
ET,IN,2007.0,2,3,-1
PK,CZ,2021.0,3,5,-2
MZ,IT,2019.0,1,2,-1
CU,CL,2000.0,4,3,1
UZ,US,2018.0,3,2,1
SE,CR,1999.0,2,1,1
HR,RU,2009.0,5,4,1
RU,PK,2010.0,1,1,0
NG,BJ,2020.0,5,6,-1
TH,IR,2020.0,2,3,-1
CZ,SI,2022.0,5,2,3
BR,ID,2022.0,9,5,4
BF,BR,2018.0,1,1,0
SD,MY,2015.0,5,8,-3
BB,GB,2006.0,3,1,2
BG,ZA,2020.0,1,2,-1
VN,ZA,2017.0,1,1,0
KR,QA,2015.0,2,6,-4
TW,MX,2010.0,2,2,0
PT,SK,2018.0,2,1,1
SN,MA,2022.0,3,1,2
AM,JP,2021.0,1,1,0
SE,BY,2018.0,2,1,1
BW,IL,2015.0,1,1,0
FR,TG,2014.0,4,3,1
IT,SK,2020.0,3,8,-5
NO,ZA,2013.0,6,5,1
IN,BB,2003.0,1,1,0
nan,RO,2014.0,1,1,0
IQ,IT,2007.0,1,1,0
EE,IN,2017.0,2,6,-4
IT,VE,1999.0,1,6,-5
EE,CZ,2013.0,3,1,2
BD,CA,1998.0,2,3,-1
NO,HU,2004.0,1,2,-1
NZ,CO,1999.0,1,1,0
PE,NI,2017.0,1,3,-2
UY,CA,1998.0,1,1,0
TN,OM,2021.0,3,1,2
SN,GN,2005.0,1,1,0
SA,NL,2005.0,2,2,0
RU,AE,2020.0,1,2,-1
AU,MM,2018.0,3,3,0
DE,CW,2021.0,2,2,0
UZ,LA,2016.0,1,1,0
IR,CD,2020.0,1,1,0
AF,MX,2007.0,5,1,4
CI,BF,2011.0,1,1,0
CD,ET,2020.0,2,1,1
ZA,TT,2020.0,1,1,0
AZ,DE,2014.0,1,2,-1
KE,DK,2011.0,2,1,1
AU,HU,2015.0,9,12,-3
AE,DE,2008.0,4,3,1
IE,CL,2008.0,1,2,-1
SG,BN,2013.0,1,2,-1
IT,SI,1999.0,2,1,1
TR,SI,2021.0,1,3,-2
IT,VA,2018.0,1,2,-1
KR,RO,2011.0,1,2,-1
PT,TW,2010.0,2,2,0
ID,AT,2011.0,1,2,-1
GH,US,2005.0,3,5,-2
LT,IT,2005.0,1,2,-1
TG,TR,2017.0,1,1,0
NL,JO,2015.0,1,1,0
CZ,NO,2000.0,2,4,-2
CA,EG,2000.0,5,7,-2
AE,ZA,2020.0,4,6,-2
SI,IR,2013.0,1,1,0
KR,FI,2013.0,2,2,0
SA,AT,2016.0,2,7,-5
ML,FR,2007.0,2,3,-1
NL,RS,2021.0,6,4,2
ZA,CM,2012.0,2,1,1
PE,BD,2016.0,1,1,0
OM,PK,2012.0,2,7,-5
PH,KR,2001.0,1,1,0
CH,MA,2009.0,2,2,0
PT,QA,2020.0,1,1,0
HR,NL,2021.0,3,5,-2
SG,MM,2005.0,1,2,-1
AE,CL,2015.0,1,1,0
BA,RS,2007.0,1,3,-2
RU,PE,2017.0,1,1,0
HU,BY,2008.0,1,2,-1
ID,IT,2005.0,1,1,0
BD,RU,2021.0,1,2,-1
NO,TH,2020.0,2,1,1
PT,MY,2005.0,1,2,-1
NO,NZ,2006.0,2,6,-4
FI,GH,2017.0,2,1,1
JP,ET,2011.0,3,3,0
RU,SA,2012.0,2,1,1
HN,ES,2001.0,3,6,-3
NG,AE,2021.0,3,1,2
LB,SN,2020.0,1,1,0
AU,SD,2016.0,1,3,-2
DE,MN,2021.0,1,1,0
CA,EE,2022.0,3,3,0
CH,IE,2005.0,4,6,-2
HU,JO,2022.0,3,1,2
VN,CZ,2007.0,1,1,0
CO,JP,2004.0,2,5,-3
RO,BE,1999.0,3,1,2
FR,SA,2005.0,1,3,-2
IN,RS,2012.0,3,2,1
SA,NL,2002.0,1,1,0
CY,PT,2020.0,1,1,0
NZ,BE,2006.0,2,5,-3
JP,US,2000.0,1593,1586,7
LU,FR,2020.0,32,43,-11
BR,ES,2016.0,324,439,-115
US,IE,2022.0,307,285,22
SG,TW,2006.0,33,20,13
JP,CA,2017.0,98,114,-16
DE,AT,2008.0,429,346,83
US,JP,1998.0,1362,1414,-52
AU,NZ,2021.0,131,129,2
MY,SG,2022.0,95,116,-21
PE,ES,2011.0,52,72,-20
CH,US,2005.0,503,549,-46
MY,BN,2016.0,14,5,9
NL,CH,2016.0,127,108,19
MY,ID,2022.0,100,157,-57
BR,nan,2017.0,136,114,22
IT,IE,2011.0,29,16,13
PH,US,2021.0,227,159,68
CN,HK,2008.0,59,50,9
PK,CN,2010.0,64,42,22
PL,JP,2001.0,16,14,2
CA,SE,2007.0,36,53,-17
DE,SA,2016.0,31,27,4
PT,DE,2014.0,57,48,9
BD,MY,2001.0,4,4,0
SA,GB,1998.0,15,13,2
NO,IN,2017.0,17,37,-20
SK,US,2009.0,30,35,-5
JP,IR,2016.0,11,26,-15
FR,CD,2018.0,6,1,5
AU,NL,2015.0,82,128,-46
AT,ES,2016.0,42,46,-4
RU,PT,2019.0,43,18,25
KE,nan,2022.0,3,3,0
HU,CN,2018.0,8,9,-1
nan,CH,2020.0,21,10,11
IL,DE,2018.0,66,68,-2
IQ,CN,2020.0,9,10,-1
CN,IL,2019.0,21,21,0
AU,TW,2013.0,30,38,-8
JP,GH,2017.0,6,4,2
AT,IT,2008.0,29,31,-2
SA,GB,1997.0,7,9,-2
KE,ZA,2016.0,18,43,-25
LU,ZA,2017.0,1,1,0
ES,BG,2012.0,4,3,1
TN,MA,2018.0,45,40,5
ZA,IE,2002.0,5,1,4
IN,DK,2020.0,32,19,13
HU,PL,2019.0,23,60,-37
IQ,AU,2018.0,15,21,-6
TH,IT,2016.0,2,6,-4
AU,ET,2013.0,2,4,-2
IR,JP,2012.0,9,23,-14
ZA,RW,2018.0,10,2,8
IN,RW,2022.0,9,3,6
US,ZW,2014.0,11,8,3
RO,CH,2022.0,6,9,-3
CA,PK,2007.0,6,10,-4
MX,DO,2017.0,7,6,1
BR,PK,2018.0,10,5,5
US,JO,2013.0,61,32,29
DK,CZ,2005.0,4,1,3
FI,DK,2005.0,9,6,3
DE,SG,2003.0,14,6,8
NO,JP,2014.0,10,16,-6
AU,JP,1997.0,29,31,-2
MD,TN,2001.0,1,1,0
CL,IT,2002.0,10,11,-1
CH,CA,2000.0,39,44,-5
HN,VE,2009.0,2,1,1
DE,BY,2014.0,4,7,-3
NL,BG,2016.0,5,1,4
CL,CN,2003.0,6,1,5
NL,CR,2020.0,3,3,0
EG,BE,2008.0,2,2,0
DK,JP,2017.0,15,15,0
CZ,CH,1999.0,8,3,5
CU,AT,2005.0,2,1,1
TW,nan,2016.0,3,3,0
BE,SA,2017.0,7,2,5
GE,SK,2010.0,3,7,-4
BD,TN,2015.0,2,2,0
MA,TN,2012.0,29,28,1
nan,NG,2010.0,3,4,-1
TT,CA,2006.0,2,2,0
NI,EC,2017.0,1,1,0
AR,VE,2015.0,12,16,-4
AR,PL,2017.0,5,1,4
MX,CZ,2021.0,5,3,2
CO,PY,2010.0,3,3,0
CN,UZ,2009.0,19,16,3
TN,FR,1997.0,10,11,-1
GR,PL,2022.0,3,3,0
TH,ZA,2012.0,4,2,2
ES,CA,1998.0,15,20,-5
LK,GR,2003.0,6,1,5
GR,DE,1998.0,15,19,-4
AR,MT,2014.0,1,1,0
CI,US,2016.0,5,7,-2
NG,CY,2020.0,10,7,3
FI,PK,2019.0,5,7,-2
AE,AT,2017.0,1,1,0
nan,RU,1998.0,5,4,1
CZ,ZA,2015.0,2,3,-1
DE,IS,2007.0,2,1,1
ES,PY,2010.0,2,6,-4
RU,TR,2020.0,9,18,-9
PT,CZ,2006.0,2,2,0
JP,PL,2000.0,16,12,4
MX,VN,1999.0,2,1,1
nan,CZ,2019.0,8,10,-2
XK,SE,2011.0,2,1,1
SG,SE,2002.0,3,4,-1
FI,CN,2001.0,15,6,9
PK,NZ,2009.0,1,1,0
JO,SA,2008.0,11,8,3
PL,AM,2004.0,1,1,0
EG,AT,2004.0,2,1,1
JO,BD,2022.0,2,1,1
PK,KE,2022.0,4,4,0
IN,UG,2016.0,2,3,-1
PL,FI,2004.0,2,6,-4
LT,CA,2018.0,2,1,1
HR,IT,2022.0,3,6,-3
IL,UA,2002.0,3,6,-3
DK,RO,2009.0,1,3,-2
KR,AT,2004.0,5,2,3
GH,IT,2002.0,1,3,-2
AT,RO,2003.0,2,4,-2
VE,CA,2013.0,3,1,2
SE,DZ,2021.0,1,4,-3
HR,CH,1997.0,1,1,0
EE,DE,1997.0,1,6,-5
NL,RW,2011.0,1,1,0
TG,FR,1998.0,1,1,0
BR,MZ,2006.0,1,2,-1
BR,TW,2014.0,1,1,0
RE,BJ,2007.0,1,1,0
BW,US,1999.0,2,3,-1
LV,US,2004.0,1,3,-2
LV,FR,2016.0,1,4,-3
KR,VG,2016.0,1,2,-1
CI,FR,1999.0,4,4,0
MQ,BR,2010.0,1,1,0
CL,CZ,2020.0,2,3,-1
CH,PE,2015.0,2,2,0
ZA,ES,2006.0,1,3,-2
PY,CL,2015.0,1,8,-7
GB,CL,2016.0,46,54,-8
US,AM,2019.0,18,12,6
IN,AE,2022.0,79,31,48
US,LK,2022.0,18,18,0
US,UA,2000.0,20,29,-9
IE,ZA,2018.0,10,9,1
CH,ES,2022.0,71,84,-13
SI,IT,2011.0,14,14,0
US,GA,2017.0,2,1,1
TN,DZ,2005.0,2,3,-1
JM,NZ,2010.0,1,1,0
DE,,2015.0,13530,0,13530
IT,,2013.0,5766,0,5766
,IL,1994.0,8264,0,8264
US,,2018.0,73318,0,73318
,GB,1999.0,15728,0,15728
,SG,2009.0,1575,0,1575
FI,,2014.0,1195,0,1195
,RU,2008.0,6881,0,6881
,US,2003.0,72718,0,72718
ES,,2013.0,5955,0,5955
EC,,2019.0,576,0,576
,AR,2014.0,2418,0,2418
,CO,2005.0,1627,0,1627
BR,,2006.0,1619,0,1619
,SE,2016.0,2646,0,2646
CO,,2004.0,87,0,87
,PA,2012.0,102,0,102
ZW,,2020.0,144,0,144
,CN,2018.0,42102,0,42102
ID,,2017.0,853,0,853
MY,,2014.0,784,0,784
,EG,2011.0,3869,0,3869
NL,,2003.0,1665,0,1665
MD,BR,2007.0,2,0,2
,ES,2018.0,11088,0,11088
PL,,2006.0,943,0,943
AO,JP,2003.0,2,0,2
IS,,2024.0,962,0,962
GB,,2001.0,5411,0,5411
,PT,2000.0,995,0,995
LK,,2012.0,80,0,80
,CO,2002.0,996,0,996
,LT,2001.0,462,0,462
GR,,2024.0,15294,0,15294
EC,,2017.0,172,0,172
ID,,2019.0,2573,0,2573
,JO,2011.0,437,0,437
,SA,2013.0,2285,0,2285
PA,,2022.0,165,0,165
,FJ,2012.0,36,0,36
,SD,1998.0,33,0,33
PT,,2008.0,258,0,258
BD,,2021.0,863,0,863
,NG,1998.0,622,0,622
,HR,2008.0,1083,0,1083
SI,,2024.0,3860,0,3860
,LB,2008.0,221,0,221
,TN,2003.0,800,0,800
SG,EG,2006.0,2,0,2
,DZ,2014.0,1544,0,1544
,GH,2017.0,645,0,645
,GH,2019.0,398,0,398
FR,PY,2018.0,2,0,2
KW,,2008.0,69,0,69
IT,PE,2011.0,5,0,5
,MT,2011.0,76,0,76
,SI,2013.0,626,0,626
BT,,2023.0,69,0,69
,BE,2015.0,2963,0,2963
CA,SC,2001.0,1,0,1
LB,EG,2001.0,1,0,1
,JM,2012.0,54,0,54
NG,,2006.0,230,0,230
PS,,2022.0,213,0,213
,CM,2001.0,124,0,124
,QA,1999.0,42,0,42
,ET,2011.0,583,0,583
,NZ,2016.0,1019,0,1019
,ID,1994.0,371,0,371
ID,,2010.0,122,0,122
,GE,2012.0,219,0,219
,KZ,2001.0,114,0,114
PE,PK,2015.0,3,0,3
,MM,1999.0,26,0,26
BF,,2021.0,161,0,161
,NE,2011.0,28,0,28
,GH,2010.0,341,0,341
EC,,2010.0,30,0,30
,EE,2013.0,354,0,354
,NG,1997.0,576,0,576
CZ,,2004.0,280,0,280
KR,IR,2008.0,3,0,3
QA,,2020.0,216,0,216
,HT,2004.0,6,0,6
BY,,2012.0,217,0,217
EG,CO,2007.0,2,0,2
,AL,2009.0,92,0,92
BG,,2018.0,404,0,404
JO,SD,2014.0,3,0,3
LY,,2010.0,13,0,13
LY,,2017.0,59,0,59
EG,,2001.0,153,0,153
,SV,2015.0,37,0,37
AF,ES,2017.0,1,0,1
,AF,2011.0,9,0,9
,MA,2003.0,489,0,489
,BO,2010.0,61,0,61
LY,,2019.0,63,0,63
XK,DK,2017.0,1,0,1
MO,BR,2020.0,2,0,2
PS,SD,2018.0,1,0,1
VE,DO,2010.0,1,0,1
CR,,2025.0,49,0,49
FJ,,2023.0,121,0,121
PA,BA,2015.0,1,0,1
,BO,2017.0,37,0,37
SY,MY,2013.0,4,0,4
,SD,1997.0,49,0,49
XK,BA,2011.0,1,0,1
,BO,2019.0,12,0,12
,YE,2018.0,74,0,74
TW,TN,2021.0,1,0,1
,KW,2000.0,135,0,135
,RO,2009.0,1686,0,1686
ML,,2022.0,90,0,90
SI,RU,2001.0,3,0,3
PK,TD,2022.0,1,0,1
GA,,2014.0,7,0,7
MD,FI,2003.0,1,0,1
CA,MT,2018.0,4,0,4
GT,,2015.0,20,0,20
IQ,,1999.0,6,0,6
IS,CH,2017.0,2,0,2
RO,,2007.0,146,0,146
IR,IS,2013.0,3,0,3
,SN,1999.0,52,0,52
EC,NL,2008.0,1,0,1
PH,BD,2003.0,2,0,2
,AZ,2000.0,69,0,69
ZA,CZ,2022.0,6,0,6
SV,CA,2015.0,1,0,1
TZ,LY,2018.0,1,0,1
WS,,2020.0,3,0,3
ZM,CH,2007.0,1,0,1
,GT,2011.0,45,0,45
CA,SY,2012.0,1,0,1
MW,,2003.0,6,0,6
IR,DK,2006.0,3,0,3
AE,TZ,2009.0,1,0,1
SN,TH,1998.0,2,0,2
ET,,2001.0,20,0,20
GA,CH,1998.0,1,0,1
JO,IN,2010.0,4,0,4
KE,MZ,2012.0,2,0,2
,CG,2012.0,40,0,40
PA,GB,2002.0,6,0,6
,MC,2013.0,6,0,6
XK,GE,2021.0,1,0,1
,SY,2003.0,55,0,55
DK,AE,2001.0,1,0,1
ZW,PK,2002.0,1,0,1
GH,,2002.0,23,0,23
ET,PT,2022.0,1,0,1
,PF,2006.0,4,0,4
MT,FR,2022.0,1,0,1
BF,CM,2014.0,1,0,1
,GM,2007.0,8,0,8
,GD,2005.0,10,0,10
CZ,GE,2014.0,2,0,2
UA,SE,2002.0,9,0,9
ZM,,2012.0,12,0,12
SE,AG,2020.0,1,0,1
BI,IR,2018.0,1,0,1
GR,ES,1997.0,3,0,3
CH,SN,2015.0,5,0,5
TJ,,2014.0,9,0,9
US,BI,2007.0,1,0,1
RU,CO,2013.0,5,0,5
BW,,2016.0,56,0,56
TN,,1998.0,7,0,7
TN,AT,2005.0,1,0,1
CW,,2009.0,10,0,10
,TT,2000.0,28,0,28
ML,CD,2016.0,1,0,1
PL,SG,2006.0,1,0,1
MX,SD,2014.0,1,0,1
CL,SI,2016.0,2,0,2
MK,CZ,2012.0,1,0,1
NL,MK,2013.0,1,0,1
NG,nan,2008.0,3,0,3
KP,CN,2013.0,3,0,3
ET,BW,2011.0,1,0,1
RS,AE,2015.0,2,0,2
HR,BD,2012.0,1,0,1
LK,MX,2022.0,1,0,1
VN,TW,2004.0,5,0,5
BD,DK,2004.0,1,0,1
CI,,1999.0,5,0,5
PK,JO,2008.0,2,0,2
UY,NI,2012.0,1,0,1
NG,LT,2022.0,2,0,2
BZ,IL,2002.0,1,0,1
HU,EG,1999.0,3,0,3
SN,,2003.0,9,0,9
MX,FI,2013.0,1,0,1
,GF,1995.0,4,0,4
MX,ET,2006.0,3,0,3
US,GY,2008.0,1,0,1
NO,PK,2003.0,1,0,1
,TH,2020.0,115,0,115
UZ,LK,2014.0,3,0,3
PH,UY,2009.0,1,0,1
DZ,QA,2016.0,3,0,3
MG,,2003.0,4,0,4
NA,KR,2007.0,4,0,4
VN,MZ,2005.0,1,0,1
PR,IR,2012.0,1,0,1
,LA,2011.0,23,0,23
IE,LY,2013.0,2,0,2
AT,KG,2009.0,1,0,1
GH,,2005.0,16,0,16
,SO,2004.0,2,0,2
BF,ML,2016.0,4,0,4
GB,KZ,2003.0,1,0,1
TN,TD,2016.0,1,0,1
CH,ET,2005.0,1,0,1
AT,BI,2022.0,1,0,1
UA,AU,2010.0,3,0,3
PK,SN,2007.0,1,0,1
KR,RS,2012.0,1,0,1
KH,FR,2006.0,7,0,7
MX,DO,2010.0,4,0,4
BF,SD,2016.0,1,0,1
GR,KZ,2018.0,4,0,4
BE,PK,2005.0,1,0,1
CY,SE,2015.0,2,0,2
PL,LU,2009.0,2,0,2
SJ,NO,2007.0,1,0,1
GR,nan,1997.0,1,0,1
SY,,1998.0,8,0,8
VE,AO,2003.0,1,0,1
KZ,EG,2013.0,2,0,2
OM,NP,2003.0,2,0,2
PT,MY,2002.0,3,0,3
SD,NG,2008.0,4,0,4
MY,SE,2008.0,1,0,1
,WS,1995.0,2,0,2
BO,NI,2008.0,1,0,1
BF,NG,2009.0,1,0,1
HK,MY,2016.0,1,0,1
,HN,2014.0,50,0,50
GE,SK,2019.0,3,0,3
BG,LV,2014.0,1,0,1
IR,BO,2011.0,1,0,1
PG,FJ,2019.0,1,0,1
TW,AL,2018.0,1,0,1
DK,MA,2017.0,1,0,1
US,BB,1998.0,1,0,1
ID,RW,2020.0,2,0,2
KR,PT,2006.0,2,0,2
DZ,,2000.0,16,0,16
AF,ES,2019.0,1,0,1
RU,BW,2019.0,1,0,1
NA,IN,2021.0,2,0,2
VN,ZA,2010.0,1,0,1
TT,IT,2016.0,1,0,1
CG,MU,2018.0,1,0,1
AM,GH,2021.0,4,0,4
RU,PE,2019.0,1,0,1
BH,BD,2021.0,1,0,1
GA,MG,2003.0,1,0,1
AZ,IR,2012.0,4,0,4
CD,UG,2021.0,5,0,5
ET,CN,2003.0,2,0,2
HN,US,2022.0,6,0,6
SN,ET,2015.0,1,0,1
,TD,2002.0,3,0,3
BO,IE,2013.0,1,0,1
MK,GB,1997.0,2,0,2
CG,LK,2010.0,1,0,1
SK,CY,2016.0,1,0,1
CD,TZ,2017.0,1,0,1
KE,ES,2013.0,1,0,1
IN,BJ,2004.0,2,0,2
KZ,MY,2022.0,2,0,2
MZ,GR,2010.0,1,0,1
PL,SD,2015.0,1,0,1
LV,FI,2003.0,1,0,1
NZ,GH,2014.0,2,0,2
CO,NL,2001.0,3,0,3
BI,CA,1997.0,1,0,1
SK,VN,2012.0,1,0,1
,BS,2005.0,6,0,6
AU,IS,1999.0,1,0,1
SZ,US,2015.0,1,0,1
MG,CH,2014.0,1,0,1
LR,,2022.0,14,0,14
BJ,PG,2018.0,1,0,1
BE,DZ,2003.0,2,0,2
AZ,KR,2001.0,1,0,1
GH,IT,2005.0,1,0,1
AM,ES,2021.0,2,0,2
MY,EE,2020.0,1,0,1
JP,RU,2023.0,4,0,4
BE,CW,2022.0,2,0,2
AZ,ID,2007.0,3,0,3
IN,ZW,2002.0,1,0,1
UA,CH,2004.0,2,0,2
ME,RS,2023.0,1,0,1
BD,CA,1997.0,2,0,2
ZA,PA,2009.0,1,0,1
BD,QA,2016.0,2,0,2
NG,LY,2019.0,1,0,1
NZ,CY,2011.0,1,0,1
ZM,AU,2004.0,2,0,2
PK,ES,2003.0,2,0,2
IT,XK,2007.0,1,0,1
SG,EC,2005.0,1,0,1
HU,VG,2007.0,1,0,1
BF,CF,2019.0,1,0,1
GB,LA,2021.0,4,0,4
NL,IS,2003.0,1,0,1
GB,MC,2004.0,1,0,1
HU,SG,2010.0,1,0,1
KZ,MK,2012.0,1,0,1
CZ,LB,2017.0,1,0,1
AU,MN,2017.0,1,0,1
NZ,MX,1997.0,1,0,1
ES,BY,1999.0,1,0,1
KE,RU,2019.0,2,0,2
CN,PY,2018.0,1,0,1
PT,DK,2004.0,2,0,2
GT,CH,2005.0,1,0,1
HK,NO,2014.0,1,0,1
PS,OM,2015.0,1,0,1
US,DO,2001.0,1,0,1
PK,PE,2022.0,1,0,1
IR,LV,2022.0,2,0,2
CN,YE,2015.0,1,0,1
PA,IT,2017.0,2,0,2
AR,CN,2016.0,5,0,5
SD,PH,2009.0,1,0,1
MZ,,2009.0,6,0,6
NP,MV,2020.0,2,0,2
IQ,DZ,2013.0,1,0,1
CM,CG,2002.0,1,0,1
BA,GB,2021.0,4,0,4
AM,SE,2020.0,2,0,2
CY,KR,2016.0,1,0,1
VE,DO,2019.0,3,0,3
IR,IQ,2012.0,3,0,3
KY,AU,2013.0,1,0,1
HR,QA,2013.0,1,0,1
PS,IE,2020.0,1,0,1
PH,EG,2003.0,1,0,1
FR,ZW,2004.0,2,0,2
GD,AU,2020.0,1,0,1
ID,NZ,2000.0,2,0,2
OM,DZ,2012.0,1,0,1
ZA,BE,1999.0,5,0,5
AU,MA,2013.0,2,0,2
NP,NL,2009.0,2,0,2
MY,TN,2007.0,1,0,1
AO,AR,2006.0,1,0,1
BR,GF,2015.0,2,0,2
SD,IT,2013.0,2,0,2
NI,PH,2017.0,1,0,1
nan,MC,2012.0,1,0,1
UY,IE,2001.0,2,0,2
DE,NG,1997.0,3,0,3
MY,BA,2018.0,3,0,3
VN,LU,2020.0,2,0,2
HK,,2008.0,7,0,7
FI,TZ,2012.0,1,0,1
US,GA,2010.0,1,0,1
VN,SA,2022.0,2,0,2
SG,GF,2020.0,1,0,1
TW,AZ,2016.0,1,0,1
FJ,FR,2010.0,1,0,1
RS,BY,2012.0,1,0,1
IT,HN,2009.0,1,0,1
NG,SL,2018.0,2,0,2
TN,DZ,2002.0,1,0,1
AU,AE,2001.0,6,0,6
CY,PL,2012.0,1,0,1
LI,,2009.0,6,0,6
AU,LA,2010.0,1,0,1
CN,BW,2007.0,3,0,3
CA,ZM,2008.0,1,0,1
AU,FJ,1999.0,4,0,4
EC,AU,2014.0,4,0,4
GR,MA,2014.0,2,0,2
TZ,ES,2014.0,1,0,1
KW,NG,2003.0,1,0,1
BF,ZA,2019.0,3,0,3
nan,BG,2013.0,3,0,3
MU,,2011.0,9,0,9
BI,GB,2015.0,1,0,1
BA,AU,2021.0,1,0,1
RO,LB,2022.0,1,0,1
NG,NE,2015.0,2,0,2
CH,MK,2015.0,3,0,3
DE,GF,1998.0,1,0,1
CH,GE,2011.0,1,0,1
ES,TN,2007.0,2,0,2
GA,GR,2020.0,1,0,1
,HT,1996.0,1,0,1
KG,,2004.0,4,0,4
SK,NZ,2005.0,2,0,2
ZW,AU,2004.0,2,0,2
SI,LK,2007.0,1,0,1
IL,GR,2000.0,1,0,1
BR,UG,2006.0,1,0,1
,RW,1995.0,2,0,2
NO,TR,2005.0,3,0,3
MS,FR,2000.0,1,0,1
GP,,1998.0,1,0,1
IE,KY,2007.0,1,0,1
,FO,2002.0,1,0,1
FR,BH,2021.0,1,0,1
DE,AR,2023.0,2,0,2
TM,,2015.0,1,0,1
MY,nan,2001.0,2,0,2
LK,BR,2011.0,3,0,3
AM,IN,2006.0,1,0,1
GH,NL,2003.0,3,0,3
ID,EE,2020.0,1,0,1
EE,CH,1997.0,2,0,2
BF,CN,2020.0,1,0,1
IS,TH,2013.0,1,0,1
BE,HK,2021.0,1,0,1
IE,KE,2004.0,1,0,1
ML,IT,2018.0,1,0,1
PL,ZA,2003.0,2,0,2
UZ,MY,2011.0,3,0,3
BO,VE,2007.0,2,0,2
FR,ET,2005.0,2,0,2
RW,MW,2022.0,1,0,1
LV,SI,2008.0,1,0,1
PH,TW,1999.0,2,0,2
ZM,GB,1997.0,3,0,3
RO,LK,2018.0,1,0,1
IT,BF,2006.0,1,0,1
ID,HK,2014.0,1,0,1
PK,AT,2000.0,1,0,1
DE,PA,2004.0,1,0,1
LT,TW,2008.0,1,0,1
CN,IS,2005.0,2,0,2
IR,MA,2013.0,3,0,3
NO,TW,1999.0,1,0,1
ID,EC,2015.0,2,0,2
ZM,BE,2005.0,2,0,2
IE,PT,1998.0,4,0,4
,FO,2005.0,2,0,2
PK,PT,2005.0,1,0,1
LV,BG,2020.0,2,0,2
AU,AM,2010.0,1,0,1
CN,MY,1998.0,5,0,5
,GD,2002.0,2,0,2
MG,CN,2009.0,4,0,4
DE,TJ,2020.0,2,0,2
AT,AE,2004.0,1,0,1
FI,ET,2020.0,1,0,1
MN,,2001.0,2,0,2
ES,QA,2006.0,3,0,3
FI,TW,2006.0,1,0,1
IT,DZ,1998.0,3,0,3
TL,AU,2019.0,1,0,1
GR,TN,2018.0,1,0,1
NG,PK,2007.0,1,0,1
BF,BI,2010.0,1,0,1
MX,SY,2006.0,1,0,1
BR,NA,2007.0,1,0,1
FI,VE,2022.0,1,0,1
GP,GF,2015.0,1,0,1
ZW,ZM,2020.0,2,0,2
SV,DE,2018.0,1,0,1
ZM,GR,2020.0,1,0,1
RE,NO,2013.0,1,0,1
FR,ME,2021.0,1,0,1
IS,CN,2007.0,1,0,1
NE,TN,2011.0,1,0,1
NG,GE,2021.0,1,0,1
MW,EG,2000.0,1,0,1
SV,SN,2002.0,1,0,1
ZW,MW,2011.0,1,0,1
CU,FI,2007.0,1,0,1
CH,PF,2015.0,1,0,1
VE,DO,2017.0,1,0,1
NG,RS,2010.0,1,0,1
SN,GM,2005.0,1,0,1
AO,MX,2000.0,1,0,1
SN,ZA,2004.0,1,0,1
FI,CU,2001.0,1,0,1
PA,BR,2022.0,1,0,1
MQ,,2008.0,4,0,4
CM,KH,2019.0,1,0,1
EE,AZ,2021.0,1,0,1
PY,PE,2013.0,2,0,2
PH,ZA,2004.0,1,0,1
GB,SY,2000.0,1,0,1
PA,RU,2017.0,1,0,1
DK,HR,1997.0,1,0,1
AT,CU,2012.0,1,0,1
NO,PT,1998.0,3,0,3
TH,BW,2004.0,1,0,1
SE,LU,2003.0,1,0,1
CG,LK,2017.0,1,0,1
MM,US,1997.0,1,0,1
TZ,CA,2005.0,1,0,1
IT,AL,2003.0,1,0,1
NZ,LA,2007.0,1,0,1
IR,IL,2013.0,1,0,1
HU,AR,2001.0,1,0,1
DK,GE,2015.0,1,0,1
DE,ZW,1999.0,1,0,1
GB,SM,2007.0,1,0,1
CD,,2006.0,2,0,2
DK,EG,2012.0,2,0,2
JP,BH,2018.0,2,0,2
PH,SA,2021.0,2,0,2
GR,LB,2010.0,1,0,1
KE,ZM,2009.0,2,0,2
JP,BJ,2004.0,1,0,1
HR,GR,2018.0,1,0,1
KR,HK,2009.0,1,0,1
PT,TW,2019.0,1,0,1
ZM,ET,2021.0,2,0,2
JP,CY,2010.0,1,0,1
SA,ZM,2014.0,1,0,1
PL,MM,2016.0,1,0,1
TR,KR,1997.0,1,0,1
VN,GH,2011.0,1,0,1
RU,UG,2017.0,1,0,1
MG,GP,2015.0,1,0,1
BG,OM,2013.0,1,0,1
PS,ZA,2011.0,1,0,1
KE,SN,2003.0,1,0,1
OM,LB,2020.0,1,0,1
ES,TH,2006.0,2,0,2
CO,OM,2009.0,1,0,1
BY,TR,2000.0,1,0,1
IL,ID,2013.0,1,0,1
US,SV,1999.0,1,0,1
SE,SI,2002.0,1,0,1
PK,MX,1998.0,1,0,1
TH,ZM,2001.0,1,0,1
LK,TW,2009.0,1,0,1
NL,CD,2013.0,1,0,1
AT,BD,2001.0,1,0,1
CG,LA,2016.0,1,0,1
JM,KY,2020.0,1,0,1
MA,KR,2015.0,1,0,1
CY,FI,2023.0,1,0,1
IE,ID,2016.0,2,0,2
CL,ZM,2012.0,1,0,1
LY,US,2004.0,2,0,2
CN,ME,2020.0,1,0,1
FI,KW,2010.0,1,0,1
ES,GE,1999.0,1,0,1
VG,ES,1997.0,1,0,1
TD,FR,2002.0,1,0,1
ZM,IN,1998.0,2,0,2
CO,AO,2014.0,1,0,1
EG,SK,2020.0,1,0,1
AT,BF,2022.0,1,0,1
IR,EE,2021.0,3,0,3
ZA,KN,2006.0,1,0,1
AR,NL,1997.0,2,0,2
IL,SI,1998.0,1,0,1
AT,ET,2006.0,1,0,1
MY,CY,2022.0,1,0,1
IN,KY,2009.0,2,0,2
DZ,JO,2011.0,1,0,1
NE,,2014.0,5,0,5
NZ,ID,2001.0,1,0,1
GE,CN,2008.0,1,0,1
,GL,2016.0,3,0,3
SZ,,2011.0,2,0,2
MZ,CH,2000.0,1,0,1
KW,NZ,2020.0,1,0,1
MT,US,2008.0,1,0,1
GF,ID,2017.0,1,0,1
ML,SN,1999.0,1,0,1
PF,GP,2008.0,1,0,1
ID,PG,2017.0,1,0,1
CL,KZ,2018.0,2,0,2
NL,ZW,2000.0,3,0,3
IR,BY,2017.0,1,0,1
GR,SD,2008.0,1,0,1
CO,KZ,2022.0,1,0,1
RU,CM,1998.0,1,0,1
UA,DK,1998.0,2,0,2
SE,CU,2007.0,1,0,1
MA,SY,1997.0,1,0,1
HU,BR,2003.0,1,0,1
MY,PG,2020.0,1,0,1
FR,LV,2002.0,2,0,2
PG,IR,2000.0,1,0,1
PG,CH,2015.0,1,0,1
PY,UY,2012.0,3,0,3
JM,IN,2003.0,1,0,1
JP,DO,2012.0,1,0,1
TT,DE,2017.0,1,0,1
ZA,NA,1997.0,1,0,1
BR,JM,2014.0,1,0,1
MY,PA,2009.0,1,0,1
JO,RU,2018.0,1,0,1
US,SS,2007.0,1,0,1
ST,BE,2014.0,1,0,1
CM,TR,2020.0,1,0,1
MX,IE,2003.0,1,0,1
GD,BG,2009.0,2,0,2
HN,CH,2000.0,1,0,1
,BM,2000.0,2,0,2
DO,CU,1998.0,1,0,1
KZ,NL,2005.0,1,0,1
IL,KR,2004.0,1,0,1
AZ,HU,2022.0,1,0,1
DK,SI,2013.0,1,0,1
DK,VE,2020.0,1,0,1
PT,AE,2013.0,1,0,1
CM,IN,2013.0,1,0,1
PY,BE,1997.0,1,0,1
CZ,CD,2020.0,1,0,1
KG,GB,2020.0,1,0,1
OM,BN,2022.0,1,0,1
BD,BN,2018.0,2,0,2
IN,ER,2000.0,1,0,1
KZ,US,2000.0,1,0,1
MQ,GF,2015.0,1,0,1
ME,MK,2015.0,1,0,1
TH,NP,2008.0,2,0,2
SI,AZ,2015.0,1,0,1
CW,HU,2016.0,1,0,1
MK,TR,2015.0,1,1,0
MD,GB,2001.0,1,1,0
BE,LB,2012.0,1,2,-1
SE,VE,2011.0,1,1,0
FR,NE,1998.0,2,4,-2
CA,LU,2008.0,2,1,1
RS,JP,2020.0,1,2,-1
BE,RS,2007.0,1,3,-2
BH,JP,2014.0,1,3,-2
PL,RO,2000.0,2,1,1
AU,RO,2019.0,2,4,-2
DE,MA,2010.0,5,7,-2
NO,SI,2009.0,1,2,-1
PA,EC,2021.0,1,6,-5
SE,LK,2014.0,1,2,-1
NZ,DK,2000.0,2,3,-1
BW,GB,2022.0,1,2,-1
GH,BH,2006.0,1,1,0
IE,RS,2018.0,1,4,-3
AU,MN,2010.0,1,1,0
GB,CU,2008.0,4,6,-2
ID,DE,2000.0,2,2,0
ZA,TR,2008.0,1,2,-1
BG,MX,2011.0,1,1,0
QA,JP,2013.0,2,6,-4
ZA,KE,2023.0,1,1,0
TW,ZA,2012.0,1,3,-2
OM,QA,2018.0,2,2,0
CY,BE,2017.0,1,2,-1
MN,RU,2013.0,1,2,-1
US,ER,2017.0,1,1,0
KE,NO,2016.0,2,2,0
KE,SA,2015.0,2,2,0
nan,IE,2012.0,1,2,-1
AT,MY,2003.0,1,1,0
IN,SR,2020.0,1,1,0
IL,NZ,2022.0,1,1,0
PS,TR,2018.0,1,1,0
AT,IE,2021.0,3,5,-2
PA,CA,2009.0,2,1,1
CA,PE,2007.0,1,4,-3
LB,IR,2006.0,1,1,0
HK,RO,2008.0,1,21,-20
LU,ZA,2019.0,3,1,2
CI,ZA,2016.0,1,2,-1
KR,BH,2017.0,1,2,-1
MX,GR,2009.0,4,8,-4
TZ,MW,2019.0,2,1,1
OM,AE,2006.0,1,2,-1
CH,CY,2013.0,2,1,1
ET,EG,2017.0,1,9,-8
JO,SY,2009.0,2,1,1
IE,GR,2001.0,1,1,0
MZ,UA,2000.0,2,2,0
DE,AM,2015.0,1,12,-11
CZ,EC,2013.0,1,1,0
BR,UA,2015.0,1,7,-6
TZ,PK,2016.0,1,1,0
HR,FR,2000.0,1,1,0
KR,PL,2009.0,1,1,0
GE,CA,2012.0,1,3,-2
FI,SK,2022.0,1,2,-1
JM,TT,1998.0,1,1,0
BE,CG,2011.0,1,1,0
FJ,LK,2015.0,1,1,0
LK,SE,2014.0,2,1,1
GE,ES,2013.0,1,1,0
NE,US,2013.0,1,4,-3
GD,GB,2016.0,2,4,-2
CD,TZ,2019.0,1,1,0
BE,MZ,2009.0,1,4,-3
AU,SC,2021.0,1,1,0
TH,CZ,2018.0,1,3,-2
BD,PE,2016.0,1,1,0
FI,KZ,2017.0,2,1,1
ET,NG,2006.0,1,1,0
TZ,BW,2018.0,1,2,-1
CH,RW,2014.0,1,1,0
CL,BG,2019.0,1,2,-1
AU,LA,2019.0,1,2,-1
BR,IE,2001.0,1,1,0
GE,KR,2007.0,1,2,-1
JP,EE,2020.0,1,1,0
ID,DZ,2016.0,1,1,0
AE,AT,2010.0,1,3,-2
IN,VN,2012.0,2,1,1
LU,MX,2019.0,1,2,-1
AR,MD,2012.0,1,2,-1
JP,PA,2015.0,2,1,1
CY,NL,2020.0,2,5,-3
AT,BA,2009.0,1,1,0
XK,PL,2015.0,1,5,-4
KE,BI,2015.0,1,1,0
IT,DZ,1997.0,2,1,1
OM,JP,2014.0,1,1,0
BD,BH,2017.0,2,1,1
QA,ID,2016.0,1,1,0
KR,UA,2011.0,1,2,-1
EG,BR,2006.0,1,1,0
CL,SG,2022.0,1,1,0
ES,TT,2011.0,1,1,0
KE,MX,2018.0,1,1,0
EC,HN,2015.0,1,1,0
CZ,QA,2015.0,1,1,0
BA,SK,2021.0,1,2,-1
SA,LU,2014.0,1,1,0
FJ,KR,2010.0,1,1,0
CL,DK,2009.0,1,3,-2
LB,DE,2004.0,1,3,-2
TR,SA,2023.0,1,2,-1
HR,MX,2020.0,1,1,0
LY,TR,2022.0,1,2,-1
BG,AU,1998.0,2,3,-1
MU,GB,2021.0,4,1,3
LB,KR,2019.0,1,1,0
SK,nan,2008.0,1,2,-1
IE,LK,2014.0,1,1,0
MY,BE,2006.0,1,1,0
BR,AT,2002.0,2,2,0
TZ,NO,2022.0,1,2,-1
MD,SN,2004.0,1,1,0
RO,EG,2021.0,1,1,0
ZM,CZ,2021.0,1,1,0
TG,TR,2010.0,1,1,0
BY,SI,2008.0,1,1,0
TD,FR,2005.0,1,2,-1
GB,UY,2022.0,1,2,-1
PE,GB,2004.0,1,1,0
,SO,1996.0,1,0,1
SR,,2008.0,1,0,1
BE,KH,2020.0,1,0,1
YE,OM,2015.0,1,0,1
MK,PL,2006.0,1,0,1
JO,FI,2009.0,1,0,1
RS,NP,2015.0,1,0,1
FI,KW,2017.0,2,0,2
LT,SI,2012.0,1,0,1
MN,CO,2021.0,1,0,1
DK,LV,1999.0,1,0,1
HN,NI,2018.0,1,0,1
VE,NG,2020.0,1,0,1
EC,CG,2002.0,1,0,1
PH,CL,2004.0,1,0,1
TH,BR,2009.0,2,0,2
BR,GH,2008.0,1,0,1
HN,HT,2016.0,1,0,1
MT,LY,2019.0,1,0,1
RO,MA,2014.0,1,0,1
MZ,KE,2015.0,2,0,2
NG,MW,2004.0,1,0,1
CN,LS,2016.0,1,0,1
,BS,2002.0,1,0,1
JO,PS,2007.0,1,0,1
NO,BJ,2015.0,1,0,1
NZ,JM,2003.0,1,0,1
EC,BD,2009.0,1,0,1
KR,BH,2019.0,2,0,2
KW,YE,2009.0,1,0,1
PY,NO,2018.0,1,0,1
TN,GM,2022.0,1,0,1
KR,GD,2012.0,1,0,1
BY,nan,2006.0,1,0,1
HR,MK,2014.0,1,0,1
ML,CM,2011.0,1,0,1
BE,AO,2008.0,1,0,1
GE,AT,2016.0,1,0,1
EG,MD,2013.0,1,0,1
NZ,BD,2005.0,2,0,2
UA,TW,2000.0,2,0,2
JM,TT,1997.0,2,0,2
NZ,HU,2011.0,1,0,1
PL,CO,2005.0,1,0,1
KE,GH,2022.0,1,0,1
SG,IR,2000.0,1,0,1
ES,AO,2007.0,2,0,2
MA,NE,2006.0,1,0,1
IE,GM,2014.0,1,0,1
SS,CY,2017.0,1,0,1
,GY,2001.0,1,0,1
PL,CH,2023.0,2,0,2
TG,IT,2018.0,1,0,1
BD,TT,2014.0,1,0,1
AL,FI,2017.0,1,0,1
LK,ZA,2016.0,1,0,1
TZ,JO,2020.0,1,0,1
FO,GL,2018.0,1,0,1
GR,LY,2009.0,1,0,1
US,MZ,2023.0,1,0,1
FR,ZM,2007.0,1,0,1
CZ,TR,1999.0,1,0,1
CN,TZ,2011.0,1,0,1
RU,VE,2009.0,1,0,1
AE,CO,2007.0,1,0,1
DE,BI,2007.0,1,0,1
VE,KW,2004.0,1,0,1
PW,,2020.0,1,0,1
IN,LT,2000.0,1,0,1
TR,AL,2019.0,2,0,2
CA,CY,2004.0,2,0,2
BE,LV,2006.0,1,0,1
ZM,DK,2016.0,1,0,1
TR,MD,2008.0,1,0,1
BH,ES,2016.0,1,0,1
EG,NG,2004.0,1,0,1
SS,NO,2021.0,1,0,1
XK,CH,2018.0,1,0,1
FR,DJ,2012.0,1,0,1
IN,ZW,2005.0,1,0,1
UG,DE,2009.0,1,0,1
MX,RO,1997.0,1,0,1
DK,CY,2013.0,1,0,1
AU,EC,2008.0,1,0,1
BF,GA,2014.0,1,0,1
TW,LK,2002.0,1,0,1
US,SL,2007.0,1,0,1
US,ER,2010.0,1,0,1
BD,NZ,2002.0,1,0,1
BR,BA,2010.0,1,0,1
ZM,ES,2020.0,1,0,1
MK,DE,2002.0,1,0,1
SD,SG,2018.0,1,0,1
IS,MT,2022.0,1,0,1
CI,GB,2004.0,1,0,1
LB,NO,2022.0,1,0,1
CM,NC,2016.0,1,0,1
nan,BJ,2018.0,1,0,1
TW,ID,2007.0,1,0,1
SN,CH,2018.0,3,0,3
LU,MX,2017.0,1,0,1
GB,MM,2012.0,1,0,1
NL,MD,2002.0,1,0,1
BM,,2002.0,1,0,1
CY,IN,2010.0,1,0,1
NO,UA,2001.0,1,0,1
NL,BA,2009.0,1,0,1
US,SR,2020.0,1,0,1
TT,NG,2008.0,1,0,1
SI,BR,2004.0,1,0,1
SK,BA,2016.0,2,0,2
GB,SN,2007.0,1,0,1
AR,HU,2014.0,1,0,1
FI,DZ,2006.0,1,0,1
nan,EG,2000.0,1,0,1
MX,TN,2007.0,1,0,1
UY,CZ,2015.0,1,0,1
,FM,1999.0,1,0,1
PK,ET,2021.0,1,0,1
VE,PH,2005.0,1,0,1
BG,EE,2003.0,1,0,1
PA,IT,2010.0,1,0,1
OM,EG,1997.0,1,0,1
BD,UA,2019.0,1,0,1
BE,SA,2010.0,1,0,1
MR,EG,2021.0,1,0,1
AZ,TJ,2020.0,2,0,2
KH,JO,2020.0,1,0,1
SY,IE,2016.0,1,0,1
AT,PT,2000.0,1,0,1
BY,LT,2023.0,2,0,2
IN,SV,2019.0,1,0,1
NZ,JO,2007.0,1,0,1
IL,GE,2006.0,1,0,1
AT,NO,1997.0,1,0,1
,TD,2005.0,1,0,1
JP,GD,2017.0,1,0,1
ES,UZ,2018.0,1,0,1
BE,EG,2000.0,1,0,1
QA,PY,2020.0,1,0,1
IT,CD,2013.0,1,0,1
XK,AE,2019.0,1,0,1
BY,AU,2019.0,1,0,1
IE,BN,2006.0,1,0,1
UG,CU,2011.0,1,0,1
JO,QA,2023.0,1,0,1
BJ,NE,2002.0,1,0,1
GH,KR,2008.0,1,0,1
NE,UG,2019.0,1,0,1
AM,AU,2013.0,1,0,1
LS,CH,2014.0,1,0,1
BE,IS,2018.0,1,0,1
PL,AZ,2015.0,1,0,1
PA,GB,2005.0,1,0,1
GR,LB,2017.0,1,0,1
TH,EG,2016.0,1,0,1
,ER,1994.0,1,0,1
JO,NZ,2003.0,1,0,1
RE,GB,2016.0,1,0,1
RS,RO,2021.0,1,0,1
,UY,2020.0,4,0,4
ID,KH,2020.0,1,0,1
IN,CU,2005.0,1,0,1
IL,LK,2009.0,1,0,1
NC,AU,2009.0,1,0,1
UG,NP,2016.0,1,0,1
GR,SK,2011.0,1,0,1
GR,RU,2023.0,1,0,1
XK,RO,2013.0,1,0,1
PE,UG,2023.0,1,0,1
TR,NG,2023.0,1,0,1
UZ,PH,2022.0,1,0,1
KR,BS,2020.0,1,0,1
IR,RO,2015.0,1,0,1
TW,MN,2021.0,1,0,1
,TM,2011.0,1,0,1
PT,BR,2020.0,1230,1159,71
ES,AU,2000.0,10,11,-1
SI,BR,2014.0,2,2,0
US,CA,2010.0,3045,3039,6
CL,PE,2017.0,80,66,14
US,CL,2021.0,187,272,-85
US,CA,2019.0,3614,3985,-371
FR,US,2014.0,1629,1345,284
GB,AU,2014.0,1504,1296,208
JO,US,2018.0,57,71,-14
US,AU,2021.0,2053,1996,57
BR,US,2019.0,1604,1463,141
US,CA,2017.0,3415,3752,-337
JP,TW,2002.0,51,29,22
GB,FR,2011.0,568,540,28
JP,ES,2022.0,18,17,1
CN,SG,1999.0,99,52,47
US,ES,2013.0,1008,987,21
US,AR,2008.0,197,196,1
FR,SN,2008.0,21,17,4
US,TW,2019.0,744,710,34
GB,SE,2021.0,212,142,70
AR,EC,2020.0,52,46,6
MX,CU,2021.0,26,37,-11
FR,GB,2018.0,716,652,64
ES,GB,2006.0,192,216,-24
AU,CN,1999.0,73,65,8
US,PK,2013.0,233,164,69
IT,BR,2012.0,214,197,17
US,KR,2006.0,1011,906,105
MY,NL,2014.0,6,11,-5
DE,NL,2017.0,374,463,-89
AU,GB,2022.0,767,855,-88
BE,US,1999.0,164,125,39
DE,FR,2014.0,571,542,29
GB,TH,2009.0,53,23,30
PK,AU,2015.0,38,37,1
US,DK,2017.0,303,297,6
CH,JP,2014.0,96,107,-11
US,CO,2020.0,324,426,-102
GB,DE,2015.0,899,903,-4
MY,ID,2016.0,342,104,238
EC,PE,2020.0,61,55,6
JP,RS,1998.0,1,4,-3
GB,SG,2018.0,181,140,41
JP,GB,2005.0,234,287,-53
FR,DE,1998.0,227,219,8
FR,IN,2021.0,109,111,-2
CL,UY,2020.0,15,23,-8
US,TW,2010.0,760,621,139
JP,CN,2009.0,673,439,234
IL,DE,2010.0,43,37,6
CN,TW,2015.0,929,1363,-434
US,BR,2022.0,565,873,-308
CA,CN,2015.0,553,494,59
nan,GB,2018.0,94,127,-33
MY,SG,2016.0,116,150,-34
BR,US,2010.0,885,966,-81
IR,GB,2018.0,120,101,19
BR,US,2017.0,1275,1388,-113
DE,EG,2002.0,17,15,2
JP,HK,2016.0,5,8,-3
CA,ES,2021.0,72,62,10
FR,ES,2016.0,296,383,-87
US,DK,2019.0,333,298,35
CA,IN,2006.0,119,194,-75
KR,DE,1999.0,14,16,-2
DE,BE,2004.0,81,83,-2
AR,US,2004.0,212,141,71
CL,AU,2011.0,11,8,3
CY,GB,2019.0,41,62,-21
CO,PY,2018.0,17,4,13
US,DK,2010.0,262,229,33
BE,ES,2011.0,54,60,-6
JP,GB,2002.0,236,234,2
US,EG,2021.0,277,254,23
BE,TW,2000.0,5,4,1
ES,TR,2022.0,8,11,-3
CH,ZA,2017.0,29,25,4
ZA,CH,2019.0,29,16,13
IT,UA,2009.0,11,7,4
US,MX,1999.0,142,143,-1
nan,ID,2019.0,121,73,48
BD,IN,2018.0,158,165,-7
NL,ES,2018.0,86,103,-17
ES,IS,2015.0,7,4,3
CN,FR,2003.0,169,240,-71
HR,DE,2018.0,24,23,1
US,IE,2016.0,545,492,53
FR,DE,1997.0,160,196,-36
DK,US,2021.0,225,308,-83
PK,KR,2017.0,57,49,8
JP,IT,2008.0,63,43,20
GB,IT,2010.0,347,456,-109
FR,GA,2014.0,12,7,5
CA,IT,2006.0,62,56,6
nan,FR,2007.0,166,174,-8
DE,OM,2009.0,4,1,3
TN,MA,2010.0,15,26,-11
BE,AU,2022.0,19,25,-6
DE,NL,2010.0,299,278,21
IN,JP,2003.0,114,96,18
PE,MX,2014.0,94,98,-4
FR,CU,2000.0,3,3,0
ES,PA,2007.0,10,4,6
IL,DE,2019.0,86,78,8
GR,JP,2001.0,34,50,-16
US,TW,2017.0,649,802,-153
IR,SE,2011.0,31,20,11
NL,CH,2022.0,79,73,6
nan,MY,2017.0,78,59,19
IT,GB,2006.0,309,289,20
IN,TR,2018.0,23,19,4
GB,PT,2022.0,62,74,-12
RO,DE,2011.0,28,28,0
DK,ES,2015.0,32,52,-20
JP,BH,2019.0,3,2,1
US,JM,2012.0,19,20,-1
FI,SE,2005.0,37,64,-27
GB,MY,2008.0,103,53,50
BE,FR,2003.0,145,205,-60
DE,IT,2003.0,129,145,-16
AU,CA,2011.0,308,355,-47
CL,SE,2016.0,9,8,1
DE,NL,2019.0,444,453,-9
GB,IT,2019.0,595,687,-92
PK,CN,2018.0,295,202,93
CL,PE,2019.0,110,66,44
JP,SK,2010.0,24,22,2
FR,IT,2007.0,264,254,10
BR,CA,2020.0,304,259,45
CH,IN,2003.0,14,19,-5
US,AT,2013.0,251,218,33
RU,GB,1998.0,44,47,-3
ST,BR,2015.0,45,27,18
IN,IT,2007.0,58,48,10
RU,HU,2012.0,14,8,6
NL,BE,2011.0,238,306,-68
US,RS,2014.0,75,62,13
ZA,CH,2017.0,25,29,-4
MX,IT,2017.0,39,47,-8
HU,PL,2018.0,34,35,-1
KR,CN,2020.0,320,296,24
IR,MY,2011.0,63,48,15
JP,UZ,2006.0,6,1,5
KR,BD,2018.0,37,36,1
GB,BE,2020.0,179,152,27
PT,CN,2000.0,4,4,0
DK,SE,2015.0,133,155,-22
DE,KR,2012.0,42,51,-9
PL,DE,2013.0,95,163,-68
CN,LT,2013.0,8,4,4
JP,CA,2018.0,110,109,1
IE,IN,2012.0,21,21,0
MA,DE,2015.0,4,4,0
NL,EG,2020.0,8,8,0
SG,NP,2020.0,4,1,3
KE,NO,2022.0,4,1,3
IL,DE,2017.0,74,65,9
US,LK,2016.0,38,25,13
CH,CZ,2013.0,27,26,1
RU,GB,1997.0,34,27,7
CN,PT,2011.0,4,7,-3
GB,IT,2017.0,477,706,-229
BG,RU,1999.0,13,6,7
TR,CN,2004.0,15,3,12
GB,NO,2013.0,109,72,37
CH,EE,2021.0,11,8,3
CU,CO,2020.0,41,33,8
IT,IN,2011.0,56,62,-6
BR,nan,2018.0,136,147,-11
SE,CO,2004.0,2,1,1
BE,CO,2012.0,10,4,6
CR,ZA,2009.0,1,1,0
HU,KE,2017.0,1,1,0
NO,IN,2018.0,21,81,-60
PT,CH,2020.0,26,25,1
EC,GR,2012.0,3,1,2
MX,PY,2020.0,19,15,4
TR,ZW,2017.0,1,1,0
LT,CN,2002.0,3,14,-11
US,JO,2008.0,65,25,40
GH,CN,2018.0,28,16,12
SE,RU,2009.0,17,29,-12
nan,MY,2019.0,57,77,-20
CA,GR,2019.0,14,13,1
PK,KR,2019.0,37,76,-39
PK,KG,2019.0,2,1,1
RU,PT,2018.0,18,10,8
US,FI,2018.0,147,176,-29
BR,JP,2018.0,64,67,-3
US,GE,1997.0,50,40,10
BE,NL,2018.0,280,287,-7
AR,nan,2000.0,13,8,5
CO,CA,2016.0,25,20,5
IN,GB,1999.0,125,98,27
GB,UG,2019.0,29,16,13
CH,CI,2017.0,2,2,0
FR,LB,2014.0,94,43,51
CH,NL,2005.0,73,69,4
US,PH,2000.0,189,187,2
GA,BF,2017.0,3,2,1
MY,YE,2019.0,20,8,12
JO,SA,2013.0,48,20,28
HR,RS,2014.0,141,92,49
DE,IL,2001.0,33,38,-5
DZ,IT,2016.0,32,40,-8
BE,PL,2015.0,21,18,3
HU,FR,2007.0,20,21,-1
PK,IN,2005.0,45,30,15
BD,NL,2013.0,4,5,-1
IN,KW,2017.0,15,9,6
AT,FR,2021.0,38,52,-14
AE,DE,2013.0,4,9,-5
GB,GM,2015.0,17,5,12
BD,AU,2012.0,46,18,28
PH,JP,2018.0,24,30,-6
nan,ID,2017.0,92,31,61
US,BO,2009.0,6,10,-4
LB,SY,2013.0,1,2,-1
SA,ID,2021.0,18,22,-4
PH,AU,2015.0,16,12,4
BR,DK,2018.0,35,26,9
CY,GB,2017.0,26,46,-20
MA,DZ,2017.0,24,24,0
DO,US,2011.0,3,1,2
EC,ES,2016.0,62,177,-115
TW,MX,2018.0,3,3,0
NL,IT,2009.0,57,81,-24
SV,US,2019.0,3,5,-2
IE,CA,2000.0,38,39,-1
CN,PK,2016.0,116,126,-10
CZ,ID,2009.0,3,1,2
IT,CA,1999.0,65,60,5
UA,US,2013.0,53,44,9
NL,GR,2013.0,21,22,-1
DE,MA,2018.0,7,7,0
BE,ZA,2014.0,14,24,-10
FR,NL,2011.0,168,162,6
SE,CN,1997.0,16,25,-9
HR,AT,2015.0,9,4,5
VN,JP,2022.0,35,32,3
AE,CA,2005.0,10,5,5
RU,KG,2021.0,16,4,12
BD,IT,2020.0,9,7,2
IQ,MY,2021.0,40,69,-29
AR,CO,2020.0,92,133,-41
NL,ID,2014.0,30,20,10
IN,CH,2011.0,41,21,20
PA,RU,2018.0,1,1,0
HR,US,1999.0,16,23,-7
CN,TH,2008.0,7,15,-8
NZ,DE,2005.0,17,28,-11
IQ,VN,2022.0,1,1,0
GH,nan,2017.0,5,5,0
CZ,AU,2021.0,1,6,-5
AT,JP,2012.0,13,18,-5
NG,GB,2016.0,72,89,-17
CA,ZA,2020.0,46,53,-7
DE,EE,2021.0,39,31,8
FI,PT,2021.0,2,1,1
SN,FR,2001.0,17,14,3
TN,SA,2012.0,36,7,29
IS,PT,2017.0,2,1,1
PK,MY,2021.0,77,88,-11
ZA,DE,2020.0,61,64,-3
GH,CA,2021.0,13,5,8
DE,SG,2001.0,10,11,-1
ES,BE,2004.0,23,25,-2
DE,SK,2016.0,31,39,-8
CH,CI,2019.0,5,2,3
PL,CH,2000.0,9,12,-3
RU,MY,2020.0,11,21,-10
US,GA,2018.0,3,1,2
BR,ID,2016.0,20,7,13
UA,BY,2020.0,21,19,2
SI,DE,2014.0,21,15,6
RS,TR,2003.0,35,33,2
nan,TW,2008.0,5,6,-1
IQ,IR,2018.0,8,16,-8
DK,IT,2023.0,3,1,2
EE,RU,2005.0,6,1,5
BE,RU,2000.0,9,14,-5
TW,GB,2002.0,42,34,8
FR,GP,2021.0,19,20,-1
IN,KW,2019.0,17,12,5
MW,GB,2021.0,18,24,-6
CN,UA,2022.0,16,14,2
KW,PK,2016.0,4,1,3
TH,CN,2022.0,36,42,-6
US,SI,2021.0,15,18,-3
GH,nan,2019.0,5,6,-1
CN,KZ,2022.0,7,8,-1
ZA,RW,2017.0,12,3,9
KE,ZA,2022.0,20,6,14
CH,GB,2022.0,170,231,-61
US,NZ,2000.0,173,172,1
OM,QA,2019.0,9,3,6
RU,UA,2018.0,515,681,-166
AR,ES,2006.0,214,171,43
FI,CN,2003.0,11,9,2
NL,RU,2016.0,66,55,11
CL,DE,2008.0,29,24,5
HU,CN,2010.0,10,6,4
KR,IR,2013.0,6,15,-9
RO,MD,2021.0,16,12,4
KR,VN,2022.0,60,56,4
TN,IT,2019.0,25,17,8
BR,PK,2019.0,10,3,7
BE,PH,2020.0,3,5,-2
KR,MX,2015.0,6,6,0
US,NP,2013.0,40,51,-11
GB,DK,2009.0,117,92,25
GB,BD,2006.0,27,22,5
TN,MA,2017.0,38,41,-3
CA,AR,2011.0,21,18,3
AE,DZ,2019.0,1,3,-2
CZ,IN,2015.0,16,15,1
PY,BR,2002.0,5,1,4
MX,RU,2009.0,12,9,3
TR,FR,2021.0,21,18,3
GB,ES,1998.0,99,122,-23
SK,DE,2012.0,37,35,2
PL,FR,2007.0,49,39,10
NL,TR,2008.0,16,29,-13
DE,ET,2011.0,6,7,-1
SG,FR,2016.0,23,45,-22
RS,IL,2005.0,3,1,2
HN,MX,2019.0,28,19,9
TZ,US,2003.0,3,6,-3
GB,CZ,2005.0,16,20,-4
IE,KW,2020.0,1,2,-1
FR,BI,2010.0,30,19,11
HU,DE,2008.0,57,50,7
FR,BI,2019.0,23,25,-2
JP,HU,2016.0,7,10,-3
KZ,TR,2016.0,59,46,13
GB,BG,2014.0,19,12,7
NO,ZA,2008.0,5,5,0
SG,IE,2015.0,6,7,-1
ES,DK,2014.0,41,27,14
IN,ML,2022.0,6,2,4
HU,SK,2016.0,14,11,3
QA,TN,2022.0,4,7,-3
TR,TH,2002.0,2,1,1
FR,RE,2021.0,50,31,19
DK,GR,2021.0,9,8,1
TH,US,2005.0,82,137,-55
AU,SG,2008.0,77,64,13
PT,IT,2005.0,13,13,0
GR,KZ,2017.0,3,1,2
DE,QA,2011.0,7,4,3
EG,IR,2020.0,16,27,-11
TN,BH,2022.0,1,3,-2
JP,US,2023.0,63,55,8
CH,ES,2016.0,85,138,-53
SA,PK,2003.0,9,5,4
BD,FI,2014.0,2,3,-1
KR,SE,2021.0,16,5,11
IN,AE,2016.0,69,55,14
JP,DZ,2020.0,1,1,0
VE,PA,2015.0,5,2,3
PK,GB,2016.0,106,187,-81
NZ,BR,2010.0,5,10,-5
ZA,NZ,2020.0,26,17,9
HU,FI,2012.0,11,5,6
IR,CY,2020.0,9,3,6
EG,QA,2009.0,13,6,7
RO,IR,2021.0,1,1,0
MX,IT,2019.0,38,50,-12
CA,FI,2020.0,24,21,3
BR,NI,2017.0,2,5,-3
SG,BR,2015.0,4,6,-2
AU,RO,2018.0,2,2,0
ZA,SA,1999.0,1,1,0
CZ,SE,2021.0,12,17,-5
RU,BR,2009.0,14,4,10
TZ,SE,2016.0,2,3,-1
MA,CM,2020.0,3,1,2
NL,AT,2013.0,22,28,-6
IR,CN,2022.0,36,15,21
IN,OM,2015.0,29,21,8
TR,PL,2015.0,5,4,1
AE,EG,2003.0,3,13,-10
IE,BR,2001.0,1,1,0
TW,AU,2006.0,12,14,-2
IN,SK,2014.0,2,2,0
DK,IR,2018.0,15,30,-15
CH,ZA,2019.0,16,29,-13
AT,TH,2012.0,10,2,8
JP,LT,2009.0,6,28,-22
ES,CZ,2000.0,3,3,0
CZ,HR,2020.0,16,6,10
NO,BD,2013.0,6,2,4
HU,CN,2019.0,8,5,3
IT,AR,2009.0,60,70,-10
SA,IN,2014.0,53,125,-72
IN,KW,2010.0,8,7,1
MY,FR,2002.0,3,4,-1
NL,DK,2014.0,49,37,12
LB,CN,2021.0,7,22,-15
FR,CG,2004.0,12,8,4
HR,CZ,2017.0,5,13,-8
BA,US,2011.0,5,10,-5
IN,SA,2023.0,9,10,-1
CA,RO,2004.0,2,7,-5
RO,CA,2007.0,4,10,-6
DK,IN,2004.0,7,6,1
CZ,IT,2015.0,20,28,-8
MC,FR,2005.0,2,6,-4
UG,SE,2018.0,4,2,2
CZ,JP,2013.0,6,22,-16
SA,IR,2020.0,16,12,4
US,AM,2018.0,15,9,6
FR,DZ,2001.0,27,22,5
RS,HR,2003.0,22,26,-4
JP,LK,2020.0,22,14,8
CZ,GB,2006.0,29,30,-1
PK,TW,2020.0,3,4,-1
TH,NP,2013.0,5,2,3
JP,TW,2005.0,50,45,5
US,KE,2011.0,49,46,3
GB,ES,1997.0,80,69,11
SY,EG,2012.0,3,4,-1
CM,US,2019.0,20,21,-1
PT,PL,2015.0,8,5,3
BD,BN,2017.0,3,3,0
DE,EG,2005.0,36,15,21
CI,IT,2019.0,1,1,0
SK,PL,2022.0,6,1,5
nan,HU,2006.0,6,1,5
PH,CA,2008.0,6,6,0
TR,KE,2021.0,2,1,1
HK,JP,2020.0,14,15,-1
FI,JP,2018.0,18,16,2
NZ,ES,2003.0,2,1,1
MY,YE,2017.0,20,9,11
NO,RO,2020.0,6,6,0
DE,nan,1999.0,18,8,10
RU,BY,1999.0,18,8,10
TH,US,2002.0,54,96,-42
CH,AM,2017.0,2,1,1
TW,BE,2020.0,11,4,7
FR,CI,2000.0,6,7,-1
US,TN,2013.0,19,17,2
SE,CN,1998.0,28,34,-6
UG,KE,2022.0,15,14,1
JP,NO,2022.0,8,3,5
TN,MA,2019.0,36,48,-12
US,VE,2005.0,42,56,-14
IN,AT,2004.0,43,2,41
GB,HU,2011.0,44,71,-27
FI,FR,2022.0,19,15,4
AR,IL,2013.0,4,4,0
MX,BE,2012.0,14,7,7
IT,BE,2021.0,134,101,33
MY,JP,1998.0,7,11,-4
CH,nan,2022.0,11,7,4
PT,BG,2003.0,3,4,-1
ES,PY,2018.0,36,8,28
EG,SA,2008.0,96,65,31
HR,CZ,2019.0,15,8,7
AT,IT,2013.0,40,53,-13
LV,DE,2005.0,3,2,1
LT,BE,2016.0,3,1,2
RO,AU,2021.0,7,5,2
ID,RU,2014.0,5,2,3
OM,IN,2021.0,11,23,-12
GB,HR,2022.0,11,4,7
EE,SE,2022.0,7,5,2
TW,HR,2003.0,1,3,-2
UA,nan,2001.0,5,11,-6
CZ,GR,2015.0,5,12,-7
HN,MX,2017.0,30,12,18
nan,NZ,2010.0,38,3,35
IE,CL,2013.0,2,1,1
JM,BB,2017.0,3,4,-1
QA,AU,2012.0,11,6,5
SA,SD,2008.0,4,6,-2
CA,QA,2015.0,18,11,7
ZA,IL,2021.0,2,4,-2
TR,MX,2016.0,2,1,1
US,CY,2003.0,11,5,6
US,VE,2002.0,35,43,-8
FR,ZA,2020.0,42,43,-1
RU,SK,2011.0,11,17,-6
IT,IR,2012.0,14,27,-13
NZ,DE,2002.0,10,15,-5
CN,NP,2012.0,24,17,7
DE,BA,2005.0,2,1,1
DK,nan,2013.0,18,22,-4
QA,DE,2020.0,5,6,-1
QA,US,1999.0,7,6,1
GB,MT,2005.0,5,3,2
GB,SA,2008.0,40,27,13
DE,PK,2012.0,33,19,14
UZ,JP,2004.0,1,3,-2
nan,BE,2021.0,11,15,-4
PK,BD,2005.0,6,5,1
FR,VN,2021.0,39,31,8
EG,FR,2006.0,4,6,-2
SE,AE,2017.0,7,2,5
IN,PT,2011.0,16,7,9
DK,NL,2000.0,12,18,-6
nan,NO,2001.0,14,12,2
NG,ZA,2008.0,14,6,8
ZA,CH,2010.0,11,16,-5
UG,IT,2019.0,7,2,5
NO,AU,2016.0,15,31,-16
TH,IN,2013.0,8,8,0
CA,AE,2001.0,7,2,5
RU,NL,1999.0,20,13,7
HK,RO,2013.0,36,11,25
nan,IL,2004.0,16,17,-1
SG,BE,2017.0,4,8,-4
SA,JO,2009.0,6,19,-13
PA,MX,1999.0,2,2,0
BR,RU,2012.0,14,11,3
MY,BN,2022.0,9,4,5
CZ,SI,2016.0,11,6,5
MY,FR,2005.0,8,4,4
LS,ZA,2011.0,5,2,3
US,IS,2011.0,14,17,-3
nan,ID,2010.0,4,4,0
HN,MX,2010.0,26,15,11
FI,AU,2003.0,7,9,-2
RO,HU,2011.0,30,19,11
PK,IN,2002.0,13,23,-10
SE,GR,2001.0,9,2,7
IQ,US,2016.0,22,59,-37
SE,FR,2003.0,44,48,-4
KR,BE,2003.0,4,4,0
CN,PH,2015.0,18,23,-5
IT,LU,2011.0,7,1,6
US,KZ,2006.0,8,7,1
PK,DE,2013.0,15,38,-23
SE,EC,2020.0,3,1,2
CH,FI,2020.0,26,31,-5
PT,IT,2002.0,7,15,-8
NL,CL,2001.0,2,1,1
HU,PT,2011.0,3,2,1
nan,PT,2004.0,7,7,0
RU,SE,2004.0,37,18,19
nan,CZ,2018.0,9,10,-1
NZ,FJ,2005.0,1,1,0
KR,nan,2007.0,13,9,4
NP,CA,2012.0,2,3,-1
KR,ES,2008.0,1,5,-4
IN,NG,2016.0,24,21,3
SE,RS,2016.0,4,8,-4
nan,NZ,2019.0,9,4,5
DE,UA,2015.0,25,35,-10
CH,SK,2018.0,9,12,-3
GR,SE,2011.0,24,6,18
MZ,RU,2017.0,16,8,8
ES,PS,2013.0,6,13,-7
SE,LV,1997.0,3,2,1
PL,HU,1999.0,10,3,7
CR,CA,1998.0,1,1,0
GB,PK,2003.0,23,24,-1
FR,KE,2013.0,9,2,7
BE,IN,2022.0,18,30,-12
CN,BR,2012.0,63,45,18
AR,PE,2007.0,10,12,-2
IL,TR,2020.0,4,2,2
SG,AU,2001.0,20,34,-14
MK,US,2020.0,4,8,-4
HU,CN,2017.0,6,6,0
CN,DZ,2020.0,11,2,9
VN,TW,2014.0,10,19,-9
CO,CN,2006.0,4,1,3
BO,CN,2005.0,5,4,1
UZ,KG,2021.0,3,4,-1
VN,FR,2012.0,23,26,-3
JP,SK,2017.0,6,10,-4
RU,PK,2018.0,10,2,8
OM,GB,2020.0,11,25,-14
LY,IE,2020.0,2,2,0
NL,JP,1997.0,21,15,6
MY,MM,2015.0,2,5,-3
FJ,AU,2020.0,7,11,-4
QA,EG,2013.0,15,21,-6
IE,MT,2012.0,2,1,1
UG,MY,2014.0,1,2,-1
PA,BR,2016.0,2,7,-5
EG,SY,2017.0,5,3,2
RO,TR,2020.0,2,4,-2
TH,GB,2004.0,18,53,-35
DE,PA,2014.0,6,3,3
GR,RU,2000.0,1,5,-4
CH,RS,2005.0,4,5,-1
BJ,TG,2019.0,2,1,1
TR,CH,2014.0,18,20,-2
IE,PA,2015.0,2,1,1
nan,MY,2010.0,38,12,26
DE,BY,2004.0,7,8,-1
CH,ZA,2010.0,16,11,5
BE,SK,2006.0,4,3,1
CH,DK,2006.0,17,21,-4
UZ,US,2019.0,3,8,-5
DE,BJ,2011.0,2,1,1
CY,GR,2014.0,30,61,-31
FR,BI,2017.0,20,22,-2
MA,DZ,2019.0,25,39,-14
TW,SE,2011.0,5,4,1
RO,IL,2021.0,2,5,-3
SD,PK,2017.0,4,1,3
BR,CN,2005.0,17,21,-4
BE,nan,2008.0,21,21,0
PS,ES,2008.0,7,4,3
PT,DE,2004.0,17,14,3
MY,nan,2003.0,12,3,9
MX,CN,2021.0,5,11,-6
CZ,DE,2003.0,31,30,1
QA,ID,2022.0,2,3,-1
MA,DZ,2010.0,8,8,0
DK,EE,2021.0,6,3,3
NO,BG,2014.0,4,4,0
LY,US,2014.0,4,3,1
CA,PA,2015.0,7,2,5
EG,NG,2014.0,4,5,-1
GH,KE,2018.0,7,5,2
JP,SK,2019.0,4,4,0
UG,IR,2013.0,1,1,0
LK,IE,2011.0,2,1,1
UA,MX,2012.0,4,4,0
ID,IL,2022.0,2,3,-1
MK,ID,2012.0,2,2,0
GB,CR,2013.0,4,7,-3
IN,SG,2009.0,51,45,6
RS,IT,2004.0,3,3,0
AR,PL,2018.0,1,2,-1
CA,PL,2005.0,14,20,-6
US,MK,2004.0,4,5,-1
IS,NO,2014.0,8,7,1
CY,GB,2010.0,13,32,-19
MX,JP,2014.0,8,13,-5
CL,CA,2011.0,22,16,6
DZ,CA,2006.0,9,2,7
CO,nan,2014.0,4,7,-3
MX,IT,2010.0,26,24,2
BE,AR,2005.0,3,6,-3
BE,HU,2002.0,5,12,-7
RU,IR,2015.0,9,14,-5
UG,NO,2011.0,3,3,0
AE,IT,2022.0,6,8,-2
RU,IN,1999.0,8,7,1
TW,FI,2016.0,3,3,0
BR,PK,2017.0,9,5,4
AU,FI,2007.0,11,6,5
UA,BG,2013.0,8,5,3
IT,MY,2023.0,8,4,4
CA,BG,2013.0,4,4,0
GM,AU,2020.0,1,1,0
BE,BI,2014.0,1,1,0
GR,IT,2001.0,7,9,-2
NG,BR,2010.0,1,3,-2
FI,nan,2020.0,14,8,6
CH,VN,2011.0,3,2,1
AM,GB,2011.0,4,2,2
BE,SA,2018.0,3,3,0
NL,SK,1997.0,5,3,2
TR,UA,2020.0,6,1,5
GH,IN,2009.0,4,1,3
US,GN,2022.0,1,4,-3
MX,GB,2012.0,44,79,-35
TZ,JP,2019.0,5,5,0
IN,RW,2016.0,5,19,-14
DK,BE,2012.0,13,33,-20
NZ,PT,2021.0,1,2,-1
FI,PL,2014.0,8,5,3
BR,VE,2002.0,8,8,0
MY,CU,2014.0,1,2,-1
DK,JP,2018.0,16,16,0
AU,PT,2012.0,9,10,-1
MY,TW,2011.0,10,19,-9
LK,ET,2014.0,3,1,2
SE,IN,1998.0,4,9,-5
IN,QA,2011.0,8,6,2
GR,SG,2008.0,3,2,1
GB,CU,2013.0,4,6,-2
SG,VN,2012.0,8,4,4
CN,MG,2011.0,6,1,5
KR,NZ,2012.0,7,8,-1
US,FJ,2005.0,7,3,4
JO,IN,2018.0,3,1,2
PT,MX,2006.0,6,12,-6
AT,AR,2007.0,2,4,-2
FR,BJ,2021.0,17,19,-2
KR,AT,2014.0,7,5,2
GH,NO,2021.0,3,2,1
PT,KR,2010.0,3,5,-2
US,DZ,2009.0,17,11,6
AE,NG,2017.0,1,1,0
ET,PR,2016.0,8,10,-2
PT,AU,2006.0,8,1,7
JM,BB,2019.0,8,5,3
BR,PE,2003.0,7,1,6
BR,ST,2013.0,27,34,-7
RU,SG,2010.0,4,1,3
MC,FR,2002.0,2,5,-3
SI,CH,2012.0,8,2,6
IE,NG,2013.0,3,2,1
PH,ES,2006.0,9,6,3
TN,IT,2010.0,5,7,-2
AU,MM,2019.0,10,1,9
SK,IT,2009.0,8,3,5
SE,TH,2012.0,4,3,1
CM,US,2017.0,16,17,-1
IN,PH,2009.0,9,12,-3
UY,CR,2016.0,4,1,3
UA,IN,2014.0,6,6,0
AM,US,2016.0,17,17,0
CO,BO,2011.0,4,7,-3
IE,IR,2020.0,9,27,-18
CH,NO,2004.0,16,6,10
CN,HU,2002.0,2,4,-2
UA,MY,2012.0,2,1,1
PL,JP,2003.0,12,17,-5
VE,CH,2015.0,2,1,1
KE,JP,2006.0,4,5,-1
EG,NZ,2015.0,5,1,4
FR,CD,2017.0,2,1,1
AL,FR,2016.0,3,2,1
CO,AT,2018.0,1,3,-2
KW,IN,2015.0,12,10,2
BD,IQ,2019.0,10,3,7
IQ,IN,2021.0,13,12,1
HR,FI,2021.0,6,1,5
HR,IT,2016.0,9,10,-1
AE,NG,2019.0,4,1,3
RU,KR,2012.0,10,8,2
ES,ID,2004.0,3,4,-1
US,BY,2013.0,12,10,2
GB,RW,2014.0,4,1,3
BR,CN,2002.0,10,5,5
HU,ES,2015.0,4,10,-6
NO,CZ,2011.0,13,7,6
CL,SG,2016.0,2,1,1
DK,SA,2011.0,2,1,1
KE,FR,2007.0,4,2,2
JP,PH,2011.0,24,9,15
PE,GB,2014.0,9,11,-2
VN,GB,2000.0,2,2,0
ET,CN,2001.0,3,2,1
ES,HR,2012.0,4,2,2
SG,MY,2003.0,15,10,5
CH,RS,2002.0,3,3,0
SK,JP,1997.0,2,12,-10
GB,CZ,2002.0,13,11,2
NZ,KR,2022.0,8,9,-1
US,GM,2000.0,1,1,0
TZ,JP,2017.0,1,1,0
IE,ID,2022.0,1,6,-5
NL,ML,2019.0,1,1,0
US,ZW,2004.0,5,9,-4
BR,VE,2005.0,10,10,0
HU,MY,2016.0,1,1,0
EE,IN,2018.0,6,4,2
CA,SK,2007.0,3,8,-5
RU,CH,2023.0,3,4,-1
NO,SE,2001.0,20,43,-23
VN,BY,2007.0,3,1,2
SA,TR,2005.0,5,1,4
JP,GH,2018.0,5,3,2
SA,TR,2002.0,3,4,-1
BN,AU,1999.0,1,2,-1
CH,SI,2014.0,7,3,4
TZ,JP,2010.0,1,4,-3
ET,KE,2011.0,3,5,-2
GR,IE,2011.0,1,5,-4
CM,US,2010.0,9,7,2
ZA,ZM,2015.0,8,6,2
IT,RO,2018.0,15,16,-1
NO,IS,2004.0,2,4,-2
GR,VN,2010.0,4,5,-1
MY,CM,2017.0,2,2,0
JP,NL,2022.0,16,14,2
US,NI,2022.0,4,2,2
AT,ES,2022.0,13,22,-9
RU,AT,2016.0,23,8,15
AU,TR,2000.0,3,1,2
ET,IT,2021.0,3,4,-1
DE,MG,2013.0,3,1,2
CH,AM,2019.0,3,1,2
GH,nan,2010.0,1,2,-1
AT,IN,2003.0,11,32,-21
JP,RU,2000.0,26,33,-7
ES,KE,2012.0,1,1,0
SN,CH,2017.0,3,3,0
IR,BY,2018.0,1,3,-2
AO,BR,2009.0,22,11,11
SA,AT,2022.0,3,1,2
NL,GH,2013.0,7,3,4
ZA,LS,2019.0,10,5,5
GB,BA,2018.0,5,5,0
NZ,FI,2003.0,2,2,0
JP,PL,2023.0,1,1,0
IL,KR,2014.0,5,3,2
EC,PH,2020.0,4,2,2
PH,IN,2016.0,25,17,8
PA,ES,1999.0,4,2,2
UA,EC,2007.0,13,11,2
NO,PH,2004.0,1,2,-1
CN,NZ,2006.0,14,22,-8
TR,MA,2017.0,1,2,-1
KW,SA,2008.0,3,2,1
MY,AR,1997.0,3,2,1
HU,JP,2011.0,10,7,3
CA,CI,2012.0,4,1,3
DE,VE,2011.0,4,7,-3
AU,TW,2008.0,26,35,-9
SK,MX,2021.0,2,1,1
US,BA,2013.0,4,5,-1
QA,KR,2014.0,2,1,1
BF,BE,2008.0,2,2,0
NO,RS,2009.0,1,1,0
TW,IT,2006.0,1,4,-3
ZA,TW,2016.0,3,3,0
LB,DE,2014.0,6,7,-1
GB,GH,2000.0,3,2,1
AF,PK,2019.0,1,5,-4
BR,BG,2012.0,1,4,-3
NZ,PK,2012.0,7,7,0
MY,YE,2010.0,5,5,0
MN,JP,2004.0,1,3,-2
AE,CA,2002.0,3,6,-3
PH,GB,2016.0,9,23,-14
KR,NG,2020.0,6,8,-2
EG,SY,2019.0,6,6,0
AU,BH,2015.0,1,1,0
BE,VN,2009.0,3,1,2
CA,GR,2017.0,15,19,-4
RO,RU,2014.0,7,4,3
EE,FR,2009.0,10,2,8
AT,RU,2009.0,8,25,-17
SD,QA,2021.0,4,1,3
SG,AT,2019.0,2,7,-5
BR,TW,2004.0,2,2,0
IL,PS,2012.0,5,1,4
LK,CN,2003.0,2,2,0
CA,HR,1999.0,6,1,5
GA,BF,2019.0,2,3,-1
PH,KH,2006.0,1,1,0
KE,nan,2016.0,1,4,-3
nan,GP,2007.0,1,1,0
DE,AE,2015.0,10,4,6
ID,NG,2013.0,3,4,-1
CA,HK,2006.0,1,2,-1
RU,SG,2019.0,7,8,-1
AT,LB,2019.0,1,2,-1
US,MD,2013.0,3,7,-4
PT,SK,2017.0,2,1,1
nan,NG,2018.0,3,10,-7
FR,PY,2017.0,2,1,1
TR,BD,2020.0,3,1,2
CN,NG,2012.0,6,5,1
GB,LT,1999.0,2,2,0
GB,IQ,2013.0,30,9,21
GB,UG,2010.0,9,6,3
CZ,HU,2009.0,3,4,-1
BE,PT,2021.0,18,11,7
PE,NZ,2022.0,2,1,1
PK,FI,2015.0,7,2,5
VE,CU,1998.0,4,3,1
PS,GB,2007.0,1,3,-2
BE,KE,2000.0,1,4,-3
SE,PA,2011.0,1,3,-2
PH,KR,2003.0,2,1,1
PK,KR,2010.0,4,10,-6
EC,GB,2013.0,2,3,-1
GB,FI,2023.0,5,6,-1
PT,SK,2019.0,3,1,2
CY,CN,2021.0,2,2,0
TZ,NO,2016.0,5,4,1
ID,JO,2021.0,8,2,6
IR,PL,2012.0,2,1,1
TR,BA,2006.0,1,1,0
LT,CN,2005.0,6,2,4
CH,KR,1999.0,1,4,-3
ID,BR,2011.0,3,2,1
CU,CN,2020.0,6,2,4
SI,BY,2015.0,2,1,1
TN,IT,2017.0,23,15,8
MN,KR,2019.0,4,15,-11
EG,AT,2014.0,6,7,-1
HN,ES,2003.0,3,3,0
CZ,MK,2019.0,1,1,0
DK,IL,2020.0,3,10,-7
BW,KE,2007.0,1,2,-1
AU,GR,2009.0,4,5,-1
AR,JP,1997.0,3,2,1
PS,TR,2017.0,2,2,0
UA,PL,1999.0,8,4,4
CA,TR,2004.0,9,12,-3
KE,MX,2019.0,3,2,1
TH,NZ,2001.0,3,2,1
BE,AM,2012.0,2,1,1
NO,SJ,2002.0,2,2,0
IT,KE,2012.0,4,6,-2
PL,PK,2004.0,3,3,0
EG,LB,2006.0,2,4,-2
BW,GB,2016.0,2,8,-6
ZW,CH,2007.0,2,3,-1
UG,NL,2020.0,2,8,-6
MX,ZA,2010.0,3,1,2
AU,PG,2007.0,2,7,-5
PL,RO,2023.0,2,2,0
KR,AE,2016.0,5,2,3
TR,IE,2005.0,3,1,2
JO,BR,2011.0,1,1,0
RO,CH,2016.0,8,14,-6
GR,MX,2014.0,3,5,-2
IR,NG,2011.0,2,5,-3
RS,CN,2008.0,1,9,-8
IT,HR,1999.0,1,3,-2
IQ,AU,2017.0,5,16,-11
US,TT,2006.0,4,4,0
LT,FR,2007.0,3,1,2
MY,CM,2019.0,4,3,1
RU,IE,2013.0,2,9,-7
SY,GR,2017.0,1,1,0
TN,CZ,2020.0,3,3,0
GB,BW,2021.0,3,6,-3
SY,US,1999.0,3,2,1
nan,CU,2017.0,3,3,0
AZ,RU,2009.0,3,6,-3
NL,KE,2007.0,4,2,2
SK,RU,2004.0,7,4,3
CO,IE,2014.0,4,5,-1
IS,ES,2014.0,4,7,-3
PL,GE,2002.0,1,1,0
PY,VE,2020.0,1,2,-1
NO,UG,2021.0,5,2,3
CZ,IE,2008.0,1,1,0
JP,IR,2022.0,2,5,-3
SG,BE,2019.0,2,3,-1
nan,ET,2021.0,2,1,1
MW,TW,2019.0,1,1,0
HU,AU,2022.0,5,8,-3
NG,IN,2000.0,4,2,2
SE,AE,2010.0,3,3,0
FR,KH,2014.0,6,4,2
HN,US,2016.0,2,2,0
US,MN,2011.0,2,6,-4
CN,AT,2023.0,3,1,2
NL,ML,2010.0,1,1,0
FJ,PK,2014.0,1,2,-1
FR,MY,2006.0,6,4,2
RU,SG,2017.0,12,12,0
MW,US,1998.0,1,4,-3
BG,SK,2001.0,1,1,0
CA,GR,2010.0,5,15,-10
DK,HU,2019.0,5,8,-3
IE,ZA,2017.0,8,14,-6
LT,DE,2008.0,6,10,-4
TR,MA,2019.0,2,1,1
CA,IQ,2023.0,1,1,0
GB,BN,2015.0,8,3,5
TR,DK,2008.0,1,1,0
CH,IL,2003.0,4,17,-13
GB,KZ,2001.0,1,2,-1
PK,RS,2014.0,3,4,-1
IR,AZ,2015.0,2,2,0
SG,ES,2007.0,4,1,3
CA,IS,2011.0,1,1,0
SA,BH,2007.0,2,2,0
NG,nan,2013.0,3,4,-1
AU,EC,2013.0,1,1,0
VE,BR,1998.0,7,2,5
KG,TR,2015.0,5,1,4
EG,SY,2010.0,3,2,1
SK,nan,2013.0,2,2,0
ZA,ET,2011.0,2,5,-3
CN,HU,2005.0,5,6,-1
US,UZ,2019.0,8,3,5
VE,PL,2015.0,1,3,-2
BH,EG,2014.0,3,4,-1
ZA,LS,2017.0,3,2,1
SY,CA,2019.0,1,1,0
HU,IE,2015.0,5,5,0
DE,SA,2022.0,13,21,-8
IE,ZA,2019.0,9,12,-3
GH,CH,2016.0,2,2,0
PL,CL,2011.0,3,5,-2
IQ,AU,2019.0,13,30,-17
RS,DK,2015.0,4,1,3
KR,TH,2008.0,9,2,7
UA,KZ,2006.0,2,1,1
SE,IN,1997.0,3,6,-3
LB,JO,2020.0,6,7,-1
ZW,BH,2018.0,4,2,2
ZM,CN,2015.0,1,3,-2
CI,UG,2012.0,1,1,0
CA,GD,2012.0,2,2,0
CI,US,2022.0,3,1,2
FR,BD,2007.0,1,1,0
SI,AT,2005.0,3,5,-2
HU,HR,2010.0,1,1,0
UA,CH,2014.0,10,4,6
TR,AL,2018.0,1,1,0
nan,NP,2019.0,2,3,-1
ML,TG,2014.0,1,2,-1
SE,BY,2017.0,1,2,-1
GR,MK,2004.0,4,1,3
NP,PH,2014.0,2,1,1
US,RW,2014.0,6,8,-2
FR,JP,2023.0,6,7,-1
BR,KW,2018.0,1,1,0
nan,LU,2007.0,1,4,-3
MX,GT,2004.0,4,4,0
IE,ZA,2010.0,8,6,2
DK,IS,1999.0,2,1,1
AR,TR,2010.0,1,1,0
LK,CH,2011.0,1,2,-1
AT,FI,1997.0,1,4,-3
TW,IR,2020.0,1,9,-8
SK,CH,2005.0,7,5,2
CZ,KR,2002.0,3,1,2
BE,HU,2005.0,7,6,1
CA,MT,2017.0,2,4,-2
CM,BR,2014.0,1,1,0
HT,US,2009.0,2,4,-2
MY,JP,1997.0,1,1,0
OM,QA,2010.0,2,1,1
BG,AT,2007.0,1,2,-1
CA,LU,2013.0,3,6,-3
DE,BW,2007.0,1,2,-1
ZW,CA,2015.0,1,1,0
MY,AR,1998.0,1,3,-2
UZ,IT,2010.0,2,1,1
SI,HR,2007.0,8,7,1
RE,CA,2015.0,2,1,1
DZ,PK,2019.0,5,1,4
KE,MX,2017.0,2,4,-2
ZA,BF,2016.0,1,2,-1
PL,BG,2006.0,3,4,-1
LT,CZ,2010.0,4,32,-28
EG,IT,2011.0,8,9,-1
MA,HU,2010.0,3,3,0
BY,BR,2008.0,1,1,0
KW,BD,2015.0,5,1,4
SY,CA,2010.0,3,1,2
BE,NZ,2014.0,4,7,-3
PK,BD,2002.0,3,4,-1
DE,MK,2011.0,2,2,0
CZ,UA,2006.0,4,5,-1
IQ,CA,2020.0,3,15,-12
GE,AZ,2013.0,3,7,-4
MX,ZA,2019.0,1,2,-1
TW,BD,2011.0,4,2,2
NL,MA,2014.0,2,1,1
CL,CH,2008.0,4,7,-3
PL,PT,2013.0,4,4,0
BE,NG,2021.0,3,4,-1
BF,ZA,2018.0,1,2,-1
VN,GR,2009.0,10,3,7
NL,CY,2018.0,2,3,-1
ES,GR,2004.0,4,8,-4
SG,BE,2010.0,3,4,-1
MA,HU,2017.0,1,5,-4
BR,PK,2010.0,2,3,-1
GB,CM,2020.0,4,10,-6
ID,DZ,2022.0,2,3,-1
VE,BR,1997.0,1,2,-1
ML,CI,2020.0,2,8,-6
IN,YE,2021.0,8,3,5
HK,MY,2022.0,1,1,0
JP,HR,2016.0,2,2,0
IR,PK,2023.0,1,1,0
AM,AU,2008.0,2,1,1
IQ,AU,2010.0,1,1,0
CH,AM,2010.0,1,3,-2
PY,ES,2012.0,4,3,1
AR,JP,1998.0,4,2,2
PK,AR,2022.0,1,1,0
IL,FI,2012.0,3,2,1
IE,CZ,2000.0,1,2,-1
TR,QA,2013.0,3,2,1
KE,AU,2015.0,6,6,0
MX,PT,2022.0,6,10,-4
KH,KR,2014.0,1,2,-1
BO,AR,2021.0,4,3,1
AU,MN,2018.0,3,3,0
SV,US,2010.0,2,2,0
GR,AU,2003.0,3,1,2
BR,SK,2013.0,5,3,2
QA,MY,2021.0,5,9,-4
MA,AU,2019.0,2,2,0
DE,SL,2018.0,1,1,0
IS,KE,2014.0,1,1,0
BA,TR,2006.0,1,1,0
RS,NO,2020.0,3,1,2
BJ,CG,2021.0,2,2,0
GH,KR,2013.0,1,2,-1
MX,FI,2008.0,2,1,1
EG,CL,2020.0,1,1,0
BR,IE,2003.0,4,2,2
CR,CL,2002.0,4,2,2
CL,CN,2001.0,3,3,0
BO,CN,2002.0,3,1,2
NZ,BR,2017.0,1,13,-12
DK,RS,2012.0,4,2,2
FR,CD,2019.0,8,7,1
HU,HR,2017.0,4,3,1
PE,GT,2018.0,1,2,-1
AT,ID,2015.0,7,2,5
PT,LU,2019.0,1,4,-3
BE,MG,2022.0,1,1,0
nan,VE,2002.0,2,1,1
SN,MA,2016.0,2,1,1
LT,SE,1999.0,1,2,-1
CN,OM,2018.0,2,2,0
TN,EG,2007.0,3,1,2
AU,RS,2007.0,5,5,0
MA,IN,2003.0,1,1,0
OM,QA,2017.0,5,2,3
CN,TR,1998.0,2,2,0
ES,PL,2007.0,14,7,7
RU,PA,2015.0,1,1,0
NP,ET,2021.0,1,1,0
JM,BB,2010.0,7,6,1
PL,GE,2005.0,1,1,0
GB,UY,2016.0,4,4,0
DK,HU,2010.0,1,2,-1
BJ,DE,1999.0,2,4,-2
BE,AE,2019.0,2,1,1
RO,DK,2005.0,2,1,1
QA,HU,2019.0,1,1,0
AR,PK,2004.0,2,4,-2
LI,DE,2014.0,2,5,-3
AT,ZA,2013.0,3,6,-3
RO,NL,1999.0,2,2,0
ES,TW,2006.0,1,1,0
BE,MX,2007.0,3,7,-4
NE,US,2008.0,1,1,0
NO,AT,2009.0,2,5,-3
ID,CR,2020.0,1,1,0
NG,MY,2004.0,1,4,-3
FI,GH,2018.0,2,1,1
CA,CY,2014.0,1,1,0
SS,US,1997.0,2,1,1
MA,GB,2009.0,2,4,-2
FR,GE,2008.0,2,2,0
KR,NO,2022.0,5,4,1
UA,BR,2013.0,4,3,1
CA,MT,2010.0,2,1,1
CH,HR,2020.0,5,9,-4
PH,BE,1999.0,1,1,0
KW,NL,2011.0,1,1,0
PS,SD,2017.0,1,1,0
OM,BD,2018.0,1,4,-3
DK,HU,2017.0,4,9,-5
KW,AE,2011.0,2,3,-1
nan,GE,2015.0,3,4,-1
ET,EG,2018.0,4,11,-7
TW,MY,2006.0,7,7,0
AM,CN,2003.0,2,4,-2
KE,IE,2008.0,1,1,0
CL,NL,2006.0,4,2,2
JP,AO,2008.0,1,1,0
PL,FI,2014.0,5,8,-3
RU,HR,2020.0,8,15,-7
HN,CR,2018.0,3,2,1
GD,CA,2012.0,2,2,0
NG,NZ,2005.0,1,1,0
BE,EC,2012.0,3,4,-1
QA,FI,2013.0,3,1,2
HU,CU,2013.0,2,1,1
SK,SI,2012.0,3,2,1
UY,SE,2008.0,2,2,0
BT,IN,2019.0,1,5,-4
PT,KR,2019.0,2,3,-1
NZ,IT,2014.0,4,10,-6
TW,nan,2022.0,1,1,0
IS,NL,2014.0,1,1,0
SN,CH,2019.0,1,4,-3
CN,TR,1997.0,1,2,-1
CA,ZW,1998.0,2,1,1
AU,UG,2014.0,1,2,-1
VE,IN,2005.0,1,1,0
IL,CZ,2011.0,2,7,-5
RU,AU,2023.0,1,3,-2
FR,PY,2019.0,2,2,0
SE,GW,2005.0,1,2,-1
NZ,SE,2010.0,5,6,-1
BJ,NO,2007.0,1,1,0
PK,QA,2008.0,2,1,1
AE,NG,2010.0,1,1,0
ZM,RW,2014.0,1,3,-2
CL,GB,1999.0,3,6,-3
EG,FI,2013.0,1,4,-3
RW,ZA,2015.0,2,6,-4
BJ,PK,2021.0,1,2,-1
SV,MX,2014.0,1,3,-2
AU,QA,2008.0,5,10,-5
JP,TN,2015.0,3,1,2
AT,GR,2006.0,2,3,-1
BR,RS,2002.0,1,2,-1
PS,DE,2014.0,4,4,0
CH,GR,2004.0,3,9,-6
MT,NL,2020.0,1,2,-1
MX,NG,2019.0,2,1,1
OM,NL,2011.0,1,1,0
EE,DK,2021.0,3,6,-3
MW,DE,2016.0,1,1,0
PE,NI,2018.0,2,8,-6
SI,FI,2011.0,1,3,-2
FR,TG,2004.0,3,1,2
SS,US,1998.0,1,1,0
NO,PK,2001.0,1,5,-4
KE,GH,2016.0,1,3,-2
NG,SK,2019.0,1,1,0
NO,VN,2021.0,1,3,-2
GE,FR,2007.0,1,1,0
IN,LU,2020.0,3,3,0
BA,MY,2012.0,1,2,-1
HR,CA,2000.0,2,1,1
EG,ID,2007.0,1,2,-1
MT,US,2013.0,2,4,-2
CA,CL,2000.0,5,3,2
KR,PH,2004.0,3,3,0
MY,SI,2015.0,5,1,4
LU,NL,2014.0,1,5,-4
MN,KR,2017.0,1,7,-6
EG,MX,2013.0,1,3,-2
ZM,CD,2020.0,2,2,0
HU,KE,2019.0,1,2,-1
BW,JP,2020.0,2,1,1
SD,PK,2019.0,4,4,0
SK,BE,2017.0,2,2,0
SD,NG,2013.0,4,3,1
PT,NO,2007.0,2,1,1
MT,FR,2016.0,2,2,0
BE,AE,2017.0,1,1,0
GB,SD,1998.0,1,1,0
PA,AU,2015.0,3,5,-2
BR,ES,2022.0,247,130,117
CN,US,2008.0,4690,7209,-2519
UG,JP,2018.0,2,1,1
DE,AT,2013.0,605,533,72
CN,HK,2013.0,140,82,58
US,FR,2015.0,1556,1529,27
ES,CO,2016.0,648,473,175
NZ,AU,2007.0,147,115,32
CH,NL,2002.0,56,38,18
US,TR,2007.0,340,276,64
US,IR,2014.0,360,625,-265
SG,IN,2016.0,139,147,-8
JP,GR,2001.0,50,34,16
CN,NL,1999.0,20,25,-5
FR,HR,2004.0,7,2,5
TW,GB,2005.0,41,42,-1
PL,US,2011.0,183,210,-27
CA,JP,2022.0,49,44,5
SE,DK,2012.0,108,91,17
FI,US,2015.0,155,140,15
MX,RS,2009.0,31,49,-18
CN,nan,2009.0,176,247,-71
CN,MM,2005.0,7,7,0
GB,RS,2009.0,14,7,7
EG,JP,2008.0,48,58,-10
EC,FR,2021.0,6,8,-2
IL,BE,2009.0,8,4,4
IN,ES,2003.0,11,12,-1
CH,BR,2021.0,42,56,-14
IN,IL,2021.0,82,67,15
IN,ID,2022.0,20,63,-43
ZA,RW,2019.0,12,6,6
HR,BR,2015.0,4,5,-1
NZ,SE,2019.0,16,9,7
CO,JP,2014.0,15,10,5
PH,SG,2020.0,20,14,6
NG,BR,2019.0,6,12,-6
DE,ES,2009.0,189,164,25
ET,ZA,2016.0,3,9,-6
LK,IN,2020.0,34,18,16
ES,EC,2014.0,90,23,67
FR,CZ,2021.0,26,30,-4
NL,JP,1998.0,27,19,8
GB,UG,2017.0,7,10,-3
FI,SE,2002.0,48,48,0
IN,NP,2015.0,100,107,-7
NG,BR,2017.0,11,5,6
GB,MA,2013.0,8,3,5
CD,ZA,2021.0,2,1,1
CL,PE,2010.0,40,15,25
PE,US,2012.0,65,107,-42
AR,CL,2008.0,48,53,-5
SD,CA,2022.0,1,1,0
IN,ET,2014.0,27,8,19
CR,CL,2005.0,6,7,-1
MZ,RU,2010.0,30,13,17
GB,RU,2003.0,45,78,-33
CZ,TW,2009.0,2,3,-1
GB,MX,2004.0,32,39,-7
SE,AE,2019.0,5,4,1
DE,PS,2009.0,4,6,-2
BG,FR,2009.0,9,8,1
nan,KR,2016.0,23,38,-15
CN,IL,2018.0,23,17,6
ZA,TZ,2009.0,2,2,0
BD,KR,2007.0,5,1,4
FI,PK,2018.0,6,6,0
UA,GB,2001.0,14,4,10
nan,NZ,2017.0,2,7,-5
CO,CU,2016.0,33,42,-9
GB,CL,2022.0,33,30,3
NZ,BR,2019.0,15,21,-6
BD,IQ,2017.0,3,2,1
MA,ES,2015.0,6,20,-14
TR,ES,2007.0,8,5,3
LV,US,2014.0,3,7,-4
SI,GB,2012.0,7,8,-1
BG,CA,2015.0,4,3,1
US,GE,1998.0,83,58,25
CA,PL,2002.0,9,10,-1
IN,FI,2011.0,15,3,12
SK,CH,2002.0,7,6,1
JO,AU,2015.0,5,6,-1
IS,CH,2018.0,5,3,2
PE,CA,2009.0,3,4,-1
FR,TW,2007.0,18,16,2
CU,JP,2009.0,6,1,5
NG,MW,2014.0,1,1,0
CA,CM,2020.0,6,6,0
ID,ES,2009.0,12,7,5
NP,AU,2015.0,10,6,4
IQ,TR,2016.0,11,12,-1
ES,BO,2022.0,6,4,2
AU,CO,2008.0,4,4,0
MX,PR,2020.0,4,12,-8
LB,CA,2016.0,15,12,3
GB,IL,2023.0,3,3,0
SE,EG,2021.0,12,6,6
BH,GB,2020.0,8,4,4
KR,TW,1997.0,4,5,-1
SG,AT,2010.0,4,2,2
PK,KE,2016.0,26,16,10
PT,DK,2014.0,3,6,-3
TZ,BW,2010.0,2,1,1
IE,RS,2010.0,1,3,-2
MY,SE,2013.0,6,7,-1
AT,PT,2023.0,1,1,0
CN,IT,2007.0,19,41,-22
PL,IT,2011.0,29,23,6
CN,MM,2002.0,5,13,-8
JO,TR,2020.0,6,2,4
MZ,PL,2006.0,8,3,5
DE,AR,2000.0,13,17,-4
NZ,SE,2017.0,16,5,11
JP,RO,2005.0,4,3,1
DE,SY,2016.0,3,4,-1
JP,RO,2002.0,3,5,-2
CH,PH,2007.0,2,3,-1
MZ,RU,2019.0,17,11,6
TH,SG,2008.0,8,4,4
SY,CA,2017.0,3,1,2
NL,UG,2009.0,3,1,2
AT,SI,2022.0,10,6,4
PS,TR,2019.0,3,2,1
US,BW,2007.0,3,9,-6
SE,ET,2015.0,13,5,8
DK,TW,2007.0,2,1,1
ZA,TR,2013.0,3,3,0
TW,NL,2009.0,8,6,2
HR,IR,2021.0,1,1,0
MX,SG,2021.0,2,3,-1
HU,HR,2019.0,6,7,-1
IT,KZ,2014.0,3,3,0
NL,SK,1998.0,11,3,8
SK,BE,2010.0,3,4,-1
SI,BE,2007.0,1,2,-1
CY,AU,2015.0,2,4,-2
SD,BR,2008.0,5,7,-2
SK,JP,1998.0,7,8,-1
IR,AM,2012.0,2,2,0
MX,SE,2003.0,3,6,-3
GA,GB,2020.0,2,1,1
LB,MA,2016.0,2,1,1
SI,AT,2002.0,3,3,0
BY,FR,2020.0,1,3,-2
ZW,AU,2014.0,1,1,0
JP,PT,2021.0,1,4,-3
AU,EG,2007.0,2,2,0
CM,BE,2005.0,4,2,2
LT,CA,2019.0,3,1,2
IE,HR,1999.0,1,2,-1
ZA,CZ,2016.0,2,2,0
CU,PE,2003.0,1,2,-1
ZA,PH,2006.0,1,1,0
nan,CU,2019.0,4,8,-4
CL,NO,2019.0,3,2,1
CH,PG,2014.0,3,1,2
GB,RO,1999.0,2,9,-7
VG,nan,2020.0,1,1,0
PK,IT,2008.0,3,3,0
NO,JP,2004.0,2,6,-4
AU,MM,2017.0,3,1,2
PH,IE,2000.0,1,1,0
GR,EG,2022.0,1,2,-1
PL,BY,2011.0,1,2,-1
GB,MT,2002.0,2,6,-4
MX,NO,2012.0,1,2,-1
PL,IL,2008.0,3,4,-1
CL,PY,2021.0,5,6,-1
CZ,AE,2014.0,1,1,0
AM,DE,2018.0,5,7,-2
EC,MX,2003.0,2,3,-1
VE,CA,2008.0,3,4,-1
KR,FI,2008.0,5,26,-21
TR,RO,2001.0,1,1,0
TZ,MY,2015.0,1,1,0
MY,DK,2020.0,2,3,-1
GE,CN,2013.0,2,1,1
PS,TR,2010.0,1,3,-2
VE,ES,2006.0,62,67,-5
IR,SG,2015.0,42,50,-8
EG,BE,2013.0,4,5,-1
KR,TW,1998.0,6,7,-1
CA,TN,2012.0,18,7,11
PK,JP,2001.0,5,9,-4
ES,BD,2003.0,6,6,0
GE,SK,2018.0,3,1,2
SG,RU,2012.0,3,3,0
MY,NO,2020.0,3,4,-1
MX,PA,2018.0,15,9,6
MX,DO,2018.0,5,4,1
CH,CA,2023.0,9,4,5
UZ,CZ,2015.0,2,6,-4
CZ,MX,1997.0,1,1,0
CL,NO,2017.0,1,3,-2
TR,PK,2006.0,4,1,3
PK,KW,2014.0,2,4,-2
BI,DE,2018.0,1,1,0
BD,BN,2019.0,4,3,1
,CN,2010.0,41878,0,41878
US,,2017.0,67059,0,67059
US,,2010.0,40524,0,40524
,SI,2008.0,580,0,580
US,,2019.0,82361,0,82361
PT,,2013.0,490,0,490
CA,,2024.0,67963,0,67963
,IT,2005.0,11625,0,11625
,US,2001.0,67541,0,67541
KR,,2021.0,7026,0,7026
,DE,2007.0,19172,0,19172
,IN,1995.0,8250,0,8250
,IT,2002.0,10883,0,10883
JP,,2007.0,8428,0,8428
,ES,2010.0,14771,0,14771
,AR,2004.0,2160,0,2160
,CA,2006.0,10187,0,10187
,AR,1996.0,2003,0,2003
,PL,2006.0,4261,0,4261
nan,,2012.0,505,0,505
,nan,2005.0,932,0,932
,CN,2017.0,46265,0,46265
,MX,2016.0,4956,0,4956
SE,,2012.0,1863,0,1863
ES,,2008.0,3522,0,3522
,CH,2012.0,4136,0,4136
NL,,2001.0,1574,0,1574
,FI,1995.0,2958,0,2958
GB,,2003.0,6045,0,6045
,CN,2019.0,30752,0,30752
,BA,2009.0,222,0,222
,IE,2005.0,1160,0,1160
BE,,2020.0,3801,0,3801
,RU,2013.0,15004,0,15004
AT,,2012.0,1171,0,1171
,DZ,2004.0,481,0,481
,LB,2013.0,443,0,443
IE,,2006.0,288,0,288
IT,,2008.0,3634,0,3634
DZ,,2023.0,4853,0,4853
CO,,2014.0,618,0,618
,ES,2019.0,6697,0,6697
,IE,2002.0,1022,0,1022
CZ,,2014.0,1002,0,1002
,SA,2008.0,831,0,831
ID,,2018.0,1480,0,1480
,ES,2017.0,11243,0,11243
,PK,1994.0,540,0,540
,TN,2001.0,473,0,473
,GR,2011.0,2617,0,2617
,SK,1998.0,515,0,515
SA,,2020.0,1698,0,1698
,MG,2007.0,46,0,46
FI,,2004.0,542,0,542
,CM,2003.0,163,0,163
MT,,2015.0,21,0,21
,ZW,2006.0,76,0,76
ST,,2021.0,5,0,5
PL,ZA,2001.0,1,0,1
,AM,2011.0,165,0,165
,HN,2004.0,21,0,21
,VE,2006.0,495,0,495
LB,,2020.0,375,0,375
,VG,2011.0,20,0,20
,PE,1995.0,225,0,225
AR,,2015.0,1259,0,1259
,MA,2001.0,367,0,367
,AE,2012.0,401,0,401
EC,,2018.0,267,0,267
,VN,2015.0,575,0,575
,LT,2003.0,562,0,562
BG,,2019.0,559,0,559
,CY,2006.0,119,0,119
,nan,2002.0,964,0,964
,HR,2013.0,847,0,847
MA,,2021.0,1391,0,1391
,GH,2018.0,711,0,711
,RS,2015.0,752,0,752
,EE,2008.0,344,0,344
GH,DK,2006.0,1,0,1
BG,,2010.0,216,0,216
,LU,2007.0,124,0,124
BW,,2022.0,160,0,160
MY,,2004.0,77,0,77
EE,CZ,2008.0,1,0,1
PS,,2016.0,60,0,60
,SY,2001.0,48,0,48
,NP,2015.0,488,0,488
NZ,,2009.0,420,0,420
MA,BR,2011.0,1,0,1
,SK,1997.0,488,0,488
EG,,2003.0,205,0,205
,BY,2016.0,353,0,353
,GA,2011.0,26,0,26
,AO,2009.0,19,0,19
LY,,2018.0,59,0,59
,GW,1999.0,8,0,8
NA,PL,2018.0,1,0,1
,CF,2012.0,7,0,7
,YE,2010.0,41,0,41
AZ,,2006.0,25,0,25
ZA,,2009.0,521,0,521
BG,,2017.0,376,0,376
,KZ,2003.0,97,0,97
,UG,1998.0,91,0,91
IR,SK,2020.0,5,0,5
FR,MR,2004.0,1,0,1
LU,JP,2007.0,5,0,5
PA,,2016.0,46,0,46
,DZ,1996.0,147,0,147
HR,,2006.0,108,0,108
NZ,FJ,2002.0,1,0,1
KZ,SA,2016.0,2,0,2
EE,EG,2022.0,1,0,1
FK,GB,2007.0,1,0,1
,KH,2006.0,37,0,37
,CI,2000.0,36,0,36
CH,ID,2008.0,1,0,1
,YE,2019.0,52,0,52
BE,OM,2007.0,1,0,1
,YE,2017.0,66,0,66
,TG,2007.0,33,0,33
,GP,2016.0,11,0,11
BH,ID,2015.0,1,0,1
,NI,2016.0,37,0,37
,BH,2011.0,52,0,52
BH,,2025.0,36,0,36
NI,,2021.0,51,0,51
,BO,2018.0,40,0,40
,UG,1997.0,72,0,72
MX,TT,2023.0,1,0,1
HK,,2013.0,63,0,63
nan,RW,2013.0,5,0,5
,GY,2003.0,4,0,4
BG,HU,2006.0,4,0,4
KW,,2013.0,79,0,79
GM,US,2005.0,5,0,5
AT,ZW,2020.0,1,0,1
,ME,2009.0,28,0,28
MK,AL,2018.0,3,0,3
CA,ZM,2013.0,1,0,1
,PY,2020.0,2,0,2
FJ,GB,2022.0,1,0,1
GL,SE,2011.0,1,0,1
TZ,,1999.0,18,0,18
BR,AO,2000.0,4,0,4
MY,IE,2007.0,3,0,3
SN,ZA,2014.0,2,0,2
VE,AU,2015.0,5,0,5
VN,KE,2010.0,1,0,1
HK,HU,2017.0,1,0,1
ET,AU,2009.0,3,0,3
SK,BW,1999.0,1,0,1
IE,BH,2014.0,2,0,2
DK,CL,2003.0,1,0,1
GR,ID,2022.0,2,0,2
TT,CN,2022.0,1,0,1
MX,IE,2001.0,1,0,1
AU,BM,2006.0,1,0,1
PL,IE,2006.0,6,0,6
EG,NO,2020.0,4,0,4
,MU,2000.0,14,0,14
MK,KR,2017.0,1,0,1
CH,KZ,2005.0,2,0,2
SV,BR,2015.0,5,0,5
KG,,2014.0,6,0,6
JO,FR,2007.0,10,0,10
IL,RS,2011.0,4,0,4
FR,UZ,1998.0,1,0,1
SI,MK,2012.0,1,0,1
IE,SE,2001.0,5,0,5
ZA,SI,2007.0,1,0,1
ML,,2016.0,27,0,27
NC,GB,2006.0,1,0,1
SA,GH,2003.0,1,0,1
,PG,2000.0,15,0,15
HU,KE,2010.0,2,0,2
IR,GE,2015.0,1,0,1
VG,JP,2008.0,2,0,2
JP,KW,2012.0,2,0,2
MG,,2001.0,2,0,2
IL,IE,2011.0,2,0,2
LU,ZA,2018.0,1,0,1
IR,AT,2002.0,1,0,1
VE,DO,2018.0,3,0,3
ZM,CA,2016.0,1,0,1
TW,,2026.0,1,0,1
,SS,2002.0,4,0,4
IL,SG,2001.0,3,0,3
US,DO,2003.0,1,0,1
AU,KE,2000.0,2,0,2
MC,BE,2005.0,1,0,1
VG,,2009.0,11,0,11
,MQ,1995.0,13,0,13
LY,QA,2016.0,1,0,1
SN,,2001.0,10,0,10
AR,CZ,2011.0,1,0,1
EE,RS,2018.0,1,0,1
IR,IN,2023.0,4,0,4
GE,SG,2011.0,1,0,1
IE,PH,2009.0,3,0,3
FI,PH,2013.0,2,0,2
HU,VE,2008.0,1,0,1
YE,,2011.0,7,0,7
UG,IT,2017.0,6,0,6
IT,AO,2014.0,1,0,1
CY,,2007.0,20,0,20
,HN,1996.0,25,0,25
,MC,2008.0,8,0,8
PA,AE,2022.0,1,0,1
MT,CH,2006.0,1,0,1
ET,,2003.0,11,0,11
,HT,2014.0,15,0,15
SI,CN,2000.0,2,0,2
AM,IQ,2017.0,1,0,1
BR,TZ,2009.0,1,0,1
SI,RU,2003.0,2,0,2
ZM,SE,2013.0,1,0,1
PL,MN,2016.0,2,0,2
IS,TR,2009.0,1,0,1
BE,LU,2023.0,1,0,1
AZ,DE,2004.0,2,0,2
TR,GE,2011.0,2,0,2
RO,NG,2003.0,1,0,1
NG,HU,2006.0,1,0,1
SK,HR,2001.0,1,0,1
ID,CO,2007.0,1,0,1
EG,MA,1999.0,2,0,2
DE,SS,2010.0,1,0,1
PL,TH,1998.0,1,0,1
NG,MA,2020.0,3,0,3
IN,UZ,2020.0,4,0,4
FR,CD,2010.0,1,0,1
JP,MT,2021.0,1,0,1
SD,MA,2022.0,1,0,1
CD,US,2006.0,1,0,1
GB,MC,2014.0,1,0,1
NL,QA,2005.0,1,0,1
ML,BJ,2013.0,1,0,1
LY,MA,2015.0,1,0,1
MX,,2026.0,15,0,15
UZ,,1999.0,13,0,13
KR,KP,2013.0,1,0,1
AR,ID,2021.0,4,0,4
ZA,HU,2020.0,4,0,4
DE,RW,2004.0,1,0,1
MR,,2024.0,22,0,22
CN,TJ,2021.0,1,0,1
CD,NG,2022.0,3,0,3
BY,IT,2021.0,2,0,2
BD,HU,2021.0,1,0,1
SV,CO,2022.0,1,0,1
VG,UA,2020.0,1,0,1
PH,PK,2008.0,1,0,1
AZ,KR,2003.0,1,0,1
IN,SJ,2020.0,1,0,1
CZ,KR,2005.0,2,0,2
KP,JP,2004.0,2,0,2
CY,BE,2018.0,3,0,3
BG,SE,2009.0,5,0,5
nan,JM,2018.0,1,0,1
MW,,2001.0,5,0,5
DK,FO,2021.0,5,0,5
UG,GH,2020.0,2,0,2
BE,EG,2023.0,2,0,2
NZ,ID,2003.0,1,0,1
EE,RO,2017.0,1,0,1
CL,KZ,2019.0,1,0,1
SR,,2013.0,1,0,1
NZ,KW,2011.0,1,0,1
BF,GA,2004.0,1,0,1
LU,QA,2015.0,2,0,2
CG,PK,2007.0,1,0,1
PL,KZ,2010.0,1,0,1
SX,,2008.0,1,0,1
IR,AF,2021.0,8,0,8
OM,JP,2004.0,1,0,1
BA,DE,1999.0,1,0,1
CA,MW,2003.0,2,0,2
ZA,VN,2001.0,1,0,1
CA,ZW,1997.0,2,0,2
KE,CL,2020.0,1,0,1
TH,TR,2003.0,2,0,2
JM,IN,2001.0,1,0,1
PT,ZM,2015.0,2,0,2
HN,GB,2015.0,2,0,2
LR,,2016.0,6,0,6
TZ,BD,2021.0,1,0,1
TN,AE,2005.0,1,0,1
HK,VN,1997.0,1,0,1
,SO,2014.0,2,0,2
PF,,2012.0,8,0,8
TG,BE,2020.0,1,0,1
PK,IE,2001.0,2,0,2
PL,NG,2014.0,3,0,3
GH,BJ,2015.0,1,0,1
TZ,BJ,2020.0,1,0,1
AL,,2025.0,7,0,7
DO,,2012.0,5,0,5
PR,MX,2011.0,1,0,1
SG,PK,2007.0,5,0,5
NZ,MM,2016.0,1,0,1
ZA,MU,2021.0,1,0,1
CW,RU,2018.0,1,0,1
,LY,1999.0,11,0,11
MQ,,2013.0,6,0,6
AM,BG,2019.0,1,0,1
UZ,US,2010.0,5,0,5
MY,GE,2017.0,1,0,1
SN,TG,2020.0,3,0,3
NE,DZ,2011.0,1,0,1
TH,ET,2016.0,4,0,4
UG,JO,2020.0,1,0,1
AG,HU,2008.0,1,0,1
CL,,2026.0,7,0,7
UA,EE,2002.0,1,0,1
CO,NL,2003.0,2,0,2
CD,TZ,2018.0,5,0,5
HR,MK,2004.0,1,0,1
FI,OM,2011.0,1,0,1
TH,IT,2022.0,3,0,3
HU,SG,2018.0,1,0,1
GR,TN,2017.0,4,0,4
UY,NC,2020.0,1,0,1
KE,KG,2019.0,1,0,1
BY,VN,2014.0,5,0,5
ML,IT,2010.0,1,0,1
BY,SI,2013.0,5,0,5
GA,,2004.0,4,0,4
AF,PK,2017.0,1,0,1
BR,LU,2016.0,6,0,6
SS,CN,2009.0,1,0,1
IR,LT,2020.0,1,0,1
KZ,EG,2008.0,1,0,1
PH,EG,2001.0,1,0,1
BA,IT,2001.0,1,0,1
TT,NZ,2010.0,1,0,1
SG,IR,2023.0,1,0,1
ZW,BR,2014.0,2,0,2
SA,IQ,1999.0,1,0,1
MU,CA,2006.0,2,0,2
EG,TN,2001.0,3,0,3
BY,UZ,2022.0,2,0,2
EG,IL,1997.0,1,0,1
SI,CA,2003.0,1,0,1
MC,GB,2013.0,3,0,3
UY,PY,2006.0,1,0,1
VE,CU,1997.0,1,0,1
TH,IL,2011.0,1,0,1
SA,MT,2020.0,5,0,5
AU,LA,2018.0,1,0,1
XK,CH,2017.0,1,0,1
MD,BJ,2012.0,1,0,1
BW,SG,2002.0,1,0,1
OM,CH,2021.0,1,0,1
CA,BM,2008.0,1,0,1
DE,KE,2001.0,4,0,4
TZ,TR,2016.0,1,0,1
GL,NO,2015.0,1,0,1
LB,ES,1999.0,1,0,1
BE,MM,2020.0,1,0,1
AU,DZ,2012.0,2,0,2
AL,UZ,2016.0,1,0,1
UA,SI,2003.0,1,0,1
MK,AT,2003.0,1,0,1
IT,TZ,1999.0,1,0,1
DE,PG,2014.0,1,0,1
UZ,IT,2017.0,3,0,3
US,GL,2021.0,1,0,1
PK,PE,2016.0,2,0,2
AZ,CH,2020.0,2,0,2
SY,FR,2005.0,3,0,3
GL,,2004.0,1,0,1
CN,KH,2009.0,1,0,1
,SS,2005.0,6,0,6
NL,BW,1998.0,1,0,1
TZ,PK,2022.0,2,0,2
SJ,FR,2019.0,1,0,1
GH,PT,2019.0,3,0,3
NZ,KH,2009.0,1,0,1
MY,CY,2016.0,2,0,2
HR,GR,2010.0,1,0,1
IM,GB,2012.0,2,0,2
MY,AF,2020.0,5,0,5
TJ,,2004.0,4,0,4
NL,UY,2009.0,2,0,2
ZM,JP,2004.0,2,0,2
ID,PT,2008.0,1,0,1
KE,BW,2004.0,1,0,1
UG,CY,2015.0,1,0,1
VN,HU,2001.0,1,0,1
BA,QA,2019.0,2,0,2
IR,BR,2005.0,1,0,1
MZ,BY,2015.0,1,0,1
DE,LI,1998.0,2,0,2
BG,PL,2022.0,2,0,2
AZ,BY,2020.0,1,0,1
ML,IT,2019.0,1,0,1
IE,GR,2003.0,2,0,2
SE,JO,2006.0,2,0,2
AU,SD,2022.0,1,0,1
JM,AU,2007.0,2,0,2
GR,LU,1998.0,1,0,1
ID,CH,2009.0,1,0,1
PW,US,2009.0,1,0,1
MK,KR,2019.0,1,0,1
SN,CI,2013.0,1,0,1
TR,IE,2002.0,1,0,1
,LI,2016.0,5,0,5
PT,CV,2009.0,1,0,1
BD,CO,2012.0,1,0,1
IT,SJ,2011.0,1,0,1
SG,AE,2006.0,2,0,2
SY,MY,2008.0,1,0,1
CM,PK,2016.0,3,0,3
LK,NL,2011.0,1,0,1
LU,MX,2018.0,1,0,1
SE,BY,2010.0,2,0,2
HN,AR,1999.0,1,0,1
JP,CU,1997.0,1,0,1
NZ,DK,2023.0,1,0,1
GW,BR,2022.0,1,0,1
CI,GH,2020.0,1,0,1
PG,ZA,2013.0,7,0,7
PT,NA,2019.0,1,0,1
BH,KE,1997.0,1,0,1
CO,CR,1997.0,1,0,1
,PK,2021.0,10,0,10
JP,CL,1999.0,3,0,3
AM,PL,2020.0,2,0,2
NP,DE,2005.0,1,0,1
BE,VG,2019.0,1,0,1
GT,VE,2013.0,1,0,1
DE,SS,2017.0,1,0,1
US,MQ,2016.0,1,0,1
TH,LK,2020.0,4,0,4
CH,TH,2006.0,4,0,4
RO,LK,2019.0,1,0,1
LB,IN,2003.0,1,0,1
BS,GB,2002.0,2,0,2
PK,BE,2001.0,2,0,2
CM,GA,2016.0,2,0,2
FI,BW,2012.0,1,0,1
BI,NL,2008.0,1,0,1
FI,MW,1997.0,1,0,1
SE,LA,2015.0,2,0,2
MY,CM,2010.0,1,0,1
CZ,BA,2021.0,1,0,1
MX,HU,1997.0,1,0,1
CY,KR,2022.0,1,0,1
TW,SK,2019.0,1,0,1
VE,CZ,2018.0,1,0,1
LV,NL,2005.0,1,0,1
CA,LV,2013.0,2,0,2
SE,PH,1999.0,1,0,1
AU,MC,2018.0,1,0,1
TR,CZ,2001.0,1,0,1
CL,NZ,2023.0,1,0,1
PT,RE,2021.0,1,0,1
AU,RE,2013.0,1,0,1
SY,NL,2008.0,1,0,1
NP,TH,1998.0,1,0,1
TW,SK,2017.0,1,0,1
SK,TW,2018.0,1,0,1
DE,NI,2009.0,1,0,1
IT,LT,2000.0,1,0,1
GB,SD,1997.0,1,0,1
LU,MT,2020.0,1,0,1
NI,DO,2012.0,1,0,1
MR,CI,2002.0,1,0,1
TW,NO,2009.0,3,0,3
RU,NZ,2007.0,1,0,1
IR,BH,2006.0,1,0,1
GT,BB,2018.0,1,0,1
KE,ES,2008.0,1,0,1
BT,IN,2010.0,1,0,1
XK,NL,2007.0,3,0,3
GE,AU,2022.0,2,0,2
RE,TN,2017.0,1,0,1
AT,LB,2010.0,1,0,1
ZM,EG,2013.0,1,0,1
CL,IE,2022.0,2,0,2
BN,CZ,2019.0,1,0,1
BR,HK,2013.0,1,0,1
PE,PT,2007.0,2,0,2
VN,PR,2022.0,1,0,1
LT,GR,2000.0,1,0,1
KG,AU,2021.0,1,0,1
LA,CH,1999.0,1,0,1
IT,TT,2012.0,1,0,1
ID,IE,2007.0,1,0,1
SG,BN,2008.0,3,0,3
NZ,TT,2022.0,1,0,1
EE,CN,2000.0,3,0,3
SY,YE,2014.0,2,0,2
TG,MD,2018.0,1,0,1
NP,AF,2019.0,1,0,1
UZ,CH,1999.0,1,0,1
MQ,GB,2017.0,1,0,1
RU,IS,2013.0,2,0,2
BO,SE,2009.0,2,0,2
MQ,BR,2018.0,1,0,1
NC,CG,2011.0,4,0,4
AM,FR,1999.0,1,0,1
GM,NG,2002.0,1,0,1
GH,PK,2012.0,1,0,1
CH,CY,2008.0,1,0,1
CA,LT,2003.0,1,0,1
BF,CF,2018.0,1,0,1
PK,GD,2021.0,1,0,1
IT,PA,2014.0,1,0,1
OM,CN,2011.0,1,0,1
FR,YE,2009.0,1,0,1
BE,IS,2019.0,1,0,1
MW,SD,2015.0,1,0,1
TJ,AT,2021.0,1,0,1
JP,ZW,2020.0,1,0,1
EG,ML,2007.0,1,0,1
BR,GR,2004.0,1,0,1
CL,SV,2020.0,3,0,3
PH,DK,2002.0,1,0,1
CG,TH,2008.0,1,0,1
AG,DE,2018.0,1,0,1
MD,RO,2001.0,1,0,1
EE,BE,2005.0,1,0,1
US,ER,2018.0,1,0,1
SD,BW,1999.0,1,0,1
SE,UY,2007.0,1,0,1
NL,SD,2009.0,1,0,1
IT,BA,2022.0,1,0,1
KH,nan,2018.0,1,0,1
SN,JP,2020.0,1,0,1
nan,BF,2012.0,1,0,1
GH,GA,2020.0,1,0,1
RU,TH,2002.0,1,0,1
TH,LV,2014.0,1,0,1
CY,SG,2020.0,1,0,1
CA,MQ,2014.0,2,0,2
IL,TZ,2007.0,1,0,1
FM,FJ,2013.0,1,0,1
UA,SG,2011.0,2,0,2
BS,CH,2021.0,1,0,1
NG,IL,2003.0,1,0,1
PL,IS,2014.0,1,0,1
US,ME,2011.0,1,0,1
IT,MK,2000.0,1,0,1
BO,NI,2013.0,1,0,1
IT,TG,2020.0,1,0,1
SD,SG,2017.0,1,0,1
ST,PH,2018.0,1,0,1
IQ,CZ,2023.0,1,0,1
NO,OM,2021.0,1,0,1
GA,BF,2010.0,1,0,1
GR,ME,2022.0,1,0,1
OM,KW,2021.0,2,0,2
KZ,BY,2013.0,2,0,2
HK,KZ,2014.0,1,0,1
MA,HR,2016.0,1,0,1
ML,IT,2017.0,3,0,3
AE,PT,2002.0,1,0,1
US,MO,2014.0,1,0,1
CL,TG,2011.0,1,0,1
KZ,AL,2018.0,1,0,1
IE,NC,2021.0,1,0,1
JP,CM,2013.0,2,0,2
KW,CH,2003.0,1,0,1
SL,DE,2020.0,1,0,1
GH,NL,2001.0,1,0,1
MN,,2003.0,1,0,1
ID,DE,2023.0,1,0,1
SD,LB,2013.0,1,0,1
AT,OM,2019.0,1,0,1
HR,OM,2020.0,1,0,1
IL,ID,2008.0,1,0,1
LA,US,2006.0,1,0,1
AZ,CZ,2017.0,1,0,1
PY,PE,2008.0,1,0,1
MK,CA,2011.0,1,0,1
SA,IL,2000.0,1,0,1
IS,IL,2020.0,1,0,1
BE,JO,2015.0,1,0,1
AU,IQ,2008.0,2,0,2
CY,MK,2019.0,1,0,1
RE,MD,2018.0,2,0,2
ES,UZ,2017.0,1,0,1
AT,EE,2005.0,1,0,1
SE,CM,2012.0,1,0,1
FJ,,2000.0,1,0,1
,AG,2012.0,1,0,1
NL,DZ,2022.0,1,0,1
KR,MN,2011.0,1,0,1
PH,CH,2009.0,3,0,3
SE,PY,2020.0,1,0,1
UG,BJ,2005.0,1,0,1
MW,PK,2004.0,1,0,1
MZ,GW,2018.0,1,0,1
ZW,NA,2012.0,1,0,1
NC,CA,2020.0,1,0,1
IE,SI,2013.0,1,0,1
nan,AM,2008.0,1,0,1
ME,XK,2007.0,2,0,2
BY,SE,2015.0,1,0,1
PG,UG,2017.0,1,0,1
HU,NZ,2020.0,1,0,1
KH,SK,2017.0,1,0,1
PL,KZ,2019.0,2,0,2
GA,KH,2018.0,1,0,1
MH,,2013.0,1,0,1
FO,,2013.0,1,0,1
KR,AZ,2020.0,1,0,1
AE,YE,2000.0,1,0,1
KZ,US,2023.0,1,0,1
RU,CO,2008.0,2,2,0
QA,HU,2017.0,2,1,1
nan,NP,2017.0,1,5,-4
SG,CL,2022.0,1,1,0
AE,DZ,2017.0,1,2,-1
XK,CH,2019.0,2,1,1
ST,AR,2004.0,1,1,0
PE,IT,2000.0,1,1,0
AU,AE,2003.0,1,2,-1
ET,NL,2014.0,4,8,-4
GB,SZ,2004.0,1,1,0
BE,CW,2016.0,2,1,1
KE,RU,2018.0,2,2,0
BE,BG,2020.0,1,2,-1
MK,GR,2004.0,1,4,-3
CA,EG,2023.0,2,6,-4
AF,ES,2018.0,1,2,-1
AE,BD,2012.0,2,6,-4
NG,PH,2021.0,1,2,-1
HR,CZ,2010.0,2,3,-1
ZA,SE,2023.0,1,2,-1
AR,TR,2017.0,1,1,0
GR,ZA,2006.0,1,2,-1
AU,CU,1998.0,1,2,-1
PL,LT,2022.0,2,1,1
CA,UY,2014.0,1,2,-1
ES,MY,2009.0,2,2,0
SY,IN,2015.0,1,1,0
FI,RU,2023.0,3,3,0
TN,BE,2007.0,1,1,0
FR,NG,2007.0,3,3,0
SG,AT,2017.0,3,3,0
KR,BH,2018.0,1,3,-2
PT,HR,2016.0,1,1,0
PT,SG,2011.0,1,1,0
AO,CN,2007.0,1,1,0
TZ,AU,2021.0,3,1,2
CI,GB,2014.0,1,1,0
PH,TR,2016.0,1,2,-1
CY,IN,2018.0,2,4,-2
PT,RU,2007.0,3,7,-4
RU,RO,2021.0,4,4,0
IR,NO,2006.0,2,1,1
SV,US,2017.0,4,7,-3
CW,SK,2014.0,1,1,0
MW,CA,2021.0,1,1,0
DE,UY,2022.0,1,4,-3
KE,PE,2014.0,2,1,1
DE,EC,2006.0,1,1,0
BH,CA,2005.0,1,1,0
ZA,LS,2010.0,2,3,-1
BF,CM,2004.0,1,1,0
MW,US,1997.0,1,3,-2
OM,CY,2015.0,1,1,0
NI,EC,2018.0,1,3,-2
PL,SE,2023.0,1,3,-2
YE,US,2012.0,2,2,0
US,CI,2013.0,3,2,1
RU,GE,2006.0,1,8,-7
RS,IE,2007.0,1,1,0
AE,SE,2014.0,3,3,0
IT,VA,2019.0,2,1,1
IT,PH,2000.0,2,2,0
MW,BE,2017.0,1,1,0
AT,BF,2016.0,1,3,-2
DE,PE,2001.0,1,1,0
MW,JP,2009.0,1,1,0
PH,CL,2014.0,1,1,0
BD,BH,2018.0,2,2,0
MA,HU,2019.0,1,1,0
RS,IL,2002.0,1,1,0
MN,KR,2010.0,1,1,0
LV,SI,2013.0,1,5,-4
SK,BE,2019.0,1,2,-1
TT,NG,2013.0,1,1,0
IN,LB,2011.0,2,2,0
PH,KE,2016.0,1,2,-1
AZ,CZ,2019.0,1,1,0
MA,MD,2016.0,2,3,-1
nan,CU,2010.0,2,1,1
CH,CU,2015.0,1,4,-3
AZ,UZ,2018.0,1,1,0
SA,ES,2018.0,2,14,-12
PE,IN,2022.0,1,2,-1
CZ,MA,2021.0,1,2,-1
ZA,LK,2014.0,2,1,1
IE,HU,2007.0,1,2,-1
MA,GP,2016.0,1,1,0
BW,SZ,2008.0,1,2,-1
CA,SD,2000.0,1,3,-2
BE,AR,2002.0,1,4,-3
CL,GR,2016.0,1,3,-2
SK,FR,2022.0,1,3,-2
GT,EC,2015.0,1,1,0
PG,AU,2004.0,1,2,-1
DE,SN,2012.0,1,1,0
SC,GB,2016.0,1,2,-1
CI,ZA,2022.0,1,1,0
BT,IN,2017.0,1,2,-1
EG,IE,2005.0,1,1,0
IE,RS,2017.0,1,2,-1
GW,DK,1999.0,1,1,0
RO,LK,2010.0,1,5,-4
PG,BE,2020.0,1,1,0
BD,MY,2003.0,1,4,-3
NO,MK,2021.0,1,1,0
KE,CM,2016.0,1,3,-2
NG,SZ,2015.0,1,1,0
GH,PE,2019.0,1,1,0
AR,CN,2022.0,1,1,0
AE,NO,2008.0,1,1,0
CH,LU,1998.0,1,1,0
DE,AL,2021.0,1,2,-1
NI,US,2011.0,2,4,-2
VN,KE,2019.0,1,1,0
CA,KZ,2012.0,1,1,0
IR,KW,2009.0,1,3,-2
BJ,IT,2005.0,1,2,-1
CM,NG,2014.0,1,3,-2
UG,PE,2020.0,1,1,0
CA,MT,2019.0,1,1,0
MD,TN,2003.0,1,2,-1
PK,ES,2001.0,1,2,-1
TN,BR,2009.0,1,1,0
KE,DE,2006.0,3,6,-3
LU,AR,2015.0,1,1,0
PT,DZ,2016.0,1,1,0
OM,ZA,2000.0,1,1,0
EE,NL,2005.0,2,1,1
NA,ZA,2008.0,1,3,-2
PK,EG,2011.0,3,5,-2
GM,ES,2022.0,1,1,0
CN,PE,2013.0,1,2,-1
IE,LB,2020.0,1,3,-2
ML,US,2011.0,2,4,-2
HK,IT,2015.0,1,1,0
RS,QA,2020.0,1,1,0
TR,SA,2000.0,1,1,0
CM,BE,2002.0,1,3,-2
BH,KE,1998.0,1,3,-2
MY,KZ,2014.0,1,2,-1
GR,PL,2016.0,1,1,0
BR,RS,2005.0,1,0,1
AT,JM,2018.0,1,0,1
EC,nan,2014.0,1,0,1
LU,HR,2012.0,1,0,1
PA,CZ,2009.0,1,0,1
MD,BY,2002.0,1,0,1
TW,ET,2008.0,1,0,1
nan,BJ,2019.0,1,0,1
TW,TZ,2014.0,1,0,1
AO,CO,2012.0,1,0,1
JP,CD,1997.0,1,0,1
LT,IE,2021.0,2,0,2
AT,FI,1998.0,1,0,1
KR,MW,2013.0,2,0,2
IN,CD,2018.0,1,0,1
RO,GH,2017.0,1,0,1
BE,BJ,2004.0,1,0,1
AZ,nan,2020.0,1,0,1
ZA,BY,2019.0,1,0,1
IR,SD,2013.0,2,0,2
CA,SN,1999.0,1,0,1
IR,VN,2014.0,1,0,1
CZ,NO,2023.0,1,0,1
ES,BZ,2021.0,1,0,1
nan,IS,2018.0,1,0,1
TH,EG,2022.0,1,0,1
MX,DK,2004.0,2,0,2
BR,TN,2021.0,1,0,1
EC,AU,2004.0,2,0,2
RS,PH,2006.0,1,0,1
PT,IS,2015.0,1,0,1
DO,GB,2014.0,1,0,1
PK,KH,2007.0,2,0,2
PL,KZ,2017.0,2,0,2
ES,UZ,2019.0,1,0,1
RO,GH,2019.0,1,0,1
CZ,MK,2010.0,1,0,1
SI,CL,2009.0,1,0,1
SG,NG,2020.0,1,0,1
CZ,BI,2014.0,1,0,1
TD,,2005.0,1,0,1
BW,NL,2017.0,1,0,1
JM,ZA,2014.0,1,0,1
NE,,2004.0,3,0,3
GM,NL,2006.0,1,0,1
LB,NO,2016.0,1,0,1
BA,PT,2019.0,1,0,1
CA,PF,2015.0,1,0,1
BD,ET,2012.0,1,0,1
ST,PT,2001.0,1,0,1
SD,CL,2007.0,1,0,1
ZM,NA,2006.0,1,0,1
MY,BA,2019.0,2,0,2
SG,JM,2017.0,1,0,1
IL,CL,2007.0,1,0,1
KW,GB,2023.0,1,0,1
SD,CN,2001.0,1,0,1
MY,LU,2020.0,1,0,1
IR,CL,2005.0,1,0,1
GT,PY,2016.0,1,0,1
PH,IR,2020.0,2,0,2
BD,QA,2022.0,2,0,2
SV,PA,2015.0,1,0,1
ME,GB,1997.0,1,0,1
HN,CA,2013.0,1,0,1
EG,LY,2007.0,2,0,2
MX,BG,2014.0,1,0,1
BD,DK,2014.0,1,0,1
TH,FJ,2016.0,1,0,1
DE,GL,2012.0,1,0,1
,KN,2007.0,2,0,2
CN,ZM,2023.0,1,0,1
MW,TW,2017.0,1,0,1
IL,NZ,2016.0,3,0,3
NC,nan,1999.0,1,0,1
DZ,AE,2006.0,1,0,1
IR,MA,2008.0,1,0,1
PS,PH,2022.0,1,0,1
DZ,BH,2009.0,1,0,1
UZ,GB,2021.0,2,0,2
TR,TH,2005.0,1,0,1
CD,KE,2007.0,1,0,1
IQ,DZ,2008.0,2,0,2
PL,SA,2007.0,1,0,1
XK,CH,2010.0,1,0,1
SS,DE,2012.0,1,0,1
NP,FI,2012.0,1,0,1
UA,AU,2018.0,1,0,1
SD,IN,1998.0,1,0,1
JP,RS,1997.0,1,0,1
UG,PG,2008.0,1,0,1
TR,MD,2013.0,1,0,1
NZ,RS,2011.0,1,0,1
BW,CH,2023.0,1,0,1
NG,CG,2006.0,1,0,1
PG,CZ,2021.0,1,0,1
FR,MU,2001.0,1,0,1
BY,SG,2008.0,1,0,1
BR,HU,1997.0,1,0,1
JO,QA,2000.0,1,0,1
FI,KZ,2018.0,1,0,1
IE,SG,1998.0,1,0,1
MC,TN,2015.0,1,0,1
LB,IL,2008.0,2,0,2
MU,BR,2004.0,1,0,1
CU,TT,2009.0,1,0,1
IT,MW,2013.0,1,0,1
KR,KW,2014.0,1,0,1
PT,BJ,2014.0,1,0,1
JO,BD,2016.0,2,0,2
SA,NZ,2002.0,1,0,1
TG,TR,2018.0,1,0,1
BE,LK,2011.0,1,0,1
UG,ZW,2016.0,1,0,1
DZ,PK,2010.0,1,0,1
GP,QA,2009.0,1,0,1
BE,IS,2010.0,1,0,1
CH,PY,2010.0,1,0,1
BG,IE,1999.0,1,0,1
PE,SV,2011.0,1,0,1
ID,IR,2008.0,1,0,1
AL,PL,2022.0,1,0,1
GT,IT,2016.0,1,0,1
IM,,2009.0,1,0,1
BT,FR,2022.0,1,0,1
SK,UZ,2002.0,1,0,1
IE,RS,2019.0,2,0,2
CM,SE,2020.0,1,0,1
NE,CH,2014.0,1,0,1
US,GY,2013.0,1,0,1
MC,ES,2011.0,1,0,1
RO,PG,2014.0,1,0,1
NA,IL,2015.0,1,0,1
CF,UG,2019.0,1,0,1
AU,BY,1997.0,1,0,1
AO,MZ,2012.0,1,0,1
RU,MK,1997.0,1,0,1
TT,DE,2018.0,1,0,1
LB,PK,2009.0,1,0,1
AT,LB,2017.0,1,0,1
GF,CO,2010.0,1,0,1
VE,DK,2016.0,1,0,1
LT,ZA,2021.0,1,0,1
LK,GR,2001.0,1,0,1
DZ,QA,2022.0,1,0,1
IL,HK,2015.0,1,0,1
MY,BA,2017.0,1,0,1
FI,CU,2003.0,1,0,1
JP,NE,2014.0,1,0,1
LB,UZ,2017.0,1,0,1
UA,TZ,2003.0,1,0,1
PT,IL,2023.0,1,0,1
ST,ES,2007.0,1,0,1
PE,CR,1999.0,1,0,1
DZ,LB,2021.0,1,0,1
DZ,PK,2017.0,1,0,1
BM,NZ,2014.0,1,0,1
BS,JM,2012.0,1,0,1
TT,PH,2014.0,1,0,1
BE,DZ,2001.0,1,0,1
UG,DZ,2017.0,1,0,1
CN,HR,2003.0,1,0,1
ZA,KZ,2016.0,1,0,1
DE,JM,2001.0,1,0,1
KE,MX,2010.0,1,0,1
ZW,ZA,1999.0,1,0,1
TH,VE,2014.0,1,0,1
HR,IL,2004.0,1,0,1
BR,GW,2014.0,1,0,1
MX,NG,2017.0,1,0,1
JP,PE,2009.0,1,0,1
NG,BE,2014.0,1,0,1
IN,KH,2007.0,1,0,1
PH,ID,2007.0,1,0,1
TZ,ZW,2013.0,1,0,1
BW,TH,2014.0,1,0,1
CN,CO,2000.0,1,0,1
CL,AF,2012.0,1,0,1
BE,UZ,2019.0,2,0,2
KE,DZ,2020.0,1,0,1
DE,LB,2002.0,1,0,1
IL,HR,2008.0,1,0,1
,KP,2020.0,2,0,2
RS,IN,2003.0,1,0,1
AT,RO,2001.0,1,0,1
ER,DE,2007.0,1,0,1
MA,MX,2022.0,1,0,1
IE,KG,2023.0,1,0,1
ZW,IE,2005.0,1,0,1
CH,BW,2020.0,1,0,1
UG,PH,2020.0,1,0,1
GR,BW,2020.0,1,0,1
NG,TW,2012.0,1,0,1
MY,JO,2023.0,1,0,1
NO,SD,2014.0,1,0,1
KE,NA,2022.0,1,0,1
MM,ES,2015.0,1,0,1
NZ,HK,2020.0,1,0,1
EG,FJ,2020.0,1,0,1
US,CN,2022.0,4478,2986,1492
CA,GB,2013.0,890,861,29
US,NZ,2018.0,399,453,-54
US,GB,1998.0,3030,2731,299
CA,CL,2018.0,27,21,6
AU,US,2012.0,1999,2356,-357
MY,PK,2021.0,88,77,11
DE,US,2009.0,2232,2355,-123
US,GB,1997.0,2457,2266,191
CL,PT,2012.0,17,3,14
GB,AT,2008.0,75,54,21
AU,IL,2012.0,18,17,1
CA,DE,2021.0,201,223,-22
JP,US,2010.0,1740,1792,-52
nan,PL,2011.0,5,5,0
JP,US,2019.0,1698,1794,-96
GB,CA,2001.0,458,421,37
KR,US,2009.0,1041,1200,-159
PH,DE,2016.0,12,9,3
ES,PT,2015.0,187,180,7
GB,BE,2007.0,81,87,-6
JP,GB,2004.0,204,277,-73
BE,US,2003.0,222,148,74
DE,DK,2011.0,146,127,19
JP,US,2017.0,1702,1891,-189
ES,US,2012.0,996,931,65
FR,CN,2009.0,283,201,82
US,HU,2011.0,114,102,12
BR,PT,2016.0,1013,1133,-120
TW,CN,2015.0,1363,929,434
CO,PH,2014.0,4,5,-1
ZA,US,2009.0,283,276,7
IT,CH,2015.0,365,218,147
CH,FR,2012.0,335,430,-95
TR,CO,2021.0,150,120,30
CN,NL,2003.0,33,32,1
CH,US,2014.0,820,910,-90
US,VN,2022.0,115,114,1
US,TR,2020.0,407,418,-11
CO,ES,2015.0,476,580,-104
IN,AU,2008.0,93,62,31
SE,NO,2009.0,103,54,49
CN,SG,2003.0,171,137,34
CN,CA,2013.0,432,541,-109
IT,MY,2010.0,52,38,14
RU,BG,2021.0,60,33,27
IN,SA,2019.0,181,104,77
JO,US,2000.0,12,13,-1
JP,BD,2013.0,73,44,29
TW,US,1998.0,294,402,-108
RO,ZA,2018.0,7,4,3
AT,CH,2011.0,84,80,4
AU,DE,2015.0,257,254,3
ES,DE,1997.0,44,50,-6
GB,FI,2010.0,57,46,11
AT,US,2013.0,218,251,-33
GB,RU,1999.0,39,63,-24
BE,MX,2020.0,8,10,-2
CH,GR,2005.0,17,2,15
US,PH,2018.0,311,363,-52
DE,PT,2009.0,44,31,13
GB,SG,2000.0,29,21,8
IN,GB,2003.0,176,169,7
MX,US,1998.0,130,122,8
GB,JP,2016.0,279,311,-32
UY,IT,2017.0,9,13,-4
CA,IQ,2019.0,14,14,0
IE,ES,2016.0,25,41,-16
CA,HU,2001.0,15,3,12
US,CO,2007.0,160,156,4
RU,SE,2002.0,41,32,9
CO,MX,1998.0,18,12,6
DK,IN,2005.0,6,5,1
ZA,SE,2019.0,28,17,11
IT,SE,2001.0,79,29,50
US,CR,2001.0,16,9,7
BE,DK,2013.0,52,18,34
DE,AU,2021.0,174,166,8
ZA,nan,2009.0,7,14,-7
JP,CA,2000.0,109,86,23
CW,NL,2015.0,26,11,15
US,PT,2014.0,198,165,33
IT,MY,2019.0,47,46,1
UA,RU,2013.0,243,185,58
MX,CO,2016.0,409,354,55
nan,GB,2000.0,25,53,-28
NZ,AU,2020.0,236,196,40
CA,ZA,2007.0,16,32,-16
GB,nan,2021.0,97,61,36
FR,JP,2019.0,212,186,26
AU,CN,2003.0,144,108,36
MK,AU,2013.0,55,55,0
FR,IT,2020.0,382,423,-41
AU,IN,2021.0,190,196,-6
CN,AU,2013.0,391,315,76
TR,IT,2013.0,26,15,11
JP,TW,2004.0,59,40,19
AR,US,2005.0,194,131,63
CN,IT,2020.0,53,51,2
TR,GB,2021.0,127,109,18
KR,DE,2003.0,19,26,-7
IT,US,2008.0,958,765,193
NP,US,2014.0,71,39,32
JP,PL,2017.0,18,23,-5
CA,IR,1998.0,9,2,7
IT,ES,1998.0,60,47,13
DE,MY,2013.0,17,10,7
BO,CN,2004.0,5,7,-2
AE,US,2015.0,58,86,-28
CA,MY,1998.0,1,3,-2
CN,ES,2021.0,54,65,-11
IN,JP,1999.0,106,77,29
DE,IE,2011.0,69,79,-10
ID,TR,2021.0,20,16,4
MX,VE,2006.0,31,32,-1
CH,CN,2008.0,63,61,2
AR,IT,2001.0,31,29,2
ES,BE,2005.0,28,34,-6
SE,JP,2021.0,28,25,3
UY,AR,2017.0,46,36,10
TH,GB,2002.0,14,30,-16
GB,TR,2015.0,127,116,11
JP,CR,2019.0,2,1,1
GR,CH,2001.0,4,10,-6
DE,IT,1999.0,94,124,-30
CO,CL,2021.0,191,155,36
DK,IT,2019.0,35,52,-17
PL,JP,1999.0,14,12,2
US,CY,1999.0,10,3,7
SG,SE,2014.0,10,15,-5
TH,KR,2015.0,12,15,-3
GP,FR,2013.0,14,21,-7
IE,CA,2018.0,178,166,12
DE,PY,2020.0,4,3,1
GB,IL,2019.0,63,79,-16
ZA,NZ,2007.0,11,10,1
FR,JP,2017.0,200,151,49
BE,RU,2018.0,19,21,-2
US,HK,2010.0,20,11,9
ES,CN,2011.0,76,77,-1
IE,CN,2014.0,45,52,-7
KR,CN,2007.0,234,171,63
JP,BE,2011.0,25,17,8
ID,AU,2013.0,30,66,-36
IL,GB,2015.0,74,58,16
ID,CN,2009.0,18,18,0
MY,FR,2004.0,6,2,4
QA,CN,2008.0,14,12,2
GB,NG,2012.0,39,42,-3
VN,CN,2011.0,46,40,6
NO,FI,2001.0,8,8,0
FR,PT,2015.0,47,66,-19
RU,AZ,2011.0,7,10,-3
MY,JO,2019.0,33,11,22
VN,US,2022.0,114,115,-1
FR,JP,2010.0,124,124,0
NO,GB,2016.0,93,103,-10
CU,CL,2017.0,30,19,11
AU,CH,2006.0,48,63,-15
ZA,KE,2018.0,48,33,15
GH,US,2014.0,27,30,-3
MX,UY,2016.0,20,20,0
PE,EC,2021.0,33,56,-23
CH,MX,2015.0,13,14,-1
EG,RU,2011.0,5,3,2
US,ID,2012.0,90,61,29
ID,DE,2017.0,18,59,-41
FR,IE,2011.0,29,37,-8
PK,AT,2010.0,6,10,-4
TR,CN,2002.0,10,9,1
US,QA,2013.0,58,23,35
BE,FR,1999.0,124,139,-15
AU,FI,2020.0,23,16,7
CU,CL,2019.0,37,20,17
FI,DE,2009.0,48,41,7
LT,US,2013.0,16,20,-4
JP,RU,2018.0,67,26,41
JP,TH,2013.0,119,57,62
BI,FR,2009.0,24,24,0
nan,MX,2017.0,33,41,-8
NZ,SA,2017.0,5,5,0
CO,MX,1997.0,6,7,-1
KE,HU,2019.0,2,1,1
BY,IN,2011.0,4,1,3
CA,EG,2019.0,95,84,11
IT,CL,2016.0,38,28,10
LB,FR,2022.0,64,39,25
DE,EG,2004.0,33,17,16
AR,PE,2020.0,66,68,-2
CZ,RU,2021.0,40,87,-47
CN,CH,2008.0,61,63,-2
IR,IN,2017.0,25,38,-13
ES,CZ,2018.0,29,21,8
US,UA,2019.0,116,113,3
US,CA,2023.0,84,96,-12
RU,CH,2019.0,45,45,0
MK,DE,2014.0,5,4,1
IT,NO,2013.0,26,17,9
AR,nan,2018.0,46,47,-1
ZA,BW,2021.0,6,12,-6
JP,LK,2007.0,17,11,6
SG,MM,2014.0,2,2,0
CZ,BE,2011.0,11,9,2
IT,PT,2016.0,55,35,20
RO,CA,2020.0,13,16,-3
KZ,US,2017.0,20,20,0
IE,NZ,2011.0,17,8,9
CL,GB,2003.0,4,16,-12
MY,NG,2015.0,81,45,36
US,MZ,2018.0,10,4,6
TW,US,1997.0,236,322,-86
EG,ID,2020.0,41,68,-27
MY,AE,2015.0,9,5,4
CN,ID,2021.0,233,214,19
PT,IT,2004.0,17,15,2
DE,BE,2002.0,58,65,-7
MY,LK,2011.0,1,1,0
GB,CZ,2004.0,16,14,2
BR,CA,2007.0,186,178,8
CA,EG,2017.0,111,65,46
GR,BR,2014.0,5,4,1
ID,JP,2021.0,157,164,-7
EG,ES,2013.0,4,5,-1
US,PL,1998.0,103,103,0
US,LV,2021.0,6,4,2
NZ,SG,2011.0,11,13,-2
BD,KR,2020.0,27,43,-16
CA,EG,2010.0,38,32,6
IL,FR,2001.0,32,30,2
IN,BR,2006.0,14,16,-2
KR,CA,2016.0,68,63,5
BR,US,2023.0,52,44,8
CZ,CH,2001.0,12,12,0
GB,SY,2010.0,9,2,7
MA,AE,2009.0,2,1,1
NO,BR,2012.0,25,19,6
AT,HU,1998.0,9,5,4
FR,NZ,2012.0,27,21,6
DE,LB,2004.0,3,1,2
CN,AT,2017.0,17,24,-7
CN,AT,2019.0,19,22,-3
AT,PL,2013.0,13,12,1
CN,UG,2018.0,3,1,2
PT,US,2009.0,116,108,8
NL,MX,2019.0,15,31,-16
SE,FR,1999.0,39,27,12
CH,NL,2004.0,58,58,0
FR,SA,2014.0,45,14,31
IN,nan,2009.0,35,23,12
PL,RO,2019.0,10,11,-1
PE,PT,2020.0,8,5,3
ID,DE,2019.0,41,50,-9
ZA,DE,2007.0,42,39,3
US,UA,2017.0,80,98,-18
DK,IT,2017.0,32,40,-8
CR,BR,2006.0,5,4,1
FI,RU,2017.0,40,33,7
BR,NG,2017.0,5,11,-6
CV,BR,2020.0,2,2,0
FR,NC,2021.0,11,16,-5
RS,GB,2015.0,23,20,3
GB,GH,2018.0,34,20,14
AT,PK,2017.0,13,5,8
AR,PA,2014.0,6,4,2
JP,CZ,2014.0,19,15,4
IN,SA,2010.0,57,22,35
PK,IN,2004.0,32,38,-6
PT,CO,2016.0,18,15,3
SI,HR,2020.0,41,42,-1
BE,KE,2018.0,5,6,-1
SE,DE,2022.0,115,142,-27
HR,SK,2012.0,4,3,1
UY,IT,2019.0,6,8,-2
NL,LU,2019.0,11,5,6
US,SG,2006.0,243,223,20
IN,AT,2002.0,21,10,11
PY,MX,2018.0,15,20,-5
NL,CN,2016.0,118,142,-24
FR,CI,2018.0,33,12,21
PL,SE,2019.0,39,22,17
SK,RS,2017.0,11,10,1
CY,GB,2023.0,2,1,1
LU,GB,2013.0,8,14,-6
FI,MD,2006.0,1,1,0
UG,AU,2017.0,10,4,6
TW,GB,2004.0,27,44,-17
RU,AU,2010.0,11,11,0
EG,CA,2009.0,29,35,-6
CN,FR,1999.0,45,72,-27
ES,AU,2018.0,68,68,0
BG,US,2021.0,21,20,1
AU,IE,2022.0,82,70,12
DE,HR,2006.0,13,17,-4
FR,FI,2013.0,24,23,1
GH,FI,2019.0,3,2,1
CH,PL,2016.0,38,30,8
IR,PK,2010.0,2,6,-4
ES,FR,2006.0,172,183,-11
MK,CN,2011.0,4,2,2
TR,ES,2020.0,9,21,-12
IR,BE,2022.0,18,9,9
ID,GB,2011.0,10,34,-24
RU,SE,2005.0,34,27,7
PT,NO,2020.0,8,6,2
ES,ZA,2021.0,6,6,0
IN,IT,2020.0,78,63,15
IR,PK,2019.0,21,20,1
PL,FR,2020.0,41,49,-8
CH,ZA,2023.0,5,1,4
GB,MX,2005.0,33,28,5
EC,CU,2021.0,19,18,1
HU,US,2022.0,49,42,7
AU,SE,2012.0,65,48,17
MY,SA,2016.0,81,33,48
CH,IE,2014.0,12,14,-2
RU,EE,2009.0,5,2,3
DZ,GB,2015.0,4,13,-9
FR,MC,2011.0,8,3,5
VN,GB,2018.0,10,22,-12
UA,SD,2020.0,2,2,0
IT,CR,2019.0,2,1,1
PT,RU,2020.0,24,13,11
BR,AO,2018.0,42,25,17
SA,CN,2013.0,12,22,-10
IT,AZ,2021.0,15,11,4
RU,BY,2003.0,23,21,2
PK,CN,2000.0,13,11,2
FI,EG,2011.0,2,1,1
CU,CR,2015.0,20,15,5
IR,DE,2014.0,92,58,34
PK,CH,2021.0,18,14,4
MY,IN,2022.0,76,46,30
DE,NL,2023.0,23,17,6
GB,QA,2021.0,31,22,9
AR,FR,2006.0,32,22,10
DE,SE,2016.0,277,196,81
DK,DE,2016.0,153,206,-53
NO,CA,2014.0,12,20,-8
JP,PL,2010.0,17,11,6
JP,ZA,2016.0,7,3,4
US,MK,2005.0,5,4,1
ES,BR,2001.0,124,84,40
FR,NG,2020.0,10,11,-1
CZ,PL,2016.0,61,52,9
TN,EG,2020.0,28,20,8
RU,CZ,2013.0,41,37,4
PL,CH,2018.0,45,27,18
RU,UA,2000.0,72,62,10
AT,MX,2013.0,3,6,-3
KW,GB,2010.0,14,12,2
AU,SK,2012.0,1,3,-2
AT,IN,1999.0,13,2,11
PL,SE,2017.0,23,21,2
AR,CA,2006.0,15,10,5
FI,AU,1999.0,7,9,-2
IN,CZ,2016.0,26,12,14
ZA,BE,2001.0,5,8,-3
PT,PY,2017.0,3,3,0
CA,RO,2002.0,4,4,0
FR,LU,2012.0,49,30,19
AU,nan,2013.0,26,44,-18
GB,PL,1998.0,29,16,13
FI,IN,2014.0,12,16,-4
CA,NL,2011.0,99,78,21
TT,JM,2009.0,13,8,5
GR,BE,2001.0,3,6,-3
AT,SE,2012.0,29,17,12
ZA,SE,2017.0,17,15,2
SI,ES,2013.0,11,14,-3
US,CZ,2006.0,82,111,-29
ME,RS,2018.0,19,19,0
DK,IT,2010.0,21,23,-2
AU,FJ,2001.0,4,2,2
ES,DE,1998.0,56,51,5
NG,KE,2022.0,7,7,0
ES,VE,2008.0,69,102,-33
IT,DK,2013.0,40,21,19
MX,EC,2013.0,30,14,16
FI,CH,2006.0,5,6,-1
FI,nan,2007.0,11,8,3
CO,VE,2022.0,8,11,-3
UY,CL,2015.0,18,10,8
FI,SE,2004.0,51,52,-1
GB,FI,2019.0,98,55,43
FR,KR,2011.0,32,40,-8
ET,SE,2017.0,3,6,-3
nan,EG,2019.0,11,8,3
LK,SE,2005.0,3,1,2
US,BW,2020.0,12,7,5
CU,AR,2021.0,15,10,5
BR,EG,2019.0,8,3,5
IE,NL,2022.0,14,8,6
SG,TH,2016.0,7,4,3
GR,CA,2013.0,18,7,11
VE,US,2021.0,21,26,-5
RU,AU,2017.0,24,51,-27
UA,FR,2006.0,12,9,3
MY,JO,2017.0,30,9,21
IT,nan,2021.0,36,63,-27
RS,TR,1999.0,14,11,3
UA,PL,2003.0,14,7,7
GB,PL,1997.0,21,22,-1
CA,SD,2018.0,3,1,2
SI,PL,2015.0,9,2,7
CA,TW,2013.0,42,48,-6
TN,QA,2011.0,1,1,0
NG,DK,2017.0,2,2,0
RU,CN,2012.0,53,58,-5
IR,ID,2015.0,11,5,6
DE,CZ,2001.0,18,28,-10
CH,KR,2003.0,4,3,1
BR,EC,2022.0,24,23,1
UZ,JP,2005.0,1,2,-1
GB,IL,2017.0,74,75,-1
US,GM,2018.0,2,3,-1
US,PL,1997.0,87,66,21
PH,JP,2000.0,12,11,1
AU,BE,2011.0,29,40,-11
PT,MY,2014.0,3,1,2
ES,SE,1997.0,12,11,1
IL,AT,2013.0,11,1,10
nan,IL,2005.0,11,14,-3
AT,PK,2010.0,10,6,4
CU,CO,2007.0,16,14,2
FR,MD,2012.0,35,65,-30
RU,NZ,2020.0,4,1,3
PT,CH,2007.0,7,7,0
IT,BG,2008.0,3,6,-3
TW,DE,2015.0,27,31,-4
JP,SA,2011.0,19,5,14
PL,HR,2022.0,2,2,0
DE,KZ,2015.0,7,6,1
GR,BD,2013.0,4,2,2
RU,AU,2019.0,24,39,-15
NI,GB,2015.0,2,1,1
DK,IN,2002.0,9,2,7
AT,PT,2017.0,1,7,-6
DK,NL,2018.0,63,71,-8
IS,IN,2019.0,1,3,-2
CO,DO,2019.0,9,5,4
BE,LU,2019.0,25,17,8
BY,FR,2007.0,1,2,-1
NO,GR,2011.0,5,2,3
RU,CH,2010.0,26,17,9
CZ,ES,2021.0,17,24,-7
LB,IQ,2020.0,4,7,-3
CN,MM,2004.0,7,14,-7
CZ,NO,2019.0,6,11,-5
US,HK,2017.0,14,14,0
PA,US,2022.0,27,14,13
AU,KR,2021.0,27,34,-7
CN,IQ,2018.0,14,6,8
BG,KZ,2018.0,4,1,3
MA,KW,2013.0,11,5,6
SG,NZ,2013.0,9,8,1
NO,CH,2013.0,22,32,-10
KZ,US,2019.0,30,28,2
GE,BE,2020.0,1,3,-2
FI,RU,2019.0,32,35,-3
EG,YE,2015.0,5,5,0
ID,BD,2022.0,24,19,5
DK,ID,2020.0,4,7,-3
ES,CR,2021.0,42,48,-6
CN,SL,2021.0,4,1,3
DE,TH,2012.0,21,18,3
ID,MA,2015.0,2,1,1
SA,BH,2020.0,18,13,5
DK,PL,2013.0,13,17,-4
CZ,NL,2022.0,9,2,7
GB,SY,2017.0,2,5,-3
IL,DE,2023.0,3,2,1
PK,MA,2016.0,19,18,1
KR,ID,2016.0,28,17,11
CY,UG,2018.0,1,1,0
IR,FI,2019.0,31,9,22
BD,IT,2007.0,2,1,1
SG,ES,2020.0,8,7,1
NG,ID,2013.0,4,3,1
KW,GB,2017.0,12,19,-7
JO,QA,2018.0,10,8,2
ZA,SI,2020.0,3,1,2
JP,AT,2012.0,18,13,5
KR,PE,2020.0,2,1,1
CU,PA,2010.0,1,1,0
CA,LK,2021.0,6,2,4
FI,CN,1999.0,7,4,3
CA,TR,2005.0,8,13,-5
BE,SE,2009.0,13,19,-6
RU,KZ,2009.0,9,10,-1
IL,NL,2006.0,18,8,10
SK,CA,2001.0,4,3,1
NO,nan,2016.0,40,26,14
DE,BE,2005.0,62,72,-10
US,HK,2019.0,10,18,-8
IR,IN,2019.0,25,47,-22
IT,MY,2017.0,35,46,-11
NG,IN,2018.0,16,23,-7
BE,FI,2016.0,8,13,-5
ES,FI,2011.0,23,16,7
US,LT,2008.0,8,10,-2
JP,NZ,2014.0,11,13,-2
MX,nan,2016.0,25,35,-10
KR,SA,2014.0,19,5,14
MX,CA,2011.0,33,33,0
FI,RU,2010.0,14,26,-12
TR,BR,2010.0,30,10,20
MW,ET,2018.0,3,2,1
SG,IR,2019.0,51,47,4
BR,NG,2019.0,12,6,6
PK,BG,2014.0,1,1,0
NG,NL,2021.0,8,4,4
NL,SE,2013.0,70,44,26
US,AM,2000.0,7,6,1
GB,JO,2014.0,23,12,11
CH,SG,2013.0,13,14,-1
CH,NO,2005.0,14,5,9
PY,US,2019.0,11,12,-1
BG,RS,2011.0,5,6,-1
CZ,DE,1999.0,23,21,2
UG,GB,2012.0,13,13,0
BG,RU,2003.0,12,14,-2
PL,MZ,2015.0,13,25,-12
MX,HN,2006.0,9,8,1
nan,DZ,2016.0,14,4,10
TZ,KE,2008.0,3,4,-1
GB,IL,2010.0,30,49,-19
SE,UA,2016.0,11,13,-2
BH,PL,2018.0,10,17,-7
CH,BE,2001.0,25,26,-1
IR,BD,2017.0,9,2,7
NO,LT,2008.0,2,1,1
VN,IT,2017.0,5,7,-2
NZ,NL,2022.0,8,6,2
MA,ZA,2020.0,1,4,-3
NC,US,2011.0,3,3,0
GR,FI,2009.0,1,4,-3
IQ,AE,2004.0,1,1,0
GR,MK,2005.0,3,4,-1
CG,GH,2019.0,1,1,0
FR,BY,2008.0,2,3,-1
TH,DE,2013.0,15,24,-9
IE,CZ,2018.0,6,5,1
DE,LU,2008.0,29,7,22
BE,LT,2006.0,1,2,-1
SA,PL,2015.0,6,2,4
KE,HU,2017.0,1,1,0
CU,CL,2010.0,17,12,5
ZA,ZW,2003.0,1,9,-8
ZA,JP,1997.0,2,4,-2
JP,MN,2008.0,4,3,1
GB,MX,2002.0,43,33,10
nan,IL,2002.0,13,9,4
RU,LV,2013.0,32,24,8
CZ,PT,2013.0,1,1,0
IE,AE,2016.0,5,3,2
JO,OM,2006.0,1,3,-2
NZ,DK,2010.0,12,4,8
FI,NO,2012.0,16,10,6
SE,IL,2006.0,6,5,1
UY,US,2012.0,16,27,-11
CN,DZ,2007.0,2,1,1
IN,AT,2005.0,26,4,22
AE,LB,2011.0,3,2,1
SE,NZ,1997.0,4,3,1
RO,BE,2001.0,9,3,6
IL,ZA,2008.0,1,1,0
CU,FR,2015.0,6,7,-1
CU,US,1998.0,7,11,-4
CU,IT,2013.0,6,2,4
DE,VN,2016.0,25,10,15
RO,BG,2019.0,4,1,3
RU,IN,2003.0,5,3,2
QA,ES,2018.0,12,8,4
RS,NL,2009.0,5,1,4
BE,LU,2010.0,13,12,1
nan,MX,2019.0,36,37,-1
BE,EG,2017.0,7,3,4
IL,CH,2011.0,19,11,8
CU,US,1997.0,12,4,8
US,VE,2004.0,32,53,-21
MN,JP,2005.0,1,2,-1
CU,PA,2017.0,2,1,1
KR,PH,2005.0,2,3,-1
IN,TZ,2021.0,2,4,-2
CL,ID,2018.0,13,13,0
TR,SA,2018.0,21,18,3
TR,IE,2004.0,2,1,1
RS,DE,2022.0,13,14,-1
LU,JP,2020.0,2,3,-1
SD,IQ,2018.0,7,3,4
CL,IT,2014.0,22,23,-1
GE,JP,2007.0,1,1,0
JO,TR,2007.0,3,2,1
nan,TH,2012.0,3,1,2
IN,RU,2013.0,11,21,-10
CN,AT,2010.0,15,15,0
CO,PT,2006.0,3,4,-1
PY,CU,1997.0,5,2,3
BR,VE,2004.0,8,8,0
RS,HR,1999.0,16,12,4
ID,IT,2014.0,4,11,-7
ID,LB,2021.0,5,3,2
LU,BE,2011.0,8,24,-16
PK,nan,2015.0,5,5,0
AR,PT,2016.0,12,14,-2
US,GH,2009.0,6,8,-2
FR,PK,2006.0,4,3,1
PL,SE,2010.0,20,14,6
UA,SK,2018.0,6,7,-1
CN,IL,2000.0,15,5,10
PK,FR,2016.0,12,26,-14
SK,RS,2019.0,15,6,9
DE,GE,2012.0,4,4,0
PE,DE,2015.0,12,10,2
nan,CL,2009.0,1,4,-3
VN,IN,2015.0,4,3,1
RU,ID,2021.0,30,14,16
BR,nan,2000.0,8,13,-5
FI,DK,2014.0,24,15,9
SG,DK,2016.0,5,3,2
HR,IE,2012.0,5,5,0
US,OM,2021.0,11,7,4
JO,MY,2022.0,8,20,-12
FR,EC,2005.0,1,3,-2
US,SY,2013.0,4,20,-16
IT,CU,2011.0,2,4,-2
AT,AU,1998.0,2,1,1
CN,IR,2001.0,2,3,-1
US,ZW,2002.0,2,5,-3
VN,IE,2021.0,3,2,1
EG,AU,2016.0,15,20,-5
DE,AR,2018.0,48,52,-4
ID,FR,2015.0,14,38,-24
PL,BA,2019.0,3,3,0
CN,HU,2004.0,6,3,3
ES,PL,2020.0,26,29,-3
KG,US,2012.0,6,1,5
TR,BR,2017.0,24,20,4
IT,TW,2022.0,5,5,0
AL,IT,2009.0,1,2,-1
SK,NL,2016.0,7,4,3
AR,GB,2009.0,19,26,-7
US,UA,2010.0,52,32,20
PL,ES,2011.0,15,12,3
BE,EG,2019.0,13,5,8
US,BH,2012.0,4,6,-2
CO,KR,2010.0,9,5,4
IT,VE,2001.0,3,2,1
HU,IQ,2020.0,3,6,-3
ID,IE,2020.0,4,5,-1
CN,RU,2022.0,33,35,-2
AT,PK,2019.0,5,1,4
EC,BR,2015.0,8,31,-23
HU,GB,2009.0,48,40,8
MY,AU,2011.0,58,80,-22
FR,CG,2002.0,7,7,0
TW,TR,2006.0,13,8,5
RS,IT,2002.0,2,2,0
IL,AU,2008.0,13,10,3
DZ,SA,2009.0,5,1,4
LU,DE,2013.0,27,33,-6
GB,KW,2016.0,18,12,6
NL,LU,2010.0,2,2,0
RS,CA,2001.0,4,4,0
SE,NL,2001.0,29,29,0
CA,RO,2005.0,3,9,-6
NG,GH,2009.0,2,4,-2
PR,ET,2013.0,5,2,3
PY,US,2010.0,4,1,3
BR,DE,1998.0,26,39,-13
US,AL,2019.0,4,4,0
CR,RU,2020.0,4,1,3
JP,DK,2014.0,17,14,3
IL,IQ,2018.0,4,3,1
ES,RO,2016.0,9,20,-11
TR,RU,2022.0,8,6,2
ML,CH,2019.0,3,1,2
CI,FR,2001.0,5,5,0
BD,DE,1999.0,5,1,4
OM,SA,2020.0,14,13,1
PK,AT,2017.0,5,13,-8
CN,LK,2021.0,9,3,6
UY,AR,2019.0,49,56,-7
GB,IT,2023.0,30,33,-3
PT,CN,2018.0,13,9,4
UZ,RU,2001.0,10,6,4
CH,IL,1999.0,11,5,6
BH,KR,2012.0,1,1,0
IT,AM,2006.0,13,12,1
US,PY,2021.0,9,7,2
KW,MA,2008.0,4,4,0
DZ,MY,2017.0,1,7,-6
US,AL,2010.0,5,2,3
PK,DK,2021.0,10,14,-4
PA,MX,2003.0,2,4,-2
ET,ZW,2021.0,3,1,2
PE,BR,2008.0,17,18,-1
LT,FR,2020.0,5,3,2
SE,MZ,2016.0,2,1,1
NO,IS,2002.0,6,1,5
TR,BR,2019.0,13,14,-1
CZ,RS,2016.0,12,15,-3
NL,MX,2017.0,19,17,2
CH,HR,2007.0,4,2,2
CZ,UZ,2021.0,2,1,1
HU,AT,1998.0,5,9,-4
SG,NL,2014.0,9,24,-15
IL,CL,2020.0,5,2,3
AT,AU,1997.0,4,4,0
nan,PK,2015.0,5,5,0
GB,LV,2006.0,2,1,1
SA,NL,2014.0,3,8,-5
RO,NL,2003.0,6,2,4
ZA,ID,2015.0,12,9,3
TW,ES,2012.0,2,3,-1
FR,IR,2006.0,16,9,7
DE,BY,2005.0,5,7,-2
IR,PK,2017.0,19,13,6
nan,DK,2022.0,9,4,5
NZ,TH,2016.0,8,4,4
HU,AE,2016.0,2,2,0
ZW,ZA,2003.0,9,1,8
US,DK,2023.0,13,7,6
BE,LU,2017.0,18,18,0
UA,CA,2008.0,4,6,-2
RU,CH,2017.0,31,45,-14
ES,SE,1998.0,16,12,4
MN,PL,2018.0,2,5,-3
FI,EE,2016.0,14,16,-2
ZA,SE,2010.0,8,11,-3
CH,GR,2002.0,8,5,3
TH,AU,2012.0,14,33,-19
GB,ET,2015.0,12,5,7
FI,ZA,2022.0,2,3,-1
ET,SE,2010.0,6,2,4
AU,AE,1999.0,2,2,0
AE,IN,2008.0,5,7,-2
FI,JP,2000.0,15,8,7
TH,GB,2005.0,20,43,-23
SK,GB,2012.0,18,17,1
SN,GN,2014.0,3,4,-1
ZW,DE,2020.0,1,1,0
CN,CL,2021.0,3,2,1
HR,SE,2016.0,4,1,3
AR,IN,2016.0,3,2,1
KE,SD,2019.0,1,1,0
AU,TR,2018.0,16,18,-2
MX,PA,2000.0,1,2,-1
nan,MX,2010.0,12,24,-12
BR,EG,2010.0,2,1,1
HN,ES,1999.0,2,2,0
NO,SJ,2004.0,6,1,5
ES,BD,1999.0,1,2,-1
BR,TW,2002.0,2,1,1
BR,DE,1997.0,19,29,-10
CN,SI,2018.0,5,5,0
HT,FR,2014.0,2,2,0
MX,HR,2013.0,2,1,1
CH,PT,2012.0,15,9,6
PL,PK,2005.0,5,3,2
PS,GB,2020.0,7,7,0
CH,RS,2004.0,3,5,-2
UG,CZ,2020.0,1,3,-2
CO,CZ,2022.0,3,2,1
CR,IL,2008.0,3,1,2
BN,MY,2013.0,8,4,4
ZM,JP,2005.0,3,2,1
NL,AR,1998.0,1,5,-4
EC,VE,2011.0,3,2,1
DE,nan,2003.0,24,26,-2
MY,NI,2018.0,5,1,4
US,LB,1998.0,6,4,2
MY,JO,2010.0,6,7,-1
PK,CA,2006.0,6,11,-5
SG,MY,1999.0,7,8,-1
IE,FI,2009.0,4,1,3
US,TW,2023.0,19,30,-11
IE,RO,2020.0,7,4,3
SG,PK,2020.0,11,6,5
FR,HR,2005.0,2,3,-1
RS,BG,2015.0,1,4,-3
CA,IQ,2010.0,2,1,1
CU,PY,2016.0,5,2,3
ET,FR,2019.0,6,4,2
SG,DE,2006.0,12,26,-14
BR,EG,2017.0,5,3,2
MK,US,2007.0,4,4,0
BA,CH,2018.0,1,1,0
ES,BE,2002.0,13,29,-16
AU,KE,2018.0,7,13,-6
LT,IT,2014.0,2,4,-2
UA,EC,2020.0,14,21,-7
CN,ZM,2017.0,2,1,1
CL,VE,2009.0,12,21,-9
AU,RS,2020.0,5,10,-5
PH,SG,2007.0,2,2,0
RO,BG,2010.0,1,2,-1
ES,PA,2020.0,17,16,1
TR,AR,2014.0,2,5,-3
BR,IN,2008.0,12,17,-5
CL,NZ,2019.0,6,4,2
BE,PH,2007.0,1,1,0
SG,NO,2015.0,4,3,1
PA,NL,2012.0,1,3,-2
NZ,BY,2018.0,1,1,0
CA,ID,2006.0,3,6,-3
KE,GB,2006.0,17,18,-1
PK,KR,2023.0,6,3,3
BD,IN,2000.0,9,6,3
GB,SY,2019.0,5,6,-1
ET,SE,2019.0,9,5,4
OM,AU,2015.0,3,2,1
CO,IT,2003.0,2,1,1
BY,PL,2015.0,3,7,-4
ES,GR,2005.0,9,3,6
KE,SE,2008.0,3,4,-1
SE,BD,2012.0,6,7,-1
SI,SE,2016.0,7,3,4
NL,KE,2020.0,9,5,4
JP,PL,2019.0,20,19,1
BE,HU,2004.0,9,8,1
FI,BE,2006.0,8,5,3
ET,NZ,2012.0,1,1,0
MY,IE,2020.0,4,10,-6
NO,IN,2000.0,28,25,3
CN,LU,2013.0,2,4,-2
TH,ID,2014.0,9,9,0
IL,GR,2010.0,3,2,1
CU,BE,2014.0,2,1,1
CR,FR,2018.0,4,9,-5
PK,PL,2012.0,5,4,1
NL,MX,2010.0,4,12,-8
SI,AT,2004.0,5,2,3
KW,IQ,2018.0,8,5,3
SA,PH,2020.0,2,3,-1
VN,CA,2003.0,2,2,0
ZW,US,2013.0,9,7,2
BR,TR,2015.0,14,33,-19
NI,BR,2017.0,5,2,3
IR,BD,2019.0,6,3,3
GR,RU,2018.0,7,5,2
AE,NL,2015.0,1,5,-4
NL,KR,2013.0,17,8,9
RO,IT,2012.0,7,16,-9
BR,CU,2006.0,9,13,-4
HU,FR,2020.0,9,22,-13
DK,PT,2016.0,4,15,-11
KZ,ES,2020.0,1,3,-2
NL,ES,2000.0,30,38,-8
IR,IN,2010.0,16,27,-11
PA,ES,2003.0,8,7,1
RO,GB,2011.0,29,27,2
LU,CH,2014.0,8,5,3
LB,CH,2005.0,1,1,0
MX,BO,2021.0,9,4,5
PL,GR,2011.0,12,6,6
NZ,DE,2004.0,10,21,-11
IT,NG,2012.0,9,10,-1
CH,EC,2019.0,7,2,5
PL,HU,2003.0,3,7,-4
CN,ZM,2010.0,2,2,0
BR,AT,2014.0,16,16,0
JP,CO,2006.0,5,10,-5
DE,MX,2001.0,16,9,7
PL,RO,2010.0,7,10,-3
BR,CH,1998.0,6,17,-11
PG,AU,2005.0,3,1,2
PH,NL,2009.0,4,4,0
RO,CZ,2022.0,2,1,1
UG,AU,2019.0,6,5,1
RU,MY,2007.0,3,5,-2
GA,NL,2020.0,4,2,2
CZ,NO,2010.0,7,5,2
SI,CZ,2014.0,9,9,0
UZ,JP,2002.0,3,3,0
UA,MD,2009.0,1,2,-1
CO,DO,2017.0,5,5,0
PL,MX,2012.0,3,9,-6
CZ,CN,2021.0,6,19,-13
MC,FR,2004.0,4,4,0
BD,PK,2008.0,12,21,-9
TW,MX,2000.0,2,1,1
IN,ES,1999.0,4,5,-1
US,NA,2018.0,4,5,-1
CA,FI,2007.0,15,14,1
ZA,PT,2011.0,2,1,1
KR,PH,2002.0,1,3,-2
MA,CI,2017.0,2,2,0
GB,PK,1999.0,15,26,-11
AF,JP,2022.0,2,2,0
DK,IS,2003.0,3,2,1
AM,KR,2009.0,12,6,6
CO,SA,2019.0,2,1,1
KE,IN,2013.0,11,2,9
IT,CR,2017.0,5,3,2
ID,NZ,2017.0,5,5,0
SA,PK,1999.0,7,3,4
EG,MA,2003.0,2,3,-1
BO,CO,2008.0,3,5,-2
CZ,NO,2017.0,11,10,1
AR,EC,2007.0,5,2,3
IT,PH,2018.0,6,4,2
DK,SG,2014.0,7,7,0
CA,MY,1997.0,4,1,3
CR,IT,2018.0,4,2,2
SE,RO,2006.0,2,5,-3
US,UY,2006.0,16,17,-1
MK,SA,2020.0,4,1,3
TH,SE,2012.0,3,4,-1
DK,JP,2000.0,14,12,2
KZ,CN,2022.0,8,7,1
IS,IN,2017.0,2,1,1
MA,LB,2015.0,2,2,0
IQ,JP,2003.0,3,1,2
CA,IR,1997.0,3,5,-2
HN,PH,2019.0,1,1,0
BE,MA,2021.0,7,3,4
BR,CR,2008.0,5,3,2
AU,JO,2022.0,4,2,2
PK,DZ,2019.0,1,5,-4
UZ,BY,2013.0,1,2,-1
UG,NG,2016.0,5,8,-3
IR,BD,2010.0,1,3,-2
IL,AR,1998.0,5,1,4
KZ,PL,2022.0,8,2,6
PS,CN,2013.0,1,1,0
TN,RO,2022.0,1,1,0
CO,DO,2010.0,2,3,-1
SI,CN,2018.0,5,5,0
HU,RU,2009.0,8,6,2
nan,PT,2005.0,13,10,3
DK,TZ,2013.0,2,2,0
NO,ET,2021.0,8,7,1
BG,IL,2013.0,1,1,0
IL,TR,2007.0,3,5,-2
DE,CO,2001.0,4,4,0
PT,DE,2005.0,16,28,-12
CA,TR,2002.0,5,9,-4
RS,NO,2007.0,2,1,1
PK,NO,2015.0,7,6,1
BR,PY,1998.0,5,4,1
AU,PG,2020.0,4,8,-4
ZM,BR,2012.0,5,1,4
IN,JO,2006.0,1,1,0
RS,ME,2022.0,11,12,-1
BG,IT,2015.0,9,6,3
RS,CZ,2022.0,8,4,4
FR,MZ,2019.0,2,3,-1
UA,LV,2018.0,3,2,1
AT,VN,2022.0,1,1,0
MX,VN,2001.0,6,1,5
FR,CF,2015.0,1,1,0
NZ,JP,2021.0,4,6,-2
AR,ZA,2013.0,1,1,0
OM,GB,2007.0,2,14,-12
SG,KR,2006.0,19,17,2
IE,DE,1997.0,7,15,-8
IT,TN,2009.0,4,8,-4
GB,ZM,2012.0,3,5,-2
nan,EG,2010.0,3,4,-1
PT,CL,2008.0,8,7,1
TT,IN,2013.0,4,9,-5
SE,ZA,2021.0,10,20,-10
HN,BR,2015.0,5,1,4
ID,SE,2015.0,5,12,-7
BE,TH,2022.0,3,3,0
US,MW,2003.0,6,2,4
NL,ZW,2017.0,3,1,2
HR,DE,2000.0,8,18,-10
LT,CN,2004.0,1,11,-10
PL,BA,2010.0,4,6,-2
NL,TW,2008.0,3,2,1
CH,NO,2002.0,14,5,9
SI,BA,2021.0,3,3,0
nan,PT,2002.0,5,9,-4
EE,LT,2021.0,1,1,0
CO,KR,2017.0,2,2,0
TR,MM,2021.0,10,10,0
BE,JP,2011.0,17,25,-8
SN,BE,2014.0,3,2,1
KE,IL,2011.0,2,2,0
US,MG,2016.0,3,3,0
US,MA,2001.0,8,11,-3
GB,RO,2003.0,3,13,-10
TG,CG,2016.0,1,1,0
SK,RS,2010.0,8,2,6
ES,RU,2001.0,7,11,-4
LK,JP,2022.0,4,16,-12
DK,AR,2013.0,2,4,-2
CL,UY,2007.0,5,9,-4
KW,OM,2008.0,2,2,0
CA,PL,2004.0,11,11,0
CH,IN,1999.0,7,5,2
BW,US,2001.0,2,3,-1
ZA,DK,2018.0,10,8,2
RO,UA,2012.0,1,1,0
SY,US,2003.0,4,1,3
TH,nan,2016.0,3,3,0
EG,GB,2001.0,14,14,0
nan,FI,2012.0,4,7,-3
SE,LK,2005.0,1,3,-2
FI,SG,2013.0,2,1,1
LV,SE,2008.0,2,3,-1
AU,PA,2018.0,3,4,-1
CN,AE,2012.0,2,4,-2
NZ,BD,2014.0,5,6,-1
AO,IT,2015.0,1,3,-2
CN,ZM,2019.0,2,2,0
CR,CL,2004.0,10,8,2
AR,AU,2015.0,6,11,-5
SE,CR,2001.0,4,1,3
NG,NZ,2004.0,1,1,0
IE,DE,1998.0,16,17,-1
FR,CU,2018.0,5,12,-7
SE,EE,2013.0,8,8,0
ME,US,2020.0,3,1,2
BD,JO,2022.0,1,2,-1
TN,BE,2020.0,8,8,0
GE,FR,2020.0,2,2,0
PS,LB,2017.0,4,1,3
AU,GE,2012.0,2,2,0
TH,DK,2006.0,1,3,-2
AT,HU,1997.0,4,1,3
MA,nan,2020.0,5,6,-1
ID,DE,2010.0,8,22,-14
SI,BE,2020.0,6,6,0
GR,DK,2006.0,8,2,6
PK,BD,2004.0,5,2,3
SE,CO,2005.0,2,5,-3
BR,CH,1997.0,4,15,-11
BE,SG,2021.0,9,8,1
NL,EE,2010.0,3,1,2
CN,CO,2018.0,4,5,-1
SN,US,2009.0,8,5,3
NL,EE,2019.0,5,2,3
CU,EC,2012.0,5,2,3
PK,IR,2012.0,7,13,-6
HR,IN,2003.0,2,3,-1
CU,DO,2013.0,2,1,1
IR,GB,2000.0,4,24,-20
BE,EG,2010.0,2,6,-4
VN,IT,2019.0,5,4,1
SI,AU,2011.0,2,1,1
UA,SA,2016.0,1,1,0
BG,AT,2020.0,5,1,4
AT,AR,2020.0,3,11,-8
CR,CH,2020.0,1,4,-3
CU,PE,1999.0,2,1,1
RO,ID,2013.0,3,2,1
GB,TT,1998.0,4,1,3
GR,LK,2013.0,3,6,-3
BG,CZ,2010.0,2,3,-1
SG,SA,2012.0,4,2,2
PT,IL,2019.0,5,7,-2
UA,SE,2014.0,8,10,-2
IR,CY,2007.0,1,1,0
PL,RO,2017.0,9,7,2
DZ,nan,2012.0,3,5,-2
PS,LB,2019.0,4,1,3
NZ,SA,2019.0,4,4,0
US,ZW,2005.0,4,13,-9
PE,IT,2018.0,3,6,-3
RO,GR,2013.0,3,4,-1
IS,IN,2010.0,3,1,2
AZ,DE,2005.0,1,2,-1
IN,TR,2000.0,3,2,1
SA,FR,2001.0,7,1,6
CH,TN,2016.0,6,6,0
EE,JP,2013.0,2,1,1
TZ,FR,2006.0,3,5,-2
KW,LB,2017.0,2,3,-1
IL,PH,2016.0,4,3,1
IL,PE,2018.0,2,2,0
BE,BG,2007.0,4,6,-2
FK,GB,2020.0,1,1,0
CN,MK,2014.0,2,4,-2
EE,CN,2018.0,3,2,1
FR,BD,2020.0,5,6,-1
UZ,IN,2009.0,2,1,1
SE,PT,2022.0,9,17,-8
AG,JP,2020.0,8,5,3
MN,US,2015.0,5,6,-1
GR,MK,2002.0,1,1,0
KE,ML,2008.0,1,1,0
KE,SD,2017.0,1,2,-1
SK,BR,2018.0,2,3,-1
AG,GB,2020.0,1,4,-3
BG,CZ,2017.0,3,1,2
BR,RO,2012.0,2,1,1
US,AL,2017.0,2,7,-5
IQ,JO,2012.0,1,7,-6
MT,CN,2003.0,1,1,0
nan,CA,2001.0,7,13,-6
TH,BE,2015.0,2,5,-3
NO,EG,2015.0,1,2,-1
NO,JP,2002.0,6,3,3
NZ,FR,1998.0,5,7,-2
AT,EE,2004.0,2,1,1
GH,EG,2010.0,4,3,1
TR,AZ,2008.0,5,3,2
NO,IS,2005.0,3,1,2
BA,SE,2020.0,3,1,2
IS,CH,2000.0,1,1,0
NO,BA,2006.0,1,1,0
TW,BE,2007.0,3,2,1
NL,ZW,2010.0,1,3,-2
CN,BY,2012.0,3,2,1
NO,JP,2005.0,5,6,-1
DE,BY,2002.0,4,22,-18
AU,VG,2008.0,2,2,0
JM,AU,2020.0,1,2,-1
BJ,SN,2015.0,2,4,-2
CH,KE,2012.0,3,1,2
HK,JP,2007.0,3,6,-3
BE,PK,2014.0,2,2,0
NL,LU,2017.0,3,4,-1
ES,UY,2001.0,12,10,2
KW,BH,2013.0,1,1,0
UY,PE,2013.0,3,3,0
TR,AT,2006.0,5,8,-3
DK,RU,2022.0,3,12,-9
KW,GB,2019.0,10,17,-7
TZ,EG,2011.0,1,1,0
KR,HU,2018.0,5,1,4
PG,AU,2002.0,3,2,1
TZ,CA,2014.0,1,2,-1
VE,NL,2011.0,2,2,0
PL,BA,2017.0,3,4,-1
IN,LT,2017.0,3,2,1
NL,EE,2017.0,3,3,0
US,AO,2013.0,1,3,-2
MZ,UA,2019.0,3,2,1
IS,AT,2010.0,1,1,0
PK,UA,2022.0,2,3,-1
GB,FK,2012.0,1,1,0
IE,DK,2005.0,3,4,-1
CH,BG,2022.0,2,3,-1
LY,ET,2014.0,1,1,0
AR,NO,2015.0,1,1,0
SE,MX,2016.0,9,16,-7
BD,FR,2011.0,3,7,-4
ID,nan,2008.0,2,2,0
LA,GB,2013.0,2,1,1
JP,GH,2000.0,1,2,-1
NZ,UG,2012.0,2,4,-2
BS,US,2015.0,3,2,1
IT,SY,1998.0,2,1,1
KE,CZ,1997.0,1,1,0
RO,MA,2005.0,1,1,0
nan,RO,2002.0,1,2,-1
BJ,BE,2015.0,3,3,0
NG,JP,2008.0,2,3,-1
CW,DE,2015.0,3,3,0
IT,SM,2011.0,3,2,1
SK,UA,2015.0,3,2,1
KR,SK,2009.0,2,1,1
PH,AR,2017.0,2,2,0
NP,DE,2004.0,1,2,-1
IN,GD,2018.0,1,1,0
RO,BG,2017.0,2,2,0
LT,ES,2019.0,2,3,-1
UA,BE,2022.0,1,2,-1
GT,BR,2021.0,4,2,2
ES,LT,2015.0,2,2,0
TR,UZ,2019.0,1,1,0
GB,EE,1998.0,2,1,1
DO,AR,2004.0,1,1,0
PA,GB,2014.0,2,6,-4
AR,PK,2002.0,3,1,2
SK,RU,2005.0,6,8,-2
AU,LK,1997.0,2,1,1
AR,FI,2013.0,1,2,-1
RW,NL,2019.0,2,2,0
AE,AU,2009.0,4,10,-6
MY,YE,2023.0,2,1,1
CM,SN,2018.0,2,3,-1
RO,FI,2019.0,3,3,0
PA,ID,2021.0,1,3,-2
TZ,ES,2002.0,2,1,1
PH,AR,2010.0,2,1,1
SA,IT,2015.0,2,20,-18
SA,LB,1997.0,1,1,0
CA,TT,2021.0,2,3,-1
TR,BG,2004.0,1,1,0
KR,TR,2013.0,6,3,3
TR,NG,2018.0,4,3,1
BG,ID,2019.0,2,3,-1
nan,EG,2017.0,5,8,-3
NG,AU,2022.0,6,7,-1
CA,SK,2020.0,3,1,2
JO,RO,2005.0,1,1,0
MX,DK,2005.0,1,1,0
NL,EG,2007.0,2,4,-2
CZ,KR,2004.0,3,2,1
CM,IT,2006.0,1,3,-2
GE,ZA,2020.0,1,1,0
CR,SE,1997.0,1,1,0
FI,BR,2005.0,2,1,1
LY,AE,2019.0,2,2,0
BD,KW,2012.0,3,3,0
PE,DO,2020.0,2,6,-4
SD,SS,2006.0,1,2,-1
CO,HN,2011.0,4,2,2
NO,PH,2002.0,1,1,0
ZM,ZW,2018.0,3,4,-1
ZA,FI,2005.0,1,1,0
CO,SA,2017.0,3,1,2
RW,TR,2018.0,2,1,1
BR,PY,1997.0,2,2,0
AR,DO,2020.0,2,1,1
VE,CR,2008.0,1,2,-1
DE,CR,2011.0,2,7,-5
MX,PK,2012.0,2,2,0
HR,FR,2019.0,8,5,3
IR,AT,2004.0,2,1,1
LT,KH,2015.0,1,1,0
BR,TG,2020.0,1,2,-1
IL,BR,1997.0,1,1,0
CA,PG,2015.0,1,2,-1
SK,HU,2009.0,3,9,-6
AE,OM,2013.0,2,11,-9
US,LB,1997.0,5,1,4
SA,TR,2004.0,3,3,0
MA,IQ,2021.0,3,3,0
ZA,GH,2013.0,3,5,-2
BR,DK,2000.0,2,3,-1
RO,DK,2004.0,2,2,0
CM,CH,2008.0,2,1,1
ZA,GR,2002.0,1,3,-2
KZ,US,2010.0,4,2,2
UG,ET,2015.0,1,3,-2
BE,TW,2018.0,2,3,-1
NL,NG,2009.0,4,3,1
CR,AR,2022.0,3,7,-4
PH,AR,2019.0,2,2,0
BG,IN,2022.0,3,1,2
UY,JP,2003.0,1,1,0
HU,AT,1997.0,1,4,-3
DK,CZ,2014.0,3,11,-8
CL,NZ,2010.0,4,2,2
GB,BM,2012.0,2,1,1
SA,KW,2008.0,2,3,-1
EE,NO,2013.0,1,1,0
ZW,CH,2020.0,1,2,-1
SE,SI,2014.0,2,2,0
HU,EG,2001.0,3,1,2
IE,GR,1999.0,1,1,0
DZ,BE,2014.0,3,4,-1
IN,FJ,2003.0,1,1,0
ZA,IR,2012.0,1,5,-4
MV,IN,2020.0,1,3,-2
SA,IL,2018.0,1,3,-2
TW,IR,2007.0,1,1,0
CA,CR,1998.0,1,1,0
BD,NZ,2014.0,6,5,1
HU,PK,2022.0,1,2,-1
GB,CM,2007.0,1,6,-5
US,BM,2001.0,2,1,1
IL,UA,2014.0,5,4,1
IE,HR,2003.0,3,4,-1
UA,BY,2007.0,3,7,-4
AU,LB,2003.0,2,1,1
ET,JP,2021.0,1,3,-2
PT,IR,2020.0,8,19,-11
MV,GB,2018.0,1,1,0
CH,PH,2020.0,3,2,1
ME,HR,2012.0,1,2,-1
UG,NL,2007.0,1,3,-2
NE,DE,2016.0,1,1,0
SD,JP,2016.0,2,1,1
NP,IT,2018.0,2,4,-2
LT,SE,2003.0,5,3,2
EC,MX,1999.0,1,1,0
US,BJ,2021.0,1,4,-3
IT,VN,2016.0,4,6,-2
HU,CZ,2006.0,2,5,-3
NL,GA,2015.0,3,4,-1
SE,TZ,2009.0,2,2,0
FR,EC,2002.0,1,2,-1
UA,SI,1999.0,2,1,1
PY,US,2017.0,5,5,0
NA,US,2011.0,1,1,0
BH,AU,2019.0,1,1,0
EE,RU,2004.0,1,1,0
FR,LV,2014.0,1,1,0
UG,CN,2016.0,3,4,-1
LT,AT,2022.0,1,1,0
DE,CY,2008.0,5,2,3
BJ,US,2006.0,1,3,-2
CY,IE,2018.0,2,1,1
NZ,CL,2021.0,4,2,2
IT,LB,2008.0,3,2,1
SE,IQ,2022.0,1,3,-2
BR,ZA,1997.0,2,1,1
BH,IE,2016.0,1,2,-1
PA,IN,2019.0,1,3,-2
NO,CO,2022.0,1,4,-3
KW,IR,2021.0,1,1,0
CH,DZ,2013.0,1,2,-1
TN,SE,2013.0,1,1,0
ZA,BR,2022.0,7,12,-5
IN,ER,2019.0,2,1,1
MM,GB,2021.0,1,4,-3
CL,ZA,2013.0,2,3,-1
LU,PT,2016.0,1,1,0
GH,BE,2018.0,2,2,0
NO,TR,2014.0,7,9,-2
PA,NO,2019.0,1,1,0
JP,NG,2009.0,1,3,-2
nan,CZ,2000.0,2,2,0
FI,QA,2015.0,2,1,1
IE,DK,2002.0,3,2,1
HR,FR,2010.0,2,2,0
UG,AU,2010.0,1,2,-1
CL,US,2015.0,241,232,9
US,MX,2003.0,226,195,31
US,SE,1997.0,147,201,-54
IT,DE,2012.0,324,211,113
BE,NL,2000.0,113,88,25
US,FI,2000.0,94,109,-15
CH,CA,2019.0,126,163,-37
NL,US,2012.0,681,763,-82
AR,CO,2007.0,34,40,-6
US,SE,1998.0,174,250,-76
HU,RO,2008.0,34,20,14
DE,JP,2012.0,171,217,-46
EG,SE,2015.0,7,3,4
BR,CN,2004.0,15,23,-8
BR,NO,2015.0,25,22,3
CH,CA,2017.0,122,129,-7
AR,US,2002.0,137,122,15
CO,FR,2012.0,36,33,3
CZ,AT,2014.0,27,22,5
FR,GB,2000.0,300,234,66
IT,ES,1997.0,36,39,-3
CN,PL,2014.0,47,27,20
NG,CA,2021.0,18,14,4
CN,LB,2012.0,31,31,0
MY,CN,2011.0,34,45,-11
IR,TR,2021.0,72,22,50
GB,FI,2017.0,66,89,-23
CA,MA,2016.0,17,17,0
CH,CA,2010.0,102,121,-19
RU,IT,2001.0,20,11,9
EG,LY,2020.0,12,5,7
KR,nan,2020.0,33,30,3
TN,DZ,2014.0,27,22,5
DK,GB,2021.0,108,168,-60
IT,SI,2001.0,5,2,3
SG,IR,2017.0,33,39,-6
KE,FR,2020.0,6,11,-5
nan,FR,2020.0,161,137,24
JO,AE,2016.0,20,11,9
IT,FI,2021.0,49,23,26
FR,CM,2016.0,30,20,10
RU,NL,2003.0,25,22,3
FR,TW,2020.0,12,6,6
GB,KE,2021.0,32,29,3
TH,US,2004.0,58,140,-82
UY,AR,2010.0,21,26,-5
CU,PA,2019.0,6,3,3
IT,CA,2003.0,39,71,-32
HU,PL,2000.0,5,8,-3
BR,JP,2000.0,19,22,-3
BE,CL,2022.0,5,4,1
FR,CG,2005.0,12,7,5
CZ,GE,2005.0,2,1,1
PT,DE,2002.0,8,11,-3
MX,US,1997.0,82,98,-16
CL,NZ,2017.0,5,4,1
AU,EG,2020.0,23,35,-12
CD,CA,2020.0,5,1,4
PH,ID,2020.0,6,8,-2
IR,FI,2017.0,22,14,8
NZ,DK,2017.0,5,15,-10
RU,HR,2007.0,4,1,3
ES,GR,2002.0,3,8,-5
HR,CA,2018.0,6,1,5
MX,TR,2012.0,1,5,-4
JP,JO,2008.0,3,5,-2
LB,SA,2022.0,8,3,5
IR,FI,2010.0,6,6,0
SE,KE,2016.0,6,1,5
MA,PT,2016.0,14,10,4
SK,AT,2009.0,10,9,1
NZ,FR,1997.0,4,5,-1
DE,TW,2009.0,26,21,5
ZA,SD,2013.0,4,1,3
AU,CZ,2015.0,8,7,1
CZ,NZ,2014.0,2,1,1
MX,KR,2018.0,7,4,3
NG,MY,2005.0,2,1,1
ES,DO,2012.0,3,7,-4
PT,NL,2001.0,6,11,-5
ES,MA,2016.0,17,9,8
ID,ET,2017.0,4,1,3
DK,TW,2020.0,2,2,0
GR,NZ,2009.0,1,1,0
SA,SY,2021.0,4,4,0
CH,FI,2007.0,10,14,-4
NZ,DK,2019.0,9,7,2
IT,RU,2009.0,15,21,-6
ZA,KR,2014.0,5,6,-1
ES,ID,2002.0,2,4,-2
MA,CA,2013.0,10,19,-9
AR,PK,2005.0,6,5,1
GH,EG,2019.0,13,1,12
UY,IT,2010.0,6,2,4
IS,GB,1998.0,3,2,1
SK,CH,2004.0,8,13,-5
BG,CZ,2019.0,2,3,-1
CH,SK,2000.0,3,3,0
DE,LV,2008.0,3,3,0
IR,TW,2017.0,4,5,-1
GH,EG,2017.0,5,9,-4
HR,US,2003.0,34,21,13
SG,IR,2010.0,4,24,-20
IN,MX,2016.0,23,13,10
AE,EG,1999.0,4,9,-5
BB,AU,2006.0,2,2,0
DZ,DE,2021.0,8,1,7
IS,RU,2016.0,2,1,1
CN,DK,2001.0,15,11,4
US,PR,2011.0,2,4,-2
RU,KE,2018.0,2,2,0
TR,IQ,2014.0,1,1,0
NP,BT,2019.0,1,3,-2
MY,DK,2007.0,1,1,0
ES,VN,2018.0,4,2,2
AT,PT,2019.0,6,6,0
DZ,MY,2019.0,3,4,-1
CA,IQ,2017.0,5,8,-3
VN,UA,2019.0,3,2,1
BR,PE,1999.0,4,4,0
GR,TR,2016.0,12,3,9
TR,CN,2005.0,13,4,9
MY,TH,2022.0,8,1,7
SI,TW,2011.0,2,1,1
CU,RU,2014.0,1,2,-1
PY,BR,2004.0,5,1,4
SK,RU,2002.0,15,7,8
KZ,nan,2019.0,3,1,2
IT,HR,2003.0,3,5,-2
UA,TW,2010.0,1,2,-1
UZ,RS,2009.0,4,2,2
MK,GR,2005.0,4,3,1
QA,US,2003.0,3,8,-5
LT,FI,2003.0,3,1,2
BR,AF,2021.0,3,7,-4
SG,GR,2022.0,2,1,1
BM,GB,2016.0,1,2,-1
PT,CR,2013.0,2,1,1
ZM,BE,2014.0,1,1,0
BR,NG,2010.0,3,1,2
GN,SN,2017.0,3,1,2
HU,IL,1998.0,3,4,-1
BA,HU,2019.0,1,2,-1
UA,TW,2017.0,1,1,0
CN,RO,2003.0,1,6,-5
AZ,KZ,2019.0,4,5,-1
US,FJ,2004.0,4,1,3
GH,IT,2014.0,2,3,-1
CA,HR,2003.0,1,2,-1
BG,UA,2011.0,4,3,1
BD,MY,1999.0,1,1,0
AZ,GE,2009.0,3,1,2
IN,ER,2010.0,1,1,0
DE,CM,1998.0,1,1,0
RS,IL,2004.0,4,3,1
TN,GB,2016.0,5,3,2
DE,GA,2008.0,1,8,-7
nan,GR,2011.0,4,4,0
IL,GR,2017.0,3,1,2
KR,IQ,2015.0,1,2,-1
NL,GB,2011.0,279,282,-3
PT,BR,2007.0,435,431,4
IN,SA,2017.0,176,85,91
ES,NO,2008.0,28,19,9
IL,RU,2015.0,43,27,16
JP,AU,2021.0,34,67,-33
TR,RS,2011.0,63,87,-24
PA,IN,2017.0,6,3,3
CL,CR,2016.0,26,25,1
BE,EE,2021.0,2,4,-2
GR,NO,2012.0,4,2,2
IT,RO,2000.0,6,4,2
BE,ID,2008.0,4,2,2
CR,VE,2009.0,3,2,1
FO,DK,2009.0,2,2,0
KZ,GB,2012.0,1,4,-3
CM,JP,2011.0,1,3,-2
HR,DK,2011.0,1,1,0
SA,CA,2008.0,20,42,-22
FR,ZA,2007.0,23,17,6
GB,NZ,2012.0,262,268,-6
ZA,IE,2014.0,3,17,-14
,IT,1996.0,12536,0,12536
,TW,2011.0,4452,0,4452
US,,2023.0,312837,0,312837
,BR,2012.0,21590,0,21590
,KR,2006.0,5467,0,5467
,AR,2005.0,2179,0,2179
PE,,2015.0,343,0,343
JP,,2020.0,22078,0,22078
,GB,2001.0,15443,0,15443
FR,,2009.0,6361,0,6361
,IT,2004.0,11253,0,11253
GB,,1999.0,4534,0,4534
,CU,2013.0,508,0,508
,PT,2017.0,1549,0,1549
FI,,2002.0,512,0,512
,TR,1997.0,2785,0,2785
,AU,2008.0,6653,0,6653
UG,,2024.0,2165,0,2165
,LV,2015.0,338,0,338
,nan,2004.0,904,0,904
,AR,2002.0,1881,0,1881
,DK,2011.0,2433,0,2433
,TR,1998.0,2860,0,2860
CH,,2013.0,2282,0,2282
MY,,2005.0,79,0,79
,CL,2011.0,1885,0,1885
,NO,2013.0,1882,0,1882
BE,,2007.0,918,0,918
,IE,1996.0,910,0,910
DK,,2012.0,912,0,912
TZ,,2003.0,15,0,15
,CR,2011.0,238,0,238
,PT,2010.0,2356,0,2356
IL,,2008.0,1029,0,1029
DZ,,2017.0,611,0,611
FI,,2005.0,585,0,585
EC,,2000.0,6,0,6
JP,CL,2003.0,4,0,4
NO,,2009.0,583,0,583
,CZ,2013.0,2533,0,2533
EG,,1999.0,136,0,136
BN,,2024.0,236,0,236
FJ,,2018.0,11,0,11
GT,PA,2003.0,1,0,1
BG,,2023.0,2349,0,2349
,BF,2008.0,83,0,83
,KE,1998.0,139,0,139
,nan,1996.0,681,0,681
CR,,2021.0,443,0,443
,LK,2012.0,503,0,503
BR,SA,2001.0,1,0,1
UZ,HR,2007.0,1,0,1
,IE,2004.0,1072,0,1072
,BM,2017.0,1,0,1
,MY,1994.0,767,0,767
,SN,2001.0,84,0,84
,AZ,2019.0,92,0,92
CO,TZ,2015.0,1,0,1
,CO,2014.0,3078,0,3078
,KZ,1999.0,104,0,104
UY,DK,2015.0,1,0,1
,GH,2000.0,64,0,64
GH,,2014.0,52,0,52
BD,,2025.0,325,0,325
,BI,1995.0,16,0,16
UA,,2013.0,915,0,915
DZ,,2019.0,1069,0,1069
CY,,2020.0,242,0,242
,DZ,2005.0,594,0,594
LA,CN,2007.0,2,0,2
,QA,2001.0,67,0,67
KE,JM,2021.0,1,0,1
,MU,2018.0,27,0,27
,KE,1997.0,190,0,190
AM,,2015.0,98,0,98
FJ,AU,2007.0,1,0,1
RS,,2013.0,356,0,356
NP,,2013.0,49,0,49
AT,PT,2010.0,4,0,4
CA,LT,1999.0,1,0,1
GE,,2015.0,122,0,122
,LT,1999.0,197,0,197
UZ,,2003.0,33,0,33
,AZ,2010.0,117,0,117
,DE,2020.0,1140,0,1140
,KW,2010.0,144,0,144
,LY,2003.0,17,0,17
CG,,2022.0,88,0,88
DZ,,2010.0,93,0,93
,TD,2014.0,5,0,5
CV,IT,2020.0,1,0,1
,DZ,2002.0,384,0,384
LU,IL,2010.0,1,0,1
OM,,2008.0,23,0,23
PL,BD,2016.0,2,0,2
BW,IT,2018.0,1,0,1
SA,,2007.0,143,0,143
LA,,2020.0,16,0,16
AE,,1998.0,19,0,19
ES,ID,2005.0,2,0,2
,PT,2019.0,838,0,838
IN,BG,2020.0,2,0,2
,KW,2017.0,170,0,170
TZ,MM,2014.0,5,0,5
CM,,2012.0,56,0,56
IQ,ET,2018.0,3,0,3
,ZM,2016.0,142,0,142
IS,AU,2022.0,2,0,2
,AZ,2017.0,179,0,179
MM,IR,2016.0,1,0,1
BY,PT,2019.0,2,0,2
PT,PY,2019.0,1,0,1
MG,BI,2017.0,1,0,1
,CI,2018.0,150,0,150
LS,,2022.0,25,0,25
BB,,2024.0,50,0,50
,CM,1999.0,102,0,102
TN,CN,2018.0,5,0,5
,PS,2013.0,103,0,103
NG,DK,2019.0,2,0,2
EG,ML,2020.0,1,0,1
CA,CM,2007.0,2,0,2
,MD,2009.0,105,0,105
TR,UA,2007.0,2,0,2
nan,QA,2017.0,4,0,4
,TT,2010.0,39,0,39
AR,RU,2003.0,1,0,1
MY,,2002.0,83,0,83
MM,DE,2014.0,2,0,2
FO,AU,2010.0,1,0,1
RW,,2012.0,7,0,7
BR,JO,2013.0,8,0,8
KE,TH,2021.0,3,0,3
,HN,2002.0,22,0,22
EG,VE,2008.0,1,0,1
GN,LB,2023.0,1,0,1
VN,IR,2006.0,1,0,1
EE,,2006.0,38,0,38
AE,DK,2004.0,2,0,2
UA,PT,2014.0,3,0,3
CG,NC,2022.0,1,0,1
FI,UA,2008.0,1,0,1
KZ,NL,2014.0,1,0,1
LB,,2007.0,38,0,38
GB,CG,2015.0,3,0,3
ET,BH,2011.0,2,0,2
,MM,2001.0,12,0,12
GR,AU,1999.0,6,0,6
BI,,2024.0,92,0,92
AR,SD,2016.0,1,0,1
IE,LV,2019.0,2,0,2
ME,,2013.0,6,0,6
PH,NZ,2021.0,1,0,1
CY,CM,2022.0,1,0,1
,PG,2018.0,25,0,25
NL,OM,2022.0,1,0,1
MX,PY,2007.0,2,0,2
RO,FI,2010.0,3,0,3
,MN,2013.0,79,0,79
,GD,2014.0,30,0,30
ID,ET,2019.0,4,0,4
,KW,2019.0,76,0,76
GB,MU,2015.0,3,0,3
MD,,1998.0,23,0,23
IE,MY,2004.0,1,0,1
RS,UA,1997.0,3,0,3
LY,BE,2007.0,1,0,1
NL,MT,2013.0,2,0,2
OM,SE,2010.0,2,0,2
,BO,2000.0,28,0,28
ZA,MZ,2012.0,2,0,2
AZ,ES,1998.0,3,0,3
JP,IQ,2009.0,6,0,6
,DO,2008.0,12,0,12
JO,,1998.0,17,0,17
PL,XK,2012.0,9,0,9
SK,LY,2012.0,1,0,1
NO,GH,2013.0,1,0,1
ID,,2000.0,20,0,20
,XK,2006.0,71,0,71
NL,ZW,2019.0,5,0,5
EG,NO,2007.0,2,0,2
HU,NG,2011.0,6,0,6
SN,CM,2003.0,1,0,1
,SS,2004.0,7,0,7
KR,GE,2008.0,1,0,1
CU,CN,2007.0,1,0,1
SM,GB,2016.0,1,0,1
MX,GT,2005.0,3,0,3
HR,CZ,2023.0,1,0,1
CD,JP,2006.0,1,0,1
ML,NE,2002.0,1,0,1
,RE,1995.0,20,0,20
,BN,2015.0,24,0,24
DE,FO,2015.0,2,0,2
MX,EG,2007.0,1,0,1
MG,KH,2022.0,1,0,1
AT,IS,2014.0,2,0,2
SK,TJ,2019.0,1,0,1
MM,HU,2004.0,2,0,2
MW,SN,2021.0,1,0,1
MD,PL,2018.0,1,0,1
MZ,GB,2021.0,2,0,2
GF,,2022.0,38,0,38
GI,GB,2015.0,2,0,2
DZ,BI,2016.0,1,0,1
MN,JP,2002.0,2,0,2
SS,JP,2009.0,1,0,1
BR,TW,2005.0,4,0,4
PL,TR,2014.0,4,0,4
CW,AT,2010.0,1,0,1
,TT,2017.0,44,0,44
HT,CU,2013.0,2,0,2
,HN,2005.0,10,0,10
nan,MA,2001.0,1,0,1
PK,LT,2007.0,3,0,3
TW,BW,2012.0,1,0,1
PK,CM,2015.0,2,0,2
FI,LU,2022.0,3,0,3
BE,TT,2018.0,1,0,1
GP,FI,2015.0,1,0,1
MS,,2020.0,1,0,1
,SS,1996.0,4,0,4
GA,,2005.0,4,0,4
BD,CZ,2016.0,3,0,3
GA,,2002.0,4,0,4
CA,AM,2006.0,2,0,2
NE,GN,2016.0,1,0,1
,CW,1997.0,11,0,11
MR,CH,2017.0,1,0,1
IL,CY,2016.0,2,0,2
TR,CI,2020.0,1,0,1
IT,NZ,1998.0,2,0,2
LB,ID,2018.0,2,0,2
IT,MT,2008.0,1,0,1
BA,VN,2021.0,2,0,2
IL,NP,2018.0,1,0,1
IT,UZ,1997.0,1,0,1
AT,SG,2008.0,5,0,5
BF,TG,2009.0,1,0,1
SA,MV,2015.0,1,0,1
ET,,1999.0,8,0,8
PH,BE,2003.0,1,0,1
BR,PK,2023.0,1,0,1
AF,,2012.0,2,0,2
,TT,2019.0,18,0,18
CH,RE,2020.0,2,0,2
AF,PK,2023.0,1,0,1
RS,KW,2018.0,1,0,1
MZ,UG,2020.0,1,0,1
PY,AR,2009.0,2,0,2
IQ,,2001.0,4,0,4
HR,IL,2005.0,1,0,1
BJ,,2008.0,15,0,15
GB,SJ,2011.0,1,0,1
SD,FR,2013.0,2,0,2
HU,IL,1997.0,5,0,5
CY,FR,2006.0,3,0,3
FO,AU,2017.0,1,0,1
SN,KR,2010.0,1,0,1
IQ,SA,2008.0,2,0,2
BR,RS,2004.0,2,0,2
SG,NG,2007.0,1,0,1
PE,UG,2018.0,1,0,1
ET,CY,2017.0,2,0,2
BB,IN,2014.0,1,0,1
HT,,2011.0,2,0,2
LY,,2000.0,5,0,5
TR,VN,2016.0,2,0,2
ID,BA,2021.0,1,0,1
MA,JO,2016.0,1,0,1
,LR,2009.0,4,0,4
RU,PT,2000.0,8,0,8
DO,IT,2014.0,2,0,2
LS,SZ,2003.0,1,0,1
ET,CU,2021.0,1,0,1
,GN,2008.0,11,0,11
IE,GE,2015.0,1,0,1
AO,PT,2012.0,2,0,2
,KP,2007.0,5,0,5
CO,PL,2001.0,1,0,1
NC,CA,2007.0,2,0,2
KH,GB,2012.0,1,0,1
IQ,KE,2019.0,1,0,1
SA,ES,2000.0,2,0,2
GH,KE,2000.0,1,0,1
RW,NL,2017.0,3,0,3
PR,ES,2012.0,4,0,4
CZ,HR,2007.0,3,0,3
BR,AZ,1998.0,2,0,2
MZ,UA,2017.0,6,0,6
,BM,2010.0,6,0,6
KW,LB,2019.0,1,0,1
CH,EC,2017.0,1,0,1
ZA,FI,2002.0,2,0,2
MM,CH,2019.0,1,0,1
SN,UY,2012.0,1,0,1
CG,GH,2010.0,1,0,1
ES,MK,2021.0,1,0,1
BE,AR,2004.0,4,0,4
UY,,2006.0,26,0,26
SE,MK,2005.0,1,0,1
IT,BW,2013.0,1,0,1
NE,,2002.0,2,0,2
SE,CY,2011.0,2,0,2
OM,ZA,2018.0,1,0,1
BR,SI,2006.0,1,0,1
,PY,2007.0,14,0,14
RU,MA,2009.0,1,0,1
MY,VN,2008.0,3,0,3
PL,GE,2004.0,1,0,1
LT,TR,2017.0,2,0,2
SE,BW,2018.0,3,0,3
LB,JO,2007.0,1,0,1
KR,BH,2000.0,1,0,1
QA,IL,2020.0,1,0,1
SE,LB,2002.0,1,0,1
AU,YE,2015.0,1,0,1
ID,FI,2011.0,1,0,1
NC,SN,2010.0,1,0,1
ZA,CW,2020.0,1,0,1
MK,FR,2012.0,2,0,2
,FO,2014.0,7,0,7
RU,KH,2009.0,2,0,2
nan,LU,2020.0,3,0,3
VG,CA,2018.0,2,0,2
AU,CY,2011.0,4,0,4
SY,HU,2021.0,2,0,2
IT,LT,2018.0,5,0,5
BA,NO,2013.0,2,0,2
,BB,2008.0,6,0,6
AM,CN,1999.0,1,0,1
TR,HR,2005.0,2,0,2
JP,CR,2010.0,1,0,1
HK,KH,2001.0,1,0,1
BD,ZW,2009.0,1,0,1
JP,CY,2000.0,4,0,4
PR,,2008.0,1,0,1
nan,BM,2008.0,2,0,2
KR,OM,2012.0,2,0,2
RO,FI,2017.0,2,0,2
FI,KW,2000.0,1,0,1
JP,PF,1997.0,1,0,1
IR,TW,2010.0,3,0,3
NE,,2005.0,4,0,4
US,SJ,1999.0,1,0,1
EC,ZW,2014.0,1,0,1
ES,GE,2001.0,1,0,1
FJ,CA,2015.0,1,0,1
VN,DK,2003.0,2,0,2
CH,MQ,2014.0,1,0,1
SE,LK,2002.0,1,0,1
NI,HN,2020.0,3,0,3
LB,PH,2013.0,1,0,1
MA,CI,2019.0,4,0,4
RO,PK,2007.0,2,0,2
KZ,LV,2019.0,2,0,2
SE,LB,2005.0,1,0,1
KE,BF,2003.0,1,0,1
RE,,2008.0,4,0,4
SN,TZ,2015.0,1,0,1
MX,AO,2001.0,1,0,1
,CW,1998.0,6,0,6
TW,HR,1999.0,1,0,1
LB,KE,2014.0,1,0,1
TN,IT,2023.0,3,0,3
CO,NL,1999.0,1,0,1
MA,CO,2022.0,1,0,1
GN,SN,2010.0,2,0,2
CM,nan,2002.0,2,0,2
GA,GB,2007.0,1,0,1
,TO,2010.0,2,0,2
AR,SV,2021.0,2,0,2
TR,SO,2022.0,2,0,2
,MR,2012.0,6,0,6
GT,HU,2018.0,1,0,1
SY,QA,2022.0,2,0,2
IN,MN,2009.0,1,0,1
ID,BN,2013.0,1,0,1
CA,UZ,2018.0,1,0,1
NO,QA,2014.0,1,0,1
ET,SY,2016.0,1,0,1
SK,SD,2014.0,1,0,1
GT,DO,2019.0,2,0,2
AF,ES,2000.0,1,0,1
CH,NG,2004.0,3,0,3
CG,BJ,2022.0,1,0,1
BM,,2014.0,3,0,3
,BZ,2008.0,2,0,2
BM,SJ,2018.0,1,0,1
BE,UY,2012.0,1,0,1
BI,MA,2013.0,1,0,1
KE,BW,2005.0,1,0,1
,BS,2014.0,3,0,3
SD,PT,2016.0,1,0,1
NO,KE,2006.0,1,0,1
PK,KH,2020.0,1,0,1
SY,SD,2022.0,2,0,2
SE,PH,2003.0,2,0,2
ZA,HR,2003.0,1,0,1
SE,AL,2003.0,1,0,1
WS,CA,2007.0,1,0,1
AR,NZ,2012.0,3,0,3
KZ,VN,2020.0,1,0,1
BR,EE,2015.0,1,0,1
LS,US,2011.0,3,0,3
BF,,2025.0,11,0,11
RW,AU,2011.0,1,0,1
VN,nan,2013.0,2,0,2
BW,IN,2006.0,1,0,1
CA,LY,2011.0,4,0,4
BJ,JP,2018.0,2,0,2
CH,MT,2008.0,1,0,1
MZ,CA,2015.0,2,0,2
PE,CR,2003.0,3,0,3
NE,AU,2012.0,1,0,1
TG,ML,2018.0,1,0,1
GE,ZW,2020.0,1,0,1
MR,BF,2000.0,1,0,1
PK,AF,2012.0,1,0,1
BY,LV,2022.0,2,0,2
FI,UG,2021.0,2,0,2
PK,IS,2017.0,1,0,1
HU,LT,2021.0,1,0,1
BT,,2018.0,3,0,3
SI,NO,2008.0,1,0,1
NZ,NG,1998.0,1,0,1
SE,XK,2016.0,2,0,2
NA,MY,2016.0,1,0,1
MX,TW,2015.0,4,0,4
TH,CR,2019.0,1,0,1
ZM,HU,1999.0,1,0,1
SE,NC,2014.0,1,0,1
SG,CY,2011.0,1,0,1
ID,BH,2016.0,1,0,1
TW,LB,2020.0,1,0,1
UG,CO,2011.0,1,0,1
IL,VE,2022.0,1,0,1
VE,GT,2011.0,2,0,2
IN,LA,2021.0,1,0,1
CL,DZ,2011.0,1,0,1
GN,,2013.0,4,0,4
FI,PK,2000.0,1,0,1
JO,MX,2016.0,2,0,2
CA,AG,2019.0,1,0,1
ZA,GF,2016.0,1,0,1
NG,FJ,2020.0,1,0,1
PR,CN,2015.0,2,0,2
IL,TZ,2020.0,1,0,1
SV,JP,2010.0,1,0,1
SO,UG,2015.0,1,0,1
OM,NG,2003.0,2,0,2
BW,IR,2007.0,1,0,1
ET,GE,2009.0,1,0,1
GH,BW,2009.0,1,0,1
PY,GB,2013.0,1,0,1
PT,HN,2021.0,1,0,1
VG,NL,2009.0,1,0,1
LU,BI,2018.0,1,0,1
SG,EC,2014.0,1,0,1
GF,BJ,2011.0,2,0,2
CI,,2001.0,5,0,5
MX,DO,2000.0,1,0,1
VE,MT,2014.0,1,0,1
NG,CL,2018.0,1,0,1
NG,RO,2016.0,1,0,1
SI,OM,2016.0,1,0,1
NG,MY,2002.0,2,0,2
BR,CV,2011.0,1,0,1
BY,PT,2010.0,3,0,3
NG,LS,2008.0,1,0,1
nan,GD,2020.0,1,0,1
AL,JP,2013.0,1,0,1
IQ,nan,2002.0,1,0,1
RS,BE,1998.0,1,0,1
NP,BT,2017.0,1,0,1
ZA,RS,2017.0,2,0,2
UG,CH,2009.0,2,0,2
PH,NG,2022.0,2,0,2
KR,CO,2006.0,1,0,1
MC,,2008.0,2,0,2
AM,CH,2003.0,1,0,1
PH,BN,2016.0,1,0,1
CH,GH,2008.0,2,0,2
CN,TN,2001.0,1,0,1
GF,MD,2019.0,1,0,1
ZA,GR,2005.0,1,0,1
TT,PK,2017.0,1,0,1
NI,SD,2008.0,1,0,1
GE,FI,2016.0,1,0,1
IS,AT,2017.0,2,0,2
AM,CZ,2018.0,2,0,2
VN,IT,2010.0,2,0,2
HT,BR,2018.0,1,0,1
BI,ES,2014.0,1,0,1
FI,EC,2020.0,1,0,1
MD,GB,1999.0,1,0,1
KE,LA,2013.0,1,0,1
GB,EE,1997.0,1,0,1
GT,CA,2004.0,1,0,1
ET,BR,2009.0,1,0,1
MK,IN,2014.0,3,0,3
BD,IL,2009.0,2,0,2
TW,AR,2001.0,1,0,1
UA,SN,2021.0,1,0,1
HU,SA,2013.0,2,0,2
MX,UG,2019.0,1,0,1
BD,HK,2019.0,1,0,1
BN,DE,2018.0,2,0,2
SE,HR,2001.0,2,0,2
HR,IL,2002.0,1,0,1
EG,IR,2007.0,1,0,1
IT,NZ,1997.0,1,0,1
AR,IR,2005.0,1,0,1
HR,PH,2016.0,1,0,1
US,AZ,2013.0,4,0,4
GT,PL,2012.0,1,0,1
MY,MN,2013.0,1,0,1
IE,NP,2020.0,2,0,2
CF,,2009.0,1,0,1
HR,VE,2008.0,3,0,3
GB,GY,2015.0,1,0,1
IN,ER,2017.0,2,0,2
SA,NZ,2004.0,1,0,1
UZ,PL,2009.0,2,0,2
KE,FI,2003.0,1,0,1
,FM,2001.0,2,0,2
QA,SE,2011.0,1,0,1
JP,BH,2023.0,1,0,1
ZW,BE,1998.0,2,0,2
LY,NZ,2007.0,1,0,1
HN,CH,2017.0,1,0,1
MN,FI,2019.0,1,0,1
LT,TR,2019.0,1,0,1
AM,PT,2011.0,2,0,2
AU,SS,1998.0,1,0,1
HT,CI,2011.0,1,0,1
NG,YE,2022.0,1,0,1
FR,VG,1998.0,1,0,1
CH,LT,2020.0,3,0,3
IR,MK,2020.0,2,0,2
JM,ID,2015.0,1,0,1
AU,NA,2008.0,1,0,1
VN,UA,2010.0,1,0,1
RW,CN,2009.0,1,0,1
CH,KW,2010.0,1,0,1
MY,NP,2007.0,1,0,1
BE,CI,2013.0,3,0,3
YE,QA,2019.0,1,0,1
TH,NG,2012.0,1,0,1
PT,IL,2010.0,3,0,3
TJ,KZ,2017.0,1,0,1
ZM,JP,2002.0,1,3,-2
UA,AU,2000.0,2,2,0
DZ,SE,2012.0,1,1,0
LK,IN,2007.0,2,1,1
LT,ES,2017.0,3,1,2
KE,SD,2010.0,1,1,0
HR,FR,2017.0,3,8,-5
BR,PL,2003.0,1,4,-3
PL,SA,2020.0,1,2,-1
LV,DE,2004.0,3,1,2
WS,GB,2017.0,1,1,0
EC,BE,2009.0,2,3,-1
KR,NG,2007.0,2,11,-9
ST,US,2006.0,2,1,1
BH,AU,2010.0,1,4,-3
IE,LV,2010.0,1,4,-3
SG,FI,2009.0,2,2,0
CA,PS,2016.0,4,1,3
US,MK,2002.0,3,5,-2
SE,NZ,1998.0,1,4,-3
JP,RO,2004.0,3,2,1
IR,TW,2019.0,2,1,1
EG,PS,2013.0,4,6,-2
IE,TR,2018.0,1,11,-10
SA,BR,2022.0,1,5,-4
AR,KR,2007.0,1,1,0
ID,CO,2020.0,3,5,-2
AT,CL,2008.0,1,1,0
MX,GT,2002.0,2,2,0
MX,SK,2008.0,1,2,-1
TZ,US,1999.0,2,5,-3
CU,DE,2022.0,1,1,0
nan,QA,2019.0,2,1,1
DZ,BD,2018.0,2,1,1
PE,UY,2022.0,2,1,1
MX,ID,2016.0,1,2,-1
CA,LB,2011.0,6,4,2
AD,ES,2021.0,1,3,-2
IN,UZ,2007.0,2,1,1
TH,PH,2008.0,1,1,0
ES,AM,2018.0,1,1,0
BY,LT,2018.0,1,1,0
KR,PA,2015.0,2,3,-1
NO,SG,2022.0,1,4,-3
IL,MX,2022.0,2,1,1
OM,SE,2017.0,1,2,-1
FR,BO,2021.0,1,2,-1
TW,IL,2021.0,2,2,0
GM,US,2004.0,1,2,-1
PS,MY,2015.0,3,5,-2
CG,PK,2020.0,4,4,0
IT,CI,2006.0,1,1,0
MA,SA,2008.0,1,2,-1
ET,FR,2017.0,1,3,-2
BJ,NL,2008.0,1,1,0
MZ,UA,2010.0,3,1,2
LT,RO,1997.0,1,1,0
EC,AU,2005.0,1,1,0
FI,SI,2006.0,2,1,1
LU,ES,2011.0,1,3,-2
AT,NG,2010.0,1,1,0
JP,MA,2018.0,1,1,0
GE,CH,2006.0,2,2,0
DE,MA,2000.0,1,4,-3
KZ,nan,2017.0,1,1,0
OM,SE,2019.0,1,2,-1
TR,AE,2021.0,4,7,-3
CH,BI,2004.0,1,1,0
RS,IE,2020.0,1,1,0
FR,TG,2002.0,1,1,0
CN,MN,2016.0,1,2,-1
FR,ET,2014.0,2,3,-1
UA,ID,2015.0,1,1,0
EE,UA,2014.0,1,1,0
BO,FR,2011.0,3,4,-1
IE,SK,2015.0,1,1,0
LU,RU,2015.0,1,3,-2
CU,CH,2013.0,1,1,0
KN,CA,2016.0,1,3,-2
IE,EG,2009.0,1,2,-1
JO,PK,2003.0,1,2,-1
nan,SN,2010.0,1,1,0
MY,CA,2001.0,1,7,-6
TZ,DE,2021.0,1,5,-4
TR,RW,2012.0,1,2,-1
CZ,RO,2022.0,1,2,-1
FR,UG,2005.0,1,2,-1
DE,BA,2004.0,2,1,1
PK,IS,2019.0,2,1,1
nan,NG,2000.0,1,1,0
LK,BT,2014.0,1,1,0
ZA,JP,1998.0,2,3,-1
PT,PY,2010.0,1,1,0
US,CW,2006.0,1,1,0
IL,AR,1997.0,1,2,-1
SY,FR,2004.0,2,2,0
CI,NE,2021.0,1,1,0
IN,KH,2020.0,1,2,-1
EE,IL,2011.0,1,1,0
BW,ZA,2003.0,2,4,-2
IQ,DE,2008.0,2,2,0
BF,SE,2012.0,1,4,-3
DK,IL,2007.0,1,4,-3
MK,GR,2002.0,1,1,0
SA,BD,2003.0,3,1,2
DK,KE,2011.0,1,2,-1
EG,IN,2006.0,2,3,-1
NO,LU,2021.0,1,2,-1
FR,HR,2002.0,1,1,0
IE,IR,2007.0,1,2,-1
KE,KR,2020.0,2,3,-1
PG,TN,2011.0,1,2,-1
MW,ZM,2012.0,1,1,0
ZA,MG,2014.0,1,1,0
SZ,UG,2019.0,1,1,0
VG,nan,2007.0,1,2,-1
QA,KW,2011.0,1,2,-1
JP,ZM,2008.0,1,1,0
PT,IL,2017.0,1,2,-1
AM,DE,2000.0,1,2,-1
PH,KR,1999.0,1,3,-2
ES,IQ,2011.0,1,1,0
IN,LT,2019.0,1,1,0
CH,EG,2003.0,3,2,1
JO,FR,2020.0,2,1,1
DK,CL,1999.0,1,1,0
NO,PH,2005.0,1,5,-4
GE,IN,2016.0,1,2,-1
DE,AZ,2018.0,1,2,-1
PL,PK,2002.0,1,1,0
SK,PT,2013.0,1,3,-2
KE,UG,2008.0,2,4,-2
BR,IE,1999.0,2,1,1
MZ,ZA,2016.0,1,1,0
KZ,IL,2020.0,1,1,0
nan,IQ,2020.0,1,1,0
BG,PT,2016.0,1,2,-1
ZA,RS,2019.0,1,2,-1
AT,UG,2013.0,1,3,-2
RS,IT,2005.0,1,2,-1
nan,EE,2011.0,1,6,-5
CZ,GE,2002.0,1,1,0
PT,MA,2011.0,1,4,-3
RU,TH,2004.0,1,1,0
nan,MY,2023.0,2,2,0
LB,GB,2006.0,1,1,0
SV,nan,2021.0,1,1,0
ET,DE,2003.0,1,1,0
IQ,LB,2015.0,1,4,-3
IN,SI,2013.0,1,1,0
AR,GT,2022.0,1,1,0
EE,CA,2009.0,2,2,0
BJ,GB,2008.0,1,1,0
NL,SY,2015.0,1,1,0
BE,BJ,2002.0,1,1,0
BE,MD,2012.0,1,2,-1
MZ,PT,2022.0,1,11,-10
PY,VE,2007.0,1,1,0
SK,CL,2021.0,1,1,0
CR,PT,2008.0,2,2,0
GN,SN,2019.0,1,4,-3
ID,NZ,2019.0,2,8,-6
BS,CA,2020.0,1,1,0
PK,AT,2019.0,1,5,-4
EG,VN,2016.0,1,1,0
BR,GR,2002.0,1,2,-1
NZ,SA,2010.0,1,1,0
GB,FO,2013.0,1,1,0
GB,MS,2006.0,1,1,0
ID,VN,2018.0,1,1,0
SE,UY,2020.0,1,2,-1
MD,ES,1998.0,1,1,0
GH,FI,2017.0,1,2,-1
DE,ZW,2001.0,1,1,0
ML,GB,2006.0,1,1,0
GA,BJ,2018.0,1,2,-1
BR,GR,2005.0,1,1,0
BR,ZM,2009.0,1,4,-3
MX,MA,2013.0,1,1,0
TH,UG,2014.0,1,1,0
ZA,CH,2023.0,1,5,-4
TD,FR,2014.0,1,2,-1
NG,SY,2022.0,1,1,0
AT,NP,2019.0,1,1,0
AE,CA,2004.0,5,11,-6
PE,BO,2014.0,3,3,0
nan,SN,2019.0,2,1,1
BR,ZA,1998.0,1,2,-1
FI,LT,2011.0,2,3,-1
JP,CR,2017.0,1,1,0
FI,PE,2011.0,2,1,1
JP,FJ,2021.0,1,1,0
AE,KR,2014.0,2,3,-1
TW,AE,2016.0,1,2,-1
JP,PR,2012.0,1,1,0
CM,GB,2006.0,1,3,-2
ZA,SA,2003.0,1,2,-1
NG,CN,2009.0,1,2,-1
GH,CZ,2011.0,1,1,0
CL,SV,2007.0,1,2,-1
VE,IN,2004.0,1,1,0
SL,CN,2022.0,1,1,0
SA,DK,2014.0,1,3,-2
KR,BD,2000.0,1,1,0
CY,AE,2021.0,2,1,1
TJ,,2002.0,3,0,3
PT,JM,2014.0,1,0,1
SK,DZ,2017.0,1,0,1
NE,MA,2011.0,1,0,1
PG,NL,1997.0,1,0,1
IL,KZ,2015.0,1,0,1
PY,IE,2020.0,1,0,1
TR,KZ,1998.0,1,0,1
BE,SY,2015.0,2,0,2
SL,US,2001.0,1,0,1
HU,AR,1999.0,1,0,1
SA,IR,2007.0,1,0,1
JP,LU,2002.0,1,0,1
UG,PT,2009.0,1,0,1
CU,AU,2022.0,1,0,1
MA,CI,2010.0,1,0,1
VG,NG,2013.0,1,0,1
TZ,NG,2003.0,1,0,1
IQ,CZ,2017.0,1,0,1
CL,DO,2012.0,2,0,2
VN,BY,2020.0,1,0,1
,KN,2020.0,3,0,3
ES,ZM,2021.0,1,0,1
ME,XK,2020.0,1,0,1
ZM,NP,2017.0,1,0,1
CD,KR,2018.0,1,0,1
IN,SN,2016.0,2,0,2
CA,CR,1997.0,1,0,1
HK,GB,1998.0,1,0,1
IN,TT,1999.0,1,0,1
CA,SN,2003.0,1,0,1
CW,PK,2009.0,1,0,1
KE,PH,2014.0,1,0,1
GR,KR,2021.0,2,0,2
AL,PH,2020.0,1,0,1
GE,LV,2017.0,1,0,1
PH,VE,2004.0,1,0,1
MW,TR,2017.0,1,0,1
US,KP,2018.0,1,0,1
LK,OM,2013.0,1,0,1
IE,LV,2017.0,1,0,1
RU,DZ,2017.0,1,0,1
NG,MA,2007.0,1,0,1
,GY,1999.0,1,0,1
BG,ES,1998.0,2,0,2
AL,GR,2013.0,1,0,1
CM,CZ,2009.0,1,0,1
MD,IL,2016.0,2,0,2
BJ,CH,2021.0,1,0,1
NZ,MA,2016.0,1,0,1
CA,GP,2008.0,1,0,1
SE,BN,2020.0,1,0,1
SJ,SE,2020.0,1,0,1
BG,KW,2011.0,1,0,1
AO,UY,2007.0,1,0,1
LK,CN,1999.0,1,0,1
CG,KR,2020.0,1,0,1
TR,UZ,2017.0,1,0,1
DZ,MY,2010.0,2,0,2
PG,SG,2009.0,1,0,1
DE,BW,2020.0,1,0,1
TZ,TH,2014.0,1,0,1
NO,LK,2011.0,1,0,1
FR,BW,2011.0,1,0,1
TW,CO,2016.0,1,0,1
TG,,2011.0,5,0,5
KW,ET,2006.0,1,0,1
UG,BR,2012.0,1,0,1
KH,PK,2005.0,1,0,1
VE,HN,1997.0,1,0,1
CI,CF,2014.0,1,0,1
AT,PH,1997.0,1,0,1
SG,BE,2023.0,1,0,1
MW,CH,2011.0,1,0,1
CU,CG,2019.0,1,0,1
NZ,TZ,2019.0,1,0,1
IS,AT,2019.0,1,0,1
TN,AE,2004.0,1,0,1
CM,KE,2022.0,1,0,1
GB,MD,2003.0,1,0,1
JP,LS,2022.0,1,0,1
MA,BI,2006.0,1,0,1
GE,IL,2020.0,1,0,1
MQ,CH,2005.0,1,0,1
BR,FI,2003.0,1,0,1
JM,JP,2008.0,1,0,1
RU,JO,1999.0,1,0,1
MY,BZ,2019.0,1,0,1
TN,IE,2021.0,1,0,1
TT,JP,2020.0,1,0,1
MX,IT,2023.0,2,0,2
TR,TH,2004.0,2,0,2
CD,KE,2020.0,1,0,1
BA,DE,2003.0,2,0,2
NG,HR,2009.0,1,0,1
MD,UA,2008.0,1,0,1
BH,ZA,2009.0,1,0,1
CA,FJ,2022.0,1,0,1
SY,PK,2013.0,1,0,1
RO,AM,2020.0,1,0,1
AD,,2021.0,1,0,1
PK,GR,2016.0,1,0,1
ET,DK,1999.0,1,0,1
AE,SO,2019.0,1,0,1
MW,BW,2015.0,1,0,1
DK,MY,2005.0,1,0,1
AM,MX,2017.0,1,0,1
NI,BR,2019.0,1,0,1
MW,TR,2010.0,1,0,1
NG,PG,1998.0,1,0,1
BD,SI,2016.0,1,0,1
IL,PT,2022.0,1,0,1
AE,GR,1997.0,1,0,1
GR,AE,1999.0,1,0,1
LB,EE,2008.0,1,0,1
RW,BD,2000.0,2,0,2
MK,AT,1999.0,1,0,1
TR,MK,2002.0,1,0,1
SA,FI,2001.0,1,0,1
CD,SN,2018.0,1,0,1
BR,VN,2016.0,1,0,1
BE,TZ,2008.0,1,0,1
NA,IE,2021.0,1,0,1
KE,CG,2004.0,1,0,1
AR,NI,2016.0,1,0,1
US,LI,2010.0,1,0,1
GH,GM,2010.0,1,0,1
TW,NG,2019.0,1,0,1
BY,CA,1999.0,1,0,1
KE,CZ,1998.0,1,0,1
SE,PY,2007.0,1,0,1
PK,SO,2020.0,1,0,1
AT,UZ,2016.0,1,0,1
PS,BH,2012.0,1,0,1
MU,US,2012.0,1,0,1
DE,MU,2018.0,1,0,1
CH,BN,2012.0,1,0,1
AT,CW,1999.0,1,0,1
EE,PT,2015.0,1,0,1
NZ,RE,2007.0,1,0,1
,GW,2003.0,1,0,1
ET,CY,2019.0,1,0,1
PH,AG,2020.0,1,0,1
KP,JP,2002.0,1,0,1
TH,NL,1997.0,1,0,1
AO,MX,2017.0,2,0,2
SA,BG,2017.0,1,0,1
GB,PS,2006.0,2,0,2
FR,MZ,2017.0,1,0,1
PE,SI,2021.0,1,0,1
DE,MZ,2015.0,1,0,1
CO,FO,2022.0,1,0,1
NG,DK,2010.0,2,0,2
GM,AU,2007.0,1,0,1
KW,SY,2021.0,1,0,1
CA,AG,2017.0,1,0,1
IE,KG,2017.0,1,0,1
DK,MC,2022.0,1,0,1
GE,SK,2000.0,1,0,1
nan,SO,2019.0,1,0,1
BG,AR,2012.0,1,0,1
FI,BR,2002.0,1,0,1
CN,IS,2014.0,1,0,1
BJ,DE,2003.0,1,0,1
EC,TH,2017.0,1,0,1
MD,LT,2015.0,1,0,1
CH,VE,2013.0,1,0,1
LV,IL,2013.0,1,0,1
BO,CR,2009.0,1,0,1
PK,HN,2001.0,1,0,1
US,LR,2006.0,1,0,1
CI,MD,2019.0,1,0,1
,LU,2020.0,5,0,5
TT,PK,2019.0,1,0,1
IQ,CH,2016.0,1,0,1
SA,IQ,2003.0,1,0,1
CI,AU,2015.0,1,0,1
LU,MX,2000.0,1,0,1
BE,PR,2008.0,1,0,1
GE,NA,2016.0,1,0,1
BO,IT,2015.0,1,0,1
GB,SC,2021.0,1,0,1
AO,CU,2022.0,1,0,1
HU,AL,2013.0,1,0,1
FI,IL,1998.0,1,0,1
AU,TJ,2022.0,1,0,1
GH,FR,2009.0,1,0,1
AL,IQ,2019.0,1,0,1
KE,MX,2023.0,1,0,1
IN,RO,1997.0,1,0,1
MX,EE,2019.0,1,0,1
GB,TT,1997.0,1,0,1
IR,ES,2005.0,1,0,1
SG,CR,2011.0,1,0,1
IE,KW,2007.0,1,0,1
FJ,NG,2008.0,1,0,1
PY,PL,2020.0,1,0,1
BH,CA,2004.0,1,0,1
CR,VN,2020.0,1,0,1
KR,MM,2006.0,1,0,1
AM,PL,2007.0,1,0,1
SJ,,2001.0,1,0,1
GB,SO,2011.0,1,0,1
AE,VG,2012.0,1,0,1
,TG,2020.0,2,0,2
CO,GR,2020.0,1,0,1
BW,CH,2017.0,1,0,1
DZ,DK,2020.0,1,0,1
KP,BE,2021.0,1,0,1
CZ,CR,2006.0,1,0,1
AT,NG,2017.0,1,0,1
BJ,NZ,2014.0,1,0,1
ML,CH,2017.0,1,0,1
US,CA,2000.0,1518,1878,-360
AU,TR,2010.0,9,9,0
GB,AU,2002.0,764,714,50
US,NO,2021.0,169,130,39
AE,IN,2013.0,12,49,-37
BR,PT,2022.0,1031,562,469
FR,CA,2009.0,525,468,57
ES,BR,2003.0,148,148,0
BR,AU,2009.0,62,46,16
BE,AR,2014.0,16,8,8
SN,FR,1999.0,10,13,-3
ES,RO,2022.0,10,4,6
IL,MX,2016.0,6,3,3
JP,US,2018.0,1615,1833,-218
CN,DE,2006.0,147,239,-92
FR,US,2002.0,1026,890,136
CN,SG,2001.0,135,116,19
GB,KR,2007.0,63,62,1
RU,NL,2001.0,30,10,20
IN,CA,2006.0,194,119,75
JP,TR,2012.0,28,32,-4
US,PH,2019.0,279,366,-87
US,TW,2000.0,495,368,127
BR,US,2000.0,287,354,-67
DE,EG,2014.0,73,36,37
FR,MX,2021.0,49,41,8
CA,GB,2008.0,749,769,-20
GB,AU,2005.0,894,791,103
nan,US,1998.0,112,94,18
CH,JP,2002.0,52,55,-3
DE,CN,2011.0,285,256,29
US,ZA,2006.0,254,202,52
FR,US,2005.0,1070,983,87
CH,SE,1997.0,13,17,-4
CN,GB,2011.0,434,571,-137
GB,IL,2018.0,80,88,-8
BA,RS,2020.0,51,42,9
AU,ZA,2021.0,42,59,-17
CR,US,2012.0,34,23,11
US,NZ,2010.0,392,306,86
CN,CA,2008.0,358,453,-95
AU,TR,2019.0,16,21,-5
US,PH,2010.0,378,413,-35
FR,TN,2012.0,203,140,63
CO,SE,2011.0,4,5,-1
GR,CH,2003.0,9,8,1
DK,PL,2008.0,9,8,1
US,NZ,2019.0,434,467,-33
ES,EC,2005.0,11,8,3
ES,NL,2021.0,75,81,-6
IN,GB,2001.0,131,121,10
ID,NZ,2018.0,11,14,-3
JP,GB,2014.0,244,306,-62
IN,SA,2018.0,193,90,103
UA,RU,2008.0,94,167,-73
CN,JP,2021.0,355,497,-142
GB,BG,2002.0,7,6,1
DE,NL,2000.0,152,143,9
US,SA,2020.0,392,203,189
JP,ID,1998.0,11,5,6
TR,NG,2019.0,5,7,-2
AU,CN,2001.0,143,78,65
DE,SE,2022.0,142,115,27
nan,IN,2011.0,33,50,-17
nan,US,1997.0,92,68,24
ZA,GB,2015.0,147,167,-20
FR,FI,2008.0,14,20,-6
TW,GB,2014.0,63,68,-5
CU,ES,2011.0,110,82,28
HU,RO,2013.0,31,26,5
PT,CR,2008.0,2,2,0
JP,FI,2009.0,16,12,4
IT,US,2013.0,1081,945,136
ID,TW,2014.0,16,19,-3
IE,BR,1999.0,1,2,-1
DK,NL,2019.0,71,69,2
US,MX,2001.0,153,169,-16
NZ,IN,2009.0,15,14,1
IE,CA,2010.0,112,152,-40
GB,CA,2003.0,554,498,56
MX,CO,2022.0,154,117,37
ZA,KE,2017.0,42,28,14
RO,DK,2014.0,4,4,0
CO,PA,2020.0,16,14,2
SG,IR,2018.0,65,43,22
GB,JO,2004.0,15,4,11
AU,ES,2021.0,53,44,9
CO,VE,2016.0,42,68,-26
GB,NL,2006.0,186,229,-43
CN,CR,2013.0,7,1,6
GB,IT,2000.0,172,245,-73
IN,FR,2012.0,107,88,19
US,PE,1998.0,11,14,-3
SE,NL,2003.0,40,30,10
IN,KW,2000.0,4,4,0
BD,PK,2013.0,40,22,18
US,VE,2014.0,29,43,-14
IS,US,2006.0,11,27,-16
CZ,SK,2009.0,48,78,-30
JP,TW,2014.0,75,89,-14
BD,JP,2012.0,35,79,-44
IE,JP,2011.0,23,23,0
PL,BH,2020.0,9,10,-1
nan,DK,2016.0,28,13,15
EG,MY,1998.0,1,2,-1
MY,BR,2006.0,100,102,-2
nan,NZ,2000.0,3,8,-5
DE,TN,2020.0,8,7,1
ES,IT,2020.0,292,283,9
UA,nan,1999.0,13,11,2
KR,CA,2022.0,45,46,-1
ZA,KE,2019.0,46,25,21
ID,DE,2018.0,39,52,-13
DE,CA,2021.0,223,201,22
US,RS,2002.0,21,20,1
SE,DE,2016.0,196,277,-81
AR,nan,2010.0,41,31,10
GR,RU,2019.0,7,5,2
RU,GR,2020.0,6,7,-1
ES,AU,2017.0,80,59,21
GR,IT,1999.0,5,1,4
IN,CO,2020.0,4,7,-3
JP,TH,2008.0,70,28,42
CA,PL,2014.0,22,25,-3
GB,EG,2012.0,103,49,54
BE,KE,2017.0,5,4,1
MX,PE,2012.0,86,52,34
NL,CZ,2015.0,20,17,3
MX,BR,2006.0,43,43,0
AR,BR,2012.0,140,103,37
CN,GR,2009.0,23,21,2
IN,CN,2006.0,118,93,25
CN,HU,2014.0,5,3,2
US,DK,2000.0,150,152,-2
BR,CN,2014.0,47,65,-18
RO,ZA,2010.0,4,2,2
nan,CN,2015.0,132,114,18
CN,RS,2015.0,10,4,6
DE,CZ,2003.0,30,31,-1
US,PH,2017.0,301,408,-107
BG,RU,2001.0,9,12,-3
PE,MX,2005.0,19,26,-7
PK,NL,2009.0,5,1,4
CA,SE,2020.0,54,56,-2
AU,IE,2016.0,101,101,0
VN,US,2016.0,71,127,-56
nan,JP,2007.0,98,42,56
PL,BE,2015.0,18,21,-3
BE,DE,2015.0,135,154,-19
CZ,NL,2016.0,16,16,0
GB,AT,2013.0,94,104,-10
RS,US,2015.0,54,65,-11
BE,BR,2015.0,84,71,13
BJ,BR,2006.0,2,2,0
CA,TZ,2007.0,5,2,3
SG,CH,2020.0,21,24,-3
HR,SI,2020.0,42,41,1
JP,GR,1999.0,31,36,-5
IL,US,2021.0,380,405,-25
US,SK,2015.0,32,34,-2
FR,JP,2018.0,185,178,7
ID,AU,2008.0,10,37,-27
FR,LB,2002.0,16,5,11
NZ,DE,2014.0,46,45,1
TR,BR,2018.0,23,10,13
CU,AU,2016.0,3,1,2
FR,BR,2015.0,235,234,1
FR,BE,1997.0,96,103,-7
PT,CA,2011.0,19,12,7
HU,US,2016.0,94,107,-13
PL,CH,2017.0,39,31,8
CH,EC,2018.0,4,2,2
JP,PL,2018.0,14,18,-4
IN,NL,2012.0,65,36,29
ES,CZ,2019.0,26,22,4
NL,LU,2018.0,8,4,4
nan,MX,2018.0,46,36,10
CN,BD,2006.0,18,15,3
GB,SK,2011.0,18,27,-9
CH,JP,2005.0,56,49,7
TR,SA,2019.0,13,19,-6
CH,CN,2013.0,69,83,-14
BR,CO,2009.0,49,64,-15
CN,SE,1998.0,34,28,6
JP,EG,2006.0,53,41,12
PK,IN,2014.0,207,216,-9
AR,PT,2022.0,9,8,1
IR,KR,2015.0,12,9,3
IE,CA,2017.0,130,169,-39
IT,EG,2006.0,9,3,6
BR,UY,2015.0,32,49,-17
GR,JP,1999.0,36,31,5
CN,CH,2013.0,83,69,14
CL,ID,2019.0,25,12,13
BE,TR,2021.0,17,16,1
IR,AT,2014.0,14,12,2
ES,DK,2002.0,22,16,6
IL,DE,2000.0,34,37,-3
SE,ES,2009.0,35,45,-10
SA,IN,2005.0,12,11,1
PE,IT,2010.0,4,2,2
nan,BR,2007.0,31,40,-9
GB,IS,2009.0,10,5,5
IE,CA,2019.0,186,170,16
BE,CH,2020.0,105,89,16
NL,nan,2011.0,61,65,-4
EE,GB,2012.0,6,12,-6
DK,DE,2022.0,95,110,-15
CA,BE,2006.0,39,48,-9
CZ,PL,2022.0,48,35,13
HR,RS,2002.0,15,13,2
NL,FR,2006.0,161,155,6
IT,NO,2008.0,22,26,-4
NO,GB,2022.0,56,73,-17
BR,VE,2014.0,17,26,-9
VN,SG,2014.0,6,8,-2
PT,ES,2007.0,93,88,5
SA,EG,2011.0,102,262,-160
CA,EG,2018.0,77,79,-2
JO,MY,2016.0,17,17,0
NL,NO,2012.0,37,31,6
FI,SE,2014.0,93,77,16
HR,RS,2005.0,55,38,17
RU,IT,2003.0,18,15,3
JM,GB,2020.0,6,4,2
MY,IN,2016.0,114,148,-34
JO,PS,2020.0,11,14,-3
ES,UY,2003.0,14,14,0
NG,PK,2020.0,5,9,-4
NL,ID,2005.0,11,11,0
CH,AR,2015.0,19,18,1
AE,GB,2021.0,29,61,-32
GB,ZA,2015.0,167,147,20
nan,IT,2006.0,69,93,-24
AR,nan,2017.0,43,47,-4
NL,SG,2011.0,14,12,2
PY,MX,2017.0,11,20,-9
ZA,PK,2020.0,9,1,8
CN,RO,2001.0,7,2,5
RU,CZ,2008.0,43,27,16
SG,NZ,2008.0,13,12,1
nan,CA,2003.0,9,13,-4
HU,NL,2015.0,12,14,-2
nan,DZ,2022.0,9,3,6
DE,LU,2013.0,33,27,6
JP,IN,2021.0,81,90,-9
PK,IQ,2020.0,28,26,2
SD,TR,2015.0,1,1,0
HR,XK,2021.0,2,5,-3
AR,nan,2019.0,48,47,1
ES,CZ,2017.0,23,16,7
FI,NL,1998.0,11,16,-5
UA,LV,2019.0,4,5,-1
DE,BR,2012.0,230,167,63
GB,GH,2019.0,45,22,23
US,IR,2005.0,71,60,11
QA,ES,2017.0,5,12,-7
ML,FR,2020.0,12,27,-15
AT,CL,2013.0,5,3,2
FI,EE,2022.0,9,6,3
MX,FR,1998.0,19,25,-6
NG,IN,2019.0,30,43,-13
BH,PL,2019.0,8,15,-7
CN,SY,2012.0,37,27,10
PL,GB,2020.0,125,107,18
NL,CN,2022.0,117,107,10
NZ,IE,2006.0,11,9,2
VN,NL,1998.0,3,3,0
nan,DE,2012.0,82,64,18
CA,PK,2020.0,60,51,9
UA,CN,2015.0,13,11,2
nan,EG,2018.0,15,2,13
NZ,DK,2018.0,13,5,8
ES,DK,2005.0,32,21,11
SG,SE,2004.0,3,5,-2
US,MY,2006.0,64,38,26
SD,IQ,2019.0,16,6,10
IT,AU,1998.0,15,12,3
GB,AE,2015.0,53,29,24
CA,SG,2015.0,51,42,9
BR,MY,2006.0,102,100,2
MZ,UA,2018.0,2,3,-1
IR,CH,2020.0,41,28,13
US,RS,2005.0,39,42,-3
nan,KE,2020.0,3,7,-4
JP,RU,2019.0,60,37,23
SJ,NO,2020.0,8,6,2
PL,CN,2006.0,28,12,16
IN,DK,2007.0,9,8,1
RU,CH,2018.0,39,41,-2
PK,CN,2023.0,30,25,5
NZ,SE,2000.0,4,4,0
AT,CO,2021.0,3,4,-1
ES,CZ,2010.0,17,11,6
ES,VE,2013.0,70,88,-18
CL,NZ,2018.0,6,8,-2
PA,US,2016.0,55,77,-22
TR,ET,2021.0,2,4,-2
RW,KE,2020.0,8,4,4
KR,PR,2020.0,31,58,-27
DZ,US,2021.0,52,40,12
NZ,TH,2022.0,2,3,-1
IR,FI,2018.0,22,11,11
VN,UA,2018.0,2,6,-4
SI,AT,2014.0,25,13,12
CU,IT,2008.0,7,2,5
NL,BD,2012.0,3,4,-1
RS,ME,2016.0,21,12,9
FR,SG,2021.0,32,17,15
GM,GB,2020.0,8,12,-4
NO,nan,2022.0,10,14,-4
US,TH,2006.0,156,76,80
PL,AT,2011.0,11,10,1
AT,US,2008.0,162,201,-39
JO,QA,2019.0,20,7,13
JO,EG,2020.0,28,24,4
FR,BE,1998.0,130,125,5
DK,CA,2021.0,34,44,-10
IE,AE,2022.0,2,2,0
ES,MA,2022.0,4,5,-1
SK,BR,2019.0,4,6,-2
TR,NO,2020.0,13,10,3
US,UA,2018.0,86,77,9
AT,VN,2016.0,7,2,5
US,QA,2008.0,31,12,19
NO,DK,1997.0,21,24,-3
RU,LT,2021.0,6,11,-5
IN,CZ,2022.0,20,11,9
PL,CH,2019.0,34,27,7
PA,ES,2001.0,6,13,-7
FR,TD,2021.0,1,1,0
NG,ET,2021.0,16,9,7
PL,SE,2018.0,37,24,13
US,LI,2018.0,2,1,1
UA,UZ,2016.0,9,1,8
DE,CL,2015.0,69,44,25
CN,DK,2003.0,13,8,5
IT,MY,2018.0,47,48,-1
US,VN,2016.0,127,71,56
ES,CU,2012.0,86,114,-28
GE,US,2012.0,166,141,25
CA,CL,2019.0,36,26,10
CN,RU,2016.0,55,43,12
MZ,BR,2011.0,5,9,-4
MX,AR,1998.0,20,17,3
ES,JP,2012.0,31,30,1
ES,TN,2020.0,5,12,-7
MY,JO,2018.0,21,14,7
IE,CZ,2017.0,4,3,1
SI,US,2015.0,17,26,-9
ET,IN,2020.0,29,64,-35
LB,FR,2016.0,42,97,-55
KE,US,2006.0,35,25,10
BR,CL,1998.0,9,12,-3
IT,PT,2022.0,23,25,-2
UY,AR,2018.0,39,45,-6
CN,FI,2021.0,36,44,-8
NI,BR,2018.0,3,2,1
DE,MY,2008.0,7,7,0
IS,NL,2002.0,1,1,0
DK,IT,2018.0,32,71,-39
NZ,NP,2015.0,37,33,4
ES,AT,2015.0,42,24,18
RS,CA,2003.0,5,12,-7
US,CM,2015.0,15,18,-3
FR,BI,2000.0,11,12,-1
CA,CH,2012.0,130,93,37
RU,AU,2018.0,22,43,-21
IR,PK,2018.0,27,13,14
BR,NG,2018.0,15,7,8
TZ,KE,2013.0,5,8,-3
AE,CA,2014.0,14,29,-15
US,LT,2013.0,20,16,4
FR,GR,1997.0,8,11,-3
CO,CH,2020.0,23,13,10
MA,SA,2013.0,1,3,-2
IT,SE,2003.0,56,33,23
SE,UA,2022.0,5,2,3
ZA,SE,2018.0,20,19,1
TR,IT,2008.0,15,6,9
US,IR,2002.0,27,28,-1
US,HK,2018.0,18,13,5
JP,BD,2008.0,69,35,34
RU,RS,2021.0,18,11,7
ME,RS,2019.0,21,21,0
NO,DK,1998.0,33,34,-1
SG,GB,2007.0,91,89,2
AT,NL,2012.0,18,30,-12
NL,IL,2009.0,14,18,-4
NL,MX,2018.0,17,17,0
LI,DE,2005.0,3,8,-5
HR,CA,2010.0,3,3,0
BW,US,2003.0,7,4,3
TR,IE,2014.0,4,2,2
MY,SD,2015.0,8,5,3
FR,VE,2007.0,6,5,1
IE,ES,2022.0,21,17,4
IR,HR,2010.0,1,2,-1
CR,CL,2014.0,25,28,-3
CA,HR,2001.0,2,1,1
BE,FI,2022.0,11,10,1
PE,CO,2021.0,50,82,-32
NL,DK,2005.0,27,12,15
GB,SG,2023.0,8,9,-1
SE,AU,2021.0,55,50,5
NL,QA,2014.0,5,2,3
ES,RU,2003.0,9,5,4
QA,JO,2015.0,3,6,-3
LT,US,2008.0,10,8,2
NL,SE,2008.0,38,36,2
AU,PL,2011.0,15,9,6
DK,NL,2017.0,58,72,-14
BE,KE,2019.0,7,5,2
RS,DE,2016.0,22,10,12
AU,nan,2008.0,39,22,17
SD,IQ,2017.0,9,5,4
IR,EG,2011.0,10,9,1
KR,MY,2021.0,17,20,-3
IL,TN,2017.0,2,1,1
MY,SA,2022.0,39,16,23
BN,MY,2008.0,5,1,4
KW,GB,2018.0,10,21,-11
FI,RU,2018.0,40,37,3
MX,JP,2005.0,16,9,7
CZ,CH,2003.0,19,16,3
SE,IE,1997.0,2,1,1
SY,QA,2016.0,3,1,2
KE,IT,2021.0,8,4,4
SA,CA,2013.0,44,101,-57
MY,NL,2005.0,3,2,1
BG,DE,2009.0,21,27,-6
IS,NO,2002.0,1,6,-5
HK,NL,2015.0,15,17,-2
BG,ID,2018.0,7,3,4
GB,KW,2022.0,10,8,2
SA,KW,2013.0,8,13,-5
UA,NL,2015.0,12,5,7
NO,NL,2011.0,30,22,8
IN,LT,2018.0,1,2,-1
IR,CZ,2021.0,10,6,4
CL,CU,2012.0,19,19,0
IE,ZA,2000.0,2,2,0
ES,AO,2020.0,1,2,-1
CA,CL,2017.0,28,25,3
FR,BY,2013.0,2,1,1
MC,FR,2014.0,9,7,2
DE,AR,2017.0,49,51,-2
VE,FR,2015.0,13,5,8
MX,EC,2008.0,5,6,-1
KR,ID,2022.0,16,23,-7
CU,CL,2018.0,34,20,14
VN,TW,2005.0,5,2,3
QA,CN,2013.0,14,7,7
PS,IL,2020.0,6,12,-6
DE,AZ,2017.0,3,7,-4
BE,RU,2017.0,18,15,3
SG,TH,2022.0,6,2,4
IN,MX,2022.0,8,8,0
ES,AU,2010.0,43,32,11
AE,QA,2015.0,10,7,3
IR,BE,2016.0,31,25,6
SE,TR,2009.0,2,11,-9
DK,TR,2015.0,8,13,-5
MK,SI,2020.0,3,1,2
KR,IT,2021.0,11,4,7
CA,TW,2008.0,38,25,13
AU,TH,2015.0,47,21,26
DE,SG,1999.0,5,2,3
MM,JP,2020.0,8,16,-8
FR,CI,2019.0,37,27,10
GH,FI,2018.0,1,2,-1
ID,BD,2016.0,17,28,-11
MY,FR,2014.0,7,20,-13
DK,FI,2020.0,20,28,-8
GB,IR,2006.0,64,24,40
GB,CY,2006.0,11,7,4
VN,GB,2010.0,6,10,-4
AU,VN,2015.0,35,33,2
IT,AO,2002.0,5,3,2
UY,VE,2012.0,5,4,1
CN,NL,2001.0,24,36,-12
BR,EC,2016.0,40,15,25
ET,SG,2021.0,2,1,1
DZ,MA,2020.0,39,21,18
IQ,AE,2014.0,4,5,-1
PK,SE,2021.0,10,15,-5
IR,ZA,2020.0,5,5,0
MM,CN,2020.0,3,5,-2
BN,GB,2021.0,1,5,-4
BE,NL,2023.0,10,10,0
AT,SK,2006.0,11,7,4
US,MA,2003.0,6,11,-5
ES,AU,2019.0,73,64,9
PL,NO,2012.0,10,7,3
PT,IT,2014.0,36,47,-11
GR,CY,2012.0,50,25,25
KE,UG,2013.0,6,11,-5
LI,AT,2020.0,3,7,-4
LK,NZ,2011.0,2,2,0
ZA,MW,2012.0,7,6,1
IR,IN,2018.0,31,40,-9
UA,TR,2020.0,1,6,-5
FR,GF,2021.0,12,14,-2
AU,FJ,2003.0,2,2,0
ID,PK,2011.0,9,4,5
ET,SE,2018.0,8,10,-2
BG,CN,2021.0,5,5,0
UY,IT,2018.0,11,9,2
UA,PL,2001.0,14,8,6
DE,FR,2005.0,380,353,27
FR,CI,2010.0,23,13,10
AR,IT,2003.0,50,42,8
CN,KE,2021.0,10,3,7
KR,TR,2008.0,4,4,0
nan,PE,2015.0,9,11,-2
NO,SJ,2014.0,4,5,-1
UA,CA,2013.0,5,4,1
JO,QA,2017.0,7,2,5
DK,GL,2012.0,6,2,4
NO,SE,1999.0,26,41,-15
SE,MX,2022.0,3,12,-9
UA,GB,1999.0,7,7,0
SI,RS,2012.0,21,11,10
NG,KE,2016.0,3,5,-2
TH,FR,2021.0,10,22,-12
ZA,KE,2010.0,15,8,7
QA,US,2001.0,3,7,-4
LU,GB,2008.0,5,8,-3
NP,US,2004.0,6,12,-6
LT,GB,2013.0,5,7,-2
FR,DZ,1999.0,20,9,11
NL,PK,2009.0,1,5,-4
IE,HR,2001.0,2,1,1
PE,BR,2013.0,28,41,-13
HK,DE,2017.0,2,1,1
GB,GH,2017.0,34,19,15
BY,CZ,2012.0,13,20,-7
IT,AU,1997.0,10,16,-6
CH,RS,2014.0,8,10,-2
NO,BG,2005.0,4,3,1
FR,LB,2005.0,24,18,6
JP,NZ,2004.0,13,7,6
CH,HU,2015.0,10,16,-6
PT,CN,2019.0,9,7,2
BE,NO,2015.0,12,8,4
LV,SE,2013.0,3,5,-2
FR,TR,2012.0,24,16,8
CH,SG,2008.0,13,5,8
UZ,KZ,2013.0,11,8,3
CL,ES,1998.0,32,41,-9
NO,CH,2008.0,9,15,-6
DE,MX,2003.0,19,19,0
LA,UZ,2016.0,1,1,0
CN,CO,2010.0,2,2,0
CH,SE,1998.0,20,23,-3
JP,CZ,2004.0,16,18,-2
CM,NG,2005.0,1,1,0
DE,AR,2019.0,40,65,-25
CZ,RO,2016.0,24,6,18
TR,SA,2010.0,7,11,-4
IT,VN,2022.0,2,5,-3
GB,CZ,2014.0,56,44,12
CL,GB,2001.0,9,10,-1
IE,BE,2007.0,7,7,0
KZ,JP,2020.0,4,3,1
nan,SE,1998.0,30,32,-2
NO,ID,2016.0,4,3,1
IT,TW,2016.0,4,5,-1
NO,FI,2003.0,9,6,3
MQ,FR,2007.0,6,10,-4
HR,GB,2012.0,18,8,10
RU,MX,1998.0,11,5,6
RU,UZ,2007.0,9,17,-8
NZ,SA,2018.0,3,6,-3
CL,ES,1997.0,29,27,2
NP,KR,2015.0,8,9,-1
NO,CA,2004.0,9,12,-3
LK,JP,2016.0,11,25,-14
RU,LV,2008.0,12,27,-15
LU,DE,2008.0,7,29,-22
CN,UG,2019.0,2,4,-2
BD,IR,2011.0,2,3,-1
CA,CL,2010.0,17,10,7
MX,HR,2008.0,2,1,1
IR,CO,2020.0,6,2,4
GT,CO,2015.0,2,8,-6
IS,CA,2013.0,3,1,2
IT,UY,2009.0,6,3,3
TW,CA,1998.0,17,17,0
GR,KW,2021.0,7,3,4
RS,CZ,2016.0,15,12,3
NP,IT,2017.0,2,1,1
NP,IT,2019.0,3,2,1
IN,RU,2008.0,11,20,-9
KE,IN,2008.0,3,1,2
SE,IS,1998.0,9,3,6
PT,CN,2017.0,15,12,3
LV,PH,2011.0,2,1,1
BE,DK,2008.0,10,8,2
MX,JP,2002.0,5,9,-4
BE,LU,2018.0,20,14,6
ET,GB,2007.0,3,4,-1
CR,IT,2019.0,1,2,-1
IL,FR,2003.0,29,20,9
AT,DK,2009.0,12,7,5
FR,ML,2011.0,9,10,-1
IT,CL,2022.0,11,19,-8
AE,SE,2005.0,1,2,-1
SE,TW,2003.0,1,2,-1
LB,ID,2017.0,3,1,2
PG,TR,2020.0,1,2,-1
DE,nan,2001.0,26,20,6
US,MZ,2010.0,3,2,1
BE,TH,2016.0,7,6,1
TR,BG,2014.0,2,1,1
PL,CH,2010.0,24,10,14
FR,GR,1998.0,20,15,5
BR,BE,1998.0,14,16,-2
IT,CA,2001.0,64,54,10
MX,KR,2019.0,7,3,4
nan,IR,2015.0,5,2,3
PL,IN,2020.0,13,27,-14
RO,ZA,2017.0,6,5,1
JP,IL,2021.0,7,10,-3
US,SL,2020.0,1,4,-3
VN,TW,2002.0,7,2,5
AU,MK,2012.0,42,37,5
PT,CN,2010.0,11,9,2
RO,CZ,2016.0,6,24,-18
MX,UY,2022.0,6,6,0
IE,nan,2011.0,6,3,3
LB,SA,2016.0,4,5,-1
PT,CO,2022.0,10,9,1
PK,KR,2000.0,5,3,2
KW,MA,2013.0,5,11,-6
MT,GB,2009.0,8,5,3
NL,SI,2020.0,8,8,0
CO,PL,2003.0,1,1,0
CR,FR,2019.0,9,6,3
MN,PL,2017.0,1,1,0
RU,BY,2001.0,17,23,-6
CN,AT,2018.0,20,23,-3
SI,NL,2012.0,4,4,0
CN,IQ,2019.0,16,10,6
PH,AR,2018.0,3,3,0
CN,SI,2010.0,2,3,-1
SK,RS,2018.0,10,11,-1
CM,DE,2020.0,11,8,3
IT,PH,2017.0,6,1,5
NG,IR,2020.0,4,5,-1
CN,MA,2021.0,2,2,0
DE,GR,2006.0,29,28,1
PY,MX,2019.0,13,27,-14
DE,IS,2020.0,6,6,0
GR,RU,2017.0,4,5,-1
BA,CH,2019.0,5,2,3
RO,BE,2003.0,5,1,4
IE,MX,2009.0,3,4,-1
FR,CL,2012.0,51,28,23
TH,CA,2006.0,11,7,4
CH,BE,2003.0,31,29,2
IN,SK,2005.0,1,1,0
DK,NL,2010.0,32,35,-3
CH,MY,2015.0,4,3,1
NG,BH,2015.0,3,1,2
IT,BD,2012.0,5,7,-2
IL,PT,2016.0,4,1,3
IT,TR,1998.0,10,4,6
KW,IQ,2019.0,9,5,4
CN,SK,2007.0,1,4,-3
BO,CO,2013.0,5,4,1
FR,CU,2019.0,1,5,-4
SY,FR,2014.0,7,13,-6
ZA,BR,2016.0,8,11,-3
CG,BJ,2016.0,2,1,1
MY,TN,2020.0,6,1,5
NL,ZA,2007.0,29,24,5
SE,PT,2016.0,10,15,-5
FI,ZA,2016.0,4,1,3
HR,AU,2011.0,5,1,4
CG,FR,2006.0,13,14,-1
AT,BE,2021.0,11,18,-7
SE,IS,1997.0,9,3,6
US,FI,2023.0,7,11,-4
PE,BE,2007.0,1,1,0
RS,CL,2007.0,1,1,0
EG,JO,1997.0,1,4,-3
UA,CH,2002.0,6,1,5
JO,AE,2022.0,24,15,9
SA,TR,2014.0,17,10,7
UZ,UA,2007.0,4,1,3
IR,IE,2014.0,18,7,11
JP,DK,2004.0,6,10,-4
ZA,DK,2017.0,7,9,-2
NL,ZW,2018.0,2,2,0
CA,BW,2006.0,3,1,2
BR,CL,1997.0,6,5,1
CZ,NO,2018.0,12,3,9
AT,nan,2006.0,7,12,-5
AE,YE,2019.0,2,1,1
NO,IT,2006.0,10,20,-10
TR,SE,2009.0,11,2,9
SI,ES,2008.0,4,4,0
SA,FR,2003.0,3,4,-1
FR,SA,2004.0,3,4,-1
HR,DE,2023.0,1,1,0
BG,BR,2011.0,3,3,0
AU,TR,2017.0,11,23,-12
ES,AD,2016.0,3,2,1
IT,LB,2013.0,13,10,3
UA,CH,2005.0,3,4,-1
VN,GB,2017.0,13,18,-5
LB,QA,2021.0,9,1,8
RO,ZA,2019.0,6,7,-1
SA,NZ,2014.0,2,4,-2
TR,NG,2017.0,6,2,4
JP,UA,2015.0,10,3,7
RS,SK,2011.0,8,5,3
IR,BR,2014.0,16,1,15
AU,AT,2009.0,14,23,-9
ZM,ZW,2017.0,1,3,-2
IL,ZA,2013.0,3,2,1
PK,JP,1999.0,9,2,7
NZ,IT,2005.0,2,3,-1
IR,GB,2023.0,4,2,2
SE,HU,2011.0,9,10,-1
GB,GH,2010.0,13,5,8
NZ,IT,2002.0,4,1,3
SE,SG,2007.0,6,3,3
CO,JP,2002.0,5,7,-2
TR,CH,2005.0,7,2,5
TH,DE,2008.0,5,14,-9
AU,JO,2016.0,11,4,7
IN,ET,2005.0,5,1,4
VA,IT,2020.0,2,1,1
DE,VN,2022.0,10,19,-9
DE,LB,2014.0,7,6,1
UA,NG,2013.0,1,1,0
IN,GH,2012.0,2,5,-3
GN,SN,2018.0,2,4,-2
ZW,US,2008.0,5,3,2
CH,PL,2022.0,13,23,-10
ES,EG,2012.0,9,5,4
CN,SI,2017.0,5,6,-1
TR,SY,2021.0,2,2,0
AT,RS,2007.0,7,5,2
MX,NZ,2015.0,2,1,1
CA,GR,2000.0,9,6,3
NZ,AR,2009.0,1,1,0
KR,AU,1997.0,6,6,0
IR,DE,2004.0,7,10,-3
BD,EG,2020.0,11,11,0
PK,BD,2014.0,26,39,-13
BD,nan,2011.0,2,2,0
BE,TW,2017.0,4,5,-1
CH,IE,2004.0,5,8,-3
US,AL,2018.0,6,4,2
MY,TR,2013.0,11,13,-2
MT,AU,2014.0,4,1,3
PY,DE,2020.0,3,4,-1
IE,CN,2004.0,7,17,-10
SI,CN,2017.0,6,5,1
CM,CA,2020.0,6,6,0
FI,KR,2015.0,4,2,2
ME,RS,2017.0,13,20,-7
AR,BO,2011.0,1,3,-2
NZ,MY,2009.0,6,7,-1
NL,TW,2013.0,6,8,-2
SE,EE,2008.0,8,6,2
BR,PL,2001.0,2,5,-3
DK,PT,2022.0,5,7,-2
GB,OM,2007.0,14,2,12
TR,CH,2002.0,3,5,-2
ES,RS,2006.0,2,2,0
CZ,CA,2020.0,12,9,3
ME,RS,2010.0,10,9,1
FI,UA,2013.0,1,5,-4
TN,AE,2014.0,4,2,2
HK,CA,2006.0,2,1,1
KW,JO,2013.0,5,3,2
CM,GR,2012.0,1,1,0
HR,MX,2007.0,1,3,-2
ID,VN,2019.0,1,2,-1
PH,CL,2005.0,3,1,2
CL,BO,2011.0,6,11,-5
US,GM,2010.0,1,2,-1
SA,TW,2012.0,1,4,-3
LU,NL,2002.0,2,3,-1
BY,DE,2011.0,8,2,6
BO,US,2006.0,5,4,1
CA,SD,2017.0,3,3,0
NL,CW,2020.0,4,7,-3
HU,CN,2000.0,3,2,1
MA,CN,2007.0,2,1,1
PT,RS,2006.0,1,1,0
MA,KW,2008.0,4,4,0
NP,SG,2015.0,2,2,0
BR,AO,2017.0,18,27,-9
MX,PL,2020.0,4,4,0
KR,AU,1998.0,6,6,0
AU,PA,2017.0,5,1,4
PH,DE,2022.0,4,4,0
BN,DE,2019.0,1,1,0
US,GM,2019.0,3,2,1
CA,AE,1999.0,9,3,6
JP,MX,2020.0,6,8,-2
UA,BE,2016.0,4,3,1
IE,MY,2014.0,11,1,10
TW,CA,1997.0,15,10,5
BR,CZ,2011.0,8,6,2
CY,GR,2002.0,6,3,3
AT,KR,1999.0,2,1,1
SI,CN,2019.0,3,5,-2
SG,AU,1999.0,24,27,-3
SA,KZ,2020.0,4,1,3
JP,KE,2012.0,9,10,-1
PK,FR,2022.0,10,12,-2
JP,AR,2011.0,5,7,-2
SA,BR,2016.0,5,4,1
SI,CZ,2004.0,6,5,1
KR,DE,2001.0,9,18,-9
CR,IT,2017.0,3,5,-2
US,PA,2006.0,11,17,-6
nan,CH,2007.0,8,14,-6
TR,NL,2006.0,11,12,-1
PH,NP,2014.0,1,2,-1
DE,AZ,2019.0,3,4,-1
CY,IE,2019.0,1,1,0
BA,SI,2015.0,5,5,0
BD,ES,2011.0,7,39,-32
BA,CA,2015.0,1,1,0
GB,RO,2001.0,7,9,-2
TW,EG,2007.0,3,1,2
DE,LV,2013.0,7,3,4
AR,TW,2012.0,18,10,8
GB,MT,2014.0,14,11,3
PA,IN,2018.0,2,4,-2
OM,US,2015.0,13,16,-3
IR,BD,2018.0,13,7,6
IT,GR,1998.0,5,4,1
HU,EG,2003.0,3,3,0
CH,TN,2022.0,6,1,5
FR,MG,2015.0,12,9,3
LV,US,2005.0,3,4,-1
LU,FR,2007.0,17,19,-2
TR,SA,2017.0,20,14,6
VE,EC,2012.0,6,2,4
BR,IN,2013.0,27,30,-3
US,MW,2001.0,4,2,2
NI,CL,2009.0,3,2,1
PL,FI,2002.0,1,2,-1
MK,AU,2008.0,16,26,-10
IL,DK,2007.0,4,1,3
DK,IE,2007.0,6,6,0
UY,BE,2015.0,2,1,1
DE,PH,1997.0,4,2,2
GB,LT,2001.0,1,1,0
IL,NO,2011.0,1,1,0
EG,AU,2022.0,16,11,5
FR,IS,2021.0,3,4,-1
NO,LT,2013.0,1,1,0
ZA,DK,2010.0,4,6,-2
SI,NO,2013.0,2,1,1
GB,BY,2020.0,1,1,0
FR,GB,2023.0,13,18,-5
DE,CO,2003.0,4,7,-3
NG,IN,2017.0,17,23,-6
BB,JM,2009.0,3,2,1
NZ,nan,2007.0,9,25,-16
FI,MY,2013.0,3,1,2
AT,PT,2018.0,8,5,3
SG,BE,2000.0,1,1,0
JP,MN,2013.0,5,3,2
EE,SI,2020.0,1,1,0
BE,CI,2008.0,1,2,-1
SG,GR,2016.0,2,3,-1
LU,CH,2004.0,1,1,0
CH,CL,2007.0,5,6,-1
RU,ES,2012.0,13,7,6
SK,CH,2014.0,5,7,-2
CZ,RS,2022.0,4,8,-4
NL,EE,2018.0,7,5,2
CH,BG,2016.0,3,3,0
BJ,ZA,2008.0,2,1,1
CN,ZM,2018.0,3,2,1
CH,TZ,2015.0,5,6,-1
KE,CA,2015.0,10,8,2
US,CR,2003.0,13,13,0
NG,IN,2010.0,5,5,0
MD,UA,2013.0,1,1,0
IQ,OM,2020.0,6,4,2
PL,nan,2006.0,6,6,0
GR,CA,2008.0,6,10,-4
AR,IN,2022.0,2,2,0
NZ,BR,2000.0,2,1,1
SA,BD,2001.0,2,5,-3
GB,ZW,1997.0,4,3,1
DK,NZ,2011.0,7,7,0
SY,US,2001.0,3,8,-5
SA,IN,2002.0,9,10,-1
IT,VE,2003.0,4,4,0
GR,RS,2015.0,2,2,0
AT,SG,2013.0,5,5,0
PA,CO,2012.0,7,7,0
NG,CZ,2015.0,1,2,-1
IE,CZ,2010.0,3,5,-2
VE,CR,2013.0,6,3,3
DK,NP,2009.0,1,1,0
CA,HU,2003.0,7,10,-3
JP,RO,2014.0,3,4,-1
IL,AU,2013.0,18,11,7
FR,GN,2012.0,3,4,-1
RU,TW,1997.0,2,5,-3
NZ,NL,2016.0,14,16,-2
NZ,ZA,1997.0,3,4,-1
CL,PE,2000.0,5,2,3
NL,KR,2008.0,7,7,0
KE,CN,2009.0,1,6,-5
QA,ES,2019.0,10,4,6
CM,CH,2013.0,3,6,-3
GW,DK,2001.0,2,3,-1
CL,CR,2022.0,4,12,-8
PE,GB,2005.0,7,4,3
BE,BI,2002.0,2,1,1
CA,UA,2021.0,2,4,-2
FI,IR,2020.0,13,41,-28
NL,SA,1997.0,2,1,1
CA,KH,2019.0,1,3,-2
IE,TR,2017.0,6,7,-1
EG,NL,2020.0,8,8,0
BR,CR,2013.0,6,9,-3
FR,CM,2022.0,7,7,0
PE,GB,2002.0,2,1,1
IT,BG,2013.0,8,5,3
KZ,US,2018.0,16,13,3
TR,AZ,2013.0,9,4,5
SY,IR,2021.0,1,2,-1
NZ,IR,2015.0,2,17,-15
EC,PY,2020.0,4,2,2
CN,IQ,2017.0,9,4,5
MX,IT,2000.0,10,7,3
EG,GB,2003.0,12,26,-14
AE,OM,2008.0,2,3,-1
AT,EE,2014.0,2,5,-3
YE,EG,2015.0,5,5,0
BD,AE,2011.0,1,1,0
BR,PH,1997.0,1,1,0
CO,IL,2020.0,11,5,6
BE,KE,2010.0,2,2,0
PE,IT,2019.0,5,9,-4
MZ,ZA,2022.0,2,1,1
IR,TW,2018.0,5,2,3
PE,MX,2002.0,17,12,5
MT,IT,2020.0,7,2,5
IT,SK,2007.0,8,13,-5
SE,SI,2004.0,2,2,0
GB,ZW,1998.0,6,2,4
IE,CZ,2019.0,7,9,-2
TN,nan,2011.0,2,5,-3
MD,RU,2006.0,4,1,3
BR,nan,2023.0,4,6,-2
TR,nan,2006.0,3,4,-1
EE,RU,2014.0,3,4,-1
SV,MX,2002.0,1,1,0
SA,QA,2009.0,5,2,3
AF,MX,2020.0,3,2,1
KZ,FI,2021.0,2,1,1
US,FJ,2014.0,3,5,-2
DK,CZ,2004.0,3,4,-1
PE,IT,2017.0,2,5,-3
KH,JP,2006.0,5,4,1
NL,ID,2002.0,2,5,-3
SN,MR,2014.0,1,1,0
BE,AT,2011.0,11,13,-2
ET,NO,2015.0,5,7,-2
NL,ES,2023.0,4,9,-5
DK,PH,2008.0,1,4,-3
HR,CA,2017.0,8,8,0
SG,DK,2022.0,4,2,2
BH,CA,2014.0,2,3,-1
UA,SK,2017.0,3,5,-2
RO,FI,2018.0,1,3,-2
KE,SE,2013.0,5,8,-3
JP,ZA,2022.0,3,3,0
MX,KR,2017.0,6,7,-1
AR,UY,1997.0,1,9,-8
LT,DK,2015.0,4,3,1
FR,CU,2017.0,7,7,0
RU,TR,2007.0,4,3,1
CL,ZA,2008.0,2,2,0
AU,SA,2009.0,11,6,5
TZ,GB,2015.0,17,16,1
DE,BA,2014.0,4,5,-1
HK,PL,2015.0,1,2,-1
HR,SE,2022.0,1,7,-6
ZW,ZA,2001.0,4,1,3
SG,IS,2014.0,2,1,1
MX,UA,2006.0,3,2,1
IQ,DE,2013.0,5,4,1
AT,GP,2015.0,1,1,0
JO,GB,2011.0,6,19,-13
SK,CA,2003.0,6,4,2
LT,PK,2008.0,3,2,1
ID,nan,2013.0,13,17,-4
PE,AR,2011.0,13,14,-1
SE,IE,1998.0,1,4,-3
JP,KH,2009.0,3,2,1
IQ,MA,2021.0,3,3,0
IR,RS,2021.0,1,1,0
BE,HU,2014.0,8,9,-1
BH,SA,2012.0,1,5,-4
AT,PK,2018.0,10,6,4
ZM,ZW,2019.0,4,3,1
PL,TW,1997.0,2,1,1
RS,CH,2007.0,5,2,3
JM,BB,2000.0,2,1,1
IT,IS,2015.0,3,2,1
LT,CN,2014.0,3,9,-6
LV,US,2002.0,6,2,4
MY,EG,2009.0,6,14,-8
IT,CR,2018.0,2,4,-2
IL,UA,2004.0,3,3,0
CL,ID,2017.0,16,6,10
BH,PL,2017.0,4,7,-3
IL,AT,2008.0,3,7,-4
GB,UA,2011.0,10,14,-4
CN,CO,2017.0,4,6,-2
JO,QA,2010.0,5,2,3
LT,SE,2001.0,2,4,-2
GH,BE,2019.0,1,3,-2
CH,BF,2022.0,2,1,1
CH,SI,2005.0,5,5,0
SE,GR,1999.0,3,2,1
DZ,BE,2004.0,2,2,0
DK,IS,2001.0,2,4,-2
IE,IL,2012.0,2,1,1
HR,FR,2018.0,4,11,-7
GB,DZ,1998.0,3,1,2
NL,UA,2006.0,2,5,-3
AU,KW,2012.0,2,2,0
CY,IE,2017.0,1,2,-1
GA,FR,2012.0,7,8,-1
PK,MA,2022.0,7,13,-6
nan,PS,2021.0,1,1,0
GR,AT,2021.0,6,7,-1
CM,KE,2016.0,3,1,2
FR,UA,2015.0,12,19,-7
CZ,FI,2011.0,9,8,1
HN,MX,2000.0,6,9,-3
BR,EG,2018.0,6,5,1
CM,SN,2017.0,3,3,0
VN,GB,2019.0,15,22,-7
KR,SD,2015.0,1,1,0
CN,IL,2023.0,4,6,-2
AU,KE,2017.0,7,4,3
SI,DE,2005.0,6,10,-4
NP,NZ,2009.0,6,6,0
IE,TR,2019.0,3,7,-4
NL,ZM,2015.0,2,1,1
ZA,IE,2004.0,5,2,3
PE,UY,2016.0,3,5,-2
NO,IN,2023.0,1,2,-1
TZ,ZA,2015.0,3,9,-6
DK,SG,2004.0,5,2,3
MX,VN,2003.0,2,4,-2
KZ,CN,2016.0,6,5,1
GR,VN,2000.0,5,4,1
SA,IL,2019.0,2,3,-1
AF,JP,2016.0,1,2,-1
IQ,KW,2011.0,1,1,0
TN,CN,2019.0,8,2,6
CA,SD,2019.0,2,1,1
NP,BD,2020.0,2,3,-1
RW,TR,2019.0,1,2,-1
NG,AU,2016.0,6,10,-4
PL,BA,2018.0,3,1,2
US,GM,2017.0,6,1,5
ZA,CH,2000.0,4,2,2
CH,MD,2015.0,1,1,0
UG,FR,2020.0,4,6,-2
ZA,BE,2003.0,5,6,-1
CA,NG,1998.0,1,1,0
AO,ES,2006.0,4,2,2
LU,US,1998.0,2,1,1
PK,UZ,2012.0,1,1,0
IR,PH,2019.0,2,1,1
DZ,TN,2009.0,4,3,1
PT,JP,2015.0,4,3,1
PA,GB,2004.0,2,1,1
VE,ID,2014.0,1,1,0
CH,ZA,2000.0,2,4,-2
FI,PL,2002.0,2,1,1
PT,PY,2018.0,3,1,2
CM,BE,2014.0,4,6,-2
JO,LB,2012.0,3,1,2
AR,FI,2008.0,1,1,0
RS,AT,2011.0,3,4,-1
BE,ZA,2002.0,7,7,0
CA,PE,2020.0,3,10,-7
MX,FR,1997.0,13,11,2
IE,AR,2016.0,1,3,-2
HN,DE,2019.0,1,1,0
HU,PL,2023.0,2,1,1
BE,NZ,2002.0,1,4,-3
RS,AU,2015.0,5,2,3
VN,IT,2018.0,1,8,-7
QA,ES,2010.0,3,7,-4
PH,IE,2010.0,2,1,1
AU,PA,2019.0,3,3,0
IN,TR,2023.0,2,2,0
HU,PK,2016.0,1,7,-6
CY,GB,2000.0,2,4,-2
IT,PH,2010.0,3,1,2
GB,SY,2018.0,2,8,-6
DE,GA,2013.0,2,5,-3
RO,RU,2005.0,2,3,-1
SY,BE,2005.0,1,1,0
JP,BG,2011.0,1,3,-2
DK,VN,2011.0,3,4,-1
GR,BE,2003.0,5,9,-4
GR,CM,2012.0,1,1,0
UG,CN,2022.0,1,2,-1
CR,CN,2002.0,1,1,0
BG,TR,2016.0,1,1,0
DK,AR,2008.0,2,2,0
NO,TR,2004.0,1,5,-4
CN,GH,2009.0,2,1,1
RU,MD,2007.0,6,3,3
TN,NO,2019.0,3,1,2
PT,DK,2002.0,3,2,1
PL,FI,2005.0,3,1,2
AU,SY,2014.0,1,2,-1
UZ,RU,2003.0,6,3,3
GH,SE,2012.0,1,1,0
AE,BR,2014.0,1,3,-2
PK,KW,2002.0,2,3,-1
BR,IR,2007.0,2,2,0
US,AO,2008.0,1,1,0
GR,IL,2009.0,1,1,0
CM,GH,2020.0,3,1,2
CR,PA,2014.0,2,1,1
BG,NL,2021.0,2,2,0
IS,PL,2020.0,1,2,-1
BE,RS,2020.0,2,5,-3
PE,UG,2010.0,1,2,-1
PK,SA,2007.0,13,10,3
VG,CA,2010.0,1,2,-1
BJ,JP,2019.0,1,1,0
CZ,KR,2014.0,5,15,-10
SG,ZA,2021.0,3,3,0
RS,GR,2011.0,1,3,-2
CY,IE,2010.0,1,1,0
VN,CA,2001.0,1,7,-6
PK,AT,2018.0,6,10,-4
DE,PH,1998.0,4,1,3
FI,LU,2016.0,2,4,-2
CA,PH,2020.0,6,15,-9
DZ,MY,2018.0,2,2,0
MW,NG,2016.0,1,1,0
US,XK,2021.0,3,2,1
GB,TZ,2007.0,5,5,0
GR,TW,2009.0,2,1,1
UA,SK,2019.0,8,4,4
US,GT,2006.0,3,4,-1
CN,SI,2019.0,5,3,2
US,SY,2008.0,3,4,-1
CU,PT,2012.0,1,3,-2
CL,IL,2011.0,3,2,1
NO,BG,2002.0,5,8,-3
CZ,DK,2011.0,3,1,2
GB,UG,2000.0,3,2,1
DO,MX,2012.0,5,4,1
NG,KR,2011.0,5,4,1
CH,PA,2016.0,1,2,-1
AU,IS,2003.0,1,1,0
CN,LY,2018.0,1,1,0
NC,FR,2009.0,8,15,-7
IQ,SA,2013.0,6,8,-2
MX,ZA,2000.0,1,1,0
ID,BH,2022.0,1,2,-1
BZ,FR,2011.0,2,2,0
MX,AR,1997.0,6,8,-2
CM,MA,2015.0,2,1,1
PA,AR,2007.0,2,2,0
MA,ID,2021.0,2,7,-5
US,BI,2020.0,1,5,-4
IL,VE,2016.0,1,1,0
SI,DE,2002.0,6,8,-2
OM,SE,2018.0,1,1,0
LK,GR,1999.0,2,5,-3
CA,PS,2022.0,2,1,1
US,NA,2019.0,6,1,5
NG,ZW,2017.0,1,1,0
PK,ID,2011.0,4,9,-5
BJ,IT,2014.0,2,1,1
AU,PE,2012.0,1,4,-3
ZW,BW,2021.0,3,1,2
KW,LB,2018.0,3,3,0
VG,CA,2019.0,1,1,0
AZ,ID,2020.0,2,4,-2
AT,IL,2011.0,5,5,0
TR,IS,2012.0,1,1,0
ML,IN,2009.0,2,7,-5
BR,AT,2004.0,3,3,0
IN,MA,2013.0,3,4,-1
TN,MA,2000.0,3,2,1
KW,BH,2008.0,1,1,0
EE,ES,2007.0,1,1,0
EE,CN,2019.0,2,1,1
IE,VE,2017.0,1,1,0
LK,PK,2011.0,1,1,0
GR,PT,2007.0,1,1,0
IN,JM,2015.0,3,2,1
IT,HR,2001.0,2,2,0
IS,AU,2016.0,2,1,1
UY,CU,2021.0,1,2,-1
DK,RU,2016.0,8,13,-5
CL,EC,2009.0,4,3,1
ZA,SN,2013.0,1,1,0
DE,AZ,2010.0,1,1,0
ZA,KR,2004.0,1,1,0
DK,IR,2023.0,1,3,-2
ZA,TH,2011.0,1,2,-1
CU,PA,2018.0,7,3,4
IR,KZ,2015.0,3,1,2
RU,QA,2020.0,1,1,0
ZA,CO,2007.0,1,2,-1
CL,nan,2006.0,1,1,0
IL,GR,2018.0,3,6,-3
US,PE,1997.0,10,9,1
FI,DK,2004.0,5,6,-1
OM,CA,2021.0,3,7,-4
QA,NZ,2020.0,3,1,2
DK,HU,2000.0,1,3,-2
DE,KE,1999.0,1,2,-1
IT,LT,2010.0,1,1,0
NO,HU,2005.0,1,3,-2
LU,US,1997.0,2,2,0
VN,nan,2008.0,1,1,0
BD,IN,2023.0,4,4,0
SI,SK,2011.0,1,3,-2
CA,NG,1997.0,2,1,1
NE,BE,2013.0,2,3,-1
UG,AU,2018.0,2,2,0
RS,KW,2019.0,1,1,0
PH,JP,2023.0,1,2,-1
PK,KW,2005.0,1,2,-1
GR,MX,2005.0,2,1,1
TT,GB,2007.0,3,2,1
CZ,TR,2003.0,1,1,0
NZ,ZA,1998.0,3,4,-1
IL,KR,2005.0,1,3,-2
MX,nan,2022.0,4,15,-11
CU,PY,2022.0,1,1,0
VN,PT,2012.0,1,1,0
DO,EC,2020.0,2,1,1
PE,CR,2001.0,1,2,-1
IN,EG,1998.0,1,1,0
NL,BJ,2009.0,1,1,0
MY,NL,2002.0,1,1,0
CZ,LV,2013.0,1,1,0
RU,TH,2014.0,2,2,0
CN,UG,2017.0,2,3,-1
RU,IN,2001.0,1,11,-10
IN,HK,2017.0,1,1,0
CN,MM,2014.0,1,5,-4
TZ,RU,2011.0,1,1,0
AT,BG,2016.0,1,5,-4
JP,ID,1997.0,2,2,0
GR,LK,2008.0,1,3,-2
FI,IN,2004.0,2,4,-2
BN,VN,2020.0,1,1,0
NO,SG,2016.0,2,2,0
JP,CA,2023.0,3,2,1
HN,DE,2017.0,1,1,0
UZ,US,2000.0,3,3,0
LK,TH,2011.0,2,2,0
UA,LV,2017.0,2,3,-1
BF,DE,2017.0,1,2,-1
MA,CI,2018.0,2,1,1
SA,ES,2023.0,1,1,0
IN,SK,2002.0,1,1,0
ET,SA,2022.0,1,3,-2
PY,MX,2010.0,3,2,1
MW,ET,2017.0,2,1,1
AU,KE,2010.0,1,4,-3
EG,PS,2008.0,3,1,2
ES,SV,2021.0,1,4,-3
MZ,PT,2016.0,2,1,1
US,CN,2016.0,5697,5042,655
US,IN,2020.0,3043,3064,-21
UA,SK,2010.0,4,2,2
CN,KR,2011.0,262,371,-109
US,NL,2009.0,668,616,52
CY,US,2009.0,11,40,-29
CN,AU,2008.0,249,238,11
IN,AU,2013.0,161,122,39
CA,SA,2015.0,110,57,53
DE,FR,2002.0,256,319,-63
CI,FR,2003.0,7,8,-1
US,PT,2004.0,115,80,35
FR,CI,2017.0,29,26,3
US,NZ,2017.0,426,372,54
GB,JP,2022.0,115,121,-6
CH,US,2004.0,498,536,-38
FR,nan,2009.0,178,162,16
GB,FI,2018.0,89,75,14
DE,IL,1999.0,29,25,4
BD,US,2007.0,34,62,-28
BR,AO,2019.0,40,24,16
US,GR,2015.0,154,212,-58
AU,KE,2019.0,11,12,-1
GR,RU,2010.0,6,6,0
BG,IN,2016.0,2,2,0
GE,RU,2020.0,8,6,2
TW,ID,2020.0,60,94,-34
IN,ZA,2021.0,47,43,4
QA,CA,2021.0,15,11,4
CU,DE,2016.0,11,2,9
LK,AU,2021.0,43,28,15
BE,US,2001.0,176,133,43
DO,AR,2014.0,1,1,0
KE,SO,2020.0,1,1,0
CZ,IL,2015.0,5,4,1
AT,GB,2012.0,76,108,-32
US,MZ,2019.0,3,6,-3
CH,CA,2018.0,112,128,-16
RU,MX,1997.0,7,3,4
CR,AR,2016.0,26,7,19
JP,RU,2010.0,39,37,2
TH,US,2014.0,116,227,-111
FR,DK,2006.0,38,28,10
JP,RU,2017.0,52,52,0
PL,HU,2001.0,9,7,2
JP,SK,2000.0,8,12,-4
TR,TW,2020.0,12,11,1
IL,nan,2021.0,22,19,3
BE,RU,2019.0,20,26,-6
US,NG,2006.0,20,26,-6
BE,GR,2006.0,10,7,3
EG,AT,2005.0,2,4,-2
HR,US,2001.0,22,16,6
SA,MY,2011.0,10,17,-7
TW,KR,2009.0,34,29,5
GH,US,2004.0,9,7,2
ES,MT,2015.0,4,2,2
nan,NO,1999.0,4,7,-3
ES,NO,2013.0,30,17,13
DE,AR,2010.0,27,29,-2
TH,PH,2013.0,5,2,3
IE,NL,2016.0,18,24,-6
PL,RO,2018.0,10,10,0
DE,CY,2013.0,5,4,1
ES,EC,2002.0,5,1,4
PE,CL,1997.0,4,1,3
RU,TW,1998.0,9,12,-3
MA,CA,2008.0,7,17,-10
BE,TW,2019.0,7,5,2
ZA,DK,2019.0,8,5,3
CO,EC,2009.0,2,10,-8
RU,ZW,2011.0,9,3,6
CN,IR,2003.0,4,2,2
BE,EG,2018.0,7,10,-3
DE,LK,2015.0,2,2,0
US,KW,2006.0,21,18,3
MY,TH,2016.0,9,9,0
UG,NG,2022.0,5,7,-2
BE,CL,2016.0,9,10,-1
MA,PT,2022.0,19,14,5
BE,RU,2010.0,13,13,0
CA,IQ,2018.0,18,4,14
BH,AU,2018.0,1,4,-3
JO,US,2023.0,2,1,1
CH,PK,2015.0,11,26,-15
BE,ZA,2005.0,8,7,1
BE,NZ,2005.0,6,3,3
SG,NL,2004.0,4,4,0
IT,AO,2005.0,1,2,-1
CO,DO,2018.0,5,6,-1
CN,SE,1997.0,25,16,9
GB,PE,2006.0,5,1,4
nan,SE,1997.0,18,31,-13
BG,FI,1998.0,1,1,0
DE,PA,2005.0,3,1,2
KR,BD,2023.0,3,3,0
NO,BE,2011.0,8,13,-5
SA,OM,2021.0,8,7,1
AT,PL,2008.0,9,18,-9
MN,TW,2011.0,1,1,0
TR,RU,2016.0,5,3,2
LB,BD,2020.0,1,1,0
IT,PH,2019.0,7,5,2
UZ,CN,2012.0,7,18,-11
LT,ES,2018.0,1,3,-2
CY,GR,2005.0,5,5,0
CN,PL,2004.0,10,19,-9
PL,GE,2014.0,2,1,1
BR,BE,1997.0,7,11,-4
FR,GA,2002.0,2,1,1
TR,NG,2010.0,1,2,-1
nan,AT,2015.0,10,13,-3
BR,AO,2010.0,10,9,1
IN,GD,2017.0,3,2,1
CR,FR,2017.0,7,5,2
GP,FR,2008.0,6,13,-7
BE,IL,2020.0,9,10,-1
JO,IR,2011.0,2,1,1
CA,MA,2022.0,8,12,-4
CH,LI,2012.0,2,1,1
GD,US,2012.0,5,6,-1
NZ,TW,2015.0,6,14,-8
CH,JO,2008.0,1,1,0
SD,AE,2012.0,1,1,0
PT,NZ,2003.0,2,1,1
KR,HU,2010.0,1,1,0
NG,JP,2013.0,3,8,-5
KW,IQ,2017.0,9,1,8
SI,CN,2010.0,3,2,1
SG,MM,2004.0,1,1,0
GH,GM,2018.0,3,1,2
IN,HU,2020.0,9,6,3
AT,MX,2008.0,1,4,-3
ES,VN,2019.0,2,2,0
MZ,BE,2011.0,2,2,0
AM,BE,2015.0,2,1,1
BE,ID,2013.0,2,1,1
PT,TR,2006.0,4,3,1
VN,CZ,2020.0,5,9,-4
GH,EG,2018.0,5,5,0
CN,MK,2004.0,2,8,-6
SI,SE,2022.0,1,1,0
IN,GR,2007.0,4,3,1
PL,ZA,1999.0,1,1,0
CR,FR,2010.0,2,5,-3
EG,IE,2014.0,2,9,-7
BO,BR,2012.0,1,2,-1
IT,MK,2019.0,1,2,-1
PE,UG,2017.0,1,1,0
PE,CL,1998.0,2,3,-1
US,UZ,2000.0,3,3,0
BE,AG,2018.0,1,1,0
LT,CZ,2000.0,2,1,1
FI,AT,2011.0,8,7,1
IE,TR,2010.0,2,1,1
MY,KW,2015.0,1,1,0
ZA,SZ,2012.0,1,5,-4
GE,IN,2022.0,1,4,-3
JP,CL,2001.0,2,3,-1
YE,QA,2018.0,1,1,0
LK,SG,2011.0,3,2,1
PT,NL,2003.0,5,9,-4
AE,CN,2009.0,2,3,-1
IT,LT,2019.0,1,3,-2
CH,NL,2014.0,109,119,-10
IT,DK,2008.0,27,15,12
PT,CL,2013.0,9,10,-1
CL,IT,2004.0,11,9,2
GB,BG,2005.0,10,8,2
NL,DK,2002.0,20,15,5
NO,CN,2007.0,18,25,-7
CZ,AT,2004.0,9,4,5
KR,EG,2021.0,7,5,2
LB,AU,2011.0,1,1,0
PY,BR,2014.0,3,12,-9
BO,nan,2016.0,1,1,0
IS,IN,2018.0,1,6,-5
,US,1999.0,66022,0,66022
TW,,2009.0,1431,0,1431
,NL,2011.0,6621,0,6621
,CN,2000.0,28973,0,28973
IN,,2024.0,124497,0,124497
,JP,1995.0,39233,0,39233
KR,,2025.0,5308,0,5308
,GB,2003.0,17357,0,17357
,ES,2000.0,10062,0,10062
US,,2000.0,21535,0,21535
,CZ,2008.0,2121,0,2121
,UY,2007.0,248,0,248
,FR,2012.0,15895,0,15895
NL,,1999.0,1371,0,1371
,CO,2004.0,1576,0,1576
,IR,2012.0,15146,0,15146
ID,,2023.0,65299,0,65299
EC,,2023.0,3556,0,3556
,AU,2013.0,7503,0,7503
RU,,2012.0,4108,0,4108
,NO,2008.0,1836,0,1836
,nan,2014.0,865,0,865
CL,,2009.0,356,0,356
,ZA,1998.0,1192,0,1192
,HU,1995.0,1966,0,1966
BA,,2024.0,916,0,916
,CU,2008.0,489,0,489
,IT,2014.0,11398,0,11398
,TH,2007.0,1970,0,1970
IL,IQ,2019.0,3,0,3
CH,,2008.0,1585,0,1585
XK,,2024.0,380,0,380
,ZA,1997.0,1266,0,1266
,CO,1996.0,537,0,537
CO,,2005.0,104,0,104
PG,,2015.0,18,0,18
VN,,2006.0,19,0,19
SY,NG,2015.0,1,0,1
,MU,2019.0,16,0,16
CN,,1998.0,543,0,543
MX,,2009.0,804,0,804
RO,,2020.0,1574,0,1574
IL,,2013.0,1339,0,1339
SG,,1998.0,120,0,120
,MK,1997.0,28,0,28
ZA,GH,2008.0,1,0,1
TH,,2011.0,525,0,525
,CI,2010.0,204,0,204
,OM,1994.0,109,0,109
KE,,2024.0,3245,0,3245
,MU,2010.0,33,0,33
,IE,2014.0,1526,0,1526
,TN,1999.0,412,0,412
,SN,2003.0,70,0,70
CO,,2002.0,59,0,59
CZ,,2002.0,214,0,214
,EC,2015.0,1377,0,1377
,AZ,2018.0,198,0,198
,BF,2013.0,138,0,138
DZ,,2018.0,783,0,783
IE,LV,2018.0,7,0,7
,MA,1999.0,433,0,433
CZ,,2005.0,346,0,346
,BB,2013.0,11,0,11
,PT,2018.0,1422,0,1422
,CI,2017.0,186,0,186
IR,,2006.0,201,0,201
UZ,,2001.0,19,0,19
,MN,2008.0,57,0,57
,LY,2001.0,18,0,18
UA,,2008.0,507,0,507
,BJ,2015.0,166,0,166
CN,VG,2006.0,1,0,1
MW,BJ,2008.0,1,0,1
,QA,2003.0,79,0,79
LY,,2023.0,331,0,331
PH,,2015.0,252,0,252
FJ,,2019.0,30,0,30
MA,,2025.0,268,0,268
BH,,2021.0,96,0,96
NP,,2008.0,27,0,27
PK,,2006.0,66,0,66
,IQ,2006.0,144,0,144
LT,,2012.0,183,0,183
TT,,2009.0,15,0,15
,VU,2011.0,4,0,4
MY,IR,2003.0,1,0,1
TR,AG,2014.0,5,0,5
BG,,2000.0,132,0,132
SK,,2011.0,251,0,251
FI,AE,2012.0,3,0,3
BJ,,2013.0,24,0,24
,MM,2003.0,21,0,21
MZ,RU,2000.0,9,0,9
CL,PS,2009.0,1,0,1
CG,,2016.0,15,0,15
,MW,2006.0,65,0,65
EG,SK,2007.0,1,0,1
,PS,2008.0,67,0,67
BE,TZ,2013.0,4,0,4
OM,,2013.0,61,0,61
,TD,2004.0,7,0,7
TZ,,2001.0,20,0,20
FR,BA,2013.0,2,0,2
,HK,2016.0,55,0,55
,PG,2017.0,26,0,26
,MU,2017.0,22,0,22
,TT,2018.0,45,0,45
,KW,2018.0,160,0,160
IT,RW,2021.0,1,0,1
,PG,2010.0,35,0,35
,TJ,2016.0,37,0,37
,CI,2019.0,84,0,84
,SY,1999.0,43,0,43
AL,,2021.0,114,0,114
NZ,CI,2021.0,1,0,1
IQ,,2003.0,6,0,6
HK,DE,2019.0,2,0,2
AZ,PL,2012.0,1,0,1
ZW,,2007.0,26,0,26
,MK,1998.0,37,0,37
GE,BR,2007.0,1,0,1
AR,UY,1998.0,2,0,2
,IS,1995.0,127,0,127
,UZ,1995.0,154,0,154
RS,,2008.0,135,0,135
IL,NP,2019.0,1,0,1
SG,LK,2007.0,1,0,1
RS,JP,2007.0,5,0,5
MX,KE,2016.0,1,0,1
FJ,,2017.0,7,0,7
,KG,1998.0,11,0,11
UG,SE,2023.0,1,0,1
TN,DK,2013.0,1,0,1
SN,CM,2001.0,3,0,3
SD,BD,2014.0,1,0,1
ZA,RE,2016.0,3,0,3
FR,KZ,2011.0,2,0,2
CY,UG,2019.0,3,0,3
NI,nan,2013.0,2,0,2
IL,PE,2019.0,2,0,2
LU,AE,2019.0,1,0,1
GN,DZ,2019.0,2,0,2
MA,CO,2016.0,1,0,1
CI,,2003.0,6,0,6
,BW,2006.0,62,0,62
LB,NL,2015.0,2,0,2
,ML,1998.0,15,0,15
IL,PH,2022.0,2,0,2
IS,ES,2005.0,4,0,4
NO,GH,2008.0,1,0,1
,GN,2013.0,20,0,20
IN,MU,2006.0,1,0,1
AT,NG,2018.0,1,0,1
ER,PK,2007.0,4,0,4
MK,,2006.0,8,0,8
FR,LA,2013.0,1,0,1
MV,GB,2019.0,1,0,1
TH,VE,2002.0,1,0,1
NZ,CO,2003.0,1,0,1
nan,HK,2002.0,2,0,2
CY,SA,2013.0,2,0,2
ES,GE,2003.0,1,0,1
TW,SA,2003.0,1,0,1
AL,XK,2011.0,5,0,5
KW,GH,2016.0,2,0,2
TT,SE,2007.0,1,0,1
DZ,PG,2015.0,1,0,1
JM,ZA,2002.0,1,0,1
MZ,CN,2009.0,1,0,1
BG,FI,1997.0,1,0,1
,BS,2004.0,3,0,3
BR,RE,2022.0,1,0,1
,PG,2019.0,17,0,17
UZ,SA,1998.0,1,0,1
SL,FR,2022.0,1,0,1
GB,LY,1997.0,1,0,1
GM,NG,2014.0,3,0,3
IL,KR,2002.0,2,0,2
GH,BE,2017.0,2,0,2
KR,KG,2020.0,1,0,1
GF,,2016.0,9,0,9
DK,BD,2002.0,1,0,1
ES,GT,2007.0,4,0,4
JE,,2021.0,2,0,2
BR,CD,2021.0,2,0,2
TN,CN,2017.0,4,0,4
MA,JO,2022.0,1,0,1
SG,CZ,2015.0,2,0,2
TN,MT,2015.0,1,0,1
,DO,2013.0,25,0,25
HR,PL,2009.0,1,0,1
PH,ZA,2005.0,1,0,1
XK,FI,2004.0,1,0,1
GM,US,2014.0,1,0,1
JP,MA,2019.0,4,0,4
CH,UA,2007.0,3,0,3
SA,ET,2009.0,1,0,1
SN,BE,2004.0,1,0,1
RO,ID,2008.0,5,0,5
BE,KN,2016.0,1,0,1
RE,,2013.0,16,0,16
MY,NI,2017.0,2,0,2
MX,LY,2012.0,1,0,1
KW,IQ,2010.0,2,0,2
LU,BF,2016.0,2,0,2
MD,RO,1999.0,1,0,1
JP,YE,2015.0,1,0,1
GB,DZ,1997.0,2,0,2
TZ,JP,2000.0,3,0,3
BE,BA,2011.0,1,0,1
FR,FJ,2014.0,1,0,1
TG,ML,2019.0,3,0,3
BN,SG,2001.0,2,0,2
ID,EE,2007.0,1,0,1
IT,GR,1997.0,6,0,6
QA,OM,1999.0,1,0,1
BW,ZA,2001.0,5,0,5
PH,TW,2003.0,2,0,2
MY,ZA,1999.0,1,0,1
SE,IQ,2016.0,5,0,5
LB,DE,2005.0,3,0,3
NZ,BD,2004.0,1,0,1
EG,JO,1998.0,6,0,6
CL,KR,2009.0,1,0,1
BA,NL,2021.0,4,0,4
SY,BR,2013.0,1,0,1
PK,IE,1999.0,2,0,2
NL,CL,1999.0,2,0,2
,KG,1997.0,2,0,2
NL,AF,2014.0,1,0,1
IS,RO,2020.0,2,0,2
QA,,2007.0,17,0,17
MA,QA,2020.0,7,0,7
TZ,TH,2004.0,1,0,1
LS,,2016.0,5,0,5
GH,nan,2000.0,2,0,2
CU,RU,2004.0,3,0,3
MC,,2013.0,10,0,10
CH,KR,2001.0,4,0,4
IL,IQ,2017.0,1,0,1
EE,CN,2010.0,1,0,1
CA,NE,2020.0,1,0,1
IQ,LU,2022.0,1,0,1
QA,BR,2015.0,1,0,1
AR,HR,2006.0,1,0,1
TH,VN,2006.0,6,0,6
IL,CR,2011.0,1,0,1
BI,UG,2019.0,2,0,2
KE,IQ,2021.0,2,0,2
CY,UG,2017.0,3,0,3
DZ,BI,2022.0,3,0,3
LV,FI,1999.0,1,0,1
RO,CL,2011.0,1,0,1
AU,UG,2002.0,1,0,1
GB,SN,2020.0,3,0,3
AR,LB,2022.0,1,0,1
JP,MA,2017.0,2,0,2
MW,,1999.0,7,0,7
SE,HN,1999.0,1,0,1
HK,DE,2010.0,1,0,1
ML,CH,2018.0,3,0,3
,SZ,2009.0,9,0,9
,YE,2000.0,8,0,8
,GD,1996.0,1,0,1
AE,PK,2024.0,2,0,2
JM,IE,2019.0,1,0,1
EG,MY,1997.0,2,0,2
LB,SE,2016.0,2,0,2
CO,nan,2002.0,2,0,2
CW,BR,2004.0,1,0,1
ST,TR,2014.0,1,0,1
HN,IT,2022.0,1,0,1
AM,FR,2001.0,5,0,5
KW,IT,2014.0,1,0,1
TH,IR,2007.0,1,0,1
HR,KW,2012.0,2,0,2
EE,BE,2014.0,2,0,2
IL,NG,2015.0,1,0,1
CL,PL,2013.0,5,0,5
GH,,2004.0,10,0,10
AM,CZ,2019.0,4,0,4
,SM,2015.0,1,0,1
ME,,2008.0,4,0,4
NC,,2012.0,10,0,10
AU,WS,2016.0,1,0,1
ST,,2025.0,2,0,2
,HT,2005.0,6,0,6
BY,CH,2013.0,1,0,1
LT,ID,2021.0,2,0,2
SI,BR,2002.0,1,0,1
ZA,CL,2011.0,4,0,4
NP,SN,2015.0,1,0,1
SG,BM,2007.0,1,0,1
SE,NI,2007.0,2,0,2
GD,PK,2015.0,1,0,1
GB,PF,2010.0,1,0,1
BE,RW,1997.0,1,0,1
PT,MY,2004.0,1,0,1
,TD,1996.0,1,0,1
ET,CN,1999.0,3,0,3
KW,HU,1997.0,1,0,1
PH,IE,2019.0,3,0,3
NP,IR,2015.0,1,0,1
KG,BG,2022.0,1,0,1
EC,SE,2013.0,1,0,1
BT,,2019.0,4,0,4
MA,AR,2012.0,1,0,1
EE,GR,2015.0,3,0,3
FJ,,2010.0,9,0,9
AT,UG,2008.0,1,0,1
EC,CG,2004.0,1,0,1
KH,KE,2022.0,2,0,2
CU,FI,2020.0,1,0,1
DE,PR,1999.0,1,0,1
SJ,SA,2010.0,1,0,1
RW,TR,2017.0,4,0,4
LV,IT,2011.0,3,0,3
PK,GR,2022.0,1,0,1
BM,US,2009.0,3,0,3
CN,UG,2010.0,1,0,1
,PW,2015.0,3,0,3
ET,UG,2003.0,2,0,2
NG,BR,2000.0,1,0,1
AT,ME,2020.0,1,0,1
,GD,2004.0,3,0,3
MN,AU,2020.0,1,0,1
TW,HK,2012.0,2,0,2
CO,AT,2023.0,1,0,1
TR,PE,2013.0,2,0,2
VE,SV,2013.0,2,0,2
MD,PL,2017.0,1,0,1
BD,HK,2018.0,2,0,2
CL,BS,2016.0,1,0,1
UZ,ES,2016.0,1,0,1
NI,,2025.0,1,0,1
JP,TT,2013.0,1,0,1
RS,OM,2019.0,1,0,1
KY,,2011.0,1,0,1
AR,DK,2011.0,1,0,1
MX,UG,2018.0,1,0,1
CN,IQ,2010.0,2,0,2
FR,LT,1998.0,1,0,1
ZW,nan,1999.0,1,0,1
IR,ZW,2020.0,1,0,1
PL,NC,2020.0,1,0,1
FK,AR,2003.0,1,0,1
BH,NG,2009.0,4,0,4
MA,IL,2016.0,3,0,3
KY,CN,2021.0,1,0,1
OM,JM,2010.0,1,0,1
LT,TR,2018.0,1,0,1
SD,AT,2014.0,1,0,1
CY,IR,2006.0,1,0,1
GT,TR,2015.0,1,0,1
CG,US,1997.0,1,0,1
,ML,1997.0,8,0,8
SK,SG,1999.0,1,0,1
QA,NO,2011.0,1,0,1
JP,EE,2007.0,1,0,1
GB,XK,2002.0,2,0,2
BA,NO,2008.0,1,0,1
KW,LY,2010.0,2,0,2
QA,BH,2009.0,1,0,1
GB,KZ,1999.0,1,0,1
RW,FR,2003.0,1,0,1
ZA,RS,2018.0,2,0,2
MX,BG,2002.0,1,0,1
KG,,2005.0,3,0,3
UA,AR,2003.0,1,0,1
SN,,1999.0,2,0,2
ID,AM,2011.0,2,0,2
EG,RS,2008.0,2,0,2
CH,MT,2013.0,1,0,1
CA,AG,2018.0,2,0,2
TN,LB,2003.0,1,0,1
BI,MA,2008.0,1,0,1
MD,DE,1998.0,1,0,1
CO,IT,2001.0,3,0,3
PR,,2013.0,1,0,1
HU,QA,2012.0,2,0,2
US,BN,2006.0,1,0,1
UY,BJ,2011.0,1,0,1
SV,,1998.0,2,0,2
BN,GH,2017.0,2,0,2
,SJ,2016.0,4,0,4
RS,AL,2018.0,1,0,1
MY,RS,2021.0,2,0,2
TN,PA,2007.0,2,0,2
RU,LU,2011.0,2,0,2
IL,AL,2015.0,1,0,1
ZA,VE,2012.0,1,0,1
RO,BG,2018.0,3,0,3
CN,ZW,2015.0,2,0,2
GP,ZA,2018.0,1,0,1
GB,NA,2021.0,2,0,2
KH,NL,2021.0,1,0,1
GE,NP,2017.0,1,0,1
MK,FI,2007.0,1,0,1
JP,GE,2016.0,1,0,1
PK,TR,1998.0,2,0,2
MD,SN,2005.0,2,0,2
MA,TH,2019.0,1,0,1
AT,MY,1999.0,1,0,1
PG,NA,2010.0,1,0,1
IR,HR,2017.0,1,0,1
VN,NO,2009.0,3,0,3
KW,HU,1998.0,1,0,1
ET,FR,2018.0,1,0,1
IE,ER,2018.0,1,0,1
IE,CH,1997.0,1,0,1
IL,RO,2009.0,1,0,1
GB,FJ,2006.0,3,0,3
PS,LB,2018.0,3,0,3
AU,CM,2015.0,1,0,1
ZA,,2026.0,4,0,4
CO,ET,2009.0,1,0,1
LY,FI,2015.0,2,0,2
NG,RO,2022.0,1,0,1
CA,FJ,2016.0,1,0,1
EC,RU,2006.0,3,0,3
,TO,2018.0,1,0,1
HN,AR,2001.0,1,0,1
BT,,2010.0,2,0,2
CL,AT,2011.0,3,0,3
MA,CG,2016.0,3,0,3
,BS,1996.0,1,0,1
IQ,ET,2017.0,1,0,1
IQ,CH,2022.0,1,0,1
CH,PS,2020.0,2,0,2
CD,AU,2022.0,1,0,1
AU,UG,2005.0,2,0,2
EG,PT,2003.0,1,0,1
VG,CL,1998.0,1,0,1
ZW,FJ,2020.0,1,0,1
ET,CH,2014.0,2,0,2
NL,MA,2002.0,1,0,1
HR,NZ,2007.0,1,0,1
SI,BR,2005.0,2,0,2
ES,VN,2017.0,2,0,2
IR,PH,2010.0,1,0,1
JP,MW,2001.0,1,0,1
LK,KW,2015.0,1,0,1
UA,ZA,2021.0,1,0,1
IT,AL,1999.0,1,0,1
BJ,MG,2016.0,1,0,1
MG,VN,2014.0,1,0,1
PK,MW,2016.0,1,0,1
GB,RE,2009.0,2,0,2
DZ,BD,2019.0,2,0,2
NG,ID,2008.0,1,0,1
ES,NI,2007.0,2,0,2
LT,IT,2004.0,2,0,2
PF,CH,2009.0,1,0,1
CN,UY,2020.0,1,0,1
AU,PF,2008.0,1,0,1
RS,TW,2003.0,2,0,2
GY,,1998.0,1,0,1
LV,IL,2008.0,1,0,1
IN,BH,2007.0,1,0,1
YE,MA,2021.0,1,0,1
TR,TH,2014.0,3,0,3
BR,PH,1998.0,1,0,1
TW,BH,2014.0,1,0,1
AU,XK,2016.0,1,0,1
SA,FI,2003.0,1,0,1
MA,HT,2009.0,1,0,1
NL,KZ,2009.0,2,0,2
ID,VN,2017.0,2,0,2
IN,HR,2022.0,1,0,1
CF,VN,2008.0,1,0,1
BD,AT,2021.0,2,0,2
ZA,LK,2005.0,1,0,1
NP,PH,2002.0,1,0,1
HU,KW,2011.0,1,0,1
CH,PG,2002.0,2,0,2
SY,SD,2016.0,1,0,1
CN,SD,2012.0,2,0,2
BR,DK,2023.0,1,0,1
DE,NA,2007.0,1,0,1
FR,XK,2005.0,1,0,1
KW,IE,1997.0,1,0,1
SE,KE,2022.0,3,0,3
BN,nan,2015.0,1,0,1
SG,TN,2015.0,1,0,1
IE,KG,2018.0,1,0,1
CY,FI,2019.0,1,0,1
VN,KE,2000.0,1,0,1
AL,HU,2016.0,2,0,2
IL,AE,2013.0,2,0,2
PA,RU,2023.0,1,0,1
ES,CG,2008.0,1,0,1
GE,SE,2002.0,2,0,2
CL,ID,2010.0,1,0,1
BW,TH,2005.0,1,0,1
ZW,JP,2003.0,1,0,1
JO,BH,2020.0,3,0,3
LB,ID,2019.0,3,0,3
IN,EG,1997.0,2,0,2
MX,ME,2017.0,1,0,1
EE,TW,2016.0,1,0,1
IQ,ZW,2021.0,1,0,1
BG,SK,1999.0,1,0,1
CY,FI,2017.0,1,0,1
TN,AU,2018.0,1,0,1
CD,KR,2017.0,1,0,1
SD,CN,1999.0,1,0,1
IT,LY,2015.0,1,0,1
ES,LK,2006.0,1,0,1
VE,PY,2011.0,4,0,4
IR,CL,2014.0,1,0,1
BI,CM,2012.0,1,0,1
VN,NL,1997.0,1,0,1
US,NA,2010.0,1,0,1
KR,GE,2013.0,1,0,1
LB,PS,2012.0,1,0,1
AM,MA,2013.0,2,0,2
NE,MY,2015.0,1,0,1
nan,TZ,2017.0,1,0,1
BY,VN,2005.0,2,0,2
TG,BR,2003.0,1,0,1
EG,AR,2003.0,1,0,1
AU,LB,2001.0,1,0,1
CH,SI,2002.0,1,0,1
HU,NC,2018.0,1,0,1
IL,TN,2019.0,3,0,3
FI,RO,2009.0,1,0,1
NG,CL,2017.0,1,0,1
RU,OM,1999.0,1,0,1
IQ,IR,2023.0,2,0,2
BR,VN,2022.0,1,0,1
BN,CA,2019.0,2,0,2
JE,FR,2002.0,1,0,1
NP,FR,2021.0,1,0,1
EC,IE,2009.0,1,0,1
,GW,2001.0,2,0,2
EG,NG,2005.0,2,0,2
,SS,2014.0,5,0,5
BI,LU,2021.0,1,0,1
PL,BD,2022.0,1,0,1
AT,AE,2002.0,1,0,1
UA,GM,2022.0,1,0,1
MY,KE,2014.0,3,0,3
NL,MD,2004.0,2,0,2
MA,RO,2020.0,1,0,1
BG,IL,2008.0,1,0,1
NZ,MA,2022.0,1,0,1
CO,PS,2018.0,1,0,1
NL,JM,2002.0,1,0,1
KZ,AT,2008.0,1,0,1
TZ,IQ,2015.0,1,0,1
CN,LU,2008.0,2,0,2
DO,BR,2009.0,2,0,2
EG,SY,2000.0,1,0,1
AR,PA,2004.0,2,0,2
PE,GL,2018.0,1,0,1
EC,TR,2022.0,1,0,1
NO,GE,2020.0,1,0,1
CA,CY,2005.0,1,0,1
NO,BW,2022.0,1,0,1
TN,MQ,2020.0,1,0,1
CN,LR,2018.0,1,0,1
TZ,CH,2007.0,1,0,1
US,KP,2019.0,3,0,3
CG,PT,2014.0,1,0,1
CD,SN,2019.0,1,0,1
CW,GB,2010.0,1,0,1
JP,CR,2018.0,1,0,1
NO,HK,2017.0,1,0,1
FI,SG,2008.0,1,0,1
nan,UZ,2014.0,1,0,1
AT,BH,2009.0,1,0,1
ES,EE,2006.0,1,0,1
IE,VE,2010.0,1,0,1
MN,PL,2010.0,1,0,1
,FO,2004.0,3,0,3
MO,BR,2007.0,1,0,1
KZ,HU,2011.0,1,0,1
CG,NC,2016.0,3,0,3
FR,HK,2011.0,3,0,3
DO,ID,2018.0,1,0,1
TG,BJ,2004.0,1,0,1
OM,TN,2018.0,3,4,-1
ZA,DZ,2015.0,1,1,0
PL,MA,2020.0,1,1,0
CI,SN,2007.0,1,1,0
FR,MZ,2018.0,1,1,0
RU,PT,2023.0,1,1,0
nan,QA,2018.0,2,1,1
FI,NL,1997.0,4,6,-2
EG,VN,2022.0,4,1,3
LU,SE,2012.0,1,2,-1
BD,VN,2021.0,1,1,0
KZ,RU,2006.0,6,3,3
CM,CD,2020.0,3,1,2
ZA,ZW,2001.0,1,4,-3
JO,CA,1997.0,1,1,0
BY,LT,2017.0,1,1,0
NO,TN,2016.0,1,2,-1
IT,TR,1997.0,2,2,0
GE,SE,2005.0,1,1,0
GR,AM,2013.0,1,1,0
SK,NL,2022.0,4,5,-1
JP,ZM,2013.0,2,2,0
DE,UG,2001.0,2,1,1
BJ,NL,2013.0,3,3,0
KE,ZW,2015.0,2,3,-1
AE,ZA,2007.0,1,2,-1
NP,DE,2014.0,4,2,2
SK,BR,2017.0,2,2,0
TW,AE,2022.0,1,1,0
CN,CO,2019.0,5,8,-3
NO,CO,2016.0,1,1,0
BE,TN,2009.0,2,2,0
LV,CA,2007.0,1,1,0
RO,GR,2008.0,1,4,-3
MA,DZ,2000.0,1,1,0
TD,FR,2004.0,1,1,0
RW,CH,2014.0,1,1,0
RU,DZ,2018.0,3,1,2
IT,SI,2003.0,3,5,-2
PY,US,2018.0,2,10,-8
CN,AR,2006.0,2,1,1
MX,MY,2013.0,1,1,0
IL,KE,2007.0,1,1,0
BN,AU,2001.0,2,2,0
IL,BD,2014.0,1,2,-1
AE,CO,2020.0,1,3,-2
IN,CY,2011.0,1,1,0
nan,GB,2023.0,1,3,-2
SA,CN,2008.0,2,1,1
BD,SA,2007.0,3,4,-1
ET,IR,2021.0,1,3,-2
FI,GR,1997.0,1,1,0
DE,TZ,2011.0,2,3,-1
EC,DZ,2015.0,1,2,-1
CY,IL,2015.0,1,1,0
SD,JP,2022.0,2,1,1
IR,PH,2017.0,2,2,0
ET,PE,2022.0,1,1,0
CZ,ZM,2010.0,1,1,0
CN,CY,2019.0,3,2,1
NG,NZ,2014.0,1,4,-3
AM,CA,2012.0,1,1,0
SA,NG,2007.0,2,3,-1
TW,PA,2012.0,1,1,0
NI,AR,2015.0,1,1,0
PK,SG,2011.0,1,5,-4
BG,KZ,2019.0,2,3,-1
IS,NO,2005.0,1,3,-2
GE,IT,2021.0,1,1,0
BR,BF,2014.0,1,1,0
NO,MX,2007.0,1,1,0
IR,nan,2015.0,2,5,-3
GB,BS,2016.0,1,2,-1
PH,DK,2014.0,1,1,0
CZ,NZ,2004.0,1,1,0
IT,MT,2013.0,2,2,0
IQ,ET,2019.0,1,2,-1
CO,CZ,2016.0,1,1,0
LK,DE,2006.0,1,3,-2
CA,UY,2005.0,1,1,0
MN,AT,2014.0,1,1,0
ET,ER,2007.0,1,1,0
CU,SE,2021.0,1,1,0
CN,NA,2020.0,1,1,0
EE,NO,2008.0,2,1,1
HU,SI,2015.0,2,2,0
MX,EE,2018.0,3,1,2
MC,IT,2021.0,1,1,0
CM,TG,2015.0,1,3,-2
KE,CH,2012.0,1,3,-2
AE,CZ,2011.0,1,1,0
VG,US,2021.0,1,3,-2
PH,PL,2009.0,1,2,-1
CO,JP,2005.0,3,7,-4
ZA,HR,2001.0,2,1,1
GB,MD,2001.0,1,1,0
TW,AR,2003.0,2,2,0
RE,BJ,2020.0,1,1,0
MM,SG,2013.0,1,3,-2
KR,GR,2020.0,3,1,2
MD,CH,2021.0,1,1,0
MN,PL,2019.0,1,2,-1
SE,BW,2010.0,1,1,0
SE,CR,2003.0,1,3,-2
UA,SE,2004.0,1,5,-4
BY,LT,2019.0,1,1,0
LV,DE,2014.0,2,2,0
nan,TN,2012.0,1,1,0
SK,IE,2015.0,1,1,0
AR,IE,2012.0,1,1,0
AR,GT,2016.0,2,4,-2
US,BM,2003.0,2,1,1
DK,CO,2016.0,1,3,-2
PT,IL,2018.0,1,2,-1
IT,RO,2023.0,2,1,1
KW,SE,2021.0,1,2,-1
BJ,GB,2013.0,1,1,0
IS,CN,2020.0,1,1,0
BF,DE,2019.0,1,2,-1
IQ,IT,2020.0,1,1,0
EG,AT,2002.0,1,3,-2
UA,NO,2007.0,1,2,-1
BH,MY,2014.0,2,1,1
DE,DZ,2021.0,1,8,-7
FR,GA,2005.0,2,4,-2
AE,DK,2014.0,1,1,0
GE,KR,2020.0,1,1,0
TN,CN,2010.0,1,1,0
SI,GR,2016.0,1,1,0
CR,PT,2013.0,1,2,-1
BE,AL,2014.0,1,1,0
SK,PT,2008.0,1,2,-1
LU,CN,2012.0,1,5,-4
FI,IE,2007.0,1,1,0
BO,CL,2003.0,1,1,0
ZA,JM,2011.0,1,1,0
IE,BA,2019.0,1,1,0
IL,EE,2016.0,1,1,0
KN,US,2014.0,1,7,-6
PK,DZ,2018.0,1,2,-1
NG,CI,2015.0,2,1,1
ES,LU,1998.0,1,1,0
AU,EE,2013.0,1,1,0
MY,CA,2003.0,1,4,-3
TR,VN,2022.0,1,1,0
CU,UY,2021.0,2,1,1
DE,XK,2015.0,1,2,-1
PE,PY,2014.0,1,1,0
CH,NG,2014.0,2,1,1
RU,UA,2023.0,1,4,-3
BA,BG,2014.0,1,1,0
FI,PL,2005.0,1,3,-2
QA,nan,2020.0,1,2,-1
LU,PT,2022.0,1,2,-1
BG,CZ,2018.0,2,5,-3
BF,CI,2011.0,1,1,0
CZ,ZM,2019.0,1,2,-1
BJ,NG,2011.0,1,1,0
ZM,ZW,2010.0,1,1,0
JP,AF,2021.0,1,4,-3
RO,MX,2006.0,1,1,0
CO,nan,2005.0,1,2,-1
PE,SE,2007.0,1,2,-1
KE,NG,2009.0,1,2,-1
LU,GR,2015.0,1,3,-2
ZW,NL,2006.0,1,2,-1
LT,PL,2012.0,1,1,0
BH,KW,2015.0,1,1,0
PS,CA,2009.0,1,1,0
EG,IQ,2007.0,1,1,0
UA,EE,2014.0,1,1,0
ZW,AU,2005.0,1,1,0
EE,CN,2017.0,1,2,-1
TN,DZ,2004.0,1,3,-2
CO,KR,2018.0,1,2,-1
NL,LV,2021.0,1,1,0
US,HT,2011.0,1,1,0
QA,SA,2006.0,1,3,-2
US,RW,2005.0,1,1,0
NL,PE,2021.0,1,2,-1
AU,HR,2011.0,1,5,-4
PH,NG,2016.0,1,1,0
UA,SA,2022.0,1,1,0
SE,XK,2022.0,1,1,0
ES,LB,2020.0,1,2,-1
MG,GB,2012.0,1,1,0
CM,SN,2010.0,1,1,0
IN,AL,2017.0,1,2,-1
CR,HN,2016.0,1,1,0
NL,GE,2016.0,1,1,0
MX,KR,2010.0,4,4,0
PH,PE,2012.0,1,1,0
UG,IL,2015.0,2,1,1
CY,NL,2007.0,1,1,0
IN,GD,2019.0,2,1,1
PL,HR,2016.0,2,3,-1
PS,DE,2002.0,1,2,-1
SA,SE,2009.0,1,2,-1
MX,BG,2005.0,1,4,-3
PS,DE,2005.0,1,1,0
ML,SN,2003.0,1,1,0
RS,MX,2012.0,1,34,-33
GB,FO,2008.0,1,1,0
IL,PE,2010.0,2,1,1
BH,EG,2002.0,1,1,0
LU,CO,2018.0,1,1,0
SV,MX,2005.0,1,1,0
VG,GB,2007.0,2,2,0
IT,LT,2017.0,3,3,0
CL,TR,2019.0,1,2,-1
MN,CN,2001.0,1,1,0
KE,HU,2018.0,2,0,2
GR,BD,2008.0,1,0,1
ZW,GH,2011.0,1,0,1
PL,IR,2003.0,1,0,1
US,TG,2006.0,1,0,1
PL,TR,2004.0,2,0,2
,BZ,2013.0,2,0,2
KW,DZ,2018.0,1,0,1
UZ,FR,1999.0,1,0,1
NI,ID,2021.0,1,0,1
GH,CN,2023.0,1,0,1
BW,IT,2019.0,1,0,1
HU,ZM,2019.0,1,0,1
FK,AU,2009.0,1,0,1
RO,NL,2001.0,4,0,4
VN,AR,2013.0,1,0,1
IL,PE,2017.0,1,0,1
GH,RW,2011.0,1,0,1
FJ,ES,2008.0,1,0,1
CM,EG,2012.0,1,0,1
MY,NI,2010.0,1,0,1
PS,YE,2017.0,1,0,1
MW,EG,2018.0,1,0,1
SK,BE,2000.0,2,0,2
GH,IT,2004.0,1,0,1
BY,ES,2005.0,2,0,2
HR,LK,2006.0,1,0,1
UZ,CD,2020.0,1,0,1
GF,CH,2008.0,1,0,1
EE,IN,2023.0,1,0,1
QA,SY,2015.0,1,0,1
NL,BO,2006.0,1,0,1
MX,AE,2012.0,1,0,1
IE,BA,2017.0,1,0,1
MG,,1999.0,2,0,2
MW,CG,2014.0,1,0,1
ES,JO,2011.0,2,0,2
PT,BO,2015.0,1,0,1
PK,KZ,2020.0,1,0,1
TW,KZ,2003.0,1,0,1
JP,QA,2009.0,3,0,3
ET,RU,2013.0,1,0,1
BF,BJ,2014.0,3,0,3
ER,NO,2002.0,1,0,1
KG,GB,2007.0,1,0,1
CR,DK,2002.0,1,0,1
HT,MA,2017.0,1,0,1
ID,RU,2005.0,1,0,1
HN,IE,2015.0,1,0,1
MM,TW,2012.0,1,0,1
DK,MK,2020.0,1,0,1
ES,AL,2012.0,1,0,1
CG,GB,2020.0,1,0,1
US,FM,2016.0,1,0,1
NO,CR,1999.0,1,0,1
BA,BE,2012.0,1,0,1
HU,CY,2018.0,1,0,1
SY,DZ,2014.0,1,0,1
AO,MX,2018.0,1,0,1
ES,BA,2021.0,1,0,1
KE,SD,2018.0,1,0,1
AZ,KZ,2018.0,2,0,2
IN,MG,2019.0,1,0,1
DE,GT,2015.0,1,0,1
AZ,UA,2016.0,1,0,1
GB,UZ,2007.0,1,0,1
PH,nan,2021.0,1,0,1
MX,PS,2019.0,1,0,1
TJ,KZ,2018.0,1,0,1
TN,KW,2006.0,1,0,1
UY,IN,2012.0,1,0,1
CR,IT,2010.0,2,0,2
SK,NZ,2004.0,1,0,1
PK,AZ,2011.0,1,0,1
SE,MT,2015.0,1,0,1
FM,,2024.0,1,0,1
CL,CZ,2007.0,1,0,1
ER,,2011.0,1,0,1
TR,BH,2002.0,1,0,1
TW,CO,2022.0,1,0,1
BH,CH,2007.0,1,0,1
,FO,1996.0,1,0,1
JO,PK,2001.0,1,0,1
US,MG,2022.0,3,0,3
IT,BH,1998.0,1,0,1
AG,CN,2013.0,1,0,1
PH,RO,2021.0,1,0,1
SE,MZ,2022.0,1,0,1
SV,PT,2020.0,1,0,1
US,GW,2013.0,1,0,1
CU,BO,2009.0,1,0,1
MA,CD,2018.0,1,0,1
CL,TR,2017.0,2,0,2
QA,ME,2017.0,1,0,1
JO,TW,2007.0,1,0,1
VN,AL,2008.0,1,0,1
BE,TW,2010.0,2,0,2
CA,ML,2001.0,1,0,1
UA,TN,2008.0,1,0,1
ES,NZ,1997.0,1,0,1
,JE,2015.0,1,0,1
MX,ID,2022.0,1,0,1
CA,DO,2019.0,1,0,1
CR,UY,2011.0,1,0,1
US,PF,2008.0,1,0,1
MN,IN,2014.0,1,0,1
IR,GR,2022.0,2,0,2
CH,LV,2009.0,1,0,1
CA,CD,2022.0,1,0,1
IT,PA,2005.0,2,0,2
ES,NZ,1998.0,1,0,1
BD,CY,2007.0,1,0,1
SL,DZ,2013.0,1,0,1
LU,MR,2013.0,1,0,1
BG,PT,2022.0,1,0,1
AR,ZA,2008.0,1,0,1
AE,UA,2022.0,2,0,2
MD,GP,2022.0,1,0,1
ML,GN,2013.0,1,0,1
CI,SD,2011.0,2,0,2
HR,GN,2017.0,1,0,1
FI,MA,2012.0,1,0,1
nan,SI,1998.0,1,0,1
LU,NZ,2013.0,1,0,1
ME,DE,1998.0,1,0,1
AG,BR,2017.0,1,0,1
JO,NO,2016.0,1,0,1
VE,IN,2014.0,1,0,1
IN,PG,2012.0,1,0,1
CA,CY,2002.0,2,0,2
MY,ZW,2022.0,1,0,1
TZ,MA,2018.0,1,0,1
TR,MW,2012.0,1,0,1
HU,SV,2017.0,1,0,1
ML,CA,2011.0,1,0,1
KN,CN,2022.0,1,0,1
BR,JP,2023.0,1,0,1
NI,SE,2020.0,1,0,1
LV,AT,2005.0,1,0,1
NL,KN,2013.0,1,0,1
PL,MD,2016.0,1,0,1
LT,AT,2016.0,1,0,1
UG,PR,2011.0,1,0,1
BH,IE,2022.0,1,0,1
nan,SI,1997.0,1,0,1
ZM,AU,2005.0,1,0,1
UA,NI,2012.0,1,0,1
GA,UG,2009.0,1,0,1
TN,GH,2019.0,1,0,1
TJ,IN,2005.0,1,0,1
QA,ME,2019.0,1,0,1
RS,IQ,2018.0,1,0,1
CY,UG,2010.0,1,0,1
HU,ZM,2010.0,2,0,2
JE,MG,2013.0,1,0,1
NO,TH,2007.0,1,0,1
UG,nan,2001.0,1,0,1
GN,CI,2015.0,1,0,1
RS,XK,1998.0,1,0,1
SG,AR,2014.0,1,0,1
TN,NZ,2021.0,1,0,1
FR,LV,2004.0,1,0,1
PA,AT,2017.0,1,0,1
US,KP,2017.0,1,0,1
JP,PG,2015.0,1,0,1
JO,KH,2018.0,1,0,1
KZ,PL,2016.0,1,0,1
CR,CN,2005.0,1,0,1
NO,HU,2002.0,1,0,1
BW,MY,2018.0,1,0,1
NE,SA,2021.0,1,0,1
IL,CY,2022.0,1,0,1
AR,PH,2009.0,1,0,1
JP,MA,2010.0,1,0,1
ET,MY,2003.0,1,0,1
LA,KR,2019.0,1,0,1
DO,VE,2008.0,1,0,1
PK,RS,2002.0,1,0,1
PH,HU,2021.0,1,0,1
MM,IR,2022.0,1,0,1
nan,CU,2000.0,1,0,1
GP,RU,2002.0,1,0,1
QA,TZ,2021.0,1,0,1
EG,KR,1999.0,1,0,1
BY,BG,2013.0,1,0,1
BW,FI,2015.0,1,0,1
HR,ES,1997.0,1,0,1
IT,XK,2020.0,1,0,1
MY,FI,2003.0,1,0,1
nan,RS,2011.0,1,0,1
AM,SK,2004.0,1,0,1
DE,PA,2002.0,1,0,1
UA,IR,2009.0,1,0,1
CF,CH,2014.0,1,0,1
UA,MZ,1998.0,1,0,1
CU,TW,2006.0,1,0,1
FR,MU,1999.0,1,0,1
NE,MR,2012.0,1,0,1
DE,BN,2022.0,1,0,1
PH,CL,2002.0,1,0,1
MY,TT,2017.0,1,0,1
ZA,SG,2006.0,1,0,1
MY,TT,2019.0,1,0,1
BG,CY,2009.0,1,0,1
GR,CR,2013.0,1,0,1
IR,SN,2012.0,1,0,1
SA,AF,2021.0,1,0,1
LU,HU,2015.0,1,0,1
MZ,PE,2017.0,1,0,1
SJ,DK,2009.0,1,0,1
,GM,2020.0,1,0,1
GB,ML,2020.0,1,0,1
RS,LV,2020.0,1,0,1
BT,,2017.0,1,0,1
BE,LY,2011.0,1,0,1
LV,LT,2009.0,1,0,1
PH,LV,2009.0,1,0,1
ZA,SD,2008.0,1,0,1
CH,SK,2023.0,1,0,1
MU,NL,2020.0,1,0,1
TW,MA,2012.0,1,0,1
CN,IN,2022.0,152,186,-34
UY,BR,2010.0,45,37,8
IN,US,2023.0,130,51,79
CA,AU,2009.0,312,315,-3
CO,ES,2014.0,426,538,-112
NZ,GB,2011.0,201,267,-66
CA,TW,2007.0,43,37,6
TR,US,2010.0,332,395,-63
IN,BE,2009.0,19,10,9
CH,DE,2001.0,364,434,-70
LT,JP,2018.0,12,2,10
TW,CN,2014.0,1408,891,517
CA,GB,2007.0,647,703,-56
GB,CN,2003.0,321,235,86
SE,US,2009.0,326,358,-32
US,ES,2020.0,937,1050,-113
HN,US,2021.0,5,2,3
AU,DE,2014.0,229,240,-11
ES,CO,2021.0,372,467,-95
DE,GB,2005.0,612,493,119
BE,BR,2004.0,24,33,-9
JP,SE,1999.0,21,31,-10
PL,NL,2017.0,24,20,4
IN,KR,2010.0,140,109,31
US,DE,2011.0,2290,2499,-209
US,CL,2016.0,292,223,69
BD,CN,2002.0,2,2,0
DE,IR,2018.0,73,148,-75
FR,LK,2006.0,2,3,-1
PT,BR,2013.0,789,942,-153
DE,GB,2002.0,452,425,27
IL,CA,2011.0,74,53,21
SG,SE,2015.0,20,13,7
CN,CA,2007.0,304,442,-138
CO,CU,2021.0,19,23,-4
BR,CA,2013.0,274,273,1
BR,FR,2006.0,102,121,-19
JP,KR,2022.0,188,264,-76
NG,SA,2018.0,14,13,1
GB,MK,2019.0,6,4,2
IT,NL,2018.0,150,96,54
CO,PE,2018.0,134,100,34
CA,US,2000.0,1878,1518,360
DE,AT,2020.0,727,682,45
GT,IT,2021.0,2,1,1
GB,IN,2003.0,169,176,-7
DE,CL,2004.0,15,22,-7
PR,KR,1999.0,29,11,18
US,EG,2016.0,277,226,51
GB,ES,2012.0,336,314,22
US,CO,2013.0,277,264,13
NZ,US,2018.0,453,399,54
CO,CR,2012.0,23,27,-4
DE,PL,2006.0,96,100,-4
TR,US,2019.0,468,505,-37
FR,BF,2009.0,6,14,-8
PK,MY,2016.0,86,102,-16
ES,MX,2009.0,492,554,-62
CW,NL,2014.0,18,15,3
RU,US,2010.0,332,381,-49
IN,KR,2019.0,272,181,91
BR,SD,2009.0,5,4,1
US,AT,2020.0,238,240,-2
DE,KR,1998.0,16,6,10
SG,TW,2011.0,42,46,-4
MY,SG,2021.0,128,138,-10
DE,IN,2018.0,194,246,-52
IT,KR,2022.0,6,4,2
IR,US,2018.0,856,523,333
TH,KR,2014.0,18,9,9
CL,CO,2017.0,264,255,9
FR,DE,2012.0,496,523,-27
IE,FR,2018.0,38,36,2
CH,BR,2016.0,41,54,-13
AT,DE,2000.0,201,240,-39
DK,US,2016.0,259,299,-40
CN,LT,2020.0,5,3,2
CA,CM,2013.0,3,1,2
CN,PL,2015.0,26,25,1
US,IT,2022.0,496,595,-99
JP,DE,2002.0,148,120,28
IN,KR,2017.0,248,177,71
ZA,AU,2000.0,26,15,11
NL,IR,2019.0,45,65,-20
AU,BR,2006.0,47,35,12
US,BA,2020.0,11,11,0
CN,AU,2007.0,183,215,-32
FR,IN,2016.0,131,125,6
BR,IT,2009.0,166,156,10
MD,FR,2002.0,55,60,-5
PT,GB,2022.0,74,62,12
ID,NG,2020.0,19,33,-14
TR,CY,2017.0,81,50,31
AT,US,2007.0,167,191,-24
CA,KR,2022.0,46,45,1
ES,AR,2009.0,248,237,11
ES,PT,2014.0,174,162,12
RU,US,2017.0,485,701,-216
US,BY,2020.0,16,11,5
US,QA,2007.0,19,10,9
RU,HU,1997.0,1,2,-1
DK,BR,2006.0,4,7,-3
SE,DK,1997.0,34,28,6
MW,US,2012.0,17,8,9
BE,CA,2022.0,23,29,-6
SA,ID,2016.0,30,15,15
SG,CN,2002.0,140,139,1
CY,TR,2018.0,51,91,-40
SK,JP,2012.0,14,9,5
DE,EE,2016.0,58,50,8
NZ,CA,1999.0,18,28,-10
BA,HR,2019.0,46,60,-14
FR,RE,2016.0,60,43,17
SE,RS,2021.0,5,3,2
IR,NL,2009.0,26,8,18
DK,MX,2010.0,4,4,0
PK,ZA,2019.0,3,5,-2
SY,CN,2022.0,10,16,-6
GB,ZA,2004.0,75,84,-9
NL,NZ,2018.0,17,16,1
IN,IL,2016.0,99,33,66
CH,SG,2007.0,10,6,4
BR,ST,2020.0,23,32,-9
RU,US,2019.0,572,718,-146
SE,DK,1998.0,40,31,9
BA,HR,2017.0,41,56,-15
SA,TN,2017.0,38,86,-48
CL,MX,2009.0,102,109,-7
US,RO,2019.0,127,87,40
FJ,IN,2009.0,3,1,2
ES,IE,2006.0,11,10,1
IL,JP,2009.0,12,6,6
GB,IQ,2020.0,125,44,81
UA,BG,2020.0,15,8,7
EG,ES,2007.0,4,3,1
BE,IT,2002.0,54,58,-4
GR,US,2010.0,196,181,15
MY,AE,2014.0,13,3,10
SG,CA,2005.0,27,24,3
CN,TR,2012.0,104,51,53
FR,BJ,2016.0,22,20,2
RS,US,2004.0,33,37,-4
CL,SE,2021.0,8,8,0
nan,AR,2017.0,47,43,4
GR,US,2017.0,187,157,30
US,BG,2001.0,9,28,-19
GR,US,2019.0,167,170,-3
CH,CL,2008.0,7,4,3
AR,MX,2009.0,69,66,3
CN,PK,2021.0,333,255,78
BD,CN,2005.0,8,10,-2
KR,CN,2013.0,285,255,30
EG,US,2011.0,122,218,-96
IE,CN,2015.0,46,45,1
KR,IN,2000.0,16,27,-11
nan,CN,2004.0,78,75,3
SE,CN,2012.0,81,89,-8
US,nan,2009.0,246,254,-8
LT,CH,2010.0,2,2,0
IT,CM,2017.0,5,4,1
GB,NO,2020.0,152,73,79
TW,DE,2014.0,47,21,26
CA,ES,2016.0,72,126,-54
TW,RU,2009.0,23,20,3
EC,ES,2021.0,191,153,38
AU,EC,2020.0,3,6,-3
AT,BR,2018.0,24,15,9
RU,KR,1997.0,3,3,0
ID,FR,2014.0,19,39,-20
FR,PE,2019.0,18,21,-3
BE,CN,2018.0,62,60,2
MX,CH,2019.0,18,12,6
HK,US,2018.0,13,18,-5
SE,BR,2005.0,23,11,12
AT,FR,2016.0,44,34,10
GB,NP,2010.0,8,6,2
SG,US,2022.0,252,248,4
MX,CU,2016.0,51,80,-29
US,TN,2020.0,21,22,-1
BY,GB,2018.0,6,2,4
LU,FR,2008.0,12,25,-13
US,SD,2018.0,7,12,-5
US,SK,2004.0,21,34,-13
TR,CY,2010.0,20,8,12
EC,CL,2011.0,9,6,3
MY,ID,2021.0,233,227,6
US,RO,2017.0,115,80,35
FR,SA,2015.0,45,18,27
SA,DE,2018.0,26,37,-11
GB,BR,2023.0,6,16,-10
GR,EC,2010.0,1,3,-2
IQ,MY,2016.0,30,85,-55
IN,TW,2018.0,70,46,24
UA,RU,2007.0,92,118,-26
IE,AU,2003.0,38,45,-7
VE,CU,2012.0,14,5,9
CA,ZA,2013.0,39,48,-9
RU,CA,2006.0,33,16,17
UY,BR,2019.0,62,63,-1
TH,PK,2018.0,13,8,5
RW,US,2012.0,4,8,-4
GB,TR,2014.0,118,108,10
nan,AT,2004.0,8,10,-2
SE,SG,2008.0,5,6,-1
MK,HR,2018.0,1,2,-1
GB,BE,2013.0,139,130,9
US,BF,2018.0,4,2,2
IT,FR,2006.0,261,227,34
PL,NL,2019.0,33,24,9
NL,AT,2020.0,41,48,-7
SE,PL,2009.0,13,19,-6
NG,GB,2021.0,104,80,24
nan,AR,2010.0,31,41,-10
SA,TN,2019.0,50,157,-107
PH,US,2022.0,141,137,4
RU,FI,2019.0,35,32,3
BE,CZ,2017.0,13,15,-2
PA,EC,2022.0,1,1,0
IR,AU,2017.0,182,84,98
MX,HR,2007.0,3,1,2
NL,FI,2005.0,31,25,6
FR,FI,2007.0,14,16,-2
NL,EG,2013.0,6,6,0
SA,AE,1999.0,4,3,1
NI,ES,2017.0,6,9,-3
PT,EG,2019.0,2,1,1
CL,SV,2013.0,2,1,1
CN,SA,2022.0,38,45,-7
GB,ID,2022.0,27,40,-13
CZ,AT,2015.0,21,27,-6
PL,DE,2020.0,121,126,-5
nan,AR,2019.0,47,48,-1
SY,SA,2019.0,8,11,-3
FI,DK,2015.0,27,19,8
BR,MX,2009.0,55,56,-1
AU,NL,2002.0,41,20,21
CR,CO,2012.0,27,23,4
IR,AU,2010.0,49,30,19
TN,DZ,2015.0,18,23,-5
SG,JP,2018.0,44,49,-5
IR,AU,2019.0,237,93,144
NP,US,2015.0,51,50,1
IR,EE,2022.0,7,1,6
MX,SG,2016.0,6,4,2
TR,FR,2016.0,25,27,-2
GB,MU,2014.0,6,1,5
LB,CA,2021.0,18,11,7
LU,CH,2015.0,4,5,-1
GB,JO,2015.0,28,16,12
US,SI,2016.0,21,30,-9
RU,UZ,2008.0,27,4,23
GB,OM,2008.0,7,5,2
UA,US,2020.0,96,119,-23
BR,SE,2003.0,10,8,2
TW,AT,2019.0,4,3,1
IN,DZ,2019.0,4,3,1
HK,CN,2023.0,12,11,1
GB,PA,2018.0,12,8,4
ZA,DE,2013.0,40,60,-20
CH,PK,2004.0,7,13,-6
TR,IN,2019.0,22,20,2
TR,IL,2010.0,4,1,3
PT,VE,2018.0,4,4,0
NG,nan,2020.0,8,11,-3
AU,PH,2019.0,20,19,1
IR,RU,2019.0,19,9,10
nan,BE,2016.0,30,18,12
ET,ZA,2021.0,14,14,0
RO,AU,2016.0,3,1,2
IL,PL,2010.0,7,4,3
RU,AM,2022.0,9,14,-5
BD,US,2008.0,52,66,-14
IT,CZ,2011.0,24,22,2
BE,GB,2001.0,62,52,10
AU,HU,2002.0,6,7,-1
FR,NO,2017.0,74,59,15
US,HR,2018.0,50,36,14
DZ,IT,2021.0,27,28,-1
IR,FR,2018.0,33,42,-9
UY,BR,2017.0,51,64,-13
RU,KG,2016.0,5,5,0
CL,UY,2013.0,21,9,12
TR,MY,2019.0,10,15,-5
BR,GB,2006.0,98,112,-14
IT,ID,2018.0,32,4,28
BY,IR,2016.0,2,1,1
DE,NO,2022.0,43,40,3
IT,BR,1998.0,43,29,14
SA,IT,2014.0,6,15,-9
NL,SK,2012.0,9,5,4
NL,SE,2007.0,29,47,-18
US,GE,2012.0,141,166,-25
BE,DE,2004.0,83,81,2
CZ,JP,2020.0,22,20,2
TR,QA,2020.0,7,4,3
AU,MY,2005.0,12,13,-1
AU,NP,2019.0,18,22,-4
FR,PH,2018.0,13,7,6
nan,KR,2021.0,26,23,3
HU,SK,2021.0,8,11,-3
SG,FR,2021.0,17,32,-15
IR,NZ,2022.0,10,5,5
NL,VN,2009.0,4,4,0
SK,UA,2014.0,7,6,1
CL,GT,2019.0,12,3,9
KZ,TR,2021.0,31,48,-17
RO,SE,2022.0,1,1,0
NL,GR,2020.0,35,44,-9
RU,PL,2005.0,10,22,-12
NG,AE,2022.0,5,3,2
SI,CZ,2015.0,17,4,13
QA,EG,2020.0,107,79,28
IN,AE,2021.0,66,61,5
GM,ZA,2017.0,1,1,0
GB,NP,2019.0,11,14,-3
RU,CZ,2007.0,21,13,8
TR,US,2017.0,528,425,103
AM,RU,2018.0,25,11,14
HK,TW,2017.0,6,2,4
GB,LK,2018.0,36,26,10
BR,IL,2018.0,9,7,2
HU,UA,2001.0,2,1,1
EG,DE,1999.0,9,9,0
RU,BE,2003.0,15,13,2
BR,TR,2014.0,19,39,-20
IL,HU,2006.0,5,2,3
RU,FI,2010.0,26,14,12
NL,IN,2011.0,40,40,0
KR,SG,2018.0,49,51,-2
AU,IT,1999.0,19,15,4
BD,SA,2008.0,2,7,-5
ID,ZA,2018.0,109,61,48
TR,CY,2019.0,84,77,7
LK,GB,2018.0,26,36,-10
FR,UY,2018.0,9,8,1
PT,ES,2008.0,82,103,-21
SG,GB,2008.0,81,93,-12
RU,FI,2017.0,33,40,-7
TW,RO,2002.0,1,1,0
CH,VE,2007.0,1,2,-1
DE,FI,2018.0,72,78,-6
FR,NO,2019.0,74,75,-1
JP,DE,2005.0,144,156,-12
AT,CZ,2023.0,1,1,0
CD,ZA,2016.0,3,3,0
CH,UA,2008.0,4,2,2
CL,IT,2015.0,25,34,-9
KW,TR,2009.0,4,4,0
TR,KW,2010.0,1,3,-2
NZ,CH,2006.0,7,7,0
RS,FR,2019.0,8,9,-1
NL,PL,2017.0,20,24,-4
FI,GB,2009.0,60,48,12
KR,TW,2012.0,34,34,0
BE,IT,2005.0,56,66,-10
UA,JP,2017.0,3,4,-1
FR,NO,2010.0,52,50,2
PL,MZ,2014.0,20,13,7
FR,QA,2018.0,9,9,0
JP,DK,2015.0,16,17,-1
US,PS,2005.0,7,2,5
PL,BE,2004.0,11,16,-5
TZ,CH,2008.0,2,1,1
BE,PT,2016.0,23,22,1
DK,GR,2016.0,7,14,-7
CA,LU,2020.0,8,4,4
SE,EG,2016.0,10,8,2
KR,FR,2003.0,9,19,-10
RU,nan,2003.0,37,24,13
PL,AZ,2002.0,2,1,1
NL,PL,2010.0,23,28,-5
CA,SG,2004.0,17,19,-2
IT,MX,2009.0,31,24,7
KR,IR,2020.0,9,17,-8
RO,CH,2021.0,11,13,-2
SE,EE,2007.0,8,8,0
EG,CN,2017.0,37,39,-2
FR,RS,2022.0,2,5,-3
MX,DE,2011.0,39,34,5
PE,BO,2015.0,6,4,2
GR,CL,2016.0,3,1,2
JP,BR,2006.0,39,37,2
BY,RU,2009.0,36,60,-24
KZ,UA,2020.0,7,5,2
ET,NO,2004.0,4,2,2
SE,nan,2018.0,25,80,-55
MX,EC,2007.0,6,5,1
DK,FR,2011.0,37,43,-6
MK,US,2013.0,7,11,-4
CV,PT,2011.0,1,1,0
SE,IN,2012.0,25,44,-19
VE,CO,2001.0,11,3,8
nan,JP,2008.0,59,36,23
IR,IT,2011.0,18,11,7
CU,CR,2014.0,20,16,4
CZ,FR,2017.0,40,50,-10
KR,JP,2023.0,34,16,18
UY,FR,2018.0,8,9,-1
CA,BJ,2017.0,4,3,1
PL,NL,2010.0,28,23,5
PK,DE,2020.0,35,35,0
AT,LI,2017.0,3,2,1
JP,nan,2009.0,41,60,-19
TW,EG,2008.0,2,1,1
IQ,TR,2021.0,19,12,7
BJ,FR,2011.0,21,25,-4
GH,CA,2016.0,8,9,-1
CA,MX,2022.0,17,31,-14
JP,RS,2012.0,3,1,2
BG,BE,2005.0,4,1,3
DE,IQ,2019.0,22,2,20
RU,EC,2011.0,7,1,6
VE,FR,2004.0,5,3,2
AE,nan,2017.0,1,3,-2
AT,RS,2008.0,5,8,-3
FR,BG,2010.0,8,6,2
RU,PL,2002.0,15,6,9
SE,FI,2000.0,40,45,-5
JP,CH,2003.0,33,49,-16
MK,DE,2015.0,5,4,1
PK,KE,2021.0,11,6,5
ML,CI,2013.0,3,2,1
HK,RO,2020.0,10,16,-6
LT,US,2007.0,6,11,-5
CU,CO,2013.0,27,20,7
MY,SE,2020.0,11,2,9
MA,BE,2010.0,5,4,1
AT,CN,2017.0,24,17,7
RU,AT,2021.0,34,12,22
AM,US,2021.0,18,7,11
EE,HU,2018.0,2,2,0
IN,DK,2008.0,12,7,5
HU,RS,2010.0,4,7,-3
ZA,IE,2015.0,10,4,6
TN,JP,2019.0,4,2,2
IT,IL,2000.0,14,8,6
NL,IR,2017.0,33,42,-9
SA,SG,2018.0,7,7,0
AE,DE,2020.0,12,13,-1
PE,VE,2022.0,4,7,-3
NO,PL,2019.0,11,14,-3
SI,PL,2014.0,7,2,5
AR,NO,2014.0,3,1,2
AU,TH,2004.0,20,10,10
TR,IT,2007.0,15,10,5
GB,KR,2008.0,89,66,23
KR,PK,2022.0,23,34,-11
LB,CN,2016.0,38,11,27
ZA,KR,2015.0,5,4,1
MX,CH,2010.0,10,6,4
PT,FR,1999.0,14,26,-12
SE,CZ,2011.0,5,8,-3
IT,BR,1997.0,42,28,14
DK,nan,2020.0,13,24,-11
CH,CZ,2020.0,34,40,-6
EG,CN,2019.0,51,54,-3
ZA,JO,2019.0,2,1,1
CA,CO,2011.0,16,16,0
BG,BE,2002.0,2,6,-4
IR,ID,2014.0,8,3,5
PT,CH,2013.0,19,15,4
FR,BG,2017.0,9,6,3
BW,GB,2021.0,6,3,3
SI,ES,2007.0,5,5,0
UA,BR,2020.0,15,9,6
BE,PK,2015.0,4,4,0
IQ,US,2021.0,59,77,-18
BE,SI,2010.0,3,1,2
BD,GB,2009.0,28,31,-3
HU,RS,2019.0,9,5,4
IL,RU,2014.0,41,25,16
IR,CA,1999.0,6,17,-11
AL,MK,2019.0,2,2,0
TH,BD,2017.0,6,6,0
SG,CA,2002.0,22,20,2
NL,GH,2020.0,4,5,-1
GH,GB,2011.0,14,21,-7
CZ,FR,2019.0,44,45,-1
ID,US,2001.0,11,10,1
TH,ID,2015.0,9,6,3
US,LK,2021.0,24,20,4
NL,CA,2009.0,83,77,6
EC,GB,2020.0,11,14,-3
FR,PE,2017.0,16,12,4
VE,CL,2006.0,15,18,-3
HU,IN,2006.0,4,3,1
JP,TH,2007.0,78,34,44
FR,BR,2004.0,95,89,6
EC,PE,2013.0,6,8,-2
NZ,nan,2008.0,9,40,-31
FR,HU,2011.0,19,29,-10
HU,NL,2004.0,10,6,4
ZA,ID,2014.0,8,6,2
IL,IT,2003.0,9,6,3
QA,AE,2017.0,12,18,-6
NP,ET,2016.0,2,1,1
TN,PA,2008.0,1,1,0
EG,YE,2014.0,5,3,2
PH,SG,2013.0,10,6,4
FR,AR,2000.0,20,21,-1
CZ,FR,2010.0,24,31,-7
EG,KW,2006.0,6,7,-1
DE,MY,2007.0,8,5,3
BG,GB,2003.0,10,1,9
AU,TZ,2019.0,4,4,0
ZW,US,2007.0,12,3,9
CA,FI,2013.0,22,19,3
NO,UG,2016.0,4,1,3
PH,GB,2021.0,16,11,5
CA,AT,2006.0,13,21,-8
RO,US,1999.0,37,14,23
GB,AR,2000.0,14,14,0
CH,IE,2015.0,13,22,-9
PL,DK,2003.0,5,9,-4
MY,NG,2014.0,37,35,2
CH,EE,2016.0,17,7,10
EC,UA,2011.0,18,18,0
SN,CI,2020.0,4,3,1
AU,ID,2001.0,7,5,2
CH,FI,2013.0,23,20,3
ZA,GB,2004.0,84,75,9
TR,KW,2017.0,13,7,6
IT,DK,2007.0,23,10,13
PL,AU,2011.0,9,15,-6
GR,BR,2015.0,6,3,3
IE,BE,2008.0,2,9,-7
LU,DE,2007.0,7,36,-29
RU,MY,2013.0,13,10,3
IT,IE,2006.0,14,10,4
AR,ID,2016.0,3,2,1
NL,CR,2008.0,2,1,1
EG,AE,2003.0,13,3,10
KR,TR,2007.0,3,4,-1
FR,KW,2019.0,12,1,11
LK,US,2011.0,15,18,-3
VE,MX,2022.0,15,12,3
AU,PH,2010.0,14,16,-2
MY,GB,2001.0,9,30,-21
BB,GB,2011.0,4,3,1
TR,IN,2010.0,19,22,-3
NL,FI,2002.0,20,20,0
EE,US,2005.0,4,11,-7
ZA,ES,2011.0,6,4,2
LB,US,1999.0,9,21,-12
AE,OM,2007.0,2,2,0
IN,DE,1999.0,48,55,-7
ES,nan,1999.0,5,3,2
PT,BE,2003.0,7,3,4
IN,NZ,2000.0,9,4,5
PE,DE,2014.0,7,6,1
ZA,NL,2001.0,9,15,-6
US,JM,1997.0,3,4,-1
BR,NO,2014.0,27,27,0
BR,UY,2004.0,30,14,16
AE,SA,2000.0,4,2,2
CN,NO,2023.0,10,4,6
RO,GR,2007.0,4,3,1
nan,ZA,2011.0,11,4,7
OM,IN,2016.0,18,23,-5
JO,JP,2017.0,3,1,2
CN,ET,2001.0,2,3,-1
FR,CZ,2016.0,54,25,29
JP,HR,2021.0,2,1,1
HU,CA,2003.0,10,7,3
RS,CH,2008.0,5,4,1
NL,BR,2006.0,32,23,9
RS,GB,2014.0,19,20,-1
RU,JP,2011.0,26,33,-7
UY,CL,2014.0,8,5,3
AU,NL,2005.0,31,40,-9
US,IQ,2012.0,17,12,5
AU,nan,2007.0,19,22,-3
IT,OM,2006.0,1,1,0
IN,IE,1999.0,2,1,1
IN,NG,2021.0,29,24,5
PK,ZA,2017.0,8,7,1
RU,HR,2013.0,2,3,-1
GA,DE,2000.0,2,1,1
SE,BR,2002.0,8,6,2
SK,DE,1998.0,17,13,4
TR,IL,2017.0,4,5,-1
PT,UY,2017.0,6,2,4
NL,ZA,2008.0,30,25,5
KR,PT,2011.0,10,2,8
GE,GB,2017.0,7,5,2
MK,AU,2007.0,18,21,-3
DE,RS,2006.0,17,5,12
BR,AE,2022.0,4,2,2
CL,TW,2004.0,1,1,0
NO,CN,2008.0,29,26,3
UG,US,2003.0,10,9,1
US,AF,2011.0,3,1,2
PH,IN,2021.0,11,14,-3
CU,BR,2011.0,27,6,21
MX,AF,2010.0,2,3,-1
AU,NP,2017.0,14,10,4
AU,MX,2018.0,13,21,-8
PL,PT,2020.0,6,9,-3
FR,GP,2016.0,25,24,1
SG,NO,2014.0,3,2,1
DZ,FR,2001.0,22,27,-5
DZ,GB,2014.0,10,8,2
ZA,FR,2018.0,33,46,-13
SA,IR,2013.0,13,5,8
PL,AZ,2005.0,2,6,-4
FR,MG,2004.0,4,2,2
NO,BD,2020.0,17,6,11
CO,SV,2018.0,2,10,-8
DK,AT,2009.0,7,12,-5
PT,IE,2022.0,5,1,4
SE,BE,2011.0,16,23,-7
BD,IT,2013.0,5,5,0
NO,AU,2021.0,13,19,-6
IR,XK,2021.0,1,1,0
GH,NZ,2017.0,2,1,1
UA,DE,2002.0,30,26,4
UA,DE,2005.0,39,25,14
KR,NG,2013.0,7,7,0
SG,NZ,2007.0,9,4,5
ZA,NZ,2013.0,19,17,2
PE,US,1997.0,9,10,-1
NO,CA,2015.0,31,26,5
CZ,SE,2016.0,19,13,6
RU,LV,2007.0,10,8,2
AT,MX,2007.0,3,1,2
BR,NZ,2011.0,6,6,0
JP,NZ,2015.0,5,11,-6
CR,ES,2000.0,7,11,-4
JP,CZ,2015.0,13,20,-7
DK,PL,2007.0,8,15,-7
DE,TR,2000.0,10,12,-2
FR,UA,2004.0,10,10,0
BW,CN,2022.0,1,1,0
AT,JP,1998.0,7,4,3
JP,UA,2004.0,2,3,-1
nan,PK,2014.0,10,6,4
IN,PA,2018.0,4,2,2
CH,MX,2014.0,11,16,-5
AR,SE,2002.0,1,2,-1
CN,DZ,2013.0,5,3,2
PH,IR,2013.0,1,1,0
MA,CA,2007.0,7,10,-3
JP,LK,2013.0,21,19,2
FR,KE,2020.0,11,6,5
nan,CH,2008.0,19,10,9
NZ,SI,2012.0,1,1,0
nan,BR,2008.0,42,56,-14
VE,SE,2004.0,4,1,3
DE,KW,2011.0,2,1,1
MY,OM,2018.0,13,3,10
RU,MZ,2018.0,12,15,-3
PL,PH,2003.0,1,7,-6
DE,AL,2016.0,1,1,0
MX,GB,1997.0,15,17,-2
BR,AT,2015.0,9,12,-3
NL,IE,2009.0,20,19,1
DE,NP,2010.0,4,1,3
KE,BH,2017.0,1,2,-1
GR,CA,2007.0,6,14,-8
ZW,SE,1998.0,1,1,0
GF,FR,2018.0,17,12,5
DE,PK,1997.0,2,1,1
DE,RO,2002.0,9,23,-14
PK,nan,2014.0,6,10,-4
GB,MK,2010.0,3,7,-4
IT,CM,2019.0,4,2,2
TR,IN,2017.0,18,16,2
NO,TR,2015.0,4,8,-4
CM,GA,2021.0,1,1,0
IE,NO,2010.0,5,2,3
TZ,SE,2021.0,4,4,0
ES,SA,2023.0,1,1,0
UA,ES,2003.0,4,2,2
PE,US,1998.0,14,11,3
AU,MT,2019.0,2,3,-1
CH,TR,2000.0,1,7,-6
TW,GR,2010.0,2,2,0
NZ,BE,2011.0,7,6,1
GR,CZ,2003.0,1,1,0
CH,HR,2013.0,5,7,-2
AU,PH,2017.0,14,21,-7
JO,DE,2009.0,9,10,-1
GR,PT,2008.0,1,1,0
CN,SK,2008.0,5,4,1
FR,EG,2002.0,3,2,1
AU,BW,2010.0,2,1,1
LU,GB,2007.0,2,2,0
PK,TN,2019.0,2,3,-1
CL,RU,2006.0,6,1,5
SI,US,2004.0,10,13,-3
IL,PL,2019.0,14,11,3
TZ,NO,2021.0,2,2,0
CH,HU,2004.0,6,12,-6
KR,BR,2009.0,5,7,-2
TW,JP,2000.0,34,54,-20
TR,MY,2017.0,12,20,-8
NI,ES,2019.0,6,2,4
SD,NG,2020.0,8,3,5
BY,nan,2011.0,1,1,0
IE,NO,2019.0,10,5,5
AR,EC,2013.0,13,4,9
PT,PK,2009.0,1,1,0
GB,SD,2012.0,8,2,6
RS,AU,2004.0,3,2,1
DK,SG,2015.0,2,2,0
MY,BE,2011.0,4,1,3
TH,BD,2019.0,4,3,1
PK,TN,2017.0,1,1,0
MM,TR,2021.0,10,10,0
MX,GB,1998.0,26,20,6
AE,IR,2011.0,1,4,-3
US,ET,1999.0,7,8,-1
VE,BR,2012.0,11,17,-6
HK,AU,2011.0,6,2,4
FR,GM,2010.0,1,1,0
AR,CH,2011.0,15,10,5
PT,UY,2010.0,2,3,-1
CA,NC,2015.0,1,1,0
UY,CO,2010.0,12,6,6
SA,LK,2018.0,1,1,0
GB,MA,2020.0,8,10,-2
PT,PH,2020.0,1,2,-1
DE,NP,2019.0,5,5,0
VE,PE,2022.0,7,4,3
AU,PK,2009.0,10,13,-3
DE,IQ,2017.0,10,5,5
TZ,GB,2004.0,3,4,-1
LB,JO,2013.0,6,1,5
SK,IL,2000.0,1,1,0
DK,ET,2021.0,2,1,1
IE,SG,2012.0,7,7,0
GB,TZ,2008.0,8,3,5
FI,KR,2004.0,6,7,-1
NG,TZ,2022.0,1,4,-3
EG,HU,2009.0,2,4,-2
FR,CO,2009.0,21,15,6
PK,NO,2014.0,5,6,-1
IT,SK,2008.0,5,3,2
UA,CN,2004.0,9,6,3
NL,CZ,2004.0,8,9,-1
SE,LT,2019.0,5,5,0
BB,US,1999.0,3,2,1
UY,PT,2022.0,2,3,-1
FR,PE,2010.0,4,3,1
IS,FR,2012.0,2,3,-1
AU,CZ,2014.0,10,6,4
MT,ES,2017.0,2,5,-3
US,SN,2006.0,8,7,1
GB,CU,2020.0,5,4,1
HR,IT,2021.0,6,4,2
NZ,BD,2015.0,6,6,0
NO,IE,2022.0,3,4,-1
IE,NO,2017.0,5,4,1
BA,HR,2010.0,12,19,-7
CO,CA,2021.0,30,19,11
KW,PK,2021.0,8,1,7
GB,BW,2016.0,8,2,6
AM,ID,2018.0,2,1,1
UY,CO,2019.0,16,14,2
NZ,IL,2003.0,2,1,1
CO,LU,2020.0,1,1,0
BE,SI,2017.0,4,10,-6
SY,SA,2017.0,9,1,8
SI,IT,2006.0,10,7,3
CL,PY,2016.0,11,2,9
DE,MG,2020.0,3,1,2
GR,QA,2017.0,1,5,-4
PT,DZ,2021.0,2,5,-3
IN,BD,2003.0,16,8,8
MA,EG,2022.0,4,7,-3
RE,US,2011.0,4,1,3
AU,SI,2019.0,3,1,2
TR,GR,2005.0,5,6,-1
MY,EC,2020.0,2,1,1
ES,AT,2004.0,5,7,-2
MX,PY,2013.0,4,4,0
AR,VE,2005.0,15,12,3
TN,NG,2012.0,1,1,0
MK,IN,2015.0,4,1,3
MY,NP,2013.0,2,1,1
SG,HK,2010.0,3,1,2
FR,VE,2008.0,4,13,-9
SE,KR,2000.0,4,2,2
TH,IN,2020.0,21,27,-6
MY,RU,2018.0,12,17,-5
AR,AU,2014.0,10,10,0
MX,CZ,2022.0,5,3,2
BR,ID,2021.0,17,17,0
RU,KR,1998.0,6,1,5
DE,KR,1997.0,4,2,2
IS,DE,2011.0,4,5,-1
IQ,FR,2011.0,2,1,1
AR,IL,2020.0,5,1,4
PS,IN,2020.0,2,3,-1
SA,PL,2014.0,2,2,0
GB,CM,2013.0,4,2,2
KH,FR,2011.0,4,5,-1
ET,GB,2008.0,6,3,3
AT,CN,2019.0,22,19,3
VN,KR,2009.0,16,16,0
DK,MX,2019.0,12,7,5
FR,MQ,2000.0,10,1,9
PK,ZA,2010.0,3,2,1
OM,AE,2011.0,5,1,4
GB,ET,2014.0,4,8,-4
GH,US,2015.0,22,58,-36
AM,KZ,2015.0,1,2,-1
HU,BE,2018.0,16,10,6
AT,TH,1998.0,1,2,-1
US,EE,2006.0,13,5,8
EE,ES,2008.0,2,1,1
UA,RO,2003.0,4,1,3
GE,GB,2010.0,3,12,-9
TW,TH,2012.0,6,3,3
RS,PT,2017.0,1,1,0
NO,MX,2008.0,1,1,0
UG,NL,2013.0,2,3,-1
NL,GA,2014.0,4,1,3
PT,IN,2022.0,6,8,-2
RO,IR,2016.0,2,1,1
GE,GB,2019.0,7,7,0
US,LA,2020.0,1,1,0
NO,TZ,2009.0,4,5,-1
US,LU,2011.0,16,10,6
FR,KW,2010.0,3,4,-1
DK,AR,2007.0,2,1,1
EG,IR,2013.0,11,5,6
GR,QA,2019.0,5,3,2
BR,MZ,2011.0,9,5,4
PE,AU,2011.0,2,2,0
PT,MY,2015.0,3,1,2
AU,HU,2005.0,6,7,-1
NG,UG,2011.0,4,1,3
AT,ZA,2020.0,4,9,-5
LK,RO,2010.0,5,1,4
MA,LB,2014.0,2,2,0
PK,TN,2010.0,8,1,7
TR,DE,2023.0,5,1,4
UA,NL,2004.0,4,5,-1
UA,SE,2015.0,10,7,3
IL,UA,2015.0,4,7,-3
FI,TW,2011.0,4,4,0
UA,MX,1998.0,2,3,-1
JO,JP,2010.0,1,1,0
RU,CL,2018.0,4,3,1
FI,NZ,2006.0,3,1,2
GN,US,2018.0,3,1,2
AE,nan,2019.0,4,3,1
CH,AR,2004.0,4,4,0
GB,MW,1999.0,3,3,0
PF,FR,2000.0,5,2,3
BI,GB,2005.0,4,1,3
nan,PE,2004.0,1,2,-1
MW,NO,2018.0,2,1,1
AR,MY,2003.0,3,2,1
AL,IL,2018.0,1,1,0
VN,FR,1997.0,3,3,0
CA,SA,2004.0,16,12,4
DK,IE,2008.0,3,9,-6
CO,BR,1999.0,8,11,-3
IL,ES,2018.0,18,17,1
AR,VE,2002.0,6,7,-1
EC,BR,2014.0,14,23,-9
TR,IL,2019.0,6,4,2
DK,FO,2016.0,2,1,1
IL,AT,2007.0,2,3,-1
SI,CH,1998.0,3,1,2
NL,IR,2010.0,15,30,-15
US,AO,2007.0,4,2,2
TW,PL,2022.0,1,7,-6
CA,GH,2003.0,1,1,0
PA,UY,2016.0,1,1,0
ZM,MW,2018.0,2,6,-4
HU,RS,2017.0,9,8,1
LK,IN,2013.0,6,5,1
NO,RO,2013.0,4,1,3
BG,NO,1999.0,4,2,2
CO,PH,2015.0,5,5,0
PK,SA,2008.0,14,11,3
PL,TR,2015.0,4,5,-1
RS,BA,2005.0,4,5,-1
SY,EG,1998.0,2,1,1
NP,GB,2018.0,12,9,3
AE,NL,2014.0,2,1,1
BG,IT,2014.0,5,5,0
FI,nan,2013.0,8,17,-9
AL,MK,2017.0,2,3,-1
MA,BE,2017.0,2,10,-8
GB,BB,2018.0,4,3,1
CL,GT,2010.0,3,6,-3
PH,KE,2021.0,2,4,-2
BR,BG,1998.0,1,2,-1
NL,KR,2007.0,3,7,-4
TW,GR,2019.0,3,1,2
ES,XK,2021.0,1,1,0
NL,RU,2021.0,24,34,-10
CA,TH,2006.0,7,11,-4
CN,PE,2020.0,4,2,2
GR,SA,2022.0,4,1,3
RO,TR,2013.0,3,3,0
BR,SK,2020.0,1,3,-2
CF,CM,2020.0,1,1,0
KE,CM,2021.0,6,5,1
DZ,PT,2022.0,2,1,1
DE,ZM,2019.0,2,1,1
NP,nan,2018.0,1,5,-4
UA,BY,2013.0,9,5,4
JP,OM,2013.0,5,2,3
IL,PL,2017.0,5,7,-2
TH,JP,1999.0,9,23,-14
TR,KW,2019.0,8,5,3
HK,NL,2004.0,3,3,0
IL,CN,2023.0,6,4,2
IE,IT,2006.0,10,14,-4
MX,SY,2011.0,1,1,0
OM,TR,2018.0,2,1,1
MX,AF,2017.0,3,2,1
SA,NG,2008.0,2,2,0
SI,FR,1999.0,4,2,2
HU,ZA,2022.0,4,2,2
UG,TZ,2018.0,3,3,0
SG,MM,2015.0,4,3,1
UA,IL,2018.0,9,10,-1
IQ,IN,2016.0,3,17,-14
FI,AR,2018.0,2,4,-2
BE,SI,2019.0,8,9,-1
nan,ES,2000.0,8,8,0
TH,TW,2022.0,3,13,-10
IR,DK,2011.0,12,7,5
PL,SG,2011.0,2,3,-1
KR,SE,2016.0,15,8,7
EE,US,2002.0,3,4,-1
GB,CO,2003.0,12,10,2
CO,UY,2012.0,5,8,-3
GR,RS,2004.0,1,1,0
MX,NL,2011.0,11,12,-1
RU,ZA,2002.0,3,6,-3
TH,BE,2014.0,3,5,-2
PL,BR,2023.0,3,7,-4
DK,EC,2018.0,2,1,1
ES,QA,2011.0,5,4,1
RO,PL,2011.0,5,12,-7
EG,PS,2007.0,2,1,1
BE,DK,2007.0,11,9,2
KE,nan,2021.0,3,5,-2
BE,CM,2018.0,3,6,-3
UA,IT,2001.0,2,12,-10
UY,GB,2005.0,2,2,0
TH,DE,2007.0,11,12,-1
KR,DK,2009.0,4,3,1
NZ,AE,2017.0,3,2,1
RU,TR,2008.0,6,3,3
US,MM,2018.0,12,10,2
AE,ZA,2008.0,1,1,0
GB,HK,2018.0,2,7,-5
ID,SE,2014.0,3,4,-1
IR,RU,2017.0,8,13,-5
DE,NP,2017.0,6,1,5
JP,PT,2016.0,2,7,-5
IN,YE,2016.0,1,3,-2
DK,IL,2013.0,2,8,-6
CU,BE,2015.0,1,1,0
SK,DE,1997.0,12,23,-11
CA,RS,2006.0,8,9,-1
MZ,FR,2009.0,1,1,0
IR,KR,2004.0,1,1,0
CU,VE,2018.0,12,16,-4
KH,AU,2012.0,1,1,0
GB,SL,2018.0,1,1,0
CZ,ZA,2005.0,1,1,0
NI,MX,2018.0,4,2,2
ML,MA,2017.0,2,2,0
PL,ID,2020.0,11,11,0
MT,BR,2011.0,2,2,0
AU,LT,2013.0,2,3,-1
CN,ZA,1999.0,4,1,3
BE,HR,2012.0,1,1,0
SE,PK,2009.0,3,5,-2
EG,FI,2020.0,3,1,2
PT,CZ,2011.0,3,1,2
US,GD,2011.0,4,8,-4
IE,AT,2006.0,5,4,1
NZ,NP,2004.0,2,3,-1
GR,BD,2007.0,1,1,0
MA,BE,2019.0,7,10,-3
NZ,NO,2009.0,3,2,1
KR,CH,2002.0,4,5,-1
IE,BD,2018.0,1,3,-2
RU,RO,2016.0,4,3,1
LU,VN,2019.0,1,1,0
EG,ZA,2001.0,1,1,0
NO,NZ,2011.0,3,5,-2
CZ,nan,2018.0,10,9,1
CN,ZW,2004.0,1,2,-1
IN,BH,2008.0,4,1,3
SG,HK,2019.0,1,6,-5
GB,EC,2011.0,2,5,-3
EG,nan,2011.0,1,4,-3
NE,GH,2015.0,1,1,0
TH,CH,2020.0,3,2,1
ZA,TR,2020.0,4,7,-3
TR,MY,2010.0,5,3,2
AR,UA,2018.0,2,1,1
GB,IE,2023.0,15,17,-2
YE,MY,2022.0,10,10,0
BJ,CG,2016.0,1,2,-1
CZ,BY,2010.0,7,10,-3
RS,PL,2012.0,3,1,2
IS,BE,2009.0,2,1,1
EC,JP,2022.0,2,2,0
AU,SI,2017.0,2,7,-5
GB,GE,2011.0,4,6,-2
BR,LU,2021.0,9,3,6
FR,CF,2014.0,2,1,1
ZA,CZ,2021.0,5,11,-6
BR,RU,1997.0,4,7,-3
KR,PA,2014.0,6,1,5
EG,BH,2017.0,6,9,-3
GE,CN,2020.0,6,3,3
MY,NO,2013.0,4,3,1
TR,UA,2013.0,3,1,2
CZ,AU,2016.0,7,9,-2
DK,LT,2019.0,3,3,0
CA,VN,2012.0,7,5,2
FI,PT,2016.0,4,9,-5
MT,ES,2019.0,2,2,0
TH,LK,2013.0,3,1,2
IN,IS,2021.0,4,2,2
GH,NZ,2019.0,2,5,-3
SK,AU,2006.0,1,2,-1
SA,TN,2010.0,5,16,-11
PY,GB,2007.0,2,1,1
MX,IN,2001.0,6,8,-2
TH,NP,2020.0,4,7,-3
EG,SE,2014.0,7,8,-1
FR,BG,2019.0,5,7,-2
AT,MK,2009.0,2,9,-7
HU,MA,2018.0,2,2,0
LK,AT,2022.0,2,1,1
DE,ZM,2017.0,1,1,0
BR,RU,1998.0,8,15,-7
MX,PR,2013.0,4,1,3
EC,NL,2020.0,3,8,-5
CM,CI,2018.0,3,5,-2
ET,TZ,2019.0,1,1,0
CN,IS,2015.0,2,1,1
TR,MD,2020.0,10,5,5
NO,IL,2011.0,1,1,0
SE,QA,1999.0,1,1,0
EG,OM,2005.0,4,1,3
BE,GH,2009.0,1,1,0
DK,BE,1997.0,6,3,3
TW,IR,2013.0,10,3,7
PT,EG,2017.0,4,3,1
FI,IN,2015.0,13,21,-8
PL,KR,2022.0,3,1,2
TR,XK,2017.0,1,1,0
GB,CR,2020.0,9,5,4
BE,GM,2018.0,2,1,1
RO,AR,2020.0,2,1,1
IT,CM,2010.0,8,1,7
EG,NO,2013.0,2,1,1
IE,IR,2013.0,2,4,-2
PL,UZ,1999.0,1,2,-1
AT,TH,1997.0,1,1,0
TJ,US,2009.0,2,2,0
CY,IT,2017.0,2,1,1
BG,IL,2007.0,1,1,0
ET,IT,2016.0,8,4,4
FR,UZ,2012.0,1,1,0
KR,UA,2006.0,1,1,0
CN,RS,2004.0,7,5,2
ZA,IL,2016.0,5,2,3
SE,SI,2015.0,2,8,-6
TZ,ZW,2020.0,3,1,2
EG,BE,2020.0,5,5,0
HU,KR,2005.0,3,2,1
CN,BR,1997.0,4,1,3
FJ,CA,2014.0,2,1,1
IQ,CA,2013.0,3,4,-1
QA,DE,2013.0,3,8,-5
QA,MY,2016.0,1,12,-11
AU,TZ,2017.0,1,2,-1
EG,BH,2010.0,4,1,3
TW,CZ,2009.0,3,2,1
FJ,AU,2013.0,7,3,4
KW,CA,2003.0,1,2,-1
UA,HU,2001.0,1,2,-1
SG,PH,2011.0,4,5,-1
SE,LT,2010.0,3,2,1
CD,BE,2012.0,8,4,4
BD,RU,2022.0,1,1,0
PT,UY,2019.0,5,4,1
IQ,RU,2017.0,1,2,-1
BS,US,2014.0,4,4,0
ZA,BF,2021.0,1,1,0
DK,KR,2022.0,2,4,-2
BE,BG,2013.0,2,10,-8
ID,IT,2015.0,3,19,-16
BF,US,2008.0,2,1,1
KR,KP,2020.0,12,2,10
PA,DE,2017.0,5,3,2
ES,UA,2000.0,2,1,1
PK,ZW,2022.0,4,2,2
TH,AT,2016.0,2,10,-8
CH,GE,2006.0,2,2,0
RO,MD,2016.0,6,6,0
CZ,IL,2004.0,2,2,0
CZ,SI,2021.0,7,5,2
BR,IR,2008.0,2,1,1
HR,NL,2022.0,6,4,2
TN,OM,2022.0,2,2,0
NP,JP,2001.0,3,3,0
OM,US,2004.0,8,5,3
EG,BH,2019.0,6,9,-3
HU,BY,2020.0,2,1,1
ZM,BD,2011.0,1,1,0
MY,IT,2023.0,4,8,-4
PA,CH,2016.0,2,1,1
NG,ZM,2019.0,2,3,-1
GB,BJ,2012.0,1,3,-2
NL,SR,2012.0,2,1,1
VG,GB,2008.0,1,1,0
CH,LU,2012.0,1,4,-3
SE,DZ,2022.0,2,3,-1
ZA,RU,2002.0,6,3,3
MN,US,2014.0,1,10,-9
RS,KR,2007.0,1,2,-1
ES,LT,2014.0,1,3,-2
DZ,CN,2012.0,2,2,0
SK,PT,2007.0,3,1,2
GP,GF,2005.0,1,2,-1
FI,BG,2019.0,1,1,0
BR,LT,2022.0,2,1,1
CZ,MA,2016.0,1,1,0
CA,GE,2018.0,6,1,5
AT,CA,2023.0,1,3,-2
ZW,IN,2019.0,2,1,1
CI,CD,2021.0,1,1,0
VN,CL,2004.0,1,1,0
PT,RO,2005.0,3,5,-2
PG,US,2011.0,1,4,-3
FI,HU,2003.0,3,9,-6
DZ,LB,2016.0,1,1,0
PA,BR,2021.0,3,4,-1
CU,CN,2013.0,1,1,0
SK,KR,2012.0,2,1,1
US,BS,2001.0,2,1,1
TW,VN,2003.0,1,2,-1
IR,AF,2016.0,4,1,3
IT,CY,1998.0,1,1,0
MX,KZ,2018.0,1,1,0
ZA,PS,2017.0,1,2,-1
JP,AM,2001.0,3,4,-1
CL,CZ,2008.0,1,2,-1
GH,IT,2015.0,1,1,0
ID,MA,2014.0,1,1,0
BR,UA,2005.0,3,1,2
AT,IE,2022.0,1,2,-1
ID,BE,2009.0,1,4,-3
AU,VN,2004.0,6,4,2
PS,SE,2017.0,2,1,1
DK,EE,2016.0,3,2,1
BE,CO,1997.0,1,1,0
SE,CH,2023.0,3,2,1
NZ,PL,2011.0,1,2,-1
ES,GT,2008.0,1,2,-1
US,CI,2020.0,6,6,0
EE,DK,2016.0,2,3,-1
CM,PK,2021.0,1,3,-2
CN,BR,1998.0,3,3,0
KW,FR,2016.0,2,2,0
YE,IQ,2020.0,4,2,2
IT,PE,2006.0,3,1,2
DK,MX,2017.0,3,6,-3
LT,DK,2004.0,1,3,-2
CA,BJ,2019.0,4,2,2
GT,US,2009.0,3,5,-2
BR,GH,2020.0,3,1,2
FR,KW,2017.0,6,5,1
GB,LB,2006.0,1,1,0
CW,DE,2014.0,7,2,5
LU,RU,2014.0,1,1,0
MT,ES,2010.0,3,2,1
IN,TH,2003.0,4,1,3
CA,BG,2020.0,4,1,3
BG,DK,2011.0,1,1,0
BR,KR,2009.0,7,5,2
UA,GE,2020.0,1,1,0
SS,US,2012.0,2,2,0
IE,IN,1997.0,1,2,-1
US,PS,2002.0,5,3,2
NG,DE,2003.0,2,3,-1
NO,CH,2007.0,5,18,-13
SK,SI,1998.0,1,1,0
DE,AM,2005.0,2,6,-4
MT,FR,2021.0,2,3,-1
DZ,BE,2015.0,6,3,3
OM,GB,2013.0,6,10,-4
VN,SE,2000.0,1,3,-2
NO,KR,2022.0,4,5,-1
HK,TW,2010.0,2,3,-1
CZ,BR,2005.0,1,4,-3
GR,BG,2003.0,2,4,-2
HU,JO,2021.0,3,3,0
BJ,SN,2014.0,3,1,2
TN,SN,2018.0,1,1,0
CA,TZ,2008.0,1,2,-1
BA,GB,2022.0,1,2,-1
PS,US,2006.0,1,10,-9
MM,AU,2022.0,3,2,1
HR,ID,2022.0,1,1,0
LR,NG,2020.0,1,1,0
CZ,LT,2001.0,2,3,-1
SE,NG,2006.0,2,1,1
AU,BD,2009.0,4,15,-11
PA,DE,2010.0,4,2,2
BH,GB,2013.0,2,7,-5
US,MD,2020.0,4,2,2
US,LY,2011.0,1,3,-2
MX,EG,2013.0,3,1,2
BD,AU,1998.0,4,2,2
CL,GT,2017.0,3,2,1
SN,GN,2015.0,2,3,-1
DK,PH,2007.0,1,2,-1
JP,HU,2021.0,5,16,-11
MX,AF,2019.0,5,2,3
IN,RU,2007.0,2,14,-12
UG,ET,2014.0,1,1,0
FR,CR,2002.0,2,1,1
FR,LY,2013.0,1,1,0
BD,IE,2009.0,1,2,-1
SG,LK,2008.0,1,1,0
CA,EE,2021.0,1,2,-1
RS,SI,2023.0,4,1,3
ZA,RO,2012.0,1,3,-2
BE,UA,2012.0,4,2,2
NO,AR,2018.0,2,3,-1
JO,CO,2015.0,1,1,0
TN,SA,1998.0,1,1,0
ZM,CL,2018.0,1,1,0
MY,DE,2006.0,2,3,-1
EE,IR,2012.0,1,1,0
ES,PS,2020.0,7,8,-1
TW,AT,2017.0,2,2,0
NO,PL,2010.0,4,6,-2
MW,DE,2021.0,2,2,0
FI,IE,2008.0,1,3,-2
GT,ES,2003.0,3,1,2
BO,AR,2016.0,3,4,-1
NL,JO,2005.0,2,1,1
VN,IN,2014.0,1,2,-1
CY,IT,2019.0,1,3,-2
AR,BE,2001.0,2,1,1
UY,PE,2007.0,2,2,0
IN,BT,2021.0,1,1,0
TR,CA,2023.0,2,2,0
CA,ZM,2020.0,2,1,1
PH,TR,2021.0,1,1,0
SN,DE,2018.0,1,3,-2
FI,CZ,2022.0,2,6,-4
CA,KE,2000.0,1,2,-1
AU,PT,1997.0,1,2,-1
US,JM,1998.0,3,12,-9
PK,PH,2018.0,4,1,3
RU,TJ,2000.0,1,2,-1
FR,OM,2011.0,1,6,-5
SN,LB,2020.0,1,1,0
TR,FI,2009.0,3,3,0
SI,CH,1997.0,1,1,0
HK,TW,2019.0,2,2,0
ME,IT,2018.0,1,2,-1
GH,KR,2020.0,4,8,-4
AU,AR,2001.0,2,3,-1
BY,JP,2018.0,1,1,0
NO,US,2018.0,172,207,-35
US,AU,2016.0,2584,2467,117
PK,GB,2021.0,178,137,41
UA,JP,2010.0,2,6,-4
SE,GB,2011.0,161,177,-16
AR,CO,2013.0,101,81,20
SG,CN,2005.0,264,210,54
CL,CO,2019.0,260,286,-26
CH,US,2015.0,872,911,-39
AT,FI,2012.0,11,8,3
CL,US,2014.0,201,247,-46
CN,HK,2020.0,176,143,33
US,PK,2020.0,424,468,-44
US,AE,2018.0,105,81,24
KR,GB,2003.0,44,48,-4
CL,BR,2022.0,53,49,4
SG,IN,2021.0,112,120,-8
KR,ET,2018.0,87,125,-38
CO,AR,2003.0,22,18,4
CL,CO,2010.0,155,118,37
MX,CH,2017.0,16,15,1
AE,US,2014.0,52,87,-35
GB,SE,2016.0,212,207,5
US,NP,2020.0,84,105,-21
ES,CL,2009.0,242,222,20
AU,NZ,2022.0,86,106,-20
PE,ES,2006.0,22,29,-7
US,IE,2021.0,399,391,8
IT,BE,2016.0,184,112,72
MD,FR,2005.0,56,54,2
FR,VN,2016.0,50,16,34
US,BD,2018.0,117,223,-106
CN,CZ,2003.0,24,20,4
CH,ES,2021.0,84,123,-39
MW,GB,2016.0,12,8,4
FR,PT,2014.0,51,55,-4
US,PT,2015.0,208,195,13
JP,BD,2007.0,56,25,31
FR,ES,2021.0,240,243,-3
JO,SA,2020.0,56,60,-4
EG,CN,2010.0,20,20,0
PL,CA,2018.0,30,47,-17
AT,IT,2020.0,73,82,-9
RU,GB,2012.0,88,70,18
AT,PL,2007.0,9,11,-2
US,GR,2004.0,163,110,53
FR,SY,2009.0,14,1,13
ES,IR,2022.0,12,19,-7
IL,GB,2014.0,63,56,7
PL,CZ,2000.0,9,3,6
IR,DE,2015.0,116,53,63
QA,AE,2019.0,13,7,6
IL,TR,2013.0,2,3,-1
RU,IE,2020.0,13,7,6
JP,HK,2021.0,7,12,-5
CO,UA,2019.0,2,1,1
KZ,SA,2021.0,4,1,3
CA,NZ,2018.0,78,82,-4
MX,AU,2003.0,5,2,3
ZA,CN,2022.0,13,9,4
AT,LI,2019.0,3,1,2
IE,CL,2020.0,3,3,0
PH,MX,2012.0,5,6,-1
ET,KR,2023.0,15,31,-16
LU,FI,2016.0,4,2,2
UA,JP,2019.0,6,6,0
RU,DK,2003.0,13,4,9
NL,PL,2019.0,24,33,-9
AR,PA,2015.0,9,3,6
IT,NO,2007.0,15,19,-4
MY,JP,2012.0,32,59,-27
GP,FR,2007.0,11,10,1
PE,BE,2008.0,2,1,1
FR,AU,2000.0,58,40,18
SA,NL,2015.0,8,4,4
CI,ML,2012.0,3,5,-2
PH,CN,2001.0,8,8,0
US,RO,2010.0,70,58,12
NO,PL,2017.0,10,18,-8
FR,ET,2015.0,4,1,3
AT,CN,2010.0,15,15,0
IN,GR,2008.0,3,2,1
PK,CZ,2022.0,4,2,2
US,BE,2023.0,17,9,8
US,CH,2023.0,31,28,3
ES,NI,2008.0,2,2,0
KE,GH,2021.0,2,3,-1
KR,SA,2015.0,10,4,6
FR,CR,2005.0,2,2,0
KR,IQ,2014.0,1,1,0
BR,AR,1999.0,15,26,-11
CZ,BY,2017.0,18,20,-2
GH,CH,2021.0,4,1,3
IN,TN,2017.0,4,3,1
KR,IL,2019.0,5,9,-4
NG,BJ,2008.0,4,2,2
BE,CZ,2019.0,10,12,-2
NO,FR,2022.0,23,32,-9
UY,CO,2017.0,8,13,-5
BE,CZ,2010.0,7,11,-4
TN,US,1999.0,5,3,2
BR,NL,2001.0,16,7,9
TR,IQ,2015.0,6,4,2
TW,SG,2003.0,13,23,-10
CZ,HR,2013.0,7,8,-1
FR,EG,2005.0,10,7,3
SA,CN,2007.0,3,5,-2
RS,FR,2017.0,9,9,0
BY,PL,2014.0,5,5,0
BY,FR,2013.0,1,2,-1
BE,NG,2016.0,1,1,0
MX,IL,2018.0,8,4,4
HK,JP,2013.0,11,6,5
DE,RO,2005.0,27,30,-3
BH,KE,2012.0,4,1,3
AT,HR,2006.0,3,2,1
FR,ZA,2013.0,38,36,2
GH,CI,2017.0,3,1,2
BE,CD,2006.0,1,1,0
MT,US,2020.0,6,9,-3
SN,BE,2015.0,3,3,0
SE,IR,2001.0,4,4,0
KR,AE,2021.0,6,5,1
DK,CN,2023.0,6,20,-14
AR,CR,2005.0,3,5,-2
FI,IT,2001.0,6,7,-1
KR,IL,2017.0,6,3,3
GE,BR,2008.0,3,1,2
AU,RU,2022.0,20,25,-5
CN,MX,2001.0,4,2,2
MY,DK,2013.0,2,4,-2
SE,LT,2017.0,6,4,2
PA,GB,2015.0,4,9,-5
AU,SI,2010.0,3,4,-1
ID,AU,2007.0,18,17,1
AR,CU,2003.0,6,7,-1
DK,BE,1998.0,5,6,-1
SG,NL,2015.0,15,23,-8
BD,SE,2001.0,3,1,2
GT,FR,2012.0,1,2,-1
MQ,FR,2008.0,7,8,-1
GR,QA,2010.0,3,1,2
SE,CL,2012.0,8,3,5
CR,NL,2017.0,7,2,5
CA,RU,2009.0,30,17,13
US,GY,2020.0,3,3,0
US,EC,2011.0,14,19,-5
GB,AE,2004.0,12,7,5
SA,DK,2015.0,1,3,-2
AR,SE,2005.0,2,1,1
PA,ZA,2017.0,1,2,-1
ZA,TW,2021.0,1,2,-1
MX,CN,2016.0,11,11,0
HU,CH,2000.0,8,5,3
KR,CZ,2009.0,2,7,-5
TW,BE,2013.0,5,5,0
AU,MT,2017.0,2,1,1
DE,KZ,2014.0,7,1,6
RO,SK,2012.0,2,5,-3
LB,IR,2011.0,1,2,-1
LU,nan,2010.0,1,1,0
TR,PG,2018.0,2,1,1
AU,MY,2002.0,5,8,-3
BD,NZ,2015.0,6,6,0
AR,JP,2012.0,4,4,0
JP,CM,2020.0,3,3,0
EC,FR,2016.0,5,14,-9
IN,TN,2019.0,3,2,1
HR,HU,2012.0,1,1,0
GB,NP,2017.0,11,4,7
CZ,MX,2012.0,2,6,-4
CA,CZ,2009.0,7,9,-2
CA,IE,2023.0,2,7,-5
BE,VE,2016.0,2,1,1
OM,AU,2014.0,2,8,-6
GR,LU,2012.0,1,1,0
AU,FR,2023.0,3,1,2
JP,ET,2006.0,3,4,-1
CA,OM,2005.0,4,2,2
DE,SK,2021.0,12,64,-52
NL,MW,2018.0,1,3,-2
EE,MX,2021.0,1,2,-1
CO,IN,2011.0,3,2,1
ZW,NG,1999.0,1,3,-2
KR,CH,2005.0,4,7,-3
CA,CU,2020.0,3,8,-5
NP,CN,2003.0,1,2,-1
IS,DK,2003.0,2,3,-1
CU,FR,2014.0,6,3,3
CA,BJ,2010.0,2,1,1
IR,CY,2013.0,4,1,3
GR,HU,2011.0,2,3,-1
ET,PR,2021.0,3,6,-3
EG,IL,2012.0,1,3,-2
GF,GP,2019.0,1,1,0
GP,MA,2014.0,1,2,-1
GR,LK,2007.0,2,4,-2
IT,JP,2023.0,2,1,1
NI,ES,2010.0,3,1,2
SM,IT,2018.0,1,4,-3
AU,JM,2018.0,2,2,0
IT,CH,2014.0,359,208,151
DE,ZA,2018.0,62,63,-1
NL,JP,2012.0,35,34,1
CZ,PT,2007.0,3,3,0
CZ,BY,2019.0,16,16,0
US,CM,2004.0,6,5,1
HU,FI,1998.0,4,1,3
NG,SE,2012.0,4,1,3
LU,nan,2019.0,1,1,0
IR,RU,2010.0,1,10,-9
IN,LU,2013.0,1,1,0
CA,,2018.0,9846,0,9846
KR,,2016.0,3773,0,3773
ID,,2024.0,53891,0,53891
,BE,2002.0,2564,0,2564
IN,,2023.0,85930,0,85930
BR,,2011.0,3979,0,3979
,EC,1996.0,37,0,37
EC,,2024.0,2413,0,2413
DE,,2002.0,5770,0,5770
DE,,2005.0,6473,0,6473
FO,,2020.0,11,0,11
XK,,2023.0,366,0,366
,CH,1997.0,3195,0,3195
,MX,1994.0,4195,0,4195
PT,,2020.0,1737,0,1737
GR,,2010.0,1283,0,1283
,CH,1998.0,3000,0,3000
,BE,2005.0,3011,0,3011
,CZ,2007.0,2017,0,2017
,AT,2010.0,2364,0,2364
,NO,2007.0,2002,0,2002
,CO,2015.0,3060,0,3060
GR,,2019.0,2680,0,2680
KE,,2023.0,2620,0,2620
,EG,2006.0,1867,0,1867
GR,,2017.0,2083,0,2083
AU,,2003.0,1423,0,1423
BE,,2013.0,1767,0,1767
BD,,2022.0,1490,0,1490
HU,,2009.0,551,0,551
,MT,2006.0,41,0,41
BF,,2022.0,273,0,273
CH,,2007.0,1335,0,1335
,KP,2013.0,18,0,18
MA,,2016.0,594,0,594
,CU,2007.0,497,0,497
SE,,1998.0,605,0,605
BA,,2023.0,975,0,975
DE,IQ,2010.0,3,0,3
,SK,2012.0,1261,0,1261
SA,,2013.0,335,0,335
,UG,2012.0,397,0,397
GH,,2015.0,80,0,80
NG,,2011.0,323,0,323
,BJ,2004.0,46,0,46
SI,,2017.0,541,0,541
IS,,2019.0,114,0,114
,BG,2001.0,389,0,389
,BY,1994.0,620,0,620
NO,EG,2014.0,4,0,4
QA,,2008.0,40,0,40
JM,KR,2013.0,1,0,1
SI,,2019.0,611,0,611
PE,,2014.0,232,0,232
,AE,1997.0,70,0,70
,TH,2008.0,2209,0,2209
KW,,2020.0,201,0,201
BO,,2009.0,11,0,11
AM,,2014.0,80,0,80
AT,,1998.0,250,0,250
PS,,2021.0,161,0,161
,LV,2014.0,368,0,368
SI,,2010.0,190,0,190
,AT,2019.0,1244,0,1244
,AT,2017.0,2103,0,2103
UA,,2007.0,523,0,523
,MD,1995.0,138,0,138
,BN,2014.0,40,0,40
,PS,2007.0,46,0,46
,PY,2013.0,97,0,97
,RE,2009.0,33,0,33
,MN,2007.0,45,0,45
ME,,2007.0,7,0,7
,FO,2015.0,9,0,9
,EC,2004.0,99,0,99
,GT,2006.0,25,0,25
CD,CN,2018.0,1,0,1
,JO,2006.0,320,0,320
nan,,1998.0,100,0,100
FR,MN,2009.0,1,0,1
CO,MY,2009.0,1,0,1
HK,,2020.0,51,0,51
,NE,2006.0,13,0,13
,ET,2006.0,238,0,238
,RU,2020.0,1058,0,1058
VU,AU,2019.0,1,0,1
NP,,2007.0,24,0,24
GE,,2014.0,89,0,89
PA,,2021.0,132,0,132
CI,BF,2006.0,2,0,2
PH,,2004.0,79,0,79
,PH,2018.0,730,0,730
RS,,2007.0,130,0,130
RU,IQ,2008.0,1,0,1
,GD,2015.0,27,0,27
,AE,1998.0,73,0,73
IS,,2010.0,49,0,49
SS,SD,2022.0,1,0,1
BG,EG,2018.0,3,0,3
ES,SG,2003.0,1,0,1
,MZ,2018.0,62,0,62
,NC,2018.0,8,0,8
,BT,2018.0,29,0,29
CY,DE,2023.0,1,0,1
,BD,2010.0,1218,0,1218
PL,,2011.0,1574,0,1574
ML,,2021.0,76,0,76
NE,BJ,2009.0,1,0,1
,BD,2019.0,892,0,892
BN,,2000.0,2,0,2
LY,,2024.0,248,0,248
,NA,2017.0,44,0,44
KW,JP,2009.0,1,0,1
,UY,2008.0,282,0,282
,BD,2017.0,969,0,969
,PK,2016.0,2866,0,2866
,TZ,1999.0,92,0,92
LB,,2013.0,90,0,90
,BI,2009.0,14,0,14
AU,PW,2010.0,1,0,1
MG,ZW,2009.0,1,0,1
MD,US,2005.0,6,0,6
,LI,1994.0,4,0,4
UG,,2000.0,2,0,2
CA,LV,2020.0,1,0,1
IT,MM,2022.0,5,0,5
PK,TH,2009.0,3,0,3
IS,,2017.0,95,0,95
BR,GT,2011.0,1,0,1
MW,KE,2019.0,1,0,1
,NA,2010.0,26,0,26
NZ,WS,2016.0,1,0,1
UA,KG,2018.0,1,0,1
VE,PH,2015.0,1,0,1
DO,ES,2003.0,3,0,3
ZM,NL,2019.0,3,0,3
SA,TG,2021.0,1,0,1
,SL,2017.0,20,0,20
UG,IR,2020.0,1,0,1
CA,NI,2017.0,11,0,11
MR,DZ,2019.0,1,0,1
VN,SA,2021.0,4,0,4
IT,UG,2006.0,1,0,1
MA,KR,2005.0,1,0,1
RS,MD,2011.0,1,0,1
QA,TW,2001.0,1,0,1
PS,CN,2007.0,1,0,1
MU,,2006.0,6,0,6
nan,BF,1998.0,2,0,2
HN,,2009.0,7,0,7
LR,,2021.0,12,0,12
NZ,PT,2016.0,4,0,4
MA,KW,2007.0,3,0,3
NG,GE,2022.0,1,0,1
MR,,2018.0,13,0,13
SC,,2012.0,1,0,1
TM,,2005.0,3,0,3
CN,VE,2004.0,1,0,1
,AG,1997.0,2,0,2
VG,RU,2017.0,1,0,1
CM,LS,2007.0,1,0,1
EE,AM,2002.0,1,0,1
CO,TZ,2014.0,1,0,1
BE,IR,2002.0,1,0,1
NI,,2016.0,13,0,13
BB,,2000.0,1,0,1
TW,AT,2010.0,1,0,1
PK,ET,2022.0,1,0,1
RE,VN,2017.0,1,0,1
TH,BA,2011.0,2,0,2
UA,FI,2009.0,2,0,2
FI,VE,2021.0,1,0,1
TN,MX,2003.0,3,0,3
,CD,2000.0,8,0,8
SE,TH,1997.0,1,0,1
GE,PL,1999.0,1,0,1
MQ,,2020.0,25,0,25
LT,KP,2010.0,1,0,1
CI,SA,2012.0,1,0,1
VE,IE,2019.0,3,0,3
VU,AU,2010.0,1,0,1
BE,CW,2021.0,2,0,2
,LA,2006.0,7,0,7
,PW,2004.0,2,0,2
SK,MK,2012.0,1,0,1
,JE,2004.0,3,0,3
GF,GP,2010.0,1,0,1
BE,IE,2023.0,1,0,1
MA,PL,2019.0,1,0,1
EC,PL,2016.0,1,0,1
,SV,2002.0,8,0,8
GR,SI,2012.0,2,0,2
IR,nan,2004.0,3,0,3
CA,MN,2018.0,1,0,1
NZ,AE,2010.0,2,0,2
MW,GM,2012.0,1,0,1
SY,KW,1997.0,1,0,1
LV,DK,2009.0,1,0,1
PL,NZ,2006.0,2,0,2
ZW,,2008.0,20,0,20
JM,FR,2008.0,3,0,3
KE,SA,2002.0,1,0,1
PL,SI,2006.0,2,0,2
ID,NL,2023.0,1,0,1
IR,LT,2013.0,1,0,1
NZ,OM,2003.0,3,0,3
TN,GP,2011.0,1,0,1
CG,,2025.0,1,0,1
SV,SN,2015.0,1,0,1
,BJ,1996.0,19,0,19
BA,FI,2018.0,1,0,1
EC,DE,2003.0,2,0,2
AE,QA,2004.0,2,0,2
MZ,LT,2018.0,1,0,1
AZ,US,2000.0,3,0,3
PL,IQ,2007.0,2,0,2
TZ,AU,2016.0,3,0,3
JP,EE,2008.0,2,0,2
CV,,2001.0,1,0,1
PH,BR,1999.0,1,0,1
PY,ES,1998.0,1,0,1
,AG,1998.0,5,0,5
BR,HN,2012.0,4,0,4
UY,NO,2021.0,1,0,1
AU,TT,2018.0,2,0,2
BO,IT,2014.0,1,0,1
SN,MA,2021.0,1,0,1
,GP,1994.0,28,0,28
SN,GB,2019.0,2,0,2
ZA,GH,2007.0,2,0,2
TR,,2026.0,5,0,5
nan,AE,2011.0,1,0,1
ZA,KZ,2021.0,1,0,1
ZW,IS,2018.0,1,0,1
HU,TH,2011.0,1,0,1
CD,,2011.0,10,0,10
,CF,1997.0,7,0,7
BE,MM,2013.0,1,0,1
RW,RU,2014.0,1,0,1
IN,AM,2018.0,1,0,1
,BS,2015.0,3,0,3
RW,GA,2009.0,1,0,1
MX,HK,1998.0,1,0,1
,ST,1999.0,13,0,13
MT,BE,2019.0,1,0,1
PL,RS,1999.0,1,0,1
LK,RO,2017.0,6,0,6
TR,XK,2019.0,2,0,2
SS,DE,1998.0,2,0,2
,AF,2006.0,5,0,5
,SV,2005.0,11,0,11
ES,VG,1999.0,1,0,1
BD,FJ,2016.0,1,0,1
,HR,2020.0,38,0,38
UZ,BE,2000.0,1,0,1
,NI,1994.0,12,0,12
MV,FI,2013.0,1,0,1
FR,SL,2020.0,1,0,1
GB,VN,2001.0,3,0,3
AE,BF,2020.0,1,0,1
MW,NL,1999.0,2,0,2
,SL,2010.0,3,0,3
MT,DE,1999.0,1,0,1
IT,PK,2001.0,4,0,4
NG,FI,2022.0,1,0,1
CA,TN,1997.0,1,0,1
TN,SG,2016.0,1,0,1
UA,OM,2001.0,1,0,1
PF,,1998.0,1,0,1
TR,MX,2021.0,2,0,2
nan,PH,2016.0,3,0,3
FO,DE,2010.0,2,0,2
PR,JP,1999.0,2,0,2
PY,CL,2005.0,1,0,1
IT,BW,2007.0,1,0,1
DE,LI,2012.0,4,0,4
PE,RU,2013.0,1,0,1
SK,ES,2000.0,1,0,1
LV,TJ,2021.0,1,0,1
IE,NG,2020.0,6,0,6
HN,GT,2017.0,2,0,2
DE,TT,2023.0,1,0,1
nan,MT,2019.0,1,0,1
BR,TN,2016.0,2,0,2
ET,BW,2006.0,1,0,1
SR,,2020.0,5,0,5
AR,TN,2018.0,1,0,1
BE,TG,2022.0,1,0,1
,PF,2011.0,4,0,4
IT,MN,2018.0,1,0,1
PA,NZ,2010.0,1,0,1
KE,OM,2001.0,1,0,1
ZW,CZ,2018.0,4,0,4
DE,BO,2009.0,3,0,3
,NA,2019.0,21,0,21
GF,,2025.0,9,0,9
VN,TR,2018.0,1,0,1
PK,CG,2008.0,1,0,1
KN,,2020.0,8,0,8
PA,SE,2018.0,1,0,1
ML,GP,1997.0,1,0,1
GB,GA,2023.0,2,0,2
PK,BG,2015.0,1,0,1
IR,SD,2020.0,5,0,5
LS,,2025.0,4,0,4
AU,BG,2000.0,4,0,4
IT,KE,1998.0,2,0,2
AL,UZ,2021.0,1,0,1
GF,DE,2005.0,1,0,1
NP,KR,2004.0,3,0,3
CN,GT,2021.0,1,0,1
FR,BZ,2021.0,1,0,1
DZ,NZ,2007.0,1,0,1
AL,NG,2023.0,1,0,1
PY,,2009.0,3,0,3
PF,GF,2007.0,1,0,1
GM,GH,2011.0,1,0,1
LT,IE,2016.0,2,0,2
AL,SE,2012.0,1,0,1
CO,BD,2009.0,2,0,2
NO,VN,2016.0,2,0,2
GE,BD,2019.0,1,0,1
ES,PH,2001.0,4,0,4
SS,,2009.0,2,0,2
CU,NL,2000.0,1,0,1
EG,NP,2013.0,2,0,2
KE,CA,2004.0,3,0,3
SG,LY,2015.0,1,0,1
ML,NG,2002.0,2,0,2
HN,PA,2013.0,1,0,1
DZ,IQ,2016.0,2,0,2
ID,SY,2021.0,4,0,4
CN,TZ,2006.0,1,0,1
BA,BN,2019.0,1,0,1
SI,GB,1997.0,1,0,1
GF,GP,2017.0,2,0,2
FR,ME,2022.0,1,0,1
CI,TG,2011.0,1,0,1
IE,UY,2003.0,1,0,1
SV,NO,2017.0,1,0,1
NP,AE,2009.0,1,0,1
FI,IS,2018.0,2,0,2
UA,IE,2009.0,1,0,1
CL,BA,2018.0,1,0,1
CU,RU,2015.0,2,0,2
LU,CI,2011.0,1,0,1
UZ,KG,2016.0,2,0,2
IT,KE,1997.0,2,0,2
LK,KE,2019.0,1,0,1
CA,BS,2012.0,1,0,1
GT,,2002.0,1,0,1
VN,MZ,2015.0,1,0,1
LB,SY,2020.0,5,0,5
BF,BD,2003.0,1,0,1
BD,AU,1997.0,1,0,1
KZ,IT,2011.0,1,0,1
BI,US,2000.0,3,0,3
PR,BR,2012.0,1,0,1
LK,RU,2015.0,1,0,1
US,MR,2014.0,1,0,1
HR,BG,2012.0,1,0,1
KW,RO,2018.0,1,0,1
ZM,IT,2019.0,2,0,2
DZ,MD,2002.0,1,0,1
BI,ID,2011.0,1,0,1
RO,CY,2012.0,1,0,1
RS,PT,2019.0,5,0,5
PE,EG,2022.0,1,0,1
MQ,CM,2018.0,1,0,1
DO,,1998.0,2,0,2
ST,,2016.0,4,0,4
US,YE,2003.0,1,0,1
IN,PR,2001.0,1,0,1
VE,AE,2015.0,1,0,1
EG,SK,2008.0,1,0,1
MW,CA,2016.0,1,0,1
MG,DE,2009.0,2,0,2
SN,ML,2007.0,1,0,1
TR,BD,2013.0,2,0,2
SN,GB,2010.0,2,0,2
IR,LU,2012.0,1,0,1
AT,MN,2017.0,1,0,1
EG,BR,2011.0,1,0,1
TH,TZ,2008.0,1,0,1
JO,BD,2021.0,1,0,1
SZ,AU,2020.0,2,0,2
CU,AT,2015.0,2,0,2
DE,BD,2003.0,2,0,2
TR,EG,2003.0,1,0,1
SK,IE,2004.0,2,0,2
BG,nan,2005.0,1,0,1
FI,LY,2012.0,1,0,1
,LB,2020.0,25,0,25
MK,QA,2020.0,1,0,1
PH,JM,2012.0,1,0,1
CN,TJ,2016.0,1,0,1
AR,LV,2019.0,1,0,1
AM,BE,2004.0,1,0,1
TT,ES,2017.0,1,0,1
PK,RU,2011.0,1,0,1
SN,BF,2005.0,2,0,2
NE,CI,2012.0,1,0,1
RU,VG,2019.0,1,0,1
TR,MN,2005.0,1,0,1
KW,TN,2010.0,4,0,4
NL,AM,2017.0,2,0,2
SA,UG,2014.0,1,0,1
LU,UG,2006.0,1,0,1
GB,YE,2001.0,1,0,1
MD,BG,2013.0,1,0,1
MD,SE,2010.0,1,0,1
PL,BW,2012.0,1,0,1
RW,ZW,2017.0,1,0,1
BJ,BO,2005.0,1,0,1
CR,CA,2012.0,2,0,2
AU,NG,2005.0,2,0,2
GA,CO,2011.0,1,0,1
CY,AM,2007.0,1,0,1
AM,PL,2013.0,1,0,1
RU,NO,1999.0,3,0,3
TN,FI,2004.0,1,0,1
BO,NI,2020.0,1,0,1
IN,RW,2021.0,2,0,2
SL,GB,2021.0,1,0,1
MM,IL,2007.0,1,0,1
KR,TN,2011.0,1,0,1
HU,MK,2015.0,1,0,1
BY,MY,2004.0,1,0,1
YE,ZW,2022.0,1,0,1
MD,LT,2014.0,2,0,2
IE,SI,2020.0,2,0,2
DE,UZ,2005.0,2,0,2
BD,SG,1999.0,1,0,1
ES,KE,1997.0,1,0,1
CN,AO,2018.0,2,0,2
HR,FI,2016.0,2,0,2
CH,PE,2005.0,1,0,1
RO,MC,2010.0,1,0,1
VE,QA,2013.0,1,0,1
MQ,SN,1997.0,1,0,1
TW,RS,2000.0,1,0,1
ZW,IN,2010.0,1,0,1
ZA,UG,2001.0,1,0,1
CL,GR,2021.0,1,0,1
,JE,1996.0,2,0,2
ZA,MU,2016.0,1,0,1
SA,CH,2011.0,1,0,1
GB,CI,2011.0,2,0,2
PK,VN,2001.0,2,0,2
JE,MX,2017.0,1,0,1
,SL,2019.0,9,0,9
NL,MD,2015.0,1,0,1
NO,GL,2022.0,1,0,1
ZA,JO,2017.0,1,0,1
DK,MN,2013.0,1,0,1
SY,ET,2014.0,1,0,1
BF,GB,2009.0,1,0,1
SG,TL,2019.0,1,0,1
CZ,GH,2015.0,2,0,2
CL,NI,2000.0,1,0,1
GR,AR,2020.0,1,0,1
BH,IR,2015.0,1,0,1
CU,PH,2009.0,1,0,1
AM,UA,2010.0,2,0,2
PA,DE,2019.0,3,0,3
QA,PL,2017.0,4,0,4
ET,BE,2023.0,1,0,1
TH,SS,2020.0,1,0,1
TR,CR,2018.0,2,0,2
IT,IR,1997.0,1,0,1
NZ,MK,2020.0,1,0,1
NG,CH,1999.0,1,0,1
JM,CH,2017.0,2,0,2
GB,AL,2020.0,1,0,1
JP,ME,2013.0,1,0,1
SK,EE,2019.0,1,0,1
EG,TJ,2021.0,1,0,1
UA,CL,2008.0,1,0,1
LA,VN,2021.0,1,0,1
LV,NO,2007.0,1,0,1
KE,SG,2000.0,2,0,2
CI,GH,2013.0,2,0,2
AR,KR,2013.0,1,0,1
CI,CG,2013.0,1,0,1
GD,IL,2019.0,1,0,1
CL,ZA,2007.0,3,0,3
IN,FO,2002.0,1,0,1
AE,UG,2022.0,1,0,1
BF,GH,2020.0,1,0,1
VN,GF,2018.0,1,0,1
MA,MD,2021.0,2,0,2
CH,DO,2012.0,1,0,1
SK,PG,2009.0,1,0,1
NG,ZM,2017.0,1,0,1
,TD,2015.0,3,0,3
RU,NP,2001.0,1,0,1
NG,BH,2004.0,2,0,2
EG,GM,2009.0,1,0,1
MX,IQ,2019.0,1,0,1
US,GF,2018.0,2,0,2
MU,GB,2022.0,2,0,2
DK,GW,2018.0,3,0,3
LA,AU,2022.0,1,0,1
EC,SG,2013.0,1,0,1
MY,IL,2022.0,1,0,1
AR,RO,2014.0,1,0,1
GH,UG,2015.0,1,0,1
CY,CH,2018.0,2,0,2
DE,CW,2022.0,1,0,1
RU,IL,2023.0,3,0,3
BE,IR,2005.0,3,0,3
SK,EE,2010.0,1,0,1
GM,CH,2002.0,1,0,1
nan,ET,2016.0,1,0,1
BO,PA,2009.0,1,0,1
LV,CH,2002.0,1,0,1
KW,TN,2017.0,1,0,1
ZA,PS,2010.0,1,0,1
HU,NZ,2013.0,2,0,2
AU,BS,2009.0,1,0,1
ET,PH,2010.0,1,0,1
NC,TW,2020.0,1,0,1
MT,QA,1997.0,1,0,1
SA,nan,2000.0,2,0,2
TJ,PK,2015.0,1,0,1
FI,BA,2008.0,1,0,1
CI,SN,2008.0,1,0,1
CO,LK,2020.0,1,0,1
NG,LT,2021.0,1,0,1
MG,BJ,2018.0,1,0,1
CH,SZ,2015.0,1,0,1
PT,FI,2001.0,1,0,1
KE,PH,2015.0,2,0,2
ZA,OM,2006.0,1,0,1
PT,BY,2017.0,1,0,1
PF,GP,2020.0,1,0,1
PT,GT,2020.0,1,0,1
MM,KR,2012.0,1,0,1
BG,TW,2013.0,1,0,1
SG,KW,1999.0,2,0,2
BH,AE,2007.0,3,0,3
LT,CH,2019.0,5,0,5
IT,LK,2008.0,1,0,1
QA,YE,2009.0,1,0,1
ZW,PK,2015.0,1,0,1
IL,JO,2004.0,1,0,1
SS,ID,2020.0,1,0,1
IQ,KR,2022.0,2,0,2
CZ,YE,2019.0,1,0,1
FM,,2023.0,1,0,1
KR,CR,2017.0,1,0,1
GB,VU,2000.0,1,0,1
FR,JO,2003.0,4,0,4
BE,KG,2021.0,1,0,1
UZ,MY,2006.0,1,0,1
KZ,AM,2013.0,2,0,2
UY,CR,2021.0,2,0,2
TN,JO,2013.0,1,0,1
OM,MA,2011.0,1,0,1
AU,KG,2016.0,1,0,1
ML,GM,2015.0,1,0,1
CM,BJ,2018.0,1,3,-2
NG,PH,2016.0,1,1,0
AU,BW,2019.0,1,1,0
MX,BE,1997.0,3,2,1
SE,LV,2012.0,1,3,-2
GH,BH,2011.0,1,3,-2
RU,MD,2008.0,4,6,-2
NP,TH,2012.0,2,6,-4
DK,RS,1997.0,1,1,0
PK,OM,2011.0,1,3,-2
JP,CU,2012.0,1,1,0
SA,AU,2000.0,4,2,2
QA,GB,2009.0,3,15,-12
IN,TN,2010.0,2,2,0
UZ,UA,2008.0,3,3,0
SE,GE,2005.0,1,1,0
PR,CA,2004.0,1,2,-1
IS,IL,2013.0,1,2,-1
HN,CO,2009.0,3,1,2
CR,CU,2003.0,1,1,0
CF,FR,2000.0,1,1,0
JP,KW,1998.0,1,1,0
TG,BJ,2015.0,1,2,-1
MX,BE,1998.0,1,3,-2
VN,FR,1998.0,1,4,-3
VE,IE,2017.0,1,1,0
RW,MW,2021.0,1,1,0
BE,ML,2020.0,1,1,0
RU,CR,2022.0,2,3,-1
AT,EC,2020.0,1,1,0
GL,DK,2022.0,3,1,2
TW,FI,2021.0,1,2,-1
MD,AR,2013.0,1,1,0
CZ,BR,2002.0,1,5,-4
AE,PK,2023.0,1,10,-9
CA,JM,2018.0,3,4,-1
NZ,HU,2006.0,1,2,-1
DE,GH,2023.0,2,1,1
GR,CN,2023.0,1,1,0
nan,TR,1999.0,2,1,1
TR,GR,2002.0,1,4,-3
ID,KE,2018.0,4,9,-5
TH,BD,2010.0,2,1,1
GT,CL,2022.0,2,3,-1
BO,GT,2022.0,1,1,0
FR,PF,2000.0,2,5,-3
BE,RE,2020.0,2,1,1
IN,DZ,2017.0,2,3,-1
IE,SK,2014.0,2,3,-1
RU,MK,2012.0,1,1,0
ZA,HU,2013.0,1,3,-2
GH,ID,2011.0,3,1,2
GT,VE,2020.0,2,1,1
IT,IR,1998.0,1,1,0
IR,AE,2012.0,3,4,-1
CI,ES,2000.0,1,2,-1
SD,MY,2005.0,1,2,-1
HR,MX,2008.0,1,2,-1
EG,SI,2014.0,1,1,0
BJ,BE,2014.0,1,6,-5
MY,UZ,2017.0,1,1,0
NZ,AE,2019.0,2,3,-1
TH,ES,2022.0,1,1,0
HU,FI,1997.0,1,4,-3
JO,JP,2019.0,4,2,2
VE,PT,2009.0,2,6,-4
PL,UA,2023.0,2,1,1
CD,UG,2022.0,1,1,0
YE,DE,2019.0,2,1,1
YE,IN,2009.0,1,2,-1
RS,FR,2010.0,1,4,-3
SG,IL,2002.0,1,2,-1
BR,HU,2012.0,2,2,0
NO,ZM,2020.0,1,2,-1
CA,RE,2012.0,1,2,-1
TT,CA,2011.0,1,3,-2
NZ,TW,2004.0,2,2,0
SY,MA,2019.0,1,2,-1
FI,ES,2023.0,2,1,1
IQ,RU,2019.0,1,3,-2
MX,HU,2012.0,1,1,0
BG,MX,2006.0,3,1,2
QA,PL,2019.0,1,3,-2
VG,CN,2018.0,1,1,0
AE,MY,2001.0,1,2,-1
BD,MX,2018.0,1,2,-1
DE,AM,2002.0,3,3,0
SD,LB,2020.0,1,1,0
LV,BE,2018.0,1,2,-1
DO,IT,2015.0,1,2,-1
AT,JP,1997.0,1,3,-2
EE,UA,2015.0,3,1,2
RO,HR,2019.0,1,3,-2
SD,EG,2003.0,2,1,1
TT,GB,2008.0,3,4,-1
AT,LK,2016.0,1,1,0
CR,nan,2003.0,2,3,-1
BE,AO,2020.0,1,1,0
MY,PH,2012.0,1,6,-5
PY,PT,2001.0,1,2,-1
CA,VE,2018.0,2,8,-6
SD,MY,2002.0,1,1,0
HT,FR,2015.0,1,2,-1
IN,LK,2000.0,1,1,0
LT,BE,2021.0,1,1,0
RO,PK,2013.0,1,2,-1
HU,BG,2011.0,1,1,0
IQ,YE,2015.0,1,1,0
SK,FI,2022.0,2,1,1
FI,BG,2010.0,1,1,0
BE,CO,1998.0,1,2,-1
SY,DE,2005.0,2,1,1
FK,US,2012.0,1,1,0
TZ,TR,2021.0,1,3,-2
DK,UA,2001.0,1,1,0
CZ,ZA,2002.0,1,1,0
MD,US,2002.0,1,3,-2
DZ,CH,2000.0,1,1,0
SG,NP,2013.0,1,2,-1
AM,UA,2019.0,1,2,-1
TG,BF,2013.0,1,2,-1
IQ,NL,2018.0,1,5,-4
CO,UA,2017.0,1,1,0
OM,KW,2016.0,1,2,-1
RO,IL,2016.0,2,1,1
KE,CD,2022.0,2,2,0
PR,US,2003.0,1,2,-1
BJ,CI,2017.0,2,1,1
LT,IT,2015.0,3,1,2
TW,MN,2022.0,1,1,0
FI,SK,2021.0,1,2,-1
PK,TW,2013.0,1,3,-2
CU,IT,2007.0,2,4,-2
PA,AR,2008.0,1,3,-2
FI,BG,2017.0,1,1,0
PT,JP,2004.0,1,2,-1
BR,KN,2020.0,1,2,-1
AE,TR,2023.0,1,1,0
SK,nan,2020.0,2,1,1
DK,CZ,2015.0,2,7,-5
GA,CM,2018.0,1,6,-5
LR,US,2008.0,1,1,0
ZW,IN,2017.0,1,4,-3
PK,CN,2024.0,1,2,-1
KZ,PK,2018.0,1,1,0
MA,CN,2008.0,1,1,0
CY,IT,2010.0,1,2,-1
TW,NZ,2000.0,1,1,0
RO,MC,2017.0,1,1,0
UG,FI,2011.0,1,1,0
VN,CH,2011.0,2,3,-1
RO,LT,2001.0,1,3,-2
ZA,MA,2018.0,1,1,0
KW,TN,2019.0,1,1,0
CN,XK,2018.0,1,1,0
CA,DZ,1999.0,1,1,0
nan,SA,2008.0,1,2,-1
SY,MA,2017.0,1,1,0
PR,AR,2011.0,1,1,0
GA,US,1999.0,1,1,0
KW,SD,2011.0,1,1,0
TW,PK,2003.0,1,2,-1
IN,CL,2011.0,2,3,-1
TT,IN,2007.0,1,3,-2
KR,AM,2018.0,1,2,-1
RS,BA,2002.0,1,2,-1
CU,CH,2007.0,1,2,-1
SN,JP,2013.0,1,4,-3
QA,HR,2021.0,1,1,0
SD,IN,2012.0,1,2,-1
IL,ET,2011.0,1,2,-1
BO,DE,2012.0,1,1,0
YE,DE,2017.0,1,1,0
YE,DE,2010.0,1,1,0
TR,JP,2023.0,1,1,0
QA,FI,2020.0,1,1,0
KR,PS,2020.0,1,1,0
ES,DZ,2000.0,1,1,0
DK,TR,2004.0,1,1,0
BE,NO,2004.0,2,3,-1
CR,NL,2019.0,3,3,0
MA,FI,2021.0,3,1,2
PE,SE,2008.0,2,1,1
MD,NL,2017.0,1,1,0
CA,OM,2002.0,2,2,0
SI,GB,1998.0,1,3,-2
CL,BE,1999.0,1,1,0
DE,SY,2021.0,1,4,-3
DE,CI,2003.0,1,1,0
SE,KW,2004.0,1,1,0
GR,PL,2021.0,1,1,0
IL,DK,2008.0,1,3,-2
US,AZ,2007.0,1,1,0
BA,PL,2018.0,1,3,-2
TW,GR,2017.0,1,3,-2
LB,MA,2021.0,1,1,0
BJ,CI,2019.0,1,3,-2
VN,AT,2022.0,1,1,0
NZ,IR,2004.0,1,1,0
UA,MX,1997.0,1,1,0
AU,PT,1998.0,1,3,-2
RS,BG,2014.0,1,2,-1
IE,TW,1999.0,2,0,2
MS,GB,2000.0,3,0,3
DZ,TW,2005.0,1,0,1
GR,PS,2016.0,2,0,2
CH,RO,1999.0,1,0,1
MN,NL,2014.0,1,0,1
GR,SD,2020.0,1,0,1
KE,PK,2001.0,2,0,2
AT,MN,2019.0,1,0,1
FR,NI,2012.0,1,0,1
IT,BI,2022.0,1,0,1
AT,BF,2021.0,1,0,1
JO,TH,2007.0,1,0,1
RE,CL,2015.0,1,0,1
ZW,TZ,2004.0,1,0,1
PE,AZ,2018.0,1,0,1
SG,RU,1998.0,1,0,1
IE,KW,2013.0,1,0,1
GP,IN,2016.0,1,0,1
AM,GR,2017.0,1,0,1
MX,KN,2010.0,2,0,2
AT,LI,2010.0,2,0,2
MR,SN,2017.0,1,0,1
YE,SD,2013.0,1,0,1
CG,RW,2021.0,1,0,1
LY,ET,2015.0,1,0,1
NP,SA,2022.0,1,0,1
NG,IS,2022.0,1,0,1
PG,,2004.0,2,0,2
JP,BF,2012.0,1,0,1
RO,RS,2001.0,3,0,3
CR,PH,2001.0,1,0,1
ES,PG,2002.0,1,0,1
EC,DO,2012.0,1,0,1
TR,BE,2023.0,1,0,1
,TL,2009.0,1,0,1
AT,DO,2002.0,1,0,1
HN,PT,2018.0,1,0,1
ZW,KE,2022.0,2,0,2
PK,LT,2013.0,2,0,2
FI,JM,2007.0,1,0,1
YE,OM,2005.0,1,0,1
ES,TH,2011.0,1,0,1
TM,,2002.0,2,0,2
KZ,FR,2009.0,1,0,1
MW,SL,2020.0,1,0,1
NO,NC,2017.0,1,0,1
BB,NZ,2011.0,1,0,1
SN,BF,2002.0,1,0,1
DK,SD,2000.0,1,0,1
BM,,2015.0,4,0,4
TN,CZ,2013.0,1,0,1
SI,MK,1997.0,1,0,1
RU,TM,2000.0,3,0,3
BG,MK,2001.0,1,0,1
PL,VI,2009.0,1,0,1
EG,TW,2001.0,2,0,2
GD,CN,2020.0,1,0,1
IT,BF,2011.0,1,0,1
KR,RO,2006.0,1,0,1
TR,IR,2005.0,2,0,2
KH,US,2002.0,2,0,2
IL,SK,2007.0,1,0,1
PL,LV,1999.0,1,0,1
EG,IQ,2008.0,1,0,1
LU,LT,2014.0,1,0,1
ZW,MW,2006.0,1,0,1
ES,BB,2017.0,1,0,1
MA,JM,2018.0,2,0,2
PE,DZ,2017.0,1,0,1
UG,IS,2011.0,1,0,1
AM,GR,2010.0,1,0,1
KW,NZ,2008.0,1,0,1
MX,GE,2007.0,1,0,1
TR,AR,2015.0,1,0,1
PK,CM,2014.0,2,0,2
FR,LV,2015.0,3,0,3
BG,nan,2002.0,1,0,1
TR,SI,2022.0,1,0,1
MA,BF,2011.0,1,0,1
,SC,2014.0,1,0,1
DK,RS,1998.0,1,0,1
BR,EE,2014.0,1,0,1
JP,ZW,2013.0,1,0,1
JO,ES,2003.0,1,0,1
SZ,,2006.0,2,0,2
ZM,BE,2015.0,2,0,2
AU,NG,2002.0,1,0,1
DO,TR,2004.0,1,0,1
ZA,RU,2005.0,1,0,1
GB,GY,2014.0,1,0,1
BZ,GB,2022.0,1,0,1
ET,ER,2008.0,1,0,1
TW,DZ,2019.0,2,0,2
ES,HR,1998.0,1,0,1
FR,GM,2017.0,1,0,1
JP,MM,2000.0,1,0,1
SG,QA,2011.0,1,0,1
MU,BE,2007.0,1,0,1
DK,UY,2019.0,1,0,1
TN,ES,2002.0,2,0,2
KZ,CZ,2012.0,1,0,1
nan,RW,2020.0,1,0,1
ZM,NL,2017.0,2,0,2
SL,CA,2022.0,2,0,2
NZ,GE,2011.0,1,0,1
ES,TZ,2001.0,1,0,1
UZ,AU,2008.0,1,0,1
SD,QA,2016.0,2,0,2
US,MQ,2021.0,1,0,1
CM,KR,2004.0,1,0,1
AE,TW,2003.0,1,0,1
BE,KZ,2016.0,1,0,1
MY,PL,2023.0,2,0,2
DE,NA,2008.0,1,0,1
AL,JP,2007.0,1,0,1
GT,,2005.0,2,0,2
MM,CZ,2010.0,1,0,1
CM,RE,2006.0,1,0,1
TR,EE,2018.0,2,0,2
ZA,SC,2015.0,1,0,1
JP,PA,2002.0,1,0,1
BO,CU,2016.0,2,0,2
DE,GD,2016.0,1,0,1
CU,MZ,2019.0,1,0,1
AM,UA,2017.0,1,0,1
IE,UG,2014.0,1,0,1
JO,TN,2012.0,1,0,1
BW,DE,2006.0,1,0,1
GR,EC,2017.0,1,0,1
MR,SN,2019.0,2,0,2
BE,CI,2007.0,1,0,1
BT,IT,2021.0,1,0,1
SA,AZ,2013.0,1,0,1
HR,MM,2018.0,1,0,1
KE,ER,2019.0,1,0,1
GE,GR,2014.0,1,0,1
UY,GR,2007.0,1,0,1
BF,FI,2012.0,1,0,1
SE,VE,2006.0,1,0,1
WS,,2008.0,2,0,2
LT,ZA,2016.0,1,0,1
UA,CZ,2023.0,1,0,1
JP,LY,2000.0,2,0,2
RU,SJ,2020.0,1,0,1
IN,ZW,2015.0,2,0,2
KW,KR,2021.0,1,0,1
BI,CH,1998.0,1,0,1
AE,PL,2003.0,1,0,1
LB,GH,2021.0,1,0,1
KG,RU,2012.0,2,0,2
RU,VG,2010.0,1,0,1
DZ,EC,2019.0,1,0,1
ZA,PS,2019.0,1,0,1
RS,CY,2015.0,2,0,2
NI,CZ,2014.0,1,0,1
GN,FR,1999.0,1,0,1
ML,BJ,2020.0,1,0,1
GB,CG,2014.0,1,0,1
TW,CL,1999.0,1,0,1
CG,ZW,2000.0,1,0,1
MD,SA,2013.0,1,0,1
AZ,AT,2019.0,1,0,1
ZA,SK,2005.0,1,0,1
CA,TN,1998.0,1,0,1
SI,DK,2005.0,1,0,1
LB,IE,2006.0,1,0,1
US,MH,2018.0,1,0,1
RE,SE,2014.0,1,0,1
GR,LT,2008.0,1,0,1
IT,NI,2006.0,1,0,1
BE,BO,2009.0,1,0,1
PH,VN,2016.0,1,0,1
HU,GR,2003.0,1,0,1
BI,,2000.0,1,0,1
SV,VE,2017.0,1,0,1
BN,SD,2010.0,1,0,1
SY,DE,2002.0,1,0,1
SJ,nan,2006.0,1,0,1
NI,CH,2020.0,1,0,1
RO,HR,2010.0,2,0,2
nan,ZW,2002.0,1,0,1
LK,CZ,2021.0,1,0,1
IL,MA,2004.0,1,0,1
BF,AE,2021.0,1,0,1
IL,PS,1998.0,1,0,1
AE,KR,2015.0,1,0,1
BW,CM,2006.0,1,0,1
PS,SA,2012.0,1,0,1
IL,KZ,2014.0,1,0,1
GR,IR,2008.0,1,0,1
IR,MM,2020.0,1,0,1
US,MC,1999.0,1,0,1
LT,HR,2015.0,1,0,1
BI,RW,2014.0,1,0,1
US,JE,2003.0,1,0,1
SG,IT,2001.0,1,0,1
EG,NA,2005.0,1,0,1
GD,KR,2022.0,1,0,1
YE,TW,2021.0,1,0,1
KZ,GE,2017.0,1,0,1
CZ,XK,2018.0,1,0,1
AE,ET,2017.0,1,0,1
PT,CR,2007.0,1,0,1
AU,BW,2017.0,1,0,1
IL,FI,1997.0,1,0,1
NO,FO,2009.0,1,0,1
UG,BF,2018.0,1,0,1
NZ,PH,2006.0,1,0,1
PS,SE,2010.0,1,0,1
NZ,EC,2021.0,1,0,1
BF,CZ,2016.0,1,0,1
TZ,ER,2016.0,1,0,1
GP,DE,2014.0,1,0,1
BN,TW,2021.0,1,0,1
MZ,ES,2022.0,1,0,1
TH,IS,2010.0,1,0,1
YE,SA,2003.0,1,0,1
MT,KE,2019.0,1,0,1
AT,LV,2018.0,1,0,1
MM,FI,2019.0,1,0,1
CZ,NP,2020.0,1,0,1
MY,CZ,2003.0,1,0,1
BR,CA,2008.0,185,243,-58
CY,TR,2019.0,77,84,-7
CH,DE,2003.0,369,479,-110
PK,IN,2015.0,226,239,-13
AU,CA,2006.0,230,233,-3
DE,EE,2022.0,32,20,12
GB,HU,2006.0,34,34,0
IN,US,2000.0,648,538,110
US,CO,2008.0,161,157,4
CO,ES,2004.0,133,123,10
CA,NZ,2010.0,60,70,-10
US,JP,2012.0,1840,1627,213
GB,US,1999.0,3092,3288,-196
AT,BR,2010.0,7,7,0
AT,BR,2017.0,16,21,-5
MX,CL,2009.0,109,102,7
US,KR,2011.0,1324,1170,154
GB,DE,2002.0,425,452,-27
US,CH,2000.0,400,471,-71
US,AR,2020.0,269,285,-16
CN,US,2020.0,5032,6423,-1391
CN,TW,2005.0,578,1096,-518
SG,US,2016.0,490,451,39
PT,BR,2008.0,488,569,-81
CN,TW,2002.0,563,816,-253
ES,HU,2009.0,5,6,-1
BR,CN,2015.0,56,70,-14
CA,NZ,2017.0,73,72,1
NL,PL,2018.0,21,19,2
US,BR,2021.0,935,1214,-279
FI,US,2005.0,126,112,14
ZA,CA,2012.0,38,41,-3
US,FR,2002.0,890,1026,-136
KR,CN,2008.0,271,217,54
NZ,US,2019.0,467,434,33
TR,US,2018.0,525,449,76
DE,CL,2014.0,65,40,25
CA,CN,2002.0,238,211,27
CA,CN,2005.0,354,280,74
AR,ES,2011.0,296,306,-10
TW,CN,2004.0,1006,622,384
US,TZ,1999.0,5,2,3
JP,CH,2001.0,43,42,1
nan,CN,2014.0,126,135,-9
ZA,NO,2009.0,5,3,2
PH,ES,2011.0,14,12,2
AU,FR,2000.0,40,58,-18
IN,AU,2007.0,68,48,20
SA,DE,2010.0,4,20,-16
US,IT,2016.0,965,1155,-190
IT,PL,1999.0,6,6,0
CA,PL,2015.0,36,32,4
SE,IT,1998.0,61,45,16
AU,TH,2014.0,36,24,12
IL,GB,2004.0,40,33,7
VE,FR,2014.0,9,6,3
US,HR,2017.0,42,51,-9
GB,MY,2020.0,148,117,31
IT,GB,2011.0,501,334,167
CL,CO,2018.0,244,307,-63
DE,LV,2007.0,5,2,3
AR,CL,2020.0,107,122,-15
GB,DE,2005.0,493,612,-119
AR,AU,2004.0,6,3,3
IT,ID,2019.0,15,17,-2
IE,FR,2019.0,34,44,-10
GB,IN,2001.0,121,131,-10
PH,US,2016.0,441,371,70
IT,NL,2010.0,114,74,40
CH,IT,2009.0,135,248,-113
KR,ET,2010.0,101,139,-38
AU,GB,2021.0,1076,1088,-12
IR,AU,2018.0,178,89,89
CY,TR,2017.0,50,81,-31
TR,CY,2018.0,91,51,40
AE,SA,2023.0,2,2,0
DK,GW,2010.0,2,5,-3
AU,MX,2019.0,18,15,3
KR,ET,2017.0,94,120,-26
SG,JP,2017.0,62,39,23
ID,MY,2009.0,23,27,-4
GB,PT,2021.0,92,80,12
CA,IT,2011.0,80,80,0
GB,ID,2016.0,86,16,70
US,BD,2017.0,119,195,-76
SG,BN,2020.0,2,3,-1
DE,FI,2010.0,35,68,-33
CO,US,2012.0,237,276,-39
MA,FR,2012.0,245,298,-53
NL,IR,2018.0,44,52,-8
BR,NL,2003.0,19,21,-2
UA,IT,2003.0,8,7,1
IN,KR,2018.0,229,178,51
DE,IN,2019.0,197,257,-60
US,EG,2022.0,181,218,-37
GB,IE,2000.0,117,113,4
ES,VE,2007.0,63,84,-21
KR,SG,2017.0,44,36,8
DE,IN,2017.0,201,229,-28
GB,CH,1998.0,86,93,-7
AR,CO,2008.0,43,42,1
GB,ZA,2014.0,193,125,68
JP,GB,2015.0,279,359,-80
CL,UY,2008.0,5,12,-7
RS,AU,2014.0,10,13,-3
GB,BR,2000.0,74,39,35
CO,PE,2019.0,170,92,78
ES,GB,2011.0,316,365,-49
AU,DE,2004.0,111,138,-27
HK,US,2019.0,18,10,8
US,AE,2017.0,79,82,-3
NL,PH,2009.0,4,4,0
NO,US,2010.0,128,140,-12
CH,GB,2021.0,265,295,-30
RU,DE,2009.0,176,115,61
CA,IE,2000.0,39,38,1
EG,NO,2008.0,2,3,-1
IE,SA,2009.0,2,1,1
JP,IT,2020.0,48,55,-7
GB,CN,2001.0,233,179,54
HU,NL,2014.0,18,15,3
BE,DE,2014.0,132,116,16
IR,US,2010.0,249,198,51
DK,US,2022.0,168,180,-12
BE,CN,2019.0,62,62,0
DE,IN,2010.0,122,162,-40
IE,US,2012.0,478,469,9
BD,US,2013.0,98,85,13
MY,IT,2000.0,14,26,-12
AT,EG,2009.0,3,2,1
ET,KR,2000.0,74,44,30
BE,CA,2016.0,79,60,19
CA,KR,2016.0,63,68,-5
JP,RO,2015.0,5,5,0
GB,LK,2019.0,43,28,15
DE,FI,2017.0,62,77,-15
CA,SG,2014.0,50,44,6
ID,FR,2004.0,2,6,-4
MY,RU,2017.0,28,15,13
RU,US,2018.0,527,637,-110
FR,PL,2012.0,45,31,14
RO,FR,1998.0,8,10,-2
IL,ES,2017.0,11,17,-6
HU,DE,2020.0,72,48,24
ID,ZA,2019.0,164,92,72
ES,CA,2012.0,77,69,8
NZ,US,2010.0,306,392,-86
AU,SG,2020.0,139,165,-26
CN,GE,2020.0,3,6,-3
IT,JP,2000.0,26,33,-7
DE,NO,2016.0,127,85,42
FR,NO,2018.0,76,82,-6
nan,BR,2013.0,86,80,6
US,BD,2019.0,149,257,-108
EG,BH,2018.0,12,5,7
FR,NL,2006.0,155,161,-6
CN,IE,2009.0,46,33,13
KR,GB,2001.0,36,41,-5
CN,MX,2003.0,5,6,-1
FR,AT,1998.0,19,14,5
GB,LK,2017.0,26,21,5
ZW,CN,2004.0,2,1,1
BE,CN,2010.0,52,72,-20
IQ,AE,2015.0,3,5,-2
UA,CN,2014.0,28,15,13
EG,AE,2001.0,3,5,-2
US,FR,2005.0,983,1070,-87
CN,TH,2020.0,59,60,-1
CL,BR,2016.0,111,102,9
ES,BO,2021.0,14,13,1
SA,DE,2017.0,23,45,-22
CO,SV,2019.0,5,7,-2
DE,EG,2015.0,78,51,27
US,LT,2007.0,11,6,5
CA,ES,2022.0,47,59,-12
CD,CN,2017.0,1,4,-3
AM,RU,2010.0,6,8,-2
CN,CH,2007.0,47,40,7
AM,RU,2017.0,17,11,6
GB,BD,2011.0,46,49,-3
GF,FR,2017.0,15,24,-9
AT,BR,2019.0,11,30,-19
BA,HR,2018.0,50,46,4
IE,FR,2010.0,34,39,-5
PL,NL,2018.0,19,21,-2
NG,ZA,2020.0,134,134,0
NP,GB,2019.0,14,11,3
ZA,NZ,2008.0,12,6,6
NO,US,2017.0,152,196,-44
ZA,GB,2014.0,125,193,-68
US,CL,2022.0,141,150,-9
GB,BE,2008.0,116,103,13
PT,ES,2013.0,129,202,-73
TW,MY,2011.0,19,10,9
GB,SE,2022.0,107,105,2
nan,AT,2014.0,16,20,-4
GR,GB,2012.0,212,188,24
FR,UY,2017.0,10,4,6
EG,IT,2006.0,3,9,-6
IE,FR,2017.0,26,40,-14
FI,SE,2015.0,103,105,-2
JP,TW,2015.0,80,91,-11
UG,TZ,2017.0,4,3,1
ZA,DE,2008.0,35,37,-2
FR,IN,2022.0,74,70,4
PE,BR,2007.0,16,15,1
PT,IN,2016.0,14,16,-2
JP,IR,2021.0,8,14,-6
nan,UA,1999.0,11,13,-2
IR,RU,2018.0,12,10,2
GB,KR,2013.0,99,90,9
TH,CN,2021.0,47,60,-13
KE,JP,2011.0,5,8,-3
BE,BR,2014.0,79,60,19
US,JO,2020.0,68,63,5
UA,IL,2017.0,7,4,3
CL,DE,2020.0,56,56,0
CN,SA,2016.0,46,26,20
IR,CN,2021.0,66,47,19
IT,NL,2019.0,147,106,41
NL,CH,2021.0,108,113,-5
KR,SG,2019.0,52,44,8
DE,IR,2017.0,85,111,-26
GB,AT,2007.0,50,60,-10
JP,PH,2006.0,18,15,3
BE,IE,2000.0,4,2,2
EG,IQ,2013.0,8,8,0
nan,AR,2018.0,47,46,1
JP,NL,2021.0,22,25,-3
IL,AU,2007.0,13,18,-5
DZ,CA,2011.0,7,8,-1
SK,BA,2021.0,2,1,1
GR,DE,2012.0,75,55,20
NO,PL,2018.0,17,13,4
IN,CH,2006.0,30,14,16
nan,RU,2012.0,66,37,29
FI,FR,2021.0,15,21,-6
SI,US,2014.0,20,22,-2
DE,NP,2018.0,5,4,1
FR,MY,2011.0,10,8,2
IQ,RU,2018.0,3,6,-3
CA,IN,2011.0,154,192,-38
CA,US,2023.0,96,84,12
BY,US,1998.0,16,2,14
ES,NI,2013.0,4,1,3
GB,SA,2020.0,226,81,145
IR,AT,2015.0,7,8,-1
ID,US,2003.0,15,22,-7
BR,IL,2017.0,12,13,-1
AU,NZ,2016.0,169,208,-39
PL,IE,2011.0,10,12,-2
HK,US,2010.0,11,20,-9
DK,SE,2002.0,48,55,-7
SE,LT,2018.0,4,9,-5
DE,ZA,2017.0,55,69,-14
PL,CA,2010.0,27,22,5
DE,IQ,2018.0,13,7,6
NP,GB,2010.0,6,8,-2
CH,CL,2013.0,14,13,1
RU,SK,2006.0,10,5,5
GM,US,2015.0,2,1,1
SA,DE,2019.0,26,42,-16
SE,nan,2010.0,52,50,2
CN,IN,2016.0,104,197,-93
SI,AT,2015.0,18,16,2
DE,UA,2002.0,26,30,-4
IN,TW,2017.0,65,43,22
GB,AE,2014.0,30,27,3
TW,GB,2015.0,57,62,-5
BR,TR,2004.0,17,6,11
CZ,KR,2015.0,11,10,1
IN,TW,2010.0,40,25,15
nan,BE,2022.0,11,13,-2
KE,ZA,2021.0,22,25,-3
ES,IN,2009.0,19,22,-3
KW,SA,2020.0,38,31,7
US,HR,2019.0,56,41,15
RU,TJ,2023.0,9,10,-1
AU,ET,2020.0,17,23,-6
IT,ID,2017.0,22,5,17
NL,MY,2012.0,7,3,4
IE,NO,2018.0,4,7,-3
nan,PE,2014.0,6,10,-4
IN,ID,2021.0,78,91,-13
DE,LB,2015.0,9,5,4
ES,AT,2014.0,35,18,17
SA,US,2012.0,83,165,-82
KR,ET,2019.0,98,119,-21
AT,GR,2011.0,3,10,-7
IN,IR,2009.0,28,24,4
ES,GT,2013.0,14,5,9
CH,NL,2015.0,107,125,-18
US,BD,2010.0,84,62,22
NO,PE,2020.0,1,1,0
FI,US,2002.0,109,120,-11
CA,JM,2017.0,3,3,0
GB,CH,1997.0,70,83,-13
FR,RE,2022.0,31,26,5
CA,NZ,2019.0,74,79,-5
KR,SG,2010.0,32,33,-1
MY,OM,2019.0,20,9,11
NG,SA,2017.0,7,12,-5
AU,IQ,2020.0,43,22,21
GB,HR,2021.0,15,13,2
KR,FI,2020.0,9,4,5
TN,AE,2015.0,6,1,5
IT,NL,2017.0,144,95,49
IT,KR,2016.0,13,7,6
CZ,EE,2020.0,3,2,1
GB,BN,2002.0,1,1,0
IS,SE,2000.0,10,10,0
AU,MX,2017.0,13,21,-8
RU,IL,2000.0,19,14,5
CY,TR,2010.0,8,20,-12
IT,BE,2022.0,100,100,0
CA,JM,2019.0,2,3,-1
CO,CN,2011.0,5,4,1
MX,IL,2017.0,6,3,3
CH,CN,2007.0,40,47,-7
NG,RU,2019.0,3,1,2
SE,SG,2013.0,13,10,3
BE,CN,2017.0,71,64,7
NG,SA,2019.0,25,21,4
EE,DE,2012.0,28,48,-20
BR,IN,2007.0,14,20,-6
BE,GB,2003.0,76,60,16
PK,PH,2017.0,2,2,0
TR,FR,2022.0,14,12,2
BE,ES,2006.0,31,20,11
PT,IT,2015.0,37,33,4
FR,CZ,2022.0,29,13,16
PL,RU,2009.0,12,38,-26
CH,FI,2008.0,14,13,1
US,BE,2000.0,129,163,-34
JM,TT,2012.0,13,15,-2
CH,LK,2021.0,1,1,0
EG,JP,2020.0,49,54,-5
KE,NL,2012.0,15,8,7
PK,ZA,2018.0,7,5,2
AR,ID,2022.0,1,3,-2
KR,TH,2020.0,21,14,7
DE,FI,2019.0,86,76,10
RS,CN,2020.0,3,3,0
AM,RU,2019.0,30,23,7
KR,SE,2022.0,10,5,5
KW,EG,1999.0,5,8,-3
SG,JP,2019.0,41,42,-1
FR,PE,2018.0,17,16,1
UG,KE,2021.0,17,8,9
FR,GP,2022.0,21,9,12
PT,VE,2019.0,5,5,0
KR,VN,2021.0,95,68,27
BE,PT,2022.0,7,15,-8
IR,FR,2019.0,56,40,16
VE,MX,2016.0,61,32,29
FR,SN,2020.0,40,34,6
IN,IL,2022.0,61,46,15
IT,IN,2006.0,49,41,8
CA,SA,2014.0,118,55,63
UY,BR,2018.0,56,71,-15
NO,CN,2013.0,42,28,14
ML,BF,2009.0,4,4,0
RU,IR,2005.0,21,2,19
PT,GB,2016.0,133,98,35
TW,ET,2020.0,8,4,4
RU,FR,2009.0,71,49,22
TW,PK,2001.0,1,1,0
AT,ES,2021.0,31,31,0
IR,BR,2015.0,18,6,12
GB,CL,2021.0,49,57,-8
CH,nan,2021.0,14,19,-5
ET,IT,2022.0,5,4,1
nan,JP,2013.0,45,35,10
TR,IN,2018.0,19,23,-4
PK,BD,2015.0,45,49,-4
CA,AR,2006.0,10,15,-5
US,RO,2018.0,96,102,-6
IT,ID,2010.0,7,1,6
RU,MZ,2010.0,13,30,-17
CL,NL,2011.0,8,3,5
CA,JP,2021.0,63,82,-19
IQ,MY,2022.0,33,50,-17
NL,CZ,2014.0,21,13,8
CH,DK,2011.0,36,28,8
SG,BR,2002.0,1,2,-1
SK,CH,2015.0,15,3,12
CH,PK,2014.0,19,18,1
ZA,PL,2009.0,4,1,3
MA,EG,2016.0,14,5,9
CA,ZA,2008.0,20,20,0
RS,CH,2013.0,9,7,2
CH,RS,2015.0,11,15,-4
PH,SG,2008.0,5,4,1
FR,UA,2014.0,12,13,-1
IT,AT,2009.0,50,26,24
AE,CA,2015.0,15,28,-13
OM,DE,2009.0,1,4,-3
US,AE,2019.0,130,95,35
BG,IT,2004.0,7,4,3
IT,BG,2007.0,11,7,4
RU,GE,2011.0,4,4,0
TN,OM,2016.0,3,4,-1
FR,RS,2016.0,10,13,-3
PL,CA,2019.0,40,35,5
HU,RO,2007.0,21,18,3
JP,ES,2021.0,30,22,8
MQ,FR,2013.0,10,19,-9
CZ,GB,2011.0,40,44,-4
NZ,NP,2014.0,25,28,-3
AE,ZA,2013.0,2,4,-2
PK,IT,2020.0,10,14,-4
ES,IR,2016.0,16,18,-2
ZA,FR,2010.0,29,35,-6
DE,ZA,2019.0,67,68,-1
IT,MZ,2019.0,2,1,1
TH,SG,2020.0,9,7,2
SG,HK,2018.0,2,3,-1
ES,CH,2012.0,89,82,7
DE,NG,2012.0,14,6,8
NL,TR,2020.0,36,37,-1
CN,NZ,2011.0,24,36,-12
ZA,NL,2003.0,17,11,6
ID,TW,2015.0,17,25,-8
GB,BB,2017.0,3,1,2
IR,KR,2014.0,23,8,15
LT,CH,2018.0,3,3,0
IR,FR,2017.0,35,32,3
GB,LK,2010.0,19,14,5
RU,CL,2019.0,2,6,-4
PL,IL,2020.0,15,4,11
AT,LI,2018.0,3,2,1
CO,DK,2012.0,1,1,0
US,MV,2018.0,2,1,1
ES,TR,2021.0,13,12,1
QA,CN,2007.0,5,15,-10
MK,HR,2019.0,3,1,2
CU,VE,2017.0,9,9,0
NO,FR,2016.0,73,64,9
IS,nan,2016.0,2,1,1
VN,SG,2015.0,5,16,-11
DK,SE,2005.0,68,73,-5
US,AE,2010.0,51,37,14
CZ,FR,2018.0,33,47,-14
RU,KG,2022.0,6,7,-1
ZA,CN,2016.0,26,11,15
GH,CA,2022.0,10,7,3
KR,JP,2000.0,96,126,-30
GB,PA,2017.0,11,9,2
AE,nan,2018.0,8,2,6
ID,IR,2020.0,19,40,-21
RU,nan,2001.0,11,6,5
SE,IT,1997.0,45,25,20
BE,AU,2021.0,26,31,-5
KR,PK,2016.0,41,35,6
NO,PT,2012.0,6,5,1
RU,MZ,2019.0,11,17,-6
FR,VN,2022.0,26,22,4
HK,NL,2014.0,13,16,-3
NZ,nan,2013.0,1,7,-6
SE,CA,1997.0,19,15,4
US,FJ,2015.0,2,2,0
HR,CH,2012.0,6,6,0
FR,PH,2019.0,11,9,2
IE,AU,2001.0,34,33,1
RU,MD,2013.0,5,8,-3
US,BF,2017.0,4,4,0
IN,NO,1997.0,13,17,-4
MY,SD,2014.0,10,9,1
CA,MX,2016.0,39,39,0
AU,VN,2014.0,26,16,10
SK,CZ,1999.0,26,21,5
BW,ZW,2012.0,1,4,-3
TR,KW,2018.0,13,7,6
KR,IL,2018.0,7,4,3
SG,JP,2010.0,36,39,-3
DE,LU,2007.0,36,7,29
PK,SA,2013.0,62,29,33
GR,ID,2021.0,4,2,2
VE,CO,2003.0,16,12,4
DE,JO,2009.0,10,9,1
VE,CR,2007.0,1,3,-2
CZ,GR,2005.0,2,8,-6
NI,MX,2019.0,4,8,-4
CL,HU,2017.0,1,1,0
FR,QA,2017.0,15,10,5
NL,NZ,2019.0,21,13,8
IQ,IN,2022.0,11,9,2
EC,AR,2020.0,46,52,-6
SA,SD,2020.0,21,56,-35
FI,ES,2000.0,6,4,2
GB,NP,2018.0,9,12,-3
ZA,HU,2008.0,1,1,0
FR,GE,2020.0,2,2,0
PL,UA,2000.0,8,9,-1
EG,FR,2011.0,24,27,-3
GB,TR,2004.0,43,30,13
nan,TW,2020.0,6,2,4
RU,CL,2010.0,4,3,1
SE,EG,2022.0,5,3,2
CL,CA,2006.0,12,16,-4
AU,PH,2018.0,19,28,-9
DE,LK,2014.0,2,2,0
TH,BD,2018.0,5,2,3
DE,MN,2016.0,3,1,2
TH,PK,2019.0,10,4,6
MY,FR,2015.0,8,11,-3
CO,PE,2010.0,24,27,-3
MW,GB,2022.0,14,9,5
OM,UA,2020.0,3,3,0
LB,CN,2022.0,12,34,-22
PL,LT,2021.0,5,8,-3
DK,AU,2012.0,52,42,10
AU,RU,2016.0,53,21,32
GB,CZ,2015.0,48,54,-6
ZA,FR,2019.0,36,32,4
US,CM,2014.0,18,9,9
AR,CU,2001.0,4,7,-3
IE,MY,2015.0,12,2,10
NP,KR,2014.0,6,7,-1
RS,US,2014.0,62,75,-13
CH,ID,2020.0,12,7,5
PT,nan,1999.0,6,5,1
LT,GB,2007.0,5,5,0
US,IS,2006.0,27,11,16
BE,CZ,2018.0,17,14,3
AL,GB,2016.0,1,3,-2
HU,JP,2006.0,7,10,-3
CN,CZ,2001.0,7,9,-2
ID,IL,2021.0,4,5,-1
KE,DE,2011.0,9,17,-8
ZA,AU,2023.0,6,4,2
LK,GB,2019.0,28,43,-15
TW,SG,2001.0,16,14,2
ZW,GB,1999.0,9,5,4
IR,MA,2020.0,14,8,6
IL,ES,2019.0,16,15,1
TR,JP,2000.0,37,27,10
US,HR,2010.0,44,40,4
TH,PK,2017.0,6,7,-1
MU,CA,2011.0,2,1,1
BE,CM,2017.0,4,4,0
SG,LK,2013.0,3,1,2
AT,SI,2021.0,6,10,-4
UA,BY,2008.0,6,7,-1
AT,NO,2012.0,9,6,3
RO,ES,2009.0,9,10,-1
FR,ID,1998.0,8,3,5
IE,BE,2013.0,13,7,6
GB,GM,2005.0,8,10,-2
PL,CZ,2023.0,5,4,1
LK,AT,2016.0,1,1,0
IR,SE,2006.0,3,9,-6
GB,MT,2015.0,19,9,10
RS,PT,2018.0,2,3,-1
HU,MA,2010.0,3,3,0
CM,FR,1998.0,7,3,4
FR,QA,2019.0,14,7,7
US,KE,2006.0,25,35,-10
IL,ES,2010.0,12,15,-3
IR,AZ,2005.0,2,1,1
PL,DK,2001.0,5,1,4
SE,CA,1998.0,20,26,-6
AU,AR,2003.0,4,7,-3
TZ,KE,2007.0,2,2,0
SA,NZ,2015.0,2,3,-1
DE,IR,2010.0,40,45,-5
GF,FR,2019.0,17,28,-11
BD,CH,2011.0,2,4,-2
nan,CM,2020.0,16,6,10
BY,UA,1998.0,2,1,1
IT,HU,2009.0,13,16,-3
CZ,IT,2005.0,15,17,-2
IN,DK,2013.0,13,19,-6
CM,IN,2020.0,3,5,-2
NZ,DE,2015.0,44,37,7
NP,nan,2017.0,5,1,4
GB,LA,2016.0,1,1,0
MY,NG,2004.0,4,1,3
CL,CH,2020.0,10,13,-3
EG,LB,2011.0,4,4,0
TN,BH,2021.0,4,1,3
TZ,CH,2013.0,4,4,0
DK,UY,2018.0,2,1,1
RO,HU,2006.0,25,16,9
SS,GB,1998.0,5,5,0
DE,CU,2000.0,3,1,2
IR,FR,2010.0,20,36,-16
BE,PL,2002.0,11,14,-3
DK,TR,2014.0,7,6,1
RU,FI,2018.0,37,40,-3
CO,DE,2012.0,25,10,15
CA,JO,1997.0,1,1,0
US,MM,2019.0,22,4,18
BE,PL,2005.0,6,14,-8
CZ,US,1997.0,32,41,-9
DK,ES,2002.0,16,22,-6
ES,PH,2003.0,6,4,2
NP,AU,2005.0,2,2,0
JP,LK,2008.0,18,22,-4
CA,VE,2017.0,2,1,1
NO,VN,2022.0,4,2,2
IN,BD,2001.0,10,9,1
US,TT,2011.0,7,7,0
JP,MN,2007.0,2,1,1
KE,CA,2014.0,9,7,2
DK,EG,1998.0,6,2,4
GB,TW,1997.0,13,9,4
BE,AR,2015.0,5,5,0
CZ,US,1998.0,42,41,1
LK,GB,2010.0,14,19,-5
AU,MX,2010.0,8,16,-8
CZ,nan,2017.0,9,5,4
AE,US,2004.0,13,30,-17
BE,IN,2021.0,29,46,-17
CN,UA,2021.0,21,27,-6
FR,VE,2013.0,7,8,-1
GB,ET,2004.0,4,4,0
EE,CH,2012.0,6,18,-12
NL,CR,2013.0,1,1,0
VE,ID,2015.0,2,1,1
PH,AU,2002.0,8,4,4
CZ,nan,2019.0,10,8,2
CU,VE,2010.0,8,13,-5
TR,DE,2000.0,12,10,2
TR,EE,2017.0,2,1,1
FI,IT,2003.0,6,4,2
KE,AR,2014.0,1,1,0
HR,AT,2002.0,3,2,1
AU,CZ,2004.0,2,3,-1
FI,UA,2007.0,3,2,1
AT,CZ,2000.0,12,2,10
CZ,AU,2022.0,6,5,1
US,SD,2017.0,5,8,-3
US,SD,2019.0,16,7,9
SA,SG,2019.0,5,5,0
IN,OM,2002.0,9,1,8
NG,DE,2001.0,4,3,1
NG,US,1998.0,12,7,5
CN,NO,2000.0,5,4,1
GN,US,2019.0,1,1,0
MZ,PL,2011.0,9,6,3
IN,MY,1999.0,10,9,1
TW,EG,2013.0,5,11,-6
FR,KW,2018.0,8,7,1
GB,PA,2019.0,5,9,-4
TW,BE,2008.0,4,2,2
ET,GB,2013.0,5,9,-4
MD,UA,2007.0,1,1,0
IT,MA,1999.0,7,2,5
EG,CN,2018.0,29,37,-8
AR,BE,2003.0,5,3,2
MM,ID,2019.0,2,3,-1
IR,JP,1998.0,9,2,7
CZ,SE,2022.0,11,10,1
VG,RU,2018.0,3,1,2
MA,BE,2018.0,5,9,-4
DE,BD,2001.0,1,1,0
SA,AT,2021.0,2,3,-1
nan,CH,2013.0,13,13,0
ES,MZ,2012.0,3,1,2
PL,CA,2017.0,27,43,-16
NL,NZ,2017.0,13,15,-2
GB,TW,1998.0,18,19,-1
CZ,GR,2002.0,3,2,1
NL,QA,2015.0,10,1,9
KE,NO,2021.0,4,4,0
IL,DK,2013.0,8,2,6
CH,UA,2013.0,6,7,-1
TN,JP,2018.0,2,3,-1
PK,AR,2021.0,4,3,1
US,MM,2017.0,9,6,3
IR,NO,2011.0,9,3,6
IN,PT,2006.0,5,1,4
ID,DZ,2021.0,4,2,2
FR,ZA,2008.0,18,13,5
SA,GB,2012.0,27,107,-80
ES,CY,2011.0,1,1,0
HR,QA,2020.0,1,2,-1
NG,RU,2017.0,3,2,1
SA,TR,2015.0,9,10,-1
CN,RS,2014.0,6,12,-6
CA,nan,2012.0,44,33,11
IN,NP,2005.0,24,25,-1
ES,SK,2009.0,2,2,0
CN,HU,2015.0,5,8,-3
IR,nan,2014.0,4,5,-1
US,GF,2010.0,1,1,0
KW,IN,2005.0,7,6,1
TR,DK,2020.0,14,12,2
HU,BE,2017.0,13,8,5
PT,CL,2007.0,8,6,2
BR,SE,2001.0,9,12,-3
JP,UA,2014.0,4,6,-2
CZ,IN,2002.0,12,10,2
PT,MX,2011.0,15,17,-2
BR,VE,2015.0,20,33,-13
LV,RU,2009.0,8,19,-11
IN,TW,2019.0,79,55,24
AU,BW,2018.0,4,3,1
BD,CA,2012.0,31,32,-1
KP,CN,2020.0,4,11,-7
LK,GB,2017.0,21,26,-5
RO,DE,2006.0,23,27,-4
BA,SI,2014.0,8,2,6
MX,CZ,2016.0,7,6,1
FR,IL,1999.0,25,23,2
LV,DE,2015.0,4,2,2
MY,TR,2007.0,2,2,0
FR,AT,1997.0,5,12,-7
FI,nan,2008.0,8,13,-5
KW,AE,2006.0,1,2,-1
DE,SI,1999.0,3,3,0
NO,MX,2013.0,3,4,-1
NZ,FJ,2015.0,3,4,-1
NL,HU,2009.0,11,15,-4
FR,MG,2014.0,11,8,3
IR,AF,2022.0,8,2,6
RU,BE,2001.0,20,7,13
UG,CA,2009.0,1,2,-1
BR,IL,2019.0,14,14,0
NO,CZ,2006.0,4,26,-22
MM,US,2012.0,3,3,0
PT,AU,2011.0,12,14,-2
SE,ET,2005.0,4,2,2
BE,CM,2019.0,9,8,1
BE,NO,2014.0,9,10,-1
HK,US,2017.0,14,14,0
BE,BG,2008.0,5,7,-2
nan,SA,2013.0,3,2,1
ES,SI,2009.0,7,5,2
GB,GM,2002.0,5,2,3
SK,PL,2021.0,6,9,-3
PS,ES,2020.0,8,7,1
DE,LT,2009.0,8,5,3
DZ,MN,2020.0,2,2,0
GR,SA,2016.0,7,2,5
CA,UG,2009.0,2,1,1
SA,CZ,2020.0,4,2,2
BR,RS,2015.0,3,1,2
FJ,AU,2008.0,6,5,1
CM,FR,1997.0,4,6,-2
MY,PT,2012.0,3,2,1
MA,US,1999.0,5,6,-1
BO,ES,2009.0,12,7,5
CA,JM,2010.0,5,1,4
CR,ES,2023.0,1,2,-1
GB,CO,2001.0,10,3,7
AU,SI,2018.0,1,7,-6
CH,NZ,1999.0,7,3,4
CU,GB,2003.0,4,1,3
IN,PA,2017.0,3,6,-3
MZ,ES,2016.0,3,1,2
IL,IT,2001.0,11,8,3
MY,AE,2004.0,3,3,0
CU,CO,2008.0,17,15,2
IE,BD,2017.0,1,2,-1
RS,RO,2016.0,2,1,1
SK,FR,2021.0,6,2,4
CR,DE,2012.0,6,3,3
TW,DE,2004.0,14,10,4
NP,nan,2019.0,3,2,1
ES,PE,1999.0,14,10,4
ET,NO,2014.0,8,5,3
CW,NL,2004.0,6,12,-6
VE,PE,2016.0,10,9,1
MX,SG,2022.0,4,2,2
DE,ET,2006.0,3,5,-2
IN,SE,1998.0,9,4,5
CH,HR,2008.0,5,4,1
CN,PH,2005.0,11,18,-7
HU,BE,2019.0,9,10,-1
UA,CZ,2000.0,4,1,3
MA,DE,2005.0,6,4,2
GB,PA,2010.0,2,4,-2
SE,ET,2002.0,2,2,0
LK,CA,2012.0,2,2,0
MZ,LT,2019.0,2,2,0
CU,HN,2022.0,1,1,0
MX,IN,2003.0,9,4,5
KP,US,2020.0,2,3,-1
FI,HU,2001.0,8,5,3
US,SK,2014.0,33,29,4
MK,US,2008.0,3,6,-3
SY,TN,2021.0,1,1,0
TW,VN,2001.0,3,2,1
AE,ES,2009.0,1,2,-1
BE,KZ,2022.0,1,1,0
PA,SE,2010.0,3,1,2
NI,ES,2018.0,7,5,2
OM,GB,2008.0,5,7,-2
SE,nan,2017.0,23,89,-66
EE,NL,2015.0,6,5,1
IL,IN,1998.0,5,5,0
UG,TZ,2019.0,4,8,-4
UA,KR,2016.0,7,2,5
CZ,BY,2018.0,13,24,-11
NA,ZA,2020.0,5,17,-12
SY,FR,2015.0,9,10,-1
KN,US,2015.0,3,5,-2
CZ,EC,2020.0,1,1,0
ET,KE,2006.0,1,4,-3
PT,CH,2008.0,9,9,0
DK,GR,2022.0,5,7,-2
UA,DK,2012.0,3,1,2
SY,SA,2018.0,6,4,2
PA,AR,2013.0,5,3,2
KW,IN,2002.0,6,1,5
IN,UG,2021.0,6,1,5
IL,IE,2006.0,2,1,1
IT,CM,2018.0,4,4,0
BG,HU,2011.0,1,1,0
IL,RU,2004.0,17,20,-3
RS,DK,2005.0,4,2,2
SA,SG,2017.0,5,12,-7
IN,OM,2005.0,9,2,7
NP,GB,2017.0,4,11,-7
PT,HU,2021.0,1,3,-2
GR,IE,2006.0,3,1,2
UZ,UA,2013.0,4,2,2
EE,HU,2019.0,1,1,0
DE,UA,2005.0,25,39,-14
IT,DZ,2012.0,22,16,6
ZM,GB,2012.0,5,3,2
BR,IR,2013.0,4,12,-8
AT,CN,2018.0,23,20,3
CZ,IT,2002.0,33,17,16
IN,SE,1997.0,6,3,3
GF,FR,2010.0,7,11,-4
CL,PY,2022.0,7,2,5
RO,SE,2016.0,8,5,3
AT,RS,2013.0,7,8,-1
BY,GB,2017.0,5,3,2
KR,UZ,1998.0,3,1,2
EG,IR,2008.0,3,3,0
IE,IR,2008.0,2,3,-1
UZ,CZ,2005.0,4,1,3
PT,ZA,2012.0,3,4,-1
PA,AU,2005.0,2,4,-2
KR,RU,1999.0,3,2,1
ST,BR,2002.0,10,5,5
HR,nan,2009.0,4,3,1
BH,KW,2014.0,3,1,2
HU,ES,2005.0,3,1,2
TW,AT,2018.0,2,2,0
VG,GB,2013.0,7,9,-2
SM,IT,2019.0,3,3,0
JP,NP,2012.0,13,6,7
CI,US,2021.0,4,4,0
SS,AU,1999.0,1,1,0
NO,ZA,2020.0,6,7,-1
AT,CA,2000.0,6,7,-1
ID,PT,2020.0,2,5,-3
CH,MY,2014.0,5,4,1
AR,NL,2012.0,8,6,2
GH,MY,2013.0,3,2,1
GB,TZ,2013.0,16,10,6
AU,TT,2017.0,2,1,1
HU,IT,1997.0,4,3,1
US,KH,2000.0,2,1,1
HU,MA,2017.0,5,1,4
TZ,ZA,2014.0,4,7,-3
RO,FR,1997.0,9,12,-3
DE,CY,2007.0,2,1,1
KW,JO,2007.0,2,2,0
NL,NZ,2010.0,13,7,6
PK,ZM,2016.0,2,1,1
MX,AF,2018.0,2,6,-4
DK,ZA,2009.0,1,6,-5
IN,GR,2013.0,4,3,1
NO,AR,2019.0,2,5,-3
BF,BE,2020.0,4,5,-1
DE,MD,2011.0,2,3,-1
CA,FI,2008.0,12,26,-14
NC,CA,2008.0,1,2,-1
CM,TG,2014.0,1,2,-1
KR,NL,1999.0,1,3,-2
RU,HR,2008.0,3,3,0
PT,JP,2014.0,2,4,-2
AT,IE,2016.0,5,4,1
CH,BJ,2007.0,3,1,2
IQ,DZ,2020.0,2,3,-1
SA,KW,2007.0,4,1,3
IL,PL,2018.0,10,14,-4
CZ,AR,2016.0,5,2,3
RS,NO,2008.0,2,2,0
ID,KE,2010.0,1,6,-5
RS,GB,2004.0,7,10,-3
IL,TR,2008.0,1,2,-1
US,NI,2021.0,8,4,4
LT,JP,2010.0,12,6,6
NO,SJ,2015.0,8,7,1
PE,VE,2016.0,9,10,-1
BR,NO,2004.0,13,14,-1
BD,ZA,2009.0,2,1,1
FR,QA,2010.0,9,1,8
TN,CH,2009.0,5,8,-3
BE,KR,2009.0,4,4,0
HU,RS,2018.0,13,11,2
GB,MK,2018.0,3,1,2
CZ,IE,2020.0,2,1,1
SA,IR,2008.0,1,1,0
AT,EE,2015.0,5,7,-2
LY,ZA,2016.0,1,1,0
MD,MA,2009.0,4,1,3
ZA,NA,2012.0,7,5,2
IN,NP,2002.0,12,7,5
IN,TH,2001.0,1,2,-1
CZ,UA,2011.0,9,25,-16
SK,IE,2014.0,3,2,1
PL,MK,2012.0,1,1,0
PR,GB,2003.0,2,1,1
EC,CO,2012.0,15,18,-3
CO,AR,2001.0,8,17,-9
PY,VE,2008.0,2,1,1
CN,PT,2006.0,7,10,-3
KR,IN,2023.0,12,17,-5
DZ,FR,2003.0,20,36,-16
TR,BG,2015.0,1,4,-3
IL,CZ,2006.0,3,2,1
PE,GH,2019.0,1,1,0
FI,IS,2019.0,2,1,1
PE,HN,1999.0,1,1,0
RU,AM,2016.0,7,14,-7
MM,TH,2020.0,7,12,-5
nan,BG,2020.0,1,2,-1
MX,PT,2021.0,16,18,-2
KR,FR,2001.0,13,7,6
CD,US,2011.0,1,5,-4
VN,AU,1998.0,1,3,-2
EE,SE,2021.0,8,10,-2
PY,PE,2020.0,6,5,1
GA,AU,2011.0,1,1,0
FR,BJ,2022.0,6,7,-1
PY,BR,2015.0,9,7,2
UA,IL,2010.0,1,4,-3
FR,BG,2018.0,3,3,0
MX,AU,2001.0,3,1,2
RS,DK,2002.0,1,2,-1
PA,EC,2016.0,3,1,2
KE,BE,2000.0,4,1,3
IN,FI,2006.0,3,5,-2
CR,PE,2011.0,5,2,3
FR,UY,2019.0,8,2,6
NG,ZM,2018.0,1,1,0
GR,BG,2001.0,3,4,-1
QA,JO,2014.0,4,5,-1
TR,TN,2014.0,2,2,0
MX,CR,1999.0,1,3,-2
BN,CN,2021.0,2,2,0
RU,CO,2020.0,4,4,0
MX,FI,2020.0,5,1,4
AE,QA,2014.0,11,1,10
EG,IE,2015.0,5,6,-1
NL,RS,2016.0,3,3,0
IR,IE,2015.0,9,5,4
SG,AE,2011.0,3,2,1
IR,NZ,2016.0,14,5,9
EC,CZ,2022.0,2,1,1
UY,FR,2010.0,7,7,0
CZ,EG,2021.0,10,2,8
SA,ID,2022.0,12,11,1
NG,CM,1999.0,3,1,2
SI,BY,2005.0,2,1,1
ID,KE,2017.0,5,5,0
CA,BD,2009.0,11,18,-7
AU,CL,2009.0,8,10,-2
UY,CA,2012.0,5,4,1
VN,CO,2019.0,2,1,1
US,SI,2022.0,11,15,-4
ZA,IT,2009.0,8,9,-1
IR,SG,2002.0,1,2,-1
SM,IT,2010.0,1,2,-1
SA,DZ,2009.0,1,5,-4
PE,PA,2011.0,1,1,0
NE,US,2020.0,4,3,1
NL,TZ,2009.0,4,4,0
PK,ZW,2016.0,1,1,0
PH,AU,2005.0,3,6,-3
MZ,VN,2016.0,1,1,0
SM,IT,2017.0,1,2,-1
LU,GR,2014.0,3,3,0
IS,IT,2013.0,1,2,-1
IT,IS,2014.0,1,2,-1
HU,AU,2021.0,5,6,-1
SD,CA,2021.0,3,2,1
EC,BR,2004.0,2,2,0
KR,NO,2021.0,7,6,1
BD,QA,2021.0,3,5,-2
JP,NO,2021.0,8,7,1
BN,IN,2020.0,2,3,-1
SA,SG,2010.0,2,7,-5
SE,AT,1999.0,6,2,4
PH,CN,2003.0,17,19,-2
MY,TW,2006.0,7,7,0
VG,CH,2020.0,1,1,0
DE,YE,2010.0,1,1,0
SE,IR,2003.0,4,2,2
LV,PL,2016.0,1,1,0
FR,UY,2010.0,7,7,0
TH,TW,2016.0,7,19,-12
CL,AU,2006.0,9,2,7
QA,TN,2021.0,5,7,-2
US,SD,2010.0,4,5,-1
ML,US,2006.0,3,4,-1
FI,AR,2017.0,1,3,-2
RU,UZ,2013.0,12,6,6
ID,BR,2006.0,1,3,-2
IL,RS,2006.0,2,5,-3
ST,BR,2005.0,13,13,0
BG,GR,2020.0,7,3,4
RS,SI,2000.0,2,1,1
SA,NG,2013.0,9,4,5
TW,UA,2011.0,1,1,0
ET,TZ,2018.0,2,2,0
MM,SG,2007.0,1,1,0
AU,DK,1999.0,8,15,-7
TH,ZA,1998.0,1,1,0
KE,CD,2016.0,1,2,-1
BY,PL,2004.0,5,2,3
GB,OM,2013.0,10,6,4
FR,NE,2012.0,9,3,6
TZ,GB,2014.0,12,17,-5
MY,RU,2010.0,2,8,-6
UY,CL,2004.0,1,4,-3
AT,TR,1999.0,7,2,5
RU,MZ,2017.0,8,16,-8
GT,CU,2010.0,1,1,0
RO,AU,2022.0,4,5,-1
NG,NZ,2015.0,1,4,-3
CH,CY,2020.0,2,1,1
RU,TR,2013.0,8,4,4
IE,LY,2020.0,2,2,0
CA,QA,2005.0,1,3,-2
GB,BN,2005.0,3,1,2
NO,KR,2016.0,4,1,3
MU,GB,2016.0,2,5,-3
NO,IE,2016.0,4,7,-3
DK,KR,2016.0,3,8,-5
PT,UY,2018.0,1,3,-2
BJ,CA,2021.0,2,2,0
LK,NL,2006.0,1,1,0
US,KZ,2011.0,8,3,5
CZ,IN,2005.0,17,17,0
NG,JP,2007.0,4,3,1
FR,ID,1997.0,2,1,1
FI,CZ,2016.0,13,5,8
DK,EG,1997.0,2,1,1
NL,EG,2008.0,6,4,2
NZ,TW,2014.0,7,7,0
BR,IL,2010.0,3,7,-4
MY,GB,2003.0,13,59,-46
UY,FR,2019.0,2,8,-6
FI,PA,2012.0,1,1,0
NO,HR,2001.0,1,1,0
CN,PH,2002.0,14,10,4
DE,VE,2006.0,5,2,3
nan,SK,2001.0,2,1,1
GR,NL,1999.0,2,3,-1
FI,QA,2004.0,1,1,0
SY,CN,2016.0,12,14,-2
GT,CL,2016.0,3,6,-3
AR,UA,2017.0,1,2,-1
UZ,KG,2022.0,1,3,-2
TR,KR,2012.0,6,6,0
CY,IT,2018.0,2,3,-1
PT,PL,2002.0,3,1,2
DK,ES,2005.0,21,32,-11
KR,NG,2008.0,3,5,-2
PT,IE,2016.0,6,4,2
BD,PK,2007.0,5,13,-8
DZ,PT,2016.0,1,1,0
DK,LT,2018.0,4,4,0
UA,ES,2001.0,3,1,2
NP,AU,2002.0,1,1,0
PK,MX,2012.0,2,2,0
MX,KZ,2019.0,1,1,0
LT,CN,2015.0,2,7,-5
SD,QA,2022.0,2,1,1
BE,RO,1999.0,1,3,-2
US,BB,2012.0,3,4,-1
PL,BG,2011.0,3,2,1
BY,GB,2010.0,1,1,0
SG,CZ,2014.0,2,2,0
HU,AG,1998.0,2,3,-1
ZA,ET,2006.0,1,1,0
FR,AE,2009.0,3,2,1
UZ,PK,2012.0,1,1,0
IR,IL,2020.0,4,1,3
VE,AU,2002.0,2,1,1
MN,RU,2020.0,4,5,-1
TR,EE,2019.0,2,3,-1
LT,JP,2019.0,6,1,5
HR,IR,2022.0,1,2,-1
AZ,TR,2009.0,7,6,1
TW,IT,2011.0,1,4,-3
AE,ET,2018.0,2,1,1
UA,RO,2001.0,4,1,3
BA,US,2006.0,5,5,0
RO,MD,2022.0,1,13,-12
GB,HK,2019.0,4,4,0
nan,IR,2014.0,5,4,1
IN,PA,2019.0,3,1,2
CO,SV,2017.0,4,3,1
FR,CF,2004.0,4,2,2
MA,BD,2012.0,4,8,-4
IE,BD,2019.0,1,3,-2
MX,SI,2012.0,2,2,0
SI,TR,2019.0,1,1,0
EG,ET,2011.0,3,3,0
BG,CA,2005.0,1,3,-2
FI,AR,2010.0,1,2,-1
BE,CM,2010.0,4,3,1
MG,FR,1999.0,2,1,1
BG,JP,2010.0,3,5,-2
BJ,IT,2015.0,2,1,1
VE,AU,2005.0,1,2,-1
LY,EG,2009.0,3,2,1
SD,BR,2020.0,1,1,0
AU,QA,2020.0,8,14,-6
ES,TW,2011.0,3,4,-1
CH,CU,2002.0,1,1,0
BE,ID,2007.0,1,1,0
SD,OM,2011.0,1,1,0
IN,BH,2013.0,1,1,0
FR,PH,2010.0,6,9,-3
BY,FR,2008.0,3,2,1
NZ,LK,2011.0,2,2,0
IN,YE,2022.0,3,1,2
BN,US,2011.0,4,2,2
VN,AT,2016.0,2,7,-5
nan,ES,2023.0,3,2,1
BR,PA,2011.0,2,1,1
PL,KR,2016.0,3,2,1
GD,GB,2021.0,3,3,0
CZ,HR,2008.0,5,2,3
IL,ID,2020.0,3,3,0
SI,FI,2006.0,1,2,-1
UG,US,2001.0,5,7,-2
BO,CO,2007.0,1,2,-1
TR,PK,2011.0,5,7,-2
AU,JM,2017.0,2,2,0
ML,MA,2018.0,1,4,-3
GB,VE,2000.0,4,2,2
GB,HK,2017.0,2,2,0
UG,CY,2002.0,1,1,0
MY,IL,2016.0,2,3,-1
AE,IT,2021.0,6,7,-1
KW,CA,2001.0,1,3,-2
DE,MT,2011.0,1,2,-1
PK,EG,2006.0,3,3,0
UA,JP,2018.0,2,11,-9
GR,RS,2014.0,4,4,0
GB,GA,2000.0,1,1,0
CN,MM,2015.0,2,2,0
SE,DZ,2016.0,5,2,3
EG,DK,1999.0,1,4,-3
HU,CA,2001.0,3,15,-12
TG,FR,2012.0,3,2,1
BG,MK,2003.0,1,1,0
QA,FR,2011.0,2,11,-9
TH,ES,2016.0,1,5,-4
CH,VN,2006.0,2,1,1
IE,ID,2021.0,3,1,2
ZM,MW,2019.0,7,2,5
CN,KZ,2021.0,9,7,2
NZ,KR,2021.0,3,6,-3
BW,CA,2019.0,1,2,-1
FI,KR,2014.0,4,2,2
PH,IT,2009.0,4,2,2
KE,BH,2018.0,1,2,-1
PH,FR,1997.0,1,2,-1
MW,CA,2022.0,1,1,0
IN,SD,2009.0,1,2,-1
BA,PL,2010.0,6,4,2
HN,PT,2019.0,1,1,0
nan,IE,1998.0,1,2,-1
MA,TN,1998.0,2,1,1
DK,EC,2019.0,1,1,0
RS,FR,2018.0,7,8,-1
IL,IN,1997.0,1,3,-2
TR,CA,2000.0,8,11,-3
IR,TN,2009.0,2,3,-1
SA,AU,2023.0,2,5,-3
CA,GH,2001.0,1,1,0
KW,OM,2007.0,1,1,0
NI,US,2006.0,1,4,-3
BY,US,1997.0,1,4,-3
FI,IS,2017.0,2,1,1
SG,NO,2004.0,2,3,-1
DE,BA,2015.0,2,4,-2
FI,IE,2013.0,3,6,-3
IN,NZ,2023.0,1,1,0
NO,AR,2017.0,2,4,-2
MY,PS,2011.0,1,3,-2
MT,ES,2018.0,15,3,12
BS,GB,2015.0,2,2,0
CM,BJ,2019.0,1,2,-1
LB,NZ,2017.0,1,1,0
VG,CN,2017.0,4,1,3
ZA,MA,2019.0,1,1,0
IT,SK,2013.0,5,3,2
US,ZM,2000.0,2,1,1
US,MM,2010.0,3,2,1
MX,IL,2019.0,3,3,0
MC,FR,2015.0,3,13,-10
GE,CA,1997.0,1,2,-1
OM,TR,2017.0,1,1,0
PK,AU,2005.0,2,13,-11
GR,ME,2021.0,3,1,2
ZM,CN,2002.0,2,1,1
DE,NZ,1997.0,7,4,3
CA,VE,2019.0,2,5,-3
RU,RO,2022.0,3,1,2
MX,IL,2010.0,1,1,0
CH,GH,2007.0,1,1,0
BG,CA,2002.0,4,3,1
SY,AU,2009.0,2,1,1
RU,DK,2001.0,3,3,0
CA,HK,2011.0,2,3,-1
BD,MX,2010.0,1,1,0
BG,AU,2012.0,2,5,-3
BF,ML,2021.0,5,3,2
CH,NG,2015.0,2,2,0
IE,BD,2010.0,1,1,0
PH,NP,2015.0,2,2,0
MY,OM,2010.0,1,2,-1
GB,VN,2003.0,4,5,-1
TR,PL,2002.0,1,1,0
SG,IS,2015.0,2,1,1
UZ,ID,2020.0,1,1,0
TW,SE,2006.0,2,2,0
EE,GR,2014.0,1,1,0
IE,KR,2011.0,2,6,-4
BR,DZ,2016.0,2,3,-1
DZ,EG,2011.0,4,2,2
SD,AU,2020.0,2,1,1
ES,SG,2001.0,1,2,-1
HU,AG,1997.0,1,3,-2
IS,DK,2001.0,4,2,2
BD,NO,2023.0,2,1,1
CA,MD,2016.0,3,1,2
CZ,LT,2003.0,3,4,-1
YE,PK,2012.0,2,1,1
HK,JP,2008.0,3,3,0
IE,PL,2003.0,1,1,0
BF,US,2013.0,2,1,1
CL,PA,2003.0,1,1,0
GL,DK,2016.0,3,8,-5
US,ML,1999.0,3,1,2
DK,IL,2008.0,3,1,2
RO,JP,2000.0,4,3,1
SG,MX,2012.0,6,4,2
NO,TH,2013.0,2,1,1
LB,NL,2014.0,1,1,0
AT,SA,2011.0,3,1,2
TT,GB,2013.0,1,5,-4
AU,JM,2010.0,4,1,3
TW,PH,1998.0,1,4,-3
CR,CU,2001.0,1,3,-2
TW,JP,2023.0,2,4,-2
PL,MZ,2004.0,2,9,-7
UY,FR,2017.0,4,10,-6
IL,CO,2020.0,5,11,-6
CL,HU,2019.0,1,1,0
PT,VE,2010.0,5,2,3
AU,MT,2018.0,3,2,1
PE,PY,2015.0,2,2,0
TW,GR,2018.0,2,1,1
DE,QA,2006.0,1,1,0
HR,FI,2022.0,2,1,1
TH,PH,2007.0,2,1,1
BA,PL,2019.0,3,3,0
NO,UG,2022.0,2,1,1
KR,MX,2005.0,3,1,2
CN,CR,2007.0,1,2,-1
HR,AT,2005.0,2,2,0
IQ,DE,2007.0,1,1,0
BY,UA,1997.0,1,1,0
OM,EG,2012.0,3,8,-5
HK,ZA,2020.0,1,1,0
MX,NZ,2014.0,2,2,0
SK,SE,1998.0,2,2,0
DK,SI,2020.0,2,3,-1
GH,NZ,2018.0,1,2,-1
VN,AU,1997.0,1,3,-2
FR,AR,2023.0,3,1,2
HR,NL,2016.0,3,6,-3
UA,EE,2015.0,1,3,-2
BE,HU,2015.0,3,9,-6
QA,JP,2020.0,1,6,-5
PK,MY,2022.0,75,68,7
US,AU,2022.0,1566,1437,129
NZ,US,2017.0,372,426,-54
NO,US,2019.0,186,177,9
FR,BR,2014.0,218,189,29
MY,BN,2021.0,14,12,2
DE,ZA,2010.0,44,46,-2
AT,DE,2023.0,18,21,-3
NL,BE,2006.0,164,161,3
CL,US,2004.0,75,93,-18
IL,CN,2000.0,5,15,-10
JP,KR,2016.0,371,370,1
CO,PE,2017.0,110,67,43
CR,CL,2015.0,15,23,-8
AU,TW,2020.0,51,35,16
CH,HU,2014.0,16,29,-13
US,GR,2014.0,163,224,-61
EG,SA,2020.0,443,404,39
DK,GW,2019.0,3,4,-1
VE,ES,2011.0,89,71,18
PL,IT,2006.0,17,13,4
IR,US,2017.0,845,420,425
US,BF,2019.0,3,4,-1
IR,US,2019.0,767,506,261
IT,CH,2004.0,135,113,22
SA,TN,2018.0,49,131,-82
GB,FR,2006.0,361,417,-56
CZ,IL,2014.0,4,2,2
PL,US,2006.0,190,188,2
UY,CO,2018.0,12,30,-18
KR,ES,2020.0,22,12,10
FR,PT,2004.0,30,22,8
SG,GB,2013.0,96,135,-39
DE,IR,2019.0,90,176,-86
UA,IL,2019.0,6,9,-3
SE,CH,2000.0,22,23,-1
LT,JP,2017.0,11,3,8
LU,FR,2013.0,26,52,-26
DE,RU,1999.0,74,138,-64
CN,MY,2012.0,60,32,28
FR,RO,2009.0,41,36,5
BH,CA,2015.0,1,2,-1
QA,ID,2021.0,3,1,2
GR,US,2018.0,179,157,22
BR,UY,2014.0,38,50,-12
PH,CA,2020.0,15,6,9
NL,BG,2021.0,2,2,0
ID,ZA,2017.0,44,41,3
AU,NP,2018.0,12,21,-9
JP,FR,1999.0,53,87,-34
TN,FR,2012.0,140,203,-63
US,VE,2015.0,41,36,5
DK,CN,2000.0,10,8,2
TR,IL,2018.0,5,6,-1
CU,VE,2019.0,25,18,7
MY,RU,2019.0,34,21,13
PR,US,2001.0,8,3,5
MX,CH,2018.0,16,15,1
ES,NO,2007.0,21,9,12
BE,nan,2020.0,22,16,6
GR,ES,2012.0,15,14,1
GE,GB,2018.0,7,3,4
CM,CI,2017.0,1,2,-1
AT,FR,2022.0,25,32,-7
TW,AU,2011.0,34,40,-6
EG,PL,1999.0,1,1,0
US,BG,2003.0,21,29,-8
AU,CO,2020.0,14,16,-2
LT,DE,2020.0,10,6,4
CA,VE,2010.0,6,5,1
CH,BR,2022.0,30,50,-20
OM,US,2014.0,8,16,-8
HU,SE,2012.0,15,8,7
CL,FR,2012.0,28,51,-23
QA,AE,2018.0,12,12,0
ES,PT,2004.0,55,46,9
PK,QA,2020.0,21,18,3
AU,JP,2012.0,65,81,-16
DE,TR,2023.0,1,5,-4
AR,DE,1999.0,15,9,6
PL,BE,2014.0,17,18,-1
ZA,FR,2017.0,31,46,-15
KE,PK,2003.0,1,2,-1
MA,ES,2005.0,11,5,6
CO,NZ,2009.0,2,1,1
DE,NZ,1998.0,10,10,0
SS,GB,1997.0,7,2,5
DE,SA,2021.0,30,30,0
EE,RU,2015.0,9,3,6
CH,AR,2014.0,16,17,-1
CH,MX,2004.0,6,5,1
NL,MW,2019.0,2,1,1
RS,BG,2004.0,3,4,-1
VE,GB,2009.0,10,4,6
SE,nan,2019.0,14,43,-29
TH,IR,2013.0,2,1,1
AU,ID,2003.0,7,11,-4
DK,IE,2013.0,7,5,2
ZM,IN,2012.0,2,1,1
HU,BE,2010.0,8,7,1
BG,GB,2001.0,18,6,12
NL,ZA,2013.0,39,31,8
BD,RU,2016.0,1,1,0
CW,DE,2004.0,2,1,1
PK,AU,2002.0,5,8,-3
BR,CR,2007.0,1,5,-4
TR,MY,2018.0,11,17,-6
MX,CU,2022.0,15,32,-17
HU,IT,1998.0,6,6,0
EC,FR,2022.0,4,6,-2
NG,US,1997.0,8,7,1
BD,SA,2013.0,11,9,2
BY,UZ,2021.0,6,1,5
KW,US,1999.0,13,8,5
CA,IS,2006.0,2,3,-1
IN,NO,1998.0,15,21,-6
MY,OM,2017.0,12,6,6
LT,DK,2014.0,1,1,0
HR,BA,2009.0,25,14,11
GB,BB,2010.0,3,2,1
US,BF,2010.0,1,2,-1
ZA,DZ,2014.0,1,2,-1
DZ,LU,2020.0,1,1,0
GB,UZ,2013.0,1,1,0
UZ,CZ,2002.0,4,3,1
OM,AU,2004.0,2,1,1
MA,ES,2002.0,5,2,3
GT,CO,2014.0,2,3,-1
US,MU,2009.0,1,2,-1
CN,BH,2020.0,2,1,1
GB,SI,2009.0,6,12,-6
YE,MY,2016.0,6,19,-13
LK,IN,2008.0,4,3,1
NL,TW,2007.0,1,1,0
KW,MY,2009.0,1,1,0
GF,GP,2018.0,3,1,2
IE,PT,2012.0,2,3,-1
CM,BE,2015.0,1,8,-7
NL,MW,2017.0,2,2,0
nan,GE,2005.0,1,2,-1
PH,PK,2020.0,4,3,1
PK,TW,2008.0,4,1,3
NI,MX,2017.0,4,5,-1
JO,AU,2005.0,3,2,1
TW,BR,2009.0,2,1,1
CA,GE,2017.0,2,3,-1
PL,BY,2006.0,4,2,2
TW,NP,2020.0,2,2,0
BA,FR,2019.0,2,3,-1
GH,CI,2018.0,2,1,1
TR,IE,2015.0,4,3,1
AU,SY,2015.0,1,1,0
ZA,UG,2003.0,2,3,-1
RO,LT,2003.0,1,2,-1
MX,CN,2022.0,13,11,2
JP,AM,2003.0,5,4,1
HK,TW,2018.0,2,5,-3
AR,SA,2014.0,2,1,1
XK,TR,2020.0,2,3,-1
IN,SY,2020.0,1,4,-3
SA,JP,1999.0,2,1,1
AT,SG,2007.0,2,1,1
EE,BE,2015.0,1,3,-2
CN,SK,2013.0,1,4,-3
GB,BB,2019.0,3,3,0
CZ,BG,2012.0,2,2,0
CO,BO,2006.0,2,4,-2
AE,IN,2007.0,2,6,-4
BO,PE,2009.0,3,3,0
FI,ID,2012.0,2,1,1
QA,MY,2022.0,3,2,1
CH,EE,2022.0,1,2,-1
SE,FI,2023.0,5,4,1
NG,BJ,2013.0,2,2,0
DK,EC,2017.0,2,2,0
IT,US,2007.0,854,770,84
BR,ES,2021.0,304,278,26
VN,JP,2021.0,29,66,-37
TH,US,2015.0,124,247,-123
SA,CA,2007.0,24,33,-9
OM,IN,2022.0,15,15,0
GB,HK,2010.0,6,3,3
BE,SI,2018.0,8,6,2
FR,SI,2012.0,26,9,17
MA,BR,2006.0,3,1,2
KE,AU,2002.0,2,1,1
PH,FR,1998.0,1,2,-1
BY,CH,2007.0,1,1,0
KE,SE,2007.0,4,1,3
BG,CH,1997.0,2,3,-1
US,,2024.0,510821,0,510821
CA,,2019.0,11114,0,11114
,SD,2012.0,197,0,197
,JP,2009.0,15261,0,15261
CA,,2017.0,9068,0,9068
,SE,1994.0,12501,0,12501
,EC,2014.0,1061,0,1061
,CA,2011.0,11113,0,11113
BG,,2024.0,2846,0,2846
,ID,2016.0,25506,0,25506
ES,,2020.0,14404,0,14404
KR,,2022.0,9821,0,9821
,RS,2002.0,821,0,821
IT,,2020.0,12276,0,12276
,AU,2007.0,6478,0,6478
,NZ,1994.0,2605,0,2605
CA,,2010.0,4831,0,4831
BN,,2023.0,125,0,125
,PL,2011.0,8346,0,8346
,ZW,2011.0,182,0,182
DE,EC,2011.0,5,0,5
,RS,2005.0,928,0,928
,HU,2009.0,1395,0,1395
MA,,2022.0,2363,0,2363
,GR,2006.0,2975,0,2975
,NG,2012.0,2873,0,2873
,IE,2015.0,1415,0,1415
TW,PL,2016.0,7,0,7
,JM,1998.0,43,0,43
,PH,2010.0,636,0,636
CA,TZ,2013.0,4,0,4
,AT,2018.0,2055,0,2055
AU,,2001.0,1258,0,1258
UG,,2023.0,1362,0,1362
GR,,2018.0,2183,0,2183
BD,,2016.0,438,0,438
IN,,2000.0,1292,0,1292
,BG,2003.0,434,0,434
ZA,TN,2005.0,1,0,1
,IT,2015.0,10784,0,10784
,LV,2004.0,117,0,117
SA,,2008.0,150,0,150
IL,,2007.0,902,0,902
KZ,,2009.0,41,0,41
AR,,2005.0,343,0,343
,IL,2016.0,2392,0,2392
SI,,2018.0,571,0,571
IE,,2011.0,516,0,516
,TH,2013.0,2518,0,2518
,NP,2002.0,118,0,118
,CY,2011.0,218,0,218
,UA,2000.0,1241,0,1241
,nan,2015.0,765,0,765
,SZ,1995.0,4,0,4
PH,,2014.0,217,0,217
CU,,2009.0,129,0,129
TN,,2012.0,334,0,334
,VN,2002.0,193,0,193
,VN,2005.0,178,0,178
,IS,2009.0,125,0,125
,GE,1997.0,148,0,148
,ER,2016.0,9,0,9
,UY,2013.0,317,0,317
AR,,2002.0,261,0,261
,KH,2011.0,71,0,71
BD,LU,2015.0,1,0,1
,UZ,2009.0,159,0,159
BH,VN,2018.0,1,0,1
,BH,2006.0,37,0,37
,BJ,2014.0,150,0,150
,AM,2006.0,161,0,161
RU,SY,2013.0,1,0,1
AM,,2004.0,44,0,44
,PH,2017.0,792,0,792
,VE,2011.0,301,0,301
VE,,1999.0,41,0,41
BB,,2023.0,36,0,36
SY,IT,2003.0,2,0,2
UY,PT,2016.0,1,0,1
,VG,2006.0,28,0,28
,LV,1996.0,131,0,131
,MZ,2010.0,38,0,38
BJ,CI,2018.0,2,0,2
LB,,2008.0,58,0,58
,PR,2000.0,13,0,13
,SA,2020.0,336,0,336
,BF,2007.0,83,0,83
TR,TH,2015.0,3,0,3
NI,,2022.0,120,0,120
BW,,2021.0,108,0,108
CN,BF,2022.0,1,0,1
HR,,2011.0,283,0,283
AZ,,2011.0,47,0,47
BI,,2023.0,68,0,68
CN,MG,2006.0,2,0,2
PE,,2004.0,32,0,32
KE,CG,2015.0,1,0,1
,MZ,2017.0,73,0,73
,MZ,2019.0,31,0,31
LB,IL,2020.0,4,0,4
,NA,2018.0,38,0,38
DE,NA,2013.0,3,0,3
PT,AE,2020.0,3,0,3
,BT,2017.0,20,0,20
CN,TJ,2022.0,3,0,3
QA,IR,2012.0,3,0,3
,PA,1998.0,21,0,21
YE,IT,2014.0,1,0,1
CO,SV,2010.0,2,0,2
BE,,2008.0,1050,0,1050
,BD,2018.0,1281,0,1281
ST,,2022.0,18,0,18
QA,,2013.0,77,0,77
,PH,2019.0,458,0,458
MR,TZ,2020.0,1,0,1
BF,,2016.0,40,0,40
NP,JP,2003.0,6,0,6
,NP,2005.0,181,0,181
PE,TW,2006.0,1,0,1
,KY,2009.0,7,0,7
,PA,1997.0,33,0,33
JM,,2009.0,21,0,21
ET,TW,2001.0,1,0,1
,NC,2010.0,14,0,14
IS,,2018.0,119,0,119
BJ,,2007.0,9,0,9
SZ,BW,2021.0,1,0,1
SY,,2012.0,36,0,36
,PY,2008.0,17,0,17
,BN,1996.0,15,0,15
IQ,NL,2010.0,1,0,1
,GN,2007.0,7,0,7
JM,DE,2007.0,1,0,1
TO,,2020.0,2,0,2
CA,GY,2010.0,1,0,1
GE,,2004.0,30,0,30
US,AD,2017.0,1,0,1
LK,,1998.0,14,0,14
LV,,2009.0,45,0,45
CO,TZ,2004.0,1,0,1
MK,RS,2011.0,2,0,2
DJ,IN,2021.0,1,0,1
MM,,2009.0,7,0,7
UA,NL,2014.0,11,0,11
IR,IS,2020.0,2,0,2
RE,,2007.0,7,0,7
TD,,2015.0,3,0,3
VG,CN,2019.0,5,0,5
CM,SE,2008.0,1,0,1
,GE,1998.0,151,0,151
SS,SA,2015.0,1,0,1
AO,IT,2004.0,2,0,2
CO,SD,2019.0,1,0,1
SE,SA,2003.0,2,0,2
,FJ,1997.0,4,0,4
ZW,,2013.0,19,0,19
,CG,1997.0,15,0,15
CG,LU,2012.0,1,0,1
,JM,1997.0,50,0,50
RO,BR,1999.0,2,0,2
BW,FI,2014.0,1,0,1
VU,nan,2004.0,1,0,1
GR,PK,2009.0,2,0,2
SE,LY,2009.0,1,0,1
AU,JM,2019.0,3,0,3
,CG,1998.0,12,0,12
,FJ,1998.0,15,0,15
NO,EG,2004.0,1,0,1
JO,ES,2001.0,3,0,3
,BT,2010.0,10,0,10
TH,TZ,2013.0,1,0,1
,BZ,2007.0,8,0,8
TR,AG,2015.0,9,0,9
VE,SE,2014.0,3,0,3
ME,NL,2014.0,1,0,1
AU,HK,2000.0,1,0,1
CN,AO,2010.0,4,0,4
SN,CN,2011.0,1,0,1
ZM,CN,2005.0,1,0,1
DE,LA,2013.0,1,0,1
KW,BD,2005.0,1,0,1
SE,NI,2013.0,3,0,3
CH,TW,1997.0,1,0,1
PK,PH,2010.0,1,0,1
,BB,2007.0,10,0,10
MT,,2002.0,4,0,4
PG,,2014.0,14,0,14
JP,TZ,2009.0,6,0,6
BA,,2000.0,2,0,2
AU,VU,2002.0,1,0,1
IL,BZ,2000.0,1,0,1
CM,BJ,2017.0,3,0,3
ID,ZA,2010.0,2,0,2
TH,KR,2004.0,1,0,1
PE,SE,2013.0,8,0,8
BN,NP,2014.0,1,0,1
BF,CA,2001.0,1,0,1
KE,,2000.0,38,0,38
US,GF,2017.0,2,0,2
PL,AR,2012.0,1,0,1
,DO,2007.0,12,0,12
AL,AT,2020.0,1,0,1
GR,PT,2013.0,7,0,7
OM,,2007.0,26,0,26
DE,TJ,2013.0,1,0,1
,JE,2014.0,1,0,1
AR,TN,2017.0,1,0,1
PA,AU,2002.0,2,0,2
MD,BE,2000.0,4,0,4
PH,PA,2006.0,1,0,1
AR,UA,2019.0,1,0,1
TT,ES,2018.0,3,0,3
SJ,US,2020.0,2,0,2
,SL,2018.0,17,0,17
BY,KR,1999.0,1,0,1
NG,BW,2001.0,2,0,2
UG,MW,2013.0,1,0,1
AE,MA,2014.0,3,0,3
PA,ZA,2018.0,1,0,1
AG,nan,2018.0,1,0,1
PS,AE,2016.0,1,0,1
NC,ES,2011.0,1,0,1
NP,nan,2010.0,2,0,2
DK,CU,1998.0,1,0,1
IL,MA,2014.0,1,0,1
PH,SA,2016.0,6,0,6
KP,DK,2012.0,1,0,1
NG,EE,2022.0,1,0,1
PR,,2007.0,5,0,5
GP,,2012.0,8,0,8
MT,JP,2022.0,1,0,1
EC,DZ,2014.0,2,0,2
HU,ES,2002.0,2,0,2
KH,TH,2011.0,2,0,2
AU,CR,2001.0,1,0,1
SN,TW,2014.0,1,0,1
BY,,1998.0,22,0,22
VE,SV,2007.0,1,0,1
TN,MT,2014.0,2,0,2
CU,CR,2004.0,4,0,4
,GA,2006.0,22,0,22
AR,CZ,2006.0,2,0,2
MC,,2007.0,4,0,4
KH,NZ,2020.0,3,0,3
SZ,NG,2016.0,1,0,1
,SS,2015.0,6,0,6
PH,ML,2017.0,1,0,1
CZ,MA,2022.0,1,0,1
AZ,AT,2018.0,1,0,1
PK,GD,2022.0,1,0,1
NP,SD,2021.0,1,0,1
,BT,2019.0,20,0,20
GR,PS,2022.0,1,0,1
TR,NZ,1997.0,1,0,1
NZ,TN,2022.0,1,0,1
SS,CA,2012.0,1,0,1
GA,CM,2010.0,1,0,1
BE,GM,2017.0,3,0,3
TW,PT,2003.0,2,0,2
CN,BN,2009.0,1,0,1
MK,IL,2015.0,1,0,1
UG,BI,2021.0,2,0,2
CY,AU,2002.0,1,0,1
JP,MK,2012.0,2,0,2
CI,CG,2008.0,1,0,1
NL,NE,2015.0,1,0,1
NL,LT,2009.0,2,0,2
LY,CA,1999.0,1,0,1
CH,MT,2007.0,1,0,1
,SC,2004.0,3,0,3
TZ,CN,2009.0,3,0,3
AT,CU,1998.0,1,0,1
TR,ZM,2022.0,2,0,2
JM,PT,2003.0,1,0,1
FI,IS,2010.0,1,0,1
RE,PL,2009.0,1,0,1
GA,BE,2001.0,1,0,1
GB,CG,2004.0,1,0,1
MG,MD,2009.0,1,0,1
HU,NZ,2008.0,3,0,3
SL,JP,2012.0,1,0,1
MR,,2017.0,2,0,2
US,GN,2021.0,3,0,3
MW,NO,2017.0,1,0,1
TW,PH,1997.0,1,0,1
BS,,2012.0,2,0,2
FR,GM,2018.0,1,0,1
NL,AF,2015.0,1,0,1
AM,JP,2016.0,6,0,6
BR,TN,2022.0,1,0,1
AT,ID,2005.0,1,0,1
NZ,IL,2001.0,1,0,1
PK,CO,2009.0,1,0,1
MA,NL,2001.0,1,0,1
BY,MX,1998.0,1,0,1
SY,NG,2014.0,1,0,1
CL,MU,2019.0,1,0,1
PK,CZ,2016.0,2,0,2
JP,PG,2014.0,1,0,1
,NC,2019.0,6,0,6
MN,PT,2008.0,1,0,1
NL,FJ,2022.0,1,0,1
CR,PA,2015.0,2,0,2
TR,LV,2022.0,1,0,1
CL,TT,2021.0,1,0,1
ZA,PS,2018.0,2,0,2
LK,KE,2018.0,1,0,1
GQ,JP,2019.0,1,0,1
PE,GH,2017.0,2,0,2
SA,MA,1999.0,1,0,1
YE,,2006.0,4,0,4
GE,NL,2012.0,1,0,1
GR,SG,2020.0,2,0,2
,GL,1994.0,4,0,4
nan,BM,2007.0,3,0,3
GB,YE,2003.0,2,0,2
PE,DE,2004.0,2,0,2
MA,DE,2002.0,7,0,7
AF,NZ,2019.0,1,0,1
CM,SA,2000.0,1,0,1
RE,MA,2017.0,1,0,1
KE,TZ,2000.0,2,0,2
KW,NZ,2013.0,1,0,1
TH,PK,2010.0,2,0,2
LK,IE,2006.0,1,0,1
TW,MN,2016.0,3,0,3
PK,SK,2012.0,1,0,1
ES,ST,2009.0,2,0,2
IL,NG,2014.0,1,0,1
PW,,2013.0,2,0,2
ZW,ZM,2013.0,1,0,1
PL,CL,2006.0,1,0,1
GM,ZA,2018.0,1,0,1
CN,DZ,2008.0,1,0,1
LU,AU,2009.0,2,0,2
GB,CM,2008.0,1,0,1
PK,NO,2004.0,3,0,3
BD,BR,2021.0,1,0,1
DK,EC,2010.0,1,0,1
CY,AU,2005.0,1,0,1
MY,GT,2022.0,1,0,1
,PW,2014.0,3,0,3
IE,VG,2008.0,1,0,1
BY,RS,2015.0,2,0,2
MA,ML,2011.0,2,0,2
GD,BR,2014.0,1,0,1
DK,TH,1998.0,1,0,1
TW,RW,2002.0,1,0,1
DE,KH,2015.0,1,0,1
NZ,PT,2022.0,2,0,2
MR,,2019.0,6,0,6
US,GF,2019.0,1,0,1
,SC,1996.0,5,0,5
UG,GM,2014.0,1,0,1
AE,CH,2001.0,1,0,1
VE,IN,2015.0,2,0,2
RO,RS,2003.0,1,0,1
YE,DE,2018.0,3,0,3
LK,JO,2012.0,1,0,1
FR,NP,2009.0,1,0,1
IE,RU,2000.0,4,0,4
MY,PG,2013.0,1,0,1
TR,NZ,1998.0,1,0,1
SK,ZA,2011.0,1,0,1
CG,IT,2017.0,1,0,1
HK,MK,2009.0,2,0,2
TG,PT,2011.0,1,0,1
CA,JO,1998.0,2,0,2
IR,AL,2012.0,2,0,2
SN,SG,2012.0,1,0,1
BG,CH,1998.0,5,0,5
CA,MN,2017.0,1,0,1
MY,LY,2011.0,4,0,4
UG,UY,2021.0,2,0,2
UY,BE,2014.0,1,0,1
,BN,2004.0,6,0,6
MY,CL,2001.0,1,0,1
BD,ID,2009.0,2,0,2
SD,IT,2020.0,1,0,1
GR,CN,2000.0,3,0,3
DZ,CZ,2017.0,2,0,2
,SI,2020.0,34,0,34
AU,TZ,2018.0,2,0,2
SN,DE,2017.0,1,0,1
RU,TH,2015.0,1,0,1
GB,KH,1998.0,1,0,1
ZM,UG,2018.0,1,0,1
BR,LT,2016.0,1,0,1
AR,UA,2010.0,1,0,1
FI,JO,2017.0,3,0,3
UG,BF,2017.0,1,0,1
HU,NO,2003.0,5,0,5
,LS,2000.0,6,0,6
MY,UZ,2018.0,3,0,3
HU,CW,2001.0,1,0,1
UZ,CA,2011.0,1,0,1
SE,KR,2023.0,1,0,1
BE,JO,2005.0,1,0,1
PS,BE,2002.0,1,0,1
RU,IR,2002.0,5,0,5
RO,nan,2001.0,1,0,1
CL,CZ,2013.0,1,0,1
AT,NZ,2000.0,1,0,1
VU,FR,2006.0,2,0,2
CA,NI,2018.0,6,0,6
CH,TH,2011.0,6,0,6
RO,LY,2013.0,1,0,1
ES,BJ,2002.0,1,0,1
DO,ES,2001.0,1,0,1
BD,PE,2021.0,1,0,1
CZ,UG,2006.0,1,0,1
AM,ID,2017.0,2,0,2
IQ,CA,2008.0,1,0,1
MA,MY,2009.0,2,0,2
SJ,GB,2020.0,2,0,2
,NZ,2021.0,1,0,1
BY,BR,2020.0,1,0,1
BH,SD,2003.0,1,0,1
TZ,IR,2021.0,1,0,1
NZ,ET,2014.0,1,0,1
FR,GT,2003.0,1,0,1
DZ,JM,2017.0,1,0,1
IE,TN,2009.0,1,0,1
FR,AZ,2011.0,1,0,1
,NC,2017.0,4,0,4
CO,AU,2023.0,1,0,1
JP,DZ,2008.0,2,0,2
MW,AU,2007.0,2,0,2
BG,SG,2012.0,1,0,1
HK,IE,2012.0,1,0,1
LI,CH,2000.0,1,0,1
US,CF,2018.0,1,0,1
ZM,IT,2018.0,2,0,2
IN,CR,2003.0,2,0,2
EG,SN,2014.0,1,0,1
ET,CH,2015.0,5,0,5
ZW,NZ,2019.0,1,0,1
GM,IN,2018.0,1,0,1
SC,NL,2009.0,1,0,1
CN,LS,2021.0,1,0,1
ER,CN,2020.0,1,0,1
nan,BW,2017.0,1,0,1
IN,DZ,2018.0,3,0,3
LA,NZ,2010.0,1,0,1
SI,AE,2016.0,1,0,1
AZ,MN,2019.0,1,0,1
HU,ZA,2016.0,3,0,3
PT,BO,2014.0,1,0,1
CU,CA,1998.0,1,0,1
CM,MG,2011.0,1,0,1
LV,IN,2023.0,2,0,2
,KP,2008.0,1,0,1
MY,MM,2002.0,2,0,2
LR,PK,2015.0,1,0,1
GB,SV,2005.0,1,0,1
UA,KZ,2011.0,1,0,1
NL,AM,2018.0,2,0,2
JO,TT,2019.0,1,0,1
KN,ES,2021.0,1,0,1
ZA,MX,1999.0,1,0,1
GA,AT,2012.0,1,0,1
BN,QA,2017.0,1,0,1
TN,DK,2007.0,1,0,1
UA,KG,2019.0,2,0,2
CO,BY,2019.0,1,0,1
DE,KZ,2004.0,1,0,1
MT,,2005.0,3,0,3
ET,PH,2018.0,3,0,3
SE,MT,2014.0,2,0,2
RS,AG,2014.0,1,0,1
ID,JO,2022.0,3,0,3
PA,TW,2009.0,2,0,2
NP,SA,2016.0,3,0,3
PY,CA,2017.0,1,0,1
SI,CO,2015.0,1,0,1
HR,EG,2020.0,1,0,1
PT,QA,2013.0,1,0,1
MZ,IN,2012.0,1,0,1
BE,KH,2013.0,1,0,1
BI,CA,2012.0,1,0,1
RU,BA,2016.0,1,0,1
SK,UA,2004.0,1,0,1
AU,EE,2007.0,1,0,1
LY,DZ,2017.0,2,0,2
KE,AU,2005.0,3,0,3
FI,ET,2013.0,1,0,1
JP,OM,2008.0,1,0,1
VN,BE,1997.0,2,0,2
JP,SI,1999.0,1,0,1
RS,QA,2008.0,2,0,2
SI,NO,2007.0,1,0,1
GP,MD,2015.0,1,0,1
AF,UG,2020.0,1,0,1
MT,IE,1999.0,1,0,1
AU,KG,2022.0,1,0,1
UA,AT,1997.0,2,0,2
DZ,NC,1997.0,1,0,1
EE,DK,2022.0,1,0,1
PT,FJ,2020.0,1,0,1
MT,CA,2009.0,1,0,1
NL,ER,2010.0,1,0,1
FR,ME,2016.0,1,0,1
CY,CH,2010.0,2,0,2
BG,KR,1999.0,1,0,1
JE,GB,2011.0,1,0,1
IQ,GB,2001.0,1,0,1
SM,US,2008.0,1,0,1
IN,PS,2011.0,1,0,1
GM,SE,2016.0,1,0,1
CG,ZA,2005.0,1,0,1
MR,,2010.0,2,0,2
GM,EG,2015.0,1,0,1
SX,,2020.0,1,0,1
VE,PA,2002.0,2,0,2
JP,ME,2008.0,1,0,1
GF,LB,2015.0,1,0,1
ZW,CZ,2017.0,1,0,1
GR,RO,1999.0,1,0,1
IL,PY,2012.0,1,0,1
ZA,ID,2004.0,2,0,2
IR,EE,2016.0,2,0,2
SK,ID,2009.0,1,0,1
FJ,NO,2008.0,1,0,1
GE,AU,2021.0,1,0,1
MD,PT,2007.0,1,0,1
BO,EC,2013.0,4,0,4
PL,SK,2009.0,2,0,2
GA,CI,2019.0,1,0,1
MD,GF,2016.0,1,0,1
ZM,,1998.0,1,0,1
UA,NO,2013.0,1,0,1
ML,CI,2008.0,1,0,1
BF,MA,2012.0,1,0,1
GR,EG,2021.0,2,0,2
GB,AR,2023.0,1,0,1
US,MR,2004.0,1,0,1
CA,MN,2010.0,1,0,1
PK,IL,2020.0,1,0,1
SN,SE,2001.0,1,0,1
CY,BA,2020.0,1,0,1
NL,MU,2022.0,1,0,1
BN,ZW,2021.0,1,0,1
SN,GB,2018.0,3,0,3
,EE,2020.0,8,0,8
CU,AO,2020.0,1,0,1
TR,UA,2008.0,1,0,1
MY,KR,1997.0,1,0,1
AE,IQ,2013.0,1,0,1
,SX,2005.0,3,0,3
LV,GB,2001.0,2,0,2
CY,TW,2022.0,1,0,1
NC,GB,2011.0,1,0,1
TW,AM,2014.0,1,0,1
HN,GT,2018.0,1,0,1
DK,FJ,2012.0,1,0,1
BD,SY,2009.0,1,0,1
BD,HU,2022.0,1,0,1
SK,MD,1998.0,1,0,1
ID,DK,2011.0,2,0,2
LB,CO,2016.0,1,0,1
LB,SD,2015.0,1,0,1
HR,EE,2004.0,1,0,1
TN,MK,2017.0,1,0,1
IR,LT,2008.0,1,0,1
ME,IT,2017.0,3,0,3
ZM,ZA,1999.0,2,0,2
IT,FK,2018.0,1,0,1
AL,BG,2020.0,1,0,1
AR,CN,2021.0,1,2,-1
ZM,NZ,2016.0,2,1,1
CL,JP,2009.0,3,4,-1
CZ,nan,2010.0,4,10,-6
BY,GB,2019.0,2,1,1
BI,BE,2009.0,1,1,0
PA,DE,2018.0,4,6,-2
LV,BG,2013.0,2,2,0
MQ,AR,2010.0,1,1,0
GB,BH,2009.0,2,2,0
KR,GE,2007.0,2,1,1
BA,FR,2010.0,1,1,0
AU,MA,2020.0,1,1,0
FR,AU,2023.0,1,3,-2
PS,SE,2018.0,1,2,-1
ID,SE,2004.0,1,1,0
BD,TW,2011.0,2,4,-2
BW,CN,2016.0,2,1,1
PE,IN,2021.0,1,1,0
RS,KZ,2010.0,2,1,1
BA,PL,2017.0,4,3,1
GH,NO,2022.0,2,2,0
GR,SE,2006.0,2,7,-5
BG,JP,2017.0,1,3,-2
CY,ES,2011.0,1,1,0
DK,MX,2018.0,2,7,-5
BA,FR,2017.0,2,1,1
GA,CM,2019.0,2,2,0
IR,DZ,2012.0,1,2,-1
JP,TN,2002.0,2,2,0
TR,SI,2016.0,2,1,1
FJ,GB,2021.0,1,1,0
AE,KW,2009.0,3,3,0
VG,CN,2010.0,2,2,0
HR,MX,2013.0,1,2,-1
BH,GB,2008.0,2,3,-1
PK,TN,2018.0,2,3,-1
AM,GR,2018.0,1,1,0
CH,TZ,2014.0,2,2,0
NO,IR,2009.0,1,4,-3
UY,SE,2020.0,2,1,1
PT,BE,2001.0,2,2,0
JM,CH,2018.0,1,1,0
CY,CH,2019.0,1,3,-2
DE,ML,2013.0,1,1,0
ZW,CZ,2019.0,3,1,2
IR,SG,2005.0,1,1,0
NZ,AE,2018.0,2,4,-2
LS,ZA,2006.0,1,2,-1
PH,DK,2015.0,1,1,0
EE,CZ,2020.0,2,3,-1
MY,KW,2014.0,2,3,-1
DE,XK,2014.0,3,1,2
KW,FR,2022.0,3,2,1
DE,YE,2017.0,1,1,0
CM,CI,2019.0,1,2,-1
UA,CA,2007.0,3,4,-1
CM,ET,2021.0,1,1,0
PK,LT,2008.0,2,3,-1
DZ,GB,2004.0,1,1,0
ZM,GH,2003.0,1,1,0
ID,KE,2019.0,2,12,-10
CL,GT,2018.0,1,3,-2
RO,DK,2015.0,1,2,-1
CM,NL,2019.0,1,3,-2
LV,SE,2007.0,1,2,-1
KE,UG,2007.0,1,2,-1
BE,GM,2019.0,2,1,1
IT,LB,2007.0,2,9,-7
FJ,US,1998.0,1,1,0
IQ,CN,2013.0,2,10,-8
DO,CU,2012.0,1,2,-1
PT,PL,2005.0,1,3,-2
HU,MA,2019.0,1,1,0
ZA,MA,2017.0,2,2,0
MK,GB,2012.0,1,7,-6
VN,CO,2017.0,1,1,0
UZ,KZ,2007.0,2,3,-1
DO,PY,2020.0,1,1,0
HK,CN,2000.0,3,2,1
UG,NL,2008.0,1,1,0
KZ,PK,2019.0,1,2,-1
NG,AE,2016.0,1,1,0
CA,GP,2007.0,1,1,0
GL,SE,2006.0,1,1,0
IT,CD,2020.0,1,1,0
YE,EG,2014.0,3,5,-2
DE,AE,2005.0,1,3,-2
IN,ML,2021.0,1,2,-1
NZ,IR,2014.0,3,8,-5
IR,MY,2006.0,2,2,0
LV,TR,2018.0,1,1,0
TG,CA,2019.0,1,1,0
ID,NL,2000.0,2,2,0
VE,CH,2002.0,1,1,0
JP,PT,2022.0,3,3,0
SG,IT,2003.0,1,4,-3
CH,MD,2014.0,1,3,-2
GB,BW,2022.0,2,1,1
DE,ZM,2018.0,3,1,2
PT,EG,2018.0,4,1,3
CH,MC,2018.0,1,1,0
TN,PA,2013.0,1,4,-3
NG,SA,2010.0,1,6,-5
SE,JO,2011.0,1,3,-2
IT,LU,2006.0,1,1,0
NI,MX,2010.0,1,4,-3
BF,BJ,2015.0,1,2,-1
BO,MX,2009.0,2,4,-2
NP,DE,2015.0,1,4,-3
BJ,NL,2007.0,1,1,0
IQ,PK,2012.0,1,1,0
KW,TN,2018.0,1,2,-1
MA,CN,2013.0,1,1,0
NO,AR,2010.0,1,2,-1
DE,AE,2002.0,2,1,1
SD,KE,1999.0,1,1,0
FI,BG,2018.0,1,1,0
US,HN,2001.0,1,2,-1
JP,JO,2007.0,3,3,0
CY,NL,2013.0,1,3,-2
VE,CA,2020.0,1,6,-5
AT,LK,2022.0,1,2,-1
RS,CL,2013.0,1,2,-1
CO,BE,1999.0,1,2,-1
ID,KW,2020.0,1,3,-2
DE,CW,2016.0,2,1,1
CD,ZA,2022.0,2,1,1
FR,PH,2017.0,2,7,-5
IR,JP,1997.0,1,4,-3
PT,VE,2017.0,3,5,-2
ZA,IL,2022.0,1,2,-1
CH,VU,2010.0,1,1,0
ZA,ZM,2002.0,1,1,0
MZ,LT,2010.0,2,2,0
CH,BI,2015.0,1,1,0
JO,JP,2018.0,1,2,-1
TR,PG,2019.0,1,2,-1
EE,HU,2017.0,1,2,-1
HK,PL,2014.0,1,1,0
NP,PT,2007.0,1,1,0
OM,JO,2003.0,1,1,0
RU,VG,2018.0,1,3,-2
PA,SE,2017.0,1,1,0
GE,ES,2020.0,1,1,0
AE,MY,2003.0,2,1,1
SA,BE,2011.0,1,2,-1
FR,BY,2007.0,2,1,1
EG,GH,2013.0,1,1,0
TW,LU,2013.0,1,1,0
CA,BJ,2018.0,2,5,-3
TN,DE,2012.0,1,8,-7
BA,GB,2016.0,2,8,-6
ET,MW,2014.0,1,1,0
BE,SK,2011.0,2,6,-4
nan,HU,2011.0,1,2,-1
IN,PL,1999.0,1,1,0
BJ,GB,2007.0,1,1,0
HU,GR,2001.0,1,1,0
US,GP,1999.0,1,1,0
LK,FR,2012.0,1,3,-2
BY,SE,2005.0,1,1,0
TZ,PK,2021.0,1,4,-3
SV,BR,2002.0,1,1,0
JO,AU,2002.0,1,1,0
nan,VE,2015.0,1,3,-2
JP,EE,2013.0,1,2,-1
ES,MT,2014.0,1,5,-4
GE,CA,1998.0,1,1,0
TR,AZ,2007.0,1,6,-5
BG,JP,2019.0,1,3,-2
CL,SV,2008.0,1,3,-2
CM,CH,2007.0,1,1,0
QA,PL,2018.0,2,1,1
DO,AR,2015.0,1,2,-1
NG,FI,2016.0,1,1,0
AE,DK,2015.0,1,1,0
CR,NL,2018.0,1,2,-1
US,ST,2006.0,1,2,-1
RU,NI,2014.0,1,1,0
AT,PE,2016.0,1,1,0
CA,MN,2019.0,1,1,0
EG,TR,2023.0,1,1,0
KZ,PK,2017.0,1,1,0
IR,CL,2015.0,1,1,0
US,KG,2012.0,1,6,-5
DE,YE,2019.0,1,2,-1
MR,ML,2019.0,1,1,0
FI,AR,2019.0,1,1,0
BH,BD,2016.0,2,1,1
DE,FJ,2015.0,1,1,0
BD,SE,2003.0,2,1,1
OM,TR,2010.0,1,2,-1
NO,SK,2009.0,1,2,-1
DE,GA,2007.0,8,1,7
TR,OM,2008.0,1,1,0
LU,AT,2014.0,2,3,-1
AE,BR,2015.0,2,1,1
KE,VN,2020.0,2,1,1
DO,US,2006.0,1,1,0
BY,JP,2017.0,1,1,0
SY,IN,2005.0,1,1,0
GR,QA,2018.0,1,2,-1
NI,CU,2014.0,1,1,0
FI,PT,2022.0,1,4,-3
NI,AR,2014.0,1,1,0
NZ,CZ,2009.0,1,2,-1
SV,CO,2021.0,2,1,1
DK,GW,2017.0,1,7,-6
BW,IE,2015.0,1,1,0
IN,TN,2018.0,5,9,-4
SK,MX,2022.0,1,4,-3
MW,KE,2018.0,1,2,-1
RS,JP,2013.0,1,6,-5
BY,BG,2007.0,1,1,0
HK,MY,2021.0,1,1,0
CR,PH,2003.0,1,1,0
IT,GN,2014.0,1,0,1
VN,RS,2012.0,1,0,1
NO,MK,2022.0,1,0,1
DZ,ZA,2016.0,1,0,1
KZ,PK,2010.0,2,0,2
ZW,NZ,2017.0,1,0,1
LT,IE,2022.0,1,0,1
DZ,CZ,2019.0,1,0,1
GR,ZA,2011.0,3,0,3
AZ,IE,2020.0,1,0,1
SI,TR,2017.0,1,0,1
AU,MW,1999.0,2,0,2
PK,AL,2015.0,1,0,1
NA,KE,2014.0,1,0,1
US,BS,2003.0,1,0,1
GE,SA,2006.0,1,0,1
RO,TW,2013.0,2,0,2
CN,VE,2014.0,2,0,2
MY,SI,2005.0,1,0,1
IT,LI,2017.0,1,0,1
MZ,DE,2021.0,1,0,1
GM,CA,2017.0,1,0,1
BE,GW,2019.0,1,0,1
US,SM,2019.0,2,0,2
GR,nan,2012.0,1,0,1
LU,,1999.0,2,0,2
ES,IS,2002.0,1,0,1
SZ,ZM,2013.0,1,0,1
JO,BR,2006.0,1,0,1
VE,PL,2002.0,2,0,2
PY,PT,2003.0,2,0,2
,GI,2002.0,1,0,1
SG,CL,2021.0,2,0,2
LV,GE,2016.0,1,0,1
UY,PY,2011.0,1,0,1
WS,,2013.0,1,0,1
CO,LV,2019.0,1,0,1
ID,NI,2020.0,1,0,1
MA,PL,2018.0,1,0,1
KY,GB,2015.0,1,0,1
NL,DZ,2021.0,1,0,1
FI,VN,2011.0,1,0,1
nan,KW,2011.0,1,0,1
SD,DK,2001.0,1,0,1
RS,PH,2011.0,1,0,1
HK,IN,2021.0,1,0,1
KR,IE,1999.0,1,0,1
IS,SG,2019.0,3,0,3
NZ,BW,2003.0,1,0,1
MR,DZ,2018.0,1,0,1
MG,JP,2014.0,2,0,2
GB,MU,2004.0,2,0,2
BJ,LU,2021.0,1,0,1
UA,HU,2003.0,1,0,1
ZW,UG,2006.0,1,0,1
UZ,AL,2007.0,1,0,1
OM,NL,2006.0,1,0,1
EG,TW,2003.0,1,0,1
TW,NZ,2023.0,1,0,1
BD,SD,2005.0,1,0,1
JP,PW,2013.0,1,0,1
LI,IT,2009.0,1,0,1
UA,AT,1998.0,1,0,1
TN,FI,2014.0,1,0,1
ZW,KE,2016.0,1,0,1
TD,DE,2017.0,1,0,1
SY,IE,2021.0,2,0,2
FR,LY,2008.0,2,0,2
CM,DK,2021.0,2,0,2
PH,ML,2019.0,1,0,1
PK,CG,2013.0,2,0,2
NG,CZ,2014.0,2,0,2
BE,ZM,2018.0,1,0,1
CN,XK,2019.0,1,0,1
BH,TZ,1999.0,2,0,2
AM,GB,2006.0,1,0,1
BE,SR,2015.0,1,0,1
BS,US,2004.0,1,0,1
ER,MY,2018.0,1,0,1
AR,EC,2008.0,4,0,4
PK,nan,2004.0,1,0,1
ES,BG,1997.0,1,0,1
TR,PL,2005.0,1,0,1
BR,LK,2009.0,1,0,1
TN,SD,2011.0,1,0,1
SE,HK,2023.0,1,0,1
KR,BO,2001.0,1,0,1
SN,MG,1998.0,1,0,1
MY,KG,2022.0,1,0,1
SY,IN,2002.0,2,0,2
MK,HR,2017.0,1,0,1
GP,US,2022.0,1,0,1
BZ,CA,2001.0,1,0,1
PW,DK,2006.0,1,0,1
SY,MA,2018.0,1,0,1
MZ,CO,2003.0,1,0,1
IS,CA,2007.0,2,0,2
KZ,UY,2014.0,2,0,2
GE,PK,2012.0,2,0,2
DK,CY,2020.0,1,0,1
TR,BD,2008.0,1,0,1
AT,GE,2021.0,1,0,1
CY,PS,2003.0,1,0,1
IR,KZ,2014.0,1,0,1
VN,ET,2009.0,1,0,1
CA,GL,2000.0,2,0,2
TH,FI,1999.0,1,0,1
AL,NL,2016.0,1,0,1
GH,ZM,2000.0,1,0,1
AT,GH,1999.0,1,0,1
PF,GB,2019.0,1,0,1
PK,ET,2016.0,1,0,1
CR,IL,2007.0,1,0,1
LK,ZA,2021.0,1,0,1
NG,CY,2013.0,1,0,1
MK,CA,2006.0,1,0,1
GM,NL,2011.0,1,0,1
LV,RS,2019.0,1,0,1
GR,MY,2014.0,1,0,1
BR,PR,2009.0,1,0,1
SD,AT,2015.0,1,0,1
CM,GM,2020.0,1,0,1
CA,PA,2005.0,2,0,2
FR,MK,1997.0,1,0,1
PR,UG,2014.0,1,0,1
ME,IT,2019.0,1,0,1
ML,BD,2007.0,1,0,1
CU,CN,2008.0,1,0,1
KR,KZ,2023.0,1,0,1
TR,XK,2018.0,1,0,1
AU,LT,2008.0,1,0,1
PF,GR,2021.0,1,0,1
BW,CA,2010.0,1,0,1
DE,CG,2019.0,1,0,1
NP,EG,2020.0,1,0,1
NZ,OM,2001.0,1,0,1
PK,TZ,2012.0,2,0,2
nan,IE,1997.0,1,0,1
PH,FI,2003.0,1,0,1
MG,LU,2010.0,1,0,1
DE,MW,2003.0,1,0,1
SG,NP,2008.0,2,0,2
FI,JO,2019.0,1,0,1
NC,CO,2015.0,1,0,1
IN,GY,2001.0,1,0,1
ZW,KR,2017.0,1,0,1
BR,GP,2022.0,1,0,1
IN,LB,2006.0,2,0,2
ML,GN,2007.0,1,0,1
NI,AU,2007.0,1,0,1
IN,JM,2014.0,1,0,1
CL,AM,2004.0,1,0,1
BR,NP,2021.0,1,0,1
AU,PS,2006.0,1,0,1
NC,VU,2012.0,1,0,1
TJ,PL,2016.0,1,0,1
JE,MG,2007.0,1,0,1
HU,PT,2006.0,1,0,1
CH,VU,2019.0,1,0,1
GR,IR,2013.0,1,0,1
AR,PY,1998.0,1,0,1
BR,BJ,2021.0,1,0,1
XK,GB,2000.0,1,0,1
RU,CU,2000.0,1,0,1
IL,KE,2013.0,1,0,1
MW,IE,2013.0,1,0,1
BA,TR,2011.0,1,0,1
AE,MX,2006.0,1,0,1
IT,MM,2016.0,1,0,1
SE,KW,2014.0,1,0,1
LA,IT,2022.0,1,0,1
ML,DE,2003.0,1,0,1
NO,CD,2006.0,1,0,1
KR,MX,2002.0,1,0,1
HN,nan,2005.0,1,0,1
HR,LT,2013.0,1,0,1
nan,AM,2020.0,1,0,1
SY,PH,2013.0,1,0,1
BY,DK,2010.0,1,0,1
PH,OM,2012.0,1,0,1
SV,VE,2018.0,1,0,1
HU,EE,2016.0,1,0,1
IN,KZ,1999.0,1,0,1
IT,EC,2023.0,1,0,1
HR,ID,2016.0,1,0,1
DK,HK,2021.0,1,0,1
IR,CY,2008.0,1,0,1
YE,AT,2015.0,1,0,1
SN,DE,2010.0,1,0,1
GP,IL,2019.0,1,0,1
NO,GL,2016.0,1,0,1
UZ,DE,1998.0,1,0,1
BD,RS,2015.0,1,0,1
SS,SE,2013.0,1,0,1
LB,NZ,2019.0,1,0,1
TW,ZA,1998.0,1,0,1
JM,BS,2009.0,1,0,1
JE,MU,2013.0,1,0,1
IE,UG,2004.0,1,0,1
CL,PK,2001.0,1,0,1
BD,IT,2008.0,1,0,1
KR,VG,2021.0,1,0,1
BW,CA,2017.0,1,0,1
FI,RS,2004.0,1,0,1
BY,SE,2002.0,1,0,1
KH,BE,2012.0,1,0,1
SI,IL,2021.0,1,0,1
ID,BG,2016.0,1,0,1
BD,MZ,1998.0,1,0,1
EC,AO,2012.0,1,0,1
BR,DO,2001.0,1,0,1
VG,DE,2017.0,1,0,1
SA,PS,2001.0,1,0,1
PL,EE,2000.0,1,0,1
HR,RO,2012.0,1,0,1
MR,ML,2017.0,1,0,1
MX,PY,2008.0,1,0,1
AR,AT,1999.0,1,0,1
SK,EE,2018.0,1,0,1
LV,BY,2009.0,1,0,1
NO,MZ,2002.0,1,0,1
ES,SL,2021.0,1,0,1
BR,BF,2015.0,1,0,1
KN,AU,2021.0,1,0,1
PH,MY,2003.0,1,0,1
IQ,NL,2017.0,1,0,1
RE,GB,2021.0,1,0,1
BY,KG,2022.0,1,0,1
XK,ME,2009.0,1,0,1
DK,SJ,2003.0,1,0,1
CH,BW,2008.0,1,0,1
AM,GE,1999.0,1,0,1
YE,KW,2001.0,1,0,1
MX,KZ,2017.0,1,0,1
MY,CZ,2001.0,1,0,1
KE,ZW,2014.0,1,0,1
nan,MZ,2010.0,1,0,1
ID,MM,2015.0,1,0,1
VN,KH,2021.0,1,0,1
BI,US,2023.0,1,0,1
,MC,2020.0,1,0,1
CN,XK,2017.0,1,0,1
MM,BN,2022.0,1,0,1
UG,IL,2014.0,1,0,1
CA,GN,2011.0,1,0,1
ES,PK,1999.0,1,0,1
CO,UA,2018.0,1,0,1
VG,JP,2020.0,1,0,1
ES,CR,2011.0,36,24,12
US,FR,2007.0,1182,1255,-73
GB,DE,2007.0,558,726,-168
DE,US,2000.0,1668,1521,147
US,CN,2006.0,6850,4288,2562
GB,AU,2013.0,1511,1138,373
ES,VE,2005.0,54,54,0
FR,US,2013.0,1539,1459,80
US,ES,2014.0,930,1102,-172
TW,CN,2020.0,1382,889,493
CA,RO,2008.0,9,3,6
AR,CL,2004.0,36,33,3
AU,DE,2020.0,249,252,-3
IT,CH,2020.0,330,307,23
CH,DE,2012.0,726,959,-233
DE,BG,2017.0,26,25,1
JP,EG,2016.0,76,59,17
ES,CN,2021.0,65,54,11
CN,TW,2007.0,591,1114,-523
US,JP,2003.0,1662,1970,-308
BE,GB,2012.0,121,133,-12
CN,US,2004.0,3781,5106,-1325
BE,NL,2009.0,219,210,9
KR,US,2000.0,422,518,-96
VN,TH,2016.0,8,15,-7
US,TR,2015.0,491,449,42
KZ,RU,2016.0,46,50,-4
US,UY,2022.0,13,15,-2
CN,MY,2003.0,11,10,1
MY,GB,2012.0,75,181,-106
BE,ZA,2013.0,30,13,17
ES,ID,2008.0,10,9,1
NG,CA,2011.0,13,4,9
ES,EC,2013.0,70,17,53
CO,ES,2020.0,553,517,36
CA,CN,2007.0,442,304,138
CO,GB,2010.0,16,21,-5
PK,CH,2011.0,21,11,10
FR,IT,2015.0,338,433,-95
ES,PT,2020.0,194,180,14
CL,ES,1999.0,43,47,-4
NO,SE,1997.0,32,23,9
GB,IR,2016.0,102,107,-5
AR,AU,2020.0,17,16,1
PK,US,2019.0,523,436,87
FR,IE,2021.0,33,24,9
US,MY,2016.0,199,186,13
IE,DK,2008.0,9,3,6
DE,AU,2011.0,243,177,66
IT,US,2002.0,653,645,8
RU,UA,2009.0,133,135,-2
NZ,IE,2016.0,15,17,-2
BD,IN,2009.0,37,47,-10
US,JO,2004.0,25,12,13
JP,CN,2018.0,542,436,106
US,GE,2001.0,83,69,14
IR,GB,2009.0,56,71,-15
HK,RO,2014.0,25,11,14
CO,nan,2013.0,8,6,2
AU,IN,2011.0,103,125,-22
nan,IL,2008.0,20,15,5
CH,JP,2013.0,75,92,-17
MY,AU,2021.0,65,53,12
EG,MY,1999.0,2,2,0
DE,LU,2002.0,7,2,5
SE,DE,2006.0,117,115,2
PA,PE,2017.0,2,4,-2
SK,RU,2008.0,8,14,-6
ZA,NL,2012.0,35,45,-10
AM,KR,2000.0,2,4,-2
US,NG,2016.0,98,88,10
FR,BE,1999.0,139,124,15
US,IR,2013.0,269,578,-309
CA,nan,2003.0,13,9,4
IN,CA,2016.0,239,233,6
NL,HK,2017.0,24,22,2
CO,CL,2011.0,155,156,-1
FR,BD,2015.0,7,7,0
GB,ES,2001.0,136,132,4
MY,NG,2020.0,138,65,73
LT,RU,2017.0,10,9,1
RO,GB,2021.0,54,57,-3
FR,GB,2009.0,534,499,35
CN,nan,2018.0,101,137,-36
AR,US,2008.0,196,197,-1
IT,TR,1999.0,13,6,7
AU,SG,2004.0,34,45,-11
RS,RU,2019.0,20,20,0
SE,CL,2001.0,5,1,4
CA,DE,2011.0,275,275,0
NI,PE,2018.0,8,2,6
JP,GR,1998.0,33,29,4
IE,NZ,2021.0,14,12,2
TR,CH,2013.0,24,20,4
MX,CA,2021.0,41,32,9
MA,ES,2007.0,7,4,3
EG,JP,2004.0,42,46,-4
GB,DK,2018.0,144,156,-12
GB,nan,2011.0,91,79,12
DE,BE,2008.0,91,81,10
ES,DK,2013.0,43,23,20
NO,DK,1999.0,33,19,14
JP,IT,2004.0,37,45,-8
SK,JP,2001.0,17,24,-7
US,AR,2004.0,141,212,-71
HR,RS,2013.0,135,91,44
HN,CL,2001.0,1,1,0
ZA,CA,2003.0,28,17,11
PL,CN,2016.0,21,23,-2
US,CU,2010.0,27,26,1
ES,PL,2015.0,29,22,7
GB,AT,2005.0,48,60,-12
DK,GB,2011.0,89,128,-39
PK,DE,2014.0,18,38,-20
AT,IT,2014.0,32,58,-26
BG,UA,2021.0,9,13,-4
PE,nan,2010.0,7,8,-1
AE,US,2020.0,83,103,-20
EG,QA,2018.0,61,59,2
NL,FR,2016.0,179,186,-7
NL,DK,2013.0,37,25,12
DE,GR,2016.0,56,80,-24
EG,SE,2020.0,13,8,5
ID,US,2012.0,61,90,-29
TN,CA,2017.0,13,15,-2
DE,AT,2014.0,656,528,128
HU,RO,2005.0,31,21,10
BR,DK,2009.0,7,11,-4
AU,EG,2015.0,16,18,-2
BR,BE,1999.0,9,13,-4
AG,TR,2020.0,133,331,-198
SI,HR,2015.0,42,22,20
IL,GB,2020.0,68,78,-10
BD,KR,2015.0,34,17,17
CO,DE,2003.0,7,4,3
US,FI,2009.0,233,127,106
CO,GB,2019.0,35,39,-4
LU,US,1999.0,2,2,0
IN,CN,2016.0,197,104,93
ID,CN,2000.0,3,3,0
KR,TW,2001.0,24,16,8
FR,CN,2000.0,80,59,21
CN,RU,2006.0,27,33,-6
CZ,CN,2011.0,51,56,-5
CN,ES,2011.0,77,76,1
CN,PE,2014.0,2,2,0
NL,GR,2014.0,20,42,-22
CN,IL,2009.0,22,28,-6
DK,JP,2009.0,13,25,-12
CN,UZ,2010.0,9,25,-16
IN,SG,2018.0,176,141,35
ES,FR,2022.0,184,174,10
RU,GB,2001.0,80,33,47
US,ZA,2016.0,345,364,-19
MY,AE,2020.0,28,10,18
NZ,AU,2015.0,213,179,34
US,SG,2022.0,248,252,-4
US,PK,2014.0,235,203,32
JP,VN,2019.0,87,33,54
US,NP,2014.0,39,71,-32
US,AM,2009.0,7,16,-9
RU,PK,2009.0,2,1,1
ID,JP,2011.0,44,127,-83
IT,US,2005.0,745,640,105
CH,ID,2004.0,1,1,0
TR,GB,2011.0,52,87,-35
SE,IL,2022.0,6,6,0
NL,CO,2017.0,15,13,2
CH,CN,2002.0,31,36,-5
MY,BR,2016.0,59,28,31
nan,FR,2015.0,206,202,4
NA,US,2021.0,6,5,1
CN,TR,2001.0,14,9,5
DZ,FR,2012.0,61,146,-85
FI,US,2007.0,121,157,-36
GR,DK,2022.0,7,5,2
DE,DK,2021.0,160,146,14
GB,NL,2016.0,311,384,-73
SE,CN,2001.0,37,25,12
GB,TR,2020.0,121,149,-28
AT,CH,2021.0,100,94,6
US,DZ,2018.0,88,50,38
nan,RU,2003.0,24,37,-13
IL,RU,2020.0,39,54,-15
US,AT,2014.0,263,246,17
CN,EG,2017.0,39,37,2
BR,EC,2006.0,5,3,2
SA,IT,2020.0,7,16,-9
DE,BY,2008.0,8,8,0
AU,KZ,2019.0,6,1,5
JO,AU,2007.0,3,6,-3
CN,UZ,2019.0,12,8,4
ES,VE,2002.0,30,47,-17
PK,US,2010.0,138,150,-12
US,RS,2013.0,67,57,10
CA,NL,2021.0,78,61,17
LV,CZ,2017.0,1,1,0
CA,BR,2017.0,261,245,16
MA,FR,2003.0,126,148,-22
TR,nan,2016.0,24,16,8
CZ,JP,2014.0,15,19,-4
MX,BR,2016.0,127,135,-8
GB,TH,2018.0,76,42,34
SE,GH,2017.0,3,1,2
MW,US,2001.0,2,4,-2
US,BG,2012.0,25,29,-4
CO,PT,2022.0,9,10,-1
EG,BE,2014.0,8,8,0
CO,JP,2013.0,9,7,2
IN,PH,2018.0,21,15,6
VE,CO,2012.0,66,40,26
RU,TN,2008.0,1,1,0
FR,LB,2013.0,91,39,52
US,CZ,2022.0,92,74,18
PL,DE,2014.0,135,143,-8
IN,AU,2005.0,58,39,19
AU,NO,2017.0,25,15,10
SK,US,2017.0,32,33,-1
CO,US,2003.0,81,88,-7
IN,NP,2007.0,31,25,6
ZA,ID,2020.0,160,213,-53
NL,IT,2018.0,96,150,-54
PK,HU,2022.0,2,1,1
PH,CO,2019.0,10,8,2
CZ,IN,2007.0,20,26,-6
VE,US,2011.0,49,35,14
IT,DZ,2003.0,11,1,10
CN,EG,2010.0,20,20,0
AU,JO,2006.0,4,2,2
VN,IR,2022.0,7,1,6
US,CU,2017.0,30,46,-16
CA,ID,2022.0,21,15,6
CN,EG,2019.0,54,51,3
DE,HU,2010.0,54,56,-2
SA,BH,2015.0,9,4,5
CH,SE,1999.0,20,22,-2
MX,VE,2022.0,12,15,-3
DE,LU,2005.0,12,3,9
ZA,US,2000.0,136,133,3
IN,IT,2015.0,54,49,5
SG,KR,2022.0,21,19,2
FR,DK,2016.0,59,44,15
GH,DE,2010.0,4,6,-2
GR,JP,1998.0,29,33,-4
CA,QA,2007.0,5,2,3
KR,PL,2017.0,4,10,-6
SE,IN,2001.0,16,16,0
CN,BD,2016.0,58,94,-36
DE,HU,2019.0,59,64,-5
CN,IT,2015.0,33,50,-17
GB,IQ,2014.0,43,12,31
CN,SE,1999.0,26,27,-1
CZ,RU,2011.0,21,33,-12
NE,US,2004.0,1,2,-1
ES,CH,2003.0,37,38,-1
ID,ES,2018.0,20,12,8
nan,IT,2016.0,132,95,37
nan,PL,2021.0,10,8,2
ID,XK,2016.0,1,1,0
LY,US,2013.0,5,3,2
TR,AU,2019.0,21,16,5
FR,CA,2023.0,15,16,-1
SE,RU,2018.0,30,34,-4
CR,MX,2017.0,53,39,14
TN,EG,2015.0,17,9,8
IT,QA,2017.0,7,2,5
SE,ZA,2011.0,14,8,6
CN,LT,2014.0,9,3,6
GB,RS,2018.0,19,30,-11
RS,GB,2020.0,16,17,-1
NL,HR,2017.0,6,6,0
US,VG,2010.0,18,12,6
ES,NO,2002.0,10,14,-4
PE,nan,2019.0,12,14,-2
HT,US,2018.0,3,6,-3
JP,VN,2017.0,73,37,36
CH,CZ,2014.0,37,34,3
GB,NO,2014.0,88,72,16
CH,MA,2017.0,4,5,-1
VE,CH,2007.0,2,1,1
IR,ID,2020.0,40,19,21
PT,DK,2013.0,11,10,1
TN,CA,2019.0,20,10,10
ID,FR,2020.0,29,38,-9
ES,FI,2021.0,22,25,-3
HU,PL,2009.0,11,14,-3
PL,SA,2015.0,2,6,-4
IL,EG,2016.0,6,4,2
KE,US,2016.0,93,106,-13
IT,QA,2019.0,7,7,0
KZ,KG,2021.0,12,1,11
TH,GB,2008.0,24,43,-19
SE,IS,1999.0,7,6,1
SA,JO,2018.0,59,40,19
IT,nan,2011.0,133,83,50
PT,EC,2018.0,9,8,1
CU,CR,2020.0,22,32,-10
EE,FI,2019.0,12,12,0
CZ,ES,2011.0,5,11,-6
SA,US,2003.0,32,49,-17
AL,DE,2021.0,2,1,1
MY,IQ,2022.0,50,33,17
DE,ES,2018.0,236,321,-85
CR,BR,2022.0,8,9,-1
nan,PK,2020.0,10,2,8
IN,SK,2013.0,5,2,3
GB,MX,2008.0,59,40,19
LU,BE,2021.0,10,13,-3
DK,QA,2022.0,2,2,0
NG,IQ,2022.0,1,2,-1
nan,GB,2009.0,82,68,14
PE,MX,2013.0,61,97,-36
CN,CH,2005.0,52,45,7
VN,CN,2021.0,18,21,-3
AE,CN,2023.0,2,1,1
UZ,KR,2018.0,2,3,-1
HU,NG,2021.0,12,1,11
GB,MY,2004.0,33,25,8
AT,LU,2022.0,2,3,-1
ID,GB,2021.0,72,71,1
NG,PT,2021.0,2,1,1
ID,SE,2020.0,10,8,2
MY,ES,2022.0,6,1,5
DE,IE,2021.0,68,71,-3
NO,LK,2021.0,4,1,3
BR,JP,2009.0,45,41,4
SG,DE,2022.0,18,22,-4
BR,NO,2020.0,31,20,11
QA,CN,2005.0,4,2,2
GR,FR,2010.0,31,29,2
RU,SE,2008.0,38,13,25
FR,PT,2020.0,68,46,22
CA,BG,2014.0,6,3,3
IT,RS,2017.0,10,7,3
ZA,TZ,2018.0,12,7,5
PA,PE,2019.0,5,5,0
JP,ID,1999.0,16,3,13
ES,PH,2012.0,14,11,3
FR,NC,2011.0,14,11,3
BE,JP,2021.0,11,15,-4
IT,AR,2018.0,113,104,9
IN,AU,2002.0,40,30,10
JP,CA,2009.0,128,129,-1
US,KW,2016.0,26,20,6
US,BO,2018.0,14,12,2
SK,US,2019.0,42,36,6
AT,BA,2019.0,2,3,-1
BF,FR,2010.0,6,9,-3
JP,GR,1997.0,22,17,5
DE,BG,2019.0,39,27,12
GB,AT,2002.0,37,42,-5
JO,FR,2015.0,6,1,5
SG,MX,2003.0,5,5,0
CZ,BG,2003.0,2,1,1
GR,JP,1997.0,17,22,-5
BE,TH,2006.0,1,3,-2
JP,VN,2010.0,33,18,15
UY,CH,2019.0,3,1,2
TH,BR,2019.0,5,2,3
IT,RU,2000.0,22,27,-5
AT,RU,2018.0,29,21,8
CA,LU,2014.0,5,4,1
VE,CU,2001.0,2,3,-1
AU,KR,2011.0,24,37,-13
DK,nan,2014.0,23,20,3
AU,ID,2012.0,44,21,23
AU,NO,2019.0,21,27,-6
FR,KH,2013.0,5,2,3
TT,US,2010.0,9,9,0
GB,SG,2009.0,99,67,32
IT,AE,2010.0,1,1,0
CO,VE,2006.0,20,18,2
BE,MX,2015.0,19,16,3
PE,CA,2018.0,6,3,3
GB,PH,2019.0,26,21,5
JP,MY,2017.0,69,50,19
CM,GB,2022.0,5,4,1
PK,CN,2009.0,66,55,11
SA,GB,2003.0,17,23,-6
ES,PS,2014.0,18,8,10
US,PA,2016.0,77,55,22
FR,IR,2022.0,10,32,-22
DE,IL,1997.0,31,21,10
PL,FR,2015.0,40,46,-6
TH,KR,2020.0,14,21,-7
MG,CN,2019.0,4,8,-4
FI,PL,2013.0,6,4,2
DE,HU,2017.0,61,77,-16
CR,MX,2019.0,44,56,-12
CZ,TH,2018.0,3,1,2
BR,MY,2016.0,28,59,-31
GB,CY,2016.0,41,31,10
NP,NO,2017.0,2,4,-2
SE,CO,2008.0,6,1,5
EG,YE,2020.0,14,6,8
PH,JP,2009.0,14,15,-1
CG,FR,2016.0,27,16,11
BE,PL,2007.0,11,33,-22
CG,BJ,2006.0,1,1,0
ES,ZA,2011.0,4,6,-2
TR,CN,2008.0,9,7,2
AU,IE,2006.0,59,70,-11
TR,TZ,2021.0,3,1,2
FR,CG,2008.0,21,21,0
ID,MA,2020.0,5,7,-2
NL,ES,2009.0,72,66,6
CZ,SK,2023.0,7,3,4
DE,MA,2009.0,9,5,4
NL,GH,2014.0,3,3,0
MX,JP,2013.0,8,12,-4
JP,MY,2010.0,53,20,33
RU,IR,2007.0,5,4,1
US,LT,2002.0,6,9,-3
AR,PE,2015.0,46,59,-13
nan,PT,2008.0,26,33,-7
nan,SE,1999.0,37,25,12
IE,PT,2003.0,3,2,1
DE,BG,2010.0,20,32,-12
FI,QA,2020.0,1,1,0
ES,GR,2008.0,9,12,-3
BF,FR,2019.0,29,21,8
DK,RU,2006.0,4,10,-6
DK,ES,2007.0,20,122,-102
CY,NZ,2014.0,1,1,0
BE,VN,2018.0,14,2,12
PT,MA,2021.0,30,35,-5
KR,ZA,2010.0,2,5,-3
AM,IT,2017.0,29,16,13
KE,AU,2007.0,3,2,1
US,IQ,2001.0,1,4,-3
FI,JP,2009.0,12,16,-4
DK,SE,2007.0,61,100,-39
PT,AT,2017.0,7,1,6
AR,PK,2008.0,9,9,0
TR,AT,2022.0,4,14,-10
LU,RU,2020.0,2,10,-8
TH,CA,2016.0,8,13,-5
UG,DE,2019.0,7,4,3
nan,DK,2006.0,6,14,-8
LT,FR,2015.0,6,2,4
SE,PT,2006.0,7,3,4
JP,MY,2019.0,63,65,-2
UA,US,2014.0,57,59,-2
CZ,BE,2021.0,4,16,-12
EC,RU,2016.0,8,5,3
TR,AU,2017.0,23,11,12
BO,US,2016.0,9,9,0
EG,NG,2013.0,4,3,1
CA,PT,2019.0,14,20,-6
AE,IN,2005.0,1,3,-2
IT,UA,2018.0,28,48,-20
ET,AU,2018.0,20,7,13
NO,SG,2006.0,3,6,-3
ZM,US,2019.0,14,19,-5
NG,KE,2006.0,2,1,1
HU,GB,2000.0,25,28,-3
KR,KP,2014.0,1,2,-1
EC,CA,2022.0,4,2,2
KR,nan,2015.0,23,25,-2
EC,BR,2020.0,41,56,-15
SN,FR,1998.0,9,8,1
TN,CA,2010.0,9,9,0
MY,PK,2011.0,17,43,-26
NL,ID,2013.0,29,20,9
AU,AR,2012.0,8,11,-3
UY,CL,2020.0,23,15,8
SK,US,2010.0,29,33,-4
BE,nan,2004.0,19,19,0
MG,CN,2017.0,8,4,4
NZ,SG,2021.0,13,13,0
SG,AU,1998.0,16,20,-4
NO,SE,1998.0,35,27,8
TR,ES,2015.0,15,5,10
JP,BE,2021.0,15,11,4
GB,VN,2012.0,5,1,4
FR,NG,2015.0,5,5,0
US,CG,2021.0,5,2,3
IL,CH,2021.0,19,19,0
BR,TR,2020.0,13,18,-5
CV,BR,2015.0,1,1,0
CY,GR,2013.0,22,68,-46
AE,FR,2019.0,9,18,-9
ID,PH,2019.0,7,5,2
JP,CO,2022.0,11,5,6
CR,MX,2010.0,23,19,4
ES,NO,2005.0,17,11,6
AU,JP,2003.0,52,56,-4
SE,NO,2000.0,35,29,6
US,LT,2005.0,19,7,12
EG,RU,2021.0,20,26,-6
nan,US,1999.0,108,70,38
IE,SE,1998.0,4,1,3
RU,NZ,2015.0,3,3,0
VN,DE,2022.0,19,10,9
PT,US,2000.0,35,54,-19
EE,FR,2018.0,8,5,3
US,VN,2006.0,24,14,10
ET,BH,2021.0,29,31,-2
PE,UA,2021.0,1,2,-1
IE,OM,2018.0,4,3,1
FR,MC,2021.0,8,4,4
CH,UY,2016.0,3,1,2
BE,SE,2000.0,12,8,4
PK,JP,1997.0,10,5,5
MX,RU,2018.0,14,8,6
GB,YE,2012.0,2,1,1
AU,CH,2022.0,52,37,15
BJ,BE,2020.0,3,7,-4
FI,BE,2022.0,10,11,-1
SE,JP,2011.0,33,52,-19
BY,IN,2021.0,6,9,-3
PH,CH,2018.0,5,6,-1
MX,GR,2019.0,4,3,1
DE,AE,2007.0,7,1,6
nan,NO,1997.0,2,5,-3
AU,NO,2010.0,22,15,7
IT,BG,2005.0,6,9,-3
KR,PL,2010.0,4,6,-2
ZM,GH,2012.0,13,15,-2
HU,ES,2007.0,3,3,0
LV,CZ,2019.0,1,2,-1
AT,FI,2001.0,4,4,0
ST,BR,2007.0,17,12,5
BG,IT,2020.0,6,6,0
LY,DE,2011.0,1,5,-4
EG,ID,2015.0,18,8,10
CZ,ID,2018.0,10,10,0
US,PE,1999.0,15,16,-1
JP,MN,2005.0,2,1,1
GB,JM,2017.0,7,4,3
RU,PT,2009.0,7,3,4
BR,ST,2014.0,24,36,-12
UZ,JP,2008.0,2,3,-1
CZ,IT,2007.0,14,16,-2
EG,SA,2004.0,34,29,5
AU,UA,2022.0,1,1,0
PE,CN,2019.0,2,2,0
DE,UA,2007.0,21,37,-16
NL,JP,2001.0,27,39,-12
BR,NL,2012.0,41,40,1
GB,SA,2004.0,30,15,15
IE,RO,2015.0,2,4,-2
IS,NO,2013.0,11,2,9
ZA,BW,2011.0,6,8,-2
LB,FR,2006.0,17,39,-22
PT,TR,2016.0,5,3,2
PL,nan,2016.0,20,17,3
NO,ET,2011.0,4,4,0
CA,LB,2021.0,11,18,-7
NO,AT,2018.0,9,17,-8
TN,MD,2011.0,11,13,-2
TR,KR,2003.0,5,9,-4
NO,BG,2013.0,2,2,0
SK,AT,2000.0,4,8,-4
KR,PL,2019.0,6,5,1
LT,RU,2010.0,6,20,-14
US,CI,2014.0,6,4,2
DE,NG,2003.0,3,2,1
CA,TR,2008.0,14,27,-13
GR,GB,2003.0,68,127,-59
KE,GB,2022.0,24,28,-4
MY,IN,2006.0,16,26,-10
TW,NL,2018.0,8,8,0
FI,BD,2017.0,5,7,-2
LB,GB,2022.0,9,6,3
GB,ZW,1999.0,5,9,-4
ET,NL,2013.0,1,6,-5
KE,PK,2012.0,12,9,3
PK,RS,2013.0,1,2,-1
AR,NO,2020.0,5,2,3
FI,CH,2022.0,21,15,6
FI,ZA,2006.0,1,3,-2
EE,FI,2017.0,11,18,-7
DE,SG,1998.0,7,1,6
PE,BR,2002.0,4,5,-1
MY,SE,2014.0,4,7,-3
NZ,IT,2013.0,7,14,-7
NL,AT,2014.0,41,25,16
IT,AM,2022.0,17,20,-3
AE,JP,2021.0,1,1,0
IN,BR,2022.0,12,16,-4
PK,IE,1998.0,1,1,0
GB,QA,2011.0,19,9,10
BR,BW,2020.0,1,1,0
BE,MZ,2017.0,5,8,-3
US,RW,2013.0,6,15,-9
BI,FR,2000.0,12,11,1
RS,MK,2021.0,4,1,3
AR,FR,2022.0,42,46,-4
MX,GT,2008.0,2,2,0
GB,JM,2010.0,6,4,2
KR,BD,2009.0,6,6,0
CZ,HU,2018.0,10,10,0
SG,ES,2015.0,4,7,-3
BE,CL,2006.0,3,4,-1
IL,AU,2002.0,10,13,-3
CY,FR,2022.0,5,1,4
PH,MY,2012.0,6,1,5
CH,MX,2020.0,13,29,-16
CO,IE,2013.0,5,1,4
US,BN,2016.0,6,1,5
DE,PS,2018.0,7,4,3
AR,CA,2022.0,16,9,7
PK,NO,2020.0,7,6,1
FR,DZ,1998.0,15,16,-1
QA,SA,2016.0,14,26,-12
GB,AM,2022.0,2,3,-1
MU,CN,2010.0,1,1,0
JO,KW,2019.0,5,11,-6
CN,ID,2011.0,18,21,-3
JM,TT,2003.0,8,6,2
BE,EE,2011.0,2,1,1
IN,AT,2008.0,5,7,-2
PA,CA,2019.0,9,6,3
CD,ZM,2019.0,2,2,0
OM,SA,2015.0,15,12,3
VN,IN,2020.0,11,7,4
IT,AU,1999.0,15,19,-4
SG,PK,2015.0,7,5,2
NL,HK,2010.0,11,16,-5
PH,CN,2012.0,21,24,-3
TW,CA,1999.0,12,21,-9
CA,LK,2011.0,7,2,5
EC,GB,2014.0,5,9,-4
BE,MZ,2019.0,10,4,6
AU,BE,2021.0,31,26,5
FR,PK,2022.0,12,10,2
EG,IN,2022.0,9,8,1
BG,CO,2017.0,2,1,1
ID,TN,2016.0,2,3,-1
KZ,CN,2006.0,6,8,-2
MN,US,2020.0,4,12,-8
RO,RU,2013.0,5,8,-3
EG,TW,2012.0,11,6,5
VN,MX,2019.0,7,7,0
IN,CI,2020.0,1,1,0
AR,BE,2012.0,16,6,10
FI,LT,2021.0,4,2,2
RS,CN,2004.0,5,7,-2
MN,JP,2008.0,3,4,-1
RU,MX,1999.0,19,4,15
CN,CH,2002.0,36,31,5
DZ,GB,2020.0,10,7,3
NO,KE,2022.0,1,4,-3
IT,GE,2006.0,3,1,2
UY,DK,2020.0,1,1,0
IR,TR,2011.0,9,6,3
SA,KW,2005.0,11,2,9
IS,US,2016.0,11,24,-13
US,BW,2015.0,10,21,-11
PT,CU,2010.0,5,3,2
CA,TT,2011.0,3,1,2
IT,FI,2011.0,24,8,16
LU,IT,2018.0,10,14,-4
NZ,NL,2006.0,7,12,-5
JO,SA,2014.0,35,24,11
FR,SN,2004.0,18,13,5
CU,GB,2012.0,6,2,4
AE,NL,2020.0,3,10,-7
BD,SE,2012.0,7,6,1
FR,PL,2003.0,28,34,-6
CA,RW,2018.0,3,1,2
CM,NG,2013.0,1,1,0
PH,CO,2017.0,6,6,0
VE,BR,2001.0,8,4,4
DE,HR,2022.0,14,9,5
ZM,US,2017.0,11,22,-11
ZA,UA,2019.0,5,2,3
RS,IT,2008.0,8,5,3
NL,HK,2019.0,25,15,10
FR,TW,2015.0,6,14,-8
CU,AR,2011.0,14,12,2
EG,FI,2014.0,5,4,1
JP,ZM,2005.0,2,3,-1
IQ,LB,2020.0,7,4,3
CH,NP,2019.0,2,1,1
IT,RO,2009.0,20,6,14
GB,GM,2007.0,6,5,1
DK,AU,2003.0,17,11,6
ZA,BR,2006.0,5,6,-1
TH,IN,2014.0,14,11,3
AR,GB,2000.0,14,14,0
NG,NL,2011.0,2,5,-3
BF,FR,2017.0,11,23,-12
AR,RO,2020.0,1,2,-1
BR,IN,2002.0,8,9,-1
HU,IE,2007.0,2,1,1
US,BA,2014.0,8,4,4
CH,NO,2008.0,15,9,6
AT,nan,2016.0,14,24,-10
ET,CA,2016.0,4,4,0
CH,SI,2013.0,2,6,-4
PT,RU,2015.0,8,5,3
IT,PK,2012.0,10,7,3
ID,KR,2016.0,17,28,-11
CN,MX,2012.0,3,11,-8
BR,SK,2014.0,3,6,-3
KW,IR,2011.0,3,1,2
FI,DE,2000.0,24,24,0
MK,GR,2008.0,9,3,6
CL,FR,2003.0,13,15,-2
IT,EG,2016.0,17,7,10
GH,DE,2017.0,10,10,0
MU,IN,2017.0,3,3,0
MX,FR,1999.0,15,26,-11
DE,IL,1998.0,35,36,-1
QA,IQ,2016.0,5,5,0
TR,NL,2016.0,29,39,-10
IE,HU,2015.0,5,5,0
KW,SA,2004.0,3,2,1
AU,GM,2021.0,1,1,0
MX,PA,2009.0,5,2,3
NL,SK,2001.0,6,11,-5
TR,AU,2010.0,9,9,0
BE,LT,2022.0,2,1,1
ZA,PA,2017.0,2,1,1
nan,LU,2015.0,2,1,1
TN,QA,2021.0,7,5,2
CA,PT,2010.0,13,16,-3
CL,DK,2010.0,4,3,1
NO,IN,2009.0,13,22,-9
NO,SI,2019.0,2,2,0
PA,US,2006.0,17,11,6
ET,JP,2011.0,3,3,0
PE,CU,2010.0,5,3,2
PE,GB,2013.0,8,11,-3
AU,RO,2009.0,2,4,-2
FI,BR,2008.0,4,5,-1
CA,PT,2017.0,20,33,-13
BH,EG,2013.0,3,2,1
ES,AE,2022.0,4,2,2
PG,ZA,2014.0,1,1,0
LK,JP,2006.0,8,21,-13
ZA,nan,2000.0,4,5,-1
QA,SE,2021.0,1,5,-4
KR,FI,2004.0,7,6,1
AO,BR,2018.0,25,42,-17
PT,CL,2002.0,3,1,2
CW,NL,2020.0,7,4,3
VN,US,2006.0,14,24,-10
MX,DO,2009.0,2,3,-1
SG,AU,1997.0,12,13,-1
FR,NE,2003.0,2,2,0
PK,JO,2014.0,1,1,0
MY,MW,2022.0,1,1,0
AR,UY,1999.0,2,2,0
TR,QA,2014.0,5,1,4
AU,SA,2023.0,5,2,3
BD,PK,2002.0,4,3,1
CA,VN,2001.0,7,1,6
SA,CA,2002.0,5,21,-16
PG,GB,2018.0,3,2,1
US,LV,2011.0,9,2,7
UA,IN,2013.0,8,3,5
FR,GR,1999.0,13,7,6
HK,CA,2016.0,4,4,0
RU,BG,2011.0,20,20,0
MM,US,2003.0,2,2,0
CH,BD,2019.0,5,7,-2
FR,GT,2012.0,2,1,1
VN,MX,2017.0,6,19,-13
NZ,KH,2018.0,1,2,-1
BR,CU,2022.0,4,5,-1
US,VG,2019.0,9,10,-1
SI,TW,2021.0,2,1,1
MK,SA,2015.0,1,1,0
NP,CH,2017.0,5,2,3
PL,FI,2013.0,4,6,-2
UA,BR,2014.0,8,3,5
MD,DE,1999.0,4,1,3
GB,JM,2019.0,11,3,8
EG,UA,2019.0,1,5,-4
PK,nan,2020.0,2,10,-8
PA,CA,2010.0,1,6,-5
CY,NO,2021.0,1,1,0
KE,ZM,2019.0,8,3,5
CD,JP,2022.0,2,1,1
MX,HN,2022.0,5,8,-3
GH,DE,2019.0,21,21,0
AU,PG,2015.0,5,5,0
PS,ES,2004.0,4,3,1
US,ZW,2008.0,3,5,-2
PK,LK,2019.0,1,5,-4
UA,IT,2012.0,14,22,-8
PL,TW,1999.0,2,4,-2
US,TN,2014.0,18,34,-16
GB,ET,2020.0,12,24,-12
EE,FI,2010.0,4,10,-6
HR,DE,2009.0,16,22,-6
PL,ES,2021.0,14,25,-11
NL,KE,2015.0,11,2,9
CN,CL,2011.0,2,3,-1
BR,CL,1999.0,7,7,0
CY,IR,2016.0,5,8,-3
DE,TW,2000.0,12,8,4
JM,AU,2015.0,3,1,2
MK,GB,2003.0,2,1,1
NO,IT,2016.0,15,37,-22
NZ,IN,2023.0,1,1,0
TH,VN,2016.0,15,8,7
BF,PK,2003.0,1,1,0
KR,MX,2007.0,4,4,0
IQ,BA,2017.0,4,2,2
CH,GR,2008.0,9,18,-9
HU,FR,2015.0,22,24,-2
PT,CU,2017.0,6,3,3
TN,FR,2003.0,35,78,-43
MD,RU,2016.0,10,3,7
US,MD,2014.0,4,4,0
ES,PY,2009.0,2,5,-3
NZ,JP,2011.0,8,9,-1
TW,DE,2020.0,24,27,-3
AM,IT,2010.0,22,15,7
MX,GR,2010.0,5,3,2
NO,BD,2014.0,1,1,0
ID,CZ,2016.0,6,15,-9
NG,JP,2005.0,9,4,5
MA,PS,2016.0,2,1,1
TT,US,2017.0,4,12,-8
ZA,GR,2008.0,3,2,1
DK,SJ,2012.0,1,1,0
ES,MY,2018.0,5,5,0
CN,TH,2004.0,1,7,-6
KE,CO,2018.0,7,7,0
UA,GB,1998.0,6,3,3
MY,HU,2018.0,1,2,-1
EG,CA,2000.0,7,5,2
AE,FR,2017.0,3,13,-10
IN,OM,2007.0,3,4,-1
FR,DZ,1997.0,7,5,2
CY,CA,2017.0,6,1,5
DK,LU,2016.0,2,1,1
CL,DE,2004.0,22,15,7
KR,AU,1999.0,7,9,-2
SE,GR,1997.0,2,1,1
BE,GR,2016.0,14,22,-8
SE,ET,2007.0,5,3,2
FI,NL,1999.0,7,16,-9
DE,MG,2014.0,1,4,-3
RO,CZ,2006.0,4,1,3
SA,CA,2005.0,19,21,-2
IT,TW,2006.0,4,1,3
LB,TN,2017.0,3,2,1
BE,MZ,2010.0,4,3,1
UA,EC,2015.0,16,46,-30
SI,AU,2021.0,4,4,0
JO,US,2009.0,24,44,-20
CH,GH,2005.0,1,1,0
NP,NO,2010.0,6,4,2
NL,HR,2010.0,8,3,5
HR,CH,2003.0,7,1,6
AT,AE,2013.0,3,1,2
ID,CM,2018.0,2,6,-4
GH,IN,2018.0,10,12,-2
KE,UG,2005.0,4,1,3
AU,QA,2004.0,2,3,-1
US,GH,2000.0,4,6,-2
DE,KE,1997.0,3,1,2
GB,CR,2014.0,5,4,1
TZ,EG,2021.0,3,2,1
GA,NL,2015.0,4,3,1
DK,UA,2012.0,1,3,-2
SA,SY,2011.0,1,1,0
JP,RS,2001.0,8,5,3
AE,NZ,1998.0,1,2,-1
IL,AU,2005.0,13,9,4
PH,CU,2019.0,1,2,-1
NO,IS,2008.0,6,5,1
RU,TW,1999.0,7,5,2
IR,ES,2008.0,2,2,0
PE,CU,2019.0,13,33,-20
RS,ME,2006.0,4,5,-1
MY,IE,2015.0,2,12,-10
HU,CZ,2022.0,6,9,-3
CG,PK,2015.0,3,1,2
RS,RU,2017.0,10,11,-1
BR,GH,2014.0,1,1,0
BE,GE,2017.0,2,1,1
CY,CA,2010.0,2,4,-2
RO,RS,2012.0,2,2,0
CN,PH,2007.0,12,29,-17
MX,BO,2011.0,4,7,-3
PE,CU,2017.0,5,13,-8
PT,CU,2019.0,4,1,3
LT,DE,2004.0,3,4,-1
ZA,PT,2021.0,2,9,-7
QA,PK,2016.0,7,10,-3
AT,ZA,2014.0,2,5,-3
FR,KE,2014.0,6,12,-6
NL,CO,2019.0,17,19,-2
SE,ES,2023.0,2,9,-7
PK,NZ,2019.0,9,17,-8
PE,DE,2020.0,13,10,3
MY,NL,2013.0,4,11,-7
PL,LU,2017.0,5,2,3
KE,UG,2002.0,1,1,0
LT,RU,2019.0,7,8,-1
CL,CH,2004.0,5,1,4
ES,PA,2015.0,17,17,0
SE,GH,2019.0,2,3,-1
CZ,GR,2007.0,6,4,2
IL,NL,2022.0,5,6,-1
NO,JP,2008.0,6,10,-4
AT,SK,2016.0,17,12,5
ZM,US,2010.0,4,11,-7
HR,RU,2019.0,12,9,3
RS,CZ,2006.0,14,16,-2
TR,HR,2008.0,1,1,0
RO,VN,2012.0,3,9,-6
LV,US,2013.0,7,3,4
BG,FR,2018.0,3,3,0
ID,AZ,2019.0,3,5,-2
DK,IN,2008.0,7,12,-5
CH,NP,2017.0,2,5,-3
SA,KW,2002.0,1,2,-1
CA,AE,1998.0,1,2,-1
LU,ES,2021.0,3,6,-3
CO,HN,2021.0,4,2,2
PK,AU,2007.0,7,8,-1
ET,IL,2011.0,2,1,1
IL,BE,2018.0,8,8,0
KR,ZA,2019.0,6,5,1
NP,NL,2010.0,2,2,0
DE,PA,2013.0,4,3,1
AT,BG,2006.0,2,3,-1
US,OM,2011.0,14,7,7
BE,GE,2010.0,1,1,0
DK,RO,2017.0,2,5,-3
JP,LA,2021.0,1,1,0
PE,CN,2017.0,3,3,0
RO,KR,2016.0,1,2,-1
nan,RO,2008.0,1,3,-2
IE,NL,2006.0,15,13,2
AM,IT,2019.0,29,19,10
PK,NZ,2017.0,5,10,-5
BD,NL,2014.0,5,2,3
RU,SI,2018.0,3,5,-2
SV,BR,2007.0,1,1,0
GR,MX,2013.0,5,6,-1
AT,CL,2005.0,1,3,-2
KE,SE,2005.0,3,1,2
ZM,JP,2008.0,1,1,0
ZM,RW,2013.0,3,2,1
SK,IT,2018.0,5,2,3
SI,PL,2020.0,2,2,0
nan,NO,1998.0,8,9,-1
BD,PL,2006.0,2,1,1
US,LR,2022.0,2,4,-2
TR,RU,2006.0,1,3,-2
DK,RO,2019.0,3,3,0
AE,AU,2000.0,1,1,0
CL,DK,2019.0,3,3,0
BR,GR,2008.0,4,2,2
IT,BY,2010.0,3,3,0
MD,IT,2017.0,2,3,-1
NE,BF,2014.0,1,2,-1
FR,GA,2013.0,12,8,4
GR,MK,2008.0,3,9,-6
UG,ET,2020.0,4,3,1
IE,SE,1997.0,1,2,-1
TT,US,2019.0,9,13,-4
PT,CL,2005.0,5,3,2
DK,IR,2009.0,3,3,0
IN,KY,2019.0,1,1,0
UY,AU,2019.0,2,2,0
MA,nan,2015.0,3,1,2
US,BY,2014.0,9,12,-3
DZ,DE,2011.0,4,3,1
IL,VE,2006.0,2,1,1
KH,JP,2016.0,4,5,-1
RO,CA,2015.0,15,14,1
NO,HU,2013.0,6,7,-1
CZ,UZ,2011.0,2,1,1
FR,EC,2008.0,3,1,2
NL,TW,2002.0,1,6,-5
SK,SA,2019.0,1,1,0
BG,CA,2007.0,3,4,-1
UY,AU,2017.0,2,4,-2
SV,MX,2013.0,4,3,1
RO,PT,2016.0,3,4,-1
PH,ZA,2013.0,4,2,2
GR,ES,2003.0,8,4,4
AO,CN,2015.0,1,5,-4
NP,JP,2012.0,6,13,-7
NO,NP,2016.0,6,2,4
TW,DK,2016.0,4,2,2
IE,NG,2014.0,1,3,-2
EE,DE,2003.0,9,11,-2
ID,TR,2011.0,5,3,2
OM,AU,2020.0,7,8,-1
VN,RU,2022.0,4,2,2
AE,MY,2012.0,4,8,-4
AF,IQ,2018.0,1,1,0
AT,AR,2015.0,5,5,0
VN,MX,2010.0,3,3,0
FI,SA,2022.0,1,1,0
GB,PH,2010.0,14,7,7
TH,SG,2004.0,2,5,-3
UA,nan,1997.0,7,2,5
CH,BD,2017.0,1,5,-4
TR,AZ,2005.0,3,1,2
IL,CL,2015.0,1,2,-1
KR,SI,2019.0,2,1,1
TN,BR,2018.0,1,1,0
GB,SD,2001.0,1,3,-2
BE,UA,2001.0,2,2,0
GE,CN,2014.0,5,5,0
SN,CI,2014.0,3,1,2
VE,DE,2010.0,3,1,2
NG,OM,2018.0,4,1,3
DK,SK,2010.0,3,3,0
ZW,ET,2018.0,2,1,1
BG,TR,2006.0,1,1,0
PK,KW,2013.0,2,3,-1
KR,PH,2008.0,3,3,0
IR,SD,2014.0,2,2,0
SG,NO,2020.0,7,3,4
PH,NL,2000.0,1,1,0
GB,CU,2014.0,7,5,2
JP,UG,2008.0,1,1,0
ZA,SG,2016.0,3,1,2
SD,BE,2012.0,1,2,-1
PE,BR,2005.0,5,14,-9
OM,EG,2003.0,2,2,0
MX,RS,2018.0,7,1,6
UA,CH,2013.0,7,6,1
VE,DE,2019.0,6,3,3
LK,ID,2016.0,4,4,0
UA,BE,2006.0,2,2,0
SK,HU,2000.0,3,4,-1
KR,IR,2014.0,8,23,-15
JO,OM,2022.0,5,1,4
UA,GB,1997.0,7,2,5
IT,SM,2021.0,3,2,1
AE,LB,2021.0,2,11,-9
CZ,PE,2020.0,2,2,0
JO,KW,2017.0,6,3,3
TH,CH,2014.0,1,2,-1
ES,LT,2020.0,2,7,-5
AE,FR,2010.0,3,12,-9
MX,GR,2017.0,2,4,-2
DZ,TR,2022.0,3,1,2
NP,PH,2013.0,2,1,1
CN,LK,2011.0,8,10,-2
NO,ZA,2004.0,1,4,-3
ID,nan,2005.0,1,1,0
NP,NL,2019.0,6,1,5
AE,LU,2022.0,2,1,1
CY,CA,2019.0,4,4,0
FR,UG,2008.0,3,1,2
AT,BA,2017.0,3,2,1
LB,TN,2019.0,3,3,0
TR,RS,2021.0,2,5,-3
RS,DE,2006.0,5,17,-12
BD,DK,2013.0,4,1,3
AR,IL,2014.0,2,6,-4
MX,UA,2016.0,1,2,-1
UZ,PL,2000.0,2,5,-3
VN,TW,2013.0,5,12,-7
LV,SE,2005.0,2,3,-1
DE,PH,1999.0,1,3,-2
PF,AU,2016.0,2,1,1
SS,CA,2003.0,1,1,0
ZM,GB,2003.0,2,1,1
GB,BN,2007.0,3,2,1
IN,MU,2016.0,1,1,0
JP,ZM,2002.0,3,1,2
PK,TR,1999.0,3,1,2
GH,VN,2021.0,2,2,0
NL,BY,2019.0,1,1,0
PH,AU,2007.0,4,8,-4
CA,CY,2013.0,1,3,-2
BR,BO,2010.0,3,2,1
CZ,NL,2006.0,4,7,-3
CH,PH,2015.0,3,4,-1
RU,IE,2014.0,2,11,-9
RS,BR,2017.0,4,1,3
SE,LV,2001.0,2,3,-1
CA,SK,2015.0,6,4,2
CH,MA,2019.0,5,4,1
IT,AO,2013.0,3,2,1
HU,RU,2000.0,2,2,0
US,PY,2011.0,3,1,2
PL,PT,2014.0,5,6,-1
FR,SI,2003.0,7,3,4
LI,DE,2013.0,5,6,-1
IT,BY,2017.0,1,5,-4
KR,ZA,2017.0,7,3,4
SE,BH,2016.0,1,1,0
NL,BA,2017.0,3,2,1
PK,PS,2019.0,1,5,-4
ID,IE,2015.0,2,3,-1
TW,MX,2009.0,4,1,3
NG,nan,2014.0,3,3,0
IT,AZ,2011.0,1,1,0
UA,CA,2005.0,8,1,7
KP,KR,2022.0,6,2,4
IT,CU,2021.0,2,2,0
VE,GT,2021.0,3,2,1
TH,BR,2010.0,4,2,2
UA,nan,1998.0,8,8,0
AE,DE,2014.0,3,6,-3
CU,JP,2018.0,2,1,1
CA,UY,2013.0,1,2,-1
LK,FR,2003.0,1,1,0
HN,CU,2018.0,2,1,1
GB,MA,2014.0,6,3,3
HU,RO,2002.0,6,35,-29
AU,RS,2015.0,2,5,-3
BS,US,2020.0,5,5,0
EG,NZ,2007.0,2,2,0
ET,EG,2009.0,7,1,6
DE,OM,2018.0,2,3,-1
BG,MK,2012.0,2,1,1
US,MK,2008.0,6,3,3
JP,AM,2012.0,2,6,-4
JP,NG,2000.0,1,3,-2
ES,TZ,2012.0,1,1,0
ID,NG,2014.0,1,3,-2
ES,RS,2016.0,3,5,-2
PK,YE,2017.0,1,3,-2
TZ,DE,2011.0,3,2,1
NL,HR,2019.0,5,7,-2
IN,nan,2000.0,6,10,-4
EE,CH,2003.0,2,1,1
QA,KW,2021.0,4,1,3
CU,DE,2006.0,3,3,0
IR,KW,2018.0,7,1,6
AR,DO,2015.0,2,1,1
ID,CL,2012.0,1,1,0
RU,ID,2011.0,2,1,1
RS,BR,2019.0,2,2,0
PS,GB,2015.0,3,6,-3
LB,DE,2013.0,3,4,-1
NG,ZA,2004.0,5,2,3
IR,SG,2007.0,1,1,0
NG,AU,2006.0,3,3,0
PH,UY,2019.0,1,1,0
SI,DE,2013.0,7,11,-4
NZ,ZA,1999.0,2,7,-5
MY,NZ,1998.0,1,1,0
IS,ES,2013.0,2,7,-5
IT,RS,2010.0,6,4,2
IR,BE,2006.0,3,1,2
NO,ZM,2014.0,2,1,1
US,VG,2017.0,4,31,-27
TH,BE,2020.0,2,4,-2
GH,CN,2009.0,1,2,-1
TW,TH,2001.0,1,2,-1
TR,DK,2004.0,1,1,0
PA,CA,2017.0,4,8,-4
US,CV,2021.0,1,1,0
JO,SY,2017.0,2,2,0
BW,IN,2022.0,3,2,1
RU,BR,2018.0,11,14,-3
MY,JP,2001.0,3,12,-9
CL,nan,2016.0,6,10,-4
RS,BG,2020.0,7,4,3
CR,CO,2001.0,1,1,0
IL,KZ,2020.0,1,1,0
ES,MZ,2003.0,1,2,-1
CO,TZ,2020.0,1,1,0
ES,EE,2016.0,3,1,2
DE,KE,1998.0,1,2,-1
FI,UA,2005.0,2,2,0
SE,GH,2010.0,2,1,1
BE,SG,2011.0,4,2,2
TN,BE,2015.0,2,4,-2
CR,AR,2006.0,1,4,-3
IN,TR,2009.0,7,15,-8
IN,KY,2010.0,1,1,0
AU,BN,1999.0,2,1,1
NC,US,2021.0,4,2,2
TT,JM,2000.0,3,5,-2
MD,IT,2010.0,1,5,-4
NZ,RO,2020.0,1,1,0
AM,DE,2009.0,7,6,1
CA,SI,2011.0,2,1,1
IL,LK,2019.0,1,1,0
FI,BD,2010.0,2,1,1
IT,PA,2013.0,1,1,0
PR,GB,2012.0,1,1,0
PT,PL,2007.0,6,3,3
BD,PK,2005.0,5,6,-1
RS,IE,2015.0,1,1,0
BF,TN,2018.0,1,1,0
SE,AM,2019.0,1,1,0
HN,BR,2020.0,1,2,-1
PH,CA,2004.0,5,5,0
nan,GR,2021.0,1,1,0
EG,MX,2014.0,2,1,1
CH,CU,2007.0,2,1,1
TH,NP,2014.0,8,3,5
BY,SI,2014.0,1,1,0
SE,GR,1998.0,3,1,2
BG,GR,2004.0,2,2,0
PL,MZ,2020.0,4,12,-8
EC,CO,2003.0,1,2,-1
IT,BG,2002.0,5,3,2
FR,nan,2023.0,4,2,2
MT,US,2014.0,2,6,-4
DE,CR,2021.0,5,4,1
IE,PL,2012.0,3,5,-2
NG,BE,2013.0,1,2,-1
CO,AT,2009.0,1,2,-1
RS,RU,2010.0,5,12,-7
GB,NI,2015.0,1,2,-1
EC,BD,2019.0,1,1,0
EG,IL,2001.0,1,1,0
CR,CN,2013.0,1,7,-6
QA,KR,2013.0,3,2,1
CM,CH,2005.0,2,1,1
AZ,DE,2008.0,2,1,1
CL,PA,2012.0,4,4,0
DE,GA,2005.0,4,4,0
IN,MW,2019.0,1,1,0
PE,PL,2010.0,1,1,0
SD,NG,2014.0,3,3,0
EG,LY,2015.0,3,5,-2
PL,IL,2004.0,1,5,-4
KE,NL,2003.0,2,5,-3
GB,PS,2022.0,3,4,-1
RU,VE,2019.0,1,2,-1
CY,US,2023.0,1,5,-4
JP,TN,2007.0,1,2,-1
BO,FR,2021.0,2,1,1
KW,MA,2002.0,2,2,0
NO,JO,2008.0,1,1,0
NP,NL,2017.0,3,2,1
US,LA,2014.0,1,1,0
HR,RU,2010.0,4,3,1
ES,CI,2000.0,2,1,1
CZ,TW,2018.0,1,3,-2
MX,IN,2012.0,3,9,-6
PK,VN,2012.0,1,1,0
KZ,AE,2013.0,2,2,0
CA,CU,2014.0,2,4,-2
NP,NO,2019.0,3,4,-1
DO,PE,2021.0,1,2,-1
PT,FI,2012.0,4,4,0
CH,LT,2015.0,1,4,-3
PE,nan,2017.0,6,10,-4
BE,BJ,2008.0,3,2,1
VE,CR,2005.0,2,2,0
PL,LU,2019.0,1,3,-2
GE,IL,2015.0,1,1,0
AT,SG,2002.0,1,2,-1
AT,NO,2003.0,2,2,0
MX,DK,2008.0,2,4,-2
AU,BT,2019.0,1,5,-4
RU,PH,2018.0,1,1,0
SD,BR,2004.0,3,2,1
JM,GP,2022.0,1,1,0
VN,IS,2014.0,1,1,0
PE,CL,1999.0,5,2,3
IN,PE,2017.0,3,1,2
EE,IN,2009.0,1,4,-3
KR,AT,2013.0,4,4,0
SE,SJ,2016.0,1,1,0
SY,ET,2020.0,2,2,0
BY,PL,2020.0,4,3,1
PT,IR,2015.0,2,18,-16
US,GY,2014.0,2,1,1
SG,IT,2012.0,2,7,-5
SE,CY,2021.0,1,1,0
SN,ZA,2013.0,1,1,0
HR,ES,1999.0,1,1,0
AE,VN,2019.0,1,2,-1
LV,AT,2013.0,1,1,0
IT,BY,2019.0,1,1,0
CA,BR,2019.0,262,292,-30
HU,US,2006.0,95,92,3
CN,DE,2016.0,326,327,-1
ES,CA,2003.0,26,27,-1
US,NL,2023.0,28,25,3
PK,US,2017.0,341,308,33
PT,DE,2008.0,27,36,-9
CH,CN,2005.0,45,52,-7
FR,DE,2001.0,293,296,-3
NC,AU,2010.0,3,2,1
NL,GB,2021.0,256,354,-98
CA,BE,2016.0,60,79,-19
DE,FR,2013.0,538,515,23
US,CU,2019.0,31,73,-42
RO,LT,2012.0,7,1,6
AZ,RU,2018.0,23,17,6
GR,FR,2017.0,50,45,5
CO,GB,2017.0,51,41,10
HU,DE,2004.0,48,35,13
TD,CM,2018.0,1,1,0
JO,KW,2010.0,3,1,2
MX,AR,1999.0,27,22,5
PL,PK,2008.0,6,1,5
US,TH,2016.0,253,140,113
PE,PT,2015.0,8,6,2
HR,RU,2017.0,7,7,0
BG,US,2011.0,23,32,-9
FR,KR,2021.0,23,26,-3
PS,MY,2020.0,4,8,-4
US,HU,2021.0,57,58,-1
LK,KR,2021.0,2,7,-5
JP,AU,2011.0,82,56,26
GR,FR,2019.0,47,53,-6
QA,EG,2014.0,29,36,-7
BR,BO,2019.0,7,2,5
HR,DK,2021.0,2,5,-3
FI,IT,2012.0,16,17,-1
PK,CA,2022.0,36,28,8
SG,ID,2019.0,43,27,16
AU,GR,2018.0,8,18,-10
BR,IN,2005.0,15,12,3
EC,VE,2021.0,12,17,-5
ID,CH,2018.0,4,4,0
BR,nan,2009.0,64,66,-2
AU,CZ,2020.0,10,11,-1
IT,LB,2005.0,8,9,-1
nan,CZ,2009.0,9,9,0
PT,NO,2015.0,13,8,5
IT,AE,2019.0,10,3,7
CL,VE,2000.0,5,3,2
CN,UZ,2017.0,7,3,4
SG,ID,2017.0,20,15,5
IT,AE,2017.0,14,4,10
LU,NL,2013.0,4,9,-5
SA,IN,2013.0,36,105,-69
GR,DE,2003.0,22,28,-6
PK,JP,1998.0,8,8,0
NO,GR,2021.0,8,6,2
GB,KE,2011.0,27,21,6
NL,CO,2010.0,7,4,3
AU,FI,2015.0,15,22,-7
AR,NL,2003.0,6,3,3
IR,SA,2012.0,3,5,-2
HU,SE,2003.0,8,10,-2
IT,RS,2019.0,6,4,2
SE,IR,2012.0,26,43,-17
DE,KZ,2020.0,5,4,1
JP,SA,2021.0,10,5,5
SG,ID,2010.0,6,4,2
MW,CH,2021.0,1,1,0
AU,UG,2013.0,1,6,-5
SI,BE,2015.0,8,4,4
IL,KR,2013.0,4,6,-2
IE,LU,2017.0,3,1,2
UA,BG,2014.0,6,5,1
UA,FR,2022.0,8,5,3
NL,TR,2004.0,10,14,-4
TZ,KE,2005.0,3,5,-2
NO,LT,2002.0,5,2,3
US,GT,2016.0,5,9,-4
DE,PT,2000.0,6,10,-4
KE,FR,2015.0,11,9,2
RU,KZ,2000.0,3,6,-3
AL,US,2022.0,6,3,3
MA,GB,2018.0,8,13,-5
BE,NZ,2013.0,9,4,5
SE,SA,2012.0,6,4,2
GR,IT,1998.0,4,5,-1
AU,TW,2004.0,12,12,0
SE,AR,2010.0,5,4,1
NL,UG,2018.0,4,7,-3
NZ,CL,2011.0,5,3,2
OM,JO,2012.0,4,2,2
DK,TW,2015.0,2,1,1
DE,SG,1997.0,4,1,3
MM,SG,2005.0,2,1,1
nan,CL,2000.0,1,2,-1
SJ,SE,2015.0,1,1,0
KW,IN,2007.0,3,7,-4
PT,AT,2019.0,6,6,0
GB,PH,2017.0,12,27,-15
ZA,UG,2012.0,6,8,-2
TW,TR,2022.0,5,1,4
AO,ES,2016.0,2,3,-1
SA,SD,2004.0,2,4,-2
HU,NO,2012.0,7,2,5
KR,ES,2004.0,7,3,4
LB,CH,2008.0,1,1,0
LB,IQ,2015.0,4,1,3
SE,AR,2017.0,7,4,3
GE,CZ,2021.0,3,1,2
US,TG,2016.0,1,1,0
BG,DE,2023.0,1,3,-2
FI,GR,1999.0,1,2,-1
JP,PE,2018.0,2,2,0
KE,ZM,2017.0,4,1,3
BD,CA,2003.0,8,5,3
GB,PE,2016.0,9,13,-4
NG,JP,2002.0,4,6,-2
GB,BG,2013.0,11,7,4
HU,BY,2014.0,3,3,0
IL,ZA,2005.0,5,3,2
CO,ID,2016.0,3,6,-3
BD,FI,2013.0,2,4,-2
FR,BO,2011.0,4,3,1
MD,UA,2005.0,3,1,2
RW,ZA,2007.0,1,1,0
LB,SA,2006.0,3,3,0
CZ,AM,2021.0,2,5,-3
AU,EE,2002.0,1,2,-1
IE,CL,2014.0,1,2,-1
NG,MY,2008.0,3,3,0
CH,MA,2010.0,4,1,3
BG,AT,2015.0,3,1,2
HN,VE,2017.0,1,2,-1
DE,HK,2017.0,1,2,-1
KR,IQ,2020.0,2,1,1
BO,SE,2018.0,3,1,2
IT,LB,2002.0,2,1,1
BY,CN,2019.0,4,3,1
NC,AU,2017.0,1,3,-2
GE,SK,2009.0,1,2,-1
SE,RO,2022.0,1,1,0
RS,BR,2010.0,1,1,0
CN,HK,2014.0,120,121,-1
IE,US,2003.0,244,282,-38
CA,BR,2010.0,249,235,14
MY,CN,2021.0,103,104,-1
ES,BE,2008.0,43,49,-6
PH,TH,2018.0,7,5,2
SN,FR,1997.0,9,2,7
UG,SE,2009.0,1,2,-1
RU,AZ,2021.0,17,20,-3
EC,CU,2011.0,1,2,-1
TW,NO,2018.0,1,4,-3
ID,FI,2021.0,9,5,4
NC,AU,2019.0,1,1,0
AR,JP,2001.0,3,2,1
IN,ET,2013.0,17,7,10
US,GA,2009.0,1,1,0
SE,AR,2019.0,6,6,0
IQ,BA,2019.0,3,6,-3
FI,NP,2022.0,2,2,0
HK,ZA,2004.0,1,1,0
CL,US,2020.0,278,259,19
,TW,1994.0,7804,0,7804
,US,1997.0,76451,0,76451
MX,,2023.0,21665,0,21665
,AU,2005.0,6136,0,6136
,US,1998.0,71740,0,71740
FR,,2000.0,3348,0,3348
CL,,2023.0,8573,0,8573
,DE,2015.0,19567,0,19567
JP,,2015.0,13124,0,13124
,AR,2008.0,2508,0,2508
HU,,2024.0,8962,0,8962
TW,,2023.0,14007,0,14007
,AU,2002.0,5113,0,5113
,MY,2011.0,5659,0,5659
,CL,1994.0,1530,0,1530
IT,,2004.0,2375,0,2375
NL,,1998.0,1084,0,1084
ES,,2004.0,2310,0,2310
IR,,2016.0,4306,0,4306
,VN,2007.0,265,0,265
,SG,2010.0,1715,0,1715
,DK,1994.0,5137,0,5137
ZA,,2018.0,2030,0,2030
,SK,2001.0,449,0,449
,RU,2014.0,16107,0,16107
JP,AO,2004.0,2,0,2
,HR,2014.0,799,0,799
,DZ,2008.0,682,0,682
PK,,2016.0,498,0,498
FI,,2008.0,794,0,794
IL,,2005.0,759,0,759
NZ,,2018.0,1062,0,1062
CN,,1999.0,901,0,901
MZ,,2010.0,22,0,22
BO,,2024.0,208,0,208
CO,,2013.0,558,0,558
PT,,2014.0,686,0,686
CZ,,2013.0,913,0,913
OM,,2002.0,13,0,13
IL,,2002.0,633,0,633
,IQ,2016.0,1625,0,1625
NO,ML,2006.0,1,0,1
,RS,2007.0,997,0,997
,BB,2002.0,17,0,17
,MA,1997.0,355,0,355
,CR,1994.0,154,0,154
,ZA,1999.0,1228,0,1228
,HK,2006.0,66,0,66
,TN,1997.0,246,0,246
PE,,2020.0,891,0,891
,RO,2010.0,2067,0,2067
,SA,1996.0,601,0,601
,EE,2004.0,296,0,296
PY,,2024.0,320,0,320
,LB,2014.0,491,0,491
,MA,1998.0,375,0,375
VG,,2018.0,28,0,28
JO,NZ,1997.0,1,0,1
,SG,2017.0,1416,0,1416
VN,,2016.0,150,0,150
,NG,2003.0,1279,0,1279
,SI,2004.0,493,0,493
OM,,2005.0,30,0,30
KZ,TW,2008.0,1,0,1
EE,,2022.0,710,0,710
,RO,2017.0,1626,0,1626
NO,,2000.0,256,0,256
AM,,2020.0,173,0,173
,SY,1998.0,45,0,45
CY,,2015.0,86,0,86
,SG,2019.0,703,0,703
AT,VN,2006.0,1,0,1
HK,,2014.0,85,0,85
AR,,2007.0,424,0,424
,EE,1996.0,196,0,196
,AL,2010.0,142,0,142
,SA,2004.0,457,0,457
,BG,2012.0,514,0,514
UY,,2022.0,685,0,685
,SY,1997.0,41,0,41
,BF,2002.0,48,0,48
,SI,1996.0,403,0,403
BY,AU,2009.0,1,0,1
MU,IN,2019.0,3,0,3
,UG,2001.0,90,0,90
SY,,2003.0,7,0,7
,MD,2000.0,73,0,73
,GH,2009.0,277,0,277
,ME,2018.0,34,0,34
KW,,2014.0,82,0,82
,TN,1998.0,294,0,294
TN,,2003.0,32,0,32
BF,NG,2019.0,4,0,4
CR,,2011.0,51,0,51
GE,,2020.0,256,0,256
TG,,2021.0,106,0,106
,MG,2015.0,67,0,67
TH,NZ,1998.0,1,0,1
ZA,GA,2012.0,3,0,3
TG,CH,2017.0,2,0,2
KW,MA,2005.0,2,0,2
MY,,2008.0,161,0,161
ID,,2009.0,89,0,89
,BO,2009.0,69,0,69
,NP,2007.0,221,0,221
TT,,2023.0,196,0,196
,MK,1999.0,40,0,40
LT,GB,2005.0,5,0,5
PH,CU,2017.0,1,0,1
,LU,2015.0,115,0,115
,RO,2019.0,1043,0,1043
SA,PH,2015.0,2,0,2
MZ,,2019.0,39,0,39
CU,FR,2020.0,6,0,6
,BA,2018.0,148,0,148
SG,,1999.0,150,0,150
MD,FI,1997.0,3,0,3
OM,KZ,2017.0,1,0,1
SS,,2024.0,26,0,26
IT,KZ,2013.0,2,0,2
,AL,2017.0,77,0,77
,SD,2003.0,78,0,78
,MW,2016.0,84,0,84
,AL,2019.0,48,0,48
HU,BR,1998.0,2,0,2
HN,,2024.0,108,0,108
US,CW,2022.0,3,0,3
UZ,IN,2000.0,2,0,2
KG,,2013.0,10,0,10
MK,,2016.0,68,0,68
ML,IN,2023.0,1,0,1
MQ,,2014.0,10,0,10
BE,BI,2013.0,4,0,4
,TG,2015.0,42,0,42
HU,UA,2012.0,1,0,1
LS,ET,2014.0,1,0,1
MX,SA,2013.0,2,0,2
NZ,MX,2003.0,2,0,2
HT,,2021.0,11,0,11
,DO,2002.0,9,0,9
UG,DE,2017.0,3,0,3
UG,MA,2019.0,1,0,1
IR,VN,2013.0,1,0,1
MY,KZ,2013.0,1,0,1
RU,NG,2018.0,5,0,5
JP,FI,2023.0,1,0,1
PG,CA,2021.0,1,0,1
ZA,TR,2014.0,2,0,2
CO,VN,2012.0,1,0,1
TZ,CZ,2016.0,1,0,1
RU,BD,2012.0,1,0,1
GH,KE,2009.0,1,0,1
BN,TH,2022.0,1,0,1
IR,SY,2022.0,2,0,2
RE,,2002.0,3,0,3
,AO,2018.0,43,0,43
FI,EG,2021.0,5,0,5
MZ,,2017.0,27,0,27
IN,BJ,2013.0,1,0,1
NG,CN,2000.0,2,0,2
LS,CA,2017.0,1,0,1
,BW,2016.0,73,0,73
,BF,2005.0,76,0,76
LI,,2010.0,6,0,6
,HN,2008.0,28,0,28
EC,,2009.0,26,0,26
nan,ER,2005.0,1,0,1
SE,IE,1999.0,3,0,3
BJ,,2002.0,5,0,5
LA,,2015.0,7,0,7
DK,GH,2018.0,4,0,4
MW,,1998.0,3,0,3
QA,IL,2015.0,1,0,1
TR,AZ,2002.0,2,0,2
,HT,2013.0,18,0,18
KZ,CZ,2001.0,1,0,1
AT,KE,2012.0,1,0,1
nan,HR,1998.0,1,0,1
PG,AU,2008.0,3,0,3
IL,ZA,2002.0,1,0,1
AR,EE,2017.0,2,0,2
BY,CH,2002.0,1,0,1
BJ,BR,2016.0,3,0,3
HR,BR,2007.0,1,0,1
PH,NZ,2011.0,2,0,2
DO,NO,2018.0,1,0,1
CW,,2017.0,22,0,22
TZ,BR,2021.0,1,0,1
HR,TR,2007.0,1,0,1
LI,,2017.0,9,0,9
CZ,AZ,2018.0,1,0,1
DE,CY,2005.0,3,0,3
AU,CY,2021.0,3,0,3
PS,TW,2021.0,1,0,1
AU,VG,2005.0,1,0,1
GB,LV,2022.0,1,0,1
UA,UZ,2006.0,1,0,1
,ML,1999.0,13,0,13
DZ,EE,2017.0,1,0,1
BY,CN,2017.0,7,0,7
nan,UY,2019.0,3,0,3
TT,PL,2020.0,1,0,1
CN,CW,2006.0,1,0,1
US,BS,2012.0,3,0,3
FJ,CN,2015.0,1,0,1
MU,,2025.0,4,0,4
US,BJ,2011.0,5,0,5
LY,IQ,2011.0,2,0,2
ID,AZ,2010.0,5,0,5
LY,,2009.0,10,0,10
ET,QA,2020.0,2,0,2
GE,NL,2003.0,1,0,1
CI,AU,2020.0,1,0,1
MC,,2005.0,4,0,4
MD,ZA,2017.0,1,0,1
ML,NL,2022.0,1,0,1
IE,LY,2004.0,1,0,1
MX,KE,2006.0,1,0,1
IM,,2018.0,1,0,1
SK,nan,2014.0,3,0,3
,CD,1995.0,14,0,14
CZ,LT,2012.0,12,0,12
GA,,2008.0,8,0,8
BE,MA,2011.0,7,0,7
HU,LT,2011.0,2,0,2
,KG,1999.0,9,0,9
MT,GB,2023.0,3,0,3
TW,PT,2012.0,2,0,2
DE,LV,2002.0,1,0,1
IN,BG,2015.0,1,0,1
GT,EC,2007.0,1,0,1
SE,UY,2015.0,2,0,2
TG,TR,2009.0,1,0,1
NL,BA,2019.0,4,0,4
EG,ZA,2012.0,3,0,3
AT,ID,2007.0,1,0,1
UY,GT,2017.0,1,0,1
BY,VN,2013.0,4,0,4
ZA,IQ,2021.0,3,0,3
KR,GT,2012.0,1,0,1
ID,PH,2010.0,2,0,2
,MC,1996.0,6,0,6
PE,HT,2018.0,1,0,1
ET,HU,2017.0,1,0,1
TR,KH,2016.0,1,0,1
BS,NZ,2004.0,1,0,1
FR,HR,2008.0,4,0,4
BW,PL,2019.0,1,0,1
TR,AE,2011.0,4,0,4
KR,HK,2017.0,3,0,3
ER,CH,2012.0,1,0,1
BG,CO,2019.0,1,0,1
GT,GB,2016.0,3,0,3
IS,SA,2015.0,1,0,1
CM,CH,2002.0,2,0,2
DE,BH,2012.0,3,0,3
UZ,RS,2000.0,1,0,1
GR,AM,2005.0,1,0,1
AZ,UZ,2009.0,1,0,1
PY,CO,2012.0,3,0,3
CW,,2010.0,5,0,5
CA,AZ,2010.0,2,0,2
CR,AT,2018.0,3,0,3
OM,BD,2009.0,2,0,2
PT,CY,2021.0,1,0,1
ML,ZA,2016.0,1,0,1
IS,AU,2006.0,1,0,1
NI,MY,2019.0,4,0,4
AL,SE,2001.0,1,0,1
,SO,2013.0,5,0,5
PY,PT,2012.0,7,0,7
NL,BY,2017.0,1,0,1
nan,PG,2018.0,1,0,1
IR,MX,2019.0,1,0,1
TZ,ZW,2014.0,1,0,1
SR,,2014.0,3,0,3
KE,ZM,2010.0,2,0,2
PL,LU,2010.0,1,0,1
CZ,TN,2017.0,2,0,2
IN,MA,2005.0,1,0,1
nan,CM,2004.0,4,0,4
MX,MG,2012.0,1,0,1
NG,SG,2004.0,1,0,1
CI,BJ,2005.0,1,0,1
LS,CA,2010.0,1,0,1
VE,EG,2010.0,1,0,1
NZ,CR,2017.0,1,0,1
ZA,VN,1998.0,1,0,1
IN,KH,2015.0,2,0,2
IT,ZM,2011.0,1,0,1
CL,MA,2015.0,1,0,1
CH,CG,2018.0,3,0,3
CM,KH,2009.0,1,0,1
AM,PH,2015.0,1,0,1
AE,RU,2013.0,1,0,1
UA,MZ,1999.0,2,0,2
GB,BA,2009.0,3,0,3
BH,nan,2016.0,1,0,1
AG,,2018.0,2,0,2
SJ,AT,2019.0,1,0,1
SR,BR,2014.0,1,0,1
BY,CH,2005.0,1,0,1
LI,,2019.0,11,0,11
MW,UZ,2021.0,1,0,1
MC,,2002.0,1,0,1
,MC,2004.0,11,0,11
SS,CN,2018.0,2,0,2
MW,BW,2020.0,1,0,1
YE,FR,2013.0,1,0,1
MY,SL,2022.0,1,0,1
JM,IN,1998.0,2,0,2
,DO,2005.0,14,0,14
CH,BJ,2002.0,1,0,1
IE,PH,2018.0,1,0,1
SE,AO,2009.0,1,0,1
,LR,2000.0,3,0,3
MW,ZW,2019.0,3,0,3
BW,PL,2010.0,1,0,1
PE,NI,2009.0,1,0,1
PE,EC,2011.0,2,0,2
SI,DZ,2000.0,1,0,1
CY,JO,2021.0,1,0,1
BJ,SN,2020.0,2,0,2
ME,XK,2015.0,2,0,2
MA,LU,2018.0,1,0,1
TZ,ZM,2021.0,1,0,1
CY,RO,2014.0,1,0,1
JP,AZ,2011.0,2,0,2
AR,MT,2008.0,4,0,4
CN,EC,2003.0,1,0,1
KZ,AL,2009.0,1,0,1
DK,KH,2019.0,1,0,1
SG,PL,1999.0,1,0,1
NO,ID,2006.0,1,0,1
CH,LU,2001.0,2,0,2
BH,LB,2005.0,2,0,2
IL,SG,1997.0,1,0,1
SS,GR,2018.0,1,0,1
NC,AR,2015.0,1,0,1
KW,BR,2012.0,1,0,1
UG,JP,2009.0,2,0,2
JP,JO,2005.0,3,0,3
IT,GP,2009.0,1,0,1
NL,SY,2020.0,1,0,1
,DK,2021.0,2,0,2
JP,JM,2014.0,1,0,1
nan,UY,2010.0,1,0,1
PL,ET,2012.0,1,0,1
DE,NE,2022.0,2,0,2
BE,TZ,2005.0,1,0,1
,BB,2005.0,7,0,7
MY,ZA,1997.0,1,0,1
TH,HK,2009.0,2,0,2
BG,IN,2006.0,2,0,2
GR,KR,2011.0,1,0,1
AO,JP,1998.0,1,0,1
BH,SD,2012.0,1,0,1
RE,,2005.0,2,0,2
AT,KR,1997.0,1,0,1
CU,SN,2018.0,1,0,1
,BZ,2002.0,2,0,2
AT,KG,2017.0,1,0,1
GE,ZA,2015.0,1,0,1
BR,CV,2021.0,2,0,2
CA,BI,1999.0,1,0,1
PS,ID,2012.0,1,0,1
GH,MW,2020.0,1,0,1
ML,MZ,2018.0,1,0,1
UG,DE,2010.0,1,0,1
MG,PF,2003.0,1,0,1
BG,SK,1998.0,1,0,1
VE,DE,2017.0,8,0,8
JP,IQ,2000.0,1,0,1
NL,KW,2003.0,1,0,1
KW,HU,1999.0,2,0,2
QA,PS,2016.0,3,0,3
CW,,2019.0,10,0,10
MY,ZA,1998.0,1,0,1
UA,GE,2014.0,2,0,2
CY,BE,2009.0,1,0,1
US,LS,2018.0,1,0,1
LK,DE,2016.0,6,0,6
BR,EE,2020.0,4,0,4
CA,VG,1999.0,3,0,3
BE,ET,1999.0,1,0,1
TJ,LV,2015.0,1,0,1
IL,TZ,2015.0,1,0,1
FR,CF,2020.0,2,0,2
CA,ZW,2001.0,1,0,1
BE,SA,2009.0,3,0,3
SG,MK,2018.0,2,0,2
,TJ,2006.0,11,0,11
KH,BE,2003.0,1,0,1
CF,,2000.0,2,0,2
GA,AT,2003.0,1,0,1
FI,LU,2006.0,2,0,2
RS,CO,2016.0,3,0,3
CM,IN,2004.0,1,0,1
CO,TW,2004.0,1,0,1
KR,UG,2021.0,1,0,1
AR,EE,2019.0,2,0,2
EG,SG,1999.0,1,0,1
BR,SI,2022.0,3,0,3
XK,EG,2019.0,1,0,1
SZ,TW,2015.0,1,0,1
NA,BW,2004.0,1,0,1
NE,NL,1998.0,1,0,1
ET,HU,2019.0,2,0,2
IT,ST,2011.0,1,0,1
IE,CH,1999.0,2,0,2
CD,TZ,2009.0,2,0,2
SE,BN,2015.0,1,0,1
CY,JP,2018.0,1,0,1
NL,BS,2009.0,1,0,1
KR,KW,2013.0,4,0,4
MU,CN,2017.0,1,0,1
IN,BF,2012.0,1,0,1
SE,BA,2002.0,2,0,2
MZ,PT,2006.0,2,0,2
SD,PH,2019.0,1,0,1
IT,BN,2016.0,1,0,1
MC,IN,2008.0,1,0,1
AU,WS,2006.0,1,0,1
PK,DK,2011.0,3,0,3
AU,BA,2016.0,1,0,1
GB,AF,1997.0,1,0,1
IL,AE,2005.0,1,0,1
BJ,,2005.0,3,0,3
MT,,2007.0,3,0,3
UA,CA,2002.0,5,0,5
UZ,SY,2014.0,1,0,1
FO,,2014.0,2,0,2
UY,CA,2003.0,2,0,2
KN,,2014.0,4,0,4
PK,CM,2020.0,3,0,3
VE,PL,2007.0,1,0,1
DE,MW,2012.0,2,0,2
BA,PK,2016.0,1,0,1
CG,,2006.0,5,0,5
,IM,2000.0,1,0,1
KR,GE,2002.0,1,0,1
NE,,2008.0,2,0,2
PT,SI,2010.0,1,0,1
,GN,2005.0,7,0,7
BB,JM,2023.0,1,0,1
CH,DO,2001.0,2,0,2
BF,GH,2014.0,3,0,3
CI,GB,2013.0,3,0,3
NO,PT,2003.0,2,0,2
CH,GH,2002.0,1,0,1
IE,UG,2020.0,2,0,2
GB,XK,2013.0,1,0,1
IN,PE,2010.0,1,0,1
SA,SE,2023.0,1,0,1
DK,ID,2015.0,1,0,1
CY,UA,2018.0,1,0,1
LK,SE,2008.0,2,0,2
,LV,2020.0,13,0,13
FR,TG,2008.0,1,0,1
MN,CH,2014.0,1,0,1
KW,RS,1998.0,1,0,1
CA,CW,2015.0,1,0,1
BG,AU,2003.0,1,0,1
KW,YE,2019.0,1,0,1
CH,IQ,2020.0,1,0,1
MZ,AO,2022.0,1,0,1
GB,DZ,1999.0,2,0,2
IN,BI,2021.0,2,0,2
SL,CN,2006.0,1,0,1
SK,SG,1998.0,1,0,1
VG,GR,2007.0,1,0,1
AG,HU,2004.0,1,0,1
LB,RO,2018.0,1,0,1
LK,TW,2019.0,1,0,1
US,GW,2005.0,1,0,1
AL,IT,2000.0,1,0,1
,KN,2015.0,8,0,8
IE,BR,1997.0,1,0,1
NL,IS,1997.0,1,0,1
TW,IL,2011.0,4,0,4
BE,ID,2005.0,2,0,2
QA,JP,2004.0,2,0,2
IN,CR,2012.0,1,0,1
CR,GT,2022.0,1,0,1
ZA,PA,2019.0,1,0,1
UA,RS,1999.0,2,0,2
CU,PS,2019.0,1,0,1
PS,IR,2012.0,1,0,1
AM,UG,2020.0,1,0,1
BY,MN,2020.0,1,0,1
KH,KR,2013.0,1,0,1
GT,AT,2018.0,1,0,1
IS,NZ,2015.0,2,0,2
PK,NL,2023.0,2,0,2
GR,NG,2013.0,1,0,1
AG,US,2012.0,1,0,1
GB,LY,1999.0,1,0,1
FR,LT,1999.0,1,0,1
CA,NG,1999.0,1,0,1
JP,LB,2003.0,2,0,2
AM,NL,2002.0,2,0,2
LU,TN,2007.0,1,0,1
BE,TZ,2002.0,1,0,1
DK,CR,2016.0,1,0,1
nan,BM,2005.0,1,0,1
RU,CO,2004.0,1,0,1
CA,BS,2001.0,1,0,1
CA,MQ,2013.0,1,0,1
nan,GE,2007.0,2,0,2
SD,CN,1998.0,1,0,1
DK,SK,2019.0,1,0,1
AU,CU,2001.0,1,0,1
ZW,ML,2001.0,1,0,1
GB,NC,2012.0,1,0,1
AE,TT,2017.0,2,0,2
LV,ES,2022.0,2,0,2
LB,MT,2020.0,1,0,1
MY,MK,2012.0,1,0,1
PH,BH,2017.0,1,0,1
TR,CI,2015.0,1,0,1
TN,RO,2006.0,1,0,1
QA,CN,2002.0,1,0,1
YE,BR,2016.0,1,0,1
MA,BI,2022.0,1,0,1
BH,QA,2018.0,3,0,3
TT,NG,2014.0,1,0,1
JP,SN,2012.0,1,0,1
PR,,2005.0,4,0,4
TN,BF,2021.0,1,0,1
LK,GR,1998.0,2,0,2
IT,RE,2014.0,1,0,1
ES,ET,2016.0,3,0,3
SA,BR,2006.0,1,0,1
CA,AZ,2019.0,1,0,1
KG,RU,2001.0,1,0,1
,GN,2002.0,2,0,2
PL,JO,2023.0,1,0,1
MK,CN,2021.0,1,0,1
AE,VN,2017.0,1,0,1
ZW,MX,2017.0,3,0,3
IN,CG,2008.0,1,0,1
SE,LA,2007.0,1,0,1
UY,AU,2010.0,2,0,2
BN,IN,2004.0,1,0,1
CR,CH,2015.0,1,0,1
BS,ZA,2015.0,1,0,1
HU,GE,2014.0,2,0,2
QA,CZ,2017.0,1,0,1
IT,MT,2005.0,1,0,1
GR,LY,2017.0,2,0,2
LK,NP,2018.0,1,0,1
AR,SK,2018.0,2,0,2
CR,CA,2001.0,1,0,1
NL,CV,2020.0,1,0,1
BA,ME,2023.0,1,0,1
ET,TN,2018.0,1,0,1
GB,BS,2006.0,3,0,3
JP,GH,2009.0,1,0,1
CL,EG,2021.0,2,0,2
NL,MY,2003.0,1,0,1
OM,KZ,2019.0,1,0,1
NP,NG,2011.0,1,0,1
IQ,BE,2018.0,1,0,1
CH,BD,2010.0,2,0,2
TW,BY,2020.0,1,0,1
CH,PA,2006.0,1,0,1
ES,NZ,1999.0,1,0,1
NG,ML,1998.0,1,0,1
FJ,PK,2013.0,1,0,1
BJ,NL,2002.0,1,0,1
GY,CH,1998.0,1,0,1
ET,CG,2021.0,1,0,1
LK,TW,2017.0,1,0,1
BE,DJ,2010.0,1,0,1
UZ,KZ,2005.0,2,0,2
BE,PY,2000.0,1,0,1
AT,BW,1998.0,1,0,1
CA,NA,2014.0,3,0,3
LB,ZA,2021.0,1,0,1
EG,KH,2021.0,1,0,1
BW,NO,2023.0,1,0,1
NO,PK,1997.0,2,0,2
JP,CY,2009.0,1,0,1
SD,TN,2017.0,2,0,2
UZ,CZ,2007.0,2,0,2
PK,NG,1999.0,1,0,1
SA,KE,2005.0,1,0,1
PK,IE,1997.0,1,0,1
HU,SG,2009.0,1,0,1
MV,IT,2020.0,1,0,1
GP,CH,2021.0,1,0,1
KY,CA,2017.0,1,0,1
BO,CO,2002.0,1,0,1
BG,FI,1999.0,2,0,2
,SJ,2006.0,1,0,1
RE,ZA,2011.0,1,0,1
DE,PG,2013.0,1,0,1
JM,JP,2002.0,2,0,2
TR,AL,2009.0,1,0,1
RU,IS,2014.0,2,0,2
IT,QA,2010.0,1,0,1
AF,JP,2006.0,1,0,1
HR,MK,2008.0,1,0,1
JP,JO,2002.0,1,0,1
JM,NZ,2009.0,1,0,1
CN,BJ,2022.0,2,0,2
IE,LU,2010.0,1,0,1
TJ,,2008.0,2,0,2
AG,KH,2020.0,1,0,1
TG,FR,2003.0,3,0,3
SG,AF,2022.0,1,0,1
SE,AX,2011.0,1,0,1
GP,,2003.0,2,0,2
CO,CR,2001.0,1,1,0
LU,JP,2015.0,1,2,-1
NL,MA,2013.0,2,1,1
BR,CR,2002.0,2,1,1
IT,GR,1999.0,1,5,-4
PK,PS,2017.0,2,4,-2
MA,DE,2007.0,2,6,-4
ES,IS,2007.0,1,2,-1
PE,CN,2010.0,1,2,-1
GB,GN,2016.0,1,1,0
BD,TH,2018.0,2,5,-3
BR,AU,2023.0,3,3,0
TH,BR,2017.0,4,3,1
ZW,MX,2010.0,2,1,1
BI,DZ,2015.0,1,1,0
HU,CU,2014.0,1,1,0
PA,IT,2009.0,1,1,0
CM,KE,2006.0,1,1,0
KE,ID,2022.0,2,4,-2
MY,EG,2023.0,1,1,0
TW,IE,2022.0,2,2,0
LU,ZA,2009.0,1,1,0
AT,KZ,2020.0,1,2,-1
TN,CG,2015.0,1,1,0
BG,SE,2018.0,1,5,-4
BJ,NC,2019.0,1,1,0
GE,BE,2015.0,1,2,-1
KG,UZ,2019.0,1,3,-2
BR,CO,2023.0,1,4,-3
GB,MG,2022.0,1,2,-1
SA,ES,2009.0,2,3,-1
AT,UA,1999.0,2,3,-1
EG,DZ,2008.0,5,1,4
CR,ZA,2018.0,2,2,0
DO,CL,2016.0,4,1,3
CM,IT,2022.0,1,5,-4
SG,GR,2006.0,1,1,0
CZ,RO,2006.0,1,4,-3
AE,SY,2020.0,2,2,0
ID,PS,2019.0,2,2,0
CA,BW,2016.0,2,1,1
PH,CO,2010.0,2,2,0
NL,NG,2000.0,1,1,0
AE,AT,2009.0,1,2,-1
CL,EC,2023.0,2,1,1
NL,GA,2020.0,2,4,-2
JO,HU,2020.0,3,2,1
ZW,MX,2019.0,1,2,-1
CR,PT,2005.0,1,1,0
SY,IN,2007.0,1,1,0
TZ,MW,2009.0,1,2,-1
CA,LY,2021.0,2,2,0
CH,SK,2009.0,4,13,-9
AU,GA,2011.0,1,1,0
KZ,UA,2014.0,2,2,0
IN,TZ,2011.0,1,1,0
TH,DK,2022.0,1,2,-1
DK,BD,2013.0,1,4,-3
CL,DK,2017.0,2,7,-5
EG,JO,1999.0,1,1,0
SI,PT,2017.0,1,1,0
TR,BH,2013.0,1,1,0
FI,BD,2019.0,2,6,-4
VN,BY,2015.0,1,2,-1
CN,GE,2004.0,1,2,-1
RW,BE,2016.0,1,2,-1
SN,US,2000.0,2,3,-1
GB,FJ,2016.0,1,4,-3
PS,DE,2013.0,3,9,-6
nan,MM,2021.0,2,1,1
ES,LK,2016.0,1,3,-2
FR,BY,2002.0,1,2,-1
UY,CH,2010.0,2,1,1
MW,JP,2018.0,2,2,0
AU,GH,1997.0,1,1,0
SG,BR,2007.0,1,4,-3
NA,ZA,2004.0,1,1,0
FI,UG,2011.0,1,1,0
ZW,CN,2020.0,1,1,0
PT,PH,2014.0,1,1,0
NZ,LU,2019.0,1,1,0
KE,RW,2012.0,1,1,0
TN,KW,2016.0,1,1,0
nan,EE,2021.0,1,1,0
NO,SI,2017.0,1,1,0
IS,CH,2009.0,1,1,0
PH,CL,2013.0,1,4,-3
MT,SE,2021.0,2,2,0
KR,HK,2019.0,2,1,1
PH,MX,2001.0,1,1,0
EG,UA,2017.0,1,1,0
UA,AU,2009.0,1,1,0
PL,GR,2021.0,1,1,0
KE,BW,2008.0,1,2,-1
LK,CA,2003.0,1,4,-3
NO,PK,1998.0,1,1,0
DE,LV,2005.0,2,3,-1
AT,TW,2016.0,2,4,-2
BH,KE,2001.0,2,1,1
IQ,IR,2009.0,1,1,0
AU,BT,2017.0,1,4,-3
EG,AT,2013.0,2,3,-1
PK,KH,2015.0,1,2,-1
VN,FJ,2021.0,1,1,0
SK,UA,2020.0,2,9,-7
DK,SK,2017.0,1,4,-3
KH,RU,2011.0,1,1,0
MY,TR,2002.0,2,1,1
ID,RU,2013.0,1,3,-2
US,NE,2021.0,1,2,-1
ZA,ZM,2007.0,1,2,-1
SA,PL,2020.0,2,1,1
UA,ID,2020.0,1,9,-8
AT,CL,2002.0,1,1,0
JO,CH,2018.0,1,2,-1
MX,IE,1998.0,1,2,-1
SI,BR,2013.0,1,2,-1
SE,RW,2022.0,1,1,0
PT,SI,2017.0,1,1,0
VN,FI,2015.0,1,1,0
PL,PE,2021.0,2,1,1
HR,AT,2007.0,1,2,-1
NL,UA,2016.0,1,5,-4
JO,MY,2006.0,1,5,-4
BE,ME,2017.0,1,1,0
ID,AZ,2017.0,2,10,-8
CZ,MX,2001.0,2,1,1
DK,RO,2010.0,1,1,0
TG,MA,2013.0,1,1,0
TL,AU,2009.0,1,1,0
NL,UZ,2019.0,1,1,0
AT,DZ,2018.0,1,1,0
MA,SN,2018.0,2,6,-4
IT,SG,1999.0,1,1,0
BR,TW,2008.0,1,1,0
MG,BE,2017.0,1,1,0
BD,FR,2021.0,1,4,-3
LB,SY,2014.0,2,2,0
CN,CR,2002.0,1,1,0
CD,RW,2021.0,1,2,-1
CN,CI,2022.0,1,3,-2
IS,NL,2013.0,1,5,-4
SS,US,2001.0,1,2,-1
GR,FI,2000.0,1,1,0
MA,LY,2019.0,1,1,0
VE,CA,2004.0,1,4,-3
CM,JP,2021.0,1,3,-2
BE,OM,2015.0,1,1,0
GB,MU,2020.0,1,2,-1
NP,CH,2019.0,1,2,-1
CN,GR,2023.0,1,1,0
IQ,UA,2021.0,1,1,0
AU,CO,2004.0,2,2,0
CM,BF,2016.0,1,2,-1
MY,LK,2021.0,4,2,2
SE,SK,2021.0,1,1,0
JP,LT,2018.0,2,12,-10
CR,DE,2003.0,1,4,-3
NI,CO,2012.0,1,3,-2
NO,RS,2018.0,1,4,-3
JP,CM,2014.0,1,1,0
NL,TH,1999.0,2,1,1
ID,BW,2019.0,1,1,0
ID,PH,2017.0,2,7,-5
AE,JO,1999.0,1,5,-4
BE,SN,2016.0,1,2,-1
JP,VE,2006.0,1,1,0
CZ,IE,2004.0,1,1,0
BW,KE,2015.0,1,1,0
AO,IT,2020.0,3,2,1
NP,AU,2007.0,2,2,0
PH,ID,2015.0,1,2,-1
PR,VN,2007.0,2,0,2
BR,CR,2005.0,2,0,2
EC,SE,2002.0,1,0,1
ZW,CG,2003.0,1,0,1
VE,AU,2007.0,1,0,1
BN,JP,2020.0,2,0,2
,BZ,2005.0,2,0,2
LS,TZ,2011.0,1,0,1
TH,LY,2021.0,1,0,1
TL,ID,2020.0,1,0,1
UY,CH,2017.0,1,0,1
MT,UY,2012.0,1,0,1
CN,BH,2004.0,2,0,2
DK,MY,2008.0,1,0,1
CR,ST,2002.0,1,0,1
FI,GP,1997.0,1,0,1
PT,SI,2019.0,3,0,3
MZ,LV,2019.0,1,0,1
PE,PL,2019.0,1,0,1
NL,CY,2009.0,1,0,1
PK,PS,2010.0,1,0,1
PH,FI,2012.0,1,0,1
GT,PH,2018.0,2,0,2
AM,BR,2015.0,1,0,1
MG,,1998.0,1,0,1
UZ,PK,2003.0,1,0,1
SI,QA,2018.0,1,0,1
OM,BH,2016.0,1,0,1
TW,KH,2015.0,1,0,1
KR,CG,2021.0,1,0,1
AZ,SI,2016.0,1,0,1
ET,IQ,2014.0,1,0,1
JP,BJ,2013.0,2,0,2
KR,BH,2009.0,2,0,2
PE,VN,2016.0,2,0,2
GH,BR,2011.0,1,0,1
DE,LI,2001.0,1,0,1
SD,UA,2017.0,1,0,1
DZ,CY,2019.0,2,0,2
SD,UA,2019.0,1,0,1
SK,BG,2016.0,1,0,1
EC,CD,2009.0,1,0,1
AR,CM,2003.0,1,0,1
LK,AF,2016.0,1,0,1
BE,RW,1999.0,1,0,1
MN,CZ,2020.0,1,0,1
MY,SI,2007.0,1,0,1
PT,GW,2019.0,1,0,1
GR,HR,2013.0,1,0,1
NG,AR,2020.0,1,0,1
KE,RU,2009.0,1,0,1
IN,AG,2021.0,1,0,1
BE,NC,2009.0,1,0,1
PK,QA,2004.0,1,0,1
ID,PT,2004.0,1,0,1
GR,LI,2010.0,1,0,1
CY,IN,2009.0,1,0,1
LS,US,2021.0,2,0,2
BB,nan,2021.0,1,0,1
PR,QA,2020.0,1,0,1
UG,NA,2014.0,1,0,1
NZ,IS,2023.0,1,0,1
PH,PT,2000.0,1,0,1
CH,NP,2010.0,1,0,1
NG,GD,2012.0,1,0,1
PK,SO,2015.0,1,0,1
RS,AZ,2018.0,1,0,1
UY,MA,2000.0,1,0,1
FR,XK,2013.0,1,0,1
BH,JP,2008.0,1,0,1
MA,SA,2005.0,1,0,1
MY,NZ,1997.0,1,0,1
CA,ZM,2014.0,3,0,3
MZ,CO,2012.0,1,0,1
ET,UY,2017.0,1,0,1
MW,KR,2014.0,1,0,1
PS,NG,2017.0,1,0,1
BG,OM,2004.0,1,0,1
SN,,1998.0,1,0,1
BD,KE,2010.0,1,0,1
VE,CR,2002.0,1,0,1
GB,IM,1998.0,1,0,1
MS,JM,1998.0,1,0,1
LT,GE,2019.0,1,0,1
FJ,NG,2005.0,1,0,1
KR,CO,2022.0,1,0,1
CA,AE,1997.0,1,0,1
BH,FR,2005.0,1,0,1
,BN,2020.0,4,0,4
NE,MA,2021.0,1,0,1
CU,BB,2010.0,1,0,1
DZ,SL,2014.0,1,0,1
CO,AE,2012.0,1,0,1
IE,LU,2019.0,1,0,1
KZ,AU,2023.0,1,0,1
CL,HR,2021.0,1,0,1
KZ,BE,2004.0,1,0,1
ZW,NL,2016.0,1,0,1
NL,CL,1997.0,1,0,1
NL,XK,2022.0,1,0,1
VN,ZA,2009.0,1,0,1
DO,GB,2013.0,1,0,1
IL,PT,2006.0,1,0,1
EC,ZA,2012.0,1,0,1
KY,CA,2019.0,1,0,1
BY,BR,2004.0,2,0,2
TJ,IN,2013.0,1,0,1
SG,CO,2004.0,1,0,1
IL,UZ,2020.0,1,0,1
MA,TZ,2014.0,1,0,1
FI,PH,2014.0,1,0,1
FR,MR,2008.0,1,0,1
SE,TR,2023.0,1,0,1
BJ,MG,2006.0,1,0,1
PK,IT,2004.0,3,0,3
SK,LT,2016.0,1,0,1
CA,BB,2012.0,1,0,1
NO,LT,2005.0,1,0,1
CD,NE,2011.0,1,0,1
SD,TN,2010.0,1,0,1
PH,ZW,2018.0,1,0,1
KH,CH,2011.0,2,0,2
BO,CO,2005.0,1,0,1
BR,TZ,2018.0,1,0,1
IQ,KH,2022.0,1,0,1
CM,UG,2022.0,1,0,1
SK,LV,2022.0,1,0,1
VG,MX,2017.0,1,0,1
PT,RS,2016.0,1,0,1
TN,GF,2019.0,1,0,1
DK,KH,2017.0,1,0,1
PL,AL,2021.0,1,0,1
NP,BR,2017.0,1,0,1
ZW,AE,2021.0,1,0,1
ET,AE,2020.0,1,0,1
FI,KW,2009.0,1,0,1
CN,TG,2016.0,2,0,2
CD,ZM,2017.0,1,0,1
ER,US,1999.0,1,0,1
NZ,MT,2012.0,1,0,1
IT,TN,2000.0,1,0,1
SK,KR,2001.0,1,0,1
GR,AM,2002.0,1,0,1
EC,WS,2010.0,1,0,1
SI,GH,2019.0,1,0,1
ZW,CA,2007.0,1,0,1
IT,IQ,2016.0,1,0,1
GB,SJ,2021.0,1,0,1
PT,UA,2008.0,1,0,1
NG,AF,2021.0,1,0,1
GE,SE,2013.0,1,0,1
IL,LV,2016.0,1,0,1
ML,DE,2012.0,2,0,2
IR,IL,2004.0,1,0,1
,GI,2007.0,1,0,1
nan,RW,2014.0,1,0,1
ID,AO,2021.0,1,0,1
PK,ES,1998.0,1,0,1
AT,BA,2010.0,1,0,1
EC,UY,2003.0,1,0,1
PH,UY,2017.0,1,0,1
TT,GY,2019.0,1,0,1
ZA,BI,2020.0,1,0,1
LT,IQ,2018.0,1,0,1
PG,ES,2008.0,1,0,1
KH,ID,2016.0,1,0,1
LB,TN,2010.0,1,0,1
SY,QA,2006.0,1,0,1
JM,DE,2002.0,2,0,2
CR,IL,2005.0,1,0,1
PL,ID,2014.0,1,0,1
PK,IL,2004.0,1,0,1
RO,MW,2008.0,1,0,1
ET,CN,1997.0,1,0,1
TZ,PL,2016.0,1,0,1
BO,BE,2016.0,1,0,1
SE,HN,1998.0,1,0,1
MT,ID,2019.0,1,0,1
LV,MY,2016.0,1,0,1
JP,TT,2005.0,1,0,1
PK,YE,2019.0,1,0,1
HN,SV,2016.0,1,0,1
SS,FR,2004.0,1,0,1
UZ,IS,1999.0,1,0,1
CN,KH,2018.0,1,0,1
FI,MY,2005.0,1,0,1
GL,,2008.0,1,0,1
GB,GY,2020.0,1,0,1
BR,HN,2001.0,1,0,1
CN,CV,2019.0,1,0,1
AR,GP,2020.0,1,0,1
DK,ME,2021.0,1,0,1
GF,,2006.0,1,0,1
HU,LV,2017.0,1,0,1
BN,PH,2020.0,1,0,1
BR,AF,2011.0,1,0,1
GT,NZ,2020.0,1,0,1
GB,IT,2009.0,307,441,-134
DE,GB,2007.0,726,558,168
EG,QA,2019.0,79,83,-4
SG,CN,2007.0,315,224,91
TR,IR,2007.0,3,4,-1
CN,AU,2005.0,186,159,27
CN,US,2014.0,4918,5959,-1041
US,ES,2004.0,538,574,-36
US,GB,1999.0,3288,3092,196
CN,KR,2021.0,224,261,-37
FR,US,2008.0,1291,1286,5
SE,AU,2011.0,54,55,-1
CN,GB,2021.0,541,712,-171
CA,GB,2005.0,621,634,-13
US,CA,2009.0,2938,2881,57
CZ,DK,2021.0,4,2,2
FR,CA,2000.0,254,212,42
JP,CN,2019.0,596,446,150
US,TW,2009.0,722,697,25
JP,LT,2017.0,3,11,-8
NO,PT,2001.0,2,2,0
US,NO,2011.0,156,114,42
CR,MX,2018.0,58,50,8
NL,KR,2005.0,7,3,4
ES,MY,2010.0,2,1,1
CO,AR,2012.0,89,86,3
BR,DE,1999.0,24,43,-19
GB,IN,2012.0,443,339,104
DE,CL,2020.0,56,56,0
CN,CA,2005.0,280,354,-74
TW,US,1999.0,327,462,-135
GB,MY,2014.0,180,87,93
US,NP,2004.0,12,6,6
US,ZA,2022.0,195,203,-8
US,SA,2015.0,239,131,108
CA,GB,2002.0,492,505,-13
GB,CN,2012.0,568,401,167
GB,AU,2008.0,1185,965,220
IN,CN,2022.0,186,152,34
MX,CO,2006.0,108,75,33
CN,MY,2001.0,9,11,-2
DE,NL,2009.0,294,291,3
DK,CA,2011.0,37,41,-4
ES,FR,2016.0,383,296,87
DK,DE,2006.0,63,83,-20
US,DK,2009.0,293,186,107
EG,BE,2004.0,3,2,1
CZ,DE,1997.0,8,8,0
CN,DE,2022.0,273,325,-52
TW,TR,2016.0,8,3,5
US,IN,2015.0,2607,2471,136
US,SG,2016.0,451,490,-39
US,AT,2004.0,149,187,-38
AT,US,2005.0,179,168,11
IL,US,2011.0,466,474,-8
US,GE,2003.0,95,98,-3
ES,IT,2015.0,241,245,-4
SE,CO,2013.0,4,5,-1
JP,CN,2017.0,541,426,115
MX,US,1999.0,143,142,1
US,AR,2014.0,274,235,39
BR,US,2009.0,851,866,-15
DE,AT,2004.0,343,301,42
IN,CA,2022.0,161,123,38
US,SE,1999.0,257,239,18
AZ,ID,2015.0,22,1,21
JP,IN,2011.0,133,134,-1
ZA,GB,2020.0,181,156,25
IR,CH,2015.0,38,21,17
DE,ES,2017.0,244,272,-28
DE,ES,2010.0,205,193,12
FR,BR,2020.0,228,216,12
EG,AE,2012.0,18,25,-7
CA,TW,2002.0,21,26,-5
NL,FR,2022.0,65,72,-7
KR,CA,2006.0,34,32,2
KR,GB,2012.0,97,96,1
SV,CL,2003.0,1,1,0
CA,BR,2018.0,285,276,9
AO,BR,2017.0,27,18,9
RU,SE,2013.0,30,27,3
CH,CG,2017.0,4,3,1
DE,IT,1997.0,79,87,-8
MK,AU,2002.0,10,7,3
IE,OM,2019.0,3,3,0
LU,IT,2017.0,4,19,-15
GB,ZA,2020.0,156,181,-25
ES,BE,2013.0,94,64,30
BG,DE,2000.0,21,12,9
IN,JP,1997.0,41,43,-2
JP,MY,2018.0,80,46,34
NL,DK,2008.0,28,21,7
RS,HR,1997.0,7,8,-1
BY,CN,2018.0,1,1,0
DE,ES,2019.0,284,297,-13
DE,US,2023.0,89,65,24
TH,SG,2014.0,5,13,-8
DE,GR,2022.0,36,31,5
RU,GB,2003.0,78,45,33
ZA,US,2023.0,15,15,0
BE,FR,1997.0,103,96,7
NL,nan,2021.0,55,65,-10
AR,CL,2014.0,101,94,7
CN,AU,2002.0,114,118,-4
GB,NL,2022.0,244,190,54
CA,ID,2016.0,40,27,13
ES,DE,1999.0,63,57,6
ES,DK,2008.0,67,14,53
US,MY,2022.0,116,99,17
PK,SE,2011.0,14,9,5
CR,BR,2016.0,15,23,-8
US,NL,2000.0,322,349,-27
GB,ES,2003.0,144,165,-21
SK,JP,2003.0,25,20,5
BE,DE,2020.0,157,148,9
RU,RS,2011.0,16,11,5
MA,FR,2001.0,121,143,-22
ES,BD,1998.0,4,1,3
AU,SG,2014.0,127,109,18
NL,SE,2005.0,28,32,-4
US,PL,1999.0,114,111,3
US,IR,2008.0,171,140,31
GB,CY,2022.0,28,16,12
IE,AU,2012.0,106,88,18
SG,CA,2007.0,29,29,0
CO,JP,2008.0,4,7,-3
SA,SD,2014.0,11,26,-15
CN,FI,2011.0,20,29,-9
JP,QA,2000.0,2,1,1
SK,NL,2006.0,9,7,2
US,RS,2008.0,61,31,30
PT,RS,2022.0,3,1,2
BW,IN,2016.0,1,1,0
GB,DK,2010.0,113,92,21
DE,FR,2008.0,526,470,56
IN,ES,1997.0,2,5,-3
BE,ZA,2008.0,10,14,-4
SE,EE,2005.0,10,5,5
NL,SE,2002.0,22,30,-8
BE,NO,2020.0,11,17,-6
NL,CN,2006.0,58,61,-3
CN,nan,2010.0,185,207,-22
FR,nan,2000.0,52,52,0
CN,CZ,2012.0,51,48,3
CN,nan,2017.0,100,114,-14
EG,JP,2014.0,49,67,-18
CN,nan,2019.0,116,137,-21
CN,KH,2010.0,2,2,0
TR,CN,2013.0,76,90,-14
PL,IN,2015.0,12,21,-9
JO,EG,2015.0,12,6,6
CA,SA,2020.0,126,75,51
NZ,NP,2020.0,65,65,0
ZA,JP,1999.0,3,3,0
RS,RU,2018.0,12,12,0
PK,ID,2021.0,45,68,-23
FR,CN,2023.0,9,11,-2
GB,PH,2018.0,20,29,-9
JP,LT,2010.0,6,12,-6
US,CU,2018.0,41,74,-33
MX,IT,2009.0,24,31,-7
NO,NL,2021.0,27,33,-6
ES,TN,2015.0,11,7,4
SE,BR,2007.0,11,12,-1
BJ,NG,2021.0,9,2,7
RU,ZA,2007.0,4,1,3
NZ,IN,2000.0,4,9,-5
MX,BR,2022.0,50,58,-8
RS,US,2020.0,53,54,-1
GB,SA,2014.0,136,55,81
PS,IL,2015.0,4,1,3
AR,FR,2016.0,91,108,-17
IR,MA,2014.0,10,4,6
TH,FR,2011.0,11,21,-10
MM,JP,2015.0,4,10,-6
DE,TZ,2021.0,5,1,4
DE,BY,2013.0,2,3,-1
KE,US,2022.0,41,33,8
PT,BE,2012.0,13,9,4
IL,DE,2009.0,57,46,11
NL,TR,2014.0,31,31,0
IT,AR,2017.0,119,79,40
RU,nan,2012.0,37,66,-29
PE,CO,2011.0,26,32,-6
AT,DK,2000.0,8,4,4
NG,ZA,2014.0,64,31,33
nan,NZ,2009.0,86,7,79
CN,LT,2004.0,11,1,10
US,CZ,2016.0,184,110,74
NL,FI,2007.0,38,45,-7
PL,FI,2008.0,4,8,-4
PE,CA,2010.0,2,7,-5
PH,CA,2014.0,7,11,-4
BE,CH,2015.0,93,56,37
EG,CA,2023.0,6,2,4
AU,CH,2016.0,85,82,3
GB,AE,2020.0,76,38,38
PE,nan,2018.0,16,10,6
BE,BR,2020.0,94,68,26
CN,TH,2014.0,29,27,2
IN,SG,2010.0,75,33,42
EG,IN,2016.0,19,14,5
KR,PR,2015.0,32,38,-6
JP,IT,2014.0,75,60,15
US,SL,2015.0,8,1,7
MX,VE,2016.0,32,61,-29
CR,CU,2012.0,13,17,-4
KE,ZW,2020.0,1,5,-4
FR,UG,2013.0,7,3,4
DZ,US,2011.0,17,20,-3
HR,RS,2008.0,81,79,2
FI,HU,2012.0,5,11,-6
SK,US,2018.0,37,47,-10
BE,AT,2021.0,18,11,7
SN,CA,2012.0,3,2,1
NG,DE,2012.0,6,14,-8
IR,ES,2013.0,14,11,3
CH,CZ,2004.0,17,15,2
MY,BR,2022.0,7,10,-3
EG,QA,2017.0,69,71,-2
CN,GE,2014.0,5,5,0
DK,IN,2013.0,19,13,6
KR,IT,2011.0,9,5,4
UA,US,2004.0,37,19,18
RU,LV,2005.0,13,11,2
DK,MY,2013.0,4,2,2
BR,CO,2000.0,11,13,-2
GB,IR,2022.0,32,90,-58
US,DZ,2019.0,93,73,20
FR,DK,2022.0,26,24,2
AU,GR,2017.0,10,13,-3
CN,TR,2003.0,9,21,-12
RO,RU,2008.0,2,4,-2
GB,TH,2010.0,49,27,22
IT,DK,2002.0,13,11,2
CZ,PL,2006.0,21,31,-10
SE,LK,2013.0,4,4,0
CO,MX,1999.0,29,24,5
BF,CI,2021.0,6,2,4
SG,KR,2016.0,40,40,0
IN,SG,2017.0,165,121,44
PK,KR,2009.0,7,4,3
MY,KW,2020.0,8,6,2
VN,TH,2022.0,10,10,0
AR,US,2013.0,235,244,-9
AZ,RU,2010.0,11,10,1
CH,HU,2020.0,17,13,4
EE,FI,2018.0,20,12,8
RU,GR,2015.0,1,9,-8
nan,IN,2021.0,95,85,10
KR,SD,2020.0,14,17,-3
TZ,GB,2020.0,18,14,4
CA,BE,2022.0,29,23,6
TH,VN,2022.0,10,10,0
IL,NO,2021.0,4,2,2
SI,US,2020.0,22,23,-1
AR,VE,2007.0,15,11,4
US,VG,2018.0,8,17,-9
FI,BD,2018.0,4,4,0
VN,CZ,2015.0,1,3,-2
VN,RU,2016.0,4,9,-5
ET,AU,2017.0,15,8,7
BR,UY,2020.0,57,50,7
BE,nan,2014.0,22,25,-3
US,ZW,2013.0,7,9,-2
CN,FR,1997.0,28,28,0
nan,CN,2020.0,115,117,-2
CH,BD,2018.0,9,1,8
SE,CN,2003.0,72,30,42
UA,CN,2020.0,28,34,-6
IL,JO,2020.0,3,2,1
TH,GB,2013.0,33,81,-48
AU,TH,2020.0,36,22,14
ID,ES,2017.0,13,22,-9
JP,VN,2018.0,87,40,47
SD,EG,2012.0,18,7,11
CN,BD,2022.0,33,36,-3
AL,US,2016.0,1,2,-1
NO,AT,2017.0,11,17,-6
MY,IQ,2016.0,85,30,55
LT,DE,2014.0,7,8,-1
IN,CZ,2006.0,18,10,8
TR,NL,2022.0,23,17,6
CY,IR,2022.0,5,5,0
BF,FR,2018.0,17,18,-1
RS,SK,2021.0,5,7,-2
CH,MA,2018.0,6,4,2
US,KW,2022.0,18,9,9
FR,ML,2021.0,17,14,3
SA,MY,2021.0,28,52,-24
ID,PK,2021.0,68,45,23
TR,CH,2008.0,12,10,2
QA,SA,2022.0,18,21,-3
GR,FR,2018.0,69,47,22
IQ,GB,2012.0,8,20,-12
JP,PE,2017.0,4,1,3
KH,JP,2022.0,3,2,1
CA,UA,2011.0,6,2,4
IN,PH,2017.0,18,25,-7
CA,SG,2020.0,45,46,-1
IR,nan,2020.0,5,5,0
GB,UA,2021.0,13,10,3
CH,PK,2020.0,23,22,1
AT,RU,2019.0,23,15,8
US,BO,2017.0,6,7,-1
TH,KH,2021.0,7,1,6
CN,FR,1998.0,36,55,-19
TW,ID,2015.0,25,17,8
NL,IT,2017.0,95,144,-49
DE,IT,1998.0,93,127,-34
DK,HU,2009.0,1,4,-3
KR,US,2023.0,67,51,16
DE,SE,2006.0,115,117,-2
IN,JP,1998.0,79,70,9
NL,IT,2019.0,106,147,-41
FR,BI,2009.0,24,24,0
PL,DE,2004.0,74,87,-13
FR,UA,2020.0,12,13,-1
CA,PK,2015.0,48,49,-1
FR,DE,2003.0,314,304,10
PT,CO,2006.0,4,3,1
CA,TR,2013.0,30,18,12
AT,US,2002.0,170,134,36
HU,DE,2014.0,72,46,26
US,DZ,2017.0,60,41,19
GB,RS,2019.0,17,17,0
US,LR,2016.0,4,1,3
CO,GB,2018.0,30,31,-1
CM,MA,2020.0,1,3,-2
BE,GR,2022.0,12,8,4
ID,CH,2017.0,3,15,-12
CZ,HU,2019.0,8,13,-5
ES,ID,2013.0,15,10,5
JP,UA,2020.0,4,5,-1
CH,NO,2013.0,32,22,10
NL,CW,2015.0,11,26,-15
AE,OM,2005.0,1,2,-1
MX,RU,2017.0,14,6,8
MX,RU,2019.0,14,4,10
FR,SG,2011.0,30,14,16
NL,AR,1999.0,5,2,3
FR,CM,2006.0,12,12,0
PL,BD,2006.0,1,2,-1
SD,BR,2014.0,16,7,9
BG,GB,2012.0,11,10,1
CH,SG,2005.0,6,2,4
IN,BD,2012.0,65,64,1
GB,DK,2017.0,140,158,-18
OM,US,2020.0,12,21,-9
CR,ZA,2017.0,3,3,0
JP,TH,2005.0,69,23,46
PL,GB,2015.0,106,112,-6
CA,nan,2001.0,13,7,6
KR,PH,2013.0,9,12,-3
TR,DK,2014.0,6,7,-1
TN,FR,2001.0,24,38,-14
NL,GR,2004.0,19,12,7
RU,CO,2014.0,3,1,2
UA,RU,2002.0,90,69,21
GR,AT,2011.0,10,3,7
CO,US,2001.0,52,57,-5
IT,PT,2006.0,15,14,1
JP,BD,2005.0,35,16,19
TT,IN,2005.0,3,1,2
IT,UA,2017.0,38,28,10
NZ,IE,2022.0,9,12,-3
ET,IN,2015.0,11,27,-16
PE,MX,2008.0,36,28,8
AT,LU,2016.0,7,3,4
UG,US,2012.0,23,23,0
ID,AU,2002.0,6,10,-4
RU,BR,2019.0,9,19,-10
CR,ZA,2019.0,6,1,5
nan,IL,2013.0,20,21,-1
DK,QA,2016.0,2,1,1
PK,NZ,2018.0,8,6,2
TN,CA,2018.0,14,14,0
IT,QA,2018.0,9,7,2
IL,NG,2020.0,2,3,-1
IR,KR,2020.0,17,9,8
GR,DK,2016.0,14,7,7
KE,BR,2021.0,4,1,3
AU,nan,2002.0,10,8,2
NP,NO,2018.0,2,5,-3
SE,NO,2023.0,9,5,4
RS,AU,2020.0,10,5,5
DE,HU,2018.0,57,69,-12
FR,SN,2014.0,36,28,8
BE,SN,2022.0,1,2,-1
NL,IT,2010.0,74,114,-40
EG,OM,2007.0,2,1,1
GB,MX,2013.0,57,54,3
IN,BR,2016.0,37,24,13
JP,IL,2011.0,5,13,-8
AR,IN,2006.0,3,1,2
KE,GB,2016.0,21,33,-12
JP,MX,2015.0,10,9,1
DK,GH,2019.0,1,2,-1
PT,KR,2009.0,4,3,1
GB,RS,2010.0,17,13,4
FR,PK,2016.0,26,12,14
DE,UZ,2007.0,7,2,5
CZ,JP,2004.0,18,16,2
SE,LV,2003.0,5,3,2
CO,nan,2008.0,2,3,-1
AU,ET,2014.0,3,6,-3
SK,RU,2013.0,16,14,2
MY,NL,2008.0,5,1,4
NO,GB,2006.0,39,54,-15
KW,SA,2014.0,17,6,11
CA,TW,2005.0,30,32,-2
PE,AR,2021.0,41,40,1
US,TJ,2022.0,4,1,3
MD,FR,2007.0,89,37,52
MA,CA,2005.0,11,2,9
KZ,RU,2022.0,29,52,-23
RO,HK,2012.0,15,9,6
IT,ES,1999.0,54,61,-7
MG,CN,2018.0,10,4,6
CA,PT,2018.0,20,17,3
TW,NO,2017.0,6,4,2
KR,EG,2011.0,6,6,0
AR,CR,2007.0,3,6,-3
GH,DE,2018.0,13,18,-5
GB,RU,1998.0,47,44,3
CO,PT,2016.0,15,18,-3
IL,MA,2020.0,2,2,0
NL,ID,2008.0,14,6,8
KH,CA,2019.0,3,1,2
LK,BD,2013.0,1,2,-1
EC,AR,2014.0,9,21,-12
DE,BD,2012.0,14,10,4
MX,DK,2013.0,8,6,2
BR,BO,2018.0,7,4,3
FI,CH,2016.0,29,14,15
SA,IN,2008.0,15,28,-13
NP,CN,2012.0,17,24,-7
NL,IL,2000.0,7,11,-4
ZW,US,2002.0,5,2,3
CL,BO,2021.0,9,9,0
NO,nan,2006.0,15,23,-8
FI,CN,1998.0,8,6,2
AU,ES,2011.0,23,44,-21
AT,IL,2021.0,5,9,-4
LB,GB,2016.0,5,16,-11
IE,LU,2018.0,2,3,-1
TR,AU,2018.0,18,16,2
IN,PH,2019.0,20,18,2
ES,AT,2020.0,47,31,16
CN,EG,2018.0,37,29,8
IL,BE,2010.0,4,4,0
AT,IT,2004.0,22,25,-3
MX,SE,1997.0,1,1,0
JO,KW,2018.0,10,8,2
MY,SD,2020.0,10,2,8
BR,MY,2022.0,10,7,3
CZ,ID,2017.0,15,8,7
NP,BD,2015.0,5,5,0
MZ,RU,2009.0,11,10,1
NO,IT,2022.0,8,24,-16
CU,ES,2021.0,73,46,27
GB,PK,1998.0,19,15,4
IN,ZA,2011.0,38,26,12
HK,NL,2020.0,20,9,11
UY,CH,2018.0,1,4,-3
CH,TZ,2020.0,8,9,-1
NO,BE,2021.0,10,15,-5
DE,DZ,2011.0,3,4,-1
AU,TW,2014.0,38,44,-6
IE,DE,1999.0,10,15,-5
CZ,HU,2010.0,8,6,2
BE,FR,1998.0,125,130,-5
FR,FI,2002.0,13,4,9
PT,CA,2021.0,14,12,2
US,TH,2022.0,82,60,22
SE,SO,2016.0,1,1,0
IL,nan,2011.0,12,17,-5
NO,JP,2013.0,14,11,3
PA,CA,2018.0,13,4,9
CU,US,1999.0,13,7,6
FR,FI,2005.0,12,12,0
CZ,FI,2021.0,5,6,-1
CH,GR,2013.0,10,29,-19
SG,ID,2018.0,40,15,25
JP,TH,2002.0,24,23,1
IT,NO,2005.0,22,14,8
CY,GR,2008.0,10,18,-8
AU,UG,2008.0,3,2,1
LK,TH,2021.0,2,5,-3
ID,KR,2022.0,23,16,7
IT,DK,2005.0,14,9,5
IT,NO,2002.0,11,20,-9
ZA,CA,2001.0,11,10,1
RS,HR,1998.0,13,9,4
AT,RU,2010.0,11,14,-3
DE,MY,2005.0,5,4,1
IL,PH,2006.0,3,2,1
CA,SE,2015.0,57,57,0
DE,OM,2017.0,4,2,2
RU,CZ,2005.0,14,15,-1
OM,JP,2013.0,2,5,-3
JP,BG,2021.0,1,1,0
EG,QA,2010.0,10,16,-6
AU,JP,2001.0,40,38,2
SE,ES,2000.0,14,18,-4
MA,DZ,2009.0,2,9,-7
GE,ES,2014.0,2,2,0
DZ,MA,2015.0,15,19,-4
CA,BG,2004.0,3,5,-2
MX,JP,2008.0,7,5,2
US,SK,2020.0,29,33,-4
DK,AU,2001.0,18,25,-7
FR,PL,2001.0,31,29,2
SE,AR,2018.0,5,7,-2
RU,SG,2009.0,3,2,1
PL,BE,2020.0,20,17,3
AG,CO,2020.0,8,21,-13
BD,CA,2001.0,4,3,1
SG,CH,2015.0,11,15,-4
ES,CA,2001.0,30,41,-11
ES,NL,2011.0,68,75,-7
DK,PL,2002.0,5,5,0
JP,CO,2016.0,17,15,2
nan,KE,2015.0,3,2,1
nan,AT,2020.0,10,11,-1
LU,IT,2010.0,4,8,-4
KE,NL,2001.0,6,2,4
GR,MX,2008.0,3,7,-4
HR,ME,2012.0,2,1,1
CL,DE,2014.0,40,65,-25
SA,GB,2001.0,10,16,-6
PL,VE,2015.0,3,1,2
AR,PK,2013.0,16,25,-9
BR,GR,2013.0,4,2,2
NL,SI,2015.0,8,8,0
MX,RU,2010.0,9,3,6
nan,PT,2013.0,54,18,36
DE,IS,2015.0,10,7,3
GB,PE,2022.0,7,11,-4
SE,RU,2010.0,30,25,5
GB,RU,1997.0,27,34,-7
SG,BE,2009.0,3,3,0
LT,CZ,2009.0,6,15,-9
CY,GB,2009.0,8,27,-19
IT,AM,2016.0,30,13,17
RU,LT,2011.0,20,2,18
PL,JP,1998.0,12,9,3
GR,CA,2002.0,5,10,-5
TR,GR,2007.0,10,4,6
nan,PE,2020.0,12,9,3
IL,NL,2016.0,15,14,1
NI,PE,2017.0,3,1,2
TH,DE,2005.0,8,8,0
PE,GB,2008.0,9,5,4
CR,CO,2003.0,4,6,-2
CL,PE,2009.0,26,31,-5
TW,SG,2012.0,48,39,9
AO,BR,2010.0,9,10,-1
RS,PK,2012.0,2,1,1
VN,DE,2016.0,10,25,-15
QA,EG,2004.0,5,7,-2
KR,MY,2011.0,29,6,23
CO,NI,2021.0,3,1,2
JP,EG,2022.0,30,19,11
BE,CI,2005.0,2,1,1
AT,PL,2005.0,11,10,1
FR,GF,2011.0,9,10,-1
NG,BW,2012.0,3,5,-2
KR,TW,2003.0,20,20,0
GB,PL,1999.0,26,23,3
US,PA,2022.0,14,27,-13
IL,IT,2012.0,6,20,-14
FR,MX,2011.0,44,52,-8
ES,AO,2015.0,2,2,0
AU,CO,2014.0,7,9,-2
NG,OM,2019.0,1,2,-1
NO,RS,2017.0,3,1,2
NL,LV,2011.0,1,1,0
ZM,US,2018.0,16,13,3
IL,ID,2014.0,1,3,-2
TH,BR,2018.0,4,6,-2
CN,RS,2020.0,3,3,0
CH,IN,1997.0,6,5,1
PK,IQ,2015.0,12,8,4
AO,BR,2019.0,24,40,-16
EE,FR,2017.0,7,12,-5
AU,ZA,2011.0,40,54,-14
EG,AU,2006.0,7,1,6
PK,DE,2004.0,8,6,2
MX,AT,2000.0,2,4,-2
IN,ES,1998.0,7,6,1
SA,PK,1997.0,3,5,-2
US,MK,2013.0,11,7,4
CA,IR,1999.0,17,6,11
NO,AT,2010.0,9,10,-1
IN,PH,2010.0,11,7,4
PT,US,2023.0,8,11,-3
BG,CN,2011.0,18,13,5
RU,BR,2010.0,6,15,-9
CO,DE,2001.0,4,4,0
FI,BR,2013.0,8,5,3
PH,CO,2018.0,8,8,0
EC,CA,2016.0,5,7,-2
IN,AT,2013.0,17,10,7
SA,JO,2019.0,67,54,13
KR,FI,2014.0,2,4,-2
BR,CU,2016.0,16,43,-27
KR,IR,2004.0,1,1,0
RU,CZ,2002.0,9,13,-4
MX,PL,2015.0,10,5,5
CH,ZA,2009.0,6,18,-12
DK,TR,2020.0,12,14,-2
ES,GR,2013.0,16,23,-7
EE,DE,2001.0,11,9,2
MA,KW,2002.0,2,2,0
IL,BE,2019.0,7,10,-3
nan,TW,2014.0,5,7,-2
FI,SG,2005.0,2,1,1
NZ,IR,2020.0,8,31,-23
US,BO,2010.0,7,8,-1
CL,FR,2001.0,9,17,-8
CL,DK,2018.0,5,1,4
IQ,KW,2021.0,10,14,-4
LK,NZ,2021.0,3,5,-2
VG,US,2011.0,10,11,-1
HR,SI,2015.0,22,42,-20
NL,AT,2004.0,9,17,-8
DE,RO,2007.0,36,22,14
TR,YE,2017.0,1,1,0
MA,CA,2002.0,4,5,-1
BE,FI,2006.0,5,8,-3
CY,US,2000.0,6,8,-2
MX,RS,2017.0,7,2,5
FR,IR,2016.0,28,47,-19
SE,KE,2006.0,3,3,0
JO,AE,2006.0,4,3,1
HR,AU,2021.0,2,3,-1
AE,FR,2018.0,15,14,1
TR,IT,2005.0,15,13,2
GT,ES,2012.0,9,7,2
HU,CA,2012.0,16,11,5
MD,US,2007.0,7,1,6
MK,AU,2005.0,15,22,-7
IE,JP,2021.0,27,14,13
TT,US,2018.0,10,14,-4
US,CD,2012.0,1,4,-3
IN,RU,2002.0,4,4,0
US,TN,2004.0,10,5,5
FR,MG,2020.0,7,7,0
AU,MY,2007.0,19,14,5
BE,DK,2005.0,9,7,2
CA,GH,2012.0,6,4,2
GB,KW,2006.0,5,7,-2
MX,HN,2016.0,19,31,-12
MM,CN,2015.0,2,2,0
CA,RO,2013.0,12,11,1
DK,GH,2017.0,2,1,1
DK,FI,2015.0,19,27,-8
KP,CN,2014.0,1,3,-2
SG,DK,2006.0,8,1,7
SE,IN,2003.0,13,22,-9
GB,BG,2008.0,6,7,-1
TH,DE,2002.0,6,7,-1
IT,UA,2010.0,9,24,-15
UZ,US,2009.0,6,2,4
CA,GR,2009.0,14,8,6
ZW,US,2005.0,13,4,9
ID,PH,2018.0,4,6,-2
SJ,NO,2015.0,7,8,-1
PE,CU,2018.0,15,13,2
TR,IT,2002.0,10,7,3
EG,AT,2008.0,4,5,-1
SE,FR,1997.0,19,25,-6
ES,SE,1999.0,15,27,-12
NL,CZ,2020.0,15,16,-1
IL,AT,2005.0,4,3,1
DK,RO,2018.0,1,1,0
BG,BE,2007.0,6,4,2
US,UY,2016.0,23,26,-3
RS,TR,1997.0,7,4,3
SI,ES,2005.0,5,4,1
DZ,MN,2014.0,3,3,0
BR,SI,2016.0,5,1,4
MN,JP,2013.0,3,5,-2
DE,NG,2001.0,3,4,-1
TZ,ZA,2020.0,8,10,-2
ET,AU,2019.0,16,11,5
NG,KR,2021.0,3,9,-6
NL,NA,2015.0,1,1,0
HT,US,2019.0,9,5,4
CH,ZW,2019.0,4,1,3
SE,FR,1998.0,22,35,-13
BE,UA,2003.0,2,3,-1
AU,QA,2014.0,12,3,9
HU,CN,2009.0,5,2,3
GH,IN,2017.0,8,7,1
NG,MY,2013.0,24,25,-1
GB,LV,2016.0,4,2,2
BR,TW,2013.0,2,1,1
FI,IR,2015.0,8,16,-8
RE,IT,2000.0,1,1,0
NO,CH,2005.0,5,14,-9
EE,FR,2019.0,8,9,-1
BR,SE,2012.0,12,18,-6
SG,NZ,2002.0,4,3,1
FI,CN,1997.0,2,1,1
ES,MY,2019.0,5,6,-1
ES,SV,2011.0,1,3,-2
PH,PK,2014.0,1,2,-1
AZ,RU,2019.0,28,21,7
AM,IT,2018.0,26,42,-16
NZ,BR,2009.0,5,6,-1
TH,IN,2004.0,5,2,3
SY,CA,2009.0,3,2,1
IE,UY,2012.0,1,1,0
KR,CH,2007.0,8,9,-1
BE,VN,2019.0,16,10,6
JP,SK,2009.0,12,11,1
BE,RS,2015.0,6,7,-1
CA,AM,2016.0,3,1,2
LU,DE,2005.0,3,12,-9
HN,VE,2018.0,2,2,0
CO,PA,2015.0,14,13,1
GE,KR,2015.0,2,1,1
RS,TR,1998.0,7,17,-10
DK,nan,2004.0,6,13,-7
BR,CH,1999.0,9,9,0
GB,VG,2011.0,5,5,0
MX,GE,2005.0,2,1,1
NL,HK,2018.0,14,17,-3
US,SS,2015.0,3,3,0
JO,IQ,2007.0,1,3,-2
TW,KR,2000.0,14,13,1
VE,BR,2003.0,7,3,4
MT,IT,2015.0,3,2,1
BD,NL,2004.0,1,3,-2
VN,MX,2018.0,13,6,7
AT,PL,2002.0,7,8,-1
MK,GB,2001.0,1,1,0
TR,AT,2016.0,18,8,10
IE,ZA,2009.0,8,5,3
ZA,TH,2021.0,2,1,1
CZ,GE,2013.0,4,1,3
NL,SG,2021.0,8,18,-10
SE,IL,2016.0,7,7,0
PK,QA,2014.0,6,2,4
DE,PS,2017.0,10,3,7
VN,RO,2015.0,8,3,5
GT,CO,2020.0,6,6,0
SA,OM,2011.0,2,3,-1
JM,BB,2009.0,2,3,-1
MY,ES,2016.0,7,5,2
SG,ZA,2011.0,1,2,-1
NO,CH,2002.0,5,14,-9
GR,MK,2013.0,5,9,-4
NL,UG,2019.0,7,9,-2
PH,CH,2019.0,9,6,3
MZ,BE,2021.0,3,11,-8
QA,IQ,2022.0,12,4,8
GP,FR,2005.0,10,6,4
JO,SA,2004.0,2,3,-1
RU,PH,2019.0,2,1,1
IN,UA,2012.0,8,6,2
DK,NZ,2021.0,2,6,-4
BG,LV,2013.0,2,2,0
UG,CN,2006.0,1,2,-1
NG,BH,2020.0,5,5,0
CZ,IL,2020.0,4,9,-5
BN,IN,2014.0,5,2,3
VN,TW,2008.0,1,3,-2
PK,BJ,2021.0,2,1,1
NL,KR,2002.0,4,4,0
IN,nan,2023.0,2,3,-1
GE,RU,2015.0,5,6,-1
US,LS,2019.0,4,1,3
NO,KE,2016.0,2,2,0
TR,KH,2022.0,9,1,8
DE,BG,2018.0,26,14,12
CH,MD,2020.0,5,5,0
TW,NO,2019.0,5,2,3
ES,CH,2001.0,26,38,-12
RU,SI,2019.0,8,3,5
PT,EC,2017.0,10,5,5
ID,CH,2019.0,8,13,-5
LK,DE,2022.0,2,1,1
CY,CA,2018.0,7,3,4
VE,DE,2018.0,8,3,5
KE,IT,2011.0,3,4,-1
CO,IE,2008.0,2,1,1
ID,AZ,2018.0,7,4,3
CA,PE,2015.0,4,3,1
KH,EG,2022.0,1,1,0
ES,LK,2022.0,3,2,1
US,DO,1997.0,1,2,-1
FI,EE,2006.0,8,7,1
BA,CA,2020.0,1,1,0
MK,GR,2013.0,9,5,4
SA,US,2001.0,46,37,9
FI,PL,2008.0,8,4,4
KE,MY,2012.0,2,1,1
CZ,RS,2006.0,16,14,2
KR,TR,2002.0,1,3,-2
EG,ES,2002.0,1,4,-3
AU,RE,2004.0,1,1,0
QA,KR,2008.0,1,2,-1
SE,CL,2003.0,4,1,3
AT,IN,1998.0,8,1,7
PR,US,2012.0,3,6,-3
AU,UA,2016.0,2,3,-1
EG,NG,2008.0,3,2,1
IL,SK,2002.0,3,1,2
nan,CM,2014.0,2,3,-1
AU,KZ,2018.0,2,1,1
CN,LU,2002.0,2,5,-3
KH,US,2007.0,5,2,3
BE,MZ,2018.0,4,16,-12
IE,ES,2006.0,10,11,-1
RS,CN,2014.0,12,6,6
ZA,TZ,2019.0,11,11,0
IT,UA,2019.0,9,52,-43
BD,IR,2021.0,1,6,-5
QA,RU,2016.0,1,2,-1
DE,LK,2020.0,3,2,1
IL,KR,2008.0,2,3,-1
HR,CH,2001.0,2,3,-1
PT,LU,2009.0,1,1,0
MX,GT,2013.0,12,17,-5
KE,ID,2016.0,4,8,-4
LB,CU,2006.0,4,2,2
KE,CO,2017.0,5,2,3
TR,SE,2000.0,5,1,4
CA,PH,2015.0,11,7,4
AR,BO,2021.0,3,4,-1
TR,NO,2015.0,8,4,4
IT,DZ,2001.0,2,3,-1
AU,GR,2019.0,6,14,-8
PL,PH,2012.0,1,2,-1
CU,PY,2006.0,6,11,-5
CA,MA,2006.0,8,9,-1
CZ,ID,2019.0,10,9,1
FI,BE,2016.0,13,8,5
JO,PS,2015.0,4,3,1
NC,FR,2000.0,5,6,-1
CZ,CA,2015.0,11,14,-3
TN,MX,2012.0,2,4,-2
IT,AE,2018.0,11,5,6
CH,MY,2020.0,3,3,0
SI,DE,2008.0,7,9,-2
QA,CA,2011.0,3,11,-8
PL,BH,2015.0,10,6,4
JO,IT,1998.0,1,3,-2
BE,TR,2011.0,11,14,-3
JO,ES,2012.0,1,2,-1
CH,CO,2012.0,11,8,3
EG,ES,2005.0,4,3,1
NO,ZA,2014.0,6,8,-2
NA,ZA,2014.0,5,8,-3
US,MG,2006.0,2,3,-1
UG,FR,2015.0,5,4,1
US,BY,2004.0,6,9,-3
MA,GB,2010.0,5,5,0
BG,NL,2011.0,1,3,-2
PS,ES,2014.0,8,18,-10
CH,PL,2006.0,11,19,-8
HU,CZ,2016.0,5,9,-4
IE,PH,2010.0,1,2,-1
TZ,US,1997.0,2,5,-3
FI,AU,1998.0,2,3,-1
PK,RS,2008.0,1,1,0
IN,TH,2012.0,6,2,4
PK,SG,2021.0,6,10,-4
IL,AT,2002.0,2,1,1
TN,IT,2009.0,8,4,4
CZ,DE,1998.0,19,20,-1
CZ,BR,2007.0,2,1,1
SA,PK,1998.0,3,7,-4
CA,MY,1999.0,2,6,-4
ID,IR,2014.0,3,8,-5
AT,HU,1999.0,6,6,0
RU,PL,2007.0,16,20,-4
PY,CU,1999.0,5,4,1
EE,US,2007.0,14,14,0
KR,LV,2019.0,1,1,0
AF,MX,2015.0,4,2,2
JM,ZA,2008.0,1,3,-2
IL,CO,2014.0,5,2,3
OM,QA,2009.0,2,2,0
AF,GB,2012.0,1,1,0
BE,VN,2017.0,10,6,4
RU,PH,2017.0,2,5,-3
TW,NL,2019.0,12,3,9
SV,US,2009.0,1,1,0
PL,IL,2014.0,6,5,1
CG,FR,2022.0,9,7,2
NI,PE,2019.0,3,3,0
BE,VN,2010.0,5,2,3
ZM,JP,2013.0,2,2,0
ID,CA,1999.0,1,1,0
FR,KE,2004.0,1,2,-1
US,UZ,2009.0,2,6,-4
TH,NL,1999.0,1,2,-1
NL,ZM,2020.0,4,1,3
PH,RO,2011.0,1,1,0
MW,TZ,2016.0,1,2,-1
BF,KE,2017.0,1,1,0
US,MD,2004.0,2,2,0
IT,RU,2023.0,3,10,-7
MM,TH,2014.0,1,4,-3
MA,GB,2019.0,7,10,-3
MN,AU,2015.0,1,1,0
AE,TT,2018.0,1,1,0
YE,EG,2020.0,6,14,-8
AE,CH,2012.0,1,2,-1
LT,DK,2020.0,5,1,4
NG,CN,2023.0,5,1,4
BD,EG,2015.0,7,7,0
GE,IN,2006.0,1,1,0
SA,JO,2010.0,8,28,-20
TZ,US,1998.0,4,3,1
NO,BG,2008.0,6,21,-15
AE,MA,2020.0,6,3,3
BG,AU,2001.0,3,1,2
CL,CH,2014.0,10,17,-7
CA,OM,2007.0,5,1,4
DE,NI,2019.0,1,1,0
CY,FR,2016.0,3,2,1
MT,US,2004.0,3,5,-2
CZ,HU,2017.0,8,11,-3
PE,CA,2017.0,7,5,2
PT,EC,2019.0,6,6,0
CO,IL,2015.0,4,3,1
LU,NL,2008.0,2,4,-2
CH,SG,2002.0,1,2,-1
CO,EC,2000.0,2,2,0
TW,IE,2016.0,1,1,0
JP,FI,2000.0,8,15,-7
BE,IR,2007.0,3,3,0
PK,IT,2014.0,14,12,2
ZA,RU,2007.0,1,4,-3
CU,PE,1998.0,1,1,0
FR,TZ,2006.0,5,3,2
AU,HR,2021.0,3,2,1
QA,PS,2022.0,2,2,0
NL,CO,2018.0,19,13,6
VN,GR,2010.0,5,4,1
HU,HR,2009.0,2,2,0
BR,TZ,2017.0,1,1,0
AT,IN,1997.0,3,1,2
SI,BR,2008.0,1,1,0
AR,SE,2007.0,7,5,2
PK,NL,2000.0,1,1,0
GR,SG,2014.0,3,2,1
IT,RS,2018.0,6,10,-4
LU,DE,2002.0,2,7,-5
PL,PK,2013.0,7,5,2
CU,JP,2017.0,3,1,2
IN,RU,2005.0,5,6,-1
BG,BR,2021.0,3,2,1
PA,PE,2018.0,2,5,-3
IR,KW,2019.0,5,4,1
JP,AR,2021.0,3,3,0
DE,CM,1999.0,2,1,1
SG,MY,1997.0,1,7,-6
US,HT,2021.0,3,2,1
CR,AT,2017.0,1,3,-2
AU,SA,2000.0,2,4,-2
JP,ZA,2006.0,3,2,1
TR,PT,2012.0,3,1,2
LK,SE,2013.0,4,4,0
LT,RU,2018.0,7,8,-1
BA,SI,2020.0,3,4,-1
LT,CA,2009.0,1,2,-1
IR,ZA,2015.0,5,5,0
NZ,IT,2008.0,7,6,1
ZA,FI,2013.0,2,7,-5
MX,nan,2006.0,14,11,3
BD,TH,2019.0,3,4,-1
NL,UG,2017.0,4,2,2
HU,NL,2020.0,14,10,4
PT,DK,2008.0,4,1,3
PL,MA,2015.0,1,1,0
BE,SE,2023.0,3,2,1
GN,CA,2022.0,3,1,2
IR,KW,2017.0,2,3,-1
IS,DK,2012.0,5,4,1
US,CY,1998.0,4,2,2
MU,IN,2018.0,5,1,4
AT,MX,2002.0,1,2,-1
CN,KE,2011.0,8,7,1
ES,RO,2006.0,4,8,-4
IS,US,2022.0,10,8,2
LB,TN,2018.0,2,3,-1
CL,AT,2021.0,4,1,3
US,QA,2002.0,8,7,1
CO,CH,2015.0,9,8,1
HN,ES,1998.0,1,2,-1
RO,NO,2012.0,1,2,-1
CD,ZM,2018.0,1,1,0
CO,SE,2021.0,9,4,5
NP,EG,2014.0,3,1,2
RS,AT,2021.0,5,4,1
SI,IR,2014.0,1,1,0
PG,AU,2013.0,4,4,0
PG,GB,2019.0,2,1,1
NO,RS,2019.0,2,3,-1
ES,AE,2016.0,8,1,7
US,DZ,2010.0,12,11,1
SE,NZ,1999.0,3,2,1
CH,IL,1998.0,3,9,-6
nan,RU,2001.0,6,11,-5
FI,SA,2016.0,2,1,1
IS,NO,2008.0,5,6,-1
GB,CU,2004.0,1,3,-2
VE,CA,2014.0,6,2,4
IT,NE,2021.0,2,1,1
BJ,CD,2020.0,1,1,0
CH,IL,1997.0,3,5,-2
CA,CY,2008.0,2,1,1
IS,TR,2019.0,2,3,-1
GR,KW,2011.0,2,3,-1
PK,HU,2016.0,7,1,6
KR,MM,2016.0,2,1,1
MY,JP,2003.0,7,13,-6
PH,CH,2010.0,3,5,-2
TH,CA,2022.0,8,6,2
ML,FR,2015.0,8,8,0
SD,MY,2007.0,2,1,1
US,YE,2012.0,2,2,0
CL,ZA,2005.0,3,1,2
MX,NZ,2020.0,2,3,-1
MX,GR,2018.0,3,4,-1
HU,AT,1999.0,6,6,0
FR,TG,2013.0,3,4,-1
CH,UY,2022.0,1,3,-2
GB,UG,2009.0,9,7,2
DE,XK,2020.0,1,1,0
PH,DE,2006.0,4,6,-2
BG,FR,2019.0,7,5,2
IN,HR,2006.0,1,1,0
JP,PE,2010.0,2,1,1
RS,BA,2007.0,3,1,2
CM,NG,2008.0,1,2,-1
ZW,NL,2022.0,1,1,0
CN,BW,2015.0,1,2,-1
LU,IT,2019.0,8,15,-7
PE,CA,2019.0,6,9,-3
CO,CR,2003.0,6,4,2
AR,IL,2004.0,1,4,-3
CH,IN,1998.0,6,4,2
AE,SG,2013.0,2,5,-3
KZ,JP,2015.0,5,6,-1
SV,MX,2008.0,2,3,-1
AT,FI,2003.0,1,7,-6
NO,IS,2013.0,2,11,-9
FR,HR,2013.0,3,3,0
VN,nan,2002.0,2,3,-1
IT,NZ,1999.0,1,1,0
NP,SG,2020.0,1,4,-3
PH,nan,2011.0,2,1,1
AR,JP,2003.0,3,4,-1
LU,GB,2005.0,3,8,-5
KR,ZA,2018.0,2,8,-6
TW,VN,2012.0,5,5,0
SD,TR,2020.0,3,3,0
LT,US,2005.0,7,19,-12
BO,US,2022.0,1,7,-6
PS,KR,2020.0,1,1,0
SD,ID,2012.0,1,1,0
ES,MY,2017.0,2,3,-1
MX,AU,2012.0,10,11,-1
DE,PA,2008.0,5,4,1
BE,NZ,2008.0,2,5,-3
MA,GB,2017.0,5,13,-8
AU,IQ,2014.0,2,4,-2
LI,DE,2008.0,2,3,-1
KR,ES,2014.0,7,8,-1
LB,CH,2013.0,3,5,-2
PK,PS,2018.0,3,3,0
IE,RS,2009.0,3,1,2
PS,DE,2008.0,2,4,-2
HR,CZ,2009.0,3,9,-6
IE,DK,2013.0,5,7,-2
CH,TN,2006.0,4,6,-2
XK,TR,2014.0,1,2,-1
nan,RO,2013.0,1,2,-1
IT,EG,2022.0,2,8,-6
IS,ES,2008.0,2,3,-1
KR,GR,2015.0,2,2,0
CA,CD,2006.0,1,1,0
RU,TN,2013.0,3,2,1
LV,US,2008.0,3,6,-3
IL,LB,2012.0,1,1,0
UY,GB,2007.0,1,2,-1
BG,IL,2005.0,1,2,-1
ZA,LS,2009.0,2,3,-1
PT,JP,2020.0,2,7,-5
EE,FR,2010.0,4,6,-2
DE,PS,2010.0,5,1,4
PT,CR,2005.0,1,1,0
IN,CY,2021.0,2,5,-3
GR,ES,2001.0,5,6,-1
NZ,FR,1999.0,5,7,-2
GP,FR,2002.0,6,3,3
SA,IE,1997.0,1,1,0
KE,NG,2000.0,1,1,0
BE,IS,2009.0,1,2,-1
DE,TN,2015.0,3,3,0
ES,SG,2012.0,3,5,-2
GA,BE,2012.0,1,1,0
AR,NL,2001.0,3,3,0
CM,GB,2016.0,5,5,0
GB,PS,2016.0,3,3,0
PT,CU,2018.0,4,6,-2
MX,EC,2005.0,3,5,-2
ID,CM,2019.0,3,4,-1
HK,PL,2020.0,4,2,2
ZA,CL,2021.0,2,3,-1
CG,KE,2006.0,1,1,0
TT,IN,2002.0,1,1,0
AU,PL,2021.0,9,18,-9
MD,RU,2022.0,4,2,2
KR,PL,2018.0,6,8,-2
HR,SE,2006.0,1,3,-2
ES,PS,2004.0,3,4,-1
CL,IL,2021.0,2,2,0
ZA,SK,2007.0,1,1,0
AE,EG,1998.0,4,3,1
NL,HR,2018.0,6,5,1
FI,KR,2020.0,4,9,-5
LK,CA,2001.0,2,2,0
BG,FR,2017.0,6,9,-3
LU,GR,2020.0,1,6,-5
SK,IT,2010.0,1,7,-6
NL,UG,2010.0,1,2,-1
CZ,PH,2019.0,1,4,-3
AE,EG,1997.0,1,3,-2
PL,DK,2012.0,8,11,-3
DE,LI,2003.0,2,3,-1
US,GT,2022.0,4,6,-2
BD,TH,2017.0,6,6,0
CM,IN,2014.0,1,5,-4
IL,BR,1999.0,1,2,-1
SE,EE,2002.0,10,7,3
RU,KZ,2023.0,2,1,1
RU,NG,2017.0,2,3,-1
BH,KW,2020.0,3,2,1
US,PS,2007.0,6,3,3
PH,CH,2017.0,3,3,0
KW,AU,1998.0,2,1,1
QA,NL,2012.0,1,3,-2
DE,NE,2016.0,1,1,0
CZ,TW,2010.0,1,3,-2
BH,EG,2008.0,3,2,1
SA,SE,2000.0,4,1,3
ES,MA,2006.0,3,7,-4
MX,RS,2019.0,4,4,0
NG,IQ,2016.0,3,3,0
UZ,ID,2014.0,1,1,0
PK,FR,2006.0,3,4,-1
JP,LU,2013.0,1,3,-2
MD,IT,2018.0,1,2,-1
PT,AT,2018.0,5,8,-3
AT,BA,2018.0,2,1,1
MX,ID,2006.0,2,1,1
CO,IR,2020.0,2,6,-4
ZW,TZ,2020.0,1,3,-2
MX,UY,2006.0,4,7,-3
MY,HU,2019.0,1,1,0
IL,EG,2022.0,3,3,0
BD,nan,2021.0,1,4,-3
CL,nan,2022.0,1,2,-1
RS,IT,2013.0,3,9,-6
CZ,TW,2019.0,1,6,-5
IR,SY,2016.0,1,1,0
CN,LU,2005.0,1,3,-2
ZA,TZ,2017.0,8,5,3
US,BO,2019.0,8,9,-1
UA,LT,2022.0,4,2,2
FR,NE,2001.0,3,4,-1
CN,AR,2022.0,1,1,0
BG,FR,2010.0,6,8,-2
SE,MX,2006.0,2,3,-1
CU,nan,2021.0,2,5,-3
AU,HU,2007.0,9,9,0
IR,KZ,2020.0,2,2,0
MZ,BR,2021.0,11,25,-14
TR,PH,1999.0,1,2,-1
DE,OM,2019.0,2,3,-1
PH,KR,1998.0,1,1,0
CM,DE,2015.0,2,4,-2
DK,VN,2021.0,5,2,3
NZ,FI,1998.0,1,1,0
ID,AM,2021.0,5,2,3
DE,AM,2007.0,6,3,3
ZA,TZ,2010.0,2,4,-2
KZ,UZ,2007.0,3,2,1
UA,NL,2020.0,5,3,2
BE,LT,2016.0,1,3,-2
BO,SE,2019.0,1,2,-1
IS,CN,2015.0,1,2,-1
IN,CO,2015.0,5,5,0
NP,NZ,2000.0,4,1,3
RU,QA,2015.0,1,1,0
TR,nan,2022.0,12,12,0
SI,ES,2002.0,2,6,-4
EG,AZ,2014.0,2,2,0
SS,US,2003.0,1,2,-1
CL,TW,2020.0,1,1,0
MN,RU,2014.0,7,3,4
UA,GR,1999.0,1,1,0
GH,IN,2010.0,1,3,-2
ID,PS,2018.0,2,2,0
DK,PL,2005.0,3,4,-1
ZA,PG,2014.0,1,1,0
GM,GB,2015.0,5,17,-12
BG,SE,2017.0,4,1,3
AR,PT,2006.0,5,7,-2
SE,OM,2012.0,2,1,1
ES,SN,2016.0,1,1,0
GB,MA,2004.0,2,4,-2
GR,VN,2009.0,3,10,-7
BD,DE,1998.0,1,1,0
TR,TW,2015.0,5,4,1
SG,NZ,2005.0,5,5,0
FR,EC,2013.0,2,1,1
HN,FR,2017.0,1,1,0
SG,MY,1998.0,3,6,-3
PA,FR,2016.0,3,4,-1
GB,SN,2015.0,4,2,2
IR,CZ,2011.0,1,4,-3
PT,CV,2017.0,1,4,-3
NG,nan,2004.0,1,1,0
FR,JO,2012.0,3,4,-1
ET,CA,2022.0,2,4,-2
BT,NP,2020.0,1,1,0
HK,CA,2022.0,2,5,-3
ZA,GH,2002.0,1,2,-1
BY,DE,2021.0,2,3,-1
GR,CZ,2012.0,3,3,0
IS,NL,2008.0,1,2,-1
SG,AT,2009.0,2,1,1
SA,PT,2021.0,2,2,0
BH,QA,2019.0,2,1,1
CH,PE,2007.0,1,1,0
SI,CA,1997.0,1,1,0
CN,ZW,2020.0,1,1,0
RW,RS,2011.0,2,1,1
PK,LK,2018.0,2,1,1
IE,nan,2021.0,4,4,0
US,SY,2002.0,1,2,-1
NL,MA,2008.0,1,1,0
BJ,US,2016.0,4,2,2
AE,PL,2012.0,1,1,0
BD,CZ,2006.0,1,1,0
KE,ZM,2018.0,1,2,-1
US,HN,2012.0,2,3,-1
BN,GB,2011.0,2,8,-6
MX,HR,2005.0,2,2,0
ES,RS,2022.0,2,3,-1
BG,IL,2002.0,2,1,1
GB,IS,2000.0,3,3,0
BG,SE,2019.0,2,5,-3
DK,PT,2006.0,1,1,0
UY,SE,2014.0,3,1,2
PL,LU,2018.0,4,3,1
VE,JP,2011.0,3,1,2
CZ,EE,2014.0,2,1,1
NZ,MY,2000.0,1,1,0
BO,SE,2010.0,2,2,0
JP,NP,2001.0,3,3,0
VE,FR,2020.0,3,3,0
UA,DK,2001.0,1,1,0
BR,PE,1998.0,2,3,-1
JP,KH,2000.0,3,1,2
EE,CZ,2014.0,1,2,-1
NL,SK,2003.0,4,13,-9
SI,SK,2021.0,3,2,1
RS,PL,2003.0,1,4,-3
FR,CR,2007.0,3,2,1
KR,AT,2008.0,5,4,1
CR,SE,1999.0,1,2,-1
SE,RW,2016.0,2,1,1
BJ,NC,2018.0,1,1,0
KP,KR,2016.0,1,5,-4
nan,CO,1999.0,1,1,0
JP,RS,2003.0,3,9,-6
NP,PK,2013.0,1,5,-4
ID,CM,2017.0,2,3,-1
FI,NP,2016.0,1,1,0
IQ,AU,2009.0,3,2,1
GE,AZ,2004.0,1,1,0
CN,CI,2016.0,1,1,0
NL,SD,2019.0,1,2,-1
UA,RO,2012.0,1,1,0
JM,GB,2015.0,5,6,-1
OM,BH,2022.0,2,1,1
MD,CH,2011.0,2,2,0
MW,JP,2019.0,1,3,-2
US,CY,1997.0,1,1,0
CA,BF,2021.0,1,3,-2
FI,SI,2016.0,1,2,-1
GB,JM,2018.0,2,7,-5
LB,AU,2021.0,1,3,-2
KR,CO,2016.0,4,3,1
IL,CR,2021.0,2,2,0
BJ,CN,2018.0,1,2,-1
FI,AU,1997.0,2,1,1
FI,DE,2023.0,5,3,2
IN,SG,2019.0,156,160,-4
US,JP,2001.0,1615,1809,-194
CN,JP,2011.0,428,646,-218
UA,FR,2016.0,18,13,5
BR,PT,2006.0,452,365,87
EG,SA,2014.0,298,287,11
DE,CN,2021.0,378,334,44
JP,CN,2010.0,603,438,165
GB,CO,2012.0,23,27,-4
GB,JP,2006.0,255,253,2
JP,CH,2012.0,107,71,36
BE,IT,2007.0,62,68,-6
ZA,CH,2009.0,18,6,12
IE,US,2001.0,163,205,-42
RU,BE,2012.0,19,10,9
PK,CA,2016.0,33,49,-16
AU,NL,2007.0,62,56,6
GR,AU,1997.0,3,1,2
CN,UZ,2018.0,12,9,3
IT,AR,2019.0,132,123,9
UA,ES,2012.0,4,5,-1
JP,DE,2007.0,190,162,28
GB,DK,2019.0,166,152,14
DE,CA,2011.0,275,275,0
CH,JP,2008.0,61,83,-22
IT,AR,2010.0,86,62,24
PK,US,2018.0,384,362,22
AT,RU,2017.0,19,18,1
SE,RU,2017.0,31,17,14
DE,BE,2013.0,135,112,23
BD,CN,2007.0,26,23,3
CN,HK,2004.0,14,12,2
AU,VN,2020.0,82,58,24
GB,TH,2019.0,73,54,19
GB,RS,2017.0,28,25,3
RU,BR,2017.0,22,19,3
RU,ZW,2021.0,47,9,38
US,GR,2020.0,138,166,-28
NZ,TW,2020.0,9,5,4
SE,RU,2019.0,45,41,4
SA,EG,2021.0,348,413,-65
IL,AR,1999.0,3,5,-2
AR,CA,2016.0,30,33,-3
ES,EC,2008.0,20,13,7
GB,TH,2017.0,71,40,31
BD,ES,2021.0,14,12,2
LV,CZ,2018.0,2,2,0
nan,IT,2022.0,23,40,-17
IN,HU,2015.0,14,5,9
AE,QA,2020.0,6,9,-3
AZ,RU,2017.0,24,20,4
SA,JO,2017.0,39,42,-3
OM,CA,2011.0,4,9,-5
CZ,SK,2000.0,13,22,-9
LK,SG,2021.0,2,1,1
QA,PK,2022.0,14,18,-4
GR,GB,2001.0,59,90,-31
IN,ET,2008.0,6,2,4
SG,DE,2016.0,36,38,-2
AU,NO,2018.0,21,22,-1
NO,AT,2019.0,13,16,-3
BR,ST,2004.0,22,12,10
GB,NO,2004.0,35,35,0
UA,DE,2007.0,37,21,16
NL,JP,2003.0,36,25,11
IQ,BA,2018.0,6,2,4
EE,IT,2021.0,5,5,0
RS,BR,2018.0,2,1,1
UA,RU,2005.0,86,99,-13
US,NG,2022.0,50,121,-71
IT,IS,2020.0,6,1,5
US,PK,2004.0,65,74,-9
BE,DK,2002.0,12,8,4
US,CM,2020.0,15,12,3
JP,BD,2002.0,19,17,2
KR,TH,2014.0,9,18,-9
FI,AT,2021.0,15,12,3
GH,IN,2019.0,11,11,0
JO,SY,2018.0,6,2,4
KR,FR,2012.0,30,31,-1
BG,CO,2018.0,1,1,0
PL,CN,2022.0,15,9,6
IL,BE,2017.0,14,11,3
HR,RU,2018.0,10,9,1
FR,LB,2008.0,29,28,1
DE,PS,2019.0,8,2,6
GR,DE,2001.0,19,26,-7
IR,KW,2010.0,1,1,0
IR,EG,2021.0,13,8,5
LT,US,2002.0,9,6,3
FR,EG,2007.0,24,16,8
MX,RS,2010.0,65,28,37
CU,IT,2005.0,5,2,3
LU,HU,2020.0,2,1,1
NZ,SE,2009.0,7,5,2
US,LB,1999.0,21,9,12
TN,BJ,2018.0,1,1,0
BA,RS,2015.0,35,39,-4
KW,CA,2012.0,6,11,-5
AR,CU,2012.0,12,15,-3
KE,CA,2020.0,13,7,6
nan,ID,2009.0,1,11,-10
nan,MY,2009.0,21,9,12
JO,GB,2021.0,13,29,-16
DE,HR,2016.0,19,28,-9
PT,DE,2013.0,26,43,-17
AT,BE,2011.0,13,11,2
FR,IS,2011.0,3,4,-1
NG,PK,2015.0,8,12,-4
RW,BE,2022.0,2,1,1
NL,JO,2007.0,2,5,-3
HN,MX,2009.0,15,12,3
RU,DK,2012.0,8,12,-4
GB,BY,2015.0,3,1,2
NC,PF,2009.0,1,1,0
CU,JP,2010.0,2,1,1
SE,HU,2021.0,6,12,-6
CL,CR,2006.0,6,5,1
GR,CA,2005.0,14,15,-1
TW,NL,2010.0,8,4,4
IR,RO,2007.0,1,1,0
JO,OM,2016.0,3,3,0
CN,AL,2010.0,2,1,1
AU,GR,2010.0,6,4,2
UA,CH,2008.0,2,4,-2
KE,CN,2000.0,2,1,1
QA,JO,2020.0,10,17,-7
GB,PK,1997.0,17,11,6
PH,TH,2019.0,5,2,3
ID,ES,2010.0,12,10,2
US,QA,2005.0,13,12,1
HU,SI,2020.0,2,1,1
PK,MA,2006.0,7,1,6
IN,KW,2009.0,10,8,2
SK,IT,2017.0,4,5,-1
NG,CI,2020.0,1,3,-2
SI,UA,2021.0,1,1,0
AT,SK,2022.0,5,7,-2
IN,MX,2006.0,9,6,3
ES,JO,2021.0,4,2,2
FR,GA,2008.0,7,3,4
JM,TT,2001.0,5,7,-2
BH,KE,2003.0,5,1,4
TN,nan,2021.0,2,5,-3
DO,ES,2012.0,7,3,4
CW,BE,2011.0,3,3,0
NP,NL,2018.0,3,8,-5
HU,SE,2001.0,11,8,3
SK,IT,2019.0,3,7,-4
AE,GB,2011.0,20,33,-13
VE,CU,2003.0,4,5,-1
EG,NL,2015.0,4,8,-4
AU,AT,2000.0,10,8,2
ID,PT,2014.0,2,1,1
nan,IR,2020.0,5,5,0
UA,AM,2008.0,1,1,0
MX,NI,2011.0,2,2,0
GR,TR,2006.0,2,4,-2
TN,PK,2007.0,6,1,5
SK,NO,1998.0,1,1,0
PL,JP,1997.0,6,9,-3
LU,PT,2006.0,1,2,-1
BO,SE,2017.0,1,2,-1
RU,LV,2002.0,11,7,4
YE,SA,2012.0,1,2,-1
NL,LK,2021.0,2,3,-1
AR,DK,2021.0,2,4,-2
TH,CH,2004.0,1,2,-1
CM,US,2009.0,8,5,3
NO,HU,2008.0,2,3,-1
HU,RU,2023.0,5,2,3
US,BI,2015.0,2,4,-2
BR,CZ,2021.0,13,8,5
ET,NO,2020.0,3,10,-7
PL,nan,2022.0,2,6,-4
JP,KN,2018.0,2,1,1
SK,KR,2003.0,2,1,1
GB,SK,2021.0,8,7,1
MK,SI,2015.0,3,3,0
NC,AU,2018.0,2,2,0
KR,BE,1998.0,2,2,0
NP,KR,2020.0,7,23,-16
JO,IR,2021.0,1,1,0
HT,US,2017.0,1,4,-3
RU,IE,2004.0,3,1,2
NO,BJ,2007.0,1,1,0
KE,CO,2019.0,5,4,1
HK,NO,2013.0,1,1,0
BG,ES,1999.0,2,2,0
MC,US,2021.0,2,2,0
SE,UA,2006.0,2,5,-3
MA,SN,2017.0,1,1,0
US,IQ,2003.0,2,1,1
CZ,AZ,2019.0,1,1,0
US,BN,2022.0,2,2,0
AU,nan,2005.0,16,13,3
CH,AR,2020.0,23,22,1
FR,CG,2013.0,16,20,-4
IT,CL,2006.0,22,18,4
TW,NL,2017.0,5,4,1
BE,IL,2015.0,4,6,-2
BR,AU,2000.0,9,16,-7
SE,RO,2016.0,5,8,-3
AT,AU,1999.0,7,6,1
ID,AU,2005.0,3,16,-13
LK,AU,2011.0,15,17,-2
UG,CI,2012.0,1,1,0
CN,CA,2002.0,211,238,-27
ID,ES,2019.0,17,25,-8
US,JO,2014.0,74,44,30
PL,AT,2021.0,13,15,-2
JP,PE,2019.0,3,3,0
ZA,,2019.0,2284,0,2284
NO,,2023.0,8986,0,8986
CU,,2024.0,950,0,950
,CN,2009.0,47288,0,47288
US,,2009.0,37065,0,37065
FR,,2023.0,59967,0,59967
,NL,1994.0,17586,0,17586
DE,,2007.0,7104,0,7104
GB,,1998.0,3600,0,3600
IT,,2014.0,6028,0,6028
,ES,2009.0,13809,0,13809
,CU,2005.0,422,0,422
,RU,1996.0,8272,0,8272
SK,,2021.0,1256,0,1256
ES,,2014.0,6800,0,6800
,BE,2007.0,3059,0,3059
IR,,2022.0,19792,0,19792
RO,,2015.0,758,0,758
,TR,1999.0,3160,0,3160
LV,,2024.0,1609,0,1609
TH,,2021.0,3035,0,3035
NZ,,2019.0,1255,0,1255
VN,,2022.0,1100,0,1100
EE,,2016.0,292,0,292
LI,,2018.0,12,0,12
CH,,2005.0,1145,0,1145
,AR,2013.0,2459,0,2459
,NO,2002.0,1407,0,1407
,RU,2004.0,8355,0,8355
,NO,2005.0,1675,0,1675
CG,IN,2006.0,1,0,1
KZ,,2024.0,3021,0,3021
,HR,1996.0,599,0,599
,KR,2016.0,4543,0,4543
,UA,1995.0,1525,0,1525
NZ,,2017.0,933,0,933
,PR,1995.0,40,0,40
,CZ,2002.0,1715,0,1715
,DZ,2013.0,1396,0,1396
PK,,2022.0,3787,0,3787
ZA,,2017.0,1586,0,1586
PH,,2020.0,553,0,553
PT,BO,2020.0,2,0,2
JM,,2024.0,184,0,184
,NG,2001.0,676,0,676
FI,,2013.0,1138,0,1138
MZ,,2018.0,52,0,52
CH,,2002.0,1071,0,1071
NZ,,2010.0,458,0,458
,CU,2002.0,330,0,330
,XK,2016.0,90,0,90
BR,IE,1998.0,1,0,1
,LB,2004.0,228,0,228
,BA,2010.0,270,0,270
ZA,,2010.0,616,0,616
RS,,2002.0,37,0,37
TW,,2000.0,540,0,540
,CZ,2005.0,1930,0,1930
,HR,2004.0,815,0,815
PH,PL,2000.0,40,0,40
CO,,2008.0,193,0,193
,SA,2014.0,2301,0,2301
,CW,1999.0,12,0,12
,UG,2003.0,142,0,142
MY,,2013.0,542,0,542
CZ,,2008.0,533,0,533
CF,,2023.0,34,0,34
,RO,2018.0,1535,0,1535
,SK,2003.0,454,0,454
RS,,2005.0,82,0,82
,LB,1996.0,100,0,100
MM,,2024.0,287,0,287
MK,,2022.0,370,0,370
,YE,2009.0,41,0,41
,SI,2014.0,578,0,578
,PS,2005.0,43,0,43
UY,,2016.0,124,0,124
,SG,2018.0,1280,0,1280
,KE,1999.0,202,0,202
AG,,2019.0,12,0,12
PT,,2004.0,144,0,144
UA,,2005.0,454,0,454
UA,,2002.0,283,0,283
,EE,2014.0,320,0,320
,KZ,1997.0,56,0,56
,BA,2017.0,183,0,183
CF,IT,2021.0,1,0,1
,LT,1998.0,186,0,186
CZ,NP,2004.0,1,0,1
VG,,2010.0,26,0,26
EG,UA,2018.0,1,0,1
,SD,2001.0,35,0,35
PL,NA,2012.0,1,0,1
,HN,2013.0,70,0,70
MX,,2000.0,227,0,227
,OM,2011.0,198,0,198
,GM,2015.0,20,0,20
BJ,BF,2012.0,2,0,2
SY,,2001.0,7,0,7
NZ,NA,2016.0,1,0,1
,SV,2007.0,25,0,25
ZW,BW,2011.0,3,0,3
,CM,1997.0,84,0,84
SA,QA,2000.0,1,0,1
GH,SZ,2019.0,1,0,1
CM,GH,2015.0,3,0,3
CY,UA,2019.0,1,0,1
,CM,1998.0,82,0,82
VG,,2019.0,17,0,17
,FK,2002.0,2,0,2
NL,PA,2023.0,1,0,1
KE,AR,2020.0,2,0,2
TN,,2001.0,11,0,11
,ME,2017.0,26,0,26
MZ,UZ,2020.0,1,0,1
TZ,RU,2021.0,2,0,2
,AO,2017.0,27,0,27
BY,MA,2009.0,1,0,1
,AL,2018.0,57,0,57
,ME,2019.0,20,0,20
,AO,2019.0,13,0,13
AR,QA,2017.0,1,0,1
AE,,1999.0,21,0,21
SI,CL,2017.0,1,0,1
AU,,2012.0,3308,0,3308
EG,,1998.0,155,0,155
BG,,2009.0,190,0,190
KW,,2004.0,62,0,62
GB,MV,2015.0,2,0,2
,KZ,1998.0,65,0,65
JP,AF,2011.0,1,0,1
,LT,1997.0,180,0,180
,MC,2014.0,15,0,15
CA,LT,1997.0,2,0,2
NP,,2005.0,11,0,11
CR,CN,2008.0,3,0,3
MN,,1998.0,6,0,6
,ZM,2006.0,47,0,47
VG,,2017.0,38,0,38
EG,GE,2018.0,1,0,1
TR,LT,2013.0,2,0,2
DK,BA,2011.0,1,0,1
SO,SE,2019.0,1,0,1
CW,,2018.0,13,0,13
PT,SN,2011.0,1,0,1
BH,SG,2015.0,1,0,1
AF,IQ,2019.0,2,0,2
TR,ET,2011.0,1,0,1
CL,,2000.0,101,0,101
IR,MX,2018.0,3,0,3
SA,MD,2012.0,2,0,2
,ME,2010.0,41,0,41
SE,MA,1999.0,1,0,1
AZ,GB,2012.0,2,0,2
,MN,2002.0,23,0,23
ID,GH,2012.0,4,0,4
PG,,2020.0,34,0,34
BM,CA,2015.0,1,0,1
ID,DO,2021.0,1,0,1
TW,NP,2014.0,2,0,2
SA,SN,2022.0,1,0,1
ME,AU,2017.0,1,0,1
SD,CO,2017.0,1,0,1
LK,CN,1997.0,2,0,2
SA,CN,2002.0,5,0,5
PT,CV,2010.0,2,0,2
SL,CH,2016.0,3,0,3
AL,,2011.0,10,0,10
nan,RS,2021.0,2,0,2
SI,DK,2007.0,2,0,2
EC,DE,2012.0,5,0,5
MA,HU,2009.0,3,0,3
BD,KE,2018.0,1,0,1
IE,KZ,2017.0,1,0,1
DE,HK,2018.0,2,0,2
NL,UY,2019.0,5,0,5
BR,JO,2002.0,1,0,1
KH,NL,2011.0,3,0,3
DE,LY,2007.0,1,0,1
MN,MG,2018.0,1,0,1
AU,TN,2012.0,1,0,1
YE,SY,2015.0,1,0,1
ZA,SG,2022.0,1,0,1
,AO,2010.0,12,0,12
SY,NL,2014.0,2,0,2
IE,PH,2017.0,2,0,2
BO,UY,2007.0,2,0,2
BD,MY,1997.0,1,0,1
NG,OM,2010.0,1,0,1
DK,NC,2016.0,1,0,1
ER,,2021.0,10,0,10
GT,VE,2004.0,2,0,2
GT,,2007.0,6,0,6
EG,MX,2004.0,1,0,1
ET,,1998.0,3,0,3
UZ,BY,2005.0,1,0,1
SD,IT,2014.0,2,0,2
BE,GE,2018.0,2,0,2
,PS,2002.0,15,0,15
CZ,PH,2017.0,3,0,3
CN,VE,2020.0,2,0,2
EC,MX,1998.0,1,0,1
BW,ZW,2001.0,1,0,1
,SO,2008.0,1,0,1
CN,BG,1999.0,2,0,2
RS,AG,2020.0,3,0,3
GB,NA,2011.0,2,0,2
CH,VE,2005.0,1,0,1
GT,SK,2012.0,1,0,1
PE,TZ,2015.0,1,0,1
BG,EC,2005.0,1,0,1
BG,GR,2014.0,3,0,3
AG,,2017.0,4,0,4
MD,,1999.0,20,0,20
MX,MA,2005.0,1,0,1
TN,BR,2019.0,1,0,1
ML,NL,2016.0,1,0,1
IE,AE,2006.0,4,0,4
JO,,1999.0,19,0,19
DE,GT,2020.0,1,0,1
YE,,2025.0,24,0,24
TR,HR,2013.0,1,0,1
,GY,1998.0,2,0,2
UZ,KR,2010.0,2,0,2
CU,BO,2000.0,1,0,1
HN,CU,2019.0,2,0,2
GM,FR,2022.0,1,0,1
,GY,1997.0,4,0,4
MQ,ES,2016.0,1,0,1
VN,nan,2005.0,2,0,2
TZ,FR,2016.0,1,0,1
RE,KR,2010.0,1,0,1
SY,PK,2005.0,1,0,1
JP,PG,2020.0,2,0,2
JP,PA,2007.0,3,0,3
SY,GR,2009.0,1,0,1
KZ,HU,2021.0,4,0,4
UA,ZA,2011.0,1,0,1
PT,CV,2019.0,1,0,1
GB,GL,2020.0,2,0,2
,BA,2019.0,58,0,58
PL,IQ,2005.0,1,0,1
AR,YE,2016.0,4,0,4
LV,IT,2021.0,2,0,2
BH,,2011.0,11,0,11
RO,CY,2003.0,1,0,1
RO,LK,2009.0,1,0,1
EE,JP,2002.0,1,0,1
UZ,KR,2017.0,1,0,1
KE,IN,2002.0,1,0,1
,CV,1997.0,1,0,1
CZ,TN,2018.0,1,0,1
AR,SG,2012.0,1,0,1
PW,US,2017.0,2,0,2
US,AZ,2002.0,3,0,3
GN,,2005.0,1,0,1
AU,UZ,2002.0,1,0,1
CY,UA,2017.0,1,0,1
PK,MK,2021.0,1,0,1
NZ,ID,1997.0,1,0,1
SN,GP,2015.0,1,0,1
NI,NL,2009.0,1,0,1
DZ,TR,2016.0,3,0,3
OM,EG,2001.0,2,0,2
NO,FJ,2020.0,1,0,1
PT,RO,2007.0,3,0,3
RW,US,2003.0,1,0,1
NG,BE,2008.0,1,0,1
CM,nan,2013.0,2,0,2
ZW,AU,2008.0,2,0,2
GR,BG,2012.0,3,0,3
KZ,EG,2014.0,2,0,2
IL,AL,2020.0,1,0,1
EC,CO,2001.0,1,0,1
UZ,JP,2013.0,3,0,3
CY,JP,2017.0,2,0,2
LB,PK,2010.0,1,0,1
KR,ID,2006.0,1,0,1
CZ,PT,2005.0,4,0,4
JE,,2011.0,2,0,2
NL,AE,2000.0,1,0,1
GH,GR,2011.0,1,0,1
FR,VG,1999.0,1,0,1
SN,CI,2004.0,1,0,1
RO,MX,2022.0,1,0,1
KW,GR,1999.0,2,0,2
CZ,AZ,2010.0,1,0,1
SD,IN,2003.0,1,0,1
RE,BE,2012.0,1,0,1
CG,WS,2017.0,1,0,1
US,BA,2004.0,1,0,1
BO,BE,2022.0,1,0,1
MX,UA,2022.0,1,0,1
JO,BA,2019.0,1,0,1
ML,IN,2000.0,4,0,4
TR,KZ,1999.0,1,0,1
CA,BH,2000.0,2,0,2
HU,KR,2007.0,3,0,3
AE,VN,2018.0,1,0,1
MA,LU,2017.0,2,0,2
NG,IR,2015.0,4,0,4
HT,US,2010.0,1,0,1
IT,LY,2020.0,3,0,3
UY,HN,2020.0,1,0,1
CA,LU,2004.0,1,0,1
MK,AE,2015.0,1,0,1
CO,ST,2020.0,1,0,1
EC,GB,2004.0,1,0,1
PH,MX,2003.0,1,0,1
CU,SE,2011.0,1,0,1
NG,BR,2009.0,1,0,1
,MN,2005.0,34,0,34
NP,CH,2018.0,3,0,3
DE,VN,2006.0,5,0,5
BA,KZ,2013.0,1,0,1
OM,PS,2022.0,2,0,2
BA,QA,2009.0,1,0,1
LT,BG,2007.0,2,0,2
GH,RW,2021.0,1,0,1
GA,,2013.0,6,0,6
SS,GR,2010.0,1,0,1
HN,CL,2003.0,1,0,1
BR,CI,2020.0,1,0,1
,EC,2020.0,32,0,32
KR,PG,2017.0,2,0,2
CI,CA,1998.0,2,0,2
XK,AL,2021.0,1,0,1
PY,CL,2007.0,1,0,1
HN,FR,2019.0,1,0,1
PG,GB,2017.0,2,0,2
LT,RO,1999.0,4,0,4
MG,MA,2016.0,1,0,1
EC,DK,2001.0,1,0,1
AE,CY,2012.0,1,0,1
DK,AR,2002.0,2,0,2
KH,ID,2022.0,1,0,1
ST,US,2016.0,1,0,1
BS,BB,2019.0,1,0,1
nan,BG,2014.0,3,0,3
TN,BN,2020.0,1,0,1
CH,BF,2006.0,1,0,1
VG,CH,2014.0,2,0,2
DZ,NG,2019.0,2,0,2
HR,IL,2013.0,2,0,2
FR,CY,2021.0,4,0,4
BI,FR,2023.0,1,0,1
UY,PG,2022.0,1,0,1
DZ,GR,2010.0,1,0,1
NE,,2013.0,5,0,5
IN,GY,2012.0,1,0,1
PH,CZ,1998.0,1,0,1
TW,HU,2007.0,1,0,1
KZ,OM,2018.0,1,0,1
TN,PS,2019.0,2,0,2
,HT,2008.0,6,0,6
ML,TN,2016.0,1,0,1
LK,SY,2008.0,1,0,1
NZ,GH,2013.0,1,0,1
FR,SI,2001.0,2,0,2
NO,PS,2021.0,1,0,1
BJ,GH,2022.0,2,0,2
SN,NL,2018.0,1,0,1
NG,RW,2020.0,3,0,3
JM,GD,2018.0,3,0,3
LB,PL,2007.0,2,0,2
US,XK,2011.0,2,0,2
BR,MU,2014.0,1,0,1
MW,ID,2018.0,1,0,1
SN,BI,2019.0,1,0,1
VN,IR,2016.0,1,0,1
ES,LB,2015.0,1,0,1
BY,SI,2004.0,2,0,2
TN,NG,2003.0,5,0,5
NG,TN,2006.0,1,0,1
DE,CI,2012.0,1,0,1
MX,BG,2008.0,2,0,2
IM,,2017.0,3,0,3
US,MT,1998.0,1,0,1
DE,MG,2004.0,1,0,1
PL,KZ,2009.0,2,0,2
GB,RW,2008.0,2,0,2
EE,NO,2005.0,2,0,2
ZM,AU,2008.0,1,0,1
LB,nan,2022.0,1,0,1
SK,PT,2005.0,1,0,1
IN,TJ,2014.0,2,0,2
BG,VN,2008.0,1,0,1
,VU,1994.0,1,0,1
CO,NE,2014.0,1,0,1
TR,TG,2003.0,1,0,1
CA,RE,2003.0,1,0,1
IN,SK,2008.0,4,0,4
PL,LY,2008.0,1,0,1
IR,GH,2022.0,2,0,2
BH,AE,2005.0,1,0,1
QA,IR,2001.0,1,0,1
GM,CU,2017.0,1,0,1
nan,PS,2011.0,1,0,1
NC,FJ,2018.0,1,0,1
CU,IT,2002.0,3,0,3
CO,TW,2014.0,1,0,1
MU,NL,2015.0,1,0,1
MA,SY,2001.0,1,0,1
KY,,2021.0,5,0,5
CA,NP,1999.0,1,0,1
AE,LU,2016.0,2,0,2
KE,IS,2015.0,2,0,2
PE,GR,2017.0,1,0,1
EG,CO,2015.0,1,0,1
PE,CN,2018.0,1,0,1
GB,LS,2006.0,1,0,1
MY,BW,2019.0,1,0,1
BO,PH,2019.0,1,0,1
UY,GT,2018.0,1,0,1
GE,SE,2008.0,1,0,1
MX,ZA,2009.0,1,0,1
ZA,UA,2018.0,2,0,2
SN,TH,2001.0,1,0,1
IE,PG,2017.0,1,0,1
NL,BA,2018.0,1,0,1
,SZ,2000.0,5,0,5
MN,ET,2020.0,1,0,1
MA,RW,2019.0,1,0,1
CH,JO,2005.0,1,0,1
PK,MX,2001.0,1,0,1
FI,PH,2004.0,3,0,3
CI,JP,2012.0,3,0,3
DE,MM,2011.0,1,0,1
HK,AT,2021.0,1,0,1
BZ,,2021.0,4,0,4
BW,SL,2014.0,1,0,1
PL,CD,2013.0,1,0,1
HU,IL,1999.0,1,0,1
HU,GB,2023.0,3,0,3
DE,RW,2013.0,1,0,1
,LS,1995.0,3,0,3
ML,ZA,2022.0,1,0,1
CZ,EC,2014.0,1,0,1
TR,KR,2001.0,2,0,2
BF,AT,2011.0,1,0,1
YE,IQ,2004.0,1,0,1
LK,NO,2012.0,2,0,2
DE,BN,2006.0,1,0,1
PK,DJ,2021.0,1,0,1
BR,TH,1999.0,1,0,1
EE,CH,2001.0,1,0,1
IS,TR,2010.0,1,0,1
EG,SY,2009.0,2,0,2
TJ,KR,2015.0,1,0,1
GH,IR,2013.0,1,0,1
NP,,2002.0,9,0,9
ZW,CG,2001.0,1,0,1
GL,,2013.0,2,0,2
CZ,CU,2020.0,1,0,1
IT,RE,2004.0,1,0,1
BN,MY,2002.0,1,0,1
NZ,FI,1997.0,1,0,1
MY,MA,2007.0,1,0,1
RU,AO,2009.0,1,0,1
VE,PY,2021.0,1,0,1
HK,BR,2014.0,1,0,1
LB,QA,2011.0,3,0,3
CU,UY,2011.0,5,0,5
CG,CI,2016.0,1,0,1
ME,,2005.0,6,0,6
AT,MX,2005.0,2,0,2
SI,RU,1998.0,3,0,3
ZA,PE,2012.0,2,0,2
NP,LY,2008.0,1,0,1
GT,ZA,2017.0,1,0,1
CH,ZW,2017.0,1,0,1
IL,SK,2005.0,1,0,1
AG,CY,2021.0,1,0,1
KG,DE,2012.0,1,0,1
ID,TN,2022.0,1,0,1
AR,MT,2013.0,1,0,1
SY,MY,2014.0,1,0,1
BG,SE,2010.0,1,0,1
JO,NP,2015.0,1,0,1
TT,,2000.0,4,0,4
NL,NC,2017.0,1,0,1
DK,CY,2014.0,1,0,1
SI,SA,2013.0,1,0,1
IE,SG,2003.0,1,0,1
TT,ZA,2002.0,1,0,1
CH,CI,2009.0,1,0,1
GA,CH,2001.0,1,0,1
IN,MW,2018.0,1,0,1
NL,XK,2016.0,1,0,1
SG,TH,2006.0,1,0,1
AL,JP,2002.0,1,0,1
AO,TW,2009.0,1,0,1
ZA,BY,2009.0,1,0,1
GR,nan,2001.0,2,0,2
MX,EC,2002.0,2,0,2
IS,TW,2003.0,1,0,1
HK,,2004.0,1,0,1
AT,ME,2015.0,1,0,1
TW,SD,2020.0,1,0,1
UG,IL,2020.0,1,0,1
RO,SK,2003.0,3,0,3
SK,AR,2017.0,1,0,1
KR,BE,1997.0,1,0,1
AU,BB,2012.0,1,0,1
DO,CU,2001.0,1,0,1
SE,AE,2009.0,2,0,2
TW,KE,2021.0,2,0,2
BW,EG,2004.0,1,0,1
JP,AO,2014.0,1,0,1
JO,GR,2000.0,1,0,1
MY,HU,2017.0,1,0,1
CA,JE,2016.0,1,0,1
PA,BG,2018.0,1,0,1
GB,BF,2012.0,1,0,1
GH,ZW,2020.0,1,0,1
ZW,GH,2021.0,1,0,1
KR,LV,2010.0,1,0,1
BW,ML,2018.0,1,0,1
EG,IL,2003.0,1,0,1
BR,TZ,2010.0,1,0,1
MD,RE,2019.0,1,0,1
ML,CA,2021.0,1,0,1
JP,BH,2009.0,2,0,2
US,RW,2008.0,2,0,2
KE,SA,2007.0,1,0,1
TN,ET,2019.0,1,0,1
IL,LK,2018.0,1,0,1
TJ,,2013.0,9,0,9
TN,MA,2009.0,3,10,-7
CM,IT,2016.0,3,1,2
IT,IQ,2022.0,2,1,1
SR,NL,2012.0,1,2,-1
AR,FI,2002.0,1,2,-1
LB,NL,2020.0,2,1,1
US,AO,2005.0,1,1,0
CN,AL,2019.0,1,2,-1
TN,GB,2006.0,1,4,-3
LT,IN,2016.0,2,1,1
BG,PT,2006.0,2,1,1
HR,RO,2001.0,1,1,0
PL,EG,2000.0,1,1,0
CH,SN,2007.0,3,1,2
GF,MQ,2020.0,1,3,-2
UA,TR,2015.0,1,1,0
CO,ID,2022.0,1,2,-1
EE,CA,2023.0,1,1,0
SD,FR,2005.0,1,1,0
ZW,MX,2018.0,1,2,-1
CZ,IE,2014.0,3,3,0
UG,NZ,2021.0,1,5,-4
LK,FR,2001.0,1,2,-1
MY,CZ,2012.0,1,3,-2
CH,SI,2008.0,6,2,4
LK,ID,2022.0,1,1,0
YE,FI,2020.0,1,1,0
ES,EE,2022.0,2,1,1
CN,MN,2006.0,1,1,0
ES,ET,2022.0,1,1,0
ZA,PK,2015.0,3,2,1
UA,BR,2004.0,1,3,-2
KE,IN,2005.0,3,4,-1
IE,CL,2004.0,1,1,0
EG,PS,2005.0,1,2,-1
CU,CH,2002.0,1,1,0
UA,IN,2008.0,1,1,0
nan,CU,2009.0,2,1,1
TR,MK,2013.0,1,1,0
QA,BE,2016.0,1,3,-2
IT,ME,2020.0,1,2,-1
PY,PE,2014.0,1,1,0
MX,TN,2015.0,3,2,1
AU,SS,1999.0,1,1,0
DK,SK,2018.0,1,1,0
BR,PE,1997.0,2,3,-1
ZW,TR,2017.0,1,1,0
NI,MY,2018.0,1,5,-4
EG,DZ,2013.0,1,2,-1
UG,NG,2006.0,1,1,0
RW,CN,2023.0,1,1,0
BR,PK,2009.0,2,4,-2
QA,BR,2020.0,2,5,-3
DE,OM,2010.0,1,3,-2
AE,OM,2002.0,3,2,1
MA,PA,2012.0,1,1,0
IQ,BE,2019.0,1,1,0
GE,CN,2004.0,2,1,1
NG,SE,2003.0,1,4,-3
SE,MK,2013.0,1,3,-2
CH,VE,2002.0,1,1,0
GB,AM,2016.0,2,2,0
AE,AU,2023.0,1,2,-1
HN,CU,2017.0,1,3,-2
PT,UA,2013.0,2,2,0
RU,SI,2017.0,2,5,-3
AT,CO,2011.0,1,1,0
UA,BG,2004.0,1,4,-3
RU,NG,2019.0,1,3,-2
SE,TR,2000.0,1,5,-4
LV,GB,2012.0,1,3,-2
MA,NL,2012.0,1,1,0
NZ,TH,2006.0,1,2,-1
MY,AR,2003.0,2,3,-1
AU,LK,1999.0,2,1,1
CA,VN,2003.0,2,2,0
LU,AT,2020.0,2,4,-2
MN,GB,2017.0,1,2,-1
AU,NG,2007.0,1,2,-1
NL,MK,2014.0,1,1,0
BB,JM,2000.0,1,2,-1
CL,HN,2021.0,1,3,-2
PG,GB,2010.0,1,2,-1
CZ,TW,2017.0,1,3,-2
ES,MT,2020.0,1,1,0
DE,TW,2023.0,2,3,-1
DE,PT,2023.0,1,3,-2
CH,CY,2014.0,2,3,-1
GN,CI,2020.0,2,3,-1
MY,SE,2004.0,1,1,0
TR,TN,2020.0,1,3,-2
NL,PK,2000.0,1,1,0
NO,MY,2021.0,2,5,-3
HU,PS,2020.0,2,1,1
BD,ZM,2011.0,1,1,0
CN,TG,2022.0,1,2,-1
ET,TR,2001.0,1,1,0
MY,YE,2009.0,1,2,-1
UY,BE,2020.0,1,1,0
HN,CU,2010.0,1,1,0
CA,UY,2008.0,1,1,0
DO,CH,2000.0,1,1,0
SN,BF,2007.0,1,1,0
PL,PT,2004.0,2,1,1
JO,BH,2015.0,2,1,1
DK,GH,2010.0,1,1,0
CH,CG,2019.0,2,2,0
TZ,BW,2009.0,1,1,0
AF,IR,2013.0,2,2,0
AT,ZA,2004.0,1,3,-2
JP,UG,2013.0,1,1,0
AR,SA,2020.0,1,2,-1
NG,IE,2015.0,2,2,0
GB,CR,2004.0,1,2,-1
IE,GR,1997.0,1,1,0
QA,SY,2020.0,1,3,-2
KR,LV,2017.0,1,1,0
MX,SE,1998.0,1,2,-1
CR,ZA,2010.0,1,4,-3
HR,XK,2011.0,1,2,-1
TN,MT,2020.0,1,3,-2
RU,LU,2021.0,4,1,3
CZ,SG,2021.0,2,4,-2
GR,UA,1999.0,1,1,0
KR,TR,2005.0,1,10,-9
EC,AU,2013.0,1,1,0
RO,nan,2012.0,1,2,-1
MK,RU,2021.0,2,2,0
BR,PY,1999.0,1,6,-5
MY,EG,2000.0,2,1,1
GA,MA,2019.0,2,1,1
GE,IT,2011.0,1,1,0
AU,CM,2020.0,1,2,-1
AT,TW,2022.0,3,1,2
PS,CH,2021.0,1,1,0
NG,CZ,2020.0,2,6,-4
SK,BE,2009.0,1,2,-1
BR,UA,2007.0,1,1,0
BR,VG,2021.0,1,1,0
CA,RW,2010.0,1,1,0
MA,SN,2019.0,2,2,0
TR,EG,2012.0,1,2,-1
QA,FI,2004.0,1,1,0
IE,KZ,2019.0,2,1,1
SK,AT,2023.0,1,1,0
FI,RO,2000.0,1,2,-1
NO,NP,2022.0,1,4,-3
CH,LU,2003.0,2,1,1
SI,HU,1998.0,1,1,0
KW,ET,2016.0,1,1,0
ZA,GH,2005.0,1,1,0
AU,BT,2018.0,2,3,-1
BD,TH,2010.0,1,2,-1
GT,PH,2019.0,1,1,0
CO,NL,1998.0,1,1,0
GB,TT,1999.0,1,1,0
GR,AU,1998.0,1,2,-1
CN,KH,2017.0,1,1,0
IE,KE,2008.0,1,1,0
LT,LV,2013.0,1,3,-2
KE,CO,2010.0,2,4,-2
OM,UA,2014.0,1,1,0
IL,HR,2014.0,1,1,0
BE,BJ,2013.0,1,1,0
IQ,RO,2019.0,1,3,-2
MY,TN,2015.0,1,4,-3
BR,DO,2012.0,1,2,-1
ID,CN,2023.0,1,1,0
GH,AU,2023.0,1,2,-1
PH,TH,2017.0,3,1,2
AE,SE,2008.0,2,3,-1
CM,CA,2015.0,2,2,0
MN,GB,2019.0,3,3,0
BF,JP,2021.0,1,1,0
MX,FI,2014.0,2,1,1
CN,BT,2018.0,2,1,1
SG,CZ,2020.0,3,4,-1
RW,GB,2012.0,1,1,0
DK,SI,2014.0,1,1,0
MW,US,2003.0,2,6,-4
PT,SK,2009.0,2,1,1
CR,AT,2019.0,1,3,-2
IE,PT,2001.0,1,2,-1
SE,GH,2018.0,3,3,0
SG,IL,2007.0,1,2,-1
CR,nan,2012.0,1,4,-3
MM,US,2001.0,1,1,0
UZ,KR,2019.0,2,5,-3
AF,US,2022.0,1,2,-1
GB,SD,2003.0,2,1,1
JP,LT,2019.0,1,6,-5
NL,UA,2022.0,1,1,0
AT,nan,2022.0,1,3,-2
BR,ZA,1999.0,1,2,-1
IS,GB,1999.0,1,3,-2
SI,SE,2006.0,1,6,-5
CH,ID,2014.0,1,7,-6
MT,GB,2000.0,3,1,2
LT,PK,2005.0,1,0,1
ET,NL,2008.0,2,0,2
TN,BD,2022.0,2,0,2
SA,GR,2023.0,2,0,2
ID,KW,2014.0,1,0,1
NP,BF,2019.0,1,0,1
GW,HK,2005.0,1,0,1
AO,AU,2011.0,1,0,1
KZ,BY,2004.0,1,0,1
FR,NI,2003.0,1,0,1
FR,KH,2008.0,2,0,2
VE,SE,2020.0,2,0,2
ER,IE,2000.0,1,0,1
BG,HK,2004.0,1,0,1
AU,ML,2006.0,1,0,1
NL,MZ,1999.0,1,0,1
DO,EC,2015.0,1,0,1
LV,CH,2007.0,1,0,1
QA,CZ,2018.0,1,0,1
SI,PT,2018.0,2,0,2
RS,GR,2021.0,2,0,2
SZ,PL,2020.0,1,0,1
YE,RU,2020.0,1,0,1
KG,,2008.0,2,0,2
PY,DE,2015.0,1,0,1
CU,AO,2014.0,1,0,1
NL,RE,1999.0,1,0,1
NE,SA,2011.0,1,0,1
PG,NL,1999.0,1,0,1
CU,SK,2005.0,1,0,1
SD,FR,2002.0,1,0,1
AE,CL,2007.0,1,0,1
JO,CH,2017.0,1,0,1
CO,GT,2003.0,1,0,1
XK,NO,2021.0,1,0,1
CA,KY,2020.0,1,0,1
BR,JO,2005.0,1,0,1
NL,UY,2010.0,1,0,1
RU,KW,2021.0,1,0,1
MN,BE,2020.0,1,0,1
CI,SE,2019.0,1,0,1
FI,NA,2009.0,1,0,1
BH,ZM,2005.0,1,0,1
SK,AR,2019.0,1,0,1
MY,JM,2011.0,1,0,1
IT,AO,2008.0,1,0,1
RS,KR,2002.0,1,0,1
IN,MM,2022.0,1,0,1
MQ,GF,2007.0,1,0,1
MA,QA,2015.0,2,0,2
NL,PE,2011.0,1,0,1
CO,DK,2001.0,2,0,2
GP,CA,2019.0,1,0,1
BE,UZ,2009.0,1,0,1
CO,ZA,2000.0,1,0,1
IS,QA,2002.0,1,0,1
JO,PL,2020.0,2,0,2
IT,GN,2020.0,1,0,1
GW,DE,2005.0,1,0,1
TO,NZ,2010.0,1,0,1
MD,GB,1997.0,2,0,2
GB,BJ,2003.0,1,0,1
IT,XK,2015.0,2,0,2
LV,UZ,2020.0,1,0,1
AZ,AU,2021.0,1,0,1
GE,MX,2003.0,1,0,1
TW,ET,2014.0,2,0,2
GB,ST,2014.0,1,0,1
CM,CD,2015.0,1,0,1
VN,NO,2000.0,1,0,1
AT,CW,1997.0,1,0,1
SN,ML,2002.0,1,0,1
BE,ME,2018.0,1,0,1
BY,ES,2008.0,1,0,1
AR,MY,2012.0,1,0,1
AU,PF,2005.0,1,0,1
NL,AG,2019.0,1,0,1
GM,CY,2021.0,1,0,1
ZW,ET,2017.0,1,0,1
SY,PK,2002.0,1,0,1
MX,GH,2016.0,1,0,1
BW,FI,2020.0,1,0,1
TN,BR,2010.0,3,0,3
CM,SD,2002.0,1,0,1
PE,LU,2022.0,1,0,1
GR,RS,2020.0,2,0,2
CA,CR,1999.0,1,0,1
LV,NO,2005.0,1,0,1
HU,DO,2022.0,1,0,1
GR,PE,2016.0,1,0,1
TH,nan,2006.0,1,0,1
RO,NZ,2006.0,1,0,1
ET,ID,2012.0,1,0,1
GB,GW,2010.0,1,0,1
MA,GN,2021.0,1,0,1
VE,SK,1999.0,1,0,1
MY,BW,2010.0,1,0,1
KH,PK,2013.0,1,0,1
ZA,EC,2022.0,1,0,1
IN,PE,2018.0,1,0,1
HR,HU,2003.0,1,0,1
SI,CL,2010.0,1,0,1
RS,IN,1998.0,1,0,1
nan,VG,2013.0,1,0,1
ZA,LK,2008.0,1,0,1
SA,KZ,2015.0,1,0,1
BG,IR,2022.0,1,0,1
NL,BN,1998.0,1,0,1
FR,PR,1999.0,1,0,1
JO,FI,2018.0,1,0,1
PT,AE,2014.0,3,0,3
BN,MY,2005.0,1,0,1
BF,NL,2004.0,2,0,2
PL,MT,2016.0,1,0,1
AG,,2010.0,1,0,1
nan,LI,2018.0,1,0,1
LV,SI,2004.0,1,0,1
NP,BR,2018.0,1,0,1
CZ,VE,2002.0,2,0,2
IT,UY,2000.0,1,0,1
BD,MY,1998.0,1,0,1
ZA,KH,2007.0,1,0,1
NG,MW,2008.0,1,0,1
HT,CA,2013.0,1,0,1
SK,LV,2016.0,1,0,1
CY,JP,2019.0,1,0,1
PT,YE,2012.0,1,0,1
GR,LK,2002.0,3,0,3
PY,FI,2020.0,1,0,1
GT,DE,2004.0,1,0,1
RU,GH,2021.0,1,0,1
NL,ML,2009.0,1,0,1
US,LS,2010.0,1,0,1
GT,AT,2017.0,1,0,1
CY,IL,2020.0,1,0,1
IM,,2019.0,1,0,1
SY,FI,2020.0,1,0,1
NZ,AR,2000.0,1,0,1
IQ,PT,2021.0,1,0,1
PL,IS,2008.0,1,0,1
ID,CM,2010.0,1,0,1
NI,AR,2020.0,1,0,1
GP,NC,2003.0,1,0,1
SD,SS,2016.0,1,0,1
LB,FI,2011.0,1,0,1
MQ,,2004.0,2,0,2
MA,RW,2017.0,1,0,1
AZ,PT,2011.0,1,0,1
SO,AE,2018.0,1,0,1
GB,SM,2015.0,1,0,1
BF,NG,2018.0,3,0,3
IS,PL,2015.0,1,0,1
LT,nan,2015.0,1,0,1
US,KG,2001.0,1,0,1
RS,SE,1999.0,1,0,1
IT,VN,2006.0,1,0,1
RE,NE,2021.0,1,0,1
SL,,1999.0,1,0,1
ZM,SG,2001.0,1,0,1
MA,IN,1998.0,1,0,1
BW,NL,2009.0,1,0,1
AR,LB,2006.0,1,0,1
CI,ML,2003.0,1,0,1
US,PF,2005.0,1,0,1
AM,SA,2002.0,1,0,1
KZ,XK,2016.0,1,0,1
AU,AE,1997.0,1,0,1
RU,MK,2003.0,1,0,1
SN,CH,2009.0,1,0,1
SK,SA,2018.0,1,0,1
DZ,GR,2017.0,1,0,1
SI,ET,2018.0,1,0,1
CG,MG,2020.0,1,0,1
MA,AU,2009.0,2,0,2
JO,CH,2010.0,1,0,1
GP,GF,2007.0,1,0,1
SN,ZA,2008.0,1,0,1
NG,GH,2023.0,1,0,1
GM,BF,2010.0,1,0,1
NZ,NC,2015.0,1,0,1
AU,BY,2003.0,1,0,1
GB,EE,1999.0,2,0,2
RO,CL,2021.0,1,0,1
PY,GB,2005.0,1,0,1
GW,ST,2019.0,1,0,1
TW,PK,2012.0,1,0,1
YE,CH,2019.0,1,0,1
BH,NG,2000.0,1,0,1
NO,SD,2008.0,1,0,1
BF,TN,2019.0,1,0,1
TW,DK,2022.0,1,0,1
RS,NL,2023.0,1,0,1
SE,PR,2007.0,1,0,1
DZ,TN,2000.0,1,0,1
RO,GR,2002.0,1,0,1
SX,IN,2021.0,1,0,1
IQ,PK,2001.0,1,0,1
NO,PE,2014.0,2,0,2
SA,LB,1999.0,1,0,1
ZA,nan,2023.0,1,0,1
CN,BJ,2016.0,1,0,1
HR,QA,2014.0,1,0,1
SN,PT,2002.0,1,0,1
IE,CY,2008.0,1,0,1
NA,NO,2017.0,1,0,1
VE,TR,2011.0,1,0,1
GN,PK,2016.0,1,0,1
BN,NP,2020.0,1,0,1
CY,EE,2010.0,1,0,1
ET,BJ,2012.0,1,0,1
SN,US,2023.0,1,0,1
NZ,VG,2007.0,1,0,1
MA,LY,2018.0,1,0,1
KP,UZ,2019.0,1,0,1
CN,VG,2022.0,1,0,1
,BJ,2020.0,2,0,2
OM,ID,2020.0,1,0,1
BY,FI,2021.0,1,0,1
MT,AR,2011.0,1,0,1
ET,HU,2018.0,1,0,1
CG,TH,2014.0,1,0,1
BR,GB,2022.0,186,117,69
AU,US,2001.0,1211,1178,33
CR,ES,2009.0,24,36,-12
NL,PT,2017.0,19,36,-17
MX,ES,2018.0,926,1104,-178
GB,AU,2007.0,1015,987,28
GB,HU,2016.0,49,44,5
GB,US,1997.0,2266,2457,-191
ES,US,2001.0,464,478,-14
IE,GB,2019.0,427,477,-50
ES,CO,2011.0,354,327,27
US,ES,2015.0,888,1106,-218
SG,CN,2008.0,353,253,100
EG,US,2021.0,254,277,-23
US,FR,2013.0,1459,1539,-80
CA,CN,2013.0,541,432,109
FR,SE,2018.0,111,79,32
US,IT,2006.0,732,860,-128
FI,TR,2019.0,7,13,-6
GB,US,1998.0,2731,3030,-299
DE,CH,2019.0,1062,914,148
US,IL,2019.0,593,596,-3
DE,CH,2017.0,1085,750,335
IE,GB,2010.0,261,341,-80
CA,US,2009.0,2881,2938,-57
FR,US,2007.0,1255,1182,73
ES,BR,2012.0,379,279,100
KR,PK,2006.0,3,3,0
US,AT,2015.0,264,244,20
US,DE,2021.0,1895,1799,96
BE,ES,2016.0,71,92,-21
CH,US,2020.0,887,823,64
SG,US,2006.0,223,243,-20
NL,DE,2019.0,453,444,9
NL,DE,2010.0,278,299,-21
JP,SG,2018.0,49,44,5
NL,AU,2019.0,129,113,16
IE,BG,2018.0,5,1,4
NZ,GB,2021.0,213,228,-15
DE,PL,2022.0,70,69,1
US,TR,2014.0,504,407,97
ES,DK,2007.0,122,20,102
EC,CL,2021.0,57,60,-3
DE,JP,2001.0,145,133,12
GB,DE,2013.0,917,874,43
DE,AE,2013.0,9,4,5
PT,ES,2005.0,57,63,-6
nan,JP,2002.0,127,63,64
US,IE,2011.0,519,449,70
KR,MX,2013.0,3,4,-1
IR,MY,2016.0,80,246,-166
DE,FR,2007.0,494,407,87
CL,AR,2018.0,120,139,-19
AU,CA,2016.0,369,455,-86
CN,TW,2013.0,928,1278,-350
MY,US,2018.0,219,187,32
JP,IE,2017.0,38,27,11
FR,ES,2011.0,268,274,-6
PK,EG,2016.0,16,12,4
AU,NZ,2006.0,110,143,-33
BE,ZA,2007.0,14,10,4
US,IL,2010.0,399,487,-88
NO,DE,2018.0,76,107,-31
CA,FR,2018.0,588,654,-66
NZ,nan,2002.0,8,2,6
PH,US,2006.0,349,316,33
IN,PK,2018.0,427,299,128
DE,AT,2015.0,592,580,12
FR,BF,2000.0,3,4,-1
DE,GB,2008.0,815,608,207
NL,CW,2004.0,12,6,6
CH,PT,2001.0,4,5,-1
SG,GB,2002.0,45,58,-13
AT,IT,2015.0,36,66,-30
PE,ES,2022.0,79,74,5
GB,BN,2013.0,8,1,7
US,IL,2017.0,511,560,-49
CN,VN,2018.0,54,17,37
DE,CH,2010.0,874,653,221
FR,CH,2019.0,550,387,163
DE,NZ,1999.0,10,17,-7
BE,CA,2006.0,48,39,9
UY,ES,2010.0,40,28,12
AT,ZA,2015.0,10,9,1
IT,CN,2010.0,35,28,7
NL,BE,2016.0,329,286,43
IT,SE,2012.0,83,59,24
NP,IN,2018.0,141,175,-34
TW,JP,2009.0,55,94,-39
ES,IE,2022.0,17,21,-4
AR,PE,2014.0,41,42,-1
JP,KR,2006.0,270,174,96
NZ,AU,2014.0,245,156,89
IT,LU,2016.0,19,4,15
DK,CH,2018.0,44,55,-11
NZ,CN,2018.0,66,56,10
US,nan,2000.0,109,96,13
nan,BR,2005.0,42,33,9
GE,US,2003.0,98,95,3
CA,DK,2018.0,49,38,11
AR,IT,2012.0,79,99,-20
GB,GR,2018.0,217,290,-73
DE,VE,2016.0,6,3,3
DE,TR,2009.0,42,59,-17
CA,AU,2000.0,147,131,16
CU,MX,2010.0,41,34,7
TW,IN,2018.0,46,70,-24
BR,IT,2000.0,55,54,1
JP,DE,2008.0,190,158,32
DE,BR,2003.0,74,62,12
IT,DE,2001.0,136,136,0
CA,CH,2003.0,49,61,-12
GB,CH,1999.0,92,92,0
MY,BD,2017.0,74,45,29
ES,JP,2003.0,14,17,-3
SE,US,2000.0,249,220,29
NL,US,2001.0,348,391,-43
JP,AT,2001.0,11,7,4
ES,PA,2014.0,17,8,9
JP,TR,2003.0,57,39,18
ZW,RU,2017.0,23,12,11
PL,DE,2015.0,116,146,-30
PA,AU,2013.0,1,1,0
US,PK,2015.0,259,224,35
BR,MX,2000.0,24,20,4
CN,DK,2012.0,35,31,4
AR,CH,2021.0,13,10,3
PL,IN,2004.0,3,2,1
TW,SE,2016.0,12,1,11
FR,NL,2016.0,186,179,7
CH,JP,2007.0,45,76,-31
ES,MX,2000.0,200,202,-2
NL,BR,2022.0,22,50,-28
PE,FR,2019.0,21,18,3
HR,RS,2007.0,72,50,22
nan,AU,2019.0,32,27,5
DK,nan,2015.0,18,24,-6
NO,FR,2006.0,33,40,-7
GB,TW,1999.0,26,15,11
CA,PK,2004.0,8,10,-2
IN,FR,2003.0,69,53,16
IT,CN,2019.0,49,55,-6
CZ,CL,1999.0,1,1,0
DE,ET,2016.0,10,4,6
NL,GR,2015.0,21,38,-17
AT,DE,2009.0,436,429,7
ES,IL,2019.0,15,16,-1
CU,MX,2019.0,87,72,15
ES,AR,2000.0,96,91,5
KR,IN,2009.0,90,134,-44
NL,AU,2017.0,125,101,24
DE,SK,2011.0,37,35,2
PH,AU,2013.0,15,11,4
UY,ES,2017.0,54,63,-9
IN,BW,2009.0,4,1,3
GB,AR,2009.0,26,19,7
MY,IR,2012.0,105,95,10
DE,MX,2012.0,40,37,3
NO,RU,2010.0,19,22,-3
IN,KE,2019.0,13,17,-4
MY,ID,2011.0,56,39,17
VE,MX,2006.0,32,31,1
UY,MX,2017.0,17,16,1
MA,CN,2005.0,1,2,-1
UY,ES,2019.0,57,65,-8
CN,IN,2006.0,93,118,-25
KZ,TR,2011.0,42,28,14
TW,LB,2014.0,1,3,-2
FR,TN,2003.0,78,35,43
SY,CN,2006.0,14,8,6
NL,DE,2017.0,463,374,89
MY,CA,2012.0,37,23,14
MM,CN,2004.0,14,7,7
GB,KR,2002.0,44,50,-6
SD,KE,1997.0,8,2,6
US,LU,2021.0,23,16,7
IT,CN,2017.0,72,31,41
CN,IR,2012.0,17,30,-13
CN,PK,2011.0,58,80,-22
BD,US,2002.0,25,18,7
JP,nan,2000.0,86,80,6
nan,FR,2014.0,214,242,-28
IL,CA,2021.0,41,54,-13
AM,US,2011.0,11,7,4
FR,CH,2017.0,500,381,119
SE,BR,2008.0,12,19,-7
LK,CH,2016.0,7,6,1
BR,FR,2022.0,137,79,58
CN,IT,2014.0,38,47,-9
US,CR,2012.0,23,34,-11
DE,AM,2008.0,1,3,-2
CN,PL,2020.0,25,17,8
IN,QA,2016.0,14,23,-9
NO,AU,2011.0,9,19,-10
PT,SG,2016.0,2,3,-1
US,TN,2015.0,26,15,11
FR,CH,2010.0,383,329,54
QA,EG,2015.0,32,48,-16
DE,ID,2017.0,59,18,41
IE,CN,2020.0,36,36,0
FR,LU,2001.0,6,7,-1
IN,IT,2014.0,63,49,14
CH,XK,2012.0,1,1,0
KR,PR,2004.0,17,31,-14
JP,FR,1998.0,50,65,-15
US,GD,2021.0,12,17,-5
GB,NO,2015.0,116,73,43
DK,NO,2017.0,141,75,66
CH,AT,2018.0,125,130,-5
CU,BR,2021.0,10,21,-11
CN,KP,2012.0,4,1,3
DK,SE,2013.0,94,143,-49
SK,GB,2001.0,38,15,23
US,NP,2015.0,50,51,-1
JP,IE,2010.0,24,21,3
ID,SA,2019.0,15,24,-9
RU,CN,2001.0,13,14,-1
IT,CZ,2021.0,34,27,7
HR,AT,2013.0,9,8,1
PE,FR,2017.0,12,16,-4
CH,AU,2018.0,98,110,-12
FR,RU,2018.0,101,77,24
GB,EG,2003.0,26,12,14
US,KE,2016.0,106,93,13
IL,UA,2020.0,4,5,-1
ZA,IE,2020.0,10,8,2
CL,IT,2020.0,24,32,-8
FR,LB,2007.0,34,20,14
US,UG,2010.0,32,20,12
BE,CH,2004.0,36,29,7
UZ,RU,2012.0,18,13,5
FI,DK,2020.0,28,20,8
DK,NO,2010.0,75,74,1
GB,GM,2013.0,5,12,-7
LK,MY,2017.0,7,6,1
KR,MN,2016.0,12,4,8
CH,ES,2011.0,67,85,-18
PK,GB,2011.0,82,109,-27
RO,HU,2016.0,43,50,-7
FR,IL,1998.0,23,17,6
IT,FR,2022.0,214,174,40
SE,BE,2021.0,17,23,-6
GB,ID,2006.0,7,3,4
RU,ZA,2008.0,4,2,2
AU,EG,2014.0,9,16,-7
KH,FR,2021.0,3,2,1
NO,RU,2019.0,20,16,4
BO,CL,2012.0,7,3,4
SK,CZ,1998.0,24,20,4
DK,FR,2021.0,39,43,-4
IQ,US,2011.0,5,5,0
DE,NO,2006.0,54,37,17
SG,PH,2021.0,5,5,0
IT,PS,2017.0,5,1,4
nan,UA,1998.0,8,8,0
nan,AU,2017.0,40,21,19
ES,IT,2004.0,97,96,1
DE,ID,2019.0,50,41,9
CN,BE,2018.0,60,62,-2
NG,TR,2021.0,7,3,4
NZ,AT,2018.0,6,2,4
CA,NO,2019.0,41,28,13
IN,KE,2017.0,17,4,13
IE,IT,2022.0,21,23,-2
RO,CN,2017.0,8,7,1
FR,TH,2018.0,27,14,13
MX,DE,2021.0,49,35,14
RO,CN,2019.0,4,13,-9
GB,IQ,2015.0,43,25,18
NL,AT,2015.0,34,36,-2
US,RS,2007.0,48,33,15
IN,NP,2013.0,82,77,5
UY,MX,2019.0,8,20,-12
TR,PL,2013.0,4,3,1
EG,KW,2022.0,19,13,6
IE,GB,2017.0,396,439,-43
DE,MN,2006.0,1,1,0
JO,SA,2015.0,55,33,22
IR,DK,2021.0,36,8,28
FR,IQ,2019.0,14,4,10
AR,KE,2019.0,2,1,1
PK,AU,2013.0,30,30,0
NO,TW,2012.0,2,2,0
nan,CA,2012.0,33,44,-11
RS,HU,2018.0,11,13,-2
UG,NO,2016.0,1,4,-3
PL,IT,2016.0,28,20,8
DE,CZ,2012.0,67,49,18
AU,IR,2017.0,84,182,-98
DK,BR,2022.0,17,24,-7
DE,RU,1998.0,95,118,-23
CH,FR,2001.0,196,229,-33
FR,TW,2014.0,15,12,3
DZ,ES,2017.0,4,10,-6
JM,CA,2018.0,4,3,1
nan,NL,2010.0,73,55,18
GB,NZ,2001.0,124,119,5
GH,US,2020.0,66,60,6
NE,FR,2019.0,31,37,-6
ID,IT,2020.0,16,30,-14
AU,BR,2022.0,57,80,-23
ET,NG,2021.0,9,16,-7
SE,GB,2021.0,142,212,-70
US,MN,2016.0,4,4,0
SE,SG,2002.0,4,3,1
SI,CZ,2020.0,7,5,2
TH,ID,2020.0,25,31,-6
PT,SE,2019.0,22,18,4
EG,PK,2018.0,17,15,2
NL,DK,2007.0,30,8,22
LB,IT,2017.0,15,11,4
nan,DE,2003.0,26,24,2
GB,LB,2022.0,6,9,-3
FR,EG,2008.0,12,11,1
PR,MX,2016.0,6,6,0
NL,KE,2014.0,11,8,3
CL,MX,2000.0,18,38,-20
NG,BE,2007.0,2,2,0
CZ,US,1999.0,53,53,0
PT,AR,2019.0,16,26,-10
JP,PH,2016.0,28,24,4
RU,JP,2021.0,32,23,9
BR,MZ,2021.0,25,11,14
PT,AR,2017.0,18,14,4
LB,IT,2019.0,15,23,-8
KH,CY,2021.0,2,2,0
GH,ZA,2018.0,24,20,4
HU,SK,2011.0,20,4,16
DZ,ES,2019.0,4,6,-2
IQ,SY,2021.0,7,4,3
ID,SA,2017.0,6,40,-34
CN,TZ,2022.0,7,4,3
SE,NL,2012.0,52,45,7
LU,IN,2018.0,1,4,-3
VE,UY,2019.0,5,1,4
PK,OM,2021.0,10,6,4
RU,TR,2002.0,3,2,1
BH,GH,2018.0,20,9,11
ES,CU,2003.0,45,44,1
RO,DE,2016.0,42,42,0
EG,GB,2012.0,49,103,-54
CH,RU,2017.0,45,31,14
SA,KR,2012.0,4,12,-8
SG,PT,2017.0,1,2,-1
US,BW,2014.0,15,9,6
ZA,IN,1998.0,4,2,2
IR,DE,2020.0,112,80,32
AU,IR,2019.0,93,237,-144
GB,KR,2005.0,59,55,4
BH,US,2018.0,17,8,9
ES,UY,2012.0,35,32,3
JM,US,2018.0,20,11,9
US,IR,2007.0,114,111,3
EC,CR,2019.0,19,33,-14
GB,BG,2007.0,7,7,0
TH,IN,2015.0,15,12,3
SE,CA,1999.0,23,23,0
PT,NL,2012.0,29,24,5
PL,VN,2017.0,3,3,0
EG,BD,2018.0,6,11,-5
FI,US,2013.0,144,138,6
CZ,CH,2012.0,22,16,6
PT,ES,2002.0,41,67,-26
SG,CA,2008.0,32,33,-1
RU,AT,2011.0,12,7,5
TW,CZ,2000.0,2,2,0
SE,IT,1999.0,28,86,-58
BR,NZ,2021.0,19,8,11
RU,SK,2016.0,12,27,-15
IL,CZ,2016.0,9,6,3
MY,SE,2015.0,7,5,2
ZW,RU,2019.0,16,23,-7
NL,GH,2015.0,5,3,2
RS,CA,2012.0,9,16,-7
IR,SE,2016.0,42,39,3
SI,HR,2014.0,24,27,-3
AU,SE,2001.0,24,17,7
FR,AU,2009.0,123,93,30
US,SA,2004.0,61,35,26
BE,IR,2008.0,7,4,3
DK,ES,2013.0,23,43,-20
SK,CA,2012.0,3,1,2
NL,PT,2010.0,24,13,11
SA,NG,2002.0,1,2,-1
BY,US,1999.0,5,4,1
GA,DE,2009.0,6,1,5
PT,NO,2014.0,5,5,0
SD,SA,2022.0,32,15,17
US,SN,2022.0,5,3,2
CO,CA,2011.0,16,16,0
IL,PA,2017.0,1,1,0
GR,IN,2018.0,3,9,-6
BD,NL,2015.0,4,8,-4
CA,NO,2017.0,40,15,25
MY,SG,2011.0,51,129,-78
JP,MX,2004.0,8,4,4
JO,BH,2004.0,1,1,0
MY,BD,2019.0,74,51,23
JP,PK,2010.0,13,7,6
EC,ES,2011.0,22,23,-1
NL,IN,2021.0,49,69,-20
SG,TW,2021.0,33,51,-18
CA,HU,2012.0,11,16,-5
RE,FR,2017.0,34,47,-13
FR,EE,2018.0,5,8,-3
ID,LK,2017.0,10,14,-4
ES,IL,2017.0,17,11,6
CL,AU,2016.0,34,23,11
FR,AR,2009.0,38,32,6
US,LY,2021.0,5,3,2
UG,ZA,2018.0,18,16,2
RU,BH,2020.0,1,7,-6
NZ,BD,2020.0,6,4,2
MG,US,2018.0,5,5,0
ZA,AU,2009.0,45,44,1
ES,PL,2014.0,17,22,-5
CH,VN,2016.0,4,2,2
CH,RU,2010.0,17,26,-9
IL,JP,2000.0,10,11,-1
LU,CH,2020.0,9,5,4
AU,RS,2014.0,13,10,3
CH,CZ,2015.0,38,31,7
GR,CH,2012.0,30,20,10
SG,ET,2019.0,1,1,0
NL,FI,2008.0,36,29,7
CU,MX,2017.0,63,55,8
SA,IN,2007.0,13,8,5
US,LK,2011.0,18,15,3
AE,SA,2009.0,7,10,-3
AU,NL,2008.0,54,78,-24
RE,FR,2010.0,14,42,-28
US,BA,2015.0,5,4,1
ZA,BE,2012.0,15,21,-6
JO,BR,2016.0,12,1,11
PT,NZ,2012.0,2,6,-4
JP,CZ,2020.0,20,22,-2
NG,FR,2017.0,2,6,-4
IN,PT,2016.0,16,14,2
RE,FR,2019.0,39,51,-12
SI,BE,2014.0,3,4,-1
HU,IN,2022.0,4,4,0
CA,OM,2008.0,9,2,7
FR,IQ,2017.0,11,3,8
BE,CW,2011.0,3,3,0
CH,RU,2019.0,45,45,0
PE,FR,2010.0,3,4,-1
PL,NO,2003.0,2,1,1
nan,CH,2002.0,3,7,-4
KW,QA,2018.0,7,4,3
VN,GH,2022.0,1,1,0
FI,MX,2017.0,7,2,5
US,AF,2021.0,5,1,4
SK,CZ,1997.0,11,16,-5
PK,DE,2015.0,33,35,-2
SG,IL,2008.0,2,1,1
PA,GB,2020.0,12,7,5
FR,SA,2020.0,47,16,31
PS,US,2022.0,7,5,2
CN,MG,2016.0,5,5,0
IN,MY,1998.0,4,4,0
KR,SA,2020.0,20,7,13
NE,FR,2017.0,20,34,-14
FR,MD,2001.0,39,41,-2
PT,PE,2017.0,9,2,7
ZM,nan,2017.0,2,1,1
CA,KW,2018.0,14,14,0
GH,GB,2021.0,30,22,8
RO,BE,2012.0,13,8,5
UG,ES,2009.0,1,1,0
CA,CO,2021.0,19,30,-11
TN,EG,2014.0,13,16,-3
TH,NP,2015.0,5,3,2
ES,RU,2012.0,7,13,-6
MY,BE,2021.0,7,2,5
GB,CU,2015.0,5,6,-1
CY,GR,2007.0,9,24,-15
US,UG,2017.0,47,42,5
FI,IN,2020.0,24,20,4
DE,CO,2012.0,10,25,-15
FR,NZ,2001.0,9,9,0
RU,PL,2008.0,35,17,18
nan,GH,2021.0,2,4,-2
NO,CA,2020.0,34,39,-5
PL,FR,2014.0,36,54,-18
BD,JP,2003.0,17,19,-2
NL,ID,2007.0,8,4,4
UA,US,2015.0,73,64,9
LS,ZA,2016.0,5,2,3
IR,IT,2021.0,69,22,47
ZA,TW,2011.0,1,2,-1
GB,EC,2021.0,6,8,-2
TR,ES,2014.0,5,7,-2
JP,PK,2019.0,15,11,4
NL,CA,2000.0,34,46,-12
NL,ZA,2005.0,20,26,-6
LK,BT,2020.0,3,2,1
SE,CZ,2021.0,17,12,5
BJ,FR,2021.0,19,17,2
SS,SD,2006.0,2,1,1
CM,NG,2007.0,2,2,0
GR,IE,2016.0,6,4,2
PS,DE,2007.0,3,1,2
HK,RO,2015.0,14,24,-10
CH,BE,2012.0,66,68,-2
MY,DE,2022.0,17,8,9
DE,RO,2008.0,19,18,1
FR,SK,2018.0,5,6,-1
FI,TR,2010.0,8,5,3
MA,MD,2011.0,5,8,-3
DK,FI,2004.0,6,5,1
IN,IQ,2012.0,7,1,6
CO,FR,2001.0,9,9,0
ET,KE,2016.0,4,6,-2
ZA,CD,2019.0,3,2,1
LB,BR,2017.0,4,3,1
JP,DK,2020.0,17,17,0
TZ,NL,2009.0,4,4,0
FR,HU,2021.0,13,21,-8
AR,BR,2003.0,47,36,11
CZ,VN,1998.0,2,1,1
PL,MN,2011.0,1,2,-1
CZ,AT,2020.0,39,42,-3
IT,ZA,2018.0,27,18,9
BG,CA,2013.0,4,4,0
RO,CA,2014.0,15,14,1
US,MA,2012.0,16,11,5
CL,BR,2006.0,31,38,-7
US,ID,2001.0,10,11,-1
AU,DK,1998.0,11,11,0
SI,IT,2022.0,12,10,2
BE,MX,2014.0,11,9,2
CZ,JP,2015.0,20,13,7
AU,IR,2010.0,30,49,-19
DE,QA,2016.0,7,5,2
AU,FI,2014.0,20,18,2
SA,NL,2020.0,6,5,1
JO,FR,2014.0,1,4,-3
PL,GB,2004.0,38,27,11
CA,NO,2010.0,21,16,5
SA,CH,2021.0,6,4,2
IL,LU,2000.0,1,1,0
UA,EC,2014.0,29,50,-21
TH,BT,2018.0,3,2,1
NL,IE,2000.0,10,7,3
CA,PE,2004.0,2,2,0
ID,PE,2017.0,2,1,1
nan,KR,2011.0,32,23,9
NL,PT,2019.0,15,35,-20
SE,AT,1998.0,9,2,7
IS,NO,2007.0,4,6,-2
DK,PK,2022.0,4,6,-2
SV,ES,2018.0,9,6,3
MY,MM,2013.0,3,5,-2
NO,RU,2017.0,31,12,19
TW,RU,2000.0,6,7,-1
AT,TR,1998.0,6,6,0
ES,GT,2002.0,1,1,0
MX,SV,2010.0,3,3,0
TW,FI,2011.0,4,4,0
CO,PH,2020.0,14,7,7
RU,IR,2013.0,11,3,8
BE,PE,2019.0,5,4,1
DE,RS,2022.0,14,13,1
UA,DE,2008.0,27,28,-1
EG,DK,1997.0,1,2,-1
CA,AR,2016.0,33,30,3
GB,NG,2001.0,12,5,7
CA,MX,2006.0,20,28,-8
CA,CU,2015.0,1,6,-5
GB,GD,2017.0,5,1,4
IL,FR,2012.0,30,28,2
SE,RS,2011.0,3,2,1
JP,IE,2019.0,24,44,-20
KE,AU,2013.0,10,6,4
LK,ES,2019.0,4,1,3
JP,AE,2019.0,11,1,10
IT,IN,2016.0,59,59,0
ES,PE,1998.0,9,7,2
ES,EC,2007.0,14,12,2
ES,PE,1997.0,7,13,-6
RU,AM,2006.0,7,3,4
PK,SA,2002.0,5,6,-1
CA,RU,2000.0,21,21,0
FR,KE,2015.0,9,11,-2
NL,NO,2003.0,10,22,-12
TH,TW,2006.0,3,2,1
IL,RS,2016.0,3,1,2
JM,GB,2004.0,8,3,5
CH,AE,2008.0,1,1,0
IN,MY,1997.0,4,3,1
HU,FR,2014.0,24,22,2
KY,US,2017.0,2,1,1
MX,VN,2012.0,5,3,2
US,IS,2016.0,24,11,13
CA,SK,2014.0,4,3,1
CA,SE,2004.0,25,38,-13
GB,SS,2017.0,7,10,-3
IL,KR,2007.0,2,1,1
ES,IS,2013.0,7,2,5
NO,CN,2005.0,9,14,-5
BD,CN,2008.0,26,40,-14
LB,IT,2010.0,8,10,-2
ID,MY,2023.0,6,2,4
HT,FR,2020.0,2,4,-2
CA,TH,2022.0,6,8,-2
IL,HU,2022.0,2,4,-2
EG,BE,2015.0,2,7,-5
TR,SG,2018.0,13,6,7
GH,ID,2021.0,15,17,-2
OM,AE,2021.0,6,5,1
PL,RU,2023.0,3,1,2
CZ,CO,2018.0,1,2,-1
EE,AU,2016.0,7,1,6
IQ,ID,2018.0,5,9,-4
KZ,NL,2020.0,3,1,2
ST,BR,2013.0,34,27,7
RS,BA,2008.0,7,8,-1
IT,MA,1997.0,1,1,0
BF,SN,2010.0,2,3,-1
GR,NL,1997.0,2,5,-3
PH,GB,2011.0,16,14,2
DE,LY,2008.0,1,1,0
MM,JP,2004.0,2,4,-2
FR,MQ,2009.0,13,13,0
IQ,SE,2019.0,5,11,-6
PK,RU,2021.0,8,3,5
DK,AT,2000.0,4,8,-4
HR,NL,2006.0,5,1,4
SD,KE,1998.0,2,1,1
JO,nan,2018.0,2,1,1
CA,PF,2013.0,1,1,0
CA,KN,2016.0,3,1,2
SG,IE,2013.0,4,8,-4
PT,SE,2017.0,18,10,8
SK,FI,2006.0,18,2,16
EC,UA,2021.0,11,10,1
KY,US,2019.0,1,1,0
EG,nan,2021.0,6,2,4
KW,IN,2013.0,8,8,0
MD,FR,2008.0,63,34,29
HU,ES,2013.0,9,8,1
DZ,ES,2010.0,1,2,-1
BD,US,2005.0,25,26,-1
PT,SE,2010.0,3,5,-2
CH,IE,2020.0,20,14,6
SG,NL,2020.0,27,15,12
PT,AR,2010.0,8,7,1
CA,KR,2006.0,32,34,-2
LK,ES,2010.0,4,2,2
ES,IL,2010.0,15,12,3
KR,RU,1998.0,1,6,-5
HK,AU,2021.0,4,3,1
CZ,CA,2004.0,4,9,-5
SD,US,2010.0,5,4,1
KE,FR,2014.0,12,6,6
SN,CI,2015.0,5,1,4
NO,CN,2002.0,8,10,-2
HN,US,2011.0,4,2,2
ID,NG,2015.0,4,9,-5
BW,US,2012.0,8,11,-3
DK,CZ,2020.0,11,5,6
FR,PF,2009.0,8,6,2
US,MD,2015.0,6,5,1
DE,UA,2013.0,30,22,8
IN,KE,2010.0,4,9,-5
BG,BE,2008.0,7,5,2
MZ,SE,2019.0,1,3,-2
MD,US,2008.0,7,6,1
EG,CH,2019.0,8,8,0
NI,SE,2004.0,3,2,1
NL,ET,2009.0,4,5,-1
NL,RU,2011.0,22,25,-3
JP,FR,1997.0,39,48,-9
BR,AT,2020.0,22,12,10
DZ,IT,2011.0,11,18,-7
IT,PL,1998.0,9,6,3
IN,NO,1999.0,24,28,-4
PT,nan,1997.0,4,1,3
GB,OM,2002.0,6,1,5
AT,GB,2003.0,36,42,-6
DE,MK,2016.0,1,3,-2
GR,SE,2016.0,29,15,14
SD,US,2017.0,8,5,3
NO,CZ,2016.0,5,47,-42
IT,SK,2002.0,1,4,-3
RU,IT,2012.0,20,17,3
DO,IT,2020.0,3,7,-4
AU,MY,2008.0,40,32,8
RU,TR,2005.0,7,6,1
CA,IS,2016.0,2,6,-4
PF,FR,2009.0,6,8,-2
CO,IN,2021.0,3,2,1
LU,FR,2005.0,14,21,-7
ZA,CD,2017.0,2,4,-2
SG,FR,2011.0,14,30,-16
GB,SS,2010.0,6,13,-7
NO,IE,2006.0,3,2,1
GE,DE,2010.0,8,7,1
JP,ET,2022.0,5,2,3
MX,CL,2023.0,4,1,3
PT,GB,2006.0,48,59,-11
AT,LT,2010.0,1,1,0
CI,FR,2012.0,11,15,-4
KW,US,1997.0,3,5,-2
CO,CU,2011.0,23,22,1
FR,KH,2007.0,4,4,0
KY,US,2010.0,3,1,2
ES,PS,2015.0,12,15,-3
IN,NG,2011.0,9,5,4
JP,BR,2022.0,16,17,-1
HU,IE,2013.0,2,1,1
IN,EE,2009.0,4,1,3
RU,IE,2015.0,5,6,-1
ZA,CR,2010.0,4,1,3
NG,FR,2010.0,3,3,0
IT,MX,2000.0,7,10,-3
TW,ES,2001.0,3,3,0
NO,BR,2001.0,13,4,9
SE,ET,2013.0,8,2,6
CG,ZW,2009.0,2,1,1
HU,TR,2018.0,4,10,-6
IT,PL,1997.0,7,7,0
PE,BO,2020.0,7,6,1
SA,MA,1998.0,1,2,-1
ID,AT,2022.0,6,1,5
CL,CA,2016.0,23,33,-10
SA,BH,2014.0,4,7,-3
SE,KR,2009.0,7,7,0
AR,LU,2016.0,1,1,0
AT,RS,2005.0,3,3,0
NZ,nan,2005.0,16,5,11
AR,VE,2008.0,8,19,-11
nan,ZA,2021.0,6,10,-4
RS,CH,2005.0,5,4,1
CH,NZ,1998.0,2,3,-1
SE,SG,2005.0,2,11,-9
AU,DK,1997.0,14,7,7
US,ML,1998.0,2,2,0
SG,PT,2019.0,3,2,1
LB,BR,2010.0,4,3,1
VE,PE,2006.0,5,5,0
IN,BE,2000.0,5,8,-3
JP,HK,2011.0,6,5,1
AT,NL,2003.0,14,14,0
DE,BJ,2016.0,4,2,2
MX,SV,2019.0,6,5,1
SE,UG,2022.0,3,2,1
JM,FR,2002.0,2,1,1
DE,MG,2015.0,1,2,-1
AR,PR,2011.0,1,1,0
LU,NL,2007.0,1,1,0
IT,IE,2022.0,23,21,2
DE,TN,2004.0,3,3,0
SY,JO,2012.0,3,1,2
BY,RU,2000.0,14,15,-1
RO,IN,2022.0,3,5,-2
LB,DE,2007.0,2,5,-3
RO,UA,2001.0,1,4,-3
FI,PL,2007.0,3,11,-8
AT,AR,2014.0,3,4,-1
BD,NZ,2020.0,4,6,-2
PE,JP,1999.0,1,1,0
CL,PH,2017.0,7,2,5
JP,HU,2011.0,7,10,-3
BE,PE,2017.0,5,2,3
CA,EC,2017.0,9,5,4
BE,PK,2020.0,6,6,0
KR,GR,2004.0,2,1,1
TR,AR,2020.0,1,3,-2
CN,BO,2018.0,2,1,1
SE,MY,2018.0,7,3,4
KE,GH,2011.0,1,1,0
CL,PH,2019.0,9,2,7
CO,GR,2014.0,1,1,0
RO,IE,2017.0,1,2,-1
GB,BY,2004.0,1,4,-3
GB,CR,2015.0,6,1,5
BJ,NE,2020.0,1,2,-1
SG,ES,2014.0,5,10,-5
UG,BE,2018.0,17,10,7
AE,DE,2015.0,4,10,-6
PE,PT,2014.0,3,6,-3
IN,CL,2021.0,6,5,1
LK,MY,2019.0,4,10,-6
HR,UA,2022.0,17,3,14
ID,LK,2019.0,8,9,-1
IT,PE,2022.0,3,5,-2
BR,SG,2019.0,3,4,-1
IN,PL,1997.0,1,1,0
PL,FI,2007.0,11,3,8
GH,IT,2020.0,4,7,-3
AE,KR,2020.0,4,13,-9
GE,DE,2017.0,5,3,2
TR,HU,2022.0,6,10,-4
SG,QA,2021.0,3,3,0
BD,NO,2009.0,2,1,1
ZA,ET,2016.0,9,3,6
NO,TR,2020.0,10,13,-3
TR,FI,2000.0,2,3,-1
ZA,IN,1997.0,2,3,-1
CN,SY,2003.0,6,10,-4
HU,EG,2012.0,4,2,2
UA,BR,2015.0,7,1,6
GB,JE,2016.0,1,1,0
RS,MX,2003.0,16,7,9
IN,HU,2004.0,3,5,-2
IQ,SE,2017.0,6,4,2
IR,NG,2016.0,2,2,0
CU,BE,2020.0,4,3,1
NO,FI,2012.0,10,16,-6
FR,CL,2003.0,15,13,2
MY,CH,2017.0,7,6,1
PT,PL,2013.0,4,4,0
MX,PE,2003.0,10,9,1
ES,HN,2018.0,8,5,3
MQ,FR,2002.0,6,8,-2
IT,PS,2019.0,2,1,1
KE,ET,2019.0,9,8,1
FR,VE,2002.0,5,2,3
GR,MX,2007.0,5,2,3
ES,QA,2021.0,5,3,2
TR,GR,2008.0,8,5,3
PE,GB,2007.0,5,3,2
CA,EE,2011.0,4,2,2
DE,SI,1998.0,6,6,0
BE,NE,2019.0,3,3,0
SA,FR,2012.0,11,29,-18
AU,OM,2009.0,3,2,1
CH,UG,2018.0,3,8,-5
CO,JP,2007.0,7,9,-2
KE,ET,2017.0,5,6,-1
CM,DE,2004.0,5,4,1
AE,SE,2007.0,4,2,2
GL,DK,2006.0,3,3,0
IN,LY,2010.0,5,2,3
US,BH,2001.0,4,5,-1
PL,AU,2021.0,18,9,9
GA,FR,2003.0,5,3,2
CM,CG,2020.0,1,2,-1
ES,EG,2003.0,3,3,0
RU,UZ,2005.0,9,5,4
HR,BR,2013.0,4,3,1
AU,HU,2008.0,12,12,0
SI,IE,2017.0,5,1,4
KW,US,1998.0,5,10,-5
CH,UA,2005.0,4,3,1
MA,BR,2016.0,4,1,3
RU,MD,2005.0,3,1,2
SE,PL,2000.0,14,7,7
RS,JP,2005.0,4,6,-2
GR,CY,2003.0,6,10,-4
BE,MQ,2017.0,1,1,0
DK,KR,2006.0,1,1,0
nan,SG,2009.0,8,3,5
SE,VN,2018.0,3,2,1
ET,ZA,2011.0,5,2,3
nan,PY,2020.0,1,2,-1
NG,PK,2004.0,2,1,1
AT,MA,2019.0,1,1,0
AU,JE,2020.0,1,1,0
PT,PE,2019.0,7,4,3
RO,FR,1999.0,13,9,4
CH,TR,2009.0,11,15,-4
CA,KE,2009.0,4,5,-1
PH,TW,2012.0,3,4,-1
CL,SE,2011.0,4,3,1
UY,US,2001.0,4,5,-1
IE,BE,2002.0,3,1,2
VN,AU,1999.0,2,2,0
IN,BH,2002.0,3,2,1
HR,GB,2003.0,7,7,0
HU,ID,2022.0,6,5,1
CN,LT,2015.0,7,2,5
BG,RO,2010.0,2,1,1
BE,CD,2022.0,7,5,2
CA,LU,2015.0,4,5,-1
VE,PL,2013.0,1,2,-1
HU,DK,2018.0,9,3,6
UA,BG,2015.0,8,11,-3
US,TZ,1997.0,5,2,3
RO,CN,2010.0,4,4,0
ZM,CN,2013.0,1,1,0
PE,VE,2006.0,5,5,0
BD,GB,2000.0,9,13,-4
FR,AL,2019.0,3,1,2
DZ,BE,2020.0,10,7,3
ET,GB,2005.0,1,1,0
DO,nan,2018.0,2,1,1
TW,QA,2019.0,3,3,0
BR,UG,2021.0,1,1,0
GB,GE,2021.0,4,4,0
AT,HR,2022.0,3,5,-2
IQ,LY,2018.0,2,3,-1
US,CI,2015.0,8,2,6
LV,US,2007.0,4,2,2
EE,US,2008.0,7,5,2
TH,CH,2015.0,1,3,-2
NZ,CH,2022.0,9,7,2
MA,DE,2013.0,3,8,-5
MG,AU,2018.0,1,3,-2
NG,UG,2021.0,11,5,6
SK,nan,2015.0,3,3,0
ZW,AU,2007.0,2,1,1
AT,MA,2010.0,1,1,0
PK,SA,2005.0,7,14,-7
PT,DK,2007.0,2,2,0
BR,GE,2016.0,2,4,-2
NZ,PL,2021.0,2,3,-1
CU,PT,2003.0,1,1,0
CI,SN,2005.0,1,1,0
SI,RS,2003.0,4,2,2
DO,US,2016.0,3,3,0
TR,QA,2015.0,3,1,2
SI,FI,2016.0,2,1,1
EE,UA,2020.0,2,1,1
RS,ES,1997.0,1,1,0
PL,SA,2014.0,2,2,0
GH,BH,2021.0,8,25,-17
GM,GB,2004.0,6,5,1
GB,JO,2020.0,33,22,11
IL,IN,1999.0,6,11,-5
SG,MM,2020.0,10,3,7
UY,PT,2006.0,2,2,0
nan,CH,2005.0,7,7,0
SA,AU,2009.0,6,11,-5
PL,TR,2020.0,4,7,-3
AU,RU,2006.0,8,12,-4
ZA,KR,2020.0,6,4,2
AT,IE,2006.0,4,5,-1
BD,SA,2002.0,3,2,1
VE,PA,2013.0,3,3,0
EC,NL,2015.0,2,3,-1
CA,PH,2004.0,5,5,0
KH,PH,2017.0,1,1,0
RO,PL,2021.0,7,4,3
RU,UZ,2002.0,9,9,0
CZ,GR,2013.0,2,10,-8
CN,PT,2016.0,12,11,1
nan,FI,2001.0,4,7,-3
CH,LT,2014.0,3,1,2
US,GY,2015.0,1,2,-1
KR,IR,2015.0,9,12,-3
LB,CA,2011.0,4,6,-2
TZ,MY,2013.0,2,1,1
KE,KR,2014.0,1,2,-1
ET,IN,2004.0,1,4,-3
CA,AT,2022.0,11,18,-7
SE,AT,1997.0,7,2,5
CN,PE,2015.0,2,3,-1
SG,TR,2018.0,6,13,-7
IL,DK,2005.0,4,2,2
MX,ET,2021.0,1,2,-1
AU,NG,2008.0,1,1,0
ML,US,2016.0,4,3,1
IN,LK,2009.0,4,9,-5
QA,FI,2015.0,1,2,-1
MY,IE,2014.0,1,11,-10
EG,PT,2012.0,1,3,-2
HU,nan,2018.0,4,3,1
SD,MY,2008.0,2,2,0
IN,RW,2011.0,7,6,1
BG,RO,2017.0,2,2,0
BW,GB,2011.0,4,4,0
ID,PA,2017.0,1,4,-3
BI,US,2009.0,2,2,0
BE,RS,2004.0,2,1,1
EG,DK,1998.0,2,6,-4
DK,EG,1999.0,4,1,3
SA,JP,1998.0,2,1,1
KW,EG,1997.0,3,2,1
PK,FI,2013.0,3,2,1
nan,AE,2021.0,2,2,0
IN,BG,2014.0,3,3,0
BI,DZ,2014.0,2,2,0
CR,US,2003.0,13,13,0
nan,UA,1997.0,2,7,-5
AU,IL,2001.0,7,12,-5
AU,PG,2014.0,6,12,-6
MQ,FR,2005.0,7,4,3
BA,US,2016.0,8,13,-5
HR,IT,2011.0,6,5,1
FR,TR,2003.0,12,11,1
OM,SA,2014.0,7,11,-4
IE,CL,2015.0,1,4,-3
OM,CN,2016.0,1,2,-1
TH,LA,2021.0,2,3,-1
LU,FR,2002.0,8,12,-4
US,TZ,1998.0,3,4,-1
CO,FI,2018.0,1,3,-2
CH,ET,2020.0,5,4,1
QA,GB,2000.0,4,4,0
EG,ID,2014.0,8,7,1
SE,SI,2020.0,6,3,3
ET,ES,2021.0,2,1,1
IL,DK,2002.0,3,2,1
NZ,IT,2007.0,1,6,-5
MY,NL,2007.0,4,5,-1
TW,NZ,2009.0,2,6,-4
CO,AU,2009.0,2,6,-4
TZ,nan,2007.0,2,1,1
IN,ZW,2020.0,1,2,-1
RS,DK,2013.0,2,2,0
JP,CM,2015.0,1,2,-1
ID,SA,2010.0,4,2,2
GT,nan,2019.0,1,1,0
IN,ET,2007.0,3,2,1
LK,NL,2016.0,1,3,-2
UA,GE,2015.0,1,1,0
KW,DE,2017.0,1,4,-3
ID,HU,2022.0,5,6,-1
TN,PK,2008.0,2,1,1
JO,AU,2013.0,7,11,-4
US,BY,2015.0,4,19,-15
NZ,MK,2015.0,1,1,0
FI,NO,2001.0,8,8,0
SG,BR,2013.0,3,2,1
IT,TH,1998.0,2,2,0
RU,FR,2023.0,9,1,8
EG,NG,2007.0,1,3,-2
AT,SE,2001.0,7,6,1
ZA,CR,2019.0,1,6,-5
PH,IN,2011.0,10,9,1
TR,NO,2004.0,5,1,4
EG,AT,2007.0,3,3,0
TZ,NO,2011.0,4,8,-4
FR,ET,2020.0,5,4,1
ZA,CN,2006.0,2,11,-9
PA,JP,2010.0,2,2,0
IL,BG,2021.0,1,1,0
AT,TR,1997.0,4,1,3
RS,UZ,2009.0,2,4,-2
GB,UZ,2002.0,1,4,-3
ZW,GB,1997.0,3,4,-1
SK,ES,2009.0,2,2,0
DZ,CH,2009.0,1,3,-2
NL,GW,2005.0,2,1,1
RS,CH,2002.0,3,3,0
RO,IT,2001.0,5,5,0
CZ,TR,2012.0,9,5,4
MY,CH,2019.0,7,4,3
TN,IN,2012.0,3,4,-1
PL,PT,2015.0,5,8,-3
BH,EG,2007.0,1,1,0
GB,SS,2019.0,6,9,-3
US,EE,2022.0,6,9,-3
SA,MA,1997.0,1,1,0
CH,PH,2014.0,5,4,1
BR,GT,2021.0,2,4,-2
HU,IT,1999.0,7,4,3
NO,ZM,2015.0,2,1,1
ZA,ES,2021.0,6,6,0
SD,BH,2018.0,2,2,0
MX,CR,1997.0,4,2,2
PS,IT,2022.0,1,1,0
RU,NZ,2014.0,3,10,-7
UZ,CN,2003.0,1,2,-1
CM,FR,1999.0,8,12,-4
CO,AG,2018.0,1,5,-4
TR,LB,2019.0,2,2,0
BH,CN,2022.0,2,3,-1
MA,CH,2009.0,2,2,0
LB,BR,2019.0,8,9,-1
LV,RU,2023.0,1,1,0
FR,OM,2021.0,1,1,0
LT,AM,2011.0,2,1,1
EG,OM,2008.0,4,3,1
IT,SK,2005.0,6,3,3
TH,AU,2001.0,6,8,-2
PK,IR,2001.0,1,1,0
TH,PL,2018.0,1,2,-1
MT,US,2015.0,4,11,-7
SI,MX,2012.0,2,2,0
NL,SI,2004.0,2,2,0
ZA,MW,2003.0,1,1,0
CA,BD,2023.0,1,1,0
CA,QA,2013.0,12,5,7
SE,HR,2012.0,2,1,1
GB,OM,2005.0,3,6,-3
AM,JP,2006.0,6,9,-3
IS,DE,2021.0,5,2,3
UY,GB,2008.0,3,2,1
NL,RS,2006.0,3,5,-2
AU,PK,2000.0,5,2,3
RO,RU,2007.0,1,2,-1
VE,IT,2018.0,5,1,4
CR,CN,2007.0,2,1,1
LT,UA,2009.0,1,1,0
PT,RO,2008.0,3,2,1
ZW,GB,1998.0,2,6,-4
BD,NG,2022.0,1,2,-1
UA,KR,2006.0,1,1,0
NO,BD,2015.0,1,3,-2
KZ,UA,2015.0,2,3,-1
LY,RS,2017.0,1,1,0
IT,VE,2012.0,4,10,-6
FI,CZ,2006.0,4,5,-1
CA,ZM,2015.0,2,1,1
NZ,BE,2021.0,3,5,-2
NE,FR,2010.0,3,5,-2
MX,CR,1998.0,1,3,-2
CL,CU,2003.0,7,11,-4
FI,TH,2009.0,1,1,0
LT,IT,2020.0,3,1,2
SE,BG,2018.0,5,1,4
PS,IN,2015.0,1,1,0
TG,BJ,2020.0,1,6,-5
CH,CL,2002.0,4,2,2
PT,SA,2017.0,2,1,1
LK,ES,2017.0,3,4,-1
ID,LK,2010.0,2,3,-1
NG,BJ,2002.0,1,2,-1
RO,CH,2011.0,7,5,2
IN,AR,2009.0,1,1,0
BR,SG,2010.0,4,2,2
CO,BO,2016.0,6,14,-8
TT,CA,2021.0,3,2,1
BN,PK,2017.0,1,3,-2
BR,SG,2017.0,3,4,-1
JP,GT,2013.0,1,1,0
FR,AL,2017.0,1,1,0
HR,ZA,2001.0,1,2,-1
MX,SV,2017.0,1,9,-8
EG,TR,2009.0,2,5,-3
IT,SI,2012.0,11,14,-3
RU,TJ,2009.0,5,8,-3
NP,LK,2013.0,1,2,-1
BH,OM,2022.0,1,2,-1
KZ,GB,2001.0,2,1,1
UA,AT,1999.0,3,2,1
BR,MA,2003.0,1,2,-1
CF,FR,2009.0,1,1,0
HU,PT,2016.0,1,3,-2
CR,AU,2009.0,1,1,0
ID,BR,2016.0,7,20,-13
FI,CO,2018.0,3,1,2
GR,NO,2001.0,1,1,0
IN,SE,1999.0,5,5,0
EG,CH,2017.0,3,6,-3
RO,TW,2002.0,1,1,0
RU,EC,2021.0,1,1,0
IE,GH,2021.0,3,1,2
DK,IE,2005.0,4,3,1
CA,EC,2019.0,4,5,-1
NI,US,2016.0,2,5,-3
SA,NG,2005.0,4,1,3
BN,PK,2019.0,1,2,-1
RO,IE,2010.0,4,1,3
UZ,TJ,2018.0,2,4,-2
SD,US,2019.0,7,16,-9
nan,BR,2002.0,8,14,-6
VE,CL,2022.0,5,5,0
CH,KE,2001.0,2,1,1
GA,NL,2014.0,1,4,-3
AM,GB,2016.0,2,2,0
IR,AZ,2013.0,3,8,-5
HR,CN,2009.0,2,2,0
PL,CL,2016.0,4,6,-2
UY,MX,2010.0,5,10,-5
ID,PA,2019.0,2,2,0
KR,RW,2022.0,2,1,1
MT,BR,2021.0,1,1,0
PA,CL,2018.0,4,4,0
AE,IR,2021.0,3,8,-5
PE,BE,2005.0,1,1,0
KE,CH,2003.0,1,1,0
VG,GB,2005.0,3,3,0
JP,SD,2017.0,1,2,-1
AL,IN,2016.0,1,3,-2
CH,CL,2005.0,4,4,0
IN,BY,2019.0,4,12,-8
AU,KH,2012.0,1,1,0
RU,ES,2003.0,5,9,-4
AL,GB,2006.0,1,1,0
NO,BG,2007.0,4,10,-6
IT,KR,2006.0,2,6,-4
LU,CA,2022.0,3,1,2
US,BM,2012.0,3,3,0
CV,BR,2014.0,2,1,1
JP,LY,2009.0,3,2,1
SE,BO,2012.0,3,1,2
CO,BE,1998.0,2,1,1
SE,PK,2000.0,1,1,0
QA,LB,2021.0,1,9,-8
KW,DE,2010.0,3,2,1
IS,ES,2007.0,2,1,1
IE,PA,2013.0,1,1,0
NO,NZ,2021.0,2,7,-5
IL,TZ,2014.0,1,1,0
FR,PA,2018.0,1,3,-2
EG,BR,2021.0,2,3,-1
PT,SA,2019.0,4,2,2
MY,FI,2012.0,2,3,-1
FR,VE,2005.0,3,6,-3
IN,BY,2017.0,6,13,-7
IR,NZ,2006.0,4,1,3
TW,BD,2016.0,1,2,-1
FR,GA,2007.0,3,4,-1
KR,QA,2008.0,2,1,1
SE,BD,2001.0,1,3,-2
DE,SD,2022.0,1,1,0
BG,CL,2003.0,1,1,0
ID,MX,2017.0,4,4,0
UG,GB,2001.0,3,1,2
CO,PA,2004.0,1,1,0
UY,DE,1997.0,1,3,-2
DK,SA,2016.0,1,1,0
AR,IL,2015.0,6,3,3
SI,NL,2003.0,3,2,1
DK,SG,2020.0,4,7,-3
BF,SN,2019.0,3,2,1
MZ,US,1998.0,2,1,1
PH,RU,2018.0,1,1,0
MK,DE,2020.0,2,3,-1
GH,JP,2000.0,2,1,1
IL,MY,2021.0,1,2,-1
CO,CH,2004.0,1,2,-1
TN,BE,2014.0,2,2,0
TH,FI,1998.0,1,1,0
AF,BR,2012.0,2,1,1
HR,SI,2004.0,4,4,0
CH,UA,2002.0,1,6,-5
SA,FI,2012.0,1,1,0
KR,KP,2015.0,3,1,2
GR,PL,2011.0,6,12,-6
CW,US,2018.0,1,1,0
ZM,NG,2016.0,1,1,0
MA,GA,2021.0,1,2,-1
IT,PY,2022.0,1,1,0
IN,DK,2002.0,2,9,-7
ID,MX,2019.0,2,10,-8
PS,BE,2013.0,2,4,-2
ZM,KE,2021.0,1,2,-1
UA,SE,2020.0,7,7,0
LT,MZ,2011.0,1,9,-8
GT,US,2000.0,2,2,0
CA,RS,2022.0,5,7,-2
MK,FR,2001.0,1,2,-1
BR,ID,2011.0,2,3,-1
QA,SG,2019.0,1,5,-4
FR,ID,1999.0,4,4,0
TW,JO,2018.0,2,1,1
KR,AT,2007.0,3,3,0
BD,TR,2018.0,3,1,2
HR,IE,2001.0,1,2,-1
AT,ID,2013.0,2,2,0
LT,FR,2014.0,1,5,-4
IN,GR,2005.0,2,4,-2
SE,TW,2012.0,3,3,0
PH,SK,2019.0,1,3,-2
BZ,US,2019.0,3,1,2
MZ,SE,2017.0,3,2,1
LU,BR,2018.0,3,5,-2
GR,NL,1998.0,5,5,0
SK,IL,2009.0,1,2,-1
RS,IE,2014.0,4,1,3
GB,TZ,2005.0,4,8,-4
TZ,SE,2011.0,6,5,1
TZ,BE,2009.0,2,1,1
UA,TR,2004.0,2,5,-3
CO,BE,1997.0,1,1,0
NO,SA,2000.0,2,1,1
MA,ES,2013.0,4,15,-11
IE,PK,2023.0,1,2,-1
PK,KW,2007.0,2,2,0
AR,PA,2020.0,3,2,1
CA,BG,2015.0,3,4,-1
HR,MX,2005.0,2,2,0
BY,CZ,2003.0,3,3,0
NZ,UA,2017.0,1,2,-1
DE,TH,2001.0,4,5,-1
MA,AM,2012.0,1,1,0
FR,BZ,2011.0,2,2,0
KE,MW,2012.0,1,3,-2
LI,DE,2007.0,1,5,-4
CO,nan,2007.0,2,4,-2
SG,CH,2004.0,4,4,0
AR,TW,2003.0,2,2,0
SN,GN,2020.0,2,4,-2
IN,BH,2005.0,2,1,1
PL,SG,2021.0,2,2,0
ET,nan,2018.0,3,1,2
BR,GH,2015.0,1,1,0
UG,NA,2015.0,1,1,0
JP,HR,2011.0,3,3,0
AR,CZ,2016.0,2,5,-3
IE,HU,2014.0,3,2,1
CH,CU,2013.0,1,1,0
ES,SI,2023.0,2,1,1
CN,IS,2020.0,1,1,0
FI,MX,2019.0,2,4,-2
KW,EG,1998.0,2,1,1
NO,IL,2021.0,2,4,-2
GB,CA,2012.0,868,870,-2
IN,AE,2011.0,31,14,17
KR,nan,2014.0,27,23,4
US,IN,2004.0,835,1059,-224
NP,US,2020.0,105,84,21
BD,KR,2014.0,25,22,3
SG,GB,2005.0,55,58,-3
FR,MA,2018.0,326,193,133
EG,SD,2018.0,20,50,-30
SK,SE,1999.0,3,2,1
GB,FR,2016.0,571,647,-76
CN,HK,2015.0,124,108,16
AR,CR,2008.0,11,7,4
US,PT,2020.0,197,206,-9
BR,ST,2015.0,27,45,-18
AR,MX,2000.0,16,25,-9
US,UG,2019.0,58,40,18
ES,CL,2000.0,80,54,26
MY,BD,2010.0,12,20,-8
nan,JP,2005.0,103,53,50
SE,FI,2009.0,109,71,38
nan,ES,2009.0,22,25,-3
NL,AU,2010.0,72,70,2
nan,NL,2019.0,77,77,0
JP,NZ,2020.0,15,14,1
BE,IT,2008.0,93,87,6
SD,GB,2018.0,12,7,5
BE,PE,2010.0,2,1,1
CN,PH,2013.0,22,21,1
DE,ID,2010.0,22,8,14
NO,ES,2010.0,22,24,-2
CZ,NZ,2020.0,3,1,2
SG,SE,2020.0,26,11,15
nan,CR,2013.0,7,1,6
TR,IQ,2020.0,29,13,16
TW,FR,2018.0,21,22,-1
PL,CZ,2009.0,29,29,0
IT,AT,2023.0,3,4,-1
GR,BE,2012.0,29,19,10
GB,MA,2015.0,9,5,4
EG,LY,2014.0,9,4,5
IN,CH,2016.0,64,54,10
EC,CR,2017.0,13,29,-16
CA,IL,2018.0,65,68,-3
FR,NG,2014.0,5,2,3
AU,FJ,2012.0,1,7,-6
MX,NL,2021.0,17,6,11
NP,AU,2013.0,6,5,1
RU,DE,2023.0,10,6,4
EC,US,2018.0,71,115,-44
NG,GB,2011.0,28,31,-3
SG,IN,2011.0,66,87,-21
GR,HU,2021.0,1,1,0
DE,RU,1997.0,86,77,9
US,RU,2018.0,637,527,110
FR,IT,2014.0,331,415,-84
DK,NO,2019.0,161,108,53
nan,NL,2017.0,98,76,22
IN,NL,2003.0,15,16,-1
NA,GB,2019.0,3,1,2
CH,IR,2010.0,9,21,-12
nan,AU,2010.0,32,46,-14
NG,US,1999.0,15,6,9
NO,ES,2019.0,27,37,-10
FR,IL,1997.0,20,14,6
KR,CH,2008.0,10,9,1
HN,PE,2019.0,4,2,2
EG,FI,2015.0,3,7,-4
IR,SG,2013.0,27,40,-13
IN,DK,2005.0,5,6,-1
JO,DE,2000.0,4,4,0
US,EC,2021.0,73,96,-23
IN,FI,2016.0,24,13,11
CZ,IT,2013.0,15,36,-21
CN,IE,2023.0,6,1,5
RU,CA,2022.0,28,18,10
LK,US,2021.0,20,24,-4
HU,CH,2009.0,24,6,18
CZ,SI,2011.0,6,9,-3
JP,PK,2017.0,10,13,-3
ID,SG,2012.0,4,7,-3
DE,GE,2001.0,3,2,1
FR,AT,1999.0,18,14,4
NG,FR,2019.0,8,8,0
FI,GB,2000.0,22,25,-3
TR,TW,2004.0,6,8,-2
NO,ES,2017.0,20,36,-16
FR,CO,2000.0,5,8,-3
CZ,IN,2013.0,15,22,-7
CH,IR,2017.0,21,31,-10
AU,MK,2003.0,11,7,4
US,PS,2008.0,5,7,-2
IN,OM,2013.0,21,12,9
PT,RU,2014.0,4,8,-4
MY,TW,2016.0,23,35,-12
JP,TN,2013.0,3,2,1
CH,LB,2016.0,3,7,-4
IT,IL,2009.0,15,6,9
PT,IR,2014.0,5,10,-5
ZA,AT,1998.0,3,1,2
SS,GB,1999.0,2,5,-3
MX,JP,2007.0,14,7,7
TW,SA,2012.0,4,1,3
IN,NZ,2009.0,14,15,-1
AR,DE,1998.0,7,10,-3
EG,PL,1997.0,1,1,0
SG,EG,2021.0,4,5,-1
AR,DE,1997.0,12,7,5
DK,IE,2002.0,2,3,-1
IL,CL,2014.0,1,3,-2
IN,BY,2010.0,4,1,3
TW,AR,2012.0,10,18,-8
NG,IT,2018.0,4,5,-1
FR,BD,2014.0,4,6,-2
TR,LB,2017.0,2,3,-1
FI,CA,2018.0,25,20,5
NL,ZA,2002.0,13,18,-5
PL,VN,2019.0,5,2,3
CZ,GH,2020.0,7,5,2
SI,DE,2007.0,5,6,-1
RU,MD,2002.0,3,1,2
TR,CH,2007.0,4,10,-6
CL,PT,2001.0,3,1,2
ZA,IT,2023.0,2,1,1
HU,JP,2016.0,10,7,3
IN,LB,2016.0,4,5,-1
JP,MM,2009.0,1,2,-1
EG,IT,2016.0,7,17,-10
HN,PE,2017.0,4,1,3
BE,PL,2013.0,18,15,3
CA,PA,2013.0,3,1,2
DE,SY,2011.0,6,2,4
AU,EC,2015.0,4,1,3
IL,IE,2016.0,5,3,2
CH,IT,2023.0,8,12,-4
SJ,NO,2004.0,1,6,-5
AR,SE,2008.0,1,8,-7
PE,MX,2007.0,24,41,-17
CO,HU,2021.0,2,1,1
GE,DE,2019.0,4,6,-2
BR,LB,2012.0,4,6,-2
ML,SN,2012.0,1,2,-1
MA,TN,1999.0,1,2,-1
BJ,BO,2008.0,2,1,1
NL,LB,2016.0,3,1,2
GE,RU,2004.0,3,3,0
MY,GR,2010.0,1,1,0
PK,KE,2011.0,5,6,-1
SE,BF,2012.0,4,1,3
KR,RU,1997.0,3,3,0
AU,BG,2009.0,2,1,1
FI,TR,2017.0,4,5,-1
BE,PA,2017.0,1,1,0
BF,US,2002.0,1,1,0
MX,BG,2007.0,1,2,-1
TN,AT,2020.0,1,1,0
BE,IL,2004.0,4,1,3
KG,KZ,2018.0,6,4,2
MD,CN,2009.0,2,1,1
GB,UY,2011.0,3,1,2
PS,GB,2014.0,1,6,-5
BR,LU,2011.0,5,3,2
BE,MD,2001.0,2,1,1
BF,SN,2017.0,3,6,-3
ES,TN,2004.0,2,1,1
KW,AE,2016.0,5,3,2
US,ME,2016.0,3,1,2
DE,ME,2019.0,2,1,1
SG,PK,2014.0,1,5,-4
DK,TW,2014.0,1,6,-5
VE,UY,2010.0,4,1,3
SV,MX,2007.0,2,1,1
UA,SG,2016.0,4,2,2
AE,SD,2009.0,1,1,0
IN,VG,2017.0,1,2,-1
GH,KR,2015.0,2,2,0
CG,CH,2021.0,2,4,-2
BY,SI,2015.0,1,2,-1
ZA,TR,2015.0,2,6,-4
PL,US,2016.0,262,272,-10
MA,IT,2018.0,26,40,-14
TN,DZ,2020.0,43,23,20
CH,IR,2019.0,19,45,-26
KH,US,2008.0,2,2,0
HU,BY,2015.0,2,1,1
PE,SV,2016.0,4,4,0
TR,IR,2008.0,7,1,6
FI,MX,2010.0,3,2,1
RO,EC,2022.0,1,1,0
MM,TW,2003.0,1,1,0
ET,US,2018.0,52,80,-28
NL,VN,2000.0,4,1,3
TR,,2019.0,5499,0,5499
,IR,2003.0,3202,0,3202
FR,,2024.0,87117,0,87117
NO,,2024.0,14663,0,14663
,BR,2001.0,10043,0,10043
,GB,2012.0,18135,0,18135
,FR,2003.0,14339,0,14339
BR,,2021.0,26391,0,26391
BE,ZW,2018.0,1,0,1
EE,,2025.0,107,0,107
JP,,2014.0,11434,0,11434
,DE,2014.0,19974,0,19974
CU,,2023.0,1924,0,1924
RU,,2003.0,2189,0,2189
,ID,2006.0,1871,0,1871
NG,,2021.0,3192,0,3192
,RS,2013.0,869,0,869
DE,,2008.0,8076,0,8076
,BE,2008.0,3424,0,3424
,RU,2015.0,16391,0,16391
AR,,2013.0,920,0,920
TR,,2010.0,1195,0,1195
,VN,2013.0,445,0,445
,BY,2011.0,333,0,333
DK,,2001.0,319,0,319
,IN,2018.0,24448,0,24448
,MX,2011.0,5260,0,5260
TR,,2017.0,4166,0,4166
LV,,2023.0,1266,0,1266
,SN,2012.0,173,0,173
PL,,2021.0,9280,0,9280
HK,,2015.0,89,0,89
,TH,2005.0,1501,0,1501
NL,VG,2011.0,1,0,1
IT,EC,2009.0,2,0,2
,IL,2006.0,2330,0,2330
KW,,2015.0,100,0,100
YE,,2016.0,37,0,37
,NP,2013.0,459,0,459
PT,,2015.0,832,0,832
BD,,2006.0,34,0,34
,PE,2018.0,1082,0,1082
,TH,2002.0,1021,0,1021
CZ,,2007.0,423,0,423
KZ,,2023.0,2221,0,2221
,RW,2010.0,62,0,62
MU,GB,2006.0,1,0,1
PG,PK,2000.0,1,0,1
,HR,2015.0,842,0,842
HU,,2000.0,227,0,227
,GR,2016.0,1982,0,1982
,CD,2009.0,56,0,56
,LB,2015.0,561,0,561
,GE,1999.0,145,0,145
,UY,2005.0,198,0,198
,QA,2012.0,293,0,293
,UY,2002.0,168,0,168
KR,BY,2010.0,1,0,1
MM,,2023.0,276,0,276
,FI,2018.0,1370,0,1370
,LK,2001.0,143,0,143
BY,,1999.0,41,0,41
IQ,,2012.0,35,0,35
LT,,2003.0,39,0,39
,MG,2014.0,74,0,74
,LU,2014.0,153,0,153
MA,MY,2023.0,1,0,1
KH,,2018.0,46,0,46
,TG,2014.0,80,0,80
SD,,2019.0,116,0,116
CD,,2021.0,202,0,202
CF,,2024.0,23,0,23
JM,,2023.0,207,0,207
,NI,2011.0,36,0,36
VE,MY,2008.0,1,0,1
UY,,2025.0,86,0,86
SY,SE,2018.0,1,0,1
,SV,2008.0,16,0,16
AO,,2018.0,9,0,9
,BH,2016.0,111,0,111
CY,,2014.0,64,0,64
VE,FI,2019.0,1,0,1
NL,MD,2020.0,1,0,1
BA,nan,2021.0,2,0,2
EG,BA,2017.0,4,0,4
JP,TZ,2023.0,1,0,1
NA,,2019.0,32,0,32
,FJ,1999.0,13,0,13
GE,NG,2020.0,1,0,1
,RW,2017.0,103,0,103
,MM,2012.0,26,0,26
AL,IR,2017.0,1,0,1
,GA,2016.0,43,0,43
SD,,2010.0,27,0,27
CI,,2012.0,33,0,33
,KN,2014.0,14,0,14
,MQ,2018.0,12,0,12
,SR,2018.0,15,0,15
,GF,2019.0,13,0,13
GH,,2020.0,290,0,290
CM,,2001.0,4,0,4
GE,EE,2016.0,2,0,2
,AM,2016.0,162,0,162
,GH,1995.0,102,0,102
LK,,1999.0,15,0,15
,CO,2020.0,70,0,70
IQ,CI,2019.0,1,0,1
,MO,1998.0,1,0,1
CO,,2007.0,140,0,140
MU,,2022.0,67,0,67
,JM,1999.0,48,0,48
MT,,2013.0,12,0,12
GD,,2017.0,13,0,13
AZ,PL,2003.0,9,0,9
PH,ID,2014.0,3,0,3
LA,,2014.0,5,0,5
SD,,2017.0,62,0,62
NA,GB,2017.0,2,0,2
FI,AL,2019.0,1,0,1
GD,,2019.0,19,0,19
QA,,2005.0,10,0,10
BA,GB,2006.0,1,0,1
ZA,OM,2022.0,1,0,1
PL,KR,2006.0,2,0,2
KR,NL,1998.0,4,0,4
SZ,,2022.0,28,0,28
TH,OM,2013.0,3,0,3
,RW,2019.0,66,0,66
DE,KW,2021.0,2,0,2
RO,,2004.0,91,0,91
UZ,CZ,2013.0,1,0,1
CR,DK,2007.0,1,0,1
PH,LS,2012.0,1,0,1
KW,KR,2011.0,2,0,2
DE,LA,2002.0,1,0,1
KH,SG,2019.0,4,0,4
ML,,2011.0,7,0,7
PA,PT,2013.0,1,0,1
SS,,2000.0,3,0,3
EG,GH,2005.0,1,0,1
BR,SD,2000.0,3,0,3
HU,CL,2018.0,1,0,1
AM,KZ,2020.0,4,0,4
GM,,2019.0,16,0,16
IQ,NZ,2021.0,2,0,2
PA,JP,2017.0,6,0,6
,WS,2017.0,4,0,4
,MV,2017.0,3,0,3
,VG,2016.0,5,0,5
VE,,1998.0,41,0,41
CA,EC,2010.0,2,0,2
CV,PT,2021.0,2,0,2
NG,NA,2019.0,2,0,2
DK,ET,2011.0,1,0,1
PH,GT,2014.0,1,0,1
MQ,,2015.0,14,0,14
GM,,2010.0,7,0,7
,PA,1999.0,31,0,31
PG,VE,2016.0,2,0,2
KZ,UZ,2008.0,1,0,1
GR,GE,2010.0,1,0,1
AL,FR,2011.0,1,0,1
,GM,1996.0,10,0,10
HT,NP,2018.0,3,0,3
NG,MW,2007.0,1,0,1
TH,ZA,1999.0,1,0,1
UG,,2009.0,23,0,23
,PF,1994.0,23,0,23
FR,AL,2010.0,2,0,2
CD,KE,2014.0,1,0,1
NA,,2017.0,19,0,19
UA,CL,2002.0,1,0,1
,GP,2011.0,27,0,27
VE,PT,2000.0,1,0,1
TW,EG,2005.0,1,0,1
AZ,JP,2021.0,1,0,1
HU,MY,2011.0,2,0,2
GB,CI,2021.0,1,0,1
TT,GB,2005.0,4,0,4
,BO,1995.0,23,0,23
CN,LB,2001.0,1,0,1
MA,NO,2009.0,3,0,3
DE,PA,2007.0,5,0,5
IR,PA,2013.0,1,0,1
ZW,,2002.0,15,0,15
KW,MY,2023.0,1,0,1
MK,SA,2014.0,1,0,1
GM,,2017.0,9,0,9
KR,NL,1997.0,1,0,1
KN,,2015.0,2,0,2
,CG,1999.0,12,0,12
NG,SZ,2013.0,1,0,1
NO,IR,2023.0,2,0,2
DK,LI,2006.0,1,0,1
SN,GM,2020.0,1,0,1
PA,AR,2002.0,1,0,1
HR,MX,2002.0,1,0,1
QA,,2002.0,5,0,5
nan,MD,2006.0,2,0,2
CF,GN,2007.0,1,0,1
ZW,,2005.0,24,0,24
,LI,2011.0,7,0,7
AU,UG,2007.0,1,0,1
HN,,2000.0,2,0,2
IQ,CN,2005.0,2,0,2
PS,,2011.0,20,0,20
MK,MU,2015.0,1,0,1
SD,NG,2015.0,4,0,4
OM,FR,2018.0,2,0,2
NE,DZ,2016.0,1,0,1
MR,MY,2014.0,1,0,1
UZ,DE,1999.0,1,0,1
BI,,2009.0,7,0,7
,GF,2010.0,15,0,15
BF,,2006.0,8,0,8
FO,,2015.0,4,0,4
YE,OM,2008.0,1,0,1
SZ,IN,2006.0,1,0,1
PF,US,2000.0,1,0,1
CO,LK,2015.0,1,0,1
AU,KW,2003.0,2,0,2
LV,CA,2002.0,2,0,2
BR,KR,2000.0,2,0,2
PY,,2000.0,8,0,8
TT,AU,2008.0,2,0,2
SY,TR,2017.0,1,0,1
JP,AE,2010.0,2,0,2
CI,BF,2022.0,3,0,3
DK,UG,2019.0,2,0,2
JO,EG,2004.0,4,0,4
CU,PH,2000.0,1,0,1
SL,AE,2022.0,1,0,1
TH,IR,2005.0,3,0,3
AO,CN,2014.0,2,0,2
FR,RS,2006.0,4,0,4
EC,CR,2010.0,2,0,2
NG,NA,2010.0,1,0,1
BY,HU,2018.0,2,0,2
GH,HU,2012.0,1,0,1
NG,CU,2014.0,2,0,2
CW,SK,2007.0,1,0,1
MC,GB,2015.0,1,0,1
UZ,AU,2005.0,1,0,1
nan,IQ,2014.0,2,0,2
US,MU,2023.0,1,0,1
IR,SD,2015.0,1,0,1
,GF,2017.0,10,0,10
NZ,PH,2022.0,3,0,3
BG,ZA,2005.0,1,0,1
UG,CM,2021.0,2,0,2
GR,LT,2005.0,2,0,2
SE,BJ,2016.0,1,0,1
PA,,2011.0,17,0,17
MK,CZ,1999.0,1,0,1
BY,UY,2022.0,3,0,3
TH,UG,2020.0,1,0,1
PA,TN,2017.0,1,0,1
ME,US,2014.0,1,0,1
PA,BD,2015.0,1,0,1
IR,BO,2022.0,2,0,2
MZ,KE,2008.0,1,0,1
,MV,2019.0,6,0,6
DK,TJ,2021.0,2,0,2
ZM,SE,2015.0,1,0,1
GE,TW,2001.0,1,0,1
GB,AL,2015.0,1,0,1
,RE,2000.0,21,0,21
UA,MQ,2018.0,1,0,1
IT,EE,2012.0,3,0,3
PS,AE,2006.0,2,0,2
PG,IN,2000.0,1,0,1
ES,TH,2021.0,3,0,3
CU,CA,1999.0,2,0,2
PT,nan,1998.0,5,0,5
nan,LU,2014.0,1,0,1
NC,,2003.0,2,0,2
PT,SA,2010.0,1,0,1
nan,MA,2012.0,4,0,4
JP,LI,2018.0,1,0,1
KP,RU,2019.0,1,0,1
MA,US,1998.0,1,0,1
CH,TW,1999.0,1,0,1
CY,SE,2008.0,1,0,1
PT,GT,2015.0,1,0,1
LT,nan,2004.0,1,0,1
SI,AZ,2008.0,5,0,5
CL,QA,2020.0,1,0,1
UG,AT,2009.0,1,0,1
AT,CY,2011.0,3,0,3
NO,MA,2022.0,1,0,1
SG,GH,2016.0,3,0,3
SV,AR,2003.0,2,0,2
IT,TH,1997.0,1,0,1
ZM,TR,2007.0,2,0,2
BW,CN,2006.0,1,0,1
BO,GB,2012.0,2,0,2
DK,AM,2003.0,1,0,1
SL,US,2012.0,3,0,3
FJ,US,1999.0,2,0,2
CY,KH,2020.0,1,0,1
nan,MC,1999.0,1,0,1
NA,,2010.0,8,0,8
AR,AO,2018.0,2,0,2
LB,MA,2011.0,1,0,1
GT,,2008.0,4,0,4
GH,MX,2020.0,1,0,1
CR,RU,2014.0,2,0,2
SN,MA,2011.0,2,0,2
DZ,MD,2008.0,8,0,8
CN,ME,2002.0,1,0,1
PK,SY,2022.0,2,0,2
SN,BJ,1998.0,1,0,1
GB,ML,2004.0,1,0,1
MV,,2021.0,1,0,1
HU,MK,2020.0,1,0,1
UG,BW,2012.0,1,0,1
BI,GB,2008.0,2,0,2
TR,GH,2018.0,3,0,3
LK,MY,2010.0,1,0,1
KE,PH,2020.0,1,0,1
,WS,2019.0,3,0,3
EC,NO,2020.0,1,0,1
GB,LU,1998.0,1,0,1
NO,MX,2005.0,3,0,3
DE,NA,2005.0,1,0,1
PT,NP,2018.0,1,0,1
BZ,US,2017.0,1,0,1
MX,IR,2013.0,1,0,1
SG,ET,2017.0,1,0,1
KW,DE,2019.0,3,0,3
,BI,2000.0,9,0,9
VN,CI,2022.0,1,0,1
MA,TR,2013.0,1,0,1
LR,GH,2020.0,1,0,1
UA,FI,2000.0,3,0,3
QA,CD,2016.0,1,0,1
RU,CR,2006.0,2,0,2
NG,TZ,2006.0,2,0,2
GN,BJ,2014.0,1,0,1
PA,GR,2011.0,1,0,1
PA,TZ,2012.0,1,0,1
LR,,2011.0,4,0,4
ME,XK,2014.0,1,0,1
PL,AZ,2008.0,2,0,2
BD,EG,2004.0,2,0,2
EG,IQ,2005.0,1,0,1
BF,GH,2015.0,1,0,1
BD,PH,2008.0,2,0,2
CL,SG,2011.0,1,0,1
VN,FI,2014.0,2,0,2
IT,NG,2001.0,1,0,1
IE,BW,2011.0,1,0,1
BB,GB,2021.0,1,0,1
LV,IE,2014.0,4,0,4
CO,MT,2016.0,2,0,2
VE,PS,2018.0,1,0,1
TZ,ET,2017.0,2,0,2
GB,PR,2000.0,2,0,2
PA,CO,2003.0,1,0,1
GE,IE,1998.0,1,0,1
UG,FR,2004.0,2,0,2
GE,BE,2014.0,1,0,1
MA,OM,2018.0,1,0,1
AL,SA,2018.0,1,0,1
LU,EG,2019.0,1,0,1
,GM,2004.0,5,0,5
RE,US,2021.0,3,0,3
ID,SY,2011.0,1,0,1
LY,EG,2023.0,1,0,1
VE,AR,1997.0,6,0,6
BG,CH,1999.0,4,0,4
UA,AZ,2001.0,1,0,1
LU,,1998.0,1,0,1
GR,ZM,2018.0,2,0,2
MM,TZ,2017.0,4,0,4
AL,BE,2018.0,2,0,2
DE,DO,2017.0,1,0,1
CA,UY,2007.0,1,0,1
FR,PS,2001.0,1,0,1
GR,GA,2017.0,1,0,1
GB,NI,2014.0,1,0,1
NG,BF,2017.0,2,0,2
VU,,2019.0,2,0,2
EG,CZ,2022.0,3,0,3
KR,UA,2022.0,2,0,2
VU,,2017.0,2,0,2
GR,UG,2019.0,2,0,2
TN,TR,2022.0,1,0,1
SS,IT,2019.0,2,0,2
NL,BT,2016.0,1,0,1
CM,PK,2011.0,1,0,1
JO,YE,2013.0,2,0,2
GR,AR,2015.0,3,0,3
PH,FR,1999.0,3,0,3
PL,VE,2004.0,1,0,1
NL,CR,2002.0,1,0,1
FR,LK,2022.0,2,0,2
HK,IT,2013.0,1,0,1
UY,PA,2014.0,1,0,1
MD,NG,2021.0,1,0,1
SI,BR,2007.0,1,0,1
AU,GE,2001.0,3,0,3
CH,LI,2003.0,1,0,1
nan,HN,2009.0,1,0,1
FI,IE,2005.0,3,0,3
SE,KZ,2018.0,1,0,1
MQ,RE,2013.0,1,0,1
GE,PH,2008.0,1,0,1
BR,CM,2012.0,1,0,1
RS,CL,2002.0,5,0,5
IL,MT,2021.0,1,0,1
ZW,KE,2006.0,3,0,3
JP,AE,2017.0,3,0,3
NP,TR,2015.0,1,0,1
PS,NO,2008.0,1,0,1
CU,AT,2020.0,1,0,1
PK,CG,2005.0,1,0,1
PS,OM,2008.0,1,0,1
ZA,SC,2020.0,1,0,1
LB,SG,2022.0,1,0,1
LU,KR,2021.0,1,0,1
,FM,2012.0,1,0,1
RO,SA,2020.0,1,0,1
AT,EC,2015.0,1,0,1
DE,TJ,2002.0,1,0,1
HU,VN,1999.0,2,0,2
MY,GR,2017.0,1,0,1
BE,RO,1997.0,3,0,3
KH,NO,2007.0,1,0,1
MY,MA,2008.0,1,0,1
BE,OM,2014.0,1,0,1
CZ,AE,2007.0,1,0,1
KR,KZ,2009.0,1,0,1
PL,MX,2001.0,2,0,2
AU,RE,2015.0,1,0,1
CA,JO,1999.0,1,0,1
BH,ET,2012.0,2,0,2
PL,ZM,2016.0,1,0,1
NG,BJ,2005.0,1,0,1
MZ,JP,2002.0,1,0,1
SG,LK,2005.0,1,0,1
GE,CA,1999.0,2,0,2
TM,,2008.0,1,0,1
GB,TZ,2002.0,3,0,3
FI,IR,2004.0,1,0,1
CR,UZ,2021.0,2,0,2
FR,RW,2009.0,1,0,1
CY,AU,2013.0,2,0,2
TW,YE,2017.0,2,0,2
LU,JP,2014.0,3,0,3
VE,UY,2017.0,3,0,3
FI,OM,2016.0,1,0,1
UA,SY,2019.0,1,0,1
JP,JM,2015.0,1,0,1
CA,MZ,2019.0,1,0,1
ET,BW,2022.0,3,0,3
KG,,2007.0,2,0,2
BE,MQ,2019.0,1,0,1
EC,NG,2021.0,1,0,1
CG,DE,2017.0,1,0,1
TH,AF,2021.0,1,0,1
UA,IN,2007.0,3,0,3
KY,CH,2021.0,1,0,1
BE,ML,2015.0,2,0,2
IN,IS,2011.0,1,0,1
HU,ZA,2006.0,3,0,3
SE,NI,2005.0,1,0,1
KR,UZ,1999.0,2,0,2
FR,MW,2002.0,1,0,1
BB,,2009.0,2,0,2
,HT,2007.0,4,0,4
CD,FR,2009.0,2,0,2
NZ,GR,2007.0,1,0,1
EG,AF,2021.0,1,0,1
XK,BE,2018.0,1,0,1
UA,CY,2012.0,1,0,1
PL,OM,2018.0,1,0,1
ZM,,1999.0,3,0,3
SY,DE,2008.0,2,0,2
GE,KR,2004.0,3,0,3
SI,DK,2008.0,1,0,1
TR,SI,2006.0,1,0,1
BO,,2000.0,4,0,4
PT,JO,2012.0,1,0,1
BE,PA,2019.0,3,0,3
KW,PK,2011.0,2,0,2
TN,IL,2018.0,1,0,1
FR,IQ,2010.0,2,0,2
NL,CR,2005.0,1,0,1
SK,MM,2022.0,2,0,2
IT,PS,2010.0,2,0,2
CO,ZW,2016.0,2,0,2
CA,CY,2007.0,4,0,4
MX,SY,2021.0,1,0,1
NL,JM,2007.0,1,0,1
GH,SE,2003.0,1,0,1
QA,LT,2021.0,1,0,1
TH,PE,2020.0,3,0,3
IE,TT,2000.0,1,0,1
KZ,JP,2004.0,1,0,1
SJ,,2012.0,2,0,2
ZA,EG,1999.0,1,0,1
MA,YE,2016.0,2,0,2
LV,CN,2005.0,1,0,1
,MV,2010.0,2,0,2
AO,PT,2001.0,1,0,1
CO,RU,1997.0,1,0,1
SL,IN,2016.0,2,0,2
BY,GR,2015.0,1,0,1
JO,IL,2018.0,1,0,1
EE,GB,2003.0,2,0,2
BR,IR,2002.0,2,0,2
AE,SS,2012.0,1,0,1
LB,IE,2022.0,2,0,2
PT,PH,2015.0,1,0,1
GT,CL,2006.0,1,0,1
PK,GE,2019.0,1,0,1
MZ,UG,2014.0,2,0,2
BR,AE,2006.0,1,0,1
EG,PE,2001.0,2,0,2
TT,NG,2015.0,1,0,1
TN,CD,2022.0,1,0,1
BR,LI,2010.0,1,0,1
GR,GE,2019.0,1,0,1
BR,NE,2018.0,2,0,2
CZ,SA,2012.0,2,0,2
PK,GE,2010.0,1,0,1
CH,PE,2008.0,1,0,1
BD,SD,2013.0,1,0,1
MK,PL,2021.0,1,0,1
NZ,UA,2019.0,1,0,1
CO,IL,2004.0,1,0,1
HN,PE,2010.0,1,0,1
VG,SA,2017.0,1,0,1
CY,PT,2005.0,1,0,1
GT,CH,2020.0,1,0,1
GT,RU,2020.0,1,0,1
MK,FJ,2021.0,1,0,1
MS,,2014.0,1,0,1
FJ,JP,2014.0,1,0,1
CR,CH,2014.0,2,0,2
TR,LB,2010.0,1,0,1
ZA,BN,2019.0,1,0,1
CG,CM,2018.0,1,0,1
SV,BR,2013.0,1,0,1
nan,TN,2003.0,1,0,1
BO,EC,2002.0,1,0,1
RO,ES,2023.0,1,0,1
AU,BD,2000.0,1,0,1
TH,MM,2003.0,1,0,1
CY,LB,2023.0,1,0,1
DE,BW,2014.0,1,0,1
PK,UG,2012.0,2,0,2
MY,MX,2016.0,2,0,2
PK,RS,2007.0,1,0,1
DK,ID,2014.0,2,0,2
ET,CO,2021.0,1,0,1
BH,RU,2016.0,1,0,1
MN,KZ,2012.0,1,0,1
OM,HR,2019.0,1,0,1
BO,AU,2003.0,1,0,1
BO,NI,2015.0,1,0,1
DE,BI,2004.0,2,0,2
CN,BI,2016.0,1,0,1
TR,ZA,2022.0,2,3,-1
TH,SE,2001.0,1,2,-1
IE,AT,2022.0,2,1,1
TW,QA,2017.0,2,1,1
AE,ZW,2003.0,2,1,1
ES,NI,2005.0,1,2,-1
AZ,CN,2009.0,1,1,0
SE,ZW,2001.0,1,1,0
EG,NZ,2013.0,1,2,-1
GE,CN,2015.0,4,3,1
RS,ES,1998.0,1,1,0
CL,SA,2018.0,1,1,0
CU,RU,2020.0,2,3,-1
DE,ME,2017.0,1,1,0
UY,VE,2003.0,1,3,-2
MZ,NL,2000.0,1,1,0
BE,NE,2017.0,1,2,-1
FI,IE,2002.0,1,1,0
MD,BR,2004.0,1,3,-2
PT,IE,2006.0,2,2,0
ZM,NZ,2006.0,1,1,0
VN,SE,2009.0,1,4,-3
ES,GT,2005.0,4,3,1
FI,TW,2021.0,2,1,1
BH,IN,2012.0,3,1,2
IE,NG,2015.0,2,2,0
CH,NZ,1997.0,4,3,1
ES,BG,1999.0,2,2,0
BE,RO,1998.0,2,2,0
BG,DK,2021.0,1,1,0
RO,SE,2006.0,5,2,3
CO,IE,2007.0,3,1,2
PA,AR,2005.0,1,2,-1
XK,SE,2022.0,1,1,0
PL,NZ,2022.0,2,3,-1
ZA,CR,2017.0,3,3,0
DZ,MA,2004.0,2,1,1
BR,UA,2008.0,1,5,-4
VE,PH,2020.0,2,2,0
CA,CZ,2000.0,2,5,-3
HU,TN,2017.0,1,1,0
UA,CL,2005.0,1,2,-1
TZ,CO,2020.0,1,1,0
QA,SG,2017.0,2,7,-5
EG,NL,2004.0,1,3,-2
FI,DZ,2021.0,1,1,0
SA,DK,2020.0,1,7,-6
PK,PL,2001.0,3,1,2
GP,JM,2022.0,1,1,0
CZ,ZA,2008.0,1,1,0
ZA,RU,2008.0,2,4,-2
RO,SI,2017.0,2,1,1
US,RW,2007.0,1,1,0
PT,HR,2011.0,2,2,0
PL,BY,2016.0,2,6,-4
UY,DE,1998.0,2,1,1
HR,JP,2009.0,1,3,-2
SE,UY,2014.0,1,3,-2
YE,IQ,2015.0,1,1,0
PE,AU,2021.0,1,4,-3
IT,MW,2015.0,1,1,0
CR,BO,2018.0,3,4,-1
EC,GB,2015.0,3,7,-4
IQ,SG,2022.0,1,1,0
GM,GH,2021.0,1,1,0
JP,KZ,2018.0,4,6,-2
TZ,ET,2019.0,1,1,0
VN,NZ,2012.0,1,1,0
RU,IS,2015.0,1,1,0
GB,SV,2013.0,2,1,1
IN,LY,2017.0,1,6,-5
HK,SE,2017.0,1,1,0
GR,PT,2005.0,3,1,2
FR,SY,2000.0,1,3,-2
CL,RO,2008.0,1,1,0
SE,PA,2016.0,1,4,-3
QA,IL,2014.0,1,1,0
SY,TR,2019.0,1,1,0
SI,JP,2018.0,2,3,-1
US,PG,1999.0,1,2,-1
RU,GR,2004.0,2,3,-1
BE,NP,2018.0,1,2,-1
SE,NG,2022.0,1,5,-4
CN,GN,2020.0,1,1,0
BA,RS,2004.0,1,4,-3
BY,VN,2007.0,1,3,-2
ZA,ZM,2013.0,1,2,-1
IT,NC,2010.0,1,1,0
EG,MX,2015.0,1,2,-1
CI,BE,1998.0,1,1,0
RS,JP,2002.0,2,4,-2
ZM,nan,2019.0,1,5,-4
JP,PR,2001.0,1,1,0
HK,KR,2016.0,1,3,-2
PE,BE,2002.0,1,1,0
DE,SI,1997.0,2,6,-4
MA,nan,2014.0,1,3,-2
nan,JO,2013.0,1,1,0
AE,BH,2018.0,2,3,-1
IL,NZ,2011.0,1,2,-1
ML,FR,2004.0,2,6,-4
FO,GB,2017.0,1,1,0
RE,CA,2013.0,1,1,0
LT,BE,2011.0,1,2,-1
JP,KE,2003.0,3,3,0
FI,SK,2011.0,1,7,-6
BR,SA,2012.0,1,2,-1
CL,NI,2009.0,2,3,-1
PT,CZ,2021.0,2,1,1
CH,SI,2007.0,2,5,-3
CN,PS,2018.0,1,1,0
ES,DZ,2009.0,2,2,0
TJ,RU,1998.0,1,3,-2
IR,JP,1999.0,1,8,-7
BH,SA,2003.0,1,1,0
BO,BR,2003.0,1,1,0
SN,BE,2020.0,1,3,-2
ES,UA,2009.0,1,2,-1
PK,NP,2009.0,1,1,0
PL,IR,2012.0,1,2,-1
TH,RU,2009.0,1,2,-1
FI,NG,2016.0,1,1,0
SK,DK,2018.0,1,1,0
GB,GD,2010.0,2,2,0
AR,AT,1998.0,1,2,-1
AT,ET,2021.0,1,2,-1
VN,TW,2007.0,1,1,0
SI,IE,2019.0,1,1,0
EG,BA,2019.0,1,1,0
EE,PK,2017.0,1,1,0
PG,US,2021.0,1,3,-2
KE,DK,2022.0,1,4,-3
TN,ES,2008.0,1,3,-2
LB,IR,2021.0,1,2,-1
MK,VN,2018.0,2,1,1
SA,CY,2019.0,1,1,0
PE,TR,2017.0,1,1,0
CZ,BR,2008.0,1,7,-6
PA,BR,2011.0,1,2,-1
BG,RO,2019.0,1,4,-3
IR,TZ,2016.0,1,1,0
TW,YE,2019.0,1,1,0
PL,VN,2010.0,3,1,2
IN,CW,2017.0,1,1,0
IQ,YE,2020.0,2,4,-2
UA,NO,2005.0,1,2,-1
NO,QA,2020.0,1,1,0
GD,ZA,2015.0,1,1,0
PT,MT,2019.0,1,1,0
AZ,ID,2004.0,1,1,0
PT,IN,2006.0,1,5,-4
VN,CZ,2004.0,1,1,0
IT,MC,2018.0,1,1,0
SY,BE,2007.0,1,1,0
FR,CR,2008.0,1,4,-3
KN,GB,2018.0,1,2,-1
AR,DO,2014.0,1,1,0
TZ,CA,2020.0,1,4,-3
AT,LT,2019.0,1,1,0
ID,IE,2014.0,1,2,-1
GH,TR,2019.0,2,1,1
VN,CH,2021.0,3,1,2
SK,AU,2022.0,1,1,0
HK,RS,2012.0,4,1,3
RO,IE,2019.0,3,1,2
PH,KE,2011.0,1,1,0
FR,SD,2018.0,2,1,1
IN,PL,1998.0,1,2,-1
GR,BR,2020.0,2,5,-3
EG,CH,2010.0,2,2,0
CR,EC,2003.0,1,1,0
UZ,UA,2005.0,1,2,-1
SE,LA,2013.0,1,1,0
IT,JO,2009.0,1,3,-2
PH,CR,2021.0,1,1,0
MY,CH,2010.0,1,1,0
BR,SK,2015.0,3,5,-2
NZ,CO,2012.0,2,1,1
IT,MA,1998.0,2,2,0
SY,LB,2009.0,1,3,-2
ZA,CZ,2011.0,1,3,-2
NG,nan,2015.0,1,6,-5
CL,PH,2010.0,1,3,-2
JO,IQ,2008.0,2,0,2
IT,GT,2017.0,3,0,3
ID,MX,2010.0,1,0,1
BE,KR,2023.0,1,0,1
ES,GP,2014.0,1,0,1
IL,KW,2017.0,1,0,1
US,SV,2012.0,1,0,1
ZA,AT,1997.0,1,0,1
KH,PH,2010.0,1,0,1
LT,NO,2022.0,2,0,2
LV,CH,2008.0,1,0,1
ET,PR,2011.0,2,0,2
TH,BG,2020.0,1,0,1
NO,KW,2016.0,1,0,1
ET,IQ,2015.0,1,0,1
AT,MA,2017.0,2,0,2
NO,SN,2002.0,1,0,1
PL,SK,2023.0,1,0,1
FI,YE,2022.0,1,0,1
OM,IE,2001.0,1,0,1
DE,PG,2007.0,1,0,1
YE,TR,2014.0,1,0,1
TT,GB,2002.0,1,0,1
CI,SN,2002.0,1,0,1
KW,JP,2000.0,1,0,1
BY,NO,2018.0,3,0,3
,FO,2020.0,1,0,1
BR,MT,2009.0,1,0,1
TH,MN,2019.0,1,0,1
KW,CY,2019.0,2,0,2
US,GP,1998.0,2,0,2
KG,TR,2013.0,2,0,2
BW,CM,2022.0,1,0,1
RS,NG,2019.0,1,0,1
NG,BF,2010.0,1,0,1
EG,PL,1998.0,1,0,1
CL,RU,2022.0,1,0,1
nan,UG,2013.0,2,0,2
SA,UY,2014.0,1,0,1
MW,SL,2015.0,1,0,1
VG,SA,2010.0,1,0,1
AR,AE,2020.0,1,0,1
BI,ZW,2000.0,1,0,1
SS,NZ,2011.0,1,0,1
LY,HU,2006.0,1,0,1
GR,CI,2017.0,2,0,2
MW,ML,2019.0,1,0,1
OM,NL,2016.0,2,0,2
GB,GD,2019.0,2,0,2
SN,NG,2001.0,1,0,1
VN,MY,1998.0,1,0,1
SR,,2015.0,2,0,2
BG,nan,2008.0,2,0,2
BE,BO,2000.0,1,0,1
TH,MX,2007.0,1,0,1
ZA,PK,2004.0,1,0,1
SG,SA,2001.0,1,0,1
CA,GT,2009.0,1,0,1
TW,LU,2005.0,1,0,1
UZ,IL,2017.0,1,0,1
CD,CM,2012.0,1,0,1
SY,AU,2023.0,1,0,1
UA,NO,2002.0,3,0,3
DE,DO,2010.0,1,0,1
PR,ES,2001.0,1,0,1
PT,DO,2021.0,2,0,2
SL,ZA,2002.0,1,0,1
MD,SN,2007.0,1,0,1
IR,TH,2009.0,1,0,1
BD,OM,2003.0,1,0,1
,GI,2013.0,3,0,3
JM,NO,2010.0,1,0,1
SI,IE,2010.0,1,0,1
FR,XK,2007.0,1,0,1
FJ,PK,2007.0,1,0,1
GD,,2010.0,3,0,3
MW,KR,2015.0,1,0,1
NL,MN,2017.0,1,0,1
VG,AU,2019.0,1,0,1
TN,CF,2016.0,1,0,1
IN,LI,2017.0,1,0,1
SL,ZA,2005.0,1,0,1
BM,,2020.0,1,0,1
AR,GR,2009.0,1,0,1
PS,EG,1998.0,1,0,1
JO,NG,2009.0,1,0,1
SC,GB,2011.0,1,0,1
ML,GM,2020.0,1,0,1
BJ,BI,2019.0,1,0,1
BY,KR,1997.0,1,0,1
SD,NL,2011.0,1,0,1
SA,NP,2014.0,1,0,1
TW,MM,2017.0,1,0,1
NG,CM,1998.0,3,0,3
RS,RO,2006.0,1,0,1
GM,IE,2011.0,1,0,1
BH,IR,2020.0,1,0,1
CA,TG,2018.0,1,0,1
SC,FR,2018.0,1,0,1
RW,CA,1997.0,1,0,1
TW,MM,2019.0,1,0,1
BI,PT,2014.0,1,0,1
PS,AU,2013.0,1,0,1
QA,LY,2014.0,1,0,1
ES,MM,2013.0,1,0,1
RW,,2001.0,1,0,1
AO,CL,2009.0,1,0,1
KR,GN,2014.0,1,0,1
AR,NZ,2001.0,2,0,2
UZ,UA,2002.0,1,0,1
CF,GA,2015.0,1,0,1
GB,MM,1999.0,1,0,1
FJ,SG,2012.0,1,0,1
AE,MX,2016.0,1,0,1
US,FO,2017.0,2,0,2
FO,GB,2019.0,1,0,1
CA,MD,2006.0,1,0,1
ES,AO,2004.0,1,0,1
DO,MX,2003.0,1,0,1
BN,,2009.0,2,0,2
NO,SS,2020.0,1,0,1
DE,LT,2023.0,1,0,1
LA,PH,2005.0,1,0,1
AL,ES,1998.0,1,0,1
CF,CM,2015.0,1,0,1
MK,BG,1998.0,1,0,1
MX,TR,2001.0,1,0,1
YE,IN,2000.0,1,0,1
,MO,1997.0,1,0,1
ST,nan,2012.0,1,0,1
NG,ES,2023.0,1,0,1
BE,NZ,2007.0,2,0,2
RO,AL,2009.0,1,0,1
TZ,TH,2020.0,1,0,1
IT,BF,2021.0,1,0,1
GQ,CU,2021.0,1,0,1
SK,GR,2009.0,2,0,2
HK,CH,2009.0,1,0,1
PT,PE,2010.0,1,0,1
IT,GH,2009.0,1,0,1
PY,PR,2022.0,1,0,1
ZM,ES,2005.0,1,0,1
YE,MY,2006.0,1,0,1
ES,NI,2002.0,1,0,1
MA,NG,2014.0,1,0,1
AT,IS,2020.0,1,0,1
NG,VN,2016.0,1,0,1
BR,DZ,2006.0,1,0,1
ID,CO,2014.0,1,0,1
RW,UG,2016.0,1,0,1
GB,SI,2023.0,1,0,1
CR,CZ,2014.0,1,0,1
ET,PS,2022.0,1,0,1
MG,JE,2006.0,1,0,1
NZ,CZ,2023.0,1,0,1
NO,SK,2023.0,1,0,1
BY,ES,2007.0,1,0,1
KE,RO,2014.0,2,0,2
DE,ML,2002.0,1,0,1
MA,LT,2021.0,1,0,1
DZ,JP,2001.0,1,0,1
SV,IT,2018.0,1,0,1
MY,IL,2006.0,1,0,1
KW,BD,2013.0,1,0,1
PH,LY,2013.0,1,0,1
NO,PA,2016.0,1,0,1
PR,SE,2001.0,1,0,1
GD,CN,2015.0,1,0,1
BW,AU,1999.0,1,0,1
BO,IR,2021.0,2,0,2
AT,MK,2000.0,1,0,1
AM,DK,2016.0,1,0,1
ES,PF,2012.0,1,0,1
BN,PL,2022.0,1,0,1
CD,IN,2010.0,1,0,1
AE,IQ,2002.0,1,0,1
SN,MG,1999.0,1,0,1
BE,MQ,2010.0,1,0,1
DZ,VG,2015.0,1,0,1
IR,VN,2007.0,1,0,1
KP,RU,2017.0,1,0,1
CM,ZM,2022.0,1,0,1
MK,BE,2016.0,1,0,1
AR,RE,2010.0,1,0,1
ZW,ZM,2002.0,1,0,1
CN,TN,2012.0,1,0,1
KE,CM,2011.0,1,0,1
CN,GD,2019.0,1,0,1
JE,MU,2005.0,1,0,1
NZ,UG,2001.0,1,0,1
LV,IN,2009.0,1,0,1
PR,VN,2013.0,2,0,2
IN,MR,2019.0,1,0,1
VE,IL,2018.0,1,0,1
PH,ZA,2007.0,1,0,1
GB,PY,2022.0,1,0,1
PE,IL,2008.0,1,0,1
JP,EE,2005.0,1,0,1
PH,SK,2017.0,1,0,1
EG,SK,2002.0,1,0,1
JE,NZ,2018.0,1,0,1
VG,SA,2019.0,1,0,1
OM,IS,2012.0,1,0,1
BE,KH,2002.0,1,0,1
UA,AM,2007.0,1,0,1
AU,PS,2016.0,1,0,1
NC,AR,2014.0,1,0,1
PL,ID,2015.0,1,0,1
LT,BG,2008.0,1,0,1
GB,LA,2006.0,1,0,1
ES,HU,2023.0,1,0,1
IE,MD,2015.0,1,0,1
PA,JP,2019.0,1,0,1
EE,ES,2005.0,1,0,1
IE,NP,2014.0,1,0,1
MA,ZA,2014.0,1,0,1
PW,JP,2008.0,1,0,1
PE,FI,2017.0,1,0,1
,GD,2020.0,1,0,1
JP,MZ,2018.0,1,0,1
NG,NA,2017.0,1,0,1
MY,EC,2015.0,1,0,1
US,CO,2005.0,124,91,33
IE,GB,2018.0,458,532,-74
US,IN,2014.0,2681,2108,573
CN,US,2015.0,5101,5701,-600
KR,DE,2012.0,51,42,9
IN,PK,2019.0,510,395,115
IN,US,2009.0,1678,1579,99
AU,US,2003.0,1250,1324,-74
GB,NZ,2003.0,175,139,36
BR,ES,2011.0,274,307,-33
CH,AT,2017.0,110,126,-16
GB,DE,2008.0,608,815,-207
CN,TW,2008.0,702,1098,-396
DE,CH,2018.0,1052,890,162
DE,LB,2020.0,5,7,-2
MX,ES,2019.0,1089,988,101
US,BR,2011.0,995,936,59
KR,JP,2009.0,262,348,-86
US,RU,2019.0,718,572,146
CA,FR,2010.0,486,536,-50
MY,US,2017.0,174,205,-31
DE,GB,2013.0,874,917,-43
PT,BR,2002.0,216,227,-11
US,FR,2008.0,1286,1291,-5
IT,JP,2009.0,64,49,15
GB,MT,2020.0,22,10,12
US,KR,2021.0,1100,988,112
GE,US,2001.0,69,83,-14
US,AU,2006.0,1743,1510,233
IT,BE,2006.0,83,56,27
GB,MY,2015.0,183,99,84
ES,US,2003.0,525,526,-1
CN,VN,2019.0,50,23,27
NZ,CN,2017.0,52,65,-13
US,CO,2002.0,52,81,-29
US,BE,2009.0,261,241,20
EG,SA,2015.0,329,320,9
AU,SG,2015.0,115,129,-14
HU,nan,2017.0,7,6,1
DE,BE,2007.0,105,77,28
VN,JP,2011.0,21,41,-20
CA,IL,2010.0,40,72,-32
CH,AU,2019.0,123,92,31
EG,KW,2016.0,22,36,-14
IN,GB,2012.0,339,443,-104
BR,GB,2016.0,232,194,38
LB,US,1998.0,4,6,-2
AU,GB,2011.0,1168,1381,-213
IT,GB,2021.0,445,523,-78
PT,BR,2005.0,311,333,-22
NL,DE,2018.0,436,454,-18
MX,ES,2010.0,603,558,45
CN,VN,2017.0,29,11,18
JP,IT,2015.0,77,67,10
US,AR,2015.0,280,215,65
BD,CN,2013.0,84,77,7
NP,IN,2019.0,201,154,47
BA,RS,2014.0,33,23,10
DE,EG,2020.0,58,66,-8
FI,GB,2023.0,6,5,1
US,MX,2012.0,343,359,-16
CL,JP,2000.0,1,2,-1
CA,CN,2008.0,453,358,95
EG,SD,2017.0,26,29,-3
MX,ES,2017.0,880,997,-117
IT,IN,2022.0,31,70,-39
GB,SA,2015.0,137,61,76
IN,DE,1998.0,54,42,12
AE,CA,2020.0,24,33,-9
ID,TW,2020.0,94,60,34
LU,BR,2019.0,5,2,3
CA,IL,2017.0,57,90,-33
CZ,KR,2020.0,8,11,-3
DK,CN,2009.0,30,28,2
AU,MY,2013.0,116,105,11
TR,AG,2020.0,331,133,198
JP,GB,2020.0,230,282,-52
GB,BD,2021.0,45,43,2
AR,CL,2015.0,92,89,3
CA,IN,2021.0,176,211,-35
TW,IN,2017.0,43,65,-22
MX,GB,1999.0,18,23,-5
AU,CN,2012.0,314,348,-34
CA,DK,2010.0,33,20,13
SJ,US,2015.0,2,3,-1
BE,US,2012.0,276,390,-114
CN,SG,2012.0,414,401,13
FR,MA,2010.0,236,251,-15
IT,CA,2012.0,91,76,15
SG,CN,2013.0,426,425,1
MG,SN,2017.0,1,1,0
CZ,IE,2015.0,6,9,-3
AR,BR,2001.0,32,40,-8
MD,FR,2013.0,64,41,23
US,CH,2009.0,681,641,40
CH,GB,2011.0,250,284,-34
CL,AR,2017.0,104,119,-15
CL,AR,2019.0,140,147,-7
US,RU,2017.0,701,485,216
nan,NL,2018.0,68,97,-29
PT,MX,2021.0,18,16,2
FR,CH,2018.0,512,402,110
UZ,JP,2007.0,3,3,0
CA,FR,2017.0,538,657,-119
BR,CA,2005.0,174,121,53
CA,IT,2021.0,108,107,1
AU,NL,2013.0,66,91,-25
FR,IT,2004.0,194,206,-12
AR,CR,2013.0,15,5,10
US,TR,2004.0,266,243,23
EC,US,2019.0,109,116,-7
TR,SG,2010.0,4,1,3
AR,CO,2005.0,35,22,13
DE,SA,2011.0,22,7,15
NZ,CN,2019.0,77,68,9
CN,NZ,2021.0,59,74,-15
ES,IE,2016.0,41,25,16
US,SA,2014.0,215,124,91
FR,RU,2010.0,58,71,-13
IE,IT,2016.0,25,42,-17
CA,JP,2011.0,92,100,-8
IN,PK,2010.0,104,100,4
DE,JP,2003.0,133,172,-39
CH,RU,2018.0,41,39,2
CA,DK,2019.0,41,54,-13
ES,MX,2023.0,25,12,13
JP,BR,2016.0,72,44,28
BR,CA,2002.0,117,89,28
CL,CA,2022.0,25,5,20
NL,US,2003.0,421,467,-46
CN,BE,2019.0,62,62,0
KR,PR,2014.0,38,30,8
IT,FR,2016.0,457,342,115
JP,SG,2019.0,42,41,1
SG,CA,2013.0,33,42,-9
FR,CG,2007.0,9,14,-5
AR,ES,2021.0,354,288,66
KR,CN,2005.0,251,163,88
NZ,AU,2004.0,97,86,11
FR,RO,2000.0,19,13,6
NP,IN,2010.0,60,34,26
FR,RU,2019.0,84,93,-9
AU,FR,2009.0,93,123,-30
IT,PS,2018.0,3,1,2
FR,EG,2013.0,32,18,14
VE,ES,2021.0,43,22,21
FR,IQ,2018.0,14,2,12
DE,MT,2021.0,1,1,0
CH,AT,2010.0,77,81,-4
LB,BR,2018.0,8,7,1
SK,FR,2011.0,10,5,5
TH,CN,2011.0,14,6,8
PE,ES,2016.0,155,128,27
GR,CN,2009.0,21,23,-2
TR,CN,2007.0,11,3,8
IL,CN,2009.0,28,22,6
CN,NO,2009.0,38,25,13
FI,TR,2018.0,4,9,-5
CN,VN,2010.0,25,30,-5
FR,TG,2007.0,3,1,2
ES,IT,2014.0,291,251,40
SA,SD,2015.0,18,20,-2
DE,nan,2012.0,64,82,-18
GB,GR,2019.0,236,271,-35
CL,GB,2012.0,31,38,-7
EG,PK,2017.0,19,19,0
nan,AU,2018.0,30,48,-18
US,IL,2018.0,537,653,-116
DE,ID,2018.0,52,39,13
JP,MX,2014.0,13,8,5
CH,NL,2020.0,122,155,-33
TW,GB,2020.0,52,61,-9
RU,QA,2014.0,2,3,-1
CL,AR,2010.0,79,51,28
PH,NP,2020.0,10,5,5
DE,PL,2016.0,169,137,32
CN,CD,2017.0,4,1,3
NL,TR,2015.0,41,24,17
MX,CU,2006.0,24,26,-2
AT,NL,2001.0,13,10,3
KW,SA,2015.0,16,15,1
GB,SE,2006.0,119,135,-16
GB,MX,2007.0,52,28,24
RU,CA,2016.0,29,46,-17
MY,US,2010.0,69,132,-63
IQ,IE,2012.0,2,1,1
FR,MA,2019.0,304,238,66
EG,IT,2022.0,8,2,6
FR,TH,2010.0,17,11,6
SV,ES,2010.0,5,4,1
CA,SE,2014.0,55,58,-3
FI,SE,2020.0,104,101,3
SE,US,2023.0,11,18,-7
FR,SN,2015.0,38,39,-1
CZ,IT,2008.0,24,27,-3
CA,SK,2004.0,8,4,4
IT,IE,2016.0,42,25,17
US,MK,2007.0,4,4,0
EC,US,2017.0,55,95,-40
CA,IE,2009.0,130,118,12
TR,TW,2014.0,6,2,4
BR,FR,2016.0,211,243,-32
IN,PK,2017.0,343,300,43
DZ,CA,2021.0,13,8,5
RE,FR,2018.0,55,54,1
JP,TR,2001.0,45,29,16
BE,IR,2013.0,17,22,-5
NL,BE,2022.0,166,174,-8
NZ,CH,2016.0,16,17,-1
ZA,SA,2012.0,4,3,1
RU,ES,2001.0,11,7,4
CA,AT,2016.0,39,32,7
TH,US,2020.0,124,208,-84
DK,SE,2008.0,85,128,-43
IT,ZA,2017.0,27,18,9
MD,MA,2000.0,9,4,5
NO,DE,2017.0,85,120,-35
IT,ZA,2019.0,36,17,19
IN,DE,1997.0,40,29,11
BG,RU,2012.0,24,26,-2
CA,ZA,2002.0,10,18,-8
GB,GR,2017.0,172,323,-151
MX,PE,2001.0,8,16,-8
UY,ES,2018.0,46,84,-38
PL,GB,2014.0,95,83,12
UA,CZ,2009.0,25,7,18
DK,CH,2019.0,62,58,4
TH,GB,2007.0,28,41,-13
IN,IT,2004.0,52,28,24
US,CL,2006.0,110,110,0
IR,CN,2011.0,33,19,14
FI,US,2008.0,102,187,-85
CL,SA,2017.0,2,1,1
NZ,CA,1997.0,20,22,-2
SD,SA,2016.0,40,17,23
CH,NO,2007.0,18,5,13
MY,BD,2018.0,69,55,14
CZ,CO,2019.0,2,4,-2
CZ,EG,2011.0,3,4,-1
NL,AU,2018.0,120,126,-6
NG,ZA,2015.0,62,64,-2
EG,PK,2019.0,26,18,8
EG,OM,2013.0,6,7,-1
NO,RU,2018.0,21,13,8
DK,BE,1999.0,5,9,-4
FR,RU,2017.0,110,80,30
MY,DE,2016.0,21,19,2
MG,US,2010.0,4,4,0
CL,NL,2021.0,13,5,8
CH,AU,2017.0,86,88,-2
CN,HU,2020.0,13,4,9
FR,TW,2004.0,14,11,3
NE,FR,2018.0,28,30,-2
FI,FR,2011.0,24,24,0
NL,CH,2011.0,88,65,23
BH,US,2017.0,14,10,4
PT,IT,2020.0,49,43,6
US,VE,2020.0,24,46,-22
EG,SD,2019.0,28,39,-11
JP,SG,2010.0,39,36,3
BE,AR,2020.0,10,10,0
FR,NL,2022.0,72,65,7
JO,EG,2014.0,18,5,13
JP,PH,2022.0,12,8,4
CN,BE,2010.0,72,52,20
US,JO,2015.0,57,44,13
CO,FR,2003.0,11,4,7
MY,TW,2022.0,14,33,-19
TW,IN,2019.0,55,79,-24
TR,PK,2021.0,12,11,1
FR,EE,2017.0,12,7,5
NZ,DE,2020.0,49,43,6
FI,NO,2003.0,6,9,-3
MX,DK,2007.0,2,4,-2
JP,TW,2020.0,73,89,-16
EG,LB,2021.0,16,31,-15
TW,MY,2021.0,22,17,5
SD,US,2018.0,12,7,5
EG,CH,2018.0,7,8,-1
NL,QA,2020.0,7,5,2
CO,BO,2022.0,10,3,7
IR,AT,2020.0,28,16,12
US,SO,2021.0,2,1,1
BH,GH,2019.0,21,29,-8
US,KZ,2021.0,19,13,6
JP,DE,2013.0,197,176,21
CU,MX,2018.0,94,62,32
AE,PK,2009.0,4,5,-1
CH,AT,2019.0,145,145,0
EG,BD,2010.0,4,3,1
JP,IE,2018.0,24,39,-15
SE,CH,2009.0,47,37,10
HR,GB,2001.0,6,7,-1
IT,CN,2018.0,51,38,13
CN,TH,2015.0,18,25,-7
HR,US,2012.0,55,38,17
ES,CU,2001.0,36,48,-12
CA,IL,2019.0,73,47,26
GB,PT,2011.0,94,66,28
IR,NO,2021.0,29,7,22
BH,GH,2017.0,15,25,-10
GB,BE,2005.0,82,79,3
NL,PT,2018.0,23,24,-1
AR,US,2007.0,205,174,31
GB,IE,2009.0,313,259,54
KR,ES,2015.0,10,9,1
MY,US,2019.0,221,185,36
AU,IR,2018.0,89,178,-89
TW,FR,2010.0,18,14,4
FR,SE,2017.0,100,71,29
FR,TN,2001.0,38,24,14
AU,BR,2016.0,134,142,-8
ES,PA,2004.0,9,6,3
RU,SK,2022.0,29,9,20
AU,QA,2015.0,14,19,-5
UG,GB,2003.0,4,6,-2
JP,AT,2003.0,15,5,10
NL,BR,2016.0,57,54,3
HU,nan,2010.0,4,1,3
CA,PL,2020.0,34,26,8
DE,UY,2011.0,4,1,3
GB,GR,2010.0,169,181,-12
GH,ZA,2019.0,22,17,5
SD,BR,2015.0,9,7,2
CH,AU,2010.0,75,58,17
CL,CH,2015.0,18,13,5
MD,US,2013.0,7,3,4
BE,PL,2008.0,7,17,-10
PS,US,2016.0,4,16,-12
HK,JP,2002.0,12,1,11
HK,JP,2005.0,12,3,9
TR,DE,2009.0,59,42,17
DK,CH,2017.0,39,46,-7
US,ET,1998.0,9,2,7
IN,ID,2011.0,11,3,8
CL,DE,2015.0,44,69,-25
AZ,TR,2000.0,2,4,-2
EG,PK,2010.0,2,4,-2
ES,BO,2011.0,9,8,1
CN,BW,2014.0,3,1,2
GR,IN,2017.0,6,4,2
CZ,UA,2021.0,19,20,-1
UA,PL,2012.0,14,16,-2
HU,IE,2008.0,2,3,-1
BW,ZA,2012.0,14,15,-1
NL,FI,2013.0,40,36,4
UY,US,2003.0,13,8,5
CA,OM,2013.0,12,6,6
IL,CO,2015.0,3,4,-1
LK,ES,2018.0,2,3,-1
RU,PL,2013.0,35,25,10
MY,PS,2021.0,8,2,6
EC,AR,2015.0,17,36,-19
ZA,CR,2018.0,2,2,0
VE,IT,2017.0,7,4,3
CA,ZA,2005.0,15,27,-12
US,FJ,2020.0,7,8,-1
KR,PH,2007.0,2,3,-1
GB,CZ,2020.0,49,47,2
IR,CH,2014.0,24,18,6
CH,DK,2021.0,47,36,11
NO,DE,2019.0,100,124,-24
PA,ES,2012.0,8,10,-2
PH,CA,2015.0,7,11,-4
BD,GB,2023.0,5,2,3
FI,CA,2017.0,21,20,1
IN,CO,2014.0,3,5,-2
RO,IE,2018.0,3,3,0
SE,MY,2017.0,9,7,2
JP,SG,2017.0,39,62,-23
BR,VE,2020.0,20,30,-10
PL,SI,2016.0,3,5,-2
FR,IN,2006.0,46,95,-49
ES,HN,2017.0,11,5,6
ID,IR,2015.0,5,11,-6
DK,BR,2016.0,18,30,-12
EG,JP,2015.0,40,63,-23
IN,NL,2001.0,12,7,5
HU,DK,2019.0,8,5,3
KR,NP,2009.0,3,4,-1
JP,LK,2005.0,13,8,5
CH,nan,2011.0,11,12,-1
SK,CH,2020.0,7,9,-2
FI,IR,2014.0,5,9,-4
CA,TH,2016.0,13,8,5
PL,IN,2014.0,16,12,4
nan,PT,2007.0,18,25,-7
RU,CN,2003.0,26,23,3
HU,ES,2008.0,6,3,3
BH,GB,2002.0,3,1,2
VE,CL,2016.0,28,21,7
RU,FR,2000.0,36,43,-7
MG,US,2017.0,6,3,3
DE,RO,2013.0,44,30,14
PT,RO,2013.0,4,4,0
MA,IT,2017.0,21,43,-22
GB,HU,2022.0,31,27,4
ET,KR,2009.0,112,111,1
DE,EE,2006.0,30,19,11
TW,IN,2010.0,25,40,-15
PT,CH,2002.0,6,7,-1
GA,FR,2001.0,6,4,2
IN,FR,2001.0,49,132,-83
PK,AR,2011.0,14,15,-1
CO,IT,2012.0,15,15,0
KE,TZ,2009.0,3,3,0
IQ,ID,2017.0,3,7,-4
BY,IT,2006.0,1,1,0
NO,DE,2010.0,52,81,-29
NO,CZ,2022.0,2,3,-1
SG,TR,2017.0,9,4,5
EG,BA,2018.0,2,1,1
IQ,ID,2019.0,11,11,0
GB,BE,2002.0,54,67,-13
SI,JP,2017.0,4,3,1
IR,BR,2020.0,8,7,1
IN,KE,2018.0,9,7,2
SY,FR,2020.0,7,8,-1
NG,NZ,2020.0,7,4,3
IN,PT,2022.0,8,6,2
NO,ES,2018.0,24,35,-11
FR,LU,2003.0,12,9,3
CO,CH,2014.0,8,7,1
FR,VN,2006.0,13,5,8
FR,SK,2010.0,8,7,1
MY,KE,2020.0,3,3,0
CO,PA,2014.0,12,8,4
NL,EG,2002.0,3,1,2
nan,BE,2006.0,39,24,15
DE,KR,1999.0,16,14,2
BJ,IT,2020.0,1,2,-1
NZ,LK,2021.0,5,3,2
CH,RS,2020.0,10,10,0
JP,IR,2011.0,19,14,5
LV,DE,2020.0,4,4,0
US,UG,2018.0,35,32,3
FR,TH,2017.0,19,12,7
IQ,AE,2020.0,16,22,-6
SG,AE,2021.0,5,4,1
CA,PK,2014.0,40,29,11
GR,IE,2022.0,3,5,-2
FR,SK,2019.0,8,5,3
PE,FR,2018.0,16,17,-1
EG,SD,2010.0,9,3,6
LU,BR,2017.0,5,1,4
ID,SA,2018.0,17,37,-20
CH,FI,2002.0,8,10,-2
QA,FR,2021.0,6,11,-5
IN,CH,2022.0,32,35,-3
PH,RU,2017.0,5,2,3
PK,BD,2020.0,46,58,-12
US,EG,2006.0,109,75,34
JP,NO,2011.0,16,4,12
HR,SI,2014.0,27,24,3
KE,DK,2016.0,2,10,-8
PG,AU,2007.0,7,2,5
CA,RO,2007.0,10,4,6
AU,SE,2003.0,25,34,-9
CO,AG,2019.0,11,13,-2
FR,EE,2019.0,9,8,1
TR,JP,2009.0,35,27,8
HU,DK,2010.0,2,1,1
CN,NG,1999.0,2,1,1
FR,SE,2010.0,56,69,-13
DK,US,2006.0,188,206,-18
AU,FI,2004.0,7,6,1
IE,MY,2020.0,10,4,6
FR,CZ,2006.0,28,27,1
HU,AU,2011.0,21,8,13
ES,BE,2007.0,33,27,6
FR,SE,2019.0,103,83,20
UG,BE,2010.0,4,7,-3
MK,US,2002.0,5,3,2
JP,SE,1998.0,29,27,2
IL,TR,2002.0,4,1,3
RO,HU,2022.0,20,84,-64
NO,EE,2016.0,2,1,1
SG,CH,2014.0,23,19,4
RO,US,1998.0,26,16,10
ZW,ZA,2012.0,24,9,15
EE,CZ,2015.0,5,2,3
SI,AT,2020.0,11,9,2
BE,AU,2011.0,40,29,11
FR,ZA,2005.0,13,11,2
HU,TR,2019.0,9,10,-1
ET,IT,2006.0,2,5,-3
UY,MX,2018.0,20,20,0
CH,IT,2000.0,98,110,-12
BD,JP,2001.0,9,16,-7
US,KE,2022.0,33,41,-8
DE,TN,2014.0,7,4,3
MY,IT,2009.0,32,30,2
RS,BA,2013.0,35,31,4
CL,UY,2005.0,7,5,2
VE,UY,2018.0,4,1,3
AR,SE,2013.0,12,4,8
GB,RO,2012.0,30,37,-7
GM,GB,2014.0,7,11,-4
ES,IL,2018.0,17,18,-1
US,ZM,2009.0,10,6,4
RU,BY,2012.0,60,77,-17
US,SI,2006.0,16,17,-1
EE,RU,2020.0,11,10,1
HU,DK,2017.0,9,4,5
PT,DE,2007.0,18,38,-20
NG,IE,2014.0,3,1,2
BE,IN,2011.0,20,30,-10
PK,MY,2006.0,6,6,0
SI,GB,1999.0,6,2,4
MX,CL,2000.0,38,18,20
NO,IS,2007.0,6,4,2
PL,NO,2001.0,8,2,6
JP,KZ,2019.0,5,2,3
AT,FR,2006.0,27,26,1
FR,BJ,2006.0,22,16,6
ZA,IL,2006.0,4,3,1
ES,TR,2011.0,7,9,-2
ES,TN,2014.0,7,3,4
SE,DK,1999.0,38,33,5
RS,CN,2015.0,4,10,-6
TW,FR,2017.0,16,17,-1
BY,CZ,2001.0,3,6,-3
LB,US,1997.0,1,5,-4
RO,NL,2012.0,11,11,0
CH,ID,2015.0,5,3,2
RO,TR,2005.0,3,1,2
PT,SE,2018.0,17,10,7
MX,PT,2011.0,17,15,2
nan,GE,2008.0,4,3,1
ET,CH,2020.0,4,5,-1
AU,TW,2015.0,40,51,-11
PE,PY,2020.0,5,6,-1
IN,SY,2015.0,1,1,0
BE,PT,2006.0,10,7,3
JP,RO,2020.0,1,5,-4
CR,PE,2021.0,7,8,-1
RO,CN,2018.0,6,4,2
MK,GR,2007.0,7,6,1
CY,KR,2011.0,1,1,0
US,ID,2003.0,22,15,7
ZW,RU,2018.0,17,16,1
BE,KR,2000.0,1,2,-1
ID,LK,2018.0,7,13,-6
AU,IT,1998.0,12,15,-3
RU,IL,2009.0,23,14,9
BR,RU,1999.0,6,7,-1
US,EE,2016.0,11,16,-5
ES,IN,2000.0,6,3,3
PT,FR,1997.0,7,9,-2
FI,MX,2018.0,3,2,1
IR,MY,2022.0,20,25,-5
CA,FI,2005.0,15,25,-10
BH,US,2010.0,12,10,2
DE,UG,2012.0,1,1,0
CN,PH,2008.0,11,28,-17
NI,US,2022.0,2,4,-2
CH,BR,2006.0,27,17,10
IN,ML,2011.0,3,5,-2
CN,BE,2017.0,64,71,-7
UG,BE,2017.0,16,16,0
KW,IN,2008.0,10,8,2
ID,KW,2015.0,1,3,-2
BR,AR,1998.0,22,30,-8
TR,NO,2014.0,9,7,2
FI,NZ,2016.0,6,4,2
KR,QA,2013.0,2,3,-1
PS,ES,2015.0,15,12,3
ID,AT,2016.0,2,13,-11
FI,ES,2009.0,20,16,4
GP,GF,2013.0,2,3,-1
CH,KR,2012.0,12,9,3
QA,TN,2011.0,1,1,0
NA,ZA,2015.0,6,8,-2
PT,AU,2021.0,19,14,5
AT,CZ,2009.0,13,14,-1
PA,CL,2019.0,10,12,-2
JP,CL,2012.0,8,3,5
SK,GB,2003.0,21,11,10
JP,PT,2006.0,5,4,1
JP,ES,2011.0,32,37,-5
IT,ZA,2010.0,10,9,1
ZA,ZW,2012.0,9,24,-15
ET,IN,2014.0,8,27,-19
BD,KW,2003.0,2,1,1
UG,ZA,2019.0,14,16,-2
BE,CD,2016.0,12,5,7
TR,GR,2013.0,5,5,0
UG,ZA,2010.0,5,4,1
SK,RU,2007.0,7,3,4
SE,BR,2013.0,21,22,-1
EG,ET,2021.0,16,8,8
PL,UA,2009.0,10,15,-5
NZ,PH,2016.0,2,1,1
FR,TH,2019.0,20,16,4
ZA,ET,2022.0,9,7,2
TN,CH,2000.0,3,2,1
AU,ET,2015.0,6,5,1
IN,AT,2007.0,15,4,11
RS,SI,2009.0,8,10,-2
XK,PL,2013.0,1,3,-2
ET,US,2010.0,28,24,4
NL,CW,2014.0,15,18,-3
FI,CO,2019.0,2,3,-1
ES,AO,2014.0,3,2,1
CA,KW,2019.0,16,8,8
KW,AE,2022.0,3,1,2
CO,BR,1997.0,4,1,3
MT,AU,2020.0,2,5,-3
CZ,GR,2008.0,3,3,0
PT,PE,2018.0,4,5,-1
NG,PL,2021.0,4,2,2
EC,KR,2019.0,3,1,2
TH,JP,1998.0,9,15,-6
QA,SG,2018.0,4,1,3
BE,CH,2014.0,68,65,3
PL,RU,2000.0,11,22,-11
KG,KZ,2017.0,3,2,1
CA,TR,2007.0,13,17,-4
GR,MK,2007.0,6,7,-1
OM,GB,2005.0,6,3,3
PL,IE,2021.0,4,5,-1
PL,FR,2004.0,32,40,-8
NL,RO,2009.0,7,6,1
IE,DK,2007.0,6,6,0
CA,EC,2018.0,9,6,3
CM,IN,2015.0,3,2,1
EC,US,2010.0,16,21,-5
CN,PT,2022.0,10,11,-1
RU,KR,1999.0,2,3,-1
GB,LT,2012.0,9,9,0
nan,DE,2001.0,20,26,-6
US,IS,2022.0,8,10,-2
ES,HN,2010.0,6,5,1
NZ,CN,2010.0,27,35,-8
MW,GB,2006.0,9,2,7
AR,CN,2011.0,5,4,1
BE,IE,2009.0,8,7,1
SG,TR,2019.0,9,13,-4
TR,HU,2016.0,8,2,6
UA,DE,2013.0,22,30,-8
KH,US,2013.0,4,3,1
LT,DE,2015.0,6,5,1
AT,ES,2011.0,18,30,-12
CO,IL,2014.0,2,5,-3
CN,UA,2011.0,15,19,-4
BA,US,2022.0,2,5,-3
HU,ID,2016.0,10,5,5
KR,VN,2011.0,32,22,10
IT,HU,2000.0,7,2,5
BE,IL,2014.0,9,8,1
DE,ME,2018.0,1,2,-1
NL,SI,2014.0,5,3,2
HU,IN,2016.0,7,3,4
ID,MX,2018.0,4,4,0
PS,IL,2014.0,6,7,-1
LV,RU,2000.0,17,1,16
KE,ZA,2011.0,7,9,-2
CR,US,2001.0,9,16,-7
NO,JP,2007.0,8,9,-1
RO,IN,2016.0,16,20,-4
TW,AU,2021.0,29,35,-6
NG,IT,2019.0,9,5,4
JP,PK,2018.0,10,13,-3
BG,IE,2012.0,2,1,1
HR,UA,2016.0,2,3,-1
FI,nan,2005.0,8,11,-3
SJ,NO,2014.0,5,4,1
SE,NG,2016.0,3,5,-2
GB,GM,2008.0,9,12,-3
US,MW,2012.0,8,17,-9
MM,TH,2015.0,4,5,-1
TR,SG,2017.0,4,9,-5
IE,HR,2012.0,5,5,0
TN,AE,2020.0,6,5,1
DK,GR,2006.0,2,8,-6
PA,MX,2012.0,4,8,-4
MA,IT,2019.0,21,39,-18
DE,MD,2021.0,3,2,1
US,JM,1999.0,9,6,3
SN,BF,2013.0,5,1,4
AE,IT,2011.0,1,4,-3
GR,NO,2003.0,4,3,1
IN,HU,2014.0,5,3,2
NL,NO,2001.0,10,4,6
VE,IL,2010.0,1,1,0
EE,SE,2011.0,4,12,-8
NZ,AT,2017.0,8,6,2
JO,nan,2017.0,2,1,1
PR,KR,1997.0,16,10,6
CA,DK,2017.0,47,36,11
PH,VE,2020.0,2,2,0
CA,SN,2012.0,2,3,-1
ES,ID,2007.0,11,5,6
GR,CY,2001.0,2,5,-3
ZA,DE,2002.0,14,24,-10
MX,FI,2015.0,3,4,-1
RU,MY,2005.0,1,5,-4
RS,HU,2010.0,7,4,3
EG,MA,2012.0,6,3,3
JP,KZ,2017.0,2,2,0
IL,HU,2016.0,2,5,-3
MX,GT,2007.0,8,3,5
DZ,ES,2018.0,4,6,-2
JP,SE,1997.0,15,13,2
FR,GP,2006.0,10,12,-2
DE,CU,2009.0,1,4,-3
TR,CA,2009.0,13,13,0
DE,ET,2022.0,4,13,-9
DE,PK,1999.0,5,1,4
IE,KR,2021.0,4,5,-1
BR,PA,2021.0,4,3,1
SA,BD,2012.0,9,3,6
PL,BR,2009.0,5,4,1
AU,MK,2001.0,4,5,-1
US,KN,2009.0,4,1,3
UG,ZA,2017.0,10,13,-3
AR,CO,2002.0,19,12,7
CA,PH,2014.0,11,7,4
US,ET,1997.0,4,6,-2
BE,MX,2004.0,4,9,-5
MY,TN,2014.0,3,3,0
IN,FI,2022.0,13,12,1
GB,BN,2008.0,4,2,2
CL,PT,2003.0,3,2,1
VN,CA,2012.0,5,7,-2
RO,US,1997.0,11,14,-3
TW,IR,2002.0,1,3,-2
CA,AR,2022.0,9,16,-7
US,BW,2004.0,4,3,1
TW,FR,2019.0,14,15,-1
TR,BE,2009.0,9,13,-4
DK,ES,2008.0,14,67,-53
SE,MY,2010.0,5,1,4
FR,RE,2006.0,14,24,-10
BR,FI,2012.0,6,7,-1
SK,DE,1999.0,16,19,-3
ES,CL,2023.0,6,14,-8
DK,FI,2014.0,15,24,-9
BG,NO,1998.0,4,2,2
AT,SI,2011.0,7,13,-6
GM,US,2020.0,6,2,4
BE,HU,2020.0,11,7,4
AR,VE,2013.0,11,26,-15
SE,EG,2006.0,2,1,1
FI,CA,2019.0,18,19,-1
MK,CA,2022.0,1,2,-1
TR,ES,2004.0,7,3,4
ZA,PK,2014.0,3,6,-3
PK,EG,2022.0,18,15,3
SK,CN,2009.0,4,6,-2
BE,RS,2014.0,6,3,3
EG,DE,1998.0,8,10,-2
EE,AU,2022.0,5,3,2
IT,UG,2016.0,3,1,2
NO,BR,2003.0,10,10,0
NZ,FJ,2020.0,3,4,-1
FR,HR,2007.0,4,2,2
TH,AU,2003.0,10,14,-4
US,SN,2016.0,12,8,4
CN,MD,2012.0,3,2,1
TW,SI,2019.0,1,3,-2
nan,FI,2003.0,8,3,5
ZW,MW,2016.0,1,1,0
CA,MZ,2018.0,1,1,0
PT,CH,2005.0,8,2,6
PK,QA,2015.0,13,6,7
FR,CR,2013.0,1,2,-1
TR,IE,2020.0,4,4,0
DE,RS,2016.0,10,22,-12
PR,MX,2022.0,4,1,3
VN,FR,1999.0,3,2,1
RO,DE,2022.0,16,18,-2
MA,DE,2008.0,7,9,-2
AM,FR,2012.0,1,4,-3
CH,HR,2002.0,2,3,-1
ES,nan,1997.0,5,2,3
JO,IL,2019.0,3,2,1
PL,UZ,1997.0,4,4,0
SG,nan,1998.0,1,1,0
FR,CL,2001.0,17,9,8
PT,SA,2018.0,1,5,-4
BD,TR,2017.0,4,1,3
PH,BE,2012.0,2,5,-3
IE,ID,2011.0,1,1,0
IR,CA,1997.0,5,3,2
AZ,ID,2014.0,12,9,3
PK,PL,2003.0,2,1,1
KR,CH,2013.0,12,14,-2
GB,AG,2021.0,3,3,0
TN,GR,2016.0,2,1,1
CL,AU,2022.0,7,5,2
PL,HU,2012.0,7,11,-4
GB,LB,2016.0,16,5,11
SI,FR,1997.0,1,2,-1
PE,CR,2012.0,5,8,-3
PH,ES,2021.0,11,15,-4
JP,BY,2000.0,2,2,0
CA,QA,2008.0,8,2,6
KE,JP,2021.0,3,4,-1
AU,PK,2023.0,7,5,2
JM,US,2019.0,12,14,-2
CA,PE,2014.0,9,4,5
PY,PE,2015.0,2,2,0
CH,EE,2006.0,5,3,2
PT,RU,2004.0,5,3,2
SD,MY,2013.0,5,8,-3
VE,IT,2019.0,4,6,-2
SE,MY,2019.0,6,10,-4
ET,DE,2012.0,5,6,-1
ZA,IT,2000.0,4,4,0
KE,IS,2014.0,1,1,0
RS,HU,2017.0,8,9,-1
LK,ZA,2011.0,2,1,1
DK,IL,2002.0,2,3,-1
AT,HR,2016.0,4,11,-7
CH,PH,2004.0,3,1,2
MA,IT,2010.0,5,13,-8
KE,ET,2018.0,7,6,1
ML,US,2022.0,4,1,3
TH,AT,2006.0,2,5,-3
DE,TH,2003.0,7,2,5
RU,GE,2021.0,2,4,-2
AT,GR,2021.0,7,6,1
PL,MY,2012.0,1,1,0
MX,PL,2014.0,17,9,8
PT,HU,2011.0,2,3,-1
MY,CH,2018.0,5,4,1
NZ,AT,2019.0,5,4,1
TN,CI,2011.0,1,1,0
UA,EC,2004.0,9,8,1
IR,ZA,2014.0,8,5,3
KE,BE,2009.0,2,1,1
JO,nan,2019.0,1,2,-1
VN,RO,2014.0,4,8,-4
FR,SK,2017.0,5,8,-3
RU,ZA,2013.0,8,5,3
ES,nan,1998.0,3,8,-5
LK,MY,2018.0,6,4,2
BY,FR,2002.0,2,1,1
DK,SI,2015.0,4,1,3
MN,RU,2015.0,3,4,-1
AE,DK,2020.0,2,2,0
GR,SG,2015.0,3,1,2
CA,RS,2016.0,9,11,-2
SE,PL,2023.0,3,1,2
GB,NG,2003.0,10,10,0
BD,EG,2014.0,3,4,-1
SI,RS,2001.0,2,2,0
CN,RO,2012.0,3,4,-1
DK,PK,2016.0,9,7,2
SE,VN,2019.0,4,4,0
VE,GB,2000.0,2,4,-2
DK,IN,2007.0,8,9,-1
FI,CA,2010.0,18,16,2
DK,RS,1999.0,2,1,1
IR,CL,2020.0,6,1,5
BE,JO,2008.0,1,1,0
SY,DE,2013.0,6,5,1
JM,CA,2017.0,3,3,0
NP,BD,2014.0,5,4,1
AT,NZ,2009.0,4,4,0
CZ,BA,2006.0,1,1,0
BN,IN,2015.0,2,2,0
FR,UG,2007.0,4,2,2
HR,BA,2000.0,3,3,0
EG,DE,1997.0,6,7,-1
OM,CN,2022.0,2,1,1
GB,HR,2011.0,6,10,-4
ES,KR,1998.0,3,3,0
DK,CH,2010.0,26,24,2
MC,FR,2020.0,7,13,-6
FR,NZ,2003.0,5,5,0
MA,ES,2008.0,6,5,1
PH,IT,2000.0,2,2,0
KR,NG,2002.0,1,1,0
BG,PL,2011.0,2,3,-1
ZA,LU,2009.0,1,1,0
KW,QA,2019.0,5,3,2
BW,GH,2018.0,1,2,-1
RO,IT,2003.0,8,4,4
PK,IQ,2014.0,1,6,-5
UA,KZ,2021.0,5,7,-2
NL,HU,2000.0,3,5,-2
IT,PE,2016.0,5,4,1
JP,KZ,2010.0,2,1,1
IT,NG,2003.0,3,3,0
DZ,MA,2014.0,13,15,-2
IQ,OM,2014.0,3,2,1
KR,EE,2021.0,1,1,0
US,ME,2022.0,3,1,2
NO,ZA,2015.0,4,9,-5
IQ,HU,2021.0,10,3,7
IT,MC,2010.0,2,1,1
SV,ES,2019.0,6,2,4
TR,OM,2002.0,2,1,1
RU,SE,2007.0,17,23,-6
MG,US,2019.0,4,10,-6
CN,MM,2020.0,5,3,2
VN,DK,2012.0,2,2,0
PA,JP,2018.0,1,1,0
JM,GB,2014.0,5,5,0
GB,SS,2018.0,5,13,-8
KE,CH,2001.0,1,2,-1
CH,GR,2007.0,12,15,-3
PH,IL,2011.0,1,1,0
BR,UA,2013.0,3,4,-1
JP,PA,2013.0,1,2,-1
PL,IL,2015.0,6,6,0
TH,JP,1997.0,4,12,-8
SI,IR,2015.0,1,1,0
AR,PE,2004.0,7,5,2
BE,BG,2002.0,6,2,4
SI,IT,2016.0,10,5,5
AU,IT,1997.0,16,10,6
ZA,NZ,2002.0,12,3,9
TR,BA,2021.0,2,4,-2
AT,JP,1999.0,5,2,3
CH,FI,2005.0,6,8,-2
ES,AR,2023.0,6,6,0
RU,NO,1998.0,1,6,-5
PK,AU,2008.0,10,10,0
BO,VE,2014.0,1,1,0
KW,QA,2017.0,4,3,1
EE,NL,2020.0,4,2,2
TR,DK,2015.0,13,8,5
UY,VE,2001.0,2,1,1
BE,nan,2015.0,18,19,-1
RU,HR,2005.0,9,1,8
PT,BD,2021.0,1,2,-1
CD,US,2021.0,6,2,4
CZ,IN,2008.0,11,22,-11
nan,HU,2021.0,3,3,0
FI,VN,2021.0,2,3,-1
SA,TR,2020.0,12,8,4
CH,NG,2020.0,5,1,4
AT,AR,2004.0,1,2,-1
KR,LK,2012.0,1,1,0
IE,SD,2012.0,2,1,1
KR,MN,2022.0,1,2,-1
RO,CA,2004.0,7,2,5
US,SL,2014.0,2,4,-2
LT,SE,2012.0,2,4,-2
AT,SE,2003.0,13,6,7
MX,SG,2006.0,3,7,-4
GH,ZA,2010.0,2,1,1
SE,BG,2019.0,5,2,3
LI,CH,2009.0,3,3,0
ES,IS,2008.0,3,2,1
HR,AT,2008.0,4,6,-2
IT,LU,2022.0,4,5,-1
IT,ML,2003.0,1,1,0
PE,US,1999.0,16,15,1
IE,AT,2016.0,4,5,-1
ID,NO,2009.0,1,1,0
CH,LK,2011.0,2,1,1
JO,BH,2014.0,1,3,-2
KE,FR,2004.0,2,1,1
NG,IT,2010.0,5,13,-8
JP,AE,2018.0,4,3,1
NI,VE,2018.0,1,1,0
MY,MA,2013.0,3,3,0
BE,BJ,2007.0,4,1,3
CH,EG,2012.0,4,6,-2
SI,IE,2018.0,2,2,0
KN,GB,2017.0,1,2,-1
IR,CA,1998.0,2,9,-7
FR,AM,1997.0,2,1,1
ZA,NZ,2005.0,4,7,-3
SI,CH,1999.0,1,4,-3
MK,US,2005.0,4,5,-1
MX,LU,2019.0,2,1,1
OM,KW,2006.0,1,3,-2
BY,SE,2008.0,1,2,-1
ET,KE,2022.0,6,5,1
CN,TZ,2016.0,4,6,-2
GR,IN,2019.0,5,6,-1
ML,FR,2014.0,8,9,-1
LB,IE,2016.0,1,1,0
NZ,PT,2006.0,1,2,-1
CL,UY,2002.0,2,4,-2
SE,VN,2010.0,2,1,1
CG,CM,2010.0,1,1,0
VN,SG,2020.0,12,21,-9
EG,CZ,2016.0,5,5,0
IR,SE,2022.0,26,8,18
JO,IQ,2013.0,2,2,0
BH,US,2019.0,9,16,-7
AE,KW,2000.0,1,1,0
NG,IT,2017.0,2,3,-1
GB,EG,2001.0,14,14,0
TH,IT,2011.0,3,5,-2
JO,AU,2008.0,3,7,-4
FR,TR,2001.0,12,9,3
EG,NL,2014.0,7,9,-2
AU,RS,2004.0,2,3,-1
JM,US,2017.0,18,11,7
PT,FR,1998.0,11,12,-1
CI,US,2011.0,2,4,-2
ZA,CD,2018.0,4,1,3
DE,GH,2009.0,5,3,2
PK,IT,2015.0,7,9,-2
TR,SG,2019.0,13,9,4
HU,nan,2019.0,5,6,-1
US,PS,2013.0,11,4,7
GA,CA,2005.0,1,1,0
CH,QA,2012.0,1,1,0
GH,DK,2021.0,1,1,0
NL,CA,2023.0,5,6,-1
IR,NL,2023.0,3,1,2
UG,FR,2014.0,5,5,0
IR,IL,2015.0,2,2,0
VG,FR,2010.0,6,3,3
SY,US,2012.0,7,14,-7
SK,BY,2011.0,2,2,0
NE,US,2015.0,2,2,0
TN,TR,2016.0,2,1,1
PA,CL,2010.0,1,4,-3
ID,HU,2016.0,5,10,-5
US,ZW,2007.0,3,12,-9
SK,PL,2011.0,4,4,0
GH,ZA,2017.0,17,16,1
CN,PS,2019.0,2,1,1
LB,SD,2020.0,1,1,0
HR,IE,2003.0,4,3,1
RW,KE,2014.0,1,2,-1
SA,BE,2021.0,3,4,-1
PA,CL,2017.0,4,8,-4
CZ,ZA,2013.0,5,4,1
BR,BY,2010.0,1,1,0
NG,PK,2014.0,3,13,-10
FR,MY,2021.0,10,9,1
CR,PA,2020.0,3,1,2
IT,GT,2018.0,2,1,1
CM,DE,2014.0,5,7,-2
BD,TW,2021.0,2,1,1
DE,MK,2022.0,1,1,0
BG,CA,2008.0,3,3,0
CU,PT,2001.0,2,2,0
RS,AR,2004.0,1,1,0
LA,US,2021.0,1,1,0
ES,PL,2004.0,6,7,-1
MX,BE,1999.0,2,3,-1
VE,IL,2019.0,2,4,-2
CH,KE,2003.0,1,1,0
PL,MX,2003.0,1,2,-1
ES,SA,2009.0,3,2,1
TR,PL,2008.0,1,1,0
FR,JM,2002.0,1,2,-1
BH,CA,2020.0,2,5,-3
CI,BF,2016.0,2,3,-1
ZA,BG,2006.0,1,1,0
SC,FR,2017.0,1,1,0
BD,PH,2013.0,2,2,0
SE,VN,2017.0,4,1,3
LB,CN,2006.0,4,7,-3
AU,HK,2009.0,2,3,-1
SE,UG,2016.0,3,4,-1
RO,DK,2020.0,3,3,0
IT,MC,2017.0,2,1,1
FI,BR,2007.0,2,6,-4
NZ,AT,2010.0,4,3,1
PA,PT,2008.0,1,1,0
AU,CO,2015.0,6,17,-11
MZ,SE,2018.0,1,2,-1
SG,IL,2013.0,3,8,-5
KE,BW,2007.0,2,1,1
FI,nan,2002.0,6,12,-6
LT,FI,2012.0,4,2,2
VE,IT,2010.0,6,5,1
CH,PT,2003.0,7,2,5
AR,MX,2023.0,1,2,-1
GB,VE,2009.0,4,10,-6
HN,AR,2012.0,2,2,0
CZ,CO,2017.0,3,3,0
KE,IE,2015.0,1,1,0
JP,ET,2016.0,4,7,-3
CL,PH,2018.0,5,7,-2
SY,TR,2018.0,1,1,0
BD,CH,2021.0,2,2,0
KG,KZ,2019.0,4,8,-4
GE,RU,2014.0,4,5,-1
PL,UZ,1998.0,4,9,-5
BG,BE,2013.0,10,2,8
CZ,AU,2006.0,6,3,3
DE,BA,2020.0,3,5,-2
LB,CY,2020.0,2,2,0
KR,FI,2015.0,2,4,-2
AU,HU,2013.0,6,10,-4
BR,GE,2022.0,1,1,0
IR,MA,2015.0,5,5,0
IN,FJ,2012.0,2,3,-1
MT,IT,2014.0,4,1,3
PL,LT,2011.0,6,2,4
KZ,UZ,2013.0,8,11,-3
NP,DE,2020.0,4,6,-2
DZ,AE,2021.0,3,1,2
DE,AM,2013.0,5,3,2
FR,PA,2019.0,4,1,3
TH,SG,2015.0,5,6,-1
SC,FR,2019.0,1,1,0
IR,ES,2007.0,3,2,1
AU,NG,2013.0,3,8,-5
SA,NZ,2020.0,3,3,0
NG,HU,2021.0,1,12,-11
SN,MR,2020.0,2,1,1
DK,SA,2022.0,2,1,1
CN,IE,2000.0,3,4,-1
LK,BR,2016.0,3,3,0
CZ,BR,2013.0,2,14,-12
NL,PH,2000.0,1,1,0
CH,VG,2012.0,3,1,2
LU,CA,2016.0,4,5,-1
MY,BN,2011.0,3,2,1
CL,MX,2023.0,1,4,-3
SG,UA,2012.0,1,1,0
ID,SN,2018.0,1,2,-1
AE,BH,2019.0,2,8,-6
BE,SK,2021.0,1,3,-2
JO,PS,2014.0,4,1,3
nan,TW,2015.0,2,6,-4
CO,FI,2019.0,3,2,1
LK,IN,2005.0,1,1,0
BN,AU,2012.0,2,1,1
UY,GB,2013.0,4,1,3
IQ,AF,2022.0,1,1,0
MD,BE,2009.0,3,2,1
FR,GN,2001.0,2,1,1
TW,IT,2021.0,1,8,-7
JM,CA,2019.0,3,2,1
AE,NO,2015.0,3,2,1
TH,MY,2009.0,1,4,-3
PH,BR,1997.0,1,1,0
BJ,CA,2011.0,1,1,0
CH,PE,2013.0,3,1,2
BR,PL,2012.0,5,2,3
SG,BN,2015.0,6,3,3
BD,IT,2005.0,1,1,0
MX,CN,2006.0,7,5,2
AG,RS,2016.0,1,8,-7
BE,MY,2009.0,1,2,-1
ES,SI,2000.0,2,4,-2
VN,KR,2023.0,6,5,1
SI,HR,2004.0,4,4,0
ZA,OM,2016.0,3,2,1
MK,TR,2013.0,1,1,0
nan,VG,2007.0,2,1,1
MY,BH,2021.0,2,1,1
JP,KE,2001.0,2,3,-1
UA,BY,2002.0,5,1,4
CA,ML,2012.0,2,1,1
TN,US,1998.0,2,4,-2
BR,TW,2007.0,3,3,0
US,GN,2011.0,1,1,0
ID,BR,2022.0,5,9,-4
UA,EE,2020.0,1,2,-1
MZ,PL,2021.0,4,4,0
US,MU,2000.0,1,1,0
AU,PG,2004.0,2,1,1
PK,KZ,2014.0,1,2,-1
BE,BG,2005.0,1,4,-3
GR,IN,2010.0,3,2,1
LS,ZA,2022.0,1,1,0
TR,LB,2018.0,2,4,-2
BG,AT,2004.0,1,1,0
nan,VE,2020.0,1,2,-1
BG,NO,1997.0,2,1,1
GE,AU,2011.0,1,2,-1
CL,SA,2019.0,1,1,0
US,NI,2011.0,4,2,2
EG,IR,2005.0,1,3,-2
ID,NL,2009.0,3,17,-14
DZ,EG,2021.0,2,5,-3
SK,DK,2010.0,3,3,0
BO,ES,2000.0,3,1,2
NL,BG,2011.0,3,1,2
HR,TR,2008.0,1,1,0
AE,BR,2020.0,2,5,-3
ZA,RU,2013.0,5,8,-3
FR,EE,2010.0,6,4,2
TH,PL,2017.0,1,1,0
CW,US,2019.0,2,2,0
TW,QA,2018.0,1,3,-2
HU,FI,1999.0,4,5,-1
PS,MA,2016.0,1,2,-1
FR,PA,2010.0,1,1,0
AU,CL,2000.0,1,3,-2
CH,UG,2019.0,2,3,-1
TR,SK,2012.0,2,3,-1
BA,DE,2012.0,2,2,0
RS,HU,2019.0,5,9,-4
IN,OM,2008.0,5,5,0
TW,SE,2022.0,3,8,-5
BJ,CG,2006.0,1,1,0
TH,SE,2003.0,3,5,-2
DK,MY,2007.0,1,1,0
BR,RO,2003.0,1,1,0
TW,nan,2011.0,6,7,-1
KE,ES,2015.0,2,3,-1
PK,TJ,2017.0,1,1,0
LI,AT,2014.0,2,2,0
FR,NG,2004.0,2,1,1
IN,UZ,2002.0,1,1,0
DE,AE,2008.0,3,4,-1
SI,BY,2008.0,1,1,0
ES,GR,2007.0,8,15,-7
PT,PL,2008.0,2,2,0
IL,SE,1997.0,1,1,0
AF,MX,2014.0,3,3,0
DK,IL,2005.0,2,4,-2
OM,GB,2002.0,1,6,-5
TW,IR,2005.0,2,1,1
BG,GR,2015.0,1,3,-2
CH,SN,2013.0,3,4,-1
CH,LB,2022.0,2,8,-6
QA,CH,2009.0,1,1,0
NZ,TT,2011.0,1,1,0
FR,AM,1998.0,1,3,-2
CN,GE,2015.0,3,4,-1
BD,AU,1999.0,1,2,-1
GB,SN,2014.0,1,4,-3
nan,CR,2008.0,1,2,-1
MK,NO,2021.0,1,1,0
KW,FR,2006.0,2,1,1
DE,QA,2022.0,2,5,-3
RO,JP,2009.0,1,5,-4
HU,CL,2019.0,1,1,0
SY,NL,2015.0,1,1,0
LU,CN,2001.0,2,1,1
TN,US,1997.0,1,3,-2
PL,BY,2022.0,3,4,-1
IQ,SE,2018.0,2,10,-8
KR,UA,2016.0,2,7,-5
LT,CN,2020.0,3,5,-2
CH,RO,1998.0,1,2,-1
TR,BG,2020.0,1,2,-1
BW,SE,2010.0,1,1,0
CM,CA,2014.0,2,5,-3
KR,GR,2014.0,1,2,-1
UA,BY,2005.0,1,3,-2
GB,MW,1997.0,1,2,-1
CL,RO,2013.0,1,1,0
KR,SE,2006.0,2,2,0
CH,HR,2005.0,2,2,0
GB,BY,2014.0,1,1,0
DK,GL,2001.0,1,1,0
GH,CA,2006.0,3,4,-1
SG,IE,2008.0,3,1,2
JP,UZ,2021.0,2,2,0
IL,TW,2021.0,2,2,0
AU,IL,2003.0,4,13,-9
QA,nan,2014.0,1,1,0
BE,CO,1999.0,2,1,1
CH,TH,2021.0,3,5,-2
NO,NG,2009.0,1,2,-1
NO,GE,2014.0,1,1,0
DZ,NL,2016.0,1,3,-2
SE,PK,2023.0,1,3,-2
GE,KR,2014.0,3,2,1
KR,CN,2002.0,137,114,23
US,RU,2010.0,381,332,49
nan,FR,2004.0,86,124,-38
ES,GB,2021.0,319,384,-65
PK,IN,2020.0,376,458,-82
TR,FR,2006.0,16,10,6
IN,LB,2022.0,16,10,6
CA,CH,2001.0,42,55,-13
CH,FR,2003.0,196,273,-77
QA,US,2012.0,47,51,-4
IQ,IT,2014.0,2,2,0
CN,NL,2012.0,92,92,0
TW,ID,2014.0,19,16,3
GB,FR,2022.0,259,260,-1
CH,IR,2018.0,21,39,-18
CA,FR,2019.0,544,681,-137
NP,IN,2017.0,124,167,-43
BE,IT,2013.0,105,136,-31
BR,SG,2018.0,8,6,2
FR,MA,2017.0,264,239,25
HK,CN,2009.0,46,104,-58
CN,KZ,2011.0,9,7,2
DK,NO,2018.0,145,135,10
RU,DE,2000.0,135,80,55
KR,TH,2015.0,15,12,3
AU,CA,2022.0,227,248,-21
CR,CL,2020.0,24,28,-4
GB,CL,2011.0,33,26,7
BR,CN,2020.0,44,47,-3
IT,AT,2000.0,9,12,-3
ES,HN,2019.0,10,16,-6
CL,CU,2001.0,7,7,0
DE,UA,2008.0,28,27,1
JP,NL,2011.0,39,44,-5
AT,CA,2009.0,36,17,19
EG,BD,2019.0,7,11,-4
EC,CR,2018.0,18,20,-2
RU,IR,2008.0,15,2,13
CM,BE,2020.0,6,7,-1
ET,US,2019.0,66,69,-3
GB,BR,2009.0,146,130,16
PL,IT,2022.0,25,21,4
CZ,GB,2021.0,51,36,15
IT,DE,2003.0,145,129,16
CA,ES,2006.0,47,50,-3
CA,NO,2018.0,34,22,12
CN,AM,2021.0,1,2,-1
AT,GB,2001.0,31,27,4
ET,US,2017.0,45,49,-4
NG,FR,2018.0,9,10,-1
PT,AR,2018.0,16,20,-4
IR,IE,2020.0,27,9,18
IN,QA,2022.0,24,13,11
PY,BR,2020.0,10,20,-10
US,BH,2003.0,3,7,-4
EG,FR,2021.0,22,33,-11
NO,IQ,2016.0,2,1,1
IT,BR,1999.0,57,37,20
MM,CN,2014.0,5,1,4
DE,BR,2001.0,51,42,9
RU,NL,2012.0,38,24,14
NL,EG,2005.0,3,3,0
AM,CH,2012.0,1,3,-2
KR,NO,2011.0,8,6,2
nan,IL,2007.0,18,22,-4
EG,IE,2020.0,12,9,3
CO,BR,1998.0,4,4,0
SV,ES,2017.0,7,11,-4
IN,NP,2008.0,27,32,-5
ES,JP,2001.0,17,28,-11
UG,BE,2019.0,9,11,-2
US,TT,2021.0,8,10,-2
LU,IN,2019.0,3,6,-3
FR,ZA,2002.0,8,13,-5
DE,EC,2021.0,9,7,2
GR,SE,2022.0,19,14,5
US,nan,2023.0,7,4,3
HU,DE,2015.0,65,44,21
GE,DE,2018.0,6,3,3
KR,nan,2004.0,7,17,-10
SI,JP,2019.0,3,6,-3
AR,PK,2007.0,7,12,-5
SK,DK,2017.0,4,1,3
FR,MD,2003.0,45,51,-6
HU,FR,2004.0,13,15,-2
DE,JO,2000.0,4,4,0
BR,GR,2007.0,2,5,-3
GB,SI,2000.0,4,9,-5
ZA,DE,2005.0,23,35,-12
MY,FR,2020.0,18,12,6
CU,CO,2005.0,14,9,5
ST,BR,2008.0,25,30,-5
HU,JP,2022.0,3,2,1
KR,NG,2005.0,6,3,3
CZ,CA,2014.0,12,19,-7
IS,SE,2009.0,17,13,4
BR,AR,1997.0,14,25,-11
US,BI,2014.0,5,4,1
RU,NO,1997.0,2,2,0
SD,GB,2019.0,11,8,3
US,KH,2009.0,4,2,2
NP,AU,2008.0,1,2,-1
BR,IT,2023.0,9,6,3
DE,SD,2016.0,2,4,-2
LU,BR,2010.0,4,4,0
TZ,NG,2012.0,1,1,0
SD,GB,2010.0,4,5,-1
JP,LK,2002.0,13,3,10
EE,US,2013.0,16,17,-1
OM,IN,2006.0,3,4,-1
CU,CO,2002.0,9,6,3
KH,NZ,2015.0,1,1,0
AU,BD,2023.0,2,12,-10
CA,KW,2010.0,8,5,3
NO,SJ,2020.0,6,8,-2
CZ,EE,2015.0,2,5,-3
EG,BD,2017.0,5,10,-5
JP,UG,2007.0,1,1,0
NZ,HU,2016.0,2,1,1
IN,IR,2000.0,2,2,0
CN,IT,2004.0,10,32,-22
UG,nan,2012.0,1,4,-3
TN,ES,2013.0,5,6,-1
BA,TR,2021.0,4,2,2
SA,AE,1998.0,2,1,1
CA,KW,2017.0,22,5,17
GW,DK,2012.0,4,1,3
ET,BE,2009.0,3,1,2
CA,AU,2023.0,16,19,-3
SE,ET,2008.0,1,2,-1
DK,IS,2012.0,4,5,-1
DE,IS,2014.0,4,2,2
ZA,GR,2007.0,3,1,2
SI,FR,1998.0,2,3,-1
EE,BE,2020.0,5,5,0
SA,IQ,2012.0,6,6,0
GB,BW,2006.0,7,3,4
AU,PT,1999.0,2,2,0
PK,TW,2005.0,4,1,3
CL,BE,1998.0,2,1,1
JM,US,2010.0,10,15,-5
PH,AU,2008.0,5,10,-5
MK,SK,2008.0,1,2,-1
IE,TW,1997.0,2,1,1
CR,BO,2010.0,2,1,1
GH,ZM,2009.0,6,6,0
CA,IS,2022.0,1,1,0
SD,GB,2017.0,5,10,-5
MX,SV,2018.0,5,4,1
FR,EC,2007.0,3,4,-1
SK,AU,2016.0,1,5,-4
UZ,TJ,2019.0,4,9,-5
LB,AE,2012.0,2,3,-1
TN,PK,2013.0,3,7,-4
PY,ES,1999.0,1,1,0
FR,SD,2017.0,1,1,0
RS,IL,2020.0,1,1,0
RS,IT,2007.0,4,6,-2
DE,BY,2007.0,6,6,0
DK,TW,2004.0,1,1,0
AT,EE,2020.0,6,4,2
CZ,IQ,2021.0,1,3,-2
MK,VN,2017.0,2,2,0
DE,LT,2000.0,1,6,-5
IE,RU,2009.0,1,7,-6
NZ,KR,2011.0,4,6,-2
IN,BY,2018.0,5,7,-2
CN,LB,2003.0,2,2,0
UY,PY,2021.0,1,5,-4
TR,GH,2019.0,1,2,-1
GP,US,2006.0,1,1,0
LB,IT,2018.0,10,7,3
PH,SG,2005.0,4,4,0
IT,HR,2012.0,2,3,-1
MN,JP,2007.0,1,2,-1
KR,MX,2008.0,4,5,-1
SI,JP,2010.0,2,5,-3
ET,BW,2016.0,1,1,0
KN,US,2020.0,5,10,-5
CA,CM,2002.0,1,1,0
CZ,SE,2006.0,7,9,-2
ES,EG,2001.0,1,3,-2
KE,DE,2021.0,5,14,-9
DE,VE,2022.0,2,2,0
RO,AU,2006.0,1,2,-1
RU,IN,2012.0,20,9,11
BE,ES,2022.0,64,48,16
PL,US,2022.0,126,127,-1
NZ,CA,1998.0,17,20,-3
PR,KR,1998.0,19,14,5
AE,BH,2017.0,2,3,-1
IR,SG,2008.0,13,2,11
CA,FI,2002.0,10,9,1
TR,IR,2013.0,20,32,-12
UG,KE,2011.0,4,4,0
AU,LB,2012.0,5,2,3
IN,IL,2006.0,15,9,6
BR,MX,2023.0,2,1,1
PK,BH,2022.0,5,2,3
PL,PK,2007.0,4,2,2
HN,PE,2018.0,1,1,0
XK,HR,2012.0,1,2,-1
QA,JP,2015.0,2,3,-1
IT,NC,2018.0,1,1,0
SS,FR,2015.0,1,1,0
JP,,2004.0,7547,0,7547
TW,,2024.0,26124,0,26124
DE,,2013.0,10737,0,10737
,BR,2003.0,11934,0,11934
,IN,2010.0,23605,0,23605
KR,,2006.0,706,0,706
,FR,2001.0,12229,0,12229
IT,,2015.0,6849,0,6849
,CN,1995.0,13550,0,13550
,DE,1996.0,20816,0,20816
,JP,2000.0,19146,0,19146
,EG,2016.0,4498,0,4498
,CA,1994.0,28233,0,28233
CL,,2024.0,9162,0,9162
TR,,2018.0,5805,0,5805
,ES,1995.0,12403,0,12403
ES,,2015.0,7918,0,7918
MX,,2024.0,24391,0,24391
,IR,2001.0,1788,0,1788
,UA,2009.0,1554,0,1554
,AR,2007.0,2434,0,2434
,IN,2017.0,22661,0,22661
,SE,2011.0,3477,0,3477
,HU,2000.0,1196,0,1196
HU,,2023.0,6066,0,6066
,DE,2004.0,16935,0,16935
,BE,2013.0,3236,0,3236
IE,,2021.0,2011,0,2011
,VE,1994.0,883,0,883
IR,,2025.0,2362,0,2362
,NZ,2011.0,1228,0,1228
IN,,2009.0,3078,0,3078
,FI,2010.0,2088,0,2088
SE,,1999.0,726,0,726
,VN,2008.0,264,0,264
,PL,1994.0,7387,0,7387
,CH,1999.0,2777,0,2777
PY,,2023.0,372,0,372
KH,,2010.0,8,0,8
HR,,2021.0,1220,0,1220
,DZ,2007.0,790,0,790
,PK,2006.0,998,0,998
RO,,2014.0,588,0,588
BE,,2002.0,711,0,711
PK,,2025.0,1128,0,1128
GA,NL,2004.0,2,0,2
GD,,2018.0,13,0,13
VN,,2025.0,364,0,364
,IN,2019.0,15145,0,15145
BE,,2005.0,804,0,804
AR,,2008.0,494,0,494
RU,NZ,2004.0,3,0,3
,RS,2008.0,1025,0,1025
DK,,2003.0,357,0,357
,PE,2010.0,724,0,724
,SV,2013.0,22,0,22
,AE,1999.0,85,0,85
,IS,2000.0,137,0,137
,PY,2005.0,25,0,25
YE,,2022.0,119,0,119
FI,,2007.0,709,0,709
RU,,2001.0,1294,0,1294
SA,,2005.0,152,0,152
,EE,2015.0,289,0,289
,LU,2004.0,73,0,73
LU,IN,2010.0,2,0,2
,NP,2008.0,314,0,314
,IT,2020.0,1033,0,1033
,UZ,2000.0,107,0,107
,PE,2017.0,1069,0,1069
,ET,2016.0,1197,0,1197
MA,,2006.0,106,0,106
,SA,2015.0,2796,0,2796
BO,,2023.0,199,0,199
,FI,2017.0,1483,0,1483
,SI,2015.0,526,0,526
GB,DO,2015.0,2,0,2
,MG,1996.0,15,0,15
TT,,2024.0,233,0,233
AT,,1999.0,341,0,341
ZM,nan,2018.0,1,0,1
TZ,,2012.0,60,0,60
,LY,2012.0,80,0,80
LB,,2005.0,35,0,35
KH,,2019.0,56,0,56
nan,,1999.0,94,0,94
,TZ,1998.0,83,0,83
JP,SD,2018.0,2,0,2
,GM,2014.0,35,0,35
MK,,2025.0,24,0,24
,FI,2019.0,880,0,880
MY,,2007.0,158,0,158
PL,SK,2000.0,1,0,1
AZ,,2021.0,265,0,265
CU,,2000.0,26,0,26
CO,TW,2015.0,1,0,1
,LK,2003.0,125,0,125
,JO,2016.0,527,0,527
,NE,2016.0,58,0,58
SA,,2002.0,146,0,146
SD,,2018.0,92,0,92
,HN,2007.0,29,0,29
BF,ML,2011.0,2,0,2
CM,,2003.0,12,0,12
,LU,1996.0,34,0,34
VN,AE,2021.0,1,0,1
,TZ,1997.0,107,0,107
MD,BR,2014.0,1,0,1
NL,JO,2013.0,3,0,3
AT,AM,2020.0,1,0,1
AO,,2010.0,5,0,5
,LA,2016.0,25,0,25
LT,,2001.0,25,0,25
,MT,2016.0,65,0,65
,AF,2016.0,29,0,29
SG,ES,2004.0,4,0,4
,MQ,2017.0,11,0,11
,RW,2018.0,119,0,119
BF,NE,2021.0,2,0,2
,GT,2016.0,53,0,53
,IE,2020.0,105,0,105
AL,NG,2009.0,1,0,1
PH,RU,2010.0,2,0,2
,ZW,1994.0,133,0,133
HN,,2023.0,123,0,123
,CA,2021.0,4,0,4
,PE,2019.0,524,0,524
RU,TZ,2012.0,6,0,6
SE,QA,1998.0,3,0,3
LK,CH,2022.0,1,0,1
PT,BA,2014.0,1,0,1
CO,MN,2018.0,1,0,1
NL,BF,1997.0,1,0,1
,PY,2002.0,13,0,13
MT,KR,2022.0,1,0,1
ZA,PL,2000.0,3,0,3
PK,UY,2006.0,1,0,1
,CY,1994.0,98,0,98
IN,YE,2006.0,2,0,2
BW,,2011.0,23,0,23
GY,US,2017.0,2,0,2
AU,IQ,2015.0,11,0,11
,YE,1995.0,25,0,25
,PR,2009.0,26,0,26
SE,LK,2007.0,2,0,2
IL,BD,2020.0,5,0,5
LV,,2000.0,16,0,16
CY,QA,2016.0,1,0,1
XK,,2009.0,6,0,6
AO,,2017.0,26,0,26
SS,,2023.0,9,0,9
BH,GB,2005.0,3,0,3
HU,NZ,2005.0,2,0,2
MY,ET,2009.0,3,0,3
PL,SN,2018.0,1,0,1
KH,,2017.0,31,0,31
IN,PS,2021.0,2,0,2
IE,IS,2016.0,1,0,1
PE,SV,2022.0,1,0,1
,SR,2019.0,8,0,8
,GF,2018.0,8,0,8
NI,FR,2009.0,1,0,1
VN,IQ,2014.0,1,0,1
DK,ZA,2000.0,4,0,4
TD,,2020.0,6,0,6
NP,MX,2011.0,1,0,1
,TG,2004.0,23,0,23
MU,,2016.0,18,0,18
PL,BH,2014.0,12,0,12
KR,BY,2018.0,2,0,2
CL,SA,2010.0,1,0,1
AO,,2019.0,8,0,8
AT,ID,2008.0,4,0,4
JE,US,2017.0,2,0,2
NE,,2007.0,2,0,2
AE,LK,2021.0,1,0,1
NA,,2018.0,26,0,26
MW,ZA,1998.0,1,0,1
MM,TW,2001.0,2,0,2
IS,LT,2016.0,1,0,1
JM,,2000.0,9,0,9
GE,JP,2005.0,1,0,1
RO,TR,2002.0,1,0,1
JO,nan,2010.0,1,0,1
AR,EC,2002.0,1,0,1
DZ,QA,2011.0,3,0,3
,MG,2004.0,35,0,35
CA,GD,1999.0,1,0,1
CR,BO,2019.0,4,0,4
IE,EC,2014.0,1,0,1
JP,KP,1999.0,1,0,1
HU,UY,2010.0,1,0,1
VE,CA,2015.0,5,0,5
JO,VE,2019.0,1,0,1
LV,FR,2011.0,1,0,1
UZ,,2012.0,70,0,70
BJ,UG,2010.0,1,0,1
BO,MX,2000.0,3,0,3
NO,ME,2014.0,1,0,1
KE,CR,2017.0,1,0,1
KW,QA,2010.0,3,0,3
TW,JO,2019.0,2,0,2
,TM,2016.0,4,0,4
LT,SA,2022.0,1,0,1
AE,UZ,2019.0,1,0,1
CA,HT,2015.0,2,0,2
GL,RU,2006.0,1,0,1
CN,BI,2022.0,3,0,3
KE,,2009.0,65,0,65
,KH,1994.0,12,0,12
MW,CN,2012.0,1,0,1
LB,,2002.0,23,0,23
IL,ID,2015.0,3,0,3
ES,LB,2014.0,2,0,2
RS,DK,2008.0,5,0,5
PK,BR,1998.0,2,0,2
MX,PK,2003.0,4,0,4
DZ,JP,2003.0,3,0,3
MG,VN,2020.0,1,0,1
,SS,2020.0,2,0,2
MX,TN,2014.0,8,0,8
IE,IL,2001.0,3,0,3
RW,CH,2020.0,2,0,2
TR,JO,2009.0,4,0,4
CU,AO,2015.0,5,0,5
SE,ZM,2014.0,1,0,1
NO,UG,2006.0,1,0,1
MX,PR,2005.0,2,0,2
KZ,TW,2007.0,1,0,1
TW,ES,2003.0,3,0,3
NC,MX,2012.0,1,0,1
BN,PK,2018.0,4,0,4
BE,NG,2006.0,2,0,2
CN,ZA,1997.0,1,0,1
JP,OM,2002.0,1,0,1
TW,PE,2018.0,1,0,1
KE,AT,1999.0,1,0,1
IL,RS,2022.0,2,0,2
,MR,2003.0,5,0,5
IQ,CA,2002.0,1,0,1
IE,BG,2019.0,1,0,1
BR,NE,2019.0,1,0,1
SE,KZ,2019.0,1,0,1
CY,,2004.0,10,0,10
MX,EG,2002.0,1,0,1
RU,KG,2006.0,2,0,2
,TG,1996.0,20,0,20
CN,KG,2020.0,2,0,2
GT,US,2023.0,1,0,1
TH,AE,2021.0,1,0,1
LU,EG,2018.0,1,0,1
ZA,PH,2021.0,1,0,1
DO,MX,2001.0,1,0,1
ET,nan,2017.0,1,0,1
RS,LU,2020.0,2,0,2
nan,KH,2017.0,3,0,3
BO,BR,2001.0,1,0,1
NG,VN,2022.0,1,0,1
IL,CZ,2022.0,2,0,2
,KP,2002.0,2,0,2
UZ,CH,2012.0,1,0,1
SE,BJ,2022.0,1,0,1
,nan,2020.0,23,0,23
CI,KR,2018.0,1,0,1
MU,US,2003.0,2,0,2
BE,MT,2018.0,1,0,1
BY,FR,2005.0,3,0,3
TJ,,2007.0,3,0,3
,MC,2015.0,14,0,14
CZ,EC,2015.0,1,0,1
PK,TW,2002.0,4,0,4
GT,,2013.0,7,0,7
nan,AM,2015.0,1,0,1
,CF,1999.0,1,0,1
IT,SA,1998.0,2,0,2
CM,TD,2013.0,1,0,1
DE,LY,2013.0,4,0,4
BH,SE,2010.0,1,0,1
PL,SD,2013.0,1,0,1
IL,FI,1999.0,2,0,2
UG,UY,2011.0,1,0,1
PG,TR,2014.0,1,0,1
LA,,2004.0,3,0,3
GL,QA,2016.0,1,0,1
QA,GL,2017.0,1,0,1
CM,AU,2009.0,1,0,1
SI,AZ,2013.0,2,0,2
SA,IR,2005.0,3,0,3
IN,UG,2011.0,1,0,1
LV,CH,2013.0,2,0,2
,MQ,2010.0,23,0,23
BR,NP,2011.0,1,0,1
OM,UA,2015.0,3,0,3
KP,,2012.0,2,0,2
JP,MT,2006.0,1,0,1
PL,VN,2018.0,3,0,3
SY,MY,2015.0,3,0,3
RU,CO,2015.0,7,0,7
ES,KR,1997.0,1,0,1
LI,SE,2012.0,1,0,1
BA,,2009.0,14,0,14
CH,AE,2013.0,1,0,1
ES,HU,2000.0,2,0,2
MM,TZ,2018.0,1,0,1
IR,IS,2015.0,1,0,1
SN,CN,2021.0,4,0,4
CL,RU,2016.0,3,0,3
,LS,2009.0,8,0,8
BY,UZ,2011.0,2,0,2
KR,DK,2023.0,2,0,2
SE,ME,2018.0,1,0,1
,DJ,2001.0,3,0,3
CZ,ZW,2021.0,4,0,4
BR,AL,2014.0,1,0,1
YE,JO,2008.0,1,0,1
BY,SA,2017.0,1,0,1
BE,ZW,2010.0,2,0,2
QA,GL,2010.0,1,0,1
BR,KE,2015.0,2,0,2
CM,nan,2007.0,1,0,1
ET,AR,2014.0,1,0,1
SA,IR,2002.0,1,0,1
GM,,2018.0,6,0,6
FK,GB,2004.0,3,0,3
PT,AE,2015.0,5,0,5
CM,CD,2014.0,2,0,2
AE,CM,2019.0,1,0,1
MD,CA,1997.0,2,0,2
PG,TZ,2012.0,1,0,1
LT,FR,2004.0,2,0,2
LK,NG,2021.0,1,0,1
RO,TN,2020.0,1,0,1
SG,CO,2015.0,2,0,2
EE,BR,2016.0,2,0,2
RO,ES,2000.0,3,0,3
AM,PL,2005.0,1,0,1
JP,LV,2016.0,1,0,1
,SR,2010.0,6,0,6
HR,CR,2021.0,1,0,1
PY,IT,1999.0,1,0,1
CI,ID,1999.0,1,0,1
RS,NO,2005.0,1,0,1
IQ,MY,2006.0,1,0,1
JP,AO,2015.0,2,0,2
SG,BR,2008.0,2,0,2
IT,TG,2002.0,1,0,1
NI,CR,2008.0,1,0,1
PL,BG,2021.0,2,0,2
KR,FJ,2013.0,1,0,1
CH,CR,2012.0,2,0,2
PR,JP,1998.0,1,0,1
SD,BH,2019.0,1,0,1
BM,nan,2020.0,1,0,1
PG,ES,2007.0,1,0,1
MA,DK,2020.0,1,0,1
BJ,DE,2012.0,1,0,1
,GL,2011.0,5,0,5
CN,PG,2013.0,1,0,1
AZ,JO,2008.0,1,0,1
FI,CO,2017.0,1,0,1
TH,PL,2019.0,1,0,1
VU,,2018.0,1,0,1
,ST,1997.0,8,0,8
NO,BO,2017.0,1,0,1
RO,IL,2006.0,2,0,2
SZ,,2016.0,4,0,4
GH,UA,2010.0,1,0,1
PK,TJ,2019.0,1,0,1
ZW,BD,2011.0,1,0,1
TW,BF,2019.0,1,0,1
EC,AU,2007.0,1,0,1
LB,RW,2021.0,1,0,1
,WS,2018.0,9,0,9
GB,PY,2016.0,2,0,2
MX,NO,1999.0,1,0,1
CL,RS,2009.0,2,0,2
VI,PL,2012.0,1,0,1
KZ,FR,2023.0,1,0,1
MM,,2000.0,2,0,2
VG,SA,2018.0,1,0,1
VU,PK,2018.0,1,0,1
PH,BJ,2013.0,1,0,1
DO,,1999.0,4,0,4
,MQ,2019.0,5,0,5
SE,CO,2007.0,2,0,2
SA,VG,2016.0,2,0,2
SY,DZ,2020.0,1,0,1
AE,IE,2003.0,2,0,2
AR,CZ,2022.0,3,0,3
BE,NE,2018.0,3,0,3
CA,CI,1999.0,1,0,1
TJ,CA,1999.0,1,0,1
TR,FI,2023.0,1,0,1
QA,MA,2014.0,1,0,1
TR,PS,2012.0,3,0,3
PG,CH,2013.0,2,0,2
PT,TN,2012.0,1,0,1
OM,NZ,2009.0,1,0,1
NG,MY,2007.0,2,0,2
CA,TN,1999.0,3,0,3
FR,GE,2015.0,3,0,3
PA,CN,1999.0,1,0,1
CN,PA,2000.0,1,0,1
ES,ST,2000.0,1,0,1
TR,UY,2011.0,1,0,1
BD,AR,2016.0,2,0,2
TH,LK,2002.0,1,0,1
ZW,SE,1999.0,2,0,2
CH,CU,2008.0,4,0,4
GE,JP,2002.0,1,0,1
LU,AU,2000.0,1,0,1
CZ,MZ,2000.0,1,0,1
PL,EE,2009.0,1,0,1
BW,BD,2018.0,1,0,1
,ST,1998.0,6,0,6
HK,MY,2011.0,1,0,1
IN,CW,2018.0,2,0,2
SZ,ZA,2023.0,1,0,1
CM,RU,2022.0,2,0,2
VN,GH,2016.0,1,0,1
EC,PY,2014.0,1,0,1
IQ,SK,2021.0,1,0,1
RU,PA,2008.0,2,0,2
KE,AU,2008.0,4,0,4
DE,HN,2014.0,2,0,2
TR,LT,2007.0,1,0,1
BE,GA,2009.0,2,0,2
ZM,JP,2007.0,2,0,2
NZ,NO,2023.0,2,0,2
SG,LA,2011.0,1,0,1
LU,UG,2016.0,1,0,1
BJ,SC,2011.0,1,0,1
ME,BH,2017.0,1,0,1
FI,TN,2010.0,3,0,3
NO,AE,1998.0,1,0,1
BI,GB,2013.0,2,0,2
CY,CN,2006.0,1,0,1
NZ,WS,2006.0,1,0,1
BE,BF,1997.0,1,0,1
ZM,SZ,2018.0,1,0,1
SE,JO,2021.0,4,0,4
,KP,2005.0,1,0,1
GP,JM,2016.0,3,0,3
VG,CH,2015.0,2,0,2
JP,CI,2002.0,2,0,2
NO,MA,2016.0,2,0,2
HU,TR,2010.0,3,0,3
MT,,2008.0,4,0,4
VU,FR,2022.0,1,0,1
UG,BJ,2020.0,1,0,1
CA,HK,2021.0,5,0,5
MZ,PK,2017.0,1,0,1
LI,FI,2019.0,2,0,2
DE,FJ,2020.0,1,0,1
BH,RU,2022.0,2,0,2
BA,AE,2018.0,1,0,1
UA,MX,1999.0,4,0,4
SA,KZ,2014.0,2,0,2
nan,RO,2007.0,2,0,2
MQ,SN,1999.0,1,0,1
ZA,CY,2012.0,2,0,2
CW,DK,2008.0,1,0,1
BI,CH,1999.0,1,0,1
BB,US,1997.0,3,0,3
PE,TH,2018.0,2,0,2
KR,NZ,1999.0,1,0,1
SD,BD,2020.0,3,0,3
EC,GR,1999.0,1,0,1
MQ,RE,2008.0,1,0,1
UZ,MY,2016.0,1,0,1
BY,IS,2014.0,1,0,1
VE,PA,2008.0,1,0,1
IE,LY,2015.0,2,0,2
HK,ZA,2015.0,1,0,1
BH,TD,2022.0,1,0,1
IT,ZW,2020.0,1,0,1
BI,KE,2012.0,1,0,1
,MV,2018.0,4,0,4
IQ,JP,2012.0,2,0,2
KR,MD,2004.0,1,0,1
GL,,2007.0,1,0,1
TM,,2013.0,1,0,1
NI,SE,2014.0,1,0,1
OM,DE,2000.0,2,0,2
XK,BE,2010.0,1,0,1
NP,HR,2016.0,1,0,1
TT,AE,2020.0,1,0,1
SD,SO,2012.0,1,0,1
NL,PK,2024.0,1,0,1
PL,DZ,2010.0,2,0,2
AU,MA,2015.0,2,0,2
IR,RO,2013.0,1,0,1
MU,AU,2012.0,1,0,1
EE,SK,2020.0,2,0,2
AL,BE,2010.0,1,0,1
,GW,2012.0,4,0,4
UZ,IL,2018.0,1,0,1
ZA,HU,2002.0,1,0,1
FI,CY,2018.0,2,0,2
SD,CL,2004.0,1,0,1
JP,ZW,2002.0,1,0,1
IQ,JO,2003.0,1,0,1
LB,AT,2009.0,1,0,1
SD,DE,1997.0,1,0,1
CN,NE,2020.0,3,0,3
CN,UY,2014.0,1,0,1
CH,MG,2018.0,1,0,1
MT,CH,2021.0,2,0,2
IN,MV,2018.0,2,0,2
KZ,,2000.0,5,0,5
PL,BM,2020.0,1,0,1
TH,PT,2012.0,1,0,1
DK,PS,2020.0,1,0,1
ZW,FI,2018.0,2,0,2
CG,GA,2016.0,1,0,1
AT,MA,2018.0,1,0,1
PT,PA,1998.0,1,0,1
MC,CA,2021.0,1,0,1
CA,,2026.0,4,0,4
SD,SY,2019.0,2,0,2
GA,GB,2002.0,1,0,1
VN,BY,2004.0,3,0,3
MG,AU,2010.0,1,0,1
RS,MX,2001.0,5,0,5
PL,GL,2016.0,1,0,1
AT,EG,2000.0,3,0,3
SX,,2015.0,1,0,1
SY,TN,2011.0,1,0,1
AR,AO,2017.0,1,0,1
KW,DE,2018.0,4,0,4
CA,TG,2017.0,1,0,1
SA,DZ,2000.0,1,0,1
PA,TN,2018.0,2,0,2
GF,GB,2017.0,2,0,2
nan,KH,2019.0,1,0,1
BE,GF,2015.0,1,0,1
BS,NL,2000.0,1,0,1
TJ,IR,2019.0,2,0,2
FM,US,2012.0,1,0,1
RS,AE,2013.0,1,0,1
BE,NP,2019.0,1,0,1
AU,UY,2012.0,1,0,1
BE,EC,1999.0,1,0,1
AT,TH,1999.0,2,0,2
QA,AU,1999.0,1,0,1
RO,AT,1998.0,1,0,1
LK,UZ,2009.0,1,0,1
SD,CA,2011.0,1,0,1
KW,IL,2018.0,1,0,1
RO,PK,2002.0,1,0,1
PF,,1999.0,2,0,2
DZ,nan,2003.0,1,0,1
CY,BW,2020.0,1,0,1
GA,,2007.0,3,0,3
CN,NA,2014.0,1,0,1
NP,EG,2015.0,2,0,2
RU,TH,2020.0,1,0,1
TW,JO,2017.0,2,0,2
IT,BT,2022.0,1,0,1
BW,NA,2013.0,1,0,1
TT,OM,2021.0,1,0,1
EC,KR,2017.0,2,0,2
NL,DZ,2011.0,1,0,1
CZ,QA,2013.0,1,0,1
NZ,AM,2007.0,1,0,1
MA,CM,2002.0,1,0,1
BN,RU,1999.0,1,0,1
BE,PA,2018.0,2,0,2
DK,OM,2000.0,1,0,1
KE,SA,2013.0,1,0,1
FI,CL,1999.0,1,0,1
ES,WS,2017.0,1,0,1
PA,VN,2018.0,1,0,1
HK,SE,2018.0,1,0,1
nan,KW,2021.0,1,0,1
JM,AU,2004.0,1,0,1
EE,DK,2006.0,2,0,2
SI,NZ,2016.0,1,0,1
CH,SA,2000.0,1,0,1
CW,HU,2011.0,1,0,1
TW,BJ,2019.0,1,0,1
JP,MW,2012.0,1,0,1
KG,IL,2006.0,1,0,1
IR,TJ,2021.0,1,0,1
,SR,2017.0,6,0,6
ID,DK,2021.0,1,4,-3
RW,ZM,2013.0,2,3,-1
RW,UG,2022.0,2,2,0
NG,AT,2020.0,2,1,1
ET,nan,2019.0,2,4,-2
ID,PE,2018.0,2,5,-3
BD,NG,2016.0,2,4,-2
GR,EG,2011.0,1,1,0
TH,BT,2017.0,1,1,0
AM,GB,2022.0,3,2,1
GR,SK,2016.0,1,1,0
nan,CM,2015.0,1,3,-2
TZ,ET,2018.0,2,2,0
RU,RO,2006.0,2,1,1
CU,IL,2016.0,1,1,0
BD,TR,2019.0,2,4,-2
MK,RS,2021.0,1,4,-3
VE,AU,2008.0,1,3,-2
BF,SN,2018.0,3,2,1
HU,CL,2017.0,1,1,0
JP,MZ,2019.0,1,1,0
CY,DE,2009.0,1,4,-3
BY,HU,2017.0,1,4,-3
SE,BD,2003.0,1,2,-1
TN,BE,2004.0,2,4,-2
PT,NO,2004.0,2,2,0
CI,ZA,2011.0,1,2,-1
IN,LY,2018.0,1,5,-4
PS,GB,2004.0,1,1,0
IR,NG,2022.0,2,3,-1
IT,IR,1999.0,2,3,-1
IN,GH,2001.0,1,2,-1
DE,VG,2021.0,1,1,0
RU,LB,2018.0,1,1,0
KY,US,2018.0,1,1,0
TH,BT,2019.0,1,2,-1
NL,MK,2015.0,1,1,0
SA,CY,2018.0,2,1,1
KR,RO,2016.0,2,1,1
VG,FR,2017.0,1,2,-1
DE,GE,2003.0,1,6,-5
FI,CO,2010.0,1,1,0
SE,VE,2016.0,1,1,0
GT,CA,2020.0,1,1,0
PY,VE,2002.0,1,1,0
ZM,CH,2014.0,1,2,-1
MN,IN,2020.0,1,2,-1
IQ,ID,2010.0,1,3,-2
BH,MY,2020.0,2,7,-5
SV,CO,2011.0,2,1,1
NE,NG,2020.0,1,4,-3
CA,CM,2005.0,1,1,0
PH,DK,2020.0,1,2,-1
CN,SY,2001.0,3,3,0
SD,PS,2016.0,1,1,0
KH,TH,2021.0,1,7,-6
CA,BD,2000.0,1,2,-1
MY,NO,2005.0,1,1,0
JP,PR,2003.0,1,1,0
DZ,MN,2015.0,1,2,-1
CO,CN,2021.0,2,2,0
IN,BE,2023.0,1,1,0
IL,TR,2005.0,1,6,-5
CN,BR,1999.0,2,6,-4
PK,BN,2021.0,1,3,-2
AR,DO,2004.0,1,1,0
RS,LY,2016.0,1,1,0
AU,ZM,2009.0,1,1,0
IN,IE,1997.0,2,1,1
IL,SE,1998.0,2,1,1
DZ,MD,2013.0,1,4,-3
SA,RU,2012.0,1,2,-1
VG,FR,2019.0,1,2,-1
IE,IN,1999.0,1,2,-1
BN,US,2021.0,1,5,-4
SA,AT,2011.0,1,3,-2
DK,AZ,2014.0,1,1,0
SE,BG,2017.0,1,4,-3
LK,IN,2002.0,1,2,-1
CG,NG,2020.0,1,2,-1
SA,CZ,2015.0,2,4,-2
IE,PK,2000.0,1,1,0
KZ,JP,2014.0,1,4,-3
HU,TR,2017.0,1,9,-8
KE,FI,2012.0,1,1,0
AT,SA,2021.0,3,2,1
CA,PA,2008.0,1,3,-2
TR,UA,2002.0,1,1,0
FJ,GB,2011.0,1,2,-1
PK,RO,2013.0,2,1,1
SG,PT,2018.0,1,3,-2
PH,SG,2002.0,1,2,-1
JO,IL,2017.0,1,2,-1
IQ,LY,2019.0,1,1,0
UG,NO,2022.0,1,2,-1
CI,MA,2021.0,1,1,0
GB,ZM,2003.0,1,2,-1
UG,CY,2008.0,1,2,-1
SI,BE,2004.0,1,2,-1
JO,FR,2004.0,1,2,-1
NO,BH,2013.0,1,1,0
ES,HR,1999.0,1,1,0
CO,FI,2010.0,1,1,0
CN,BN,2000.0,1,1,0
SG,TR,2010.0,1,4,-3
MN,CN,2012.0,2,2,0
EC,IT,2012.0,1,4,-3
CN,ZA,1998.0,2,1,1
CA,RU,2023.0,1,1,0
NL,RW,2016.0,1,3,-2
SK,ZA,2021.0,1,1,0
SJ,GB,2015.0,1,2,-1
NL,KE,2004.0,2,1,1
IE,BG,2010.0,1,1,0
FR,SD,2019.0,1,1,0
CH,CY,2015.0,1,2,-1
nan,ET,2006.0,1,1,0
CG,CM,2017.0,1,1,0
US,MN,2022.0,1,3,-2
LU,IN,2017.0,2,4,-2
FR,BF,2023.0,1,1,0
IT,KE,1999.0,1,3,-2
BD,KR,2004.0,1,1,0
UG,NL,2005.0,1,1,0
PY,CL,2013.0,1,1,0
CH,UG,2010.0,1,3,-2
PH,RU,2019.0,1,2,-1
OM,FR,2017.0,1,1,0
BS,GB,2020.0,1,2,-1
TN,IL,2017.0,1,2,-1
NA,GB,2018.0,2,4,-2
CL,SV,2002.0,1,1,0
MX,TR,2003.0,1,3,-2
RO,UA,2003.0,1,4,-3
OM,FR,2010.0,2,3,-1
DE,UZ,2013.0,1,3,-2
XK,BE,2019.0,1,2,-1
IT,BA,2011.0,1,2,-1
HR,BR,2008.0,1,1,0
ML,CI,2005.0,1,1,0
FO,CN,2020.0,1,1,0
KH,GB,2003.0,1,1,0
ZW,NG,1998.0,1,2,-1
DO,AR,2020.0,1,2,-1
CA,CZ,2023.0,1,1,0
PH,GH,2023.0,1,1,0
JM,CA,2010.0,1,5,-4
CA,TG,2019.0,1,1,0
TR,TH,2020.0,1,2,-1
NG,SG,2015.0,1,1,0
LT,PL,2001.0,1,2,-1
ZA,AR,2013.0,1,1,0
PH,PK,2015.0,2,1,1
BE,PE,2018.0,6,1,5
IR,UA,2020.0,2,1,1
BZ,US,2018.0,1,3,-2
PF,CA,2020.0,1,2,-1
IE,BG,2017.0,1,1,0
GM,PK,2020.0,1,1,0
CH,PS,2014.0,1,1,0
DO,US,2022.0,1,3,-2
HR,MK,2007.0,1,1,0
TW,BE,2002.0,1,4,-3
MY,UA,2009.0,1,2,-1
YE,GB,2010.0,1,3,-2
UZ,CZ,2008.0,2,2,0
GM,NG,2020.0,3,4,-1
UZ,TJ,2017.0,1,5,-4
JO,BE,2021.0,1,0,1
SY,SE,2019.0,1,0,1
IN,AZ,2017.0,1,0,1
KH,SG,2018.0,2,0,2
NL,BD,2001.0,1,0,1
RE,NO,2015.0,1,0,1
BD,PE,2011.0,1,0,1
BE,HN,2010.0,1,0,1
CZ,CO,2010.0,1,0,1
CH,CD,2005.0,1,0,1
TD,NG,2007.0,1,0,1
MX,LT,2019.0,1,0,1
IT,AF,2018.0,1,0,1
PT,UZ,2012.0,2,0,2
NA,ZW,2000.0,1,0,1
KN,NZ,2016.0,2,0,2
ZW,NA,1999.0,2,0,2
IN,AZ,2019.0,1,0,1
TW,BD,2022.0,1,0,1
RS,QA,2005.0,1,0,1
SD,BH,2010.0,1,0,1
IL,CL,2004.0,2,0,2
ML,AU,2018.0,1,0,1
LY,CN,2012.0,1,0,1
TT,MY,2021.0,1,0,1
BG,CL,2001.0,1,0,1
BG,HU,2021.0,1,0,1
MN,AT,2020.0,1,0,1
ST,,2006.0,3,0,3
MX,BD,2014.0,1,0,1
SL,NG,2001.0,1,0,1
UG,PK,2009.0,2,0,2
MY,LY,2021.0,5,0,5
CI,CG,2005.0,1,0,1
NC,CA,2005.0,1,0,1
AL,SA,2019.0,1,0,1
SA,TW,2001.0,1,0,1
BY,BR,2015.0,1,0,1
NO,MM,2018.0,2,0,2
NG,CH,1998.0,1,0,1
TH,NE,2005.0,1,0,1
AM,CL,2002.0,1,0,1
LT,NO,2016.0,2,0,2
BH,PH,2018.0,1,0,1
TR,OM,2005.0,1,0,1
nan,ST,2009.0,1,0,1
KH,CD,2015.0,1,0,1
GE,BE,2004.0,1,0,1
DO,CN,2020.0,1,0,1
GP,SN,2018.0,1,0,1
IT,MC,2019.0,1,0,1
CN,BH,2015.0,1,0,1
PS,ZA,2016.0,1,0,1
GB,FK,2003.0,1,0,1
SE,CM,1999.0,2,0,2
TR,ZM,2006.0,1,0,1
TW,RU,2023.0,1,0,1
SG,ET,2018.0,1,0,1
CN,LV,2011.0,1,0,1
MW,PH,2018.0,1,0,1
CN,BO,2019.0,1,0,1
PK,SL,2019.0,1,0,1
IN,VE,2009.0,1,0,1
JP,BI,2021.0,1,0,1
UA,TR,2014.0,2,0,2
VE,PS,2017.0,1,0,1
GE,TR,2012.0,2,0,2
FR,ZM,2014.0,1,0,1
TR,GH,2017.0,1,0,1
GP,RE,2014.0,1,0,1
SG,GH,2022.0,1,0,1
DK,FO,2006.0,1,0,1
BH,LT,2009.0,1,0,1
TO,FJ,2014.0,1,0,1
PA,BE,2012.0,1,0,1
,KY,2000.0,1,0,1
SD,CH,2009.0,1,0,1
GR,HK,2011.0,1,0,1
RS,LT,2014.0,1,0,1
,MS,2016.0,1,0,1
MR,CI,2020.0,1,0,1
GE,FR,2004.0,1,0,1
BW,ER,2014.0,1,0,1
NG,NA,2018.0,1,0,1
GM,SN,2018.0,1,0,1
MA,PF,2010.0,1,0,1
NP,LK,2008.0,1,0,1
KH,ZA,2015.0,1,0,1
CA,BT,2017.0,1,0,1
NO,JO,2007.0,1,0,1
XK,BA,2016.0,1,0,1
MS,,2004.0,2,0,2
UA,CI,2009.0,1,0,1
DZ,SY,2004.0,1,0,1
IN,LU,2005.0,1,0,1
HK,KR,2022.0,1,0,1
MT,IS,2021.0,1,0,1
IR,NP,2014.0,1,0,1
NA,AU,2007.0,1,0,1
AZ,DE,2007.0,1,0,1
MR,nan,2020.0,1,0,1
MD,CA,1998.0,1,0,1
CG,DE,2018.0,1,0,1
ZA,AL,2015.0,1,0,1
CH,GE,2016.0,1,0,1
GR,PK,2000.0,1,0,1
BF,GA,2007.0,1,0,1
TW,HU,2013.0,1,0,1
MX,LT,2017.0,1,0,1
HU,PT,2022.0,1,0,1
SE,SY,2021.0,1,0,1
IS,RS,2011.0,1,0,1
FM,,2009.0,1,0,1
US,MC,1997.0,1,0,1
SG,NG,2005.0,1,0,1
PE,PA,2021.0,2,0,2
AR,LU,2022.0,1,0,1
IL,VG,2014.0,1,0,1
TW,LB,2004.0,1,0,1
NP,ZM,2021.0,1,0,1
LA,LT,2017.0,1,0,1
BH,BG,2017.0,1,0,1
SV,AU,2022.0,1,0,1
ZA,HK,2011.0,1,0,1
SE,SS,2012.0,1,0,1
AM,QA,2019.0,1,0,1
PF,TW,2020.0,1,0,1
PE,TZ,2014.0,1,0,1
CA,ET,2009.0,1,0,1
CZ,HR,2002.0,1,0,1
SI,ME,2009.0,1,0,1
SE,UY,2004.0,1,0,1
ML,BF,2000.0,1,0,1
AR,RU,2012.0,1,0,1
CD,NO,2002.0,1,0,1
BG,TW,2002.0,1,0,1
LK,MW,2021.0,1,0,1
RE,BJ,2014.0,2,0,2
PF,RE,2003.0,1,0,1
NC,,2001.0,1,0,1
BE,UG,1997.0,1,0,1
JP,SV,2003.0,1,0,1
WS,NZ,2017.0,1,0,1
YE,LB,2019.0,1,0,1
SK,MX,2006.0,1,0,1
nan,TH,2003.0,1,0,1
CA,UG,2000.0,1,0,1
VG,IE,1999.0,1,0,1
NG,CG,2021.0,1,0,1
ZM,IE,2007.0,1,0,1
IQ,PF,2009.0,1,0,1
SE,PS,2016.0,1,0,1
AT,CR,2012.0,1,0,1
UA,CR,2020.0,1,0,1
NZ,JO,2014.0,1,0,1
AU,SK,2003.0,1,0,1
CN,PS,2017.0,1,0,1
AM,CA,2001.0,1,0,1
NO,SA,2023.0,1,0,1
PK,TH,2023.0,1,0,1
BJ,JM,2017.0,1,0,1
TZ,IS,2021.0,1,0,1
GB,CM,2002.0,1,0,1
GB,GD,2018.0,1,0,1
IN,RE,2004.0,1,0,1
nan,LU,2004.0,1,0,1
GW,BR,2011.0,1,0,1
PL,BJ,2020.0,1,0,1
US,CN,2017.0,6217,4943,1274
AU,IE,2010.0,95,69,26
ES,MX,2011.0,604,626,-22
IT,DE,2014.0,345,231,114
GB,CA,2020.0,933,956,-23
ES,AR,2011.0,306,296,10
AU,US,2014.0,2162,2514,-352
US,CN,2019.0,6776,5075,1701
RU,GB,2015.0,83,135,-52
US,DE,2009.0,2355,2232,123
CA,US,2021.0,2593,2621,-28
DE,BR,2004.0,83,71,12
BR,AT,2012.0,13,10,3
ES,US,2014.0,1102,930,172
GB,US,2013.0,5941,6043,-102
HU,US,2010.0,128,87,41
nan,JP,1999.0,77,83,-6
SE,DE,2019.0,244,279,-35
CA,AU,2011.0,355,308,47
CR,ES,2021.0,48,42,6
AT,DE,2021.0,488,543,-55
FR,ES,2000.0,119,110,9
JP,SE,2008.0,44,41,3
US,IN,2003.0,763,982,-219
GB,EG,2004.0,19,24,-5
GB,CH,2002.0,128,126,2
DE,LI,2015.0,5,1,4
ES,CL,2011.0,296,293,3
AU,KE,2016.0,5,5,0
PT,nan,2013.0,18,54,-36
DK,CO,2017.0,2,3,-1
nan,KR,2000.0,14,12,2
MY,IN,2019.0,166,166,0
US,PH,2016.0,371,441,-70
SE,US,2011.0,354,423,-69
BR,PT,2018.0,1140,1249,-109
ZA,RO,2015.0,5,3,2
GB,FI,2022.0,38,45,-7
IL,CA,2009.0,56,38,18
MX,CO,2018.0,464,483,-19
GB,ES,2015.0,361,551,-190
SE,DE,2017.0,271,269,2
CL,MX,2011.0,110,147,-37
JP,US,2022.0,769,788,-19
GB,DE,1997.0,217,243,-26
PL,GB,2003.0,35,30,5
DK,DE,2018.0,194,195,-1
CN,TW,1998.0,150,254,-104
SG,AU,2007.0,71,53,18
US,FR,1998.0,672,723,-51
PK,JP,2007.0,12,18,-6
NL,CN,2018.0,149,146,3
NL,US,2014.0,715,743,-28
AU,GB,2023.0,62,75,-13
GB,DE,1998.0,289,327,-38
CA,CN,1998.0,127,131,-4
CL,CR,2018.0,34,36,-2
SL,US,2020.0,4,1,3
MY,JP,2015.0,63,65,-2
JP,FR,2013.0,125,111,14
IN,DK,1999.0,3,4,-1
IR,IN,2022.0,15,11,4
GE,US,2004.0,101,113,-12
PT,NL,2020.0,22,32,-10
IN,IE,2008.0,28,11,17
CN,IQ,2016.0,11,2,9
FR,TN,2004.0,81,63,18
SE,HR,2020.0,6,6,0
US,PT,2012.0,168,144,24
CO,BR,2008.0,53,55,-2
US,NZ,2016.0,415,398,17
LB,US,2008.0,40,42,-2
IT,MY,2022.0,35,9,26
US,FR,1997.0,558,539,19
EG,US,2009.0,117,141,-24
ES,RO,2018.0,14,20,-6
DE,JP,2014.0,207,201,6
PT,FR,2008.0,37,47,-10
CA,VN,2015.0,15,5,10
US,VN,2017.0,158,78,80
US,VN,2019.0,213,82,131
KR,SA,2012.0,12,4,8
AU,IE,2017.0,123,106,17
DE,AR,2016.0,43,36,7
IN,SA,2022.0,73,61,12
BR,IT,2011.0,189,228,-39
KR,CA,2018.0,88,70,18
AR,IT,2020.0,112,95,17
DE,SE,2018.0,271,219,52
AR,MX,2011.0,70,109,-39
GB,JP,2018.0,381,276,105
CA,CN,1997.0,115,56,59
BY,US,2005.0,7,7,0
US,GE,2015.0,143,195,-52
FR,AT,2005.0,35,22,13
BD,PL,2019.0,5,4,1
LB,FR,2017.0,59,125,-66
CA,EG,2022.0,53,46,7
FI,NO,2014.0,30,11,19
PA,US,2019.0,70,55,15
KW,IN,1997.0,1,4,-3
CH,FR,2014.0,385,477,-92
US,nan,2011.0,290,300,-10
SK,US,2006.0,30,31,-1
SE,CL,2015.0,11,3,8
NZ,AU,2001.0,74,68,6
VN,US,2017.0,78,158,-80
SI,CN,2016.0,6,6,0
CH,NZ,2013.0,20,16,4
VN,US,2019.0,82,213,-131
RU,ES,2004.0,7,6,1
FR,ID,2002.0,3,2,1
CN,TW,1997.0,114,186,-72
RO,SK,2015.0,4,6,-2
NZ,GB,2009.0,192,273,-81
CA,PS,2018.0,5,2,3
AT,GB,2004.0,53,32,21
nan,CA,2020.0,44,33,11
FR,DE,2015.0,576,529,47
DK,NL,2016.0,46,58,-12
BG,NO,2008.0,21,6,15
IE,CA,2016.0,153,147,6
KR,ID,2018.0,50,22,28
IR,CA,2008.0,71,56,15
RU,TJ,2021.0,207,27,180
ZA,IN,2013.0,47,68,-21
AU,SE,2014.0,58,43,15
VN,US,2010.0,40,36,4
IE,CN,2012.0,48,43,5
CN,RU,2017.0,56,47,9
SE,IN,2015.0,45,63,-18
CN,TR,2015.0,30,107,-77
CN,RU,2019.0,72,59,13
KZ,CN,2010.0,6,11,-5
CN,IR,2020.0,41,90,-49
NL,KE,2001.0,2,6,-4
PH,FR,2005.0,2,2,0
MY,SA,2018.0,89,39,50
CA,SE,2003.0,42,36,6
IT,SE,2020.0,91,65,26
FR,JP,2022.0,101,90,11
PL,CH,2016.0,30,38,-8
CI,FR,2020.0,30,24,6
GH,DE,2006.0,4,3,1
FR,CM,2018.0,33,21,12
NL,CH,2023.0,6,9,-3
NO,GB,2018.0,113,103,10
CA,BR,2006.0,172,153,19
IE,ES,2018.0,35,48,-13
DE,IL,2007.0,30,42,-12
NL,JP,2015.0,22,30,-8
FI,US,1998.0,97,106,-9
DK,FR,2009.0,30,39,-9
IE,CZ,2016.0,5,5,0
nan,FR,2001.0,69,67,2
GB,JO,2012.0,33,10,23
IT,VE,2020.0,5,9,-4
DE,TR,2021.0,72,90,-18
DK,SE,1997.0,28,34,-6
AM,IT,2006.0,12,13,-1
MY,JO,2022.0,20,8,12
CH,PL,2018.0,27,45,-18
NL,NO,2004.0,27,9,18
IN,DE,2008.0,110,101,9
DE,VN,2018.0,37,17,20
BR,MX,2011.0,87,79,8
FR,IT,2001.0,186,153,33
DE,RU,2013.0,178,142,36
ZA,KE,2016.0,43,18,25
SE,FI,2021.0,70,93,-23
nan,UA,2013.0,15,19,-4
JO,AE,2018.0,28,16,12
BY,RU,2011.0,61,66,-5
AT,FI,2015.0,5,14,-9
HU,US,2017.0,111,103,8
IT,SI,2020.0,14,10,4
CL,PT,2014.0,9,16,-7
CH,BE,2020.0,89,105,-16
JP,nan,2011.0,47,53,-6
US,ID,2014.0,128,100,28
SE,CZ,2009.0,14,10,4
JP,CZ,2012.0,14,9,5
GR,TR,2018.0,11,8,3
ES,AU,2016.0,89,49,40
US,SA,2003.0,49,32,17
NG,US,2005.0,22,14,8
IN,CZ,2018.0,26,12,14
RO,CZ,2017.0,9,8,1
SE,GB,2009.0,151,171,-20
SG,nan,2008.0,9,5,4
US,EC,2009.0,19,19,0
SK,CZ,2013.0,121,96,25
CN,RU,2010.0,52,58,-6
RU,CH,2022.0,28,17,11
CN,CU,2021.0,3,2,1
CO,FR,2014.0,34,48,-14
PK,UA,2017.0,1,1,0
CZ,RO,2017.0,8,9,-1
SE,AT,2013.0,24,22,2
VE,CU,2015.0,19,14,5
GB,NG,2014.0,68,44,24
nan,DE,2004.0,26,31,-5
CI,ML,2015.0,6,2,4
BD,GB,2011.0,49,46,3
VE,BR,2015.0,33,20,13
ES,PE,2013.0,135,76,59
SE,CN,2015.0,90,101,-11
JP,GR,2007.0,60,46,14
CA,PT,2006.0,11,14,-3
ES,UY,2020.0,49,52,-3
AR,nan,2016.0,40,47,-7
ID,BD,2010.0,2,2,0
CN,IT,2001.0,14,20,-6
JP,RU,2016.0,67,53,14
SG,GB,1999.0,17,30,-13
PA,US,2017.0,60,58,2
US,MG,2018.0,5,5,0
PL,CZ,2021.0,87,73,14
CZ,CH,2020.0,40,34,6
CU,EC,2014.0,18,3,15
CR,CO,2015.0,40,33,7
ZA,AU,2021.0,59,42,17
US,IQ,2015.0,38,21,17
IL,IN,2002.0,9,10,-1
ES,DO,2014.0,6,4,2
CO,CR,2015.0,33,40,-7
US,SS,2003.0,2,1,1
SS,GB,2005.0,11,6,5
PK,US,2006.0,70,81,-11
ID,BD,2019.0,45,63,-18
NG,US,2002.0,17,13,4
FR,AR,2021.0,67,65,2
KR,TW,2015.0,34,56,-22
CR,AR,2019.0,19,12,7
BR,VN,2018.0,4,1,3
ID,BD,2017.0,25,46,-21
IT,IL,2021.0,15,14,1
LV,UA,2020.0,6,4,2
NG,ZW,2016.0,1,1,0
KR,JO,2014.0,2,1,1
CO,CZ,2019.0,4,2,2
NL,IE,2011.0,16,18,-2
IN,IQ,2020.0,19,15,4
IQ,FR,2009.0,3,1,2
US,MA,2020.0,27,22,5
CZ,RS,2018.0,26,14,12
DE,HK,2006.0,1,3,-2
CZ,TR,2020.0,13,14,-1
IR,FI,2022.0,35,4,31
ZA,NG,2013.0,36,42,-6
SA,FR,2020.0,16,47,-31
ZA,BE,2020.0,25,22,3
GB,ZM,2014.0,10,3,7
BE,LU,2022.0,13,3,10
HR,PH,2018.0,1,1,0
NL,CO,2006.0,6,3,3
PA,US,2010.0,23,55,-32
TR,BR,2022.0,7,6,1
CZ,PL,2018.0,87,100,-13
EG,IL,2015.0,6,8,-2
DE,SK,2000.0,10,16,-6
GH,HU,2020.0,3,2,1
BE,CH,2003.0,29,31,-2
GB,IL,2022.0,33,42,-9
LK,JP,2017.0,20,32,-12
GB,BN,1998.0,1,2,-1
CD,BE,2015.0,9,11,-2
IN,LK,2021.0,26,18,8
PH,DE,2018.0,9,12,-3
US,BH,2014.0,7,9,-2
BJ,FR,2009.0,25,20,5
UZ,RU,2020.0,28,65,-37
MX,ID,2018.0,4,4,0
VN,UA,2022.0,7,1,6
DE,CO,2020.0,30,49,-19
GB,GH,2016.0,29,18,11
RU,IT,2020.0,55,86,-31
ES,IT,2003.0,77,101,-24
NL,BD,2004.0,3,1,2
nan,DK,2010.0,20,11,9
NZ,SA,2022.0,2,1,1
EE,FI,2006.0,7,8,-1
FR,AU,2021.0,94,105,-11
NO,SE,2007.0,68,78,-10
SE,UA,2018.0,8,15,-7
MY,CA,2020.0,46,23,23
AU,IE,2019.0,126,141,-15
SE,DE,2010.0,181,177,4
PT,CO,2018.0,17,20,-3
CO,VE,2017.0,43,79,-36
TW,TH,2015.0,14,6,8
CR,MX,2006.0,11,12,-1
PK,GB,2000.0,14,14,0
MX,PE,2004.0,21,16,5
SE,CA,2002.0,33,28,5
CZ,SI,2000.0,5,4,1
SK,RS,2022.0,4,3,1
HU,US,2019.0,93,82,11
JP,MM,2021.0,8,5,3
TR,RU,2019.0,9,3,6
CA,MA,2018.0,24,19,5
YE,CN,2021.0,6,3,3
KR,VN,2023.0,5,6,-1
CN,SI,2016.0,6,6,0
IN,FR,2004.0,74,53,21
SA,AU,2021.0,34,42,-8
AE,SA,2021.0,21,30,-9
KZ,US,2022.0,13,6,7
GR,BE,2020.0,35,21,14
ES,CU,2004.0,59,58,1
NL,CA,2011.0,78,99,-21
EG,GB,2020.0,123,107,16
AU,DK,2013.0,32,41,-9
FI,DK,2012.0,21,9,12
DE,CZ,2020.0,93,80,13
EG,DE,2008.0,28,49,-21
IN,MX,2018.0,15,13,2
KR,IE,2013.0,5,9,-4
MY,TH,2017.0,14,4,10
KR,RU,2013.0,12,10,2
ZA,SE,2022.0,18,10,8
CZ,MX,2015.0,7,3,4
UA,BE,2019.0,4,5,-1
TR,SA,2016.0,12,11,1
KR,IN,2021.0,142,184,-42
BR,AR,2008.0,93,99,-6
ZA,BR,2019.0,24,19,5
NZ,NL,2019.0,13,21,-8
IR,BE,2017.0,31,18,13
GH,US,2012.0,15,34,-19
NO,TZ,2011.0,8,4,4
IN,BE,2011.0,30,20,10
RO,CA,2001.0,12,7,5
BE,PL,1997.0,6,2,4
TN,IR,2007.0,5,1,4
FR,TR,2004.0,16,13,3
nan,ES,2021.0,58,63,-5
GB,BY,2003.0,2,2,0
AT,NL,2004.0,17,9,8
VN,KR,2011.0,22,32,-10
BR,HU,2015.0,2,4,-2
CA,PH,2003.0,7,8,-1
NO,IL,2009.0,2,3,-1
SE,IT,2002.0,31,65,-34
AU,IT,2008.0,37,45,-8
GA,DE,2021.0,6,2,4
AU,BD,2011.0,13,26,-13
FI,RU,2022.0,11,39,-28
FI,ZA,2017.0,8,5,3
IN,IT,2001.0,23,25,-2
AR,BR,2004.0,64,42,22
US,LK,2000.0,5,6,-1
MA,US,2013.0,17,14,3
CA,CL,2016.0,33,23,10
RW,US,2015.0,9,10,-1
MZ,US,2013.0,4,5,-1
SE,TW,2020.0,8,6,2
NZ,BD,2012.0,2,2,0
JO,MY,2019.0,11,33,-22
GR,NL,2013.0,22,21,1
AR,HN,2021.0,1,1,0
IN,NL,2004.0,20,15,5
BE,IN,2023.0,1,1,0
BR,ES,2023.0,15,19,-4
PE,IT,2016.0,4,5,-1
GB,KR,1999.0,27,30,-3
GR,CH,2020.0,34,21,13
CH,IE,2012.0,11,12,-1
TH,JP,2008.0,28,70,-42
US,UA,2022.0,38,35,3
CZ,US,2002.0,90,62,28
CA,CO,2009.0,10,10,0
SE,BE,2009.0,19,13,6
KG,US,2014.0,2,1,1
PY,MX,2016.0,6,15,-9
US,VN,2010.0,36,40,-4
CR,US,2004.0,16,14,2
IN,NG,2000.0,2,4,-2
SK,GB,2014.0,27,15,12
US,LU,2009.0,20,14,6
AU,PK,2011.0,18,19,-1
IN,AL,2016.0,3,1,2
CZ,NO,2022.0,3,2,1
SI,MX,2020.0,14,4,10
TH,nan,2018.0,2,1,1
FR,DZ,2007.0,55,53,2
IT,MX,2011.0,37,24,13
GP,MQ,2020.0,3,4,-1
NO,AE,2008.0,1,1,0
EE,UA,2012.0,1,1,0
MX,IE,2007.0,5,2,3
SG,TW,2009.0,27,26,1
BY,US,2002.0,19,4,15
LU,FR,1999.0,3,12,-9
IT,VN,2018.0,8,1,7
PK,RU,2009.0,1,2,-1
NO,SA,2011.0,3,3,0
IN,PL,2013.0,13,6,7
GB,LU,2013.0,14,8,6
CZ,NL,2010.0,14,19,-5
FR,HU,2009.0,18,24,-6
IE,NL,2017.0,16,27,-11
CA,SD,2016.0,5,1,4
PR,KR,2008.0,32,15,17
ES,MA,2018.0,16,12,4
RO,US,2008.0,30,57,-27
nan,MX,2022.0,15,4,11
KR,NL,2013.0,8,17,-9
DK,ES,1998.0,20,8,12
CL,IT,2012.0,19,16,3
PR,JP,2008.0,3,2,1
IR,DE,2012.0,60,46,14
SE,IT,2005.0,52,54,-2
KR,nan,2001.0,7,14,-7
RS,DE,2017.0,20,15,5
nan,DK,2017.0,15,28,-13
IN,EE,2021.0,6,4,2
CM,FR,2002.0,7,8,-1
IR,IT,2009.0,12,10,2
NO,FI,2020.0,24,30,-6
CA,HU,2020.0,13,18,-5
FI,IN,2012.0,11,19,-8
BE,UA,2015.0,1,3,-2
IN,HU,2003.0,7,3,4
BR,SD,2011.0,9,10,-1
DK,CZ,2012.0,8,4,4
LT,RU,2006.0,10,6,4
NL,SK,2015.0,6,7,-1
TW,RU,2011.0,19,19,0
DZ,BI,2018.0,2,1,1
BD,SG,2008.0,1,3,-2
CZ,NL,2019.0,14,13,1
ES,RU,2020.0,25,21,4
DK,RU,2017.0,13,15,-2
IN,SE,2005.0,23,17,6
GB,TW,2005.0,42,41,1
BE,HR,2015.0,4,2,2
RE,US,2009.0,3,1,2
FR,SA,2012.0,29,11,18
ID,DE,2022.0,23,17,6
AU,JO,2017.0,14,6,8
TZ,NL,2021.0,2,4,-2
FR,HT,2005.0,1,1,0
IN,NO,2005.0,13,13,0
nan,FI,2014.0,9,9,0
VN,JP,2023.0,5,2,3
CZ,RO,2019.0,8,2,6
AU,TR,2016.0,11,13,-2
BT,LK,2020.0,2,3,-1
KN,CA,2018.0,1,1,0
BD,NO,2021.0,5,16,-11
JP,ES,2023.0,2,1,1
US,CR,2020.0,35,49,-14
TW,SA,2020.0,5,8,-3
SA,KR,2020.0,7,20,-13
IR,PK,2022.0,9,8,1
RS,CA,2020.0,6,8,-2
DE,KE,2007.0,11,3,8
SE,CA,2005.0,43,35,8
NG,CM,2013.0,1,1,0
IT,CZ,2009.0,17,21,-4
SG,DK,2018.0,5,3,2
GR,IT,2007.0,15,15,0
KW,EG,2013.0,24,10,14
CO,AU,2021.0,14,7,7
IL,FR,2020.0,31,42,-11
MX,KR,2016.0,2,4,-2
RS,ME,2019.0,21,21,0
GH,GB,2009.0,10,11,-1
CA,CH,2004.0,63,58,5
JP,RS,2015.0,3,2,1
CG,NC,2019.0,2,1,1
CZ,AT,2012.0,16,16,0
SE,PT,2019.0,18,22,-4
CN,MN,2018.0,6,2,4
FI,EE,2018.0,12,20,-8
IT,PT,2018.0,50,43,7
JP,MY,2006.0,22,14,8
EG,TR,2021.0,4,9,-5
AZ,PL,2004.0,10,1,9
GB,KW,2018.0,21,10,11
IL,EE,2017.0,1,3,-2
AT,SE,2014.0,33,25,8
IR,NL,2011.0,31,20,11
BR,NG,2022.0,4,3,1
IR,BE,2010.0,12,11,1
DE,SI,2013.0,11,7,4
FR,CL,2004.0,16,17,-1
CN,MK,2012.0,5,3,2
DK,SK,2006.0,4,9,-5
RS,DE,2010.0,17,20,-3
IT,PL,2013.0,22,31,-9
DE,TH,2014.0,23,16,7
GR,NO,2014.0,8,5,3
IE,SE,2007.0,4,8,-4
BE,PL,1998.0,8,3,5
NP,US,2012.0,25,22,3
HU,MX,2013.0,3,1,2
DE,HU,2006.0,47,52,-5
TH,NG,2014.0,3,4,-1
TR,FI,2011.0,3,7,-4
EE,PL,2020.0,3,4,-1
SN,FR,2007.0,25,24,1
IR,AE,2015.0,5,9,-4
AU,IL,2014.0,11,21,-10
FR,OM,2009.0,4,3,1
BE,RU,2016.0,24,22,2
DK,AT,2011.0,10,7,3
MA,MD,2000.0,4,9,-5
NL,HK,2006.0,6,1,5
BE,MX,2001.0,1,2,-1
VN,GB,2016.0,6,19,-13
DE,NZ,2005.0,28,17,11
ID,IQ,2021.0,15,5,10
US,MZ,2016.0,5,4,1
IN,NZ,2021.0,34,33,1
RS,DE,2019.0,31,19,12
MX,NL,2009.0,4,11,-7
AT,VN,2017.0,2,2,0
DE,NZ,2002.0,15,10,5
GB,GM,1997.0,6,3,3
FR,AT,2002.0,22,16,6
HU,BG,2009.0,3,1,2
nan,EG,2022.0,2,2,0
RO,FR,2002.0,18,17,1
IT,NG,2014.0,7,10,-3
FJ,US,2005.0,3,7,-4
GB,AR,2021.0,37,33,4
SE,PK,2011.0,9,14,-5
KE,FR,2001.0,1,1,0
JP,AT,2014.0,17,20,-3
IN,KZ,2013.0,2,1,1
JP,DK,2012.0,18,15,3
IN,SE,2002.0,8,11,-3
ES,CO,2000.0,48,39,9
CO,UY,2015.0,13,7,6
CH,MA,2006.0,2,3,-1
BD,US,1999.0,6,13,-7
NO,CO,2019.0,3,5,-2
CN,ZA,2008.0,8,11,-3
PK,AT,2022.0,1,4,-3
PK,IR,2014.0,10,14,-4
SG,SE,2012.0,15,11,4
CH,PT,2014.0,16,27,-11
RS,CZ,2017.0,14,8,6
IE,CO,2013.0,1,5,-4
GB,TW,2002.0,34,42,-8
PY,US,2022.0,10,3,7
PK,AU,1997.0,3,1,2
SA,AE,2008.0,6,2,4
CO,GT,2015.0,8,2,6
JP,KE,2004.0,6,1,5
CA,JO,2002.0,4,1,3
TH,AU,2014.0,24,36,-12
US,HK,2022.0,11,7,4
BR,NZ,2009.0,6,5,1
PH,IE,2016.0,2,3,-1
GB,PT,2023.0,6,11,-5
NO,CO,2010.0,1,2,-1
MX,DE,2009.0,30,32,-2
FR,NZ,2014.0,19,17,2
UG,GB,2014.0,11,14,-3
QA,GB,2011.0,9,19,-10
GM,GB,2003.0,7,10,-3
CN,AT,2022.0,13,19,-6
RS,MX,2004.0,16,11,5
NL,IN,2009.0,29,44,-15
BJ,NE,2012.0,1,1,0
SD,IQ,2016.0,6,1,5
TN,US,2008.0,11,6,5
PE,BO,2012.0,3,8,-5
DE,MX,2020.0,40,65,-25
SE,MX,2018.0,13,14,-1
NG,AU,2019.0,17,12,5
ZA,IE,2012.0,10,7,3
FR,TW,2001.0,16,23,-7
RO,ZA,2016.0,11,3,8
MM,CN,2003.0,16,4,12
CA,PK,2003.0,6,8,-2
IR,CN,2023.0,6,2,4
US,LY,2009.0,1,2,-1
NZ,DK,2022.0,3,5,-2
BR,AO,2016.0,15,31,-16
SG,TH,2018.0,7,4,3
GR,JP,2007.0,46,60,-14
UA,EC,2001.0,5,2,3
FR,ET,2012.0,5,3,2
AE,IE,2014.0,4,2,2
SN,IT,2015.0,1,2,-1
JO,MY,2010.0,7,6,1
RU,NO,2008.0,30,5,25
VA,US,2017.0,1,1,0
SE,GR,2007.0,10,9,1
QA,ES,2016.0,3,16,-13
EC,UA,2009.0,16,9,7
SI,RS,2004.0,3,4,-1
MY,PH,2015.0,1,2,-1
LK,GR,2007.0,4,2,2
TJ,RU,2013.0,23,28,-5
LY,IN,2013.0,3,2,1
AR,PT,2018.0,20,16,4
nan,DK,2019.0,29,15,14
HU,CH,2021.0,8,13,-5
TZ,CA,2012.0,1,2,-1
NL,EC,2020.0,8,3,5
AM,US,2000.0,6,7,-1
MA,PT,2018.0,18,27,-9
NG,KE,2017.0,5,7,-2
PK,SA,1999.0,3,7,-4
NL,LU,2022.0,2,9,-7
GR,CY,2004.0,9,4,5
AZ,UA,2019.0,3,1,2
MX,UY,2018.0,20,20,0
CA,RU,2011.0,18,23,-5
GR,BR,2012.0,4,2,2
PH,NO,2005.0,5,1,4
PL,ZA,2007.0,5,3,2
DK,FI,2003.0,5,8,-3
FI,GB,2011.0,48,64,-16
DZ,nan,2014.0,7,6,1
US,TZ,2013.0,24,14,10
KW,US,2013.0,16,18,-2
PT,CN,2016.0,11,12,-1
GB,MW,2008.0,9,12,-3
CO,BE,2013.0,13,6,7
CO,CU,2000.0,6,2,4
BE,KE,2016.0,8,2,6
RS,ME,2010.0,9,10,-1
KR,TZ,2013.0,2,2,0
ZA,BR,2010.0,12,13,-1
PT,ES,1999.0,27,33,-6
AT,VN,2019.0,4,2,2
PL,FR,2001.0,29,31,-2
ES,CZ,2016.0,25,14,11
SA,NG,1999.0,3,1,2
JP,PL,2022.0,5,9,-4
CH,ES,2000.0,21,19,2
BW,AU,2005.0,1,2,-1
UY,AR,2022.0,11,15,-4
RO,NZ,2018.0,2,1,1
SE,UY,2001.0,3,1,2
BB,GB,2009.0,2,2,0
NG,IN,2016.0,21,24,-3
IN,NO,2002.0,35,12,23
CL,BE,2008.0,4,5,-1
PK,CL,2019.0,1,1,0
ZM,US,2006.0,4,3,1
CM,DE,2003.0,4,3,1
PL,BD,2018.0,6,4,2
DK,SE,1998.0,31,40,-9
HR,IE,2014.0,3,6,-3
MA,TN,2005.0,6,8,-2
CN,PL,2012.0,26,35,-9
IE,AE,2018.0,6,3,3
TW,AR,2020.0,3,7,-4
TZ,BE,2021.0,2,1,1
RU,JP,2009.0,26,58,-32
UA,AT,2002.0,5,1,4
PT,RU,2001.0,4,4,0
IT,TH,2013.0,5,3,2
JP,TR,2004.0,39,55,-16
RO,FR,2005.0,33,39,-6
JO,MY,2017.0,9,30,-21
NG,KE,2019.0,8,7,1
DK,IT,2022.0,23,24,-1
LK,US,2009.0,16,25,-9
SG,IN,2000.0,9,18,-9
IR,JP,2005.0,12,20,-8
IN,CO,2003.0,2,1,1
TR,ID,2008.0,3,2,1
ML,FR,2003.0,5,3,2
IT,GH,2021.0,2,3,-1
UA,nan,2007.0,9,7,2
NZ,NL,2017.0,15,13,2
PE,PL,2006.0,1,1,0
ID,IN,2013.0,13,17,-4
GB,GM,1998.0,3,6,-3
ZA,AT,2013.0,6,3,3
DK,SG,2012.0,5,4,1
PK,FR,2018.0,10,17,-7
AF,JP,2019.0,1,7,-6
ZM,IR,2019.0,4,3,1
AT,IS,2012.0,1,3,-2
UA,UZ,2010.0,8,4,4
US,BW,2001.0,3,2,1
BR,KR,2011.0,4,2,2
BE,PK,2012.0,3,4,-1
RO,BR,2013.0,4,1,3
FR,MT,2021.0,3,2,1
CH,GB,2023.0,13,16,-3
NO,TR,2012.0,2,4,-2
ZM,ZA,2013.0,2,1,1
CH,LU,2015.0,5,4,1
CL,CN,2007.0,3,1,2
HN,DE,2016.0,2,1,1
NL,CL,2007.0,7,4,3
BD,PL,2017.0,5,3,2
SG,SA,2014.0,6,3,3
SA,DK,2012.0,2,1,1
SG,PH,2009.0,5,5,0
SE,PT,2017.0,10,18,-8
GT,MX,2008.0,2,2,0
ES,PA,2001.0,13,6,7
ZA,AE,2013.0,4,2,2
SK,SE,2005.0,3,5,-2
SA,NL,2012.0,1,3,-2
NG,UG,2009.0,3,1,2
VE,AR,2013.0,26,11,15
AR,GT,2019.0,4,2,2
JO,DE,2011.0,12,13,-1
ES,AO,2003.0,4,3,1
IN,OM,1998.0,4,1,3
MZ,PT,2019.0,12,5,7
CN,PK,2000.0,11,13,-2
SA,BR,2017.0,8,3,5
US,GD,2009.0,3,8,-5
nan,CH,1999.0,5,1,4
NL,ET,2021.0,6,10,-4
TN,RU,2020.0,2,5,-3
AU,SK,2014.0,2,5,-3
MA,CG,2019.0,3,1,2
AT,CU,2005.0,1,2,-1
GH,BE,2016.0,3,1,2
nan,SG,2021.0,8,6,2
CO,GB,2006.0,11,16,-5
LB,SA,2017.0,5,13,-8
AR,PA,2012.0,3,2,1
PL,AU,2009.0,14,8,6
IL,JP,2011.0,13,5,8
NO,nan,2018.0,17,26,-9
BY,CN,2006.0,5,1,4
PH,TW,2020.0,13,4,9
FR,CU,2016.0,7,7,0
US,NA,2016.0,3,1,2
NG,AU,2017.0,12,6,6
VE,DE,2006.0,2,5,-3
SK,JP,2015.0,5,6,-1
PL,HR,2019.0,9,6,3
TH,FI,2013.0,3,2,1
KE,ZM,2006.0,2,3,-1
GB,IM,2007.0,1,1,0
DE,BO,2011.0,2,2,0
GT,FR,2015.0,1,1,0
DE,ZW,2020.0,1,1,0
CG,BJ,2010.0,2,2,0
ZM,ZW,2016.0,4,2,2
FR,PF,2021.0,9,11,-2
CH,RO,2008.0,7,3,4
IE,AR,2019.0,4,5,-1
AU,KH,2020.0,8,2,6
CH,BG,2017.0,6,3,3
BE,RO,2013.0,9,12,-3
EC,CL,2009.0,3,4,-1
ET,UG,2020.0,3,4,-1
CA,IQ,2022.0,2,7,-5
CD,FR,2021.0,3,3,0
ID,BH,2018.0,2,1,1
PK,UA,2019.0,2,4,-2
ET,SA,2018.0,2,2,0
SE,BO,2020.0,4,1,3
PH,FR,2002.0,3,4,-1
KR,BR,2011.0,2,4,-2
ES,UA,2021.0,4,4,0
BE,CY,2021.0,2,1,1
LY,SA,2013.0,2,1,1
CN,AE,2014.0,8,7,1
NG,TR,2009.0,3,1,2
FI,LU,2010.0,4,3,1
GA,FR,2004.0,1,3,-2
NO,BR,2014.0,27,27,0
BR,RO,2014.0,3,7,-4
IE,NL,2010.0,19,21,-2
UA,SE,2012.0,9,4,5
AU,FJ,2020.0,11,7,4
UA,LV,2016.0,1,3,-2
ID,HR,2022.0,1,1,0
IS,FR,2015.0,2,2,0
IL,PT,2019.0,7,5,2
NG,TT,2011.0,1,1,0
MG,FR,2013.0,8,13,-5
BE,CL,2017.0,13,6,7
PL,MX,2014.0,9,17,-8
CN,JO,2005.0,3,2,1
FR,LU,2014.0,51,35,16
BE,CL,2019.0,8,15,-7
TW,ES,2014.0,4,5,-1
SE,KE,2018.0,7,5,2
ID,IT,2012.0,1,4,-3
RS,CZ,2010.0,8,10,-2
RO,BE,2020.0,9,12,-3
NO,ID,2019.0,8,5,3
IL,UA,2012.0,2,5,-3
AU,FI,2001.0,7,6,1
AT,BG,2017.0,2,2,0
SE,PL,2011.0,26,20,6
SA,BR,2019.0,6,7,-1
ES,nan,2008.0,16,21,-5
UG,FR,2003.0,2,1,1
NG,GB,2000.0,4,8,-4
MY,SG,2000.0,10,4,6
UZ,CN,2004.0,4,1,3
RO,PL,2009.0,3,7,-4
LU,CN,2004.0,2,3,-1
PT,AT,2006.0,2,4,-2
PK,BR,2008.0,2,1,1
CH,BG,2010.0,2,3,-1
MW,US,2015.0,14,12,2
OM,AE,2009.0,2,3,-1
SK,HR,2007.0,2,3,-1
KZ,DE,2021.0,7,7,0
BE,TH,2019.0,8,2,6
LB,SA,2019.0,10,9,1
RS,ME,2017.0,20,13,7
IT,TW,2017.0,6,5,1
HU,IT,2002.0,11,3,8
GB,TZ,1999.0,3,1,2
NL,CW,2003.0,12,5,7
FR,BF,2011.0,10,11,-1
AR,CH,2009.0,12,5,7
RO,IT,2014.0,10,17,-7
IL,IN,2005.0,8,15,-7
IT,BY,2006.0,1,1,0
US,MC,2008.0,1,2,-1
RO,CZ,2019.0,2,8,-6
SI,GR,2019.0,1,2,-1
OM,ZA,2016.0,2,3,-1
CZ,RO,2010.0,11,2,9
RW,FR,2020.0,1,2,-1
BE,TH,2017.0,5,3,2
SE,BD,2014.0,6,4,2
BD,PL,2010.0,1,10,-9
IT,SK,1999.0,8,2,6
RO,UA,2014.0,2,3,-1
NO,CO,2017.0,1,2,-1
PL,SE,2022.0,20,13,7
CH,BG,2019.0,4,8,-4
ME,RS,2016.0,12,21,-9
JO,QA,2016.0,7,3,4
PH,GB,2000.0,9,11,-2
ZW,DE,2001.0,1,1,0
ZW,CA,1998.0,1,2,-1
CO,PH,2012.0,3,4,-1
PE,UY,2017.0,5,1,4
TR,RU,2010.0,6,5,1
CU,BR,2009.0,17,13,4
nan,ZA,2009.0,14,7,7
CU,NL,2021.0,1,2,-1
BR,LB,2020.0,5,7,-2
GR,PL,2000.0,2,3,-1
KH,FR,2009.0,4,4,0
PT,PA,2008.0,1,1,0
UA,GB,2007.0,6,5,1
BE,IL,2003.0,3,4,-1
FI,TW,2009.0,2,1,1
RS,DK,1997.0,1,1,0
PH,IN,2000.0,4,3,1
IT,LT,2016.0,4,3,1
MY,KR,2002.0,2,1,1
TR,AU,2006.0,6,2,4
SV,CL,2015.0,4,5,-1
SG,ES,2001.0,2,1,1
KR,DK,2011.0,4,2,2
ES,PK,2013.0,3,6,-3
CN,CO,2016.0,4,5,-1
IL,SG,2007.0,2,1,1
IT,PH,2016.0,3,4,-1
NZ,NL,2010.0,7,13,-6
TT,US,2006.0,4,4,0
ME,HR,2014.0,1,1,0
DK,BG,2013.0,1,2,-1
IL,NZ,2000.0,3,2,1
NG,SY,2019.0,1,1,0
TR,RU,2017.0,12,3,9
MW,ZA,2008.0,2,2,0
NG,GM,2021.0,4,1,3
JP,ZA,2018.0,7,5,2
PF,FR,2021.0,11,9,2
CH,ML,2019.0,1,3,-2
PT,CU,2006.0,2,3,-1
CH,CM,2007.0,1,1,0
AR,PE,2001.0,4,4,0
IR,BE,2019.0,28,29,-1
HR,CA,2016.0,7,5,2
CZ,NL,2017.0,11,20,-9
HU,PK,2019.0,4,2,2
PH,BR,2008.0,5,2,3
VE,PT,2011.0,5,5,0
AR,GT,2017.0,6,5,1
nan,DZ,2018.0,15,12,3
MX,KE,2017.0,4,2,2
CM,KE,2019.0,2,5,-3
AT,BG,2019.0,7,5,2
IN,BW,2021.0,3,2,1
NL,ZW,2022.0,1,1,0
CM,ID,2021.0,2,2,0
HR,SK,2014.0,5,3,2
nan,NO,2007.0,26,22,4
MK,BG,2013.0,2,9,-7
RU,UZ,1999.0,9,12,-3
HN,CO,2011.0,2,4,-2
IS,RU,2018.0,2,3,-1
RS,ES,2013.0,3,1,2
IN,HR,2018.0,3,1,2
IT,TW,2010.0,1,4,-3
SZ,ZA,2011.0,3,1,2
FI,LU,2017.0,4,5,-1
EG,KZ,2011.0,1,1,0
DK,ES,1997.0,12,6,6
CU,CA,2005.0,3,1,2
ES,TR,2023.0,1,1,0
NO,TW,2020.0,2,5,-3
CR,IT,2016.0,2,6,-4
NL,SI,2003.0,2,3,-1
RS,JP,1999.0,1,5,-4
TR,CZ,2007.0,2,2,0
CN,EG,2006.0,2,9,-7
TR,PL,1998.0,1,1,0
BG,IN,2010.0,3,1,2
CA,TZ,1999.0,1,1,0
PL,RO,2022.0,4,8,-4
DE,BG,2006.0,13,22,-9
SS,GB,2002.0,6,2,4
MK,IN,2012.0,1,1,0
IT,CO,2008.0,4,3,1
CN,UG,2016.0,4,3,1
CZ,IT,1997.0,8,8,0
IN,NP,1998.0,6,2,4
TN,GB,2018.0,5,6,-1
NO,PK,2007.0,1,1,0
BA,MX,2007.0,2,1,1
BF,FR,2006.0,9,9,0
LB,MY,2018.0,4,2,2
BW,US,2020.0,7,12,-5
PK,ES,2007.0,1,1,0
CN,KP,2020.0,11,4,7
KW,TR,2011.0,4,2,2
IQ,EG,2013.0,8,8,0
NL,ZA,1999.0,10,8,2
SI,HR,2001.0,2,3,-1
HR,SI,2003.0,8,5,3
US,AL,2022.0,3,6,-3
BA,IT,2007.0,1,1,0
ES,DZ,2021.0,4,7,-3
SJ,NO,2003.0,4,2,2
BY,UA,2005.0,3,1,2
ZA,IR,2014.0,5,8,-3
KW,GB,2022.0,8,10,-2
BA,CH,2016.0,2,1,1
IL,DK,1999.0,1,1,0
JM,NG,2021.0,1,1,0
DK,PT,2018.0,6,9,-3
SE,MZ,2018.0,2,1,1
AT,KR,2007.0,3,3,0
FI,ZA,2019.0,3,6,-3
PK,UG,2020.0,2,2,0
EG,HU,2011.0,4,1,3
IQ,JO,2014.0,4,5,-1
nan,UY,2006.0,2,1,1
IE,BR,2007.0,3,5,-2
FR,MQ,2021.0,9,8,1
TT,CA,2009.0,2,5,-3
CL,CU,2004.0,13,10,3
CA,CZ,2011.0,6,10,-4
ZA,KR,2012.0,6,3,3
ZW,GB,2013.0,5,3,2
KH,KE,2018.0,1,1,0
IE,AR,2017.0,3,2,1
RS,CZ,2019.0,11,21,-10
TW,ZA,2005.0,5,2,3
CH,TN,2018.0,10,10,0
GT,US,2011.0,2,10,-8
NZ,nan,1999.0,5,5,0
SG,BD,2008.0,3,1,2
CL,CZ,1999.0,1,1,0
PK,CL,2017.0,2,1,1
MX,HU,2015.0,2,3,-1
DE,GE,2014.0,2,6,-4
BY,SK,2013.0,2,3,-1
DK,CO,2019.0,4,4,0
CM,SN,2016.0,1,1,0
ML,SN,2020.0,3,3,0
UG,AU,2022.0,4,4,0
TN,IN,2020.0,2,2,0
IN,AR,2021.0,2,7,-5
ET,SE,2022.0,4,3,1
SI,CZ,2012.0,6,12,-6
IT,TW,2019.0,5,6,-1
IR,YE,2014.0,2,1,1
RU,AT,2000.0,4,10,-6
DO,CO,2008.0,1,1,0
GB,GE,2009.0,5,2,3
GB,JM,2006.0,7,3,4
CY,CA,2006.0,2,2,0
UA,AT,2005.0,4,3,1
JP,VE,2010.0,2,1,1
TH,KE,2017.0,4,1,3
ST,MZ,2017.0,2,1,1
HR,HU,2015.0,3,2,1
SE,IQ,2019.0,11,5,6
JP,HK,2000.0,8,6,2
HR,GB,2004.0,4,6,-2
NL,VN,2011.0,3,5,-2
SG,MM,2012.0,1,2,-1
VN,IT,2022.0,5,2,3
PH,AU,1997.0,6,5,1
LB,CA,2000.0,2,1,1
MY,BE,2009.0,2,1,1
BE,FI,2018.0,11,18,-7
TN,NG,2015.0,4,1,3
MY,AR,2015.0,3,2,1
PS,EG,2013.0,6,4,2
CZ,CA,2003.0,6,8,-2
VN,AU,2002.0,1,3,-2
AE,SD,2021.0,5,5,0
MY,KR,2005.0,2,4,-2
NZ,TH,2018.0,3,4,-1
VE,CH,1997.0,4,1,3
GA,US,2008.0,2,1,1
CG,BJ,2019.0,1,1,0
BG,TR,2017.0,2,3,-1
GB,PH,2006.0,7,10,-3
IR,TH,2021.0,5,1,4
BH,IN,2020.0,2,7,-5
VN,NZ,2020.0,5,5,0
BE,MD,2014.0,3,3,0
OM,SA,2001.0,3,1,2
MZ,PT,2017.0,3,2,1
JP,NO,2023.0,1,2,-1
GE,nan,2021.0,2,2,0
IT,SD,2021.0,2,1,1
TH,CN,2023.0,2,6,-4
IR,PH,2016.0,1,2,-1
US,VG,2006.0,7,9,-2
IL,PH,2018.0,3,1,2
CN,UZ,2006.0,8,6,2
IL,MX,2019.0,3,3,0
TR,NG,2016.0,3,3,0
CO,CZ,2017.0,3,3,0
BI,US,2021.0,1,1,0
KZ,CN,2019.0,8,10,-2
PT,MY,2012.0,2,3,-1
MD,CN,2021.0,2,2,0
CG,NC,2017.0,1,1,0
IT,RS,2006.0,5,6,-1
AU,RS,2001.0,2,4,-2
CN,CM,2013.0,2,1,1
GN,FR,2008.0,2,1,1
BW,CH,2022.0,1,1,0
KW,LB,2022.0,1,1,0
IR,HU,2015.0,2,1,1
AU,JO,2010.0,3,2,1
IT,EC,2021.0,5,11,-6
LY,CA,2013.0,2,2,0
IL,VE,2019.0,4,2,2
ET,GH,2004.0,1,1,0
ES,KR,2008.0,5,1,4
DE,PE,2007.0,3,1,2
BA,CZ,2014.0,1,2,-1
CN,PH,1998.0,5,5,0
BH,KE,2015.0,5,3,2
SE,HK,2021.0,1,1,0
DK,ET,2000.0,1,1,0
BR,HN,2015.0,1,5,-4
AR,AT,2013.0,2,1,1
IR,DK,2009.0,3,3,0
ER,IN,2008.0,1,1,0
SG,GR,2019.0,2,2,0
TR,NO,2003.0,3,2,1
CU,BE,2012.0,2,4,-2
CA,PA,1998.0,1,1,0
DK,RU,2010.0,3,9,-6
AU,PG,2001.0,3,3,0
NO,NZ,2009.0,2,3,-1
LU,CH,2012.0,4,1,3
RO,AT,2008.0,1,1,0
JO,CN,2007.0,5,1,4
MK,DE,2012.0,3,4,-1
DE,UA,1997.0,5,15,-10
TN,NO,2016.0,2,1,1
PT,PK,2011.0,2,3,-1
AO,CU,2019.0,1,3,-2
FR,ID,2005.0,5,1,4
LT,AT,2010.0,1,1,0
DE,UA,1998.0,9,18,-9
CG,BJ,2017.0,1,2,-1
RS,PL,2015.0,3,12,-9
MY,LB,2004.0,1,1,0
SI,nan,2013.0,2,3,-1
CI,CH,2011.0,1,1,0
GB,UY,2000.0,2,1,1
MM,KR,2015.0,1,2,-1
CZ,SA,2020.0,2,4,-2
RU,NZ,2001.0,3,2,1
PE,nan,2006.0,2,3,-1
HU,SK,2000.0,4,3,1
UY,IT,2022.0,5,2,3
PL,NO,2004.0,2,2,0
TW,CO,2018.0,1,1,0
CO,NO,2015.0,1,1,0
JM,FR,1999.0,2,2,0
SS,US,2015.0,3,3,0
NO,SG,2019.0,5,2,3
HR,AT,1998.0,4,2,2
ZA,MZ,2014.0,2,2,0
UA,UZ,2019.0,5,6,-1
VN,ES,2014.0,2,3,-1
GB,BM,2014.0,1,1,0
JP,HU,2000.0,4,10,-6
GR,HU,2009.0,3,3,0
BE,TW,2016.0,3,5,-2
CH,UA,1999.0,3,2,1
TZ,TH,2012.0,1,1,0
VG,GB,1999.0,3,7,-4
BY,UA,2002.0,1,5,-4
EE,GB,2004.0,4,1,3
FI,HR,2021.0,1,6,-5
UA,SK,2016.0,7,5,2
VN,AU,2005.0,4,2,2
PK,AE,2013.0,4,6,-2
IL,MX,2017.0,3,6,-3
CA,PA,1997.0,2,1,1
nan,TR,2008.0,6,6,0
CA,JO,2005.0,8,4,4
DK,EG,2005.0,1,1,0
TN,CA,2006.0,2,8,-6
AT,PK,2022.0,4,1,3
AR,JP,2015.0,6,4,2
GR,RO,2013.0,4,3,1
CH,PA,2019.0,2,2,0
PK,AU,1998.0,3,3,0
EG,VN,2018.0,4,10,-6
KE,MW,2020.0,3,2,1
IQ,CH,2018.0,2,1,1
MX,KE,2019.0,2,3,-1
PL,IN,2003.0,2,4,-2
IN,GR,1999.0,4,4,0
AR,NI,2018.0,2,3,-1
AZ,CN,2021.0,2,3,-1
PT,NG,2021.0,1,2,-1
AU,JO,2019.0,7,7,0
CO,CA,2000.0,6,3,3
MA,DE,1998.0,2,3,-1
nan,MA,2020.0,6,5,1
VN,SE,2021.0,2,3,-1
TW,NZ,2021.0,5,3,2
AR,IN,2018.0,1,5,-4
GE,CA,2002.0,2,2,0
HU,IT,2005.0,5,15,-10
HU,PK,2017.0,1,2,-1
BG,CA,1998.0,3,6,-3
SD,CN,2007.0,1,1,0
HT,CN,2011.0,1,1,0
AU,NO,2006.0,9,8,1
CR,HN,2019.0,3,3,0
AU,KW,2004.0,1,1,0
GA,BR,2018.0,2,1,1
EG,CM,2020.0,2,1,1
BD,LK,2019.0,2,1,1
CL,DO,2014.0,2,1,1
FI,LU,2019.0,2,2,0
PK,PL,2014.0,7,16,-9
NZ,NO,2011.0,5,3,2
KZ,CN,2017.0,3,4,-1
RS,CH,1999.0,2,2,0
KR,ZA,2006.0,3,4,-1
NA,NG,2016.0,1,1,0
US,ML,2013.0,2,4,-2
MA,TN,2002.0,5,1,4
nan,BR,1999.0,5,7,-2
GH,IT,2012.0,3,2,1
DK,RO,2006.0,2,4,-2
BR,EC,2010.0,5,4,1
GH,JP,2011.0,2,5,-3
ES,BG,2005.0,5,1,4
BG,CH,2002.0,1,3,-2
BE,DZ,2007.0,2,3,-1
CH,ET,2012.0,1,1,0
CZ,IN,1998.0,4,3,1
PS,FR,2011.0,1,1,0
IS,AU,2019.0,2,3,-1
CU,DE,2017.0,4,1,3
AT,PT,2022.0,4,7,-3
AF,MX,2003.0,2,3,-1
IL,MX,2010.0,1,1,0
CO,DO,2022.0,2,1,1
CR,CA,2015.0,1,3,-2
ES,AD,2019.0,3,2,1
EE,CN,2016.0,3,1,2
BE,TH,2010.0,2,3,-1
SE,SG,1999.0,3,1,2
ID,NZ,2022.0,6,2,4
UG,AT,2021.0,1,1,0
FR,AM,2008.0,1,2,-1
SA,FI,2020.0,5,3,2
SK,CA,2020.0,1,3,-2
JO,NO,2017.0,1,1,0
CN,PH,1997.0,4,4,0
AU,PA,2016.0,2,3,-1
JP,CD,2015.0,1,1,0
CU,DE,2019.0,6,3,3
KH,TR,2021.0,1,3,-2
UG,DE,2006.0,2,1,1
TW,PH,2002.0,1,1,0
SE,PT,2010.0,5,3,2
UY,DE,2013.0,2,3,-1
EC,ES,2000.0,2,1,1
BE,LV,2009.0,1,1,0
MY,NI,2016.0,3,1,2
PT,NO,2001.0,2,2,0
SG,IR,2022.0,8,8,0
MD,BR,2003.0,1,1,0
AU,GE,2014.0,3,2,1
SG,ID,2006.0,1,1,0
EG,NL,2003.0,2,4,-2
AT,BG,2010.0,3,5,-2
SE,KR,2021.0,5,16,-11
BR,SA,2020.0,2,8,-6
HK,AU,2009.0,3,2,1
SY,JO,2020.0,4,5,-1
PT,CZ,2009.0,2,4,-2
CU,RU,2012.0,2,1,1
NL,SR,2015.0,2,3,-1
OM,TN,2022.0,2,2,0
NO,CN,1999.0,2,2,0
KR,UZ,2005.0,2,2,0
IS,BE,2011.0,1,1,0
MX,PL,2003.0,2,1,1
PK,IE,2007.0,2,1,1
DZ,BE,2012.0,2,5,-3
UG,CN,2018.0,1,3,-2
JO,NG,2021.0,1,2,-1
DK,EG,2002.0,3,2,1
HR,NO,2008.0,2,1,1
JP,MX,2003.0,5,8,-3
SN,BE,2012.0,3,2,1
LU,PT,2018.0,1,4,-3
EG,KR,2007.0,2,6,-4
IN,MK,2021.0,2,2,0
FR,TZ,2018.0,1,2,-1
TN,RO,2019.0,1,2,-1
ID,BE,2011.0,1,2,-1
CA,JP,2023.0,2,3,-1
UA,IE,2011.0,2,1,1
IL,EE,2019.0,2,1,1
NZ,UG,2014.0,3,1,2
FR,GH,2021.0,1,7,-6
IR,TW,2022.0,3,2,1
CA,ZW,2015.0,1,1,0
RU,MD,1999.0,1,2,-1
TW,AE,2018.0,1,2,-1
PG,US,2009.0,3,1,2
IS,AU,2010.0,1,1,0
SA,nan,2021.0,3,4,-1
ZA,ES,2009.0,2,5,-3
IL,GH,2018.0,1,1,0
GB,EC,2009.0,2,2,0
TH,SE,2014.0,2,6,-4
US,PG,2005.0,1,3,-2
CN,TN,2020.0,2,4,-2
SD,IN,2015.0,4,4,0
PL,SG,2009.0,3,2,1
NO,CL,2005.0,1,1,0
CD,CM,2020.0,1,3,-2
EG,PT,2020.0,2,2,0
DK,IE,1999.0,2,2,0
UA,PT,2012.0,4,1,3
ES,TN,2003.0,1,1,0
ES,PL,2001.0,1,1,0
ZW,MX,2006.0,1,1,0
PE,EE,2019.0,1,1,0
KE,AU,1998.0,1,1,0
NP,TH,2015.0,3,5,-2
PK,OM,2009.0,1,7,-6
IN,CM,2015.0,2,3,-1
KH,GB,2014.0,2,1,1
ET,CN,2007.0,2,4,-2
CU,AU,2010.0,2,1,1
AO,PT,2014.0,2,5,-3
RU,GR,2003.0,2,1,1
LV,HU,2021.0,2,1,1
PL,HR,2017.0,1,5,-4
MA,CH,2021.0,3,5,-2
FR,TT,2013.0,1,1,0
CZ,IN,1997.0,1,1,0
GB,OM,1999.0,2,5,-3
EG,TN,2007.0,1,3,-2
ES,BG,2002.0,3,4,-1
BR,EC,2017.0,59,33,26
TW,JP,2021.0,73,72,1
GB,NZ,2014.0,275,226,49
NO,CA,2012.0,24,24,0
GB,CH,2005.0,150,194,-44
CH,US,2012.0,749,859,-110
BD,JP,2004.0,23,24,-1
CH,CA,2022.0,61,76,-15
LK,JP,2010.0,15,23,-8
CL,ID,2016.0,14,7,7
MY,TH,2010.0,5,3,2
BR,EC,2019.0,90,58,32
US,IE,2000.0,184,167,17
MY,IN,2010.0,50,66,-16
US,TR,2001.0,226,169,57
ID,SD,2021.0,1,3,-2
US,BR,2023.0,44,52,-8
MY,IR,2020.0,94,55,39
IT,CL,2018.0,39,29,10
IN,MY,2013.0,158,85,73
RU,CN,2014.0,49,36,13
FR,CO,2011.0,22,25,-3
CZ,US,2005.0,105,106,-1
LK,JP,2019.0,22,26,-4
IT,MA,2013.0,14,23,-9
RW,IN,2008.0,4,5,-1
TR,ES,2001.0,2,2,0
FR,CI,2016.0,28,9,19
FR,IL,2013.0,33,36,-3
MY,IN,2017.0,142,160,-18
CN,DK,2020.0,86,60,26
PK,MA,2018.0,26,32,-6
MX,nan,2018.0,36,46,-10
LB,FR,2019.0,87,130,-43
CA,KE,2021.0,9,12,-3
IE,NL,2019.0,33,30,3
CO,VE,2010.0,32,53,-21
IT,JO,2021.0,3,4,-1
RU,AU,2022.0,25,20,5
BH,ET,2020.0,26,42,-16
GB,SD,2015.0,7,4,3
SE,NL,2020.0,72,80,-8
RU,DZ,2022.0,3,1,2
GN,SN,2022.0,2,1,1
ES,BR,2020.0,381,376,5
NZ,CA,2008.0,64,50,14
DK,RU,2019.0,10,12,-2
FR,VE,1999.0,8,2,6
FR,MD,2014.0,42,47,-5
CH,TR,2021.0,17,27,-10
AR,DE,2013.0,42,28,14
MY,TH,2019.0,14,4,10
ZA,BR,2017.0,8,13,-5
DE,SG,2007.0,31,12,19
ZA,DK,2016.0,15,7,8
LB,FR,2010.0,28,58,-30
MX,VN,2020.0,13,25,-12
CO,VE,2019.0,49,76,-27
FI,US,1997.0,89,79,10
CU,CL,2022.0,10,5,5
KR,PR,2003.0,21,22,-1
CR,AR,2017.0,19,18,1
AT,TR,2013.0,8,11,-3
TN,DZ,2012.0,18,18,0
IS,DE,2009.0,5,3,2
IE,SG,2015.0,7,6,1
ES,JP,2004.0,26,23,3
FR,BZ,2000.0,6,3,3
CU,PT,2004.0,3,1,2
SG,NL,2012.0,9,16,-7
GR,FR,2006.0,21,25,-4
MX,CR,2013.0,24,18,6
CZ,IT,1998.0,19,21,-2
EG,AU,2018.0,13,28,-15
CR,AR,2010.0,12,12,0
MK,BA,2011.0,2,1,1
AU,MK,2004.0,14,12,2
BH,PL,2016.0,6,9,-3
ID,SG,2020.0,19,16,3
NL,RU,2000.0,14,21,-7
CN,SY,2004.0,7,5,2
RS,BR,2006.0,2,1,1
AZ,US,2021.0,5,5,0
UY,US,2014.0,18,27,-9
JP,NZ,2012.0,10,16,-6
US,CU,2006.0,15,16,-1
PL,IR,2020.0,7,16,-9
JP,VN,2006.0,13,10,3
BE,CL,2010.0,6,5,1
HU,FR,2001.0,20,15,5
TH,RU,2021.0,4,2,2
BE,EG,2022.0,4,5,-1
PH,MX,2015.0,6,8,-2
KR,CZ,2011.0,9,6,3
CA,AE,2007.0,8,8,0
FI,KE,2021.0,2,4,-2
MQ,FR,1999.0,10,4,6
DZ,IT,2000.0,3,1,2
SI,GR,2017.0,1,3,-2
GE,IN,2018.0,2,2,0
CR,FR,2016.0,6,4,2
UG,NG,2018.0,3,5,-2
BO,CL,2020.0,5,13,-8
KG,RU,2015.0,6,5,1
SA,JP,2013.0,4,22,-18
FR,SY,2011.0,16,4,12
IE,TR,2016.0,3,4,-1
UA,BE,2010.0,4,1,3
IE,BE,1999.0,3,3,0
nan,BY,2011.0,1,1,0
HU,EG,2020.0,8,5,3
NO,AU,2000.0,8,2,6
NO,SG,2017.0,1,4,-3
IT,EE,2020.0,5,5,0
SE,SI,2012.0,3,1,2
LT,PL,2004.0,4,5,-1
ZM,BR,2014.0,8,6,2
MY,BN,2023.0,2,1,1
KW,IN,1998.0,3,9,-6
MY,NZ,2007.0,4,2,2
SY,QA,2017.0,3,2,1
MX,TR,2014.0,4,2,2
DK,CO,2010.0,1,1,0
PK,NP,2021.0,4,8,-4
SI,FR,2008.0,5,9,-4
LB,SA,2010.0,4,1,3
TR,TW,2003.0,2,4,-2
JP,NL,2023.0,2,1,1
CU,PY,2018.0,10,3,7
BO,DE,2015.0,2,1,1
AT,ES,2023.0,1,2,-1
NZ,CO,2020.0,2,3,-1
GR,LU,2015.0,3,1,2
BG,CH,2005.0,4,3,1
EG,PL,2013.0,1,1,0
GB,SY,2022.0,3,5,-2
VN,BE,2002.0,2,2,0
IQ,CZ,2022.0,2,2,0
AE,IT,2023.0,1,1,0
CM,FR,2005.0,6,14,-8
PH,KE,2000.0,1,1,0
HN,CL,2015.0,1,8,-7
CA,SK,2001.0,3,4,-1
MM,JP,2003.0,2,1,1
HR,SE,2018.0,5,3,2
IT,AE,2006.0,1,1,0
SE,ET,1998.0,1,3,-2
AU,EG,2001.0,2,1,1
SE,PE,2011.0,2,1,1
CN,SK,1999.0,1,1,0
NL,MX,2022.0,7,9,-2
ID,ET,2022.0,5,1,4
GH,NL,2007.0,1,3,-2
AE,NZ,2007.0,1,1,0
ZM,MY,2020.0,2,11,-9
JP,MA,2016.0,2,2,0
VN,CH,2009.0,2,2,0
SK,SE,2002.0,2,4,-2
HR,CN,2021.0,2,1,1
IR,GR,2018.0,4,3,1
JO,MX,2018.0,1,1,0
AT,MK,2011.0,4,3,1
US,CN,2010.0,6919,5440,1479
CN,LB,2014.0,32,48,-16
SE,AR,2006.0,6,1,5
ZA,BJ,2021.0,2,1,1
SG,CH,2003.0,2,4,-2
IR,JP,2002.0,7,7,0
JM,GB,2003.0,2,5,-3
ET,PK,2015.0,2,4,-2
RS,RU,2006.0,4,7,-3
BH,IE,2018.0,2,1,1
US,ET,2008.0,19,26,-7
,US,2007.0,72239,0,72239
,TW,1995.0,4215,0,4215
,TH,1999.0,722,0,722
,FR,1996.0,17768,0,17768
,RS,1998.0,396,0,396
,BR,2014.0,21699,0,21699
,DK,1995.0,2552,0,2552
,IR,1996.0,561,0,561
,FR,2004.0,14602,0,14602
,DE,2001.0,14847,0,14847
,GE,2002.0,143,0,143
BR,,2009.0,2780,0,2780
,IR,2004.0,4344,0,4344
,SG,2006.0,1227,0,1227
NL,,2007.0,2098,0,2098
,CO,2012.0,2904,0,2904
,MX,2000.0,2643,0,2643
,UY,1999.0,181,0,181
DK,,2014.0,987,0,987
,CL,1995.0,1162,0,1162
,NP,1997.0,59,0,59
JP,,2001.0,6127,0,6127
,GB,2020.0,1166,0,1166
,NP,1998.0,65,0,65
,JM,2005.0,51,0,51
,RO,2006.0,1691,0,1691
HU,,2011.0,687,0,687
LV,CL,2008.0,1,0,1
,TN,2007.0,1055,0,1055
NG,SY,2010.0,1,0,1
NG,SY,2017.0,1,0,1
CR,,2024.0,913,0,913
PL,,2009.0,1302,0,1302
UG,,2021.0,336,0,336
RU,,2004.0,2719,0,2719
,CR,1995.0,102,0,102
,PA,2002.0,39,0,39
PT,UG,2011.0,1,0,1
CW,,2006.0,5,0,5
VE,,2013.0,320,0,320
,TZ,2008.0,176,0,176
CI,,2020.0,275,0,275
DZ,,2022.0,2795,0,2795
CG,,2017.0,25,0,25
,SK,2015.0,999,0,999
,MA,2007.0,707,0,707
,BS,2012.0,6,0,6
,GE,2005.0,166,0,166
,LU,2001.0,46,0,46
HN,,2011.0,10,0,10
SN,,2007.0,20,0,20
SI,,2025.0,387,0,387
GR,,2025.0,1458,0,1458
,LK,2014.0,529,0,529
BY,,2002.0,103,0,103
IQ,,2020.0,500,0,500
,JM,2002.0,53,0,53
,TJ,2017.0,53,0,53
,SY,2007.0,66,0,66
,VN,1998.0,141,0,141
,BY,2000.0,300,0,300
,HK,2010.0,76,0,76
NG,,2009.0,262,0,262
LS,,2017.0,2,0,2
RO,,2003.0,100,0,100
AR,,1998.0,113,0,113
,MU,2016.0,28,0,28
TH,ID,2012.0,7,0,7
BY,,2005.0,142,0,142
LT,,2004.0,23,0,23
LY,AE,2022.0,1,0,1
BI,,2021.0,23,0,23
PH,HN,2018.0,1,0,1
IS,,2025.0,94,0,94
,PA,2005.0,40,0,40
KW,IQ,2016.0,8,0,8
FJ,,2016.0,14,0,14
RW,,2014.0,10,0,10
,CI,2016.0,255,0,255
,NI,2000.0,10,0,10
ES,BY,2020.0,2,0,2
,PG,2016.0,18,0,18
ZA,SS,2017.0,1,0,1
GP,BE,2004.0,1,0,1
GH,GM,2022.0,1,0,1
,RE,2011.0,43,0,43
,GP,2000.0,18,0,18
,GM,2003.0,13,0,13
,HK,2017.0,51,0,51
,ZM,2018.0,135,0,135
VE,DZ,2013.0,1,0,1
ES,MD,2011.0,2,0,2
,TJ,2019.0,44,0,44
,VN,1997.0,117,0,117
BW,,2023.0,375,0,375
CG,,2019.0,40,0,40
,UG,2015.0,349,0,349
MX,IS,2021.0,1,0,1
AT,SI,2023.0,1,0,1
HU,CY,2022.0,1,0,1
,RS,1997.0,403,0,403
JO,FR,2001.0,1,0,1
SK,GR,2021.0,5,0,5
CN,GN,2012.0,1,0,1
SK,RO,2008.0,4,0,4
,CG,2002.0,24,0,24
BE,UG,2008.0,8,0,8
CR,LK,2017.0,1,0,1
GF,,2017.0,9,0,9
PL,XK,2014.0,3,0,3
BN,,2021.0,36,0,36
IQ,YE,2012.0,1,0,1
,FJ,2005.0,24,0,24
RU,EG,2008.0,5,0,5
QA,,1999.0,10,0,10
,FJ,2002.0,24,0,24
ZW,CH,2001.0,1,0,1
BB,,2021.0,14,0,14
ZW,SL,2019.0,1,0,1
NO,VE,2011.0,1,0,1
AD,,2024.0,5,0,5
ES,EG,2004.0,3,0,3
BO,,2011.0,29,0,29
UA,DZ,2019.0,1,0,1
IL,ET,2009.0,2,0,2
,GD,2012.0,34,0,34
GH,,2012.0,30,0,30
HR,IT,2000.0,3,0,3
CN,ZM,2022.0,3,0,3
CM,,2014.0,76,0,76
MX,PH,2011.0,5,0,5
DK,GL,2004.0,7,0,7
DE,BW,2001.0,3,0,3
ES,SM,2014.0,1,0,1
US,BM,2020.0,3,0,3
,TJ,2010.0,36,0,36
PY,,2011.0,6,0,6
TL,,2015.0,2,0,2
,AL,2006.0,47,0,47
CZ,GR,1998.0,1,0,1
,ST,2008.0,19,0,19
GH,SN,2021.0,2,0,2
LU,,2013.0,66,0,66
AL,SE,2015.0,1,0,1
CH,BD,2006.0,4,0,4
MW,,2007.0,10,0,10
,BI,2011.0,23,0,23
AT,RO,2007.0,2,0,2
BG,CO,2006.0,1,0,1
NO,SG,2010.0,4,0,4
PS,MK,2005.0,1,0,1
ME,US,2001.0,1,0,1
FR,LV,2012.0,2,0,2
BF,MY,2014.0,1,0,1
CN,EE,2005.0,3,0,3
TW,PS,2019.0,1,0,1
ZM,,2002.0,3,0,3
,CG,2005.0,24,0,24
CG,,2010.0,10,0,10
IS,IN,2022.0,2,0,2
ZW,,1999.0,27,0,27
GF,,2019.0,14,0,14
BE,KN,2019.0,1,0,1
NO,CL,2002.0,1,0,1
SY,CL,2000.0,1,0,1
,QA,2020.0,26,0,26
UG,FI,2009.0,1,0,1
MG,KH,2019.0,1,0,1
LT,MZ,2000.0,4,0,4
NZ,QA,2015.0,2,0,2
FR,PS,2014.0,3,0,3
HN,US,2000.0,3,0,3
CY,KR,2023.0,1,0,1
,CD,1994.0,7,0,7
LK,,2002.0,18,0,18
DO,SV,2005.0,1,0,1
,MG,2001.0,26,0,26
LK,,2005.0,20,0,20
AL,NZ,2016.0,1,0,1
RO,BG,2022.0,2,0,2
IT,MK,2016.0,5,0,5
TH,KE,2010.0,1,0,1
,FO,2012.0,6,0,6
BN,NZ,2002.0,1,0,1
CD,,2009.0,7,0,7
CZ,NG,2011.0,2,0,2
BD,PG,2016.0,1,0,1
PL,TR,2012.0,1,0,1
IN,LV,2013.0,1,0,1
HU,ES,1997.0,3,0,3
,TG,2001.0,12,0,12
CO,CH,2003.0,1,0,1
MW,NG,2017.0,1,0,1
PL,MN,2000.0,1,0,1
TH,LA,2009.0,1,0,1
ZW,PK,2012.0,2,0,2
RS,SG,2015.0,2,0,2
NO,BW,2018.0,1,0,1
IE,QA,2018.0,6,0,6
DE,IS,2003.0,2,0,2
CH,TW,2002.0,3,0,3
AF,,2014.0,6,0,6
LB,TR,2005.0,2,0,2
PK,CL,2010.0,1,0,1
WS,,1999.0,2,0,2
MK,IE,2013.0,1,0,1
CU,DE,2010.0,5,0,5
BG,AT,2001.0,2,0,2
CA,GI,2012.0,1,0,1
MN,NO,2017.0,2,0,2
NG,BN,2021.0,2,0,2
BE,MZ,2006.0,1,0,1
MY,ID,2000.0,2,0,2
TR,PL,1997.0,1,0,1
IS,HU,2014.0,2,0,2
,MR,2014.0,8,0,8
NL,GE,2019.0,1,0,1
BE,TJ,2014.0,1,0,1
MX,BW,2017.0,1,0,1
TT,GY,2006.0,1,0,1
HR,TW,2013.0,3,0,3
CZ,VN,2013.0,5,0,5
CR,GB,2007.0,2,0,2
ID,SI,2013.0,1,0,1
IR,LU,2015.0,4,0,4
LS,,2019.0,10,0,10
ZM,,2005.0,3,0,3
YE,ID,2018.0,3,0,3
NG,CD,2021.0,2,0,2
,SJ,2019.0,1,0,1
UG,DK,2021.0,2,0,2
,HK,2019.0,45,0,45
GH,EG,2022.0,4,0,4
HR,AR,2007.0,2,0,2
nan,GH,2009.0,2,0,2
,SJ,2010.0,7,0,7
SJ,,2020.0,4,0,4
BE,PS,2007.0,1,0,1
JP,VE,2017.0,2,0,2
BO,GB,2020.0,3,0,3
LB,SE,2019.0,5,0,5
ES,TH,2009.0,1,0,1
GB,PR,2011.0,1,0,1
PG,CN,2004.0,1,0,1
TW,EE,2021.0,1,0,1
ID,CW,2018.0,2,0,2
SE,ET,1997.0,3,0,3
PL,UZ,2008.0,2,0,2
DK,ID,2001.0,1,0,1
ZA,PK,2003.0,3,0,3
KE,HU,2022.0,1,0,1
KR,CL,2011.0,4,0,4
MY,FI,2020.0,4,0,4
SA,FJ,2018.0,1,0,1
CO,PL,2020.0,2,0,2
NL,IS,2007.0,2,0,2
,PF,2009.0,10,0,10
HR,SG,2020.0,1,0,1
BG,KZ,2016.0,2,0,2
MA,CG,2017.0,3,0,3
PT,SI,2006.0,1,0,1
KZ,RO,2017.0,4,0,4
PL,CO,2012.0,1,0,1
HK,BG,2013.0,1,0,1
MK,MW,2020.0,1,0,1
BY,LU,2010.0,2,0,2
RO,CH,2000.0,2,0,2
IN,SN,2018.0,1,0,1
DE,TN,2003.0,3,0,3
JO,FI,2006.0,1,0,1
RO,LV,2017.0,1,0,1
TR,IQ,2012.0,1,0,1
MZ,,2006.0,11,0,11
JP,GE,2019.0,2,0,2
CR,BE,2015.0,1,0,1
AO,JP,2007.0,2,0,2
SK,BR,2016.0,1,0,1
SG,LK,1999.0,1,0,1
VN,BE,2005.0,7,0,7
GD,IN,2015.0,1,0,1
ST,PT,2007.0,1,0,1
CL,DK,2006.0,2,0,2
NI,SE,2003.0,2,0,2
UY,VE,2004.0,1,0,1
KR,HU,2016.0,3,0,3
MX,BA,2014.0,1,0,1
MZ,BY,1997.0,1,0,1
ZA,RE,2010.0,1,0,1
TR,DZ,2014.0,3,0,3
MA,PE,2016.0,1,0,1
KW,SG,2007.0,1,0,1
BE,GP,1997.0,1,0,1
PK,CI,2018.0,1,0,1
AO,CA,2008.0,1,0,1
KE,GR,2021.0,1,0,1
BY,nan,2009.0,2,0,2
BG,LT,2009.0,5,0,5
IE,MW,2019.0,1,0,1
FR,NG,2001.0,1,0,1
JP,HR,2000.0,3,0,3
SY,QA,2019.0,3,0,3
RW,NL,2022.0,1,0,1
CM,NO,2009.0,1,0,1
KE,SZ,2009.0,1,0,1
LV,MK,2020.0,1,0,1
IT,SA,2008.0,3,0,3
LU,DK,2008.0,1,0,1
BG,CL,2004.0,2,0,2
KR,OM,2014.0,1,0,1
TR,UZ,2022.0,3,0,3
ZA,RE,2019.0,1,0,1
CO,CY,2018.0,1,0,1
PK,GN,2014.0,1,0,1
NP,NO,2006.0,2,0,2
LT,TR,2022.0,2,0,2
AF,AE,2018.0,1,0,1
AU,AF,2012.0,1,0,1
NO,AL,2005.0,1,0,1
VG,TN,2020.0,1,0,1
SN,MG,2002.0,1,0,1
GB,AZ,2015.0,1,0,1
UZ,AZ,2015.0,4,0,4
KR,DZ,2005.0,1,0,1
SS,,2011.0,5,0,5
BE,BB,2018.0,1,0,1
TJ,PK,2012.0,2,0,2
AR,GR,2021.0,1,0,1
AU,OM,2021.0,3,0,3
ES,BO,2023.0,4,0,4
SK,ES,2021.0,3,0,3
AU,BH,1998.0,1,0,1
MR,US,2020.0,1,0,1
JO,KE,2015.0,1,0,1
JO,KW,2006.0,1,0,1
BD,LK,2010.0,2,0,2
CO,MY,2011.0,4,0,4
GE,JO,2018.0,1,0,1
MG,,2007.0,7,0,7
ES,VN,2016.0,2,0,2
PT,NZ,2020.0,3,0,3
PS,SA,2015.0,3,0,3
MA,JO,2018.0,2,0,2
,VC,2018.0,1,0,1
VN,MX,2006.0,5,0,5
BR,GT,2009.0,3,0,3
IT,BD,2004.0,2,0,2
PK,AF,2014.0,1,0,1
AR,SI,2005.0,1,0,1
US,AF,2009.0,5,0,5
CA,PE,2003.0,1,0,1
AL,NO,2014.0,1,0,1
NL,BG,2023.0,1,0,1
MX,GR,2006.0,6,0,6
ZA,EG,2002.0,1,0,1
MW,NL,2008.0,1,0,1
CA,NC,2012.0,1,0,1
NZ,TZ,2022.0,1,0,1
,SJ,2017.0,3,0,3
CH,NP,2006.0,1,0,1
CH,MW,2015.0,1,0,1
VG,BR,2014.0,1,0,1
PE,CH,2004.0,1,0,1
AU,PE,2004.0,1,0,1
MY,TN,2003.0,1,0,1
PA,,2000.0,6,0,6
ZW,NG,2008.0,2,0,2
CH,BH,2018.0,1,0,1
NP,AU,1997.0,2,0,2
UA,BE,2017.0,3,0,3
NG,AU,2010.0,4,0,4
NA,MW,2015.0,1,0,1
KW,ES,2007.0,1,0,1
BG,ID,2022.0,1,0,1
LU,RS,2018.0,1,0,1
AM,ZW,2012.0,1,0,1
EC,TH,2022.0,1,0,1
VN,CZ,2003.0,1,0,1
CH,BO,2010.0,1,0,1
HU,QA,2004.0,1,0,1
BH,SA,2004.0,2,0,2
SD,AE,2004.0,1,0,1
IL,CL,2001.0,1,0,1
TH,HU,2001.0,1,0,1
TG,BJ,2012.0,1,0,1
NL,OM,2019.0,1,0,1
SE,LV,2015.0,4,0,4
NA,PK,2009.0,1,0,1
AU,IS,2020.0,2,0,2
FR,ST,2011.0,1,0,1
RS,IE,2001.0,1,0,1
AR,PY,2005.0,1,0,1
IT,ML,2014.0,2,0,2
IT,AL,2007.0,4,0,4
IT,BJ,2013.0,2,0,2
ST,ES,2001.0,1,0,1
US,KP,2016.0,1,0,1
GP,VN,2004.0,1,0,1
CO,EG,1997.0,1,0,1
LA,UZ,2017.0,2,0,2
GE,CA,2005.0,3,0,3
CY,MX,2014.0,1,0,1
EG,SK,1999.0,1,0,1
SZ,SD,2018.0,1,0,1
PR,BR,2015.0,3,0,3
EG,JM,2006.0,1,0,1
SE,LU,2007.0,2,0,2
PY,NL,2019.0,1,0,1
CO,BD,2011.0,1,0,1
KE,MA,2020.0,2,0,2
UA,VN,2005.0,1,0,1
AU,RW,2014.0,1,0,1
ET,NG,2009.0,1,0,1
,TL,2011.0,1,0,1
MW,NG,2010.0,1,0,1
BD,OM,2004.0,1,0,1
PS,,2000.0,4,0,4
PH,ME,2020.0,1,0,1
FJ,CN,2001.0,1,0,1
NC,AU,2006.0,1,0,1
SV,GT,2007.0,1,0,1
SE,CR,2020.0,1,0,1
BD,SA,1999.0,1,0,1
IS,IE,2017.0,2,0,2
ST,ZA,2011.0,1,0,1
PA,NL,2014.0,1,0,1
CI,KE,2013.0,1,0,1
IE,TW,2008.0,4,0,4
BF,SE,2014.0,2,0,2
IN,NP,1997.0,2,0,2
MK,SK,1998.0,1,0,1
HU,ES,1998.0,1,0,1
IS,AT,2022.0,1,0,1
SK,SG,2007.0,1,0,1
GR,PT,1999.0,1,0,1
BN,SA,2020.0,1,0,1
FJ,IN,2011.0,2,0,2
CR,AU,2021.0,1,0,1
PH,QA,2015.0,4,0,4
BO,HN,2010.0,1,0,1
FI,ZA,2010.0,2,0,2
HR,FR,2022.0,5,0,5
ET,KZ,2019.0,1,0,1
MA,IL,2019.0,2,0,2
TH,TJ,2010.0,1,0,1
NL,OM,2017.0,3,0,3
VG,CA,2016.0,2,0,2
BE,GH,2011.0,2,0,2
ML,MR,2018.0,1,0,1
KZ,LV,2022.0,6,0,6
RU,TM,2021.0,1,0,1
DZ,SN,2019.0,1,0,1
UG,OM,2015.0,1,0,1
LK,TT,2016.0,1,0,1
GT,PL,2014.0,1,0,1
IN,BO,2016.0,1,0,1
CO,OM,2006.0,1,0,1
PT,SV,2013.0,1,0,1
GE,TW,2014.0,1,0,1
TW,PS,2017.0,1,0,1
ZM,BH,2014.0,1,0,1
GH,BH,2009.0,1,0,1
MD,CA,2008.0,1,0,1
MG,DE,2011.0,1,0,1
LB,RU,2020.0,1,0,1
NG,NI,2019.0,1,0,1
CO,SA,2022.0,2,0,2
ES,QA,2009.0,8,0,8
AU,WS,2019.0,1,0,1
GD,DE,2015.0,1,0,1
DE,SA,2023.0,1,0,1
MY,SK,2013.0,1,0,1
UA,EG,2004.0,1,0,1
ST,BR,1997.0,3,0,3
IE,TZ,2008.0,1,0,1
IL,IQ,2016.0,1,0,1
CZ,NZ,2012.0,1,0,1
HK,VN,2015.0,1,0,1
PH,GH,2011.0,1,0,1
PK,CD,2015.0,1,0,1
IT,GE,2010.0,1,0,1
AE,VG,2014.0,1,0,1
MA,TW,2016.0,1,0,1
AM,CA,2004.0,1,0,1
nan,GE,1998.0,1,0,1
BT,,2016.0,2,0,2
ID,LU,2021.0,1,0,1
PS,GB,2001.0,1,0,1
BY,LV,2019.0,1,0,1
JO,BH,2003.0,2,0,2
ES,AD,2017.0,3,0,3
BM,GB,2018.0,1,0,1
AL,AR,2013.0,1,0,1
SG,LB,2019.0,2,0,2
UY,CR,2000.0,1,0,1
BR,BO,2006.0,1,0,1
NL,BF,2008.0,1,0,1
LI,,2006.0,3,0,3
PH,LK,2007.0,1,0,1
TR,CL,2005.0,1,0,1
NL,OM,2010.0,1,0,1
SD,DE,2008.0,2,0,2
NG,CH,2008.0,1,0,1
CD,MX,2008.0,1,0,1
SC,,2015.0,2,0,2
LK,SI,2020.0,1,0,1
BG,IN,2019.0,3,0,3
UZ,DE,2002.0,1,0,1
GB,BS,2017.0,1,0,1
SI,BG,2016.0,1,0,1
DZ,SE,2014.0,1,0,1
IR,CH,2003.0,1,0,1
MT,LB,2018.0,1,0,1
GM,BE,2011.0,1,0,1
AR,DO,2001.0,1,0,1
ML,,2000.0,1,0,1
TR,RO,2007.0,2,0,2
CH,CU,1997.0,4,0,4
CM,RO,2014.0,2,0,2
BI,BJ,2010.0,1,0,1
BG,HR,2008.0,1,0,1
SE,CU,2003.0,1,0,1
IS,CN,2003.0,2,0,2
PH,CO,2006.0,1,0,1
LI,FR,2015.0,1,0,1
NA,UG,2021.0,2,0,2
ET,NA,2021.0,1,0,1
SG,KE,2002.0,1,0,1
AU,KY,2019.0,1,0,1
NL,VG,2000.0,1,0,1
CM,PK,2000.0,1,0,1
BI,BJ,2017.0,1,0,1
PE,DO,2001.0,1,0,1
CZ,EG,2023.0,1,0,1
JP,BA,2008.0,1,0,1
QA,NG,2007.0,1,0,1
SD,CI,2012.0,2,0,2
VN,MY,2013.0,1,0,1
PH,ST,2009.0,1,0,1
AE,HR,2017.0,1,0,1
TR,SO,2017.0,1,0,1
UG,NI,2018.0,1,0,1
FI,AE,2004.0,1,0,1
AL,RS,2009.0,1,0,1
KR,BI,2022.0,1,0,1
CY,,2001.0,5,0,5
MN,DE,2004.0,2,0,2
CU,AU,2017.0,3,0,3
HU,UZ,2005.0,1,0,1
US,FM,2019.0,1,0,1
BT,NL,2018.0,1,0,1
CY,NL,1999.0,1,0,1
PK,IS,2022.0,1,0,1
CH,BF,2018.0,2,0,2
ET,ES,2009.0,1,0,1
SN,GN,2012.0,1,0,1
UA,CL,1999.0,2,0,2
PK,KE,2000.0,1,0,1
ZA,LV,2018.0,1,0,1
VE,EC,2004.0,1,0,1
IQ,NZ,2009.0,1,0,1
ID,GR,2013.0,1,0,1
PA,SG,2017.0,1,0,1
HK,DE,2016.0,1,0,1
BN,MM,2017.0,1,0,1
GR,ME,2023.0,1,0,1
RU,UY,2007.0,1,0,1
TZ,NO,2000.0,1,0,1
AU,TJ,2017.0,1,0,1
DZ,IN,2011.0,1,0,1
IN,ZW,2012.0,2,0,2
PT,PL,1998.0,1,0,1
GB,CI,2009.0,1,0,1
EG,nan,2009.0,1,0,1
UG,BR,2014.0,1,0,1
PK,DZ,2022.0,1,0,1
AU,BZ,2015.0,2,0,2
PS,IL,2003.0,2,0,2
GB,GF,2009.0,1,0,1
TW,BG,2010.0,2,0,2
OM,AR,2014.0,1,0,1
BH,TR,2004.0,2,0,2
NG,PE,2004.0,1,0,1
CR,NI,2014.0,1,0,1
,AD,2017.0,1,0,1
CH,ML,2010.0,2,0,2
AO,US,2002.0,1,0,1
AU,PY,2005.0,1,0,1
JP,TN,1998.0,1,0,1
KR,PT,2009.0,3,4,-1
SK,VE,2004.0,1,1,0
PE,UY,2019.0,2,6,-4
PL,RS,2008.0,1,1,0
AE,TH,2017.0,2,1,1
IS,EE,2010.0,1,1,0
HU,BR,2007.0,2,1,1
CU,HU,2002.0,2,1,1
NP,TW,2021.0,1,3,-2
SA,LY,2013.0,1,2,-1
BD,CZ,2018.0,1,1,0
AF,JP,2017.0,1,2,-1
UZ,FR,2007.0,1,1,0
SA,MA,2013.0,3,1,2
AT,MY,2007.0,1,1,0
SK,NL,2018.0,1,4,-3
BG,DK,2009.0,1,3,-2
MD,RO,2007.0,2,1,1
RO,CZ,2010.0,2,11,-9
GR,RU,2016.0,2,2,0
BE,AU,2023.0,3,1,2
LT,FR,2001.0,1,1,0
PG,UY,2018.0,1,1,0
TH,NZ,2007.0,1,6,-5
AE,RS,2018.0,1,2,-1
NO,ID,2017.0,3,2,1
nan,AE,2009.0,1,1,0
LT,AT,2019.0,1,1,0
ES,CD,2013.0,1,1,0
BA,RS,2003.0,1,3,-2
SG,GR,2017.0,1,2,-1
BR,MT,2021.0,1,1,0
PK,TH,2011.0,1,2,-1
KZ,GB,2014.0,3,7,-4
NO,TN,2019.0,1,3,-2
AZ,IT,2008.0,1,2,-1
SA,IL,2016.0,2,1,1
SE,IQ,2017.0,4,6,-2
AR,ST,2004.0,1,1,0
DE,AZ,2016.0,2,2,0
CM,KE,2017.0,3,1,2
IL,NP,2016.0,1,1,0
LI,AT,2003.0,1,1,0
LT,UA,2021.0,3,1,2
PT,GE,2000.0,1,1,0
YE,IN,2011.0,1,2,-1
IL,VE,2010.0,1,1,0
US,GM,2016.0,1,1,0
UY,EC,2021.0,2,5,-3
HR,JP,2021.0,1,2,-1
BR,GA,2018.0,1,2,-1
VG,IN,2014.0,1,1,0
SG,GR,2010.0,1,1,0
RO,FI,2022.0,1,1,0
EG,DK,2013.0,1,5,-4
SI,NL,2004.0,2,2,0
SY,LB,2021.0,3,3,0
MQ,GP,2008.0,1,1,0
IQ,PS,2014.0,2,1,1
NG,RO,2018.0,1,2,-1
IR,BD,2022.0,3,3,0
MZ,PT,2010.0,1,2,-1
US,RE,2008.0,1,2,-1
NL,HR,2006.0,1,5,-4
IS,AU,2017.0,2,1,1
CH,PA,2017.0,1,1,0
MZ,ZA,2018.0,2,1,1
PH,NG,2019.0,1,2,-1
IL,PT,2017.0,2,1,1
SE,QA,2008.0,2,2,0
BW,NG,2007.0,1,2,-1
US,PG,2002.0,1,1,0
ZA,MX,2013.0,1,1,0
AU,BG,2021.0,1,2,-1
AR,TW,2004.0,1,3,-2
MW,ET,2016.0,1,2,-1
AU,GD,2012.0,1,1,0
AT,VN,2010.0,1,1,0
BR,MZ,2009.0,2,2,0
LV,EE,2008.0,1,1,0
ES,GE,2020.0,1,1,0
LT,LB,2017.0,1,1,0
TG,ML,2016.0,1,2,-1
AO,US,2005.0,1,1,0
ES,UG,2007.0,1,1,0
CU,CA,2002.0,1,1,0
CN,UA,2023.0,1,1,0
CL,SE,2000.0,1,3,-2
BY,CZ,2004.0,2,10,-8
CM,GA,2000.0,1,1,0
HR,AT,1997.0,1,2,-1
AR,LB,2018.0,1,1,0
LA,UZ,2010.0,1,1,0
KE,EG,2018.0,1,1,0
TG,BR,2020.0,2,1,1
CH,CL,1999.0,1,1,0
CH,TW,2005.0,2,2,0
JP,SI,2013.0,3,3,0
IL,SE,2008.0,2,3,-1
IR,JO,2013.0,1,2,-1
IS,RO,2003.0,1,1,0
PY,DE,2003.0,1,1,0
JO,KR,2014.0,1,2,-1
TR,RW,2014.0,1,1,0
RW,TR,2016.0,1,2,-1
ZA,SZ,2004.0,1,1,0
DZ,BD,2016.0,1,1,0
PA,CO,2004.0,1,1,0
AG,BR,2016.0,2,1,1
QA,AT,2019.0,1,2,-1
MV,US,2018.0,1,2,-1
BD,NZ,2012.0,2,2,0
PH,NO,2002.0,1,1,0
AR,AE,2012.0,1,1,0
BT,US,2011.0,1,1,0
AZ,IR,2005.0,1,2,-1
PH,AU,1998.0,1,4,-3
SG,FR,2000.0,1,4,-3
BE,LB,2005.0,1,1,0
AM,IR,2021.0,1,1,0
NL,GE,2017.0,1,1,0
JO,EG,2003.0,1,1,0
CH,PH,2001.0,1,2,-1
ZA,RE,2017.0,1,2,-1
NE,DE,2018.0,1,1,0
PA,GB,2012.0,1,7,-6
TT,GB,1999.0,1,1,0
IQ,BA,2006.0,1,1,0
PS,LB,2022.0,1,2,-1
CZ,MY,2011.0,1,2,-1
SD,SE,2021.0,1,1,0
PE,AT,2021.0,1,1,0
BB,CA,2018.0,1,2,-1
LK,IL,2014.0,1,2,-1
CY,RU,2020.0,1,2,-1
CA,RE,2015.0,1,2,-1
EE,LV,2008.0,1,1,0
NL,EE,2022.0,1,1,0
CN,BY,2014.0,1,9,-8
TW,KZ,2020.0,1,2,-1
KE,ZA,2023.0,1,1,0
AZ,KZ,2022.0,1,1,0
NP,CZ,2019.0,1,1,0
BG,SK,2007.0,1,1,0
NE,ML,2022.0,1,1,0
MZ,UA,2022.0,1,3,-2
nan,IE,2005.0,1,1,0
ZA,MY,2013.0,1,4,-3
MU,US,2014.0,1,1,0
CH,ZM,2014.0,2,1,1
SI,SE,2018.0,2,4,-2
BD,JO,2017.0,1,1,0
US,SV,2020.0,4,2,2
DZ,CH,2021.0,1,1,0
DK,LV,2020.0,1,2,-1
NG,SE,2015.0,2,3,-1
CN,PR,2018.0,1,1,0
IN,CL,2009.0,2,1,1
RS,HK,2013.0,1,1,0
UG,TH,2013.0,1,1,0
BE,BF,2008.0,2,2,0
PL,VE,2003.0,1,2,-1
EG,BR,2009.0,1,1,0
JP,IR,2023.0,1,2,-1
GH,NG,2008.0,3,4,-1
AG,IN,2014.0,1,1,0
NP,IT,2016.0,3,2,1
BH,HU,1998.0,1,0,1
SN,GP,2003.0,1,0,1
SV,PE,2007.0,1,0,1
HT,GR,2014.0,1,0,1
DE,MR,2013.0,1,0,1
UA,GW,2009.0,1,0,1
MM,IR,2018.0,1,0,1
IE,TH,2014.0,1,0,1
BE,PG,2011.0,1,0,1
HN,VE,2006.0,1,0,1
CL,KN,2015.0,1,0,1
ID,PH,2006.0,2,0,2
TW,HK,2004.0,2,0,2
QA,AT,2017.0,1,0,1
AF,CR,2016.0,1,0,1
DK,TW,2001.0,2,0,2
IQ,ET,2016.0,1,0,1
ZW,DK,2019.0,1,0,1
DZ,MA,2003.0,1,0,1
GB,KZ,2007.0,1,0,1
SN,KR,2022.0,1,0,1
MA,IE,1999.0,1,0,1
CL,NI,2021.0,1,0,1
CW,CA,2008.0,1,0,1
HU,PK,2010.0,1,0,1
SE,ZW,2014.0,1,0,1
US,TM,2002.0,1,0,1
BY,LT,2016.0,1,0,1
TG,SN,2013.0,1,0,1
BR,UZ,2019.0,1,0,1
NZ,PL,2009.0,2,0,2
IN,HK,2016.0,1,0,1
AD,MX,2016.0,1,0,1
CA,CD,2018.0,1,0,1
LY,RU,2020.0,1,0,1
FR,MU,2007.0,2,0,2
LS,,2010.0,2,0,2
KZ,RO,2010.0,1,0,1
BG,ZA,1999.0,1,0,1
HN,IT,2018.0,1,0,1
nan,TH,2014.0,2,0,2
TZ,CO,2012.0,1,0,1
TW,PH,2005.0,2,0,2
KG,UZ,2006.0,1,0,1
FR,UZ,2015.0,1,0,1
IR,PT,2008.0,1,0,1
,LI,2000.0,2,0,2
BM,,2012.0,2,0,2
CG,NC,2010.0,1,0,1
MW,NG,2019.0,1,0,1
,TD,2012.0,4,0,4
TR,NZ,2002.0,1,0,1
LB,DK,2020.0,1,0,1
LS,GB,2000.0,1,0,1
US,GP,2013.0,1,0,1
CU,QA,2005.0,1,0,1
IT,CW,2013.0,1,0,1
ML,MQ,2015.0,1,0,1
PA,AU,1998.0,1,0,1
TZ,SE,2000.0,1,0,1
SI,IN,2014.0,2,0,2
PH,EG,2007.0,1,0,1
UA,TR,2003.0,1,0,1
NP,GE,2015.0,1,0,1
ZM,BE,2012.0,1,0,1
DO,MX,2004.0,1,0,1
ZA,SL,2004.0,1,0,1
IT,GE,2017.0,1,0,1
GB,SN,2003.0,1,0,1
QA,TN,2023.0,1,0,1
LV,PT,2020.0,1,0,1
JO,ZA,2015.0,1,0,1
BR,SJ,2021.0,1,0,1
SD,RU,2005.0,1,0,1
BA,HU,2022.0,1,0,1
PL,MD,2019.0,1,0,1
SK,KR,2015.0,1,0,1
BD,KR,2001.0,1,0,1
GL,NO,1997.0,1,0,1
MG,CM,2007.0,1,0,1
BE,MW,2009.0,1,0,1
PL,BT,2021.0,1,0,1
KW,JP,2011.0,1,0,1
MQ,JP,2007.0,1,0,1
UG,IS,2009.0,1,0,1
LT,RS,2012.0,1,0,1
TH,NO,2008.0,1,0,1
PK,NI,2022.0,1,0,1
KE,CH,2004.0,2,0,2
CD,SE,2012.0,1,0,1
BA,AL,2016.0,1,0,1
AX,SE,2014.0,1,0,1
NG,LK,2007.0,1,0,1
TN,LB,2020.0,1,0,1
AE,GM,2022.0,1,0,1
FR,MK,2005.0,1,0,1
CA,BN,2000.0,1,0,1
AR,NP,2017.0,1,0,1
SL,CN,2017.0,1,0,1
NG,GY,2018.0,1,0,1
CW,GB,2016.0,1,0,1
YE,PT,2015.0,1,0,1
TJ,US,2011.0,1,0,1
GH,UG,2012.0,1,0,1
BR,OM,2021.0,1,0,1
CZ,CL,2002.0,1,0,1
FJ,GB,2023.0,2,0,2
BW,AU,2002.0,1,0,1
MU,ID,2019.0,1,0,1
SE,CW,2014.0,1,0,1
QA,MT,2010.0,1,0,1
FJ,US,2002.0,1,0,1
CN,LY,2022.0,1,0,1
CZ,JO,2020.0,1,0,1
LV,HR,2019.0,1,0,1
MT,,1998.0,1,0,1
GR,BJ,2019.0,1,0,1
SG,VE,2004.0,1,0,1
SG,BR,1997.0,2,0,2
GB,BO,2001.0,1,0,1
CO,MA,2015.0,1,0,1
NZ,ZM,2015.0,1,0,1
KZ,JM,2009.0,1,0,1
NO,ML,2010.0,1,0,1
RS,BD,2018.0,1,0,1
NO,MN,2016.0,1,0,1
OM,SE,2022.0,1,0,1
KR,NO,2023.0,1,0,1
DE,AE,1997.0,1,0,1
LT,GR,2016.0,1,0,1
GT,CH,2012.0,1,0,1
AU,DO,2016.0,1,0,1
TG,CG,2018.0,1,0,1
IR,AZ,1998.0,1,0,1
BH,DK,2020.0,1,0,1
PG,PK,2011.0,1,0,1
FI,TH,2021.0,1,0,1
YE,QA,2022.0,1,0,1
CM,CG,2012.0,1,0,1
BD,IE,2011.0,1,0,1
BD,BE,2002.0,1,0,1
LT,AT,2017.0,1,0,1
SI,BY,1998.0,1,0,1
VG,MX,2006.0,1,0,1
TW,ZA,2002.0,1,0,1
WS,GB,2022.0,1,0,1
HU,TW,2008.0,1,0,1
KZ,nan,2022.0,1,0,1
CM,ZA,2008.0,1,0,1
PL,GD,2008.0,1,0,1
QA,BD,2005.0,1,0,1
ET,GB,1999.0,1,0,1
AT,AR,2001.0,1,0,1
PK,ER,2013.0,1,0,1
KW,GH,2019.0,1,0,1
PT,PL,1997.0,1,0,1
LY,NG,2015.0,1,0,1
PG,BD,2017.0,1,0,1
PK,PT,2012.0,1,0,1
BN,DE,2016.0,1,0,1
FR,NI,2015.0,1,0,1
IT,CR,2022.0,1,0,1
NL,CG,2020.0,1,0,1
MX,PT,2023.0,1,0,1
PE,KE,2011.0,1,0,1
KW,KR,2000.0,1,0,1
ZA,GD,2013.0,1,0,1
DZ,AU,2004.0,1,0,1
SZ,GB,2015.0,1,0,1
RO,SA,2012.0,1,0,1
PH,NG,2017.0,1,0,1
,SN,2020.0,4,0,4
IN,GH,2004.0,1,0,1
IT,NA,2005.0,1,0,1
BR,RE,2018.0,1,0,1
TR,NZ,2005.0,1,0,1
JP,BF,2015.0,1,0,1
CO,IL,2003.0,1,0,1
PS,TN,2015.0,1,0,1
IN,ID,2023.0,1,0,1
,MM,2020.0,1,0,1
MV,CA,2021.0,1,0,1
GF,,2010.0,1,0,1
SG,LB,2010.0,1,0,1
NP,RU,2020.0,1,0,1
MM,CH,2022.0,1,0,1
TZ,MA,2022.0,1,0,1
UA,SA,2018.0,1,0,1
BR,PT,2019.0,1298,1252,46
US,MX,2020.0,379,542,-163
US,JP,2015.0,1658,1688,-30
AU,GB,2000.0,555,598,-43
BG,NO,2013.0,2,2,0
DE,nan,2020.0,88,68,20
BR,PT,2017.0,1077,1134,-57
CA,IT,2009.0,71,95,-24
AU,US,2004.0,1368,1434,-66
NL,CN,2019.0,172,153,19
US,CH,2021.0,698,657,41
GB,US,2008.0,5144,5222,-78
AU,CN,2020.0,597,541,56
AT,GB,2014.0,111,102,9
US,KR,2009.0,1200,1041,159
CN,NZ,2009.0,29,25,4
NL,US,2004.0,447,459,-12
IN,US,2021.0,2364,2440,-76
IN,GB,2020.0,654,549,105
CH,FR,2004.0,227,280,-53
BR,CN,2012.0,45,63,-18
CN,nan,2006.0,149,185,-36
CO,US,2015.0,280,329,-49
IT,GB,2009.0,441,307,134
DE,GB,1998.0,327,289,38
US,IN,2001.0,617,739,-122
NL,MY,2015.0,12,10,2
BD,SG,2013.0,2,7,-5
JP,US,2016.0,1758,1751,7
EG,DE,2013.0,39,84,-45
US,BR,2000.0,354,287,67
SE,RU,2006.0,26,29,-3
EG,FR,2009.0,16,22,-6
MX,CO,2019.0,435,475,-40
IE,US,2015.0,485,524,-39
US,VN,2018.0,149,87,62
CA,PL,2012.0,27,20,7
AU,FR,2021.0,105,94,11
IR,CA,2013.0,278,123,155
MY,IT,2021.0,37,32,5
MY,SA,2019.0,88,53,35
KR,ID,2019.0,45,48,-3
AR,ES,2009.0,237,248,-11
JP,CN,2006.0,605,387,218
KR,JP,2021.0,290,296,-6
MX,UY,2019.0,20,8,12
ES,US,2004.0,574,538,36
IN,JP,2007.0,112,138,-26
SA,IQ,2020.0,43,43,0
GB,BR,2021.0,201,259,-58
MX,CO,2010.0,178,163,15
MY,SA,2017.0,93,43,50
CN,FR,2007.0,176,352,-176
NO,BR,2004.0,14,13,1
SA,AE,2013.0,17,16,1
AT,NL,2014.0,25,41,-16
NL,CW,2001.0,7,5,2
SA,BD,2020.0,31,33,-2
SE,AT,2008.0,15,13,2
GB,CZ,2012.0,41,29,12
FI,ES,2021.0,25,22,3
CN,SG,2020.0,525,590,-65
AE,EG,2007.0,7,9,-2
GB,JP,2010.0,272,299,-27
JP,GB,2012.0,272,313,-41
JP,DE,1997.0,78,100,-22
RU,IN,2020.0,20,35,-15
SE,CH,2021.0,64,80,-16
MX,nan,2019.0,37,36,1
GB,JP,2017.0,314,278,36
NL,CN,2017.0,135,129,6
DK,DE,2010.0,117,140,-23
DE,KR,2005.0,34,37,-3
UA,CZ,2021.0,20,19,1
CH,PL,2019.0,27,34,-7
PA,CO,2014.0,8,12,-4
CO,NL,2007.0,4,5,-1
GB,IE,2021.0,329,345,-16
PT,BR,1999.0,135,148,-13
GB,DK,2006.0,106,71,35
LB,US,2013.0,97,61,36
CA,JP,2000.0,86,109,-23
GB,JP,2019.0,296,256,40
HK,CN,2021.0,118,162,-44
JP,UZ,2009.0,5,5,0
CL,GB,2020.0,54,64,-10
GB,RO,2020.0,77,59,18
VN,US,2018.0,87,149,-62
DE,BR,2014.0,218,199,19
BE,FR,2007.0,230,262,-32
CO,BR,2013.0,114,101,13
AU,MK,2014.0,45,66,-21
IL,TR,1999.0,3,5,-2
PA,US,2018.0,86,51,35
OM,DE,2011.0,1,4,-3
IT,DE,2004.0,138,141,-3
ES,CH,2015.0,134,74,60
US,PH,2022.0,137,141,-4
PY,MX,2022.0,7,6,1
DE,SE,2017.0,269,271,-2
DE,SE,2019.0,279,244,35
DK,DE,2017.0,172,202,-30
SG,CN,1998.0,37,62,-25
NZ,AU,2003.0,111,96,15
AT,JP,2002.0,4,8,-4
JP,AT,2004.0,6,5,1
DK,FI,2001.0,6,6,0
IN,SA,2016.0,156,88,68
IE,ES,2010.0,20,20,0
ES,EG,2014.0,9,6,3
NO,nan,2010.0,35,37,-2
NL,CN,2010.0,86,88,-2
IE,ES,2019.0,43,51,-8
KR,CA,2019.0,78,61,17
NZ,CA,2013.0,73,73,0
IN,DE,2013.0,183,161,22
NZ,DE,2012.0,39,34,5
PK,FR,2010.0,13,4,9
SE,IQ,2018.0,10,2,8
NO,GB,2019.0,98,128,-30
DE,TH,2004.0,11,8,3
KR,CA,2017.0,81,57,24
FR,JP,2016.0,153,172,-19
US,NZ,2022.0,203,193,10
IN,FR,2014.0,120,126,-6
AT,PK,2016.0,8,3,5
PK,BD,2012.0,26,33,-7
CA,SK,2003.0,4,6,-2
CH,KR,2020.0,26,24,2
GB,MW,2013.0,16,10,6
IE,ES,2017.0,29,44,-15
FR,CL,2014.0,58,42,16
TN,FR,2015.0,162,242,-80
BO,ES,2011.0,8,9,-1
AU,JP,2015.0,76,79,-3
BR,AR,2013.0,123,160,-37
LB,EG,2007.0,3,2,1
MA,FR,2015.0,232,304,-72
HR,US,2020.0,39,25,14
DE,IT,2007.0,152,189,-37
IT,BR,2005.0,107,102,5
PL,CH,2022.0,23,13,10
MX,nan,2017.0,41,33,8
IT,CA,2020.0,159,120,39
IR,IN,2016.0,30,50,-20
IE,CA,2022.0,78,71,7
KR,ID,2017.0,50,16,34
DE,VN,2019.0,43,10,33
TW,BH,2012.0,5,2,3
JP,SE,2013.0,35,31,4
nan,DE,2014.0,79,75,4
CO,DE,2015.0,27,27,0
CN,IT,2003.0,24,21,3
DE,SE,2010.0,177,181,-4
CA,IN,2009.0,124,143,-19
DE,RU,2008.0,131,205,-74
RU,CH,2016.0,31,34,-3
RU,CN,2004.0,35,21,14
CN,MY,2015.0,114,65,49
VN,FR,2005.0,8,10,-2
SE,BR,1997.0,10,1,9
CN,SY,2014.0,28,19,9
GR,GB,2015.0,309,174,135
CY,JP,2006.0,2,2,0
RU,DE,2011.0,167,148,19
AZ,RU,2006.0,5,6,-1
IT,PT,2010.0,28,20,8
SE,MX,2017.0,9,13,-4
JP,FR,2008.0,105,108,-3
KR,NP,2021.0,13,13,0
PT,nan,2008.0,33,26,7
IT,CR,2016.0,6,2,4
US,SA,2001.0,37,46,-9
MX,CL,2011.0,147,110,37
HU,US,2018.0,105,97,8
IN,CZ,2010.0,22,10,12
CN,NL,2020.0,159,153,6
ES,SK,2011.0,4,4,0
KZ,CN,2018.0,8,5,3
US,CO,1999.0,33,43,-10
BE,FI,2019.0,14,21,-7
TW,GB,2012.0,67,67,0
BE,IE,2021.0,9,11,-2
NO,GB,2010.0,41,84,-43
BR,CA,1999.0,44,36,8
ES,IT,2001.0,68,71,-3
UA,PL,2020.0,58,58,0
PL,UA,2021.0,44,62,-18
nan,TR,2013.0,10,16,-6
BR,PL,2020.0,27,20,7
FR,IT,2003.0,207,178,29
IN,MY,2008.0,42,30,12
CN,IQ,2022.0,8,5,3
AT,CA,2021.0,25,25,0
BE,US,2020.0,383,405,-22
SK,CZ,2008.0,67,48,19
CZ,RS,2019.0,21,11,10
DE,KR,2002.0,19,22,-3
AE,LY,2019.0,2,2,0
IT,PT,2019.0,55,46,9
UA,DE,1998.0,18,9,9
IT,AT,2011.0,37,31,6
CA,EG,2016.0,90,66,24
KE,BE,2021.0,4,6,-2
CA,HR,2020.0,10,3,7
EG,QA,2006.0,2,10,-8
FR,TN,2014.0,218,153,65
MX,PE,2014.0,98,94,4
SE,DE,2018.0,219,271,-52
DE,JO,2011.0,13,12,1
PT,IT,2012.0,27,44,-17
RO,ZA,2022.0,6,3,3
US,MZ,2022.0,1,5,-4
EC,CO,2015.0,35,103,-68
IN,NL,2014.0,48,49,-1
FR,CM,2019.0,41,16,25
CA,IE,2021.0,157,114,43
TW,CO,2017.0,2,2,0
RU,AU,2016.0,21,53,-32
KR,CA,2010.0,52,51,1
PL,BR,2021.0,24,26,-2
DE,JP,2004.0,150,167,-17
RO,US,2013.0,71,98,-27
PK,FR,2019.0,15,19,-4
VN,GB,2022.0,14,11,3
RS,HR,2007.0,50,72,-22
BD,JP,2014.0,48,69,-21
BR,VN,2019.0,1,1,0
ES,CO,2023.0,4,7,-3
SY,FR,2012.0,6,9,-3
IT,DZ,2015.0,41,24,17
ZA,IT,2011.0,9,14,-5
GB,IL,2016.0,60,84,-24
VE,ES,2009.0,97,74,23
ET,KR,2021.0,72,100,-28
GB,EG,2014.0,106,70,36
TR,BE,2021.0,16,17,-1
NL,BD,2014.0,2,5,-3
SI,CN,2022.0,5,2,3
IR,PK,2016.0,10,13,-3
DE,EG,2012.0,52,39,13
CZ,PL,2019.0,86,105,-19
ZA,IN,2008.0,25,34,-9
CZ,PL,2010.0,31,37,-6
IE,IN,2002.0,5,3,2
RU,BY,2020.0,84,102,-18
FR,TW,2003.0,23,29,-6
TR,BR,2016.0,30,21,9
IQ,AE,2012.0,2,3,-1
IN,MX,2017.0,22,16,6
DE,GB,1997.0,243,217,26
FR,PL,2015.0,46,40,6
FR,NE,2015.0,22,16,6
GB,FI,2016.0,81,76,5
SA,US,2015.0,131,239,-108
PT,IL,2016.0,1,4,-3
CA,CH,2014.0,146,120,26
CR,DE,2015.0,5,9,-4
ES,MA,2017.0,14,8,6
ES,RO,2017.0,21,15,6
FI,EE,2017.0,18,11,7
IE,TW,2013.0,3,5,-2
CO,CZ,2018.0,2,1,1
ID,BD,2018.0,34,54,-20
HR,GB,2014.0,21,21,0
TH,US,2012.0,122,206,-84
KR,DE,2020.0,81,64,17
SG,BD,2013.0,7,2,5
IR,BR,2012.0,14,4,10
US,BE,2021.0,294,295,-1
IT,AR,2006.0,59,45,14
HR,BA,2011.0,27,21,6
ID,DE,2016.0,18,41,-23
BR,ES,2000.0,96,112,-16
DK,PT,2019.0,11,13,-2
ES,RO,2019.0,24,12,12
SG,IR,2016.0,47,42,5
US,UA,2016.0,61,67,-6
DK,FJ,2015.0,1,1,0
BR,EG,2016.0,5,2,3
MX,BE,2002.0,4,1,3
BE,MX,2003.0,7,1,6
MX,GB,2005.0,28,33,-5
TR,JP,2021.0,55,53,2
ZW,ZA,2020.0,52,53,-1
AU,TR,2022.0,9,8,1
GB,GH,2022.0,13,12,1
ZA,SE,2016.0,8,16,-8
ZA,ZW,2020.0,53,52,1
ID,NL,2021.0,35,47,-12
CZ,PL,2017.0,56,86,-30
CN,PK,2023.0,25,30,-5
CH,IN,2007.0,22,30,-8
MY,SA,2010.0,14,13,1
CZ,NO,2016.0,47,5,42
NL,FI,1997.0,6,4,2
PA,ES,2020.0,16,17,-1
IR,PT,2013.0,15,3,12
FI,CN,2007.0,16,18,-2
CA,nan,2015.0,39,149,-110
IE,NL,2018.0,21,28,-7
GR,ES,2015.0,22,17,5
AU,IE,2018.0,140,119,21
PE,CR,2020.0,6,23,-17
MZ,ZA,2019.0,2,8,-6
CL,CU,2014.0,15,22,-7
FI,EE,2010.0,10,4,6
TZ,NG,2020.0,6,5,1
US,MW,2020.0,20,18,2
MX,SI,2015.0,8,6,2
IT,JP,2021.0,38,36,2
RS,TR,2007.0,78,54,24
AE,CA,2012.0,14,25,-11
GB,TH,2006.0,50,14,36
PK,FR,2017.0,16,16,0
JO,MY,2018.0,14,21,-7
FI,RU,2016.0,43,30,13
RS,ME,2018.0,19,19,0
EE,RU,2012.0,9,10,-1
MY,PT,2015.0,1,3,-2
TR,DE,2021.0,90,72,18
GH,ZM,2021.0,25,16,9
DE,ES,2006.0,128,106,22
TN,GB,2019.0,6,5,1
AU,NL,1998.0,22,20,2
ES,AU,2022.0,34,42,-8
AT,CZ,2021.0,46,30,16
KR,HU,2022.0,1,1,0
BR,AO,2022.0,29,28,1
CA,MA,2019.0,26,19,7
KR,IE,2008.0,3,5,-2
SG,DK,2019.0,8,4,4
PK,MA,2010.0,5,14,-9
AZ,IT,2013.0,6,4,2
PH,BE,2020.0,5,3,2
GE,US,2014.0,176,170,6
RO,CZ,2018.0,7,4,3
US,RE,2013.0,4,2,2
NG,IN,2022.0,17,19,-2
CO,IT,2020.0,29,17,12
CH,GB,2000.0,104,96,8
DK,NL,2022.0,33,34,-1
ZA,KE,2022.0,6,20,-14
IN,IT,2003.0,41,31,10
ZM,GB,2015.0,5,6,-1
NZ,TH,2019.0,7,3,4
EG,AU,2019.0,32,20,12
IE,MY,2012.0,5,6,-1
SG,CA,1997.0,11,6,5
NO,GB,2017.0,89,139,-50
ES,CA,2015.0,113,99,14
IR,IE,2012.0,5,5,0
CL,FR,2015.0,37,64,-27
DK,AU,2015.0,50,34,16
JO,AE,2010.0,11,3,8
AR,BR,2014.0,141,144,-3
GB,BE,1999.0,57,57,0
US,VU,2020.0,1,1,0
ZA,CA,2015.0,45,43,2
IE,CZ,2022.0,3,3,0
AT,IN,2007.0,4,15,-11
IR,FI,2016.0,15,7,8
CN,UA,2000.0,5,13,-8
IT,SA,2013.0,19,3,16
IE,QA,2019.0,2,3,-1
RS,DE,2018.0,28,19,9
FR,SI,2015.0,11,8,3
IT,CL,2010.0,16,15,1
EG,OM,1998.0,1,3,-2
CZ,UA,2009.0,7,25,-18
MA,PT,2017.0,10,27,-17
PH,DE,2010.0,4,10,-6
PH,DE,2017.0,12,11,1
NO,nan,2017.0,21,26,-5
RO,ES,2011.0,7,19,-12
DK,CN,2021.0,74,63,11
GB,RS,2006.0,13,21,-8
DK,BE,2005.0,7,9,-2
PL,BD,2010.0,10,1,9
JP,DE,1998.0,118,108,10
AO,BR,2006.0,9,8,1
CH,IT,2011.0,192,278,-86
CH,NL,2012.0,72,109,-37
EE,DE,2015.0,51,54,-3
AG,BR,2022.0,3,1,2
CL,JP,2011.0,8,5,3
CH,PL,2017.0,31,39,-8
US,BH,2004.0,3,6,-3
BE,CH,2001.0,26,25,1
IT,MY,2016.0,48,62,-14
SA,GB,2015.0,61,137,-76
NL,LU,2016.0,8,5,3
GB,BD,2009.0,31,28,3
nan,RU,2015.0,59,28,31
ET,SE,2016.0,6,5,1
NP,DE,2012.0,3,3,0
SG,CA,1998.0,10,21,-11
ZA,BR,2018.0,15,23,-8
DK,RS,2005.0,2,4,-2
SE,MX,2019.0,16,12,4
ET,DE,2020.0,14,19,-5
US,CY,2007.0,20,8,12
AT,NO,2015.0,16,3,13
SE,MZ,2017.0,2,3,-1
CH,DK,2009.0,38,20,18
CR,US,2014.0,28,37,-9
EE,CH,2015.0,13,6,7
SD,DE,2013.0,5,8,-3
KE,EG,2017.0,3,2,1
DK,RU,2018.0,14,11,3
SD,JP,2017.0,2,1,1
PT,CO,2019.0,18,17,1
MX,GB,2002.0,33,43,-10
AU,JO,2018.0,14,7,7
IL,SE,2013.0,4,6,-2
FR,TR,2014.0,28,19,9
HU,FR,2003.0,29,11,18
SA,JO,2006.0,2,8,-6
nan,UA,2008.0,16,12,4
CH,PL,2010.0,10,24,-14
PT,BG,2007.0,1,1,0
ES,JP,2014.0,42,41,1
BR,PE,2007.0,15,16,-1
DK,PT,2017.0,9,7,2
JP,NL,2000.0,34,25,9
CA,ET,2021.0,4,8,-4
HU,SE,2015.0,18,11,7
UA,EC,2003.0,5,8,-3
MX,CR,2008.0,16,19,-3
IN,IE,2013.0,20,30,-10
JP,IR,2000.0,6,2,4
IT,PT,2017.0,44,47,-3
AR,PT,2019.0,26,16,10
FI,NO,2004.0,8,8,0
BR,EC,2018.0,66,46,20
FR,MD,2004.0,47,57,-10
JP,PL,2016.0,32,13,19
US,HK,2016.0,15,13,2
IN,MX,2019.0,25,17,8
PE,US,2002.0,21,28,-7
DE,PK,2005.0,5,12,-7
AU,NL,1997.0,13,16,-3
KR,PR,2001.0,19,38,-19
nan,MX,2016.0,35,25,10
CU,CL,2016.0,26,15,11
CN,BR,2002.0,5,10,-5
FI,AU,2007.0,6,11,-5
DE,NG,2015.0,11,5,6
BG,FR,2006.0,6,10,-4
FR,RO,2011.0,43,48,-5
SE,DK,2002.0,55,48,7
BG,RU,2020.0,35,26,9
CR,AR,2018.0,19,17,2
MX,nan,2010.0,24,12,12
SG,FR,2023.0,2,1,1
US,ID,2004.0,21,22,-1
ES,CZ,2022.0,10,15,-5
VN,IT,2016.0,6,4,2
AE,PK,2021.0,16,26,-10
SK,NL,2017.0,7,8,-1
MY,JO,2016.0,17,17,0
TG,FR,2015.0,3,6,-3
JP,LT,2006.0,17,5,12
CA,MA,2017.0,23,21,2
BD,CA,2015.0,41,37,4
MX,KE,2018.0,1,1,0
TW,ES,2004.0,2,2,0
nan,DK,2018.0,11,20,-9
PT,MX,2009.0,11,13,-2
ST,MZ,2018.0,3,1,2
PA,MX,2020.0,17,10,7
BD,JO,2018.0,1,1,0
DE,VN,2010.0,9,10,-1
ML,FR,2001.0,1,1,0
TH,AU,2004.0,10,20,-10
CL,CR,2019.0,41,33,8
OM,EG,2015.0,9,9,0
RU,KR,2005.0,18,11,7
KW,GB,2016.0,12,18,-6
IS,SE,2021.0,12,21,-9
MY,LB,2014.0,3,2,1
nan,DZ,2017.0,9,7,2
BR,NG,2016.0,10,8,2
NL,IT,2006.0,54,67,-13
AU,HK,2021.0,3,4,-1
GH,EG,2016.0,7,2,5
IT,CO,2013.0,15,16,-1
US,GM,2022.0,1,1,0
GB,KW,2010.0,12,14,-2
CH,TN,2019.0,9,12,-3
CH,CR,2020.0,4,1,3
LT,TR,2016.0,1,2,-1
BD,OM,2014.0,2,3,-1
GB,RU,2007.0,52,84,-32
EG,VN,2017.0,5,4,1
GA,FR,2014.0,7,12,-5
TR,SA,2022.0,7,10,-3
US,KH,2021.0,6,4,2
SE,KE,2017.0,5,4,1
ES,IN,2011.0,27,16,11
UY,AR,2016.0,40,33,7
SG,CN,1997.0,30,38,-8
IR,TN,2011.0,4,5,-1
CZ,BR,1998.0,5,1,4
MX,UY,2017.0,16,17,-1
nan,DZ,2019.0,8,10,-2
IT,TW,2018.0,5,4,1
TN,US,2013.0,17,19,-2
CN,AT,2016.0,20,14,6
DE,VN,2017.0,27,17,10
BR,VE,2012.0,17,11,6
PR,KR,2013.0,26,38,-12
IS,RU,2010.0,1,1,0
LB,FR,2018.0,80,129,-49
FR,AM,2013.0,4,1,3
SK,NL,2019.0,6,3,3
MA,PT,2019.0,26,35,-9
AT,JP,2005.0,11,9,2
CN,BR,2005.0,21,17,4
ET,PL,2021.0,2,1,1
PH,KR,2007.0,3,2,1
KH,KE,2019.0,1,2,-1
CH,EC,2016.0,3,2,1
MD,FR,1997.0,42,21,21
DE,GE,2004.0,9,2,7
GR,CY,2014.0,61,30,31
BR,RU,2005.0,8,7,1
RU,BR,2006.0,8,11,-3
LI,CH,2021.0,3,1,2
PL,FR,2003.0,34,28,6
CA,FI,1999.0,9,9,0
PE,US,2005.0,34,26,8
PL,IE,2009.0,8,3,5
NL,HU,2011.0,16,13,3
MZ,PL,2009.0,6,3,3
AT,ES,2000.0,9,5,4
CZ,RS,2010.0,10,8,2
SK,DE,2002.0,22,16,6
CH,IL,2007.0,12,12,0
FR,NZ,2004.0,10,1,9
TN,DE,2015.0,3,3,0
PL,JP,2007.0,23,9,14
AU,IT,2013.0,47,84,-37
IT,MA,2008.0,11,7,4
CH,RO,2013.0,14,14,0
RU,PL,1998.0,11,7,4
QA,AU,2005.0,4,6,-2
nan,FI,2004.0,7,5,2
RS,MX,2014.0,2,6,-4
LU,IT,2006.0,1,1,0
AT,EE,2012.0,7,2,5
JP,NP,2015.0,9,7,2
RU,FR,2011.0,74,51,23
BR,FI,2020.0,18,11,7
CO,CN,2009.0,2,2,0
MX,RU,2006.0,9,10,-1
SK,NL,2010.0,6,5,1
UA,MX,2005.0,2,2,0
UY,CA,2015.0,2,2,0
HR,SE,2010.0,3,2,1
JP,KE,2014.0,10,3,7
BD,CH,2009.0,1,2,-1
BE,RO,2008.0,12,6,6
FR,AE,2011.0,11,7,4
IL,BD,2012.0,2,4,-2
BG,PL,2000.0,5,2,3
AT,SE,2004.0,9,9,0
SE,UA,2019.0,9,5,4
SY,QA,2018.0,1,1,0
GB,KW,2017.0,19,12,7
DZ,CA,2009.0,4,7,-3
MW,ZA,2013.0,2,1,1
IN,CZ,2019.0,23,15,8
US,BO,2006.0,4,5,-1
NO,nan,2019.0,18,43,-25
CO,FR,2004.0,12,10,2
JO,LB,2014.0,6,1,5
LT,FI,2020.0,4,3,1
NZ,TH,2017.0,6,7,-1
IT,IR,2005.0,2,4,-2
SG,MX,2015.0,6,2,4
SG,TH,2017.0,6,8,-2
SA,IE,2007.0,1,1,0
MM,US,2015.0,9,7,2
IL,CN,2021.0,27,28,-1
AL,TR,2014.0,1,1,0
MT,CA,2011.0,1,2,-1
AR,nan,2022.0,22,15,7
SG,MY,2007.0,47,32,15
AR,NL,2015.0,12,5,7
AU,KW,2014.0,1,3,-2
KW,EG,2008.0,10,11,-1
BG,AT,2003.0,2,1,1
US,ZM,2021.0,14,14,0
IN,CZ,2017.0,24,17,7
MX,RS,2006.0,27,26,1
CY,ES,2009.0,1,3,-2
SE,PT,2018.0,10,17,-7
KE,JP,2009.0,5,6,-1
IE,RU,2021.0,8,3,5
NO,PT,2015.0,8,13,-5
DE,SI,2008.0,9,7,2
SE,BR,1998.0,7,5,2
RO,BR,2008.0,2,2,0
NO,ID,2018.0,11,5,6
BE,LU,2016.0,25,15,10
IR,GR,2019.0,3,2,1
SJ,NO,2001.0,2,1,1
SI,ME,2021.0,1,1,0
ID,IN,2008.0,4,1,3
JP,ZA,2010.0,5,9,-4
AR,PT,2017.0,14,18,-4
UG,GB,2004.0,7,2,5
GB,MT,2012.0,12,7,5
RO,IT,2004.0,13,9,4
BR,RU,2002.0,12,11,1
MM,CN,2001.0,9,6,3
NL,FI,1998.0,16,11,5
CH,EG,2020.0,3,5,-2
QA,ES,2022.0,2,3,-1
MY,nan,2007.0,17,10,7
KE,FR,2003.0,5,1,4
IL,BE,2006.0,9,4,5
SK,RS,2016.0,12,11,1
SA,BR,2018.0,3,4,-1
BB,US,2013.0,3,4,-1
GE,IN,2019.0,1,6,-5
SI,FR,2013.0,13,9,4
IQ,ET,2022.0,1,1,0
PL,SE,2016.0,17,30,-13
TR,RU,2018.0,13,2,11
GR,RO,2008.0,4,1,3
AE,TR,2021.0,7,4,3
GT,MX,2013.0,17,12,5
RU,KR,2002.0,9,7,2
UG,NG,2017.0,3,6,-3
IR,AT,2012.0,11,7,4
AT,TH,2002.0,2,1,1
AR,RU,2020.0,4,1,3
CN,NO,2021.0,23,29,-6
IT,HU,2011.0,7,14,-7
PH,DE,2019.0,12,9,3
RU,ES,2014.0,15,21,-6
FR,ES,2023.0,15,7,8
ET,SA,2019.0,1,2,-1
KW,US,2008.0,16,21,-5
TW,AE,2017.0,2,2,0
SI,HR,2003.0,5,8,-3
EG,AU,2017.0,14,15,-1
HU,AU,2000.0,6,7,-1
PH,ES,2009.0,12,14,-2
GB,PT,2000.0,37,30,7
UY,US,2004.0,12,3,9
FR,IL,2008.0,30,35,-5
SE,UA,2017.0,10,8,2
CO,SA,2016.0,1,2,-1
US,IE,2023.0,10,13,-3
VN,SG,2012.0,4,8,-4
TZ,US,2007.0,10,9,1
MX,QA,2014.0,2,1,1
ID,PL,2021.0,4,5,-1
AT,NZ,2021.0,4,4,0
CN,SD,2014.0,6,3,3
MW,NG,2018.0,1,2,-1
GB,NG,2004.0,12,12,0
IT,BD,2014.0,9,10,-1
US,AL,2016.0,2,1,1
PT,CN,2022.0,11,10,1
UY,IT,2016.0,12,9,3
CA,SE,2001.0,20,35,-15
CN,ZA,2013.0,12,14,-2
BW,ZA,2020.0,13,11,2
SK,DE,2005.0,25,22,3
ZM,NP,2016.0,1,1,0
PL,BD,2019.0,4,5,-1
MK,GB,2015.0,8,4,4
LV,RU,2011.0,16,14,2
nan,HU,2009.0,3,1,2
DE,BA,2012.0,2,2,0
CA,MA,2010.0,15,9,6
FR,ZA,1999.0,5,6,-1
AU,WS,2018.0,1,1,0
PK,MA,2017.0,19,20,-1
nan,DZ,2010.0,8,1,7
US,BW,2003.0,4,7,-3
ES,MA,2019.0,12,4,8
ZW,GB,2008.0,6,2,4
BE,UG,2013.0,5,8,-3
GE,PK,2015.0,1,1,0
NG,AU,2018.0,8,18,-10
LV,EE,2013.0,3,4,-1
BE,RS,2001.0,1,1,0
AU,DK,2008.0,26,17,9
PL,RU,2011.0,16,22,-6
PH,SE,2015.0,3,1,2
EG,AU,2010.0,6,5,1
BD,AU,2002.0,7,3,4
ES,PK,2008.0,1,2,-1
AR,AT,2008.0,3,1,2
ES,MA,2010.0,9,4,5
DK,IT,2016.0,31,44,-13
JO,AE,2019.0,39,19,20
ZA,NO,2011.0,6,4,2
JP,CL,2020.0,8,8,0
GM,GB,2001.0,7,2,5
CH,ZW,2006.0,1,2,-1
KR,BE,2007.0,4,2,2
AT,SI,2000.0,3,3,0
NZ,LK,2009.0,1,1,0
IN,MX,2010.0,8,12,-4
NZ,TH,2010.0,3,6,-3
NZ,FI,2007.0,5,2,3
RU,ZA,1997.0,3,1,2
CZ,RO,2018.0,4,7,-3
IN,HU,2001.0,17,5,12
DK,GL,2014.0,4,3,1
TH,SA,2015.0,3,2,1
FI,EE,2019.0,12,12,0
US,TZ,2008.0,9,3,6
US,TT,2009.0,6,6,0
GN,SN,2016.0,3,2,1
PS,EG,2008.0,1,3,-2
CH,BF,2010.0,2,1,1
NZ,SA,2016.0,4,5,-1
CO,RU,2008.0,2,2,0
SE,UA,2010.0,6,9,-3
NO,SJ,2012.0,5,5,0
MK,NZ,2015.0,1,1,0
PE,NL,2021.0,2,1,1
CR,EC,2014.0,6,4,2
NG,KE,2018.0,5,11,-6
IR,BE,2018.0,27,27,0
ES,TR,2000.0,4,1,3
JM,TT,2015.0,15,22,-7
PT,AU,2009.0,9,15,-6
OM,SA,2003.0,2,1,1
EG,LB,2009.0,6,7,-1
ET,LK,2010.0,1,1,0
IN,PH,2006.0,4,5,-1
MY,ID,2023.0,2,6,-4
MY,GH,2021.0,3,2,1
MA,US,2008.0,9,9,0
EE,US,1998.0,3,5,-2
AU,SK,2004.0,1,3,-2
LU,CN,2014.0,3,2,1
MX,UY,2010.0,10,5,5
NL,MX,2016.0,16,15,1
RS,CZ,2018.0,14,26,-12
US,MG,2019.0,10,4,6
PY,BR,2012.0,3,3,0
PE,PY,2012.0,2,1,1
CU,PT,2014.0,4,3,1
IQ,PK,2015.0,8,12,-4
EE,SE,2000.0,11,6,5
FR,LU,2004.0,20,9,11
IN,TT,2007.0,3,1,2
RU,PL,1997.0,5,7,-2
SE,MX,2010.0,2,7,-5
LK,CA,2015.0,3,5,-2
LB,BE,2021.0,11,4,7
SI,GB,2002.0,3,6,-3
DE,GH,2021.0,12,16,-4
GB,HR,2000.0,1,1,0
IN,ES,2007.0,14,10,4
AR,TW,2014.0,17,7,10
ES,TN,2001.0,1,1,0
UG,CG,2021.0,1,2,-1
BA,DE,2020.0,5,3,2
IN,AE,2023.0,4,5,-1
TN,GB,2010.0,3,8,-5
PT,ZA,2015.0,5,3,2
TH,MM,2014.0,4,1,3
BE,TW,2022.0,5,3,2
UZ,CN,2014.0,5,11,-6
BE,MY,2021.0,2,7,-5
IR,OM,2020.0,16,2,14
CH,TN,2017.0,15,13,2
RO,CA,2003.0,7,5,2
IT,BJ,2008.0,1,1,0
AU,KE,2022.0,4,4,0
UY,NL,2021.0,2,2,0
IN,IR,2011.0,43,27,16
ES,SA,2021.0,12,3,9
CU,DE,2018.0,6,5,1
US,FJ,2012.0,6,5,1
IE,TR,2022.0,5,5,0
IQ,QA,2021.0,16,8,8
BD,DE,2007.0,3,3,0
CN,RO,2020.0,10,10,0
NG,NZ,2012.0,2,1,1
MY,FR,2012.0,12,13,-1
RO,NZ,2019.0,2,1,1
BH,PL,2022.0,7,6,1
IT,NG,2004.0,6,4,2
ML,MR,2019.0,1,1,0
BE,IT,1997.0,19,24,-5
ZA,NG,2008.0,6,14,-8
SE,GE,1997.0,1,1,0
CH,TN,2010.0,5,9,-4
DE,AM,1998.0,1,4,-3
MA,BD,2015.0,11,4,7
ES,nan,2013.0,33,41,-8
GR,NL,2008.0,12,10,2
MX,ID,2019.0,10,2,8
CZ,DE,2007.0,40,62,-22
SA,PK,2007.0,10,13,-3
KW,AU,2007.0,2,1,1
SA,TR,2012.0,8,7,1
UG,nan,2020.0,2,1,1
CU,PY,2019.0,11,5,6
MX,SE,2007.0,6,5,1
KZ,TR,2023.0,6,5,1
UG,NG,2019.0,7,13,-6
HR,CH,2015.0,6,4,2
SI,NL,2014.0,3,5,-2
IT,PH,2022.0,1,2,-1
BH,SA,2014.0,7,4,3
IN,PL,2008.0,3,4,-1
KR,NZ,2002.0,1,2,-1
VE,EC,2014.0,22,4,18
CH,QA,2020.0,1,2,-1
DK,BE,2002.0,8,12,-4
FR,EG,1997.0,4,2,2
XK,HR,2020.0,3,3,0
BO,PE,2011.0,3,2,1
PL,HR,2018.0,4,5,-1
CN,HR,2007.0,3,1,2
NG,TN,2017.0,3,2,1
UG,NG,2010.0,2,5,-3
ID,TW,2012.0,4,12,-8
ZA,DE,1999.0,9,14,-5
VE,AR,2008.0,19,8,11
GA,NL,2003.0,3,3,0
TW,MY,2009.0,8,11,-3
PL,GB,2001.0,23,37,-14
TR,IE,2012.0,3,6,-3
NZ,FJ,2012.0,2,3,-1
AT,TH,2005.0,2,3,-1
IL,CY,2019.0,2,3,-1
CZ,KR,2012.0,5,5,0
AU,LB,2020.0,6,5,1
BW,ZW,2015.0,3,2,1
MK,BG,2008.0,1,4,-3
BD,PT,2021.0,2,1,1
PH,BR,2013.0,5,6,-1
DK,PT,2010.0,6,4,2
SG,IN,2023.0,2,4,-2
SI,GB,2005.0,8,4,4
SE,KE,2010.0,3,6,-3
CH,BF,2019.0,1,3,-2
HR,IE,2004.0,4,1,3
CH,PT,2004.0,4,5,-1
RU,NO,2013.0,7,24,-17
ES,PA,2003.0,7,8,-1
ME,RS,2022.0,12,11,1
GB,KW,2019.0,17,10,7
BR,BG,2005.0,1,1,0
AT,RU,2006.0,9,5,4
SE,TH,2005.0,4,3,1
NP,CA,2005.0,2,1,1
IT,PL,2008.0,13,23,-10
CL,BE,2013.0,4,11,-7
JP,LK,1999.0,8,9,-1
EE,LV,2013.0,4,3,1
AT,SA,2009.0,4,3,1
MD,MA,2011.0,8,5,3
ID,NZ,2016.0,4,12,-8
ES,CY,2009.0,3,1,2
BE,CL,2018.0,18,8,10
CR,CL,2012.0,17,10,7
JP,MX,2001.0,6,5,1
ZA,NZ,1999.0,7,2,5
IQ,IE,2020.0,3,4,-1
PT,CO,2017.0,12,15,-3
CN,UG,2022.0,2,1,1
SG,CH,2001.0,2,7,-5
IE,PK,2011.0,3,7,-4
IE,HR,2020.0,3,6,-3
MX,PT,2000.0,5,7,-2
EE,NL,2012.0,3,1,2
AU,PE,2014.0,2,6,-4
GB,CL,2000.0,3,3,0
CO,DO,2016.0,3,7,-4
CL,NL,2009.0,4,5,-1
ES,BD,2007.0,7,9,-2
CH,RS,2012.0,5,10,-5
AM,FR,2020.0,4,5,-1
LT,FR,2003.0,2,4,-2
SG,DK,2017.0,7,1,6
CU,PE,2007.0,3,2,1
BG,IE,2020.0,1,1,0
AR,PT,2010.0,7,8,-1
CO,DK,2015.0,3,1,2
TW,HK,2014.0,2,4,-2
SG,TH,2010.0,2,6,-4
LB,ES,2020.0,2,1,1
AU,IL,2004.0,3,14,-11
ZA,LV,2019.0,1,1,0
AT,BG,2018.0,2,1,1
CA,ZA,1999.0,11,12,-1
DO,CO,2013.0,3,2,1
SI,CH,2005.0,5,5,0
MD,IL,2019.0,1,1,0
ET,AT,2008.0,1,2,-1
CN,MN,2019.0,4,5,-1
TT,EG,2021.0,1,1,0
CL,CR,2010.0,10,15,-5
GE,IN,2017.0,2,1,1
ET,BE,2021.0,13,11,2
GW,DK,2020.0,6,1,5
JP,NO,2000.0,4,7,-3
MY,KE,2012.0,1,2,-1
LK,SA,2018.0,1,1,0
RW,TZ,2020.0,2,7,-5
KZ,US,2016.0,13,20,-7
CM,KE,2018.0,2,1,1
ZA,RS,2016.0,1,3,-2
BE,RU,2022.0,10,11,-1
DE,AM,1997.0,1,1,0
PT,RU,2003.0,6,7,-1
CH,BY,2004.0,2,3,-1
TH,NO,2013.0,1,2,-1
NC,ZA,2013.0,1,1,0
QA,IR,2015.0,2,3,-1
SG,RU,2005.0,1,2,-1
SI,RS,2014.0,21,25,-4
OM,GB,1999.0,5,2,3
AU,AE,2007.0,8,1,7
UG,CN,2017.0,3,2,1
JM,GB,2001.0,3,5,-2
NO,AT,2006.0,5,4,1
IR,BD,2016.0,2,7,-5
IT,VN,2019.0,4,5,-1
HU,PK,2018.0,2,4,-2
EG,MA,2020.0,11,12,-1
IR,GR,2017.0,3,2,1
LB,ID,2022.0,3,4,-1
HK,JP,1999.0,5,9,-4
KW,MY,2011.0,2,1,1
CZ,HU,2006.0,5,2,3
RU,PH,2006.0,2,2,0
BD,CN,1998.0,1,1,0
DE,LT,2011.0,6,3,3
KE,EG,2019.0,4,1,3
IT,VN,2017.0,7,5,2
IR,NO,2009.0,4,1,3
US,DZ,2006.0,9,7,2
MX,BE,2005.0,2,7,-5
KR,CH,1998.0,3,1,2
IT,LT,2022.0,4,2,2
BG,BE,1998.0,4,1,3
BE,FI,2017.0,10,13,-3
CU,PY,2017.0,7,3,4
NZ,ES,2007.0,6,1,5
CG,BJ,2018.0,1,1,0
DE,UG,2020.0,6,5,1
BE,FI,2010.0,5,16,-11
PL,SK,2011.0,4,4,0
BE,KR,2011.0,7,4,3
AE,KW,2011.0,3,2,1
AU,CL,2011.0,8,11,-3
AU,MY,1998.0,4,4,0
DK,BG,2008.0,1,4,-3
BE,IN,2000.0,8,5,3
ZA,SZ,2014.0,7,3,4
OM,NG,2020.0,2,1,1
PL,RS,2013.0,1,1,0
IR,CN,2000.0,1,3,-2
nan,TN,2014.0,6,4,2
PY,US,2016.0,8,6,2
TW,BR,2011.0,3,2,1
FR,FJ,2012.0,1,1,0
KR,QA,1997.0,3,2,1
NL,QA,2012.0,3,1,2
IE,SA,2011.0,2,2,0
VN,CA,2020.0,8,23,-15
TR,KR,2015.0,6,2,4
BN,SG,2020.0,3,2,1
IS,AU,2018.0,4,4,0
FR,JM,1999.0,2,2,0
AU,FI,2003.0,9,7,2
PE,CH,2014.0,4,4,0
NG,CM,2008.0,2,1,1
ES,RO,2010.0,11,7,4
AR,SE,1998.0,2,3,-1
TR,TW,2001.0,6,4,2
AT,PT,2016.0,6,6,0
HR,BE,2013.0,3,6,-3
PL,AZ,1998.0,2,1,1
CZ,CA,2001.0,5,4,1
BE,KE,2022.0,2,3,-1
AT,TR,2008.0,2,3,-1
DE,PK,2002.0,3,2,1
EG,PL,2008.0,3,7,-4
VN,UA,2016.0,6,2,4
AR,PE,2003.0,6,7,-1
CA,SD,2022.0,1,1,0
ZA,DK,2022.0,2,1,1
MD,TN,2007.0,8,2,6
DE,LB,2012.0,2,5,-3
SK,GB,2004.0,9,18,-9
PG,CN,2014.0,1,1,0
RU,GE,2009.0,4,1,3
NO,IR,2011.0,3,9,-6
SY,US,2020.0,9,8,1
TH,nan,2019.0,3,2,1
BH,IE,2019.0,1,3,-2
AR,CO,1999.0,12,9,3
SI,SE,2017.0,3,3,0
AT,AR,2003.0,2,1,1
LU,PT,2019.0,4,1,3
CH,NZ,2008.0,6,8,-2
PF,CN,2019.0,1,1,0
IT,LV,2020.0,2,1,1
LU,DK,2013.0,1,4,-3
PE,UY,2018.0,5,2,3
BH,ZW,2020.0,3,2,1
KZ,PL,2018.0,2,4,-2
NL,RO,2021.0,5,15,-10
PL,IN,2001.0,1,3,-2
SE,QA,2013.0,3,2,1
CA,DZ,2013.0,10,5,5
PE,CA,2006.0,2,2,0
DK,IS,2020.0,8,5,3
AU,LY,2015.0,2,1,1
SG,DK,2010.0,3,3,0
BN,AU,2020.0,3,1,2
CN,NG,2002.0,3,1,2
NL,PH,2011.0,3,5,-2
NP,ID,2020.0,3,1,2
DE,SA,2000.0,3,3,0
GA,US,2013.0,2,1,1
AU,PT,2005.0,5,8,-3
IT,KE,2002.0,1,1,0
ES,BO,2000.0,1,3,-2
TH,PT,2020.0,1,1,0
GR,TR,2019.0,2,11,-9
UA,UZ,2018.0,3,4,-1
CO,NZ,2011.0,3,2,1
IS,AT,2016.0,1,2,-1
SA,MA,2008.0,2,1,1
AU,HU,1997.0,4,5,-1
RO,AT,2013.0,3,9,-6
BD,AU,2005.0,4,8,-4
KR,ID,2010.0,5,3,2
CA,SN,2020.0,5,7,-2
AO,CU,2018.0,1,1,0
CL,NZ,2016.0,3,9,-6
US,MG,2017.0,3,6,-3
KZ,KR,2013.0,1,1,0
FI,ID,2015.0,4,1,3
RO,FI,2016.0,3,2,1
ET,SA,2017.0,3,1,2
GB,SY,2016.0,6,7,-1
SE,PH,2020.0,1,2,-1
DZ,MY,2016.0,4,4,0
JP,RU,2022.0,12,14,-2
AU,ZM,2021.0,2,1,1
FR,TZ,2010.0,2,6,-4
RU,KE,2022.0,3,2,1
CM,AU,2021.0,2,1,1
ID,TZ,2022.0,2,1,1
CZ,TW,2006.0,2,2,0
DE,BN,2019.0,1,1,0
GH,NG,2013.0,3,12,-9
HN,ES,2007.0,2,2,0
BY,SK,2008.0,1,1,0
PH,HN,2019.0,1,1,0
IE,AE,2019.0,4,6,-2
BG,HU,2009.0,1,3,-2
PL,MY,2020.0,1,3,-2
RO,LU,2020.0,1,1,0
PH,CH,2006.0,4,3,1
BH,TZ,2008.0,2,2,0
SG,KZ,2020.0,3,2,1
BD,MY,2007.0,6,7,-1
PH,IL,2000.0,2,2,0
CO,BE,2008.0,3,3,0
NL,KH,2001.0,1,3,-2
CH,IS,2007.0,2,1,1
GB,GA,2021.0,1,1,0
EE,nan,2013.0,2,1,1
UY,IN,2014.0,1,1,0
HK,BE,2020.0,1,2,-1
EC,MX,2007.0,5,6,-1
VN,JP,2000.0,4,7,-3
BE,HU,2012.0,7,10,-3
BR,IE,2007.0,5,3,2
IN,SN,2010.0,1,1,0
ZA,NA,2015.0,8,6,2
IR,HR,2022.0,2,1,1
GR,CN,2021.0,5,9,-4
MD,CA,2013.0,2,1,1
AR,IE,2014.0,1,1,0
TN,AE,2012.0,2,1,1
DE,MD,2009.0,1,2,-1
PT,CO,2010.0,7,10,-3
HN,AR,2020.0,3,4,-1
XK,DE,2020.0,1,1,0
UA,DE,1997.0,15,5,10
CR,FR,2022.0,4,2,2
LB,SA,2018.0,5,13,-8
KE,EG,2010.0,2,1,1
SV,AR,2014.0,1,2,-1
GR,PK,2011.0,2,2,0
BE,SK,2009.0,2,1,1
JP,ZA,2017.0,4,11,-7
SI,GR,2018.0,1,1,0
EG,TZ,2011.0,1,1,0
SN,AU,2016.0,1,1,0
ES,PL,2003.0,4,2,2
PK,AE,2008.0,2,4,-2
PK,UA,2018.0,1,5,-4
KR,KE,2020.0,3,2,1
IR,TW,2016.0,4,3,1
DE,RO,1998.0,11,11,0
US,MG,2010.0,4,4,0
TN,CH,2011.0,9,10,-1
RW,NL,2016.0,3,1,2
US,MT,2007.0,3,1,2
PT,PY,2016.0,4,2,2
LT,CN,2012.0,3,21,-18
MX,ID,2017.0,4,4,0
CH,TH,2009.0,3,3,0
KR,NL,2008.0,7,7,0
SI,SE,2010.0,1,1,0
UY,VE,2014.0,2,3,-1
EC,BY,2009.0,1,1,0
CN,HU,2012.0,2,6,-4
RU,ZA,1998.0,2,1,1
NL,KE,2003.0,5,2,3
AR,IN,2019.0,4,4,0
BG,AU,2015.0,4,2,2
TH,MY,2021.0,4,9,-5
JO,EG,2001.0,3,2,1
LB,MY,2017.0,2,5,-3
CA,EE,2023.0,1,1,0
IE,KR,2009.0,3,4,-1
VE,CN,2008.0,1,1,0
SL,CN,2018.0,2,1,1
UA,BE,2018.0,5,5,0
SK,IT,2006.0,6,9,-3
NL,NP,2013.0,4,2,2
RU,EG,2013.0,2,7,-5
SA,BH,2003.0,1,1,0
CA,TN,2002.0,4,3,1
JP,PR,2004.0,1,1,0
CI,BE,2008.0,2,1,1
US,BB,2015.0,4,4,0
CU,GT,2011.0,1,1,0
ZA,MW,2014.0,4,11,-7
KR,RU,2008.0,9,16,-7
NL,KW,2015.0,1,1,0
SE,NP,2013.0,1,1,0
NG,TN,2019.0,3,3,0
EG,VN,2019.0,2,3,-1
BE,AR,2012.0,6,16,-10
ID,CI,2018.0,2,1,1
KR,NO,2000.0,2,1,1
HR,RO,2015.0,1,1,0
HR,SE,2017.0,4,3,1
MX,PK,2004.0,1,4,-3
CA,PH,2001.0,8,5,3
UY,GB,1998.0,1,2,-1
ZA,AE,2008.0,1,1,0
IE,AE,2010.0,1,1,0
BE,TH,2018.0,3,9,-6
BH,IQ,2020.0,3,3,0
KH,BE,2015.0,1,1,0
RU,JO,2007.0,1,1,0
CR,HN,2018.0,2,3,-1
CA,CL,2022.0,5,25,-20
AR,CN,2000.0,1,1,0
NO,UA,2007.0,2,1,1
VE,GB,2011.0,1,7,-6
MT,AU,2012.0,4,2,2
DK,IL,1999.0,1,1,0
UA,KZ,2009.0,3,1,2
PL,RO,2016.0,3,8,-5
ET,SY,2019.0,3,1,2
MZ,ZA,2017.0,1,7,-6
HU,AE,2019.0,3,1,2
BE,EG,2016.0,6,3,3
TR,ES,2003.0,2,6,-4
NL,EE,2016.0,1,2,-1
OM,IQ,2013.0,1,1,0
FR,EG,1998.0,5,4,1
CM,MY,2007.0,1,2,-1
AR,LB,2019.0,1,1,0
KR,NZ,2005.0,5,3,2
HR,SI,2001.0,3,2,1
RU,SI,2006.0,2,1,1
NZ,VN,2013.0,1,1,0
MY,SG,2023.0,2,3,-1
GB,LS,2019.0,1,1,0
OM,TN,2016.0,4,3,1
MZ,PT,2018.0,4,3,1
BE,CO,2002.0,3,2,1
NI,BR,2016.0,3,2,1
IL,MX,2018.0,4,8,-4
AR,SK,2006.0,1,1,0
HR,NO,2013.0,5,2,3
NL,TZ,2011.0,5,2,3
HU,IR,2011.0,1,2,-1
JP,RO,2012.0,3,6,-3
RS,HK,2008.0,1,1,0
AT,VN,2018.0,2,1,1
ES,KR,2013.0,2,5,-3
ME,BA,2021.0,1,1,0
nan,KR,2023.0,2,3,-1
ZM,ZW,2022.0,1,2,-1
TZ,UG,2020.0,4,5,-1
BE,AU,2000.0,6,5,1
CH,FI,1999.0,4,5,-1
BG,BE,1997.0,3,8,-5
GR,AU,2007.0,6,8,-2
ID,VN,2022.0,1,2,-1
CG,KE,2017.0,1,2,-1
PA,AT,2022.0,1,1,0
LA,TH,2013.0,2,1,1
LT,PL,2014.0,2,4,-2
AR,IN,2010.0,2,1,1
NZ,EG,2013.0,2,1,1
DK,CO,2018.0,3,4,-1
GB,LT,2020.0,8,8,0
TR,BG,2012.0,3,1,2
KR,GH,2013.0,2,1,1
AT,GR,2009.0,5,2,3
BH,PK,2020.0,2,4,-2
DK,ZA,2011.0,4,9,-5
AE,BR,2012.0,1,1,0
ZM,IR,2018.0,2,1,1
CM,ZA,2013.0,1,2,-1
PA,IN,2016.0,2,3,-1
GB,LS,2017.0,1,1,0
NO,NG,2021.0,2,4,-2
CL,PT,2004.0,1,2,-1
CL,IR,2015.0,1,1,0
PK,TZ,2015.0,1,1,0
BY,FR,1999.0,1,1,0
RU,HU,2002.0,4,3,1
EE,FR,2006.0,2,3,-1
LU,PL,2021.0,1,4,-3
CO,KR,2016.0,3,4,-1
CM,DE,2001.0,2,1,1
BR,RO,2004.0,2,1,1
FR,GN,2014.0,3,2,1
BN,US,2009.0,3,1,2
GW,SE,2005.0,2,1,1
BJ,DE,2020.0,1,1,0
KE,FI,2020.0,2,1,1
SK,RO,2013.0,4,1,3
HU,FI,2002.0,3,6,-3
JO,MX,2017.0,1,1,0
IL,TW,2009.0,1,1,0
PK,PL,2004.0,3,3,0
BM,GB,2010.0,1,1,0
SD,AE,2014.0,2,2,0
UG,PK,2021.0,1,2,-1
ID,NO,2021.0,3,1,2
SD,CA,2000.0,3,1,2
IE,GR,2007.0,3,5,-2
BY,IL,2002.0,1,1,0
TR,UA,1999.0,2,1,1
PS,AT,2013.0,1,1,0
SI,nan,2008.0,2,2,0
EG,DK,2008.0,2,2,0
IE,PH,2006.0,2,1,1
ZA,PL,2011.0,3,4,-1
BE,BG,1999.0,1,5,-4
GH,IN,2006.0,2,1,1
GB,BH,2011.0,3,3,0
TR,JO,2021.0,1,3,-2
TR,PS,2020.0,3,2,1
SA,TW,2014.0,3,9,-6
CL,FI,2013.0,2,10,-8
BW,UG,2015.0,1,1,0
MC,FR,2012.0,6,6,0
BE,MD,2004.0,2,1,1
PE,IT,2022.0,5,3,2
UG,CN,2019.0,4,2,2
SY,EG,2002.0,1,2,-1
CA,IQ,2016.0,4,2,2
LY,EG,2011.0,2,1,1
KH,KE,2017.0,1,1,0
LY,CA,2008.0,1,3,-2
UG,AU,2016.0,5,2,3
TH,SE,2004.0,2,1,1
HR,SK,2004.0,1,2,-1
KN,US,2012.0,2,4,-2
CZ,EG,2000.0,1,1,0
DE,EC,2009.0,1,1,0
IT,NP,2007.0,1,2,-1
BM,GB,2019.0,1,1,0
KE,NL,2015.0,2,11,-9
FI,LV,2021.0,2,1,1
IE,IN,2005.0,3,5,-2
US,CN,2018.0,6489,5094,1395
JP,TW,2012.0,82,71,11
ES,GB,2009.0,311,289,22
GB,NZ,2004.0,173,158,15
DK,HR,2015.0,3,4,-1
CO,VE,2018.0,63,87,-24
IT,BR,2002.0,84,75,9
MX,CO,2017.0,439,411,28
GR,DE,2015.0,87,51,36
SI,SE,2019.0,8,3,5
PK,IN,2012.0,141,148,-7
SE,FR,2007.0,43,63,-20
MY,IN,2018.0,162,151,11
IT,CL,2017.0,32,29,3
PL,BD,2017.0,3,5,-2
CN,RU,2018.0,79,53,26
NL,NO,2014.0,38,22,16
KR,CN,1999.0,39,41,-2
TH,CN,2000.0,5,2,3
DK,DE,2019.0,180,224,-44
MY,TH,2018.0,18,11,7
US,NA,2022.0,1,2,-1
TR,CA,2021.0,40,26,14
ID,ES,2006.0,5,6,-1
US,ET,2013.0,24,33,-9
CL,CR,2017.0,43,29,14
SE,DK,2005.0,73,68,5
KR,nan,2003.0,8,11,-3
CH,nan,2000.0,7,4,3
CZ,GB,2009.0,39,35,4
IT,CL,2019.0,46,37,9
US,TR,2003.0,259,247,12
CH,CA,2016.0,121,151,-30
PL,HU,2020.0,88,36,52
TW,IT,2009.0,2,5,-3
FI,SE,2012.0,92,76,16
RO,NL,2020.0,8,11,-3
PK,MA,2019.0,21,24,-3
NL,CH,2000.0,30,26,4
CA,BD,2011.0,19,32,-13
DE,AR,2022.0,23,26,-3
QA,US,2020.0,85,85,0
NZ,DK,2016.0,11,8,3
EC,CH,2020.0,4,3,1
BA,CH,2022.0,1,1,0
nan,FR,2003.0,71,84,-13
JP,ZA,2019.0,6,8,-2
RU,NL,2020.0,49,41,8
MD,FR,1998.0,60,34,26
CN,IE,2011.0,43,47,-4
IQ,TN,2021.0,3,4,-1
CA,PK,2001.0,1,4,-3
AU,NG,1998.0,2,2,0
FR,CM,2010.0,10,9,1
TR,PK,2009.0,8,6,2
IN,SG,2006.0,35,22,13
ES,SI,2011.0,11,6,5
DO,MX,2014.0,3,6,-3
JP,TR,2014.0,19,18,1
PK,GB,2023.0,13,20,-7
IN,HR,2019.0,2,2,0
NO,SG,2018.0,2,2,0
GD,US,2014.0,8,12,-4
ID,MY,2011.0,39,56,-17
NC,CF,2001.0,1,1,0
JP,ES,2000.0,19,11,8
RU,IL,2021.0,39,32,7
LK,JP,2018.0,25,42,-17
BG,TR,2018.0,1,1,0
ES,CU,2014.0,77,105,-28
RW,IN,2013.0,6,3,3
KR,LK,2020.0,6,3,3
ES,PE,2008.0,37,36,1
LB,MY,2019.0,5,3,2
AR,GT,2018.0,3,5,-2
PT,FR,2013.0,49,43,6
JP,SI,2008.0,1,5,-4
AU,SE,2004.0,34,35,-1
JO,QA,2022.0,11,8,3
FR,CM,2017.0,28,13,15
SK,CH,2012.0,9,2,7
PL,NO,2014.0,10,8,2
AR,DE,2008.0,16,18,-2
VN,FR,2002.0,5,13,-8
TW,AU,2009.0,24,30,-6
GB,LU,2008.0,8,5,3
GB,PK,2007.0,60,38,22
FR,CI,2022.0,14,7,7
BO,BR,2014.0,4,2,2
JO,AE,2017.0,22,15,7
US,PS,1998.0,1,1,0
ES,TW,2009.0,7,4,3
SI,AT,2012.0,12,19,-7
GR,TR,2010.0,4,3,1
LY,FR,2011.0,2,1,1
NZ,NL,2018.0,16,17,-1
EC,IT,2020.0,7,8,-1
FR,MY,2009.0,12,4,8
US,VE,2012.0,29,53,-24
ZA,SA,2020.0,10,4,6
PY,ES,2005.0,1,1,0
AU,GR,2006.0,7,6,1
CA,TN,2005.0,4,1,3
AU,HU,1998.0,6,2,4
IL,GR,2016.0,4,2,2
SG,nan,2013.0,9,18,-9
RS,SI,2021.0,17,9,8
MY,UA,2021.0,5,9,-4
CZ,NL,2018.0,7,14,-7
CH,ES,2023.0,4,6,-2
US,JM,2002.0,9,10,-1
JP,GE,2018.0,1,1,0
GR,TR,2017.0,5,7,-2
KZ,GB,2004.0,3,1,2
KE,DE,2009.0,1,6,-5
CD,US,2009.0,2,3,-1
IE,PT,2015.0,6,9,-3
DZ,MA,2001.0,1,1,0
CU,AU,2018.0,4,3,1
CU,CO,1999.0,3,1,2
AU,NG,1997.0,2,4,-2
PH,IT,2011.0,6,5,1
US,KN,2021.0,5,5,0
US,ML,2008.0,5,1,4
HR,FR,2016.0,3,4,-1
ZA,PK,2001.0,2,2,0
SA,RU,2020.0,3,4,-1
BE,VN,2006.0,6,2,4
EE,CN,2022.0,3,1,2
PK,EE,2021.0,1,3,-2
CZ,BG,2015.0,4,5,-1
AE,RS,2017.0,1,2,-1
CY,DE,2021.0,6,7,-1
IE,UA,2011.0,1,2,-1
DE,RO,1997.0,4,8,-4
IT,UA,2006.0,11,9,2
CZ,RS,2017.0,8,14,-6
TJ,RU,2008.0,2,16,-14
BO,MX,2011.0,7,4,3
ES,HU,2011.0,4,9,-5
LT,SE,2020.0,5,6,-1
MG,FR,2008.0,6,13,-7
EE,US,1997.0,5,1,4
GE,IN,2010.0,2,2,0
PT,CH,1999.0,1,1,0
TN,AU,2016.0,1,2,-1
AT,EG,2011.0,5,3,2
RO,DK,2012.0,1,4,-3
FI,FR,2000.0,12,10,2
EE,GB,2014.0,7,10,-3
FI,ZA,2018.0,7,5,2
BE,IL,2001.0,5,6,-1
UA,MX,2002.0,3,1,2
SG,TH,2019.0,5,8,-3
ET,FR,2016.0,1,2,-1
US,JM,2005.0,7,7,0
NA,DE,2021.0,1,3,-2
EC,UY,2015.0,1,1,0
KZ,IR,2015.0,1,3,-2
MZ,UA,2016.0,2,1,1
CI,US,2000.0,1,1,0
UA,TW,2016.0,2,1,1
IN,HR,2017.0,2,1,1
IN,FJ,2020.0,6,7,-1
SA,ZA,2021.0,5,2,3
PH,AR,2016.0,1,1,0
SA,JP,2008.0,2,6,-4
BG,IN,2018.0,1,1,0
KR,AR,2007.0,1,1,0
BA,AT,2020.0,4,2,2
BD,ID,2011.0,1,6,-5
IE,CO,2008.0,1,2,-1
CG,KE,2019.0,1,1,0
CU,JP,2006.0,1,1,0
PK,AT,2016.0,3,8,-5
CM,BE,2012.0,5,7,-2
LK,CN,2007.0,2,5,-3
DK,TW,2003.0,2,2,0
nan,EG,2016.0,3,4,-1
GN,ML,2014.0,1,3,-2
TW,ZW,2002.0,1,1,0
BR,PT,2010.0,692,549,143
TH,JP,2013.0,57,119,-62
KE,TZ,2021.0,6,7,-1
SY,GB,2011.0,2,10,-8
IT,HR,2020.0,11,14,-3
BY,CZ,2014.0,20,10,10
BE,IT,1998.0,32,31,1
VN,DK,2020.0,3,2,1
GB,SI,2011.0,8,9,-1
SE,KE,2019.0,5,4,1
IQ,US,2023.0,1,3,-2
,IT,2012.0,12871,0,12871
,DE,2003.0,16005,0,16005
,JP,2011.0,15460,0,15460
GB,,2007.0,8247,0,8247
,CY,2009.0,147,0,147
,SE,2000.0,2903,0,2903
,CH,2002.0,3061,0,3061
,BR,2004.0,13428,0,13428
,VE,2009.0,421,0,421
CA,,2025.0,5091,0,5091
,NL,1995.0,8827,0,8827
,PL,2009.0,5493,0,5493
IN,,2021.0,23979,0,23979
SE,,2002.0,915,0,915
JP,,2003.0,7138,0,7138
RU,,2014.0,3819,0,3819
,BR,1996.0,8028,0,8028
SE,,2005.0,1046,0,1046
EG,,2007.0,263,0,263
DE,,1998.0,2752,0,2752
,CH,2005.0,3306,0,3306
,CA,2009.0,10722,0,10722
CU,,2011.0,159,0,159
,IE,2012.0,1452,0,1452
,UA,1994.0,2163,0,2163
ZA,,2006.0,401,0,401
,BE,1997.0,2468,0,2468
,BE,1998.0,2329,0,2329
,FR,2014.0,14328,0,14328
IE,,2009.0,441,0,441
PK,,2026.0,398,0,398
MX,PS,2022.0,1,0,1
,IR,2014.0,13447,0,13447
CN,EC,2015.0,3,0,3
KE,,2021.0,828,0,828
,NZ,2000.0,860,0,860
,nan,2012.0,946,0,946
TZ,,2020.0,223,0,223
BA,,2021.0,374,0,374
,AE,2005.0,125,0,125
DK,,2004.0,408,0,408
TN,,2015.0,582,0,582
VE,,2008.0,154,0,154
AT,,2005.0,628,0,628
,TZ,2013.0,259,0,259
AT,,2002.0,495,0,495
CR,PY,2021.0,3,0,3
,HU,2011.0,1463,0,1463
PA,,2023.0,408,0,408
PS,,2023.0,463,0,463
NZ,,2006.0,264,0,264
BH,,2024.0,556,0,556
AL,,2024.0,343,0,343
SY,,2015.0,80,0,80
HR,SE,2019.0,4,0,4
UY,IE,2007.0,1,0,1
,PR,1994.0,51,0,51
,LT,2007.0,522,0,522
,AZ,2016.0,186,0,186
,NG,2015.0,3085,0,3085
HR,,2009.0,181,0,181
BE,,1999.0,487,0,487
,IS,2011.0,139,0,139
,ZW,2009.0,107,0,107
LT,,2014.0,287,0,287
IS,RU,2017.0,5,0,5
,KZ,2007.0,115,0,115
SY,RU,2020.0,3,0,3
,PT,2016.0,1501,0,1501
UZ,,2020.0,120,0,120
DZ,,2016.0,504,0,504
PT,TZ,2015.0,1,0,1
KN,CA,2017.0,4,0,4
RO,,2001.0,74,0,74
KP,,2020.0,5,0,5
LR,,2023.0,30,0,30
CL,RS,2021.0,1,0,1
BT,,2022.0,19,0,19
CZ,ID,2006.0,1,0,1
JO,IT,2007.0,5,0,5
LU,,2008.0,29,0,29
,ZM,2010.0,89,0,89
KE,CH,2014.0,2,0,2
ML,,2023.0,280,0,280
TN,CU,2000.0,1,0,1
LB,,1999.0,12,0,12
nan,,2002.0,152,0,152
,AE,2002.0,111,0,111
CG,,2018.0,29,0,29
TN,CN,2022.0,6,0,6
,SD,2015.0,167,0,167
TN,TG,2016.0,1,0,1
,CM,2007.0,198,0,198
,ZM,2017.0,115,0,115
,KW,2016.0,185,0,185
,LK,2004.0,143,0,143
LV,,2011.0,73,0,73
ET,,2007.0,20,0,20
SA,,1999.0,125,0,125
,ZM,2019.0,77,0,77
,SV,1997.0,10,0,10
,LK,1996.0,115,0,115
BG,IS,2021.0,1,0,1
SN,CM,2020.0,5,0,5
NO,TN,2018.0,1,0,1
AZ,,2009.0,32,0,32
MK,RS,2009.0,1,0,1
NL,TN,2013.0,2,0,2
AZ,UA,2018.0,3,0,3
SK,GT,2019.0,1,0,1
,MG,2003.0,42,0,42
,BA,2006.0,189,0,189
,KH,2009.0,56,0,56
JE,,2024.0,9,0,9
IT,MK,2022.0,2,0,2
,HK,2018.0,47,0,47
SG,UA,2020.0,4,0,4
nan,,2005.0,184,0,184
CN,CY,2022.0,2,0,2
FJ,,2022.0,66,0,66
,TJ,2018.0,44,0,44
FJ,GB,2000.0,3,0,3
,PY,1999.0,11,0,11
TZ,PK,2000.0,1,0,1
KZ,,2011.0,42,0,42
FR,NG,2003.0,1,0,1
CA,HK,2009.0,6,0,6
FI,BW,2005.0,1,0,1
BD,WS,2020.0,1,0,1
FR,PS,2004.0,2,0,2
XK,,2021.0,122,0,122
SD,KW,2007.0,1,0,1
PK,MX,2015.0,3,0,3
MD,MG,2017.0,1,0,1
,UZ,2011.0,155,0,155
SK,NG,2008.0,1,0,1
BG,PT,2010.0,5,0,5
BA,SN,2015.0,1,0,1
,SS,2012.0,4,0,4
FR,AD,2013.0,1,0,1
,LU,2003.0,72,0,72
SD,LA,2018.0,1,0,1
,TT,2016.0,37,0,37
CN,NP,2002.0,2,0,2
CR,ZA,2006.0,2,0,2
PR,SG,2004.0,2,0,2
DZ,AU,2014.0,1,0,1
GH,FI,2016.0,2,0,2
NG,BD,2011.0,3,0,3
EC,TR,2019.0,2,0,2
MD,NZ,2020.0,2,0,2
AE,UA,2019.0,3,0,3
PK,IR,2004.0,3,0,3
JM,,2011.0,32,0,32
PH,BN,2017.0,1,0,1
BF,SE,2004.0,1,0,1
CA,OM,1998.0,2,0,2
JP,MW,2020.0,2,0,2
,CF,2002.0,4,0,4
NL,SI,2001.0,6,0,6
AZ,BG,2013.0,1,0,1
NG,GY,2017.0,1,0,1
PK,GR,2019.0,2,0,2
IL,FI,2005.0,2,0,2
PS,GB,2003.0,4,0,4
NC,,2014.0,12,0,12
,ME,2006.0,37,0,37
IE,TZ,2013.0,1,0,1
SG,RO,2020.0,2,0,2
EE,TW,2018.0,1,0,1
RU,HU,2005.0,11,0,11
,MH,2006.0,1,0,1
BD,KR,2003.0,3,0,3
KN,BE,2017.0,1,0,1
BE,KN,2018.0,1,0,1
SE,XK,2010.0,1,0,1
PG,CH,1997.0,1,0,1
DE,MQ,2016.0,1,0,1
GE,AR,2011.0,1,0,1
SY,CH,2021.0,1,0,1
ES,LB,2001.0,2,0,2
NC,CN,2009.0,1,0,1
AT,JO,2014.0,1,0,1
GF,,2018.0,11,0,11
CN,MN,2010.0,3,0,3
RU,VN,2007.0,2,0,2
BM,MC,2010.0,1,0,1
MX,ZM,1999.0,2,0,2
TW,CY,2009.0,1,0,1
IR,,2026.0,11,0,11
CN,MN,2017.0,2,0,2
,SV,1998.0,15,0,15
BW,,2000.0,3,0,3
SE,LY,2011.0,1,0,1
UA,BY,1999.0,4,0,4
SD,PT,2019.0,2,0,2
IL,SY,2019.0,2,0,2
FI,LU,2018.0,2,0,2
SG,SA,2004.0,1,0,1
RU,TT,2021.0,1,0,1
BH,CA,2012.0,1,0,1
nan,RE,2022.0,1,0,1
IL,PH,2010.0,1,0,1
MC,MG,2012.0,1,0,1
KH,TH,2009.0,1,0,1
CY,,2003.0,8,0,8
MU,CA,2009.0,1,0,1
ES,MY,2006.0,2,0,2
BE,TT,2022.0,1,0,1
PF,RE,2004.0,1,0,1
BY,LU,2018.0,1,0,1
QA,CH,2021.0,3,0,3
BY,KZ,2020.0,2,0,2
CH,MZ,2010.0,1,0,1
SD,KE,2008.0,3,0,3
ZA,UY,2014.0,1,0,1
,GL,2000.0,4,0,4
SE,TH,2002.0,1,0,1
HU,MX,2008.0,1,0,1
LY,AE,2016.0,1,0,1
RU,AR,2015.0,4,0,4
JM,RO,2015.0,1,0,1
ES,MZ,2015.0,3,0,3
PT,BD,2009.0,1,0,1
LK,CO,2013.0,1,0,1
,LS,1994.0,8,0,8
ES,NA,2015.0,1,0,1
GI,US,2013.0,1,0,1
JP,OM,1999.0,1,0,1
BG,KR,2008.0,2,0,2
LS,,2018.0,2,0,2
BW,BG,2010.0,1,0,1
AR,NI,2019.0,1,0,1
,TG,2003.0,9,0,9
KP,TW,2007.0,1,0,1
BO,CN,2012.0,1,0,1
GP,,2015.0,9,0,9
,ST,2013.0,10,0,10
CM,,2004.0,16,0,16
AM,CN,2007.0,2,0,2
IN,BN,2011.0,3,0,3
,MR,2004.0,5,0,5
PH,SG,1999.0,2,0,2
IQ,PL,2015.0,2,0,2
LK,JM,2018.0,1,0,1
CO,NP,2012.0,1,0,1
NG,RO,2019.0,1,0,1
GT,PA,2020.0,1,0,1
FR,NP,2011.0,1,0,1
PK,BF,2008.0,4,0,4
SN,BR,2011.0,2,0,2
AE,LY,2010.0,1,0,1
CN,PA,2011.0,1,0,1
AO,MX,2016.0,3,0,3
RU,TH,2012.0,1,0,1
LR,CN,2012.0,1,0,1
KE,BF,2020.0,2,0,2
HU,CY,2016.0,2,0,2
KR,AE,2023.0,1,0,1
TW,CO,2019.0,1,0,1
DO,,2005.0,1,0,1
BA,IQ,2013.0,2,0,2
,MR,1996.0,6,0,6
UG,CA,2011.0,2,0,2
BH,AU,2016.0,2,0,2
AU,XK,2018.0,1,0,1
YE,ID,2019.0,9,0,9
,SJ,2018.0,2,0,2
FR,TZ,2017.0,1,0,1
GE,AT,2000.0,1,0,1
ID,CW,2019.0,5,0,5
BR,MO,2011.0,1,0,1
IL,GH,2017.0,1,0,1
CH,BI,2012.0,1,0,1
AU,RS,2003.0,2,0,2
,GM,2001.0,6,0,6
SI,AR,2016.0,1,0,1
US,PS,1997.0,1,0,1
NZ,PE,2005.0,1,0,1
UA,DZ,2018.0,1,0,1
MA,CL,2020.0,1,0,1
,AO,2006.0,9,0,9
MY,ZW,2010.0,1,0,1
BM,GB,2017.0,1,0,1
IE,AE,2017.0,4,0,4
EE,SK,2012.0,1,0,1
TR,SK,2020.0,2,0,2
MD,MG,2010.0,1,0,1
TN,TZ,2015.0,1,0,1
KZ,nan,2016.0,1,0,1
JO,AF,2020.0,1,0,1
IR,CH,2001.0,1,0,1
RS,BA,1998.0,4,0,4
CA,PS,2019.0,6,0,6
NZ,TR,2011.0,1,0,1
,KI,2012.0,2,0,2
IR,LB,2013.0,3,0,3
IN,HK,2022.0,3,0,3
MY,ET,2021.0,3,0,3
YE,ID,2017.0,2,0,2
IN,PG,2014.0,2,0,2
EC,SI,2020.0,1,0,1
CD,BR,2020.0,1,0,1
IQ,LU,2017.0,1,0,1
CA,ML,2020.0,1,0,1
SD,JP,2019.0,2,0,2
NG,LR,2017.0,2,0,2
CG,CA,2009.0,1,0,1
SK,IQ,2018.0,1,0,1
DO,CU,2015.0,4,0,4
NI,SE,2001.0,2,0,2
JO,UA,2015.0,1,0,1
ZA,MY,2008.0,1,0,1
CN,SN,2020.0,1,0,1
IN,ER,2016.0,2,0,2
TR,VN,2019.0,1,0,1
SE,CW,2004.0,1,0,1
,CF,2005.0,3,0,3
IQ,IT,2001.0,2,0,2
RO,UA,2004.0,2,0,2
RS,IL,2012.0,1,0,1
,MO,2008.0,1,0,1
SS,ZA,2006.0,1,0,1
US,LS,2006.0,1,0,1
SA,GH,2007.0,1,0,1
SK,DZ,2016.0,1,0,1
JO,MX,2019.0,1,0,1
ME,FR,2008.0,1,0,1
UG,TR,2019.0,1,0,1
BB,CA,2019.0,2,0,2
GE,IL,2003.0,1,0,1
MY,IE,2003.0,1,0,1
NL,JO,1998.0,3,0,3
MG,RE,2021.0,2,0,2
SA,LY,2008.0,2,0,2
BD,TW,2009.0,1,0,1
IL,UY,2008.0,1,0,1
SA,BG,2016.0,4,0,4
TH,PG,2015.0,1,0,1
AT,AL,2015.0,3,0,3
AU,ZW,2000.0,3,0,3
UA,SA,2017.0,2,0,2
CY,BR,2020.0,1,0,1
ID,LA,2022.0,2,0,2
TW,MK,2016.0,1,0,1
MK,UZ,2019.0,1,0,1
LB,AE,2020.0,10,0,10
SC,US,2011.0,1,0,1
ES,AL,2014.0,3,0,3
AU,GP,2017.0,1,0,1
RU,MY,1999.0,4,0,4
NO,BW,2010.0,1,0,1
MK,DK,2021.0,4,0,4
SG,HU,2007.0,2,0,2
LU,PT,2017.0,3,0,3
PY,CL,1997.0,1,0,1
NZ,BS,2010.0,1,0,1
CZ,BR,1997.0,2,0,2
IL,IR,2011.0,3,0,3
CF,GF,2021.0,1,0,1
PK,LB,2013.0,1,0,1
ZA,CY,2020.0,1,0,1
BH,UZ,2022.0,1,0,1
CH,PA,2018.0,2,0,2
UA,DK,2015.0,1,0,1
UA,LV,2022.0,3,0,3
LT,AT,2018.0,4,0,4
CD,KR,2022.0,1,0,1
RU,PS,2020.0,1,0,1
SN,TN,2004.0,1,0,1
MA,BJ,2020.0,1,0,1
SK,MA,2017.0,1,0,1
LB,CU,2019.0,3,0,3
DE,TN,2001.0,1,0,1
BY,CA,2007.0,4,0,4
TT,OM,2009.0,1,0,1
SS,DE,2002.0,1,0,1
TW,ZW,2005.0,1,0,1
GE,ZA,2003.0,2,0,2
DE,CD,1998.0,1,0,1
TH,BF,2016.0,1,0,1
BS,,2015.0,2,0,2
ZW,CG,2015.0,3,0,3
VN,SA,2023.0,1,0,1
MO,IT,2011.0,1,0,1
UA,NI,2014.0,2,0,2
MA,SG,2013.0,3,0,3
PG,NP,2012.0,1,0,1
TN,KR,2016.0,2,0,2
KE,ZA,2000.0,2,0,2
SA,FJ,2019.0,1,0,1
BD,IT,1999.0,1,0,1
CO,ME,2017.0,1,0,1
MT,CH,2009.0,1,0,1
BG,nan,1998.0,1,0,1
MX,NC,2011.0,1,0,1
AU,DZ,2005.0,1,0,1
nan,KW,2009.0,1,0,1
AU,EG,2003.0,2,0,2
NG,LR,2019.0,1,0,1
ES,RE,2014.0,1,0,1
JO,NL,2011.0,3,0,3
GA,NE,2016.0,1,0,1
IN,MZ,2013.0,1,0,1
QA,BA,2014.0,1,0,1
ZW,NA,2005.0,1,0,1
UA,MY,2005.0,2,0,2
MR,PK,2019.0,2,0,2
NL,BF,2013.0,1,0,1
ZA,GD,2008.0,1,0,1
IL,CL,2003.0,1,0,1
,KY,2011.0,3,0,3
BE,IR,1998.0,1,0,1
BA,SE,2003.0,1,0,1
VG,,2006.0,4,0,4
PT,TH,2014.0,2,0,2
US,MC,2013.0,1,0,1
GA,CH,2015.0,2,0,2
BG,SE,2006.0,2,0,2
BD,ET,2005.0,1,0,1
GE,JO,2017.0,1,0,1
CO,TR,2013.0,2,0,2
SG,VN,2005.0,1,0,1
SA,PE,2014.0,1,0,1
CM,PL,2019.0,2,0,2
RE,ML,2002.0,1,0,1
ES,HR,2002.0,2,0,2
UG,TR,2017.0,1,0,1
BS,TT,2015.0,1,0,1
CN,AF,2021.0,1,0,1
BF,DE,2022.0,2,0,2
CA,CD,2017.0,2,0,2
SY,BA,2013.0,1,0,1
JP,PA,1998.0,1,0,1
SG,MK,2006.0,1,0,1
CN,NE,2012.0,2,0,2
DE,PF,2013.0,1,0,1
AZ,BE,2007.0,1,0,1
CD,SN,2022.0,1,0,1
DE,PS,2006.0,2,0,2
AU,GE,2004.0,1,0,1
SJ,IS,2021.0,1,0,1
nan,DO,2021.0,1,0,1
IR,BH,2009.0,1,0,1
AE,LY,2017.0,1,0,1
ES,HK,2020.0,1,0,1
IR,PH,2022.0,1,0,1
FJ,BR,2018.0,1,0,1
MV,US,2017.0,1,0,1
MK,US,1999.0,2,0,2
AX,CN,2012.0,1,0,1
US,BI,2001.0,1,0,1
DZ,BD,2022.0,1,0,1
CW,AT,2016.0,2,0,2
NG,TN,2010.0,1,0,1
AU,ME,2010.0,1,0,1
BR,ET,2013.0,1,0,1
UZ,CA,2009.0,1,0,1
MT,IT,2001.0,1,0,1
ET,BI,2018.0,1,0,1
BE,CO,2005.0,3,0,3
,AG,2002.0,2,0,2
AZ,KZ,2016.0,1,0,1
ME,CN,2022.0,1,0,1
MN,AE,2013.0,1,0,1
GR,NP,2015.0,1,0,1
GE,AU,2000.0,2,0,2
BG,CL,2014.0,1,0,1
RU,HR,1999.0,1,0,1
NE,UY,2018.0,1,0,1
GE,PL,2013.0,3,0,3
KR,NG,1999.0,1,0,1
SE,MZ,2010.0,1,0,1
AR,VE,1998.0,1,0,1
CI,DE,1998.0,1,0,1
FR,TT,2008.0,2,0,2
RS,PH,2009.0,1,0,1
RS,NO,1999.0,1,0,1
PA,IE,2018.0,1,0,1
NE,NG,2012.0,1,0,1
US,LI,2016.0,2,0,2
NA,CH,2003.0,1,0,1
DE,KG,2013.0,1,0,1
EG,IS,2013.0,1,0,1
BJ,nan,2013.0,1,0,1
AT,NG,2016.0,2,0,2
CH,AL,2011.0,1,0,1
IN,KH,2003.0,1,0,1
CH,BF,2017.0,1,0,1
BT,NL,2010.0,1,0,1
KR,ZW,2018.0,2,0,2
PT,UZ,2020.0,1,0,1
JP,MK,2015.0,2,0,2
HU,QA,2014.0,2,0,2
ML,CH,2016.0,2,0,2
KH,HK,2006.0,3,0,3
LY,NL,2014.0,1,0,1
NL,GE,2018.0,1,0,1
AT,DZ,2006.0,2,0,2
RE,NC,2004.0,1,0,1
DE,SN,2005.0,1,0,1
GM,NG,2012.0,2,0,2
CU,PA,2016.0,3,0,3
GE,FI,2010.0,1,0,1
GT,,1998.0,1,0,1
AR,DZ,2017.0,1,0,1
FJ,FM,2011.0,1,0,1
JP,KG,2013.0,2,0,2
KZ,FJ,2011.0,1,0,1
HR,IT,2023.0,1,0,1
TW,LB,2003.0,1,0,1
TG,CI,2014.0,1,0,1
EG,ML,2003.0,1,0,1
ZA,IR,2004.0,1,0,1
AT,CR,2020.0,2,0,2
CU,IS,2017.0,1,0,1
nan,LU,2003.0,2,0,2
MA,JO,2010.0,1,0,1
TW,NC,2021.0,1,0,1
NG,ES,2011.0,1,0,1
GB,BZ,2005.0,1,0,1
SD,LU,2012.0,1,0,1
CY,SI,2014.0,1,0,1
AU,ES,2024.0,1,0,1
GF,BO,2001.0,1,0,1
BW,CD,2021.0,1,0,1
PK,DZ,2016.0,1,0,1
KG,PK,2013.0,2,0,2
CI,AT,2020.0,1,0,1
SE,KH,2015.0,1,0,1
MX,MT,2020.0,1,0,1
IE,LV,2016.0,2,0,2
BB,CA,2017.0,1,0,1
YE,QA,2016.0,2,0,2
EE,KR,2007.0,1,0,1
LK,PE,2018.0,1,0,1
ZM,ZA,2008.0,2,0,2
TG,CG,2019.0,1,0,1
TR,UZ,2016.0,2,0,2
ZA,TW,2023.0,1,0,1
MN,,2007.0,3,0,3
GE,JP,1999.0,1,0,1
FM,,2021.0,1,0,1
IS,IN,2016.0,1,0,1
,LY,2020.0,1,0,1
ML,NG,1997.0,1,0,1
AX,,2015.0,2,0,2
NZ,PG,2012.0,1,0,1
GB,MQ,2016.0,1,0,1
FI,CL,2002.0,1,0,1
LV,FR,2000.0,3,0,3
ET,TR,2015.0,1,0,1
AR,PS,2009.0,1,0,1
IE,AR,2018.0,1,0,1
PF,,2005.0,3,0,3
GW,,2005.0,1,0,1
OM,SE,2016.0,1,0,1
UG,KE,2000.0,2,0,2
CN,AE,2004.0,1,0,1
MD,US,1998.0,1,2,-1
EG,IE,2012.0,4,3,1
IR,DZ,2015.0,2,1,1
SK,CN,2021.0,3,2,1
GM,US,2012.0,2,2,0
DK,RS,2002.0,2,1,1
QA,FR,2009.0,2,8,-6
BE,BF,2013.0,1,3,-2
IN,NG,2023.0,2,2,0
CA,PE,2001.0,2,1,1
IQ,JO,2004.0,1,1,0
GR,nan,2015.0,5,2,3
AU,UY,2020.0,1,1,0
CN,SI,2022.0,2,5,-3
OM,nan,2011.0,2,1,1
IL,PT,2018.0,2,1,1
ID,BH,2019.0,2,4,-2
HU,FI,2005.0,1,5,-4
CI,NG,2021.0,1,2,-1
ZA,MX,2008.0,1,3,-2
PK,BR,2013.0,1,6,-5
MA,MY,2011.0,1,1,0
TH,TR,2007.0,2,3,-1
DE,UY,2000.0,1,2,-1
AR,IN,2017.0,2,2,0
ZA,RU,1998.0,1,2,-1
US,KZ,2009.0,3,2,1
NG,CH,2013.0,2,4,-2
ZW,SE,2005.0,1,1,0
SK,BR,2022.0,1,2,-1
NG,GB,2023.0,2,3,-1
IE,EE,2015.0,1,1,0
LS,IN,2016.0,1,1,0
KW,IQ,2022.0,2,2,0
NZ,MX,2015.0,1,2,-1
BD,CZ,2019.0,2,2,0
CH,LI,2014.0,2,2,0
MK,NL,2011.0,1,2,-1
IS,RU,2019.0,2,2,0
ZA,CZ,2023.0,1,1,0
ZA,AT,2008.0,2,5,-3
BR,MA,2014.0,1,2,-1
TH,FI,2008.0,2,1,1
LU,AE,2022.0,1,2,-1
BD,PL,2018.0,4,6,-2
PH,PE,2014.0,1,3,-2
SI,CA,2007.0,3,2,1
AU,PT,2002.0,2,2,0
TR,GR,1998.0,1,1,0
SA,DZ,2011.0,2,6,-4
IN,LT,2016.0,1,2,-1
AZ,TR,2011.0,1,7,-6
AM,CA,2014.0,1,2,-1
US,KP,2022.0,2,1,1
BF,PK,2015.0,1,1,0
MA,PT,2010.0,1,2,-1
BE,CU,2007.0,1,3,-2
CH,LK,2000.0,1,1,0
KR,QA,1998.0,1,2,-1
RO,BG,2016.0,1,5,-4
LT,ES,2016.0,1,2,-1
VN,BY,2003.0,1,2,-1
CY,IQ,2020.0,2,3,-1
NO,RS,2006.0,1,1,0
BN,CN,2000.0,1,1,0
BG,CZ,2016.0,1,1,0
SE,XK,2019.0,1,3,-2
SG,PK,2003.0,1,3,-2
MQ,GP,2013.0,2,2,0
ES,DO,2004.0,1,1,0
FI,nan,1999.0,1,5,-4
AE,DK,2012.0,1,1,0
PH,KH,2009.0,2,1,1
ZA,RU,1997.0,1,3,-2
NL,EG,1999.0,1,2,-1
SG,GR,2018.0,2,5,-3
AU,PG,2003.0,1,4,-3
UA,AZ,2004.0,1,1,0
EG,ET,2009.0,1,7,-6
TR,TH,2012.0,1,3,-2
BG,PT,2017.0,1,2,-1
CR,PE,2009.0,1,3,-2
PH,EC,2014.0,1,1,0
CH,VG,2020.0,1,1,0
GB,PG,2000.0,1,1,0
AU,MY,1997.0,3,2,1
RU,TZ,2020.0,1,1,0
GR,RU,2022.0,3,4,-1
CL,UY,1999.0,2,1,1
US,SS,2001.0,2,1,1
TR,NG,2022.0,2,5,-3
BE,PH,1999.0,1,1,0
LY,CN,2020.0,1,2,-1
SE,MZ,2019.0,3,1,2
CI,CA,2007.0,2,1,1
IT,TZ,2020.0,1,1,0
PK,SD,2008.0,1,1,0
SE,BD,2004.0,1,1,0
PH,NP,2012.0,1,3,-2
NL,BG,2000.0,2,1,1
AU,MU,2011.0,1,3,-2
TH,nan,2017.0,2,1,1
CR,RU,2003.0,1,1,0
GH,NE,2021.0,1,1,0
MM,IQ,2020.0,1,2,-1
US,MU,2011.0,1,1,0
GH,SE,2014.0,2,1,1
LV,DE,2012.0,1,1,0
IQ,CH,2017.0,1,1,0
BY,MZ,2021.0,1,1,0
TN,MY,2020.0,1,6,-5
IR,GR,2010.0,1,2,-1
PL,BG,2009.0,1,1,0
SK,AR,2006.0,1,1,0
IR,UG,2013.0,1,1,0
IT,TH,2008.0,1,4,-3
UA,EE,2012.0,1,1,0
RE,DE,2014.0,1,1,0
PL,UZ,2013.0,2,1,1
UA,SK,2022.0,2,3,-1
ET,CH,2012.0,1,1,0
ZA,TZ,2006.0,1,1,0
LB,PS,2014.0,1,1,0
CN,NG,2005.0,1,3,-2
IT,KE,2005.0,1,1,0
SI,IN,2004.0,1,2,-1
LB,CA,2023.0,1,1,0
FM,US,2020.0,1,1,0
CL,ID,2022.0,1,5,-4
GE,NO,2014.0,1,1,0
CO,KE,2007.0,1,2,-1
CH,LT,2003.0,1,1,0
DE,PY,2003.0,1,1,0
DE,AZ,2022.0,1,1,0
US,LK,2023.0,1,1,0
EC,ES,2023.0,1,2,-1
HR,IN,2020.0,1,1,0
CH,BG,2018.0,1,1,0
TH,nan,2010.0,1,2,-1
GB,HN,2019.0,1,1,0
JP,BN,2021.0,1,1,0
TR,ID,2013.0,1,1,0
PH,TH,2006.0,1,1,0
KE,CO,2006.0,1,1,0
HR,CA,2022.0,2,1,1
GB,MD,2020.0,1,2,-1
RS,ES,2008.0,2,3,-1
LK,IN,1999.0,1,1,0
TW,NL,2006.0,1,4,-3
IL,IQ,2022.0,1,2,-1
TW,NG,2016.0,1,1,0
ET,LK,2017.0,1,1,0
SN,BJ,2008.0,1,1,0
PL,AR,2015.0,1,1,0
TW,nan,2000.0,2,3,-1
GT,PE,2014.0,1,3,-2
CH,NG,2012.0,1,2,-1
AR,SE,1997.0,1,3,-2
NO,AU,2023.0,1,2,-1
SY,AU,2011.0,1,1,0
TN,GB,2017.0,2,13,-11
MD,US,1997.0,1,1,0
SI,IL,2000.0,1,1,0
SL,NG,2014.0,1,0,1
US,KG,2015.0,1,0,1
IQ,KE,2016.0,1,0,1
TR,GR,1997.0,1,0,1
VN,BD,2011.0,1,0,1
nan,CD,2013.0,1,0,1
LU,TR,2008.0,1,0,1
DE,BN,2017.0,1,0,1
JO,PK,2020.0,3,0,3
BH,TR,2014.0,1,0,1
CO,CY,2017.0,1,0,1
QA,NZ,2001.0,1,0,1
MW,NL,2013.0,1,0,1
JP,KW,2002.0,1,0,1
CN,MD,2020.0,4,0,4
IN,GH,2014.0,2,0,2
NZ,MV,2011.0,1,0,1
RU,MN,2005.0,1,0,1
MU,AU,2020.0,2,0,2
DZ,AE,2009.0,2,0,2
GW,BR,2000.0,1,0,1
FJ,MA,2021.0,1,0,1
TW,CO,2010.0,1,0,1
MW,BR,2021.0,1,0,1
BG,DZ,2014.0,1,0,1
ML,KE,2014.0,1,0,1
MM,,2011.0,2,0,2
SA,AT,2000.0,1,0,1
TW,MA,2014.0,1,0,1
TW,FI,2023.0,1,0,1
CL,AE,2014.0,1,0,1
LU,RS,2017.0,1,0,1
JP,UY,2008.0,1,0,1
NI,UA,2007.0,1,0,1
TG,NG,2011.0,1,0,1
LY,IR,2002.0,1,0,1
UZ,KR,2006.0,1,0,1
MA,GF,2011.0,1,0,1
RO,NZ,2017.0,1,0,1
IL,CY,2017.0,1,0,1
SI,ZA,2002.0,1,0,1
NG,PK,2001.0,1,0,1
US,GI,2021.0,1,0,1
RW,,2004.0,1,0,1
TO,NZ,2006.0,1,0,1
IE,QA,2010.0,1,0,1
CR,CH,2003.0,1,0,1
DZ,ID,2014.0,1,0,1
CH,AE,1998.0,1,0,1
BG,nan,1997.0,2,0,2
SO,EG,2018.0,1,0,1
MV,BN,2022.0,1,0,1
ZW,NG,2013.0,1,0,1
PL,GE,2012.0,1,0,1
GE,RU,2001.0,2,0,2
NO,RO,1999.0,1,0,1
KZ,LV,2016.0,1,0,1
GB,BI,2007.0,1,0,1
IS,UG,2012.0,1,0,1
CY,IE,2022.0,1,0,1
BD,LT,2019.0,1,0,1
IT,HK,2010.0,1,0,1
MY,SY,1997.0,1,0,1
IR,PS,2014.0,2,0,2
ZA,PH,2009.0,1,0,1
PA,BE,2020.0,1,0,1
IT,HK,2017.0,1,0,1
GT,PH,2006.0,1,0,1
CD,AU,2019.0,1,0,1
CI,FI,2011.0,1,0,1
CM,CA,2001.0,1,0,1
PE,NZ,2000.0,1,0,1
GE,TW,2004.0,1,0,1
TN,BE,2003.0,1,0,1
PF,,2002.0,1,0,1
PK,IS,2016.0,1,0,1
CM,PL,2017.0,1,0,1
CM,MX,2015.0,1,0,1
BN,CA,2022.0,1,0,1
US,NI,2000.0,1,0,1
FI,CM,2021.0,1,0,1
SN,CN,2009.0,1,0,1
MY,ZW,2019.0,1,0,1
CO,EE,2020.0,2,0,2
SY,EG,2005.0,1,0,1
PY,ES,2002.0,3,0,3
UY,DE,2008.0,1,0,1
AE,PT,2012.0,1,0,1
IN,GD,2022.0,1,0,1
BW,MW,2008.0,1,0,1
IR,AM,2005.0,1,0,1
FI,MA,2014.0,1,0,1
CA,CM,1999.0,1,0,1
IE,MN,2020.0,1,0,1
JO,NO,2018.0,1,0,1
IL,PS,2002.0,1,0,1
nan,QA,2016.0,1,0,1
DE,NI,2006.0,1,0,1
CN,PR,2010.0,1,0,1
SE,XK,2017.0,1,0,1
,AW,2016.0,1,0,1
BN,MM,2018.0,1,0,1
IL,PS,2005.0,1,0,1
DZ,BI,2017.0,1,0,1
MY,PS,2009.0,1,0,1
CZ,LY,2011.0,2,0,2
IE,KH,2011.0,1,0,1
NL,AF,2012.0,1,0,1
DZ,EG,2009.0,2,0,2
TW,HU,1997.0,1,0,1
BO,SE,2006.0,1,0,1
GE,NL,2015.0,1,0,1
BO,ID,2012.0,1,0,1
nan,TH,2004.0,1,0,1
SE,CM,2002.0,1,0,1
TR,BA,2009.0,1,0,1
RS,AZ,2006.0,1,0,1
BY,LT,2022.0,1,0,1
SD,OM,2009.0,2,0,2
CM,SA,2021.0,1,0,1
EC,IN,2021.0,1,0,1
ES,HR,2005.0,1,0,1
GF,US,2014.0,1,0,1
MG,KH,2018.0,1,0,1
NP,BE,2014.0,1,0,1
SK,KH,2020.0,1,0,1
MK,NG,2018.0,1,0,1
MC,SI,2008.0,1,0,1
US,BT,2020.0,1,0,1
GM,IQ,2017.0,1,0,1
AU,LV,2020.0,1,0,1
CR,TW,2006.0,1,0,1
SL,DE,1999.0,1,0,1
EC,GR,2002.0,1,0,1
LA,JP,2002.0,1,0,1
PL,MX,2004.0,1,0,1
IR,CL,2012.0,1,0,1
BG,TW,1999.0,1,0,1
JP,ME,1999.0,1,0,1
ZA,HR,2020.0,1,0,1
IL,EE,2018.0,1,0,1
ML,CI,1999.0,1,0,1
IT,IR,2002.0,1,0,1
RO,TR,1999.0,1,0,1
TR,VN,2017.0,1,0,1
KG,US,2004.0,1,0,1
SZ,NZ,2010.0,1,0,1
BR,BJ,2000.0,1,0,1
SL,FR,2017.0,1,0,1
CH,PE,1998.0,1,0,1
CH,CG,2006.0,1,0,1
IE,ID,2000.0,1,0,1
NL,TG,2016.0,1,0,1
GH,CD,2018.0,1,0,1
BD,KW,2004.0,1,0,1
GE,TR,2020.0,1,0,1
SK,ZA,2009.0,1,0,1
IT,ML,2004.0,1,0,1
PK,TW,1999.0,1,0,1
PH,MA,2019.0,1,0,1
DK,NG,2011.0,1,0,1
NP,CA,2002.0,1,0,1
IQ,CA,1999.0,1,0,1
PT,ID,2011.0,1,0,1
SA,NO,2004.0,1,0,1
AR,UG,2009.0,1,0,1
PF,CN,2017.0,1,0,1
HU,AR,2007.0,1,0,1
BD,TH,2006.0,1,0,1
PH,HN,2010.0,1,0,1
TR,IS,2014.0,1,0,1
JP,LB,2015.0,1,0,1
HU,JO,2023.0,1,0,1
TR,TT,2008.0,1,0,1
TT,JP,2003.0,1,0,1
PE,AO,2016.0,1,0,1
MX,UG,2016.0,1,0,1
UZ,DK,2017.0,1,0,1
BR,PA,2009.0,1,0,1
nan,AZ,2011.0,1,0,1
KE,nan,2023.0,1,0,1
DE,IS,2001.0,1,0,1
BY,QA,2017.0,1,0,1
AL,DK,2014.0,1,0,1
HU,KR,1998.0,1,0,1
SE,CM,2005.0,1,0,1
MD,NO,2021.0,1,0,1
SS,AU,2008.0,1,0,1
PT,HR,2023.0,1,0,1
MA,CG,2018.0,1,0,1
AZ,MZ,2013.0,1,0,1
MZ,MY,2014.0,1,0,1
SK,NO,2007.0,1,0,1
PA,GE,2018.0,1,0,1
VN,,2026.0,1,0,1
CH,JP,1997.0,37,25,12
ES,US,2015.0,1106,888,218
GB,US,2007.0,4726,5081,-355
SG,US,2019.0,562,611,-49
BR,NL,2020.0,79,61,18
CN,US,2003.0,3440,4608,-1168
IT,US,1999.0,498,475,23
CL,ES,2002.0,102,84,18
DE,US,2011.0,2499,2290,209
DE,IT,2008.0,155,267,-112
IE,GB,2006.0,207,264,-57
DK,GB,2000.0,54,56,-2
JP,KR,2010.0,350,308,42
US,AU,2018.0,2700,2612,88
US,JP,2004.0,1754,1959,-205
KR,US,2011.0,1170,1324,-154
nan,PL,2009.0,4,5,-1
US,IT,2017.0,904,1178,-274
TW,CN,2012.0,1372,878,494
US,EG,2018.0,339,257,82
PH,US,2010.0,413,378,35
FR,GB,2021.0,399,429,-30
AU,US,2015.0,2397,2593,-196
AT,CL,1999.0,1,1,0
AU,NZ,2019.0,221,233,-12
CN,FR,2008.0,201,319,-118
US,IT,2019.0,1065,1153,-88
ES,CH,2004.0,28,40,-12
CO,US,2004.0,94,87,7
IT,CN,2006.0,36,28,8
NZ,US,2016.0,398,415,-17
DK,US,2018.0,334,322,12
GB,AU,1997.0,390,360,30
CL,BR,2010.0,57,57,0
FR,BE,2002.0,164,177,-13
US,IT,2010.0,814,999,-185
PK,MY,2018.0,66,158,-92
US,CY,2008.0,24,16,8
JP,CA,2021.0,82,63,19
CR,CO,2014.0,45,40,5
nan,AU,2006.0,8,9,-1
ZA,US,2011.0,246,306,-60
PH,US,2017.0,408,301,107
DE,ZA,2016.0,59,64,-5
DE,TH,2015.0,33,12,21
SG,US,2017.0,551,539,12
SE,IN,2014.0,44,50,-6
IT,AU,2005.0,46,29,17
DE,IR,2016.0,55,117,-62
GB,AU,1998.0,497,441,56
GB,NZ,2015.0,250,245,5
PK,CN,2021.0,255,333,-78
SG,MY,2008.0,51,21,30
PT,UY,2022.0,3,2,1
CL,BR,2019.0,129,140,-11
RU,US,2022.0,355,259,96
US,ES,2001.0,478,464,14
PH,US,2019.0,366,279,87
IT,DE,2015.0,345,241,104
FR,DE,2014.0,542,571,-29
GB,ES,2014.0,325,524,-199
KR,RU,2007.0,10,10,0
FR,CN,2011.0,245,186,59
DE,CH,2006.0,663,404,259
AT,CH,2009.0,99,71,28
nan,US,2005.0,177,229,-52
KR,ET,2016.0,116,128,-12
BD,IN,2021.0,110,131,-21
MX,AR,2005.0,67,39,28
MX,CR,2007.0,10,21,-11
UA,KR,2017.0,1,5,-4
DE,DK,2009.0,135,95,40
GB,SG,2021.0,125,119,6
FR,VN,2018.0,69,31,38
CH,SE,2005.0,28,28,0
DE,FR,1997.0,196,160,36
NL,DE,2006.0,230,249,-19
CH,DE,2020.0,857,1041,-184
GB,ID,2019.0,121,72,49
CA,MX,2010.0,23,31,-8
CA,ES,2018.0,107,93,14
FR,US,1998.0,723,672,51
SY,CN,2019.0,21,18,3
VE,MX,2019.0,67,24,43
CN,SA,2017.0,41,52,-11
US,IL,2006.0,348,477,-129
AU,DK,2007.0,24,31,-7
AU,ES,2023.0,1,2,-1
GR,IT,2013.0,31,24,7
CA,KR,2010.0,51,52,-1
CA,AE,2013.0,22,13,9
TR,FR,2018.0,32,25,7
SE,CN,2014.0,90,92,-2
NL,ES,2021.0,81,75,6
JP,IE,2006.0,18,16,2
GB,nan,2000.0,53,25,28
ID,ZA,2016.0,30,16,14
CA,KR,2019.0,61,78,-17
IR,AU,2022.0,97,45,52
DE,IE,2009.0,85,61,24
SG,AU,2013.0,107,83,24
US,PE,2002.0,28,21,7
DE,AT,2001.0,219,219,0
JP,KR,2019.0,395,368,27
CO,SV,2016.0,6,3,3
GB,SE,2018.0,232,224,8
nan,US,2002.0,124,134,-10
FR,CH,2006.0,317,267,50
DE,NO,2017.0,120,85,35
PT,GB,2019.0,106,101,5
ZA,CA,2004.0,23,19,4
BE,FR,2008.0,261,282,-21
AU,DE,2012.0,203,225,-22
AU,IN,2000.0,27,32,-5
ES,PE,2007.0,38,41,-3
DE,IN,2016.0,226,222,4
IE,US,2004.0,226,296,-70
BR,PE,2008.0,18,17,1
CU,MX,2006.0,26,24,2
SA,IN,1998.0,8,5,3
BE,CA,2019.0,78,69,9
nan,NO,2013.0,41,28,13
HU,RO,1999.0,35,69,-34
HU,GB,2011.0,71,44,27
BE,CA,2017.0,67,66,1
DE,FR,1998.0,219,227,-8
SE,BD,2015.0,10,9,1
AU,IL,2015.0,17,20,-3
EG,YE,2012.0,5,4,1
MX,SE,2008.0,7,6,1
IT,NL,2016.0,136,90,46
CH,CN,1999.0,27,18,9
MX,AR,2002.0,32,34,-2
SK,CZ,2007.0,55,48,7
FR,KR,2009.0,21,28,-7
CA,NZ,2016.0,70,78,-8
US,GE,2014.0,170,176,-6
IN,EG,2005.0,4,6,-2
CO,PE,2016.0,83,80,3
VN,IN,2012.0,1,2,-1
CL,VE,2011.0,25,19,6
CN,JP,2023.0,41,13,28
JP,FR,2007.0,125,102,23
FR,GR,2005.0,22,19,3
HU,PL,2021.0,32,38,-6
EG,JP,2003.0,20,33,-13
ES,CN,2009.0,53,50,3
SA,ID,2018.0,37,17,20
DE,JP,2015.0,207,228,-21
SA,TN,2022.0,64,66,-2
CN,ES,2000.0,17,12,5
IN,IL,2018.0,105,56,49
CA,DE,2000.0,115,108,7
UA,MZ,2002.0,3,3,0
IN,nan,2011.0,50,33,17
RU,FI,2022.0,39,11,28
BE,SE,2011.0,23,16,7
BI,FR,2011.0,28,12,16
KR,SG,2016.0,40,40,0
NL,GB,2009.0,256,243,13
TR,US,2022.0,226,201,25
FR,GP,2018.0,44,20,24
CH,IN,2008.0,20,21,-1
JP,IT,2003.0,43,38,5
FR,DZ,2013.0,137,75,62
GR,GB,2004.0,90,117,-27
NL,SY,2012.0,3,1,2
AU,NZ,2017.0,197,220,-23
PE,VE,2017.0,10,9,1
RU,UA,2021.0,404,562,-158
FI,CN,2008.0,16,15,1
SY,CN,2010.0,32,28,4
TH,SE,2015.0,11,10,1
BR,nan,2021.0,150,106,44
VN,CN,2009.0,46,20,26
CN,IN,2010.0,174,185,-11
CN,SE,2005.0,52,74,-22
US,ID,2015.0,159,130,29
CN,TR,2014.0,66,107,-41
TW,CA,2002.0,26,21,5
CH,NZ,2007.0,15,6,9
LB,CN,2018.0,30,12,18
RU,CN,2015.0,48,54,-6
ID,CN,2011.0,21,18,3
IR,US,2016.0,794,391,403
CN,IN,2019.0,183,306,-123
DE,IL,2013.0,58,56,2
SG,US,2010.0,251,344,-93
NO,VN,2018.0,9,3,6
NO,FR,2017.0,59,74,-15
US,HR,2016.0,47,26,21
IR,GB,2021.0,115,63,52
GB,AT,1999.0,20,20,0
IE,SE,2013.0,21,10,11
CH,JP,1998.0,51,41,10
GR,US,2022.0,85,72,13
AU,AR,2020.0,16,17,-1
EC,MX,2008.0,6,5,1
CA,KR,2017.0,57,81,-24
FR,BE,2005.0,214,233,-19
TN,FR,2004.0,63,81,-18
CH,FR,2015.0,357,535,-178
NI,CO,2020.0,4,5,-1
FI,PK,2021.0,6,13,-7
NO,FR,2010.0,50,52,-2
RU,AM,2010.0,8,6,2
RU,AM,2019.0,23,30,-7
nan,GB,2021.0,61,97,-36
MY,GB,2020.0,117,148,-31
FR,US,1997.0,539,558,-19
PT,GB,2010.0,65,112,-47
FR,RE,2018.0,54,55,-1
QA,IT,2020.0,4,6,-2
CH,BR,2018.0,66,75,-9
ES,LT,2012.0,2,1,1
CN,SE,2002.0,40,39,1
RO,GB,2009.0,24,22,2
SK,GB,2015.0,16,15,1
ES,VE,1999.0,32,28,4
US,IR,1998.0,10,11,-1
US,JO,2003.0,16,13,3
MW,KE,2022.0,1,4,-3
AT,SE,2015.0,34,19,15
DK,IR,2021.0,8,36,-28
JP,NG,2011.0,7,5,2
IT,CH,2012.0,308,172,136
GR,NO,2015.0,17,7,10
EG,CA,2011.0,43,31,12
BE,GB,2020.0,152,179,-27
CO,PY,2021.0,9,7,2
PL,NL,2022.0,10,12,-2
NO,IN,2021.0,25,35,-10
DZ,FR,2020.0,124,146,-22
NL,NZ,2016.0,16,14,2
ID,US,2020.0,227,363,-136
CO,FR,2015.0,37,32,5
US,AE,2016.0,91,62,29
BE,NL,2021.0,249,212,37
AU,RU,2017.0,51,24,27
US,FI,2021.0,116,111,5
CH,SE,2002.0,17,29,-12
EC,BR,2012.0,10,9,1
IT,GR,2002.0,13,11,2
FR,PH,2016.0,9,8,1
PL,ES,2009.0,15,14,1
MN,US,2012.0,4,4,0
BR,JP,2021.0,45,24,21
IT,BG,1999.0,10,8,2
AE,JP,2009.0,3,2,1
AT,FR,2018.0,48,64,-16
EG,CN,2022.0,33,52,-19
MX,CU,2018.0,62,94,-32
FI,NO,2015.0,23,13,10
PE,MX,1998.0,18,13,5
LK,GB,2016.0,18,36,-18
BE,CN,2016.0,61,76,-15
IN,KE,2006.0,1,2,-1
MX,CZ,2019.0,3,10,-7
AT,CN,2022.0,19,13,6
US,AT,2001.0,173,139,34
SE,ZA,2000.0,6,2,4
nan,NL,2006.0,46,60,-14
GB,SA,2003.0,23,17,6
NL,PT,2006.0,15,9,6
ZA,NG,2007.0,13,10,3
PL,CA,2016.0,35,27,8
SG,JP,2016.0,33,46,-13
CA,MX,2017.0,60,44,16
VE,BR,2014.0,26,17,9
ID,MX,2006.0,1,2,-1
SE,SA,2020.0,10,4,6
NO,IE,2017.0,4,5,-1
KR,PK,2010.0,10,4,6
NO,SE,2013.0,75,94,-19
ZA,RO,2014.0,3,4,-1
EG,TN,2013.0,10,8,2
ID,TH,2020.0,31,25,6
GB,PK,2008.0,61,55,6
IN,KR,2022.0,175,75,100
IE,NZ,2009.0,11,8,3
AU,NZ,2010.0,130,163,-33
DE,EE,2018.0,74,33,41
IR,AF,2018.0,6,1,5
IT,PK,2020.0,14,10,4
HU,BE,2016.0,10,13,-3
LT,CH,2022.0,1,2,-1
MY,AU,2009.0,52,35,17
DE,NO,2019.0,124,100,24
GB,MY,2003.0,59,13,46
ZM,GH,2020.0,35,21,14
HR,RS,1998.0,9,13,-4
RS,HR,2008.0,79,81,-2
CO,CL,2000.0,16,14,2
JO,US,2021.0,68,49,19
CL,CO,2022.0,92,96,-4
BR,DK,2021.0,43,19,24
TH,AU,2015.0,21,47,-26
AU,RU,2019.0,39,24,15
IL,US,2023.0,15,9,6
IE,BR,2013.0,11,10,1
PH,CN,2020.0,22,24,-2
HR,DE,2021.0,18,15,3
CN,IN,2017.0,130,223,-93
BR,CL,2005.0,22,35,-13
CY,TR,2016.0,25,87,-62
TR,CY,2022.0,25,39,-14
NG,TZ,2019.0,3,6,-3
PY,PT,2020.0,2,1,1
DK,NO,2006.0,50,63,-13
SK,JP,2014.0,10,4,6
FR,GR,2002.0,28,10,18
TR,RS,2009.0,65,95,-30
ID,CL,2020.0,15,13,2
AU,JP,2004.0,44,63,-19
DE,RU,2007.0,132,143,-11
CZ,nan,2016.0,6,9,-3
ET,EG,2021.0,8,16,-8
EE,DE,2004.0,16,17,-1
DE,PT,2011.0,53,28,25
EE,IN,2021.0,4,6,-2
AL,GB,2019.0,3,3,0
SY,MA,2022.0,7,1,6
BR,TR,2012.0,32,23,9
MX,CN,2018.0,17,7,10
RO,MD,2018.0,15,8,7
IR,FR,2016.0,47,28,19
AR,ID,2018.0,3,3,0
SE,FR,2008.0,73,50,23
CD,ZA,2018.0,1,4,-3
PT,nan,2007.0,25,18,7
CU,CR,2012.0,17,13,4
UY,BR,2022.0,22,21,1
CN,MX,2020.0,14,12,2
BE,ZA,1997.0,7,2,5
GB,BW,2018.0,8,4,4
YE,MY,2019.0,8,20,-12
GH,CN,2021.0,14,53,-39
PK,SE,2023.0,3,1,2
AM,RU,2016.0,14,7,7
CL,ES,2005.0,120,132,-12
JP,KR,2017.0,358,406,-48
KR,PK,2019.0,76,37,39
CD,UG,2019.0,4,2,2
JP,BE,2009.0,25,12,13
GB,NG,2015.0,82,61,21
CN,SA,2019.0,56,44,12
IT,RU,2011.0,22,27,-5
AR,JP,2014.0,7,2,5
MY,ZA,2013.0,4,1,3
FR,PT,2012.0,58,39,19
EC,CN,2019.0,1,4,-3
ES,IR,2019.0,20,28,-8
IT,NG,2015.0,8,10,-2
AT,IE,2017.0,8,2,6
ZA,UG,2020.0,17,13,4
IT,BE,2018.0,183,118,65
LT,BY,2019.0,1,1,0
DE,CA,2023.0,8,8,0
TH,TW,2017.0,9,13,-4
IN,JP,2008.0,118,112,6
CH,IS,2008.0,1,3,-2
SE,nan,2016.0,30,78,-48
EG,IL,2014.0,4,9,-5
IT,MA,2007.0,12,7,5
DE,PH,2005.0,4,7,-3
FR,IE,2009.0,40,30,10
UY,ES,2006.0,23,19,4
BY,SI,2001.0,2,1,1
ES,DK,1997.0,6,12,-6
PT,IN,2010.0,3,19,-16
RU,MX,2002.0,14,8,6
HU,BR,2013.0,2,2,0
CZ,BY,2022.0,10,5,5
CW,NL,2012.0,9,14,-5
UA,US,2001.0,46,15,31
LU,BE,2009.0,13,18,-5
SK,AT,2011.0,12,16,-4
BG,GR,2003.0,4,2,2
IT,ID,2016.0,9,6,3
AU,AE,2008.0,13,3,10
PL,KR,2017.0,10,4,6
PH,KR,2008.0,3,3,0
US,RS,1997.0,10,11,-1
GH,NL,2013.0,3,7,-4
GB,LK,2016.0,36,18,18
US,HU,2009.0,100,105,-5
HR,FI,2018.0,3,3,0
CU,EC,2015.0,42,3,39
CH,KE,2015.0,5,1,4
LV,RS,2016.0,1,1,0
BE,CA,2010.0,56,59,-3
DE,SG,2013.0,36,22,14
NL,RS,2019.0,10,11,-1
NO,UG,2018.0,5,1,4
ZA,NL,2020.0,65,38,27
BE,MA,2000.0,3,1,2
SA,DE,2016.0,27,31,-4
IN,ES,2008.0,22,9,13
GB,ET,2012.0,8,8,0
US,BY,2001.0,4,12,-8
IE,FR,2016.0,32,46,-14
MX,JP,1997.0,5,3,2
GB,NO,2001.0,28,24,4
VE,PE,2019.0,22,10,12
FR,PL,2004.0,40,32,8
ZA,FR,2016.0,36,38,-2
US,BD,2016.0,120,152,-32
CZ,SE,2018.0,15,18,-3
SI,DE,1997.0,6,2,4
FR,PE,2022.0,9,10,-1
PL,DE,2001.0,59,50,9
BE,CZ,2022.0,6,13,-7
LT,JP,2016.0,7,4,3
PK,VN,2020.0,5,3,2
RU,EE,2011.0,3,6,-3
FR,BO,2000.0,4,2,2
CZ,AR,2017.0,3,2,1
GB,LY,2005.0,4,1,3
GR,DE,2004.0,23,30,-7
AU,ID,2020.0,77,67,10
NL,GR,2001.0,6,8,-2
RO,IT,2015.0,19,25,-6
FR,IL,2007.0,29,32,-3
MY,JP,2014.0,34,100,-66
UA,IT,2020.0,20,15,5
FI,PT,2018.0,9,4,5
DE,FI,2016.0,68,79,-11
EC,VE,2009.0,2,1,1
nan,RU,2004.0,29,31,-2
BY,PL,2012.0,6,1,5
DE,AU,2000.0,80,73,7
JP,IQ,2011.0,3,5,-2
DZ,SA,2011.0,6,2,4
MX,CA,2009.0,21,34,-13
IE,SG,2014.0,6,6,0
CR,NL,2022.0,2,3,-1
TR,IN,2022.0,17,19,-2
AT,IT,2001.0,14,23,-9
FR,KE,2001.0,1,1,0
NL,JP,2014.0,27,33,-6
CZ,JP,2001.0,7,7,0
HU,DE,2003.0,44,32,12
RO,AU,2018.0,2,2,0
GR,SA,2019.0,10,1,9
CA,VN,2014.0,7,6,1
SK,NO,2008.0,2,1,1
BE,JP,2009.0,12,25,-13
LB,IT,2006.0,3,7,-4
CO,CR,2014.0,40,45,-5
GF,FR,2016.0,18,21,-3
BG,US,2000.0,26,20,6
NL,NG,2011.0,5,2,3
MW,US,2014.0,19,15,4
GB,RU,2008.0,58,90,-32
SA,PK,2008.0,11,14,-3
GR,SA,2017.0,7,2,5
CH,CM,2013.0,6,3,3
CN,LB,2015.0,31,32,-1
FR,NO,2022.0,32,23,9
NL,PL,2022.0,12,10,2
NO,FR,2019.0,75,74,1
FR,BJ,2018.0,30,20,10
BO,CU,2018.0,2,1,1
DZ,PT,2019.0,2,6,-4
US,SI,2018.0,20,24,-4
AT,BR,2016.0,9,20,-11
MX,FR,2005.0,28,43,-15
RU,AM,2017.0,11,17,-6
NZ,SG,2009.0,9,6,3
CN,CH,1999.0,18,27,-9
ES,NL,2023.0,9,4,5
NL,IR,2022.0,20,46,-26
PH,LK,2013.0,1,1,0
CN,ID,2000.0,3,3,0
SN,US,2011.0,6,7,-1
IE,CH,2002.0,4,6,-2
TH,TW,2019.0,15,16,-1
BY,CA,2008.0,4,2,2
NO,PK,2013.0,6,9,-3
CA,GE,2016.0,2,1,1
CA,NO,2006.0,18,14,4
ES,IL,2006.0,8,10,-2
VE,MX,2017.0,55,42,13
JP,ID,2002.0,25,19,6
ID,JP,2000.0,8,20,-12
MX,AF,2022.0,1,2,-1
NL,RS,2010.0,3,6,-3
LT,BY,2017.0,1,1,0
KE,PK,2020.0,8,7,1
IQ,KR,2019.0,1,2,-1
BO,AR,2018.0,4,3,1
BY,IR,2018.0,3,1,2
SX,US,2022.0,4,2,2
CU,FR,2012.0,7,1,6
ZW,IN,2022.0,2,3,-1
US,SZ,2017.0,4,1,3
IQ,IR,2021.0,18,24,-6
CH,EE,2018.0,12,17,-5
IT,TR,2002.0,7,10,-3
TH,AT,2018.0,6,2,4
GH,KE,2021.0,3,2,1
VN,ZA,2021.0,2,1,1
US,RO,2022.0,51,38,13
NI,EC,2021.0,2,1,1
GR,JP,2013.0,45,18,27
FR,RS,2010.0,4,1,3
ZM,MW,2016.0,2,1,1
DE,NO,2010.0,81,52,29
PH,MX,2014.0,10,9,1
PA,EC,2019.0,5,4,1
MX,CH,2022.0,13,2,11
CN,IL,2021.0,28,27,1
CH,PT,2015.0,15,25,-10
GB,SD,2014.0,5,9,-4
AU,SG,2003.0,48,31,17
SY,CN,2017.0,20,9,11
EC,FR,2018.0,8,21,-13
IN,ZA,2023.0,4,1,3
FI,NL,2005.0,25,31,-6
DE,KE,2013.0,16,10,6
LU,US,2005.0,3,6,-3
RS,TR,2008.0,63,67,-4
RO,SE,2017.0,16,6,10
RU,MZ,2016.0,6,19,-13
PS,DE,1998.0,1,2,-1
RO,SE,2010.0,4,7,-3
MY,AR,2014.0,4,2,2
JP,PT,2018.0,3,5,-2
TT,JM,2011.0,13,13,0
AU,SE,2015.0,58,55,3
US,BG,2020.0,30,23,7
FI,DE,2011.0,55,56,-1
CL,FR,2004.0,17,16,1
JP,AU,2000.0,37,37,0
FR,CZ,2018.0,47,33,14
IL,RU,2012.0,19,20,-1
IQ,MY,2018.0,29,173,-144
RU,RO,2018.0,5,7,-2
AR,GB,2011.0,19,26,-7
ME,HR,2015.0,3,3,0
FR,QA,2016.0,14,5,9
SE,TZ,2011.0,5,6,-1
IT,DZ,2004.0,7,3,4
PH,SA,2010.0,2,1,1
PT,IN,2017.0,24,9,15
BA,GB,2010.0,1,2,-1
SE,NO,2011.0,77,72,5
GB,MA,2001.0,1,2,-1
UY,FR,2016.0,7,9,-2
FI,AU,2008.0,15,6,9
TZ,KE,1999.0,1,1,0
IQ,IN,2018.0,4,16,-12
US,GA,2021.0,2,3,-1
US,SD,2016.0,6,6,0
IS,CA,1999.0,3,1,2
BG,RS,2009.0,6,2,4
NZ,ZA,2002.0,3,12,-9
AU,SI,2022.0,2,3,-1
TH,IE,2020.0,5,2,3
BH,TZ,2007.0,4,4,0
VE,MX,2010.0,47,34,13
ES,IR,2017.0,14,18,-4
US,GH,2011.0,16,7,9
HR,RS,1997.0,8,7,1
RS,RO,2010.0,2,1,1
DK,EE,2018.0,2,2,0
CH,MX,2012.0,13,12,1
IT,nan,2000.0,60,63,-3
NL,DK,1997.0,8,5,3
AR,NL,2004.0,4,2,2
US,PK,2001.0,44,51,-7
AT,IE,2019.0,6,9,-3
BR,IE,2008.0,5,9,-4
ZA,MZ,2015.0,2,1,1
HU,NO,2020.0,3,3,0
GB,ID,2010.0,17,12,5
PK,IR,2015.0,13,16,-3
ES,DK,1998.0,8,20,-12
MY,RU,2016.0,22,10,12
ID,FI,2009.0,1,1,0
CN,ET,2020.0,23,17,6
AT,IE,2010.0,8,13,-5
IR,AE,2014.0,4,2,2
UG,GB,2015.0,13,4,9
CH,CZ,2001.0,12,12,0
AR,CL,2003.0,20,27,-7
PK,TN,2022.0,4,1,3
EG,SA,2003.0,26,23,3
ES,CR,2000.0,11,7,4
BR,BE,2002.0,17,20,-3
US,RS,1998.0,14,24,-10
IT,AU,2002.0,31,23,8
IN,TR,2021.0,18,21,-3
HR,SK,2015.0,6,6,0
US,TN,2001.0,5,1,4
KR,AU,2005.0,18,18,0
ZA,CN,2017.0,20,15,5
ZA,CN,2019.0,20,18,2
TW,CA,2005.0,32,30,2
JO,SE,2020.0,2,1,1
PE,VE,2010.0,3,7,-4
PE,CL,2005.0,17,17,0
FI,CZ,2017.0,15,6,9
RS,FR,2022.0,5,2,3
ES,CA,2004.0,40,41,-1
SE,GR,2013.0,11,26,-15
RU,BG,2000.0,7,9,-2
SG,NO,2012.0,3,1,2
CU,HN,2018.0,1,2,-1
OM,EG,2004.0,2,3,-1
HK,US,2016.0,13,15,-2
PT,FI,2020.0,6,10,-4
ZA,IN,2007.0,17,20,-3
BA,GB,2017.0,6,5,1
SD,BR,2003.0,2,2,0
FI,IS,2016.0,2,1,1
EG,JO,2002.0,2,5,-3
LV,SE,1999.0,4,3,1
UY,CL,2012.0,11,7,4
PK,ZA,2022.0,3,1,2
TN,QA,2009.0,3,1,2
RU,KZ,2011.0,15,9,6
QA,EG,2001.0,1,4,-3
IS,FR,2014.0,6,3,3
SE,LT,2022.0,1,3,-2
CL,PT,2015.0,11,11,0
VE,PE,2017.0,9,10,-1
US,PE,2005.0,26,34,-8
US,BH,2015.0,6,7,-1
FI,CZ,2019.0,10,6,4
CL,CH,2003.0,7,4,3
DE,TW,2011.0,24,27,-3
AR,AU,2012.0,11,8,3
TN,IR,2013.0,4,7,-3
BR,IL,2016.0,7,11,-4
PK,DE,2001.0,4,2,2
MU,US,2015.0,2,2,0
CN,AE,2015.0,9,8,1
IE,PL,2020.0,6,4,2
IT,TH,2007.0,5,4,1
HU,UA,2020.0,7,5,2
CH,RU,2006.0,22,24,-2
SG,SA,2015.0,11,1,10
RU,AZ,2009.0,6,3,3
ZA,AT,2007.0,6,4,2
DE,BH,2020.0,1,1,0
PL,XK,2015.0,5,1,4
CL,DE,2003.0,20,20,0
PL,FI,1997.0,2,1,1
TR,KW,2022.0,5,3,2
JP,PS,2006.0,1,1,0
UZ,PL,2011.0,2,1,1
ID,FR,2012.0,17,18,-1
PF,JP,2014.0,1,1,0
FR,PS,2015.0,4,1,3
AE,MY,2020.0,10,28,-18
AR,BE,2020.0,10,10,0
MA,JP,2020.0,1,3,-2
NL,AT,2001.0,10,13,-3
SA,GB,2004.0,15,30,-15
KR,TH,2003.0,3,6,-3
IR,NZ,2019.0,26,10,16
TH,TW,2010.0,5,4,1
FR,MD,2015.0,39,53,-14
SE,IE,2005.0,7,1,6
KR,MY,2023.0,2,2,0
SA,US,2004.0,35,61,-26
SE,IR,2020.0,37,67,-30
BR,BE,2005.0,34,35,-1
VE,PE,2010.0,7,3,4
PS,SA,2014.0,5,7,-2
TW,DE,2012.0,20,28,-8
IL,AU,1999.0,5,7,-2
PK,ES,2013.0,6,3,3
RS,GB,2012.0,18,34,-16
VN,AT,2017.0,2,2,0
MA,US,2007.0,6,13,-7
MY,AE,2012.0,8,4,4
NL,TH,2005.0,4,3,1
LK,GR,2013.0,6,3,3
UA,nan,2013.0,19,15,4
DK,AU,2004.0,25,14,11
CN,LT,2001.0,7,6,1
SI,DE,1998.0,6,6,0
FI,NL,2002.0,20,20,0
MA,BE,2022.0,4,4,0
YE,MY,2017.0,9,20,-11
HR,DK,2009.0,2,1,1
IT,PL,2007.0,21,16,5
FR,GA,1997.0,3,2,1
MY,NZ,2013.0,7,29,-22
SE,AT,2007.0,13,17,-4
ZA,IR,2015.0,5,5,0
RE,FR,2006.0,24,14,10
BE,DZ,2013.0,8,2,6
DZ,nan,2015.0,8,10,-2
US,TZ,2007.0,9,10,-1
QA,OM,2013.0,1,3,-2
PL,JP,2008.0,17,18,-1
OM,MY,2011.0,4,3,1
AU,IR,2006.0,22,12,10
IT,KR,2017.0,14,2,12
NL,TH,2002.0,6,2,4
IT,KR,2010.0,7,6,1
NO,IE,2019.0,5,10,-5
GB,KE,2000.0,9,8,1
IL,ES,2016.0,8,16,-8
BE,CM,2016.0,6,7,-1
GE,SE,1997.0,1,1,0
IQ,JO,2015.0,7,4,3
GB,PA,2016.0,8,8,0
TR,KE,2018.0,1,2,-1
ES,NG,2017.0,1,3,-2
CO,RU,2007.0,1,1,0
US,NO,2023.0,13,1,12
ID,SE,2012.0,2,3,-1
BG,AU,2004.0,5,3,2
AT,LI,2022.0,4,2,2
AU,GH,2013.0,3,4,-1
JM,TT,2004.0,8,7,1
PH,SA,2017.0,2,2,0
KR,AU,2002.0,7,8,-1
US,AM,2021.0,7,18,-11
IL,CH,2009.0,13,15,-2
PH,CA,2003.0,8,7,1
DE,PH,2002.0,1,1,0
IN,CM,2014.0,5,1,4
TN,DE,2004.0,3,3,0
MD,TN,2008.0,6,6,0
MZ,ES,2010.0,2,3,-1
AT,NO,2004.0,3,1,2
AR,PL,2021.0,3,2,1
NP,nan,2016.0,5,1,4
SD,KE,2007.0,1,4,-3
ZA,CN,2010.0,10,14,-4
CL,CN,2013.0,2,4,-2
BW,NG,2013.0,1,3,-2
PK,MX,2004.0,4,1,3
PE,CL,2002.0,11,12,-1
UY,PT,2019.0,4,5,-1
CL,GT,2022.0,3,2,1
CA,LB,2009.0,10,13,-3
nan,NG,2021.0,13,5,8
RS,CN,2003.0,4,8,-4
PL,FI,1998.0,3,1,2
US,OM,2000.0,9,5,4
DE,CR,2009.0,2,1,1
US,MM,2016.0,7,7,0
AT,IN,2008.0,7,5,2
HU,EE,2017.0,2,1,1
US,IR,1997.0,13,6,7
JP,SA,2009.0,15,5,10
EC,BE,2011.0,2,6,-4
KR,SE,2018.0,8,5,3
CY,GR,1998.0,2,4,-2
TH,BD,2022.0,2,7,-5
BR,CL,2002.0,18,24,-6
SN,FR,2013.0,34,42,-8
ID,BG,2019.0,3,2,1
NP,TH,2014.0,3,8,-5
QA,KR,1998.0,2,1,1
CN,SA,2010.0,9,6,3
IN,PL,2007.0,5,3,2
PE,DE,2012.0,3,7,-4
MA,EG,2017.0,13,7,6
GB,HK,2016.0,3,7,-4
BD,KW,2015.0,1,5,-4
KW,EG,2007.0,12,12,0
NP,JP,2020.0,4,12,-8
BR,NO,2012.0,19,25,-6
PK,JP,2013.0,11,16,-5
IT,TR,2005.0,13,15,-2
AE,IN,1999.0,1,1,0
BG,FI,2002.0,1,2,-1
TR,CH,1997.0,3,2,1
US,LV,2000.0,1,5,-4
PK,AE,2007.0,4,4,0
nan,ET,2018.0,1,3,-2
GB,KZ,2013.0,3,3,0
BR,ST,2001.0,6,6,0
GB,LA,2017.0,4,1,3
NP,GB,2016.0,10,10,0
RU,TW,2005.0,9,12,-3
TH,TR,2008.0,1,3,-2
RS,NL,2011.0,8,8,0
FR,RS,2017.0,9,9,0
RU,CR,2019.0,7,7,0
FR,NZ,2015.0,14,22,-8
CA,nan,2004.0,18,9,9
RS,BG,2012.0,1,10,-9
CY,IT,2022.0,4,3,1
CN,QA,2005.0,2,4,-2
BG,IT,2012.0,10,4,6
NI,MX,2016.0,7,4,3
ET,CN,2013.0,2,3,-1
PE,VE,2019.0,10,22,-12
UY,PT,2017.0,2,6,-4
CL,HU,2016.0,3,1,2
ZM,BR,2015.0,9,14,-5
AL,GB,2017.0,2,1,1
TH,KR,2012.0,10,11,-1
MM,NZ,2020.0,1,1,0
MK,CN,2009.0,2,7,-5
GB,VN,2020.0,16,17,-1
NG,FR,2006.0,6,3,3
SK,FI,2017.0,2,1,1
HU,RU,2011.0,8,9,-1
PH,JP,2021.0,20,23,-3
EC,PL,2018.0,2,1,1
CO,UY,2014.0,6,5,1
AU,MX,2016.0,20,23,-3
IT,CM,2022.0,5,1,4
BR,DZ,2017.0,1,1,0
BE,CU,2008.0,3,1,2
PT,IN,2019.0,24,21,3
ES,BD,2008.0,12,7,5
UZ,FR,2013.0,2,1,1
RU,PE,2021.0,7,4,3
FR,NC,2000.0,6,5,1
DE,NP,2022.0,3,3,0
KW,FR,2018.0,7,8,-1
BG,MK,2020.0,3,4,-1
IT,BJ,2007.0,2,2,0
NO,KR,2017.0,6,5,1
MG,FR,2007.0,7,8,-1
GB,ZM,2015.0,6,5,1
DK,KR,2017.0,9,3,6
UA,AU,2021.0,3,2,1
NO,BR,2015.0,22,25,-3
GB,ZW,2002.0,5,4,1
UG,JP,2021.0,2,2,0
MX,CZ,2017.0,11,2,9
IL,SA,2011.0,1,1,0
PT,DK,1998.0,1,5,-4
CZ,MX,2014.0,4,2,2
PL,MX,2015.0,5,10,-5
CN,FI,2023.0,6,2,4
PH,MY,2020.0,3,3,0
UA,GB,2013.0,6,8,-2
PY,CO,2020.0,14,18,-4
NG,AE,2019.0,1,4,-3
BG,JP,2016.0,3,6,-3
RS,PL,2014.0,8,13,-5
GL,DK,2019.0,5,7,-2
FR,UY,2016.0,9,7,2
GB,MK,2022.0,1,4,-3
RS,XK,2005.0,2,3,-1
TW,TH,2014.0,11,3,8
MZ,ES,2017.0,3,2,1
RO,CN,2006.0,2,1,1
RO,SE,2019.0,7,5,2
GR,ES,2004.0,8,4,4
ID,KE,2016.0,8,4,4
NL,SK,2014.0,5,6,-1
KR,BE,2008.0,4,6,-2
BE,nan,2003.0,12,16,-4
RE,MG,2013.0,2,2,0
GR,FI,2011.0,3,3,0
TN,PG,2013.0,4,1,3
HU,ZA,2019.0,1,2,-1
UZ,AZ,2014.0,2,3,-1
PL,ZA,2013.0,2,1,1
JP,NP,2004.0,3,3,0
JO,CN,2013.0,3,3,0
NO,BG,1998.0,2,4,-2
CA,UY,1998.0,1,1,0
IL,SG,2013.0,8,3,5
ID,GB,2009.0,5,17,-12
RW,US,2014.0,8,6,2
BJ,CH,2000.0,1,1,0
KW,US,2007.0,15,16,-1
IT,GR,2005.0,15,14,1
UA,IL,2016.0,5,2,3
PL,MZ,2012.0,11,8,3
DE,PE,2013.0,4,4,0
NO,ES,2006.0,12,15,-3
BE,NZ,1998.0,1,1,0
JP,GR,2013.0,18,45,-27
SE,EG,2018.0,4,12,-8
DK,FO,2018.0,4,4,0
GR,NL,2007.0,10,15,-5
CG,BR,2005.0,1,1,0
PL,KR,2019.0,5,6,-1
BO,CR,2011.0,1,3,-2
IT,TN,2011.0,5,15,-10
TR,GB,2000.0,22,60,-38
VE,CU,2014.0,14,13,1
PK,IE,2013.0,2,12,-10
DK,KR,2019.0,4,10,-6
IR,ID,2012.0,4,4,0
PT,AR,2006.0,7,5,2
NO,KR,2010.0,2,8,-6
HN,ES,2008.0,3,3,0
CA,MW,2008.0,1,2,-1
CR,DE,2004.0,2,1,1
CY,IN,2021.0,5,2,3
LT,GB,1999.0,2,2,0
PS,AE,2010.0,1,1,0
GP,US,2018.0,1,2,-1
BE,SA,2021.0,4,3,1
CA,JM,2016.0,2,8,-6
SE,CL,2014.0,4,9,-5
FI,UA,1999.0,2,2,0
CZ,AU,2018.0,8,14,-6
LV,US,1998.0,9,2,7
GB,NP,2022.0,6,7,-1
SE,JP,2000.0,25,30,-5
SK,FI,2010.0,1,1,0
AU,BE,2009.0,24,26,-2
nan,FI,2015.0,11,16,-5
RO,UA,2015.0,3,2,1
CZ,FR,2022.0,13,29,-16
NG,GH,2011.0,2,3,-1
SA,IT,2012.0,6,11,-5
DE,SI,2007.0,6,5,1
FR,RS,2019.0,9,8,1
JP,IN,2023.0,4,7,-3
CO,VN,2020.0,1,1,0
nan,UA,2007.0,7,9,-2
MX,DO,2021.0,4,1,3
CZ,BE,2009.0,6,6,0
KW,SA,2003.0,1,2,-1
ZA,nan,2011.0,4,11,-7
PS,ID,2020.0,2,1,1
DE,CW,2019.0,5,1,4
BW,CA,2016.0,1,2,-1
CD,UG,2017.0,1,1,0
PH,NL,2011.0,5,3,2
PH,VN,2018.0,3,2,1
RU,PT,2021.0,6,15,-9
HR,NL,2017.0,6,6,0
ZA,IL,2018.0,6,1,5
BA,HR,2022.0,24,25,-1
CD,BE,2014.0,1,18,-17
QA,CA,2023.0,2,1,1
IR,NZ,2010.0,4,2,2
PK,PL,2015.0,11,11,0
CH,LU,2014.0,5,8,-3
SG,IT,2020.0,6,5,1
JP,PK,2006.0,12,9,3
US,NP,2001.0,4,10,-6
EG,BH,2022.0,8,4,4
nan,BE,2018.0,27,21,6
LB,KW,2020.0,2,2,0
GR,RO,2007.0,3,4,-1
DE,GE,2015.0,3,3,0
CW,ID,2021.0,3,1,2
DE,ID,2006.0,4,3,1
nan,AR,2022.0,15,22,-7
CG,UG,2021.0,2,1,1
NL,CL,2013.0,8,11,-3
NG,CM,2007.0,2,2,0
CR,GB,2013.0,7,4,3
CO,BE,2007.0,5,2,3
ES,NZ,2005.0,4,1,3
ES,DO,2015.0,7,3,4
NO,RU,2006.0,5,10,-5
US,CG,2009.0,3,2,1
AT,ZA,2001.0,2,1,1
VE,AR,2007.0,11,15,-4
TH,ES,2017.0,2,2,0
EC,PT,2020.0,7,6,1
BR,IN,1999.0,2,8,-6
CN,MY,2004.0,9,17,-8
UA,BR,2001.0,4,4,0
TH,NZ,2013.0,4,4,0
ES,NZ,2002.0,2,1,1
MK,HR,2016.0,2,1,1
DE,CW,2017.0,1,1,0
MX,CZ,2010.0,2,1,1
BN,ID,2020.0,5,4,1
AG,US,2020.0,4,7,-3
NG,AE,2010.0,1,1,0
BD,FR,2009.0,2,2,0
UY,MX,2006.0,7,4,3
BO,FR,2009.0,6,3,3
AT,RO,2013.0,9,3,6
CO,DE,2004.0,4,2,2
MY,OM,2016.0,6,4,2
BE,PT,2018.0,12,24,-12
ZW,GB,2007.0,5,2,3
KE,RW,2020.0,4,8,-4
AU,PH,2022.0,4,9,-5
BR,ZM,2011.0,5,3,2
BG,UA,2009.0,9,4,5
AR,AT,2007.0,4,2,2
IR,SI,2013.0,1,1,0
FR,ME,2010.0,1,1,0
SI,CA,2008.0,3,5,-2
EG,TW,2020.0,17,36,-19
AT,TR,2007.0,7,3,4
SE,TN,2020.0,2,5,-3
AT,KR,2013.0,4,4,0
SY,SA,2022.0,3,5,-2
PT,IE,2019.0,12,6,6
UZ,GB,2018.0,1,6,-5
NE,US,2003.0,1,2,-1
PE,MX,1997.0,4,3,1
GL,DK,2010.0,3,5,-2
NL,IS,2013.0,5,1,4
GT,CL,2010.0,6,3,3
PT,AO,2011.0,3,3,0
CN,BY,2015.0,3,3,0
CH,SI,1998.0,1,3,-2
PS,EG,2007.0,1,2,-1
nan,CL,2011.0,6,6,0
IT,SG,2005.0,1,2,-1
NL,SA,2005.0,2,2,0
NG,FI,2017.0,2,2,0
NG,ZA,2003.0,3,3,0
PH,BD,2013.0,2,2,0
AU,RO,2021.0,5,7,-2
CU,AR,2000.0,10,8,2
TR,RO,2013.0,3,3,0
AU,BW,2022.0,1,2,-1
nan,CZ,2021.0,5,4,1
PE,GT,2021.0,6,2,4
CI,ML,2014.0,2,2,0
IT,RO,2021.0,8,17,-9
MR,EG,2019.0,1,1,0
FI,JP,2021.0,7,8,-1
PL,GR,2009.0,6,6,0
PT,MZ,2002.0,3,2,1
CO,DK,2004.0,1,1,0
AU,JM,2016.0,4,4,0
UY,PT,2010.0,3,2,1
NZ,ES,2008.0,4,3,1
KR,NL,2007.0,7,3,4
CO,AT,2021.0,4,3,1
RU,TW,2002.0,10,12,-2
nan,TW,2003.0,3,5,-2
MZ,IT,2021.0,1,1,0
CL,PA,2020.0,6,7,-1
ZA,MU,2018.0,1,2,-1
LU,US,2002.0,4,3,1
CO,NL,2008.0,2,2,0
IR,SA,2020.0,12,16,-4
PK,CZ,2019.0,6,7,-1
NO,PL,2022.0,7,11,-4
DE,GA,1999.0,1,2,-1
ZM,CZ,2019.0,2,1,1
ZA,AE,2007.0,2,1,1
CO,NO,2014.0,1,2,-1
EG,AT,1997.0,2,2,0
AU,BN,2005.0,1,1,0
QA,KR,1997.0,2,3,-1
BE,PE,2006.0,2,1,1
CO,GT,2014.0,3,2,1
MA,EG,2019.0,7,15,-8
OM,AU,2012.0,2,2,0
DE,MA,2021.0,6,6,0
GT,CL,2019.0,3,12,-9
DE,LI,2014.0,5,2,3
GR,LU,2014.0,3,3,0
PT,IE,2017.0,6,9,-3
NG,FI,2019.0,1,5,-4
NO,PT,2004.0,2,2,0
TR,SD,2020.0,3,3,0
IS,NO,1998.0,2,2,0
AE,NZ,2013.0,2,10,-8
SC,AU,2020.0,1,2,-1
FI,CZ,2010.0,8,9,-1
TW,MN,2019.0,1,1,0
UA,KR,2010.0,2,1,1
ET,TZ,2022.0,3,1,2
KH,IN,2020.0,2,1,1
PE,NI,2021.0,1,2,-1
AU,ZA,2023.0,4,6,-2
GL,DK,2017.0,3,6,-3
NG,SA,2016.0,10,10,0
DZ,PT,2017.0,1,1,0
MX,SV,2006.0,1,1,0
nan,PK,2012.0,4,5,-1
JO,SA,2001.0,4,3,1
GE,GB,2022.0,4,1,3
FR,BG,2022.0,3,2,1
NL,PG,2018.0,1,1,0
BE,PS,2013.0,4,2,2
BA,SK,2019.0,4,2,2
SK,HR,2013.0,2,3,-1
CO,HN,2009.0,1,3,-2
AE,JO,2005.0,2,5,-3
BJ,KE,2020.0,3,2,1
NL,RS,2017.0,10,6,4
NO,LT,1999.0,2,2,0
AE,nan,2022.0,1,5,-4
LB,EG,2008.0,3,4,-1
DK,KR,2010.0,4,3,1
MX,JP,1998.0,1,2,-1
KR,SK,2011.0,2,1,1
EG,JO,2005.0,2,2,0
GB,LU,2007.0,2,2,0
CI,CA,2008.0,2,2,0
SV,CL,2014.0,1,3,-2
EG,KR,2013.0,6,7,-1
AU,SC,2017.0,1,1,0
PE,FR,2006.0,2,1,1
BD,MY,2008.0,11,13,-2
NO,IE,2010.0,2,5,-3
BE,SG,2000.0,1,1,0
TR,KR,2004.0,6,3,3
FI,AR,2016.0,3,1,2
ES,PK,2007.0,1,1,0
SD,IN,2014.0,3,1,2
CO,AE,2020.0,3,1,2
AL,IT,2011.0,1,2,-1
AE,AU,2011.0,6,8,-2
RS,RO,2019.0,1,3,-2
SK,IN,2002.0,1,1,0
PS,ES,2003.0,1,1,0
PE,BR,1999.0,4,4,0
SI,IN,2015.0,2,3,-1
MK,AL,2021.0,2,2,0
DZ,SE,2015.0,3,5,-2
KE,BH,2022.0,1,1,0
PA,EC,2017.0,4,2,2
MM,AU,2019.0,1,10,-9
MX,IL,2016.0,3,6,-3
MY,IL,2017.0,2,1,1
AR,IL,2001.0,3,1,2
PA,CR,2011.0,1,1,0
LA,AU,2019.0,2,1,1
GB,ZW,2005.0,2,7,-5
SD,QA,2018.0,2,1,1
ES,IR,2010.0,6,9,-3
TH,BE,2012.0,3,2,1
BD,SE,2020.0,7,5,2
GB,BG,1997.0,1,3,-2
NO,HU,1997.0,2,1,1
MY,BD,2006.0,3,2,1
KR,ES,2003.0,5,1,4
CG,US,2002.0,1,2,-1
PK,NO,2012.0,1,6,-5
CL,PY,2018.0,10,6,4
US,LT,1999.0,3,2,1
BY,GB,2016.0,1,2,-1
CZ,RU,2000.0,11,7,4
GE,CZ,2009.0,2,1,1
PK,KW,1998.0,1,1,0
VN,CO,2016.0,1,1,0
TW,CH,2005.0,2,2,0
AM,JP,2019.0,2,1,1
LK,FR,2004.0,1,1,0
FR,LT,2005.0,4,2,2
MY,PK,2000.0,2,3,-1
JP,RS,2014.0,4,1,3
IR,NZ,2017.0,14,7,7
ET,IT,2018.0,4,4,0
TR,MY,2022.0,4,6,-2
LK,KR,2009.0,2,2,0
SI,TW,2009.0,4,1,3
BF,SN,2006.0,1,1,0
TW,ES,2015.0,6,5,1
NE,FR,2006.0,6,2,4
EG,RU,2009.0,4,1,3
MX,PA,2021.0,5,7,-2
PS,IR,2020.0,1,2,-1
DE,MN,2017.0,2,2,0
ES,FI,2009.0,16,20,-4
TT,BB,2012.0,1,3,-2
NL,GA,2012.0,5,6,-1
FR,MC,2009.0,4,4,0
BE,SI,2022.0,3,7,-4
HR,CH,2004.0,3,2,1
EC,JP,2017.0,1,1,0
JO,IT,2008.0,1,3,-2
FR,LB,1998.0,3,2,1
SG,HK,2022.0,1,3,-2
SD,US,2006.0,4,2,2
SK,UA,2012.0,4,5,-1
BR,TN,2018.0,1,1,0
BE,MD,2015.0,1,4,-3
KE,BJ,2019.0,2,2,0
GR,CL,2018.0,1,1,0
GB,MU,2012.0,2,1,1
CZ,UZ,2000.0,1,2,-1
CZ,BA,2018.0,1,1,0
SM,IT,2016.0,3,1,2
TW,PL,2010.0,3,3,0
DK,GR,2018.0,5,17,-12
IE,CO,2007.0,1,3,-2
AT,UA,2005.0,3,4,-1
SV,PE,2013.0,1,1,0
IE,TH,2015.0,2,1,1
BE,RO,2007.0,3,6,-3
JO,CA,2005.0,4,8,-4
AT,GH,2007.0,1,1,0
UA,OM,2020.0,3,3,0
JO,JP,2022.0,3,1,2
FI,PL,1998.0,1,3,-2
CA,NG,2005.0,2,4,-2
GB,DZ,2005.0,2,4,-2
IE,NO,2022.0,4,3,1
BJ,CG,2018.0,1,1,0
TZ,US,2008.0,3,9,-6
TW,PL,2017.0,4,4,0
DZ,ZA,2019.0,3,1,2
CY,BE,2021.0,1,2,-1
AE,IE,2015.0,2,4,-2
BR,RO,2015.0,6,4,2
BE,NG,2018.0,5,2,3
RU,PK,2021.0,3,8,-5
PK,ZW,2019.0,3,1,2
KE,ET,2006.0,4,1,3
US,CI,2001.0,2,1,1
UA,KR,2019.0,3,1,2
DK,GW,2016.0,3,3,0
BO,DE,2014.0,3,2,1
SE,LV,2014.0,6,4,2
BE,BD,2011.0,2,2,0
KR,IL,2022.0,3,3,0
KH,GB,2015.0,4,3,1
CU,GB,2020.0,4,5,-1
NZ,AE,2022.0,1,1,0
PT,SD,2011.0,1,1,0
UG,TZ,2016.0,3,3,0
GH,AU,2011.0,2,2,0
NZ,FI,2008.0,3,1,2
ET,PK,2014.0,1,1,0
IQ,EG,2007.0,1,1,0
CZ,BG,2004.0,2,1,1
IN,PA,2016.0,3,2,1
UG,IN,2013.0,1,4,-3
DE,NG,2004.0,3,5,-2
DK,UA,2020.0,2,4,-2
YE,MY,2010.0,5,5,0
PY,AR,2011.0,4,4,0
CO,KE,2008.0,3,2,1
BE,HK,2017.0,3,1,2
TZ,IN,2011.0,1,1,0
MY,PH,2014.0,2,1,1
SK,HU,2011.0,4,20,-16
MM,KR,2014.0,2,1,1
AU,CZ,2012.0,6,8,-2
EG,ZA,2020.0,4,3,1
RU,CR,2017.0,1,3,-2
AO,PT,2015.0,2,6,-4
DZ,ES,2006.0,1,2,-1
UY,CO,2022.0,3,7,-4
CA,VE,2016.0,1,8,-7
IN,YE,2018.0,5,1,4
KE,BJ,2017.0,2,1,1
US,BA,2001.0,4,1,3
PA,SE,2016.0,4,1,3
GB,QA,2000.0,4,4,0
JP,AM,2020.0,1,1,0
AU,EE,1999.0,2,1,1
PK,nan,2012.0,5,4,1
FR,LT,2002.0,2,2,0
EG,MY,2002.0,1,6,-5
PH,NZ,2000.0,1,1,0
CZ,AR,2010.0,1,1,0
TR,AZ,1999.0,2,1,1
GT,CL,2017.0,2,3,-1
HR,NL,2019.0,7,5,2
PL,KR,2010.0,6,4,2
LK,AU,2023.0,2,2,0
IE,EG,2011.0,2,2,0
NZ,ZA,2005.0,7,4,3
CL,DO,2015.0,1,3,-2
AU,GE,2015.0,2,4,-2
LK,BN,2013.0,2,1,1
DE,KZ,2012.0,4,3,1
GE,DE,2006.0,4,2,2
GB,KN,2020.0,1,3,-2
ZM,CZ,2010.0,1,1,0
IE,FI,2011.0,3,2,1
PL,IL,2003.0,1,3,-2
NO,HU,1998.0,2,2,0
ES,ZA,2000.0,2,2,0
SE,IE,2002.0,2,2,0
UZ,IN,2011.0,2,2,0
BN,LK,2013.0,1,2,-1
ES,NG,2019.0,4,3,1
PT,CL,1999.0,1,2,-1
BF,CG,2013.0,4,1,3
US,ML,2007.0,1,4,-3
PT,VE,2016.0,2,3,-1
EE,CA,2011.0,2,4,-2
PK,ET,2017.0,2,2,0
IE,CL,2001.0,1,1,0
CA,NG,2002.0,1,1,0
TJ,RU,2007.0,2,2,0
ET,JP,2000.0,2,1,1
AT,MY,2013.0,4,2,2
FR,BY,1999.0,1,1,0
NG,AE,2017.0,1,1,0
BR,AE,2019.0,5,2,3
MN,DZ,2020.0,2,2,0
BE,UY,2015.0,1,2,-1
PT,SE,2006.0,3,7,-4
BR,AE,2017.0,1,3,-2
AT,FI,2014.0,4,13,-9
XK,US,2013.0,1,1,0
FI,PL,1997.0,1,2,-1
VN,AT,2019.0,2,4,-2
BE,SY,2012.0,2,1,1
BR,CR,1999.0,1,2,-1
TG,FR,2004.0,1,3,-2
ET,PH,2022.0,1,1,0
PA,IT,2021.0,1,1,0
GB,LY,2002.0,1,1,0
TH,IN,2001.0,2,1,1
GB,BB,2016.0,2,5,-3
XK,RS,2005.0,3,2,1
BR,SV,2002.0,1,1,0
CR,CA,2014.0,1,2,-1
SA,ES,2021.0,3,12,-9
BA,SK,2017.0,1,1,0
IT,MM,2019.0,1,1,0
JO,IN,2021.0,1,3,-2
EG,MY,2005.0,4,3,1
BD,PK,1999.0,3,5,-2
NG,SE,2014.0,2,1,1
VN,NL,2005.0,2,4,-2
FI,GR,2002.0,2,2,0
HR,IE,2015.0,4,3,1
ID,IN,2007.0,1,1,0
AU,TT,2016.0,1,1,0
CO,ES,2012.0,390,437,-47
FR,LU,2015.0,53,34,19
FR,IN,2018.0,119,155,-36
NL,US,2015.0,704,797,-93
US,CL,2018.0,278,264,14
JP,ID,2005.0,57,16,41
IN,MY,2007.0,48,23,25
CL,US,2012.0,231,212,19
PT,US,2011.0,148,171,-23
NO,US,2016.0,154,190,-36
HN,CL,2014.0,2,7,-5
VE,US,2000.0,21,29,-8
MX,FR,2002.0,22,32,-10
CL,BR,2017.0,122,113,9
AR,NZ,2015.0,1,1,0
GH,CA,2018.0,8,8,0
AZ,UZ,2021.0,4,3,1
MY,CN,2009.0,24,33,-9
ES,PT,2012.0,174,139,35
UY,DE,2007.0,2,1,1
GB,TR,2012.0,99,83,16
IL,GB,2012.0,54,44,10
CU,VE,2016.0,15,9,6
ZW,KE,2019.0,3,2,1
CA,MX,2019.0,36,47,-11
MY,NG,2012.0,11,20,-9
IR,HU,2014.0,3,3,0
AE,EG,2008.0,9,12,-3
KR,TW,2014.0,34,55,-21
IN,AU,1999.0,32,28,4
RU,GB,2014.0,92,90,2
IN,TW,2016.0,66,45,21
RU,KG,2018.0,7,3,4
SE,DZ,2019.0,9,8,1
GB,ID,2017.0,93,48,45
KR,BD,2021.0,29,22,7
IE,CH,2005.0,6,4,2
PA,DE,2022.0,6,1,5
PT,GB,2017.0,133,106,27
IT,KR,2019.0,7,14,-7
AU,NP,2022.0,11,16,-5
US,AR,2003.0,134,175,-41
NZ,JP,2000.0,15,18,-3
NL,DK,1998.0,16,16,0
LK,CA,2004.0,2,3,-1
CA,NL,2009.0,77,83,-6
CH,IL,2008.0,7,15,-8
FR,SN,2003.0,16,15,1
JP,AT,2015.0,23,14,9
NG,CN,2011.0,6,4,2
MX,IN,2020.0,9,12,-3
FI,IT,2020.0,22,107,-85
IT,BI,2010.0,1,1,0
MW,GB,2018.0,20,24,-4
OM,IN,2018.0,21,27,-6
NO,DK,2005.0,43,45,-2
US,BF,2016.0,3,5,-2
BN,BD,2020.0,3,1,2
IR,RU,2022.0,6,5,1
AE,JO,2002.0,3,4,-1
VE,CO,2020.0,63,31,32
MA,FR,2004.0,138,207,-69
NL,AU,2006.0,53,33,20
KR,PK,2017.0,49,57,-8
US,IQ,2014.0,18,20,-2
IL,PL,2022.0,15,5,10
SE,IS,2002.0,10,5,5
HU,SE,2004.0,10,12,-2
SA,SG,2016.0,6,7,-1
AR,DE,2007.0,23,23,0
nan,SE,2002.0,52,47,5
AR,UY,2002.0,8,4,4
ES,PY,2021.0,22,18,4
PK,CH,2000.0,8,4,4
UG,CH,2011.0,2,1,1
AT,KE,2020.0,3,4,-1
LV,KR,2002.0,1,1,0
nan,SE,2005.0,51,36,15
DK,nan,2001.0,9,5,4
GB,SS,2006.0,12,7,5
CZ,DE,2008.0,59,56,3
US,UG,2006.0,13,10,3
SK,GE,2002.0,1,2,-1
SA,IN,1997.0,5,5,0
TR,CZ,2013.0,5,4,1
LK,CN,2008.0,2,1,1
EC,CN,2017.0,2,1,1
ES,EC,1998.0,1,1,0
AU,RU,2010.0,11,11,0
SA,CA,1999.0,6,9,-3
LK,GH,2013.0,1,1,0
DK,JP,2021.0,9,12,-3
CN,PK,2024.0,2,1,1
AU,SK,2015.0,1,4,-3
MY,nan,2008.0,15,14,1
SE,DZ,2017.0,6,4,2
GR,AU,2008.0,4,9,-5
CZ,ES,2000.0,3,3,0
TR,RW,2015.0,2,2,0
SA,JP,2007.0,3,8,-5
AR,UY,2005.0,9,13,-4
SE,IS,2005.0,6,9,-3
CH,BJ,1999.0,1,1,0
PL,AR,2004.0,1,1,0
QA,SE,2009.0,1,3,-2
LT,DE,2003.0,3,5,-2
US,BS,2020.0,5,5,0
ID,JO,2018.0,1,5,-4
NL,TR,2003.0,9,11,-2
MD,DE,2005.0,3,3,0
AU,TW,2003.0,17,9,8
EG,SE,2012.0,6,6,0
AM,KR,2011.0,8,2,6
IT,FI,2000.0,7,4,3
CU,PE,2008.0,4,7,-3
MU,GB,2017.0,3,3,0
AU,KR,2000.0,12,5,7
DK,MX,2022.0,3,4,-1
UA,BG,2001.0,1,4,-3
AM,JP,2010.0,4,4,0
CH,IR,2006.0,2,5,-3
CN,TH,2003.0,5,2,3
PT,IE,2010.0,5,4,1
NG,JP,1999.0,3,1,2
CN,HK,2001.0,1,2,-1
MM,RU,2019.0,3,4,-1
BY,NL,2005.0,3,3,0
CZ,CN,2000.0,7,1,6
OM,BD,2021.0,6,2,4
RO,BR,2007.0,2,2,0
CA,LT,2008.0,2,2,0
PK,TR,2002.0,2,1,1
HR,NL,2010.0,3,8,-5
SE,AU,2023.0,4,2,2
RS,ES,2007.0,1,1,0
BE,HR,2014.0,1,2,-1
SN,DE,2016.0,1,1,0
EG,PL,2007.0,4,3,1
IE,GR,2008.0,3,4,-1
RU,IE,2001.0,3,2,1
DE,CW,2010.0,3,1,2
JP,SI,2007.0,1,3,-2
QA,AE,2022.0,11,3,8
RO,IR,2018.0,2,2,0
IS,CH,2021.0,1,1,0
BZ,US,2006.0,1,1,0
ES,NO,1999.0,6,9,-3
DE,IQ,2022.0,4,7,-3
UA,HU,2020.0,5,7,-2
BD,RU,2019.0,1,2,-1
US,SZ,2019.0,1,1,0
IR,TR,2000.0,2,3,-1
CN,CL,2000.0,1,1,0
BW,CN,2019.0,1,5,-4
PK,PH,2016.0,3,1,2
PS,MY,2012.0,1,6,-5
MX,TW,2012.0,2,2,0
TH,PK,2016.0,5,3,2
PL,PT,2001.0,3,1,2
RU,MX,2005.0,4,5,-1
NC,US,2009.0,1,2,-1
UZ,TR,2020.0,2,2,0
TR,DZ,2015.0,1,3,-2
BD,CA,2004.0,9,8,1
AE,US,2012.0,42,87,-45
QA,MY,2018.0,5,11,-6
GH,NO,2018.0,5,3,2
UY,US,2015.0,17,26,-9
NO,DK,2002.0,43,43,0
LU,ES,2009.0,1,2,-1
PK,CZ,2017.0,3,2,1
ES,PH,2020.0,24,11,13
NL,MY,2004.0,1,2,-1
AU,MT,2022.0,3,1,2
DE,MW,2020.0,2,1,1
VG,JP,2003.0,1,2,-1
,ZA,2002.0,1310,0,1310
,US,2013.0,75308,0,75308
FR,,2011.0,8163,0,8163
CA,,2016.0,8040,0,8040
,ML,2002.0,32,0,32
ML,,2024.0,290,0,290
,LB,2001.0,171,0,171
,TW,2009.0,5080,0,5080
EC,,2021.0,1292,0,1292
,ID,2010.0,5459,0,5459
,IL,2010.0,2349,0,2349
,ID,2017.0,23874,0,23874
KR,,2018.0,4903,0,4903
SG,,2002.0,199,0,199
,CL,2009.0,1941,0,1941
,AU,1999.0,5148,0,5148
,NG,2004.0,1024,0,1024
GB,,2008.0,7721,0,7721
ID,,2021.0,11081,0,11081
NL,,2013.0,3374,0,3374
,BR,2015.0,21525,0,21525
,MY,2000.0,611,0,611
VE,,2007.0,123,0,123
GR,,2022.0,4686,0,4686
PS,,2024.0,693,0,693
UY,CA,2004.0,1,0,1
,RU,2001.0,7053,0,7053
,DK,2009.0,2049,0,2049
ES,,2003.0,2110,0,2110
,TN,2013.0,1714,0,1714
,CR,2009.0,299,0,299
BJ,LK,2009.0,1,0,1
,SA,2003.0,372,0,372
NO,,2011.0,1306,0,1306
CN,,2005.0,2808,0,2808
,ZA,2005.0,1667,0,1667
MA,,2018.0,834,0,834
,PK,2018.0,3431,0,3431
IS,,2022.0,316,0,316
,LT,2008.0,591,0,591
,NG,1996.0,446,0,446
BD,,2017.0,567,0,567
CN,,2002.0,1329,0,1329
GB,SL,2016.0,4,0,4
EG,,2008.0,252,0,252
SY,,2004.0,10,0,10
,EE,2003.0,247,0,247
VG,CN,2016.0,2,0,2
PT,,2001.0,109,0,109
,PH,2016.0,744,0,744
SG,,2005.0,243,0,243
IT,,2003.0,2403,0,2403
BD,,2019.0,783,0,783
PT,SA,2006.0,1,0,1
TR,,2006.0,623,0,623
,MA,2013.0,1312,0,1312
,HR,2001.0,586,0,586
DK,,2015.0,1179,0,1179
BH,,2023.0,377,0,377
PA,,2024.0,265,0,265
GE,,2012.0,63,0,63
,BN,2012.0,27,0,27
LR,,2024.0,26,0,26
,MK,2002.0,40,0,40
,KZ,2008.0,143,0,143
IL,,1999.0,503,0,503
,LV,2012.0,423,0,423
QA,JP,2003.0,2,0,2
PE,,2012.0,109,0,109
,SK,2014.0,990,0,990
,CM,2008.0,215,0,215
,LK,2015.0,541,0,541
CY,MA,2002.0,1,0,1
SS,US,2014.0,4,0,4
AL,,2023.0,346,0,346
,ID,2019.0,5423,0,5423
UA,LU,2002.0,1,0,1
LY,,2021.0,108,0,108
SI,,2022.0,1135,0,1135
,IL,2019.0,1405,0,1405
BD,,2010.0,82,0,82
,UG,2014.0,331,0,331
,IL,2017.0,2203,0,2203
IS,JP,2001.0,1,0,1
AR,NC,2020.0,1,0,1
CO,,1998.0,35,0,35
CM,,2015.0,77,0,77
TN,,2004.0,43,0,43
HT,,2009.0,3,0,3
,SI,2003.0,568,0,568
,MZ,2016.0,76,0,76
SD,,2006.0,9,0,9
,SY,2013.0,102,0,102
JE,,2023.0,4,0,4
DZ,,2025.0,130,0,130
JP,SV,2015.0,1,0,1
SA,NO,2015.0,3,0,3
BA,FR,2016.0,2,0,2
FR,IQ,2006.0,1,0,1
MN,,2008.0,8,0,8
CR,JP,2005.0,1,0,1
,MR,2015.0,13,0,13
,ER,2017.0,7,0,7
RO,RU,1997.0,1,0,1
MZ,ES,2019.0,3,0,3
KW,TN,2022.0,1,0,1
UG,GN,2017.0,1,0,1
CZ,,1998.0,120,0,120
RO,SK,2014.0,4,0,4
,GH,1994.0,109,0,109
BF,,2019.0,103,0,103
BF,,2010.0,15,0,15
,NC,2016.0,18,0,18
IT,BH,2002.0,1,0,1
,BF,1999.0,42,0,42
KW,,2001.0,41,0,41
OM,,1999.0,8,0,8
,KG,2002.0,5,0,5
AZ,GE,2011.0,6,0,6
,MD,2011.0,95,0,95
,MK,2005.0,77,0,77
IR,EE,2019.0,4,0,4
MR,EG,2017.0,1,0,1
TN,NL,2008.0,1,0,1
LU,,2007.0,19,0,19
BA,AU,2019.0,3,0,3
TZ,KZ,2021.0,1,0,1
CY,CH,2016.0,3,0,3
CV,,2020.0,4,0,4
AZ,FR,2013.0,1,0,1
IN,TT,2008.0,3,0,3
BE,TG,2017.0,1,0,1
LV,PL,2017.0,1,0,1
GH,OM,2020.0,5,0,5
KR,FI,2003.0,6,0,6
AM,CN,2008.0,3,0,3
GE,MY,2020.0,2,0,2
AM,,2012.0,81,0,81
,SD,1996.0,56,0,56
DK,CA,2023.0,5,0,5
KR,JO,2015.0,2,0,2
BF,,2017.0,64,0,64
,BT,2016.0,14,0,14
,SD,2004.0,52,0,52
,ML,2005.0,25,0,25
NL,SR,2014.0,5,0,5
,RW,2006.0,31,0,31
CZ,MM,2020.0,10,0,10
ET,,2008.0,35,0,35
CM,FI,2008.0,1,0,1
US,BJ,2000.0,1,0,1
CZ,XK,2016.0,2,0,2
PE,DK,2011.0,1,0,1
ZW,LS,2009.0,1,0,1
GB,AZ,2014.0,3,0,3
NO,LK,2009.0,1,0,1
,HT,1998.0,2,0,2
DK,LK,2020.0,3,0,3
SN,,2013.0,28,0,28
MG,,2013.0,20,0,20
JP,ZM,1999.0,2,0,2
NI,,2018.0,34,0,34
DO,PE,2009.0,1,0,1
MW,,2013.0,24,0,24
UG,CD,2011.0,1,0,1
BI,NL,2003.0,1,0,1
CY,BD,2019.0,1,0,1
NZ,MU,2014.0,1,0,1
EC,AR,2003.0,1,0,1
,DO,1999.0,15,0,15
CL,ET,2016.0,1,0,1
CR,SV,2014.0,1,0,1
EG,DK,2007.0,2,0,2
BO,IT,2012.0,1,0,1
ID,IR,2003.0,2,0,2
IR,LU,2014.0,1,0,1
DK,LT,2022.0,2,0,2
MQ,,2001.0,2,0,2
HR,ID,2019.0,2,0,2
,BO,1994.0,23,0,23
MM,IN,2011.0,2,0,2
BA,PL,2016.0,3,0,3
CR,,2000.0,8,0,8
NG,MW,1998.0,1,0,1
,MC,2003.0,3,0,3
NO,ZA,2003.0,3,0,3
HK,,2001.0,5,0,5
HU,MN,2020.0,1,0,1
TG,,2009.0,9,0,9
BJ,TR,2018.0,2,0,2
ZA,BG,2018.0,2,0,2
VE,CA,2003.0,5,0,5
NA,GB,2006.0,1,0,1
UG,SE,2021.0,3,0,3
BY,KR,2007.0,2,0,2
MZ,VN,2010.0,1,0,1
SK,MK,2014.0,1,0,1
FI,LT,2009.0,1,0,1
KE,IR,2013.0,1,0,1
MD,DK,2008.0,1,0,1
MW,BW,2012.0,1,0,1
CF,US,2003.0,1,0,1
RU,CO,2003.0,1,0,1
AU,NC,2011.0,2,0,2
UA,HK,2004.0,1,0,1
NG,ZM,2022.0,3,0,3
GR,CW,1998.0,1,0,1
PE,EC,2000.0,2,0,2
SG,MX,2004.0,9,0,9
NG,TZ,2017.0,4,0,4
DE,LU,1999.0,5,0,5
GB,SJ,2009.0,1,0,1
PH,ML,2016.0,1,0,1
BE,GM,2016.0,1,0,1
SE,HN,2013.0,1,0,1
SJ,CN,2017.0,1,0,1
GB,CW,2000.0,1,0,1
nan,NA,2013.0,1,0,1
MK,GB,2004.0,1,0,1
TR,LB,2006.0,4,0,4
HU,NG,2009.0,1,0,1
GE,CN,2001.0,1,0,1
TR,TG,2014.0,2,0,2
FR,LB,1997.0,11,0,11
KW,NG,2013.0,1,0,1
TW,TN,2010.0,2,0,2
TH,ES,2010.0,2,0,2
HU,RS,2022.0,3,0,3
BR,SG,2006.0,2,0,2
PS,BH,2015.0,2,0,2
TN,OM,2010.0,1,0,1
PH,SA,2019.0,1,0,1
DE,PA,1998.0,1,0,1
CM,CI,2016.0,2,0,2
PS,AE,2017.0,2,0,2
BO,GT,2019.0,1,0,1
MZ,LT,2016.0,2,0,2
MK,CM,2020.0,1,0,1
CN,OM,2021.0,4,0,4
ZM,NZ,2017.0,1,0,1
PA,DO,2020.0,1,0,1
YE,AR,2018.0,2,0,2
,BG,2020.0,14,0,14
DZ,MX,2020.0,1,0,1
GP,,2004.0,2,0,2
LU,MX,2021.0,1,0,1
,GN,1999.0,7,0,7
AF,,2015.0,7,0,7
CN,BA,2014.0,1,0,1
MK,LT,2009.0,1,0,1
BR,HU,2014.0,3,0,3
GB,BM,2015.0,1,0,1
GH,RU,2018.0,1,0,1
AU,UG,1998.0,2,0,2
IR,CZ,2023.0,2,0,2
,KG,2005.0,12,0,12
PK,IT,2003.0,3,0,3
TN,CO,2009.0,1,0,1
LB,LK,2013.0,1,0,1
AU,BY,2014.0,1,0,1
FR,NE,2004.0,3,0,3
BR,DZ,2019.0,1,0,1
RW,,2015.0,9,0,9
UA,MD,2011.0,1,0,1
DE,FO,2012.0,1,0,1
,PF,1995.0,10,0,10
CG,LU,2004.0,1,0,1
CM,IL,2005.0,1,0,1
ZA,NP,1999.0,1,0,1
GM,,2006.0,4,0,4
BR,AM,2020.0,1,0,1
GR,MX,1998.0,2,0,2
ST,CO,2021.0,1,0,1
KR,GE,1999.0,1,0,1
HR,AR,2013.0,1,0,1
GM,SN,2006.0,2,0,2
,ER,2010.0,5,0,5
LK,FI,2014.0,1,0,1
MK,IE,2007.0,1,0,1
ER,US,2005.0,1,0,1
IQ,LB,2012.0,1,0,1
BD,RU,2017.0,2,0,2
AZ,BR,2000.0,2,0,2
AR,SV,2000.0,1,0,1
HR,JO,2019.0,3,0,3
IQ,PS,2015.0,2,0,2
IT,NP,2008.0,1,0,1
NG,IL,2008.0,1,0,1
BE,KZ,2018.0,1,0,1
FR,ME,2019.0,1,0,1
PY,PE,2003.0,1,0,1
CZ,EE,2003.0,1,0,1
NZ,PT,2018.0,1,0,1
GR,SG,2003.0,2,0,2
NO,UA,2008.0,2,0,2
EG,KE,2002.0,1,0,1
UZ,RS,2011.0,7,0,7
BH,HR,2017.0,1,0,1
PE,GB,1997.0,1,0,1
BF,SE,2015.0,4,0,4
MR,,2016.0,9,0,9
MG,CA,2005.0,1,0,1
AM,JP,2017.0,4,0,4
ZM,IT,2022.0,1,0,1
IT,SG,2002.0,4,0,4
SG,PL,2002.0,4,0,4
TN,OM,2017.0,5,0,5
AE,SE,1997.0,1,0,1
BS,,2004.0,1,0,1
TN,PT,2008.0,1,0,1
OM,TR,2016.0,1,0,1
DK,HR,2004.0,1,0,1
LB,QA,2023.0,1,0,1
SD,JO,2020.0,2,0,2
LB,IN,2008.0,2,0,2
CL,KN,2014.0,1,0,1
PT,MZ,2005.0,1,0,1
ID,BG,2017.0,3,0,3
UG,OM,2014.0,1,0,1
CN,BH,2003.0,2,0,2
,BB,1999.0,7,0,7
LV,BR,2011.0,1,0,1
QA,FI,2001.0,1,0,1
NG,FI,2010.0,2,0,2
PH,EG,2013.0,2,0,2
ZA,JO,2022.0,1,0,1
ML,MA,2022.0,2,0,2
TW,GM,2020.0,1,0,1
MZ,nan,2019.0,1,0,1
DZ,KR,2002.0,2,0,2
RO,MY,2013.0,1,0,1
LK,MM,2020.0,1,0,1
US,MR,2012.0,1,0,1
NZ,RO,2012.0,1,0,1
NA,TZ,2005.0,1,0,1
BY,NL,2002.0,2,0,2
BR,KE,2003.0,1,0,1
KR,IE,2007.0,5,0,5
MD,DE,2002.0,2,0,2
BG,AM,2015.0,1,0,1
FR,IS,2023.0,1,0,1
ID,LK,2006.0,1,0,1
CO,MZ,2011.0,1,0,1
IL,UZ,2012.0,1,0,1
US,NE,2009.0,1,0,1
PS,SY,2007.0,1,0,1
ET,LS,2003.0,1,0,1
EC,CO,2004.0,4,0,4
NL,KG,2020.0,1,0,1
BH,LB,1999.0,1,0,1
BA,IT,2013.0,1,0,1
TN,MD,2000.0,2,0,2
SK,KW,1999.0,2,0,2
IN,LY,2006.0,1,0,1
KR,LY,2017.0,1,0,1
ZM,GB,2004.0,2,0,2
GT,SE,2001.0,1,0,1
RU,BD,2020.0,2,0,2
BR,LT,2017.0,1,0,1
LT,NL,2011.0,2,0,2
AL,NL,2019.0,1,0,1
MY,TR,1999.0,1,0,1
AD,CO,2007.0,1,0,1
KE,UG,1999.0,1,0,1
BE,PA,2006.0,1,0,1
HR,EG,2003.0,1,0,1
AM,TH,2012.0,3,0,3
GN,US,2016.0,1,0,1
CA,MN,2016.0,2,0,2
UA,TH,2019.0,2,0,2
CZ,LT,2020.0,6,0,6
BF,IT,2000.0,1,0,1
NA,,2006.0,3,0,3
KE,BD,2019.0,2,0,2
CY,TW,2018.0,1,0,1
,MV,2006.0,1,0,1
BH,KE,2014.0,4,0,4
NP,DK,2007.0,1,0,1
IT,PG,2015.0,1,0,1
SG,PR,2012.0,1,0,1
SV,,2005.0,3,0,3
FJ,CA,2012.0,1,0,1
ZW,RU,2006.0,4,0,4
GB,BJ,2014.0,2,0,2
NZ,JM,2013.0,3,0,3
JM,EG,2009.0,1,0,1
CA,LK,2000.0,3,0,3
CA,VG,2005.0,1,0,1
MM,RU,2017.0,1,0,1
UA,CH,1997.0,3,0,3
MA,PL,2022.0,1,0,1
RO,BF,2019.0,1,0,1
ID,ML,2015.0,1,0,1
PL,LY,1998.0,1,0,1
BB,CN,2018.0,1,0,1
FR,ME,2017.0,1,0,1
ID,VE,2005.0,2,0,2
IL,KR,1998.0,3,0,3
TH,NG,2015.0,1,0,1
BR,AE,2010.0,1,0,1
AR,RO,2012.0,2,0,2
YE,AE,2012.0,2,0,2
JO,PT,2010.0,1,0,1
PK,AF,2015.0,2,0,2
MA,NZ,2011.0,1,0,1
ST,,2018.0,6,0,6
KW,CH,2008.0,1,0,1
HN,CR,2021.0,1,0,1
GR,LV,2016.0,1,0,1
DZ,KW,2021.0,2,0,2
SC,,2014.0,1,0,1
,MO,2007.0,5,0,5
DZ,RO,2021.0,2,0,2
OM,FI,2018.0,1,0,1
PL,EC,2005.0,1,0,1
VG,DE,2016.0,1,0,1
IE,LT,2020.0,1,0,1
NG,nan,2001.0,1,0,1
RS,GD,2013.0,1,0,1
PF,GP,2001.0,1,0,1
LU,LV,2007.0,1,0,1
MR,ML,2016.0,2,0,2
HU,ZA,2010.0,2,0,2
,GF,2006.0,9,0,9
GP,SN,2006.0,1,0,1
LY,JO,2020.0,2,0,2
DE,PR,2013.0,1,0,1
TW,MM,2006.0,1,0,1
IT,MT,1999.0,1,0,1
RO,EG,2019.0,1,0,1
AE,LB,2009.0,2,0,2
HU,EE,2010.0,2,0,2
MO,FR,2007.0,2,0,2
PL,TH,2014.0,1,0,1
CA,MD,2010.0,1,0,1
FI,TR,2006.0,1,0,1
KZ,BY,2001.0,1,0,1
,LR,2011.0,3,0,3
LU,SI,2012.0,2,0,2
MK,AT,2008.0,2,0,2
SA,HU,2009.0,1,0,1
MM,US,2004.0,1,0,1
CD,IT,2014.0,1,0,1
US,GP,2007.0,2,0,2
LS,US,2009.0,2,0,2
ML,DE,2020.0,1,0,1
SR,,2001.0,1,0,1
PL,TW,2002.0,3,0,3
DO,FR,2009.0,1,0,1
FI,MT,2018.0,1,0,1
TW,ET,2003.0,2,0,2
IT,GP,2021.0,2,0,2
CY,CN,2018.0,2,0,2
MT,US,2001.0,1,0,1
EE,IE,2005.0,1,0,1
ZA,TR,2001.0,1,0,1
NZ,QA,2014.0,3,0,3
AG,DE,2021.0,1,0,1
PR,,1999.0,2,0,2
BY,CH,1999.0,1,0,1
NZ,SK,2012.0,2,0,2
HK,MA,2001.0,1,0,1
IQ,IL,2014.0,2,0,2
GW,US,2015.0,1,0,1
CH,ZM,2015.0,1,0,1
IL,KZ,2012.0,1,0,1
DE,MN,2010.0,2,0,2
BW,CN,2010.0,1,0,1
IS,SG,2016.0,2,0,2
CR,NI,2015.0,2,0,2
CM,NL,2016.0,1,0,1
NL,CM,2020.0,1,0,1
BY,AU,2021.0,1,0,1
LU,ZA,2021.0,1,0,1
IL,ZA,1999.0,2,0,2
BG,EG,2016.0,1,0,1
FR,KH,1997.0,1,0,1
SN,IN,2015.0,1,0,1
ZM,NZ,2019.0,1,0,1
CU,NE,2008.0,1,0,1
TR,AL,2021.0,2,0,2
ZW,MY,2006.0,1,0,1
nan,EE,2009.0,2,0,2
LB,DE,1998.0,2,0,2
PH,PT,2011.0,1,0,1
KZ,PK,2016.0,1,0,1
BW,NP,2013.0,1,0,1
FI,BG,2022.0,1,0,1
JP,SD,2006.0,2,0,2
NP,SA,2017.0,2,0,2
SV,MX,1997.0,1,0,1
DK,AL,2018.0,1,0,1
DJ,FR,2011.0,1,0,1
GE,TH,2014.0,1,0,1
BW,nan,1998.0,1,0,1
VU,,2006.0,1,0,1
BD,MX,2016.0,1,0,1
AE,EE,2007.0,1,0,1
ES,MZ,2004.0,1,0,1
IT,BI,2019.0,1,0,1
GR,XK,2018.0,1,0,1
ML,EG,2009.0,1,0,1
LB,DE,1997.0,1,0,1
CR,JP,2002.0,1,0,1
GF,BE,2020.0,1,0,1
SV,MX,1998.0,2,0,2
BR,HN,2014.0,2,0,2
MC,,1999.0,1,0,1
SG,SI,2007.0,1,0,1
JO,AR,2006.0,1,0,1
GB,CU,2001.0,2,0,2
SA,CL,2009.0,1,0,1
TW,RE,2013.0,1,0,1
PT,HK,2020.0,1,0,1
MA,SE,2002.0,2,0,2
ZW,AU,1998.0,1,0,1
UG,ZM,2020.0,1,0,1
HR,JO,2010.0,1,0,1
AR,BD,1999.0,1,0,1
AU,UG,1997.0,1,0,1
NE,MA,2009.0,1,0,1
SO,PK,2016.0,1,0,1
ES,LU,2005.0,1,0,1
,GY,2008.0,2,0,2
SY,MX,2010.0,1,0,1
RO,LT,2020.0,1,0,1
,HT,1997.0,1,0,1
CA,MC,2015.0,1,0,1
PH,ZA,1998.0,1,0,1
AM,ES,2019.0,1,0,1
AM,ID,2016.0,2,0,2
TN,BG,2012.0,2,0,2
SZ,NG,2017.0,1,0,1
OM,KW,2018.0,1,0,1
ET,BR,2011.0,1,0,1
IE,GE,2012.0,1,0,1
LV,ZA,2020.0,1,0,1
NE,UG,2021.0,1,0,1
US,GY,2001.0,1,0,1
GE,IE,2007.0,1,0,1
MN,RU,2003.0,2,0,2
SE,LU,2013.0,3,0,3
MA,EG,2010.0,2,0,2
BY,IN,2009.0,4,0,4
CO,NG,2011.0,1,0,1
MK,CI,2018.0,1,0,1
DE,CY,1999.0,3,0,3
BF,NL,2001.0,1,0,1
NL,KW,2004.0,2,0,2
CL,PL,1999.0,1,0,1
ZA,CI,2020.0,1,0,1
LA,AU,2017.0,1,0,1
MY,CH,2006.0,2,0,2
IT,AO,1998.0,2,1,1
SD,AU,2003.0,1,1,0
ZA,ID,2012.0,1,4,-3
US,LA,2001.0,1,1,0
US,BB,2004.0,1,1,0
CY,NO,2009.0,1,1,0
US,MD,2001.0,2,2,0
AM,DE,2021.0,3,4,-1
US,PR,2009.0,2,8,-6
CW,DE,2012.0,2,4,-2
BA,GB,2019.0,4,5,-1
ME,DE,2005.0,1,1,0
FR,GF,2023.0,2,1,1
EG,CH,2006.0,2,1,1
IT,AO,1997.0,1,1,0
AO,IT,2012.0,2,3,-1
RU,RS,2023.0,1,2,-1
LV,BE,2016.0,1,1,0
DZ,GB,2012.0,2,4,-2
HU,LT,2000.0,1,1,0
PK,NG,2005.0,1,1,0
UA,AM,1998.0,2,2,0
PK,ET,2019.0,1,2,-1
MD,RO,2013.0,2,4,-2
CZ,VN,2007.0,1,1,0
SI,MY,2009.0,1,1,0
SK,IN,2005.0,1,1,0
BH,KR,2015.0,2,1,1
NO,BG,1997.0,1,2,-1
SK,GE,2005.0,1,1,0
NP,SA,2019.0,2,1,1
BD,DE,2008.0,4,5,-1
PT,ST,2009.0,1,2,-1
VE,UY,2006.0,1,1,0
TR,SI,2019.0,1,1,0
FR,KW,2022.0,2,3,-1
BE,ZA,1998.0,2,7,-5
NO,ET,2000.0,1,1,0
KE,CD,2017.0,2,1,1
AU,CU,2014.0,3,1,2
EG,BE,2001.0,2,1,1
SI,nan,2007.0,1,1,0
LT,KH,2012.0,1,1,0
EE,DK,2018.0,2,2,0
ZM,ZA,2007.0,2,1,1
FR,SI,2004.0,2,5,-3
FI,RS,2012.0,1,2,-1
IE,SK,2012.0,2,1,1
MY,SE,2001.0,2,2,0
GB,BG,1998.0,5,2,3
SI,AU,2009.0,1,3,-2
KR,AM,2016.0,1,2,-1
BE,TG,2019.0,1,1,0
JO,CA,2002.0,1,4,-3
CZ,BD,2014.0,1,2,-1
VN,TW,1997.0,1,1,0
LU,RU,2012.0,2,1,1
SI,TR,2016.0,1,2,-1
PL,VN,2006.0,1,1,0
RU,KH,2011.0,1,1,0
AU,BN,2002.0,1,1,0
MA,AE,2011.0,1,1,0
AU,CY,2009.0,1,2,-1
GR,nan,2004.0,1,4,-3
RO,IE,2006.0,2,2,0
DE,MN,2019.0,3,2,1
IT,GT,2006.0,2,1,1
PR,CN,2012.0,2,1,1
UA,JP,2022.0,1,2,-1
NG,RU,2016.0,2,1,1
NO,KR,2019.0,3,16,-13
BF,ZA,2021.0,1,1,0
ID,PA,2006.0,1,2,-1
FR,MX,2023.0,2,1,1
ID,GM,2020.0,1,1,0
JP,GH,2021.0,2,6,-4
NL,MW,2016.0,1,1,0
NG,NL,2000.0,1,1,0
FI,GR,2005.0,1,3,-2
AT,BD,2008.0,1,2,-1
BJ,SN,2012.0,2,1,1
CD,BF,2020.0,1,1,0
PT,EG,2022.0,2,2,0
AE,SY,2012.0,1,1,0
IN,EG,2002.0,2,2,0
OM,JO,2020.0,1,4,-3
LY,IN,2007.0,1,2,-1
PT,DK,1997.0,1,1,0
CA,RE,2014.0,1,3,-2
PE,CO,2023.0,1,1,0
FR,GA,1998.0,1,1,0
MW,ZM,2015.0,1,1,0
MX,TR,2015.0,2,3,-1
PR,FR,2000.0,1,1,0
PK,KW,1997.0,1,2,-1
MX,IE,2013.0,1,1,0
VG,IN,2015.0,1,2,-1
BE,UA,2014.0,1,2,-1
IE,BD,2016.0,2,3,-1
nan,HR,2013.0,1,1,0
BE,NZ,1997.0,1,1,0
MW,NO,2016.0,1,4,-3
NL,CY,2021.0,1,3,-2
BD,IL,2011.0,1,1,0
MU,GB,2019.0,1,3,-2
CH,VU,2016.0,1,1,0
KZ,GB,2015.0,2,10,-8
SA,MR,2019.0,1,1,0
ZW,KE,2017.0,1,2,-1
BA,CZ,2015.0,1,1,0
BY,JP,2016.0,1,2,-1
RS,PT,2022.0,1,3,-2
KH,PH,2006.0,1,1,0
SK,nan,2001.0,1,2,-1
CH,SI,1997.0,1,1,0
BF,BE,2003.0,2,1,1
MK,FR,2015.0,1,2,-1
CY,GR,1997.0,1,2,-1
FI,KZ,2021.0,1,2,-1
LT,VE,2005.0,1,3,-2
DK,KE,2009.0,1,4,-3
IL,nan,2023.0,1,1,0
FI,QA,2012.0,1,1,0
TR,CH,1998.0,1,6,-5
KE,NL,2004.0,1,2,-1
VN,PL,2002.0,1,4,-3
RS,RO,2017.0,1,1,0
MW,CA,2018.0,1,1,0
ES,TZ,2020.0,1,1,0
PT,MA,2009.0,1,2,-1
TH,SG,2003.0,1,1,0
KW,BR,2020.0,1,1,0
DK,CL,2008.0,1,1,0
PE,HN,2007.0,1,1,0
VN,AT,2010.0,1,1,0
CY,nan,2017.0,1,1,0
FR,SG,2023.0,1,2,-1
ZM,NL,2022.0,1,1,0
HU,EE,2019.0,1,1,0
DE,AL,2018.0,1,2,-1
KG,KR,2019.0,1,1,0
ZA,NA,2004.0,1,1,0
MM,AU,2017.0,1,3,-2
RU,VN,2008.0,1,1,0
QA,TW,2020.0,1,2,-1
TH,ES,2019.0,7,4,3
HU,ZA,2017.0,2,3,-1
TR,LV,2018.0,1,1,0
AE,NL,2012.0,3,2,1
MY,IL,2019.0,4,3,1
TW,AT,2022.0,1,3,-2
NL,SA,2002.0,1,1,0
MT,PK,2019.0,1,1,0
AL,NL,2017.0,1,1,0
TW,MN,2010.0,1,1,0
AE,GB,2023.0,1,3,-2
IT,AL,2013.0,1,1,0
ZA,MA,2016.0,1,1,0
TR,IL,2022.0,2,1,1
IT,CU,2009.0,3,3,0
NI,PA,2013.0,1,1,0
NO,GR,2009.0,2,10,-8
SA,SD,2003.0,1,2,-1
US,DO,2008.0,2,1,1
AT,UA,2002.0,1,5,-4
BH,BD,2017.0,1,2,-1
KG,RU,2014.0,1,2,-1
BD,RU,2010.0,1,1,0
SN,BJ,2007.0,1,1,0
UA,CA,1999.0,1,1,0
DZ,LB,2018.0,1,1,0
VE,DO,2021.0,1,1,0
AR,UA,2016.0,1,0,1
GE,AZ,2001.0,2,0,2
MA,SE,2005.0,1,0,1
ID,UZ,2004.0,1,0,1
AF,ES,2021.0,1,0,1
IN,AG,2009.0,1,0,1
KR,EG,2023.0,2,0,2
SL,MW,2017.0,1,0,1
US,RW,1997.0,1,0,1
HR,ID,2010.0,1,0,1
AT,LK,2018.0,1,0,1
NG,SN,2007.0,1,0,1
GH,BR,2000.0,1,0,1
DK,EC,2016.0,1,0,1
AU,MA,2003.0,1,0,1
AU,TZ,2022.0,1,0,1
RW,CO,2016.0,1,0,1
ES,CI,2011.0,1,0,1
GB,FK,2015.0,1,0,1
AT,KW,2016.0,1,0,1
SY,JP,2013.0,2,0,2
TN,JP,2022.0,1,0,1
VE,BE,2002.0,1,0,1
MX,ZW,2011.0,1,0,1
JP,CU,2014.0,1,0,1
FJ,MY,2014.0,1,0,1
US,MV,2022.0,1,0,1
UA,ID,2012.0,1,0,1
CN,LK,2000.0,1,0,1
SD,TZ,2016.0,1,0,1
IS,NO,1997.0,1,0,1
GR,DZ,2019.0,2,0,2
DZ,IQ,2018.0,1,0,1
RS,HK,2007.0,1,0,1
KW,IE,2005.0,1,0,1
CL,BG,2021.0,1,0,1
MX,FI,2003.0,1,0,1
CY,EG,2013.0,1,0,1
SA,VN,2013.0,1,0,1
BF,TG,2011.0,1,0,1
BW,ZW,2004.0,1,0,1
BR,GW,1998.0,1,0,1
MN,CO,2010.0,1,0,1
VG,ID,2015.0,1,0,1
AT,LV,2016.0,2,0,2
TN,OM,2019.0,2,0,2
VE,PR,2009.0,1,0,1
CL,LU,2015.0,1,0,1
SK,MY,2021.0,1,0,1
DE,YE,2016.0,1,0,1
AR,NO,2012.0,2,0,2
CW,PT,2015.0,1,0,1
NC,IT,2002.0,1,0,1
MZ,SE,2006.0,1,0,1
MX,KZ,2016.0,1,0,1
SE,ZW,2015.0,1,0,1
NP,ET,2018.0,1,0,1
ST,NL,2017.0,1,0,1
OM,PH,2013.0,1,0,1
PS,PK,2008.0,1,0,1
PT,LT,2020.0,1,0,1
ET,RW,2015.0,1,0,1
,BZ,1999.0,1,0,1
CA,CY,1997.0,1,0,1
NZ,TO,2004.0,1,0,1
BR,BD,1999.0,1,0,1
FJ,RU,2009.0,1,0,1
TW,PT,2020.0,1,0,1
MD,LT,2012.0,1,0,1
SY,AE,2013.0,1,0,1
CM,JP,2009.0,1,0,1
KW,NA,2013.0,1,0,1
LT,IE,2018.0,1,0,1
US,NC,2005.0,1,0,1
BJ,ML,2007.0,1,0,1
PK,FJ,2008.0,1,0,1
AE,ID,2011.0,1,0,1
SK,CW,2013.0,2,0,2
SZ,IN,2010.0,1,0,1
SS,SD,2019.0,1,0,1
LR,AU,2019.0,1,0,1
CM,RO,2015.0,1,0,1
PS,SE,2022.0,1,0,1
QA,PL,2022.0,1,0,1
DZ,CM,2009.0,1,0,1
,ER,2019.0,4,0,4
GD,IN,2014.0,1,0,1
BH,EG,1997.0,1,0,1
IN,SY,2003.0,1,0,1
MX,HU,2014.0,1,0,1
ZW,nan,2013.0,1,0,1
LU,VN,2022.0,2,0,2
SI,HU,2008.0,1,0,1
DK,LI,2017.0,1,0,1
IQ,NL,2016.0,2,0,2
NO,OM,2018.0,1,0,1
CN,TJ,2018.0,1,0,1
GD,,2006.0,1,0,1
MN,UA,2021.0,1,0,1
CM,NG,1997.0,1,0,1
CW,CZ,2005.0,1,0,1
nan,SI,2005.0,1,0,1
SY,IT,2020.0,1,0,1
GB,NC,2020.0,1,0,1
PE,NO,2013.0,1,0,1
LU,PK,2020.0,1,0,1
VU,US,2013.0,1,0,1
IL,IS,2011.0,1,0,1
BA,EE,2018.0,1,0,1
GT,SI,2018.0,2,0,2
nan,PR,1998.0,1,0,1
CR,PL,2013.0,1,0,1
GE,HU,2015.0,1,0,1
GI,,2014.0,1,0,1
AU,CG,2007.0,1,0,1
GB,GP,2013.0,1,0,1
ZA,VN,2013.0,2,0,2
IN,BS,2020.0,1,0,1
OM,IE,2015.0,1,0,1
CM,BJ,2016.0,1,0,1
SG,BH,2018.0,1,0,1
KR,KW,1997.0,1,0,1
RE,,1999.0,1,0,1
nan,TH,2015.0,4,0,4
FJ,TO,2013.0,1,0,1
BJ,MX,2020.0,1,0,1
MY,MK,2020.0,1,0,1
NG,CA,2000.0,1,0,1
NL,ID,1998.0,2,0,2
NO,GL,2017.0,1,0,1
AL,HR,2014.0,1,0,1
NL,ID,1997.0,1,0,1
MA,BD,2004.0,1,0,1
TN,SK,2021.0,1,0,1
PS,FJ,2010.0,1,0,1
YE,ES,2020.0,1,0,1
ES,ZM,2000.0,1,0,1
DK,SJ,2020.0,1,0,1
RS,IN,2008.0,2,0,2
UZ,KG,2018.0,2,0,2
NZ,LT,2017.0,1,0,1
PH,GE,2017.0,1,0,1
ZM,LK,2009.0,1,0,1
FJ,CZ,2008.0,1,0,1
MN,CO,2017.0,1,0,1
SN,IT,2014.0,1,0,1
BJ,PK,2018.0,1,0,1
IN,KZ,2007.0,1,0,1
NZ,MT,2020.0,1,0,1
BF,FI,2014.0,1,0,1
ZA,BD,2005.0,1,0,1
CR,DO,2008.0,1,0,1
VE,BO,2005.0,1,0,1
AM,LT,2007.0,1,0,1
GR,UG,2006.0,1,0,1
CA,BS,2014.0,1,0,1
TJ,SE,2014.0,1,0,1
LT,SG,2008.0,1,0,1
NO,CR,2013.0,1,0,1
GE,UY,2012.0,1,0,1
TT,BR,2010.0,1,0,1
NA,ZA,2003.0,1,0,1
PH,QA,2014.0,1,0,1
PL,KE,2016.0,1,0,1
PS,DE,1997.0,1,0,1
ES,EC,1997.0,1,0,1
EE,AZ,2017.0,1,0,1
GD,PL,2014.0,1,0,1
TN,CM,2008.0,1,0,1
CI,GB,1997.0,1,0,1
ES,NC,2012.0,1,0,1
SN,GA,2005.0,1,0,1
GT,BO,2021.0,1,0,1
CD,TZ,2021.0,1,0,1
MD,GB,2008.0,1,0,1
MK,BG,2007.0,1,0,1
NL,SC,2003.0,1,0,1
JP,CD,2014.0,1,0,1
nan,BM,1999.0,1,0,1
CV,FI,2018.0,1,0,1
VN,MY,2007.0,1,0,1
RO,JM,2005.0,1,0,1
OM,SG,2005.0,1,0,1
BW,FR,2005.0,1,0,1
LI,MY,2016.0,1,0,1
KG,CH,2013.0,1,0,1
EC,DO,2014.0,1,0,1
SI,PL,2012.0,1,0,1
ET,AE,2012.0,1,0,1
NG,GE,2019.0,1,0,1
CA,SV,2000.0,1,0,1
LT,AU,2002.0,1,0,1
SY,NP,2002.0,1,0,1
US,GL,2018.0,1,0,1
BI,CN,2018.0,1,0,1
BR,HR,2002.0,1,0,1
OM,GD,2008.0,1,0,1
CG,US,2005.0,1,0,1
CN,SO,2022.0,1,0,1
TZ,SA,2013.0,1,0,1
HR,PT,2008.0,1,0,1
EC,CN,2010.0,1,0,1
AL,NL,2010.0,1,0,1
QA,IE,2013.0,1,0,1
HU,SG,2021.0,1,0,1
GM,CA,2016.0,1,0,1
CH,BN,2015.0,1,0,1
UG,BR,2015.0,1,0,1
PK,GE,2006.0,1,0,1
BA,OM,2022.0,1,0,1
NO,MD,2016.0,1,0,1
SG,PT,2006.0,1,0,1
BJ,CI,2022.0,1,0,1
MX,CV,2019.0,1,0,1
GR,JO,2011.0,1,0,1
ET,NZ,2015.0,1,0,1
UZ,AT,2017.0,1,0,1
KZ,UA,2001.0,1,0,1
DZ,YE,2002.0,1,0,1
MZ,ST,2007.0,1,0,1
RU,LT,2023.0,1,0,1
YE,MA,2023.0,1,0,1
MM,PH,2022.0,1,0,1
CY,PS,2020.0,1,0,1
IE,ZM,2020.0,1,0,1
SO,NO,2012.0,1,0,1
ME,CZ,2013.0,1,0,1
BE,FR,2013.0,304,350,-46
US,JP,2014.0,1818,1587,231
CO,US,2014.0,300,309,-9
GB,SE,2019.0,244,217,27
US,AU,2019.0,2756,2583,173
US,GB,2002.0,3752,3822,-70
UY,VE,2015.0,2,5,-3
TN,FR,2014.0,153,218,-65
US,GB,2005.0,4579,4354,225
GB,CN,2020.0,764,663,101
RS,TR,2013.0,106,72,34
DK,FO,2010.0,4,1,3
SG,MX,2014.0,4,7,-3
CA,TW,1999.0,21,12,9
US,ES,2003.0,526,525,1
AR,CU,2020.0,13,11,2
BR,DE,2005.0,78,81,-3
FR,CA,2011.0,545,493,52
MX,ES,2006.0,414,391,23
BD,BN,2021.0,1,1,0
nan,DE,2015.0,89,89,0
US,AU,2017.0,2567,2579,-12
US,AU,2010.0,2165,1852,313
IR,US,2022.0,415,233,182
US,CA,2021.0,2621,2593,28
MX,CU,2019.0,72,87,-15
VE,PE,2018.0,15,7,8
BG,DE,2011.0,19,21,-2
KR,GB,2020.0,118,105,13
CL,DE,2001.0,17,14,3
GB,IN,2020.0,549,654,-105
LB,EG,2013.0,10,13,-3
GB,SE,2017.0,226,190,36
RU,US,2016.0,502,608,-106
CA,ES,2017.0,104,87,17
CA,ES,2019.0,84,112,-28
IN,JP,2013.0,129,118,11
ZA,CA,2014.0,45,49,-4
RU,ES,2015.0,17,18,-1
DK,US,2019.0,298,333,-35
US,DK,2021.0,308,225,83
US,PL,2005.0,166,197,-31
SA,GB,2014.0,55,136,-81
CN,CA,1999.0,115,141,-26
NO,SE,2008.0,83,99,-16
CL,CO,2016.0,256,234,22
AR,CL,2001.0,22,29,-7
QA,EG,2003.0,3,3,0
GB,ES,2004.0,171,180,-9
DO,BR,2011.0,1,1,0
CO,AR,2020.0,133,92,41
DE,AT,2003.0,277,253,24
IE,US,2014.0,495,506,-11
GB,GR,2006.0,160,110,50
AU,SG,2001.0,34,20,14
FR,MA,2006.0,234,187,47
TW,US,2005.0,569,659,-90
AT,US,1999.0,144,121,23
MX,US,2005.0,216,228,-12
US,CL,2019.0,272,279,-7
SE,TR,2011.0,5,4,1
SG,MY,2013.0,123,69,54
DE,IL,2008.0,39,70,-31
JP,SG,2006.0,28,13,15
FR,CZ,2019.0,45,44,1
AT,GB,2015.0,126,112,14
MX,SE,2013.0,13,6,7
US,CL,2010.0,198,154,44
NZ,US,2022.0,193,203,-10
GB,PL,2002.0,45,22,23
IN,FR,2015.0,133,146,-13
FR,IN,2019.0,131,136,-5
BR,US,2021.0,1214,935,279
FR,TN,2015.0,242,162,80
MX,PE,2015.0,95,135,-40
PH,US,2018.0,363,311,52
GR,GB,2014.0,287,178,109
IN,KR,2016.0,241,163,78
CR,CU,2020.0,32,22,10
MX,AU,2020.0,20,12,8
CN,GB,2009.0,393,552,-159
MA,FR,2014.0,250,335,-85
NO,US,2022.0,96,122,-26
ES,NL,2000.0,38,30,8
SA,EG,2009.0,71,138,-67
TW,SG,2020.0,57,44,13
US,RU,2006.0,246,341,-95
AU,VN,2012.0,20,16,4
BG,GB,2020.0,16,13,3
US,EG,2019.0,365,296,69
RS,HR,2013.0,91,135,-44
SG,AU,2008.0,64,77,-13
US,IT,2018.0,1063,1159,-96
AR,US,1998.0,86,79,7
US,EG,2017.0,303,266,37
CN,KR,2009.0,229,265,-36
FR,DE,2004.0,332,372,-40
GE,US,2015.0,195,143,52
IL,US,2000.0,340,315,25
DE,CN,2009.0,230,218,12
GR,DE,2014.0,85,49,36
JP,IN,2000.0,83,109,-26
CH,BR,2019.0,64,68,-4
DE,EE,2019.0,74,58,16
NL,IR,2016.0,33,43,-10
DO,MX,2015.0,4,4,0
US,CL,2017.0,317,251,66
EC,CO,2014.0,18,56,-38
ID,ZA,2022.0,73,62,11
BR,CO,2011.0,74,100,-26
IN,IL,2019.0,127,56,71
nan,AR,2016.0,47,40,7
MY,PK,2023.0,9,9,0
CA,SG,2012.0,48,47,1
SG,HK,2016.0,4,2,2
SD,EG,2020.0,37,23,14
MY,nan,2013.0,48,75,-27
DK,US,2010.0,229,262,-33
CN,JP,2000.0,268,313,-45
TR,US,2016.0,442,486,-44
NO,NL,2009.0,16,31,-15
DE,IN,2022.0,111,137,-26
YE,MY,2018.0,10,22,-12
CL,FR,2014.0,42,58,-16
FR,CL,2015.0,64,37,27
NL,JP,2004.0,53,27,26
MX,CU,2017.0,55,63,-8
CH,BR,2017.0,49,70,-21
NZ,CN,2006.0,22,14,8
CA,DK,2006.0,21,22,-1
DK,US,2017.0,297,303,-6
US,SE,2005.0,341,336,5
SE,ES,2011.0,45,59,-14
MY,EG,2011.0,16,22,-6
SG,US,2018.0,524,549,-25
JP,TR,2015.0,27,16,11
IQ,MY,2019.0,39,152,-113
CN,MY,2014.0,90,58,32
FI,KR,2012.0,6,2,4
AR,DK,2009.0,1,3,-2
TW,US,2002.0,441,650,-209
CA,FR,2006.0,370,431,-61
CA,GB,1999.0,404,352,52
IN,PK,2006.0,34,47,-13
MX,US,2002.0,192,196,-4
DE,FI,2022.0,44,34,10
GB,PL,2005.0,33,36,-3
VG,RU,2016.0,2,1,1
AU,JP,2014.0,67,82,-15
DE,BR,2015.0,263,213,50
ES,EG,2015.0,16,14,2
AU,AE,2013.0,14,7,7
PL,EG,2011.0,1,1,0
MW,GB,2019.0,29,17,12
TR,CY,2016.0,87,25,62
DE,NO,2018.0,107,76,31
MY,YE,2021.0,18,6,12
IT,BE,2019.0,200,130,70
BZ,FR,2009.0,7,1,6
RU,SE,1998.0,34,14,20
CA,IR,2005.0,53,50,3
AR,BR,2015.0,183,112,71
RU,NO,2007.0,13,5,8
CH,IN,2013.0,46,55,-9
CA,ES,2010.0,68,72,-4
BR,AR,2007.0,84,120,-36
CO,MX,2002.0,50,46,4
AU,TH,2012.0,33,14,19
UZ,CN,2015.0,13,15,-2
TH,SG,2001.0,3,2,1
nan,CN,2012.0,179,162,17
DE,IT,2013.0,226,345,-119
IN,IL,2010.0,25,21,4
NO,FR,2018.0,82,76,6
DE,BD,2020.0,12,15,-3
GB,IT,2021.0,523,445,78
CN,GR,2011.0,21,19,2
IT,DK,1999.0,9,8,1
CN,BE,2006.0,21,53,-32
SE,CN,2004.0,60,45,15
RE,AU,2019.0,1,1,0
AU,IT,2007.0,37,48,-11
KE,CN,2011.0,7,8,-1
FI,CA,2006.0,14,19,-5
CN,GH,2011.0,6,2,4
UZ,KG,2019.0,3,1,2
CA,IL,2006.0,22,56,-34
US,NO,2000.0,65,68,-3
NP,NZ,2011.0,20,14,6
MW,GB,2010.0,6,9,-3
DE,EE,2017.0,71,46,25
DE,IR,2022.0,55,86,-31
CL,PE,2021.0,55,51,4
FR,RE,2019.0,51,39,12
IT,ES,2002.0,66,74,-8
FR,NO,2016.0,64,73,-9
ES,AT,2012.0,23,24,-1
IT,FI,2023.0,6,5,1
IN,ES,2013.0,24,31,-7
GR,US,2016.0,181,177,4
ES,SE,2005.0,22,18,4
AT,AU,2005.0,16,10,6
BR,AU,2011.0,67,61,6
KR,FR,2020.0,34,28,6
EG,SA,2001.0,28,23,5
SA,DE,2022.0,21,13,8
PT,IN,2018.0,22,11,11
DK,CA,2000.0,10,21,-11
IN,IL,2017.0,86,45,41
CA,AE,2008.0,15,1,14
IT,SA,2007.0,1,2,-1
GR,nan,2014.0,8,1,7
BR,PE,2013.0,41,28,13
IQ,MY,2017.0,35,108,-73
BD,JP,2015.0,38,57,-19
FR,VN,2017.0,65,24,41
IR,AU,2016.0,187,61,126
GB,ZA,2012.0,190,143,47
IN,NL,2015.0,49,45,4
HU,AT,2002.0,16,14,2
IN,ZA,2000.0,6,8,-2
FR,IN,2017.0,129,145,-16
CN,FR,2013.0,166,231,-65
JP,CH,2020.0,93,105,-12
UA,RU,1999.0,66,53,13
KR,ET,2022.0,73,77,-4
NG,SE,2004.0,3,1,2
ZA,GB,2012.0,143,190,-47
SA,US,2014.0,124,215,-91
JP,KE,2015.0,11,2,9
CN,AU,1999.0,65,73,-8
FI,AU,2013.0,16,19,-3
CO,DE,2014.0,24,30,-6
nan,ID,2021.0,74,75,-1
CH,LI,2015.0,1,3,-2
TZ,GB,2012.0,13,13,0
US,PL,2002.0,141,143,-2
AT,HU,2005.0,16,17,-1
RU,BE,2020.0,24,36,-12
US,CD,2020.0,10,7,3
UG,US,2020.0,34,38,-4
CZ,FR,2016.0,25,54,-29
OM,IN,2019.0,33,39,-6
FR,RE,2017.0,47,34,13
UY,BR,2016.0,57,44,13
GB,MY,2001.0,30,9,21
CM,US,2021.0,18,10,8
VE,MX,2018.0,61,34,27
IE,DE,2005.0,34,59,-25
DE,CA,2000.0,108,115,-7
SE,FR,2013.0,56,92,-36
JP,AU,2023.0,6,5,1
PK,MY,2017.0,73,135,-62
GR,BG,2020.0,3,7,-4
NL,nan,2009.0,45,62,-17
CL,GT,2016.0,6,3,3
US,SI,2017.0,17,26,-9
CN,ZA,2007.0,5,2,3
PL,DE,2003.0,68,59,9
IQ,GB,2020.0,44,125,-81
IT,DZ,2014.0,24,18,6
GH,CA,2019.0,13,21,-8
NL,RS,2018.0,9,9,0
PL,BE,2012.0,18,14,4
ZA,NA,2014.0,8,5,3
nan,PT,1997.0,1,4,-3
PT,GB,2018.0,152,103,49
SK,RO,2007.0,3,1,2
NL,PL,2016.0,24,26,-2
nan,MY,2021.0,46,35,11
ID,GH,2020.0,13,26,-13
KW,CA,2020.0,12,20,-8
NL,AE,2011.0,6,1,5
CO,MX,2005.0,70,97,-27
ZW,US,1999.0,8,2,6
nan,BE,2019.0,17,20,-3
RU,MZ,2022.0,17,11,6
TR,KW,2016.0,11,7,4
NZ,SE,2021.0,12,8,4
EE,CH,2014.0,10,13,-3
JP,TH,1999.0,23,9,14
PS,AE,2018.0,2,2,0
SI,US,2012.0,22,25,-3
QA,NL,2020.0,5,7,-2
CZ,JP,2003.0,13,17,-4
RU,FI,2016.0,30,43,-13
SI,RS,2015.0,19,24,-5
AU,SA,2011.0,22,7,15
US,HR,2022.0,18,23,-5
DE,CL,2012.0,38,31,7
MX,IT,2021.0,22,21,1
FJ,NZ,2005.0,1,1,0
LK,GB,2022.0,19,9,10
CZ,DE,2013.0,51,64,-13
US,SI,2010.0,22,11,11
SI,NL,2015.0,8,8,0
IT,NL,2022.0,83,60,23
AT,FR,2017.0,54,66,-12
AU,NZ,2018.0,207,230,-23
CL,BR,2018.0,118,123,-5
IE,JP,2009.0,25,26,-1
AT,NL,2015.0,36,34,2
GR,CY,2015.0,60,27,33
CN,CZ,2020.0,19,22,-3
GB,SE,2010.0,159,170,-11
AU,PH,2016.0,19,12,7
PR,KR,2007.0,31,24,7
EC,US,2006.0,8,9,-1
NO,UG,2017.0,1,4,-3
PK,KR,2021.0,39,59,-20
MA,DZ,2021.0,25,39,-14
BA,GB,2018.0,5,5,0
NG,RU,2022.0,4,1,3
IN,GH,2015.0,11,5,6
TR,FR,2017.0,23,29,-6
AU,nan,1999.0,9,9,0
DE,IQ,2016.0,9,8,1
AU,MX,2022.0,8,11,-3
BE,BF,2007.0,2,1,1
SA,PK,2013.0,29,62,-33
BE,CN,2022.0,54,43,11
BH,US,2006.0,8,10,-2
NL,NO,2015.0,55,28,27
CU,US,2002.0,19,16,3
BE,AE,2021.0,2,1,1
nan,RU,2014.0,73,31,42
BR,DO,2020.0,10,7,3
JP,GR,2008.0,33,41,-8
US,AE,2022.0,48,64,-16
FR,GP,2019.0,24,28,-4
CO,PE,2022.0,37,28,9
SN,CA,2020.0,7,5,2
OM,IN,2017.0,13,34,-21
IQ,RU,2016.0,2,1,1
TW,IN,2006.0,20,40,-20
BE,BR,2012.0,77,54,23
PL,DK,2020.0,8,14,-6
CH,AT,2006.0,52,65,-13
TW,VN,2020.0,39,24,15
NC,FR,2011.0,11,14,-3
CA,GH,2020.0,11,12,-1
CU,HN,2017.0,3,1,2
CY,US,2011.0,16,23,-7
BO,AR,2017.0,4,2,2
PA,CO,2015.0,13,14,-1
ES,CH,2014.0,126,67,59
PH,KR,2013.0,12,9,3
CA,nan,2014.0,34,40,-6
BE,NG,2019.0,6,4,2
UA,GB,2008.0,10,5,5
IL,DE,2021.0,67,65,2
BE,CA,2018.0,80,59,21
UY,CO,2016.0,17,15,2
JM,TT,2014.0,24,18,6
PT,BE,2020.0,28,17,11
SY,CN,2018.0,17,15,2
FR,SI,2014.0,8,8,0
SA,ID,2017.0,40,6,34
IR,FR,2022.0,32,10,22
EC,FR,2017.0,4,17,-13
CL,PY,2019.0,13,6,7
FR,SE,2006.0,45,49,-4
TH,NL,2005.0,3,4,-1
TW,KR,2011.0,32,28,4
DE,NL,2021.0,344,322,22
CA,KR,2018.0,70,88,-18
ID,UZ,2014.0,1,1,0
BR,UY,2012.0,38,34,4
GB,ID,2018.0,103,63,40
EC,FR,2019.0,18,14,4
SE,GR,2008.0,7,11,-4
FR,VN,2019.0,72,26,46
AF,PK,2021.0,5,2,3
RU,KG,2017.0,7,4,3
PT,DE,1997.0,8,4,4
FR,BJ,2017.0,32,17,15
ID,RO,2020.0,4,6,-2
IQ,AU,2021.0,12,23,-11
FR,PL,2014.0,54,36,18
FR,BG,2016.0,6,1,5
NP,KR,2012.0,7,9,-2
nan,IN,2009.0,23,35,-12
GB,MX,1998.0,20,26,-6
US,EG,2010.0,176,121,55
AL,GB,2018.0,1,1,0
MW,GB,2017.0,20,24,-4
BR,DE,2002.0,55,42,13
HN,MX,2021.0,9,10,-1
IN,TH,2020.0,27,21,6
CA,CH,2015.0,138,113,25
PL,NO,2015.0,14,7,7
CH,AU,2006.0,63,48,15
FR,SN,2001.0,14,17,-3
GE,GB,2016.0,8,6,2
IL,nan,2000.0,9,11,-2
GB,LK,2022.0,9,19,-10
GB,NP,2016.0,10,10,0
US,HT,2009.0,4,2,2
FR,BJ,2019.0,33,26,7
MX,SG,2010.0,3,9,-6
MA,IN,2013.0,4,3,1
ET,nan,2006.0,1,1,0
GR,IT,2008.0,16,17,-1
US,GE,2004.0,113,101,12
IE,AU,2020.0,132,133,-1
GB,NO,2003.0,33,29,4
US,RO,2016.0,79,88,-9
nan,BE,2010.0,9,20,-11
VE,FR,2012.0,12,14,-2
LV,IT,2009.0,1,1,0
NZ,BR,2021.0,8,19,-11
AT,BE,2000.0,3,4,-1
EG,CN,2016.0,37,33,4
CN,SA,2018.0,47,55,-8
IR,NZ,2018.0,22,6,16
BY,DE,2009.0,13,4,9
LY,GB,2005.0,1,4,-3
AT,IT,2003.0,18,17,1
US,AT,2003.0,152,147,5
NO,DE,2006.0,37,54,-17
AU,GH,2008.0,2,2,0
DE,NG,2014.0,11,7,4
TW,MN,2018.0,4,2,2
FI,AE,2015.0,2,1,1
RO,MD,2017.0,7,10,-3
CZ,AU,2017.0,10,14,-4
CZ,AU,2019.0,9,11,-2
DE,BE,1997.0,41,41,0
IN,TW,2022.0,51,39,12
RS,US,2012.0,39,61,-22
ES,IR,2018.0,18,31,-13
AU,PL,2009.0,8,14,-6
BF,CA,2020.0,3,6,-3
IN,TN,2016.0,8,3,5
IN,KW,2021.0,10,3,7
FR,VN,2010.0,28,10,18
FR,CZ,2017.0,50,40,10
TR,FR,2010.0,20,22,-2
JP,KH,2011.0,8,4,4
NO,PS,2009.0,1,1,0
GR,ES,2014.0,16,10,6
BJ,NG,2009.0,1,3,-2
JM,BB,2021.0,6,6,0
SE,IN,2004.0,9,16,-7
FR,GP,2017.0,20,34,-14
US,LB,2002.0,22,14,8
DK,GR,2017.0,9,15,-6
AT,FR,2010.0,44,36,8
GR,CA,1999.0,7,10,-3
SA,AE,2007.0,8,3,5
MA,BE,2016.0,5,7,-2
PK,DE,2003.0,5,4,1
KW,ID,2015.0,3,1,2
TH,MM,2015.0,5,4,1
MX,SG,2017.0,2,4,-2
GA,FR,2015.0,5,13,-8
KW,FR,2019.0,1,12,-11
JP,FI,2011.0,21,9,12
CH,EE,2010.0,7,2,5
LV,AU,2011.0,1,4,-3
nan,BE,2017.0,40,16,24
CL,EC,2011.0,6,9,-3
DE,ZA,2022.0,31,23,8
BE,PT,2010.0,13,6,7
CN,SY,2015.0,16,16,0
PL,NL,2016.0,26,24,2
UA,CN,2012.0,25,15,10
RW,JP,2019.0,1,1,0
FR,GP,2010.0,12,6,6
DK,GL,2015.0,8,2,6
BE,PT,2017.0,20,21,-1
CZ,SE,2017.0,22,13,9
GF,FR,2022.0,14,9,5
FR,RE,2010.0,42,14,28
FR,TR,2015.0,21,24,-3
CY,GB,2021.0,19,32,-13
IR,KR,2012.0,6,6,0
IT,MM,2018.0,1,1,0
SA,ID,2019.0,24,15,9
NZ,IN,2011.0,19,15,4
FR,ML,2009.0,6,7,-1
ES,JP,2015.0,38,34,4
PA,EC,2018.0,8,5,3
MZ,IN,2014.0,1,1,0
ZA,LS,2021.0,8,2,6
AU,KR,2023.0,4,5,-1
GP,US,2017.0,5,1,4
NL,AT,2003.0,14,14,0
TN,IT,2021.0,17,16,1
ET,ID,2020.0,5,5,0
FR,QA,2022.0,5,4,1
AT,CN,2016.0,14,20,-6
PE,AR,2009.0,10,12,-2
CZ,SK,2011.0,49,88,-39
CA,NZ,2022.0,32,34,-2
HK,NL,2012.0,16,11,5
KY,IN,2019.0,1,1,0
PT,FR,2007.0,22,37,-15
SE,CL,2004.0,6,4,2
JP,IL,2000.0,11,10,1
GR,JP,2008.0,41,33,8
VE,EC,2015.0,24,3,21
BG,ES,2002.0,4,3,1
AU,ES,2000.0,11,10,1
SE,EG,2017.0,17,8,9
ES,CU,2015.0,89,104,-15
AR,JP,2004.0,3,4,-1
ZA,IL,2019.0,4,5,-1
DE,SG,2008.0,31,14,17
GR,CZ,2020.0,8,4,4
TR,GB,2023.0,8,3,5
YE,SA,2020.0,20,18,2
US,CY,2013.0,26,17,9
CY,TR,2022.0,39,25,14
BG,NO,2007.0,10,4,6
DK,nan,2003.0,11,6,5
EC,MX,2013.0,14,30,-16
CD,ZA,2017.0,4,2,2
PK,CZ,2018.0,8,6,2
IS,DK,2020.0,5,8,-3
RU,nan,2020.0,48,42,6
LT,JP,2022.0,1,2,-1
DK,TR,2012.0,6,5,1
nan,PH,2017.0,2,3,-1
DK,PL,1999.0,8,1,7
TW,PK,2020.0,4,3,1
HU,AT,2005.0,17,16,1
PH,CA,2001.0,5,8,-3
TZ,JP,2021.0,6,2,4
BD,IQ,2021.0,3,6,-3
NG,SA,2022.0,12,7,5
FR,PE,2016.0,16,15,1
US,ZW,1998.0,4,5,-1
FR,TH,2006.0,12,3,9
BE,AT,2009.0,7,12,-5
SA,IE,2013.0,3,4,-1
DE,MN,2018.0,2,2,0
CA,IR,2002.0,30,23,7
US,LB,2005.0,34,27,7
TR,MY,2016.0,13,21,-8
FR,UY,2022.0,2,2,0
TZ,AU,2017.0,2,1,1
ES,SE,2002.0,21,20,1
JO,JP,2016.0,1,4,-3
GR,AU,2013.0,14,6,8
nan,NO,2008.0,24,22,2
HU,DE,2001.0,30,26,4
LT,CH,2016.0,4,1,3
LU,FI,2017.0,5,4,1
AT,DK,2011.0,7,10,-3
GB,MX,1997.0,17,15,2
TH,JP,2007.0,34,78,-44
DK,CH,2006.0,21,17,4
US,QA,1999.0,6,7,-1
HU,ZA,2018.0,1,2,-1
BE,PT,2019.0,18,15,3
IT,ID,2022.0,8,3,5
IQ,IN,2010.0,2,6,-4
MZ,BE,2009.0,4,1,3
IE,PT,2014.0,3,6,-3
KR,BE,2013.0,9,8,1
BR,ZA,2005.0,5,2,3
ES,GR,1998.0,4,1,3
AR,US,1997.0,59,61,-2
DK,GR,2019.0,6,16,-10
CL,AR,2006.0,40,41,-1
SK,DK,2006.0,9,4,5
TZ,BH,2006.0,1,2,-1
GB,RU,2013.0,93,104,-11
RU,SE,1997.0,21,15,6
EE,DK,2019.0,3,3,0
RO,HK,2020.0,16,10,6
PL,AT,2009.0,18,13,5
CH,NO,1998.0,10,9,1
CH,EE,2019.0,8,16,-8
IR,CA,2007.0,60,69,-9
ZA,RW,2021.0,4,2,2
PE,PH,2013.0,4,5,-1
IL,SE,2007.0,4,2,2
SG,JP,2022.0,21,25,-4
UA,NL,2012.0,9,5,4
JP,PT,2010.0,9,4,5
IR,nan,2012.0,6,4,2
PL,KR,2018.0,8,6,2
ZA,MW,2015.0,7,6,1
FR,GF,2000.0,8,2,6
FR,BI,2021.0,21,18,3
NL,MY,2014.0,11,6,5
CH,HU,2012.0,8,16,-8
JP,SK,2021.0,6,1,5
SA,PS,2020.0,10,9,1
PK,NL,2011.0,4,5,-1
HU,NL,2012.0,17,10,7
KR,SE,2019.0,10,10,0
ZA,IL,2017.0,3,4,-1
DO,ES,2020.0,11,20,-9
LB,US,2007.0,31,36,-5
XK,AL,2009.0,3,2,1
IE,nan,2009.0,1,3,-2
IN,IE,2007.0,10,5,5
ES,HN,2006.0,2,4,-2
PK,MY,2010.0,26,13,13
JP,NP,2014.0,12,6,6
FI,CN,2013.0,23,24,-1
SE,AU,2000.0,17,19,-2
MA,NL,2020.0,1,1,0
CR,CO,2004.0,5,4,1
HR,IR,2010.0,2,1,1
DK,AU,2014.0,38,41,-3
PK,TN,2016.0,1,1,0
NP,IN,2006.0,21,19,2
NP,CN,2020.0,27,22,5
TW,PL,2018.0,4,1,3
RS,AU,2012.0,3,5,-2
CN,ES,2023.0,4,5,-1
AE,OM,1999.0,3,1,2
CZ,FI,2009.0,8,9,-1
IR,DZ,2014.0,4,2,2
KR,SG,2022.0,19,21,-2
CH,IL,2013.0,15,21,-6
HU,IL,2005.0,5,4,1
GB,SA,2001.0,16,10,6
VE,IT,2006.0,4,5,-1
NZ,FR,2002.0,5,6,-1
GT,MX,2007.0,3,8,-5
PH,BR,2007.0,5,5,0
IN,TT,2013.0,9,4,5
BG,BR,2009.0,4,2,2
SE,NZ,2005.0,10,6,4
nan,NZ,2021.0,2,1,1
KR,SE,2017.0,13,7,6
IL,ES,2022.0,8,13,-5
RU,ZW,2009.0,3,5,-2
TW,TH,2004.0,1,1,0
TR,KZ,2005.0,8,19,-11
BY,CZ,2015.0,15,15,0
US,YE,2020.0,3,3,0
FR,CZ,2010.0,31,24,7
BN,GB,2000.0,5,1,4
JP,PT,2019.0,5,2,3
NL,TR,2001.0,9,5,4
RO,nan,2020.0,2,4,-2
BR,ST,2003.0,13,7,6
SE,NZ,2002.0,5,4,1
AR,NL,2014.0,10,10,0
NP,GB,2022.0,7,6,1
CN,BG,2002.0,1,3,-2
HR,PT,2013.0,1,1,0
MY,CM,2021.0,2,2,0
KW,SA,2001.0,2,6,-4
RU,LV,1999.0,5,3,2
AT,BR,2022.0,11,18,-7
LB,CN,2019.0,28,10,18
CA,RO,1998.0,2,2,0
PA,ZA,2016.0,2,1,1
CH,EE,2017.0,21,7,14
MT,ES,2016.0,7,4,3
SE,LK,1997.0,1,1,0
DE,EE,2010.0,51,34,17
HU,CA,2020.0,18,13,5
NL,PK,2011.0,5,4,1
NL,SE,1999.0,19,10,9
ID,JO,2019.0,2,8,-6
TH,GB,1997.0,7,12,-5
MY,OM,2022.0,11,6,5
DK,EE,2019.0,3,3,0
EE,DK,2017.0,2,2,0
IR,AF,2019.0,11,2,9
MX,CU,2010.0,34,41,-7
CA,GR,2021.0,12,11,1
NG,KR,2009.0,11,4,7
IE,BR,2008.0,9,5,4
NO,IE,2018.0,7,4,3
PH,MX,2004.0,3,1,2
ZA,FR,2022.0,21,16,5
CZ,BY,2016.0,22,12,10
CH,AR,2012.0,8,15,-7
UA,nan,2008.0,12,16,-4
HR,CH,2014.0,11,3,8
AE,CY,2020.0,2,1,1
CH,PK,2012.0,17,23,-6
NO,CH,1999.0,6,9,-3
NZ,FI,2013.0,1,5,-4
UA,ES,2020.0,4,2,2
SD,QA,2019.0,14,4,10
NO,PL,2016.0,3,15,-12
NL,CZ,2012.0,26,18,8
TH,GB,1998.0,7,20,-13
CZ,SE,2019.0,25,24,1
CO,BR,2007.0,29,49,-20
MY,NZ,2008.0,4,8,-4
IE,FR,2022.0,15,18,-3
NO,KR,2018.0,9,9,0
LB,CN,2017.0,33,16,17
NZ,IR,2012.0,2,9,-7
BA,HR,2016.0,30,36,-6
SY,SA,2016.0,2,1,1
GB,AE,2012.0,41,11,30
SI,ES,1999.0,2,4,-2
GT,ES,2020.0,11,9,2
QA,AE,2016.0,10,8,2
CA,TR,1997.0,6,3,3
BR,NI,2021.0,2,1,1
BB,JM,2011.0,3,7,-4
JO,GB,2009.0,11,12,-1
CH,GR,1997.0,3,1,2
LT,DK,2012.0,2,3,-1
nan,IL,1998.0,8,11,-3
TN,MA,2021.0,24,28,-4
OM,EG,2014.0,7,7,0
CH,MD,2012.0,3,2,1
AT,AU,2002.0,14,8,6
BE,SI,2016.0,5,9,-4
NZ,MY,2011.0,15,6,9
GB,EE,2005.0,8,3,5
BE,UG,2007.0,2,5,-3
SE,QA,2007.0,3,6,-3
OM,US,2012.0,11,15,-4
NO,GL,2018.0,2,1,1
NZ,NP,2012.0,21,22,-1
AZ,GB,2020.0,3,2,1
CH,CZ,2003.0,16,19,-3
TR,IN,2016.0,18,28,-10
MD,GB,2013.0,3,1,2
GR,AT,2000.0,3,1,2
ZA,JP,2005.0,6,5,1
FR,SK,2006.0,11,10,1
AU,BW,2016.0,4,4,0
DZ,TN,2011.0,10,6,4
SG,BE,2021.0,8,9,-1
US,CM,2012.0,11,17,-6
AU,ZA,2000.0,15,26,-11
US,SI,2019.0,22,23,-1
NZ,AR,2011.0,1,4,-3
LK,NO,2020.0,3,3,0
ZM,GB,2014.0,3,10,-7
SN,FR,2008.0,17,21,-4
CU,US,2005.0,16,19,-3
SE,EG,2019.0,11,11,0
AT,HU,2002.0,14,16,-2
AU,KW,2015.0,7,2,5
ES,MT,2012.0,2,10,-8
SE,LV,2004.0,6,4,2
GP,FR,1999.0,4,8,-4
TZ,US,2013.0,14,24,-10
AM,CA,2015.0,1,2,-1
NZ,ES,2013.0,10,11,-1
NG,SL,2021.0,1,2,-1
ES,nan,2007.0,15,26,-11
DK,FO,2019.0,4,2,2
PR,US,2020.0,6,2,4
CL,CU,2015.0,11,29,-18
US,PF,1999.0,1,1,0
CH,CO,2020.0,13,23,-10
SG,NZ,1999.0,3,4,-1
GH,CA,2010.0,4,3,1
CR,US,2015.0,32,40,-8
IL,BR,2005.0,7,3,4
BE,nan,2001.0,6,13,-7
PA,CH,2019.0,2,2,0
ZA,CH,2021.0,15,13,2
US,SD,2022.0,9,6,3
MX,SG,2019.0,3,1,2
TR,TN,2012.0,2,1,1
LY,GB,2002.0,1,1,0
DK,FO,2017.0,4,3,1
AU,CO,2001.0,3,2,1
ET,TW,2020.0,4,8,-4
GB,BW,2019.0,10,3,7
AE,NZ,2008.0,4,3,1
FR,SG,2000.0,4,1,3
EG,JP,2001.0,16,34,-18
AR,TW,2015.0,10,9,1
FR,CD,2021.0,3,3,0
KR,PH,1998.0,1,1,0
CO,CL,2023.0,5,2,3
MW,US,2004.0,2,5,-3
LT,US,1999.0,2,3,-1
GB,PA,2022.0,2,3,-1
AU,BB,2020.0,2,2,0
AU,PE,2015.0,2,3,-1
JP,PT,2017.0,4,3,1
HR,ME,2020.0,4,7,-3
GF,US,2015.0,1,1,0
BE,DZ,2008.0,1,1,0
RO,AU,2010.0,4,5,-1
DE,AU,2023.0,5,8,-3
DK,EE,2017.0,2,2,0
HU,DK,2006.0,2,1,1
JO,ES,2020.0,2,4,-2
AU,NP,2016.0,8,9,-1
ET,IT,2019.0,1,9,-8
FI,AT,2009.0,6,9,-3
JP,BD,1999.0,10,13,-3
CL,CN,2008.0,1,6,-5
CO,EC,2011.0,11,13,-2
MX,CN,2010.0,7,4,3
TW,FR,2006.0,12,18,-6
GB,TN,2005.0,3,2,1
OM,IN,2010.0,5,21,-16
CN,LT,2003.0,9,6,3
CR,NL,2016.0,2,2,0
IQ,PK,2014.0,6,1,5
RO,AU,2017.0,3,5,-2
PT,VE,2022.0,1,1,0
FR,MG,2012.0,9,9,0
KE,CA,2012.0,2,3,-1
AU,LY,2014.0,3,1,2
PT,IE,2018.0,6,6,0
BH,SA,2015.0,4,9,-5
RU,DK,2020.0,10,7,3
KE,MY,2020.0,3,3,0
SA,ID,2010.0,2,4,-2
MY,SD,2012.0,6,3,3
BY,IT,2017.0,5,1,4
ZA,CL,2009.0,3,1,2
PK,ID,2009.0,2,1,1
TH,ES,2018.0,2,4,-2
TR,PT,2020.0,7,3,4
CH,ZA,2021.0,13,15,-2
ID,KE,2022.0,4,2,2
BE,CM,2022.0,6,1,5
US,UZ,2021.0,5,3,2
FI,PT,2017.0,6,4,2
NZ,MX,2014.0,2,2,0
IL,AR,2005.0,2,3,-1
HR,CZ,2021.0,7,6,1
DE,AL,2010.0,2,1,1
TR,IT,1999.0,6,13,-7
TR,FR,2019.0,16,30,-14
LK,CN,2013.0,3,7,-4
MW,CA,2017.0,2,2,0
MD,CA,2007.0,3,1,2
KE,NL,2014.0,8,11,-3
ES,BD,2013.0,27,13,14
CL,BE,2007.0,6,4,2
nan,IL,1997.0,8,7,1
TR,EE,2022.0,1,1,0
nan,IR,2012.0,4,6,-2
AM,RU,2022.0,14,9,5
CN,BG,2005.0,4,6,-2
ID,AU,1999.0,1,7,-6
AT,PL,1999.0,7,4,3
IT,ZA,2006.0,14,11,3
SE,EE,1999.0,8,9,-1
RS,FR,2016.0,13,10,3
HR,NL,2018.0,5,6,-1
CN,TR,2004.0,3,15,-12
MK,AU,1999.0,4,3,1
US,BB,2014.0,3,5,-2
TR,CO,2023.0,15,8,7
AR,ID,2019.0,8,2,6
GR,LK,1999.0,5,2,3
ET,PH,2016.0,1,1,0
GL,DK,2018.0,2,5,-3
IT,BD,2015.0,9,10,-1
GB,BW,2017.0,7,6,1
NZ,TW,2012.0,12,5,7
NG,BR,2021.0,7,8,-1
EG,SD,2006.0,4,4,0
VE,CA,2001.0,1,1,0
PS,PK,2013.0,3,1,2
AU,IN,2023.0,4,12,-8
HK,US,2022.0,7,11,-4
VE,BR,2004.0,8,8,0
KZ,NO,2015.0,2,1,1
GR,TW,2011.0,2,4,-2
TH,PK,2022.0,4,9,-5
PT,GR,2005.0,1,3,-2
EE,GB,2015.0,7,8,-1
PK,ZM,2018.0,2,1,1
IL,NO,2009.0,3,2,1
DK,GR,2010.0,5,12,-7
LT,BY,2018.0,1,1,0
NG,IT,2006.0,8,3,5
LK,TH,2009.0,1,2,-1
SD,CN,2008.0,1,2,-1
MZ,RU,2021.0,8,20,-12
EC,JP,2018.0,2,2,0
RS,HU,2006.0,2,4,-2
FR,UA,2012.0,12,12,0
DE,LK,2012.0,2,1,1
GR,UA,2005.0,1,1,0
IN,RU,1999.0,7,8,-1
CH,RO,2007.0,7,3,4
RS,IN,2013.0,2,2,0
HR,FI,2019.0,1,1,0
NL,AR,2005.0,2,3,-1
TR,KR,2014.0,3,8,-5
IE,SE,2008.0,7,10,-3
OM,QA,2021.0,4,2,2
ES,BE,1998.0,18,15,3
nan,CO,2005.0,2,1,1
NL,IS,2008.0,2,1,1
CU,HN,2010.0,1,1,0
RU,RO,2010.0,8,2,6
HR,RO,2014.0,4,1,3
JP,RS,2004.0,3,5,-2
AE,PL,2020.0,1,5,-4
NG,PH,2019.0,2,1,1
IT,AL,2008.0,1,2,-1
RU,AM,2018.0,11,25,-14
CA,DE,2023.0,8,8,0
MT,GB,2011.0,10,7,3
CU,PT,2015.0,3,1,2
CW,US,2006.0,1,1,0
SA,SD,2001.0,1,1,0
PT,ZA,2014.0,7,1,6
SI,JP,2006.0,5,3,2
PK,IE,2008.0,1,4,-3
MK,GB,2014.0,3,7,-4
BR,CH,2005.0,17,26,-9
AT,IN,2013.0,10,17,-7
NO,JP,1997.0,4,4,0
GB,UG,2021.0,15,31,-16
PK,JO,2003.0,2,1,1
IE,MX,2011.0,3,3,0
TH,TR,2013.0,2,4,-2
CR,DE,2014.0,3,5,-2
PY,CU,2005.0,3,7,-4
AU,TN,2020.0,1,3,-2
IQ,SD,2011.0,1,4,-3
IQ,NL,2022.0,2,1,1
SV,ES,2006.0,2,1,1
PE,CO,2000.0,8,3,5
AT,PE,2018.0,1,2,-1
TR,MA,2021.0,3,3,0
nan,PE,2012.0,9,10,-1
IT,CO,2007.0,8,5,3
CN,TH,2001.0,4,3,1
CL,BO,2009.0,3,2,1
TH,AT,2019.0,4,4,0
US,KG,2014.0,1,2,-1
NO,PK,2008.0,2,2,0
RU,KG,2019.0,10,6,4
SD,ID,2020.0,7,1,6
HU,MA,2022.0,3,1,2
nan,ET,2019.0,4,2,2
BH,NG,2011.0,2,2,0
JO,LB,2015.0,3,3,0
US,HN,2020.0,5,7,-2
KH,NL,2000.0,1,2,-1
CR,GB,2008.0,2,3,-1
GR,SA,2018.0,3,1,2
PH,LV,2011.0,1,2,-1
UZ,GB,2019.0,3,3,0
IT,KR,2018.0,5,8,-3
FI,HU,2020.0,5,2,3
IE,NO,2016.0,7,4,3
TN,DE,2014.0,4,7,-3
GR,QA,2016.0,11,2,9
AL,XK,2009.0,2,3,-1
BB,US,2007.0,2,3,-1
DK,LT,2016.0,2,3,-1
DK,IN,1997.0,2,3,-1
AT,NO,2014.0,6,7,-1
ID,MK,2013.0,3,1,2
PL,IL,2001.0,5,2,3
BE,DK,1999.0,9,5,4
IT,ET,2011.0,1,1,0
NO,PT,2014.0,5,5,0
BE,CZ,2016.0,12,8,4
nan,AT,2012.0,9,16,-7
DK,NZ,2009.0,11,7,4
CA,TR,1998.0,5,1,4
SR,NL,2020.0,3,3,0
MC,US,2009.0,2,1,1
GB,CU,2003.0,1,4,-3
GH,NG,2007.0,1,1,0
PE,CH,2015.0,2,2,0
AU,HR,2009.0,5,2,3
BH,BD,2018.0,2,2,0
US,MD,2003.0,2,6,-4
nan,TR,2007.0,2,7,-5
DE,KE,2008.0,8,10,-2
RU,RO,2019.0,12,8,4
NL,NZ,2022.0,6,8,-2
CO,NL,2013.0,10,7,3
PK,BR,2007.0,1,2,-1
GH,CA,2017.0,8,8,0
EG,BE,2003.0,3,4,-1
CN,SD,2015.0,6,5,1
nan,TN,2015.0,6,6,0
DZ,IQ,2019.0,4,4,0
ET,CN,2008.0,3,4,-1
PE,VE,2018.0,7,15,-8
ET,IT,2010.0,3,2,1
MX,IE,2008.0,5,4,1
CA,UA,2000.0,2,1,1
NL,GR,2003.0,8,10,-2
TW,AT,2016.0,4,2,2
NL,IL,2011.0,14,13,1
AT,LI,2016.0,2,1,1
CM,CN,2013.0,1,2,-1
NL,SG,2009.0,10,12,-2
CA,DZ,2007.0,8,3,5
US,SZ,2018.0,1,2,-1
RU,EG,2007.0,3,1,2
DE,BY,1997.0,2,4,-2
RU,IE,2003.0,4,2,2
EG,BH,2016.0,5,1,4
IL,BY,2020.0,1,2,-1
IL,AT,1999.0,2,3,-1
IT,IS,2012.0,2,1,1
SK,BE,2021.0,3,1,2
JP,CD,2004.0,1,1,0
RO,AU,2019.0,4,2,2
ZM,JP,1997.0,1,2,-1
SE,HU,2009.0,10,20,-10
BE,NG,2017.0,2,2,0
BR,AE,2018.0,5,2,3
EG,PK,2006.0,3,3,0
US,BA,2003.0,4,1,3
KZ,UA,2003.0,1,1,0
DZ,PT,2018.0,3,1,2
PT,JP,2012.0,2,7,-5
ES,NG,2018.0,4,1,3
CU,nan,2009.0,1,2,-1
CL,CH,2001.0,1,3,-2
TR,AE,2023.0,1,1,0
VG,US,2000.0,3,6,-3
FR,KE,2003.0,1,5,-4
IQ,MY,2010.0,3,3,0
TG,CI,2015.0,2,1,1
CN,RS,2012.0,13,6,7
HU,nan,2006.0,1,6,-5
UA,BG,2003.0,6,6,0
RU,LT,2000.0,2,4,-2
IE,BD,2022.0,3,2,1
RS,AT,2009.0,2,4,-2
UZ,GB,2017.0,1,2,-1
CN,ID,2023.0,1,1,0
JP,BH,2021.0,2,2,0
NO,IS,1998.0,2,2,0
RO,NO,2020.0,6,6,0
LT,CA,2021.0,1,1,0
NG,DE,2020.0,13,16,-3
US,BF,2022.0,2,3,-1
UG,ZA,2006.0,3,2,1
KG,DE,2020.0,3,1,2
TN,nan,2009.0,2,1,1
RU,CZ,1999.0,6,9,-3
HU,RS,2016.0,5,12,-7
CZ,SE,2010.0,4,11,-7
FR,FI,1999.0,10,9,1
UA,RO,2020.0,10,3,7
CZ,AR,2018.0,5,3,2
AR,ID,2017.0,7,2,5
NZ,AT,2006.0,1,2,-1
US,BY,2003.0,6,11,-5
US,NP,2003.0,4,13,-9
PK,CH,2023.0,1,1,0
IT,NZ,2005.0,3,2,1
DK,HU,2021.0,3,6,-3
BE,UA,2004.0,3,1,2
DZ,US,2000.0,3,3,0
UY,PT,2018.0,3,1,2
PK,ZA,2016.0,5,4,1
MG,US,2006.0,3,2,1
CA,KW,2006.0,6,7,-1
SG,nan,2007.0,8,2,6
GB,BW,2010.0,2,2,0
RU,LU,2009.0,3,1,2
ML,IN,2011.0,5,3,2
TH,NL,2002.0,2,6,-4
BG,NL,2000.0,1,2,-1
TH,AT,2017.0,4,7,-3
SG,TR,2006.0,2,3,-1
IR,AF,2017.0,3,2,1
ZA,JP,2002.0,3,2,1
MX,CN,2017.0,6,12,-6
IL,BR,2002.0,4,3,1
LU,FI,2019.0,2,2,0
CA,VE,2022.0,2,2,0
RU,VG,2016.0,1,2,-1
ZA,GR,1998.0,2,1,1
NO,VN,2017.0,4,3,1
AU,MV,2013.0,1,1,0
PL,CA,2022.0,9,12,-3
IQ,IN,2017.0,6,23,-17
PH,PE,2015.0,3,1,2
GN,FR,2007.0,2,2,0
SA,MY,2009.0,11,8,3
US,MM,2022.0,6,8,-2
MY,CL,2020.0,2,2,0
MA,BD,2014.0,2,5,-3
HU,GR,2020.0,1,2,-1
FI,ID,2014.0,2,3,-1
KH,CN,2020.0,1,2,-1
FR,HR,1997.0,3,1,2
VN,NO,2011.0,4,3,1
FR,PH,2022.0,4,5,-1
NI,UA,2013.0,1,1,0
JM,US,2006.0,8,15,-7
PT,DE,1998.0,4,6,-2
AZ,IT,2007.0,1,1,0
DE,PE,2008.0,2,1,1
KW,FR,2010.0,4,3,1
AR,PH,2011.0,1,2,-1
SN,DE,2022.0,1,1,0
HR,BE,2007.0,2,1,1
HU,BE,2022.0,3,2,1
CN,HR,2013.0,3,5,-2
GR,IN,2006.0,4,4,0
EG,IL,2004.0,1,1,0
RS,MX,2015.0,2,9,-7
CZ,RU,2023.0,3,3,0
nan,SK,2020.0,1,2,-1
IL,PL,2016.0,8,7,1
PA,DE,2016.0,4,5,-1
BI,MA,1999.0,1,1,0
UG,NZ,2009.0,2,1,1
BA,MX,2008.0,1,2,-1
DK,EE,2010.0,1,2,-1
FR,CG,1998.0,3,2,1
VE,CU,2004.0,4,11,-7
FI,RO,2011.0,3,2,1
JO,CN,2008.0,2,2,0
TN,US,2007.0,11,6,5
FR,KW,2016.0,2,2,0
UG,TZ,2022.0,3,1,2
US,MT,2013.0,4,2,2
GB,UA,2009.0,8,12,-4
JP,CM,2003.0,1,1,0
MD,TN,2013.0,10,5,5
TN,IR,2008.0,3,2,1
DK,KR,2018.0,1,3,-2
BJ,CG,2019.0,1,1,0
TR,SE,2011.0,4,5,-1
VG,FR,2006.0,2,1,1
BE,VE,2019.0,1,2,-1
GT,CL,2018.0,3,1,2
FR,EE,2006.0,3,2,1
LU,SE,2015.0,3,3,0
NL,BD,2015.0,8,4,4
ID,BG,2018.0,3,7,-4
AT,IL,2009.0,6,7,-1
SE,JP,2023.0,3,3,0
ZA,SZ,2015.0,2,6,-4
GH,nan,2021.0,4,2,2
BR,IL,2022.0,3,2,1
NG,BW,2020.0,1,5,-4
SE,ZA,2023.0,2,1,1
IE,GR,2013.0,3,6,-3
BY,IT,2010.0,3,3,0
GB,SD,2004.0,1,2,-1
GB,MW,2007.0,8,7,1
MY,AR,2004.0,2,2,0
TH,TW,2018.0,11,16,-5
KE,ES,2001.0,1,1,0
AM,ES,2018.0,1,1,0
PA,CH,2017.0,1,1,0
PL,RS,2007.0,1,1,0
AT,MY,2008.0,2,1,1
CZ,AU,2010.0,3,8,-5
AE,DZ,2021.0,1,3,-2
AO,JP,2008.0,1,1,0
ZW,KE,2018.0,2,1,1
GH,RU,2019.0,2,1,1
ZA,FI,1998.0,1,1,0
nan,VN,2002.0,3,2,1
TW,HK,2015.0,2,3,-1
HK,TW,2016.0,3,1,2
TN,OM,2018.0,4,3,1
UZ,JP,1998.0,4,1,3
GB,HK,2022.0,3,1,2
NL,LK,2009.0,1,1,0
FI,PT,2019.0,2,7,-5
IT,MC,2006.0,1,1,0
LV,GB,2020.0,5,6,-1
NG,ZM,2016.0,1,1,0
TR,SG,2006.0,3,2,1
KE,CD,2018.0,2,1,1
YE,EG,2012.0,4,5,-1
CR,nan,2020.0,2,1,1
BE,HK,2018.0,1,1,0
RU,AR,2014.0,2,4,-2
CA,MY,2002.0,1,4,-3
SA,TW,2015.0,1,13,-12
GB,TN,2002.0,3,1,2
KW,TN,2016.0,1,1,0
SK,KR,2004.0,2,2,0
ET,NO,2012.0,3,8,-5
HU,CN,2021.0,3,10,-7
NI,ES,2016.0,8,8,0
BR,CZ,2009.0,3,3,0
PT,CA,2009.0,5,16,-11
IT,UZ,2002.0,2,1,1
ZA,IL,2010.0,4,2,2
BR,CH,2002.0,10,6,4
AT,IE,2018.0,5,9,-4
BA,SK,2018.0,3,2,1
QA,MY,2017.0,6,14,-8
KR,SE,2010.0,2,5,-3
KH,AU,2004.0,1,1,0
MX,CZ,2018.0,5,4,1
CY,CN,2019.0,2,3,-1
AU,MM,2021.0,4,3,1
DK,MX,2016.0,7,7,0
SE,AE,2021.0,5,6,-1
PR,RU,2017.0,1,1,0
EC,GT,2015.0,1,1,0
ID,JO,2017.0,3,2,1
MX,NG,2021.0,1,3,-2
MW,ZA,2007.0,3,1,2
TG,FR,2014.0,3,4,-1
VE,nan,2002.0,1,2,-1
PS,CA,2011.0,2,2,0
SV,VE,2016.0,1,1,0
ID,PK,2009.0,1,2,-1
KH,BE,2014.0,1,1,0
CD,ZA,2019.0,2,3,-1
NO,JP,1998.0,8,6,2
BD,nan,2009.0,3,1,2
NZ,AE,2016.0,1,3,-2
GN,US,2022.0,4,1,3
BH,DE,2020.0,1,1,0
IL,JO,2012.0,1,2,-1
UY,FR,2022.0,2,2,0
MY,PH,2004.0,1,1,0
AU,LK,2002.0,1,2,-1
RS,SK,2009.0,3,3,0
PT,EG,2016.0,2,2,0
LT,DE,2001.0,1,3,-2
FI,PT,2010.0,2,3,-1
SE,nan,2022.0,4,8,-4
HU,BR,2008.0,4,7,-3
GB,MA,2003.0,1,6,-5
QA,IN,2008.0,4,4,0
TR,CN,1998.0,2,2,0
CO,CR,2004.0,4,5,-1
MM,US,2014.0,3,4,-1
UY,CA,2014.0,2,1,1
CZ,PT,1999.0,2,1,1
HK,GB,2002.0,1,1,0
nan,CU,2021.0,5,2,3
CR,CA,2004.0,2,2,0
NL,KZ,2011.0,1,1,0
AT,KR,2008.0,4,5,-1
GH,ZA,2006.0,1,2,-1
IE,ZA,2021.0,6,10,-4
CA,BG,2003.0,1,10,-9
BA,AU,2018.0,2,2,0
CI,CA,2013.0,2,2,0
TH,BD,2016.0,3,7,-4
QA,IR,2014.0,2,1,1
HU,BA,2014.0,1,2,-1
NO,VN,2019.0,1,4,-3
KR,FI,2001.0,2,1,1
AT,JO,2015.0,1,1,0
SA,QA,2011.0,4,12,-8
RE,IT,2011.0,1,1,0
HR,AU,2009.0,2,5,-3
VE,IL,2006.0,1,2,-1
TZ,ZA,2012.0,1,4,-3
HU,EE,2018.0,2,2,0
NZ,PT,2017.0,2,5,-3
HU,CU,2003.0,2,1,1
GB,nan,2023.0,3,1,2
AU,SI,2016.0,4,2,2
US,MC,2007.0,1,2,-1
LV,PL,2018.0,3,1,2
CH,UG,2006.0,1,1,0
RO,SE,2018.0,8,9,-1
CZ,nan,2022.0,3,1,2
SE,LU,2008.0,1,2,-1
OM,TR,2022.0,1,2,-1
TZ,BW,2021.0,1,1,0
IL,HR,2001.0,1,1,0
MX,SI,2014.0,8,1,7
NO,MW,2011.0,2,1,1
UA,DK,2014.0,3,1,2
EG,KR,2008.0,2,5,-3
TZ,AU,2019.0,4,4,0
CA,VN,2004.0,1,3,-2
BJ,CG,2010.0,2,2,0
KE,CH,2015.0,1,5,-4
KW,FR,2017.0,5,6,-1
NO,UG,2019.0,3,4,-1
AM,BE,2012.0,1,2,-1
DK,IN,1998.0,5,5,0
BG,CN,2000.0,2,1,1
AU,QA,2001.0,1,1,0
CH,NO,1997.0,5,3,2
BG,GR,2001.0,4,3,1
LK,GR,2008.0,3,1,2
CO,KE,2013.0,2,4,-2
UA,NI,2015.0,2,4,-2
SE,LT,2016.0,4,8,-4
IR,EG,2009.0,2,5,-3
AR,BO,2009.0,2,5,-3
BO,BR,2015.0,1,6,-5
MU,GB,2018.0,1,7,-6
US,TW,2021.0,512,439,73
JP,KR,2018.0,399,386,13
CN,US,2001.0,2501,2897,-396
US,PK,2003.0,70,54,16
IT,BE,2010.0,106,65,41
CU,ES,2009.0,96,82,14
KR,PK,2018.0,63,53,10
US,AR,2001.0,100,121,-21
BD,MY,2013.0,59,36,23
IT,BE,2017.0,179,131,48
IN,DE,2007.0,143,89,54
LB,CN,2010.0,20,21,-1
ES,DE,2005.0,104,138,-34
ES,BE,1997.0,15,30,-15
US,NL,2011.0,690,645,45
BD,CA,2014.0,42,33,9
CA,SA,2012.0,92,36,56
CN,IN,2018.0,133,265,-132
US,GR,2012.0,170,188,-18
GB,CO,2020.0,36,36,0
AE,CH,2020.0,4,3,1
CN,VN,2006.0,12,44,-32
GB,EG,2015.0,108,61,47
FR,BR,2012.0,176,169,7
FR,nan,2011.0,170,223,-53
BE,DE,2012.0,116,131,-15
MX,CH,2016.0,13,15,-2
UA,US,2003.0,29,21,8
RU,GB,2004.0,80,52,28
CA,MX,2018.0,34,57,-23
MY,US,2006.0,38,64,-26
FR,IN,2010.0,85,125,-40
EE,DE,2014.0,43,57,-14
ID,CA,2005.0,5,5,0
PK,MY,2019.0,87,189,-102
MD,RO,2008.0,4,1,3
NZ,CA,2007.0,45,64,-19
ES,CA,2014.0,121,79,42
ZA,JM,2009.0,1,2,-1
AT,FR,2019.0,44,79,-35
CA,BF,2009.0,1,1,0
FI,CZ,2018.0,6,12,-6
US,SE,2002.0,272,312,-40
IQ,IN,2019.0,13,29,-16
RO,MD,2019.0,22,11,11
EG,AE,2020.0,65,53,12
FR,DZ,2008.0,75,51,24
DE,BE,1998.0,38,38,0
ES,SG,2020.0,7,8,-1
JP,SE,2007.0,42,41,1
GB,PK,2013.0,163,95,68
HU,IL,2002.0,2,2,0
FR,MX,2000.0,24,24,0
FR,RU,2006.0,43,48,-5
US,SK,2012.0,22,32,-10
TR,EG,2020.0,12,18,-6
AU,MK,2015.0,51,73,-22
CZ,BG,2014.0,3,2,1
SK,PH,2019.0,3,1,2
US,BD,2022.0,97,144,-47
BR,SE,2020.0,35,27,8
AU,RU,2018.0,43,22,21
AU,TW,2001.0,21,9,12
CR,EC,2015.0,9,6,3
UA,JP,2016.0,7,9,-2
SE,DZ,2018.0,15,1,14
BE,VE,2010.0,1,2,-1
GD,US,2015.0,22,12,10
BR,IE,2013.0,10,11,-1
NO,HR,2020.0,3,2,1
AE,NG,2021.0,1,3,-2
MY,CZ,2020.0,11,13,-2
DE,NP,2016.0,4,3,1
CN,FI,2000.0,7,9,-2
NG,BH,2012.0,4,5,-1
NO,AR,2022.0,2,3,-1
AU,AT,2011.0,27,23,4
HU,SE,2014.0,15,9,6
ZA,CN,2018.0,17,22,-5
RS,SE,2005.0,4,1,3
FR,BJ,2010.0,32,33,-1
AT,FI,2004.0,5,2,3
CA,MY,2005.0,3,5,-2
RO,US,2007.0,43,50,-7
LB,JP,2007.0,1,2,-1
AE,GB,2000.0,4,3,1
US,ET,2007.0,18,14,4
BE,NO,2012.0,10,7,3
BO,AR,2019.0,2,2,0
EG,DE,2007.0,25,32,-7
FR,RS,2018.0,8,7,1
MA,EG,2018.0,10,9,1
PL,JP,2013.0,13,22,-9
BH,KE,2004.0,4,4,0
JP,IT,2001.0,31,35,-4
HR,GB,2015.0,23,20,3
KR,IL,2016.0,8,5,3
CN,HK,2003.0,3,3,0
GB,IS,2011.0,10,8,2
IR,RU,2016.0,7,12,-5
NL,AR,2002.0,3,3,0
JP,UA,2012.0,7,1,6
LU,GR,2012.0,1,1,0
JP,AR,2009.0,4,2,2
IE,DE,2002.0,26,20,6
PK,JP,2008.0,6,19,-13
AE,nan,2016.0,3,1,2
BA,SI,2012.0,2,2,0
BR,PK,2021.0,4,4,0
SK,JP,2004.0,20,14,6
US,JO,2001.0,18,12,6
FR,HR,1998.0,7,2,5
DK,GB,2023.0,6,6,0
EG,SY,2021.0,6,4,2
ET,IT,2017.0,7,3,4
SA,TN,2016.0,24,76,-52
MX,AF,2016.0,4,4,0
ET,US,2006.0,16,15,1
LU,FI,2010.0,3,4,-1
FR,GN,2015.0,2,3,-1
AU,LK,2005.0,3,5,-2
GB,SK,2009.0,18,25,-7
UY,IE,2013.0,1,1,0
SG,AT,2021.0,4,3,1
IT,UY,2011.0,6,5,1
CU,PE,2013.0,11,7,4
BD,ES,2009.0,7,12,-5
BR,ZA,2002.0,5,3,2
MY,HK,2014.0,3,1,2
AE,EG,2013.0,26,19,7
UA,IL,2022.0,2,2,0
MX,CN,2019.0,12,9,3
TR,KZ,2002.0,4,4,0
BE,TN,2011.0,3,2,1
US,TN,2003.0,8,3,5
SD,GB,2006.0,3,2,1
NL,KR,1999.0,3,1,2
GR,IL,2011.0,2,1,1
TW,SI,2006.0,2,1,1
ST,PT,2008.0,1,1,0
UG,BE,2006.0,2,1,1
NZ,FR,2005.0,5,9,-4
SV,US,2021.0,5,1,4
BE,CU,2013.0,4,3,1
CL,NO,2021.0,4,2,2
IE,TW,2007.0,1,4,-3
CA,BA,2011.0,1,2,-1
DK,CL,2013.0,3,2,1
BG,SK,2008.0,3,1,2
EG,TN,2008.0,6,4,2
MA,IT,2006.0,1,11,-10
SK,RU,1998.0,4,2,2
NL,SK,2004.0,4,8,-4
IT,CM,2016.0,1,3,-2
NL,CL,2008.0,5,8,-3
PK,KG,2021.0,1,1,0
BY,IT,2019.0,1,1,0
SI,FR,2007.0,6,4,2
MY,LB,2015.0,1,1,0
SK,MX,2017.0,2,1,1
RU,VN,2013.0,5,4,1
CL,PY,2010.0,1,1,0
HR,MK,1997.0,1,1,0
EE,IT,2009.0,1,1,0
MY,JP,2004.0,8,16,-8
SV,AR,2015.0,2,2,0
AL,NL,2018.0,1,1,0
RO,IL,2017.0,1,4,-3
KE,BH,2016.0,3,4,-1
CL,PK,2020.0,1,2,-1
NO,BE,2009.0,2,7,-5
QA,JO,2012.0,1,5,-4
GB,MK,2016.0,1,7,-6
SD,KR,2011.0,1,1,0
LK,FR,2014.0,1,4,-3
HR,PL,2011.0,1,1,0
AU,MA,2001.0,1,2,-1
TR,CZ,2008.0,3,2,1
IT,ES,2005.0,116,89,27
SD,BR,2001.0,2,3,-1
BD,DE,2013.0,8,9,-1
IN,BD,2020.0,172,151,21
CH,BR,2010.0,36,37,-1
ES,DE,2002.0,74,78,-4
IL,IT,2020.0,17,31,-14
EC,DE,2020.0,5,11,-6
AU,MT,2016.0,5,2,3
KE,IN,1999.0,4,1,3
CL,PY,2017.0,7,5,2
HN,ES,2013.0,7,7,0
IT,NO,1999.0,12,9,3
NL,NP,2007.0,1,1,0
FR,NE,2014.0,34,10,24
KR,TW,2004.0,17,25,-8
SD,AE,2015.0,5,2,3
CI,CM,2013.0,2,2,0
RS,SE,2002.0,2,2,0
CH,MY,2012.0,7,3,4
TH,CH,2003.0,2,2,0
BM,US,2011.0,1,4,-3
ID,CA,2002.0,2,1,1
JO,SA,2003.0,3,1,2
,US,2008.0,71675,0,71675
AU,,2020.0,7726,0,7726
,CN,1994.0,17489,0,17489
US,,2021.0,110112,0,110112
,CA,1995.0,14305,0,14305
,ES,1994.0,22154,0,22154
KR,,2017.0,4604,0,4604
CA,,2022.0,20754,0,20754
BG,,2021.0,796,0,796
,NL,2009.0,6580,0,6580
,TR,2002.0,4890,0,4890
TW,,2011.0,1931,0,1931
KR,,2019.0,5190,0,5190
,TR,2005.0,5307,0,5307
,AR,1997.0,1708,0,1708
,AR,1998.0,1824,0,1824
ES,,2001.0,1484,0,1484
CH,,1999.0,795,0,795
GB,,2013.0,10873,0,10873
,SK,2004.0,603,0,603
,ID,2018.0,17882,0,17882
,IN,2006.0,12477,0,12477
RU,,2015.0,4108,0,4108
MX,,2011.0,1206,0,1206
,SK,1996.0,568,0,568
VU,AU,2016.0,1,0,1
,FR,2015.0,13359,0,13359
GR,,2016.0,1982,0,1982
MA,,2017.0,670,0,670
FI,,1998.0,239,0,239
CR,,2023.0,1057,0,1057
BD,,2018.0,700,0,700
,TN,2008.0,1145,0,1145
KR,,2010.0,1361,0,1361
,PL,1995.0,4705,0,4705
,PK,2010.0,1817,0,1817
,SA,2001.0,410,0,410
,EC,2012.0,441,0,441
NL,,2008.0,2170,0,2170
SY,NG,2012.0,1,0,1
,NO,1999.0,1241,0,1241
,FI,2006.0,1953,0,1953
,PK,2017.0,3113,0,3113
,HR,2003.0,625,0,625
,VE,1995.0,626,0,626
,AT,2016.0,2165,0,2165
CL,,2011.0,457,0,457
BF,,2018.0,107,0,107
,IR,2015.0,12257,0,12257
PT,,2003.0,133,0,133
,CZ,1999.0,1231,0,1231
IT,,2001.0,2221,0,2221
,MA,2008.0,633,0,633
,PE,2006.0,413,0,413
,CM,2013.0,504,0,504
,IL,2018.0,2186,0,2186
,NG,2014.0,3204,0,3204
EG,,2013.0,622,0,622
,RU,2003.0,6183,0,6183
MA,,2019.0,909,0,909
DK,UY,2016.0,2,0,2
,OM,2000.0,81,0,81
NI,,2017.0,13,0,13
TH,,2009.0,378,0,378
TN,,2014.0,440,0,440
,LT,2013.0,923,0,923
,ZW,1995.0,117,0,117
JO,,2002.0,38,0,38
,BJ,2012.0,148,0,148
DE,MG,2003.0,1,0,1
,SD,2014.0,175,0,175
,SY,2008.0,97,0,97
AE,,2005.0,34,0,34
,EE,2001.0,223,0,223
SY,,2014.0,80,0,80
LT,,2015.0,372,0,372
,KZ,2013.0,687,0,687
HU,CL,2006.0,1,0,1
,UG,2004.0,132,0,132
SI,,2016.0,387,0,387
UA,,1999.0,129,0,129
,PK,2019.0,1773,0,1773
,KE,2005.0,255,0,255
BW,,2024.0,393,0,393
JO,,2005.0,41,0,41
BT,,2025.0,2,0,2
PY,JP,2004.0,1,0,1
MX,GT,1998.0,1,0,1
,SI,2001.0,513,0,513
ZM,CZ,2018.0,4,0,4
MW,,2008.0,16,0,16
,DZ,1997.0,192,0,192
PH,,2012.0,178,0,178
,CU,1999.0,329,0,329
NP,,1999.0,5,0,5
MD,,2002.0,23,0,23
IL,CO,2001.0,1,0,1
MY,,1998.0,59,0,59
,HN,1998.0,33,0,33
PH,SA,2018.0,2,0,2
,MQ,2006.0,13,0,13
CA,BJ,2016.0,6,0,6
FR,VG,2002.0,1,0,1
,KE,2002.0,291,0,291
SN,,2008.0,19,0,19
ET,SD,2022.0,3,0,3
NI,,2019.0,45,0,45
KW,,2003.0,48,0,48
GT,SK,2020.0,1,0,1
BD,NL,2003.0,2,0,2
TR,ID,2007.0,1,0,1
MA,,2010.0,183,0,183
,UG,1996.0,64,0,64
,CY,1995.0,66,0,66
NG,UY,2021.0,1,0,1
KG,AU,2019.0,1,0,1
,TZ,2007.0,135,0,135
IT,BI,2018.0,2,0,2
,DZ,1998.0,184,0,184
CA,LT,2013.0,2,0,2
SK,,2009.0,227,0,227
,BD,2016.0,907,0,907
,LB,2003.0,195,0,195
HU,TR,2006.0,3,0,3
PE,AM,2011.0,1,0,1
MN,,2013.0,20,0,20
PH,SE,2014.0,3,0,3
,CW,2002.0,15,0,15
FR,PY,2021.0,1,0,1
SA,CO,2014.0,1,0,1
IQ,PL,2014.0,1,0,1
RU,RS,2000.0,2,0,2
IL,ID,2001.0,2,0,2
PS,IN,2003.0,1,0,1
ET,DK,2013.0,1,0,1
BE,KZ,2017.0,2,0,2
CM,GR,2015.0,1,0,1
,CN,2021.0,7,0,7
IR,TR,2023.0,6,0,6
UG,MM,2007.0,1,0,1
,KH,1995.0,12,0,12
ES,SV,2000.0,2,0,2
OM,SY,2021.0,1,0,1
MX,CI,2020.0,1,0,1
MG,,2008.0,14,0,14
,NA,2016.0,32,0,32
SA,ZM,1997.0,1,0,1
IT,GM,2022.0,1,0,1
PL,PH,2020.0,2,0,2
HK,AT,2009.0,1,0,1
AT,LK,2019.0,2,0,2
QA,JP,2001.0,2,0,2
JP,MK,2014.0,1,0,1
DZ,PL,2002.0,1,0,1
IL,NG,2012.0,1,0,1
HU,SI,2012.0,4,0,4
CM,EG,2015.0,1,0,1
IS,,2016.0,87,0,87
MD,,2005.0,23,0,23
DK,SI,2001.0,1,0,1
SE,RE,2020.0,1,0,1
ER,,2009.0,2,0,2
CD,ZA,2010.0,1,0,1
IT,nan,2023.0,4,0,4
NZ,ID,2013.0,4,0,4
BZ,,2009.0,1,0,1
ST,,2010.0,4,0,4
PG,,2012.0,11,0,11
TR,RO,2008.0,1,0,1
GT,CO,2012.0,2,0,2
IT,DO,2011.0,5,0,5
IN,YE,2019.0,13,0,13
NE,,1998.0,1,0,1
RW,IN,2007.0,1,0,1
,CW,2005.0,24,0,24
RE,MA,2022.0,1,0,1
AE,KZ,2015.0,2,0,2
FK,CA,2014.0,1,0,1
LB,CH,1997.0,1,0,1
KE,GN,2008.0,1,0,1
PT,LU,2021.0,3,0,3
LT,CZ,2021.0,6,0,6
SD,QA,2017.0,5,0,5
TH,DE,1999.0,3,0,3
NE,US,2001.0,4,0,4
RU,LK,2007.0,1,0,1
DE,ZM,2016.0,2,0,2
,SL,2016.0,14,0,14
NG,SD,2002.0,1,0,1
PT,BO,2012.0,1,0,1
ZA,MU,2019.0,2,0,2
AG,HU,2001.0,6,0,6
RS,,1999.0,34,0,34
BW,RW,2007.0,1,0,1
,PS,1999.0,24,0,24
VN,nan,1999.0,2,0,2
AT,PH,2005.0,2,0,2
PL,DZ,2006.0,1,0,1
AZ,DE,1997.0,1,0,1
,ST,2007.0,23,0,23
SG,BH,2017.0,1,0,1
AE,,2002.0,21,0,21
HK,,2003.0,3,0,3
JO,NZ,2008.0,1,0,1
PK,TZ,2014.0,1,0,1
NI,,2010.0,9,0,9
MR,,2022.0,23,0,23
UZ,KG,2010.0,1,0,1
LY,MX,2008.0,1,0,1
PT,GR,2002.0,2,0,2
ST,,2017.0,12,0,12
TN,NE,2009.0,1,0,1
CH,CI,2021.0,4,0,4
BY,IR,2019.0,2,0,2
,SZ,2011.0,10,0,10
DK,AR,1999.0,1,0,1
LV,KZ,2015.0,1,0,1
HR,JO,2018.0,1,0,1
GR,PS,2019.0,2,0,2
GP,US,2019.0,2,0,2
NO,ZA,2001.0,2,0,2
AU,CM,2012.0,1,0,1
CR,BE,2004.0,1,0,1
BR,PY,2005.0,2,0,2
NC,,2015.0,10,0,10
ET,CZ,2009.0,1,0,1
SL,,2005.0,1,0,1
FR,HK,2009.0,2,0,2
GB,CR,2003.0,2,0,2
US,MK,1998.0,2,0,2
GB,IQ,2003.0,1,0,1
,HN,1997.0,15,0,15
IQ,CR,2007.0,1,0,1
BR,HU,2004.0,1,0,1
TN,SG,2019.0,1,0,1
CN,PS,2006.0,1,0,1
BA,RU,2019.0,3,0,3
NG,nan,2003.0,1,0,1
NG,FI,2018.0,3,0,3
CY,CN,2010.0,1,0,1
NG,ZA,2001.0,2,0,2
BD,GH,2019.0,1,0,1
KE,AE,2020.0,1,0,1
IE,IL,2015.0,2,0,2
CD,nan,2020.0,1,0,1
YE,AR,2019.0,1,0,1
ID,AF,2022.0,5,0,5
WS,AU,2020.0,2,0,2
GP,,2014.0,9,0,9
AD,,2023.0,7,0,7
ET,,2013.0,54,0,54
BR,TN,2017.0,2,0,2
SK,NO,2013.0,6,0,6
MW,FR,2014.0,1,0,1
SC,IN,2012.0,1,0,1
VN,RS,2014.0,1,0,1
TR,LV,2017.0,2,0,2
KE,ZW,2012.0,1,0,1
BH,,2000.0,13,0,13
KH,,2006.0,4,0,4
CA,MW,2013.0,1,0,1
NZ,BG,2020.0,1,0,1
NZ,PT,2019.0,6,0,6
,MN,1999.0,16,0,16
nan,RS,2009.0,1,0,1
NZ,JP,2023.0,1,0,1
UY,RU,2020.0,1,0,1
US,CI,2003.0,2,0,2
UZ,KG,2017.0,3,0,3
MK,CR,2016.0,1,0,1
GA,AT,2014.0,1,0,1
RW,ZW,2016.0,2,0,2
CA,CR,2005.0,2,0,2
ST,,2019.0,7,0,7
BE,TR,2000.0,1,0,1
CZ,MA,2010.0,1,0,1
DK,NP,2011.0,2,0,2
CL,IN,2002.0,1,0,1
VN,EG,2011.0,1,0,1
LV,RO,2018.0,1,0,1
GP,US,2010.0,3,0,3
,YE,1994.0,9,0,9
,FK,1999.0,2,0,2
PH,VN,2010.0,2,0,2
MZ,AU,2003.0,1,0,1
NL,BF,2007.0,1,0,1
US,IQ,2004.0,2,0,2
SD,QA,2010.0,2,0,2
BD,IR,2009.0,2,0,2
OM,SD,2002.0,1,0,1
CZ,CO,2006.0,1,0,1
FI,SJ,2016.0,1,0,1
ES,PR,2011.0,1,0,1
BF,PK,2014.0,1,0,1
BY,GR,2003.0,2,0,2
DE,CM,2002.0,2,0,2
ID,NG,2003.0,1,0,1
IQ,MA,2000.0,1,0,1
CM,ZA,2007.0,2,0,2
FR,AO,2005.0,1,0,1
IL,MA,2012.0,1,0,1
NI,CL,2011.0,1,0,1
NG,TG,2015.0,1,0,1
PK,MX,2014.0,4,0,4
QA,DK,2009.0,2,0,2
JO,IL,2006.0,3,0,3
AM,UA,2016.0,1,0,1
ZW,CG,2014.0,2,0,2
PS,BD,2020.0,1,0,1
CN,MW,2020.0,1,0,1
BD,RU,2018.0,1,0,1
FI,AR,2022.0,2,0,2
MY,BA,2021.0,1,0,1
BR,SK,2003.0,1,0,1
US,PY,2023.0,1,0,1
PL,HK,2023.0,2,0,2
BD,GH,2017.0,1,0,1
SA,GH,2013.0,2,0,2
SE,KH,2014.0,1,0,1
CA,GF,2015.0,2,0,2
MX,GE,1999.0,1,0,1
,MC,2001.0,7,0,7
nan,EC,2011.0,3,0,3
ES,VG,2007.0,1,0,1
PK,GH,2020.0,3,0,3
ID,QA,2014.0,1,0,1
JP,BG,2009.0,3,0,3
NL,AL,2020.0,2,0,2
SI,SK,2009.0,1,0,1
CN,MA,2000.0,1,0,1
MZ,nan,2018.0,1,0,1
LA,IT,2017.0,1,0,1
TT,,2011.0,5,0,5
EG,GD,2021.0,1,0,1
BO,SV,2013.0,1,0,1
SO,,2015.0,1,0,1
NZ,RU,2005.0,1,0,1
ES,MZ,2014.0,3,0,3
MX,NZ,2012.0,4,0,4
MD,DZ,2005.0,2,0,2
JO,PH,2017.0,1,0,1
MC,IT,2000.0,2,0,2
SE,VN,2006.0,2,0,2
SE,OM,2020.0,4,0,4
GR,BY,2006.0,1,0,1
PL,SY,2010.0,1,0,1
HU,SY,2003.0,1,0,1
FJ,,2025.0,5,0,5
FR,AF,2017.0,2,0,2
NZ,WS,2019.0,1,0,1
FR,EC,1997.0,1,0,1
ET,ML,2015.0,2,0,2
IT,MZ,2022.0,1,0,1
ES,MC,2014.0,1,0,1
BA,CA,2012.0,1,0,1
PY,GB,1999.0,1,0,1
IN,KN,2013.0,1,0,1
MK,IT,2013.0,3,0,3
TR,MM,2023.0,1,0,1
EE,AT,2002.0,2,0,2
,ES,2021.0,2,0,2
US,JE,2020.0,1,0,1
ZA,GR,1997.0,3,0,3
LV,PA,2019.0,1,0,1
,GY,2013.0,3,0,3
CU,VE,2022.0,3,0,3
DO,IE,2011.0,1,0,1
GB,GI,2002.0,1,0,1
SA,YE,2002.0,1,0,1
BA,RU,2017.0,1,0,1
MK,GR,1998.0,3,0,3
CA,NA,2003.0,1,0,1
IR,KZ,2012.0,2,0,2
SN,GB,2016.0,2,0,2
SY,CA,2021.0,1,0,1
TT,ES,2016.0,1,0,1
ZA,BW,2023.0,2,0,2
AT,BD,2013.0,1,0,1
CO,UA,2016.0,1,0,1
AM,JP,2018.0,1,0,1
PH,VN,2017.0,2,0,2
CA,RO,1997.0,2,0,2
GA,,1998.0,2,0,2
IN,BA,2014.0,3,0,3
,SR,2006.0,3,0,3
FR,MM,2009.0,1,0,1
GN,LB,2021.0,1,0,1
TJ,,1998.0,1,0,1
HU,VE,2001.0,1,0,1
NG,MY,1998.0,2,0,2
JP,HN,1997.0,1,0,1
TR,SI,2018.0,4,0,4
FR,TG,1997.0,1,0,1
AL,,2000.0,4,0,4
KR,PH,1997.0,1,0,1
GB,KE,2023.0,2,0,2
BR,LT,2018.0,2,0,2
BY,GB,2022.0,1,0,1
QA,CA,2000.0,2,0,2
JO,IR,2009.0,1,0,1
DE,XK,2012.0,3,0,3
MW,UG,2008.0,3,0,3
CH,SG,1999.0,4,0,4
DO,CH,2011.0,1,0,1
FR,VG,2005.0,1,0,1
KR,TH,2001.0,1,0,1
BW,SZ,2001.0,1,0,1
NP,FR,2000.0,2,0,2
PL,MK,2014.0,4,0,4
TN,SG,2017.0,1,0,1
HU,KE,2021.0,1,0,1
AF,GB,2020.0,2,0,2
GE,NL,2014.0,2,0,2
MZ,ES,2018.0,2,0,2
NP,nan,2022.0,3,0,3
LT,PL,2015.0,2,0,2
UG,ID,2013.0,1,0,1
DE,TZ,2009.0,2,0,2
CU,GM,2014.0,1,0,1
PL,TH,2004.0,1,0,1
RS,UA,2005.0,2,0,2
IN,YE,2010.0,1,0,1
PH,EC,2015.0,1,0,1
GY,IN,2021.0,1,0,1
RE,AU,2017.0,1,0,1
NE,GT,2014.0,1,0,1
BY,BE,2007.0,1,0,1
GL,CA,2012.0,1,0,1
CL,FI,2007.0,1,0,1
SD,ET,1999.0,1,0,1
EG,RO,2013.0,2,0,2
CL,AT,2009.0,2,0,2
CZ,PA,2021.0,1,0,1
GF,MQ,2012.0,1,0,1
CY,LT,2020.0,1,0,1
IL,MC,2022.0,1,0,1
,ER,2018.0,4,0,4
EC,GB,2003.0,2,0,2
VE,IE,2016.0,1,0,1
BF,BE,2001.0,1,0,1
GB,RE,2011.0,1,0,1
QA,PL,2016.0,1,0,1
PS,QA,2011.0,1,0,1
nan,LA,2008.0,1,0,1
SD,TZ,2022.0,1,0,1
ZA,PE,2020.0,2,0,2
VN,PH,2002.0,1,0,1
IQ,AT,2020.0,2,0,2
GA,CM,2022.0,2,0,2
AO,,2006.0,5,0,5
DZ,PS,2021.0,1,0,1
CN,LA,2021.0,2,0,2
BE,NG,2010.0,2,0,2
ZA,MT,2019.0,1,0,1
RS,KZ,2022.0,1,0,1
AM,CN,2013.0,1,0,1
BE,GM,2022.0,1,0,1
EC,CZ,2010.0,1,0,1
GP,DZ,2019.0,1,0,1
NE,ID,2019.0,1,0,1
KW,AR,2015.0,1,0,1
US,BZ,2011.0,2,0,2
UG,CI,2020.0,1,0,1
IR,BN,2019.0,1,0,1
IT,NP,2013.0,1,0,1
CO,NI,2009.0,1,0,1
NA,KH,2021.0,1,0,1
AT,IR,2005.0,2,0,2
ZA,BG,2017.0,3,0,3
CN,BA,2004.0,1,0,1
CY,TW,2019.0,1,0,1
CI,JP,2020.0,1,0,1
LK,KW,2012.0,1,0,1
RS,RW,2013.0,1,0,1
KH,SN,2007.0,1,0,1
IQ,KW,2009.0,1,0,1
GE,PK,2014.0,1,0,1
TN,KE,2020.0,1,0,1
BO,CU,2010.0,2,0,2
MO,CN,2005.0,1,0,1
IN,AF,2020.0,5,0,5
UA,PA,2016.0,1,0,1
FR,GE,2001.0,1,0,1
MW,CA,2019.0,1,0,1
AE,UG,2018.0,1,0,1
TW,SN,2019.0,1,0,1
CR,PL,2008.0,1,0,1
KE,MR,2012.0,1,0,1
SV,CL,2004.0,2,0,2
RU,BA,2018.0,1,0,1
AM,ID,2022.0,2,0,2
HR,IR,2019.0,1,0,1
EE,LU,2020.0,1,0,1
EC,PA,1999.0,1,0,1
SV,PE,2008.0,1,0,1
HU,HR,2021.0,4,0,4
CG,PE,2008.0,1,0,1
LK,AE,2020.0,1,0,1
IN,CF,2015.0,1,0,1
PK,GD,2017.0,1,0,1
DZ,CZ,2022.0,1,0,1
NP,IE,2005.0,1,0,1
KE,VU,2022.0,1,0,1
NA,FI,2020.0,1,0,1
LK,BN,2008.0,1,0,1
CN,XK,2022.0,1,0,1
SE,CO,1998.0,3,0,3
FR,AO,2002.0,3,0,3
NL,MZ,2002.0,1,0,1
GH,CI,2016.0,1,0,1
DO,RU,2020.0,2,0,2
TR,LY,2020.0,1,0,1
BE,BJ,1998.0,1,0,1
IL,PY,2014.0,1,0,1
PL,CR,2015.0,1,0,1
AT,PR,2012.0,1,0,1
QA,TR,2002.0,1,0,1
CU,NI,1998.0,1,0,1
NZ,SZ,2021.0,1,0,1
TW,SN,2017.0,1,0,1
SV,GT,2008.0,1,0,1
CL,SA,2006.0,1,0,1
UA,IR,2011.0,2,0,2
BD,AE,2009.0,1,0,1
OM,JP,1998.0,1,0,1
PE,ZA,2015.0,2,0,2
KZ,KW,2009.0,1,0,1
GH,PT,2021.0,1,0,1
DE,MY,1999.0,2,0,2
BR,SC,2019.0,1,0,1
GB,VG,2000.0,2,0,2
BD,AT,2000.0,1,0,1
CY,CH,2022.0,1,0,1
ER,IN,2007.0,1,0,1
ET,GH,2015.0,1,0,1
CA,BH,2011.0,1,0,1
SA,TH,2007.0,1,0,1
LV,FI,2008.0,1,0,1
PF,RW,2021.0,1,0,1
FR,TD,2000.0,1,0,1
CW,BE,2000.0,1,0,1
PH,LK,2008.0,1,0,1
BE,IS,2021.0,1,0,1
OM,JP,1997.0,1,0,1
IT,SY,2005.0,2,0,2
SG,BH,2010.0,2,0,2
ES,ID,1998.0,1,0,1
,CV,2013.0,3,0,3
IR,EE,2018.0,3,0,3
nan,HR,2008.0,1,0,1
PT,KR,2021.0,4,0,4
BE,RE,2003.0,1,0,1
CU,BZ,2016.0,1,0,1
BD,OM,2015.0,2,1,1
GR,AE,2013.0,2,1,1
PH,VN,2019.0,4,2,2
RU,SG,2021.0,2,7,-5
IL,AR,2002.0,2,3,-1
PK,ZW,2018.0,1,1,0
CU,IT,1999.0,1,1,0
AL,TR,2015.0,2,2,0
MY,IL,2018.0,3,1,2
NL,MW,2022.0,1,2,-1
CH,LU,2004.0,1,1,0
MX,QA,2015.0,2,1,1
LK,RO,2016.0,1,1,0
GR,CL,2019.0,1,1,0
DE,AL,2017.0,1,1,0
LK,AU,2000.0,1,4,-3
CR,SE,2005.0,2,3,-1
SO,PK,2022.0,1,1,0
KZ,KR,2007.0,1,1,0
SY,PL,2013.0,1,1,0
NZ,EG,2007.0,2,2,0
TR,KE,2019.0,1,2,-1
NO,MY,2009.0,1,2,-1
RO,HR,2016.0,4,1,3
ES,JO,2009.0,1,2,-1
IE,DK,1998.0,1,1,0
ZW,BE,2005.0,1,1,0
CZ,GE,1998.0,1,2,-1
AR,IL,2003.0,3,1,2
NO,VN,2010.0,1,1,0
DO,CU,2014.0,1,3,-2
RO,IL,2019.0,1,1,0
BA,BE,2015.0,1,1,0
SE,EG,2010.0,2,3,-1
TH,CZ,2021.0,1,1,0
DE,BY,1998.0,2,6,-4
IL,SG,2008.0,1,2,-1
IN,UA,2020.0,4,8,-4
SK,HR,2008.0,2,1,1
NG,AE,2018.0,3,4,-1
RE,BE,2020.0,1,2,-1
VE,SE,2012.0,1,1,0
KE,MX,2021.0,1,1,0
ZW,TZ,2012.0,1,2,-1
MM,AU,2018.0,3,3,0
LT,RO,2005.0,3,3,0
NG,CH,2007.0,1,1,0
AU,CR,2020.0,3,1,2
PK,PH,2022.0,3,2,1
DK,GW,2022.0,1,3,-2
IE,RS,2021.0,2,2,0
RO,MD,2010.0,1,3,-2
CO,UY,2004.0,1,3,-2
RU,RO,2017.0,2,13,-11
AT,ZA,2003.0,2,1,1
HR,FI,2017.0,3,6,-3
CN,KE,2000.0,1,2,-1
BJ,CG,2017.0,2,1,1
SZ,GB,2004.0,1,1,0
ML,KE,2015.0,1,1,0
US,SY,1999.0,2,3,-1
BO,CU,2019.0,1,1,0
UZ,US,2021.0,3,5,-2
EE,DK,2010.0,2,1,1
CY,IT,2016.0,1,3,-2
PK,ES,2008.0,2,1,1
KE,CI,2020.0,1,1,0
FR,TG,1998.0,1,1,0
ME,IT,2022.0,1,1,0
AU,CU,2004.0,1,1,0
IT,NZ,2002.0,1,4,-3
KE,NG,2011.0,1,2,-1
ZA,BG,2010.0,1,1,0
ZM,DE,2011.0,1,1,0
DK,AE,2013.0,1,1,0
KZ,MN,2021.0,1,3,-2
GB,BF,2020.0,2,3,-1
JM,CA,2006.0,1,1,0
ZW,IN,2016.0,1,1,0
QA,OM,2008.0,1,1,0
ES,KR,2007.0,1,2,-1
MA,TG,2013.0,1,1,0
MZ,BR,2009.0,2,2,0
CZ,BA,2019.0,2,1,1
TR,CN,1997.0,2,1,1
SA,SG,2022.0,2,4,-2
JP,QA,2011.0,1,1,0
IE,ET,2020.0,1,1,0
KG,RU,2004.0,1,2,-1
ES,PS,2003.0,1,1,0
TH,GR,2017.0,1,1,0
PS,JO,2013.0,1,1,0
CZ,MK,2021.0,1,3,-2
BE,ZM,2016.0,2,1,1
GB,KZ,2008.0,1,2,-1
ES,CR,2023.0,2,1,1
PL,KZ,2021.0,1,7,-6
HU,BY,2003.0,1,2,-1
BG,ES,2005.0,1,5,-4
LB,IN,2013.0,2,4,-2
SN,CH,2021.0,2,2,0
GR,RS,2012.0,1,2,-1
IS,GB,2005.0,1,4,-3
CL,AE,2015.0,1,1,0
LK,NZ,2009.0,1,1,0
CA,NP,2005.0,1,2,-1
PT,BG,2013.0,1,1,0
NZ,IL,2020.0,1,2,-1
NL,FJ,2017.0,1,1,0
NZ,ET,2012.0,1,1,0
SI,RU,2013.0,1,3,-2
OM,KW,2017.0,2,1,1
SK,RU,1997.0,2,3,-1
US,ZW,1997.0,4,3,1
UY,SE,2001.0,1,3,-2
CH,GR,1998.0,3,2,1
FO,US,2011.0,1,1,0
CO,SE,2009.0,1,3,-2
NZ,PT,2010.0,1,2,-1
PK,SE,2000.0,1,1,0
LK,CA,2014.0,1,4,-3
DZ,ZA,2018.0,2,1,1
MX,DK,1998.0,1,2,-1
MT,PL,2019.0,1,1,0
CA,CR,2002.0,2,1,1
FR,SD,2006.0,1,1,0
GR,CL,2017.0,3,2,1
GN,ML,2015.0,1,3,-2
SN,CF,2011.0,1,1,0
PH,RU,2006.0,2,2,0
BH,GH,2006.0,1,1,0
NZ,NG,2005.0,1,1,0
CD,UG,2018.0,1,2,-1
IN,AT,1997.0,1,3,-2
KZ,PK,2022.0,1,2,-1
VN,AT,2018.0,1,2,-1
TR,DK,2001.0,3,1,2
IN,AT,1998.0,1,8,-7
PG,AU,1998.0,1,2,-1
PH,AT,2009.0,1,3,-2
ID,JP,2023.0,2,2,0
DK,AM,2015.0,1,1,0
UA,GR,2005.0,1,1,0
ZM,JP,1998.0,1,1,0
BR,PY,2002.0,1,5,-4
DZ,ID,2015.0,3,1,2
TN,FI,2012.0,1,1,0
DZ,LB,2019.0,1,2,-1
FR,JO,2020.0,1,2,-1
TR,IL,2016.0,2,7,-5
RU,BG,2023.0,1,4,-3
QA,BR,2012.0,1,2,-1
CY,nan,2018.0,1,1,0
CZ,MA,2019.0,1,1,0
SD,SG,2021.0,1,1,0
MN,KR,2021.0,1,11,-10
ZA,MA,2022.0,1,2,-1
SI,CA,2013.0,1,3,-2
RS,CN,2001.0,2,5,-3
AL,SE,2004.0,1,1,0
PH,CZ,2013.0,1,1,0
EC,FR,2010.0,1,3,-2
HU,QA,2015.0,1,2,-1
AT,RO,2008.0,1,1,0
JO,IT,2013.0,1,3,-2
CZ,MX,2004.0,1,2,-1
SM,IT,2022.0,1,3,-2
CF,SN,2011.0,1,1,0
NI,AR,2012.0,1,1,0
SK,IE,2012.0,1,2,-1
MX,IL,2022.0,1,2,-1
TN,IL,2006.0,1,1,0
PY,CU,2002.0,1,2,-1
AE,QA,2012.0,1,2,-1
RS,PL,2004.0,1,4,-3
JP,BW,2020.0,1,2,-1
OM,FR,2006.0,1,1,0
SA,CN,1999.0,1,2,-1
AR,MY,2020.0,1,2,-1
NO,UG,2010.0,1,2,-1
CD,ES,2013.0,1,1,0
nan,NP,2021.0,1,6,-5
TH,IN,2003.0,1,4,-3
BT,IN,2021.0,1,1,0
MY,RU,2022.0,1,21,-20
CH,CM,2008.0,1,2,-1
RW,GB,2020.0,1,5,-4
DE,CM,2005.0,1,2,-1
KE,IT,2000.0,1,2,-1
MX,AE,2015.0,1,2,-1
VN,TR,2022.0,1,1,0
JM,CH,2016.0,1,1,0
GN,CI,2012.0,1,1,0
KY,IN,2010.0,1,1,0
MA,PK,2002.0,1,7,-6
RO,IR,2019.0,1,2,-1
CN,BO,2006.0,1,7,-6
SK,EE,2016.0,1,1,0
NG,CZ,2012.0,1,1,0
CZ,SG,2009.0,3,1,2
BJ,TG,2021.0,2,2,0
CZ,DK,2009.0,2,7,-5
LU,CN,2015.0,2,4,-2
GH,NL,2008.0,1,1,0
SK,MX,2019.0,1,2,-1
MX,ZA,2021.0,2,1,1
NG,TZ,2018.0,1,4,-3
IE,CL,2003.0,1,1,0
FI,BG,2016.0,1,1,0
BE,VE,2017.0,1,3,-2
MY,PT,2014.0,1,3,-2
LK,SE,1997.0,1,1,0
CH,TZ,2012.0,2,4,-2
CH,DO,2004.0,1,1,0
BW,ZW,2014.0,1,1,0
LU,nan,2016.0,1,1,0
MN,DE,2015.0,1,5,-4
nan,TW,2001.0,1,6,-5
MA,PK,2005.0,2,5,-3
SA,MR,2018.0,1,1,0
MX,EC,1999.0,1,1,0
TN,JP,2016.0,2,5,-3
OM,KW,2019.0,1,2,-1
TN,MG,2018.0,1,4,-3
DK,VN,2009.0,1,0,1
BH,SE,2006.0,1,0,1
PH,OM,2014.0,2,0,2
US,DO,2013.0,3,0,3
BS,,2014.0,4,0,4
KW,SE,2000.0,1,0,1
IT,ME,2012.0,1,0,1
EC,DK,2014.0,1,0,1
SO,TR,2018.0,1,0,1
nan,PA,2015.0,1,0,1
PE,SI,2023.0,2,0,2
CO,UG,2020.0,1,0,1
TR,KE,2017.0,2,0,2
MQ,US,2007.0,1,0,1
NZ,GH,1998.0,1,0,1
EE,RO,2021.0,1,0,1
US,AZ,1999.0,1,0,1
NG,BG,2004.0,1,0,1
MN,JP,1998.0,2,0,2
EE,nan,2007.0,1,0,1
MW,NO,2022.0,1,0,1
GR,BN,2013.0,1,0,1
BR,MA,2015.0,3,0,3
AE,MA,2012.0,1,0,1
GB,SL,2022.0,3,0,3
CO,GT,2004.0,1,0,1
MM,OM,2014.0,1,0,1
BB,NL,2018.0,1,0,1
TN,MR,2020.0,2,0,2
BW,CN,2018.0,2,0,2
MM,RU,2018.0,1,0,1
FR,AF,2019.0,1,0,1
AE,SN,2009.0,1,0,1
KE,BW,1997.0,1,0,1
CA,LU,2003.0,1,0,1
CN,CD,2006.0,1,0,1
IN,YE,2017.0,2,0,2
BJ,UG,2006.0,1,0,1
DE,LI,2004.0,2,0,2
PK,UZ,2015.0,1,0,1
UA,HK,2014.0,1,0,1
AE,BH,2006.0,1,0,1
NZ,SS,2008.0,1,0,1
CH,LV,2011.0,2,0,2
GR,LU,2004.0,1,0,1
MT,US,2003.0,1,0,1
CH,DZ,1999.0,1,0,1
IR,PT,2007.0,2,0,2
US,MK,1997.0,1,0,1
GB,AL,2003.0,2,0,2
US,RE,2007.0,2,0,2
AE,SI,2023.0,1,0,1
SD,PK,2021.0,2,0,2
SG,CZ,2012.0,1,0,1
BO,AR,2010.0,4,0,4
NL,BJ,2011.0,1,0,1
DE,JM,2008.0,1,0,1
AF,DE,2017.0,1,0,1
BR,TW,1997.0,1,0,1
EG,FI,2003.0,1,0,1
BI,GF,2017.0,1,0,1
,PW,2012.0,1,0,1
AU,EC,2003.0,1,0,1
AM,GR,2016.0,1,0,1
TJ,GE,2020.0,1,0,1
GD,DE,2004.0,1,0,1
,DJ,2015.0,3,0,3
MM,CZ,2016.0,2,0,2
IS,ZA,2016.0,1,0,1
MW,IT,2018.0,1,0,1
GR,BD,1999.0,1,0,1
TJ,UZ,2013.0,2,0,2
YE,NL,2002.0,1,0,1
UA,MA,2016.0,1,0,1
LV,IL,1999.0,1,0,1
LB,IL,2001.0,1,0,1
AT,RW,2018.0,1,0,1
LK,KE,2016.0,1,0,1
KR,LT,2023.0,1,0,1
BR,DZ,2018.0,1,0,1
CN,DO,2017.0,1,0,1
PR,DK,2006.0,1,0,1
BN,FO,2015.0,1,0,1
IR,AE,2004.0,1,0,1
IQ,PH,2019.0,1,0,1
NA,IN,2018.0,1,0,1
MZ,VN,2018.0,1,0,1
PA,VE,2005.0,2,0,2
JP,JM,2003.0,1,0,1
CN,AO,2022.0,1,0,1
PR,JP,2007.0,1,0,1
CY,KG,2020.0,1,0,1
BE,HR,2004.0,1,0,1
BJ,TR,2019.0,1,0,1
MW,CA,2010.0,1,0,1
AR,SG,2020.0,1,0,1
GR,TN,2021.0,1,0,1
TH,ZM,2013.0,1,0,1
MN,TW,2009.0,1,0,1
TR,LV,2019.0,1,0,1
GP,NC,2004.0,1,0,1
KE,BR,2009.0,2,0,2
DZ,IQ,2017.0,2,0,2
PR,BR,2004.0,1,0,1
IE,PS,2014.0,1,0,1
BE,CI,1999.0,1,0,1
DK,TT,2013.0,1,0,1
SY,AE,2008.0,1,0,1
SK,nan,2003.0,1,0,1
BO,PT,2011.0,1,0,1
TT,FR,2020.0,1,0,1
MU,CH,2011.0,1,0,1
ZM,UG,2016.0,1,0,1
GR,PS,2017.0,1,0,1
CU,BO,2011.0,1,0,1
HR,ID,2018.0,1,0,1
MD,CL,2012.0,1,0,1
SG,FJ,1998.0,1,0,1
NZ,KN,2013.0,1,0,1
TH,GR,2019.0,1,0,1
DZ,LB,2017.0,1,0,1
KW,NG,2008.0,2,0,2
ZA,JE,2002.0,1,0,1
UG,ML,2014.0,1,0,1
MC,AT,2013.0,1,0,1
RO,BI,2015.0,1,0,1
RS,IT,1998.0,1,0,1
KW,HR,2019.0,1,0,1
MW,BE,2021.0,1,0,1
ZW,BW,2000.0,1,0,1
CH,MC,2016.0,1,0,1
QA,GL,2006.0,1,0,1
GR,DZ,2018.0,1,0,1
TH,SA,2014.0,1,0,1
CZ,ES,2023.0,1,0,1
SS,NO,2018.0,1,0,1
MY,KG,2017.0,1,0,1
BD,SG,2007.0,1,0,1
SD,DE,2007.0,1,0,1
FR,MR,1997.0,1,0,1
nan,PH,2010.0,1,0,1
BG,US,2023.0,1,0,1
SI,BM,2011.0,1,0,1
BE,UZ,2021.0,1,0,1
FR,BH,2018.0,1,0,1
MK,NZ,2014.0,1,0,1
MM,KR,2004.0,1,0,1
ES,UZ,2021.0,1,0,1
VU,CH,2014.0,1,0,1
PH,UA,2012.0,1,0,1
AZ,AU,2009.0,1,0,1
CI,EG,2008.0,1,0,1
CA,LK,2023.0,1,0,1
GR,SG,2001.0,1,0,1
DE,CG,2022.0,2,0,2
UG,DZ,2021.0,1,0,1
NP,ET,2019.0,1,0,1
IT,LY,2012.0,1,0,1
YE,PK,2014.0,1,0,1
IS,PT,2021.0,1,0,1
CU,NZ,2014.0,1,0,1
TZ,AU,2010.0,1,0,1
TR,ZM,2019.0,1,0,1
HU,KW,2009.0,1,0,1
PG,AU,1997.0,1,0,1
KG,FR,2005.0,1,0,1
ZW,SS,2021.0,1,0,1
RW,AG,2019.0,1,0,1
BA,PL,2022.0,1,0,1
nan,RO,1997.0,1,0,1
NG,CI,2012.0,1,0,1
AU,JM,2022.0,1,0,1
BA,ME,2011.0,1,0,1
BG,DZ,2015.0,1,0,1
SI,TT,2018.0,1,0,1
BE,KZ,2019.0,1,0,1
ZW,FR,2008.0,1,0,1
BE,MC,2013.0,1,0,1
CY,CN,2017.0,1,0,1
GB,BJ,2004.0,1,0,1
ES,GW,2018.0,1,0,1
JE,CA,2020.0,1,0,1
VN,KE,2021.0,1,0,1
CA,NI,2016.0,1,0,1
SE,BY,2021.0,1,0,1
UA,GR,2002.0,1,0,1
SE,KZ,2006.0,1,0,1
PA,UY,2019.0,1,0,1
KW,RS,2008.0,1,0,1
SA,GF,2019.0,1,0,1
DZ,PK,2021.0,1,0,1
RS,UA,2002.0,1,0,1
RU,ME,2020.0,1,0,1
MX,FI,2001.0,1,0,1
EG,SN,2012.0,1,0,1
BI,CN,2010.0,1,0,1
SS,US,2004.0,1,0,1
UZ,BR,2022.0,1,0,1
KR,TR,1999.0,1,0,1
MA,BA,2018.0,1,0,1
NP,MY,2002.0,1,0,1
NO,OM,2010.0,1,0,1
AE,ET,2016.0,1,0,1
BO,DE,2004.0,1,0,1
PL,TN,2015.0,1,0,1
JO,TT,2022.0,1,0,1
BG,MD,2020.0,1,0,1
MZ,TJ,2021.0,1,0,1
ZA,FI,1997.0,1,0,1
PL,CG,2019.0,1,0,1
CH,NA,2020.0,1,0,1
JE,,2000.0,1,0,1
NZ,WS,2010.0,1,0,1
KR,EG,2000.0,1,0,1
GF,GP,2016.0,1,0,1
ZW,CZ,2022.0,1,0,1
IN,AM,2022.0,1,0,1
OM,FI,2019.0,1,0,1
YE,RO,2011.0,1,0,1
ZM,CL,2022.0,1,0,1
JO,AM,2009.0,1,0,1
CN,AZ,2013.0,1,0,1
MQ,,2003.0,1,0,1
BF,MA,2014.0,1,0,1
RO,EG,2018.0,1,0,1
NG,CO,2023.0,1,0,1
CR,CO,2020.0,49,48,1
UA,MX,2013.0,3,2,1
DE,KR,2013.0,49,49,0
CA,US,2011.0,3225,3097,128
AU,PT,2013.0,16,11,5
US,ES,2012.0,931,996,-65
GB,IN,2004.0,184,190,-6
AU,FJ,2015.0,8,4,4
US,GB,2007.0,5081,4726,355
ES,BR,2015.0,454,375,79
ES,HR,2013.0,4,7,-3
TR,FI,2021.0,12,11,1
CL,MX,2021.0,154,146,8
ES,CL,2021.0,308,348,-40
ES,FR,2019.0,334,337,-3
CN,BR,2013.0,62,62,0
JP,US,2006.0,1894,1795,99
SK,ES,2011.0,4,4,0
ES,nan,2005.0,18,22,-4
DE,GB,1999.0,387,286,101
ES,AR,2021.0,288,354,-66
US,CZ,2019.0,170,153,17
US,CR,2015.0,40,32,8
ES,MX,2021.0,593,792,-199
RU,GB,2020.0,113,132,-19
US,ZA,2018.0,353,403,-50
DE,BG,2022.0,14,8,6
BE,DE,2003.0,64,63,1
ES,FR,2017.0,374,303,71
PH,TR,2009.0,2,2,0
CO,MX,2007.0,113,129,-16
GB,NL,2018.0,359,395,-36
CH,DE,2014.0,824,1018,-194
JP,DE,1999.0,131,110,21
MA,TN,2008.0,16,12,4
ES,CO,2009.0,263,268,-5
DE,CZ,2015.0,72,72,0
IL,FR,2015.0,23,37,-14
BR,MX,2021.0,105,112,-7
AU,CH,2019.0,92,123,-31
CN,TR,2020.0,17,30,-13
US,nan,2021.0,201,205,-4
AU,AR,2014.0,10,10,0
US,SG,2019.0,611,562,49
NL,CA,2021.0,61,78,-17
JP,CN,2016.0,528,396,132
ES,FR,2010.0,235,315,-80
TW,CN,2001.0,578,443,135
ES,DE,2007.0,127,161,-34
GB,ES,2020.0,494,421,73
CZ,NO,2006.0,26,4,22
US,UY,2010.0,17,12,5
GB,CN,2004.0,329,301,28
SE,DK,2013.0,143,94,49
EG,DE,2005.0,15,36,-21
DE,ES,2016.0,190,280,-90
NA,CN,2019.0,2,2,0
FR,IR,2019.0,40,56,-16
GB,TH,2016.0,81,34,47
IN,CA,2018.0,287,211,76
nan,IT,2018.0,104,108,-4
VE,CO,2014.0,70,31,39
FR,AT,2008.0,43,36,7
CN,DE,2018.0,369,376,-7
SE,US,2021.0,349,370,-21
ZA,DE,1997.0,11,14,-3
US,AT,2012.0,225,220,5
JP,MY,2022.0,21,31,-10
AR,IT,2015.0,106,116,-10
DE,AT,2012.0,505,533,-28
FR,ZA,1998.0,6,4,2
PL,nan,2018.0,20,14,6
US,CZ,2017.0,169,160,9
GB,CH,2008.0,228,217,11
BR,DE,2007.0,123,104,19
SE,RS,2009.0,3,3,0
PR,KR,2002.0,30,21,9
BR,AR,2005.0,72,51,21
FR,AU,2011.0,129,104,25
TW,JP,2011.0,73,74,-1
HR,CN,2011.0,4,2,2
FR,DE,2020.0,527,503,24
ES,UY,2015.0,62,43,19
BR,IT,2021.0,247,197,50
US,TH,2018.0,235,146,89
PK,CA,2010.0,17,25,-8
BR,CA,1998.0,35,46,-11
BR,MY,2018.0,21,72,-51
CZ,ID,2016.0,15,6,9
SG,IN,2009.0,45,51,-6
OM,GB,1997.0,4,5,-1
nan,CA,2015.0,149,39,110
SE,IN,2020.0,53,82,-29
IL,JP,2021.0,10,7,3
AR,MX,2021.0,128,119,9
AR,FR,2019.0,109,131,-22
SE,BE,2000.0,8,12,-4
BR,ST,2012.0,21,41,-20
US,SG,2017.0,539,551,-12
US,MY,2018.0,187,219,-32
HU,NL,2003.0,9,6,3
IT,BR,2013.0,267,194,73
RS,CO,2018.0,15,1,14
SE,BR,1999.0,9,5,4
NO,FI,2015.0,13,23,-10
US,SG,2010.0,344,251,93
US,PA,2018.0,51,86,-35
US,CO,1997.0,36,21,15
CA,ID,2010.0,9,4,5
MX,BR,2018.0,155,176,-21
BD,SE,2014.0,4,6,-2
CO,BR,2005.0,34,22,12
US,IE,2009.0,495,370,125
IN,SG,2016.0,147,139,8
BR,CH,2007.0,22,28,-6
AU,IT,2002.0,23,31,-8
US,KR,2023.0,51,67,-16
NL,IN,2000.0,12,21,-9
ES,BG,2008.0,4,9,-5
ZA,GB,2003.0,102,85,17
EG,GB,2015.0,61,108,-47
RU,nan,2004.0,31,29,2
TW,SA,2015.0,13,1,12
UA,DE,1999.0,29,13,16
DE,HR,2017.0,17,26,-9
TW,TR,2019.0,3,11,-8
PT,BR,1998.0,142,112,30
AR,FR,2017.0,105,86,19
PK,US,2022.0,328,221,107
DE,PK,2013.0,38,15,23
AU,ID,2014.0,74,35,39
RW,US,2020.0,19,24,-5
IT,ES,2007.0,169,108,61
FI,CH,2017.0,31,27,4
IN,IE,2005.0,5,3,2
CM,ID,2011.0,1,1,0
NL,IE,2021.0,26,31,-5
FR,ES,2009.0,250,208,42
SE,IT,2008.0,53,87,-34
IR,NL,2021.0,50,28,22
SA,JO,2016.0,40,46,-6
PL,DE,2012.0,113,123,-10
NL,IT,2016.0,90,136,-46
SG,DE,2017.0,38,38,0
BR,SE,2004.0,14,13,1
IN,NO,2008.0,23,12,11
CN,nan,2016.0,102,103,-1
CN,PK,2009.0,55,66,-11
CA,TN,2013.0,8,10,-2
SE,KR,2011.0,11,8,3
QA,EG,2012.0,18,13,5
ES,PS,2012.0,15,17,-2
nan,CN,2003.0,61,55,6
SG,CN,1999.0,52,99,-47
IE,AU,2004.0,43,58,-15
IT,EG,2018.0,17,8,9
MX,US,2007.0,284,295,-11
FI,GB,2021.0,65,71,-6
IR,JP,2008.0,17,28,-11
QA,SA,2018.0,14,28,-14
CA,AU,2021.0,312,345,-33
AE,US,2001.0,15,19,-4
NL,FR,2018.0,186,176,10
US,ET,2002.0,11,12,-1
IL,NL,2017.0,19,10,9
NO,AT,2016.0,13,12,1
AU,DE,2001.0,100,96,4
MY,JP,2020.0,46,51,-5
US,TN,2012.0,18,12,6
GB,IR,2018.0,101,120,-19
FR,PK,2017.0,16,16,0
ES,MY,2016.0,5,7,-2
IT,SE,2015.0,108,66,42
JP,SE,2002.0,30,46,-16
GB,DK,2016.0,129,143,-14
RU,NO,2005.0,5,9,-4
IN,BE,2021.0,46,29,17
SK,DE,2013.0,33,39,-6
SE,RW,2017.0,4,2,2
BE,VN,2016.0,15,4,11
AT,DE,2011.0,512,531,-19
FR,DK,2018.0,54,52,2
FR,PT,2001.0,26,16,10
CU,CL,2006.0,17,10,7
IN,CN,2018.0,265,133,132
JP,CO,2019.0,12,11,1
JP,CO,2010.0,9,7,2
PK,CA,2017.0,45,45,0
nan,ES,2011.0,19,31,-12
BE,GB,2014.0,162,141,21
NL,GR,2012.0,23,29,-6
CN,CZ,2004.0,28,42,-14
CR,BR,2017.0,15,16,-1
MY,IQ,2017.0,108,35,73
SE,CN,2020.0,128,126,2
CN,LT,2012.0,21,3,18
PT,BR,1997.0,95,71,24
SG,IT,2014.0,5,8,-3
CD,BE,2020.0,12,9,3
NL,JP,2020.0,30,38,-8
SK,CA,2015.0,4,6,-2
TN,SA,2013.0,38,10,28
CA,ID,2019.0,95,56,39
GB,CO,2004.0,13,16,-3
BD,GB,2021.0,43,45,-2
PL,CZ,2011.0,45,41,4
MY,IQ,2019.0,152,39,113
IN,NZ,2011.0,15,19,-4
SG,KR,2019.0,44,52,-8
LU,IT,2016.0,4,19,-15
CH,HU,2003.0,11,6,5
AU,CH,2017.0,88,86,2
UG,US,2004.0,8,6,2
JP,VN,2022.0,32,35,-3
CH,TW,2008.0,6,1,5
UA,FR,2019.0,22,17,5
MY,CA,2015.0,44,38,6
BY,RU,2021.0,65,84,-19
IT,CR,2006.0,2,1,1
GH,DE,2022.0,4,12,-8
NI,CO,2014.0,5,8,-3
ZA,NL,2014.0,43,67,-24
SE,IL,2017.0,10,9,1
CA,ID,2017.0,46,37,9
MY,BR,2018.0,72,21,51
VN,KR,2021.0,68,95,-27
NP,JP,2014.0,6,12,-6
QA,GB,2021.0,22,31,-9
GB,PL,2007.0,38,64,-26
GB,ZA,2003.0,85,102,-17
CZ,MX,2020.0,3,10,-7
CH,CZ,2012.0,16,22,-6
AT,IT,2012.0,43,49,-6
US,BO,2016.0,9,9,0
BO,US,2018.0,12,14,-2
BE,CO,2013.0,6,13,-7
AT,AU,2007.0,18,11,7
MX,VE,2010.0,34,47,-13
AU,NL,1999.0,21,28,-7
CA,BR,2022.0,109,261,-152
EC,ES,2009.0,17,20,-3
AO,BR,2016.0,31,15,16
ML,SN,2015.0,4,2,2
TW,NZ,2011.0,6,9,-3
MX,IN,2014.0,18,10,8
US,CZ,2010.0,145,119,26
DE,GR,2018.0,71,89,-18
FI,RU,2006.0,16,26,-10
LB,US,2005.0,27,34,-7
IL,NL,2019.0,25,20,5
ID,US,2014.0,100,128,-28
IT,AM,2010.0,15,22,-7
AU,BD,2021.0,61,58,3
KE,US,2018.0,101,90,11
ZA,CZ,2009.0,3,1,2
RO,BE,2015.0,10,14,-4
RS,US,2003.0,29,39,-10
SL,US,2015.0,1,8,-7
BE,LU,2006.0,9,7,2
KE,GB,2019.0,48,44,4
RO,PT,2018.0,1,2,-1
GR,BE,2015.0,30,17,13
GB,LV,2019.0,8,8,0
DE,HR,2019.0,20,31,-11
TN,CA,2022.0,4,4,0
KW,TR,2021.0,2,3,-1
IN,SA,2006.0,9,10,-1
KR,IN,2011.0,119,142,-23
KZ,RU,2018.0,76,93,-17
PH,IN,2009.0,12,9,3
TR,NL,2018.0,50,35,15
ES,AE,2019.0,8,3,5
TT,US,2022.0,10,7,3
CN,NP,2013.0,20,25,-5
ZM,US,2022.0,13,7,6
GB,NO,2012.0,87,59,28
US,UA,2006.0,29,48,-19
IN,BR,2017.0,43,37,6
AU,PK,2021.0,43,53,-10
CI,GN,2021.0,2,1,1
DE,TR,2011.0,57,62,-5
TW,ZA,2008.0,1,2,-1
CO,CR,2020.0,48,49,-1
ID,KR,2018.0,22,50,-28
PE,ID,2018.0,5,2,3
MX,HN,2019.0,19,28,-9
DE,MX,2015.0,41,44,-3
US,CU,2022.0,14,26,-12
CN,EG,2022.0,52,33,19
RU,AT,2009.0,25,8,17
IL,EG,2018.0,7,8,-1
CO,GB,2022.0,22,21,1
ES,PT,2001.0,52,51,1
DE,CL,2003.0,20,20,0
AT,MK,2021.0,27,4,23
RU,BE,2004.0,22,14,8
PK,NZ,2022.0,5,6,-1
CO,PT,2017.0,15,12,3
AT,RU,2016.0,8,23,-15
GB,IL,2006.0,35,44,-9
IR,HU,2020.0,13,2,11
AM,IT,2022.0,20,17,3
GH,JP,2021.0,6,2,4
EG,IN,2017.0,23,23,0
TW,TR,2017.0,6,2,4
NG,IQ,2019.0,9,7,2
TW,US,2007.0,593,740,-147
AU,CH,2010.0,58,75,-17
JP,MM,2011.0,6,2,4
CZ,US,2008.0,121,141,-20
TR,AT,2010.0,5,8,-3
DE,PS,2016.0,7,3,4
PS,FR,2021.0,2,3,-1
MX,GB,2013.0,54,57,-3
SE,GB,2000.0,67,69,-2
DZ,FR,2014.0,80,201,-121
EC,RU,2018.0,9,4,5
NL,FI,1999.0,16,7,9
KE,CO,2016.0,5,1,4
TR,nan,2018.0,34,27,7
NZ,NO,2021.0,7,2,5
SA,AE,2005.0,4,2,2
SE,PL,2021.0,14,25,-11
IT,MY,2006.0,29,32,-3
GB,CY,2018.0,52,35,17
TH,VN,2018.0,20,12,8
GB,FI,2006.0,39,42,-3
HU,CZ,2017.0,11,8,3
US,LB,2007.0,36,31,5
IT,UA,2016.0,34,35,-1
DK,QA,2017.0,2,1,1
MX,UA,2018.0,1,3,-2
IL,CA,2000.0,22,32,-10
UA,US,2012.0,32,41,-9
DE,NZ,2008.0,41,29,12
CM,FR,2008.0,12,11,1
VN,DE,2019.0,10,43,-33
RO,CH,2009.0,3,4,-1
ZA,AU,2011.0,54,40,14
VE,FR,2003.0,5,4,1
CN,BD,2018.0,40,77,-37
KR,FR,2004.0,20,15,5
LB,US,2002.0,14,22,-8
MD,FR,1999.0,47,45,2
nan,SG,2011.0,5,12,-7
PE,DE,2001.0,1,1,0
AT,HU,2007.0,20,16,4
SE,RU,2016.0,43,27,16
EG,US,2000.0,44,58,-14
TR,KZ,2007.0,28,24,4
CA,IR,2007.0,69,60,9
UA,IT,2014.0,17,40,-23
FI,BE,2010.0,16,5,11
ZW,NL,2018.0,2,2,0
PY,CU,2007.0,9,6,3
MW,US,2020.0,18,20,-2
RU,BR,2016.0,13,14,-1
NZ,CA,2005.0,39,38,1
AU,IT,2005.0,29,46,-17
UA,FR,2017.0,18,13,5
CA,BE,2018.0,59,80,-21
IN,SE,2008.0,27,13,14
EG,IN,2010.0,4,6,-2
DE,CO,2015.0,27,27,0
AL,US,2017.0,7,2,5
AL,US,2019.0,4,4,0
FI,BE,2019.0,21,14,7
SZ,ZA,2021.0,7,2,5
BW,US,2015.0,21,10,11
CU,US,2007.0,21,23,-2
NG,GB,2009.0,26,21,5
SE,NL,2015.0,42,77,-35
US,GE,2020.0,144,164,-20
KP,KR,2017.0,3,13,-10
GR,FR,2022.0,28,20,8
VE,CU,2020.0,16,13,3
CO,BD,2021.0,6,3,3
AE,SA,2011.0,10,6,4
PE,US,2013.0,66,90,-24
US,BG,2014.0,29,33,-4
FI,BE,2017.0,13,10,3
CN,IR,2015.0,34,48,-14
SE,CA,2008.0,32,50,-18
PK,CA,2019.0,40,65,-25
US,UY,2019.0,24,20,4
AU,NO,2022.0,18,9,9
GB,FJ,2018.0,3,1,2
UA,BR,2012.0,3,4,-1
CA,CI,2013.0,2,2,0
FR,AR,2011.0,135,47,88
BR,CU,2019.0,22,46,-24
MY,GB,2014.0,87,180,-93
IN,RO,2007.0,11,14,-3
JP,SE,2005.0,44,33,11
LB,GB,2019.0,20,12,8
IN,AE,2009.0,19,10,9
VE,PT,2021.0,3,1,2
BY,US,2008.0,10,3,7
PL,SE,2006.0,16,12,4
IN,DE,2002.0,88,77,11
US,LR,2017.0,6,5,1
CM,GB,2017.0,5,8,-3
ID,CL,2014.0,3,5,-2
RU,PL,1999.0,11,18,-7
GR,DK,2019.0,16,6,10
SE,NZ,2007.0,6,3,3
CN,AT,2006.0,13,11,2
TH,CA,2018.0,13,15,-2
DK,CR,2018.0,2,1,1
BD,NO,2011.0,1,1,0
CR,ES,2011.0,24,36,-12
BE,BR,2003.0,16,18,-2
CM,GB,2019.0,13,8,5
SG,KR,2010.0,33,32,1
SI,GB,2013.0,18,7,11
IL,RU,2001.0,15,26,-11
US,NP,2012.0,22,25,-3
DE,HR,2010.0,17,19,-2
JP,LK,1997.0,4,1,3
KE,GB,2017.0,40,36,4
AT,PT,2006.0,4,2,2
IT,AM,2019.0,19,29,-10
CN,NZ,2023.0,11,1,10
ET,AU,2016.0,14,2,12
CU,CO,1997.0,3,1,2
BR,AR,2002.0,37,38,-1
MX,PH,2021.0,8,6,2
NL,EC,2015.0,3,2,1
nan,MX,2006.0,11,14,-3
ID,FR,2001.0,2,2,0
FI,CH,2019.0,20,21,-1
US,CO,1998.0,41,33,8
BR,NL,2014.0,59,64,-5
ET,CA,2018.0,8,8,0
CA,PT,2022.0,13,8,5
KZ,CA,2007.0,2,1,1
MY,ID,2009.0,27,23,4
TW,DE,2001.0,15,15,0
VE,BR,2020.0,30,20,10
nan,KR,2009.0,15,20,-5
VN,TH,2018.0,12,20,-8
CZ,SI,2009.0,15,10,5
ES,GB,2023.0,18,19,-1
JO,DE,2021.0,8,8,0
ID,TH,2014.0,9,9,0
VN,AU,2008.0,8,8,0
HR,FR,2006.0,7,3,4
ZA,BE,2015.0,24,24,0
CA,RU,2021.0,30,31,-1
SA,KR,2015.0,4,10,-6
FR,HU,2000.0,15,12,3
KE,GB,2010.0,22,22,0
NL,HK,2022.0,17,7,10
UG,DE,2022.0,2,1,1
JP,CH,2004.0,46,43,3
EE,FI,2022.0,6,9,-3
CZ,MY,2021.0,11,10,1
FR,PF,2011.0,21,2,19
ZA,JP,2007.0,8,7,1
FI,SI,2019.0,4,3,1
IT,IR,2013.0,14,32,-18
VN,RU,2019.0,9,13,-4
EC,CA,2019.0,5,4,1
BE,MZ,2022.0,11,2,9
GB,PS,2019.0,11,6,5
AZ,RU,2016.0,10,13,-3
NZ,PK,2013.0,9,4,5
CR,BR,2019.0,17,15,2
RU,CH,2006.0,24,22,2
IN,JO,2019.0,4,3,1
GR,LU,2020.0,6,1,5
RU,IT,2015.0,20,43,-23
GB,TR,2001.0,51,25,26
NL,RU,2009.0,27,38,-11
IN,DE,2005.0,106,87,19
LK,ID,2018.0,13,7,6
UY,CL,2001.0,5,3,2
BR,CU,2010.0,14,18,-4
GB,PH,2022.0,12,8,4
TH,CH,2012.0,6,1,5
NL,UA,2018.0,4,3,1
IL,IN,2008.0,14,20,-6
PH,MX,2020.0,18,16,2
NI,AR,2003.0,1,1,0
BE,HR,2020.0,6,3,3
NG,SE,2020.0,5,4,1
AU,UA,2019.0,5,5,0
RU,EG,2002.0,1,1,0
CH,BE,2015.0,56,93,-37
US,KW,2018.0,32,23,9
NG,IQ,2017.0,2,6,-4
HK,JP,1997.0,4,4,0
BD,IE,2021.0,5,1,4
US,SK,2003.0,18,21,-3
FR,IR,2017.0,32,35,-3
IE,IN,2013.0,30,20,10
AU,TH,2003.0,14,10,4
AR,CA,2019.0,31,28,3
RU,HU,2013.0,8,7,1
CA,SA,2003.0,13,14,-1
CA,EG,2006.0,23,19,4
IR,CA,2005.0,50,53,-3
PL,PT,2012.0,4,3,1
SA,FR,2015.0,18,45,-27
CH,PK,2003.0,19,10,9
NL,EG,1998.0,2,6,-4
BG,ES,2007.0,4,6,-2
TR,MX,2009.0,1,1,0
DK,SK,2022.0,1,1,0
MX,VE,2019.0,24,67,-43
CZ,CH,2015.0,31,38,-7
KG,RU,2020.0,6,8,-2
NL,AT,2012.0,30,18,12
AT,KE,2014.0,4,1,3
IL,GB,2001.0,27,34,-7
AR,FR,2010.0,39,92,-53
IT,GB,2023.0,33,30,3
BE,IT,1999.0,35,52,-17
KZ,TR,2009.0,20,38,-18
BR,CA,1997.0,22,33,-11
CA,ZA,1998.0,5,11,-6
CH,CG,2016.0,2,1,1
GB,PE,2018.0,16,12,4
RO,VN,2014.0,8,4,4
SI,US,2003.0,8,10,-2
IT,IL,2011.0,17,9,8
US,MA,2015.0,31,24,7
GH,CG,2019.0,1,1,0
LY,GB,2007.0,1,4,-3
NG,US,2008.0,32,32,0
BR,NO,2001.0,4,13,-9
NG,DE,2004.0,5,3,2
EG,QA,2016.0,30,43,-13
US,ET,2005.0,14,18,-4
CN,RS,2003.0,8,4,4
CN,BG,2007.0,17,8,9
JP,HU,2009.0,13,4,9
GR,DK,2017.0,15,9,6
ES,SE,2007.0,33,41,-8
HU,IT,2008.0,21,5,16
NL,ZW,2006.0,2,1,1
EG,HU,2021.0,6,8,-2
LB,CA,2009.0,13,10,3
BG,BE,1999.0,5,1,4
AU,MY,1999.0,10,5,5
SG,DE,2019.0,43,34,9
PK,DE,2012.0,19,33,-14
TH,JP,2002.0,23,24,-1
BY,UA,2008.0,7,6,1
GR,DK,2010.0,12,5,7
GB,IQ,2012.0,20,8,12
RU,TJ,2011.0,19,16,3
IN,AR,2011.0,4,5,-1
AR,ES,2023.0,6,6,0
FR,IR,2010.0,36,20,16
IE,SG,2020.0,4,5,-1
BG,NO,2002.0,8,5,3
RU,AU,2006.0,12,8,4
CO,ES,2001.0,66,71,-5
SG,TW,2000.0,17,14,3
QA,PK,2018.0,7,11,-4
CN,ZA,2002.0,3,3,0
CZ,JP,2012.0,9,14,-5
DK,AT,2021.0,15,21,-6
TW,FI,2009.0,1,2,-1
KR,GB,2004.0,51,55,-4
FR,PK,2010.0,4,13,-9
GB,TW,2008.0,53,39,14
SG,CA,1999.0,11,20,-9
KR,CN,1997.0,12,24,-12
EG,AE,2004.0,8,9,-1
EG,FI,2012.0,3,2,1
AR,CU,2004.0,6,6,0
IT,NZ,2007.0,6,1,5
DK,EG,2008.0,2,2,0
IR,PL,2013.0,5,1,4
NL,MX,2006.0,5,7,-2
CU,CR,2001.0,3,1,2
HU,AT,2007.0,16,20,-4
CA,SG,2003.0,22,18,4
HK,CA,2018.0,4,6,-2
LB,GB,2010.0,8,10,-2
AR,JP,2020.0,3,1,2
SS,GB,2008.0,12,8,4
CO,GT,2020.0,6,6,0
UA,AT,2008.0,4,6,-2
VN,DE,2017.0,17,27,-10
ES,AE,2010.0,1,1,0
CH,TR,2011.0,11,12,-1
TH,BR,2022.0,3,1,2
TW,AR,2015.0,9,10,-1
BE,GR,2018.0,23,33,-10
RU,JP,2000.0,33,26,7
FR,MQ,2011.0,15,8,7
US,UY,2017.0,30,19,11
PT,CH,1998.0,1,2,-1
US,GT,2018.0,18,16,2
GW,NL,2005.0,1,2,-1
GB,BE,1998.0,31,41,-10
CL,SE,2009.0,6,7,-1
ZA,RO,2020.0,8,7,1
IN,PH,2016.0,17,25,-8
US,CI,2012.0,6,3,3
MY,ES,2019.0,6,5,1
PH,CN,2014.0,16,24,-8
MD,CN,2011.0,1,1,0
GB,MA,2012.0,11,4,7
DE,LI,2020.0,5,1,4
TZ,FR,2010.0,6,2,4
TN,US,2005.0,6,7,-1
JO,OM,2019.0,3,4,-1
BB,GB,2000.0,2,1,1
IT,MX,2021.0,21,22,-1
CN,KH,2016.0,3,1,2
MY,AE,2001.0,2,1,1
PH,GB,2009.0,15,8,7
US,LK,2009.0,25,16,9
QA,IQ,2018.0,10,2,8
MY,SE,2012.0,6,6,0
nan,TR,2005.0,5,2,3
SE,CL,2020.0,11,7,4
ZA,NZ,1998.0,4,3,1
CZ,NG,2021.0,9,2,7
TW,DK,2018.0,4,3,1
JP,nan,2021.0,12,27,-15
ES,EE,2018.0,2,2,0
SE,PK,2021.0,15,10,5
IN,LK,2011.0,11,7,4
LT,IN,2017.0,2,3,-1
EG,IN,2019.0,17,18,-1
SK,US,2022.0,10,12,-2
DZ,CN,2020.0,2,11,-9
AM,US,2009.0,16,7,9
AU,UA,2017.0,5,1,4
AL,US,2010.0,2,5,-3
JP,RS,2020.0,2,1,1
LU,DK,2005.0,1,1,0
MY,KR,2008.0,8,10,-2
NZ,CA,2002.0,33,23,10
GB,BE,1997.0,36,34,2
IL,SE,2005.0,1,3,-2
US,DZ,2016.0,59,31,28
CO,PT,2019.0,17,18,-1
PK,KE,2009.0,7,6,1
AR,CA,2010.0,12,16,-4
NL,CZ,2003.0,9,7,2
US,LR,2019.0,9,2,7
EE,FR,2016.0,10,2,8
IS,US,2018.0,12,22,-10
NZ,FR,2007.0,11,17,-6
DE,HU,2022.0,29,27,2
CA,AM,2019.0,1,1,0
BR,CU,2017.0,22,40,-18
MX,VE,2017.0,42,55,-13
NO,IT,2018.0,19,40,-21
CO,RO,2018.0,1,1,0
TW,TH,2020.0,19,14,5
SE,SA,2014.0,11,4,7
DE,SY,2009.0,5,1,4
TN,US,2002.0,3,2,1
BH,nan,2018.0,2,1,1
IL,NL,2010.0,15,9,6
BR,UY,2003.0,17,19,-2
DK,FR,2000.0,9,19,-10
AU,HU,1999.0,5,3,2
AT,SK,2018.0,12,19,-7
ZM,GH,2014.0,34,18,16
IT,CZ,2000.0,21,13,8
EG,DE,2002.0,15,17,-2
CA,DZ,2005.0,2,5,-3
TH,IN,2012.0,2,6,-4
PK,BR,2002.0,1,2,-1
CA,CZ,2021.0,6,7,-1
CA,FI,1998.0,7,12,-5
NZ,QA,2020.0,1,3,-2
FI,KE,2011.0,1,2,-1
HN,CO,2021.0,2,4,-2
GB,AZ,2020.0,2,3,-1
BG,CZ,2006.0,4,2,2
JP,LT,2016.0,4,7,-3
CA,VN,2020.0,23,8,15
BD,TH,2016.0,7,3,4
GB,MU,2001.0,2,1,1
CU,CO,1998.0,4,2,2
PL,BE,2003.0,12,15,-3
IT,JO,2011.0,1,2,-1
ZA,SE,2006.0,11,6,5
KE,ID,2010.0,6,1,5
CO,CU,2009.0,26,22,4
US,BA,2012.0,5,3,2
CN,NG,2013.0,6,5,1
ID,SG,2015.0,6,19,-13
TH,ZA,2008.0,1,3,-2
NL,GH,2012.0,1,3,-2
BW,IN,2010.0,3,3,0
PL,MZ,2001.0,5,17,-12
TZ,NL,2011.0,2,5,-3
MX,HN,2010.0,15,26,-11
DE,RO,1999.0,5,10,-5
SY,IQ,2013.0,1,1,0
CL,BE,2005.0,2,6,-4
KW,GB,2006.0,7,5,2
CN,AR,2018.0,1,5,-4
nan,TR,2002.0,3,4,-1
MY,SG,2009.0,34,63,-29
IT,KE,2013.0,2,2,0
PT,NL,2015.0,22,25,-3
IR,CA,2002.0,23,30,-7
NO,AU,2009.0,12,15,-3
CA,IN,2023.0,2,11,-9
AU,VN,2003.0,4,3,1
IE,PH,2016.0,3,2,1
TH,NL,2007.0,3,8,-5
AR,CH,2000.0,5,3,2
AR,CA,2017.0,23,24,-1
KR,CN,1998.0,24,25,-1
SG,KR,2017.0,36,44,-8
CU,BR,2000.0,7,2,5
CA,MY,2007.0,8,6,2
ZA,DE,1998.0,12,18,-6
NL,VN,2021.0,6,4,2
IR,LU,2020.0,3,4,-1
TR,BR,2006.0,10,43,-33
CH,UY,2018.0,4,1,3
BR,KR,2021.0,10,3,7
BR,SA,2015.0,7,1,6
SE,IL,2019.0,5,14,-9
AT,IR,2007.0,5,2,3
RO,US,2005.0,35,37,-2
BJ,FR,2000.0,3,6,-3
IT,AM,2017.0,16,29,-13
HR,BE,2005.0,1,1,0
BY,IL,2013.0,1,1,0
IL,SE,2002.0,4,2,2
UA,NZ,2017.0,2,1,1
GB,CR,2012.0,4,3,1
FR,UA,2003.0,8,13,-5
BF,GB,2021.0,1,3,-2
PT,FR,2002.0,17,26,-9
GB,PS,2010.0,4,2,2
DK,nan,2012.0,18,13,5
DO,ES,2004.0,1,1,0
KE,MW,2015.0,1,1,0
CA,FI,1997.0,8,5,3
BJ,GH,2018.0,2,2,0
KR,CH,1999.0,4,1,3
ES,SN,2019.0,1,2,-1
BO,CL,2015.0,5,6,-1
DK,BE,2013.0,18,52,-34
PE,CU,2022.0,6,4,2
SK,RO,2002.0,1,3,-2
UZ,RU,2015.0,23,10,13
SG,FR,2009.0,13,26,-13
HU,EG,2015.0,3,1,2
IN,RW,2009.0,7,2,5
CA,CO,2000.0,3,6,-3
SE,BO,2015.0,2,1,1
LB,GB,2017.0,12,11,1
IQ,IL,2020.0,1,1,0
ZA,NZ,1997.0,4,3,1
PR,US,2004.0,6,1,5
BR,HU,2020.0,8,6,2
IR,AE,2020.0,10,9,1
CZ,HU,2016.0,9,5,4
HN,CL,2020.0,3,1,2
CI,ML,2020.0,8,2,6
PK,TH,2021.0,3,6,-3
CH,LU,2020.0,5,9,-4
ZA,UA,2022.0,2,1,1
TW,RU,2021.0,4,7,-3
VN,RU,2017.0,1,6,-5
FI,CH,2010.0,22,14,8
CH,FI,1998.0,6,4,2
JP,PL,2006.0,16,10,6
SK,SE,2008.0,3,6,-3
IT,SI,2015.0,11,9,2
nan,AT,2003.0,8,8,0
DK,IL,1997.0,3,3,0
FR,KE,2012.0,12,9,3
UA,BY,1997.0,1,1,0
CA,HU,2015.0,10,12,-2
ET,UG,2015.0,3,1,2
ZA,TZ,2016.0,18,2,16
MX,NO,2013.0,4,3,1
GB,JM,2022.0,2,4,-2
GB,VN,2014.0,15,13,2
RO,BD,2018.0,2,3,-1
CO,PT,2010.0,10,7,3
GB,RS,2016.0,21,22,-1
MY,RO,2017.0,2,2,0
JP,BF,2020.0,1,1,0
ML,DE,2014.0,4,1,3
KE,ID,2019.0,12,2,10
CO,CA,2009.0,10,10,0
DE,CM,2007.0,3,4,-1
OM,LK,2015.0,2,1,1
SE,TH,2013.0,7,1,6
UZ,AZ,2020.0,1,7,-6
NP,CA,2013.0,5,1,4
NP,NO,2022.0,4,1,3
SE,GE,1999.0,1,2,-1
NO,KE,2017.0,1,4,-3
DE,OM,2016.0,6,1,5
IT,PK,2014.0,12,14,-2
SK,JP,2020.0,2,2,0
UA,ES,2004.0,2,2,0
FR,PK,2019.0,19,15,4
SG,VN,2013.0,9,5,4
UY,AR,2006.0,14,14,0
US,HN,2004.0,3,2,1
LV,JP,2018.0,2,4,-2
OM,US,2003.0,8,6,2
RS,RU,2022.0,14,2,12
DK,TH,2008.0,1,3,-2
CY,RU,2015.0,2,1,1
IT,VE,2015.0,4,5,-1
SD,NG,2012.0,1,2,-1
IN,IQ,2015.0,9,6,3
FR,ID,2008.0,9,6,3
AU,BA,2018.0,2,2,0
PL,AZ,1999.0,3,1,2
ZA,RU,1999.0,2,3,-1
JP,PE,2016.0,2,1,1
TR,AT,2017.0,10,12,-2
NL,UG,2016.0,7,2,5
SA,AU,2011.0,7,22,-15
SE,LV,2020.0,4,2,2
IN,JO,2017.0,4,3,1
AT,LU,2019.0,3,1,2
MY,JO,2006.0,5,1,4
GE,nan,2011.0,4,8,-4
DZ,IT,2009.0,8,14,-6
GE,PL,2005.0,1,1,0
TR,AT,2019.0,7,18,-11
GB,MW,2005.0,5,10,-5
AR,IL,2012.0,4,3,1
ET,FR,2006.0,2,4,-2
DK,RS,2013.0,2,2,0
MX,RU,2016.0,7,10,-3
AT,LU,2017.0,4,8,-4
SG,NO,2001.0,2,1,1
PH,CH,2016.0,5,1,4
UG,NL,1998.0,1,1,0
EG,SE,2001.0,2,1,1
RS,CA,2015.0,4,25,-21
CO,BR,2002.0,21,21,0
AE,DE,2012.0,7,9,-2
CL,NZ,2006.0,2,2,0
AT,JP,2013.0,15,26,-11
TW,AU,2023.0,1,2,-1
KR,DK,2021.0,6,5,1
PG,ZA,2012.0,1,1,0
CL,PA,2014.0,6,5,1
BG,GB,2004.0,7,5,2
TW,NO,2016.0,1,4,-3
FI,CL,2013.0,10,2,8
PY,ES,2013.0,1,8,-7
US,BN,2018.0,6,3,3
IS,DK,2004.0,4,5,-1
AO,US,2008.0,1,1,0
AT,nan,2018.0,6,17,-11
GB,GE,2000.0,2,5,-3
IL,BE,2016.0,4,7,-3
PK,HU,2017.0,2,1,1
IR,nan,2003.0,4,1,3
MX,HN,2017.0,12,30,-18
SS,DE,2013.0,1,1,0
AT,ZA,2012.0,5,2,3
MX,RS,2016.0,5,3,2
BJ,US,2010.0,2,1,1
ZA,ES,2000.0,2,2,0
BW,GB,2009.0,4,3,1
CY,IR,2018.0,10,8,2
SE,CZ,2000.0,3,5,-2
CU,GB,2014.0,5,7,-2
IR,IN,2006.0,5,9,-4
BE,EG,2006.0,1,2,-1
QA,IT,2014.0,1,1,0
CR,MX,2022.0,17,10,7
HK,NL,2003.0,3,7,-4
HK,RO,2012.0,9,15,-6
UA,MY,2013.0,2,1,1
SE,TW,2015.0,4,5,-1
ES,ET,2018.0,3,2,1
CZ,IR,2008.0,2,2,0
OM,PK,2008.0,1,1,0
PK,HU,2019.0,2,4,-2
US,VG,2022.0,2,2,0
IR,SA,2014.0,6,5,1
BJ,US,2019.0,4,5,-1
JP,UA,2003.0,4,9,-5
SG,IQ,2021.0,5,3,2
CL,nan,2018.0,8,7,1
VN,NZ,2015.0,2,1,1
CO,ID,2018.0,7,2,5
UA,CN,2003.0,7,10,-3
LK,DE,2018.0,2,5,-3
ES,BY,2015.0,1,1,0
NO,CL,2008.0,3,1,2
IR,QA,2013.0,3,2,1
BG,IT,2001.0,7,2,5
RU,KR,2013.0,10,12,-2
HU,CZ,2010.0,6,8,-2
GB,MW,2002.0,7,6,1
MX,BE,2013.0,7,9,-2
FI,SA,2017.0,2,2,0
US,JM,2013.0,19,11,8
EC,AT,2020.0,1,1,0
HU,SK,2009.0,9,3,6
GA,DE,2011.0,8,2,6
RU,IE,2012.0,9,5,4
GE,CN,2012.0,5,2,3
PE,nan,2022.0,4,4,0
CN,UZ,2022.0,10,8,2
SE,QA,2002.0,1,3,-2
FR,BF,2021.0,20,16,4
PA,CA,2022.0,1,3,-2
TR,KH,2018.0,2,1,1
UY,IT,2006.0,1,7,-6
SE,IL,2010.0,4,3,1
ES,RU,2015.0,18,17,1
RS,SE,2007.0,3,2,1
CZ,TR,2015.0,7,10,-3
US,LU,2000.0,2,5,-3
US,BY,2012.0,9,7,2
US,SV,2015.0,5,4,1
AT,TH,2013.0,4,5,-1
UY,CH,2022.0,3,1,2
FI,nan,1998.0,3,4,-1
IN,TH,2004.0,2,5,-3
UA,NL,2003.0,6,2,4
MY,FI,2015.0,4,4,0
BR,RU,2013.0,13,15,-2
LK,US,2000.0,6,5,1
PL,RO,2006.0,3,2,1
TZ,GB,2003.0,3,3,0
nan,ZA,2000.0,5,4,1
US,PG,2008.0,1,2,-1
ML,GB,2019.0,1,1,0
GB,KH,2008.0,3,1,2
KZ,US,2006.0,7,8,-1
CH,ZW,2016.0,1,2,-1
IN,EE,2011.0,2,1,1
MA,GB,2016.0,6,8,-2
IS,TR,2016.0,2,2,0
CY,CA,2022.0,1,2,-1
AT,TW,2018.0,2,2,0
AR,HN,2011.0,3,1,2
AR,AU,2001.0,3,2,1
IT,CY,2013.0,1,2,-1
CA,EE,2009.0,2,2,0
QA,AU,2013.0,8,6,2
nan,EG,2006.0,2,3,-1
TW,BE,1998.0,1,2,-1
AU,EC,2012.0,1,2,-1
PL,DK,2004.0,4,4,0
US,CM,2003.0,3,2,1
AF,BR,2015.0,3,2,1
ES,KR,2005.0,4,2,2
AR,CO,1998.0,5,9,-4
AU,GR,2016.0,4,13,-9
IN,GE,2007.0,1,1,0
IR,IT,2000.0,2,2,0
CN,MX,2014.0,10,8,2
GT,US,2021.0,5,12,-7
NO,NP,2018.0,5,2,3
IN,IE,2002.0,3,5,-2
AR,MY,2004.0,2,2,0
KR,CO,2010.0,5,9,-4
DE,KW,2000.0,1,2,-1
PH,FR,2008.0,3,3,0
IN,BD,2004.0,5,5,0
PE,JP,2008.0,2,1,1
NP,NL,2022.0,2,2,0
DK,IL,1998.0,1,2,-1
BR,PY,2007.0,1,2,-1
UY,AU,2022.0,3,1,2
HR,NO,2002.0,3,4,-1
PL,RS,2005.0,3,2,1
TH,NP,2012.0,6,2,4
NL,EG,1997.0,5,3,2
FI,IT,2014.0,17,19,-2
CN,CU,2011.0,2,1,1
FR,BZ,2009.0,1,7,-6
AO,ES,2018.0,2,2,0
ES,AE,2017.0,3,5,-2
HU,CA,2004.0,12,10,2
IS,GB,2007.0,4,9,-5
NZ,NP,2003.0,1,6,-5
TZ,NO,2009.0,5,4,1
CL,UY,1998.0,2,3,-1
GB,SD,2020.0,7,8,-1
IL,IT,2004.0,8,7,1
MY,AR,2020.0,2,1,1
SG,RU,2013.0,4,3,1
GD,CA,2013.0,2,2,0
BR,BG,2013.0,2,3,-1
SI,FR,2002.0,4,2,2
BD,NL,2012.0,4,3,1
AF,US,2018.0,4,3,1
NL,LU,2006.0,3,1,2
KH,JP,2018.0,2,8,-6
EC,CA,2017.0,5,9,-4
GP,CA,2016.0,1,1,0
PS,IQ,2021.0,2,4,-2
IN,CM,2020.0,5,3,2
GR,CZ,2004.0,2,2,0
MY,IQ,2010.0,3,3,0
CA,ZA,1997.0,5,10,-5
HR,JP,2011.0,3,3,0
MA,MD,2009.0,1,4,-3
RS,GB,2001.0,6,4,2
DZ,TR,2017.0,1,3,-2
nan,IR,2003.0,1,4,-3
DE,AM,1999.0,3,4,-1
CH,MD,2003.0,1,1,0
NL,NP,2002.0,2,2,0
SD,EG,2004.0,4,2,2
BH,IN,2015.0,3,6,-3
PT,RS,2018.0,3,2,1
CA,BG,2012.0,1,7,-6
IR,SY,2019.0,3,2,1
KR,ZA,2022.0,1,3,-2
BG,NO,2005.0,3,4,-1
IL,AR,2007.0,3,1,2
PY,US,2006.0,2,1,1
AR,SE,1999.0,4,2,2
FR,SY,2021.0,3,4,-1
FI,nan,1997.0,2,4,-2
NZ,KH,2016.0,1,1,0
IN,MU,2018.0,1,5,-4
GH,NG,2005.0,1,2,-1
AU,LK,2007.0,5,1,4
NZ,DK,2006.0,4,3,1
PT,AT,2022.0,7,4,3
CN,JO,2008.0,2,2,0
TZ,ZW,2012.0,2,1,1
DZ,MX,2014.0,2,3,-1
RU,DK,2004.0,6,6,0
PE,CZ,2019.0,2,2,0
AE,MY,2014.0,3,13,-10
GE,CA,2008.0,3,2,1
SE,RW,2019.0,2,3,-1
AR,BE,2014.0,8,16,-8
NO,BA,2019.0,1,1,0
CA,GH,2004.0,2,2,0
TR,PK,2023.0,2,3,-1
ES,RS,2018.0,3,5,-2
CU,PA,2006.0,2,1,1
CH,HR,1997.0,1,1,0
RW,BE,2018.0,2,3,-1
MW,GH,2017.0,1,2,-1
BH,ET,2015.0,5,12,-7
US,TJ,2018.0,1,2,-1
UY,PG,2018.0,1,1,0
IN,PE,2022.0,2,1,1
TN,LB,2015.0,2,3,-1
SK,IL,2011.0,2,1,1
BO,SE,2016.0,1,1,0
QA,SK,2014.0,2,2,0
MK,ID,2013.0,1,3,-2
GB,LV,2017.0,3,4,-1
GH,IN,2016.0,7,4,3
IL,BG,2000.0,3,2,1
CF,FR,2011.0,3,3,0
CW,NL,2001.0,5,7,-2
JO,OM,2017.0,2,5,-3
DK,GH,2016.0,3,1,2
RO,SK,2020.0,2,4,-2
NI,PE,2016.0,2,2,0
US,PS,1999.0,2,3,-1
MT,US,2012.0,3,3,0
NO,KE,2019.0,4,1,3
UY,GB,1999.0,1,3,-2
GH,ET,2007.0,1,1,0
IR,FI,2006.0,2,3,-1
HU,IL,2007.0,2,6,-4
CN,VG,2018.0,1,1,0
CR,SE,2007.0,2,2,0
VE,DE,2022.0,2,2,0
AU,CU,2020.0,2,1,1
RO,AT,2002.0,1,1,0
DZ,TR,2019.0,2,4,-2
UA,BG,2012.0,5,1,4
BW,IN,2019.0,4,3,1
VN,BE,2008.0,2,5,-3
KR,IR,2012.0,6,6,0
GH,GB,2000.0,2,3,-1
CY,FR,2019.0,2,8,-6
FJ,VN,2021.0,1,1,0
NP,FI,2013.0,2,1,1
SG,nan,2005.0,9,5,4
MA,BI,2010.0,1,1,0
PT,CH,1997.0,2,4,-2
SI,CH,2013.0,6,2,4
PK,LK,2022.0,1,2,-1
CM,UG,2019.0,1,1,0
MN,GB,2016.0,1,4,-3
ID,DE,2006.0,3,4,-1
BG,CH,2008.0,3,3,0
TZ,SE,2009.0,2,2,0
CM,IT,2010.0,1,8,-7
GB,AE,2003.0,5,5,0
NL,AR,2007.0,2,4,-2
CR,BR,2010.0,7,11,-4
TR,UA,1997.0,2,1,1
US,KY,2018.0,1,1,0
PT,EC,2016.0,11,3,8
BE,CW,2009.0,3,2,1
TW,IE,2017.0,2,1,1
GB,LV,2010.0,2,2,0
GB,BD,2023.0,2,5,-3
ML,NL,2019.0,1,1,0
US,BM,2015.0,2,2,0
KR,CL,2021.0,2,2,0
VN,IR,2019.0,2,13,-11
UA,OM,2014.0,1,1,0
ES,AT,2003.0,5,11,-6
JP,AM,2014.0,4,2,2
US,BS,2014.0,4,4,0
TR,UA,1998.0,1,1,0
PL,UZ,2005.0,2,7,-5
nan,PE,2003.0,4,2,2
CO,NO,2020.0,2,4,-2
RU,SI,2016.0,4,5,-1
ID,PS,2022.0,1,2,-1
PL,MT,2019.0,1,1,0
NP,TH,2020.0,7,4,3
PF,FR,2011.0,2,21,-19
BR,SK,2012.0,1,2,-1
NL,CO,2022.0,5,9,-4
RU,NO,2002.0,5,2,3
CD,FR,2011.0,1,1,0
GB,NC,2014.0,1,2,-1
IR,SY,2017.0,1,4,-3
KZ,UA,2012.0,4,1,3
BR,MT,2011.0,2,2,0
AU,OM,2011.0,3,1,2
DZ,IN,2021.0,1,3,-2
BR,MZ,2000.0,2,2,0
MA,BI,2019.0,1,1,0
GR,MT,2018.0,1,2,-1
SG,ID,2022.0,8,12,-4
KH,AU,2020.0,2,8,-6
NL,SR,2020.0,3,3,0
BH,KE,2020.0,2,1,1
GB,EE,2007.0,3,5,-2
PK,NO,2001.0,5,1,4
BN,US,2023.0,1,1,0
HT,US,2016.0,3,3,0
MX,AU,2004.0,6,4,2
AU,CZ,2001.0,2,3,-1
PT,BE,2004.0,3,8,-5
BR,BO,2022.0,3,5,-2
PK,YE,2022.0,2,1,1
MM,KR,2020.0,2,3,-1
BE,XK,2014.0,1,1,0
ID,PH,2022.0,2,3,-1
BG,nan,1999.0,2,2,0
BY,CN,2022.0,2,1,1
SG,PH,2000.0,2,1,1
MA,PK,2007.0,3,6,-3
BE,NO,2003.0,5,2,3
AM,IR,2011.0,1,3,-2
UZ,NG,2020.0,1,3,-2
GB,AM,2019.0,2,1,1
KE,ID,2017.0,5,5,0
HR,HU,2020.0,3,2,1
BD,GR,2007.0,1,1,0
SE,GH,2022.0,1,1,0
RO,MX,2018.0,2,1,1
IE,KR,2023.0,1,1,0
IN,VN,2008.0,1,1,0
FR,JO,2004.0,2,1,1
PL,BA,2006.0,2,2,0
CA,BB,2014.0,1,1,0
YE,US,2013.0,1,4,-3
KE,RW,2014.0,2,1,1
KW,CA,2004.0,3,5,-2
PL,IR,2015.0,4,5,-1
GB,UY,2009.0,4,4,0
BR,LU,2009.0,1,1,0
NZ,CO,2015.0,2,2,0
IT,IQ,2018.0,1,1,0
VN,SE,2011.0,1,2,-1
nan,CO,2007.0,4,2,2
CL,IN,2007.0,1,3,-2
PT,NZ,2015.0,3,2,1
ES,LK,2018.0,3,2,1
IL,GR,2006.0,2,2,0
AR,PY,2008.0,1,1,0
DE,BD,2004.0,4,2,2
NL,HR,2022.0,4,6,-2
ID,TN,2018.0,2,8,-6
JM,GP,2010.0,2,1,1
BE,BG,1997.0,8,3,5
RU,ZA,1999.0,3,2,1
ET,SE,2006.0,2,3,-1
ID,EG,2007.0,2,1,1
IT,RS,2022.0,4,5,-1
AE,FR,2022.0,4,10,-6
BG,FR,2016.0,1,6,-5
TZ,ZA,2003.0,1,1,0
AE,SD,2011.0,2,1,1
LY,JP,2009.0,2,3,-1
YE,IN,2021.0,3,8,-5
NO,IL,2000.0,1,2,-1
NG,KW,2011.0,1,1,0
EC,PT,2014.0,2,4,-2
TR,AU,2022.0,8,9,-1
HU,FI,2013.0,4,6,-2
GR,PH,2010.0,1,1,0
SI,MX,2015.0,6,8,-2
CA,GD,2013.0,2,2,0
IN,UA,2004.0,2,1,1
CN,ET,2014.0,1,5,-4
LB,TW,2014.0,3,1,2
CA,JO,2008.0,5,9,-4
FI,SI,2010.0,1,1,0
CD,IT,2020.0,1,1,0
GR,PL,2009.0,6,6,0
US,CW,2019.0,2,2,0
VN,BR,2019.0,1,1,0
MY,ES,2010.0,1,2,-1
NO,TZ,2021.0,2,2,0
BW,IN,2017.0,2,2,0
SY,JO,2015.0,1,2,-1
DK,QA,2019.0,1,1,0
BR,NZ,2000.0,1,2,-1
RU,EC,2000.0,1,2,-1
RS,BE,2007.0,3,1,2
HR,RU,2022.0,3,8,-5
TN,KW,2018.0,2,1,1
NO,KE,2010.0,1,1,0
SI,SG,2017.0,2,1,1
DK,UA,2014.0,1,3,-2
FR,EG,1999.0,1,7,-6
FI,SI,2017.0,2,2,0
PA,CN,2013.0,1,1,0
IL,FI,2013.0,3,1,2
FJ,IN,2021.0,3,2,1
CM,ES,2020.0,1,3,-2
CM,IT,2017.0,4,5,-1
JP,HR,2009.0,3,1,2
SK,RS,2006.0,2,7,-5
CR,GT,2019.0,3,3,0
PL,LU,2022.0,2,2,0
PT,AU,2023.0,2,4,-2
IN,NG,2009.0,2,5,-3
HK,JP,1998.0,4,11,-7
CY,FR,2010.0,1,2,-1
NL,ET,2011.0,1,3,-2
CN,ZA,2005.0,2,6,-4
LK,IN,1998.0,2,1,1
OM,GB,1998.0,1,6,-5
CM,IT,2019.0,2,4,-2
GB,PS,2017.0,2,2,0
IT,UZ,2007.0,2,2,0
MA,SN,2016.0,1,2,-1
IL,NZ,2009.0,3,1,2
AE,BD,2013.0,2,2,0
MY,HU,2016.0,1,1,0
SC,AU,2014.0,1,1,0
BG,MK,2014.0,1,2,-1
TJ,US,2021.0,2,1,1
CA,NP,2007.0,2,1,1
GR,BG,2004.0,2,2,0
ER,IN,2005.0,1,2,-1
KZ,DE,2011.0,2,2,0
VE,DK,2009.0,1,1,0
TW,PT,2014.0,1,1,0
SE,CR,2015.0,1,4,-3
CZ,SA,2015.0,4,2,2
US,EC,2000.0,1,2,-1
FR,AO,2007.0,1,2,-1
ZA,TR,2012.0,2,1,1
LT,RU,2022.0,1,2,-1
TN,RU,2015.0,1,5,-4
RU,PH,2016.0,3,1,2
GT,MX,2002.0,2,2,0
BE,PH,1997.0,2,2,0
MA,PS,2018.0,1,1,0
NG,HU,2023.0,1,2,-1
TH,DK,2019.0,1,1,0
NG,nan,2012.0,1,7,-6
BE,LT,2017.0,1,3,-2
PA,FR,2019.0,1,4,-3
UA,FI,2021.0,3,3,0
KG,UZ,2022.0,3,1,2
VN,MX,2022.0,4,7,-3
MY,ES,2017.0,3,2,1
JP,CU,2020.0,2,1,1
CR,ZA,2016.0,4,4,0
IN,MM,2018.0,1,1,0
DK,SJ,2014.0,1,1,0
US,DE,2000.0,1521,1668,-147
IT,AR,2016.0,116,95,21
GB,CA,2015.0,903,947,-44
GB,AR,2011.0,26,19,7
FR,JP,2006.0,115,97,18
HU,CH,2011.0,10,18,-8
IT,QA,2022.0,5,2,3
US,SE,2007.0,392,331,61
BD,AU,2013.0,47,23,24
US,PK,2012.0,185,173,12
US,PL,2007.0,169,201,-32
ID,CZ,2018.0,10,10,0
CN,DK,2015.0,43,37,6
SE,FI,2011.0,82,71,11
NZ,TW,2003.0,3,1,2
JP,EG,2018.0,68,36,32
MY,IR,2015.0,187,107,80
CN,HK,2012.0,123,77,46
IT,CH,2001.0,127,87,40
JO,SA,2012.0,35,13,22
ZA,UG,2014.0,16,14,2
TW,SG,2004.0,29,24,5
PL,CN,2018.0,28,26,2
US,IQ,2020.0,116,70,46
RO,US,2002.0,50,24,26
ID,ES,2016.0,13,18,-5
JP,CO,2017.0,6,20,-14
CA,IT,2023.0,15,7,8
US,GR,2003.0,141,106,35
VN,FR,2013.0,23,41,-18
CL,US,2001.0,72,80,-8
RO,FR,2008.0,27,35,-8
IN,BR,2019.0,41,42,-1
PR,KR,2005.0,21,19,2
DE,SK,2009.0,30,32,-2
SE,IR,2014.0,38,50,-12
JP,HK,2009.0,4,4,0
ES,PH,2014.0,18,12,6
KR,CZ,2021.0,8,4,4
NZ,GB,2000.0,113,102,11
AT,FI,2020.0,9,12,-3
SE,RO,2019.0,5,7,-2
TH,JP,2005.0,23,69,-46
IS,FR,2020.0,5,6,-1
CI,FR,2015.0,13,33,-20
BE,LT,2019.0,1,1,0
SG,DE,2010.0,33,37,-4
ID,BE,2021.0,13,13,0
MD,RU,2018.0,10,5,5
VN,DE,2010.0,10,9,1
FR,BR,2003.0,96,70,26
GR,CH,2015.0,48,24,24
RS,PL,2020.0,9,3,6
CH,ES,2009.0,68,58,10
JP,LK,1998.0,11,7,4
MX,VN,2015.0,10,4,6
MX,DE,2000.0,13,16,-3
BR,ZA,2007.0,5,11,-6
SE,RO,2010.0,7,4,3
FR,VG,2007.0,5,2,3
CH,CO,2004.0,2,1,1
IN,BR,2010.0,12,29,-17
PH,GH,2021.0,1,32,-31
PE,CA,2016.0,3,6,-3
NL,SK,2020.0,1,7,-6
JM,GP,2019.0,2,5,-3
FR,ZA,1997.0,7,5,2
CO,AU,2011.0,16,7,9
TW,NL,2016.0,8,3,5
IT,CO,2005.0,3,2,1
AT,LU,2010.0,3,1,2
BF,FR,2022.0,12,12,0
UA,FR,2010.0,20,10,10
TW,TR,2010.0,5,12,-7
IE,PL,2014.0,9,4,5
SK,TR,2007.0,2,1,1
CA,DZ,2002.0,5,6,-1
PT,FI,2014.0,7,6,1
SE,QA,2005.0,5,6,-1
IR,PK,2006.0,3,1,2
CG,FR,2018.0,20,17,3
CO,AR,2004.0,17,24,-7
BR,SI,2017.0,1,1,0
PL,AU,2000.0,5,9,-4
CA,KE,2011.0,5,4,1
IT,AE,2022.0,8,6,2
BR,HN,2020.0,2,1,1
KW,PS,2014.0,1,2,-1
FI,HU,2004.0,6,6,0
DK,IT,2006.0,13,19,-6
CZ,CL,2008.0,2,1,1
JO,SY,2022.0,2,1,1
PK,UG,2015.0,1,2,-1
KR,TW,2020.0,51,53,-2
HU,CZ,2019.0,13,8,5
PT,JP,2003.0,4,2,2
SE,RO,2017.0,6,16,-10
KR,MM,2019.0,3,2,1
NZ,IE,2018.0,22,23,-1
FJ,US,2008.0,3,2,1
KE,CA,2003.0,2,3,-1
QA,BE,2017.0,1,1,0
CO,UY,2020.0,15,14,1
RO,PL,2000.0,1,2,-1
CY,FR,2017.0,3,5,-2
ID,CA,2007.0,3,5,-2
BE,CR,2017.0,1,1,0
GA,NG,2016.0,1,1,0
EG,BE,2012.0,2,5,-3
PH,TH,2016.0,7,2,5
PS,SA,2020.0,9,10,-1
CZ,LT,2014.0,2,1,1
EG,IL,2020.0,6,2,4
US,LA,2012.0,2,1,1
SK,MK,2020.0,1,1,0
BE,UA,2020.0,2,5,-3
EG,TW,2014.0,6,16,-10
HR,IT,2009.0,5,4,1
CH,MX,2001.0,5,2,3
SY,LB,2011.0,1,1,0
CH,FI,1997.0,8,1,7
SI,FR,2005.0,8,4,4
BE,GH,2021.0,1,2,-1
KR,CO,2017.0,2,2,0
ES,nan,2002.0,5,10,-5
OM,JO,2014.0,1,7,-6
PT,PK,2021.0,1,1,0
KR,NZ,2013.0,4,5,-1
IL,TR,1997.0,1,1,0
NO,RS,2016.0,2,1,1
JP,CM,2012.0,3,1,2
BE,PF,2019.0,1,3,-2
CZ,GB,2023.0,2,1,1
MY,RO,2019.0,1,2,-1
PK,VN,2014.0,2,1,1
RO,FI,2006.0,1,2,-1
US,MD,2012.0,2,7,-5
CH,HR,1998.0,2,2,0
IR,TW,2006.0,1,1,0
SA,nan,2011.0,1,2,-1
PL,UZ,2002.0,3,1,2
SN,JP,1997.0,1,1,0
EC,DO,2020.0,1,2,-1
NL,CU,2018.0,2,1,1
HK,GB,2007.0,1,4,-3
PH,QA,2020.0,1,1,0
HU,ET,2021.0,2,2,0
EE,US,1999.0,3,10,-7
SE,SJ,2018.0,1,1,0
KP,KR,2019.0,2,18,-16
CH,CA,2006.0,82,72,10
PK,GB,2009.0,77,65,12
US,NG,2018.0,151,116,35
IE,DE,2007.0,59,72,-13
PT,FR,2005.0,26,33,-7
KE,PK,2014.0,14,25,-11
IL,BR,2007.0,6,3,3
BD,CN,1999.0,1,1,0
SE,AR,2022.0,2,6,-4
ID,CH,2016.0,6,7,-1
CH,RO,2005.0,2,8,-6
FR,CO,2021.0,23,42,-19
AT,,2013.0,1323,0,1323
DE,,1999.0,4055,0,4055
TR,,2025.0,3739,0,3739
,KR,2010.0,6124,0,6124
IR,,2018.0,6817,0,6817
,RU,2012.0,11238,0,11238
,GB,2015.0,16132,0,16132
SE,,2013.0,1802,0,1802
PK,,2018.0,757,0,757
,CH,2013.0,4092,0,4092
PT,,2012.0,435,0,435
HR,,2023.0,4064,0,4064
HU,,2021.0,1846,0,1846
,TR,2007.0,5431,0,5431
BR,,2000.0,521,0,521
CU,JP,2016.0,5,0,5
PS,,2009.0,12,0,12
,BE,1999.0,2382,0,2382
,KR,2019.0,2775,0,2775
ZA,,2016.0,1490,0,1490
UY,,2010.0,50,0,50
,MX,2009.0,4675,0,4675
nan,,2013.0,622,0,622
,PT,2006.0,1564,0,1564
UY,,2017.0,162,0,162
NZ,,2016.0,825,0,825
,KR,2017.0,4468,0,4468
AU,,2004.0,1478,0,1478
,MY,1995.0,521,0,521
,AE,2013.0,456,0,456
,ST,2002.0,25,0,25
PH,BR,2002.0,1,0,1
,BG,2014.0,632,0,632
,PA,2008.0,71,0,71
,TZ,2002.0,105,0,105
,GE,2008.0,146,0,146
,CD,2011.0,116,0,116
,KW,2006.0,143,0,143
,LB,2012.0,424,0,424
,TZ,2005.0,156,0,156
PL,,2000.0,395,0,395
PE,AU,2000.0,1,0,1
BO,,2021.0,87,0,87
UY,,2019.0,258,0,258
,JM,2008.0,52,0,52
EE,,2019.0,407,0,407
MD,,2007.0,25,0,25
PY,,2021.0,137,0,137
AZ,,2023.0,581,0,581
,SN,2015.0,140,0,140
,QA,2015.0,304,0,304
MK,,2018.0,117,0,117
NZ,GN,2013.0,1,0,1
KW,,2012.0,91,0,91
EE,,2010.0,89,0,89
,KE,2007.0,369,0,369
PH,,2003.0,73,0,73
VN,,2018.0,188,0,188
nan,VN,2007.0,3,0,3
,LV,2001.0,92,0,92
SD,,2025.0,19,0,19
,AZ,2006.0,148,0,148
,AG,2013.0,5,0,5
,MM,2015.0,87,0,87
,HR,2012.0,866,0,866
IQ,,2015.0,103,0,103
NA,,2025.0,10,0,10
,EC,2003.0,77,0,77
QA,RU,2017.0,2,0,2
BY,,2008.0,168,0,168
IL,TR,1998.0,4,0,4
HN,,2021.0,70,0,70
,ME,2016.0,34,0,34
SA,,1998.0,107,0,107
,BA,2016.0,221,0,221
,IQ,2018.0,1474,0,1474
JO,,2007.0,53,0,53
LK,,2008.0,26,0,26
MZ,,2022.0,118,0,118
BH,QA,2016.0,2,0,2
NG,,2000.0,74,0,74
CI,,2015.0,62,0,62
,XK,2010.0,81,0,81
,XK,2017.0,87,0,87
UG,,2011.0,52,0,52
AM,,2001.0,28,0,28
JM,CO,2005.0,1,0,1
,BW,2018.0,85,0,85
SG,BD,2005.0,3,0,3
EC,GR,2013.0,2,0,2
NL,TN,2005.0,1,0,1
,MW,2018.0,128,0,128
JM,MQ,2022.0,1,0,1
,BY,2009.0,309,0,309
IE,,2023.0,5854,0,5854
BE,,1998.0,348,0,348
HK,,2012.0,40,0,40
TG,,2024.0,244,0,244
BW,AU,2008.0,2,0,2
,TT,2006.0,29,0,29
BE,UG,2005.0,3,0,3
EE,,2017.0,325,0,325
,PY,1997.0,10,0,10
CA,AM,2017.0,1,0,1
PA,,2009.0,11,0,11
,BJ,2003.0,39,0,39
BJ,BF,2004.0,1,0,1
PK,AT,2006.0,2,0,2
SE,PE,2021.0,1,0,1
BR,IQ,2014.0,1,0,1
ET,SZ,2019.0,2,0,2
TW,PK,2004.0,5,0,5
NI,GT,2018.0,1,0,1
NZ,YE,2017.0,1,0,1
BJ,GR,2011.0,1,0,1
AZ,CN,2011.0,1,0,1
QA,PS,2018.0,3,0,3
GF,BE,2014.0,1,0,1
UZ,DE,2008.0,4,0,4
MU,KR,2004.0,1,0,1
HT,,2024.0,46,0,46
FR,GD,2015.0,1,0,1
,CG,2008.0,17,0,17
,BI,1994.0,28,0,28
KG,CZ,2020.0,2,0,2
,SV,1999.0,18,0,18
,AO,2016.0,15,0,15
NA,FR,2021.0,1,0,1
ID,MT,2022.0,1,0,1
TR,CM,2021.0,1,0,1
GM,,2025.0,6,0,6
TO,nan,2017.0,1,0,1
BJ,RE,2010.0,2,0,2
AE,,2007.0,43,0,43
MG,ES,2021.0,1,0,1
,NI,2009.0,27,0,27
nan,MC,2008.0,3,0,3
SR,NL,2004.0,1,0,1
PG,,2003.0,7,0,7
JP,TO,2015.0,1,0,1
UZ,AE,2018.0,1,0,1
GE,,2001.0,35,0,35
ES,GE,2015.0,1,0,1
IS,DE,2000.0,1,0,1
NZ,IR,2003.0,1,0,1
PL,RS,2002.0,3,0,3
GH,CG,2017.0,1,0,1
HR,NO,2005.0,3,0,3
,PF,2000.0,6,0,6
MQ,,2012.0,7,0,7
KR,BG,2007.0,2,0,2
NZ,LU,2022.0,2,0,2
,RE,1994.0,29,0,29
KW,AT,2020.0,1,0,1
MK,XK,2013.0,1,0,1
DZ,,2006.0,34,0,34
PE,,2001.0,20,0,20
JO,TN,2020.0,1,0,1
BE,SN,2018.0,3,0,3
,CW,2007.0,23,0,23
LV,ES,2019.0,1,0,1
KP,DE,2019.0,1,0,1
KR,CO,2019.0,1,0,1
UG,KR,2009.0,1,0,1
SS,,2021.0,10,0,10
PK,BR,2005.0,4,0,4
IT,EC,2011.0,1,0,1
JO,SE,2014.0,3,0,3
CH,MA,2022.0,1,0,1
AU,KZ,2022.0,1,0,1
,XK,2019.0,36,0,36
CD,,2000.0,3,0,3
PR,CA,2003.0,1,0,1
AO,GB,2019.0,1,0,1
PH,NO,2008.0,1,0,1
HU,TW,2002.0,1,0,1
PT,LT,2014.0,3,0,3
CW,,2022.0,15,0,15
GH,SA,2005.0,1,0,1
ZM,,2008.0,9,0,9
BE,IR,1999.0,2,0,2
DO,,2013.0,4,0,4
KR,GH,2005.0,1,0,1
GP,MQ,2015.0,1,0,1
,FJ,2008.0,25,0,25
EC,CL,2000.0,4,0,4
EE,PL,2015.0,2,0,2
VE,nan,2007.0,2,0,2
FJ,NC,2007.0,1,0,1
,GP,2009.0,20,0,20
ET,ZA,2009.0,5,0,5
nan,SK,2004.0,3,0,3
US,HK,2006.0,4,0,4
GW,,2013.0,1,0,1
AU,BS,2021.0,2,0,2
AU,BG,2011.0,2,0,2
RS,BA,1999.0,3,0,3
ES,DZ,2011.0,4,0,4
FO,VN,2011.0,1,0,1
LS,GB,2009.0,1,0,1
JO,CH,2016.0,1,0,1
,SC,2001.0,5,0,5
LY,CH,2015.0,1,0,1
nan,PK,2001.0,1,0,1
BE,EC,2013.0,4,0,4
KN,,2012.0,3,0,3
AR,YE,2017.0,1,0,1
ZA,EC,2018.0,2,0,2
MA,BI,2017.0,3,0,3
LV,GB,2004.0,2,0,2
EC,HN,1999.0,3,0,3
MK,CZ,2008.0,1,0,1
MG,DE,2021.0,1,0,1
VU,NC,2015.0,1,0,1
BB,,2011.0,7,0,7
CG,CI,2010.0,1,0,1
NG,PL,2023.0,1,0,1
,CF,2013.0,9,0,9
CA,BW,2018.0,2,0,2
FI,AX,2005.0,1,0,1
EG,YE,2001.0,4,0,4
FI,TH,2011.0,3,0,3
CL,DK,2022.0,3,0,3
SI,ZA,2013.0,1,0,1
OM,AE,2000.0,3,0,3
FI,MD,2019.0,1,0,1
DE,ZW,2015.0,1,0,1
IT,PR,2010.0,1,0,1
NO,AE,2005.0,1,0,1
EG,FR,2023.0,2,0,2
PF,,2013.0,3,0,3
NZ,BE,2000.0,3,0,3
,ST,2005.0,21,0,21
NZ,ZM,2020.0,1,0,1
GE,CH,2019.0,3,0,3
BA,PK,2018.0,1,0,1
LB,,1998.0,5,0,5
nan,GT,2013.0,1,0,1
FR,AM,2005.0,2,0,2
VG,,2016.0,17,0,17
SI,MK,2013.0,2,0,2
GR,IQ,2015.0,1,0,1
RW,GB,2004.0,1,0,1
ID,DK,2023.0,1,0,1
nan,RW,2012.0,3,0,3
TR,SD,2014.0,2,0,2
KW,BE,2016.0,1,0,1
KR,MM,2017.0,6,0,6
GE,JP,1998.0,2,0,2
NO,NI,2009.0,1,0,1
LB,nan,2018.0,2,0,2
OM,NO,2007.0,1,0,1
DZ,IR,2021.0,3,0,3
GD,IN,2020.0,1,0,1
AM,IN,2000.0,1,0,1
CO,TR,2002.0,1,0,1
TW,KG,2011.0,1,0,1
BI,,2011.0,2,0,2
UA,KZ,2023.0,1,0,1
AM,NO,2013.0,1,0,1
,BN,2001.0,5,0,5
MS,US,2011.0,1,0,1
US,PW,2019.0,1,0,1
BA,MY,2013.0,1,0,1
UG,NA,2012.0,3,0,3
EE,LV,2005.0,1,0,1
AO,MX,2006.0,1,0,1
LI,,2022.0,11,0,11
LT,BR,2008.0,1,0,1
NO,ZM,2012.0,3,0,3
KZ,CZ,2020.0,1,0,1
BO,DE,2020.0,1,0,1
UY,KZ,2017.0,1,0,1
CD,ZM,2022.0,1,0,1
GW,nan,2022.0,1,0,1
,SK,2020.0,28,0,28
CD,JP,2019.0,4,0,4
SE,BH,2018.0,1,0,1
MA,XK,2010.0,1,0,1
EC,BR,2001.0,1,0,1
BA,IE,2008.0,2,0,2
VN,SK,2014.0,1,0,1
TN,BD,2018.0,3,0,3
KZ,RS,2014.0,3,0,3
GI,,2020.0,1,0,1
BH,SD,2014.0,1,0,1
KH,IN,2014.0,2,0,2
MZ,ZW,2020.0,1,0,1
IL,LU,2021.0,1,0,1
KH,SE,2011.0,1,0,1
VN,MK,2008.0,2,0,2
BE,BF,2002.0,1,0,1
RU,EG,2005.0,2,0,2
SK,nan,2012.0,2,0,2
CZ,BR,1999.0,2,0,2
VN,IN,2001.0,1,0,1
CH,MW,2020.0,2,0,2
SC,,2020.0,2,0,2
AE,CH,2004.0,1,0,1
SA,BE,2023.0,1,0,1
NL,EE,2006.0,4,0,4
LB,HU,2007.0,4,0,4
NI,SV,2017.0,2,0,2
BD,BE,2008.0,1,0,1
LY,JO,2014.0,3,0,3
IQ,BD,2013.0,1,0,1
PT,HK,2014.0,2,0,2
SY,IT,2014.0,1,0,1
YE,EG,2003.0,2,0,2
,PY,1998.0,5,0,5
SN,MA,2009.0,2,0,2
RU,ME,2004.0,1,0,1
HN,CU,2016.0,2,0,2
GA,US,2005.0,2,0,2
NO,NZ,2000.0,1,0,1
CZ,NP,2012.0,2,0,2
BY,PL,2001.0,3,0,3
CA,NA,2012.0,1,0,1
IS,IN,2006.0,1,0,1
MA,KZ,2013.0,1,0,1
BG,HR,2002.0,1,0,1
BE,ML,2012.0,1,0,1
SN,TZ,2001.0,1,0,1
VN,MG,2016.0,1,0,1
QA,BD,2008.0,2,0,2
PA,FR,2017.0,4,0,4
SI,DK,1999.0,2,0,2
EG,MX,2012.0,2,0,2
GI,US,2005.0,1,0,1
PG,GB,2016.0,1,0,1
NL,RE,2007.0,1,0,1
DK,RO,2022.0,5,0,5
NP,CN,2004.0,2,0,2
GB,AL,2012.0,1,0,1
EC,ZA,2014.0,1,0,1
JO,PR,2018.0,1,0,1
CD,BW,2018.0,1,0,1
MA,CI,2006.0,1,0,1
CA,CG,2011.0,2,0,2
UY,BE,2003.0,1,0,1
FR,AM,2002.0,3,0,3
TW,RO,1999.0,1,0,1
ID,SD,2011.0,1,0,1
CU,CA,2008.0,1,0,1
RO,PE,2013.0,1,0,1
ET,HU,2022.0,1,0,1
MZ,AO,2017.0,1,0,1
JO,BA,2016.0,1,0,1
DE,GW,2013.0,1,0,1
CN,BJ,2017.0,4,0,4
HR,KE,2018.0,1,0,1
GP,LB,2020.0,1,0,1
FJ,CA,2001.0,1,0,1
AU,KH,2015.0,1,0,1
NP,AE,2021.0,2,0,2
IR,MX,2022.0,3,0,3
TR,UZ,2006.0,1,0,1
UZ,TR,2014.0,2,0,2
BN,,2011.0,3,0,3
LI,PL,2017.0,1,0,1
ML,GB,2017.0,1,0,1
IT,CI,2017.0,1,0,1
NL,SN,2000.0,1,0,1
MA,SD,2008.0,1,0,1
NG,GD,2014.0,1,0,1
MG,CN,2022.0,4,0,4
KH,CA,2016.0,1,0,1
BY,PT,2006.0,2,0,2
DE,KG,2002.0,2,0,2
FI,GE,2019.0,1,0,1
FR,GT,2014.0,1,0,1
LT,IN,2010.0,4,0,4
CO,VN,2014.0,1,0,1
AT,CY,2009.0,1,0,1
FO,,2012.0,2,0,2
SI,KW,2013.0,1,0,1
BI,IT,2002.0,1,0,1
BT,AU,2013.0,1,0,1
BA,HU,2006.0,1,0,1
HN,CA,2012.0,1,0,1
US,YE,2004.0,1,0,1
FR,CR,1999.0,2,0,2
TR,PT,2004.0,2,0,2
PE,IE,2021.0,1,0,1
CA,CM,1997.0,1,0,1
UY,AT,2013.0,1,0,1
PR,GB,2014.0,1,0,1
KH,FR,2000.0,2,0,2
BG,MA,2019.0,1,0,1
MD,CA,2005.0,3,0,3
OM,KE,2017.0,1,0,1
MX,CI,2004.0,1,0,1
AZ,IR,2008.0,1,0,1
KR,PT,2000.0,1,0,1
IR,SY,2010.0,2,0,2
SN,SA,2014.0,1,0,1
KE,SS,2017.0,2,0,2
PA,TZ,2015.0,1,0,1
TW,MY,2023.0,2,0,2
UA,VN,2008.0,2,0,2
AZ,GB,2004.0,1,0,1
HR,AE,2021.0,1,0,1
RO,nan,2004.0,2,0,2
KZ,MX,2007.0,1,0,1
PT,PH,2012.0,1,0,1
IN,MC,2006.0,1,0,1
AM,CY,2006.0,1,0,1
AR,EC,1997.0,1,0,1
AO,IT,2001.0,2,0,2
FJ,MY,2020.0,1,0,1
HU,VN,2008.0,1,0,1
VN,UA,2006.0,1,0,1
AU,DZ,2013.0,3,0,3
RS,PK,2004.0,1,0,1
GH,IQ,2018.0,2,0,2
GB,GW,2016.0,1,0,1
NO,TW,2015.0,1,0,1
CM,ZA,2002.0,1,0,1
nan,SN,2006.0,1,0,1
NI,CH,2012.0,1,0,1
IT,BN,2018.0,1,0,1
SZ,GB,2020.0,1,0,1
TW,IE,2010.0,3,0,3
BS,AU,1999.0,1,0,1
CM,KR,2003.0,1,0,1
RO,LT,2014.0,1,0,1
MQ,DZ,2019.0,1,0,1
NP,CH,2022.0,1,0,1
OM,KE,2010.0,1,0,1
BI,PE,2002.0,1,0,1
GN,FR,2002.0,1,0,1
MD,CA,2002.0,1,0,1
PE,PL,2022.0,1,0,1
SE,HK,2011.0,2,0,2
AR,VE,1999.0,5,0,5
BR,SI,2019.0,3,0,3
HR,BG,2020.0,1,0,1
IT,SA,2005.0,2,0,2
TR,IR,1999.0,1,0,1
IT,SY,2007.0,1,0,1
GB,MG,2019.0,4,0,4
NO,BF,2014.0,1,0,1
US,LS,2016.0,2,0,2
MN,GH,2020.0,1,0,1
,LI,2009.0,1,0,1
PY,PT,2014.0,3,0,3
ET,TW,2004.0,1,0,1
BD,IT,1997.0,1,0,1
TR,GR,1999.0,1,0,1
KH,DE,2016.0,1,0,1
nan,LY,2017.0,1,0,1
BN,TH,2017.0,1,0,1
BR,IS,2021.0,3,0,3
LY,NG,2020.0,1,0,1
KW,AG,2018.0,1,0,1
SN,CA,2004.0,3,0,3
GT,ES,2004.0,3,0,3
CH,BD,2022.0,1,0,1
FI,MW,2020.0,1,0,1
KH,CN,2004.0,2,0,2
TL,,2020.0,3,0,3
KW,JP,2021.0,1,0,1
MY,BW,2016.0,2,0,2
PE,CN,2022.0,3,0,3
UG,IR,2012.0,1,0,1
OM,KR,2007.0,1,0,1
GP,QA,2016.0,1,0,1
CF,CM,2012.0,1,0,1
ET,NO,2003.0,1,0,1
LA,VN,2009.0,1,0,1
IT,SA,2002.0,1,0,1
HU,SI,2003.0,1,0,1
MY,MW,2017.0,1,0,1
MG,JP,2003.0,2,0,2
PR,UY,2018.0,1,0,1
PF,AU,2018.0,2,0,2
MA,NO,2011.0,1,0,1
PF,BE,2012.0,1,0,1
TR,BA,2023.0,1,0,1
NL,CM,2014.0,1,0,1
MD,TR,2002.0,2,0,2
MD,nan,2013.0,2,0,2
AL,SE,2020.0,2,0,2
HU,NZ,1997.0,1,0,1
UG,SZ,2020.0,1,0,1
KG,IE,2019.0,1,0,1
SK,IE,2003.0,1,0,1
GA,JP,2014.0,2,0,2
TR,AF,2021.0,2,0,2
DE,MW,2014.0,1,0,1
VN,IS,2012.0,2,0,2
NL,LY,2007.0,1,0,1
IQ,GB,2004.0,1,0,1
LB,KW,2014.0,1,0,1
US,CW,2010.0,1,0,1
GT,VE,2012.0,1,0,1
BN,TW,2009.0,1,0,1
AO,NL,2011.0,1,0,1
TR,OM,1998.0,2,0,2
GH,EG,2006.0,1,0,1
EG,OM,1999.0,1,0,1
DE,NE,2017.0,1,0,1
GB,BF,2004.0,1,0,1
,KP,1997.0,5,0,5
NO,RO,1998.0,2,0,2
DE,LR,2021.0,1,0,1
ET,PK,2020.0,3,0,3
SG,nan,2002.0,3,0,3
,BM,2006.0,3,0,3
BF,KE,2016.0,1,0,1
KZ,EE,2022.0,2,0,2
FI,LY,2020.0,1,0,1
SK,AE,2021.0,1,0,1
TZ,FR,2019.0,1,0,1
CZ,CR,2019.0,1,0,1
ZM,NA,2023.0,1,0,1
UA,IE,2021.0,1,0,1
,JE,2003.0,1,0,1
KW,PK,2009.0,1,0,1
CZ,TW,2016.0,3,0,3
MY,SY,1999.0,1,0,1
ID,NP,2008.0,1,0,1
SD,UA,2022.0,1,0,1
BJ,ES,2015.0,1,0,1
ID,HR,2006.0,1,0,1
EC,HR,2018.0,1,0,1
DK,MT,2015.0,1,0,1
BG,NZ,2014.0,1,0,1
DZ,MY,2006.0,1,0,1
MW,ZA,2005.0,3,0,3
MZ,UA,2006.0,3,0,3
UA,TW,2006.0,2,0,2
ML,ZA,2018.0,2,0,2
MD,US,1999.0,5,0,5
LA,ET,2011.0,1,0,1
ES,KZ,2013.0,1,0,1
MX,NL,2000.0,6,0,6
JP,LY,2011.0,1,0,1
BR,TZ,2016.0,1,0,1
IM,GB,2013.0,1,0,1
MQ,GP,2005.0,1,0,1
BG,IR,2018.0,2,0,2
GB,AM,2017.0,2,0,2
AR,TZ,2017.0,1,0,1
LT,UA,2011.0,2,0,2
MD,CL,2003.0,1,0,1
LU,LI,2019.0,1,0,1
NO,LV,2008.0,1,0,1
IL,MD,2011.0,1,0,1
IT,BY,2022.0,1,0,1
US,TL,2011.0,1,0,1
GW,NL,2002.0,3,0,3
PL,QA,2009.0,1,0,1
SG,AE,2023.0,1,0,1
BJ,US,2017.0,3,0,3
KR,KZ,2011.0,1,0,1
KZ,OM,2022.0,1,0,1
CA,RE,2020.0,1,0,1
IE,GE,2001.0,1,0,1
IR,MM,2012.0,1,0,1
MA,NL,2004.0,3,0,3
IN,NE,2005.0,1,0,1
RU,NP,2014.0,1,0,1
RS,BG,2001.0,3,0,3
TH,HR,2014.0,1,0,1
HU,NO,2014.0,3,0,3
KZ,KR,2005.0,1,0,1
ML,MW,2004.0,1,0,1
,UG,2020.0,12,0,12
SE,SY,2023.0,1,0,1
LT,SI,2008.0,1,0,1
CI,SE,2016.0,1,0,1
TR,MD,2012.0,1,0,1
CL,FI,2005.0,3,0,3
SK,VN,2008.0,1,0,1
LY,AE,2006.0,1,0,1
KW,ET,2010.0,1,0,1
ES,ML,2008.0,1,0,1
JP,CR,2006.0,1,0,1
AT,NP,2006.0,1,0,1
TW,GE,2018.0,2,0,2
NZ,VN,2002.0,1,0,1
ZW,ID,2018.0,3,0,3
US,AL,2006.0,1,0,1
UG,EG,2021.0,1,0,1
UA,AR,2015.0,1,0,1
PY,KR,2018.0,1,0,1
NG,BY,2019.0,1,0,1
NZ,RO,2001.0,1,0,1
WS,ES,2019.0,1,0,1
MW,ZW,2022.0,1,0,1
MY,PH,2020.0,3,3,0
NP,TW,2011.0,1,2,-1
MD,ES,2007.0,1,2,-1
IQ,RO,2016.0,2,6,-4
IL,UG,2021.0,1,1,0
LU,NO,2018.0,2,3,-1
FR,MG,2003.0,2,3,-1
BR,TR,2001.0,3,1,2
RU,NG,2016.0,1,2,-1
nan,MA,2015.0,1,3,-2
PH,CO,2022.0,1,2,-1
CN,TN,2015.0,1,1,0
TR,PH,2007.0,1,3,-2
UA,BY,1998.0,1,2,-1
NO,HR,2004.0,1,2,-1
SI,PT,2022.0,1,1,0
PS,JP,2009.0,1,2,-1
ML,NL,2010.0,1,1,0
GB,SY,2006.0,1,1,0
PT,GR,2007.0,1,1,0
PH,TW,2015.0,3,9,-6
IQ,US,2009.0,3,8,-5
RU,MN,2013.0,2,1,1
BS,US,2001.0,1,2,-1
nan,BD,2007.0,1,1,0
BE,UG,2002.0,1,1,0
IR,AM,2013.0,1,2,-1
RO,RS,2014.0,1,3,-2
IT,CI,2019.0,1,1,0
BJ,RE,2019.0,1,1,0
CR,AT,2016.0,1,1,0
SN,JP,1998.0,1,1,0
MA,GP,2009.0,1,2,-1
CH,DK,2023.0,2,1,1
NA,CN,2017.0,1,1,0
TW,PH,2008.0,2,2,0
RO,JO,2005.0,1,1,0
BI,US,2011.0,2,4,-2
TH,DK,2017.0,1,3,-2
NO,SA,2021.0,5,4,1
TN,IN,2015.0,2,8,-6
CA,AM,2010.0,1,2,-1
TN,PL,2021.0,2,1,1
CR,CA,2020.0,2,6,-4
KR,BR,2021.0,3,10,-7
MY,MK,2014.0,2,1,1
PT,SI,2022.0,1,1,0
SY,EG,2013.0,1,1,0
AT,QA,2014.0,1,1,0
MX,HU,2020.0,2,4,-2
CZ,IL,2003.0,1,4,-3
TN,AR,2021.0,1,1,0
SD,IN,2020.0,1,1,0
PG,US,2000.0,3,2,1
HN,US,2009.0,2,3,-1
CA,BS,2020.0,1,1,0
JP,CD,2020.0,1,3,-2
AF,ID,2021.0,1,1,0
CR,SV,2020.0,1,1,0
BH,JO,2004.0,1,1,0
GB,CU,2012.0,2,6,-4
CM,GB,2010.0,2,7,-5
CR,AU,2011.0,1,1,0
TZ,BE,2011.0,1,2,-1
SN,CI,2012.0,1,1,0
KR,PL,2022.0,1,3,-2
PT,CU,2022.0,1,2,-1
BR,EG,2006.0,1,1,0
SO,SE,2016.0,1,1,0
FI,SK,2009.0,1,3,-2
GE,PL,2002.0,1,1,0
CA,LU,2012.0,1,1,0
CA,SS,2003.0,1,1,0
IR,KW,2016.0,2,5,-3
ZW,CN,2001.0,1,1,0
CN,ZW,2003.0,1,2,-1
PL,ID,2012.0,1,1,0
QA,FI,2012.0,1,1,0
US,SX,2007.0,1,1,0
EE,PE,2019.0,1,1,0
PT,PY,2006.0,1,1,0
EG,ZA,2014.0,1,6,-5
KE,SD,2006.0,1,2,-1
VN,RU,2010.0,1,3,-2
JP,DZ,1998.0,2,1,1
GR,SI,2020.0,1,2,-1
MG,BE,2022.0,1,1,0
RU,MK,2020.0,1,1,0
BG,SE,2016.0,1,3,-2
BR,SI,2010.0,1,1,0
CH,DO,2020.0,2,2,0
PE,KE,2021.0,1,1,0
NE,BJ,2021.0,1,2,-1
ET,IE,2021.0,1,1,0
KR,CY,2017.0,1,1,0
PE,AT,2011.0,1,1,0
SE,TN,2014.0,1,1,0
BE,BG,1998.0,1,4,-3
SA,FI,2015.0,1,5,-4
ID,NG,2012.0,1,1,0
IL,SD,2017.0,1,1,0
TH,ET,2009.0,1,1,0
JM,GP,2017.0,2,2,0
OM,BH,2018.0,1,1,0
RO,AT,2005.0,1,1,0
GH,CH,2009.0,1,1,0
AU,IS,2015.0,1,1,0
MW,TZ,2019.0,1,2,-1
LT,DK,2003.0,1,2,-1
PA,FR,2010.0,1,1,0
IQ,NG,2013.0,2,1,1
AT,BA,2022.0,1,1,0
GB,MS,2010.0,1,1,0
CH,AR,2003.0,2,7,-5
KR,LV,2016.0,2,1,1
SV,JP,2006.0,1,2,-1
MA,AM,2015.0,1,1,0
nan,CY,2021.0,1,1,0
FR,JM,1997.0,1,1,0
BE,BF,2005.0,1,1,0
PG,IN,2021.0,1,2,-1
PT,HR,2009.0,1,1,0
MW,JP,2016.0,1,1,0
EC,UA,2000.0,1,5,-4
MW,NL,2005.0,1,4,-3
KW,RU,2013.0,1,1,0
UG,BW,2015.0,1,1,0
GE,CH,2010.0,1,1,0
SD,DE,2002.0,1,1,0
PH,MY,2014.0,1,2,-1
LT,IN,2019.0,1,1,0
KH,ID,2018.0,1,1,0
JO,KW,2022.0,1,3,-2
CA,CU,2012.0,1,7,-6
TW,IE,2019.0,1,5,-4
ZW,JP,2015.0,1,2,-1
EC,BY,2023.0,1,1,0
IQ,HU,2023.0,1,1,0
SE,SD,2021.0,1,1,0
UZ,BE,2011.0,1,1,0
MM,nan,2021.0,1,2,-1
FI,BD,2022.0,1,4,-3
GB,TT,2007.0,2,3,-1
MN,DZ,2014.0,3,3,0
IR,SD,2012.0,1,1,0
PT,TR,2018.0,3,6,-3
PT,CV,2016.0,1,1,0
EG,PT,2015.0,1,2,-1
ES,UA,2011.0,2,3,-1
nan,IE,2008.0,3,2,1
LT,RO,2007.0,2,6,-4
BB,US,2002.0,1,1,0
SG,IR,2006.0,1,1,0
AZ,US,2011.0,1,2,-1
GH,NG,2002.0,1,2,-1
CH,RO,2002.0,1,6,-5
IQ,TR,2009.0,1,1,0
IE,CL,2012.0,1,1,0
JM,NG,2011.0,2,0,2
AG,,2016.0,1,0,1
AT,NG,2006.0,1,0,1
BD,SG,2002.0,1,0,1
DZ,CY,2022.0,1,0,1
NE,BF,2012.0,1,0,1
CL,KN,2020.0,1,0,1
NZ,SI,2020.0,1,0,1
PE,JO,2021.0,1,0,1
HN,PA,1998.0,1,0,1
KE,PT,2019.0,1,0,1
CO,PL,2015.0,1,0,1
NL,GA,2001.0,1,0,1
SD,SE,2011.0,1,0,1
FR,JM,1998.0,1,0,1
IE,TT,2021.0,1,0,1
NZ,OM,2004.0,1,0,1
AT,AZ,2015.0,1,0,1
VE,NI,2009.0,1,0,1
LS,BW,2021.0,1,0,1
TT,NG,2012.0,1,0,1
AU,NG,1999.0,1,0,1
BR,TH,2007.0,1,0,1
KW,DK,2013.0,1,0,1
PK,JO,2012.0,2,0,2
IT,SN,2004.0,1,0,1
HU,TH,2000.0,1,0,1
BN,JP,2001.0,1,0,1
CR,BE,2020.0,3,0,3
GB,MG,2010.0,1,0,1
UZ,SY,2012.0,1,0,1
CM,SE,1997.0,3,0,3
CA,PW,2002.0,1,0,1
DK,TR,2003.0,2,0,2
KZ,QA,2021.0,1,0,1
GT,DE,2012.0,2,0,2
PR,JP,2002.0,2,0,2
KR,KP,2012.0,1,0,1
PA,SN,2020.0,1,0,1
DJ,LA,2009.0,1,0,1
AZ,SG,2017.0,1,0,1
CY,AR,2021.0,1,0,1
GT,FR,2020.0,2,0,2
SE,SO,2017.0,1,0,1
NA,JP,2021.0,1,0,1
TW,IQ,2020.0,1,0,1
ML,,2009.0,3,0,3
GY,NZ,2021.0,1,0,1
BB,US,2005.0,2,0,2
KR,BO,2004.0,1,0,1
MW,GH,2019.0,2,0,2
BN,PH,2001.0,1,0,1
CL,PK,2004.0,1,0,1
VN,GR,2016.0,3,0,3
PS,ID,2014.0,1,0,1
PS,RU,2021.0,1,0,1
CD,MW,2014.0,1,0,1
UY,KZ,2010.0,1,0,1
,PW,2003.0,1,0,1
ES,QA,2000.0,1,0,1
ST,US,2019.0,2,0,2
BN,ID,2014.0,1,0,1
IE,MD,2012.0,1,0,1
IE,LU,2022.0,1,0,1
PE,MY,2017.0,1,0,1
AM,PL,1997.0,1,0,1
DZ,BH,2016.0,1,0,1
CY,PS,2014.0,1,0,1
RO,BA,2002.0,1,0,1
TZ,GM,2021.0,1,0,1
HK,RS,2015.0,1,0,1
PH,KE,2009.0,1,0,1
TT,CL,2014.0,1,0,1
ZA,EE,2005.0,1,0,1
NG,CI,2003.0,1,0,1
SG,UZ,2020.0,1,0,1
CH,XK,2015.0,1,0,1
MD,IS,1999.0,1,0,1
LY,KW,2011.0,1,0,1
GM,RW,2007.0,1,0,1
FI,HR,2011.0,1,0,1
BB,AU,2017.0,1,0,1
LV,ES,2017.0,2,0,2
PA,VE,2007.0,1,0,1
ET,PR,2009.0,1,0,1
nan,LY,2019.0,1,0,1
GR,LI,2022.0,1,0,1
NO,BA,2017.0,1,0,1
KE,LK,2009.0,1,0,1
BH,GB,1998.0,1,0,1
KZ,BY,2012.0,1,0,1
SN,DZ,2020.0,1,0,1
IE,KZ,2016.0,1,0,1
SN,IT,2020.0,1,0,1
GT,CR,2005.0,1,0,1
IN,LU,1998.0,1,0,1
TN,HU,2018.0,1,0,1
NP,BR,2022.0,1,0,1
GB,CM,1997.0,1,0,1
SK,LV,2010.0,1,0,1
NE,GB,2013.0,1,0,1
NG,CH,2005.0,3,0,3
RO,NO,2004.0,1,0,1
IR,BD,2006.0,1,0,1
JP,KW,2013.0,2,0,2
AT,DZ,2016.0,1,0,1
NG,CH,2002.0,1,0,1
SS,CN,2016.0,1,0,1
GB,YE,2014.0,1,0,1
NI,MY,2022.0,1,0,1
BT,US,2021.0,1,0,1
IQ,CA,1997.0,1,0,1
FR,OM,2000.0,1,0,1
ME,QA,2013.0,1,0,1
PF,JP,2020.0,1,0,1
PY,CL,1999.0,1,0,1
KZ,FR,2021.0,1,0,1
HU,PR,2019.0,1,0,1
PG,NL,2007.0,1,0,1
CL,VN,2017.0,1,0,1
SJ,,2015.0,1,0,1
AU,BB,2004.0,1,0,1
PK,SZ,2020.0,1,0,1
HN,VE,2022.0,1,0,1
ZW,ET,2016.0,1,0,1
SK,AM,2001.0,1,0,1
SA,YE,2007.0,1,0,1
ME,SI,2007.0,2,0,2
BY,SI,2012.0,1,0,1
LV,ES,2010.0,1,0,1
JP,DZ,1997.0,1,0,1
CO,IN,2000.0,1,0,1
MY,CZ,2004.0,1,0,1
PF,CG,2017.0,1,0,1
PT,NG,2011.0,1,0,1
RU,SA,2008.0,1,0,1
ST,UY,2019.0,1,0,1
ES,PG,1999.0,1,0,1
PK,GW,2015.0,1,0,1
BO,BE,2018.0,1,0,1
ME,JP,2002.0,1,0,1
CZ,GF,2017.0,1,0,1
SK,RO,2005.0,1,0,1
CA,JE,2017.0,1,0,1
VN,IR,2010.0,1,0,1
CZ,BD,2020.0,1,0,1
HR,SA,2020.0,1,0,1
RU,GE,2023.0,1,0,1
ES,KR,2002.0,1,0,1
LV,IN,2011.0,1,0,1
CR,PH,2014.0,1,0,1
BI,IT,2005.0,1,0,1
CL,AM,2001.0,1,0,1
CA,SY,2008.0,1,0,1
FI,TZ,2008.0,1,0,1
DK,BO,2013.0,1,0,1
TW,IR,1998.0,1,0,1
CR,GR,2018.0,1,0,1
NL,BF,2005.0,1,0,1
DE,MT,2023.0,1,0,1
TN,BJ,2022.0,1,0,1
KE,JP,2023.0,1,0,1
PK,TW,1997.0,1,0,1
DE,NE,2019.0,1,0,1
ER,ET,2021.0,2,0,2
ML,CH,2006.0,1,0,1
IQ,BR,2018.0,1,0,1
IS,LU,2022.0,1,0,1
NZ,TZ,2006.0,1,0,1
FR,MT,2011.0,1,0,1
GT,,1999.0,1,0,1
CZ,AZ,2016.0,1,0,1
DE,NI,2016.0,1,0,1
BN,HU,2016.0,1,0,1
SL,,2007.0,1,0,1
KW,LB,2006.0,1,0,1
,FM,2015.0,1,0,1
LY,TN,2020.0,1,0,1
GD,,2025.0,2,0,2
IL,LK,2022.0,1,0,1
DK,QA,2010.0,1,0,1
NO,MC,2014.0,1,0,1
NP,UG,2017.0,1,0,1
BJ,RE,2017.0,1,0,1
nan,MN,2015.0,1,0,1
CV,,2014.0,1,0,1
AE,VN,2022.0,1,0,1
SD,LY,2021.0,1,0,1
US,SO,2023.0,1,0,1
LK,NO,2004.0,1,0,1
GA,TG,2017.0,1,0,1
CM,EC,2019.0,1,0,1
IN,ER,2006.0,1,0,1
BH,UG,2011.0,1,0,1
CZ,LI,2006.0,1,0,1
CN,US,2012.0,5335,6254,-919
MX,UA,2017.0,2,3,-1
FR,BE,2007.0,262,230,32
BO,US,2010.0,8,7,1
CN,MD,2015.0,3,3,0
US,ZA,2017.0,385,387,-2
GB,US,2005.0,4354,4579,-225
US,PH,2006.0,316,349,-33
CN,SG,2015.0,469,492,-23
GB,IN,2014.0,478,351,127
IN,GB,2015.0,435,494,-59
US,AR,2012.0,235,240,-5
JP,EG,2019.0,58,45,13
US,NZ,2006.0,286,226,60
GB,US,2002.0,3822,3752,70
GB,DE,1999.0,286,387,-101
RO,ES,2021.0,12,11,1
IT,CA,2015.0,167,86,81
GB,IR,2019.0,110,133,-23
US,SG,2018.0,549,524,25
TW,CN,2003.0,951,526,425
AU,GB,2009.0,975,1189,-214
GB,BR,2011.0,171,144,27
PL,nan,2010.0,8,4,4
IN,CA,2017.0,266,222,44
ZA,GB,2001.0,74,67,7
AU,SG,2012.0,116,86,30
US,MY,2010.0,132,69,63
US,BR,2009.0,866,851,15
GB,NL,2017.0,355,400,-45
CL,IR,2020.0,1,6,-5
CN,DE,2017.0,340,371,-31
SE,GB,2023.0,8,4,4
JP,CH,2014.0,107,96,11
CA,BR,2016.0,315,268,47
US,KR,2000.0,518,422,96
NL,CH,2009.0,104,87,17
IN,US,2011.0,1774,2015,-241
ZA,CA,2020.0,53,46,7
DE,ES,2022.0,163,158,5
TH,VN,2019.0,22,7,15
KR,JP,2011.0,319,363,-44
GB,CN,2014.0,591,432,159
SE,CH,2011.0,43,35,8
BR,CL,2007.0,39,50,-11
PH,CA,2012.0,8,5,3
AU,CH,2018.0,110,98,12
ES,FR,2018.0,380,346,34
KR,DE,2015.0,56,54,2
MY,BR,2019.0,68,27,41
CN,TW,1999.0,174,257,-83
AT,ES,2009.0,26,14,12
CO,ES,2003.0,89,100,-11
JP,IT,2012.0,78,90,-12
US,JP,2020.0,1567,1518,49
CO,US,2020.0,426,324,102
US,ZA,2010.0,287,317,-30
CN,DE,2019.0,354,451,-97
GB,IE,2011.0,338,284,54
US,CH,2011.0,889,667,222
AU,JP,2020.0,83,72,11
DE,NZ,2013.0,29,38,-9
DE,CL,2001.0,14,17,-3
BE,DE,2001.0,55,60,-5
MX,BR,2017.0,151,149,2
nan,US,2007.0,252,240,12
BR,ES,2009.0,238,243,-5
IT,GB,2000.0,245,172,73
DE,HU,2016.0,54,75,-21
BE,GR,2019.0,31,35,-4
NL,GA,2003.0,3,3,0
NL,FR,2010.0,163,175,-12
CH,DE,2004.0,392,571,-179
IT,BR,2008.0,167,131,36
DE,GR,2019.0,66,77,-11
PK,US,2016.0,256,285,-29
MX,BR,2019.0,187,182,5
VE,ES,2000.0,47,40,7
IL,CA,2023.0,5,3,2
IN,SE,2013.0,64,40,24
IN,CA,2019.0,304,276,28
MY,IQ,2018.0,173,29,144
CA,IE,2011.0,153,126,27
ET,KR,2011.0,152,89,63
SJ,US,2012.0,2,2,0
GB,CY,2017.0,46,26,20
SG,GB,1998.0,16,24,-8
MX,CR,2002.0,6,5,1
MX,CL,2021.0,146,154,-8
CN,NZ,2000.0,16,12,4
GB,CH,2013.0,335,269,66
AU,CN,2015.0,405,501,-96
SA,US,2020.0,203,392,-189
GB,NL,2019.0,420,383,37
JP,CN,2022.0,365,254,111
AR,CN,2009.0,6,5,1
BE,AU,2009.0,26,24,2
IS,US,2010.0,13,25,-12
ES,CA,2020.0,92,93,-1
US,MY,2017.0,205,174,31
PE,US,2008.0,43,39,4
IE,US,2020.0,514,572,-58
DE,KR,2008.0,28,36,-8
US,PE,2007.0,43,40,3
IT,JP,2011.0,69,93,-24
AO,BR,2022.0,28,29,-1
CR,MX,2016.0,35,49,-14
CR,CU,2014.0,16,20,-4
JP,EG,2017.0,72,52,20
CU,FR,2003.0,5,2,3
CL,ES,2007.0,178,179,-1
CA,JP,2009.0,129,128,1
US,MX,2015.0,445,421,24
IS,US,2019.0,22,21,1
IN,CN,2017.0,223,130,93
PA,ES,2015.0,17,17,0
NL,CO,2016.0,14,10,4
GB,BH,2021.0,6,4,2
DK,ES,1999.0,22,10,12
MD,BE,2011.0,2,3,-1
US,NG,2017.0,123,106,17
nan,JP,1998.0,77,80,-3
FI,US,1999.0,97,98,-1
GB,TH,2022.0,37,16,21
JP,EG,2010.0,70,50,20
CH,IT,2021.0,237,274,-37
CA,PT,2016.0,22,18,4
SA,SD,2012.0,6,12,-6
AU,DE,2003.0,96,116,-20
TH,CA,2017.0,15,24,-9
CZ,US,2013.0,152,169,-17
CN,NO,2011.0,35,33,2
PE,CL,2007.0,24,17,7
CL,nan,2019.0,8,12,-4
CO,IT,2015.0,21,26,-5
CO,AR,2014.0,92,93,-1
SK,CZ,2005.0,51,37,14
GB,ZA,2001.0,67,74,-7
NZ,nan,1998.0,8,7,1
RO,FR,2013.0,39,50,-11
ZW,ZA,2015.0,40,30,10
BE,US,2015.0,390,418,-28
CH,GB,2009.0,216,208,8
US,TH,2017.0,227,136,91
ES,BO,2009.0,7,12,-5
MX,AR,2007.0,81,61,20
RU,FR,2021.0,72,74,-2
AT,SK,2017.0,17,13,4
SE,DK,2008.0,128,85,43
ES,GB,2000.0,102,136,-34
US,MY,2019.0,185,221,-36
MX,BR,2010.0,77,64,13
US,KW,2019.0,35,27,8
HK,CN,2011.0,86,139,-53
IN,CN,2010.0,185,174,11
CN,CO,2006.0,1,4,-3
CN,NL,2015.0,140,126,14
CN,BD,2010.0,54,56,-2
IL,CN,2011.0,25,21,4
nan,IT,2017.0,106,127,-21
CN,CZ,2014.0,19,34,-15
NP,CN,2014.0,18,13,5
PT,CN,2006.0,10,7,3
AM,IT,2016.0,13,30,-17
IN,NO,2013.0,24,13,11
nan,CN,2001.0,30,29,1
CN,QA,2007.0,15,5,10
CN,EG,2016.0,33,37,-4
LU,US,2007.0,12,9,3
HU,SE,2020.0,12,13,-1
AR,ES,2000.0,91,96,-5
DE,RU,2005.0,142,190,-48
RS,CO,2019.0,6,1,5
IN,CA,2010.0,154,143,11
US,TH,2010.0,183,106,77
HR,US,2015.0,29,53,-24
TN,CH,2021.0,5,3,2
EE,DE,2020.0,52,70,-18
NL,IT,2022.0,60,83,-23
US,DE,2023.0,65,89,-24
VN,TH,2017.0,8,13,-5
AU,FR,2011.0,104,129,-25
FR,NE,2020.0,20,25,-5
QA,US,2015.0,50,95,-45
BY,IL,2008.0,1,1,0
US,CZ,2018.0,172,142,30
FI,BE,2018.0,18,11,7
SE,IT,2013.0,73,85,-12
US,TH,2019.0,196,134,62
DE,JO,2021.0,8,8,0
HU,NO,2004.0,2,1,1
US,JO,2012.0,64,47,17
AT,nan,2010.0,18,9,9
TH,SG,2012.0,8,7,1
SK,DE,2008.0,28,38,-10
FR,IL,2005.0,21,28,-7
KZ,RU,2019.0,99,72,27
JP,SI,2005.0,3,4,-1
DK,AU,2020.0,62,73,-11
TR,nan,2010.0,17,7,10
JP,MY,2016.0,87,55,32
NL,TR,2012.0,31,23,8
ID,KR,2019.0,48,45,3
MX,VE,2018.0,34,61,-27
VE,FR,2001.0,6,2,4
JP,VN,2016.0,73,39,34
ES,CH,2020.0,141,106,35
PK,CA,2018.0,38,63,-25
MY,BR,2017.0,68,39,29
MY,KR,2013.0,20,41,-21
EC,CO,2020.0,129,166,-37
AU,CO,2012.0,7,7,0
US,PA,2010.0,55,23,32
MA,FR,2020.0,203,249,-46
IN,CN,2019.0,306,183,123
MA,SY,2020.0,3,3,0
DK,SE,1999.0,33,38,-5
IL,GB,2003.0,42,28,14
RU,NL,2015.0,47,33,14
CN,nan,2022.0,71,80,-9
DE,AR,2006.0,17,25,-8
DE,BG,2016.0,28,23,5
KR,FR,2014.0,33,34,-1
NL,FR,2019.0,156,189,-33
MY,BR,2010.0,163,54,109
CH,NZ,2002.0,3,6,-3
US,KW,2010.0,21,18,3
BW,ZA,2015.0,8,7,1
BR,CU,2018.0,22,33,-11
AR,CL,2012.0,88,81,7
IN,SG,2022.0,71,82,-11
FR,DK,2017.0,47,34,13
RU,DE,2021.0,141,134,7
FR,DK,2010.0,32,22,10
AT,LU,2018.0,3,1,2
GB,SA,2012.0,107,27,80
SY,US,2015.0,9,6,3
TR,NL,2019.0,58,32,26
nan,IT,2019.0,158,98,60
NO,IT,2017.0,16,41,-25
GR,DE,2020.0,99,56,43
PK,AU,1999.0,3,3,0
IL,NL,2018.0,17,13,4
PL,CN,2017.0,27,18,9
CL,FR,2020.0,58,48,10
MY,IT,2011.0,34,47,-13
CH,NP,2016.0,1,2,-1
CA,BE,2010.0,59,56,3
LT,SE,2015.0,4,6,-2
LV,RU,2021.0,19,13,6
NL,FR,2017.0,191,161,30
BE,GB,2004.0,66,68,-2
CA,IT,2000.0,45,51,-6
CA,nan,2020.0,33,44,-11
NO,IT,2019.0,23,49,-26
BR,PL,2015.0,12,11,1
DE,nan,2015.0,89,89,0
BE,IN,2009.0,10,19,-9
IT,AU,2007.0,48,37,11
MX,CR,2005.0,6,10,-4
FR,PK,2018.0,17,10,7
ES,PE,2002.0,20,22,-2
IT,IQ,2017.0,6,3,3
DE,GR,2010.0,41,58,-17
NL,MY,2020.0,12,11,1
EG,AE,2014.0,31,31,0
CA,ID,2018.0,62,46,16
IT,HR,2015.0,7,3,4
PT,ZA,2020.0,3,7,-4
FI,ES,2011.0,16,23,-7
KW,SA,2012.0,12,2,10
UG,US,2014.0,40,34,6
LT,RU,2016.0,11,6,5
EG,JP,2012.0,63,89,-26
FR,AE,2021.0,23,5,18
LU,IT,2022.0,5,4,1
US,PA,2019.0,55,70,-15
AU,TW,2012.0,30,34,-4
KE,US,2017.0,74,92,-18
US,NG,2019.0,170,147,23
KP,KR,2018.0,6,13,-7
CY,IR,2019.0,9,9,0
nan,IT,2010.0,116,80,36
GB,CY,2019.0,62,41,21
IE,CA,2006.0,89,75,14
CZ,IT,1999.0,12,12,0
GB,LU,2005.0,8,3,5
NG,IN,2006.0,9,2,7
BD,ID,2021.0,41,49,-8
ID,NL,2011.0,16,17,-1
BR,SE,2014.0,25,11,14
FR,IR,2018.0,42,33,9
PA,MX,2015.0,6,9,-3
KE,US,2019.0,105,106,-1
IN,MY,2002.0,12,5,7
IT,AM,2018.0,42,26,16
NZ,OM,2014.0,4,1,3
IT,CH,2003.0,119,134,-15
BG,GB,2014.0,12,19,-7
DE,HR,2018.0,23,24,-1
US,KW,2017.0,27,24,3
GB,DK,2022.0,108,78,30
ET,AU,2022.0,17,10,7
BR,MY,2019.0,27,68,-41
UA,LT,2017.0,4,1,3
FI,NL,2007.0,45,38,7
CN,BR,2008.0,34,35,-1
GB,PE,2019.0,18,15,3
RS,RU,2016.0,9,8,1
IN,TH,2014.0,11,14,-3
PT,BE,2014.0,20,14,6
SG,ID,2016.0,26,11,15
GB,CO,2014.0,20,26,-6
SK,IT,2022.0,5,2,3
GT,ES,2014.0,12,5,7
RS,US,2001.0,23,21,2
GR,DK,2018.0,17,5,12
IT,DZ,2020.0,47,32,15
PK,PS,2016.0,4,1,3
UA,PL,2015.0,40,19,21
BE,nan,2012.0,20,25,-5
ID,KR,2017.0,16,50,-34
TH,CN,2009.0,12,11,1
CN,BN,2021.0,2,2,0
JM,TT,2020.0,13,13,0
UA,LT,2019.0,2,3,-1
IN,FJ,2015.0,8,3,5
CN,BD,2017.0,38,104,-66
SA,GB,2020.0,81,226,-145
KE,US,2010.0,43,56,-13
FR,AT,2013.0,56,44,12
FR,UA,2001.0,9,7,2
SG,DE,2018.0,50,40,10
IT,EG,2017.0,11,7,4
NL,UA,2019.0,7,1,6
UA,CN,2001.0,4,19,-15
ZA,SG,2017.0,2,2,0
CN,AR,2010.0,3,2,1
CN,PH,1999.0,2,15,-13
DE,RU,2002.0,107,172,-65
VN,RU,2018.0,8,17,-9
CH,KR,2015.0,7,18,-11
LK,ID,2017.0,14,10,4
CO,ID,2017.0,9,1,8
QA,PS,2017.0,1,3,-2
ZA,DK,2006.0,5,4,1
CZ,IN,1999.0,5,5,0
PE,ID,2017.0,1,2,-1
JP,FR,2002.0,54,61,-7
KR,MM,2018.0,3,3,0
IE,CH,2007.0,4,6,-2
LB,GB,2018.0,8,6,2
AT,nan,2019.0,10,20,-10
MX,FR,2007.0,36,39,-3
PL,RU,2021.0,27,40,-13
MY,QA,2013.0,2,2,0
ZA,ZW,2015.0,30,40,-10
MX,RU,2022.0,6,3,3
AR,CA,2018.0,31,30,1
CL,TH,2021.0,1,1,0
FR,RO,2021.0,25,33,-8
IQ,GB,2014.0,12,43,-31
TW,nan,2009.0,9,6,3
US,BG,2004.0,26,29,-3
BR,DO,2014.0,2,2,0
CN,IE,2021.0,28,33,-5
AR,FR,2018.0,108,105,3
CL,DE,2012.0,31,38,-7
MX,SI,2020.0,4,14,-10
BO,US,2017.0,7,6,1
BO,ES,2021.0,13,14,-1
US,FR,1999.0,671,832,-161
CA,BE,2017.0,66,67,-1
QA,SA,2019.0,26,51,-25
CA,CN,1999.0,141,115,26
JP,ID,2007.0,79,18,61
GB,IR,2017.0,111,88,23
PL,nan,2017.0,16,15,1
CA,SN,2015.0,6,4,2
CZ,IL,2001.0,2,2,0
NG,BD,2021.0,7,2,5
RW,TZ,2015.0,1,1,0
CN,RS,2001.0,5,2,3
GB,CY,2010.0,32,13,19
JP,IR,2009.0,26,20,6
QA,IQ,2019.0,12,9,3
BO,US,2019.0,9,8,1
IT,AT,2021.0,61,56,5
TN,FR,2020.0,171,166,5
ZA,NA,2020.0,17,5,12
FI,FR,2009.0,15,17,-2
IR,PL,2008.0,7,3,4
FR,SI,2020.0,9,6,3
ES,EE,2010.0,3,1,2
AU,NO,2016.0,31,15,16
MA,US,2002.0,13,13,0
JO,CA,2007.0,7,3,4
JP,TZ,2021.0,2,6,-4
BE,MZ,2016.0,3,5,-2
CZ,GB,2000.0,13,10,3
ID,US,2004.0,22,21,1
HU,CA,2014.0,9,13,-4
BR,RU,2008.0,8,11,-3
MZ,PL,2000.0,10,2,8
RU,BE,2014.0,17,17,0
GR,ES,2020.0,15,17,-2
BR,UY,2001.0,12,14,-2
JP,CL,2015.0,3,6,-3
NG,US,2013.0,69,60,9
NA,NL,2015.0,1,1,0
FR,PL,2020.0,49,41,8
FR,GR,2007.0,25,19,6
BW,MW,2005.0,1,1,0
FI,CH,2018.0,26,23,3
DE,SA,2009.0,13,4,9
UA,CZ,2011.0,25,9,16
IT,MA,2005.0,10,5,5
nan,SE,2007.0,84,55,29
ZA,IT,2021.0,18,19,-1
BR,NL,2004.0,16,24,-8
SE,TH,2008.0,4,6,-2
UA,RO,2014.0,3,2,1
TR,AT,2018.0,18,5,13
BE,VN,2022.0,7,7,0
IQ,PK,2020.0,26,28,-2
MK,GB,2020.0,5,2,3
TR,DE,2011.0,62,57,5
GW,DK,2015.0,3,3,0
PL,DK,2014.0,7,13,-6
JM,GP,2018.0,1,4,-3
KW,US,2002.0,14,9,5
JP,NL,2009.0,29,28,1
TR,AU,2016.0,13,11,2
BJ,DE,2015.0,2,1,1
DK,ZA,2021.0,7,4,3
IT,GR,2007.0,15,15,0
PE,CU,2016.0,9,16,-7
GB,PH,2016.0,23,9,14
AR,CU,2014.0,18,18,0
NO,NP,2019.0,4,3,1
YE,SA,2014.0,5,3,2
DE,CI,2014.0,2,1,1
JP,UA,2001.0,8,9,-1
HU,CZ,2018.0,10,10,0
BF,FR,2016.0,13,16,-3
UA,ES,2014.0,3,4,-1
CA,BE,2019.0,69,78,-9
US,ZM,2011.0,10,13,-3
TR,nan,2019.0,24,39,-15
GB,LY,2007.0,4,1,3
nan,UA,2002.0,15,11,4
RU,HU,2008.0,7,5,2
CA,CL,2006.0,16,12,4
EG,DK,2005.0,1,1,0
IR,JP,2013.0,23,23,0
KE,GB,2018.0,35,31,4
RU,TW,2007.0,15,14,1
PL,nan,2019.0,27,14,13
PL,CH,2006.0,19,11,8
ES,AT,2001.0,5,9,-4
AT,SK,2010.0,13,14,-1
SG,KR,2018.0,51,49,2
GB,MY,2012.0,181,75,106
BD,US,1997.0,9,12,-3
BR,BE,2007.0,35,48,-13
MG,CN,2016.0,5,5,0
CN,NP,2008.0,5,2,3
KR,PL,2016.0,2,3,-1
CN,TG,2019.0,2,1,1
CH,SE,2007.0,45,55,-10
ES,RS,2019.0,4,3,1
IR,KW,2022.0,3,1,2
TR,NL,2010.0,26,18,8
PT,AT,2016.0,6,6,0
RU,nan,2014.0,31,73,-42
TH,CA,2019.0,13,17,-4
US,PA,2017.0,58,60,-2
US,SK,2001.0,14,29,-15
CA,JO,2013.0,11,12,-1
nan,RU,2020.0,42,48,-6
IN,BR,2018.0,46,40,6
PL,CN,2010.0,34,40,-6
EC,DE,2014.0,4,5,-1
ZM,GB,2020.0,10,9,1
MX,GB,2008.0,40,59,-19
FR,ID,2013.0,23,14,9
GB,IR,2010.0,104,64,40
CN,ZW,2001.0,1,1,0
TH,VN,2017.0,13,8,5
TR,nan,2017.0,22,25,-3
DE,PK,2008.0,10,7,3
GR,FR,2016.0,53,35,18
US,GT,2019.0,9,15,-6
RO,MX,2019.0,2,1,1
MX,HN,2018.0,22,21,1
TR,JP,2011.0,35,38,-3
CN,TH,2012.0,18,21,-3
MX,PT,2009.0,13,11,2
SK,FR,2009.0,10,9,1
ID,UZ,2020.0,1,1,0
TH,CA,2010.0,12,16,-4
ML,GB,2018.0,2,2,0
VN,AU,2013.0,19,19,0
QA,IQ,2017.0,11,5,6
PS,ES,2012.0,17,15,2
US,TG,2019.0,2,2,0
CL,nan,2017.0,4,6,-2
ZA,NO,2021.0,12,2,10
GB,BD,2000.0,13,9,4
CA,BW,2019.0,2,1,1
SE,IL,2018.0,10,6,4
BJ,US,2018.0,6,3,3
AT,CA,2011.0,21,27,-6
CA,SA,2001.0,24,8,16
IT,PH,2006.0,3,1,2
CA,GH,2014.0,5,5,0
CA,TN,2008.0,10,5,5
SI,US,2001.0,20,4,16
AT,RU,2022.0,12,13,-1
TW,TR,2018.0,8,5,3
SK,CZ,2002.0,35,21,14
RS,CN,2012.0,6,13,-7
SA,IQ,2015.0,16,8,8
FR,CI,2006.0,15,12,3
EC,RU,2017.0,12,3,9
IT,RS,2016.0,8,8,0
AT,JP,2008.0,18,13,5
CO,GB,2016.0,27,38,-11
TW,CA,2007.0,37,43,-6
OM,EG,2020.0,18,13,5
AT,TW,2019.0,3,4,-1
BD,TH,2022.0,7,2,5
DE,NG,2020.0,16,13,3
DE,GR,2017.0,40,86,-46
ID,CZ,2017.0,8,15,-7
RU,BY,2015.0,49,98,-49
PT,nan,2005.0,10,13,-3
KR,VN,2009.0,16,16,0
VN,TH,2010.0,4,6,-2
BR,TR,2003.0,9,4,5
CA,KZ,2008.0,1,1,0
CH,HU,2001.0,5,4,1
GB,CL,2009.0,26,28,-2
IT,TR,2007.0,10,15,-5
DE,SI,2002.0,8,6,2
DK,IS,2015.0,6,9,-3
ZA,IN,2005.0,13,18,-5
BR,MY,2010.0,54,163,-109
NG,ZA,2012.0,27,28,-1
CH,DK,2000.0,13,16,-3
TN,DE,2020.0,7,8,-1
NO,AT,2022.0,7,11,-4
ZA,IN,2002.0,11,5,6
GB,LT,2015.0,8,3,5
US,CW,2018.0,1,1,0
PH,FR,2013.0,7,6,1
IQ,BG,2014.0,1,1,0
US,JM,2008.0,10,14,-4
CG,FR,2019.0,11,15,-4
IE,CZ,2006.0,1,1,0
HR,ES,2007.0,5,2,3
ES,HR,2008.0,3,3,0
SI,PL,2003.0,3,1,2
MA,TN,2013.0,34,21,13
GB,OM,1998.0,6,1,5
IN,DK,1997.0,3,2,1
GR,NL,2005.0,13,9,4
KE,BE,2011.0,4,3,1
KR,AU,2007.0,30,18,12
SS,GB,2013.0,10,6,4
PL,SK,2021.0,9,6,3
ES,HU,2021.0,7,4,3
BY,US,2013.0,10,12,-2
VN,DE,2018.0,17,37,-20
GB,PE,2017.0,10,10,0
DE,SI,2005.0,10,6,4
IT,EG,2019.0,20,14,6
NZ,ZA,2007.0,10,11,-1
AT,SI,2009.0,8,9,-1
TR,NZ,2013.0,4,1,3
IS,SE,2011.0,22,12,10
PT,ES,1998.0,23,25,-2
DE,BD,2014.0,7,13,-6
KR,NP,2011.0,7,4,3
GB,TR,2003.0,51,17,34
RO,HK,2014.0,11,25,-14
EE,FI,2016.0,16,14,2
SK,US,2016.0,25,30,-5
US,NG,2010.0,30,34,-4
BE,IE,2011.0,8,7,1
LU,FR,1998.0,7,7,0
DE,UY,2009.0,3,2,1
PT,ES,1997.0,14,19,-5
HU,AU,2009.0,11,8,3
IN,PH,2022.0,13,8,5
BE,GR,2017.0,17,24,-7
nan,JP,1997.0,43,56,-13
ES,AU,2006.0,16,18,-2
EG,DK,2002.0,2,3,-1
FR,IL,2002.0,25,27,-2
SE,BE,2023.0,2,3,-1
EG,QA,2022.0,32,36,-4
LT,FI,2015.0,4,2,2
HU,DE,2012.0,60,59,1
US,UY,2018.0,23,27,-4
CN,RO,2015.0,11,3,8
CH,BD,2016.0,5,4,1
RU,IN,2015.0,24,20,4
TN,SA,2008.0,8,2,6
PK,SA,1997.0,5,3,2
GB,TW,2013.0,68,45,23
nan,CH,1998.0,8,4,4
GB,KR,1997.0,10,10,0
BY,CN,2016.0,1,6,-5
AU,CL,2021.0,20,24,-4
KH,JP,2019.0,8,13,-5
GE,AU,2009.0,4,1,3
TW,VN,2014.0,19,10,9
US,CU,2016.0,17,46,-29
JP,ES,2009.0,35,29,6
CO,PT,2018.0,20,17,3
CL,CH,2012.0,12,10,2
HR,TW,2002.0,1,1,0
AZ,RU,2022.0,9,11,-2
GB,KR,1998.0,23,13,10
DK,NL,2006.0,29,16,13
PT,RS,2017.0,1,1,0
AU,MA,2012.0,1,1,0
HR,BA,2021.0,27,34,-7
JP,NP,2020.0,12,4,8
KR,TH,2012.0,11,10,1
ZM,US,2016.0,20,13,7
PK,YE,2016.0,1,1,0
YE,PK,2020.0,5,1,4
NG,DE,2014.0,7,11,-4
SA,DZ,2021.0,6,8,-2
BG,RU,2015.0,54,21,33
AU,DK,2002.0,25,19,6
GE,CA,2013.0,2,1,1
NP,NL,2016.0,4,3,1
PY,PT,2004.0,3,3,0
KW,US,2005.0,10,10,0
QA,AU,2008.0,10,5,5
FI,GR,2007.0,2,4,-2
EG,FR,2000.0,3,6,-3
JP,AM,2004.0,8,5,3
RU,DK,2014.0,9,7,2
CL,nan,2010.0,3,5,-2
IN,OM,1999.0,1,5,-4
PK,nan,2003.0,4,3,1
GR,CN,2011.0,19,21,-2
MN,CN,2015.0,6,6,0
NL,ZA,1998.0,3,2,1
ZW,CN,2003.0,2,1,1
CN,UA,2009.0,14,12,2
PE,nan,2016.0,8,10,-2
UZ,UA,1998.0,5,2,3
ES,SI,2021.0,10,12,-2
TW,NO,2022.0,2,1,1
CM,GB,2018.0,6,8,-2
KR,ZA,2016.0,9,4,5
PT,EC,2022.0,4,2,2
FR,PT,2003.0,36,20,16
CW,NL,2003.0,5,12,-7
IQ,QA,2011.0,1,2,-1
PH,BE,2015.0,3,4,-1
FI,HU,2014.0,6,3,3
FR,MK,2013.0,2,1,1
UY,CL,2003.0,3,3,0
PH,CN,2004.0,15,11,4
FR,JO,2014.0,4,1,3
JO,KW,2016.0,9,5,4
KR,ES,2012.0,6,8,-2
US,DZ,2022.0,18,23,-5
AU,ID,2004.0,12,7,5
ET,CA,2017.0,3,4,-1
CH,SA,2021.0,4,6,-2
IR,DK,2023.0,3,1,2
SA,AT,2009.0,3,4,-1
IT,EG,2010.0,8,3,5
KE,TZ,2011.0,4,2,2
LK,CA,2020.0,11,6,5
SE,IE,2007.0,8,4,4
TN,CA,2016.0,11,20,-9
AE,PK,2011.0,5,4,1
IT,PL,2002.0,11,14,-3
RO,PT,2019.0,3,3,0
IS,US,2017.0,14,28,-14
EC,UY,2020.0,10,2,8
GB,VE,2011.0,7,1,6
BR,MY,2017.0,39,68,-29
NO,NP,2010.0,4,6,-2
CA,SG,2001.0,18,19,-1
CG,FR,2010.0,14,13,1
SE,AT,2005.0,14,8,6
BR,AO,2006.0,8,9,-1
IE,PK,2021.0,10,13,-3
IN,SD,2021.0,1,1,0
HK,CZ,2018.0,1,1,0
DE,CU,2011.0,3,3,0
CZ,HU,2022.0,9,6,3
DK,SK,2016.0,3,1,2
DK,IE,1998.0,1,1,0
AT,SK,2019.0,14,15,-1
OM,JO,2004.0,3,1,2
GM,FR,2010.0,1,1,0
ES,SG,2014.0,10,5,5
IN,ID,2009.0,8,2,6
ZW,GB,2005.0,7,2,5
TR,KR,2020.0,9,5,4
BI,KE,2015.0,1,1,0
BR,NO,2003.0,10,10,0
UY,AU,2016.0,5,2,3
HR,AT,1999.0,2,1,1
NO,ZA,2012.0,4,9,-5
LT,DE,2012.0,6,3,3
BY,UA,2013.0,5,9,-4
JP,RU,2006.0,37,25,12
AT,nan,2017.0,18,17,1
XK,RS,2007.0,6,3,3
SD,EG,2014.0,16,11,5
nan,HU,2000.0,1,4,-3
JP,NO,2009.0,7,7,0
AT,CZ,2011.0,15,16,-1
HU,IT,2013.0,8,11,-3
KR,LK,2015.0,5,3,2
CU,LB,2005.0,2,2,0
SE,IS,2007.0,18,11,7
PK,AR,2009.0,5,13,-8
ET,BE,2011.0,4,3,1
DK,QA,2018.0,3,1,2
SE,IR,2004.0,5,2,3
NL,HK,2016.0,18,23,-5
DK,NG,2021.0,1,1,0
ID,GH,2014.0,4,4,0
GB,PS,2018.0,9,4,5
IL,RU,2003.0,14,15,-1
KE,ES,2012.0,1,1,0
MG,FR,2002.0,3,5,-2
HK,CA,2010.0,4,5,-1
PL,HU,2015.0,21,8,13
ZA,SA,2015.0,7,5,2
DZ,FR,2004.0,33,30,3
FI,IT,2004.0,11,5,6
RO,nan,2014.0,1,1,0
TR,DK,2012.0,5,6,-1
VN,JP,2009.0,14,34,-20
MA,US,2005.0,9,6,3
GB,FJ,2010.0,1,2,-1
LY,SA,2005.0,2,1,1
BD,AU,2008.0,10,14,-4
US,TZ,2002.0,5,7,-2
US,VG,2016.0,7,21,-14
ES,IN,2021.0,13,22,-9
MA,JP,2004.0,2,1,1
ZA,NL,2004.0,15,23,-8
IN,GR,1997.0,3,1,2
MA,NL,2014.0,1,2,-1
AU,CZ,2003.0,6,3,3
FR,VE,1998.0,6,2,4
IN,GR,1998.0,1,3,-2
PT,TR,2017.0,2,2,0
NG,EG,2007.0,3,1,2
CN,UZ,2016.0,1,4,-3
CN,MX,2004.0,3,5,-2
EG,PL,2005.0,2,2,0
UY,SE,2012.0,3,2,1
MG,FR,2005.0,5,2,3
QA,SA,2017.0,15,25,-10
RU,MD,1998.0,6,4,2
TW,ZA,2013.0,4,1,3
ML,BF,2021.0,3,5,-2
US,TG,2010.0,1,1,0
IE,IN,2008.0,11,28,-17
BH,PK,2015.0,1,1,0
CY,IR,2017.0,4,10,-6
ES,PH,2004.0,6,2,4
ES,RS,2010.0,2,1,1
TW,CH,2007.0,3,5,-2
VE,AR,2002.0,7,6,1
SG,GB,1997.0,7,15,-8
OM,DE,2021.0,4,1,3
BR,FI,2015.0,5,8,-3
NZ,IE,2017.0,18,17,1
QA,PK,2017.0,10,11,-1
nan,BR,1998.0,6,6,0
KR,CO,2018.0,2,1,1
BE,BR,2001.0,21,10,11
US,GT,2010.0,6,7,-1
TN,MY,2015.0,4,1,3
RS,ES,2005.0,2,2,0
JP,SI,2002.0,3,1,2
AF,US,2017.0,5,5,0
PT,MX,2000.0,7,5,2
JP,CO,2018.0,9,8,1
LB,IL,2012.0,1,1,0
nan,TW,2012.0,4,6,-2
PE,CR,2015.0,13,10,3
AR,nan,2006.0,8,22,-14
QA,IR,2020.0,6,7,-1
AU,AR,2004.0,3,6,-3
SA,BD,2015.0,17,20,-3
AM,FR,2015.0,3,2,1
CR,BR,2018.0,14,17,-3
EC,CA,2018.0,6,9,-3
SI,GB,2008.0,9,11,-2
VE,BE,2007.0,1,1,0
ES,AE,2018.0,5,1,4
CN,NG,2008.0,4,3,1
BE,CO,2008.0,3,3,0
NL,UA,2017.0,5,4,1
CH,TW,2013.0,8,9,-1
UA,FR,2018.0,12,14,-2
IN,DK,1998.0,5,5,0
IE,EE,2020.0,1,2,-1
NO,CN,1998.0,2,3,-1
KR,RU,2002.0,7,9,-2
JO,AU,1999.0,1,1,0
CA,CI,2008.0,2,2,0
MY,GB,2004.0,25,33,-8
ES,AF,2018.0,2,1,1
EG,IN,2018.0,7,25,-18
RO,KR,2019.0,2,1,1
RO,NL,2015.0,8,7,1
IL,EG,2017.0,5,7,-2
NL,TZ,2021.0,4,2,2
GH,ZM,2011.0,18,6,12
SY,GB,2021.0,3,5,-2
IN,MU,2017.0,3,3,0
TN,BD,2019.0,2,1,1
MM,US,2020.0,17,12,5
MX,AU,2014.0,21,12,9
RW,BE,2017.0,1,2,-1
PT,TR,2019.0,3,3,0
BN,AU,2015.0,3,4,-1
KZ,IQ,2021.0,1,1,0
SA,SK,2019.0,1,1,0
ET,CA,2019.0,6,9,-3
EE,CH,2020.0,9,8,1
ZA,CM,2013.0,2,1,1
CG,FR,2017.0,8,15,-7
TR,BE,2011.0,14,11,3
IT,AE,2016.0,16,3,13
RS,PK,2014.0,4,3,1
JP,LB,2020.0,2,1,1
KZ,RU,2010.0,14,15,-1
IN,SY,2012.0,1,1,0
PT,CU,2016.0,1,2,-1
IT,SK,1997.0,5,1,4
PH,CO,2016.0,3,4,-1
PR,US,2014.0,5,11,-6
QA,PK,2019.0,11,19,-8
PK,IT,2012.0,7,10,-3
HK,CA,2017.0,4,5,-1
US,KH,2011.0,2,2,0
AU,DK,2005.0,22,19,3
KE,JP,2000.0,3,5,-2
BH,TZ,2005.0,2,2,0
RU,BR,2022.0,3,9,-6
NP,CH,2016.0,2,1,1
JM,FR,1997.0,1,1,0
ES,LK,2010.0,2,4,-2
NL,RO,2011.0,7,7,0
BE,LB,2013.0,7,3,4
IT,UA,2022.0,4,9,-5
IN,UA,2014.0,6,6,0
ZW,NL,2010.0,3,1,2
HK,DE,2006.0,3,1,2
BO,PE,2021.0,3,4,-1
NG,CM,2005.0,1,1,0
VE,DE,2016.0,3,6,-3
BJ,GH,2019.0,1,3,-2
TG,FR,2020.0,6,5,1
UA,IQ,2021.0,1,1,0
CL,DK,2016.0,4,2,2
PK,AE,2005.0,5,1,4
FJ,US,2013.0,6,2,4
KH,JP,2010.0,5,5,0
MX,DZ,2010.0,1,1,0
GB,TZ,1997.0,2,1,1
AE,US,2003.0,7,16,-9
ES,LK,2017.0,4,3,1
nan,UA,2005.0,14,8,6
IL,FI,2008.0,2,1,1
GR,NL,2002.0,7,12,-5
MA,BD,2020.0,11,15,-4
ID,ES,2022.0,9,4,5
HK,BE,2015.0,1,1,0
MX,GR,2016.0,4,2,2
CH,nan,2009.0,13,13,0
KR,RU,2005.0,11,18,-7
MX,IN,2004.0,7,7,0
IN,JO,2018.0,1,3,-2
US,BO,2022.0,7,1,6
DE,GH,2011.0,8,3,5
HK,CA,2019.0,4,5,-1
AT,NO,2020.0,16,14,2
BH,nan,2019.0,3,1,2
IN,ML,2009.0,7,2,5
NZ,IE,2010.0,15,10,5
ID,KR,2010.0,3,5,-2
RO,LT,2004.0,2,3,-1
MA,ES,1999.0,3,1,2
RW,BE,2010.0,3,2,1
nan,AT,2001.0,7,8,-1
SE,AT,2002.0,6,9,-3
CA,BB,2004.0,1,1,0
EC,BR,2003.0,3,2,1
HR,CA,2006.0,1,5,-4
NP,JP,2004.0,3,3,0
MX,FI,2012.0,1,2,-1
TR,NL,2017.0,28,29,-1
CN,EC,2020.0,3,3,0
CO,NZ,2021.0,3,3,0
BR,PH,2007.0,5,5,0
ES,LU,2007.0,2,1,1
EC,RU,2010.0,1,3,-2
GD,CA,2008.0,2,2,0
AE,IT,2009.0,1,3,-2
AU,GR,2022.0,9,1,8
CH,CO,2014.0,7,8,-1
IL,IN,2013.0,19,31,-12
AR,PY,2013.0,2,1,1
AT,TW,2017.0,2,2,0
CH,PK,2001.0,7,3,4
SE,GH,2016.0,2,1,1
AO,US,2013.0,3,1,2
UA,AT,2013.0,4,2,2
LK,ID,2010.0,3,2,1
MA,GB,2022.0,4,3,1
SN,CA,2014.0,5,8,-3
VN,NL,2007.0,3,2,1
ZA,KE,2006.0,6,3,3
SV,CO,2009.0,2,1,1
DE,KZ,2003.0,4,1,3
IR,IL,2012.0,1,2,-1
PK,SA,1998.0,7,3,4
AU,TH,2001.0,8,6,2
DE,UA,1999.0,13,29,-16
IN,NP,1999.0,4,4,0
EC,RU,2019.0,4,4,0
US,TZ,2005.0,3,6,-3
SA,PS,2014.0,7,5,2
CN,UG,2006.0,2,1,1
ZA,TZ,2022.0,4,8,-4
PS,EG,2005.0,2,1,1
ES,LK,2019.0,1,4,-3
CA,ET,2011.0,3,1,2
KE,DE,2000.0,3,3,0
KE,CO,2022.0,1,3,-2
IE,RU,2011.0,7,2,5
AL,US,2018.0,4,6,-2
TZ,NG,2015.0,1,3,-2
VN,BE,2013.0,8,4,4
SK,BG,2019.0,2,1,1
IR,MA,2012.0,4,3,1
MX,BE,2008.0,2,10,-8
NL,TH,2007.0,8,3,5
NO,IR,2021.0,7,29,-22
NZ,NP,2001.0,4,1,3
MX,KR,2006.0,3,2,1
GH,DE,2016.0,9,10,-1
GB,GH,2006.0,8,8,0
ZA,UG,2004.0,1,2,-1
BE,RO,2005.0,9,5,4
US,KN,2011.0,6,3,3
NO,PT,2020.0,6,8,-2
BD,US,1998.0,18,6,12
NZ,TW,2001.0,2,1,1
TR,EG,2014.0,7,4,3
BA,DE,2015.0,4,2,2
US,HN,2014.0,4,8,-4
PY,EC,2021.0,1,6,-5
NG,UG,2023.0,1,1,0
IR,GH,2019.0,1,1,0
ZA,PA,2016.0,1,2,-1
IT,LT,2006.0,3,1,2
GB,VN,2004.0,5,4,1
BE,ET,2007.0,3,3,0
UA,IT,2004.0,12,8,4
UZ,DE,2013.0,3,1,2
CH,AR,2001.0,3,2,1
CH,EG,2015.0,11,4,7
IN,PL,2002.0,6,4,2
CN,AR,2019.0,6,2,4
HR,CH,2020.0,9,5,4
LK,ID,2019.0,9,8,1
RU,KR,2008.0,16,9,7
PH,IT,2021.0,4,2,2
BE,PL,1999.0,5,3,2
TZ,FR,2018.0,2,1,1
TR,KH,2019.0,3,1,2
ES,ET,2019.0,7,1,6
ZA,NG,2005.0,9,7,2
PL,LU,2016.0,4,5,-1
US,BT,2015.0,1,1,0
VG,GB,1997.0,1,1,0
MY,NG,2003.0,2,1,1
PL,MZ,2003.0,3,10,-7
SE,ET,1999.0,4,4,0
NZ,TR,2021.0,3,3,0
DK,EG,2013.0,5,1,4
SA,NG,1997.0,1,3,-2
MX,TW,2003.0,1,1,0
ID,CH,2022.0,4,1,3
ES,NI,1997.0,2,1,1
ES,NZ,2007.0,1,6,-5
CN,VG,2010.0,2,2,0
KZ,IR,2020.0,2,2,0
BO,MX,2021.0,4,9,-5
GB,ET,2003.0,3,5,-2
DZ,GB,2003.0,2,2,0
CN,KZ,2009.0,5,4,1
IS,DK,2014.0,6,6,0
EG,MY,2007.0,6,8,-2
TN,HU,2017.0,1,1,0
IL,DK,1997.0,3,3,0
SG,SD,2021.0,1,1,0
BR,BO,2016.0,4,5,-1
CO,RO,2010.0,1,1,0
SD,KE,2002.0,3,2,1
GB,HR,2009.0,7,10,-3
KR,NL,2002.0,4,4,0
KW,EG,2002.0,8,4,4
UG,DE,2016.0,4,3,1
DZ,TR,2018.0,2,5,-3
AZ,TR,2021.0,13,11,2
ZA,PL,2021.0,7,4,3
IL,EG,2019.0,5,2,3
TH,BR,2016.0,5,1,4
TZ,CN,2021.0,6,10,-4
CR,DE,2020.0,7,1,6
BE,RO,2002.0,10,7,3
SE,RW,2018.0,3,3,0
RS,XK,2007.0,3,6,-3
IT,BJ,2005.0,2,1,1
MD,RU,2010.0,4,3,1
TH,MY,2011.0,2,2,0
CY,CA,2016.0,5,4,1
CN,JO,2013.0,3,3,0
VN,TH,2019.0,7,22,-15
QA,NL,2014.0,2,5,-3
KE,NL,2020.0,5,9,-4
IL,PS,2008.0,3,1,2
KE,NZ,2007.0,1,1,0
NP,NO,2016.0,2,6,-4
VE,CO,2004.0,6,14,-8
GR,nan,2020.0,2,6,-4
KR,FI,2012.0,2,6,-4
IR,TN,2021.0,4,3,1
PE,IT,2006.0,1,3,-2
PT,nan,2002.0,9,5,4
US,TJ,2017.0,1,2,-1
MX,RO,2020.0,2,2,0
CA,GD,2008.0,2,2,0
EG,JO,2007.0,3,2,1
BE,GR,2010.0,13,18,-5
HN,AR,2015.0,7,3,4
MY,CZ,2014.0,5,4,1
EG,MA,2015.0,8,5,3
CH,MA,2016.0,4,6,-2
AT,TH,2008.0,3,2,1
ZA,QA,2021.0,1,3,-2
BE,KE,2006.0,3,1,2
EE,SE,2009.0,2,14,-12
RS,DK,1999.0,1,2,-1
MY,AE,2003.0,1,2,-1
GB,FJ,2019.0,3,3,0
GB,OM,1997.0,5,4,1
BJ,BR,2017.0,1,2,-1
AE,IL,2014.0,2,3,-1
TH,VN,2010.0,6,4,2
MG,BE,2016.0,3,2,1
UY,CH,2016.0,1,3,-2
KR,NL,2005.0,3,7,-4
CR,nan,2014.0,4,1,3
BD,NP,2007.0,2,3,-1
IT,HU,2021.0,8,11,-3
KR,HK,2016.0,3,1,2
KW,CA,2014.0,5,18,-13
AE,JO,2007.0,3,7,-4
US,BB,2020.0,6,3,3
ES,EE,2017.0,5,3,2
FI,SA,2018.0,1,1,0
NL,HR,2016.0,6,3,3
HU,IR,2021.0,2,6,-4
IN,EG,2007.0,3,2,1
FR,VE,1997.0,2,2,0
IN,MM,2019.0,2,2,0
CZ,BG,2020.0,3,3,0
AU,QA,2012.0,6,11,-5
CU,CR,2003.0,1,1,0
BY,SK,2005.0,3,3,0
QA,TN,2009.0,1,3,-2
NA,ZA,2012.0,5,7,-2
RS,BG,2003.0,3,2,1
LV,GB,2014.0,5,2,3
KE,ZM,2016.0,3,1,2
PA,FR,2018.0,3,1,2
GR,AL,2020.0,3,1,2
BG,CA,1999.0,2,1,1
AZ,IR,2013.0,8,3,5
DE,MD,2000.0,2,4,-2
MG,CF,2008.0,1,1,0
OM,BH,2019.0,2,1,1
AT,NZ,2011.0,4,5,-1
AR,AU,2003.0,7,4,3
GB,GM,1999.0,2,6,-4
TH,SA,2020.0,1,1,0
CO,RO,2017.0,2,1,1
CH,MX,2003.0,5,4,1
AU,HK,2011.0,2,6,-4
ES,CZ,2006.0,2,6,-4
CL,PK,2014.0,1,1,0
PT,ID,2021.0,2,3,-1
AE,ES,2021.0,1,3,-2
ES,SA,2011.0,3,3,0
TH,KR,2003.0,6,3,3
AE,MY,2004.0,3,3,0
AO,IT,2003.0,2,1,1
BG,IT,2003.0,5,3,2
HU,AM,2014.0,3,1,2
MY,ES,2018.0,5,5,0
CH,UY,2010.0,1,2,-1
VN,FR,2008.0,7,12,-5
PK,BF,2002.0,1,1,0
US,MW,2015.0,12,14,-2
GR,RU,2006.0,1,7,-6
NO,CY,2018.0,3,2,1
TJ,RU,2005.0,6,2,4
TW,PH,2013.0,6,3,3
KE,ID,2018.0,9,4,5
RO,BD,2019.0,2,1,1
UY,CA,2020.0,4,2,2
PK,QA,2012.0,3,1,2
NL,PH,2021.0,1,4,-3
VN,BR,2018.0,1,4,-3
AO,ES,2019.0,2,4,-2
JO,IE,2020.0,5,1,4
IE,HR,2015.0,3,4,-1
AF,IQ,2022.0,1,1,0
BD,SE,2004.0,1,1,0
RS,FI,2021.0,2,1,1
VE,CA,2012.0,4,4,0
XK,DE,2015.0,2,1,1
NO,CN,1997.0,4,1,3
VN,CA,2015.0,5,15,-10
EG,TZ,2021.0,2,3,-1
GB,AE,2001.0,10,7,3
HU,NL,2001.0,6,5,1
BD,ZA,2021.0,1,2,-1
TT,GB,1998.0,1,4,-3
IL,IR,2021.0,3,2,1
LY,CN,2015.0,1,1,0
FI,NP,2018.0,1,3,-2
BY,MZ,2011.0,3,1,2
RS,SI,2011.0,6,16,-10
CU,GB,2004.0,3,1,2
AT,EG,2021.0,2,3,-1
ES,RS,2017.0,2,5,-3
LK,DE,2017.0,2,3,-1
HU,GR,2014.0,3,2,1
ZW,GB,2002.0,4,5,-1
KH,JP,2017.0,2,6,-4
US,BN,2010.0,3,1,2
NO,IT,2010.0,7,14,-7
QA,BD,2013.0,2,2,0
TZ,KR,2013.0,2,2,0
KE,PK,2004.0,2,3,-1
ID,CM,2022.0,2,2,0
ZA,AT,2005.0,1,2,-1
US,KG,2020.0,5,3,2
LB,AE,2015.0,7,1,6
IT,IR,2008.0,2,12,-10
IT,IQ,2019.0,3,3,0
DO,ES,2014.0,4,6,-2
CN,AR,2017.0,1,5,-4
CN,EE,2013.0,2,1,1
KE,ZA,2009.0,6,10,-4
TZ,GB,2001.0,1,1,0
NL,BA,2016.0,1,4,-3
BW,AU,2013.0,2,3,-1
GB,AM,2018.0,1,7,-6
TW,DK,2017.0,3,6,-3
BH,QA,2022.0,1,2,-1
ID,IR,2012.0,4,4,0
CL,IE,2009.0,1,2,-1
PK,HU,2018.0,4,2,2
GB,DZ,2007.0,4,1,3
ET,CA,2010.0,3,1,2
CL,JP,2021.0,2,3,-1
BG,IE,2015.0,1,2,-1
UZ,TW,2021.0,1,1,0
CH,QA,2015.0,1,2,-1
IL,DK,1998.0,2,1,1
PT,TR,2010.0,2,3,-1
ES,NI,1998.0,1,1,0
IL,CO,2012.0,1,1,0
ZW,CA,1999.0,2,1,1
LK,US,2023.0,1,1,0
MD,IT,2016.0,2,3,-1
OM,PK,2013.0,2,7,-5
PL,PH,2014.0,2,1,1
IN,PL,2005.0,3,7,-4
ID,AR,2011.0,2,2,0
CH,ZW,2022.0,1,1,0
IR,IT,2023.0,5,1,4
BN,SG,2015.0,3,6,-3
CO,RO,2019.0,1,1,0
MD,RU,2019.0,9,4,5
SI,CH,2008.0,2,6,-4
DK,LU,2017.0,3,1,2
BE,LT,2018.0,2,2,0
US,PG,2013.0,5,4,1
MX,NO,2008.0,1,1,0
US,TG,2017.0,2,1,1
IT,SG,2007.0,2,5,-3
RS,AU,2001.0,4,2,2
IT,CY,2008.0,1,1,0
BG,FR,2022.0,2,3,-1
US,CD,2014.0,2,2,0
TR,SA,2006.0,4,3,1
GB,LV,2018.0,3,4,-1
ME,RS,2006.0,5,4,1
CN,SK,1997.0,1,1,0
DK,TH,2013.0,3,2,1
CR,FR,2006.0,1,1,0
AR,MD,2013.0,1,1,0
SE,PH,2015.0,1,3,-2
UA,DK,2020.0,4,2,2
QA,SA,2010.0,1,7,-6
AU,TR,2006.0,2,6,-4
ZW,MX,2016.0,2,1,1
KR,NZ,2008.0,2,3,-1
PT,AU,2000.0,2,2,0
GB,FJ,2017.0,2,1,1
CU,PL,2021.0,2,1,1
PA,CA,2016.0,2,6,-4
IE,BE,1997.0,1,3,-2
CZ,IR,2013.0,2,3,-1
PL,AR,2020.0,1,4,-3
UZ,UA,1997.0,1,1,0
NL,CU,2019.0,2,2,0
IL,BY,2014.0,2,3,-1
CN,SN,2015.0,1,3,-2
PL,IL,2012.0,2,6,-4
LK,DE,2019.0,3,3,0
CA,TZ,1997.0,1,5,-4
IT,TH,2002.0,6,2,4
BO,BE,2010.0,1,2,-1
FI,BD,2016.0,1,1,0
PK,CO,2021.0,2,1,1
AE,BE,2021.0,1,2,-1
NL,AL,2014.0,1,1,0
AT,GR,2000.0,1,3,-2
BE,SN,2019.0,3,1,2
IT,LV,2015.0,4,1,3
DO,CL,2017.0,1,1,0
AU,KE,2006.0,1,7,-6
US,BN,2019.0,3,4,-1
NG,ES,2021.0,2,1,1
PL,BG,2000.0,2,5,-3
ES,BG,2013.0,1,4,-3
SI,CN,2006.0,1,1,0
SZ,BW,2009.0,1,1,0
ES,MY,2022.0,1,6,-5
CA,HN,2017.0,1,1,0
PT,MZ,2007.0,1,2,-1
RO,PL,2023.0,2,2,0
AU,VN,2001.0,1,1,0
SA,JP,2002.0,2,2,0
SE,SJ,2019.0,3,1,2
EC,IT,2015.0,3,8,-5
EC,CL,2023.0,1,2,-1
TR,PL,1999.0,1,1,0
AO,ES,2010.0,1,2,-1
nan,CH,1997.0,2,5,-3
PL,LT,2009.0,2,1,1
US,CM,2001.0,1,1,0
GA,BE,2014.0,2,2,0
IT,TH,2005.0,1,3,-2
ZM,ZA,2002.0,1,1,0
LK,FR,2020.0,2,2,0
PH,SE,2020.0,2,1,1
DE,NE,2018.0,1,1,0
MU,IN,2016.0,1,1,0
BG,PL,2009.0,1,1,0
VG,CH,2012.0,1,3,-2
BJ,CM,2002.0,1,1,0
PY,PE,2012.0,1,2,-1
IR,IQ,2013.0,1,1,0
IE,LU,2016.0,1,3,-2
TJ,RU,2002.0,3,1,2
IT,MA,2002.0,4,6,-2
CZ,UA,2000.0,1,4,-3
TW,NP,2012.0,2,1,1
MY,ET,2011.0,2,1,1
AU,ET,2012.0,1,3,-2
SG,VN,2008.0,3,3,0
AE,FR,2016.0,5,16,-11
AF,GB,2014.0,1,1,0
CH,CG,2022.0,1,3,-2
VN,DK,2015.0,1,5,-4
ES,EE,2019.0,3,3,0
PF,NC,2014.0,1,2,-1
BH,JO,2014.0,3,1,2
nan,IE,2013.0,2,4,-2
AU,ZW,2009.0,1,2,-1
LT,IN,2018.0,2,1,1
ID,PH,2016.0,3,5,-2
SI,XK,2021.0,1,1,0
IE,PL,2004.0,1,3,-2
US,MZ,2006.0,2,1,1
US,GM,2006.0,2,2,0
US,ZA,2019.0,327,375,-48
US,BE,2011.0,342,270,72
TR,CA,2011.0,21,21,0
EG,SA,2012.0,273,188,85
DK,CN,2011.0,30,31,-1
IT,AR,2022.0,40,51,-11
TW,SG,2014.0,51,41,10
SE,CA,2013.0,52,57,-5
GB,RO,2015.0,63,64,-1
TW,AU,2000.0,9,12,-3
KR,GB,2014.0,115,92,23
PL,CN,2019.0,22,25,-3
ES,PT,2003.0,54,55,-1
IN,BD,2014.0,87,106,-19
ID,MY,2021.0,227,233,-6
FR,SN,2012.0,45,33,12
CA,BD,2021.0,26,41,-15
NZ,IE,2019.0,22,13,9
CL,GB,2015.0,40,48,-8
GR,GB,2020.0,230,208,22
CN,DE,2010.0,252,246,6
CN,BD,2019.0,42,97,-55
MX,DE,2023.0,2,2,0
CN,SE,2007.0,53,78,-25
CO,DE,2020.0,49,30,19
EG,US,2023.0,25,16,9
CA,IN,2000.0,92,54,38
FR,DK,2019.0,56,54,2
CN,MY,2020.0,130,156,-26
IR,CN,2009.0,21,24,-3
BD,CA,2020.0,47,46,1
GB,JM,2016.0,4,7,-3
US,GR,2001.0,103,83,20
FR,BR,2001.0,81,44,37
SK,SE,2013.0,5,2,3
IN,MY,2005.0,19,19,0
HU,FI,2008.0,5,4,1
GB,NL,2010.0,243,270,-27
IN,IR,2021.0,17,27,-10
RU,UZ,1998.0,6,14,-8
IT,PL,2005.0,21,9,12
IL,IT,2014.0,18,24,-6
GB,PT,2009.0,53,58,-5
GH,IN,2022.0,3,10,-7
IL,ID,2012.0,1,1,0
IE,AU,2014.0,119,108,11
SA,JO,2022.0,24,20,4
PH,AU,1999.0,5,3,2
NL,UA,2010.0,5,3,2
IQ,JP,2015.0,1,3,-2
SE,RU,2022.0,17,32,-15
KZ,RU,2017.0,74,63,11
HR,RU,2016.0,6,3,3
AR,DE,2002.0,18,6,12
CM,FR,2013.0,13,24,-11
NC,AU,2016.0,4,2,2
AR,NL,2020.0,13,6,7
DK,HR,2020.0,3,2,1
KW,EG,2005.0,9,9,0
PL,BR,2011.0,10,3,7
DK,BE,2008.0,8,10,-2
NL,HU,2021.0,9,13,-4
SE,RO,2018.0,9,8,1
MX,UA,2010.0,3,3,0
RS,GB,2003.0,9,11,-2
SA,JP,2005.0,5,6,-1
RU,MX,2007.0,5,5,0
PL,BE,2001.0,13,9,4
SD,BR,2012.0,12,21,-9
KR,NO,2009.0,3,4,-1
IR,DZ,2020.0,4,4,0
VE,AR,2005.0,12,15,-3
US,LR,2018.0,5,1,4
CG,US,2007.0,1,2,-1
TT,US,2016.0,15,10,5
CA,MG,2017.0,1,2,-1
US,GT,2017.0,9,12,-3
AU,LB,2015.0,8,3,5
ID,CZ,2019.0,9,10,-1
RU,IL,2011.0,19,27,-8
GB,RS,2022.0,4,15,-11
ST,BR,1999.0,3,4,-1
MD,RU,2017.0,5,6,-1
AU,PT,2008.0,6,10,-4
AR,UY,2007.0,6,15,-9
IR,OM,2015.0,4,1,3
CM,IT,2018.0,4,4,0
RO,JP,2011.0,4,7,-3
NG,IQ,2018.0,4,4,0
PL,UA,2011.0,16,18,-2
NZ,GB,2023.0,11,9,2
SG,MX,2020.0,1,4,-3
RO,PT,2010.0,1,6,-5
CA,HR,2015.0,7,3,4
IN,BN,2021.0,3,1,2
IE,SA,2021.0,10,10,0
IT,CZ,2023.0,4,1,3
BD,BE,2013.0,3,3,0
DK,LU,2010.0,1,1,0
KE,AU,1999.0,2,2,0
SE,AR,2016.0,3,2,1
BR,CG,2003.0,1,1,0
MX,RS,2022.0,2,1,1
ID,QA,2020.0,4,7,-3
ES,PE,2005.0,20,26,-6
IN,UG,2009.0,1,1,0
NL,CZ,2001.0,5,12,-7
ES,TR,2009.0,4,10,-6
NO,CL,2013.0,2,1,1
BA,AT,2015.0,2,2,0
BF,CA,2014.0,1,2,-1
SA,RU,2015.0,3,2,1
TW,NL,2022.0,4,5,-1
ID,FR,2003.0,2,5,-3
UG,KE,2009.0,4,3,1
GB,PE,2010.0,9,10,-1
IT,QA,2016.0,8,1,7
GB,MM,2013.0,1,2,-1
VN,GB,2006.0,3,8,-5
VN,MX,2016.0,1,11,-10
PK,NZ,2016.0,9,8,1
QA,BE,2018.0,2,3,-1
FI,ID,2020.0,4,7,-3
BJ,KE,2004.0,2,1,1
JP,MA,2006.0,2,1,1
BF,ML,2009.0,4,4,0
BE,RU,2006.0,14,19,-5
UA,MX,2008.0,3,1,2
HK,NL,2001.0,2,5,-3
CN,BJ,2018.0,2,1,1
LY,EG,2021.0,7,9,-2
JO,SY,2016.0,4,5,-1
CY,FR,2018.0,3,6,-3
CZ,LT,2004.0,1,4,-3
NZ,CZ,2021.0,2,2,0
JO,OM,2018.0,6,3,3
PH,TH,2022.0,4,4,0
MQ,FR,1998.0,6,4,2
AR,SI,2013.0,2,1,1
ZA,SG,2010.0,2,1,1
CO,ID,2019.0,6,6,0
AT,TR,2002.0,2,9,-7
FR,CF,2003.0,3,1,2
GB,MU,2003.0,1,1,0
US,BN,2017.0,3,5,-2
NO,NP,2017.0,4,2,2
LB,KW,2004.0,1,1,0
PE,CA,2022.0,1,4,-3
NL,SA,2007.0,4,3,1
CH,NZ,2005.0,8,9,-1
IE,BE,1998.0,1,6,-5
GB,BN,1999.0,4,1,3
OM,US,2001.0,2,7,-5
RW,GB,2014.0,1,4,-3
SK,CN,2011.0,2,1,1
SI,BG,2006.0,1,1,0
NE,US,2012.0,1,1,0
NO,SI,2016.0,1,2,-1
RO,PT,2017.0,1,3,-2
IE,PT,2020.0,3,10,-7
JP,FR,2005.0,97,117,-20
NO,DK,2007.0,85,60,25
CL,US,2003.0,76,87,-11
TW,DE,2003.0,20,15,5
DE,PH,2007.0,7,4,3
ET,DE,2015.0,7,13,-6
AM,CO,2011.0,1,1,0
AR,DE,2005.0,21,18,3
GB,SI,2021.0,16,13,3
NZ,KR,2009.0,5,2,3
,JP,1994.0,87447,0,87447
BR,,2023.0,87180,0,87180
AU,,2014.0,3480,0,3480
,CA,2000.0,7685,0,7685
ES,,2012.0,5665,0,5665
NZ,,2022.0,2398,0,2398
,RS,1999.0,330,0,330
CU,,2021.0,604,0,604
IR,,2019.0,8088,0,8088
PL,,2023.0,24693,0,24693
,SE,2009.0,3122,0,3122
CN,,2007.0,5640,0,5640
IR,,2017.0,5508,0,5508
IT,,2012.0,5572,0,5572
IN,,2011.0,3739,0,3739
NG,,2023.0,12192,0,12192
SE,,2008.0,1386,0,1386
ZA,,2022.0,4730,0,4730
SK,,2024.0,4453,0,4453
PK,,2019.0,1033,0,1033
AT,,2008.0,756,0,756
,VE,2000.0,408,0,408
,SA,2012.0,2065,0,2065
,KR,2018.0,4014,0,4014
,CH,2008.0,3562,0,3562
TH,,2024.0,15298,0,15298
,HU,1994.0,3442,0,3442
VE,,2002.0,95,0,95
IR,,2010.0,695,0,695
,UA,2011.0,2617,0,2617
,ZA,2007.0,1820,0,1820
,CG,2013.0,53,0,53
,IQ,2017.0,1678,0,1678
,PL,2000.0,3449,0,3449
,RO,2016.0,1441,0,1441
,NZ,2009.0,1307,0,1307
VG,,2022.0,26,0,26
,BG,1996.0,639,0,639
,GE,2013.0,214,0,214
nan,,2008.0,360,0,360
MK,,2010.0,20,0,20
,TH,1998.0,734,0,734
,AE,2008.0,225,0,225
SG,,2007.0,389,0,389
VN,,2019.0,271,0,271
VN,,2017.0,179,0,179
,SI,2012.0,688,0,688
,OM,1995.0,61,0,61
DE,SN,2008.0,1,0,1
,IQ,2019.0,681,0,681
UY,,2018.0,218,0,218
CU,JP,2022.0,1,0,1
,IS,1994.0,207,0,207
,IQ,2010.0,373,0,373
,UY,1997.0,119,0,119
,CF,2008.0,7,0,7
IN,BH,1998.0,2,0,2
TN,,2020.0,1500,0,1500
,TH,1997.0,600,0,600
PK,,2017.0,594,0,594
MK,,2019.0,156,0,156
,LV,2003.0,144,0,144
,UZ,1994.0,160,0,160
CD,,2023.0,499,0,499
,EC,2001.0,103,0,103
PK,,2010.0,151,0,151
,SG,2016.0,1553,0,1553
EE,,2018.0,378,0,378
,VN,1999.0,156,0,156
,EE,2012.0,451,0,451
,NP,1999.0,65,0,65
,MW,2010.0,91,0,91
,CI,2006.0,120,0,120
,BG,2004.0,471,0,471
AR,,1999.0,117,0,117
ZW,,1998.0,14,0,14
,ML,2007.0,57,0,57
VE,,2005.0,129,0,129
,JM,2013.0,50,0,50
,KH,2000.0,21,0,21
LK,,2013.0,120,0,120
XK,AT,2015.0,1,0,1
AG,,2022.0,156,0,156
AM,,2003.0,56,0,56
RU,MN,2008.0,5,0,5
,XK,2018.0,77,0,77
KZ,,2021.0,610,0,610
nan,JO,1999.0,2,0,2
,UY,1998.0,129,0,129
SY,,2020.0,101,0,101
LV,,2021.0,460,0,460
,PA,2013.0,95,0,95
IE,,2000.0,173,0,173
UZ,,2015.0,64,0,64
CN,CI,2018.0,1,0,1
,ZW,2000.0,51,0,51
BR,BJ,2009.0,2,0,2
VG,GR,1999.0,1,0,1
BS,,2020.0,5,0,5
,BW,2010.0,62,0,62
BA,,2011.0,30,0,30
ML,TN,2018.0,2,0,2
JM,,2021.0,72,0,72
MM,,2021.0,79,0,79
CA,TZ,1998.0,5,0,5
PE,,2003.0,28,0,28
MV,,2023.0,11,0,11
GP,,2020.0,37,0,37
KW,CZ,2015.0,1,0,1
,LY,2015.0,61,0,61
BY,,2013.0,162,0,162
,BJ,2001.0,21,0,21
,BW,2017.0,75,0,75
AR,QA,2022.0,1,0,1
CO,ID,2010.0,2,0,2
ZM,CN,1999.0,2,0,2
GD,BG,2016.0,4,0,4
,MW,2019.0,59,0,59
VE,TW,2013.0,1,0,1
KP,,2015.0,4,0,4
TZ,,2015.0,79,0,79
,MW,2017.0,92,0,92
,CY,2000.0,67,0,67
ID,OM,2014.0,1,0,1
MM,IQ,2015.0,1,0,1
ZM,,2013.0,18,0,18
RO,KR,2017.0,1,0,1
,PW,2001.0,2,0,2
BI,CA,2020.0,1,0,1
ET,NO,2001.0,2,0,2
PY,MX,2006.0,1,0,1
BW,,2009.0,13,0,13
EE,UZ,2006.0,1,0,1
LI,,2016.0,5,0,5
MA,DE,1999.0,2,0,2
MK,,2017.0,116,0,116
,AL,2016.0,66,0,66
BZ,,2024.0,12,0,12
,MK,2007.0,88,0,88
ZW,PE,2014.0,1,0,1
PH,,2001.0,56,0,56
,PR,2011.0,19,0,19
PK,TZ,2020.0,3,0,3
FJ,,2006.0,4,0,4
CI,JP,2014.0,1,0,1
BR,SN,2017.0,1,0,1
AU,KZ,2016.0,3,0,3
CZ,KE,2021.0,2,0,2
CN,ML,2011.0,2,0,2
BS,IT,2015.0,1,0,1
,NG,2020.0,93,0,93
,BW,2019.0,34,0,34
LU,,2005.0,14,0,14
CA,AO,2013.0,1,0,1
KE,,2011.0,86,0,86
VN,,2010.0,41,0,41
UA,MZ,2007.0,9,0,9
JP,KW,2008.0,1,0,1
,PG,2006.0,21,0,21
LU,NO,2019.0,2,0,2
,KG,2007.0,21,0,21
SI,ZA,2008.0,2,0,2
EE,BY,2017.0,1,0,1
GE,,2003.0,29,0,29
IR,SG,1999.0,1,0,1
AU,LV,2015.0,1,0,1
FR,MY,2000.0,4,0,4
SG,PL,2007.0,2,0,2
BG,HU,2000.0,4,0,4
AG,AT,2019.0,1,0,1
HR,,2000.0,50,0,50
YE,US,2008.0,1,0,1
SE,OM,2014.0,1,0,1
SN,CG,2011.0,2,0,2
PK,OM,2023.0,1,0,1
AZ,,2000.0,5,0,5
ID,CD,2013.0,1,0,1
SG,RS,2020.0,4,0,4
BR,BG,2008.0,1,0,1
KG,EG,2018.0,1,0,1
CU,CA,2013.0,4,0,4
NE,nan,2014.0,1,0,1
,BN,2003.0,11,0,11
GR,PE,2018.0,1,0,1
RS,CO,2017.0,5,0,5
FR,MG,2001.0,5,0,5
DE,MZ,2003.0,1,0,1
SA,BS,2020.0,1,0,1
TZ,SZ,2018.0,1,0,1
SA,BA,2020.0,1,0,1
,GL,2009.0,5,0,5
GR,CZ,2014.0,13,0,13
EG,ET,2000.0,1,0,1
DZ,MX,2004.0,1,0,1
CY,MW,2017.0,2,0,2
PE,ID,2019.0,8,0,8
,FJ,2013.0,18,0,18
AO,,2025.0,4,0,4
LU,NO,2017.0,2,0,2
AU,UY,2015.0,2,0,2
UG,AE,2019.0,2,0,2
TZ,CZ,2019.0,1,0,1
KR,BN,2020.0,3,0,3
RU,UZ,1997.0,6,0,6
NG,CZ,2001.0,1,0,1
IT,TZ,2015.0,2,0,2
UA,HR,2013.0,3,0,3
UA,NO,1998.0,2,0,2
OM,SK,2019.0,1,0,1
HR,TR,1999.0,3,0,3
CA,TJ,2013.0,1,0,1
CM,IN,2012.0,1,0,1
,KY,1994.0,1,0,1
GE,TR,2015.0,1,0,1
LU,NO,2010.0,2,0,2
MD,PL,2006.0,1,0,1
SE,ID,2007.0,2,0,2
GB,MD,2015.0,3,0,3
PH,CU,2016.0,1,0,1
FR,HT,2013.0,1,0,1
MT,,1999.0,2,0,2
SA,BE,2000.0,2,0,2
GB,PG,2009.0,1,0,1
RU,SA,2013.0,2,0,2
HU,AZ,2006.0,1,0,1
GB,BF,2014.0,2,0,2
KH,ID,2019.0,2,0,2
DK,SC,2018.0,1,0,1
CW,,2016.0,14,0,14
ES,MQ,2010.0,1,0,1
DK,UA,2004.0,5,0,5
NA,DE,2011.0,1,0,1
,LS,2011.0,7,0,7
YE,JO,1999.0,1,0,1
KW,PL,2000.0,1,0,1
HN,SV,2017.0,1,0,1
DK,SS,2018.0,1,0,1
US,ML,2002.0,4,0,4
IE,VN,2020.0,3,0,3
SO,SE,2022.0,1,0,1
NP,UG,2018.0,1,0,1
TW,IE,2018.0,2,0,2
IL,AG,2015.0,1,0,1
NL,UY,2022.0,1,0,1
GL,CN,2013.0,1,0,1
RS,CO,2010.0,1,0,1
IT,CG,2015.0,1,0,1
QA,RU,2018.0,2,0,2
TN,BD,2017.0,4,0,4
CM,UG,2018.0,1,0,1
LB,ET,2017.0,1,0,1
SN,PK,2005.0,1,0,1
,MU,2006.0,26,0,26
ID,IN,2005.0,2,0,2
SK,QA,2015.0,3,0,3
PK,BF,2005.0,1,0,1
IN,CR,2004.0,3,0,3
PY,IT,2008.0,2,0,2
MA,MR,2021.0,3,0,3
,MC,2012.0,9,0,9
BJ,SN,2003.0,2,0,2
GY,,2007.0,3,0,3
XK,,2011.0,11,0,11
BW,QA,2022.0,1,0,1
nan,BG,2012.0,2,0,2
GT,GB,2010.0,1,0,1
TZ,CH,1997.0,1,0,1
CG,MA,2014.0,2,0,2
RO,VE,1998.0,1,0,1
NG,BJ,1998.0,1,0,1
CN,MW,2014.0,1,0,1
CU,LB,2002.0,3,0,3
GR,MT,2017.0,4,0,4
NL,CM,2004.0,1,0,1
ES,TZ,2004.0,2,0,2
AZ,SI,2010.0,4,0,4
MA,PE,2006.0,1,0,1
SY,PT,2013.0,1,0,1
JP,UZ,2000.0,4,0,4
NZ,nan,1997.0,11,0,11
SI,SG,2018.0,1,0,1
BR,PR,2021.0,1,0,1
HK,AU,2023.0,1,0,1
OM,AU,2003.0,1,0,1
SS,AU,2005.0,1,0,1
JO,PK,2015.0,3,0,3
SA,CO,2020.0,2,0,2
UA,SK,2006.0,2,0,2
RU,FK,2000.0,2,0,2
PW,US,2022.0,2,0,2
PE,DE,2003.0,3,0,3
BI,GA,2019.0,2,0,2
AT,RS,1998.0,1,0,1
KR,HU,2006.0,2,0,2
SG,KE,2013.0,2,0,2
TR,EC,2001.0,1,0,1
ME,CN,2006.0,1,0,1
ZM,NO,2009.0,2,0,2
KH,,2025.0,11,0,11
KR,SI,2016.0,2,0,2
PT,TN,2015.0,2,0,2
ET,PL,2011.0,2,0,2
VE,NZ,1997.0,2,0,2
KE,SS,2018.0,1,0,1
MZ,,2016.0,29,0,29
LU,,2002.0,4,0,4
IE,CO,2002.0,1,0,1
US,MS,2008.0,1,0,1
SI,nan,2002.0,1,0,1
RW,CA,2005.0,1,0,1
FJ,NL,2021.0,1,0,1
BW,UG,2020.0,2,0,2
LV,CR,2015.0,1,0,1
AO,PH,2008.0,1,0,1
LV,JP,2017.0,2,0,2
CM,PH,2021.0,1,0,1
nan,YE,2015.0,2,0,2
EE,ES,1997.0,2,0,2
JO,ES,2014.0,1,0,1
FR,YE,2022.0,1,0,1
CI,UG,2008.0,2,0,2
AG,MD,2022.0,1,0,1
KR,UZ,2013.0,1,0,1
TN,MR,2014.0,3,0,3
UA,LT,2010.0,1,0,1
MW,FR,2020.0,1,0,1
KR,LV,2022.0,1,0,1
PS,DZ,2014.0,1,0,1
nan,IR,2001.0,1,0,1
NP,EG,2012.0,1,0,1
MY,KW,2001.0,1,0,1
RO,UY,2009.0,1,0,1
KY,,2024.0,7,0,7
SK,IN,2007.0,2,0,2
US,YE,2014.0,2,0,2
TT,BB,2003.0,1,0,1
CA,SY,2013.0,1,0,1
DK,LK,2004.0,1,0,1
AG,HU,2012.0,2,0,2
PR,PT,1997.0,1,0,1
UA,GH,2011.0,1,0,1
LT,DK,2001.0,1,0,1
SD,DK,2014.0,1,0,1
GM,MW,2015.0,1,0,1
CA,ML,2015.0,3,0,3
US,LU,2023.0,1,0,1
PT,CV,2022.0,1,0,1
TT,FR,2014.0,1,0,1
MA,BJ,2015.0,3,0,3
MW,IE,1997.0,1,0,1
EG,AL,2014.0,1,0,1
VE,GB,2021.0,4,0,4
UY,DE,2005.0,2,0,2
nan,PE,2001.0,2,0,2
TR,JO,2011.0,2,0,2
RO,TW,1998.0,1,0,1
IN,VN,2013.0,1,0,1
BN,NG,2013.0,1,0,1
nan,LY,2018.0,1,0,1
NL,LT,2021.0,1,0,1
RU,IR,1999.0,3,0,3
GY,SG,2021.0,1,0,1
PH,RW,2019.0,1,0,1
AE,TT,2016.0,2,0,2
CI,US,2009.0,2,0,2
CL,NL,2000.0,2,0,2
GR,SG,2012.0,1,0,1
TN,KE,2014.0,1,0,1
SD,UA,2016.0,1,0,1
AU,BA,2017.0,3,0,3
AR,AT,2005.0,4,0,4
CY,KR,2009.0,1,0,1
SK,BG,2010.0,2,0,2
SK,ME,2017.0,1,0,1
GM,CD,2007.0,1,0,1
UG,MX,2011.0,1,0,1
IT,CI,2018.0,2,0,2
SJ,GB,2012.0,1,0,1
CW,GB,2006.0,1,0,1
,SC,2003.0,2,0,2
LU,FR,1997.0,3,0,3
AT,QA,2004.0,1,0,1
AU,MW,2002.0,1,0,1
BJ,BR,2019.0,2,0,2
SG,BN,2012.0,2,0,2
EC,BD,2016.0,1,0,1
LT,BR,2013.0,1,0,1
PK,SK,2020.0,2,0,2
TG,CH,2016.0,1,0,1
EG,KE,2007.0,1,0,1
MX,UA,2019.0,2,0,2
FJ,CA,2003.0,1,0,1
UG,BD,2019.0,1,0,1
SA,SN,2017.0,1,0,1
IT,BY,2016.0,2,0,2
CY,AT,2007.0,2,0,2
AT,BY,1997.0,1,0,1
HU,VN,2013.0,2,0,2
UY,PG,2010.0,1,0,1
GH,ML,2021.0,1,0,1
AT,RS,1997.0,1,0,1
JE,GB,2000.0,1,0,1
DK,ZW,2013.0,1,0,1
nan,AZ,2021.0,1,0,1
GB,MS,2018.0,1,0,1
PA,BE,2015.0,1,0,1
UA,HU,2004.0,2,0,2
TH,RW,2017.0,1,0,1
BE,RW,2007.0,2,0,2
LV,CN,1998.0,1,0,1
MK,KZ,2020.0,2,0,2
BD,CH,2000.0,1,0,1
DK,PE,2002.0,1,0,1
ET,GP,2014.0,1,0,1
HR,NZ,1997.0,1,0,1
ES,BJ,1999.0,1,0,1
ML,ZA,2019.0,2,0,2
TW,GE,2017.0,2,0,2
IQ,BD,2008.0,1,0,1
ER,ES,2017.0,1,0,1
MY,HK,2020.0,1,0,1
ES,LI,2021.0,1,0,1
KE,CA,2001.0,3,0,3
MA,PS,2010.0,1,0,1
IE,CO,2005.0,1,0,1
BJ,CM,2005.0,2,0,2
BY,JO,2017.0,1,0,1
ER,,2024.0,6,0,6
CD,JP,2018.0,1,0,1
BG,IR,2019.0,2,0,2
EC,HR,2019.0,2,0,2
IL,LV,2017.0,1,0,1
PL,GT,2015.0,1,0,1
VE,CH,1999.0,1,0,1
GR,EG,2009.0,1,0,1
CU,TW,2019.0,2,0,2
TR,SK,2015.0,2,0,2
IR,MX,2016.0,3,0,3
,AX,2009.0,1,0,1
AZ,SI,2017.0,1,0,1
nan,AE,2023.0,1,0,1
GN,TR,2020.0,1,0,1
AO,CO,2008.0,1,0,1
MT,NZ,2021.0,1,0,1
PT,MO,2007.0,1,0,1
NZ,PA,2013.0,1,0,1
DZ,BR,2021.0,1,0,1
SA,TZ,2018.0,1,0,1
CZ,LU,2021.0,2,0,2
NL,SY,2003.0,1,0,1
MA,PA,2014.0,1,0,1
IR,NO,2000.0,1,0,1
,GW,2015.0,6,0,6
EC,HR,2017.0,2,0,2
MY,PG,1997.0,1,0,1
GB,MG,2018.0,1,0,1
SE,NI,1998.0,1,0,1
MT,IE,2002.0,1,0,1
IE,BB,2014.0,1,0,1
SK,SA,2016.0,1,0,1
ER,US,2007.0,1,0,1
ZA,CY,2015.0,1,0,1
BD,SY,2021.0,1,0,1
AU,MD,2013.0,1,0,1
SG,AO,2010.0,1,0,1
SE,AM,2016.0,1,0,1
TH,PT,2015.0,1,0,1
LB,AT,2011.0,1,0,1
LV,KR,2007.0,1,0,1
JP,UY,2002.0,1,0,1
CA,PA,1999.0,1,0,1
SE,YE,2013.0,1,0,1
FI,CL,2008.0,2,0,2
PG,,2001.0,5,0,5
EG,ZA,2004.0,1,0,1
CM,BF,2019.0,1,0,1
MC,AR,2010.0,1,0,1
SV,,2007.0,5,0,5
LR,US,1997.0,1,0,1
JO,LY,2007.0,1,0,1
PA,PT,1999.0,1,0,1
SA,AR,2011.0,1,0,1
MX,CG,2004.0,1,0,1
GT,NO,2019.0,1,0,1
TR,KH,2017.0,2,0,2
FI,FJ,2022.0,1,0,1
CZ,BN,2018.0,1,0,1
PY,UY,2013.0,1,0,1
JP,MW,2015.0,1,0,1
MW,MM,2013.0,1,0,1
SY,TZ,2020.0,1,0,1
ZA,MX,2002.0,1,0,1
NL,AG,2022.0,1,0,1
GR,BA,2011.0,1,0,1
CA,HN,2019.0,1,0,1
ID,IL,2009.0,1,0,1
PL,MK,2020.0,1,0,1
OM,SG,2007.0,1,0,1
PE,PL,2016.0,1,0,1
UA,NZ,2018.0,2,0,2
QA,SY,2001.0,1,0,1
TR,CL,2013.0,1,0,1
SD,YE,2017.0,1,0,1
RS,VN,2015.0,1,0,1
MZ,DE,2009.0,1,0,1
PE,IN,2009.0,1,0,1
IQ,CN,1997.0,1,0,1
ZM,ZA,2005.0,1,0,1
VN,CG,2003.0,1,0,1
IN,MU,2010.0,1,0,1
GE,BR,1997.0,1,0,1
CZ,ZM,2006.0,1,0,1
TH,RW,2019.0,1,0,1
CL,TT,2009.0,1,0,1
SX,GD,2008.0,1,0,1
SE,SN,1998.0,1,0,1
BG,MY,2019.0,1,0,1
LU,IE,2013.0,1,0,1
LK,AE,2014.0,2,0,2
CZ,EG,2009.0,1,0,1
PR,PE,2020.0,1,0,1
LV,FR,2009.0,1,0,1
NO,ZW,2015.0,2,0,2
NG,OM,2022.0,1,0,1
VN,RS,2020.0,1,0,1
MM,TH,2012.0,1,0,1
DE,TG,2015.0,1,0,1
FM,,2011.0,1,0,1
OM,NG,2015.0,2,0,2
BY,SG,2012.0,1,0,1
NP,ID,2015.0,1,0,1
CA,MK,2007.0,1,0,1
ZA,AT,2002.0,2,0,2
CY,AL,2012.0,1,0,1
KW,YE,2016.0,1,0,1
PA,AT,2006.0,1,0,1
CZ,TN,2016.0,1,0,1
OM,nan,2021.0,1,0,1
SG,QA,2023.0,1,0,1
HR,MA,2017.0,1,0,1
IL,NP,2006.0,1,0,1
NZ,IL,2014.0,2,0,2
ZM,IN,2020.0,2,0,2
DK,CR,2019.0,1,0,1
SE,KW,2001.0,1,0,1
SG,NO,2003.0,2,0,2
IQ,TN,2011.0,1,0,1
ID,CZ,2010.0,2,0,2
SK,IE,2001.0,3,0,3
DZ,QA,2009.0,1,0,1
NG,CM,2002.0,1,0,1
CI,NG,2011.0,1,0,1
US,TJ,2019.0,2,0,2
KR,MZ,2006.0,1,0,1
NO,SK,2021.0,1,0,1
FI,SS,2006.0,1,0,1
CA,AM,2018.0,1,0,1
PH,NO,2013.0,1,0,1
EG,SG,2007.0,1,0,1
OM,PS,2019.0,1,0,1
PF,,2008.0,3,0,3
KE,FI,2015.0,1,0,1
DK,ZM,2018.0,1,0,1
MX,DZ,2017.0,2,0,2
DE,AE,1999.0,1,1,0
ID,TN,2019.0,3,8,-5
ML,DE,2004.0,1,1,0
AF,US,2019.0,3,4,-1
BE,TW,2006.0,1,4,-3
CR,JP,2007.0,1,1,0
CO,BE,2002.0,2,3,-1
LU,PL,2011.0,1,1,0
PH,ES,2000.0,2,1,1
JP,LT,2022.0,2,1,1
CO,DK,2020.0,3,4,-1
MM,MY,2013.0,5,3,2
BH,ZW,2015.0,1,1,0
TW,PT,2004.0,1,1,0
HU,IE,1999.0,1,1,0
IR,GH,2017.0,1,1,0
VN,PK,2021.0,2,2,0
IE,TR,2006.0,1,1,0
PY,ES,2008.0,2,5,-3
MY,BN,2009.0,2,1,1
DK,CR,2017.0,1,1,0
CN,GE,2012.0,2,5,-3
SD,GH,2015.0,1,1,0
RU,AR,2020.0,1,4,-3
ES,ET,2010.0,1,1,0
IL,TN,2006.0,1,1,0
GB,YE,2004.0,1,1,0
BE,KR,2021.0,4,7,-3
ZA,SG,2019.0,1,5,-4
BW,NZ,2005.0,1,1,0
IN,RS,2013.0,2,2,0
BG,CH,2013.0,2,1,1
PK,CM,2003.0,1,1,0
VN,BD,2021.0,1,1,0
DE,PS,2022.0,1,1,0
PA,MA,2012.0,1,1,0
BE,CR,2018.0,1,3,-2
PH,IE,2006.0,1,2,-1
nan,PK,2003.0,3,4,-1
NZ,MX,2020.0,3,2,1
BR,SV,2007.0,1,1,0
KW,IN,1999.0,1,3,-2
QA,PS,2019.0,3,2,1
US,EC,2023.0,1,3,-2
OM,NZ,2011.0,1,1,0
ET,OM,2019.0,1,1,0
KW,MY,2021.0,3,5,-2
ID,AZ,2016.0,4,12,-8
FJ,GB,2009.0,1,1,0
QA,IQ,2010.0,1,2,-1
QA,JP,2012.0,1,4,-3
US,KY,2019.0,1,1,0
NL,ZA,1997.0,1,6,-5
US,NI,2009.0,1,3,-2
CZ,IE,2012.0,2,5,-3
PA,PE,2016.0,1,2,-1
NI,MY,2016.0,1,3,-2
ZA,MY,2002.0,1,1,0
MQ,FR,1997.0,2,4,-2
GH,GB,2023.0,1,1,0
PT,SI,2016.0,1,1,0
CU,HU,2013.0,1,2,-1
GT,JP,2013.0,1,1,0
SY,NL,2012.0,1,3,-2
ID,PS,2016.0,1,1,0
CR,GT,2018.0,1,1,0
DZ,CA,2000.0,1,5,-4
SG,IE,1999.0,1,2,-1
UG,CA,2021.0,1,1,0
AE,KW,2021.0,1,7,-6
ID,RO,2014.0,1,2,-1
MW,ZW,2016.0,1,1,0
BE,MY,2011.0,1,4,-3
US,ML,2005.0,2,1,1
EC,AR,2012.0,5,7,-2
RU,NG,2022.0,1,4,-3
BR,SN,2019.0,1,2,-1
DK,TR,2001.0,1,3,-2
NL,CU,2017.0,1,1,0
NO,HR,2014.0,1,1,0
IT,SK,1998.0,3,9,-6
TH,DK,2018.0,1,4,-3
IN,MM,2017.0,1,1,0
PH,IL,2009.0,1,1,0
NO,BA,2018.0,1,2,-1
CN,SI,2006.0,1,1,0
PH,MY,2004.0,1,1,0
RS,JP,1998.0,4,1,3
SN,LU,2015.0,1,1,0
CI,BE,2005.0,1,2,-1
SA,LY,2005.0,1,2,-1
TZ,UG,2015.0,2,5,-3
nan,SI,2007.0,1,1,0
ZA,MY,2005.0,1,1,0
CH,UY,2019.0,1,3,-2
GB,ZW,2007.0,2,5,-3
MA,SN,2022.0,1,3,-2
RO,NO,2014.0,2,4,-2
CY,DE,2011.0,1,1,0
LI,SE,2015.0,1,2,-1
CN,VG,2017.0,1,4,-3
BJ,NC,2016.0,1,1,0
ES,SN,2018.0,1,3,-2
SA,ZA,2011.0,1,3,-2
SV,CR,2020.0,1,1,0
CR,IT,2006.0,1,2,-1
DK,SI,2012.0,1,2,-1
MA,MY,2021.0,1,4,-3
ET,GB,1998.0,1,1,0
KP,CN,2012.0,1,4,-3
TR,PT,2014.0,2,3,-1
HR,ME,2014.0,1,1,0
AR,MY,2014.0,2,4,-2
FI,KR,2001.0,1,2,-1
PL,IE,2000.0,1,1,0
FR,LT,2007.0,1,3,-2
BE,EC,2008.0,2,1,1
AU,CR,2014.0,1,3,-2
UA,NL,2001.0,1,3,-2
BR,SI,2018.0,1,5,-4
BT,TH,2021.0,1,2,-1
CH,LK,2009.0,1,1,0
HR,IN,2015.0,1,1,0
SY,IN,1999.0,1,1,0
MD,DE,2007.0,1,1,0
CA,NG,2007.0,1,4,-3
US,TT,2000.0,2,2,0
CA,UG,2021.0,1,1,0
RW,BE,2019.0,1,3,-2
ZA,PG,2012.0,1,1,0
KR,CY,2018.0,1,3,-2
SI,PT,2016.0,1,1,0
TN,CN,2006.0,1,1,0
TW,DK,2019.0,1,3,-2
US,KY,2010.0,1,3,-2
TR,PS,2015.0,1,1,0
ET,TR,2020.0,1,3,-2
NG,HU,2000.0,1,1,0
SA,SN,2019.0,1,2,-1
RS,CH,1997.0,2,1,1
SY,MY,2012.0,2,1,1
CH,CL,1998.0,1,2,-1
CU,GT,2021.0,1,2,-1
ZA,UA,2016.0,1,2,-1
US,KY,2017.0,1,2,-1
JP,PE,2022.0,1,1,0
RU,GE,2000.0,1,4,-3
DK,LU,2019.0,1,1,0
DK,FR,2023.0,1,4,-3
TW,BR,2021.0,1,2,-1
SN,CM,2015.0,2,2,0
SE,CZ,2023.0,1,1,0
TH,BE,2003.0,1,1,0
HR,RO,2020.0,2,1,1
DE,AZ,2006.0,1,1,0
PT,FI,2004.0,1,2,-1
US,TJ,2010.0,1,2,-1
VN,PL,2007.0,1,2,-1
TR,PK,2000.0,1,1,0
LB,TN,2016.0,1,3,-2
NL,UG,2022.0,1,1,0
GE,CH,2018.0,1,1,0
ZW,NL,2017.0,1,3,-2
HU,BD,2014.0,1,2,-1
NI,PE,2022.0,1,1,0
DE,LT,2021.0,1,7,-6
AT,TR,2005.0,4,5,-1
CY,JP,2022.0,1,1,0
PL,TW,2007.0,1,2,-1
AR,AT,2002.0,1,1,0
HN,CU,2022.0,1,1,0
TH,IT,2009.0,2,2,0
ES,ET,2017.0,1,3,-2
KE,CI,2014.0,2,1,1
ZA,MX,2005.0,2,2,0
GR,EE,2021.0,1,1,0
EC,GR,2008.0,2,3,-1
LK,DE,2010.0,1,2,-1
JP,SY,2021.0,1,1,0
KH,ID,2017.0,1,2,-1
RU,TR,1998.0,2,1,1
TN,KW,2019.0,1,1,0
IN,MW,2016.0,1,1,0
AE,CH,2014.0,1,1,0
PH,PK,2012.0,1,1,0
DZ,OM,2021.0,1,0,1
ES,VA,2018.0,1,0,1
UA,NO,1997.0,1,0,1
IE,LY,2012.0,3,0,3
AF,AU,2020.0,1,0,1
SE,LY,2021.0,1,0,1
ZA,PE,2014.0,1,0,1
CZ,TH,2022.0,2,0,2
GT,GB,2017.0,2,0,2
ZA,AE,2002.0,1,0,1
,SD,2020.0,6,0,6
NZ,RO,2003.0,1,0,1
FR,GE,2012.0,1,0,1
ES,MQ,2017.0,1,0,1
LA,JP,2008.0,1,0,1
IE,KZ,2022.0,1,0,1
CW,HU,2009.0,1,0,1
GD,IR,2018.0,1,0,1
CH,MY,2001.0,2,0,2
SE,SG,1998.0,2,0,2
BY,EE,2021.0,1,0,1
KR,BW,2005.0,1,0,1
GE,IE,2002.0,2,0,2
LK,IQ,2018.0,1,0,1
GA,AT,2020.0,1,0,1
BW,CD,2011.0,1,0,1
DZ,GR,2022.0,1,0,1
UZ,ZA,2007.0,1,0,1
NP,MM,2011.0,1,0,1
UG,HU,2019.0,1,0,1
RO,MX,2010.0,1,0,1
CZ,VN,2005.0,1,0,1
TN,HU,2019.0,1,0,1
CG,MG,2001.0,1,0,1
IN,PE,2016.0,2,0,2
SI,ME,2011.0,1,0,1
LB,NL,2001.0,1,0,1
CD,AR,2016.0,1,0,1
NZ,IR,2001.0,1,0,1
ID,NO,2011.0,1,0,1
JP,AO,2012.0,1,0,1
VN,ET,2021.0,3,0,3
CM,GM,2012.0,1,0,1
AU,MU,2021.0,1,0,1
LV,ES,2018.0,1,0,1
SE,FO,2008.0,1,0,1
CI,BR,2015.0,1,0,1
US,NA,2006.0,1,0,1
IR,JO,2005.0,1,0,1
GR,RO,2005.0,1,0,1
,MO,2005.0,1,0,1
GB,GN,2019.0,1,0,1
,GI,1999.0,1,0,1
BY,KR,2005.0,1,0,1
DZ,MN,2012.0,1,0,1
JE,IN,2020.0,1,0,1
SN,MG,2013.0,1,0,1
KZ,EG,2012.0,1,0,1
ES,MZ,2020.0,1,0,1
OM,BH,2017.0,2,0,2
BY,NL,2007.0,1,0,1
ES,RW,2018.0,1,0,1
PH,JO,2020.0,1,0,1
NG,CI,2001.0,1,0,1
BY,BR,2012.0,1,0,1
CZ,MN,2008.0,1,0,1
MA,TR,1999.0,1,0,1
AU,LY,2020.0,2,0,2
BY,KZ,2015.0,1,0,1
CL,AM,2003.0,1,0,1
AT,ZM,2006.0,1,0,1
AU,MW,2005.0,1,0,1
PL,MY,2015.0,2,0,2
JO,ID,2002.0,1,0,1
RO,LU,2015.0,1,0,1
IL,TW,2000.0,1,0,1
AR,ET,2013.0,1,0,1
ZA,LU,2011.0,1,0,1
IQ,BE,2022.0,1,0,1
TD,BJ,2014.0,1,0,1
MX,NL,2023.0,1,0,1
LV,CA,1997.0,1,0,1
SS,AU,2002.0,1,0,1
BY,NI,2017.0,1,0,1
DE,UG,2015.0,2,0,2
CA,QA,1999.0,1,0,1
CH,KH,2021.0,1,0,1
RS,BR,2016.0,2,0,2
PS,BD,2014.0,1,0,1
GB,KH,2013.0,2,0,2
ZW,ZM,1998.0,1,0,1
XK,BR,2017.0,1,0,1
QA,,1998.0,4,0,4
BG,OM,2012.0,1,0,1
NO,DZ,2017.0,1,0,1
CZ,CR,2018.0,1,0,1
SN,RU,2019.0,1,0,1
MW,TZ,2018.0,1,0,1
IL,EG,2010.0,2,0,2
LV,CA,1998.0,1,0,1
DE,TJ,1998.0,1,0,1
nan,CR,1999.0,1,0,1
LV,GR,2008.0,1,0,1
TH,ZA,2013.0,2,0,2
JE,ZA,1999.0,1,0,1
BA,SI,2001.0,1,0,1
NZ,LU,2016.0,1,0,1
LT,EE,2013.0,1,0,1
GE,AE,2021.0,1,0,1
IQ,BA,2016.0,1,0,1
GP,CA,2022.0,1,0,1
PR,IT,2008.0,1,0,1
SA,CH,2023.0,1,0,1
IN,PS,2000.0,2,0,2
CH,TZ,2001.0,1,0,1
MK,SG,2007.0,1,0,1
NP,SD,2009.0,1,0,1
GR,PK,2021.0,1,0,1
IQ,DK,2013.0,1,0,1
SI,ET,2016.0,1,0,1
SN,MZ,2021.0,1,0,1
LY,FR,2021.0,1,0,1
CM,SN,2006.0,1,0,1
ES,IS,1999.0,1,0,1
ID,XK,2019.0,1,0,1
LU,RW,2003.0,1,0,1
CU,NZ,2020.0,1,0,1
TG,OM,2020.0,1,0,1
ID,CU,2018.0,1,0,1
UY,DE,2002.0,1,0,1
MY,RO,2018.0,2,0,2
YE,AE,2003.0,1,0,1
MW,ID,2016.0,1,0,1
GN,CA,2019.0,1,0,1
SA,MA,2002.0,1,0,1
TN,CI,2009.0,1,0,1
PT,EE,2013.0,2,0,2
PL,EE,2011.0,1,0,1
GH,DK,2000.0,2,0,2
EG,BR,2023.0,1,0,1
EE,AE,2022.0,1,0,1
PG,NZ,2018.0,1,0,1
RE,IN,2007.0,1,0,1
IN,LV,2005.0,1,0,1
CI,TR,2011.0,1,0,1
IT,BJ,2002.0,1,0,1
NG,CF,2021.0,1,0,1
ES,MT,2001.0,1,0,1
LV,ZA,2004.0,1,0,1
MZ,CZ,1999.0,1,0,1
LK,NP,2022.0,1,0,1
ES,CY,2000.0,1,0,1
DZ,TZ,2019.0,1,0,1
CM,SA,2011.0,1,0,1
EG,UZ,2019.0,1,0,1
PL,AU,2023.0,1,0,1
VN,KH,2009.0,1,0,1
PE,JP,2013.0,1,0,1
AE,VN,2016.0,1,0,1
NP,CA,2008.0,1,0,1
MX,ET,2023.0,1,0,1
SG,CL,2009.0,1,0,1
BY,LB,2017.0,1,0,1
UY,NL,2011.0,1,0,1
ID,TH,2004.0,1,0,1
CH,CY,2012.0,2,0,2
US,MU,2021.0,1,0,1
BJ,CA,2009.0,1,0,1
NL,CD,2012.0,1,0,1
DK,CU,2013.0,1,0,1
RO,VN,2004.0,1,0,1
CH,CU,1999.0,1,0,1
US,GP,2002.0,1,0,1
RO,RS,2004.0,1,0,1
SS,KR,2016.0,1,0,1
MY,PG,1998.0,1,0,1
MY,PT,2020.0,1,0,1
AE,MN,2007.0,1,0,1
BJ,CO,2020.0,1,0,1
,JP,2021.0,1,0,1
XK,ME,2021.0,1,0,1
BG,TN,2019.0,1,0,1
SK,ID,2021.0,1,0,1
RS,BY,2013.0,1,0,1
GH,CG,2018.0,1,0,1
SI,IS,2021.0,1,0,1
BR,IR,1997.0,1,0,1
SK,NG,2005.0,1,0,1
CH,GT,2004.0,1,0,1
CH,UA,1998.0,1,0,1
BR,KE,2012.0,1,0,1
KE,AE,2014.0,1,0,1
LS,PL,2020.0,1,0,1
LB,BE,2011.0,1,0,1
AM,AU,2012.0,1,0,1
ZA,EC,2017.0,1,0,1
NG,BW,2014.0,1,0,1
BG,XK,2018.0,1,0,1
AM,TJ,2023.0,1,0,1
DO,PA,2022.0,1,0,1
ET,OM,2017.0,1,0,1
SK,ME,2019.0,1,0,1
TN,BJ,2016.0,1,0,1
US,LS,2022.0,1,0,1
IL,LV,2019.0,1,0,1
NL,BR,2019.0,63,76,-13
ES,BR,2014.0,424,348,76
ES,US,2020.0,1050,937,113
DE,US,2021.0,1799,1895,-96
IN,GB,2004.0,190,184,6
US,GB,2013.0,6043,5941,102
AU,US,2020.0,2571,2609,-38
US,FI,2011.0,131,125,6
MY,GB,2015.0,99,183,-84
KR,US,2021.0,988,1100,-112
AR,US,1999.0,104,83,21
IT,FR,2019.0,459,424,35
BD,IN,2011.0,70,54,16
CH,US,2001.0,470,416,54
GB,FR,2018.0,652,716,-64
UY,BR,2006.0,30,25,5
TW,CA,2008.0,25,38,-13
CU,EC,2020.0,22,27,-5
AU,CA,2018.0,419,436,-17
CU,MX,2022.0,32,15,17
MY,TW,2018.0,29,31,-2
CH,DE,2015.0,820,961,-141
US,CR,2014.0,37,28,9
PE,ES,2017.0,120,160,-40
EG,GB,2014.0,70,106,-36
AR,PE,2012.0,33,18,15
CN,AU,1998.0,61,64,-3
US,MX,2004.0,229,213,16
IT,FR,2010.0,332,268,64
nan,AR,2006.0,22,8,14
FR,IT,2012.0,278,411,-133
US,RU,2016.0,608,502,106
NZ,CN,2016.0,53,51,2
CA,GB,1998.0,383,386,-3
BR,GB,2010.0,135,152,-17
UY,US,2020.0,34,32,2
CA,GB,1997.0,322,277,45
SG,SA,2020.0,5,6,-1
nan,US,2008.0,219,241,-22
DE,JP,2020.0,187,182,5
CO,CL,2009.0,114,127,-13
NL,BE,2018.0,287,280,7
CN,FR,2005.0,180,309,-129
CH,AU,2016.0,82,85,-3
SI,IT,2010.0,9,7,2
TW,FR,2016.0,21,16,5
nan,GB,2011.0,79,91,-12
DE,PL,2017.0,122,148,-26
FR,GB,2011.0,540,568,-28
BD,DE,2005.0,2,2,0
MX,ES,2016.0,855,966,-111
SA,EG,2023.0,29,41,-12
JP,TW,2003.0,49,43,6
SE,DK,2007.0,100,61,39
BE,FR,2002.0,177,164,13
FR,NO,2006.0,40,33,7
JP,BD,1998.0,13,5,8
AU,BR,2017.0,103,135,-32
SE,SA,2015.0,8,4,4
nan,NL,2022.0,69,22,47
MX,AR,2008.0,66,69,-3
CO,FR,2020.0,52,36,16
CA,DE,2009.0,245,250,-5
NL,US,2020.0,822,905,-83
ES,IE,2017.0,44,29,15
CN,VN,2016.0,26,14,12
BR,GB,2017.0,254,227,27
AU,CN,2004.0,169,128,41
JP,NZ,2001.0,11,7,4
RU,SE,1999.0,32,12,20
GB,QA,2009.0,15,3,12
US,HU,2000.0,102,79,23
PE,US,2007.0,40,43,-3
DE,CH,2022.0,486,458,28
US,DO,2005.0,5,1,4
KR,DE,2004.0,26,29,-3
NL,SE,1998.0,26,13,13
GB,PK,2005.0,45,18,27
MX,US,2013.0,355,361,-6
VE,US,2009.0,58,32,26
CO,MX,2013.0,266,267,-1
DK,BR,2017.0,25,27,-2
IN,JP,2002.0,124,88,36
CN,BE,2016.0,76,61,15
CL,CO,2006.0,92,55,37
DE,RS,2019.0,19,31,-12
TR,RS,2000.0,15,12,3
CA,IR,2013.0,123,278,-155
DE,PL,2010.0,104,119,-15
BE,NL,2011.0,306,238,68
US,JM,2007.0,11,5,6
US,VE,2003.0,42,43,-1
US,PE,2008.0,39,43,-4
RO,IN,2017.0,13,20,-7
IT,RU,2021.0,56,51,5
CH,PT,2020.0,25,26,-1
DE,AU,2009.0,217,163,54
FI,CN,2002.0,8,11,-3
nan,CZ,2011.0,12,5,7
CU,US,2013.0,28,23,5
ID,US,2015.0,130,159,-29
DE,IT,2005.0,154,171,-17
TR,IT,1998.0,4,10,-6
CN,IL,2011.0,21,25,-4
IT,CU,2000.0,3,2,1
CN,AU,1997.0,39,44,-5
CA,FR,2016.0,617,612,5
TH,US,2003.0,67,104,-37
BR,DE,2013.0,173,215,-42
GB,SG,2011.0,124,76,48
MY,US,2016.0,186,199,-13
JP,BR,2017.0,59,66,-7
BR,GB,2019.0,337,289,48
BR,FR,2019.0,272,285,-13
CH,BE,2014.0,65,68,-3
DE,PT,2021.0,43,42,1
GB,NZ,2020.0,275,275,0
CN,CA,1998.0,131,127,4
NZ,AU,2012.0,225,127,98
UG,GB,2020.0,19,22,-3
IE,GB,2022.0,229,237,-8
FR,CH,2022.0,209,180,29
BH,SE,2016.0,1,1,0
AU,ID,2015.0,99,42,57
US,PL,2013.0,218,199,19
SE,NO,2021.0,92,70,22
TZ,IN,2021.0,4,2,2
AU,BR,2019.0,158,181,-23
PT,US,2021.0,126,165,-39
IR,AU,2006.0,12,22,-10
US,TR,2012.0,424,405,19
JP,BR,2019.0,58,73,-15
ZA,UG,2015.0,14,15,-1
ZA,US,2021.0,313,234,79
SD,SA,2017.0,44,19,25
IT,SE,2014.0,100,62,38
DZ,FR,2015.0,100,191,-91
PE,ES,2019.0,144,205,-61
BE,GB,2015.0,149,166,-17
RU,UA,2011.0,148,158,-10
IT,NO,1998.0,11,9,2
PL,MX,2020.0,4,4,0
GB,GR,2016.0,185,302,-117
BE,US,2004.0,209,146,63
RS,HR,2002.0,13,15,-2
IT,HR,2004.0,5,1,4
CO,BO,2018.0,9,6,3
IT,BR,2007.0,142,124,18
CH,SE,2008.0,36,39,-3
IL,AR,2013.0,4,4,0
ES,CN,2000.0,12,17,-5
IN,IT,2012.0,59,63,-4
GB,EE,2013.0,5,9,-4
CN,QA,2008.0,12,14,-2
CN,SE,2008.0,59,86,-27
CN,FR,2002.0,144,207,-63
CN,ES,2009.0,50,53,-3
PK,CN,2011.0,80,58,22
CN,IT,2012.0,34,46,-12
JM,AU,2012.0,1,5,-4
BR,TH,2013.0,7,3,4
US,PT,2001.0,60,60,0
US,GH,2021.0,53,44,9
CZ,CN,2009.0,62,50,12
CL,GB,2004.0,11,11,0
AE,EG,2002.0,8,7,1
CN,GB,2023.0,137,45,92
CN,ID,2009.0,18,18,0
IE,CN,2001.0,4,4,0
US,SE,2013.0,382,371,11
CH,FR,2020.0,366,507,-141
NG,CN,2021.0,35,43,-8
CH,LT,2012.0,4,2,2
ES,SE,2013.0,78,42,36
JP,GB,2003.0,223,263,-40
IT,nan,2009.0,110,92,18
DZ,nan,2020.0,13,12,1
FR,CN,2021.0,141,143,-2
VE,CO,2015.0,77,40,37
BE,FR,2005.0,233,214,19
IR,PL,2007.0,1,4,-3
RU,SK,2018.0,11,23,-12
IN,LB,2018.0,9,7,2
HR,UA,2017.0,3,4,-1
CA,TR,1999.0,11,1,10
AT,US,1998.0,107,115,-8
VE,CL,2017.0,40,12,28
MA,IT,2016.0,28,50,-22
NL,ES,2011.0,75,68,7
GB,PL,2013.0,85,91,-6
ES,ID,1999.0,1,1,0
UA,RU,1998.0,55,49,6
US,SN,2010.0,9,10,-1
FR,BE,2008.0,282,261,21
JP,SG,2016.0,46,33,13
RU,US,2006.0,341,246,95
BE,CD,2017.0,12,8,4
DE,ET,2018.0,19,7,12
NL,GB,2000.0,138,141,-3
FR,NL,2018.0,176,186,-10
CL,PT,2020.0,15,10,5
CN,TZ,2019.0,14,3,11
JO,US,2011.0,33,59,-26
TW,IN,2016.0,45,66,-21
NE,FR,2022.0,17,12,5
BH,GH,2016.0,11,16,-5
US,LB,2013.0,61,97,-36
CA,HR,2004.0,1,2,-1
DE,MK,2018.0,2,4,-2
MX,BE,2007.0,7,3,4
FI,NL,2008.0,29,36,-7
IT,PE,2019.0,9,5,4
BE,CD,2019.0,19,5,14
BE,CD,2010.0,4,3,1
SE,NG,2019.0,2,4,-2
GB,LB,2017.0,11,12,-1
FI,NO,2020.0,30,24,6
EC,US,2016.0,34,85,-51
ES,CR,2009.0,36,24,12
AT,HU,2013.0,34,38,-4
IL,HU,2010.0,4,4,0
CA,KW,2016.0,15,11,4
IN,KR,2006.0,82,47,35
ES,IE,2019.0,51,43,8
NO,DE,2016.0,85,127,-42
CN,IR,2014.0,32,51,-19
ET,KE,2018.0,6,7,-1
TW,GB,2003.0,38,42,-4
GB,VN,2015.0,11,15,-4
PT,NL,2014.0,22,30,-8
NZ,ZA,2008.0,6,12,-6
GR,BE,2014.0,29,14,15
CZ,DE,2002.0,33,22,11
SD,SA,2019.0,50,31,19
CH,RU,2022.0,17,28,-11
GB,RU,2002.0,36,70,-34
BI,DE,2011.0,2,1,1
CN,BR,2007.0,16,37,-21
CN,RO,2004.0,1,1,0
NP,JP,2015.0,7,9,-2
NO,FI,2014.0,11,30,-19
CZ,FR,2006.0,27,28,-1
RO,IN,2019.0,8,16,-8
CA,TH,2017.0,24,15,9
NL,KE,2012.0,8,15,-7
CA,IL,2016.0,61,59,2
IT,IE,2019.0,59,29,30
TR,SG,2016.0,8,8,0
NZ,CH,2010.0,5,13,-8
SA,PK,2002.0,6,5,1
nan,CA,2014.0,40,34,6
NZ,CH,2019.0,13,18,-5
CA,DK,2016.0,38,49,-11
FR,LU,2020.0,43,32,11
BR,DK,2011.0,11,15,-4
DE,nan,2004.0,31,26,5
DE,ID,2022.0,17,23,-6
ID,CN,2021.0,214,233,-19
BR,JP,2011.0,52,53,-1
GB,TN,2013.0,7,3,4
AT,HR,2017.0,8,7,1
AT,IN,2005.0,4,26,-22
EG,CA,2021.0,79,68,11
ES,RU,2014.0,21,15,6
UY,ES,2022.0,23,24,-1
CN,AE,2020.0,17,20,-3
PS,US,2017.0,16,5,11
PE,ES,2010.0,53,60,-7
US,KE,2018.0,90,101,-11
SE,FR,2002.0,35,47,-12
CA,AT,2017.0,37,23,14
US,SN,2017.0,10,12,-2
FI,DE,2021.0,54,56,-2
AE,AU,2021.0,9,18,-9
AT,US,1997.0,102,99,3
AT,HR,2010.0,8,4,4
AU,IN,2009.0,69,108,-39
ZA,MZ,2020.0,4,4,0
ID,HU,2019.0,21,11,10
SE,SK,2000.0,4,2,2
MY,nan,2005.0,10,8,2
AU,LK,2013.0,17,21,-4
SE,JP,2009.0,35,45,-10
DK,CH,2016.0,53,35,18
SK,DE,2007.0,29,35,-6
CA,TH,2019.0,17,13,4
NL,BR,2017.0,46,71,-25
RO,HU,2018.0,40,43,-3
ET,US,2016.0,47,44,3
MY,DE,2019.0,27,22,5
RU,BY,2004.0,23,27,-4
MC,FR,2003.0,6,4,2
CZ,CH,2014.0,34,37,-3
HU,GB,2021.0,40,28,12
SD,US,2022.0,6,9,-3
NG,NL,2009.0,3,4,-1
AU,IR,2022.0,45,97,-52
PK,EG,2018.0,15,17,-2
IN,PK,2016.0,262,277,-15
TR,US,2006.0,284,359,-75
FR,SE,2016.0,114,78,36
CL,ES,2008.0,191,208,-17
NP,IN,2016.0,122,145,-23
AT,SE,2020.0,44,25,19
FR,MD,2020.0,34,33,1
PE,FR,2022.0,10,9,1
DK,NO,2022.0,58,78,-20
IE,DE,2013.0,76,63,13
PH,CN,2015.0,23,18,5
CA,NO,2022.0,23,9,14
ML,US,2018.0,9,4,5
RU,CZ,1998.0,11,9,2
BI,FR,2021.0,18,21,-3
EG,BD,2016.0,8,8,0
IR,RU,2006.0,5,13,-8
JP,AT,2020.0,14,21,-7
CL,AU,2018.0,27,26,1
MY,IR,2014.0,167,122,45
HU,ID,2010.0,4,1,3
JP,BR,2010.0,56,49,7
SI,IT,2017.0,17,16,1
EG,JO,2008.0,3,3,0
RU,CN,2020.0,53,91,-38
PK,PL,2020.0,8,4,4
US,RO,2006.0,30,44,-14
GB,MX,1999.0,23,18,5
JP,CA,2011.0,100,92,8
FR,TW,2012.0,22,17,5
BR,CH,2013.0,37,50,-13
IE,PL,2015.0,9,8,1
AU,IL,2020.0,17,14,3
MY,nan,2002.0,11,1,10
AT,IN,2002.0,10,21,-11
DE,DK,2000.0,56,47,9
KR,RO,2019.0,1,2,-1
EG,KW,2019.0,38,33,5
SE,NL,2014.0,51,68,-17
FR,FI,1997.0,10,9,1
SK,AT,2021.0,8,9,-1
UA,EC,2012.0,15,16,-1
UY,MX,2022.0,6,6,0
nan,FR,2012.0,201,178,23
JP,RO,2003.0,4,5,-1
CA,MY,2013.0,34,31,3
FR,SK,2016.0,11,9,2
LU,CA,2019.0,6,5,1
GR,CH,2014.0,45,21,24
SE,FR,2005.0,45,39,6
SE,IR,2015.0,41,31,10
VN,NL,2008.0,4,3,1
DE,MX,2014.0,41,49,-8
DE,IT,2002.0,118,125,-7
BE,SE,2021.0,23,17,6
nan,CO,2013.0,6,8,-2
GB,KE,2009.0,22,22,0
IE,IT,2019.0,29,59,-30
BW,US,2014.0,9,15,-6
CN,CA,1997.0,56,115,-59
IN,nan,2021.0,85,95,-10
DE,VE,2018.0,3,8,-5
AU,GE,2020.0,2,1,1
IT,ZA,2016.0,31,16,15
ZM,BR,2020.0,2,5,-3
ES,UY,2014.0,44,41,3
ID,IE,2012.0,2,5,-3
GP,JM,2017.0,2,2,0
NP,MY,2013.0,1,2,-1
PL,FR,2012.0,31,45,-14
MA,PK,2013.0,11,25,-14
ID,CA,2013.0,8,11,-3
NZ,CO,2014.0,3,3,0
AU,SE,2020.0,81,65,16
AR,BE,2015.0,5,5,0
CN,MG,2018.0,4,10,-6
AT,CN,2006.0,11,13,-2
CL,CA,2018.0,21,27,-6
ES,PH,2015.0,25,16,9
NZ,RU,2013.0,3,10,-7
GB,LB,2019.0,12,20,-8
DE,CZ,2014.0,84,56,28
AF,MY,2016.0,1,2,-1
PL,JP,2002.0,12,25,-13
JO,CA,2008.0,9,5,4
ZA,ET,2018.0,14,7,7
KZ,RS,2015.0,5,1,4
US,SN,2019.0,11,8,3
RU,CZ,1997.0,9,5,4
ZA,BE,2014.0,24,14,10
CI,BF,2019.0,8,12,-4
JP,BE,2000.0,16,13,3
HU,PL,2011.0,13,11,2
IL,FR,2014.0,32,37,-5
US,EE,2010.0,7,10,-3
MY,AT,2019.0,5,3,2
AT,JP,2007.0,12,15,-3
ES,BD,2002.0,4,3,1
IT,IE,2017.0,41,28,13
DK,IR,2011.0,7,12,-5
NL,PL,2006.0,16,17,-1
HU,CL,2016.0,1,3,-2
RU,PT,2011.0,5,3,2
BR,PE,2005.0,14,5,9
FR,RU,2016.0,111,73,38
KR,AU,2008.0,26,20,6
AU,SK,2020.0,2,5,-3
FI,IT,2015.0,19,25,-6
CN,KR,2023.0,27,14,13
NL,VE,2019.0,4,1,3
SI,GB,2007.0,12,11,1
SG,IT,2015.0,7,18,-11
AT,CH,2000.0,48,39,9
RE,NC,2020.0,3,3,0
NG,IT,2016.0,12,4,8
KE,PK,2015.0,23,19,4
BR,CN,2003.0,10,16,-6
GB,HU,2018.0,49,65,-16
JP,BD,1997.0,6,2,4
GH,US,2001.0,7,7,0
GB,nan,2009.0,68,82,-14
nan,AU,2022.0,12,15,-3
MX,GB,2007.0,28,52,-24
BG,US,2009.0,31,20,11
ID,AT,2019.0,3,8,-5
BR,NL,2015.0,60,56,4
CZ,DE,2005.0,42,32,10
SA,PK,2005.0,14,7,7
RO,GB,2000.0,8,5,3
TW,SA,2014.0,9,3,6
GR,CA,1997.0,7,5,2
SG,MY,2005.0,23,21,2
TH,AU,2020.0,22,36,-14
CN,ET,2015.0,5,5,0
HR,IE,2020.0,6,3,3
EC,MX,2005.0,5,3,2
BH,ET,2014.0,4,3,1
US,QA,1998.0,6,2,4
VE,CL,2019.0,47,18,29
NO,CZ,2018.0,3,12,-9
nan,ZM,2019.0,5,1,4
IT,AU,2008.0,45,37,8
MX,IN,2015.0,16,16,0
MY,BD,2022.0,31,37,-6
CH,LB,2018.0,5,3,2
SI,HR,2012.0,13,26,-13
NP,US,2001.0,10,4,6
BD,KW,2020.0,4,1,3
CN,LB,2020.0,10,18,-8
DE,CM,2013.0,2,4,-2
IQ,JO,2020.0,19,20,-1
GH,ZA,2016.0,16,10,6
IT,CN,2022.0,40,57,-17
EG,TW,2015.0,12,10,2
EG,KW,2010.0,9,18,-9
MY,DE,2017.0,30,18,12
DK,PK,2017.0,8,8,0
SE,TW,2014.0,4,2,2
ES,IL,2022.0,13,8,5
IR,NG,2018.0,6,2,4
RU,KZ,2021.0,73,73,0
JP,PK,2022.0,6,10,-4
DE,BE,1999.0,49,51,-2
UZ,PL,2021.0,1,2,-1
NG,GH,2021.0,11,13,-2
FR,NC,2009.0,15,8,7
IT,DK,1997.0,16,11,5
JP,NG,2021.0,23,32,-9
HU,NO,2015.0,3,3,0
PK,IR,2020.0,17,23,-6
HU,DK,2016.0,11,2,9
FR,PS,2020.0,5,1,4
JP,PH,2018.0,30,24,6
UA,RU,1997.0,37,33,4
RS,TR,2005.0,58,66,-8
IT,NO,1997.0,6,5,1
IN,CH,2018.0,71,65,6
RU,KR,2007.0,10,10,0
PL,HU,2004.0,13,7,6
DK,GB,2009.0,92,117,-25
HU,ID,2019.0,11,21,-10
IE,IT,2017.0,28,41,-13
US,UG,2022.0,24,19,5
IT,IE,2010.0,29,15,14
SA,ES,2011.0,3,3,0
CR,BO,2016.0,2,2,0
IL,CH,2000.0,7,6,1
GR,AU,2005.0,6,3,3
CA,HU,2014.0,13,9,4
KE,FR,2012.0,9,12,-3
EC,BE,2021.0,9,4,5
GR,NO,2020.0,20,9,11
CA,NG,2008.0,5,6,-1
ID,BR,2018.0,16,29,-13
ID,HU,2017.0,8,22,-14
DE,CO,2014.0,30,24,6
JP,TH,1998.0,15,9,6
ZW,US,1997.0,3,4,-1
NL,AR,2013.0,12,12,0
IE,IT,2010.0,15,29,-14
HU,RS,2006.0,4,2,2
ZW,RU,2022.0,7,62,-55
US,CY,2005.0,24,2,22
RO,DE,2018.0,28,49,-21
SI,BE,2012.0,6,2,4
BG,ES,2013.0,4,1,3
HU,RU,2021.0,24,17,7
SE,TH,2007.0,7,1,6
GE,IL,2012.0,1,1,0
PL,IR,2014.0,7,4,3
GH,BR,2009.0,1,1,0
BD,IL,2021.0,2,1,1
EC,PT,2015.0,3,8,-5
IL,PS,2007.0,2,1,1
RU,IT,2014.0,18,42,-24
CN,MK,2001.0,2,1,1
RE,FR,2022.0,26,31,-5
HU,FR,2012.0,22,30,-8
IT,TR,2008.0,6,15,-9
PL,SI,2017.0,9,4,5
NO,JP,1999.0,4,5,-1
AU,UY,2004.0,1,1,0
DK,SG,2001.0,3,7,-4
UG,SE,2011.0,5,5,0
GB,LT,2004.0,3,2,1
TR,KZ,2013.0,47,29,18
JP,TH,1997.0,12,4,8
LT,CH,2006.0,1,1,0
SG,MY,2002.0,14,14,0
LY,GB,2013.0,2,19,-17
BR,LB,2014.0,5,5,0
GB,LB,2010.0,10,8,2
SE,UG,2010.0,3,2,1
AU,KR,2009.0,27,24,3
NZ,FR,2013.0,20,15,5
RU,BG,2009.0,25,19,6
CH,IN,2005.0,9,15,-6
NZ,ID,2005.0,1,1,0
AE,EG,2005.0,11,7,4
AR,GB,2021.0,33,37,-4
FI,SE,2003.0,64,41,23
CH,KE,2020.0,9,6,3
GB,ZM,2020.0,9,10,-1
RU,TW,2008.0,15,14,1
RU,MX,2008.0,6,7,-1
nan,SI,2008.0,2,2,0
RU,CA,2019.0,36,53,-17
US,MA,2014.0,22,19,3
CN,NL,2004.0,49,47,2
CA,BY,2018.0,1,1,0
IE,GR,2002.0,1,3,-2
PA,MX,2004.0,3,1,2
GA,NL,2012.0,6,5,1
RS,IE,2012.0,1,1,0
IN,TR,2011.0,13,17,-4
DE,KR,2007.0,36,23,13
IS,GB,2013.0,7,6,1
DK,BR,2019.0,20,34,-14
HU,IN,2019.0,7,21,-14
AT,IR,2013.0,8,10,-2
TZ,FI,2010.0,2,1,1
US,OM,2009.0,8,4,4
SK,HU,2021.0,11,8,3
CA,TN,2007.0,5,3,2
CA,RS,2010.0,9,6,3
NO,BR,2020.0,20,31,-11
IR,AT,2003.0,2,2,0
PK,IN,2003.0,25,30,-5
CZ,ES,2009.0,14,10,4
PA,ES,2004.0,6,9,-3
VE,CL,2010.0,29,11,18
AR,UY,2008.0,18,18,0
TT,JM,2021.0,17,8,9
PT,AO,2021.0,6,2,4
DE,RS,2010.0,20,17,3
IT,FI,2009.0,15,14,1
PT,NO,2012.0,5,6,-1
TR,CY,2006.0,4,5,-1
US,BG,2015.0,35,27,8
LK,ES,2022.0,2,3,-1
ES,LU,2008.0,1,1,0
AU,LU,2013.0,3,1,2
IT,PE,2017.0,5,2,3
CA,AR,2018.0,30,31,-1
NZ,DE,2003.0,20,20,0
JP,CZ,2001.0,7,7,0
SA,BH,2012.0,5,1,4
HR,US,2004.0,25,22,3
IR,GB,2011.0,64,97,-33
HU,AT,2013.0,38,34,4
US,IS,2018.0,22,12,10
SG,RU,2007.0,1,3,-2
ES,PL,2012.0,22,14,8
AT,TH,2007.0,5,5,0
FI,DK,2001.0,6,6,0
PY,CO,2015.0,5,12,-7
EG,SD,2016.0,23,26,-3
CA,AT,2010.0,27,33,-6
CA,RS,2017.0,9,11,-2
TR,CN,1999.0,2,4,-2
IT,IN,2018.0,54,65,-11
AL,IT,2021.0,5,6,-1
JP,KZ,2016.0,3,2,1
FR,KR,2000.0,4,10,-6
HN,ES,2005.0,6,3,3
SG,TR,2016.0,8,8,0
NZ,UG,2020.0,11,3,8
HR,DE,2011.0,12,17,-5
RU,CA,2010.0,21,16,5
SE,IE,2008.0,10,7,3
CA,TT,2009.0,5,2,3
FR,BD,2012.0,11,8,3
MD,DZ,2013.0,4,1,3
HU,JP,2018.0,9,11,-2
JM,CA,2016.0,8,2,6
US,EE,2017.0,18,23,-5
IN,TT,2002.0,1,1,0
DK,PK,2019.0,12,9,3
LU,US,2008.0,11,13,-2
NZ,PH,2017.0,2,3,-1
DK,IN,1999.0,4,3,1
LT,FI,2004.0,1,1,0
EG,IT,2018.0,8,17,-9
CH,GR,1999.0,11,2,9
AU,AR,2015.0,11,6,5
RO,CN,2022.0,9,13,-4
FR,NZ,2020.0,21,24,-3
NL,IR,2006.0,5,3,2
RS,TR,2002.0,23,28,-5
RU,LV,1998.0,7,3,4
IL,CZ,2018.0,5,2,3
ME,HR,2020.0,7,4,3
CG,BF,2013.0,1,4,-3
IT,SY,2013.0,2,2,0
AU,BE,2000.0,5,6,-1
HU,ID,2017.0,22,8,14
SE,NG,2017.0,5,4,1
TH,TR,2002.0,1,2,-1
FR,MC,2000.0,2,1,1
CZ,AT,2001.0,9,3,6
US,BH,2020.0,17,11,6
TR,HU,2017.0,9,1,8
SI,IT,2019.0,18,11,7
KZ,GB,2020.0,3,12,-9
BR,BE,2008.0,37,34,3
IN,BY,2022.0,3,1,2
CA,TH,2010.0,16,12,4
CN,BG,2013.0,19,10,9
EG,CN,2006.0,9,2,7
ZA,JP,2013.0,3,12,-9
JP,ET,2010.0,4,4,0
TH,SE,2020.0,8,4,4
DE,RS,2017.0,15,20,-5
SA,FR,2014.0,14,45,-31
UZ,RU,2014.0,19,7,12
ZA,NL,2015.0,46,47,-1
JM,US,2016.0,26,15,11
UA,MX,2007.0,3,2,1
IE,AT,2010.0,13,8,5
RU,NL,2004.0,15,12,3
US,EE,2019.0,15,17,-2
PL,JP,2005.0,16,17,-1
TH,NL,2013.0,7,9,-2
nan,FI,2020.0,8,14,-6
LT,US,1998.0,4,3,1
AU,RS,2012.0,5,3,2
CH,SK,2011.0,5,6,-1
nan,PT,1999.0,5,6,-1
UG,BE,2016.0,6,22,-16
DK,BE,2007.0,9,11,-2
OM,IE,2020.0,2,2,0
JP,AG,2020.0,5,8,-3
ES,IE,2010.0,20,20,0
IE,NO,2006.0,2,3,-1
UA,AU,2011.0,2,1,1
AE,GR,2013.0,1,2,-1
SE,IS,2008.0,11,6,5
IT,DK,1998.0,13,6,7
DZ,JO,2017.0,2,4,-2
IL,AT,1998.0,3,1,2
AU,FI,2012.0,13,22,-9
CH,EG,2004.0,2,1,1
DE,EG,2003.0,19,20,-1
LT,FR,2012.0,1,5,-4
BR,RU,2007.0,14,5,9
FI,AU,2005.0,3,9,-6
IT,GR,2008.0,17,16,1
ZW,US,1998.0,5,4,1
US,ZW,1999.0,2,8,-6
HU,SG,2011.0,1,3,-2
JP,ET,2019.0,12,4,8
TR,KW,2006.0,1,3,-2
RS,IL,2003.0,2,4,-2
FI,CA,2016.0,14,23,-9
MG,US,2016.0,3,3,0
CA,PL,2003.0,16,14,2
SA,KR,2014.0,5,19,-14
JP,GH,2011.0,5,2,3
JO,FR,2012.0,4,3,1
MX,SE,2005.0,2,1,1
GB,CZ,2003.0,14,16,-2
US,BS,2015.0,2,3,-1
KE,DK,2017.0,1,5,-4
IE,IN,2007.0,5,10,-5
ET,EG,2011.0,3,3,0
PT,SE,2022.0,17,9,8
MX,SE,2002.0,3,2,1
RS,HR,2005.0,38,55,-17
CA,AT,2019.0,25,27,-2
IE,DK,1999.0,2,2,0
NZ,CL,2009.0,3,1,2
CU,GB,2015.0,6,5,1
GB,JO,2001.0,9,4,5
MD,TN,2005.0,5,1,4
IT,LU,2018.0,14,10,4
CA,KN,2018.0,1,1,0
CA,IS,2018.0,3,1,2
HR,ES,2008.0,3,3,0
DZ,NL,2010.0,1,1,0
GB,RO,2004.0,5,10,-5
SE,MY,2016.0,11,9,2
HU,EG,2014.0,6,2,4
CL,IT,2001.0,7,12,-5
HK,GB,2013.0,5,6,-1
DE,CR,2000.0,1,1,0
JO,IL,2016.0,2,1,1
CO,NL,2002.0,5,2,3
EG,ID,2012.0,4,4,0
NZ,FI,2002.0,3,3,0
MX,VN,2014.0,3,10,-7
LU,CA,2017.0,8,2,6
SI,CZ,2001.0,4,2,2
DE,PK,2007.0,10,10,0
AU,PT,2007.0,10,1,9
LU,CA,2010.0,1,2,-1
NO,CH,1997.0,3,5,-2
DK,LT,2006.0,2,3,-1
CA,EC,2022.0,2,4,-2
JP,DK,2001.0,10,8,2
PH,ID,2012.0,3,1,2
DE,BJ,2018.0,5,1,4
GH,CN,2011.0,2,6,-4
IR,SA,2015.0,7,7,0
KR,MN,2018.0,9,5,4
ZA,nan,2021.0,10,6,4
ID,AT,2017.0,4,7,-3
IT,UG,2019.0,2,7,-5
RS,NL,2021.0,4,6,-2
SD,SA,2010.0,6,4,2
NO,IN,2011.0,13,18,-5
SG,PK,2012.0,2,4,-2
TR,AL,2011.0,5,4,1
ES,DO,2020.0,20,11,9
IN,KE,2022.0,4,6,-2
OM,SD,2013.0,1,2,-1
IT,TN,2021.0,16,17,-1
EG,KW,2017.0,16,32,-16
KR,RW,2019.0,2,1,1
RS,HU,2016.0,12,5,7
NG,FR,2022.0,5,4,1
UA,IT,2015.0,22,32,-10
GW,DK,2004.0,4,1,3
BR,ZM,2021.0,3,8,-5
ML,DE,2015.0,2,3,-1
HN,PE,2022.0,1,2,-1
nan,IN,2023.0,3,2,1
TR,HU,2019.0,10,9,1
TZ,ET,2022.0,1,3,-2
RO,BE,2014.0,17,15,2
IN,RO,2013.0,26,16,10
TN,SA,2007.0,6,2,4
BH,US,2016.0,11,14,-3
PT,IT,2003.0,13,12,1
RO,IN,2010.0,18,83,-65
ES,PA,2012.0,10,8,2
US,LV,2009.0,12,4,8
SA,FI,2014.0,2,2,0
CN,PT,2018.0,9,13,-4
EG,MY,2008.0,9,5,4
BR,PL,2004.0,1,1,0
BE,CO,2007.0,2,5,-3
IN,RU,1998.0,6,7,-1
PE,CL,2008.0,27,20,7
US,BW,2012.0,11,8,3
CH,NO,1999.0,9,6,3
JP,CL,2004.0,1,6,-5
RS,BE,2013.0,6,6,0
ZM,GH,2015.0,33,8,25
CY,PS,2015.0,1,1,0
BD,MA,2008.0,2,3,-1
JP,ET,2017.0,5,2,3
IT,NG,2020.0,3,13,-10
FI,TR,2022.0,4,6,-2
UA,PE,2021.0,2,1,1
CZ,TR,2014.0,5,10,-5
ZA,BW,2009.0,4,12,-8
CA,RS,2019.0,10,10,0
FR,CG,1999.0,7,4,3
BR,IE,2005.0,1,3,-2
US,AZ,1998.0,1,1,0
DE,CN,2023.0,27,47,-20
NO,ES,2022.0,22,27,-5
PA,VE,2013.0,3,3,0
CN,MM,2003.0,4,16,-12
ES,HN,2016.0,3,10,-7
PS,US,2019.0,13,17,-4
DE,TW,2021.0,24,26,-2
KR,UA,2010.0,1,2,-1
ES,NZ,2008.0,3,4,-1
XK,RS,2008.0,4,4,0
GB,PY,2017.0,2,2,0
TR,IN,2006.0,7,2,5
RW,UG,2018.0,1,3,-2
BE,CI,1998.0,1,1,0
PL,NL,2006.0,17,16,1
DE,GE,2020.0,6,8,-2
NZ,AT,2016.0,8,5,3
SE,UG,2017.0,3,3,0
IN,RU,1997.0,5,3,2
LK,CN,2005.0,2,1,1
IE,GR,2005.0,3,4,-1
GR,IN,2016.0,2,5,-3
ET,BW,2019.0,4,1,3
UA,SE,2001.0,7,4,3
SE,ZA,2009.0,6,9,-3
OM,BD,2011.0,1,2,-1
FI,JP,2011.0,9,21,-12
BG,MX,2010.0,2,1,1
CZ,LT,2015.0,1,2,-1
SE,UG,2019.0,3,3,0
BA,HR,2006.0,4,7,-3
RU,FI,2006.0,26,16,10
VE,nan,2013.0,6,1,5
OM,FR,2016.0,1,4,-3
NZ,FJ,2003.0,2,1,1
NI,US,2018.0,7,6,1
SE,HR,2014.0,1,1,0
CZ,RU,2009.0,22,33,-11
FI,IL,2013.0,1,3,-2
FR,FI,1998.0,9,2,7
SI,AT,2003.0,4,5,-1
BE,JP,2000.0,13,16,-3
SE,ID,2008.0,1,4,-3
SK,SI,2007.0,1,1,0
PY,ES,2007.0,4,4,0
BR,VE,2003.0,3,7,-4
MM,VN,2020.0,3,1,2
PE,PT,2012.0,1,2,-1
BE,SA,2011.0,2,1,1
CN,CL,2009.0,1,3,-2
UZ,JP,1999.0,4,1,3
CL,VE,2021.0,14,15,-1
SK,CA,2014.0,3,4,-1
GB,MK,2006.0,4,1,3
CL,RU,2019.0,6,2,4
IE,AT,2019.0,9,6,3
CH,VE,1997.0,1,4,-3
IN,LY,2022.0,3,2,1
PH,TW,2014.0,5,4,1
CL,RU,2010.0,3,4,-1
IE,AT,2017.0,2,8,-6
PG,AU,1999.0,3,4,-1
CH,VN,2018.0,6,3,3
SI,IN,2020.0,3,4,-1
PK,BD,2003.0,5,3,2
NZ,ES,2002.0,1,2,-1
VN,NZ,2014.0,3,2,1
BE,DK,1998.0,6,5,1
DE,BY,1999.0,5,8,-3
CA,TW,1998.0,17,17,0
PH,JP,2011.0,9,24,-15
HR,UA,2019.0,8,24,-16
PL,NZ,2019.0,4,2,2
MX,PA,2011.0,4,5,-1
IN,PT,2018.0,11,22,-11
HU,IN,2010.0,1,6,-5
BD,MY,2005.0,4,5,-1
NO,RU,2022.0,10,17,-7
ID,SG,2014.0,5,9,-4
CN,KP,2014.0,3,1,2
CU,PE,2005.0,3,2,1
US,BM,2014.0,4,5,-1
MX,BO,2009.0,4,2,2
SN,GM,2001.0,1,1,0
IL,HU,2019.0,6,15,-9
BG,RU,2004.0,13,15,-2
QA,AU,2007.0,6,5,1
PK,TR,2008.0,7,10,-3
BR,BG,2007.0,2,3,-1
SE,BD,2020.0,5,7,-2
ID,AU,1998.0,1,3,-2
BE,UY,2020.0,1,1,0
TN,RU,2014.0,1,1,0
GB,BI,2005.0,1,4,-3
RS,PT,2006.0,1,1,0
CL,PA,2015.0,3,2,1
NO,MA,2019.0,2,2,0
PT,BG,2005.0,1,1,0
SE,NZ,2013.0,4,11,-7
ZA,IR,2020.0,5,5,0
BD,GR,2013.0,2,4,-2
PT,AR,2022.0,8,9,-1
GH,TR,2022.0,2,1,1
IT,VE,2014.0,2,9,-7
IL,QA,2014.0,1,1,0
AU,PG,2012.0,9,9,0
NI,DE,2019.0,1,1,0
NZ,PH,2019.0,3,7,-4
ES,BD,2005.0,4,9,-5
TR,ES,2012.0,7,5,2
SA,GR,2021.0,3,3,0
CN,MX,2015.0,5,17,-12
PK,GN,2020.0,1,1,0
MX,TR,2020.0,3,2,1
GH,FR,2021.0,7,1,6
ID,TH,2015.0,6,9,-3
KG,US,2020.0,3,5,-2
RO,CA,2012.0,11,14,-3
IE,HU,2012.0,4,7,-3
PT,FI,2015.0,3,4,-1
DE,QA,2018.0,9,6,3
BJ,ES,2014.0,1,1,0
CA,RO,1999.0,2,5,-3
GP,JM,2010.0,1,2,-1
NO,CH,1998.0,9,10,-1
FI,AU,2002.0,3,7,-4
NZ,FI,2005.0,3,2,1
RO,IT,2020.0,17,27,-10
CO,IT,2004.0,1,2,-1
BA,US,2018.0,6,9,-3
EG,CZ,2017.0,3,3,0
FR,IE,2000.0,4,10,-6
MY,IE,2012.0,6,5,1
KW,IR,2009.0,3,1,2
SL,US,2014.0,4,2,2
MX,DO,2011.0,3,1,2
NI,CO,2015.0,3,4,-1
BH,IN,2014.0,3,3,0
BD,SE,2015.0,9,10,-1
KE,ET,2022.0,5,6,-1
SA,NL,2001.0,3,1,2
NZ,JP,2009.0,7,15,-8
BD,KR,2012.0,11,22,-11
nan,NG,2011.0,4,3,1
BE,EC,2007.0,2,1,1
nan,MA,2014.0,3,1,2
JO,BR,2018.0,2,2,0
BG,AT,2012.0,2,2,0
GE,CZ,2000.0,3,1,2
CH,IE,2001.0,4,5,-1
BD,TR,2016.0,2,2,0
UA,JP,2006.0,2,5,-3
CR,CL,2003.0,4,6,-2
TR,ZA,2017.0,6,3,3
GE,ZA,2012.0,1,2,-1
BE,SG,2009.0,3,3,0
MX,NO,2007.0,1,1,0
TH,GB,1999.0,11,13,-2
PT,MK,2013.0,1,1,0
AT,UA,2008.0,6,4,2
LT,CN,2003.0,6,9,-3
EE,RU,2003.0,1,4,-3
KR,BD,2011.0,15,14,1
CH,SG,1997.0,1,1,0
SG,PL,2008.0,1,1,0
BE,SI,2006.0,1,4,-3
US,MN,2018.0,3,2,1
NL,VE,2010.0,1,1,0
FR,PA,2016.0,4,3,1
BO,FR,2000.0,2,4,-2
BE,AR,2003.0,3,5,-2
TR,IE,2003.0,2,2,0
PS,ZA,2017.0,2,1,1
US,AM,2011.0,7,11,-4
TW,AR,2014.0,7,17,-10
AM,DE,2011.0,9,5,4
AU,nan,1998.0,5,5,0
IT,PY,2019.0,2,1,1
FI,NZ,2019.0,6,6,0
TR,ZA,2010.0,3,1,2
AE,PS,2018.0,2,2,0
LU,BE,2000.0,3,3,0
KE,TW,2013.0,1,1,0
MD,DE,2008.0,3,2,1
TN,PT,2005.0,1,2,-1
IL,CL,2012.0,3,4,-1
DE,SD,2019.0,3,4,-1
PA,CL,2016.0,6,9,-3
RO,NL,2004.0,4,2,2
PK,AF,2020.0,8,4,4
IT,AZ,2009.0,2,1,1
AM,FR,2004.0,2,1,1
CN,PL,2001.0,4,4,0
TZ,US,2002.0,7,5,2
GB,MT,2003.0,2,5,-3
GT,AR,2008.0,2,1,1
ET,UG,2014.0,1,1,0
IL,PL,2006.0,5,3,2
KG,KZ,2016.0,2,1,1
NG,CA,2009.0,2,1,1
TR,LU,2018.0,2,2,0
TR,SD,2015.0,1,1,0
EG,CZ,2019.0,2,5,-3
CA,KZ,2007.0,1,2,-1
DE,MA,2011.0,10,1,9
DK,MX,2006.0,1,3,-2
NZ,HU,2010.0,2,1,1
EE,AT,2013.0,3,2,1
EG,PK,2016.0,12,16,-4
IT,RO,2011.0,11,16,-5
EG,LK,2019.0,2,2,0
AE,ID,2021.0,9,7,2
DK,PK,2010.0,4,1,3
TW,BD,2018.0,2,3,-1
RO,CO,2018.0,1,1,0
nan,PL,2000.0,2,2,0
AO,PT,2020.0,4,2,2
DZ,SA,2021.0,8,6,2
CZ,BY,2006.0,6,8,-2
SI,CH,2007.0,5,2,3
CA,TW,1997.0,10,15,-5
DK,BR,2010.0,4,15,-11
KE,BH,2006.0,4,3,1
AT,PL,1997.0,3,4,-1
TW,HR,2002.0,1,1,0
TR,IL,2006.0,2,7,-5
FR,EE,2016.0,2,10,-8
AE,MY,2015.0,5,9,-4
NO,TW,2014.0,1,2,-1
KH,GB,2020.0,7,7,0
RO,VN,2015.0,3,8,-5
NL,TH,2008.0,5,6,-1
AR,AO,2016.0,1,1,0
PS,IT,2019.0,1,2,-1
RS,CA,2014.0,5,11,-6
UG,ZA,2016.0,12,13,-1
TR,ZA,2019.0,3,1,2
DZ,IE,2020.0,1,1,0
PE,EC,2009.0,2,2,0
NO,CA,2001.0,7,9,-2
NO,IS,1999.0,2,2,0
VN,ES,2020.0,1,2,-1
CH,IN,2002.0,9,15,-6
SY,US,2004.0,2,7,-5
DO,US,2018.0,5,5,0
GR,FI,2021.0,3,4,-1
FO,SE,2018.0,1,1,0
OM,CN,2018.0,2,2,0
US,QA,1997.0,4,4,0
KW,QA,2016.0,6,3,3
DK,IS,2004.0,5,4,1
QA,AE,2006.0,1,3,-2
BR,PH,2008.0,2,5,-3
IQ,SG,2019.0,5,4,1
DZ,SE,2020.0,5,10,-5
AG,IN,2020.0,2,2,0
NO,ET,2009.0,3,2,1
IR,BR,2003.0,1,1,0
KR,UA,2017.0,5,1,4
JO,SE,2015.0,2,2,0
CO,PY,2011.0,3,2,1
GP,JM,2019.0,5,2,3
nan,IL,1999.0,6,12,-6
LK,DK,2016.0,1,2,-1
SG,NZ,1997.0,1,3,-2
FR,TH,2016.0,19,18,1
IQ,SE,2022.0,3,1,2
MN,DZ,2015.0,2,1,1
US,ME,2018.0,1,5,-4
PE,SV,2018.0,3,5,-2
DK,PL,1998.0,2,1,1
IT,SI,2014.0,11,13,-2
US,GA,2011.0,1,2,-1
PT,DE,1999.0,9,5,4
ES,FI,2000.0,4,6,-2
GN,GB,2016.0,1,1,0
MA,BE,2006.0,1,4,-3
RS,SE,2013.0,3,6,-3
CH,IS,2005.0,1,1,0
RU,HU,2007.0,9,8,1
SE,PS,2017.0,1,2,-1
PH,KR,2005.0,3,2,1
AR,CZ,2018.0,3,5,-2
IE,NZ,2000.0,2,6,-4
EG,BH,2006.0,2,2,0
LB,IE,2019.0,4,1,3
NE,TN,2019.0,1,1,0
ES,GE,2014.0,2,2,0
KR,NZ,2007.0,2,7,-5
GH,KE,2011.0,1,1,0
BH,ZA,2021.0,1,1,0
SE,BG,2016.0,3,1,2
TH,NG,2020.0,2,4,-2
IT,PK,2015.0,9,7,2
JO,JP,2006.0,2,6,-4
LK,MY,2022.0,3,3,0
BR,PE,2002.0,5,4,1
FI,MX,2022.0,2,2,0
BD,NG,2019.0,1,3,-2
KE,DK,2019.0,3,3,0
CZ,KR,2003.0,1,3,-2
HU,nan,2016.0,6,4,2
TN,JP,2006.0,1,2,-1
ZW,ZA,2004.0,9,3,6
PL,SI,2019.0,4,5,-1
SI,JP,2016.0,1,1,0
IN,TT,2005.0,1,3,-2
CA,MW,2005.0,1,2,-1
DK,IQ,2020.0,1,1,0
CH,RS,2003.0,5,1,4
KR,UA,2019.0,1,3,-2
CG,SN,2018.0,1,2,-1
SV,CU,2014.0,1,1,0
SA,YE,2013.0,3,1,2
RW,CN,2021.0,6,5,1
CN,LK,2009.0,4,5,-1
EE,CA,2021.0,2,1,1
NP,CA,2007.0,1,2,-1
BY,HU,2016.0,3,3,0
SE,VE,2010.0,1,1,0
CN,HU,2003.0,1,3,-2
CH,KR,2004.0,4,4,0
CL,IN,2013.0,2,2,0
PA,DE,2006.0,1,2,-1
SV,ES,2016.0,2,8,-6
JP,EC,2008.0,1,1,0
KR,PH,1999.0,3,1,2
PL,AE,2018.0,3,2,1
ID,LK,2022.0,1,1,0
PT,IR,2012.0,4,14,-10
GB,TT,2013.0,5,1,4
JO,IN,2011.0,1,1,0
AU,SI,2006.0,1,3,-2
CH,UG,2016.0,2,7,-5
CI,BF,2017.0,3,4,-1
IN,AT,1999.0,2,13,-11
IQ,AF,2018.0,1,1,0
LA,TR,2020.0,3,7,-4
PR,MX,2018.0,3,10,-7
CN,NP,2007.0,1,2,-1
MY,CH,2022.0,1,2,-1
VN,GH,2019.0,1,1,0
GB,DZ,2008.0,5,4,1
FR,LK,2019.0,3,4,-1
FR,IQ,2022.0,3,2,1
GB,JE,2018.0,1,1,0
VE,RU,2019.0,2,1,1
HU,IN,2017.0,5,14,-9
BE,PE,2022.0,3,2,1
JP,SD,2022.0,1,2,-1
IE,FI,2021.0,2,5,-3
NL,NG,2021.0,4,8,-4
BD,MY,2002.0,4,2,2
BH,OM,2019.0,1,2,-1
XK,SE,2019.0,3,1,2
AT,PH,2013.0,4,2,2
PK,NG,2008.0,1,3,-2
PT,BG,2002.0,1,2,-1
AM,GB,2018.0,7,1,6
AU,LB,2004.0,1,1,0
EC,CR,2022.0,5,7,-2
MY,MK,2015.0,1,2,-1
IL,IE,2018.0,5,3,2
IT,IR,2007.0,1,8,-7
ES,ZA,2009.0,5,2,3
AU,nan,1997.0,3,4,-1
CO,SG,2013.0,2,1,1
AE,JP,2000.0,1,1,0
CR,VE,2021.0,3,1,2
CZ,PK,2013.0,2,2,0
nan,ZM,2017.0,1,2,-1
ZA,ZW,2004.0,3,9,-6
IE,TH,2020.0,2,5,-3
HU,UA,2015.0,3,1,2
BE,CZ,2006.0,4,6,-2
OM,SA,2012.0,6,11,-5
nan,CL,2021.0,2,3,-1
UG,CH,2021.0,2,4,-2
CA,NP,2013.0,1,5,-4
PT,SA,2022.0,2,4,-2
CN,TN,2014.0,1,3,-2
BD,AR,2019.0,1,1,0
MA,YE,2018.0,1,1,0
TZ,US,2005.0,6,3,3
IT,KE,2007.0,2,2,0
NA,GB,2022.0,3,2,1
PL,NZ,2017.0,2,1,1
BO,CL,2014.0,4,13,-9
CL,DO,2020.0,2,3,-1
IM,GB,2007.0,1,1,0
PH,KR,2002.0,3,1,2
PL,CL,2018.0,3,5,-2
TW,ES,2020.0,3,2,1
CR,RU,2012.0,1,1,0
AT,LT,2022.0,1,1,0
IE,EG,2021.0,6,8,-2
BR,IE,2002.0,2,4,-2
DE,SD,2017.0,2,3,-1
CU,IL,2010.0,1,1,0
ID,CO,2012.0,1,2,-1
NL,SG,2023.0,1,2,-1
AE,CA,2003.0,2,10,-8
PH,MY,2015.0,2,1,1
LK,BR,2019.0,2,6,-4
DE,SD,2010.0,3,2,1
BD,NG,2017.0,3,1,2
NZ,SG,2000.0,3,3,0
BY,IL,2007.0,1,1,0
AU,EG,2012.0,9,10,-1
EG,BA,2022.0,1,1,0
TW,IL,2009.0,1,1,0
EG,IE,2003.0,1,1,0
NG,SD,2013.0,3,4,-1
ZA,CD,2022.0,1,2,-1
CH,PH,2012.0,1,6,-5
RO,UA,2020.0,3,10,-7
LV,UA,2014.0,2,1,1
MW,ZM,2020.0,2,3,-1
LK,EG,2014.0,1,1,0
ID,GB,2000.0,3,3,0
TL,BR,2013.0,1,1,0
MX,CA,2000.0,4,11,-7
PK,BH,2018.0,1,2,-1
FR,LT,2008.0,3,2,1
QA,TW,2015.0,1,3,-2
NG,EG,2008.0,2,3,-1
CR,SE,2013.0,1,1,0
CA,LB,2000.0,1,2,-1
ZM,NG,2018.0,1,1,0
GR,SK,2019.0,1,2,-1
PL,GR,2000.0,3,2,1
SG,RO,2004.0,1,1,0
ID,CL,2015.0,2,6,-4
PL,GE,2003.0,1,2,-1
SK,DK,2016.0,1,3,-2
EG,CZ,2010.0,1,2,-1
DK,PL,1997.0,2,2,0
MY,DZ,2013.0,1,1,0
TZ,NG,2004.0,1,1,0
BJ,DE,2004.0,1,1,0
SD,PS,2017.0,1,1,0
JP,AM,2015.0,2,2,0
JP,AE,2022.0,2,2,0
SG,VN,2007.0,3,1,2
ET,LY,2014.0,1,1,0
SG,FI,2021.0,4,5,-1
DE,BH,2015.0,1,1,0
US,BJ,2009.0,1,3,-2
AE,TN,2021.0,1,5,-4
ID,HU,2010.0,1,4,-3
RU,MN,2007.0,4,1,3
XK,MX,2019.0,1,2,-1
IT,PE,2010.0,2,4,-2
CU,BE,2001.0,1,1,0
PT,SG,2018.0,3,1,2
nan,BD,2013.0,3,4,-1
ZA,BH,2021.0,1,1,0
VN,CA,2004.0,3,1,2
EE,PK,2022.0,1,1,0
RS,LY,2017.0,1,1,0
MK,AU,1998.0,1,5,-4
US,FJ,2003.0,1,1,0
GP,MQ,2014.0,1,1,0
LU,DE,1998.0,3,2,1
NO,SJ,2003.0,2,4,-2
DZ,DE,2009.0,2,4,-2
NZ,MT,2015.0,2,1,1
US,MW,2004.0,5,2,3
LU,DE,1997.0,3,2,1
ID,IT,2001.0,1,1,0
ET,BW,2017.0,3,2,1
TW,US,2013.0,764,734,30
IN,JP,2005.0,107,112,-5
CH,IL,2002.0,16,8,8
GB,CA,2014.0,927,884,43
PL,US,2018.0,305,270,35
FI,CN,2005.0,22,11,11
ID,JP,2009.0,32,112,-80
US,IL,2022.0,262,264,-2
MX,FR,2008.0,34,41,-7
DE,TH,2020.0,16,19,-3
ES,DE,2013.0,243,212,31
DK,JP,2011.0,16,12,4
GB,PK,2002.0,32,11,21
nan,LB,2013.0,1,1,0
NL,SE,1997.0,16,15,1
US,ID,2020.0,363,227,136
IT,FR,2017.0,458,359,99
DE,PL,2019.0,157,147,10
BR,ZA,2013.0,7,19,-12
IT,DE,2020.0,388,333,55
NL,DE,2022.0,227,266,-39
IT,CA,2004.0,65,43,22
MY,DE,2010.0,13,9,4
NL,BR,2010.0,37,41,-4
FR,MA,2016.0,266,216,50
BR,FR,2017.0,250,245,5
GR,US,2006.0,133,169,-36
AR,IT,2014.0,103,104,-1
NO,DK,2008.0,62,57,5
GR,SE,2018.0,24,20,4
AT,AU,2013.0,23,25,-2
BR,FR,2010.0,165,163,2
CH,IL,2005.0,10,11,-1
nan,SE,2008.0,52,42,10
IT,ES,2013.0,251,236,15
GB,NG,2020.0,112,128,-16
CL,AR,2016.0,102,114,-12
CN,SG,2004.0,196,237,-41
BR,CL,2008.0,42,38,4
RU,CA,2017.0,19,43,-24
PL,IT,2018.0,34,42,-8
NL,AU,2022.0,46,59,-13
CN,DK,2014.0,32,45,-13
JP,AU,2009.0,70,53,17
IN,FI,2018.0,22,17,5
MX,CH,2006.0,7,2,5
JP,ID,2008.0,96,36,60
CU,AR,2009.0,14,17,-3
IR,MY,2018.0,71,187,-116
MY,CA,2014.0,36,27,9
CA,NL,2000.0,46,34,12
TW,SE,2018.0,7,6,1
SK,GB,2020.0,30,16,14
GB,RU,2005.0,65,69,-4
FR,BG,2006.0,10,6,4
SE,EE,1998.0,9,6,3
IR,SE,2018.0,43,35,8
SN,US,2021.0,9,14,-5
RU,EE,2021.0,14,11,3
CZ,UZ,2009.0,2,1,1
JO,nan,2016.0,2,1,1
BR,nan,2011.0,64,67,-3
IT,CM,2006.0,3,1,2
PL,BY,2018.0,3,4,-1
AT,HR,2019.0,14,11,3
OM,JO,2015.0,1,5,-4
LB,IT,2022.0,4,24,-20
IN,QA,2018.0,23,22,1
DK,TW,2012.0,1,4,-3
NZ,CH,2017.0,17,11,6
KR,nan,2012.0,23,22,1
MY,PK,2009.0,8,13,-5
JP,IE,2022.0,22,10,12
CN,TZ,2017.0,3,6,-3
CH,NL,2003.0,53,49,4
DE,IE,2000.0,25,14,11
SK,RU,1999.0,5,4,1
BD,AU,2007.0,4,7,-3
FR,GR,2008.0,33,21,12
SK,AU,2017.0,3,7,-4
AU,BR,2010.0,63,79,-16
IR,DE,2001.0,3,6,-3
ML,SN,2014.0,2,3,-1
HN,EC,2021.0,2,3,-1
EG,CH,2022.0,2,7,-5
SD,GB,2016.0,4,8,-4
IT,NZ,2013.0,14,7,7
GH,AU,2021.0,19,13,6
AU,PH,2006.0,6,11,-5
DK,CZ,2001.0,3,2,1
CH,IR,2022.0,9,19,-10
CN,BY,2020.0,3,2,1
DE,UG,2004.0,1,2,-1
AU,AE,2005.0,7,2,5
HR,SK,2020.0,5,5,0
UA,PL,2004.0,9,5,4
NZ,AE,2006.0,3,2,1
TN,EG,2012.0,8,12,-4
AU,FJ,2014.0,6,6,0
SG,ES,2012.0,5,3,2
SK,AU,2019.0,4,5,-1
KW,AE,2018.0,6,5,1
FI,IN,2001.0,4,1,3
TN,MD,2009.0,9,10,-1
PA,CR,2021.0,3,5,-2
ID,SA,2022.0,11,12,-1
PK,CH,2009.0,6,15,-9
SA,SY,2009.0,1,1,0
BY,CA,2002.0,1,3,-2
EE,AU,2018.0,5,4,1
KR,BE,2002.0,3,2,1
ET,DK,2002.0,1,1,0
FR,UG,1999.0,2,1,1
HU,TR,2016.0,2,8,-6
VN,FR,2007.0,9,13,-4
FI,NZ,2010.0,2,3,-1
ME,SI,2013.0,1,1,0
NZ,HU,2019.0,3,1,2
US,CY,2002.0,9,8,1
MY,FI,2014.0,1,6,-5
SI,BA,2009.0,2,1,1
PT,NZ,2014.0,4,3,1
VE,IT,2016.0,4,2,2
PY,AR,2021.0,5,8,-3
FR,LK,2010.0,1,5,-4
BE,MX,2012.0,7,14,-7
NL,RW,2019.0,2,2,0
CI,FR,2014.0,10,31,-21
BR,GE,2018.0,2,1,1
IL,UA,2001.0,4,5,-1
IN,IQ,2014.0,7,4,3
IL,BR,2013.0,5,6,-1
FR,NG,2012.0,5,3,2
LB,EG,2005.0,1,3,-2
AT,AR,2012.0,1,3,-2
CU,IT,1997.0,1,2,-1
CO,KE,2005.0,2,1,1
EE,BR,2019.0,1,3,-2
CA,MK,2008.0,1,1,0
BE,HU,2003.0,5,8,-3
EG,LY,2012.0,3,2,1
SE,NG,2010.0,4,2,2
GR,IE,2018.0,8,4,4
US,SV,2014.0,4,1,3
GP,FR,1997.0,3,5,-2
TN,IN,2014.0,7,3,4
NL,LB,2018.0,3,2,1
SY,EG,2007.0,2,2,0
PS,JO,2005.0,1,1,0
JE,US,2016.0,2,1,1
PL,ES,2000.0,5,1,4
QA,US,2004.0,6,13,-7
MY,AU,2000.0,4,3,1
LT,SE,2004.0,2,6,-4
QA,GR,2013.0,1,5,-4
QA,SG,2022.0,3,1,2
SE,LT,2006.0,4,3,1
IL,AT,1997.0,3,1,2
IN,ES,2005.0,9,4,5
TR,MY,2006.0,2,1,1
GR,AU,2002.0,2,4,-2
TW,MX,2011.0,2,3,-1
GE,GB,2006.0,5,6,-1
ZA,IE,2001.0,3,1,2
NO,PL,2006.0,3,4,-1
nan,VE,2003.0,2,1,1
HU,IL,2013.0,5,4,1
UG,NO,2018.0,1,5,-4
SK,CH,2003.0,9,5,4
NO,IQ,2019.0,2,1,1
FR,HR,1999.0,1,3,-2
DE,MW,2015.0,2,3,-1
SA,NO,2020.0,3,2,1
PY,CU,2013.0,1,1,0
CU,IL,2017.0,2,1,1
AU,VE,2021.0,1,4,-3
GP,FR,1998.0,3,5,-2
BE,ES,2018.0,95,127,-32
CH,AT,2016.0,114,127,-13
TR,GB,2009.0,58,47,11
US,PR,2000.0,3,8,-5
NL,PT,2022.0,24,27,-3
DE,PH,2008.0,6,7,-1
BR,PY,2013.0,4,3,1
NO,EE,2019.0,4,3,1
ES,BE,1999.0,15,18,-3
MY,CN,2000.0,6,5,1
RU,BD,2015.0,1,2,-1
MA,CA,1998.0,3,2,1
PT,LT,2015.0,1,1,0
AE,IE,2020.0,3,6,-3
QA,TR,2013.0,2,3,-1
PL,AT,2023.0,1,1,0
,CU,1998.0,348,0,348
,IT,2003.0,11038,0,11038
PL,,2024.0,35365,0,35365
,TR,2013.0,8137,0,8137
JP,,2012.0,11931,0,11931
BR,,2024.0,102046,0,102046
,DE,2012.0,20967,0,20967
FR,,2021.0,22347,0,22347
LA,BR,2019.0,2,0,2
DK,,2020.0,2432,0,2432
,GB,2014.0,16759,0,16759
,MX,1995.0,3065,0,3065
CN,,2008.0,9096,0,9096
,CH,2007.0,3648,0,3648
NO,,2021.0,2735,0,2735
,EG,2017.0,4385,0,4385
,EG,2010.0,3254,0,3254
,MD,1994.0,256,0,256
GB,,2002.0,6014,0,6014
,TW,2000.0,4113,0,4113
,MY,2009.0,4144,0,4144
SG,,2008.0,392,0,392
,AT,2006.0,2194,0,2194
,DK,2000.0,1297,0,1297
NG,,2024.0,11970,0,11970
,IE,2003.0,1123,0,1123
,AE,2007.0,182,0,182
,CZ,1997.0,1201,0,1201
TR,,2022.0,10755,0,10755
GB,,2005.0,5988,0,5988
,QA,2014.0,411,0,411
,AR,1999.0,1632,0,1632
,LT,2002.0,480,0,480
SE,,2007.0,1301,0,1301
TH,,2023.0,9478,0,9478
,BD,2006.0,683,0,683
,CL,2000.0,1323,0,1323
,CU,1997.0,333,0,333
,LU,2012.0,150,0,150
,ZA,2008.0,2044,0,2044
,IN,2016.0,23762,0,23762
,NO,1998.0,1307,0,1307
GD,,2022.0,32,0,32
,NO,1997.0,1361,0,1361
,CO,2001.0,846,0,846
,NE,2010.0,34,0,34
,MT,2010.0,87,0,87
SK,,2023.0,3632,0,3632
,KE,2013.0,645,0,645
,JO,2010.0,429,0,429
EG,,2005.0,258,0,258
,GH,2011.0,497,0,497
,nan,2003.0,957,0,957
AE,,2013.0,84,0,84
MU,,2019.0,35,0,35
,CZ,1998.0,1336,0,1336
SI,,2006.0,128,0,128
,ET,2017.0,1408,0,1408
CH,VE,1998.0,3,0,3
,BG,2015.0,577,0,577
JO,,2013.0,93,0,93
,NE,2017.0,47,0,47
RW,,2020.0,66,0,66
,MM,2014.0,64,0,64
,CM,2005.0,171,0,171
,DZ,1999.0,199,0,199
SZ,,2017.0,7,0,7
,CM,2002.0,141,0,141
,BY,1995.0,492,0,492
CD,,2024.0,474,0,474
,CR,2000.0,149,0,149
,KZ,2005.0,120,0,120
,ET,2010.0,381,0,381
,GR,2018.0,1904,0,1904
,SN,2014.0,172,0,172
,LT,2005.0,515,0,515
SD,,2022.0,249,0,249
CM,,2020.0,298,0,298
,PE,2016.0,994,0,994
ET,TH,2017.0,2,0,2
,TG,2012.0,81,0,81
AT,,2007.0,710,0,710
UA,,1998.0,89,0,89
CH,,1998.0,605,0,605
IQ,,2014.0,46,0,46
FI,,1999.0,336,0,336
TJ,DE,2018.0,2,0,2
ID,,2011.0,112,0,112
,BO,2011.0,46,0,46
EG,,2002.0,169,0,169
CA,LT,2002.0,3,0,3
PK,TJ,2016.0,1,0,1
MD,,2013.0,53,0,53
MV,,2024.0,23,0,23
NA,,2022.0,94,0,94
UG,SG,2020.0,1,0,1
,MK,2008.0,128,0,128
ME,AE,2017.0,1,0,1
ET,,2002.0,14,0,14
,JO,2017.0,591,0,591
GR,,2006.0,592,0,592
,AM,2018.0,137,0,137
OM,BE,2019.0,3,0,3
MY,VE,2011.0,1,0,1
HN,ES,2002.0,6,0,6
AF,,2020.0,9,0,9
CR,,2009.0,27,0,27
BY,GE,2014.0,2,0,2
AU,KH,2014.0,1,0,1
NO,NL,2023.0,3,0,3
,EG,2019.0,1927,0,1927
DZ,JO,2019.0,3,0,3
SV,,2008.0,5,0,5
IN,EG,2008.0,5,0,5
,MG,2012.0,71,0,71
ZA,CR,2022.0,1,0,1
GQ,,2023.0,1,0,1
ER,,2023.0,15,0,15
,MT,2017.0,51,0,51
CY,,2012.0,49,0,49
,ET,2019.0,1230,0,1230
,BH,2018.0,110,0,110
,JO,2019.0,392,0,392
,GT,2019.0,24,0,24
FI,GH,2011.0,1,0,1
,GA,2018.0,25,0,25
CM,ZM,2019.0,1,0,1
NG,KR,2023.0,2,0,2
nan,,2007.0,245,0,245
,FI,2016.0,1605,0,1605
,BR,2020.0,702,0,702
KY,US,2022.0,2,0,2
,PS,1998.0,28,0,28
ER,NL,2020.0,1,0,1
IS,,2006.0,32,0,32
TZ,,2004.0,18,0,18
,GT,2010.0,33,0,33
MX,LU,2016.0,1,0,1
GH,,2001.0,21,0,21
RS,,1998.0,20,0,20
YE,,2018.0,28,0,28
,KZ,2002.0,95,0,95
LK,NL,2018.0,2,0,2
,CW,2013.0,13,0,13
,KG,2008.0,20,0,20
,GT,2017.0,60,0,60
DO,,2007.0,1,0,1
EG,ZA,2015.0,7,0,7
VE,LT,2011.0,1,0,1
TZ,CO,2001.0,1,0,1
PT,RU,2012.0,7,0,7
DK,AE,2005.0,1,0,1
,HN,1999.0,24,0,24
SX,GD,2007.0,3,0,3
NC,CG,2018.0,2,0,2
,NA,2006.0,12,0,12
CL,LU,2020.0,1,0,1
CO,FI,2016.0,3,0,3
GM,,2022.0,35,0,35
IR,EG,2023.0,1,0,1
BD,DE,2002.0,3,0,3
BD,,2026.0,11,0,11
,MT,2019.0,43,0,43
MY,,1999.0,71,0,71
EC,,2011.0,42,0,42
,AF,2017.0,31,0,31
,LA,2017.0,21,0,21
IL,FI,2007.0,3,0,3
TW,BF,2016.0,1,0,1
TD,MA,2016.0,1,0,1
MU,,2010.0,9,0,9
JP,LV,2010.0,3,0,3
,PS,1997.0,23,0,23
UG,BW,2014.0,3,0,3
AO,,2016.0,18,0,18
LB,ML,2015.0,1,0,1
IE,BG,2016.0,2,0,2
RO,LT,2015.0,2,0,2
NP,KE,2019.0,1,0,1
MK,CN,2000.0,2,0,2
CY,BE,2011.0,1,0,1
MU,,2017.0,20,0,20
,ML,2008.0,35,0,35
CI,,2014.0,40,0,40
PA,BE,2004.0,1,0,1
KH,,2016.0,29,0,29
,LA,2010.0,17,0,17
CY,MY,2013.0,1,0,1
VG,RU,2006.0,3,0,3
SE,PS,2019.0,1,0,1
CN,CD,2016.0,2,0,2
,LY,1996.0,25,0,25
UZ,,2004.0,46,0,46
MW,ES,2019.0,2,0,2
,KN,2012.0,8,0,8
ST,IT,2017.0,1,0,1
AT,AG,2021.0,1,0,1
ES,BY,2014.0,3,0,3
KE,IN,1998.0,4,0,4
BW,DE,2019.0,1,0,1
LY,,2011.0,15,0,15
AR,JO,2020.0,1,0,1
VU,,2022.0,3,0,3
,AF,2010.0,9,0,9
BE,NP,2016.0,4,0,4
TW,GR,2006.0,3,0,3
KN,GB,2016.0,2,0,2
CO,PL,2014.0,5,0,5
RS,LY,2019.0,3,0,3
CW,,2025.0,1,0,1
UZ,IN,2021.0,1,0,1
RU,VN,2002.0,1,0,1
,LK,2020.0,23,0,23
MZ,,2025.0,12,0,12
VE,HN,2013.0,3,0,3
VN,SG,2003.0,1,0,1
LI,,2025.0,2,0,2
LB,ES,2004.0,1,0,1
GB,YE,2015.0,1,0,1
TW,GM,2015.0,2,0,2
,MN,1998.0,11,0,11
RU,KH,2021.0,1,0,1
VG,CY,2003.0,1,0,1
PT,CA,2023.0,3,0,3
DE,KP,2017.0,1,0,1
RW,GR,2020.0,1,0,1
MN,UA,2011.0,1,0,1
NC,MD,2019.0,1,0,1
SI,NZ,2010.0,1,0,1
GE,MU,2010.0,1,0,1
BE,MA,2009.0,8,0,8
UA,AR,2014.0,6,0,6
,TD,2001.0,5,0,5
ET,CH,2003.0,1,0,1
KE,RW,2015.0,3,0,3
PK,KH,2012.0,1,0,1
UG,LU,2013.0,3,0,3
PL,SA,2012.0,2,0,2
KY,,2023.0,10,0,10
RO,EC,2019.0,1,0,1
DO,CA,2017.0,2,0,2
UG,NZ,2023.0,3,0,3
,GD,2001.0,2,0,2
HT,NP,2016.0,1,0,1
IT,NI,2010.0,1,0,1
SI,NZ,2019.0,1,0,1
BO,DO,2008.0,1,0,1
,FO,2001.0,3,0,3
LV,KR,2008.0,2,0,2
DE,NP,2006.0,3,0,3
SL,UG,2021.0,1,0,1
,BS,2001.0,1,0,1
BI,CH,2007.0,1,0,1
TG,TR,2011.0,1,0,1
SE,VN,2016.0,5,0,5
,SL,2006.0,1,0,1
SZ,,2019.0,4,0,4
,SS,2003.0,10,0,10
SI,CA,2002.0,1,0,1
PH,BE,2004.0,1,0,1
AL,IN,2018.0,1,0,1
IT,ML,2020.0,1,0,1
AM,AZ,2021.0,1,0,1
ZW,AM,2005.0,2,0,2
NG,BF,2022.0,1,0,1
SI,FI,2018.0,3,0,3
SS,JP,2021.0,1,0,1
MK,UA,2008.0,1,0,1
ET,,2005.0,11,0,11
PL,VA,2019.0,1,0,1
BR,FI,2004.0,2,0,2
,MN,1997.0,9,0,9
nan,OM,2013.0,1,0,1
SN,GN,2001.0,2,0,2
RU,VN,2005.0,1,0,1
BR,PG,2014.0,1,0,1
,MQ,2016.0,20,0,20
,TM,2017.0,5,0,5
,AF,2019.0,27,0,27
EC,IT,2004.0,1,0,1
,TM,2019.0,4,0,4
ST,nan,2014.0,2,0,2
PL,ET,2015.0,1,0,1
NE,DZ,2018.0,1,0,1
KW,FI,2006.0,1,0,1
TJ,IR,2016.0,1,0,1
UA,PT,2001.0,1,0,1
CR,PH,2015.0,1,0,1
RE,CD,2017.0,1,0,1
PH,FI,2015.0,2,0,2
FJ,SE,2022.0,2,0,2
HT,,2000.0,3,0,3
PT,JM,2001.0,1,0,1
ZW,LS,2000.0,1,0,1
AU,BI,2004.0,1,0,1
US,SY,1997.0,1,0,1
SY,SE,2016.0,1,0,1
,NI,1995.0,16,0,16
ZM,BE,2001.0,2,0,2
DK,CL,2005.0,2,0,2
,MS,2010.0,2,0,2
AR,DO,2012.0,2,0,2
GB,LR,2012.0,1,0,1
GH,ES,2020.0,1,0,1
CH,SG,1998.0,2,0,2
HR,SG,2014.0,1,0,1
ZW,MW,2017.0,2,0,2
MN,PK,2011.0,1,0,1
DE,ME,2022.0,1,0,1
QA,SE,2000.0,2,0,2
RE,ZA,2009.0,1,0,1
BD,AE,2023.0,1,0,1
,SR,2016.0,5,0,5
DK,LK,2015.0,1,0,1
NO,MA,2017.0,1,0,1
,FK,1998.0,1,0,1
AO,CN,2012.0,3,0,3
KZ,TW,1999.0,1,0,1
SI,AU,2000.0,1,0,1
UA,AZ,2020.0,1,0,1
MK,HU,2021.0,1,0,1
,LA,2019.0,4,0,4
KW,IE,2008.0,1,0,1
GB,BA,2011.0,2,0,2
MA,AT,2002.0,1,0,1
ES,PY,2011.0,6,0,6
,NE,2019.0,14,0,14
MN,,2005.0,6,0,6
JP,LA,2000.0,3,0,3
AM,BR,2012.0,1,0,1
BR,CW,2003.0,1,0,1
,GW,1996.0,1,0,1
BE,CG,2017.0,3,0,3
BJ,TZ,2008.0,1,0,1
IT,EE,2014.0,2,0,2
TW,HR,2005.0,1,0,1
BH,PK,2004.0,1,0,1
SN,NG,2020.0,4,0,4
DE,ZW,2014.0,2,0,2
CO,TN,2002.0,1,0,1
AU,PS,2018.0,1,0,1
EC,CG,2001.0,1,0,1
NO,TR,2001.0,5,0,5
KE,CG,2003.0,1,0,1
nan,ZM,2010.0,2,0,2
BW,FR,2008.0,1,0,1
AR,NZ,2020.0,4,0,4
EC,PA,1998.0,1,0,1
ME,US,2012.0,1,0,1
,VG,2018.0,4,0,4
MA,KZ,2007.0,1,0,1
NC,MG,2018.0,1,0,1
ID,BF,2019.0,1,0,1
ZA,BD,2008.0,2,0,2
RO,EC,2017.0,1,0,1
CL,PH,2022.0,5,0,5
BR,LV,2014.0,1,0,1
LK,SE,1999.0,1,0,1
BR,FJ,2002.0,1,0,1
CI,CM,2002.0,1,0,1
RS,SK,2023.0,1,0,1
GH,TZ,2013.0,1,0,1
TN,LB,2014.0,1,0,1
,LY,2004.0,14,0,14
DE,BM,2000.0,1,0,1
QA,NE,2010.0,1,0,1
GM,US,2003.0,1,0,1
HR,IN,2004.0,3,0,3
HK,TH,2016.0,1,0,1
UG,AR,2019.0,1,0,1
GM,KE,2007.0,1,0,1
UA,MZ,2008.0,4,0,4
NL,MN,2022.0,1,0,1
UA,SI,2002.0,3,0,3
ZW,JP,2014.0,1,0,1
GR,SK,2010.0,2,0,2
YE,GB,2016.0,1,0,1
HR,IL,1999.0,1,0,1
KE,AT,2007.0,2,0,2
ZM,BW,2008.0,1,0,1
NE,,1999.0,2,0,2
SN,MQ,2018.0,1,0,1
RO,MK,2014.0,1,0,1
BY,XK,2012.0,1,0,1
BN,BD,2015.0,1,0,1
IT,PY,2010.0,1,0,1
JP,LV,2019.0,1,0,1
HU,TN,2022.0,1,0,1
IL,AZ,2000.0,1,0,1
UZ,TJ,2016.0,1,0,1
GM,SN,2022.0,1,0,1
SD,FR,1997.0,1,0,1
SY,LK,2007.0,1,0,1
VN,IE,2009.0,1,0,1
FI,AT,2023.0,2,0,2
SV,nan,2009.0,1,0,1
XK,DE,2004.0,1,0,1
LC,EG,2016.0,1,0,1
EC,CU,2009.0,2,0,2
RU,LV,1997.0,6,0,6
NO,GH,1997.0,1,0,1
UG,RW,2013.0,2,0,2
NO,PH,1999.0,2,0,2
,CF,2007.0,7,0,7
TJ,UZ,2005.0,2,0,2
IN,SI,1998.0,1,0,1
BH,TW,2022.0,1,0,1
PH,VE,2003.0,1,0,1
DE,AD,2009.0,1,0,1
,GP,1995.0,9,0,9
HK,SE,2022.0,1,0,1
UZ,BY,1998.0,1,0,1
IQ,TZ,2020.0,2,0,2
GB,NI,2012.0,2,0,2
RW,SA,2013.0,1,0,1
RS,BS,2016.0,1,0,1
DE,RE,1999.0,1,0,1
IS,BR,2020.0,1,0,1
RO,RS,2015.0,2,0,2
EE,PL,2014.0,1,0,1
ZA,OM,2017.0,1,0,1
AL,GH,2021.0,1,0,1
BW,CM,2019.0,1,0,1
MS,,2012.0,1,0,1
QA,VN,2019.0,1,0,1
LA,,2012.0,5,0,5
IT,NI,2017.0,1,0,1
SN,LV,2019.0,1,0,1
CF,,2021.0,8,0,8
OM,MU,2019.0,1,0,1
NO,GR,2000.0,2,0,2
CZ,SA,2014.0,4,0,4
NO,JM,2003.0,1,0,1
IT,SM,2000.0,1,0,1
GR,SK,2017.0,3,0,3
GN,BR,2015.0,1,0,1
UA,RS,2008.0,2,0,2
ES,GR,1999.0,3,0,3
CY,AE,2009.0,1,0,1
SG,GE,2013.0,1,0,1
RS,TW,2014.0,1,0,1
SA,TR,2003.0,3,0,3
CN,NG,2007.0,1,0,1
NO,MA,2010.0,1,0,1
ES,TT,2019.0,1,0,1
IS,IQ,2020.0,2,0,2
CA,ML,2004.0,2,0,2
AE,SZ,2019.0,1,0,1
IQ,CL,2016.0,1,0,1
IN,BG,2012.0,1,0,1
CL,RU,2017.0,3,0,3
TN,TR,2019.0,1,0,1
MD,LU,2018.0,1,0,1
IR,BO,2010.0,3,0,3
ET,NZ,2020.0,2,0,2
DK,MT,2014.0,1,0,1
AT,IS,2001.0,1,0,1
AT,QA,2015.0,1,0,1
MZ,KR,2010.0,1,0,1
CN,HR,2005.0,1,0,1
SI,IE,2022.0,1,0,1
DZ,ES,2022.0,1,0,1
HR,NG,2011.0,1,0,1
CY,PE,2020.0,1,0,1
MY,UG,2008.0,1,0,1
BH,CN,2019.0,1,0,1
MK,SG,2008.0,1,0,1
LB,AE,2004.0,1,0,1
BR,SV,2008.0,1,0,1
CU,ES,2023.0,2,0,2
KZ,MX,2013.0,2,0,2
CO,PH,2001.0,1,0,1
TN,CM,2002.0,1,0,1
BH,IT,2021.0,1,0,1
PK,SO,2012.0,1,0,1
ST,TW,2011.0,3,0,3
NA,US,2000.0,1,0,1
BR,KW,2011.0,1,0,1
KW,LK,2013.0,1,0,1
ET,DE,2004.0,3,0,3
SI,NZ,2017.0,1,0,1
CL,KE,2015.0,2,0,2
SV,AU,2018.0,1,0,1
TW,AT,2006.0,5,0,5
RU,MA,2021.0,1,0,1
MX,BA,2020.0,1,0,1
LU,ML,2018.0,2,0,2
ZA,SA,2004.0,1,0,1
SD,AT,2003.0,1,0,1
GY,AU,2021.0,1,0,1
BJ,MD,2022.0,1,0,1
GT,PL,2020.0,1,0,1
CL,CM,2015.0,1,0,1
AE,FJ,2015.0,1,0,1
EG,MW,2017.0,1,0,1
GM,PK,2003.0,1,0,1
IE,AL,2014.0,1,0,1
BW,ZA,2004.0,2,0,2
VE,ZM,2012.0,1,0,1
UZ,NO,2017.0,1,0,1
nan,BH,2017.0,1,0,1
KZ,IE,2007.0,1,0,1
IT,OM,2017.0,2,0,2
GW,DE,1997.0,1,0,1
MM,CA,2008.0,1,0,1
CU,CZ,2018.0,1,0,1
NO,LU,2009.0,3,0,3
PH,NP,2003.0,1,0,1
,CV,2005.0,1,0,1
PE,DK,2021.0,1,0,1
DO,AR,2003.0,1,0,1
BE,CU,2002.0,2,0,2
LI,US,2013.0,2,0,2
CV,,2015.0,3,0,3
LB,TW,2015.0,2,0,2
CO,SE,2023.0,1,0,1
ML,CM,2019.0,3,0,3
TW,KH,2012.0,1,0,1
GB,CW,2009.0,1,0,1
VE,NL,2000.0,1,0,1
QA,IL,2012.0,1,0,1
IL,KG,2008.0,1,0,1
NL,PA,2021.0,1,0,1
CO,MT,2018.0,1,0,1
CO,NG,2021.0,2,0,2
PL,PK,1999.0,1,0,1
DK,KW,2000.0,1,0,1
MX,CG,2015.0,1,0,1
PT,MA,2000.0,2,0,2
NO,NC,2006.0,1,0,1
KE,RU,2011.0,1,0,1
DE,PY,2012.0,1,0,1
SK,SL,2022.0,1,0,1
AR,ZW,2013.0,1,0,1
MT,TR,2018.0,1,0,1
GR,UA,2013.0,1,0,1
UZ,MY,2010.0,2,0,2
US,PY,2009.0,1,0,1
JP,IQ,2021.0,1,0,1
AU,BO,2012.0,1,0,1
SI,HU,2005.0,1,0,1
MN,,2002.0,3,0,3
RO,KZ,2019.0,2,0,2
RO,TN,2003.0,1,0,1
,LR,1994.0,1,0,1
RO,GR,1998.0,1,0,1
SY,SA,2006.0,1,0,1
TH,ID,2001.0,3,0,3
KW,LT,2000.0,1,0,1
BE,EE,2009.0,2,0,2
BG,LV,1999.0,1,0,1
BG,MK,2015.0,3,0,3
BR,TG,2012.0,1,0,1
BH,IR,2001.0,1,0,1
US,SX,2013.0,1,0,1
SY,IT,2015.0,2,0,2
TN,IL,2016.0,2,0,2
ES,SJ,2012.0,1,0,1
HR,KR,2015.0,2,0,2
EE,BE,2003.0,1,0,1
ME,AE,2019.0,1,0,1
,LI,1995.0,4,0,4
FR,BW,2000.0,1,0,1
NP,SE,2008.0,1,0,1
ZM,HU,2005.0,1,0,1
QA,DZ,2021.0,1,0,1
SG,HK,2006.0,1,0,1
AU,DZ,2007.0,2,0,2
SA,DK,2001.0,1,0,1
PF,,2007.0,1,0,1
GF,GY,2014.0,1,0,1
BR,RO,2020.0,4,0,4
IR,AM,2007.0,1,0,1
MX,PK,2020.0,2,0,2
IS,CU,2014.0,1,0,1
FI,CY,2022.0,1,0,1
SN,IN,2020.0,2,0,2
TR,CO,2009.0,2,0,2
IE,RO,2012.0,1,0,1
BZ,,2023.0,4,0,4
AU,NC,2021.0,1,0,1
BE,RW,2008.0,4,0,4
IT,CG,2004.0,1,0,1
SJ,,2014.0,1,0,1
SZ,ZW,2016.0,1,0,1
PK,GE,2022.0,1,0,1
nan,BH,2019.0,1,3,-2
DK,SA,2018.0,3,1,2
AT,PL,1998.0,3,1,2
BR,HR,2008.0,1,1,0
SG,SE,2001.0,1,1,0
DK,ID,2012.0,1,2,-1
HU,FI,2007.0,3,6,-3
DK,SJ,2015.0,1,1,0
PL,VN,2022.0,3,4,-1
QA,IT,2015.0,1,11,-10
BN,AU,2004.0,1,1,0
IL,HU,2017.0,4,2,2
PL,SI,2010.0,1,4,-3
GB,MD,2004.0,1,3,-2
SN,CM,2004.0,2,2,0
ET,MY,2014.0,2,3,-1
MA,BR,2018.0,1,1,0
RS,XK,2008.0,4,4,0
LU,UG,2017.0,1,3,-2
TN,BE,2012.0,3,3,0
PT,UY,2006.0,2,2,0
HU,NG,2000.0,1,1,0
PT,PE,2022.0,3,2,1
KH,SG,2022.0,1,1,0
MX,SV,2022.0,2,1,1
SE,TZ,2021.0,4,4,0
TR,IT,1997.0,2,2,0
IT,SG,2008.0,2,1,1
SY,ZA,2017.0,1,1,0
SY,JO,2014.0,2,3,-1
RU,IN,2004.0,1,10,-9
BG,UA,2000.0,1,3,-2
BE,ZW,2016.0,1,1,0
CM,RU,2018.0,1,1,0
LB,KW,2015.0,1,1,0
SG,NL,2001.0,1,5,-4
FI,GR,2008.0,2,1,1
VN,BY,2012.0,1,1,0
CA,LK,2009.0,2,1,1
BT,LK,2014.0,1,1,0
IQ,JP,2004.0,1,1,0
LV,DE,2003.0,2,3,-1
VN,CN,2000.0,5,14,-9
CU,PE,2002.0,1,1,0
ID,EG,2013.0,3,5,-2
GB,FK,2020.0,1,1,0
GB,ZW,2008.0,2,6,-4
TW,CH,2008.0,1,6,-5
PH,NL,2021.0,4,1,3
LS,ZA,2018.0,2,6,-4
MA,JP,2015.0,1,1,0
GH,BW,2021.0,1,2,-1
DZ,JO,2010.0,1,1,0
LU,JP,2012.0,2,1,1
NO,UA,2005.0,2,1,1
SE,EE,1997.0,3,2,1
CO,AT,2011.0,1,1,0
BG,NZ,2015.0,1,1,0
SA,TN,2006.0,2,1,1
BA,CZ,2020.0,1,2,-1
BR,BY,2016.0,2,1,1
MX,AF,2006.0,2,5,-3
IE,CH,2008.0,2,13,-11
CA,SI,2009.0,2,4,-2
ZW,UG,2018.0,1,1,0
PK,VN,2015.0,1,1,0
IR,TR,2009.0,2,6,-4
IQ,PS,2020.0,4,3,1
GR,NZ,2021.0,1,1,0
GR,CA,1998.0,1,6,-5
IN,TN,2006.0,1,3,-2
DZ,JP,2020.0,1,1,0
CZ,CO,2016.0,1,1,0
BR,SA,2014.0,1,2,-1
GH,IE,2021.0,1,3,-2
PL,TW,2008.0,2,3,-1
CH,GE,2010.0,1,1,0
GB,LY,2008.0,3,2,1
AU,GT,2014.0,1,1,0
FK,GB,2012.0,1,1,0
FR,BO,2009.0,3,6,-3
KE,MW,2014.0,2,1,1
AE,MX,2018.0,2,2,0
JO,KR,2020.0,2,1,1
UG,JP,2011.0,1,2,-1
TN,TR,2017.0,1,2,-1
BH,KR,2020.0,2,6,-4
KR,JO,2020.0,1,2,-1
GB,NC,2015.0,4,1,3
FR,GT,2015.0,1,1,0
MA,AE,2021.0,3,2,1
IQ,LY,2016.0,1,2,-1
UA,HU,2015.0,1,3,-2
KW,GR,2013.0,3,1,2
AM,KR,2021.0,1,2,-1
PY,PT,2015.0,1,2,-1
IT,PS,2022.0,1,1,0
RU,NZ,2012.0,2,6,-4
CG,BE,2011.0,1,1,0
DK,CL,2002.0,1,3,-2
EG,PT,2014.0,2,3,-1
BE,DK,1997.0,3,6,-3
NZ,HU,2017.0,1,3,-2
PK,UG,2014.0,1,1,0
ID,BF,2017.0,1,1,0
IR,BO,2019.0,2,3,-1
US,MT,2002.0,1,2,-1
BR,AT,2001.0,1,1,0
EE,IN,2011.0,1,2,-1
UZ,MY,2017.0,1,1,0
GB,SS,2022.0,4,1,3
ZA,KR,2001.0,1,2,-1
PA,GB,2001.0,1,4,-3
BR,SG,2022.0,1,2,-1
SG,NZ,1998.0,2,5,-3
EE,NL,2003.0,1,3,-2
GR,CO,2013.0,1,1,0
TR,LB,2022.0,1,3,-2
QA,CY,2020.0,1,2,-1
SI,MX,2014.0,1,8,-7
KN,NZ,2017.0,1,2,-1
ZA,GR,1999.0,1,1,0
CA,CI,2007.0,1,2,-1
ES,HR,2007.0,2,5,-3
PH,RU,2016.0,1,3,-2
BE,MD,2020.0,1,1,0
KW,IL,2022.0,1,1,0
CZ,BE,2000.0,2,5,-3
MK,MY,2013.0,2,1,1
BO,CN,2003.0,1,7,-6
NC,US,2000.0,1,1,0
JO,IT,2005.0,1,1,0
MX,DK,1999.0,1,2,-1
CG,PK,2012.0,1,1,0
PA,DO,2015.0,1,2,-1
SE,ZW,2020.0,1,1,0
RU,LB,2022.0,1,1,0
CA,BI,2008.0,1,2,-1
VE,IL,2016.0,1,1,0
NO,EE,2017.0,1,6,-5
UA,SG,2018.0,1,2,-1
IL,KW,2022.0,1,1,0
OM,MY,2021.0,3,13,-10
IS,CH,2011.0,1,1,0
SE,UY,2012.0,2,3,-1
TH,IE,2015.0,1,2,-1
ZM,PK,2013.0,1,1,0
SG,DZ,2021.0,1,3,-2
KE,DK,2010.0,1,2,-1
PS,IT,2017.0,1,5,-4
MK,AU,1997.0,1,1,0
KW,NL,2018.0,1,1,0
AR,RE,2022.0,1,1,0
IE,HR,2004.0,1,4,-3
AG,RS,2019.0,1,12,-11
GE,SK,2011.0,1,8,-7
CY,IN,2011.0,1,1,0
CO,GR,2012.0,1,1,0
BN,PK,2022.0,1,2,-1
JP,SA,2000.0,1,1,0
AU,RO,2011.0,1,2,-1
FR,PE,2006.0,1,2,-1
FR,KW,2006.0,1,2,-1
NL,nan,2023.0,1,1,0
SA,NP,2012.0,1,1,0
MG,CH,1999.0,1,3,-2
ES,KE,2007.0,1,1,0
NZ,ES,2005.0,1,4,-3
FI,NZ,2017.0,1,10,-9
BA,DE,2004.0,1,2,-1
SE,AL,2004.0,1,1,0
AU,AE,2002.0,1,1,0
GE,TW,2020.0,1,1,0
OM,BE,2017.0,1,1,0
AZ,DE,1999.0,1,2,-1
BR,CM,2014.0,1,1,0
AU,IS,2014.0,1,1,0
GE,DE,2022.0,1,3,-2
FR,LK,2017.0,1,2,-1
MK,CA,2018.0,1,3,-2
PH,PA,2018.0,1,1,0
BJ,KE,2015.0,1,1,0
FR,SA,2001.0,1,7,-6
MY,FR,2003.0,1,1,0
VN,PH,2013.0,2,1,1
IN,ES,2002.0,4,10,-6
DZ,MX,2015.0,2,1,1
SA,LB,2013.0,4,9,-5
SK,NO,2005.0,1,1,0
AF,BR,2014.0,1,2,-1
AE,JO,2008.0,2,3,-1
AE,BH,2016.0,2,2,0
CO,KE,2002.0,1,1,0
nan,ML,2019.0,1,1,0
KW,AU,2005.0,1,3,-2
CA,SK,2012.0,1,3,-2
CN,TZ,2010.0,2,1,1
IL,SA,2021.0,1,3,-2
TZ,IT,2010.0,1,1,0
PR,ES,2020.0,1,1,0
UY,CO,2006.0,1,2,-1
ET,JP,2009.0,2,1,1
CZ,UG,2018.0,1,2,-1
LK,CH,2018.0,2,7,-5
UA,MY,2007.0,1,2,-1
SE,BO,2014.0,1,2,-1
BA,SE,2012.0,1,1,0
MU,US,2020.0,2,1,1
GB,GD,2022.0,1,0,1
IR,MK,2012.0,1,0,1
SD,JO,2015.0,1,0,1
MY,TZ,2008.0,1,0,1
MY,AT,2017.0,1,0,1
GR,IQ,2014.0,1,0,1
TH,UA,2013.0,1,0,1
GA,CN,1999.0,1,0,1
CA,CR,2013.0,2,0,2
NG,CO,2009.0,1,0,1
DE,IQ,2006.0,1,0,1
TN,AT,2001.0,1,0,1
MR,SN,2006.0,1,0,1
FI,PK,2011.0,1,0,1
,GY,2005.0,2,0,2
nan,ML,2017.0,2,0,2
ID,PE,2022.0,2,0,2
FI,BG,2006.0,2,0,2
nan,GT,2007.0,1,0,1
AU,SS,2013.0,1,0,1
PH,TT,2016.0,2,0,2
ET,BR,2021.0,1,0,1
DK,AR,1998.0,1,0,1
CO,HN,2000.0,1,0,1
MN,CN,2004.0,2,0,2
JM,IR,2008.0,1,0,1
CI,TN,2015.0,1,0,1
RS,UA,2013.0,1,0,1
nan,IQ,2012.0,2,0,2
SG,PT,2022.0,2,0,2
CZ,AM,2000.0,1,0,1
NL,BS,2011.0,1,0,1
IE,SD,2004.0,1,0,1
BZ,US,2022.0,2,0,2
JP,AR,2023.0,1,0,1
VG,FR,2016.0,1,0,1
PL,DZ,2016.0,1,0,1
UG,BR,2020.0,2,0,2
CG,LR,2009.0,1,0,1
IR,QA,2007.0,1,0,1
SE,PH,2004.0,1,0,1
SL,YE,2019.0,1,0,1
nan,MK,2011.0,1,0,1
BR,MW,2022.0,1,0,1
QA,SI,2021.0,2,0,2
MX,TZ,2010.0,1,0,1
HK,TW,2006.0,1,0,1
RU,AZ,2000.0,1,0,1
LK,IT,2013.0,1,0,1
LV,AZ,2018.0,1,0,1
ZW,BH,2011.0,1,0,1
LT,KG,2022.0,1,0,1
IR,YE,2020.0,1,0,1
LA,NL,2022.0,1,0,1
BJ,TH,2006.0,2,0,2
TH,BT,2016.0,2,0,2
HU,PT,2018.0,1,0,1
KW,CZ,2004.0,1,0,1
BJ,PH,2009.0,1,0,1
VI,PL,2004.0,1,0,1
LT,NO,2010.0,2,0,2
AE,MN,2008.0,1,0,1
BA,LU,2021.0,1,0,1
AR,MT,1999.0,1,0,1
KW,AU,2002.0,1,0,1
KZ,ZA,2018.0,1,0,1
NL,BN,2005.0,1,0,1
GA,CG,2021.0,1,0,1
BF,TG,2021.0,1,0,1
BW,GH,2022.0,1,0,1
RE,GH,2015.0,1,0,1
CD,UA,2020.0,1,0,1
MX,UZ,2014.0,1,0,1
BI,MA,1997.0,1,0,1
ZM,MY,2014.0,1,0,1
LU,IN,2016.0,4,0,4
LY,IQ,2009.0,1,0,1
CF,CO,2021.0,1,0,1
MG,CA,2008.0,1,0,1
CA,AL,2013.0,1,0,1
TW,IS,2017.0,1,0,1
JM,NZ,2011.0,1,0,1
NZ,MD,2006.0,1,0,1
UG,CU,2019.0,1,0,1
VN,GH,2017.0,2,0,2
TR,NE,2022.0,1,0,1
PA,nan,2017.0,2,0,2
EG,LK,2017.0,1,0,1
TH,ZM,2005.0,1,0,1
PH,GT,2012.0,1,0,1
AT,BD,2002.0,1,0,1
BS,GB,2003.0,1,0,1
TN,RS,2021.0,1,0,1
AZ,UZ,2011.0,2,0,2
SL,,2013.0,1,0,1
SA,BD,2004.0,1,0,1
BY,NO,2016.0,1,0,1
IQ,ID,2016.0,2,0,2
GB,SZ,1999.0,1,0,1
RO,NG,2002.0,1,0,1
MX,GT,1999.0,3,0,3
CH,TT,2018.0,1,0,1
LV,MK,2014.0,1,0,1
MO,,2024.0,3,0,3
BE,CU,2005.0,1,0,1
GM,NZ,2005.0,1,0,1
NL,MZ,2013.0,1,0,1
CY,AZ,2005.0,1,0,1
NL,AZ,2022.0,1,0,1
CH,GE,2017.0,1,0,1
IT,UG,2010.0,1,0,1
MM,CZ,2006.0,1,0,1
IN,MD,2010.0,1,0,1
PH,DK,2003.0,1,0,1
PT,EG,2006.0,1,0,1
IT,TZ,2004.0,1,0,1
US,DO,2002.0,1,0,1
BD,CO,2007.0,1,0,1
CN,AZ,2005.0,1,0,1
UZ,TN,2011.0,1,0,1
US,VU,2004.0,1,0,1
KR,RO,2010.0,3,0,3
SD,BD,2003.0,1,0,1
NL,EC,2014.0,2,0,2
JP,AL,2008.0,2,0,2
JO,GB,2023.0,2,0,2
DZ,NL,2017.0,1,0,1
RU,NP,2015.0,1,0,1
TR,PH,2013.0,1,0,1
FI,SG,1998.0,1,0,1
UG,ZM,2015.0,2,0,2
MX,TZ,2019.0,1,0,1
PW,IN,2005.0,1,0,1
AM,EE,2009.0,1,0,1
SZ,,2010.0,1,0,1
IT,CY,2007.0,1,0,1
DK,RS,2007.0,1,0,1
IR,FJ,2020.0,1,0,1
PL,NZ,2010.0,2,0,2
TN,GR,2010.0,1,0,1
PE,DO,2012.0,1,0,1
US,AO,1998.0,1,0,1
LB,IE,2017.0,1,0,1
AL,CH,2013.0,1,0,1
ML,CM,2010.0,1,0,1
MD,GB,2002.0,1,0,1
PG,LK,2020.0,1,0,1
PS,NL,2005.0,1,0,1
AO,VE,2012.0,1,0,1
SE,ML,2012.0,1,0,1
MA,NG,2012.0,1,0,1
US,PF,1997.0,2,0,2
CD,TZ,2011.0,1,0,1
OM,NL,2018.0,1,0,1
SN,GB,2006.0,1,0,1
CZ,FI,2023.0,1,0,1
ZW,TW,2004.0,1,0,1
BE,AT,2023.0,2,0,2
GH,AL,2008.0,1,0,1
TZ,UG,2004.0,1,0,1
SG,PA,2014.0,1,0,1
CF,PK,2015.0,1,0,1
BW,CL,2020.0,1,0,1
SE,GW,2003.0,1,0,1
RS,LY,2010.0,1,0,1
GL,,1999.0,1,0,1
GA,MY,2016.0,1,0,1
TW,PE,2022.0,1,0,1
SN,BE,2001.0,1,0,1
BO,DK,2007.0,1,0,1
KE,BF,2004.0,1,0,1
VE,BO,2008.0,1,0,1
CW,US,2016.0,1,0,1
KE,GM,2004.0,1,0,1
NO,EE,2010.0,1,0,1
PK,DK,2009.0,3,0,3
NZ,ID,2002.0,1,0,1
MX,MZ,2013.0,1,0,1
nan,TH,2020.0,1,0,1
GH,CZ,2000.0,1,0,1
RS,MT,2018.0,2,0,2
ZA,OM,2010.0,1,0,1
KR,LA,2008.0,1,0,1
IT,SC,2022.0,1,0,1
IN,CD,2011.0,1,0,1
NL,CM,2015.0,1,0,1
TW,YE,2022.0,1,0,1
ID,PK,2023.0,1,0,1
SE,TN,2015.0,1,0,1
LB,LY,2014.0,1,0,1
PS,ID,2015.0,1,0,1
CA,BJ,2006.0,1,0,1
YE,NL,2013.0,1,0,1
VE,BE,2008.0,1,0,1
CA,BB,2015.0,1,0,1
HK,RS,2014.0,1,0,1
MT,CO,2008.0,1,0,1
CG,NE,2010.0,1,0,1
EE,FJ,2013.0,1,0,1
VE,HU,2006.0,1,0,1
RO,GR,1997.0,1,0,1
TJ,,1999.0,1,0,1
CU,UG,2014.0,1,0,1
BH,CN,2017.0,1,0,1
NO,CM,2012.0,1,0,1
NC,MD,2017.0,1,0,1
ZA,OM,2019.0,1,0,1
SE,CO,1999.0,1,0,1
TT,IN,1997.0,1,0,1
BW,DE,2017.0,1,0,1
IT,PY,2017.0,1,0,1
EG,ES,1997.0,1,0,1
NP,,1998.0,1,0,1
SK,AU,2010.0,1,0,1
NP,KE,2017.0,1,0,1
RO,SI,2022.0,1,0,1
RU,JO,2005.0,1,0,1
NE,AU,2020.0,1,0,1
CZ,DZ,2009.0,1,0,1
IT,MC,2016.0,1,0,1
FI,SJ,2006.0,1,0,1
DK,TZ,1998.0,1,0,1
SD,PS,2019.0,1,0,1
PE,GD,2017.0,1,0,1
IN,BF,2015.0,1,0,1
DZ,SO,2022.0,1,0,1
MC,IL,2023.0,1,0,1
DO,nan,2016.0,1,0,1
AT,IQ,2015.0,1,0,1
KE,UA,2019.0,1,0,1
SK,NO,2002.0,1,0,1
LB,IN,2005.0,1,0,1
HU,CO,2004.0,1,0,1
CZ,GE,1999.0,1,0,1
TR,AE,2009.0,1,0,1
US,TW,2011.0,769,733,36
ES,IT,2012.0,214,248,-34
BR,DE,2008.0,127,141,-14
GB,CN,2015.0,542,507,35
US,GB,2008.0,5222,5144,78
CO,AG,2022.0,21,19,2
ES,BR,2004.0,162,134,28
CN,JP,2009.0,439,673,-234
US,IL,2016.0,532,574,-42
GB,IN,2015.0,494,435,59
GE,US,2020.0,164,144,20
JP,ID,2013.0,160,65,95
US,CA,2011.0,3097,3225,-128
GB,FR,2019.0,569,643,-74
BR,US,2011.0,936,995,-59
GB,AU,1999.0,521,571,-50
MX,ES,2022.0,440,400,40
US,IN,2012.0,2243,2002,241
BG,DE,2021.0,15,10,5
MY,TW,2017.0,30,37,-7
IT,US,1997.0,410,413,-3
CH,US,2003.0,460,499,-39
DE,CH,2016.0,956,776,180
US,AE,2006.0,28,16,12
DE,FR,1999.0,218,242,-24
GB,IT,2011.0,334,501,-167
JP,PH,2019.0,26,29,-3
GB,FR,2010.0,558,507,51
FR,CA,2021.0,454,383,71
IL,US,2009.0,494,390,104
AO,JP,2005.0,3,2,1
KR,GB,2015.0,94,118,-24
CN,SG,2014.0,457,485,-28
BE,CH,2012.0,68,66,2
RO,BE,2004.0,9,5,4
DE,BR,2020.0,247,289,-42
MY,US,2022.0,99,116,-17
MX,US,2008.0,291,310,-19
AR,UY,2013.0,40,26,14
FR,CL,2020.0,48,58,-10
TW,US,2008.0,660,732,-72
BE,ES,2019.0,94,108,-14
IN,FR,2020.0,134,123,11
UY,ES,2016.0,56,72,-16
PL,DK,2015.0,13,9,4
CO,EC,2021.0,108,97,11
US,SE,2008.0,364,351,13
TW,SE,2019.0,12,6,6
GB,TW,2007.0,63,44,19
PK,KR,2011.0,12,11,1
EG,PK,2022.0,15,18,-3
CL,EC,2021.0,60,57,3
AU,CA,2010.0,310,354,-44
ST,PT,2005.0,1,2,-1
AU,CN,2014.0,427,413,14
US,MX,2014.0,396,418,-22
SD,SA,2018.0,40,29,11
RO,HK,2015.0,24,14,10
KR,FR,2015.0,26,35,-9
BR,CL,2013.0,69,89,-20
NZ,US,2006.0,226,286,-60
US,NO,2009.0,171,111,60
SG,AU,2005.0,55,43,12
DE,NL,2011.0,309,322,-13
FR,US,1999.0,832,671,161
AU,CA,2017.0,373,418,-45
FR,BI,2011.0,12,28,-16
PE,CL,2013.0,39,64,-25
BR,FR,2018.0,224,285,-61
IN,PT,2019.0,21,24,-3
DE,TN,2012.0,8,1,7
FR,NL,2019.0,189,156,33
MY,EG,2021.0,35,39,-4
IT,CA,2014.0,151,86,65
EG,SD,2022.0,15,19,-4
IE,AU,2015.0,111,101,10
CL,AU,2017.0,24,28,-4
US,PE,2013.0,90,66,24
DK,CA,2009.0,21,34,-13
FR,BE,2013.0,350,304,46
DE,CA,2009.0,250,245,5
FI,DK,2003.0,8,5,3
IT,AU,2013.0,84,47,37
ZA,CH,2011.0,12,12,0
CH,ZA,2011.0,12,12,0
DE,SG,2005.0,15,11,4
GB,GR,2022.0,125,88,37
FI,SE,2001.0,36,47,-11
CN,VN,2022.0,24,34,-10
nan,US,2013.0,285,262,23
PE,ES,2018.0,120,163,-43
BG,GB,2015.0,17,17,0
US,PT,2003.0,95,53,42
CU,CA,2007.0,4,4,0
PL,US,2017.0,263,267,-4
PL,US,2019.0,312,258,54
AR,BR,2020.0,176,143,33
IT,NL,2006.0,67,54,13
NL,DE,2016.0,387,407,-20
AU,AT,2021.0,26,16,10
IT,GR,2013.0,24,31,-7
CN,GB,2000.0,150,200,-50
US,PL,2008.0,197,195,2
US,DK,2011.0,258,235,23
FR,TR,2020.0,28,32,-4
CL,ES,2013.0,333,343,-10
IN,ZA,2009.0,32,20,12
JP,GR,2002.0,39,43,-4
GR,JP,2005.0,45,32,13
RO,HU,2010.0,26,28,-2
PT,BE,2015.0,29,14,15
CH,BE,2004.0,29,36,-7
CO,PA,2012.0,7,7,0
ES,JP,2020.0,31,32,-1
NL,BE,2010.0,263,242,21
CL,AR,2022.0,53,64,-11
SN,DE,2006.0,2,1,1
JP,IN,2009.0,104,128,-24
IT,LU,2019.0,15,8,7
NL,BE,2017.0,328,310,18
RU,RS,2009.0,15,5,10
US,RU,2022.0,259,355,-96
JP,PH,2010.0,25,15,10
NO,CZ,2019.0,11,6,5
TR,LB,2016.0,4,1,3
IN,BD,2015.0,123,115,8
US,SA,2012.0,165,83,82
TW,CA,2013.0,48,42,6
IT,FR,2018.0,483,369,114
FR,NL,2010.0,175,163,12
RO,HU,2017.0,49,41,8
MY,CH,2016.0,8,5,3
NP,IN,2022.0,64,67,-3
MX,AR,2013.0,125,119,6
SE,ES,2021.0,59,73,-14
DE,EG,2001.0,18,12,6
CZ,CH,2004.0,15,17,-2
BR,AU,2021.0,129,94,35
AU,ZA,2009.0,44,45,-1
GR,SE,2017.0,30,9,21
BR,CO,2021.0,144,141,3
NL,CW,2012.0,14,9,5
AU,BR,2018.0,117,164,-47
CA,FR,2022.0,264,275,-11
GB,CH,2007.0,174,208,-34
MX,PE,2020.0,183,126,57
BE,CN,2006.0,53,21,32
CH,LB,2017.0,4,4,0
MX,TN,2012.0,4,2,2
CN,NL,2014.0,100,97,3
IN,FI,2010.0,12,2,10
TW,SG,2015.0,60,33,27
GB,FR,2017.0,586,648,-62
IR,MY,2010.0,52,25,27
TW,ID,2012.0,12,4,8
RO,DE,2017.0,37,50,-13
ES,SE,2008.0,36,46,-10
KR,AU,2013.0,46,34,12
ET,BW,2018.0,3,1,2
CZ,US,2007.0,109,129,-20
CN,FI,2009.0,17,21,-4
CL,CN,2005.0,7,2,5
CN,RO,2014.0,6,4,2
NO,DK,2013.0,93,71,22
CN,MM,2001.0,6,9,-3
AL,CN,2013.0,2,4,-2
DE,ID,2016.0,41,18,23
HR,US,2014.0,51,25,26
CN,CZ,2015.0,21,22,-1
GR,IE,2017.0,13,2,11
RU,BY,2014.0,77,112,-35
IT,ES,2008.0,190,147,43
CH,JP,1999.0,50,43,7
DE,PL,2018.0,128,149,-21
AR,IT,2004.0,45,42,3
IN,GB,2014.0,351,478,-127
NZ,CH,2018.0,16,10,6
IQ,SD,2021.0,10,11,-1
IT,IN,2010.0,34,56,-22
FR,MX,2009.0,48,42,6
HU,DK,2022.0,5,3,2
NL,IL,2021.0,11,16,-5
IN,FI,2017.0,24,18,6
HU,CA,2015.0,12,10,2
ES,NL,2009.0,66,72,-6
RO,CO,2017.0,1,2,-1
UA,nan,2005.0,8,14,-6
XK,RS,2013.0,9,10,-1
PE,CO,2009.0,20,16,4
PL,GB,2012.0,86,105,-19
NL,BE,2019.0,319,338,-19
GB,RO,2014.0,34,53,-19
DE,RS,2018.0,19,28,-9
DK,BR,2018.0,26,35,-9
SE,ID,2013.0,6,2,4
CH,IE,2003.0,8,3,5
IL,FR,2004.0,25,30,-5
AT,GB,2020.0,113,144,-31
AT,NL,2020.0,48,41,7
IR,SE,2019.0,68,46,22
UA,IR,2021.0,3,3,0
CA,AR,2010.0,16,12,4
IT,IE,2018.0,42,27,15
RU,nan,2015.0,28,59,-31
FR,nan,2021.0,105,135,-30
CA,IR,2008.0,56,71,-15
QA,SG,2016.0,5,6,-1
JP,KE,2020.0,7,7,0
AR,IE,2020.0,8,3,5
NO,US,2006.0,108,124,-16
IL,HU,2018.0,3,7,-4
CN,BE,2022.0,43,54,-11
RU,MZ,2006.0,13,2,11
IR,SE,2017.0,45,39,6
CH,AU,2022.0,37,52,-15
EG,IT,2010.0,3,8,-5
ZW,RU,2016.0,16,5,11
RO,NL,2014.0,19,10,9
CA,PH,2012.0,5,8,-3
JP,RO,2001.0,6,7,-1
JP,CH,2015.0,103,95,8
CN,GH,2021.0,53,14,39
SK,GE,2013.0,4,3,1
BR,GB,2018.0,296,233,63
NO,DE,2022.0,40,43,-3
PA,CO,2020.0,14,16,-2
IN,ZM,2021.0,3,1,2
GB,EG,2020.0,107,123,-16
ET,US,2022.0,45,35,10
HR,SI,2012.0,26,13,13
CL,GB,2014.0,35,40,-5
UZ,CN,2020.0,11,18,-7
HU,IL,2008.0,4,2,2
CA,CH,2020.0,130,120,10
DE,LV,1998.0,3,4,-1
LK,GB,2006.0,7,7,0
GR,BE,2004.0,8,7,1
HU,AT,2008.0,26,10,16
UA,PL,2014.0,21,18,3
BR,HR,2013.0,3,4,-1
JP,BR,2018.0,67,64,3
IT,CN,2016.0,48,39,9
CO,AR,2015.0,112,105,7
US,KE,2010.0,56,43,13
IR,MY,2017.0,61,233,-172
CO,BO,2019.0,14,10,4
RU,NL,2014.0,41,33,8
PL,HU,2014.0,20,10,10
IL,ES,2006.0,10,8,2
IE,ZA,2011.0,9,9,0
US,SS,2012.0,2,2,0
NZ,ZA,2013.0,17,19,-2
CZ,SK,2021.0,100,97,3
SE,GR,2005.0,9,2,7
PE,MX,1999.0,8,9,-1
IE,FR,2006.0,23,34,-11
SE,IT,2007.0,68,68,0
PH,PE,2020.0,9,7,2
AU,PL,2000.0,9,5,4
IT,IN,2019.0,63,80,-17
CL,CA,2017.0,25,28,-3
nan,IE,2007.0,5,2,3
IR,MY,2019.0,75,161,-86
FR,NL,2017.0,161,191,-30
CA,AR,2019.0,28,31,-3
CH,RU,2016.0,34,31,3
CA,PK,2012.0,18,27,-9
IE,DE,2008.0,59,78,-19
CO,CH,2012.0,8,11,-3
QA,IN,2002.0,1,1,0
IN,CO,2012.0,5,5,0
nan,AU,2016.0,64,29,35
KE,DK,2018.0,7,2,5
NL,NO,2020.0,38,36,2
TR,EG,2015.0,3,3,0
GR,SE,2019.0,35,20,15
SG,TR,2022.0,7,1,6
CO,MX,2008.0,114,127,-13
AU,MK,2020.0,28,55,-27
DE,IN,2006.0,82,121,-39
CA,IL,2022.0,32,39,-7
TR,SE,2021.0,24,12,12
US,HR,2006.0,43,18,25
PK,IN,2001.0,16,15,1
NL,BR,2018.0,60,65,-5
DZ,TN,2021.0,26,27,-1
CA,NZ,2006.0,52,45,7
MY,KR,2007.0,5,6,-1
PL,IT,2019.0,52,49,3
AT,HR,2018.0,6,15,-9
VE,CL,2018.0,42,17,25
LK,CH,2019.0,7,4,3
BH,SA,2020.0,13,18,-5
JP,PH,2017.0,30,24,6
XK,HR,2014.0,2,5,-3
ZA,ET,2017.0,19,11,8
IQ,SG,2018.0,8,4,4
UG,US,2015.0,41,23,18
GB,HU,2010.0,50,46,4
FR,MA,2022.0,112,75,37
CR,US,2020.0,49,35,14
MY,BD,2016.0,56,45,11
GB,AT,1998.0,20,22,-2
BG,RU,2014.0,40,18,22
NZ,PH,2018.0,4,6,-2
BR,PL,2014.0,6,4,2
GR,CY,2020.0,91,47,44
nan,DE,2020.0,68,88,-20
JP,TW,2001.0,44,32,12
US,KE,2019.0,106,105,1
DE,VE,2019.0,3,6,-3
FR,RU,2022.0,38,48,-10
IE,CN,2003.0,9,7,2
KE,CH,2020.0,6,9,-3
NP,CN,2015.0,11,13,-2
KR,DE,2014.0,66,48,18
CN,PL,2003.0,4,8,-4
GB,LY,2013.0,19,2,17
TH,NL,2008.0,6,5,1
SA,EG,2000.0,24,8,16
NO,CZ,2017.0,10,11,-1
ES,DK,1999.0,10,22,-12
NG,PK,2012.0,11,6,5
EG,IT,2019.0,14,20,-6
nan,EC,2021.0,4,7,-3
GB,LB,2018.0,6,8,-2
DO,BR,2021.0,6,6,0
RU,ES,2020.0,21,25,-4
SA,QA,2021.0,29,17,12
FR,TN,2020.0,166,171,-5
KR,KE,2014.0,2,1,1
CA,DK,2022.0,42,18,24
RE,FR,2016.0,43,60,-17
FR,GR,2013.0,27,63,-36
NZ,IN,2021.0,33,34,-1
IN,TH,2015.0,12,15,-3
DE,nan,2014.0,75,79,-4
BZ,US,2016.0,2,1,1
ID,LK,2016.0,4,4,0
BB,JM,2021.0,6,6,0
ID,EG,2008.0,4,1,3
IN,LY,2016.0,3,4,-1
ZA,CR,2016.0,4,4,0
SJ,NO,2012.0,5,5,0
JP,KH,2021.0,8,5,3
IT,ET,2021.0,4,3,1
BR,BE,2013.0,55,98,-43
GM,GB,2012.0,15,5,10
NC,FR,2021.0,16,11,5
LU,CN,2020.0,1,4,-3
AE,GB,2009.0,14,21,-7
GB,HU,2017.0,58,56,2
DE,CN,2000.0,84,100,-16
AT,CO,2009.0,2,1,1
DE,ET,2019.0,14,10,4
QA,US,2014.0,57,63,-6
GB,VG,2009.0,5,6,-1
FR,ID,2007.0,4,6,-2
JP,SG,2022.0,25,21,4
NO,FI,2004.0,8,8,0
AU,SA,2021.0,42,34,8
NL,PT,2016.0,24,34,-10
IT,DO,2021.0,4,2,2
PK,TR,2013.0,10,10,0
IQ,ID,2022.0,4,6,-2
IN,BY,2016.0,6,7,-1
BY,AT,2022.0,1,1,0
PK,EG,2019.0,18,26,-8
EG,KW,2018.0,31,37,-6
DE,BJ,2019.0,2,3,-1
US,IR,1999.0,19,8,11
BE,ES,2017.0,64,106,-42
SD,EG,2015.0,13,20,-7
BD,TR,2022.0,3,2,1
DK,NO,2016.0,107,102,5
CH,AT,2022.0,62,60,2
KR,ET,2006.0,89,101,-12
JP,GB,2001.0,227,239,-12
ES,DE,2008.0,133,147,-14
ZA,ET,2019.0,23,10,13
MA,NL,2015.0,5,1,4
MN,CN,2014.0,4,4,0
NP,NZ,2021.0,37,60,-23
MY,TW,2010.0,6,18,-12
IN,NL,2020.0,87,62,25
CA,AT,2018.0,32,23,9
GB,CO,2015.0,30,32,-2
TW,KR,2021.0,38,24,14
JO,LB,2020.0,7,6,1
BH,US,2022.0,10,11,-1
CO,BO,2010.0,4,4,0
CH,SE,2013.0,71,59,12
US,IS,2017.0,28,14,14
TW,FR,2022.0,8,2,6
IL,RS,2010.0,10,3,7
CH,LI,2020.0,6,2,4
CA,MY,2008.0,13,7,6
ES,CU,2020.0,88,92,-4
SE,AU,2009.0,53,49,4
ID,SA,2016.0,15,30,-15
JP,IE,2016.0,29,28,1
MX,IT,2011.0,24,37,-13
TH,MM,2020.0,12,7,5
HU,RO,1998.0,32,47,-15
AZ,ID,2012.0,10,5,5
BR,SE,2015.0,23,17,6
TH,FR,2009.0,13,10,3
IT,SE,2004.0,58,33,25
IE,CH,2013.0,19,11,8
IL,nan,2009.0,17,19,-2
FR,AT,2007.0,26,32,-6
TH,US,2001.0,34,77,-43
YE,SA,2015.0,15,2,13
NO,SE,2002.0,40,51,-11
SE,CA,2007.0,53,36,17
DE,QA,2017.0,10,6,4
IN,CH,2010.0,46,31,15
IL,ZA,1997.0,3,3,0
GR,SE,2010.0,10,9,1
NP,US,2003.0,13,4,9
BE,ES,2010.0,48,50,-2
IN,RO,2008.0,21,38,-17
IN,FI,2019.0,40,14,26
UA,GB,2005.0,13,4,9
US,CD,2015.0,3,4,-1
DE,IL,2002.0,28,44,-16
AU,IR,2016.0,61,187,-126
GB,PL,2008.0,28,84,-56
US,KE,2017.0,92,74,18
AU,CR,2015.0,3,4,-1
nan,NL,2016.0,69,73,-4
US,IS,2010.0,25,13,12
BF,CA,2015.0,3,4,-1
MX,FR,2013.0,54,53,1
RU,BE,2015.0,10,23,-13
ZA,SZ,2020.0,11,1,10
NI,US,2019.0,4,6,-2
ZW,ZA,2014.0,29,27,2
GR,CZ,2015.0,12,5,7
FR,DZ,2005.0,40,50,-10
NO,CA,2003.0,15,8,7
CH,QA,2014.0,2,1,1
CG,US,2013.0,1,1,0
US,UG,2016.0,36,36,0
GB,SS,2016.0,11,7,4
IT,IN,2017.0,61,52,9
ES,VE,1997.0,16,19,-3
CL,AU,2019.0,26,23,3
US,BD,2006.0,57,21,36
BA,RS,2012.0,21,26,-5
CZ,CA,2012.0,11,9,2
SV,ES,2022.0,3,3,0
UZ,TJ,2022.0,2,2,0
CA,AE,2002.0,6,3,3
PL,BY,2010.0,5,2,3
UA,SE,2003.0,12,4,8
JP,DK,2003.0,16,9,7
CU,MX,2016.0,80,51,29
LV,SE,1997.0,2,3,-1
UA,NI,2020.0,13,23,-10
DZ,MA,2012.0,11,24,-13
GB,HU,2019.0,54,55,-1
IN,KW,2011.0,9,8,1
NE,FR,2016.0,26,28,-2
FI,GR,2013.0,4,7,-3
CR,CU,2015.0,15,20,-5
CA,TH,2018.0,15,13,2
BW,US,2004.0,3,4,-1
FR,SG,2009.0,26,13,13
ZA,ZW,2014.0,27,29,-2
FR,SA,2003.0,4,3,1
LT,PL,2020.0,6,4,2
CA,NO,2016.0,29,11,18
nan,CA,2004.0,9,18,-9
NZ,CN,2022.0,58,43,15
DE,IL,2005.0,33,37,-4
BG,CN,2009.0,16,11,5
CL,CU,2020.0,18,29,-11
RU,LT,2009.0,12,12,0
ET,KE,2017.0,6,5,1
PT,CA,2000.0,4,7,-3
VN,RO,2012.0,9,3,6
IS,DK,2015.0,9,6,3
US,EE,2018.0,20,14,6
PA,JP,2016.0,1,2,-1
KR,MN,2017.0,7,1,6
IR,NG,2019.0,9,4,5
TZ,UG,2014.0,2,5,-3
CO,BO,2017.0,9,8,1
DE,CM,2008.0,3,5,-2
FO,GB,2016.0,1,2,-1
SD,KR,2021.0,10,11,-1
PL,NO,2020.0,17,6,11
RO,HU,2019.0,51,49,2
CN,IR,2004.0,8,8,0
MX,PL,2012.0,9,3,6
ES,IE,2018.0,48,35,13
ID,HU,2018.0,14,10,4
IN,QA,2019.0,49,16,33
JP,TR,2020.0,51,73,-22
PL,CA,2006.0,23,21,2
SA,DE,2006.0,4,9,-5
US,LB,2008.0,42,40,2
GB,HK,2006.0,2,2,0
AT,JO,2020.0,1,1,0
EG,AE,2015.0,26,36,-10
IN,SE,2007.0,18,14,4
HN,MX,2011.0,18,11,7
NL,NZ,2006.0,12,7,5
US,RS,1999.0,21,20,1
JO,BR,2019.0,1,1,0
EG,GB,2004.0,24,19,5
MX,AU,2015.0,20,23,-3
IR,SE,2010.0,26,27,-1
IE,IT,2018.0,27,42,-15
IT,BG,1998.0,4,7,-3
SE,TW,2004.0,4,2,2
IL,CZ,2010.0,4,2,2
JP,LV,2018.0,4,2,2
EE,GB,2020.0,10,13,-3
CN,PT,2017.0,12,15,-3
EG,CH,2016.0,9,8,1
CL,RU,2018.0,3,4,-1
PL,IT,2010.0,28,18,10
nan,NZ,2011.0,20,5,15
BA,US,2017.0,6,7,-1
HR,ES,2013.0,7,4,3
DE,KE,2005.0,6,3,3
CO,IT,2014.0,22,20,2
DE,SG,2002.0,8,8,0
TN,SY,2013.0,3,2,1
NL,TH,2013.0,9,7,2
SI,NL,2020.0,8,8,0
GB,MT,2001.0,8,1,7
nan,NO,2005.0,25,15,10
RU,IT,2004.0,24,24,0
PA,ES,2014.0,8,17,-9
LT,IT,2003.0,1,1,0
ES,AO,2012.0,3,3,0
LT,CN,2001.0,6,7,-1
AE,JO,2013.0,6,17,-11
IT,PE,2018.0,6,3,3
IT,BD,2020.0,7,9,-2
ID,CA,2008.0,5,3,2
NL,DK,1999.0,18,13,5
FI,NL,2013.0,36,40,-4
FR,TH,2022.0,5,8,-3
SE,nan,2006.0,36,59,-23
FR,GN,2020.0,3,5,-2
MA,TN,2007.0,7,14,-7
TN,MA,2011.0,26,24,2
FI,IL,2008.0,1,2,-1
BR,CH,2008.0,28,23,5
US,IS,2019.0,21,22,-1
IL,RO,2021.0,5,2,3
ID,SG,2004.0,2,2,0
SG,CH,2012.0,10,14,-4
IN,AU,1998.0,36,23,13
GR,JP,2002.0,43,39,4
DE,FI,2006.0,36,43,-7
ES,RU,2004.0,6,7,-1
IT,UG,2018.0,1,5,-4
IL,CZ,2019.0,6,9,-3
TR,PT,2015.0,3,3,0
RU,MX,2013.0,4,6,-2
BH,DE,2015.0,1,1,0
KR,IT,2009.0,8,3,5
DE,IS,2012.0,14,2,12
ML,US,2019.0,5,10,-5
JP,GR,2005.0,32,45,-13
BY,GB,2006.0,3,2,1
IE,AT,2018.0,9,5,4
IE,HR,2014.0,6,3,3
EG,MY,2013.0,29,36,-7
IN,QA,2010.0,6,3,3
RO,EC,2018.0,1,1,0
RS,XK,2013.0,10,9,1
IT,SG,2013.0,12,8,4
KW,AE,2019.0,8,5,3
MY,DE,2018.0,26,19,7
CA,AE,2005.0,5,10,-5
US,MN,2019.0,3,5,-2
JP,SK,2011.0,9,25,-16
BA,PL,2006.0,2,2,0
PT,AR,2016.0,14,12,2
CN,CH,1998.0,24,12,12
DZ,US,2009.0,11,17,-6
TW,IN,2022.0,39,51,-12
BR,PH,2013.0,6,5,1
BA,US,2010.0,1,5,-4
AT,DK,2021.0,21,15,6
ES,IL,2016.0,16,8,8
SA,IQ,2014.0,7,8,-1
IN,AU,1997.0,31,12,19
DE,NZ,2007.0,32,29,3
BE,AT,2000.0,4,3,1
KR,MY,2009.0,9,4,5
BR,FI,2014.0,7,11,-4
VG,US,2009.0,10,12,-2
CO,PE,2006.0,8,16,-8
DE,CO,2004.0,2,4,-2
PH,PA,2017.0,2,1,1
PA,CL,2022.0,7,3,4
PE,SV,2019.0,1,8,-7
JM,US,2022.0,8,5,3
CN,PT,2010.0,9,11,-2
NI,US,2017.0,10,6,4
GR,IT,2002.0,11,13,-2
IN,PT,2010.0,19,3,16
US,CR,2004.0,14,16,-2
CA,EC,2016.0,7,5,2
SK,SE,2007.0,5,3,2
IN,TW,2006.0,40,20,20
IN,FJ,2014.0,3,4,-1
FI,UA,1998.0,1,1,0
GT,ES,2015.0,9,6,3
GB,SK,2000.0,9,26,-17
FI,CA,2022.0,11,20,-9
DK,IS,2014.0,6,6,0
TR,CH,1999.0,5,3,2
HN,AR,2014.0,1,1,0
SG,JP,2006.0,13,28,-15
HU,CN,2011.0,4,5,-1
JP,MX,2012.0,5,13,-8
CN,BG,2008.0,10,9,1
AM,GB,2019.0,1,2,-1
nan,VN,2008.0,1,1,0
TW,VN,2015.0,21,13,8
BG,CL,2020.0,1,1,0
NO,NL,2000.0,13,10,3
UG,IT,2011.0,4,2,2
IL,BR,2008.0,8,7,1
SA,LB,2008.0,4,4,0
EG,JO,2013.0,10,14,-4
BY,US,2007.0,7,12,-5
SI,FI,2019.0,3,4,-1
PK,NL,2021.0,7,4,3
AF,MX,2012.0,2,1,1
RU,SK,2017.0,15,20,-5
LB,IE,2018.0,1,1,0
TW,SE,2010.0,6,4,2
CY,GB,2011.0,17,38,-21
RU,SK,2019.0,14,29,-15
UA,GB,2002.0,13,5,8
SE,TR,2021.0,12,24,-12
LB,IT,2016.0,11,11,0
CH,CI,2011.0,1,1,0
PG,CN,2020.0,1,1,0
NL,nan,2000.0,21,26,-5
RU,TZ,2014.0,2,2,0
RU,DK,2015.0,8,13,-5
PK,EG,2017.0,19,19,0
TR,TW,2012.0,2,2,0
IN,KE,2016.0,8,6,2
CH,VN,2019.0,6,2,4
KR,RS,2007.0,2,1,1
RO,CN,2016.0,10,4,6
BT,JP,2017.0,1,1,0
IQ,GB,2015.0,25,43,-18
AR,CU,2015.0,13,12,1
JP,KZ,2022.0,2,1,1
NG,US,2007.0,29,34,-5
NP,KE,2018.0,1,1,0
RO,DE,2019.0,36,51,-15
LT,NO,2018.0,1,1,0
SD,US,2016.0,6,6,0
DE,ET,2017.0,10,17,-7
DE,ZA,2006.0,37,31,6
CA,AR,2017.0,24,23,1
GB,GD,2016.0,4,2,2
EC,GT,2020.0,4,2,2
CL,CN,2002.0,4,5,-1
AT,RO,2002.0,1,1,0
NG,DE,2015.0,5,11,-6
IR,CH,2012.0,28,11,17
IN,NO,2007.0,21,15,6
AU,ES,2009.0,30,31,-1
RU,IN,2014.0,16,23,-7
AE,NZ,2002.0,1,1,0
IN,HU,2012.0,4,7,-3
JP,PK,2016.0,16,13,3
BD,NP,2013.0,9,6,3
NZ,BG,2015.0,1,1,0
PR,MX,2017.0,4,8,-4
BN,AU,2014.0,4,2,2
IT,OM,2018.0,2,2,0
MY,MX,2019.0,4,5,-1
RO,DE,2010.0,17,31,-14
IT,TR,2013.0,15,26,-11
CM,NG,1999.0,1,3,-2
IL,CZ,2017.0,11,6,5
GP,JM,2018.0,4,1,3
ZA,MW,2020.0,14,7,7
TN,AE,2001.0,1,1,0
IT,SI,2004.0,8,3,5
BE,RW,2013.0,4,4,0
TR,HU,2018.0,10,4,6
OM,CN,2019.0,5,4,1
SI,CZ,2003.0,6,6,0
SE,PA,2010.0,1,3,-2
BD,ES,2000.0,3,2,1
ID,BR,2019.0,20,25,-5
BE,JP,2023.0,3,2,1
SI,RS,2020.0,19,21,-2
TR,CZ,2005.0,5,6,-1
UA,nan,2002.0,11,15,-4
IT,LU,2017.0,19,4,15
GB,LK,2006.0,7,7,0
UG,NO,2017.0,4,1,3
SE,IS,2013.0,15,22,-7
DE,MX,2004.0,22,15,7
nan,SK,2015.0,3,3,0
PT,SG,2017.0,2,1,1
BH,GH,2022.0,12,5,7
JP,FI,2021.0,8,7,1
nan,IN,2000.0,10,6,4
US,MA,2004.0,11,10,1
GB,JO,2003.0,3,8,-5
BD,BE,2007.0,1,2,-1
DE,PH,2013.0,7,13,-6
GE,DE,2016.0,7,4,3
FI,AE,2020.0,4,2,2
FR,GA,1999.0,3,1,2
CO,JP,1999.0,1,7,-6
PT,TH,2020.0,1,1,0
FR,AL,2016.0,2,3,-1
FI,HU,2015.0,5,4,1
DE,QA,2019.0,5,10,-5
GR,CH,2004.0,9,3,6
CU,PT,2020.0,8,2,6
CY,US,2021.0,13,9,4
GB,ZW,2013.0,3,5,-2
BE,TR,2009.0,13,9,4
AE,PS,2010.0,1,1,0
LV,DE,2001.0,5,4,1
IL,IE,2010.0,1,1,0
GN,ML,2020.0,3,1,2
SE,GR,2002.0,6,2,4
AR,RU,2014.0,4,2,2
MA,SA,1997.0,1,1,0
MA,DZ,2011.0,6,8,-2
TN,IT,2011.0,15,5,10
DK,SG,2003.0,6,2,4
RO,IE,2016.0,5,4,1
NL,CL,2002.0,3,1,2
US,LT,1998.0,3,4,-1
MX,JP,1999.0,3,5,-2
FR,GF,2009.0,13,12,1
CU,US,2008.0,20,27,-7
PE,BR,1998.0,3,2,1
SG,AU,2002.0,21,36,-15
NO,TR,2003.0,2,3,-1
PY,CU,2008.0,12,3,9
CH,EG,2014.0,7,2,5
GB,AT,1997.0,18,13,5
US,SD,2006.0,2,4,-2
ET,CN,2005.0,2,2,0
ES,VE,1998.0,27,26,1
GF,FR,2006.0,8,3,5
EC,CR,2016.0,3,27,-24
CA,HU,2004.0,10,12,-2
CN,QA,2013.0,7,14,-7
TN,MY,2014.0,3,3,0
ES,SG,2015.0,7,4,3
KR,MN,2019.0,15,4,11
BD,EG,2012.0,6,4,2
NL,CL,2005.0,5,2,3
PL,CL,2019.0,6,3,3
PK,JP,2005.0,9,7,2
ES,BG,2007.0,6,4,2
RS,CA,2004.0,4,14,-10
RS,SK,2000.0,5,3,2
CN,NA,2012.0,1,1,0
ES,NO,1998.0,7,8,-1
GB,TT,2008.0,4,3,1
GR,IT,2005.0,14,15,-1
ET,GH,2020.0,4,1,3
AL,IN,2017.0,2,1,1
HU,ID,2018.0,10,14,-4
NO,CL,2007.0,1,2,-1
BD,JP,2020.0,51,82,-31
MX,SV,2016.0,5,4,1
MZ,BR,2000.0,2,2,0
MA,YE,2019.0,5,1,4
CA,HR,2014.0,5,5,0
JO,EG,2012.0,11,3,8
CY,TR,2006.0,5,4,1
CH,KR,2014.0,15,17,-2
LB,AE,2014.0,1,1,0
nan,SI,2013.0,3,2,1
RU,SK,2010.0,10,3,7
SA,CA,1997.0,4,8,-4
DE,LU,1998.0,2,3,-1
FI,NG,2019.0,5,1,4
EG,IT,2017.0,7,11,-4
IN,UA,2015.0,5,3,2
LK,NL,2010.0,2,2,0
BY,UA,2007.0,7,3,4
ES,SV,2009.0,4,1,3
NL,SG,2000.0,6,1,5
EG,MA,2014.0,8,6,2
RO,RU,1999.0,1,1,0
AR,CZ,2017.0,2,3,-1
ES,EC,1999.0,2,1,1
PL,AE,2019.0,3,3,0
GB,CZ,2001.0,11,15,-4
HR,RS,1999.0,12,16,-4
IL,RS,2019.0,2,1,1
SY,US,2014.0,11,6,5
LV,GB,2015.0,5,2,3
VN,EG,2021.0,4,1,3
GB,PA,2006.0,4,4,0
IT,UY,2021.0,9,8,1
CN,PT,2019.0,7,9,-2
KE,NG,2021.0,2,14,-12
BE,UZ,2011.0,1,1,0
UG,ZA,2022.0,8,3,5
LS,ZA,2017.0,2,3,-1
IT,HR,2014.0,6,7,-1
US,UZ,2011.0,2,4,-2
BR,AT,2003.0,3,3,0
IT,NZ,2008.0,6,7,-1
UZ,RU,2004.0,18,8,10
IL,AU,1998.0,5,6,-1
NL,AR,2008.0,11,5,6
ZA,JP,2008.0,5,3,2
PL,TW,2013.0,2,5,-3
PL,IT,2017.0,26,26,0
BG,ES,2008.0,9,4,5
CH,RS,2001.0,2,2,0
RS,GR,2000.0,1,1,0
RU,TW,2013.0,10,14,-4
AT,BE,2009.0,12,7,5
ES,TN,2012.0,6,3,3
PK,SE,2009.0,5,3,2
RU,CA,2018.0,39,42,-3
PK,EG,2010.0,4,2,2
GB,UG,2011.0,6,11,-5
KE,ET,2016.0,6,4,2
CN,MG,2019.0,8,4,4
HR,CZ,2011.0,6,3,3
OM,QA,2011.0,5,1,4
BG,RO,2016.0,5,1,4
PT,TN,2014.0,1,1,0
UY,MX,2016.0,20,20,0
NL,ID,1999.0,3,1,2
CU,VE,2006.0,7,8,-1
TW,GB,2001.0,23,33,-10
PE,CR,2014.0,10,4,6
IT,ZA,2022.0,9,13,-4
GB,BY,2012.0,2,1,1
KE,CN,2021.0,3,10,-7
IN,GH,2020.0,7,8,-1
EG,LK,2018.0,2,2,0
CH,CO,2015.0,8,9,-1
CL,KR,2021.0,2,2,0
PH,TW,2004.0,2,1,1
CZ,AT,2003.0,8,5,3
ES,LU,2013.0,8,1,7
CL,AU,2010.0,3,7,-4
BA,US,2019.0,5,9,-4
GE,SE,1999.0,2,1,1
TZ,KE,1998.0,1,1,0
GA,FR,2020.0,7,6,1
MD,DE,2013.0,4,5,-1
US,MW,2014.0,15,19,-4
SG,PL,2013.0,5,4,1
ML,US,2010.0,6,5,1
PT,SK,2011.0,1,1,0
PE,FR,2016.0,15,16,-1
GB,UA,2000.0,6,6,0
TR,NO,2012.0,4,2,2
NZ,GR,1999.0,1,1,0
CA,IS,2010.0,2,3,-1
RO,IN,2018.0,9,19,-10
PK,JP,2002.0,8,7,1
RU,GR,2012.0,5,5,0
CA,MT,2011.0,2,1,1
GR,IE,2019.0,15,3,12
JM,BB,2011.0,7,3,4
HU,IT,2007.0,9,7,2
SA,CA,1998.0,9,11,-2
GB,EE,2008.0,8,3,5
ML,IN,2021.0,2,1,1
BA,DE,2014.0,5,4,1
SA,SE,2021.0,12,3,9
JP,IL,2009.0,6,12,-6
AU,MX,2006.0,4,10,-6
PL,EG,2021.0,1,1,0
UG,NO,2010.0,2,1,1
RO,NO,2015.0,3,1,2
IE,RS,2011.0,2,2,0
BE,CD,2018.0,10,10,0
MY,ZA,2005.0,1,1,0
IR,JP,2007.0,14,18,-4
LT,AU,2013.0,3,2,1
SY,CA,2011.0,3,1,2
CI,FR,2004.0,7,3,4
BR,MA,2020.0,1,1,0
CZ,nan,2006.0,6,4,2
ID,AT,2018.0,5,10,-5
BF,SN,2016.0,6,4,2
CA,NG,2013.0,10,8,2
PT,MZ,2013.0,4,1,3
MY,YE,2011.0,5,4,1
PE,BR,1997.0,3,2,1
BR,VE,2001.0,4,8,-4
BR,IN,1997.0,2,3,-1
JO,CN,2005.0,2,3,-1
AR,CZ,2010.0,1,1,0
NP,GW,2020.0,1,1,0
FI,NZ,2018.0,6,3,3
JO,GB,2000.0,3,7,-4
IL,IN,2007.0,14,16,-2
VN,CA,2014.0,6,7,-1
NO,CZ,2010.0,5,7,-2
IN,PT,2017.0,9,24,-15
nan,CO,2008.0,3,2,1
VN,BE,2007.0,4,2,2
BW,AU,2007.0,2,2,0
JO,nan,2022.0,4,1,3
MA,BR,2019.0,3,1,2
ET,IN,2012.0,2,11,-9
US,ME,2017.0,3,1,2
AT,IR,2008.0,2,5,-3
PT,DK,1999.0,2,2,0
AU,PE,2020.0,3,3,0
IR,NG,2010.0,3,10,-7
LK,BR,2018.0,3,2,1
FI,RO,2021.0,1,1,0
SR,NL,2015.0,3,2,1
ET,KE,2019.0,8,9,-1
SV,US,2011.0,4,6,-2
PK,NG,2013.0,13,11,2
ES,NZ,2013.0,11,10,1
SE,NZ,2008.0,9,7,2
UZ,DE,2007.0,2,7,-5
MT,GB,2021.0,8,12,-4
HU,PT,2010.0,2,1,1
HR,ME,2015.0,3,3,0
NZ,MY,2021.0,9,9,0
CN,SD,2020.0,21,5,16
GH,ZA,2022.0,18,16,2
US,ME,2019.0,2,3,-1
CL,CA,2010.0,10,17,-7
UZ,US,2011.0,4,2,2
SG,SE,2003.0,2,4,-2
BE,ET,2013.0,3,2,1
MY,RU,2006.0,4,5,-1
BH,RU,2019.0,3,2,1
HR,UA,2018.0,8,16,-8
UG,BE,2022.0,8,7,1
UA,CA,1998.0,2,2,0
PL,CL,2010.0,1,1,0
PA,MX,2014.0,4,11,-7
AT,MT,2019.0,2,1,1
US,MN,2010.0,2,2,0
FR,VG,2008.0,3,2,1
SE,HU,2000.0,9,5,4
EG,BD,2022.0,5,5,0
CH,CN,1998.0,12,24,-12
GW,DK,2014.0,4,1,3
XK,BA,2018.0,2,1,1
MX,AT,2021.0,3,5,-2
CA,GR,2011.0,9,11,-2
EG,TN,2005.0,3,2,1
DE,PE,2002.0,3,4,-1
JP,CL,2014.0,7,7,0
BE,TN,2021.0,4,5,-1
PL,IN,2012.0,8,13,-5
CL,IN,2008.0,2,2,0
SA,BD,2014.0,8,19,-11
IN,EG,2013.0,7,10,-3
ZA,BE,2004.0,10,11,-1
NA,GB,2016.0,3,2,1
SG,UA,2014.0,2,1,1
BR,GE,2019.0,3,1,2
RS,SE,2008.0,3,4,-1
JO,CA,2013.0,12,11,1
JP,ET,2018.0,7,4,3
BB,IN,2003.0,1,1,0
UY,FR,2006.0,6,4,2
ZA,FR,2006.0,14,14,0
BW,ZA,2014.0,9,9,0
CN,EE,2007.0,1,1,0
AU,KW,2020.0,4,6,-2
SN,FR,2002.0,7,15,-8
NI,US,2010.0,1,1,0
NZ,FR,2008.0,12,13,-1
MX,IE,2005.0,2,1,1
AT,XK,2021.0,3,2,1
FR,LT,2013.0,2,5,-3
TR,NZ,2007.0,1,1,0
RW,nan,2011.0,4,1,3
UA,RO,2015.0,2,3,-1
ET,DE,2014.0,8,8,0
US,YE,2015.0,2,2,0
CN,GR,2021.0,9,5,4
PL,BY,2017.0,4,3,1
DE,GA,1998.0,1,1,0
IL,UA,2003.0,4,3,1
SK,BE,2011.0,6,2,4
PK,SG,2000.0,1,1,0
AT,HU,2008.0,10,26,-16
IE,BR,2002.0,4,2,2
NO,BG,1999.0,2,4,-2
LK,CH,2017.0,7,3,4
LS,ZA,2010.0,3,2,1
IN,VN,2007.0,3,2,1
FI,PL,1999.0,2,1,1
LT,GB,1997.0,3,1,2
JO,ES,2015.0,1,6,-5
GB,IS,2021.0,6,4,2
AR,TW,2020.0,7,3,4
CN,CH,1997.0,13,4,9
FI,UA,1997.0,1,1,0
NZ,BR,2011.0,6,6,0
UA,IL,2006.0,2,3,-1
IE,SE,2002.0,2,2,0
HU,JP,2010.0,5,5,0
FR,UY,2006.0,4,6,-2
PK,BD,2001.0,1,5,-4
IT,LU,2010.0,8,4,4
AE,CY,2015.0,1,3,-2
LU,CA,2018.0,9,7,2
CA,UA,2009.0,3,5,-2
IQ,JP,2014.0,4,7,-3
CN,MK,2003.0,5,3,2
TR,ZA,2018.0,7,3,4
SE,SI,2003.0,1,2,-1
DZ,ES,2016.0,3,5,-2
SA,FR,2004.0,4,3,1
ZA,BD,2013.0,2,1,1
KW,CA,2015.0,12,15,-3
CA,SN,2014.0,8,5,3
ID,BR,2017.0,10,21,-11
TN,MX,2015.0,2,3,-1
DK,PK,2018.0,7,5,2
DK,SA,2017.0,3,4,-1
BE,DZ,2005.0,3,1,2
US,SN,2018.0,16,12,4
SN,CA,2015.0,4,6,-2
CM,EG,2020.0,1,2,-1
PE,TR,2016.0,1,1,0
NO,RU,2016.0,15,17,-2
SK,DK,2022.0,1,1,0
MY,MX,2017.0,5,1,4
PL,CU,2021.0,1,2,-1
MK,IR,2009.0,1,1,0
HU,NG,2023.0,2,1,1
EE,AU,2019.0,2,4,-2
BE,LK,2019.0,1,2,-1
PT,IT,2001.0,2,7,-5
FR,SK,2022.0,3,1,2
BZ,FR,2000.0,3,6,-3
DE,KE,2002.0,5,1,4
DK,NZ,2000.0,3,2,1
BR,DO,2015.0,5,1,4
HU,CO,2014.0,1,1,0
BR,ZA,2008.0,6,9,-3
CA,GH,2015.0,3,8,-5
GB,BG,1999.0,5,8,-3
GR,SK,2018.0,1,1,0
PE,AR,2000.0,2,2,0
NO,PA,2019.0,1,1,0
nan,ID,2011.0,8,6,2
ZA,IE,2003.0,4,2,2
ZA,CD,2016.0,3,3,0
NZ,HU,2018.0,4,3,1
TR,AZ,1997.0,2,1,1
JM,GB,2012.0,7,8,-1
GB,DZ,2013.0,7,4,3
GR,BR,2003.0,2,2,0
TT,NZ,2011.0,1,1,0
TR,CZ,2002.0,2,2,0
NZ,OM,2015.0,1,3,-2
IL,IE,2019.0,3,1,2
IT,UZ,2008.0,1,1,0
DK,HU,2011.0,1,6,-5
IR,PS,2020.0,2,1,1
CN,HU,2001.0,2,1,1
FR,IQ,2016.0,7,2,5
AE,CA,2001.0,2,7,-5
MA,SA,1998.0,2,1,1
PS,US,2018.0,4,16,-12
CH,TW,2007.0,5,3,2
BE,RS,2012.0,2,2,0
CZ,TR,2004.0,2,5,-3
US,MN,2017.0,5,2,3
ES,CN,2023.0,5,4,1
MY,LB,2020.0,6,1,5
DE,DZ,2009.0,4,2,2
TW,BD,2019.0,1,2,-1
HU,GR,2015.0,6,3,3
ZA,LS,2011.0,2,5,-3
DO,ES,2015.0,3,7,-4
CN,TZ,2018.0,8,6,2
US,FO,2016.0,1,1,0
MA,BR,2017.0,1,2,-1
EG,CZ,2018.0,4,4,0
CA,JO,2007.0,3,7,-4
FI,IN,2003.0,1,6,-5
BD,MA,2013.0,6,6,0
GB,LT,2014.0,4,6,-2
IR,DE,2003.0,6,7,-1
NG,JP,1998.0,1,2,-1
CL,PH,2016.0,6,3,3
DK,FI,2012.0,9,21,-12
GB,GT,2013.0,1,1,0
VN,NL,2013.0,3,8,-5
CO,nan,1999.0,1,1,0
GB,SN,2012.0,1,1,0
GR,BG,2015.0,3,1,2
AE,NZ,2005.0,2,2,0
IL,AR,2008.0,2,3,-1
RO,CO,2019.0,1,1,0
AO,US,2007.0,2,4,-2
FI,NG,2017.0,2,2,0
LT,JP,2006.0,5,17,-12
CI,BF,2018.0,5,5,0
GB,BF,2015.0,1,2,-1
ID,UY,2021.0,2,1,1
FR,LB,1999.0,6,7,-1
QA,NL,2015.0,1,10,-9
UA,SG,2010.0,1,1,0
DE,BD,2015.0,8,10,-2
PK,IE,2005.0,2,5,-3
CA,PE,2012.0,3,6,-3
NL,IS,2002.0,1,1,0
ML,KE,2020.0,2,3,-1
GN,CN,2020.0,1,1,0
IR,ZA,2012.0,5,1,4
AE,CH,2015.0,3,1,2
AM,RU,2006.0,3,7,-4
CM,DE,2012.0,4,9,-5
SE,MY,2022.0,2,1,1
DE,LU,1997.0,2,3,-1
UY,VE,2020.0,3,3,0
ID,MX,2016.0,2,1,1
RW,UG,2017.0,2,2,0
DK,SA,2019.0,2,3,-1
RW,UG,2019.0,8,6,2
BH,TR,2020.0,1,1,0
ML,US,2017.0,7,8,-1
VN,NO,2021.0,3,1,2
PT,MA,2023.0,3,2,1
SK,CA,2004.0,4,8,-4
MX,VN,2004.0,2,1,1
UA,SG,2017.0,1,4,-3
GB,NA,2009.0,1,1,0
SA,ET,2021.0,1,1,0
PR,US,2015.0,5,9,-4
SA,TW,2020.0,8,5,3
TN,TR,2018.0,3,3,0
NP,BD,2012.0,3,8,-5
GB,KZ,2005.0,1,1,0
DE,MK,2017.0,3,1,2
MA,IT,2022.0,4,23,-19
LU,BR,2022.0,3,2,1
VN,DK,2014.0,4,2,2
DE,ET,2010.0,4,4,0
SI,AT,2001.0,3,4,-1
DK,UG,2016.0,3,1,2
VE,IT,2022.0,1,1,0
US,PG,2007.0,4,1,3
MY,FR,2001.0,3,4,-1
LU,CH,2003.0,1,2,-1
SK,IN,2013.0,2,5,-3
DE,LV,1997.0,1,1,0
UZ,IT,2011.0,3,2,1
HN,PE,2016.0,3,3,0
NG,BR,2011.0,1,1,0
IN,GE,2008.0,3,2,1
RO,GB,2023.0,1,2,-1
NZ,DE,2001.0,9,17,-8
EC,DE,2015.0,2,9,-7
JP,ZM,1997.0,2,1,1
NZ,IT,1999.0,1,1,0
MA,HU,2011.0,1,5,-4
ID,GH,2015.0,5,11,-6
PL,AT,2000.0,6,5,1
PH,EC,2020.0,2,4,-2
GH,SE,2020.0,2,2,0
SE,PS,2018.0,2,1,1
JO,PS,2012.0,3,1,2
KG,KZ,2022.0,6,2,4
NL,LB,2017.0,1,1,0
KW,AE,2010.0,2,2,0
IL,IE,2017.0,1,3,-2
PL,SI,2018.0,3,4,-1
NL,LB,2019.0,3,8,-5
AT,CH,2023.0,4,5,-1
NC,PF,2011.0,1,1,0
LK,NL,2019.0,1,4,-3
DE,SD,2018.0,3,1,2
NL,PK,2021.0,4,7,-3
SA,OM,2009.0,3,3,0
CH,NG,2001.0,1,1,0
BE,HU,2001.0,6,6,0
nan,BH,2018.0,1,2,-1
IL,SG,2002.0,2,1,1
SG,BE,2011.0,2,4,-2
MY,ZA,2002.0,1,1,0
SE,UG,2018.0,2,4,-2
AU,BN,2013.0,2,2,0
BD,OM,2020.0,1,4,-3
UA,ES,2015.0,5,3,2
BW,DE,2018.0,2,1,1
UG,NO,2019.0,4,3,1
UA,CA,1997.0,1,1,0
UA,CH,1999.0,2,3,-1
PH,PA,2010.0,1,1,0
MD,ES,2008.0,2,1,1
IT,AO,1999.0,2,2,0
CG,SN,2010.0,2,1,1
TW,KE,2000.0,1,1,0
MT,IT,2012.0,1,4,-3
LY,RS,2016.0,1,1,0
BE,AR,2001.0,1,2,-1
SI,DE,1999.0,3,3,0
CH,LV,2021.0,1,2,-1
LT,CA,2011.0,1,1,0
GE,RU,2012.0,2,6,-4
AT,BR,2006.0,3,9,-6
SE,NG,2018.0,1,1,0
NP,BE,2020.0,2,1,1
PK,IQ,2012.0,1,1,0
CA,BY,2010.0,2,1,1
SI,FI,2010.0,1,1,0
CH,GE,2018.0,1,1,0
GR,VN,2011.0,2,4,-2
IE,JO,2005.0,1,2,-1
GE,CA,2007.0,1,1,0
MN,DE,2020.0,1,4,-3
MY,IR,2004.0,1,1,0
CG,SN,2017.0,2,1,1
FI,AT,2000.0,1,3,-2
BY,JP,2006.0,1,1,0
HU,LU,2013.0,1,2,-1
MK,DE,2003.0,1,1,0
BE,NE,2016.0,3,2,1
PE,CH,2020.0,2,5,-3
NZ,IL,2015.0,2,1,1
AU,BE,2023.0,1,3,-2
TH,ZA,2007.0,1,3,-2
CA,VE,2006.0,3,5,-2
SG,PT,2016.0,3,2,1
KH,NL,2009.0,2,1,1
HR,IN,2014.0,1,1,0
CA,VG,2013.0,1,1,0
PH,FR,2007.0,2,4,-2
IE,BR,2005.0,3,1,2
KR,UZ,2007.0,2,2,0
LK,ES,2016.0,3,1,2
PT,KR,2011.0,2,10,-8
MA,BJ,2014.0,1,3,-2
TJ,DE,2019.0,2,1,1
FI,TR,2016.0,3,9,-6
TW,PH,2007.0,1,2,-1
JP,ZM,1998.0,1,1,0
MD,CH,2009.0,1,1,0
NO,PK,2002.0,1,2,-1
SA,TR,2001.0,1,1,0
EE,AU,2017.0,2,1,1
FJ,US,2007.0,1,5,-4
PL,FI,1999.0,1,2,-1
IE,SE,2005.0,1,7,-6
XK,US,2005.0,1,3,-2
KR,AM,2006.0,4,14,-10
NP,SE,2013.0,1,1,0
QA,CA,2009.0,1,12,-11
OM,CA,2009.0,4,7,-3
BA,AT,2014.0,1,2,-1
CM,CA,2012.0,3,2,1
PK,BH,2019.0,3,2,1
PH,BE,2014.0,1,2,-1
RW,RS,2009.0,1,1,0
SY,FR,2001.0,2,2,0
GB,MD,2014.0,2,2,0
MZ,LT,2006.0,4,7,-3
IN,IQ,2004.0,1,1,0
RS,BE,2008.0,1,2,-1
GB,CA,2004.0,620,466,154
IE,GB,2016.0,443,418,25
US,NL,2021.0,711,652,59
FR,CH,2016.0,531,384,147
LU,US,2013.0,12,17,-5
DE,IR,2006.0,18,14,4
CH,IR,2016.0,15,31,-16
CN,SY,2020.0,15,16,-1
AU,CA,2019.0,429,474,-45
NO,SE,2005.0,45,65,-20
BE,US,2014.0,387,399,-12
SD,GB,2022.0,10,4,6
IN,PK,2022.0,244,251,-7
HU,RO,1997.0,45,25,20
VE,EC,2020.0,27,17,10
CA,PL,2001.0,9,9,0
US,VE,2001.0,34,52,-18
FI,AR,2006.0,2,2,0
IS,GB,2008.0,11,10,1
CR,EC,2020.0,27,22,5
PL,US,2010.0,197,207,-10
SK,AU,2018.0,2,4,-2
IT,US,1998.0,466,500,-34
SE,NL,2004.0,30,37,-7
CN,KR,2000.0,61,73,-12
IR,US,2006.0,85,109,-24
CL,CA,2019.0,26,36,-10
CH,NL,2001.0,44,45,-1
UG,FR,2012.0,6,3,3
BR,CN,2001.0,14,6,8
CL,NO,2011.0,4,2,2
MZ,RU,2011.0,20,10,10
KR,PR,2012.0,21,33,-12
IN,QA,2017.0,24,21,3
MY,TW,2019.0,30,31,-1
NL,AU,2016.0,142,101,41
HR,GB,2020.0,24,13,11
IN,CH,2019.0,78,67,11
KZ,AU,2021.0,3,2,1
FR,SE,2022.0,57,59,-2
EC,US,2022.0,63,39,24
nan,MY,2011.0,50,34,16
BY,CZ,2020.0,9,17,-8
RO,FR,2007.0,25,31,-6
CA,RS,2018.0,9,16,-7
IL,DE,2011.0,52,34,18
KR,EG,2009.0,4,9,-5
nan,SE,2013.0,49,52,-3
TR,KZ,2008.0,30,26,4
LK,AU,2009.0,16,9,7
IL,IT,2015.0,17,23,-6
ZA,SA,2014.0,6,3,3
IN,CH,2017.0,67,59,8
NO,ES,2016.0,34,43,-9
CN,MG,2017.0,4,8,-4
MY,CZ,2015.0,14,5,9
BO,BR,2020.0,4,10,-6
EG,SY,2011.0,1,3,-2
HU,TR,2022.0,10,6,4
CA,SE,2012.0,55,46,9
CA,KW,2022.0,6,5,1
BR,IL,2006.0,4,4,0
LS,ZA,2019.0,5,10,-5
SN,FR,2005.0,18,21,-3
GT,PE,2020.0,7,4,3
SD,AE,2020.0,5,8,-3
PT,SE,2016.0,15,10,5
HU,IN,2018.0,5,7,-2
CA,GE,2006.0,2,4,-2
LT,CZ,2011.0,3,33,-30
IR,FR,2006.0,9,16,-7
BG,JP,2006.0,5,5,0
TR,IS,2020.0,2,2,0
RS,MX,2020.0,5,3,2
FR,DZ,2002.0,28,17,11
SE,IE,2013.0,10,21,-11
SA,IN,1999.0,4,6,-2
PT,NL,2004.0,5,15,-10
CO,PH,2003.0,1,1,0
TW,SE,2017.0,6,3,3
CA,NL,2023.0,6,5,1
AT,AU,2008.0,21,20,1
CN,DK,2004.0,8,19,-11
CU,ES,2000.0,39,41,-2
ES,HN,2022.0,5,4,1
ES,NO,1997.0,7,7,0
NL,GB,2023.0,10,23,-13
SS,GB,2007.0,15,3,12
IE,JP,2000.0,9,24,-15
JP,AE,2016.0,5,1,4
CL,PE,2011.0,45,19,26
CM,US,2011.0,14,8,6
BO,CN,2001.0,2,1,1
GE,TR,2014.0,3,1,2
SK,CH,2001.0,9,1,8
GR,KW,2009.0,2,5,-3
KR,SG,2006.0,17,19,-2
HU,JP,2019.0,15,13,2
JP,CZ,2003.0,17,13,4
DK,GL,2020.0,4,7,-3
EG,NL,2012.0,3,7,-4
CL,IT,2003.0,11,8,3
IR,CZ,2009.0,2,2,0
AU,LB,2014.0,4,5,-1
ZA,PK,2012.0,4,2,2
PR,MX,2019.0,4,4,0
IN,PG,2020.0,1,2,-1
DE,DK,2023.0,8,5,3
HU,JP,2017.0,8,23,-15
PL,BY,2019.0,6,4,2
GR,IE,2010.0,4,3,1
CH,SI,1999.0,4,1,3
nan,TN,2020.0,14,4,10
EE,AU,2010.0,3,1,2
TW,CH,2013.0,9,8,1
HU,BE,2006.0,7,8,-1
BY,DE,2000.0,6,4,2
DZ,ID,2020.0,5,4,1
SI,IT,2018.0,12,19,-7
AR,MY,2015.0,2,3,-1
CN,KE,2009.0,6,1,5
BG,CH,2007.0,1,3,-2
EC,IT,2014.0,2,7,-5
VN,CN,2023.0,3,3,0
BR,SG,2016.0,2,1,1
IT,BG,1997.0,1,4,-3
KW,ID,2020.0,3,1,2
IE,IL,2020.0,5,2,3
CM,FR,2007.0,6,13,-7
BR,PK,2011.0,3,5,-2
SY,TR,2016.0,3,1,2
EG,KR,2005.0,1,1,0
SD,ID,2015.0,2,2,0
EG,RU,2023.0,1,2,-1
ES,EG,2020.0,8,6,2
US,BF,2006.0,2,2,0
GH,US,2003.0,3,4,-1
CZ,UG,2019.0,2,4,-2
AR,PH,2021.0,7,1,6
FI,IR,2012.0,6,7,-1
AU,LK,2008.0,4,8,-4
ME,DE,2013.0,1,1,0
BR,CR,1997.0,1,1,0
IQ,MM,2021.0,2,4,-2
UA,SG,2019.0,2,1,1
NG,JP,1997.0,2,2,0
US,BM,2004.0,1,2,-1
CZ,FI,2000.0,1,1,0
ET,CN,2002.0,1,3,-2
CH,LB,2019.0,4,8,-4
BA,BE,2020.0,1,1,0
NZ,SE,2011.0,6,7,-1
CZ,DK,2000.0,1,1,0
LV,AU,2021.0,1,1,0
TR,LU,2017.0,2,1,1
IE,MX,2021.0,2,4,-2
FR,IS,2009.0,2,1,1
GR,TW,2021.0,1,1,0
AU,FJ,2004.0,2,2,0
IR,BO,2018.0,4,2,2
CR,GB,2005.0,4,2,2
FR,PH,2006.0,3,2,1
NL,SI,2012.0,4,4,0
NG,SA,2006.0,1,3,-2
NG,BW,2015.0,3,2,1
US,NC,2013.0,1,2,-1
LB,BR,2016.0,2,4,-2
NL,SA,2013.0,8,4,4
CN,SE,2013.0,90,87,3
CA,MK,2013.0,3,1,2
US,SV,2004.0,2,2,0
GD,US,2020.0,27,14,13
CH,VN,2017.0,8,2,6
nan,NO,2002.0,10,8,2
DE,CZ,2004.0,44,22,22
NG,FR,2016.0,9,7,2
KE,CI,2015.0,3,1,2
ES,UY,2004.0,14,25,-11
TR,PS,2014.0,2,3,-1
CA,IS,2017.0,4,2,2
DK,CH,2022.0,28,41,-13
IN,LB,2019.0,6,3,3
LK,CH,2010.0,2,2,0
DO,MX,2020.0,3,4,-1
BE,IL,2012.0,3,3,0
RU,SG,2011.0,3,5,-2
PH,EG,2005.0,1,1,0
MY,CN,2023.0,7,7,0
,GB,1996.0,21257,0,21257
,US,2005.0,72317,0,72317
,US,2002.0,75319,0,75319
US,,2011.0,43242,0,43242
,CN,2011.0,57452,0,57452
CN,,2013.0,54817,0,54817
,IE,2001.0,814,0,814
,ES,2011.0,15081,0,15081
,GB,2004.0,16855,0,16855
CL,,2021.0,2855,0,2855
,AU,1998.0,5466,0,5466
,SE,1995.0,5718,0,5718
,AU,1997.0,5773,0,5773
VE,UY,2016.0,2,0,2
MX,,2021.0,7751,0,7751
,IT,2001.0,10579,0,10579
IE,,2024.0,9268,0,9268
,TN,2005.0,1084,0,1084
CA,,2006.0,2765,0,2765
IL,,1998.0,495,0,495
KR,UA,2018.0,6,0,6
,NZ,1995.0,1515,0,1515
NL,,2005.0,1745,0,1745
HR,,2024.0,5744,0,5744
SN,CH,2011.0,2,0,2
,PH,2006.0,397,0,397
,NL,2000.0,4730,0,4730
TW,,2021.0,4912,0,4912
AU,,2015.0,4300,0,4300
RU,,2020.0,12291,0,12291
NL,,2002.0,1709,0,1709
,YE,2011.0,50,0,50
ZA,,2025.0,1069,0,1069
,CO,2003.0,1310,0,1310
YE,,2019.0,54,0,54
TR,,2016.0,2951,0,2951
NZ,,2025.0,796,0,796
,MA,2002.0,538,0,538
,GT,2018.0,53,0,53
,ZA,2013.0,2705,0,2705
SG,,2013.0,574,0,574
,TR,2008.0,5383,0,5383
,CW,2008.0,13,0,13
,MA,2005.0,563,0,563
,SY,2005.0,72,0,72
,JM,2007.0,67,0,67
ML,NO,2005.0,1,0,1
,IR,2020.0,356,0,356
,GR,2010.0,2586,0,2586
,TN,2002.0,709,0,709
,MZ,2006.0,53,0,53
KH,,2022.0,100,0,100
,GE,2007.0,153,0,153
BG,,2011.0,269,0,269
,CG,2007.0,42,0,42
BY,,2007.0,148,0,148
NC,,2020.0,19,0,19
,QA,2004.0,90,0,90
SD,,2016.0,53,0,53
RO,,2012.0,473,0,473
,BH,2019.0,92,0,92
LT,,2020.0,785,0,785
TH,,2000.0,84,0,84
,OM,2009.0,151,0,151
,MK,2013.0,269,0,269
NL,BT,2017.0,1,0,1
MD,,2008.0,35,0,35
,SY,2002.0,51,0,51
,KG,2013.0,37,0,37
,QA,1996.0,46,0,46
,GR,2019.0,1312,0,1312
,FR,2020.0,415,0,415
UZ,,2014.0,85,0,85
,AM,2010.0,150,0,150
UY,JP,2014.0,1,0,1
,GR,2017.0,1960,0,1960
,GA,2010.0,24,0,24
TW,SK,2011.0,2,0,2
,EG,2018.0,3936,0,3936
,ML,2013.0,40,0,40
,AM,2019.0,69,0,69
IQ,,2004.0,7,0,7
AE,,2008.0,52,0,52
,SN,2004.0,77,0,77
QA,NZ,2012.0,1,0,1
CZ,,1999.0,178,0,178
,SN,1996.0,56,0,56
,AF,2018.0,36,0,36
,AM,2017.0,173,0,173
NL,BD,2020.0,5,0,5
TG,,2023.0,215,0,215
SK,,2000.0,112,0,112
MK,HR,2006.0,1,0,1
,PA,2007.0,34,0,34
JO,,2008.0,44,0,44
GE,SA,2017.0,1,0,1
JO,LY,2013.0,1,0,1
,LY,2014.0,55,0,55
KN,KY,2020.0,1,0,1
,NE,2018.0,46,0,46
,JO,2018.0,641,0,641
,BH,2010.0,49,0,49
NA,,2016.0,24,0,24
NA,SE,2015.0,1,0,1
AM,DK,2019.0,1,0,1
IQ,IE,2014.0,2,0,2
,MM,2004.0,14,0,14
,BH,2017.0,110,0,110
,RW,2016.0,99,0,99
ID,PE,2016.0,1,0,1
AO,,2022.0,66,0,66
OM,NG,2014.0,1,0,1
,LA,2018.0,20,0,20
AG,,2025.0,50,0,50
HT,,2023.0,43,0,43
,GA,2019.0,19,0,19
ML,CN,2021.0,1,0,1
,MT,2018.0,57,0,57
,DO,1997.0,13,0,13
,GM,2012.0,12,0,12
GH,AE,2020.0,1,0,1
,nan,2001.0,656,0,656
AZ,,2024.0,549,0,549
,ET,2018.0,1631,0,1631
,GA,2017.0,37,0,37
,KE,2008.0,389,0,389
BH,,2009.0,17,0,17
,BF,1997.0,26,0,26
GH,BB,2020.0,1,0,1
GD,,2016.0,22,0,22
RE,IT,2021.0,1,0,1
YE,,2017.0,34,0,34
,BB,1997.0,8,0,8
KG,DE,2015.0,2,0,2
TT,,2021.0,78,0,78
KR,RW,2018.0,1,0,1
,WS,2016.0,5,0,5
GH,,2003.0,19,0,19
CN,MT,2009.0,1,0,1
ZM,nan,2016.0,6,0,6
LT,VE,2013.0,1,0,1
UY,SA,2015.0,1,0,1
CG,DE,2016.0,1,0,1
MK,CA,2019.0,1,0,1
,DO,1998.0,8,0,8
GL,SE,2010.0,1,0,1
CA,BY,2017.0,2,0,2
JO,IL,2022.0,1,0,1
MY,NZ,2002.0,4,0,4
CM,CO,2007.0,1,0,1
SE,BJ,2017.0,1,0,1
IT,LB,1998.0,2,0,2
SX,HT,2021.0,2,0,2
,GF,2016.0,22,0,22
CU,UA,2021.0,1,0,1
BR,MC,2019.0,2,0,2
,MM,1996.0,7,0,7
MU,,2018.0,27,0,27
CI,MX,2022.0,1,0,1
MQ,CA,2021.0,2,0,2
CO,,1999.0,21,0,21
BE,GN,2019.0,2,0,2
MR,,2006.0,1,0,1
PT,CM,2013.0,1,0,1
,BF,1998.0,27,0,27
UG,nan,2014.0,4,0,4
TR,GE,2017.0,3,0,3
RS,PK,2015.0,4,0,4
TZ,,2014.0,62,0,62
TZ,IT,2018.0,4,0,4
BJ,ET,2014.0,1,0,1
GB,ML,2012.0,1,0,1
nan,NP,2011.0,2,0,2
MG,,2005.0,5,0,5
BH,SG,2012.0,1,0,1
FR,TD,2009.0,1,0,1
AF,PK,2011.0,1,0,1
CH,NE,2021.0,2,0,2
QA,IE,2005.0,1,0,1
SA,CY,2016.0,1,0,1
IN,ET,1999.0,1,0,1
IR,AT,2001.0,1,0,1
NZ,AR,2021.0,2,0,2
LK,,2007.0,25,0,25
FR,LK,2018.0,1,0,1
,VG,2019.0,1,0,1
NP,GB,2006.0,6,0,6
NE,IT,2007.0,2,0,2
KP,,2014.0,4,0,4
RS,LY,2018.0,1,0,1
,SZ,1994.0,4,0,4
BG,NL,2009.0,6,0,6
MA,,2026.0,12,0,12
IT,LB,1997.0,2,0,2
AU,HR,2000.0,1,0,1
LY,BD,2016.0,1,0,1
GY,,2013.0,2,0,2
MW,,2005.0,9,0,9
MW,CY,2021.0,1,0,1
UG,RW,2008.0,1,0,1
SD,PK,2011.0,2,0,2
VU,US,2005.0,1,0,1
,VG,2017.0,10,0,10
CR,KR,2003.0,1,0,1
GR,GE,2016.0,1,0,1
SD,TZ,2006.0,1,0,1
GH,IT,2003.0,3,0,3
BG,AZ,2009.0,1,0,1
SN,,2005.0,12,0,12
MU,AU,2014.0,1,0,1
VU,,2016.0,1,0,1
IQ,OM,2012.0,3,0,3
FR,AO,2008.0,1,0,1
SE,AL,2014.0,1,0,1
PT,SG,2010.0,1,0,1
TD,CH,2006.0,1,0,1
MY,KE,2001.0,1,0,1
DK,CZ,2003.0,2,0,2
MY,UG,2013.0,1,0,1
MG,,2002.0,8,0,8
NA,NL,2014.0,1,0,1
PL,ZM,2010.0,1,0,1
MK,CA,2017.0,3,0,3
,BS,2003.0,1,0,1
MY,TN,2012.0,4,0,4
LR,GB,2014.0,1,0,1
IE,BD,2006.0,1,0,1
FR,EE,2022.0,2,0,2
LK,IE,2019.0,2,0,2
IL,SG,2005.0,2,0,2
TG,US,2013.0,1,0,1
,VG,2010.0,23,0,23
AE,PS,2019.0,1,0,1
CA,GI,2003.0,1,0,1
LA,BR,2018.0,2,0,2
IL,KR,1999.0,1,0,1
BE,NZ,1999.0,1,0,1
YE,,2010.0,9,0,9
SA,KW,1997.0,2,0,2
,VU,2000.0,2,0,2
GM,US,2001.0,3,0,3
PS,nan,2010.0,1,0,1
SA,DK,2003.0,1,0,1
MM,CN,2012.0,5,0,5
TW,MA,2020.0,1,0,1
SV,,2013.0,5,0,5
GB,HT,2017.0,1,0,1
ET,KE,2010.0,4,0,4
NG,IR,2012.0,5,0,5
CA,BA,2021.0,1,0,1
RW,DE,2007.0,1,0,1
BJ,GB,1998.0,1,0,1
MV,ID,2022.0,1,0,1
TW,QA,2016.0,3,0,3
IS,CA,1998.0,2,0,2
DE,TZ,2000.0,2,0,2
QA,KR,1999.0,3,0,3
MA,PA,2015.0,1,0,1
DK,SA,2010.0,4,0,4
QA,TR,2008.0,1,0,1
LV,FI,2002.0,1,0,1
BR,NI,2011.0,2,0,2
KE,MX,2011.0,1,0,1
MX,LU,2022.0,3,0,3
NG,VN,2019.0,3,0,3
SL,US,2004.0,1,0,1
HU,BR,2005.0,2,0,2
,FO,2003.0,6,0,6
NL,LB,2010.0,1,0,1
PK,PG,2007.0,1,0,1
GH,TR,2016.0,1,0,1
NZ,KW,2019.0,2,0,2
GT,nan,2016.0,1,0,1
MA,RU,2000.0,1,0,1
CM,NL,2006.0,1,0,1
SN,,2002.0,11,0,11
JO,CN,2002.0,1,0,1
AL,,2009.0,8,0,8
ZM,,2007.0,12,0,12
,BB,1998.0,7,0,7
CA,CY,1999.0,1,0,1
CM,TH,2016.0,2,0,2
SK,KW,1998.0,3,0,3
,GN,1998.0,1,0,1
VG,IR,2014.0,1,0,1
NL,IS,2005.0,1,0,1
BF,BR,2011.0,2,0,2
NZ,RS,2017.0,1,0,1
MK,RU,2000.0,2,0,2
PT,CL,1998.0,1,0,1
,SS,2001.0,4,0,4
CO,AM,2002.0,1,0,1
AM,DK,2010.0,1,0,1
MY,CO,2021.0,1,0,1
BE,PE,2016.0,4,0,4
CZ,KR,2001.0,5,0,5
US,HN,2015.0,4,0,4
DE,ME,2016.0,1,0,1
HU,VN,2007.0,1,0,1
MA,YE,2017.0,1,0,1
IE,JO,2002.0,1,0,1
RO,KZ,2018.0,2,0,2
NO,AR,2006.0,2,0,2
NL,RW,2018.0,3,0,3
UG,IN,2002.0,1,0,1
EC,CH,2014.0,1,0,1
IN,AF,2015.0,2,0,2
DK,KN,2014.0,1,0,1
KE,FI,2014.0,5,0,5
PR,,1998.0,1,0,1
AT,CL,1998.0,2,0,2
PY,CH,2019.0,1,0,1
GT,AR,2013.0,2,0,2
AF,GB,2015.0,3,0,3
TW,PE,2016.0,1,0,1
,MV,2016.0,3,0,3
LR,BH,2021.0,1,0,1
SI,IE,2016.0,3,0,3
MW,,2002.0,6,0,6
RE,BJ,2012.0,1,0,1
FJ,NZ,2008.0,2,0,2
NG,LK,2005.0,1,0,1
,FJ,2007.0,16,0,16
VG,AU,2016.0,2,0,2
AR,CZ,2019.0,3,0,3
LI,MX,2020.0,1,0,1
OM,,1998.0,5,0,5
FR,PR,2008.0,1,0,1
BY,ZA,2006.0,1,0,1
PT,SA,2016.0,4,0,4
CG,JP,2000.0,1,0,1
FR,PY,2011.0,1,0,1
JM,CA,2022.0,4,0,4
GT,AU,2008.0,1,0,1
LV,KZ,2020.0,3,0,3
CR,JP,2013.0,1,0,1
CI,,2004.0,4,0,4
DE,IE,2023.0,3,0,3
MA,PK,2008.0,10,0,10
XK,IL,2020.0,1,0,1
BG,VN,1999.0,1,0,1
BJ,IT,2001.0,2,0,2
AR,DK,2000.0,1,0,1
VG,BE,2005.0,1,0,1
TJ,QA,2016.0,1,0,1
IN,LB,2010.0,1,0,1
FI,PS,2013.0,1,0,1
VN,CR,2005.0,1,0,1
BW,NG,2002.0,1,0,1
NZ,AT,2022.0,3,0,3
nan,CU,2011.0,2,0,2
IN,CY,2000.0,1,0,1
LA,GR,1999.0,1,0,1
DE,BI,2012.0,2,0,2
SG,MM,2003.0,1,0,1
BG,PH,2021.0,1,0,1
RS,NZ,2000.0,1,0,1
ME,AR,2021.0,1,0,1
DE,CI,2015.0,1,0,1
UA,MZ,2013.0,1,0,1
ML,CG,2018.0,1,0,1
TW,MM,2016.0,1,0,1
GF,CF,2019.0,1,0,1
VN,CZ,2012.0,3,0,3
TZ,ET,2016.0,1,0,1
GF,US,2020.0,3,0,3
ZW,BW,2009.0,3,0,3
KW,NG,2005.0,1,0,1
US,LT,1997.0,8,0,8
ML,NO,2002.0,1,0,1
UA,AM,1999.0,3,0,3
DZ,PL,2008.0,1,0,1
SE,PA,2019.0,2,0,2
KE,UG,1998.0,2,0,2
GM,,2016.0,6,0,6
UA,PH,2003.0,1,0,1
RS,EG,2007.0,1,0,1
BE,GM,2006.0,2,0,2
AE,MX,2010.0,3,0,3
SN,SE,2015.0,1,0,1
BJ,UG,2022.0,1,0,1
,NC,2006.0,4,0,4
IL,DZ,2013.0,1,0,1
PE,NO,2002.0,1,0,1
UA,EG,2020.0,1,0,1
BJ,BI,2016.0,2,0,2
BR,SO,2016.0,1,0,1
SO,,2020.0,3,0,3
SZ,,2018.0,8,0,8
IL,AM,2017.0,2,0,2
LV,SE,1998.0,3,0,3
JP,BW,2015.0,1,0,1
JO,BR,2017.0,2,0,2
SR,CA,2019.0,1,0,1
TN,MR,2015.0,1,0,1
CA,KN,2010.0,1,0,1
BE,PA,2016.0,1,0,1
NG,BF,2016.0,2,0,2
NG,ML,2005.0,1,0,1
VN,GF,2006.0,1,0,1
KW,SE,2009.0,1,0,1
,BZ,1998.0,3,0,3
HU,PH,2007.0,1,0,1
BF,AT,2009.0,1,0,1
TZ,JP,2011.0,1,0,1
ET,ML,2020.0,1,0,1
CR,nan,2015.0,2,0,2
FO,SE,2017.0,1,0,1
QA,IN,2005.0,4,0,4
PK,SN,2012.0,2,0,2
RU,ZW,2000.0,4,0,4
TH,RS,2007.0,1,0,1
MX,LY,2020.0,1,0,1
BG,SK,2005.0,1,0,1
KE,MY,2015.0,1,0,1
AT,SG,1997.0,1,0,1
SN,KE,2000.0,1,0,1
LV,US,1999.0,2,0,2
TH,PL,2022.0,1,0,1
MO,GB,2011.0,1,0,1
TW,KW,2002.0,1,0,1
BY,KZ,2014.0,1,0,1
PE,BJ,2009.0,1,0,1
UY,ST,2007.0,1,0,1
US,JE,2015.0,2,0,2
PE,HU,2013.0,1,0,1
PL,ZA,2005.0,3,0,3
GB,KH,2007.0,1,0,1
TW,BJ,2022.0,1,0,1
DO,DE,2011.0,1,0,1
GH,nan,2011.0,2,0,2
MA,CF,2020.0,1,0,1
SG,HR,2021.0,1,0,1
TJ,CN,2023.0,1,0,1
ET,TW,2015.0,2,0,2
GE,SG,2010.0,1,0,1
ZW,FR,2005.0,2,0,2
ET,BH,2023.0,1,0,1
,FM,2004.0,2,0,2
KE,PH,2003.0,1,0,1
BW,DK,2017.0,1,0,1
EE,RU,2001.0,1,0,1
PK,PH,2006.0,2,0,2
BE,MQ,2016.0,1,0,1
KZ,FI,2009.0,1,0,1
CF,TZ,2012.0,1,0,1
MX,ZA,2011.0,2,0,2
BE,BY,2014.0,1,0,1
AU,JM,2006.0,1,0,1
MY,BA,2011.0,2,0,2
GM,SN,2016.0,1,0,1
DE,QA,2010.0,2,0,2
IL,LB,2015.0,2,0,2
ZW,AL,2001.0,1,0,1
MM,TZ,2016.0,3,0,3
CR,SG,2005.0,1,0,1
CI,MG,2005.0,1,0,1
BZ,CA,2015.0,1,0,1
IS,CN,2012.0,1,0,1
UZ,FR,2005.0,2,0,2
IT,AL,2002.0,1,0,1
KW,MA,1997.0,1,0,1
nan,BD,2008.0,1,0,1
MW,LU,2017.0,1,0,1
PE,KH,2018.0,1,0,1
CA,AL,2008.0,1,0,1
PH,BW,2014.0,1,0,1
SG,GH,2017.0,3,0,3
AT,PH,2008.0,1,0,1
IE,ET,2015.0,2,0,2
MD,UA,1998.0,2,0,2
NO,KW,2019.0,2,0,2
IT,BH,2013.0,2,0,2
LK,NO,2015.0,1,0,1
PE,FI,2016.0,1,0,1
BD,PK,1997.0,2,0,2
VE,PY,2000.0,1,0,1
IQ,DE,1998.0,1,0,1
SK,EG,2015.0,1,0,1
ZA,SL,2020.0,2,0,2
GT,ID,2017.0,1,0,1
FJ,ID,2013.0,1,0,1
PA,SE,2006.0,2,0,2
BF,CI,2000.0,2,0,2
IN,CW,2016.0,1,0,1
BH,NG,2021.0,2,0,2
PL,VN,2016.0,2,0,2
MG,VN,2001.0,1,0,1
CH,MM,2007.0,1,0,1
ST,CN,2013.0,1,0,1
BH,IN,2004.0,1,0,1
CG,BR,2013.0,2,0,2
BY,CO,2009.0,1,0,1
PL,BH,2012.0,2,0,2
PK,ID,2000.0,1,0,1
RO,IS,2002.0,1,0,1
DK,JO,2005.0,1,0,1
ZM,NG,2010.0,1,0,1
NP,IS,2021.0,1,0,1
UA,TM,2021.0,1,0,1
IN,BB,2002.0,1,0,1
BN,BE,2001.0,1,0,1
IL,BY,2015.0,1,0,1
MT,VE,2008.0,1,0,1
LY,US,1999.0,1,0,1
CO,SE,2000.0,1,0,1
PH,RU,2022.0,2,0,2
FR,LV,2003.0,1,0,1
UA,AT,2007.0,4,0,4
FR,KZ,2000.0,1,0,1
ZW,SY,2014.0,1,0,1
TR,GE,2010.0,1,0,1
TN,MC,2006.0,1,0,1
IN,NA,2008.0,1,0,1
AR,LU,2019.0,1,0,1
MK,MX,2009.0,1,0,1
SD,GH,2014.0,2,0,2
FI,BY,2014.0,1,0,1
UA,HR,2007.0,1,0,1
NE,BE,1998.0,1,0,1
MM,IT,2021.0,1,0,1
SN,ES,2021.0,2,0,2
BR,CD,2009.0,1,0,1
KY,US,2016.0,2,0,2
TN,PG,2005.0,1,0,1
NL,PE,2009.0,2,0,2
CY,AG,2019.0,1,0,1
HN,AU,2009.0,1,0,1
SK,HR,2002.0,2,0,2
NG,NO,2008.0,3,0,3
TW,JO,2022.0,1,0,1
MY,SN,2015.0,1,0,1
UA,VN,2007.0,1,0,1
LU,ML,2010.0,1,0,1
AT,EE,2001.0,1,0,1
AT,KR,2005.0,1,0,1
SG,GH,2019.0,1,0,1
SE,MD,2013.0,1,0,1
NZ,IS,2021.0,1,0,1
DE,PE,2005.0,1,0,1
SY,JP,2002.0,1,0,1
BR,GE,2010.0,1,0,1
IN,PA,2006.0,1,0,1
CI,GA,2021.0,1,0,1
CU,FI,2012.0,1,0,1
IT,SJ,2019.0,1,0,1
AU,BF,2001.0,1,0,1
BR,TH,2008.0,3,0,3
AD,TR,2018.0,1,0,1
SG,AT,2011.0,2,0,2
DE,BA,2001.0,1,0,1
IE,NZ,2023.0,1,0,1
ZM,MY,2004.0,1,0,1
MX,SK,1997.0,1,0,1
LK,GR,2005.0,1,0,1
VE,BO,2013.0,2,0,2
GR,TT,2005.0,1,0,1
NL,TW,1998.0,1,0,1
IT,PS,2016.0,3,0,3
MK,ME,2003.0,1,0,1
TR,BN,2015.0,1,0,1
PK,ES,2005.0,1,0,1
BO,CO,1997.0,1,0,1
ID,GB,2023.0,1,0,1
BY,TW,2015.0,1,0,1
KW,ES,2005.0,1,0,1
BY,MX,2007.0,1,0,1
JP,PS,2016.0,3,0,3
IT,SM,2023.0,2,0,2
UA,CO,2021.0,1,0,1
PL,AE,2017.0,3,0,3
NZ,RS,2019.0,2,0,2
TN,KH,2015.0,1,0,1
IR,OM,2014.0,2,0,2
IN,AZ,2022.0,2,0,2
ID,IT,2003.0,1,0,1
PA,TN,2016.0,3,0,3
MD,FI,2002.0,2,0,2
KW,AE,2017.0,3,2,1
LT,FI,2014.0,2,3,-1
HU,PT,2019.0,2,5,-3
NL,AL,2015.0,3,1,2
MW,RW,2021.0,1,1,0
CA,LB,2023.0,1,1,0
LT,RO,2008.0,5,1,4
DE,MK,2019.0,2,2,0
US,HU,2023.0,2,3,-1
EG,AT,1999.0,1,1,0
GR,IN,2022.0,1,2,-1
KN,GB,2022.0,1,2,-1
MY,GR,2016.0,1,1,0
PY,BR,2001.0,3,2,1
TR,SG,2022.0,1,7,-6
CH,CN,1997.0,4,13,-9
MY,CA,2004.0,4,8,-4
KZ,NO,2020.0,1,1,0
BE,DZ,2002.0,2,3,-1
BE,PK,2003.0,1,1,0
ZA,ET,2010.0,1,1,0
CH,CM,2005.0,1,2,-1
BH,JO,2015.0,1,2,-1
EG,GR,2007.0,3,1,2
QA,BA,2020.0,1,2,-1
DO,US,2017.0,2,4,-2
LK,PK,2000.0,1,1,0
AT,RO,2005.0,1,1,0
SA,RU,2014.0,1,3,-2
JP,NZ,2003.0,7,5,2
JP,BE,2023.0,2,3,-1
CZ,CO,2022.0,2,3,-1
PL,CL,2017.0,3,1,2
PT,PE,2016.0,6,9,-3
SI,FI,2017.0,2,2,0
NO,EE,2018.0,1,2,-1
AT,UA,2013.0,2,4,-2
FI,MX,2016.0,1,3,-2
DO,US,2019.0,4,10,-6
NG,EG,2013.0,3,4,-1
BE,IS,2011.0,1,1,0
LT,GB,1998.0,1,3,-2
JP,BG,2000.0,1,7,-6
TW,AR,2004.0,3,1,2
EG,IE,2001.0,1,1,0
IL,AU,1997.0,4,4,0
BE,LK,2010.0,1,1,0
LV,LT,2021.0,2,1,1
KR,LK,2014.0,2,2,0
IR,NG,2017.0,1,4,-3
CY,GR,1999.0,1,1,0
EC,IE,2021.0,1,1,0
LB,PS,2020.0,1,1,0
KR,MN,2010.0,1,1,0
LY,GB,2008.0,2,3,-1
ML,FR,2012.0,5,10,-5
PS,nan,2017.0,1,2,-1
AM,CA,2020.0,1,2,-1
NO,SJ,2001.0,1,2,-1
IT,SN,2015.0,2,1,1
PS,MA,2018.0,1,1,0
CU,SE,2009.0,1,1,0
EE,NL,2001.0,1,1,0
nan,CI,2000.0,1,1,0
BJ,BF,2015.0,2,1,1
ZA,EG,2007.0,1,2,-1
SE,CR,2004.0,1,1,0
HR,XK,2009.0,2,2,0
RW,KE,2012.0,1,1,0
BH,OM,2018.0,1,1,0
IL,NO,2000.0,2,1,1
VN,AU,2007.0,7,3,4
ZM,NG,2019.0,3,2,1
ML,SN,2004.0,1,1,0
TW,HK,2020.0,1,3,-2
ID,RO,2015.0,1,2,-1
SE,HR,2004.0,1,1,0
CN,MD,2014.0,1,1,0
CA,IS,2019.0,1,1,0
RO,CO,2010.0,1,1,0
GB,JE,2010.0,1,1,0
JE,AU,2020.0,1,1,0
PS,QA,2021.0,1,1,0
TR,PH,2008.0,2,2,0
BJ,GF,2017.0,1,2,-1
PS,IT,2018.0,1,3,-2
KZ,CA,2008.0,1,1,0
ST,PT,2002.0,2,1,1
SK,QA,2014.0,2,2,0
TR,GH,2022.0,1,2,-1
FR,MK,2007.0,1,1,0
SA,HU,2023.0,1,1,0
NC,CG,2017.0,1,1,0
US,ME,2010.0,3,1,2
DE,BJ,2010.0,1,2,-1
QA,BH,2021.0,1,1,0
IT,VE,2004.0,1,4,-3
IN,LB,2017.0,4,8,-4
IS,NO,1999.0,2,2,0
CN,JO,2007.0,1,5,-4
CO,ZA,2021.0,1,3,-2
PT,LU,2011.0,1,1,0
FR,CD,2011.0,1,1,0
AE,CN,2021.0,4,7,-3
IT,BO,2009.0,1,1,0
RU,CL,2006.0,1,6,-5
PK,KW,1999.0,1,2,-1
PT,GR,2008.0,1,1,0
GR,UY,2006.0,1,1,0
CW,BE,2009.0,2,3,-1
BR,PY,2008.0,3,3,0
MX,IE,2002.0,1,1,0
MD,RO,2005.0,1,1,0
TH,NZ,2005.0,1,4,-3
JO,PK,2014.0,1,1,0
AZ,SE,2017.0,1,1,0
CA,GF,2020.0,1,1,0
AU,LV,2014.0,1,1,0
BD,NG,2018.0,1,2,-1
GR,AT,2009.0,2,5,-3
AR,LU,2017.0,1,1,0
US,XK,2009.0,1,2,-1
KR,GR,2012.0,1,2,-1
NG,NA,2016.0,1,1,0
HK,GB,2008.0,2,1,1
XK,DE,2014.0,1,3,-2
BW,CA,2006.0,1,3,-2
KW,NL,2017.0,2,1,1
BR,IN,1998.0,2,6,-4
PL,ES,2023.0,3,1,2
MA,BR,2010.0,1,3,-2
ES,FI,2023.0,1,2,-1
CO,SV,2006.0,1,1,0
MY,TZ,2013.0,1,2,-1
CO,IL,2012.0,1,1,0
DE,VE,2010.0,1,3,-2
PS,IL,2012.0,1,5,-4
LK,MY,2016.0,4,4,0
NO,BE,2000.0,1,8,-7
NZ,FJ,2001.0,1,1,0
BW,GH,2016.0,2,1,1
NL,KZ,2021.0,1,1,0
IL,CH,2023.0,1,1,0
CA,BH,2021.0,2,2,0
FR,KR,2023.0,1,1,0
CD,CI,2021.0,1,1,0
SI,AU,2023.0,1,1,0
HK,KR,2019.0,1,2,-1
MD,GR,2019.0,1,1,0
NC,CG,2019.0,1,2,-1
PL,NZ,2018.0,2,1,1
NP,DE,2001.0,1,1,0
FR,IE,2023.0,1,4,-3
BO,VE,2012.0,1,2,-1
ZW,UG,2017.0,1,1,0
PT,SG,2019.0,2,3,-1
SA,KW,1998.0,1,1,0
NL,VE,2018.0,2,3,-1
NI,SE,2012.0,1,2,-1
AE,TW,2015.0,1,3,-2
MZ,SE,2016.0,1,2,-1
VN,PL,2013.0,1,1,0
MC,IT,2009.0,1,3,-2
BA,ME,2021.0,1,1,0
CA,JM,2006.0,1,1,0
PS,TR,2011.0,2,4,-2
TH,IL,2010.0,1,2,-1
AU,KH,2004.0,1,1,0
RO,SI,2016.0,1,1,0
BR,CR,1998.0,1,3,-2
AE,MX,2019.0,1,1,0
SA,NL,2003.0,1,3,-2
SA,MY,2000.0,1,1,0
PS,CA,2021.0,1,1,0
AE,BH,2022.0,1,2,-1
CR,CL,2001.0,1,6,-5
BH,RU,2017.0,1,1,0
SE,PA,2017.0,1,1,0
CA,ML,2014.0,1,1,0
DE,PA,1999.0,1,1,0
SG,KZ,2014.0,1,1,0
FR,JO,2015.0,1,6,-5
LT,SE,2014.0,1,3,-2
PL,CO,2003.0,1,1,0
HU,EG,2004.0,2,1,1
SG,NL,2003.0,1,4,-3
BE,CM,2006.0,1,1,0
SE,AE,2011.0,1,1,0
XK,ES,2021.0,1,1,0
BD,AR,2018.0,1,1,0
JP,SD,2016.0,1,2,-1
PL,KZ,2011.0,1,2,-1
TR,RO,2005.0,1,3,-2
DE,LB,2001.0,1,1,0
SN,MQ,2019.0,1,1,0
SE,VN,2022.0,1,2,-1
NG,IT,2022.0,1,5,-4
BG,IE,2014.0,1,1,0
US,BI,2012.0,4,2,2
KR,AT,1999.0,1,2,-1
KH,AT,2019.0,1,1,0
US,BZ,2021.0,2,1,1
HU,QA,2020.0,1,1,0
MX,NI,2009.0,1,3,-2
FR,ML,2000.0,1,1,0
CN,PS,2022.0,1,1,0
RO,nan,2015.0,1,2,-1
FR,ET,2003.0,2,1,1
SN,CM,2014.0,3,3,0
GB,BB,2006.0,1,3,-2
DK,TH,2007.0,2,1,1
CA,BY,2019.0,1,1,0
MM,JP,2012.0,2,1,1
HU,HR,2011.0,1,2,-1
KH,CN,2015.0,1,1,0
LV,KR,2013.0,1,1,0
IQ,AU,2011.0,2,1,1
MY,AU,2023.0,1,6,-5
EE,HR,2005.0,1,0,1
LK,AE,2015.0,1,0,1
FI,OM,2010.0,2,0,2
JP,EC,2013.0,2,0,2
EE,ID,2013.0,2,0,2
AT,IS,2003.0,1,0,1
NO,PA,2017.0,1,0,1
GR,TH,2013.0,1,0,1
KW,CY,2016.0,1,0,1
NG,BE,1999.0,1,0,1
TH,AM,2006.0,1,0,1
TZ,FI,2018.0,1,0,1
TH,IL,2019.0,1,0,1
GR,MX,1999.0,1,0,1
NC,MX,2014.0,1,0,1
AU,LU,2008.0,1,0,1
MG,SN,2022.0,1,0,1
LU,SG,2005.0,1,0,1
JP,AF,2009.0,1,0,1
BH,IQ,2014.0,1,0,1
PE,SV,2017.0,2,0,2
NG,SL,2011.0,1,0,1
AO,JP,2002.0,1,0,1
,GD,2003.0,1,0,1
PK,BH,2010.0,1,0,1
SE,BY,2011.0,1,0,1
,BT,2006.0,2,0,2
JO,DZ,2023.0,1,0,1
PK,UZ,2020.0,1,0,1
FR,LI,2013.0,1,0,1
IQ,AF,2017.0,1,0,1
YE,UY,2019.0,1,0,1
IR,TT,2020.0,1,0,1
ES,LB,2012.0,2,0,2
BY,FI,2000.0,1,0,1
ZA,RW,2011.0,1,0,1
AM,AE,2013.0,1,0,1
SE,CU,2012.0,1,0,1
KN,NZ,2018.0,2,0,2
CL,HN,2000.0,1,0,1
DZ,CD,2019.0,1,0,1
KG,UA,2022.0,1,0,1
BN,SG,2014.0,1,0,1
NZ,RS,2010.0,2,0,2
LU,ML,2017.0,1,0,1
AU,PS,2017.0,1,0,1
SA,PE,2020.0,1,0,1
CO,PL,2004.0,1,0,1
,BZ,1997.0,1,0,1
MM,ET,2019.0,2,0,2
FI,GL,2010.0,1,0,1
HK,PT,2013.0,1,0,1
FO,US,2021.0,1,0,1
MA,QA,2012.0,1,0,1
CH,GP,2018.0,1,0,1
ZW,SZ,2003.0,1,0,1
US,SC,2019.0,1,0,1
SN,AE,2020.0,1,0,1
CA,NE,2012.0,1,0,1
IN,SL,2020.0,1,0,1
MX,CA,2023.0,1,0,1
NI,CA,2019.0,1,0,1
DZ,SK,2020.0,1,0,1
KW,CN,2013.0,1,0,1
CH,VN,2010.0,2,0,2
LB,QA,2009.0,2,0,2
CD,CM,2004.0,1,0,1
SG,TT,2007.0,1,0,1
TZ,MD,2010.0,1,0,1
FI,UY,2004.0,1,0,1
NL,TW,1997.0,1,0,1
FR,BA,1998.0,1,0,1
BN,PK,2016.0,2,0,2
CO,CF,2019.0,1,0,1
ID,KE,2006.0,2,0,2
KE,MA,2004.0,1,0,1
,TM,2018.0,1,0,1
KR,RO,2018.0,2,0,2
LY,CN,2014.0,1,0,1
ID,BF,2018.0,1,0,1
SI,ZW,2014.0,1,0,1
PL,TN,2020.0,2,0,2
DK,NP,2021.0,1,0,1
SN,GM,2003.0,1,0,1
MD,BF,2021.0,1,0,1
LY,GY,2008.0,1,0,1
TR,PG,2006.0,1,0,1
ES,UG,2005.0,1,0,1
PF,GB,2006.0,1,0,1
FI,CY,2016.0,1,0,1
PL,IR,2004.0,1,0,1
IR,CO,2012.0,1,0,1
PK,BH,2017.0,2,0,2
LU,SE,2020.0,1,0,1
MX,QA,2020.0,1,0,1
SM,,2013.0,2,0,2
PS,HU,2021.0,1,0,1
EE,CO,2021.0,1,0,1
EG,SG,2013.0,1,0,1
CN,AO,2006.0,1,0,1
BR,YE,2013.0,1,0,1
BD,NZ,2003.0,1,0,1
RO,DK,2001.0,1,0,1
PK,SL,2022.0,1,0,1
MU,TH,2020.0,2,0,2
OM,BG,2010.0,1,0,1
TG,SY,2013.0,1,0,1
IE,MN,2014.0,1,0,1
NZ,ZW,2013.0,2,0,2
JP,BH,2011.0,1,0,1
RO,TG,2014.0,1,0,1
NZ,RU,2008.0,1,0,1
RU,OM,2002.0,1,0,1
UG,NZ,2000.0,1,0,1
NG,TG,2020.0,2,0,2
DE,BJ,2017.0,1,0,1
US,HT,2000.0,1,0,1
UZ,ZA,2013.0,1,0,1
BF,CG,2005.0,1,0,1
PG,UG,2011.0,1,0,1
BM,US,2021.0,1,0,1
LI,US,2008.0,1,0,1
KW,SG,2002.0,1,0,1
NP,MY,2008.0,1,0,1
PF,NC,2015.0,1,0,1
AZ,PL,2020.0,1,0,1
PA,FI,2019.0,1,0,1
AZ,ES,2008.0,1,0,1
FR,BY,1998.0,1,0,1
IE,SD,2014.0,2,0,2
CF,MZ,2017.0,1,0,1
AE,UZ,2022.0,1,0,1
CU,UY,2009.0,2,0,2
NL,MM,2020.0,1,0,1
TT,ET,2013.0,1,0,1
CZ,BE,2023.0,1,0,1
NO,MY,2000.0,1,0,1
QA,nan,2012.0,1,0,1
,GL,1995.0,2,0,2
PK,KZ,2012.0,1,0,1
AR,RE,2016.0,1,0,1
BF,DK,2004.0,1,0,1
SE,TJ,2015.0,1,0,1
HT,FR,2003.0,1,0,1
UA,ZA,2009.0,1,0,1
AF,TH,2020.0,1,0,1
MK,BE,2019.0,2,0,2
CZ,PK,2008.0,1,0,1
XK,SE,2018.0,1,0,1
RE,BE,2015.0,1,0,1
AT,CU,2007.0,1,0,1
TN,IR,2002.0,1,0,1
MY,AM,2006.0,1,0,1
BE,PS,2005.0,1,0,1
UG,LB,2016.0,1,0,1
ID,KZ,2021.0,2,0,2
CN,BI,2019.0,1,0,1
AM,DK,2017.0,1,0,1
UA,GR,2008.0,1,0,1
WS,MA,2019.0,1,0,1
NG,LU,2011.0,1,0,1
TW,BF,2022.0,1,0,1
KW,BG,2009.0,1,0,1
nan,MW,2018.0,1,0,1
MZ,NO,2017.0,1,0,1
CO,CM,2011.0,1,0,1
NG,PS,2013.0,1,0,1
TR,LU,2019.0,1,0,1
UY,IN,2020.0,1,0,1
DZ,AU,2020.0,1,0,1
MT,BO,2017.0,1,0,1
PT,CY,2023.0,1,0,1
PE,GH,2006.0,1,0,1
MY,AT,2018.0,1,0,1
TR,GE,2019.0,2,0,2
KW,NL,2010.0,1,0,1
CI,IN,2005.0,1,0,1
ES,UG,2002.0,1,0,1
NZ,SD,2014.0,1,0,1
RS,MT,2017.0,1,0,1
CL,FJ,2020.0,1,0,1
HR,KW,2020.0,1,0,1
HU,nan,2022.0,1,0,1
BR,GE,2017.0,1,0,1
YE,GB,2022.0,2,0,2
GN,ZA,2009.0,1,0,1
KW,RS,2002.0,2,0,2
CD,BD,2019.0,1,0,1
VE,JP,2009.0,1,0,1
KH,PH,2016.0,1,0,1
,GW,2014.0,2,0,2
BS,GB,2001.0,1,0,1
SY,IR,2009.0,1,0,1
CI,LV,2015.0,1,0,1
KR,KW,1999.0,1,0,1
PH,PL,2021.0,1,0,1
AM,GB,2010.0,2,0,2
BD,HR,2007.0,1,0,1
CU,DK,2002.0,1,0,1
TW,BD,2010.0,2,0,2
KZ,NZ,2021.0,1,0,1
SG,OM,2021.0,1,0,1
ZM,TH,2006.0,1,0,1
SE,BG,2022.0,1,0,1
NI,VE,2016.0,1,0,1
PK,ES,2002.0,1,0,1
RE,,1998.0,1,0,1
GT,CH,2003.0,1,0,1
TJ,TR,2021.0,1,0,1
BA,EG,2021.0,1,0,1
PL,PE,2023.0,1,0,1
TZ,NG,2014.0,1,0,1
IQ,LY,2022.0,1,0,1
,TD,2003.0,1,0,1
BJ,MA,2005.0,1,0,1
RW,UG,2010.0,1,0,1
,MS,2018.0,1,0,1
OM,FR,2022.0,1,0,1
SR,ID,2021.0,1,0,1
TH,BT,2022.0,1,0,1
BE,LK,2017.0,1,0,1
TD,FR,2003.0,1,0,1
