year,countrycode,padded_population_of_researchers,paddedpop,number_of_inmigrations,number_of_outmigrations,netmigration,outmigrationrate,inmigrationrate,netmigrationrate
2006.0,AD,1,1,0,0,0,0.0,0.0,0.0
2011.0,AD,4,4,0,0,0,0.0,0.0,0.0
2013.0,AD,11,11,5,0,5,0.0,0.45454547,0.45454547
2014.0,AD,13,13,3,1,2,0.07692308,0.23076923,0.15384616
2015.0,AD,13,13,0,2,-2,0.15384616,0.0,-0.15384616
2017.0,AD,18,18,4,0,4,0.0,0.22222222,0.22222222
2019.0,AD,14,14,4,2,2,0.14285715,0.2857143,0.14285715
1996.0,AE,451,451,0,0,0,0.0,0.0,0.0
1997.0,AE,525,525,17,13,4,0.024761904,0.032380953,0.0076190475
1998.0,AE,593,593,24,29,-5,0.04890388,0.040472176,-0.008431703
1999.0,AE,643,643,63,44,19,0.06842924,0.09797823,0.02954899
2000.0,AE,685,685,57,31,26,0.045255475,0.083211675,0.037956204
2001.0,AE,767,767,80,46,34,0.059973925,0.10430248,0.04432855
2002.0,AE,863,863,80,47,33,0.05446118,0.092699885,0.0382387
2003.0,AE,965,965,88,40,48,0.041450776,0.09119171,0.049740933
2004.0,AE,1090,1090,123,69,54,0.063302755,0.112844035,0.049541283
2005.0,AE,1201,1201,109,71,38,0.059117403,0.090757705,0.0316403
2006.0,AE,1353,1353,118,79,39,0.058388766,0.0872136,0.028824834
2007.0,AE,1551,1551,165,103,62,0.06640877,0.10638298,0.03997421
2008.0,AE,1818,1818,186,96,90,0.052805282,0.10231023,0.04950495
2009.0,AE,2076,2076,208,130,78,0.062620424,0.10019268,0.037572253
2010.0,AE,2404,2404,237,149,88,0.06198003,0.09858569,0.036605656
2011.0,AE,2797,2797,287,154,133,0.055058993,0.10260994,0.047550946
2012.0,AE,3262,3262,349,213,136,0.065297365,0.10698958,0.041692212
2013.0,AE,3805,3805,412,235,177,0.061760843,0.10827858,0.04651774
2014.0,AE,4301,4301,448,281,167,0.06533364,0.10416182,0.03882818
2015.0,AE,4843,4843,527,355,172,0.07330167,0.10881685,0.035515178
2016.0,AE,5382,5382,602,408,194,0.07580825,0.11185433,0.03604608
2017.0,AE,5946,5946,632,427,205,0.07181298,0.106289946,0.03447696
2018.0,AE,6567,6567,755,518,237,0.078879245,0.114968784,0.03608954
2019.0,AE,7174,7174,888,567,321,0.07903541,0.12378032,0.044744913
2020.0,AE,7255,7255,790,590,200,0.08132323,0.10889042,0.027567195
2021.0,AE,7064,7064,634,455,179,0.0644111,0.08975085,0.02533975
2022.0,AE,0,0,525,353,172,,,
1996.0,AF,6,6,0,0,0,0.0,0.0,0.0
1997.0,AF,9,9,2,1,1,0.11111111,0.22222222,0.11111111
1998.0,AF,7,7,0,2,-2,0.2857143,0.0,-0.2857143
1999.0,AF,8,8,1,0,1,0.0,0.125,0.125
2001.0,AF,8,8,0,1,-1,0.125,0.0,-0.125
2002.0,AF,9,9,1,0,1,0.0,0.11111111,0.11111111
2003.0,AF,14,14,3,2,1,0.14285715,0.21428572,0.071428575
2004.0,AF,16,16,2,1,1,0.0625,0.125,0.0625
2005.0,AF,24,24,5,2,3,0.083333336,0.20833333,0.125
2006.0,AF,30,30,5,6,-1,0.2,0.16666667,-0.033333335
2007.0,AF,34,34,3,6,-3,0.1764706,0.0882353,-0.0882353
2008.0,AF,35,35,6,8,-2,0.22857143,0.17142858,-0.057142857
2009.0,AF,50,50,9,5,4,0.1,0.18,0.08
2010.0,AF,63,63,11,6,5,0.0952381,0.17460318,0.07936508
2011.0,AF,78,78,14,8,6,0.102564104,0.17948718,0.07692308
2012.0,AF,88,88,10,9,1,0.10227273,0.11363637,0.011363637
2013.0,AF,94,94,6,7,-1,0.07446808,0.06382979,-0.010638298
2014.0,AF,114,114,11,9,2,0.078947365,0.096491225,0.01754386
2015.0,AF,123,123,14,16,-2,0.1300813,0.11382114,-0.016260162
2016.0,AF,150,150,21,13,8,0.086666666,0.14,0.053333335
2017.0,AF,179,179,25,19,6,0.10614525,0.1396648,0.033519555
2018.0,AF,222,222,35,24,11,0.10810811,0.15765765,0.04954955
2019.0,AF,286,286,55,22,33,0.07692308,0.1923077,0.115384616
2020.0,AF,313,313,61,34,27,0.1086262,0.19488817,0.08626198
2021.0,AF,309,309,37,32,5,0.103559874,0.1197411,0.01618123
2022.0,AF,0,0,32,18,14,,,
1996.0,AG,17,17,0,0,0,0.0,0.0,0.0
1997.0,AG,17,17,1,3,-2,0.1764706,0.05882353,-0.11764706
1998.0,AG,20,20,2,4,-2,0.2,0.1,-0.1
1999.0,AG,16,16,1,0,1,0.0,0.0625,0.0625
2000.0,AG,12,12,0,5,-5,0.41666666,0.0,-0.41666666
2004.0,AG,4,4,0,1,-1,0.25,0.0,-0.25
2006.0,AG,7,7,2,1,1,0.14285715,0.2857143,0.14285715
2008.0,AG,6,6,0,1,-1,0.16666667,0.0,-0.16666667
2011.0,AG,6,6,1,2,-1,0.33333334,0.16666667,-0.16666667
2014.0,AG,31,31,8,1,7,0.032258064,0.2580645,0.22580644
2015.0,AG,69,69,17,0,17,0.0,0.24637681,0.24637681
2016.0,AG,148,148,45,7,38,0.0472973,0.30405405,0.25675675
2017.0,AG,379,379,189,12,177,0.03166227,0.49868074,0.46701846
2018.0,AG,697,697,309,49,260,0.070301294,0.44332856,0.37302727
2019.0,AG,957,957,343,138,205,0.14420062,0.3584117,0.21421108
2020.0,AG,1168,1168,380,163,217,0.1395548,0.32534248,0.18578768
2021.0,AG,1258,1258,385,248,137,0.19713831,0.30604133,0.10890302
2022.0,AG,0,0,280,218,62,,,
1996.0,AL,45,45,0,0,0,0.0,0.0,0.0
1997.0,AL,65,65,1,0,1,0.0,0.015384615,0.015384615
1998.0,AL,83,83,4,2,2,0.024096385,0.04819277,0.024096385
1999.0,AL,87,87,1,2,-1,0.022988506,0.011494253,-0.011494253
2000.0,AL,101,101,2,2,0,0.01980198,0.01980198,0.0
2001.0,AL,104,104,3,4,-1,0.03846154,0.028846154,-0.009615385
2002.0,AL,110,110,5,4,1,0.036363635,0.045454547,0.009090909
2003.0,AL,124,124,8,5,3,0.04032258,0.06451613,0.024193548
2004.0,AL,126,126,5,7,-2,0.055555556,0.03968254,-0.015873017
2005.0,AL,161,161,5,4,1,0.024844721,0.031055901,0.0062111802
2006.0,AL,196,196,7,8,-1,0.040816326,0.035714287,-0.0051020407
2007.0,AL,264,264,11,5,6,0.018939395,0.041666668,0.022727273
2008.0,AL,339,339,11,8,3,0.02359882,0.032448377,0.0088495575
2009.0,AL,434,434,18,10,8,0.023041476,0.041474655,0.01843318
2010.0,AL,567,567,23,12,11,0.02116402,0.040564373,0.019400353
2011.0,AL,848,848,27,19,8,0.02240566,0.031839624,0.009433962
2012.0,AL,1022,1022,28,11,17,0.010763209,0.02739726,0.01663405
2013.0,AL,1155,1155,33,23,10,0.01991342,0.028571429,0.008658009
2014.0,AL,1213,1213,19,32,-13,0.026380874,0.015663644,-0.01071723
2015.0,AL,1262,1262,43,32,11,0.025356578,0.0340729,0.008716323
2016.0,AL,1220,1220,31,32,-1,0.026229508,0.025409836,-0.00081967213
2017.0,AL,1161,1161,37,36,1,0.031007752,0.03186908,0.00086132647
2018.0,AL,1123,1123,45,51,-6,0.045414068,0.040071238,-0.005342832
2019.0,AL,1144,1144,43,44,-1,0.03846154,0.03758741,-0.00087412586
2020.0,AL,1099,1099,31,31,0,0.02820746,0.02820746,0.0
2021.0,AL,998,998,25,17,8,0.017034069,0.0250501,0.008016032
1996.0,AM,539,539,0,0,0,0.0,0.0,0.0
1997.0,AM,626,626,13,34,-21,0.0543131,0.020766772,-0.033546325
1998.0,AM,776,776,15,52,-37,0.067010306,0.019329896,-0.04768041
1999.0,AM,894,894,28,25,3,0.027964206,0.03131991,0.0033557047
2000.0,AM,1005,1005,29,26,3,0.025870647,0.02885572,0.0029850747
2001.0,AM,1092,1092,30,37,-7,0.033882786,0.027472528,-0.0064102565
2002.0,AM,1173,1173,36,39,-3,0.03324808,0.030690538,-0.0025575447
2003.0,AM,1250,1250,49,31,18,0.0248,0.0392,0.0144
2004.0,AM,1299,1299,57,49,8,0.037721325,0.043879908,0.0061585833
2005.0,AM,1418,1418,50,44,6,0.03102962,0.03526093,0.004231312
2006.0,AM,1476,1476,53,73,-20,0.049457993,0.03590786,-0.013550135
2007.0,AM,1543,1543,64,67,-3,0.043421905,0.04147764,-0.0019442644
2008.0,AM,1595,1595,51,72,-21,0.045141067,0.031974923,-0.0131661445
2009.0,AM,1590,1590,49,100,-51,0.062893085,0.03081761,-0.032075472
2010.0,AM,1623,1623,50,85,-35,0.05237215,0.030807147,-0.021565003
2011.0,AM,1686,1686,71,72,-1,0.042704627,0.042111505,-0.0005931198
2012.0,AM,1778,1778,80,78,2,0.043869518,0.044994377,0.0011248594
2013.0,AM,1809,1809,57,89,-32,0.049198452,0.03150912,-0.01768933
2014.0,AM,1855,1855,64,89,-25,0.04797844,0.034501348,-0.013477089
2015.0,AM,1905,1905,68,91,-23,0.04776903,0.035695538,-0.012073491
2016.0,AM,1964,1964,77,83,-6,0.04226069,0.039205704,-0.0030549897
2017.0,AM,2046,2046,65,94,-29,0.045943305,0.031769305,-0.0141739985
2018.0,AM,2147,2147,100,99,1,0.046110854,0.04657662,0.00046576618
2019.0,AM,2184,2184,100,114,-14,0.052197803,0.045787547,-0.0064102565
2020.0,AM,2105,2105,95,97,-2,0.04608076,0.04513064,-0.00095011876
2021.0,AM,1920,1920,85,97,-12,0.050520834,0.044270832,-0.00625
2022.0,AM,0,0,60,59,1,,,
1996.0,AO,35,35,0,0,0,0.0,0.0,0.0
1997.0,AO,38,38,2,3,-1,0.078947365,0.05263158,-0.02631579
1998.0,AO,49,49,5,5,0,0.10204082,0.10204082,0.0
1999.0,AO,52,52,3,8,-5,0.15384616,0.057692308,-0.09615385
2000.0,AO,71,71,14,5,9,0.07042254,0.1971831,0.12676056
2001.0,AO,74,74,9,10,-1,0.13513513,0.12162162,-0.013513514
2002.0,AO,93,93,12,10,2,0.10752688,0.12903225,0.021505376
2003.0,AO,115,115,22,15,7,0.13043478,0.19130434,0.060869563
2004.0,AO,130,130,23,14,9,0.10769231,0.17692308,0.06923077
2005.0,AO,129,129,17,25,-8,0.19379845,0.13178295,-0.062015504
2006.0,AO,127,127,15,20,-5,0.15748031,0.11811024,-0.03937008
2007.0,AO,123,123,17,25,-8,0.20325203,0.13821138,-0.06504065
2008.0,AO,140,140,21,23,-2,0.16428572,0.15,-0.014285714
2009.0,AO,137,137,22,31,-9,0.22627737,0.16058394,-0.06569343
2010.0,AO,152,152,23,16,7,0.10526316,0.1513158,0.04605263
2011.0,AO,172,172,28,29,-1,0.16860466,0.1627907,-0.0058139535
2012.0,AO,193,193,28,36,-8,0.1865285,0.14507772,-0.041450776
2013.0,AO,207,207,40,39,1,0.1884058,0.19323671,0.004830918
2014.0,AO,227,227,43,29,14,0.1277533,0.18942732,0.06167401
2015.0,AO,227,227,48,45,3,0.19823788,0.21145375,0.013215859
2016.0,AO,213,213,30,52,-22,0.24413146,0.14084508,-0.103286386
2017.0,AO,215,215,30,43,-13,0.2,0.13953489,-0.060465116
2018.0,AO,262,262,56,38,18,0.14503817,0.21374045,0.06870229
2019.0,AO,285,285,57,41,16,0.14385965,0.2,0.056140352
2020.0,AO,309,309,65,39,26,0.1262136,0.21035598,0.084142394
2021.0,AO,298,298,58,47,11,0.15771812,0.19463088,0.03691275
1996.0,AR,8121,8121,0,0,0,0.0,0.0,0.0
1997.0,AR,9846,9846,232,215,17,0.021836279,0.023562869,0.0017265895
1998.0,AR,11617,11617,278,331,-53,0.028492726,0.023930447,-0.004562279
1999.0,AR,12578,12578,346,396,-50,0.031483542,0.027508348,-0.003975195
2000.0,AR,13610,13610,374,459,-85,0.033725202,0.027479794,-0.0062454077
2001.0,AR,14762,14762,445,519,-74,0.035157837,0.030144967,-0.0050128708
2002.0,AR,16028,16028,497,571,-74,0.035625156,0.031008236,-0.0046169204
2003.0,AR,17231,17231,580,706,-126,0.040972665,0.033660263,-0.007312402
2004.0,AR,18619,18619,619,781,-162,0.0419464,0.03324561,-0.00870079
2005.0,AR,20181,20181,745,788,-43,0.039046627,0.03691591,-0.002130717
2006.0,AR,21733,21733,842,875,-33,0.040261354,0.038742926,-0.0015184282
2007.0,AR,23392,23392,940,1013,-73,0.043305404,0.04018468,-0.003120725
2008.0,AR,25261,25261,1022,1047,-25,0.04144729,0.04045762,-0.0009896678
2009.0,AR,27365,27365,1149,1100,49,0.04019733,0.04198794,0.0017906084
2010.0,AR,29480,29480,1322,1170,152,0.039687924,0.04484396,0.005156038
2011.0,AR,31727,31727,1426,1338,88,0.042172283,0.044945944,0.0027736628
2012.0,AR,33316,33316,1543,1526,17,0.04580382,0.046314083,0.00051026535
2013.0,AR,34758,34758,1544,1653,-109,0.0475574,0.044421427,-0.0031359687
2014.0,AR,36401,36401,1757,1731,26,0.04755364,0.048267905,0.0007142661
2015.0,AR,37868,37868,1754,1732,22,0.045737825,0.04631879,0.0005809655
2016.0,AR,39138,39138,1964,1813,151,0.046323266,0.05018141,0.003858143
2017.0,AR,40041,40041,1942,1992,-50,0.049749006,0.04850029,-0.0012487201
2018.0,AR,41053,41053,2185,2092,93,0.050958518,0.053223882,0.0022653644
2019.0,AR,40841,40841,2255,2322,-67,0.05685463,0.055214122,-0.0016405083
2020.0,AR,39072,39072,1901,2004,-103,0.051289927,0.048653767,-0.0026361588
2021.0,AR,35909,35909,1426,1667,-241,0.046422902,0.039711494,-0.0067114094
2022.0,AR,0,0,862,920,-58,,,
1996.0,AT,10135,10135,0,0,0,0.0,0.0,0.0
1997.0,AT,11791,11791,353,409,-56,0.034687474,0.029938089,-0.004749385
1998.0,AT,13475,13475,481,487,-6,0.036141,0.03569573,-0.00044526902
1999.0,AT,14352,14352,558,570,-12,0.03971572,0.0388796,-0.0008361204
2000.0,AT,15143,15143,591,637,-46,0.04206564,0.039027933,-0.0030377072
2001.0,AT,16135,16135,691,627,64,0.03885962,0.042826153,0.003966532
2002.0,AT,17128,17128,734,716,18,0.041802894,0.042853806,0.0010509108
2003.0,AT,18257,18257,811,724,87,0.03965602,0.04442132,0.0047652954
2004.0,AT,19347,19347,869,860,9,0.044451337,0.044916525,0.0004651884
2005.0,AT,20679,20679,964,875,89,0.042313457,0.04661734,0.0043038833
2006.0,AT,22040,22040,945,962,-17,0.04364791,0.042876586,-0.00077132485
2007.0,AT,23612,23612,1015,1021,-6,0.043240726,0.042986616,-0.00025410808
2008.0,AT,25235,25235,1183,1059,124,0.041965526,0.046879333,0.00491381
2009.0,AT,26631,26631,1200,1307,-107,0.04907814,0.04506027,-0.004017874
2010.0,AT,28106,28106,1360,1299,61,0.04621789,0.048388243,0.002170355
2011.0,AT,29494,29494,1484,1388,96,0.04706042,0.050315317,0.0032548993
2012.0,AT,30830,30830,1504,1541,-37,0.04998378,0.048783652,-0.0012001297
2013.0,AT,32245,32245,1696,1570,126,0.04868972,0.052597303,0.0039075827
2014.0,AT,33759,33759,1857,1613,244,0.04777985,0.055007555,0.007227702
2015.0,AT,34958,34958,1817,1770,47,0.050632186,0.05197666,0.0013444705
2016.0,AT,35887,35887,1909,1851,58,0.051578566,0.05319475,0.0016161841
2017.0,AT,36813,36813,2043,1869,174,0.050770108,0.0554967,0.004726591
2018.0,AT,37824,37824,2141,1980,161,0.052347716,0.056604274,0.0042565567
2019.0,AT,38098,38098,2279,2065,214,0.054202322,0.05981941,0.005617093
2020.0,AT,36582,36582,2094,1994,100,0.05450768,0.057241265,0.0027335847
2021.0,AT,34209,34209,1632,1475,157,0.043117307,0.047706746,0.0045894356
2022.0,AT,0,0,1161,1001,160,,,
1996.0,AU,31983,31983,0,0,0,0.0,0.0,0.0
1997.0,AU,37910,37910,1684,1530,154,0.040358745,0.044421,0.0040622526
1998.0,AU,43477,43477,2138,2037,101,0.046852358,0.049175426,0.0023230673
1999.0,AU,45971,45971,2495,2408,87,0.05238085,0.054273345,0.0018924974
2000.0,AU,48205,48205,2565,2535,30,0.052587904,0.053210247,0.0006223421
2001.0,AU,50374,50374,2772,2936,-164,0.058284037,0.055028386,-0.0032556478
2002.0,AU,52733,52733,2933,3113,-180,0.05903324,0.05561982,-0.0034134223
2003.0,AU,55881,55881,3320,3285,35,0.058785632,0.059411965,0.00062633096
2004.0,AU,59790,59790,3707,3553,154,0.059424654,0.062000334,0.0025756815
2005.0,AU,64045,64045,3969,3667,302,0.057256617,0.06197205,0.0047154343
2006.0,AU,68837,68837,4539,3946,593,0.057323825,0.065938376,0.008614553
2007.0,AU,73700,73700,4721,4410,311,0.059837177,0.064056985,0.00421981
2008.0,AU,78838,78838,5268,4692,576,0.059514448,0.06682057,0.0073061213
2009.0,AU,84028,84028,5584,4812,772,0.057266627,0.06645404,0.009187413
2010.0,AU,89010,89010,5986,5409,577,0.06076845,0.06725087,0.0064824177
2011.0,AU,94753,94753,6623,5712,911,0.06028305,0.069897525,0.009614471
2012.0,AU,100802,100802,6938,5866,1072,0.05819329,0.068828,0.01063471
2013.0,AU,106537,106537,7458,6072,1386,0.056994285,0.070003845,0.013009565
2014.0,AU,111971,111971,7790,6767,1023,0.06043529,0.069571584,0.009136294
2015.0,AU,117170,117170,8156,7173,983,0.061218742,0.06960826,0.0083895195
2016.0,AU,120594,120594,8249,7678,571,0.06366818,0.06840307,0.0047348957
2017.0,AU,123796,123796,8349,7936,413,0.064105466,0.0674416,0.0033361337
2018.0,AU,126190,126190,8808,8547,261,0.0677312,0.069799505,0.0020683096
2019.0,AU,127728,127728,9296,8453,843,0.06617969,0.072779655,0.0065999622
2020.0,AU,123655,123655,8515,8195,320,0.0662731,0.06886094,0.0025878453
2021.0,AU,116024,116024,6328,6339,-11,0.05463525,0.05454044,-9.480797e-05
2022.0,AU,0,0,4813,4574,239,,,
2010.0,AW,1,1,0,0,0,0.0,0.0,0.0
2017.0,AW,5,5,2,1,1,0.2,0.4,0.2
2018.0,AW,3,3,0,2,-2,0.6666667,0.0,-0.6666667
2011.0,AX,5,5,2,0,2,0.0,0.4,0.4
1996.0,AZ,187,187,0,0,0,0.0,0.0,0.0
1997.0,AZ,218,218,5,6,-1,0.027522936,0.02293578,-0.0045871558
1998.0,AZ,312,312,7,11,-4,0.035256412,0.022435898,-0.012820513
1999.0,AZ,358,358,10,7,3,0.019553073,0.02793296,0.008379889
2000.0,AZ,408,408,10,15,-5,0.036764707,0.024509804,-0.012254902
2001.0,AZ,481,481,13,10,3,0.02079002,0.027027028,0.0062370063
2002.0,AZ,555,555,18,3,15,0.0054054055,0.032432433,0.027027028
2003.0,AZ,593,593,6,20,-14,0.03372681,0.010118044,-0.023608768
2004.0,AZ,650,650,15,30,-15,0.046153847,0.023076924,-0.023076924
2005.0,AZ,751,751,15,14,1,0.01864181,0.01997337,0.0013315579
2006.0,AZ,867,867,27,24,3,0.027681662,0.031141868,0.0034602077
2007.0,AZ,1029,1029,19,24,-5,0.023323616,0.018464528,-0.0048590866
2008.0,AZ,1179,1179,40,23,17,0.019508058,0.033927057,0.014418999
2009.0,AZ,1319,1319,25,24,1,0.018195603,0.018953754,0.0007581501
2010.0,AZ,1377,1377,38,45,-7,0.03267974,0.027596224,-0.005083515
2011.0,AZ,1460,1460,36,38,-2,0.026027398,0.024657534,-0.001369863
2012.0,AZ,1463,1463,21,56,-35,0.03827751,0.014354067,-0.023923445
2013.0,AZ,1540,1540,50,56,-6,0.036363635,0.032467533,-0.003896104
2014.0,AZ,1582,1582,52,62,-10,0.039190896,0.032869786,-0.0063211126
2015.0,AZ,1677,1677,53,60,-7,0.035778176,0.031604055,-0.0041741203
2016.0,AZ,1801,1801,49,55,-6,0.030538589,0.027207106,-0.0033314824
2017.0,AZ,1924,1924,70,85,-15,0.044178795,0.036382537,-0.0077962577
2018.0,AZ,2084,2084,77,88,-11,0.042226486,0.036948178,-0.0052783107
2019.0,AZ,2112,2112,90,105,-15,0.04971591,0.042613637,-0.007102273
2020.0,AZ,1985,1985,91,108,-17,0.054408062,0.04584383,-0.008564232
2021.0,AZ,1793,1793,78,78,0,0.04350251,0.04350251,0.0
2022.0,AZ,0,0,43,36,7,,,
1996.0,BA,55,55,0,0,0,0.0,0.0,0.0
1997.0,BA,92,92,1,3,-2,0.032608695,0.010869565,-0.02173913
1998.0,BA,137,137,8,0,8,0.0,0.05839416,0.05839416
1999.0,BA,157,157,5,5,0,0.031847134,0.031847134,0.0
2000.0,BA,217,217,5,8,-3,0.03686636,0.023041476,-0.013824885
2001.0,BA,297,297,13,9,4,0.030303031,0.043771043,0.013468013
2002.0,BA,372,372,13,7,6,0.018817205,0.034946237,0.016129032
2003.0,BA,454,454,13,10,3,0.02202643,0.028634362,0.0066079297
2004.0,BA,573,573,26,9,17,0.015706806,0.045375217,0.029668411
2005.0,BA,716,716,21,12,9,0.016759777,0.02932961,0.012569833
2006.0,BA,891,891,31,26,5,0.029180696,0.034792367,0.005611672
2007.0,BA,1057,1057,26,24,2,0.022705771,0.024597919,0.0018921476
2008.0,BA,1236,1236,42,33,9,0.026699029,0.033980582,0.0072815535
2009.0,BA,1448,1448,75,39,36,0.026933702,0.05179558,0.024861878
2010.0,BA,1680,1680,57,54,3,0.03214286,0.033928573,0.0017857143
2011.0,BA,1983,1983,95,51,44,0.025718609,0.04790721,0.022188604
2012.0,BA,2284,2284,93,61,32,0.02670753,0.040718038,0.014010508
2013.0,BA,2513,2513,98,86,12,0.034222044,0.038997214,0.0047751693
2014.0,BA,2719,2719,91,109,-18,0.040088266,0.033468187,-0.006620081
2015.0,BA,2934,2934,112,106,6,0.036128152,0.038173143,0.0020449897
2016.0,BA,3086,3086,151,126,25,0.040829554,0.048930656,0.008101102
2017.0,BA,3247,3247,176,127,49,0.039113026,0.05420388,0.015090853
2018.0,BA,3323,3323,183,162,21,0.048751127,0.05507072,0.006319591
2019.0,BA,3335,3335,179,171,8,0.051274363,0.053673163,0.0023988006
2020.0,BA,3156,3156,149,166,-17,0.052598227,0.047211662,-0.0053865653
2021.0,BA,2843,2843,98,122,-24,0.042912416,0.03447063,-0.008441787
2022.0,BA,0,0,71,75,-4,,,
1996.0,BB,39,39,0,0,0,0.0,0.0,0.0
1997.0,BB,46,46,5,6,-1,0.13043478,0.10869565,-0.02173913
1998.0,BB,55,55,5,3,2,0.054545455,0.09090909,0.036363635
1999.0,BB,57,57,7,4,3,0.07017544,0.12280702,0.05263158
2000.0,BB,67,67,10,4,6,0.05970149,0.14925373,0.08955224
2001.0,BB,70,70,4,8,-4,0.114285715,0.057142857,-0.057142857
2002.0,BB,81,81,3,3,0,0.037037037,0.037037037,0.0
2003.0,BB,86,86,6,5,1,0.058139537,0.069767445,0.011627907
2004.0,BB,87,87,7,7,0,0.08045977,0.08045977,0.0
2005.0,BB,85,85,5,16,-11,0.1882353,0.05882353,-0.12941177
2006.0,BB,92,92,6,10,-4,0.10869565,0.06521739,-0.04347826
2007.0,BB,98,98,6,6,0,0.06122449,0.06122449,0.0
2008.0,BB,97,97,9,13,-4,0.13402061,0.0927835,-0.041237112
2009.0,BB,102,102,10,8,2,0.078431375,0.09803922,0.019607844
2010.0,BB,115,115,18,11,7,0.09565217,0.15652174,0.060869563
2011.0,BB,117,117,15,15,0,0.12820514,0.12820514,0.0
2012.0,BB,127,127,21,20,1,0.15748031,0.16535433,0.007874016
2013.0,BB,135,135,15,16,-1,0.11851852,0.11111111,-0.0074074073
2014.0,BB,132,132,13,20,-7,0.15151516,0.09848485,-0.053030305
2015.0,BB,134,134,17,17,0,0.12686567,0.12686567,0.0
2016.0,BB,136,136,14,12,2,0.0882353,0.10294118,0.014705882
2017.0,BB,135,135,13,11,2,0.08148148,0.096296296,0.014814815
2018.0,BB,136,136,17,15,2,0.11029412,0.125,0.014705882
2019.0,BB,141,141,18,13,5,0.09219858,0.12765957,0.035460994
2020.0,BB,144,144,19,16,3,0.11111111,0.13194445,0.020833334
2021.0,BB,129,129,10,11,-1,0.08527132,0.07751938,-0.007751938
1996.0,BD,567,567,0,0,0,0.0,0.0,0.0
1997.0,BD,712,712,42,35,7,0.049157303,0.058988765,0.009831461
1998.0,BD,863,863,45,57,-12,0.06604867,0.052143686,-0.013904982
1999.0,BD,988,988,68,65,3,0.065789476,0.06882591,0.0030364373
2000.0,BD,1047,1047,61,66,-5,0.06303725,0.0582617,-0.0047755493
2001.0,BD,1163,1163,101,76,25,0.06534824,0.08684437,0.02149613
2002.0,BD,1274,1274,94,108,-14,0.08477237,0.07378336,-0.010989011
2003.0,BD,1422,1422,106,119,-13,0.08368495,0.074542895,-0.009142053
2004.0,BD,1612,1612,125,125,0,0.07754342,0.07754342,0.0
2005.0,BD,2139,2139,176,146,30,0.06825619,0.08228144,0.014025246
2006.0,BD,2841,2841,247,156,91,0.054910243,0.08694122,0.032030974
2007.0,BD,3769,3769,313,197,116,0.052268505,0.0830459,0.030777395
2008.0,BD,4804,4804,384,261,123,0.054329727,0.07993339,0.025603663
2009.0,BD,5679,5679,379,311,68,0.054763164,0.0667371,0.011973939
2010.0,BD,6824,6824,474,398,76,0.058323562,0.06946073,0.011137163
2011.0,BD,8006,8006,557,518,39,0.064701475,0.06957282,0.0048713465
2012.0,BD,8945,8945,633,592,41,0.066182226,0.07076579,0.0045835664
2013.0,BD,9860,9860,659,733,-74,0.07434077,0.0668357,-0.007505071
2014.0,BD,10622,10622,704,809,-105,0.07616268,0.066277534,-0.009885144
2015.0,BD,11143,11143,811,884,-73,0.079332314,0.072781116,-0.006551198
2016.0,BD,11580,11580,839,915,-76,0.079015546,0.07245251,-0.0065630395
2017.0,BD,11905,11905,822,1062,-240,0.08920622,0.06904662,-0.020159597
2018.0,BD,12637,12637,950,1124,-174,0.08894516,0.07517607,-0.013769091
2019.0,BD,13031,13031,1074,1284,-210,0.09853426,0.082418844,-0.016115418
2020.0,BD,12676,12676,1085,1007,78,0.079441465,0.085594825,0.0061533605
2021.0,BD,11901,11901,892,767,125,0.064448364,0.074951686,0.010503319
2022.0,BD,0,0,581,696,-115,,,
1996.0,BE,15551,15551,0,0,0,0.0,0.0,0.0
1997.0,BE,17961,17961,540,598,-58,0.03329436,0.030065142,-0.0032292188
1998.0,BE,20281,20281,675,684,-9,0.03372615,0.033282384,-0.0004437651
1999.0,BE,21396,21396,732,765,-33,0.035754345,0.034212,-0.0015423443
2000.0,BE,22540,22540,740,834,-94,0.037000887,0.032830525,-0.004170364
2001.0,BE,23636,23636,869,899,-30,0.0380352,0.03676595,-0.0012692503
2002.0,BE,24843,24843,922,1104,-182,0.044439077,0.03711307,-0.0073260074
2003.0,BE,26302,26302,991,1103,-112,0.041935973,0.037677743,-0.0042582313
2004.0,BE,27871,27871,1050,1216,-166,0.04362958,0.037673566,-0.005956012
2005.0,BE,29732,29732,1152,1297,-145,0.043623034,0.038746133,-0.0048769005
2006.0,BE,31710,31710,1342,1411,-69,0.044497006,0.042321034,-0.0021759698
2007.0,BE,33829,33829,1469,1421,48,0.04200538,0.043424282,0.0014189009
2008.0,BE,36366,36366,1570,1571,-1,0.043199692,0.043172196,-2.7498212e-05
2009.0,BE,38459,38459,1725,1635,90,0.042512804,0.04485296,0.0023401545
2010.0,BE,40536,40536,1915,1812,103,0.044701006,0.047241956,0.0025409514
2011.0,BE,42515,42515,2124,2026,98,0.04765377,0.049958836,0.0023050688
2012.0,BE,44904,44904,2388,1977,411,0.044027258,0.053180117,0.009152859
2013.0,BE,46173,46173,2438,2213,225,0.04792844,0.05280142,0.0048729777
2014.0,BE,47758,47758,2515,2538,-23,0.053142928,0.052661333,-0.0004815947
2015.0,BE,49166,49166,2626,2661,-35,0.05412277,0.053410895,-0.00071187405
2016.0,BE,50082,50082,2637,2603,34,0.051974762,0.052653648,0.0006788866
2017.0,BE,50766,50766,2749,2725,24,0.05367766,0.054150417,0.00047275735
2018.0,BE,51298,51298,2810,2784,26,0.05427112,0.054777965,0.0005068424
2019.0,BE,51051,51051,2932,2986,-54,0.05849053,0.057432763,-0.0010577658
2020.0,BE,48742,48742,2817,2760,57,0.056624677,0.057794098,0.0011694226
2021.0,BE,45067,45067,2186,2071,115,0.045953803,0.04850556,0.0025517563
2022.0,BE,0,0,1492,1478,14,,,
1996.0,BF,121,121,0,0,0,0.0,0.0,0.0
1997.0,BF,150,150,6,3,3,0.02,0.04,0.02
1998.0,BF,179,179,10,8,2,0.044692736,0.05586592,0.011173184
1999.0,BF,205,205,4,10,-6,0.048780486,0.019512195,-0.029268293
2000.0,BF,227,227,9,9,0,0.039647575,0.039647575,0.0
2001.0,BF,259,259,13,11,2,0.042471044,0.05019305,0.0077220076
2002.0,BF,305,305,13,7,6,0.022950819,0.04262295,0.019672131
2003.0,BF,343,343,15,17,-2,0.04956268,0.04373178,-0.005830904
2004.0,BF,396,396,14,17,-3,0.04292929,0.035353534,-0.007575758
2005.0,BF,458,458,17,15,2,0.03275109,0.037117902,0.0043668123
2006.0,BF,528,528,21,19,2,0.035984848,0.039772727,0.003787879
2007.0,BF,594,594,24,28,-4,0.047138046,0.04040404,-0.0067340066
2008.0,BF,674,674,39,27,12,0.040059347,0.0578635,0.017804155
2009.0,BF,744,744,23,32,-9,0.043010753,0.030913979,-0.012096774
2010.0,BF,841,841,29,26,3,0.030915577,0.03448276,0.003567182
2011.0,BF,926,926,29,31,-2,0.03347732,0.031317495,-0.0021598272
2012.0,BF,1094,1094,53,32,21,0.029250458,0.04844607,0.019195613
2013.0,BF,1196,1196,42,49,-7,0.0409699,0.035117056,-0.0058528427
2014.0,BF,1293,1293,42,49,-7,0.037896365,0.032482598,-0.0054137665
2015.0,BF,1398,1398,63,53,10,0.037911303,0.04506438,0.0071530757
2016.0,BF,1518,1518,70,52,18,0.034255598,0.04611331,0.011857707
2017.0,BF,1581,1581,79,70,9,0.044275776,0.049968373,0.0056926
2018.0,BF,1612,1612,72,66,6,0.04094293,0.044665013,0.0037220845
2019.0,BF,1575,1575,80,96,-16,0.06095238,0.05079365,-0.01015873
2020.0,BF,1506,1506,68,68,0,0.045152724,0.045152724,0.0
2021.0,BF,1393,1393,60,55,5,0.03948313,0.043072507,0.0035893754
2022.0,BF,0,0,39,27,12,,,
1996.0,BG,2914,2914,0,0,0,0.0,0.0,0.0
1997.0,BG,3393,3393,62,68,-6,0.02004126,0.018272914,-0.0017683466
1998.0,BG,3778,3778,68,121,-53,0.032027528,0.017998941,-0.014028586
1999.0,BG,3854,3854,88,145,-57,0.03762325,0.02283342,-0.014789829
2000.0,BG,3896,3896,98,135,-37,0.034650926,0.025154004,-0.00949692
2001.0,BG,3954,3954,97,154,-57,0.038947903,0.024532119,-0.014415782
2002.0,BG,4126,4126,93,148,-55,0.035870094,0.02253999,-0.013330102
2003.0,BG,4271,4271,117,161,-44,0.03769609,0.027394053,-0.010302037
2004.0,BG,4530,4530,131,175,-44,0.038631346,0.028918322,-0.009713024
2005.0,BG,4809,4809,123,156,-33,0.032439176,0.025577042,-0.0068621333
2006.0,BG,5032,5032,138,170,-32,0.033783782,0.027424483,-0.0063593006
2007.0,BG,5315,5315,168,166,2,0.03123236,0.031608656,0.00037629352
2008.0,BG,5578,5578,185,207,-22,0.037110075,0.03316601,-0.003944066
2009.0,BG,5720,5720,169,225,-56,0.039335664,0.029545454,-0.00979021
2010.0,BG,5982,5982,168,197,-29,0.03293213,0.028084252,-0.004847877
2011.0,BG,6288,6288,189,196,-7,0.031170484,0.030057251,-0.0011132315
2012.0,BG,6548,6548,201,204,-3,0.03115455,0.030696396,-0.00045815515
2013.0,BG,6745,6745,215,179,36,0.026538176,0.031875465,0.0053372867
2014.0,BG,7216,7216,199,215,-16,0.0297949,0.027577605,-0.0022172949
2015.0,BG,7545,7545,211,234,-23,0.031013917,0.02796554,-0.0030483764
2016.0,BG,7873,7873,246,201,45,0.025530294,0.03124603,0.005715737
2017.0,BG,8034,8034,218,216,2,0.026885735,0.027134677,0.000248942
2018.0,BG,8289,8289,246,234,12,0.028230185,0.029677887,0.0014477018
2019.0,BG,8348,8348,235,260,-25,0.031145185,0.028150456,-0.0029947292
2020.0,BG,7998,7998,197,188,9,0.023505876,0.024631158,0.0011252813
2021.0,BG,7378,7378,179,154,25,0.020872865,0.024261318,0.003388452
2022.0,BG,0,0,147,95,52,,,
1996.0,BH,139,139,0,0,0,0.0,0.0,0.0
1997.0,BH,175,175,6,8,-2,0.045714285,0.034285713,-0.011428571
1998.0,BH,201,201,16,9,7,0.04477612,0.07960199,0.03482587
1999.0,BH,210,210,12,11,1,0.052380953,0.057142857,0.004761905
2000.0,BH,236,236,13,16,-3,0.06779661,0.055084746,-0.012711864
2001.0,BH,256,256,18,11,7,0.04296875,0.0703125,0.02734375
2002.0,BH,293,293,25,16,9,0.054607507,0.085324235,0.030716723
2003.0,BH,305,305,19,25,-6,0.08196721,0.062295083,-0.019672131
2004.0,BH,328,328,21,21,0,0.06402439,0.06402439,0.0
2005.0,BH,347,347,34,35,-1,0.10086455,0.09798271,-0.0028818443
2006.0,BH,379,379,44,34,10,0.089709766,0.116094984,0.026385223
2007.0,BH,383,383,32,43,-11,0.11227154,0.083550915,-0.028720627
2008.0,BH,400,400,38,42,-4,0.105,0.095,-0.01
2009.0,BH,415,415,29,40,-11,0.09638554,0.06987952,-0.026506023
2010.0,BH,439,439,44,41,3,0.09339408,0.10022779,0.006833713
2011.0,BH,466,466,39,43,-4,0.09227468,0.083690986,-0.008583691
2012.0,BH,524,524,51,52,-1,0.099236645,0.097328246,-0.001908397
2013.0,BH,593,593,65,49,16,0.082630694,0.109612145,0.02698145
2014.0,BH,682,682,70,63,7,0.09237537,0.102639295,0.01026393
2015.0,BH,807,807,102,69,33,0.08550186,0.12639405,0.040892195
2016.0,BH,920,920,117,82,35,0.08913043,0.12717392,0.038043477
2017.0,BH,1047,1047,132,110,22,0.10506208,0.1260745,0.021012416
2018.0,BH,1166,1166,157,126,31,0.10806175,0.13464837,0.02658662
2019.0,BH,1296,1296,207,157,50,0.12114198,0.15972222,0.038580246
2020.0,BH,1301,1301,205,176,29,0.13528055,0.15757109,0.022290546
2021.0,BH,1206,1206,136,165,-29,0.13681592,0.112769485,-0.024046434
2022.0,BH,0,0,117,103,14,,,
1996.0,BI,53,53,0,0,0,0.0,0.0,0.0
1997.0,BI,55,55,5,14,-9,0.25454545,0.09090909,-0.16363636
1998.0,BI,59,59,10,12,-2,0.20338982,0.16949153,-0.033898305
1999.0,BI,48,48,6,13,-7,0.27083334,0.125,-0.14583333
2000.0,BI,51,51,13,17,-4,0.33333334,0.25490198,-0.078431375
2001.0,BI,50,50,8,13,-5,0.26,0.16,-0.1
2002.0,BI,67,67,17,8,9,0.11940298,0.25373134,0.13432837
2003.0,BI,75,75,19,20,-1,0.26666668,0.25333333,-0.013333334
2004.0,BI,84,84,15,18,-3,0.21428572,0.17857143,-0.035714287
2005.0,BI,81,81,17,30,-13,0.37037036,0.20987654,-0.16049382
2006.0,BI,108,108,28,16,12,0.14814815,0.25925925,0.11111111
2007.0,BI,115,115,21,22,-1,0.19130434,0.1826087,-0.008695652
2008.0,BI,121,121,26,31,-5,0.25619835,0.21487603,-0.041322313
2009.0,BI,138,138,29,29,0,0.21014492,0.21014492,0.0
2010.0,BI,156,156,36,27,9,0.17307693,0.23076923,0.057692308
2011.0,BI,147,147,19,42,-23,0.2857143,0.1292517,-0.15646258
2012.0,BI,155,155,31,34,-3,0.21935484,0.2,-0.019354839
2013.0,BI,162,162,31,28,3,0.17283951,0.19135803,0.018518519
2014.0,BI,182,182,36,40,-4,0.21978022,0.1978022,-0.021978023
2015.0,BI,183,183,29,49,-20,0.26775956,0.15846995,-0.10928962
2016.0,BI,199,199,28,31,-3,0.1557789,0.14070351,-0.015075377
2017.0,BI,216,216,40,40,0,0.18518518,0.18518518,0.0
2018.0,BI,231,231,39,41,-2,0.17748918,0.16883117,-0.008658009
2019.0,BI,229,229,38,45,-7,0.19650654,0.16593887,-0.030567685
2020.0,BI,222,222,35,31,4,0.13963965,0.15765765,0.018018018
2021.0,BI,213,213,40,25,15,0.11737089,0.18779343,0.07042254
2022.0,BI,0,0,37,17,20,,,
1996.0,BJ,78,78,0,0,0,0.0,0.0,0.0
1997.0,BJ,93,93,2,1,1,0.010752688,0.021505376,0.010752688
1998.0,BJ,121,121,7,7,0,0.05785124,0.05785124,0.0
1999.0,BJ,143,143,19,7,12,0.04895105,0.13286713,0.08391608
2000.0,BJ,163,163,17,12,5,0.073619634,0.10429448,0.030674847
2001.0,BJ,175,175,13,10,3,0.057142857,0.074285716,0.017142856
2002.0,BJ,235,235,23,20,3,0.08510638,0.09787234,0.012765957
2003.0,BJ,245,245,15,23,-8,0.093877554,0.06122449,-0.03265306
2004.0,BJ,304,304,37,22,15,0.07236842,0.121710524,0.049342107
2005.0,BJ,371,371,41,23,18,0.06199461,0.11051213,0.04851752
2006.0,BJ,419,419,46,36,10,0.08591885,0.1097852,0.023866348
2007.0,BJ,468,468,45,32,13,0.06837607,0.09615385,0.027777778
2008.0,BJ,511,511,46,46,0,0.09001957,0.09001957,0.0
2009.0,BJ,580,580,42,47,-5,0.08103448,0.072413795,-0.00862069
2010.0,BJ,689,689,55,55,0,0.07982583,0.07982583,0.0
2011.0,BJ,831,831,61,39,22,0.04693141,0.073405534,0.026474128
2012.0,BJ,967,967,57,62,-5,0.06411582,0.05894519,-0.0051706308
2013.0,BJ,1116,1116,63,58,5,0.051971328,0.05645161,0.004480287
2014.0,BJ,1246,1246,77,71,6,0.056982342,0.061797753,0.0048154094
2015.0,BJ,1390,1390,67,72,-5,0.05179856,0.048201438,-0.0035971224
2016.0,BJ,1496,1496,63,56,7,0.037433155,0.0421123,0.0046791444
2017.0,BJ,1648,1648,92,52,40,0.0315534,0.05582524,0.024271844
2018.0,BJ,1728,1728,95,92,3,0.053240743,0.05497685,0.0017361111
2019.0,BJ,1752,1752,89,86,3,0.049086757,0.050799087,0.0017123288
2020.0,BJ,1687,1687,80,90,-10,0.05334914,0.04742146,-0.0059276824
2021.0,BJ,1553,1553,56,72,-16,0.04636188,0.03605924,-0.0103026405
2022.0,BJ,0,0,26,31,-5,,,
2000.0,BM,6,6,1,1,0,0.16666667,0.16666667,0.0
2002.0,BM,7,7,0,1,-1,0.14285715,0.0,-0.14285715
2004.0,BM,7,7,1,2,-1,0.2857143,0.14285715,-0.14285715
2005.0,BM,11,11,4,1,3,0.09090909,0.36363637,0.27272728
2007.0,BM,20,20,6,0,6,0.0,0.3,0.3
2008.0,BM,31,31,9,1,8,0.032258064,0.29032257,0.2580645
2009.0,BM,31,31,2,3,-1,0.09677419,0.06451613,-0.032258064
2010.0,BM,31,31,2,4,-2,0.12903225,0.06451613,-0.06451613
2011.0,BM,35,35,8,4,4,0.114285715,0.22857143,0.114285715
2012.0,BM,38,38,5,4,1,0.10526316,0.13157895,0.02631579
2013.0,BM,36,36,2,2,0,0.055555556,0.055555556,0.0
2014.0,BM,35,35,5,7,-2,0.2,0.14285715,-0.057142857
2015.0,BM,32,32,3,3,0,0.09375,0.09375,0.0
2016.0,BM,24,24,2,6,-4,0.25,0.083333336,-0.16666667
2019.0,BM,22,22,3,2,1,0.09090909,0.13636364,0.045454547
1996.0,BN,48,48,0,0,0,0.0,0.0,0.0
1997.0,BN,68,68,1,1,0,0.014705882,0.014705882,0.0
1998.0,BN,80,80,7,5,2,0.0625,0.0875,0.025
1999.0,BN,86,86,10,6,4,0.069767445,0.11627907,0.046511628
2000.0,BN,87,87,9,6,3,0.06896552,0.10344828,0.03448276
2001.0,BN,71,71,3,17,-14,0.23943663,0.04225352,-0.1971831
2002.0,BN,59,59,5,7,-2,0.118644066,0.084745765,-0.033898305
2003.0,BN,72,72,7,5,2,0.06944445,0.097222224,0.027777778
2004.0,BN,76,76,10,8,2,0.10526316,0.13157895,0.02631579
2005.0,BN,85,85,5,7,-2,0.08235294,0.05882353,-0.023529412
2006.0,BN,101,101,13,9,4,0.089108914,0.12871288,0.03960396
2007.0,BN,108,108,10,7,3,0.06481481,0.09259259,0.027777778
2008.0,BN,117,117,13,11,2,0.094017096,0.11111111,0.017094018
2009.0,BN,128,128,13,9,4,0.0703125,0.1015625,0.03125
2010.0,BN,144,144,14,12,2,0.083333336,0.097222224,0.013888889
2011.0,BN,180,180,23,13,10,0.072222225,0.12777779,0.055555556
2012.0,BN,218,218,27,15,12,0.06880734,0.123853214,0.055045873
2013.0,BN,273,273,36,22,14,0.08058608,0.13186814,0.051282052
2014.0,BN,319,319,37,29,8,0.09090909,0.11598746,0.02507837
2015.0,BN,384,384,60,27,33,0.0703125,0.15625,0.0859375
2016.0,BN,436,436,61,35,26,0.08027523,0.13990825,0.059633028
2017.0,BN,461,461,47,42,5,0.09110629,0.10195228,0.010845987
2018.0,BN,510,510,64,44,20,0.08627451,0.1254902,0.039215688
2019.0,BN,518,518,52,62,-10,0.11969112,0.1003861,-0.019305019
2020.0,BN,511,511,64,55,9,0.10763209,0.12524462,0.017612524
2021.0,BN,492,492,48,35,13,0.07113821,0.09756097,0.026422765
2022.0,BN,0,0,29,21,8,,,
1996.0,BO,62,62,0,0,0,0.0,0.0,0.0
1997.0,BO,91,91,3,2,1,0.021978023,0.032967035,0.010989011
1998.0,BO,116,116,8,3,5,0.02586207,0.06896552,0.04310345
1999.0,BO,141,141,4,4,0,0.028368793,0.028368793,0.0
2000.0,BO,160,160,16,20,-4,0.125,0.1,-0.025
2001.0,BO,174,174,14,16,-2,0.09195402,0.08045977,-0.011494253
2002.0,BO,172,172,11,22,-11,0.12790698,0.06395349,-0.06395349
2003.0,BO,245,245,39,11,28,0.04489796,0.15918367,0.114285715
2004.0,BO,288,288,30,21,9,0.072916664,0.104166664,0.03125
2005.0,BO,327,327,36,30,6,0.09174312,0.110091746,0.018348623
2006.0,BO,360,360,28,32,-4,0.08888889,0.07777778,-0.011111111
2007.0,BO,406,406,40,40,0,0.098522164,0.098522164,0.0
2008.0,BO,447,447,52,46,6,0.102908276,0.11633109,0.013422819
2009.0,BO,493,493,55,59,-4,0.11967546,0.111561865,-0.00811359
2010.0,BO,539,539,58,53,5,0.098330244,0.10760668,0.009276438
2011.0,BO,550,550,48,71,-23,0.1290909,0.087272726,-0.041818183
2012.0,BO,537,537,54,72,-18,0.13407822,0.10055866,-0.033519555
2013.0,BO,584,584,67,70,-3,0.11986301,0.11472603,-0.0051369863
2014.0,BO,622,622,78,70,8,0.11254019,0.12540193,0.012861736
2015.0,BO,681,681,98,76,22,0.111600585,0.14390603,0.032305434
2016.0,BO,690,690,86,100,-14,0.14492753,0.12463768,-0.020289855
2017.0,BO,725,725,100,95,5,0.13103448,0.13793103,0.0068965517
2018.0,BO,741,741,104,111,-7,0.14979757,0.14035088,-0.009446694
2019.0,BO,735,735,98,91,7,0.123809524,0.13333334,0.00952381
2020.0,BO,692,692,115,99,16,0.14306359,0.16618498,0.023121387
2021.0,BO,604,604,70,73,-3,0.12086093,0.11589404,-0.0049668876
1996.0,BR,25963,25963,0,0,0,0.0,0.0,0.0
1997.0,BR,34265,34265,712,499,213,0.014562965,0.02077922,0.0062162555
1998.0,BR,42796,42796,988,700,288,0.01635667,0.02308627,0.006729601
1999.0,BR,49754,49754,1051,881,170,0.017707119,0.021123929,0.0034168107
2000.0,BR,56718,56718,1225,1065,160,0.018777108,0.021598082,0.002820974
2001.0,BR,64528,64528,1389,1198,191,0.018565584,0.02152554,0.0029599555
2002.0,BR,73324,73324,1532,1505,27,0.02052534,0.020893568,0.00036822868
2003.0,BR,82635,82635,1752,1646,106,0.01991892,0.02120167,0.0012827495
2004.0,BR,93614,93614,2054,1913,141,0.020434977,0.021941163,0.0015061849
2005.0,BR,105830,105830,2292,2241,51,0.02117547,0.021657376,0.00048190495
2006.0,BR,118935,118935,2608,2656,-48,0.022331527,0.021927943,-0.0004035818
2007.0,BR,132742,132742,3014,2783,231,0.020965481,0.0227057,0.0017402179
2008.0,BR,146893,146893,3222,3170,52,0.021580335,0.021934332,0.00035399917
2009.0,BR,161474,161474,3774,3445,329,0.021334704,0.023372184,0.0020374798
2010.0,BR,177445,177445,3984,3840,144,0.021640508,0.022452027,0.00081151904
2011.0,BR,193715,193715,4301,4078,223,0.021051545,0.02220272,0.0011511757
2012.0,BR,210330,210330,4698,4224,474,0.020082727,0.022336328,0.0022536016
2013.0,BR,227127,227127,5026,4554,472,0.020050457,0.02212859,0.0020781325
2014.0,BR,244233,244233,5531,4967,564,0.020337136,0.022646407,0.0023092702
2015.0,BR,260924,260924,6088,5337,751,0.020454232,0.023332465,0.0028782326
2016.0,BR,275575,275575,6164,5610,554,0.020357434,0.022367777,0.002010342
2017.0,BR,288312,288312,6219,6016,203,0.020866284,0.021570383,0.0007040983
2018.0,BR,302719,302719,6974,6765,209,0.022347458,0.023037868,0.0006904093
2019.0,BR,304545,304545,6927,7434,-507,0.024410186,0.022745406,-0.0016647786
2020.0,BR,292796,292796,6135,6652,-517,0.02271889,0.020953154,-0.0017657345
2021.0,BR,271234,271234,4370,5831,-1461,0.021498043,0.016111549,-0.0053864927
2022.0,BR,0,0,2562,4135,-1573,,,
2023.0,BR,0,0,234,264,-30,,,
1996.0,BS,2,2,0,0,0,0.0,0.0,0.0
1998.0,BS,5,5,1,0,1,0.0,0.2,0.2
1999.0,BS,5,5,1,1,0,0.2,0.2,0.0
2000.0,BS,9,9,1,1,0,0.11111111,0.11111111,0.0
2002.0,BS,12,12,2,2,0,0.16666667,0.16666667,0.0
2003.0,BS,13,13,1,1,0,0.07692308,0.07692308,0.0
2004.0,BS,14,14,0,2,-2,0.14285715,0.0,-0.14285715
2005.0,BS,16,16,0,1,-1,0.0625,0.0,-0.0625
2006.0,BS,37,37,7,1,6,0.027027028,0.1891892,0.16216215
2007.0,BS,41,41,1,0,1,0.0,0.024390243,0.024390243
2008.0,BS,49,49,5,0,5,0.0,0.10204082,0.10204082
2009.0,BS,53,53,5,6,-1,0.11320755,0.094339624,-0.018867925
2010.0,BS,56,56,5,4,1,0.071428575,0.08928572,0.017857144
2011.0,BS,48,48,2,4,-2,0.083333336,0.041666668,-0.041666668
2012.0,BS,57,57,5,1,4,0.01754386,0.0877193,0.07017544
2013.0,BS,60,60,5,8,-3,0.13333334,0.083333336,-0.05
2014.0,BS,63,63,10,5,5,0.07936508,0.15873016,0.07936508
2015.0,BS,62,62,5,9,-4,0.14516129,0.08064516,-0.06451613
2016.0,BS,68,68,13,5,8,0.073529415,0.19117647,0.11764706
2017.0,BS,63,63,7,7,0,0.11111111,0.11111111,0.0
2018.0,BS,69,69,7,6,1,0.08695652,0.10144927,0.014492754
2019.0,BS,69,69,9,9,0,0.13043478,0.13043478,0.0
2020.0,BS,72,72,17,9,8,0.125,0.2361111,0.11111111
1998.0,BT,2,2,0,0,0,0.0,0.0,0.0
2000.0,BT,3,3,0,0,0,0.0,0.0,0.0
2001.0,BT,5,5,0,0,0,0.0,0.0,0.0
2002.0,BT,11,11,0,0,0,0.0,0.0,0.0
2003.0,BT,14,14,0,1,-1,0.071428575,0.0,-0.071428575
2004.0,BT,18,18,0,0,0,0.0,0.0,0.0
2005.0,BT,20,20,1,0,1,0.0,0.05,0.05
2006.0,BT,20,20,0,1,-1,0.05,0.0,-0.05
2007.0,BT,24,24,1,1,0,0.041666668,0.041666668,0.0
2008.0,BT,21,21,0,3,-3,0.14285715,0.0,-0.14285715
2009.0,BT,25,25,1,1,0,0.04,0.04,0.0
2010.0,BT,34,34,1,2,-1,0.05882353,0.029411765,-0.029411765
2011.0,BT,35,35,2,3,-1,0.08571429,0.057142857,-0.028571429
2012.0,BT,39,39,4,2,2,0.051282052,0.102564104,0.051282052
2013.0,BT,46,46,5,2,3,0.04347826,0.10869565,0.06521739
2014.0,BT,68,68,8,3,5,0.04411765,0.11764706,0.073529415
2015.0,BT,77,77,5,6,-1,0.077922076,0.064935066,-0.012987013
2016.0,BT,91,91,7,6,1,0.06593407,0.07692308,0.010989011
2017.0,BT,109,109,13,9,4,0.08256881,0.119266056,0.036697246
2018.0,BT,149,149,17,12,5,0.08053691,0.11409396,0.033557046
2019.0,BT,169,169,18,20,-2,0.1183432,0.10650887,-0.01183432
2020.0,BT,174,174,23,17,6,0.09770115,0.13218391,0.03448276
2021.0,BT,174,174,18,13,5,0.07471264,0.10344828,0.028735632
1996.0,BW,113,113,0,0,0,0.0,0.0,0.0
1997.0,BW,144,144,3,3,0,0.020833334,0.020833334,0.0
1998.0,BW,185,185,7,6,1,0.032432433,0.037837837,0.0054054055
1999.0,BW,219,219,13,6,7,0.02739726,0.05936073,0.03196347
2000.0,BW,256,256,9,6,3,0.0234375,0.03515625,0.01171875
2001.0,BW,286,286,15,14,1,0.04895105,0.052447554,0.0034965035
2002.0,BW,335,335,9,12,-3,0.035820894,0.026865672,-0.0089552235
2003.0,BW,372,372,16,13,3,0.034946237,0.043010753,0.008064516
2004.0,BW,407,407,11,15,-4,0.03685504,0.027027028,-0.00982801
2005.0,BW,447,447,13,16,-3,0.035794184,0.029082773,-0.0067114094
2006.0,BW,501,501,29,28,1,0.055888224,0.05788423,0.001996008
2007.0,BW,547,547,28,30,-2,0.054844607,0.0511883,-0.0036563072
2008.0,BW,576,576,27,30,-3,0.052083332,0.046875,-0.0052083335
2009.0,BW,627,627,42,35,7,0.05582137,0.066985644,0.011164274
2010.0,BW,657,657,30,39,-9,0.05936073,0.0456621,-0.01369863
2011.0,BW,753,753,39,26,13,0.034528553,0.05179283,0.017264277
2012.0,BW,823,823,56,41,15,0.04981774,0.068043746,0.018226003
2013.0,BW,879,879,41,43,-2,0.048919227,0.046643913,-0.0022753128
2014.0,BW,967,967,48,39,9,0.04033092,0.049638055,0.009307136
2015.0,BW,1038,1038,49,57,-8,0.054913294,0.047206167,-0.007707129
2016.0,BW,1104,1104,63,48,15,0.04347826,0.05706522,0.013586956
2017.0,BW,1135,1135,63,54,9,0.047577094,0.05550661,0.007929515
2018.0,BW,1179,1179,75,59,16,0.05004241,0.06361323,0.013570823
2019.0,BW,1203,1203,79,63,16,0.052369077,0.065669164,0.013300084
2020.0,BW,1170,1170,53,47,6,0.04017094,0.045299146,0.0051282053
2021.0,BW,1047,1047,36,52,-16,0.04966571,0.034383953,-0.015281757
2022.0,BW,0,0,31,25,6,,,
2023.0,BW,0,0,3,5,-2,,,
1996.0,BY,1468,1468,0,0,0,0.0,0.0,0.0
1997.0,BY,1761,1761,30,37,-7,0.02101079,0.017035775,-0.003975014
1998.0,BY,2180,2180,29,56,-27,0.025688073,0.013302753,-0.012385321
1999.0,BY,2464,2464,54,44,10,0.017857144,0.021915585,0.0040584416
2000.0,BY,2649,2649,52,55,-3,0.020762552,0.019630048,-0.0011325028
2001.0,BY,2859,2859,43,76,-33,0.026582722,0.0150402235,-0.011542497
2002.0,BY,3008,3008,47,98,-51,0.032579787,0.015625,-0.016954787
2003.0,BY,3099,3099,65,76,-11,0.02452404,0.020974508,-0.003549532
2004.0,BY,3314,3314,63,88,-25,0.026554013,0.019010259,-0.007543754
2005.0,BY,3448,3448,74,93,-19,0.026972158,0.021461718,-0.005510441
2006.0,BY,3458,3458,68,103,-35,0.029786004,0.019664546,-0.010121457
2007.0,BY,3516,3516,77,120,-43,0.034129694,0.021899886,-0.012229807
2008.0,BY,3559,3559,126,126,0,0.035403203,0.035403203,0.0
2009.0,BY,3638,3638,99,110,-11,0.030236393,0.027212754,-0.0030236393
2010.0,BY,3689,3689,129,123,6,0.03334237,0.034968827,0.0016264571
2011.0,BY,3821,3821,125,149,-24,0.038995028,0.03271395,-0.0062810783
2012.0,BY,3964,3964,119,144,-25,0.03632694,0.030020181,-0.006306761
2013.0,BY,4087,4087,141,146,-5,0.035723023,0.034499634,-0.0012233913
2014.0,BY,4229,4229,153,209,-56,0.049420666,0.036178764,-0.013241901
2015.0,BY,4254,4254,124,180,-56,0.042313118,0.029149037,-0.013164081
2016.0,BY,4365,4365,132,187,-55,0.04284078,0.03024055,-0.012600229
2017.0,BY,4700,4700,168,238,-70,0.0506383,0.035744682,-0.0148936175
2018.0,BY,4935,4935,144,251,-107,0.050861195,0.02917933,-0.021681864
2019.0,BY,5041,5041,191,266,-75,0.052767307,0.03788931,-0.014878
2020.0,BY,4851,4851,188,189,-1,0.038961038,0.038754895,-0.00020614306
2021.0,BY,4478,4478,141,159,-18,0.035506923,0.03148727,-0.0040196516
2022.0,BY,0,0,92,86,6,,,
1996.0,BZ,4,4,0,0,0,0.0,0.0,0.0
1997.0,BZ,8,8,3,0,3,0.0,0.375,0.375
1998.0,BZ,13,13,3,1,2,0.07692308,0.23076923,0.15384616
1999.0,BZ,13,13,3,4,-1,0.30769232,0.23076923,-0.07692308
2000.0,BZ,22,22,8,3,5,0.13636364,0.36363637,0.22727273
2001.0,BZ,22,22,2,5,-3,0.22727273,0.09090909,-0.13636364
2002.0,BZ,19,19,1,4,-3,0.21052632,0.05263158,-0.15789473
2003.0,BZ,25,25,11,6,5,0.24,0.44,0.2
2004.0,BZ,20,20,5,9,-4,0.45,0.25,-0.2
2005.0,BZ,25,25,10,7,3,0.28,0.4,0.12
2007.0,BZ,35,35,10,2,8,0.057142857,0.2857143,0.22857143
2008.0,BZ,32,32,9,11,-2,0.34375,0.28125,-0.0625
2009.0,BZ,27,27,1,7,-6,0.25925925,0.037037037,-0.22222222
2010.0,BZ,19,19,1,8,-7,0.42105263,0.05263158,-0.36842105
2011.0,BZ,23,23,7,3,4,0.13043478,0.3043478,0.17391305
2012.0,BZ,16,16,1,7,-6,0.4375,0.0625,-0.375
2013.0,BZ,14,14,1,4,-3,0.2857143,0.071428575,-0.21428572
2015.0,BZ,18,18,3,5,-2,0.2777778,0.16666667,-0.11111111
2016.0,BZ,21,21,4,3,1,0.14285715,0.1904762,0.04761905
2017.0,BZ,22,22,4,3,1,0.13636364,0.18181819,0.045454547
2018.0,BZ,24,24,5,3,2,0.125,0.20833333,0.083333336
2021.0,BZ,29,29,4,1,3,0.03448276,0.13793103,0.10344828
1996.0,CA,52732,52732,0,0,0,0.0,0.0,0.0
1997.0,CA,61081,61081,2274,2597,-323,0.042517312,0.03722925,-0.0052880603
1998.0,CA,68795,68795,2889,3291,-402,0.04783778,0.04199433,-0.005843448
1999.0,CA,70691,70691,3171,3669,-498,0.05190194,0.044857197,-0.007044744
2000.0,CA,72939,72939,3255,3854,-599,0.052838672,0.044626333,-0.008212342
2001.0,CA,76475,76475,3860,4085,-225,0.053416148,0.05047401,-0.002942138
2002.0,CA,81385,81385,4351,4320,31,0.053081036,0.05346194,0.00038090558
2003.0,CA,86699,86699,4741,4659,82,0.053737644,0.054683447,0.000945801
2004.0,CA,93432,93432,5290,4789,501,0.05125653,0.056618717,0.0053621884
2005.0,CA,100551,100551,5858,5254,604,0.05225209,0.05825899,0.006006902
2006.0,CA,108049,108049,6186,5764,422,0.05334617,0.057251804,0.0039056353
2007.0,CA,115524,115524,6607,6114,493,0.052924067,0.05719158,0.0042675114
2008.0,CA,121936,121936,6853,6699,154,0.054938655,0.056201614,0.0012629576
2009.0,CA,128509,128509,7220,7192,28,0.05596495,0.056182835,0.00021788357
2010.0,CA,135035,135035,7477,7618,-141,0.056415003,0.05537083,-0.0010441737
2011.0,CA,141065,141065,7812,7933,-121,0.056236487,0.055378728,-0.0008577606
2012.0,CA,146568,146568,8004,8314,-310,0.056724522,0.054609466,-0.0021150592
2013.0,CA,152450,152450,8419,8657,-238,0.056785833,0.055224665,-0.0015611676
2014.0,CA,157838,157838,8751,9111,-360,0.057723742,0.05544292,-0.0022808195
2015.0,CA,162171,162171,8867,9521,-654,0.058709633,0.054676853,-0.0040327804
2016.0,CA,165756,165756,9247,9672,-425,0.058350828,0.05578682,-0.0025640097
2017.0,CA,168904,168904,9406,9790,-384,0.05796192,0.055688437,-0.0022734809
2018.0,CA,171623,171623,9886,9979,-93,0.058144886,0.057603,-0.0005418854
2019.0,CA,171688,171688,10227,10441,-214,0.060813803,0.059567355,-0.0012464471
2020.0,CA,163832,163832,9434,9836,-402,0.06003711,0.057583377,-0.002453733
2021.0,CA,152103,152103,7480,7048,432,0.046337023,0.049177203,0.0028401806
2022.0,CA,0,0,5326,4984,342,,,
2023.0,CA,0,0,380,281,99,,,
1996.0,CD,33,33,0,0,0,0.0,0.0,0.0
1997.0,CD,42,42,2,0,2,0.0,0.04761905,0.04761905
1998.0,CD,52,52,2,0,2,0.0,0.03846154,0.03846154
1999.0,CD,53,53,1,3,-2,0.056603774,0.018867925,-0.03773585
2000.0,CD,52,52,1,0,1,0.0,0.01923077,0.01923077
2001.0,CD,59,59,0,0,0,0.0,0.0,0.0
2002.0,CD,80,80,1,1,0,0.0125,0.0125,0.0
2003.0,CD,101,101,2,2,0,0.01980198,0.01980198,0.0
2004.0,CD,129,129,3,5,-2,0.03875969,0.023255814,-0.015503876
2005.0,CD,168,168,6,3,3,0.017857144,0.035714287,0.017857144
2006.0,CD,210,210,6,6,0,0.028571429,0.028571429,0.0
2007.0,CD,234,234,6,4,2,0.017094018,0.025641026,0.008547009
2008.0,CD,291,291,5,12,-7,0.041237112,0.01718213,-0.024054984
2009.0,CD,337,337,11,7,4,0.020771513,0.03264095,0.011869436
2010.0,CD,415,415,11,7,4,0.01686747,0.026506023,0.009638554
2011.0,CD,509,509,21,17,4,0.033398822,0.041257367,0.007858546
2012.0,CD,691,691,12,21,-9,0.030390738,0.017366135,-0.013024602
2013.0,CD,873,873,25,18,7,0.020618556,0.028636884,0.008018328
2014.0,CD,1122,1122,33,12,21,0.010695187,0.029411765,0.018716577
2015.0,CD,1278,1278,37,24,13,0.018779343,0.028951487,0.010172144
2016.0,CD,1458,1458,48,29,19,0.01989026,0.03292181,0.01303155
2017.0,CD,1566,1566,50,30,20,0.019157087,0.03192848,0.012771392
2018.0,CD,1652,1652,57,43,14,0.026029056,0.03450363,0.008474576
2019.0,CD,1680,1680,62,61,1,0.036309525,0.036904763,0.0005952381
2020.0,CD,1593,1593,69,65,4,0.040803514,0.0433145,0.0025109856
2021.0,CD,1450,1450,45,38,7,0.026206896,0.031034483,0.004827586
1996.0,CF,11,11,0,0,0,0.0,0.0,0.0
1997.0,CF,18,18,0,0,0,0.0,0.0,0.0
1998.0,CF,18,18,1,1,0,0.055555556,0.055555556,0.0
1999.0,CF,17,17,1,2,-1,0.11764706,0.05882353,-0.05882353
2001.0,CF,22,22,2,2,0,0.09090909,0.09090909,0.0
2002.0,CF,19,19,1,1,0,0.05263158,0.05263158,0.0
2003.0,CF,23,23,4,2,2,0.08695652,0.17391305,0.08695652
2004.0,CF,31,31,4,3,1,0.09677419,0.12903225,0.032258064
2005.0,CF,34,34,3,3,0,0.0882353,0.0882353,0.0
2006.0,CF,37,37,1,2,-1,0.054054055,0.027027028,-0.027027028
2007.0,CF,40,40,3,5,-2,0.125,0.075,-0.05
2008.0,CF,47,47,5,4,1,0.08510638,0.10638298,0.021276595
2009.0,CF,51,51,3,5,-2,0.09803922,0.05882353,-0.039215688
2010.0,CF,61,61,8,3,5,0.04918033,0.13114753,0.08196721
2011.0,CF,64,64,4,8,-4,0.125,0.0625,-0.0625
2012.0,CF,65,65,1,7,-6,0.10769231,0.015384615,-0.092307694
2013.0,CF,79,79,6,3,3,0.03797468,0.07594936,0.03797468
2014.0,CF,83,83,7,2,5,0.024096385,0.084337346,0.060240965
2015.0,CF,80,80,6,7,-1,0.0875,0.075,-0.0125
2016.0,CF,89,89,6,5,1,0.056179777,0.06741573,0.011235955
2017.0,CF,79,79,2,11,-9,0.1392405,0.025316456,-0.11392405
2018.0,CF,79,79,9,1,8,0.012658228,0.11392405,0.101265825
2019.0,CF,90,90,9,6,3,0.06666667,0.1,0.033333335
2020.0,CF,88,88,6,1,5,0.011363637,0.06818182,0.056818184
2021.0,CF,77,77,2,5,-3,0.064935066,0.025974026,-0.038961038
1996.0,CG,34,34,0,0,0,0.0,0.0,0.0
1997.0,CG,45,45,0,4,-4,0.08888889,0.0,-0.08888889
1998.0,CG,55,55,3,5,-2,0.09090909,0.054545455,-0.036363635
1999.0,CG,63,63,10,5,5,0.07936508,0.15873016,0.07936508
2000.0,CG,65,65,4,14,-10,0.21538462,0.06153846,-0.15384616
2001.0,CG,84,84,9,10,-1,0.11904762,0.10714286,-0.011904762
2002.0,CG,108,108,17,12,5,0.11111111,0.1574074,0.046296295
2003.0,CG,137,137,13,10,3,0.0729927,0.09489051,0.02189781
2004.0,CG,170,170,20,14,6,0.08235294,0.11764706,0.03529412
2005.0,CG,200,200,26,14,12,0.07,0.13,0.06
2006.0,CG,211,211,25,21,4,0.09952607,0.11848341,0.018957347
2007.0,CG,244,244,23,23,0,0.094262294,0.094262294,0.0
2008.0,CG,254,254,40,29,11,0.114173226,0.15748031,0.04330709
2009.0,CG,268,268,26,29,-3,0.108208954,0.09701493,-0.01119403
2010.0,CG,283,283,28,34,-6,0.12014134,0.09893993,-0.021201413
2011.0,CG,297,297,34,29,5,0.0976431,0.11447811,0.016835017
2012.0,CG,330,330,32,26,6,0.07878788,0.096969694,0.018181818
2013.0,CG,394,394,43,32,11,0.08121827,0.10913706,0.027918782
2014.0,CG,414,414,31,46,-15,0.11111111,0.07487923,-0.036231883
2015.0,CG,486,486,60,32,28,0.06584362,0.12345679,0.057613168
2016.0,CG,519,519,44,55,-11,0.10597303,0.08477842,-0.021194605
2017.0,CG,575,575,48,33,15,0.057391305,0.083478265,0.026086956
2018.0,CG,609,609,61,45,16,0.073891625,0.100164205,0.026272578
2019.0,CG,660,660,66,33,33,0.05,0.1,0.05
2020.0,CG,624,624,41,46,-5,0.07371795,0.06570513,-0.008012821
2021.0,CG,596,596,48,35,13,0.05872483,0.08053691,0.021812081
2022.0,CG,0,0,37,28,9,,,
1996.0,CH,18815,18815,0,0,0,0.0,0.0,0.0
1997.0,CH,22001,22001,1073,1082,-9,0.049179584,0.04877051,-0.00040907232
1998.0,CH,25124,25124,1450,1327,123,0.052818023,0.05771374,0.0048957174
1999.0,CH,26370,26370,1536,1495,41,0.05669321,0.05824801,0.0015547972
2000.0,CH,27670,27670,1677,1644,33,0.05941453,0.060607154,0.0011926274
2001.0,CH,28872,28872,1815,1806,9,0.06255195,0.06286368,0.0003117207
2002.0,CH,30510,30510,1998,1800,198,0.05899705,0.06548673,0.0064896755
2003.0,CH,32127,32127,2137,1979,158,0.061599277,0.066517256,0.0049179816
2004.0,CH,34229,34229,2388,1973,415,0.057641182,0.069765404,0.012124222
2005.0,CH,36119,36119,2384,2176,208,0.0602453,0.066004045,0.005758742
2006.0,CH,38440,38440,2818,2353,465,0.06121228,0.07330906,0.012096774
2007.0,CH,41183,41183,3064,2561,503,0.062185854,0.07439963,0.012213778
2008.0,CH,43741,43741,3265,2846,419,0.06506481,0.074643925,0.009579114
2009.0,CH,46341,46341,3479,2991,488,0.06454328,0.075073905,0.010530632
2010.0,CH,49451,49451,3853,3079,774,0.062263656,0.07791551,0.015651857
2011.0,CH,52542,52542,4140,3269,871,0.062216893,0.07879411,0.016577214
2012.0,CH,55432,55432,4355,3474,881,0.06267138,0.078564726,0.015893348
2013.0,CH,58432,58432,4618,3646,972,0.062397316,0.07903203,0.016634721
2014.0,CH,61256,61256,4789,4060,729,0.066279225,0.0781801,0.011900875
2015.0,CH,63905,63905,4919,4137,782,0.06473672,0.07697363,0.012236915
2016.0,CH,66008,66008,5110,4239,871,0.06421949,0.077414855,0.01319537
2017.0,CH,68022,68022,5313,4388,925,0.06450854,0.07810708,0.013598542
2018.0,CH,69426,69426,5318,4709,609,0.06782761,0.076599546,0.00877193
2019.0,CH,70316,70316,5651,4764,887,0.067751296,0.08036578,0.012614483
2020.0,CH,67605,67605,5135,4646,489,0.068722725,0.07595592,0.0072331927
2021.0,CH,62868,62868,3802,3577,225,0.056896992,0.06047592,0.0035789274
2022.0,CH,0,0,2681,2312,369,,,
1996.0,CI,114,114,0,0,0,0.0,0.0,0.0
1997.0,CI,164,164,3,4,-1,0.024390243,0.018292682,-0.0060975607
1998.0,CI,204,204,5,6,-1,0.029411765,0.024509804,-0.004901961
1999.0,CI,234,234,11,9,2,0.03846154,0.047008548,0.008547009
2000.0,CI,257,257,14,13,1,0.050583657,0.054474708,0.0038910506
2001.0,CI,266,266,11,11,0,0.041353382,0.041353382,0.0
2002.0,CI,357,357,15,8,7,0.022408964,0.042016808,0.019607844
2003.0,CI,421,421,17,11,6,0.026128266,0.040380046,0.014251782
2004.0,CI,489,489,14,16,-2,0.032719836,0.028629856,-0.0040899795
2005.0,CI,566,566,19,16,3,0.028268551,0.033568904,0.0053003533
2006.0,CI,693,693,27,24,3,0.034632035,0.038961038,0.0043290043
2007.0,CI,752,752,16,16,0,0.021276595,0.021276595,0.0
2008.0,CI,856,856,36,23,13,0.02686916,0.042056076,0.015186916
2009.0,CI,971,971,30,28,2,0.028836252,0.030895984,0.0020597323
2010.0,CI,1147,1147,40,27,13,0.023539668,0.034873582,0.0113339145
2011.0,CI,1326,1326,58,20,38,0.015082956,0.043740574,0.028657617
2012.0,CI,1562,1562,56,38,18,0.024327785,0.03585147,0.011523687
2013.0,CI,1810,1810,64,42,22,0.02320442,0.035359114,0.0121546965
2014.0,CI,2124,2124,67,42,25,0.01977401,0.031544257,0.011770245
2015.0,CI,2342,2342,88,58,30,0.024765158,0.037574723,0.012809564
2016.0,CI,2542,2542,66,43,23,0.016915815,0.025963807,0.009047993
2017.0,CI,2687,2687,88,75,13,0.02791217,0.03275028,0.0048381095
2018.0,CI,2811,2811,94,62,32,0.022056207,0.033440057,0.011383849
2019.0,CI,2815,2815,108,95,13,0.03374778,0.038365897,0.004618117
2020.0,CI,2636,2636,77,90,-13,0.03414264,0.029210925,-0.004931715
2021.0,CI,2380,2380,64,45,19,0.018907564,0.026890757,0.007983194
2022.0,CI,0,0,28,36,-8,,,
1996.0,CL,3648,3648,0,0,0,0.0,0.0,0.0
1997.0,CL,4586,4586,128,112,16,0.024422154,0.027911033,0.0034888792
1998.0,CL,5744,5744,193,170,23,0.0295961,0.03360028,0.004004178
1999.0,CL,6506,6506,237,178,59,0.02735936,0.03642791,0.009068552
2000.0,CL,7565,7565,321,231,90,0.03053536,0.042432252,0.011896893
2001.0,CL,8612,8612,384,345,39,0.040060382,0.044588946,0.004528565
2002.0,CL,9606,9606,419,373,46,0.038829897,0.04361857,0.004788674
2003.0,CL,10581,10581,477,460,17,0.043474153,0.045080807,0.0016066534
2004.0,CL,11623,11623,519,548,-29,0.047147896,0.044652842,-0.002495053
2005.0,CL,12588,12588,600,609,-9,0.04837941,0.04766444,-0.0007149666
2006.0,CL,13566,13566,711,668,43,0.04924075,0.05241044,0.0031696889
2007.0,CL,14645,14645,796,795,1,0.05428474,0.05435302,6.8282694e-05
2008.0,CL,15867,15867,904,861,43,0.054263566,0.05697359,0.0027100272
2009.0,CL,17482,17482,1041,979,62,0.056000456,0.059546962,0.003546505
2010.0,CL,18731,18731,1118,1131,-13,0.060381185,0.05968715,-0.0006940366
2011.0,CL,20214,20214,1292,1208,84,0.059760563,0.063916095,0.0041555357
2012.0,CL,21522,21522,1373,1436,-63,0.06672242,0.06379519,-0.0029272372
2013.0,CL,22860,22860,1462,1543,-81,0.06749781,0.0639545,-0.003543307
2014.0,CL,24310,24310,1728,1544,184,0.06351296,0.07108186,0.007568902
2015.0,CL,25841,25841,1903,1718,185,0.0664835,0.07364266,0.0071591656
2016.0,CL,27204,27204,2093,1868,225,0.068666376,0.07693721,0.008270843
2017.0,CL,28311,28311,2141,2023,118,0.07145633,0.07562432,0.004167991
2018.0,CL,29415,29415,2337,2144,193,0.07288798,0.07944926,0.0065612784
2019.0,CL,29573,29573,2375,2301,74,0.077807456,0.08030974,0.0025022824
2020.0,CL,28176,28176,2060,2074,-14,0.07360875,0.07311187,-0.0004968768
2021.0,CL,25914,25914,1515,1732,-217,0.06683646,0.05846261,-0.008373852
2022.0,CL,0,0,913,997,-84,,,
1996.0,CM,281,281,0,0,0,0.0,0.0,0.0
1997.0,CM,365,365,13,13,0,0.03561644,0.03561644,0.0
1998.0,CM,442,442,8,13,-5,0.029411765,0.018099548,-0.011312217
1999.0,CM,514,514,22,22,0,0.042801555,0.042801555,0.0
2000.0,CM,582,582,14,18,-4,0.030927835,0.024054984,-0.0068728523
2001.0,CM,691,691,25,22,3,0.031837918,0.03617945,0.004341534
2002.0,CM,818,818,27,24,3,0.029339854,0.033007335,0.0036674817
2003.0,CM,961,961,32,29,3,0.030176898,0.03329865,0.003121748
2004.0,CM,1088,1088,39,36,3,0.033088237,0.03584559,0.002757353
2005.0,CM,1217,1217,36,33,3,0.02711586,0.029580936,0.0024650781
2006.0,CM,1338,1338,34,46,-12,0.034379672,0.025411062,-0.00896861
2007.0,CM,1462,1462,37,54,-17,0.036935706,0.025307797,-0.011627907
2008.0,CM,1580,1580,37,47,-10,0.029746836,0.023417722,-0.006329114
2009.0,CM,1755,1755,37,51,-14,0.02905983,0.021082621,-0.007977208
2010.0,CM,2018,2018,62,48,14,0.023785926,0.030723488,0.006937562
2011.0,CM,2348,2348,71,71,0,0.030238502,0.030238502,0.0
2012.0,CM,2737,2737,76,80,-4,0.029229082,0.027767628,-0.0014614542
2013.0,CM,3164,3164,75,69,6,0.021807838,0.023704171,0.0018963338
2014.0,CM,3682,3682,104,80,24,0.021727322,0.028245518,0.006518197
2015.0,CM,4141,4141,109,104,5,0.025114706,0.026322145,0.0012074378
2016.0,CM,4606,4606,121,108,13,0.023447677,0.026270082,0.0028224057
2017.0,CM,5071,5071,132,132,0,0.02603037,0.02603037,0.0
2018.0,CM,5563,5563,171,153,18,0.027503146,0.03073881,0.0032356642
2019.0,CM,5859,5859,190,157,33,0.026796382,0.03242874,0.0056323605
2020.0,CM,5778,5778,169,138,31,0.023883697,0.029248875,0.0053651785
2021.0,CM,5474,5474,123,129,-6,0.023565948,0.022469858,-0.0010960907
2022.0,CM,0,0,66,52,14,,,
1996.0,CN,43012,43012,0,0,0,0.0,0.0,0.0
1997.0,CN,57497,57497,1874,1447,427,0.02516653,0.032593004,0.0074264742
1998.0,CN,78037,78037,2372,2289,83,0.02933224,0.030395838,0.0010635981
1999.0,CN,97678,97678,2949,2761,188,0.028266344,0.030191036,0.0019246914
2000.0,CN,122379,122379,3907,3436,471,0.028076712,0.031925414,0.0038486996
2001.0,CN,155554,155554,5426,4588,838,0.02949458,0.034881778,0.005387197
2002.0,CN,204837,204837,6860,5589,1271,0.02728511,0.033490043,0.006204934
2003.0,CN,256586,256586,8374,6111,2263,0.023816576,0.032636233,0.008819655
2004.0,CN,313254,313254,9227,6836,2391,0.021822546,0.02945533,0.0076327836
2005.0,CN,368953,368953,10837,7337,3500,0.019886002,0.029372305,0.009486303
2006.0,CN,425514,425514,11932,7657,4275,0.017994707,0.028041381,0.010046673
2007.0,CN,476835,476835,12640,8220,4420,0.017238667,0.02650812,0.009269454
2008.0,CN,523573,523573,12998,9044,3954,0.017273618,0.024825573,0.0075519555
2009.0,CN,562936,562936,12894,10036,2858,0.01782796,0.022904912,0.0050769537
2010.0,CN,593725,593725,12989,10826,2163,0.018234031,0.021877132,0.0036431008
2011.0,CN,635794,635794,13709,11045,2664,0.017371979,0.021562016,0.0041900366
2012.0,CN,657682,657682,12817,11067,1750,0.016827282,0.019488141,0.0026608603
2013.0,CN,656308,656308,12459,10572,1887,0.016108291,0.018983465,0.0028751744
2014.0,CN,638786,638786,12988,10894,2094,0.017054224,0.020332318,0.0032780932
2015.0,CN,611679,611679,12729,11427,1302,0.018681368,0.020809935,0.0021285675
2016.0,CN,592066,592066,12946,11230,1716,0.01896748,0.021865806,0.0028983254
2017.0,CN,613541,613541,14278,11266,3012,0.018362261,0.023271468,0.0049092076
2018.0,CN,625806,625806,15076,11922,3154,0.019050632,0.024090532,0.0050399005
2019.0,CN,657316,657316,15793,12447,3346,0.018936098,0.024026496,0.005090398
2020.0,CN,663630,663630,15165,12754,2411,0.01921854,0.022851588,0.0036330486
2021.0,CN,641131,641131,12943,10527,2416,0.016419422,0.020187762,0.0037683407
2022.0,CN,0,0,10362,7908,2454,,,
2023.0,CN,0,0,557,1796,-1239,,,
1996.0,CO,1887,1887,0,0,0,0.0,0.0,0.0
1997.0,CO,2467,2467,99,83,16,0.033644103,0.040129714,0.0064856103
1998.0,CO,3198,3198,142,137,5,0.042839274,0.044402752,0.0015634772
1999.0,CO,3742,3742,172,184,-12,0.049171567,0.045964725,-0.0032068412
2000.0,CO,4246,4246,233,205,28,0.048280735,0.054875176,0.006594442
2001.0,CO,4939,4939,291,243,48,0.049200244,0.058918808,0.009718566
2002.0,CO,5648,5648,321,366,-45,0.0648017,0.056834277,-0.007967422
2003.0,CO,6701,6701,413,395,18,0.058946427,0.061632592,0.0026861662
2004.0,CO,7973,7973,530,468,62,0.058698107,0.06647435,0.007776245
2005.0,CO,9457,9457,641,500,141,0.05287089,0.06778048,0.014909591
2006.0,CO,11109,11109,772,593,179,0.053380143,0.069493204,0.016113061
2007.0,CO,12804,12804,906,811,95,0.06333958,0.07075914,0.0074195564
2008.0,CO,14592,14592,968,907,61,0.062157348,0.06633772,0.0041803727
2009.0,CO,16495,16495,1103,1053,50,0.06383753,0.066868745,0.0030312217
2010.0,CO,18663,18663,1282,1118,164,0.059904624,0.068692066,0.00878744
2011.0,CO,20796,20796,1466,1396,70,0.06712829,0.070494324,0.003366032
2012.0,CO,23224,23224,1761,1620,141,0.06975543,0.075826734,0.0060713054
2013.0,CO,25740,25740,1845,1779,66,0.069114216,0.07167832,0.0025641026
2014.0,CO,28426,28426,2162,1972,190,0.06937311,0.07605713,0.0066840216
2015.0,CO,31203,31203,2368,2247,121,0.072012305,0.07589014,0.0038778323
2016.0,CO,33279,33279,2662,2344,318,0.07043481,0.07999039,0.009555575
2017.0,CO,34910,34910,2865,2745,120,0.07863077,0.082068175,0.0034374106
2018.0,CO,36097,36097,3011,3182,-171,0.08815137,0.08341414,-0.0047372356
2019.0,CO,35883,35883,3064,3308,-244,0.0921885,0.08538862,-0.006799877
2020.0,CO,33616,33616,2679,2920,-241,0.0868634,0.0796942,-0.007169205
2021.0,CO,30109,30109,1900,2358,-458,0.07831545,0.063104056,-0.015211399
2022.0,CO,0,0,1153,1183,-30,,,
1996.0,CR,327,327,0,0,0,0.0,0.0,0.0
1997.0,CR,397,397,17,18,-1,0.04534005,0.042821158,-0.0025188916
1998.0,CR,504,504,19,20,-1,0.03968254,0.037698414,-0.001984127
1999.0,CR,557,557,32,29,3,0.05206463,0.05745063,0.0053859963
2000.0,CR,672,672,37,32,5,0.04761905,0.055059522,0.007440476
2001.0,CR,801,801,54,42,12,0.052434456,0.06741573,0.014981274
2002.0,CR,913,913,57,52,5,0.05695509,0.062431544,0.0054764515
2003.0,CR,1026,1026,85,63,22,0.06140351,0.082846,0.021442495
2004.0,CR,1095,1095,75,88,-13,0.0803653,0.06849315,-0.011872146
2005.0,CR,1177,1177,69,80,-11,0.06796941,0.05862362,-0.009345794
2006.0,CR,1272,1272,85,102,-17,0.08018868,0.0668239,-0.01336478
2007.0,CR,1473,1473,103,110,-7,0.07467753,0.06992532,-0.004752206
2008.0,CR,1608,1608,128,136,-8,0.08457711,0.07960199,-0.0049751243
2009.0,CR,1918,1918,157,106,51,0.055265903,0.0818561,0.026590198
2010.0,CR,2093,2093,173,162,11,0.07740086,0.08265647,0.005255614
2011.0,CR,2297,2297,196,179,17,0.07792773,0.08532869,0.007400958
2012.0,CR,2463,2463,205,244,-39,0.09906618,0.08323183,-0.015834348
2013.0,CR,2832,2832,262,216,46,0.076271184,0.09251413,0.016242938
2014.0,CR,3116,3116,276,271,5,0.08697048,0.088575095,0.0016046213
2015.0,CR,3385,3385,331,293,38,0.08655834,0.09778434,0.0112259975
2016.0,CR,3581,3581,354,348,6,0.09717956,0.09885507,0.0016755096
2017.0,CR,3647,3647,382,444,-62,0.1217439,0.10474362,-0.017000275
2018.0,CR,3800,3800,406,412,-6,0.10842105,0.10684211,-0.0015789474
2019.0,CR,3770,3770,497,441,56,0.11697613,0.13183025,0.014854112
2020.0,CR,3493,3493,355,400,-45,0.114514746,0.101631835,-0.012882909
2021.0,CR,3167,3167,258,291,-33,0.09188507,0.08146511,-0.0104199555
2022.0,CR,0,0,111,156,-45,,,
1996.0,CU,1012,1012,0,0,0,0.0,0.0,0.0
1997.0,CU,1350,1350,51,46,5,0.034074076,0.037777778,0.0037037036
1998.0,CU,1715,1715,81,64,17,0.037317783,0.047230322,0.0099125365
1999.0,CU,1913,1913,83,101,-18,0.052796654,0.04338735,-0.009409305
2000.0,CU,2161,2161,116,125,-9,0.057843592,0.05367885,-0.0041647386
2001.0,CU,2382,2382,102,125,-23,0.05247691,0.042821158,-0.009655751
2002.0,CU,2489,2489,107,157,-50,0.06307754,0.042989153,-0.02008839
2003.0,CU,2716,2716,136,164,-28,0.060382918,0.05007364,-0.010309278
2004.0,CU,3004,3004,165,180,-15,0.059920106,0.054926764,-0.0049933423
2005.0,CU,3255,3255,174,207,-33,0.06359447,0.05345622,-0.010138249
2006.0,CU,3590,3590,195,212,-17,0.059052926,0.05431755,-0.004735376
2007.0,CU,4001,4001,242,239,3,0.059735067,0.06048488,0.0007498125
2008.0,CU,4320,4320,276,277,-1,0.06412037,0.06388889,-0.00023148148
2009.0,CU,4580,4580,243,324,-81,0.07074236,0.05305677,-0.01768559
2010.0,CU,4788,4788,261,335,-74,0.069966584,0.05451128,-0.015455305
2011.0,CU,5025,5025,277,333,-56,0.06626866,0.05512438,-0.011144279
2012.0,CU,5273,5273,285,412,-127,0.07813389,0.05404893,-0.024084961
2013.0,CU,5483,5483,308,412,-104,0.07514135,0.056173626,-0.018967718
2014.0,CU,5640,5640,316,443,-127,0.0785461,0.05602837,-0.022517731
2015.0,CU,5783,5783,336,520,-184,0.089918725,0.05810133,-0.031817395
2016.0,CU,5747,5747,327,561,-234,0.09761615,0.056899253,-0.040716894
2017.0,CU,5678,5678,359,537,-178,0.094575554,0.06322649,-0.031349067
2018.0,CU,5717,5717,447,641,-194,0.11212174,0.07818786,-0.03393388
2019.0,CU,5609,5609,458,663,-205,0.11820289,0.08165448,-0.036548406
2020.0,CU,5163,5163,404,500,-96,0.09684292,0.07824908,-0.01859384
2021.0,CU,4491,4491,300,360,-60,0.08016032,0.06680027,-0.013360053
2022.0,CU,0,0,110,171,-61,,,
1996.0,CV,1,1,0,0,0,0.0,0.0,0.0
1999.0,CV,2,2,1,1,0,0.5,0.5,0.0
2006.0,CV,4,4,0,0,0,0.0,0.0,0.0
2007.0,CV,6,6,2,0,2,0.0,0.33333334,0.33333334
2011.0,CV,22,22,3,1,2,0.045454547,0.13636364,0.09090909
2012.0,CV,27,27,2,2,0,0.074074075,0.074074075,0.0
2013.0,CV,33,33,4,3,1,0.09090909,0.121212125,0.030303031
2014.0,CV,40,40,4,2,2,0.05,0.1,0.05
2015.0,CV,44,44,5,2,3,0.045454547,0.11363637,0.06818182
2016.0,CV,36,36,3,6,-3,0.16666667,0.083333336,-0.083333336
2017.0,CV,32,32,3,8,-5,0.25,0.09375,-0.15625
2018.0,CV,40,40,4,7,-3,0.175,0.1,-0.075
2019.0,CV,49,49,10,1,9,0.020408163,0.20408164,0.18367347
2020.0,CV,47,47,6,6,0,0.12765957,0.12765957,0.0
2021.0,CV,44,44,4,3,1,0.06818182,0.09090909,0.022727273
1996.0,CW,52,52,0,0,0,0.0,0.0,0.0
1997.0,CW,68,68,5,0,5,0.0,0.073529415,0.073529415
1998.0,CW,75,75,6,5,1,0.06666667,0.08,0.013333334
1999.0,CW,75,75,5,7,-2,0.093333334,0.06666667,-0.026666667
2000.0,CW,83,83,9,5,4,0.060240965,0.10843374,0.04819277
2001.0,CW,93,93,8,5,3,0.05376344,0.086021505,0.032258064
2002.0,CW,101,101,7,9,-2,0.089108914,0.06930693,-0.01980198
2003.0,CW,125,125,20,7,13,0.056,0.16,0.104
2004.0,CW,141,141,17,10,7,0.07092199,0.120567374,0.04964539
2005.0,CW,142,142,8,19,-11,0.13380282,0.056338027,-0.07746479
2006.0,CW,162,162,14,10,4,0.061728396,0.086419754,0.024691358
2007.0,CW,175,175,14,18,-4,0.10285714,0.08,-0.022857143
2008.0,CW,162,162,7,20,-13,0.12345679,0.043209877,-0.08024691
2009.0,CW,171,171,27,27,0,0.15789473,0.15789473,0.0
2010.0,CW,176,176,23,21,2,0.11931818,0.13068181,0.011363637
2011.0,CW,199,199,38,28,10,0.14070351,0.19095477,0.050251257
2012.0,CW,205,205,22,14,8,0.068292685,0.107317075,0.03902439
2013.0,CW,215,215,25,27,-2,0.1255814,0.11627907,-0.009302326
2014.0,CW,212,212,22,30,-8,0.14150943,0.10377359,-0.03773585
2015.0,CW,196,196,21,39,-18,0.19897959,0.10714286,-0.091836736
2016.0,CW,157,157,12,44,-32,0.28025478,0.07643312,-0.20382166
2017.0,CW,137,137,16,26,-10,0.18978103,0.11678832,-0.0729927
2018.0,CW,105,105,18,38,-20,0.36190477,0.17142858,-0.1904762
2019.0,CW,95,95,16,24,-8,0.25263157,0.16842106,-0.08421053
2020.0,CW,91,91,20,21,-1,0.23076923,0.21978022,-0.010989011
2021.0,CW,82,82,8,11,-3,0.13414635,0.09756097,-0.036585364
1996.0,CY,216,216,0,0,0,0.0,0.0,0.0
1997.0,CY,275,275,9,5,4,0.018181818,0.03272727,0.014545455
1998.0,CY,349,349,16,10,6,0.028653296,0.045845274,0.017191976
1999.0,CY,398,398,24,10,14,0.025125628,0.06030151,0.03517588
2000.0,CY,458,458,28,14,14,0.030567685,0.06113537,0.030567685
2001.0,CY,494,494,19,21,-2,0.042510122,0.03846154,-0.004048583
2002.0,CY,538,538,29,28,1,0.05204461,0.053903345,0.001858736
2003.0,CY,594,594,33,26,7,0.043771043,0.055555556,0.011784512
2004.0,CY,681,681,55,27,28,0.039647575,0.080763586,0.041116007
2005.0,CY,822,822,62,20,42,0.024330901,0.07542579,0.05109489
2006.0,CY,961,961,68,48,20,0.04994797,0.070759624,0.020811655
2007.0,CY,1152,1152,97,47,50,0.040798612,0.08420139,0.043402776
2008.0,CY,1270,1270,88,47,41,0.037007876,0.06929134,0.032283466
2009.0,CY,1460,1460,129,55,74,0.037671234,0.08835617,0.050684933
2010.0,CY,1698,1698,140,65,75,0.03828033,0.08244994,0.044169612
2011.0,CY,1957,1957,163,89,74,0.04547777,0.08329075,0.037812978
2012.0,CY,2147,2147,195,108,87,0.050302748,0.0908244,0.04052166
2013.0,CY,2413,2413,204,118,86,0.04890178,0.084542066,0.03564028
2014.0,CY,2712,2712,225,160,65,0.05899705,0.0829646,0.023967551
2015.0,CY,2969,2969,223,144,79,0.04850118,0.07510947,0.026608286
2016.0,CY,3239,3239,264,165,99,0.05094165,0.08150664,0.03056499
2017.0,CY,3464,3464,291,194,97,0.056004617,0.08400693,0.028002309
2018.0,CY,3742,3742,319,214,105,0.057188667,0.08524853,0.02805986
2019.0,CY,3887,3887,342,296,46,0.076151274,0.08798559,0.01183432
2020.0,CY,3857,3857,351,231,120,0.05989111,0.09100337,0.031112263
2021.0,CY,3623,3623,216,209,7,0.057687,0.0596191,0.0019321005
2022.0,CY,0,0,151,159,-8,,,
1996.0,CZ,6145,6145,0,0,0,0.0,0.0,0.0
1997.0,CZ,7367,7367,162,141,21,0.019139405,0.021989955,0.0028505498
1998.0,CZ,8716,8716,241,228,13,0.02615879,0.027650299,0.0014915098
1999.0,CZ,9427,9427,250,238,12,0.025246631,0.026519572,0.0012729394
2000.0,CZ,10078,10078,261,260,1,0.02579877,0.025897997,9.922604e-05
2001.0,CZ,10937,10937,286,324,-38,0.02962421,0.026149767,-0.0034744446
2002.0,CZ,12173,12173,339,389,-50,0.03195597,0.027848518,-0.004107451
2003.0,CZ,13270,13270,399,372,27,0.028033158,0.030067822,0.0020346646
2004.0,CZ,14675,14675,454,435,19,0.029642249,0.030936968,0.0012947189
2005.0,CZ,16188,16188,501,518,-17,0.03199901,0.030948851,-0.0010501606
2006.0,CZ,17647,17647,553,575,-22,0.03258344,0.03133677,-0.0012466708
2007.0,CZ,19070,19070,584,604,-20,0.031672783,0.030624017,-0.0010487677
2008.0,CZ,20828,20828,768,658,110,0.031592086,0.03687344,0.005281352
2009.0,CZ,22353,22353,753,712,41,0.031852547,0.033686753,0.0018342057
2010.0,CZ,24038,24038,724,713,11,0.029661369,0.030118978,0.00045760878
2011.0,CZ,25993,25993,848,749,99,0.02881545,0.032624166,0.0038087177
2012.0,CZ,27992,27992,838,807,31,0.028829666,0.029937126,0.0011074593
2013.0,CZ,29583,29583,967,823,144,0.027820032,0.032687694,0.0048676603
2014.0,CZ,31556,31556,1088,865,223,0.027411586,0.03447839,0.0070668017
2015.0,CZ,32898,32898,1105,974,131,0.029606663,0.033588666,0.003982005
2016.0,CZ,33837,33837,1167,1066,101,0.031503975,0.03448887,0.0029848982
2017.0,CZ,34551,34551,1176,1149,27,0.03325519,0.03403664,0.0007814535
2018.0,CZ,34941,34941,1247,1147,100,0.032826766,0.03568873,0.0028619673
2019.0,CZ,34773,34773,1380,1211,169,0.03482587,0.039685965,0.0048600924
2020.0,CZ,33336,33336,1277,1182,95,0.035457164,0.038306937,0.002849772
2021.0,CZ,30828,30828,1020,946,74,0.03068639,0.033086803,0.0024004153
2022.0,CZ,0,0,716,602,114,,,
1996.0,DE,99679,99679,0,0,0,0.0,0.0,0.0
1997.0,DE,117291,117291,2925,2891,34,0.024648098,0.024937974,0.00028987732
1998.0,DE,133861,133861,3762,3849,-87,0.028753707,0.02810378,-0.0006499279
1999.0,DE,141206,141206,3927,4252,-325,0.030112036,0.027810434,-0.002301602
2000.0,DE,147652,147652,4398,4658,-260,0.03154715,0.029786253,-0.0017608972
2001.0,DE,153124,153124,4758,4993,-235,0.03260756,0.031072857,-0.0015347039
2002.0,DE,159350,159350,5149,5240,-91,0.03288359,0.03231252,-0.00057106995
2003.0,DE,165899,165899,5448,5748,-300,0.034647588,0.032839257,-0.0018083291
2004.0,DE,173828,173828,5820,6322,-502,0.036369283,0.03348137,-0.002887912
2005.0,DE,181817,181817,6016,6601,-585,0.036305737,0.033088215,-0.003217521
2006.0,DE,190746,190746,6249,7361,-1112,0.038590588,0.032760844,-0.005829742
2007.0,DE,201401,201401,6836,7997,-1161,0.039706852,0.033942234,-0.005764619
2008.0,DE,214279,214279,7704,8158,-454,0.03807186,0.035953127,-0.002118733
2009.0,DE,224871,224871,8297,8608,-311,0.038279723,0.03689671,-0.0013830152
2010.0,DE,236854,236854,8768,8910,-142,0.03761811,0.037018586,-0.00059952546
2011.0,DE,247843,247843,8929,9718,-789,0.03921031,0.03602684,-0.0031834668
2012.0,DE,258212,258212,9405,9898,-493,0.038332842,0.03642356,-0.0019092838
2013.0,DE,265950,265950,9797,10330,-533,0.03884189,0.036837753,-0.002004136
2014.0,DE,276584,276584,10456,10721,-265,0.038762186,0.037804067,-0.0009581176
2015.0,DE,286048,286048,10637,10640,-3,0.037196554,0.037186068,-1.048775e-05
2016.0,DE,292827,292827,10925,11143,-218,0.038053185,0.03730872,-0.00074446684
2017.0,DE,298460,298460,11386,11358,28,0.03805535,0.038149167,9.381492e-05
2018.0,DE,302825,302825,11859,11799,60,0.038963098,0.03916123,0.00019813424
2019.0,DE,301826,301826,12297,12210,87,0.040453773,0.040742017,0.00028824556
2020.0,DE,286543,286543,11320,11289,31,0.03939723,0.039505415,0.00010818621
2021.0,DE,264095,264095,8901,8518,383,0.032253545,0.03370378,0.0014502357
2022.0,DE,0,0,6009,6011,-2,,,
2023.0,DE,0,0,403,412,-9,,,
1997.0,DJ,1,1,0,0,0,0.0,0.0,0.0
2003.0,DJ,4,4,0,0,0,0.0,0.0,0.0
2007.0,DJ,2,2,0,0,0,0.0,0.0,0.0
2008.0,DJ,4,4,1,0,1,0.0,0.25,0.25
2010.0,DJ,11,11,3,0,3,0.0,0.27272728,0.27272728
2011.0,DJ,8,8,0,3,-3,0.375,0.0,-0.375
2012.0,DJ,9,9,2,0,2,0.0,0.22222222,0.22222222
2015.0,DJ,14,14,4,2,2,0.14285715,0.2857143,0.14285715
2017.0,DJ,16,16,1,1,0,0.0625,0.0625,0.0
2018.0,DJ,18,18,3,1,2,0.055555556,0.16666667,0.11111111
2020.0,DJ,19,19,3,4,-1,0.21052632,0.15789473,-0.05263158
2021.0,DJ,17,17,1,2,-1,0.11764706,0.05882353,-0.05882353
1996.0,DK,9473,9473,0,0,0,0.0,0.0,0.0
1997.0,DK,10904,10904,382,359,23,0.0329237,0.035033014,0.0021093176
1998.0,DK,12296,12296,482,466,16,0.037898503,0.03919974,0.0013012362
1999.0,DK,12777,12777,494,487,7,0.038115364,0.038663223,0.0005478594
2000.0,DK,13337,13337,530,530,0,0.039739072,0.039739072,0.0
2001.0,DK,13932,13932,580,560,20,0.040195234,0.04163078,0.0014355441
2002.0,DK,14655,14655,600,617,-17,0.04210167,0.04094166,-0.0011600136
2003.0,DK,15450,15450,641,636,5,0.04116505,0.041488674,0.00032362458
2004.0,DK,16239,16239,685,718,-33,0.044214547,0.0421824,-0.002032145
2005.0,DK,17315,17315,729,694,35,0.040080857,0.042102225,0.0020213688
2006.0,DK,18873,18873,909,749,160,0.039686326,0.048164044,0.0084777195
2007.0,DK,21594,21594,1224,755,469,0.034963414,0.05668241,0.021718996
2008.0,DK,23322,23322,1208,808,400,0.0346454,0.051796585,0.017151188
2009.0,DK,25096,25096,1263,870,393,0.03466688,0.050326746,0.015659867
2010.0,DK,26810,26810,1209,1003,206,0.037411414,0.045095112,0.0076837
2011.0,DK,28587,28587,1265,1068,197,0.03735964,0.044250883,0.006891244
2012.0,DK,29315,29315,1262,1134,128,0.03868327,0.043049634,0.0043663653
2013.0,DK,31361,31361,1511,1187,324,0.037849557,0.048180863,0.010331303
2014.0,DK,33208,33208,1577,1310,267,0.039448325,0.047488555,0.008040232
2015.0,DK,34889,34889,1625,1421,204,0.04072917,0.046576284,0.005847115
2016.0,DK,36165,36165,1764,1543,221,0.04266556,0.04877644,0.0061108805
2017.0,DK,36975,36975,1720,1692,28,0.04576065,0.046517916,0.0007572684
2018.0,DK,37633,37633,1936,1764,172,0.046873756,0.05144421,0.0045704567
2019.0,DK,37878,37878,1973,1783,190,0.04707218,0.052088283,0.0050161043
2020.0,DK,36611,36611,1996,1725,271,0.047116987,0.05451913,0.0074021467
2021.0,DK,34471,34471,1638,1370,268,0.039743554,0.047518205,0.007774651
2022.0,DK,0,0,1141,932,209,,,
2023.0,DK,0,0,105,77,28,,,
1996.0,DO,57,57,0,0,0,0.0,0.0,0.0
1997.0,DO,70,70,2,2,0,0.028571429,0.028571429,0.0
1998.0,DO,76,76,1,3,-2,0.039473683,0.013157895,-0.02631579
1999.0,DO,84,84,1,3,-2,0.035714287,0.011904762,-0.023809524
2000.0,DO,81,81,3,4,-1,0.049382716,0.037037037,-0.012345679
2001.0,DO,79,79,7,4,3,0.050632913,0.088607594,0.03797468
2002.0,DO,83,83,11,4,7,0.04819277,0.13253012,0.084337346
2003.0,DO,82,82,1,7,-6,0.085365854,0.0121951215,-0.07317073
2004.0,DO,77,77,4,12,-8,0.15584415,0.051948052,-0.103896104
2005.0,DO,83,83,8,6,2,0.072289154,0.09638554,0.024096385
2006.0,DO,85,85,3,12,-9,0.14117648,0.03529412,-0.105882354
2007.0,DO,93,93,8,3,5,0.032258064,0.086021505,0.05376344
2008.0,DO,105,105,7,6,1,0.057142857,0.06666667,0.00952381
2009.0,DO,113,113,8,19,-11,0.16814159,0.07079646,-0.097345136
2010.0,DO,123,123,13,8,5,0.06504065,0.10569106,0.040650405
2011.0,DO,147,147,19,15,4,0.10204082,0.1292517,0.027210884
2012.0,DO,185,185,35,24,11,0.12972973,0.1891892,0.05945946
2013.0,DO,215,215,28,19,9,0.0883721,0.13023256,0.041860465
2014.0,DO,243,243,32,29,3,0.11934157,0.13168724,0.012345679
2015.0,DO,262,262,40,37,3,0.14122137,0.15267175,0.011450382
2016.0,DO,282,282,25,38,-13,0.13475177,0.088652484,-0.04609929
2017.0,DO,367,367,59,30,29,0.081743866,0.16076294,0.07901908
2018.0,DO,438,438,78,43,35,0.098173514,0.1780822,0.07990868
2019.0,DO,479,479,77,33,44,0.06889353,0.16075157,0.09185804
2020.0,DO,469,469,73,61,12,0.13006397,0.15565032,0.025586354
2021.0,DO,460,460,46,29,17,0.063043475,0.1,0.036956523
1996.0,DZ,485,485,0,0,0,0.0,0.0,0.0
1997.0,DZ,678,678,13,12,1,0.017699115,0.019174041,0.0014749262
1998.0,DZ,868,868,28,22,6,0.025345622,0.032258064,0.0069124424
1999.0,DZ,998,998,29,25,4,0.0250501,0.029058116,0.004008016
2000.0,DZ,1212,1212,38,23,15,0.018976897,0.031353135,0.012376238
2001.0,DZ,1406,1406,37,36,1,0.025604552,0.02631579,0.00071123755
2002.0,DZ,1697,1697,46,42,4,0.024749558,0.02710666,0.0023571008
2003.0,DZ,2058,2058,56,48,8,0.023323616,0.027210884,0.0038872692
2004.0,DZ,2460,2460,59,65,-6,0.026422765,0.02398374,-0.0024390244
2005.0,DZ,2953,2953,77,82,-5,0.027768372,0.026075177,-0.0016931933
2006.0,DZ,3581,3581,101,82,19,0.022898631,0.028204411,0.0053057806
2007.0,DZ,4256,4256,98,110,-12,0.025845865,0.023026315,-0.0028195488
2008.0,DZ,4852,4852,148,107,41,0.022052761,0.030502886,0.0084501235
2009.0,DZ,5585,5585,170,131,39,0.023455685,0.030438675,0.00698299
2010.0,DZ,6528,6528,193,160,33,0.024509804,0.02956495,0.005055147
2011.0,DZ,7837,7837,248,158,90,0.020160776,0.03164476,0.011483986
2012.0,DZ,9223,9223,296,172,124,0.01864903,0.032093678,0.013444649
2013.0,DZ,10548,10548,292,177,115,0.016780432,0.027682973,0.010902541
2014.0,DZ,12013,12013,385,239,146,0.019895114,0.032048613,0.012153501
2015.0,DZ,13352,13352,397,296,101,0.022168964,0.029733373,0.0075644096
2016.0,DZ,14420,14420,448,304,144,0.021081831,0.031067962,0.0099861305
2017.0,DZ,15277,15277,485,332,153,0.021732016,0.03174707,0.010015056
2018.0,DZ,16100,16100,551,424,127,0.026335403,0.0342236,0.007888199
2019.0,DZ,16407,16407,609,487,122,0.029682452,0.037118305,0.0074358503
2020.0,DZ,15723,15723,465,455,10,0.028938498,0.029574508,0.00063601095
2021.0,DZ,14322,14322,281,348,-67,0.024298282,0.019620165,-0.0046781176
2022.0,DZ,0,0,202,184,18,,,
1996.0,EC,148,148,0,0,0,0.0,0.0,0.0
1997.0,EC,196,196,7,4,3,0.020408163,0.035714287,0.015306123
1998.0,EC,276,276,14,9,5,0.032608695,0.050724637,0.018115941
1999.0,EC,309,309,15,22,-7,0.07119741,0.048543688,-0.022653721
2000.0,EC,391,391,24,16,8,0.040920716,0.061381076,0.020460358
2001.0,EC,478,478,22,25,-3,0.052301254,0.046025105,-0.0062761507
2002.0,EC,516,516,31,29,2,0.05620155,0.06007752,0.003875969
2003.0,EC,560,560,38,46,-8,0.08214286,0.067857146,-0.014285714
2004.0,EC,631,631,35,50,-15,0.0792393,0.055467512,-0.02377179
2005.0,EC,701,701,49,55,-6,0.078459345,0.06990014,-0.008559201
2006.0,EC,822,822,78,53,25,0.064476885,0.09489051,0.030413626
2007.0,EC,948,948,78,67,11,0.070675105,0.08227848,0.011603376
2008.0,EC,1081,1081,100,81,19,0.07493062,0.09250694,0.017576318
2009.0,EC,1197,1197,106,112,-6,0.09356725,0.08855472,-0.0050125313
2010.0,EC,1403,1403,124,127,-3,0.090520315,0.088382035,-0.0021382752
2011.0,EC,1587,1587,141,132,9,0.0831758,0.08884688,0.0056710774
2012.0,EC,2015,2015,184,150,34,0.074441686,0.091315135,0.01687345
2013.0,EC,2730,2730,322,181,141,0.06630037,0.11794872,0.051648352
2014.0,EC,3980,3980,461,242,219,0.06080402,0.11582915,0.055025127
2015.0,EC,5734,5734,733,294,439,0.051273108,0.12783398,0.07656086
2016.0,EC,7506,7506,941,419,522,0.055822007,0.12536637,0.06954437
2017.0,EC,8989,8989,1152,614,538,0.06830571,0.12815663,0.059850927
2018.0,EC,10351,10351,1240,791,449,0.07641774,0.11979519,0.04337745
2019.0,EC,10864,10864,1364,1085,279,0.099871136,0.12555228,0.02568115
2020.0,EC,10497,10497,1100,1021,79,0.097265884,0.10479184,0.00752596
2021.0,EC,9468,9468,749,866,-117,0.09146599,0.07910857,-0.012357415
2022.0,EC,0,0,364,425,-61,,,
1996.0,EE,798,798,0,0,0,0.0,0.0,0.0
1997.0,EE,967,967,17,22,-5,0.022750776,0.017580144,-0.0051706308
1998.0,EE,1175,1175,42,23,19,0.019574469,0.035744682,0.016170213
1999.0,EE,1322,1322,43,26,17,0.019667171,0.032526474,0.012859304
2000.0,EE,1454,1454,36,41,-5,0.028198075,0.024759285,-0.0034387896
2001.0,EE,1631,1631,32,34,-2,0.020846106,0.019619865,-0.0012262416
2002.0,EE,1788,1788,46,35,11,0.019574944,0.025727069,0.006152125
2003.0,EE,1986,1986,53,47,6,0.02366566,0.026686808,0.003021148
2004.0,EE,2263,2263,74,41,33,0.018117543,0.032699957,0.014582412
2005.0,EE,2535,2535,77,49,28,0.019329388,0.030374754,0.011045365
2006.0,EE,2820,2820,95,55,40,0.019503547,0.03368794,0.014184397
2007.0,EE,3156,3156,94,65,29,0.02059569,0.029784538,0.009188847
2008.0,EE,3462,3462,110,84,26,0.024263432,0.03177354,0.00751011
2009.0,EE,3781,3781,131,78,53,0.020629464,0.034646917,0.014017455
2010.0,EE,4096,4096,136,90,46,0.021972656,0.033203125,0.011230469
2011.0,EE,4450,4450,138,101,37,0.02269663,0.031011237,0.008314607
2012.0,EE,4865,4865,159,109,50,0.022404933,0.032682426,0.010277492
2013.0,EE,5106,5106,171,132,39,0.025851939,0.033490013,0.007638073
2014.0,EE,5261,5261,165,150,15,0.02851169,0.031362858,0.002851169
2015.0,EE,5385,5385,159,177,-18,0.032869082,0.029526463,-0.0033426185
2016.0,EE,5412,5412,192,171,21,0.031596452,0.035476718,0.003880266
2017.0,EE,5392,5392,247,201,46,0.03727745,0.045808606,0.008531157
2018.0,EE,5356,5356,221,208,13,0.03883495,0.041262135,0.0024271845
2019.0,EE,5247,5247,230,219,11,0.041738138,0.04383457,0.002096436
2020.0,EE,4994,4994,259,199,60,0.039847817,0.051862236,0.012014417
2021.0,EE,4592,4592,185,147,38,0.032012194,0.040287457,0.008275261
2022.0,EE,0,0,125,99,26,,,
1996.0,EG,4355,4355,0,0,0,0.0,0.0,0.0
1997.0,EG,5391,5391,112,103,9,0.019105917,0.020775367,0.001669449
1998.0,EG,6308,6308,169,150,19,0.023779327,0.026791375,0.003012048
1999.0,EG,6689,6689,164,163,1,0.024368366,0.024517866,0.00014949917
2000.0,EG,7258,7258,203,126,77,0.017360155,0.027969137,0.010608983
2001.0,EG,7837,7837,223,205,18,0.026157968,0.028454766,0.0022967972
2002.0,EG,8371,8371,251,215,36,0.02568391,0.02998447,0.0043005613
2003.0,EG,9185,9185,282,221,61,0.024060968,0.030702231,0.006641263
2004.0,EG,10162,10162,335,288,47,0.028340878,0.03296595,0.0046250736
2005.0,EG,11358,11358,372,322,50,0.02835006,0.032752246,0.0044021835
2006.0,EG,12675,12675,412,334,78,0.026351085,0.03250493,0.006153846
2007.0,EG,14866,14866,508,399,109,0.026839769,0.034171935,0.0073321676
2008.0,EG,17414,17414,579,486,93,0.027908579,0.03324911,0.0053405305
2009.0,EG,19895,19895,638,626,12,0.03146519,0.03206836,0.00060316664
2010.0,EG,22525,22525,739,704,35,0.03125416,0.03280799,0.0015538291
2011.0,EG,25996,25996,897,825,72,0.03173565,0.034505308,0.002769657
2012.0,EG,29392,29392,1085,966,119,0.032866087,0.036914807,0.004048721
2013.0,EG,32885,32885,1122,983,139,0.029892048,0.0341189,0.0042268513
2014.0,EG,37044,37044,1355,1099,256,0.029667422,0.036578123,0.006910701
2015.0,EG,41245,41245,1494,1258,236,0.030500667,0.036222573,0.0057219057
2016.0,EG,45458,45458,1714,1376,338,0.0302697,0.037705135,0.007435435
2017.0,EG,49656,49656,1834,1577,257,0.0317585,0.036934108,0.005175608
2018.0,EG,53583,53583,1987,1691,296,0.031558517,0.037082657,0.0055241403
2019.0,EG,55701,55701,2250,1974,276,0.03543922,0.040394247,0.0049550277
2020.0,EG,54952,54952,2123,2024,99,0.036832143,0.038633715,0.0018015723
2021.0,EG,51954,51954,1720,1775,-55,0.03416484,0.033106208,-0.0010586288
2022.0,EG,0,0,1169,1305,-136,,,
2023.0,EG,0,0,82,124,-42,,,
1996.0,ER,5,5,0,0,0,0.0,0.0,0.0
1998.0,ER,13,13,1,0,1,0.0,0.07692308,0.07692308
1999.0,ER,13,13,1,2,-1,0.15384616,0.07692308,-0.07692308
2000.0,ER,19,19,3,2,1,0.10526316,0.15789473,0.05263158
2001.0,ER,21,21,0,0,0,0.0,0.0,0.0
2002.0,ER,23,23,2,1,1,0.04347826,0.08695652,0.04347826
2003.0,ER,36,36,5,0,5,0.0,0.1388889,0.1388889
2004.0,ER,40,40,2,1,1,0.025,0.05,0.025
2005.0,ER,41,41,3,4,-1,0.09756097,0.07317073,-0.024390243
2006.0,ER,39,39,2,4,-2,0.102564104,0.051282052,-0.051282052
2007.0,ER,32,32,2,8,-6,0.25,0.0625,-0.1875
2009.0,ER,25,25,1,4,-3,0.16,0.04,-0.12
2010.0,ER,25,25,3,3,0,0.12,0.12,0.0
2011.0,ER,26,26,2,3,-1,0.115384616,0.07692308,-0.03846154
2012.0,ER,21,21,1,8,-7,0.3809524,0.04761905,-0.33333334
2013.0,ER,22,22,1,1,0,0.045454547,0.045454547,0.0
2015.0,ER,28,28,3,0,3,0.0,0.10714286,0.10714286
2016.0,ER,44,44,7,0,7,0.0,0.1590909,0.1590909
2017.0,ER,56,56,4,7,-3,0.125,0.071428575,-0.05357143
2018.0,ER,61,61,3,6,-3,0.09836066,0.04918033,-0.04918033
2019.0,ER,63,63,9,6,3,0.0952381,0.14285715,0.04761905
2020.0,ER,55,55,0,9,-9,0.16363636,0.0,-0.16363636
2021.0,ER,45,45,1,5,-4,0.11111111,0.022222223,-0.08888889
1996.0,ES,44674,44674,0,0,0,0.0,0.0,0.0
1997.0,ES,53699,53699,1025,1001,24,0.018640943,0.019087879,0.0004469357
1998.0,ES,64168,64168,1350,1350,0,0.021038523,0.021038523,0.0
1999.0,ES,70929,70929,1538,1525,13,0.021500373,0.021683656,0.00018328187
2000.0,ES,77512,77512,1767,1737,30,0.022409433,0.02279647,0.00038703685
2001.0,ES,84049,84049,2019,1916,103,0.022796227,0.024021702,0.0012254756
2002.0,ES,91217,91217,2143,2029,114,0.02224366,0.023493428,0.001249767
2003.0,ES,98067,98067,2402,2336,66,0.023820449,0.024493458,0.00067300926
2004.0,ES,106057,106057,2604,2622,-18,0.024722556,0.024552835,-0.00016972005
2005.0,ES,113589,113589,2882,2697,185,0.023743497,0.025372175,0.0016286789
2006.0,ES,121753,121753,3224,3080,144,0.025297118,0.02647984,0.0011827224
2007.0,ES,130580,130580,3753,3609,144,0.027638229,0.028741002,0.0011027722
2008.0,ES,139803,139803,4039,3872,167,0.027696116,0.028890653,0.0011945381
2009.0,ES,149077,149077,4572,4234,338,0.02840143,0.030668715,0.0022672848
2010.0,ES,159310,159310,4956,4656,300,0.029226037,0.031109158,0.001883121
2011.0,ES,169445,169445,5119,5242,-123,0.030936291,0.030210393,-0.00072589924
2012.0,ES,178162,178162,5481,5847,-366,0.032818448,0.030764136,-0.0020543102
2013.0,ES,185902,185902,5717,6447,-730,0.03467956,0.030752761,-0.0039268
2014.0,ES,191828,191828,5715,7300,-1585,0.038054924,0.029792314,-0.00826261
2015.0,ES,198407,198407,6104,7733,-1629,0.03897544,0.030765044,-0.008210395
2016.0,ES,200410,200410,6212,8260,-2048,0.04121551,0.030996457,-0.010219051
2017.0,ES,204096,204096,6678,7964,-1286,0.03902085,0.032719895,-0.0063009565
2018.0,ES,207857,207857,7066,8539,-1473,0.041081127,0.033994526,-0.007086603
2019.0,ES,209169,209169,7803,8205,-402,0.039226655,0.037304763,-0.0019218909
2020.0,ES,199997,199997,7305,7351,-46,0.03675555,0.036525548,-0.00023000345
2021.0,ES,186187,186187,5962,5473,489,0.029395178,0.03202157,0.0026263918
2022.0,ES,0,0,3932,3671,261,,,
2023.0,ES,0,0,245,230,15,,,
1996.0,ET,536,536,0,0,0,0.0,0.0,0.0
1997.0,ET,621,621,42,79,-37,0.12721416,0.06763285,-0.05958132
1998.0,ET,729,729,62,69,-7,0.09465021,0.08504801,-0.009602195
1999.0,ET,771,771,67,96,-29,0.12451362,0.08690013,-0.03761349
2000.0,ET,845,845,68,92,-24,0.10887574,0.08047337,-0.028402368
2001.0,ET,841,841,65,118,-53,0.14030915,0.07728894,-0.063020214
2002.0,ET,908,908,88,104,-16,0.11453745,0.0969163,-0.017621145
2003.0,ET,961,961,103,124,-21,0.12903225,0.10718002,-0.021852238
2004.0,ET,1082,1082,107,133,-26,0.12292052,0.098890945,-0.024029575
2005.0,ET,1245,1245,146,125,21,0.10040161,0.11726908,0.01686747
2006.0,ET,1448,1448,145,149,-4,0.10290055,0.10013812,-0.002762431
2007.0,ET,1633,1633,185,166,19,0.1016534,0.113288425,0.011635028
2008.0,ET,1783,1783,164,207,-43,0.11609647,0.09197981,-0.024116658
2009.0,ET,1951,1951,176,226,-50,0.11583803,0.09021015,-0.025627883
2010.0,ET,2202,2202,171,237,-66,0.107629426,0.07765668,-0.029972753
2011.0,ET,2685,2685,194,249,-55,0.09273743,0.07225326,-0.020484172
2012.0,ET,3323,3323,208,224,-16,0.06740897,0.06259404,-0.004814926
2013.0,ET,3987,3987,229,253,-24,0.06345623,0.057436667,-0.0060195634
2014.0,ET,4762,4762,277,297,-20,0.062368754,0.058168836,-0.004199916
2015.0,ET,5694,5694,325,298,27,0.05233579,0.057077624,0.0047418335
2016.0,ET,6805,6805,379,334,45,0.049081556,0.05569434,0.0066127847
2017.0,ET,8147,8147,417,386,31,0.047379404,0.051184487,0.0038050816
2018.0,ET,9845,9845,522,412,110,0.041848656,0.053021837,0.011173184
2019.0,ET,11148,11148,550,465,85,0.041711517,0.049336202,0.007624686
2020.0,ET,11241,11241,544,464,80,0.04127747,0.04839427,0.0071168044
2021.0,ET,10893,10893,493,384,109,0.035251997,0.04525842,0.010006426
2022.0,ET,0,0,300,334,-34,,,
1996.0,FI,11239,11239,0,0,0,0.0,0.0,0.0
1997.0,FI,13245,13245,234,230,4,0.017365044,0.017667044,0.00030200076
1998.0,FI,15085,15085,294,265,29,0.01756712,0.019489558,0.0019224396
1999.0,FI,15997,15997,321,298,23,0.018628493,0.020066263,0.0014377696
2000.0,FI,16904,16904,321,342,-21,0.020231897,0.018989589,-0.0012423095
2001.0,FI,17844,17844,348,370,-22,0.020735262,0.019502353,-0.0012329074
2002.0,FI,18711,18711,416,381,35,0.020362353,0.02223291,0.0018705574
2003.0,FI,19628,19628,406,424,-18,0.021601794,0.020684736,-0.0009170573
2004.0,FI,20672,20672,453,470,-17,0.022736069,0.0219137,-0.0008223684
2005.0,FI,21776,21776,504,481,23,0.022088537,0.023144746,0.0010562086
2006.0,FI,23076,23076,578,496,82,0.021494193,0.02504767,0.0035534755
2007.0,FI,25014,25014,636,532,104,0.02126809,0.025425762,0.0041576717
2008.0,FI,26179,26179,654,626,28,0.023912296,0.024981856,0.0010695596
2009.0,FI,27310,27310,772,637,135,0.02332479,0.028268034,0.004943244
2010.0,FI,28418,28418,736,688,48,0.024210008,0.025899079,0.0016890703
2011.0,FI,29528,29528,728,661,67,0.022385532,0.024654565,0.0022690329
2012.0,FI,29750,29750,766,738,28,0.024806723,0.025747899,0.0009411765
2013.0,FI,30850,30850,798,750,48,0.024311183,0.025867099,0.0015559157
2014.0,FI,31759,31759,834,823,11,0.025913915,0.026260274,0.00034635852
2015.0,FI,32544,32544,899,911,-12,0.02799287,0.02762414,-0.00036873156
2016.0,FI,32898,32898,874,971,-97,0.029515471,0.026566964,-0.0029485074
2017.0,FI,33089,33089,890,1063,-173,0.03212548,0.026897157,-0.0052283234
2018.0,FI,33263,33263,975,1040,-65,0.03126597,0.029311849,-0.0019541231
2019.0,FI,33143,33143,1116,990,126,0.02987056,0.03367227,0.0038017076
2020.0,FI,31743,31743,1155,984,171,0.03099896,0.036385976,0.0053870142
2021.0,FI,29680,29680,902,790,112,0.026617251,0.030390836,0.003773585
2022.0,FI,0,0,648,539,109,,,
1996.0,FJ,30,30,0,0,0,0.0,0.0,0.0
1997.0,FJ,36,36,4,2,2,0.055555556,0.11111111,0.055555556
1998.0,FJ,53,53,5,3,2,0.056603774,0.094339624,0.03773585
1999.0,FJ,65,65,8,3,5,0.046153847,0.12307692,0.07692308
2000.0,FJ,73,73,4,7,-3,0.09589041,0.05479452,-0.04109589
2001.0,FJ,81,81,7,7,0,0.086419754,0.086419754,0.0
2002.0,FJ,105,105,8,3,5,0.028571429,0.07619048,0.04761905
2003.0,FJ,116,116,10,8,2,0.06896552,0.0862069,0.01724138
2004.0,FJ,137,137,9,6,3,0.04379562,0.06569343,0.02189781
2005.0,FJ,167,167,19,8,11,0.047904193,0.11377245,0.065868266
2006.0,FJ,175,175,11,13,-2,0.074285716,0.06285714,-0.011428571
2007.0,FJ,181,181,10,6,4,0.03314917,0.055248618,0.022099448
2008.0,FJ,197,197,12,19,-7,0.0964467,0.060913704,-0.035532996
2009.0,FJ,188,188,9,17,-8,0.09042553,0.047872342,-0.04255319
2010.0,FJ,198,198,18,25,-7,0.12626262,0.09090909,-0.035353534
2011.0,FJ,201,201,13,18,-5,0.08955224,0.06467662,-0.024875622
2012.0,FJ,229,229,17,25,-8,0.1091703,0.074235804,-0.0349345
2013.0,FJ,233,233,16,21,-5,0.09012876,0.06866953,-0.021459227
2014.0,FJ,273,273,23,25,-2,0.09157509,0.08424909,-0.0073260074
2015.0,FJ,310,310,33,22,11,0.07096774,0.106451616,0.03548387
2016.0,FJ,336,336,30,23,7,0.06845238,0.08928572,0.020833334
2017.0,FJ,370,370,33,23,10,0.06216216,0.08918919,0.027027028
2018.0,FJ,407,407,35,42,-7,0.1031941,0.085995086,-0.017199017
2019.0,FJ,421,421,32,40,-8,0.095011875,0.076009504,-0.019002376
2020.0,FJ,414,414,50,38,12,0.09178744,0.12077295,0.028985508
2021.0,FJ,391,391,19,22,-3,0.056265984,0.04859335,-0.0076726344
2022.0,FJ,0,0,13,16,-3,,,
2000.0,FK,8,8,4,0,4,0.0,0.5,0.5
2001.0,FK,11,11,2,0,2,0.0,0.18181819,0.18181819
2002.0,FK,13,13,2,2,0,0.15384616,0.15384616,0.0
2003.0,FK,14,14,1,1,0,0.071428575,0.071428575,0.0
2004.0,FK,12,12,0,3,-3,0.25,0.0,-0.25
2005.0,FK,12,12,2,1,1,0.083333336,0.16666667,0.083333336
2006.0,FK,13,13,1,2,-1,0.15384616,0.07692308,-0.07692308
2008.0,FK,10,10,2,2,0,0.2,0.2,0.0
1996.0,FM,1,1,0,0,0,0.0,0.0,0.0
2001.0,FM,4,4,0,0,0,0.0,0.0,0.0
2003.0,FM,4,4,0,0,0,0.0,0.0,0.0
2006.0,FM,8,8,1,0,1,0.0,0.125,0.125
2008.0,FM,9,9,0,0,0,0.0,0.0,0.0
2014.0,FM,6,6,0,0,0,0.0,0.0,0.0
2015.0,FM,9,9,2,0,2,0.0,0.22222222,0.22222222
2017.0,FM,8,8,0,0,0,0.0,0.0,0.0
1996.0,FO,8,8,0,0,0,0.0,0.0,0.0
1997.0,FO,11,11,0,0,0,0.0,0.0,0.0
1998.0,FO,14,14,1,0,1,0.0,0.071428575,0.071428575
1999.0,FO,12,12,1,0,1,0.0,0.083333336,0.083333336
2000.0,FO,16,16,0,1,-1,0.0625,0.0,-0.0625
2002.0,FO,19,19,2,3,-1,0.15789473,0.10526316,-0.05263158
2003.0,FO,23,23,0,0,0,0.0,0.0,0.0
2004.0,FO,27,27,2,1,1,0.037037037,0.074074075,0.037037037
2005.0,FO,30,30,1,0,1,0.0,0.033333335,0.033333335
2006.0,FO,29,29,2,3,-1,0.10344828,0.06896552,-0.03448276
2007.0,FO,29,29,0,0,0,0.0,0.0,0.0
2008.0,FO,36,36,4,2,2,0.055555556,0.11111111,0.055555556
2009.0,FO,44,44,7,2,5,0.045454547,0.1590909,0.11363637
2010.0,FO,49,49,4,4,0,0.08163265,0.08163265,0.0
2011.0,FO,52,52,5,3,2,0.057692308,0.09615385,0.03846154
2012.0,FO,60,60,3,1,2,0.016666668,0.05,0.033333335
2013.0,FO,64,64,2,3,-1,0.046875,0.03125,-0.015625
2014.0,FO,75,75,5,3,2,0.04,0.06666667,0.026666667
2015.0,FO,90,90,10,4,6,0.044444446,0.11111111,0.06666667
2016.0,FO,97,97,7,3,4,0.030927835,0.072164945,0.041237112
2017.0,FO,108,108,8,6,2,0.055555556,0.074074075,0.018518519
2018.0,FO,112,112,11,6,5,0.05357143,0.09821428,0.04464286
2019.0,FO,119,119,5,3,2,0.025210084,0.042016808,0.016806724
2020.0,FO,119,119,7,6,1,0.05042017,0.05882353,0.008403362
2021.0,FO,114,114,7,1,6,0.00877193,0.06140351,0.05263158
2022.0,FO,0,0,1,4,-3,,,
1996.0,FR,88641,88641,0,0,0,0.0,0.0,0.0
1997.0,FR,103057,103057,2097,2148,-51,0.020842835,0.020347962,-0.00049487175
1998.0,FR,115912,115912,2657,2993,-336,0.025821313,0.022922562,-0.0028987508
1999.0,FR,121769,121769,2896,3501,-605,0.02875116,0.023782736,-0.004968424
2000.0,FR,126530,126530,3103,3769,-666,0.029787403,0.024523828,-0.005263574
2001.0,FR,131225,131225,3556,4204,-648,0.03203658,0.027098496,-0.0049380832
2002.0,FR,138345,138345,3778,4396,-618,0.031775635,0.02730854,-0.004467093
2003.0,FR,145414,145414,4059,4780,-721,0.032871664,0.027913406,-0.004958257
2004.0,FR,153528,153528,4444,4922,-478,0.032059297,0.02894586,-0.0031134386
2005.0,FR,161958,161958,4896,5344,-448,0.032996207,0.03023006,-0.0027661494
2006.0,FR,171530,171530,5412,5904,-492,0.034419633,0.03155133,-0.0028683029
2007.0,FR,179998,179998,5928,6524,-596,0.036244847,0.0329337,-0.003311148
2008.0,FR,189115,189115,6583,6717,-134,0.035518073,0.034809507,-0.00070856354
2009.0,FR,197340,197340,6521,7011,-490,0.035527516,0.03304449,-0.0024830243
2010.0,FR,206580,206580,6985,7525,-540,0.036426567,0.033812568,-0.0026139994
2011.0,FR,215048,215048,7387,7961,-574,0.037019644,0.03435047,-0.0026691714
2012.0,FR,222709,222709,7434,8216,-782,0.03689119,0.033379883,-0.0035113085
2013.0,FR,228747,228747,7678,8562,-884,0.03743,0.03356547,-0.0038645316
2014.0,FR,234887,234887,7981,9131,-1150,0.03887401,0.03397804,-0.004895971
2015.0,FR,239632,239632,8277,9057,-780,0.037795454,0.034540463,-0.003254991
2016.0,FR,241929,241929,8409,9227,-818,0.038139287,0.034758132,-0.0033811573
2017.0,FR,241980,241980,8347,9490,-1143,0.039218117,0.034494586,-0.0047235307
2018.0,FR,241836,241836,8661,9852,-1191,0.04073835,0.035813525,-0.004924825
2019.0,FR,237235,237235,8569,10029,-1460,0.04227454,0.036120303,-0.0061542355
2020.0,FR,223633,223633,7878,8812,-934,0.039403845,0.03522736,-0.0041764854
2021.0,FR,205356,205356,6027,6497,-470,0.031637743,0.029349033,-0.0022887085
2022.0,FR,0,0,4062,4025,37,,,
2023.0,FR,0,0,230,225,5,,,
1996.0,GA,66,66,0,0,0,0.0,0.0,0.0
1997.0,GA,82,82,6,4,2,0.048780486,0.07317073,0.024390243
1998.0,GA,93,93,4,3,1,0.032258064,0.043010753,0.010752688
1999.0,GA,104,104,10,9,1,0.086538464,0.09615385,0.009615385
2000.0,GA,107,107,5,7,-2,0.06542056,0.046728972,-0.018691588
2001.0,GA,112,112,7,9,-2,0.08035714,0.0625,-0.017857144
2002.0,GA,125,125,3,5,-2,0.04,0.024,-0.016
2003.0,GA,133,133,9,14,-5,0.10526316,0.067669176,-0.037593983
2004.0,GA,132,132,9,9,0,0.06818182,0.06818182,0.0
2005.0,GA,139,139,9,13,-4,0.09352518,0.0647482,-0.02877698
2006.0,GA,155,155,18,13,5,0.08387097,0.11612903,0.032258064
2007.0,GA,177,177,15,12,3,0.06779661,0.084745765,0.016949153
2008.0,GA,195,195,15,19,-4,0.0974359,0.07692308,-0.020512821
2009.0,GA,201,201,14,20,-6,0.09950249,0.06965174,-0.029850746
2010.0,GA,223,223,19,12,7,0.05381166,0.08520179,0.031390134
2011.0,GA,242,242,17,22,-5,0.09090909,0.07024793,-0.020661157
2012.0,GA,268,268,27,23,4,0.0858209,0.10074627,0.014925373
2013.0,GA,298,298,25,25,0,0.08389262,0.08389262,0.0
2014.0,GA,349,349,36,19,17,0.054441262,0.103151865,0.048710603
2015.0,GA,400,400,37,25,12,0.0625,0.0925,0.03
2016.0,GA,437,437,30,29,1,0.066361554,0.06864989,0.0022883294
2017.0,GA,449,449,27,31,-4,0.06904232,0.06013363,-0.008908686
2018.0,GA,468,468,37,35,2,0.07478633,0.07905983,0.0042735045
2019.0,GA,468,468,39,32,7,0.06837607,0.083333336,0.014957265
2020.0,GA,441,441,20,31,-11,0.07029478,0.045351475,-0.02494331
2021.0,GA,402,402,23,28,-5,0.06965174,0.05721393,-0.012437811
2022.0,GA,0,0,17,8,9,,,
1996.0,GB,106157,106157,0,0,0,0.0,0.0,0.0
1997.0,GB,124839,124839,4908,4766,142,0.038177174,0.03931464,0.001137465
1998.0,GB,143265,143265,6294,6066,228,0.042341117,0.043932572,0.0015914564
1999.0,GB,149860,149860,7192,6691,501,0.044648338,0.04799146,0.0033431202
2000.0,GB,155624,155624,7474,7365,109,0.047325604,0.04802601,0.0007004061
2001.0,GB,161594,161594,8187,8251,-64,0.051060066,0.05066401,-0.0003960543
2002.0,GB,167309,167309,8591,8932,-341,0.05338625,0.051348105,-0.002038145
2003.0,GB,174587,174587,9176,9612,-436,0.055055644,0.05255832,-0.0024973222
2004.0,GB,182310,182310,9583,10237,-654,0.05615161,0.05256431,-0.0035872965
2005.0,GB,192513,192513,10713,10714,-1,0.055653386,0.05564819,-5.1944544e-06
2006.0,GB,202416,202416,11434,11586,-152,0.057238556,0.05648763,-0.00075092877
2007.0,GB,212496,212496,12370,12138,232,0.057121076,0.05821286,0.0010917853
2008.0,GB,220927,220927,13238,13261,-23,0.06002435,0.059920244,-0.00010410679
2009.0,GB,230069,230069,13622,13947,-325,0.060620945,0.059208326,-0.0014126197
2010.0,GB,237535,237535,14001,14755,-754,0.062117163,0.05894289,-0.003174269
2011.0,GB,246335,246335,14687,16003,-1316,0.06496438,0.05962206,-0.005342318
2012.0,GB,254348,254348,15062,16451,-1389,0.0646791,0.05921808,-0.005461022
2013.0,GB,261859,261859,16103,17082,-979,0.06523358,0.061494928,-0.0037386531
2014.0,GB,268101,268101,16765,17809,-1044,0.066426456,0.0625324,-0.0038940548
2015.0,GB,274863,274863,17590,18117,-527,0.065912835,0.06399552,-0.0019173188
2016.0,GB,279166,279166,18126,18102,24,0.06484314,0.06492911,8.597036e-05
2017.0,GB,283249,283249,18195,18946,-751,0.066888146,0.06423677,-0.0026513773
2018.0,GB,287968,287968,19756,20036,-280,0.06957717,0.06860484,-0.0009723303
2019.0,GB,287824,287824,19936,21100,-1164,0.07330869,0.06926455,-0.004044138
2020.0,GB,276186,276186,18533,19275,-742,0.069789924,0.06710333,-0.0026865953
2021.0,GB,256416,256416,14410,15004,-594,0.05851429,0.05619774,-0.002316548
2022.0,GB,0,0,10146,10554,-408,,,
2023.0,GB,0,0,803,615,188,,,
1996.0,GD,3,3,0,0,0,0.0,0.0,0.0
1998.0,GD,5,5,0,0,0,0.0,0.0,0.0
2000.0,GD,6,6,0,0,0,0.0,0.0,0.0
2001.0,GD,8,8,1,0,1,0.0,0.125,0.125
2002.0,GD,12,12,2,0,2,0.0,0.16666667,0.16666667
2003.0,GD,14,14,1,0,1,0.0,0.071428575,0.071428575
2004.0,GD,18,18,3,1,2,0.055555556,0.16666667,0.11111111
2005.0,GD,32,32,6,0,6,0.0,0.1875,0.1875
2006.0,GD,46,46,7,2,5,0.04347826,0.1521739,0.10869565
2007.0,GD,65,65,8,4,4,0.06153846,0.12307692,0.06153846
2008.0,GD,87,87,13,7,6,0.08045977,0.14942528,0.06896552
2009.0,GD,103,103,10,10,0,0.097087376,0.097087376,0.0
2010.0,GD,129,129,15,11,4,0.08527132,0.11627907,0.031007752
2011.0,GD,138,138,8,10,-2,0.072463766,0.057971016,-0.014492754
2012.0,GD,171,171,18,11,7,0.064327486,0.10526316,0.040935673
2013.0,GD,183,183,21,17,4,0.09289618,0.114754096,0.021857923
2014.0,GD,216,216,20,13,7,0.060185187,0.09259259,0.032407407
2015.0,GD,231,231,22,32,-10,0.13852814,0.0952381,-0.043290045
2016.0,GD,235,235,20,36,-16,0.15319149,0.08510638,-0.068085104
2017.0,GD,240,240,34,21,13,0.0875,0.14166667,0.054166667
2018.0,GD,271,271,31,23,8,0.084870845,0.11439114,0.029520296
2019.0,GD,283,283,33,35,-2,0.123674914,0.11660777,-0.007067138
2020.0,GD,256,256,18,33,-15,0.12890625,0.0703125,-0.05859375
2021.0,GD,227,227,25,26,-1,0.11453745,0.11013216,-0.004405286
2022.0,GD,0,0,6,12,-6,,,
1996.0,GE,638,638,0,0,0,0.0,0.0,0.0
1997.0,GE,804,804,70,52,18,0.06467662,0.087064676,0.02238806
1998.0,GE,976,976,101,80,21,0.08196721,0.10348361,0.021516394
1999.0,GE,1055,1055,97,106,-9,0.10047393,0.09194313,-0.008530806
2000.0,GE,1086,1086,79,109,-30,0.10036832,0.07274401,-0.027624309
2001.0,GE,1185,1185,104,90,14,0.07594936,0.08776371,0.011814346
2002.0,GE,1258,1258,116,111,5,0.0882353,0.09220985,0.003974563
2003.0,GE,1352,1352,118,124,-6,0.09171598,0.087278105,-0.00443787
2004.0,GE,1500,1500,144,125,19,0.083333336,0.096,0.012666667
2005.0,GE,1577,1577,131,156,-25,0.09892201,0.083069116,-0.015852885
2006.0,GE,1668,1668,146,176,-30,0.105515584,0.08752998,-0.017985612
2007.0,GE,1686,1686,138,205,-67,0.121589564,0.081850536,-0.039739028
2008.0,GE,1696,1696,157,211,-54,0.124410376,0.09257075,-0.031839624
2009.0,GE,1821,1821,205,170,35,0.0933553,0.11257551,0.019220209
2010.0,GE,1979,1979,220,207,13,0.104598284,0.11116726,0.0065689743
2011.0,GE,2150,2150,220,217,3,0.10093024,0.10232558,0.0013953488
2012.0,GE,2289,2289,207,211,-4,0.09217999,0.0904325,-0.001747488
2013.0,GE,2411,2411,190,222,-32,0.09207798,0.07880548,-0.013272501
2014.0,GE,2593,2593,234,228,6,0.08792904,0.09024296,0.0023139222
2015.0,GE,2713,2713,200,252,-52,0.092886105,0.07371913,-0.019166974
2016.0,GE,2801,2801,228,228,0,0.0813995,0.0813995,0.0
2017.0,GE,2874,2874,210,262,-52,0.091162145,0.073068894,-0.01809325
2018.0,GE,2973,2973,216,257,-41,0.08644467,0.07265388,-0.0137907835
2019.0,GE,2979,2979,242,226,16,0.07586438,0.08123531,0.00537093
2020.0,GE,2826,2826,206,228,-22,0.08067941,0.07289455,-0.007784855
2021.0,GE,2507,2507,136,200,-64,0.07977662,0.054248106,-0.02552852
2022.0,GE,0,0,66,121,-55,,,
1996.0,GF,14,14,0,0,0,0.0,0.0,0.0
1997.0,GF,26,26,4,1,3,0.03846154,0.15384616,0.115384616
1998.0,GF,32,32,4,4,0,0.125,0.125,0.0
1999.0,GF,39,39,3,5,-2,0.12820514,0.07692308,-0.051282052
2000.0,GF,46,46,10,3,7,0.06521739,0.2173913,0.1521739
2001.0,GF,52,52,3,5,-2,0.09615385,0.057692308,-0.03846154
2002.0,GF,50,50,10,9,1,0.18,0.2,0.02
2003.0,GF,66,66,13,6,7,0.09090909,0.1969697,0.10606061
2004.0,GF,63,63,5,10,-5,0.15873016,0.07936508,-0.07936508
2005.0,GF,67,67,9,8,1,0.11940298,0.13432837,0.014925373
2006.0,GF,67,67,6,10,-4,0.14925373,0.08955224,-0.05970149
2007.0,GF,80,80,15,7,8,0.0875,0.1875,0.1
2008.0,GF,88,88,12,7,5,0.07954545,0.13636364,0.056818184
2009.0,GF,102,102,17,12,5,0.11764706,0.16666667,0.04901961
2010.0,GF,109,109,12,13,-1,0.119266056,0.110091746,-0.0091743115
2011.0,GF,118,118,12,13,-1,0.11016949,0.10169491,-0.008474576
2012.0,GF,138,138,21,7,14,0.050724637,0.1521739,0.10144927
2013.0,GF,166,166,23,17,6,0.10240964,0.13855422,0.036144577
2014.0,GF,188,188,23,15,8,0.07978723,0.122340426,0.04255319
2015.0,GF,220,220,19,15,4,0.06818182,0.086363636,0.018181818
2016.0,GF,243,243,28,24,4,0.09876543,0.115226336,0.016460905
2017.0,GF,255,255,32,26,6,0.101960786,0.1254902,0.023529412
2018.0,GF,256,256,24,25,-1,0.09765625,0.09375,-0.00390625
2019.0,GF,267,267,40,29,11,0.10861423,0.14981273,0.041198503
2020.0,GF,280,280,49,29,20,0.10357143,0.175,0.071428575
2021.0,GF,255,255,21,16,5,0.0627451,0.08235294,0.019607844
2022.0,GF,0,0,9,17,-8,,,
1996.0,GH,297,297,0,0,0,0.0,0.0,0.0
1997.0,GH,419,419,12,7,5,0.016706444,0.028639618,0.011933174
1998.0,GH,546,546,25,16,9,0.02930403,0.045787547,0.016483517
1999.0,GH,602,602,16,10,6,0.016611295,0.026578072,0.009966778
2000.0,GH,619,619,13,23,-10,0.037156705,0.021001615,-0.016155088
2001.0,GH,648,648,21,19,2,0.029320987,0.032407407,0.0030864198
2002.0,GH,716,716,33,21,12,0.02932961,0.046089385,0.016759777
2003.0,GH,747,747,17,27,-10,0.036144577,0.022757698,-0.013386881
2004.0,GH,839,839,35,32,3,0.038140643,0.04171633,0.0035756854
2005.0,GH,967,967,39,28,11,0.028955532,0.04033092,0.011375388
2006.0,GH,1077,1077,40,43,-3,0.03992572,0.037140206,-0.0027855153
2007.0,GH,1196,1196,42,43,-1,0.03595318,0.035117056,-0.0008361204
2008.0,GH,1345,1345,53,46,7,0.034200743,0.039405204,0.005204461
2009.0,GH,1526,1526,53,54,-1,0.035386633,0.034731325,-0.000655308
2010.0,GH,1873,1873,94,61,33,0.03256807,0.050186865,0.017618794
2011.0,GH,2391,2391,102,77,25,0.0322041,0.042659976,0.010455877
2012.0,GH,2979,2979,135,93,42,0.03121853,0.04531722,0.014098691
2013.0,GH,3526,3526,169,109,60,0.030913217,0.047929667,0.01701645
2014.0,GH,4212,4212,215,137,78,0.032526117,0.051044635,0.018518519
2015.0,GH,4878,4878,240,172,68,0.035260353,0.049200494,0.01394014
2016.0,GH,5441,5441,265,220,45,0.040433742,0.04870428,0.008270538
2017.0,GH,5992,5992,323,288,35,0.048064087,0.053905208,0.0058411215
2018.0,GH,6677,6677,382,342,40,0.051220607,0.05721132,0.0059907143
2019.0,GH,7059,7059,426,387,39,0.05482363,0.060348492,0.005524862
2020.0,GH,7095,7095,459,383,76,0.053981677,0.06469344,0.010711769
2021.0,GH,6805,6805,340,340,0,0.049963262,0.049963262,0.0
2022.0,GH,0,0,244,220,24,,,
2001.0,GI,2,2,0,0,0,0.0,0.0,0.0
2003.0,GI,5,5,1,0,1,0.0,0.2,0.2
2004.0,GI,5,5,0,0,0,0.0,0.0,0.0
2006.0,GI,2,2,0,0,0,0.0,0.0,0.0
2009.0,GI,6,6,0,2,-2,0.33333334,0.0,-0.33333334
2011.0,GI,6,6,0,1,-1,0.16666667,0.0,-0.16666667
2015.0,GI,8,8,3,2,1,0.25,0.375,0.125
1996.0,GL,6,6,0,0,0,0.0,0.0,0.0
1997.0,GL,8,8,1,2,-1,0.25,0.125,-0.125
1999.0,GL,15,15,3,1,2,0.06666667,0.2,0.13333334
2000.0,GL,17,17,2,2,0,0.11764706,0.11764706,0.0
2001.0,GL,17,17,2,1,1,0.05882353,0.11764706,0.05882353
2002.0,GL,23,23,1,2,-1,0.08695652,0.04347826,-0.04347826
2004.0,GL,35,35,9,0,9,0.0,0.25714287,0.25714287
2005.0,GL,33,33,4,5,-1,0.15151516,0.121212125,-0.030303031
2006.0,GL,38,38,5,6,-1,0.15789473,0.13157895,-0.02631579
2007.0,GL,32,32,1,8,-7,0.25,0.03125,-0.21875
2008.0,GL,35,35,2,3,-1,0.08571429,0.057142857,-0.028571429
2009.0,GL,40,40,5,4,1,0.1,0.125,0.025
2010.0,GL,46,46,8,7,1,0.1521739,0.17391305,0.02173913
2011.0,GL,54,54,7,3,4,0.055555556,0.12962963,0.074074075
2012.0,GL,60,60,10,5,5,0.083333336,0.16666667,0.083333336
2013.0,GL,60,60,4,6,-2,0.1,0.06666667,-0.033333335
2014.0,GL,62,62,4,4,0,0.06451613,0.06451613,0.0
2015.0,GL,72,72,9,4,5,0.055555556,0.125,0.06944445
2016.0,GL,77,77,11,5,6,0.064935066,0.14285715,0.077922076
2017.0,GL,79,79,8,4,4,0.050632913,0.101265825,0.050632913
2018.0,GL,88,88,12,5,7,0.056818184,0.13636364,0.07954545
2019.0,GL,84,84,8,10,-2,0.11904762,0.0952381,-0.023809524
2020.0,GL,82,82,7,8,-1,0.09756097,0.085365854,-0.0121951215
2021.0,GL,76,76,13,5,8,0.065789476,0.17105263,0.10526316
1996.0,GM,55,55,0,0,0,0.0,0.0,0.0
1997.0,GM,68,68,10,5,5,0.073529415,0.14705883,0.073529415
1998.0,GM,68,68,4,9,-5,0.13235295,0.05882353,-0.073529415
1999.0,GM,70,70,4,6,-2,0.08571429,0.057142857,-0.028571429
2000.0,GM,84,84,18,5,13,0.05952381,0.21428572,0.15476191
2001.0,GM,76,76,6,14,-8,0.18421052,0.078947365,-0.10526316
2002.0,GM,84,84,14,7,7,0.083333336,0.16666667,0.083333336
2003.0,GM,97,97,15,12,3,0.12371134,0.15463917,0.030927835
2004.0,GM,92,92,10,13,-3,0.14130434,0.10869565,-0.032608695
2005.0,GM,93,93,12,17,-5,0.1827957,0.12903225,-0.05376344
2006.0,GM,107,107,20,14,6,0.13084112,0.18691589,0.056074765
2007.0,GM,112,112,13,11,2,0.09821428,0.116071425,0.017857144
2008.0,GM,109,109,16,24,-8,0.22018349,0.14678898,-0.07339449
2009.0,GM,107,107,15,15,0,0.14018692,0.14018692,0.0
2010.0,GM,109,109,16,22,-6,0.20183486,0.14678898,-0.055045873
2011.0,GM,98,98,10,21,-11,0.21428572,0.10204082,-0.1122449
2012.0,GM,94,94,11,23,-12,0.24468085,0.11702128,-0.12765957
2013.0,GM,91,91,10,15,-5,0.16483517,0.10989011,-0.054945055
2014.0,GM,132,132,17,16,1,0.121212125,0.12878788,0.007575758
2015.0,GM,162,162,29,14,15,0.086419754,0.17901234,0.09259259
2016.0,GM,191,191,28,16,12,0.083769634,0.14659686,0.06282722
2017.0,GM,255,255,54,19,35,0.07450981,0.21176471,0.13725491
2018.0,GM,298,298,50,33,17,0.110738255,0.16778524,0.05704698
2019.0,GM,347,347,48,16,32,0.04610951,0.13832854,0.09221902
2020.0,GM,336,336,35,33,2,0.09821428,0.104166664,0.005952381
2021.0,GM,339,339,32,17,15,0.050147492,0.09439528,0.044247787
2022.0,GM,0,0,20,20,0,,,
1996.0,GN,9,9,0,0,0,0.0,0.0,0.0
1997.0,GN,9,9,0,0,0,0.0,0.0,0.0
1998.0,GN,11,11,1,0,1,0.0,0.09090909,0.09090909
2000.0,GN,16,16,2,2,0,0.125,0.125,0.0
2001.0,GN,18,18,5,1,4,0.055555556,0.2777778,0.22222222
2004.0,GN,25,25,2,0,2,0.0,0.08,0.08
2005.0,GN,34,34,2,1,1,0.029411765,0.05882353,0.029411765
2006.0,GN,43,43,2,2,0,0.046511628,0.046511628,0.0
2007.0,GN,55,55,7,2,5,0.036363635,0.12727273,0.09090909
2008.0,GN,62,62,4,5,-1,0.08064516,0.06451613,-0.016129032
2009.0,GN,65,65,5,5,0,0.07692308,0.07692308,0.0
2010.0,GN,69,69,2,5,-3,0.072463766,0.028985508,-0.04347826
2011.0,GN,78,78,5,6,-1,0.07692308,0.06410257,-0.012820513
2012.0,GN,97,97,11,6,5,0.06185567,0.11340206,0.05154639
2013.0,GN,121,121,13,4,9,0.03305785,0.10743801,0.07438017
2014.0,GN,159,159,19,10,9,0.062893085,0.11949685,0.056603774
2015.0,GN,169,169,12,12,0,0.07100592,0.07100592,0.0
2016.0,GN,178,178,10,16,-6,0.08988764,0.056179777,-0.033707865
2017.0,GN,203,203,18,14,4,0.06896552,0.08866995,0.019704433
2018.0,GN,215,215,25,21,4,0.09767442,0.11627907,0.018604651
2019.0,GN,237,237,31,13,18,0.05485232,0.1308017,0.07594936
2020.0,GN,229,229,22,25,-3,0.1091703,0.09606987,-0.013100437
2021.0,GN,228,228,26,15,11,0.065789476,0.114035085,0.048245613
1996.0,GP,50,50,0,0,0,0.0,0.0,0.0
1997.0,GP,64,64,11,4,7,0.0625,0.171875,0.109375
1998.0,GP,81,81,10,4,6,0.049382716,0.12345679,0.074074075
1999.0,GP,82,82,9,8,1,0.09756097,0.1097561,0.0121951215
2000.0,GP,104,104,13,7,6,0.067307696,0.125,0.057692308
2001.0,GP,111,111,11,9,2,0.08108108,0.0990991,0.018018018
2002.0,GP,124,124,5,9,-4,0.07258064,0.04032258,-0.032258064
2003.0,GP,125,125,8,9,-1,0.072,0.064,-0.008
2004.0,GP,141,141,10,8,2,0.056737587,0.07092199,0.014184397
2005.0,GP,141,141,9,17,-8,0.120567374,0.06382979,-0.056737587
2006.0,GP,145,145,11,16,-5,0.11034483,0.07586207,-0.03448276
2007.0,GP,159,159,15,17,-2,0.10691824,0.094339624,-0.012578616
2008.0,GP,180,180,20,11,9,0.06111111,0.11111111,0.05
2009.0,GP,204,204,23,13,10,0.063725494,0.1127451,0.04901961
2010.0,GP,243,243,19,13,6,0.053497944,0.0781893,0.024691358
2011.0,GP,276,276,26,21,5,0.07608695,0.0942029,0.018115941
2012.0,GP,311,311,32,21,11,0.06752411,0.10289389,0.035369776
2013.0,GP,347,347,35,23,12,0.06628242,0.10086455,0.034582134
2014.0,GP,375,375,38,26,12,0.06933333,0.101333335,0.032
2015.0,GP,388,388,32,33,-1,0.085051544,0.082474224,-0.0025773195
2016.0,GP,389,389,32,37,-5,0.095115684,0.08226221,-0.012853471
2017.0,GP,336,336,32,48,-16,0.14285715,0.0952381,-0.04761905
2018.0,GP,338,338,54,32,22,0.09467456,0.1597633,0.06508876
2019.0,GP,309,309,29,46,-17,0.14886731,0.093851134,-0.055016182
2020.0,GP,303,303,39,35,4,0.11551155,0.12871288,0.013201321
2021.0,GP,263,263,24,27,-3,0.102661595,0.091254756,-0.0114068445
2022.0,GP,0,0,27,16,11,,,
2013.0,GQ,1,1,0,0,0,0.0,0.0,0.0
2018.0,GQ,3,3,0,0,0,0.0,0.0,0.0
2019.0,GQ,3,3,0,1,-1,0.33333334,0.0,-0.33333334
2020.0,GQ,3,3,1,1,0,0.33333334,0.33333334,0.0
1996.0,GR,8596,8596,0,0,0,0.0,0.0,0.0
1997.0,GR,10399,10399,215,171,44,0.01644389,0.020675065,0.004231176
1998.0,GR,12384,12384,314,205,109,0.016553618,0.025355298,0.008801679
1999.0,GR,13706,13706,300,254,46,0.01853203,0.021888224,0.0033561944
2000.0,GR,15152,15152,382,282,100,0.018611405,0.025211193,0.006599789
2001.0,GR,17029,17029,405,284,121,0.016677432,0.02378296,0.007105526
2002.0,GR,19193,19193,491,325,166,0.016933257,0.025582243,0.008648987
2003.0,GR,21410,21410,478,372,106,0.017375058,0.022326017,0.0049509574
2004.0,GR,23779,23779,491,412,79,0.017326212,0.020648472,0.003322259
2005.0,GR,26059,26059,518,509,9,0.019532599,0.019877968,0.00034537012
2006.0,GR,28291,28291,599,510,89,0.018026935,0.02117281,0.0031458768
2007.0,GR,30437,30437,672,576,96,0.018924335,0.022078391,0.003154056
2008.0,GR,32113,32113,704,634,70,0.019742783,0.021922586,0.0021798026
2009.0,GR,33754,33754,690,715,-25,0.021182675,0.020442022,-0.00074065296
2010.0,GR,34759,34759,709,819,-110,0.023562243,0.020397594,-0.003164648
2011.0,GR,35699,35699,743,864,-121,0.024202358,0.020812908,-0.0033894507
2012.0,GR,36402,36402,731,958,-227,0.026317235,0.020081313,-0.0062359213
2013.0,GR,37010,37010,701,1042,-341,0.028154552,0.018940827,-0.009213726
2014.0,GR,37441,37441,742,1196,-454,0.03194359,0.019817846,-0.0121257445
2015.0,GR,38103,38103,756,1179,-423,0.030942446,0.019840958,-0.011101488
2016.0,GR,38194,38194,767,1144,-377,0.02995235,0.020081688,-0.0098706605
2017.0,GR,38319,38319,768,1190,-422,0.031055091,0.020042276,-0.011012813
2018.0,GR,38852,38852,894,1172,-278,0.030165758,0.0230104,-0.007155359
2019.0,GR,39165,39165,952,1127,-175,0.028775692,0.024307417,-0.0044682752
2020.0,GR,37335,37335,824,1079,-255,0.028900495,0.022070443,-0.006830052
2021.0,GR,34540,34540,708,661,47,0.019137232,0.020497974,0.0013607412
2022.0,GR,0,0,500,466,34,,,
1996.0,GT,42,42,0,0,0,0.0,0.0,0.0
1997.0,GT,53,53,1,1,0,0.018867925,0.018867925,0.0
1998.0,GT,65,65,3,3,0,0.046153847,0.046153847,0.0
1999.0,GT,77,77,8,2,6,0.025974026,0.103896104,0.077922076
2000.0,GT,94,94,8,8,0,0.08510638,0.08510638,0.0
2001.0,GT,114,114,6,8,-2,0.07017544,0.05263158,-0.01754386
2002.0,GT,133,133,7,8,-1,0.060150377,0.05263158,-0.007518797
2003.0,GT,154,154,9,10,-1,0.064935066,0.058441557,-0.0064935065
2004.0,GT,154,154,9,18,-9,0.116883114,0.058441557,-0.058441557
2005.0,GT,159,159,12,15,-3,0.094339624,0.0754717,-0.018867925
2006.0,GT,163,163,14,23,-9,0.1411043,0.08588957,-0.055214725
2007.0,GT,177,177,22,15,7,0.084745765,0.12429378,0.03954802
2008.0,GT,196,196,18,17,1,0.0867347,0.091836736,0.0051020407
2009.0,GT,236,236,27,17,10,0.0720339,0.11440678,0.042372882
2010.0,GT,253,253,28,33,-5,0.13043478,0.11067194,-0.019762846
2011.0,GT,307,307,43,28,15,0.09120521,0.14006515,0.048859935
2012.0,GT,349,349,45,45,0,0.12893982,0.12893982,0.0
2013.0,GT,406,406,46,50,-4,0.12315271,0.113300495,-0.009852217
2014.0,GT,454,454,44,54,-10,0.11894273,0.0969163,-0.02202643
2015.0,GT,537,537,68,48,20,0.08938547,0.12662943,0.037243947
2016.0,GT,562,562,68,76,-8,0.13523132,0.12099644,-0.014234875
2017.0,GT,612,612,78,88,-10,0.14379086,0.12745099,-0.01633987
2018.0,GT,674,674,112,85,27,0.12611276,0.1661721,0.040059347
2019.0,GT,729,729,126,86,40,0.11796982,0.17283951,0.054869685
2020.0,GT,677,677,82,101,-19,0.1491876,0.1211226,-0.028064992
2021.0,GT,633,633,86,69,17,0.109004736,0.13586098,0.02685624
2022.0,GT,0,0,40,33,7,,,
1996.0,GW,5,5,0,0,0,0.0,0.0,0.0
1997.0,GW,10,10,0,1,-1,0.1,0.0,-0.1
1998.0,GW,18,18,5,1,4,0.055555556,0.2777778,0.22222222
1999.0,GW,27,27,2,1,1,0.037037037,0.074074075,0.037037037
2000.0,GW,27,27,2,8,-6,0.2962963,0.074074075,-0.22222222
2001.0,GW,30,30,4,3,1,0.1,0.13333334,0.033333335
2002.0,GW,31,31,5,4,1,0.12903225,0.16129032,0.032258064
2003.0,GW,34,34,7,3,4,0.0882353,0.20588236,0.11764706
2004.0,GW,31,31,4,6,-2,0.19354838,0.12903225,-0.06451613
2005.0,GW,30,30,8,10,-2,0.33333334,0.26666668,-0.06666667
2007.0,GW,25,25,3,3,0,0.12,0.12,0.0
2008.0,GW,24,24,1,3,-2,0.125,0.041666668,-0.083333336
2009.0,GW,29,29,5,3,2,0.10344828,0.1724138,0.06896552
2010.0,GW,30,30,3,7,-4,0.23333333,0.1,-0.13333334
2011.0,GW,38,38,4,5,-1,0.13157895,0.10526316,-0.02631579
2012.0,GW,37,37,3,5,-2,0.13513513,0.08108108,-0.054054055
2013.0,GW,45,45,6,4,2,0.08888889,0.13333334,0.044444446
2014.0,GW,47,47,4,6,-2,0.12765957,0.08510638,-0.04255319
2015.0,GW,53,53,6,6,0,0.11320755,0.11320755,0.0
2016.0,GW,56,56,9,6,3,0.10714286,0.16071428,0.05357143
2017.0,GW,45,45,2,12,-10,0.26666668,0.044444446,-0.22222222
2018.0,GW,49,49,6,4,2,0.08163265,0.12244898,0.040816326
2019.0,GW,41,41,5,9,-4,0.2195122,0.12195122,-0.09756097
2020.0,GW,35,35,3,8,-5,0.22857143,0.08571429,-0.14285715
2021.0,GW,31,31,2,0,2,0.0,0.06451613,0.06451613
1996.0,GY,7,7,0,0,0,0.0,0.0,0.0
1997.0,GY,10,10,0,1,-1,0.1,0.0,-0.1
1999.0,GY,10,10,1,0,1,0.0,0.1,0.1
2000.0,GY,8,8,0,1,-1,0.125,0.0,-0.125
2001.0,GY,11,11,2,0,2,0.0,0.18181819,0.18181819
2002.0,GY,6,6,1,4,-3,0.6666667,0.16666667,-0.5
2003.0,GY,9,9,0,1,-1,0.11111111,0.0,-0.11111111
2005.0,GY,13,13,1,0,1,0.0,0.07692308,0.07692308
2006.0,GY,17,17,2,0,2,0.0,0.11764706,0.11764706
2007.0,GY,16,16,0,1,-1,0.0625,0.0,-0.0625
2008.0,GY,16,16,3,2,1,0.125,0.1875,0.0625
2010.0,GY,29,29,2,0,2,0.0,0.06896552,0.06896552
2011.0,GY,30,30,1,1,0,0.033333335,0.033333335,0.0
2012.0,GY,36,36,2,2,0,0.055555556,0.055555556,0.0
2013.0,GY,36,36,1,3,-2,0.083333336,0.027777778,-0.055555556
2014.0,GY,41,41,4,2,2,0.048780486,0.09756097,0.048780486
2015.0,GY,42,42,2,4,-2,0.0952381,0.04761905,-0.04761905
2016.0,GY,49,49,5,2,3,0.040816326,0.10204082,0.06122449
2017.0,GY,55,55,3,3,0,0.054545455,0.054545455,0.0
2018.0,GY,65,65,9,2,7,0.03076923,0.13846155,0.10769231
2019.0,GY,67,67,4,0,4,0.0,0.05970149,0.05970149
2020.0,GY,63,63,4,5,-1,0.07936508,0.06349207,-0.015873017
1996.0,HK,69,69,0,0,0,0.0,0.0,0.0
1997.0,HK,103,103,8,8,0,0.0776699,0.0776699,0.0
1998.0,HK,124,124,18,9,9,0.07258064,0.14516129,0.07258064
1999.0,HK,147,147,16,8,8,0.054421768,0.108843535,0.054421768
2000.0,HK,160,160,23,19,4,0.11875,0.14375,0.025
2001.0,HK,167,167,18,17,1,0.1017964,0.10778443,0.005988024
2002.0,HK,171,171,22,24,-2,0.14035088,0.12865497,-0.0116959065
2003.0,HK,184,184,27,28,-1,0.1521739,0.14673913,-0.0054347827
2004.0,HK,224,224,41,35,6,0.15625,0.18303572,0.026785715
2005.0,HK,256,256,32,47,-15,0.18359375,0.125,-0.05859375
2006.0,HK,345,345,63,38,25,0.11014493,0.1826087,0.072463766
2007.0,HK,491,491,112,41,71,0.08350305,0.2281059,0.14460285
2008.0,HK,622,622,131,83,48,0.13344051,0.21061093,0.07717042
2009.0,HK,774,774,182,88,94,0.11369509,0.23514211,0.12144703
2010.0,HK,877,877,178,137,41,0.15621437,0.20296465,0.046750285
2011.0,HK,985,985,210,162,48,0.164467,0.21319798,0.048730966
2012.0,HK,1041,1041,194,152,42,0.14601345,0.18635927,0.04034582
2013.0,HK,1092,1092,211,190,21,0.17399268,0.19322345,0.01923077
2014.0,HK,1066,1066,211,221,-10,0.20731707,0.1979362,-0.009380863
2015.0,HK,1059,1059,211,193,18,0.1822474,0.19924457,0.016997168
2016.0,HK,976,976,190,236,-46,0.24180327,0.19467214,-0.047131147
2017.0,HK,970,970,233,235,-2,0.24226804,0.24020618,-0.0020618557
2018.0,HK,934,934,213,232,-19,0.248394,0.2280514,-0.020342613
2019.0,HK,941,941,220,233,-13,0.24760893,0.23379384,-0.01381509
2020.0,HK,960,960,265,223,42,0.23229167,0.27604166,0.04375
2021.0,HK,950,950,226,187,39,0.1968421,0.23789474,0.041052632
2022.0,HK,0,0,187,160,27,,,
1996.0,HN,64,64,0,0,0,0.0,0.0,0.0
1997.0,HN,87,87,8,0,8,0.0,0.09195402,0.09195402
1998.0,HN,121,121,14,13,1,0.10743801,0.11570248,0.008264462
1999.0,HN,141,141,18,15,3,0.10638298,0.12765957,0.021276595
2000.0,HN,160,160,16,19,-3,0.11875,0.1,-0.01875
2001.0,HN,165,165,17,17,0,0.1030303,0.1030303,0.0
2002.0,HN,163,163,15,29,-14,0.17791411,0.09202454,-0.08588957
2003.0,HN,177,177,15,21,-6,0.118644066,0.084745765,-0.033898305
2004.0,HN,197,197,29,17,12,0.08629441,0.14720812,0.060913704
2005.0,HN,174,174,19,34,-15,0.1954023,0.109195404,-0.0862069
2006.0,HN,174,174,14,19,-5,0.109195404,0.08045977,-0.028735632
2007.0,HN,196,196,33,26,7,0.13265306,0.16836734,0.035714287
2008.0,HN,187,187,15,36,-21,0.19251336,0.080213904,-0.112299465
2009.0,HN,213,213,28,28,0,0.13145539,0.13145539,0.0
2010.0,HN,255,255,37,39,-2,0.15294118,0.14509805,-0.007843138
2011.0,HN,268,268,29,38,-9,0.14179105,0.108208954,-0.03358209
2012.0,HN,309,309,41,36,5,0.116504855,0.13268608,0.01618123
2013.0,HN,375,375,49,54,-5,0.144,0.13066667,-0.013333334
2014.0,HN,415,415,54,62,-8,0.1493976,0.13012049,-0.019277109
2015.0,HN,467,467,70,62,8,0.13276231,0.14989293,0.01713062
2016.0,HN,482,482,49,78,-29,0.16182573,0.10165975,-0.060165975
2017.0,HN,452,452,57,75,-18,0.1659292,0.12610619,-0.03982301
2018.0,HN,460,460,63,66,-3,0.14347826,0.13695653,-0.006521739
2019.0,HN,434,434,67,97,-30,0.22350231,0.15437788,-0.06912442
2020.0,HN,408,408,56,64,-8,0.15686275,0.13725491,-0.019607844
2021.0,HN,366,366,41,36,5,0.09836066,0.112021856,0.013661202
1996.0,HR,2579,2579,0,0,0,0.0,0.0,0.0
1997.0,HR,3152,3152,41,49,-8,0.015545685,0.013007614,-0.002538071
1998.0,HR,3689,3689,60,61,-1,0.016535647,0.01626457,-0.00027107616
1999.0,HR,3951,3951,79,65,14,0.016451532,0.019994939,0.0035434067
2000.0,HR,4231,4231,81,61,20,0.014417395,0.01914441,0.004727015
2001.0,HR,4593,4593,93,111,-18,0.024167212,0.020248204,-0.0039190073
2002.0,HR,5023,5023,114,90,24,0.017917579,0.022695601,0.004778021
2003.0,HR,5355,5355,98,146,-48,0.02726424,0.018300654,-0.008963586
2004.0,HR,6002,6002,124,121,3,0.020159947,0.02065978,0.0004998334
2005.0,HR,6793,6793,130,150,-20,0.022081554,0.019137347,-0.0029442073
2006.0,HR,7834,7834,190,165,25,0.021062037,0.024253255,0.0031912178
2007.0,HR,8920,8920,184,195,-11,0.021860987,0.020627802,-0.0012331839
2008.0,HR,9956,9956,243,232,11,0.02330253,0.024407392,0.0011048614
2009.0,HR,10782,10782,254,260,-6,0.024114264,0.023557782,-0.00055648305
2010.0,HR,11516,11516,247,295,-48,0.025616534,0.02144842,-0.004168114
2011.0,HR,12156,12156,269,323,-54,0.02657124,0.02212899,-0.004442251
2012.0,HR,12472,12472,262,372,-110,0.029826812,0.021007055,-0.008819756
2013.0,HR,12856,12856,297,410,-113,0.031891722,0.023102054,-0.008789671
2014.0,HR,13182,13182,310,402,-92,0.030496132,0.023516918,-0.006979214
2015.0,HR,13659,13659,381,394,-13,0.02884545,0.027893696,-0.0009517534
2016.0,HR,13910,13910,379,398,-19,0.02861251,0.027246585,-0.0013659238
2017.0,HR,14330,14330,427,468,-41,0.03265876,0.029797627,-0.0028611305
2018.0,HR,14773,14773,487,449,38,0.030393286,0.032965545,0.00257226
2019.0,HR,14999,14999,510,508,2,0.033868924,0.034002267,0.00013334223
2020.0,HR,14433,14433,450,469,-19,0.032494977,0.031178549,-0.0013164276
2021.0,HR,13453,13453,342,336,6,0.024975842,0.02542184,0.00044599717
2022.0,HR,0,0,233,245,-12,,,
1996.0,HT,2,2,0,0,0,0.0,0.0,0.0
1998.0,HT,7,7,0,0,0,0.0,0.0,0.0
1999.0,HT,7,7,0,0,0,0.0,0.0,0.0
2000.0,HT,10,10,1,0,1,0.0,0.1,0.1
2002.0,HT,8,8,0,0,0,0.0,0.0,0.0
2003.0,HT,9,9,2,1,1,0.11111111,0.22222222,0.11111111
2005.0,HT,22,22,2,1,1,0.045454547,0.09090909,0.045454547
2006.0,HT,28,28,3,0,3,0.0,0.10714286,0.10714286
2007.0,HT,35,35,3,0,3,0.0,0.08571429,0.08571429
2008.0,HT,37,37,1,4,-3,0.10810811,0.027027028,-0.08108108
2009.0,HT,41,41,5,4,1,0.09756097,0.12195122,0.024390243
2010.0,HT,42,42,2,1,1,0.023809524,0.04761905,0.023809524
2011.0,HT,45,45,4,5,-1,0.11111111,0.08888889,-0.022222223
2012.0,HT,49,49,5,5,0,0.10204082,0.10204082,0.0
2013.0,HT,64,64,2,6,-4,0.09375,0.03125,-0.0625
2014.0,HT,78,78,7,7,0,0.08974359,0.08974359,0.0
2015.0,HT,98,98,14,2,12,0.020408163,0.14285715,0.12244898
2016.0,HT,109,109,5,5,0,0.04587156,0.04587156,0.0
2017.0,HT,127,127,11,3,8,0.023622047,0.08661418,0.062992126
2018.0,HT,135,135,13,9,4,0.06666667,0.096296296,0.02962963
2019.0,HT,134,134,12,13,-1,0.09701493,0.08955224,-0.0074626864
2020.0,HT,131,131,9,6,3,0.045801528,0.06870229,0.022900764
2021.0,HT,117,117,7,6,1,0.051282052,0.05982906,0.008547009
2022.0,HT,0,0,3,0,3,,,
1996.0,HU,6760,6760,0,0,0,0.0,0.0,0.0
1997.0,HU,7932,7932,212,238,-26,0.030005043,0.02672718,-0.0032778617
1998.0,HU,9237,9237,271,278,-7,0.030096352,0.02933853,-0.0007578218
1999.0,HU,9974,9974,298,274,24,0.027471425,0.029877681,0.0024062563
2000.0,HU,10666,10666,372,298,74,0.027939247,0.03487718,0.0069379336
2001.0,HU,11505,11505,400,303,97,0.026336376,0.034767494,0.008431117
2002.0,HU,12133,12133,316,347,-31,0.028599687,0.026044672,-0.0025550153
2003.0,HU,12819,12819,308,424,-116,0.033075903,0.024026835,-0.009049068
2004.0,HU,13461,13461,335,391,-56,0.029046876,0.02488671,-0.0041601663
2005.0,HU,14336,14336,383,380,3,0.026506696,0.02671596,0.0002092634
2006.0,HU,14985,14985,396,416,-20,0.027761094,0.026426427,-0.001334668
2007.0,HU,15835,15835,440,431,9,0.027218187,0.02778655,0.0005683612
2008.0,HU,16427,16427,406,499,-93,0.030376818,0.024715407,-0.005661411
2009.0,HU,17127,17127,422,504,-82,0.029427221,0.024639457,-0.004787762
2010.0,HU,17581,17581,437,548,-111,0.031170012,0.02485638,-0.006313634
2011.0,HU,18383,18383,469,576,-107,0.031333297,0.025512703,-0.005820595
2012.0,HU,19065,19065,462,557,-95,0.02921584,0.024232887,-0.004982953
2013.0,HU,19599,19599,506,578,-72,0.0294913,0.025817644,-0.0036736568
2014.0,HU,20204,20204,514,577,-63,0.028558701,0.025440507,-0.0031181944
2015.0,HU,20645,20645,505,596,-91,0.028868975,0.024461128,-0.004407847
2016.0,HU,21370,21370,592,627,-35,0.029340196,0.027702387,-0.00163781
2017.0,HU,21863,21863,634,686,-52,0.03137721,0.028998764,-0.0023784477
2018.0,HU,22411,22411,642,664,-22,0.029628307,0.028646646,-0.0009816608
2019.0,HU,22713,22713,731,657,74,0.028926166,0.032184213,0.003258046
2020.0,HU,22076,22076,694,621,73,0.028130095,0.031436853,0.0033067584
2021.0,HU,20552,20552,487,526,-39,0.025593616,0.02369599,-0.0018976255
2022.0,HU,0,0,330,410,-80,,,
1996.0,ID,1039,1039,0,0,0,0.0,0.0,0.0
1997.0,ID,1449,1449,22,14,8,0.009661836,0.015182884,0.005521049
1998.0,ID,1961,1961,48,29,19,0.014788373,0.024477307,0.009688934
1999.0,ID,2334,2334,57,32,25,0.013710368,0.024421593,0.010711226
2000.0,ID,2629,2629,64,42,22,0.015975656,0.024343858,0.008368201
2001.0,ID,3027,3027,74,49,25,0.016187644,0.024446648,0.008259002
2002.0,ID,3499,3499,80,79,1,0.02257788,0.022863675,0.00028579595
2003.0,ID,4264,4264,117,79,38,0.018527204,0.027439024,0.00891182
2004.0,ID,5129,5129,129,94,35,0.01832716,0.025151102,0.006823942
2005.0,ID,6516,6516,171,110,61,0.016881522,0.026243094,0.009361572
2006.0,ID,8184,8184,212,118,94,0.014418378,0.025904203,0.011485826
2007.0,ID,10023,10023,262,153,109,0.015264891,0.026139878,0.010874988
2008.0,ID,12877,12877,317,213,104,0.01654112,0.024617536,0.008076415
2009.0,ID,16300,16300,397,207,190,0.012699386,0.024355829,0.011656442
2010.0,ID,21395,21395,459,269,190,0.012573031,0.021453612,0.00888058
2011.0,ID,28368,28368,573,340,233,0.0119853355,0.020198816,0.00821348
2012.0,ID,35749,35749,631,380,251,0.010629668,0.017650843,0.007021175
2013.0,ID,46322,46322,813,526,287,0.011355296,0.017551055,0.0061957603
2014.0,ID,61539,61539,1122,712,410,0.011569899,0.01823234,0.006662442
2015.0,ID,83376,83376,1505,747,758,0.008959413,0.018050758,0.009091346
2016.0,ID,109534,109534,2113,946,1167,0.008636587,0.019290814,0.010654226
2017.0,ID,134898,134898,2518,1262,1256,0.009355216,0.018665954,0.009310738
2018.0,ID,154564,154564,3064,1681,1383,0.010875754,0.019823503,0.00894775
2019.0,ID,161755,161755,3395,2155,1240,0.013322618,0.020988531,0.0076659145
2020.0,ID,160982,160982,2975,2426,549,0.015070008,0.018480327,0.003410319
2021.0,ID,155796,155796,2218,2104,114,0.0135048395,0.014236566,0.0007317261
2022.0,ID,0,0,923,1251,-328,,,
1996.0,IE,3727,3727,0,0,0,0.0,0.0,0.0
1997.0,IE,4569,4569,303,248,55,0.054278836,0.06631648,0.012037645
1998.0,IE,5440,5440,385,355,30,0.065257356,0.07077206,0.005514706
1999.0,IE,5985,5985,533,423,110,0.07067669,0.08905597,0.018379282
2000.0,IE,6567,6567,485,461,24,0.07019948,0.07385412,0.003654637
2001.0,IE,7103,7103,577,463,114,0.06518372,0.081233285,0.016049556
2002.0,IE,7901,7901,680,574,106,0.07264903,0.086065054,0.013416023
2003.0,IE,8673,8673,728,664,64,0.07655944,0.08393866,0.0073792227
2004.0,IE,9576,9576,850,651,199,0.06798246,0.08876357,0.02078112
2005.0,IE,10549,10549,974,789,185,0.074793816,0.09233103,0.017537206
2006.0,IE,11749,11749,1068,909,159,0.07736829,0.09090135,0.013533067
2007.0,IE,12932,12932,1220,973,247,0.07523972,0.094339624,0.019099908
2008.0,IE,14062,14062,1269,1066,203,0.07580714,0.090243205,0.014436069
2009.0,IE,15300,15300,1455,1168,287,0.07633987,0.09509804,0.01875817
2010.0,IE,16546,16546,1569,1239,330,0.07488215,0.09482654,0.019944398
2011.0,IE,17589,17589,1538,1421,117,0.08078913,0.08744101,0.006651885
2012.0,IE,18436,18436,1517,1552,-35,0.08418312,0.08228466,-0.0018984595
2013.0,IE,19093,19093,1514,1700,-186,0.089037865,0.079296075,-0.009741791
2014.0,IE,19772,19772,1642,1749,-107,0.08845843,0.083046734,-0.0054116934
2015.0,IE,20548,20548,1778,1743,35,0.08482578,0.086529106,0.0017033288
2016.0,IE,21106,21106,1802,1737,65,0.082298875,0.085378565,0.003079693
2017.0,IE,21691,21691,1923,1745,178,0.08044811,0.08865428,0.008206168
2018.0,IE,22284,22284,2077,1995,82,0.08952612,0.093205884,0.0036797703
2019.0,IE,22581,22581,2105,1990,115,0.08812719,0.093219966,0.0050927773
2020.0,IE,21924,21924,2100,1857,243,0.084701695,0.09578544,0.011083744
2021.0,IE,20396,20396,1526,1463,63,0.07172975,0.07481859,0.003088841
2022.0,IE,0,0,1097,949,148,,,
1996.0,IL,15148,15148,0,0,0,0.0,0.0,0.0
1997.0,IL,17586,17586,457,386,71,0.021949278,0.02598658,0.0040373025
1998.0,IL,19799,19799,499,538,-39,0.027173089,0.025203293,-0.0019697964
1999.0,IL,20650,20650,530,574,-44,0.02779661,0.025665859,-0.0021307506
2000.0,IL,21581,21581,583,581,2,0.02692183,0.027014503,9.267411e-05
2001.0,IL,22608,22608,593,659,-66,0.029148974,0.026229654,-0.0029193205
2002.0,IL,23734,23734,587,711,-124,0.029957024,0.024732452,-0.0052245725
2003.0,IL,24765,24765,578,726,-148,0.029315567,0.02333939,-0.005976176
2004.0,IL,25824,25824,536,807,-271,0.03125,0.020755885,-0.010494114
2005.0,IL,26875,26875,609,834,-225,0.031032559,0.022660466,-0.008372093
2006.0,IL,28104,28104,653,864,-211,0.030742954,0.023235127,-0.007507828
2007.0,IL,29251,29251,723,898,-175,0.030699804,0.024717104,-0.0059827017
2008.0,IL,30280,30280,742,913,-171,0.030151915,0.024504624,-0.005647292
2009.0,IL,31127,31127,781,991,-210,0.03183731,0.025090758,-0.0067465543
2010.0,IL,31973,31973,784,968,-184,0.030275544,0.02452069,-0.0057548555
2011.0,IL,32994,32994,890,927,-37,0.028096018,0.026974602,-0.001121416
2012.0,IL,33956,33956,897,999,-102,0.029420426,0.026416538,-0.0030038874
2013.0,IL,35156,35156,1000,992,8,0.02821709,0.028444646,0.00022755718
2014.0,IL,36481,36481,1034,1101,-67,0.030180093,0.028343521,-0.0018365724
2015.0,IL,38071,38071,1147,1103,44,0.028972184,0.030127918,0.0011557353
2016.0,IL,39154,39154,1157,1166,-9,0.029779844,0.029549982,-0.00022986157
2017.0,IL,40080,40080,1176,1244,-68,0.031037925,0.029341318,-0.0016966067
2018.0,IL,41037,41037,1273,1399,-126,0.034091186,0.031020787,-0.0030703999
2019.0,IL,41645,41645,1407,1329,78,0.031912595,0.033785567,0.001872974
2020.0,IL,40205,40205,1359,1217,142,0.030269867,0.033801764,0.003531899
2021.0,IL,37516,37516,988,946,42,0.025215907,0.02633543,0.0011195224
2022.0,IL,0,0,642,639,3,,,
1998.0,IM,7,7,3,0,3,0.0,0.42857143,0.42857143
1999.0,IM,7,7,0,0,0,0.0,0.0,0.0
2000.0,IM,8,8,0,0,0,0.0,0.0,0.0
2002.0,IM,3,3,1,1,0,0.33333334,0.33333334,0.0
2003.0,IM,5,5,0,1,-1,0.2,0.0,-0.2
2005.0,IM,7,7,1,0,1,0.0,0.14285715,0.14285715
2006.0,IM,5,5,0,2,-2,0.4,0.0,-0.4
2009.0,IM,6,6,2,1,1,0.16666667,0.33333334,0.16666667
2014.0,IM,7,7,2,0,2,0.0,0.2857143,0.2857143
2015.0,IM,9,9,1,0,1,0.0,0.11111111,0.11111111
2017.0,IM,9,9,0,1,-1,0.11111111,0.0,-0.11111111
2018.0,IM,5,5,1,2,-1,0.4,0.2,-0.2
1996.0,IN,29732,29732,0,0,0,0.0,0.0,0.0
1997.0,IN,36060,36060,677,732,-55,0.020299502,0.018774265,-0.0015252357
1998.0,IN,42384,42384,950,1045,-95,0.02465553,0.022414118,-0.002241412
1999.0,IN,45462,45462,1086,1227,-141,0.026989574,0.023888083,-0.0031014914
2000.0,IN,49129,49129,1342,1433,-91,0.029168108,0.027315842,-0.0018522665
2001.0,IN,53501,53501,1494,1675,-181,0.031307828,0.02792471,-0.0033831142
2002.0,IN,58446,58446,1518,2008,-490,0.0343565,0.025972692,-0.008383808
2003.0,IN,64319,64319,1683,2230,-547,0.034670938,0.026166452,-0.008504486
2004.0,IN,71185,71185,1914,2466,-552,0.03464213,0.026887687,-0.0077544427
2005.0,IN,79778,79778,2217,2578,-361,0.032314673,0.027789617,-0.004525057
2006.0,IN,88503,88503,2327,2935,-608,0.033162717,0.026292894,-0.0068698237
2007.0,IN,98908,98908,2683,3317,-634,0.033536214,0.02712622,-0.006409997
2008.0,IN,111862,111862,2942,3623,-681,0.03238812,0.026300263,-0.006087858
2009.0,IN,127462,127462,3437,4033,-596,0.0316408,0.0269649,-0.0046759034
2010.0,IN,146570,146570,3948,4376,-428,0.029856041,0.026935935,-0.0029201065
2011.0,IN,169283,169283,4389,4615,-226,0.027262041,0.025926998,-0.0013350425
2012.0,IN,194263,194263,4854,4947,-93,0.025465477,0.024986744,-0.00047873243
2013.0,IN,218516,218516,5516,5250,266,0.024025701,0.025243003,0.0012173022
2014.0,IN,243397,243397,5946,5717,229,0.023488374,0.024429224,0.0009408497
2015.0,IN,262869,262869,6129,6548,-419,0.024909746,0.023315797,-0.0015939499
2016.0,IN,277811,277811,6583,7036,-453,0.02532657,0.023695966,-0.001630605
2017.0,IN,289976,289976,6521,7759,-1238,0.026757387,0.022488069,-0.0042693187
2018.0,IN,304196,304196,7037,8564,-1527,0.028152902,0.023133112,-0.00501979
2019.0,IN,311217,311217,7719,9280,-1561,0.029818423,0.024802629,-0.005015793
2020.0,IN,299756,299756,7549,8433,-884,0.028132882,0.025183816,-0.0029490653
2021.0,IN,279227,279227,6093,6495,-402,0.023260644,0.021820955,-0.0014396888
2022.0,IN,0,0,4087,5051,-964,,,
2023.0,IN,0,0,173,374,-201,,,
1996.0,IQ,111,111,0,0,0,0.0,0.0,0.0
1997.0,IQ,148,148,3,4,-1,0.027027028,0.02027027,-0.006756757
1998.0,IQ,187,187,1,5,-4,0.026737968,0.0053475937,-0.021390375
1999.0,IQ,213,213,3,3,0,0.014084507,0.014084507,0.0
2000.0,IQ,232,232,5,9,-4,0.038793102,0.021551725,-0.01724138
2001.0,IQ,245,245,4,9,-5,0.036734693,0.01632653,-0.020408163
2002.0,IQ,249,249,3,4,-1,0.016064256,0.012048192,-0.004016064
2003.0,IQ,288,288,9,10,-1,0.034722224,0.03125,-0.0034722222
2004.0,IQ,360,360,8,11,-3,0.030555556,0.022222223,-0.008333334
2005.0,IQ,427,427,18,14,4,0.032786883,0.042154565,0.009367681
2006.0,IQ,547,547,14,10,4,0.018281536,0.02559415,0.0073126145
2007.0,IQ,739,739,30,19,11,0.025710419,0.040595397,0.014884979
2008.0,IQ,952,952,24,22,2,0.023109244,0.025210084,0.0021008404
2009.0,IQ,1163,1163,48,43,5,0.036973346,0.04127257,0.004299226
2010.0,IQ,1520,1520,65,42,23,0.027631579,0.04276316,0.015131579
2011.0,IQ,2074,2074,94,59,35,0.028447445,0.045323048,0.016875602
2012.0,IQ,2621,2621,132,78,54,0.029759634,0.050362457,0.020602824
2013.0,IQ,3307,3307,173,90,83,0.027214998,0.052313276,0.025098277
2014.0,IQ,4208,4208,219,151,68,0.03588403,0.052043725,0.016159697
2015.0,IQ,5363,5363,328,161,167,0.03002051,0.061159797,0.031139288
2016.0,IQ,7069,7069,458,218,240,0.030838873,0.06478993,0.033951055
2017.0,IQ,9035,9035,648,305,343,0.03375761,0.071721084,0.037963476
2018.0,IQ,11047,11047,871,335,536,0.030324975,0.078844935,0.04851996
2019.0,IQ,12278,12278,1022,510,512,0.04153771,0.08323831,0.0417006
2020.0,IQ,12491,12491,888,586,302,0.046913777,0.07109118,0.024177408
2021.0,IQ,12119,12119,653,525,128,0.043320406,0.053882334,0.010561927
2022.0,IQ,0,0,349,351,-2,,,
1996.0,IR,1698,1698,0,0,0,0.0,0.0,0.0
1997.0,IR,2380,2380,42,27,15,0.011344538,0.01764706,0.006302521
1998.0,IR,3294,3294,64,47,17,0.014268367,0.019429265,0.0051608984
1999.0,IR,4166,4166,98,34,64,0.008161305,0.023523765,0.015362458
2000.0,IR,5408,5408,107,49,58,0.009060651,0.019785503,0.010724852
2001.0,IR,7028,7028,134,68,66,0.009675584,0.01906659,0.009391007
2002.0,IR,9313,9313,173,107,66,0.011489316,0.018576184,0.007086868
2003.0,IR,12335,12335,229,128,101,0.010376976,0.018565059,0.008188083
2004.0,IR,16510,16510,262,145,117,0.008782556,0.01586917,0.007086614
2005.0,IR,21985,21985,353,237,116,0.010780077,0.016056402,0.0052763247
2006.0,IR,28692,28692,436,284,152,0.0098982295,0.015195874,0.005297644
2007.0,IR,36381,36381,478,378,100,0.010390039,0.013138726,0.0027486875
2008.0,IR,45034,45034,589,499,90,0.0110805165,0.013079007,0.00199849
2009.0,IR,56987,56987,649,722,-73,0.012669556,0.011388563,-0.0012809939
2010.0,IR,69760,69760,802,958,-156,0.013732798,0.01149656,-0.0022362384
2011.0,IR,82428,82428,923,1162,-239,0.014097151,0.011197652,-0.0028995
2012.0,IR,95592,95592,1067,1462,-395,0.015294167,0.011162022,-0.004132145
2013.0,IR,107258,107258,1188,1787,-599,0.016660761,0.011076096,-0.005584665
2014.0,IR,117399,117399,1388,1984,-596,0.016899632,0.011822929,-0.005076704
2015.0,IR,125720,125720,1469,2196,-727,0.017467387,0.011684696,-0.0057826918
2016.0,IR,132326,132326,1646,2382,-736,0.018000998,0.012438976,-0.005562021
2017.0,IR,137695,137695,1724,2437,-713,0.017698536,0.012520426,-0.005178111
2018.0,IR,141858,141858,1916,2731,-815,0.019251646,0.013506465,-0.005745182
2019.0,IR,142006,142006,1921,3053,-1132,0.021499092,0.013527597,-0.007971494
2020.0,IR,135312,135312,1663,2903,-1240,0.02145412,0.012290115,-0.009164006
2021.0,IR,124805,124805,1214,2266,-1052,0.018156324,0.009727174,-0.008429149
2022.0,IR,0,0,793,1626,-833,,,
1996.0,IS,464,464,0,0,0,0.0,0.0,0.0
1997.0,IS,540,540,13,14,-1,0.025925925,0.024074074,-0.0018518518
1998.0,IS,641,641,21,15,6,0.023400936,0.03276131,0.009360374
1999.0,IS,706,706,29,20,9,0.028328612,0.04107649,0.012747875
2000.0,IS,803,803,34,34,0,0.04234122,0.04234122,0.0
2001.0,IS,882,882,46,33,13,0.037414964,0.052154195,0.014739229
2002.0,IS,1006,1006,49,20,29,0.019880716,0.048707753,0.028827038
2003.0,IS,1087,1087,54,29,25,0.026678933,0.049678013,0.02299908
2004.0,IS,1165,1165,46,28,18,0.024034334,0.039484978,0.015450643
2005.0,IS,1212,1212,45,39,6,0.03217822,0.037128713,0.004950495
2006.0,IS,1282,1282,66,52,14,0.040561624,0.05148206,0.010920437
2007.0,IS,1368,1368,69,48,21,0.03508772,0.050438598,0.015350877
2008.0,IS,1497,1497,73,56,17,0.03740815,0.048764195,0.0113560455
2009.0,IS,1573,1573,75,70,5,0.044500954,0.047679592,0.0031786396
2010.0,IS,1717,1717,101,72,29,0.041933604,0.05882353,0.016889924
2011.0,IS,1784,1784,76,91,-15,0.05100897,0.042600896,-0.0084080715
2012.0,IS,1847,1847,100,66,34,0.03573362,0.054141853,0.01840823
2013.0,IS,1946,1946,92,86,6,0.044193216,0.047276463,0.0030832477
2014.0,IS,2028,2028,100,98,2,0.04832347,0.049309663,0.0009861933
2015.0,IS,2166,2166,130,85,45,0.039242845,0.06001847,0.020775624
2016.0,IS,2214,2214,109,98,11,0.044263776,0.04923216,0.004968383
2017.0,IS,2299,2299,122,95,27,0.041322313,0.05306655,0.011744237
2018.0,IS,2360,2360,122,103,19,0.043644067,0.051694915,0.008050848
2019.0,IS,2445,2445,134,112,22,0.04580777,0.054805726,0.008997955
2020.0,IS,2407,2407,117,105,12,0.043622766,0.048608225,0.004985459
2021.0,IS,2239,2239,97,78,19,0.03483698,0.043322913,0.008485931
2022.0,IS,0,0,55,56,-1,,,
1996.0,IT,71747,71747,0,0,0,0.0,0.0,0.0
1997.0,IT,82250,82250,1259,1248,11,0.015173253,0.015306991,0.0001337386
1998.0,IT,92280,92280,1442,1741,-299,0.018866492,0.015626354,-0.0032401388
1999.0,IT,96063,96063,1583,1837,-254,0.019122867,0.01647877,-0.0026440981
2000.0,IT,100011,100011,1707,2035,-328,0.020347761,0.017068122,-0.0032796392
2001.0,IT,105466,105466,1984,2075,-91,0.019674588,0.01881175,-0.0008628373
2002.0,IT,112079,112079,2217,2223,-6,0.019834224,0.01978069,-5.353367e-05
2003.0,IT,118696,118696,2285,2250,35,0.018955989,0.019250859,0.00029487093
2004.0,IT,125905,125905,2251,2453,-202,0.019482944,0.017878558,-0.0016043843
2005.0,IT,133489,133489,2415,2798,-383,0.020960528,0.018091379,-0.0028691504
2006.0,IT,141450,141450,2674,3099,-425,0.021908801,0.018904207,-0.0030045952
2007.0,IT,149546,149546,2918,3308,-390,0.022120284,0.01951239,-0.0026078932
2008.0,IT,156744,156744,3026,3761,-735,0.023994539,0.019305363,-0.0046891747
2009.0,IT,163585,163585,3100,3942,-842,0.024097564,0.018950393,-0.005147171
2010.0,IT,170647,170647,3291,4215,-924,0.024700113,0.019285426,-0.0054146866
2011.0,IT,178167,178167,3509,4681,-1172,0.026273103,0.019695004,-0.006578098
2012.0,IT,184438,184438,3757,4883,-1126,0.026475022,0.020369988,-0.0061050327
2013.0,IT,190234,190234,4090,5270,-1180,0.027702725,0.021499837,-0.006202887
2014.0,IT,195954,195954,4331,5513,-1182,0.028134154,0.022102127,-0.006032028
2015.0,IT,200837,200837,4527,5709,-1182,0.028426036,0.022540668,-0.0058853696
2016.0,IT,203734,203734,4556,6057,-1501,0.029729942,0.022362493,-0.00736745
2017.0,IT,206996,206996,4612,6167,-1555,0.029792847,0.022280624,-0.0075122225
2018.0,IT,212423,212423,5125,6337,-1212,0.029831987,0.02412639,-0.005705597
2019.0,IT,214171,214171,5586,6311,-725,0.029467108,0.026081963,-0.0033851455
2020.0,IT,207009,207009,5245,5762,-517,0.027834538,0.025337063,-0.002497476
2021.0,IT,194868,194868,4367,4305,62,0.022091877,0.022410043,0.0003181641
2022.0,IT,0,0,2973,3127,-154,,,
2023.0,IT,0,0,243,266,-23,,,
1996.0,JE,5,5,0,0,0,0.0,0.0,0.0
1997.0,JE,7,7,0,0,0,0.0,0.0,0.0
1998.0,JE,8,8,0,0,0,0.0,0.0,0.0
1999.0,JE,10,10,2,1,1,0.1,0.2,0.1
2000.0,JE,10,10,0,1,-1,0.1,0.0,-0.1
2001.0,JE,8,8,0,0,0,0.0,0.0,0.0
2002.0,JE,7,7,1,3,-2,0.42857143,0.14285715,-0.2857143
2004.0,JE,13,13,1,0,1,0.0,0.07692308,0.07692308
2005.0,JE,11,11,2,2,0,0.18181819,0.18181819,0.0
2006.0,JE,13,13,1,0,1,0.0,0.07692308,0.07692308
2008.0,JE,17,17,1,3,-2,0.1764706,0.05882353,-0.11764706
2009.0,JE,16,16,4,4,0,0.25,0.25,0.0
2010.0,JE,19,19,3,2,1,0.10526316,0.15789473,0.05263158
2011.0,JE,20,20,2,1,1,0.05,0.1,0.05
2012.0,JE,14,14,0,4,-4,0.2857143,0.0,-0.2857143
2013.0,JE,17,17,5,4,1,0.23529412,0.29411766,0.05882353
2015.0,JE,25,25,3,0,3,0.0,0.12,0.12
2016.0,JE,24,24,3,3,0,0.125,0.125,0.0
2017.0,JE,24,24,1,3,-2,0.125,0.041666668,-0.083333336
2019.0,JE,21,21,0,0,0,0.0,0.0,0.0
2020.0,JE,23,23,6,3,3,0.13043478,0.26086956,0.13043478
1996.0,JM,210,210,0,0,0,0.0,0.0,0.0
1997.0,JM,259,259,11,12,-1,0.046332046,0.042471044,-0.0038610038
1998.0,JM,292,292,13,23,-10,0.07876712,0.04452055,-0.034246575
1999.0,JM,323,323,22,19,3,0.05882353,0.06811146,0.009287925
2000.0,JM,334,334,14,28,-14,0.08383234,0.04191617,-0.04191617
2001.0,JM,363,363,44,26,18,0.071625344,0.121212125,0.049586777
2002.0,JM,381,381,23,30,-7,0.07874016,0.060367454,-0.018372703
2003.0,JM,411,411,32,30,2,0.0729927,0.07785888,0.00486618
2004.0,JM,449,449,28,31,-3,0.06904232,0.0623608,-0.0066815144
2005.0,JM,476,476,39,30,9,0.063025214,0.081932776,0.018907564
2006.0,JM,538,538,53,34,19,0.063197024,0.098513015,0.035315987
2007.0,JM,578,578,36,36,0,0.062283736,0.062283736,0.0
2008.0,JM,609,609,48,50,-2,0.08210181,0.07881773,-0.0032840723
2009.0,JM,650,650,50,49,1,0.07538462,0.07692308,0.0015384615
2010.0,JM,685,685,59,51,8,0.07445256,0.08613139,0.011678832
2011.0,JM,690,690,44,54,-10,0.07826087,0.06376812,-0.014492754
2012.0,JM,702,702,57,65,-8,0.09259259,0.081196584,-0.011396011
2013.0,JM,750,750,65,57,8,0.076,0.086666666,0.010666667
2014.0,JM,781,781,67,55,12,0.07042254,0.08578745,0.015364917
2015.0,JM,775,775,61,62,-1,0.08,0.07870968,-0.0012903226
2016.0,JM,744,744,53,99,-46,0.13306452,0.07123656,-0.061827958
2017.0,JM,703,703,52,62,-10,0.088193454,0.07396871,-0.014224751
2018.0,JM,661,661,58,81,-23,0.12254161,0.08774584,-0.034795765
2019.0,JM,659,659,60,55,5,0.08345979,0.09104704,0.0075872536
2020.0,JM,616,616,50,52,-2,0.084415585,0.08116883,-0.0032467532
2021.0,JM,563,563,52,43,9,0.07637656,0.092362344,0.01598579
1996.0,JO,660,660,0,0,0,0.0,0.0,0.0
1997.0,JO,823,823,24,21,3,0.025516404,0.029161604,0.0036452005
1998.0,JO,1009,1009,47,22,25,0.021803766,0.046580773,0.024777006
1999.0,JO,1110,1110,44,22,22,0.01981982,0.03963964,0.01981982
2000.0,JO,1203,1203,41,34,7,0.028262677,0.034081463,0.0058187866
2001.0,JO,1265,1265,51,53,-2,0.041897234,0.040316205,-0.0015810276
2002.0,JO,1398,1398,64,41,23,0.02932761,0.045779686,0.016452074
2003.0,JO,1504,1504,52,52,0,0.034574468,0.034574468,0.0
2004.0,JO,1698,1698,90,46,44,0.027090695,0.053003535,0.025912838
2005.0,JO,1915,1915,131,81,50,0.04229765,0.06840731,0.02610966
2006.0,JO,2210,2210,148,90,58,0.040723983,0.06696833,0.026244344
2007.0,JO,2489,2489,119,139,-20,0.055845723,0.047810365,-0.008035355
2008.0,JO,2868,2868,156,106,50,0.036959555,0.054393306,0.017433751
2009.0,JO,3226,3226,133,108,25,0.03347799,0.041227527,0.007749535
2010.0,JO,3565,3565,146,148,-2,0.04151473,0.040953718,-0.0005610098
2011.0,JO,3904,3904,171,185,-14,0.047387294,0.04380123,-0.0035860655
2012.0,JO,4338,4338,222,188,34,0.043337945,0.051175658,0.007837714
2013.0,JO,4609,4609,238,213,25,0.04621393,0.0516381,0.0054241703
2014.0,JO,4940,4940,256,225,31,0.045546558,0.05182186,0.0062753037
2015.0,JO,5263,5263,238,269,-31,0.051111534,0.045221355,-0.0058901766
2016.0,JO,5663,5663,297,303,-6,0.05350521,0.0524457,-0.0010595091
2017.0,JO,6198,6198,343,259,84,0.041787673,0.05534043,0.013552759
2018.0,JO,6841,6841,381,339,42,0.049554158,0.05569361,0.0061394535
2019.0,JO,7348,7348,451,380,71,0.051714752,0.061377246,0.009662493
2020.0,JO,7307,7307,420,387,33,0.052962914,0.05747913,0.0045162174
2021.0,JO,6961,6961,314,321,-7,0.046114065,0.04510846,-0.0010056027
2022.0,JO,0,0,194,191,3,,,
1996.0,JP,155935,155935,0,0,0,0.0,0.0,0.0
1997.0,JP,179717,179717,2208,2100,108,0.011685038,0.012285983,0.0006009448
1998.0,JP,201403,201403,2831,2884,-53,0.014319548,0.014056395,-0.00026315398
1999.0,JP,208458,208458,3100,3268,-168,0.015677018,0.014871101,-0.0008059177
2000.0,JP,215539,215539,3282,3454,-172,0.016024942,0.0152269425,-0.00079799944
2001.0,JP,221421,221421,3564,3889,-325,0.017563825,0.016096035,-0.0014677921
2002.0,JP,227892,227892,3743,4155,-412,0.018232321,0.016424447,-0.001807874
2003.0,JP,232288,232288,3785,4381,-596,0.018860208,0.016294427,-0.0025657804
2004.0,JP,237028,237028,3979,4462,-483,0.01882478,0.016787047,-0.002037734
2005.0,JP,241250,241250,4221,4637,-416,0.019220725,0.017496374,-0.0017243524
2006.0,JP,245278,245278,4063,4737,-674,0.01931278,0.016564878,-0.0027479024
2007.0,JP,249384,249384,4333,4981,-648,0.019973215,0.017374812,-0.0025984026
2008.0,JP,254456,254456,4297,5197,-900,0.020423964,0.016887005,-0.0035369573
2009.0,JP,259197,259197,4612,5162,-550,0.019915354,0.017793415,-0.0021219382
2010.0,JP,263765,263765,4593,5092,-499,0.019305063,0.017413227,-0.0018918356
2011.0,JP,269128,269128,4670,5262,-592,0.019552035,0.017352337,-0.0021996968
2012.0,JP,274504,274504,4690,5095,-405,0.01856075,0.01708536,-0.0014753883
2013.0,JP,278360,278360,4584,5328,-744,0.019140681,0.016467884,-0.0026727978
2014.0,JP,283264,283264,4789,5195,-406,0.018339781,0.01690649,-0.0014332919
2015.0,JP,289655,289655,4685,5407,-722,0.018667035,0.016174415,-0.0024926206
2016.0,JP,296329,296329,5043,5531,-488,0.018665064,0.017018247,-0.0016468182
2017.0,JP,302004,302004,5391,5278,113,0.01747659,0.017850757,0.00037416723
2018.0,JP,304967,304967,5404,5420,-16,0.017772414,0.01771995,-5.2464693e-05
2019.0,JP,305232,305232,5412,5634,-222,0.01845809,0.017730774,-0.0007273156
2020.0,JP,294344,294344,4979,5043,-64,0.017133014,0.016915582,-0.00021743267
2021.0,JP,272189,272189,3645,3804,-159,0.013975583,0.0133914305,-0.00058415293
2022.0,JP,0,0,2477,2525,-48,,,
2023.0,JP,0,0,215,186,29,,,
1996.0,KE,878,878,0,0,0,0.0,0.0,0.0
1997.0,KE,1079,1079,45,34,11,0.03151066,0.041705284,0.010194625
1998.0,KE,1220,1220,59,57,2,0.046721313,0.048360657,0.0016393443
1999.0,KE,1319,1319,61,54,7,0.040940106,0.04624716,0.005307051
2000.0,KE,1423,1423,65,66,-1,0.046380885,0.045678146,-0.0007027407
2001.0,KE,1498,1498,58,80,-22,0.05340454,0.03871829,-0.014686248
2002.0,KE,1734,1734,89,76,13,0.043829296,0.051326413,0.0074971165
2003.0,KE,1921,1921,104,96,8,0.049973972,0.05413847,0.004164498
2004.0,KE,2089,2089,105,93,12,0.04451891,0.050263286,0.0057443753
2005.0,KE,2207,2207,114,116,-2,0.052560035,0.05165383,-0.00090620754
2006.0,KE,2464,2464,123,124,-1,0.050324675,0.04991883,-0.00040584416
2007.0,KE,2708,2708,132,140,-8,0.05169867,0.048744462,-0.0029542097
2008.0,KE,2967,2967,143,146,-3,0.049207956,0.048196834,-0.0010111224
2009.0,KE,3357,3357,173,142,31,0.042299673,0.05153411,0.009234436
2010.0,KE,3854,3854,200,189,11,0.04903996,0.051894136,0.0028541775
2011.0,KE,4345,4345,219,189,30,0.043498274,0.05040276,0.006904488
2012.0,KE,4958,4958,251,219,32,0.044171035,0.050625253,0.0064542154
2013.0,KE,5542,5542,288,253,35,0.04565139,0.051966798,0.0063154097
2014.0,KE,6236,6236,362,261,101,0.041853752,0.058050033,0.016196279
2015.0,KE,6798,6798,339,333,6,0.048984997,0.049867608,0.00088261254
2016.0,KE,7533,7533,424,302,122,0.04009027,0.056285676,0.016195407
2017.0,KE,8074,8074,420,364,56,0.045082983,0.052018825,0.0069358433
2018.0,KE,8596,8596,433,455,-22,0.052931596,0.050372265,-0.0025593298
2019.0,KE,8828,8828,465,480,-15,0.054372452,0.052673314,-0.0016991391
2020.0,KE,8596,8596,445,437,8,0.0508376,0.051768266,0.0009306654
2021.0,KE,8047,8047,344,309,35,0.038399402,0.04274885,0.004349447
2022.0,KE,0,0,190,221,-31,,,
1996.0,KG,15,15,0,0,0,0.0,0.0,0.0
1997.0,KG,17,17,0,0,0,0.0,0.0,0.0
1998.0,KG,29,29,1,0,1,0.0,0.03448276,0.03448276
1999.0,KG,32,32,1,4,-3,0.125,0.03125,-0.09375
2000.0,KG,39,39,1,2,-1,0.051282052,0.025641026,-0.025641026
2001.0,KG,49,49,3,2,1,0.040816326,0.06122449,0.020408163
2002.0,KG,55,55,3,0,3,0.0,0.054545455,0.054545455
2003.0,KG,67,67,1,0,1,0.0,0.014925373,0.014925373
2004.0,KG,79,79,2,3,-1,0.03797468,0.025316456,-0.012658228
2005.0,KG,82,82,0,4,-4,0.048780486,0.0,-0.048780486
2006.0,KG,105,105,6,2,4,0.01904762,0.057142857,0.03809524
2007.0,KG,126,126,5,2,3,0.015873017,0.03968254,0.023809524
2008.0,KG,139,139,5,2,3,0.01438849,0.035971224,0.021582734
2009.0,KG,154,154,4,3,1,0.019480519,0.025974026,0.0064935065
2010.0,KG,181,181,4,6,-2,0.03314917,0.022099448,-0.011049724
2011.0,KG,186,186,5,4,1,0.021505376,0.02688172,0.005376344
2012.0,KG,204,204,8,11,-3,0.05392157,0.039215688,-0.014705882
2013.0,KG,225,225,11,10,1,0.044444446,0.04888889,0.0044444446
2014.0,KG,249,249,11,5,6,0.02008032,0.044176705,0.024096385
2015.0,KG,287,287,9,20,-11,0.06968641,0.031358887,-0.038327526
2016.0,KG,339,339,15,12,3,0.03539823,0.044247787,0.0088495575
2017.0,KG,437,437,33,16,17,0.03661327,0.075514875,0.0389016
2018.0,KG,577,577,32,16,16,0.027729636,0.055459272,0.027729636
2019.0,KG,713,713,54,29,25,0.04067321,0.07573633,0.035063114
2020.0,KG,732,732,46,30,16,0.040983606,0.06284153,0.021857923
2021.0,KG,719,719,47,29,18,0.040333796,0.06536857,0.02503477
2022.0,KG,0,0,27,25,2,,,
1996.0,KH,45,45,0,0,0,0.0,0.0,0.0
1997.0,KH,67,67,9,3,6,0.04477612,0.13432837,0.08955224
1998.0,KH,71,71,5,6,-1,0.08450704,0.07042254,-0.014084507
1999.0,KH,71,71,7,11,-4,0.15492958,0.09859155,-0.056338027
2000.0,KH,86,86,7,8,-1,0.093023255,0.08139535,-0.011627907
2001.0,KH,96,96,10,11,-1,0.114583336,0.104166664,-0.010416667
2002.0,KH,104,104,7,15,-8,0.14423077,0.067307696,-0.07692308
2003.0,KH,129,129,14,14,0,0.10852713,0.10852713,0.0
2004.0,KH,146,146,8,13,-5,0.0890411,0.05479452,-0.034246575
2005.0,KH,168,168,12,8,4,0.04761905,0.071428575,0.023809524
2006.0,KH,195,195,18,19,-1,0.0974359,0.092307694,-0.0051282053
2007.0,KH,224,224,19,20,-1,0.08928572,0.084821425,-0.004464286
2008.0,KH,234,234,14,14,0,0.05982906,0.05982906,0.0
2009.0,KH,300,300,30,16,14,0.053333335,0.1,0.046666667
2010.0,KH,356,356,27,25,2,0.07022472,0.07584269,0.0056179776
2011.0,KH,413,413,25,27,-2,0.065375306,0.06053269,-0.004842615
2012.0,KH,450,450,17,25,-8,0.055555556,0.037777778,-0.017777778
2013.0,KH,512,512,29,24,5,0.046875,0.056640625,0.009765625
2014.0,KH,539,539,23,25,-2,0.04638219,0.042671613,-0.0037105752
2015.0,KH,562,562,32,35,-3,0.06227758,0.0569395,-0.0053380784
2016.0,KH,629,629,50,38,12,0.060413353,0.07949126,0.0190779
2017.0,KH,673,673,56,49,7,0.07280832,0.08320951,0.010401188
2018.0,KH,745,745,67,35,32,0.046979867,0.08993289,0.04295302
2019.0,KH,753,753,79,57,22,0.07569721,0.10491368,0.029216468
2020.0,KH,715,715,75,73,2,0.1020979,0.10489511,0.002797203
2021.0,KH,659,659,57,50,7,0.07587253,0.08649469,0.010622155
2022.0,KH,0,0,46,40,6,,,
2014.0,KI,2,2,0,0,0,0.0,0.0,0.0
2008.0,KN,15,15,2,1,1,0.06666667,0.13333334,0.06666667
2009.0,KN,20,20,5,1,4,0.05,0.25,0.2
2010.0,KN,38,38,13,0,13,0.0,0.34210527,0.34210527
2011.0,KN,42,42,6,3,3,0.071428575,0.14285715,0.071428575
2012.0,KN,51,51,6,5,1,0.09803922,0.11764706,0.019607844
2013.0,KN,51,51,9,10,-1,0.19607843,0.1764706,-0.019607844
2014.0,KN,79,79,14,1,13,0.012658228,0.17721519,0.16455697
2015.0,KN,91,91,13,6,7,0.06593407,0.14285715,0.07692308
2016.0,KN,98,98,16,16,0,0.1632653,0.1632653,0.0
2017.0,KN,104,104,15,16,-1,0.15384616,0.14423077,-0.009615385
2018.0,KN,119,119,18,11,7,0.09243698,0.15126051,0.05882353
2019.0,KN,123,123,12,7,5,0.05691057,0.09756097,0.040650405
2020.0,KN,118,118,15,21,-6,0.1779661,0.12711865,-0.050847456
2021.0,KN,105,105,9,14,-5,0.13333334,0.08571429,-0.04761905
2022.0,KN,0,0,8,8,0,,,
1998.0,KP,10,10,1,0,1,0.0,0.1,0.1
1999.0,KP,12,12,2,0,2,0.0,0.16666667,0.16666667
2003.0,KP,6,6,2,0,2,0.0,0.33333334,0.33333334
2004.0,KP,5,5,0,2,-2,0.4,0.0,-0.4
2005.0,KP,6,6,0,0,0,0.0,0.0,0.0
2006.0,KP,9,9,1,0,1,0.0,0.11111111,0.11111111
2007.0,KP,13,13,0,1,-1,0.07692308,0.0,-0.07692308
2008.0,KP,12,12,1,0,1,0.0,0.083333336,0.083333336
2009.0,KP,11,11,0,2,-2,0.18181819,0.0,-0.18181819
2010.0,KP,14,14,2,0,2,0.0,0.14285715,0.14285715
2011.0,KP,24,24,5,0,5,0.0,0.20833333,0.20833333
2012.0,KP,44,44,9,2,7,0.045454547,0.20454545,0.1590909
2013.0,KP,59,59,1,3,-2,0.050847456,0.016949153,-0.033898305
2014.0,KP,87,87,5,4,1,0.04597701,0.057471264,0.011494253
2015.0,KP,119,119,4,2,2,0.016806724,0.033613447,0.016806724
2016.0,KP,172,172,12,1,11,0.0058139535,0.069767445,0.06395349
2017.0,KP,257,257,22,10,12,0.038910504,0.08560311,0.046692606
2018.0,KP,344,344,28,7,21,0.020348838,0.08139535,0.06104651
2019.0,KP,403,403,42,12,30,0.029776676,0.104218364,0.074441686
2020.0,KP,419,419,29,8,21,0.01909308,0.06921241,0.050119333
2021.0,KP,423,423,23,14,9,0.03309693,0.05437352,0.021276595
2022.0,KP,0,0,8,14,-6,,,
1996.0,KR,14884,14884,0,0,0,0.0,0.0,0.0
1997.0,KR,18856,18856,654,377,277,0.019993637,0.03468392,0.014690285
1998.0,KR,23203,23203,838,525,313,0.022626385,0.03611602,0.013489635
1999.0,KR,26434,26434,915,668,247,0.025270484,0.03461451,0.009344026
2000.0,KR,29634,29634,1027,815,212,0.027502194,0.034656137,0.0071539446
2001.0,KR,32986,32986,1201,1046,155,0.031710424,0.036409386,0.0046989634
2002.0,KR,36423,36423,1343,1330,13,0.03651539,0.036872305,0.00035691733
2003.0,KR,39686,39686,1532,1442,90,0.03633523,0.038603034,0.0022678021
2004.0,KR,43588,43588,1706,1466,240,0.03363311,0.03913921,0.0055061025
2005.0,KR,47249,47249,1867,1741,126,0.03684734,0.039514065,0.0026667232
2006.0,KR,51662,51662,2002,1824,178,0.035306416,0.03875189,0.0034454726
2007.0,KR,56321,56321,2195,1975,220,0.03506685,0.03897303,0.0039061806
2008.0,KR,61311,61311,2424,2045,379,0.033354536,0.039536137,0.0061815986
2009.0,KR,66094,66094,2587,2277,310,0.034450933,0.039141223,0.0046902895
2010.0,KR,71477,71477,2791,2484,307,0.03475244,0.039047524,0.004295088
2011.0,KR,76346,76346,2877,2730,147,0.035758257,0.037683703,0.0019254447
2012.0,KR,81054,81054,2999,2642,357,0.032595553,0.037000023,0.0044044713
2013.0,KR,85248,85248,3216,2828,388,0.0331738,0.037725225,0.0045514265
2014.0,KR,88712,88712,3213,2998,215,0.033794753,0.036218323,0.0024235728
2015.0,KR,91423,91423,3169,2868,301,0.031370662,0.03466305,0.003292388
2016.0,KR,93009,93009,3163,3284,-121,0.03530841,0.03400746,-0.0013009494
2017.0,KR,94201,94201,3174,3489,-315,0.037037823,0.03369391,-0.0033439135
2018.0,KR,94745,94745,3389,3608,-219,0.038081165,0.035769697,-0.0023114677
2019.0,KR,94873,94873,3381,3726,-345,0.039273556,0.035637114,-0.0036364403
2020.0,KR,92740,92740,3356,3575,-219,0.03854863,0.03618719,-0.0023614406
2021.0,KR,86914,86914,2686,2719,-33,0.0312838,0.030904112,-0.00037968566
2022.0,KR,0,0,2128,2062,66,,,
1996.0,KW,792,792,0,0,0,0.0,0.0,0.0
1997.0,KW,974,974,26,22,4,0.02258727,0.026694044,0.0041067763
1998.0,KW,1101,1101,42,20,22,0.018165303,0.03814714,0.019981835
1999.0,KW,1174,1174,43,34,9,0.028960818,0.036626916,0.007666099
2000.0,KW,1222,1222,44,56,-12,0.045826513,0.036006548,-0.009819968
2001.0,KW,1263,1263,58,48,10,0.038004752,0.045922406,0.007917657
2002.0,KW,1282,1282,51,53,-2,0.041341655,0.039781593,-0.0015600624
2003.0,KW,1350,1350,61,44,17,0.03259259,0.045185186,0.012592592
2004.0,KW,1423,1423,77,60,17,0.04216444,0.054111034,0.011946592
2005.0,KW,1501,1501,65,62,3,0.041305795,0.043304462,0.0019986676
2006.0,KW,1567,1567,76,79,-3,0.050414804,0.048500318,-0.0019144863
2007.0,KW,1685,1685,94,71,23,0.042136498,0.05578635,0.013649852
2008.0,KW,1781,1781,91,87,4,0.04884896,0.05109489,0.0022459293
2009.0,KW,1804,1804,94,107,-13,0.059312638,0.05210643,-0.0072062085
2010.0,KW,1833,1833,108,130,-22,0.07092199,0.058919802,-0.012002182
2011.0,KW,1982,1982,117,108,9,0.054490414,0.05903128,0.0045408676
2012.0,KW,2015,2015,102,113,-11,0.056079406,0.050620347,-0.005459057
2013.0,KW,2142,2142,136,117,19,0.05462185,0.06349207,0.008870215
2014.0,KW,2264,2264,158,133,25,0.05874558,0.06978799,0.011042403
2015.0,KW,2385,2385,155,149,6,0.062473796,0.064989515,0.0025157232
2016.0,KW,2481,2481,179,194,-15,0.078194275,0.07214833,-0.006045949
2017.0,KW,2599,2599,199,192,7,0.07387457,0.07656791,0.0026933437
2018.0,KW,2729,2729,232,232,0,0.08501282,0.08501282,0.0
2019.0,KW,2848,2848,272,217,55,0.07619382,0.09550562,0.019311797
2020.0,KW,2793,2793,229,218,11,0.078052275,0.08199069,0.0039384174
2021.0,KW,2623,2623,173,142,31,0.054136485,0.06595501,0.011818528
2022.0,KW,0,0,120,101,19,,,
1996.0,KY,1,1,0,0,0,0.0,0.0,0.0
2000.0,KY,2,2,0,1,-1,0.5,0.0,-0.5
2002.0,KY,3,3,0,0,0,0.0,0.0,0.0
2004.0,KY,3,3,0,0,0,0.0,0.0,0.0
2007.0,KY,11,11,2,0,2,0.0,0.18181819,0.18181819
2008.0,KY,18,18,3,0,3,0.0,0.16666667,0.16666667
2009.0,KY,27,27,4,1,3,0.037037037,0.14814815,0.11111111
2010.0,KY,28,28,3,4,-1,0.14285715,0.10714286,-0.035714287
2011.0,KY,34,34,4,1,3,0.029411765,0.11764706,0.0882353
2012.0,KY,28,28,2,7,-5,0.25,0.071428575,-0.17857143
2013.0,KY,25,25,3,4,-1,0.16,0.12,-0.04
2014.0,KY,23,23,1,4,-3,0.17391305,0.04347826,-0.13043478
2015.0,KY,18,18,1,2,-1,0.11111111,0.055555556,-0.055555556
2016.0,KY,19,19,2,2,0,0.10526316,0.10526316,0.0
2018.0,KY,29,29,5,1,4,0.03448276,0.1724138,0.13793103
2019.0,KY,29,29,3,3,0,0.10344828,0.10344828,0.0
2022.0,KY,0,0,2,3,-1,,,
1996.0,KZ,155,155,0,0,0,0.0,0.0,0.0
1997.0,KZ,215,215,5,1,4,0.004651163,0.023255814,0.018604651
1998.0,KZ,276,276,6,10,-4,0.036231883,0.02173913,-0.014492754
1999.0,KZ,363,363,13,8,5,0.022038568,0.035812672,0.013774104
2000.0,KZ,454,454,11,12,-1,0.026431719,0.024229076,-0.002202643
2001.0,KZ,546,546,18,20,-2,0.03663004,0.032967035,-0.0036630037
2002.0,KZ,619,619,27,25,2,0.040387724,0.04361874,0.0032310179
2003.0,KZ,699,699,33,22,11,0.031473532,0.047210302,0.015736766
2004.0,KZ,775,775,39,32,7,0.041290324,0.05032258,0.009032258
2005.0,KZ,849,849,40,47,-7,0.055359244,0.047114253,-0.008244994
2006.0,KZ,876,876,49,58,-9,0.06621005,0.055936072,-0.0102739725
2007.0,KZ,923,923,60,77,-17,0.08342362,0.065005414,-0.018418202
2008.0,KZ,979,979,60,75,-15,0.076608784,0.061287027,-0.015321757
2009.0,KZ,1106,1106,78,51,27,0.046112116,0.07052441,0.024412297
2010.0,KZ,1368,1368,77,68,9,0.049707603,0.05628655,0.0065789474
2011.0,KZ,1862,1862,85,81,4,0.04350161,0.045649838,0.0021482278
2012.0,KZ,2603,2603,125,105,20,0.040338073,0.048021514,0.007683442
2013.0,KZ,3314,3314,158,92,66,0.027761014,0.047676522,0.01991551
2014.0,KZ,4032,4032,164,155,9,0.03844246,0.040674604,0.002232143
2015.0,KZ,4780,4780,221,161,60,0.033682007,0.04623431,0.012552301
2016.0,KZ,5405,5405,212,171,41,0.031637374,0.03922294,0.007585569
2017.0,KZ,6013,6013,198,220,-22,0.036587395,0.032928653,-0.0036587394
2018.0,KZ,6941,6941,287,233,54,0.03356865,0.04134851,0.007779859
2019.0,KZ,7419,7419,284,283,1,0.038145304,0.038280092,0.00013478905
2020.0,KZ,7394,7394,307,251,56,0.033946443,0.041520152,0.0075737084
2021.0,KZ,7067,7067,236,231,5,0.03268714,0.03339465,0.00070751377
2022.0,KZ,0,0,209,150,59,,,
1996.0,LA,3,3,0,0,0,0.0,0.0,0.0
1997.0,LA,5,5,0,0,0,0.0,0.0,0.0
1999.0,LA,15,15,2,2,0,0.13333334,0.13333334,0.0
2000.0,LA,19,19,3,1,2,0.05263158,0.15789473,0.10526316
2001.0,LA,26,26,2,1,1,0.03846154,0.07692308,0.03846154
2002.0,LA,30,30,6,3,3,0.1,0.2,0.1
2003.0,LA,34,34,0,1,-1,0.029411765,0.0,-0.029411765
2004.0,LA,43,43,1,3,-2,0.069767445,0.023255814,-0.046511628
2005.0,LA,46,46,3,5,-2,0.10869565,0.06521739,-0.04347826
2006.0,LA,50,50,2,2,0,0.04,0.04,0.0
2007.0,LA,59,59,3,4,-1,0.06779661,0.050847456,-0.016949153
2008.0,LA,73,73,5,3,2,0.04109589,0.06849315,0.02739726
2009.0,LA,82,82,4,3,1,0.036585364,0.048780486,0.0121951215
2010.0,LA,96,96,5,5,0,0.052083332,0.052083332,0.0
2011.0,LA,115,115,7,10,-3,0.08695652,0.060869563,-0.026086956
2012.0,LA,133,133,6,5,1,0.037593983,0.04511278,0.007518797
2013.0,LA,139,139,7,7,0,0.05035971,0.05035971,0.0
2014.0,LA,143,143,10,7,3,0.04895105,0.06993007,0.02097902
2015.0,LA,174,174,12,6,6,0.03448276,0.06896552,0.03448276
2016.0,LA,194,194,17,8,9,0.041237112,0.087628864,0.04639175
2017.0,LA,212,212,20,18,2,0.08490566,0.094339624,0.009433962
2018.0,LA,237,237,17,8,9,0.033755273,0.07172996,0.03797468
2019.0,LA,252,252,28,15,13,0.05952381,0.11111111,0.051587302
2020.0,LA,263,263,24,11,13,0.041825093,0.091254756,0.04942966
2021.0,LA,265,265,26,8,18,0.03018868,0.09811321,0.06792453
1996.0,LB,366,366,0,0,0,0.0,0.0,0.0
1997.0,LB,508,508,24,5,19,0.00984252,0.047244094,0.037401576
1998.0,LB,638,638,18,11,7,0.01724138,0.028213166,0.010971786
1999.0,LB,805,805,44,24,20,0.029813664,0.054658387,0.024844721
2000.0,LB,923,923,55,33,22,0.03575298,0.0595883,0.02383532
2001.0,LB,1085,1085,58,47,11,0.043317974,0.05345622,0.010138249
2002.0,LB,1255,1255,57,36,21,0.028685259,0.045418326,0.016733067
2003.0,LB,1431,1431,81,49,32,0.034241788,0.056603774,0.022361984
2004.0,LB,1597,1597,84,82,2,0.051346276,0.05259862,0.0012523482
2005.0,LB,1794,1794,98,85,13,0.047380157,0.054626532,0.007246377
2006.0,LB,2013,2013,116,86,30,0.042722303,0.057625435,0.01490313
2007.0,LB,2187,2187,112,108,4,0.049382716,0.051211707,0.0018289895
2008.0,LB,2316,2316,120,122,-2,0.052677028,0.051813472,-0.00086355786
2009.0,LB,2540,2540,136,159,-23,0.06259842,0.053543307,-0.009055118
2010.0,LB,2772,2772,195,185,10,0.066738814,0.07034632,0.0036075036
2011.0,LB,3059,3059,194,149,45,0.04870873,0.06341942,0.01471069
2012.0,LB,3466,3466,281,178,103,0.05135603,0.081073284,0.029717254
2013.0,LB,3863,3863,298,270,28,0.06989387,0.07714212,0.0072482526
2014.0,LB,4315,4315,319,263,56,0.060950175,0.073928155,0.012977984
2015.0,LB,4852,4852,349,281,68,0.05791426,0.071929105,0.014014839
2016.0,LB,5322,5322,323,308,15,0.05787298,0.06069147,0.0028184892
2017.0,LB,5864,5864,383,345,38,0.05883356,0.06531378,0.0064802184
2018.0,LB,6325,6325,396,378,18,0.059762847,0.0626087,0.0028458498
2019.0,LB,6532,6532,433,443,-10,0.06781996,0.06628904,-0.0015309247
2020.0,LB,6244,6244,343,440,-97,0.07046765,0.054932736,-0.015534913
2021.0,LB,5733,5733,246,384,-138,0.06698064,0.042909473,-0.024071166
2022.0,LB,0,0,217,312,-95,,,
1996.0,LI,8,8,0,0,0,0.0,0.0,0.0
1997.0,LI,9,9,0,0,0,0.0,0.0,0.0
1999.0,LI,17,17,1,0,1,0.0,0.05882353,0.05882353
2000.0,LI,22,22,6,2,4,0.09090909,0.27272728,0.18181819
2001.0,LI,28,28,3,0,3,0.0,0.10714286,0.10714286
2002.0,LI,32,32,3,0,3,0.0,0.09375,0.09375
2003.0,LI,32,32,4,4,0,0.125,0.125,0.0
2004.0,LI,38,38,3,0,3,0.0,0.078947365,0.078947365
2005.0,LI,47,47,9,5,4,0.10638298,0.19148937,0.08510638
2006.0,LI,59,59,13,4,9,0.06779661,0.22033899,0.15254237
2007.0,LI,65,65,7,2,5,0.03076923,0.10769231,0.07692308
2008.0,LI,65,65,5,7,-2,0.10769231,0.07692308,-0.03076923
2009.0,LI,63,63,8,9,-1,0.14285715,0.12698413,-0.015873017
2010.0,LI,66,66,10,11,-1,0.16666667,0.15151516,-0.015151516
2011.0,LI,71,71,8,1,7,0.014084507,0.112676054,0.09859155
2012.0,LI,88,88,12,2,10,0.022727273,0.13636364,0.11363637
2013.0,LI,94,94,14,10,4,0.10638298,0.14893617,0.04255319
2014.0,LI,97,97,9,10,-1,0.10309278,0.0927835,-0.010309278
2015.0,LI,102,102,11,8,3,0.078431375,0.10784314,0.029411765
2016.0,LI,101,101,6,7,-1,0.06930693,0.05940594,-0.00990099
2017.0,LI,110,110,15,10,5,0.09090909,0.13636364,0.045454547
2018.0,LI,125,125,15,7,8,0.056,0.12,0.064
2019.0,LI,123,123,12,7,5,0.05691057,0.09756097,0.040650405
2020.0,LI,124,124,19,8,11,0.06451613,0.15322581,0.088709675
2021.0,LI,111,111,8,12,-4,0.10810811,0.072072074,-0.036036037
1996.0,LK,381,381,0,0,0,0.0,0.0,0.0
1997.0,LK,499,499,16,16,0,0.03206413,0.03206413,0.0
1998.0,LK,604,604,26,17,9,0.028145695,0.04304636,0.014900662
1999.0,LK,638,638,30,31,-1,0.04858934,0.047021944,-0.0015673981
2000.0,LK,688,688,34,34,0,0.049418606,0.049418606,0.0
2001.0,LK,784,784,34,28,6,0.035714287,0.04336735,0.0076530613
2002.0,LK,845,845,51,27,24,0.031952664,0.06035503,0.028402368
2003.0,LK,924,924,48,43,5,0.046536796,0.051948052,0.0054112556
2004.0,LK,1035,1035,56,45,11,0.04347826,0.05410628,0.010628019
2005.0,LK,1167,1167,55,57,-2,0.048843186,0.047129393,-0.001713796
2006.0,LK,1395,1395,67,57,10,0.040860213,0.048028674,0.007168459
2007.0,LK,1749,1749,89,60,29,0.034305315,0.05088622,0.016580904
2008.0,LK,2068,2068,82,95,-13,0.045938104,0.039651837,-0.0062862667
2009.0,LK,2469,2469,130,103,27,0.041717295,0.052652895,0.010935602
2010.0,LK,2814,2814,122,126,-4,0.04477612,0.043354657,-0.0014214641
2011.0,LK,3190,3190,159,107,52,0.03354232,0.04984326,0.01630094
2012.0,LK,3543,3543,140,128,12,0.036127575,0.039514534,0.0033869601
2013.0,LK,4033,4033,164,169,-5,0.04190429,0.040664516,-0.0012397718
2014.0,LK,4433,4433,172,154,18,0.034739453,0.038799908,0.0040604556
2015.0,LK,4897,4897,207,172,35,0.035123546,0.04227078,0.007147233
2016.0,LK,5317,5317,210,169,41,0.03178484,0.039495956,0.0077111153
2017.0,LK,5677,5677,243,211,32,0.03716752,0.042804297,0.00563678
2018.0,LK,6041,6041,270,247,23,0.04088727,0.044694588,0.0038073168
2019.0,LK,6272,6272,332,280,52,0.04464286,0.052933674,0.008290816
2020.0,LK,6015,6015,233,241,-8,0.0400665,0.038736492,-0.0013300083
2021.0,LK,5544,5544,177,170,7,0.03066378,0.03192641,0.0012626263
2022.0,LK,0,0,110,126,-16,,,
1996.0,LR,1,1,0,0,0,0.0,0.0,0.0
2002.0,LR,7,7,2,0,2,0.0,0.2857143,0.2857143
2006.0,LR,6,6,1,0,1,0.0,0.16666667,0.16666667
2008.0,LR,17,17,1,1,0,0.05882353,0.05882353,0.0
2009.0,LR,20,20,1,2,-1,0.1,0.05,-0.05
2010.0,LR,26,26,0,0,0,0.0,0.0,0.0
2011.0,LR,29,29,2,0,2,0.0,0.06896552,0.06896552
2012.0,LR,34,34,3,1,2,0.029411765,0.0882353,0.05882353
2013.0,LR,43,43,5,1,4,0.023255814,0.11627907,0.093023255
2014.0,LR,55,55,2,3,-1,0.054545455,0.036363635,-0.018181818
2015.0,LR,58,58,4,4,0,0.06896552,0.06896552,0.0
2016.0,LR,63,63,5,4,1,0.06349207,0.07936508,0.015873017
2017.0,LR,73,73,13,5,8,0.06849315,0.1780822,0.10958904
2018.0,LR,88,88,12,4,8,0.045454547,0.13636364,0.09090909
2019.0,LR,101,101,15,3,12,0.02970297,0.14851485,0.11881188
2020.0,LR,91,91,9,13,-4,0.14285715,0.0989011,-0.043956045
2021.0,LR,82,82,6,7,-1,0.085365854,0.07317073,-0.0121951215
2022.0,LR,0,0,4,4,0,,,
1996.0,LS,15,15,0,0,0,0.0,0.0,0.0
1997.0,LS,19,19,1,1,0,0.05263158,0.05263158,0.0
1998.0,LS,19,19,0,1,-1,0.05263158,0.0,-0.05263158
1999.0,LS,21,21,1,0,1,0.0,0.04761905,0.04761905
2000.0,LS,21,21,2,3,-1,0.14285715,0.0952381,-0.04761905
2001.0,LS,20,20,0,0,0,0.0,0.0,0.0
2002.0,LS,20,20,1,3,-2,0.15,0.05,-0.1
2003.0,LS,23,23,1,4,-3,0.17391305,0.04347826,-0.13043478
2004.0,LS,28,28,1,3,-2,0.10714286,0.035714287,-0.071428575
2005.0,LS,35,35,3,0,3,0.0,0.08571429,0.08571429
2006.0,LS,45,45,7,1,6,0.022222223,0.15555556,0.13333334
2007.0,LS,51,51,3,4,-1,0.078431375,0.05882353,-0.019607844
2008.0,LS,67,67,5,4,1,0.05970149,0.07462686,0.014925373
2009.0,LS,73,73,4,6,-2,0.08219178,0.05479452,-0.02739726
2010.0,LS,75,75,3,4,-1,0.053333335,0.04,-0.013333334
2011.0,LS,69,69,2,11,-9,0.1594203,0.028985508,-0.13043478
2012.0,LS,74,74,4,9,-5,0.12162162,0.054054055,-0.067567565
2013.0,LS,80,80,6,3,3,0.0375,0.075,0.0375
2014.0,LS,84,84,4,5,-1,0.05952381,0.04761905,-0.011904762
2015.0,LS,84,84,4,14,-10,0.16666667,0.04761905,-0.11904762
2016.0,LS,83,83,7,8,-1,0.09638554,0.084337346,-0.012048192
2017.0,LS,94,94,6,6,0,0.06382979,0.06382979,0.0
2018.0,LS,113,113,10,2,8,0.017699115,0.088495575,0.07079646
2019.0,LS,130,130,18,9,9,0.06923077,0.13846155,0.06923077
2020.0,LS,116,116,5,13,-8,0.112068966,0.04310345,-0.06896552
2021.0,LS,107,107,11,8,3,0.07476635,0.10280374,0.028037382
1996.0,LT,600,600,0,0,0,0.0,0.0,0.0
1997.0,LT,782,782,21,19,2,0.024296675,0.02685422,0.0025575447
1998.0,LT,969,969,30,29,1,0.02992776,0.030959751,0.0010319918
1999.0,LT,1094,1094,31,29,2,0.026508227,0.02833638,0.0018281536
2000.0,LT,1404,1404,28,35,-7,0.024928775,0.01994302,-0.004985755
2001.0,LT,1811,1811,45,39,6,0.021535063,0.02484815,0.0033130867
2002.0,LT,2234,2234,63,47,16,0.021038497,0.028200537,0.007162041
2003.0,LT,2781,2781,101,43,58,0.015462064,0.03631787,0.020855807
2004.0,LT,3337,3337,76,56,20,0.01678154,0.022774948,0.005993407
2005.0,LT,3762,3762,79,68,11,0.018075492,0.020999469,0.0029239766
2006.0,LT,4105,4105,82,66,16,0.016077954,0.01997564,0.0038976858
2007.0,LT,4450,4450,81,77,4,0.01730337,0.018202247,0.0008988764
2008.0,LT,4847,4847,86,98,-12,0.020218693,0.017742934,-0.0024757583
2009.0,LT,5434,5434,107,91,16,0.016746411,0.019690836,0.002944424
2010.0,LT,6135,6135,125,81,44,0.013202934,0.020374898,0.0071719643
2011.0,LT,7006,7006,197,59,138,0.008421353,0.028118756,0.019697402
2012.0,LT,7956,7956,138,72,66,0.009049774,0.0173454,0.008295626
2013.0,LT,8834,8834,138,77,61,0.008716323,0.015621463,0.0069051394
2014.0,LT,9339,9339,117,76,41,0.008137916,0.0125281075,0.0043901918
2015.0,LT,9640,9640,75,82,-7,0.0085062245,0.007780083,-0.0007261411
2016.0,LT,9864,9864,84,109,-25,0.011050284,0.008515815,-0.002534469
2017.0,LT,9926,9926,109,102,7,0.010276043,0.010981262,0.00070521864
2018.0,LT,9853,9853,107,119,-12,0.01207754,0.010859637,-0.0012179032
2019.0,LT,9837,9837,109,98,11,0.009962386,0.011080614,0.0011182271
2020.0,LT,9335,9335,102,102,0,0.01092662,0.01092662,0.0
2021.0,LT,8543,8543,86,94,-8,0.011003161,0.010066722,-0.0009364392
2022.0,LT,0,0,60,43,17,,,
1996.0,LU,139,139,0,0,0,0.0,0.0,0.0
1997.0,LU,168,168,12,10,2,0.05952381,0.071428575,0.011904762
1998.0,LU,206,206,17,21,-4,0.10194175,0.08252427,-0.019417476
1999.0,LU,241,241,27,11,16,0.045643155,0.112033196,0.066390045
2000.0,LU,261,261,23,26,-3,0.099616855,0.08812261,-0.011494253
2001.0,LU,313,313,39,21,18,0.06709265,0.12460064,0.057507988
2002.0,LU,377,377,39,32,7,0.084880635,0.10344828,0.018567638
2003.0,LU,446,446,46,30,16,0.06726457,0.10313901,0.03587444
2004.0,LU,544,544,66,28,38,0.05147059,0.121323526,0.06985294
2005.0,LU,661,661,83,41,42,0.06202723,0.12556732,0.06354009
2006.0,LU,785,785,86,47,39,0.059872612,0.10955414,0.04968153
2007.0,LU,898,898,91,71,20,0.079064585,0.1013363,0.022271715
2008.0,LU,1052,1052,133,68,65,0.064638786,0.12642586,0.061787073
2009.0,LU,1209,1209,161,81,80,0.06699752,0.13316791,0.06617039
2010.0,LU,1362,1362,164,119,45,0.08737151,0.12041116,0.033039648
2011.0,LU,1561,1561,189,81,108,0.051889814,0.12107623,0.06918642
2012.0,LU,1728,1728,203,137,66,0.07928241,0.11747685,0.038194444
2013.0,LU,1871,1871,213,141,72,0.07536077,0.11384287,0.038482096
2014.0,LU,2022,2022,241,171,70,0.08456973,0.11918892,0.03461919
2015.0,LU,2182,2182,266,164,102,0.07516041,0.12190651,0.046746105
2016.0,LU,2277,2277,251,183,68,0.080368906,0.11023276,0.029863857
2017.0,LU,2380,2380,266,203,63,0.08529412,0.11176471,0.026470589
2018.0,LU,2525,2525,282,205,77,0.08118812,0.11168317,0.03049505
2019.0,LU,2571,2571,287,207,80,0.08051342,0.11162972,0.031116297
2020.0,LU,2575,2575,303,223,80,0.08660194,0.1176699,0.031067962
2021.0,LU,2458,2458,216,161,55,0.06550041,0.08787632,0.022375915
2022.0,LU,0,0,150,108,42,,,
1996.0,LV,583,583,0,0,0,0.0,0.0,0.0
1997.0,LV,724,724,15,8,7,0.011049724,0.020718232,0.009668509
1998.0,LV,841,841,16,25,-9,0.029726516,0.01902497,-0.0107015455
1999.0,LV,942,942,20,17,3,0.018046709,0.021231422,0.0031847134
2000.0,LV,947,947,8,32,-24,0.03379092,0.00844773,-0.025343189
2001.0,LV,960,960,28,32,-4,0.033333335,0.029166667,-0.004166667
2002.0,LV,1006,1006,23,23,0,0.022862824,0.022862824,0.0
2003.0,LV,1087,1087,30,29,1,0.026678933,0.027598895,0.0009199632
2004.0,LV,1138,1138,36,21,15,0.018453427,0.031634446,0.01318102
2005.0,LV,1297,1297,26,27,-1,0.02081727,0.02004626,-0.00077101
2006.0,LV,1447,1447,23,25,-2,0.017277125,0.015894955,-0.00138217
2007.0,LV,1622,1622,36,27,9,0.016646115,0.022194821,0.0055487053
2008.0,LV,1773,1773,35,54,-19,0.030456852,0.019740554,-0.0107163
2009.0,LV,2119,2119,57,29,28,0.0136857005,0.026899481,0.01321378
2010.0,LV,2438,2438,56,43,13,0.017637407,0.022969646,0.0053322394
2011.0,LV,2831,2831,56,51,5,0.018014835,0.019780995,0.0017661604
2012.0,LV,3185,3185,52,51,1,0.016012559,0.01632653,0.00031397174
2013.0,LV,3707,3707,82,64,18,0.017264634,0.022120314,0.0048556784
2014.0,LV,3993,3993,76,72,4,0.018031554,0.01903331,0.001001753
2015.0,LV,4268,4268,84,65,19,0.015229615,0.01968135,0.004451734
2016.0,LV,4387,4387,66,74,-8,0.01686802,0.01504445,-0.0018235696
2017.0,LV,4533,4533,76,79,-3,0.017427752,0.01676594,-0.00066181336
2018.0,LV,4600,4600,85,85,0,0.018478261,0.018478261,0.0
2019.0,LV,4648,4648,90,83,7,0.017857144,0.019363167,0.001506024
2020.0,LV,4380,4380,76,80,-4,0.01826484,0.017351598,-0.000913242
2021.0,LV,4043,4043,58,56,2,0.013851101,0.014345783,0.0004946822
2022.0,LV,0,0,56,38,18,,,
1996.0,LY,75,75,0,0,0,0.0,0.0,0.0
1997.0,LY,94,94,3,1,2,0.010638298,0.031914894,0.021276595
1998.0,LY,118,118,4,4,0,0.033898305,0.033898305,0.0
1999.0,LY,113,113,2,8,-6,0.07079646,0.017699115,-0.053097345
2000.0,LY,115,115,5,1,4,0.008695652,0.04347826,0.034782607
2001.0,LY,120,120,4,4,0,0.033333335,0.033333335,0.0
2002.0,LY,118,118,6,6,0,0.050847456,0.050847456,0.0
2003.0,LY,116,116,7,13,-6,0.112068966,0.060344826,-0.05172414
2004.0,LY,111,111,6,9,-3,0.08108108,0.054054055,-0.027027028
2005.0,LY,138,138,12,8,4,0.057971016,0.08695652,0.028985508
2006.0,LY,155,155,7,8,-1,0.051612902,0.045161292,-0.006451613
2007.0,LY,180,180,19,10,9,0.055555556,0.10555556,0.05
2008.0,LY,243,243,20,12,8,0.049382716,0.08230453,0.03292181
2009.0,LY,288,288,29,15,14,0.052083332,0.10069445,0.048611112
2010.0,LY,321,321,24,13,11,0.040498443,0.07476635,0.034267914
2011.0,LY,393,393,41,24,17,0.061068702,0.1043257,0.043256998
2012.0,LY,466,466,38,26,12,0.055793993,0.08154506,0.025751073
2013.0,LY,530,530,56,28,28,0.05283019,0.10566038,0.05283019
2014.0,LY,593,593,55,32,23,0.0539629,0.09274874,0.038785834
2015.0,LY,656,656,54,34,20,0.051829267,0.08231708,0.030487806
2016.0,LY,706,706,54,43,11,0.060906515,0.07648725,0.015580736
2017.0,LY,760,760,66,46,20,0.060526315,0.086842105,0.02631579
2018.0,LY,850,850,96,38,58,0.044705883,0.112941176,0.06823529
2019.0,LY,908,908,97,52,45,0.057268724,0.10682819,0.04955947
2020.0,LY,897,897,82,52,30,0.057971016,0.09141583,0.033444814
2021.0,LY,854,854,51,23,28,0.026932085,0.05971897,0.032786883
2022.0,LY,0,0,30,16,14,,,
1996.0,MA,1106,1106,0,0,0,0.0,0.0,0.0
1997.0,MA,1479,1479,82,64,18,0.04327248,0.055442866,0.012170386
1998.0,MA,1881,1881,122,95,27,0.05050505,0.064859115,0.014354067
1999.0,MA,2264,2264,169,116,53,0.05123675,0.074646644,0.023409894
2000.0,MA,2599,2599,168,135,33,0.051943056,0.06464025,0.012697191
2001.0,MA,2837,2837,188,172,16,0.060627423,0.066267185,0.0056397603
2002.0,MA,3173,3173,155,197,-42,0.062086355,0.04884967,-0.013236685
2003.0,MA,3487,3487,218,195,23,0.055921994,0.062517926,0.0065959278
2004.0,MA,3882,3882,266,229,37,0.05899021,0.06852138,0.009531169
2005.0,MA,4261,4261,235,247,-12,0.057967614,0.055151373,-0.0028162403
2006.0,MA,4772,4772,316,260,56,0.054484494,0.06621961,0.011735122
2007.0,MA,5354,5354,357,298,59,0.05565932,0.06667912,0.011019798
2008.0,MA,5722,5722,338,392,-54,0.068507515,0.059070256,-0.009437259
2009.0,MA,6327,6327,359,309,50,0.048838314,0.05674095,0.00790264
2010.0,MA,7024,7024,374,398,-24,0.05666287,0.053246014,-0.0034168565
2011.0,MA,7857,7857,449,454,-5,0.05778287,0.057146493,-0.0006363752
2012.0,MA,9131,9131,536,428,108,0.04687329,0.058701128,0.01182784
2013.0,MA,10342,10342,524,406,118,0.039257396,0.05066718,0.011409786
2014.0,MA,11787,11787,609,478,131,0.040553153,0.05166709,0.011113939
2015.0,MA,13112,13112,608,503,105,0.038361806,0.04636974,0.0080079315
2016.0,MA,14185,14185,588,495,93,0.034896016,0.041452236,0.0065562213
2017.0,MA,15235,15235,623,533,90,0.034985233,0.040892683,0.00590745
2018.0,MA,16747,16747,735,554,181,0.03308055,0.043888457,0.010807906
2019.0,MA,17576,17576,723,631,92,0.03590123,0.04113564,0.0052344105
2020.0,MA,17193,17193,678,551,127,0.032047927,0.039434653,0.0073867273
2021.0,MA,16165,16165,521,438,83,0.027095577,0.032230128,0.00513455
2022.0,MA,0,0,327,267,60,,,
1996.0,MC,24,24,0,0,0,0.0,0.0,0.0
1997.0,MC,31,31,4,3,1,0.09677419,0.12903225,0.032258064
1998.0,MC,33,33,4,3,1,0.09090909,0.121212125,0.030303031
1999.0,MC,40,40,4,2,2,0.05,0.1,0.05
2000.0,MC,41,41,3,4,-1,0.09756097,0.07317073,-0.024390243
2001.0,MC,51,51,6,2,4,0.039215688,0.11764706,0.078431375
2002.0,MC,64,64,7,5,2,0.078125,0.109375,0.03125
2003.0,MC,67,67,6,7,-1,0.104477614,0.08955224,-0.014925373
2004.0,MC,82,82,12,5,7,0.06097561,0.14634146,0.085365854
2005.0,MC,84,84,6,9,-3,0.10714286,0.071428575,-0.035714287
2006.0,MC,94,94,13,6,7,0.06382979,0.13829787,0.07446808
2007.0,MC,95,95,7,9,-2,0.094736844,0.07368421,-0.021052632
2008.0,MC,104,104,13,7,6,0.067307696,0.125,0.057692308
2009.0,MC,112,112,14,7,7,0.0625,0.125,0.0625
2010.0,MC,126,126,18,8,10,0.06349207,0.14285715,0.07936508
2011.0,MC,146,146,13,6,7,0.04109589,0.0890411,0.047945205
2012.0,MC,149,149,10,12,-2,0.08053691,0.06711409,-0.013422819
2013.0,MC,157,157,17,8,9,0.050955415,0.10828026,0.05732484
2014.0,MC,167,167,18,12,6,0.07185629,0.10778443,0.035928145
2015.0,MC,178,178,18,7,11,0.039325844,0.101123594,0.061797753
2016.0,MC,183,183,18,7,11,0.038251366,0.09836066,0.06010929
2017.0,MC,198,198,19,11,8,0.055555556,0.0959596,0.04040404
2018.0,MC,200,200,23,11,12,0.055,0.115,0.06
2019.0,MC,199,199,17,22,-5,0.110552765,0.085427135,-0.025125628
2020.0,MC,184,184,18,12,6,0.06521739,0.097826086,0.032608695
2021.0,MC,177,177,16,10,6,0.056497175,0.09039548,0.033898305
2022.0,MC,0,0,14,8,6,,,
1996.0,MD,504,504,0,0,0,0.0,0.0,0.0
1997.0,MD,558,558,34,59,-25,0.105734766,0.0609319,-0.044802867
1998.0,MD,600,600,57,80,-23,0.13333334,0.095,-0.038333334
1999.0,MD,620,620,61,73,-12,0.117741935,0.0983871,-0.019354839
2000.0,MD,601,601,46,95,-49,0.15806988,0.0765391,-0.08153078
2001.0,MD,591,591,55,65,-10,0.10998308,0.09306261,-0.016920473
2002.0,MD,661,661,77,79,-2,0.11951589,0.11649016,-0.0030257185
2003.0,MD,682,682,65,80,-15,0.11730205,0.09530792,-0.021994134
2004.0,MD,713,713,74,91,-17,0.12762973,0.10378682,-0.023842918
2005.0,MD,758,758,76,95,-19,0.12532982,0.10026385,-0.025065962
2006.0,MD,807,807,91,91,0,0.11276332,0.11276332,0.0
2007.0,MD,816,816,59,135,-76,0.16544117,0.07230392,-0.09313726
2008.0,MD,834,834,73,111,-38,0.13309352,0.08752998,-0.04556355
2009.0,MD,909,909,82,81,1,0.089108914,0.09020902,0.00110011
2010.0,MD,944,944,91,130,-39,0.13771187,0.0963983,-0.04131356
2011.0,MD,986,986,100,108,-8,0.10953347,0.10141988,-0.00811359
2012.0,MD,975,975,82,127,-45,0.13025641,0.08410256,-0.046153847
2013.0,MD,984,984,82,138,-56,0.1402439,0.083333336,-0.05691057
2014.0,MD,995,995,74,116,-42,0.116582915,0.07437186,-0.042211056
2015.0,MD,1010,1010,83,100,-17,0.0990099,0.08217822,-0.016831683
2016.0,MD,1012,1012,76,101,-25,0.099802375,0.07509881,-0.024703557
2017.0,MD,1005,1005,69,119,-50,0.11840796,0.06865671,-0.049751244
2018.0,MD,1091,1091,101,105,-4,0.09624198,0.09257562,-0.003666361
2019.0,MD,1132,1132,99,110,-11,0.09717315,0.08745583,-0.0097173145
2020.0,MD,1120,1120,117,82,35,0.073214285,0.104464285,0.03125
2021.0,MD,1033,1033,74,76,-2,0.07357212,0.07163601,-0.0019361085
2022.0,MD,0,0,46,51,-5,,,
1996.0,ME,29,29,0,0,0,0.0,0.0,0.0
1997.0,ME,37,37,0,1,-1,0.027027028,0.0,-0.027027028
1998.0,ME,47,47,0,4,-4,0.08510638,0.0,-0.08510638
1999.0,ME,49,49,2,1,1,0.020408163,0.040816326,0.020408163
2000.0,ME,59,59,2,1,1,0.016949153,0.033898305,0.016949153
2001.0,ME,79,79,1,5,-4,0.06329114,0.012658228,-0.050632913
2002.0,ME,94,94,7,4,3,0.04255319,0.07446808,0.031914894
2003.0,ME,118,118,6,3,3,0.025423728,0.050847456,0.025423728
2004.0,ME,138,138,5,2,3,0.014492754,0.036231883,0.02173913
2005.0,ME,162,162,5,4,1,0.024691358,0.030864198,0.0061728396
2006.0,ME,178,178,6,9,-3,0.050561797,0.033707865,-0.016853932
2007.0,ME,190,190,8,11,-3,0.057894737,0.042105265,-0.015789473
2008.0,ME,205,205,10,17,-7,0.08292683,0.048780486,-0.034146342
2009.0,ME,231,231,12,8,4,0.034632035,0.051948052,0.017316017
2010.0,ME,260,260,19,19,0,0.073076926,0.073076926,0.0
2011.0,ME,313,313,25,11,14,0.03514377,0.079872206,0.044728436
2012.0,ME,369,369,17,15,2,0.040650405,0.04607046,0.0054200543
2013.0,ME,442,442,35,24,11,0.054298643,0.07918552,0.024886878
2014.0,ME,463,463,19,29,-10,0.06263499,0.041036718,-0.021598272
2015.0,ME,492,492,35,30,5,0.06097561,0.07113821,0.010162601
2016.0,ME,540,540,48,22,26,0.04074074,0.08888889,0.048148148
2017.0,ME,571,571,43,29,14,0.05078809,0.07530648,0.02451839
2018.0,ME,588,588,39,40,-1,0.06802721,0.06632653,-0.0017006802
2019.0,ME,592,592,42,49,-7,0.08277027,0.07094595,-0.011824325
2020.0,ME,566,566,42,38,4,0.06713781,0.074204944,0.007067138
2021.0,ME,552,552,46,30,16,0.054347824,0.083333336,0.028985508
2022.0,ME,0,0,26,18,8,,,
1996.0,MG,55,55,0,0,0,0.0,0.0,0.0
1997.0,MG,85,85,3,0,3,0.0,0.03529412,0.03529412
1998.0,MG,118,118,3,1,2,0.008474576,0.025423728,0.016949153
1999.0,MG,139,139,5,4,1,0.02877698,0.035971224,0.007194245
2000.0,MG,146,146,4,4,0,0.02739726,0.02739726,0.0
2001.0,MG,169,169,9,3,6,0.01775148,0.053254437,0.03550296
2002.0,MG,203,203,8,5,3,0.024630541,0.039408866,0.014778325
2003.0,MG,221,221,7,9,-2,0.040723983,0.03167421,-0.009049774
2004.0,MG,248,248,10,6,4,0.024193548,0.04032258,0.016129032
2005.0,MG,288,288,10,9,1,0.03125,0.034722224,0.0034722222
2006.0,MG,336,336,11,12,-1,0.035714287,0.032738097,-0.0029761905
2007.0,MG,377,377,21,11,10,0.02917772,0.055702917,0.0265252
2008.0,MG,423,423,22,16,6,0.03782506,0.052009456,0.014184397
2009.0,MG,456,456,14,23,-9,0.050438598,0.030701755,-0.019736841
2010.0,MG,478,478,12,19,-7,0.039748956,0.025104603,-0.014644352
2011.0,MG,533,533,23,23,0,0.04315197,0.04315197,0.0
2012.0,MG,587,587,21,21,0,0.03577513,0.03577513,0.0
2013.0,MG,657,657,32,15,17,0.02283105,0.04870624,0.02587519
2014.0,MG,712,712,37,32,5,0.04494382,0.05196629,0.007022472
2015.0,MG,769,769,23,22,1,0.028608583,0.029908972,0.0013003901
2016.0,MG,814,814,27,30,-3,0.03685504,0.033169534,-0.0036855037
2017.0,MG,802,802,40,45,-5,0.056109726,0.04987531,-0.006234414
2018.0,MG,860,860,46,39,7,0.045348838,0.053488374,0.008139535
2019.0,MG,920,920,58,29,29,0.031521738,0.063043475,0.031521738
2020.0,MG,883,883,23,35,-12,0.0396376,0.026047565,-0.013590034
2021.0,MG,800,800,20,28,-8,0.035,0.025,-0.01
2006.0,MH,3,3,0,0,0,0.0,0.0,0.0
2008.0,MH,3,3,0,0,0,0.0,0.0,0.0
1996.0,MK,90,90,0,0,0,0.0,0.0,0.0
1997.0,MK,122,122,9,5,4,0.040983606,0.07377049,0.032786883
1998.0,MK,159,159,9,9,0,0.056603774,0.056603774,0.0
1999.0,MK,182,182,5,12,-7,0.06593407,0.027472528,-0.03846154
2000.0,MK,223,223,19,10,9,0.044843048,0.08520179,0.040358745
2001.0,MK,245,245,17,15,2,0.06122449,0.06938776,0.008163265
2002.0,MK,280,280,21,25,-4,0.08928572,0.075,-0.014285714
2003.0,MK,316,316,27,21,6,0.0664557,0.085443035,0.01898734
2004.0,MK,384,384,30,30,0,0.078125,0.078125,0.0
2005.0,MK,467,467,46,29,17,0.0620985,0.09850107,0.03640257
2006.0,MK,543,543,49,36,13,0.06629834,0.09023941,0.023941068
2007.0,MK,602,602,47,52,-5,0.08637874,0.07807309,-0.008305647
2008.0,MK,709,709,56,55,1,0.077574044,0.078984484,0.0014104373
2009.0,MK,878,878,72,61,11,0.06947608,0.082004555,0.0125284735
2010.0,MK,1065,1065,71,50,21,0.04694836,0.06666667,0.01971831
2011.0,MK,1320,1320,102,75,27,0.056818184,0.07727273,0.020454545
2012.0,MK,1571,1571,104,85,19,0.054105666,0.06619988,0.012094207
2013.0,MK,1844,1844,121,108,13,0.05856833,0.065618224,0.0070498916
2014.0,MK,1997,1997,123,131,-8,0.0655984,0.06159239,-0.004006009
2015.0,MK,2085,2085,129,152,-23,0.07290168,0.061870504,-0.011031175
2016.0,MK,2104,2104,118,169,-51,0.0803232,0.05608365,-0.024239544
2017.0,MK,2134,2134,114,168,-54,0.0787254,0.053420804,-0.025304593
2018.0,MK,2135,2135,121,145,-24,0.06791569,0.056674473,-0.011241218
2019.0,MK,2096,2096,127,147,-20,0.07013359,0.060591605,-0.009541985
2020.0,MK,1941,1941,98,138,-40,0.071097374,0.050489437,-0.020607933
2021.0,MK,1766,1766,96,85,11,0.04813137,0.054360136,0.0062287655
2022.0,MK,0,0,72,40,32,,,
1996.0,ML,81,81,0,0,0,0.0,0.0,0.0
1997.0,ML,85,85,2,6,-4,0.07058824,0.023529412,-0.047058824
1998.0,ML,103,103,9,6,3,0.058252428,0.08737864,0.029126214
1999.0,ML,97,97,4,11,-7,0.11340206,0.041237112,-0.072164945
2000.0,ML,105,105,5,9,-4,0.08571429,0.04761905,-0.03809524
2001.0,ML,125,125,10,7,3,0.056,0.08,0.024
2002.0,ML,161,161,15,9,6,0.055900622,0.0931677,0.03726708
2003.0,ML,192,192,14,14,0,0.072916664,0.072916664,0.0
2004.0,ML,234,234,26,9,17,0.03846154,0.11111111,0.072649576
2005.0,ML,261,261,24,16,8,0.06130268,0.09195402,0.03065134
2006.0,ML,291,291,18,21,-3,0.072164945,0.06185567,-0.010309278
2007.0,ML,336,336,18,22,-4,0.065476194,0.05357143,-0.011904762
2008.0,ML,360,360,22,25,-3,0.06944445,0.06111111,-0.008333334
2009.0,ML,397,397,27,23,4,0.057934508,0.06801008,0.010075566
2010.0,ML,436,436,28,35,-7,0.08027523,0.06422018,-0.016055046
2011.0,ML,494,494,35,33,2,0.06680162,0.0708502,0.004048583
2012.0,ML,512,512,32,38,-6,0.07421875,0.0625,-0.01171875
2013.0,ML,535,535,29,43,-14,0.08037383,0.054205608,-0.026168223
2014.0,ML,602,602,54,51,3,0.08471761,0.089701,0.004983389
2015.0,ML,678,678,58,46,12,0.06784661,0.085545726,0.017699115
2016.0,ML,678,678,47,51,-4,0.07522124,0.069321536,-0.005899705
2017.0,ML,706,706,69,68,1,0.096317284,0.09773371,0.0014164306
2018.0,ML,720,720,64,88,-24,0.12222222,0.08888889,-0.033333335
2019.0,ML,761,761,82,70,12,0.091984235,0.10775296,0.015768725
2020.0,ML,777,777,90,43,47,0.055341054,0.115830116,0.060489062
2021.0,ML,745,745,56,52,4,0.069798656,0.07516778,0.0053691277
1996.0,MM,27,27,0,0,0,0.0,0.0,0.0
1997.0,MM,47,47,2,3,-1,0.06382979,0.04255319,-0.021276595
1998.0,MM,66,66,2,1,1,0.015151516,0.030303031,0.015151516
1999.0,MM,92,92,7,4,3,0.04347826,0.07608695,0.032608695
2000.0,MM,115,115,9,4,5,0.034782607,0.07826087,0.04347826
2001.0,MM,119,119,10,13,-3,0.1092437,0.084033616,-0.025210084
2002.0,MM,125,125,11,24,-13,0.192,0.088,-0.104
2003.0,MM,125,125,10,23,-13,0.184,0.08,-0.104
2004.0,MM,127,127,14,24,-10,0.18897638,0.11023622,-0.07874016
2005.0,MM,130,130,17,20,-3,0.15384616,0.13076924,-0.023076924
2006.0,MM,132,132,11,22,-11,0.16666667,0.083333336,-0.083333336
2007.0,MM,138,138,19,18,1,0.13043478,0.13768116,0.007246377
2008.0,MM,150,150,15,17,-2,0.11333334,0.1,-0.013333334
2009.0,MM,161,161,12,21,-9,0.13043478,0.07453416,-0.055900622
2010.0,MM,185,185,28,16,12,0.08648649,0.15135135,0.06486487
2011.0,MM,210,210,23,18,5,0.08571429,0.10952381,0.023809524
2012.0,MM,225,225,16,22,-6,0.09777778,0.07111111,-0.026666667
2013.0,MM,282,282,34,25,9,0.088652484,0.120567374,0.031914894
2014.0,MM,347,347,35,24,11,0.06916427,0.10086455,0.031700287
2015.0,MM,435,435,39,35,4,0.08045977,0.089655176,0.009195402
2016.0,MM,505,505,55,36,19,0.071287125,0.10891089,0.037623763
2017.0,MM,620,620,88,44,44,0.07096774,0.14193548,0.07096774
2018.0,MM,719,719,101,68,33,0.0945758,0.14047287,0.045897078
2019.0,MM,790,790,128,64,64,0.08101266,0.16202532,0.08101266
2020.0,MM,814,814,118,72,46,0.088452086,0.14496315,0.056511056
2021.0,MM,798,798,100,83,17,0.10401002,0.12531328,0.021303259
2022.0,MM,0,0,68,68,0,,,
1996.0,MN,39,39,0,0,0,0.0,0.0,0.0
1997.0,MN,49,49,1,0,1,0.0,0.020408163,0.020408163
1998.0,MN,61,61,3,2,1,0.032786883,0.04918033,0.016393442
1999.0,MN,63,63,1,3,-2,0.04761905,0.015873017,-0.031746034
2000.0,MN,81,81,4,2,2,0.024691358,0.049382716,0.024691358
2001.0,MN,100,100,9,2,7,0.02,0.09,0.07
2002.0,MN,117,117,1,7,-6,0.05982906,0.008547009,-0.051282052
2003.0,MN,137,137,7,3,4,0.02189781,0.05109489,0.02919708
2004.0,MN,162,162,6,6,0,0.037037037,0.037037037,0.0
2005.0,MN,183,183,8,7,1,0.038251366,0.043715846,0.0054644807
2006.0,MN,227,227,4,4,0,0.017621145,0.017621145,0.0
2007.0,MN,261,261,11,15,-4,0.057471264,0.042145595,-0.01532567
2008.0,MN,324,324,19,12,7,0.037037037,0.058641974,0.021604938
2009.0,MN,356,356,9,14,-5,0.039325844,0.025280898,-0.014044944
2010.0,MN,407,407,21,12,9,0.02948403,0.05159705,0.022113021
2011.0,MN,424,424,14,23,-9,0.054245282,0.03301887,-0.021226415
2012.0,MN,520,520,28,22,6,0.042307694,0.053846154,0.011538462
2013.0,MN,584,584,24,17,7,0.02910959,0.04109589,0.011986301
2014.0,MN,672,672,51,24,27,0.035714287,0.07589286,0.04017857
2015.0,MN,759,759,39,23,16,0.030303031,0.0513834,0.02108037
2016.0,MN,927,927,63,21,42,0.022653721,0.067961164,0.045307443
2017.0,MN,990,990,46,25,21,0.025252525,0.046464648,0.021212121
2018.0,MN,1073,1073,70,41,29,0.038210623,0.06523765,0.027027028
2019.0,MN,1102,1102,61,59,2,0.05353902,0.055353902,0.001814882
2020.0,MN,1086,1086,59,34,25,0.031307552,0.05432781,0.023020258
2021.0,MN,999,999,43,30,13,0.03003003,0.043043043,0.013013013
1999.0,MO,2,2,0,0,0,0.0,0.0,0.0
2000.0,MO,4,4,1,1,0,0.25,0.25,0.0
2002.0,MO,3,3,0,0,0,0.0,0.0,0.0
2005.0,MO,6,6,1,2,-1,0.33333334,0.16666667,-0.16666667
2006.0,MO,6,6,0,1,-1,0.16666667,0.0,-0.16666667
2007.0,MO,11,11,2,3,-1,0.27272728,0.18181819,-0.09090909
2008.0,MO,12,12,1,1,0,0.083333336,0.083333336,0.0
2009.0,MO,10,10,0,1,-1,0.1,0.0,-0.1
2010.0,MO,11,11,3,2,1,0.18181819,0.27272728,0.09090909
2013.0,MO,6,6,2,2,0,0.33333334,0.33333334,0.0
2020.0,MO,2,2,1,2,-1,1.0,0.5,-0.5
1996.0,MQ,53,53,0,0,0,0.0,0.0,0.0
1997.0,MQ,56,56,4,4,0,0.071428575,0.071428575,0.0
1998.0,MQ,72,72,7,6,1,0.083333336,0.097222224,0.013888889
1999.0,MQ,71,71,4,11,-7,0.15492958,0.056338027,-0.09859155
2000.0,MQ,76,76,10,2,8,0.02631579,0.13157895,0.10526316
2001.0,MQ,69,69,3,5,-2,0.072463766,0.04347826,-0.028985508
2003.0,MQ,80,80,9,8,1,0.1,0.1125,0.0125
2004.0,MQ,83,83,6,6,0,0.072289154,0.072289154,0.0
2005.0,MQ,86,86,5,10,-5,0.11627907,0.058139537,-0.058139537
2006.0,MQ,107,107,13,6,7,0.056074765,0.12149533,0.06542056
2007.0,MQ,117,117,12,10,2,0.08547009,0.102564104,0.017094018
2008.0,MQ,120,120,12,10,2,0.083333336,0.1,0.016666668
2009.0,MQ,132,132,13,14,-1,0.10606061,0.09848485,-0.007575758
2010.0,MQ,170,170,29,14,15,0.08235294,0.17058824,0.0882353
2011.0,MQ,194,194,20,9,11,0.04639175,0.10309278,0.05670103
2012.0,MQ,232,232,22,18,4,0.077586204,0.094827585,0.01724138
2013.0,MQ,258,258,24,20,4,0.07751938,0.093023255,0.015503876
2014.0,MQ,295,295,27,12,15,0.040677965,0.09152542,0.050847456
2015.0,MQ,310,310,20,14,6,0.045161292,0.06451613,0.019354839
2016.0,MQ,322,322,23,17,6,0.05279503,0.071428575,0.01863354
2017.0,MQ,285,285,17,31,-14,0.10877193,0.05964912,-0.049122807
2018.0,MQ,282,282,25,20,5,0.07092199,0.088652484,0.017730497
2019.0,MQ,273,273,28,21,7,0.07692308,0.102564104,0.025641026
2020.0,MQ,250,250,28,27,1,0.108,0.112,0.004
2021.0,MQ,227,227,14,12,2,0.052863438,0.06167401,0.008810572
1996.0,MR,11,11,0,0,0,0.0,0.0,0.0
1997.0,MR,16,16,2,0,2,0.0,0.125,0.125
1998.0,MR,18,18,0,0,0,0.0,0.0,0.0
1999.0,MR,18,18,1,3,-2,0.16666667,0.055555556,-0.11111111
2000.0,MR,20,20,2,1,1,0.05,0.1,0.05
2001.0,MR,20,20,0,0,0,0.0,0.0,0.0
2002.0,MR,20,20,2,4,-2,0.2,0.1,-0.1
2004.0,MR,26,26,2,0,2,0.0,0.07692308,0.07692308
2005.0,MR,34,34,2,3,-1,0.0882353,0.05882353,-0.029411765
2006.0,MR,36,36,2,2,0,0.055555556,0.055555556,0.0
2007.0,MR,41,41,1,0,1,0.0,0.024390243,0.024390243
2008.0,MR,44,44,2,3,-1,0.06818182,0.045454547,-0.022727273
2009.0,MR,52,52,1,1,0,0.01923077,0.01923077,0.0
2010.0,MR,61,61,2,4,-2,0.06557377,0.032786883,-0.032786883
2011.0,MR,68,68,4,1,3,0.014705882,0.05882353,0.04411765
2012.0,MR,76,76,8,2,6,0.02631579,0.10526316,0.078947365
2013.0,MR,76,76,3,7,-4,0.09210526,0.039473683,-0.05263158
2014.0,MR,74,74,6,5,1,0.067567565,0.08108108,0.013513514
2015.0,MR,90,90,7,1,6,0.011111111,0.07777778,0.06666667
2016.0,MR,113,113,6,3,3,0.026548672,0.053097345,0.026548672
2017.0,MR,114,114,9,9,0,0.078947365,0.078947365,0.0
2018.0,MR,121,121,9,7,2,0.05785124,0.07438017,0.016528925
2019.0,MR,120,120,12,12,0,0.1,0.1,0.0
2020.0,MR,122,122,15,8,7,0.06557377,0.12295082,0.057377048
2021.0,MR,115,115,5,3,2,0.026086956,0.04347826,0.017391304
1997.0,MS,16,16,6,0,6,0.0,0.375,0.375
1998.0,MS,5,5,0,12,-12,2.4,0.0,-2.4
2000.0,MS,7,7,0,4,-4,0.5714286,0.0,-0.5714286
2002.0,MS,7,7,1,1,0,0.14285715,0.14285715,0.0
2004.0,MS,11,11,2,2,0,0.18181819,0.18181819,0.0
2005.0,MS,10,10,2,1,1,0.1,0.2,0.1
2006.0,MS,9,9,1,2,-1,0.22222222,0.11111111,-0.11111111
2007.0,MS,9,9,1,2,-1,0.22222222,0.11111111,-0.11111111
2009.0,MS,12,12,0,2,-2,0.16666667,0.0,-0.16666667
2010.0,MS,15,15,4,1,3,0.06666667,0.26666668,0.2
2012.0,MS,12,12,0,2,-2,0.16666667,0.0,-0.16666667
2014.0,MS,11,11,0,1,-1,0.09090909,0.0,-0.09090909
2016.0,MS,14,14,0,1,-1,0.071428575,0.0,-0.071428575
2018.0,MS,16,16,2,0,2,0.0,0.125,0.125
2020.0,MS,16,16,3,1,2,0.0625,0.1875,0.125
1996.0,MT,80,80,0,0,0,0.0,0.0,0.0
1997.0,MT,92,92,3,6,-3,0.06521739,0.032608695,-0.032608695
1998.0,MT,112,112,4,6,-2,0.05357143,0.035714287,-0.017857144
1999.0,MT,125,125,6,6,0,0.048,0.048,0.0
2000.0,MT,136,136,5,7,-2,0.05147059,0.036764707,-0.014705882
2001.0,MT,172,172,10,4,6,0.023255814,0.058139537,0.034883723
2002.0,MT,175,175,3,11,-8,0.06285714,0.017142856,-0.045714285
2003.0,MT,193,193,12,12,0,0.062176164,0.062176164,0.0
2004.0,MT,204,204,12,11,1,0.05392157,0.05882353,0.004901961
2005.0,MT,243,243,12,6,6,0.024691358,0.049382716,0.024691358
2006.0,MT,276,276,16,10,6,0.036231883,0.057971016,0.02173913
2007.0,MT,310,310,15,12,3,0.038709678,0.048387095,0.009677419
2008.0,MT,353,353,21,10,11,0.028328612,0.059490085,0.031161472
2009.0,MT,418,418,21,15,6,0.035885166,0.050239235,0.014354067
2010.0,MT,513,513,33,17,16,0.0331384,0.064327486,0.031189084
2011.0,MT,567,567,33,36,-3,0.06349207,0.05820106,-0.005291005
2012.0,MT,646,646,33,35,-2,0.054179568,0.05108359,-0.0030959751
2013.0,MT,735,735,40,19,21,0.02585034,0.054421768,0.028571429
2014.0,MT,820,820,40,31,9,0.03780488,0.048780486,0.0109756095
2015.0,MT,913,913,53,27,26,0.029572837,0.058050383,0.028477546
2016.0,MT,966,966,62,51,11,0.05279503,0.06418219,0.011387164
2017.0,MT,1031,1031,74,39,35,0.037827354,0.071774974,0.033947624
2018.0,MT,1085,1085,67,57,10,0.05253456,0.061751153,0.00921659
2019.0,MT,1123,1123,82,67,15,0.05966162,0.0730187,0.01335708
2020.0,MT,1115,1115,77,46,31,0.041255604,0.0690583,0.02780269
2021.0,MT,1062,1062,47,36,11,0.033898305,0.04425612,0.010357816
2022.0,MT,0,0,34,29,5,,,
1996.0,MU,34,34,0,0,0,0.0,0.0,0.0
1997.0,MU,61,61,1,0,1,0.0,0.016393442,0.016393442
1998.0,MU,82,82,2,2,0,0.024390243,0.024390243,0.0
1999.0,MU,93,93,3,3,0,0.032258064,0.032258064,0.0
2000.0,MU,101,101,2,4,-2,0.03960396,0.01980198,-0.01980198
2001.0,MU,110,110,5,1,4,0.009090909,0.045454547,0.036363635
2002.0,MU,111,111,3,6,-3,0.054054055,0.027027028,-0.027027028
2003.0,MU,119,119,3,4,-1,0.033613447,0.025210084,-0.008403362
2004.0,MU,125,125,3,3,0,0.024,0.024,0.0
2005.0,MU,140,140,7,4,3,0.028571429,0.05,0.021428572
2006.0,MU,163,163,4,6,-2,0.036809817,0.024539877,-0.012269938
2007.0,MU,190,190,6,3,3,0.015789473,0.031578947,0.015789473
2008.0,MU,206,206,5,5,0,0.024271844,0.024271844,0.0
2009.0,MU,211,211,5,8,-3,0.037914693,0.023696683,-0.014218009
2010.0,MU,247,247,8,1,7,0.004048583,0.032388665,0.02834008
2011.0,MU,256,256,3,13,-10,0.05078125,0.01171875,-0.0390625
2012.0,MU,288,288,10,7,3,0.024305556,0.034722224,0.010416667
2013.0,MU,320,320,5,8,-3,0.025,0.015625,-0.009375
2014.0,MU,344,344,16,9,7,0.02616279,0.046511628,0.020348838
2015.0,MU,380,380,10,9,1,0.023684211,0.02631579,0.002631579
2016.0,MU,397,397,15,6,9,0.01511335,0.037783377,0.022670025
2017.0,MU,404,404,14,12,2,0.02970297,0.034653466,0.004950495
2018.0,MU,415,415,15,15,0,0.036144577,0.036144577,0.0
2019.0,MU,418,418,11,13,-2,0.031100478,0.02631579,-0.004784689
2020.0,MU,395,395,8,13,-5,0.032911394,0.020253165,-0.012658228
2021.0,MU,360,360,8,5,3,0.013888889,0.022222223,0.008333334
2022.0,MU,0,0,3,4,-1,,,
2003.0,MV,4,4,0,0,0,0.0,0.0,0.0
2005.0,MV,4,4,0,1,-1,0.25,0.0,-0.25
2006.0,MV,5,5,0,0,0,0.0,0.0,0.0
2008.0,MV,6,6,1,1,0,0.16666667,0.16666667,0.0
2009.0,MV,10,10,0,0,0,0.0,0.0,0.0
2011.0,MV,11,11,1,1,0,0.09090909,0.09090909,0.0
2012.0,MV,7,7,0,0,0,0.0,0.0,0.0
2015.0,MV,22,22,4,0,4,0.0,0.18181819,0.18181819
2016.0,MV,28,28,3,1,2,0.035714287,0.10714286,0.071428575
2017.0,MV,28,28,3,4,-1,0.14285715,0.10714286,-0.035714287
2018.0,MV,35,35,11,9,2,0.25714287,0.31428573,0.057142857
2019.0,MV,42,42,6,8,-2,0.1904762,0.14285715,-0.04761905
2020.0,MV,49,49,13,3,10,0.06122449,0.26530612,0.20408164
2021.0,MV,47,47,4,3,1,0.06382979,0.08510638,0.021276595
1996.0,MW,98,98,0,0,0,0.0,0.0,0.0
1997.0,MW,127,127,6,7,-1,0.05511811,0.047244094,-0.007874016
1998.0,MW,147,147,5,10,-5,0.06802721,0.034013607,-0.034013607
1999.0,MW,172,172,9,11,-2,0.06395349,0.05232558,-0.011627907
2000.0,MW,188,188,10,11,-1,0.05851064,0.05319149,-0.005319149
2001.0,MW,219,219,14,8,6,0.03652968,0.06392694,0.02739726
2002.0,MW,251,251,14,14,0,0.055776894,0.055776894,0.0
2003.0,MW,289,289,15,12,3,0.04152249,0.051903114,0.010380623
2004.0,MW,320,320,14,7,7,0.021875,0.04375,0.021875
2005.0,MW,377,377,21,23,-2,0.061007958,0.055702917,-0.0053050397
2006.0,MW,418,418,17,24,-7,0.057416268,0.040669855,-0.016746411
2007.0,MW,447,447,29,19,10,0.042505592,0.06487696,0.022371365
2008.0,MW,482,482,26,33,-7,0.06846473,0.05394191,-0.014522822
2009.0,MW,543,543,34,26,8,0.047882136,0.062615104,0.014732965
2010.0,MW,597,597,22,29,-7,0.048576213,0.03685092,-0.0117252935
2011.0,MW,679,679,43,36,7,0.053019147,0.06332842,0.010309278
2012.0,MW,761,761,40,47,-7,0.061760843,0.05256242,-0.0091984235
2013.0,MW,846,846,48,37,11,0.043735225,0.056737587,0.013002364
2014.0,MW,913,913,48,61,-13,0.06681271,0.05257393,-0.014238773
2015.0,MW,1032,1032,64,59,5,0.057170544,0.062015504,0.004844961
2016.0,MW,1114,1114,66,60,6,0.053859964,0.05924596,0.0053859963
2017.0,MW,1164,1164,77,83,-6,0.07130584,0.0661512,-0.005154639
2018.0,MW,1281,1281,102,94,8,0.07338017,0.07962529,0.006245121
2019.0,MW,1329,1329,89,85,4,0.06395786,0.066967644,0.0030097817
2020.0,MW,1298,1298,94,72,22,0.055469953,0.07241911,0.016949153
2021.0,MW,1222,1222,79,64,15,0.05237316,0.064648114,0.012274959
2022.0,MW,0,0,39,47,-8,,,
1996.0,MX,9784,9784,0,0,0,0.0,0.0,0.0
1997.0,MX,12326,12326,328,304,24,0.024663314,0.026610417,0.0019471037
1998.0,MX,14943,14943,519,487,32,0.032590512,0.03473198,0.002141471
1999.0,MX,16553,16553,594,566,28,0.0341932,0.035884734,0.0016915363
2000.0,MX,18189,18189,673,656,17,0.036065754,0.037000384,0.0009346308
2001.0,MX,20174,20174,742,755,-13,0.037424408,0.036780015,-0.0006443938
2002.0,MX,22362,22362,887,837,50,0.037429567,0.039665505,0.002235936
2003.0,MX,24866,24866,1018,960,58,0.038606934,0.040939435,0.0023325023
2004.0,MX,27527,27527,1116,1107,9,0.04021506,0.040542014,0.00032695173
2005.0,MX,30121,30121,1157,1237,-80,0.041067693,0.03841174,-0.0026559543
2006.0,MX,32854,32854,1268,1398,-130,0.042551897,0.038594995,-0.0039569004
2007.0,MX,36236,36236,1490,1560,-70,0.04305111,0.04111933,-0.0019317806
2008.0,MX,39407,39407,1573,1674,-101,0.04247976,0.039916765,-0.0025629965
2009.0,MX,42886,42886,1774,1749,25,0.04078254,0.041365482,0.0005829408
2010.0,MX,46462,46462,1885,2028,-143,0.043648575,0.040570788,-0.003077784
2011.0,MX,50127,50127,1974,2294,-320,0.04576376,0.039379977,-0.006383785
2012.0,MX,54455,54455,2274,2358,-84,0.04330181,0.041759253,-0.0015425581
2013.0,MX,58758,58758,2486,2471,15,0.04205385,0.04230913,0.0002552844
2014.0,MX,63133,63133,2710,2690,20,0.042608462,0.042925254,0.00031679153
2015.0,MX,67642,67642,3127,3040,87,0.04494249,0.046228673,0.0012861831
2016.0,MX,71457,71457,3253,3159,94,0.044208404,0.045523882,0.0013154765
2017.0,MX,75002,75002,3509,3448,61,0.04597211,0.046785418,0.00081331166
2018.0,MX,77493,77493,3764,3729,35,0.048120476,0.04857213,0.0004516537
2019.0,MX,77339,77339,3718,4148,-430,0.053634003,0.048074063,-0.0055599376
2020.0,MX,73479,73479,3174,3708,-534,0.050463397,0.043196015,-0.0072673825
2021.0,MX,67341,67341,2320,2600,-280,0.038609464,0.034451522,-0.0041579423
2022.0,MX,0,0,1338,1520,-182,,,
1996.0,MY,1748,1748,0,0,0,0.0,0.0,0.0
1997.0,MY,2221,2221,53,67,-14,0.030166592,0.023863126,-0.006303467
1998.0,MY,2794,2794,113,68,45,0.024337867,0.040443808,0.01610594
1999.0,MY,3129,3129,151,103,48,0.032917865,0.04825823,0.015340365
2000.0,MY,3549,3549,156,118,38,0.0332488,0.043956045,0.0107072415
2001.0,MY,4024,4024,211,168,43,0.041749503,0.052435387,0.010685884
2002.0,MY,4723,4723,235,192,43,0.040652126,0.049756512,0.009104383
2003.0,MY,5568,5568,304,196,108,0.03520115,0.054597702,0.019396551
2004.0,MY,6467,6467,350,310,40,0.047935672,0.05412092,0.006185248
2005.0,MY,7400,7400,346,378,-32,0.05108108,0.046756756,-0.0043243244
2006.0,MY,9119,9119,494,390,104,0.04276785,0.054172605,0.011404759
2007.0,MY,11461,11461,620,445,175,0.038827326,0.0540965,0.015269173
2008.0,MY,14427,14427,749,508,241,0.035211757,0.051916547,0.01670479
2009.0,MY,18363,18363,809,787,22,0.042857923,0.044055983,0.0011980613
2010.0,MY,23584,23584,1091,757,334,0.032098033,0.046260178,0.014162144
2011.0,MY,29092,29092,1317,901,416,0.030970713,0.04527018,0.0142994635
2012.0,MY,34319,34319,1457,1207,250,0.035170022,0.042454615,0.0072845947
2013.0,MY,39140,39140,1901,1483,418,0.037889626,0.04856924,0.010679612
2014.0,MY,42812,42812,1910,1741,169,0.040666167,0.04461366,0.0039474913
2015.0,MY,46005,46005,1978,2111,-133,0.045886315,0.042995326,-0.00289099
2016.0,MY,48077,48077,2008,2561,-553,0.053268716,0.041766334,-0.011502381
2017.0,MY,48955,48955,2086,2793,-707,0.057052396,0.04261056,-0.014441835
2018.0,MY,49187,49187,2067,3081,-1014,0.0626385,0.042023297,-0.020615203
2019.0,MY,48549,48549,2179,3322,-1143,0.068425715,0.04488249,-0.023543224
2020.0,MY,45818,45818,2001,2693,-692,0.05877603,0.043672793,-0.015103235
2021.0,MY,41690,41690,1567,1766,-199,0.04236028,0.03758695,-0.004773327
2022.0,MY,0,0,1138,1209,-71,,,
1996.0,MZ,117,117,0,0,0,0.0,0.0,0.0
1997.0,MZ,147,147,6,6,0,0.040816326,0.040816326,0.0
1998.0,MZ,180,180,8,13,-5,0.072222225,0.044444446,-0.027777778
1999.0,MZ,205,205,20,21,-1,0.10243902,0.09756097,-0.004878049
2000.0,MZ,203,203,14,26,-12,0.12807882,0.06896552,-0.0591133
2001.0,MZ,193,193,11,36,-25,0.1865285,0.05699482,-0.12953368
2002.0,MZ,213,213,25,29,-4,0.13615024,0.11737089,-0.018779343
2003.0,MZ,200,200,9,31,-22,0.155,0.045,-0.11
2004.0,MZ,218,218,18,25,-7,0.1146789,0.08256881,-0.03211009
2005.0,MZ,236,236,14,28,-14,0.118644066,0.059322033,-0.059322033
2006.0,MZ,292,292,34,28,6,0.09589041,0.11643836,0.020547945
2007.0,MZ,359,359,56,25,31,0.06963788,0.15598886,0.08635098
2008.0,MZ,448,448,72,27,45,0.06026786,0.16071428,0.100446425
2009.0,MZ,474,474,30,43,-13,0.0907173,0.06329114,-0.02742616
2010.0,MZ,492,492,52,60,-8,0.12195122,0.10569106,-0.016260162
2011.0,MZ,484,484,48,64,-16,0.1322314,0.09917355,-0.03305785
2012.0,MZ,519,519,62,74,-12,0.1425819,0.1194605,-0.023121387
2013.0,MZ,569,569,61,59,2,0.103690684,0.10720562,0.0035149385
2014.0,MZ,621,621,51,62,-11,0.09983897,0.082125604,-0.017713366
2015.0,MZ,704,704,71,80,-9,0.11363637,0.10085227,-0.012784091
2016.0,MZ,728,728,55,80,-25,0.10989011,0.07554945,-0.03434066
2017.0,MZ,744,744,68,99,-31,0.13306452,0.09139785,-0.041666668
2018.0,MZ,780,780,78,95,-17,0.12179487,0.1,-0.021794872
2019.0,MZ,789,789,93,92,1,0.11660329,0.117870726,0.0012674271
2020.0,MZ,746,746,67,89,-22,0.11930295,0.08981233,-0.029490616
2021.0,MZ,703,703,76,53,23,0.07539118,0.10810811,0.032716926
2022.0,MZ,0,0,64,42,22,,,
1996.0,NA,30,30,0,0,0,0.0,0.0,0.0
1997.0,NA,36,36,2,1,1,0.027777778,0.055555556,0.027777778
1998.0,NA,43,43,5,3,2,0.069767445,0.11627907,0.046511628
1999.0,NA,57,57,5,2,3,0.03508772,0.0877193,0.05263158
2000.0,NA,65,65,2,3,-1,0.046153847,0.03076923,-0.015384615
2001.0,NA,72,72,5,1,4,0.013888889,0.06944445,0.055555556
2002.0,NA,76,76,4,3,1,0.039473683,0.05263158,0.013157895
2003.0,NA,87,87,8,7,1,0.08045977,0.09195402,0.011494253
2004.0,NA,89,89,2,4,-2,0.04494382,0.02247191,-0.02247191
2005.0,NA,90,90,5,4,1,0.044444446,0.055555556,0.011111111
2006.0,NA,97,97,6,4,2,0.041237112,0.06185567,0.020618556
2007.0,NA,100,100,4,10,-6,0.1,0.04,-0.06
2008.0,NA,116,116,9,3,6,0.02586207,0.077586204,0.05172414
2009.0,NA,145,145,9,5,4,0.03448276,0.062068965,0.027586207
2010.0,NA,170,170,11,6,5,0.03529412,0.064705886,0.029411765
2011.0,NA,225,225,17,5,12,0.022222223,0.075555556,0.053333335
2012.0,NA,279,279,30,8,22,0.028673835,0.10752688,0.07885305
2013.0,NA,322,322,24,8,16,0.024844721,0.07453416,0.049689442
2014.0,NA,360,360,28,14,14,0.03888889,0.07777778,0.03888889
2015.0,NA,406,406,25,25,0,0.061576355,0.061576355,0.0
2016.0,NA,431,431,37,16,21,0.03712297,0.08584687,0.0487239
2017.0,NA,461,461,26,20,6,0.04338395,0.056399133,0.013015185
2018.0,NA,508,508,46,29,17,0.057086613,0.09055118,0.033464566
2019.0,NA,548,548,50,17,33,0.031021899,0.091240875,0.06021898
2020.0,NA,545,545,38,20,18,0.036697246,0.06972477,0.033027522
2021.0,NA,513,513,35,26,9,0.05068226,0.06822612,0.01754386
2022.0,NA,0,0,14,17,-3,,,
1996.0,NC,52,52,0,0,0,0.0,0.0,0.0
1997.0,NC,57,57,2,4,-2,0.07017544,0.03508772,-0.03508772
1998.0,NC,61,61,4,10,-6,0.16393442,0.06557377,-0.09836066
1999.0,NC,66,66,8,6,2,0.09090909,0.121212125,0.030303031
2000.0,NC,70,70,7,9,-2,0.12857144,0.1,-0.028571429
2001.0,NC,74,74,8,6,2,0.08108108,0.10810811,0.027027028
2002.0,NC,83,83,7,8,-1,0.09638554,0.084337346,-0.012048192
2003.0,NC,90,90,12,11,1,0.12222222,0.13333334,0.011111111
2004.0,NC,100,100,15,13,2,0.13,0.15,0.02
2005.0,NC,123,123,15,14,1,0.11382114,0.12195122,0.008130081
2006.0,NC,133,133,20,12,8,0.09022556,0.15037593,0.060150377
2007.0,NC,145,145,17,12,5,0.08275862,0.11724138,0.03448276
2008.0,NC,163,163,22,19,3,0.116564415,0.13496932,0.018404908
2009.0,NC,176,176,25,15,10,0.08522727,0.14204545,0.056818184
2010.0,NC,173,173,24,27,-3,0.15606937,0.13872832,-0.01734104
2011.0,NC,190,190,28,27,1,0.14210527,0.14736842,0.005263158
2012.0,NC,211,211,28,19,9,0.0900474,0.13270143,0.04265403
2013.0,NC,227,227,26,18,8,0.07929515,0.11453745,0.03524229
2014.0,NC,235,235,24,31,-7,0.1319149,0.10212766,-0.029787235
2015.0,NC,246,246,32,27,5,0.1097561,0.1300813,0.020325202
2016.0,NC,266,266,40,25,15,0.09398496,0.15037593,0.05639098
2017.0,NC,261,261,27,24,3,0.09195402,0.10344828,0.011494253
2018.0,NC,256,256,39,34,5,0.1328125,0.15234375,0.01953125
2019.0,NC,223,223,21,40,-19,0.17937219,0.09417041,-0.08520179
2020.0,NC,220,220,34,23,11,0.10454545,0.15454546,0.05
2021.0,NC,192,192,18,27,-9,0.140625,0.09375,-0.046875
1996.0,NE,44,44,0,0,0,0.0,0.0,0.0
1997.0,NE,49,49,3,4,-1,0.08163265,0.06122449,-0.020408163
1998.0,NE,64,64,4,7,-3,0.109375,0.0625,-0.046875
1999.0,NE,68,68,4,3,1,0.04411765,0.05882353,0.014705882
2000.0,NE,63,63,1,6,-5,0.0952381,0.015873017,-0.07936508
2001.0,NE,57,57,4,12,-8,0.21052632,0.07017544,-0.14035088
2002.0,NE,70,70,4,3,1,0.042857144,0.057142857,0.014285714
2003.0,NE,82,82,5,4,1,0.048780486,0.06097561,0.0121951215
2004.0,NE,92,92,7,6,1,0.06521739,0.07608695,0.010869565
2005.0,NE,113,113,6,4,2,0.03539823,0.053097345,0.017699115
2006.0,NE,120,120,7,7,0,0.058333334,0.058333334,0.0
2007.0,NE,130,130,9,4,5,0.03076923,0.06923077,0.03846154
2008.0,NE,148,148,10,6,4,0.04054054,0.067567565,0.027027028
2009.0,NE,162,162,6,14,-8,0.086419754,0.037037037,-0.049382716
2010.0,NE,193,193,10,7,3,0.03626943,0.051813472,0.015544041
2011.0,NE,203,203,5,18,-13,0.08866995,0.024630541,-0.06403941
2012.0,NE,254,254,25,12,13,0.047244094,0.098425195,0.051181104
2013.0,NE,315,315,32,13,19,0.041269843,0.1015873,0.06031746
2014.0,NE,410,410,50,22,28,0.053658538,0.12195122,0.068292685
2015.0,NE,481,481,45,27,18,0.056133058,0.09355509,0.03742204
2016.0,NE,544,544,60,41,19,0.075367644,0.11029412,0.03492647
2017.0,NE,592,592,58,37,21,0.0625,0.097972974,0.035472974
2018.0,NE,641,641,57,45,12,0.070202805,0.08892356,0.018720748
2019.0,NE,651,651,69,56,13,0.086021505,0.10599078,0.019969279
2020.0,NE,625,625,55,54,1,0.0864,0.088,0.0016
2021.0,NE,566,566,39,50,-11,0.088339224,0.06890459,-0.019434629
2022.0,NE,0,0,21,27,-6,,,
1996.0,NG,1885,1885,0,0,0,0.0,0.0,0.0
1997.0,NG,2459,2459,29,31,-2,0.012606751,0.011793412,-0.00081333873
1998.0,NG,3055,3055,32,58,-26,0.01898527,0.010474632,-0.008510638
1999.0,NG,3263,3263,40,52,-12,0.015936255,0.012258657,-0.0036775973
2000.0,NG,3758,3758,43,52,-9,0.0138371475,0.011442256,-0.0023948909
2001.0,NG,4227,4227,54,56,-2,0.013248167,0.012775018,-0.0004731488
2002.0,NG,5310,5310,68,67,1,0.012617703,0.012806026,0.00018832392
2003.0,NG,6408,6408,93,70,23,0.010923845,0.014513109,0.0035892634
2004.0,NG,7226,7226,83,98,-15,0.013562136,0.011486299,-0.0020758372
2005.0,NG,7937,7937,101,111,-10,0.013985133,0.012725211,-0.0012599219
2006.0,NG,8660,8660,91,147,-56,0.016974596,0.010508083,-0.0064665126
2007.0,NG,9313,9313,132,134,-2,0.01438849,0.014173736,-0.00021475357
2008.0,NG,10056,10056,144,165,-21,0.016408114,0.014319809,-0.0020883055
2009.0,NG,11368,11368,146,176,-30,0.015482055,0.012843069,-0.0026389866
2010.0,NG,13261,13261,195,225,-30,0.016967047,0.014704773,-0.0022622729
2011.0,NG,15886,15886,234,218,16,0.013722775,0.014729951,0.0010071761
2012.0,NG,18407,18407,293,301,-8,0.016352475,0.015917858,-0.00043461728
2013.0,NG,20633,20633,353,367,-14,0.01778704,0.017108515,-0.00067852467
2014.0,NG,23310,23310,407,384,23,0.016473617,0.017460318,0.000986701
2015.0,NG,25864,25864,540,478,62,0.018481286,0.020878442,0.0023971545
2016.0,NG,28606,28606,612,585,27,0.020450255,0.021394113,0.00094385794
2017.0,NG,31353,31353,703,685,18,0.02184799,0.022422098,0.00057410775
2018.0,NG,34924,34924,940,762,178,0.021818807,0.026915587,0.0050967815
2019.0,NG,36682,36682,1055,1033,22,0.02816095,0.0287607,0.0005997492
2020.0,NG,35901,35901,923,982,-59,0.027352998,0.02570959,-0.0016434082
2021.0,NG,33645,33645,698,848,-150,0.02520434,0.020746024,-0.0044583147
2022.0,NG,0,0,423,617,-194,,,
1996.0,NI,34,34,0,0,0,0.0,0.0,0.0
1997.0,NI,44,44,2,2,0,0.045454547,0.045454547,0.0
1998.0,NI,52,52,3,4,-1,0.07692308,0.057692308,-0.01923077
1999.0,NI,57,57,1,0,1,0.0,0.01754386,0.01754386
2000.0,NI,59,59,3,5,-2,0.084745765,0.050847456,-0.033898305
2001.0,NI,55,55,0,6,-6,0.10909091,0.0,-0.10909091
2002.0,NI,60,60,3,3,0,0.05,0.05,0.0
2003.0,NI,67,67,4,5,-1,0.07462686,0.05970149,-0.014925373
2004.0,NI,88,88,11,9,2,0.10227273,0.125,0.022727273
2005.0,NI,94,94,10,7,3,0.07446808,0.10638298,0.031914894
2006.0,NI,129,129,13,8,5,0.062015504,0.1007752,0.03875969
2007.0,NI,137,137,10,13,-3,0.09489051,0.0729927,-0.02189781
2008.0,NI,149,149,15,12,3,0.08053691,0.10067114,0.020134227
2009.0,NI,152,152,13,21,-8,0.13815789,0.08552632,-0.05263158
2010.0,NI,171,171,15,13,2,0.07602339,0.0877193,0.0116959065
2011.0,NI,196,196,23,20,3,0.10204082,0.11734694,0.015306123
2012.0,NI,231,231,33,30,3,0.12987013,0.14285715,0.012987013
2013.0,NI,271,271,33,25,8,0.09225092,0.12177122,0.029520296
2014.0,NI,322,322,40,37,3,0.11490683,0.124223605,0.00931677
2015.0,NI,354,354,43,41,2,0.11581921,0.121468924,0.0056497175
2016.0,NI,381,381,50,49,1,0.12860893,0.1312336,0.002624672
2017.0,NI,505,505,72,70,2,0.13861386,0.14257425,0.003960396
2018.0,NI,569,569,77,70,7,0.12302285,0.13532513,0.012302285
2019.0,NI,571,571,64,56,8,0.09807356,0.11208406,0.014010508
2020.0,NI,516,516,53,71,-18,0.1375969,0.102713175,-0.034883723
2021.0,NI,454,454,40,58,-18,0.1277533,0.08810572,-0.039647575
1996.0,NL,32772,32772,0,0,0,0.0,0.0,0.0
1997.0,NL,37857,37857,783,931,-148,0.024592545,0.020683097,-0.0039094486
1998.0,NL,42715,42715,1088,1143,-55,0.026758749,0.025471145,-0.0012876039
1999.0,NL,44390,44390,1167,1219,-52,0.02746114,0.026289705,-0.001171435
2000.0,NL,46316,46316,1395,1267,128,0.027355557,0.03011918,0.0027636238
2001.0,NL,48344,48344,1530,1361,169,0.028152408,0.03164819,0.0034957803
2002.0,NL,50985,50985,1692,1538,154,0.030165736,0.03318623,0.0030204963
2003.0,NL,53709,53709,1787,1636,151,0.030460443,0.03327189,0.0028114468
2004.0,NL,56511,56511,1815,1851,-36,0.032754686,0.032117642,-0.00063704414
2005.0,NL,59864,59864,2036,1919,117,0.032055993,0.034010425,0.00195443
2006.0,NL,63471,63471,2105,2273,-168,0.03581163,0.03316475,-0.0026468781
2007.0,NL,67542,67542,2299,2401,-102,0.03554825,0.03403808,-0.0015101715
2008.0,NL,72388,72388,2503,2665,-162,0.036815494,0.034577556,-0.00223794
2009.0,NL,76734,76734,2758,2737,21,0.035668675,0.035942346,0.0002736727
2010.0,NL,80791,80791,2951,2882,69,0.03567229,0.036526345,0.0008540555
2011.0,NL,84713,84713,3103,2965,138,0.035000533,0.03662956,0.0016290297
2012.0,NL,88144,88144,3232,3248,-16,0.036848795,0.036667272,-0.00018152114
2013.0,NL,89672,89672,3264,3547,-283,0.039555266,0.036399323,-0.003155946
2014.0,NL,92533,92533,3495,3654,-159,0.039488614,0.03777031,-0.0017183059
2015.0,NL,95279,95279,3592,3778,-186,0.03965197,0.037699807,-0.0019521615
2016.0,NL,97025,97025,3834,3974,-140,0.040958516,0.03951559,-0.001442927
2017.0,NL,98383,98383,3892,4163,-271,0.04231422,0.03955968,-0.0027545409
2018.0,NL,99531,99531,4077,4327,-250,0.043473892,0.04096211,-0.0025117802
2019.0,NL,99228,99228,4491,4444,47,0.044785745,0.0452594,0.00047365663
2020.0,NL,94997,94997,4256,3988,268,0.041980274,0.044801414,0.0028211416
2021.0,NL,88517,88517,3486,2998,488,0.0338692,0.039382264,0.0055130655
2022.0,NL,0,0,2510,2049,461,,,
1996.0,NO,8047,8047,0,0,0,0.0,0.0,0.0
1997.0,NO,9388,9388,216,236,-20,0.025138475,0.023008095,-0.0021303792
1998.0,NO,10704,10704,298,289,9,0.026999252,0.02784006,0.00084080716
1999.0,NO,11228,11228,319,306,13,0.027253296,0.028411115,0.0011578198
2000.0,NO,11832,11832,388,347,41,0.029327247,0.032792427,0.0034651791
2001.0,NO,12441,12441,409,338,71,0.027168235,0.03287517,0.0057069366
2002.0,NO,13261,13261,454,429,25,0.032350503,0.034235727,0.0018852274
2003.0,NO,14372,14372,474,393,81,0.027344838,0.032980796,0.0056359586
2004.0,NO,15583,15583,540,465,75,0.02984021,0.034653146,0.004812937
2005.0,NO,16967,16967,603,474,129,0.027936583,0.03553958,0.007602994
2006.0,NO,18442,18442,706,553,153,0.029985901,0.038282182,0.00829628
2007.0,NO,20453,20453,816,564,252,0.027575416,0.039896347,0.012320931
2008.0,NO,21970,21970,898,706,192,0.03213473,0.04087392,0.00873919
2009.0,NO,23652,23652,994,658,336,0.027820058,0.042026043,0.014205987
2010.0,NO,25080,25080,1013,777,236,0.03098086,0.04039075,0.009409889
2011.0,NO,26319,26319,1003,817,186,0.031042213,0.03810935,0.007067138
2012.0,NO,27252,27252,1120,846,274,0.031043593,0.0410979,0.010054308
2013.0,NO,28598,28598,1164,925,239,0.03234492,0.040702146,0.008357228
2014.0,NO,29719,29719,1170,952,218,0.03203338,0.039368752,0.0073353746
2015.0,NO,31000,31000,1265,995,270,0.032096773,0.04080645,0.0087096775
2016.0,NO,31792,31792,1336,1108,228,0.034851536,0.042023152,0.0071716155
2017.0,NO,32750,32750,1437,1060,377,0.032366414,0.043877862,0.011511451
2018.0,NO,33525,33525,1476,1228,248,0.036629383,0.044026844,0.0073974645
2019.0,NO,34046,34046,1550,1302,248,0.038242377,0.04552664,0.0072842627
2020.0,NO,33108,33108,1498,1198,300,0.03618461,0.045245863,0.009061254
2021.0,NO,31297,31297,1197,955,242,0.030514106,0.03824648,0.0077323704
2022.0,NO,0,0,872,669,203,,,
1996.0,NP,125,125,0,0,0,0.0,0.0,0.0
1997.0,NP,185,185,7,6,1,0.032432433,0.037837837,0.0054054055
1998.0,NP,256,256,17,11,6,0.04296875,0.06640625,0.0234375
1999.0,NP,311,311,16,10,6,0.03215434,0.051446944,0.019292604
2000.0,NP,354,354,27,31,-4,0.08757062,0.076271184,-0.011299435
2001.0,NP,508,508,29,33,-4,0.06496063,0.057086613,-0.007874016
2002.0,NP,613,613,33,29,4,0.04730832,0.053833604,0.0065252855
2003.0,NP,717,717,34,40,-6,0.055788007,0.047419805,-0.008368201
2004.0,NP,844,844,49,52,-3,0.061611373,0.058056872,-0.0035545023
2005.0,NP,1002,1002,54,61,-7,0.060878243,0.053892214,-0.006986028
2006.0,NP,1098,1098,62,52,10,0.047358833,0.056466304,0.009107468
2007.0,NP,1279,1279,83,83,0,0.064894445,0.064894445,0.0
2008.0,NP,1539,1539,80,84,-4,0.054580897,0.051981807,-0.0025990903
2009.0,NP,1791,1791,112,109,3,0.060859855,0.0625349,0.0016750419
2010.0,NP,2114,2114,123,159,-36,0.075212866,0.05818354,-0.017029328
2011.0,NP,2591,2591,192,152,40,0.05866461,0.07410266,0.015438055
2012.0,NP,2967,2967,215,184,31,0.062015504,0.072463766,0.010448264
2013.0,NP,3394,3394,259,247,12,0.07277548,0.076311134,0.0035356511
2014.0,NP,3748,3748,253,317,-64,0.08457844,0.06750267,-0.017075773
2015.0,NP,4124,4124,295,297,-2,0.07201746,0.071532495,-0.00048496606
2016.0,NP,4523,4523,375,379,-4,0.083793946,0.08290958,-0.0008843688
2017.0,NP,4796,4796,409,376,33,0.07839867,0.0852794,0.006880734
2018.0,NP,5170,5170,484,439,45,0.084912956,0.09361702,0.008704062
2019.0,NP,5248,5248,435,563,-128,0.107278965,0.08288872,-0.024390243
2020.0,NP,5011,5011,462,506,-44,0.100977845,0.092197165,-0.008780682
2021.0,NP,4613,4613,380,331,49,0.07175374,0.08237589,0.010622155
2022.0,NP,0,0,225,239,-14,,,
1996.0,NZ,5220,5220,0,0,0,0.0,0.0,0.0
1997.0,NZ,6290,6290,323,289,34,0.045945946,0.05135135,0.0054054055
1998.0,NZ,7276,7276,417,366,51,0.050302364,0.05731171,0.0070093456
1999.0,NZ,7649,7649,420,427,-7,0.05582429,0.05490914,-0.0009151523
2000.0,NZ,8026,8026,492,514,-22,0.06404186,0.061300773,-0.0027410914
2001.0,NZ,8355,8355,516,566,-50,0.06774387,0.061759427,-0.0059844404
2002.0,NZ,8774,8774,563,549,14,0.062571235,0.06416686,0.0015956234
2003.0,NZ,9394,9394,669,648,21,0.0689802,0.07121567,0.0022354694
2004.0,NZ,10068,10068,721,684,37,0.06793802,0.07161303,0.0036750098
2005.0,NZ,10908,10908,782,723,59,0.06628163,0.0716905,0.0054088742
2006.0,NZ,11792,11792,891,779,112,0.066061735,0.0755597,0.009497965
2007.0,NZ,12726,12726,964,831,133,0.065299384,0.07575043,0.010451045
2008.0,NZ,13655,13655,998,957,41,0.07008422,0.07308678,0.0030025633
2009.0,NZ,14653,14653,1138,1010,128,0.06892786,0.07766328,0.008735413
2010.0,NZ,15641,15641,1197,1031,166,0.0659165,0.07652964,0.010613132
2011.0,NZ,16452,16452,1196,1160,36,0.070508145,0.07269633,0.0021881838
2012.0,NZ,17122,17122,1202,1281,-79,0.074816026,0.07020208,-0.004613947
2013.0,NZ,17692,17692,1211,1302,-91,0.07359258,0.06844901,-0.005143568
2014.0,NZ,18212,18212,1287,1374,-87,0.075444765,0.07066769,-0.00477707
2015.0,NZ,18673,18673,1345,1412,-67,0.0756172,0.072029136,-0.0035880683
2016.0,NZ,19160,19160,1454,1412,42,0.0736952,0.07588726,0.0021920667
2017.0,NZ,19691,19691,1517,1404,113,0.07130161,0.07704027,0.0057386626
2018.0,NZ,20009,20009,1599,1608,-9,0.08036384,0.07991404,-0.0004497976
2019.0,NZ,20039,20039,1677,1719,-42,0.08578272,0.08368681,-0.002095913
2020.0,NZ,19288,19288,1580,1555,25,0.08062007,0.08191622,0.0012961427
2021.0,NZ,18016,18016,1173,1106,67,0.061389875,0.06510879,0.0037189166
2022.0,NZ,0,0,739,815,-76,,,
2023.0,NZ,0,0,61,49,12,,,
1996.0,OM,242,242,0,0,0,0.0,0.0,0.0
1997.0,OM,306,306,15,11,4,0.035947714,0.04901961,0.013071896
1998.0,OM,424,424,32,12,20,0.028301887,0.0754717,0.047169812
1999.0,OM,496,496,34,22,12,0.044354837,0.06854839,0.024193548
2000.0,OM,570,570,35,23,12,0.040350877,0.06140351,0.021052632
2001.0,OM,653,653,46,23,23,0.035222054,0.07044411,0.035222054
2002.0,OM,714,714,45,25,20,0.035014007,0.063025214,0.028011205
2003.0,OM,754,754,39,40,-1,0.0530504,0.05172414,-0.0013262599
2004.0,OM,781,781,31,41,-10,0.0524968,0.0396927,-0.0128040975
2005.0,OM,850,850,53,41,12,0.048235293,0.06235294,0.014117647
2006.0,OM,927,927,54,32,22,0.034519956,0.058252428,0.02373247
2007.0,OM,982,982,49,46,3,0.04684318,0.049898166,0.0030549897
2008.0,OM,1093,1093,71,47,24,0.043000914,0.064958826,0.021957913
2009.0,OM,1223,1223,73,58,15,0.047424365,0.059689287,0.012264922
2010.0,OM,1383,1383,95,58,37,0.041937817,0.06869125,0.026753435
2011.0,OM,1551,1551,94,82,12,0.052869115,0.060606062,0.007736944
2012.0,OM,1782,1782,124,81,43,0.045454547,0.069584735,0.024130192
2013.0,OM,2011,2011,132,79,53,0.03928394,0.06563899,0.026355047
2014.0,OM,2214,2214,178,104,74,0.046973802,0.08039747,0.033423666
2015.0,OM,2358,2358,156,124,32,0.05258694,0.06615776,0.013570823
2016.0,OM,2477,2477,157,124,33,0.050060555,0.063383125,0.013322568
2017.0,OM,2540,2540,174,151,23,0.05944882,0.06850394,0.009055118
2018.0,OM,2636,2636,206,173,33,0.06562974,0.07814871,0.012518968
2019.0,OM,2724,2724,225,212,13,0.07782672,0.08259912,0.0047723935
2020.0,OM,2660,2660,209,183,26,0.06879699,0.07857143,0.009774436
2021.0,OM,2555,2555,167,108,59,0.042270057,0.065362036,0.023091976
2022.0,OM,0,0,133,93,40,,,
1996.0,PA,124,124,0,0,0,0.0,0.0,0.0
1997.0,PA,165,165,21,13,8,0.07878788,0.12727273,0.048484847
1998.0,PA,191,191,25,20,5,0.10471204,0.13089006,0.02617801
1999.0,PA,206,206,16,24,-8,0.116504855,0.0776699,-0.03883495
2000.0,PA,214,214,19,21,-2,0.098130845,0.088785045,-0.009345794
2001.0,PA,256,256,34,22,12,0.0859375,0.1328125,0.046875
2002.0,PA,271,271,27,42,-15,0.15498155,0.099631,-0.055350553
2003.0,PA,291,291,32,31,1,0.106529206,0.10996564,0.0034364262
2004.0,PA,302,302,30,41,-11,0.13576159,0.09933775,-0.03642384
2005.0,PA,335,335,42,43,-1,0.12835822,0.12537314,-0.0029850747
2006.0,PA,364,364,39,41,-2,0.11263736,0.10714286,-0.0054945056
2007.0,PA,422,422,74,32,42,0.07582939,0.17535545,0.09952607
2008.0,PA,488,488,71,75,-4,0.15368852,0.14549181,-0.008196721
2009.0,PA,552,552,88,73,15,0.13224638,0.1594203,0.027173912
2010.0,PA,668,668,116,69,47,0.10329341,0.1736527,0.07035928
2011.0,PA,788,788,133,88,45,0.11167513,0.16878173,0.0571066
2012.0,PA,866,866,117,116,1,0.13394919,0.13510393,0.0011547344
2013.0,PA,919,919,124,133,-9,0.14472252,0.13492927,-0.009793254
2014.0,PA,1012,1012,169,131,38,0.12944664,0.16699605,0.037549406
2015.0,PA,1124,1124,191,155,36,0.13790035,0.16992882,0.03202847
2016.0,PA,1186,1186,202,173,29,0.14586847,0.1703204,0.02445194
2017.0,PA,1230,1230,202,188,14,0.15284553,0.16422765,0.011382114
2018.0,PA,1246,1246,188,228,-40,0.18298556,0.15088283,-0.03210273
2019.0,PA,1238,1238,201,208,-7,0.16801292,0.16235864,-0.005654281
2020.0,PA,1150,1150,148,166,-18,0.14434783,0.12869565,-0.015652174
2021.0,PA,1036,1036,111,106,5,0.1023166,0.10714286,0.0048262547
2022.0,PA,0,0,47,84,-37,,,
1996.0,PE,716,716,0,0,0,0.0,0.0,0.0
1997.0,PE,905,905,29,40,-11,0.044198897,0.0320442,-0.0121546965
1998.0,PE,1100,1100,52,54,-2,0.04909091,0.047272727,-0.0018181818
1999.0,PE,1211,1211,63,67,-4,0.055326175,0.05202312,-0.0033030554
2000.0,PE,1381,1381,80,73,7,0.052860245,0.057929035,0.0050687906
2001.0,PE,1478,1478,67,100,-33,0.067659,0.04533153,-0.02232747
2002.0,PE,1630,1630,116,118,-2,0.072392635,0.07116564,-0.0012269939
2003.0,PE,1806,1806,116,116,0,0.064230345,0.064230345,0.0
2004.0,PE,2115,2115,144,150,-6,0.07092199,0.068085104,-0.0028368793
2005.0,PE,2388,2388,151,161,-10,0.06742044,0.06323283,-0.004187605
2006.0,PE,2684,2684,181,163,18,0.060730252,0.067436665,0.006706408
2007.0,PE,2974,2974,217,234,-17,0.07868191,0.072965704,-0.005716207
2008.0,PE,3318,3318,219,242,-23,0.07293551,0.06600361,-0.0069318865
2009.0,PE,3792,3792,246,283,-37,0.074630804,0.06487342,-0.009757384
2010.0,PE,4452,4452,354,276,78,0.06199461,0.079514824,0.017520215
2011.0,PE,5415,5415,426,315,111,0.058171745,0.07867036,0.020498615
2012.0,PE,6873,6873,618,377,241,0.05485232,0.08991706,0.035064746
2013.0,PE,7872,7872,666,460,206,0.05843496,0.08460366,0.026168698
2014.0,PE,8756,8756,765,630,135,0.07195066,0.08736866,0.015417999
2015.0,PE,9357,9357,667,865,-198,0.09244416,0.071283534,-0.021160629
2016.0,PE,9882,9882,774,833,-59,0.08429468,0.07832423,-0.0059704515
2017.0,PE,10559,10559,916,734,182,0.069514155,0.08675064,0.01723648
2018.0,PE,11582,11582,1029,886,143,0.07649802,0.08884476,0.012346745
2019.0,PE,12329,12329,1338,963,375,0.07810853,0.10852461,0.030416092
2020.0,PE,12007,12007,1157,934,223,0.07778796,0.09636046,0.0185725
2021.0,PE,11198,11198,807,727,80,0.06492231,0.07206644,0.007144133
2022.0,PE,0,0,435,438,-3,,,
1996.0,PF,44,44,0,0,0,0.0,0.0,0.0
1997.0,PF,56,56,8,3,5,0.05357143,0.14285715,0.08928572
1998.0,PF,58,58,2,7,-5,0.12068965,0.03448276,-0.0862069
1999.0,PF,57,57,5,8,-3,0.14035088,0.0877193,-0.05263158
2000.0,PF,54,54,2,7,-5,0.12962963,0.037037037,-0.09259259
2001.0,PF,50,50,3,7,-4,0.14,0.06,-0.08
2002.0,PF,59,59,8,4,4,0.06779661,0.13559322,0.06779661
2003.0,PF,72,72,11,4,7,0.055555556,0.15277778,0.097222224
2004.0,PF,70,70,7,10,-3,0.14285715,0.1,-0.042857144
2005.0,PF,77,77,6,4,2,0.051948052,0.077922076,0.025974026
2006.0,PF,76,76,6,6,0,0.078947365,0.078947365,0.0
2007.0,PF,89,89,11,6,5,0.06741573,0.123595506,0.056179777
2008.0,PF,94,94,10,8,2,0.08510638,0.10638298,0.021276595
2009.0,PF,99,99,12,10,2,0.1010101,0.121212125,0.02020202
2010.0,PF,114,114,17,9,8,0.078947365,0.1491228,0.07017544
2011.0,PF,129,129,22,6,16,0.046511628,0.17054264,0.12403101
2012.0,PF,148,148,14,7,7,0.0472973,0.0945946,0.0472973
2013.0,PF,156,156,15,17,-2,0.10897436,0.09615385,-0.012820513
2014.0,PF,174,174,14,15,-1,0.0862069,0.08045977,-0.0057471264
2015.0,PF,178,178,21,12,9,0.06741573,0.11797753,0.050561797
2016.0,PF,172,172,12,20,-8,0.11627907,0.069767445,-0.046511628
2017.0,PF,170,170,11,17,-6,0.1,0.064705886,-0.03529412
2018.0,PF,194,194,36,10,26,0.05154639,0.185567,0.13402061
2019.0,PF,207,207,28,14,14,0.06763285,0.1352657,0.06763285
2020.0,PF,190,190,14,16,-2,0.08421053,0.07368421,-0.010526316
2021.0,PF,170,170,12,16,-4,0.09411765,0.07058824,-0.023529412
1996.0,PG,100,100,0,0,0,0.0,0.0,0.0
1997.0,PG,131,131,4,7,-3,0.053435113,0.030534351,-0.022900764
1998.0,PG,158,158,8,4,4,0.025316456,0.050632913,0.025316456
1999.0,PG,156,156,7,11,-4,0.070512824,0.044871796,-0.025641026
2000.0,PG,158,158,9,13,-4,0.08227848,0.056962024,-0.025316456
2001.0,PG,154,154,10,12,-2,0.077922076,0.064935066,-0.012987013
2002.0,PG,147,147,7,7,0,0.04761905,0.04761905,0.0
2003.0,PG,136,136,4,8,-4,0.05882353,0.029411765,-0.029411765
2004.0,PG,147,147,8,6,2,0.040816326,0.054421768,0.013605442
2005.0,PG,143,143,3,14,-11,0.0979021,0.02097902,-0.07692308
2006.0,PG,156,156,6,6,0,0.03846154,0.03846154,0.0
2007.0,PG,162,162,10,15,-5,0.09259259,0.061728396,-0.030864198
2008.0,PG,189,189,4,13,-9,0.06878307,0.02116402,-0.04761905
2009.0,PG,219,219,18,11,7,0.05022831,0.08219178,0.03196347
2010.0,PG,250,250,22,14,8,0.056,0.088,0.032
2011.0,PG,273,273,23,13,10,0.04761905,0.08424909,0.03663004
2012.0,PG,299,299,23,20,3,0.06688963,0.07692308,0.0100334445
2013.0,PG,299,299,20,26,-6,0.08695652,0.06688963,-0.020066889
2014.0,PG,321,321,25,23,2,0.07165109,0.07788162,0.0062305294
2015.0,PG,339,339,24,20,4,0.05899705,0.07079646,0.01179941
2016.0,PG,332,332,17,26,-9,0.078313254,0.05120482,-0.027108435
2017.0,PG,351,351,20,24,-4,0.06837607,0.05698006,-0.011396011
2018.0,PG,361,361,26,26,0,0.07202216,0.07202216,0.0
2019.0,PG,368,368,20,29,-9,0.07880435,0.054347824,-0.024456521
2020.0,PG,341,341,16,26,-10,0.076246336,0.04692082,-0.029325513
2021.0,PG,309,309,14,12,2,0.03883495,0.045307443,0.006472492
1996.0,PH,1395,1395,0,0,0,0.0,0.0,0.0
1997.0,PH,1694,1694,169,175,-6,0.10330579,0.09976387,-0.0035419127
1998.0,PH,1912,1912,212,248,-36,0.12970711,0.11087866,-0.018828452
1999.0,PH,1988,1988,221,269,-48,0.13531187,0.111167,-0.02414487
2000.0,PH,2132,2132,265,293,-28,0.13742964,0.124296434,-0.013133208
2001.0,PH,2212,2212,260,278,-18,0.12567812,0.11754069,-0.008137432
2002.0,PH,2347,2347,310,314,-4,0.13378781,0.1320835,-0.0017043033
2003.0,PH,2527,2527,323,373,-50,0.14760585,0.12781955,-0.019786308
2004.0,PH,2747,2747,366,356,10,0.12959592,0.13323626,0.0036403348
2005.0,PH,3001,3001,391,382,9,0.1272909,0.1302899,0.0029990003
2006.0,PH,3206,3206,430,487,-57,0.15190268,0.13412352,-0.017779164
2007.0,PH,3485,3485,427,485,-58,0.13916786,0.12252511,-0.016642755
2008.0,PH,3803,3803,488,490,-2,0.12884565,0.12831974,-0.0005259006
2009.0,PH,4092,4092,523,578,-55,0.14125122,0.12781036,-0.01344086
2010.0,PH,4539,4539,562,585,-23,0.12888302,0.12381582,-0.0050671953
2011.0,PH,4981,4981,552,646,-94,0.12969284,0.11082112,-0.018871713
2012.0,PH,5479,5479,604,648,-44,0.11826976,0.110239096,-0.008030662
2013.0,PH,6044,6044,665,714,-49,0.11813369,0.11002647,-0.008107213
2014.0,PH,6573,6573,647,689,-42,0.10482276,0.09843298,-0.0063897762
2015.0,PH,6924,6924,609,710,-101,0.102541886,0.08795494,-0.014586944
2016.0,PH,7343,7343,668,735,-67,0.10009533,0.09097099,-0.009124336
2017.0,PH,7716,7716,584,749,-165,0.09707102,0.07568689,-0.021384137
2018.0,PH,8162,8162,657,682,-25,0.08355795,0.08049498,-0.0030629747
2019.0,PH,8407,8407,640,727,-87,0.08647556,0.07612704,-0.010348519
2020.0,PH,7964,7964,594,685,-91,0.08601206,0.07458564,-0.011426419
2021.0,PH,7410,7410,436,441,-5,0.05951417,0.058839407,-0.0006747638
2022.0,PH,0,0,312,273,39,,,
2023.0,PH,0,0,19,16,3,,,
1996.0,PK,1271,1271,0,0,0,0.0,0.0,0.0
1997.0,PK,1612,1612,75,83,-8,0.051488835,0.046526056,-0.004962779
1998.0,PK,1955,1955,107,99,8,0.050639387,0.05473146,0.0040920717
1999.0,PK,2080,2080,119,141,-22,0.06778846,0.057211537,-0.010576923
2000.0,PK,2332,2332,145,142,3,0.060891937,0.06217839,0.0012864494
2001.0,PK,2611,2611,178,180,-2,0.068939105,0.06817311,-0.00076599006
2002.0,PK,2991,2991,207,208,-1,0.06954196,0.06920762,-0.00033433634
2003.0,PK,3440,3440,258,254,4,0.073837206,0.075,0.0011627907
2004.0,PK,3983,3983,265,305,-40,0.07657544,0.06653276,-0.010042681
2005.0,PK,4716,4716,319,350,-31,0.074215434,0.06764207,-0.0065733674
2006.0,PK,5553,5553,374,380,-6,0.06843148,0.06735098,-0.001080497
2007.0,PK,6580,6580,440,422,18,0.06413374,0.0668693,0.0027355624
2008.0,PK,7776,7776,514,483,31,0.062114198,0.06610082,0.0039866255
2009.0,PK,9003,9003,575,600,-25,0.06664445,0.0638676,-0.002776852
2010.0,PK,10561,10561,651,670,-19,0.06344096,0.06164189,-0.001799072
2011.0,PK,12398,12398,846,800,46,0.064526536,0.06823681,0.0037102757
2012.0,PK,14552,14552,1005,952,53,0.06542056,0.06906267,0.003642111
2013.0,PK,16769,16769,1154,1080,74,0.064404555,0.06881746,0.004412905
2014.0,PK,19370,19370,1344,1177,167,0.060764067,0.06938565,0.00862158
2015.0,PK,21836,21836,1478,1459,19,0.06681627,0.06768639,0.00087012275
2016.0,PK,24429,24429,1625,1566,59,0.06410414,0.0665193,0.0024151623
2017.0,PK,27200,27200,1922,1798,124,0.066102944,0.07066177,0.0045588235
2018.0,PK,30662,30662,2255,2014,241,0.06568391,0.0735438,0.007859891
2019.0,PK,32769,32769,2642,2414,228,0.07366718,0.08062498,0.0069577955
2020.0,PK,32862,32862,2535,2207,328,0.06715964,0.07714077,0.009981133
2021.0,PK,31603,31603,2068,1998,70,0.06322185,0.065436825,0.0022149796
2022.0,PK,0,0,1375,1633,-258,,,
2023.0,PK,0,0,177,146,31,,,
1996.0,PL,15883,15883,0,0,0,0.0,0.0,0.0
1997.0,PL,19399,19399,297,246,51,0.012681066,0.015310068,0.0026290014
1998.0,PL,22855,22855,366,320,46,0.014001313,0.016014,0.0020126887
1999.0,PL,24968,24968,424,399,25,0.015980454,0.016981736,0.0010012817
2000.0,PL,27229,27229,502,365,137,0.013404826,0.018436227,0.0050314004
2001.0,PL,30076,30076,420,455,-35,0.0151283415,0.013964623,-0.0011637185
2002.0,PL,33156,33156,540,467,73,0.014084931,0.016286645,0.0022017132
2003.0,PL,36299,36299,517,511,6,0.014077523,0.014242817,0.00016529381
2004.0,PL,39135,39135,583,564,19,0.0144116515,0.014897151,0.00048549892
2005.0,PL,42316,42316,641,641,0,0.015147935,0.015147935,0.0
2006.0,PL,44972,44972,682,738,-56,0.016410211,0.015164992,-0.0012452193
2007.0,PL,47795,47795,702,817,-115,0.01709384,0.014687729,-0.0024061094
2008.0,PL,50678,50678,752,907,-155,0.017897312,0.014838786,-0.0030585264
2009.0,PL,54448,54448,763,807,-44,0.014821481,0.0140133705,-0.0008081105
2010.0,PL,59128,59128,838,934,-96,0.015796239,0.0141726425,-0.0016235963
2011.0,PL,66715,66715,929,925,4,0.0138649475,0.013924904,5.9956532e-05
2012.0,PL,73952,73952,977,890,87,0.012034833,0.013211272,0.0011764388
2013.0,PL,82386,82386,1120,932,188,0.011312602,0.013594543,0.002281941
2014.0,PL,89482,89482,1138,1104,34,0.012337677,0.012717642,0.00037996468
2015.0,PL,94660,94660,1268,1098,170,0.011599408,0.013395309,0.0017959011
2016.0,PL,98094,98094,1243,1195,48,0.012182193,0.012671519,0.00048932654
2017.0,PL,100027,100027,1249,1350,-101,0.013496356,0.012486628,-0.0010097274
2018.0,PL,100362,100362,1404,1479,-75,0.014736653,0.013989358,-0.0007472948
2019.0,PL,98708,98708,1416,1633,-217,0.016543746,0.014345341,-0.0021984035
2020.0,PL,93410,93410,1352,1388,-36,0.014859223,0.014473825,-0.0003853977
2021.0,PL,85748,85748,1128,1028,100,0.0119886175,0.013154826,0.001166208
2022.0,PL,0,0,747,701,46,,,
1996.0,PR,135,135,0,0,0,0.0,0.0,0.0
1997.0,PR,151,151,13,25,-12,0.16556291,0.08609272,-0.0794702
1998.0,PR,167,167,19,23,-4,0.13772455,0.11377245,-0.023952097
1999.0,PR,154,154,15,42,-27,0.27272728,0.097402595,-0.17532468
2000.0,PR,132,132,18,44,-26,0.33333334,0.13636364,-0.1969697
2001.0,PR,108,108,25,50,-25,0.46296296,0.23148148,-0.23148148
2002.0,PR,108,108,21,41,-20,0.37962964,0.19444445,-0.18518518
2003.0,PR,128,128,27,29,-2,0.2265625,0.2109375,-0.015625
2004.0,PR,137,137,25,42,-17,0.30656934,0.18248175,-0.124087594
2005.0,PR,154,154,30,29,1,0.18831168,0.19480519,0.0064935065
2006.0,PR,176,176,45,35,10,0.19886364,0.2556818,0.056818184
2007.0,PR,178,178,33,39,-6,0.21910113,0.18539326,-0.033707865
2008.0,PR,169,169,26,50,-24,0.295858,0.15384616,-0.14201184
2009.0,PR,166,166,28,53,-25,0.3192771,0.16867469,-0.15060242
2010.0,PR,154,154,26,48,-22,0.3116883,0.16883117,-0.14285715
2011.0,PR,166,166,37,45,-8,0.27108434,0.22289157,-0.04819277
2012.0,PR,179,179,39,51,-12,0.2849162,0.21787709,-0.06703911
2013.0,PR,213,213,51,38,13,0.17840375,0.23943663,0.061032865
2014.0,PR,255,255,65,47,18,0.18431373,0.25490198,0.07058824
2015.0,PR,277,277,65,60,5,0.2166065,0.23465703,0.018050542
2016.0,PR,274,274,52,71,-19,0.2591241,0.18978103,-0.06934307
2017.0,PR,282,282,61,63,-2,0.22340426,0.21631205,-0.0070921984
2018.0,PR,300,300,85,68,17,0.22666667,0.28333333,0.05666667
2019.0,PR,285,285,63,73,-10,0.25614035,0.22105263,-0.03508772
2020.0,PR,224,224,45,97,-52,0.4330357,0.20089285,-0.23214285
2021.0,PR,156,156,24,63,-39,0.40384614,0.15384616,-0.25
1996.0,PS,86,86,0,0,0,0.0,0.0,0.0
1997.0,PS,110,110,3,2,1,0.018181818,0.027272727,0.009090909
1998.0,PS,139,139,7,6,1,0.043165468,0.05035971,0.007194245
1999.0,PS,149,149,4,3,1,0.020134227,0.026845638,0.0067114094
2000.0,PS,191,191,20,5,15,0.02617801,0.10471204,0.07853403
2001.0,PS,226,226,9,3,6,0.013274336,0.03982301,0.026548672
2002.0,PS,240,240,19,8,11,0.033333335,0.079166666,0.045833334
2003.0,PS,246,246,9,18,-9,0.07317073,0.036585364,-0.036585364
2004.0,PS,281,281,11,15,-4,0.053380784,0.03914591,-0.014234875
2005.0,PS,318,318,27,16,11,0.050314464,0.08490566,0.034591194
2006.0,PS,369,369,32,12,20,0.032520324,0.08672087,0.05420054
2007.0,PS,411,411,28,26,2,0.06326034,0.06812652,0.00486618
2008.0,PS,469,469,36,31,5,0.06609808,0.07675906,0.010660981
2009.0,PS,523,523,31,28,3,0.053537283,0.05927342,0.0057361377
2010.0,PS,631,631,49,18,31,0.02852615,0.07765452,0.04912837
2011.0,PS,733,733,62,44,18,0.060027286,0.0845839,0.024556616
2012.0,PS,801,801,59,47,12,0.058676653,0.07365793,0.014981274
2013.0,PS,889,889,59,51,8,0.057367828,0.0663667,0.0089988755
2014.0,PS,1022,1022,90,50,40,0.04892368,0.08806262,0.039138943
2015.0,PS,1142,1142,75,76,-1,0.06654991,0.06567425,-0.0008756567
2016.0,PS,1321,1321,124,59,65,0.044663135,0.09386828,0.049205147
2017.0,PS,1362,1362,86,105,-19,0.07709251,0.06314244,-0.013950073
2018.0,PS,1538,1538,150,87,63,0.05656697,0.09752926,0.04096229
2019.0,PS,1671,1671,152,130,22,0.077797726,0.0909635,0.013165769
2020.0,PS,1653,1653,150,122,28,0.073805206,0.0907441,0.016938899
2021.0,PS,1550,1550,100,84,16,0.05419355,0.06451613,0.010322581
2022.0,PS,0,0,78,60,18,,,
1996.0,PT,4121,4121,0,0,0,0.0,0.0,0.0
1997.0,PT,5180,5180,214,210,4,0.04054054,0.041312743,0.00077220076
1998.0,PT,6188,6188,275,283,-8,0.04573368,0.044440854,-0.0012928249
1999.0,PT,6824,6824,359,309,50,0.045281358,0.05260844,0.0073270807
2000.0,PT,7524,7524,409,361,48,0.0479798,0.054359384,0.0063795852
2001.0,PT,8361,8361,461,450,11,0.053821314,0.055136945,0.0013156321
2002.0,PT,9313,9313,568,466,102,0.05003758,0.060990013,0.010952432
2003.0,PT,10244,10244,642,507,135,0.049492385,0.062670834,0.013178446
2004.0,PT,11422,11422,647,622,25,0.054456312,0.05664507,0.0021887585
2005.0,PT,12659,12659,771,711,60,0.056165572,0.060905285,0.004739711
2006.0,PT,14089,14089,961,779,182,0.055291362,0.06820924,0.012917879
2007.0,PT,15488,15488,996,896,100,0.05785124,0.06430785,0.0064566117
2008.0,PT,17020,17020,1236,1030,206,0.06051704,0.072620444,0.012103408
2009.0,PT,18559,18559,1200,1141,59,0.061479606,0.06465866,0.0031790505
2010.0,PT,20848,20848,1458,1152,306,0.0552571,0.06993476,0.014677667
2011.0,PT,23176,23176,1658,1282,376,0.055315845,0.07153952,0.01622368
2012.0,PT,25333,25333,1797,1396,401,0.055105988,0.070935145,0.015829155
2013.0,PT,27324,27324,1971,1576,395,0.05767823,0.07213439,0.014456156
2014.0,PT,28570,28570,1901,1988,-87,0.069583476,0.06653833,-0.0030451522
2015.0,PT,29531,29531,2016,2148,-132,0.07273712,0.06826724,-0.004469879
2016.0,PT,30050,30050,2029,2206,-177,0.07341098,0.0675208,-0.005890183
2017.0,PT,30802,30802,2139,2262,-123,0.07343679,0.069443546,-0.003993247
2018.0,PT,31389,31389,2204,2328,-124,0.07416611,0.07021568,-0.0039504287
2019.0,PT,31654,31654,2506,2427,79,0.07667278,0.079168506,0.0024957352
2020.0,PT,30829,30829,2302,2318,-16,0.07518894,0.07466996,-0.00051899184
2021.0,PT,29693,29693,2181,1646,535,0.05543394,0.07345165,0.018017715
2022.0,PT,0,0,1680,1241,439,,,
2023.0,PT,0,0,142,159,-17,,,
1996.0,PW,1,1,0,0,0,0.0,0.0,0.0
1999.0,PW,5,5,0,0,0,0.0,0.0,0.0
2001.0,PW,6,6,0,1,-1,0.16666667,0.0,-0.16666667
2003.0,PW,13,13,0,0,0,0.0,0.0,0.0
2004.0,PW,11,11,0,0,0,0.0,0.0,0.0
2005.0,PW,12,12,0,2,-2,0.16666667,0.0,-0.16666667
2006.0,PW,12,12,1,1,0,0.083333336,0.083333336,0.0
2007.0,PW,13,13,1,0,1,0.0,0.07692308,0.07692308
2010.0,PW,11,11,1,0,1,0.0,0.09090909,0.09090909
2012.0,PW,12,12,0,1,-1,0.083333336,0.0,-0.083333336
2013.0,PW,17,17,1,0,1,0.0,0.05882353,0.05882353
2014.0,PW,19,19,1,1,0,0.05263158,0.05263158,0.0
2015.0,PW,19,19,0,1,-1,0.05263158,0.0,-0.05263158
2016.0,PW,21,21,1,0,1,0.0,0.04761905,0.04761905
2017.0,PW,17,17,0,3,-3,0.1764706,0.0,-0.1764706
2018.0,PW,15,15,0,1,-1,0.06666667,0.0,-0.06666667
2020.0,PW,18,18,2,1,1,0.055555556,0.11111111,0.055555556
2021.0,PW,17,17,0,0,0,0.0,0.0,0.0
1996.0,PY,67,67,0,0,0,0.0,0.0,0.0
1997.0,PY,74,74,7,10,-3,0.13513513,0.0945946,-0.04054054
1998.0,PY,84,84,10,5,5,0.05952381,0.11904762,0.05952381
1999.0,PY,72,72,8,21,-13,0.29166666,0.11111111,-0.18055555
2000.0,PY,82,82,7,6,1,0.07317073,0.085365854,0.0121951215
2001.0,PY,80,80,12,8,4,0.1,0.15,0.05
2002.0,PY,90,90,8,12,-4,0.13333334,0.08888889,-0.044444446
2003.0,PY,121,121,21,10,11,0.08264463,0.17355372,0.09090909
2004.0,PY,134,134,13,13,0,0.09701493,0.09701493,0.0
2005.0,PY,155,155,16,11,5,0.07096774,0.103225805,0.032258064
2006.0,PY,161,161,14,24,-10,0.14906833,0.08695652,-0.062111802
2007.0,PY,170,170,22,21,1,0.12352941,0.12941177,0.005882353
2008.0,PY,166,166,21,32,-11,0.19277108,0.12650603,-0.06626506
2009.0,PY,201,201,15,18,-3,0.08955224,0.07462686,-0.014925373
2010.0,PY,215,215,22,35,-13,0.1627907,0.10232558,-0.060465116
2011.0,PY,232,232,29,26,3,0.112068966,0.125,0.012931035
2012.0,PY,275,275,30,39,-9,0.14181818,0.10909091,-0.03272727
2013.0,PY,398,398,39,19,20,0.047738694,0.09798995,0.050251257
2014.0,PY,567,567,70,24,46,0.04232804,0.12345679,0.081128746
2015.0,PY,694,694,91,56,35,0.08069164,0.13112392,0.050432276
2016.0,PY,822,822,114,68,46,0.08272506,0.13868614,0.05596107
2017.0,PY,952,952,126,77,49,0.080882356,0.13235295,0.05147059
2018.0,PY,1098,1098,171,74,97,0.06739526,0.1557377,0.08834244
2019.0,PY,1158,1158,167,119,48,0.102763385,0.14421417,0.041450776
2020.0,PY,1122,1122,141,131,10,0.11675579,0.12566845,0.0089126555
2021.0,PY,1045,1045,98,88,10,0.08421053,0.09377991,0.009569378
2022.0,PY,0,0,57,45,12,,,
1996.0,QA,135,135,0,0,0,0.0,0.0,0.0
1997.0,QA,167,167,16,17,-1,0.1017964,0.09580839,-0.005988024
1998.0,QA,229,229,26,14,12,0.06113537,0.11353712,0.052401748
1999.0,QA,242,242,15,25,-10,0.10330579,0.06198347,-0.041322313
2000.0,QA,302,302,34,24,10,0.0794702,0.11258278,0.03311258
2001.0,QA,351,351,25,21,4,0.05982906,0.07122507,0.011396011
2002.0,QA,398,398,27,27,0,0.0678392,0.0678392,0.0
2003.0,QA,467,467,31,20,11,0.042826552,0.06638116,0.023554605
2004.0,QA,557,557,55,37,18,0.06642729,0.09874327,0.032315977
2005.0,QA,624,624,55,54,1,0.086538464,0.088141024,0.0016025641
2006.0,QA,714,714,64,59,5,0.082633056,0.08963586,0.007002801
2007.0,QA,854,854,95,56,39,0.06557377,0.11124122,0.045667447
2008.0,QA,1054,1054,118,88,30,0.08349146,0.11195446,0.028462999
2009.0,QA,1307,1307,158,85,73,0.06503443,0.120887525,0.0558531
2010.0,QA,1540,1540,204,89,115,0.05779221,0.13246754,0.07467532
2011.0,QA,1826,1826,229,119,110,0.06516977,0.12541074,0.060240965
2012.0,QA,2100,2100,231,196,35,0.093333334,0.11,0.016666668
2013.0,QA,2514,2514,302,137,165,0.054494828,0.12012729,0.065632455
2014.0,QA,2988,2988,379,196,183,0.065595716,0.1268407,0.06124498
2015.0,QA,3432,3432,481,250,231,0.07284382,0.14015152,0.067307696
2016.0,QA,3899,3899,495,293,202,0.07514747,0.12695563,0.051808156
2017.0,QA,4379,4379,509,409,100,0.09340032,0.11623658,0.022836264
2018.0,QA,4844,4844,506,443,63,0.09145334,0.10445912,0.01300578
2019.0,QA,5314,5314,669,453,216,0.08524652,0.12589386,0.040647347
2020.0,QA,5319,5319,622,497,125,0.09343862,0.11693928,0.023500659
2021.0,QA,5188,5188,479,396,83,0.07632999,0.09232845,0.015998458
2022.0,QA,0,0,275,341,-66,,,
1996.0,RE,78,78,0,0,0,0.0,0.0,0.0
1997.0,RE,97,97,4,2,2,0.020618556,0.041237112,0.020618556
1998.0,RE,116,116,5,2,3,0.01724138,0.04310345,0.02586207
1999.0,RE,117,117,9,8,1,0.06837607,0.07692308,0.008547009
2000.0,RE,139,139,10,5,5,0.035971224,0.07194245,0.035971224
2001.0,RE,135,135,6,10,-4,0.074074075,0.044444446,-0.02962963
2002.0,RE,144,144,5,11,-6,0.07638889,0.034722224,-0.041666668
2003.0,RE,181,181,18,3,15,0.016574586,0.09944751,0.08287293
2004.0,RE,199,199,18,10,8,0.050251257,0.09045226,0.040201005
2005.0,RE,189,189,13,27,-14,0.14285715,0.06878307,-0.074074075
2006.0,RE,204,204,20,27,-7,0.13235295,0.09803922,-0.034313727
2007.0,RE,232,232,27,17,10,0.073275864,0.11637931,0.04310345
2008.0,RE,237,237,25,26,-1,0.10970464,0.10548523,-0.004219409
2009.0,RE,265,265,26,23,3,0.086792454,0.09811321,0.011320755
2010.0,RE,328,328,57,20,37,0.06097561,0.17378049,0.112804875
2011.0,RE,397,397,57,32,25,0.08060453,0.14357683,0.06297229
2012.0,RE,433,433,47,33,14,0.07621247,0.108545035,0.032332562
2013.0,RE,450,450,56,53,3,0.11777778,0.12444445,0.006666667
2014.0,RE,434,434,48,73,-25,0.16820276,0.11059908,-0.057603687
2015.0,RE,447,447,63,51,12,0.11409396,0.1409396,0.026845638
2016.0,RE,457,457,80,55,25,0.12035011,0.1750547,0.054704595
2017.0,RE,459,459,61,62,-1,0.13507625,0.1328976,-0.0021786492
2018.0,RE,462,462,68,71,-3,0.15367965,0.14718615,-0.0064935065
2019.0,RE,484,484,69,51,18,0.1053719,0.14256199,0.037190083
2020.0,RE,487,487,93,64,29,0.13141684,0.19096509,0.059548255
2021.0,RE,474,474,61,41,20,0.08649789,0.12869199,0.042194095
1996.0,RO,2498,2498,0,0,0,0.0,0.0,0.0
1997.0,RO,3022,3022,100,84,16,0.027796162,0.03309067,0.005294507
1998.0,RO,3503,3503,101,142,-41,0.040536683,0.02883243,-0.011704253
1999.0,RO,3659,3659,103,178,-75,0.048647173,0.028149767,-0.020497404
2000.0,RO,3909,3909,128,197,-69,0.05039652,0.032744948,-0.017651573
2001.0,RO,4172,4172,122,257,-135,0.06160115,0.02924257,-0.03235858
2002.0,RO,4517,4517,102,218,-116,0.04826212,0.02258136,-0.025680762
2003.0,RO,4903,4903,124,221,-97,0.045074444,0.025290638,-0.019783806
2004.0,RO,5592,5592,142,217,-75,0.038805436,0.025393419,-0.013412017
2005.0,RO,6774,6774,203,223,-20,0.032919988,0.029967522,-0.0029524653
2006.0,RO,8272,8272,203,227,-24,0.027441973,0.024540618,-0.0029013539
2007.0,RO,9787,9787,265,236,29,0.02411362,0.027076734,0.0029631143
2008.0,RO,11505,11505,339,264,75,0.022946546,0.02946545,0.006518905
2009.0,RO,13018,13018,368,338,30,0.02596405,0.028268551,0.0023045014
2010.0,RO,14897,14897,464,324,140,0.021749346,0.03114721,0.009397865
2011.0,RO,17064,17064,423,382,41,0.02238631,0.02478903,0.002402719
2012.0,RO,19236,19236,465,372,93,0.01933874,0.024173426,0.004834685
2013.0,RO,20964,20964,536,410,126,0.019557336,0.02556764,0.0060103033
2014.0,RO,22266,22266,541,474,67,0.021288063,0.024297135,0.003009072
2015.0,RO,23352,23352,530,509,21,0.021796849,0.022696128,0.0008992806
2016.0,RO,23862,23862,517,546,-29,0.02288157,0.021666247,-0.0012153215
2017.0,RO,24429,24429,618,554,64,0.022677965,0.025297802,0.0026198372
2018.0,RO,24820,24820,566,528,38,0.021273166,0.02280419,0.0015310234
2019.0,RO,25365,25365,656,552,104,0.02176227,0.025862409,0.004100138
2020.0,RO,24742,24742,604,503,101,0.020329803,0.024411932,0.0040821275
2021.0,RO,23209,23209,433,397,36,0.017105434,0.018656556,0.0015511224
2022.0,RO,0,0,369,237,132,,,
1996.0,RS,1789,1789,0,0,0,0.0,0.0,0.0
1997.0,RS,2185,2185,42,49,-7,0.02242563,0.019221967,-0.0032036614
1998.0,RS,2578,2578,82,85,-3,0.032971296,0.0318076,-0.0011636928
1999.0,RS,2703,2703,84,103,-19,0.03810581,0.031076582,-0.007029227
2000.0,RS,3389,3389,104,104,0,0.030687518,0.030687518,0.0
2001.0,RS,4088,4088,137,131,6,0.03204501,0.03351272,0.0014677104
2002.0,RS,4772,4772,143,138,5,0.028918693,0.029966472,0.0010477788
2003.0,RS,5478,5478,219,214,5,0.039065354,0.039978094,0.0009127419
2004.0,RS,6204,6204,242,250,-8,0.040296584,0.039007094,-0.0012894906
2005.0,RS,6917,6917,306,296,10,0.042793117,0.04423883,0.0014457135
2006.0,RS,7636,7636,340,310,30,0.04059717,0.04452593,0.0039287587
2007.0,RS,8437,8437,369,317,52,0.037572596,0.043735925,0.0061633284
2008.0,RS,9359,9359,456,363,93,0.038786195,0.048723154,0.0099369595
2009.0,RS,10401,10401,450,419,31,0.04028459,0.04326507,0.0029804825
2010.0,RS,11650,11650,519,386,133,0.03313305,0.044549357,0.011416309
2011.0,RS,12881,12881,575,409,166,0.03175219,0.04463939,0.0128871985
2012.0,RS,13887,13887,605,450,155,0.032404408,0.043565925,0.011161518
2013.0,RS,14529,14529,559,498,61,0.034276277,0.038474776,0.0041984995
2014.0,RS,15178,15178,581,529,52,0.03485308,0.038279086,0.0034260114
2015.0,RS,15638,15638,586,587,-1,0.03753677,0.03747282,-6.39468e-05
2016.0,RS,15496,15496,510,641,-131,0.041365515,0.032911718,-0.008453795
2017.0,RS,15329,15329,511,698,-187,0.045534607,0.033335507,-0.0121991
2018.0,RS,15239,15239,543,711,-168,0.046656605,0.03563226,-0.011024346
2019.0,RS,15036,15036,582,616,-34,0.040968344,0.038707104,-0.0022612398
2020.0,RS,14321,14321,516,547,-31,0.03819566,0.036031004,-0.0021646533
2021.0,RS,13422,13422,401,391,10,0.029131277,0.029876322,0.0007450454
2022.0,RS,0,0,233,299,-66,,,
1996.0,RU,33257,33257,0,0,0,0.0,0.0,0.0
1997.0,RU,39937,39937,524,649,-125,0.016250595,0.013120665,-0.0031299295
1998.0,RU,49429,49429,703,865,-162,0.017499847,0.01422242,-0.0032774282
1999.0,RU,55821,55821,687,999,-312,0.01789649,0.012307196,-0.0055892942
2000.0,RU,60711,60711,831,1041,-210,0.01714681,0.0136878,-0.0034590107
2001.0,RU,64633,64633,810,1226,-416,0.018968638,0.0125322975,-0.0064363405
2002.0,RU,68011,68011,903,1313,-410,0.0193057,0.013277264,-0.0060284366
2003.0,RU,70069,70069,903,1364,-461,0.019466525,0.012887297,-0.006579229
2004.0,RU,74250,74250,1023,1341,-318,0.018060606,0.013777778,-0.0042828284
2005.0,RU,78941,78941,1109,1371,-262,0.0173674,0.014048466,-0.0033189345
2006.0,RU,80600,80600,1167,1397,-230,0.017332505,0.014478908,-0.002853598
2007.0,RU,82388,82388,1125,1457,-332,0.017684614,0.013654902,-0.004029713
2008.0,RU,84361,84361,1175,1974,-799,0.023399439,0.013928237,-0.009471201
2009.0,RU,85939,85939,1345,1789,-444,0.020817092,0.015650636,-0.005166455
2010.0,RU,85935,85935,1511,1590,-79,0.018502356,0.017583057,-0.0009192995
2011.0,RU,91671,91671,1592,1622,-30,0.01769371,0.017366452,-0.00032725726
2012.0,RU,99570,99570,1735,1779,-44,0.017866828,0.017424928,-0.00044190016
2013.0,RU,111655,111655,2038,1819,219,0.016291255,0.018252654,0.0019613989
2014.0,RU,126029,126029,2334,1886,448,0.01496481,0.018519547,0.0035547374
2015.0,RU,141591,141591,2606,1913,693,0.013510746,0.018405125,0.004894379
2016.0,RU,157968,157968,2967,2224,743,0.014078801,0.018782284,0.0047034845
2017.0,RU,176297,176297,3299,2366,933,0.013420534,0.01871274,0.0052922056
2018.0,RU,191867,191867,3479,2718,761,0.014166063,0.018132351,0.003966289
2019.0,RU,197667,197667,3788,3139,649,0.015880244,0.019163543,0.0032832997
2020.0,RU,191786,191786,3353,3123,230,0.016283775,0.017483028,0.0011992534
2021.0,RU,179190,179190,2463,2805,-342,0.015653776,0.013745187,-0.0019085887
2022.0,RU,0,0,1372,2275,-903,,,
1996.0,RW,20,20,0,0,0,0.0,0.0,0.0
1997.0,RW,20,20,2,3,-1,0.15,0.1,-0.05
1998.0,RW,19,19,0,2,-2,0.10526316,0.0,-0.10526316
1999.0,RW,13,13,2,3,-1,0.23076923,0.15384616,-0.07692308
2000.0,RW,12,12,1,3,-2,0.25,0.083333336,-0.16666667
2001.0,RW,13,13,1,1,0,0.07692308,0.07692308,0.0
2002.0,RW,21,21,1,0,1,0.0,0.04761905,0.04761905
2003.0,RW,29,29,1,3,-2,0.10344828,0.03448276,-0.06896552
2004.0,RW,42,42,1,1,0,0.023809524,0.023809524,0.0
2005.0,RW,54,54,4,2,2,0.037037037,0.074074075,0.037037037
2006.0,RW,90,90,9,3,6,0.033333335,0.1,0.06666667
2007.0,RW,112,112,7,6,1,0.05357143,0.0625,0.008928572
2008.0,RW,154,154,19,5,14,0.032467533,0.12337662,0.09090909
2009.0,RW,207,207,27,16,11,0.077294685,0.13043478,0.053140096
2010.0,RW,268,268,23,27,-4,0.10074627,0.0858209,-0.014925373
2011.0,RW,317,317,28,33,-5,0.10410095,0.08832808,-0.01577287
2012.0,RW,418,418,38,21,17,0.050239235,0.09090909,0.040669855
2013.0,RW,477,477,38,35,3,0.07337526,0.07966457,0.006289308
2014.0,RW,538,538,41,33,8,0.06133829,0.07620818,0.014869888
2015.0,RW,637,637,52,32,20,0.05023548,0.08163265,0.031397175
2016.0,RW,703,703,40,70,-30,0.099573255,0.056899004,-0.042674255
2017.0,RW,777,777,59,56,3,0.072072074,0.07593308,0.0038610038
2018.0,RW,915,915,75,43,32,0.046994537,0.08196721,0.03497268
2019.0,RW,1011,1011,97,65,32,0.06429278,0.095944606,0.03165183
2020.0,RW,1016,1016,99,69,30,0.06791338,0.09744094,0.02952756
2021.0,RW,955,955,68,63,5,0.06596859,0.071204185,0.005235602
2022.0,RW,0,0,38,42,-4,,,
1996.0,SA,2837,2837,0,0,0,0.0,0.0,0.0
1997.0,SA,3331,3331,89,85,4,0.025517862,0.026718702,0.0012008406
1998.0,SA,3794,3794,126,101,25,0.02662098,0.033210333,0.0065893517
1999.0,SA,3777,3777,109,106,3,0.028064601,0.028858883,0.0007942812
2000.0,SA,3812,3812,120,141,-21,0.036988456,0.031479537,-0.0055089192
2001.0,SA,3885,3885,165,153,12,0.039382238,0.042471044,0.003088803
2002.0,SA,4045,4045,167,145,22,0.035846725,0.041285537,0.0054388135
2003.0,SA,4113,4113,174,155,19,0.037685387,0.04230489,0.004619499
2004.0,SA,4358,4358,215,170,45,0.039008718,0.049334556,0.010325838
2005.0,SA,4560,4560,223,225,-2,0.049342107,0.04890351,-0.0004385965
2006.0,SA,4881,4881,241,219,22,0.044867855,0.049375128,0.004507273
2007.0,SA,5491,5491,329,257,72,0.04680386,0.059916228,0.013112365
2008.0,SA,6302,6302,435,289,146,0.045858458,0.0690257,0.023167249
2009.0,SA,7652,7652,589,323,266,0.042211186,0.07697334,0.034762155
2010.0,SA,9279,9279,788,378,410,0.04073715,0.08492295,0.044185795
2011.0,SA,11550,11550,1081,407,674,0.035238095,0.093593076,0.058354978
2012.0,SA,14031,14031,1208,615,593,0.043831516,0.08609507,0.04226356
2013.0,SA,16804,16804,1450,740,710,0.044037133,0.08628898,0.042251844
2014.0,SA,19313,19313,1591,991,600,0.05131259,0.08237974,0.031067157
2015.0,SA,22427,22427,1775,1157,618,0.0515896,0.07914567,0.027556071
2016.0,SA,25202,25202,1883,1422,461,0.056424093,0.07471629,0.0182922
2017.0,SA,27758,27758,2151,1620,531,0.058361553,0.07749117,0.01912962
2018.0,SA,31031,31031,2343,1799,544,0.057974283,0.07550514,0.017530857
2019.0,SA,33443,33443,2636,2041,595,0.061029214,0.07882068,0.017791467
2020.0,SA,33681,33681,2546,1832,714,0.054392684,0.07559158,0.021198895
2021.0,SA,32353,32353,1899,1538,361,0.047538094,0.058696255,0.011158162
2022.0,SA,0,0,1350,1169,181,,,
2023.0,SA,0,0,131,109,22,,,
1996.0,SC,7,7,0,0,0,0.0,0.0,0.0
1998.0,SC,7,7,0,0,0,0.0,0.0,0.0
2002.0,SC,17,17,2,1,1,0.05882353,0.11764706,0.05882353
2003.0,SC,19,19,1,0,1,0.0,0.05263158,0.05263158
2004.0,SC,20,20,0,2,-2,0.1,0.0,-0.1
2005.0,SC,23,23,0,1,-1,0.04347826,0.0,-0.04347826
2006.0,SC,22,22,2,2,0,0.09090909,0.09090909,0.0
2007.0,SC,18,18,0,1,-1,0.055555556,0.0,-0.055555556
2010.0,SC,21,21,1,3,-2,0.14285715,0.04761905,-0.0952381
2011.0,SC,24,24,1,4,-3,0.16666667,0.041666668,-0.125
2012.0,SC,22,22,1,3,-2,0.13636364,0.045454547,-0.09090909
2013.0,SC,25,25,5,2,3,0.08,0.2,0.12
2015.0,SC,29,29,5,3,2,0.10344828,0.1724138,0.06896552
2016.0,SC,25,25,3,4,-1,0.16,0.12,-0.04
2019.0,SC,40,40,6,5,1,0.125,0.15,0.025
2020.0,SC,39,39,4,3,1,0.07692308,0.102564104,0.025641026
2021.0,SC,41,41,5,1,4,0.024390243,0.12195122,0.09756097
1996.0,SD,189,189,0,0,0,0.0,0.0,0.0
1997.0,SD,232,232,8,14,-6,0.060344826,0.03448276,-0.02586207
1998.0,SD,260,260,8,13,-5,0.05,0.03076923,-0.01923077
1999.0,SD,248,248,4,21,-17,0.08467742,0.016129032,-0.06854839
2000.0,SD,281,281,26,10,16,0.035587188,0.09252669,0.0569395
2001.0,SD,280,280,15,16,-1,0.057142857,0.05357143,-0.0035714286
2002.0,SD,307,307,25,24,1,0.078175895,0.08143322,0.0032573289
2003.0,SD,365,365,22,33,-11,0.090410955,0.06027397,-0.030136986
2004.0,SD,385,385,19,26,-7,0.067532465,0.04935065,-0.018181818
2005.0,SD,478,478,41,20,21,0.041841004,0.08577406,0.043933053
2006.0,SD,562,562,34,28,6,0.049822062,0.06049822,0.010676157
2007.0,SD,620,620,31,49,-18,0.07903226,0.05,-0.029032258
2008.0,SD,667,667,41,41,0,0.061469264,0.061469264,0.0
2009.0,SD,779,779,40,50,-10,0.06418485,0.05134788,-0.01283697
2010.0,SD,846,846,46,43,3,0.050827425,0.05437352,0.0035460992
2011.0,SD,964,964,65,61,4,0.06327801,0.06742739,0.004149378
2012.0,SD,1148,1148,92,76,16,0.06620209,0.080139376,0.013937282
2013.0,SD,1260,1260,95,106,-11,0.08412699,0.07539683,-0.008730159
2014.0,SD,1377,1377,97,125,-28,0.090777054,0.07044299,-0.02033406
2015.0,SD,1512,1512,123,115,8,0.0760582,0.08134921,0.005291005
2016.0,SD,1541,1541,122,159,-37,0.10317975,0.07916937,-0.024010383
2017.0,SD,1608,1608,136,174,-38,0.108208954,0.08457711,-0.023631841
2018.0,SD,1696,1696,154,196,-42,0.11556604,0.09080189,-0.02476415
2019.0,SD,1728,1728,186,243,-57,0.140625,0.10763889,-0.032986112
2020.0,SD,1628,1628,172,219,-47,0.13452089,0.1056511,-0.02886978
2021.0,SD,1490,1490,143,172,-29,0.11543624,0.09597316,-0.019463087
2022.0,SD,0,0,109,122,-13,,,
1996.0,SE,22336,22336,0,0,0,0.0,0.0,0.0
1997.0,SE,25692,25692,613,684,-71,0.026623074,0.023859568,-0.0027635063
1998.0,SE,28789,28789,858,864,-6,0.030011462,0.02980305,-0.00020841294
1999.0,SE,30086,30086,948,894,54,0.029714817,0.03150967,0.0017948548
2000.0,SE,31436,31436,1088,957,131,0.030442804,0.03461,0.004167197
2001.0,SE,32844,32844,1077,1126,-49,0.03428328,0.032791376,-0.0014919011
2002.0,SE,34222,34222,1116,1202,-86,0.035123605,0.032610603,-0.0025130033
2003.0,SE,35890,35890,1234,1305,-71,0.036361102,0.034382835,-0.001978267
2004.0,SE,37548,37548,1270,1334,-64,0.03552786,0.03382337,-0.0017044849
2005.0,SE,39275,39275,1346,1461,-115,0.037199236,0.034271166,-0.0029280712
2006.0,SE,40862,40862,1343,1589,-246,0.038886987,0.032866724,-0.0060202633
2007.0,SE,44281,44281,1657,1707,-50,0.038549267,0.037420113,-0.0011291525
2008.0,SE,45694,45694,1761,1773,-12,0.03880159,0.038538978,-0.00026261652
2009.0,SE,47240,47240,1786,1801,-15,0.038124472,0.037806943,-0.0003175275
2010.0,SE,48760,48760,1850,2004,-154,0.04109926,0.037940934,-0.0031583265
2011.0,SE,50750,50750,2111,1878,233,0.037004925,0.04159606,0.004591133
2012.0,SE,50783,50783,2153,1915,238,0.03770947,0.042396076,0.0046866075
2013.0,SE,52659,52659,2345,2109,236,0.040050134,0.0445318,0.004481665
2014.0,SE,54434,54434,2447,2249,198,0.04131609,0.04495352,0.0036374326
2015.0,SE,56015,56015,2707,2342,365,0.04181023,0.04832634,0.0065161115
2016.0,SE,57253,57253,2803,2465,338,0.043054514,0.048958134,0.0059036207
2017.0,SE,58152,58152,2904,2592,312,0.044572845,0.049938094,0.0053652497
2018.0,SE,58900,58900,3037,2704,333,0.04590832,0.05156197,0.00565365
2019.0,SE,58801,58801,3126,2841,285,0.048315506,0.053162362,0.0048468565
2020.0,SE,56648,56648,2994,2620,374,0.04625053,0.052852705,0.0066021746
2021.0,SE,52971,52971,2270,2058,212,0.038851447,0.04285364,0.0040021897
2022.0,SE,0,0,1549,1477,72,,,
1996.0,SG,3453,3453,0,0,0,0.0,0.0,0.0
1997.0,SG,4306,4306,181,154,27,0.03576405,0.04203437,0.0062703206
1998.0,SG,5271,5271,301,216,85,0.040978942,0.057104915,0.016125971
1999.0,SG,5938,5938,421,252,169,0.042438533,0.07089929,0.028460762
2000.0,SG,6622,6622,431,330,101,0.049833886,0.065086074,0.01525219
2001.0,SG,7318,7318,475,451,24,0.06162886,0.064908445,0.0032795847
2002.0,SG,8305,8305,594,515,79,0.062010836,0.07152318,0.009512342
2003.0,SG,9165,9165,642,515,127,0.056192037,0.0700491,0.013857065
2004.0,SG,9925,9925,725,722,3,0.07274559,0.07304786,0.000302267
2005.0,SG,10611,10611,783,783,0,0.07379135,0.07379135,0.0
2006.0,SG,11400,11400,844,925,-81,0.081140354,0.074035086,-0.007105263
2007.0,SG,12053,12053,871,1061,-190,0.08802788,0.072264165,-0.015763711
2008.0,SG,12925,12925,1052,1061,-9,0.08208898,0.08139265,-0.000696325
2009.0,SG,14168,14168,1263,1107,156,0.07813382,0.08914455,0.011010729
2010.0,SG,15643,15643,1416,1203,213,0.07690341,0.09051972,0.013616314
2011.0,SG,16855,16855,1428,1433,-5,0.08501928,0.08472263,-0.0002966479
2012.0,SG,18403,18403,1643,1414,229,0.0768353,0.08927892,0.0124436235
2013.0,SG,19623,19623,1679,1663,16,0.08474749,0.08556286,0.0008153697
2014.0,SG,20963,20963,1877,1795,82,0.08562706,0.08953871,0.003911654
2015.0,SG,22145,22145,1980,1912,68,0.08634003,0.0894107,0.0030706706
2016.0,SG,22903,22903,2048,2110,-62,0.092127666,0.0894206,-0.002707069
2017.0,SG,23601,23601,2203,2231,-28,0.09452989,0.093343504,-0.0011863904
2018.0,SG,24147,24147,2227,2397,-170,0.09926699,0.09222678,-0.007040212
2019.0,SG,24244,24244,2354,2526,-172,0.10419073,0.09709619,-0.007094539
2020.0,SG,23299,23299,2196,2343,-147,0.10056226,0.094252974,-0.0063092834
2021.0,SG,21522,21522,1717,1888,-171,0.08772419,0.07977883,-0.007945358
2022.0,SG,0,0,1158,1397,-239,,,
1996.0,SI,1872,1872,0,0,0,0.0,0.0,0.0
1997.0,SI,2319,2319,38,26,12,0.01121173,0.016386373,0.0051746443
1998.0,SI,2771,2771,47,43,4,0.015517863,0.016961386,0.0014435222
1999.0,SI,3102,3102,55,41,14,0.013217279,0.017730497,0.004513217
2000.0,SI,3418,3418,50,56,-6,0.016383851,0.014628437,-0.0017554126
2001.0,SI,3817,3817,48,55,-7,0.014409222,0.012575321,-0.0018339009
2002.0,SI,4169,4169,71,74,-3,0.01775006,0.017030463,-0.00071959704
2003.0,SI,4613,4613,68,76,-8,0.016475178,0.0147409495,-0.0017342294
2004.0,SI,4954,4954,93,82,11,0.01655228,0.018772708,0.0022204279
2005.0,SI,5391,5391,99,109,-10,0.020218883,0.01836394,-0.0018549435
2006.0,SI,5827,5827,112,93,19,0.015960185,0.019220868,0.003260683
2007.0,SI,6190,6190,120,128,-8,0.020678515,0.019386107,-0.0012924072
2008.0,SI,6582,6582,131,125,6,0.018991187,0.019902766,0.000911577
2009.0,SI,7012,7012,146,156,-10,0.022247575,0.020821448,-0.0014261267
2010.0,SI,7438,7438,173,144,29,0.019360043,0.023258941,0.0038988974
2011.0,SI,7958,7958,179,183,-4,0.022995727,0.022493089,-0.00050263887
2012.0,SI,8432,8432,230,198,32,0.023481973,0.02727704,0.0037950664
2013.0,SI,8879,8879,223,231,-8,0.026016444,0.025115442,-0.0009010024
2014.0,SI,9264,9264,242,255,-13,0.027525907,0.026122626,-0.0014032815
2015.0,SI,9582,9582,240,314,-74,0.032769777,0.025046963,-0.0077228136
2016.0,SI,9626,9626,239,311,-72,0.032308333,0.024828589,-0.007479742
2017.0,SI,9668,9668,244,333,-89,0.034443524,0.025237897,-0.009205627
2018.0,SI,9636,9636,270,342,-72,0.035491906,0.028019926,-0.00747198
2019.0,SI,9617,9617,328,315,13,0.032754496,0.03410627,0.0013517729
2020.0,SI,9255,9255,304,275,29,0.029713668,0.03284711,0.0031334413
2021.0,SI,8656,8656,223,222,1,0.02564695,0.025762476,0.000115526804
2022.0,SI,0,0,164,139,25,,,
1996.0,SJ,8,8,0,0,0,0.0,0.0,0.0
1997.0,SJ,10,10,2,0,2,0.0,0.2,0.2
1998.0,SJ,12,12,3,3,0,0.25,0.25,0.0
2000.0,SJ,17,17,3,1,2,0.05882353,0.1764706,0.11764706
2001.0,SJ,14,14,1,2,-1,0.14285715,0.071428575,-0.071428575
2002.0,SJ,16,16,4,3,1,0.1875,0.25,0.0625
2004.0,SJ,27,27,7,1,6,0.037037037,0.25925925,0.22222222
2005.0,SJ,28,28,1,3,-2,0.10714286,0.035714287,-0.071428575
2006.0,SJ,29,29,5,5,0,0.1724138,0.1724138,0.0
2007.0,SJ,30,30,4,1,3,0.033333335,0.13333334,0.1
2008.0,SJ,38,38,11,4,7,0.10526316,0.28947368,0.18421052
2010.0,SJ,54,54,11,8,3,0.14814815,0.2037037,0.055555556
2011.0,SJ,55,55,7,4,3,0.07272727,0.12727273,0.054545455
2012.0,SJ,63,63,10,10,0,0.15873016,0.15873016,0.0
2013.0,SJ,63,63,8,19,-11,0.3015873,0.12698413,-0.17460318
2014.0,SJ,68,68,10,7,3,0.10294118,0.14705883,0.04411765
2015.0,SJ,74,74,16,16,0,0.21621622,0.21621622,0.0
2016.0,SJ,74,74,13,15,-2,0.2027027,0.17567568,-0.027027028
2017.0,SJ,80,80,18,15,3,0.1875,0.225,0.0375
2018.0,SJ,83,83,11,9,2,0.10843374,0.13253012,0.024096385
2019.0,SJ,78,78,15,19,-4,0.24358974,0.1923077,-0.051282052
2020.0,SJ,70,70,13,16,-3,0.22857143,0.18571429,-0.042857144
2021.0,SJ,74,74,12,4,8,0.054054055,0.16216215,0.10810811
2022.0,SJ,0,0,3,7,-4,,,
1996.0,SK,2980,2980,0,0,0,0.0,0.0,0.0
1997.0,SK,3522,3522,132,78,54,0.022146508,0.037478704,0.015332198
1998.0,SK,4028,4028,130,139,-9,0.03450844,0.032274082,-0.0022343595
1999.0,SK,4143,4143,140,165,-25,0.039826214,0.033791937,-0.0060342746
2000.0,SK,4266,4266,138,148,-10,0.03469292,0.032348804,-0.0023441163
2001.0,SK,4416,4416,162,217,-55,0.049139492,0.03668478,-0.01245471
2002.0,SK,4605,4605,162,221,-59,0.047991313,0.035179153,-0.012812161
2003.0,SK,4726,4726,158,228,-70,0.048243757,0.033432078,-0.01481168
2004.0,SK,5102,5102,213,248,-35,0.04860839,0.041748334,-0.006860055
2005.0,SK,5516,5516,204,262,-58,0.04749819,0.036983322,-0.010514866
2006.0,SK,5941,5941,238,273,-35,0.04595186,0.040060595,-0.005891264
2007.0,SK,6361,6361,238,287,-49,0.045118693,0.0374155,-0.007703191
2008.0,SK,6919,6919,274,312,-38,0.04509322,0.0396011,-0.0054921233
2009.0,SK,7517,7517,248,294,-46,0.039111346,0.032991886,-0.0061194627
2010.0,SK,8281,8281,293,284,9,0.034295376,0.0353822,0.0010868253
2011.0,SK,9246,9246,282,365,-83,0.03947653,0.030499676,-0.008976855
2012.0,SK,10271,10271,309,334,-25,0.03251874,0.030084705,-0.0024340376
2013.0,SK,10950,10950,336,377,-41,0.034429222,0.030684931,-0.0037442923
2014.0,SK,11671,11671,353,379,-26,0.032473654,0.03024591,-0.002227744
2015.0,SK,12333,12333,366,413,-47,0.03348739,0.029676478,-0.0038109138
2016.0,SK,12778,12778,342,416,-74,0.032555956,0.026764752,-0.0057912036
2017.0,SK,13047,13047,407,392,15,0.03004522,0.03119491,0.0011496895
2018.0,SK,13238,13238,413,392,21,0.029611723,0.031198066,0.0015863423
2019.0,SK,13135,13135,435,504,-69,0.038370766,0.033117626,-0.0052531403
2020.0,SK,12404,12404,386,410,-24,0.033053853,0.031118995,-0.0019348597
2021.0,SK,11362,11362,264,316,-52,0.027812004,0.023235345,-0.004576659
2022.0,SK,0,0,192,215,-23,,,
1996.0,SL,13,13,0,0,0,0.0,0.0,0.0
1997.0,SL,17,17,0,0,0,0.0,0.0,0.0
1998.0,SL,18,18,1,3,-2,0.16666667,0.055555556,-0.11111111
1999.0,SL,18,18,1,1,0,0.055555556,0.055555556,0.0
2000.0,SL,17,17,0,1,-1,0.05882353,0.0,-0.05882353
2001.0,SL,14,14,0,3,-3,0.21428572,0.0,-0.21428572
2007.0,SL,18,18,1,1,0,0.055555556,0.055555556,0.0
2008.0,SL,30,30,3,1,2,0.033333335,0.1,0.06666667
2009.0,SL,35,35,1,0,1,0.0,0.028571429,0.028571429
2010.0,SL,35,35,3,1,2,0.028571429,0.08571429,0.057142857
2011.0,SL,46,46,3,0,3,0.0,0.06521739,0.06521739
2012.0,SL,48,48,1,6,-5,0.125,0.020833334,-0.104166664
2013.0,SL,63,63,4,2,2,0.031746034,0.06349207,0.031746034
2014.0,SL,82,82,7,6,1,0.07317073,0.085365854,0.0121951215
2015.0,SL,109,109,12,5,7,0.04587156,0.110091746,0.06422018
2016.0,SL,122,122,9,10,-1,0.08196721,0.07377049,-0.008196721
2017.0,SL,141,141,13,10,3,0.07092199,0.09219858,0.021276595
2018.0,SL,151,151,10,10,0,0.06622516,0.06622516,0.0
2019.0,SL,163,163,21,15,6,0.09202454,0.12883435,0.036809817
2020.0,SL,161,161,14,11,3,0.06832298,0.08695652,0.01863354
2021.0,SL,144,144,9,15,-6,0.104166664,0.0625,-0.041666668
1996.0,SM,1,1,0,0,0,0.0,0.0,0.0
2000.0,SM,4,4,1,1,0,0.25,0.25,0.0
2008.0,SM,7,7,0,2,-2,0.2857143,0.0,-0.2857143
2009.0,SM,10,10,2,0,2,0.0,0.2,0.2
2010.0,SM,13,13,3,1,2,0.07692308,0.23076923,0.15384616
2011.0,SM,16,16,3,2,1,0.125,0.1875,0.0625
2012.0,SM,16,16,2,1,1,0.0625,0.125,0.0625
2013.0,SM,21,21,6,1,5,0.04761905,0.2857143,0.23809524
2015.0,SM,27,27,8,1,7,0.037037037,0.2962963,0.25925925
2017.0,SM,26,26,3,1,2,0.03846154,0.115384616,0.07692308
2019.0,SM,25,25,9,4,5,0.16,0.36,0.2
2020.0,SM,25,25,4,3,1,0.12,0.16,0.04
1996.0,SN,267,267,0,0,0,0.0,0.0,0.0
1997.0,SN,322,322,9,14,-5,0.04347826,0.027950311,-0.015527951
1998.0,SN,375,375,17,26,-9,0.06933333,0.045333333,-0.024
1999.0,SN,411,411,29,18,11,0.04379562,0.07055961,0.02676399
2000.0,SN,440,440,20,24,-4,0.054545455,0.045454547,-0.009090909
2001.0,SN,499,499,27,35,-8,0.07014028,0.054108217,-0.016032064
2002.0,SN,564,564,34,22,12,0.039007094,0.060283687,0.021276595
2003.0,SN,613,613,36,32,4,0.052202284,0.05872757,0.0065252855
2004.0,SN,664,664,40,39,1,0.05873494,0.060240965,0.001506024
2005.0,SN,718,718,39,39,0,0.05431755,0.05431755,0.0
2006.0,SN,790,790,41,44,-3,0.055696204,0.051898733,-0.0037974683
2007.0,SN,861,861,52,43,9,0.049941927,0.06039489,0.010452962
2008.0,SN,920,920,40,40,0,0.04347826,0.04347826,0.0
2009.0,SN,1023,1023,43,55,-12,0.05376344,0.042033236,-0.011730205
2010.0,SN,1100,1100,53,61,-8,0.055454545,0.048181817,-0.0072727273
2011.0,SN,1254,1254,65,57,8,0.045454547,0.051834133,0.0063795852
2012.0,SN,1435,1435,84,66,18,0.04599303,0.058536585,0.012543554
2013.0,SN,1559,1559,85,79,6,0.050673507,0.05452213,0.003848621
2014.0,SN,1723,1723,88,82,6,0.04759141,0.051073708,0.0034822982
2015.0,SN,1843,1843,104,100,4,0.05425936,0.056429733,0.0021703744
2016.0,SN,1921,1921,98,96,2,0.049973972,0.051015098,0.0010411245
2017.0,SN,2006,2006,98,103,-5,0.051345963,0.04885344,-0.0024925224
2018.0,SN,2074,2074,115,123,-8,0.05930569,0.05544841,-0.0038572806
2019.0,SN,2087,2087,127,111,16,0.05318639,0.0608529,0.007666507
2020.0,SN,2006,2006,109,112,-3,0.0558325,0.054336987,-0.0014955135
2021.0,SN,1869,1869,94,86,8,0.04601391,0.050294276,0.0042803637
2022.0,SN,0,0,43,44,-1,,,
1996.0,SO,3,3,0,0,0,0.0,0.0,0.0
1998.0,SO,3,3,0,1,-1,0.33333334,0.0,-0.33333334
2006.0,SO,2,2,0,0,0,0.0,0.0,0.0
2010.0,SO,3,3,0,0,0,0.0,0.0,0.0
2011.0,SO,9,9,3,1,2,0.11111111,0.33333334,0.22222222
2013.0,SO,17,17,0,3,-3,0.1764706,0.0,-0.1764706
2014.0,SO,17,17,0,2,-2,0.11764706,0.0,-0.11764706
2015.0,SO,26,26,6,2,4,0.07692308,0.23076923,0.15384616
2016.0,SO,31,31,7,3,4,0.09677419,0.22580644,0.12903225
2017.0,SO,38,38,6,3,3,0.078947365,0.15789473,0.078947365
2018.0,SO,41,41,5,5,0,0.12195122,0.12195122,0.0
2019.0,SO,52,52,9,3,6,0.057692308,0.17307693,0.115384616
2020.0,SO,56,56,16,8,8,0.14285715,0.2857143,0.14285715
2021.0,SO,58,58,8,3,5,0.05172414,0.13793103,0.0862069
1999.0,SR,4,4,0,0,0,0.0,0.0,0.0
2000.0,SR,8,8,0,0,0,0.0,0.0,0.0
2001.0,SR,9,9,0,0,0,0.0,0.0,0.0
2002.0,SR,18,18,2,0,2,0.0,0.11111111,0.11111111
2003.0,SR,17,17,0,0,0,0.0,0.0,0.0
2004.0,SR,17,17,0,1,-1,0.05882353,0.0,-0.05882353
2006.0,SR,19,19,0,0,0,0.0,0.0,0.0
2007.0,SR,18,18,0,1,-1,0.055555556,0.0,-0.055555556
2008.0,SR,21,21,1,0,1,0.0,0.04761905,0.04761905
2009.0,SR,20,20,0,0,0,0.0,0.0,0.0
2010.0,SR,27,27,2,0,2,0.0,0.074074075,0.074074075
2012.0,SR,44,44,2,1,1,0.022727273,0.045454547,0.022727273
2013.0,SR,55,55,1,0,1,0.0,0.018181818,0.018181818
2014.0,SR,71,71,7,1,6,0.014084507,0.09859155,0.08450704
2015.0,SR,78,78,4,3,1,0.03846154,0.051282052,0.012820513
2016.0,SR,80,80,2,1,1,0.0125,0.025,0.0125
2017.0,SR,90,90,6,2,4,0.022222223,0.06666667,0.044444446
2018.0,SR,106,106,8,5,3,0.047169812,0.0754717,0.028301887
2019.0,SR,109,109,8,4,4,0.036697246,0.07339449,0.036697246
2020.0,SR,105,105,7,5,2,0.04761905,0.06666667,0.01904762
2021.0,SR,97,97,3,6,-3,0.06185567,0.030927835,-0.030927835
2022.0,SR,0,0,2,3,-1,,,
1996.0,SS,30,30,0,0,0,0.0,0.0,0.0
1997.0,SS,28,28,3,9,-6,0.32142857,0.10714286,-0.21428572
1998.0,SS,28,28,8,9,-1,0.32142857,0.2857143,-0.035714287
1999.0,SS,29,29,6,5,1,0.1724138,0.20689656,0.03448276
2000.0,SS,35,35,9,6,3,0.17142858,0.25714287,0.08571429
2001.0,SS,36,36,10,8,2,0.22222222,0.2777778,0.055555556
2002.0,SS,34,34,3,11,-8,0.32352942,0.0882353,-0.23529412
2003.0,SS,44,44,12,9,3,0.20454545,0.27272728,0.06818182
2004.0,SS,53,53,11,9,2,0.16981132,0.20754717,0.03773585
2005.0,SS,54,54,11,13,-2,0.24074075,0.2037037,-0.037037037
2006.0,SS,69,69,19,13,6,0.1884058,0.2753623,0.08695652
2007.0,SS,67,67,8,17,-9,0.25373134,0.11940298,-0.13432837
2008.0,SS,69,69,17,16,1,0.23188406,0.24637681,0.014492754
2009.0,SS,62,62,12,22,-10,0.3548387,0.19354838,-0.16129032
2010.0,SS,57,57,9,17,-8,0.2982456,0.15789473,-0.14035088
2011.0,SS,58,58,15,13,2,0.22413793,0.25862068,0.03448276
2012.0,SS,54,54,11,13,-2,0.24074075,0.2037037,-0.037037037
2013.0,SS,51,51,11,18,-7,0.3529412,0.21568628,-0.13725491
2014.0,SS,48,48,10,14,-4,0.29166666,0.20833333,-0.083333336
2015.0,SS,56,56,13,13,0,0.23214285,0.23214285,0.0
2016.0,SS,66,66,17,10,7,0.15151516,0.25757575,0.10606061
2017.0,SS,68,68,15,12,3,0.1764706,0.22058824,0.04411765
2018.0,SS,62,62,15,22,-7,0.3548387,0.24193548,-0.11290322
2019.0,SS,57,57,10,20,-10,0.3508772,0.1754386,-0.1754386
2020.0,SS,60,60,14,9,5,0.15,0.23333333,0.083333336
2021.0,SS,54,54,7,8,-1,0.14814815,0.12962963,-0.018518519
2022.0,SS,0,0,9,5,4,,,
1996.0,ST,15,15,0,0,0,0.0,0.0,0.0
1997.0,ST,19,19,0,4,-4,0.21052632,0.0,-0.21052632
1998.0,ST,27,27,2,0,2,0.0,0.074074075,0.074074075
1999.0,ST,41,41,5,4,1,0.09756097,0.12195122,0.024390243
2000.0,ST,58,58,10,1,9,0.01724138,0.1724138,0.15517241
2001.0,ST,61,61,6,8,-2,0.13114753,0.09836066,-0.032786883
2002.0,ST,78,78,7,13,-6,0.16666667,0.08974359,-0.07692308
2003.0,ST,107,107,16,7,9,0.06542056,0.1495327,0.08411215
2004.0,ST,129,129,27,13,14,0.1007752,0.20930232,0.10852713
2005.0,ST,143,143,15,17,-2,0.11888112,0.10489511,-0.013986014
2006.0,ST,154,154,26,33,-7,0.21428572,0.16883117,-0.045454547
2007.0,ST,157,157,16,24,-8,0.15286624,0.10191083,-0.050955415
2008.0,ST,173,173,33,28,5,0.1618497,0.19075145,0.028901733
2009.0,ST,173,173,27,40,-13,0.23121387,0.15606937,-0.07514451
2010.0,ST,181,181,32,36,-4,0.19889502,0.17679559,-0.022099448
2011.0,ST,176,176,29,39,-10,0.2215909,0.16477273,-0.056818184
2012.0,ST,155,155,27,49,-22,0.31612903,0.17419355,-0.14193548
2013.0,ST,158,158,30,38,-8,0.24050634,0.18987341,-0.050632913
2014.0,ST,148,148,27,43,-16,0.29054055,0.18243243,-0.10810811
2015.0,ST,132,132,29,52,-23,0.3939394,0.21969697,-0.17424242
2016.0,ST,115,115,26,47,-21,0.40869564,0.22608696,-0.1826087
2017.0,ST,107,107,18,33,-15,0.3084112,0.1682243,-0.14018692
2018.0,ST,109,109,31,39,-8,0.35779816,0.28440368,-0.07339449
2019.0,ST,106,106,25,36,-11,0.33962265,0.23584905,-0.10377359
2020.0,ST,96,96,24,37,-13,0.38541666,0.25,-0.13541667
2021.0,ST,87,87,25,23,2,0.26436782,0.28735632,0.022988506
2022.0,ST,0,0,14,10,4,,,
1996.0,SV,39,39,0,0,0,0.0,0.0,0.0
1997.0,SV,48,48,0,1,-1,0.020833334,0.0,-0.020833334
1998.0,SV,62,62,1,2,-1,0.032258064,0.016129032,-0.016129032
1999.0,SV,82,82,6,0,6,0.0,0.07317073,0.07317073
2000.0,SV,98,98,9,4,5,0.040816326,0.091836736,0.05102041
2001.0,SV,106,106,3,9,-6,0.08490566,0.028301887,-0.056603774
2002.0,SV,109,109,4,10,-6,0.09174312,0.036697246,-0.055045873
2003.0,SV,110,110,10,11,-1,0.1,0.09090909,-0.009090909
2004.0,SV,114,114,8,17,-9,0.1491228,0.07017544,-0.078947365
2005.0,SV,122,122,5,7,-2,0.057377048,0.040983606,-0.016393442
2006.0,SV,127,127,10,6,4,0.047244094,0.07874016,0.031496063
2007.0,SV,138,138,8,14,-6,0.10144927,0.057971016,-0.04347826
2008.0,SV,139,139,10,16,-6,0.11510792,0.07194245,-0.043165468
2009.0,SV,133,133,8,11,-3,0.082706764,0.060150377,-0.02255639
2010.0,SV,150,150,14,14,0,0.093333334,0.093333334,0.0
2011.0,SV,159,159,15,18,-3,0.11320755,0.094339624,-0.018867925
2012.0,SV,173,173,17,16,1,0.09248555,0.098265894,0.0057803467
2013.0,SV,200,200,28,24,4,0.12,0.14,0.02
2014.0,SV,230,230,26,17,9,0.073913045,0.11304348,0.039130434
2015.0,SV,298,298,46,33,13,0.110738255,0.15436241,0.043624163
2016.0,SV,313,313,43,29,14,0.092651755,0.1373802,0.044728436
2017.0,SV,346,346,52,30,22,0.0867052,0.15028901,0.06358381
2018.0,SV,325,325,27,61,-34,0.18769231,0.083076924,-0.10461538
2019.0,SV,303,303,29,47,-18,0.15511551,0.09570957,-0.05940594
2020.0,SV,242,242,28,35,-7,0.1446281,0.11570248,-0.02892562
2021.0,SV,200,200,22,26,-4,0.13,0.11,-0.02
2005.0,SX,9,9,0,1,-1,0.11111111,0.0,-0.11111111
2006.0,SX,10,10,2,1,1,0.1,0.2,0.1
2007.0,SX,7,7,1,4,-3,0.5714286,0.14285715,-0.42857143
2011.0,SX,1,1,0,0,0,0.0,0.0,0.0
2014.0,SX,4,4,1,1,0,0.25,0.25,0.0
2018.0,SX,14,14,2,1,1,0.071428575,0.14285715,0.071428575
2019.0,SX,23,23,5,0,5,0.0,0.2173913,0.2173913
2020.0,SX,22,22,0,2,-2,0.09090909,0.0,-0.09090909
2021.0,SX,17,17,0,4,-4,0.23529412,0.0,-0.23529412
1996.0,SY,154,154,0,0,0,0.0,0.0,0.0
1997.0,SY,191,191,5,9,-4,0.04712042,0.02617801,-0.020942409
1998.0,SY,242,242,15,9,6,0.037190083,0.06198347,0.024793388
1999.0,SY,268,268,14,11,3,0.041044775,0.052238807,0.01119403
2000.0,SY,286,286,9,8,1,0.027972028,0.031468533,0.0034965035
2001.0,SY,315,315,20,16,4,0.05079365,0.06349207,0.012698413
2002.0,SY,340,340,9,21,-12,0.061764706,0.026470589,-0.03529412
2003.0,SY,378,378,20,18,2,0.04761905,0.052910052,0.005291005
2004.0,SY,435,435,26,14,12,0.032183908,0.059770115,0.027586207
2005.0,SY,480,480,30,31,-1,0.06458333,0.0625,-0.0020833334
2006.0,SY,521,521,32,35,-3,0.0671785,0.061420344,-0.0057581575
2007.0,SY,573,573,45,30,15,0.05235602,0.07853403,0.02617801
2008.0,SY,652,652,48,41,7,0.06288344,0.073619634,0.010736196
2009.0,SY,763,763,84,59,25,0.07732634,0.110091746,0.0327654
2010.0,SY,877,877,79,57,22,0.0649943,0.090079814,0.025085518
2011.0,SY,989,989,95,74,21,0.07482305,0.096056625,0.02123357
2012.0,SY,1106,1106,110,76,34,0.068716094,0.0994575,0.03074141
2013.0,SY,1157,1157,89,93,-4,0.08038029,0.07692308,-0.003457217
2014.0,SY,1216,1216,82,85,-3,0.06990132,0.067434214,-0.0024671052
2015.0,SY,1212,1212,71,74,-3,0.061056107,0.058580857,-0.0024752475
2016.0,SY,1240,1240,62,86,-24,0.06935484,0.05,-0.019354839
2017.0,SY,1294,1294,56,108,-52,0.083462134,0.04327666,-0.04018547
2018.0,SY,1348,1348,72,112,-40,0.08308605,0.053412464,-0.029673591
2019.0,SY,1439,1439,113,107,6,0.07435719,0.07852676,0.0041695624
2020.0,SY,1422,1422,97,101,-4,0.07102672,0.06821378,-0.0028129395
2021.0,SY,1334,1334,83,70,13,0.052473765,0.06221889,0.0097451275
2022.0,SY,0,0,59,69,-10,,,
1996.0,SZ,15,15,0,0,0,0.0,0.0,0.0
1997.0,SZ,21,21,2,1,1,0.04761905,0.0952381,0.04761905
1998.0,SZ,28,28,0,0,0,0.0,0.0,0.0
1999.0,SZ,32,32,3,0,3,0.0,0.09375,0.09375
2000.0,SZ,36,36,1,1,0,0.027777778,0.027777778,0.0
2001.0,SZ,38,38,2,2,0,0.05263158,0.05263158,0.0
2002.0,SZ,41,41,3,4,-1,0.09756097,0.07317073,-0.024390243
2003.0,SZ,39,39,2,0,2,0.0,0.051282052,0.051282052
2004.0,SZ,42,42,2,2,0,0.04761905,0.04761905,0.0
2005.0,SZ,40,40,1,2,-1,0.05,0.025,-0.025
2006.0,SZ,49,49,4,3,1,0.06122449,0.08163265,0.020408163
2007.0,SZ,49,49,2,2,0,0.040816326,0.040816326,0.0
2008.0,SZ,52,52,5,3,2,0.057692308,0.09615385,0.03846154
2009.0,SZ,65,65,7,2,5,0.03076923,0.10769231,0.07692308
2010.0,SZ,62,62,0,5,-5,0.08064516,0.0,-0.08064516
2011.0,SZ,71,71,4,3,1,0.04225352,0.056338027,0.014084507
2012.0,SZ,72,72,4,8,-4,0.11111111,0.055555556,-0.055555556
2013.0,SZ,70,70,5,5,0,0.071428575,0.071428575,0.0
2014.0,SZ,79,79,7,3,4,0.03797468,0.088607594,0.050632913
2015.0,SZ,85,85,5,10,-5,0.11764706,0.05882353,-0.05882353
2016.0,SZ,98,98,7,4,3,0.040816326,0.071428575,0.030612245
2017.0,SZ,119,119,14,3,11,0.025210084,0.11764706,0.09243698
2018.0,SZ,144,144,17,8,9,0.055555556,0.11805555,0.0625
2019.0,SZ,153,153,23,14,9,0.09150327,0.1503268,0.05882353
2020.0,SZ,165,165,21,8,13,0.048484847,0.12727273,0.07878788
2021.0,SZ,151,151,6,14,-8,0.09271523,0.0397351,-0.052980132
1996.0,TD,2,2,0,0,0,0.0,0.0,0.0
1998.0,TD,4,4,0,0,0,0.0,0.0,0.0
2000.0,TD,11,11,2,0,2,0.0,0.18181819,0.18181819
2001.0,TD,16,16,1,1,0,0.0625,0.0625,0.0
2002.0,TD,19,19,1,1,0,0.05263158,0.05263158,0.0
2003.0,TD,18,18,0,1,-1,0.055555556,0.0,-0.055555556
2004.0,TD,25,25,2,1,1,0.04,0.08,0.04
2005.0,TD,27,27,2,1,1,0.037037037,0.074074075,0.037037037
2006.0,TD,22,22,0,2,-2,0.09090909,0.0,-0.09090909
2007.0,TD,25,25,1,1,0,0.04,0.04,0.0
2008.0,TD,25,25,0,0,0,0.0,0.0,0.0
2009.0,TD,20,20,1,0,1,0.0,0.05,0.05
2010.0,TD,19,19,0,1,-1,0.05263158,0.0,-0.05263158
2011.0,TD,25,25,2,1,1,0.04,0.08,0.04
2012.0,TD,28,28,0,1,-1,0.035714287,0.0,-0.035714287
2013.0,TD,36,36,2,3,-1,0.083333336,0.055555556,-0.027777778
2014.0,TD,43,43,3,3,0,0.069767445,0.069767445,0.0
2015.0,TD,54,54,7,0,7,0.0,0.12962963,0.12962963
2016.0,TD,55,55,6,3,3,0.054545455,0.10909091,0.054545455
2017.0,TD,57,57,9,4,5,0.07017544,0.15789473,0.0877193
2019.0,TD,63,63,9,2,7,0.031746034,0.14285715,0.11111111
2020.0,TD,57,57,3,1,2,0.01754386,0.05263158,0.03508772
2021.0,TD,54,54,5,2,3,0.037037037,0.09259259,0.055555556
1996.0,TG,35,35,0,0,0,0.0,0.0,0.0
1997.0,TG,49,49,1,0,1,0.0,0.020408163,0.020408163
1998.0,TG,57,57,2,1,1,0.01754386,0.03508772,0.01754386
1999.0,TG,68,68,0,1,-1,0.014705882,0.0,-0.014705882
2000.0,TG,84,84,3,1,2,0.011904762,0.035714287,0.023809524
2001.0,TG,92,92,3,0,3,0.0,0.032608695,0.032608695
2002.0,TG,101,101,2,1,1,0.00990099,0.01980198,0.00990099
2003.0,TG,104,104,1,4,-3,0.03846154,0.009615385,-0.028846154
2004.0,TG,126,126,4,3,1,0.023809524,0.031746034,0.007936508
2005.0,TG,142,142,2,3,-1,0.02112676,0.014084507,-0.0070422534
2006.0,TG,179,179,8,4,4,0.022346368,0.044692736,0.022346368
2007.0,TG,210,210,7,3,4,0.014285714,0.033333335,0.01904762
2008.0,TG,239,239,7,1,6,0.0041841003,0.029288704,0.025104603
2009.0,TG,264,264,7,4,3,0.015151516,0.026515152,0.011363637
2010.0,TG,302,302,6,8,-2,0.026490066,0.01986755,-0.0066225166
2011.0,TG,354,354,7,8,-1,0.02259887,0.01977401,-0.0028248588
2012.0,TG,439,439,10,7,3,0.01594533,0.022779044,0.006833713
2013.0,TG,517,517,11,12,-1,0.023210831,0.021276595,-0.001934236
2014.0,TG,605,605,18,12,6,0.01983471,0.029752066,0.009917355
2015.0,TG,647,647,22,20,2,0.030911902,0.03400309,0.00309119
2016.0,TG,703,703,31,19,12,0.027027028,0.044096727,0.017069701
2017.0,TG,730,730,22,20,2,0.02739726,0.030136986,0.002739726
2018.0,TG,761,761,27,15,12,0.019710906,0.03547963,0.015768725
2019.0,TG,773,773,22,21,1,0.027166883,0.028460544,0.0012936611
2020.0,TG,744,744,28,19,9,0.025537634,0.03763441,0.012096774
2021.0,TG,685,685,16,11,5,0.016058395,0.023357663,0.00729927
2022.0,TG,0,0,10,9,1,,,
1996.0,TH,2319,2319,0,0,0,0.0,0.0,0.0
1997.0,TH,2951,2951,64,32,32,0.010843782,0.021687564,0.010843782
1998.0,TH,3731,3731,113,67,46,0.017957652,0.030286787,0.012329134
1999.0,TH,4267,4267,119,77,42,0.018045465,0.027888447,0.009842981
2000.0,TH,4929,4929,135,74,61,0.015013187,0.027388923,0.012375736
2001.0,TH,5763,5763,167,123,44,0.02134305,0.028977962,0.007634912
2002.0,TH,6631,6631,218,137,81,0.020660535,0.032875884,0.012215352
2003.0,TH,7708,7708,270,166,104,0.021536067,0.035028543,0.013492475
2004.0,TH,9241,9241,331,180,151,0.019478412,0.035818633,0.016340222
2005.0,TH,10537,10537,340,196,144,0.01860112,0.03226725,0.013666129
2006.0,TH,12231,12231,392,218,174,0.017823564,0.032049708,0.014226147
2007.0,TH,14060,14060,425,262,163,0.018634424,0.030227596,0.011593172
2008.0,TH,15966,15966,435,267,168,0.016723037,0.027245397,0.01052236
2009.0,TH,17820,17820,447,304,143,0.017059484,0.025084175,0.008024692
2010.0,TH,20129,20129,477,368,109,0.01828208,0.023697153,0.0054150727
2011.0,TH,22260,22260,577,386,191,0.01734052,0.025920935,0.008580414
2012.0,TH,24349,24349,606,398,208,0.01634564,0.024888085,0.0085424455
2013.0,TH,26316,26316,661,440,221,0.016719867,0.0251178,0.008397933
2014.0,TH,28173,28173,690,442,248,0.01568878,0.024491534,0.008802755
2015.0,TH,30209,30209,763,451,312,0.014929325,0.025257373,0.010328048
2016.0,TH,32051,32051,788,528,260,0.016473744,0.024585817,0.008112071
2017.0,TH,33740,33740,739,517,222,0.015323059,0.021902787,0.0065797274
2018.0,TH,35388,35388,832,610,222,0.01723748,0.023510795,0.006273313
2019.0,TH,36273,36273,792,632,160,0.017423429,0.021834422,0.0044109942
2020.0,TH,35209,35209,807,623,184,0.01769434,0.022920277,0.0052259364
2021.0,TH,32828,32828,595,447,148,0.013616425,0.018124772,0.0045083463
2022.0,TH,0,0,423,274,149,,,
1996.0,TJ,23,23,0,0,0,0.0,0.0,0.0
1997.0,TJ,28,28,2,0,2,0.0,0.071428575,0.071428575
1998.0,TJ,48,48,4,1,3,0.020833334,0.083333336,0.0625
1999.0,TJ,54,54,2,1,1,0.018518519,0.037037037,0.018518519
2000.0,TJ,71,71,3,2,1,0.028169014,0.04225352,0.014084507
2001.0,TJ,74,74,0,4,-4,0.054054055,0.0,-0.054054055
2002.0,TJ,78,78,2,3,-1,0.03846154,0.025641026,-0.012820513
2003.0,TJ,77,77,3,5,-2,0.064935066,0.038961038,-0.025974026
2004.0,TJ,97,97,7,2,5,0.020618556,0.072164945,0.05154639
2005.0,TJ,96,96,2,9,-7,0.09375,0.020833334,-0.072916664
2006.0,TJ,105,105,4,4,0,0.03809524,0.03809524,0.0
2007.0,TJ,121,121,3,3,0,0.024793388,0.024793388,0.0
2008.0,TJ,188,188,19,4,15,0.021276595,0.10106383,0.07978723
2009.0,TJ,196,196,10,13,-3,0.06632653,0.05102041,-0.015306123
2010.0,TJ,226,226,18,10,8,0.044247787,0.07964602,0.03539823
2011.0,TJ,259,259,23,18,5,0.06949807,0.08880309,0.019305019
2012.0,TJ,274,274,30,26,4,0.09489051,0.10948905,0.01459854
2013.0,TJ,293,293,31,27,4,0.092150174,0.105802044,0.013651877
2014.0,TJ,324,324,34,43,-9,0.13271604,0.10493827,-0.027777778
2015.0,TJ,345,345,38,48,-10,0.13913043,0.11014493,-0.028985508
2016.0,TJ,322,322,22,59,-37,0.18322982,0.06832298,-0.11490683
2017.0,TJ,364,364,35,49,-14,0.13461539,0.09615385,-0.03846154
2018.0,TJ,401,401,39,47,-8,0.11720698,0.097256854,-0.019950125
2019.0,TJ,477,477,94,57,37,0.11949685,0.197065,0.077568136
2020.0,TJ,575,575,148,44,104,0.07652174,0.2573913,0.18086956
2021.0,TJ,729,729,229,44,185,0.060356654,0.31412894,0.2537723
2022.0,TJ,0,0,395,35,360,,,
2007.0,TL,3,3,0,0,0,0.0,0.0,0.0
2008.0,TL,3,3,0,0,0,0.0,0.0,0.0
2011.0,TL,7,7,1,0,1,0.0,0.14285715,0.14285715
2012.0,TL,9,9,2,1,1,0.11111111,0.22222222,0.11111111
2013.0,TL,13,13,2,2,0,0.15384616,0.15384616,0.0
2014.0,TL,18,18,1,1,0,0.055555556,0.055555556,0.0
2015.0,TL,21,21,1,2,-1,0.0952381,0.04761905,-0.04761905
2016.0,TL,23,23,0,0,0,0.0,0.0,0.0
2017.0,TL,26,26,2,1,1,0.03846154,0.07692308,0.03846154
2018.0,TL,28,28,6,3,3,0.10714286,0.21428572,0.10714286
2019.0,TL,30,30,3,3,0,0.1,0.1,0.0
2020.0,TL,30,30,4,5,-1,0.16666667,0.13333334,-0.033333335
2021.0,TL,25,25,0,2,-2,0.08,0.0,-0.08
1996.0,TM,6,6,0,0,0,0.0,0.0,0.0
1997.0,TM,7,7,0,0,0,0.0,0.0,0.0
1998.0,TM,9,9,0,1,-1,0.11111111,0.0,-0.11111111
1999.0,TM,7,7,0,2,-2,0.2857143,0.0,-0.2857143
2000.0,TM,13,13,3,0,3,0.0,0.23076923,0.23076923
2002.0,TM,10,10,1,2,-1,0.2,0.1,-0.1
2003.0,TM,9,9,1,1,0,0.11111111,0.11111111,0.0
2007.0,TM,5,5,1,0,1,0.0,0.2,0.2
2013.0,TM,9,9,0,0,0,0.0,0.0,0.0
2014.0,TM,9,9,1,0,1,0.0,0.11111111,0.11111111
2015.0,TM,6,6,0,1,-1,0.16666667,0.0,-0.16666667
2018.0,TM,15,15,1,0,1,0.0,0.06666667,0.06666667
2019.0,TM,12,12,0,4,-4,0.33333334,0.0,-0.33333334
2020.0,TM,12,12,3,3,0,0.25,0.25,0.0
2021.0,TM,14,14,2,0,2,0.0,0.14285715,0.14285715
1996.0,TN,751,751,0,0,0,0.0,0.0,0.0
1997.0,TN,1000,1000,18,15,3,0.015,0.018,0.003
1998.0,TN,1332,1332,56,18,38,0.013513514,0.042042043,0.028528528
1999.0,TN,1681,1681,38,31,7,0.018441403,0.022605592,0.004164188
2000.0,TN,2015,2015,55,45,10,0.022332506,0.027295286,0.004962779
2001.0,TN,2441,2441,66,40,26,0.016386727,0.0270381,0.010651372
2002.0,TN,3095,3095,66,52,14,0.016801292,0.021324717,0.004523425
2003.0,TN,3843,3843,115,70,45,0.018214935,0.029924538,0.011709602
2004.0,TN,4757,4757,137,100,37,0.021021653,0.028799664,0.0077780113
2005.0,TN,5791,5791,162,108,54,0.018649628,0.027974444,0.009324814
2006.0,TN,6845,6845,190,136,54,0.019868517,0.027757486,0.00788897
2007.0,TN,7761,7761,198,188,10,0.024223683,0.025512176,0.0012884937
2008.0,TN,8788,8788,230,198,32,0.022530723,0.026172053,0.003641329
2009.0,TN,9764,9764,259,240,19,0.02458009,0.026526013,0.0019459238
2010.0,TN,10824,10824,335,268,67,0.024759794,0.030949742,0.0061899484
2011.0,TN,11938,11938,385,303,82,0.025381137,0.032249957,0.006868822
2012.0,TN,13085,13085,402,326,76,0.024914024,0.0307222,0.0058081774
2013.0,TN,14455,14455,426,364,62,0.025181599,0.029470772,0.0042891735
2014.0,TN,15733,15733,458,448,10,0.02847518,0.029110786,0.0006356067
2015.0,TN,16910,16910,520,451,69,0.026670609,0.030751035,0.004080426
2016.0,TN,17793,17793,543,501,42,0.028157141,0.03051762,0.0023604787
2017.0,TN,18354,18354,545,501,44,0.027296502,0.0296938,0.0023972976
2018.0,TN,18795,18795,567,636,-69,0.033838786,0.030167598,-0.003671189
2019.0,TN,18576,18576,537,683,-146,0.036767874,0.02890827,-0.0078596035
2020.0,TN,17520,17520,513,620,-107,0.035388127,0.029280823,-0.006107306
2021.0,TN,16000,16000,373,394,-21,0.024625,0.0233125,-0.0013125
2022.0,TN,0,0,238,270,-32,,,
2006.0,TO,3,3,1,1,0,0.33333334,0.33333334,0.0
2007.0,TO,3,3,0,0,0,0.0,0.0,0.0
2011.0,TO,3,3,0,1,-1,0.33333334,0.0,-0.33333334
2012.0,TO,4,4,0,0,0,0.0,0.0,0.0
2014.0,TO,7,7,1,1,0,0.14285715,0.14285715,0.0
2015.0,TO,9,9,1,0,1,0.0,0.11111111,0.11111111
2016.0,TO,8,8,0,1,-1,0.125,0.0,-0.125
2017.0,TO,7,7,0,1,-1,0.14285715,0.0,-0.14285715
2020.0,TO,6,6,1,0,1,0.0,0.16666667,0.16666667
1996.0,TR,10678,10678,0,0,0,0.0,0.0,0.0
1997.0,TR,13500,13500,178,141,37,0.010444445,0.013185185,0.0027407408
1998.0,TR,16403,16403,258,215,43,0.0131073585,0.01572883,0.0026214716
1999.0,TR,18717,18717,325,275,50,0.014692525,0.017363893,0.0026713682
2000.0,TR,22013,22013,410,345,65,0.015672557,0.018625358,0.0029528006
2001.0,TR,25795,25795,484,368,116,0.014266331,0.018763326,0.0044969954
2002.0,TR,30042,30042,510,452,58,0.015045603,0.016976234,0.0019306304
2003.0,TR,34568,34568,588,500,88,0.014464244,0.017009951,0.002545707
2004.0,TR,39011,39011,598,576,22,0.014765066,0.01532901,0.0005639435
2005.0,TR,43442,43442,687,618,69,0.014225865,0.015814189,0.0015883247
2006.0,TR,47314,47314,762,664,98,0.0140339015,0.01610517,0.0020712686
2007.0,TR,51277,51277,753,760,-7,0.01482146,0.014684946,-0.00013651345
2008.0,TR,54848,54848,760,868,-108,0.015825555,0.013856476,-0.001969078
2009.0,TR,59012,59012,863,930,-67,0.015759507,0.014624144,-0.0011353623
2010.0,TR,63395,63395,975,1017,-42,0.016042275,0.015379761,-0.00066251284
2011.0,TR,69351,69351,1177,993,184,0.014318467,0.016971637,0.0026531701
2012.0,TR,75733,75733,1245,1133,112,0.014960453,0.016439334,0.0014788797
2013.0,TR,82864,82864,1303,1257,46,0.015169434,0.01572456,0.00055512646
2014.0,TR,89130,89130,1455,1340,115,0.015034219,0.01632447,0.0012902502
2015.0,TR,93318,93318,1424,1377,47,0.014755996,0.01525965,0.0005036542
2016.0,TR,96596,96596,1474,1496,-22,0.015487184,0.015259431,-0.00022775271
2017.0,TR,99700,99700,1453,1867,-414,0.01872618,0.014573721,-0.004152457
2018.0,TR,102829,102829,1456,2222,-766,0.02160869,0.01415943,-0.0074492604
2019.0,TR,104879,104879,1767,2297,-530,0.021901429,0.016847987,-0.0050534424
2020.0,TR,102699,102699,1763,2245,-482,0.021859998,0.017166672,-0.004693327
2021.0,TR,97083,97083,1599,1765,-166,0.01818032,0.016470443,-0.0017098772
2022.0,TR,0,0,1133,1261,-128,,,
1996.0,TT,97,97,0,0,0,0.0,0.0,0.0
1997.0,TT,125,125,8,6,2,0.048,0.064,0.016
1998.0,TT,162,162,10,6,4,0.037037037,0.061728396,0.024691358
1999.0,TT,176,176,9,13,-4,0.07386363,0.051136363,-0.022727273
2000.0,TT,198,198,14,8,6,0.04040404,0.07070707,0.030303031
2001.0,TT,234,234,20,11,9,0.047008548,0.08547009,0.03846154
2002.0,TT,245,245,13,17,-4,0.06938776,0.053061225,-0.01632653
2003.0,TT,265,265,20,14,6,0.05283019,0.0754717,0.02264151
2004.0,TT,275,275,18,15,3,0.054545455,0.06545454,0.010909091
2005.0,TT,295,295,21,23,-2,0.0779661,0.07118644,-0.006779661
2006.0,TT,297,297,27,34,-7,0.11447811,0.09090909,-0.023569023
2007.0,TT,345,345,33,21,12,0.060869563,0.09565217,0.034782607
2008.0,TT,358,358,39,36,3,0.10055866,0.108938545,0.008379889
2009.0,TT,387,387,29,29,0,0.0749354,0.0749354,0.0
2010.0,TT,410,410,39,41,-2,0.1,0.09512195,-0.004878049
2011.0,TT,439,439,39,30,9,0.06833713,0.08883827,0.020501139
2012.0,TT,488,488,34,39,-5,0.079918034,0.06967213,-0.0102459015
2013.0,TT,532,532,54,44,10,0.082706764,0.10150376,0.018796992
2014.0,TT,552,552,41,46,-5,0.083333336,0.07427536,-0.009057971
2015.0,TT,587,587,52,42,10,0.07155026,0.08858603,0.017035775
2016.0,TT,624,624,68,43,25,0.068910256,0.10897436,0.040064104
2017.0,TT,661,661,61,35,26,0.052950077,0.09228442,0.039334342
2018.0,TT,743,743,78,41,37,0.055181697,0.10497981,0.049798116
2019.0,TT,764,764,69,44,25,0.057591625,0.090314135,0.032722514
2020.0,TT,717,717,45,59,-14,0.08228731,0.06276151,-0.019525802
2021.0,TT,647,647,40,47,-7,0.07264297,0.061823804,-0.010819165
2022.0,TT,0,0,24,33,-9,,,
1996.0,TW,15641,15641,0,0,0,0.0,0.0,0.0
1997.0,TW,19106,19106,533,533,0,0.027896997,0.027896997,0.0
1998.0,TW,22825,22825,708,700,8,0.030668126,0.03101862,0.0003504929
1999.0,TW,25388,25388,818,727,91,0.028635576,0.032219946,0.0035843705
2000.0,TW,28104,28104,998,939,59,0.033411615,0.03551096,0.0020993452
2001.0,TW,30974,30974,1283,1235,48,0.03987215,0.041421838,0.0015496869
2002.0,TW,34260,34260,1538,1523,15,0.044454172,0.044892002,0.00043782836
2003.0,TW,37555,37555,1433,1725,-292,0.045932632,0.03815737,-0.007775263
2004.0,TW,40942,40942,1578,1816,-238,0.04435543,0.038542327,-0.0058131013
2005.0,TW,44136,44136,1557,1979,-422,0.04483868,0.035277326,-0.009561356
2006.0,TW,47904,47904,1643,1942,-299,0.040539414,0.03429776,-0.00624165
2007.0,TW,51674,51674,1762,2066,-304,0.03998142,0.034098387,-0.005883036
2008.0,TW,55111,55111,1858,2120,-262,0.03846782,0.033713777,-0.004754042
2009.0,TW,58546,58546,2001,2284,-283,0.03901206,0.034178253,-0.004833806
2010.0,TW,61653,61653,2151,2312,-161,0.037500203,0.03488881,-0.0026113896
2011.0,TW,64122,64122,2252,2637,-385,0.04112473,0.03512055,-0.0060041794
2012.0,TW,65596,65596,2168,2702,-534,0.041191537,0.033050794,-0.00814074
2013.0,TW,66419,66419,2190,2648,-458,0.03986811,0.032972492,-0.006895617
2014.0,TW,66132,66132,2229,2804,-575,0.042400047,0.033705316,-0.008694732
2015.0,TW,65361,65361,2230,2809,-579,0.0429767,0.034118205,-0.0088584935
2016.0,TW,63493,63493,2085,2995,-910,0.047170553,0.032838266,-0.014332289
2017.0,TW,61948,61948,2123,3060,-937,0.04939627,0.034270678,-0.015125589
2018.0,TW,60331,60331,2106,3266,-1160,0.05413469,0.034907427,-0.019227263
2019.0,TW,59900,59900,2344,3223,-879,0.053806342,0.039131887,-0.014674458
2020.0,TW,57787,57787,2283,2748,-465,0.04755395,0.039507154,-0.008046793
2021.0,TW,53672,53672,1970,1971,-1,0.03672306,0.03670443,-1.8631688e-05
2022.0,TW,0,0,1557,1614,-57,,,
1996.0,TZ,331,331,0,0,0,0.0,0.0,0.0
1997.0,TZ,437,437,11,12,-1,0.027459955,0.025171624,-0.0022883294
1998.0,TZ,526,526,22,16,6,0.03041825,0.041825093,0.0114068445
1999.0,TZ,586,586,20,13,7,0.022184301,0.034129694,0.011945393
2000.0,TZ,609,609,19,19,0,0.031198686,0.031198686,0.0
2001.0,TZ,650,650,17,13,4,0.02,0.026153846,0.006153846
2002.0,TZ,713,713,25,17,8,0.023842918,0.035063114,0.011220196
2003.0,TZ,765,765,29,21,8,0.02745098,0.0379085,0.010457517
2004.0,TZ,927,927,34,28,6,0.030204963,0.036677454,0.006472492
2005.0,TZ,1060,1060,31,27,4,0.025471698,0.029245283,0.003773585
2006.0,TZ,1204,1204,43,25,18,0.02076412,0.035714287,0.014950166
2007.0,TZ,1306,1306,47,44,3,0.033690657,0.03598775,0.0022970904
2008.0,TZ,1464,1464,56,38,18,0.025956284,0.038251366,0.012295082
2009.0,TZ,1563,1563,59,43,16,0.027511196,0.03774792,0.010236724
2010.0,TZ,1733,1733,83,56,27,0.032313906,0.047893826,0.015579919
2011.0,TZ,1880,1880,83,83,0,0.044148937,0.044148937,0.0
2012.0,TZ,2126,2126,92,88,4,0.041392285,0.043273754,0.0018814675
2013.0,TZ,2378,2378,125,82,43,0.03448276,0.05256518,0.018082421
2014.0,TZ,2665,2665,124,96,28,0.036022514,0.04652908,0.010506567
2015.0,TZ,2958,2958,144,107,37,0.03617309,0.048681542,0.012508452
2016.0,TZ,3205,3205,130,129,1,0.04024961,0.040561624,0.00031201247
2017.0,TZ,3449,3449,149,115,34,0.033343,0.04320093,0.00985793
2018.0,TZ,3682,3682,152,124,28,0.03367735,0.041281912,0.0076045627
2019.0,TZ,3871,3871,190,163,27,0.04210798,0.049082924,0.006974942
2020.0,TZ,3797,3797,191,149,42,0.039241508,0.05030287,0.011061364
2021.0,TZ,3575,3575,123,122,1,0.034125876,0.034405593,0.0002797203
2022.0,TZ,0,0,95,62,33,,,
1996.0,UA,5085,5085,0,0,0,0.0,0.0,0.0
1997.0,UA,6321,6321,93,136,-43,0.021515584,0.014712862,-0.006802721
1998.0,UA,7868,7868,147,178,-31,0.022623284,0.018683273,-0.00394001
1999.0,UA,8846,8846,169,256,-87,0.028939635,0.01910468,-0.009834954
2000.0,UA,9570,9570,192,258,-66,0.026959248,0.020062696,-0.0068965517
2001.0,UA,10387,10387,279,267,12,0.025705209,0.026860498,0.0011552903
2002.0,UA,11158,11158,218,324,-106,0.029037463,0.019537551,-0.00949991
2003.0,UA,11829,11829,262,299,-37,0.025276862,0.022148956,-0.003127906
2004.0,UA,12330,12330,255,283,-28,0.022952149,0.020681266,-0.002270884
2005.0,UA,13207,13207,300,333,-33,0.025213901,0.022715228,-0.002498675
2006.0,UA,13862,13862,286,376,-90,0.027124513,0.020631943,-0.0064925696
2007.0,UA,14458,14458,329,340,-11,0.023516392,0.022755567,-0.0007608245
2008.0,UA,15065,15065,401,359,42,0.02383007,0.026617989,0.002787919
2009.0,UA,15931,15931,382,416,-34,0.02611261,0.023978407,-0.0021342037
2010.0,UA,17335,17335,402,410,-8,0.023651572,0.023190077,-0.00046149408
2011.0,UA,19083,19083,408,473,-65,0.02478646,0.021380287,-0.003406173
2012.0,UA,21372,21372,474,482,-8,0.022552872,0.022178551,-0.00037432153
2013.0,UA,23188,23188,527,602,-75,0.025961705,0.022727273,-0.0032344316
2014.0,UA,25988,25988,618,697,-79,0.026820071,0.023780206,-0.0030398646
2015.0,UA,29317,29317,625,850,-225,0.028993417,0.021318689,-0.007674728
2016.0,UA,33856,33856,774,978,-204,0.02888705,0.022861531,-0.0060255197
2017.0,UA,38879,38879,1002,1035,-33,0.026621055,0.025772268,-0.00084878725
2018.0,UA,42621,42621,1140,1262,-122,0.029609816,0.026747378,-0.0028624388
2019.0,UA,43249,43249,1245,1395,-150,0.03225508,0.028786793,-0.0034682883
2020.0,UA,41550,41550,1173,1291,-118,0.031070998,0.028231047,-0.0028399518
2021.0,UA,38283,38283,844,1100,-256,0.02873338,0.022046339,-0.0066870414
2022.0,UA,0,0,459,462,-3,,,
1996.0,UG,204,204,0,0,0,0.0,0.0,0.0
1997.0,UG,269,269,4,11,-7,0.040892195,0.014869888,-0.026022306
1998.0,UG,365,365,15,10,5,0.02739726,0.04109589,0.01369863
1999.0,UG,432,432,20,12,8,0.027777778,0.046296295,0.018518519
2000.0,UG,513,513,16,16,0,0.031189084,0.031189084,0.0
2001.0,UG,588,588,21,17,4,0.028911564,0.035714287,0.006802721
2002.0,UG,698,698,16,20,-4,0.028653296,0.022922637,-0.0057306592
2003.0,UG,810,810,32,26,6,0.032098766,0.039506175,0.0074074073
2004.0,UG,900,900,25,37,-12,0.04111111,0.027777778,-0.013333334
2005.0,UG,1042,1042,45,34,11,0.032629557,0.04318618,0.0105566215
2006.0,UG,1177,1177,44,44,0,0.037383176,0.037383176,0.0
2007.0,UG,1349,1349,53,49,4,0.0363232,0.03928836,0.0029651595
2008.0,UG,1610,1610,93,52,41,0.032298137,0.057763975,0.025465839
2009.0,UG,1864,1864,75,83,-8,0.044527896,0.040236052,-0.0042918455
2010.0,UG,2138,2138,93,64,29,0.029934518,0.043498598,0.013564078
2011.0,UG,2417,2417,82,89,-7,0.03682251,0.033926357,-0.0028961522
2012.0,UG,2739,2739,93,111,-18,0.04052574,0.033954,-0.0065717413
2013.0,UG,3056,3056,115,124,-9,0.040575918,0.03763089,-0.0029450261
2014.0,UG,3311,3311,156,152,4,0.04590758,0.047115676,0.0012080942
2015.0,UG,3517,3517,112,157,-45,0.044640318,0.031845324,-0.012794996
2016.0,UG,3858,3858,185,161,24,0.041731466,0.047952306,0.00622084
2017.0,UG,4105,4105,174,176,-2,0.042874545,0.042387333,-0.00048721072
2018.0,UG,4475,4475,187,201,-14,0.0449162,0.04178771,-0.0031284916
2019.0,UG,4763,4763,256,213,43,0.044719715,0.05374764,0.009027923
2020.0,UG,4709,4709,229,192,37,0.04077299,0.048630282,0.007857295
2021.0,UG,4484,4484,181,174,7,0.03880464,0.040365744,0.0015611062
2022.0,UG,0,0,135,117,18,,,
1996.0,US,492873,492873,0,0,0,0.0,0.0,0.0
1997.0,US,568354,568354,12386,13356,-970,0.023499439,0.021792756,-0.0017066828
1998.0,US,639914,639914,16242,16422,-180,0.025662823,0.025381535,-0.0002812878
1999.0,US,661109,661109,18391,17927,464,0.027116558,0.027818408,0.000701851
2000.0,US,685043,685043,20045,19651,394,0.028685791,0.029260937,0.0005751464
2001.0,US,712230,712230,22436,21814,622,0.030627746,0.03150106,0.0008733134
2002.0,US,750118,750118,24635,23873,762,0.031825658,0.0328415,0.0010158402
2003.0,US,785254,785254,25999,26133,-134,0.033279676,0.03310903,-0.00017064542
2004.0,US,827537,827537,27480,28103,-623,0.03395981,0.033206973,-0.0007528364
2005.0,US,865028,865028,28581,31197,-2616,0.03606473,0.03304055,-0.0030241795
2006.0,US,903561,903561,30559,33745,-3186,0.037346676,0.03382063,-0.0035260485
2007.0,US,938841,938841,31920,36042,-4122,0.038389888,0.03399937,-0.0043905196
2008.0,US,974303,974303,33625,37429,-3804,0.03841618,0.03451185,-0.0039043296
2009.0,US,1005944,1005944,35481,38842,-3361,0.03861249,0.035271347,-0.0033411402
2010.0,US,1040108,1040108,36595,40346,-3751,0.038790204,0.035183847,-0.0036063562
2011.0,US,1073823,1073823,38549,42231,-3682,0.03932771,0.03589884,-0.0034288706
2012.0,US,1108326,1108326,39562,42512,-2950,0.038356945,0.035695273,-0.0026616717
2013.0,US,1139174,1139174,40162,43906,-3744,0.03854196,0.03525537,-0.003286592
2014.0,US,1169891,1169891,42211,44709,-2498,0.038216382,0.03608114,-0.0021352416
2015.0,US,1199897,1199897,43675,45050,-1375,0.037544888,0.03639896,-0.0011459317
2016.0,US,1222598,1222598,45275,45749,-474,0.037419494,0.037031796,-0.000387699
2017.0,US,1245497,1245497,46796,47083,-287,0.03780258,0.03757215,-0.0002304301
2018.0,US,1266850,1266850,48810,49431,-621,0.039018825,0.038528632,-0.0004901922
2019.0,US,1267570,1267570,49889,50743,-854,0.040031713,0.039357983,-0.00067373004
2020.0,US,1212977,1212977,46018,46785,-767,0.038570393,0.037938066,-0.00063232856
2021.0,US,1124749,1124749,35749,37217,-1468,0.03308916,0.03178398,-0.0013051801
2022.0,US,0,0,26061,25992,69,,,
2023.0,US,0,0,2226,1426,800,,,
1996.0,UY,424,424,0,0,0,0.0,0.0,0.0
1997.0,UY,541,541,19,21,-2,0.038817007,0.03512015,-0.0036968577
1998.0,UY,677,677,38,31,7,0.04579025,0.056129985,0.010339734
1999.0,UY,818,818,37,38,-1,0.04645477,0.045232274,-0.001222494
2000.0,UY,921,921,51,44,7,0.04777416,0.055374593,0.007600434
2001.0,UY,1090,1090,53,48,5,0.044036698,0.048623852,0.0045871558
2002.0,UY,1200,1200,56,65,-9,0.054166667,0.046666667,-0.0075
2003.0,UY,1308,1308,79,86,-7,0.065749235,0.060397554,-0.0053516817
2004.0,UY,1454,1454,86,78,8,0.053645115,0.05914718,0.0055020633
2005.0,UY,1549,1549,82,119,-37,0.076823756,0.052937377,-0.023886379
2006.0,UY,1730,1730,115,121,-6,0.0699422,0.06647399,-0.003468208
2007.0,UY,1944,1944,118,113,5,0.05812757,0.06069959,0.0025720166
2008.0,UY,2166,2166,146,140,6,0.06463527,0.06740536,0.002770083
2009.0,UY,2414,2414,160,152,8,0.062966034,0.06628003,0.0033140017
2010.0,UY,2638,2638,172,169,3,0.06406368,0.06520091,0.0011372252
2011.0,UY,2847,2847,180,178,2,0.06252195,0.06322445,0.0007024939
2012.0,UY,3090,3090,207,186,21,0.060194176,0.06699029,0.0067961165
2013.0,UY,3357,3357,243,241,2,0.071790285,0.072386056,0.00059577
2014.0,UY,3574,3574,227,219,8,0.06127588,0.06351427,0.0022383884
2015.0,UY,3800,3800,253,241,12,0.063421056,0.06657895,0.0031578948
2016.0,UY,4031,4031,282,300,-18,0.074423224,0.06995783,-0.0044653933
2017.0,UY,4229,4229,319,268,51,0.06337196,0.07543154,0.012059589
2018.0,UY,4412,4412,374,291,83,0.06595648,0.08476881,0.01881233
2019.0,UY,4463,4463,337,308,29,0.069011874,0.07550975,0.0064978716
2020.0,UY,4255,4255,283,303,-20,0.07121034,0.06650999,-0.0047003524
2021.0,UY,3955,3955,220,179,41,0.045259167,0.05562579,0.010366624
2022.0,UY,0,0,120,120,0,,,
1996.0,UZ,423,423,0,0,0,0.0,0.0,0.0
1997.0,UZ,540,540,19,7,12,0.0129629625,0.035185184,0.022222223
1998.0,UZ,683,683,20,44,-24,0.06442167,0.029282577,-0.03513909
1999.0,UZ,799,799,22,28,-6,0.035043806,0.027534418,-0.0075093866
2000.0,UZ,849,849,24,38,-14,0.04475854,0.028268551,-0.016489988
2001.0,UZ,909,909,19,38,-19,0.04180418,0.02090209,-0.02090209
2002.0,UZ,983,983,30,36,-6,0.036622584,0.03051882,-0.006103764
2003.0,UZ,1005,1005,18,37,-19,0.03681592,0.017910447,-0.018905472
2004.0,UZ,1042,1042,35,37,-2,0.035508636,0.03358925,-0.0019193857
2005.0,UZ,1153,1153,37,44,-7,0.03816132,0.0320902,-0.0060711186
2006.0,UZ,1182,1182,43,42,1,0.035532996,0.036379017,0.0008460237
2007.0,UZ,1237,1237,50,59,-9,0.04769604,0.040420372,-0.007275667
2008.0,UZ,1311,1311,69,49,20,0.03737605,0.05263158,0.01525553
2009.0,UZ,1432,1432,66,68,-2,0.047486033,0.046089385,-0.001396648
2010.0,UZ,1402,1402,55,106,-51,0.07560628,0.039229672,-0.036376607
2011.0,UZ,1439,1439,55,81,-26,0.056289088,0.038220987,-0.018068103
2012.0,UZ,1498,1498,63,72,-9,0.048064087,0.042056076,-0.006008011
2013.0,UZ,1553,1553,53,57,-4,0.036703154,0.034127496,-0.0025756601
2014.0,UZ,1567,1567,60,60,0,0.038289726,0.038289726,0.0
2015.0,UZ,1587,1587,63,82,-19,0.051669817,0.039697543,-0.011972275
2016.0,UZ,1611,1611,51,64,-13,0.03972688,0.031657357,-0.008069522
2017.0,UZ,1890,1890,57,93,-36,0.04920635,0.03015873,-0.01904762
2018.0,UZ,2474,2474,90,94,-4,0.03799515,0.036378335,-0.0016168149
2019.0,UZ,2947,2947,150,85,65,0.02884289,0.05089922,0.022056328
2020.0,UZ,3006,3006,165,77,88,0.025615435,0.05489022,0.029274784
2021.0,UZ,2928,2928,135,93,42,0.031762294,0.04610656,0.014344262
2022.0,UZ,0,0,78,85,-7,,,
2004.0,VA,7,7,0,0,0,0.0,0.0,0.0
2005.0,VA,7,7,0,0,0,0.0,0.0,0.0
2015.0,VA,8,8,1,1,0,0.125,0.125,0.0
2017.0,VA,10,10,1,1,0,0.1,0.1,0.0
2019.0,VA,13,13,3,1,2,0.07692308,0.23076923,0.15384616
2020.0,VA,12,12,1,2,-1,0.16666667,0.083333336,-0.083333336
2014.0,VC,1,1,0,0,0,0.0,0.0,0.0
2020.0,VC,1,1,0,0,0,0.0,0.0,0.0
1996.0,VE,1941,1941,0,0,0,0.0,0.0,0.0
1997.0,VE,2425,2425,66,80,-14,0.032989692,0.027216494,-0.005773196
1998.0,VE,2907,2907,99,93,6,0.031991743,0.03405573,0.0020639836
1999.0,VE,3097,3097,117,124,-7,0.040038746,0.037778497,-0.002260252
2000.0,VE,3290,3290,130,127,3,0.038601823,0.039513677,0.0009118541
2001.0,VE,3447,3447,120,180,-60,0.05221932,0.034812883,-0.017406441
2002.0,VE,3592,3592,140,179,-39,0.049832962,0.0389755,-0.010857461
2003.0,VE,3761,3761,165,202,-37,0.05370912,0.04387131,-0.009837809
2004.0,VE,4099,4099,209,218,-9,0.053183705,0.050988045,-0.0021956575
2005.0,VE,4437,4437,216,232,-16,0.052287582,0.048681542,-0.00360604
2006.0,VE,4717,4717,253,259,-6,0.05490778,0.053635787,-0.0012719949
2007.0,VE,5021,5021,275,324,-49,0.06452898,0.054769967,-0.009759013
2008.0,VE,5188,5188,291,360,-69,0.0693909,0.05609098,-0.013299922
2009.0,VE,5298,5298,279,392,-113,0.07399019,0.05266138,-0.021328803
2010.0,VE,5213,5213,285,387,-102,0.07423748,0.054671016,-0.019566469
2011.0,VE,5138,5138,292,379,-87,0.07376411,0.056831453,-0.016932659
2012.0,VE,4897,4897,275,442,-167,0.09025934,0.05615683,-0.03410251
2013.0,VE,4782,4782,274,428,-154,0.0895023,0.057298202,-0.0322041
2014.0,VE,4543,4543,248,428,-180,0.09421087,0.05458948,-0.039621394
2015.0,VE,4386,4386,300,495,-195,0.1128591,0.06839945,-0.044459645
2016.0,VE,4142,4142,283,486,-203,0.11733462,0.068324484,-0.04901014
2017.0,VE,3947,3947,281,481,-200,0.12186471,0.071193315,-0.050671395
2018.0,VE,3720,3720,304,549,-245,0.14758064,0.08172043,-0.06586021
2019.0,VE,3461,3461,311,574,-263,0.16584802,0.08985842,-0.0759896
2020.0,VE,3041,3041,268,408,-140,0.13416639,0.0881289,-0.046037488
2021.0,VE,2585,2585,179,234,-55,0.090522245,0.06924565,-0.021276595
2022.0,VE,0,0,90,115,-25,,,
1996.0,VG,55,55,0,0,0,0.0,0.0,0.0
1997.0,VG,70,70,8,4,4,0.057142857,0.114285715,0.057142857
1998.0,VG,89,89,6,6,0,0.06741573,0.06741573,0.0
1999.0,VG,102,102,21,9,12,0.0882353,0.20588236,0.11764706
2000.0,VG,112,112,16,6,10,0.05357143,0.14285715,0.08928572
2001.0,VG,119,119,9,14,-5,0.11764706,0.075630255,-0.042016808
2002.0,VG,136,136,11,9,2,0.066176474,0.080882356,0.014705882
2003.0,VG,145,145,14,9,5,0.062068965,0.096551724,0.03448276
2004.0,VG,148,148,14,13,1,0.08783784,0.0945946,0.006756757
2005.0,VG,170,170,20,13,7,0.07647059,0.11764706,0.04117647
2006.0,VG,188,188,18,19,-1,0.10106383,0.095744684,-0.005319149
2007.0,VG,222,222,34,18,16,0.08108108,0.15315315,0.072072074
2008.0,VG,237,237,32,22,10,0.09282701,0.13502109,0.042194095
2009.0,VG,245,245,28,29,-1,0.118367344,0.114285715,-0.0040816325
2010.0,VG,260,260,30,29,1,0.11153846,0.115384616,0.0038461538
2011.0,VG,250,250,25,26,-1,0.104,0.1,-0.004
2012.0,VG,242,242,29,35,-6,0.1446281,0.11983471,-0.024793388
2013.0,VG,269,269,36,17,19,0.063197024,0.133829,0.07063197
2014.0,VG,276,276,39,36,3,0.13043478,0.14130434,0.010869565
2015.0,VG,273,273,32,29,3,0.10622711,0.11721612,0.010989011
2016.0,VG,243,243,19,49,-30,0.20164609,0.0781893,-0.12345679
2017.0,VG,217,217,19,50,-31,0.23041475,0.08755761,-0.14285715
2018.0,VG,176,176,21,38,-17,0.2159091,0.11931818,-0.09659091
2019.0,VG,152,152,21,28,-7,0.18421052,0.13815789,-0.04605263
2020.0,VG,138,138,16,16,0,0.11594203,0.11594203,0.0
2021.0,VG,108,108,7,5,2,0.046296295,0.06481481,0.018518519
1999.0,VI,4,4,0,0,0,0.0,0.0,0.0
1996.0,VN,340,340,0,0,0,0.0,0.0,0.0
1997.0,VN,454,454,21,24,-3,0.052863438,0.046255507,-0.0066079297
1998.0,VN,602,602,36,29,7,0.048172757,0.059800666,0.011627907
1999.0,VN,726,726,41,29,12,0.039944902,0.05647383,0.016528925
2000.0,VN,857,857,69,48,21,0.056009334,0.08051342,0.024504084
2001.0,VN,1007,1007,104,76,28,0.0754717,0.10327706,0.027805362
2002.0,VN,1129,1129,102,108,-6,0.095659874,0.090345435,-0.0053144377
2003.0,VN,1151,1151,100,150,-50,0.13032146,0.086880974,-0.043440487
2004.0,VN,1263,1263,97,125,-28,0.098970704,0.07680127,-0.022169437
2005.0,VN,1338,1338,115,162,-47,0.12107623,0.085949175,-0.035127055
2006.0,VN,1524,1524,133,113,20,0.07414698,0.08727034,0.0131233595
2007.0,VN,1763,1763,158,144,14,0.08167896,0.089619964,0.0079410095
2008.0,VN,2015,2015,195,152,43,0.075434245,0.09677419,0.021339951
2009.0,VN,2311,2311,219,183,36,0.0791865,0.09476417,0.015577672
2010.0,VN,2699,2699,278,204,74,0.07558355,0.10300111,0.027417563
2011.0,VN,3140,3140,338,226,112,0.07197452,0.10764331,0.03566879
2012.0,VN,3630,3630,348,250,98,0.06887052,0.09586777,0.026997246
2013.0,VN,4129,4129,373,268,105,0.06490675,0.09033664,0.025429886
2014.0,VN,4709,4709,500,297,203,0.063070714,0.106179655,0.04310894
2015.0,VN,5337,5337,516,342,174,0.064080946,0.09668353,0.032602586
2016.0,VN,6208,6208,635,328,307,0.05283505,0.102287374,0.04945232
2017.0,VN,7262,7262,727,399,328,0.054943543,0.100110166,0.04516662
2018.0,VN,8346,8346,861,456,405,0.05463695,0.10316319,0.04852624
2019.0,VN,9442,9442,1014,418,596,0.04427028,0.107392505,0.06312222
2020.0,VN,9842,9842,979,558,421,0.056695793,0.09947165,0.04277586
2021.0,VN,9670,9670,675,544,131,0.056256462,0.06980351,0.013547053
2022.0,VN,0,0,482,489,-7,,,
1996.0,VU,1,1,0,0,0,0.0,0.0,0.0
1999.0,VU,3,3,0,0,0,0.0,0.0,0.0
2000.0,VU,8,8,2,0,2,0.0,0.25,0.25
2002.0,VU,9,9,1,0,1,0.0,0.11111111,0.11111111
2003.0,VU,11,11,0,0,0,0.0,0.0,0.0
2005.0,VU,14,14,1,1,0,0.071428575,0.071428575,0.0
2006.0,VU,13,13,0,3,-3,0.23076923,0.0,-0.23076923
2007.0,VU,15,15,3,0,3,0.0,0.2,0.2
2008.0,VU,14,14,0,1,-1,0.071428575,0.0,-0.071428575
2009.0,VU,13,13,0,3,-3,0.23076923,0.0,-0.23076923
2010.0,VU,12,12,1,2,-1,0.16666667,0.083333336,-0.083333336
2012.0,VU,18,18,1,0,1,0.0,0.055555556,0.055555556
2013.0,VU,16,16,0,5,-5,0.3125,0.0,-0.3125
2014.0,VU,15,15,0,1,-1,0.06666667,0.0,-0.06666667
2015.0,VU,16,16,0,2,-2,0.125,0.0,-0.125
2016.0,VU,20,20,3,2,1,0.1,0.15,0.05
2018.0,VU,19,19,2,3,-1,0.15789473,0.10526316,-0.05263158
2019.0,VU,20,20,3,2,1,0.1,0.15,0.05
2020.0,VU,22,22,4,1,3,0.045454547,0.18181819,0.13636364
2021.0,VU,23,23,1,0,1,0.0,0.04347826,0.04347826
1997.0,WS,3,3,0,0,0,0.0,0.0,0.0
1999.0,WS,4,4,0,0,0,0.0,0.0,0.0
2001.0,WS,4,4,0,0,0,0.0,0.0,0.0
2003.0,WS,6,6,1,1,0,0.16666667,0.16666667,0.0
2004.0,WS,7,7,1,0,1,0.0,0.14285715,0.14285715
2005.0,WS,8,8,0,0,0,0.0,0.0,0.0
2006.0,WS,9,9,2,1,1,0.11111111,0.22222222,0.11111111
2007.0,WS,7,7,0,3,-3,0.42857143,0.0,-0.42857143
2009.0,WS,7,7,0,0,0,0.0,0.0,0.0
2010.0,WS,8,8,2,1,1,0.125,0.25,0.125
2011.0,WS,10,10,2,0,2,0.0,0.2,0.2
2013.0,WS,22,22,1,0,1,0.0,0.045454547,0.045454547
2014.0,WS,28,28,4,0,4,0.0,0.14285715,0.14285715
2015.0,WS,30,30,1,1,0,0.033333335,0.033333335,0.0
2016.0,WS,36,36,4,1,3,0.027777778,0.11111111,0.083333336
2017.0,WS,42,42,5,2,3,0.04761905,0.11904762,0.071428575
2018.0,WS,47,47,3,5,-2,0.10638298,0.06382979,-0.04255319
2019.0,WS,49,49,4,2,2,0.040816326,0.08163265,0.040816326
2020.0,WS,47,47,4,4,0,0.08510638,0.08510638,0.0
2021.0,WS,41,41,1,4,-3,0.09756097,0.024390243,-0.07317073
1996.0,XK,11,11,0,0,0,0.0,0.0,0.0
1997.0,XK,15,15,0,0,0,0.0,0.0,0.0
1998.0,XK,23,23,2,0,2,0.0,0.08695652,0.08695652
1999.0,XK,20,20,0,0,0,0.0,0.0,0.0
2000.0,XK,21,21,0,2,-2,0.0952381,0.0,-0.0952381
2001.0,XK,27,27,0,3,-3,0.11111111,0.0,-0.11111111
2002.0,XK,42,42,2,1,1,0.023809524,0.04761905,0.023809524
2003.0,XK,52,52,1,0,1,0.0,0.01923077,0.01923077
2004.0,XK,104,104,3,2,1,0.01923077,0.028846154,0.009615385
2005.0,XK,154,154,9,6,3,0.038961038,0.058441557,0.019480519
2006.0,XK,229,229,4,0,4,0.0,0.01746725,0.01746725
2007.0,XK,311,311,14,11,3,0.035369776,0.045016076,0.009646302
2008.0,XK,396,396,13,5,8,0.012626262,0.032828283,0.02020202
2009.0,XK,461,461,14,15,-1,0.03253796,0.030368764,-0.0021691974
2010.0,XK,520,520,14,22,-8,0.042307694,0.026923077,-0.015384615
2011.0,XK,616,616,22,16,6,0.025974026,0.035714287,0.0097402595
2012.0,XK,719,719,36,16,20,0.02225313,0.05006954,0.027816411
2013.0,XK,793,793,26,26,0,0.032786883,0.032786883,0.0
2014.0,XK,887,887,29,18,11,0.020293122,0.032694478,0.012401353
2015.0,XK,966,966,39,31,8,0.032091096,0.04037267,0.008281574
2016.0,XK,1052,1052,56,29,27,0.02756654,0.05323194,0.025665399
2017.0,XK,1136,1136,57,30,27,0.02640845,0.050176058,0.023767605
2018.0,XK,1187,1187,58,52,6,0.04380792,0.04886268,0.00505476
2019.0,XK,1222,1222,69,57,12,0.046644844,0.05646481,0.009819968
2020.0,XK,1176,1176,64,52,12,0.044217687,0.054421768,0.010204081
2021.0,XK,1058,1058,32,34,-2,0.032136105,0.030245747,-0.0018903592
2022.0,XK,0,0,21,13,8,,,
1996.0,YE,47,47,0,0,0,0.0,0.0,0.0
1997.0,YE,55,55,1,2,-1,0.036363635,0.018181818,-0.018181818
1998.0,YE,73,73,4,2,2,0.02739726,0.05479452,0.02739726
1999.0,YE,82,82,2,1,1,0.0121951215,0.024390243,0.0121951215
2000.0,YE,77,77,4,7,-3,0.09090909,0.051948052,-0.038961038
2001.0,YE,88,88,6,3,3,0.03409091,0.06818182,0.03409091
2002.0,YE,109,109,7,3,4,0.027522936,0.06422018,0.036697246
2003.0,YE,116,116,6,6,0,0.05172414,0.05172414,0.0
2004.0,YE,124,124,4,4,0,0.032258064,0.032258064,0.0
2005.0,YE,139,139,5,4,1,0.02877698,0.035971224,0.007194245
2006.0,YE,173,173,10,3,7,0.01734104,0.057803467,0.040462427
2007.0,YE,200,200,9,5,4,0.025,0.045,0.02
2008.0,YE,234,234,8,13,-5,0.055555556,0.034188036,-0.021367522
2009.0,YE,263,263,16,9,7,0.03422053,0.0608365,0.02661597
2010.0,YE,297,297,19,17,2,0.057239056,0.06397306,0.0067340066
2011.0,YE,332,332,17,16,1,0.04819277,0.05120482,0.003012048
2012.0,YE,408,408,32,21,11,0.05147059,0.078431375,0.026960785
2013.0,YE,450,450,32,21,11,0.046666667,0.07111111,0.024444444
2014.0,YE,524,524,36,26,10,0.049618322,0.06870229,0.01908397
2015.0,YE,580,580,39,34,5,0.05862069,0.06724138,0.00862069
2016.0,YE,635,635,52,50,2,0.07874016,0.08188976,0.0031496063
2017.0,YE,663,663,56,57,-1,0.08597285,0.08446456,-0.0015082957
2018.0,YE,731,731,60,59,1,0.08071136,0.08207934,0.0013679891
2019.0,YE,806,806,98,69,29,0.08560794,0.12158809,0.03598015
2020.0,YE,790,790,86,79,7,0.1,0.10886076,0.008860759
2021.0,YE,744,744,67,63,4,0.08467742,0.09005377,0.005376344
2022.0,YE,0,0,63,45,18,,,
1996.0,ZA,6036,6036,0,0,0,0.0,0.0,0.0
1997.0,ZA,7278,7278,198,222,-24,0.030502886,0.027205275,-0.0032976093
1998.0,ZA,8485,8485,275,260,15,0.03064231,0.032410137,0.0017678256
1999.0,ZA,9034,9034,311,295,16,0.032654416,0.034425505,0.0017710871
2000.0,ZA,9572,9572,319,310,9,0.032386128,0.03332637,0.0009402424
2001.0,ZA,10119,10119,395,376,19,0.037157822,0.039035477,0.0018776559
2002.0,ZA,10757,10757,373,450,-77,0.041833226,0.034675095,-0.0071581295
2003.0,ZA,11663,11663,489,522,-33,0.044756923,0.041927464,-0.0028294607
2004.0,ZA,12605,12605,500,487,13,0.038635463,0.039666798,0.0010313367
2005.0,ZA,13698,13698,575,555,20,0.040516865,0.041976932,0.0014600671
2006.0,ZA,15233,15233,672,601,71,0.039453816,0.04411475,0.0046609333
2007.0,ZA,16501,16501,702,700,2,0.042421672,0.042542875,0.00012120477
2008.0,ZA,18034,18034,777,700,77,0.03881557,0.043085285,0.0042697126
2009.0,ZA,20085,20085,873,789,84,0.03928305,0.04346527,0.0041822256
2010.0,ZA,22298,22298,1004,919,85,0.04121446,0.04502646,0.003812001
2011.0,ZA,24554,24554,991,861,130,0.03506557,0.040360022,0.005294453
2012.0,ZA,27003,27003,1195,1030,165,0.03814391,0.044254344,0.006110432
2013.0,ZA,29197,29197,1268,1109,159,0.037983354,0.043429118,0.005445765
2014.0,ZA,31323,31323,1447,1227,220,0.039172493,0.046196084,0.007023593
2015.0,ZA,33155,33155,1387,1310,77,0.039511386,0.04183381,0.002322425
2016.0,ZA,34362,34362,1444,1427,17,0.041528434,0.042023163,0.0004947326
2017.0,ZA,35396,35396,1579,1550,29,0.04379026,0.04460956,0.00081930164
2018.0,ZA,36522,36522,1655,1731,-76,0.04739609,0.045315154,-0.0020809376
2019.0,ZA,36547,36547,1704,1842,-138,0.050400853,0.046624895,-0.0037759598
2020.0,ZA,34736,34736,1650,1913,-263,0.055072546,0.04750115,-0.0075713955
2021.0,ZA,32019,32019,1218,1493,-275,0.046628565,0.038039915,-0.00858865
2022.0,ZA,0,0,926,899,27,,,
1996.0,ZM,90,90,0,0,0,0.0,0.0,0.0
1997.0,ZM,116,116,7,6,1,0.05172414,0.060344826,0.00862069
1998.0,ZM,135,135,7,11,-4,0.08148148,0.05185185,-0.02962963
1999.0,ZM,151,151,11,8,3,0.052980132,0.07284768,0.01986755
2000.0,ZM,172,172,11,7,4,0.040697675,0.06395349,0.023255814
2001.0,ZM,179,179,8,10,-2,0.05586592,0.044692736,-0.011173184
2002.0,ZM,212,212,15,9,6,0.04245283,0.070754714,0.028301887
2003.0,ZM,233,233,7,14,-7,0.060085837,0.030042918,-0.030042918
2004.0,ZM,278,278,19,14,5,0.05035971,0.06834532,0.017985612
2005.0,ZM,302,302,18,25,-7,0.08278146,0.059602648,-0.023178808
2006.0,ZM,340,340,19,22,-3,0.064705886,0.055882353,-0.00882353
2007.0,ZM,401,401,20,17,3,0.042394016,0.04987531,0.0074812965
2008.0,ZM,424,424,18,29,-11,0.068396226,0.04245283,-0.025943397
2009.0,ZM,488,488,35,28,7,0.057377048,0.07172131,0.014344262
2010.0,ZM,572,572,40,33,7,0.057692308,0.06993007,0.012237762
2011.0,ZM,642,642,58,44,14,0.06853583,0.09034268,0.021806853
2012.0,ZM,751,751,54,57,-3,0.075898804,0.07190413,-0.003994674
2013.0,ZM,877,877,54,62,-8,0.07069556,0.061573546,-0.009122007
2014.0,ZM,994,994,97,93,4,0.093561366,0.097585514,0.0040241447
2015.0,ZM,1151,1151,97,92,5,0.07993049,0.084274545,0.0043440484
2016.0,ZM,1254,1254,84,116,-32,0.09250399,0.066985644,-0.025518341
2017.0,ZM,1357,1357,114,91,23,0.06705969,0.08400884,0.016949153
2018.0,ZM,1440,1440,101,124,-23,0.08611111,0.07013889,-0.015972223
2019.0,ZM,1483,1483,119,139,-20,0.09372893,0.08024275,-0.013486177
2020.0,ZM,1456,1456,122,111,11,0.07623626,0.08379121,0.007554945
2021.0,ZM,1364,1364,93,76,17,0.055718474,0.06818182,0.012463343
2022.0,ZM,0,0,90,43,47,,,
1996.0,ZW,334,334,0,0,0,0.0,0.0,0.0
1997.0,ZW,431,431,16,11,5,0.025522042,0.03712297,0.011600928
1998.0,ZW,510,510,20,17,3,0.033333335,0.039215688,0.005882353
1999.0,ZW,533,533,16,30,-14,0.056285176,0.030018762,-0.026266417
2000.0,ZW,539,539,26,17,9,0.031539887,0.048237476,0.016697587
2001.0,ZW,567,567,17,28,-11,0.049382716,0.029982364,-0.019400353
2002.0,ZW,555,555,19,40,-21,0.072072074,0.034234233,-0.037837837
2003.0,ZW,555,555,14,39,-25,0.07027027,0.025225226,-0.045045044
2004.0,ZW,598,598,25,38,-13,0.06354515,0.04180602,-0.02173913
2005.0,ZW,626,626,24,56,-32,0.08945687,0.038338657,-0.05111821
2006.0,ZW,632,632,26,64,-38,0.101265825,0.04113924,-0.060126584
2007.0,ZW,621,621,24,43,-19,0.069243155,0.038647342,-0.030595813
2008.0,ZW,654,654,19,50,-31,0.0764526,0.029051987,-0.047400612
2009.0,ZW,675,675,24,78,-54,0.115555555,0.035555556,-0.08
2010.0,ZW,800,800,31,58,-27,0.0725,0.03875,-0.03375
2011.0,ZW,955,955,40,63,-23,0.06596859,0.041884817,-0.024083769
2012.0,ZW,1170,1170,39,55,-16,0.047008548,0.033333335,-0.013675214
2013.0,ZW,1370,1370,86,70,16,0.05109489,0.06277372,0.011678832
2014.0,ZW,1524,1524,81,78,3,0.051181104,0.053149607,0.001968504
2015.0,ZW,1652,1652,87,103,-16,0.062348668,0.052663438,-0.00968523
2016.0,ZW,1726,1726,81,111,-30,0.06431054,0.046929315,-0.017381229
2017.0,ZW,1785,1785,89,132,-43,0.07394958,0.049859945,-0.024089636
2018.0,ZW,1857,1857,113,131,-18,0.070543885,0.060850836,-0.009693054
2019.0,ZW,1964,1964,167,133,34,0.06771894,0.08503055,0.017311608
2020.0,ZW,1921,1921,150,128,22,0.066631965,0.078084335,0.011452368
2021.0,ZW,1803,1803,139,113,26,0.06267332,0.077093735,0.014420411
2022.0,ZW,0,0,122,70,52,,,
1996.0,nan,2995,2995,0,0,0,0.0,0.0,0.0
1997.0,nan,3600,3600,354,332,22,0.09222222,0.09833334,0.006111111
1998.0,nan,4240,4240,523,501,22,0.118160374,0.123349056,0.0051886793
1999.0,nan,4577,4577,533,524,9,0.11448547,0.11645182,0.0019663535
2000.0,nan,4976,4976,634,599,35,0.120377816,0.12741157,0.007033762
2001.0,nan,5340,5340,705,740,-35,0.13857678,0.13202247,-0.006554307
2002.0,nan,6008,6008,784,797,-13,0.13265646,0.13049267,-0.0021637816
2003.0,nan,6683,6683,893,890,3,0.13317372,0.13362263,0.0004489002
2004.0,nan,7295,7295,945,955,-10,0.13091159,0.12954079,-0.0013708019
2005.0,nan,7918,7918,1163,1197,-34,0.15117455,0.14688052,-0.0042940136
2006.0,nan,8429,8429,1302,1366,-64,0.16205956,0.15446672,-0.007592834
2007.0,nan,8799,8799,1380,1608,-228,0.18274803,0.156836,-0.025912035
2008.0,nan,9245,9245,1512,1600,-88,0.17306653,0.16354786,-0.009518659
2009.0,nan,9488,9488,1548,1751,-203,0.1845489,0.16315345,-0.021395447
2010.0,nan,9905,9905,1699,1739,-40,0.1755679,0.17152953,-0.0040383646
2011.0,nan,10279,10279,1834,1921,-87,0.18688588,0.17842202,-0.008463859
2012.0,nan,10664,10664,1826,1930,-104,0.18098274,0.1712303,-0.009752438
2013.0,nan,11000,11000,1959,2005,-46,0.18227273,0.17809092,-0.004181818
2014.0,nan,11339,11339,2030,2023,7,0.1784108,0.17902814,0.0006173384
2015.0,nan,11325,11325,1993,2228,-235,0.1967329,0.17598234,-0.020750552
2016.0,nan,11314,11314,2044,2284,-240,0.20187378,0.18066113,-0.021212656
2017.0,nan,11077,11077,2035,2339,-304,0.21115826,0.183714,-0.027444255
2018.0,nan,11188,11188,2240,2337,-97,0.20888452,0.20021452,-0.008670003
2019.0,nan,10976,10976,2293,2526,-233,0.23013848,0.20891035,-0.021228135
2020.0,nan,10319,10319,2042,2179,-137,0.21116388,0.19788739,-0.01327648
2021.0,nan,9324,9324,1548,1644,-96,0.17631918,0.16602316,-0.01029601
2022.0,nan,0,0,872,982,-110,,,
2023.0,nan,0,0,65,40,25,,,
