migrationfrom,migrationto,year,n_migrations,n_migrations_back,netmigrations
ITA,ESP,2010.0,190,89,101
USA,MEX,2014.0,166,186,-20
BRA,AUS,2013.0,34,18,16
RUS,DEU,2010.0,126,70,56
TUN,FRA,2009.0,79,92,-13
FRA,DEU,2010.0,324,265,59
USA,CAN,2015.0,1309,1811,-502
AUS,SGP,2006.0,31,53,-22
EGY,CAN,2016.0,33,44,-11
GBR,USA,2003.0,1458,1165,293
CHE,USA,2020.0,488,510,-22
DEU,GBR,2004.0,364,307,57
USA,ITA,2011.0,341,545,-204
ESP,USA,2012.0,492,345,147
ZAF,USA,2016.0,103,89,14
NLD,NZL,2010.0,15,6,9
USA,ISR,2014.0,303,364,-61
GBR,QAT,2018.0,45,24,21
GBR,ESP,2015.0,252,508,-256
HRV,USA,2007.0,9,17,-8
USA,NLD,2021.0,284,237,47
NLD,DEU,2011.0,230,220,10
USA,CHL,2013.0,85,102,-17
ITA,GBR,2016.0,581,251,330
USA,CHE,2012.0,519,427,92
FRA,NLD,2005.0,83,74,9
FRA,GBR,2006.0,336,269,67
USA,IND,2014.0,761,903,-142
GBR,GRC,2011.0,144,137,7
NLD,CAN,2004.0,32,31,1
CAN,TWN,2010.0,17,12,5
USA,IRL,2016.0,122,180,-58
DEU,CRI,2016.0,7,8,-1
NLD,IRN,2014.0,11,31,-20
ZWE,USA,2007.0,8,2,6
AUS,CAN,2004.0,102,86,16
GBR,AUS,2002.0,344,360,-16
DEU,NLD,2015.0,271,288,-17
CRI,DEU,2002.0,1,2,-1
AUT,GBR,2007.0,49,32,17
ESP,SWE,2012.0,37,22,15
USA,PHL,2004.0,13,16,-3
GBR,AUS,2005.0,406,320,86
FRA,BEL,2012.0,182,169,13
LUX,AUT,2017.0,2,1,1
LBN,USA,2005.0,28,29,-1
RUS,DEU,2019.0,124,75,49
USA,BEL,2013.0,136,169,-33
FRA,AUS,2016.0,100,92,8
COL,MEX,2017.0,27,36,-9
ITA,ESP,2017.0,167,140,27
TWN,CHN,2018.0,205,81,124
FRA,CMR,2007.0,10,14,-4
KOR,CHN,2013.0,162,61,101
CAN,COL,2020.0,17,18,-1
SWE,NOR,1999.0,17,14,3
AUS,ARE,2011.0,9,2,7
LBN,USA,2002.0,21,11,10
BRA,ITA,2021.0,56,21,35
ITA,CAN,2005.0,34,30,4
MYS,GBR,2015.0,61,158,-97
IND,ESP,2012.0,19,10,9
ESP,MEX,2014.0,155,84,71
CHE,ESP,2021.0,61,75,-14
IDN,DEU,2005.0,2,7,-5
USA,ROU,2013.0,12,8,4
ROU,HUN,2021.0,8,8,0
VEN,ITA,2018.0,5,1,4
NLD,JPN,2016.0,26,16,10
CAN,IRN,2022.0,26,163,-137
USA,SVN,2017.0,13,8,5
DEU,KEN,2020.0,11,11,0
NZL,AUS,2015.0,169,97,72
BEL,BRA,2015.0,25,19,6
USA,BHR,2016.0,4,2,2
GBR,CYP,2020.0,53,15,38
IND,ZAF,2016.0,75,29,46
FRA,CHN,2016.0,195,142,53
CHE,JPN,2008.0,20,38,-18
FRA,ESP,2005.0,107,115,-8
GBR,NOR,2014.0,71,40,31
PRT,COL,2021.0,2,3,-1
TWN,SGP,2011.0,15,11,4
JPN,KOR,1998.0,28,18,10
FRA,DEU,2019.0,389,312,77
BRA,DEU,2016.0,98,96,2
ESP,COL,2016.0,83,50,33
BRA,RUS,2019.0,10,6,4
RUS,DEU,2017.0,104,77,27
IRL,CHN,2014.0,17,14,3
IND,DNK,2011.0,11,11,0
USA,NZL,2002.0,96,113,-17
GBR,SGP,2021.0,83,77,6
MYS,IND,2016.0,33,73,-40
GBR,SVK,2017.0,4,4,0
USA,FRA,2021.0,424,552,-128
DEU,DNK,2016.0,138,89,49
NLD,SAU,2015.0,4,2,2
DNK,HUN,2021.0,4,6,-2
BEL,NLD,1998.0,15,21,-6
SWE,IRQ,2020.0,2,3,-1
MUS,GBR,2013.0,1,1,0
JPN,FRA,2009.0,93,82,11
COL,ESP,2003.0,17,15,2
COL,MEX,2019.0,52,46,6
IND,FRA,2021.0,66,47,19
PRT,ITA,2017.0,25,34,-9
DEU,ESP,2016.0,163,259,-96
CIV,FRA,1999.0,2,1,1
IDN,KOR,2017.0,14,30,-16
PAK,MYS,2015.0,44,60,-16
ESP,SAU,2019.0,15,3,12
HUN,NLD,2021.0,8,8,0
MEX,BRA,2015.0,20,13,7
SWE,NLD,2022.0,23,23,0
KOR,SWE,2016.0,11,6,5
IRL,ESP,2018.0,34,46,-12
FRA,NCL,2005.0,13,8,5
NOR,CHN,2017.0,25,14,11
KOR,DEU,2018.0,76,53,23
SGP,USA,2021.0,152,121,31
ITA,ESP,2019.0,212,186,26
HUN,SVK,2015.0,7,2,5
AUS,KOR,2006.0,17,18,-1
NAM,ZAF,2020.0,7,14,-7
NLD,NZL,2017.0,21,8,13
ITA,NLD,2014.0,108,52,56
PHL,USA,2021.0,23,11,12
ISR,CHN,2018.0,21,29,-8
SWE,KOR,2010.0,3,3,0
USA,AUT,2021.0,82,72,10
GBR,HUN,2018.0,32,47,-15
NZL,ARE,2021.0,5,3,2
CHE,GTM,2022.0,1,1,0
CHN,ESP,2022.0,28,36,-8
SRB,RUS,2016.0,4,2,2
REU,FRA,2021.0,10,5,5
IND,BEL,2020.0,40,19,21
SWE,ISL,2019.0,20,13,7
ISR,MEX,2020.0,3,4,-1
ESP,DNK,2022.0,20,7,13
MYS,JOR,2018.0,25,5,20
CAN,TGO,2018.0,2,1,1
JPN,IDN,2011.0,76,23,53
BEL,FIN,2018.0,10,15,-5
FRA,GUF,2020.0,22,13,9
TUR,GBR,2021.0,56,43,13
ITA,POL,2018.0,32,25,7
PRT,MOZ,2020.0,4,5,-1
PAK,KOR,2013.0,20,14,6
AUS,IND,2022.0,32,48,-16
IDN,NLD,2020.0,20,47,-27
GBR,CHN,2005.0,106,101,5
MAR,FRA,2021.0,39,49,-10
DNK,JPN,2019.0,10,12,-2
COL,BRA,2020.0,36,73,-37
PAK,SAU,2014.0,63,23,40
CYP,GBR,2020.0,15,53,-38
COL,MEX,2010.0,11,13,-2
SVN,HRV,2019.0,7,12,-5
GBR,CHN,2002.0,71,98,-27
CMR,USA,2018.0,5,11,-6
GRC,GBR,2022.0,51,73,-22
CAN,KWT,2020.0,11,4,7
CHN,NOR,2021.0,19,28,-9
KAZ,RUS,2017.0,33,27,6
IND,CAN,2021.0,116,64,52
USA,BGD,2021.0,45,80,-35
NLD,NZL,2019.0,15,7,8
JOR,ARE,2021.0,18,12,6
FRA,FIN,2020.0,26,16,10
CAN,IND,2006.0,36,58,-22
GBR,RUS,2009.0,27,42,-15
CHN,MMR,2021.0,5,4,1
VNM,GBR,2020.0,12,22,-10
IRL,CAN,2018.0,48,34,14
IDN,KOR,2010.0,3,5,-2
RUS,ITA,2019.0,13,20,-7
FIN,DEU,2021.0,39,37,2
FRA,PER,2017.0,8,3,5
MOZ,BRA,2022.0,2,5,-3
DEU,GHA,2011.0,7,4,3
NGA,IND,2011.0,3,6,-3
DEU,ROU,2013.0,18,25,-7
GRC,USA,2011.0,108,88,20
NOR,IND,2015.0,8,11,-3
AUS,CHE,2013.0,40,52,-12
CAN,KEN,2015.0,7,10,-3
MYS,BEL,2019.0,5,4,1
JPN,BGD,2003.0,19,19,0
BWA,ZAF,2011.0,8,7,1
SGP,CHE,2018.0,17,16,1
USA,FIN,2007.0,44,57,-13
SWE,ISL,2017.0,14,8,6
POL,AUT,2010.0,10,10,0
NLD,AUS,2012.0,69,41,28
VEN,USA,2020.0,20,5,15
CAN,CHE,2013.0,86,66,20
NLD,ISR,2015.0,11,5,6
CAN,RUS,2015.0,19,12,7
DNK,CAN,2004.0,19,11,8
JPN,EGY,2022.0,16,12,4
GBR,NZL,2003.0,112,78,34
CHE,CHN,2015.0,34,37,-3
VNM,FRA,2014.0,13,46,-33
IRN,MYS,2011.0,45,57,-12
HKG,RUS,2017.0,2,1,1
NGA,CAN,2017.0,7,3,4
CHE,BRA,2004.0,6,6,0
IND,AUT,2016.0,11,8,3
ECU,MEX,2016.0,2,3,-1
FRA,ESP,2002.0,136,123,13
IRL,SWE,2009.0,8,14,-6
FRA,PYF,2021.0,10,11,-1
NLD,NOR,2005.0,12,6,6
CAN,CHL,2006.0,13,10,3
CUB,DEU,2002.0,4,1,3
ZAF,CAN,2014.0,18,21,-3
NLD,RUS,2014.0,11,15,-4
DNK,USA,2003.0,106,87,19
CHE,AUT,2001.0,14,14,0
ITA,JOR,2019.0,6,2,4
USA,URY,1999.0,1,3,-2
GBR,BRB,2017.0,1,2,-1
POL,AUT,2019.0,11,8,3
SGP,PAK,2013.0,1,2,-1
IRN,CHN,2018.0,35,11,24
CHN,NPL,2020.0,25,14,11
ARE,NZL,2019.0,1,5,-4
FRA,EGY,2021.0,16,7,9
GBR,ARG,2015.0,11,14,-3
GMB,GBR,2022.0,6,3,3
THA,JPN,2021.0,35,77,-42
GBR,BRB,2019.0,3,1,2
KAZ,RUS,2019.0,22,44,-22
KEN,USA,2017.0,40,75,-35
PER,USA,2021.0,34,19,15
ARG,MEX,2018.0,12,32,-20
UKR,RUS,2014.0,116,39,77
CHN,NZL,2007.0,6,5,1
USA,IRN,2022.0,43,169,-126
USA,CYP,2005.0,20,3,17
HUN,ISR,2012.0,4,2,2
GBR,VNM,2021.0,10,11,-1
DZA,DEU,2018.0,6,2,4
TWN,CAN,2012.0,18,12,6
ETH,CHE,2016.0,5,2,3
NLD,ZAF,2019.0,27,24,3
IND,PRT,2011.0,21,7,14
CHN,IRN,2021.0,22,42,-20
HND,USA,2021.0,3,5,-2
FRA,IRN,2021.0,11,26,-15
HUN,DNK,1999.0,1,1,0
BEL,MAR,2021.0,5,2,3
TWN,HKG,2003.0,4,7,-3
KOR,IDN,2022.0,8,9,-1
ESP,EGY,2020.0,11,4,7
CAN,MEX,2022.0,10,28,-18
GBR,BGR,2019.0,4,5,-1
NGA,CAN,2019.0,21,7,14
AUT,ESP,2019.0,28,30,-2
GBR,CAN,1999.0,92,100,-8
SWE,JPN,2012.0,17,22,-5
AUT,JPN,2001.0,5,8,-3
ROU,BGR,2020.0,1,1,0
USA,HKG,1999.0,54,33,21
PAK,KEN,2022.0,8,1,7
GBR,UKR,2006.0,12,13,-1
ZAF,ITA,2014.0,3,11,-8
ARG,IND,2021.0,2,1,1
USA,ALB,2016.0,4,1,3
THA,AUS,2006.0,11,29,-18
CAN,POL,2011.0,32,11,21
BRA,PER,2008.0,7,1,6
SVN,DEU,2008.0,2,5,-3
GBR,MYS,2003.0,40,12,28
JPN,NGA,2005.0,2,2,0
ESP,ROU,2005.0,4,2,2
NGA,SAU,2011.0,3,1,2
POL,ESP,2009.0,17,11,6
SRB,USA,2006.0,9,15,-6
DNK,IRQ,2018.0,1,1,0
AUS,THA,2004.0,19,7,12
FIN,IRN,2009.0,2,1,1
FRA,THA,2012.0,14,10,4
DEU,POL,2003.0,51,59,-8
NGA,CAN,2010.0,6,2,4
GBR,GHA,2009.0,10,6,4
SRB,AUS,2003.0,1,1,0
FRA,UKR,2003.0,9,14,-5
SRB,MNE,2015.0,3,3,0
USA,ZAF,2005.0,68,55,13
FRA,PRT,2001.0,9,26,-17
ZAF,CHE,2003.0,4,3,1
ISR,PSE,2018.0,11,10,1
CZE,AUT,2020.0,14,11,3
AUS,ITA,2002.0,15,14,1
ITA,CAN,2002.0,35,31,4
CHE,BGR,2010.0,6,4,2
FRA,LAO,2013.0,4,6,-2
GBR,EST,2004.0,2,1,1
BGR,HUN,2005.0,1,2,-1
SAU,ARE,2005.0,7,1,6
NLD,ZAF,2010.0,14,15,-1
DNK,NLD,2000.0,5,13,-8
CAN,SGP,2013.0,22,19,3
CHE,MAR,2001.0,2,1,1
MEX,GBR,2002.0,14,36,-22
DNK,FIN,2021.0,13,13,0
TUR,ISR,2002.0,2,2,0
SRB,HRV,2004.0,4,4,0
NLD,FIN,2004.0,7,8,-1
USA,NZL,2005.0,104,83,21
NLD,NOR,2002.0,15,8,7
NLD,ZAF,2017.0,34,18,16
POL,ISR,2013.0,6,10,-4
FRA,IRL,2020.0,28,34,-6
HUN,DEU,2011.0,42,22,20
CUB,DEU,2005.0,4,2,2
ROU,FRA,2004.0,19,22,-3
ZAF,DEU,2004.0,13,9,4
IDN,USA,2000.0,3,5,-2
IRL,ROU,2011.0,1,2,-1
BEL,FRA,1999.0,49,44,5
AUS,JPN,2008.0,38,53,-15
HUN,ESP,2011.0,2,3,-1
POL,UKR,2009.0,10,12,-2
SVN,SVK,2004.0,4,5,-1
RUS,ITA,2010.0,19,11,8
GBR,MEX,1999.0,18,3,15
TUR,AZE,2018.0,9,2,7
LVA,USA,2001.0,1,3,-2
DEU,ARG,2006.0,17,30,-13
BEL,CHE,2000.0,11,3,8
KOR,CAN,1999.0,10,4,6
PHL,GBR,2019.0,6,3,3
SWE,PRT,2005.0,8,5,3
ZAF,AUS,2001.0,17,5,12
CHE,ISR,2003.0,5,19,-14
BEL,SWE,2005.0,6,7,-1
DEU,BGR,2010.0,11,15,-4
AUS,ITA,2005.0,23,17,6
JPN,KOR,1997.0,9,8,1
MYS,CAN,2001.0,4,1,3
BEL,SWE,2002.0,11,10,1
SWE,BRA,2004.0,9,2,7
DEU,JOR,2004.0,6,4,2
TWN,BLR,2016.0,1,1,0
DEU,ARM,2017.0,2,3,-1
POL,AUS,2001.0,3,5,-2
ISR,TWN,2020.0,2,2,0
KOR,MEX,2013.0,1,1,0
LBY,NLD,2009.0,1,1,0
JPN,CZE,2011.0,9,5,4
BEL,NLD,1997.0,11,14,-3
KWT,PAK,2002.0,2,1,1
POL,GBR,2000.0,5,9,-4
FRA,PER,2010.0,6,4,2
BEL,CHN,2008.0,13,19,-6
IND,MYS,2006.0,19,14,5
IRL,ZAF,2021.0,5,7,-2
KOR,PAK,2014.0,21,31,-10
SWE,ISL,2010.0,13,9,4
MEX,GBR,2005.0,11,32,-21
IRL,HKG,2008.0,2,2,0
GBR,KWT,2006.0,8,5,3
JPN,SVK,2011.0,2,3,-1
CAN,JOR,2016.0,10,12,-2
DEU,MEX,2008.0,28,23,5
USA,KEN,2022.0,21,22,-1
RUS,PRT,2004.0,6,6,0
GBR,BGR,2010.0,5,9,-4
BHS,USA,2020.0,4,3,1
TUR,JPN,2016.0,5,11,-6
BEL,AUT,2008.0,5,3,2
BEL,BGD,2017.0,6,4,2
CHE,ZAF,2015.0,15,19,-4
IND,NAM,2014.0,2,1,1
IRL,BEL,2007.0,4,3,1
BRA,SWE,2019.0,27,10,17
PRT,ITA,2010.0,7,31,-24
ESP,SGP,2012.0,7,4,3
NOR,FIN,2012.0,6,15,-9
MAR,TUN,2010.0,1,1,0
TUR,QAT,2020.0,4,1,3
GRC,BEL,2005.0,9,10,-1
ESP,HRV,2018.0,6,5,1
ROU,CHE,2009.0,4,4,0
DNK,JPN,2017.0,6,7,-1
UKR,JPN,2011.0,1,4,-3
GBR,LTU,2020.0,6,6,0
THA,CAN,2012.0,7,14,-7
MYS,IRQ,2011.0,14,2,12
HKG,IRN,2018.0,1,4,-3
TZA,ETH,2013.0,1,1,0
CHL,CRI,2013.0,2,1,1
NLD,CHN,2004.0,19,15,4
DEU,IRQ,2017.0,9,1,8
NPL,ITA,2010.0,2,1,1
NZL,IRN,2018.0,2,25,-23
MOZ,ZAF,2013.0,2,1,1
SAU,YEM,2013.0,2,4,-2
BEL,SVN,2015.0,2,4,-2
IND,BGD,2014.0,12,11,1
CZE,KOR,2017.0,5,3,2
NOR,BEL,2020.0,6,13,-7
HKG,JPN,2004.0,7,5,2
POL,AUT,2017.0,11,6,5
MYS,BEL,2017.0,2,2,0
NLD,AUT,2010.0,18,15,3
SUR,NLD,2019.0,1,6,-5
IRL,AUS,2003.0,14,24,-10
KAZ,TUR,2015.0,4,2,2
GRC,NLD,2018.0,20,21,-1
SWE,POL,2022.0,8,10,-2
CZE,KOR,2019.0,3,3,0
CHE,DNK,2022.0,19,21,-2
GIN,GNQ,2018.0,1,1,0
PER,FRA,2012.0,5,7,-2
CHN,TUR,2020.0,9,13,-4
PSE,GBR,2018.0,3,5,-2
TWN,DEU,2014.0,25,18,7
BOL,SWE,2018.0,2,3,-1
BRA,ARG,2000.0,10,6,4
CHN,FIN,2021.0,42,32,10
ESP,ARE,2012.0,2,1,1
BGR,AUT,2020.0,2,2,0
PAK,ESP,2021.0,5,2,3
ARE,IND,2021.0,22,47,-25
ZAF,KEN,2022.0,5,6,-1
RUS,ITA,2017.0,14,30,-16
FRA,REU,2013.0,5,19,-14
ITA,ALB,2001.0,1,1,0
DNK,GRC,2013.0,5,10,-5
JPN,NGA,2002.0,2,4,-2
NOR,POL,2012.0,4,6,-2
BEL,RUS,2008.0,10,10,0
DNK,CHE,2002.0,17,9,8
PYF,FRA,2019.0,10,11,-1
SWE,RUS,2007.0,14,15,-1
CHN,BRA,1999.0,1,1,0
ISR,AUT,2013.0,6,2,4
FRA,CZE,2012.0,14,22,-8
CAN,KOR,2001.0,9,17,-8
SVK,AUT,2007.0,8,3,5
EST,DEU,2021.0,8,6,2
DEU,SVN,2016.0,5,12,-7
ISR,IRN,2009.0,1,1,0
CHN,LUX,2021.0,3,3,0
COL,FRA,2016.0,20,24,-4
IDN,KOR,2019.0,15,41,-26
USA,KHM,2012.0,2,2,0
FRA,NLD,2002.0,82,67,15
JPN,MYS,2001.0,6,3,3
TUR,ARE,2021.0,5,4,1
IND,BRA,2019.0,19,16,3
PER,BRA,2013.0,14,8,6
MWI,USA,2022.0,9,11,-2
NLD,AUT,2019.0,30,28,2
TZA,GBR,2021.0,5,9,-4
CAN,CMR,2017.0,1,2,-1
SVN,ROU,2011.0,1,1,0
ARE,NZL,2017.0,2,2,0
NGA,GHA,2013.0,1,2,-1
DEU,BGR,2017.0,15,5,10
KAZ,ZAF,2017.0,1,1,0
FRA,VNM,2008.0,5,6,-1
BRA,RUS,2017.0,5,17,-12
THA,BEL,2011.0,1,3,-2
FIN,CHL,2022.0,1,1,0
JPN,NPL,2018.0,12,4,8
KOR,CZE,2021.0,3,1,2
THA,NPL,2020.0,6,4,2
EST,PAK,2020.0,1,3,-2
SRB,NOR,2010.0,2,4,-2
RUS,EGY,2011.0,2,1,1
GIN,FRA,2016.0,3,5,-2
UKR,ITA,2022.0,3,2,1
JOR,EGY,2021.0,3,1,2
BRA,ECU,2021.0,6,4,2
JOR,USA,2000.0,4,1,3
HRV,SVN,2013.0,6,7,-1
DEU,DZA,2004.0,2,2,0
FJI,IND,2007.0,3,1,2
BGR,ITA,2013.0,4,3,1
ISR,TUR,2002.0,2,2,0
JOR,CAN,2004.0,6,3,3
SWE,COL,2006.0,2,1,1
ZAF,NGA,2003.0,9,7,2
BEL,IND,2006.0,6,7,-1
USA,SVN,2010.0,9,9,0
POL,SWE,2002.0,11,7,4
PYF,FRA,2010.0,2,4,-2
CYP,GRC,2013.0,13,41,-28
SAU,GBR,2001.0,12,10,2
BEL,DNK,2001.0,5,3,2
IND,BRA,2010.0,11,2,9
USA,CYP,2002.0,7,4,3
CMR,FRA,2011.0,8,14,-6
ITA,SVK,1999.0,2,1,1
PHL,AUS,2022.0,5,2,3
SDN,MYS,2010.0,4,1,3
ESP,ISR,2007.0,5,4,1
MYS,CHN,2012.0,5,5,0
MYS,SDN,2005.0,2,1,1
AUT,ESP,2010.0,13,12,1
AUS,RUS,2012.0,3,9,-6
POL,SWE,2005.0,13,6,7
BEL,JPN,2018.0,15,11,4
NZL,POL,2017.0,1,4,-3
RUS,BLR,2015.0,4,14,-10
IDN,FRA,2007.0,2,4,-2
DEU,NAM,2011.0,1,1,0
GBR,BGR,2017.0,3,12,-9
USA,LUX,2021.0,9,5,4
CHL,NLD,2011.0,3,3,0
DNK,CHN,2005.0,7,7,0
AUT,KEN,2013.0,2,1,1
AUS,KEN,2009.0,1,2,-1
GRC,BEL,2002.0,8,3,5
TUR,NOR,2009.0,4,1,3
CHN,IRQ,2011.0,2,2,0
FIN,CZE,2018.0,5,3,2
BGR,POL,2013.0,2,7,-5
AUT,SWE,2015.0,21,21,0
DEU,NPL,2018.0,4,2,2
USA,SVN,2019.0,10,10,0
LUX,BEL,2011.0,5,14,-9
PRI,SWE,2009.0,1,1,0
NOR,JPN,2017.0,3,7,-4
GAB,USA,2012.0,4,1,3
VEN,BRA,2007.0,2,6,-4
CHE,HRV,2012.0,4,6,-2
BOL,ESP,2019.0,2,1,1
SGP,JPN,2013.0,22,35,-13
USA,PRY,2019.0,1,2,-1
AUS,CZE,2018.0,5,5,0
BRA,NGA,2021.0,3,2,1
KEN,CAN,2021.0,5,2,3
NLD,PHL,2016.0,2,2,0
HKG,MYS,2015.0,3,6,-3
SRB,FRA,2004.0,2,1,1
AUS,NGA,2016.0,1,4,-3
NLD,ARG,2018.0,5,5,0
USA,SYR,2006.0,7,1,6
SRB,NOR,2017.0,2,1,1
PHL,GBR,2010.0,2,5,-3
KWT,IND,2017.0,3,7,-4
BFA,ZAF,2019.0,2,2,0
CAN,TWN,2019.0,10,16,-6
IRQ,PAK,2021.0,2,4,-2
CHE,BGR,2019.0,1,2,-1
OMN,IND,2021.0,12,14,-2
CAN,BGR,2018.0,3,2,1
TUR,IRL,2021.0,6,3,3
CHE,PHL,2015.0,4,2,2
PAK,CHN,2003.0,2,2,0
ESP,RUS,2003.0,7,8,-1
NZL,HKG,2007.0,4,1,3
SYR,USA,2011.0,2,3,-1
USA,SDN,2004.0,1,3,-2
FIN,AUT,2009.0,4,3,1
GBR,CMR,2008.0,5,1,4
KWT,IND,2019.0,5,5,0
SVN,IND,2021.0,1,6,-5
HRV,SRB,2011.0,10,8,2
TWN,KOR,2014.0,8,6,2
MYS,BEL,2010.0,1,1,0
GBR,SVK,2019.0,3,6,-3
HUN,FRA,2004.0,8,8,0
AUT,BRA,2016.0,6,4,2
CZE,POL,2007.0,3,5,-2
MOZ,FRA,2004.0,1,3,-2
JPN,ITA,2004.0,10,11,-1
AZE,KAZ,2021.0,1,1,0
KOR,ISR,2015.0,4,6,-2
MEX,RUS,1999.0,3,10,-7
CHE,SWE,2006.0,16,39,-23
USA,ZWE,2001.0,2,16,-14
DNK,ISR,2000.0,1,2,-1
DNK,CHN,2002.0,4,11,-7
NZL,IRL,2011.0,8,2,6
PAK,EST,2020.0,3,1,2
NOR,ZAF,2006.0,1,3,-2
GBR,SVK,2010.0,10,6,4
KOR,NOR,2017.0,4,3,1
IND,TTO,2013.0,3,1,2
HUN,TUR,2013.0,2,1,1
SDN,SWE,2016.0,2,1,1
NLD,LUX,2021.0,5,5,0
LKA,USA,2015.0,8,21,-13
DEU,BGR,2019.0,7,3,4
COG,ESP,2020.0,1,1,0
COG,FRA,2018.0,4,4,0
KOR,CHE,2007.0,7,2,5
MAC,TWN,2019.0,2,3,-1
GBR,LVA,2020.0,5,4,1
EGY,HUN,2018.0,3,3,0
GRC,TUR,2021.0,1,2,-1
SVN,AUT,2014.0,8,2,6
NOR,ESP,2016.0,10,31,-21
IRL,DNK,2022.0,2,7,-5
GRC,RUS,2019.0,1,1,0
THA,BGD,2021.0,1,2,-1
SAU,HKG,2020.0,6,5,1
BRA,EGY,2011.0,2,1,1
CHN,PHL,2021.0,3,4,-1
ZAF,SWE,2022.0,8,4,4
SWE,KWT,2008.0,1,1,0
IDN,CHE,2015.0,1,1,0
FRA,CIV,2004.0,12,12,0
ETH,SWE,2001.0,2,3,-1
GRC,PRT,2009.0,1,2,-1
GBR,LBN,2006.0,7,2,5
USA,TTO,1999.0,5,1,4
SEN,GBR,2016.0,2,1,1
RUS,LTU,2003.0,1,3,-2
LUX,SWE,2006.0,2,1,1
ESP,ROU,2002.0,3,1,2
QAT,CAN,2011.0,1,3,-2
FRA,VEN,2001.0,1,5,-4
AUT,NOR,2011.0,4,5,-1
SGP,POL,2018.0,2,1,1
AUT,FIN,2015.0,3,8,-5
JOR,SAU,2008.0,8,4,4
CHL,POL,2020.0,1,3,-2
SWE,BGR,2012.0,1,2,-1
CAN,SRB,2005.0,2,2,0
ITA,FIN,2001.0,6,8,-2
MEX,DNK,2005.0,3,1,2
BOL,ESP,2017.0,1,5,-4
SAU,ARE,2002.0,3,4,-1
BRA,RUS,2010.0,3,1,2
NZL,BRA,2008.0,2,2,0
UZB,USA,2007.0,3,1,2
ISL,NOR,2002.0,5,4,1
UKR,CHE,2007.0,1,1,0
ITA,PER,2017.0,2,1,1
BEL,MEX,2014.0,11,3,8
SWE,TUR,2001.0,2,1,1
RUS,SGP,2012.0,2,2,0
CZE,GRC,2009.0,1,1,0
CHE,SRB,2011.0,4,5,-1
AUS,SVK,2017.0,2,1,1
IRN,KOR,2009.0,2,2,0
CRI,DEU,2005.0,1,2,-1
BRN,SGP,2011.0,1,1,0
GNB,DNK,2018.0,3,3,0
AUS,BTN,2017.0,3,7,-4
FIN,ROU,2015.0,3,3,0
SDN,MYS,2017.0,4,12,-8
NER,BEL,2018.0,1,1,0
FRA,PER,2019.0,4,6,-2
BEL,BGD,2019.0,5,2,3
NZL,CZE,2014.0,2,2,0
GBR,PRI,2011.0,1,2,-1
ESP,PAK,2015.0,1,2,-1
FIN,CHE,2022.0,8,7,1
GHA,KOR,2015.0,2,3,-1
IRL,POL,2015.0,4,4,0
MAC,KOR,2022.0,1,1,0
MMR,THA,2020.0,3,6,-3
CAN,CUB,2004.0,2,2,0
CHL,ITA,2015.0,4,16,-12
SVN,HRV,2017.0,6,5,1
ARE,SAU,2004.0,3,2,1
SVN,FRA,2013.0,4,4,0
ROU,BRA,2012.0,2,1,1
FRA,HRV,1999.0,1,1,0
ISR,HUN,2019.0,2,4,-2
AUT,NLD,2004.0,5,11,-6
KEN,PAK,2019.0,7,6,1
USA,PRY,2017.0,2,2,0
IDN,VNM,2022.0,2,1,1
DNK,CHE,2005.0,9,10,-1
MNE,SRB,2022.0,5,3,2
BEL,HRV,2020.0,2,2,0
KEN,CHE,2008.0,3,1,2
SWE,MYS,2014.0,4,4,0
TUR,ISR,2005.0,3,3,0
ITA,CZE,2001.0,5,2,3
TWN,FRA,2002.0,5,3,2
NGA,BWA,2002.0,1,2,-1
LBN,ITA,2014.0,1,5,-4
DNK,NZL,2013.0,3,10,-7
DEU,CMR,2007.0,1,5,-4
SAU,JPN,2013.0,4,20,-16
USA,AZE,2010.0,2,1,1
CHL,ECU,2011.0,2,1,1
FRA,YEM,2009.0,1,1,0
TUN,CHE,2009.0,2,3,-1
GAB,GBR,2016.0,2,3,-1
SWE,ROU,2020.0,1,2,-1
RUS,IND,2007.0,4,2,2
SAU,DZA,2016.0,3,6,-3
LTU,GBR,1998.0,1,1,0
SVN,CAN,2021.0,1,1,0
BGR,RUS,2010.0,1,4,-3
SGP,KAZ,2021.0,1,1,0
PAK,IRN,2013.0,2,1,1
ESP,HKG,2016.0,1,5,-4
USA,TUN,2018.0,3,4,-1
SDN,MYS,2019.0,1,5,-4
SGP,CAN,2022.0,7,12,-5
CHE,EGY,2018.0,5,7,-2
CAN,CMR,2019.0,2,2,0
SWE,BGD,2013.0,2,2,0
ARE,SGP,2018.0,2,3,-1
PRT,ARG,2012.0,1,2,-1
NZL,POL,2019.0,1,1,0
THA,CHN,2013.0,5,6,-1
PAK,SGP,2012.0,5,4,1
BGR,ESP,1999.0,3,2,1
DEU,PSE,2014.0,4,4,0
SWE,KOR,2017.0,4,10,-6
TTO,AUS,2007.0,1,1,0
ITA,JOR,2017.0,2,1,1
HKG,TWN,2000.0,1,1,0
SWE,PRT,2002.0,6,3,3
COG,USA,2013.0,3,1,2
ARG,AUS,2015.0,3,6,-3
HRV,SGP,2016.0,1,1,0
AUS,PHL,2007.0,8,2,6
SAU,MAR,2016.0,1,2,-1
FRA,ZAF,2001.0,5,3,2
SVN,HRV,2010.0,6,4,2
SAU,ZAF,2012.0,3,10,-7
IRN,BEL,2008.0,4,6,-2
ZMB,COG,2017.0,1,1,0
JPN,GHA,2011.0,3,1,2
AUT,IND,2012.0,3,6,-3
CZE,BEL,2021.0,2,12,-10
EGY,PSE,2014.0,2,1,1
CHE,COL,2015.0,3,5,-2
MYS,KWT,2019.0,2,2,0
GBR,TZA,1999.0,2,4,-2
ITA,KAZ,2018.0,2,2,0
JOR,AUS,2013.0,6,7,-1
TZA,PAK,2021.0,2,3,-1
BHR,SAU,2008.0,2,1,1
NLD,SUR,2018.0,2,2,0
KEN,PAK,2017.0,2,8,-6
ISR,IRL,2008.0,4,1,3
CHL,KOR,2021.0,5,2,3
LKA,KOR,2020.0,2,6,-4
FRA,CAF,2015.0,3,3,0
AUT,CHN,1998.0,2,3,-1
FRA,KHM,2005.0,3,1,2
SVK,ITA,2009.0,3,7,-4
ARG,IRL,2011.0,1,3,-2
NIC,SWE,2005.0,2,1,1
TWN,SWE,2007.0,1,1,0
USA,LTU,2021.0,4,5,-1
ARG,NLD,2000.0,1,1,0
CUB,BRA,2001.0,4,3,1
GAB,FRA,2012.0,2,5,-3
ISL,DNK,1999.0,2,1,1
MDG,USA,2022.0,2,1,1
FIN,BEL,2004.0,3,4,-1
AUT,IRN,2005.0,2,1,1
CIV,BEL,2006.0,1,3,-2
CHE,THA,2014.0,5,2,3
CZE,ISR,2006.0,1,1,0
ITA,PER,2019.0,1,2,-1
PRT,CHL,2013.0,3,2,1
CHE,LAO,2014.0,1,3,-2
GBR,GIB,2018.0,1,1,0
PHL,GBR,2017.0,2,2,0
AUS,KWT,2018.0,4,3,1
LKA,SWE,2018.0,2,3,-1
ZAF,HKG,2014.0,1,2,-1
UKR,TUR,2015.0,1,1,0
GHA,ITA,2017.0,1,2,-1
KGZ,USA,2021.0,1,3,-2
SWE,TZA,2020.0,2,2,0
COG,NGA,2018.0,1,1,0
OMN,SAU,2014.0,5,4,1
BIH,AUT,2005.0,1,3,-2
KEN,CHN,2005.0,2,1,1
ECU,DEU,2012.0,3,1,2
SGP,NLD,1999.0,1,1,0
QAT,MYS,2020.0,1,12,-11
GBR,GMB,2014.0,4,5,-1
BHR,ARE,2018.0,4,2,2
DZA,ITA,2020.0,5,2,3
BGD,HKG,2011.0,1,1,0
PRT,NOR,2013.0,4,2,2
SVK,SVN,2011.0,1,6,-5
CAN,ZAF,2004.0,5,10,-5
BRB,IND,2012.0,1,1,0
CHE,NGA,2005.0,1,2,-1
UGA,NLD,2009.0,1,2,-1
ETH,FIN,2013.0,2,1,1
RUS,MEX,2015.0,2,1,1
ISL,DEU,2006.0,1,2,-1
COD,BEL,2008.0,1,1,0
BRA,JPN,2013.0,5,15,-10
NZL,KOR,2014.0,4,5,-1
KOR,ETH,2016.0,5,5,0
CYP,ITA,2021.0,2,1,1
AUT,ETH,2012.0,3,2,1
FRA,DJI,2013.0,1,4,-3
RUS,ARM,2011.0,3,8,-5
OMN,MYS,2004.0,1,1,0
SGP,IRL,2021.0,4,4,0
ITA,NPL,2010.0,1,2,-1
ESP,SVN,2018.0,5,6,-1
AZE,HUN,2021.0,3,1,2
SEN,MLI,2014.0,2,2,0
SVK,FIN,2018.0,1,1,0
LUX,MEX,2020.0,1,1,0
SAU,SRB,2020.0,1,2,-1
DEU,PHL,2013.0,4,5,-1
NGA,GMB,2015.0,1,3,-2
ETH,GBR,2022.0,3,1,2
KOR,KHM,2019.0,5,2,3
KWT,TUR,2021.0,1,1,0
EGY,LBY,2013.0,2,4,-2
AUS,LUX,2020.0,1,4,-3
LBY,MYS,2018.0,1,13,-12
GHA,DEU,2006.0,1,5,-4
AUS,KHM,2010.0,1,2,-1
NZL,CAN,1997.0,2,4,-2
ZAF,HUN,2020.0,2,2,0
BEL,BGD,2010.0,1,1,0
NPL,DEU,2013.0,2,6,-4
AUT,CHN,1997.0,1,1,0
MEX,PRI,2014.0,1,1,0
ISR,BRA,2019.0,1,9,-8
VUT,NCL,2016.0,3,1,2
NLD,BGR,2000.0,1,2,-1
CAN,TTO,2009.0,2,1,1
NZL,CAN,1998.0,1,8,-7
CZE,ZAF,2019.0,2,4,-2
JPN,TUN,2005.0,1,2,-1
NAM,DEU,2012.0,1,2,-1
AUS,BRN,2008.0,1,1,0
DOM,PER,2020.0,1,1,0
FIN,IND,2022.0,3,5,-2
CAN,MLI,2020.0,1,1,0
GUF,GUY,2014.0,1,2,-1
CAN,PER,2021.0,1,3,-2
SDN,NLD,2019.0,1,1,0
ITA,TWN,2009.0,1,1,0
NOR,UKR,2022.0,1,1,0
HUN,RUS,2004.0,1,1,0
FIN,GRC,2021.0,2,2,0
IND,MAR,2012.0,1,2,-1
LKA,IND,2022.0,1,2,-1
ARE,OMN,2020.0,1,4,-3
NPL,KOR,2007.0,2,1,1
SRB,NOR,2019.0,1,1,0
GEO,NOR,2017.0,1,1,0
LUX,AUT,2019.0,1,1,0
SVK,POL,2003.0,2,3,-1
USA,LIE,2004.0,1,1,0
ETH,IND,2011.0,4,18,-14
IRQ,TUR,2015.0,4,6,-2
NZL,SWE,2007.0,4,5,-1
EST,NZL,2016.0,1,1,0
PSE,USA,2012.0,1,6,-5
GBR,GAB,2019.0,1,3,-2
PRT,IND,2007.0,4,8,-4
NLD,SGP,2005.0,2,5,-3
IND,TUR,2021.0,2,7,-5
AGO,RUS,2017.0,1,1,0
ITA,JOR,2010.0,1,1,0
NGA,BEN,2013.0,1,3,-2
CHN,GHA,2012.0,1,4,-3
USA,NCL,2012.0,2,1,1
OMN,FRA,2018.0,1,2,-1
DNK,IRL,2012.0,1,6,-5
ITA,VEN,2003.0,1,1,0
BEL,TZA,2016.0,1,3,-2
CAN,CMR,2010.0,2,3,-1
ITA,CUB,2009.0,1,2,-1
IND,ARG,2016.0,1,2,-1
MLT,AUS,2008.0,1,1,0
ZAF,EGY,2022.0,1,1,0
GHA,ITA,2019.0,1,2,-1
FIN,IRL,2022.0,1,4,-3
JAM,GBR,2012.0,1,6,-5
GBR,ISL,2004.0,1,1,0
PLW,FSM,2004.0,1,1,0
ISR,ITA,1997.0,1,3,-2
SGP,COL,2020.0,2,1,1
IRQ,IRN,2022.0,1,7,-6
NOR,EGY,2016.0,1,1,0
MYS,CHE,2015.0,2,1,1
PAN,ESP,2003.0,1,3,-2
BRN,ARE,2018.0,1,1,0
PAN,ARG,2007.0,1,1,0
JPN,BGR,2008.0,1,2,-1
BEL,EGY,2013.0,1,4,-3
DNK,ISL,2004.0,4,2,2
BGD,NZL,2015.0,1,1,0
NGA,ITA,2011.0,1,2,-1
SWE,URY,2012.0,1,1,0
USA,YEM,2006.0,1,1,0
SWE,KAZ,2017.0,1,3,-2
LUX,NOR,2015.0,1,1,0
SAU,KAZ,2022.0,1,1,0
GRC,JPN,2014.0,1,2,-1
RUS,JOR,2010.0,2,1,1
TUR,NPL,2018.0,1,1,0
TUR,KOR,2021.0,2,4,-2
AUS,FJI,2012.0,2,8,-6
DEU,BWA,2020.0,1,1,0
CHE,KEN,2008.0,1,3,-2
PHL,THA,2020.0,1,6,-5
MAR,SAU,2018.0,1,2,-1
USA,AZE,2019.0,1,8,-7
ISR,ITA,1998.0,1,3,-2
MDA,DEU,2015.0,1,1,0
PRT,CAN,2000.0,1,1,0
AUS,IRQ,2007.0,1,1,0
RUS,HRV,2008.0,1,1,0
UGA,DEU,2004.0,1,1,0
AUT,RUS,2000.0,2,7,-5
QAT,ARE,2008.0,1,2,-1
PSE,ARE,2018.0,1,1,0
UGA,CAN,2015.0,1,2,-1
DEU,MLT,2020.0,1,1,0
CHN,MEX,2018.0,1,5,-4
MEX,PRT,2021.0,1,1,0
AUS,PRT,2005.0,1,4,-3
ISR,HUN,2010.0,1,2,-1
USA,LVA,2008.0,1,1,0
DEU,PRI,2006.0,1,1,0
FRA,BOL,2008.0,1,2,-1
SRB,AUT,2003.0,1,1,0
CAN,JAM,2020.0,1,2,-1
ZWE,CHE,2008.0,1,1,0
EGY,CHE,2004.0,1,1,0
EGY,SYR,2016.0,1,1,0
SRB,ROU,2009.0,1,1,0
VNM,TWN,2011.0,1,5,-4
HRV,ITA,2015.0,1,10,-9
ISR,BRA,2017.0,1,3,-2
EGY,MAR,2011.0,1,1,0
ZAF,JPN,2011.0,1,4,-3
EST,ITA,2009.0,1,1,0
MAR,PSE,2020.0,1,1,0
NLD,AUT,2017.0,28,23,5
DNK,JPN,2010.0,7,8,-1
FRA,USA,1999.0,321,234,87
CAN,USA,2004.0,1231,1186,45
DEU,USA,2016.0,1193,1149,44
GBR,HRV,2011.0,3,4,-1
GLP,FRA,2015.0,18,11,7
ITA,CHE,2006.0,100,74,26
KEN,USA,2019.0,60,49,11
CHE,GBR,2005.0,122,126,-4
CHE,GBR,2002.0,137,112,25
CAN,TWN,2017.0,9,12,-3
BRA,SWE,2010.0,9,6,3
ESP,PER,2013.0,10,7,3
USA,POL,2014.0,83,306,-223
IND,BRA,2017.0,22,12,10
CHN,NGA,2021.0,24,23,1
ESP,SAU,2017.0,6,3,3
MEX,ESP,2015.0,106,147,-41
SUR,NLD,2017.0,2,1,1
NOR,CHN,2019.0,26,29,-3
GBR,ZAF,2018.0,70,93,-23
IRL,DEU,2022.0,19,13,6
DEU,IRQ,2019.0,13,3,10
PYF,FRA,2017.0,15,6,9
EGY,AUS,2011.0,2,3,-1
AUS,NLD,2014.0,51,87,-36
FRA,DEU,2017.0,364,343,21
CHL,CAN,2020.0,16,15,1
KOR,NOR,2019.0,10,3,7
USA,DNK,2022.0,72,53,19
GBR,THA,2021.0,44,23,21
CHN,BGD,2012.0,4,8,-4
ESP,IRL,2016.0,38,17,21
BTN,AUS,2018.0,2,1,1
ARG,USA,2011.0,82,94,-12
ESP,POL,2020.0,14,22,-8
FRA,IND,2011.0,46,92,-46
DEU,PAK,2016.0,38,24,14
SWE,KOR,2019.0,9,10,-1
JPN,DNK,2011.0,8,7,1
POL,ITA,2001.0,14,9,5
HKG,SGP,2003.0,18,15,3
USA,BWA,2021.0,11,8,3
JPN,CHE,2007.0,22,39,-17
PRT,IRL,2003.0,3,3,0
JPN,SGP,2007.0,20,15,5
SGP,NZL,2007.0,7,6,1
EGY,RUS,2018.0,5,4,1
SWE,FIN,2016.0,43,73,-30
AUS,BTN,2019.0,3,4,-1
FRA,TUN,2021.0,34,61,-27
AUS,VNM,2021.0,40,37,3
PAK,THA,2015.0,4,10,-6
IND,PAK,2021.0,29,29,0
JOR,MYS,2021.0,5,27,-22
TTO,USA,2013.0,10,2,8
ISR,DEU,2014.0,42,45,-3
PHL,KOR,2007.0,3,2,1
AUS,ISR,2013.0,9,14,-5
AUS,DNK,2003.0,11,12,-1
USA,ISL,2013.0,10,10,0
UZB,KGZ,2007.0,2,1,1
AUT,ITA,2006.0,20,17,3
ISR,IND,2009.0,9,25,-16
NZL,ITA,2001.0,2,1,1
USA,ZAF,2002.0,69,72,-3
BRA,NLD,2003.0,6,10,-4
FRA,NCL,2002.0,8,8,0
SWE,LVA,2013.0,4,5,-1
NLD,KOR,2004.0,4,2,2
GBR,PRT,2001.0,27,23,4
BEL,ITA,2000.0,14,11,3
CZE,CAN,2015.0,8,10,-2
FIN,FRA,2004.0,10,13,-3
ISL,NOR,2005.0,1,5,-4
AUT,ESP,2017.0,18,27,-9
AUS,ZAF,2012.0,20,43,-23
SAU,IND,2014.0,25,123,-98
GBR,FIN,1999.0,11,15,-4
QAT,AUS,2016.0,5,16,-11
ROU,AUT,2012.0,4,1,3
USA,UKR,1998.0,6,19,-13
ARG,DEU,2004.0,21,8,13
BGD,PAK,2007.0,5,4,1
ITA,NPL,2017.0,2,2,0
SAU,DEU,2022.0,10,7,3
SVK,BEL,2012.0,3,1,2
HRV,GBR,2021.0,9,4,5
RUS,AZE,2000.0,4,3,1
ARG,FRA,2001.0,13,17,-4
NOR,HUN,2006.0,2,2,0
CAN,BGD,2022.0,8,19,-11
NGA,DEU,2018.0,5,7,-2
ZAF,BWA,2009.0,5,12,-7
AUT,SVK,2021.0,6,8,-2
KEN,USA,2010.0,26,38,-12
KAZ,RUS,2010.0,3,6,-3
DEU,COL,2007.0,3,10,-7
BRA,SWE,2017.0,16,11,5
NPL,ITA,2017.0,2,2,0
SVK,CAN,2021.0,1,1,0
IRL,SAU,2021.0,4,2,2
USA,EST,2006.0,6,2,4
CYP,USA,2002.0,4,7,-3
EGY,OMN,2008.0,3,1,2
NGA,NOR,2020.0,1,1,0
GRC,ITA,2006.0,10,18,-8
SWE,ETH,2012.0,2,2,0
VEN,COL,2004.0,2,1,1
PRT,BEL,2012.0,6,8,-2
ISR,TUR,2005.0,3,3,0
EGY,JOR,2013.0,2,1,1
IRN,NLD,2006.0,3,5,-2
PRT,RUS,2003.0,6,6,0
SWE,DNK,2000.0,16,21,-5
KOR,NOR,2010.0,4,2,2
KEN,ITA,2020.0,2,1,1
AUS,KHM,2019.0,2,2,0
NOR,JPN,2019.0,4,11,-7
KOR,KHM,2017.0,1,1,0
BEL,CMR,2022.0,1,2,-1
POL,NOR,2002.0,2,2,0
COL,CHE,2016.0,3,2,1
URY,BRA,2020.0,6,26,-20
QAT,ESP,2021.0,1,3,-2
RUS,BRA,2018.0,4,9,-5
VEN,CHL,2008.0,4,2,2
MAR,TUN,2017.0,3,4,-1
SWE,NGA,2005.0,2,1,1
ZAF,SGP,2007.0,2,1,1
BIH,HRV,2016.0,9,11,-2
MOZ,SWE,2019.0,1,1,0
MEX,CUB,2015.0,4,26,-22
CZE,UKR,2020.0,3,17,-14
ARE,CHN,2015.0,1,5,-4
HRV,DEU,2000.0,3,2,1
POL,MEX,2011.0,2,3,-1
NOR,JPN,2010.0,3,6,-3
POL,NOR,2005.0,2,1,1
HUN,SRB,2015.0,2,3,-1
CHE,SVN,2008.0,1,1,0
AUT,NZL,2011.0,3,2,1
BFA,USA,2014.0,1,2,-1
NOR,IRL,2008.0,1,3,-2
NOR,CHN,2010.0,5,21,-16
CUB,VEN,2008.0,1,1,0
GRC,SGP,2015.0,4,2,2
SWE,TWN,2014.0,2,1,1
ROU,DNK,2018.0,2,1,1
USA,NAM,2017.0,4,3,1
ITA,GHA,2016.0,1,1,0
THA,ITA,2002.0,3,1,2
EGY,POL,2002.0,1,5,-4
SVN,FIN,2013.0,1,1,0
TWN,FRA,2005.0,2,4,-2
MAR,TUN,2019.0,3,4,-1
GHA,ZAF,2009.0,1,2,-1
GBR,GAB,2017.0,1,2,-1
BGR,RUS,2019.0,3,8,-5
JPN,ROU,2016.0,3,2,1
VNM,RUS,2015.0,3,15,-12
PAK,NLD,2015.0,6,16,-10
DZA,CHN,2013.0,1,1,0
FRO,GBR,2022.0,1,1,0
RWA,SWE,2012.0,1,1,0
UKR,SGP,2009.0,1,1,0
BGR,HUN,2002.0,1,3,-2
ITA,IRQ,2008.0,1,1,0
EST,SWE,1997.0,1,1,0
BWA,KEN,2007.0,1,2,-1
CZE,HKG,2017.0,1,1,0
ZMB,NGA,2020.0,1,1,0
USA,GMB,2018.0,1,3,-2
URY,CHE,2015.0,1,1,0
SAU,ETH,2018.0,1,3,-2
IRL,BGR,2007.0,1,1,0
BRA,,2024.0,93647,0,93647
USA,,2010.0,49222,0,49222
RUS,,2009.0,3631,0,3631
USA,,2017.0,82152,0,82152
,CHN,2003.0,68570,0,68570
MAR,,2020.0,953,0,953
,JPN,2010.0,23672,0,23672
GBR,,2009.0,10391,0,10391
USA,,2019.0,96829,0,96829
POL,,2009.0,1997,0,1997
,SRB,2002.0,697,0,697
DEU,,2013.0,13679,0,13679
,USA,2012.0,90219,0,90219
SAU,,2021.0,2123,0,2123
JOR,,2014.0,171,0,171
EGY,,2023.0,13405,0,13405
SGP,BRN,2003.0,2,0,2
,SAU,2013.0,1906,0,1906
,TUR,2009.0,7287,0,7287
ROU,,2023.0,7007,0,7007
PRT,,2004.0,177,0,177
,GRC,2000.0,2828,0,2828
DNK,,2016.0,1657,0,1657
EST,,2014.0,150,0,150
KOR,,2003.0,1323,0,1323
CAN,,2003.0,1642,0,1642
,SRB,2005.0,1046,0,1046
HUN,,2021.0,1999,0,1999
,CHE,1997.0,1538,0,1538
MYS,,2018.0,2501,0,2501
SVN,,2014.0,342,0,342
,PRT,2001.0,1765,0,1765
,CMR,2006.0,180,0,180
BGR,,2002.0,39,0,39
MRT,,2009.0,4,0,4
,NPL,2002.0,158,0,158
,LTU,1997.0,169,0,169
SDN,,2012.0,72,0,72
,JPN,2017.0,19865,0,19865
JAM,,2009.0,15,0,15
,NGA,2006.0,1460,0,1460
,CHE,1998.0,5669,0,5669
,LTU,1998.0,272,0,272
,TWN,2010.0,7278,0,7278
BRA,MOZ,2011.0,1,0,1
UZB,,2011.0,61,0,61
PER,,2021.0,638,0,638
,CZE,1995.0,1397,0,1397
IND,LBY,2008.0,10,0,10
AUT,,2000.0,73,0,73
KOR,ARM,2014.0,1,0,1
BRB,,2008.0,9,0,9
,JOR,2011.0,390,0,390
ARE,,2019.0,280,0,280
,CUB,2011.0,637,0,637
UGA,ZMB,2017.0,1,0,1
,TWN,2017.0,5367,0,5367
,URY,2010.0,236,0,236
COG,,2018.0,80,0,80
,ARG,2014.0,2538,0,2538
,UKR,2011.0,1834,0,1834
,ZWE,2011.0,130,0,130
NOR,,2007.0,475,0,475
,LKA,2007.0,185,0,185
ARE,,2017.0,193,0,193
,NPL,2005.0,175,0,175
ATA,,2023.0,1,0,1
ARE,,2010.0,76,0,76
,TWN,2019.0,3594,0,3594
AGO,,2020.0,13,0,13
NER,,2021.0,49,0,49
GRC,IRL,2020.0,9,0,9
MDV,,2016.0,2,0,2
MYS,UZB,2019.0,2,0,2
DNK,ARG,2016.0,2,0,2
,JPN,2019.0,10689,0,10689
USA,MSR,2018.0,2,0,2
,BLR,2013.0,208,0,208
GIN,,2023.0,107,0,107
,URY,2017.0,175,0,175
,BHS,2009.0,5,0,5
,KHM,2013.0,52,0,52
GUM,,2022.0,12,0,12
TUN,PSE,2019.0,1,0,1
ESP,ARM,2015.0,1,0,1
,VEN,2009.0,468,0,468
,KWT,2009.0,136,0,136
BWA,TZA,2020.0,2,0,2
,SDN,2009.0,136,0,136
,BRN,2016.0,34,0,34
BGD,CZE,2018.0,2,0,2
ZMB,CAN,2020.0,1,0,1
,BWA,2018.0,73,0,73
,IRQ,2006.0,133,0,133
,FJI,2011.0,18,0,18
,NER,2015.0,22,0,22
PAK,KGZ,2009.0,1,0,1
AFG,AUS,2018.0,1,0,1
JPN,IRQ,2010.0,1,0,1
KEN,,2014.0,166,0,166
MLI,CAN,2014.0,1,0,1
QAT,DNK,2020.0,4,0,4
IRN,ISR,2010.0,2,0,2
ROU,NOR,2008.0,3,0,3
,CAF,2011.0,9,0,9
,GRL,2011.0,8,0,8
BGR,,2005.0,130,0,130
,UZB,2000.0,111,0,111
UKR,TWN,2007.0,3,0,3
FRA,KHM,2002.0,1,0,1
MYS,SRB,2021.0,2,0,2
SRB,GBR,2000.0,6,0,6
HKG,BRN,2018.0,1,0,1
PHL,DEU,2018.0,7,0,7
DEU,GIN,2018.0,1,0,1
NZL,MWI,2017.0,1,0,1
BRA,LUX,2019.0,2,0,2
GBR,GRL,2019.0,1,0,1
UKR,IRL,2016.0,1,0,1
CZE,MLI,2020.0,1,0,1
TZA,,2005.0,24,0,24
HKG,MEX,2021.0,1,0,1
IND,MWI,2022.0,1,0,1
GRC,AUS,2000.0,1,0,1
ESP,CMR,2010.0,1,0,1
,SYR,2005.0,50,0,50
COL,HUN,2022.0,1,0,1
,MRT,2018.0,9,0,9
THA,AUT,2007.0,3,0,3
CRI,,2012.0,55,0,55
MYS,NLD,2004.0,2,0,2
FRO,,2020.0,6,0,6
,LUX,1999.0,40,0,40
FRA,GAB,2022.0,2,0,2
,NAM,2000.0,16,0,16
,SYR,2002.0,40,0,40
ECU,COL,2005.0,2,0,2
SLV,DEU,2010.0,1,0,1
,UGA,1998.0,113,0,113
ZAF,BEL,1998.0,4,0,4
PNG,,2012.0,11,0,11
,DJI,1995.0,3,0,3
,GLP,1995.0,14,0,14
AND,,2018.0,5,0,5
SWE,SDN,2003.0,2,0,2
BLR,FRA,2005.0,4,0,4
,JAM,2006.0,55,0,55
USA,TZA,2001.0,2,0,2
NZL,POL,2010.0,1,0,1
JPN,ECU,2010.0,1,0,1
BEN,CMR,2007.0,1,0,1
BEL,GRC,2000.0,2,0,2
ESP,ECU,2001.0,1,0,1
SWE,MAC,2020.0,1,0,1
CUB,SRB,2002.0,1,0,1
,HTI,2003.0,9,0,9
,CYP,1994.0,33,0,33
BEL,NZL,2007.0,1,0,1
SGP,SWE,2000.0,1,0,1
HND,ITA,2022.0,1,0,1
BRA,PAN,2004.0,1,0,1
ZAF,KNA,2011.0,2,0,2
PNG,IND,2000.0,1,0,1
CIV,JPN,2016.0,1,0,1
,PRY,1995.0,8,0,8
MEX,DNK,2002.0,2,0,2
NLD,HKG,2007.0,3,0,3
LBR,NGA,2020.0,3,0,3
PRT,QAT,2014.0,3,0,3
AUS,BWA,2009.0,2,0,2
USA,PRY,2010.0,1,0,1
NLD,ARM,2004.0,1,0,1
SVN,AUS,2007.0,3,0,3
SWE,MLT,2013.0,2,0,2
USA,ASM,2016.0,1,0,1
HRV,SVK,2008.0,1,0,1
JPN,MDG,2005.0,1,0,1
,UGA,1997.0,8,0,8
LBN,FIN,2011.0,1,0,1
UGA,USA,1998.0,1,0,1
,BLZ,2010.0,3,0,3
KOR,KHM,2010.0,2,0,2
PSE,FIN,2011.0,1,0,1
CAN,BWA,2015.0,2,0,2
SRB,CYP,2021.0,1,0,1
,GMB,2009.0,16,0,16
,TCA,2010.0,1,0,1
,MOZ,2009.0,43,0,43
IND,IRQ,2016.0,13,0,13
NPL,SWE,2016.0,2,0,2
UKR,NGA,2011.0,1,0,1
MLT,ISL,2015.0,1,0,1
IRL,SGP,2005.0,1,0,1
KEN,PAK,2010.0,3,0,3
CRI,CHL,2022.0,2,0,2
ETH,ZWE,2018.0,1,0,1
,BLZ,2017.0,6,0,6
,URY,2019.0,89,0,89
SWE,ZMB,2005.0,1,0,1
TUR,,2003.0,231,0,231
BWA,POL,2010.0,1,0,1
BEL,GMB,2003.0,2,0,2
RUS,IRN,1999.0,2,0,2
CHE,GEO,2014.0,1,0,1
CUB,ECU,2015.0,25,0,25
CUB,ARG,2012.0,2,0,2
,BRB,1994.0,2,0,2
NOR,ZWE,2012.0,1,0,1
MUS,USA,2015.0,2,0,2
THA,ARE,2020.0,2,0,2
TWN,KEN,2018.0,2,0,2
OMN,QAT,2021.0,1,0,1
AUS,KHM,2017.0,1,0,1
GRC,NOR,2021.0,3,0,3
TUR,KWT,2020.0,3,0,3
BGD,NLD,2007.0,1,0,1
EST,EGY,2022.0,2,0,2
ETH,HUN,2020.0,1,0,1
ETH,NAM,2021.0,1,0,1
IRL,ISR,2013.0,2,0,2
MYS,KAZ,2018.0,1,0,1
AUT,BFA,2018.0,2,0,2
BFA,NGA,2005.0,1,0,1
BFA,GBR,2007.0,1,0,1
AUT,LIE,2014.0,2,0,2
SYR,DEU,1999.0,1,0,1
CUB,FRA,2008.0,1,0,1
ARG,NZL,2008.0,2,0,2
ZAF,BFA,1998.0,4,0,4
COL,AUS,1999.0,2,0,2
BWA,BHS,2021.0,1,0,1
CUB,DNK,2005.0,2,0,2
LKA,BRN,2012.0,2,0,2
BRA,TWN,2001.0,1,0,1
ITA,BFA,2019.0,2,0,2
BOL,MEX,2008.0,2,0,2
GTM,,2011.0,6,0,6
KOR,QAT,2014.0,1,0,1
TWN,HUN,2019.0,1,0,1
FJI,AUS,2007.0,11,0,11
SVK,ESP,2005.0,1,0,1
KHM,PNG,2009.0,1,0,1
NIC,,2012.0,8,0,8
ESP,SAU,2010.0,2,0,2
SLV,ESP,2010.0,2,0,2
HKG,GRC,2010.0,1,0,1
BRA,GTM,2011.0,1,0,1
VGB,USA,2013.0,1,0,1
PRT,NGA,2011.0,1,0,1
BLR,FRA,2002.0,6,0,6
KWT,IRL,2011.0,1,0,1
ITA,BGD,2014.0,3,0,3
ARE,GRC,2009.0,2,0,2
PAK,FIN,2021.0,4,0,4
NOR,BLR,2009.0,1,0,1
DOM,,2008.0,3,0,3
IRL,PAK,2012.0,1,0,1
LVA,CHE,2022.0,1,0,1
JPN,TUN,2002.0,1,0,1
GBR,GRD,2013.0,2,0,2
FRO,NOR,2008.0,2,0,2
ECU,,2008.0,12,0,12
NLD,COG,2011.0,1,0,1
FRA,NGA,2018.0,2,0,2
GBR,BRB,2010.0,2,0,2
GMB,,2008.0,8,0,8
CAN,MRT,2012.0,1,0,1
TZA,THA,2016.0,1,0,1
BOL,ESP,2010.0,3,0,3
JPN,ECU,2017.0,2,0,2
MEX,URY,2001.0,3,0,3
CHE,TUN,2012.0,1,0,1
MNE,,2014.0,9,0,9
BGR,SGP,2017.0,1,0,1
AUS,MOZ,2018.0,1,0,1
ISR,HUN,2017.0,3,0,3
AUT,EST,2020.0,1,0,1
ZAF,LBY,2021.0,2,0,2
NLD,CYP,2022.0,2,0,2
NPL,NGA,2010.0,1,0,1
RUS,NZL,2020.0,2,0,2
BRA,TUR,2021.0,2,0,2
CIV,TGO,2017.0,1,0,1
FIN,MWI,2020.0,1,0,1
TWN,PAK,2015.0,1,0,1
CZE,ECU,2013.0,1,0,1
LUX,,2001.0,2,0,2
BIH,,2003.0,2,0,2
BGR,OMN,2016.0,1,0,1
ZWE,AUT,2003.0,1,0,1
ZMB,GBR,2001.0,2,0,2
ISL,ISR,2014.0,3,0,3
LBN,GUM,2013.0,1,0,1
DZA,SAU,2008.0,3,0,3
ARG,ISR,1997.0,1,0,1
SGP,UKR,2005.0,1,0,1
SWE,ZMB,2002.0,1,0,1
RUS,CHL,2001.0,4,0,4
BLR,PRT,2003.0,2,0,2
MAR,DZA,2009.0,1,0,1
FIN,NZL,2002.0,1,0,1
MWI,CHE,1998.0,1,0,1
ECU,URY,2014.0,1,0,1
SRB,IRL,2013.0,2,0,2
CRI,GBR,2013.0,1,0,1
FRA,GUY,2007.0,2,0,2
,AGO,2001.0,2,0,2
ROU,CAN,1998.0,2,0,2
FRA,SVN,1999.0,1,0,1
MEX,MAR,2012.0,1,0,1
NPL,THA,2004.0,1,0,1
COD,ZAF,2010.0,1,0,1
UGA,USA,1997.0,5,0,5
HUN,CHN,2011.0,1,0,1
,REU,1998.0,5,0,5
SVK,PRT,2003.0,1,0,1
VNM,GHA,2010.0,1,0,1
FIN,KOR,2012.0,3,0,3
CAN,SVN,2005.0,2,0,2
PRT,IDN,2013.0,1,0,1
AUT,EGY,2014.0,4,0,4
GBR,BIH,2006.0,1,0,1
CAN,SLE,2021.0,1,0,1
NAM,CHE,2019.0,1,0,1
NLD,URY,2019.0,3,0,3
ETH,,2025.0,1,0,1
MAR,MLI,2018.0,3,0,3
TUN,MCO,2006.0,1,0,1
BRA,BEN,2002.0,1,0,1
KEN,BEN,2007.0,1,0,1
HRV,CZE,2007.0,1,0,1
ATG,,2022.0,4,0,4
SEN,GMB,2016.0,1,0,1
COL,URY,2012.0,1,0,1
MUS,MDG,2019.0,1,0,1
NAM,,2004.0,3,0,3
TUN,BEL,2007.0,2,0,2
FRA,HKG,1997.0,1,0,1
,BTN,2009.0,10,0,10
SGP,ETH,2012.0,1,0,1
GBR,PYF,2006.0,1,0,1
,MNE,1995.0,4,0,4
CAF,RWA,2015.0,1,0,1
BHR,EGY,2012.0,1,0,1
ETH,BWA,2019.0,1,0,1
IND,QAT,2007.0,2,0,2
JPN,UZB,1998.0,1,0,1
FRA,AND,2003.0,2,0,2
ITA,MDG,2018.0,1,0,1
CHE,BGR,2017.0,3,0,3
,TLS,2015.0,5,0,5
LVA,SVN,2014.0,1,0,1
SLB,AUS,2013.0,1,0,1
LBY,ARE,2018.0,1,0,1
VNM,BRA,2013.0,1,0,1
COG,RWA,2013.0,1,0,1
FRA,RWA,2018.0,1,0,1
AUS,MAC,2012.0,1,0,1
FIN,BGD,2022.0,1,0,1
MYS,UZB,2017.0,1,0,1
ISR,QAT,2018.0,2,0,2
ITA,UZB,2020.0,2,0,2
JOR,ESP,2007.0,1,0,1
BEN,JPN,2020.0,1,0,1
ETH,BWA,2017.0,1,0,1
ETH,BLR,2021.0,1,0,1
BFA,GMB,2016.0,1,0,1
LTU,FRA,2001.0,1,0,1
SWE,FJI,2018.0,2,0,2
CHL,HND,2013.0,1,0,1
KOR,IRL,2016.0,6,0,6
PRT,LTU,2011.0,1,0,1
,MTQ,2018.0,2,0,2
ARM,MEX,1999.0,1,0,1
CHE,MMR,2016.0,1,0,1
BFA,KEN,2018.0,2,0,2
BEN,TZA,2009.0,1,0,1
IND,RUS,2008.0,2,0,2
NPL,PAK,2009.0,1,0,1
SGP,KHM,2018.0,1,0,1
CIV,CHE,2016.0,1,0,1
ARM,FRA,2006.0,1,0,1
GRC,RUS,2017.0,4,0,4
MWI,BWA,2020.0,1,0,1
EST,BEL,2003.0,1,0,1
AUS,CMR,2014.0,1,0,1
SLB,MYS,2013.0,3,0,3
IND,BRN,2020.0,1,0,1
CAN,LBY,2005.0,1,0,1
COL,IRL,2020.0,1,0,1
PRI,CHE,2019.0,1,0,1
USA,NAM,2019.0,4,0,4
HND,,2004.0,2,0,2
IDN,THA,2008.0,1,0,1
ESP,VNM,1998.0,1,0,1
TCD,FRA,2002.0,2,0,2
ISR,LUX,2006.0,1,0,1
QAT,,2000.0,1,0,1
PRY,,2005.0,3,0,3
TZA,,2002.0,2,0,2
TUR,KAZ,2000.0,1,0,1
BHR,IND,2009.0,2,0,2
RUS,TUR,2022.0,2,0,2
ARG,ISR,1998.0,1,0,1
KWT,JPN,2002.0,1,0,1
FRA,SGP,2000.0,2,0,2
ETH,EGY,2011.0,1,0,1
CAN,BRN,2014.0,2,0,2
ZAF,BGR,2003.0,1,0,1
ERI,NLD,2004.0,1,0,1
MNG,,2025.0,1,0,1
TUR,SRB,2011.0,2,0,2
BHR,QAT,2007.0,1,0,1
CZE,CHL,2011.0,2,0,2
GRC,HKG,2013.0,2,0,2
EGY,SVK,2020.0,1,0,1
LBN,IRL,2022.0,1,0,1
GHA,GMB,2018.0,1,0,1
LVA,POL,2021.0,1,0,1
IND,MDV,2020.0,1,0,1
BDI,,2019.0,8,0,8
COL,TLS,2017.0,1,0,1
ESP,VEN,1997.0,2,0,2
BDI,,2017.0,6,0,6
JPN,KWT,2015.0,2,0,2
BRA,LUX,2017.0,1,0,1
LUX,DNK,2015.0,1,0,1
GBR,MNG,1999.0,1,0,1
FRA,SYC,2005.0,1,0,1
SEN,CIV,2007.0,1,0,1
FIN,,2025.0,4,0,4
EST,TUR,2015.0,2,0,2
GHA,GTM,2015.0,1,0,1
MYS,KWT,2017.0,4,0,4
DEU,DOM,2013.0,1,0,1
LTU,IRL,2004.0,1,0,1
ROU,SGP,2003.0,1,0,1
NZL,BOL,2004.0,1,0,1
LIE,USA,2014.0,1,0,1
SRB,TUR,2012.0,3,0,3
NLD,LBN,2013.0,1,0,1
CHL,BOL,2002.0,1,0,1
BEL,MLI,2006.0,1,0,1
USA,DJI,2016.0,1,0,1
MKD,FRA,2009.0,1,0,1
CHN,COD,2017.0,2,0,2
ESP,KAZ,2006.0,1,0,1
NZL,CYP,2018.0,1,0,1
PRT,HKG,2003.0,1,0,1
NZL,CMR,2012.0,1,0,1
SVK,NLD,2007.0,1,0,1
KHM,PER,2015.0,1,0,1
IND,VEN,2013.0,2,0,2
CHN,GRC,2013.0,2,0,2
ESP,SEN,2015.0,1,0,1
MWI,ZMB,2011.0,1,0,1
SVN,CZE,2010.0,1,0,1
SWE,ZWE,2018.0,1,0,1
LBY,SAU,2004.0,1,0,1
,BLZ,2019.0,2,0,2
TJK,,2006.0,1,0,1
AUT,PAK,2002.0,1,0,1
SWE,LBN,2015.0,1,0,1
LUX,KEN,2019.0,1,0,1
VEN,CAN,2015.0,2,0,2
CYP,CHN,2017.0,1,0,1
CAN,QAT,2001.0,2,0,2
GBR,MAC,2004.0,1,0,1
MWI,BEL,2019.0,2,0,2
GAB,KHM,2015.0,1,0,1
FRA,GTM,2019.0,1,0,1
BRB,AUS,2016.0,3,0,3
PHL,MAR,2021.0,2,0,2
BRA,KEN,2014.0,1,0,1
NGA,FRA,2014.0,1,0,1
TUR,HRV,2019.0,1,0,1
LBN,ESP,2015.0,1,0,1
MAR,GIN,2019.0,1,0,1
BGD,SGP,2002.0,1,0,1
NLD,CHL,2000.0,1,0,1
GRC,HRV,2022.0,1,0,1
KOR,MAR,2020.0,1,0,1
BLR,LBN,2018.0,1,0,1
PHL,COL,2005.0,1,0,1
NLD,CZE,1999.0,1,0,1
ARE,LVA,2015.0,1,0,1
BGD,QAT,2011.0,1,0,1
UKR,ROU,2022.0,2,0,2
SVN,CZE,2017.0,2,0,2
UKR,ARE,2019.0,1,0,1
NZL,ISL,2004.0,2,0,2
NOR,ARE,2005.0,1,0,1
BHR,IRL,2009.0,1,0,1
ARE,CHL,2013.0,1,0,1
AUT,TUR,2001.0,1,0,1
URY,MEX,2012.0,1,0,1
SEN,COL,2019.0,1,0,1
UKR,ESP,2007.0,1,0,1
GBR,CRI,2009.0,1,0,1
PAN,DNK,2017.0,1,0,1
ARM,ITA,2006.0,1,0,1
BRA,DZA,2016.0,1,0,1
DNK,LUX,2013.0,1,0,1
MLT,BEL,2001.0,1,0,1
PRT,ROU,2015.0,2,0,2
CHE,SVK,2014.0,1,0,1
GHA,DNK,2012.0,1,0,1
UGA,PNG,2018.0,1,0,1
KNA,NZL,2018.0,2,0,2
JOR,BHR,2022.0,1,0,1
CZE,HUN,2004.0,2,0,2
SDN,ITA,2013.0,1,0,1
COL,BGD,2018.0,1,0,1
ZAF,ESP,1998.0,1,0,1
ZWE,JPN,2020.0,1,0,1
MAR,GIN,2017.0,1,0,1
TZA,ISR,2008.0,1,0,1
IDN,KEN,2003.0,1,0,1
LUX,RWA,2003.0,2,0,2
CYP,AUS,2009.0,1,0,1
PRT,KEN,2019.0,1,0,1
BFA,ITA,2005.0,1,0,1
TUR,BIH,2007.0,1,0,1
HKG,TUR,2005.0,1,0,1
RUS,PAK,2009.0,2,0,2
COL,JPN,2000.0,1,0,1
LTU,GBR,1997.0,1,0,1
CZE,EGY,1998.0,1,0,1
COD,SEN,2018.0,1,0,1
POL,HKG,2007.0,1,0,1
MWI,SRB,2009.0,1,0,1
KWT,JPN,2005.0,1,0,1
AUS,SVK,2010.0,1,0,1
TUN,PRT,2009.0,1,0,1
MLI,KEN,2022.0,1,0,1
IND,SYR,2015.0,1,0,1
ISL,FIN,2016.0,1,0,1
PNG,CZE,2015.0,1,0,1
GBR,AGO,2001.0,1,0,1
LVA,RUS,2020.0,2,0,2
MDA,GBR,2007.0,1,0,1
CYP,CHE,2010.0,1,0,1
ITA,LBY,2020.0,2,0,2
CUB,KOR,2016.0,1,0,1
AUT,GRC,2007.0,3,0,3
TUR,CZE,2022.0,2,0,2
ZWE,COL,2010.0,1,0,1
RUS,VEN,2001.0,2,0,2
AUS,GMB,2004.0,1,0,1
KWT,ARE,1999.0,1,0,1
SSD,,2023.0,2,0,2
SRB,ESP,2006.0,1,0,1
BRB,USA,2021.0,1,0,1
DNK,BLR,2014.0,2,0,2
POL,NZL,2006.0,1,0,1
CRI,URY,2003.0,1,0,1
UKR,AUS,2013.0,1,0,1
ESP,PSE,2015.0,2,0,2
GTM,AUS,2011.0,1,0,1
MYS,TZA,2015.0,1,0,1
IRQ,FRA,2009.0,1,0,1
ROU,YEM,2003.0,1,0,1
CIV,TUN,2014.0,1,0,1
BEL,KEN,2012.0,2,0,2
SEN,NGA,2013.0,1,0,1
CUB,LUX,2016.0,1,0,1
,MYS,2020.0,9,0,9
TUN,IRL,2011.0,1,0,1
KAZ,JAM,2009.0,1,0,1
MWI,IRL,2012.0,1,0,1
SRB,CZE,2003.0,1,0,1
ALB,NOR,2011.0,1,0,1
PER,NZL,2007.0,1,0,1
TZA,IND,2004.0,1,0,1
BLR,CAN,2010.0,1,0,1
NAM,AUS,2007.0,1,0,1
COD,GNQ,2010.0,1,0,1
EGY,BEL,2000.0,2,0,2
PSE,CAN,2004.0,1,0,1
UZB,AUS,2005.0,1,0,1
ETH,USA,1999.0,2,0,2
CHE,MYS,1998.0,1,0,1
URY,SWE,2020.0,1,0,1
LBN,TUR,2011.0,1,0,1
MYS,BRN,2003.0,1,0,1
SGP,CHL,2004.0,1,0,1
SAU,ISR,2013.0,1,0,1
ARE,UZB,2018.0,1,0,1
DEU,YEM,2014.0,1,0,1
BEL,COD,2007.0,1,0,1
GRC,RUS,2010.0,2,0,2
UZB,TWN,2004.0,1,0,1
LBN,JPN,2007.0,1,0,1
IDN,NGA,2005.0,1,0,1
MAC,IRL,2016.0,1,0,1
BEN,BDI,2013.0,1,0,1
VNM,AUS,2000.0,2,0,2
TWN,SRB,2003.0,1,0,1
TUR,HRV,2010.0,1,0,1
GRC,EGY,2022.0,1,0,1
DOM,PRT,2020.0,1,0,1
PAK,HUN,2018.0,1,0,1
KWT,SAU,2008.0,1,0,1
ITA,LIE,2020.0,1,0,1
AUT,PAK,2005.0,1,0,1
RUS,JOR,2017.0,1,0,1
ESP,NPL,2021.0,1,0,1
CZE,QAT,2015.0,1,0,1
DEU,KGZ,2014.0,1,0,1
QAT,SWE,2021.0,1,0,1
MNG,DEU,2001.0,1,0,1
AGO,GBR,2016.0,1,0,1
GBR,MAR,2006.0,1,0,1
TZA,IRL,2020.0,1,0,1
ISL,ITA,2021.0,1,0,1
BRA,HRV,2004.0,1,0,1
SRB,NZL,2016.0,1,0,1
FRA,ALB,2020.0,1,0,1
YEM,RUS,2020.0,1,0,1
COG,SEN,2008.0,1,0,1
IND,COL,2003.0,1,0,1
NZL,NAM,2015.0,1,0,1
BGR,ISR,2015.0,1,0,1
ITA,BFA,2010.0,1,0,1
CCK,,2019.0,1,0,1
POL,TUR,2001.0,1,0,1
PHL,NPL,2010.0,1,0,1
CIV,USA,1999.0,1,0,1
HRV,DNK,2003.0,1,0,1
,PRK,2009.0,3,0,3
ARM,SAU,2022.0,1,0,1
TZA,KEN,2003.0,1,0,1
BIH,NOR,2005.0,1,0,1
BLR,CHN,2011.0,1,0,1
NER,ETH,2009.0,1,0,1
PRI,DOM,2013.0,1,0,1
IND,BEN,2010.0,1,0,1
BRA,HUN,2007.0,1,0,1
CYP,JPN,2000.0,1,0,1
DOM,AUS,2015.0,1,0,1
SDN,ZAF,2012.0,1,0,1
DEU,UZB,2002.0,2,0,2
KOR,TUR,2000.0,1,0,1
BIH,MNE,2008.0,2,0,2
PER,HKG,2020.0,1,0,1
EGY,MYS,2005.0,1,0,1
CRI,KHM,2016.0,1,0,1
ISR,COL,2016.0,1,0,1
SLV,DEU,2019.0,1,0,1
SAU,KHM,2018.0,1,0,1
PAK,LBY,2008.0,1,0,1
SLB,TWN,2011.0,1,0,1
NOR,PSE,2016.0,1,0,1
ISL,THA,2013.0,1,0,1
TLS,USA,2018.0,1,0,1
NOR,MOZ,2020.0,1,0,1
MAR,IND,2013.0,1,0,1
TUN,GUF,2020.0,1,0,1
YEM,SYR,2021.0,1,0,1
SDN,RUS,2020.0,1,0,1
USA,ESP,2007.0,321,295,26
CAN,USA,2014.0,1731,1381,350
MAR,TUN,2018.0,2,7,-5
USA,MEX,2004.0,146,121,25
ESP,FRA,2009.0,158,162,-4
AUS,HKG,2015.0,24,47,-23
USA,KOR,2012.0,944,644,300
FRA,DEU,2018.0,372,306,66
GRC,DEU,2012.0,53,42,11
KOR,FRA,2009.0,26,21,5
DEU,GBR,2014.0,616,577,39
AUS,TWN,2009.0,20,10,10
DZA,GBR,2005.0,3,1,2
USA,DEU,2002.0,1079,1232,-153
AUS,IND,2016.0,62,110,-48
NLD,SWE,2007.0,22,30,-8
AUS,USA,2012.0,475,587,-112
EGY,SAU,2009.0,159,53,106
NLD,ARG,2017.0,3,5,-2
USA,POL,2004.0,97,128,-31
BEL,EGY,2008.0,4,1,3
CHN,ESP,2016.0,30,37,-7
ISR,USA,2005.0,325,196,129
USA,AUS,2021.0,387,417,-30
BGD,USA,2007.0,13,10,3
USA,DEU,2005.0,896,1092,-196
CAN,CHN,2011.0,187,169,18
ISL,CHE,2010.0,2,1,1
NGA,ZAF,2009.0,20,8,12
USA,CZE,2009.0,38,36,2
ZAF,KEN,2016.0,21,12,9
USA,IND,2004.0,237,579,-342
KOR,CHN,2008.0,63,68,-5
NZL,GBR,2011.0,99,128,-29
AUS,CAN,2014.0,132,174,-42
KOR,DEU,2010.0,36,40,-4
CHL,COL,2014.0,19,21,-2
AUS,JPN,2013.0,48,61,-13
ISR,PSE,2010.0,17,6,11
AUT,ESP,2018.0,24,40,-16
PHL,DEU,2010.0,4,3,1
GBR,ISL,2014.0,6,3,3
PRT,ITA,2018.0,35,42,-7
FIN,TUR,2002.0,1,3,-2
GBR,NLD,2005.0,123,145,-22
JPN,NPL,2017.0,14,1,13
POL,USA,2007.0,105,82,23
IND,LBY,2013.0,5,2,3
UKR,DEU,2011.0,27,25,2
CAN,KOR,2003.0,23,24,-1
SVN,DEU,2013.0,7,4,3
SGP,CHE,2017.0,17,15,2
CAN,AUS,2020.0,145,181,-36
GBR,USA,2001.0,1055,827,228
JPN,USA,2020.0,677,649,28
NLD,POL,2012.0,25,13,12
DEU,ESP,2022.0,99,104,-5
ZAF,IND,2021.0,27,26,1
CHN,DNK,2012.0,32,23,9
FRA,PER,2018.0,12,11,1
JPN,TWN,2020.0,50,42,8
KOR,IDN,2016.0,22,10,12
ITA,ESP,2018.0,204,178,26
TWN,CHN,2017.0,176,96,80
POL,AUT,2018.0,8,10,-2
GBR,SDN,2012.0,5,4,1
CAN,CHE,2008.0,74,79,-5
CHN,GBR,2015.0,287,357,-70
GBR,ARE,2021.0,47,27,20
JPN,THA,2021.0,77,35,42
JPN,GBR,2020.0,90,119,-29
SWE,NLD,2016.0,44,63,-19
IRL,CAN,2019.0,49,42,7
JPN,ECU,2018.0,2,2,0
SGP,CAN,2016.0,27,27,0
NLD,IND,2021.0,31,42,-11
HKG,JPN,2014.0,10,13,-3
ITA,POL,2019.0,42,28,14
BRA,DEU,2022.0,42,29,13
LVA,CHE,2016.0,1,1,0
ISR,CAN,2021.0,47,45,2
CHN,SGP,2021.0,220,395,-175
SWE,POL,2016.0,14,18,-4
IRN,CHN,2017.0,22,3,19
ROU,FRA,2014.0,31,31,0
BEL,CHN,2013.0,35,30,5
CZE,SVK,2011.0,19,40,-21
GBR,ZAF,2017.0,64,103,-39
JPN,IND,2021.0,52,57,-5
CHN,KEN,2021.0,14,4,10
GBR,QAT,2017.0,37,16,21
SGP,AUS,2020.0,81,73,8
ROU,DNK,2017.0,4,2,2
ITA,NLD,2004.0,45,42,3
DNK,DEU,2012.0,63,96,-33
GBR,LKA,2015.0,21,8,13
GBR,HUN,2019.0,29,39,-10
GBR,ZAF,2019.0,83,89,-6
USA,CHL,2008.0,71,81,-10
KOR,DEU,2017.0,61,45,16
DEU,ISR,2012.0,30,39,-9
HKG,USA,2020.0,147,153,-6
IND,JPN,2021.0,57,52,5
FRA,CHN,2022.0,119,63,56
NOR,ESP,2022.0,5,12,-7
CHN,JPN,2021.0,256,380,-124
RUS,CHN,2020.0,27,26,1
KOR,DEU,2019.0,83,49,34
IND,ZAF,2022.0,18,13,5
HUN,SWE,2000.0,10,5,5
AUS,PAK,2020.0,22,46,-24
IND,SGP,2015.0,74,53,21
USA,IRL,2022.0,49,46,3
NOR,USA,2020.0,55,99,-44
HKG,ITA,2016.0,1,1,0
KOR,DNK,2020.0,9,4,5
CAN,MEX,2016.0,30,35,-5
ITA,GRC,2015.0,22,42,-20
CZE,USA,2021.0,42,36,6
GBR,DNK,2021.0,99,78,21
DEU,SDN,2011.0,3,1,2
QAT,USA,2014.0,19,65,-46
USA,LBY,2001.0,1,1,0
DEU,POL,2001.0,52,36,16
DEU,DNK,2022.0,68,37,31
IRN,CHN,2019.0,60,13,47
NZL,IDN,2016.0,6,3,3
KEN,USA,2018.0,64,52,12
GRC,NLD,2019.0,29,25,4
USA,KEN,2016.0,55,57,-2
NLD,IDN,2021.0,21,19,2
MYS,BEL,2018.0,4,1,3
PAK,BGD,2015.0,5,13,-8
MEX,ECU,2020.0,11,9,2
KAZ,RUS,2018.0,31,33,-2
COL,MEX,2018.0,43,62,-19
CHN,MYS,2011.0,5,2,3
NGA,CAN,2018.0,15,12,3
MNG,USA,2021.0,2,2,0
NGA,DEU,2017.0,8,9,-1
NLD,AUT,2018.0,37,32,5
MYS,IND,2022.0,20,13,7
MAC,TWN,2018.0,5,3,2
IND,AUS,2020.0,133,75,58
USA,TUN,2017.0,7,9,-2
PHL,DEU,2019.0,12,5,7
GHA,AUS,2020.0,19,6,13
FRA,BRA,2021.0,57,117,-60
RUS,NLD,2020.0,26,11,15
IRL,ESP,2019.0,25,34,-9
IDN,AUS,1999.0,2,1,1
DEU,NPL,2019.0,4,4,0
ITA,GBR,2022.0,156,219,-63
CHN,MEX,2019.0,5,8,-3
ISR,USA,2002.0,334,267,67
EGY,RUS,2019.0,3,12,-9
USA,DNK,2016.0,142,147,-5
HUN,RUS,2014.0,1,3,-2
NPL,IND,2006.0,15,14,1
USA,QAT,2021.0,34,40,-6
FIN,CHE,2016.0,20,12,8
MEX,AUS,2021.0,7,5,2
NLD,CAN,2014.0,58,58,0
ISL,SWE,2021.0,14,15,-1
JOR,SAU,2013.0,36,15,21
DEU,ITA,2021.0,211,213,-2
VEN,COL,2014.0,21,3,18
MYS,JOR,2017.0,18,8,10
TUR,CAN,2020.0,43,15,28
USA,HUN,2005.0,60,71,-11
NOR,CHN,2018.0,25,29,-4
QAT,ARE,2013.0,1,5,-4
USA,ROU,2008.0,24,21,3
IRL,DEU,2016.0,46,34,12
CAN,SGP,2008.0,19,32,-13
GBR,ZAF,2010.0,87,68,19
BRA,JPN,2008.0,12,11,1
TWN,CHN,2010.0,57,62,-5
IRL,EGY,2014.0,4,1,3
TUR,FIN,2011.0,3,6,-3
CAN,ZAF,2014.0,21,18,3
DEU,SVK,2009.0,11,13,-2
EGY,USA,2009.0,56,104,-48
JPN,EGY,2016.0,41,25,16
GBR,MLT,2012.0,9,3,6
USA,IRN,2016.0,80,547,-467
BRA,GBR,2012.0,52,73,-21
IRN,CHN,2010.0,2,2,0
FRA,NGA,2010.0,2,1,1
HKG,SGP,2001.0,17,14,3
NOR,JPN,2018.0,6,6,0
DEU,IRL,2021.0,27,23,4
USA,BEL,2008.0,106,108,-2
RUS,JPN,2009.0,16,15,1
SWE,ESP,2021.0,43,59,-16
GMB,GBR,2016.0,4,6,-2
TUR,CZE,2016.0,2,4,-2
EGY,OMN,2013.0,1,4,-3
IRL,DNK,2016.0,4,10,-6
ESP,MEX,2004.0,70,54,16
DEU,TUR,2012.0,29,36,-7
TWN,DEU,2004.0,11,7,4
AUS,UGA,2022.0,2,1,1
DNK,USA,2001.0,86,84,2
NLD,CHN,2014.0,63,90,-27
NLD,PRT,2012.0,22,23,-1
LTU,ESP,2014.0,2,1,1
BGR,USA,2015.0,14,6,8
FRA,MAR,2012.0,92,42,50
MYS,JOR,2019.0,27,12,15
VEN,ESP,2002.0,18,9,9
BRA,NLD,2001.0,10,5,5
IND,TWN,2007.0,48,16,32
BRA,AUS,2008.0,21,4,17
OMN,MYS,2014.0,4,8,-4
IND,LUX,2021.0,7,1,6
BRA,FRA,2007.0,58,57,1
BRA,PAN,2014.0,1,1,0
CZE,DEU,2020.0,41,60,-19
CHE,FIN,2011.0,8,23,-15
ISR,CHE,2011.0,11,14,-3
USA,HUN,2002.0,61,78,-17
DEU,CAN,1999.0,53,36,17
UKR,GBR,2002.0,13,8,5
ESP,HUN,2005.0,2,2,0
KOR,NZL,2006.0,4,3,1
AUS,CZE,2019.0,11,7,4
CHE,EGY,2019.0,7,9,-2
UGA,AUS,2017.0,6,2,4
IND,GBR,1997.0,9,7,2
ISR,PSE,2019.0,16,10,6
IND,FIN,2021.0,23,5,18
NZL,IRN,2017.0,9,12,-3
KOR,AUS,2009.0,14,10,4
GBR,HUN,2017.0,36,48,-12
ESP,FIN,2020.0,24,16,8
BTN,AUS,2017.0,7,3,4
BEL,FIN,2019.0,10,13,-3
BEN,MLI,2020.0,1,1,0
PYF,FRA,2018.0,10,20,-10
FRA,ECU,2020.0,7,4,3
IDN,KOR,2018.0,10,26,-16
ZAF,USA,2022.0,44,26,18
SUR,NLD,2018.0,2,2,0
ROU,DEU,2020.0,15,12,3
SGP,CHE,2019.0,25,18,7
USA,MWI,2020.0,29,21,8
MWI,USA,2016.0,9,19,-10
ROU,ITA,2020.0,11,9,2
ARE,KOR,2020.0,3,18,-15
BTN,AUS,2019.0,4,3,1
CHN,SAU,2014.0,22,12,10
ITA,ARG,2021.0,7,22,-15
DNK,MYS,2011.0,4,1,3
CAN,TWN,2018.0,10,14,-4
FRA,GAB,2016.0,10,8,2
DNK,AUS,2001.0,18,17,1
ZAF,GBR,2005.0,50,57,-7
ESP,HUN,2002.0,1,3,-2
NGA,DEU,2019.0,7,7,0
IDN,HKG,2022.0,2,3,-1
ESP,IRL,2022.0,17,19,-2
RUS,PRT,2014.0,5,1,4
GBR,PRT,2003.0,47,25,22
CMR,USA,2019.0,7,4,3
CHE,DNK,2016.0,30,35,-5
AUS,THA,2014.0,34,21,13
CHE,BGR,2018.0,3,1,2
POL,RUS,2006.0,3,14,-11
VEN,ESP,2005.0,19,12,7
IND,IRN,2012.0,20,5,15
GBR,ZMB,2012.0,5,1,4
HRV,SVN,2008.0,5,2,3
GBR,SVK,2018.0,6,7,-1
FRA,CIV,2014.0,18,19,-1
AUS,CZE,2017.0,9,7,2
DEU,UGA,2008.0,4,1,3
FRA,AUS,2022.0,33,29,4
BEL,RUS,2013.0,4,6,-2
ZAF,NAM,2015.0,7,6,1
AUT,FRA,2007.0,19,23,-4
ESP,CHN,2012.0,14,13,1
BFA,FRA,2006.0,8,5,3
ROU,BEL,2011.0,6,8,-2
AUS,ISR,2008.0,12,4,8
ESP,BEL,2006.0,11,23,-12
USA,NOR,2011.0,68,45,23
CHE,EGY,2010.0,8,3,5
SAU,JOR,2009.0,5,17,-12
SAU,DZA,2022.0,2,6,-4
COL,ARG,2002.0,8,2,6
GBR,HUN,2010.0,25,27,-2
ISR,BEL,2002.0,4,4,0
IRL,ESP,2010.0,17,6,11
GBR,BGR,2018.0,5,4,1
RUS,ITA,2018.0,22,18,4
ARG,MEX,2010.0,7,13,-6
DEU,NOR,2005.0,35,12,23
IND,GBR,1998.0,8,15,-7
BGR,JPN,2011.0,2,3,-1
SRB,MKD,2006.0,3,10,-7
GHA,KEN,2013.0,1,2,-1
FIN,AUS,2006.0,7,9,-2
DEU,SWE,1997.0,22,7,15
CAN,SWE,2002.0,26,35,-9
BEL,CZE,2009.0,4,6,-2
AUS,CHE,2008.0,45,39,6
GBR,NZL,2001.0,66,54,12
DEU,NOR,2002.0,20,14,6
BEL,ISR,2001.0,4,3,1
NZL,JPN,1998.0,1,1,0
BEL,FIN,2010.0,2,5,-3
USA,TZA,2003.0,12,2,10
FRA,AUT,2007.0,23,19,4
ZAF,GBR,2002.0,53,55,-2
ROU,USA,2006.0,28,18,10
USA,ISL,2008.0,10,12,-2
ITA,CZE,2003.0,6,4,2
NLD,RUS,2004.0,9,17,-8
NZL,FRA,2015.0,17,10,7
POL,ITA,2003.0,16,22,-6
GBR,NOR,2004.0,33,24,9
UKR,GBR,2005.0,15,4,11
SWE,CHE,2009.0,30,24,6
ZAF,CAN,2004.0,10,5,5
USA,THA,2000.0,13,13,0
ITA,BGR,2009.0,5,2,3
MEX,CAN,2002.0,14,20,-6
CAN,SWE,2005.0,22,36,-14
DZA,DEU,2010.0,3,2,1
JPN,MYS,2003.0,10,7,3
EGY,HUN,2019.0,3,2,1
COG,FRA,2010.0,5,6,-1
SWE,SRB,2009.0,1,2,-1
TWN,AUS,2011.0,13,14,-1
NLD,ZAF,2018.0,21,19,2
CAN,FIN,2005.0,11,17,-6
ESP,CHE,2007.0,21,39,-18
CHE,AUT,2003.0,20,33,-13
VNM,FRA,2004.0,2,5,-3
POL,ARG,2003.0,1,1,0
HUN,JPN,2002.0,11,7,4
SGP,JPN,2008.0,10,30,-20
FRA,ARG,1998.0,6,5,1
SVN,SVK,2014.0,5,3,2
AUT,USA,2000.0,34,28,6
TWN,GBR,1999.0,3,10,-7
NOR,CAN,2015.0,16,22,-6
POL,JPN,1997.0,7,3,4
USA,PHL,2014.0,21,27,-6
AUS,POL,2011.0,16,5,11
FIN,EST,2011.0,10,7,3
NLD,EST,2020.0,7,2,5
CAN,FIN,2002.0,15,23,-8
CAN,ROU,2002.0,4,11,-7
CAN,BEL,2000.0,4,5,-1
NOR,NLD,2006.0,7,15,-8
SAU,GBR,2003.0,14,19,-5
ITA,AUT,2012.0,33,28,5
BLR,RUS,2011.0,12,11,1
AUS,DNK,2001.0,17,18,-1
SWE,CZE,1998.0,2,2,0
GRL,DNK,2003.0,2,2,0
ESP,RUS,2001.0,11,14,-3
HUN,AUS,2009.0,2,2,0
RUS,ESP,2011.0,14,5,9
AUT,POL,1998.0,2,1,1
SWE,GBR,1999.0,32,24,8
TUR,AZE,2017.0,10,3,7
IRL,CAN,2010.0,25,28,-3
USA,MAC,2007.0,6,1,5
CHE,IRL,2007.0,11,6,5
SAU,IND,2004.0,5,6,-1
JPN,ITA,2014.0,19,21,-2
GBR,KNA,2015.0,1,1,0
IRL,AUS,2001.0,10,21,-11
ESP,ECU,2003.0,1,1,0
HUN,NOR,2005.0,1,1,0
BRA,CHE,1998.0,2,1,1
CHE,ISR,2001.0,5,4,1
USA,TUN,2010.0,4,5,-1
IND,CHN,2005.0,9,3,6
BLR,KOR,2003.0,2,1,1
BGR,ITA,2008.0,6,5,1
SWE,ZAF,2012.0,5,8,-3
AUS,SAU,2009.0,5,6,-1
CAN,PRT,2011.0,7,3,4
GRC,NLD,2010.0,12,14,-2
PAN,USA,2020.0,15,16,-1
AUS,AUT,2006.0,16,12,4
ZAF,ITA,2004.0,3,5,-2
RUS,CAN,2012.0,22,10,12
PRT,CHL,2008.0,2,1,1
USA,COG,2009.0,6,3,3
MYS,JOR,2010.0,8,2,6
ROU,GRC,2006.0,1,3,-2
SVN,NLD,2011.0,2,4,-2
DNK,JPN,2018.0,6,6,0
UKR,FRA,2007.0,7,2,5
GBR,SVN,2009.0,14,4,10
GRC,JPN,2004.0,1,3,-2
CMR,USA,2010.0,4,3,1
THA,VNM,2012.0,5,1,4
SWE,IRL,2012.0,6,7,-1
USA,GUM,2005.0,4,4,0
AUS,BRN,2013.0,4,5,-1
OMN,NZL,2015.0,3,1,2
FIN,IRL,2016.0,4,8,-4
TTO,USA,2008.0,7,9,-2
ESP,JPN,2021.0,6,18,-12
HUN,FRA,2014.0,12,14,-2
BEL,AUT,2013.0,12,10,2
ESP,PER,2008.0,7,8,-1
DEU,ZAF,2015.0,32,27,5
SVK,DEU,2015.0,10,6,4
NZL,THA,2020.0,3,6,-3
UKR,ITA,2016.0,7,2,5
USA,PER,2020.0,34,54,-20
NLD,JPN,2022.0,11,10,1
BIH,GBR,2014.0,2,1,1
ITA,POL,2017.0,22,20,2
SVK,CHE,2017.0,6,4,2
TUR,SWE,2021.0,14,5,9
MAC,KOR,2016.0,1,1,0
BEL,JPN,2019.0,11,10,1
VEN,PER,2020.0,6,1,5
CHL,GBR,2021.0,33,34,-1
CHE,VNM,2014.0,4,3,1
TTO,GBR,2011.0,4,7,-3
PSE,GBR,2019.0,2,8,-6
THA,MMR,2015.0,2,1,1
JOR,FRA,2015.0,3,1,2
HKG,GBR,2015.0,42,61,-19
SWE,KOR,2018.0,11,15,-4
USA,TUN,2019.0,6,2,4
USA,OMN,2021.0,2,4,-2
KWT,IND,2018.0,3,7,-4
NLD,SUR,2019.0,6,1,5
SRB,CHE,2006.0,1,3,-2
IND,AUT,2022.0,8,3,5
ESP,COL,2022.0,18,28,-10
CMR,KEN,2021.0,3,1,2
MYS,NZL,2021.0,16,7,9
QAT,JPN,2022.0,2,1,1
LKA,CHN,2021.0,3,3,0
LBY,EGY,2012.0,4,4,0
FRA,VEN,2003.0,8,4,4
DEU,JOR,2014.0,13,5,8
CZE,DNK,2009.0,3,2,1
CRI,BRA,2015.0,3,1,2
USA,JOR,2005.0,34,14,20
AUT,CHE,1999.0,11,17,-6
ITA,RUS,1999.0,8,32,-24
ITA,FIN,2003.0,6,10,-4
AUT,PRT,2009.0,3,5,-2
GMB,USA,2003.0,3,2,1
FRA,KOR,2007.0,17,9,8
FRA,ISR,2011.0,15,15,0
AUS,ESP,2012.0,20,37,-17
BEL,MEX,2004.0,2,3,-1
IND,BGD,2004.0,8,4,4
KEN,PAK,2018.0,6,7,-1
IRN,THA,2020.0,3,2,1
AUS,MOZ,2019.0,1,1,0
CHE,MEX,2006.0,4,3,1
DEU,MEX,2013.0,33,30,3
SVN,FRA,2008.0,3,1,2
PSE,DEU,2011.0,2,6,-4
POL,CAN,2012.0,16,36,-20
THA,MAC,2021.0,1,1,0
SAU,PAK,2007.0,11,12,-1
AUS,SYC,2021.0,1,1,0
KOR,SWE,2022.0,8,4,4
BRA,AUT,2006.0,5,2,3
EGY,CHN,2003.0,2,1,1
USA,PAN,2011.0,16,11,5
SWE,ISL,2018.0,11,17,-6
SWE,UKR,2021.0,2,2,0
UGA,AUS,2019.0,2,4,-2
ARE,SGP,2017.0,4,5,-1
UKR,SWE,2016.0,8,6,2
ARG,FRA,2003.0,18,15,3
FRA,MDG,2011.0,9,13,-4
BGD,IND,2007.0,3,7,-4
DEU,BGR,2018.0,14,2,12
BEL,JPN,2017.0,17,10,7
ITA,HUN,2011.0,10,8,2
BEL,BGD,2018.0,5,5,0
BRA,PER,2013.0,8,14,-6
DEU,SVN,2022.0,5,8,-3
CHE,JPN,2013.0,22,39,-17
DEU,IRQ,2018.0,7,3,4
CMR,ZAF,2015.0,6,7,-1
SDN,MYS,2018.0,2,13,-11
AUS,KHM,2018.0,5,1,4
BGD,IRL,2012.0,2,1,1
DNK,ISL,2014.0,5,3,2
SAU,KWT,2015.0,3,4,-1
ARE,USA,2006.0,8,26,-18
FIN,PER,2009.0,1,1,0
ESP,CRI,2005.0,2,3,-1
COG,FRA,2019.0,2,3,-1
NZL,SGP,2015.0,11,21,-10
IRN,PAK,2015.0,2,2,0
ESP,SAU,2018.0,7,2,5
KOR,IND,2006.0,16,71,-55
KOR,IRL,2022.0,2,2,0
USA,PRY,2018.0,2,3,-1
POL,BEL,2009.0,5,6,-1
RWA,SAU,2013.0,1,2,-1
SRB,ITA,2009.0,3,4,-1
SVN,GRC,2013.0,1,2,-1
ITA,POL,2010.0,19,8,11
BEN,DEU,2006.0,1,2,-1
CMR,USA,2017.0,9,2,7
COL,CAN,2000.0,1,3,-2
GRC,HRV,2016.0,2,1,1
BEL,DNK,2003.0,4,5,-1
PRT,BRA,2000.0,9,15,-6
FIN,IND,2016.0,6,14,-8
ZWE,GBR,2002.0,5,4,1
COL,ESP,2001.0,5,10,-5
GBR,IRN,1999.0,8,1,7
BRA,POL,2003.0,2,1,1
CHE,RUS,2015.0,16,20,-4
SWE,CZE,1997.0,1,1,0
NZL,JPN,1997.0,2,3,-1
HUN,JPN,2005.0,2,1,1
AUS,KWT,2017.0,4,1,3
COL,GBR,2005.0,3,10,-7
BEL,JPN,2010.0,11,6,5
RUS,BRA,2019.0,6,10,-4
PHL,CHE,2012.0,1,4,-3
KOR,HKG,2012.0,4,5,-1
POL,EGY,2012.0,2,6,-4
FIN,BRA,2007.0,1,2,-1
ETH,GBR,2016.0,4,13,-9
DNK,IRN,2011.0,5,10,-5
NGA,GHA,2008.0,3,1,2
CHL,SWE,2012.0,3,3,0
GBR,GIB,2019.0,1,1,0
USA,CRI,2009.0,6,15,-9
DEU,PHL,2008.0,3,5,-2
PAK,KOR,2008.0,5,3,2
CAN,VEN,2011.0,2,1,1
POL,BGR,2014.0,6,1,5
USA,MYS,2007.0,18,20,-2
ROU,IRL,2008.0,2,1,1
JOR,CAN,2014.0,8,10,-2
IND,KWT,2015.0,5,1,4
LBY,SAU,2014.0,5,1,4
SDN,SAU,2011.0,6,10,-4
NZL,BGR,2018.0,1,1,0
NLD,KOR,2014.0,5,10,-5
COL,VEN,2007.0,5,3,2
GBR,MAC,2014.0,6,1,5
KAZ,UKR,2020.0,3,2,1
PRT,MEX,2011.0,1,3,-2
ARE,NZL,2018.0,3,3,0
MYS,CAN,2003.0,2,2,0
FIN,RUS,2021.0,9,27,-18
SVN,HRV,2018.0,13,8,5
BEL,FIN,2017.0,8,7,1
ITA,KAZ,2017.0,4,2,2
NOR,GRC,2020.0,3,9,-6
SVK,USA,2012.0,4,6,-2
DEU,LVA,2007.0,3,2,1
TWN,KOR,2004.0,4,7,-3
IND,BRA,2018.0,12,14,-2
LKA,CAN,2014.0,1,4,-3
SGP,POL,2017.0,1,4,-3
SWE,FIN,2022.0,14,17,-3
CHN,LTU,2018.0,1,1,0
PHL,GBR,2018.0,5,6,-1
PHL,AUS,2016.0,7,15,-8
ARE,CAN,1999.0,2,4,-2
EGY,CAN,2022.0,15,16,-1
USA,MNE,2002.0,1,1,0
BRA,RUS,2018.0,9,4,5
DZA,BEL,2006.0,1,2,-1
NOR,NZL,2014.0,5,10,-5
TWN,HKG,2001.0,5,7,-2
USA,IRQ,2011.0,2,4,-2
NZL,IRN,2019.0,2,32,-30
TUR,IRQ,2021.0,10,9,1
ZWE,GBR,2005.0,6,1,5
ESP,IRN,2009.0,3,4,-1
CUB,BRA,2003.0,4,5,-1
GHA,ITA,2018.0,2,2,0
GBR,EST,2014.0,6,7,-1
GBR,GMB,2004.0,11,6,5
ARG,ECU,2012.0,2,3,-1
DNK,PHL,2013.0,1,1,0
BGD,FRA,2014.0,1,1,0
TUR,ESP,2011.0,8,6,2
CAN,MDG,2022.0,1,1,0
VEN,ITA,2010.0,4,2,2
SWE,GHA,2012.0,3,1,2
USA,NAM,2018.0,2,3,-1
LBY,MYS,2019.0,1,18,-17
FIN,CZE,2017.0,4,3,1
IND,PHL,2014.0,6,2,4
DEU,PAK,2022.0,10,16,-6
EST,FRA,2016.0,1,1,0
ITA,GEO,2011.0,1,1,0
MYS,YEM,2012.0,11,5,6
IRL,NOR,2021.0,1,3,-2
DNK,IRQ,2019.0,1,1,0
KAZ,DEU,2020.0,2,3,-1
MDA,RUS,2009.0,1,1,0
IND,CHN,2002.0,4,2,2
KEN,AUS,2012.0,2,5,-3
IRN,BEL,2013.0,13,3,10
VEN,MEX,2009.0,3,6,-3
USA,SVN,2018.0,7,12,-5
FRA,CHL,1998.0,2,3,-1
SGP,DNK,2015.0,7,4,3
GRC,FRA,2000.0,5,7,-2
CHE,SAU,2014.0,5,2,3
FIN,BEL,2014.0,8,8,0
NLD,ARG,2010.0,4,1,3
SVK,POL,2001.0,2,2,0
LKA,ITA,2013.0,2,1,1
NLD,LTU,2007.0,3,4,-1
CZE,TUR,2014.0,2,3,-1
MEX,CAN,2005.0,14,16,-2
RUS,LTU,2001.0,2,1,1
POL,CZE,2002.0,4,4,0
ITA,AUS,1998.0,2,4,-2
MAR,SAU,2017.0,4,2,2
BEL,KOR,2011.0,2,4,-2
IRL,FIN,2007.0,4,1,3
AUS,BEL,1998.0,3,1,2
KOR,PAK,2004.0,1,2,-1
ITA,THA,2021.0,2,4,-2
FIN,CZE,2019.0,6,3,3
SGP,NOR,2007.0,5,1,4
SWE,CHL,2011.0,6,3,3
CAN,BGR,2019.0,2,2,0
GBR,BWA,1999.0,2,2,0
IRQ,GBR,2009.0,2,3,-1
BEL,NOR,2011.0,3,2,1
CZE,HKG,2018.0,2,2,0
IRQ,IRN,2016.0,2,7,-5
LBN,EGY,2006.0,2,1,1
SWE,BRA,2014.0,10,13,-3
BOL,SWE,2010.0,2,2,0
KWT,BEL,2012.0,1,1,0
HUN,MEX,2016.0,4,1,3
KEN,UGA,2011.0,2,3,-1
ESP,HRV,2019.0,4,4,0
ROU,UKR,2015.0,2,1,1
LVA,BEL,2013.0,1,1,0
SAU,SGP,2009.0,1,2,-1
ZAF,CZE,2015.0,2,4,-2
SRB,HRV,2014.0,4,11,-7
ITA,UGA,2017.0,3,4,-1
GBR,BRB,2018.0,2,1,1
EGY,CHE,2014.0,3,4,-1
ZAF,EGY,2016.0,3,1,2
BIH,HRV,2022.0,1,1,0
BEL,GHA,2021.0,2,2,0
DZA,DEU,2019.0,4,5,-1
PER,DEU,2021.0,3,1,2
PAK,POL,2020.0,3,1,2
BRA,NOR,2009.0,2,2,0
KOR,ESP,2021.0,8,4,4
TZA,JPN,1999.0,1,1,0
DZA,SAU,2013.0,6,2,4
VEN,DEU,2002.0,2,3,-1
CHN,MEX,2017.0,2,5,-3
GBR,MYS,2001.0,12,11,1
AUT,JPN,2003.0,5,13,-8
ISR,PSE,2017.0,9,5,4
MNG,JPN,2002.0,2,5,-3
PRT,NLD,1999.0,3,1,2
NZL,AUT,2015.0,7,4,3
NZL,ITA,2003.0,3,5,-2
SGP,PHL,2009.0,3,2,1
PSE,EGY,2007.0,3,1,2
SGP,TUR,2015.0,2,5,-3
KWT,SAU,2013.0,2,7,-5
FIN,CZE,2010.0,5,7,-2
MEX,BEL,2009.0,5,6,-1
COD,BEL,2013.0,1,1,0
SRB,BEL,2020.0,2,2,0
ESP,HRV,2017.0,2,2,0
TUR,DNK,2015.0,5,2,3
SGP,ISR,2011.0,2,4,-2
BRA,GRC,2020.0,3,1,2
ITA,ROU,1998.0,1,1,0
EGY,DNK,2002.0,5,4,1
GBR,ROU,2012.0,9,16,-7
NZL,ISL,2014.0,1,1,0
NZL,SAU,2009.0,2,1,1
HRV,CAN,2007.0,3,1,2
SAU,CAN,1999.0,6,5,1
GBR,GRD,2008.0,1,2,-1
THA,NOR,2011.0,1,1,0
MEX,CHE,2002.0,3,5,-2
BGD,PHL,2012.0,3,1,2
GBR,BLR,1999.0,2,1,1
FRA,UKR,2001.0,4,10,-6
EGY,KWT,2000.0,2,5,-3
NZL,NCL,2013.0,1,1,0
DNK,SRB,2013.0,1,1,0
SVK,FIN,2017.0,2,2,0
FRA,SYR,2021.0,1,3,-2
DEU,ARM,2018.0,6,3,3
CAN,JOR,2022.0,6,5,1
ETH,BWA,2018.0,3,1,2
SVK,CHE,2019.0,5,5,0
SDN,PAK,2009.0,1,1,0
MEX,CHE,2005.0,1,5,-4
ESP,HRV,2010.0,2,2,0
ESP,DZA,2009.0,3,3,0
LKA,SWE,2010.0,1,1,0
AUT,BRA,2022.0,3,5,-2
COL,FRA,2022.0,4,3,1
CHE,EGY,2017.0,1,6,-5
BLR,NOR,2012.0,1,1,0
MOZ,BRA,2016.0,6,8,-2
AUS,CZE,2010.0,3,5,-2
UKR,CAN,1997.0,1,2,-1
AUT,POL,1997.0,2,2,0
ISR,AUT,2008.0,2,4,-2
UKR,AUS,2008.0,1,2,-1
RUS,UZB,2009.0,4,3,1
GBR,CMR,2013.0,1,3,-2
MEX,ITA,2000.0,4,5,-1
BGR,ROU,2020.0,1,1,0
KOR,AUT,2007.0,3,1,2
IRQ,AUS,2007.0,1,1,0
ZWE,CHE,2013.0,2,3,-1
UGA,NGA,2020.0,3,4,-1
PRT,CHN,2007.0,1,6,-5
THA,CHN,2008.0,4,3,1
PHL,DEU,2017.0,5,6,-1
KGZ,TUR,2012.0,1,1,0
BGR,RUS,2018.0,7,3,4
MEX,PAK,2018.0,1,1,0
ROU,DNK,2019.0,3,3,0
AUS,HRV,2005.0,1,1,0
ITA,VEN,2001.0,1,1,0
USA,GEO,2002.0,2,4,-2
NGA,DEU,2010.0,3,2,1
ARE,SGP,2019.0,2,2,0
EGY,PRT,2020.0,1,1,0
SVK,UKR,2021.0,2,6,-4
CAN,EGY,2006.0,5,9,-4
CHE,ARG,2006.0,2,4,-2
FIN,ISL,2002.0,1,1,0
CHE,SVN,2013.0,2,2,0
ISR,ESP,1997.0,1,1,0
HRV,KWT,2019.0,1,2,-1
JPN,MNG,2009.0,4,1,3
CAN,UKR,2009.0,3,4,-1
POL,AUS,2003.0,2,6,-4
NLD,BFA,2006.0,1,2,-1
BOL,ESP,2018.0,2,2,0
BHR,SAU,2013.0,1,4,-3
ITA,MDG,2017.0,1,1,0
PAK,CHN,2001.0,1,1,0
ARE,IRL,2015.0,1,1,0
AUT,TUR,2003.0,1,4,-3
SGP,POL,2019.0,2,3,-1
PAN,MEX,2006.0,1,1,0
CYP,CAN,2016.0,5,1,4
LKA,IND,2016.0,1,4,-3
QAT,BRA,2018.0,1,1,0
BRA,CRI,2016.0,4,1,3
CHN,COD,2018.0,1,1,0
CHN,MAR,2021.0,1,6,-5
KAZ,SAU,2021.0,4,1,3
DNK,THA,2003.0,3,3,0
LKA,JPN,2007.0,2,4,-2
VEN,CHL,2013.0,4,3,1
USA,KNA,2011.0,1,2,-1
MOZ,ZAF,2008.0,1,1,0
ISR,BEL,2005.0,5,3,2
TTO,CAN,2016.0,1,1,0
EGY,DEU,1999.0,6,8,-2
ZMB,IND,2021.0,2,2,0
EGY,HUN,2017.0,2,1,1
SGP,AUT,2011.0,2,2,0
COL,ARG,2005.0,2,2,0
EGY,AUT,2012.0,2,1,1
SRB,FRA,2014.0,3,2,1
AUT,ARE,2007.0,1,1,0
JPN,BGR,2013.0,5,2,3
PER,ECU,2014.0,1,2,-1
GRC,DZA,2009.0,1,1,0
NZL,KOR,2004.0,1,3,-2
PER,AUS,2009.0,1,1,0
FRA,NGA,2019.0,2,5,-3
IDN,TWN,2012.0,2,5,-3
VNM,DNK,2011.0,1,1,0
LUX,AUT,2018.0,2,3,-1
CHE,UGA,2016.0,1,2,-1
BEL,EST,2021.0,2,3,-1
TUR,AZE,2019.0,6,2,4
IND,NLD,1998.0,2,1,1
BEL,ETH,2007.0,1,2,-1
BOL,SWE,2017.0,1,3,-2
IRL,ISR,2008.0,1,4,-3
AUT,BFA,2019.0,1,2,-1
MAC,SGP,2012.0,1,1,0
USA,JAM,2007.0,3,1,2
PSE,ARE,2017.0,1,1,0
NOR,IRL,2013.0,1,3,-2
ITA,JOR,2018.0,7,2,5
BIH,TUR,2016.0,2,5,-3
IRL,CHN,2004.0,1,4,-3
KOR,NLD,2006.0,2,6,-4
CHE,LBN,2014.0,2,3,-1
ECU,MEX,2022.0,8,1,7
HKG,RUS,2018.0,1,5,-4
NPL,THA,2014.0,2,5,-3
FRA,BOL,2013.0,1,4,-3
GBR,ZWE,1999.0,2,6,-4
AUT,LIE,2004.0,1,1,0
RUS,BRA,2010.0,1,3,-2
RUS,VNM,2003.0,2,1,1
USA,MLT,2015.0,1,1,0
KWT,EGY,1999.0,3,4,-1
LTU,FRA,2003.0,2,3,-1
MYS,ETH,2016.0,2,1,1
NLD,URY,2018.0,1,2,-1
SWE,BGD,2008.0,2,5,-3
FRA,LTU,2009.0,4,3,1
OMN,AUS,2021.0,2,2,0
PAK,NGA,2020.0,2,1,1
BLR,HKG,2003.0,1,1,0
DEU,LKA,2012.0,1,1,0
ALB,USA,2016.0,1,4,-3
LBN,ARE,2009.0,2,1,1
NGA,FRA,2004.0,1,1,0
UKR,CHN,2003.0,1,1,0
IRL,RUS,2020.0,2,10,-8
LVA,DEU,2007.0,2,3,-1
OMN,FRA,2019.0,1,2,-1
CMR,GAB,2011.0,1,2,-1
CHN,MEX,2010.0,2,1,1
IND,TTO,2008.0,1,1,0
CAN,CMR,2018.0,1,2,-1
AUS,URY,2016.0,1,3,-2
RUS,TUR,2016.0,2,1,1
GRC,SVN,2017.0,2,2,0
TZA,IND,2014.0,1,5,-4
TWN,POL,2021.0,3,2,1
TWN,NZL,2014.0,1,1,0
DOM,USA,2006.0,1,2,-1
CUB,ITA,2000.0,1,2,-1
ARE,MYS,2015.0,1,6,-5
SAU,ITA,2003.0,2,2,0
IRL,KNA,2016.0,1,1,0
BRA,CHE,1997.0,2,1,1
FRA,RWA,2019.0,1,1,0
PER,KEN,2022.0,1,2,-1
SVK,FIN,2019.0,1,2,-1
KNA,IRL,2016.0,1,1,0
DEU,NPL,2010.0,4,2,2
KEN,BRA,2007.0,1,1,0
CHE,SVK,2004.0,1,4,-3
DNK,BRA,2021.0,1,22,-21
DZA,MAR,2012.0,1,1,0
BEL,CMR,2016.0,2,1,1
SAU,MAR,2022.0,2,1,1
MAR,SAU,2019.0,1,4,-3
COL,ZAF,2006.0,1,1,0
JOR,AUS,2008.0,1,2,-1
VNM,SGP,2011.0,2,2,0
SWE,CMR,2016.0,1,1,0
NOR,UKR,2016.0,1,3,-2
ITA,COL,2009.0,2,2,0
CZE,KOR,2018.0,2,8,-6
EGY,PSE,2004.0,1,1,0
ROU,JPN,2006.0,2,2,0
TUR,GEO,2014.0,1,1,0
MAR,ARE,2016.0,1,1,0
GRC,SVN,2019.0,1,1,0
CZE,IRL,2006.0,1,1,0
FRA,SDN,2011.0,1,1,0
IRN,AZE,2016.0,1,4,-3
GMB,KEN,2015.0,1,1,0
UKR,CAN,1998.0,3,2,1
POL,SRB,2003.0,1,1,0
ESP,SVN,2010.0,1,3,-2
KEN,NLD,2021.0,5,2,3
NOR,HKG,2021.0,1,1,0
ARE,ZAF,2008.0,1,1,0
PRI,PER,2004.0,1,1,0
ARE,JOR,1998.0,1,1,0
BLR,POL,2015.0,2,1,1
DEU,MDA,2007.0,2,3,-1
ECU,ITA,2009.0,1,1,0
MOZ,SWE,2018.0,1,2,-1
ESP,HKG,2022.0,1,1,0
CZE,ZAF,2018.0,1,2,-1
SAU,IRQ,2021.0,2,2,0
BGR,IND,2016.0,1,1,0
DEU,NPL,2017.0,1,1,0
COD,CHE,2022.0,1,1,0
TUN,SAU,2006.0,1,1,0
TUR,FRA,1997.0,1,1,0
CUB,GBR,2007.0,2,1,1
USA,GMB,2019.0,1,1,0
FIN,TUR,2005.0,1,2,-1
SRB,LUX,2020.0,1,1,0
ZAF,NGA,2001.0,1,4,-3
LUX,CZE,2014.0,1,1,0
BHR,ARE,2010.0,1,2,-1
MNG,JPN,2005.0,1,1,0
BEN,CHE,2013.0,1,1,0
KEN,CHE,2013.0,3,1,2
FIN,PRT,2012.0,2,4,-2
CZE,ARG,2016.0,1,2,-1
JPN,AFG,2015.0,1,1,0
ISL,CHE,2019.0,1,6,-5
TUR,HKG,2020.0,1,1,0
GHA,NZL,2020.0,1,1,0
ITA,TUN,2011.0,1,4,-3
IDN,THA,2013.0,1,2,-1
SMR,ITA,2012.0,1,2,-1
EGY,CZE,2021.0,1,3,-2
FRA,LBN,1998.0,1,3,-2
CUB,VEN,2013.0,1,3,-2
JPN,JOR,2011.0,1,2,-1
CHN,UKR,2002.0,1,1,0
ITA,NOR,2009.0,16,6,10
CHN,USA,2011.0,1966,1713,253
DEU,CHL,2020.0,28,44,-16
ARG,MEX,2017.0,25,25,0
DEU,USA,2022.0,405,437,-32
NLD,ARG,2019.0,3,7,-4
CAN,IRN,2016.0,78,261,-183
ESP,PRT,2015.0,103,64,39
ITA,KAZ,2019.0,2,3,-1
MEX,ARG,2006.0,8,5,3
IRL,CAN,2017.0,38,31,7
ZAF,DEU,2014.0,20,24,-4
AUS,IDN,2007.0,13,5,8
GBR,QAT,2019.0,55,16,39
FIN,DZA,2020.0,1,3,-2
TWN,CHN,2019.0,225,93,132
NZL,BRA,2013.0,1,5,-4
JPN,CAN,2020.0,53,71,-18
KHM,FRA,2014.0,4,2,2
GRC,NLD,2017.0,25,16,9
BRA,ESP,2021.0,81,68,13
RUS,BRA,2017.0,17,5,12
CHN,AUT,2015.0,15,17,-2
DEU,IDN,2015.0,23,7,16
ISR,CHN,2017.0,17,24,-7
DNK,POL,2015.0,8,8,0
ZAF,CHE,2001.0,5,4,1
MYS,LKA,2020.0,7,2,5
CAN,AUT,2020.0,9,19,-10
IRL,ESP,2017.0,18,40,-22
RUS,DEU,2018.0,92,95,-3
MAR,MLI,2017.0,3,1,2
BGD,JPN,2020.0,42,82,-40
ITA,HRV,2020.0,10,7,3
CHL,USA,2020.0,109,92,17
IDN,MYS,2007.0,6,9,-3
ARG,MEX,2019.0,18,21,-3
DEU,LUX,2012.0,27,8,19
GRC,GBR,2016.0,250,112,138
SWE,EST,2020.0,6,3,3
COL,GBR,2002.0,3,11,-8
ISR,CHN,2019.0,23,19,4
FIN,FRA,2014.0,21,18,3
DNK,NOR,2006.0,25,20,5
FRA,VNM,2013.0,20,13,7
GBR,NLD,2002.0,161,151,10
DEU,KOR,2011.0,32,45,-13
NLD,FIN,2014.0,17,15,2
SEN,FRA,2009.0,22,24,-2
BRA,SWE,2018.0,27,9,18
GNB,DNK,2010.0,4,3,1
CYP,GRC,2008.0,10,18,-8
NLD,THA,2021.0,5,3,2
ITA,DEU,2006.0,133,139,-6
DEU,ROU,2008.0,32,15,17
DNK,RUS,2020.0,3,6,-3
NLD,NZL,2018.0,11,12,-1
ARE,AUS,2007.0,3,6,-3
DEU,SAU,2015.0,21,6,15
USA,SDN,2014.0,7,1,6
AUT,NLD,2014.0,25,28,-3
AUS,NLD,2004.0,25,29,-4
FRA,PRT,2003.0,32,10,22
ISR,DEU,2004.0,26,23,3
FRA,REU,2008.0,11,9,2
ISL,GBR,2007.0,5,5,0
DEU,SWE,1998.0,20,14,6
FRA,ARG,1997.0,1,1,0
CHE,BRA,2014.0,11,23,-12
UKR,RUS,2004.0,29,35,-6
AUS,CHN,2000.0,9,16,-7
DNK,NZL,2008.0,8,4,4
GBR,NPL,2015.0,6,4,2
DNK,GRC,2008.0,6,4,2
GBR,BHR,2009.0,4,1,3
USA,JOR,2002.0,17,10,7
TUR,AZE,2010.0,9,6,3
SGP,CHE,2010.0,8,9,-1
JPN,NPL,2019.0,12,4,8
ESP,SVN,2017.0,3,7,-4
EGY,RUS,2017.0,7,3,4
MDG,USA,2016.0,6,5,1
KWT,LBN,2017.0,2,2,0
MNE,SRB,2016.0,2,10,-8
CAN,DNK,2005.0,15,6,9
FRA,ZAF,2003.0,15,7,8
CAN,BGD,2016.0,15,21,-6
ARE,SAU,2014.0,6,19,-13
GUF,GUY,2004.0,2,3,-1
CAN,DNK,2002.0,21,9,12
HKG,NLD,2020.0,12,4,8
DZA,ESP,2017.0,5,4,1
DNK,CAN,2014.0,19,24,-5
FIN,QAT,2013.0,1,1,0
ISR,CHN,2010.0,7,3,4
SLE,CHE,2020.0,1,3,-2
CHE,LIE,2014.0,3,4,-1
JPN,FIN,1998.0,2,1,1
BRA,MEX,1998.0,3,3,0
ESP,SVN,2019.0,4,6,-2
NGA,BEN,2008.0,3,2,1
AUT,CZE,2020.0,11,14,-3
CAN,BGR,2010.0,3,1,2
NGA,GBR,2011.0,14,28,-14
BFA,USA,2004.0,2,1,1
NOR,HRV,2013.0,3,1,2
SRB,BIH,2006.0,7,5,2
ARG,CHN,2021.0,1,3,-2
AUS,KWT,2019.0,8,3,5
NPL,USA,2006.0,6,4,2
JPN,ZMB,2002.0,2,2,0
EGY,TUN,2013.0,1,1,0
ETH,RUS,2022.0,1,4,-3
RUS,GEO,1999.0,4,3,1
CRI,FRA,2009.0,4,2,2
AUS,KWT,2010.0,1,1,0
HKG,IRN,2017.0,3,4,-1
ZAF,SWE,2016.0,6,8,-2
PRT,RUS,2001.0,3,3,0
QAT,AUS,2022.0,4,9,-5
HUN,BEL,2009.0,5,3,2
PAK,SAU,2004.0,9,11,-2
SRB,SVN,2012.0,2,5,-3
ESP,GRC,2007.0,4,12,-8
TZA,KOR,2021.0,2,3,-1
GRC,ROU,2006.0,3,1,2
FRA,SAU,2006.0,2,1,1
GNB,DNK,2019.0,3,1,2
ISR,ESP,1998.0,1,1,0
ZAF,AUT,2012.0,1,2,-1
MYS,NLD,2014.0,3,8,-5
COG,FRA,2017.0,4,5,-1
PRT,UKR,2006.0,1,1,0
ARM,CAN,2012.0,2,1,1
COL,CHE,2022.0,3,2,1
SVN,AUT,2004.0,4,3,1
ETH,KEN,2007.0,1,1,0
DZA,ESP,2019.0,3,8,-5
DZA,DEU,2017.0,2,3,-1
PER,BRA,2008.0,1,7,-6
NZL,DNK,2002.0,1,7,-6
NLD,SUR,2017.0,1,2,-1
LBY,MYS,2017.0,2,9,-7
NZL,DNK,2005.0,3,3,0
ESP,NZL,1997.0,1,1,0
IRL,SRB,2002.0,1,1,0
LVA,USA,2003.0,1,3,-2
PLW,USA,2000.0,1,2,-1
JPN,NPL,2010.0,3,2,1
KEN,KOR,2014.0,1,2,-1
KOR,ETH,2022.0,1,2,-1
CHN,UKR,2005.0,1,2,-1
TWN,KEN,2019.0,1,1,0
RUS,GRC,2021.0,3,2,1
JOR,KWT,2011.0,1,1,0
ITA,BGD,2004.0,1,1,0
ETH,SWE,2003.0,2,5,-3
DEU,UKR,2000.0,1,19,-18
ALB,DEU,2013.0,1,1,0
URY,CHL,2007.0,1,1,0
BEN,BRA,2013.0,1,1,0
FIN,ETH,2013.0,1,2,-1
LIE,USA,2004.0,1,1,0
USA,,2018.0,88470,0,88470
,AUS,2000.0,8060,0,8060
HRV,,2021.0,1468,0,1468
CHN,,2011.0,34706,0,34706
,ARG,2004.0,2127,0,2127
,CHN,2001.0,35703,0,35703
,ITA,2009.0,13412,0,13412
IND,,2011.0,5663,0,5663
ITA,,2015.0,8376,0,8376
DEU,,2008.0,11031,0,11031
DNK,,2022.0,5153,0,5153
JPN,,2005.0,13646,0,13646
BEL,,2021.0,4417,0,4417
,MEX,2002.0,3042,0,3042
PAN,,2024.0,283,0,283
TWN,,2020.0,6949,0,6949
,ARG,1996.0,1075,0,1075
,SAU,2008.0,867,0,867
PRT,,2014.0,952,0,952
QAT,,2023.0,1253,0,1253
MYS,,2010.0,282,0,282
,ZAF,1998.0,2065,0,2065
,ZAF,1997.0,539,0,539
AUT,,2023.0,9769,0,9769
,PRT,2003.0,1847,0,1847
,RUS,2015.0,16252,0,16252
MYS,,2019.0,3266,0,3266
SWE,,2011.0,1993,0,1993
JPN,,2002.0,3240,0,3240
MEX,,2012.0,1692,0,1692
,DEU,2009.0,22589,0,22589
,NZL,1995.0,689,0,689
MYS,,2017.0,1981,0,1981
,SVN,2000.0,568,0,568
,MEX,2005.0,3388,0,3388
MDA,,2012.0,32,0,32
KEN,THA,2017.0,4,0,4
IRL,LIE,2014.0,1,0,1
,MAR,2000.0,715,0,715
,PAK,2016.0,4324,0,4324
CZE,,2020.0,2761,0,2761
,CRI,1994.0,43,0,43
,SGP,2000.0,1313,0,1313
,EST,2000.0,238,0,238
DZA,DNK,2020.0,3,0,3
,COL,1999.0,469,0,469
,LBN,2006.0,256,0,256
TUR,,2001.0,61,0,61
USA,SEN,2021.0,2,0,2
,BEL,2012.0,3605,0,3605
,KHM,2008.0,41,0,41
ECU,,2013.0,62,0,62
CUB,,2020.0,742,0,742
PSE,ARE,2019.0,2,0,2
CAN,,2001.0,186,0,186
NER,BEL,2010.0,1,0,1
ARE,,2018.0,234,0,234
GRC,,1999.0,24,0,24
AZE,,2021.0,318,0,318
BRA,IRQ,2010.0,1,0,1
NGA,,2025.0,22,0,22
AUS,SVK,2018.0,1,0,1
,KAZ,2012.0,1459,0,1459
,KEN,2009.0,428,0,428
CMR,,2021.0,386,0,386
,HRV,2016.0,908,0,908
LVA,,2020.0,260,0,260
,JPN,2018.0,18332,0,18332
PSE,,2015.0,44,0,44
,RWA,2012.0,108,0,108
,BWA,2010.0,47,0,47
,SVK,2015.0,992,0,992
,OMN,2007.0,97,0,97
JOR,,2004.0,47,0,47
COG,,2017.0,65,0,65
,BLR,2008.0,180,0,180
SVN,CZE,2018.0,2,0,2
COG,,2019.0,81,0,81
,TWN,2018.0,5257,0,5257
,ARM,2006.0,120,0,120
GAB,,2023.0,125,0,125
,TZA,2006.0,138,0,138
BEL,TZA,2022.0,2,0,2
,MSR,2005.0,2,0,2
,ATG,2015.0,4,0,4
MYS,KAZ,2017.0,2,0,2
TWN,ECU,2018.0,2,0,2
,DOM,2015.0,21,0,21
,MRT,2019.0,10,0,10
,SLV,2016.0,6,0,6
SLV,,2024.0,34,0,34
,BWA,2017.0,68,0,68
,URY,2018.0,157,0,157
ESP,SLV,2020.0,2,0,2
MYS,CHL,2020.0,2,0,2
,GRD,2006.0,15,0,15
SWE,KAZ,2018.0,4,0,4
MYS,KWT,2018.0,6,0,6
KOR,,2001.0,183,0,183
HKG,PER,2010.0,1,0,1
,BWA,2019.0,53,0,53
SRB,NOR,2018.0,4,0,4
ZAF,URY,2016.0,1,0,1
ECU,PAN,2015.0,1,0,1
SVN,,2004.0,73,0,73
FRO,GBR,2016.0,3,0,3
FJI,HUN,2006.0,1,0,1
MYS,EST,2019.0,4,0,4
PRI,DOM,2008.0,1,0,1
LIE,,2020.0,9,0,9
LBN,IRL,2016.0,1,0,1
VNM,POL,2020.0,1,0,1
CHE,KHM,2021.0,1,0,1
GRC,COL,2020.0,1,0,1
,MWI,1994.0,16,0,16
FRA,PRI,1998.0,1,0,1
,SUR,2016.0,6,0,6
IND,RUS,2013.0,4,0,4
,MTQ,2019.0,1,0,1
LKA,IRL,2021.0,2,0,2
,FRO,2000.0,4,0,4
,MDV,2014.0,2,0,2
MYS,AZE,2020.0,1,0,1
CYP,,2009.0,13,0,13
GRC,TWN,2017.0,1,0,1
VEN,,2006.0,174,0,174
,GTM,2002.0,15,0,15
RWA,,2007.0,1,0,1
EGY,,2000.0,25,0,25
VEN,ECU,2007.0,1,0,1
,FSM,2002.0,2,0,2
IDN,,2007.0,51,0,51
MUS,GBR,2008.0,3,0,3
NAM,,2014.0,6,0,6
ROU,,2000.0,37,0,37
DZA,ESP,2010.0,1,0,1
KEN,,2004.0,30,0,30
NGA,FJI,2019.0,1,0,1
ABW,USA,2003.0,1,0,1
SWE,TUR,2003.0,1,0,1
BRN,NGA,2015.0,1,0,1
FIN,UKR,2011.0,1,0,1
MOZ,MWI,2002.0,1,0,1
ESP,SVK,2002.0,5,0,5
,MLT,1998.0,22,0,22
USA,ETH,2000.0,2,0,2
PAK,KEN,2016.0,4,0,4
SEN,PER,2000.0,1,0,1
DEU,DZA,2014.0,2,0,2
ITA,ALB,2003.0,2,0,2
NCL,,2007.0,6,0,6
HND,,2014.0,7,0,7
LUX,,2003.0,5,0,5
BLR,SWE,1999.0,1,0,1
,MLT,1997.0,7,0,7
,GUF,1998.0,2,0,2
GUY,GUF,2017.0,1,0,1
DEU,TWN,2000.0,4,0,4
DNK,BLR,2004.0,1,0,1
PER,ITA,2002.0,2,0,2
CHL,PER,1997.0,3,0,3
VEN,PRI,2006.0,2,0,2
,HTI,2001.0,8,0,8
,ECU,1994.0,14,0,14
,PYF,2002.0,5,0,5
SGP,PAK,2008.0,3,0,3
,SYC,1999.0,1,0,1
ESP,CRI,2002.0,2,0,2
VEN,DOM,2021.0,2,0,2
GAB,NCL,2010.0,1,0,1
IRL,GUF,2011.0,1,0,1
UKR,LTU,2012.0,1,0,1
CZE,MKD,2014.0,1,0,1
PRT,EST,2012.0,1,0,1
IRN,JOR,2005.0,2,0,2
USA,RWA,2009.0,3,0,3
KOR,NOR,2018.0,14,0,14
USA,LBR,2011.0,1,0,1
USA,LVA,2013.0,3,0,3
FRA,ETH,2009.0,1,0,1
ZMB,,2012.0,11,0,11
PRY,BRA,2011.0,3,0,3
GNQ,GIN,2021.0,2,0,2
ZAF,ISR,2016.0,2,0,2
LKA,IDN,2019.0,1,0,1
GUF,KHM,2018.0,1,0,1
NPL,NZL,2009.0,2,0,2
MYS,IRL,2021.0,4,0,4
FRA,PAN,2011.0,1,0,1
KOR,BGR,2016.0,2,0,2
TCD,,2021.0,10,0,10
SGP,CHL,2014.0,2,0,2
EGY,LBY,2008.0,2,0,2
GBR,QAT,2010.0,15,0,15
ITA,QAT,2014.0,4,0,4
DEU,URY,1999.0,2,0,2
NPL,NOR,2006.0,2,0,2
MDV,MDA,2011.0,1,0,1
GMB,,2013.0,4,0,4
KWT,DZA,2011.0,1,0,1
,MTQ,2010.0,6,0,6
ESP,JOR,2011.0,1,0,1
NOR,GHA,2020.0,3,0,3
IRN,AUT,2021.0,13,0,13
FIN,ISL,2005.0,2,0,2
COG,,2010.0,18,0,18
NGA,OMN,2011.0,1,0,1
PAK,IRN,2008.0,1,0,1
BRB,,2013.0,4,0,4
,GTM,2005.0,11,0,11
CIV,,2005.0,21,0,21
MDA,BEL,2002.0,1,0,1
MDA,BEL,2005.0,2,0,2
TWN,MAR,2011.0,2,0,2
GRC,SVK,2011.0,2,0,2
UGA,COG,2005.0,1,0,1
EST,,2004.0,18,0,18
FIN,MOZ,2022.0,1,0,1
GIN,GNQ,2017.0,2,0,2
BRA,IRQ,2019.0,1,0,1
QAT,SYR,2011.0,1,0,1
ITA,PRI,2018.0,1,0,1
ZMB,ZAF,2002.0,2,0,2
ZAF,DNK,2009.0,6,0,6
GRC,JOR,2005.0,2,0,2
NIC,ESP,2005.0,1,0,1
CHN,PER,2017.0,1,0,1
ARG,NGA,2013.0,1,0,1
SWE,LVA,2008.0,4,0,4
TUR,TUN,2015.0,1,0,1
KEN,SWZ,2008.0,2,0,2
VEN,DEU,2005.0,5,0,5
KEN,SEN,2015.0,2,0,2
GHA,THA,2014.0,1,0,1
COG,USA,2008.0,2,0,2
JAM,DEU,2005.0,1,0,1
UKR,EST,2015.0,1,0,1
MWI,CMR,2014.0,1,0,1
AUT,BIH,2020.0,2,0,2
HTI,FRA,2015.0,2,0,2
TUN,MAR,2012.0,3,0,3
THA,ISR,2022.0,1,0,1
GHA,GRC,2017.0,2,0,2
DZA,TUN,2008.0,1,0,1
LTU,NZL,2010.0,1,0,1
ISR,KOR,2003.0,3,0,3
CRI,GBR,2008.0,1,0,1
GRC,HKG,2008.0,1,0,1
DOM,,2013.0,7,0,7
CUB,FRA,2013.0,4,0,4
HND,BEL,2005.0,1,0,1
CHE,CMR,2015.0,7,0,7
,GUF,1997.0,1,0,1
CHL,EST,2022.0,1,0,1
BHR,ARE,2017.0,3,0,3
DNK,SAU,2020.0,5,0,5
DEU,MOZ,2004.0,1,0,1
NZL,BWA,2011.0,1,0,1
SVK,TWN,2008.0,1,0,1
,BLZ,2018.0,3,0,3
KAZ,USA,2002.0,3,0,3
HKG,EGY,2004.0,1,0,1
CHN,AFG,2010.0,1,0,1
ISL,CHE,2017.0,1,0,1
AND,,2017.0,1,0,1
BIH,MNE,2013.0,1,0,1
MDV,,2022.0,6,0,6
AUT,EGY,2004.0,3,0,3
,MTQ,2017.0,7,0,7
BFA,GLP,2008.0,1,0,1
FLK,,2005.0,2,0,2
LUX,FRA,2000.0,2,0,2
THA,KEN,1999.0,1,0,1
NPL,NLD,2012.0,1,0,1
ATG,,2016.0,1,0,1
POL,JPN,1998.0,3,0,3
DOM,CRI,2018.0,1,0,1
,GIB,2008.0,5,0,5
BEL,BDI,2012.0,1,0,1
PER,ARG,2013.0,2,0,2
FRA,SHN,2017.0,1,0,1
ZAF,MEX,2003.0,2,0,2
TGO,USA,2016.0,1,0,1
TWN,BGD,2013.0,1,0,1
BGR,LBN,2020.0,4,0,4
PRI,CHE,2018.0,1,0,1
TTO,BRA,2008.0,1,0,1
ZWE,LSO,2010.0,1,0,1
TWN,ZAF,1999.0,1,0,1
ERI,,2006.0,5,0,5
ITA,SVN,2000.0,3,0,3
FRA,CHL,1997.0,6,0,6
POL,GEO,2007.0,1,0,1
OMN,NLD,2011.0,1,0,1
USA,LKA,1998.0,3,0,3
JPN,PNG,2010.0,2,0,2
POL,CZE,2005.0,4,0,4
NLD,SVK,2020.0,1,0,1
HUN,IRL,2011.0,3,0,3
UGA,DEU,2014.0,2,0,2
MLI,KEN,2016.0,1,0,1
JAM,DEU,2002.0,2,0,2
SAU,OMN,1998.0,2,0,2
FIN,CHL,2016.0,4,0,4
,AGO,2003.0,3,0,3
GAB,BFA,2008.0,1,0,1
,PYF,2005.0,9,0,9
AUT,KEN,2008.0,1,0,1
BTN,AUS,2010.0,1,0,1
NPL,ITA,2018.0,1,0,1
BRA,ROU,2019.0,5,0,5
KWT,LBN,2019.0,1,0,1
ZAF,JOR,2020.0,1,0,1
GUM,,2016.0,2,0,2
,MRT,2010.0,7,0,7
IRL,UGA,2015.0,2,0,2
GRC,IRQ,2020.0,2,0,2
PHL,FRA,2021.0,2,0,2
CMR,ETH,2017.0,1,0,1
VNM,KHM,2013.0,1,0,1
BEN,ZAF,2016.0,1,0,1
NLD,CRI,2005.0,1,0,1
SWE,UGA,2005.0,2,0,2
ETH,FIN,2008.0,1,0,1
ZAF,PRI,2007.0,1,0,1
BGD,NGA,2009.0,1,0,1
PSE,GBR,2017.0,5,0,5
JPN,TZA,2015.0,6,0,6
SWE,PHL,2022.0,2,0,2
CAN,MTQ,2003.0,1,0,1
DNK,JOR,2007.0,1,0,1
BEN,MDG,2016.0,1,0,1
ETH,DNK,2012.0,1,0,1
MAR,ITA,1999.0,3,0,3
ZWE,NOR,2005.0,1,0,1
AGO,CUB,2008.0,3,0,3
JPN,MAR,2011.0,1,0,1
BFA,BRN,2016.0,1,0,1
SEN,GIN,2006.0,1,0,1
DEU,ISL,2012.0,5,0,5
NGA,BRN,2021.0,4,0,4
EGY,RUS,2010.0,1,0,1
MCO,DEU,2014.0,1,0,1
CZE,VNM,2009.0,1,0,1
GBR,MSR,2016.0,1,0,1
DEU,FRO,2019.0,1,0,1
JPN,IRQ,2018.0,1,0,1
BFA,CHN,2011.0,1,0,1
SWE,BHR,2013.0,1,0,1
,LIE,2016.0,6,0,6
AUT,BGR,2021.0,2,0,2
ISR,GEO,2003.0,1,0,1
NGA,ZMB,2007.0,1,0,1
TTO,SAU,2010.0,1,0,1
,GNB,2016.0,1,0,1
NGA,GUY,2018.0,1,0,1
CAN,BEN,2013.0,1,0,1
QAT,JOR,2006.0,2,0,2
EGY,SYR,2022.0,2,0,2
SWE,DZA,2008.0,1,0,1
MAR,SAU,2010.0,2,0,2
FIN,SAU,2013.0,2,0,2
SVK,CHE,2010.0,3,0,3
TUR,BRA,2003.0,1,0,1
LTU,DNK,2014.0,3,0,3
NLD,ALB,2020.0,2,0,2
POL,SAU,2014.0,4,0,4
MEX,SUR,2018.0,1,0,1
ESP,KEN,2015.0,1,0,1
IND,KAZ,2014.0,1,0,1
BWA,RWA,2019.0,1,0,1
NGA,AUT,2017.0,1,0,1
FRA,ISL,2000.0,2,0,2
MKD,USA,1998.0,1,0,1
ROU,DNK,2010.0,2,0,2
THA,IRL,2006.0,1,0,1
IRL,COL,2008.0,2,0,2
IRN,EST,2014.0,1,0,1
TLS,BRA,2020.0,1,0,1
MAR,CIV,2004.0,1,0,1
KOR,FJI,2012.0,1,0,1
SLB,,2021.0,6,0,6
LTU,BEL,2007.0,1,0,1
GUY,USA,2012.0,1,0,1
THA,MEX,2009.0,1,0,1
ESP,COD,2003.0,1,0,1
HUN,TUR,2008.0,2,0,2
DNK,IRQ,2010.0,1,0,1
GRC,VEN,2011.0,1,0,1
NIC,USA,2005.0,1,0,1
GHA,IND,2003.0,1,0,1
BLR,BEL,2004.0,1,0,1
URY,USA,1997.0,1,0,1
ZWE,NOR,2002.0,2,0,2
MEX,PRI,2004.0,2,0,2
CHE,LAO,2004.0,1,0,1
DEU,LBN,2007.0,2,0,2
DZA,CAN,1998.0,1,0,1
GAB,BEL,1997.0,1,0,1
MAR,DEU,2006.0,2,0,2
FRA,DJI,2008.0,4,0,4
CIV,,2002.0,3,0,3
DNK,COL,2006.0,1,0,1
OMN,THA,2010.0,1,0,1
ARG,NZL,2013.0,1,0,1
BOL,SWE,2019.0,1,0,1
GRC,SVN,2010.0,2,0,2
BGD,EGY,2011.0,2,0,2
MYS,MEX,2015.0,1,0,1
RUS,CHL,2003.0,1,0,1
SDN,ETH,2017.0,1,0,1
,VCT,2013.0,3,0,3
,FSM,2005.0,3,0,3
FRA,MRT,2020.0,2,0,2
ZAF,ECU,2017.0,1,0,1
SAU,CHE,2001.0,2,0,2
DNK,MOZ,2007.0,1,0,1
AND,,2019.0,1,0,1
UZB,ISR,2002.0,1,0,1
BLR,PRT,2001.0,2,0,2
KWT,NOR,2017.0,2,0,2
MYS,UZB,2018.0,5,0,5
JPN,KAZ,2011.0,2,0,2
TUN,DEU,2015.0,1,0,1
GIN,FRA,2022.0,2,0,2
IRL,UKR,2008.0,2,0,2
BLR,KAZ,2022.0,1,0,1
BGD,ARE,2020.0,2,0,2
CHE,LUX,2006.0,1,0,1
BLR,BRA,2011.0,1,0,1
AUS,BEL,1997.0,1,0,1
NCL,SEN,2006.0,1,0,1
CIV,ZAF,2009.0,3,0,3
TUN,OMN,2005.0,1,0,1
GMB,BFA,2008.0,1,0,1
SAU,PER,2003.0,2,0,2
TWN,CHL,2015.0,2,0,2
JPN,MKD,2001.0,1,0,1
CHE,THA,2004.0,3,0,3
PHL,BEL,2011.0,2,0,2
CAN,QAT,2003.0,1,0,1
CAN,SDN,2020.0,1,0,1
BDI,,2018.0,9,0,9
TTO,PAK,2014.0,1,0,1
AFG,CAN,2014.0,1,0,1
CHL,CZE,2021.0,3,0,3
COL,HUN,2016.0,1,0,1
VEN,CRI,2014.0,1,0,1
TZA,KEN,2001.0,1,0,1
NZL,GRL,2017.0,1,0,1
NIC,ETH,2013.0,1,0,1
NLD,PHL,2022.0,3,0,3
,MRT,2017.0,9,0,9
LUX,SAU,2014.0,1,0,1
CAN,BGR,2017.0,2,0,2
USA,BRN,2002.0,1,0,1
MAR,MLI,2019.0,4,0,4
IRN,HRV,2021.0,2,0,2
LBN,KWT,2011.0,2,0,2
VNM,ARE,2021.0,1,0,1
LTU,NZL,2019.0,1,0,1
ARM,BEL,2015.0,1,0,1
SLE,GMB,2021.0,1,0,1
LKA,IDN,2010.0,1,0,1
CIV,CHE,2022.0,1,0,1
KAZ,EGY,2012.0,2,0,2
VEN,RUS,2013.0,1,0,1
BFA,ZAF,2018.0,1,0,1
PAK,CMR,2014.0,1,0,1
HRV,TUR,2021.0,1,0,1
COL,CRI,2006.0,1,0,1
IND,IRQ,2022.0,4,0,4
PAK,HUN,2019.0,2,0,2
ZAF,GMB,2013.0,6,0,6
SOM,KEN,2013.0,1,0,1
BEN,TGO,2015.0,3,0,3
OMN,CYP,2020.0,1,0,1
GEO,AZE,2006.0,1,0,1
SYR,OMN,2015.0,1,0,1
ITA,MNG,2016.0,1,0,1
ROU,KWT,2004.0,1,0,1
YEM,EGY,2003.0,1,0,1
BLR,LBN,2017.0,2,0,2
MUS,,1999.0,1,0,1
ITA,PAK,2007.0,1,0,1
ISL,ZAF,2014.0,1,0,1
ISR,NZL,2012.0,2,0,2
IND,BHR,2008.0,1,0,1
HRV,SGP,2022.0,1,0,1
LBN,MEX,2020.0,1,0,1
SRB,AUS,2001.0,2,0,2
GRC,QAT,2013.0,4,0,4
TWN,ARG,2002.0,2,0,2
NOR,DZA,2017.0,1,0,1
SEN,MEX,2016.0,1,0,1
PER,CRI,2013.0,1,0,1
PRT,ISL,2015.0,1,0,1
ITA,CRI,2014.0,1,0,1
POL,UZB,2007.0,1,0,1
ARE,UZB,2017.0,1,0,1
GHA,GMB,2017.0,1,0,1
PRT,PRI,2022.0,1,0,1
SDN,NLD,2018.0,2,0,2
POL,ISR,2008.0,2,0,2
ALB,ZAF,2014.0,1,0,1
IRN,GHA,2020.0,1,0,1
NOR,PSE,2022.0,2,0,2
ISR,SRB,2009.0,1,0,1
MEX,CRI,2003.0,1,0,1
ITA,ARM,2008.0,2,0,2
TWN,JOR,2011.0,1,0,1
JOR,BHR,2016.0,4,0,4
TZA,ESP,2021.0,1,0,1
BRA,ISR,2000.0,1,0,1
NLD,MLI,2005.0,1,0,1
PNG,FJI,2008.0,2,0,2
SWE,MYS,2004.0,1,0,1
SWE,KEN,1999.0,1,0,1
SDN,BHR,2014.0,2,0,2
HRV,NLD,2006.0,2,0,2
COL,SYR,2006.0,1,0,1
BIH,IRL,2014.0,1,0,1
TUN,EST,2022.0,1,0,1
GBR,GRL,2018.0,1,0,1
CHN,KGZ,2015.0,1,0,1
HRV,NZL,2014.0,1,0,1
RUS,JOR,2018.0,1,0,1
ITA,SDN,2011.0,1,0,1
SDN,AUS,2017.0,1,0,1
,ABW,2000.0,1,0,1
NGA,RWA,2020.0,1,0,1
BGR,URY,2021.0,1,0,1
HRV,ISR,2011.0,1,0,1
THA,CZE,2016.0,1,0,1
ITA,IRQ,2013.0,1,0,1
FRA,GEO,1998.0,1,0,1
GEO,DEU,1999.0,2,0,2
RWA,USA,2006.0,1,0,1
SVN,RUS,2014.0,1,0,1
SGP,KHM,2010.0,1,0,1
LAO,KGZ,2014.0,1,0,1
BMU,USA,2000.0,1,0,1
UZB,UKR,2008.0,1,0,1
MAR,AUS,2014.0,2,0,2
CMR,DEU,2006.0,2,0,2
CHN,GRC,2008.0,2,0,2
GEO,BEL,2016.0,1,0,1
HRV,SVK,2013.0,1,0,1
PAK,HUN,2017.0,1,0,1
FIN,IDN,2012.0,1,0,1
MEX,UZB,2014.0,1,0,1
UKR,HKG,2002.0,1,0,1
BRN,OMN,2018.0,1,0,1
CZE,CYP,2007.0,1,0,1
MCO,AUS,2011.0,1,0,1
OMN,SWZ,1999.0,1,0,1
RWA,ITA,2014.0,1,0,1
RWA,KEN,2012.0,1,0,1
BRA,LUX,2018.0,2,0,2
ISL,AUT,2011.0,1,0,1
GNB,DNK,2017.0,1,0,1
SYC,ESP,2016.0,1,0,1
KOR,MMR,2020.0,1,0,1
GIN,USA,2021.0,1,0,1
GIN,GNQ,2010.0,1,0,1
HRV,JPN,2012.0,1,0,1
BHR,ARE,2019.0,2,0,2
BLR,TWN,2000.0,1,0,1
JPN,FJI,2011.0,1,0,1
SAU,AUS,2003.0,1,0,1
AUS,TUN,2004.0,1,0,1
QAT,NZL,2020.0,1,0,1
UKR,PRT,2009.0,2,0,2
ARE,AFG,2018.0,1,0,1
CYP,CHN,2018.0,1,0,1
SDN,AUS,2019.0,1,0,1
LKA,NZL,2006.0,1,0,1
BWA,NOR,2011.0,1,0,1
OMN,THA,2017.0,1,0,1
FRA,LAO,2008.0,2,0,2
MAR,GBR,2004.0,3,0,3
TUR,ZAF,2021.0,1,0,1
CUB,URY,2016.0,1,0,1
LUX,TUR,2022.0,1,0,1
AUS,CYP,2021.0,2,0,2
MNG,CHE,2022.0,1,0,1
UZB,TWN,2014.0,1,0,1
USA,MCO,1997.0,1,0,1
CAF,GBR,2019.0,1,0,1
KOR,HUN,2011.0,1,0,1
KOR,KHM,2018.0,1,0,1
CHN,PSE,2015.0,1,0,1
CRI,PAN,2006.0,1,0,1
URY,GBR,2005.0,1,0,1
AGO,PAN,2014.0,1,0,1
NOR,LUX,2009.0,1,0,1
NLD,SUR,2010.0,1,0,1
HKG,GRC,2018.0,1,0,1
ZMB,AUS,2001.0,1,0,1
GBR,AGO,2003.0,1,0,1
BOL,BRA,1999.0,1,0,1
UKR,PSE,2007.0,1,0,1
DOM,CUB,2007.0,1,0,1
NOR,LTU,2007.0,1,0,1
CHE,PNG,2003.0,1,0,1
NZL,OMN,2012.0,1,0,1
,TON,2008.0,1,0,1
CHN,SWZ,2016.0,1,0,1
NOR,SDN,2021.0,1,0,1
DEU,GRD,2019.0,1,0,1
FIN,NGA,2013.0,1,0,1
BEL,KHM,2020.0,1,0,1
CZE,NPL,2011.0,1,0,1
PAN,ESP,2001.0,1,0,1
USA,BRN,2005.0,1,0,1
PHL,FJI,2015.0,1,0,1
BRA,TLS,2007.0,1,0,1
DEU,AFG,2015.0,1,0,1
ISR,ROU,2005.0,1,0,1
BEL,ZWE,2022.0,1,0,1
IND,CYP,2020.0,1,0,1
GHA,LKA,2017.0,1,0,1
NIC,CHE,2004.0,1,0,1
KEN,NAM,2006.0,1,0,1
ETH,UGA,2012.0,1,0,1
URY,PRY,2018.0,1,0,1
CUB,FIN,2013.0,1,0,1
CIV,GBR,1999.0,1,0,1
POL,THA,2014.0,1,0,1
OMN,BWA,1999.0,1,0,1
MMR,CHN,2014.0,2,0,2
FRA,RWA,2017.0,1,0,1
LBY,TUR,2003.0,1,0,1
ZMB,ZWE,2020.0,1,0,1
KAZ,KOR,2005.0,1,0,1
LVA,HUN,2011.0,1,0,1
UKR,DNK,2020.0,1,0,1
PAN,SAU,2014.0,1,0,1
GMB,TWN,2018.0,1,0,1
NZL,UKR,2022.0,1,0,1
NGA,FJI,2017.0,1,0,1
ESP,TTO,2002.0,1,0,1
MAR,EGY,2012.0,1,0,1
COG,SWZ,2016.0,1,0,1
LBY,ARE,2019.0,1,0,1
FRA,REU,2007.0,11,10,1
ITA,NLD,2015.0,104,79,25
USA,CAN,2014.0,1381,1731,-350
CHE,DEU,2006.0,252,507,-255
NOR,THA,2015.0,2,3,-1
USA,CHN,2016.0,2460,2592,-132
RUS,CHE,2010.0,18,8,10
TUR,USA,2011.0,199,248,-49
NLD,SWE,2008.0,31,31,0
ZAF,MWI,2012.0,5,4,1
USA,IND,2015.0,742,901,-159
ITA,USA,2001.0,355,304,51
HKG,CHN,2012.0,427,297,130
IND,USA,2006.0,648,321,327
AUS,NLD,2015.0,52,83,-31
JPN,DEU,2010.0,105,93,12
CAN,GBR,2018.0,375,353,22
POL,USA,2008.0,121,89,32
CHN,AUS,2019.0,405,396,9
FRA,MEX,2009.0,33,27,6
PRT,NOR,2007.0,1,3,-2
CAN,NZL,2010.0,32,36,-4
AUS,IRN,2010.0,22,53,-31
GBR,ESP,2014.0,219,440,-221
NLD,FRA,2010.0,82,100,-18
ZMB,BEL,2011.0,1,1,0
DEU,FRA,2009.0,308,272,36
USA,ESP,2008.0,319,331,-12
AUS,GBR,2006.0,354,420,-66
GBR,SAU,1999.0,6,4,2
DEU,RUS,2001.0,77,159,-82
USA,ISR,2015.0,309,363,-54
JPN,TZA,2004.0,6,3,3
AUT,GBR,2013.0,71,77,-6
FRA,SWE,2011.0,43,42,1
FRA,AUT,2008.0,24,22,2
ITA,FRA,2010.0,248,181,67
BRA,CAN,2009.0,58,41,17
USA,BEL,2007.0,97,124,-27
USA,SWE,2010.0,198,208,-10
CHL,DNK,2010.0,1,1,0
CAN,DEU,2016.0,152,168,-16
DEU,AUT,2016.0,328,321,7
KOR,CHN,2007.0,71,55,16
JPN,TUR,2012.0,5,8,-3
DEU,ROU,2007.0,20,25,-5
GBR,SWE,2011.0,129,98,31
FIN,DNK,2019.0,19,14,5
HKG,GBR,2004.0,30,26,4
DEU,NZL,2012.0,34,29,5
FRA,ITA,2009.0,156,252,-96
IND,CHL,2019.0,13,4,9
NLD,FRA,2019.0,94,147,-53
RUS,FRA,2012.0,51,30,21
AUS,IRN,2017.0,41,167,-126
THA,DEU,2006.0,11,13,-2
GBR,ISR,2017.0,62,61,1
THA,SWE,2009.0,6,5,1
SVN,USA,2018.0,12,7,5
FRA,NZL,2021.0,11,9,2
IRL,ITA,2012.0,11,21,-10
FRA,CHE,2005.0,219,126,93
USA,MEX,2015.0,192,193,-1
DEU,NLD,2014.0,223,305,-82
HKG,DEU,2018.0,13,19,-6
SAU,EGY,2005.0,21,36,-15
ESP,IND,2016.0,9,21,-12
USA,MYS,2008.0,27,16,11
HRV,SVN,2007.0,2,5,-3
BGR,DEU,2006.0,18,10,8
KEN,TZA,2020.0,5,4,1
ESP,BRA,2011.0,65,49,16
NLD,BEL,2009.0,126,95,31
PAK,NLD,2014.0,5,20,-15
ESP,MYS,2016.0,3,2,1
NZL,AUS,2014.0,189,92,97
CHN,CHE,2018.0,52,44,8
BEL,POL,2018.0,8,11,-3
AUT,CAN,2016.0,12,27,-15
IND,BGD,2015.0,12,11,1
IRN,USA,2017.0,598,87,511
CHN,AUS,2017.0,367,304,63
NOR,ITA,2017.0,12,24,-12
DEU,AUS,2021.0,91,114,-23
MEX,CUB,2014.0,5,13,-8
CAN,ESP,2019.0,44,76,-32
CHE,FRA,2020.0,210,358,-148
ESP,MEX,2015.0,147,106,41
GBR,ISR,2019.0,39,53,-14
CHN,AUS,2010.0,139,64,75
ISR,GBR,2017.0,61,62,-1
NOR,GBR,2018.0,49,109,-60
AUS,FIN,2019.0,17,18,-1
IRN,GBR,2018.0,64,36,28
ITA,FRA,2017.0,358,232,126
CHN,ITA,2020.0,53,69,-16
CAN,SGP,2007.0,22,9,13
IRN,USA,2019.0,535,133,402
CHN,GBR,2004.0,108,89,19
KOR,BGD,2019.0,33,17,16
DNK,IND,2018.0,13,22,-9
FRA,CYP,2022.0,2,4,-2
LBN,SAU,2021.0,4,1,3
CHN,RUS,2020.0,26,27,-1
IRN,FIN,2017.0,17,6,11
BGD,KOR,2009.0,14,5,9
LTU,SWE,2018.0,4,3,1
PAK,SAU,2015.0,71,24,47
IRN,CAN,2022.0,163,26,137
EGY,JPN,2016.0,25,41,-16
CAN,SAU,2016.0,111,59,52
CHN,HKG,2018.0,515,658,-143
JPN,DEU,2017.0,102,120,-18
IRL,CHN,2015.0,17,21,-4
BEL,GBR,2022.0,63,52,11
NOR,ITA,2019.0,14,28,-14
ITA,FRA,2019.0,348,274,74
SVN,AUT,2015.0,6,3,3
IRL,GBR,2022.0,83,95,-12
BEL,AUS,2020.0,35,23,12
ARG,ESP,2021.0,54,45,9
GBR,HKG,2011.0,54,29,25
CUB,ESP,2011.0,30,14,16
TZA,USA,2016.0,20,16,4
JPN,DEU,2019.0,110,134,-24
PRT,USA,2020.0,51,58,-7
USA,KWT,2016.0,25,7,18
COG,COD,2019.0,111,22,89
ITA,BEL,2011.0,79,34,45
FRA,CAN,2021.0,235,189,46
CHE,BEL,2016.0,64,66,-2
DEU,CHN,2011.0,184,217,-33
GBR,LUX,2016.0,9,11,-2
TWN,IND,2018.0,41,72,-31
USA,SWE,2019.0,235,227,8
AUS,PNG,2011.0,6,4,2
CHN,PRI,2019.0,5,1,4
MLT,GBR,2017.0,12,11,1
FRA,LUX,2017.0,36,14,22
CAN,NOR,2018.0,21,13,8
RUS,USA,2021.0,123,85,38
CHE,NLD,2020.0,81,109,-28
ITA,BRA,2017.0,60,52,8
USA,PRI,2021.0,30,48,-18
CHN,CHL,2011.0,1,3,-2
SGP,FRA,2019.0,20,36,-16
NLD,DNK,2021.0,25,32,-7
JPN,MMR,2020.0,9,3,6
TWN,PHL,2016.0,4,3,1
USA,IDN,2018.0,37,19,18
JPN,CHE,2013.0,39,22,17
BEL,RWA,2019.0,1,2,-1
IRN,TUR,2017.0,37,13,24
GHA,NLD,2022.0,2,1,1
GRC,SWE,2020.0,31,12,19
EGY,ITA,2016.0,6,16,-10
FRA,LUX,2019.0,33,18,15
AUS,IRN,2019.0,34,200,-166
CHN,CZE,2021.0,14,11,3
SWE,USA,2003.0,237,208,29
IRQ,RUS,2018.0,2,7,-5
CHN,DZA,2020.0,17,5,12
DZA,FRA,2020.0,54,57,-3
BRA,USA,2003.0,228,293,-65
DNK,KOR,2021.0,5,7,-2
NZL,KOR,2015.0,3,3,0
BGR,GBR,2021.0,2,3,-1
UKR,POL,2019.0,35,18,17
NLD,CHE,2021.0,89,60,29
MYS,NGA,2018.0,86,32,54
CHE,COG,2018.0,9,3,6
CHN,KOR,2021.0,125,195,-70
NOR,BRA,2021.0,5,16,-11
AUT,DNK,2019.0,16,5,11
COG,COD,2017.0,45,14,31
BEL,COG,2020.0,7,7,0
PHL,CHN,2021.0,4,3,1
RUS,CHE,2019.0,27,15,12
CAN,NZL,2017.0,32,41,-9
CHL,ARG,2020.0,21,22,-1
PAK,CAN,2020.0,28,13,15
CHE,CHN,2014.0,41,40,1
GBR,FRA,2003.0,324,304,20
CRI,USA,2020.0,19,20,-1
BGD,THA,2018.0,2,5,-3
FRA,CHE,2002.0,177,153,24
BGD,USA,2008.0,19,13,6
HRV,BIH,2010.0,11,5,6
PAK,AUS,2021.0,29,15,14
PAK,MYS,2014.0,61,30,31
BGD,IND,2008.0,11,6,5
USA,ROU,2007.0,32,16,16
JPN,AUS,2012.0,66,46,20
ESP,PSE,2014.0,4,1,3
MWI,KEN,2017.0,2,2,0
JPN,SAU,2019.0,15,11,4
ESP,ITA,2002.0,64,61,3
BRA,CHL,2019.0,47,15,32
GBR,CHE,1998.0,31,34,-3
SGP,CHN,2002.0,35,82,-47
IRN,SWE,2018.0,35,14,21
USA,GRC,1999.0,41,15,26
IRN,TUR,2010.0,9,1,8
RUS,GBR,1998.0,24,9,15
FRA,RUS,2011.0,34,73,-39
KOR,BGD,2010.0,11,11,0
JPN,POL,2011.0,28,3,25
DEU,ARE,2019.0,14,6,8
PER,CAN,2017.0,4,4,0
IRN,FRA,2012.0,20,15,5
MYS,GBR,2014.0,64,135,-71
NZL,NLD,2009.0,5,11,-6
KOR,JPN,2012.0,97,129,-32
SWE,DEU,2009.0,74,116,-42
BGD,SWE,2010.0,1,3,-2
BGD,CAN,2016.0,21,15,6
USA,FIN,2013.0,60,76,-16
KOR,PAK,2015.0,27,38,-11
NLD,IRL,2011.0,9,13,-4
FIN,DNK,2010.0,11,5,6
KOR,CHE,2013.0,10,17,-7
PRT,IND,2013.0,11,15,-4
PAK,GBR,2018.0,50,80,-30
PER,ESP,2008.0,8,7,1
BEL,IRN,2011.0,14,14,0
SGP,CHN,2005.0,98,85,13
CAN,CHE,2007.0,44,74,-30
SGP,DEU,2006.0,13,16,-3
CHN,SWE,2003.0,24,19,5
ARE,AUS,2008.0,5,11,-6
KOR,TWN,2002.0,4,5,-1
IND,DEU,2002.0,73,48,25
ROU,MDA,2013.0,4,2,2
SWE,FRA,2001.0,41,29,12
ESP,AUT,2006.0,6,8,-2
SAU,NGA,2019.0,5,9,-4
FRA,DZA,2022.0,9,26,-17
GBR,ISR,2010.0,33,34,-1
BRA,FRA,2008.0,82,62,20
DNK,BEL,2018.0,9,16,-7
FRA,SEN,2006.0,29,24,5
JPN,VNM,2011.0,35,9,26
HRV,USA,2013.0,17,20,-3
ZAF,KAZ,2017.0,1,1,0
DEU,SRB,2019.0,4,21,-17
RUS,CHE,2017.0,18,13,5
ESP,ITA,2005.0,56,85,-29
TZA,ZAF,2018.0,9,9,0
GBR,CHE,1997.0,18,18,0
CAN,KEN,2014.0,8,8,0
PAK,DEU,2019.0,17,47,-30
CZE,CHE,2012.0,13,5,8
POL,LTU,2003.0,3,3,0
IRN,FIN,2019.0,31,2,29
IDN,AUT,2020.0,1,4,-3
ESP,GRC,2008.0,9,20,-11
AUS,QAT,2022.0,9,4,5
UKR,POL,2017.0,30,15,15
MLI,CAN,2015.0,1,1,0
DEU,HUN,2001.0,24,23,1
TUN,ITA,2020.0,6,3,3
ITA,BRA,2019.0,49,64,-15
ITA,IRN,2021.0,15,59,-44
TUR,ITA,2020.0,16,8,8
CUB,MEX,2020.0,25,5,20
CHL,DNK,2019.0,3,1,2
TWN,DEU,2015.0,19,13,6
GBR,OMN,2020.0,16,10,6
CAN,NZL,2019.0,36,38,-2
BGD,DEU,2001.0,3,1,2
TUN,CAN,2021.0,9,3,6
ITA,BRA,2010.0,37,22,15
CAN,MYS,2022.0,1,11,-10
USA,CHL,2007.0,70,50,20
MEX,NGA,2020.0,2,1,1
DEU,COL,2013.0,15,19,-4
GBR,POL,2000.0,9,5,4
IND,ISR,2000.0,8,1,7
BRA,ARE,2020.0,4,1,3
NLD,MEX,2010.0,7,5,2
CHE,CZE,2011.0,6,13,-7
NOR,RUS,2019.0,9,5,4
KEN,CMR,2013.0,2,1,1
NLD,ITA,2006.0,50,54,-4
DEU,ARE,2017.0,6,3,3
IND,TWN,2008.0,47,15,32
ESP,CAN,2005.0,21,19,2
ESP,BGR,2005.0,2,1,1
ESP,CHE,2008.0,41,41,0
MDG,GBR,2004.0,2,1,1
AUS,CHE,2007.0,37,46,-9
PAN,DEU,2004.0,1,1,0
CHE,IRL,2008.0,11,4,7
NOR,ITA,2010.0,5,17,-12
BWA,ZWE,2015.0,4,1,3
ITA,JPN,2001.0,17,22,-5
GBR,NPL,2004.0,4,4,0
SWE,BOL,2014.0,4,1,3
NZL,USA,2003.0,104,92,12
ITA,MEX,1999.0,2,5,-3
CAN,VNM,2002.0,4,1,3
DEU,FIN,2002.0,27,31,-4
POL,CHE,2009.0,13,6,7
ESP,CAN,2002.0,15,17,-2
JPN,HUN,2003.0,10,6,4
ESP,NLD,2012.0,56,56,0
BRA,AUS,2007.0,14,12,2
SWE,RUS,2013.0,13,18,-5
CHE,SVK,2015.0,4,5,-1
SAU,EGY,2002.0,29,19,10
USA,HRV,2003.0,24,12,12
FIN,USA,2000.0,27,22,5
PRT,ESP,2003.0,11,32,-21
GBR,LKA,2004.0,10,5,5
NGA,BEN,2007.0,3,3,0
IDN,JPN,1999.0,2,2,0
NOR,DEU,2006.0,9,45,-36
FRO,USA,2011.0,1,1,0
FRA,KOR,2008.0,20,11,9
BGR,ITA,2007.0,7,4,3
HRV,BIH,2017.0,9,8,1
SVN,CHN,2011.0,2,2,0
JPN,CHL,2019.0,4,8,-4
HRV,BIH,2019.0,11,6,5
KOR,GBR,1999.0,3,8,-5
NZL,SWE,2013.0,16,5,11
BGR,USA,2004.0,12,14,-2
SWE,ITA,2000.0,12,7,5
RUS,UKR,2000.0,15,23,-8
BEL,VNM,2002.0,1,1,0
SAU,USA,2003.0,18,57,-39
SGP,NOR,2008.0,6,2,4
BEN,USA,2002.0,1,3,-2
LBN,FRA,2002.0,8,17,-9
BEL,NZL,2013.0,4,3,1
MYS,EGY,2021.0,15,5,10
ETH,KEN,2008.0,3,2,1
SAU,SDN,2019.0,14,30,-16
EGY,FRA,2010.0,9,8,1
ARE,EGY,2001.0,7,6,1
GBR,JPN,2022.0,48,53,-5
KOR,SGP,2006.0,6,8,-2
JPN,UKR,1999.0,2,6,-4
BEL,USA,1997.0,13,17,-4
FRA,DNK,2000.0,8,5,3
USA,HTI,2005.0,2,1,1
BOL,FRA,2009.0,1,3,-2
ZWE,USA,2013.0,8,2,6
FIN,CAN,2011.0,10,9,1
ECU,CAN,2012.0,2,1,1
GBR,GMB,2015.0,5,4,1
SAU,PAK,2008.0,6,16,-10
HKG,NZL,2005.0,3,3,0
NZL,ESP,1999.0,1,1,0
CAN,TUR,2018.0,22,35,-13
BRB,CAN,2006.0,2,2,0
BEL,NGA,2012.0,2,2,0
EGY,FIN,2018.0,4,4,0
USA,DOM,2011.0,4,4,0
IND,SWE,2009.0,27,9,18
HUN,CZE,2009.0,5,3,2
BEL,EGY,2007.0,3,1,2
FRA,PAK,2011.0,12,8,4
LBN,FRA,2005.0,9,27,-18
ISR,GBR,2010.0,34,33,1
CHE,HUN,2013.0,14,16,-2
PAK,KOR,2007.0,5,8,-3
BEL,BRA,2014.0,14,20,-6
DEU,FIN,2005.0,24,22,2
CHE,TUR,2001.0,3,1,2
NZL,IND,2006.0,3,5,-2
LUX,GBR,2011.0,2,10,-8
JPN,KGZ,2016.0,1,1,0
IRN,PAK,2004.0,2,1,1
IND,CHL,2010.0,3,2,1
TWN,ESP,2012.0,4,1,3
IND,KWT,2004.0,9,4,5
NLD,ARE,2012.0,3,1,2
TUR,NZL,2012.0,3,2,1
FRA,COG,2009.0,6,4,2
AUS,COL,2009.0,3,2,1
FRA,CMR,2013.0,15,6,9
DEU,SRB,2017.0,9,22,-13
QAT,IND,2017.0,3,12,-9
SVN,FRA,2007.0,2,4,-2
LBR,USA,2013.0,1,1,0
TUN,GBR,2013.0,1,1,0
NLD,PAK,2012.0,6,9,-3
CHN,ISR,2018.0,29,21,8
RUS,ARE,2020.0,3,1,2
NLD,ISR,2014.0,9,8,1
GBR,NGA,2011.0,28,14,14
FRA,HUN,2016.0,15,16,-1
VNM,FRA,2015.0,17,33,-16
IRL,BEL,2013.0,7,3,4
JPN,NLD,2020.0,30,18,12
RUS,IRL,2021.0,7,2,5
CAN,NGA,2018.0,12,15,-3
NLD,IRN,2015.0,17,27,-10
NLD,MEX,2019.0,5,26,-21
KWT,MYS,2012.0,2,1,1
POL,IRN,2022.0,3,16,-13
MLT,GBR,2019.0,12,21,-9
SWE,HUN,2010.0,7,12,-5
PRT,CHN,2008.0,7,4,3
OMN,TUR,2017.0,1,2,-1
QAT,IND,2019.0,5,18,-13
CAN,GRC,2011.0,4,7,-3
MAR,USA,2017.0,4,8,-4
ARG,AUS,2014.0,13,4,9
MAR,USA,2019.0,12,8,4
SWE,HUN,2019.0,1,4,-3
PRT,ZAF,2017.0,4,1,3
NOR,PAK,2021.0,2,1,1
MYS,AUS,2001.0,7,3,4
NLD,ISL,2021.0,2,3,-1
CMR,BEL,2018.0,2,2,0
GHA,USA,2016.0,12,25,-13
NGA,KEN,2021.0,2,3,-1
CZE,NLD,2020.0,8,3,5
COG,CHE,2020.0,3,2,1
BGD,SWE,2017.0,8,4,4
KGZ,DEU,2018.0,1,1,0
BGD,SWE,2019.0,8,1,7
IRN,VNM,2021.0,9,3,6
SVN,ITA,2022.0,4,3,1
KEN,ETH,2001.0,1,3,-2
IRN,EGY,2021.0,2,2,0
GBR,BRA,2009.0,48,48,0
DEU,UGA,2007.0,1,3,-2
JPN,SAU,2017.0,23,6,17
UKR,POL,2010.0,16,14,2
FIN,NLD,2012.0,18,10,8
HKG,NZL,2002.0,2,5,-3
AUT,DNK,2017.0,11,12,-1
GBR,KOR,2006.0,30,15,15
GBR,VEN,2001.0,5,4,1
BRA,CHL,2010.0,16,8,8
ESP,PRT,2004.0,19,19,0
NLD,BRA,2022.0,8,25,-17
ITA,EST,2012.0,4,1,3
SGP,FRA,2010.0,9,18,-9
ZAF,CAN,2015.0,25,19,6
NOR,RUS,2017.0,8,9,-1
RUS,EST,2020.0,5,1,4
EGY,PSE,2015.0,4,3,1
SWE,MYS,2015.0,5,4,1
GRC,SAU,2020.0,5,1,4
CHL,BRA,2006.0,3,8,-5
EGY,FRA,2017.0,10,15,-5
CAN,EST,2019.0,2,1,1
MEX,VEN,2018.0,4,14,-10
AUS,FIN,2017.0,13,13,0
ESP,GEO,2018.0,1,1,0
NOR,IND,2014.0,10,6,4
HKG,LKA,2019.0,3,1,2
GRC,JPN,2015.0,3,3,0
NGA,GHA,2007.0,2,2,0
IRN,FIN,2010.0,5,3,2
ESP,ISR,2013.0,7,6,1
NZL,BEL,2016.0,6,4,2
CHN,NLD,1999.0,7,1,6
AUT,HUN,2012.0,9,14,-5
SLE,GBR,2018.0,2,2,0
SGP,NZL,2013.0,4,7,-3
DEU,PSE,2015.0,6,4,2
FRA,SVK,2022.0,2,3,-1
BEL,USA,1998.0,28,28,0
NLD,MEX,2017.0,12,13,-1
KAZ,GBR,2018.0,5,9,-4
NOR,IRN,2019.0,3,9,-6
CZE,POL,2013.0,4,6,-2
SRB,SWE,2006.0,2,2,0
SWE,THA,2017.0,8,7,1
SWE,TWN,2015.0,5,6,-1
HKG,CHE,2016.0,9,8,1
BRN,VNM,2020.0,1,1,0
IND,SGP,2004.0,31,8,23
GBR,MCO,2018.0,2,1,1
RUS,AUT,2012.0,12,3,9
PHL,KOR,2013.0,3,7,-4
ZWE,KEN,2015.0,1,1,0
GBR,SRB,2001.0,1,2,-1
MLT,TUR,2018.0,1,1,0
ARM,RUS,2018.0,3,5,-2
NCL,AUS,2018.0,4,4,0
ALB,AUT,2020.0,2,1,1
CHE,ROU,2003.0,3,4,-1
TUR,EGY,2018.0,3,1,2
IDN,FRA,2013.0,6,12,-6
SWE,THA,2019.0,7,3,4
TWN,TUR,2006.0,2,1,1
SWE,LKA,1998.0,1,1,0
USA,GAB,2001.0,3,1,2
CAN,EST,2017.0,1,1,0
NGA,FRA,2015.0,3,5,-2
OMN,TUN,2016.0,2,2,0
RUS,GBR,1997.0,17,13,4
SVN,SWE,2016.0,6,1,5
ZAF,NAM,2004.0,2,3,-1
PRT,ZAF,2019.0,1,1,0
AUT,AUS,2006.0,12,16,-4
SGP,JPN,2007.0,15,20,-5
CZE,JPN,2005.0,3,8,-5
KOR,UZB,2006.0,2,1,1
HKG,SWE,2012.0,3,1,2
HUN,AUT,1999.0,2,3,-1
VEN,BRA,2013.0,6,2,4
NLD,QAT,2017.0,2,8,-6
CHE,TZA,2005.0,3,1,2
MEX,IRL,2009.0,4,2,2
SVK,DEU,2004.0,17,10,7
LKA,GBR,2003.0,4,11,-7
DEU,LTU,2003.0,5,4,1
CYP,NOR,2012.0,2,1,1
HKG,FRA,2001.0,1,4,-3
AUS,PHL,2013.0,3,12,-9
ZAF,ZWE,2011.0,6,14,-8
MEX,JPN,2003.0,5,2,3
BFA,SEN,2008.0,4,1,3
AUT,DNK,2010.0,10,3,7
FIN,ISR,2009.0,1,2,-1
IRN,JPN,2009.0,8,19,-11
NOR,CAN,2004.0,4,11,-7
RUS,BLR,2014.0,9,21,-12
USA,JAM,2008.0,5,3,2
IND,THA,2006.0,7,3,4
CHL,NZL,2011.0,4,3,1
ARE,CHN,2014.0,2,2,0
NLD,HKG,2013.0,4,1,3
DEU,CUB,2017.0,1,2,-1
CHE,KOR,2005.0,5,6,-1
JOR,GBR,2009.0,6,11,-5
RUS,MYS,2021.0,4,3,1
AUT,SWE,2014.0,15,16,-1
CAN,RUS,2014.0,17,16,1
CZE,ITA,2016.0,9,15,-6
SRB,SAU,2020.0,2,1,1
KOR,ITA,2018.0,8,8,0
DNK,ROU,2005.0,2,1,1
GUF,FRA,2001.0,2,2,0
NZL,CHE,2018.0,19,11,8
AUT,MEX,2017.0,2,4,-2
MYS,BHR,2017.0,3,1,2
BFA,GBR,2013.0,1,1,0
USA,MNP,2019.0,1,1,0
ARG,BRA,2021.0,14,17,-3
IND,NOR,2006.0,4,6,-2
SDN,CHN,2021.0,7,7,0
OMN,ITA,2018.0,2,1,1
DEU,ARE,2010.0,4,2,2
GTM,USA,2005.0,3,4,-1
CZE,SAU,2018.0,3,1,2
CHL,CHE,2006.0,2,1,1
BRA,CHN,2005.0,2,2,0
NCL,FRA,2012.0,10,21,-11
AUT,FIN,2014.0,4,12,-8
CHN,NZL,2013.0,11,19,-8
LBN,GBR,2001.0,2,3,-1
MAR,ZAF,2019.0,4,2,2
EGY,DZA,2011.0,2,1,1
ZWE,BRA,2011.0,1,1,0
BRA,JPN,2007.0,8,6,2
NZL,TUR,2000.0,1,1,0
ISL,GBR,2008.0,6,11,-5
EST,DNK,2019.0,2,3,-1
TGO,FRA,2009.0,6,4,2
CZE,CAN,2014.0,5,9,-4
ZAF,IRL,2005.0,5,1,4
LVA,ITA,2014.0,1,1,0
ARG,JPN,2017.0,3,1,2
DEU,SRB,2010.0,6,6,0
BEL,MYS,2013.0,3,1,2
EGY,YEM,2018.0,2,1,1
PHL,HKG,2016.0,3,4,-1
BGD,PAK,2013.0,4,8,-4
NZL,CHL,2021.0,1,1,0
YEM,SAU,2021.0,8,3,5
CZE,SWE,2022.0,6,4,2
DNK,ESP,2022.0,7,20,-13
FRA,MTQ,2022.0,7,3,4
TUN,BEL,2013.0,6,3,3
CHL,ITA,2014.0,4,8,-4
BEL,CHL,2020.0,9,11,-2
AUT,THA,2006.0,3,3,0
GBR,GUY,2013.0,2,1,1
CRI,BRA,2004.0,1,1,0
NLD,SVN,1998.0,2,1,1
FRA,CUB,2003.0,2,2,0
JPN,NZL,2006.0,4,2,2
TUN,ARE,2021.0,7,5,2
NER,FRA,2003.0,3,5,-2
FIN,ROU,2014.0,3,4,-1
NZL,FIN,2016.0,3,1,2
BRA,CHN,2002.0,6,2,4
NLD,TWN,2006.0,3,1,2
KOR,RUS,1999.0,1,10,-9
PAK,THA,2014.0,4,13,-9
MEX,COL,2003.0,8,5,3
DNK,NZL,2007.0,3,4,-1
RUS,NOR,2003.0,7,11,-4
GEO,USA,2001.0,5,6,-1
MEX,SWE,2000.0,1,1,0
UKR,NOR,2001.0,1,1,0
NZL,FRA,2004.0,4,3,1
DEU,BLR,2010.0,5,8,-3
RUS,CZE,1999.0,3,2,1
DEU,HKG,2001.0,4,2,2
AND,ESP,2012.0,3,1,2
BEL,SVN,2014.0,2,4,-2
RUS,FIN,1998.0,3,1,2
NOR,RUS,2010.0,7,14,-7
THA,PHL,2005.0,1,1,0
CHE,ZAF,2014.0,6,10,-4
KWT,AUS,2010.0,1,1,0
CZE,CHN,2006.0,1,1,0
KWT,GBR,2002.0,3,7,-4
BGR,CHE,2002.0,3,2,1
AUT,MEX,2019.0,3,7,-4
TWN,SWE,2013.0,2,3,-1
SAU,KWT,2004.0,4,1,3
UGA,CHE,2005.0,1,2,-1
LUX,DEU,2002.0,2,1,1
COG,COD,2010.0,9,13,-4
CUB,GBR,2008.0,1,2,-1
JPN,CHL,2010.0,5,1,4
KEN,SWE,2020.0,5,3,2
THA,HKG,2020.0,6,4,2
SWE,SVN,2013.0,2,4,-2
PSE,ISR,2009.0,3,7,-4
SRB,ISR,2017.0,1,1,0
COL,CUB,2012.0,1,5,-4
NLD,HUN,2022.0,2,7,-5
QAT,IND,2010.0,1,6,-5
MLT,ITA,2006.0,2,1,1
BEL,TUR,2021.0,8,8,0
KOR,TWN,2005.0,3,3,0
BEL,LTU,2019.0,1,1,0
CZE,JPN,2002.0,3,9,-6
MWI,TZA,2020.0,1,2,-1
POL,DZA,2018.0,1,1,0
KAZ,FRA,2018.0,4,3,1
UKR,NLD,2018.0,8,2,6
GHA,CHN,2022.0,9,28,-19
ZWE,IND,2021.0,1,1,0
MEX,FRA,2006.0,20,30,-10
GRC,ESP,2002.0,4,9,-5
ZAF,ZMB,2009.0,1,3,-2
DNK,GRC,2007.0,2,7,-5
BLR,USA,2000.0,6,2,4
CHN,AUT,2004.0,3,2,1
CHL,BEL,2006.0,8,2,6
PRI,IND,2006.0,2,2,0
URY,ESP,2003.0,5,8,-3
LAO,USA,2012.0,1,2,-1
AUS,IRQ,2013.0,3,4,-1
UKR,AUT,1998.0,2,3,-1
KEN,IND,2001.0,1,1,0
ZMB,NOR,2010.0,2,2,0
OMN,SAU,2015.0,4,3,1
GBR,AUT,1997.0,3,3,0
CYP,GRC,2007.0,6,24,-18
UKR,ESP,2013.0,5,2,3
BEL,MEX,2015.0,5,8,-3
BLR,POL,2004.0,3,1,2
EGY,JOR,2007.0,1,2,-1
IRL,FIN,2008.0,3,3,0
JPN,CMR,2016.0,3,1,2
IND,BHR,2007.0,1,1,0
NZL,HKG,2013.0,3,5,-2
UZB,USA,2013.0,1,1,0
EGY,KOR,2006.0,3,2,1
SVN,AUS,2013.0,2,1,1
ARE,ZAF,2007.0,1,1,0
SRB,DEU,1999.0,4,1,3
SWE,NPL,2013.0,1,1,0
GBR,LAO,2011.0,3,1,2
EST,NOR,2013.0,2,2,0
SLV,USA,2012.0,1,1,0
SGP,HUN,2018.0,1,1,0
EGY,FRA,2019.0,7,17,-10
CHE,BIH,2019.0,3,3,0
CAN,IRQ,2016.0,2,2,0
VNM,CAN,2016.0,2,4,-2
SAU,AUT,2018.0,1,1,0
SAU,KOR,2022.0,5,6,-1
CZE,PAK,2020.0,2,2,0
ARG,JPN,2010.0,2,1,1
CHE,EST,2013.0,1,2,-1
IRL,POL,2014.0,2,6,-4
MYS,FRA,2022.0,3,3,0
FRA,SRB,2003.0,2,3,-1
GBR,PAK,1999.0,1,3,-2
RUS,MDA,1999.0,1,3,-2
BRN,AUS,2010.0,2,4,-2
SRB,CAN,2000.0,2,1,1
NLD,MOZ,2004.0,1,2,-1
UZB,FRA,2006.0,1,1,0
GEO,FRA,2012.0,3,1,2
MYS,SWE,2012.0,4,5,-1
TUR,BIH,2013.0,1,1,0
MAC,GBR,2019.0,3,4,-1
COL,DNK,2020.0,3,2,1
THA,AUT,2013.0,2,3,-1
KOR,AUT,2008.0,6,1,5
ITA,BGD,2015.0,4,7,-3
USA,GHA,2022.0,13,17,-4
PRT,IRN,2021.0,1,8,-7
NZL,CHN,2009.0,3,10,-7
CHN,SOM,2020.0,1,1,0
ESP,KOR,2022.0,5,1,4
DEU,BLR,2017.0,4,5,-1
DEU,SYR,2006.0,2,1,1
HUN,TUR,2007.0,1,2,-1
SGP,ARE,2012.0,7,1,6
HUN,FIN,2000.0,4,1,3
BRA,ZAF,2002.0,1,2,-1
NLD,SAU,2014.0,6,1,5
NZL,SGP,2004.0,3,11,-8
IND,NGA,2011.0,6,3,3
SGP,DNK,2004.0,1,1,0
POL,ISR,2007.0,1,2,-1
SWE,LVA,2007.0,3,2,1
MEX,POL,2000.0,1,3,-2
FIN,ESP,1997.0,2,1,1
GAB,DEU,2003.0,2,1,1
AUS,NAM,2012.0,2,1,1
SGP,IND,2002.0,6,15,-9
BRA,COL,2003.0,5,4,1
LIE,DEU,2008.0,2,3,-1
GBR,IDN,1999.0,1,1,0
DNK,TWN,2003.0,1,1,0
DEU,LBN,2008.0,1,2,-1
BGR,CHE,2005.0,2,2,0
GRC,BRA,2012.0,2,1,1
BRN,AUS,2017.0,3,1,2
NGA,GMB,2014.0,1,2,-1
BFA,USA,2015.0,2,4,-2
ISR,NLD,2021.0,6,8,-2
ECU,BRA,2022.0,2,4,-2
THA,MYS,2021.0,2,10,-8
FRA,ARM,1999.0,1,1,0
JPN,HRV,2003.0,1,1,0
SVN,GBR,2003.0,2,2,0
MYS,PHL,2012.0,1,1,0
TUR,POL,2018.0,2,1,1
IND,SYR,2014.0,1,2,-1
CZE,SVN,2016.0,1,1,0
URY,ARG,2011.0,2,1,1
POL,SVN,2013.0,2,4,-2
NGA,NLD,2012.0,3,1,2
BEL,TUN,2006.0,2,1,1
UKR,BLR,2003.0,2,3,-1
CAN,VNM,2005.0,1,1,0
HKG,MAC,2003.0,2,1,1
ISR,UKR,2003.0,3,1,2
AUS,SRB,2003.0,1,1,0
TUR,BEL,2001.0,2,3,-1
SWE,SGP,1998.0,1,1,0
MEX,CHN,2005.0,1,1,0
ZAF,THA,2020.0,2,1,1
PER,BRA,2007.0,2,4,-2
ZAF,SGP,2013.0,1,1,0
EGY,SWE,2009.0,2,1,1
JPN,ARG,2015.0,1,1,0
CAN,IRL,2000.0,1,5,-4
GMB,CAN,2018.0,1,1,0
CAN,BWA,2014.0,1,2,-1
KWT,FRA,2015.0,1,3,-2
USA,SLV,2016.0,2,1,1
SEN,CIV,2013.0,1,1,0
JOR,IND,2021.0,2,1,1
DNK,LTU,2012.0,3,2,1
NZL,CZE,2015.0,1,1,0
ITA,NGA,2008.0,2,1,1
ZAF,ITA,2015.0,3,11,-8
KAZ,PHL,2017.0,3,1,2
GRC,ISR,2020.0,2,1,1
DNK,HRV,2013.0,1,2,-1
CHE,MLI,2006.0,1,1,0
SAU,SYR,2009.0,1,1,0
ESP,URY,2022.0,1,5,-4
CHE,COL,2014.0,4,5,-1
RWA,GBR,2013.0,1,1,0
BLR,ESP,1999.0,2,2,0
AUT,LIE,2015.0,1,2,-1
AUS,FIN,2010.0,6,6,0
GHA,FIN,2019.0,3,2,1
CZE,BRA,2009.0,1,1,0
DEU,MYS,2005.0,1,1,0
FRA,BLR,2009.0,1,1,0
JPN,ISR,1998.0,2,3,-1
USA,MDG,2009.0,1,5,-4
MDA,USA,2009.0,4,3,1
BEL,ARE,2005.0,1,1,0
SYR,GBR,2003.0,1,2,-1
AUT,GRC,2013.0,1,5,-4
JOR,AUS,2007.0,1,6,-5
IRQ,TUR,2014.0,1,3,-2
BEL,LTU,2017.0,1,1,0
JPN,DZA,2009.0,1,1,0
THA,CHE,2008.0,3,3,0
COL,VEN,2008.0,2,5,-3
NGA,HKG,2020.0,1,3,-2
HKG,PAK,2016.0,2,4,-2
CHL,DNK,2017.0,3,5,-2
SWZ,ZAF,2002.0,2,2,0
SAU,IDN,2022.0,1,1,0
UKR,CHE,2013.0,4,2,2
MAR,USA,2010.0,1,2,-1
CHE,CMR,2004.0,1,1,0
OMN,IRN,2018.0,1,4,-3
PER,CAN,2010.0,1,3,-2
HKG,BEL,2018.0,1,3,-2
CHE,PHL,2014.0,2,3,-1
NLD,QAT,2019.0,2,4,-2
EST,DNK,2017.0,1,4,-3
PRT,HUN,2019.0,2,2,0
ITA,BOL,2017.0,1,1,0
CAF,FRA,2012.0,4,3,1
PER,GBR,2000.0,1,1,0
ESP,BGR,2002.0,1,4,-3
IDN,MYS,2008.0,2,9,-7
SAU,YEM,2007.0,2,1,1
THA,CHN,2007.0,2,1,1
IND,BRB,2012.0,1,1,0
TWN,CRI,2012.0,1,1,0
BEL,ROU,2022.0,4,3,1
IRL,UKR,2007.0,1,1,0
GRC,KAZ,2020.0,1,1,0
BOL,ITA,2017.0,1,1,0
IND,LKA,2022.0,2,1,1
JPN,CHL,2017.0,5,3,2
IRN,AUS,2006.0,3,15,-12
DOM,CUB,2008.0,1,2,-1
DEU,MDA,2008.0,1,3,-2
LTU,BEL,2008.0,1,1,0
MDV,IND,2022.0,1,1,0
COL,SWE,2003.0,1,2,-1
TTO,USA,2007.0,1,5,-4
LKA,USA,2014.0,4,16,-12
ARE,BHR,2007.0,1,2,-1
SYR,JPN,2007.0,1,1,0
CHE,FJI,2011.0,1,1,0
SWE,HRV,2021.0,1,3,-2
MAC,GBR,2017.0,1,2,-1
CAN,LBN,2001.0,1,3,-2
NLD,LBY,2009.0,1,1,0
MYS,SGP,2001.0,2,1,1
SDN,USA,2020.0,1,1,0
IDN,CHE,2014.0,1,2,-1
USA,MUS,2019.0,3,4,-1
TWN,RUS,2018.0,2,3,-1
OMN,ARE,2022.0,2,1,1
CHL,URY,2021.0,1,2,-1
CZE,IDN,2009.0,1,1,0
BEL,COD,2013.0,1,1,0
AUS,TLS,2021.0,1,2,-1
AUT,ARG,2020.0,1,4,-3
FIN,ITA,1999.0,2,5,-3
IRL,KOR,2005.0,1,1,0
AGO,PRT,2012.0,1,1,0
BEL,LVA,2013.0,1,1,0
HRV,CAN,2008.0,1,2,-1
ARG,URY,2003.0,2,1,1
URY,COL,2018.0,1,1,0
THA,GRC,2011.0,1,1,0
MEX,CHN,2002.0,1,2,-1
HUN,SRB,2014.0,1,2,-1
BGR,POL,2007.0,1,3,-2
BEL,VNM,2005.0,1,2,-1
DEU,CUB,2019.0,1,9,-8
BIH,USA,2005.0,1,3,-2
ECU,VEN,2013.0,1,5,-4
BLR,GBR,2005.0,1,1,0
BGR,GRC,2016.0,1,1,0
MAR,ZAF,2017.0,1,3,-2
USA,SOM,2014.0,1,1,0
MOZ,ESP,2016.0,1,3,-2
PRT,EGY,2017.0,1,1,0
USA,MLI,2012.0,1,2,-1
BRA,CUB,2020.0,1,11,-10
TUR,DNK,2004.0,1,2,-1
ISR,ARG,2013.0,1,1,0
THA,NZL,2002.0,1,1,0
DEU,CMR,2013.0,1,5,-4
MUS,GBR,2007.0,1,3,-2
SVK,NLD,2013.0,1,1,0
FRA,MLI,2018.0,3,3,0
VNM,BEL,2013.0,1,8,-7
VNM,CHE,2011.0,1,2,-1
CIV,BFA,2016.0,1,3,-2
BRA,IND,2000.0,1,2,-1
DNK,PAK,2016.0,1,1,0
IND,BWA,2019.0,2,2,0
UZB,JPN,2012.0,1,2,-1
BEL,RWA,2010.0,1,2,-1
FRA,MDA,2001.0,1,1,0
BRN,AUS,2019.0,1,3,-2
POL,SGP,2016.0,1,5,-4
USA,BMU,2005.0,1,2,-1
NGA,TUR,2021.0,1,3,-2
NLD,RUS,2015.0,11,18,-7
CAN,ESP,2010.0,47,40,7
GBR,ARG,2014.0,11,18,-7
USA,SGP,2009.0,211,167,44
KWT,GBR,2005.0,5,6,-1
GBR,IND,2011.0,142,125,17
BRA,CHL,2017.0,37,17,20
JPN,SGP,2013.0,35,22,13
NZL,DEU,2006.0,14,22,-8
GBR,BEL,2021.0,112,99,13
MDG,FRA,2006.0,9,9,0
IND,ITA,2009.0,38,17,21
ISR,DEU,2015.0,40,54,-14
IRN,USA,2010.0,163,47,116
SAU,TUN,2020.0,31,133,-102
SAU,IND,2015.0,27,167,-140
ESP,NOR,2018.0,21,9,12
DEU,BEL,2021.0,71,75,-4
NLD,FRA,2017.0,94,103,-9
IND,IRL,2020.0,27,14,13
CAN,JPN,1999.0,43,41,2
IND,CHE,2020.0,47,39,8
NPL,KOR,2013.0,3,4,-1
KOR,BGD,2017.0,31,26,5
GBR,TUR,2020.0,67,80,-13
UKR,RUS,2015.0,219,27,192
GBR,CZE,2011.0,22,34,-12
IRN,TUR,2019.0,33,14,19
GBR,NOR,2015.0,69,43,26
ISR,GBR,2019.0,53,39,14
UKR,CZE,2020.0,17,3,14
FIN,DNK,2017.0,28,17,11
LBR,CHE,2019.0,7,2,5
GRC,LUX,2017.0,3,1,2
TWN,KOR,2015.0,11,8,3
SVK,AUT,2013.0,9,9,0
IRL,NLD,2022.0,13,9,4
AUS,HKG,2004.0,19,27,-8
PAK,DEU,2017.0,34,35,-1
FRA,POL,2012.0,78,29,49
FRA,LUX,2010.0,28,8,20
MEX,BRA,2014.0,26,12,14
AUS,IDN,2008.0,17,8,9
FRA,NOR,2011.0,32,17,15
IRN,ESP,2011.0,5,7,-2
SWE,CHN,2001.0,18,21,-3
PRI,USA,2009.0,79,53,26
FIN,CHN,2009.0,14,8,6
JPN,AUT,2012.0,15,10,5
LBN,ITA,2015.0,3,4,-1
GBR,BGD,2005.0,15,6,9
DEU,PRT,2018.0,30,45,-15
PER,CAN,2019.0,2,5,-3
PAK,OMN,2020.0,10,3,7
SWE,HUN,2017.0,7,13,-6
GLP,FRA,2014.0,18,14,4
IND,KEN,2018.0,8,4,4
ARG,CHE,2022.0,7,2,5
CHE,CAN,2003.0,53,54,-1
MYS,TUR,2020.0,13,2,11
DEU,CUB,2010.0,2,3,-1
CAN,ESP,2017.0,42,52,-10
THA,FRA,2006.0,7,6,1
OMN,JOR,2009.0,2,1,1
IND,DEU,2005.0,86,50,36
SAU,SDN,2017.0,4,25,-21
CHE,ITA,2006.0,74,100,-26
DEU,BRA,2000.0,20,10,10
GBR,TWN,2001.0,26,3,23
MAC,USA,2011.0,2,6,-4
UKR,FRA,2008.0,12,4,8
DEU,IRN,1999.0,2,2,0
SGP,FRA,2017.0,19,23,-4
CHE,KOR,2002.0,3,4,-1
ITA,GRC,2004.0,15,11,4
LUX,DEU,2005.0,4,6,-2
VEN,GBR,2005.0,4,8,-4
EST,ESP,2011.0,1,1,0
NLD,ZWE,2021.0,3,2,1
NOR,CHE,2021.0,9,24,-15
CHE,RUS,2004.0,7,18,-11
BHR,USA,2006.0,3,3,0
SWE,ARG,2003.0,4,6,-2
FRA,LAO,2007.0,1,3,-2
USA,ISL,2007.0,6,14,-8
JPN,SAU,2010.0,13,2,11
MYS,JPN,2006.0,10,15,-5
CHE,LVA,2018.0,2,5,-3
TUR,IND,2020.0,4,7,-3
NOR,IRN,2017.0,3,14,-11
ESP,PAK,2014.0,4,4,0
PAK,BGD,2004.0,5,1,4
ARE,NLD,2021.0,3,1,2
DEU,GEO,2021.0,2,3,-1
SWE,THA,2010.0,4,6,-2
USA,SVK,2012.0,6,4,2
VEN,GBR,2002.0,3,9,-6
SGP,IND,2005.0,14,21,-7
USA,ECU,2003.0,6,5,1
PRT,JPN,2011.0,3,4,-1
CHL,NOR,2018.0,4,1,3
DEU,ZAF,2004.0,9,13,-4
USA,HND,2018.0,1,3,-2
FJI,AUS,2013.0,12,5,7
CHE,PRT,2011.0,13,9,4
ARM,USA,2012.0,3,3,0
ESP,PER,2007.0,8,7,1
RUS,KAZ,2022.0,10,11,-1
CHE,NZL,2021.0,7,5,2
ISR,AUS,1998.0,1,1,0
GRC,ESP,2005.0,4,4,0
COL,ECU,2011.0,1,1,0
SAU,SDN,2010.0,2,10,-8
CAN,HUN,2016.0,7,9,-2
ISR,AUT,2007.0,4,1,3
ETH,JPN,2003.0,2,1,1
RUS,DNK,1999.0,3,2,1
SVK,KEN,2018.0,3,1,2
CAN,LUX,2018.0,3,3,0
ITA,EGY,2016.0,16,6,10
FRA,CAF,2014.0,3,3,0
GBR,AUT,1998.0,7,5,2
PAK,DEU,2010.0,11,17,-6
PRT,ROU,2014.0,3,1,2
SDN,DEU,2018.0,1,2,-1
GBR,TUN,2001.0,2,1,1
PRT,POL,2009.0,3,3,0
MNG,RUS,2014.0,1,3,-2
NZL,NOR,2003.0,3,2,1
DNK,GNB,2011.0,3,2,1
LTU,POL,2002.0,1,1,0
ITA,KEN,2012.0,3,1,2
MDA,ROU,2011.0,1,2,-1
NLD,GRC,2022.0,8,5,3
DNK,POL,2004.0,4,4,0
DNK,GRL,2003.0,2,2,0
AUS,ISR,2007.0,7,12,-5
ZAF,OMN,2010.0,1,1,0
KAZ,UZB,2002.0,1,1,0
HUN,ITA,1998.0,1,2,-1
ROU,IRL,2007.0,2,1,1
HKG,ARE,2009.0,1,1,0
THA,BTN,2020.0,2,2,0
GBR,BGD,2002.0,4,8,-4
DEU,IDN,2004.0,2,2,0
PRT,EGY,2010.0,1,1,0
USA,BMU,2002.0,2,5,-3
KGZ,KAZ,2018.0,4,1,3
PAK,ITA,2009.0,1,1,0
VNM,RUS,2014.0,1,9,-8
DEU,YEM,2015.0,1,2,-1
CMR,CAN,2022.0,3,1,2
GRC,DNK,2021.0,5,6,-1
BGD,NLD,2013.0,2,2,0
BRN,GBR,2006.0,1,2,-1
RUS,BGR,2011.0,1,6,-5
RUS,MEX,2014.0,1,4,-3
SWE,ISR,2021.0,2,9,-7
FRA,TUR,2001.0,2,3,-1
MLT,GBR,2010.0,7,8,-1
TWN,CHE,2003.0,1,2,-1
PHL,KEN,2018.0,1,1,0
DEU,BLR,2019.0,1,7,-6
DEU,CYP,2000.0,1,2,-1
MYS,DEU,2005.0,1,1,0
BEL,TWN,2011.0,1,1,0
LBR,CHE,2017.0,1,1,0
SVN,DNK,2008.0,1,4,-3
MAR,MEX,2020.0,2,1,1
PRI,CHN,2018.0,1,1,0
CYP,RUS,2019.0,2,1,1
TWN,NLD,2006.0,1,3,-2
QAT,GBR,2012.0,2,16,-14
SVK,SRB,2011.0,1,2,-1
PRT,ZAF,2010.0,1,3,-2
NOR,TUR,2021.0,2,6,-4
AUS,BGD,2009.0,1,16,-15
DEU,MNG,2018.0,1,1,0
KOR,ISR,2014.0,1,1,0
PHL,ESP,2021.0,1,3,-2
BEL,RWA,2017.0,1,2,-1
ETH,NGA,2005.0,1,1,0
ETH,MYS,2017.0,1,1,0
,RUS,2004.0,6530,0,6530
,TUN,2000.0,750,0,750
,RUS,1996.0,7799,0,7799
ARM,,2021.0,195,0,195
NOR,,2013.0,968,0,968
UKR,,2009.0,546,0,546
AUT,,2024.0,17150,0,17150
,BGR,2002.0,503,0,503
,TUR,1995.0,1893,0,1893
,CHL,2005.0,1520,0,1520
,SVK,2004.0,641,0,641
BGD,,2011.0,166,0,166
,POL,2001.0,4913,0,4913
,AUT,2010.0,2477,0,2477
DEU,,2007.0,9788,0,9788
ITA,,2004.0,2868,0,2868
,DNK,1998.0,3588,0,3588
EST,,2015.0,173,0,173
QAT,,2024.0,2533,0,2533
SVN,,2015.0,390,0,390
,NLD,1999.0,9197,0,9197
FIN,,2022.0,4118,0,4118
,FIN,2011.0,2097,0,2097
,DNK,1997.0,895,0,895
ARG,,2018.0,2007,0,2007
,SVK,1996.0,639,0,639
THA,,2009.0,450,0,450
,QAT,1999.0,62,0,62
GHA,,2010.0,27,0,27
JOR,,2015.0,181,0,181
PAN,,2023.0,265,0,265
GHA,,2017.0,116,0,116
,CHL,2002.0,1088,0,1088
NGA,,2016.0,862,0,862
PRI,,2017.0,113,0,113
KWT,,2020.0,208,0,208
AUT,PHL,2018.0,3,0,3
BRA,,2000.0,144,0,144
SYC,,2022.0,6,0,6
,BGR,2005.0,512,0,512
,CZE,2009.0,2674,0,2674
SVN,PRT,2012.0,3,0,3
ZWE,,2020.0,94,0,94
CHE,,2006.0,1349,0,1349
BHR,,2012.0,22,0,22
,MNG,1994.0,2,0,2
MNG,,2022.0,172,0,172
PRI,,2010.0,96,0,96
ARM,KOR,2005.0,1,0,1
IDN,,2008.0,65,0,65
,MLI,2000.0,35,0,35
,SAU,2007.0,740,0,740
CIV,IND,2016.0,1,0,1
,LKA,2013.0,250,0,250
,AUT,2017.0,2423,0,2423
ETH,,2022.0,1169,0,1169
KEN,,2015.0,169,0,169
,ARG,2015.0,2439,0,2439
,EGY,2006.0,1853,0,1853
,ARE,2012.0,333,0,333
,LVA,2018.0,252,0,252
,PER,2012.0,364,0,364
,IDN,1999.0,302,0,302
EST,ZAF,2017.0,1,0,1
VEN,CAN,2014.0,3,0,3
,PRI,2012.0,116,0,116
GHA,,2019.0,152,0,152
,KNA,2011.0,5,0,5
,AUT,2019.0,1441,0,1441
,MNE,2009.0,38,0,38
RWA,COD,2019.0,1,0,1
LSO,ZAF,2009.0,7,0,7
ITA,NER,2016.0,1,0,1
,VEN,1995.0,372,0,372
OMN,,2019.0,163,0,163
CMR,COG,2016.0,1,0,1
PAK,KWT,2016.0,4,0,4
BEN,,2020.0,99,0,99
SLV,,2023.0,40,0,40
JAM,TTO,2022.0,1,0,1
NGA,RUS,2022.0,2,0,2
,NER,2014.0,32,0,32
,BLR,2007.0,229,0,229
GAB,,2024.0,164,0,164
CUB,ECU,2014.0,20,0,20
ISL,EST,2018.0,1,0,1
,GMB,1995.0,15,0,15
IDN,BFA,2018.0,2,0,2
,BOL,2016.0,41,0,41
LSO,,2022.0,17,0,17
MEX,EGY,2021.0,5,0,5
SVK,,2001.0,43,0,43
IND,CHL,2017.0,8,0,8
PAK,ZAF,2006.0,1,0,1
GIN,TCD,2021.0,1,0,1
ESP,,2001.0,326,0,326
,MKD,2003.0,81,0,81
,BIH,2006.0,190,0,190
NZL,BGD,2008.0,1,0,1
PRI,,2019.0,156,0,156
UZB,CHN,2012.0,1,0,1
,OMN,2008.0,106,0,106
OMN,,2017.0,134,0,134
IRN,QAT,2013.0,3,0,3
,KHM,2007.0,34,0,34
COG,USA,2007.0,3,0,3
KEN,IDN,2020.0,1,0,1
SGP,,1999.0,13,0,13
SDN,CHE,2015.0,2,0,2
,THA,1994.0,338,0,338
TUN,,2006.0,110,0,110
,KWT,1995.0,110,0,110
,AZE,1994.0,159,0,159
,MMR,1998.0,9,0,9
LKA,DEU,2021.0,2,0,2
BLR,GBR,2002.0,9,0,9
BIH,SVK,2020.0,1,0,1
UKR,TWN,2013.0,2,0,2
IRQ,NOR,2019.0,1,0,1
,MDG,2000.0,30,0,30
,BEN,2001.0,39,0,39
,SDN,1995.0,15,0,15
HRV,CZE,2013.0,2,0,2
OMN,,2010.0,43,0,43
NLD,DZA,2006.0,1,0,1
PYF,,2018.0,10,0,10
ERI,USA,2005.0,2,0,2
LBN,IDN,2017.0,1,0,1
IND,TTO,2007.0,4,0,4
COM,FRA,2005.0,1,0,1
VEN,JPN,2003.0,2,0,2
GEO,,2003.0,25,0,25
JPN,KWT,2014.0,2,0,2
SRB,BRA,2003.0,1,0,1
SWE,MEX,1999.0,2,0,2
MLI,BEL,2007.0,2,0,2
DEU,LVA,2008.0,5,0,5
,MOZ,1995.0,3,0,3
GAB,BEN,2001.0,2,0,2
ROU,SWE,1999.0,4,0,4
ZMB,JPN,1999.0,1,0,1
,MAC,1998.0,2,0,2
ITA,LVA,2000.0,1,0,1
AUT,IRL,1999.0,1,0,1
COL,ARE,2013.0,1,0,1
ARG,BEL,2003.0,3,0,3
USA,GUF,2005.0,1,0,1
HKG,IRL,2005.0,2,0,2
GBR,YEM,2001.0,1,0,1
EGY,PER,2011.0,1,0,1
BLR,AUS,2012.0,1,0,1
GHA,PER,2019.0,1,0,1
URY,CHL,2008.0,2,0,2
FIN,POL,1998.0,2,0,2
UKR,TUR,2014.0,3,0,3
EST,PRT,2015.0,1,0,1
HUN,ARG,2001.0,2,0,2
PRI,MYS,2005.0,1,0,1
IRQ,ARE,2013.0,3,0,3
FIN,ARG,2009.0,2,0,2
,COD,2003.0,4,0,4
MUS,CAN,2011.0,4,0,4
ESP,PRI,1999.0,1,0,1
IND,QAT,2013.0,12,0,12
CHL,CRI,2007.0,3,0,3
ESP,SEN,2014.0,3,0,3
ZAF,VNM,2013.0,2,0,2
,BMU,2002.0,2,0,2
JOR,PSE,2012.0,2,0,2
PAK,IRN,2007.0,1,0,1
IND,BWA,2017.0,4,0,4
HKG,LKA,2017.0,4,0,4
TWN,BEL,2006.0,1,0,1
KOR,OMN,2018.0,3,0,3
SVN,TWN,2020.0,1,0,1
JPN,BRN,2017.0,1,0,1
SAU,NGA,2017.0,2,0,2
SRB,NLD,2018.0,1,0,1
HKG,IDN,2019.0,1,0,1
KHM,NZL,2015.0,1,0,1
SYR,ISR,2022.0,1,0,1
FRA,DJI,2007.0,1,0,1
GRC,POL,2006.0,4,0,4
BRA,NPL,2007.0,1,0,1
,MMR,1997.0,1,0,1
ZAF,CHL,2003.0,1,0,1
NPL,DEU,2007.0,3,0,3
JAM,NGA,2015.0,1,0,1
VEN,SGP,2015.0,1,0,1
MYS,MUS,2016.0,3,0,3
ZAF,LUX,2017.0,1,0,1
CUB,CAN,2016.0,10,0,10
AUT,EGY,2015.0,7,0,7
NGA,AUS,2011.0,5,0,5
MAR,SYR,2019.0,2,0,2
HKG,MYS,2014.0,5,0,5
KOR,QAT,2015.0,4,0,4
ISL,,2001.0,2,0,2
ARG,CZE,2022.0,1,0,1
PAK,AFG,2012.0,2,0,2
UKR,ISR,2018.0,4,0,4
SWE,SAU,2003.0,2,0,2
POL,URY,2015.0,1,0,1
BRA,UKR,2003.0,1,0,1
KEN,DEU,2000.0,3,0,3
HUN,ARE,2009.0,2,0,2
DEU,PAN,2002.0,2,0,2
NER,SEN,2005.0,3,0,3
,LBY,1994.0,9,0,9
GBR,KGZ,2020.0,1,0,1
CRI,MEX,2001.0,2,0,2
FIN,NPL,2005.0,1,0,1
SGP,PAK,2007.0,8,0,8
USA,HTI,2002.0,3,0,3
BOL,,2009.0,15,0,15
BEL,VEN,2009.0,1,0,1
MAR,ZAF,2010.0,1,0,1
SEN,KEN,2011.0,2,0,2
FJI,,2012.0,8,0,8
ARG,PER,2012.0,2,0,2
ISR,TUN,2013.0,1,0,1
ISR,FIN,2018.0,2,0,2
SVK,ISR,2020.0,1,0,1
RWA,COD,2017.0,1,0,1
MNE,,2015.0,8,0,8
MAR,RWA,2019.0,2,0,2
ERI,IND,2021.0,2,0,2
,PRY,2009.0,38,0,38
BFA,MDG,2009.0,1,0,1
ITA,OMN,2013.0,1,0,1
AUT,MKD,2020.0,1,0,1
NLD,SYC,2013.0,2,0,2
,DOM,2004.0,14,0,14
ISR,LTU,2014.0,2,0,2
NOR,ROU,2009.0,1,0,1
NGA,PRT,2015.0,1,0,1
IRQ,KOR,2015.0,1,0,1
TUN,NOR,2019.0,4,0,4
MYS,FIN,2022.0,2,0,2
CUB,CHE,2018.0,2,0,2
FIN,POL,1997.0,3,0,3
BEL,ECU,2011.0,5,0,5
MAC,PHL,2020.0,2,0,2
ARM,SGP,2020.0,1,0,1
NGA,MEX,2019.0,2,0,2
MAR,SGP,2012.0,1,0,1
ROU,ISL,2011.0,2,0,2
,GIB,2007.0,1,0,1
,LBR,2009.0,9,0,9
TUR,SOM,2019.0,2,0,2
CHE,GEO,2015.0,2,0,2
GHA,FRA,2015.0,2,0,2
ESP,PRY,2018.0,5,0,5
KOR,FIN,2006.0,3,0,3
,GLP,2009.0,4,0,4
IRL,IRN,2006.0,3,0,3
BRN,LKA,2020.0,1,0,1
CAN,BOL,2014.0,1,0,1
HKG,IDN,2017.0,2,0,2
EGY,ZAF,2006.0,1,0,1
NGA,TWN,2020.0,3,0,3
BRN,EGY,2022.0,1,0,1
MYS,DEU,2002.0,1,0,1
MLT,NZL,2015.0,1,0,1
,DOM,1996.0,4,0,4
PRI,NLD,2009.0,2,0,2
JPN,QAT,2012.0,2,0,2
DEU,EST,1999.0,2,0,2
LTU,ISR,2017.0,1,0,1
PRI,GBR,2003.0,2,0,2
ARG,ROU,2006.0,1,0,1
TUN,USA,1999.0,1,0,1
ZAF,OMN,2017.0,2,0,2
SAU,LBN,2001.0,2,0,2
CYP,NLD,2009.0,3,0,3
ISR,CRI,1999.0,1,0,1
BFA,RWA,2020.0,1,0,1
ISR,PRT,1999.0,2,0,2
JAM,CAN,2006.0,2,0,2
NER,SEN,2002.0,1,0,1
HKG,ZAF,1998.0,1,0,1
THA,NLD,2000.0,1,0,1
AGO,NOR,2008.0,1,0,1
KOR,ARM,2015.0,1,0,1
HUN,SVK,2014.0,3,0,3
IDN,ETH,2017.0,2,0,2
TUN,MRT,2009.0,1,0,1
GEO,ZAF,2014.0,1,0,1
MYS,BHR,2019.0,7,0,7
AGO,MEX,2013.0,1,0,1
MKD,SAU,2020.0,1,0,1
LUX,NOR,2014.0,4,0,4
USA,MDA,2016.0,3,0,3
CAN,EST,2010.0,1,0,1
DZA,PRT,2009.0,2,0,2
ZAF,CZE,2004.0,1,0,1
,GUM,2000.0,5,0,5
LUX,CHN,2003.0,1,0,1
BLR,LTU,2000.0,2,0,2
MWI,KEN,2010.0,1,0,1
CHE,TZA,2002.0,1,0,1
GMB,ITA,2006.0,1,0,1
LBN,QAT,2013.0,4,0,4
SAU,ROU,2006.0,1,0,1
USA,GUY,2021.0,1,0,1
CHE,CHL,1999.0,1,0,1
LKA,,2001.0,1,0,1
NPL,MYS,2011.0,2,0,2
MNG,CHN,2013.0,1,0,1
ZMB,CHE,2021.0,1,0,1
BRA,ISL,2021.0,1,0,1
KAZ,POL,2021.0,1,0,1
ARG,OMN,2019.0,1,0,1
CHE,CYP,2005.0,1,0,1
CPV,GBR,2020.0,1,0,1
THA,SGP,1999.0,2,0,2
AUT,BGD,2000.0,1,0,1
CHN,MAC,2005.0,2,0,2
NOR,ETH,2002.0,4,0,4
CMR,GBR,1999.0,1,0,1
SVN,ESP,2001.0,2,0,2
CMR,ITA,1999.0,1,0,1
FIN,BLR,2010.0,1,0,1
BOL,ITA,2019.0,1,0,1
CZE,OMN,2015.0,1,0,1
CHE,QAT,2011.0,1,0,1
BRA,NZL,2009.0,4,0,4
JOR,IRN,2011.0,2,0,2
BGR,HRV,2013.0,1,0,1
MDA,GBR,2013.0,1,0,1
LVA,ISR,2019.0,1,0,1
TZA,AUS,2022.0,1,0,1
ITA,CMR,2001.0,2,0,2
SRB,JPN,2018.0,2,0,2
HKG,IDN,2010.0,1,0,1
PSE,EGY,2008.0,1,0,1
JPN,BRN,2019.0,1,0,1
URY,CZE,2015.0,1,0,1
MYS,CHE,2014.0,4,0,4
SEN,USA,2002.0,2,0,2
PAN,ARG,2013.0,1,0,1
USA,BRB,2011.0,1,0,1
BTN,DNK,2008.0,1,0,1
IRL,QAT,2008.0,1,0,1
AUS,MUS,2018.0,2,0,2
UGA,CUB,2019.0,1,0,1
BIH,FRA,2015.0,1,0,1
,DJI,2009.0,4,0,4
USA,MAC,2008.0,1,0,1
GHA,ZWE,2014.0,1,0,1
JOR,CZE,2022.0,1,0,1
NZL,URY,2018.0,1,0,1
NCL,,2008.0,4,0,4
SWE,NIC,2007.0,2,0,2
NGA,BEL,2001.0,1,0,1
BGR,GHA,2009.0,1,0,1
PAK,TZA,2015.0,1,0,1
BRA,BGR,2015.0,1,0,1
PSE,LBY,2019.0,1,0,1
IRQ,MYS,2002.0,1,0,1
MOZ,,2009.0,12,0,12
KAZ,TJK,2005.0,2,0,2
OMN,TUR,2010.0,2,0,2
GHA,CAN,1999.0,1,0,1
NOR,ETH,2005.0,2,0,2
DNK,LKA,2012.0,1,0,1
JOR,NGA,2010.0,1,0,1
THA,PHL,2002.0,1,0,1
BLR,MEX,2009.0,1,0,1
PRT,DZA,2006.0,1,0,1
MYS,LBY,2006.0,1,0,1
SVK,SAU,2020.0,2,0,2
ZWE,AUS,2006.0,1,0,1
HUN,ITA,1997.0,2,0,2
PSE,,2004.0,3,0,3
SEN,USA,2005.0,2,0,2
SWE,JOR,2006.0,1,0,1
JPN,ISR,1997.0,1,0,1
NPL,POL,2010.0,1,0,1
ZAF,DZA,2018.0,1,0,1
COG,NOR,2016.0,2,0,2
GUF,USA,2014.0,1,0,1
,COM,1999.0,1,0,1
FRA,GHA,2011.0,1,0,1
KEN,NOR,2009.0,1,0,1
FRA,MWI,2002.0,1,0,1
GRC,SRB,2012.0,3,0,3
CAN,BRB,1997.0,1,0,1
CHL,ARE,2020.0,1,0,1
AUT,TTO,2015.0,1,0,1
NCL,PYF,2006.0,1,0,1
AUT,CUB,2000.0,1,0,1
DJI,FRA,1997.0,1,0,1
ISR,SGP,2001.0,2,0,2
TZA,BEL,2009.0,1,0,1
,MAC,1997.0,3,0,3
ESP,UZB,2017.0,1,0,1
SWE,RWA,2018.0,3,0,3
AUT,SVN,2001.0,3,0,3
UZB,DEU,2000.0,1,0,1
BGD,KWT,2016.0,1,0,1
MAR,JPN,2016.0,2,0,2
SLE,,2006.0,1,0,1
PRT,HRV,2011.0,1,0,1
VUT,USA,2006.0,1,0,1
NZL,AUT,2004.0,1,0,1
DEU,BIH,2002.0,2,0,2
NLD,GLP,2013.0,1,0,1
URY,VEN,2000.0,1,0,1
SAU,NOR,2000.0,1,0,1
GBR,GLP,2014.0,1,0,1
CMR,NZL,2009.0,1,0,1
LUX,GHA,2014.0,1,0,1
HKG,EGY,2015.0,1,0,1
IRL,ARE,2005.0,1,0,1
SRB,MNE,2014.0,4,0,4
AUT,CIV,2007.0,1,0,1
ZAF,RWA,2003.0,1,0,1
IRN,ARE,2018.0,2,0,2
TLS,,2021.0,4,0,4
CMR,BEN,2008.0,1,0,1
CYP,NGA,2021.0,2,0,2
PRT,BIH,2014.0,1,0,1
CAN,IDN,2000.0,1,0,1
GEO,CAN,2011.0,1,0,1
USA,MNP,2017.0,1,0,1
EGY,NGA,2009.0,1,0,1
,BMU,2005.0,5,0,5
TWN,DNK,2011.0,1,0,1
UKR,CHL,2012.0,1,0,1
IRN,ISL,2016.0,1,0,1
TUR,ETH,2018.0,1,0,1
THA,SAU,2011.0,1,0,1
LVA,SRB,2012.0,1,0,1
ARG,JPN,2019.0,2,0,2
GIN,CHE,2017.0,1,0,1
QAT,AUT,2017.0,1,0,1
MYS,KEN,2016.0,1,0,1
HKG,ISR,2009.0,1,0,1
ZWE,CAN,2006.0,1,0,1
IND,TZA,2022.0,2,0,2
PYF,MEX,2006.0,1,0,1
DNK,SVK,1999.0,1,0,1
FRA,MWI,2005.0,1,0,1
SRB,DNK,2000.0,1,0,1
MEX,ISR,2000.0,1,0,1
HUN,LBY,2004.0,1,0,1
KWT,CZE,2000.0,1,0,1
NZL,GRC,2007.0,1,0,1
HTI,BEL,2005.0,1,0,1
KOR,SDN,2016.0,1,0,1
FRA,BRN,2017.0,1,0,1
CYP,BRA,2015.0,1,0,1
RUS,MLI,2019.0,1,0,1
ZWE,TZA,2021.0,1,0,1
HUN,GHA,2022.0,3,0,3
,TLS,2014.0,4,0,4
MKD,AUS,2018.0,1,0,1
ARG,PRI,2005.0,1,0,1
ITA,SGP,2005.0,1,0,1
KWT,BGD,2021.0,1,0,1
MDG,SGP,2013.0,1,0,1
BOL,ITA,2010.0,1,0,1
IRQ,OMN,2010.0,1,0,1
ARG,SGP,2018.0,2,0,2
BWA,HUN,2009.0,1,0,1
ESP,HND,2014.0,1,0,1
COG,BEN,2022.0,1,0,1
LBY,IRN,2020.0,1,0,1
ZAF,HKG,2015.0,1,0,1
SLE,CHN,2022.0,2,0,2
ESP,LUX,2001.0,1,0,1
CRI,GBR,2007.0,1,0,1
NGA,NER,2021.0,1,0,1
SAU,MRT,2020.0,1,0,1
AUT,URY,2003.0,3,0,3
AZE,DEU,2001.0,1,0,1
NLD,LBN,2007.0,1,0,1
DEU,BGD,1998.0,1,0,1
NZL,RUS,2006.0,2,0,2
ZMB,NAM,2008.0,1,0,1
FRA,EST,2000.0,1,0,1
AUS,BHR,2009.0,2,0,2
FIN,SGP,2008.0,2,0,2
BWA,SWZ,2006.0,1,0,1
ISR,AUS,1997.0,1,0,1
ARM,IRN,2008.0,1,0,1
GIB,CAN,2019.0,1,0,1
KAZ,MAR,2021.0,1,0,1
MNE,USA,2020.0,2,0,2
THA,PRT,2018.0,1,0,1
SWE,MWI,2019.0,1,0,1
PAN,AUS,2021.0,1,0,1
BGD,IRQ,2014.0,1,0,1
KEN,ESP,2006.0,1,0,1
AUT,ISL,2018.0,1,0,1
CHN,CMR,2008.0,1,0,1
LIE,USA,2015.0,1,0,1
MYS,UKR,2022.0,1,0,1
GBR,GRD,2007.0,1,0,1
JPN,BLR,2020.0,1,0,1
LTU,,1999.0,3,0,3
PAK,HRV,2011.0,1,0,1
KEN,ZAF,1998.0,1,0,1
URY,,2003.0,3,0,3
GUF,GUY,2015.0,1,0,1
CAN,ETH,2011.0,2,0,2
SAU,BGD,2003.0,3,0,3
IND,AFG,2022.0,1,0,1
TUN,SYR,2008.0,1,0,1
KHM,ZAF,2020.0,1,0,1
AUS,BIH,2009.0,1,0,1
SWE,LAO,2018.0,1,0,1
GRC,ARG,2017.0,1,0,1
FRA,MUS,2011.0,1,0,1
ZAF,LUX,2019.0,1,0,1
SVK,IRL,2018.0,1,0,1
RWA,DEU,2018.0,1,0,1
POL,KOR,1998.0,1,0,1
BFA,NER,2006.0,1,0,1
AUT,IDN,2005.0,1,0,1
ETH,IRL,2012.0,1,0,1
IND,UGA,2016.0,1,0,1
ECU,ARG,2008.0,1,0,1
UGA,CAN,2014.0,2,0,2
DEU,MNE,2004.0,1,0,1
NGA,MOZ,2013.0,1,0,1
LBY,IRQ,2012.0,1,0,1
ISR,BLR,2003.0,1,0,1
NOR,LTU,2008.0,1,0,1
THA,ARG,2011.0,1,0,1
UZB,BEL,2001.0,1,0,1
THA,BRA,2012.0,1,0,1
KOR,ARE,2013.0,2,0,2
BRA,CZE,2012.0,1,0,1
ITA,SGP,2002.0,1,0,1
MWI,KEN,2019.0,3,0,3
IRL,SVN,2013.0,1,0,1
GBR,DOM,2019.0,1,0,1
ECU,AUS,2006.0,1,0,1
NOR,SAU,2002.0,1,0,1
MWI,DNK,2005.0,1,0,1
TUR,ROU,2021.0,2,0,2
BEL,ETH,2008.0,1,0,1
MNE,RUS,1998.0,1,0,1
UGA,TTO,2006.0,1,0,1
GBR,MWI,2000.0,1,0,1
SWE,BTN,2016.0,1,0,1
GRC,LUX,2019.0,2,0,2
GAB,ITA,2015.0,1,0,1
GRC,SGP,2014.0,2,0,2
CUB,ZWE,2017.0,1,0,1
CHN,BGR,2021.0,1,0,1
VEN,ARG,2011.0,1,0,1
BHR,GBR,2002.0,2,0,2
AUT,ECU,2020.0,1,0,1
ARM,CZE,1998.0,1,0,1
ETH,MAR,2019.0,2,0,2
PAK,YEM,2016.0,1,0,1
PRT,EGY,2019.0,1,0,1
SRB,UZB,2013.0,1,0,1
IND,LVA,2021.0,1,0,1
NLD,QAT,2010.0,1,0,1
TUN,ESP,2001.0,1,0,1
BRA,HUN,2013.0,1,0,1
PRT,CHL,2007.0,1,0,1
BEL,URY,2001.0,1,0,1
SEN,NGA,2007.0,1,0,1
MYS,SEN,2017.0,1,0,1
IRQ,,1999.0,1,0,1
NER,IND,1999.0,1,0,1
RWA,ETH,2019.0,1,0,1
HND,MEX,2011.0,1,0,1
JPN,ZAF,1998.0,1,0,1
MYS,BGD,1998.0,1,0,1
KWT,HKG,2002.0,1,0,1
IRQ,MYS,2005.0,1,0,1
BRA,LBN,2008.0,1,0,1
MEX,ETH,2014.0,1,0,1
ALB,ISR,2007.0,1,0,1
OMN,FLK,2004.0,1,0,1
UKR,SAU,2015.0,1,0,1
KOR,KAZ,2009.0,1,0,1
BIH,SAU,2017.0,1,0,1
KAZ,LTU,2022.0,1,0,1
SOM,,2016.0,1,0,1
DNK,KEN,2016.0,1,0,1
NAM,VNM,2022.0,1,0,1
MYS,LBN,2022.0,1,0,1
NLD,CIV,2006.0,1,0,1
CAN,LVA,2011.0,1,0,1
RWA,,2008.0,1,0,1
BIH,SAU,2019.0,1,0,1
JPN,PRY,2020.0,1,0,1
HUN,LUX,2022.0,1,0,1
NLD,CUW,2008.0,1,0,1
SVN,POL,1999.0,1,0,1
HKG,BRA,2008.0,1,0,1
PRY,JPN,2013.0,1,0,1
NZL,ZMB,2015.0,1,0,1
DNK,BGR,2014.0,1,0,1
ALB,ETH,2012.0,1,0,1
SVK,MKD,2018.0,1,0,1
LAO,,2006.0,1,0,1
VUT,FRA,2006.0,1,0,1
JPN,SRB,2016.0,1,0,1
BWA,KEN,2013.0,1,0,1
JPN,PRT,2022.0,1,0,1
UKR,KAZ,2016.0,1,0,1
AUT,SAU,2011.0,1,0,1
PRY,FRA,1999.0,1,0,1
ARG,PRI,2002.0,1,0,1
FJI,TON,2017.0,1,0,1
ESP,YEM,2020.0,1,0,1
QAT,KAZ,2014.0,1,0,1
IRN,SAU,2018.0,1,0,1
POL,LBN,2019.0,1,0,1
COG,UGA,2022.0,1,0,1
VEN,CHE,2019.0,1,0,1
MAR,BFA,2012.0,1,0,1
YEM,ARE,2020.0,1,0,1
ARE,NOR,2002.0,1,0,1
,BGD,2020.0,3,0,3
UKR,HRV,2003.0,1,0,1
FRA,LIE,2020.0,1,0,1
DNK,MEX,2009.0,1,0,1
,MNP,2017.0,1,0,1
NLD,CAN,2015.0,53,62,-9
CAN,USA,2015.0,1811,1309,502
NLD,FRA,2018.0,116,109,7
USA,IDN,2017.0,52,21,31
CHN,CHE,2019.0,63,60,3
USA,CAN,2004.0,1186,1231,-45
GBR,IRL,2012.0,157,208,-51
PAK,GBR,2017.0,62,70,-8
ITA,USA,2003.0,431,470,-39
USA,ESP,2013.0,348,468,-120
JPN,PAK,2009.0,11,3,8
IRL,GBR,2016.0,268,198,70
CZE,GBR,2011.0,34,22,12
DEU,GBR,2015.0,664,563,101
CAN,GBR,2010.0,348,332,16
CAN,NOR,2010.0,16,7,9
GBR,JPN,2016.0,121,100,21
CAN,TUR,2010.0,13,17,-4
QAT,USA,2015.0,33,84,-51
CHN,GBR,2014.0,259,325,-66
CHN,HKG,2019.0,604,768,-164
SGP,HKG,2020.0,40,34,6
JPN,SGP,2008.0,30,10,20
JPN,CHN,2012.0,453,280,173
CHN,HKG,2017.0,428,601,-173
KOR,USA,2021.0,551,576,-25
IRN,ARE,2019.0,6,2,4
NOR,GBR,2019.0,57,87,-30
GAB,JPN,2017.0,1,1,0
POL,PRT,2009.0,3,3,0
AUT,DNK,2018.0,9,9,0
USA,SAU,2012.0,126,37,89
NZL,USA,2001.0,83,72,11
CAN,FRA,2012.0,243,320,-77
CAN,NLD,2009.0,34,38,-4
DNK,SWE,2009.0,44,76,-32
USA,PYF,2009.0,2,1,1
GBR,FRA,2001.0,201,247,-46
AUS,HKG,2014.0,26,44,-18
USA,GBR,2000.0,353,431,-78
USA,MYS,2013.0,38,37,1
NOR,GBR,2010.0,31,47,-16
USA,FIN,2008.0,63,56,7
DEU,NLD,2004.0,140,137,3
CAN,GBR,2017.0,376,339,37
POL,USA,2013.0,117,232,-115
NLD,GBR,2002.0,151,161,-10
USA,CHN,2022.0,1796,1003,793
GBR,ISL,2015.0,7,1,6
AUS,CAN,2015.0,155,186,-31
ESP,GBR,2006.0,144,158,-14
ITA,IRL,2011.0,30,12,18
DEU,HUN,2003.0,26,50,-24
MYS,NGA,2017.0,97,27,70
RUS,KOR,2005.0,13,7,6
CAN,ESP,2018.0,64,69,-5
CAN,GBR,2019.0,369,435,-66
ESP,PRT,2014.0,90,74,16
DEU,MEX,2007.0,25,19,6
HRV,USA,2008.0,12,19,-7
CHE,RUS,2014.0,19,21,-2
IRN,USA,2018.0,569,133,436
PRT,AUT,2021.0,8,7,1
MYS,NGA,2019.0,104,35,69
BEL,GBR,2016.0,129,98,31
TWN,IND,2010.0,25,51,-26
MYS,IRN,2020.0,56,18,38
HKG,DEU,2019.0,27,15,12
SVN,ITA,2016.0,12,5,7
POL,DEU,2021.0,41,52,-11
FRA,JPN,2020.0,87,65,22
USA,SWE,2018.0,245,257,-12
SRB,HRV,2015.0,9,5,4
SWE,USA,2001.0,220,145,75
NLD,BRA,2016.0,25,41,-16
DNK,BEL,2019.0,18,21,-3
CHN,PAK,2020.0,363,305,58
ESP,NOR,2019.0,29,15,14
ESP,NOR,2017.0,26,13,13
AUS,FIN,2018.0,25,22,3
JPN,SWE,2009.0,24,27,-3
AUS,NZL,2012.0,86,151,-65
IRN,SWE,2019.0,66,15,51
NLD,MEX,2018.0,12,13,-1
PAK,GBR,2019.0,72,64,8
IRN,CAN,2016.0,261,78,183
NZL,CHE,2017.0,14,10,4
UGA,BEL,2020.0,3,4,-1
ITA,FRA,2018.0,337,279,58
IND,TWN,2013.0,37,33,4
CZE,SWE,2016.0,7,7,0
RUS,PRT,2015.0,3,8,-5
NPL,THA,2015.0,4,6,-2
CHN,AUT,2014.0,13,10,3
JPN,DEU,2018.0,113,134,-21
CHE,CAN,2001.0,44,24,20
ARG,ITA,2000.0,3,9,-6
HKG,GBR,2014.0,43,65,-22
CAN,ZAF,2015.0,19,25,-6
BEL,ESP,2021.0,52,63,-11
CHL,COL,2015.0,25,19,6
ESP,CZE,2021.0,22,14,8
NLD,ROU,2012.0,6,7,-1
BEL,CAN,2020.0,36,35,1
SAU,MYS,2020.0,23,50,-27
DNK,ESP,2016.0,17,43,-26
HUN,FRA,2015.0,14,11,3
DEU,SGP,2020.0,31,38,-7
SWE,AUT,2021.0,14,17,-3
CHN,SWE,2001.0,21,18,3
MEX,IND,2020.0,8,11,-3
GBR,EST,2015.0,6,7,-1
BEL,DEU,2000.0,13,34,-21
CAN,DEU,2022.0,47,57,-10
USA,MAC,2013.0,8,3,5
COG,COD,2018.0,75,35,40
ESP,ARG,2021.0,45,54,-9
AUS,BRA,2021.0,23,57,-34
IRN,ITA,2020.0,81,15,66
IRN,IRL,2011.0,6,3,3
TZA,ZAF,2017.0,3,8,-5
TZA,ZAF,2019.0,4,7,-3
IRN,TUR,2018.0,26,15,11
GBR,SLE,2012.0,2,1,1
NOR,PRT,2021.0,7,8,-1
TUR,POL,2017.0,5,1,4
NZL,SGP,2014.0,7,7,0
GBR,ESP,2004.0,157,119,38
GBR,UGA,2016.0,9,38,-29
IRN,GBR,2017.0,68,37,31
EST,DNK,2018.0,4,1,3
NLD,KOR,2015.0,7,12,-5
USA,PAK,2020.0,79,118,-39
AUS,RWA,2017.0,1,1,0
EGY,FIN,2017.0,4,1,3
MYS,BHR,2018.0,4,1,3
UKR,POL,2018.0,32,17,15
ZAF,TZA,2020.0,8,4,4
AUS,GHA,2021.0,9,12,-3
MYS,PSE,2020.0,10,4,6
THA,USA,2021.0,69,110,-41
BEL,LTU,2018.0,7,2,5
CAN,SAU,2022.0,36,19,17
USA,IDN,2019.0,28,13,15
ISR,FRA,2021.0,15,22,-7
THA,PAK,2020.0,10,7,3
GBR,JOR,2020.0,40,13,27
CHN,THA,2020.0,38,32,6
LTU,SWE,2019.0,7,1,6
RUS,POL,2021.0,11,16,-5
DEU,THA,2020.0,17,13,4
ITA,SAU,2021.0,13,15,-2
BRA,URY,2020.0,26,6,20
TUR,NLD,2020.0,34,15,19
IRN,GBR,2019.0,75,34,41
CHN,CHE,2017.0,60,56,4
TWN,IND,2019.0,30,75,-45
BGD,CAN,2022.0,19,8,11
IRN,DNK,2021.0,30,5,25
IRN,GBR,2010.0,29,42,-13
CAN,TUR,2019.0,15,45,-30
USA,KWT,2022.0,6,5,1
CHN,IND,2021.0,114,109,5
DEU,PRT,2017.0,24,60,-36
BGR,USA,2014.0,11,11,0
CHE,BEL,2022.0,23,34,-11
QAT,IND,2018.0,6,12,-6
RUS,KAZ,2016.0,27,27,0
IND,CHL,2018.0,8,4,4
CAN,LUX,2017.0,2,5,-3
CHN,EGY,2021.0,42,40,2
NLD,FIN,2015.0,22,19,3
NOR,GBR,2017.0,48,96,-48
RUS,SWE,2021.0,12,6,6
ESP,CHL,2012.0,68,43,25
FIN,DNK,2018.0,21,16,5
SAU,PAK,2013.0,12,70,-58
UKR,ESP,2008.0,5,1,4
CHN,BEL,2006.0,8,10,-2
AUS,IDN,2013.0,49,7,42
DEU,PRT,2010.0,30,24,6
JOR,QAT,2012.0,5,2,3
DEU,RUS,2003.0,116,166,-50
UKR,NLD,2010.0,7,2,5
NOR,CAN,2014.0,12,16,-4
NLD,HUN,2016.0,8,9,-1
PER,ARG,2007.0,1,1,0
BRA,FRA,2013.0,59,103,-44
GBR,CHL,2006.0,10,8,2
JPN,CHE,2008.0,38,20,18
NZL,CHE,2010.0,5,7,-2
IRL,FRA,2009.0,35,24,11
TWN,IND,2017.0,30,56,-26
SAU,NGA,2018.0,6,8,-2
CAN,NGA,2019.0,7,21,-14
AUS,SWE,2012.0,40,25,15
DEU,BEN,2009.0,3,2,1
FIN,BEL,2015.0,6,6,0
GBR,EGY,2011.0,67,13,54
GHA,GBR,2009.0,6,10,-4
FRA,KOR,2013.0,22,18,4
GBR,MDG,2012.0,1,3,-2
DEU,ZAF,2014.0,24,20,4
SGP,KOR,2011.0,11,16,-5
NOR,FRA,2002.0,13,21,-8
BEL,CHN,2007.0,17,12,5
ISL,USA,2002.0,7,25,-18
TWN,JPN,2011.0,36,49,-13
AUT,NLD,2015.0,29,27,2
NOR,FRA,2005.0,12,10,2
CAN,TUR,2017.0,16,26,-10
DEU,JPN,2005.0,98,102,-4
CHN,CHE,2010.0,33,24,9
SRB,ALB,2021.0,3,1,2
KOR,BGD,2018.0,36,17,19
CHL,CUB,2016.0,1,10,-9
USA,PHL,2015.0,40,24,16
IND,SAU,2006.0,9,5,4
LKA,GBR,2001.0,5,2,3
SVK,DEU,2014.0,12,11,1
IRL,BEL,2008.0,5,6,-1
SWE,NZL,2006.0,5,4,1
MYS,FIN,2016.0,4,4,0
RUS,CHE,2018.0,22,7,15
RUS,KOR,2002.0,24,13,11
SWE,BRA,2015.0,6,23,-17
SDN,KOR,2020.0,1,4,-3
AUS,IRN,2018.0,37,148,-111
CHN,TWN,2011.0,65,61,4
PRT,EGY,2018.0,2,2,0
FRA,TWN,2020.0,4,5,-1
TWN,CYP,2021.0,1,1,0
ISR,GBR,2018.0,59,43,16
BGD,IND,2013.0,8,9,-1
CHN,SAU,2015.0,20,14,6
SLE,GBR,2017.0,2,1,1
EGY,YEM,2019.0,11,2,9
SAU,SDN,2018.0,16,23,-7
TUR,CHE,2021.0,16,10,6
IRN,IRQ,2021.0,15,2,13
AUT,MEX,2018.0,3,4,-1
PAK,ARE,2020.0,21,10,11
KOR,ITA,2017.0,7,16,-9
KOR,ITA,2019.0,9,8,1
PAK,KWT,2022.0,3,1,2
ARG,URY,2001.0,3,1,2
BRA,DOM,2020.0,1,1,0
DNK,BEL,2010.0,3,7,-4
CHE,JPN,2007.0,39,22,17
HKG,ESP,2001.0,1,2,-1
BEL,ROU,2016.0,2,10,-8
IDN,MYS,2013.0,15,49,-34
SWE,CHN,2003.0,19,24,-5
CHN,ZAF,2021.0,9,13,-4
TWN,PHL,2022.0,3,4,-1
AUS,THA,2015.0,43,17,26
BEL,POL,2010.0,8,11,-3
PAK,GBR,2010.0,29,38,-9
CHE,IRN,2009.0,3,11,-8
POL,BRA,2011.0,2,15,-13
SVK,GBR,2005.0,9,2,7
ZWE,ZAF,2005.0,14,1,13
AUS,QAT,2016.0,16,5,11
DEU,NER,2012.0,1,1,0
AUT,ISR,2009.0,4,3,1
SVK,AUT,2008.0,13,8,5
BEN,FRA,2005.0,6,7,-1
TZA,ZAF,2010.0,4,4,0
DEU,SAU,2014.0,23,5,18
NOR,AUT,2012.0,2,6,-4
FRA,CMR,2008.0,14,6,8
BEL,UGA,2012.0,3,2,1
ETH,ZAF,2020.0,8,14,-6
SWE,GRC,2002.0,5,6,-1
CHE,AUS,1998.0,8,5,3
CHL,NOR,2017.0,1,3,-2
GEO,USA,2003.0,12,3,9
GUF,FRA,2003.0,9,5,4
USA,CMR,2009.0,2,4,-2
MEX,CUB,2004.0,13,10,3
ARM,RUS,2017.0,10,2,8
DEU,JPN,2002.0,107,105,2
FRA,SRB,2001.0,4,2,2
CAN,HKG,2012.0,17,19,-2
BRA,USA,2001.0,173,167,6
UKR,USA,1997.0,10,7,3
RUS,AUS,2002.0,13,6,7
ITA,QAT,2015.0,7,1,6
SVN,GBR,2001.0,3,2,1
OMN,USA,2002.0,9,3,6
SWE,FRA,2003.0,40,45,-5
ARE,GBR,2006.0,3,6,-3
CHN,ISR,2017.0,24,17,7
EGY,FRA,2018.0,8,16,-8
CHE,GRC,2011.0,10,17,-7
ZAF,NAM,2014.0,8,5,3
UKR,USA,1998.0,19,6,13
BRA,BEL,2000.0,2,1,1
JPN,GRC,2011.0,5,1,4
RUS,BLR,2004.0,7,13,-6
NPL,JPN,2001.0,2,2,0
SWE,LTU,2006.0,4,3,1
BEL,BRA,2004.0,8,7,1
BEL,COD,2008.0,1,1,0
MAR,USA,2018.0,3,2,1
BRA,VEN,2000.0,4,1,3
DNK,IND,2010.0,4,15,-11
URY,ESP,2001.0,5,1,4
RUS,SVK,2002.0,3,4,-1
NLD,SWE,2013.0,48,39,9
ARG,DEU,2015.0,28,18,10
PAK,BRA,2020.0,4,5,-1
BGR,BEL,2021.0,3,4,-1
ARE,EGY,2003.0,9,6,3
CAN,TUN,2012.0,5,7,-2
CHE,COL,2004.0,1,1,0
CHL,ESP,2006.0,24,27,-3
TWN,THA,2008.0,2,3,-1
PHL,MYS,2006.0,1,1,0
ZAF,NLD,2012.0,17,19,-2
DNK,ITA,2005.0,11,12,-1
CHE,BFA,2014.0,1,1,0
USA,RUS,1998.0,37,152,-115
SGP,NOR,2013.0,4,3,1
DNK,FRA,1997.0,4,9,-5
RUS,NOR,2001.0,7,9,-2
ARG,PRT,2002.0,3,2,1
MYS,AUS,2003.0,8,6,2
AUT,SWE,2004.0,4,5,-1
USA,RUS,1997.0,41,63,-22
CAN,BRA,2009.0,41,58,-17
BEL,ARG,2014.0,3,3,0
CAN,PAK,2006.0,8,6,2
SWE,AUS,2000.0,7,4,3
PRT,ESP,2001.0,18,18,0
ZAF,DEU,2015.0,27,32,-5
GMB,NGA,2020.0,2,1,1
DNK,FRA,1998.0,5,8,-3
GHA,PER,2018.0,1,2,-1
ISR,RUS,2011.0,5,10,-5
CHN,FRA,1998.0,7,11,-4
AUS,IRL,2002.0,15,19,-4
IRL,PRT,2021.0,3,4,-1
SGP,NZL,2008.0,7,13,-6
KEN,ETH,2003.0,2,1,1
MYS,PAK,2006.0,5,5,0
AUS,NOR,2011.0,14,8,6
VEN,BRA,2008.0,5,1,4
USA,FJI,2006.0,2,2,0
FIN,JPN,2012.0,5,9,-4
NLD,GRC,2016.0,9,35,-26
SGP,MYS,2012.0,12,18,-6
SGP,TWN,2012.0,7,12,-5
ZWE,ZAF,2002.0,8,2,6
LTU,NOR,2012.0,2,2,0
SGP,ITA,2021.0,4,7,-3
FRA,AUT,2013.0,41,31,10
ESP,NOR,2010.0,15,12,3
DNK,CAN,2015.0,21,26,-5
SRB,NLD,2010.0,1,2,-1
EGY,GBR,2012.0,17,43,-26
GBR,PHL,2009.0,2,3,-1
NZL,AUT,2014.0,5,8,-3
CHE,IRL,2013.0,9,10,-1
ITA,PAK,2013.0,7,5,2
NLD,UGA,2009.0,2,1,1
SVN,JPN,2015.0,4,1,3
ISL,RUS,2009.0,1,1,0
GUM,USA,2005.0,4,4,0
LTU,ITA,2003.0,3,1,2
LVA,DEU,2013.0,4,3,1
PSE,EGY,2013.0,7,3,4
ESP,TUN,2011.0,4,3,1
NOR,TZA,2020.0,6,1,5
SGP,TUR,2014.0,5,2,3
DEU,GRC,2020.0,41,68,-27
AZE,TUR,2009.0,8,5,3
CHE,LBN,2015.0,3,5,-2
CHL,DEU,2012.0,18,31,-13
MEX,BRA,2004.0,10,7,3
CAN,NOR,2019.0,18,14,4
GBR,ISR,2018.0,43,59,-16
IRL,NLD,2016.0,14,9,5
AUS,FRA,1998.0,9,6,3
MAR,ESP,2012.0,10,8,2
TWN,ITA,2022.0,3,1,2
GBR,IRQ,2012.0,7,8,-1
NZL,FRA,2014.0,6,11,-5
BRA,CHL,2018.0,43,11,32
ITA,GRC,2014.0,22,34,-12
PAK,BGD,2014.0,11,6,5
ITA,PRT,2012.0,30,7,23
ROU,FRA,2015.0,37,33,4
CHL,IND,2013.0,1,2,-1
PRT,ZAF,2018.0,3,1,2
CHE,BIH,2018.0,2,2,0
GHA,NLD,2016.0,3,3,0
CAN,NOR,2017.0,24,9,15
IND,MEX,2021.0,7,6,1
ARG,NZL,2007.0,2,1,1
DNK,IND,2017.0,11,22,-11
BOL,GBR,2020.0,1,1,0
EGY,FIN,2019.0,1,3,-2
MLT,GBR,2018.0,17,17,0
CAN,NZL,2018.0,20,20,0
IRQ,EGY,2022.0,1,7,-6
DEU,ARE,2018.0,13,8,5
DEU,CZE,2021.0,35,43,-8
IRL,EGY,2015.0,2,1,1
SRB,ISR,2018.0,2,1,1
ARG,CUB,2020.0,2,6,-4
NOR,IRN,2018.0,4,11,-7
HKG,THA,2009.0,1,2,-1
CZE,POL,2008.0,1,2,-1
PRT,CHE,2021.0,9,12,-3
EST,NOR,2008.0,2,1,1
ARG,JPN,2018.0,1,2,-1
CHE,COG,2010.0,3,1,2
TZA,CHN,2020.0,8,17,-9
ESP,URY,2016.0,11,5,6
LVA,ESP,2001.0,1,1,0
MEX,VEN,2017.0,5,14,-9
UKR,FRA,2013.0,17,8,9
FRA,BFA,2020.0,9,8,1
ETH,ESP,2021.0,2,1,1
NZL,BEL,2022.0,1,3,-2
IDN,FRA,2008.0,2,4,-2
GRC,CHE,2006.0,9,7,2
CZE,TUR,2015.0,2,5,-3
JPN,RUS,2012.0,15,14,1
RUS,ISR,2020.0,23,10,13
THA,GBR,2006.0,21,46,-25
FRA,LUX,2018.0,24,21,3
HUN,POL,2009.0,2,2,0
AZE,USA,2012.0,1,2,-1
EGY,JPN,2022.0,12,16,-4
USA,MKD,2012.0,4,1,3
GBR,VEN,2003.0,9,5,4
DNK,ITA,2002.0,17,12,5
HKG,KOR,2009.0,5,1,4
AUT,GRC,2008.0,1,3,-2
ESP,GRC,2013.0,17,27,-10
VNM,BGD,2020.0,2,1,1
PAK,DEU,2018.0,19,32,-13
CHE,LVA,2019.0,4,3,1
ECU,GBR,2011.0,2,1,1
CMR,CAN,2016.0,1,2,-1
NOR,MEX,2016.0,2,2,0
SVK,IRL,2019.0,1,1,0
BGR,GRC,2022.0,1,1,0
ISR,SWE,2011.0,6,2,4
AUT,CAN,2022.0,11,10,1
SVK,IRL,2017.0,1,2,-1
SRB,NLD,2019.0,7,1,6
CAN,MYS,2016.0,9,14,-5
SDN,GBR,2012.0,4,5,-1
NOR,ITA,2018.0,15,41,-26
BEL,SAU,2021.0,4,1,3
SVN,SWE,2022.0,1,1,0
GHA,CHN,2016.0,10,9,1
COG,UGA,2016.0,2,1,1
MLI,CIV,2020.0,2,1,1
BEL,PRT,1998.0,1,1,0
LUX,USA,2020.0,7,10,-3
ESP,IND,2022.0,6,11,-5
DEU,SRB,2018.0,3,14,-11
THA,IND,2021.0,10,16,-6
FRA,GIN,2011.0,3,1,2
VEN,COL,2015.0,18,4,14
GRC,HUN,2019.0,3,1,2
KOR,AUT,2013.0,3,1,2
BGD,THA,2019.0,4,1,3
SDN,DEU,2019.0,3,3,0
FRA,MTQ,2016.0,14,22,-8
AUT,ISL,2017.0,1,2,-1
IRN,NOR,2011.0,5,1,4
JPN,ETH,2020.0,4,3,1
AUT,BEL,2009.0,7,7,0
AUT,SRB,2009.0,4,3,1
JOR,SAU,2007.0,5,3,2
IRN,SWE,2010.0,22,15,7
DNK,AUT,2011.0,6,4,2
DEU,MNG,2019.0,2,1,1
THA,CHE,2013.0,5,4,1
ESP,MAR,2000.0,2,1,1
USA,HRV,2001.0,8,17,-9
JPN,HUN,2001.0,9,4,5
HTI,USA,2011.0,1,4,-3
OMN,USA,2005.0,1,9,-8
CAN,RUS,2004.0,13,27,-14
GLP,FRA,2004.0,6,9,-3
MEX,COL,2001.0,2,1,1
CZE,MEX,2020.0,2,8,-6
BEL,RUS,2007.0,13,11,2
SGP,HUN,2019.0,3,1,2
RUS,MEX,2004.0,5,8,-3
KOR,THA,2000.0,1,1,0
BEN,FRA,2002.0,1,2,-1
ARG,CAN,2000.0,5,5,0
USA,ECU,2001.0,4,2,2
ISR,JPN,2002.0,3,8,-5
CHN,HUN,1999.0,1,1,0
CAN,KEN,2004.0,3,2,1
ZWE,USA,2008.0,5,5,0
CAN,LBN,2003.0,6,1,5
TUR,BEL,2003.0,1,2,-1
CHE,ZAF,2004.0,2,2,0
VEN,CAN,2004.0,4,2,2
KOR,CHE,2008.0,12,2,10
LTU,EGY,2019.0,1,1,0
HKG,DEU,2010.0,6,12,-6
ETH,BEL,2009.0,3,2,1
HKG,DNK,2021.0,5,1,4
TUR,AUT,2011.0,1,8,-7
ESP,PRY,2017.0,2,1,1
EGY,CHE,2015.0,1,4,-3
HKG,PAK,2022.0,4,5,-1
DEU,HRV,2021.0,4,6,-2
SRB,FRA,2015.0,4,7,-3
LTU,SWE,2017.0,4,3,1
DEU,LVA,2013.0,3,4,-1
HRV,CAN,2013.0,1,2,-1
TUR,DNK,2014.0,2,6,-4
SVN,USA,2017.0,8,13,-5
HKG,JPN,2015.0,11,4,7
IRL,FIN,2013.0,4,2,2
ARE,SAU,2015.0,6,20,-14
FRA,MLI,2010.0,4,3,1
IND,LKA,2016.0,4,1,3
GIN,CHE,2018.0,1,3,-2
ARE,AUS,2013.0,4,11,-7
CRI,CHE,2019.0,5,1,4
MYS,NLD,2015.0,3,10,-7
KAZ,GBR,2019.0,4,8,-4
AUT,ARE,2013.0,2,1,1
ETH,KEN,2013.0,3,1,2
JPN,SAU,2018.0,16,7,9
FIN,SGP,2013.0,2,2,0
CHE,CHN,2004.0,16,14,2
SVN,USA,2010.0,9,9,0
NZL,CHE,2019.0,5,9,-4
USA,PRT,1999.0,8,13,-5
BWA,GBR,2005.0,2,3,-1
IND,BWA,2018.0,1,1,0
MLT,SWE,2014.0,2,1,1
ARM,IRN,2013.0,4,3,1
DEU,PER,2016.0,6,1,5
BEL,IRL,2020.0,6,11,-5
KEN,PER,2021.0,2,2,0
SYR,AUS,2009.0,1,1,0
UKR,ISR,2017.0,6,1,5
MEX,JPN,2001.0,1,2,-1
IND,IDN,2001.0,3,1,2
CHL,AUS,2009.0,6,4,2
DEU,JOR,2015.0,13,7,6
ESP,EST,2011.0,1,1,0
DEU,CUB,2018.0,1,4,-3
ECU,ARG,2013.0,8,4,4
BGD,SWE,2018.0,6,4,2
MYS,USA,2009.0,10,20,-10
SAU,IDN,2016.0,2,3,-1
THA,MMR,2014.0,1,2,-1
ARE,ITA,2015.0,2,10,-8
KOR,OMN,2017.0,4,1,3
TJK,RUS,2020.0,1,5,-4
RWA,DEU,2019.0,3,2,1
VNM,IRL,2020.0,1,2,-1
EGY,YEM,2017.0,6,2,4
SRB,LBY,2019.0,2,1,1
TWN,ETH,2021.0,7,2,5
CYP,TUR,2011.0,6,11,-5
DNK,TUR,2011.0,2,2,0
KWT,CAN,2021.0,3,1,2
USA,HND,2019.0,4,1,3
FRA,MLI,2017.0,7,2,5
PHL,TWN,2020.0,11,7,4
JPN,BGR,2007.0,9,2,7
BRA,COL,2001.0,5,2,3
PHL,SGP,2005.0,3,1,2
EGY,TUN,2007.0,3,1,2
DEU,ETH,2006.0,5,3,2
UKR,SVK,2020.0,3,1,2
USA,NPL,2012.0,5,17,-12
CAN,CZE,1998.0,2,3,-1
GBR,SRB,2003.0,2,5,-3
LUX,CHE,2020.0,6,3,3
UZB,RUS,2006.0,5,5,0
NER,FRA,2001.0,6,2,4
LTU,BEL,2013.0,4,2,2
CHE,TUR,2003.0,4,4,0
AZE,RUS,2016.0,4,9,-5
RUS,BEL,2002.0,9,9,0
NCL,AUS,2010.0,2,1,1
KWT,SAU,2007.0,1,4,-3
RUS,SRB,2009.0,2,2,0
HKG,FRA,2003.0,6,5,1
UKR,TUR,2004.0,1,1,0
MYS,ARE,2012.0,5,1,4
POL,IRN,2016.0,4,1,3
CHE,LIE,2015.0,3,1,2
FRA,VNM,2007.0,9,5,4
AUS,MYS,2006.0,9,15,-6
UZB,GBR,2011.0,1,1,0
IND,RUS,2007.0,2,4,-2
CHL,ITA,2004.0,1,2,-1
PAK,MYS,2004.0,2,4,-2
EGY,ARE,2005.0,10,7,3
DNK,PRT,2002.0,6,3,3
ISR,JPN,2005.0,3,4,-1
SGP,DNK,2014.0,7,4,3
CUB,VEN,2007.0,1,2,-1
ARG,CHE,2016.0,9,9,0
CUB,CHL,2012.0,4,1,3
PRI,CHN,2019.0,1,5,-4
KOR,ITA,2010.0,8,5,3
JPN,HKG,2011.0,5,9,-4
BGD,NLD,2008.0,3,1,2
AUT,ISL,2019.0,2,1,1
SVK,NLD,2008.0,5,2,3
MYS,FRA,2016.0,5,9,-4
GHA,SWE,2010.0,1,1,0
BEL,RWA,2018.0,4,2,2
POL,GRC,2020.0,4,5,-1
LBN,GBR,2003.0,4,4,0
EGY,UGA,2018.0,1,1,0
MYS,MEX,2014.0,1,1,0
IRQ,RUS,2019.0,3,9,-6
NGA,JPN,2012.0,3,3,0
USA,PSE,2020.0,5,4,1
KHM,JPN,2016.0,1,2,-1
JPN,PRT,2016.0,4,4,0
NZL,NOR,2001.0,4,1,3
NZL,SWE,2008.0,5,8,-3
DZA,SAU,2007.0,6,2,4
ITA,BLR,2006.0,3,1,2
IRN,BEL,2007.0,3,2,1
BRN,AUS,2018.0,3,2,1
FJI,AUS,2008.0,4,4,0
USA,DZA,2011.0,1,5,-4
PER,CAN,2018.0,5,6,-1
LKA,ETH,2011.0,1,1,0
NZL,BRA,2007.0,1,1,0
AUS,PHL,2008.0,6,3,3
EGY,ESP,2011.0,4,3,1
CAN,NGA,2017.0,3,7,-4
SAU,FIN,2014.0,1,1,0
NCL,AUS,2017.0,4,4,0
POL,FIN,2011.0,8,11,-3
CAN,HRV,1999.0,1,1,0
SLE,USA,2020.0,1,7,-6
AUS,EGY,2013.0,6,7,-1
BEL,AUT,2007.0,5,6,-1
NLD,GHA,2021.0,2,3,-1
SDN,DEU,2017.0,4,1,3
TZA,USA,2022.0,6,5,1
HUN,PAK,2021.0,1,3,-2
PRT,DEU,2000.0,2,7,-5
CZE,TWN,2021.0,2,2,0
VNM,CAN,2022.0,3,3,0
GBR,COL,1999.0,2,3,-1
FRA,BEN,2000.0,2,2,0
IDN,CHN,2007.0,1,1,0
PER,ESP,2013.0,7,10,-3
NZL,TWN,2016.0,4,2,2
USA,BIH,2021.0,2,2,0
NLD,ISR,2004.0,4,9,-5
CAN,LUX,2019.0,4,2,2
NOR,ISR,2013.0,2,1,1
POL,DNK,2012.0,4,8,-4
SAU,QAT,2009.0,3,1,2
DEU,TZA,2011.0,1,4,-3
TZA,NOR,2009.0,2,9,-7
SRB,MNE,2004.0,3,1,2
POL,SGP,2022.0,1,3,-2
HRV,CHE,2000.0,2,1,1
IND,KEN,2010.0,1,1,0
SVN,AUS,2008.0,2,1,1
AUS,FRA,1997.0,1,5,-4
AUS,GRC,2011.0,3,3,0
MYS,SGP,2003.0,1,7,-6
MEX,AUT,2012.0,3,1,2
USA,JAM,2013.0,6,2,4
FIN,NGA,2007.0,1,1,0
AUT,HRV,2020.0,7,8,-1
CHL,CHN,2020.0,6,6,0
SVK,MKD,2019.0,2,1,1
SVN,HUN,2021.0,1,1,0
MKD,DEU,2020.0,1,1,0
MAC,JPN,2020.0,1,1,0
RUS,ARG,2006.0,1,1,0
EGY,QAT,2000.0,3,1,2
PRT,FRA,1999.0,4,11,-7
JOR,IRQ,2012.0,5,3,2
FRA,URY,2021.0,4,3,1
CHE,COG,2017.0,2,2,0
DNK,TZA,2021.0,1,1,0
JOR,FRA,2014.0,1,3,-2
USA,ZMB,2021.0,5,10,-5
FIN,GBR,1998.0,6,5,1
TUN,BEL,2008.0,1,4,-3
DEU,CMR,2008.0,2,3,-1
DEU,MNG,2017.0,1,1,0
FRA,HUN,2022.0,1,3,-2
ARG,CRI,2012.0,1,1,0
URY,CHL,2013.0,1,2,-1
THA,AUT,2008.0,1,4,-3
HRV,ITA,2004.0,2,3,-1
CAN,EST,2018.0,1,3,-2
ROU,GBR,2000.0,2,1,1
PNG,AUS,1997.0,1,1,0
DEU,MDA,2013.0,1,2,-1
SVN,DEU,2007.0,2,6,-4
LTU,CHE,2020.0,1,2,-1
CHE,PAK,2011.0,2,3,-1
TUR,GRC,2004.0,3,1,2
BGD,PAK,2008.0,4,3,1
AUT,FIN,2004.0,3,3,0
USA,SDN,2015.0,4,4,0
NLD,HKG,2008.0,1,2,-1
HUN,ROU,2005.0,4,4,0
LTU,SWE,2010.0,3,5,-2
TUN,KEN,2012.0,1,1,0
BEL,NZL,2008.0,1,2,-1
FRA,CYP,2016.0,2,5,-3
PRT,CHN,2013.0,4,11,-7
ZAF,FRA,1999.0,1,2,-1
JPN,BEL,1998.0,2,4,-2
TUR,SAU,2016.0,5,1,4
IRQ,USA,2020.0,5,59,-54
SEN,ITA,2020.0,1,1,0
LTU,RUS,1998.0,1,2,-1
CZE,FRA,1999.0,3,19,-16
COL,DEU,1999.0,2,1,1
CRI,ESP,2011.0,2,5,-3
CHE,COG,2019.0,7,1,6
NZL,HKG,2008.0,4,1,3
SGP,IRN,2011.0,1,7,-6
DNK,ISL,2015.0,4,1,3
IND,HRV,2017.0,1,1,0
SLE,GBR,2019.0,5,4,1
EGY,OMN,2007.0,2,1,1
CHE,ROU,2001.0,1,2,-1
IRN,ZAF,2021.0,2,4,-2
IRL,CHE,2006.0,5,10,-5
ZAF,ETH,2005.0,3,3,0
BEL,MYS,2008.0,2,1,1
PRT,TUN,2021.0,2,1,1
CRI,BRA,2014.0,1,3,-2
MWI,ETH,2020.0,1,1,0
SWE,IND,1998.0,1,4,-3
KGZ,KAZ,2017.0,3,2,1
GBR,LUX,2022.0,4,3,1
CZE,CAN,2004.0,5,7,-2
FIN,BRA,2013.0,4,3,1
CAN,LKA,2002.0,1,1,0
SWE,LAO,2010.0,1,1,0
DEU,LBN,2013.0,2,5,-3
SVK,AUS,2017.0,1,2,-1
JOR,CAN,2015.0,8,13,-5
MYS,IDN,2002.0,1,3,-2
CHN,COL,2022.0,1,1,0
NCL,AUS,2019.0,1,1,0
AUS,OMN,2021.0,2,2,0
POL,ROU,2016.0,2,2,0
KAZ,FRA,2017.0,3,3,0
CHE,NER,2020.0,1,1,0
PAK,IND,1998.0,1,2,-1
LTU,DNK,2015.0,2,2,0
CHN,NZL,2008.0,5,4,1
WSM,USA,2021.0,1,1,0
PAK,IND,1997.0,2,1,1
IND,EGY,2006.0,1,2,-1
CAN,NGA,2010.0,2,6,-4
TUR,RUS,2011.0,1,3,-2
ARM,RUS,2019.0,3,2,1
OMN,IRN,2017.0,1,3,-2
DNK,PRT,2005.0,2,2,0
ITA,ZAF,2000.0,1,2,-1
EGY,YEM,2010.0,2,1,1
USA,VNM,1999.0,1,4,-3
PRT,DNK,2000.0,1,1,0
PRT,IND,2008.0,1,14,-13
CAN,LKA,2005.0,2,1,1
ETH,TZA,2013.0,1,1,0
LTU,NLD,2011.0,3,3,0
NLD,VNM,2011.0,1,1,0
HUN,RUS,2015.0,1,1,0
GBR,MCO,2010.0,2,1,1
EGY,PAK,2011.0,1,1,0
GRC,ZAF,2022.0,1,1,0
NZL,NGA,2021.0,1,4,-3
TUN,NOR,2018.0,1,1,0
ITA,LTU,2011.0,3,2,1
LUX,NLD,2012.0,3,5,-2
ZWE,ZMB,2009.0,1,1,0
ZAF,CZE,2014.0,1,1,0
RWA,DEU,2017.0,1,2,-1
SRB,JPN,2010.0,1,1,0
EST,RUS,2020.0,1,5,-4
NGA,RUS,2016.0,1,1,0
EST,CHE,2001.0,1,1,0
TZA,IND,2015.0,1,2,-1
PHL,PRT,2020.0,1,1,0
GBR,ETH,2005.0,1,3,-2
USA,UZB,2000.0,1,2,-1
SWE,ECU,2015.0,2,1,1
MCO,FRA,2011.0,3,5,-2
VNM,BEL,2008.0,1,5,-4
AUS,CHL,2006.0,2,4,-2
CMR,BEL,2010.0,2,4,-2
CAN,PHL,2012.0,1,2,-1
ARE,SWE,2009.0,1,2,-1
TUR,GEO,2015.0,1,1,0
GRC,THA,2011.0,1,1,0
MDG,GBR,2014.0,1,1,0
LBY,SAU,2015.0,1,1,0
VEN,NOR,2016.0,1,1,0
THA,PRT,2017.0,1,2,-1
OMN,MYS,2015.0,2,10,-8
PAK,PRT,2021.0,1,2,-1
CHL,NOR,2010.0,3,1,2
IND,KEN,2019.0,2,3,-1
HKG,CHE,2022.0,1,7,-6
ISR,FIN,2019.0,1,3,-2
GBR,ETH,2002.0,1,2,-1
LIE,DEU,2013.0,1,2,-1
CHN,FRA,1997.0,2,3,-1
USA,HND,2017.0,1,2,-1
IND,NZL,2000.0,1,1,0
KGZ,KAZ,2019.0,3,3,0
CAN,CUB,2015.0,1,3,-2
ESP,KEN,2014.0,1,1,0
DNK,PAK,2022.0,2,2,0
BGD,THA,2010.0,1,1,0
NGA,UGA,2012.0,1,1,0
ISL,AUS,2021.0,1,2,-1
ITA,EGY,2022.0,1,3,-2
CHE,PAN,2016.0,1,1,0
DEU,BLR,2018.0,1,4,-3
ARG,CZE,2016.0,2,1,1
SAU,LBY,2012.0,1,1,0
USA,ARE,1998.0,3,1,2
FRA,CUB,2001.0,1,2,-1
TUR,UZB,2006.0,1,1,0
IRL,JPN,2009.0,3,9,-6
OMN,ITA,2019.0,1,2,-1
IRQ,RUS,2017.0,1,5,-4
BRA,CMR,2017.0,1,2,-1
FRA,GUY,2008.0,1,1,0
PSE,CAN,2015.0,1,1,0
MYS,GRC,2018.0,1,1,0
AUT,CHL,2003.0,1,1,0
VEN,CHL,2007.0,3,3,0
AUS,CRI,2014.0,1,1,0
COD,USA,2020.0,2,5,-3
IRQ,CAN,2021.0,1,2,-1
SDN,JPN,2012.0,1,2,-1
IRQ,NGA,2013.0,1,1,0
ARG,RUS,2021.0,1,1,0
HKG,LKA,2018.0,1,1,0
GRC,HUN,2010.0,1,1,0
GBR,TTO,2021.0,2,6,-4
CAN,HUN,2022.0,1,1,0
GBR,PER,2012.0,1,4,-3
KAZ,FRA,2019.0,2,6,-4
TUR,POL,2010.0,2,1,1
GRC,HUN,2017.0,1,2,-1
PAK,CHE,2005.0,1,1,0
DNK,BGR,2004.0,1,2,-1
CZE,SRB,2013.0,1,1,0
ARE,MYS,2014.0,1,6,-5
CZE,NOR,1999.0,1,2,-1
NLD,SRB,2003.0,1,1,0
SGP,BEL,2001.0,1,1,0
CHE,VNM,2015.0,1,6,-5
TUN,EGY,2016.0,1,1,0
ARM,BEL,2014.0,1,1,0
UKR,SRB,2014.0,1,1,0
NOR,SGP,2016.0,1,1,0
GHA,FIN,2018.0,1,1,0
HKG,BEL,2017.0,1,2,-1
PRI,GBR,2001.0,1,2,-1
GBR,BOL,2020.0,1,1,0
CHN,AUS,2018.0,401,371,30
NOR,DNK,2006.0,20,25,-5
GBR,ARG,2004.0,11,19,-8
USA,JPN,2012.0,831,810,21
NLD,GBR,2005.0,145,123,22
DEU,AUT,2022.0,140,117,23
FRA,DZA,2016.0,81,36,45
AUS,JPN,2007.0,28,47,-19
ISL,GBR,2013.0,7,6,1
USA,COL,2005.0,29,32,-3
AUT,GBR,2008.0,62,38,24
IND,SGP,2014.0,82,50,32
ESP,CHE,2013.0,73,49,24
IRN,SWE,2017.0,33,8,25
CHE,IND,2020.0,39,47,-8
GBR,LKA,2014.0,12,6,6
SGP,FRA,2018.0,22,39,-17
ESP,KOR,2016.0,8,10,-2
SAU,AUT,2017.0,3,2,1
NLD,CHN,2015.0,100,108,-8
BGD,AUS,2009.0,16,1,15
IRN,FIN,2018.0,15,1,14
BFA,SEN,2013.0,2,4,-2
NLD,USA,2009.0,303,249,54
DNK,IND,2019.0,14,17,-3
CHN,IRL,2020.0,23,20,3
TUR,EGY,2019.0,3,3,0
FRA,CIV,2015.0,20,13,7
CHE,BRA,2015.0,18,20,-2
GBR,TWN,2003.0,30,18,12
KHM,FRA,2015.0,5,3,2
CHN,ISR,2010.0,3,7,-4
BEL,POL,2019.0,8,19,-11
BGD,USA,2013.0,35,33,2
CAN,ITA,1999.0,13,12,1
CHN,ISR,2019.0,19,23,-4
QAT,DEU,2020.0,2,11,-9
ITA,BRA,2018.0,50,61,-11
IND,PHL,2015.0,8,3,5
SAU,KOR,2016.0,5,24,-19
KOR,GHA,2020.0,4,1,3
UZB,KOR,2021.0,5,4,1
PHL,CAN,2003.0,2,1,1
LKA,USA,2004.0,8,7,1
AUS,IRL,2005.0,21,28,-7
USA,IDN,2010.0,22,16,6
DEU,IND,2009.0,72,126,-54
DEU,LTU,2001.0,2,3,-1
NZL,AUS,2004.0,89,64,25
MYS,NGA,2010.0,3,10,-7
ITA,NZL,2006.0,4,2,2
USA,TUR,2000.0,43,66,-23
SAU,USA,2001.0,15,30,-15
SWE,RUS,2008.0,14,16,-2
HUN,CHE,2002.0,12,3,9
EGY,ARE,2002.0,11,6,5
HUN,CHE,2005.0,10,5,5
DEU,HKG,2003.0,8,9,-1
ITA,JPN,2003.0,17,17,0
MLT,JPN,2000.0,1,1,0
USA,PNG,2000.0,1,1,0
DEU,COL,2008.0,8,8,0
ITA,IND,2006.0,11,10,1
GRC,FIN,2012.0,5,1,4
IRL,MEX,2009.0,2,4,-2
SVN,USA,2019.0,10,10,0
BLR,POL,2014.0,1,3,-2
MYS,GBR,2004.0,20,33,-13
POL,IRL,2006.0,2,2,0
CMR,ZAF,2014.0,4,2,2
RUS,BEL,2005.0,11,9,2
ARG,VEN,2016.0,1,5,-4
CIV,SEN,2009.0,1,3,-2
KAZ,GBR,2017.0,5,4,1
IND,KEN,2017.0,2,1,1
SYC,GBR,2016.0,1,1,0
FRA,SVK,2016.0,4,5,-1
SWE,THA,2018.0,5,2,3
HKG,DEU,2017.0,14,14,0
BEL,ZAF,2009.0,4,3,1
CZE,SAU,2019.0,4,3,1
GBR,NPL,2014.0,10,9,1
USA,BGR,2011.0,11,5,6
JPN,ITA,2015.0,20,17,3
TWN,RUS,2010.0,6,1,5
FIN,FRA,2015.0,15,28,-13
NGA,ZWE,2016.0,1,1,0
AUT,FRA,2013.0,31,41,-10
SRB,NLD,2017.0,6,1,5
LKA,CAN,2015.0,1,2,-1
ESP,SRB,2011.0,2,2,0
BRA,PER,2007.0,4,2,2
NOR,UGA,2012.0,5,4,1
FRA,TUR,2003.0,9,3,6
RUS,AUS,2005.0,8,6,2
DEU,DZA,2015.0,2,2,0
JPN,BRA,2011.0,17,9,8
CZE,ITA,2022.0,5,19,-14
DNK,POL,2014.0,5,16,-11
PAK,DNK,2021.0,4,5,-1
AUS,WSM,2014.0,2,1,1
JPN,TZA,2014.0,5,1,4
CYP,SWE,2021.0,3,2,1
FJI,IND,2008.0,1,1,0
IRQ,IND,2009.0,1,3,-2
NOR,NZL,2015.0,1,5,-4
TUR,POL,2019.0,3,1,2
SWE,HUN,2018.0,4,12,-8
DNK,BEL,2017.0,13,15,-2
BWA,CAN,2020.0,3,2,1
PNG,ZAF,2008.0,1,1,0
OMN,ARE,2016.0,3,1,2
SAU,KWT,2014.0,3,2,1
JAM,TTO,2016.0,2,6,-4
CMR,BEL,2017.0,2,3,-1
BGD,THA,2017.0,1,2,-1
TWN,RUS,2019.0,2,4,-2
MEX,VEN,2010.0,3,11,-8
EGY,ITA,2022.0,3,1,2
SVK,GBR,2002.0,3,7,-4
NZL,VNM,2021.0,4,1,3
IRN,ARE,2017.0,2,1,1
CHL,DNK,2018.0,3,2,1
CMR,BEL,2019.0,5,1,4
ISL,USA,2005.0,5,11,-6
GBR,LBY,2011.0,5,1,4
SGP,ZAF,1999.0,1,1,0
PAN,ARG,2008.0,1,1,0
CHE,SVN,2007.0,1,1,0
DEU,VEN,2009.0,4,6,-2
ZAF,GHA,2009.0,2,1,1
PRT,TUR,2013.0,2,3,-1
TUR,DEU,1999.0,2,5,-3
MEX,SAU,2021.0,2,2,0
VEN,ECU,2013.0,5,1,4
CHN,PRI,2018.0,1,1,0
ISL,NLD,2018.0,3,2,1
FIN,GBR,1997.0,1,1,0
MEX,ZAF,2005.0,2,2,0
BRA,PAN,2015.0,1,2,-1
HKG,IDN,2018.0,1,1,0
AUT,SVN,2003.0,2,5,-3
USA,LAO,2012.0,2,1,1
KOR,ISR,2004.0,1,2,-1
ESP,ISR,2008.0,2,7,-5
VNM,RUS,2004.0,1,1,0
BEN,NLD,2013.0,1,1,0
GBR,JAM,2001.0,3,1,2
NOR,RUS,2018.0,4,5,-1
PHL,KOR,2008.0,1,1,0
GBR,MCO,2017.0,1,1,0
SRB,JPN,2017.0,3,1,2
BGD,DEU,2003.0,2,2,0
GBR,BHS,2020.0,2,1,1
FRA,MLI,2019.0,6,8,-2
RUS,SVN,2012.0,1,2,-1
NLD,UKR,2011.0,1,2,-1
FIN,ROU,2004.0,1,1,0
CAN,UGA,2020.0,2,1,1
SDN,DEU,2010.0,2,4,-2
MDA,DEU,2004.0,1,2,-1
BEL,MWI,2008.0,1,1,0
DEU,MNG,2010.0,2,1,1
NOR,IRL,2007.0,1,4,-3
ARM,RUS,2010.0,1,1,0
LKA,JPN,2013.0,2,9,-7
SVN,ESP,2003.0,1,3,-2
GRC,CYP,1998.0,1,3,-2
PRT,AUS,2003.0,1,1,0
ECU,BRA,2016.0,1,9,-8
BRA,,2023.0,73754,0,73754
NLD,,2020.0,6986,0,6986
AUS,,2011.0,3431,0,3431
ARG,,2019.0,2289,0,2289
EGY,,2024.0,23776,0,23776
ROU,,2024.0,11512,0,11512
NGA,,2022.0,3608,0,3608
FRA,,2009.0,6913,0,6913
IRL,,2012.0,668,0,668
ITA,,2014.0,7633,0,7633
,GBR,2006.0,18301,0,18301
,POL,2003.0,4656,0,4656
,ITA,1995.0,10234,0,10234
,DEU,1995.0,16021,0,16021
PRT,,2015.0,1268,0,1268
ISR,,2012.0,1303,0,1303
ARG,,2017.0,1734,0,1734
PRI,,2018.0,136,0,136
FIN,,2016.0,1562,0,1562
,GHA,1998.0,86,0,86
SEN,,2011.0,36,0,36
ARG,,2010.0,728,0,728
KOR,RWA,2020.0,2,0,2
,NER,2004.0,17,0,17
VNM,,2011.0,96,0,96
,IRN,1998.0,979,0,979
NOR,,2008.0,583,0,583
,NZL,2009.0,1447,0,1447
,SEN,2002.0,63,0,63
RWA,,2013.0,10,0,10
ESP,,2003.0,1620,0,1620
,IRN,1997.0,244,0,244
GBR,MAC,2015.0,3,0,3
DZA,,2020.0,1341,0,1341
IRN,,2005.0,115,0,115
,RUS,2014.0,17662,0,17662
PAK,PHL,2022.0,1,0,1
HKG,,2021.0,1865,0,1865
YEM,,2012.0,19,0,19
KAZ,FRA,2010.0,1,0,1
,KOR,2016.0,15769,0,15769
,MUS,1999.0,21,0,21
,DZA,2012.0,1434,0,1434
SVK,,2003.0,158,0,158
NZL,,1999.0,26,0,26
,OMN,2013.0,155,0,155
,GEO,2000.0,118,0,118
CHE,MDG,2011.0,1,0,1
MAC,,2009.0,10,0,10
DNK,EGY,2012.0,2,0,2
,AUT,2018.0,2301,0,2301
,ALB,2011.0,144,0,144
OMN,,2018.0,154,0,154
GHA,,2018.0,180,0,180
NPL,,2020.0,256,0,256
GBR,AZE,2016.0,3,0,3
,LVA,2010.0,298,0,298
,VNM,2016.0,1739,0,1739
,SVK,2014.0,1137,0,1137
ETH,,2016.0,140,0,140
BRN,,2020.0,33,0,33
,SLB,2011.0,5,0,5
,PHL,2016.0,664,0,664
SEN,EGY,2015.0,1,0,1
FIN,LTU,2020.0,2,0,2
,AND,2012.0,1,0,1
BGD,CHE,2011.0,1,0,1
DOM,MEX,2020.0,3,0,3
POL,SAU,2015.0,1,0,1
,PAN,2000.0,26,0,26
IDN,,2013.0,139,0,139
,LVA,2019.0,153,0,153
,LVA,2017.0,276,0,276
,YEM,2016.0,45,0,45
UKR,KAZ,2022.0,4,0,4
CZE,COL,2016.0,1,0,1
,MDA,2006.0,52,0,52
,BEN,2003.0,39,0,39
ESP,PRY,2019.0,5,0,5
IND,YEM,2011.0,5,0,5
ECU,,2007.0,13,0,13
MNG,,2016.0,35,0,35
CHE,SAU,2015.0,7,0,7
THA,MDV,2019.0,1,0,1
AGO,PER,2017.0,1,0,1
IND,HRV,2019.0,1,0,1
SGP,LUX,2020.0,3,0,3
USA,GIN,2012.0,1,0,1
,LKA,2008.0,150,0,150
CHN,ARM,2017.0,2,0,2
NZL,FIN,2022.0,4,0,4
SOM,,2022.0,10,0,10
BRN,IDN,2021.0,3,0,3
TZA,BDI,2019.0,1,0,1
KAZ,NLD,2020.0,1,0,1
,SEN,2005.0,73,0,73
ETH,NLD,2002.0,4,0,4
IRQ,ARE,2008.0,3,0,3
GIN,,2024.0,75,0,75
LKA,,2003.0,12,0,12
,GHA,1997.0,22,0,22
,BDI,2012.0,13,0,13
,NIC,2002.0,11,0,11
KAZ,,2011.0,36,0,36
,MKD,2001.0,42,0,42
TUR,EGY,2010.0,2,0,2
,COD,2001.0,2,0,2
IRN,,2002.0,12,0,12
KHM,NLD,2014.0,1,0,1
PHL,,2006.0,47,0,47
PYF,,2019.0,8,0,8
POL,UZB,2013.0,1,0,1
USA,PLW,2005.0,2,0,2
FJI,NGA,2020.0,1,0,1
BEL,THA,1997.0,1,0,1
JPN,MEX,2006.0,5,0,5
,PSE,1999.0,31,0,31
FIN,HUN,1999.0,4,0,4
TUR,CYP,2000.0,2,0,2
MYS,NPL,2002.0,1,0,1
ISL,,2003.0,9,0,9
,TJK,1994.0,24,0,24
NLD,TUR,1998.0,1,0,1
IRN,CHE,1998.0,1,0,1
JPN,KWT,2004.0,2,0,2
LBN,IRQ,2015.0,1,0,1
ARG,BEL,2001.0,2,0,2
,TTO,1994.0,14,0,14
GUF,USA,2004.0,1,0,1
HUN,ROU,2002.0,3,0,3
BLR,,1999.0,19,0,19
VNM,MYS,2013.0,2,0,2
FIN,LUX,2003.0,1,0,1
NLD,KWT,2002.0,1,0,1
CAN,ECU,2008.0,4,0,4
JAM,IRL,2018.0,1,0,1
POL,CHN,1999.0,1,0,1
CAN,CZE,1997.0,4,0,4
KNA,CAN,2019.0,1,0,1
GEO,,2001.0,5,0,5
POL,BGR,2015.0,4,0,4
TTO,AUS,2008.0,1,0,1
ARG,PRT,2005.0,2,0,2
POL,SVN,2008.0,2,0,2
NCL,,2013.0,3,0,3
PSE,,2014.0,39,0,39
AUS,IRQ,2008.0,2,0,2
ETH,AUS,2009.0,5,0,5
NGA,JAM,2021.0,1,0,1
BMU,,2012.0,4,0,4
RUS,COL,2012.0,2,0,2
IND,SVK,2012.0,1,0,1
NLD,QAT,2018.0,7,0,7
KAZ,GBR,2010.0,1,0,1
MUS,JPN,2017.0,1,0,1
CUB,CHE,2019.0,4,0,4
JPN,BRN,2018.0,3,0,3
,LSO,2011.0,7,0,7
LUX,AUS,2016.0,2,0,2
SYC,,2016.0,2,0,2
CHN,MLT,2020.0,1,0,1
,VUT,2012.0,6,0,6
,DOM,2014.0,26,0,26
NAM,,2015.0,16,0,16
,KEN,1995.0,97,0,97
GHA,KEN,2007.0,1,0,1
PNG,AUS,1998.0,3,0,3
LTU,TUR,2015.0,1,0,1
TZA,DNK,2006.0,1,0,1
ZWE,PAK,2002.0,2,0,2
BEL,HKG,2012.0,3,0,3
FRA,CAF,2004.0,4,0,4
JPN,LVA,2014.0,2,0,2
ITA,LBN,2006.0,1,0,1
PAK,JPN,1998.0,1,0,1
PHL,KEN,2010.0,1,0,1
NGA,MEX,2018.0,1,0,1
DEU,QAT,2014.0,10,0,10
IRQ,OMN,2018.0,1,0,1
KOR,EST,2020.0,2,0,2
SYR,IRL,2018.0,1,0,1
NGA,IRL,2022.0,2,0,2
GBR,MLI,2017.0,1,0,1
BOL,BEL,2021.0,1,0,1
WLF,FRA,2013.0,1,0,1
CHL,PAN,2016.0,1,0,1
TWN,NZL,2015.0,3,0,3
CUB,FIN,2007.0,2,0,2
SAU,RWA,2014.0,3,0,3
MWI,,2006.0,12,0,12
TZA,POL,2011.0,1,0,1
LAO,LKA,2015.0,1,0,1
BEL,MOZ,2012.0,2,0,2
IRQ,JOR,1999.0,1,0,1
JPN,HRV,2001.0,3,0,3
VIR,PRI,2004.0,1,0,1
ITA,CHL,1998.0,3,0,3
ITA,CRI,2015.0,1,0,1
IND,LBY,2007.0,1,0,1
CYP,FRA,2009.0,1,0,1
POL,DZA,2019.0,3,0,3
ZWE,CHE,2007.0,4,0,4
,SLE,2002.0,3,0,3
UKR,EST,2014.0,1,0,1
USA,FSM,2005.0,1,0,1
,SLE,2005.0,4,0,4
ESP,BOL,2002.0,2,0,2
ESP,ETH,2012.0,1,0,1
HKG,BEL,2019.0,3,0,3
KEN,ZWE,2021.0,4,0,4
THA,TUR,2017.0,1,0,1
UZB,CZE,2014.0,1,0,1
MYS,RUS,2020.0,5,0,5
NGA,ARE,2021.0,2,0,2
AUT,PER,2016.0,1,0,1
NGA,EGY,2014.0,1,0,1
ZAF,CUB,2015.0,1,0,1
NGA,BFA,2022.0,2,0,2
PHL,KEN,2017.0,1,0,1
SVK,KEN,2019.0,2,0,2
CAN,TZA,2021.0,1,0,1
BGD,IDN,2014.0,2,0,2
CZE,BGR,2003.0,1,0,1
IRN,PAK,2014.0,2,0,2
CRI,CHE,2017.0,1,0,1
CYP,JOR,2021.0,3,0,3
,NCL,1999.0,15,0,15
KOR,NGA,2016.0,3,0,3
GMB,CAN,2019.0,1,0,1
SGP,BHR,2020.0,2,0,2
DNK,,2025.0,10,0,10
PRT,ROU,2004.0,1,0,1
CUB,CAN,2022.0,1,0,1
MYS,NCL,2006.0,1,0,1
THA,LUX,2017.0,1,0,1
ROU,NOR,2007.0,2,0,2
ARE,HUN,2012.0,1,0,1
BRA,BFA,2021.0,1,0,1
SSD,,2024.0,7,0,7
NER,COG,2020.0,1,0,1
TUR,TUN,2014.0,1,0,1
IND,HKG,2006.0,5,0,5
IRN,HKG,2013.0,4,0,4
ERI,ETH,2014.0,1,0,1
NLD,GNB,2018.0,1,0,1
FRA,ARE,2006.0,3,0,3
ITA,NGA,2013.0,5,0,5
BEN,CAN,2006.0,3,0,3
GMB,,2007.0,7,0,7
USA,MLT,2014.0,1,0,1
MEX,KEN,1999.0,1,0,1
HUN,SVK,2004.0,1,0,1
UKR,NOR,2003.0,1,0,1
RUS,SVK,2005.0,1,0,1
USA,PLW,2002.0,3,0,3
MEX,BGD,2014.0,1,0,1
BEL,MCO,2010.0,1,0,1
UZB,MYS,1999.0,2,0,2
NGA,DNK,1998.0,1,0,1
ZAF,CHL,2001.0,1,0,1
VEN,IRL,2009.0,1,0,1
IND,KWT,2014.0,9,0,9
AUS,BLR,2019.0,1,0,1
BLZ,,2011.0,1,0,1
SLE,KEN,2012.0,1,0,1
PRT,GNB,2015.0,1,0,1
PAK,JPN,1997.0,1,0,1
NOR,IDN,2011.0,1,0,1
CAN,MCO,2016.0,1,0,1
AUS,MEX,1999.0,2,0,2
CAN,GRD,2012.0,1,0,1
BFA,GAB,2011.0,1,0,1
TUR,PRT,2021.0,3,0,3
IRL,VEN,2002.0,1,0,1
ARG,POL,2021.0,2,0,2
GBR,TCD,2016.0,1,0,1
BGD,CYP,2017.0,1,0,1
MEX,ROU,2020.0,2,0,2
LUX,ISR,2018.0,1,0,1
BGR,UKR,2013.0,3,0,3
,NIC,2005.0,5,0,5
NLD,GAB,2014.0,1,0,1
ESP,PAK,2004.0,1,0,1
OMN,ARG,2017.0,1,0,1
BEL,SDN,2001.0,2,0,2
ZMB,USA,2000.0,2,0,2
HKG,MAC,2001.0,1,0,1
SRB,LBY,2010.0,1,0,1
GUY,,2009.0,2,0,2
NLD,CMR,2012.0,1,0,1
TUR,LUX,2016.0,1,0,1
GRC,CHL,2012.0,2,0,2
GBR,GUF,2006.0,1,0,1
AZE,DEU,2003.0,2,0,2
HND,,2015.0,6,0,6
POL,BLR,1999.0,2,0,2
PYF,,2017.0,10,0,10
BRA,LBN,2013.0,2,0,2
NPL,KOR,2008.0,2,0,2
NLD,ERI,2010.0,1,0,1
AUT,PHL,2010.0,2,0,2
AUS,MUS,2017.0,2,0,2
ISR,NOR,1999.0,1,0,1
CUB,USA,2000.0,5,0,5
,SMR,2003.0,1,0,1
MLT,POL,2019.0,2,0,2
UKR,NLD,2019.0,5,0,5
UZB,USA,2008.0,4,0,4
,TLS,2004.0,1,0,1
AUT,MNE,2016.0,1,0,1
FIN,NOR,1999.0,1,0,1
ZWE,RWA,2011.0,2,0,2
YEM,MYS,2006.0,1,0,1
,MCO,1994.0,1,0,1
PER,NOR,2012.0,1,0,1
BRA,IDN,2020.0,2,0,2
FJI,VNM,2021.0,1,0,1
TWN,RUS,2017.0,4,0,4
ISR,ARG,2008.0,1,0,1
FIN,SAU,2007.0,1,0,1
VEN,RUS,2007.0,1,0,1
MMR,GBR,2015.0,1,0,1
CUW,NLD,2004.0,1,0,1
MOZ,SDN,2020.0,1,0,1
LIE,DNK,2017.0,1,0,1
YEM,IRQ,2012.0,1,0,1
JOR,CZE,2016.0,1,0,1
ARG,AUS,2004.0,1,0,1
UKR,GEO,2016.0,3,0,3
KOR,MCO,2004.0,1,0,1
NOR,ISL,1997.0,1,0,1
UZB,IND,2005.0,1,0,1
FRA,BHR,1999.0,2,0,2
MKD,AUS,2017.0,2,0,2
DNK,FRO,2011.0,2,0,2
MAR,SUR,2019.0,1,0,1
,MDV,2015.0,2,0,2
JOR,TUN,2021.0,1,0,1
,TKM,1997.0,1,0,1
VEN,SWE,2007.0,1,0,1
NAM,LSO,2021.0,1,0,1
DEU,ECU,2002.0,1,0,1
CHE,KEN,2007.0,2,0,2
BWA,USA,1999.0,2,0,2
ESP,PSE,2004.0,3,0,3
IND,SYR,2004.0,1,0,1
,TKM,1998.0,2,0,2
ZMB,TZA,2005.0,1,0,1
CIV,DEU,2005.0,1,0,1
TGO,NLD,2009.0,1,0,1
BEL,PSE,2003.0,2,0,2
OMN,KWT,2009.0,1,0,1
PRI,GRC,1999.0,1,0,1
MCO,DEU,2015.0,1,0,1
BRB,,2007.0,1,0,1
MAR,SYR,2018.0,2,0,2
DOM,,2007.0,2,0,2
CUB,FRA,2007.0,1,0,1
GRC,ARM,2012.0,1,0,1
PYF,,2010.0,4,0,4
CUB,AUT,2003.0,1,0,1
MYS,DZA,2011.0,1,0,1
SRB,SVK,2000.0,1,0,1
THA,TTO,2006.0,1,0,1
GBR,FJI,2020.0,1,0,1
CUB,CHE,2017.0,1,0,1
HRV,PRT,2007.0,1,0,1
CHE,ZMB,2008.0,1,0,1
ITA,SRB,2000.0,1,0,1
UKR,ISR,2019.0,4,0,4
GBR,SLV,2006.0,1,0,1
GEO,CZE,2002.0,1,0,1
PHL,BGD,2001.0,1,0,1
MNG,IRN,2011.0,1,0,1
ZAF,DZA,2010.0,1,0,1
GRC,LUX,2018.0,1,0,1
BEL,SEN,2010.0,1,0,1
BGD,MYS,2000.0,2,0,2
ISR,HRV,2020.0,1,0,1
MAR,FIN,2015.0,1,0,1
COL,SWE,2001.0,2,0,2
FRA,TCD,2016.0,3,0,3
ZWE,COG,2003.0,2,0,2
SGP,HUN,2010.0,4,0,4
ZAF,BGD,2010.0,1,0,1
IDN,PHL,2002.0,1,0,1
LVA,FRA,2011.0,1,0,1
CIV,BEN,2005.0,1,0,1
ZAF,MDG,2011.0,1,0,1
BWA,KEN,2008.0,1,0,1
NAM,CHN,2012.0,1,0,1
MLT,NLD,2007.0,2,0,2
MEX,NZL,2000.0,2,0,2
LTU,ESP,2015.0,1,0,1
VNM,SWE,2009.0,1,0,1
IND,QAT,2008.0,3,0,3
ARG,SGP,2010.0,2,0,2
VEN,IND,2012.0,2,0,2
IRL,ISL,2015.0,2,0,2
ROU,MDA,2008.0,2,0,2
PRI,CHN,2010.0,1,0,1
TWN,MNG,2016.0,2,0,2
NAM,POL,2022.0,1,0,1
DEU,CIV,2020.0,1,0,1
CHL,NOR,2019.0,2,0,2
ARE,LTU,2019.0,1,0,1
MNE,JPN,2020.0,1,0,1
VGB,GBR,2018.0,1,0,1
PAK,BWA,2015.0,1,0,1
LIE,FIN,2019.0,1,0,1
ATA,,2024.0,1,0,1
TWN,PAK,2004.0,1,0,1
NOR,ISL,1998.0,1,0,1
MEX,ZAF,2002.0,1,0,1
CHN,PRK,2012.0,2,0,2
LBN,SWE,2008.0,1,0,1
EGY,AZE,2016.0,1,0,1
ZMB,NAM,2013.0,1,0,1
ALB,HRV,2019.0,1,0,1
GRD,IND,2018.0,1,0,1
MMR,IND,2021.0,1,0,1
IRQ,UKR,2021.0,1,0,1
TUN,IRN,2013.0,1,0,1
MWI,COL,2013.0,1,0,1
IDN,RUS,2018.0,1,0,1
SWE,GRC,2005.0,3,0,3
USA,SLV,2022.0,1,0,1
BGD,TZA,2017.0,1,0,1
SWE,RWA,2017.0,2,0,2
PYF,NCL,2016.0,1,0,1
NLD,LVA,2007.0,1,0,1
GUY,NLD,2001.0,1,0,1
VEN,CHE,2018.0,1,0,1
ARE,COL,2015.0,1,0,1
UKR,THA,2015.0,2,0,2
GUM,USA,2002.0,2,0,2
GBR,YEM,2003.0,1,0,1
IND,SVN,2002.0,1,0,1
ITA,BOL,2018.0,1,0,1
SEN,CUB,2000.0,1,0,1
SWE,PER,2003.0,1,0,1
ROU,FIN,1999.0,1,0,1
CUB,JPN,2006.0,1,0,1
MYS,CHE,2004.0,1,0,1
PHL,IRN,2010.0,1,0,1
MEX,SYR,2004.0,1,0,1
CHE,MAC,2013.0,1,0,1
EGY,SGP,2011.0,1,0,1
SAU,SVN,2005.0,1,0,1
,ATG,2014.0,2,0,2
SWE,RWA,2019.0,1,0,1
HUN,MNE,2020.0,1,0,1
CYP,IND,2017.0,2,0,2
AFG,NLD,2012.0,2,0,2
GHA,ZWE,2004.0,1,0,1
VEN,PRT,2008.0,2,0,2
IND,JOR,1998.0,1,0,1
NIC,MEX,2011.0,2,0,2
GUF,GLP,2005.0,1,0,1
CAN,COD,2018.0,1,0,1
CUB,SWE,2011.0,1,0,1
ROU,KOR,2020.0,1,0,1
ESP,GEO,2019.0,1,0,1
PRI,CHN,2017.0,1,0,1
IRQ,RUS,2010.0,1,0,1
JPN,PLW,2013.0,1,0,1
ROU,POL,1998.0,1,0,1
NER,USA,2009.0,2,0,2
GTM,VEN,2003.0,1,0,1
USA,GLP,1998.0,1,0,1
TJK,ITA,2020.0,1,0,1
SWE,MLI,2017.0,1,0,1
LTU,IRL,2015.0,3,0,3
NIC,PER,2006.0,1,0,1
ESP,GEO,2010.0,1,0,1
UZB,PAK,2003.0,1,0,1
KHM,DEU,2012.0,1,0,1
PAK,YEM,2022.0,1,0,1
ITA,MKD,2020.0,1,0,1
DEU,MAR,1999.0,1,0,1
ISL,EST,2010.0,1,0,1
GEO,SWE,2004.0,1,0,1
ITA,SEN,2015.0,1,0,1
DEU,MNE,2014.0,1,0,1
QAT,AUT,2018.0,2,0,2
ISR,ZAF,2009.0,1,0,1
MAC,GBR,2018.0,3,0,3
MEX,HUN,2012.0,1,0,1
LVA,DZA,2020.0,1,0,1
ESP,FJI,2020.0,1,0,1
IRL,KWT,2020.0,1,0,1
PRT,HUN,2018.0,2,0,2
PRT,BRN,2015.0,1,0,1
TUN,IRQ,2022.0,2,0,2
BWA,SWE,2019.0,1,0,1
URY,,2001.0,1,0,1
QAT,KWT,1999.0,1,0,1
HRV,UKR,2018.0,1,0,1
FIN,MEX,2012.0,1,0,1
MEX,FIN,2011.0,2,0,2
MOZ,NLD,2020.0,1,0,1
TWN,FIN,2020.0,1,0,1
PYF,AUS,2016.0,1,0,1
CUB,HND,2020.0,2,0,2
,WLF,2005.0,1,0,1
PAK,CMR,2015.0,1,0,1
LBN,QAT,2008.0,1,0,1
AUT,LKA,2020.0,1,0,1
FRA,MDA,2003.0,1,0,1
NLD,AZE,2015.0,1,0,1
DEU,OMN,2006.0,1,0,1
GBR,PSE,2012.0,2,0,2
MKD,AUS,2010.0,1,0,1
CZE,AUS,2000.0,2,0,2
ECU,VEN,2008.0,1,0,1
GUF,BRA,2015.0,1,0,1
UKR,PRI,2000.0,1,0,1
MAR,CMR,2005.0,1,0,1
BGD,FRA,2015.0,2,0,2
IND,TZA,2016.0,2,0,2
NLD,JOR,2016.0,1,0,1
IRL,TTO,2020.0,1,0,1
BEL,SVN,2004.0,1,0,1
HRV,NZL,2015.0,2,0,2
GUY,ECU,2007.0,1,0,1
CYP,BIH,2018.0,1,0,1
SRB,LBY,2017.0,1,0,1
KHM,CAN,2015.0,1,0,1
ZMB,NLD,2005.0,1,0,1
TUN,SGP,2007.0,1,0,1
BRA,SYC,2008.0,1,0,1
,NER,1996.0,2,0,2
CAN,NER,2009.0,1,0,1
DNK,SRB,2007.0,1,0,1
LSO,,2016.0,4,0,4
SLE,ESP,2011.0,1,0,1
BWA,FRA,2000.0,1,0,1
COG,CMR,2006.0,1,0,1
SLE,NGA,2016.0,1,0,1
BGD,NZL,2004.0,1,0,1
MAR,RWA,2018.0,1,0,1
TUR,SOM,2018.0,1,0,1
TUR,ETH,2017.0,1,0,1
IRN,ISL,2022.0,1,0,1
THA,ZMB,2018.0,1,0,1
IRQ,FIN,2020.0,1,0,1
POL,ETH,2022.0,1,0,1
CAN,ISL,1998.0,1,0,1
TWN,BGD,2007.0,1,0,1
NAM,BWA,2016.0,1,0,1
MEX,BOL,2013.0,1,0,1
KAZ,IRQ,2012.0,1,0,1
EGY,LTU,2022.0,1,0,1
PHL,IRN,2017.0,1,0,1
ZWE,BWA,2022.0,1,0,1
MYS,COL,2015.0,1,0,1
LVA,ISR,2018.0,1,0,1
PHL,PAN,2016.0,1,0,1
CHN,JAM,2017.0,1,0,1
THA,MDV,2017.0,1,0,1
LVA,SWE,2021.0,1,0,1
VNM,PNG,2014.0,1,0,1
RWA,UGA,2020.0,1,0,1
MLI,FRA,2000.0,1,0,1
ISR,IRL,2007.0,1,0,1
NER,KEN,2015.0,1,0,1
GRC,SGP,2004.0,1,0,1
BFA,CIV,2010.0,1,0,1
ARG,DNK,2007.0,1,0,1
NPL,ETH,2006.0,1,0,1
MHL,USA,2002.0,1,0,1
BGD,HUN,2014.0,1,0,1
IRN,LVA,2022.0,1,0,1
LBY,BEL,2015.0,1,0,1
NPL,AUT,2006.0,1,0,1
ITA,URY,2012.0,1,0,1
MMR,AUS,2001.0,1,0,1
GRC,NGA,2013.0,1,0,1
DZA,CMR,2012.0,1,0,1
SRB,BRA,2001.0,1,0,1
ITA,KWT,2020.0,1,0,1
LIE,ESP,2007.0,1,0,1
SVK,KHM,2016.0,1,0,1
IDN,NOR,2008.0,1,0,1
ALB,DEU,2007.0,1,0,1
UKR,CHE,2008.0,1,0,1
NIC,CRI,2009.0,1,0,1
BFA,DZA,2019.0,1,0,1
NGA,POL,2002.0,1,0,1
HKG,COL,2020.0,1,0,1
MYS,KEN,2022.0,1,0,1
ESP,LBY,2017.0,1,0,1
KOR,OMN,2010.0,1,0,1
OMN,KOR,2007.0,1,0,1
BGD,IRN,2016.0,1,0,1
BFA,CIV,2017.0,1,0,1
OMN,TUR,2018.0,1,0,1
SRB,CHL,2019.0,1,0,1
NLD,SDN,1999.0,1,0,1
BRA,THA,2003.0,1,0,1
GBR,MMR,2013.0,1,0,1
GLP,BRA,2008.0,1,0,1
ZAF,ETH,2002.0,1,0,1
USA,FRA,2011.0,670,831,-161
IND,CAN,2011.0,119,59,60
GBR,AUS,2008.0,498,404,94
FRA,IND,2021.0,47,66,-19
CHN,TUR,2015.0,5,5,0
DNK,CHN,2008.0,11,15,-4
FRA,SAU,2016.0,54,14,40
USA,DEU,2013.0,1118,1170,-52
CHE,GBR,2008.0,174,149,25
CHN,CAN,2018.0,274,310,-36
JPN,PHL,2010.0,21,7,14
USA,EGY,2010.0,121,46,75
GBR,GRC,2021.0,119,118,1
CHE,FRA,2014.0,203,329,-126
GBR,NLD,2013.0,226,216,10
USA,CAN,2020.0,1379,1709,-330
DEU,RUS,2012.0,86,101,-15
USA,PAK,2004.0,23,24,-1
USA,ITA,2021.0,291,335,-44
ITA,USA,2012.0,506,381,125
JPN,TUN,2008.0,1,1,0
ISR,USA,2013.0,341,304,37
POL,SWE,2008.0,19,17,2
IRL,USA,2018.0,154,136,18
USA,ZAF,2008.0,58,70,-12
SWE,FRA,2012.0,53,65,-12
BEL,BRA,2020.0,11,19,-8
JPN,AUS,2001.0,38,39,-1
LBN,USA,2008.0,50,28,22
TUN,SAU,2016.0,64,20,44
ITA,JPN,2012.0,25,24,1
ESP,BEL,2016.0,73,45,28
AUT,DEU,2019.0,321,357,-36
GBR,CHN,2008.0,144,134,10
GBR,ESP,2020.0,403,317,86
SGP,USA,2011.0,141,238,-97
MEX,PRT,2011.0,3,1,2
COG,BEL,2010.0,5,1,4
DEU,GRC,2004.0,22,25,-3
PRT,GBR,2017.0,131,83,48
FRA,TUR,2012.0,17,11,6
CHE,NLD,2014.0,55,84,-29
CHN,ITA,2014.0,34,36,-2
PAK,CAN,2014.0,20,12,8
CAN,KWT,2015.0,15,8,7
BEL,CHE,2009.0,34,22,12
JPN,CHN,2003.0,276,240,36
GBR,THA,2011.0,68,31,37
SWE,DNK,2009.0,76,44,32
MEX,ETH,2020.0,2,1,1
AUS,NZL,2003.0,99,99,0
AUT,DEU,2010.0,247,308,-61
DEU,HUN,2012.0,33,27,6
FRA,NLD,2008.0,69,106,-37
FRA,ESP,2008.0,165,171,-6
JOR,ARE,2011.0,9,4,5
CUB,DEU,2008.0,4,3,1
GBR,SGP,2011.0,85,43,42
ITA,CAN,2008.0,45,37,8
GBR,SRB,2012.0,12,2,10
FRA,IRL,2015.0,26,44,-18
DEU,NOR,2013.0,66,29,37
USA,EGY,2019.0,118,107,11
AUT,SVN,2012.0,3,5,-2
NZL,AUS,2020.0,155,132,23
ROU,USA,2016.0,21,14,7
TUR,GBR,2011.0,37,33,4
VNM,GBR,2015.0,18,13,5
RWA,USA,2016.0,13,13,0
ZAF,GBR,2013.0,65,80,-15
DEU,JPN,2007.0,91,95,-4
KOR,IND,2016.0,118,193,-75
VEN,ESP,2013.0,29,17,12
AUS,DEU,2017.0,152,141,11
DEU,NLD,2020.0,293,329,-36
PAK,USA,2018.0,119,84,35
BEL,HRV,2015.0,2,3,-1
SGP,CAN,2006.0,19,22,-3
IDN,AUT,2014.0,1,3,-2
HUN,SRB,2020.0,2,5,-3
USA,EGY,2017.0,100,106,-6
BEL,CHL,2014.0,8,6,2
SWE,TZA,2015.0,1,2,-1
CHE,ESP,2011.0,43,82,-39
NOR,IND,2020.0,15,32,-17
KOR,SAU,2018.0,17,10,7
NOR,BEL,2015.0,4,7,-3
GRC,SWE,2014.0,23,4,19
MEX,DEU,2017.0,31,24,7
HRV,AUT,2017.0,5,3,2
USA,NGA,2018.0,41,49,-8
ZAF,CHN,2019.0,19,7,12
CZE,NLD,2014.0,6,10,-4
JPN,PHL,2017.0,14,25,-11
HKG,CHN,2001.0,126,100,26
AUT,ITA,2022.0,25,22,3
ARG,GBR,2017.0,12,15,-3
JPN,IDN,2021.0,97,49,48
ARG,CHL,2019.0,29,21,8
JPN,NLD,2014.0,21,23,-2
GBR,LVA,2015.0,2,3,-1
MEX,DEU,2019.0,47,35,12
ITA,KOR,2018.0,8,8,0
IRN,NLD,2022.0,16,5,11
NOR,NLD,2016.0,16,41,-25
BGR,AUT,2015.0,2,1,1
NPL,IND,2016.0,20,19,1
HKG,SAU,2016.0,5,1,4
CHN,RUS,2014.0,9,7,2
NLD,DEU,2021.0,236,258,-22
HUN,GBR,2022.0,7,6,1
DNK,GBR,2018.0,96,111,-15
BEL,CHN,2005.0,15,17,-2
IND,DNK,2021.0,23,10,13
MYS,SAU,2019.0,68,18,50
TWN,PRT,2008.0,1,1,0
RUS,BLR,2020.0,9,14,-5
LUX,BEL,2021.0,5,6,-1
ECU,BEL,2018.0,4,2,2
EGY,BEL,2009.0,4,1,3
FRA,GBR,2022.0,127,146,-19
PRT,GBR,2019.0,104,85,19
ITA,CHE,2022.0,89,77,12
ETH,DEU,2017.0,8,5,3
AUT,NOR,2021.0,16,2,14
CHL,ITA,2020.0,15,15,0
ITA,DNK,2018.0,50,24,26
POL,FRA,2018.0,24,34,-10
SAU,CHN,2021.0,30,43,-13
FRA,PYF,2011.0,16,5,11
UGA,ZAF,2018.0,17,17,0
BRA,DNK,2017.0,17,10,7
DEU,GHA,2021.0,11,14,-3
GBR,IRL,2003.0,163,89,74
BLR,DEU,2018.0,4,1,3
HUN,SVK,2020.0,9,6,3
VNM,RUS,2020.0,14,19,-5
MYS,IRQ,2021.0,72,15,57
ROU,NLD,2018.0,4,6,-2
ZAF,CHN,2017.0,12,7,5
GBR,LBN,2022.0,5,7,-2
NLD,ISR,2020.0,11,11,0
LVA,EST,2019.0,2,2,0
BGD,CHN,2019.0,27,22,5
PRT,GBR,2010.0,50,67,-17
IND,PRT,2021.0,8,6,2
DEU,ARG,2022.0,13,12,1
IRN,IND,2018.0,6,13,-7
NZL,IRL,2021.0,9,5,4
CMR,FRA,2021.0,9,13,-4
CAN,IND,2022.0,57,63,-6
MEX,CUB,2020.0,5,25,-20
PAK,MYS,2020.0,50,149,-99
JPN,KEN,2019.0,8,7,1
RUS,EGY,2021.0,7,7,0
POL,GBR,2009.0,42,33,9
TUR,GRC,2020.0,6,3,3
AUS,JPN,2002.0,41,58,-17
CHN,NPL,2015.0,3,2,1
SRB,BIH,2016.0,14,7,7
SWE,BEL,2018.0,25,34,-9
THA,NGA,2021.0,4,2,2
AUS,ARE,2021.0,14,17,-3
HRV,GBR,2011.0,4,3,1
IND,BEL,2015.0,17,22,-5
ESP,PAN,2017.0,4,3,1
NOR,SWE,2018.0,65,61,4
BEL,AUS,2014.0,30,19,11
JPN,IRL,2019.0,10,3,7
COD,COG,2019.0,22,111,-89
MEX,BRA,2020.0,20,28,-8
CAN,FRA,2003.0,142,206,-64
PAK,THA,2020.0,7,10,-3
IND,FRA,2011.0,92,46,46
USA,VEN,2010.0,20,25,-5
JPN,NOR,2017.0,7,3,4
PRT,NLD,1998.0,1,2,-1
COD,COG,2010.0,13,9,4
HUN,DEU,2021.0,25,13,12
HUN,USA,2018.0,62,40,22
GBR,VNM,2011.0,17,8,9
HKG,FRA,2012.0,5,5,0
ISR,JPN,2007.0,4,2,2
ECU,FRA,2017.0,2,8,-6
CAN,ARG,2019.0,10,17,-7
GBR,TWN,2012.0,30,20,10
BRA,ARG,2009.0,36,23,13
GRC,CZE,2019.0,11,2,9
FIN,AUS,2016.0,20,10,10
USA,BGD,2011.0,16,29,-13
PER,USA,2011.0,27,29,-2
MYS,AUS,2012.0,65,78,-13
MAR,FRA,2011.0,43,92,-49
CAN,FIN,2013.0,13,15,-2
VEN,USA,2015.0,18,8,10
MNE,SRB,2006.0,6,2,4
KOR,CHL,2017.0,4,1,3
SWE,NLD,2006.0,25,21,4
BEL,ITA,2009.0,31,60,-29
THA,JPN,2011.0,57,78,-21
DNK,NLD,2009.0,14,18,-4
CAN,LBN,2012.0,14,4,10
DZA,FRA,2014.0,31,107,-76
TUR,BEL,2012.0,3,7,-4
JPN,NOR,2019.0,11,4,7
ESP,DNK,2006.0,6,8,-2
BEL,MAR,2011.0,11,1,10
FRA,TUN,2011.0,112,74,38
CHN,NOR,2011.0,18,9,9
CHE,ARG,2016.0,9,9,0
DEU,SGP,2004.0,12,8,4
GMB,GBR,2006.0,7,5,2
DEU,HKG,2012.0,7,16,-9
CHE,JPN,2005.0,19,31,-12
JPN,KEN,2017.0,8,3,5
ARE,USA,2016.0,43,82,-39
SAU,TWN,2018.0,2,7,-5
SGP,HKG,2004.0,17,22,-5
BEL,CHN,2002.0,14,13,1
IND,PAK,2011.0,19,12,7
HKG,BGD,2019.0,2,3,-1
MEX,NLD,2019.0,26,5,21
AUS,SWE,2003.0,24,24,0
USA,HUN,2013.0,59,70,-11
DEU,SWE,1999.0,43,25,18
IND,GBR,1999.0,28,17,11
JOR,USA,2009.0,11,40,-29
CHE,MEX,2016.0,11,7,4
GEO,USA,2012.0,13,7,6
AUT,SWE,2020.0,34,27,7
CYP,USA,2008.0,5,13,-8
AUT,RUS,2009.0,6,16,-10
FRA,POL,2001.0,30,20,10
RUS,AUS,2007.0,8,4,4
IND,NLD,1999.0,6,1,5
COL,BRA,2015.0,50,33,17
USA,IRN,2006.0,36,54,-18
BFA,FRA,2016.0,8,15,-7
VNM,JPN,2018.0,21,90,-69
FRA,SGP,2009.0,27,4,23
JPN,PHL,2019.0,23,25,-2
AUS,ITA,2008.0,12,17,-5
BWA,IND,2018.0,1,1,0
CHN,ZMB,2018.0,4,1,3
NLD,LUX,2011.0,4,3,1
MEX,ARG,2016.0,19,20,-1
ESP,NLD,2001.0,24,27,-3
NGA,IND,2021.0,9,6,3
MYS,OMN,2018.0,15,3,12
ITA,ISR,2019.0,18,20,-2
RUS,MEX,2020.0,4,6,-2
TWN,SGP,2021.0,8,18,-10
ECU,FRA,2019.0,4,6,-2
DEU,CAN,1998.0,25,19,6
KWT,IRL,2021.0,1,3,-2
CHL,PRY,2021.0,3,1,2
KAZ,TUR,2020.0,6,10,-4
GRC,ITA,2022.0,11,12,-1
ETH,SAU,2018.0,3,1,2
HRV,AUT,2019.0,9,3,6
CHL,ECU,2021.0,7,8,-1
USA,LTU,2011.0,10,4,6
IRN,MYS,2021.0,16,31,-15
ETH,IND,2021.0,24,40,-16
CAN,EGY,2016.0,44,33,11
IND,CHN,2013.0,38,18,20
ARG,CHL,2017.0,13,16,-3
URY,BRA,2015.0,10,6,4
CHN,PRT,2019.0,4,4,0
BEL,SWE,2008.0,8,10,-2
GRC,GBR,2006.0,84,142,-58
CHL,NLD,2021.0,15,5,10
NGA,ITA,2021.0,4,4,0
CAN,ARG,2010.0,8,8,0
POL,UKR,2000.0,3,12,-9
CAN,SWE,2013.0,43,32,11
FRA,IRN,2011.0,21,14,7
JPN,KEN,2010.0,3,3,0
CHE,ZAF,2020.0,5,19,-14
HKG,BGD,2017.0,1,2,-1
SVK,JPN,2011.0,3,2,1
THA,NPL,2015.0,6,4,2
MEX,CAN,2013.0,29,24,5
GBR,OMN,2014.0,13,6,7
CHE,JPN,2002.0,23,35,-12
POL,HUN,2018.0,4,4,0
CAN,IRN,2006.0,41,52,-11
JPN,RUS,2003.0,38,38,0
GBR,RUS,2000.0,17,39,-22
NOR,AUS,2018.0,15,18,-3
IRL,ITA,2001.0,5,5,0
SYR,BEL,2005.0,1,1,0
FRA,JPN,2004.0,48,68,-20
COL,ARG,2013.0,13,7,6
ARM,USA,2001.0,3,1,2
IDN,USA,2009.0,11,27,-16
AUS,JPN,2005.0,35,42,-7
LUX,CHE,2004.0,1,1,0
DEU,CAN,1997.0,13,22,-9
DNK,NOR,2016.0,43,24,19
TUN,FRA,2000.0,7,22,-15
FIN,NLD,2001.0,3,6,-3
BEL,AUT,2005.0,4,6,-2
SAU,ARE,2008.0,7,1,6
RUS,FRA,2001.0,53,33,20
USA,DNK,2006.0,88,76,12
FRA,NCL,2008.0,16,16,0
NOR,FRA,2007.0,17,21,-4
CHE,DNK,2006.0,13,23,-10
FRA,GAB,2006.0,6,4,2
GBR,IRN,1998.0,3,1,2
AUT,SVK,2011.0,6,6,0
OMN,USA,2007.0,3,8,-5
ISL,ITA,2011.0,1,1,0
DEU,MEX,2002.0,16,6,10
BRA,CHE,1999.0,2,3,-1
USA,SVK,2001.0,6,15,-9
SWE,GBR,1998.0,10,16,-6
FRA,VNM,2005.0,2,3,-1
FRA,CHL,1999.0,9,4,5
BEL,GRC,2009.0,9,8,1
NLD,SGP,2008.0,7,4,3
ITA,RUS,1997.0,11,5,6
BEL,AUT,2002.0,8,7,1
SWE,POL,2006.0,8,8,0
CHE,PER,2019.0,1,3,-2
ITA,ISR,2010.0,9,6,3
RUS,BEL,2007.0,11,13,-2
ZAF,NLD,2003.0,9,9,0
UKR,GBR,2013.0,7,6,1
UKR,CAN,1999.0,6,2,4
BIH,DEU,2018.0,7,4,3
COG,BEL,2017.0,5,7,-2
IRL,SGP,2008.0,1,2,-1
URY,USA,1999.0,3,1,2
FRA,EGY,2011.0,15,7,8
ITA,PRT,2003.0,17,3,14
THA,AUS,2022.0,11,11,0
AUS,IND,2006.0,19,44,-25
CRI,MEX,2012.0,2,4,-2
MAR,ESP,2003.0,8,4,4
MEX,CHE,2013.0,6,4,2
DNK,FIN,2011.0,10,15,-5
AUS,BRN,2002.0,1,2,-1
DEU,MEX,2005.0,23,16,7
SWE,PRT,2008.0,4,4,0
DEU,NZL,2001.0,15,11,4
AUS,BEL,1999.0,3,2,1
CZE,MEX,2004.0,2,1,1
MNE,JPN,2004.0,1,1,0
CRI,DEU,2008.0,4,1,3
AUS,VNM,2011.0,4,6,-2
ESP,TUR,2008.0,1,8,-7
SVK,ESP,2008.0,2,4,-2
ISR,SGP,2012.0,7,1,6
CHN,NGA,2011.0,4,4,0
FRA,MKD,2006.0,3,1,2
ESP,CHL,2003.0,25,14,11
ROU,HUN,2011.0,3,4,-1
HKG,TWN,2009.0,8,14,-6
CHN,IRL,2004.0,4,1,3
USA,LUX,2011.0,5,5,0
ARE,CHN,2020.0,8,15,-7
IND,CHE,2014.0,38,32,6
ISR,MEX,2015.0,1,2,-1
CHN,PRT,2010.0,10,7,3
GRC,AUS,2009.0,4,3,1
NZL,ARE,2011.0,3,1,2
ESP,POL,2015.0,16,25,-9
CAN,COL,2015.0,17,14,3
MEX,DEU,2010.0,15,25,-10
FIN,LUX,2012.0,1,2,-1
ARE,EGY,2012.0,9,10,-1
NLD,TZA,2010.0,3,3,0
HUN,ROU,2007.0,2,3,-1
BGD,CHN,2017.0,19,19,0
ARG,GBR,2019.0,15,10,5
JAM,USA,2010.0,8,6,2
GRC,BEL,2008.0,12,8,4
KOR,MYS,2019.0,8,7,1
GBR,SYR,2018.0,3,5,-2
AUT,CHL,2012.0,2,3,-1
HUN,NLD,2011.0,11,8,3
ETH,DEU,2010.0,4,2,2
CAN,SVK,2016.0,1,1,0
ITA,ISR,2017.0,19,19,0
GRC,NOR,2011.0,2,2,0
NGA,MYS,2013.0,21,17,4
TUR,KOR,2011.0,3,2,1
IRL,IND,2016.0,11,21,-10
THA,HKG,2014.0,2,4,-2
JPN,NOR,2010.0,6,3,3
CHL,ARG,2014.0,17,23,-6
TUR,ITA,2014.0,12,14,-2
CHL,CAN,2015.0,17,19,-2
SWE,ARE,2021.0,5,5,0
AUS,LKA,2018.0,18,34,-16
GRC,ISR,2014.0,3,2,1
CRI,USA,2014.0,9,9,0
CZE,UKR,2015.0,3,6,-3
SWE,LBN,2020.0,2,2,0
JAM,USA,2019.0,4,3,1
DNK,COL,2016.0,4,2,2
KOR,MYS,2017.0,7,26,-19
NZL,DNK,2013.0,10,3,7
OMN,PAK,2017.0,2,8,-6
AUS,SGP,2022.0,18,27,-9
BWA,ZAF,2021.0,6,3,3
HRV,NLD,2016.0,3,5,-2
HUN,CHN,2021.0,5,12,-7
EGY,AUS,2021.0,9,8,1
ESP,IDN,2018.0,2,1,1
ARG,AUS,2020.0,9,1,8
IDN,GBR,2022.0,5,18,-13
PAK,NLD,2020.0,7,14,-7
COL,CHN,2019.0,4,4,0
CHN,IRQ,2021.0,10,3,7
UKR,TUR,2020.0,4,2,2
SAU,BEL,2022.0,3,1,2
NOR,SRB,2009.0,6,2,4
ZWE,ZAF,2007.0,19,2,17
ITA,ROU,1999.0,3,2,1
CAN,DNK,2013.0,19,16,3
FRA,GUF,2015.0,22,14,8
MEX,GBR,2008.0,23,38,-15
CAN,HKG,2003.0,24,30,-6
GBR,ETH,2007.0,2,2,0
CAN,BGD,2006.0,2,5,-3
TUR,QAT,2015.0,2,2,0
DNK,HKG,2022.0,3,2,1
GBR,CYP,2015.0,27,21,6
JPN,IRL,2017.0,6,11,-5
FRA,FIN,2015.0,28,15,13
CAN,POL,2021.0,7,10,-3
KEN,TWN,2019.0,1,1,0
TWN,PAK,2020.0,4,6,-2
NGA,NZL,2021.0,4,1,3
GBR,LTU,2015.0,10,4,6
JPN,FRA,2000.0,19,23,-4
ZMB,DEU,2015.0,1,2,-1
NLD,NOR,2008.0,21,10,11
GLP,FRA,2020.0,10,6,4
EST,DEU,2011.0,3,5,-2
ARG,COL,2018.0,25,18,7
HUN,JPN,2013.0,2,5,-3
ESP,EGY,2015.0,13,2,11
CHN,FIN,2011.0,13,11,2
CHE,TUR,2012.0,4,9,-5
ARG,IRL,2021.0,3,1,2
PHL,USA,2011.0,30,26,4
CZE,IRN,2018.0,3,5,-2
ROU,RUS,2018.0,3,1,2
GHA,DEU,2022.0,5,7,-2
AUS,AUT,2016.0,26,20,6
RUS,AUT,2001.0,10,4,6
SYR,USA,2021.0,1,4,-3
JOR,PAK,2016.0,2,1,1
ARG,CHL,2010.0,11,11,0
SGP,VNM,2018.0,9,5,4
IRN,RUS,2018.0,5,5,0
AUT,FIN,2020.0,6,18,-12
ZAF,JPN,2021.0,4,1,3
ISR,TUR,2008.0,2,2,0
ZAF,ISR,2006.0,2,1,1
SVN,DEU,2005.0,8,3,5
IRL,DNK,2006.0,2,7,-5
ZWE,GBR,2013.0,3,6,-3
MWI,GBR,2009.0,9,10,-1
POL,ESP,2000.0,3,2,1
AUT,CHE,1997.0,7,13,-6
ESP,PAN,2019.0,6,1,5
AUT,HUN,2001.0,8,7,1
DNK,CHE,2008.0,14,25,-11
TUN,ITA,2014.0,3,2,1
CYP,GBR,2015.0,21,27,-6
SYR,IRQ,2010.0,1,1,0
JPN,BGR,2002.0,3,6,-3
CHE,IND,2004.0,6,17,-11
GBR,CMR,2005.0,4,1,3
SWE,EGY,2012.0,7,4,3
QAT,CAN,2021.0,11,13,-2
HRV,AUT,2010.0,2,3,-1
DNK,ISR,2009.0,1,5,-4
ARM,DEU,2010.0,4,1,3
SWE,ROU,2015.0,2,2,0
ARG,NLD,2009.0,6,2,4
BRA,DNK,2010.0,6,2,4
IDN,NLD,2015.0,14,15,-1
ITA,SMR,2012.0,2,1,1
ECU,FRA,2010.0,2,1,1
JOR,EGY,2011.0,2,1,1
NLD,SAU,2020.0,7,8,-1
SVN,ESP,2012.0,4,4,0
JOR,MYS,2011.0,3,10,-7
THA,FIN,2012.0,1,1,0
QAT,LBN,2018.0,1,4,-3
CAN,CHL,2022.0,6,10,-4
SVN,DEU,2002.0,6,7,-1
KEN,TZA,2014.0,4,4,0
JPN,IRN,2018.0,10,11,-1
TUN,ESP,2012.0,5,1,4
SRB,CHE,2016.0,3,3,0
ISL,NOR,2008.0,3,2,1
REU,FRA,2011.0,14,15,-1
EGY,NLD,2018.0,1,4,-3
VEN,FRA,2018.0,5,3,2
PRT,ROU,2020.0,4,2,2
IND,MYS,2022.0,13,20,-7
PER,COL,2018.0,3,2,1
CHN,PRT,2017.0,6,13,-7
MKD,SRB,2018.0,5,2,3
AUT,NZL,2021.0,5,2,3
AUT,CHE,1998.0,5,7,-2
GBR,MAR,2022.0,2,1,1
KOR,NLD,2016.0,6,8,-2
ESP,ROU,2008.0,8,1,7
OMN,PAK,2019.0,3,10,-7
TZA,GBR,2011.0,5,8,-3
POL,CZE,2013.0,6,4,2
ARE,FRA,2017.0,3,10,-7
PRT,CAN,2009.0,6,4,2
THA,KOR,2015.0,7,9,-2
HUN,ESP,2021.0,3,3,0
SGP,SAU,2017.0,7,2,5
CHL,POL,2015.0,2,2,0
CAN,KEN,2020.0,6,4,2
JPN,IRL,2010.0,7,4,3
CHL,MEX,2018.0,14,12,2
FIN,LTU,2004.0,3,2,1
PHL,THA,2015.0,1,4,-3
CAN,MEX,2006.0,14,24,-10
OMN,IND,2011.0,6,13,-7
BEL,RUS,2005.0,9,11,-2
MYS,ITA,2012.0,3,3,0
PAK,CHE,2007.0,1,3,-2
KOR,POL,2019.0,3,1,2
VEN,PRI,2016.0,2,1,1
KAZ,ITA,2016.0,2,1,1
PRT,AUS,2012.0,6,3,3
NIC,USA,2013.0,3,3,0
BEL,RUS,2002.0,9,9,0
RUS,ISL,2019.0,1,1,0
LBN,EGY,2016.0,4,6,-2
ETH,GBR,2006.0,1,2,-1
IRL,POL,2020.0,4,2,2
USA,EST,2022.0,4,3,1
GBR,ARG,2020.0,10,19,-9
SGP,ESP,2013.0,7,12,-5
KOR,CHL,2010.0,1,1,0
JPN,UGA,2018.0,2,1,1
CAN,MAR,2018.0,11,5,6
SGP,BRA,2018.0,2,3,-1
ESP,CRI,2013.0,8,2,6
AUS,ETH,2013.0,3,1,2
ESP,SVK,2013.0,2,2,0
CUB,VEN,2005.0,3,1,2
POL,NOR,2008.0,5,4,1
SGP,LKA,2004.0,1,1,0
ETH,ZAF,2004.0,5,1,4
LKA,KOR,2015.0,3,5,-2
LBN,GBR,2012.0,4,9,-5
SAU,TUN,2014.0,6,36,-30
SDN,GBR,2003.0,3,1,2
IRL,CHL,2010.0,2,3,-1
JPN,NGA,2008.0,4,3,1
ZMB,ZAF,2013.0,2,2,0
RUS,KOR,2007.0,9,11,-2
JPN,DNK,2021.0,5,6,-1
VNM,USA,1999.0,4,1,3
ARG,DNK,2005.0,1,1,0
NOR,AUT,2003.0,1,2,-1
HRV,DEU,2009.0,6,11,-5
FRA,VNM,2002.0,3,2,1
JPN,TUR,2001.0,2,4,-2
NZL,JPN,1999.0,1,3,-2
BRA,NGA,2011.0,1,1,0
FIN,CHL,2006.0,1,1,0
FIN,IRL,2006.0,2,2,0
NCL,FRA,2001.0,1,5,-4
MYS,SDN,2008.0,3,1,2
ARE,FRA,2019.0,7,22,-15
USA,GAB,2012.0,1,4,-3
SRB,GBR,2009.0,8,6,2
NZL,ISR,2013.0,2,1,1
KEN,CHN,2008.0,2,2,0
KHM,GBR,2019.0,2,2,0
BWA,GBR,2007.0,2,2,0
CHN,ESP,2006.0,4,3,1
KHM,AUS,2010.0,2,1,1
ARE,BEL,2019.0,1,4,-3
NPL,NOR,2016.0,3,3,0
FRA,MDA,2012.0,2,3,-1
NOR,CHL,2010.0,1,3,-2
NLD,CHL,2009.0,1,2,-1
BEL,NPL,2008.0,1,1,0
TUN,JPN,2016.0,1,8,-7
CHE,LUX,2016.0,5,3,2
AUS,HUN,2018.0,3,6,-3
NLD,TZA,2019.0,2,4,-2
ARE,IND,2011.0,4,17,-13
FLK,GBR,2018.0,2,1,1
TZA,PAK,2011.0,2,1,1
CMR,DEU,2016.0,3,1,2
BGD,DNK,2018.0,3,1,2
IRN,NZL,2012.0,9,1,8
CZE,CAN,2020.0,5,9,-4
TUN,QAT,2012.0,2,1,1
RUS,ISR,2004.0,10,12,-2
USA,NPL,2003.0,5,4,1
USA,LVA,2002.0,2,2,0
JPN,BGR,2005.0,4,4,0
DZA,ITA,2015.0,1,4,-3
KOR,NZL,2016.0,5,6,-1
BGD,DEU,2012.0,7,7,0
MEX,ZWE,2017.0,4,2,2
BRA,AUT,2016.0,4,6,-2
CHL,KOR,2011.0,1,2,-1
KEN,CAN,2011.0,5,7,-2
MUS,USA,2020.0,1,1,0
SYR,FRA,1999.0,1,2,-1
AUS,ARG,2022.0,2,1,1
FRA,BOL,2002.0,2,4,-2
POL,JPN,1999.0,5,9,-4
DNK,HUN,2011.0,2,5,-3
KOR,POL,2017.0,2,4,-2
SAU,LBN,2012.0,2,3,-1
JPN,CZE,2021.0,2,7,-5
GRC,ROU,2016.0,2,6,-4
HUN,NOR,2013.0,4,2,2
GRC,IRL,2015.0,1,6,-5
VNM,AUS,2009.0,3,4,-1
KEN,SWE,2014.0,1,2,-1
KAZ,USA,2013.0,2,8,-6
FRA,ALB,2015.0,1,2,-1
FIN,MYS,2021.0,2,2,0
DNK,ITA,2007.0,9,13,-4
LBY,GBR,2016.0,5,5,0
IRQ,SRB,2018.0,1,3,-2
QAT,MYS,2015.0,1,6,-5
AUT,PAK,2008.0,5,6,-1
DEU,BWA,2015.0,2,1,1
CHE,PHL,2020.0,4,4,0
ARE,ESP,2019.0,2,12,-10
SVK,HUN,2018.0,5,10,-5
HKG,MYS,2020.0,4,5,-1
JPN,GHA,2021.0,3,5,-2
CZE,BEL,2011.0,5,7,-2
CHN,THA,2004.0,2,2,0
EGY,DEU,1998.0,1,2,-1
MEX,CZE,2018.0,3,2,1
GRC,CZE,2010.0,1,1,0
BEN,SEN,2012.0,1,4,-3
ETH,KOR,2022.0,2,1,1
MNG,RUS,2020.0,2,1,1
GBR,KWT,2022.0,2,4,-2
MDA,UKR,2007.0,3,2,1
PHL,CAN,2012.0,2,1,1
LKA,NZL,2016.0,3,6,-3
COL,CRI,2016.0,3,4,-1
DNK,ZAF,2004.0,2,2,0
UKR,SVK,2004.0,1,2,-1
BFA,MLI,2009.0,1,2,-1
FRA,ARG,1999.0,8,4,4
FRA,LBN,1999.0,3,1,2
MYS,IDN,2007.0,9,6,3
FRA,IRQ,2016.0,1,1,0
ISR,ROU,2013.0,3,2,1
KOR,MYS,2010.0,9,2,7
JPN,ZMB,2013.0,2,2,0
MYS,POL,2019.0,2,1,1
KOR,DZA,2019.0,1,1,0
NER,DEU,2017.0,1,1,0
AUS,ISL,2019.0,2,2,0
ZAF,CHN,2010.0,4,6,-2
KEN,FRA,2011.0,2,1,1
FIN,TUR,2013.0,1,2,-1
ARE,ROU,2019.0,1,1,0
CHE,PER,2017.0,1,1,0
NIC,ESP,2013.0,1,1,0
POL,CHL,2016.0,2,2,0
AUT,ROU,2015.0,4,6,-2
JOR,SAU,2005.0,3,1,2
AUS,HRV,2013.0,3,1,2
BEL,IRL,2004.0,4,2,2
IRN,ITA,2004.0,1,4,-3
SWE,CZE,1999.0,3,3,0
AUT,POL,1999.0,2,2,0
SVN,TUR,2014.0,1,1,0
NOR,UGA,2003.0,1,3,-2
KEN,MWI,2017.0,2,2,0
IRN,DEU,1999.0,2,2,0
BRA,URY,2004.0,3,2,1
USA,LVA,2005.0,2,1,1
BRA,CZE,2001.0,1,1,0
ITA,RUS,1998.0,5,16,-11
FIN,GRC,2011.0,2,3,-1
LBN,FIN,2021.0,1,1,0
HRV,FRA,2009.0,4,2,2
GBR,PSE,2003.0,1,2,-1
SVK,SWE,2014.0,3,1,2
SDN,USA,2014.0,1,7,-6
ARE,JPN,2013.0,1,2,-1
DNK,CZE,2018.0,2,4,-2
CHE,COL,2020.0,4,7,-3
CAN,BWA,2020.0,2,3,-1
JPN,FIN,1999.0,3,1,2
TZA,ZWE,2011.0,1,1,0
NGA,NLD,2001.0,1,2,-1
PRT,NGA,2021.0,1,1,0
ISR,CZE,2003.0,3,1,2
LKA,IND,2006.0,1,3,-2
DEU,GAB,2021.0,2,8,-6
CAN,ROU,2013.0,4,4,0
CAN,CYP,2018.0,4,1,3
ISR,IRL,2005.0,1,2,-1
AUS,BRN,2005.0,1,3,-2
OMN,PAK,2010.0,1,5,-4
LKA,BEL,2010.0,1,1,0
AUS,PER,2015.0,1,2,-1
JPN,MMR,2014.0,5,2,3
GBR,IRN,1997.0,2,1,1
TUR,IRL,2011.0,4,4,0
JOR,SWE,2011.0,1,1,0
AUS,PRT,2008.0,2,7,-5
PER,BEL,2001.0,1,1,0
BRA,MEX,1999.0,3,5,-2
QAT,DZA,2020.0,2,1,1
KWT,SAU,2002.0,2,3,-1
GBR,SYC,2009.0,1,1,0
ARG,GBR,2010.0,4,11,-7
IND,TUR,2011.0,3,2,1
MYS,TUR,2014.0,2,1,1
FSM,USA,2021.0,1,1,0
KOR,POL,2010.0,1,2,-1
HRV,ITA,2020.0,7,10,-3
SWE,BOL,2020.0,3,3,0
LKA,HKG,2022.0,2,1,1
ALB,DEU,2002.0,1,1,0
ISR,HKG,1999.0,1,1,0
ECU,COL,2008.0,1,3,-2
SGP,SAU,2019.0,6,4,2
UKR,CZE,2014.0,4,4,0
POL,LUX,2018.0,1,1,0
MEX,DNK,2008.0,1,1,0
BEN,FRA,2007.0,2,8,-6
NOR,CHL,2017.0,3,1,2
GRD,USA,2013.0,2,3,-1
NOR,ZAF,2022.0,2,2,0
MYS,POL,2017.0,1,1,0
FJI,FRA,2019.0,1,1,0
BEL,IND,2022.0,4,8,-4
ZAF,SDN,2018.0,3,2,1
ZAF,POL,2017.0,2,4,-2
LBN,BEL,2018.0,3,7,-4
TUR,NLD,2004.0,1,2,-1
HND,USA,2011.0,1,1,0
RUS,SVK,2007.0,4,3,1
NAM,USA,2016.0,3,2,1
AUS,URY,2006.0,2,1,1
GBR,KAZ,2022.0,1,4,-3
NZL,BRA,2005.0,1,2,-1
DEU,UZB,2008.0,1,2,-1
FIN,HKG,2010.0,1,3,-2
MWI,TZA,2014.0,1,1,0
MKD,USA,1999.0,1,1,0
ARE,ROU,2017.0,1,3,-2
THA,ZAF,2008.0,1,1,0
ZAF,KEN,2006.0,5,1,4
KHM,AUS,2019.0,2,2,0
NGA,CHN,2007.0,1,1,0
KOR,BGR,2006.0,1,1,0
IDN,AUS,1997.0,1,1,0
SGP,IRL,2011.0,2,5,-3
PRT,COL,2011.0,1,2,-1
LTU,EST,2019.0,1,2,-1
GRC,SGP,2020.0,3,2,1
CHE,MWI,2020.0,2,1,1
GBR,CMR,2002.0,2,2,0
IRQ,TUR,2020.0,5,20,-15
ZAF,PSE,2022.0,1,1,0
NGA,JPN,2003.0,1,4,-3
CAN,PER,2011.0,2,2,0
SGP,TWN,2003.0,3,2,1
USA,SRB,1999.0,1,10,-9
KWT,NGA,2006.0,1,1,0
RUS,ARM,2021.0,1,2,-1
CZE,BGR,2012.0,1,1,0
MEX,ZAF,2007.0,1,1,0
ESP,TWN,2008.0,1,1,0
FIN,HKG,2019.0,2,5,-3
MDA,DEU,2020.0,1,3,-2
COL,JPN,2009.0,2,1,1
MYS,CHE,2020.0,2,3,-1
PHL,SGP,2007.0,2,1,1
MWI,TWN,2018.0,1,2,-1
ARM,DEU,2017.0,3,2,1
CZE,IRL,2016.0,1,1,0
GBR,PER,2003.0,1,2,-1
PER,CHL,2008.0,2,3,-1
CAN,TUN,2003.0,2,2,0
SVK,GBR,2007.0,2,2,0
SRB,MNE,2020.0,5,9,-4
LKA,MYS,2022.0,3,3,0
USA,VEN,2019.0,4,32,-28
ARE,CAN,1998.0,1,2,-1
ITA,CMR,2012.0,1,3,-2
ISR,IND,2000.0,1,8,-7
GUM,USA,2007.0,1,1,0
LVA,POL,2011.0,1,2,-1
COG,CAN,2021.0,1,1,0
MKD,ITA,2013.0,1,1,0
CHE,UKR,2017.0,1,8,-7
IDN,PAK,2022.0,1,1,0
GHA,KOR,2020.0,1,4,-3
DNK,IDN,2009.0,1,1,0
POL,ZAF,2021.0,1,5,-4
NLD,CRI,2013.0,1,1,0
DZA,IDN,2018.0,1,2,-1
TUN,OMN,2013.0,1,1,0
SVK,CAN,2011.0,1,4,-3
AUT,HRV,2004.0,1,3,-2
KWT,USA,1999.0,2,3,-1
CHE,PER,2010.0,1,2,-1
DEU,ZMB,2021.0,1,1,0
SRB,MKD,2016.0,1,1,0
HRV,SRB,2021.0,2,3,-1
NGA,SWE,2015.0,1,1,0
GBR,TUN,2012.0,1,4,-3
UGA,CAN,2020.0,1,2,-1
FIN,IND,2006.0,1,2,-1
POL,IND,1997.0,1,1,0
TUR,ISR,2008.0,2,2,0
EGY,OMN,2002.0,1,2,-1
IND,POL,2009.0,1,2,-1
SVK,NOR,2019.0,2,1,1
ARE,SYR,2021.0,1,1,0
JOR,RUS,2012.0,1,1,0
KOR,PRK,2020.0,1,1,0
NGA,GMB,2020.0,1,2,-1
TUR,KAZ,2009.0,1,2,-1
BGD,NZL,2020.0,1,4,-3
AUT,ARG,2014.0,1,5,-4
NGA,NOR,2015.0,1,1,0
ARE,HUN,2003.0,2,2,0
ZWE,CHE,2005.0,1,2,-1
BLR,CHN,2021.0,1,1,0
MMR,THA,2015.0,1,2,-1
GHA,UGA,2018.0,2,1,1
AUT,IRN,2008.0,1,4,-3
ZAF,POL,2010.0,1,2,-1
EST,FRA,2006.0,1,2,-1
RUS,HKG,1999.0,1,1,0
MEX,IND,2004.0,1,8,-7
SAU,CAN,1998.0,1,2,-1
WSM,JPN,2011.0,1,1,0
MEX,ZWE,2019.0,1,3,-2
BRN,LKA,2014.0,1,1,0
KWT,PAK,2008.0,1,1,0
CUB,FRA,2005.0,1,4,-3
HKG,SWE,2001.0,1,1,0
TWN,IRN,2012.0,2,2,0
COL,CHN,2017.0,1,3,-2
AUS,LUX,2015.0,1,1,0
IND,FJI,2009.0,2,1,1
ESP,HND,2020.0,1,2,-1
CAN,LKA,2007.0,1,1,0
BIH,AUT,2008.0,1,3,-2
CHE,UKR,2019.0,1,3,-2
QAT,ARE,2005.0,1,1,0
EGY,DEU,1997.0,1,5,-4
ARE,ESP,2010.0,1,1,0
BGD,HKG,2021.0,1,3,-2
NLD,GBR,2007.0,181,148,33
CHE,USA,2015.0,522,503,19
BEL,CAN,2004.0,22,13,9
CZE,EST,2014.0,4,1,3
MYS,SAU,2017.0,89,17,72
CAN,ISR,2016.0,52,55,-3
USA,KEN,2006.0,16,21,-5
USA,NLD,2011.0,283,305,-22
ROU,GRC,2016.0,6,2,4
MYS,SAU,2010.0,16,5,11
GRC,TUR,2011.0,2,1,1
AUS,IRL,2007.0,20,30,-10
CUB,ECU,2020.0,8,5,3
KOR,CHL,2019.0,2,9,-7
PAK,OMN,2014.0,11,2,9
AUT,DEU,2017.0,316,316,0
COD,COG,2017.0,14,45,-31
FIN,MWI,2015.0,2,1,1
GBR,TUR,2014.0,48,38,10
HKG,CAN,2018.0,27,27,0
PRT,SWE,2018.0,19,4,15
AUS,DEU,2010.0,93,132,-39
FIN,JPN,2003.0,14,7,7
ARG,USA,2021.0,95,48,47
CUB,MEX,2014.0,13,5,8
CHE,CHN,2020.0,72,89,-17
LKA,USA,2020.0,17,24,-7
PRT,USA,2014.0,64,56,8
VNM,TWN,2021.0,15,29,-14
POL,RUS,2016.0,14,4,10
KHM,GBR,2017.0,4,2,2
SWE,CHN,2012.0,55,52,3
USA,AUT,2011.0,111,107,4
JPN,AUT,2001.0,8,5,3
ESP,HUN,2013.0,4,5,-1
USA,JOR,2013.0,49,29,20
EGY,GBR,2003.0,17,16,1
GUF,FRA,2012.0,19,14,5
MYS,SGP,2012.0,18,12,6
NGA,USA,2018.0,49,41,8
TWN,FRA,2008.0,6,8,-2
CHE,SWE,2022.0,23,22,1
PHL,NZL,2018.0,2,3,-1
PER,JPN,2008.0,1,1,0
USA,SAU,2003.0,57,18,39
IRL,HRV,2021.0,1,2,-1
IND,IRL,2014.0,15,16,-1
USA,NZL,2008.0,112,83,29
IDN,DEU,2008.0,4,14,-10
NGA,BEL,2012.0,2,2,0
MWI,USA,2006.0,5,5,0
BEL,COG,2014.0,8,3,5
BRA,ITA,2011.0,33,36,-3
CAN,ARG,2017.0,6,11,-5
IRL,DEU,2006.0,20,33,-13
BGR,NLD,2011.0,2,1,1
ITA,AUS,1999.0,5,2,3
JPN,EGY,2006.0,31,13,18
BRA,PER,2002.0,5,1,4
EGY,ARE,2007.0,10,10,0
CHE,SEN,2012.0,2,1,1
CZE,CHE,2001.0,5,3,2
CHL,DEU,2003.0,8,7,1
DEU,THA,2004.0,11,6,5
PER,ARG,2002.0,3,1,2
ITA,CUB,2000.0,2,1,1
IND,SVK,2003.0,2,1,1
HRV,SVK,2002.0,4,2,2
SGP,SWE,2009.0,8,7,1
PRI,ESP,2004.0,2,1,1
CHN,IRN,2011.0,5,3,2
GBR,HRV,2021.0,4,9,-5
ZAF,POL,2019.0,2,4,-2
USA,BWA,2011.0,4,10,-6
MNG,JPN,2013.0,4,3,1
CAN,RUS,2020.0,15,14,1
BRA,CUB,2014.0,4,16,-12
USA,KGZ,2019.0,2,1,1
BEL,SVN,2020.0,4,2,2
ISL,USA,2007.0,14,6,8
GHA,NGA,2007.0,2,2,0
USA,CYP,2008.0,13,5,8
ZAF,GRC,2000.0,1,2,-1
KOR,JPN,2001.0,67,85,-18
DEU,KEN,2015.0,9,11,-2
IRN,PRT,2012.0,11,2,9
USA,GUM,2013.0,6,2,4
ISR,BEL,2013.0,2,3,-1
ARE,ESP,2017.0,5,10,-5
GBR,JOR,2004.0,8,2,6
MAR,TUR,2020.0,3,1,2
VEN,CHL,2005.0,4,2,2
FIN,CHE,2006.0,7,8,-1
POL,DNK,2003.0,4,6,-2
CZE,AUT,2015.0,12,15,-3
SRB,USA,2022.0,9,2,7
BEL,BGR,2010.0,2,5,-3
CAN,NPL,2022.0,4,2,2
VNM,PRT,2019.0,1,2,-1
UKR,ITA,2006.0,1,1,0
MEX,NLD,2017.0,13,12,1
FRA,BFA,2004.0,3,6,-3
CAN,MLI,2015.0,1,1,0
MEX,NLD,2010.0,5,7,-2
ISL,DEU,2022.0,1,2,-1
CAN,URY,2009.0,2,1,1
USA,GEO,2013.0,14,9,5
COG,BEL,2019.0,8,2,6
RUS,EST,2014.0,4,1,3
ZAF,SWE,2006.0,4,6,-2
UKR,SGP,2000.0,1,1,0
USA,MLI,2001.0,4,6,-2
ROU,JPN,2016.0,2,3,-1
GRC,IND,2014.0,3,3,0
KOR,ISR,2020.0,6,7,-1
SGP,MYS,2003.0,7,1,6
IRL,ZAF,2011.0,4,2,2
GBR,ZWE,1998.0,2,1,1
CAN,SVN,2008.0,1,2,-1
DOM,USA,2016.0,5,2,3
EGY,PHL,2020.0,1,2,-1
LBY,USA,2018.0,2,4,-2
URY,GBR,2013.0,3,2,1
BEL,BGR,2019.0,3,3,0
KEN,ETH,2012.0,3,2,1
NER,MDG,2004.0,1,2,-1
BHS,USA,2015.0,2,3,-1
AUT,HKG,2019.0,2,2,0
NPL,GBR,2008.0,3,1,2
LVA,EST,2010.0,2,1,1
CZE,ISR,2022.0,1,4,-3
QAT,JOR,2016.0,1,6,-5
TGO,BEN,2012.0,1,1,0
LBY,FIN,2013.0,1,1,0
ETH,DEU,2019.0,2,9,-7
JAM,USA,2017.0,4,7,-3
PHL,AUS,2006.0,1,3,-2
NLD,SRB,2012.0,1,7,-6
JPN,OMN,2017.0,3,1,2
ARE,OMN,2015.0,1,4,-3
KOR,TUR,2009.0,1,2,-1
NZL,COL,2016.0,1,2,-1
PRT,VNM,2021.0,1,1,0
MOZ,NLD,2004.0,2,1,1
CAN,PHL,2003.0,1,2,-1
ARE,CZE,2019.0,1,1,0
TWN,GBR,1998.0,1,2,-1
KAZ,GRC,2020.0,1,1,0
ARM,DEU,2019.0,2,2,0
ESP,NZL,1999.0,1,1,0
,SWE,2004.0,3592,0,3592
JPN,,2013.0,19270,0,19270
,HRV,2006.0,1059,0,1059
ESP,,2012.0,5764,0,5764
THA,,2024.0,18274,0,18274
,TUR,2000.0,5775,0,5775
,MOZ,2000.0,14,0,14
AUT,,2009.0,1059,0,1059
CIV,,2013.0,68,0,68
,DZA,2003.0,569,0,569
,ZAF,1999.0,2014,0,2014
MKD,,2017.0,95,0,95
,PAK,2006.0,1780,0,1780
,SRB,2008.0,1523,0,1523
RUS,,2000.0,891,0,891
,ESP,2018.0,13033,0,13033
UKR,,2024.0,9588,0,9588
,COL,1998.0,355,0,355
ISL,,2012.0,70,0,70
,UKR,1994.0,2762,0,2762
,KGZ,2004.0,21,0,21
,MEX,2013.0,4983,0,4983
NER,,2011.0,3,0,3
ISR,,2003.0,397,0,397
,IND,2018.0,28851,0,28851
JAM,,2000.0,1,0,1
,KWT,2000.0,165,0,165
GBR,,2000.0,823,0,823
,SWE,1996.0,2168,0,2168
,POL,2012.0,6034,0,6034
TZA,,2008.0,32,0,32
SVK,,2012.0,382,0,382
CYP,,2023.0,821,0,821
,ROU,2017.0,1605,0,1605
COL,,2018.0,1135,0,1135
,PRI,2001.0,148,0,148
ITA,MDA,2010.0,2,0,2
SAU,,2011.0,263,0,263
HUN,,2011.0,756,0,756
,PNG,2004.0,19,0,19
KWT,,2014.0,123,0,123
IRN,,2007.0,222,0,222
AUT,VNM,2007.0,1,0,1
,COL,1997.0,152,0,152
VEN,,2016.0,502,0,502
PER,,2011.0,90,0,90
ZMB,TZA,2007.0,1,0,1
,VEN,2000.0,591,0,591
,ROU,2010.0,2213,0,2213
TTO,,2010.0,29,0,29
,GRC,2009.0,2541,0,2541
URY,CAN,2010.0,2,0,2
IRQ,BRA,2007.0,1,0,1
POL,,2000.0,113,0,113
SRB,,2018.0,779,0,779
,MYS,2015.0,5201,0,5201
,PER,2001.0,175,0,175
BEL,PER,2008.0,2,0,2
,CYP,2011.0,171,0,171
,LAO,2010.0,30,0,30
,HKG,2014.0,1847,0,1847
BFA,,2018.0,83,0,83
,NPL,2008.0,230,0,230
,TCD,2011.0,6,0,6
MKD,,2019.0,125,0,125
,TZA,2016.0,276,0,276
,ISR,2014.0,2566,0,2566
TZA,MWI,2013.0,1,0,1
,BGD,2014.0,874,0,874
UZB,,2021.0,141,0,141
CHN,JOR,2016.0,1,0,1
SVK,VNM,2015.0,1,0,1
VUT,,2019.0,1,0,1
,ISL,2014.0,131,0,131
TJK,,2022.0,59,0,59
BOL,,2024.0,184,0,184
NZL,BTN,2010.0,1,0,1
,BEN,2012.0,89,0,89
SEN,BEL,2017.0,2,0,2
,UZB,2009.0,108,0,108
NLD,,2004.0,1496,0,1496
,ZMB,2014.0,103,0,103
MOZ,,2024.0,291,0,291
QAT,,2009.0,27,0,27
,ARE,2001.0,138,0,138
ZWE,CHN,2017.0,1,0,1
IRN,BGD,2021.0,1,0,1
,LBN,2016.0,578,0,578
GTM,,2021.0,52,0,52
,CIV,2015.0,124,0,124
CAN,BHR,2012.0,2,0,2
CUB,AGO,2014.0,2,0,2
,ARM,2016.0,126,0,126
,GRD,2016.0,19,0,19
,TGO,2018.0,35,0,35
,CUB,1994.0,485,0,485
,GAB,2017.0,36,0,36
GRL,,2024.0,42,0,42
,FLK,2018.0,2,0,2
,PNG,1996.0,14,0,14
,ROU,2019.0,974,0,974
,SYR,2008.0,88,0,88
BGR,,2008.0,147,0,147
GRC,SAU,2014.0,3,0,3
MAR,,2015.0,398,0,398
ARE,DZA,2016.0,2,0,2
MKD,,2010.0,29,0,29
,LIE,2006.0,4,0,4
,LAO,2017.0,24,0,24
IRL,TZA,2017.0,1,0,1
LKA,,2012.0,44,0,44
IRL,,2003.0,169,0,169
SGP,SAU,2010.0,13,0,13
KOR,ARG,2000.0,1,0,1
TUN,,2025.0,8,0,8
,SEN,2007.0,101,0,101
COL,SAU,2012.0,2,0,2
SVN,ETH,2017.0,1,0,1
,TUN,1995.0,221,0,221
TGO,,2018.0,41,0,41
TTO,,2017.0,30,0,30
,BHR,2017.0,88,0,88
,NIC,2007.0,17,0,17
SRB,IRN,2015.0,1,0,1
,JOR,1994.0,97,0,97
,BHR,2019.0,55,0,55
TTO,,2019.0,66,0,66
,MLT,1999.0,27,0,27
,AFG,2014.0,21,0,21
COG,KEN,2019.0,3,0,3
BEL,PAN,2020.0,1,0,1
MLI,ZAF,2019.0,3,0,3
CHE,,2025.0,9,0,9
LVA,ITA,2020.0,1,0,1
ESP,PSE,2020.0,4,0,4
MLI,NGA,2013.0,2,0,2
,LAO,2019.0,7,0,7
CAN,NAM,2016.0,1,0,1
USA,BRN,2013.0,2,0,2
BEN,,2014.0,38,0,38
PRY,,2008.0,4,0,4
,SDN,2000.0,54,0,54
DEU,MDG,2009.0,2,0,2
,SLE,2007.0,10,0,10
,GUF,1999.0,10,0,10
NGA,BLZ,2017.0,1,0,1
IDN,CHE,2020.0,2,0,2
IRN,BEL,2002.0,1,0,1
CAN,BEN,2005.0,2,0,2
GIN,SOM,2020.0,1,0,1
NOR,MWI,2008.0,1,0,1
FIN,NGA,2005.0,1,0,1
ERI,ROU,2011.0,1,0,1
CMR,BFA,2022.0,2,0,2
KEN,POL,2012.0,4,0,4
SGP,ARE,2001.0,1,0,1
MOZ,USA,1999.0,1,0,1
ZWE,SWZ,2006.0,1,0,1
CAN,LBY,2008.0,2,0,2
ARG,CUB,2004.0,3,0,3
NOR,TZA,2004.0,2,0,2
CHE,KEN,2002.0,2,0,2
,GMB,2000.0,12,0,12
DZA,SAU,2002.0,3,0,3
ZWE,,2014.0,29,0,29
CRI,GTM,2013.0,1,0,1
KWT,IRN,2012.0,2,0,2
ISR,PER,2010.0,1,0,1
AUT,KHM,2015.0,1,0,1
ROU,CHE,2000.0,4,0,4
VEN,SWE,2002.0,2,0,2
KWT,TUR,2011.0,1,0,1
,MLI,1995.0,4,0,4
ESP,PHL,2008.0,1,0,1
IRN,BLR,2012.0,1,0,1
ECU,,2002.0,1,0,1
SAU,BRN,2016.0,2,0,2
NPL,,2004.0,9,0,9
NZL,BRA,2002.0,1,0,1
BRB,,2005.0,1,0,1
USA,LKA,1999.0,1,0,1
ECU,,2005.0,9,0,9
JPN,BTN,2008.0,1,0,1
BTN,,2012.0,5,0,5
,AND,2003.0,4,0,4
,VUT,2003.0,4,0,4
ESP,LUX,2012.0,4,0,4
DNK,PRT,2007.0,3,0,3
BGD,CHN,2010.0,6,0,6
GEO,BEL,2006.0,1,0,1
BRB,GBR,1997.0,1,0,1
EUE,ESP,2006.0,5,0,5
PSE,KOR,2017.0,1,0,1
MMR,,2018.0,20,0,20
SDN,DZA,2014.0,1,0,1
,NAM,2009.0,19,0,19
KEN,COL,2012.0,2,0,2
,BHR,2010.0,48,0,48
,GAB,2010.0,21,0,21
JPN,CRI,2016.0,1,0,1
,GTM,2013.0,46,0,46
BRA,VNM,2018.0,2,0,2
NGA,TWN,2014.0,1,0,1
BHR,PAK,2019.0,3,0,3
COL,ZAF,2016.0,3,0,3
SAU,BRA,2019.0,2,0,2
UGA,OMN,2013.0,3,0,3
ZWE,NAM,2019.0,4,0,4
CHN,DZA,2014.0,1,0,1
NZL,GHA,2018.0,5,0,5
MNE,USA,2014.0,1,0,1
ZAF,BRA,1998.0,2,0,2
MAC,THA,2007.0,1,0,1
,ZWE,1994.0,33,0,33
KEN,BGD,2012.0,1,0,1
CHL,PER,1999.0,1,0,1
ISR,IRL,2002.0,2,0,2
PAK,NPL,2011.0,1,0,1
TUN,TUR,2019.0,2,0,2
HND,CRI,2014.0,1,0,1
,BRB,2011.0,10,0,10
ISR,SVK,2018.0,2,0,2
TUN,BDI,2016.0,1,0,1
,HND,2014.0,20,0,20
HRV,ROU,2019.0,1,0,1
ESP,PAK,2020.0,6,0,6
VUT,,2017.0,4,0,4
BRA,MOZ,2021.0,7,0,7
MAR,COG,2017.0,2,0,2
BGR,NZL,2019.0,1,0,1
FRO,,2015.0,6,0,6
TUN,SWE,2021.0,1,0,1
,PYF,2013.0,16,0,16
BGD,PNG,2020.0,1,0,1
CHN,LVA,2019.0,1,0,1
PNG,CZE,2020.0,1,0,1
DZA,,2004.0,12,0,12
EGY,MAR,2021.0,3,0,3
,CPV,2014.0,5,0,5
CHN,SVN,2007.0,2,0,2
ETH,BGD,2013.0,1,0,1
JOR,IRL,2020.0,2,0,2
ESP,ARM,2020.0,1,0,1
ZWE,MWI,2006.0,2,0,2
ITA,CYP,2016.0,5,0,5
ESP,NIC,2007.0,1,0,1
CAN,KHM,2011.0,3,0,3
FRA,LVA,2016.0,3,0,3
,KGZ,1996.0,2,0,2
MOZ,PHL,2016.0,1,0,1
SLV,NOR,2008.0,1,0,1
RUS,COL,2003.0,2,0,2
RUS,LIE,2014.0,1,0,1
KOR,PER,2018.0,2,0,2
GAB,MAR,2011.0,1,0,1
ARG,SWE,2018.0,4,0,4
TUR,SGP,2009.0,1,0,1
BRA,ECU,2011.0,5,0,5
BFA,CHE,2018.0,2,0,2
IRL,SWE,2000.0,2,0,2
GBR,YEM,2012.0,2,0,2
MYS,POL,2010.0,1,0,1
DEU,NAM,2021.0,1,0,1
CAN,JAM,2015.0,2,0,2
URY,SAU,2015.0,1,0,1
NER,NGA,2010.0,1,0,1
KHM,CHE,2016.0,3,0,3
ITA,MDA,2017.0,1,0,1
MAR,COG,2019.0,3,0,3
GRC,ARE,2008.0,1,0,1
SEN,TZA,2017.0,1,0,1
IRL,ROU,2021.0,2,0,2
MRT,CAN,2015.0,1,0,1
LKA,FRA,2017.0,1,0,1
KWT,FIN,2019.0,1,0,1
DZA,SAU,2005.0,5,0,5
AUS,UZB,1997.0,1,0,1
ZAF,LSO,2008.0,2,0,2
DEU,BDI,2009.0,1,0,1
AUT,HKG,2017.0,1,0,1
HUN,VNM,2021.0,3,0,3
GUF,,2018.0,7,0,7
CUB,CHL,2003.0,5,0,5
JPN,ETH,2004.0,2,0,2
CMR,NER,2010.0,1,0,1
CHL,CHN,2004.0,2,0,2
LUX,IRL,2003.0,1,0,1
USA,SOM,2020.0,1,0,1
VEN,DEU,2013.0,5,0,5
MUS,ZAF,2017.0,2,0,2
USA,FSM,2007.0,2,0,2
IDN,AUS,1998.0,1,0,1
EGY,NOR,2018.0,5,0,5
KWT,RUS,2016.0,1,0,1
POL,ISL,2017.0,2,0,2
CYP,ITA,2011.0,1,0,1
LBR,GBR,2016.0,1,0,1
TUR,LBN,2017.0,1,0,1
NLD,TZA,2017.0,4,0,4
JPN,PRY,2014.0,2,0,2
JPN,ZWE,2018.0,1,0,1
MYS,ROU,2020.0,1,0,1
BGD,QAT,2021.0,3,0,3
RWA,ZAF,2013.0,2,0,2
UGA,MWI,2015.0,1,0,1
BHR,,2001.0,1,0,1
,WSM,2018.0,17,0,17
COL,CUB,2001.0,2,0,2
LUX,COL,2015.0,2,0,2
AUT,GAB,2018.0,1,0,1
KEN,HUN,2018.0,1,0,1
TKM,,2018.0,1,0,1
FRA,LBY,2008.0,2,0,2
CMR,DNK,2008.0,1,0,1
,SYC,1998.0,1,0,1
SGP,UKR,2008.0,1,0,1
ISR,SVN,1998.0,2,0,2
COL,CHL,1999.0,3,0,3
CHN,LBY,2007.0,1,0,1
LVA,RUS,2015.0,3,0,3
GTM,NLD,2000.0,1,0,1
DZA,CAN,1999.0,1,0,1
LVA,IRL,2006.0,1,0,1
ISR,HRV,2004.0,2,0,2
UGA,KEN,2009.0,2,0,2
UGA,ETH,2002.0,1,0,1
CRI,PER,2016.0,1,0,1
ROU,NOR,2005.0,5,0,5
ISR,ESP,1999.0,2,0,2
GBR,MDG,2003.0,4,0,4
KOR,KWT,2002.0,1,0,1
CYP,SAU,2015.0,1,0,1
BRN,FJI,2017.0,1,0,1
IND,SVN,2007.0,1,0,1
BEL,PSE,2012.0,1,0,1
GRC,PRT,2000.0,1,0,1
AZE,UZB,2016.0,1,0,1
AUS,ISL,2010.0,1,0,1
ERI,CHE,2012.0,3,0,3
TUR,ZMB,2019.0,1,0,1
TWN,GMB,2019.0,2,0,2
GNB,,2018.0,6,0,6
EST,TUR,2020.0,1,0,1
YEM,,2003.0,2,0,2
,FJI,1994.0,4,0,4
IRL,JOR,2021.0,1,0,1
AGO,,2015.0,6,0,6
YEM,QAT,1998.0,1,0,1
UGA,BEL,2004.0,1,0,1
CIV,BRA,2016.0,1,0,1
GBR,NAM,2011.0,1,0,1
CUB,CHN,2009.0,1,0,1
TUR,MEX,2008.0,1,0,1
TTO,SGP,2001.0,1,0,1
BHR,SAU,2002.0,1,0,1
SAU,BRA,2017.0,1,0,1
MAC,NOR,2009.0,1,0,1
NIC,BRA,2014.0,1,0,1
CHN,PHL,2011.0,2,0,2
BHS,ESP,2022.0,1,0,1
HKG,ITA,2006.0,1,0,1
COG,GRC,2015.0,1,0,1
NIC,GTM,2020.0,1,0,1
GAB,,2009.0,7,0,7
TJK,RUS,2004.0,1,0,1
RUS,GEO,1998.0,2,0,2
DOM,,2002.0,1,0,1
SEN,JPN,2001.0,1,0,1
,WLF,2007.0,1,0,1
CYP,AUS,2000.0,1,0,1
UKR,IRN,2011.0,2,0,2
,SUR,2006.0,2,0,2
IDN,VNM,2006.0,1,0,1
PER,RUS,2020.0,1,0,1
GRC,CZE,2017.0,7,0,7
LBR,MWI,2005.0,1,0,1
NZL,ECU,2011.0,1,0,1
CYP,CZE,2015.0,1,0,1
,SMR,2012.0,1,0,1
CMR,NOR,2017.0,1,0,1
SWE,BWA,2018.0,2,0,2
NOR,PHL,2019.0,2,0,2
IDN,UGA,2019.0,1,0,1
CZE,ARM,2021.0,1,0,1
JOR,NLD,2019.0,1,0,1
FJI,NOR,2022.0,1,0,1
UKR,JPN,2021.0,1,0,1
GEO,CZE,2007.0,2,0,2
VNM,TUR,2018.0,2,0,2
USA,LAO,2003.0,2,0,2
PRT,MOZ,2015.0,1,0,1
NGA,HKG,2014.0,2,0,2
SWE,LBY,2012.0,1,0,1
BGD,RUS,2014.0,1,0,1
CAN,MWI,2018.0,4,0,4
SGP,FJI,2015.0,1,0,1
QAT,ARE,2002.0,2,0,2
EGY,OMN,2005.0,1,0,1
OMN,SDN,2016.0,1,0,1
VNM,HUN,2016.0,2,0,2
JOR,BHR,2006.0,1,0,1
GMB,NGA,2004.0,1,0,1
ARG,NOR,2009.0,2,0,2
AFG,ESP,2010.0,1,0,1
CIV,AUT,2008.0,1,0,1
GMB,NZL,2016.0,1,0,1
KEN,ITA,2015.0,2,0,2
BEL,URY,2012.0,1,0,1
,SLV,2006.0,4,0,4
COG,CHE,2014.0,1,0,1
PRI,ARE,2019.0,1,0,1
BLR,CHE,2019.0,2,0,2
ISR,ECU,2021.0,1,0,1
KEN,FIN,2019.0,1,0,1
HRV,ROU,2017.0,1,0,1
ESP,AFG,2020.0,1,0,1
AZE,KAZ,2011.0,1,0,1
BRA,EGY,2021.0,3,0,3
MYS,IRN,2004.0,1,0,1
SLE,UGA,2021.0,1,0,1
ESP,LTU,2003.0,1,0,1
MMR,MYS,2009.0,1,0,1
BGR,CZE,1999.0,1,0,1
KWT,GRC,2021.0,1,0,1
RUS,GEO,1997.0,3,0,3
KWT,GHA,2014.0,1,0,1
KEN,IDN,2014.0,1,0,1
JOR,OMN,1998.0,2,0,2
KEN,CHE,2005.0,2,0,2
GUM,,2006.0,1,0,1
BRN,FJI,2019.0,1,0,1
CAN,SRB,2008.0,3,0,3
FIN,MAC,2017.0,1,0,1
TTO,IRL,2011.0,1,0,1
KGZ,BEL,2014.0,1,0,1
KOR,URY,2006.0,2,0,2
NIC,DNK,2010.0,1,0,1
LTU,CAN,2009.0,1,0,1
ITA,URY,2003.0,1,0,1
ROU,CHL,2013.0,1,0,1
SDN,BEL,2011.0,1,0,1
ZAF,THA,2014.0,1,0,1
TUN,MEX,2015.0,1,0,1
NGA,SWZ,2021.0,1,0,1
JPN,PAN,2019.0,1,0,1
KOR,TZA,2018.0,2,0,2
IRL,MWI,2015.0,1,0,1
JPN,KWT,2020.0,1,0,1
MAR,GRC,2008.0,1,0,1
BLR,IRQ,2022.0,1,0,1
KEN,FIN,2017.0,1,0,1
CMR,IRL,1998.0,1,0,1
HKG,TUR,2008.0,2,0,2
BEN,GBR,2009.0,1,0,1
NLD,BFA,2016.0,1,0,1
CZE,FIN,1999.0,1,0,1
GBR,ZWE,1997.0,3,0,3
CYP,FIN,2018.0,1,0,1
,GAB,2019.0,21,0,21
GNB,PRT,2018.0,2,0,2
MDG,JPN,2000.0,1,0,1
BEL,MKD,2007.0,1,0,1
TUR,KWT,2015.0,2,0,2
ARG,NZL,2002.0,1,0,1
ARE,TUN,2003.0,1,0,1
CAF,FRA,2001.0,3,0,3
,BTN,2000.0,3,0,3
SDN,TZA,2016.0,1,0,1
FIN,PAK,2009.0,1,0,1
UKR,HKG,2013.0,1,0,1
PRT,LUX,2022.0,3,0,3
PAK,AUT,2006.0,2,0,2
JPN,PAN,2010.0,1,0,1
CHL,FIN,2009.0,1,0,1
ZAF,SLE,2010.0,1,0,1
IND,BRB,2001.0,1,0,1
AFG,CHE,2011.0,1,0,1
COL,KOR,2001.0,1,0,1
PRT,URY,2018.0,1,0,1
LSO,POL,2003.0,1,0,1
KAZ,CHN,2007.0,1,0,1
GLP,,2022.0,2,0,2
BRN,,2004.0,1,0,1
ISR,OMN,2015.0,1,0,1
IRN,BRA,2012.0,4,0,4
CHE,BRN,2016.0,2,0,2
DNK,SRB,2005.0,1,0,1
BEL,BGR,2017.0,2,0,2
,FSM,2013.0,4,0,4
HUN,KWT,2011.0,1,0,1
VEN,URY,2001.0,1,0,1
ESP,BLZ,2013.0,1,0,1
GEO,ESP,2011.0,1,0,1
FIN,TZA,2019.0,1,0,1
ZAF,SAU,2009.0,2,0,2
GMB,,2005.0,1,0,1
ZAF,ARE,2018.0,2,0,2
EGY,TWN,2019.0,4,0,4
ARG,FIN,1999.0,1,0,1
RUS,AZE,2009.0,2,0,2
URY,CAN,2017.0,1,0,1
HND,PER,2017.0,1,0,1
DOM,,2005.0,2,0,2
SVK,SVN,2021.0,2,0,2
THA,BGD,2011.0,1,0,1
NOR,NGA,2013.0,1,0,1
PRI,CUB,2021.0,1,0,1
BIH,DNK,2022.0,1,0,1
,MDG,1995.0,4,0,4
DMA,MEX,2002.0,1,0,1
SYR,UGA,2012.0,1,0,1
CHE,PRI,1999.0,1,0,1
FLK,,2013.0,2,0,2
NOR,EST,2000.0,1,0,1
ZWE,BEL,2001.0,1,0,1
IDN,CAN,1999.0,1,0,1
MAR,MYS,2009.0,1,0,1
BLZ,CAN,2010.0,1,0,1
CHN,SDN,2009.0,2,0,2
GRC,NZL,2008.0,1,0,1
SAU,BRA,2010.0,3,0,3
SVK,NZL,2012.0,1,0,1
MEX,HRV,2011.0,1,0,1
DNK,VEN,2008.0,1,0,1
NZL,BRN,2013.0,2,0,2
IRL,TTO,2004.0,1,0,1
ETH,PAK,2019.0,1,0,1
GMB,,2002.0,1,0,1
GHA,HUN,2018.0,2,0,2
DEU,TGO,2016.0,1,0,1
DEU,BFA,2004.0,1,0,1
HND,CZE,2018.0,1,0,1
UGA,RWA,2022.0,2,0,2
CIV,BEN,2007.0,1,0,1
SVK,TUR,2006.0,1,0,1
TUN,TUR,2010.0,1,0,1
PRT,SAU,2009.0,1,0,1
MYS,ARE,2003.0,1,0,1
COL,PAN,2004.0,1,0,1
MLI,RUS,2022.0,1,0,1
SRB,KAZ,2016.0,1,0,1
,CAF,1994.0,1,0,1
GEO,ITA,2000.0,1,0,1
CMR,MTQ,2007.0,1,0,1
KWT,QAT,2000.0,1,0,1
MDA,ITA,2015.0,1,0,1
ITA,UZB,2015.0,1,0,1
FIN,HKG,2017.0,1,0,1
MEX,AUT,2003.0,1,0,1
ISL,ESP,2012.0,2,0,2
AUS,JAM,2002.0,1,0,1
SWE,MAC,2015.0,1,0,1
NPL,SDN,2021.0,1,0,1
HUN,UKR,1998.0,1,0,1
MWI,BWA,2015.0,1,0,1
FRA,CAF,2020.0,3,0,3
GRD,,2008.0,1,0,1
GEO,TUR,2007.0,2,0,2
JPN,VEN,2010.0,1,0,1
GRC,KAZ,2014.0,3,0,3
KGZ,ISR,2002.0,1,0,1
ERI,,2016.0,1,0,1
SDN,IRQ,2020.0,1,0,1
MDA,BEL,2013.0,1,0,1
SOM,GBR,2022.0,1,0,1
COD,,2008.0,1,0,1
OMN,QAT,2011.0,1,0,1
GMB,CHE,2003.0,1,0,1
AUS,LVA,2011.0,1,0,1
TTO,NLD,2019.0,1,0,1
PER,PRI,2012.0,1,0,1
ISL,NZL,2009.0,1,0,1
NPL,PRT,2014.0,1,0,1
CMR,DZA,2019.0,1,0,1
JAM,ZAF,2015.0,1,0,1
KAZ,DNK,2018.0,1,0,1
TWN,GMB,2017.0,2,0,2
EST,LTU,2010.0,1,0,1
FJI,FRA,2010.0,1,0,1
SVK,EGY,2002.0,1,0,1
,BDI,2003.0,2,0,2
PER,CRI,2002.0,1,0,1
DZA,BHR,2010.0,2,0,2
JPN,EST,2009.0,1,0,1
NZL,IDN,2006.0,1,0,1
CMR,IND,2013.0,1,0,1
DNK,NPL,2013.0,1,0,1
VEN,CAN,2020.0,1,0,1
,VCT,2005.0,1,0,1
RUS,ISL,2017.0,2,0,2
USA,MOZ,2012.0,1,0,1
ISR,URY,2021.0,1,0,1
THA,ESP,2022.0,2,0,2
KWT,EGY,1998.0,1,0,1
CHE,SVN,2005.0,2,0,2
TTO,NLD,2010.0,2,0,2
IRQ,PAK,2011.0,1,0,1
UGA,JPN,2017.0,3,0,3
SRB,ESP,2022.0,2,0,2
WSM,IND,2016.0,1,0,1
SLE,USA,2004.0,1,0,1
URY,BOL,2002.0,1,0,1
ARM,GBR,2000.0,2,0,2
UZB,BRA,2015.0,1,0,1
VEN,SWE,2005.0,1,0,1
RUS,ISL,2010.0,1,0,1
SVK,GRC,2018.0,1,0,1
TUR,LBN,2019.0,1,0,1
CHE,UKR,2010.0,1,0,1
,GUM,1995.0,1,0,1
UKR,ZAF,2011.0,1,0,1
BGR,DNK,2018.0,1,0,1
ISR,MLI,2020.0,2,0,2
UKR,OMN,2010.0,1,0,1
IND,RUS,2005.0,2,0,2
NLD,PAN,2013.0,1,0,1
NGA,WSM,2013.0,1,0,1
AUT,ALB,2018.0,1,0,1
PAN,PRI,2009.0,1,0,1
IRN,JOR,2013.0,2,0,2
CHE,GAB,2020.0,1,0,1
GMB,ZAF,2016.0,1,0,1
NAM,FRA,2016.0,1,0,1
LUX,ESP,2003.0,1,0,1
MAR,MRT,2020.0,1,0,1
CHN,SVK,2013.0,1,0,1
COG,KEN,2017.0,1,0,1
,GNB,2006.0,1,0,1
SLV,ITA,2017.0,1,0,1
NPL,SGP,2018.0,1,0,1
TZA,RUS,1998.0,1,0,1
JOR,YEM,2013.0,1,0,1
JPN,LKA,1997.0,1,0,1
MAR,SEN,2016.0,1,0,1
GAB,CHN,2019.0,1,0,1
SEN,CHE,2018.0,2,0,2
SGP,SEN,2010.0,1,0,1
,BHS,2000.0,1,0,1
NOR,IRL,2002.0,1,0,1
BFA,ITA,2008.0,1,0,1
NLD,GRD,2014.0,1,0,1
VNM,EGY,2012.0,1,0,1
TTO,SWE,2018.0,1,0,1
HKG,BGD,2010.0,2,0,2
NGA,LTU,2021.0,1,0,1
ZAF,TUR,2022.0,1,0,1
GHA,PRT,2013.0,1,0,1
CYP,POL,2021.0,1,0,1
BEL,CIV,2018.0,1,0,1
GIN,BFA,2011.0,1,0,1
EGY,TWN,2017.0,1,0,1
BWA,JPN,2018.0,1,0,1
MYS,TZA,2020.0,2,0,2
IRN,AZE,2006.0,1,0,1
IRQ,BRN,2018.0,1,0,1
TUN,CZE,2022.0,2,0,2
ECU,PAK,2017.0,1,0,1
POL,LKA,2015.0,1,0,1
LUX,MEX,2015.0,1,0,1
PER,BOL,2013.0,1,0,1
SRB,ROU,2000.0,1,0,1
THA,IRL,2016.0,1,0,1
MLT,CAN,2009.0,1,0,1
ALB,USA,2006.0,1,0,1
LKA,ITA,2005.0,1,0,1
MDG,ITA,2001.0,1,0,1
LTU,NOR,2003.0,1,0,1
ARM,JPN,2001.0,1,0,1
ITA,MLT,2001.0,1,0,1
,GRL,1994.0,1,0,1
FIN,SVK,2002.0,1,0,1
BGR,IND,2006.0,1,0,1
AUT,OMN,2013.0,1,0,1
BRB,,2002.0,1,0,1
POL,MLT,2007.0,1,0,1
SEN,TCD,2012.0,1,0,1
QAT,CHN,2009.0,1,0,1
IRL,GHA,2012.0,1,0,1
HUN,IDN,2020.0,1,0,1
FRA,BOL,2005.0,1,0,1
ROU,JOR,2020.0,1,0,1
MYS,TUN,2016.0,1,0,1
URY,SWE,2015.0,2,0,2
CMR,CHE,2001.0,1,0,1
GNB,SWE,2018.0,1,0,1
TGO,USA,2006.0,1,0,1
HRV,ROU,2010.0,1,0,1
FIN,TZA,2017.0,1,0,1
AUT,HKG,2010.0,1,0,1
PER,KOR,2011.0,1,0,1
IND,SYR,2020.0,1,0,1
ZAF,SLE,2019.0,1,0,1
ETH,SGP,1998.0,1,0,1
MAR,UZB,2021.0,1,0,1
NER,NGA,2017.0,2,0,2
FIN,ROU,2020.0,1,0,1
BOL,MEX,2005.0,1,0,1
GNQ,USA,2019.0,1,0,1
EGY,HRV,2022.0,1,0,1
TUR,SRB,2021.0,1,0,1
UZB,AFG,2020.0,1,0,1
BFA,MAR,2011.0,1,0,1
GBR,URY,1999.0,1,0,1
SGP,BGD,2009.0,1,0,1
KOR,IND,2022.0,61,143,-82
FRA,GBR,2016.0,503,348,155
DEU,USA,2006.0,1170,902,268
USA,THA,2009.0,143,89,54
DNK,CHE,2013.0,30,23,7
FRA,CHE,2007.0,247,185,62
USA,DEU,2008.0,915,1113,-198
EST,CHN,2016.0,2,2,0
FRA,ESP,2013.0,142,238,-96
NLD,SGP,2013.0,14,4,10
CHN,CAN,2017.0,293,271,22
SWE,USA,2012.0,205,175,30
AUT,USA,2009.0,86,93,-7
CAN,CHE,2005.0,38,52,-14
CHE,GBR,2013.0,204,243,-39
DEU,ARG,2016.0,22,21,1
VEN,FRA,2010.0,5,7,-2
CHL,MEX,2019.0,12,22,-10
JPN,IND,2011.0,68,73,-5
CHN,CAN,2019.0,312,348,-36
GBR,AUS,2013.0,678,401,277
TUR,JPN,2006.0,7,7,0
NOR,SWE,2010.0,35,64,-29
FRA,BGR,1998.0,1,2,-1
FRA,NLD,2013.0,88,94,-6
NLD,JPN,2006.0,25,9,16
ESP,JPN,2011.0,17,14,3
LBN,USA,2013.0,58,33,25
NZL,USA,2012.0,112,126,-14
TUN,SAU,2022.0,47,23,24
PRT,USA,2004.0,28,36,-8
USA,IRL,2006.0,106,61,45
CHE,FRA,2004.0,161,220,-59
USA,AUS,2011.0,512,460,52
HKG,CAN,2010.0,29,16,13
JPN,CAN,2015.0,75,59,16
JPN,USA,2015.0,767,756,11
ISL,SWE,2011.0,8,8,0
CHN,JPN,2011.0,299,376,-77
GBR,FRA,2012.0,382,336,46
DEU,NOR,2008.0,52,17,35
USA,JOR,2008.0,54,14,40
AUS,HKG,2020.0,51,34,17
CHE,CAN,2012.0,79,82,-3
ISR,CAN,2011.0,55,50,5
DEU,PAK,2006.0,6,7,-1
LUX,FRA,2009.0,4,24,-20
BRA,DEU,2006.0,51,44,7
DEU,FIN,2007.0,35,28,7
JPN,GBR,2015.0,112,124,-12
GBR,DNK,2011.0,71,44,27
SAU,TWN,2017.0,3,3,0
SWE,PRT,2013.0,6,10,-4
BRA,USA,2012.0,282,304,-22
GBR,NLD,2008.0,126,175,-49
JPN,PRY,2004.0,2,1,1
NOR,GRC,2015.0,2,13,-11
ESP,FIN,2015.0,23,11,12
IRL,USA,2010.0,124,131,-7
CAN,SWE,2008.0,27,33,-6
ISR,USA,2008.0,339,241,98
GBR,ITA,2009.0,168,315,-147
GBR,CHN,2013.0,331,193,138
SWE,ESP,2011.0,31,53,-22
FRA,NCL,2013.0,23,13,10
JPN,THA,2011.0,78,57,21
VEN,ESP,2008.0,14,11,3
SGP,AUS,2015.0,80,67,13
IND,JPN,2011.0,73,68,5
ESP,PRT,2020.0,108,100,8
CHN,PAK,2014.0,64,84,-20
USA,HKG,1997.0,16,7,9
AUS,KOR,2016.0,28,46,-18
BRA,JPN,2005.0,6,8,-2
CHN,IRL,2014.0,14,17,-3
IRL,USA,2017.0,132,138,-6
ROU,ITA,2015.0,17,19,-2
CHN,SGP,2011.0,195,163,32
HKG,USA,2015.0,142,127,15
CHE,SWE,2016.0,60,38,22
DEU,SAU,2020.0,29,18,11
GBR,UKR,2016.0,8,9,-1
CAN,CHL,2016.0,18,18,0
IRN,NLD,2016.0,33,11,22
ROU,NLD,2017.0,5,3,2
IRQ,USA,2014.0,6,2,4
SGP,HKG,2014.0,18,31,-13
NZL,GBR,2021.0,70,100,-30
DNK,GBR,2017.0,104,114,-10
CHN,GBR,2020.0,481,590,-109
JPN,KOR,1999.0,43,28,15
RUS,NLD,2015.0,18,11,7
CAN,AUS,2015.0,186,155,31
USA,NZL,2013.0,114,117,-3
AUT,ITA,2016.0,37,57,-20
BGD,JPN,2015.0,34,57,-23
USA,ZAF,2013.0,87,95,-8
DNK,GBR,2019.0,102,106,-4
IND,DEU,2007.0,87,63,24
AUS,ITA,2013.0,21,53,-32
FIN,SWE,2011.0,40,31,9
AUS,CHN,2009.0,69,128,-59
GRC,BEL,2013.0,34,5,29
CHL,USA,2015.0,109,112,-3
ITA,DNK,2017.0,42,24,18
CAN,CHN,2021.0,328,254,74
IRN,RUS,2019.0,18,3,15
PRT,GBR,2018.0,116,78,38
IRN,RUS,2017.0,5,6,-1
GBR,CAN,1998.0,42,50,-8
GRC,ITA,2016.0,40,25,15
GHA,AUS,2015.0,4,4,0
ITA,DEU,2022.0,125,126,-1
IND,MYS,2016.0,73,33,40
DEU,ESP,2006.0,104,79,25
HUN,SWE,2009.0,12,5,7
HKG,CAN,2017.0,26,21,5
CAN,FRA,2001.0,110,129,-19
USA,NOR,2021.0,74,53,21
DNK,GRC,2005.0,1,6,-5
DEU,ZAF,2020.0,36,45,-9
POL,FRA,2019.0,33,35,-2
KOR,DNK,2015.0,11,3,8
CAN,HKG,2001.0,9,19,-10
NLD,TZA,2018.0,3,2,1
KOR,SAU,2010.0,13,1,12
MYS,IRN,2014.0,110,59,51
PAK,USA,2019.0,120,87,33
FRA,USA,1997.0,85,116,-31
SGP,BEL,2012.0,3,4,-1
ARG,CHL,2018.0,31,25,6
USA,PAN,2021.0,11,7,4
PAN,USA,2015.0,13,10,3
SVK,DEU,2020.0,7,8,-1
DNK,CHN,2013.0,19,39,-20
THA,AUS,2016.0,20,37,-17
UKR,DEU,2021.0,27,6,21
NZL,SGP,2020.0,11,14,-3
FRA,JPN,2014.0,95,77,18
JPN,IRL,2018.0,8,3,5
AUS,ZMB,2021.0,2,1,1
ITA,CAN,2013.0,53,44,9
IRN,ITA,2014.0,38,10,28
SVN,GBR,2012.0,5,2,3
NOR,SWE,2017.0,48,79,-31
ARG,COL,2010.0,7,8,-1
NGA,USA,2019.0,63,41,22
IND,SGP,2020.0,85,77,8
RUS,ESP,2021.0,5,11,-6
DEU,IDN,2020.0,24,8,16
FIN,EST,2021.0,12,5,7
ARG,COL,2017.0,20,12,8
URY,ESP,2012.0,4,12,-8
NPL,IND,2022.0,6,10,-4
IND,AUT,2006.0,9,3,6
MEX,DNK,2013.0,4,3,1
MEX,DEU,2018.0,55,37,18
CZE,SVK,2021.0,34,39,-5
HUN,USA,2019.0,56,47,9
ZAF,NAM,2020.0,14,7,7
ECU,BEL,2019.0,3,7,-4
HUN,USA,2017.0,52,49,3
SWE,BEL,2019.0,20,28,-8
SGP,ISR,2021.0,4,4,0
ITA,GRC,2020.0,18,22,-4
USA,PER,2015.0,31,45,-14
MEX,NLD,2018.0,13,12,1
ITA,DNK,2019.0,53,25,28
RUS,FRA,2003.0,48,41,7
SRB,BIH,2022.0,2,3,-1
MEX,AUS,2011.0,10,2,8
ARE,USA,2022.0,36,31,5
ITA,KOR,2017.0,16,7,9
TUN,OMN,2008.0,1,3,-2
BEL,NLD,1999.0,37,30,7
PSE,JOR,2019.0,1,3,-2
CAN,DNK,2008.0,24,16,8
DNK,POL,2020.0,7,10,-3
ESP,ROU,2013.0,7,7,0
USA,IRQ,2021.0,31,11,20
CAN,EGY,2022.0,16,15,1
JPN,CHN,2001.0,132,183,-51
SAU,USA,2012.0,37,126,-89
TUR,ESP,2021.0,10,8,2
SDN,SAU,2021.0,23,7,16
KOR,CHN,2002.0,16,18,-2
CAN,IND,2016.0,101,130,-29
JPN,AUS,2003.0,48,37,11
FRA,BRA,2011.0,88,85,3
DEU,ITA,2011.0,133,242,-109
USA,CHL,2005.0,51,49,2
MEX,ITA,2009.0,6,9,-3
IND,AUS,2015.0,110,56,54
COD,COG,2018.0,35,75,-40
MEX,CHE,2008.0,4,2,2
SAU,KWT,2020.0,10,1,9
EGY,SAU,2000.0,8,15,-7
BEL,IND,2016.0,27,26,1
PRT,BRA,2009.0,45,56,-11
CAN,MAR,2017.0,14,6,8
PAK,USA,2010.0,51,44,7
KAZ,USA,2008.0,6,4,2
AUS,CHE,2005.0,28,25,3
IRL,SGP,2013.0,5,1,4
USA,NGA,2019.0,41,63,-22
CAN,CHE,2002.0,42,41,1
CZE,USA,2011.0,38,49,-11
MEX,IND,2014.0,4,14,-10
ITA,DNK,2010.0,28,11,17
CRI,DEU,2013.0,5,4,1
DEU,CHL,2015.0,41,29,12
DNK,GBR,2010.0,45,63,-18
USA,PAK,2014.0,65,78,-13
GRC,ESP,2007.0,12,4,8
DEU,SGP,2014.0,31,34,-3
MYS,NZL,2011.0,11,13,-2
CHE,RUS,2020.0,18,27,-9
GBR,TUR,2004.0,23,20,3
SGP,AUT,2021.0,4,1,3
IRN,TWN,2020.0,6,1,5
KOR,MYS,2018.0,13,19,-6
BEL,SWE,2013.0,22,14,8
DEU,TWN,2009.0,12,14,-2
GBR,IRL,2001.0,89,63,26
BRA,JPN,2002.0,12,14,-2
MEX,JPN,2012.0,3,4,-1
FRA,CHN,2006.0,32,43,-11
CHL,MEX,2017.0,18,24,-6
PRT,ESP,2012.0,50,89,-39
AUS,LKA,2017.0,14,25,-11
KOR,SAU,2019.0,31,10,21
RUS,NOR,2012.0,7,6,1
NGA,USA,2010.0,18,20,-2
THA,PAK,2014.0,13,4,9
GBR,JOR,2014.0,32,7,25
KOR,JPN,2003.0,79,146,-67
SWE,BEL,2017.0,17,25,-8
SAU,TWN,2019.0,7,2,5
IND,VNM,2020.0,8,2,6
ZAF,GBR,2008.0,75,58,17
FRA,USA,1998.0,136,133,3
DEU,DNK,2006.0,62,42,20
SEN,GBR,2006.0,1,1,0
CAN,FIN,2008.0,14,15,-1
ARG,COL,2019.0,14,20,-6
USA,CYP,2013.0,16,10,6
HKG,CAN,2019.0,18,28,-10
VNM,JPN,2017.0,22,63,-41
ESP,FRA,2000.0,47,51,-4
NOR,USA,2015.0,47,100,-53
CZE,ISR,2016.0,4,1,3
PRT,SWE,2017.0,18,1,17
ESP,NLD,2003.0,34,32,2
ITA,ARG,2011.0,20,6,14
USA,NGA,2017.0,31,50,-19
HKG,GBR,2020.0,68,73,-5
NOR,ZAF,2016.0,5,4,1
IRL,IND,2022.0,6,28,-22
NGA,THA,2019.0,3,1,2
AUS,PAK,2015.0,20,24,-4
TWN,AUS,2021.0,13,17,-4
CAN,SEN,2019.0,1,1,0
CAN,SGP,2002.0,17,18,-1
PAK,BGD,2020.0,10,12,-2
NOR,NLD,2022.0,11,10,1
BLR,DEU,2019.0,7,1,6
NZL,GHA,2019.0,4,3,1
ZAF,USA,2006.0,46,56,-10
AUS,ISR,2002.0,16,10,6
MYS,OMN,2017.0,17,1,16
HUN,USA,2010.0,75,36,39
KOR,ESP,2011.0,4,2,2
BRA,AUS,2002.0,13,7,6
TUR,DNK,2020.0,12,2,10
FRA,AUS,2006.0,45,34,11
AUS,SWE,2001.0,14,18,-4
ISL,IRN,2017.0,1,3,-2
MYS,SAU,2018.0,78,26,52
ITA,SGP,2007.0,3,2,1
JPN,FJI,2021.0,1,1,0
JPN,LTU,2003.0,1,5,-4
NLD,SVK,2015.0,1,1,0
DEU,SVN,2006.0,9,3,6
VEN,GBR,2007.0,7,8,-1
CHE,FIN,2021.0,14,9,5
MEX,CAN,2008.0,22,22,0
FIN,NZL,2013.0,2,1,1
FRA,SAU,2022.0,8,5,3
USA,SAU,2001.0,30,15,15
FRA,REU,2005.0,4,2,2
GRC,FRA,2009.0,24,20,4
NOR,ESP,2006.0,4,5,-1
IND,CHE,2004.0,17,6,11
POL,GRC,2014.0,11,3,8
ESP,TUR,2013.0,7,6,1
BRA,COL,2012.0,25,28,-3
POL,SWE,2013.0,13,12,1
ESP,ITA,2007.0,66,110,-44
ZAF,TZA,2014.0,8,4,4
KOR,SAU,2017.0,26,12,14
PER,COL,2010.0,4,1,3
PAK,ARE,2014.0,9,5,4
USA,ROU,2005.0,14,20,-6
JPN,HUN,2012.0,2,4,-2
SVK,GRC,2019.0,2,1,1
USA,ECU,2012.0,20,13,7
VNM,JPN,2010.0,3,27,-24
AUT,CZE,2015.0,15,12,3
JPN,IRN,2010.0,22,19,3
MDG,GBR,2020.0,2,2,0
DEU,PHL,2005.0,2,2,0
USA,CHL,2002.0,63,35,28
CIV,FRA,1997.0,2,1,1
ESP,PER,2002.0,4,8,-4
DEU,ROU,2005.0,17,17,0
USA,SVK,2003.0,10,29,-19
IND,IDN,2012.0,2,1,1
ROU,DEU,2015.0,27,24,3
DZA,FRA,2004.0,17,27,-10
USA,ARM,2009.0,3,4,-1
ARE,FRA,2018.0,10,13,-3
FRA,POL,2003.0,16,22,-6
SEN,FRA,2000.0,21,6,15
CAN,MAR,2010.0,11,1,10
JPN,AUT,2003.0,13,5,8
USA,UKR,1999.0,12,29,-17
ARG,ISR,1999.0,2,1,1
JPN,RUS,2001.0,25,34,-9
SRB,RUS,2006.0,5,3,2
USA,CZE,2000.0,12,33,-21
DEU,NZL,2003.0,16,17,-1
FIN,NLD,2003.0,9,10,-1
GBR,SVN,2000.0,2,1,1
DEU,ROU,2002.0,8,20,-12
BIH,HRV,2006.0,10,5,5
USA,GEO,2008.0,8,7,1
SWE,FIN,2006.0,31,35,-4
AUS,NZL,2001.0,40,49,-9
CHL,ARG,2004.0,5,4,1
BLR,DEU,2010.0,8,5,3
CAN,TUN,2001.0,1,1,0
NGA,JPN,2001.0,2,4,-2
BRA,AUS,2005.0,11,11,0
JPN,NLD,2004.0,14,16,-2
ARG,URY,2012.0,7,1,6
JPN,IRN,2019.0,14,16,-2
MKD,SRB,2017.0,5,3,2
AUS,SGP,2016.0,81,74,7
EGY,CAN,2006.0,9,5,4
KOR,TWN,2007.0,4,8,-4
ESP,BEL,2022.0,22,32,-10
BEL,TZA,2006.0,3,1,2
THA,PHL,2007.0,2,1,1
JPN,TUR,2003.0,12,10,2
BGR,ITA,2005.0,5,4,1
HUN,AUS,2000.0,1,2,-1
GBR,ARE,2011.0,25,3,22
CAN,AUT,2015.0,23,16,7
CHE,NLD,2004.0,27,37,-10
ECU,FRA,2018.0,3,10,-7
GBR,CAN,1997.0,33,32,1
NLD,IND,2011.0,17,17,0
EGY,GBR,2001.0,6,11,-5
CHN,ITA,2004.0,10,13,-3
CHE,NGA,2013.0,3,1,2
SWE,BGD,2002.0,1,1,0
CAN,UKR,2000.0,2,5,-3
NZL,FRA,2020.0,25,17,8
HRV,SVN,2002.0,5,6,-1
AUT,HUN,2003.0,10,10,0
ARG,PER,2003.0,2,2,0
USA,ISL,2005.0,11,5,6
ITA,PRT,2001.0,5,6,-1
BEL,FRA,1998.0,28,43,-15
ISR,CZE,2001.0,3,4,-1
SGP,SAU,2018.0,7,5,2
AUS,HRV,2008.0,1,1,0
TWN,ISR,2017.0,4,2,2
BIH,DEU,2010.0,3,1,2
SGP,JPN,2005.0,10,17,-7
CUB,DEU,2013.0,7,2,5
CHE,IND,2014.0,32,38,-6
CAN,SGP,2005.0,13,23,-10
USA,HKG,1998.0,30,18,12
DNK,NZL,2005.0,3,3,0
JPN,TWN,2015.0,38,40,-2
ESP,CHL,2001.0,19,13,6
NLD,NOR,2013.0,37,15,22
LTU,POL,2007.0,3,2,1
MYS,RUS,2014.0,2,2,0
DEU,CRI,2006.0,2,1,1
CAN,JOR,2006.0,5,1,4
CYP,DEU,2016.0,4,5,-1
BEL,EGY,2005.0,5,2,3
DNK,ZAF,2014.0,3,1,2
ESP,COL,2006.0,21,12,9
USA,PSE,2014.0,9,3,6
SRB,ESP,2016.0,2,2,0
PHL,FRA,2011.0,1,1,0
AUT,IRN,2013.0,4,13,-9
KOR,CHL,2018.0,3,1,2
GBR,KWT,2016.0,20,5,15
EST,CHE,2012.0,5,2,3
IRL,MYS,2011.0,3,2,1
USA,MWI,2015.0,17,10,7
TUR,NLD,2014.0,22,17,5
EGY,KWT,2009.0,12,10,2
VEN,PER,2015.0,1,1,0
PAK,BRA,2014.0,9,4,5
CHE,PER,2018.0,3,1,2
TUR,SWE,2011.0,6,3,3
ROU,NLD,2010.0,5,4,1
PER,COL,2019.0,5,12,-7
SRB,USA,2016.0,14,10,4
EST,HUN,2016.0,1,2,-1
SGP,DNK,2020.0,9,5,4
ITA,KOR,2019.0,8,9,-1
CZE,DEU,2015.0,38,48,-10
GBR,LBN,2016.0,10,4,6
CHN,THA,2014.0,8,7,1
EST,LVA,2016.0,2,6,-4
KEN,CHN,2013.0,4,4,0
NOR,AUS,2019.0,16,19,-3
BIH,DEU,2017.0,7,2,5
ISR,CHE,2021.0,9,12,-3
SGP,VNM,2019.0,13,2,11
KOR,POL,2018.0,5,5,0
FRA,MDG,2021.0,4,3,1
MKD,DEU,2014.0,2,1,1
AUS,ARG,2016.0,8,6,2
MEX,ARG,2022.0,4,4,0
HKG,MAC,2012.0,20,4,16
MKD,SRB,2010.0,12,2,10
PRT,SWE,2019.0,21,15,6
TUR,CAN,2015.0,11,19,-8
BEL,NOR,2021.0,12,5,7
SVK,HUN,2019.0,10,6,4
ESP,IDN,2019.0,2,1,1
CAN,MAR,2019.0,6,9,-3
TUR,LBY,2020.0,4,1,3
UKR,GBR,2008.0,13,5,8
ITA,HUN,2021.0,10,5,5
JPN,AFG,2020.0,5,2,3
LKA,NZL,2022.0,3,3,0
THA,IRL,2022.0,1,1,0
IND,KWT,2020.0,3,2,1
KEN,UGA,2021.0,4,5,-1
ISL,NOR,2013.0,7,5,2
USA,BEL,2005.0,104,101,3
ITA,ISR,2018.0,22,13,9
SWE,NOR,1998.0,19,7,12
NGA,BEN,2002.0,2,1,1
GRC,SVK,2021.0,2,2,0
GTM,USA,2007.0,5,4,1
DNK,NZL,2002.0,7,1,6
MEX,CZE,2019.0,4,1,3
GRD,USA,2008.0,3,5,-2
CHE,ROU,2012.0,5,5,0
SAU,ARE,2013.0,9,8,1
HRV,AUT,2018.0,9,4,5
COL,GBR,2008.0,8,13,-5
MEX,ECU,2015.0,12,4,8
RUS,CHN,2015.0,7,12,-5
ARG,SWE,2017.0,4,3,1
MYS,OMN,2019.0,16,6,10
ITA,TUN,2021.0,6,5,1
RUS,JPN,2000.0,23,16,7
ESP,CAN,2007.0,32,21,11
LBN,BEL,2019.0,7,5,2
IRL,RUS,2015.0,3,3,0
COL,ARG,2008.0,5,9,-4
FRA,BFA,2014.0,18,10,8
ESP,BGR,2007.0,1,3,-2
NOR,SWE,2019.0,63,71,-8
CAN,LBY,2013.0,1,3,-2
ARM,ITA,2016.0,2,1,1
IND,FIN,2011.0,17,2,15
BFA,CHE,2017.0,2,1,1
CZE,NLD,2004.0,3,3,0
LVA,GBR,2016.0,4,4,0
UGA,BEL,2014.0,3,3,0
LBN,BEL,2017.0,4,10,-6
SAU,BEL,2016.0,5,4,1
BHR,PAK,2018.0,1,1,0
GBR,NPL,2020.0,13,2,11
CHL,DEU,2001.0,11,10,1
CHN,AUT,2020.0,18,15,3
NPL,GBR,2013.0,2,8,-6
BGD,CHN,2018.0,22,16,6
LTU,BLR,2021.0,1,1,0
LKA,MYS,2016.0,4,3,1
IRN,IND,2019.0,2,9,-7
AUS,LKA,2019.0,21,37,-16
USA,QAT,2011.0,29,14,15
USA,ISL,2002.0,25,7,18
USA,OMN,2011.0,7,8,-1
THA,NZL,2007.0,2,3,-1
GBR,SYR,2010.0,3,2,1
USA,ROU,2002.0,14,29,-15
DEU,BIH,2007.0,4,2,2
SWE,LVA,2002.0,2,3,-1
PAK,OMN,2004.0,2,1,1
ISR,AUT,2002.0,2,1,1
ISR,BEL,2008.0,4,1,3
IND,IRL,2004.0,6,2,4
SWE,CHE,2000.0,7,5,2
PRY,ARG,2012.0,3,2,1
AUS,PRT,2013.0,6,11,-5
ZAF,NLD,2001.0,9,5,4
SWE,NOR,1997.0,4,3,1
NZL,CAN,1999.0,5,5,0
IRN,AUT,2011.0,8,5,3
NOR,HUN,2016.0,2,6,-4
GBR,PER,2001.0,4,1,3
HUN,JPN,2008.0,6,2,4
SAU,JPN,2002.0,1,1,0
ZAF,RUS,2009.0,1,1,0
BLR,GBR,2007.0,5,2,3
IDN,DEU,2013.0,5,16,-11
KWT,GBR,2007.0,3,6,-3
HKG,NLD,2015.0,3,5,-2
UGA,ZAF,2010.0,5,4,1
COL,CAN,2009.0,7,3,4
ARG,SWE,2010.0,2,1,1
CAN,SEN,2017.0,2,2,0
ECU,BEL,2010.0,1,1,0
IND,ZAF,2006.0,9,4,5
BWA,IND,2019.0,2,2,0
ROU,RUS,2010.0,1,1,0
SWE,SAU,2012.0,4,3,1
SGP,BRA,2017.0,3,4,-1
DNK,SAU,2015.0,2,3,-1
AFG,PAK,2016.0,2,1,1
LUX,SWE,2016.0,3,3,0
FIN,RUS,2011.0,7,19,-12
FRA,ISL,2009.0,2,1,1
LUX,PRT,2019.0,1,5,-4
ECU,ESP,2009.0,3,1,2
JPN,ETH,2014.0,2,1,1
BLR,DEU,2017.0,5,4,1
FRA,BGD,2013.0,1,1,0
ITA,HRV,2015.0,10,1,9
DNK,GRC,2002.0,2,6,-4
DNK,IRN,2021.0,5,30,-25
SVK,ESP,2013.0,2,2,0
PER,COL,2017.0,4,4,0
BRN,NGA,2020.0,1,1,0
BEL,KOR,2021.0,8,11,-3
GBR,KAZ,2016.0,8,3,5
CZE,MEX,2014.0,2,1,1
UKR,CZE,2004.0,3,1,2
ITA,NOR,2000.0,2,2,0
USA,VEN,2018.0,9,28,-19
COL,FRA,2006.0,4,7,-3
AUT,ZAF,2011.0,2,2,0
CHL,GBR,2011.0,16,29,-13
CZE,JPN,2007.0,8,6,2
EST,RUS,2014.0,1,4,-3
OMN,PAK,2018.0,4,3,1
FRA,TWN,2014.0,9,12,-3
ISR,ISL,2018.0,1,1,0
SAU,MYS,2014.0,15,55,-40
DNK,NOR,2022.0,15,20,-5
TUR,NZL,2003.0,1,1,0
CZE,CHE,2003.0,4,2,2
JPN,ROU,2006.0,2,2,0
USA,HTI,2007.0,2,1,1
AUT,CHN,1999.0,6,1,5
AUS,HUN,2010.0,3,5,-2
IRN,IND,2010.0,3,25,-22
DNK,CZE,2019.0,2,6,-4
IRN,FRA,2003.0,5,5,0
RUS,AUT,2003.0,7,2,5
SRB,PRT,2013.0,2,2,0
BOL,DEU,2015.0,2,1,1
CHN,KEN,2011.0,2,2,0
ETH,ZAF,2014.0,4,3,1
ZAF,LSO,2013.0,1,3,-2
BEN,DEU,2022.0,1,1,0
ZAF,CHN,2018.0,10,8,2
ZAF,SDN,2017.0,2,2,0
BGR,ITA,2002.0,4,7,-3
TUR,FIN,2021.0,6,5,1
CHL,AUT,2021.0,1,2,-1
FJI,GBR,2016.0,3,1,2
KOR,NLD,2022.0,6,3,3
CRI,USA,2004.0,5,10,-5
AUT,BRA,2006.0,2,5,-3
ECU,COL,2013.0,3,1,2
SWE,LVA,2005.0,4,2,2
CHE,KOR,2007.0,2,7,-5
EGY,POL,2013.0,4,2,2
MEX,CZE,2017.0,2,3,-1
ESP,SLV,2015.0,1,1,0
BEL,IRL,2014.0,6,11,-5
CHE,CMR,2020.0,3,3,0
ARG,PRY,2017.0,2,2,0
UKR,CHL,2003.0,1,1,0
USA,ETH,2009.0,3,11,-8
BEL,ARG,2020.0,1,4,-3
IRL,ISR,2005.0,2,1,1
BGR,POL,2002.0,2,1,1
CAN,ARG,2018.0,14,11,3
CAN,ROU,2008.0,2,5,-3
ARM,USA,2003.0,7,2,5
AND,ESP,2003.0,1,1,0
HUN,EGY,2021.0,4,2,2
SVN,FRA,2005.0,3,3,0
NPL,DEU,2005.0,2,1,1
CYP,GRC,2005.0,2,7,-5
BGR,BRA,1998.0,1,1,0
MYS,IRL,2011.0,2,3,-1
DEU,UGA,2005.0,2,2,0
NOR,AUS,2010.0,10,7,3
IND,CHN,2008.0,6,3,3
MYS,IND,2006.0,14,19,-5
CIV,USA,1997.0,1,3,-2
DEU,JAM,2008.0,1,1,0
TWN,CHE,2012.0,3,6,-3
SRB,HUN,2013.0,1,3,-2
PER,BRA,2002.0,1,5,-4
PHL,TWN,2014.0,3,5,-2
SWE,ARG,2012.0,1,4,-3
IRN,IND,2017.0,5,13,-8
JPN,NGA,2013.0,5,6,-1
AUS,MWI,2015.0,1,1,0
GBR,SYR,2019.0,1,3,-2
NZL,MYS,2009.0,5,3,2
LBN,EGY,2022.0,2,1,1
ISL,DEU,2016.0,7,2,5
MYS,SDN,2013.0,4,3,1
BGR,USA,2020.0,4,11,-7
ITA,CYP,2022.0,1,2,-1
GHA,NZL,2015.0,1,1,0
MYS,PSE,2014.0,5,3,2
EGY,NLD,2019.0,3,2,1
BFA,BEL,2017.0,4,1,3
EGY,MYS,2013.0,8,4,4
ROU,USA,2022.0,5,5,0
SGP,BRA,2019.0,1,1,0
BGD,IDN,2020.0,3,2,1
GHA,UGA,2019.0,2,2,0
HKG,BGD,2018.0,4,6,-2
TTO,USA,2005.0,6,6,0
ETH,USA,1998.0,1,1,0
DNK,LTU,2003.0,1,3,-2
BEL,CHL,2004.0,2,1,1
CRI,JPN,2014.0,1,1,0
GRC,CZE,2018.0,7,1,6
ITA,THA,2011.0,3,1,2
CHN,GRC,2005.0,2,4,-2
SLE,USA,2014.0,1,5,-4
SGP,VNM,2017.0,11,2,9
KOR,UGA,2021.0,1,2,-1
NLD,COL,2007.0,2,1,1
ESP,PER,2005.0,7,1,6
FLK,GBR,2017.0,2,1,1
NLD,IDN,2011.0,8,7,1
IRQ,SWE,2013.0,1,1,0
MEX,ZWE,2018.0,1,1,0
CHN,MAC,2007.0,2,5,-3
BIH,AUT,2013.0,1,4,-3
PHL,NLD,2002.0,2,1,1
ISR,ITA,1999.0,4,7,-3
COL,CHE,2006.0,1,3,-2
GRC,SWE,2004.0,2,3,-1
FRA,REU,2002.0,2,2,0
SYR,HUN,2012.0,1,1,0
SVK,SWE,2004.0,3,2,1
GBR,FJI,2014.0,5,2,3
DZA,GBR,2008.0,2,3,-1
DEU,UZB,2013.0,2,4,-2
CYP,USA,2013.0,10,16,-6
POL,CZE,2008.0,2,1,1
MEX,CZE,2010.0,1,2,-1
NOR,KOR,2009.0,2,3,-1
LUX,CHE,2014.0,5,4,1
BEL,LKA,2010.0,1,1,0
POL,LTU,2012.0,1,2,-1
VNM,SGP,2021.0,4,4,0
SGP,VNM,2010.0,5,1,4
DEU,LTU,2012.0,4,3,1
KEN,BEL,2009.0,1,1,0
SGP,TUR,2020.0,5,3,2
AUS,SAU,2000.0,2,2,0
JPN,TUN,2013.0,4,1,3
TTO,GBR,2021.0,6,2,4
ESP,PAN,2018.0,3,2,1
PAK,POL,2015.0,1,1,0
SEN,BEL,2018.0,1,2,-1
AUT,HRV,2014.0,3,8,-5
UKR,SVK,2014.0,4,1,3
KHM,GBR,2018.0,2,2,0
QAT,OMN,2019.0,3,5,-2
CZE,IRL,2022.0,1,1,0
DOM,USA,2022.0,2,3,-1
ESP,TWN,2013.0,2,4,-2
ISR,AUT,2005.0,4,3,1
BLR,RUS,2021.0,8,8,0
ZAF,ARE,2019.0,4,3,1
IDN,GBR,2016.0,8,21,-13
BEL,CIV,2017.0,2,1,1
USA,GUM,2008.0,6,1,5
ARM,DEU,2018.0,3,6,-3
PRI,MEX,2009.0,2,1,1
ROU,RUS,2019.0,1,4,-3
POL,HUN,2017.0,1,2,-1
AUS,ISR,2005.0,3,13,-10
DEU,SVK,2000.0,7,14,-7
GBR,PSE,2001.0,1,1,0
FRA,LAO,2002.0,1,1,0
FIN,JPN,2001.0,8,10,-2
IRQ,MYS,2007.0,3,1,2
CHL,CHN,2014.0,4,2,2
CRI,GBR,2005.0,1,1,0
AUS,CYP,2011.0,4,1,3
USA,SEN,2011.0,1,7,-6
SAU,DNK,2013.0,2,1,1
CAN,SRB,2013.0,2,1,1
ROU,NLD,2019.0,2,3,-1
DNK,HKG,2016.0,1,2,-1
ARE,BEL,2018.0,4,1,3
LBY,USA,2019.0,1,2,-1
CUB,COL,2000.0,1,2,-1
GBR,SYR,2017.0,2,8,-6
DNK,RUS,2015.0,3,4,-1
CYP,PRT,2017.0,1,1,0
MEX,PHL,2020.0,2,3,-1
POL,DNK,2001.0,3,4,-1
GBR,MAR,2016.0,2,1,1
ESP,IRL,2006.0,6,7,-1
ARE,MYS,2020.0,4,31,-27
DNK,MYS,2021.0,2,1,1
SAU,KEN,2011.0,1,1,0
FRA,ECU,2015.0,4,5,-1
RUS,UZB,2000.0,2,8,-6
SAU,TUN,2004.0,1,1,0
USA,NIC,2009.0,2,2,0
MAR,ESP,2001.0,1,4,-3
AUS,POL,2021.0,6,8,-2
MDA,JPN,2004.0,1,1,0
CYP,GRC,2002.0,2,4,-2
SWE,UKR,2011.0,3,9,-6
VEN,DEU,2008.0,4,3,1
SRB,IRL,2002.0,1,1,0
QAT,LBN,2019.0,3,2,1
NER,CHN,2015.0,1,1,0
BRA,ISR,2009.0,2,1,1
POL,HUN,2019.0,3,3,0
HRV,QAT,2021.0,1,1,0
THA,MMR,2020.0,6,3,3
SAU,GRC,2016.0,1,6,-5
SRB,FIN,2019.0,1,2,-1
USA,LBR,2021.0,1,3,-2
ROU,RUS,2017.0,1,4,-3
JPN,KEN,2018.0,5,2,3
CHN,KGZ,2020.0,2,2,0
PRT,ISL,2020.0,1,2,-1
SVN,FRA,2002.0,2,2,0
SEN,USA,2007.0,2,7,-5
PRT,SWE,2010.0,4,5,-1
BFA,FRA,2022.0,3,2,1
CAN,PRT,2021.0,2,10,-8
MUS,GBR,2005.0,3,1,2
KOR,SWE,2006.0,3,3,0
GEO,ARE,2018.0,1,1,0
MEX,BEL,2000.0,1,4,-3
GMB,NGA,2014.0,2,1,1
HKG,SAU,2022.0,2,2,0
ESP,CRI,2008.0,4,2,2
TWN,ISR,2019.0,1,2,-1
THA,CHN,2005.0,1,1,0
DEU,BFA,2014.0,3,1,2
MEX,TUR,2020.0,1,2,-1
EGY,NLD,2017.0,3,4,-1
PRY,BRA,2021.0,2,6,-4
AUT,HKG,2018.0,2,2,0
VNM,POL,2015.0,1,3,-2
JOR,KWT,2021.0,2,1,1
PHL,NZL,2010.0,2,1,1
FRA,HKG,1999.0,1,1,0
BGR,CHE,2007.0,1,1,0
KOR,IRL,2006.0,2,1,1
QAT,JOR,2022.0,1,10,-9
YEM,GBR,2011.0,1,2,-1
ISR,VEN,2010.0,1,1,0
ARG,PRY,2010.0,1,1,0
JPN,NOR,2018.0,6,6,0
HKG,NZL,2007.0,1,4,-3
THA,ESP,2016.0,1,2,-1
NOR,AUT,2001.0,1,2,-1
PHL,NZL,2019.0,5,2,3
BMU,USA,2009.0,2,2,0
ESP,KEN,2020.0,1,4,-3
EGY,TWN,2018.0,2,2,0
KOR,UKR,2009.0,3,1,2
SWE,CHL,2021.0,1,5,-4
POL,IDN,2021.0,1,2,-1
LBY,IRQ,2003.0,1,1,0
THA,NOR,2021.0,1,1,0
JPN,OMN,2018.0,1,1,0
JAM,USA,2018.0,4,5,-1
MEX,UKR,2009.0,1,2,-1
POL,ISR,2002.0,1,3,-2
SYR,SAU,2013.0,2,2,0
VNM,NLD,2009.0,1,3,-2
GBR,MEX,1997.0,1,1,0
KOR,AUS,2000.0,1,1,0
SAU,FRA,1998.0,1,1,0
ARE,VNM,2020.0,1,1,0
MNG,JPN,2008.0,1,7,-6
CZE,PRT,2009.0,2,2,0
SRB,FIN,2010.0,1,1,0
FRA,SRB,2012.0,2,7,-5
SAU,MAR,2006.0,1,1,0
AFG,FRA,2020.0,1,2,-1
BEL,CIV,2010.0,1,1,0
GIN,FRA,2006.0,1,1,0
AUT,BIH,2015.0,1,3,-2
MEX,RUS,1997.0,1,3,-2
GBR,COG,2015.0,1,1,0
CAN,MWI,2017.0,1,2,-1
DEU,MCO,2022.0,1,1,0
AUS,WSM,2020.0,1,1,0
USA,BMU,2007.0,3,1,2
JPN,ZMB,2008.0,1,1,0
ESP,HUN,2008.0,2,2,0
KOR,CAN,1998.0,1,5,-4
PER,BEL,2003.0,1,1,0
EST,LTU,2018.0,2,1,1
COL,PAN,2014.0,2,2,0
DNK,EGY,2001.0,1,4,-3
ROU,BEL,2021.0,4,2,2
CZE,IRN,2010.0,1,2,-1
ETH,NGA,2007.0,1,2,-1
BRA,URY,2014.0,4,3,1
POL,SVK,1999.0,2,1,1
SGP,CZE,2016.0,1,1,0
TUR,MAR,2020.0,1,3,-2
PER,DEU,2011.0,1,2,-1
SVK,HUN,2017.0,3,9,-6
ITA,DZA,2009.0,3,1,2
ZAF,ARE,2017.0,1,2,-1
LKA,CHN,2011.0,1,3,-2
FIN,HKG,2018.0,2,3,-1
TZA,CHN,2014.0,1,1,0
TUR,IND,2004.0,1,4,-3
JOR,POL,2019.0,1,1,0
GBR,GTM,2021.0,1,1,0
GBR,MEX,1998.0,1,4,-3
HUN,SVN,2017.0,1,1,0
BLR,CHE,2018.0,2,1,1
PSE,DEU,2021.0,1,4,-3
GBR,TZA,1997.0,1,1,0
NLD,CZE,1997.0,1,1,0
AUS,PAN,2003.0,1,1,0
JPN,KAZ,2021.0,2,3,-1
LUX,USA,2014.0,3,6,-3
LBY,USA,2017.0,1,4,-3
CRI,BRA,2020.0,2,6,-4
PER,JPN,2013.0,1,3,-2
SWE,EST,2015.0,3,10,-7
HRV,NLD,2022.0,1,4,-3
BRA,BEN,2013.0,1,1,0
SRB,BRA,2012.0,1,1,0
USA,CRI,2000.0,2,2,0
AUS,LKA,2010.0,2,15,-13
LTU,CHE,2014.0,1,4,-3
CAN,PRI,2017.0,1,1,0
SWZ,ZAF,2007.0,1,1,0
AUS,HUN,2017.0,1,3,-2
QAT,OMN,2017.0,1,1,0
ETH,KOR,2016.0,5,5,0
ARE,DZA,2022.0,1,1,0
AUS,NGA,2006.0,2,2,0
GRC,ISR,2004.0,1,2,-1
CHE,UKR,2018.0,1,8,-7
PRI,ESP,2014.0,1,3,-2
PRI,CRI,2016.0,1,1,0
GHA,CHE,2016.0,1,4,-3
ARE,IRL,2020.0,2,2,0
CHL,BOL,2013.0,1,1,0
BIH,DEU,2019.0,2,1,1
PAK,NGA,2015.0,1,2,-1
CYP,ISR,2019.0,1,1,0
SWE,NIC,2005.0,1,2,-1
GBR,BIH,2016.0,1,1,0
NGA,EGY,2020.0,5,1,4
BLR,POL,2020.0,2,4,-2
KOR,TZA,2017.0,1,1,0
SRB,BEL,2015.0,1,6,-5
SVN,NLD,2021.0,1,3,-2
HRV,MKD,2007.0,1,1,0
SYR,CAN,2012.0,1,1,0
SAU,BRA,2018.0,1,1,0
ZAF,SDN,2010.0,1,2,-1
VEN,FRA,2017.0,3,1,2
BGR,POL,2005.0,1,1,0
MNG,USA,2011.0,1,1,0
CMR,CHE,2003.0,1,2,-1
ARE,JPN,2008.0,1,1,0
ESP,KAZ,2016.0,1,2,-1
NLD,ARE,2003.0,1,1,0
KHM,AUS,2018.0,1,5,-4
CAN,NPL,2016.0,1,1,0
AUS,HUN,2019.0,1,2,-1
PHL,DNK,2021.0,1,1,0
FRA,MYS,2009.0,2,3,-1
DEU,PHL,2002.0,1,3,-2
RUS,HUN,2009.0,2,4,-2
JAM,DEU,2008.0,1,1,0
UGA,DNK,2017.0,1,1,0
CRI,PAN,2022.0,1,1,0
GBR,FIN,1997.0,1,1,0
BFA,ITA,2013.0,1,2,-1
PRT,NOR,2002.0,1,2,-1
JOR,JPN,2016.0,1,2,-1
EGY,CZE,2011.0,1,2,-1
KOR,FRA,2000.0,1,5,-4
MDG,DEU,2016.0,1,2,-1
CZE,LUX,2022.0,1,1,0
JOR,PAK,2022.0,1,1,0
THA,LKA,2011.0,1,1,0
FRO,DNK,2013.0,1,1,0
BGR,NZL,2018.0,1,1,0
RUS,SYR,2021.0,2,1,1
KWT,PAK,2013.0,1,2,-1
VNM,SAU,2020.0,1,2,-1
AUS,DEU,2018.0,139,171,-32
ITA,CHE,2016.0,282,96,186
DEU,MYS,2007.0,3,5,-2
CHN,CAN,2010.0,199,160,39
ITA,GBR,2006.0,182,195,-13
CUB,MEX,2004.0,10,13,-3
BEL,CAN,2014.0,42,35,7
CHN,USA,2021.0,1973,2747,-774
SAU,EGY,2007.0,54,77,-23
ARG,GBR,2018.0,13,14,-1
AUT,DEU,2018.0,298,349,-51
USA,EGY,2018.0,113,112,1
USA,JPN,2001.0,785,961,-176
IRL,USA,2019.0,145,113,32
DNK,CZE,2017.0,5,4,1
CMR,ZAF,2020.0,5,10,-5
HUN,GBR,2016.0,34,17,17
MTQ,FRA,2015.0,21,19,2
SGP,CHN,2007.0,92,103,-11
GHA,DEU,2016.0,8,8,0
ZAF,SDN,2019.0,6,1,5
AUS,AUT,2022.0,7,7,0
CRI,ARG,2014.0,3,1,2
USA,BEL,2002.0,106,158,-52
PHL,JPN,2017.0,25,14,11
BEL,BGR,2018.0,2,1,1
VNM,JPN,2019.0,30,71,-41
PHL,JPN,2019.0,25,23,2
NGA,GBR,2021.0,50,39,11
ZAF,IND,2011.0,10,28,-18
USA,HUN,2008.0,64,57,7
PAK,USA,2017.0,122,73,49
HKG,CHN,2003.0,169,146,23
USA,NGA,2010.0,20,18,2
MEX,COL,2012.0,18,17,1
BRA,ESP,2011.0,49,65,-16
FRA,KHM,2013.0,4,3,1
DEU,THA,2014.0,20,21,-1
MEX,GBR,2013.0,35,48,-13
KOR,CHN,2005.0,42,41,1
PSE,TUR,2015.0,1,2,-1
SWE,BEL,2010.0,16,8,8
CHE,NER,2014.0,1,1,0
PAK,KOR,2005.0,2,1,1
EGY,PRT,2015.0,2,1,1
COG,BEL,2018.0,5,10,-5
RWA,JPN,2019.0,1,1,0
CHN,PRT,2018.0,7,13,-6
IRN,PAK,2020.0,9,1,8
DEU,KOR,2021.0,54,55,-1
DEU,IRL,2011.0,30,44,-14
BEL,AUS,2004.0,7,8,-1
IND,BHR,2005.0,5,2,3
BRA,AUT,2022.0,5,3,2
CAN,BEL,2009.0,24,29,-5
RWA,USA,2022.0,5,1,4
POL,FRA,2010.0,35,29,6
ITA,BGR,2000.0,2,1,1
GBR,OMN,2004.0,5,2,3
IRL,ITA,2003.0,5,4,1
ARG,BEL,2012.0,4,3,1
TWN,FRA,2013.0,13,11,2
ZAF,IRL,2007.0,6,2,4
TTO,USA,2002.0,6,5,1
ITA,SVN,2009.0,2,2,0
NOR,CAN,2020.0,14,32,-18
KHM,USA,2012.0,2,2,0
FIN,TUR,2008.0,4,3,1
JPN,PHL,2018.0,13,21,-8
GBR,BGD,2007.0,11,8,3
POL,HUN,2010.0,2,2,0
POL,FRA,2017.0,24,23,1
AUT,PAK,2013.0,30,5,25
KEN,NLD,2011.0,2,9,-7
NOR,AUS,2017.0,11,25,-14
ETH,CAN,2012.0,1,2,-1
PER,CHL,2013.0,2,4,-2
CHL,MEX,2010.0,10,8,2
FRA,ISR,2021.0,22,15,7
SGP,MAC,2012.0,1,1,0
NPL,USA,2022.0,13,7,6
PRT,MEX,2021.0,1,1,0
ESP,SVK,2008.0,4,2,2
VEN,MEX,2000.0,4,3,1
SGP,IND,2007.0,23,32,-9
DEU,QAT,2020.0,11,2,9
PAK,CAN,2004.0,8,7,1
DEU,UKR,2009.0,22,24,-2
GBR,LKA,2020.0,21,17,4
CAN,CYP,2017.0,1,5,-4
BRA,DNK,2018.0,19,7,12
CHN,RUS,2004.0,5,11,-6
VEN,FRA,2019.0,2,2,0
NAM,USA,2022.0,1,1,0
ESP,JOR,2021.0,1,2,-1
NCL,FRA,2003.0,7,12,-5
EGY,USA,2000.0,16,16,0
KOR,CAN,1997.0,1,3,-2
GMB,BEL,2012.0,2,1,1
ZWE,GBR,2008.0,4,1,3
MYS,OMN,2010.0,5,1,4
LBN,FRA,2007.0,14,24,-10
SVN,SGP,2017.0,1,1,0
NZL,THA,2015.0,2,5,-3
KAZ,DEU,2015.0,1,2,-1
CHN,MYS,2021.0,23,32,-9
JPN,IRN,2017.0,17,19,-2
LBY,GBR,2022.0,2,3,-1
SGP,MYS,2001.0,1,2,-1
USA,BOL,2009.0,2,3,-1
LKA,GBR,2012.0,7,8,-1
PHL,JPN,2010.0,7,21,-14
LTU,EST,2018.0,1,2,-1
UGA,ZAF,2019.0,5,10,-5
KOR,PER,2017.0,1,1,0
POL,ISL,2018.0,1,2,-1
NZL,DNK,2008.0,4,8,-4
UZB,CAN,2020.0,1,1,0
EST,SWE,1999.0,2,2,0
POL,NOR,2013.0,7,6,1
USA,ASM,2006.0,2,1,1
MEX,AUT,2001.0,1,1,0
USA,BHR,2006.0,3,3,0
SAU,BGD,2012.0,4,4,0
GBR,FIN,1998.0,5,6,-1
COL,PRI,2011.0,1,5,-4
IRL,NOR,2011.0,2,2,0
NLD,ROU,2001.0,1,3,-2
ARE,KOR,2015.0,2,5,-3
FRA,IRQ,2022.0,2,3,-1
POL,MYS,2017.0,1,1,0
CUB,ITA,2009.0,2,1,1
BIH,USA,2007.0,3,3,0
SGP,TWN,2001.0,2,2,0
NOR,ETH,2007.0,2,3,-1
THA,ITA,2013.0,2,3,-1
CHE,ARG,2022.0,2,7,-5
MKD,SRB,2019.0,6,5,1
KEN,TZA,2004.0,2,1,1
USA,NPL,2001.0,1,6,-5
NPL,JPN,2012.0,3,7,-4
NLD,THA,2011.0,5,7,-2
GBR,JAM,2012.0,6,1,5
SGP,THA,2009.0,2,5,-3
SGP,PHL,2000.0,1,2,-1
COL,SWE,2012.0,1,2,-1
KOR,TZA,2019.0,3,1,2
SVN,FIN,2002.0,2,1,1
UKR,BLR,2012.0,1,1,0
ESP,VEN,1999.0,4,2,2
BRA,CUB,2004.0,2,8,-6
MEX,RUS,1998.0,4,9,-5
PHL,BGD,2012.0,1,3,-2
SVK,HUN,2010.0,1,5,-4
BEL,COG,2004.0,2,1,1
CHE,KHM,2011.0,1,2,-1
BGD,EGY,2021.0,3,1,2
ETH,SAU,2019.0,1,1,0
ETH,DEU,2018.0,2,9,-7
UGA,ZAF,2017.0,4,10,-6
POL,MYS,2019.0,1,2,-1
FIN,AUS,2022.0,1,10,-9
BEL,PER,2013.0,2,3,-1
SDN,USA,2004.0,3,1,2
DNK,GRL,2012.0,2,3,-1
BFA,SWE,2009.0,1,1,0
LUX,DEU,2007.0,1,17,-16
SRB,UKR,2014.0,1,1,0
LTU,JPN,2019.0,2,1,1
BGD,DNK,2019.0,1,2,-1
UGA,JPN,2018.0,1,2,-1
BWA,CAN,2014.0,2,1,1
ITA,KEN,2003.0,1,1,0
PAK,FRA,1999.0,2,1,1
NZL,PRT,2012.0,1,1,0
KEN,SWE,2004.0,1,1,0
JPN,JOR,2021.0,1,2,-1
MWI,TWN,2010.0,1,1,0
FRA,,2024.0,93350,0,93350
,DEU,2000.0,21714,0,21714
RUS,,2023.0,57355,0,57355
,HKG,2004.0,1340,0,1340
CHN,,2021.0,155568,0,155568
NLD,,2014.0,3405,0,3405
SWE,,2021.0,5515,0,5515
IND,,2021.0,32140,0,32140
GBR,,2023.0,78929,0,78929
JPN,,2008.0,17205,0,17205
POL,,2023.0,25965,0,25965
,ISR,2004.0,2465,0,2465
,CHE,1999.0,5085,0,5085
CZE,,2015.0,1529,0,1529
,ITA,2000.0,15871,0,15871
,IND,2010.0,28051,0,28051
ITA,,2020.0,14204,0,14204
VEN,,2022.0,668,0,668
SRB,,2019.0,996,0,996
DEU,,2005.0,7959,0,7959
DNK,,2006.0,689,0,689
,BLR,2002.0,276,0,276
HRV,,2011.0,407,0,407
TWN,,2015.0,6173,0,6173
DEU,,2002.0,2585,0,2585
,LTU,1999.0,263,0,263
SRB,,2017.0,678,0,678
,ISL,2004.0,129,0,129
CUB,,2015.0,609,0,609
,CHL,2007.0,1685,0,1685
SRB,,2010.0,204,0,204
,ESP,2010.0,14564,0,14564
COL,,2019.0,1476,0,1476
,PER,2003.0,228,0,228
EGY,,2009.0,362,0,362
,AUS,2009.0,8363,0,8363
VUT,,2018.0,4,0,4
BEL,,2011.0,1617,0,1617
,ISR,1996.0,1251,0,1251
BGR,,2013.0,243,0,243
COL,,2010.0,220,0,220
DZA,,2014.0,204,0,204
,SWE,2014.0,3532,0,3532
,IND,2017.0,31712,0,31712
,BGD,2004.0,480,0,480
NPL,,2014.0,86,0,86
MAC,,2024.0,1149,0,1149
BFA,,2010.0,29,0,29
,BRN,2006.0,12,0,12
,MAR,2009.0,855,0,855
,KHM,2002.0,25,0,25
,DZA,2001.0,452,0,452
ROU,,2009.0,323,0,323
,SVN,2009.0,754,0,754
COL,,2017.0,810,0,810
,ZMB,1996.0,13,0,13
,HKG,1996.0,645,0,645
,ZMB,2004.0,40,0,40
,KEN,2000.0,263,0,263
PNG,COL,2011.0,1,0,1
,MEX,2008.0,3810,0,3810
,SAU,2005.0,506,0,506
LVA,,2015.0,119,0,119
BFA,,2019.0,94,0,94
,BLR,2005.0,240,0,240
,IND,2019.0,18767,0,18767
AUS,TWN,2000.0,3,0,3
AZE,,2011.0,64,0,64
,UGA,1999.0,105,0,105
,FRA,2015.0,13323,0,13323
,PRI,2003.0,126,0,126
,BGR,2007.0,580,0,580
,SAU,2002.0,472,0,472
,JAM,2016.0,29,0,29
,SGP,2009.0,2036,0,2036
,IRQ,2016.0,3178,0,3178
,NGA,2016.0,2161,0,2161
,KGZ,2014.0,57,0,57
,ESP,2017.0,13041,0,13041
,TGO,2010.0,39,0,39
,SRB,2013.0,1120,0,1120
ZAF,CZE,2020.0,4,0,4
GNQ,USA,2018.0,2,0,2
,ECU,2011.0,163,0,163
,MWI,2011.0,98,0,98
BRN,,2014.0,9,0,9
JPN,TZA,2020.0,2,0,2
,CMR,2016.0,436,0,436
,EST,2009.0,374,0,374
BGD,DNK,2017.0,4,0,4
LBR,,2023.0,52,0,52
,ESP,2019.0,7452,0,7452
BFA,,2017.0,82,0,82
CIV,CHE,2006.0,1,0,1
,GNQ,2011.0,2,0,2
,ROU,2018.0,1521,0,1521
MRT,,2023.0,54,0,54
UGA,RWA,2016.0,1,0,1
KOR,PER,2019.0,1,0,1
,IRL,2015.0,1644,0,1644
,CRI,2011.0,110,0,110
,MKD,2012.0,191,0,191
JAM,,2023.0,181,0,181
,BGD,1996.0,99,0,99
,SYR,2013.0,111,0,111
MKD,,2018.0,114,0,114
,NPL,2013.0,319,0,319
,PNG,2014.0,27,0,27
,KHM,2005.0,43,0,43
CMR,,2011.0,70,0,70
PSE,,2020.0,88,0,88
CMR,NOR,2018.0,2,0,2
SAU,FIN,2020.0,5,0,5
NGA,OMN,2021.0,1,0,1
,ERI,2015.0,17,0,17
ARE,ISL,2020.0,1,0,1
,GEO,1995.0,115,0,115
ZWE,MYS,2020.0,1,0,1
,LAO,2018.0,20,0,20
REU,,2023.0,8,0,8
,BHR,2018.0,85,0,85
CZE,MNG,2015.0,1,0,1
GEO,,2012.0,53,0,53
TGO,,2019.0,51,0,51
,FSM,2008.0,2,0,2
TGO,,2017.0,31,0,31
SAU,BRN,2022.0,2,0,2
URY,,2012.0,68,0,68
DEU,PAN,2007.0,1,0,1
NZL,NOR,2012.0,6,0,6
ERI,AUS,2020.0,1,0,1
PRY,,2013.0,9,0,9
TTO,,2018.0,36,0,36
BGD,PRT,2017.0,2,0,2
DEU,MAC,2014.0,1,0,1
ERI,,2022.0,15,0,15
CMR,GAB,2021.0,1,0,1
SYR,DEU,1997.0,1,0,1
MMR,,2017.0,20,0,20
,COD,2012.0,17,0,17
CIV,,2008.0,31,0,31
TCD,,2011.0,2,0,2
PRI,AUS,2021.0,1,0,1
,ARE,2003.0,120,0,120
UZB,SWE,2017.0,1,0,1
FRA,SYR,2011.0,18,0,18
ISR,,2001.0,46,0,46
NGA,THA,2017.0,3,0,3
,LUX,1998.0,36,0,36
,AND,2001.0,3,0,3
CUB,BEL,2013.0,2,0,2
BHR,IRQ,2012.0,1,0,1
IND,MMR,2006.0,1,0,1
MMR,,2019.0,33,0,33
KWT,,2004.0,51,0,51
,REU,1999.0,3,0,3
TZA,,2013.0,78,0,78
USA,MLI,2003.0,5,0,5
HUN,QAT,2012.0,2,0,2
FRA,GLP,1998.0,4,0,4
,ISL,1996.0,56,0,56
ZAF,DNK,2000.0,3,0,3
IND,PER,2001.0,1,0,1
NLD,CZE,1998.0,2,0,2
HRV,SVN,2005.0,3,0,3
LKA,POL,1998.0,1,0,1
BFA,GMB,2006.0,1,0,1
UKR,PRT,2000.0,3,0,3
AFG,ZWE,2010.0,1,0,1
FJI,FRA,2018.0,1,0,1
KWT,DEU,2001.0,2,0,2
CHL,,1999.0,18,0,18
FRA,HRV,1997.0,2,0,2
URY,GBR,2008.0,2,0,2
ITA,SVK,1998.0,3,0,3
FIN,LTU,2014.0,4,0,4
,LUX,1997.0,3,0,3
ESP,IDN,2017.0,1,0,1
PHL,MEX,2011.0,1,0,1
SVK,UKR,2011.0,1,0,1
UGA,CHE,2007.0,1,0,1
LIE,,2015.0,5,0,5
COL,DNK,2004.0,1,0,1
CAN,CYP,2010.0,4,0,4
TJK,,2016.0,9,0,9
UKR,AUS,2005.0,3,0,3
JOR,NPL,2009.0,1,0,1
MMR,,2010.0,7,0,7
,GTM,2008.0,29,0,29
ARE,BHR,2002.0,1,0,1
MYS,MDV,2019.0,2,0,2
SAU,IRQ,2011.0,1,0,1
TJK,RUS,2014.0,4,0,4
SDN,KOR,2014.0,2,0,2
GLP,,2016.0,14,0,14
IND,ARG,2006.0,1,0,1
FIN,TZA,2018.0,1,0,1
,FLK,2010.0,4,0,4
GUF,,2019.0,12,0,12
HUN,SGP,2016.0,4,0,4
NER,MOZ,2014.0,1,0,1
GBR,SLB,2017.0,1,0,1
AUT,ALB,2019.0,1,0,1
FJI,CHL,2016.0,1,0,1
RUS,KWT,2017.0,2,0,2
NPL,IRL,2016.0,1,0,1
NGA,GLP,2006.0,1,0,1
SYR,RUS,2020.0,1,0,1
TUN,DEU,2020.0,10,0,10
ERI,ETH,2020.0,1,0,1
,WSM,2017.0,7,0,7
,TGO,2017.0,37,0,37
ROU,KOR,2014.0,1,0,1
DJI,,2024.0,18,0,18
GNB,,2017.0,4,0,4
AUS,ISL,2018.0,3,0,3
,GAB,2018.0,23,0,23
FSM,,2007.0,3,0,3
HUN,TUR,2005.0,2,0,2
LBR,GBR,2022.0,1,0,1
MYS,SOM,2016.0,1,0,1
GRC,IRQ,2015.0,1,0,1
BGD,DNK,2010.0,2,0,2
BEL,LKA,2017.0,1,0,1
TGO,KEN,2017.0,1,0,1
THA,LTU,2016.0,1,0,1
TUR,TUN,2020.0,1,0,1
FRA,WLF,2017.0,1,0,1
ALB,AUS,2007.0,1,0,1
NIC,GBR,2021.0,1,0,1
EGY,LBY,2005.0,2,0,2
ISL,FIN,2006.0,1,0,1
ZWE,,2004.0,15,0,15
JOR,QAT,2001.0,3,0,3
KEN,IDN,2004.0,1,0,1
ECU,CAN,2003.0,4,0,4
PAN,CHE,2003.0,1,0,1
FRA,GLP,1997.0,3,0,3
BEL,VNM,2007.0,2,0,2
SVN,FIN,2005.0,1,0,1
SWE,CRI,2011.0,1,0,1
NGA,IRN,2005.0,1,0,1
ISR,THA,2014.0,1,0,1
AUS,TUR,1999.0,1,0,1
EGY,PNG,2001.0,2,0,2
NGA,ARG,2012.0,1,0,1
GBR,FRO,2003.0,1,0,1
BEL,SUR,2014.0,2,0,2
AUS,ETH,2008.0,1,0,1
GNQ,ECU,2006.0,1,0,1
COL,CUB,2003.0,1,0,1
ERI,USA,2007.0,1,0,1
,TON,2002.0,3,0,3
RUS,IRQ,2012.0,3,0,3
TUR,MEX,2013.0,3,0,3
GNB,,2010.0,3,0,3
PHL,,2025.0,5,0,5
NPL,CHE,2012.0,2,0,2
SWE,BFA,2011.0,1,0,1
,AFG,2004.0,2,0,2
MLI,GBR,2015.0,3,0,3
UGA,SDN,2011.0,1,0,1
URY,CAN,2018.0,1,0,1
,PYF,2008.0,7,0,7
GBR,BHR,2000.0,4,0,4
FRA,BGR,1997.0,2,0,2
POL,BEL,2000.0,3,0,3
SVN,SGP,2019.0,1,0,1
GHA,HUN,2017.0,1,0,1
HRV,LUX,2016.0,1,0,1
KEN,SEN,2020.0,1,0,1
LSO,CHE,2015.0,2,0,2
POL,CHL,2022.0,2,0,2
IRL,,2001.0,17,0,17
GUY,,2024.0,15,0,15
FIN,MAC,2018.0,1,0,1
PAK,BRN,2022.0,1,0,1
TZA,ETH,2005.0,1,0,1
JOR,CMR,2017.0,1,0,1
HUN,HKG,2001.0,1,0,1
CHN,BRA,1998.0,1,0,1
NOR,PHL,2018.0,1,0,1
GAB,TWN,2012.0,1,0,1
LBN,BEL,2010.0,2,0,2
MYS,MEX,2020.0,1,0,1
TZA,KOR,2011.0,1,0,1
TUR,TZA,2017.0,1,0,1
GUF,,2017.0,6,0,6
GBR,KNA,2020.0,1,0,1
SWE,COL,2016.0,4,0,4
PAK,IRN,2002.0,1,0,1
USA,TGO,2013.0,1,0,1
GRD,,2013.0,8,0,8
JOR,IRQ,2001.0,2,0,2
NLD,AFG,2014.0,2,0,2
BEL,CUB,2021.0,2,0,2
CHE,LUX,2022.0,2,0,2
,WSM,2019.0,5,0,5
IRN,CHL,2022.0,1,0,1
SDN,GBR,2001.0,4,0,4
BGD,PRT,2010.0,2,0,2
GTM,GBR,2003.0,1,0,1
EGY,NOR,2019.0,2,0,2
MCO,,2012.0,7,0,7
MKD,POL,2002.0,2,0,2
USA,MNE,2008.0,1,0,1
TGO,,2010.0,7,0,7
BEL,BIH,2019.0,1,0,1
BEL,EGY,2002.0,4,0,4
MYS,ECU,2016.0,1,0,1
NLD,LBN,2002.0,1,0,1
CHN,DZA,2004.0,1,0,1
DNK,ARG,2006.0,1,0,1
SAU,NLD,2000.0,1,0,1
TUN,CIV,2007.0,2,0,2
AUT,KEN,2002.0,1,0,1
EGY,UZB,2012.0,1,0,1
LUX,PRT,2010.0,1,0,1
PRI,COL,2009.0,3,0,3
HKG,IRL,2007.0,3,0,3
GBR,TZA,1998.0,4,0,4
UGA,NGA,2015.0,6,0,6
SWE,BLR,2006.0,2,0,2
DEU,PRI,2016.0,2,0,2
CRI,CAN,2007.0,2,0,2
AZE,TWN,2013.0,1,0,1
PAK,IRL,2007.0,3,0,3
AUS,GUY,2005.0,1,0,1
LBN,ETH,2021.0,1,0,1
SGP,BRA,2010.0,2,0,2
SRB,IRL,2005.0,1,0,1
PSE,BEL,2009.0,1,0,1
MNG,AUS,2016.0,1,0,1
BEN,TGO,2020.0,4,0,4
TTO,LCA,2016.0,1,0,1
ROU,THA,2017.0,2,0,2
NZL,COL,2022.0,2,0,2
CYP,LBN,2012.0,1,0,1
HKG,NGA,1999.0,1,0,1
IRQ,BRN,2019.0,1,0,1
ZWE,NAM,2018.0,1,0,1
PAK,LBN,2004.0,1,0,1
DOM,DMA,2021.0,1,0,1
TON,,2024.0,5,0,5
GUF,,2010.0,6,0,6
BRA,VNM,2019.0,1,0,1
HKG,ESP,2012.0,1,0,1
THA,OMN,2013.0,3,0,3
,BMU,2007.0,2,0,2
KOR,HUN,2021.0,1,0,1
UKR,MDA,2016.0,1,0,1
AUS,CRI,2020.0,3,0,3
ITA,MAR,1997.0,1,0,1
ZMB,THA,2013.0,1,0,1
MYS,LKA,2015.0,3,0,3
THA,KHM,2012.0,1,0,1
ARE,ARG,2020.0,1,0,1
CAN,PRI,2010.0,1,0,1
ITA,MAR,1998.0,1,0,1
BGR,IRL,2013.0,2,0,2
USA,MLT,2020.0,2,0,2
,HND,2004.0,4,0,4
ZWE,BEL,2003.0,1,0,1
ALB,GBR,2004.0,1,0,1
KOR,ZAF,2007.0,1,0,1
GNQ,,2012.0,1,0,1
RUS,GRC,2011.0,2,0,2
TZA,MWI,2008.0,1,0,1
BRA,IRN,2009.0,1,0,1
ZAF,ARE,2010.0,2,0,2
ISR,PER,2018.0,2,0,2
FIN,JAM,2006.0,1,0,1
GHA,BGR,2010.0,2,0,2
BTN,GBR,2021.0,2,0,2
ARM,MEX,1997.0,1,0,1
UKR,SRB,2020.0,1,0,1
MDG,SAU,2013.0,1,0,1
NER,MDG,2014.0,1,0,1
JPN,UGA,2019.0,3,0,3
MAC,JPN,2014.0,1,0,1
LUX,PRT,2017.0,2,0,2
ITA,HTI,2018.0,1,0,1
IRN,THA,2015.0,2,0,2
RUS,ISR,2014.0,11,0,11
CHN,ZMB,2019.0,3,0,3
NZL,SLB,2014.0,1,0,1
SLE,NOR,2021.0,1,0,1
GEO,FIN,2022.0,1,0,1
IRN,JOR,2008.0,1,0,1
HUN,SVN,2019.0,4,0,4
UGA,CHN,2002.0,1,0,1
GNB,,2019.0,7,0,7
,PAN,1995.0,7,0,7
ETH,LSO,2000.0,1,0,1
BRN,NZL,2002.0,1,0,1
MUS,BEL,2004.0,1,0,1
CAN,BLR,2014.0,1,0,1
UKR,AUS,2002.0,1,0,1
ZMB,DNK,1999.0,1,0,1
AUT,BGR,2011.0,1,0,1
NGA,GHA,2002.0,1,0,1
,FRO,2009.0,4,0,4
MEX,CHN,2007.0,2,0,2
CUB,AGO,2004.0,2,0,2
SYR,IRQ,2018.0,2,0,2
DNK,CZE,2010.0,2,0,2
GMB,MWI,2012.0,1,0,1
AUT,ALB,2017.0,1,0,1
TUN,LBN,2015.0,1,0,1
BRA,SVN,2019.0,3,0,3
CHN,BRA,1997.0,1,0,1
ROU,LBN,2022.0,1,0,1
HUN,BEL,2000.0,4,0,4
UGA,USA,1999.0,2,0,2
COL,VNM,2018.0,2,0,2
OMN,SDN,2022.0,1,0,1
ROU,GRC,2022.0,2,0,2
SYR,YEM,2011.0,1,0,1
ARE,NOR,2007.0,1,0,1
CMR,CIV,2022.0,1,0,1
BWA,NLD,2007.0,1,0,1
PRY,DEU,2016.0,1,0,1
USA,GRL,2018.0,3,0,3
NLD,LKA,2009.0,1,0,1
FRA,HRV,1998.0,1,0,1
MKD,ALB,2017.0,1,0,1
ITA,EST,2003.0,1,0,1
POL,LUX,2019.0,2,0,2
BEL,ARE,2007.0,1,0,1
USA,URY,1998.0,1,0,1
SVK,GRC,2010.0,1,0,1
TUR,EST,2014.0,2,0,2
NGA,BEN,2005.0,1,0,1
MTQ,CRI,2000.0,1,0,1
NLD,HRV,2007.0,2,0,2
HKG,SWE,2003.0,2,0,2
ROU,CAN,1999.0,2,0,2
SGP,PAK,2005.0,1,0,1
NCL,NZL,2011.0,1,0,1
USA,BHS,2009.0,1,0,1
SWE,BRN,2015.0,1,0,1
NLD,PAK,2003.0,1,0,1
MDA,BEL,2008.0,1,0,1
COL,KHM,2018.0,1,0,1
PAN,DEU,2020.0,3,0,3
CYP,BEL,2018.0,2,0,2
BIH,NOR,2013.0,2,0,2
ITA,URY,2001.0,1,0,1
TKM,,2019.0,2,0,2
MDG,NER,2003.0,1,0,1
VCT,,2023.0,2,0,2
MNE,ARE,2019.0,2,0,2
KEN,COG,2018.0,1,0,1
GTM,DOM,2013.0,1,0,1
USA,BEN,2014.0,1,0,1
IND,TTO,2005.0,2,0,2
EGY,NZL,2003.0,1,0,1
GRC,MNE,2004.0,1,0,1
GIN,,2009.0,4,0,4
OMN,NZL,2020.0,2,0,2
SRB,CHN,2021.0,1,0,1
THA,ZAF,2013.0,1,0,1
BGR,MYS,2013.0,1,0,1
DZA,TUN,2002.0,1,0,1
TUR,ZAF,2011.0,1,0,1
NIC,SWE,2013.0,1,0,1
DNK,GHA,2021.0,3,0,3
YEM,DEU,2004.0,1,0,1
ARG,KOR,2009.0,1,0,1
ISR,LUX,2016.0,1,0,1
COD,,2013.0,3,0,3
GNB,GBR,2003.0,1,0,1
CAN,VNM,2007.0,1,0,1
FRA,MWI,2007.0,1,0,1
USA,MNG,2009.0,1,0,1
ECU,MEX,2006.0,2,0,2
NLD,PHL,2006.0,2,0,2
BHR,,2003.0,5,0,5
UGA,SGP,2020.0,1,0,1
POL,COD,2018.0,1,0,1
NOR,TZA,2014.0,4,0,4
SGP,LKA,2014.0,4,0,4
SVN,UKR,2018.0,1,0,1
USA,COG,2000.0,1,0,1
ZAF,PSE,2016.0,1,0,1
MKD,AUT,2014.0,1,0,1
OMN,BHR,2003.0,1,0,1
AUS,BRB,2022.0,1,0,1
JPN,ZWE,2019.0,1,0,1
UKR,EST,2020.0,1,0,1
NCL,GLP,2018.0,1,0,1
DZA,QAT,2021.0,2,0,2
TTO,CHN,2015.0,2,0,2
PAK,MEX,2019.0,1,0,1
VNM,HUN,2022.0,3,0,3
DEU,SDN,2021.0,1,0,1
,TGO,2019.0,21,0,21
TWN,POL,2011.0,2,0,2
USA,NER,2013.0,1,0,1
ERI,THA,2021.0,1,0,1
AUT,GAB,2017.0,1,0,1
NZL,SLE,2019.0,1,0,1
,GIB,2005.0,4,0,4
JPN,MMR,2004.0,1,0,1
UGA,LBN,2016.0,1,0,1
ROU,HRV,2015.0,1,0,1
VNM,CUB,2012.0,1,0,1
BGD,KAZ,2011.0,1,0,1
FRA,OMN,2011.0,2,0,2
BLZ,GBR,2014.0,1,0,1
CHN,PSE,2020.0,1,0,1
GBR,GRD,2002.0,1,0,1
TUN,AUT,2006.0,1,0,1
HRV,CHL,2021.0,1,0,1
MEX,THA,2014.0,1,0,1
TWN,ISR,2010.0,1,0,1
ETH,SWZ,2019.0,1,0,1
ESP,MCO,2018.0,1,0,1
BEL,EST,2011.0,2,0,2
AUS,NCL,2009.0,2,0,2
TUR,SVN,2002.0,2,0,2
SRB,NZL,2006.0,1,0,1
CAN,SEN,2010.0,1,0,1
PER,BRA,2005.0,1,0,1
ZAF,RWA,2012.0,1,0,1
DEU,MNE,2020.0,1,0,1
IDN,COL,2008.0,1,0,1
ISR,TUR,2013.0,2,0,2
ARM,FRA,2016.0,3,0,3
PRT,URY,2017.0,1,0,1
PNG,KOR,2018.0,1,0,1
SYC,ITA,2018.0,1,0,1
CAN,PRI,2019.0,1,0,1
IND,IRQ,2006.0,1,0,1
CHL,LIE,2013.0,1,0,1
ARE,ZAF,2002.0,1,0,1
BLR,ARM,2015.0,1,0,1
PRT,NOR,2005.0,1,0,1
NOR,TWN,1998.0,1,0,1
BLR,KAZ,2006.0,1,0,1
JPN,UGA,2010.0,1,0,1
ROU,MDG,2002.0,1,0,1
NPL,NOR,2022.0,1,0,1
TGO,CAN,2006.0,1,0,1
HKG,TUR,2013.0,1,0,1
SLE,IND,2021.0,1,0,1
,SSD,2009.0,1,0,1
ARE,ROU,2018.0,1,0,1
NGA,BGR,2004.0,1,0,1
CMR,AUT,2020.0,1,0,1
,HND,1996.0,4,0,4
POL,LUX,2017.0,1,0,1
GMB,LBR,2022.0,1,0,1
GBR,MKD,2005.0,3,0,3
LTU,NOR,2001.0,2,0,2
GBR,IRQ,2001.0,2,0,2
TWN,PRT,2013.0,1,0,1
GLP,DEU,2007.0,1,0,1
KHM,CHE,2022.0,1,0,1
GMB,CHE,2001.0,1,0,1
MOZ,NLD,2014.0,2,0,2
SAU,LBY,2001.0,1,0,1
SGP,LUX,2014.0,2,0,2
KHM,SWE,2018.0,1,0,1
IND,BHR,2002.0,3,0,3
COL,CHN,2018.0,2,0,2
TTO,NGA,2014.0,1,0,1
KOR,KEN,2007.0,1,0,1
MKD,ALB,2019.0,1,0,1
PRT,MAC,1997.0,1,0,1
ZMB,ZAF,2008.0,2,0,2
ZAF,CHL,2012.0,2,0,2
IND,TTO,2002.0,1,0,1
SLV,MEX,2007.0,1,0,1
LAO,JPN,1999.0,1,0,1
PYF,DNK,2010.0,1,0,1
ROU,JPN,2022.0,2,0,2
EGY,IND,1997.0,1,0,1
TWN,NIC,2019.0,1,0,1
TGO,KEN,2019.0,1,0,1
KOR,MEX,2002.0,1,0,1
IND,CMR,2015.0,1,0,1
MWI,GHA,2011.0,1,0,1
BFA,CHE,2019.0,3,0,3
NLD,LBN,2005.0,1,0,1
PRT,LUX,2016.0,2,0,2
ARG,PRY,2019.0,2,0,2
MAC,BRA,2020.0,1,0,1
KAZ,ITA,2022.0,2,0,2
ESP,PHL,2013.0,1,0,1
CHE,GUY,2018.0,1,0,1
LBY,USA,2010.0,2,0,2
ITA,COL,2000.0,1,0,1
SVK,IRQ,2014.0,1,0,1
CUB,PER,2000.0,1,0,1
ESP,DZA,2000.0,1,0,1
MEX,BGR,2016.0,1,0,1
NGA,GHA,2005.0,1,0,1
LTU,CZE,2002.0,2,0,2
ISR,COL,2006.0,2,0,2
USA,CIV,2000.0,1,0,1
BRA,NOR,2000.0,1,0,1
BLZ,USA,2001.0,1,0,1
AUS,GEO,2000.0,1,0,1
FJI,NZL,2009.0,1,0,1
SGP,PAK,2002.0,1,0,1
TTO,JAM,2012.0,1,0,1
GBR,BMU,2014.0,1,0,1
CHN,LKA,2012.0,1,0,1
LVA,NOR,2011.0,1,0,1
NGA,MYS,2008.0,2,0,2
COD,USA,2014.0,1,0,1
ETH,PRT,2012.0,1,0,1
SDN,SWE,2006.0,1,0,1
BLR,LVA,2011.0,1,0,1
ALB,CAN,2003.0,1,0,1
AUS,MCO,2012.0,1,0,1
EGY,KAZ,2020.0,1,0,1
SWE,ZMB,2013.0,1,0,1
TWN,ESP,2003.0,1,0,1
EGY,NOR,2010.0,1,0,1
ESP,CYP,2012.0,1,0,1
GBR,PYF,2016.0,1,0,1
JAM,BHS,2011.0,1,0,1
PRI,PAN,2007.0,1,0,1
CHE,ECU,2014.0,2,0,2
DNK,SVN,2003.0,1,0,1
PHL,OMN,2013.0,1,0,1
JPN,PAN,2018.0,1,0,1
ZAF,POL,2018.0,1,0,1
CHE,BFA,2020.0,1,0,1
DEU,AFG,2020.0,1,0,1
CIV,GHA,2021.0,2,0,2
TGO,DEU,2012.0,2,0,2
FRA,SDN,2021.0,1,0,1
MYS,ARE,2001.0,1,0,1
THA,UKR,2016.0,1,0,1
ROU,KNA,2018.0,1,0,1
NOR,NIC,2012.0,1,0,1
ARG,SWE,2019.0,3,0,3
QAT,NGA,2019.0,1,0,1
PAN,CHN,2021.0,1,0,1
KEN,HUN,2019.0,1,0,1
ROU,CHE,2023.0,1,0,1
,RUS,2020.0,1,0,1
BGR,SRB,2007.0,1,0,1
COL,RUS,2015.0,1,0,1
MAR,TGO,2014.0,1,0,1
OMN,SWE,2013.0,1,0,1
TZA,CAN,2008.0,1,0,1
JPN,VEN,2018.0,1,0,1
COL,NZL,2021.0,1,0,1
KHM,MDG,2022.0,1,0,1
BEN,,2004.0,1,0,1
LKA,FRA,2018.0,1,0,1
SYR,KWT,2010.0,1,0,1
EST,GBR,1998.0,2,0,2
BEL,UGA,2001.0,1,0,1
ERI,SWE,2009.0,1,0,1
EGY,IND,1998.0,1,0,1
NGA,ZAF,2000.0,1,0,1
MEX,PAN,1999.0,1,0,1
LTU,GRC,2000.0,1,0,1
DEU,NER,2001.0,1,0,1
IRL,UKR,2005.0,1,0,1
GNB,GMB,1999.0,1,0,1
,VUT,2001.0,1,0,1
DJI,LUX,2010.0,1,0,1
SAU,FRA,1997.0,1,0,1
KHM,KOR,2011.0,1,0,1
CHN,URY,2022.0,1,0,1
IRN,AFG,2012.0,1,0,1
COD,BFA,2018.0,1,0,1
BFA,COG,2021.0,1,0,1
TWN,JOR,2021.0,1,0,1
URY,PER,2016.0,1,0,1
,BDI,2001.0,2,0,2
MWI,LUX,2003.0,1,0,1
BEL,CZE,2000.0,1,0,1
CYP,ISR,2017.0,1,0,1
LTU,KAZ,2019.0,1,0,1
GRC,PSE,2015.0,1,0,1
EGY,JOR,2005.0,1,0,1
EGY,IRL,1999.0,1,0,1
GRC,FIN,2001.0,1,0,1
BRA,LAO,2016.0,1,0,1
BRA,PRI,2013.0,1,0,1
TUR,IRQ,2011.0,1,0,1
DZA,IDN,2017.0,1,0,1
VEN,BEL,2021.0,1,0,1
KHM,NLD,2020.0,1,0,1
COM,CMR,2011.0,1,0,1
CPV,MEX,2015.0,1,0,1
NAM,GBR,2015.0,1,0,1
DEU,ZWE,2019.0,1,0,1
URY,BEL,2011.0,1,0,1
ROU,MKD,2017.0,1,0,1
JAM,ISR,2015.0,1,0,1
BEL,SDN,2012.0,1,0,1
BGD,FJI,2017.0,1,0,1
ETH,PAK,2018.0,1,0,1
MWI,TWN,2017.0,1,0,1
NLD,CRI,2008.0,1,0,1
ETH,CZE,2012.0,1,0,1
BEN,IRL,2021.0,1,0,1
IRQ,BHR,2020.0,1,0,1
TUR,LBN,2018.0,1,0,1
CZE,BRN,2010.0,1,0,1
CAN,ARE,2010.0,17,11,6
GBR,DEU,2017.0,647,699,-52
USA,DEU,2007.0,907,1131,-224
NLD,GBR,2013.0,216,226,-10
USA,IND,2020.0,723,1324,-601
GBR,SWE,2021.0,153,88,65
USA,PER,2004.0,17,21,-4
USA,ESP,2005.0,275,249,26
DEU,CHE,2017.0,632,422,210
ESP,CHE,2002.0,25,28,-3
AUS,CHL,2016.0,20,18,2
ISR,USA,2007.0,343,224,119
USA,BRA,2017.0,319,522,-203
CHE,FRA,2015.0,240,341,-101
GBR,DEU,2010.0,496,525,-29
USA,FJI,2016.0,2,1,1
DEU,EGY,2017.0,52,37,15
CZE,RUS,2010.0,3,10,-7
CHE,DEU,2022.0,188,241,-53
FRA,CAN,2011.0,300,245,55
RUS,USA,2011.0,139,122,17
BRA,POL,2012.0,27,5,22
USA,BRA,2019.0,329,633,-304
USA,BRA,2010.0,293,355,-62
JPN,CAN,2004.0,87,65,22
ZAF,CAN,2020.0,36,12,24
CUB,MEX,2015.0,26,4,22
ESP,AUT,2022.0,17,9,8
USA,JOR,2007.0,47,18,29
FRA,CHE,2008.0,232,202,30
SGP,AUS,2004.0,25,26,-1
ISR,NLD,2011.0,11,5,6
DEU,CHE,2010.0,558,387,171
ZAF,IRL,2008.0,4,2,2
ITA,SWE,2010.0,39,12,27
ESP,GBR,2016.0,502,243,259
PRT,USA,2015.0,65,57,8
FRA,ROU,2010.0,26,33,-7
CHE,POL,2019.0,18,24,-6
RUS,NLD,2004.0,17,9,8
DEU,BRA,2009.0,55,49,6
TWN,USA,2010.0,244,337,-93
IND,CHN,2007.0,11,8,3
UKR,RUS,2020.0,45,39,6
DEU,VNM,2019.0,25,4,21
VEN,ESP,2007.0,24,18,6
DZA,FRA,2015.0,30,89,-59
RUS,BEL,2013.0,6,4,2
TWN,USA,2017.0,269,207,62
NLD,ZWE,2011.0,2,3,-1
ZWE,ZAF,2013.0,14,19,-5
BRA,FRA,2005.0,62,63,-1
USA,KOR,2003.0,578,502,76
NLD,ESP,2019.0,60,76,-16
DEU,FRA,2000.0,95,73,22
ITA,CHN,2010.0,16,20,-4
ZWE,GBR,2007.0,4,1,3
CHN,KOR,2011.0,64,133,-69
CAN,IRL,2009.0,30,20,10
USA,ESP,2002.0,322,287,35
ESP,MEX,2020.0,142,137,5
FRA,PRT,2012.0,38,25,13
GBR,DEU,2019.0,710,664,46
HKG,AUS,2010.0,40,35,5
CAN,KOR,2012.0,27,35,-8
ARE,GBR,2016.0,23,34,-11
DEU,CHN,2021.0,415,319,96
IRL,GBR,2006.0,123,158,-35
NOR,FRA,2013.0,25,33,-8
ITA,SWE,2019.0,80,35,45
JPN,NLD,2015.0,16,15,1
IND,USA,2022.0,475,335,140
SGP,CHN,2008.0,117,121,-4
IND,SAU,2016.0,169,36,133
ESP,DEU,2018.0,246,172,74
GBR,TUR,2015.0,50,37,13
FRA,SWE,2021.0,85,45,40
COL,BRA,2014.0,44,24,20
DEU,AUS,2011.0,148,120,28
USA,MEX,2020.0,157,241,-84
BRA,IRL,2017.0,10,10,0
CHL,ESP,2016.0,60,129,-69
CHL,FRA,2018.0,36,34,2
GBR,NOR,2020.0,104,52,52
IND,BGD,2020.0,23,26,-3
ISR,DEU,2020.0,67,61,6
DEU,EGY,2010.0,33,26,7
ESP,AUS,2018.0,51,43,8
AUS,JOR,2018.0,10,4,6
IDN,AUT,2015.0,3,1,2
USA,LBN,2018.0,42,75,-33
KOR,PAK,2020.0,95,57,38
SGP,IND,2008.0,17,41,-24
CHN,DNK,2003.0,6,5,1
HKG,IND,2018.0,16,22,-6
CHL,CAN,2014.0,18,22,-4
SAU,IND,2020.0,41,138,-97
AUS,GBR,2022.0,202,222,-20
TWN,KOR,2020.0,10,13,-3
NLD,IRN,2020.0,11,47,-36
CAN,PAK,2016.0,23,22,1
IRN,CAN,2006.0,52,41,11
CHL,ARG,2015.0,28,19,9
UGA,GBR,2019.0,9,14,-5
SAU,AUS,2012.0,3,13,-10
GBR,BGD,2008.0,11,13,-2
OMN,CAN,2018.0,8,8,0
PAK,OMN,2015.0,9,6,3
FRA,ROU,2017.0,23,20,3
USA,ARG,2019.0,66,101,-35
GBR,NGA,2021.0,39,50,-11
AUS,MYS,2016.0,98,117,-19
ZAF,ITA,2020.0,13,3,10
THA,GBR,2016.0,36,89,-53
ITA,BEL,2021.0,71,65,6
GBR,KEN,2016.0,14,24,-10
ITA,CHN,2019.0,60,47,13
KEN,ZMB,2017.0,2,1,1
FIN,GBR,1999.0,15,11,4
TUR,ITA,2015.0,12,17,-5
DEU,ETH,2016.0,16,4,12
ITA,SWE,2017.0,82,35,47
QAT,EGY,2019.0,11,10,1
IRL,BGD,2021.0,2,1,1
CHN,BEL,2016.0,47,45,2
IND,CHE,2015.0,38,25,13
NLD,ITA,2022.0,36,55,-19
USA,MAR,2001.0,2,4,-2
CAN,ARE,2017.0,30,21,9
AUS,NLD,2020.0,59,77,-18
TUR,IRN,2017.0,13,37,-24
POL,USA,2002.0,142,84,58
GBR,HKG,2021.0,48,54,-6
CHN,ITA,2015.0,19,44,-25
IDN,BEL,2022.0,1,3,-2
MEX,PER,2019.0,4,4,0
ITA,IRN,2011.0,6,10,-4
USA,HUN,2007.0,61,55,6
JPN,VNM,2021.0,58,21,37
NOR,BIH,2019.0,1,1,0
VNM,KOR,2019.0,21,129,-108
MEX,FRA,2022.0,17,10,7
VNM,THA,2019.0,10,23,-13
KAZ,KGZ,2019.0,3,3,0
FRA,ROU,2019.0,23,17,6
SAU,SWE,2021.0,7,7,0
NZL,ZAF,2018.0,3,8,-5
ZAF,MYS,2019.0,3,2,1
GBR,ETH,2013.0,4,10,-6
KOR,SGP,2022.0,12,12,0
NLD,ESP,2010.0,72,61,11
EGY,ARE,2013.0,7,13,-6
BGD,IND,2005.0,7,10,-3
GBR,CZE,2021.0,45,26,19
CAN,AUS,2004.0,86,102,-16
USA,POL,2020.0,64,96,-32
IND,NOR,2022.0,8,4,4
ZAF,ZWE,2021.0,20,29,-9
KOR,UZB,2022.0,4,1,3
GRC,DEU,2003.0,28,28,0
FRA,NOR,2021.0,28,25,3
DEU,CHL,2004.0,5,8,-3
FRA,ITA,2000.0,90,57,33
SEN,ZAF,2009.0,2,1,1
DEU,EGY,2019.0,40,34,6
GRC,POL,2022.0,1,2,-1
IRQ,SAU,2021.0,2,2,0
ITA,CHN,2017.0,47,42,5
CZE,DEU,2004.0,31,19,12
GRC,CAN,2018.0,10,1,9
CHE,PRT,2021.0,12,9,3
CPV,PRT,2021.0,4,1,3
FRA,RUS,2021.0,22,42,-20
FRA,GUF,2014.0,12,24,-12
CHN,DEU,2018.0,395,417,-22
ITA,CZE,2012.0,4,3,1
THA,NPL,2014.0,5,2,3
MWI,FIN,2016.0,2,1,1
GBR,KOR,2022.0,30,38,-8
IRN,AUS,2022.0,47,12,35
DEU,MYS,2008.0,4,1,3
GBR,POL,2009.0,33,42,-9
AUS,BGR,2000.0,2,1,1
IND,DEU,2008.0,95,56,39
NLD,CHE,2011.0,63,43,20
GBR,CYP,2014.0,30,20,10
DEU,JPN,2013.0,106,115,-9
FRA,DNK,2009.0,26,23,3
GBR,MWI,2009.0,10,9,1
ZAF,GBR,2007.0,52,57,-5
GBR,BEL,2011.0,88,64,24
UGA,GBR,2017.0,7,11,-4
PAK,AUS,2011.0,26,7,19
FRA,MAR,2003.0,52,46,6
FRA,IDN,2017.0,10,3,7
ZAF,AUS,2012.0,43,20,23
CZE,RUS,2019.0,4,19,-15
CHE,AUT,2012.0,54,87,-33
CAN,KWT,2014.0,12,1,11
SWE,NZL,2016.0,4,11,-7
USA,ARG,2017.0,70,107,-37
DEU,BEL,2011.0,79,81,-2
PAK,NZL,2009.0,2,1,1
JPN,MYS,2012.0,56,25,31
GBR,NLD,2007.0,148,181,-33
ARG,BRA,2011.0,21,24,-3
DEU,ECU,2013.0,7,3,4
CHE,SGP,2017.0,15,17,-2
ESP,POL,2014.0,14,53,-39
CAN,QAT,2012.0,7,3,4
IND,IRL,2015.0,14,16,-2
GBR,BRN,2010.0,2,1,1
BEL,COG,2015.0,5,3,2
NLD,SWE,2002.0,21,32,-11
IND,TWN,2002.0,26,11,15
FRA,IRL,2014.0,23,38,-15
DEU,PSE,2020.0,6,4,2
MYS,PAK,2016.0,71,33,38
MYS,TWN,2016.0,5,9,-4
MEX,PER,2010.0,2,1,1
VNM,KOR,2017.0,22,69,-47
BRA,FIN,2017.0,7,4,3
FRA,FIN,2014.0,18,21,-3
SWE,IRL,2003.0,2,3,-1
DNK,DEU,2003.0,53,57,-4
CAN,ITA,1998.0,7,7,0
FRA,KOR,2005.0,11,5,6
KOR,QAT,2020.0,3,2,1
JPN,GBR,2004.0,81,95,-14
USA,SGP,2000.0,17,24,-7
SRB,CAN,2009.0,4,4,0
BRA,FRA,2002.0,52,71,-19
ESP,CHN,2003.0,3,4,-1
GBR,JPN,2006.0,92,96,-4
FRA,MEX,2000.0,20,7,13
TUN,ITA,2015.0,3,9,-6
BRA,SGP,2013.0,2,1,1
BEL,GBR,2006.0,77,58,19
ITA,FIN,2012.0,10,7,3
BRA,IRL,2019.0,19,2,17
IND,SWE,2000.0,5,1,4
NLD,ESP,2017.0,48,74,-26
NLD,BEL,2000.0,35,28,7
DNK,ITA,2013.0,20,45,-25
CHE,NLD,2015.0,66,85,-19
SVK,CZE,2017.0,41,63,-22
PRY,CHL,2019.0,1,2,-1
RUS,UKR,2009.0,27,26,1
CUB,ESP,2021.0,7,5,2
FRA,AUT,2002.0,15,13,2
CAN,ARE,2019.0,26,30,-4
ARE,IRN,2019.0,2,6,-4
GBR,PRT,2012.0,48,63,-15
KOR,TWN,2008.0,9,4,5
JPN,POL,2021.0,4,4,0
CAN,THA,2019.0,13,5,8
LUX,GBR,2021.0,7,9,-2
ESP,USA,2001.0,273,199,74
SGP,GRC,2018.0,3,1,2
SWE,HKG,2018.0,5,8,-3
LBN,DEU,2018.0,9,8,1
VEN,USA,2014.0,25,9,16
ESP,ITA,2008.0,67,128,-61
TUR,AUS,2022.0,4,5,-1
KEN,GHA,2016.0,3,1,2
TUR,IRN,2019.0,14,33,-19
PAK,CAN,2015.0,19,18,1
ARE,KWT,2019.0,3,3,0
NLD,DNK,2011.0,21,12,9
HKG,AUS,2019.0,49,37,12
POL,AUS,2012.0,6,11,-5
IND,THA,2022.0,11,5,6
GBR,OMN,2015.0,15,3,12
IND,ISR,2009.0,25,9,16
SWE,IDN,2019.0,1,3,-2
MEX,CAN,2007.0,25,24,1
COL,ARG,2007.0,3,5,-2
FRA,DZA,2006.0,35,20,15
BRA,FIN,2019.0,19,5,14
ETH,NLD,2013.0,4,4,0
CAN,COL,2014.0,10,5,5
ARG,SVN,2017.0,1,1,0
VEN,DEU,2007.0,5,6,-1
CZE,JPN,2008.0,6,6,0
ESP,CAN,2008.0,30,32,-2
CHE,NOR,2018.0,19,17,2
AUT,FRA,2005.0,21,20,1
NZL,DEU,2022.0,10,4,6
DNK,IRL,2001.0,3,1,2
ESP,BGR,2008.0,3,4,-1
BEL,ROU,2006.0,2,4,-2
FRA,BEL,2001.0,96,88,8
CAN,SWE,2007.0,16,50,-34
LBN,FRA,2008.0,17,24,-7
RUS,IRL,2011.0,2,3,-1
NZL,THA,2004.0,3,1,2
SAU,EGY,2008.0,52,79,-27
RUS,CHN,2004.0,11,5,6
UKR,USA,1999.0,29,12,17
AUS,ZAF,2001.0,5,17,-12
FIN,USA,2009.0,59,57,2
AUT,CZE,2004.0,6,13,-7
TUR,CAN,2004.0,12,5,7
AUT,FRA,2002.0,13,15,-2
AUS,RUS,2001.0,2,12,-10
TUR,DEU,1998.0,2,1,1
UGA,GBR,2010.0,9,6,3
NGA,AUS,2021.0,4,3,1
DEU,TUR,2003.0,15,17,-2
FRA,IDN,2010.0,5,1,4
GBR,UGA,2006.0,4,1,3
DEU,FIN,2008.0,31,37,-6
USA,MYS,2002.0,9,17,-8
NLD,BRA,2006.0,21,11,10
JPN,TWN,2004.0,17,10,7
NLD,SWE,2005.0,25,23,2
DNK,FRA,1999.0,6,12,-6
DEU,LVA,2002.0,8,3,5
UKR,FRA,2002.0,11,13,-2
USA,GHA,2006.0,6,5,1
CHE,HRV,2001.0,3,4,-1
CAN,THA,2010.0,17,16,1
ITA,AUT,2003.0,21,24,-3
IRL,NLD,2006.0,3,9,-6
PAK,SWE,2016.0,3,17,-14
GBR,BRA,2000.0,21,11,10
SWE,DEU,2000.0,20,31,-11
ESP,CHE,2005.0,29,26,3
VNM,KOR,2010.0,8,12,-4
USA,RUS,1999.0,41,267,-226
CAN,DNK,2007.0,15,18,-3
NOR,TUR,2011.0,2,2,0
MEX,POL,2009.0,4,3,1
DEU,NOR,2007.0,46,8,38
SWE,QAT,2018.0,1,2,-1
ESP,SWE,2001.0,15,25,-10
MYS,EGY,2011.0,4,3,1
BGD,USA,2002.0,20,13,7
CHE,CZE,2021.0,9,12,-3
CZE,UKR,2014.0,4,4,0
AUS,ESP,2003.0,10,14,-4
LKA,JPN,2005.0,4,4,0
JAM,GBR,2001.0,1,3,-2
IND,TWN,2005.0,34,9,25
ISR,TWN,2014.0,1,1,0
LTU,RUS,1999.0,2,2,0
IND,AUS,2004.0,20,7,13
USA,ARE,1999.0,2,1,1
GBR,CHL,2016.0,41,43,-2
USA,JAM,2002.0,8,4,4
ETH,KEN,2005.0,1,2,-1
CHE,SGP,2019.0,18,25,-7
FRA,KOR,2002.0,7,5,2
JPN,BEL,1999.0,8,5,3
ZWE,TZA,2011.0,1,1,0
SWE,JPN,2001.0,31,21,10
VNM,DEU,2010.0,1,13,-12
ROU,DEU,2004.0,17,15,2
GHA,NLD,2006.0,2,1,1
GRC,IRL,2014.0,5,3,2
CHN,FRA,1999.0,7,11,-4
ZAF,HUN,2014.0,1,2,-1
ECU,USA,2003.0,5,6,-1
DNK,ROU,2008.0,4,2,2
USA,HTI,2008.0,1,1,0
PRT,CHN,2005.0,1,4,-3
DEU,NGA,2017.0,9,8,1
GHA,NGA,2013.0,2,1,1
CZE,SWE,2006.0,5,2,3
MYS,NOR,2018.0,7,2,5
SVN,ITA,2006.0,4,3,1
FRA,ZAF,2012.0,26,13,13
COL,GBR,2007.0,5,8,-3
CZE,HRV,2019.0,1,3,-2
ALB,ITA,2017.0,2,6,-4
FRA,NZL,2011.0,18,15,3
PER,ESP,2002.0,8,4,4
JPN,MEX,2016.0,9,4,5
CZE,NLD,2015.0,6,11,-5
FIN,CAN,2021.0,9,25,-16
IRL,CHE,2016.0,15,11,4
ARG,FRA,2012.0,23,25,-2
AUT,JPN,2012.0,10,15,-5
HUN,IND,2012.0,4,2,2
PAK,RUS,2013.0,2,1,1
BRA,FIN,2010.0,1,3,-2
NOR,CZE,2019.0,4,1,3
BRA,PAK,2012.0,2,5,-3
SVK,SLV,2010.0,1,2,-1
AUT,VNM,2013.0,2,1,1
CHE,AFG,2013.0,1,1,0
URY,ARG,2021.0,5,9,-4
HUN,ROU,2013.0,6,9,-3
VNM,GBR,2014.0,23,19,4
SAU,ITA,2012.0,3,13,-10
CAN,FIN,2007.0,10,9,1
ARE,KWT,2017.0,3,5,-2
VNM,CHN,2022.0,6,6,0
SGP,SRB,2019.0,1,1,0
NOR,DEU,2022.0,21,35,-14
BHR,CAN,2019.0,2,1,1
NGA,FRA,2020.0,5,1,4
IDN,NLD,2014.0,8,24,-16
LUX,KOR,2017.0,1,2,-1
MMR,THA,2014.0,2,1,1
ITA,NZL,2016.0,7,5,2
DNK,RUS,2004.0,3,7,-4
GBR,GMB,2020.0,10,11,-1
NAM,ZAF,2014.0,5,8,-3
THA,FRA,2022.0,5,3,2
CZE,CHN,2022.0,10,5,5
SGP,DEU,2022.0,15,14,1
GRC,CHN,2019.0,4,2,2
CAN,CRI,2022.0,2,1,1
TUR,BGR,2018.0,1,1,0
BEL,BFA,2022.0,3,2,1
NLD,RUS,2020.0,11,26,-15
DZA,USA,2022.0,2,1,1
DNK,BGD,2021.0,3,1,2
DNK,ESP,2006.0,8,6,2
GRC,ESP,2008.0,20,9,11
FRA,MTQ,2006.0,9,15,-6
CHE,POL,2010.0,12,21,-9
NOR,BEL,2014.0,4,7,-3
CZE,FRA,1998.0,10,5,5
BRA,CAN,2000.0,12,3,9
ZAF,AUT,2003.0,1,1,0
POL,CZE,2007.0,5,3,2
ISL,USA,2013.0,10,10,0
CHE,SVK,2020.0,4,2,2
CAN,THA,2017.0,11,11,0
SWE,ITA,2009.0,21,24,-3
JPN,ESP,2018.0,15,16,-1
FRA,IDN,2019.0,13,3,10
NOR,CZE,2010.0,3,3,0
NLD,EGY,2018.0,4,1,3
NOR,USA,2004.0,37,53,-16
GRC,DNK,2011.0,8,3,5
ESP,ECU,2012.0,3,6,-3
CHE,CYP,2008.0,1,1,0
JPN,ARE,2018.0,7,1,6
ESP,CUB,2018.0,6,18,-12
COL,ITA,2010.0,6,4,2
SVN,AUT,2020.0,5,4,1
VNM,FRA,2020.0,27,64,-37
TWN,DEU,2020.0,21,10,11
NZL,KOR,2020.0,3,4,-1
RUS,ZAF,2018.0,1,2,-1
NLD,TWN,2022.0,3,3,0
CHN,MAC,2008.0,8,6,2
COG,UGA,2006.0,1,1,0
DOM,ESP,2021.0,2,1,1
EST,ESP,2021.0,4,4,0
ESP,URY,2006.0,3,4,-1
CZE,RUS,2017.0,7,18,-11
MYS,FRA,2006.0,1,3,-2
ZWE,KEN,2020.0,1,1,0
CAN,JAM,2014.0,2,2,0
AUS,IDN,2005.0,14,5,9
NLD,HUN,2006.0,5,5,0
USA,MYS,2005.0,17,12,5
KWT,GBR,2008.0,6,2,4
BRA,IND,2009.0,6,5,1
THA,PHL,2008.0,2,1,1
AUT,ROU,2014.0,1,6,-5
KGZ,RUS,2016.0,4,3,1
ARG,VEN,2006.0,2,1,1
AUS,FRA,1999.0,12,14,-2
ARE,JPN,2007.0,1,3,-2
NLD,TUR,1999.0,1,2,-1
HKG,AUS,2017.0,26,39,-13
SGP,NOR,2005.0,2,1,1
AUT,AUS,2022.0,7,7,0
JPN,PRT,2006.0,3,1,2
ROU,AUT,2001.0,3,1,2
POL,ITA,2012.0,10,40,-30
LVA,DEU,2005.0,4,1,3
AND,FRA,2004.0,1,1,0
NLD,POL,2003.0,8,13,-5
NOR,ETH,2008.0,5,2,3
THA,NLD,2009.0,8,6,2
ARE,AUS,2005.0,3,9,-6
AUS,PAK,2004.0,2,2,0
TWN,CZE,2017.0,3,2,1
UKR,FRA,2005.0,9,7,2
USA,TZA,2012.0,15,3,12
TUN,CAN,2011.0,9,6,3
ROU,BGR,2014.0,1,2,-1
SVK,GBR,2013.0,6,6,0
HUN,FIN,2009.0,3,2,1
POL,IRL,2016.0,4,5,-1
GRC,JPN,2020.0,2,1,1
CHN,NPL,2014.0,4,1,3
CZE,LTU,2018.0,2,1,1
CAN,ETH,2021.0,3,5,-2
ARE,ISR,2012.0,1,1,0
BEL,QAT,2016.0,3,3,0
ZAF,MYS,2010.0,2,1,1
PER,GBR,2009.0,3,1,2
BGR,GBR,2011.0,9,5,4
TUR,IND,2015.0,2,7,-5
FRA,CZE,2001.0,7,12,-5
FRA,BLR,2000.0,2,1,1
SDN,OMN,2000.0,1,1,0
CHE,THA,2020.0,2,5,-3
FRA,PAK,2021.0,6,6,0
FRA,SEN,2022.0,9,8,1
VNM,THA,2017.0,6,7,-1
VNM,DEU,2019.0,4,25,-21
RUS,VNM,2012.0,6,1,5
AUT,IND,2001.0,1,2,-1
PRT,BEL,2001.0,1,4,-3
IRL,RUS,2004.0,1,5,-4
USA,PRT,1998.0,2,7,-5
USA,ZWE,2012.0,3,2,1
SGP,ZAF,1998.0,1,1,0
GTM,USA,2008.0,2,2,0
ARG,CHE,2006.0,4,2,2
ARE,NLD,2011.0,2,3,-1
KAZ,DEU,2004.0,2,2,0
ROU,ESP,1999.0,1,1,0
IRQ,KOR,2020.0,1,1,0
MDA,ROU,2021.0,1,2,-1
MYS,TUR,2015.0,12,1,11
SEN,KEN,2021.0,1,2,-1
ECU,NLD,2017.0,5,2,3
EGY,PSE,2020.0,4,4,0
ESP,BOL,2013.0,1,3,-2
BEL,PRT,1999.0,2,2,0
THA,CAN,2001.0,6,4,2
ISL,GBR,2002.0,4,10,-6
ESP,FIN,2004.0,3,3,0
BEL,TUR,2011.0,2,11,-9
LKA,KOR,2014.0,2,2,0
KOR,LKA,2018.0,4,2,2
MDA,FRA,2011.0,3,1,2
CHE,NZL,2011.0,4,9,-5
LVA,USA,2012.0,5,6,-1
NPL,AUS,2017.0,8,8,0
DEU,KEN,2014.0,9,9,0
CHN,CHL,2021.0,4,6,-2
MEX,PER,2017.0,6,5,1
LTU,FIN,2019.0,2,2,0
AUT,LIE,2020.0,2,1,1
NLD,NGA,2022.0,1,2,-1
QAT,EGY,2017.0,9,16,-7
SDN,USA,2015.0,4,4,0
LBN,ITA,2020.0,4,4,0
CHE,KOR,2008.0,2,12,-10
BGD,NOR,2018.0,5,1,4
HKG,IRL,2008.0,2,2,0
BIH,USA,2008.0,1,3,-2
NLD,SVK,2004.0,1,4,-3
UKR,DNK,2004.0,2,1,1
BEL,VNM,2008.0,5,1,4
GBR,SDN,2003.0,1,3,-2
OMN,GBR,1999.0,1,2,-1
MLT,USA,2015.0,1,1,0
SVK,RUS,2017.0,3,1,2
BFA,NLD,2006.0,2,1,1
ITA,HRV,2004.0,3,2,1
SWE,ZAF,2003.0,6,3,3
FIN,TUR,2007.0,2,8,-6
KNA,USA,2016.0,4,4,0
NOR,LTU,2002.0,2,1,1
JOR,IRN,2021.0,1,1,0
PSE,USA,2001.0,2,1,1
SWE,TUR,2012.0,6,13,-7
CHE,SGP,2010.0,9,8,1
GRL,DNK,2012.0,3,2,1
OMN,ARE,2006.0,3,4,-1
AUS,HRV,2007.0,1,1,0
KEN,NGA,2021.0,3,2,1
USA,BLR,2010.0,3,1,2
JPN,NZL,2022.0,4,2,2
SAU,TUN,2015.0,9,57,-48
PRT,CHN,2002.0,2,8,-6
SVK,RUS,2010.0,2,4,-2
MAR,GBR,2020.0,2,3,-1
PAK,TUR,2018.0,15,13,2
FIN,THA,2010.0,1,2,-1
CRI,USA,2015.0,7,15,-8
DEU,GEO,2011.0,3,2,1
IRL,KOR,2008.0,1,4,-3
KEN,TZA,2015.0,5,4,1
BOL,DEU,2004.0,2,1,1
BEL,CHL,2015.0,7,10,-3
QAT,EGY,2010.0,2,2,0
BRA,CHN,2008.0,4,4,0
BEL,PAK,2018.0,2,7,-5
NZL,IND,2022.0,5,5,0
BEL,DNK,2012.0,5,12,-7
IND,SVN,2013.0,1,2,-1
USA,CUB,2017.0,2,9,-7
BEL,IRN,2021.0,5,27,-22
AZE,IRN,2013.0,2,6,-4
KAZ,BEL,2022.0,3,1,2
KWT,FRA,2020.0,2,1,1
AUT,EGY,2020.0,3,2,1
MLI,BFA,2009.0,2,1,1
ETH,SWE,2012.0,2,2,0
IDN,ESP,2019.0,1,2,-1
CAN,AUT,2004.0,9,22,-13
NLD,GRC,2006.0,10,7,3
BEL,HUN,2009.0,3,5,-2
PAN,USA,2004.0,8,3,5
CHE,IRL,2005.0,6,3,3
THA,KOR,2014.0,4,5,-1
LUX,DEU,2008.0,3,17,-14
CHN,IDN,2016.0,1,3,-2
LVA,DEU,2002.0,3,8,-5
BRN,MYS,2022.0,4,5,-1
CHE,IRL,2002.0,5,5,0
FIN,CHN,2000.0,2,5,-3
BGD,USA,2005.0,7,11,-4
NPL,AUS,2019.0,11,7,4
PRY,CHL,2017.0,1,2,-1
GBR,LTU,2014.0,8,5,3
NLD,PRT,2003.0,9,9,0
IDN,MYS,2002.0,3,1,2
PAK,CHE,2013.0,1,1,0
MRT,FRA,2017.0,1,3,-2
UZB,RUS,2016.0,3,7,-4
HUN,BGR,2003.0,1,2,-1
ISR,GRC,2010.0,4,3,1
ETH,FRA,2006.0,2,1,1
MNG,JPN,2007.0,3,4,-1
ARE,KWT,2010.0,1,2,-1
POL,TUR,2012.0,2,9,-7
MAR,CAN,2018.0,5,11,-6
THA,DEU,2022.0,2,5,-3
ITA,CHL,1999.0,1,2,-1
EST,IRL,2015.0,1,1,0
SAU,PAK,2005.0,5,9,-4
LTU,LVA,2017.0,3,2,1
MNG,KOR,2020.0,3,3,0
NZL,ITA,2012.0,4,2,2
ECU,CHL,2016.0,3,8,-5
EGY,KOR,2022.0,2,3,-1
TWN,NLD,2022.0,3,3,0
EST,FIN,2018.0,8,7,1
PRT,JPN,2021.0,1,1,0
ECU,AUS,2022.0,1,1,0
COL,ECU,2021.0,4,3,1
GMB,USA,2012.0,1,1,0
KOR,FIN,2022.0,2,5,-3
USA,DOM,2021.0,1,1,0
PRT,DZA,2022.0,2,1,1
DNK,PRT,2013.0,3,8,-5
GRC,CHN,2017.0,5,3,2
MEX,CHE,2007.0,4,4,0
ROU,ITA,2004.0,8,5,3
FRA,VEN,2012.0,2,5,-3
YEM,MYS,2016.0,2,16,-14
IND,EGY,2016.0,5,4,1
CHN,RUS,2015.0,12,7,5
IND,ITA,2000.0,2,2,0
BLR,USA,2009.0,3,2,1
BLR,UKR,2011.0,2,2,0
CUB,BRA,2012.0,7,2,5
COL,ITA,2017.0,3,9,-6
BGR,FRA,2018.0,3,7,-4
IND,LKA,2006.0,3,1,2
CZE,HRV,2017.0,3,1,2
AUT,TUR,2012.0,3,2,1
ISR,JOR,2018.0,1,2,-1
ECU,NLD,2019.0,2,4,-2
PAK,TZA,2020.0,3,1,2
COL,ITA,2019.0,4,9,-5
RUS,BGR,2021.0,3,2,1
OMN,SAU,2020.0,4,3,1
NOR,CZE,2017.0,3,2,1
SGP,FIN,2013.0,2,2,0
ESP,EGY,2014.0,5,5,0
PRT,FRA,1997.0,6,1,5
MEX,SWE,2009.0,3,4,-1
ZAF,UGA,2022.0,3,2,1
ITA,SGP,2008.0,1,2,-1
EGY,CHN,2012.0,2,5,-3
JPN,SYR,2017.0,1,1,0
CHE,BLR,2004.0,2,1,1
CUB,GBR,2002.0,2,3,-1
FRA,THA,2001.0,2,4,-2
MRT,FRA,2019.0,4,2,2
BEL,KEN,2001.0,1,2,-1
SWE,GHA,2003.0,1,1,0
NOR,FIN,2001.0,2,8,-6
MDA,ISR,2002.0,1,1,0
USA,GUM,2007.0,1,1,0
MWI,ZAF,2009.0,1,1,0
NPL,FRA,2018.0,1,1,0
FRA,ALB,2014.0,1,1,0
LTU,POL,2008.0,3,2,1
URY,BRA,2014.0,3,4,-1
USA,BFA,2022.0,1,1,0
SWE,MYS,2020.0,4,9,-5
GBR,MUS,2019.0,3,1,2
BWA,ZWE,2020.0,1,3,-2
RUS,NZL,2014.0,3,2,1
GBR,ROU,2003.0,6,11,-5
BWA,CHN,2019.0,1,2,-1
IND,COD,2022.0,1,3,-2
CHE,LTU,2021.0,1,5,-4
NGA,IRQ,2022.0,3,1,2
PHL,MYS,2016.0,1,2,-1
AUT,ETH,2001.0,1,1,0
BGD,IND,2002.0,2,11,-9
NZL,CHL,2011.0,3,4,-1
ARG,PRT,2013.0,2,2,0
BEL,SGP,2018.0,3,3,0
ITA,PAK,2002.0,1,1,0
GBR,AZE,2006.0,1,1,0
RUS,CHL,2012.0,2,3,-1
THA,ARE,2014.0,2,1,1
ITA,UKR,2010.0,2,8,-6
IND,ESP,2001.0,4,6,-2
USA,AIA,2018.0,1,1,0
DNK,CHL,2009.0,1,1,0
THA,NZL,2008.0,1,3,-2
USA,PRT,1997.0,3,1,2
ARE,DEU,2012.0,2,5,-3
SAU,POL,2019.0,2,2,0
ESP,NIC,2013.0,1,1,0
POL,ARM,2011.0,1,1,0
IRL,LTU,2016.0,1,1,0
COG,CHE,2015.0,3,7,-4
PSE,MYS,2016.0,2,8,-6
BHR,CAN,2017.0,1,1,0
CYP,ESP,2016.0,1,2,-1
CHN,RWA,2021.0,3,6,-3
SVN,CHN,2021.0,2,1,1
CZE,AUT,2014.0,6,15,-9
JOR,TUR,2021.0,3,3,0
VNM,THA,2010.0,1,6,-5
LUX,CAN,2012.0,2,1,1
IRN,EGY,2011.0,3,1,2
PER,IDN,2018.0,2,1,1
AUT,MNG,2018.0,1,1,0
BRN,PAK,2009.0,1,1,0
COL,VEN,2005.0,3,1,2
VNM,AUT,2012.0,1,4,-3
ARG,PRI,2008.0,1,2,-1
CHE,QAT,2021.0,3,1,2
KEN,SWE,2015.0,1,2,-1
GTM,CHE,2018.0,1,1,0
NZL,MEX,2018.0,1,3,-2
FIN,ISL,2007.0,1,1,0
SWE,BGR,2001.0,2,2,0
ZAF,FRA,1998.0,2,3,-1
ESP,BLR,1999.0,2,2,0
URY,CHL,2005.0,1,1,0
HRV,MKD,2008.0,1,1,0
KAZ,USA,2007.0,2,3,-1
YEM,EGY,2012.0,6,5,1
MOZ,AUS,2009.0,1,1,0
CIV,BEN,2013.0,1,2,-1
CHL,CHE,2022.0,1,2,-1
UZB,DEU,2009.0,1,1,0
GAB,FRA,2001.0,1,1,0
HRV,CAN,2002.0,1,2,-1
USA,MWI,2004.0,2,2,0
DEU,BIH,2008.0,3,2,1
SAU,CZE,2018.0,1,3,-2
RUS,ARG,2016.0,1,1,0
JPN,ZMB,2007.0,1,1,0
KEN,DEU,2009.0,4,5,-1
BRA,IRL,2010.0,1,1,0
IRN,OMN,2016.0,1,2,-1
SWE,TWN,2020.0,2,7,-5
MEX,CHN,2008.0,1,1,0
ISR,GRC,2017.0,2,1,1
BEL,ECU,2021.0,4,4,0
NZL,PHL,2018.0,3,2,1
FRA,GHA,2021.0,1,2,-1
PAK,ZAF,2022.0,1,1,0
NPL,DNK,2018.0,1,2,-1
MYS,JPN,2022.0,3,7,-4
MEX,TWN,2011.0,1,2,-1
FIN,THA,2017.0,1,2,-1
TUR,IRN,2010.0,1,9,-8
SWE,IDN,2010.0,1,2,-1
COL,DNK,2015.0,2,1,1
MCO,USA,2018.0,1,2,-1
ECU,URY,2020.0,1,2,-1
TWN,MAC,2022.0,1,2,-1
TWN,TUR,2022.0,1,1,0
MLI,CAN,2020.0,1,1,0
CHE,CUB,2020.0,1,1,0
MEX,SGP,2021.0,1,1,0
ISR,KOR,2012.0,3,3,0
NOR,ISR,2002.0,2,2,0
USA,JAM,2005.0,1,3,-2
BGR,ROU,2004.0,1,1,0
PYF,USA,2004.0,1,1,0
CZE,FRA,1997.0,2,5,-3
SWZ,ZAF,2008.0,2,2,0
BHS,USA,2014.0,1,4,-3
IRL,THA,2018.0,2,2,0
BEL,HRV,2014.0,1,2,-1
SWE,ROU,2014.0,1,1,0
IRL,IRN,2022.0,1,10,-9
BHR,GBR,2008.0,1,4,-3
GEO,CAN,2021.0,1,1,0
GRC,EST,2008.0,1,1,0
SAU,HKG,2014.0,1,4,-3
POL,MLT,2013.0,1,2,-1
TUR,DZA,2018.0,1,1,0
ARE,IRN,2017.0,1,2,-1
EGY,ZAF,2022.0,1,1,0
NLD,HRV,2008.0,1,1,0
ECU,SWE,2018.0,1,3,-2
KAZ,KGZ,2017.0,2,3,-1
THA,HKG,2015.0,1,2,-1
AUT,THA,2022.0,2,1,1
NZL,CZE,2020.0,1,3,-2
BOL,CHE,2018.0,1,1,0
IRQ,CHN,2008.0,1,2,-1
SVK,FRA,2018.0,2,6,-4
DEU,LVA,2005.0,1,4,-3
LVA,NLD,2016.0,1,1,0
ITA,TUR,1998.0,1,1,0
CZE,BRA,2000.0,1,1,0
IRL,GRC,2009.0,2,6,-4
KOR,HKG,2003.0,1,3,-2
IND,PRI,2018.0,1,2,-1
SAU,PAK,2002.0,1,5,-4
MLT,ITA,2022.0,1,2,-1
AUS,SVN,2009.0,1,2,-1
BGR,UKR,2002.0,1,1,0
UGA,CHE,2008.0,1,3,-2
HRV,AUS,2022.0,1,1,0
ESP,BGD,2014.0,1,1,0
SRB,POL,2008.0,1,1,0
DEU,MDA,2005.0,1,1,0
FIN,HUN,1997.0,1,1,0
KEN,SVK,2018.0,1,3,-2
GRC,IND,2015.0,1,3,-2
ITA,LBN,2016.0,1,4,-3
HKG,NOR,2020.0,2,3,-1
USA,FSM,2013.0,1,1,0
PER,ESP,2005.0,1,7,-6
CHL,BEL,2022.0,1,4,-3
ITA,NLD,2020.0,113,88,25
CHE,USA,2014.0,473,533,-60
TUR,USA,2021.0,174,145,29
AUS,IRL,2013.0,23,49,-26
USA,COL,2013.0,79,62,17
CYP,GBR,2014.0,20,30,-10
SVK,USA,2003.0,29,10,19
AUS,USA,2003.0,467,394,73
DEU,CHE,2019.0,582,471,111
POL,USA,2005.0,129,87,42
JPN,COL,2011.0,3,2,1
USA,ISR,2020.0,336,362,-26
ESP,BRA,2021.0,68,81,-13
MEX,USA,2018.0,221,186,35
NLD,IRL,2021.0,16,14,2
USA,CHE,2001.0,213,299,-86
GRC,CHE,2016.0,37,9,28
BEL,AUS,2015.0,26,22,4
SVK,CZE,2019.0,72,38,34
PAK,QAT,2017.0,6,5,1
QAT,PAK,2018.0,3,3,0
HKG,USA,2004.0,99,63,36
FRA,ARE,2016.0,17,4,13
CHE,ITA,2022.0,77,89,-12
BRA,GBR,2003.0,39,43,-4
IND,HKG,2016.0,17,8,9
CHN,TUR,2014.0,4,1,3
ITA,IND,2016.0,45,37,8
SAU,GBR,2012.0,11,86,-75
LKA,AUS,2018.0,34,18,16
BRA,PRY,2018.0,5,5,0
NOR,CHE,2011.0,11,6,5
USA,ARG,2010.0,107,81,26
PAK,SAU,2020.0,81,63,18
LBN,CAN,2018.0,10,10,0
IRN,ESP,2021.0,23,3,20
ZAF,IRN,2021.0,4,2,2
POL,NLD,2018.0,14,19,-5
MAC,USA,2021.0,2,11,-9
CHE,POL,2017.0,20,25,-5
GBR,IND,2021.0,120,231,-111
SWE,CAN,2018.0,37,50,-13
BEL,TWN,2021.0,3,1,2
VEN,GBR,2008.0,4,3,1
NZL,DNK,2007.0,4,3,1
NOR,DNK,2016.0,24,43,-19
HUN,CHE,2013.0,16,14,2
SVK,CZE,2010.0,30,27,3
CAN,ITA,1997.0,5,5,0
BGD,JPN,2004.0,15,22,-7
CZE,ESP,2018.0,16,27,-11
IND,NGA,2021.0,6,9,-3
VNM,DEU,2017.0,5,20,-15
GRC,SWE,2015.0,26,6,20
DEU,VNM,2017.0,20,5,15
SWE,EST,2004.0,10,5,5
USA,PRI,2011.0,50,66,-16
BRA,CUB,2015.0,4,19,-15
PRT,FRA,1998.0,6,6,0
MYS,CAN,2012.0,15,7,8
EST,USA,2006.0,2,6,-4
POL,CHE,2000.0,6,7,-1
RUS,KAZ,2006.0,8,3,5
SRB,BEL,2004.0,2,2,0
RUS,CAN,2003.0,22,17,5
ISL,GBR,2005.0,7,2,5
SEN,USA,2008.0,4,1,3
DEU,ISR,2003.0,25,34,-9
NLD,AUS,2001.0,19,20,-1
ITA,TUR,1997.0,1,1,0
CHE,AUS,1999.0,13,6,7
SWE,UGA,2007.0,2,1,1
CHL,USA,2004.0,32,45,-13
KOR,AUT,2005.0,3,1,2
NGA,CHN,2013.0,2,3,-1
DEU,LUX,2003.0,6,6,0
CHL,URY,2011.0,2,1,1
HUN,CAN,2018.0,3,4,-1
CAN,GRC,2021.0,10,10,0
BGR,CHE,2008.0,2,4,-2
OMN,USA,2013.0,3,3,0
DEU,NGA,2019.0,7,7,0
GBR,BRN,2019.0,4,4,0
USA,CUB,2010.0,8,4,4
RUS,AUS,2013.0,8,5,3
ZAF,NZL,2018.0,8,3,5
JOR,ITA,2018.0,2,7,-5
ETH,TWN,2018.0,1,5,-4
UKR,GBR,2007.0,12,8,4
PHL,CHE,2003.0,2,1,1
SWE,ETH,2001.0,3,2,1
ZAF,ETH,2013.0,3,4,-1
ZAF,CMR,2022.0,3,1,2
MTQ,FRA,2004.0,4,17,-13
ESP,GRC,2002.0,9,4,5
DNK,SGP,2009.0,3,4,-1
MEX,CRI,2012.0,4,2,2
DEU,NGA,2010.0,2,3,-1
IND,BEL,2014.0,29,17,12
LTU,DEU,2018.0,8,4,4
UKR,CZE,2015.0,6,3,3
YEM,DEU,2015.0,2,1,1
CHL,NZL,2021.0,1,1,0
ITA,ALB,2012.0,2,4,-2
CAN,LKA,2013.0,6,4,2
FRA,SVK,2006.0,8,5,3
AZE,RUS,2006.0,2,7,-5
SRB,SWE,2022.0,2,2,0
DEU,VNM,2010.0,13,1,12
NCL,USA,2016.0,4,1,3
PAK,QAT,2019.0,8,1,7
BEN,FRA,2013.0,7,9,-2
KEN,ITA,2014.0,4,2,2
MAR,YEM,2018.0,3,1,2
PHL,THA,2014.0,2,2,0
RUS,KOR,2013.0,8,10,-2
HUN,JPN,2007.0,6,6,0
DEU,PER,2006.0,2,1,1
POL,CAN,2003.0,12,12,0
ITA,NGA,2005.0,1,1,0
LKA,DEU,2011.0,1,2,-1
ITA,UKR,2017.0,1,3,-2
SWE,LTU,2016.0,5,6,-1
AUS,PNG,2021.0,3,1,2
LKA,JPN,2002.0,3,2,1
NOR,BRA,2011.0,1,4,-3
CHE,COD,2018.0,1,1,0
IND,BRN,2014.0,3,2,1
MEX,EGY,2011.0,1,2,-1
USA,GEO,2007.0,8,9,-1
BFA,SEN,2002.0,2,1,1
GUM,USA,2013.0,2,6,-4
IRL,HUN,2021.0,1,3,-2
SVK,IND,2003.0,1,2,-1
ITA,UKR,2019.0,2,2,0
GAB,USA,2001.0,1,3,-2
HRV,SWE,2013.0,3,1,2
HUN,NZL,2017.0,1,1,0
ITA,BGD,2020.0,2,4,-2
TZA,TUR,2021.0,1,1,0
NOR,ZWE,2001.0,1,1,0
MDG,FRA,2022.0,2,1,1
POL,BLR,1998.0,1,1,0
NOR,POL,2001.0,2,2,0
IND,ERI,2011.0,2,3,-1
CZE,NZL,2018.0,1,1,0
DEU,LIE,2019.0,3,1,2
ESP,GRC,2005.0,4,4,0
KAZ,ARE,2022.0,1,1,0
IDN,IND,2022.0,1,1,0
USA,CUB,2019.0,5,11,-6
PSE,EGY,2002.0,2,1,1
MEX,ZAF,2013.0,1,1,0
ZMB,GBR,2012.0,1,5,-4
BWA,NAM,2019.0,1,1,0
PRY,USA,2022.0,2,1,1
ERI,IND,2011.0,3,2,1
GEO,RUS,1999.0,3,4,-1
HKG,NZL,2008.0,1,4,-3
BTN,IND,2018.0,1,3,-2
AUS,EGY,2002.0,1,2,-1
SRB,DNK,2009.0,2,1,1
LVA,RUS,2014.0,3,2,1
AUS,MMR,2016.0,1,1,0
PRT,KOR,2018.0,1,1,0
MYS,DEU,2008.0,1,4,-3
SWE,IND,1999.0,1,2,-1
FRA,CYP,2006.0,1,1,0
,FRA,2004.0,14081,0,14081
RUS,,2024.0,61959,0,61959
GBR,,2024.0,130534,0,130534
,USA,2001.0,86797,0,86797
FRA,,2023.0,56794,0,56794
ZAF,,2010.0,634,0,634
ZAF,,2017.0,1324,0,1324
,GBR,2016.0,20243,0,20243
BRA,,2009.0,3367,0,3367
,KAZ,2003.0,99,0,99
,KOR,2006.0,11919,0,11919
ARM,,2011.0,57,0,57
,IRL,2004.0,1270,0,1270
POL,,2024.0,39633,0,39633
TUN,,2022.0,2265,0,2265
PAK,,2019.0,1811,0,1811
,FRA,1996.0,9421,0,9421
JPN,,2007.0,15637,0,15637
,PRT,2012.0,3437,0,3437
EST,,2020.0,388,0,388
,BEL,2003.0,2941,0,2941
ZAF,,2019.0,1829,0,1829
,FIN,1994.0,1862,0,1862
,MEX,2007.0,3892,0,3892
CHE,,2022.0,9132,0,9132
PAK,,2010.0,409,0,409
,CAN,2010.0,12052,0,12052
KEN,,2020.0,483,0,483
,ISR,2015.0,2574,0,2574
BRN,BGD,2019.0,3,0,3
,CAN,2017.0,11826,0,11826
IRN,,2013.0,1948,0,1948
PAK,,2017.0,1245,0,1245
,MUS,1998.0,36,0,36
,NOR,2010.0,1830,0,1830
,CZE,2000.0,2007,0,2007
TWN,,2004.0,1074,0,1074
MAC,,2023.0,445,0,445
,GRC,1995.0,870,0,870
,THA,2011.0,2380,0,2380
SWE,TZA,2014.0,1,0,1
CZE,,2004.0,369,0,369
,IRN,1999.0,1315,0,1315
,IRL,1996.0,760,0,760
MAR,,2014.0,346,0,346
,PHL,2006.0,265,0,265
SVN,,2020.0,587,0,587
,BGR,2008.0,456,0,456
,CHL,2008.0,1719,0,1719
MEX,,2003.0,228,0,228
BEL,MDA,2014.0,2,0,2
ALB,,2018.0,70,0,70
JAM,,2024.0,129,0,129
LAO,,2022.0,63,0,63
BEN,,2015.0,46,0,46
,NOR,2017.0,1862,0,1862
NGA,NOR,2014.0,1,0,1
,ZMB,2015.0,112,0,112
FRA,MUS,2021.0,1,0,1
,CAN,2019.0,6562,0,6562
,MYS,2014.0,5750,0,5750
,ETH,2010.0,397,0,397
,BFA,2010.0,126,0,126
,LBY,2011.0,37,0,37
JOR,,2020.0,359,0,359
,TUN,2009.0,1190,0,1190
,ETH,2017.0,1274,0,1274
MWI,,2016.0,40,0,40
,AZE,2011.0,143,0,143
,MNG,2011.0,44,0,44
KHM,,2018.0,44,0,44
BGD,,2021.0,828,0,828
,BGD,2015.0,911,0,911
,NIC,2013.0,11,0,11
SRB,GRC,2001.0,1,0,1
,HKG,2015.0,2009,0,2009
,AGO,2012.0,19,0,19
LTU,LVA,2019.0,2,0,2
PHL,,2016.0,135,0,135
,CIV,2014.0,101,0,101
,WLF,2013.0,1,0,1
,MDA,2016.0,45,0,45
CHL,ZAF,2017.0,1,0,1
,SEN,2013.0,167,0,167
GBR,MLT,2003.0,4,0,4
,ISL,2015.0,141,0,141
MYS,LBY,2022.0,5,0,5
,NOR,2019.0,1000,0,1000
FIN,SYR,2017.0,1,0,1
,ETH,2019.0,1259,0,1259
KIR,,2022.0,1,0,1
,GIN,2017.0,33,0,33
MRT,,2024.0,33,0,33
,HND,2015.0,34,0,34
REU,,2024.0,14,0,14
UKR,FIN,2019.0,3,0,3
,BFA,2017.0,99,0,99
LBR,,2024.0,37,0,37
,COG,2018.0,51,0,51
DJI,,2023.0,9,0,9
,BRA,2018.0,17998,0,17998
,VNM,2006.0,337,0,337
,HUN,2018.0,1304,0,1304
,OMN,2005.0,104,0,104
UKR,,2000.0,165,0,165
,GHA,1999.0,98,0,98
ZAF,MEX,2012.0,1,0,1
NPL,AUS,2010.0,8,0,8
BEN,BWA,2007.0,1,0,1
LKA,ARE,2018.0,2,0,2
THA,MYS,2011.0,5,0,5
,GTM,2007.0,31,0,31
,YEM,2006.0,25,0,25
KWT,,2015.0,149,0,149
FIN,,2006.0,777,0,777
ZWE,,2015.0,31,0,31
,UZB,1995.0,146,0,146
CAN,PAN,2022.0,2,0,2
DEU,LBN,2005.0,2,0,2
,SLE,2013.0,29,0,29
UKR,FIN,2017.0,3,0,3
,MLI,2009.0,57,0,57
,AFG,2015.0,19,0,19
GUY,,2023.0,23,0,23
SLE,,2022.0,35,0,35
BGR,DEU,2022.0,3,0,3
AUT,IDN,2008.0,1,0,1
,SWZ,2018.0,13,0,13
PAN,CAN,2009.0,3,0,3
FIN,THA,2019.0,3,0,3
PRK,KOR,2019.0,2,0,2
LUX,,2012.0,35,0,35
CUB,,2004.0,242,0,242
USA,MRT,2004.0,1,0,1
CIV,,2007.0,22,0,22
,MUS,1997.0,5,0,5
DEU,LIE,2010.0,2,0,2
CUB,ARG,2001.0,1,0,1
LVA,,2004.0,29,0,29
NER,BFA,2015.0,3,0,3
,OMN,2002.0,67,0,67
ZMB,,2003.0,4,0,4
GBR,MUS,2010.0,2,0,2
CAF,,2010.0,4,0,4
MKD,NLD,2012.0,2,0,2
,PRY,2000.0,3,0,3
CAF,,2017.0,10,0,10
TJK,USA,2022.0,2,0,2
DEU,CYP,2009.0,5,0,5
GMB,BEN,2011.0,1,0,1
ETH,UGA,2003.0,2,0,2
PSE,GRC,2006.0,2,0,2
TUN,BHR,2021.0,3,0,3
,MNE,2000.0,8,0,8
THA,,2000.0,7,0,7
GRC,CYP,1999.0,4,0,4
NLD,NER,2002.0,2,0,2
BGR,UKR,2005.0,1,0,1
,NCL,1998.0,17,0,17
MDA,,2003.0,25,0,25
RUS,SGP,2001.0,5,0,5
IND,PNG,2019.0,4,0,4
AUT,TWN,2003.0,1,0,1
UKR,NZL,2018.0,1,0,1
ITA,MCO,2009.0,1,0,1
FRA,MRT,2004.0,2,0,2
KEN,SGP,2008.0,1,0,1
AUT,PER,2006.0,1,0,1
NLD,CRI,2007.0,2,0,2
ZWE,HKG,2001.0,1,0,1
LBN,SAU,2011.0,1,0,1
AUS,MEX,1998.0,1,0,1
UKR,BEL,2010.0,3,0,3
CHE,NPL,2003.0,1,0,1
,PSE,1998.0,23,0,23
NLD,ETH,1998.0,1,0,1
CRI,SWE,2003.0,2,0,2
FIN,ISR,2000.0,1,0,1
MNE,,2020.0,51,0,51
IRN,BGR,2018.0,1,0,1
ITA,VNM,1999.0,1,0,1
NIC,USA,2007.0,3,0,3
NLD,UZB,2001.0,1,0,1
POL,LBY,2008.0,1,0,1
DEU,ISL,2003.0,2,0,2
IRN,SGP,2009.0,4,0,4
ETH,TTO,2011.0,1,0,1
NGA,KEN,2011.0,2,0,2
YEM,SAU,2011.0,3,0,3
MRT,FRA,2010.0,1,0,1
TZA,BWA,2018.0,2,0,2
FIN,PSE,2019.0,1,0,1
ZMB,CHE,2011.0,1,0,1
,GUM,2009.0,8,0,8
BLR,ITA,2014.0,3,0,3
,GIN,2010.0,14,0,14
ITA,PSE,2016.0,3,0,3
CAF,,2019.0,9,0,9
CHN,DZA,2015.0,2,0,2
NOR,BGR,2016.0,1,0,1
NZL,OMN,2003.0,2,0,2
ETH,SLE,2021.0,1,0,1
AUT,SAU,2021.0,1,0,1
ITA,SYC,2022.0,1,0,1
NZL,TWN,2006.0,3,0,3
IND,SLB,2018.0,1,0,1
ROU,IRQ,2018.0,8,0,8
,BFA,2019.0,50,0,50
KAZ,HUN,2019.0,3,0,3
GHA,TZA,2021.0,2,0,2
IDN,,2002.0,11,0,11
,GUY,2017.0,5,0,5
IDN,,2005.0,55,0,55
CHL,ZAF,2019.0,3,0,3
GBR,NCL,2000.0,1,0,1
BEN,NLD,2005.0,1,0,1
CZE,PRI,2003.0,1,0,1
ARM,MYS,2008.0,3,0,3
KNA,,2012.0,1,0,1
NLD,ALB,2004.0,1,0,1
BEL,MEX,2020.0,5,0,5
,CPV,2015.0,8,0,8
KHM,NZL,2020.0,2,0,2
NZL,ZMB,2020.0,1,0,1
ECU,MAR,2021.0,1,0,1
TUR,HUN,2020.0,1,0,1
,MDG,2009.0,75,0,75
SWE,IDN,2017.0,5,0,5
LTU,THA,2018.0,1,0,1
VEN,ARG,2021.0,3,0,3
ETH,,2006.0,25,0,25
MEX,EST,2021.0,1,0,1
EGY,AUT,2003.0,2,0,2
PRT,SVN,2022.0,1,0,1
KHM,ZAF,2015.0,1,0,1
AFG,,2016.0,9,0,9
FLK,POL,2008.0,1,0,1
,DJI,2000.0,3,0,3
UKR,PSE,2002.0,1,0,1
SYC,,2006.0,2,0,2
SVK,BEL,2001.0,2,0,2
PHL,BLR,2012.0,1,0,1
BOL,,2000.0,2,0,2
,ERI,1996.0,3,0,3
THA,VNM,2003.0,3,0,3
USA,MAC,2005.0,1,0,1
HUN,ISR,2001.0,3,0,3
TUR,UZB,2016.0,3,0,3
BOL,FRA,2000.0,3,0,3
LIE,,2004.0,3,0,3
IRL,ARG,2004.0,1,0,1
BEL,SYC,2021.0,1,0,1
AGO,,2014.0,8,0,8
AUT,BIH,2004.0,2,0,2
AUS,LBN,2002.0,4,0,4
IRQ,ESP,2011.0,1,0,1
KWT,SGP,2006.0,1,0,1
SVK,VNM,2014.0,1,0,1
KOR,SRB,2007.0,1,0,1
ZAF,COL,2010.0,2,0,2
,RWA,2003.0,8,0,8
USA,KIR,2013.0,1,0,1
SWE,PNG,2004.0,2,0,2
,ERI,2004.0,20,0,20
RUS,KGZ,1999.0,1,0,1
MEX,ISR,2009.0,3,0,3
MEX,DOM,2012.0,2,0,2
TZA,COD,2015.0,1,0,1
PAK,SGP,2001.0,2,0,2
MYS,SVK,2019.0,1,0,1
PAK,QAT,2010.0,2,0,2
IRN,GRC,2012.0,1,0,1
,MHL,2010.0,1,0,1
,GUY,2010.0,8,0,8
BHR,SDN,2020.0,1,0,1
FJI,BRN,2002.0,1,0,1
TUR,QAT,2014.0,1,0,1
EGY,TJK,2021.0,1,0,1
JPN,MMR,2015.0,2,0,2
POL,KGZ,2020.0,1,0,1
POL,MNG,2008.0,1,0,1
ISR,BEL,2007.0,4,0,4
FRO,,2014.0,2,0,2
CRI,,2001.0,3,0,3
SYR,EGY,2017.0,2,0,2
IND,MDV,2014.0,1,0,1
ESP,CRI,2007.0,2,0,2
DEU,MOZ,2020.0,1,0,1
,PYF,2007.0,10,0,10
GBR,BRN,2017.0,9,0,9
MAR,LVA,2020.0,1,0,1
PSE,QAT,2018.0,1,0,1
PNG,AUS,1999.0,1,0,1
EST,BGD,2022.0,1,0,1
DNK,GNB,2021.0,6,0,6
GBR,COL,1998.0,1,0,1
CHL,HKG,2012.0,2,0,2
TON,,2023.0,6,0,6
DEU,LIE,2017.0,3,0,3
BWA,NGA,2018.0,2,0,2
CAN,OMN,1997.0,1,0,1
KOR,PRT,2009.0,2,0,2
KOR,NGA,2006.0,2,0,2
FIN,BRA,2002.0,2,0,2
SRB,SVN,2003.0,2,0,2
SAU,TUR,1998.0,2,0,2
AGO,FIN,2012.0,1,0,1
AZE,BEL,2011.0,1,0,1
NZL,CHN,2000.0,1,0,1
FIN,NOR,1998.0,1,0,1
NZL,JOR,2014.0,1,0,1
SGP,ZAF,1997.0,1,0,1
SYR,EGY,2010.0,1,0,1
ESP,KOR,2006.0,2,0,2
BRA,LBN,2005.0,1,0,1
ESP,QAT,2012.0,2,0,2
FRA,QAT,2022.0,2,0,2
TJK,UZB,2002.0,1,0,1
FIN,SGP,2005.0,1,0,1
TWN,AZE,2016.0,2,0,2
JPN,SYR,2010.0,2,0,2
GHA,CZE,2011.0,1,0,1
FIN,CMR,2015.0,1,0,1
,FSM,2007.0,4,0,4
LAO,BRN,2022.0,1,0,1
TUN,ARE,2011.0,3,0,3
GBR,SSD,2014.0,1,0,1
RUS,EST,2015.0,2,0,2
TWN,CZE,2019.0,1,0,1
UKR,BEL,2017.0,2,0,2
LTU,AUS,2016.0,1,0,1
BHR,USA,2022.0,1,0,1
LBN,PAK,2005.0,1,0,1
ARE,IRN,2010.0,1,0,1
BLR,IND,2000.0,1,0,1
MDA,POL,1997.0,1,0,1
NER,GBR,1999.0,1,0,1
AUT,NGA,2018.0,1,0,1
NGA,POL,2013.0,3,0,3
GMB,PRT,2018.0,1,0,1
USA,BLR,2017.0,3,0,3
BGR,PRT,1997.0,1,0,1
GBR,ZMB,2003.0,3,0,3
RUS,MNG,2000.0,2,0,2
KAZ,LVA,2016.0,2,0,2
BGD,KOR,2000.0,1,0,1
AZE,CAN,2005.0,1,0,1
NZL,WSM,2020.0,2,0,2
IDN,FIN,2001.0,1,0,1
ZMB,ETH,2014.0,1,0,1
IND,JOR,1999.0,2,0,2
SVK,LTU,2017.0,1,0,1
ECU,NOR,2022.0,1,0,1
AUS,LUX,2014.0,1,0,1
ECU,MYS,2015.0,1,0,1
,BMU,2008.0,6,0,6
SYR,NZL,2014.0,2,0,2
,AIA,2011.0,1,0,1
BWA,DEU,2018.0,1,0,1
GRC,MNE,2015.0,1,0,1
BGR,KGZ,2020.0,1,0,1
TJK,,2025.0,1,0,1
BEL,CRI,2021.0,1,0,1
UKR,FIN,2010.0,3,0,3
FIN,EGY,2011.0,2,0,2
IRL,SWZ,2011.0,1,0,1
PRT,MOZ,2014.0,1,0,1
PSE,IRL,2020.0,1,0,1
SEN,IND,2012.0,1,0,1
CUB,GBR,2005.0,3,0,3
TWN,SEN,2013.0,1,0,1
IRN,CHE,1999.0,1,0,1
MDA,POL,1998.0,1,0,1
NOR,LTU,2005.0,1,0,1
AZE,PRT,2022.0,3,0,3
DZA,SWE,2005.0,1,0,1
ZMB,ZAF,2007.0,2,0,2
UGA,COL,2000.0,1,0,1
AUT,MKD,2015.0,1,0,1
MCO,FIN,2016.0,1,0,1
SGP,ESP,2007.0,2,0,2
CHL,RUS,2018.0,2,0,2
SWZ,TWN,2010.0,1,0,1
JPN,PRY,2015.0,2,0,2
CUB,AGO,2015.0,2,0,2
FRA,MLT,2013.0,1,0,1
TUN,IND,2018.0,3,0,3
ARG,AUT,2018.0,5,0,5
HKG,CYP,2012.0,1,0,1
ARM,GRC,2000.0,1,0,1
BGR,CAN,2014.0,1,0,1
,GIN,2019.0,5,0,5
KEN,RWA,2008.0,1,0,1
,GLP,2000.0,4,0,4
DEU,YEM,2020.0,3,0,3
BOL,PER,2021.0,1,0,1
LBY,FRA,2005.0,1,0,1
THA,CHE,2002.0,4,0,4
DEU,OMN,2016.0,5,0,5
CHL,SWE,2003.0,2,0,2
LKA,GRC,2009.0,1,0,1
RUS,LVA,2018.0,1,0,1
ISR,POL,2009.0,3,0,3
DEU,PAN,2008.0,1,0,1
NOR,ISL,1999.0,1,0,1
DZA,ROU,2000.0,1,0,1
IRL,SRB,2007.0,1,0,1
PAK,IND,1999.0,1,0,1
SDN,BRA,1999.0,1,0,1
LSO,,2006.0,1,0,1
UGA,IRL,2016.0,1,0,1
GHA,TUR,2021.0,1,0,1
FIN,NPL,2008.0,1,0,1
SDN,KHM,2008.0,1,0,1
EGY,ZWE,2012.0,1,0,1
ISR,MEX,2014.0,1,0,1
BGR,TUR,2013.0,2,0,2
ARE,CYP,2016.0,1,0,1
NIC,,2001.0,1,0,1
NCL,,2002.0,1,0,1
FRA,COD,2021.0,1,0,1
TLS,JPN,2009.0,1,0,1
PRT,AGO,2018.0,1,0,1
TUR,RWA,2022.0,2,0,2
GIN,BEN,2021.0,1,0,1
SLV,SVN,2003.0,1,0,1
CMR,CAN,2006.0,3,0,3
MYS,BGR,2017.0,1,0,1
ZMB,NLD,2013.0,3,0,3
AUT,ARG,2015.0,6,0,6
BWA,NAM,2017.0,1,0,1
PNG,PAK,2010.0,1,0,1
VEN,PRY,2021.0,1,0,1
TUR,KWT,2014.0,1,0,1
PLW,GUM,2017.0,1,0,1
NPL,AUT,2016.0,2,0,2
PER,FRA,2001.0,1,0,1
AUS,MWI,2004.0,1,0,1
AZE,ESP,2017.0,1,0,1
DNK,THA,2012.0,2,0,2
UZB,ISR,2007.0,2,0,2
ROU,ZAF,1999.0,1,0,1
MDG,SEN,2004.0,1,0,1
DEU,ALB,2009.0,4,0,4
ZMB,CAN,2014.0,1,0,1
CHN,UKR,2007.0,2,0,2
NLD,COL,2008.0,3,0,3
MYS,AUT,2016.0,1,0,1
GRC,KAZ,2015.0,1,0,1
JAM,TTO,2006.0,2,0,2
BLR,NLD,2014.0,1,0,1
MMR,PHL,2009.0,1,0,1
COL,HRV,2017.0,1,0,1
IND,SRB,2015.0,1,0,1
ROU,CZE,2022.0,1,0,1
TUN,ZAF,2022.0,1,0,1
IND,RWA,2022.0,1,0,1
,ATA,2015.0,1,0,1
MDG,NLD,2021.0,1,0,1
RUS,MAR,2022.0,1,0,1
MAR,LUX,2012.0,1,0,1
DEU,MAR,1997.0,1,0,1
FSM,,2008.0,1,0,1
VEN,GTM,2019.0,1,0,1
GNB,GIN,2015.0,1,0,1
LBN,NOR,2022.0,1,0,1
LVA,FIN,2016.0,1,0,1
SRB,LVA,2019.0,2,0,2
SLE,NZL,2016.0,1,0,1
IRL,LVA,2010.0,1,0,1
POL,CHN,1997.0,1,0,1
CHN,SUR,2018.0,1,0,1
MYS,NPL,2013.0,1,0,1
TWN,OMN,1999.0,1,0,1
MAR,JOR,2012.0,1,0,1
TGO,CHN,2021.0,1,0,1
NLD,PER,2012.0,1,0,1
ESP,MDA,2017.0,1,0,1
BGR,SWE,2018.0,1,0,1
KEN,AUT,2016.0,1,0,1
KEN,ESP,2022.0,2,0,2
KAZ,BGR,2018.0,3,0,3
ROU,NPL,2021.0,1,0,1
MYS,BHS,2018.0,1,0,1
MEX,NIC,2016.0,1,0,1
SMR,ITA,2003.0,1,0,1
ARM,AUS,2008.0,1,0,1
KAZ,CAN,2022.0,2,0,2
CZE,ROU,1999.0,1,0,1
SAU,ZMB,2022.0,1,0,1
ERI,GBR,2002.0,1,0,1
GBR,CUB,2021.0,1,0,1
BWA,GBR,2013.0,1,0,1
SYR,SDN,2012.0,1,0,1
ITA,ECU,1997.0,1,0,1
GRC,SAU,2015.0,4,0,4
GHA,DNK,2001.0,1,0,1
NOR,GRC,2004.0,1,0,1
BGD,PHL,2003.0,1,0,1
KOR,IRQ,2009.0,1,0,1
ZMB,TZA,2013.0,1,0,1
ARE,BGD,2022.0,1,0,1
TUR,CHL,2012.0,1,0,1
MEX,CYP,2014.0,1,0,1
ZAF,MYS,2017.0,2,0,2
NAM,GHA,2022.0,1,0,1
SLB,USA,2018.0,1,0,1
MCO,LUX,2020.0,1,0,1
MDG,ROU,2005.0,1,0,1
,LCA,2019.0,2,0,2
MNG,,2006.0,1,0,1
DEU,MAR,1998.0,1,0,1
ISR,LBN,2008.0,1,0,1
KEN,IDN,2015.0,2,0,2
BRN,LKA,2015.0,1,0,1
IRN,PSE,2021.0,1,0,1
CZE,NAM,2021.0,1,0,1
AUS,CMR,2020.0,1,0,1
CAN,VNM,2008.0,3,0,3
VNM,LAO,2020.0,2,0,2
TUR,GHA,2017.0,1,0,1
MDA,USA,2000.0,1,0,1
NGA,MYS,2007.0,1,0,1
ROU,POL,1999.0,1,0,1
RUS,TKM,2010.0,1,0,1
ITA,BHR,2011.0,1,0,1
CZE,NOR,1998.0,1,0,1
KAZ,KGZ,2010.0,1,0,1
TWN,ARG,2007.0,1,0,1
KHM,JPN,2006.0,2,0,2
ISR,EST,2012.0,1,0,1
MYS,KGZ,2018.0,1,0,1
DEU,MLT,2014.0,2,0,2
BTN,CHN,2016.0,1,0,1
ROU,PAK,2018.0,1,0,1
GBR,LVA,2014.0,2,0,2
HKG,EGY,2020.0,1,0,1
,MHL,2017.0,1,0,1
NOR,GHA,2004.0,2,0,2
ZWE,NLD,1998.0,1,0,1
UKR,BEL,2019.0,2,0,2
JAM,DEU,2007.0,1,0,1
ZAF,COL,2017.0,1,0,1
BEL,JOR,2018.0,2,0,2
TGO,FRA,2000.0,1,0,1
CRI,POL,2021.0,1,0,1
AFG,NOR,2019.0,1,0,1
GAB,REU,2017.0,1,0,1
FRA,FJI,2013.0,1,0,1
,PSE,1997.0,3,0,3
EST,NLD,1999.0,1,0,1
POL,LKA,2014.0,2,0,2
HKG,NLD,2004.0,1,0,1
AUS,GAB,2012.0,1,0,1
SDN,IRN,2006.0,1,0,1
GRC,NPL,2017.0,1,0,1
TWN,IRL,2018.0,1,0,1
AUS,QAT,2006.0,1,0,1
NGA,HKG,2015.0,1,0,1
FRA,COG,2000.0,1,0,1
,GUY,2019.0,2,0,2
,NAM,1995.0,1,0,1
NGA,TUR,2011.0,1,0,1
TUR,CMR,2022.0,1,0,1
CHE,CIV,2018.0,1,0,1
LBR,SLE,2019.0,1,0,1
COG,CAF,2012.0,2,0,2
MLI,IND,2022.0,1,0,1
BLR,CZE,2009.0,2,0,2
SRB,TWN,2018.0,1,0,1
BEL,SVK,1999.0,1,0,1
LUX,MEX,2014.0,1,0,1
GRC,NPL,2010.0,1,0,1
CRI,NOR,2009.0,1,0,1
KGZ,ESP,2021.0,1,0,1
POL,ROU,2006.0,1,0,1
SWE,URY,2001.0,1,0,1
GBR,GEO,1997.0,1,0,1
BWA,USA,1997.0,1,0,1
ITA,BLR,2016.0,2,0,2
ALB,TUR,2011.0,1,0,1
BIH,CHE,2011.0,1,0,1
FIN,SYR,2010.0,1,0,1
EGY,IDN,2018.0,1,0,1
LTU,KOR,2012.0,1,0,1
LBN,TUN,2014.0,1,0,1
IND,PNG,2010.0,1,0,1
TUN,NER,2012.0,1,0,1
NGA,MWI,2018.0,1,0,1
BFA,SEN,2005.0,1,0,1
AUS,KAZ,2012.0,1,0,1
MDG,BRA,2017.0,1,0,1
SVN,TUR,2015.0,1,0,1
UGA,CZE,2016.0,1,0,1
ECU,BRA,2006.0,1,0,1
TWN,SDN,2019.0,1,0,1
HND,MEX,2021.0,1,0,1
ERI,IRL,2001.0,1,0,1
,KIR,2011.0,1,0,1
AUT,EST,2014.0,1,0,1
ZAF,PNG,2019.0,1,0,1
POL,QAT,2016.0,1,0,1
SWE,PSE,2021.0,1,0,1
IDN,LTU,2020.0,1,0,1
BRN,BGD,2017.0,1,0,1
ISR,ROU,2007.0,1,0,1
BEN,BFA,2018.0,1,0,1
SWZ,AUS,2010.0,1,0,1
MMR,DEU,2019.0,1,0,1
PRT,PAK,2009.0,1,0,1
MAR,TCD,2016.0,1,0,1
URY,CHL,2002.0,1,0,1
USA,VNM,1998.0,3,0,3
FIN,BRB,2007.0,1,0,1
NOR,BWA,2009.0,1,0,1
MEX,SVN,2014.0,1,0,1
IRN,HKG,2005.0,1,0,1
ZMB,GHA,2006.0,1,0,1
ESP,BFA,2005.0,1,0,1
AGO,FRA,2001.0,1,0,1
DOM,RUS,2007.0,1,0,1
BEL,PRY,2007.0,1,0,1
JPN,CYP,1999.0,1,0,1
GLP,GUM,2005.0,1,0,1
IDN,TZA,2022.0,1,0,1
CHN,CMR,2005.0,1,0,1
NCL,,2005.0,1,0,1
HKG,SRB,2005.0,1,0,1
NZL,KEN,1998.0,1,0,1
VNM,NAM,2021.0,1,0,1
NGA,EST,2020.0,1,0,1
EST,CAN,2009.0,1,0,1
JOR,CHE,2014.0,1,0,1
MYS,CHL,2004.0,1,0,1
ROU,LTU,2009.0,1,0,1
,TKM,1999.0,2,0,2
PRI,PAN,2008.0,1,0,1
SAU,ZAF,2001.0,1,0,1
SDN,,2001.0,1,0,1
ARG,IRN,2016.0,1,0,1
BIH,ARE,2005.0,1,0,1
VUT,USA,2022.0,1,0,1
GRC,ISR,2015.0,1,0,1
EGY,MEX,2017.0,1,0,1
SVK,ARM,2003.0,1,0,1
BEL,GIN,2020.0,1,0,1
COL,POL,2022.0,1,0,1
IND,ISL,2016.0,1,0,1
TJK,IRN,2019.0,1,0,1
MYS,LAO,2020.0,1,0,1
ITA,BIH,2017.0,1,0,1
BRA,MYS,1999.0,1,0,1
ZAF,HRV,2008.0,1,0,1
SWZ,AUS,2019.0,1,0,1
SYR,EGY,2019.0,1,0,1
ZAF,FIN,2008.0,1,0,1
BOL,CZE,2016.0,1,0,1
NPL,BGD,2018.0,1,0,1
CUB,DOM,2015.0,1,0,1
BEN,KOR,2022.0,1,0,1
HRV,RUS,2021.0,1,0,1
USA,GBR,2009.0,1256,1280,-24
GBR,NZL,2012.0,160,94,66
USA,LBN,2010.0,36,52,-16
SWE,JPN,2003.0,30,22,8
GBR,USA,2012.0,1490,1296,194
KOR,USA,2011.0,692,874,-182
JPN,USA,2014.0,725,806,-81
AUS,THA,2020.0,36,16,20
FRA,BEL,2003.0,136,145,-9
TUR,CHE,2011.0,17,11,6
AUS,PAK,2014.0,17,30,-13
CHE,USA,2004.0,296,377,-81
ESP,FIN,2014.0,23,4,19
ESP,DEU,2010.0,145,143,2
SGP,NZL,2005.0,7,3,4
GBR,AUS,2007.0,442,366,76
SGP,CHN,2013.0,216,196,20
CHE,DEU,2016.0,435,626,-191
DNK,USA,2012.0,94,105,-11
AUS,IRL,2008.0,30,24,6
COL,BRA,2004.0,9,6,3
PAK,CHE,2008.0,1,1,0
USA,NZL,2007.0,110,83,27
CZE,ESP,2017.0,13,19,-6
DEU,GBR,2020.0,579,660,-81
USA,TUR,2009.0,197,173,24
USA,PER,2014.0,36,34,2
CHL,USA,2014.0,96,118,-22
USA,CHN,2006.0,719,1021,-302
JPN,CAN,2014.0,80,63,17
PRT,IRL,2012.0,5,5,0
ESP,AUS,2019.0,41,41,0
AUS,GBR,2016.0,530,575,-45
NOR,DEU,2016.0,46,76,-30
AUS,USA,2001.0,339,249,90
JPN,ARE,2019.0,7,2,5
FRA,ESP,2007.0,152,136,16
CAN,AUS,2014.0,174,132,42
USA,KOR,2001.0,369,284,85
ESP,AUS,2017.0,53,21,32
FRA,CHE,2013.0,317,197,120
BEL,CAN,2015.0,42,30,12
NLD,GBR,2008.0,175,126,49
BRA,IRL,2018.0,13,4,9
CZE,DEU,2014.0,47,46,1
ESP,AUT,2016.0,31,21,10
GBR,CHN,2007.0,138,112,26
RUS,POL,2011.0,12,6,6
ZAF,DEU,2020.0,45,36,9
ESP,ITA,2013.0,148,152,-4
SAU,MYS,2015.0,15,62,-47
CAN,DEU,2006.0,89,142,-53
CAN,SAU,2006.0,27,17,10
IND,USA,2016.0,1046,671,375
ESP,ARG,2011.0,74,78,-4
SAU,ARE,2007.0,10,3,7
IND,CZE,2009.0,5,2,3
GBR,JOR,2015.0,30,11,19
ESP,USA,2003.0,291,296,-5
USA,BRA,2018.0,369,587,-218
USA,ZAF,2007.0,47,56,-9
AUT,GBR,2005.0,45,39,6
JPN,ESP,2017.0,12,20,-8
FRA,NLD,2007.0,85,95,-10
JPN,GBR,2014.0,100,119,-19
FRA,JPN,2015.0,96,72,24
NZL,RUS,2016.0,2,1,1
USA,CHE,2003.0,368,337,31
ISR,FRA,2011.0,15,15,0
BRA,PRT,2021.0,127,91,36
PAN,USA,2014.0,15,12,3
RUS,PRT,2020.0,6,2,4
MEX,USA,2019.0,232,203,29
GBR,MYS,2012.0,155,55,100
VEN,COL,2020.0,29,13,16
HKG,AUS,2018.0,52,36,16
CHE,ITA,2016.0,96,282,-186
CAN,AUT,2014.0,23,22,1
CHN,DEU,2017.0,341,333,8
CHN,SAU,2020.0,51,46,5
HKG,USA,2014.0,110,141,-31
CHN,DEU,2019.0,389,394,-5
IRN,AUS,2016.0,147,35,112
GTM,USA,2013.0,13,5,8
FRA,SEN,2016.0,33,23,10
DEU,AUT,2006.0,237,174,63
NLD,ESP,2018.0,61,75,-14
IND,SAU,2022.0,21,23,-2
GBR,KOR,2016.0,36,65,-29
CHE,NOR,2010.0,11,14,-3
TWN,JPN,2021.0,34,46,-12
DEU,FIN,2013.0,36,36,0
QAT,USA,2020.0,60,51,9
POL,NLD,2017.0,23,19,4
ESP,GBR,2022.0,129,160,-31
ROU,DEU,2014.0,26,12,14
CHE,SGP,2018.0,16,17,-1
MEX,USA,2017.0,237,168,69
ZAF,UGA,2016.0,14,7,7
JPN,TWN,2014.0,36,40,-4
AUS,CAN,2020.0,181,145,36
CZE,CHN,2016.0,8,8,0
ITA,SWE,2018.0,77,38,39
DEU,GRC,2015.0,36,68,-32
THA,IND,2011.0,4,4,0
IRN,ITA,2015.0,37,10,27
GRC,CHE,2022.0,8,13,-5
JAM,CAN,2016.0,4,1,3
PAK,CHN,2012.0,35,37,-2
SVK,CZE,2018.0,68,44,24
HUN,FRA,2020.0,16,6,10
ESP,DEU,2019.0,218,190,28
CHN,IRL,2015.0,21,17,4
RUS,NLD,2014.0,15,11,4
MYS,IRN,2015.0,122,37,85
SGP,KOR,2021.0,25,20,5
FRA,IDN,2018.0,17,6,11
BGD,JPN,2014.0,42,60,-18
FRA,BFA,2015.0,14,22,-8
SAU,EGY,2013.0,126,190,-64
ITA,CHN,2018.0,42,32,10
LTU,DEU,2017.0,7,4,3
IRL,AUS,2012.0,59,32,27
KOR,TWN,2013.0,8,15,-7
IND,KOR,1999.0,7,3,4
CHL,CHN,2015.0,7,1,6
ECU,GBR,2021.0,2,1,1
POL,NLD,2019.0,17,19,-2
AUS,MYS,2022.0,26,33,-7
CHE,GBR,2007.0,165,142,23
RUS,CHN,2014.0,7,9,-2
IND,BEL,2004.0,6,1,5
SLE,USA,2015.0,5,3,2
ESP,TUN,2021.0,4,9,-5
BRA,FIN,2018.0,11,4,7
NLD,CHN,2020.0,153,158,-5
NLD,CAN,2020.0,56,61,-5
NOR,USA,2014.0,69,77,-8
CHL,FRA,2017.0,24,52,-28
SAU,CZE,2019.0,3,4,-1
IND,DEU,2013.0,133,111,22
MEX,PER,2018.0,7,5,2
CZE,ESP,2010.0,9,7,2
HKG,JPN,2020.0,18,11,7
AUS,NOR,2021.0,17,11,6
GBR,MLT,2001.0,5,1,4
MYS,PAK,2022.0,52,29,23
CAN,NLD,2000.0,9,14,-5
CHL,FRA,2019.0,32,33,-1
CAN,ARE,2018.0,27,27,0
ISR,RUS,2021.0,3,16,-13
GBR,EGY,2021.0,39,47,-8
ARG,CUB,2015.0,4,2,2
LBN,CAN,2019.0,15,16,-1
CHE,SAU,2020.0,8,2,6
USA,TWN,2021.0,133,157,-24
ROU,FRA,2020.0,22,22,0
PHL,MYS,2022.0,1,2,-1
USA,LBN,2017.0,48,72,-24
USA,BGR,2021.0,5,1,4
SWE,CAN,2019.0,39,43,-4
ZAF,NZL,2019.0,15,4,11
IRQ,USA,2015.0,8,11,-3
CHL,ESP,2022.0,32,35,-3
VNM,KOR,2018.0,27,100,-73
CZE,GBR,2021.0,26,45,-19
PAK,TUR,2019.0,6,19,-13
VNM,CZE,2021.0,5,4,1
NZL,PHL,2019.0,2,5,-3
OMN,TUN,2006.0,1,2,-1
GBR,KEN,2022.0,13,12,1
CHL,BEL,2016.0,6,8,-2
RUS,CAN,2001.0,26,11,15
CHN,THA,2015.0,9,14,-5
KEN,GHA,2022.0,2,2,0
SVK,USA,2001.0,15,6,9
PAK,BRA,2015.0,8,9,-1
TUR,AUS,2016.0,3,8,-5
CHL,MYS,2019.0,1,1,0
MEX,FRA,2016.0,42,47,-5
JPN,BGD,2012.0,65,34,31
FRA,ROU,2018.0,23,16,7
CAN,PAK,2022.0,9,16,-7
MYS,JPN,2016.0,24,61,-37
DEU,CZE,2011.0,32,42,-10
MYS,BRN,2012.0,5,3,2
EGY,KOR,2016.0,3,4,-1
FRA,MAR,2001.0,54,40,14
ITA,ISL,2012.0,1,1,0
NZL,DEU,2016.0,25,19,6
CZE,AUT,2004.0,13,6,7
CUB,USA,2009.0,8,4,4
LKA,AUS,2010.0,15,2,13
EST,FIN,2010.0,6,4,2
FRA,QAT,2016.0,14,5,9
SGP,IND,2013.0,57,65,-8
THA,USA,2011.0,101,204,-103
JPN,CHE,2005.0,31,19,12
ARE,KOR,2014.0,1,7,-6
FRA,URY,2011.0,5,4,1
NOR,CZE,2018.0,4,8,-4
FRA,NCL,2007.0,11,8,3
ESP,SWE,2003.0,23,19,4
MYS,USA,2000.0,3,2,1
POL,DEU,2011.0,78,173,-95
DNK,TUR,2021.0,3,5,-2
USA,FIN,2005.0,63,60,3
DEU,POL,2012.0,115,69,46
HKG,CHE,2006.0,2,3,-1
HKG,ZAF,1999.0,1,2,-1
KOR,DNK,2014.0,11,1,10
POL,NLD,2010.0,25,19,6
NLD,AUS,2003.0,31,35,-4
CHN,IND,2011.0,8,22,-14
USA,PAK,2015.0,72,85,-13
TUR,CAN,2014.0,16,25,-9
BEL,SGP,2017.0,6,4,2
NLD,NOR,2007.0,11,13,-2
POL,FIN,2021.0,6,8,-2
UKR,ESP,2005.0,4,1,3
RUS,LVA,2019.0,3,1,2
EGY,AUT,2001.0,3,1,2
KOR,SGP,2016.0,41,24,17
MAR,CAN,2017.0,6,14,-8
ITA,MEX,1998.0,4,2,2
IRN,NOR,2021.0,25,5,20
SWE,RUS,2002.0,29,36,-7
CZE,RUS,2018.0,10,9,1
MAR,CAN,2019.0,9,6,3
TUR,IRN,2018.0,15,26,-11
EST,FIN,2019.0,14,11,3
IND,AUS,2014.0,97,53,44
CHE,NOR,2017.0,17,15,2
ROU,CZE,2016.0,1,2,-1
ARG,DEU,2020.0,29,18,11
GBR,CHL,2022.0,17,19,-2
TWN,CAN,2003.0,6,14,-8
CHL,COL,2020.0,23,38,-15
BTN,IND,2017.0,2,4,-2
NPL,AUS,2018.0,9,4,5
CZE,HUN,2020.0,6,8,-2
IRL,CHE,2022.0,5,6,-1
LBN,USA,2007.0,34,25,9
BRA,PRY,2017.0,7,3,4
THA,DEU,2016.0,11,22,-11
EGY,JPN,2006.0,13,31,-18
SVK,NLD,2005.0,3,1,2
ESP,IND,2006.0,7,15,-8
CYP,TUR,2021.0,41,42,-1
CHE,PAK,2021.0,3,7,-4
IRN,ETH,2021.0,4,2,2
ETH,TWN,2019.0,5,5,0
ITA,IRL,2021.0,34,20,14
LBN,DEU,2019.0,10,3,7
LTU,DNK,2020.0,2,1,1
CZE,TUR,2020.0,5,11,-6
DEU,LUX,2001.0,3,1,2
CHE,ISR,2012.0,8,16,-8
ARE,GBR,2022.0,12,28,-16
ITA,LTU,2021.0,2,3,-1
YEM,MYS,2022.0,3,4,-1
JPN,BRA,2021.0,4,9,-5
PRT,KOR,2019.0,1,4,-3
JPN,ESP,2010.0,17,20,-3
USA,CUB,2018.0,8,14,-6
CZE,NZL,2019.0,2,2,0
SRB,HRV,2020.0,7,7,0
RUS,AUS,2008.0,7,2,5
IND,NOR,2016.0,13,9,4
ESP,CUB,2010.0,12,26,-14
SVK,FRA,2010.0,3,4,-1
DEU,SYR,2016.0,1,1,0
EGY,ARE,2008.0,5,5,0
MLT,ITA,2016.0,3,4,-1
ZAF,CHE,2012.0,8,12,-4
RUS,FIN,1999.0,9,5,4
IRQ,MYS,2013.0,5,36,-31
USA,FIN,2002.0,99,67,32
PRT,DEU,2009.0,25,23,2
AUS,ZAF,2003.0,13,34,-21
VEN,PER,2014.0,1,1,0
ESP,CAN,2013.0,61,40,21
ZAF,NGA,2012.0,23,36,-13
MEX,CHL,2011.0,18,8,10
GRC,CHN,2018.0,4,3,1
UKR,CHE,2002.0,5,1,4
BRA,GBR,2001.0,43,40,3
BRA,URY,2015.0,6,10,-4
PRT,IND,2005.0,3,9,-6
RUS,ZAF,2010.0,3,3,0
ETH,ZAF,2015.0,7,4,3
BGD,SAU,2012.0,4,4,0
DNK,ITA,2008.0,15,17,-2
IRL,FRA,2000.0,1,7,-6
DEU,EGY,2018.0,56,29,27
IDN,FRA,2002.0,3,4,-1
RUS,IND,2002.0,9,2,7
SVK,AUT,2002.0,7,8,-1
JPN,CHE,2002.0,35,23,12
ITA,AUT,2001.0,17,11,6
CHE,HUN,2005.0,5,10,-5
USA,GRC,1997.0,18,7,11
PER,FRA,2003.0,3,2,1
GAB,FRA,2003.0,9,3,6
FRA,BEN,2009.0,11,7,4
NLD,POL,2001.0,5,6,-1
GBR,LVA,2004.0,5,4,1
GRC,BGR,1999.0,3,1,2
DNK,SWE,2000.0,21,16,5
DEU,ISR,2001.0,22,26,-4
FRA,CMR,2005.0,11,9,2
USA,KWT,2006.0,20,8,12
FRA,CMR,2002.0,13,11,2
JOR,DEU,1999.0,1,1,0
LTU,DEU,2010.0,4,6,-2
BGR,FRA,2010.0,7,5,2
ZWE,USA,2002.0,9,3,6
HRV,USA,2005.0,11,12,-1
GBR,AUT,1999.0,12,11,1
TWN,SWE,2002.0,1,1,0
DNK,CHE,2007.0,9,20,-11
BEL,ZAF,2000.0,2,1,1
CYP,GBR,2004.0,2,7,-5
AUT,CAN,2006.0,16,8,8
SWE,RUS,2005.0,17,21,-4
CAN,BRA,2000.0,3,12,-9
AUS,BRA,2011.0,11,27,-16
ZWE,BWA,2006.0,3,1,2
IND,ESP,2003.0,9,11,-2
HRV,CHE,2009.0,4,3,1
DNK,CAN,2020.0,24,35,-11
RUS,SWE,2011.0,12,9,3
SWE,ETH,2003.0,5,2,3
DNK,DEU,2001.0,43,35,8
UKR,CHE,2005.0,2,1,1
JPN,SGP,2005.0,17,10,7
MEX,CHN,2013.0,6,3,3
JPN,SWE,2000.0,7,17,-10
KAZ,BEL,2016.0,1,1,0
OMN,USA,2008.0,2,4,-2
JPN,UKR,1997.0,1,2,-1
BEL,KEN,2003.0,5,3,2
CHE,LIE,2020.0,4,4,0
ESP,BGR,2013.0,1,1,0
NLD,PRT,2001.0,8,4,4
PRT,ARG,2003.0,1,3,-2
CHE,HUN,2002.0,3,12,-9
NLD,FIN,2020.0,17,22,-5
FIN,ITA,1997.0,5,2,3
BGR,SWE,2010.0,3,1,2
RUS,ISR,2015.0,13,8,5
FRA,GUF,2004.0,13,1,12
AUT,IND,2003.0,4,4,0
OMN,CAN,2019.0,7,9,-2
ITA,CAN,2007.0,47,31,16
CAN,JPN,1997.0,16,8,8
FIN,BEL,2020.0,7,9,-2
VEN,BRA,2005.0,4,3,1
KWT,GBR,2013.0,4,15,-11
KEN,GBR,2011.0,18,19,-1
GBR,TTO,2011.0,7,4,3
CHE,EST,2005.0,1,1,0
ITA,SGP,2013.0,15,5,10
HUN,CAN,2010.0,5,5,0
FRA,ECU,2014.0,5,3,2
NAM,ZAF,2004.0,3,2,1
SWE,CAN,2010.0,28,31,-3
POL,BGR,2020.0,1,1,0
CZE,AUS,2009.0,6,2,4
BGR,FRA,2017.0,3,8,-5
LUX,DEU,2013.0,8,32,-24
NZL,IND,2016.0,10,13,-3
ARE,SAU,2020.0,11,30,-19
CHL,FRA,2010.0,20,24,-4
GHA,NGA,2008.0,1,3,-2
TTO,IND,2010.0,3,1,2
BRA,BEL,2009.0,10,12,-2
AUT,NLD,2020.0,37,17,20
BGR,CHE,2013.0,3,2,1
SGP,DEU,2016.0,36,41,-5
ITA,UKR,2018.0,3,4,-1
QAT,EGY,2018.0,7,16,-9
IDN,FRA,2005.0,1,1,0
THA,CAN,2003.0,3,9,-6
CZE,THA,2008.0,1,1,0
BEL,IRL,2015.0,8,7,1
ISL,USA,2008.0,12,10,2
DEU,HRV,2011.0,8,7,1
GRC,CAN,2010.0,9,7,2
MAR,TGO,2015.0,4,1,3
NLD,GHA,2011.0,2,2,0
DEU,MYS,2013.0,11,2,9
IRL,PRT,2011.0,1,3,-2
ROU,ITA,2014.0,11,4,7
MLI,GIN,2019.0,2,1,1
DEU,THA,2015.0,23,10,13
IND,KAZ,2020.0,2,1,1
ISL,CAN,2009.0,2,2,0
FIN,VNM,2013.0,1,1,0
GRC,ESP,2013.0,27,17,10
PRT,CHE,2011.0,9,13,-4
JPN,HKG,2021.0,11,14,-3
POL,GRC,2015.0,5,2,3
JPN,ITA,2020.0,13,27,-14
RUS,KOR,2008.0,13,7,6
BGD,CAN,2006.0,5,2,3
NPL,THA,2020.0,4,6,-2
CYP,USA,2007.0,4,18,-14
KAZ,DEU,2014.0,2,2,0
CRI,CAN,2013.0,1,2,-1
BTN,IND,2019.0,1,4,-3
SGP,GBR,1998.0,5,11,-6
PAN,ESP,2012.0,1,2,-1
BEL,VNM,2013.0,8,1,7
LBN,DEU,2010.0,3,3,0
MYS,LBY,2016.0,6,4,2
THA,FRA,2016.0,8,25,-17
SWE,HKG,2017.0,6,4,2
MYS,DEU,2013.0,2,11,-9
LTU,IRL,2020.0,2,1,1
TUR,NLD,2015.0,14,26,-12
SWE,IDN,2018.0,2,3,-1
HKG,IND,2019.0,15,11,4
CHE,BRA,2020.0,15,33,-18
UKR,SVK,2015.0,4,1,3
BEL,SGP,2019.0,9,7,2
PAK,TUR,2017.0,11,5,6
ARE,ITA,2020.0,10,6,4
CHN,IDN,2022.0,5,2,3
THA,PAK,2015.0,10,4,6
ISL,SGP,2019.0,2,1,1
FIN,THA,2018.0,1,1,0
RUS,MDA,1998.0,1,1,0
BEL,PAK,2019.0,5,3,2
CHN,BEL,2022.0,32,44,-12
NZL,BEL,2006.0,1,4,-3
BGD,NOR,2010.0,2,1,1
MYS,DZA,2021.0,2,2,0
JPN,ETH,2015.0,3,1,2
NLD,NGA,2016.0,6,3,3
DEU,TZA,2021.0,3,1,2
DEU,BIH,2013.0,4,1,3
THA,AUT,2005.0,3,2,1
HUN,ROU,2008.0,6,5,1
BEL,SAU,2011.0,2,1,1
USA,GRC,1998.0,22,10,12
FRA,UKR,2012.0,7,18,-11
VEN,USA,2004.0,36,24,12
POL,SWE,2007.0,9,9,0
SWE,AUT,2011.0,14,18,-4
TUR,AUT,2021.0,8,3,5
PHL,SGP,2008.0,3,2,1
FRA,IRL,2004.0,13,11,2
CAN,LKA,2008.0,2,1,1
AUT,HRV,2015.0,2,5,-3
JPN,ESP,2019.0,27,24,3
GRC,POL,2016.0,3,2,1
GBR,EST,2020.0,7,4,3
GBR,BGD,2013.0,11,13,-2
ITA,IND,2022.0,16,14,2
NGA,CHE,2021.0,7,7,0
HTI,USA,2021.0,3,4,-1
LKA,AUS,2017.0,25,14,11
GBR,ISL,2020.0,4,7,-3
ESP,CUB,2017.0,10,16,-6
RUS,GBR,1999.0,40,7,33
DNK,IRL,2003.0,3,2,1
LBN,FRA,2013.0,18,62,-44
HUN,CAN,2019.0,8,7,1
AUS,ITA,2007.0,16,23,-7
ROU,GBR,2009.0,13,17,-4
BGD,PAK,2002.0,1,3,-2
HKG,IND,2010.0,6,3,3
GBR,MUS,2018.0,3,1,2
KOR,FIN,2016.0,4,3,1
CHN,DNK,2001.0,11,4,7
SWZ,ZAF,2013.0,1,1,0
AUS,GRC,2021.0,7,3,4
USA,PHL,2020.0,19,24,-5
NZL,ZAF,2017.0,3,11,-8
KOR,LKA,2019.0,5,1,4
URY,BRA,2004.0,2,3,-1
BGD,MYS,2009.0,12,5,7
VEN,BRA,2002.0,4,1,3
EGY,QAT,2009.0,5,2,3
HUN,CHE,2008.0,13,7,6
JOR,CAN,2020.0,15,15,0
IRQ,DEU,2021.0,4,3,1
CHE,GRC,2021.0,12,22,-10
OMN,MYS,2020.0,4,18,-14
CHL,CHE,2016.0,4,5,-1
SWE,NZL,2022.0,1,5,-4
SRB,POL,2013.0,6,3,3
ETH,TWN,2017.0,3,4,-1
KOR,THA,2009.0,3,2,1
BRA,NLD,2012.0,14,16,-2
UGA,CHE,2013.0,2,2,0
USA,MAR,2003.0,9,2,7
ZMB,USA,2009.0,5,4,1
NZL,SWE,2002.0,4,3,1
AZE,TUR,2000.0,5,1,4
RUS,DNK,1997.0,5,6,-1
HUN,ITA,1999.0,4,3,1
PER,IDN,2019.0,1,1,0
ESP,RUS,2012.0,8,7,1
BWA,BRN,2010.0,1,1,0
AUS,RUS,2003.0,5,15,-10
BEL,SWE,2007.0,5,10,-5
TZA,USA,2006.0,3,4,-1
LVA,SWE,2011.0,1,2,-1
TUN,BEL,2005.0,4,1,3
MYS,IDN,2008.0,9,2,7
USA,CYP,2007.0,18,4,14
USA,BIH,2011.0,5,2,3
PAK,ARE,2015.0,8,6,2
KEN,RWA,2013.0,1,1,0
UKR,ESP,2002.0,2,4,-2
UZB,USA,2005.0,1,4,-3
FRA,ARE,2022.0,4,2,2
HRV,BEL,2012.0,1,3,-2
LTU,NLD,2021.0,1,2,-1
PER,CHL,2007.0,2,4,-2
IRN,IRQ,2011.0,1,1,0
IDN,DEU,2007.0,3,10,-7
POL,NOR,2007.0,4,2,2
TWN,NLD,2016.0,2,1,1
COL,USA,1998.0,5,6,-1
JOR,ITA,2010.0,1,1,0
FRA,MCO,2009.0,7,9,-2
BGR,BEL,2011.0,3,3,0
RWA,UGA,2015.0,1,2,-1
MYS,TWN,2022.0,6,3,3
AUS,JOR,2019.0,6,3,3
CHN,ZAF,2011.0,7,7,0
BRA,CHN,2013.0,3,5,-2
NZL,ZAF,2010.0,7,5,2
TWN,HKG,2012.0,6,9,-3
PSE,ZAF,2022.0,1,1,0
EGY,ESP,2021.0,10,11,-1
MYS,NLD,2020.0,6,7,-1
ISL,FRA,2019.0,3,3,0
HRV,AUS,2016.0,3,2,1
CZE,ITA,2006.0,7,7,0
NLD,KOR,2020.0,7,17,-10
ESP,PRI,1998.0,1,1,0
DEU,DZA,2020.0,4,4,0
GBR,TGO,2020.0,1,1,0
NLD,SVN,1999.0,1,1,0
ALB,ITA,2018.0,6,10,-4
VNM,THA,2018.0,8,21,-13
PAK,IRL,2013.0,5,4,1
ECU,CHL,2022.0,4,7,-3
KEN,KOR,2020.0,2,4,-2
GHA,THA,2020.0,1,2,-1
PAK,QAT,2018.0,3,3,0
EGY,PRT,2014.0,1,3,-2
EGY,ITA,2006.0,1,4,-3
UGA,NGA,2014.0,3,2,1
ARG,POL,2011.0,5,1,4
USA,ZMB,2011.0,8,8,0
ESP,MAR,2009.0,6,5,1
NOR,FRA,2008.0,8,30,-22
VNM,DEU,2018.0,10,28,-18
IRL,KOR,2013.0,2,2,0
MCO,USA,2019.0,1,1,0
AUS,JOR,2017.0,11,4,7
PHL,TWN,2015.0,3,3,0
ZAF,BHR,2004.0,2,1,1
JPN,SGP,2002.0,14,11,3
CHE,KOR,2013.0,17,10,7
SEN,DEU,2002.0,1,1,0
DEU,COL,2005.0,4,2,2
ESP,POL,2004.0,3,4,-1
FRA,THA,2003.0,5,2,3
SWE,HKG,2010.0,4,2,2
KWT,PAK,2007.0,2,2,0
PRT,DNK,2009.0,2,2,0
AUS,ESP,2001.0,5,11,-6
VNM,BEL,2002.0,1,1,0
GRC,BEL,2007.0,5,10,-5
SWE,GRC,2008.0,8,4,4
NLD,HRV,2013.0,2,4,-2
PAK,POL,2014.0,2,4,-2
LUX,CHE,2015.0,6,3,3
LTU,FIN,2018.0,1,1,0
ZAF,NZL,2017.0,11,3,8
IRL,IRN,2016.0,4,5,-1
ISR,SWE,2021.0,9,2,7
TZA,CHN,2015.0,2,2,0
SWE,BRA,2020.0,5,35,-30
RUS,CZE,1997.0,1,1,0
DNK,FRO,2021.0,4,3,1
AUT,CZE,2014.0,15,6,9
JPN,MEX,2022.0,2,3,-1
IDN,BEL,2016.0,2,5,-3
IND,YEM,2021.0,7,3,4
DEU,ETH,2022.0,3,4,-1
IRN,DZA,2016.0,2,2,0
NZL,PAK,2012.0,3,6,-3
SWE,EST,2014.0,3,11,-8
SVK,NLD,2002.0,7,1,6
USA,HTI,2013.0,6,10,-4
CZE,POL,2002.0,4,4,0
DEU,EST,1998.0,2,1,1
PSE,AUS,2010.0,1,1,0
BWA,NGA,2010.0,3,3,0
ISR,ARG,2002.0,3,1,2
NOR,FIN,2003.0,5,11,-6
CHN,NZL,2002.0,4,2,2
CAN,COL,2004.0,1,2,-1
VNM,BEL,2005.0,2,1,1
SGP,SVN,2017.0,1,1,0
IND,PNG,2018.0,4,1,3
SWE,PRT,2007.0,5,6,-1
ZAF,SGP,2005.0,1,1,0
CZE,TWN,2011.0,2,1,1
LBN,CHE,2009.0,1,1,0
PRT,BEL,2003.0,3,4,-1
NLD,SVK,2014.0,4,6,-2
GBR,CYP,2004.0,7,2,5
JPN,NZL,2016.0,1,8,-7
DEU,COL,2002.0,5,8,-3
BEN,FRA,2008.0,5,9,-4
BEL,GMB,2012.0,1,2,-1
KAZ,TJK,2013.0,1,1,0
OMN,CAN,2017.0,3,14,-11
USA,PSE,2015.0,4,5,-1
NOR,TZA,2015.0,7,2,5
IRQ,CHN,2013.0,1,4,-3
AUT,GRC,2005.0,3,1,2
SRB,SWE,2016.0,6,2,4
BOL,DEU,2014.0,3,2,1
AUS,GHA,2011.0,2,1,1
CHE,VNM,2020.0,7,1,6
FRA,TWN,2015.0,12,6,6
NOR,GHA,2014.0,2,1,1
KAZ,ARE,2016.0,2,1,1
IND,MEX,2011.0,2,3,-1
MEX,IND,2015.0,4,11,-7
GHA,BEL,2020.0,3,1,2
KAZ,ISR,2020.0,3,2,1
MRT,SEN,2015.0,1,1,0
SGP,NZL,2002.0,5,7,-2
JPN,NGA,2007.0,2,4,-2
IND,NZL,2009.0,9,2,7
AUS,JOR,2010.0,6,2,4
BGR,GRC,2006.0,2,2,0
BRA,PRY,2010.0,1,3,-2
LTU,DEU,2019.0,12,8,4
NZL,THA,2014.0,6,1,5
HKG,NLD,2014.0,3,9,-6
CHE,CYP,2013.0,1,3,-2
HKG,NZL,2013.0,5,3,2
TGO,NGA,2016.0,1,1,0
PAK,SWE,2022.0,5,3,2
GHA,AUS,2014.0,6,2,4
FRA,HUN,2006.0,4,10,-6
DEU,KEN,2004.0,6,4,2
CHE,TZA,2013.0,2,1,1
MKD,DEU,2015.0,4,1,3
CAN,CRI,2016.0,3,1,2
SVN,SVK,2020.0,5,4,1
IRL,RUS,2014.0,3,3,0
SRB,FRA,2020.0,5,5,0
ECU,USA,2001.0,2,4,-2
JPN,ISR,1999.0,4,2,2
ISR,JPN,2008.0,3,6,-3
NZL,SWE,2005.0,3,9,-6
MDA,UKR,2008.0,2,2,0
HKG,DNK,2011.0,1,2,-1
CHL,ZAF,2018.0,4,2,2
SGP,BRN,2012.0,1,1,0
FJI,IND,2005.0,1,1,0
OMN,CAN,2010.0,2,8,-6
OMN,JPN,2006.0,2,1,1
NOR,NZL,2020.0,3,2,1
USA,BLR,2018.0,1,6,-5
COL,TWN,2019.0,1,1,0
ZAF,CMR,2016.0,3,5,-2
BHR,GBR,2013.0,3,4,-1
DEU,BFA,2015.0,4,1,3
CZE,JPN,2013.0,5,10,-5
AUT,THA,2016.0,5,2,3
MDG,FRA,2016.0,7,8,-1
NZL,MEX,2019.0,2,3,-1
NPL,DNK,2017.0,1,2,-1
LBN,AUS,2021.0,3,3,0
DNK,ZAF,2015.0,2,1,1
MYS,PSE,2015.0,5,2,3
SRB,DEU,1998.0,2,4,-2
USA,DMA,2010.0,1,1,0
BEL,PER,2007.0,2,3,-1
PHL,VNM,2019.0,2,1,1
KOR,GHA,2015.0,3,2,1
KAZ,KGZ,2018.0,1,4,-3
DNK,ROU,2013.0,2,4,-2
BRN,MYS,2016.0,3,9,-6
RUS,DNK,1998.0,4,3,1
SVK,POL,2012.0,6,1,5
ZAF,TZA,2015.0,5,3,2
PRT,IND,2002.0,2,1,1
PRT,AGO,2019.0,1,5,-4
BGD,FRA,2020.0,4,3,1
LUX,USA,2015.0,2,2,0
RUS,ZAF,2019.0,5,7,-2
GBR,ROU,2001.0,2,10,-8
TZA,SWE,2009.0,3,3,0
TUR,CYP,2009.0,5,4,1
BRA,VEN,2009.0,4,2,2
CZE,MEX,2015.0,2,1,1
ZWE,SWE,2009.0,1,1,0
NOR,ETH,2013.0,4,8,-4
SWE,ECU,2020.0,1,1,0
BWA,DEU,2017.0,1,1,0
MAR,BEL,2019.0,3,3,0
CZE,LTU,2019.0,1,2,-1
ARE,KWT,2018.0,2,5,-3
AUS,MMR,2022.0,6,2,4
MAC,HKG,2009.0,2,7,-5
DEU,TUR,2001.0,5,6,-1
GTM,CHE,2010.0,1,1,0
NOR,PRT,2011.0,1,8,-7
FJI,AUS,2005.0,3,5,-2
THA,DNK,2006.0,3,2,1
DEU,LIE,2018.0,1,1,0
UGA,DEU,2020.0,4,3,1
NLD,TUN,2021.0,1,1,0
CAN,JAM,2004.0,2,3,-1
PAK,CMR,2020.0,1,1,0
CZE,UKR,2004.0,1,3,-2
SWE,TZA,2004.0,1,2,-1
GBR,MAC,2020.0,7,3,4
NOR,BEL,2004.0,1,1,0
RUS,ZAF,2017.0,3,5,-2
EGY,POL,2007.0,1,2,-1
JPN,SRB,2006.0,1,1,0
ITA,EGY,2006.0,4,1,3
TUR,UKR,2000.0,1,5,-4
JAM,FRA,2014.0,1,1,0
EGY,MYS,2007.0,1,2,-1
BGD,CHE,2021.0,2,5,-3
KAZ,JPN,2009.0,1,1,0
SGP,ITA,2011.0,1,6,-5
ROU,AUT,2003.0,2,1,1
DEU,JOR,2020.0,8,9,-1
NGA,CHN,2008.0,1,2,-1
AUS,PHL,2002.0,1,5,-4
BEL,PAK,2017.0,1,4,-3
SWE,QAT,2019.0,1,3,-2
TWN,FIN,2015.0,1,3,-2
QAT,CHE,2013.0,1,2,-1
GMB,NGA,2015.0,3,1,2
EST,AUT,2017.0,2,2,0
NOR,SAU,2013.0,1,2,-1
BIH,AUT,2007.0,1,2,-1
TZA,BWA,2010.0,1,1,0
KEN,ITA,2004.0,1,1,0
BTN,IND,2010.0,1,1,0
PRT,AGO,2017.0,2,6,-4
BRN,BGD,2018.0,3,2,1
SWE,URY,2003.0,3,1,2
RUS,MDA,1997.0,1,1,0
SRB,TUR,2003.0,1,1,0
CAN,ECU,2005.0,1,1,0
VNM,GBR,2004.0,3,3,0
PRT,KOR,2010.0,1,3,-2
DEU,BEN,2000.0,1,1,0
UKR,TWN,2005.0,1,2,-1
ZAF,ETH,2008.0,3,4,-1
SWE,NGA,2007.0,1,1,0
BEL,NZL,2002.0,1,2,-1
KOR,HKG,2001.0,3,2,1
ARE,OMN,2004.0,3,2,1
CHN,EGY,2011.0,1,6,-5
BGR,ROU,2014.0,2,1,1
MAR,CAN,2010.0,1,11,-10
LBN,DEU,2017.0,3,4,-1
SGP,GRC,2019.0,2,2,0
EGY,ZAF,2016.0,1,3,-2
LUX,IND,2021.0,1,7,-6
SVK,GBR,2008.0,5,2,3
TUN,MAR,2001.0,1,2,-1
NLD,HKG,2005.0,1,2,-1
GBR,ETH,2008.0,3,4,-1
JOR,ITA,2019.0,2,6,-4
BEL,ISR,2012.0,1,3,-2
CZE,NZL,2017.0,2,1,1
AZE,IRN,2008.0,2,2,0
BRA,GRC,2014.0,2,2,0
ITA,SRB,2009.0,4,3,1
CHE,HRV,2003.0,2,6,-4
HUN,ISR,2003.0,2,2,0
CHL,SWE,2001.0,1,3,-2
RUS,NZL,2004.0,1,1,0
FRA,GIN,2021.0,2,2,0
NOR,IDN,2021.0,1,1,0
PSE,USA,2003.0,1,3,-2
KOR,CHE,2002.0,4,3,1
SRB,LUX,2014.0,1,1,0
HKG,IND,2017.0,5,16,-11
DZA,EGY,2014.0,2,1,1
USA,SDN,2020.0,1,1,0
VNM,CHN,2016.0,1,13,-12
GBR,PAK,1997.0,3,3,0
EST,IRN,2022.0,1,3,-2
MYS,NOR,2010.0,3,1,2
AUT,UKR,2009.0,1,3,-2
DEU,FJI,2021.0,1,1,0
NZL,ZAF,2019.0,4,15,-11
BWA,CHN,2018.0,1,1,0
ECU,NLD,2018.0,1,5,-4
ISR,JOR,2017.0,1,1,0
MYS,NOR,2017.0,1,2,-1
GBR,LBY,2021.0,2,1,1
BEL,TUN,2016.0,5,1,4
FRA,AGO,2003.0,2,1,1
PAK,ZAF,2016.0,2,2,0
MCO,FRA,2021.0,1,7,-6
NOR,GRC,2014.0,3,6,-3
MWI,BWA,2004.0,2,1,1
BGR,CAN,2004.0,5,2,3
SLV,SVN,2001.0,1,1,0
IDN,NLD,2004.0,2,7,-5
PRT,SVN,2016.0,1,2,-1
CZE,HRV,2018.0,2,2,0
UZB,ITA,2018.0,1,1,0
MWI,CHN,2015.0,3,1,2
IND,BGR,2016.0,1,1,0
NGA,SWE,2004.0,1,1,0
DEU,CMR,2005.0,1,1,0
TWN,BEL,2016.0,2,2,0
MAR,YEM,2017.0,1,1,0
RUS,SRB,2000.0,1,6,-5
CAN,UGA,2015.0,2,1,1
BGD,GBR,1999.0,2,1,1
GUY,FRA,2015.0,2,2,0
SVK,RUS,2018.0,2,3,-1
JPN,ARE,2017.0,4,1,3
DNK,ARE,2009.0,1,1,0
NOR,POL,2003.0,1,4,-3
ISR,MEX,2004.0,1,1,0
SYR,EGY,2018.0,2,1,1
HUN,EST,2016.0,2,1,1
SWE,ZAF,2001.0,1,3,-2
SVK,FRA,2019.0,5,3,2
POL,LBY,2013.0,1,1,0
ISR,ZAF,2000.0,2,1,1
PRK,KOR,2018.0,1,1,0
ITA,MYS,2021.0,2,2,0
CAN,HUN,2006.0,4,5,-1
DZA,CHE,2003.0,1,1,0
CHN,NZL,2005.0,3,1,2
ARG,AUT,2019.0,2,2,0
CHE,CIV,2019.0,2,3,-1
CHE,EST,2002.0,1,1,0
CUB,ARG,2003.0,1,1,0
BRA,PRY,2019.0,2,4,-2
SWE,QAT,2017.0,1,3,-2
NAM,KEN,2015.0,1,1,0
ESP,ISR,2005.0,1,4,-3
GUM,USA,2008.0,1,6,-5
AUS,MAR,2016.0,1,1,0
URY,IRL,2012.0,1,1,0
ZAF,IRL,2013.0,2,9,-7
SRB,AUT,2012.0,1,4,-3
IRL,NZL,1999.0,2,4,-2
MMR,CHN,2020.0,2,5,-3
POL,BRA,2021.0,2,6,-4
TUR,BGR,2017.0,1,3,-2
ISR,MDA,2002.0,1,1,0
ITA,MKD,2015.0,1,1,0
USA,BMU,2013.0,2,5,-3
ROU,SWE,1998.0,1,1,0
NZL,ESP,1997.0,1,1,0
AUT,IRN,2007.0,2,2,0
NZL,FIN,2006.0,1,2,-1
AGO,FRA,2003.0,1,2,-1
BGR,HUN,2007.0,1,1,0
MRT,FRA,2018.0,1,3,-2
ROU,BGR,2004.0,1,1,0
TUN,BEL,2002.0,1,3,-2
GBR,LTU,2004.0,1,5,-4
CAN,VNM,2013.0,3,1,2
QAT,DEU,2015.0,3,8,-5
IND,PRI,2010.0,1,2,-1
KOR,LKA,2010.0,1,3,-2
USA,AIA,2017.0,1,1,0
DNK,PRT,2008.0,1,4,-3
CRI,DEU,2007.0,1,1,0
CIV,BEN,2008.0,1,1,0
NGA,JAM,2011.0,1,1,0
DEU,UZB,2007.0,2,2,0
CHE,ETH,2009.0,1,4,-3
ESP,TUR,2007.0,1,4,-3
LTU,TUR,2020.0,1,1,0
ETH,MWI,2010.0,1,1,0
BWA,NAM,2018.0,2,1,1
DZA,USA,2016.0,1,9,-8
TJK,RUS,2015.0,2,4,-2
CHE,LBN,2020.0,1,1,0
ARE,MKD,2016.0,1,1,0
IND,MAR,2003.0,1,1,0
ESP,EST,2021.0,4,4,0
SRB,ALB,2011.0,1,3,-2
MLI,GIN,2017.0,1,1,0
TZA,IND,2020.0,3,3,0
SRB,CZE,2012.0,1,3,-2
IND,MAC,2021.0,1,2,-1
VNM,ITA,2022.0,2,2,0
JPN,GRC,2021.0,1,1,0
PRY,USA,2016.0,1,2,-1
IRL,PAK,2003.0,1,1,0
ISL,NOR,2007.0,1,2,-1
NLD,HKG,2002.0,1,2,-1
CHE,ZWE,2019.0,2,3,-1
EGY,CHE,2020.0,1,5,-4
ISR,NZL,2001.0,1,1,0
IND,PRI,2017.0,1,3,-2
TZA,DEU,2009.0,1,1,0
COL,NOR,2017.0,1,3,-2
URY,DEU,2021.0,1,1,0
SVN,SWE,2006.0,1,1,0
CHE,DZA,2009.0,1,1,0
NZL,PHL,2010.0,1,2,-1
BEN,KEN,2010.0,2,1,1
UGA,BEL,2015.0,1,1,0
SWE,IRL,2001.0,1,7,-6
ROU,ISR,1999.0,1,1,0
UKR,AUT,1999.0,1,1,0
ARE,BGD,2016.0,1,1,0
SAU,ROU,2016.0,1,3,-2
MEX,DNK,2007.0,1,3,-2
KOR,GBR,1997.0,1,3,-2
KWT,CAN,2011.0,1,13,-12
BGR,FRA,2019.0,1,1,0
CAN,GUY,2013.0,1,2,-1
JOR,ITA,2017.0,1,2,-1
IRL,EGY,2020.0,1,5,-4
FIN,POL,1999.0,1,4,-3
EGY,PAK,2021.0,1,4,-3
CHN,DEU,2010.0,188,133,55
USA,COL,2008.0,48,42,6
CAN,USA,2020.0,1709,1379,330
DEU,SGP,2015.0,39,28,11
ZWE,ZAF,2008.0,20,1,19
MEX,USA,2010.0,174,156,18
NLD,ITA,2016.0,62,126,-64
AUT,IDN,2013.0,2,1,1
GBR,DEU,2018.0,653,622,31
BEL,DEU,2009.0,56,80,-24
ESP,AUS,2010.0,23,20,3
SGP,AUS,2014.0,69,73,-4
ESP,DEU,2017.0,255,181,74
CHN,TWN,2021.0,91,109,-18
CHN,PAK,2015.0,65,131,-66
CHN,MAC,2013.0,22,18,4
USA,LBN,2019.0,36,73,-37
DEU,VNM,2018.0,28,10,18
HUN,CAN,2017.0,9,7,2
KOR,UZB,2016.0,2,1,1
USA,ARG,2018.0,74,85,-11
LKA,AUS,2019.0,37,21,16
FRA,CIV,2020.0,19,8,11
FRA,FIN,2004.0,13,10,3
BEL,USA,1999.0,53,42,11
UGA,GBR,2018.0,14,16,-2
DEU,CHL,2014.0,42,24,18
SWE,CAN,2017.0,26,40,-14
DEU,JPN,2008.0,97,109,-12
KEN,ESP,2016.0,3,1,2
BEL,ESP,2011.0,32,33,-1
BGR,DEU,2016.0,9,13,-4
ZAF,NZL,2010.0,5,7,-2
SWE,AUS,2009.0,39,28,11
MEX,GBR,2007.0,23,35,-12
NLD,VEN,2005.0,1,1,0
AUT,GBR,2002.0,38,31,7
BHR,USA,2016.0,2,4,-2
ITA,QAT,2020.0,5,4,1
NLD,USA,2000.0,87,64,23
LTU,ESP,2020.0,2,2,0
GBR,BRN,2018.0,10,2,8
COL,ESP,2012.0,38,65,-27
ARG,CAN,2009.0,13,10,3
USA,MWI,2014.0,13,13,0
GHA,USA,2006.0,5,6,-1
CZE,ESP,2019.0,11,27,-16
BOL,BEL,2011.0,1,1,0
GBR,CHE,1999.0,39,49,-10
HRV,USA,2002.0,22,12,10
CAN,JPN,1998.0,28,30,-2
LVA,RUS,2004.0,1,1,0
ESP,CZE,2011.0,7,5,2
SGP,RUS,2012.0,2,2,0
POL,CAN,2001.0,13,10,3
FIN,ESP,1999.0,2,4,-2
SVK,AUT,2005.0,11,5,6
KOR,RUS,1997.0,1,1,0
HKG,SGP,2012.0,27,19,8
IND,NPL,2009.0,27,27,0
EST,FIN,2017.0,12,11,1
DEU,IND,2000.0,17,27,-10
AUS,DNK,2012.0,22,26,-4
GRC,CAN,2019.0,11,12,-1
CHL,BRA,2016.0,17,23,-6
NZL,MEX,2017.0,3,6,-3
ARG,ITA,2009.0,17,19,-2
NLD,COL,2013.0,4,4,0
SGP,HKG,2015.0,24,30,-6
COL,ITA,2018.0,8,17,-9
CAN,THA,2018.0,10,11,-1
NZL,HKG,2005.0,3,3,0
DNK,ISL,2020.0,5,6,-1
IDN,ESP,2018.0,1,2,-1
CHE,IND,2015.0,25,38,-13
CHE,BEL,2006.0,13,22,-9
THA,GBR,2022.0,12,23,-11
ESP,ISR,2002.0,3,5,-2
KOR,ZAF,2013.0,1,1,0
VEN,GBR,2013.0,2,3,-1
SEN,USA,2013.0,1,4,-3
CAN,PAN,2016.0,1,3,-2
IRN,DNK,2011.0,10,5,5
SAU,POL,2018.0,1,1,0
BEL,UKR,2021.0,3,3,0
PAN,CRI,2022.0,1,1,0
LBN,CAN,2017.0,12,6,6
IND,HKG,2022.0,11,8,3
TWN,NZL,2020.0,2,1,1
FRA,GRC,2000.0,7,5,2
FJI,AUS,2002.0,2,1,1
CHL,CAN,2004.0,10,7,3
AUT,AUS,2016.0,20,26,-6
NPL,GBR,2007.0,4,2,2
IRL,SGP,2007.0,1,1,0
ARE,COL,2020.0,1,1,0
ESP,CUB,2019.0,3,15,-12
QAT,PAK,2017.0,5,6,-1
AUS,PRT,2007.0,3,3,0
MLI,FRA,2009.0,5,8,-3
LKA,CAN,2020.0,1,5,-4
PER,ECU,2020.0,2,5,-3
CAN,ZAF,2020.0,12,36,-24
ARG,AUT,2017.0,2,3,-1
IND,PHL,2020.0,6,13,-7
BRA,HRV,2020.0,3,1,2
BGR,IRL,2007.0,1,1,0
ITA,HRV,2014.0,3,2,1
SVN,RUS,2020.0,1,5,-4
KEN,BWA,2021.0,1,1,0
DEU,NGA,2018.0,7,5,2
ZAF,FIN,2013.0,1,2,-1
BRA,ZAF,2013.0,3,5,-2
IDN,IND,2016.0,2,4,-2
POL,TWN,2021.0,2,3,-1
NLD,EGY,2017.0,4,3,1
NLD,UKR,2021.0,1,3,-2
AUS,FJI,2003.0,4,6,-2
FIN,ITA,1998.0,1,3,-2
DNK,RUS,2014.0,5,4,1
BFA,NER,2016.0,1,1,0
PSE,MYS,2022.0,1,2,-1
SVN,IRL,2020.0,1,2,-1
ZWE,USA,2005.0,7,4,3
CIV,BFA,2006.0,4,1,3
EGY,MEX,2018.0,1,3,-2
BEL,BFA,2016.0,3,2,1
TWN,FRA,2007.0,2,8,-6
KOR,CHE,2005.0,6,5,1
ISL,FRA,2010.0,1,3,-2
TUR,RUS,2021.0,4,5,-1
AUT,UGA,2012.0,1,2,-1
KOR,MNG,2012.0,2,2,0
KEN,CMR,2002.0,1,1,0
NOR,NPL,2016.0,3,3,0
FIN,KOR,2003.0,1,1,0
NLD,EGY,2019.0,2,3,-1
VNM,FIN,2013.0,1,1,0
PHL,VNM,2017.0,1,1,0
IRL,BEL,2002.0,2,2,0
TTO,IND,2017.0,2,3,-1
NPL,KOR,2005.0,1,1,0
YEM,FRA,2009.0,1,1,0
PRI,ESP,2015.0,2,5,-3
NPL,FRA,2010.0,1,1,0
QAT,PAK,2019.0,1,8,-7
THA,ITA,2007.0,1,2,-1
THA,PHL,2013.0,1,1,0
TTO,IND,2019.0,2,2,0
NLD,TWN,2016.0,1,2,-1
ROU,IRQ,2017.0,1,2,-1
TWN,THA,2002.0,1,1,0
ITA,UZB,2004.0,1,3,-2
CAN,GEO,2021.0,1,1,0
RUS,LTU,2012.0,1,1,0
CHL,RUS,2017.0,1,1,0
RUS,SGP,2003.0,1,3,-2
FRO,DNK,2007.0,1,1,0
BWA,KEN,2002.0,1,1,0
CHL,RUS,2019.0,1,2,-1
CAN,TZA,2011.0,2,1,1
CYP,ESP,2022.0,1,1,0
BWA,GBR,2008.0,1,3,-2
CZE,,2014.0,1295,0,1295
,CHN,2012.0,148899,0,148899
AUS,,2021.0,12154,0,12154
,USA,2003.0,82961,0,82961
KOR,,2012.0,6225,0,6225
HKG,,2011.0,899,0,899
KAZ,,2021.0,1178,0,1178
TWN,,2014.0,5265,0,5265
,NLD,1997.0,1818,0,1818
NLD,,2015.0,3820,0,3820
CHE,,2016.0,3479,0,3479
THA,,2023.0,10359,0,10359
CAN,,2012.0,6337,0,6337
BIH,,2012.0,71,0,71
,CIV,2004.0,119,0,119
,IDN,1998.0,328,0,328
BRN,,2015.0,24,0,24
,MYS,2004.0,1371,0,1371
IRN,,2008.0,328,0,328
,NLD,1998.0,10127,0,10127
ZAF,,2018.0,1453,0,1453
TUR,,2012.0,2315,0,2315
,DNK,1999.0,3267,0,3267
UKR,,2023.0,11637,0,11637
BEN,CMR,2005.0,1,0,1
CUB,,2014.0,642,0,642
,AUS,1995.0,3682,0,3682
TUN,,2016.0,635,0,635
ISR,BGR,2011.0,2,0,2
FJI,VUT,2015.0,1,0,1
SEN,,2021.0,217,0,217
NLD,EGY,2010.0,4,0,4
,SRB,2007.0,1413,0,1413
,BRA,2010.0,20410,0,20410
NOR,,2002.0,71,0,71
BGR,ZAF,2001.0,1,0,1
PAK,,2018.0,1554,0,1554
,HUN,2010.0,1539,0,1539
,BEL,2001.0,2895,0,2895
,NZL,2000.0,1455,0,1455
PRT,,2020.0,2742,0,2742
VNM,,2021.0,1086,0,1086
,EGY,2016.0,4074,0,4074
CYP,,2024.0,1370,0,1370
FRA,,2000.0,522,0,522
,IRL,2014.0,1709,0,1709
NOR,,2005.0,335,0,335
MWI,,2022.0,168,0,168
,MAR,1995.0,224,0,224
,LKA,2005.0,126,0,126
,CHL,2013.0,2169,0,2169
MOZ,,2023.0,237,0,237
BGR,,2007.0,147,0,147
,SGP,1995.0,420,0,420
PRY,,2007.0,5,0,5
BOL,,2023.0,183,0,183
PHL,,2022.0,1055,0,1055
MEX,,2001.0,63,0,63
,KGZ,2015.0,52,0,52
ARM,KOR,2013.0,1,0,1
BLR,FRA,2007.0,3,0,3
LVA,,2014.0,109,0,109
,SWE,2015.0,3412,0,3412
,BRA,2017.0,19687,0,19687
DZA,,2015.0,261,0,261
,BRA,2019.0,8830,0,8830
,ETH,2018.0,1662,0,1662
,FRA,2014.0,14150,0,14150
,COG,2010.0,97,0,97
,CAN,2018.0,10771,0,10771
,BIH,2016.0,273,0,273
NAM,,2020.0,36,0,36
ALB,,2019.0,45,0,45
,NOR,2018.0,1644,0,1644
,CIV,1996.0,28,0,28
,HTI,2012.0,26,0,26
,SVN,1995.0,270,0,270
ALB,,2017.0,71,0,71
,BFA,2018.0,68,0,68
,TTO,2011.0,37,0,37
,NPL,2007.0,220,0,220
,BGR,2013.0,446,0,446
,HUN,2017.0,1443,0,1443
WSM,,2021.0,13,0,13
KHM,,2019.0,48,0,48
NPL,,2015.0,113,0,113
,GEO,2009.0,149,0,149
TWN,KIR,2020.0,1,0,1
BGR,SWE,2019.0,2,0,2
TUR,BGR,2019.0,2,0,2
,HUN,2019.0,808,0,808
,COG,2019.0,25,0,25
,COG,2017.0,64,0,64
UKR,NZL,2017.0,1,0,1
,GIN,2018.0,25,0,25
NGA,SEN,1999.0,1,0,1
HND,,2020.0,19,0,19
MDG,GMB,2021.0,1,0,1
,IDN,1997.0,91,0,91
LIE,,2014.0,7,0,7
BGR,AUT,2004.0,2,0,2
,MYS,1996.0,140,0,140
SLE,,2016.0,8,0,8
KHM,FRA,2020.0,3,0,3
GRL,,2023.0,33,0,33
,MCO,2011.0,12,0,12
,SYR,2007.0,43,0,43
,SEN,2008.0,101,0,101
CAF,KHM,2012.0,1,0,1
,EST,1995.0,94,0,94
TUR,UZB,2022.0,1,0,1
,PAN,2009.0,41,0,41
MWI,NGA,2019.0,1,0,1
CHL,IRL,2009.0,2,0,2
ESP,FJI,2015.0,1,0,1
AFG,,2022.0,51,0,51
,SWZ,2010.0,4,0,4
POL,SAU,2020.0,2,0,2
TUR,OMN,2009.0,1,0,1
,SWZ,2017.0,5,0,5
ROU,IRQ,2019.0,8,0,8
BWA,CZE,2018.0,1,0,1
NGA,,2006.0,92,0,92
NPL,DNK,2019.0,2,0,2
KAZ,BGR,2019.0,1,0,1
MAR,FIN,2020.0,1,0,1
IRN,OMN,2022.0,8,0,8
,BOL,2006.0,55,0,55
MNP,USA,2011.0,2,0,2
LAO,,2016.0,12,0,12
CUB,DEU,2007.0,5,0,5
TZA,,2007.0,29,0,29
,LKA,2002.0,108,0,108
,KAZ,2001.0,116,0,116
,COM,1998.0,3,0,3
,LSO,1994.0,3,0,3
MDA,,2001.0,5,0,5
GTM,CHE,2017.0,1,0,1
AUS,OMN,2011.0,6,0,6
MAR,,2004.0,119,0,119
BEN,BFA,2019.0,2,0,2
DEU,ISL,2001.0,3,0,3
ATG,SAU,2013.0,1,0,1
CAN,KWT,2004.0,3,0,3
USA,FRO,2008.0,1,0,1
UKR,TWN,2002.0,1,0,1
VNM,SWE,2000.0,1,0,1
USA,NER,2007.0,1,0,1
BEL,SGP,2010.0,5,0,5
,QAT,1998.0,36,0,36
KOR,ARE,2005.0,1,0,1
CZE,SVN,2006.0,1,0,1
RUS,CZE,1998.0,1,0,1
IND,OMN,1998.0,2,0,2
CHE,NGA,2007.0,1,0,1
HUN,POL,2000.0,2,0,2
CUB,PAN,2006.0,1,0,1
COL,URY,2003.0,1,0,1
CRI,,2003.0,7,0,7
ARM,ESP,1998.0,1,0,1
UGA,ITA,1999.0,1,0,1
SVK,ESP,2007.0,3,0,3
DNK,SVK,1998.0,1,0,1
ESP,PRI,1997.0,1,0,1
CAN,KNA,2016.0,1,0,1
VEN,PRT,2005.0,2,0,2
BEN,KEN,2019.0,2,0,2
KHM,,2017.0,22,0,22
PNG,,2003.0,4,0,4
,NIC,2008.0,14,0,14
GBR,BHS,2015.0,2,0,2
,MAC,1999.0,7,0,7
MEX,ECU,2014.0,9,0,9
NGA,MWI,2017.0,2,0,2
MYS,CHN,2003.0,3,0,3
BIH,GBR,2020.0,3,0,3
BGD,NOR,2019.0,2,0,2
NZL,TZA,2014.0,1,0,1
ROU,MDA,2005.0,5,0,5
BGR,KOR,2011.0,1,0,1
IRN,IRL,2021.0,13,0,13
SRB,TUN,2016.0,1,0,1
IRN,IDN,2018.0,3,0,3
BGR,SWE,2017.0,2,0,2
,PNG,2015.0,26,0,26
,ASM,2016.0,2,0,2
BEL,NZL,2005.0,6,0,6
MOZ,ESP,2006.0,1,0,1
OMN,TTO,2017.0,1,0,1
GBR,SAU,1998.0,1,0,1
AUT,IRL,1997.0,1,0,1
CYP,SAU,2004.0,1,0,1
BEL,LUX,2000.0,3,0,3
JPN,MLT,2007.0,1,0,1
SVN,AUS,2005.0,1,0,1
DEU,IRN,1998.0,1,0,1
,TJK,2011.0,32,0,32
JPN,TLS,2019.0,1,0,1
CAF,,2018.0,4,0,4
NLD,VNM,2021.0,5,0,5
PAK,VNM,2020.0,8,0,8
MLI,GBR,2014.0,5,0,5
AUS,CHL,2022.0,6,0,6
ITA,ZAF,2009.0,5,0,5
UKR,FIN,2018.0,3,0,3
THA,ARE,2004.0,1,0,1
KHM,CAN,2020.0,1,0,1
BEL,MDA,2004.0,1,0,1
,SLE,2008.0,17,0,17
BEL,LSO,2015.0,1,0,1
SVK,BEL,2003.0,1,0,1
BFA,NGA,2007.0,1,0,1
SDN,,2003.0,2,0,2
RUS,ROU,1997.0,2,0,2
ISL,GRL,2009.0,1,0,1
PAN,,2009.0,12,0,12
EST,AUS,2009.0,1,0,1
,DMA,1999.0,2,0,2
CAN,BIH,2003.0,1,0,1
,RWA,2001.0,3,0,3
YEM,ESP,2006.0,1,0,1
KEN,CHN,2007.0,2,0,2
CHE,IDN,2016.0,1,0,1
TCD,FRA,2007.0,2,0,2
ITA,BIH,2018.0,3,0,3
BEN,BFA,2017.0,4,0,4
MDG,SEN,2014.0,1,0,1
FRA,MRT,2014.0,1,0,1
RUS,LVA,2010.0,2,0,2
LBR,NZL,2018.0,1,0,1
NOR,FRO,2012.0,2,0,2
ARM,HKG,2014.0,1,0,1
SYR,IRN,2015.0,1,0,1
COL,NOR,2019.0,2,0,2
NZL,PHL,2017.0,1,0,1
RUS,MNE,2012.0,1,0,1
PSE,CAN,2020.0,2,0,2
,MMR,1999.0,8,0,8
PAK,LTU,2021.0,3,0,3
GMB,FRA,2010.0,1,0,1
PRT,DZA,2016.0,2,0,2
MLI,,2012.0,10,0,10
,ERI,2014.0,4,0,4
MYS,NOR,2019.0,5,0,5
GBR,PAK,1998.0,2,0,2
ITA,PAN,2019.0,3,0,3
ISL,AUS,2011.0,1,0,1
BGR,TUR,2008.0,2,0,2
CAN,MKD,2009.0,2,0,2
IRN,ZAF,2011.0,5,0,5
SVK,BLR,2018.0,1,0,1
TWN,BRN,2015.0,2,0,2
BGD,ARE,2014.0,1,0,1
GRC,PSE,2014.0,1,0,1
BRA,TZA,2015.0,1,0,1
KEN,MOZ,2020.0,1,0,1
IRN,EST,2020.0,6,0,6
UZB,GBR,2021.0,1,0,1
BWA,DEU,2019.0,1,0,1
ESP,BOL,2008.0,2,0,2
,ALB,1994.0,3,0,3
CHN,TUR,2004.0,1,0,1
BFA,BEN,2012.0,1,0,1
SWE,AZE,2017.0,1,0,1
IRN,GHA,2014.0,1,0,1
USA,KHM,2003.0,2,0,2
DEU,BWA,2004.0,1,0,1
PRI,BRA,2011.0,1,0,1
OMN,CYP,2014.0,1,0,1
FRA,NER,1999.0,2,0,2
GBR,SEN,1999.0,1,0,1
MEX,ZAF,2008.0,1,0,1
ROU,CUB,2005.0,1,0,1
DEU,VEN,2000.0,1,0,1
PER,HKG,2004.0,1,0,1
NZL,OMN,2001.0,2,0,2
BWA,NGA,2019.0,2,0,2
MEX,MAR,2003.0,2,0,2
MHL,NPL,2003.0,3,0,3
ISR,CYP,2009.0,1,0,1
MYS,SYR,2003.0,1,0,1
ARG,DOM,2009.0,1,0,1
AUT,ETH,2003.0,2,0,2
RUS,TZA,2012.0,1,0,1
FRA,ARM,1998.0,1,0,1
JAM,GBR,2003.0,2,0,2
ESP,TWN,2007.0,1,0,1
ZMB,NZL,1997.0,1,0,1
PRI,IND,2016.0,1,0,1
IRL,ARG,2014.0,1,0,1
SWE,SVN,2005.0,1,0,1
ROU,KOR,2015.0,1,0,1
NPL,DNK,2010.0,2,0,2
KHM,,2010.0,12,0,12
CHN,BEN,2009.0,1,0,1
ARG,RUS,2011.0,1,0,1
TZA,KEN,2012.0,1,0,1
SYR,ETH,2020.0,4,0,4
NZL,VNM,2011.0,1,0,1
FJI,PAK,2017.0,1,0,1
MYS,RUS,2015.0,2,0,2
CRI,ITA,2021.0,1,0,1
,QAT,1997.0,9,0,9
GBR,SAU,1997.0,1,0,1
USA,DZA,2021.0,1,0,1
ZAF,SGP,2002.0,1,0,1
MAR,PAK,2021.0,1,0,1
SEN,ETH,2016.0,1,0,1
BEL,COD,2002.0,2,0,2
RWA,BEL,1998.0,1,0,1
VEN,GRD,2021.0,1,0,1
PRT,RUS,2012.0,5,0,5
TJK,EST,2003.0,1,0,1
BEN,CMR,2002.0,1,0,1
GAB,USA,2003.0,2,0,2
JPN,SYR,2018.0,1,0,1
PAN,CYP,2006.0,1,0,1
DEU,PAN,2013.0,1,0,1
VUT,FRA,2016.0,1,0,1
ECU,COL,2007.0,1,0,1
PSE,QAT,2017.0,1,0,1
MYS,HUN,2022.0,2,0,2
UKR,NZL,2010.0,1,0,1
ITA,SAU,2011.0,4,0,4
NOR,PER,2021.0,1,0,1
MYS,BGD,1999.0,1,0,1
IND,PRI,2019.0,1,0,1
URY,PRT,2019.0,1,0,1
GBR,COM,2021.0,1,0,1
KGZ,BGR,2018.0,1,0,1
VUT,AUS,2006.0,1,0,1
MEX,FIN,2021.0,5,0,5
,GUY,2018.0,8,0,8
AUT,TWN,2001.0,1,0,1
UZB,SYR,2019.0,1,0,1
KOR,LKA,2017.0,3,0,3
NOR,BGR,2022.0,1,0,1
MLI,ETH,2021.0,1,0,1
TJK,DEU,2013.0,1,0,1
HRV,KHM,2020.0,1,0,1
BLR,ARM,2014.0,1,0,1
ESP,ZAF,2009.0,3,0,3
CUB,CAN,2006.0,5,0,5
HND,CAN,2016.0,1,0,1
PNG,JPN,2016.0,1,0,1
BGD,AUS,2000.0,1,0,1
JPN,TUN,2007.0,1,0,1
SYR,MAR,2017.0,3,0,3
GTM,SWE,2003.0,1,0,1
BGD,PAK,2005.0,3,0,3
SLV,,2009.0,2,0,2
IND,IRN,2001.0,3,0,3
SRB,AUS,2012.0,1,0,1
NOR,LKA,2011.0,1,0,1
SRB,BEL,2014.0,4,0,4
THA,NZL,2013.0,2,0,2
BOL,NLD,2010.0,1,0,1
ISL,VNM,2015.0,1,0,1
ITA,AGO,2019.0,1,0,1
ETH,MWI,2019.0,1,0,1
IRN,SVN,2020.0,3,0,3
KAZ,UKR,2014.0,1,0,1
ISR,LBN,2013.0,1,0,1
MWI,SDN,2015.0,2,0,2
EST,BGD,2016.0,1,0,1
MEX,SAU,2011.0,1,0,1
,SWZ,2019.0,7,0,7
DZA,SDN,2017.0,1,0,1
PHL,KOR,2005.0,1,0,1
NZL,ISL,2020.0,1,0,1
ARG,SVN,2018.0,1,0,1
FRA,GUY,2002.0,2,0,2
BGD,FIN,2020.0,2,0,2
KOR,KEN,2013.0,1,0,1
BGD,SGP,2007.0,2,0,2
CHN,GIN,2012.0,1,0,1
ZMB,JPN,1997.0,1,0,1
PAK,PHL,2006.0,1,0,1
MDA,GBR,2002.0,1,0,1
DZA,ARG,1999.0,1,0,1
AUT,LUX,1999.0,2,0,2
BGD,NLD,2002.0,3,0,3
GRC,UKR,2003.0,1,0,1
EST,AUT,2010.0,2,0,2
MDG,GUF,2004.0,1,0,1
BRA,HUN,2002.0,1,0,1
IRN,MNG,2010.0,1,0,1
IRL,ARE,2013.0,2,0,2
PAN,POL,2004.0,1,0,1
CHL,ROU,2008.0,1,0,1
SVK,PRT,2012.0,1,0,1
EST,NOR,2005.0,1,0,1
BLR,ITA,2004.0,3,0,3
SYC,ZAF,2011.0,1,0,1
JPN,ARE,2010.0,4,0,4
HKG,IRL,2013.0,2,0,2
IRL,MLT,2015.0,2,0,2
IRL,ERI,2017.0,1,0,1
COL,USA,1997.0,2,0,2
,BMU,2013.0,5,0,5
PAK,SLE,2005.0,1,0,1
DZA,IRQ,2021.0,1,0,1
UZB,USA,2002.0,3,0,3
GBR,FJI,2015.0,3,0,3
HUN,AUT,1997.0,1,0,1
CUB,PRI,2019.0,1,0,1
MHL,USA,2008.0,1,0,1
MAR,GAB,2009.0,1,0,1
SDN,AFG,2021.0,1,0,1
MMR,IND,2011.0,2,0,2
BHR,YEM,2011.0,1,0,1
CYP,FRA,2000.0,1,0,1
POL,PRT,2000.0,1,0,1
PNG,ESP,2012.0,1,0,1
CHE,OMN,2019.0,1,0,1
GBR,COG,2014.0,1,0,1
BRA,IDN,2015.0,1,0,1
LUX,THA,2013.0,1,0,1
LUX,ARE,2011.0,1,0,1
MDA,DNK,2011.0,1,0,1
NAM,GBR,2014.0,2,0,2
NPL,FRA,2017.0,2,0,2
IRL,LVA,2018.0,1,0,1
PAN,PER,2021.0,2,0,2
VNM,CAN,2006.0,2,0,2
MEX,NZL,2009.0,1,0,1
UZB,KOR,2011.0,2,0,2
PHL,NGA,2021.0,1,0,1
KAZ,NLD,2015.0,1,0,1
BRA,PAN,2020.0,3,0,3
TWN,CZE,2018.0,5,0,5
ETH,NIC,2014.0,1,0,1
CAN,HTI,2016.0,1,0,1
DEU,LBY,2011.0,1,0,1
IND,COL,2012.0,1,0,1
ARM,SWE,2018.0,1,0,1
BLZ,,2021.0,3,0,3
IRL,EST,2021.0,1,0,1
PAK,KWT,2006.0,2,0,2
KEN,ZMB,2018.0,1,0,1
MDA,ESP,2019.0,1,0,1
GBR,ARM,2022.0,2,0,2
LBN,JOR,2017.0,1,0,1
GRC,THA,2021.0,1,0,1
PHL,VNM,2010.0,1,0,1
GBR,SUR,2019.0,1,0,1
ZWE,AUS,2016.0,1,0,1
THA,JOR,2017.0,1,0,1
BOL,CHE,2017.0,1,0,1
IRQ,LBY,2000.0,2,0,2
SRB,TWN,2010.0,1,0,1
SWE,JOR,2016.0,1,0,1
FIN,PRT,2001.0,1,0,1
TGO,RWA,2007.0,1,0,1
AUS,PHL,2005.0,1,0,1
BEL,PAK,2010.0,2,0,2
BEL,DZA,1999.0,1,0,1
ARM,CAN,2001.0,1,0,1
GRD,,2007.0,1,0,1
GHA,GBR,2000.0,1,0,1
ROU,PRT,2003.0,1,0,1
PAK,PRT,2011.0,1,0,1
CHN,NAM,2008.0,1,0,1
GRC,CMR,2012.0,1,0,1
IND,JAM,2019.0,1,0,1
CRI,ARG,2015.0,1,0,1
IRN,UKR,2014.0,3,0,3
COG,DEU,2019.0,1,0,1
ESP,ABW,2017.0,1,0,1
GUY,CAN,2016.0,1,0,1
MWI,ITA,2017.0,1,0,1
PRT,GNB,2020.0,1,0,1
TJK,ARM,2020.0,1,0,1
THA,VNM,2001.0,2,0,2
IRL,MEX,2000.0,1,0,1
NOR,ZWE,2003.0,2,0,2
SGP,LBN,2019.0,2,0,2
MYS,BRA,2017.0,1,0,1
SLB,USA,2017.0,1,0,1
ECU,DNK,2022.0,1,0,1
MAR,IRQ,2020.0,1,0,1
NLD,AFG,2015.0,1,0,1
SYR,MAR,2010.0,1,0,1
VEN,VNM,2012.0,1,0,1
NZL,NGA,2011.0,1,0,1
URY,MEX,2003.0,1,0,1
UKR,IRQ,2016.0,1,0,1
MEX,HND,2008.0,2,0,2
SHN,,2021.0,1,0,1
BOL,JPN,2000.0,1,0,1
RUS,MKD,2003.0,2,0,2
JPN,BEN,2008.0,2,0,2
NGA,POL,2008.0,1,0,1
IDN,KEN,2012.0,1,0,1
MAR,MDG,2005.0,1,0,1
SGP,GRC,2010.0,1,0,1
ISR,TWN,2004.0,1,0,1
TWN,MAC,2016.0,2,0,2
PAN,NLD,2020.0,1,0,1
DEU,MLT,2004.0,1,0,1
GMB,FRA,2017.0,1,0,1
RUS,LVA,2017.0,1,0,1
BOL,NLD,2019.0,2,0,2
SVK,IRQ,2015.0,1,0,1
FIN,MWI,2004.0,1,0,1
AUS,MKD,2011.0,1,0,1
IRL,MWI,2004.0,1,0,1
GRC,LTU,2009.0,1,0,1
ESP,NIC,2008.0,1,0,1
KEN,ZAF,1999.0,1,0,1
MDA,ITA,2004.0,1,0,1
POL,MAC,2007.0,1,0,1
IRL,ISL,2020.0,1,0,1
PHL,CHE,2001.0,1,0,1
ATG,GBR,2012.0,1,0,1
HRV,MKD,2013.0,3,0,3
SVN,MKD,2013.0,2,0,2
ESP,MAC,2015.0,1,0,1
NAM,DEU,2003.0,1,0,1
NGA,BWA,2007.0,1,0,1
ROU,SGP,2012.0,1,0,1
MWI,AUS,2002.0,1,0,1
CUB,ZAF,2016.0,1,0,1
ESP,CHN,2001.0,1,0,1
SEN,COD,2020.0,1,0,1
NGA,PAK,2012.0,1,0,1
FRA,AND,2012.0,1,0,1
SMR,USA,1998.0,1,0,1
TUR,BHR,2022.0,2,0,2
IRQ,SWE,2007.0,1,0,1
BTN,SGP,2007.0,1,0,1
TUR,LVA,2012.0,1,0,1
SEN,COG,2009.0,1,0,1
BIH,BEL,2017.0,1,0,1
MAR,YEM,2019.0,3,0,3
TTO,NZL,2009.0,1,0,1
EGY,DJI,2012.0,1,0,1
TUR,ISL,2005.0,1,0,1
ARM,AUS,2013.0,1,0,1
POL,HKG,2005.0,1,0,1
BFA,GBR,2005.0,1,0,1
TUR,ISR,2007.0,1,0,1
LSO,CHE,2014.0,1,0,1
MAC,NLD,2021.0,1,0,1
NER,SEN,2013.0,1,0,1
IRL,URY,2009.0,1,0,1
HKG,KOR,2000.0,3,0,3
AUT,NGA,2010.0,1,0,1
BEL,SUR,2015.0,1,0,1
ESP,MDG,2019.0,1,0,1
HRV,SWE,2008.0,1,0,1
KWT,SDN,2012.0,1,0,1
LBY,,1999.0,1,0,1
FIN,OMN,2008.0,1,0,1
NGA,KWT,1999.0,1,0,1
ZAF,AUT,2001.0,1,0,1
SEN,CAN,2012.0,1,0,1
JPN,COG,2012.0,1,0,1
USA,COD,2012.0,1,0,1
CRI,URY,2012.0,1,0,1
UKR,DNK,2014.0,1,0,1
NLD,DZA,2016.0,1,0,1
AUT,KOR,1999.0,1,0,1
FRA,CPV,2021.0,1,0,1
ITA,KWT,2015.0,1,0,1
GEO,JOR,2006.0,1,0,1
EGY,IDN,2019.0,1,0,1
JPN,MDG,2007.0,1,0,1
SYR,THA,2019.0,1,0,1
KWT,PSE,2013.0,1,0,1
UKR,PRI,2009.0,1,0,1
BRA,KOR,1998.0,1,0,1
MWI,NGA,2010.0,1,0,1
SVN,NZL,2012.0,1,0,1
HTI,CUB,2015.0,1,0,1
ECU,SWE,2019.0,1,0,1
ITA,PSE,2022.0,1,0,1
IRN,THA,2014.0,1,0,1
ALB,,2010.0,2,0,2
KAZ,LVA,2022.0,1,0,1
MAR,ISR,2015.0,1,0,1
PRT,HKG,2012.0,1,0,1
DEU,CMR,2002.0,1,0,1
TUR,PRT,2011.0,1,0,1
GRC,ECU,2016.0,1,0,1
IND,TLS,2021.0,1,0,1
MOZ,NLD,2015.0,2,0,2
PSE,AUS,2019.0,1,0,1
MAR,AUS,2020.0,1,0,1
BGR,SRB,2013.0,1,0,1
SRB,DEU,1997.0,1,0,1
PRI,NIC,2012.0,1,0,1
PRT,MOZ,2004.0,1,0,1
TZA,BWA,2017.0,1,0,1
USA,DMA,2019.0,1,0,1
TUR,DZA,2017.0,2,0,2
COG,CMR,2022.0,1,0,1
PYF,USA,2014.0,1,0,1
SWE,KGZ,2021.0,1,0,1
IRQ,IND,2000.0,1,0,1
BEL,JOR,2017.0,1,0,1
GBR,LUX,2006.0,1,0,1
LVA,FIN,2022.0,1,0,1
UZB,IRN,2022.0,1,0,1
HRV,OMN,2018.0,1,0,1
HRV,GRC,1999.0,1,0,1
ISR,ETH,2009.0,1,0,1
TTO,ARG,2011.0,1,0,1
ARM,JOR,2009.0,1,0,1
PAK,GEO,2015.0,1,0,1
FIN,LBY,2014.0,1,0,1
IND,ARE,1998.0,1,0,1
PAK,SGP,2003.0,1,0,1
ITA,MEX,1997.0,1,0,1
TWN,TUR,2016.0,2,0,2
SLE,CHE,2014.0,1,0,1
MYS,LKA,2014.0,1,0,1
FJI,PNG,2015.0,1,0,1
GRC,IRQ,2014.0,1,0,1
USA,LIE,2020.0,1,0,1
BTN,NLD,2007.0,1,0,1
IRL,NGA,2003.0,1,0,1
PAK,KAZ,2012.0,1,0,1
KEN,JPN,1998.0,1,0,1
SWE,MCO,2008.0,1,0,1
SWE,QAT,2010.0,1,0,1
DNK,HRV,2002.0,1,0,1
MYS,GAB,2015.0,1,0,1
IRN,SDN,2020.0,1,0,1
IDN,PHL,2008.0,1,0,1
BOL,URY,2016.0,1,0,1
GBR,BOL,2015.0,1,0,1
CUB,ROU,2014.0,1,0,1
AGO,,2004.0,1,0,1
TWN,PRT,2007.0,1,0,1
UKR,BGR,2019.0,1,0,1
FLK,TCA,2006.0,1,0,1
LTU,CHE,2015.0,1,0,1
ROU,CYP,2013.0,1,0,1
GIB,,2013.0,1,0,1
CHE,CIV,2017.0,1,0,1
UKR,NZL,2019.0,1,0,1
MEX,UGA,2017.0,1,0,1
LBN,IRQ,2020.0,1,0,1
SVN,HUN,2011.0,1,0,1
BRB,SWE,2017.0,1,0,1
ZWE,GHA,2021.0,1,0,1
DEU,GTM,2021.0,1,0,1
BRN,IDN,2011.0,1,0,1
ECU,SWE,2017.0,1,0,1
PER,FRA,2014.0,7,2,5
CHN,DNK,2004.0,7,7,0
USA,KOR,2004.0,580,507,73
EGY,PSE,2012.0,4,1,3
USA,CHE,2014.0,533,473,60
PRT,GBR,2006.0,32,44,-12
TUR,USA,2009.0,173,197,-24
SGP,CAN,2010.0,26,22,4
ESP,USA,2014.0,534,309,225
PAK,JPN,2005.0,3,5,-2
AUS,USA,2004.0,424,386,38
GRC,GBR,2019.0,226,172,54
USA,IND,2012.0,682,927,-245
ESP,SWE,2014.0,62,35,27
USA,DNK,2017.0,140,129,11
ITA,BEL,2009.0,60,31,29
CHE,DNK,2019.0,40,39,1
FRA,MEX,2011.0,47,28,19
FRA,MAR,2004.0,42,48,-6
DEU,CAN,2007.0,192,92,100
UKR,USA,2002.0,43,25,18
GBR,BRA,2011.0,60,52,8
FRA,BEL,2014.0,210,170,40
FRA,GAB,2010.0,3,3,0
USA,ISR,2012.0,314,348,-34
NLD,BEL,2011.0,126,102,24
SWE,DEU,2011.0,93,135,-42
SRB,DEU,2008.0,5,16,-11
DEU,FRA,2011.0,330,310,20
KOR,DEU,2016.0,62,50,12
PRT,FRA,2013.0,35,45,-10
HKG,CHN,2015.0,498,378,120
USA,KEN,2017.0,75,40,35
USA,ESP,1999.0,115,150,-35
GBR,MWI,2021.0,10,14,-4
DEU,ESP,2018.0,172,246,-74
CHE,EGY,2016.0,7,4,3
COG,FRA,2016.0,7,3,4
USA,KEN,2010.0,38,26,12
USA,DNK,2010.0,97,89,8
DEU,PSE,2012.0,4,2,2
DEU,ISR,2004.0,23,26,-3
ESP,BRA,2009.0,47,56,-9
PAK,AUT,2010.0,8,7,1
ITA,GBR,2018.0,564,349,215
GRC,GBR,2010.0,124,152,-28
ESP,SVN,2016.0,4,4,0
SAU,CAN,2007.0,19,42,-23
ITA,ESP,2022.0,103,76,27
GBR,NOR,2012.0,62,27,35
MTQ,FRA,2003.0,5,6,-1
NLD,GBR,1998.0,31,46,-15
SVK,USA,2004.0,21,7,14
USA,MEX,2012.0,175,152,23
NCL,FRA,2015.0,24,14,10
BRA,DEU,2018.0,116,80,36
NZL,CHN,2011.0,17,7,10
JPN,CAN,2003.0,106,75,31
BRA,GBR,2004.0,43,56,-13
FRA,NOR,2009.0,31,14,17
USA,ZWE,2020.0,10,1,9
USA,ALB,2018.0,2,2,0
ETH,CHE,2018.0,9,4,5
KOR,VNM,2013.0,40,16,24
RUS,BEL,1998.0,5,5,0
UGA,TZA,2013.0,1,3,-2
RUS,BEL,1997.0,4,2,2
UZB,MYS,2013.0,2,1,1
DEU,IRN,2008.0,18,17,1
NLD,AUS,2014.0,87,51,36
GBR,HKG,2009.0,38,41,-3
IRN,CHN,2016.0,23,4,19
TWN,DEU,2012.0,20,14,6
MAC,CHN,2020.0,117,103,14
POL,ITA,2020.0,12,21,-9
GBR,SAU,2008.0,34,10,24
USA,IRL,2018.0,136,154,-18
MYS,CHN,2014.0,6,3,3
TWN,CHN,2016.0,164,64,100
DEU,CHN,2009.0,128,186,-58
AUS,ZAF,2014.0,26,35,-9
FRA,CHN,2018.0,243,155,88
CHN,FRA,2002.0,38,24,14
USA,IRN,2010.0,47,163,-116
SWE,NLD,2019.0,58,85,-27
MNE,SRB,2017.0,7,8,-1
CAN,MEX,2019.0,25,46,-21
FRA,POL,2015.0,30,78,-48
CAN,KOR,2020.0,27,61,-34
CHN,VNM,2021.0,17,7,10
MYS,JOR,2016.0,24,8,16
EGY,CAN,2018.0,34,54,-20
FIN,NLD,2015.0,19,22,-3
GBR,IRN,2007.0,70,22,48
GRC,GBR,2017.0,256,122,134
USA,KEN,2019.0,49,60,-11
GBR,ZAF,2016.0,78,92,-14
NPL,BEL,2012.0,3,1,2
DNK,SVN,2015.0,1,5,-4
ZAF,USA,2018.0,107,80,27
FRA,PAK,2009.0,5,7,-2
ITA,POL,2016.0,10,21,-11
USA,DNK,2019.0,152,154,-2
FIN,CHL,2017.0,4,2,2
ROU,AUT,2014.0,6,1,5
ITA,CZE,2020.0,29,13,16
RUS,FRA,2015.0,49,48,1
IND,ZAF,2018.0,42,32,10
ITA,FIN,2020.0,34,22,12
IRL,AUT,2013.0,10,5,5
KOR,IDN,2019.0,41,15,26
ESP,DNK,2019.0,41,27,14
FRA,AUS,2018.0,86,71,15
POL,CHN,2013.0,9,16,-7
USA,TUN,2016.0,2,4,-2
SAU,AUS,2020.0,36,65,-29
USA,ARE,2002.0,20,12,8
ZAF,KEN,2019.0,22,16,6
SAU,NZL,2015.0,2,1,1
FRA,DEU,2022.0,149,114,35
SAU,IND,2012.0,23,107,-84
TUR,DEU,2013.0,26,52,-26
FRA,RUS,2009.0,29,42,-13
COL,DEU,2013.0,19,15,4
SAU,DEU,2019.0,22,30,-8
RUS,DEU,2022.0,57,29,28
CAN,IRN,2019.0,60,345,-285
USA,TZA,2020.0,16,20,-4
RUS,AUS,1998.0,8,3,5
UKR,SWE,2019.0,6,4,2
DNK,FRA,2002.0,25,22,3
PAK,KEN,2019.0,6,7,-1
MWI,USA,2017.0,12,17,-5
USA,PER,2003.0,24,15,9
SGP,CAN,2019.0,27,29,-2
EGY,CHN,2020.0,37,39,-2
BRA,SWE,2022.0,18,2,16
FRO,GBR,2019.0,1,1,0
ESP,IRL,2018.0,46,34,12
AUS,IND,2010.0,32,79,-47
BRA,POL,2020.0,12,4,8
KOR,ETH,2018.0,4,4,0
FRA,GAB,2017.0,5,5,0
SWE,KOR,2022.0,4,8,-4
PAK,NZL,2021.0,5,4,1
IRL,DEU,2019.0,39,41,-2
JPN,TUR,2015.0,7,4,3
GBR,CZE,2009.0,34,25,9
ECU,MEX,2018.0,8,8,0
SWE,TUR,2020.0,7,25,-18
GBR,QAT,2016.0,53,13,40
ZAF,SWE,2017.0,9,7,2
USA,RUS,2002.0,188,386,-198
DEU,BRA,2021.0,40,96,-56
RUS,CAN,2004.0,27,13,14
USA,GRC,2008.0,99,98,1
ISR,PRT,2008.0,2,1,1
DNK,JPN,2022.0,5,4,1
DEU,PAK,2018.0,32,19,13
SEN,GBR,2018.0,2,2,0
RUS,UKR,2021.0,27,28,-1
JPN,MYS,2020.0,27,28,-1
MWI,ZAF,2021.0,3,10,-7
AUT,DEU,2006.0,174,237,-63
DEU,DNK,2018.0,139,109,30
CHN,ESP,2019.0,32,51,-19
JPN,AUS,2015.0,52,49,3
CHE,AUT,2020.0,62,72,-10
COL,MEX,2022.0,13,13,0
MOZ,BRA,2019.0,7,6,1
CHN,ESP,2017.0,34,45,-11
DEU,AUS,2000.0,28,16,12
BGD,JPN,2003.0,19,19,0
USA,PRT,2013.0,60,68,-8
FIN,USA,2021.0,57,44,13
NLD,CHE,2000.0,14,10,4
AUS,NLD,2012.0,41,69,-28
NLD,AUT,2022.0,19,11,8
FRA,PRT,2020.0,40,36,4
BEL,IRN,2009.0,10,8,2
GAB,FRA,2014.0,3,8,-5
AUS,IND,2017.0,63,127,-64
PAK,KEN,2017.0,8,2,6
JPN,UKR,2008.0,8,2,6
MEX,DEU,2006.0,14,17,-3
RUS,ITA,2022.0,16,4,12
EGY,LBN,2007.0,2,1,1
ZAF,ITA,2012.0,6,13,-7
CHE,DNK,2010.0,22,21,1
IND,ITA,2011.0,32,31,1
EGY,DEU,2007.0,16,30,-14
EGY,SDN,2014.0,3,1,2
IRL,CHN,2012.0,16,11,5
MEX,GTM,2013.0,4,2,2
IDN,AUS,2007.0,5,13,-8
SAU,BHR,2008.0,1,2,-1
CAN,JPN,2008.0,67,76,-9
SGP,CHE,2016.0,16,19,-3
FRA,CAN,2000.0,65,39,26
KOR,IDN,2010.0,5,3,2
CAN,JOR,2018.0,13,8,5
KOR,GBR,2008.0,24,32,-8
SGP,CAN,2017.0,40,30,10
TWN,GBR,2007.0,22,36,-14
CAN,OMN,2013.0,16,6,10
BRA,CAN,2011.0,50,37,13
FIN,CHE,2010.0,12,6,6
USA,EGY,2006.0,72,38,34
GBR,NGA,2009.0,23,18,5
IRL,DNK,2017.0,7,8,-1
POL,CAN,2004.0,20,11,9
SGP,GBR,2008.0,47,58,-11
CHN,NLD,2008.0,27,26,1
DEU,JPN,1998.0,23,36,-13
SGP,AUS,2003.0,38,30,8
CHN,FRA,2005.0,28,39,-11
FIN,GBR,2005.0,39,25,14
LBY,MYS,2016.0,4,6,-2
POL,USA,1999.0,46,33,13
PHL,AUS,2019.0,16,11,5
RUS,USA,2000.0,220,49,171
BOL,FRA,2011.0,3,3,0
KOR,SWE,2018.0,15,11,4
DEU,JPN,1997.0,14,13,1
DNK,ITA,1998.0,6,10,-4
UKR,FRA,1999.0,5,6,-1
VEN,USA,2001.0,24,19,5
IRL,DNK,2019.0,5,8,-3
BHR,OMN,2016.0,1,1,0
GRC,AUT,2013.0,5,1,4
USA,RUS,2005.0,133,238,-105
SWE,POL,2019.0,19,27,-8
AUT,HUN,2015.0,12,18,-6
NOR,USA,2003.0,65,67,-2
DEU,NZL,2015.0,22,35,-13
USA,VNM,2013.0,29,8,21
RUS,CHN,2003.0,5,3,2
ZMB,GBR,2020.0,6,3,3
ESP,ECU,2020.0,54,44,10
GRC,HRV,2019.0,2,1,1
CAN,MEX,2017.0,32,43,-11
MDG,USA,2017.0,6,3,3
AUS,IND,2019.0,63,124,-61
IND,BGD,2012.0,6,9,-3
GRC,CYP,2005.0,7,2,5
MAR,TUN,2022.0,1,1,0
MWI,USA,2010.0,11,5,6
HKG,SWE,2015.0,4,4,0
MWI,USA,2019.0,26,17,9
ETH,RUS,2018.0,7,24,-17
TUR,CZE,2017.0,6,3,3
IND,AUT,2018.0,16,7,9
KOR,NPL,2020.0,13,4,9
BIH,HRV,2018.0,10,3,7
FIN,CHE,2017.0,17,19,-2
ARG,FRA,2020.0,38,19,19
DNK,CHL,2021.0,2,1,1
BGD,IND,1999.0,3,1,2
QAT,GBR,2015.0,10,38,-28
SWE,NLD,2017.0,37,78,-41
MAC,TWN,2022.0,2,1,1
NLD,JPN,2018.0,22,25,-3
IRN,CHE,2002.0,1,1,0
IRN,AZE,2019.0,3,1,2
GBR,IDN,2008.0,4,6,-2
POL,VNM,2013.0,2,2,0
IDN,KOR,2022.0,9,8,1
ESP,SAU,2022.0,5,2,3
SWE,GBR,2007.0,111,90,21
NLD,GBR,1997.0,14,11,3
AGO,GBR,2018.0,1,1,0
FIN,ITA,2008.0,6,9,-3
FRA,GAB,2019.0,15,4,11
PNG,AUS,2002.0,5,3,2
GRC,DEU,2004.0,25,22,3
DEU,EST,2008.0,7,4,3
UKR,USA,2005.0,44,19,25
MAR,SAU,2016.0,2,1,1
SAU,DZA,2018.0,4,11,-7
USA,ARE,2005.0,31,9,22
THA,CAN,2014.0,10,11,-1
AUS,DEU,2006.0,70,108,-38
DNK,DEU,2004.0,47,38,9
CHE,AUS,2002.0,29,31,-2
SWE,NLD,2010.0,31,37,-6
RUS,BRA,2016.0,5,11,-6
MWI,NLD,2008.0,1,1,0
AUS,FRA,2005.0,33,36,-3
NZL,IDN,2017.0,7,1,6
CAN,ITA,2013.0,44,53,-9
DNK,LTU,2015.0,2,2,0
BGR,GBR,2000.0,10,4,6
ARG,ESP,2000.0,13,17,-4
GBR,CYP,2001.0,3,2,1
ESP,CHE,1999.0,13,12,1
VNM,GBR,2001.0,5,3,2
AUT,CHE,2007.0,41,36,5
KWT,EGY,2007.0,6,10,-4
COL,KEN,2013.0,2,1,1
ITA,ISR,2006.0,6,8,-2
SWE,ZAF,2004.0,4,1,3
CAN,AUT,2003.0,17,12,5
ROU,ITA,2003.0,6,4,2
IND,AUS,2003.0,25,20,5
IRN,CHE,2005.0,2,3,-1
ARG,GBR,2006.0,10,15,-5
IND,OMN,2008.0,10,3,7
ITA,MEX,2008.0,8,7,1
NLD,DNK,2000.0,13,5,8
GBR,BEL,2000.0,19,25,-6
ISR,PSE,2016.0,14,3,11
CZE,AUT,2001.0,10,3,7
ESP,FIN,2003.0,5,8,-3
BIH,SVN,2014.0,2,1,1
CZE,NOR,2013.0,3,7,-4
CZE,DEU,2003.0,26,27,-1
CAN,IRN,2010.0,52,158,-106
FRA,SWE,2009.0,56,40,16
ITA,JOR,2022.0,3,1,2
MLI,KEN,2010.0,1,1,0
KOR,DNK,2003.0,2,1,1
IDN,JPN,2008.0,10,46,-36
BGD,USA,1999.0,5,2,3
DEU,CHL,2003.0,7,8,-1
CHN,MEX,2016.0,4,4,0
USA,GTM,2008.0,2,2,0
ITA,RUS,2007.0,19,26,-7
USA,SVK,2015.0,9,5,4
DEU,LUX,2004.0,7,1,6
ITA,ECU,2013.0,6,1,5
HKG,NLD,2003.0,1,2,-1
DNK,RUS,2003.0,7,2,5
ITA,VNM,2002.0,4,1,3
NOR,GRC,2003.0,1,3,-2
ECU,USA,2004.0,6,5,1
AUS,MEX,2013.0,9,9,0
NLD,PRT,2004.0,15,8,7
POL,BLR,2013.0,6,4,2
UKR,RUS,2012.0,30,28,2
USA,VEN,2006.0,31,36,-5
SVK,HRV,2002.0,2,4,-2
MEX,KOR,2015.0,3,1,2
FRA,IRL,2001.0,6,10,-4
DEU,TUR,2004.0,16,16,0
BHR,EGY,2014.0,3,1,2
SGP,POL,2016.0,5,1,4
JPN,TWN,2003.0,34,17,17
FIN,CHN,2011.0,11,13,-2
BEL,JPN,2016.0,11,13,-2
FIN,CAN,2009.0,17,9,8
GBR,PAK,2008.0,28,41,-13
PHL,AUS,2017.0,18,6,12
SAU,ZAF,2014.0,6,2,4
ARE,CAN,2007.0,6,11,-5
ARE,TUR,2013.0,4,4,0
MEX,IRL,2011.0,2,3,-1
NGA,DEU,2016.0,5,8,-3
ARG,CHL,2006.0,14,10,4
AUS,SVN,2021.0,2,2,0
PAK,IND,2002.0,4,4,0
POL,CHE,2011.0,18,25,-7
IND,NGA,2009.0,2,2,0
LUX,CAN,2020.0,2,4,-2
CAN,BGD,2010.0,7,10,-3
SWE,ISL,2022.0,5,2,3
COL,FRA,2018.0,14,36,-22
GBR,ROU,2004.0,5,10,-5
ZAF,ZMB,2011.0,3,3,0
BEN,ZAF,2010.0,1,1,0
NZL,NLD,2011.0,6,4,2
KOR,QAT,2012.0,1,1,0
ZAF,CAN,2012.0,11,17,-6
ISL,CHE,2016.0,3,2,1
ZAF,SWE,2019.0,14,8,6
IRN,JPN,2011.0,9,16,-7
THA,SWE,2011.0,9,2,7
JOR,BHR,2019.0,7,2,5
CUB,ESP,2009.0,29,19,10
IND,ETH,2013.0,16,6,10
SLV,USA,2015.0,1,1,0
SWE,POL,2010.0,5,17,-12
FRA,COG,2011.0,5,5,0
ESP,HRV,2016.0,6,3,3
NLD,ETH,2013.0,4,4,0
IRL,DNK,2010.0,7,1,6
GMB,GBR,2019.0,12,13,-1
TUR,AZE,2016.0,7,2,5
HKG,ITA,2019.0,7,3,4
CHN,ESP,2010.0,8,7,1
CHN,KOR,2000.0,10,4,6
EST,FRA,2017.0,6,2,4
POL,TUR,2020.0,3,6,-3
IRL,ITA,2015.0,18,32,-14
PSE,USA,2014.0,3,9,-6
IND,IRQ,2018.0,9,2,7
COL,CHE,2018.0,5,5,0
FIN,IRL,2019.0,3,5,-2
NLD,NZL,2022.0,2,1,1
SAU,DEU,2017.0,13,36,-23
CZE,CHE,2015.0,13,14,-1
ESP,QAT,2020.0,2,2,0
ZAF,EGY,2017.0,1,2,-1
ETH,ITA,2013.0,2,1,1
DNK,ARG,2018.0,4,4,0
ARE,DEU,2020.0,6,13,-7
NOR,THA,2012.0,1,1,0
BEL,FIN,2016.0,8,7,1
BIH,TUR,2017.0,3,6,-3
SAU,ITA,2020.0,8,9,-1
DNK,ITA,1997.0,7,5,2
ZMB,MYS,2021.0,1,1,0
LKA,IND,2019.0,1,6,-5
RUS,AUT,2015.0,8,5,3
PER,GBR,2021.0,7,3,4
IND,MMR,2018.0,3,1,2
NGA,NLD,2015.0,2,4,-2
USA,DOM,2009.0,1,1,0
MDG,USA,2019.0,2,5,-3
ESP,POL,2001.0,6,8,-2
IND,ARE,2008.0,5,3,2
DNK,FRA,2005.0,12,22,-10
FRA,GUF,2001.0,2,2,0
NOR,ESP,2018.0,9,21,-12
ZAF,PAK,2020.0,5,2,3
ROU,AUS,2011.0,4,2,2
UKR,SWE,2017.0,5,2,3
AUS,ROU,2002.0,1,3,-2
CAN,CZE,2005.0,3,6,-3
CAN,TWN,2022.0,8,1,7
BRA,LUX,2022.0,3,1,2
CHE,AUS,2005.0,25,28,-3
JPN,PHL,2006.0,11,16,-5
PAN,USA,2003.0,9,5,4
NLD,IRL,2009.0,14,13,1
CAN,BGD,2017.0,20,30,-10
USA,MLI,2015.0,3,3,0
IRN,FRA,2015.0,22,37,-15
KAZ,FIN,2020.0,2,1,1
FIN,CZE,2016.0,8,2,6
COG,GBR,2015.0,1,1,0
FIN,KOR,2014.0,3,3,0
CHL,JPN,2013.0,2,5,-3
PAK,AUT,2019.0,3,5,-2
ITA,MLT,2015.0,2,3,-1
CHE,HRV,2014.0,4,9,-5
ZAF,KEN,2017.0,17,9,8
BIH,TUR,2019.0,4,5,-1
FRA,EST,2021.0,4,3,1
NLD,PAK,2015.0,16,6,10
AGO,BRA,2014.0,1,4,-3
FIN,IND,2019.0,11,17,-6
AUT,CZE,2003.0,5,7,-2
NLD,MYS,2013.0,6,5,1
HUN,IND,2020.0,7,10,-3
YEM,EGY,2020.0,1,7,-6
IND,BTN,2020.0,4,1,3
AUT,JPN,2020.0,12,8,4
GRC,BGD,2008.0,1,2,-1
GBR,COL,2013.0,9,17,-8
RUS,DNK,2008.0,1,6,-5
PHL,DEU,2016.0,5,6,-1
NZL,ESP,2008.0,2,3,-1
UKR,ITA,2010.0,8,2,6
JPN,KEN,2006.0,4,5,-1
CAN,KWT,2001.0,1,1,0
ZAF,KEN,2010.0,9,13,-4
PRT,JPN,2009.0,1,3,-2
VEN,ARG,2009.0,5,5,0
SVN,BEL,2013.0,2,1,1
RUS,GEO,2007.0,6,2,4
BRA,DNK,2006.0,3,5,-2
URY,ARG,2009.0,2,3,-1
NLD,TUR,2005.0,6,8,-2
NOR,ISL,2005.0,5,1,4
GEO,DEU,2007.0,6,3,3
KWT,NGA,2010.0,1,1,0
SVK,GBR,1997.0,3,2,1
FIN,CHE,2019.0,13,13,0
IRQ,JOR,2013.0,1,2,-1
GEO,FRA,2015.0,5,8,-3
IND,IRN,2004.0,12,1,11
ITA,CHL,2005.0,4,1,3
BGR,CAN,2001.0,3,5,-2
CHE,THA,2012.0,3,5,-2
AUS,KWT,2016.0,3,4,-1
KOR,PAK,2012.0,13,15,-2
VNM,FRA,2012.0,7,17,-10
GBR,PNG,2012.0,1,1,0
LUX,ITA,2014.0,2,10,-8
BOL,USA,2005.0,7,3,4
AUS,CZE,2016.0,6,6,0
TUR,CAN,2003.0,7,3,4
CAN,QAT,2020.0,15,5,10
ZAF,NOR,2008.0,2,1,1
IND,BEL,2001.0,3,5,-2
LAO,FRA,2002.0,1,1,0
CHE,CHL,2008.0,2,1,1
ISR,DNK,2005.0,2,2,0
BEL,ECU,2009.0,1,1,0
NLD,POL,2004.0,4,8,-4
CZE,FRA,2013.0,12,27,-15
BEL,MEX,2012.0,5,5,0
ESP,SGP,2014.0,5,3,2
CHE,GEO,2012.0,1,1,0
BGD,KOR,2011.0,11,16,-5
ARM,DEU,2006.0,3,2,1
MYS,SWE,2015.0,4,5,-1
DEU,SVN,2018.0,4,11,-7
IRL,PAK,2014.0,5,3,2
URY,MEX,2014.0,1,3,-2
TWN,CAN,2014.0,13,9,4
UKR,ITA,2019.0,2,2,0
JOR,GBR,2011.0,7,15,-8
BEL,ZWE,2018.0,2,1,1
FRA,KOR,1999.0,2,3,-1
BEL,CMR,2017.0,3,2,1
NLD,ZAF,2022.0,4,11,-7
SWE,POL,2017.0,12,21,-9
NOR,POL,2014.0,3,21,-18
CMR,USA,2016.0,8,2,6
TUR,BRA,2020.0,4,2,2
GHA,FRA,2012.0,2,1,1
LTU,FRA,2020.0,3,3,0
GRC,EGY,2019.0,1,2,-1
THA,NLD,2021.0,3,5,-2
HUN,CZE,2011.0,3,3,0
GAB,USA,2014.0,2,5,-3
ECU,FRA,2006.0,2,2,0
USA,COL,1998.0,6,5,1
EST,NLD,2005.0,1,2,-1
GMB,GBR,2010.0,6,6,0
IRL,CZE,2013.0,3,1,2
ARG,PER,2015.0,4,3,1
FRA,AUT,1999.0,2,11,-9
FRA,KWT,2020.0,1,2,-1
MYS,ETH,2017.0,1,1,0
ARG,BRA,2000.0,6,10,-4
BWA,USA,2013.0,6,6,0
GBR,BEN,2011.0,1,1,0
TUR,CZE,2019.0,6,6,0
ZAF,MWI,2015.0,5,3,2
AUT,TUR,2020.0,4,4,0
GIN,GNQ,2016.0,3,1,2
NLD,IRN,2012.0,9,33,-24
RUS,SGP,2014.0,5,2,3
ZAF,SWZ,2021.0,5,3,2
LAO,THA,2011.0,2,2,0
CHN,YEM,2011.0,1,1,0
SVN,AUT,2012.0,5,3,2
CHL,PHL,2019.0,2,1,1
IRN,ESP,2009.0,4,3,1
GBR,BLR,2007.0,2,5,-3
BOL,USA,2002.0,2,1,1
USA,PRI,2000.0,11,17,-6
COD,CHE,2018.0,1,1,0
EGY,SWE,2011.0,5,1,4
PSE,GBR,2016.0,1,5,-4
MNE,SRB,2010.0,6,3,3
AUS,PNG,2009.0,4,5,-1
PRT,SRB,2013.0,2,2,0
LVA,CHE,2017.0,3,1,2
FRA,VEN,2020.0,3,1,2
MYS,THA,2013.0,6,6,0
BGR,RUS,2022.0,3,1,2
NZL,FJI,2011.0,1,3,-2
SVN,PRT,2015.0,2,2,0
SWE,IND,2002.0,6,8,-2
FIN,IRL,2017.0,4,4,0
BRA,IND,2021.0,4,8,-4
ETH,GBR,2019.0,4,7,-3
IRQ,IRN,2017.0,3,7,-4
GBR,BGR,2022.0,1,1,0
ZWE,NLD,2013.0,3,3,0
GBR,GMB,2012.0,4,8,-4
SWE,EST,2003.0,10,3,7
FRA,THA,2014.0,11,14,-3
NZL,THA,2003.0,1,1,0
NLD,EST,2003.0,3,1,2
NLD,SVK,2003.0,5,2,3
FRA,FIN,2001.0,10,9,1
AUS,COL,2011.0,2,12,-10
DNK,GNB,2009.0,2,5,-3
USA,MWI,2003.0,6,1,5
ISR,NLD,2000.0,4,1,3
PRT,GRC,2002.0,1,3,-2
PSE,ISR,2011.0,10,12,-2
BRA,FRA,1999.0,16,35,-19
ISR,NOR,2013.0,1,2,-1
ZAF,CHN,2006.0,5,6,-1
RUS,TUR,2017.0,2,6,-4
SWE,TWN,2012.0,1,3,-2
ROU,PRT,2014.0,1,3,-2
BIH,SRB,2008.0,2,12,-10
GEO,BEL,2019.0,2,1,1
AUT,IND,2014.0,5,12,-7
ETH,SWE,2020.0,6,3,3
USA,MDG,2011.0,5,1,4
MEX,SWE,2021.0,5,3,2
KWT,MAR,2019.0,1,1,0
POL,AUS,2020.0,9,8,1
SWE,ETH,2014.0,4,1,3
GIN,FRA,2018.0,1,9,-8
NLD,PER,2020.0,1,3,-2
ISR,POL,2021.0,3,1,2
SWE,MYS,2012.0,5,4,1
BRN,PAK,2021.0,2,1,1
BLR,USA,2021.0,4,1,3
ITA,AUT,2004.0,14,17,-3
THA,KOR,2001.0,4,2,2
LVA,DEU,1999.0,1,1,0
JPN,BEL,2005.0,9,7,2
JAM,USA,2006.0,5,6,-1
KOR,BRA,2011.0,1,3,-2
AUS,IRL,1997.0,5,1,4
EGY,ARE,1998.0,2,1,1
TUR,JPN,2018.0,9,10,-1
TWN,AUT,2014.0,2,2,0
DEU,CYP,2021.0,6,3,3
USA,KHM,2014.0,3,4,-1
TGO,FRA,2011.0,2,4,-2
CAN,BGR,2016.0,1,1,0
CMR,CHN,2015.0,3,1,2
CHE,CZE,2009.0,9,9,0
CAN,GRC,2009.0,7,14,-7
MAR,MLI,2016.0,1,1,0
BGD,MEX,2017.0,1,1,0
SAU,TUR,2013.0,1,7,-6
CHE,UGA,2019.0,1,3,-2
ROU,ESP,2005.0,2,4,-2
DEU,MKD,2008.0,2,3,-1
SEN,MLI,2012.0,1,2,-1
ETH,DEU,2006.0,3,5,-2
ISR,DNK,2002.0,3,5,-2
IDN,NLD,2001.0,2,4,-2
ITA,ALB,2020.0,3,6,-3
GBR,HUN,2016.0,17,34,-17
SRB,RUS,2018.0,4,4,0
BRA,PAK,2020.0,5,4,1
SWE,GEO,2018.0,1,1,0
BRN,ARE,2016.0,1,1,0
IND,BRA,2022.0,1,6,-5
IND,HUN,2021.0,3,4,-1
NLD,ARG,2016.0,4,4,0
TWN,ESP,2015.0,2,4,-2
CHL,SWE,2004.0,2,2,0
PHL,GBR,2022.0,4,4,0
DEU,TUN,2013.0,3,2,1
USA,MAR,2014.0,3,3,0
TZA,NLD,2013.0,1,1,0
BEN,ZAF,2017.0,1,1,0
USA,GMB,2016.0,4,1,3
IRL,RUS,2003.0,1,4,-3
RUS,CZE,2008.0,7,9,-2
SWE,IND,2005.0,6,15,-9
GRC,DNK,2000.0,1,1,0
ZAF,PRT,2021.0,1,2,-1
CAN,LTU,2007.0,2,1,1
NOR,FRA,1998.0,1,2,-1
OMN,ZAF,2016.0,1,1,0
FIN,HKG,2006.0,2,2,0
AUT,ETH,2014.0,2,4,-2
CHE,SVK,2012.0,1,3,-2
CHE,UGA,2017.0,2,3,-1
BRA,CRI,2010.0,3,3,0
ZAF,AUT,2004.0,2,1,1
CRI,CHL,2017.0,1,1,0
PAK,IND,2005.0,10,9,1
NLD,PHL,2018.0,3,1,2
LKA,IND,2017.0,1,6,-5
KOR,HKG,2004.0,2,2,0
MEX,URY,2020.0,2,5,-3
ROU,SVN,2011.0,1,1,0
UGA,GMB,2007.0,2,1,1
BEL,CMR,2010.0,4,2,2
BEL,PRT,2002.0,3,4,-1
DZA,ESP,2016.0,3,6,-3
BEL,CMR,2019.0,1,5,-4
URY,FRA,2005.0,2,4,-2
SEN,ZAF,2021.0,1,2,-1
BEL,THA,2005.0,1,1,0
HUN,ROU,1998.0,1,3,-2
GBR,LVA,2001.0,1,5,-4
CAN,CMR,2022.0,1,3,-2
LTU,RUS,2005.0,3,3,0
AUS,NGA,2018.0,4,9,-5
UKR,SWE,2010.0,4,2,2
ITA,NGA,1999.0,1,1,0
BLR,ITA,2001.0,2,1,1
CMR,ESP,2005.0,1,1,0
ISR,JPN,1998.0,3,2,1
BEL,SVK,2005.0,2,2,0
NOR,UKR,2019.0,2,2,0
HUN,FIN,2021.0,2,2,0
KEN,DEU,2021.0,6,5,1
NOR,JPN,2022.0,1,5,-4
GRC,CYP,2002.0,4,2,2
CYP,CAN,2017.0,5,1,4
ESP,CHN,2004.0,5,2,3
CAN,CZE,2002.0,5,16,-11
NAM,ZAF,2001.0,1,1,0
SAU,MAR,2018.0,2,1,1
PHL,AUS,2010.0,6,8,-2
HUN,ISR,2014.0,2,2,0
LIE,DEU,1999.0,2,2,0
GRC,IRL,2001.0,1,1,0
RUS,KOR,1997.0,1,1,0
ZAF,SWE,2010.0,4,2,2
MAR,ARE,2017.0,2,2,0
ARE,SGP,2016.0,1,4,-3
CHL,PRT,2011.0,1,1,0
RUS,MNG,2011.0,2,1,1
LIE,AUT,2007.0,1,1,0
AUS,ESP,2004.0,1,4,-3
BRN,HKG,2015.0,1,1,0
CZE,IND,2005.0,1,1,0
DNK,MEX,2011.0,2,4,-2
JOR,OMN,2007.0,3,1,2
CZE,ZAF,2022.0,1,3,-2
HUN,CHE,1997.0,1,3,-2
DEU,NPL,2016.0,3,3,0
LKA,BRN,2014.0,1,1,0
USA,PRY,2022.0,1,2,-1
MYS,KWT,2022.0,2,1,1
MEX,NLD,2006.0,3,3,0
BEL,NER,2014.0,1,1,0
IRQ,IRN,2019.0,3,23,-20
EST,FRA,2019.0,1,1,0
BFA,USA,2012.0,1,4,-3
BGD,MEX,2019.0,1,1,0
OMN,GBR,2002.0,2,4,-2
OMN,SAU,2012.0,2,6,-4
PYF,FRA,2022.0,3,4,-1
BRA,AGO,2015.0,1,1,0
PER,BEL,2015.0,3,2,1
ECU,NZL,2020.0,1,1,0
TTO,CAN,2017.0,1,6,-5
TGO,CAN,2018.0,1,2,-1
DZA,KOR,2020.0,1,1,0
GRD,GBR,2009.0,1,1,0
MOZ,BRA,2017.0,4,6,-2
MKD,NLD,2020.0,2,2,0
FRA,ECU,2003.0,3,4,-1
CHN,GHA,2014.0,3,8,-5
IRL,GRC,2021.0,1,5,-4
SWE,PAK,2005.0,1,1,0
HRV,AUT,2006.0,1,2,-1
ITA,CHL,2002.0,1,2,-1
NLD,SWE,1999.0,7,13,-6
NOR,LTU,1999.0,1,1,0
HUN,CHE,1998.0,2,2,0
CHN,PRT,2006.0,1,7,-6
CAN,HRV,2013.0,2,1,1
CHE,GTM,2010.0,1,1,0
AUT,ROU,2001.0,1,3,-2
TZA,JPN,2007.0,1,3,-2
RUS,TJK,2005.0,1,1,0
ESP,ARE,2014.0,2,2,0
ZAF,ZWE,2009.0,2,21,-19
MAR,ARE,2019.0,1,4,-3
NZL,TUR,2021.0,1,1,0
GBR,RWA,2013.0,1,1,0
GRC,JPN,2012.0,1,1,0
SAU,SWE,2009.0,2,2,0
CYP,GBR,2001.0,2,3,-1
FIN,ISR,2011.0,1,1,0
IND,NAM,2012.0,1,1,0
BEN,BEL,2013.0,2,1,1
PAK,AUT,2017.0,1,9,-8
AUT,EGY,2012.0,1,2,-1
GUY,GUF,2016.0,1,1,0
JPN,OMN,2006.0,1,2,-1
MAR,ITA,2007.0,1,1,0
LKA,SWE,2016.0,1,3,-2
ITA,BGD,2012.0,4,3,1
URY,BRA,2001.0,2,1,1
KOR,PRT,2021.0,2,1,1
LKA,THA,2011.0,1,1,0
ZMB,JPN,2008.0,1,1,0
KWT,NLD,2021.0,1,1,0
KWT,IND,2022.0,1,1,0
DNK,IRL,2014.0,1,9,-8
ISL,GBR,1999.0,1,4,-3
NZL,EGY,2007.0,1,2,-1
OMN,THA,2016.0,1,1,0
AUS,URY,2017.0,1,1,0
ITA,KAZ,2016.0,1,2,-1
SVK,FIN,2016.0,1,1,0
ITA,GHA,2018.0,2,2,0
PRT,ARG,2014.0,2,3,-1
CUB,URY,2017.0,2,1,1
ROU,ESP,2002.0,1,3,-2
EST,FRA,2010.0,3,2,1
KGZ,PAK,2014.0,1,1,0
JPN,NOR,2006.0,2,2,0
BWA,ZWE,2012.0,1,2,-1
RUS,ROU,2008.0,3,1,2
NGA,FRA,2012.0,1,1,0
QAT,SAU,2011.0,1,1,0
BIH,TUR,2010.0,1,1,0
ISR,HUN,2022.0,1,1,0
KOR,POL,2006.0,1,1,0
ISL,BEL,2014.0,1,2,-1
PAK,AFG,2015.0,1,1,0
SGP,NOR,1999.0,1,1,0
KEN,AUS,2004.0,1,4,-3
BLR,LTU,2021.0,1,1,0
JPN,CYP,2002.0,1,1,0
LBN,ITA,2012.0,1,1,0
GRC,SRB,2015.0,1,2,-1
ITA,VNM,2005.0,1,1,0
UZB,CHN,2015.0,1,1,0
THA,CZE,2019.0,1,2,-1
LBY,TUR,2020.0,1,4,-3
MNG,TWN,2021.0,1,1,0
SWE,BGR,2014.0,1,5,-4
SRB,TUR,2014.0,1,3,-2
NGA,KEN,2000.0,1,1,0
SRB,NOR,2022.0,1,1,0
IRL,SDN,2013.0,1,1,0
KEN,PAK,2022.0,1,8,-7
BEL,COL,2021.0,1,1,0
SDN,ZAF,2014.0,1,3,-2
ETH,IRL,2015.0,1,1,0
EST,ESP,2009.0,2,2,0
LUX,AUT,2022.0,1,1,0
GBR,SVK,2022.0,1,2,-1
GBR,MLT,2004.0,2,3,-1
UKR,DNK,2003.0,1,1,0
FRA,CRI,2013.0,1,1,0
CZE,BRA,2011.0,1,2,-1
DEU,KEN,2001.0,1,2,-1
HRV,RUS,2009.0,1,2,-1
NOR,FRA,1997.0,1,2,-1
GBR,LTU,2001.0,1,1,0
RUS,BGR,2009.0,1,2,-1
VNM,CHE,2009.0,1,2,-1
GHA,NOR,2011.0,1,1,0
SDN,MYS,2022.0,1,3,-2
ESP,HKG,2018.0,1,1,0
SVK,NOR,2006.0,1,1,0
BEL,ARM,2002.0,1,1,0
LTU,RUS,2002.0,1,4,-3
MWI,DEU,2002.0,1,1,0
SAU,DEU,2010.0,1,27,-26
SAU,KAZ,2019.0,2,2,0
IRN,UKR,2003.0,1,1,0
CHL,CAN,2001.0,1,6,-5
ARE,AUT,2007.0,1,1,0
BRA,KOR,2008.0,2,1,1
PNG,BTN,2016.0,1,1,0
CMR,GBR,2008.0,1,5,-4
DNK,SVK,2008.0,1,1,0
USA,AZE,2022.0,1,1,0
ESP,EGY,2001.0,1,2,-1
FIN,BGD,2010.0,1,1,0
ITA,PHL,2013.0,1,1,0
DZA,ROU,2011.0,1,1,0
NPL,MYS,2009.0,1,1,0
ESP,COL,2018.0,100,63,37
SWE,ITA,2021.0,34,51,-17
ESP,DNK,2017.0,55,26,29
DEU,USA,2018.0,1132,1064,68
JPN,EGY,2010.0,47,15,32
GBR,SWE,2009.0,105,112,-7
GBR,IND,2009.0,97,126,-29
JPN,USA,2003.0,1297,1097,200
IND,SWE,2011.0,44,22,22
JPN,AUT,2015.0,11,10,1
ITA,TUR,2013.0,12,10,2
USA,POL,2012.0,251,89,162
MYS,IND,2018.0,68,44,24
GBR,POL,2021.0,49,39,10
FRA,CZE,2014.0,16,14,2
USA,SGP,2011.0,238,141,97
JPN,VNM,2009.0,20,10,10
HKG,USA,2003.0,97,72,25
ESP,NLD,2015.0,80,56,24
IND,ISR,2021.0,106,52,54
USA,IRN,2019.0,133,535,-402
CHE,DNK,2017.0,25,31,-6
JPN,GBR,2003.0,124,94,30
KOR,JPN,2015.0,80,119,-39
ZAF,AUS,2020.0,46,31,15
FRA,DNK,2021.0,40,35,5
FIN,IND,2017.0,8,15,-7
ITA,NLD,2012.0,98,57,41
ESP,MEX,2012.0,120,78,42
CHE,USA,2001.0,299,213,86
IND,ESP,2014.0,17,16,1
JPN,EGY,2019.0,54,28,26
SWE,FIN,2018.0,50,70,-20
IRL,CAN,2016.0,33,38,-5
PAK,SAU,2012.0,48,15,33
BEL,DNK,2020.0,17,16,1
RUS,NLD,2003.0,17,10,7
AUT,BRA,2018.0,8,13,-5
KOR,IDN,2017.0,30,14,16
GRC,NLD,2016.0,35,9,26
KAZ,RUS,2022.0,11,10,1
PRT,ITA,2022.0,16,18,-2
RUS,VNM,2020.0,19,14,5
CAN,BGD,2019.0,21,29,-8
SAU,GBR,2020.0,56,190,-134
MNE,SRB,2019.0,19,3,16
AUS,BGD,2011.0,7,32,-25
ZAF,FRA,2013.0,16,22,-6
UKR,CHN,2020.0,10,9,1
FRA,ZAF,2020.0,10,12,-2
SWE,JPN,2014.0,33,28,5
ROU,DEU,2003.0,25,9,16
JPN,EGY,2017.0,42,17,25
PRT,POL,2011.0,6,6,0
FRA,ITA,2011.0,152,310,-158
USA,IRN,2017.0,87,598,-511
FIN,NOR,2013.0,15,8,7
CAN,AUS,2003.0,83,99,-16
AUS,FJI,2014.0,14,6,8
PRT,BEL,2014.0,12,7,5
ARG,MEX,2016.0,20,19,1
MYS,CAN,2020.0,25,9,16
BRA,CRI,2019.0,4,3,1
BRA,NZL,2011.0,4,2,2
FIN,GBR,2002.0,44,44,0
DEU,BEL,2000.0,34,13,21
COD,COG,2006.0,4,3,1
JPN,LKA,2007.0,4,2,2
USA,NAM,2022.0,1,1,0
AUS,FRA,2002.0,37,58,-21
JPN,NPL,2016.0,8,8,0
BRA,CZE,2015.0,6,3,3
ALB,USA,2010.0,1,5,-4
COL,USA,2008.0,42,48,-6
CHE,PRT,2009.0,8,6,2
GEO,RUS,2005.0,4,2,2
SWE,MEX,2008.0,2,2,0
ISL,USA,1998.0,2,3,-1
NZL,KOR,2012.0,3,2,1
RUS,AUS,1997.0,5,2,3
MAC,USA,2009.0,2,6,-4
GMB,GBR,2017.0,5,4,1
PRI,USA,2011.0,66,50,16
IRL,DEU,2017.0,35,32,3
SGP,ZAF,2013.0,1,1,0
CAN,MEX,2010.0,15,40,-25
IRL,DEU,2010.0,33,52,-19
THA,SGP,2008.0,7,1,6
DEU,CRI,2018.0,7,3,4
TUR,NZL,2015.0,2,4,-2
KEN,USA,2022.0,22,21,1
ISR,CHN,2016.0,8,13,-5
PAK,JPN,2002.0,6,5,1
AUT,ESP,2022.0,9,17,-8
UKR,PAK,2009.0,2,1,1
GRL,DNK,2020.0,3,6,-3
HUN,AUT,2008.0,14,7,7
NLD,RUS,2012.0,10,14,-4
OMN,GBR,2005.0,4,13,-9
ISR,DEU,2012.0,39,30,9
AUS,NPL,2008.0,1,1,0
PAK,ITA,2011.0,7,1,6
EGY,RUS,2016.0,2,2,0
NOR,FIN,2014.0,6,15,-9
GEO,RUS,2002.0,3,2,1
NOR,BEL,2001.0,3,2,1
NOR,CHE,2000.0,2,3,-1
JPN,BEL,2002.0,9,9,0
TWN,GRC,2015.0,2,1,1
JPN,POL,2009.0,5,3,2
UKR,ITA,2017.0,3,1,2
PRT,NLD,2007.0,8,18,-10
ARM,USA,2015.0,6,3,3
NOR,ISL,2002.0,4,5,-1
MAR,GBR,2012.0,2,1,1
QAT,AUS,2018.0,7,5,2
ZAF,ISR,2017.0,3,2,1
ZAF,KOR,2011.0,3,1,2
NGA,AUS,2009.0,2,2,0
DNK,THA,2020.0,2,1,1
AUS,RUS,2014.0,11,7,4
TWN,KOR,2012.0,11,5,6
JPN,ROU,2018.0,3,3,0
TUN,USA,2008.0,2,1,1
FIN,IND,2010.0,1,8,-7
RUS,TUR,2010.0,2,4,-2
AUS,MNG,2018.0,2,1,1
JOR,PSE,2015.0,1,1,0
ISR,KOR,2020.0,7,6,1
CAN,ARG,2006.0,5,12,-7
AUS,IRL,1998.0,1,1,0
LUX,GBR,2009.0,3,6,-3
CAF,FRA,2015.0,3,3,0
BEL,BGR,2006.0,3,8,-5
NZL,IRN,2016.0,3,20,-17
NZL,ITA,2020.0,9,3,6
TWN,HRV,2013.0,1,1,0
LKA,IND,2010.0,1,2,-1
BEL,LBN,2021.0,2,7,-5
AND,ESP,2015.0,2,2,0
KOR,NOR,2022.0,4,2,2
AUT,IRL,2008.0,3,4,-1
LVA,CHE,2019.0,3,4,-1
SRB,BEL,2003.0,2,1,1
ARE,ESP,2006.0,1,1,0
GBR,BWA,2007.0,2,2,0
IRN,AZE,2010.0,2,2,0
MNG,DEU,2020.0,3,1,2
NGA,CAN,2022.0,8,3,5
KWT,MYS,2015.0,2,1,1
BEL,HUN,2021.0,5,3,2
RUS,TUR,2019.0,5,5,0
DEU,IRQ,2022.0,2,1,1
IRN,AZE,2017.0,1,2,-1
NLD,KEN,2021.0,2,5,-3
BEL,SVK,2002.0,1,4,-3
MNG,KOR,2012.0,2,2,0
USA,BHR,2018.0,3,2,1
FIN,HUN,2013.0,2,2,0
FIN,CHL,2019.0,1,2,-1
HKG,PRT,2020.0,2,1,1
CHN,BGD,2014.0,1,6,-5
NLD,CYP,2019.0,3,4,-1
COL,AUT,2014.0,1,2,-1
ETH,GBR,2017.0,2,8,-6
HRV,CAN,1999.0,1,1,0
SVN,HRV,2022.0,1,3,-2
AUT,LIE,2012.0,1,2,-1
HKG,BGD,2006.0,1,1,0
PRT,NZL,2005.0,1,1,0
COL,KOR,2015.0,1,1,0
FIN,IRL,2010.0,1,2,-1
CAN,SYR,2012.0,1,1,0
EGY,SYR,2018.0,1,2,-1
URY,VEN,2021.0,1,2,-1
DEU,YEM,2012.0,1,1,0
ETH,GBR,2010.0,1,6,-5
BEL,TWN,2009.0,1,2,-1
AUS,IDN,1999.0,1,2,-1
DEU,LVA,1999.0,1,1,0
GRC,CZE,2006.0,1,1,0
IDN,HKG,2018.0,1,1,0
GBR,ZWE,2007.0,1,4,-3
HKG,ITA,2010.0,1,1,0
BRA,CRI,2017.0,1,3,-2
USA,,2022.0,181228,0,181228
,BEL,2004.0,2946,0,2946
,FRA,2003.0,13754,0,13754
BRA,,2021.0,26377,0,26377
HKG,,2023.0,5457,0,5457
SAU,,2024.0,17835,0,17835
,MYS,2001.0,760,0,760
TWN,,2003.0,681,0,681
,IRN,2005.0,6025,0,6025
PER,,2024.0,2949,0,2949
BOL,,2011.0,27,0,27
,NLD,2008.0,6021,0,6021
,IRL,2003.0,1190,0,1190
,USA,2014.0,90268,0,90268
HUN,,2024.0,10145,0,10145
,BEL,1996.0,1611,0,1611
,PAK,2010.0,2862,0,2862
,IRN,2002.0,2536,0,2536
,ROU,2006.0,2549,0,2549
THA,,2011.0,641,0,641
NZL,,2013.0,751,0,751
IRN,KWT,2019.0,2,0,2
,COL,2007.0,1477,0,1477
DNK,,2018.0,2279,0,2279
,THA,2000.0,1310,0,1310
,RWA,2004.0,19,0,19
,CZE,2011.0,2562,0,2562
,HRV,2010.0,1131,0,1131
SGP,,2008.0,603,0,603
IRQ,,2008.0,14,0,14
EST,,2012.0,129,0,129
BGD,,2009.0,127,0,127
UKR,,2011.0,621,0,621
,UKR,1995.0,1788,0,1788
,FIN,2009.0,2107,0,2107
KEN,,2012.0,129,0,129
BDI,,2022.0,31,0,31
,CUB,1995.0,482,0,482
,KAZ,2004.0,88,0,88
LTU,,2008.0,121,0,121
NER,,2024.0,102,0,102
,GHA,2005.0,137,0,137
BLR,,2013.0,143,0,143
MEX,,2004.0,356,0,356
MYS,,2016.0,1541,0,1541
KOR,ARM,2012.0,1,0,1
SVN,,2012.0,237,0,237
,ARG,2012.0,2637,0,2637
COG,,2016.0,56,0,56
,SEN,1997.0,77,0,77
PNG,,2014.0,16,0,16
,IDN,2008.0,864,0,864
CUB,,2003.0,208,0,208
,ARE,2015.0,481,0,481
,SLV,2010.0,12,0,12
,SUR,2010.0,9,0,9
,GNB,2010.0,7,0,7
,PAK,2017.0,4517,0,4517
BGD,ITA,2008.0,2,0,2
NOR,PSE,2018.0,2,0,2
ITA,MNG,2019.0,2,0,2
,PRY,2011.0,34,0,34
,MNE,2011.0,58,0,58
,NCL,2013.0,34,0,34
,PRI,2015.0,122,0,122
,CIV,2001.0,82,0,82
,MUS,2013.0,30,0,30
DNK,ETH,2019.0,3,0,3
,PAK,2019.0,3339,0,3339
NLD,SUR,2016.0,4,0,4
,PSE,2013.0,67,0,67
SWE,ZWE,2016.0,1,0,1
GRC,,2007.0,752,0,752
IRQ,IRN,2010.0,1,0,1
QAT,JPN,2018.0,5,0,5
MEX,ISR,2021.0,3,0,3
SGP,ARE,2015.0,7,0,7
,GHA,2002.0,119,0,119
CUB,ARG,2014.0,3,0,3
SYR,ARE,2013.0,1,0,1
,HRV,2017.0,808,0,808
,BWA,2016.0,96,0,96
MEX,SVN,2001.0,1,0,1
ZAF,QAT,2020.0,5,0,5
IRN,POL,2021.0,16,0,16
MEX,NOR,2020.0,1,0,1
,MRT,2016.0,15,0,15
,HRV,2019.0,437,0,437
IRN,SGP,2021.0,6,0,6
,BRN,2018.0,60,0,60
MLT,BEL,2020.0,1,0,1
ARE,,2022.0,876,0,876
,TUN,1994.0,161,0,161
,PER,2015.0,624,0,624
,GAB,2006.0,15,0,15
LUX,,2020.0,124,0,124
,SLV,2017.0,10,0,10
CAN,NCL,2009.0,1,0,1
,AZE,2000.0,121,0,121
SDN,,2014.0,79,0,79
IND,PAN,2011.0,1,0,1
IRQ,BIH,2009.0,2,0,2
CZE,,2003.0,285,0,285
,LAO,2006.0,19,0,19
,DJI,2011.0,4,0,4
NZL,LUX,2015.0,1,0,1
,ZWE,1995.0,49,0,49
IDN,VNM,2017.0,2,0,2
,KAZ,1996.0,62,0,62
USA,LSO,2007.0,1,0,1
JOR,,2012.0,135,0,135
,GLP,2011.0,9,0,9
IRL,KAZ,2017.0,2,0,2
LVA,AUS,2019.0,1,0,1
,QAT,2008.0,97,0,97
CRI,,2014.0,48,0,48
,JOR,1995.0,99,0,99
ESP,CMR,2022.0,2,0,2
OMN,,2025.0,8,0,8
RUS,GHA,2021.0,2,0,2
LKA,BTN,2021.0,1,0,1
KOR,IRL,2018.0,1,0,1
,SEN,1998.0,116,0,116
NZL,IDN,2019.0,6,0,6
UGA,,2013.0,81,0,81
VEN,ITA,2016.0,3,0,3
KGZ,,2008.0,5,0,5
BEL,NGA,2015.0,2,0,2
KWT,FIN,2006.0,1,0,1
,BHR,2006.0,31,0,31
HRV,POL,2011.0,7,0,7
SYR,QAT,2010.0,1,0,1
JOR,BHR,2017.0,4,0,4
USA,TJK,2019.0,1,0,1
LVA,,2003.0,24,0,24
HKG,NOR,2012.0,1,0,1
,OMN,1999.0,124,0,124
IND,GMB,2011.0,1,0,1
FIN,TZA,2006.0,1,0,1
PRT,GRC,2005.0,2,0,2
SYR,,2007.0,15,0,15
JOR,NLD,2006.0,1,0,1
JPN,CUB,2005.0,1,0,1
MDA,,2004.0,18,0,18
BEL,IDN,2005.0,1,0,1
,MNG,2000.0,17,0,17
ITA,MDA,2006.0,1,0,1
RUS,SVK,1997.0,2,0,2
GEO,CZE,1998.0,1,0,1
RUS,SVK,1998.0,2,0,2
ARM,,2000.0,14,0,14
BHR,,2015.0,30,0,30
IND,MLI,2009.0,1,0,1
IRL,TUN,2002.0,2,0,2
BRA,BGR,2012.0,1,0,1
DEU,LBN,1999.0,1,0,1
ISL,USA,1997.0,1,0,1
TZA,NGA,2008.0,3,0,3
,MDG,1994.0,15,0,15
MMR,KOR,2004.0,1,0,1
MWI,DEU,2005.0,4,0,4
GRC,TWN,2016.0,2,0,2
GUF,PRI,2019.0,1,0,1
RWA,FRA,1999.0,1,0,1
FJI,,2015.0,8,0,8
EST,CZE,2021.0,1,0,1
HUN,MEX,2017.0,1,0,1
SWE,URY,2014.0,2,0,2
TUR,KWT,2001.0,1,0,1
,TKM,2005.0,3,0,3
BHR,PAK,2006.0,1,0,1
GIN,MEX,2017.0,1,0,1
ITA,MOZ,2008.0,2,0,2
GUM,,2017.0,7,0,7
PRI,SAU,2018.0,1,0,1
CHN,TZA,2011.0,2,0,2
IRL,MAC,2021.0,2,0,2
MKD,,2006.0,6,0,6
MLT,MAR,2010.0,1,0,1
CZE,GMB,2017.0,1,0,1
NIC,,2014.0,13,0,13
COG,CAF,2020.0,1,0,1
PRT,PHL,2015.0,1,0,1
AGO,ITA,2018.0,2,0,2
ROU,DNK,2016.0,2,0,2
IND,ZWE,2013.0,2,0,2
MYS,ETH,2019.0,5,0,5
LAO,USA,2015.0,3,0,3
DZA,CZE,2020.0,1,0,1
,LBR,2011.0,4,0,4
BRA,RUS,2022.0,6,0,6
MYS,CZE,2021.0,2,0,2
NPL,SWE,2018.0,1,0,1
DNK,CYP,2013.0,1,0,1
AUS,KAZ,2020.0,2,0,2
SDN,SOM,2021.0,1,0,1
GRC,BRA,2015.0,2,0,2
CZE,MNG,2003.0,1,0,1
,MLI,1994.0,11,0,11
MDG,USA,2010.0,1,0,1
BEL,SRB,2002.0,1,0,1
CAN,LVA,2009.0,1,0,1
KNA,,2020.0,8,0,8
AUT,VNM,1997.0,1,0,1
LBN,NLD,2011.0,1,0,1
PER,KEN,2018.0,4,0,4
,SLE,1998.0,3,0,3
SUR,MEX,2019.0,1,0,1
UGA,SWE,2002.0,1,0,1
MOZ,,2011.0,5,0,5
COD,ZAF,2022.0,1,0,1
POL,ARG,2020.0,1,0,1
TGO,USA,2017.0,2,0,2
UZB,EGY,2017.0,1,0,1
SWE,BLR,2018.0,2,0,2
SYR,QAT,2017.0,3,0,3
ZMB,,2004.0,4,0,4
JOR,TUR,2009.0,1,0,1
AZE,KOR,2019.0,1,0,1
ROU,ZAF,2002.0,3,0,3
,FJI,1995.0,3,0,3
,LBY,2000.0,21,0,21
AUS,MAC,2014.0,2,0,2
THA,CHE,1999.0,1,0,1
BGD,ARE,2003.0,1,0,1
TUN,LBN,2003.0,1,0,1
TTO,,2006.0,7,0,7
PRT,EST,2004.0,1,0,1
CZE,ROU,2005.0,1,0,1
BEL,IDN,2002.0,1,0,1
MAR,ARE,2010.0,1,0,1
HTI,,2007.0,1,0,1
BGR,ZAF,2004.0,1,0,1
KEN,IRN,2006.0,2,0,2
GBR,SDN,2004.0,3,0,3
BEL,PRT,2005.0,3,0,3
PHL,FIN,2011.0,1,0,1
IRN,KWT,2017.0,3,0,3
DZA,ITA,2001.0,2,0,2
EGY,DZA,2009.0,2,0,2
THA,LAO,2005.0,2,0,2
ESP,SLV,2003.0,1,0,1
HKG,FIN,2007.0,1,0,1
FRA,ARM,2008.0,1,0,1
MLI,KEN,2019.0,1,0,1
ARE,HKG,2007.0,1,0,1
GUM,,2019.0,4,0,4
LKA,FJI,2014.0,1,0,1
SVN,IRN,2015.0,1,0,1
MUS,CAN,2009.0,1,0,1
MNE,,2012.0,4,0,4
SVN,SLV,2013.0,1,0,1
DNK,ETH,2017.0,2,0,2
AUT,BGD,2021.0,2,0,2
EGY,IRQ,2015.0,4,0,4
BOL,ESP,2022.0,1,0,1
GMB,PHL,2007.0,1,0,1
ARG,THA,2020.0,1,0,1
PAN,CAN,2021.0,2,0,2
MAR,,2001.0,10,0,10
QAT,NOR,2011.0,1,0,1
IND,TWN,1999.0,11,0,11
MDG,,2007.0,9,0,9
USA,ASM,2018.0,1,0,1
MLI,BFA,2021.0,4,0,4
BLR,UZB,2022.0,1,0,1
TZA,CHE,2007.0,2,0,2
TUR,CIV,2018.0,1,0,1
CHN,CRI,2021.0,1,0,1
GUY,USA,2004.0,2,0,2
CHL,PHL,2017.0,1,0,1
MDV,SWE,2019.0,1,0,1
TGO,USA,2010.0,1,0,1
SWE,MOZ,2009.0,1,0,1
TGO,SEN,2011.0,1,0,1
GMB,USA,2020.0,3,0,3
ZAF,BRA,2007.0,1,0,1
VNM,ESP,2017.0,1,0,1
BEL,GAB,2017.0,2,0,2
MYS,ETH,2010.0,1,0,1
LSO,ZAF,2011.0,3,0,3
SRB,DNK,2021.0,2,0,2
BEL,TZA,2018.0,2,0,2
EST,CAN,2021.0,2,0,2
LBN,IRL,2019.0,1,0,1
ISR,PRI,2021.0,1,0,1
,SUR,2017.0,6,0,6
BRN,FRA,2022.0,1,0,1
MNE,MAR,2021.0,1,0,1
CUW,,2024.0,11,0,11
GRC,EGY,2010.0,3,0,3
ETH,HKG,2021.0,2,0,2
,SYC,2007.0,2,0,2
COL,NLD,2005.0,1,0,1
NLD,TZA,2006.0,3,0,3
TUN,DZA,2013.0,2,0,2
UKR,COL,2001.0,1,0,1
GUM,DEU,2008.0,1,0,1
IDN,,1999.0,2,0,2
BFA,MEX,2003.0,1,0,1
FRA,NPL,2014.0,1,0,1
SWE,IRL,2004.0,3,0,3
IND,BLR,2005.0,1,0,1
SWE,ISR,2000.0,4,0,4
RUS,KGZ,2005.0,2,0,2
RUS,KOR,1998.0,2,0,2
ZWE,ZAF,1998.0,2,0,2
IND,BEN,2022.0,1,0,1
JAM,NLD,2018.0,1,0,1
LAO,IDN,2013.0,1,0,1
BGR,TUR,1998.0,1,0,1
LIE,,2003.0,2,0,2
AGO,CHE,2003.0,1,0,1
MNE,AUS,2013.0,1,0,1
DEU,MAR,2013.0,4,0,4
FRA,PSE,2008.0,2,0,2
PAK,UZB,2006.0,1,0,1
CAN,COL,2001.0,3,0,3
COL,DOM,2000.0,1,0,1
,VGB,2005.0,1,0,1
ATG,,2010.0,2,0,2
EST,ROU,2015.0,2,0,2
,COM,2008.0,3,0,3
ZAF,ISR,2019.0,4,0,4
GRC,IDN,2011.0,1,0,1
GHA,BFA,2020.0,1,0,1
GEO,JPN,2001.0,2,0,2
AUS,PAK,2003.0,1,0,1
CHN,CZE,2000.0,1,0,1
ESP,PRI,2008.0,2,0,2
ECU,CAN,2015.0,2,0,2
ARG,ZMB,2014.0,1,0,1
PRI,NLD,2011.0,1,0,1
CYP,COL,2015.0,1,0,1
CZE,ARG,2017.0,1,0,1
BGR,NZL,2006.0,1,0,1
SWE,GRC,1998.0,2,0,2
YEM,HUN,1998.0,1,0,1
BGR,IND,2019.0,2,0,2
HKG,BRA,1999.0,1,0,1
,ERI,2003.0,6,0,6
ZWE,MWI,2010.0,1,0,1
RUS,MOZ,2021.0,1,0,1
NLD,TUR,2002.0,3,0,3
CAN,ISL,2002.0,2,0,2
COG,TZA,2014.0,1,0,1
USA,GRL,2006.0,1,0,1
AUT,SAU,2009.0,4,0,4
ARM,ESP,2008.0,1,0,1
JPN,SEN,2002.0,1,0,1
NZL,OMN,2004.0,2,0,2
EST,LTU,2006.0,1,0,1
MYS,ZAF,2008.0,1,0,1
NZL,TZA,2003.0,1,0,1
NPL,NLD,2004.0,1,0,1
AUS,TCA,2010.0,1,0,1
DEU,BRB,2003.0,1,0,1
POL,PER,2004.0,1,0,1
GTM,DEU,2004.0,1,0,1
ARE,PRI,2016.0,1,0,1
GRC,HRV,2017.0,2,0,2
AUS,KHM,2022.0,1,0,1
COG,GIN,2016.0,1,0,1
COL,FIN,2020.0,1,0,1
ISL,CZE,2019.0,1,0,1
,LIE,2017.0,5,0,5
IRQ,BEL,2021.0,1,0,1
PSE,KWT,2021.0,2,0,2
SDN,NER,2019.0,1,0,1
NOR,SVK,2015.0,2,0,2
CHL,DZA,2011.0,2,0,2
SVK,BEL,2014.0,3,0,3
MAR,POL,2013.0,1,0,1
,GNB,2017.0,5,0,5
,LIE,2019.0,4,0,4
URY,FRA,2002.0,3,0,3
BHR,HUN,2006.0,1,0,1
DEU,MDA,1999.0,2,0,2
IND,GEO,2008.0,2,0,2
SLV,BRA,2011.0,2,0,2
PAK,RUS,1998.0,2,0,2
BGR,AUT,2001.0,1,0,1
GNB,DNK,2016.0,3,0,3
GHA,CAN,2008.0,1,0,1
MAR,BFA,2015.0,1,0,1
PRT,MOZ,2001.0,1,0,1
FRA,AGO,2014.0,1,0,1
CAN,ETH,2009.0,1,0,1
ZMB,NAM,1999.0,1,0,1
SLV,GTM,2009.0,2,0,2
BEL,GIN,2012.0,1,0,1
,LIE,2010.0,3,0,3
GRC,KOR,2005.0,1,0,1
BHS,ARE,2015.0,1,0,1
PNG,AUS,2005.0,6,0,6
GBR,FRO,2015.0,3,0,3
FRA,NGA,2016.0,2,0,2
THA,POL,2007.0,1,0,1
MEX,HKG,2018.0,1,0,1
COL,NLD,2002.0,2,0,2
LAO,FRA,2005.0,1,0,1
JOR,BHR,2010.0,1,0,1
TGO,USA,2019.0,3,0,3
BEL,LBY,2013.0,1,0,1
COL,CHN,2006.0,1,0,1
ETH,BWA,2022.0,1,0,1
GTM,ITA,2007.0,1,0,1
NER,NGA,2006.0,1,0,1
IRN,KWT,2010.0,1,0,1
USA,BRB,2009.0,1,0,1
USA,PLW,1998.0,3,0,3
IND,JOR,2005.0,2,0,2
SWE,GRC,1997.0,1,0,1
SVK,SRB,2009.0,1,0,1
IDN,PER,2011.0,1,0,1
USA,BLZ,2021.0,1,0,1
CAN,MAC,2005.0,1,0,1
GUF,PYF,2005.0,1,0,1
OMN,PAK,2006.0,2,0,2
SAU,PSE,2008.0,1,0,1
GRD,CAN,2014.0,1,0,1
OMN,FRA,2016.0,1,0,1
GBR,MOZ,2014.0,3,0,3
IND,GRC,2007.0,1,0,1
PSE,CHE,2018.0,2,0,2
GLP,ARE,2015.0,1,0,1
FRA,MKD,2019.0,1,0,1
MLI,CAN,2012.0,3,0,3
LIE,USA,2012.0,1,0,1
UKR,ROU,2019.0,1,0,1
CHN,BWA,2015.0,1,0,1
,NIC,1998.0,4,0,4
,SUR,2019.0,5,0,5
ZAF,HUN,2001.0,1,0,1
SRB,NZL,2018.0,2,0,2
YEM,ROU,2008.0,1,0,1
ZAF,EGY,2010.0,1,0,1
,NIC,1997.0,1,0,1
IRL,KAZ,2019.0,1,0,1
GBR,LAO,2009.0,2,0,2
HKG,ISR,2011.0,1,0,1
MEX,POL,2021.0,2,0,2
YEM,AUS,2004.0,1,0,1
COG,BEL,2006.0,3,0,3
MKD,HRV,2002.0,1,0,1
RUS,TJK,2002.0,1,0,1
PRT,VEN,2003.0,1,0,1
SWE,PHL,2018.0,1,0,1
GBR,GIB,2016.0,1,0,1
CHN,LVA,2006.0,2,0,2
LTU,NZL,2016.0,1,0,1
DNK,LBN,2011.0,1,0,1
KEN,COG,2006.0,1,0,1
MCO,AUT,2011.0,2,0,2
KAZ,EGY,2004.0,1,0,1
DNK,VNM,2013.0,2,0,2
TUN,MAR,2004.0,2,0,2
ROU,FIN,2013.0,1,0,1
MDA,CHN,2019.0,1,0,1
LBN,TUN,2001.0,1,0,1
KOR,MYS,2006.0,1,0,1
CZE,SRB,1999.0,1,0,1
KEN,BFA,2019.0,1,0,1
NLD,ARE,2015.0,3,0,3
MYS,UZB,2022.0,1,0,1
CYP,CHN,2022.0,1,0,1
IDN,VNM,2019.0,3,0,3
MNG,HUN,2019.0,1,0,1
BEL,TTO,2005.0,1,0,1
COL,PRT,2008.0,2,0,2
GBR,COG,2003.0,1,0,1
JPN,QAT,2015.0,3,0,3
JPN,AZE,2014.0,1,0,1
AUS,CIV,2009.0,1,0,1
ISR,ALB,2017.0,1,0,1
SRB,SVN,2004.0,1,0,1
SWE,ROU,2001.0,2,0,2
BDI,KEN,2021.0,1,0,1
BEL,KEN,2014.0,2,0,2
NZL,WSM,2012.0,1,0,1
PRT,CUB,2006.0,1,0,1
SVK,CHE,2016.0,3,0,3
SWE,MNE,2016.0,1,0,1
PRI,ARG,2018.0,1,0,1
IRN,GRC,2020.0,3,0,3
UGA,FIN,2020.0,1,0,1
GIN,MLI,2008.0,1,0,1
SAU,NOR,2021.0,2,0,2
CUB,URY,2019.0,1,0,1
FRA,GRD,2003.0,1,0,1
NGA,BRA,2005.0,1,0,1
SDN,FRA,2018.0,1,0,1
ATG,,2017.0,1,0,1
AUS,UGA,2018.0,3,0,3
IRL,TCA,2021.0,1,0,1
ZWE,ITA,2021.0,1,0,1
RUS,JOR,2022.0,4,0,4
SYR,QAT,2019.0,2,0,2
,GUM,1994.0,2,0,2
MEX,PRI,2012.0,2,0,2
QAT,PSE,2016.0,2,0,2
HRV,SWE,1998.0,1,0,1
MDA,UKR,1997.0,1,0,1
JPN,DZA,2011.0,2,0,2
QAT,SRB,2011.0,2,0,2
EGY,THA,2009.0,1,0,1
KEN,GMB,2007.0,1,0,1
AUS,DZA,2014.0,1,0,1
KEN,MEX,2007.0,1,0,1
ZAF,IRN,2009.0,1,0,1
ARE,LBY,2021.0,1,0,1
BRA,TUN,2004.0,1,0,1
EGY,GHA,2013.0,1,0,1
PRI,PRT,2021.0,2,0,2
ESP,LKA,2017.0,1,0,1
GHA,NAM,2021.0,1,0,1
SSD,KEN,2021.0,1,0,1
,GRL,1995.0,1,0,1
THA,LAO,2002.0,1,0,1
,CAF,1995.0,2,0,2
BGR,UKR,1999.0,1,0,1
POL,ARE,2014.0,1,0,1
VEN,URY,2015.0,2,0,2
DNK,BOL,2013.0,1,0,1
BGR,EST,2010.0,1,0,1
BEL,GAB,2019.0,1,0,1
COL,SVK,2020.0,1,0,1
MYS,LKA,2003.0,1,0,1
NOR,KEN,2008.0,1,0,1
HRV,SGP,2018.0,1,0,1
MNG,CHE,2018.0,2,0,2
PSE,ARE,2016.0,2,0,2
POL,GTM,2018.0,1,0,1
SVN,CHE,2002.0,1,0,1
AUT,NPL,2005.0,1,0,1
IRL,NGA,2014.0,1,0,1
GBR,MDA,2010.0,1,0,1
CHE,ARE,2007.0,1,0,1
AUS,MOZ,2016.0,2,0,2
CHL,NZL,2009.0,1,0,1
LKA,ZAF,2005.0,2,0,2
LBN,AUT,2014.0,1,0,1
LBN,PSE,2010.0,1,0,1
KOR,IRQ,2021.0,1,0,1
IDN,FIN,2014.0,2,0,2
,MTQ,2016.0,7,0,7
PRI,DEU,2009.0,1,0,1
DEU,MLT,2001.0,1,0,1
JPN,BOL,2014.0,1,0,1
ECU,BOL,2020.0,1,0,1
CAN,GIB,2014.0,1,0,1
KEN,VNM,2020.0,1,0,1
CAN,GIN,2016.0,1,0,1
ATG,,2019.0,1,0,1
NPL,ITA,2022.0,1,0,1
NLD,BWA,2002.0,1,0,1
ARE,LBN,2007.0,1,0,1
MLT,,2008.0,3,0,3
ZWE,BRA,2009.0,1,0,1
FRA,MKD,2017.0,1,0,1
CYP,SGP,2014.0,1,0,1
VEN,SAU,2013.0,1,0,1
COL,CZE,2020.0,2,0,2
SWE,CMR,2017.0,1,0,1
TUR,MDV,2020.0,1,0,1
CYP,NZL,2019.0,1,0,1
,GNB,2019.0,3,0,3
BFA,CMR,2014.0,1,0,1
MDA,ISR,1999.0,1,0,1
GEO,ARM,2010.0,1,0,1
AUS,PSE,2011.0,1,0,1
PAK,LBR,2014.0,1,0,1
,TKM,2002.0,1,0,1
AND,,2016.0,1,0,1
BGD,CHN,2006.0,1,0,1
DNK,PRT,1998.0,2,0,2
PHL,CHE,2004.0,1,0,1
TUN,HTI,2012.0,1,0,1
ARG,TWN,2003.0,1,0,1
SWE,BIH,2003.0,1,0,1
ZWE,SWZ,2010.0,1,0,1
LKA,JPN,1999.0,1,0,1
NER,BEN,2008.0,1,0,1
VUT,,2006.0,1,0,1
RUS,TWN,2000.0,2,0,2
KHM,GBR,2006.0,1,0,1
FRA,BHR,2013.0,1,0,1
ISL,ISR,2012.0,1,0,1
COG,ESP,2001.0,1,0,1
KEN,BFA,2017.0,1,0,1
BEL,BEN,2007.0,1,0,1
LSO,CHN,2017.0,1,0,1
PER,ESP,1999.0,1,0,1
BEL,MMR,2018.0,1,0,1
RWA,,1999.0,1,0,1
FIN,GRD,2014.0,1,0,1
LBY,IRQ,2015.0,2,0,2
BEL,ISL,2008.0,2,0,2
CZE,IDN,2011.0,1,0,1
MYS,KAZ,2016.0,1,0,1
MDA,UKR,1998.0,1,0,1
CHE,NPL,2004.0,1,0,1
AUT,UZB,2013.0,1,0,1
SUR,,2008.0,1,0,1
FJI,JPN,2014.0,1,0,1
FRA,MKD,2010.0,1,0,1
BGR,PRT,2013.0,1,0,1
BFA,DJI,2014.0,1,0,1
DEU,MMR,2011.0,1,0,1
IRQ,ZAF,2014.0,1,0,1
AFG,KOR,2022.0,1,0,1
SUR,NLD,2022.0,1,0,1
KOR,EGY,2002.0,1,0,1
GHA,IRL,2014.0,1,0,1
ITA,AZE,2021.0,1,0,1
KAZ,ZAF,2022.0,1,0,1
TJK,NLD,2018.0,1,0,1
HRV,JPN,2004.0,1,0,1
AZE,AUT,2021.0,1,0,1
MYS,MLI,2018.0,1,0,1
PAK,SGP,2014.0,2,0,2
UGA,AUS,2016.0,1,0,1
NLD,BWA,2005.0,1,0,1
FRA,AFG,2011.0,1,0,1
GUY,DOM,2011.0,1,0,1
MYS,MTQ,2015.0,1,0,1
ESP,GHA,2019.0,1,0,1
IRL,OMN,2013.0,1,0,1
PSE,HKG,2012.0,1,0,1
SUR,FRA,2011.0,1,0,1
UGA,IND,2004.0,1,0,1
SVK,IND,2004.0,2,0,2
VUT,NCL,2018.0,1,0,1
SVK,THA,2009.0,1,0,1
AUT,HKG,2006.0,1,0,1
BOL,BRA,2007.0,1,0,1
NOR,BEN,2005.0,1,0,1
BEL,PHL,2013.0,1,0,1
KOR,BLR,2000.0,1,0,1
BEN,PRT,2000.0,1,0,1
ROU,POL,2002.0,2,0,2
LTU,AUT,2002.0,1,0,1
ARG,PRT,1998.0,1,0,1
DEU,ECU,1997.0,1,0,1
ZWE,KWT,2005.0,1,0,1
VNM,ESP,2010.0,1,0,1
MWI,NOR,2007.0,1,0,1
IRL,CHL,2006.0,1,0,1
CHN,EST,2011.0,1,0,1
PAK,TZA,2012.0,1,0,1
KAZ,TTO,2003.0,1,0,1
TWN,HND,2016.0,1,0,1
,VGB,2002.0,1,0,1
KNA,NZL,2016.0,1,0,1
TCA,BRA,2008.0,1,0,1
ZAF,EGY,2019.0,1,0,1
OMN,LKA,2021.0,1,0,1
BLR,SAU,2011.0,1,0,1
URY,KOR,2005.0,1,0,1
PNG,BWA,1998.0,1,0,1
SWE,MAR,2005.0,1,0,1
AUS,EST,2011.0,1,0,1
SVN,BIH,2011.0,1,0,1
ZWE,KEN,2012.0,1,0,1
AUS,LBN,1999.0,1,0,1
GUM,,2010.0,1,0,1
ARM,CHL,2015.0,1,0,1
BEN,MDG,2019.0,1,0,1
LBY,POL,2020.0,1,0,1
DEU,ARM,2022.0,1,0,1
GBR,ETH,1998.0,1,0,1
MYS,ZWE,2001.0,1,0,1
LKA,BRA,2011.0,1,0,1
KOR,URY,2010.0,1,0,1
GUF,CIV,2020.0,1,0,1
FJI,ETH,2018.0,1,0,1
SYR,UZB,2013.0,1,0,1
MYS,LAO,2012.0,1,0,1
JAM,GBR,2014.0,1,0,1
ROU,SRB,2006.0,1,0,1
TUN,GRC,2018.0,1,0,1
MMR,PHL,2021.0,1,0,1
UGA,BEN,2019.0,1,0,1
MEX,IDN,2018.0,1,0,1
DEU,USA,2010.0,1108,982,126
SWE,FIN,2017.0,47,74,-27
AUS,USA,2014.0,487,635,-148
TUN,MAR,2014.0,3,4,-1
SGP,GBR,2013.0,55,84,-29
USA,JPN,2015.0,756,767,-11
IND,KOR,2005.0,67,10,57
POL,CAN,2014.0,50,18,32
GBR,CAN,2007.0,300,286,14
NOR,SWE,2006.0,29,46,-17
NLD,USA,2011.0,305,283,22
FRA,AUS,2010.0,90,79,11
HUN,ITA,2005.0,6,7,-1
DEU,GBR,2012.0,489,563,-74
USA,GBR,2021.0,1133,1129,4
COL,DEU,2008.0,8,8,0
ARG,SWE,2006.0,2,3,-1
DEU,ESP,2010.0,143,145,-2
LUX,AUT,2016.0,3,2,1
USA,KOR,2014.0,971,731,240
ZAF,USA,2017.0,106,86,20
FRA,USA,2007.0,643,579,64
JPN,USA,2001.0,961,785,176
ITA,GBR,2017.0,595,268,327
KOR,USA,2000.0,152,163,-11
SWE,NOR,2007.0,64,26,38
GBR,CHE,2005.0,126,122,4
AUS,SWE,2015.0,55,39,16
NOR,ESP,2010.0,12,15,-3
ESP,CHN,2014.0,17,23,-6
ITA,GBR,2019.0,485,396,89
MYS,BGD,2005.0,2,3,-1
USA,PRY,2016.0,2,1,1
FIN,FRA,2012.0,19,20,-1
CHE,USA,2003.0,337,368,-31
KEN,USA,2016.0,57,55,2
FRA,CHN,2017.0,201,150,51
CAN,FRA,2015.0,212,350,-138
BRA,GBR,2014.0,75,74,1
DEU,DNK,2019.0,106,106,0
COL,ESP,2020.0,90,85,5
USA,TWN,2009.0,320,243,77
GRC,DEU,2014.0,73,48,25
ESP,USA,2004.0,286,261,25
ZWE,NLD,2008.0,1,2,-1
JPN,SWE,2011.0,41,22,19
BEL,LUX,2011.0,14,5,9
HKG,USA,2001.0,70,67,3
IRN,IRL,2009.0,3,2,1
ZMB,USA,2021.0,10,5,5
GBR,USA,2020.0,1694,1490,204
ZAF,USA,2019.0,119,70,49
IND,AUT,2010.0,13,7,6
FRA,AUS,2017.0,89,77,12
ITA,IRL,2009.0,20,8,12
PRT,IRL,2020.0,12,6,6
BRA,DEU,2019.0,123,71,52
ZAF,USA,2010.0,73,65,8
TUR,DEU,2008.0,20,23,-3
DEU,DNK,2017.0,128,81,47
USA,DNK,2018.0,149,142,7
USA,ALB,2010.0,5,1,4
DNK,CAN,2012.0,27,17,10
IND,IRN,2014.0,24,6,18
FRA,CHN,2019.0,212,158,54
CHN,NLD,2013.0,55,54,1
USA,PHL,2012.0,41,20,21
USA,SVN,2016.0,14,19,-5
NLD,CYP,2018.0,1,1,0
PAK,CHN,2020.0,305,363,-58
IND,ZAF,2017.0,49,38,11
RUS,DEU,2016.0,109,69,40
MYS,IND,2017.0,60,77,-17
IRL,AUS,2020.0,35,43,-8
BRA,DEU,2017.0,96,94,2
MYS,IND,2019.0,55,53,2
IND,CZE,2021.0,29,10,19
KOR,DEU,2022.0,25,25,0
ISR,FRA,2000.0,8,7,1
NLD,NZL,2016.0,13,11,2
MYS,YEM,2014.0,7,6,1
FRA,CHN,2010.0,78,97,-19
ETH,RUS,2019.0,17,16,1
GBR,PAK,2013.0,80,40,40
CAN,IRN,2018.0,80,295,-215
DEU,LUX,2014.0,37,12,25
GBR,AUT,2002.0,31,38,-7
JPN,BGD,2020.0,82,42,40
SRB,SVN,2014.0,4,1,3
IND,BRA,2016.0,31,7,24
SWE,NLD,2018.0,56,63,-7
FRA,AUS,2019.0,84,85,-1
USA,GRC,2013.0,80,115,-35
NLD,JPN,2019.0,34,25,9
USA,KEN,2018.0,52,64,-12
THA,VNM,2014.0,3,3,0
SVK,USA,2014.0,15,14,1
ISR,AUS,2005.0,13,3,10
CHN,DNK,2014.0,41,35,6
DNK,DEU,2014.0,79,87,-8
BRA,BEL,2021.0,31,10,21
NLD,AUT,2016.0,22,18,4
ESP,IRL,2017.0,40,18,22
LVA,CHE,2018.0,5,2,3
DNK,USA,2020.0,134,136,-2
ESP,COL,2017.0,125,49,76
MAC,HKG,2021.0,6,21,-15
MYS,ARE,2015.0,6,1,5
USA,IRN,2018.0,133,569,-436
KAZ,RUS,2016.0,27,27,0
GHA,ITA,2016.0,1,1,0
ITA,GHA,2019.0,2,1,1
ITA,ESP,2016.0,188,169,19
BEL,USA,2002.0,158,106,52
JPN,ROU,2017.0,6,2,4
KOR,IDN,2018.0,26,10,16
GBR,IRQ,2015.0,28,12,16
GBR,HUN,2022.0,6,7,-1
GBR,ZAF,2022.0,39,51,-12
DEU,PAK,2017.0,35,34,1
EGY,GBR,2015.0,23,55,-32
AUS,NZL,2015.0,97,169,-72
AUS,IND,2018.0,65,132,-67
PRT,DEU,2021.0,28,31,-3
BEL,DEU,2021.0,75,71,4
GBR,PER,2015.0,4,5,-1
DNK,JPN,2016.0,7,8,-1
HKG,NLD,2001.0,3,1,2
ARG,ZAF,2013.0,1,1,0
IND,AUT,2017.0,13,6,7
JPN,EGY,2018.0,44,21,23
NPL,SWE,2017.0,3,2,1
ZAF,NGA,2020.0,93,66,27
BEL,USA,2005.0,101,104,-3
ESP,DNK,2018.0,24,39,-15
GMB,GBR,2018.0,13,9,4
EGY,CAN,2019.0,52,51,1
ZAF,SWE,2018.0,16,10,6
DEU,POL,2020.0,60,50,10
JPN,ITA,2012.0,24,25,-1
VEN,USA,2003.0,32,35,-3
DEU,IND,2011.0,97,141,-44
POL,DEU,2000.0,21,27,-6
TZA,SWE,2021.0,3,1,2
DEU,BGR,2016.0,13,9,4
IND,NPL,2021.0,25,17,8
IRL,ESP,2022.0,19,17,2
ISR,CHN,2022.0,21,14,7
IND,ZAF,2019.0,52,45,7
AUS,DNK,2020.0,35,41,-6
CMR,JPN,2020.0,2,1,1
COL,CHE,2019.0,8,9,-1
TWN,CHN,2022.0,66,47,19
GBR,NZL,2020.0,118,104,14
ESP,COL,2019.0,88,77,11
ARG,ITA,2021.0,22,7,15
BRA,DEU,2010.0,58,55,3
SWE,FIN,2019.0,50,76,-26
EGY,RUS,2022.0,2,7,-5
EGY,CAN,2017.0,38,52,-14
RUS,GBR,2002.0,76,42,34
CHE,DNK,2018.0,41,35,6
BRA,NLD,2020.0,55,21,34
CUB,USA,2021.0,3,2,1
EGY,HUN,2022.0,4,1,3
KOR,THA,2021.0,12,6,6
IND,IRQ,2019.0,14,1,13
USA,IRL,2017.0,138,132,6
JPN,CHN,2015.0,508,267,241
SVK,POL,2020.0,7,2,5
IDN,JPN,2013.0,25,105,-80
SVK,CHE,2022.0,3,1,2
IND,AUT,2019.0,16,5,11
IRN,AZE,2018.0,4,3,1
CHN,CAN,2006.0,121,109,12
SGP,MYS,2015.0,15,12,3
FIN,CHE,2018.0,25,20,5
GBR,AUT,2005.0,39,45,-6
EGY,ESP,2009.0,3,11,-8
GBR,MLT,2014.0,10,9,1
IRL,DEU,2018.0,47,38,9
AUS,CAN,2012.0,133,162,-29
CHN,ARE,2011.0,1,2,-1
GBR,LBY,2009.0,6,1,5
FRA,MAR,2014.0,89,61,28
EGY,CAN,2010.0,20,24,-4
GBR,ROU,2014.0,11,20,-9
CHN,TWN,2009.0,44,63,-19
AUT,ESP,2016.0,21,31,-10
CAN,JOR,2017.0,12,7,5
PAK,USA,2006.0,34,32,2
ITA,AUT,2014.0,50,24,26
DEU,DNK,2010.0,85,51,34
MYS,IND,2010.0,25,59,-34
ITA,DNK,2006.0,22,7,15
FRA,GRC,2011.0,34,44,-10
PER,KEN,2017.0,1,1,0
AUS,THA,2012.0,31,15,16
IRN,RUS,2006.0,2,5,-3
NOR,CHN,2016.0,20,31,-11
IRL,NZL,2002.0,5,2,3
NLD,JPN,2017.0,22,22,0
SWE,JPN,2004.0,16,27,-11
CHE,SDN,2013.0,2,1,1
IRL,USA,2006.0,61,106,-45
CHL,SWE,2014.0,2,3,-1
NLD,POL,2014.0,12,43,-31
ITA,PRT,2015.0,25,33,-8
ESP,ITA,1998.0,18,25,-7
KHM,FRA,2012.0,5,6,-1
BEL,ESP,2000.0,12,4,8
BRA,SWE,2016.0,15,17,-2
SRB,HRV,2012.0,4,6,-2
TWN,CAN,2004.0,11,14,-3
SVN,RUS,2012.0,2,1,1
ESP,ARG,2000.0,17,13,4
IND,DEU,1998.0,23,13,10
GBR,QAT,2022.0,10,8,2
GBR,SVK,2016.0,4,4,0
ESP,HKG,2017.0,4,1,3
JPN,TWN,2001.0,12,4,8
FRA,CHE,1998.0,49,30,19
ARE,SGP,2022.0,4,1,3
MYS,USA,2011.0,17,36,-19
ZAF,KEN,2018.0,24,12,12
MOZ,BRA,2018.0,7,5,2
ARG,MEX,2022.0,4,4,0
CHN,SAU,2012.0,13,2,11
NLD,CAN,2012.0,55,57,-2
GBR,CYP,2003.0,8,2,6
FRA,UKR,2020.0,2,8,-6
HKG,ITA,2018.0,1,5,-4
BRA,VEN,2021.0,6,9,-3
GBR,ZMB,2014.0,5,1,4
ITA,SRB,2021.0,6,5,1
ESP,SAU,2016.0,14,3,11
POL,FRA,2006.0,21,17,4
ROU,GBR,2021.0,13,11,2
USA,PRT,2008.0,47,38,9
AUS,ESP,2014.0,20,67,-47
CHE,ETH,2021.0,4,1,3
TWN,HKG,2020.0,14,20,-6
IND,NZL,2021.0,11,4,7
CHL,COL,2012.0,11,10,1
AUT,IRL,2013.0,5,10,-5
THA,SGP,2013.0,9,5,4
JPN,GBR,2001.0,92,86,6
SRB,CZE,2020.0,4,2,2
CAN,JOR,2010.0,13,2,11
MYS,JOR,2022.0,10,3,7
HUN,AUT,2013.0,16,12,4
FRA,CZE,2004.0,13,8,5
RWA,KEN,2014.0,1,1,0
SWE,FIN,2010.0,36,46,-10
BLR,DEU,2006.0,10,7,3
RUS,IRN,2007.0,7,1,6
SWE,POL,2018.0,10,20,-10
CUB,CHL,2015.0,10,1,9
CAN,NLD,2011.0,59,49,10
CHE,GTM,2018.0,1,1,0
KOR,ETH,2019.0,14,2,12
JPN,RUS,2015.0,11,17,-6
USA,NPL,2015.0,17,13,4
ROU,DZA,2011.0,1,1,0
GBR,SYR,2006.0,2,1,1
CHE,GRC,2009.0,10,15,-5
UKR,AUT,2005.0,3,5,-2
ZAF,FRA,2008.0,7,13,-6
AUS,ZAF,2004.0,19,23,-4
RUS,POL,2000.0,14,3,11
NIC,MEX,2009.0,1,2,-1
FRA,BGR,2007.0,6,5,1
HRV,DNK,2020.0,4,2,2
GBR,EGY,2009.0,44,18,26
AUT,GBR,1999.0,11,12,-1
EGY,NLD,2006.0,2,3,-1
RUS,GBR,2005.0,43,27,16
SAU,DZA,2010.0,2,5,-3
USA,FIN,1999.0,30,50,-20
BGR,AUT,2003.0,5,1,4
BOL,ESP,2016.0,4,2,2
TUR,CHE,2000.0,2,2,0
HRV,USA,1999.0,7,4,3
IND,AUS,2001.0,15,7,8
SGP,CAN,2018.0,23,35,-12
GBR,FIN,2007.0,32,42,-10
ITA,POL,2022.0,13,9,4
BGR,ESP,2007.0,3,1,2
RUS,NLD,2001.0,29,8,21
ARE,SAU,2012.0,8,6,2
RUS,SWE,2000.0,25,7,18
NOR,BEL,2003.0,2,3,-1
HUN,USA,2006.0,57,60,-3
ESP,SRB,2009.0,2,1,1
CAN,AUS,2001.0,74,66,8
NZL,KWT,2007.0,1,1,0
NLD,JPN,2010.0,16,16,0
SAU,EGY,1997.0,5,5,0
NLD,PHL,2010.0,3,1,2
ROU,TUR,2002.0,4,1,3
DNK,GBR,2006.0,65,34,31
THA,USA,2000.0,13,13,0
JOR,IRQ,2015.0,5,4,1
TWN,EGY,2007.0,1,1,0
ESP,SWE,2004.0,15,22,-7
GIN,FRA,2017.0,5,5,0
DEU,CZE,2000.0,8,9,-1
CHL,CAN,2003.0,4,6,-2
DNK,ISL,2012.0,4,1,3
CHL,USA,2001.0,25,30,-5
BGR,CAN,2003.0,8,1,7
IND,ETH,2008.0,7,6,1
DEU,KEN,2003.0,3,6,-3
KOR,DNK,2001.0,2,1,1
KOR,CAN,2007.0,37,37,0
FRA,TGO,2002.0,4,2,2
IND,ZAF,2010.0,30,8,22
CAN,AUT,2001.0,12,11,1
NGA,KWT,2002.0,2,1,1
FRA,NER,2005.0,1,1,0
DEU,EST,2013.0,6,2,4
JPN,ISR,2002.0,8,3,5
MTQ,FRA,2001.0,12,6,6
IND,ARE,2013.0,28,6,22
JOR,QAT,2015.0,5,1,4
BGD,JPN,2001.0,11,14,-3
AUS,RUS,2004.0,7,8,-1
CAN,ITA,2008.0,37,45,-8
QAT,USA,2012.0,20,30,-10
DEU,HRV,2000.0,2,3,-1
SGP,KOR,2009.0,12,18,-6
PYF,FRA,2016.0,11,7,4
ZAF,NLD,2015.0,15,22,-7
POL,EGY,2014.0,10,1,9
CZE,DEU,2001.0,22,17,5
GBR,LTU,2003.0,4,3,1
FRA,FIN,2003.0,7,9,-2
ISR,AUS,2002.0,10,16,-6
RUS,CHN,2001.0,6,9,-3
JPN,CAN,2001.0,83,54,29
JPN,CHE,1999.0,9,4,5
FRA,GUF,2003.0,5,9,-4
COL,CHE,2010.0,4,1,3
COL,FRA,2017.0,16,24,-8
SVN,SVK,2012.0,5,1,4
NAM,ZAF,2003.0,5,4,1
SWE,RUS,1999.0,6,25,-19
SWE,ISL,2016.0,15,12,3
POL,CHN,2008.0,4,1,3
SGP,CHE,2022.0,12,7,5
SGP,AUS,2001.0,14,23,-9
CAN,HKG,2015.0,19,30,-11
IND,KOR,2002.0,26,8,18
BEL,ZAF,2011.0,6,6,0
FRA,IRL,2003.0,14,13,1
USA,NAM,2016.0,2,3,-1
IRN,IND,2006.0,3,11,-8
IND,OMN,2013.0,19,6,13
DEU,CRI,2017.0,3,4,-1
FRA,CIV,2012.0,31,9,22
SWE,IRL,2014.0,10,23,-13
SWE,ZAF,2014.0,11,8,3
CHE,BRA,2012.0,19,14,5
BRA,HRV,2012.0,2,1,1
USA,VNM,2008.0,16,6,10
NOR,AUS,2006.0,6,6,0
SRB,FRA,2012.0,7,2,5
ETH,GBR,2018.0,10,6,4
AUT,NLD,2012.0,14,24,-10
GBR,COL,2008.0,13,8,5
SWE,BRA,2012.0,11,9,2
ESP,MAR,2021.0,7,8,-1
HKG,CAN,2006.0,16,15,1
HUN,HRV,2013.0,2,2,0
KEN,ZAF,2005.0,6,4,2
GBR,SLE,2015.0,6,1,5
FIN,PRT,2014.0,4,10,-6
BIH,HRV,2019.0,6,11,-5
CAN,BGD,2018.0,14,29,-15
JOR,CAN,2012.0,10,19,-9
ITA,MEX,2013.0,10,8,2
CHE,IRN,2011.0,9,16,-7
DEU,MKD,2013.0,1,1,0
DEU,SVN,2019.0,15,9,6
ITA,HKG,2015.0,6,2,4
USA,BHR,2017.0,1,1,0
BFA,ZAF,2016.0,1,2,-1
MNE,SRB,2018.0,8,2,6
CZE,NOR,2008.0,3,2,1
BEL,JPN,2022.0,8,2,6
SAU,DEU,2018.0,12,35,-23
ESP,HKG,2019.0,2,2,0
AUT,BRA,2017.0,7,7,0
IRQ,IRN,2018.0,7,15,-8
NLD,ZAF,2016.0,22,18,4
MAC,AUS,2008.0,2,2,0
PRT,ITA,2016.0,30,28,2
GHA,SEN,2020.0,1,2,-1
CHE,ISR,2020.0,11,18,-7
KOR,SWE,2019.0,10,9,1
FRA,BEN,2021.0,6,5,1
IRN,CHN,2022.0,18,4,14
DEU,PAK,2019.0,47,17,30
ZAF,CHE,2020.0,19,5,14
CIV,CHE,2019.0,3,2,1
RUS,ITA,2016.0,20,31,-11
TWN,JPN,2009.0,16,56,-40
SWE,KOR,2016.0,6,11,-5
DEU,FIN,1997.0,4,5,-1
IDN,KOR,2016.0,10,22,-12
JPN,GRC,2009.0,4,3,1
FRA,COL,2007.0,8,3,5
ESP,CAN,1997.0,2,2,0
BGD,MYS,2021.0,17,27,-10
NOR,USA,2001.0,45,43,2
IND,BEL,2003.0,4,6,-2
ECU,USA,2014.0,5,18,-13
LBN,FRA,1998.0,3,1,2
DEU,FIN,1998.0,7,12,-5
AUT,KOR,2005.0,1,3,-2
KOR,IRL,2010.0,6,6,0
DEU,JOR,2012.0,10,9,1
NZL,QAT,2014.0,3,1,2
TUR,JPN,2010.0,4,8,-4
MCO,FRA,2009.0,9,7,2
USA,COD,2020.0,5,2,3
TUR,JPN,2017.0,7,7,0
ESP,RUS,2020.0,6,14,-8
COL,USA,2013.0,62,79,-17
KOR,IRL,2019.0,5,1,4
CAN,MAR,2006.0,6,2,4
PAK,KEN,2018.0,7,6,1
AUS,PHL,1999.0,1,1,0
NLD,AUS,2004.0,29,25,4
COL,FRA,2019.0,18,16,2
FIN,IRL,2018.0,9,5,4
CHL,MEX,2006.0,2,5,-3
IRL,FRA,2011.0,24,26,-2
SRB,AUT,2020.0,7,1,6
EGY,CHE,2012.0,4,1,3
POL,PRT,2011.0,6,6,0
CZE,GBR,2009.0,25,34,-9
EST,COL,2020.0,1,1,0
YEM,CHN,2011.0,1,1,0
ISR,RUS,2009.0,8,5,3
BEL,CMR,2018.0,2,2,0
IRL,CAN,2022.0,16,29,-13
FIN,IND,2018.0,5,19,-14
HRV,CHE,2021.0,3,2,1
PHL,AUS,2018.0,15,6,9
BEL,ISR,2020.0,7,1,6
HUN,ITA,2002.0,10,11,-1
COL,MEX,2016.0,22,39,-17
HUN,FRA,2012.0,15,10,5
ITA,ZAF,2021.0,6,6,0
KOR,IRL,2017.0,6,1,5
IDN,TWN,2014.0,12,11,1
USA,LBY,2020.0,4,1,3
GRC,AUT,2008.0,3,1,2
AUS,HUN,2006.0,3,2,1
NGA,CAN,2016.0,7,3,4
USA,AZE,2016.0,4,1,3
POL,BLR,2008.0,4,4,0
TUR,CAN,2001.0,10,6,4
ETH,RUS,2017.0,2,17,-15
JAM,BRB,2011.0,2,1,1
JOR,DEU,2002.0,4,6,-2
FRA,CMR,1999.0,2,3,-1
SGP,IND,1998.0,2,5,-3
ESP,ITA,1997.0,8,13,-5
EGY,PAK,2009.0,1,3,-2
ESP,ZAF,2021.0,4,7,-3
KOR,GBR,2013.0,36,47,-11
COL,PER,2007.0,2,1,1
SGP,NZL,1999.0,2,4,-2
NLD,FIN,2012.0,10,18,-8
NGA,USA,2006.0,14,15,-1
VEN,COL,2012.0,7,4,3
GHA,CAN,2013.0,4,5,-1
NZL,IDN,2018.0,6,4,2
DNK,ARG,2017.0,2,3,-1
ZAF,MOZ,2011.0,1,2,-1
SWE,BEL,2006.0,9,9,0
BWA,USA,2008.0,8,7,1
TWN,IDN,2011.0,8,5,3
FRA,GAB,2018.0,7,5,2
GBR,GEO,2008.0,2,1,1
KEN,AUS,2014.0,8,3,5
ZAF,DEU,2012.0,22,32,-10
AUS,FJI,2004.0,6,4,2
ETH,NOR,2007.0,3,2,1
SAU,DZA,2017.0,4,2,2
GRC,TWN,2022.0,1,1,0
BGD,SAU,2020.0,6,1,5
DEU,MAR,2008.0,4,1,3
NLD,UGA,2011.0,3,1,2
SGP,TWN,2015.0,13,21,-8
UGA,DEU,2012.0,1,1,0
DZA,MAR,2014.0,3,5,-2
POL,AUT,2016.0,13,2,11
SAU,BHR,2013.0,4,1,3
MYS,ZAF,2013.0,2,1,1
BGR,ZAF,2014.0,1,1,0
ISR,ARG,1999.0,1,2,-1
ITA,JOR,2016.0,4,2,2
ESP,IRL,2010.0,6,17,-11
BGD,GBR,2005.0,6,15,-9
DNK,AUT,2009.0,11,5,6
TZA,NLD,2008.0,1,1,0
IND,ARG,2019.0,1,3,-2
DEU,CRI,2019.0,6,2,4
ISR,BRA,2016.0,5,3,2
TUN,USA,2013.0,4,2,2
KOR,NOR,2016.0,2,5,-3
MAC,SGP,2014.0,1,3,-2
SGP,RUS,2020.0,2,6,-4
SMR,ITA,2014.0,1,2,-1
PAN,ESP,2020.0,3,5,-2
CHL,JPN,2008.0,1,6,-5
SVN,HRV,2016.0,10,8,2
USA,URY,2007.0,7,10,-3
CHL,AUS,2011.0,10,7,3
ZAF,ISR,2018.0,2,2,0
VNM,JPN,2006.0,2,10,-8
CMR,GBR,2013.0,3,1,2
GBR,PHL,2011.0,4,3,1
DEU,IRN,2013.0,23,74,-51
HKG,KOR,2011.0,4,5,-1
TUN,BEL,1999.0,2,1,1
ARG,DOM,2021.0,2,1,1
DZA,ITA,2003.0,1,8,-7
NLD,PHL,2019.0,6,1,5
COL,FRA,2010.0,4,18,-14
DEU,SVN,2017.0,8,10,-2
CHN,ROU,2020.0,2,3,-1
MAR,ESP,2015.0,5,17,-12
TUR,AUT,2009.0,3,3,0
ARG,COL,2006.0,4,2,2
DEU,ARM,2016.0,3,3,0
PAN,NLD,2012.0,1,1,0
FJI,USA,2013.0,2,3,-1
NZL,ESP,2013.0,5,3,2
ZMB,JPN,2013.0,2,2,0
MWI,NLD,2013.0,3,1,2
AUS,UGA,2019.0,4,2,2
SWE,SDN,2020.0,2,1,1
EST,FRA,2018.0,3,3,0
AUT,ISR,2011.0,4,5,-1
NOR,UGA,2015.0,6,3,3
CHE,BGR,2016.0,2,4,-2
DEU,IRQ,2016.0,5,3,2
LBN,IRL,2018.0,1,1,0
ECU,MEX,2019.0,6,17,-11
BFA,BEN,2020.0,3,2,1
AUS,NOR,2009.0,13,8,5
IND,ESP,2004.0,7,3,4
GBR,PSE,2015.0,4,2,2
BGD,ITA,2013.0,3,4,-1
SEN,CAN,2020.0,2,4,-2
ISR,PSE,2022.0,10,3,7
BGR,RUS,2016.0,4,1,3
POL,BGR,2012.0,1,4,-3
CHE,HKG,2007.0,1,3,-2
USA,TTO,2007.0,5,1,4
FRA,THA,2004.0,4,3,1
CYP,GBR,2003.0,2,8,-6
SWE,IRN,2005.0,1,1,0
JPN,BRA,2009.0,13,12,1
FIN,POL,2002.0,6,1,5
MLI,CHE,2005.0,1,1,0
NOR,POL,2004.0,2,1,1
AUT,BEL,2011.0,3,8,-5
PRI,VEN,2009.0,1,3,-2
SRB,DEU,2013.0,7,11,-4
ISR,BGR,2000.0,2,1,1
CAN,OMN,2008.0,8,3,5
GAB,FRA,2004.0,4,3,1
BEL,NER,2004.0,1,1,0
EGY,IND,2007.0,2,2,0
TUR,RUS,2009.0,3,1,2
SWE,AUT,2000.0,1,2,-1
IDN,NLD,2003.0,4,7,-3
DNK,RUS,2001.0,2,5,-3
TUR,CZE,2018.0,6,2,4
CAN,HRV,2008.0,2,1,1
AUT,BRA,2019.0,2,11,-9
GBR,TZA,2007.0,5,4,1
ETH,CHE,2017.0,8,3,5
NLD,MYS,2008.0,3,1,2
ISR,SWE,2009.0,2,1,1
FRA,URY,2000.0,1,1,0
POL,DNK,2015.0,8,8,0
SAU,DZA,2019.0,3,14,-11
IND,COL,2020.0,2,1,1
AUT,TWN,2014.0,2,2,0
BGD,FIN,2012.0,2,1,1
USA,PER,2001.0,3,15,-12
LUX,ESP,2015.0,4,7,-3
GAB,GBR,2019.0,3,1,2
OMN,MYS,2012.0,3,3,0
MYS,BRN,2020.0,11,3,8
PHL,GBR,2016.0,2,6,-4
SAU,LBY,2015.0,1,1,0
IRL,JPN,2011.0,5,3,2
SAU,ESP,2020.0,6,6,0
SDN,JPN,2015.0,1,1,0
AUS,UGA,2017.0,2,6,-4
DZA,IRN,2014.0,1,1,0
HRV,NOR,2020.0,3,1,2
USA,PNG,2021.0,1,1,0
FRA,MCO,2021.0,7,1,6
NGA,DEU,2022.0,8,5,3
ISL,FIN,2019.0,1,3,-2
COL,BRA,2003.0,4,5,-1
SWE,ROU,2003.0,1,2,-1
ITA,SVK,2007.0,2,2,0
COL,AUS,2007.0,1,2,-1
SVN,SRB,2005.0,3,1,2
GRC,BGR,2002.0,3,2,1
SGP,CHN,1998.0,2,22,-20
SGP,NLD,2007.0,6,3,3
KOR,VNM,2008.0,8,1,7
BRA,RUS,2016.0,11,5,6
ESP,HRV,2022.0,1,3,-2
MLI,SEN,2011.0,3,1,2
FRA,TGO,2005.0,3,2,1
KOR,ETH,2017.0,3,1,2
EST,NZL,2019.0,1,1,0
THA,CAN,2004.0,11,3,8
SVK,BEL,2004.0,1,2,-1
ESP,CAN,1998.0,4,4,0
LBY,EGY,2014.0,2,2,0
MAR,ARE,2018.0,2,1,1
RUS,IND,1999.0,3,1,2
AUT,SGP,2005.0,1,1,0
BGD,GBR,2002.0,8,4,4
PRT,SWE,2006.0,7,5,2
MEX,RUS,2007.0,4,3,1
RUS,DNK,2013.0,6,4,2
NZL,PAK,2020.0,8,8,0
GRC,FIN,2015.0,3,4,-1
IRL,EGY,2012.0,1,1,0
HUN,MEX,2018.0,3,2,1
CAN,JOR,2019.0,17,9,8
CAN,TUN,2015.0,4,10,-6
NLD,CZE,2007.0,5,8,-3
HKG,RUS,2016.0,4,2,2
BIH,SRB,2013.0,5,11,-6
PAN,USA,2001.0,2,2,0
HKG,JPN,2012.0,12,6,6
IRL,DNK,2018.0,7,7,0
ZAF,NOR,2013.0,1,3,-2
QAT,AUS,2017.0,6,12,-6
ZMB,AUS,2020.0,3,2,1
BGD,PAK,1999.0,1,1,0
SRB,RUS,2019.0,5,5,0
BEL,HKG,2015.0,3,1,2
SVK,AUT,1999.0,4,3,1
ROU,NLD,2006.0,3,4,-1
MDG,USA,2018.0,3,3,0
RUS,CZE,2013.0,7,6,1
SGP,POL,2022.0,3,1,2
JPN,HKG,2009.0,7,3,4
PHL,DEU,2022.0,3,3,0
GHA,GBR,2011.0,4,18,-14
VEN,FRA,2006.0,3,2,1
GBR,EST,2012.0,7,3,4
THA,KOR,2003.0,3,2,1
LIE,CHE,2008.0,1,1,0
CHE,LBN,2012.0,2,1,1
DEU,ISL,2014.0,2,3,-1
SVK,FIN,2022.0,1,1,0
FRA,PER,2016.0,4,2,2
GIN,FRA,2010.0,2,2,0
JPN,SGP,1999.0,1,4,-3
UKR,SWE,2018.0,5,3,2
DZA,ESP,2022.0,3,3,0
IRL,AUT,2008.0,4,3,1
DNK,IRL,2004.0,2,5,-3
NLD,SVK,2001.0,3,4,-1
ITA,ECU,2008.0,1,1,0
TWN,NZL,2012.0,1,2,-1
NGA,JPN,2015.0,3,1,2
JPN,NPL,2022.0,1,4,-3
CZE,JPN,1998.0,1,1,0
MAR,SAU,2022.0,1,2,-1
DEU,SVN,2010.0,3,4,-1
KAZ,DEU,2001.0,1,1,0
AUS,PAK,2001.0,2,1,1
SAU,MAR,2019.0,4,1,3
AUT,ROU,2003.0,1,2,-1
PRI,ARG,2010.0,2,1,1
FRA,NER,2002.0,3,4,-1
AUS,LKA,2006.0,5,3,2
AUT,CZE,2001.0,3,10,-7
KGZ,TUR,2014.0,1,2,-1
PRT,IND,1999.0,2,2,0
CAN,BRB,2005.0,1,1,0
CAN,KWT,2003.0,2,1,1
CHN,IND,2000.0,4,1,3
CRI,ESP,2009.0,3,2,1
MYS,THA,2008.0,2,2,0
LTU,JPN,2006.0,1,2,-1
CHE,CHL,2013.0,2,4,-2
HKG,GRC,2016.0,1,1,0
LTU,NLD,2009.0,1,4,-3
MNG,CHE,2019.0,2,1,1
CZE,ZAF,2016.0,4,1,3
KOR,HKG,2014.0,4,12,-8
GRC,BGR,2005.0,1,3,-2
UGA,BRA,2021.0,1,1,0
CYP,TUR,2009.0,4,5,-1
SVN,CZE,2016.0,1,1,0
CZE,KOR,2016.0,2,3,-1
BIH,TUR,2018.0,3,3,0
POL,KOR,2005.0,1,1,0
IND,MEX,2000.0,4,2,2
AUS,ECU,2004.0,2,1,1
DEU,ZWE,2006.0,1,1,0
IRL,CZE,2008.0,3,4,-1
POL,FIN,2009.0,5,3,2
FRA,CRI,2008.0,2,2,0
GIB,GBR,2002.0,1,1,0
NLD,ROU,2015.0,3,7,-4
BEL,UGA,2015.0,1,1,0
MYS,NLD,2012.0,4,4,0
FIN,CHL,2018.0,2,2,0
JPN,UKR,2013.0,2,3,-1
GRC,RUS,2016.0,2,1,1
NLD,SVN,2005.0,4,1,3
AUS,SVK,2016.0,1,1,0
URY,BRA,2003.0,5,4,1
KHM,THA,2020.0,3,4,-1
GBR,BRB,2016.0,1,1,0
BOL,CHL,2021.0,1,1,0
BRN,PHL,2020.0,1,1,0
ROU,IND,2005.0,1,1,0
TZA,IND,2012.0,1,1,0
BGD,MEX,2018.0,1,1,0
PRT,DNK,2021.0,7,7,0
SGP,BRN,2020.0,2,1,1
UGA,AUS,2022.0,1,2,-1
LTU,DNK,2012.0,2,3,-1
BRA,CRI,2018.0,1,1,0
KOR,SWE,2010.0,3,3,0
ARE,TUN,2015.0,1,9,-8
CAN,CUB,2012.0,1,5,-4
LUX,NLD,2015.0,5,5,0
SRB,AUS,2020.0,1,1,0
SVN,LTU,2019.0,1,1,0
SWE,PHL,2017.0,1,2,-1
IRL,ETH,2015.0,1,1,0
VEN,CRI,2012.0,1,1,0
CZE,UKR,2003.0,1,2,-1
DEU,CRI,2010.0,2,4,-2
KAZ,JPN,2021.0,3,2,1
SWE,SGP,2005.0,1,4,-3
AUT,IND,2004.0,1,4,-3
CHE,UGA,2018.0,2,2,0
NLD,ARG,2022.0,2,4,-2
MYS,BGD,2002.0,2,1,1
IRL,MEX,2011.0,3,2,1
RWA,KOR,2021.0,1,2,-1
DNK,IRQ,2022.0,1,1,0
AUS,NGA,2019.0,4,12,-8
ZAF,EGY,2018.0,1,2,-1
ISL,FIN,2010.0,1,1,0
BEL,DZA,2002.0,2,2,0
POL,HUN,2006.0,1,4,-3
NER,USA,2011.0,1,1,0
SWE,EST,2001.0,2,2,0
DEU,VEN,2011.0,3,4,-1
BGR,BEL,2000.0,1,3,-2
NGA,CMR,2005.0,1,2,-1
SWE,SGP,2002.0,2,1,1
VEN,GBR,1998.0,1,3,-2
CHE,EGY,2022.0,2,4,-2
NOR,AUT,2015.0,4,10,-6
KWT,IND,2016.0,3,4,-1
JPN,ZAF,2005.0,4,1,3
CIV,FRA,2007.0,6,30,-24
CZE,ARG,2018.0,1,1,0
BGR,DNK,2006.0,1,1,0
PAK,SGP,2004.0,2,3,-1
SWE,GHA,2014.0,1,2,-1
ETH,USA,2007.0,2,7,-5
RWA,NLD,2021.0,1,1,0
TZA,DEU,2021.0,1,3,-2
FIN,HUN,2008.0,1,4,-3
SWE,MEX,2013.0,2,7,-5
NPL,THA,2012.0,3,1,2
ESP,HKG,2010.0,1,2,-1
ALB,USA,2018.0,2,2,0
CAN,CMR,2016.0,2,1,1
JAM,GBR,2004.0,2,2,0
CHN,HRV,2020.0,1,1,0
PRT,MYS,2020.0,1,2,-1
USA,MAR,2004.0,1,7,-6
ISL,DNK,2007.0,2,4,-2
NLD,PHL,2017.0,1,3,-2
ISR,MEX,2003.0,1,1,0
FIN,BEL,2012.0,3,3,0
EST,GBR,2007.0,2,3,-1
POL,SAU,2012.0,1,1,0
DEU,BGD,2002.0,1,4,-3
KEN,ZAF,2002.0,1,2,-1
NOR,FIN,2004.0,3,4,-1
DNK,TUR,2009.0,1,2,-1
GRC,IRL,2003.0,1,3,-2
AUS,MEX,2008.0,3,6,-3
ESP,EST,2009.0,2,2,0
GTM,DEU,2014.0,2,1,1
NLD,RWA,2011.0,1,2,-1
VNM,SWE,2011.0,1,2,-1
MAC,IND,2019.0,1,3,-2
NLD,KOR,2012.0,5,8,-3
AUS,NGA,2017.0,1,8,-7
BEL,FIN,2022.0,4,4,0
NOR,FRO,2020.0,1,1,0
AUS,KWT,2022.0,4,2,2
DEU,KAZ,2008.0,1,3,-2
BGD,TWN,2015.0,1,1,0
CHE,KOR,1998.0,1,1,0
GAB,GBR,2017.0,2,1,1
DEU,NPL,2022.0,1,1,0
LBY,SAU,2012.0,1,1,0
AUT,COL,2021.0,2,2,0
FRA,GIN,2009.0,2,4,-2
SAU,TUR,2008.0,2,2,0
DEU,TZA,2009.0,1,1,0
CAN,COL,2003.0,2,2,0
ITA,GHA,2017.0,2,1,1
ROU,RUS,2006.0,1,3,-2
CHN,BEN,2021.0,1,2,-1
SDN,GBR,2015.0,1,2,-1
FIN,MEX,2015.0,1,1,0
FRA,BHR,2008.0,1,1,0
ESP,FIN,2001.0,1,4,-3
NOR,VNM,2021.0,1,3,-2
ISR,HUN,2016.0,1,2,-1
RUS,ROU,2013.0,1,1,0
ETH,CHE,2010.0,1,2,-1
KEN,ITA,2003.0,1,1,0
URY,SWE,2003.0,1,3,-2
QAT,PSE,2022.0,1,1,0
AUT,SRB,2011.0,2,1,1
BEL,KEN,2004.0,1,3,-2
ITA,MAR,2007.0,1,1,0
MYS,CHN,2004.0,1,1,0
CMR,USA,2022.0,1,1,0
BEL,ISL,2013.0,1,1,0
MYS,BEL,2016.0,1,2,-1
USA,MKD,2015.0,4,4,0
CHN,MEX,2022.0,4,6,-2
DOM,COL,2019.0,1,1,0
HRV,BEL,2020.0,2,2,0
AUS,NPL,2013.0,1,8,-7
SRB,RUS,2010.0,1,1,0
RUS,NZL,2003.0,1,1,0
COL,EST,2020.0,1,1,0
MNG,CHE,2017.0,1,1,0
BEL,BGD,2016.0,1,3,-2
IND,PHL,2012.0,2,3,-1
AUS,BRA,2000.0,1,3,-2
USA,TUN,2022.0,1,4,-3
BEL,ZWE,2017.0,1,1,0
SDN,SWE,2019.0,1,1,0
ZAF,SGP,1999.0,1,1,0
OMN,ZAF,2022.0,1,1,0
FRA,ARM,2013.0,1,1,0
DEU,DZA,2012.0,1,2,-1
SVK,NLD,1999.0,1,1,0
BGD,PHL,2014.0,1,1,0
NZL,THA,2001.0,1,2,-1
ESP,EGY,2003.0,1,2,-1
SGP,CHN,1997.0,1,8,-7
BWA,KEN,1999.0,1,1,0
ZAF,ARE,2006.0,2,1,1
IDN,FRA,1999.0,2,2,0
DZA,JPN,2002.0,1,2,-1
CHE,HRV,2004.0,1,6,-5
CYP,CAN,2018.0,1,4,-3
YEM,IND,2014.0,1,2,-1
CAN,DZA,2002.0,1,4,-3
SGP,BRA,2006.0,1,1,0
KAZ,UZB,1997.0,1,1,0
FIN,BGD,2018.0,1,2,-1
QAT,JPN,2017.0,1,1,0
IRL,RUS,2001.0,1,4,-3
AZE,NLD,2019.0,1,1,0
FRA,HRV,2007.0,1,5,-4
ITA,TUR,2008.0,1,6,-5
RWA,BEL,2013.0,1,3,-2
BGD,FRA,2012.0,2,4,-2
KWT,ARE,2007.0,1,2,-1
USA,SDN,2012.0,1,3,-2
MEX,CZE,2006.0,1,1,0
JOR,BHR,2018.0,1,2,-1
TZA,RWA,2017.0,1,2,-1
MEX,IDN,2019.0,1,1,0
PAK,SVN,2020.0,1,1,0
CAN,USA,2012.0,1551,1348,203
USA,IRL,2010.0,131,124,7
USA,HKG,2007.0,99,83,16
ITA,GBR,2010.0,333,181,152
BRA,PRT,2009.0,56,45,11
ARG,DEU,2012.0,37,27,10
DEU,USA,2019.0,1140,1032,108
GBR,SAU,2013.0,104,22,82
DEU,USA,2017.0,1193,1059,134
ESP,CHL,2015.0,147,42,105
CAN,JPN,2013.0,77,80,-3
USA,SAU,2015.0,144,81,63
DEU,ESP,2017.0,181,255,-74
CAN,BRA,2011.0,37,50,-13
USA,TUR,2021.0,145,174,-29
ZAF,GHA,2011.0,3,6,-3
DEU,ESP,2019.0,190,218,-28
RUS,FIN,2005.0,12,5,7
ROU,FRA,2012.0,30,29,1
GBR,MYS,2020.0,103,85,18
GBR,MEX,2007.0,35,23,12
GBR,IRL,2015.0,211,257,-46
NLD,CHN,2012.0,46,79,-33
TUR,CYP,2021.0,42,41,1
BEL,FRA,2007.0,126,159,-33
DEU,ISR,2014.0,45,42,3
TUR,JPN,2019.0,11,10,1
DNK,SWE,2011.0,58,77,-19
NOR,ESP,2017.0,13,26,-13
NOR,ESP,2019.0,15,29,-14
DEU,TUR,2014.0,39,39,0
ECU,MEX,2017.0,5,14,-9
DNK,AUS,2020.0,41,35,6
ESP,IRL,2019.0,34,25,9
SWE,AUS,2021.0,30,37,-7
MWI,USA,2018.0,14,24,-10
HKG,SGP,2020.0,34,40,-6
BOL,SWE,2022.0,2,1,1
CHN,ESP,2018.0,30,52,-22
FRA,DEU,2016.0,360,356,4
CAN,TWN,2016.0,13,13,0
JOR,DEU,2005.0,7,6,1
ESP,COL,2010.0,50,61,-11
PAK,IRQ,2021.0,4,2,2
ROU,ITA,2001.0,6,2,4
JPN,PAK,2011.0,10,8,2
GBR,CHE,2002.0,112,137,-25
PHL,JPN,2006.0,16,11,5
CAN,MEX,2018.0,31,37,-6
KOR,RUS,2013.0,10,8,2
NOR,JPN,2016.0,6,6,0
USA,BHR,2019.0,4,3,1
IRL,BRA,2021.0,3,14,-11
FIN,ESP,2002.0,4,6,-2
BIH,HRV,2017.0,8,9,-1
AUS,GRC,2009.0,3,4,-1
ETH,ITA,2008.0,3,2,1
AUT,BRA,2010.0,3,4,-1
UKR,AUT,2002.0,7,1,6
JPN,IRN,2006.0,9,5,4
IRL,KEN,2022.0,1,1,0
NLD,PRT,2014.0,18,19,-1
BIH,HRV,2010.0,5,11,-6
BGD,AUS,2011.0,32,7,25
DEU,CHL,2001.0,10,11,-1
FRA,CHE,1997.0,29,19,10
UKR,CHE,1999.0,3,1,2
HUN,ZAF,2020.0,2,2,0
CZE,FRA,2008.0,12,15,-3
IND,DEU,1997.0,11,13,-2
ROU,DEU,2001.0,18,6,12
KOR,SWE,2017.0,10,4,6
FRA,SVN,2007.0,4,2,2
PRI,CAN,2008.0,1,1,0
PRT,FRA,2008.0,21,34,-13
SAU,MAR,2017.0,2,4,-2
AUS,KHM,2016.0,2,3,-1
ETH,CHE,2019.0,6,4,2
GRC,NLD,2022.0,5,8,-3
AUS,NGA,2010.0,1,1,0
FIN,NOR,2008.0,14,4,10
KOR,MNG,2020.0,3,3,0
RUS,CAN,2014.0,16,17,-1
FIN,ESP,2005.0,5,3,2
CZE,AUT,2003.0,7,5,2
CZE,AUS,2021.0,2,4,-2
MEX,IDN,2017.0,1,1,0
FRA,GLP,2007.0,10,15,-5
RUS,FIN,2002.0,17,17,0
MLI,FRA,2021.0,5,4,1
PAK,AUT,2018.0,3,6,-3
HUN,POL,2011.0,9,1,8
CHN,BRA,2007.0,4,1,3
NLD,UKR,2009.0,1,2,-1
GBR,IDN,2013.0,8,1,7
CYP,FRA,2011.0,1,1,0
GBR,ISL,2012.0,10,4,6
GIN,FRA,2019.0,2,2,0
BEL,CIV,2006.0,3,1,2
ECU,CHN,2021.0,2,1,1
GBR,GAB,2016.0,3,2,1
DZA,DEU,2022.0,3,1,2
SEN,GBR,2010.0,1,3,-2
USA,BHR,2010.0,3,3,0
USA,BGR,2009.0,4,12,-8
VNM,GBR,2003.0,5,4,1
SWE,LKA,2005.0,1,1,0
AZE,TUR,2011.0,2,5,-3
IRL,NZL,2005.0,4,5,-1
TZA,NOR,2011.0,5,4,1
AUS,MNG,2019.0,3,2,1
NLD,VNM,2009.0,3,1,2
IRL,TUR,2005.0,1,3,-2
DZA,SYR,2011.0,1,1,0
CHE,HUN,1999.0,3,4,-1
FIN,ITA,2013.0,11,14,-3
BEL,UKR,2009.0,2,1,1
ITA,PHL,2008.0,1,2,-1
USA,ALB,2017.0,1,1,0
BEL,GEO,2009.0,1,2,-1
GBR,BGR,2016.0,3,5,-2
PHL,CHE,2014.0,3,2,1
SAU,KAZ,2018.0,3,3,0
CAN,BIH,2004.0,1,1,0
ESP,SVN,2022.0,1,1,0
PHL,IND,2007.0,3,7,-4
ETH,BEL,2011.0,2,4,-2
SVN,POL,2013.0,4,2,2
PRT,RUS,2020.0,2,6,-4
BLZ,USA,2015.0,1,1,0
NZL,HKG,1999.0,1,5,-4
USA,GTM,2013.0,5,13,-8
SAU,QAT,2011.0,1,1,0
ARE,QAT,2011.0,6,2,4
JPN,ROU,2010.0,1,1,0
TUR,AZE,2022.0,3,4,-1
FRA,ECU,2001.0,1,3,-2
SVK,DNK,2002.0,1,2,-1
CHE,BEN,2013.0,1,1,0
ROU,TUR,2005.0,1,2,-1
COL,CHE,2017.0,2,8,-6
TZA,KEN,2020.0,4,5,-1
EST,AUS,2021.0,2,2,0
GBR,SDN,2014.0,2,2,0
DEU,MWI,2002.0,1,1,0
NLD,BEN,2007.0,1,1,0
DNK,SVK,2013.0,1,1,0
PRT,HKG,2020.0,1,2,-1
DEU,COL,1999.0,1,2,-1
IND,ROU,2021.0,1,4,-3
PER,KEN,2019.0,1,3,-2
,USA,2004.0,82402,0,82402
BIH,,2020.0,217,0,217
FRA,,2011.0,7538,0,7538
,FRA,2001.0,14584,0,14584
KOR,,2020.0,15378,0,15378
,IRL,2001.0,1016,0,1016
HRV,,2024.0,6308,0,6308
AUS,,2009.0,3092,0,3092
,USA,1996.0,42624,0,42624
USA,,2016.0,74693,0,74693
,IND,2006.0,16770,0,16770
,MYS,2003.0,937,0,937
BEL,,2024.0,21914,0,21914
,DNK,2002.0,1918,0,1918
DNK,,2017.0,1875,0,1875
CAN,,2020.0,14211,0,14211
IRL,,2015.0,950,0,950
DNK,,2019.0,2646,0,2646
MEX,,2014.0,2163,0,2163
ISR,,2015.0,1580,0,1580
,NZL,2011.0,1444,0,1444
PRT,,2012.0,736,0,736
,ESP,2006.0,12809,0,12809
,DNK,2005.0,1862,0,1862
TUR,,2020.0,7156,0,7156
,ALB,2009.0,91,0,91
PHL,IDN,2005.0,1,0,1
,NLD,2013.0,6467,0,6467
MYS,,2022.0,7673,0,7673
,LUX,2007.0,107,0,107
DNK,,2010.0,946,0,946
IRQ,,2013.0,64,0,64
,CIV,2003.0,115,0,115
ARE,,2016.0,189,0,189
,HRV,2018.0,769,0,769
SGP,,2013.0,964,0,964
,CHL,1997.0,405,0,405
NZL,,2008.0,524,0,524
,BEL,2014.0,3413,0,3413
,BGR,1997.0,211,0,211
NOR,,1999.0,28,0,28
CMR,,2024.0,2025,0,2025
AZE,,2024.0,629,0,629
DNK,MWI,2015.0,1,0,1
,TWN,2016.0,5264,0,5264
VNM,,2009.0,75,0,75
CUB,,2001.0,84,0,84
KAZ,,2009.0,44,0,44
MLI,,2020.0,77,0,77
,BGR,1998.0,883,0,883
,TTO,2000.0,47,0,47
LBN,AUS,2009.0,2,0,2
ZMB,,2014.0,16,0,16
LTU,,2013.0,290,0,290
TUR,MYS,2007.0,2,0,2
ARM,,2023.0,573,0,573
,CHL,1998.0,1073,0,1073
,JPN,2016.0,21271,0,21271
IRN,NOR,2009.0,6,0,6
,KAZ,2014.0,1839,0,1839
,MAC,2005.0,35,0,35
ZAF,AUT,2014.0,1,0,1
,DZA,2015.0,1523,0,1523
,IDN,2013.0,3100,0,3100
,BRN,2010.0,37,0,37
PRT,EST,2014.0,1,0,1
BDI,,2016.0,5,0,5
TUR,HRV,2016.0,4,0,4
,QAT,2013.0,301,0,301
,RWA,2014.0,92,0,92
COG,,2022.0,117,0,117
HKG,,2000.0,32,0,32
,GEO,1994.0,122,0,122
MAC,,2011.0,18,0,18
ARG,ECU,2014.0,4,0,4
TWN,,2001.0,53,0,53
,CHN,2020.0,260,0,260
AND,,2022.0,3,0,3
TCD,,2024.0,24,0,24
,BRN,2017.0,39,0,39
PAN,,2021.0,58,0,58
CZE,,2001.0,77,0,77
IND,IRQ,2010.0,8,0,8
PAK,KAZ,2020.0,1,0,1
RUS,LTU,2020.0,6,0,6
BRA,ROU,2022.0,1,0,1
,URY,2016.0,236,0,236
IND,IRQ,2017.0,12,0,12
TLS,,2023.0,15,0,15
,SUR,2018.0,11,0,11
,GNB,2018.0,3,0,3
LVA,SWE,2000.0,4,0,4
,PAK,2018.0,4959,0,4959
,BRN,2019.0,28,0,28
,TGO,2006.0,42,0,42
BGR,MEX,2010.0,1,0,1
COL,PRT,2013.0,3,0,3
MYS,KOR,2007.0,5,0,5
YEM,,2015.0,22,0,22
ARG,GTM,2016.0,3,0,3
HKG,ZAF,2005.0,2,0,2
,MAC,2002.0,24,0,24
FRO,GBR,2018.0,2,0,2
QAT,PRT,2020.0,2,0,2
SRB,,2006.0,84,0,84
SEN,,2009.0,41,0,41
,BDI,2015.0,6,0,6
SLV,,2021.0,12,0,12
MAR,TUN,2016.0,2,0,2
LUX,FIN,2002.0,1,0,1
FRA,UGA,2002.0,2,0,2
DEU,BGD,2005.0,2,0,2
,SLV,2018.0,11,0,11
,LKA,1999.0,114,0,114
BLR,,2008.0,154,0,154
,MMR,2005.0,14,0,14
MDA,,2014.0,35,0,35
ARG,,2025.0,12,0,12
,MMR,2002.0,16,0,16
UGA,,2008.0,25,0,25
PER,COL,2006.0,3,0,3
CAN,PHL,2015.0,2,0,2
,ERI,2001.0,9,0,9
CHN,CAF,2011.0,1,0,1
SRB,GRC,2004.0,2,0,2
HTI,GIN,2016.0,1,0,1
COL,,2006.0,77,0,77
BEL,TZA,2010.0,5,0,5
MAR,,2003.0,80,0,80
SVN,BEL,2008.0,2,0,2
PSE,USA,2004.0,1,0,1
NER,SEN,1997.0,3,0,3
JPN,ARM,2003.0,1,0,1
BFA,CMR,2004.0,1,0,1
BEL,MDA,2003.0,2,0,2
HND,,2012.0,6,0,6
DNK,CZE,2006.0,2,0,2
SDN,,2004.0,6,0,6
ARG,BOL,2004.0,1,0,1
MKD,CZE,2002.0,1,0,1
VEN,NLD,2011.0,6,0,6
HRV,JPN,2014.0,2,0,2
SUR,,2013.0,1,0,1
JPN,ROU,2019.0,8,0,8
PNG,,2004.0,9,0,9
THA,TWN,2007.0,3,0,3
RUS,MDA,2013.0,5,0,5
ITA,BFA,2016.0,1,0,1
TGO,,2006.0,5,0,5
PRI,ARG,2019.0,2,0,2
GNB,,2006.0,3,0,3
CRI,,2004.0,17,0,17
ITA,KOR,2006.0,4,0,4
ISR,CYP,2021.0,4,0,4
SGP,ZAF,2008.0,2,0,2
AUS,GRD,2012.0,1,0,1
MLT,,2013.0,10,0,10
ISR,CHL,2011.0,2,0,2
JPN,PER,2005.0,1,0,1
ARE,ETH,2021.0,1,0,1
GRC,ESP,1998.0,1,0,1
KGZ,,2013.0,7,0,7
,MUS,2008.0,24,0,24
,PSE,2008.0,41,0,41
USA,MHL,2015.0,1,0,1
,NCL,2008.0,21,0,21
ETH,DNK,2014.0,2,0,2
NZL,OMN,2014.0,2,0,2
ZWE,SEN,2012.0,1,0,1
ROU,BRA,2004.0,1,0,1
VEN,CHN,2014.0,1,0,1
IRL,IRQ,2015.0,1,0,1
CUB,KOR,2019.0,1,0,1
SVK,UZB,2018.0,1,0,1
COL,TLS,2016.0,1,0,1
,TJK,2000.0,20,0,20
EST,BEL,2020.0,3,0,3
BEN,GHA,2022.0,2,0,2
AUS,UGA,2010.0,2,0,2
CHN,BIH,2004.0,2,0,2
ESP,ETH,2015.0,2,0,2
SAU,HUN,2020.0,1,0,1
SLB,,2024.0,6,0,6
YEM,JOR,2015.0,1,0,1
KEN,MOZ,2012.0,1,0,1
,LSO,2009.0,7,0,7
BLR,CAN,2016.0,3,0,3
MDV,,2017.0,1,0,1
PHL,PNG,2017.0,1,0,1
MAR,KOR,2021.0,1,0,1
SGP,IDN,2007.0,2,0,2
DEU,TUN,2008.0,3,0,3
MNE,RUS,2002.0,1,0,1
SGP,VNM,2006.0,2,0,2
ARE,MAC,2020.0,1,0,1
LVA,,2001.0,9,0,9
MEX,PAK,2016.0,1,0,1
SRB,RUS,2017.0,2,0,2
JPN,ECU,2016.0,3,0,3
BGD,SVN,2020.0,1,0,1
TGO,SAU,2009.0,1,0,1
MYS,ESP,2007.0,3,0,3
ITA,LUX,2002.0,2,0,2
ESP,ARE,2004.0,1,0,1
USA,KHM,2004.0,1,0,1
LBY,,2005.0,8,0,8
CZE,HUN,2012.0,3,0,3
USA,KAZ,2005.0,3,0,3
THA,IDN,2005.0,2,0,2
GTM,USA,1997.0,1,0,1
GUM,AUS,2010.0,2,0,2
CYP,UKR,2013.0,1,0,1
MAR,CHE,2000.0,3,0,3
BFA,,2006.0,8,0,8
USA,DZA,2009.0,2,0,2
BEN,UGA,2018.0,1,0,1
GBR,LVA,2003.0,3,0,3
BEL,TZA,2017.0,5,0,5
NOR,MOZ,2003.0,1,0,1
URY,AUS,2005.0,3,0,3
SRB,NOR,2016.0,4,0,4
TUR,THA,2016.0,2,0,2
NAM,,2012.0,4,0,4
SLE,COG,2022.0,1,0,1
SLV,HND,2014.0,2,0,2
SEN,GMB,2019.0,1,0,1
POL,COL,2013.0,2,0,2
CRI,ITA,2009.0,1,0,1
RWA,AUT,2003.0,1,0,1
KEN,GBR,2000.0,2,0,2
MYS,ETH,2018.0,2,0,2
LBN,CHE,2021.0,6,0,6
AGO,USA,2007.0,2,0,2
ESP,CPV,2019.0,2,0,2
MNP,USA,2000.0,1,0,1
NER,MLI,2018.0,1,0,1
UKR,LTU,2014.0,4,0,4
IND,UZB,2020.0,4,0,4
PRK,,2014.0,5,0,5
ARM,CAN,2014.0,1,0,1
REU,NCL,2012.0,1,0,1
IRN,CZE,2007.0,2,0,2
GUM,,2018.0,3,0,3
LIE,,2001.0,2,0,2
MLI,ITA,2013.0,1,0,1
IDN,VNM,2018.0,1,0,1
QAT,IRL,2013.0,1,0,1
,AND,2015.0,1,0,1
QAT,FIN,2021.0,1,0,1
THA,SOM,2018.0,1,0,1
LKA,NOR,2013.0,1,0,1
PNG,ESP,2020.0,1,0,1
BRA,KOR,2013.0,4,0,4
,BMU,1998.0,4,0,4
CHE,MMR,2017.0,2,0,2
CHN,SRB,2014.0,2,0,2
UKR,UZB,2016.0,1,0,1
TWN,BLR,2017.0,1,0,1
SWE,IRN,2002.0,4,0,4
FIN,POL,2005.0,3,0,3
NGA,NOR,2003.0,2,0,2
SEN,BRA,1999.0,1,0,1
KAZ,UZB,1998.0,1,0,1
UKR,DNK,2001.0,1,0,1
SVK,HUN,2006.0,2,0,2
NCL,JPN,2002.0,1,0,1
MRT,MLI,2002.0,1,0,1
AUT,LUX,2005.0,1,0,1
,PAN,1994.0,12,0,12
PAN,VEN,2020.0,1,0,1
LUX,PRT,2006.0,1,0,1
AUS,FSM,2007.0,2,0,2
BMU,,2015.0,2,0,2
TWN,ISR,2006.0,2,0,2
GBR,MDG,2015.0,2,0,2
PAK,GMB,2015.0,1,0,1
TUN,GRC,2010.0,1,0,1
POL,TUN,2009.0,1,0,1
AGO,ITA,2010.0,1,0,1
SDN,FRA,2010.0,1,0,1
,MCO,2000.0,8,0,8
MKD,SWE,2016.0,1,0,1
CHE,NAM,2022.0,1,0,1
MEX,AUT,2015.0,5,0,5
PNG,SGP,2003.0,1,0,1
HKG,LVA,2018.0,1,0,1
USA,TJK,2018.0,2,0,2
SLV,CHL,2017.0,1,0,1
DNK,EGY,2015.0,1,0,1
LAO,GEO,2015.0,1,0,1
MAC,KOR,2018.0,1,0,1
EST,IND,2008.0,1,0,1
ECU,PRI,2019.0,1,0,1
,LIE,2018.0,14,0,14
TUR,PSE,2007.0,1,0,1
RUS,SGP,2004.0,2,0,2
BGR,CHE,1997.0,1,0,1
CHE,EST,1999.0,1,0,1
MDA,CHE,2005.0,1,0,1
LKA,AUT,2004.0,1,0,1
AUT,GRC,1999.0,1,0,1
CHN,PRK,2015.0,1,0,1
ROU,SWE,2013.0,4,0,4
AUT,LUX,2002.0,1,0,1
BEL,DZA,2005.0,2,0,2
NLD,EST,2001.0,1,0,1
BIH,BHS,2019.0,1,0,1
ARE,NZL,2016.0,1,0,1
RUS,JAM,1999.0,1,0,1
TGO,CAN,2010.0,1,0,1
ECU,DEU,2004.0,1,0,1
DEU,BEN,2011.0,2,0,2
AUS,URY,2018.0,1,0,1
GHA,COG,2020.0,1,0,1
,SLB,2009.0,5,0,5
SWE,URY,2004.0,1,0,1
TUN,EST,2019.0,1,0,1
PHL,NPL,2016.0,1,0,1
CAN,MDG,2017.0,1,0,1
VNM,GHA,2016.0,1,0,1
PER,NOR,2015.0,2,0,2
TWN,ARE,2020.0,1,0,1
JPN,PSE,2008.0,1,0,1
ISR,NOR,2008.0,2,0,2
POL,EST,2007.0,1,0,1
CMR,GHA,2015.0,2,0,2
DNK,ARG,2019.0,2,0,2
URY,MEX,2004.0,2,0,2
FIN,ARE,2021.0,1,0,1
BLZ,,2009.0,1,0,1
FJI,BRA,2004.0,1,0,1
PAN,PER,2009.0,2,0,2
FRA,PSE,2013.0,2,0,2
KGZ,CHE,2013.0,1,0,1
MEX,HUN,2015.0,1,0,1
CHL,BHS,2014.0,1,0,1
GRC,CHL,2015.0,2,0,2
PHL,KOR,1999.0,1,0,1
USA,ASM,2019.0,1,0,1
PAK,COG,2011.0,1,0,1
PER,CHE,2002.0,2,0,2
USA,GIN,2015.0,2,0,2
BHR,ARE,2022.0,3,0,3
HUN,ETH,2015.0,1,0,1
ITA,NPL,2016.0,2,0,2
LTU,NOR,2015.0,1,0,1
NOR,ARG,2014.0,1,0,1
IND,MMR,2019.0,1,0,1
AGO,RUS,2016.0,1,0,1
LVA,RUS,2003.0,1,0,1
TZA,MDG,1999.0,1,0,1
MEX,MAR,2004.0,1,0,1
SDN,BHR,2012.0,1,0,1
PNG,ZAF,1999.0,1,0,1
LUX,IND,2009.0,1,0,1
MDG,SEN,2001.0,3,0,3
AGO,,2003.0,2,0,2
UKR,TWN,1999.0,1,0,1
SRB,BEL,2001.0,1,0,1
CHE,RWA,2014.0,1,0,1
AUS,OMN,2000.0,2,0,2
BFA,MRT,2009.0,1,0,1
DEU,MYS,1997.0,1,0,1
POL,VEN,2015.0,1,0,1
CAN,MNE,2012.0,1,0,1
CAN,GRL,2011.0,1,0,1
AUS,BTN,2016.0,2,0,2
NOR,KEN,2013.0,1,0,1
UZB,KOR,2000.0,2,0,2
TUN,KEN,2015.0,1,0,1
ABW,,2015.0,1,0,1
JPN,IRQ,2016.0,1,0,1
RUS,BIH,2010.0,3,0,3
CYP,CHE,2016.0,3,0,3
IND,MMR,2017.0,1,0,1
CHE,SAU,2012.0,1,0,1
UKR,IRL,2010.0,1,0,1
ITA,ISL,2020.0,3,0,3
KEN,TCD,2021.0,1,0,1
NLD,SWZ,2016.0,1,0,1
COL,TUR,2003.0,1,0,1
ITA,MYS,2009.0,1,0,1
CAN,PNG,2002.0,1,0,1
BGR,TWN,1998.0,1,0,1
GUY,,2011.0,1,0,1
NOR,PER,2009.0,1,0,1
,COM,2013.0,2,0,2
CRI,COL,2007.0,1,0,1
WSM,,2009.0,3,0,3
LBY,,2002.0,5,0,5
PSE,TUR,2001.0,1,0,1
PNG,USA,2007.0,1,0,1
VEN,AGO,2019.0,1,0,1
BGD,CHE,2009.0,1,0,1
TWN,SVK,2007.0,2,0,2
SEN,USA,1998.0,2,0,2
NAM,CHE,2016.0,1,0,1
LSO,NOR,2015.0,1,0,1
URY,SAU,2003.0,1,0,1
,MDV,2012.0,1,0,1
BTN,AUS,2022.0,2,0,2
COG,FRA,2022.0,1,0,1
IND,SVK,2015.0,2,0,2
PNG,LKA,2019.0,1,0,1
CHN,ZAF,2000.0,1,0,1
ETH,POL,2013.0,1,0,1
CHL,ISR,2015.0,1,0,1
BWA,ARG,2014.0,1,0,1
LUX,ITA,2004.0,1,0,1
TZA,THA,2010.0,1,0,1
LTU,ESP,2012.0,1,0,1
GBR,BGD,1998.0,2,0,2
VUT,NCL,2019.0,1,0,1
SEN,GBR,2019.0,1,0,1
UGA,SWZ,2017.0,1,0,1
TLS,NPL,2018.0,2,0,2
GRC,UKR,2004.0,1,0,1
NZL,PLW,2001.0,1,0,1
BEL,KHM,2001.0,1,0,1
TGO,BFA,2021.0,1,0,1
KOR,KHM,2016.0,1,0,1
UGA,SSD,2022.0,1,0,1
BEL,ZWE,2010.0,1,0,1
AUS,CZE,2022.0,2,0,2
CHN,BRN,2015.0,1,0,1
DEU,FRO,2022.0,1,0,1
SRB,BGR,2000.0,1,0,1
KWT,PER,2000.0,1,0,1
POL,PYF,1999.0,1,0,1
UKR,LUX,2010.0,1,0,1
OMN,TWN,2012.0,1,0,1
GBR,RWA,2008.0,2,0,2
ZAF,FLK,2015.0,1,0,1
PRT,MOZ,2003.0,1,0,1
CUB,NGA,2009.0,1,0,1
ARG,TWN,2001.0,1,0,1
GBR,TTO,2000.0,1,0,1
UZB,ARE,2015.0,1,0,1
,BLZ,2016.0,2,0,2
GRC,EGY,2018.0,2,0,2
MEX,CHL,2000.0,1,0,1
MDV,,2019.0,2,0,2
ECU,ARE,2021.0,1,0,1
CHE,TUN,2004.0,3,0,3
CRI,CHL,2018.0,1,0,1
TZA,RWA,2019.0,1,0,1
GHA,AUS,2001.0,1,0,1
NLD,HKG,1999.0,1,0,1
CAN,JAM,2003.0,2,0,2
ESP,NGA,2014.0,1,0,1
EGY,LUX,2019.0,1,0,1
SLE,IRL,2014.0,1,0,1
AUT,KGZ,2019.0,1,0,1
KGZ,MDA,2018.0,1,0,1
KHM,CAN,2012.0,1,0,1
NZL,ISL,2012.0,1,0,1
ITA,UZB,2003.0,1,0,1
LUX,IRL,2015.0,1,0,1
IND,YEM,2009.0,1,0,1
SYR,DNK,2011.0,1,0,1
CAN,LIE,2013.0,1,0,1
IRN,SVN,2012.0,1,0,1
BRN,BFA,2011.0,1,0,1
NOR,TCD,2020.0,1,0,1
IDN,SAU,2002.0,1,0,1
SEN,DEU,1999.0,2,0,2
COL,GTM,2005.0,1,0,1
NOR,ZWE,2004.0,1,0,1
ITA,CRI,2012.0,2,0,2
IRN,KWT,2018.0,1,0,1
ATG,,2018.0,1,0,1
ETH,IRN,2014.0,1,0,1
MAR,MDG,1999.0,1,0,1
TUN,MEX,2003.0,1,0,1
ISR,PRT,2013.0,1,0,1
ECU,GBR,2009.0,1,0,1
BWA,IND,2006.0,1,0,1
JPN,ZAF,2002.0,1,0,1
RUS,RWA,2009.0,2,0,2
NGA,GNQ,2018.0,1,0,1
MKD,BGR,2021.0,2,0,2
BRN,ARE,2022.0,1,0,1
SWE,SVN,1999.0,1,0,1
CHN,LAO,2008.0,1,0,1
ISR,TZA,2013.0,1,0,1
PRT,BEN,2016.0,1,0,1
KAZ,EGY,2014.0,1,0,1
ZAF,SEN,2020.0,2,0,2
FRA,NGA,2022.0,1,0,1
MCO,DEU,2012.0,1,0,1
MEX,FIN,2009.0,1,0,1
BRA,DZA,2019.0,1,0,1
YEM,FRA,2021.0,1,0,1
NLD,CMR,2015.0,1,0,1
GBR,SWZ,2011.0,1,0,1
AUS,MLT,2012.0,1,0,1
BGR,MEX,2019.0,1,0,1
AZE,USA,2015.0,1,0,1
SWE,PHL,2019.0,1,0,1
CHN,LSO,2016.0,1,0,1
ESP,BGR,1998.0,3,0,3
CHE,NPL,2014.0,1,0,1
SYR,ARE,2008.0,1,0,1
IND,COG,2011.0,1,0,1
TWN,HUN,2016.0,1,0,1
ZWE,BLR,2015.0,1,0,1
IND,GUY,2009.0,1,0,1
CAN,GEO,2009.0,1,0,1
HUN,BGR,2014.0,2,0,2
PRI,PAN,1998.0,1,0,1
GUF,,2006.0,1,0,1
MNE,SVN,1998.0,1,0,1
SWE,ETH,2004.0,2,0,2
CHL,KHM,2006.0,1,0,1
COL,RUS,2001.0,1,0,1
DZA,MYS,2013.0,1,0,1
NLD,ETH,2008.0,1,0,1
GAB,USA,2004.0,1,0,1
CAN,CPV,2008.0,1,0,1
DEU,GIN,2022.0,1,0,1
IND,MWI,2018.0,1,0,1
UZB,MEX,2010.0,1,0,1
BLR,NLD,2003.0,1,0,1
SDN,KWT,2006.0,1,0,1
ESP,LKA,2018.0,2,0,2
HUN,SVN,2006.0,1,0,1
SGP,IND,1997.0,2,0,2
HTI,USA,2009.0,1,0,1
ROU,AUT,2004.0,1,0,1
KEN,TUR,2000.0,1,0,1
ARM,AUS,1997.0,1,0,1
CAN,GRD,2015.0,2,0,2
ETH,AUS,2011.0,1,0,1
ITA,LIE,2003.0,1,0,1
IRL,SDN,2008.0,1,0,1
MYS,FJI,2011.0,1,0,1
JPN,ALB,2015.0,1,0,1
CRI,BOL,2012.0,1,0,1
HUN,HKG,2015.0,1,0,1
LKA,ESP,2020.0,1,0,1
ROU,QAT,2020.0,1,0,1
PHL,MLT,2021.0,1,0,1
FLK,ZAF,2020.0,1,0,1
TUR,OMN,2021.0,1,0,1
POL,TWN,2009.0,1,0,1
KOR,TWN,1998.0,1,0,1
IRL,KAZ,2018.0,1,0,1
LBY,AUT,2019.0,1,0,1
COD,SEN,2022.0,1,0,1
KWT,SVN,2020.0,1,0,1
KOR,SVK,2014.0,1,0,1
IND,ATG,2013.0,1,0,1
COG,ZWE,2007.0,1,0,1
USA,GRD,2007.0,1,0,1
REU,IND,2018.0,1,0,1
MDV,GBR,2016.0,1,0,1
,VUT,2015.0,2,0,2
KNA,FRA,2020.0,1,0,1
AUS,PER,2003.0,1,0,1
MYS,KAZ,2022.0,1,0,1
ZMB,NGA,2003.0,1,0,1
NAM,IND,2021.0,1,0,1
PER,BGD,2019.0,1,0,1
COG,ITA,2020.0,1,0,1
SDN,FRA,2017.0,1,0,1
CHL,CYP,2010.0,1,0,1
BEL,LBY,2008.0,1,0,1
MTQ,,2005.0,1,0,1
CZE,BLR,2021.0,1,0,1
DEU,TTO,2010.0,1,0,1
CAN,TZA,2000.0,1,0,1
ITA,QAT,2012.0,1,0,1
MDA,GBR,1999.0,1,0,1
ZWE,RWA,2009.0,1,0,1
FRA,UGA,2005.0,1,0,1
ZAF,IRL,1998.0,1,0,1
KNA,TTO,2022.0,1,0,1
VNM,BEL,1999.0,1,0,1
CHN,NZL,1999.0,1,0,1
BRB,AUS,2019.0,1,0,1
PRT,MAC,2007.0,1,0,1
BRA,LKA,2007.0,1,0,1
TWN,MEX,2020.0,1,0,1
MLI,DNK,2014.0,1,0,1
ARE,UZB,2022.0,1,0,1
RUS,SVN,2015.0,1,0,1
GEO,BEL,2018.0,1,0,1
TTO,GUY,2020.0,2,0,2
CHN,PYF,2017.0,1,0,1
ROU,BGR,2003.0,1,0,1
AZE,MEX,2004.0,1,0,1
AUS,FLK,2014.0,1,0,1
CAN,CYP,2006.0,1,0,1
GEO,NZL,2020.0,1,0,1
VEN,DNK,2003.0,1,0,1
PHL,ITA,2007.0,1,0,1
MMR,,2006.0,2,0,2
RUS,PRI,2006.0,1,0,1
LKA,SGP,2007.0,1,0,1
PRY,CRI,2017.0,1,0,1
TUN,JOR,2020.0,1,0,1
CUB,URY,2018.0,1,0,1
PER,PRT,2004.0,1,0,1
FRA,HTI,2013.0,1,0,1
SGP,CHL,2012.0,1,0,1
AUS,MNG,2010.0,1,0,1
HKG,UZB,2019.0,1,0,1
UGA,SWZ,2019.0,1,0,1
YEM,SAU,2023.0,1,0,1
QAT,OMN,2006.0,1,0,1
NCL,FJI,2005.0,1,0,1
FIN,SVN,2007.0,1,0,1
FSM,PLW,2011.0,1,0,1
MLI,KEN,2018.0,1,0,1
USA,UZB,2021.0,1,0,1
BEL,BRA,2012.0,16,18,-2
CZE,RUS,2006.0,13,11,2
ESP,USA,2015.0,537,298,239
PRT,FRA,2007.0,15,28,-13
GBR,JPN,2017.0,111,108,3
BEL,GBR,2019.0,128,133,-5
USA,CAN,2012.0,1348,1551,-203
GBR,GRC,2009.0,134,121,13
FRA,DZA,2017.0,91,34,57
IRL,GBR,2010.0,155,193,-38
PAK,MYS,2012.0,29,13,16
NLD,DEU,2009.0,201,224,-23
USA,CHN,2018.0,2736,2756,-20
BEL,GBR,2010.0,72,72,0
CAN,GBR,2016.0,361,308,53
BEL,FRA,2008.0,143,165,-22
FRA,BEL,2015.0,203,171,32
BRA,CHE,2005.0,12,15,-3
ISR,IND,2011.0,13,15,-2
HKG,CHN,2014.0,472,361,111
USA,VNM,2007.0,6,6,0
CHE,TUR,2020.0,14,18,-4
GBR,DEU,2006.0,273,484,-211
GBR,ESP,2012.0,247,283,-36
DEU,CAN,2013.0,162,185,-23
USA,CHE,2015.0,503,522,-19
JPN,FRA,2011.0,90,86,4
CHN,AUS,2022.0,178,265,-87
USA,ITA,2009.0,327,525,-198
IRL,ITA,2014.0,21,21,0
TUN,QAT,2020.0,11,2,9
HUN,NLD,2000.0,5,1,4
GBR,HRV,2009.0,7,3,4
GBR,MEX,2008.0,38,23,15
JPN,CHN,2004.0,331,176,155
ITA,CHN,2006.0,13,10,3
RUS,FRA,2014.0,60,47,13
NLD,GRC,2010.0,14,12,2
RUS,GEO,2013.0,5,1,4
ARG,USA,2009.0,94,80,14
TUR,FRA,2005.0,6,3,3
GRC,BRA,2014.0,2,2,0
USA,LKA,2005.0,10,8,2
FRA,DZA,2010.0,66,33,33
SAU,FRA,2008.0,3,3,0
USA,ARG,2006.0,74,122,-48
TWN,USA,2006.0,212,306,-94
FRA,IND,2009.0,39,70,-31
ARE,KWT,2006.0,2,1,1
ESP,SWE,2015.0,90,26,64
IRN,GBR,2016.0,48,36,12
TUR,SOM,2022.0,5,1,4
TWN,IND,2016.0,42,63,-21
CHL,VEN,2005.0,2,4,-2
EGY,DEU,2013.0,31,55,-24
IRN,CAN,2010.0,158,52,106
DEU,SWE,2002.0,58,83,-25
ISR,USA,1997.0,43,34,9
USA,DEU,1998.0,296,347,-51
NLD,MEX,2022.0,3,4,-1
AUT,CHE,2013.0,76,50,26
USA,HUN,1997.0,21,11,10
USA,SAU,2004.0,50,22,28
CHE,POL,2006.0,6,9,-3
SGP,MYS,2004.0,8,5,3
SVN,ESP,2020.0,6,2,4
CAN,TUR,2016.0,21,20,1
DEU,AUT,2018.0,349,298,51
DEU,NLD,2012.0,207,243,-36
DEU,SWE,2005.0,63,69,-6
BEL,GBR,2017.0,157,118,39
PAK,GBR,2016.0,33,88,-55
CHL,ISR,2004.0,1,3,-2
GBR,CAN,2008.0,292,311,-19
FRA,DZA,2019.0,108,51,57
CHN,HKG,2016.0,460,569,-109
ITA,USA,2020.0,487,376,111
NOR,GBR,2016.0,56,77,-21
MYS,NGA,2016.0,50,33,17
MYS,AUS,2020.0,82,82,0
USA,SWE,2022.0,90,70,20
IRN,CAN,2017.0,262,73,189
HKG,SWE,2014.0,8,1,7
PRT,BEL,2015.0,24,7,17
NLD,GRC,2019.0,25,29,-4
IRN,CAN,2019.0,345,60,285
AUS,FJI,2015.0,8,12,-4
LUX,AUS,2019.0,2,1,1
DNK,IND,2016.0,11,21,-10
ISR,USA,1998.0,62,94,-32
AUT,SWE,2012.0,19,10,9
ESP,NOR,2016.0,31,10,21
CHN,CHE,2016.0,59,39,20
BEL,GRC,2021.0,14,11,3
IND,GBR,2002.0,83,50,33
GBR,IRL,2004.0,134,106,28
GBR,JPN,2010.0,104,100,4
SAU,CAN,2013.0,35,85,-50
OMN,DEU,2019.0,3,2,1
FRA,CZE,2015.0,23,25,-2
ROU,AUT,2015.0,6,4,2
IRL,NLD,2017.0,16,13,3
DEU,RUS,2020.0,72,118,-46
IRL,GBR,2019.0,231,263,-32
RUS,KAZ,2017.0,27,33,-6
GBR,JPN,2019.0,126,105,21
USA,DEU,1997.0,196,195,1
CZE,SWE,2019.0,9,10,-1
CAN,SAU,2018.0,116,65,51
BOL,DNK,2018.0,1,1,0
RUS,KAZ,2019.0,44,22,22
SVN,USA,2016.0,19,14,5
NLD,FRA,2022.0,29,38,-9
ITA,JPN,2020.0,27,13,14
KOR,CAN,2008.0,36,31,5
GHA,CHN,2017.0,15,13,2
MEX,ARE,2021.0,2,1,1
IRL,NLD,2019.0,15,14,1
SGP,SWE,2021.0,15,6,9
NGA,BFA,2018.0,2,1,1
ESP,URY,2019.0,7,10,-3
CZE,CHE,2014.0,16,13,3
JPN,IDN,2009.0,70,10,60
CAN,HKG,2004.0,15,16,-1
FRA,HUN,2018.0,18,12,6
DNK,ESP,2017.0,26,55,-29
LKA,USA,2012.0,12,12,0
CHN,KAZ,2021.0,7,4,3
FRA,POL,2014.0,27,124,-97
POL,GBR,2021.0,39,49,-10
MYS,CHN,2015.0,18,6,12
RUS,NGA,2021.0,2,4,-2
KOR,JPN,2014.0,97,170,-73
ESP,URY,2017.0,15,7,8
CHN,GHA,2015.0,5,4,1
ISR,GBR,2022.0,27,24,3
COG,COD,2022.0,23,21,2
CHN,SDN,2021.0,7,7,0
CAN,DEU,2018.0,143,169,-26
GBR,UGA,2019.0,14,9,5
BHR,CAN,2006.0,2,1,1
CHN,ISR,2016.0,13,8,5
USA,KWT,2018.0,32,7,25
PHL,CAN,2020.0,5,5,0
ARE,EGY,2020.0,14,20,-6
ARG,CHE,2019.0,7,5,2
JOR,USA,2021.0,40,24,16
ZAF,GBR,1998.0,4,7,-3
LTU,ITA,2020.0,3,4,-1
TUR,BEL,2020.0,24,7,17
TZA,USA,2018.0,13,16,-3
ESP,PRY,2016.0,2,2,0
IRN,TUR,2022.0,25,7,18
HKG,TWN,2021.0,18,9,9
IRN,NZL,2020.0,23,5,18
CHE,FRA,2001.0,123,145,-22
MWI,GBR,2021.0,14,10,4
CAN,MYS,2010.0,9,9,0
TUN,FRA,2011.0,74,112,-38
NOR,IRN,2022.0,3,5,-2
GBR,IRN,2013.0,35,40,-5
DEU,EGY,2006.0,34,14,20
MOZ,ESP,2018.0,3,3,0
FIN,NLD,2014.0,15,17,-2
AUS,IRN,2022.0,12,47,-35
USA,BRA,2006.0,239,241,-2
KHM,JPN,2019.0,1,3,-2
CHL,FIN,2021.0,3,2,1
PRT,CAN,2021.0,10,2,8
SWE,GBR,2013.0,91,158,-67
KWT,USA,2002.0,10,6,4
JPN,LKA,2013.0,9,2,7
CHN,BRA,2008.0,4,4,0
BRA,MEX,2005.0,12,3,9
ARG,AUS,2012.0,5,2,3
RUS,BLR,2012.0,10,11,-1
ISR,ESP,2005.0,4,1,3
ITA,EGY,2018.0,10,8,2
GLP,FRA,2012.0,17,15,2
NGA,BEL,2020.0,3,2,1
FRA,SVK,2010.0,4,3,1
FRA,SGP,2021.0,24,17,7
SGP,FRA,2022.0,13,6,7
TWN,SGP,2009.0,10,4,6
KOR,VNM,2007.0,9,5,4
KAZ,GBR,2016.0,3,8,-5
COL,DEU,2007.0,10,3,7
CAN,MYS,2019.0,8,32,-24
NLD,PAK,2014.0,20,5,15
VNM,KOR,2006.0,2,5,-3
AUS,ZAF,2015.0,20,41,-21
CHN,FIN,2000.0,5,2,3
CAN,NOR,2016.0,16,11,5
NLD,ARE,2014.0,4,2,2
SWE,NOR,2008.0,58,29,29
TWN,CAN,2015.0,14,13,1
NGA,NZL,2009.0,2,1,1
NGA,IND,2009.0,2,2,0
IRN,BRA,2020.0,9,2,7
FIN,KOR,2015.0,3,3,0
FRA,TUR,2020.0,10,24,-14
GBR,SGP,2000.0,15,6,9
PAK,NLD,2012.0,9,6,3
DNK,IRL,2015.0,4,7,-3
CHE,SRB,2009.0,5,2,3
COL,AUT,2015.0,2,1,1
CHE,CHN,2012.0,36,32,4
AUS,JPN,1999.0,25,15,10
SAU,KOR,2010.0,1,13,-12
CHN,RUS,2001.0,9,6,3
JPN,AUT,2014.0,11,6,5
TUR,SAU,2017.0,12,7,5
AUT,CAN,2018.0,18,25,-7
CAN,FRA,2004.0,132,204,-72
USA,GHA,2019.0,38,37,1
NLD,BRA,2019.0,16,32,-16
BGD,CAN,2018.0,29,14,15
ITA,EST,2014.0,5,1,4
HKG,DEU,2016.0,10,8,2
FRA,LBN,2005.0,27,9,18
ITA,AUS,2005.0,17,23,-6
NOR,SGP,2019.0,1,3,-2
USA,IDN,2016.0,31,16,15
USA,NLD,2000.0,64,87,-23
BWA,USA,2007.0,8,4,4
CHL,ARG,2001.0,6,1,5
TUR,ITA,2001.0,3,3,0
IND,PRT,2009.0,13,6,7
PRT,ARG,2015.0,7,5,2
NLD,ESP,2006.0,45,29,16
BEL,CAN,2003.0,25,19,6
VNM,USA,2005.0,4,8,-4
SGP,USA,2000.0,24,17,7
CAN,GHA,2002.0,2,1,1
POL,CZE,1998.0,4,1,3
BEL,CHL,2001.0,2,1,1
DNK,ISR,2021.0,4,2,2
DEU,NER,2004.0,1,1,0
HUN,DEU,2009.0,37,23,14
HKG,PAK,2018.0,9,9,0
USA,PAK,2003.0,26,26,0
USA,PRT,2007.0,38,25,13
NZL,JPN,2005.0,6,4,2
JPN,DEU,2022.0,43,35,8
AUS,FIN,2022.0,10,1,9
CAN,ESP,2022.0,23,26,-3
IRN,MYS,2009.0,34,6,28
GRC,AUS,2021.0,3,7,-4
BEL,ROU,2019.0,8,5,3
GHA,CHN,2019.0,19,24,-5
IRQ,EGY,2018.0,1,5,-4
IND,POL,2021.0,24,13,11
SGP,QAT,2021.0,3,4,-1
JPN,NLD,2001.0,12,21,-9
CAN,URY,2021.0,1,2,-1
TUN,ESP,2020.0,8,7,1
BRA,CHL,2022.0,10,11,-1
CHE,ZAF,2012.0,12,8,4
KOR,BGD,2022.0,13,10,3
UKR,GEO,2019.0,1,1,0
UKR,POL,2022.0,10,8,2
GBR,TWN,2020.0,31,19,12
VNM,AUS,2021.0,37,40,-3
IND,NLD,2005.0,10,14,-4
BRA,ARG,2021.0,17,14,3
CMR,CAN,2017.0,2,1,1
NLD,BRA,2017.0,22,35,-13
SGP,ARE,2014.0,4,1,3
USA,GHA,2017.0,31,24,7
SWE,FRA,2020.0,57,91,-34
UGA,GBR,2006.0,1,4,-3
GBR,ARG,2012.0,18,11,7
USA,FRA,2000.0,138,253,-115
THA,FIN,2020.0,1,4,-3
CUB,MEX,2001.0,7,11,-4
BEL,ROU,2017.0,4,3,1
AUT,HUN,2014.0,9,18,-9
SVK,CZE,2006.0,28,24,4
TWN,PHL,2018.0,4,6,-2
ECU,BRA,2010.0,2,1,1
ITA,MAR,2008.0,1,1,0
FRA,THA,2015.0,21,8,13
ESP,CHL,2004.0,29,17,12
USA,GHA,2010.0,10,5,5
IND,LKA,2010.0,2,1,1
ZAF,NLD,2004.0,14,6,8
CIV,FRA,2008.0,16,27,-11
GBR,RUS,2011.0,24,33,-9
ESP,SGP,2015.0,9,4,5
CMR,FRA,2009.0,12,12,0
IND,DNK,2009.0,11,2,9
POL,BLR,2007.0,4,4,0
NLD,HUN,2017.0,10,7,3
DEU,NGA,2006.0,5,6,-1
TUR,GBR,2000.0,14,33,-19
FRA,EGY,2000.0,1,2,-1
PRT,USA,2001.0,33,27,6
DEU,MAR,2007.0,6,2,4
TZA,CHE,2013.0,1,2,-1
FRA,ARG,2002.0,11,27,-16
GBR,UGA,2010.0,6,9,-3
CHE,NLD,2001.0,28,25,3
RUS,ISR,2003.0,17,13,4
FRA,CHL,2002.0,21,15,6
DZA,FRA,2001.0,17,29,-12
MYS,FRA,2017.0,9,6,3
GBR,GHA,2011.0,18,4,14
USA,MAR,2015.0,3,3,0
QAT,EGY,2006.0,2,1,1
IND,NLD,2002.0,9,5,4
USA,TTO,2008.0,9,7,2
JOR,ARE,2000.0,4,2,2
FRA,JPN,2003.0,52,65,-13
KWT,EGY,2013.0,10,12,-2
JPN,RUS,2004.0,21,22,-1
NZL,JPN,2002.0,10,9,1
ZWE,NLD,2007.0,1,1,0
BWA,ZAF,2009.0,12,5,7
BEL,RUS,1999.0,4,5,-1
GBR,UGA,2017.0,11,7,4
ESP,URY,2010.0,18,5,13
GBR,JOR,2003.0,5,3,2
CZE,FIN,2002.0,2,2,0
IND,CAN,2000.0,25,5,20
CAN,PHL,2004.0,1,2,-1
UZB,CHN,2014.0,1,1,0
AUS,BEL,2005.0,5,7,-2
BRA,CHE,2002.0,7,7,0
ZAF,FRA,2007.0,6,9,-3
AUT,HRV,2003.0,3,3,0
SVK,SWE,2001.0,2,2,0
CAN,DNK,1998.0,6,4,2
CAN,FIN,1997.0,1,2,-1
USA,HUN,1998.0,18,21,-3
RUS,CHE,2022.0,10,6,4
CHE,JPN,1999.0,4,9,-5
ARE,JOR,2002.0,3,4,-1
UZB,MYS,2007.0,2,1,1
NZL,BEL,2018.0,3,9,-6
USA,SRB,2002.0,18,18,0
ITA,RUS,2013.0,14,18,-4
SWE,JPN,2015.0,17,27,-10
USA,UGA,2002.0,5,6,-1
USA,UGA,2005.0,9,8,1
POL,CZE,1997.0,2,2,0
SGP,HKG,2003.0,15,18,-3
SWE,CZE,2005.0,10,1,9
IRL,SWE,2011.0,11,7,4
FRA,GLP,2008.0,19,11,8
CAN,RUS,2012.0,10,22,-12
IND,IRL,2001.0,3,1,2
SAU,KOR,2019.0,10,31,-21
JPN,CZE,2009.0,8,11,-3
FIN,JPN,2004.0,7,2,5
DEU,NOR,1997.0,1,2,-1
BEL,AUS,2001.0,4,7,-3
AUS,MAC,2015.0,2,3,-1
TZA,ZAF,2016.0,5,8,-3
POL,ESP,2011.0,19,18,1
POL,JPN,2005.0,9,2,7
AUT,POL,2002.0,7,5,2
UGA,KEN,2021.0,5,4,1
NCL,FRA,2014.0,10,12,-2
IRN,DEU,2005.0,14,10,4
DEU,VNM,2006.0,6,3,3
FIN,DNK,2022.0,9,7,2
AUS,ARE,2009.0,12,6,6
FRA,COL,2008.0,12,4,8
NZL,CHE,2016.0,12,10,2
EGY,AUS,2009.0,1,3,-2
FRA,CHL,2005.0,19,12,7
NOR,FIN,2015.0,9,20,-11
GBR,SRB,2020.0,7,11,-4
FRA,CAF,2012.0,3,4,-1
CZE,SWE,2017.0,14,6,8
SDN,ZAF,2015.0,1,3,-2
IRN,FRA,2014.0,20,26,-6
THA,CAN,2015.0,10,18,-8
GBR,CRI,2011.0,2,2,0
JPN,TUR,2014.0,9,1,8
BEL,POL,2016.0,12,8,4
URY,MEX,2015.0,2,2,0
SAU,IDN,2017.0,4,1,3
SGP,TWN,2004.0,5,5,0
PAK,KWT,2018.0,1,1,0
NGA,NLD,2014.0,4,2,2
IDN,AUS,2013.0,7,49,-42
ISR,IRN,2011.0,3,1,2
NLD,CHL,2021.0,5,15,-10
BIH,SVN,2015.0,2,2,0
DNK,NLD,2021.0,32,25,7
GBR,TUN,2020.0,1,2,-1
CHE,IND,2003.0,7,14,-7
DEU,HKG,2020.0,6,21,-15
CZE,COL,2019.0,2,3,-1
AZE,RUS,2017.0,4,4,0
THA,PRT,2016.0,2,1,1
VEN,CAN,2012.0,3,2,1
ESP,KOR,2017.0,5,6,-1
BFA,CIV,2016.0,3,1,2
ITA,KEN,2014.0,2,4,-2
NOR,IND,2012.0,6,10,-4
JAM,TTO,2017.0,4,1,3
TZA,AUS,2019.0,2,1,1
EGY,SDN,2015.0,2,1,1
UKR,NLD,2016.0,5,1,4
IND,LKA,2019.0,6,1,5
GHA,NLD,2017.0,4,11,-7
SLV,USA,2014.0,2,1,1
ARE,CAN,2013.0,10,33,-23
AUT,IND,2015.0,12,9,3
FRA,ARG,2005.0,14,15,-1
CAN,ARE,2006.0,9,5,4
TUR,NLD,2003.0,11,2,9
HRV,SRB,2009.0,11,8,3
ITA,PRT,2004.0,7,5,2
CRI,USA,2001.0,5,2,3
BHR,IRL,2011.0,1,1,0
MKD,USA,2005.0,1,3,-2
NLD,HUN,2010.0,8,8,0
SRB,MNE,2012.0,8,1,7
SAU,SDN,2022.0,6,14,-8
CZE,ITA,2018.0,20,29,-9
IRN,PRT,2020.0,16,5,11
TUR,NGA,2020.0,7,2,5
PAK,DEU,2022.0,16,10,6
ECU,BRA,2019.0,5,20,-15
FRA,CYP,2017.0,5,1,4
GBR,THA,2000.0,6,4,2
FRA,BFA,2003.0,12,7,5
BRA,AGO,2014.0,4,1,3
BRA,CZE,2014.0,3,3,0
EGY,JPN,2018.0,21,44,-23
AUT,RUS,2021.0,7,9,-2
IND,GRC,2013.0,1,2,-1
ITA,BRA,2022.0,6,22,-16
TWN,GBR,2013.0,22,41,-19
PAN,BRA,2013.0,2,1,1
TWN,ESP,2014.0,3,3,0
NLD,SRB,2020.0,4,3,1
CMR,CAN,2010.0,3,2,1
SRB,NLD,2016.0,7,1,6
COG,UGA,2017.0,1,1,0
ECU,BRA,2017.0,6,8,-2
EGY,YEM,2016.0,4,2,2
DEU,PER,2019.0,5,10,-5
SWE,EGY,2020.0,2,1,1
TUR,KAZ,2021.0,2,4,-2
TWN,MNG,2017.0,3,2,1
CZE,CAN,2012.0,5,8,-3
AUT,SVN,2020.0,4,5,-1
NLD,SAU,2012.0,4,1,3
VNM,CAN,2018.0,5,5,0
CAN,NZL,2022.0,9,7,2
MEX,CUB,2012.0,12,17,-5
IRL,PAK,2015.0,6,7,-1
USA,JOR,1998.0,5,3,2
CAN,FIN,1998.0,2,5,-3
BGR,NLD,2000.0,2,1,1
EGY,BEL,2021.0,2,2,0
GEO,DEU,2013.0,5,1,4
USA,KHM,2015.0,3,7,-4
BRA,ITA,2000.0,13,17,-4
ESP,LUX,2020.0,9,5,4
PAK,CAN,2001.0,1,1,0
CAN,MYS,2017.0,6,31,-25
FRA,IDN,2006.0,6,2,4
DEU,TUN,2007.0,3,1,2
ARG,FIN,2005.0,1,1,0
CHE,ESP,2000.0,10,19,-9
DEU,THA,2003.0,5,4,1
USA,URY,2008.0,11,11,0
PRT,BGR,2011.0,2,2,0
UKR,JPN,2009.0,4,2,2
NLD,CZE,2008.0,6,5,1
CAN,BMU,2005.0,1,1,0
IRN,DEU,2002.0,6,9,-3
IRN,KOR,2011.0,6,5,1
HUN,ESP,2009.0,9,4,5
FRA,BGR,2008.0,9,4,5
BEL,IRL,2003.0,2,3,-1
CHN,ITA,2001.0,10,9,1
EST,DEU,2000.0,1,4,-3
GBR,COL,2007.0,8,5,3
FRA,MTQ,2010.0,15,16,-1
PHL,ITA,2008.0,2,1,1
GBR,MDG,2004.0,1,2,-1
HRV,ESP,2013.0,5,3,2
ARM,USA,2014.0,6,7,-1
ETH,IND,2009.0,7,5,2
IRL,AUT,2007.0,3,3,0
PRY,ESP,2014.0,3,1,2
BRA,MEX,2002.0,9,1,8
KWT,USA,2005.0,4,6,-2
ARG,CHE,2017.0,10,7,3
DNK,ZAF,2003.0,1,1,0
CZE,SWE,2010.0,3,3,0
AUS,BWA,2011.0,2,2,0
ZAF,BRA,2013.0,5,3,2
QAT,SGP,2021.0,4,3,1
COL,CHL,2005.0,5,7,-2
ZAF,BWA,2011.0,7,8,-1
RUS,ARM,2009.0,7,5,2
BEL,ROU,2010.0,8,5,3
IND,HRV,2016.0,1,1,0
ESP,UKR,2011.0,3,2,1
FIN,IRN,2011.0,8,6,2
HUN,ISR,2015.0,2,3,-1
GBR,ZWE,2013.0,6,3,3
AUT,NOR,2009.0,10,3,7
ITA,SVK,2008.0,2,3,-1
CAN,LBN,2020.0,4,20,-16
PHL,USA,2000.0,7,4,3
TZA,GBR,2000.0,3,2,1
URY,USA,2005.0,8,6,2
CHL,ITA,2012.0,6,5,1
EST,POL,2020.0,1,3,-2
POL,ROU,2017.0,1,3,-2
CAN,TUN,2004.0,5,2,3
THA,BEL,2009.0,1,1,0
SYR,USA,2009.0,4,2,2
AUS,QAT,2017.0,12,6,6
MYS,KOR,2008.0,3,1,2
IDN,CMR,2018.0,2,1,1
POL,IRN,2019.0,2,12,-10
IND,CHL,2022.0,5,4,1
ARE,RUS,2019.0,1,3,-2
TWN,ITA,2018.0,4,2,2
DEU,MEX,1999.0,11,4,7
BEL,NER,2015.0,3,1,2
DNK,PAK,2018.0,5,5,0
CHL,CUB,2017.0,3,10,-7
BEN,NGA,2013.0,3,1,2
HKG,MYS,2012.0,10,1,9
AUS,MEX,2007.0,3,5,-2
VEN,NOR,2017.0,1,1,0
MYS,ITA,2020.0,3,4,-1
CAN,THA,2006.0,11,13,-2
TUR,SAU,2019.0,8,9,-1
JPN,KHM,2021.0,4,2,2
FIN,DEU,2000.0,12,6,6
UKR,GBR,1998.0,5,8,-3
HKG,POL,2011.0,4,1,3
ETH,USA,2008.0,5,1,4
HKG,FRA,2020.0,5,6,-1
MYS,HKG,2011.0,2,3,-1
ROU,CHE,2011.0,3,2,1
SWE,BGR,2015.0,1,2,-1
NOR,MEX,2019.0,1,4,-3
POL,IRN,2017.0,1,4,-3
ESP,MYS,2018.0,5,1,4
COL,AUS,2008.0,2,1,1
SVK,IRL,2016.0,3,1,2
PRT,NLD,2013.0,20,15,5
IND,ESP,2015.0,13,16,-3
MYS,MMR,2014.0,2,1,1
OMN,DEU,2017.0,3,5,-2
ISL,ESP,2020.0,2,1,1
DEU,ARE,2022.0,3,1,2
MAR,BRA,2021.0,1,2,-1
SVK,SVN,2009.0,2,5,-3
CHE,HRV,2015.0,1,6,-5
SWE,RWA,2016.0,3,4,-1
GAB,BEN,2020.0,1,1,0
ARM,RUS,2016.0,2,3,-1
MLT,GBR,2022.0,2,4,-2
ZAF,SAU,2021.0,2,1,1
IND,LKA,2017.0,6,1,5
SAU,IDN,2019.0,4,2,2
BEL,RWA,2022.0,1,2,-1
RUS,ETH,2021.0,7,5,2
KEN,ETH,2020.0,8,1,7
TUR,SGP,2021.0,5,6,-1
DEU,SRB,2022.0,2,3,-1
AUS,QAT,2019.0,9,15,-6
JPN,FIN,2002.0,17,10,7
CAN,KEN,2012.0,4,2,2
EST,GBR,2008.0,6,5,1
BEL,KEN,2015.0,4,22,-18
CZE,TUN,2020.0,1,2,-1
GAB,FRA,2015.0,1,13,-12
POL,ZAF,2009.0,1,1,0
SWE,CZE,2002.0,5,3,2
CHL,DEU,2004.0,8,5,3
FRA,TTO,2013.0,1,1,0
ITA,ROU,2005.0,7,11,-4
COG,BFA,2019.0,1,2,-1
IND,CHE,2001.0,8,2,6
USA,LSO,2013.0,2,2,0
ISR,ESP,2002.0,5,3,2
NLD,ROU,2004.0,3,7,-4
AUS,SWE,2004.0,23,34,-11
NAM,BWA,2019.0,1,1,0
OMN,IRN,2016.0,2,1,1
USA,SRB,2005.0,14,8,6
IND,RUS,1999.0,1,3,-2
CAN,SWE,1997.0,3,1,2
POL,IND,2013.0,5,31,-26
PAK,SGP,2015.0,3,6,-3
MYS,FRA,2019.0,9,8,1
NZL,TWN,2019.0,4,1,3
THA,TWN,2008.0,3,2,1
NOR,TZA,2003.0,3,3,0
MEX,CHE,1998.0,1,1,0
SGP,ZAF,2007.0,1,2,-1
JPN,FIN,2005.0,8,8,0
USA,NPL,2004.0,6,4,2
CHN,IRL,2003.0,3,2,1
USA,GRD,2008.0,5,3,2
NLD,BRA,2010.0,12,16,-4
VNM,THA,2006.0,2,1,1
ALB,ITA,2006.0,1,2,-1
FIN,AUT,2011.0,10,6,4
LUX,ISL,2018.0,1,1,0
CHL,NOR,2016.0,1,1,0
ESP,KOR,2010.0,1,4,-3
MAR,ITA,2013.0,2,1,1
USA,MLI,2014.0,2,7,-5
SVN,ITA,2010.0,4,1,3
SAU,RUS,2020.0,3,6,-3
SWE,KEN,2013.0,3,2,1
IND,ZMB,2021.0,2,2,0
SRB,LBY,2016.0,3,1,2
EST,USA,2017.0,3,11,-8
AUT,DNK,2022.0,6,5,1
CMR,BEL,2016.0,1,2,-1
NZL,TWN,2017.0,2,6,-4
AND,ESP,2014.0,1,2,-1
FRA,CYP,2010.0,1,1,0
SWE,THA,2022.0,2,2,0
CAN,NGA,2016.0,3,7,-4
MAR,ESP,2004.0,8,3,5
CAN,POL,2009.0,11,11,0
EST,USA,2010.0,7,5,2
SVK,JPN,2000.0,4,1,3
POL,JPN,2002.0,5,12,-7
CAN,SWE,1998.0,5,5,0
MEX,CAN,1997.0,3,2,1
ARE,HUN,2004.0,1,3,-2
TUN,EGY,2010.0,1,1,0
DEU,NOR,1998.0,4,5,-1
CHN,NOR,2000.0,3,1,2
IND,FRA,2000.0,15,11,4
BGD,SWE,2022.0,4,1,3
NLD,ISR,2012.0,10,7,3
QAT,GBR,2014.0,2,32,-30
ERI,CHE,2020.0,1,1,0
SVN,DEU,1999.0,1,2,-1
PER,FRA,2015.0,2,8,-6
ETH,FRA,2019.0,2,4,-2
ARE,JOR,2005.0,3,4,-1
FIN,HUN,2007.0,5,4,1
GBR,OMN,2001.0,4,1,3
SAU,LBN,2020.0,3,5,-2
NOR,POL,2015.0,7,12,-5
RUS,AUT,2014.0,12,3,9
TUR,IRN,2006.0,1,1,0
IRL,POL,2012.0,2,5,-3
GBR,BRN,2006.0,2,1,1
TUN,CHE,2011.0,2,2,0
JPN,CMR,2018.0,1,2,-1
GEO,FRA,2014.0,5,5,0
ISR,FIN,2016.0,2,1,1
SDN,DEU,2016.0,1,1,0
DEU,PER,2017.0,2,6,-4
CAN,BMU,2002.0,1,1,0
MYS,FIN,2019.0,3,1,2
AGO,PRT,2014.0,2,3,-1
KHM,JPN,2017.0,2,3,-1
HKG,CHE,2018.0,6,5,1
ROU,HUN,2000.0,3,2,1
BHR,IND,2011.0,2,1,1
ZWE,COG,2020.0,1,1,0
TUR,ALB,2013.0,2,1,1
TZA,NLD,2007.0,2,1,1
COG,BFA,2017.0,1,1,0
CHE,TUN,2015.0,2,2,0
ESP,KOR,2019.0,4,10,-6
RUS,SGP,2015.0,2,4,-2
SWE,ETH,2015.0,3,1,2
CAN,DNK,1997.0,3,2,1
UKR,KAZ,2018.0,1,1,0
USA,BLR,2006.0,2,10,-8
FRA,SVK,2019.0,3,5,-2
NOR,SGP,2010.0,2,1,1
AUS,PAN,2014.0,1,1,0
ARG,BOL,2015.0,2,1,1
CHE,PHL,2012.0,4,1,3
LUX,ITA,2015.0,4,11,-7
GBR,PER,2004.0,1,2,-1
LUX,AUS,2017.0,2,2,0
AUS,ECU,2015.0,2,2,0
SAU,NZL,2014.0,2,4,-2
POL,GRC,2003.0,1,1,0
POL,CHN,2007.0,1,2,-1
COL,ARG,1998.0,1,6,-5
MYS,DNK,2002.0,1,2,-1
EGY,FIN,2016.0,2,5,-3
KOR,NGA,2010.0,1,1,0
GEO,ITA,2011.0,1,1,0
AUT,CHL,2020.0,2,5,-3
CMR,CHN,2014.0,1,1,0
ZAF,GBR,1997.0,3,5,-2
MYS,PHL,2014.0,1,1,0
FRA,PYF,2000.0,1,2,-1
FIN,NOR,2007.0,5,7,-2
ARG,FIN,2002.0,1,1,0
IND,TZA,2017.0,3,1,2
SVN,BEL,2007.0,1,1,0
PER,USA,2000.0,2,4,-2
SGP,ROU,2004.0,1,2,-1
CHN,PAK,2003.0,2,2,0
MEX,RUS,2008.0,3,4,-1
PRI,CHN,2016.0,3,1,2
SYR,DEU,2008.0,1,2,-1
AZE,RUS,2019.0,5,8,-3
COL,PER,2008.0,1,3,-2
CHN,UZB,2021.0,7,5,2
FRA,CYP,2019.0,4,1,3
HUN,DNK,2008.0,1,4,-3
CHE,COL,2012.0,1,3,-2
HRV,CHN,2018.0,1,1,0
CHE,MWI,2012.0,1,1,0
SLE,GBR,2016.0,1,2,-1
KOR,ISR,2012.0,3,3,0
AUT,POL,2005.0,3,4,-1
DEU,GHA,2009.0,3,1,2
BGD,THA,2016.0,2,5,-3
ISR,SGP,2020.0,2,7,-5
NAM,UGA,2021.0,2,1,1
ITA,MLT,2014.0,1,1,0
DZA,SAU,1999.0,1,1,0
IND,PAK,2000.0,1,2,-1
AZE,RUS,2010.0,3,4,-1
SAU,ZAF,2015.0,3,6,-3
JPN,PRT,2010.0,1,3,-2
CHL,JPN,2007.0,1,3,-2
VNM,USA,2002.0,3,3,0
MEX,IND,2003.0,2,5,-3
JAM,GBR,2015.0,1,2,-1
USA,GAB,2020.0,3,2,1
BEL,CHN,1999.0,1,3,-2
TUR,SAU,2010.0,3,2,1
PHL,HKG,2018.0,3,2,1
MAC,AUS,2007.0,1,2,-1
ARG,CUB,2003.0,1,1,0
BRA,MOZ,2009.0,1,3,-2
SDN,QAT,2020.0,2,1,1
DEU,LIE,2006.0,2,3,-1
PAK,AZE,2020.0,1,1,0
ECU,CRI,2020.0,2,1,1
ITA,SMR,2020.0,2,2,0
QAT,IND,2022.0,3,3,0
PYF,AUS,2017.0,1,1,0
NLD,QAT,2022.0,2,2,0
IRQ,POL,2020.0,1,1,0
EGY,GBR,2004.0,6,20,-14
ARE,CHN,2012.0,1,1,0
NPL,KEN,2019.0,1,1,0
BRA,LTU,2018.0,1,1,0
CHE,HKG,2008.0,5,1,4
TWN,ZAF,2013.0,1,7,-6
BGD,DEU,2020.0,5,12,-7
KWT,BHR,2013.0,1,1,0
FRA,KEN,2002.0,1,1,0
NGA,RUS,2017.0,3,3,0
ARG,CZE,2019.0,3,2,1
DNK,HUN,2000.0,1,1,0
CUB,ARG,2015.0,2,4,-2
HUN,JPN,1998.0,2,2,0
ARE,RUS,2017.0,1,3,-2
ETH,ZAF,2003.0,2,2,0
USA,NCL,2015.0,1,1,0
BRA,CUB,2001.0,3,4,-1
FRA,KEN,2005.0,1,1,0
DEU,PER,2010.0,2,1,1
DNK,SVN,2014.0,1,1,0
UGA,NLD,2011.0,1,3,-2
IDN,CHE,2012.0,1,2,-1
GRC,ZAF,2018.0,3,1,2
MEX,CAN,1998.0,3,3,0
POL,MEX,2009.0,3,4,-1
TWN,RUS,2016.0,1,2,-1
ARG,VEN,2017.0,1,1,0
FRA,SVN,2008.0,1,3,-2
RUS,HKG,2002.0,2,2,0
CAN,OMN,2007.0,3,1,2
USA,SLV,2018.0,1,2,-1
THA,POL,2013.0,2,1,1
TZA,JPN,2013.0,2,2,0
ZAF,MWI,2014.0,3,9,-6
CZE,NOR,2007.0,1,1,0
AUS,KEN,2011.0,2,5,-3
DNK,EGY,2004.0,1,2,-1
ITA,CUB,2011.0,2,3,-1
TUR,NOR,2011.0,2,2,0
SWE,HUN,2022.0,2,2,0
SVK,AUS,2016.0,1,1,0
USA,BGD,2000.0,1,3,-2
JPN,CHL,2022.0,2,3,-1
FRA,SVK,2017.0,3,3,0
NOR,RUS,2022.0,3,3,0
MDA,DEU,2012.0,3,2,1
SVN,SWE,2018.0,1,1,0
COL,BEL,2002.0,1,1,0
CHE,SEN,2020.0,3,3,0
CHN,BGD,2015.0,5,9,-4
MAR,ZAF,2022.0,2,1,1
BEL,NGA,2014.0,1,3,-2
HRV,FRA,2021.0,3,4,-1
JPN,SAU,2022.0,1,2,-1
EST,RUS,2003.0,1,1,0
MAR,DZA,2011.0,1,1,0
QAT,CAN,2009.0,1,9,-8
EGY,LBN,2013.0,3,3,0
UKR,ISR,2016.0,3,1,2
NLD,KAZ,2013.0,1,2,-1
SWE,ARE,2009.0,2,1,1
KEN,IND,2020.0,2,1,1
MMR,USA,2021.0,1,6,-5
IRL,NGA,2015.0,2,2,0
DEU,MNG,2016.0,1,1,0
GBR,PSE,2004.0,1,1,0
HRV,ITA,2012.0,3,7,-4
ARE,AUT,2013.0,1,2,-1
NGA,SAU,2009.0,1,1,0
PAK,HKG,2011.0,1,2,-1
MYS,BHR,2022.0,1,1,0
VNM,TWN,2009.0,2,1,1
NOR,MEX,2010.0,1,2,-1
CHE,PAN,2017.0,1,1,0
ARG,PER,2014.0,3,4,-1
SAU,TUR,2007.0,1,2,-1
JPN,ETH,2003.0,1,2,-1
GUY,FRA,2003.0,1,1,0
ITA,TWN,2011.0,2,2,0
ZAF,COL,2006.0,1,1,0
CHL,ECU,2009.0,2,1,1
CAN,HRV,2007.0,1,3,-2
ROU,FIN,2007.0,1,1,0
PRT,HUN,2022.0,1,1,0
MKD,DEU,2003.0,1,1,0
ETH,FRA,2017.0,1,3,-2
ITA,UKR,2006.0,1,1,0
KAZ,TUR,2012.0,1,1,0
CHE,PAN,2019.0,2,1,1
FRA,PHL,2013.0,1,1,0
TZA,FIN,2013.0,1,2,-1
HKG,FIN,2013.0,1,1,0
ARG,JPN,2022.0,2,1,1
MLT,GRC,2021.0,2,2,0
BHR,EGY,2015.0,2,3,-1
AUT,NZL,2009.0,2,2,0
TWN,MNG,2010.0,1,2,-1
LAO,USA,2014.0,1,3,-2
AUS,BLR,2016.0,1,1,0
SGP,IDN,2008.0,1,2,-1
HRV,BIH,2022.0,1,1,0
FRA,BRB,2019.0,1,1,0
USA,JOR,1997.0,2,1,1
DNK,FIN,2000.0,2,4,-2
BGD,HKG,2009.0,1,1,0
RUS,PAK,2011.0,1,2,-1
NGA,GMB,2012.0,2,1,1
TZA,FRA,2011.0,1,1,0
CZE,KAZ,2015.0,1,1,0
OMN,TUN,2018.0,1,3,-2
PER,PRT,2015.0,1,3,-2
OMN,ARE,2010.0,2,1,1
CYP,AUS,2011.0,1,4,-3
SRB,TUR,2015.0,1,5,-4
THA,DNK,2018.0,1,3,-2
EGY,DNK,1998.0,1,2,-1
CHE,LVA,2016.0,1,1,0
GRC,CHN,2006.0,1,1,0
LTU,FIN,2006.0,1,2,-1
KGZ,DEU,2016.0,1,2,-1
PAK,ARE,2003.0,1,1,0
VNM,RUS,2012.0,1,6,-5
ARE,LBN,2013.0,1,1,0
CHL,DNK,2022.0,1,2,-1
CZE,BGR,2020.0,1,1,0
ZWE,GBR,1998.0,1,2,-1
CMR,COG,2018.0,1,1,0
FRA,USA,2008.0,672,584,88
SWE,CHN,2020.0,91,89,2
GBR,TUR,2001.0,40,16,24
SDN,USA,2001.0,1,2,-1
IND,GBR,2005.0,102,75,27
USA,JPN,2004.0,905,1149,-244
GBR,NLD,1998.0,46,31,15
GRC,USA,2009.0,97,109,-12
NLD,AUS,2015.0,83,52,31
HKG,AUS,2006.0,36,24,12
MYS,GBR,2012.0,55,155,-100
PSE,USA,2015.0,5,4,1
BEL,ITA,2021.0,65,71,-6
IRL,GBR,2017.0,237,184,53
SAU,KOR,2017.0,12,26,-14
DEU,PRT,2016.0,31,42,-11
JPN,AUS,2014.0,56,37,19
IRN,USA,2022.0,169,43,126
AUS,NZL,2004.0,64,89,-25
SWE,DNK,2021.0,58,59,-1
GEO,USA,2020.0,13,14,-1
JPN,DNK,2009.0,12,9,3
USA,HKG,2008.0,100,124,-24
DEU,NZL,2014.0,31,30,1
KOR,TUR,2021.0,4,2,2
BEL,CHE,2021.0,44,42,2
ITA,FRA,2022.0,118,130,-12
MYS,SGP,2020.0,28,17,11
IDN,USA,2021.0,23,21,2
OMN,ARE,2019.0,11,2,9
USA,MOZ,2020.0,6,2,4
HRV,DEU,2021.0,6,4,2
MEX,ESP,2012.0,78,120,-42
FRA,MTQ,2019.0,16,30,-14
ESP,NLD,2014.0,106,63,43
ARM,POL,2011.0,1,1,0
EST,USA,2019.0,9,13,-4
USA,MKD,2004.0,1,3,-2
IRN,SWE,2016.0,27,20,7
GBR,TZA,2008.0,7,5,2
QAT,FRA,2021.0,10,9,1
DNK,ESP,2010.0,13,21,-8
IND,AFG,2019.0,3,1,2
ITA,CMR,2020.0,4,1,3
MAR,FRA,2000.0,19,22,-3
ISR,GRC,2006.0,3,1,2
USA,SVK,2014.0,14,15,-1
GBR,FIN,2008.0,33,42,-9
KOR,ITA,2016.0,14,10,4
ITA,SWE,2006.0,19,22,-3
URY,USA,2002.0,8,5,3
ITA,ROU,2002.0,2,7,-5
FRA,LBN,2002.0,17,8,9
SGP,NLD,2008.0,4,7,-3
AUS,BEL,2002.0,7,15,-8
FRA,TUN,2000.0,22,7,15
VNM,DEU,2006.0,3,6,-3
POL,UKR,2011.0,9,11,-2
FRA,ROU,2006.0,22,20,2
CZE,FRA,2007.0,12,12,0
DEU,HUN,2020.0,29,45,-16
BGR,ESP,2008.0,4,3,1
ITA,AUS,2002.0,14,15,-1
ITA,TUR,2007.0,4,5,-1
PHL,IND,2008.0,4,4,0
CHN,POL,2005.0,1,1,0
DEU,SGP,2003.0,11,3,8
USA,AUT,2000.0,28,34,-6
ESP,NZL,2002.0,3,1,2
FRA,TWN,2003.0,3,4,-1
AUT,FIN,2012.0,9,4,5
CHE,BEL,2018.0,44,64,-20
GBR,LUX,2018.0,12,5,7
AUS,RUS,2015.0,9,12,-3
GBR,ISR,2022.0,24,27,-3
CRI,MEX,2020.0,3,3,0
NZL,FIN,2018.0,3,3,0
FRA,LUX,2022.0,10,7,3
CHL,CUB,2010.0,2,8,-6
SVK,BEL,2015.0,4,2,2
KWT,AUS,2022.0,2,4,-2
ESP,IND,2018.0,11,21,-10
FIN,LVA,2019.0,1,1,0
SVN,ITA,2019.0,5,11,-6
NGA,RUS,2019.0,3,3,0
EGY,ITA,2018.0,8,10,-2
LBN,GBR,2020.0,13,6,7
GHA,USA,2018.0,22,28,-6
DZA,CAN,2002.0,4,1,3
GHA,ZAF,2011.0,6,3,3
DEU,GRC,2003.0,28,28,0
IRL,NLD,2010.0,12,9,3
PRT,AUS,2020.0,8,7,1
FRA,MTQ,2017.0,18,22,-4
CAN,ITA,2007.0,31,47,-16
ETH,NOR,2008.0,2,5,-3
NOR,ITA,2022.0,9,16,-7
LTU,SWE,2016.0,6,5,1
SLE,NGA,2019.0,2,1,1
IND,ETH,2007.0,9,2,7
FRA,MOZ,2004.0,3,1,2
FRA,MLI,2016.0,7,2,5
BOL,BRA,2013.0,1,1,0
ETH,COG,2019.0,1,1,0
AUT,ETH,2015.0,2,1,1
AZE,USA,2004.0,1,2,-1
TUR,GRC,2012.0,2,3,-1
BEL,BEN,2013.0,1,2,-1
SRB,GBR,2021.0,5,3,2
PAK,QAT,2006.0,1,1,0
IRN,FIN,2022.0,18,5,13
ZAF,ARG,2013.0,1,1,0
JAM,TTO,2019.0,4,2,2
MEX,VEN,2016.0,3,7,-4
IND,MAR,2015.0,3,1,2
TWN,SAU,2020.0,6,7,-1
CMR,CAN,2019.0,2,2,0
RUS,KAZ,2010.0,6,3,3
SVK,ITA,2011.0,4,1,3
TWN,IRN,2020.0,1,6,-5
ZAF,OMN,2022.0,1,1,0
CHE,SGP,2006.0,8,3,5
UKR,BEL,2006.0,2,1,1
CAF,FRA,2014.0,3,3,0
USA,PSE,2003.0,3,1,2
SVK,ISR,2001.0,1,1,0
NZL,IRL,2009.0,4,6,-2
FRA,GEO,2005.0,1,1,0
MYS,FIN,2017.0,1,1,0
BRA,THA,2020.0,1,1,0
AUT,ARG,2001.0,1,3,-2
MYS,SWE,2014.0,4,4,0
TUR,FRA,2002.0,4,5,-1
GBR,VNM,2000.0,1,1,0
BEN,GBR,2021.0,1,1,0
ISL,DNK,2008.0,2,4,-2
BGD,NZL,2012.0,1,1,0
USA,CUB,2006.0,4,3,1
BFA,CMR,2015.0,1,1,0
BEN,SEN,2020.0,1,2,-1
NLD,MYS,2007.0,3,1,2
HKG,LKA,2022.0,1,2,-1
EGY,FRA,2022.0,5,7,-2
ARE,TUR,2007.0,1,3,-2
PNG,GBR,2007.0,1,2,-1
THA,JPN,2000.0,3,8,-5
AUT,SVK,2000.0,2,4,-2
USA,HND,2016.0,2,4,-2
CAN,BLR,2003.0,2,1,1
CAN,HUN,2018.0,4,3,1
KEN,SWE,2001.0,1,2,-1
CAN,TTO,2011.0,3,1,2
HUN,CHN,2009.0,2,1,1
RUS,MEX,2012.0,4,2,2
JAM,TTO,2010.0,3,3,0
SWE,VNM,2005.0,1,2,-1
LUX,BEL,2009.0,3,6,-3
ARG,SGP,2016.0,2,1,1
KAZ,FRA,2016.0,1,1,0
QAT,CHN,2021.0,4,1,3
HUN,SRB,2012.0,1,2,-1
SRB,GRC,2015.0,2,1,1
IND,TZA,2019.0,1,2,-1
CAN,MLT,2013.0,2,1,1
GTM,COL,2013.0,1,3,-2
HUN,SVK,2012.0,4,3,1
SAU,NGA,2022.0,1,6,-5
IND,KEN,2016.0,1,2,-1
USA,LKA,2002.0,3,2,1
FIN,LUX,2020.0,3,1,2
IDN,SGP,2013.0,1,8,-7
HKG,IDN,2022.0,3,2,1
SVN,ITA,2017.0,4,10,-6
DNK,BGR,2012.0,1,2,-1
GRC,SWE,2001.0,1,2,-1
ARG,NLD,2021.0,2,1,1
AGO,BRA,2015.0,1,1,0
MAR,USA,2022.0,2,2,0
BEL,SEN,2016.0,1,2,-1
UGA,NAM,2021.0,1,2,-1
COL,CHL,2002.0,1,1,0
PHL,KEN,2016.0,1,1,0
CHN,POL,2002.0,1,3,-2
RUS,AZE,2021.0,1,5,-4
USA,SWZ,2013.0,1,1,0
IRQ,JOR,2007.0,3,1,2
POL,SGP,2018.0,1,2,-1
SAU,AUT,2016.0,1,3,-2
RUS,,2011.0,3918,0,3918
GBR,,2011.0,10634,0,10634
UZB,,2009.0,55,0,55
REU,,2011.0,5,0,5
FIN,,2010.0,1118,0,1118
,HKG,2001.0,1447,0,1447
BEL,,2023.0,12477,0,12477
,KGZ,2003.0,14,0,14
HRV,,2023.0,4808,0,4808
,ZAF,2002.0,1484,0,1484
ESP,,2020.0,14236,0,14236
,COL,2013.0,2092,0,2092
,DZA,2004.0,759,0,759
,MEX,1998.0,3036,0,3036
,ISR,2001.0,2637,0,2637
,GRC,1994.0,1276,0,1276
GHA,,2022.0,752,0,752
,DZA,1996.0,93,0,93
OMN,,2022.0,307,0,307
FIN,,2019.0,2141,0,2141
GRC,,2013.0,1524,0,1524
TUR,PSE,2008.0,2,0,2
,SWE,2003.0,3714,0,3714
,CAN,2006.0,11041,0,11041
FIN,,2017.0,1693,0,1693
,KOR,2010.0,15017,0,15017
,USA,2015.0,91607,0,91607
ISL,,2020.0,148,0,148
ISR,,2004.0,639,0,639
BWA,,2002.0,4,0,4
,MEX,1997.0,1638,0,1638
POL,,2011.0,2139,0,2139
,UKR,2009.0,1317,0,1317
,NOR,2006.0,1699,0,1699
AUT,,2021.0,3553,0,3553
QAT,,2021.0,264,0,264
GAB,,2021.0,53,0,53
,KOR,2017.0,15984,0,15984
ARG,,2016.0,1450,0,1450
MNG,,2010.0,16,0,16
AZE,,2023.0,695,0,695
ETH,,2010.0,46,0,46
MDG,,2013.0,30,0,30
CMR,,2023.0,1376,0,1376
MWI,NOR,2013.0,1,0,1
,BFA,2006.0,90,0,90
,BGD,2001.0,304,0,304
ARM,,2024.0,639,0,639
NZL,,2007.0,459,0,459
,ZAF,2005.0,1463,0,1463
LKA,,2020.0,255,0,255
NGA,,2018.0,949,0,949
IRL,,2004.0,229,0,229
ZAF,,2006.0,379,0,379
CHL,ZAF,2006.0,1,0,1
,VEN,2011.0,347,0,347
SVK,,2020.0,980,0,980
HUN,,2000.0,48,0,48
,VNM,2010.0,640,0,640
,VUT,2004.0,2,0,2
,VNM,2017.0,2367,0,2367
ZWE,MEX,2013.0,1,0,1
,TUR,2011.0,7725,0,7725
,ZMB,2001.0,29,0,29
,PHL,2010.0,381,0,381
,ARE,2014.0,395,0,395
,KWT,2011.0,160,0,160
FJI,,2014.0,7,0,7
PRI,,2022.0,266,0,266
SDN,,2015.0,69,0,69
TCD,,2023.0,44,0,44
,FIN,1995.0,1842,0,1842
ETH,,2017.0,140,0,140
,FJI,2009.0,24,0,24
MAR,ROU,2016.0,2,0,2
,YEM,2010.0,45,0,45
,GMB,2011.0,19,0,19
PAK,,2006.0,181,0,181
MNG,,2017.0,33,0,33
USA,,2025.0,176,0,176
,MLT,2005.0,31,0,31
CZE,COL,2017.0,2,0,2
ETH,,2019.0,280,0,280
,SDN,2011.0,107,0,107
,NER,2012.0,30,0,30
NLD,,2003.0,955,0,955
,ETH,2006.0,221,0,221
,CYP,2000.0,66,0,66
,KOR,2019.0,10338,0,10338
,CUB,2009.0,766,0,766
,PHL,2017.0,755,0,755
,JOR,2009.0,451,0,451
TUN,KOR,2015.0,3,0,3
MNG,,2019.0,51,0,51
,PER,2014.0,569,0,569
CRI,AUT,2021.0,2,0,2
SVN,UZB,2012.0,1,0,1
CMR,PRT,2019.0,1,0,1
,PRI,2014.0,109,0,109
SEN,NER,2019.0,1,0,1
AUS,MUS,2016.0,1,0,1
,VNM,2019.0,1396,0,1396
,LVA,2016.0,232,0,232
,YEM,2017.0,39,0,39
,LUX,2008.0,87,0,87
,PHL,2019.0,390,0,390
ARE,,2025.0,13,0,13
,BOL,2018.0,58,0,58
,SYC,2013.0,10,0,10
CRI,,2015.0,58,0,58
KGZ,PAK,2015.0,1,0,1
SWE,LUX,2013.0,3,0,3
,UZB,1994.0,246,0,246
SWE,BOL,2012.0,2,0,2
BRN,NPL,2020.0,1,0,1
BHR,,2014.0,21,0,21
,GIN,2006.0,9,0,9
GMB,AUS,2021.0,1,0,1
SAU,,2000.0,19,0,19
JAM,,2011.0,24,0,24
,MOZ,2011.0,38,0,38
,BHS,2011.0,10,0,10
LSO,,2010.0,4,0,4
FIN,LVA,2017.0,2,0,2
JPN,LAO,2008.0,1,0,1
ESP,SVK,1998.0,2,0,2
VNM,EGY,2020.0,1,0,1
,ISL,2001.0,109,0,109
BTN,,2020.0,14,0,14
SLB,,2023.0,21,0,21
FRA,IRN,2000.0,2,0,2
CHL,PAN,2019.0,1,0,1
NZL,TWN,2010.0,2,0,2
IRN,ISL,2018.0,1,0,1
ITA,URY,2004.0,1,0,1
,NCL,2007.0,19,0,19
,ZWE,2009.0,90,0,90
UGA,,2007.0,12,0,12
NER,CHE,2004.0,1,0,1
,PNG,2003.0,20,0,20
BLR,,2007.0,138,0,138
TUR,SDN,2014.0,1,0,1
IRL,LUX,2019.0,1,0,1
ISR,NOR,2007.0,1,0,1
DZA,,2003.0,13,0,13
,PYF,1998.0,29,0,29
NLD,CMR,2004.0,1,0,1
NLD,BEN,2008.0,2,0,2
YEM,USA,2013.0,1,0,1
NGA,ITA,2009.0,3,0,3
,GTM,1997.0,2,0,2
NLD,BRN,2011.0,1,0,1
IDN,SRB,1999.0,1,0,1
CAN,UGA,2003.0,1,0,1
GBR,KHM,2011.0,2,0,2
UKR,TUR,2012.0,1,0,1
CAF,,2006.0,6,0,6
ISR,CZE,2004.0,3,0,3
BRB,ZAF,2007.0,1,0,1
FRA,BHR,2007.0,1,0,1
CHE,ECU,2003.0,1,0,1
MEX,ROU,2003.0,1,0,1
,HND,2001.0,7,0,7
KWT,IRN,2020.0,1,0,1
UKR,CAN,2002.0,5,0,5
UKR,CZE,2001.0,1,0,1
MOZ,CHE,2007.0,1,0,1
HUN,NOR,1998.0,1,0,1
SLV,CAN,2003.0,1,0,1
AUS,QAT,2010.0,6,0,6
MUS,,2013.0,10,0,10
MYS,QAT,2005.0,2,0,2
NPL,,2003.0,6,0,6
UKR,CAN,2005.0,7,0,7
JOR,OMN,2013.0,6,0,6
NLD,SDN,2007.0,1,0,1
BHR,FRA,2021.0,1,0,1
AFG,IND,2011.0,1,0,1
,BRB,2000.0,8,0,8
,PSE,2007.0,43,0,43
BRN,,2003.0,5,0,5
COL,GRC,2012.0,1,0,1
,MUS,2007.0,25,0,25
ESP,ARE,2015.0,9,0,9
PNG,,2015.0,21,0,21
IRL,LUX,2017.0,2,0,2
MEX,PER,2006.0,3,0,3
SEN,TCD,2020.0,1,0,1
CAN,LTU,2013.0,1,0,1
RUS,SVN,2004.0,3,0,3
MAC,TUR,2020.0,1,0,1
SYR,ISR,2017.0,1,0,1
NOR,SGP,2017.0,2,0,2
,CAF,2009.0,6,0,6
UKR,FIN,2006.0,4,0,4
CHN,ISL,2009.0,1,0,1
GMB,DEU,2019.0,1,0,1
DNK,IDN,2021.0,1,0,1
AZE,DEU,2020.0,3,0,3
GBR,TCD,2019.0,2,0,2
IRN,TUN,2020.0,1,0,1
ITA,PRK,2019.0,1,0,1
GBR,MLI,2016.0,10,0,10
CMR,MDG,2013.0,1,0,1
,MLT,2002.0,27,0,27
SYR,,2013.0,48,0,48
AUS,MLI,2006.0,1,0,1
ERI,NAM,2018.0,1,0,1
IRL,ZAF,2000.0,2,0,2
FIN,LVA,2010.0,2,0,2
NGA,MYS,1997.0,1,0,1
TUR,LUX,2010.0,1,0,1
DEU,RWA,2013.0,1,0,1
,BTN,2011.0,17,0,17
TWN,AUT,2015.0,1,0,1
LBN,HUN,2017.0,1,0,1
CHN,QAT,2011.0,2,0,2
CHL,PAN,2010.0,1,0,1
ZAF,PER,2015.0,1,0,1
NZL,LUX,2014.0,2,0,2
SWE,PER,2020.0,2,0,2
CRI,ISR,2015.0,1,0,1
,GTM,1998.0,9,0,9
LUX,DNK,2012.0,1,0,1
KHM,CHN,2020.0,1,0,1
TUR,EGY,2016.0,2,0,2
TZA,AUS,2017.0,3,0,3
JPN,PRT,2019.0,3,0,3
WLF,,2021.0,1,0,1
MAR,SGP,2014.0,1,0,1
NIC,,2015.0,16,0,16
AUT,CYP,2005.0,1,0,1
BWA,MWI,2008.0,2,0,2
BWA,,2005.0,7,0,7
LSO,,2019.0,5,0,5
JPN,SDN,2005.0,3,0,3
CHL,PER,2005.0,5,0,5
SWE,VNM,2002.0,5,0,5
CHN,PHL,2000.0,1,0,1
DOM,MEX,2003.0,1,0,1
SYR,CYP,2001.0,1,0,1
ARG,CRI,2004.0,1,0,1
RUS,EST,2001.0,4,0,4
KOR,OMN,2016.0,3,0,3
,MHL,2006.0,1,0,1
GRC,SGP,2012.0,1,0,1
CHN,HUN,2007.0,1,0,1
CHE,ISL,2020.0,3,0,3
,AND,2004.0,2,0,2
TUN,POL,2013.0,2,0,2
NLD,ETH,2007.0,3,0,3
GRC,HUN,2016.0,3,0,3
NLD,JOR,2010.0,1,0,1
,AFG,2001.0,5,0,5
,GRL,2009.0,4,0,4
FRA,JAM,2013.0,1,0,1
SYC,,2010.0,3,0,3
IDN,NZL,2013.0,3,0,3
COG,UGA,2019.0,1,0,1
,PRK,2011.0,4,0,4
CUB,CAN,2018.0,12,0,12
ARE,GRC,2011.0,1,0,1
EGY,IRQ,2014.0,3,0,3
TUR,ARG,2020.0,1,0,1
POL,ETH,2018.0,1,0,1
NGA,IRL,2018.0,1,0,1
IND,TZA,2010.0,1,0,1
TLS,,2024.0,11,0,11
ZAF,TZA,2003.0,2,0,2
HTI,,2013.0,5,0,5
SYC,,2017.0,1,0,1
MYS,PRT,2021.0,2,0,2
KEN,EGY,2013.0,1,0,1
SMR,,2020.0,3,0,3
DZA,CAN,2005.0,4,0,4
GBR,PAN,2002.0,2,0,2
,FSM,1998.0,3,0,3
CZE,ARM,2009.0,1,0,1
FSM,USA,2009.0,1,0,1
IDN,CHN,1999.0,1,0,1
POL,ZWE,2014.0,1,0,1
FSM,AUS,2003.0,1,0,1
HUN,LUX,2017.0,1,0,1
IRN,YEM,2014.0,1,0,1
MKD,AUS,2016.0,1,0,1
SEN,NER,2017.0,1,0,1
SRB,DOM,2017.0,1,0,1
UKR,NOR,2020.0,2,0,2
VGB,,2024.0,5,0,5
HUN,UKR,2013.0,1,0,1
MLI,CIV,2003.0,1,0,1
ETH,EGY,2009.0,1,0,1
GMB,MLI,2007.0,1,0,1
FLK,NZL,2016.0,1,0,1
DNK,BFA,2021.0,1,0,1
CHN,IRQ,2009.0,4,0,4
UKR,SGP,2011.0,1,0,1
OMN,ARE,2017.0,9,0,9
PYF,,2016.0,11,0,11
SYR,TUR,2016.0,3,0,3
JPN,SDN,2002.0,1,0,1
OMN,ARG,2016.0,1,0,1
ESP,ISL,2021.0,1,0,1
CZE,NLD,2001.0,8,0,8
NLD,MLT,2015.0,1,0,1
BEN,TZA,2011.0,1,0,1
CZE,MEX,2003.0,1,0,1
GRC,UKR,2015.0,1,0,1
COG,ZAF,2020.0,1,0,1
PNG,USA,2008.0,3,0,3
TWN,MYS,2005.0,1,0,1
HUN,NOR,1997.0,1,0,1
,TCD,2000.0,2,0,2
GTM,,2009.0,3,0,3
JPN,QAT,2014.0,3,0,3
CHN,BDI,2008.0,1,0,1
NGA,SWZ,2009.0,2,0,2
JOR,IRL,2012.0,1,0,1
CHN,BWA,2014.0,1,0,1
AUS,SDN,2016.0,1,0,1
HRV,FLK,2020.0,1,0,1
BRA,IRL,2006.0,2,0,2
GBR,TCD,2017.0,2,0,2
GEO,SWE,2012.0,1,0,1
GBR,BOL,2003.0,2,0,2
CIV,BFA,2018.0,2,0,2
MMR,MYS,2021.0,2,0,2
BGD,OMN,2004.0,1,0,1
SVK,CAN,2000.0,1,0,1
RWA,COD,2022.0,1,0,1
NZL,EGY,2013.0,1,0,1
MYS,ESP,2008.0,1,0,1
JPN,ZMB,1998.0,1,0,1
COD,BEL,1999.0,1,0,1
IRL,TTO,2003.0,1,0,1
DEU,BFA,2003.0,1,0,1
AUT,LKA,2003.0,1,0,1
JPN,EST,2021.0,3,0,3
SYR,IRL,2022.0,1,0,1
LVA,POL,2000.0,1,0,1
PHL,TWN,2003.0,1,0,1
LSO,,2017.0,5,0,5
FRA,HRV,2008.0,2,0,2
SLE,USA,2003.0,1,0,1
BEN,THA,2013.0,1,0,1
ESP,PSE,2012.0,2,0,2
RUS,IRN,2008.0,6,0,6
DMA,USA,2011.0,1,0,1
EGY,OMN,1999.0,1,0,1
MAC,ITA,2010.0,1,0,1
DNK,LKA,2014.0,1,0,1
SYR,MYS,2017.0,1,0,1
MNE,URY,2016.0,1,0,1
SDN,NGA,2018.0,1,0,1
CHN,UGA,2004.0,1,0,1
SGP,LKA,2003.0,1,0,1
GMB,DEU,2017.0,1,0,1
,YEM,2019.0,42,0,42
KAZ,ARM,2009.0,1,0,1
VEN,ESP,1998.0,2,0,2
,GUF,2005.0,8,0,8
SWE,KWT,1999.0,1,0,1
BEL,SVN,2012.0,1,0,1
LBR,,2011.0,1,0,1
ARE,PAK,2011.0,2,0,2
SAU,OMN,2005.0,2,0,2
KEN,CHE,1999.0,2,0,2
KWT,,2001.0,3,0,3
GRC,ISR,2001.0,1,0,1
KOR,PHL,2002.0,1,0,1
CYP,SGP,2015.0,1,0,1
AUT,TZA,2007.0,1,0,1
JPN,GHA,2009.0,2,0,2
DNK,QAT,2008.0,1,0,1
TWN,MNG,2019.0,3,0,3
JOR,FIN,2020.0,1,0,1
MEX,SVK,2019.0,1,0,1
CZE,CHL,2009.0,1,0,1
SWE,LIE,2007.0,1,0,1
TZA,AUS,2010.0,1,0,1
DNK,NGA,2021.0,1,0,1
BRA,PER,1999.0,1,0,1
DNK,KEN,2018.0,3,0,3
CHN,BRB,2020.0,1,0,1
MYS,ARE,2004.0,2,0,2
HTI,GBR,2021.0,2,0,2
UKR,NGA,2009.0,1,0,1
MAR,DJI,2022.0,1,0,1
TJK,RUS,2003.0,4,0,4
ARG,IRL,2009.0,1,0,1
USA,GEO,1998.0,1,0,1
ISR,BEL,1998.0,2,0,2
JPN,SVN,2002.0,1,0,1
LUX,NLD,2004.0,1,0,1
SWZ,,2005.0,1,0,1
CIV,USA,2008.0,1,0,1
IDN,ZWE,2019.0,1,0,1
FRA,AGO,2015.0,1,0,1
GBR,SLE,2004.0,1,0,1
GMB,,1999.0,1,0,1
SWE,GLP,2003.0,2,0,2
PRT,ROU,2012.0,1,0,1
DNK,MWI,2004.0,1,0,1
CZE,HRV,2006.0,2,0,2
LBY,YEM,2007.0,1,0,1
CAN,BFA,2011.0,1,0,1
TWN,CRI,2014.0,1,0,1
GRC,PRT,2011.0,1,0,1
TWN,PAK,2012.0,1,0,1
BEL,PSE,2020.0,2,0,2
LTU,SVN,2012.0,1,0,1
COL,JPN,2021.0,3,0,3
BMU,,2004.0,1,0,1
MOZ,UGA,2022.0,1,0,1
IRN,ITA,2003.0,2,0,2
AUT,SEN,2007.0,1,0,1
DZA,ARE,2008.0,1,0,1
ZAF,SYR,2010.0,1,0,1
CHL,PAN,2017.0,1,0,1
BRA,BLR,2008.0,1,0,1
PER,DNK,2018.0,1,0,1
VEN,NOR,2010.0,1,0,1
RUS,THA,2007.0,1,0,1
TUN,EGY,2019.0,1,0,1
TUR,MYS,2008.0,1,0,1
ZAF,JAM,2010.0,1,0,1
TUR,LUX,2019.0,1,0,1
CAN,MCO,2010.0,1,0,1
COL,KOR,2014.0,1,0,1
BTN,IDN,2018.0,1,0,1
CAN,GHA,2005.0,2,0,2
SVN,MNE,2008.0,1,0,1
AUS,PRI,2008.0,1,0,1
SAU,IDN,2010.0,2,0,2
HUN,ECU,2013.0,1,0,1
PER,ETH,2016.0,1,0,1
BWA,MEX,2018.0,1,0,1
CUB,CHL,2004.0,2,0,2
PYF,NCL,2017.0,2,0,2
IRN,SAU,2016.0,1,0,1
YEM,SDN,2019.0,2,0,2
HKG,KWT,2010.0,2,0,2
ESP,NZL,2005.0,1,0,1
BRA,HND,2021.0,1,0,1
ZMB,GHA,2019.0,1,0,1
,GUF,2002.0,5,0,5
GUM,FJI,2004.0,1,0,1
,AND,1996.0,1,0,1
CZE,SLE,2020.0,1,0,1
ESP,GTM,2013.0,1,0,1
BEL,KNA,2017.0,1,0,1
PAK,JOR,2013.0,2,0,2
UKR,KWT,2016.0,1,0,1
GBR,BLR,2013.0,1,0,1
DEU,URY,2013.0,1,0,1
MWI,ZMB,2009.0,1,0,1
CZE,FIN,2005.0,3,0,3
NZL,URY,2016.0,1,0,1
LKA,EST,2022.0,2,0,2
,TLS,2012.0,5,0,5
,NAM,1994.0,1,0,1
,PYF,1997.0,4,0,4
JPN,LTU,2014.0,1,0,1
BRN,CAN,2005.0,1,0,1
LUX,ESP,2004.0,1,0,1
MAR,PRT,2002.0,1,0,1
VEN,CHE,2022.0,1,0,1
TTO,THA,2008.0,1,0,1
PHL,QAT,2014.0,1,0,1
SWE,GIN,2006.0,1,0,1
GHA,HKG,2008.0,1,0,1
CYP,RUS,2022.0,1,0,1
YEM,KWT,2013.0,1,0,1
AFG,USA,2021.0,1,0,1
CHL,TUR,2022.0,1,0,1
NCL,AUS,2016.0,2,0,2
VNM,IDN,2021.0,3,0,3
SLE,CHN,2017.0,1,0,1
CHE,JOR,2020.0,1,0,1
RUS,EGY,2009.0,2,0,2
GTM,NLD,2011.0,2,0,2
BEL,BLR,2003.0,1,0,1
BLR,ZAF,2003.0,1,0,1
JPN,PRY,2001.0,1,0,1
RUS,COL,2004.0,1,0,1
SWE,LBN,2012.0,1,0,1
CZE,SAU,2016.0,2,0,2
IRN,CZE,2008.0,1,0,1
MYS,CHE,2012.0,2,0,2
ECU,,1999.0,1,0,1
GHA,MEX,2022.0,1,0,1
,CPV,2001.0,2,0,2
KOR,CZE,2000.0,1,0,1
GBR,URY,2002.0,1,0,1
KAZ,USA,1998.0,1,0,1
UKR,SVK,2003.0,2,0,2
IRL,LUX,2010.0,1,0,1
IND,CHN,1998.0,1,0,1
ESP,MDA,2006.0,1,0,1
BRA,EGY,2009.0,1,0,1
ISL,ARE,2013.0,1,0,1
ARG,SVN,2006.0,1,0,1
,GUY,2006.0,1,0,1
BFA,AUT,2007.0,2,0,2
HUN,SAU,2015.0,1,0,1
KAZ,IND,2006.0,1,0,1
KOR,SDN,2018.0,1,0,1
MOZ,CAN,2015.0,1,0,1
TUR,NZL,2014.0,1,0,1
ETH,MYS,2022.0,2,0,2
ITA,LKA,2018.0,1,0,1
,LCA,2006.0,1,0,1
PRY,VEN,2010.0,1,0,1
NOR,ZWE,2015.0,1,0,1
FRA,GNB,2017.0,1,0,1
YEM,,2004.0,1,0,1
MEX,SVK,2017.0,1,0,1
NZL,MDV,2011.0,1,0,1
CAN,ZMB,2021.0,1,0,1
SVK,RUS,2006.0,1,0,1
RWA,NZL,2020.0,1,0,1
UGA,TZA,2007.0,1,0,1
EST,DNK,2022.0,1,0,1
PAN,CUB,2002.0,1,0,1
MRT,SEN,2003.0,1,0,1
CHE,GHA,2011.0,1,0,1
TWN,MYS,2002.0,1,0,1
TUN,EGY,2017.0,1,0,1
CMR,NGA,2008.0,1,0,1
SYC,GBR,2019.0,2,0,2
ESP,JPN,2023.0,1,0,1
ISR,MAC,2017.0,1,0,1
MYS,LBN,2019.0,1,0,1
CMR,AUS,2021.0,1,0,1
SYR,MEX,2014.0,1,0,1
NZL,MDG,2020.0,1,0,1
KEN,CZE,1999.0,1,0,1
ARE,ALB,2020.0,1,0,1
COL,KEN,2007.0,1,0,1
ARM,SWE,2006.0,1,0,1
NLD,TTO,2009.0,1,0,1
OMN,RUS,2019.0,2,0,2
ZAF,LUX,2022.0,1,0,1
CUB,AUT,2020.0,1,0,1
AUS,NAM,2014.0,1,0,1
LTU,CHE,2003.0,1,0,1
ETH,DJI,2019.0,1,0,1
OMN,POL,2019.0,1,0,1
PAK,BRA,2003.0,1,0,1
PRI,CHL,2010.0,1,0,1
BGD,TWN,2004.0,1,0,1
GIN,SEN,2005.0,1,0,1
MAR,SYR,2022.0,1,0,1
HUN,LUX,2010.0,1,0,1
CMR,PRT,2017.0,1,0,1
QAT,AUT,2022.0,1,0,1
MKD,USA,2002.0,2,0,2
CHN,UKR,1997.0,1,0,1
ETH,ARE,2013.0,1,0,1
GBR,MCO,2016.0,1,0,1
IRL,SVK,2013.0,1,0,1
IND,ECU,2013.0,1,0,1
CUB,FRA,1999.0,1,0,1
ZAF,GRC,2011.0,1,0,1
TCD,SEN,2009.0,1,0,1
DNK,CRI,2021.0,1,0,1
SWE,HND,2019.0,1,0,1
GMB,AUT,2011.0,1,0,1
GUM,ESP,2005.0,1,0,1
CYP,OMN,2008.0,1,0,1
UGA,AUT,2013.0,1,0,1
SDN,IRQ,2012.0,1,0,1
ESP,AGO,2018.0,1,0,1
DEU,MDG,2021.0,2,0,2
SWE,LBY,2020.0,1,0,1
HKG,VNM,2015.0,1,0,1
TZA,BDI,2016.0,1,0,1
PAK,KHM,2018.0,1,0,1
JOR,RUS,2020.0,1,0,1
BEN,NER,2011.0,1,0,1
TUR,LUX,2017.0,1,0,1
DZA,MRT,2010.0,1,0,1
TWN,TTO,2011.0,1,0,1
GRC,LUX,2022.0,1,0,1
ARG,NOR,2021.0,1,0,1
ZAF,BGD,2016.0,1,0,1
DEU,JAM,1998.0,1,0,1
MYS,FIN,2010.0,1,0,1
HUN,NZL,2006.0,2,0,2
KWT,QAT,2011.0,1,0,1
BFA,IND,2005.0,1,0,1
AUS,BRN,1999.0,1,0,1
GIN,SEN,2002.0,1,0,1
ISR,HKG,2002.0,1,0,1
CHE,ARE,2013.0,1,0,1
FIN,ISL,1997.0,1,0,1
BGR,CZE,2005.0,1,0,1
GRC,CHL,2004.0,1,0,1
LUX,AUS,2010.0,1,0,1
MRT,,2011.0,1,0,1
PHL,MNG,2018.0,1,0,1
IND,AFG,2010.0,1,0,1
KOR,NGA,2017.0,1,0,1
GMB,NLD,2004.0,1,0,1
FIN,LTU,2003.0,1,0,1
BLR,IRN,2020.0,1,0,1
ISL,NLD,2022.0,2,0,2
LKA,CHE,2011.0,1,0,1
CMR,CHE,2014.0,1,0,1
AUT,LTU,2005.0,1,0,1
GBR,PAN,2005.0,1,0,1
YEM,IRQ,2004.0,1,0,1
YEM,QAT,2013.0,1,0,1
ESP,THA,2021.0,1,0,1
TTO,KOR,2017.0,1,0,1
LUX,CHE,2003.0,1,0,1
CYP,ITA,2000.0,1,0,1
NLD,BHR,2013.0,1,0,1
MOZ,USA,2002.0,1,0,1
ESP,DOM,2008.0,1,0,1
URY,NGA,2011.0,1,0,1
ESP,HUN,1997.0,1,0,1
ETH,NPL,2009.0,1,0,1
CUB,VEN,1999.0,1,0,1
SAU,BHS,2021.0,1,0,1
FRA,BWA,2015.0,1,0,1
BRN,EGY,2019.0,1,0,1
BLR,CHN,2009.0,1,0,1
MOZ,USA,2005.0,1,0,1
LBY,ITA,2004.0,1,0,1
FRA,TCD,2019.0,1,0,1
ZWE,CHE,1999.0,1,0,1
PER,CAN,2022.0,1,0,1
NGA,ZWE,2019.0,1,0,1
CHN,USA,2009.0,1644,1137,507
FRA,USA,2013.0,816,677,139
USA,KOR,2015.0,906,701,205
EGY,SAU,2011.0,190,84,106
MDA,RUS,2011.0,5,2,3
BRA,COL,2020.0,73,36,37
USA,GHA,2018.0,28,22,6
USA,ZAF,1998.0,10,15,-5
RUS,ISR,2001.0,17,1,16
DEU,IDN,2012.0,28,5,23
USA,CHN,2010.0,1390,1889,-499
CHN,NLD,2007.0,31,18,13
AUS,USA,2015.0,513,594,-81
ROU,CAN,2002.0,11,4,7
MEX,USA,2006.0,159,133,26
GBR,IRN,2008.0,59,20,39
FRA,NLD,1997.0,7,12,-5
OMN,ARE,2018.0,7,4,3
CHE,CAN,2020.0,90,98,-8
NZL,USA,2020.0,93,115,-22
SGP,MYS,2014.0,23,13,10
DEU,AUT,2019.0,357,321,36
GBR,CAN,2013.0,327,340,-13
CHN,SGP,2000.0,47,8,39
DNK,ESP,2018.0,39,24,15
CHN,GBR,2012.0,186,290,-104
USA,JPN,2014.0,806,725,81
SWE,GBR,2008.0,119,90,29
DEU,CAN,2008.0,175,121,54
USA,CHN,2019.0,2887,2863,24
GBR,ITA,2021.0,349,324,25
ITA,BRA,2016.0,64,37,27
AUS,CHN,2021.0,429,253,176
EST,GBR,2013.0,9,5,4
FRA,MAR,2015.0,115,34,81
FRA,DZA,2018.0,85,51,34
IDN,NZL,2008.0,2,1,1
USA,HKG,2013.0,147,130,17
KOR,AUS,2011.0,26,17,9
GBR,TUR,2003.0,44,15,29
DEU,IRN,2007.0,16,19,-3
CAN,DEU,2017.0,178,180,-2
USA,CHN,2017.0,2588,2744,-156
CAN,DEU,2010.0,138,142,-4
ESP,PRT,2012.0,89,50,39
USA,CZE,2011.0,49,38,11
JPN,CHN,2014.0,476,259,217
KOR,ITA,2022.0,3,5,-2
CAN,DEU,2019.0,155,167,-12
CZE,NLD,2003.0,5,1,4
ITA,NOR,2011.0,9,7,2
GRC,DEU,2015.0,68,36,32
SWE,NOR,2013.0,58,44,14
USA,SWE,2016.0,243,216,27
AUS,SAU,2011.0,18,6,12
FRA,GLP,2013.0,16,13,3
CAN,FRA,2014.0,250,350,-100
NLD,POL,2015.0,14,25,-11
ESP,NLD,2004.0,35,39,-4
CAN,SAU,2017.0,115,67,48
NZL,GBR,2009.0,92,118,-26
GRC,ZAF,2017.0,4,1,3
EGY,FRA,2016.0,6,14,-8
CAN,JPN,2007.0,58,79,-21
SWE,HUN,2016.0,5,13,-8
ITA,PRT,2014.0,35,31,4
GBR,FRA,2020.0,427,426,1
USA,AUS,2000.0,107,137,-30
PAK,BGD,2012.0,6,3,3
CAN,GBR,2022.0,134,155,-21
BRB,JAM,2021.0,3,1,2
UKR,DEU,2009.0,24,22,2
FRA,JPN,2001.0,54,58,-4
SWE,USA,2020.0,181,230,-49
HKG,GBR,2012.0,26,43,-17
DNK,DEU,2015.0,67,118,-51
ITA,GRC,2012.0,28,25,3
BEL,FRA,2013.0,195,194,1
NLD,FRA,2016.0,109,89,20
ITA,AUT,2015.0,41,24,17
GBR,FIN,2013.0,41,34,7
BRA,GBR,2015.0,93,79,14
BEL,GBR,2018.0,152,100,52
CHN,HKG,2022.0,424,513,-89
ESP,CHL,2014.0,120,46,74
IRN,CAN,2018.0,295,80,215
LKA,GBR,2020.0,17,21,-4
SWE,THA,2016.0,8,3,5
IRL,GBR,2018.0,241,251,-10
GRC,FRA,2021.0,22,24,-2
UKR,POL,2016.0,31,13,18
HKG,CHN,2004.0,204,141,63
CAN,BEL,2021.0,42,33,9
CAN,SAU,2019.0,144,86,58
ESP,IND,2019.0,21,19,2
DEU,CUB,2016.0,1,6,-5
KOR,HKG,2015.0,14,7,7
BRA,USA,2020.0,671,321,350
SGP,THA,2021.0,7,3,4
SWE,SAU,2020.0,9,6,3
POL,CAN,2015.0,32,7,25
AUS,NZL,2014.0,92,189,-97
FRA,NLD,1998.0,23,15,8
AUT,CAN,2019.0,18,19,-1
SGP,BEL,2020.0,7,6,1
CAN,ESP,2016.0,36,60,-24
JPN,IND,2000.0,14,38,-24
RUS,CHE,2016.0,21,9,12
NOR,ITA,2016.0,11,25,-14
CHE,BEL,2010.0,30,31,-1
COL,USA,2007.0,48,45,3
ECU,ESP,2021.0,36,43,-7
PAK,DEU,2016.0,24,38,-14
CZE,ITA,2019.0,12,27,-15
MYS,BHR,2016.0,1,1,0
BRA,CHL,2016.0,23,17,6
SVK,DEU,2012.0,12,12,0
MYS,YEM,2015.0,15,3,12
NCL,FRA,2004.0,7,13,-6
BGD,CAN,2017.0,30,20,10
CZE,USA,2000.0,33,12,21
FIN,DNK,2016.0,24,13,11
JPN,KOR,2002.0,124,71,53
AUS,SWE,2014.0,43,33,10
CHN,CHE,2022.0,34,44,-10
ESP,IND,2017.0,17,20,-3
GBR,LUX,2017.0,8,2,6
NPL,JPN,2020.0,6,11,-5
ECU,BRA,2018.0,4,18,-14
USA,BEL,1999.0,42,53,-11
CHN,DNK,2015.0,55,30,25
GBR,JPN,2018.0,131,94,37
AUT,USA,2021.0,72,82,-10
AUT,CAN,2010.0,22,10,12
CAN,SAU,2010.0,70,31,39
IND,TZA,2018.0,3,1,2
NZL,CAN,2005.0,31,18,13
CAN,TUR,2022.0,13,10,3
USA,ECU,2020.0,29,25,4
NPL,NLD,2015.0,1,1,0
MAR,ESP,2014.0,8,21,-13
MAR,CHN,2021.0,6,1,5
MEX,COL,2020.0,55,42,13
CHE,RUS,2012.0,9,28,-19
USA,GRD,2013.0,3,2,1
GBR,LUX,2019.0,15,3,12
ZWE,BWA,2019.0,1,2,-1
CZE,ITA,2010.0,12,7,5
CAN,NZL,2016.0,38,31,7
FRA,ESP,1998.0,33,34,-1
NOR,GBR,2022.0,20,47,-27
AUT,DNK,2016.0,9,10,-1
PHL,IND,2013.0,6,5,1
DEU,KOR,2009.0,39,23,16
DEU,GRC,2001.0,21,15,6
GBR,AUS,1998.0,76,67,9
USA,KWT,2017.0,30,10,20
CHN,JPN,2000.0,109,62,47
GBR,IRL,2014.0,183,265,-82
SAU,USA,2020.0,134,303,-169
SVN,ITA,2018.0,8,13,-5
CAN,MYS,2018.0,8,28,-20
HKG,BEL,2022.0,2,1,1
ETH,USA,2013.0,21,4,17
HUN,IRN,2021.0,3,5,-2
BEL,CHL,2003.0,3,1,2
SGP,HKG,2001.0,14,17,-3
USA,UKR,2002.0,25,43,-18
SRB,DEU,2007.0,14,13,1
ISR,GBR,2016.0,64,42,22
USA,NOR,2009.0,75,61,14
USA,COG,2011.0,3,5,-2
AUT,CAN,2017.0,14,24,-10
CHL,DEU,2014.0,24,42,-18
UGA,USA,2005.0,8,9,-1
AUT,CHE,2008.0,46,24,22
IDN,AUS,2008.0,8,17,-9
JPN,DEU,2016.0,131,124,7
USA,KWT,2019.0,26,14,12
IND,SGP,2012.0,69,34,35
KOR,BGD,2016.0,21,24,-3
TWN,IND,2022.0,15,34,-19
SAU,CAN,2008.0,20,42,-22
KOR,GBR,2007.0,30,40,-10
TUR,SAU,2018.0,19,6,13
AUS,HKG,2012.0,39,40,-1
GBR,PAK,2007.0,28,22,6
CHE,GBR,1998.0,34,31,3
DEU,PER,2018.0,7,3,4
CHN,AUT,2012.0,14,12,2
BEL,NLD,2002.0,90,80,10
JPN,KOR,2005.0,149,76,73
DNK,GRL,2020.0,6,3,3
BEL,POL,2022.0,7,7,0
SAU,KOR,2018.0,10,17,-7
IRN,TUR,2016.0,23,14,9
FIN,SWE,2000.0,23,8,15
HKG,CHE,2019.0,14,7,7
SEN,FRA,2011.0,18,23,-5
NLD,ROU,2014.0,4,10,-6
CAN,HKG,2014.0,22,25,-3
RUS,FRA,2004.0,43,23,20
IND,JPN,2000.0,38,14,24
VEN,MEX,2011.0,8,3,5
FIN,ITA,2007.0,9,5,4
USA,UKR,2005.0,19,44,-25
GBR,JOR,2001.0,5,1,4
CHL,ARG,2003.0,4,21,-17
DEU,NZL,2004.0,27,13,14
FRA,BRA,2000.0,22,23,-1
ECU,USA,2015.0,9,33,-24
DEU,EST,2007.0,6,1,5
CAN,CHE,1999.0,22,17,5
AUS,ESP,2015.0,28,70,-42
IDN,TWN,2015.0,11,17,-6
NOR,SGP,2018.0,3,3,0
KOR,CAN,2013.0,39,39,0
IRN,GBR,2022.0,28,7,21
IND,IDN,2020.0,12,3,9
URY,ESP,2020.0,13,11,2
RUS,KAZ,2018.0,33,31,2
CUB,MEX,2003.0,23,6,17
DEU,TUR,2015.0,41,42,-1
COL,SWE,2020.0,3,3,0
NGA,RUS,2018.0,1,3,-2
RUS,JPN,2011.0,15,12,3
ARE,MAR,2020.0,3,1,2
FRA,MTQ,2018.0,26,23,3
COL,CAN,2021.0,22,7,15
MLT,GBR,2016.0,11,18,-7
MEX,JPN,2020.0,7,6,1
IRL,ITA,2004.0,3,10,-7
PAK,NOR,2020.0,6,4,2
ARG,CHE,2018.0,13,10,3
ITA,ETH,2021.0,4,3,1
CHN,ETH,2020.0,11,16,-5
USA,HRV,2020.0,13,9,4
USA,ETH,2021.0,19,15,4
EGY,GBR,2014.0,21,61,-40
ITA,MEX,2007.0,11,3,8
DNK,IND,2022.0,9,11,-2
ETH,CAN,2020.0,3,1,2
CHN,LKA,2020.0,7,3,4
DEU,SAU,2012.0,17,9,8
EGY,JPN,2019.0,28,54,-26
GBR,CHN,1998.0,21,19,2
GBR,UGA,2018.0,16,14,2
ARG,URY,2020.0,11,4,7
PYF,AUS,2018.0,1,2,-1
USA,SLV,2019.0,3,3,0
MEX,ITA,2021.0,16,8,8
GBR,ROU,2015.0,13,21,-8
CUB,CAN,2017.0,12,2,10
IDN,JPN,2007.0,12,49,-37
HUN,SWE,2021.0,9,6,3
SVK,FRA,2006.0,5,8,-3
FRA,HRV,2013.0,4,6,-2
ESP,VEN,2002.0,9,18,-9
MEX,BEL,2011.0,7,6,1
SWE,CAN,2006.0,34,11,23
UKR,GEO,2018.0,1,1,0
DEU,ISR,2015.0,54,40,14
LBN,CAN,2006.0,8,5,3
RUS,ESP,2009.0,15,8,7
DEU,SRB,2016.0,9,22,-13
USA,LBN,2006.0,18,29,-11
RUS,DNK,2007.0,6,1,5
MYS,FRA,2018.0,4,10,-6
PAK,FRA,2005.0,2,1,1
SRB,SVN,2015.0,5,2,3
ITA,SVN,2021.0,11,4,7
BEL,SWE,1997.0,6,2,4
DZA,MAR,2015.0,6,5,1
SWE,CHE,2011.0,36,21,15
ZAF,RUS,2021.0,1,4,-3
BRA,ESP,2000.0,11,19,-8
SAU,FIN,2012.0,4,2,2
USA,CHL,1999.0,17,18,-1
USA,PAK,2001.0,16,26,-10
USA,SVK,2004.0,7,21,-14
ESP,AUS,2006.0,12,9,3
ZAF,NAM,2012.0,7,3,4
BEL,AUS,2003.0,10,14,-4
ISR,ITA,2002.0,21,11,10
CAN,HUN,2019.0,7,8,-1
FRA,MDG,2009.0,8,5,3
JPN,THA,2000.0,8,3,5
DEU,SVK,2011.0,9,15,-6
SWE,MEX,2007.0,1,3,-2
GBR,LUX,2010.0,5,3,2
CHE,NLD,2003.0,36,41,-5
LTU,USA,2002.0,5,2,3
NLD,PRT,2015.0,21,28,-7
AUT,NGA,2006.0,2,1,1
JOR,OMN,2008.0,1,1,0
FRA,TWN,2001.0,7,2,5
JPN,TUR,2004.0,9,13,-4
CIV,FRA,2013.0,15,35,-20
FRA,ESP,1997.0,19,13,6
FRA,HKG,2002.0,8,2,6
USA,ISL,1999.0,2,4,-2
CAN,SGP,1999.0,7,2,5
NGA,TZA,2007.0,1,1,0
NGA,GBR,2009.0,18,23,-5
AUT,IRL,2007.0,3,3,0
FRA,HUN,2010.0,14,12,2
JPN,NLD,2003.0,21,14,7
USA,NZL,1998.0,11,16,-5
RUS,GRC,2000.0,6,1,5
DZA,FRA,2003.0,26,29,-3
DEU,IRL,2000.0,8,3,5
ITA,ARG,2000.0,9,3,6
DNK,CHE,1997.0,3,1,2
BEL,SWE,1998.0,2,2,0
ESP,VEN,2005.0,12,19,-7
GBR,ARE,2000.0,5,1,4
NZL,MYS,2021.0,7,16,-9
ESP,CUB,2006.0,15,14,1
AUT,HUN,2004.0,7,5,2
KWT,EGY,2008.0,8,11,-3
JOR,IRQ,2014.0,4,2,2
NZL,BEL,2010.0,3,3,0
GRC,SVK,2009.0,2,2,0
GBR,AUS,1997.0,35,39,-4
POL,SWE,1998.0,2,3,-1
AUT,ZAF,2000.0,2,1,1
FRA,SVN,2013.0,4,4,0
GBR,MEX,2013.0,48,35,13
TTO,USA,1999.0,1,5,-4
IND,CHE,2003.0,14,7,7
USA,IRQ,2009.0,3,3,0
AUT,CHN,2002.0,4,8,-4
IND,CHL,2016.0,5,4,1
SGP,TWN,2014.0,12,16,-4
ESP,IND,2010.0,11,17,-6
NOR,CAN,2012.0,11,9,2
GBR,OMN,2003.0,4,6,-2
CAN,PRT,2009.0,4,6,-2
PAK,CAN,2003.0,3,4,-1
DNK,NZL,1999.0,1,1,0
EGY,IND,2013.0,2,3,-1
BEL,CAN,2001.0,18,24,-6
ZAF,BEL,2005.0,4,5,-1
CAN,LTU,2008.0,2,1,1
FRA,HUN,2019.0,10,8,2
DEU,SGP,2001.0,1,7,-6
FRA,ISR,2009.0,19,17,2
ZAF,IND,2000.0,2,1,1
JPN,RUS,2014.0,16,15,1
PRT,USA,2003.0,33,53,-20
DEU,ARE,2016.0,10,2,8
ROU,BEL,2009.0,5,5,0
BEL,ARG,2012.0,3,4,-1
BEL,UGA,2014.0,3,3,0
POL,NLD,2006.0,9,4,5
NLD,BRA,2018.0,19,38,-19
CAN,IRQ,2019.0,5,2,3
ISR,CHE,2009.0,11,9,2
AUS,IRN,2016.0,35,147,-112
BRN,AUS,2016.0,2,3,-1
FIN,EST,2009.0,6,5,1
AUS,TWN,2011.0,14,13,1
SYR,DEU,2013.0,6,7,-1
USA,CIV,2011.0,2,2,0
SWE,IRL,2015.0,7,8,-1
GBR,IRQ,2014.0,22,12,10
POL,ROU,2018.0,2,3,-1
NZL,SGP,2012.0,10,5,5
USA,CRI,2011.0,7,8,-1
MAC,GBR,2016.0,1,4,-3
HRV,BIH,2016.0,11,9,2
TZA,AUS,2018.0,1,5,-4
GBR,IDN,2007.0,4,2,2
BEL,RWA,2016.0,5,3,2
CHE,BEL,2017.0,47,58,-11
USA,KWT,2010.0,11,7,4
RUS,CAN,2015.0,12,19,-7
IND,IRN,2015.0,23,4,19
RUS,IRN,2013.0,3,2,1
POL,SGP,2019.0,3,2,1
NZL,BEL,2019.0,6,1,5
ESP,CYP,2020.0,1,2,-1
EGY,FIN,2022.0,3,1,2
THA,VNM,2015.0,5,9,-4
HKG,CHE,2017.0,4,4,0
EST,DNK,2016.0,5,2,3
CHL,SWE,2015.0,3,3,0
DNK,POL,2012.0,8,4,4
QAT,IND,2016.0,4,7,-3
USA,TTO,2013.0,2,10,-8
SAU,AUT,2022.0,4,1,3
SWE,ZAF,2015.0,5,8,-3
OMN,DEU,2018.0,2,3,-1
CZE,SWE,2018.0,7,10,-3
EGY,HKG,2021.0,2,2,0
KOR,OMN,2022.0,3,1,2
ARG,CZE,2018.0,1,1,0
TWN,PHL,2019.0,8,11,-3
TZA,USA,2019.0,19,13,6
EGY,ITA,2019.0,9,17,-8
ARE,CAN,2008.0,1,23,-22
RUS,LVA,2006.0,2,1,1
SAU,SDN,2016.0,7,25,-18
EGY,DEU,2008.0,15,35,-20
CHN,SLE,2014.0,1,1,0
DEU,LTU,2020.0,8,7,1
GBR,SAU,2007.0,26,14,12
BEL,NLD,2005.0,75,83,-8
TUR,ESP,2009.0,5,5,0
NZL,CAN,2002.0,27,23,4
JOR,QAT,2014.0,7,3,4
EGY,LBN,2008.0,3,3,0
NLD,EGY,2006.0,3,2,1
AUS,TUR,2005.0,2,3,-1
MYS,ARE,2014.0,6,1,5
BGR,ESP,2013.0,1,1,0
CHN,ITA,2003.0,10,15,-5
NZL,CHE,2022.0,5,4,1
USA,URY,2013.0,9,8,1
ZAF,RWA,2020.0,6,2,4
CHL,FRA,2006.0,14,12,2
CRI,BRA,2012.0,4,1,3
JPN,SAU,2016.0,16,4,12
ZAF,NLD,2014.0,21,14,7
USA,ARM,2021.0,2,3,-1
SRB,ISR,2016.0,1,1,0
DEU,ISL,2015.0,7,5,2
ESP,IRN,2011.0,7,5,2
CZE,ITA,2017.0,13,10,3
ARE,MEX,2020.0,1,2,-1
THA,NOR,2009.0,1,1,0
ITA,BGR,2011.0,6,4,2
ITA,IDN,2013.0,2,1,1
USA,MDA,2017.0,1,1,0
ITA,RUS,2008.0,13,15,-2
ISR,NZL,2015.0,2,1,1
FRA,COL,2013.0,12,15,-3
TWN,ITA,2019.0,8,7,1
LTU,DEU,2006.0,11,1,10
TWN,PHL,2017.0,8,4,4
FRA,SRB,2020.0,5,5,0
SAU,JOR,2011.0,6,38,-32
JPN,CMR,2017.0,2,1,1
HKG,DEU,2022.0,6,7,-1
CZE,SVK,2009.0,15,25,-10
IND,IRL,2003.0,5,3,2
RUS,NOR,2020.0,7,5,2
ARG,VEN,2018.0,4,8,-4
ITA,LKA,2019.0,1,1,0
EGY,JPN,2010.0,15,47,-32
CHE,FIN,2009.0,5,17,-12
EGY,KWT,2021.0,7,5,2
NZL,ZAF,2006.0,3,3,0
FRA,SVK,2018.0,6,2,4
ZAF,ESP,2002.0,1,1,0
HKG,PHL,2005.0,1,1,0
MEX,GBR,1998.0,4,1,3
DNK,MYS,2009.0,1,2,-1
DEU,ROU,1999.0,2,9,-7
NLD,NOR,1997.0,2,1,1
GRC,CAN,2006.0,5,11,-6
ARG,CHN,2000.0,1,1,0
LTU,USA,2005.0,8,2,6
TUR,NLD,2001.0,3,3,0
JPN,HUN,2020.0,3,4,-1
HUN,CAN,2006.0,5,4,1
TUR,TWN,2005.0,4,1,3
MLI,USA,2002.0,2,5,-3
SGP,ISR,2009.0,3,2,1
BEL,COG,2003.0,4,2,2
ETH,ZAF,2001.0,3,1,2
HUN,AUT,2007.0,7,7,0
TZA,USA,2010.0,5,4,1
CAN,TUN,2014.0,10,15,-5
FRA,BGR,2013.0,7,4,3
GBR,TZA,2013.0,15,9,6
ITA,EGY,2010.0,8,4,4
KWT,JOR,2011.0,1,1,0
TWN,ITA,2017.0,4,5,-1
TWN,AUS,2009.0,10,20,-10
CHL,DNK,2016.0,1,2,-1
SRB,BRA,2020.0,1,2,-1
ITA,EGY,2019.0,17,9,8
GHA,CHN,2018.0,12,14,-2
GBR,MLT,2015.0,9,9,0
IND,UGA,2019.0,2,2,0
VNM,CAN,2017.0,3,6,-3
CHE,BGD,2021.0,5,2,3
ESP,MYS,2017.0,1,3,-2
AZE,RUS,2018.0,1,4,-3
KHM,JPN,2018.0,3,8,-5
NOR,KOR,2021.0,4,7,-3
TUN,USA,2007.0,2,3,-1
CAN,NOR,2022.0,8,2,6
AFG,IRN,2021.0,2,2,0
BWA,NGA,2006.0,2,1,1
HUN,BEL,2011.0,6,6,0
ITA,COL,2011.0,6,1,5
UKR,KAZ,2017.0,1,2,-1
ESP,NOR,2022.0,12,5,7
TUN,MAR,2015.0,1,1,0
DEU,TWN,2021.0,14,19,-5
AUS,ITA,1998.0,4,2,2
AUS,QAT,2018.0,5,7,-2
PRT,CZE,2011.0,2,1,1
BIH,SRB,2007.0,13,14,-1
FJI,USA,2007.0,1,4,-3
GRC,FIN,2014.0,4,2,2
BGR,USA,2012.0,14,17,-3
SVK,IRN,2021.0,1,3,-2
GBR,CHN,1997.0,8,11,-3
GBR,BWA,2008.0,3,1,2
NZL,AUT,2012.0,3,4,-1
HKG,SWE,2004.0,2,1,1
PRY,BRA,2009.0,3,2,1
NZL,BEL,2017.0,2,5,-3
KGZ,TUR,2015.0,3,4,-1
IRQ,GBR,2011.0,4,7,-3
TTO,JAM,2020.0,1,1,0
ETH,JPN,2020.0,3,4,-1
ITA,EST,2004.0,1,1,0
MLT,TUR,2022.0,1,1,0
CAN,NGA,2022.0,3,8,-5
VNM,CAN,2019.0,4,4,0
SVN,GBR,2020.0,7,8,-1
LBN,USA,1998.0,2,2,0
TUR,MYS,2013.0,2,3,-1
GAB,DEU,2020.0,6,3,3
HRV,HUN,2021.0,1,2,-1
JPN,ESP,2006.0,5,5,0
VEN,CUB,2005.0,1,3,-2
USA,HND,2022.0,1,1,0
COL,NZL,2009.0,2,1,1
LTU,GBR,2005.0,3,2,1
MAR,ITA,2008.0,1,1,0
POL,SVK,2005.0,1,1,0
CHE,CHL,2007.0,3,2,1
USA,NZL,1997.0,8,9,-1
FRA,POL,2004.0,16,27,-11
POL,SWE,1997.0,3,1,2
ARE,HUN,2014.0,1,1,0
NOR,RUS,2016.0,6,11,-5
RUS,ZAF,2006.0,2,1,1
QAT,PAK,2006.0,1,1,0
TUR,PSE,2013.0,4,1,3
ARE,THA,2017.0,1,1,0
GBR,LKA,2012.0,8,7,1
MDG,GBR,2012.0,3,1,2
ZAF,DNK,2011.0,4,4,0
TWN,PHL,2010.0,1,2,-1
GIN,CHE,2016.0,1,1,0
RUS,CZE,2007.0,7,8,-1
CHE,RWA,2015.0,1,2,-1
JPN,PRY,2003.0,2,1,1
FRA,MYS,2021.0,6,3,3
NZL,OMN,2015.0,1,3,-2
ZMB,JPN,2007.0,1,1,0
RUS,AUT,2004.0,5,2,3
ARE,TUN,2014.0,2,5,-3
LTU,NOR,2014.0,2,1,1
DNK,PAK,2019.0,1,6,-5
SVN,SWE,2019.0,3,3,0
IND,KEN,2022.0,2,2,0
CHN,COL,2019.0,4,4,0
ITA,EGY,2017.0,12,5,7
ITA,ARE,2021.0,6,3,3
ITA,SVK,2013.0,3,1,2
CHN,BLR,2021.0,1,1,0
CRI,FRA,2011.0,1,1,0
SGP,JPN,1999.0,4,1,3
CAN,HUN,2010.0,5,5,0
NZL,FIN,2019.0,2,6,-4
ISR,ITA,2005.0,10,7,3
PHL,HKG,2019.0,4,3,1
GUY,USA,2015.0,1,1,0
LBN,USA,1997.0,2,2,0
CHE,HKG,2013.0,3,3,0
RUS,IRQ,2020.0,4,3,1
DNK,BEL,2022.0,9,11,-2
BRA,CZE,2004.0,2,1,1
DEU,LKA,2015.0,1,3,-2
JPN,MNG,2011.0,4,2,2
BGR,FRA,2006.0,5,1,4
TZA,ZAF,2022.0,4,2,2
USA,ROU,1999.0,3,8,-5
SWE,SRB,2011.0,1,2,-1
ETH,UGA,2015.0,1,1,0
CRI,DEU,1998.0,1,1,0
CUB,DEU,1998.0,1,3,-2
TUR,TWN,2002.0,2,1,1
FIN,PER,2011.0,1,1,0
ZAF,NOR,2007.0,2,1,1
SGP,DNK,2012.0,6,5,1
TZA,JPN,2008.0,2,1,1
ESP,MYS,2019.0,2,2,0
SAU,KWT,2012.0,2,2,0
UKR,BLR,2020.0,1,1,0
BRA,AUS,1999.0,2,4,-2
JPN,CHL,2016.0,5,6,-1
USA,ERI,2011.0,1,1,0
NGA,UGA,2014.0,2,3,-1
VNM,DNK,2009.0,2,1,1
GBR,SLE,2014.0,3,1,2
SMR,ITA,2015.0,1,3,-2
ISL,NLD,2016.0,2,2,0
IRN,ROU,2021.0,4,1,3
ETH,FRA,2018.0,1,2,-1
SAU,IDN,2018.0,4,2,2
CMR,BEL,2022.0,2,1,1
CHE,COG,2022.0,3,1,2
EGY,YEM,2022.0,2,1,1
USA,BHS,2021.0,1,2,-1
IRQ,RUS,2022.0,2,2,0
GBR,ZWE,2008.0,1,4,-3
DNK,GHA,2009.0,1,2,-1
IRN,CZE,2013.0,4,3,1
CAN,EST,2016.0,1,1,0
CHN,PRI,2016.0,1,3,-2
LBN,ARE,2011.0,4,4,0
TUR,ITA,2003.0,1,1,0
ISL,SWE,2000.0,3,5,-2
IRN,SAU,2022.0,2,1,1
BRA,JPN,1999.0,1,4,-3
GBR,ZMB,2015.0,7,3,4
ROU,SWE,2007.0,1,1,0
FIN,MEX,2014.0,1,2,-1
NGA,EGY,2012.0,1,1,0
PSE,DEU,2009.0,2,3,-1
HKG,ESP,2020.0,3,1,2
ITA,HUN,2009.0,5,14,-9
PRT,HUN,2016.0,1,1,0
PAK,FRA,2002.0,2,1,1
ROU,ARE,2013.0,1,1,0
GBR,SVN,2011.0,3,4,-1
PHL,HKG,2010.0,2,2,0
NOR,AUT,2014.0,5,13,-8
RUS,UZB,2011.0,5,2,3
PER,NOR,2014.0,1,1,0
SWE,ESP,2000.0,5,9,-4
BEL,CUB,2009.0,1,1,0
MEX,RUS,2013.0,2,2,0
ITA,TUN,2009.0,1,1,0
UKR,MEX,2009.0,2,1,1
HUN,AUS,2011.0,4,4,0
MEX,AUS,2000.0,2,1,1
NER,CHE,2014.0,1,1,0
USA,OMN,2000.0,1,1,0
PHL,CHE,2015.0,2,4,-2
TWN,VNM,2000.0,1,1,0
SGP,AUT,2009.0,2,4,-2
DNK,CHE,1998.0,3,4,-1
UKR,CZE,2003.0,2,1,1
KEN,JPN,2007.0,1,7,-6
CHE,BFA,2012.0,1,1,0
BRN,IND,2007.0,2,1,1
CUB,CAN,2010.0,4,1,3
SGP,TUR,2012.0,3,2,1
KEN,AUS,2015.0,1,3,-2
NOR,IRN,2016.0,5,10,-5
MYS,KOR,2013.0,5,8,-3
SVN,SWE,2017.0,4,2,2
IRN,PAK,2012.0,1,4,-3
AUT,MEX,2016.0,5,5,0
CHN,COL,2017.0,3,1,2
GHA,ETH,2020.0,1,1,0
FIN,ZAF,2020.0,2,4,-2
CUB,CAN,2019.0,6,1,5
MEX,IND,2001.0,2,6,-4
TWN,COL,2020.0,1,1,0
KAZ,GBR,2022.0,4,1,3
SAU,FRA,2013.0,5,38,-33
CMR,ZAF,2012.0,3,3,0
KWT,CHE,2016.0,1,1,0
USA,LAO,2014.0,3,1,2
BWA,AUS,2011.0,2,2,0
UGA,USA,2002.0,6,5,1
LUX,NLD,2014.0,2,4,-2
GBR,CIV,2005.0,1,1,0
LBY,EGY,2015.0,3,2,1
ESP,JPN,2000.0,2,5,-3
BWA,CAN,2001.0,1,1,0
JPN,KAZ,2009.0,1,1,0
NOR,MEX,2018.0,1,2,-1
SVK,USA,2015.0,5,9,-4
CHN,MYS,2009.0,3,2,1
ARG,CRI,2014.0,1,3,-2
USA,BOL,2021.0,2,5,-3
BEL,HKG,2014.0,1,1,0
FRA,HKG,2005.0,2,4,-2
ZAF,BEL,2002.0,2,7,-5
CZE,DNK,2011.0,3,4,-1
EGY,KEN,2020.0,2,1,1
CAN,IRQ,2017.0,2,2,0
NAM,BWA,2018.0,1,2,-1
ZAF,AUT,2015.0,3,6,-3
ISL,DNK,2013.0,6,5,1
ZAF,MWI,2004.0,1,1,0
EGY,ITA,2010.0,4,8,-4
USA,PSE,2001.0,1,2,-1
ZAF,GAB,2018.0,1,1,0
NZL,FIN,2017.0,4,3,1
USA,SLV,2017.0,1,1,0
NZL,NOR,2020.0,2,3,-1
BEL,ROU,2018.0,3,3,0
TUR,EGY,2022.0,2,6,-4
ISR,UKR,2020.0,3,2,1
SWE,CHL,2009.0,2,1,1
IRN,AFG,2020.0,3,3,0
PAK,KHM,2019.0,1,1,0
VNM,ISR,2020.0,1,1,0
PYF,NCL,2018.0,1,2,-1
LUX,AUS,2018.0,3,1,2
BRA,IRN,2021.0,2,8,-6
TWN,ITA,2010.0,1,2,-1
CHE,ROU,2020.0,4,11,-7
ITA,KEN,2004.0,1,1,0
OMN,EGY,2002.0,2,1,1
GRC,BEL,1998.0,2,3,-1
CIV,USA,2013.0,2,1,1
JPN,UKR,2007.0,1,4,-3
AUS,TUR,2002.0,1,5,-4
ESP,PYF,2007.0,1,1,0
RUS,MDA,2007.0,1,1,0
BEN,TGO,2012.0,1,1,0
FRA,LTU,2011.0,2,2,0
CZE,ESP,2006.0,2,3,-1
PRT,MEX,2009.0,1,6,-5
BGR,GRC,2010.0,1,2,-1
SLE,NGA,2018.0,1,2,-1
ESP,LTU,2014.0,1,2,-1
OMN,TUN,2017.0,1,2,-1
GTM,ECU,2021.0,2,1,1
CHN,RUS,2003.0,3,5,-2
POL,IND,2008.0,1,5,-4
JPN,SRB,2010.0,1,1,0
NOR,OMN,2017.0,2,1,1
FRA,BFA,2001.0,1,4,-3
KHM,USA,2020.0,2,5,-3
MLT,USA,2003.0,1,1,0
PHL,DNK,2009.0,1,1,0
BEL,SGP,2006.0,4,2,2
HKG,CHE,2010.0,1,7,-6
TUR,DNK,2012.0,4,1,3
LKA,KEN,2016.0,1,1,0
GEO,DEU,2008.0,3,9,-6
GRC,BEL,1997.0,2,2,0
BRA,ISR,2021.0,3,2,1
KOR,BEL,2002.0,1,1,0
ITA,SYR,2013.0,1,1,0
NER,FRA,2020.0,3,5,-2
RUS,EST,2003.0,1,1,0
GBR,ECU,2011.0,1,2,-1
PYF,CAN,2017.0,1,1,0
FIN,LVA,2018.0,1,2,-1
CAN,SRB,1998.0,1,1,0
RUS,GEO,2008.0,3,4,-1
CZE,SVN,2019.0,1,2,-1
SDN,GBR,2014.0,2,2,0
POL,ISR,1999.0,1,1,0
NGA,IRL,2010.0,1,2,-1
NLD,BEN,2013.0,1,1,0
NOR,BGD,2014.0,1,2,-1
RWA,BEL,2007.0,1,1,0
BGR,GRC,2019.0,1,1,0
FRA,ISL,2021.0,1,1,0
LTU,GBR,2002.0,2,1,1
CHL,CUB,2018.0,1,17,-16
CMR,SEN,1999.0,1,1,0
YEM,USA,2008.0,1,1,0
ISR,CZE,2014.0,1,1,0
IRN,ITA,2001.0,1,2,-1
USA,MLI,2004.0,4,1,3
HKG,PAK,2017.0,1,6,-5
BGD,SWE,2016.0,4,8,-4
CHN,ECU,2020.0,1,1,0
IRQ,EGY,2019.0,1,10,-9
CHL,TUR,2016.0,1,1,0
ITA,MAR,2013.0,1,2,-1
BTN,IND,2006.0,1,1,0
IRN,FRA,2004.0,1,10,-9
KWT,DEU,2014.0,1,4,-3
PRI,GBR,2020.0,1,1,0
EGY,LTU,2019.0,1,1,0
MUS,AUS,2020.0,1,3,-2
COL,CUB,2004.0,1,1,0
UKR,KAZ,2019.0,1,2,-1
OMN,CAN,2006.0,1,6,-5
SAU,BGD,2020.0,1,6,-5
PHL,HKG,2017.0,2,1,1
CIV,CHN,2020.0,1,1,0
ZAF,OMN,2016.0,1,1,0
TUR,ETH,2022.0,2,1,1
GTM,COL,2008.0,1,2,-1
BGR,GRC,2017.0,1,4,-3
BLZ,USA,2014.0,2,1,1
BGD,THA,2022.0,3,2,1
NLD,MKD,2011.0,1,1,0
BGR,JPN,2009.0,1,4,-3
AUT,HRV,2001.0,1,2,-1
JPN,UZB,2002.0,1,1,0
GBR,NPL,2012.0,1,7,-6
SGP,PHL,2011.0,1,1,0
THA,KEN,2008.0,1,1,0
COL,PRT,2007.0,1,1,0
SWE,KEN,2008.0,1,1,0
GBR,BLR,2008.0,1,4,-3
HRV,CHN,2010.0,1,2,-1
CHE,ZWE,2006.0,1,2,-1
PER,VEN,2021.0,1,2,-1
CHN,PRK,2014.0,1,1,0
NLD,IND,2000.0,1,6,-5
HRV,SVN,1999.0,1,3,-2
BRA,URY,2001.0,1,2,-1
SRB,ITA,2011.0,1,6,-5
BRA,HKG,2012.0,1,1,0
CMR,NLD,2005.0,1,1,0
LUX,BRA,2020.0,1,2,-1
ZAF,CHL,2020.0,1,1,0
ARE,MYS,2012.0,1,5,-4
TZA,NGA,2007.0,1,1,0
COG,COD,2016.0,34,14,20
USA,SAU,2014.0,143,68,75
CHN,AUS,2016.0,313,260,53
USA,THA,2021.0,110,69,41
CAN,CHN,2009.0,114,162,-48
USA,NPL,2014.0,15,17,-2
USA,ZAF,1997.0,4,5,-1
DNK,IRN,2009.0,6,6,0
CHN,DEU,2006.0,94,124,-30
DEU,AUT,2010.0,308,247,61
AUS,CHE,1999.0,6,13,-7
FRA,LUX,2016.0,28,15,13
DEU,AUT,2017.0,316,316,0
ESP,FRA,2011.0,197,178,19
SGP,GBR,2007.0,47,63,-16
IRN,USA,2016.0,547,80,467
ISR,CAN,2000.0,7,6,1
POL,DNK,2014.0,16,5,11
FRA,MLI,2022.0,2,2,0
ESP,CHN,2015.0,22,24,-2
EGY,USA,2011.0,55,91,-36
JPN,PRT,2018.0,6,7,-1
GBR,ISR,2016.0,42,64,-22
ITA,FRA,2016.0,348,231,117
MYS,NGA,2022.0,30,22,8
CHN,SWE,2020.0,89,91,-2
HKG,PAK,2019.0,5,11,-6
KOR,JPN,2004.0,85,127,-42
MAR,USA,2016.0,8,5,3
BGD,CAN,2019.0,29,21,8
PRT,ESP,2020.0,100,108,-8
DEU,LUX,2015.0,25,11,14
IRL,NLD,2018.0,24,17,7
IND,ARE,2007.0,6,4,2
PAK,GBR,2022.0,47,27,20
DEU,UKR,2021.0,6,27,-21
BLR,RUS,2009.0,10,9,1
ESP,DEU,2006.0,79,104,-25
DEU,PRT,2022.0,11,15,-4
SGP,FRA,2016.0,22,35,-13
TWN,GBR,2008.0,13,35,-22
CAN,HUN,2017.0,7,9,-2
USA,PAN,2009.0,12,7,5
CHE,FRA,2003.0,169,247,-78
KOR,FRA,2011.0,19,25,-6
IRN,ISL,2017.0,3,1,2
ESP,URY,2018.0,21,6,15
ITA,CAN,1997.0,5,5,0
SGP,IDN,2013.0,8,1,7
NLD,MEX,2016.0,9,13,-4
NLD,HUN,2018.0,8,17,-9
IND,LKA,2018.0,7,6,1
GHA,USA,2017.0,24,31,-7
GBR,PER,2014.0,5,4,1
MYS,FIN,2018.0,2,1,1
USA,IDN,2022.0,7,5,2
CZE,CHE,2004.0,5,7,-2
IRN,SWE,2022.0,17,4,13
LUX,FRA,2021.0,18,15,3
TWN,CHE,2020.0,8,3,5
HKG,MAC,2020.0,17,11,6
CHN,BRA,2013.0,5,3,2
NGA,ZAF,2011.0,31,13,18
DEU,ITA,2000.0,48,58,-10
GBR,DNK,2000.0,21,14,7
AUS,JOR,2006.0,5,1,4
MDG,BEL,2008.0,1,1,0
POL,SVK,2002.0,4,6,-2
MEX,TUR,2012.0,2,1,1
NZL,FRA,2012.0,13,15,-2
AUS,FIN,2016.0,10,20,-10
JPN,TZA,2012.0,5,3,2
IND,OMN,2007.0,6,4,2
AUS,POL,2009.0,8,13,-5
CHN,ISR,2022.0,14,21,-7
CHE,GBR,1997.0,18,18,0
CHN,PAK,2001.0,1,1,0
CMR,CAN,2018.0,2,1,1
KOR,RUS,2007.0,11,9,2
POL,BEL,2011.0,9,20,-11
ETH,NOR,2013.0,8,4,4
USA,MLT,2012.0,2,3,-1
AUT,CHN,2005.0,7,5,2
FRA,HUN,2017.0,14,13,1
SWE,ARG,2020.0,4,6,-2
COL,AUS,2013.0,8,2,6
BGD,CAN,2010.0,10,7,3
JPN,AUS,2004.0,43,22,21
BGR,ITA,1999.0,5,2,3
CHE,NOR,2006.0,7,6,1
THA,KHM,2020.0,4,3,1
EST,FIN,2006.0,2,6,-4
EGY,JPN,2017.0,17,42,-25
TZA,USA,2017.0,14,17,-3
JPN,AUT,2004.0,6,6,0
JAM,TTO,2018.0,2,1,1
MDG,NER,2004.0,2,1,1
KOR,CHN,1999.0,4,4,0
FIN,JPN,2014.0,10,7,3
BIH,CAN,2004.0,1,1,0
AUT,ARG,2003.0,4,2,2
USA,RWA,2011.0,2,4,-2
GHA,USA,2010.0,5,10,-5
GBR,MDG,2014.0,1,1,0
NZL,PRT,2020.0,2,3,-1
PRT,NLD,2008.0,17,19,-2
BRA,NOR,2011.0,4,1,3
TTO,GBR,2009.0,2,4,-2
EGY,ITA,2017.0,5,12,-7
NLD,QAT,2016.0,3,3,0
CHL,GBR,2000.0,2,1,1
ITA,CAN,1998.0,7,7,0
FIN,NLD,2004.0,8,7,1
DNK,PAK,2017.0,1,2,-1
BEL,CZE,2011.0,7,5,2
KWT,AUS,2016.0,4,3,1
TWN,FRA,1998.0,2,1,1
NZL,FIN,2010.0,2,4,-2
SDN,SAU,2009.0,5,3,2
POL,SGP,2017.0,4,1,3
FIN,RUS,2000.0,2,14,-12
CRI,USA,2003.0,6,14,-8
TZA,UGA,2013.0,3,1,2
BEL,NOR,2009.0,3,4,-1
USA,GTM,2007.0,4,5,-1
THA,DNK,2017.0,2,2,0
CZE,PRT,2021.0,2,4,-2
NCL,AUS,2022.0,1,2,-1
EST,SWE,2002.0,6,13,-7
HUN,DNK,2013.0,3,4,-1
PHL,ITA,2013.0,1,1,0
PRT,ISR,2008.0,1,2,-1
BEL,KOR,2009.0,3,1,2
THA,SGP,2007.0,4,5,-1
IND,PRI,2006.0,2,2,0
ESP,KOR,2018.0,5,9,-4
MLI,USA,2005.0,1,6,-5
DEU,QAT,2012.0,1,1,0
GBR,DZA,2021.0,3,1,2
NLD,CZE,2013.0,8,9,-1
USA,MKD,2014.0,3,4,-1
FIN,PRT,2015.0,3,7,-4
TUR,IND,2003.0,1,2,-1
ESP,PRI,2007.0,2,3,-1
CUB,CHL,2014.0,5,1,4
SGP,NLD,2013.0,4,14,-10
PER,CAN,2016.0,4,2,2
JOR,FRA,2012.0,2,2,0
GBR,SDN,2015.0,2,1,1
SWE,UKR,2000.0,1,6,-5
LUX,GRC,2017.0,1,3,-2
SAU,LBY,2014.0,1,5,-4
THA,TWN,2013.0,3,3,0
KEN,BEL,2021.0,2,2,0
OMN,JPN,2017.0,1,3,-2
CHE,IND,2001.0,2,8,-6
SVN,ISR,2014.0,1,1,0
EST,SWE,2005.0,2,5,-3
CMR,CHE,2004.0,1,1,0
MOZ,ESP,2010.0,2,4,-2
NGA,ETH,2005.0,1,1,0
CUB,COL,2011.0,1,2,-1
PHL,BGD,2020.0,1,2,-1
LKA,AUS,2006.0,3,5,-2
USA,MNG,2021.0,2,2,0
ARG,BEL,2020.0,4,1,3
ETH,MYS,2016.0,1,2,-1
IRN,TWN,2012.0,2,2,0
FIN,SVN,2013.0,1,1,0
ZAF,NZL,2006.0,3,3,0
JPN,SRB,2017.0,1,3,-2
BGD,TWN,2014.0,1,1,0
AZE,PAK,2020.0,1,1,0
SDN,DEU,2022.0,1,1,0
DNK,SVK,2007.0,1,2,-1
SEN,BFA,2002.0,1,2,-1
KAZ,CHE,2020.0,1,1,0
ARG,ISR,2002.0,1,3,-2
CMR,GAB,2009.0,1,1,0
AUS,ITA,1997.0,1,4,-3
NOR,UGA,2014.0,1,1,0
URY,ITA,2020.0,1,1,0
CHN,,2009.0,25293,0,25293
,NLD,2007.0,5958,0,5958
IND,,2009.0,4692,0,4692
HUN,,2023.0,6228,0,6228
NGA,,2019.0,1104,0,1104
ARG,,2022.0,6041,0,6041
,PRI,2004.0,143,0,143
,CHE,2002.0,3564,0,3564
ISR,,2014.0,1436,0,1436
,AUS,1994.0,5237,0,5237
ITA,,2012.0,6692,0,6692
,PER,2004.0,236,0,236
,IDN,2007.0,643,0,643
DEU,,1999.0,944,0,944
,BRA,2006.0,16605,0,16605
,SAU,1999.0,643,0,643
FIN,,2018.0,1929,0,1929
,CHE,2005.0,3464,0,3464
,HKG,2003.0,1301,0,1301
PER,,2023.0,2399,0,2399
HKG,,2024.0,12326,0,12326
SWE,,2009.0,1953,0,1953
,UGA,2002.0,124,0,124
MEX,,2015.0,1933,0,1933
,DEU,2011.0,23636,0,23636
EGY,,2021.0,3637,0,3637
,BGD,2003.0,372,0,372
SAU,,2023.0,7860,0,7860
GRC,,2008.0,965,0,965
,ITA,2011.0,15153,0,15153
MAR,EGY,2015.0,1,0,1
,ISR,2003.0,2514,0,2514
,SWE,2001.0,4018,0,4018
,ARE,2004.0,119,0,119
IRL,,2014.0,852,0,852
,KOR,2018.0,15010,0,15010
,RUS,2012.0,12660,0,12660
,LTU,2005.0,490,0,490
,LTU,2002.0,522,0,522
,DZA,2014.0,1699,0,1699
,AUT,2016.0,2566,0,2566
GEO,,2020.0,197,0,197
IND,GRC,2008.0,2,0,2
NGA,,2017.0,800,0,800
,SVN,1994.0,360,0,360
,HUN,2006.0,1406,0,1406
NGA,,2010.0,313,0,313
,UGA,2005.0,164,0,164
AZE,,2000.0,11,0,11
SOM,,2019.0,4,0,4
CAN,VEN,2009.0,2,0,2
,SRB,1997.0,233,0,233
BEL,,2000.0,79,0,79
,SRB,1998.0,791,0,791
ROU,,2021.0,2566,0,2566
,SVK,2012.0,1185,0,1185
OMN,,2016.0,98,0,98
,MAR,1994.0,182,0,182
CYP,,2011.0,31,0,31
MDA,,2015.0,44,0,44
,COL,2008.0,1524,0,1524
,ALB,1995.0,8,0,8
,BLR,1999.0,472,0,472
DEU,URY,2008.0,1,0,1
CHL,,2002.0,51,0,51
,SGP,1994.0,514,0,514
,KEN,2011.0,408,0,408
ETH,,2018.0,168,0,168
DNK,KEN,2019.0,1,0,1
,KAZ,2015.0,1363,0,1363
,BEL,2015.0,3276,0,3276
,VNM,2018.0,2407,0,2407
,DOM,2012.0,19,0,19
MYS,,2025.0,69,0,69
YEM,,2014.0,27,0,27
SGP,,2007.0,561,0,561
URY,,2020.0,249,0,249
CHL,,2005.0,179,0,179
PSE,,2012.0,14,0,14
IRL,IRQ,2014.0,1,0,1
,PER,1996.0,62,0,62
LBR,CHE,2016.0,1,0,1
DNK,TWN,2020.0,2,0,2
MNG,,2018.0,41,0,41
,PRI,1996.0,56,0,56
RWA,DEU,2022.0,1,0,1
PYF,,2022.0,33,0,33
NER,,2023.0,89,0,89
,BOL,2017.0,32,0,32
PRY,ARG,2020.0,2,0,2
GIN,,2021.0,25,0,25
BRA,EST,2021.0,3,0,3
,PHL,2018.0,706,0,706
SYR,HUN,2020.0,1,0,1
,BOL,2019.0,12,0,12
RUS,HUN,2021.0,2,0,2
,YEM,2018.0,39,0,39
,HND,2003.0,9,0,9
,AND,2014.0,1,0,1
SYR,,2008.0,17,0,17
,RWA,2015.0,73,0,73
VEN,NOR,2018.0,1,0,1
,COG,2006.0,56,0,56
,EST,1994.0,142,0,142
,ISL,2003.0,109,0,109
MEX,KOR,2004.0,1,0,1
DNK,KEN,2010.0,1,0,1
,ECU,2000.0,57,0,57
NLD,,2001.0,107,0,107
PRI,,2016.0,103,0,103
,NPL,1998.0,64,0,64
PAN,DEU,2012.0,2,0,2
GHA,,2016.0,78,0,78
,LUX,2013.0,127,0,127
,MWI,2000.0,50,0,50
,CRI,2000.0,97,0,97
SLV,SVN,2015.0,1,0,1
TUR,LUX,2018.0,2,0,2
ARG,ECU,2015.0,7,0,7
MDV,USA,2020.0,2,0,2
LBN,,2002.0,7,0,7
KAZ,VUT,2019.0,1,0,1
,ARE,1996.0,40,0,40
,COM,2007.0,1,0,1
,ZMB,2003.0,30,0,30
,QAT,2007.0,70,0,70
,SYR,1998.0,80,0,80
FRA,HTI,2007.0,1,0,1
LTU,,2007.0,66,0,66
,PNG,2001.0,30,0,30
,KHM,1999.0,9,0,9
,SWZ,2006.0,10,0,10
,LSO,1995.0,3,0,3
KEN,SWE,2003.0,2,0,2
ROU,CAN,2005.0,3,0,3
ZWE,BWA,2010.0,3,0,3
ZWE,,2003.0,15,0,15
LSO,NGA,1999.0,1,0,1
,SYR,1997.0,15,0,15
BRA,SRB,2005.0,2,0,2
SWE,MWI,2016.0,1,0,1
SVK,BRA,2006.0,1,0,1
DNK,LTU,2004.0,1,0,1
NOR,TZA,2001.0,2,0,2
PER,CHL,1998.0,2,0,2
JPN,LKA,2008.0,2,0,2
ESP,MLT,2007.0,1,0,1
SDN,CAN,2002.0,1,0,1
ZWE,FRA,2009.0,1,0,1
IRQ,,2007.0,13,0,13
HRV,,2000.0,9,0,9
USA,AFG,2002.0,1,0,1
SVK,SWE,2003.0,2,0,2
BHR,,2004.0,8,0,8
POL,GRC,2001.0,3,0,3
ESP,TUR,1997.0,1,0,1
TJK,RUS,2001.0,4,0,4
DNK,BRA,2000.0,2,0,2
JPN,MLT,1998.0,1,0,1
CZE,EGY,2002.0,1,0,1
SDN,ITA,1999.0,1,0,1
PHL,VNM,2006.0,1,0,1
BLR,POL,2012.0,2,0,2
ETH,MEX,2013.0,3,0,3
CAN,SVN,1998.0,3,0,3
GHA,PER,2016.0,1,0,1
KWT,,2003.0,17,0,17
HND,ESP,2008.0,1,0,1
IRL,ALB,2007.0,1,0,1
POL,SGP,2010.0,3,0,3
NZL,QAT,2015.0,1,0,1
HUN,EGY,2009.0,3,0,3
ARG,ISR,2005.0,2,0,2
KWT,TUN,2003.0,1,0,1
JPN,WSM,2017.0,1,0,1
,REU,2005.0,7,0,7
LBN,,2005.0,33,0,33
PER,AUS,2011.0,1,0,1
SYC,FRA,2008.0,1,0,1
MWI,MYS,2011.0,1,0,1
ARE,SDN,2017.0,2,0,2
FRA,BRN,2016.0,1,0,1
MCO,,2020.0,12,0,12
,BOL,2010.0,41,0,41
IRN,PRI,2014.0,1,0,1
CHN,TUN,2015.0,2,0,2
NZL,SAU,2011.0,1,0,1
CIV,BFA,2019.0,1,0,1
EST,GEO,2017.0,1,0,1
MOZ,ESP,2017.0,3,0,3
AFG,GUF,2021.0,1,0,1
ESP,NGA,2015.0,1,0,1
NLD,MWI,2021.0,2,0,2
HUN,KAZ,2021.0,1,0,1
VGB,GBR,2016.0,1,0,1
LTU,HUN,2020.0,1,0,1
MOZ,ESP,2019.0,3,0,3
NPL,BGD,2006.0,1,0,1
MDG,,2008.0,16,0,16
MLI,DNK,2015.0,1,0,1
CAN,IRQ,2010.0,1,0,1
CMR,ITA,2007.0,1,0,1
FRA,TCD,2018.0,1,0,1
ZMB,,2015.0,25,0,25
PRY,ESP,2004.0,1,0,1
MYS,MUS,2019.0,1,0,1
GMB,CAN,2022.0,1,0,1
,SYC,2008.0,2,0,2
ITA,BOL,2016.0,4,0,4
IRQ,EGY,2010.0,1,0,1
GIN,CAN,2020.0,1,0,1
ITA,PRK,2018.0,1,0,1
NZL,TWN,2018.0,3,0,3
KHM,,2006.0,4,0,4
ITA,MLI,2018.0,2,0,2
JPN,LTU,2004.0,1,0,1
SGP,HUN,2022.0,1,0,1
ZWE,BWA,2017.0,1,0,1
IND,HRV,2022.0,3,0,3
SWE,HKG,2006.0,1,0,1
DMA,,2007.0,1,0,1
USA,KNA,2009.0,2,0,2
,SLB,1995.0,1,0,1
SLB,AUS,1999.0,1,0,1
,NPL,1997.0,5,0,5
GRC,LUX,2016.0,3,0,3
ITA,BDI,2009.0,1,0,1
BLR,SWE,2008.0,2,0,2
MLT,,2007.0,4,0,4
BEN,,2003.0,3,0,3
TZA,CHE,2008.0,3,0,3
GEO,GBR,2005.0,2,0,2
GRC,CHL,2014.0,2,0,2
ISR,PRT,2007.0,2,0,2
NLD,SGP,1998.0,1,0,1
GMB,IRL,2006.0,1,0,1
ERI,ETH,2012.0,1,0,1
DNK,KEN,2017.0,2,0,2
EST,CHE,2020.0,4,0,4
BLR,NOR,2015.0,2,0,2
SLE,JPN,2020.0,1,0,1
PRT,EGY,2016.0,1,0,1
MYS,KEN,2019.0,1,0,1
,KGZ,2001.0,6,0,6
BGR,POL,1999.0,1,0,1
ZAF,ESP,2005.0,1,0,1
VEN,POL,2021.0,1,0,1
BEL,BEN,2008.0,2,0,2
ESP,ETH,2014.0,2,0,2
NGA,NPL,2007.0,1,0,1
,GNQ,2000.0,2,0,2
FJI,,2004.0,2,0,2
JPN,NGA,1998.0,1,0,1
MLI,HRV,2016.0,1,0,1
HUN,CHL,2019.0,1,0,1
TWN,FIN,2001.0,1,0,1
AUS,NCL,2021.0,4,0,4
HRV,MCO,2019.0,1,0,1
SYC,,2018.0,2,0,2
ETH,DNK,2015.0,2,0,2
IND,BWA,2016.0,5,0,5
JPN,CMR,2019.0,1,0,1
JPN,KGZ,2017.0,2,0,2
SGP,ROU,2014.0,1,0,1
LAO,KOR,2015.0,1,0,1
COG,MYS,2002.0,1,0,1
VEN,CUB,2002.0,3,0,3
KGZ,,2007.0,5,0,5
NER,BFA,2003.0,1,0,1
MAR,ZAF,2016.0,1,0,1
CMR,COG,2010.0,1,0,1
GEO,GBR,2002.0,1,0,1
URY,ZAF,2003.0,1,0,1
CHE,PAN,2018.0,2,0,2
FRA,ZMB,2017.0,1,0,1
POL,MDA,1999.0,5,0,5
DNK,ZWE,2003.0,1,0,1
SAU,AZE,2012.0,1,0,1
MEX,DNK,1997.0,1,0,1
PHL,TTO,2017.0,1,0,1
TUR,SVN,1999.0,1,0,1
USA,SUR,2013.0,1,0,1
PRT,MAR,1998.0,1,0,1
DZA,MEX,2005.0,1,0,1
AUT,KEN,1999.0,1,0,1
MYS,BRA,2006.0,1,0,1
ERI,KEN,2007.0,1,0,1
JOR,HUN,2020.0,1,0,1
NLD,JOR,2018.0,1,0,1
BMU,,2014.0,3,0,3
JPN,KGZ,2019.0,1,0,1
,VUT,2014.0,2,0,2
UGA,CIV,2011.0,1,0,1
JPN,FJI,2009.0,2,0,2
DNK,EGY,2014.0,2,0,2
ITA,URY,2014.0,2,0,2
MUS,MYS,2014.0,1,0,1
LBY,GRC,2012.0,1,0,1
GRC,TTO,2019.0,1,0,1
GRC,HUN,2022.0,1,0,1
BRA,LTU,2017.0,1,0,1
BRA,LTU,2019.0,1,0,1
,BDI,2014.0,10,0,10
BFA,CIV,2022.0,3,0,3
YEM,ESP,2019.0,1,0,1
PRT,NAM,2021.0,1,0,1
MKD,GRC,2007.0,1,0,1
SVN,USA,2022.0,7,0,7
ECU,AUT,2021.0,2,0,2
JPN,JOR,2009.0,2,0,2
ARG,PER,2004.0,1,0,1
MYS,IRL,2000.0,1,0,1
VEN,AUS,2021.0,2,0,2
KOR,NGA,2018.0,4,0,4
TUR,FIN,2009.0,3,0,3
THA,DNK,2019.0,3,0,3
KAZ,SGP,2020.0,4,0,4
IRN,HUN,2020.0,5,0,5
RUS,ZWE,2021.0,1,0,1
CMR,,2000.0,1,0,1
FRA,SYR,2000.0,1,0,1
ZAF,BFA,2002.0,1,0,1
SUR,,2007.0,1,0,1
ESP,KEN,2012.0,1,0,1
YEM,AUS,2015.0,1,0,1
,AFG,2003.0,2,0,2
SGP,MAC,2020.0,3,0,3
YEM,JPN,2017.0,1,0,1
COL,ISR,2019.0,2,0,2
CHL,AUT,2009.0,1,0,1
DEU,SDN,2009.0,4,0,4
BGR,LVA,2020.0,1,0,1
BFA,DEU,2021.0,2,0,2
ISR,ARM,2017.0,2,0,2
JPN,SRB,2019.0,1,0,1
CMR,SWE,2003.0,1,0,1
KEN,MEX,2008.0,1,0,1
JPN,NER,2010.0,1,0,1
AUS,ISR,1999.0,4,0,4
AND,ESP,2004.0,1,0,1
IRL,PAN,2011.0,1,0,1
HKG,LKA,2016.0,2,0,2
MNG,FRA,2008.0,2,0,2
VEN,IND,2014.0,1,0,1
MYS,MUS,2017.0,1,0,1
DZA,SGP,2018.0,1,0,1
ARM,USA,2004.0,2,0,2
PSE,BEL,2021.0,3,0,3
CHN,MUS,2021.0,1,0,1
TWN,JOR,2009.0,1,0,1
BIH,SAU,2016.0,1,0,1
LAO,VNM,2011.0,1,0,1
SVN,TUR,2003.0,1,0,1
GRC,SAU,2003.0,1,0,1
SOM,,2017.0,2,0,2
IRQ,HUN,2020.0,5,0,5
KAZ,KHM,2019.0,1,0,1
NPL,CHE,2020.0,1,0,1
GHA,TGO,2020.0,1,0,1
CAN,GTM,2003.0,1,0,1
ISL,CHL,2011.0,1,0,1
MDG,DNK,2004.0,1,0,1
JPN,ETH,2001.0,1,0,1
BLR,ESP,2007.0,1,0,1
USA,AFG,2005.0,2,0,2
SEN,NER,2018.0,3,0,3
SLE,CHN,2018.0,2,0,2
ARE,ARG,2012.0,1,0,1
ESP,JOR,2009.0,1,0,1
ARG,ZAF,2007.0,1,0,1
ESP,GTM,2008.0,1,0,1
CHL,ISR,2014.0,1,0,1
JOR,UKR,2013.0,1,0,1
LTU,SWE,2022.0,2,0,2
CHN,SRB,2015.0,1,0,1
SAU,RWA,2012.0,1,0,1
EST,NGA,2012.0,1,0,1
PRT,MAC,2013.0,2,0,2
SAU,CRI,2016.0,1,0,1
IRQ,KAZ,2018.0,1,0,1
SWE,BTN,2019.0,1,0,1
SYR,GBR,2020.0,3,0,3
SEN,AUT,2022.0,1,0,1
URY,CUB,2000.0,1,0,1
LBN,DEU,2006.0,1,0,1
ZAF,BGD,2022.0,1,0,1
PAK,ARE,2001.0,1,0,1
USA,CYP,1998.0,1,0,1
HKG,SVK,2015.0,1,0,1
KEN,NLD,2000.0,1,0,1
ISR,SVN,2008.0,1,0,1
SWE,NGA,1997.0,1,0,1
UZB,JPN,2004.0,1,0,1
FRA,PHL,2008.0,1,0,1
GHA,TUN,2016.0,1,0,1
MRT,SEN,2001.0,1,0,1
MKD,DEU,2001.0,1,0,1
ITA,MKD,2001.0,1,0,1
VNM,TUN,2021.0,1,0,1
THA,DNK,2010.0,2,0,2
MYS,ESP,2013.0,2,0,2
GRC,MEX,2015.0,1,0,1
AZE,OMN,2008.0,1,0,1
MUS,BWA,2019.0,1,0,1
BRN,GHA,2020.0,1,0,1
POL,PER,2015.0,1,0,1
AUT,LBN,2021.0,1,0,1
NZL,ESP,2007.0,2,0,2
CRI,COL,2013.0,4,0,4
NLD,IRQ,2013.0,2,0,2
DEU,MAC,2001.0,1,0,1
AUT,PRT,2011.0,4,0,4
IND,LTU,2011.0,1,0,1
USA,ABW,2010.0,1,0,1
CZE,LBY,2011.0,2,0,2
BHR,DEU,2017.0,1,0,1
PAK,MAC,2020.0,2,0,2
NGA,GHA,1999.0,1,0,1
DNK,GRC,1999.0,1,0,1
LAO,JPN,2002.0,2,0,2
CMR,GBR,2007.0,5,0,5
BWA,BRN,2006.0,1,0,1
,GIB,1999.0,1,0,1
SVN,IRN,2004.0,1,0,1
PRT,ARE,2013.0,1,0,1
SVN,POL,2007.0,1,0,1
CMR,COG,2017.0,1,0,1
POL,EST,2013.0,1,0,1
PRT,FIN,2007.0,2,0,2
USA,TON,2018.0,1,0,1
IRL,KHM,2013.0,1,0,1
ITA,HKG,2014.0,2,0,2
ARE,RUS,2018.0,3,0,3
SDN,PAK,2011.0,1,0,1
BEL,BDI,2015.0,2,0,2
KHM,ITA,2016.0,1,0,1
USA,MHL,2014.0,1,0,1
IND,AFG,2018.0,1,0,1
SWE,SVK,2021.0,1,0,1
PER,IDN,2006.0,1,0,1
CHN,IRL,2001.0,1,0,1
UKR,EST,2012.0,2,0,2
,REU,2002.0,1,0,1
CRI,SWE,2015.0,2,0,2
TUR,POL,2022.0,2,0,2
NAM,POL,2017.0,1,0,1
BRN,,2001.0,1,0,1
SVN,KOR,2009.0,1,0,1
AUS,BHS,2016.0,1,0,1
LTU,ISR,2016.0,3,0,3
MLI,GAB,2003.0,1,0,1
KNA,CAN,2022.0,1,0,1
NPL,PHL,2013.0,1,0,1
ESP,DOM,2013.0,1,0,1
GBR,PSE,2014.0,4,0,4
NOR,TGO,2013.0,2,0,2
BEN,PER,2020.0,1,0,1
ECU,HND,2020.0,1,0,1
CUB,ITA,2021.0,1,0,1
FJI,NZL,2021.0,3,0,3
NER,TUN,2006.0,1,0,1
ESP,ROU,1998.0,1,0,1
,TON,1999.0,3,0,3
SAU,BHR,2007.0,2,0,2
CAN,MLT,2008.0,1,0,1
TUR,TUN,2012.0,1,0,1
NGA,ETH,2002.0,1,0,1
SAU,ARE,1998.0,2,0,2
FIN,URY,2010.0,1,0,1
SAU,JPN,1999.0,4,0,4
HRV,FIN,2012.0,1,0,1
MKD,TUR,2002.0,2,0,2
TJK,GBR,2010.0,1,0,1
BEL,REU,2009.0,2,0,2
MCO,USA,2006.0,1,0,1
KEN,KWT,2013.0,1,0,1
GHA,MYS,2011.0,1,0,1
ROU,SVK,2014.0,1,0,1
USA,MUS,2016.0,1,0,1
CHE,TWN,2002.0,1,0,1
ERI,JPN,2011.0,1,0,1
ZAF,LUX,2016.0,1,0,1
BIH,EGY,2019.0,1,0,1
IRN,LTU,2021.0,4,0,4
ITA,DZA,2021.0,1,0,1
FRA,CYP,2018.0,2,0,2
NLD,LKA,2021.0,1,0,1
SRB,HUN,1997.0,1,0,1
BRA,GNB,2009.0,1,0,1
SRB,HUN,1998.0,1,0,1
KWT,YEM,2014.0,1,0,1
SLE,AUS,2022.0,1,0,1
ROU,ARG,2016.0,1,0,1
PHL,KHM,2014.0,1,0,1
NLD,BGD,2005.0,1,0,1
ESP,TWN,1998.0,1,0,1
ARG,AUT,2006.0,2,0,2
UKR,PRT,2011.0,2,0,2
MUS,,2008.0,3,0,3
OMN,JPN,2019.0,2,0,2
POL,NOR,1998.0,1,0,1
CHE,IRQ,2008.0,1,0,1
ESP,MYS,2010.0,1,0,1
MWI,JPN,2014.0,1,0,1
ISR,NGA,2013.0,1,0,1
COM,,2020.0,3,0,3
BFA,NLD,2018.0,1,0,1
CHL,NOR,2022.0,1,0,1
IRQ,ETH,2021.0,1,0,1
VEN,CHE,2016.0,2,0,2
DEU,UGA,1999.0,1,0,1
CAN,LUX,2022.0,2,0,2
KOR,SVN,2021.0,1,0,1
SVN,MNE,2013.0,1,0,1
CHN,UGA,2014.0,1,0,1
NGA,ZWE,2018.0,1,0,1
IRN,ISL,2019.0,1,0,1
MWI,NLD,2007.0,1,0,1
BGD,NOR,2006.0,1,0,1
CUB,PRI,2006.0,1,0,1
IRQ,ITA,2009.0,1,0,1
NGA,MEX,2016.0,1,0,1
ISR,SRB,2011.0,1,0,1
ZAF,GRD,2021.0,1,0,1
SEN,CZE,2020.0,1,0,1
UGA,CUB,2016.0,1,0,1
USA,QAT,2000.0,1,0,1
CHL,CRI,1999.0,1,0,1
POL,LVA,2019.0,1,0,1
CMR,PAK,2013.0,1,0,1
TWN,MNG,2018.0,1,0,1
GHA,BRB,2020.0,1,0,1
TWN,BRA,2021.0,1,0,1
NER,ITA,2020.0,1,0,1
NGA,IRL,2019.0,2,0,2
JPN,SLV,2021.0,1,0,1
SAU,TUN,2003.0,1,0,1
CHN,BRN,2014.0,1,0,1
HKG,UKR,2007.0,1,0,1
ALB,,2006.0,1,0,1
CHN,PSE,2012.0,1,0,1
IRL,BRN,2009.0,1,0,1
TUR,ALB,2008.0,1,0,1
CUW,,2023.0,1,0,1
EGY,IRN,2005.0,1,0,1
CHN,BDI,2013.0,1,0,1
CZE,NZL,2006.0,1,0,1
LSO,USA,2011.0,1,0,1
FRA,MOZ,2014.0,1,0,1
MMR,KOR,2015.0,1,0,1
GRL,NOR,2015.0,1,0,1
COL,ISR,2017.0,1,0,1
SWE,PRT,1998.0,1,0,1
COG,BEN,2018.0,1,0,1
AUS,LBY,2009.0,1,0,1
EGY,ISR,2005.0,1,0,1
FIN,UGA,2011.0,1,0,1
PSE,GRC,2018.0,1,0,1
CHE,VEN,2017.0,2,0,2
ZWE,BEL,2004.0,1,0,1
DEU,KWT,2000.0,1,0,1
UKR,LTU,2015.0,1,0,1
KOR,AZE,2021.0,1,0,1
PER,DNK,2019.0,1,0,1
AUS,ZMB,2009.0,1,0,1
BRN,GRC,2020.0,1,0,1
BFA,GIN,2005.0,1,0,1
LSO,,2018.0,1,0,1
NLD,TCA,2020.0,1,0,1
SRB,ZAF,2021.0,1,0,1
PAK,FIN,2023.0,1,0,1
EGY,BHR,2005.0,1,0,1
ARM,CAN,2015.0,1,0,1
COG,ZWE,2013.0,1,0,1
BGD,EGY,2009.0,1,0,1
SVK,MKD,2022.0,1,0,1
COG,MWI,2013.0,1,0,1
JPN,HRV,2020.0,3,0,3
PAK,BRA,2001.0,1,0,1
PER,DNK,2010.0,1,0,1
ITA,TGO,2020.0,1,0,1
MEX,VEN,2022.0,1,0,1
HUN,CHL,2017.0,1,0,1
PAK,KHM,2017.0,1,0,1
MYS,TUR,2003.0,1,0,1
MAR,ROU,2022.0,1,0,1
IND,PAK,2023.0,1,0,1
CCK,CHE,2019.0,1,0,1
THA,MMR,2012.0,1,0,1
DZA,,2001.0,1,0,1
SDN,USA,2003.0,1,0,1
MYS,MAR,2014.0,2,0,2
JPN,AFG,2012.0,1,0,1
COL,UKR,2004.0,1,0,1
SRB,KWT,2005.0,1,0,1
NAM,KEN,2001.0,1,0,1
PHL,BEL,2009.0,1,0,1
POL,KNA,2020.0,1,0,1
NLD,ARE,2004.0,1,0,1
BHR,JOR,2004.0,1,0,1
RUS,ARE,2003.0,1,0,1
AUT,MNE,2018.0,1,0,1
IND,SRB,2003.0,1,0,1
FJI,BHR,2011.0,1,0,1
MWI,NGA,2006.0,1,0,1
SAU,NZL,2004.0,1,0,1
IND,GEO,2007.0,1,0,1
CAN,SMR,2017.0,1,0,1
JPN,QAT,2004.0,1,0,1
CHN,TTO,2019.0,1,0,1
,ATG,2012.0,1,0,1
KOR,ESP,2000.0,1,0,1
CHN,TTO,2017.0,1,0,1
VEN,NZL,1997.0,1,0,1
ESP,ROU,1997.0,1,0,1
GRC,ZAF,2010.0,1,0,1
,CCK,2007.0,1,0,1
KEN,NZL,2005.0,1,0,1
HRV,KOR,2015.0,1,0,1
IRL,MUS,2003.0,1,0,1
JPN,GEO,2003.0,1,0,1
HTI,,2008.0,1,0,1
NGA,BWA,1998.0,1,0,1
YEM,QAT,2008.0,1,0,1
CMR,BDI,2020.0,1,0,1
POL,NPL,2022.0,1,0,1
SVK,MAC,2020.0,1,0,1
SVK,AUS,2022.0,1,0,1
HKG,KAZ,2014.0,1,0,1
CZE,MEX,2001.0,1,0,1
KOR,SDN,2019.0,1,0,1
COL,PAN,2001.0,1,0,1
BRN,CHE,2022.0,1,0,1
PAK,OMN,2003.0,1,0,1
SRB,CHN,2009.0,1,0,1
IDN,DEU,1998.0,1,0,1
ISR,BHS,2020.0,1,0,1
CHN,THA,2001.0,1,0,1
CAN,COG,2020.0,1,0,1
RUS,TUN,2011.0,1,0,1
IND,SYC,2017.0,1,0,1
CYP,LBN,2020.0,1,0,1
USA,ABW,2019.0,1,0,1
HUN,JOR,2022.0,1,0,1
PER,IND,2011.0,1,0,1
AUS,MCO,2020.0,1,0,1
THA,BRN,2002.0,1,0,1
BLR,EST,2020.0,1,0,1
UKR,ISR,2022.0,1,0,1
CZE,BGR,2014.0,2,2,0
USA,CAN,2001.0,784,1028,-244
DEU,RUS,2014.0,91,99,-8
BRA,USA,2004.0,224,221,3
NLD,CHE,2009.0,54,54,0
ITA,USA,2014.0,604,329,275
CHE,FRA,2012.0,175,303,-128
GBR,OMN,2012.0,10,4,6
AUT,ITA,2017.0,49,92,-43
ARG,FRA,2015.0,38,26,12
DEU,AUS,2009.0,131,103,28
FRA,DEU,2006.0,248,246,2
GBR,TUR,2012.0,49,28,21
FRA,GBR,2019.0,461,444,17
SWE,USA,2004.0,200,182,18
NZL,CAN,2007.0,25,30,-5
AUT,ITA,2010.0,24,34,-10
ESP,VEN,2007.0,18,24,-6
BEL,NLD,2007.0,92,84,8
PRT,ESP,2004.0,19,19,0
POL,ITA,2015.0,32,20,12
DEU,ARG,2017.0,28,30,-2
AUS,SGP,2010.0,49,62,-13
CAN,JPN,2005.0,58,96,-38
GBR,POL,2011.0,80,53,27
USA,PRI,2009.0,53,79,-26
PHL,GBR,2006.0,4,4,0
FRA,CAN,2009.0,266,180,86
FRA,DNK,2011.0,24,21,3
GBR,IDN,2002.0,4,7,-3
SWE,DEU,2021.0,105,135,-30
GBR,BEL,2009.0,75,76,-1
NLD,KEN,2011.0,9,2,7
CHE,SWE,2010.0,41,30,11
RUS,DEU,2006.0,117,72,45
IND,KOR,2013.0,175,105,70
GBR,AUT,2013.0,77,71,6
IRL,USA,2016.0,180,122,58
KOR,GBR,2005.0,20,34,-14
CAN,IND,2019.0,85,158,-73
NLD,BEL,2021.0,142,137,5
TUR,ITA,2012.0,7,12,-5
GBR,FRA,2004.0,255,316,-61
CHN,CAN,2016.0,304,272,32
RUS,USA,2009.0,166,112,54
SAU,USA,2004.0,22,50,-28
SGP,ARE,2020.0,10,2,8
ARG,ESP,2009.0,67,74,-7
RUS,AUT,2020.0,13,5,8
AUS,FRA,2008.0,45,72,-27
ITA,ESP,2006.0,87,93,-6
USA,RUS,2008.0,137,171,-34
DEU,CHN,2000.0,30,48,-18
CHN,KOR,2009.0,66,77,-11
JPN,NLD,2012.0,19,10,9
HKG,CHN,2020.0,777,618,159
ITA,DEU,2018.0,345,215,130
HUN,AUT,2005.0,12,9,3
BEL,DNK,2015.0,15,14,1
CHE,SWE,2019.0,52,54,-2
THA,AUS,2017.0,17,28,-11
IRN,BRA,2014.0,10,1,9
JPN,TUR,2020.0,6,6,0
CHE,CAN,2004.0,41,51,-10
CHE,CHN,2001.0,9,15,-6
POL,FRA,2016.0,52,27,25
ZAF,AUS,2015.0,41,20,21
POL,AUS,2015.0,18,4,14
THA,RUS,2018.0,1,2,-1
ECU,BEL,2016.0,4,5,-1
UGA,ZAF,2016.0,7,14,-7
CAN,SVK,2018.0,2,3,-1
DEU,FRA,2021.0,231,257,-26
AUS,SGP,2019.0,79,95,-16
JPN,AUS,2020.0,49,60,-11
FIN,NLD,2020.0,22,17,5
ITA,CHE,2017.0,279,99,180
JPN,KOR,2007.0,144,83,61
SWE,SGP,2013.0,9,9,0
GBR,ESP,2001.0,118,121,-3
CHL,PRT,2021.0,3,3,0
ARG,CHL,2022.0,15,5,10
GBR,BRA,2021.0,53,103,-50
BEL,IND,2019.0,24,33,-9
IND,MYS,2017.0,77,60,17
CHN,GBR,2003.0,104,93,11
RUS,FRA,2020.0,47,49,-2
FRA,TUR,2014.0,8,14,-6
HUN,GBR,2017.0,48,36,12
USA,TZA,2015.0,17,16,1
HUN,USA,2016.0,49,48,1
CAN,EGY,2018.0,54,34,20
HKG,CAN,2016.0,39,25,14
HKG,GBR,2003.0,24,35,-11
PSE,ISR,2021.0,9,5,4
AUS,KOR,2017.0,25,57,-32
BRA,NZL,2021.0,11,1,10
SWE,RUS,1997.0,7,6,1
ROU,USA,2018.0,15,19,-4
GRC,ITA,2017.0,24,25,-1
KOR,IND,2018.0,130,198,-68
CHE,SWE,2017.0,42,50,-8
AUS,LKA,2016.0,21,17,4
MAC,CHN,2015.0,28,55,-27
IRL,ITA,2020.0,21,37,-16
LKA,MYS,2019.0,3,6,-3
MYS,SGP,2014.0,13,23,-10
BRA,CAN,2021.0,136,53,83
ROU,AUS,2021.0,3,2,1
KOR,SAU,2016.0,24,5,19
SRB,USA,2017.0,22,10,12
GBR,CZE,2000.0,12,8,4
SRB,USA,2019.0,14,14,0
GBR,PRT,2015.0,51,120,-69
IRN,FRA,2020.0,28,14,14
TTO,JAM,2004.0,2,1,1
MAR,DEU,2018.0,4,5,-1
SWE,BEL,2016.0,26,27,-1
NOR,CHN,2006.0,7,5,2
NOR,NLD,2018.0,20,34,-14
BEL,IND,2017.0,18,36,-18
SWE,TUR,2015.0,11,10,1
GBR,KWT,2019.0,16,7,9
ITA,DNK,2016.0,43,19,24
ZAF,ZMB,2021.0,10,1,9
JPN,ISR,2013.0,7,3,4
CHE,MEX,2018.0,8,7,1
CHN,TZA,2021.0,9,4,5
IDN,PAK,2017.0,2,1,1
CUB,BRA,2015.0,19,4,15
NZL,CHN,2021.0,35,31,4
DEU,NLD,2001.0,137,101,36
ESP,NLD,2020.0,89,67,22
IND,SWE,2021.0,46,20,26
AUS,KOR,2019.0,26,59,-33
PAK,ITA,2021.0,22,8,14
CAN,KOR,2015.0,35,44,-9
CHN,PRT,2022.0,6,7,-1
ESP,PAN,2022.0,3,1,2
CZE,CHE,2020.0,22,15,7
ECU,GTM,2020.0,2,1,1
CAN,CHL,2019.0,22,18,4
USA,SGP,2021.0,121,152,-31
TUR,USA,2000.0,66,43,23
EGY,IRQ,2020.0,9,7,2
CHE,BGR,2006.0,2,3,-1
ESP,ECU,2015.0,42,8,34
CZE,BRA,2021.0,3,12,-9
DEU,BGD,2013.0,8,5,3
ARE,ESP,2022.0,4,1,3
BGD,KOR,2021.0,13,24,-11
NLD,PAK,2020.0,14,7,7
FRA,PRT,2015.0,30,57,-27
NPL,IND,2018.0,9,25,-16
GAB,NLD,2021.0,1,1,0
BGR,USA,2003.0,22,8,14
AUS,ARG,2019.0,2,7,-5
CHE,NLD,2012.0,42,87,-45
DNK,GBR,2016.0,94,97,-3
PER,GBR,2011.0,3,3,0
ITA,JPN,2014.0,21,19,2
DEU,HKG,2014.0,12,13,-1
GRC,ITA,2010.0,18,20,-2
BFA,FRA,2018.0,10,16,-6
COD,COG,2022.0,21,23,-2
GBR,KAZ,2019.0,8,4,4
NOR,SWE,2016.0,36,71,-35
DEU,ZAF,2003.0,25,13,12
SVK,DEU,2003.0,22,14,8
CAN,CHL,2017.0,21,14,7
FIN,USA,2011.0,71,46,25
FIN,GBR,2008.0,42,33,9
THA,AUS,2010.0,13,34,-21
JPN,MYS,2015.0,63,33,30
FRA,VEN,2015.0,2,6,-4
AUT,SGP,2013.0,8,3,5
ARE,USA,2018.0,52,110,-58
DEU,BRA,2011.0,67,60,7
JOR,JPN,2019.0,2,2,0
ITA,IRN,2009.0,6,11,-5
DZA,FRA,2012.0,44,89,-45
KOR,NPL,2015.0,8,6,2
ZAF,TUR,2017.0,2,4,-2
DEU,IRN,2005.0,10,14,-4
RUS,UKR,2011.0,33,32,1
RUS,GBR,2013.0,39,39,0
IND,CHE,2012.0,38,18,20
GBR,IND,2000.0,15,22,-7
DNK,SVK,2002.0,2,1,1
CHN,SWE,2004.0,25,23,2
AUS,KOR,2010.0,22,34,-12
CHN,FRA,2008.0,58,58,0
CHN,RUS,2012.0,8,4,4
CAN,IND,2017.0,57,151,-94
DEU,BEL,2009.0,80,56,24
SGP,GBR,2005.0,32,48,-16
SGP,CHN,1999.0,6,45,-39
HKG,FRA,2014.0,6,7,-1
ZAF,CHN,2022.0,6,4,2
NLD,ARE,2020.0,5,5,0
MEX,DEU,2022.0,14,10,4
IRL,VNM,2018.0,2,1,1
DNK,CZE,2016.0,6,5,1
DEU,NZL,2020.0,24,26,-2
USA,EST,2017.0,11,3,8
USA,GRC,2002.0,101,79,22
ITA,ALB,2015.0,9,2,7
ITA,BEL,2000.0,11,14,-3
CAN,TWN,2006.0,13,6,7
JPN,BEL,2008.0,15,11,4
AUS,BGD,2021.0,45,54,-9
IND,DEU,1999.0,40,17,23
RUS,TWN,2009.0,4,5,-1
CAN,JPN,2002.0,85,91,-6
ITA,EST,2020.0,6,2,4
IRN,NLD,2019.0,43,16,27
DNK,GRL,2004.0,7,1,6
BRA,CZE,2020.0,15,2,13
KOR,PRT,2011.0,9,1,8
EST,CHN,2019.0,1,5,-4
CHN,EST,2021.0,2,1,1
TUN,JPN,2018.0,2,3,-1
IRN,NLD,2017.0,28,29,-1
ITA,MEX,2002.0,11,7,4
MEX,NLD,2022.0,4,3,1
FRA,IRQ,2018.0,15,1,14
GUF,FRA,2014.0,24,12,12
COL,USA,2005.0,32,29,3
AUT,CHN,2007.0,3,5,-2
IND,ITA,2021.0,38,18,20
USA,EGY,2022.0,33,45,-12
KOR,NZL,2018.0,7,6,1
CHE,LUX,2018.0,5,2,3
EGY,CHN,2015.0,8,11,-3
EGY,TWN,2022.0,3,1,2
IRN,NLD,2010.0,22,10,12
SAU,AUS,2015.0,28,42,-14
SWE,FRA,2014.0,52,82,-30
CHN,ITA,2012.0,25,28,-3
EGY,SWE,2021.0,1,4,-3
ROU,ISR,2013.0,2,3,-1
GHA,DEU,2019.0,13,17,-4
BEL,AUS,2012.0,27,13,14
CHL,HKG,2015.0,1,1,0
LAO,THA,2021.0,2,3,-1
GBR,NGA,2000.0,6,5,1
IDN,GBR,2019.0,28,32,-4
LSO,ZAF,2021.0,4,5,-1
CMR,GBR,2002.0,2,2,0
FRA,KWT,2015.0,3,1,2
JPN,PHL,2022.0,6,6,0
NZL,AUS,2001.0,49,40,9
FRA,CHE,1999.0,55,67,-12
FRA,POL,2020.0,26,24,2
DEU,LTU,2004.0,11,2,9
ETH,DEU,2022.0,4,3,1
SWE,IRN,2013.0,13,30,-17
CAN,CZE,2008.0,8,12,-4
USA,ARE,2008.0,45,14,31
USA,GRC,2005.0,89,80,9
LBN,EGY,2018.0,2,12,-10
ARM,FRA,2010.0,1,2,-1
IND,ISR,2011.0,15,13,2
GBR,PAK,2005.0,18,12,6
FIN,AUS,2018.0,22,25,-3
IRL,GRC,2011.0,3,2,1
ZAF,KOR,2021.0,1,1,0
SVK,HUN,2016.0,6,7,-1
RUS,KGZ,2008.0,1,1,0
JPN,AUT,2020.0,8,12,-4
ZAF,NAM,2003.0,4,5,-1
UKR,AUT,2013.0,4,2,2
ARG,COL,2016.0,16,11,5
MEX,URY,2015.0,2,2,0
USA,KAZ,2013.0,8,2,6
ISR,NLD,2009.0,13,11,2
THA,AUS,2019.0,20,39,-19
CHE,NZL,2009.0,11,8,3
GHA,CAN,2002.0,1,2,-1
CAN,IDN,2011.0,3,1,2
FRA,ARM,2002.0,1,1,0
DEU,MYS,1999.0,2,1,1
SRB,DEU,2002.0,16,2,14
CAN,QAT,2015.0,22,8,14
LUX,CAN,2015.0,1,3,-2
SVK,AUT,1997.0,2,2,0
NOR,CAN,2003.0,7,4,3
KEN,ETH,2014.0,4,3,1
SWE,ITA,2011.0,27,40,-13
KEN,USA,2006.0,21,16,5
GBR,SAU,2005.0,21,12,9
MEX,CUB,2001.0,11,7,4
ARE,NZL,2006.0,2,2,0
BGD,DEU,2014.0,5,10,-5
HUN,ITA,2013.0,9,12,-3
FRA,RUS,2000.0,19,33,-14
FIN,ESP,2013.0,17,14,3
NLD,AUT,2006.0,11,8,3
ISR,POL,2011.0,9,1,8
ESP,ITA,1999.0,39,28,11
ARE,NLD,2009.0,1,2,-1
RUS,FIN,2013.0,15,9,6
ROU,SWE,2002.0,3,1,2
CHE,TUR,2014.0,10,19,-9
JPN,UKR,2002.0,2,10,-8
BGR,AUS,2018.0,2,2,0
CHE,CZE,2000.0,4,2,2
NLD,ZAF,2006.0,11,6,5
FRA,SWE,2000.0,23,11,12
GBR,PAK,2002.0,13,10,3
PRT,ITA,2006.0,6,12,-6
CAN,MDA,2010.0,1,1,0
SWE,MEX,2002.0,4,4,0
BEL,BRA,2001.0,8,5,3
CHE,ZAF,2001.0,4,5,-1
CHE,ROU,2004.0,3,1,2
BEL,TUR,2009.0,4,7,-3
NCL,FRA,2020.0,17,20,-3
RUS,MDA,2005.0,6,1,5
NOR,JPN,2006.0,2,2,0
DEU,FIN,1999.0,10,5,5
AUS,HKG,2003.0,28,22,6
ISR,ITA,2007.0,4,7,-3
FIN,CAN,2000.0,7,2,5
HRV,USA,1998.0,5,5,0
ARG,BRA,2009.0,23,36,-13
HUN,AUT,2002.0,11,5,6
HUN,GBR,2010.0,27,25,2
DEU,EST,2005.0,5,2,3
SAU,ITA,2015.0,1,21,-20
KEN,JPN,2005.0,4,5,-1
ZAF,NOR,2002.0,4,1,3
RUS,CZE,2002.0,8,4,4
AUT,JPN,2015.0,10,11,-1
GBR,BRB,2006.0,1,1,0
ESP,CAN,1999.0,8,5,3
CZE,POL,1998.0,1,4,-3
RUS,BLR,2001.0,10,8,2
SGP,GBR,2002.0,36,38,-2
AIA,USA,2017.0,1,1,0
SWE,PER,2014.0,1,1,0
USA,FIN,1997.0,17,12,5
SWE,RUS,1998.0,8,19,-11
TUN,CAN,2009.0,4,4,0
IND,KWT,2003.0,11,2,9
ESP,PRI,2005.0,3,2,1
LKA,USA,2001.0,4,1,3
KHM,GBR,2022.0,2,1,1
DNK,POL,2003.0,6,4,2
NGA,BEL,2014.0,3,1,2
ITA,CHL,2008.0,8,3,5
LTU,ITA,2014.0,3,6,-3
FIN,ITA,2005.0,12,9,3
GBR,SVK,2006.0,7,3,4
ITA,KOR,2016.0,10,14,-4
CHE,AUT,2015.0,52,84,-32
BLR,CAN,2006.0,1,1,0
KOR,GBR,2002.0,13,31,-18
SVN,HRV,2006.0,3,4,-1
TUR,IND,2012.0,2,4,-2
ZAF,POL,2022.0,4,1,3
IRL,NZL,2013.0,6,3,3
TUN,ITA,2012.0,3,3,0
SWE,ISL,2006.0,8,13,-5
SVK,SWE,2012.0,2,1,1
DEU,ARG,2019.0,18,26,-8
GBR,IDN,2005.0,3,2,1
DNK,LTU,2020.0,1,2,-1
PAK,CAN,2012.0,19,6,13
DNK,THA,2015.0,4,1,3
ZAF,SDN,2016.0,2,1,1
NOR,AUS,2016.0,14,18,-4
GBR,KAZ,2017.0,4,5,-1
DEU,HUN,2014.0,25,47,-22
JPN,IRN,2016.0,8,10,-2
BRA,PAK,2015.0,9,8,1
FRA,SAU,2018.0,45,9,36
GBR,KWT,2017.0,6,5,1
THA,NLD,2011.0,7,5,2
BEL,HUN,2011.0,6,6,0
THA,IRL,2018.0,2,2,0
GRL,DNK,2015.0,4,3,1
CAN,LBN,2014.0,6,11,-5
USA,YEM,2019.0,4,1,3
BRA,IND,2011.0,6,6,0
TUR,NGA,2014.0,4,2,2
MEX,ARG,2018.0,32,12,20
LBN,GBR,2014.0,4,8,-4
JPN,NOR,2022.0,5,1,4
GEO,USA,2014.0,12,11,1
GBR,KWT,2010.0,9,3,6
ARE,EGY,2014.0,9,12,-3
NZL,NLD,2021.0,9,10,-1
PRT,PHL,2020.0,1,1,0
PRY,ESP,2020.0,2,4,-2
UKR,CZE,2012.0,3,2,1
RUS,DNK,2005.0,4,3,1
LTU,FRA,2015.0,2,4,-2
ARG,PER,2020.0,4,5,-1
LVA,USA,2015.0,3,11,-8
QAT,LBN,2016.0,4,6,-2
LKA,NZL,2018.0,5,3,2
VNM,JPN,2016.0,18,59,-41
DZA,BEL,2018.0,3,8,-5
DNK,COL,2018.0,2,4,-2
NGA,NLD,2020.0,4,2,2
EST,LVA,2019.0,2,2,0
GHA,CHE,2019.0,7,2,5
CHL,MEX,2016.0,19,15,4
ARM,FRA,2019.0,2,3,-1
GBR,UKR,2019.0,7,10,-3
KOR,KAZ,2021.0,4,4,0
PRT,SWE,2016.0,13,3,10
BGD,CHN,2022.0,8,29,-21
BRA,AUT,2018.0,13,8,5
ROU,NLD,2016.0,3,7,-4
SRB,BIH,2018.0,15,3,12
QAT,IRN,2022.0,1,3,-2
PRT,LUX,2019.0,5,1,4
JOR,GBR,2021.0,14,23,-9
SGP,VNM,2016.0,8,1,7
SRB,DEU,2005.0,10,11,-1
CAN,DZA,2013.0,5,3,2
GRC,CYP,2008.0,18,10,8
AUT,IRL,2002.0,2,1,1
USA,SVN,2006.0,11,10,1
ESP,BRA,2000.0,19,11,8
RUS,ITA,2006.0,23,12,11
RUS,NOR,2004.0,6,2,4
GBR,HKG,2000.0,7,12,-5
BRA,RUS,2006.0,4,6,-2
MYS,OMN,2016.0,5,3,2
CHN,NLD,2002.0,19,18,1
RUS,CZE,2005.0,8,7,1
SRB,ESP,2010.0,2,3,-1
BEL,IND,2010.0,7,27,-20
ITA,CZE,2015.0,16,6,10
CRI,USA,2012.0,11,12,-1
ETH,CHN,2021.0,10,25,-15
NPL,NOR,2018.0,3,2,1
SAU,LBN,2014.0,2,6,-4
GBR,TWN,2014.0,28,29,-1
PAK,AUS,2009.0,3,5,-2
IRN,RUS,2016.0,4,6,-2
GHA,DEU,2017.0,6,6,0
ZWE,DEU,2020.0,2,1,1
GHA,NOR,2021.0,2,4,-2
SRB,CAN,2011.0,4,3,1
HRV,AUT,2022.0,4,2,2
FRA,UGA,2013.0,2,3,-1
POL,TUR,2015.0,5,2,3
IDN,GBR,2017.0,10,24,-14
LBY,USA,2016.0,2,2,0
MYS,SWE,2020.0,9,4,5
TWN,ESP,2020.0,2,2,0
KEN,JPN,2002.0,3,4,-1
DJI,FRA,2013.0,4,1,3
CUB,MEX,2012.0,17,12,5
TUR,BEL,2014.0,4,13,-9
SGP,CZE,2019.0,3,1,2
DEU,ARG,2010.0,11,21,-10
CAN,MAR,2016.0,8,9,-1
POL,CHE,2021.0,18,11,7
CHE,ARG,2018.0,10,13,-3
LKA,MYS,2010.0,2,1,1
CUB,ESP,2000.0,15,3,12
DEU,GEO,2009.0,7,3,4
AUS,LAO,2011.0,1,1,0
URY,ESP,2004.0,1,9,-8
FIN,ITA,2002.0,8,5,3
ITA,PER,2006.0,1,1,0
GBR,SWE,2000.0,27,29,-2
CAN,RUS,2001.0,11,26,-15
ROU,SWE,2005.0,3,2,1
NZL,FRA,2003.0,4,7,-3
SAU,EGY,1999.0,6,3,3
DEU,EST,2002.0,3,3,0
KOR,BEL,2007.0,3,2,1
HKG,NZL,1999.0,5,1,4
GBR,ARG,2001.0,8,15,-7
FRA,NOR,2000.0,5,8,-3
JOR,PAK,2018.0,1,1,0
AUT,ESP,2006.0,8,6,2
FRA,EST,2011.0,4,1,3
FRA,ZAF,2015.0,23,17,6
BGR,GBR,2009.0,4,2,2
SWE,IND,2008.0,8,12,-4
PAK,JPN,2008.0,5,16,-11
HUN,FIN,2011.0,5,1,4
MEX,CZE,2016.0,4,3,1
GRC,ISR,2012.0,2,1,1
NZL,TTO,2011.0,1,2,-1
IND,ARE,2005.0,1,2,-1
CHL,URY,2009.0,1,3,-2
SRB,USA,2010.0,8,15,-7
NOR,ZMB,2010.0,2,2,0
IRN,PRT,2014.0,11,5,6
KEN,DEU,2011.0,5,13,-8
PRT,AUS,2014.0,11,4,7
ECU,CAN,2020.0,7,2,5
SDN,USA,2012.0,3,1,2
KEN,ZAF,2013.0,13,15,-2
SWE,ARG,2004.0,3,3,0
CMR,BWA,2018.0,1,1,0
USA,SVK,2020.0,9,6,3
NOR,ZAF,2019.0,4,3,1
JPN,HUN,2004.0,4,3,1
BEL,THA,2008.0,1,2,-1
GRC,ROU,2018.0,7,3,4
GLP,FRA,2001.0,12,3,9
ROU,GRC,2018.0,3,7,-4
AUS,KAZ,2015.0,2,1,1
ARM,ITA,2019.0,2,2,0
SEN,GIN,2018.0,1,1,0
DNK,MEX,2021.0,4,1,3
LVA,GBR,2019.0,4,3,1
BOL,USA,2008.0,4,3,1
AND,ESP,2020.0,2,2,0
MEX,COL,2004.0,3,4,-1
PNG,AUS,2008.0,2,2,0
VEN,CAN,2001.0,5,1,4
UKR,USA,2008.0,22,20,2
QAT,JOR,2018.0,6,5,1
ZAF,PRT,2011.0,2,4,-2
ZAF,MWI,2020.0,8,3,5
DNK,JPN,2006.0,5,7,-2
IND,OMN,2005.0,6,7,-1
ARG,SWE,2016.0,2,1,1
CHN,NLD,2005.0,10,19,-9
MYS,BGD,2013.0,21,30,-9
FRA,LVA,2018.0,3,1,2
SAU,NZL,2020.0,8,2,6
CZE,IRL,2018.0,4,2,2
POL,KOR,2013.0,2,12,-10
PAK,OMN,2012.0,5,2,3
ESP,IDN,2016.0,4,1,3
VEN,FRA,2016.0,6,2,4
IDN,JPN,2002.0,12,29,-17
GBR,SRB,2014.0,6,3,3
ISL,DEU,2017.0,5,5,0
EST,CAN,2011.0,1,3,-2
USA,EST,2010.0,5,7,-2
MYS,ITA,2014.0,2,3,-1
ITA,FIN,2015.0,13,14,-1
GBR,SYR,2016.0,2,2,0
FJI,GBR,2017.0,3,3,0
SGP,CZE,2017.0,1,2,-1
GTM,GBR,2020.0,2,1,1
ITA,ISR,2022.0,4,6,-2
OMN,PAK,2022.0,2,7,-5
USA,MDG,2021.0,5,3,2
EST,SWE,2007.0,5,5,0
UKR,KOR,2019.0,3,3,0
ZAF,TUR,2019.0,1,1,0
NOR,ZAF,2017.0,2,4,-2
HRV,BRA,2018.0,3,1,2
AUT,TUR,2015.0,3,3,0
IRN,IND,2016.0,4,16,-12
MAC,CAN,2008.0,1,1,0
JOR,FRA,2003.0,1,1,0
IND,BRA,2006.0,6,2,4
USA,FIN,1998.0,15,21,-6
MYS,GBR,2001.0,11,12,-1
GBR,JAM,2004.0,2,2,0
ISR,UKR,2004.0,1,3,-2
GMB,ZAF,2018.0,2,1,1
BEL,COG,2012.0,5,1,4
THA,SGP,2002.0,1,3,-2
CZE,ISR,2017.0,2,1,1
AZE,DEU,2014.0,1,2,-1
MLT,USA,2012.0,3,2,1
BRA,UKR,2004.0,2,1,1
SGP,IND,1999.0,1,10,-9
AUT,SWE,2001.0,2,10,-8
ISL,DEU,2019.0,5,6,-1
NLD,ISR,2001.0,7,6,1
PYF,FRA,2006.0,3,5,-2
RUS,DNK,2002.0,11,3,8
ITA,MEX,2005.0,5,7,-2
ITA,MLT,2020.0,2,3,-1
CHE,HUN,1997.0,3,1,2
ISR,SGP,2014.0,6,5,1
RUS,MDA,2002.0,2,2,0
ESP,BGR,1999.0,2,3,-1
UGA,ITA,2013.0,1,2,-1
ZAF,SGP,1998.0,1,1,0
SAU,BEL,2017.0,2,9,-7
UKR,TUR,2001.0,2,3,-1
NZL,SGP,2003.0,4,1,3
BRA,CHN,1999.0,1,1,0
USA,GTM,2005.0,4,3,1
SWE,COL,2010.0,1,3,-2
EGY,IRN,2007.0,1,1,0
DEU,BGR,2006.0,10,18,-8
KOR,EGY,2008.0,2,2,0
AUS,ARG,2017.0,4,5,-1
FRA,TGO,2013.0,1,3,-2
UGA,USA,2007.0,9,12,-3
TUR,NZL,2020.0,8,3,5
COL,GTM,2013.0,3,1,2
BGD,BEL,2013.0,3,1,2
IRN,CHE,2008.0,4,1,3
JPN,ZAF,2013.0,4,1,3
SRB,DNK,2011.0,1,2,-1
JOR,JPN,2010.0,1,1,0
OMN,BHR,2020.0,2,3,-1
CRI,MEX,2014.0,1,1,0
QAT,SDN,2013.0,1,1,0
IRL,IND,2018.0,5,35,-30
BFA,BEL,2016.0,2,3,-1
IDN,GBR,2010.0,3,9,-6
NZL,COL,2018.0,2,3,-1
MYS,MMR,2020.0,4,1,3
SWE,COL,2019.0,3,8,-5
URY,ARG,2000.0,1,1,0
DEU,AZE,2011.0,1,1,0
NGA,THA,2016.0,1,1,0
ZMB,JPN,2002.0,2,2,0
FRA,NZL,2009.0,12,16,-4
USA,GUY,2009.0,1,1,0
YEM,EGY,2015.0,1,3,-2
RUS,BGR,2000.0,3,3,0
FRA,MDA,2014.0,1,1,0
HKG,BGD,2022.0,3,1,2
QAT,OMN,2016.0,1,1,0
CRI,PRI,2016.0,1,1,0
IND,IRL,2012.0,13,12,1
ESP,LUX,2014.0,5,4,1
THA,SWE,2021.0,4,6,-2
AUS,NPL,2005.0,2,3,-1
NOR,CHE,2009.0,5,16,-11
IDN,JPN,2005.0,4,35,-31
SVN,CHE,2008.0,1,1,0
AUS,TUR,2007.0,1,3,-2
AUS,PHL,1997.0,1,1,0
POL,AUT,2006.0,6,4,2
CYP,DEU,2010.0,2,1,1
ZAF,BEL,2007.0,2,6,-4
UKR,KOR,2010.0,1,1,0
EGY,NLD,2016.0,2,3,-1
NOR,PAK,2009.0,1,2,-1
JPN,POL,2000.0,3,7,-4
USA,ZWE,2015.0,2,17,-15
MKD,SRB,2016.0,1,1,0
NZL,ITA,2015.0,4,7,-3
BRA,SWE,2006.0,3,7,-4
LBN,BEL,2016.0,4,3,1
ARG,GBR,2022.0,5,6,-1
JPN,UGA,2016.0,2,1,1
JOR,JPN,2017.0,2,1,1
COL,CRI,2018.0,3,1,2
GBR,LBN,2019.0,4,6,-2
AUS,COL,2021.0,4,8,-4
BEN,DEU,2018.0,2,5,-3
BGD,DNK,2016.0,2,1,1
CAN,NPL,2017.0,1,2,-1
NOR,ZAF,2010.0,1,6,-5
IDN,PAK,2019.0,1,1,0
SWE,KOR,2006.0,3,3,0
CIV,BEL,2017.0,1,2,-1
GBR,UKR,2010.0,10,16,-6
AUS,BHR,2021.0,1,1,0
MEX,TWN,2009.0,1,2,-1
POL,RUS,2018.0,12,17,-5
AUT,HUN,2020.0,8,15,-7
CZE,ROU,2008.0,1,3,-2
AUT,FIN,2001.0,3,4,-1
DEU,IRN,2002.0,9,6,3
LVA,GBR,2010.0,1,1,0
PAK,NZL,2011.0,2,2,0
SVK,DNK,2013.0,1,1,0
JPN,MMR,2012.0,2,4,-2
THA,MYS,2009.0,3,4,-1
CAN,MAC,2008.0,1,1,0
RUS,IND,1998.0,3,3,0
CAN,ARG,2022.0,2,9,-7
UKR,CHN,2015.0,2,2,0
PAN,ECU,2021.0,1,1,0
BEL,COL,2011.0,2,3,-1
SVN,SRB,2013.0,5,5,0
SWE,COL,2017.0,3,2,1
KOR,MYS,2022.0,3,11,-8
CHE,HUN,1998.0,2,2,0
FRA,COG,2021.0,1,1,0
THA,BRA,2020.0,1,1,0
IRN,GRC,2015.0,3,1,2
LBY,GBR,2018.0,3,17,-14
MTQ,CAN,2013.0,2,1,1
HRV,ITA,2001.0,1,3,-2
CZE,POL,1997.0,2,2,0
USA,SLE,2008.0,2,2,0
ARG,URY,2004.0,2,2,0
NLD,SAU,2001.0,1,1,0
MYS,DEU,1999.0,1,2,-1
USA,BLZ,2011.0,2,1,1
BEL,DZA,2013.0,2,3,-1
TUN,ESP,2014.0,5,4,1
HUN,CZE,2021.0,4,1,3
ITA,SMR,2014.0,2,1,1
CMR,NLD,2007.0,1,2,-1
BFA,CAN,2015.0,3,2,1
MEX,NOR,2015.0,1,1,0
KEN,IND,2014.0,1,4,-3
COL,CHN,2022.0,1,1,0
NER,CIV,2019.0,1,1,0
ROU,JPN,2018.0,3,3,0
CMR,CHE,2020.0,3,3,0
SRB,ESP,2017.0,1,2,-1
ROU,POL,2008.0,2,2,0
FJI,GBR,2019.0,2,3,-1
PAN,AUS,2009.0,1,1,0
BEL,PRT,2008.0,3,6,-3
UKR,ESP,1997.0,4,2,2
AUS,ARG,2010.0,4,3,1
PER,COL,2016.0,4,2,2
HUN,SVN,2016.0,1,1,0
ARE,DEU,2015.0,3,2,1
MEX,BRA,2001.0,5,4,1
USA,ECU,2004.0,5,6,-1
AFG,PAK,2019.0,2,1,1
ARM,BEL,2003.0,1,1,0
ARM,ITA,2010.0,3,1,2
CYP,NOR,2020.0,2,2,0
ZMB,GBR,2015.0,3,7,-4
GHA,DEU,2010.0,2,3,-1
NGA,ETH,2007.0,2,1,1
NZL,BHR,2019.0,1,1,0
ESP,ISR,1997.0,1,1,0
ERI,IND,2009.0,1,5,-4
PRT,NZL,2008.0,1,1,0
CZE,ISR,2010.0,1,1,0
IRN,POL,2011.0,3,1,2
AUT,CHL,2014.0,6,2,4
AUT,SVN,2014.0,2,8,-6
BLR,USA,2011.0,5,1,4
SAU,GRC,2019.0,1,9,-8
EGY,TUR,2013.0,1,1,0
ETH,KOR,2017.0,1,3,-2
IDN,SWE,2011.0,2,2,0
THA,ESP,2019.0,2,1,1
VEN,URY,2020.0,2,2,0
DNK,KOR,2009.0,3,3,0
PRT,TWN,2008.0,1,1,0
THA,HKG,2012.0,1,2,-1
USA,MLT,2003.0,1,1,0
ARE,FRA,2022.0,2,4,-2
TZA,ZMB,2020.0,1,1,0
GEO,RUS,2008.0,4,3,1
TGO,FRA,2021.0,2,3,-1
UGA,RWA,2019.0,3,4,-1
LKA,THA,2021.0,1,1,0
LBN,NLD,2021.0,1,3,-2
IDN,AUT,2012.0,2,1,1
UZB,DEU,2011.0,2,1,1
GAB,DEU,2004.0,3,1,2
NZL,AUT,2003.0,3,1,2
CHE,CHL,2002.0,1,2,-1
SWE,MEX,2005.0,2,2,0
ZAF,MEX,2015.0,2,1,1
QAT,SAU,2021.0,3,13,-10
NPL,JPN,2004.0,3,3,0
TUR,PAK,2013.0,4,3,1
COG,CHE,2012.0,1,1,0
CMR,BFA,2017.0,1,2,-1
CMR,GBR,2005.0,1,4,-3
BIH,SRB,2005.0,4,5,-1
JPN,CHE,1998.0,1,10,-9
LUX,FIN,2013.0,1,1,0
CRI,CAN,1999.0,1,2,-1
MEX,IRL,2021.0,1,2,-1
NLD,TZA,2022.0,3,1,2
GBR,VEN,2014.0,4,2,2
SWE,EGY,2014.0,4,2,2
ITA,CYP,2018.0,1,3,-2
ARM,USA,2020.0,3,3,0
GBR,MAR,2017.0,2,3,-1
GHA,IND,2015.0,2,2,0
SVN,GBR,2004.0,2,5,-3
MWI,ZAF,2011.0,1,3,-2
AUT,KOR,2013.0,1,3,-2
CIV,BEL,2010.0,1,1,0
MEX,POL,2011.0,3,2,1
ZAF,SWZ,2011.0,1,1,0
MLT,FRA,2017.0,1,1,0
CHN,JOR,2018.0,1,1,0
CAN,NPL,2019.0,2,10,-8
TUR,HRV,2006.0,1,2,-1
FRA,CUB,2004.0,3,1,2
AUT,LUX,2013.0,1,2,-1
ISR,DNK,2008.0,2,3,-1
VEN,GBR,1999.0,1,1,0
USA,YEM,2010.0,2,1,1
HUN,SGP,2019.0,1,3,-2
GBR,BEN,2021.0,1,1,0
MNG,AUS,2019.0,2,3,-1
BLR,GBR,1999.0,1,2,-1
USA,GAB,2014.0,5,2,3
FRA,PER,2006.0,1,1,0
USA,SYR,2010.0,1,2,-1
BEL,CHL,2012.0,3,2,1
NOR,TUR,2009.0,1,4,-3
POL,CHL,2018.0,3,2,1
CHN,CZE,2009.0,1,2,-1
BIH,DEU,2016.0,1,1,0
CHE,CHL,2005.0,1,3,-2
IND,OMN,2002.0,2,2,0
BEL,OMN,2022.0,1,1,0
RUS,IRL,2009.0,3,1,2
HKG,SAU,2018.0,2,7,-5
UGA,RWA,2017.0,1,3,-2
SDN,EGY,2019.0,2,1,1
ARG,PRY,2016.0,1,1,0
MEX,CRI,2015.0,2,2,0
TUN,RUS,2019.0,2,2,0
BIH,SRB,2002.0,1,1,0
SGP,BRA,2016.0,1,3,-2
NLD,MMR,2019.0,1,1,0
MLI,USA,2007.0,2,1,1
IRQ,SRB,2016.0,1,1,0
CMR,ITA,2005.0,1,1,0
NZL,ESP,2002.0,1,3,-2
VEN,CUB,2007.0,2,1,1
MNG,RUS,2001.0,1,1,0
ESP,ISR,1998.0,1,1,0
YEM,DEU,2012.0,1,1,0
FRA,CMR,1998.0,1,1,0
ZAF,TWN,2021.0,1,1,0
MEX,ISR,2011.0,1,2,-1
BRA,ARM,2016.0,1,1,0
ESP,AND,2013.0,2,1,1
COL,CUB,2020.0,2,3,-1
FRA,BLR,2021.0,1,1,0
NOR,HUN,2019.0,2,6,-4
PAK,FRA,2007.0,1,2,-1
CAN,CIV,2007.0,1,1,0
USA,VEN,2022.0,1,3,-2
GRC,BRA,2020.0,1,3,-2
GMB,USA,2015.0,1,3,-2
FRA,SRB,2004.0,1,2,-1
NLD,IRL,2000.0,1,1,0
CAN,KEN,2001.0,1,4,-3
HKG,ZAF,2013.0,1,1,0
QAT,TUR,2013.0,1,2,-1
PAK,BRN,2018.0,1,1,0
SDN,EGY,2017.0,1,2,-1
MCO,ITA,2017.0,1,1,0
MAR,TUN,2006.0,1,1,0
FRA,CMR,1997.0,1,1,0
RUS,CHL,2015.0,1,1,0
KEN,SWE,2012.0,2,2,0
LBN,FRA,1999.0,1,3,-2
TUR,CHL,2015.0,1,1,0
MWI,NLD,2005.0,1,1,0
NOR,SVK,2020.0,1,1,0
UKR,HUN,2018.0,1,2,-1
NLD,ISL,2009.0,2,3,-1
JPN,IRL,2022.0,2,1,1
ZAF,PSE,2017.0,1,1,0
EGY,BGD,2022.0,1,1,0
ZAF,IDN,2004.0,1,1,0
ROU,ZAF,2008.0,1,2,-1
SGP,SAU,2022.0,1,3,-2
ARE,LBY,2011.0,1,1,0
ITA,BHR,2009.0,1,1,0
AUT,HKG,2022.0,1,2,-1
JOR,RUS,2014.0,1,1,0
EST,NLD,2008.0,1,1,0
ROU,ESP,2008.0,1,8,-7
DNK,SVN,2020.0,1,1,0
CMR,CHN,2020.0,1,2,-1
UZB,JPN,2020.0,1,1,0
OMN,GBR,2008.0,4,9,-5
GBR,CHE,2013.0,243,204,39
FRA,GBR,2010.0,345,389,-44
ITA,CHE,2010.0,178,91,87
PRT,USA,2012.0,48,57,-9
GEO,FRA,2020.0,24,18,6
GRC,SWE,2012.0,14,7,7
BEL,USA,2013.0,169,136,33
FRA,GBR,2017.0,488,359,129
SAU,GRC,2017.0,3,3,0
RWA,USA,2018.0,13,12,1
PAK,USA,2016.0,100,68,32
MYS,AUS,2014.0,73,128,-55
LAO,USA,2020.0,1,2,-1
JPN,SGP,1998.0,6,1,5
IND,MYS,2019.0,53,55,-2
ITA,CHE,2019.0,250,155,95
IND,MYS,2010.0,59,25,34
AUT,ITA,2019.0,38,53,-15
PRI,USA,2021.0,48,30,18
PRT,POL,2021.0,6,2,4
HUN,GBR,2019.0,39,29,10
AUS,SGP,2017.0,86,79,7
GBR,LBN,2017.0,8,10,-2
AUS,DEU,2022.0,75,34,41
AUT,DEU,2022.0,117,140,-23
SWE,CHN,2014.0,56,71,-15
NPL,USA,2018.0,35,15,20
KOR,JPN,2020.0,82,106,-24
PHL,JPN,2016.0,19,31,-12
PRT,GBR,2022.0,19,35,-16
ESP,BEL,2018.0,70,51,19
EGY,NOR,2016.0,1,1,0
GRC,ITA,2019.0,35,27,8
TUR,SDN,2020.0,1,3,-2
USA,NGA,2016.0,37,53,-16
MNG,DEU,2015.0,2,2,0
CAN,IRL,2011.0,34,35,-1
NLD,TUR,2008.0,7,15,-8
IRN,NZL,2014.0,9,3,6
CAN,IND,2010.0,64,102,-38
KWT,IND,2006.0,4,3,1
NZL,USA,2004.0,105,103,2
ISR,AUS,2013.0,14,9,5
SAU,GBR,2015.0,41,112,-71
PHL,CHN,2009.0,3,1,2
FRA,MEX,2021.0,26,32,-6
CZE,CAN,2001.0,5,7,-2
NLD,NZL,2006.0,11,9,2
DNK,NOR,2018.0,56,35,21
COL,MEX,2006.0,9,10,-1
FIN,LUX,2014.0,2,2,0
MKD,HRV,2008.0,1,1,0
RUS,VNM,2015.0,15,3,12
COL,USA,2002.0,31,30,1
CZE,NLD,2012.0,6,7,-1
GRC,DNK,2009.0,8,3,5
ITA,GRC,2003.0,19,10,9
IND,SGP,2003.0,21,10,11
RUS,MEX,2001.0,19,3,16
SRB,CHE,2018.0,6,4,2
GBR,SAU,2002.0,19,7,12
USA,UKR,2007.0,18,25,-7
NLD,DNK,2009.0,18,14,4
DOM,USA,2018.0,1,4,-3
SAU,KWT,2003.0,1,1,0
AUS,SVN,2011.0,2,1,1
PAK,IND,2008.0,11,9,2
CHL,ARG,2012.0,15,15,0
IRN,SGP,2011.0,7,1,6
DNK,FRA,2008.0,21,25,-4
BRA,COL,2004.0,6,9,-3
CHN,ZMB,2016.0,3,2,1
HRV,NLD,2018.0,5,4,1
ISL,ESP,2014.0,1,1,0
KOR,NLD,2018.0,13,4,9
IRN,JPN,2021.0,11,8,3
AUS,EST,2021.0,2,2,0
GBR,MWI,2011.0,11,10,1
BRA,DNK,2022.0,8,1,7
NLD,HKG,1998.0,1,1,0
CYP,DEU,2017.0,7,2,5
THA,FIN,2014.0,1,2,-1
CZE,ISR,2019.0,4,4,0
JPN,UZB,2007.0,2,1,1
QAT,GBR,2020.0,17,42,-25
CHE,CMR,2003.0,2,1,1
MEX,ESP,2001.0,45,26,19
ESP,PRT,2003.0,32,11,21
FRA,HKG,2007.0,8,6,2
CHE,AUS,2008.0,39,45,-6
LTU,USA,2007.0,4,10,-6
LKA,GBR,2004.0,5,10,-5
HKG,SWE,2020.0,7,3,4
FIN,CHN,2021.0,32,42,-10
MYS,CAN,2015.0,21,13,8
PAK,BGD,2003.0,2,5,-3
TUN,TUR,2022.0,1,1,0
NAM,USA,2018.0,3,2,1
RUS,TJK,2008.0,1,2,-1
CHE,TWN,2007.0,3,2,1
KOR,CHE,1998.0,1,1,0
TUN,USA,2005.0,1,5,-4
OMN,EGY,2007.0,1,2,-1
EST,LVA,2010.0,1,2,-1
GBR,LBN,2010.0,4,2,2
CHE,SEN,2014.0,3,1,2
USA,EST,2019.0,13,9,4
JOR,DEU,2013.0,9,5,4
POL,SVK,2007.0,3,2,1
LTU,GBR,2007.0,5,4,1
SAU,RUS,2014.0,1,1,0
ISR,KOR,2015.0,6,4,2
MNG,AUS,2017.0,1,1,0
CHN,YEM,2021.0,3,2,1
OMN,JOR,2021.0,1,3,-2
TUN,USA,2002.0,5,6,-1
GRC,CZE,2022.0,2,4,-2
MOZ,PRT,2020.0,5,4,1
SAU,TUN,2012.0,3,31,-28
THA,SGP,2005.0,2,2,0
LKA,MYS,2017.0,3,7,-4
PER,BEL,2020.0,3,2,1
KOR,RUS,2005.0,7,13,-6
JPN,UKR,2005.0,4,1,3
CHN,AUT,2003.0,4,5,-1
GBR,UKR,2017.0,6,12,-6
QAT,TUN,2018.0,3,4,-1
CHE,RUS,2003.0,7,13,-6
DEU,ARM,2006.0,2,3,-1
ZAF,ESP,2007.0,3,1,2
SAU,TWN,2016.0,3,9,-6
ETH,KOR,2019.0,2,14,-12
POL,NZL,2017.0,4,1,3
CYP,DEU,2019.0,1,4,-3
GBR,BGD,1999.0,1,2,-1
KAZ,RUS,2006.0,3,8,-5
SAU,MEX,2021.0,2,2,0
POL,NZL,2019.0,1,1,0
JPN,COL,2009.0,1,2,-1
CAN,CYP,2016.0,1,5,-4
GBR,NPL,2003.0,1,2,-1
GBR,BGR,2006.0,3,5,-2
AUS,HUN,2016.0,3,7,-4
KWT,MYS,2020.0,1,2,-1
AUS,PNG,2000.0,2,4,-2
KWT,IRN,2014.0,1,1,0
USA,SYR,2017.0,2,6,-4
MEX,SWE,2011.0,4,2,2
BEL,IRQ,2008.0,1,1,0
THA,IDN,2013.0,2,1,1
PER,MEX,2008.0,2,3,-1
BHR,JOR,2020.0,1,4,-3
JPN,SGP,1997.0,1,2,-1
GRC,IND,2012.0,2,3,-1
GRC,RUS,2006.0,3,4,-1
DEU,MKD,2002.0,2,3,-1
ISL,DEU,2010.0,1,5,-4
JPN,CHE,1997.0,2,6,-4
BEL,NGA,2020.0,2,3,-1
GRC,SRB,2020.0,1,2,-1
USA,MOZ,2014.0,4,1,3
GHA,SLE,2021.0,1,1,0
SGP,NZL,1997.0,3,1,2
ESP,PRI,2002.0,2,2,0
SYR,LBN,2011.0,1,2,-1
CZE,IRN,2016.0,2,4,-2
NGA,SLE,2018.0,2,1,1
KEN,NGA,2000.0,1,1,0
JPN,PER,2013.0,3,1,2
TZA,BEL,2021.0,1,2,-1
FIN,POL,2013.0,2,5,-3
DEU,PRI,2010.0,1,2,-1
NLD,SVN,2013.0,2,1,1
DNK,HKG,2019.0,1,3,-2
DNK,HKG,2017.0,2,1,1
ITA,CMR,2014.0,2,2,0
DEU,MCO,2018.0,1,2,-1
MEX,MYS,2014.0,1,1,0
SAU,BEL,2019.0,1,6,-5
THA,ESP,2017.0,2,1,1
MDA,USA,2021.0,1,1,0
NOR,BRA,2009.0,2,2,0
GBR,MAR,2010.0,1,2,-1
SWE,SEN,2015.0,1,1,0
TWN,CHE,2004.0,1,2,-1
MWI,DEU,2008.0,1,3,-2
USA,AFG,2007.0,2,1,1
HUN,SVK,2001.0,1,1,0
ARE,CZE,2022.0,1,1,0
GBR,BIH,2010.0,1,1,0
KOR,BRA,2021.0,1,3,-2
ITA,KEN,2020.0,1,2,-1
,RUS,2003.0,6581,0,6581
BRA,,2011.0,5063,0,5063
ARM,,2009.0,55,0,55
UZB,,2024.0,718,0,718
,NLD,2005.0,5413,0,5413
,NLD,2002.0,5544,0,5544
ESP,,2014.0,7131,0,7131
AUS,,2023.0,34767,0,34767
,TWN,2006.0,7069,0,7069
,JPN,2006.0,24022,0,24022
,CZE,1994.0,1857,0,1857
USA,,2006.0,33556,0,33556
,FIN,2000.0,2577,0,2577
,MKD,2004.0,86,0,86
KAZ,,2023.0,3390,0,3390
,CHL,1999.0,1175,0,1175
,SVK,2003.0,672,0,672
PAK,,2025.0,537,0,537
ITA,,2003.0,1955,0,1955
UKR,,2021.0,3195,0,3195
THA,,2021.0,2972,0,2972
TGO,,2016.0,29,0,29
SRB,,2016.0,619,0,619
SVK,,2014.0,467,0,467
,CHE,2007.0,3769,0,3769
,IND,2016.0,30552,0,30552
COL,,2016.0,746,0,746
KWT,,2012.0,95,0,95
,LTU,2007.0,575,0,575
,BGR,1999.0,799,0,799
ISL,,2014.0,70,0,70
ZWE,,2012.0,18,0,18
VNM,,2023.0,5143,0,5143
,ISR,2012.0,2446,0,2446
,LKA,1998.0,126,0,126
BFA,,2016.0,57,0,57
,NER,2001.0,13,0,13
,THA,2009.0,2305,0,2305
,COD,2004.0,6,0,6
VEN,,2018.0,530,0,530
,IRN,2008.0,9460,0,9460
,NGA,2010.0,1517,0,1517
,IDN,2005.0,423,0,423
,ESP,2016.0,13601,0,13601
BOL,,2021.0,64,0,64
,BGD,2012.0,945,0,945
,DNK,2013.0,2988,0,2988
IND,JOR,2008.0,3,0,3
,LKA,1997.0,25,0,25
JAM,DZA,2018.0,1,0,1
SGP,,2005.0,372,0,372
,TUN,2011.0,1236,0,1236
GTM,,2024.0,145,0,145
,HKG,2012.0,1686,0,1686
,CMR,2010.0,266,0,266
,POL,2014.0,5969,0,5969
,IRQ,2010.0,426,0,426
CHE,MYS,2007.0,1,0,1
,AZE,2009.0,212,0,212
,MLI,2011.0,52,0,52
,MAC,2013.0,156,0,156
IRL,MAC,2011.0,1,0,1
MKD,,2022.0,234,0,234
SEN,,2023.0,513,0,513
BHR,,2020.0,72,0,72
,JAM,2010.0,47,0,47
,PRT,2015.0,2923,0,2923
,MDG,2011.0,77,0,77
,ZMB,2012.0,88,0,88
,IRQ,2019.0,912,0,912
VUT,,2022.0,7,0,7
,ISL,2012.0,123,0,123
,NGA,2017.0,2281,0,2281
NLD,SRB,2014.0,6,0,6
MOZ,,2021.0,96,0,96
,AFG,2012.0,15,0,15
WSM,,2023.0,15,0,15
,MMR,2013.0,48,0,48
FJI,,2020.0,23,0,23
,BEN,2014.0,95,0,95
TJK,,2017.0,17,0,17
TTO,,2022.0,124,0,124
,IRQ,2017.0,3534,0,3534
GHA,EGY,2019.0,1,0,1
ARM,ROU,2021.0,1,0,1
,NGA,2019.0,1308,0,1308
,AGO,2015.0,16,0,16
ZAF,ARE,2016.0,4,0,4
,URY,2006.0,185,0,185
,CMR,2017.0,429,0,429
ARE,,2006.0,43,0,43
,CMR,2019.0,273,0,273
CZE,BGD,2020.0,1,0,1
,JAM,2017.0,22,0,22
,ARM,2018.0,98,0,98
,TZA,2018.0,283,0,283
,IDN,2002.0,264,0,264
TWN,IRN,2014.0,2,0,2
,LBN,2018.0,595,0,595
IND,SDN,2019.0,1,0,1
KEN,PAK,2006.0,3,0,3
ITA,JOR,2006.0,2,0,2
HKG,MAC,2004.0,8,0,8
URY,ZAF,2012.0,1,0,1
,UGA,2007.0,204,0,204
LKA,,2014.0,81,0,81
NLD,PER,2015.0,3,0,3
FJI,USA,2002.0,1,0,1
LUX,,2015.0,69,0,69
TJK,,2010.0,8,0,8
SGP,,2002.0,57,0,57
CHL,,2007.0,289,0,289
POL,SRB,2015.0,4,0,4
,LBY,2009.0,50,0,50
,CYP,1995.0,27,0,27
LBN,SAU,2009.0,5,0,5
,QAT,2002.0,52,0,52
IRN,SRB,2013.0,2,0,2
,HND,2012.0,15,0,15
TJK,,2019.0,20,0,20
LTU,,2005.0,47,0,47
ARM,GRC,2021.0,1,0,1
,FLK,2016.0,3,0,3
ZWE,BEL,2020.0,1,0,1
JPN,BWA,2019.0,1,0,1
CAN,SEN,2016.0,2,0,2
AUS,GUM,2004.0,1,0,1
CMR,ESP,2008.0,2,0,2
,GHA,2008.0,283,0,283
,GRD,2018.0,21,0,21
,MNG,2009.0,34,0,34
URY,LUX,2020.0,1,0,1
IRL,TUR,2013.0,3,0,3
LAO,JPN,2007.0,1,0,1
ROU,CAN,2007.0,6,0,6
SAU,SYR,2021.0,2,0,2
TWN,SAU,2014.0,7,0,7
ERI,,2018.0,6,0,6
BLZ,,2023.0,10,0,10
SRB,NOR,2006.0,1,0,1
,GUM,2011.0,5,0,5
GLP,,2019.0,8,0,8
MLT,BRA,2005.0,1,0,1
LBY,,2013.0,36,0,36
ZMB,JPN,2005.0,1,0,1
URY,,2004.0,18,0,18
AUT,IRL,2005.0,1,0,1
BEL,IDN,2008.0,1,0,1
RUS,IND,1997.0,2,0,2
ISR,BRA,2006.0,1,0,1
LTU,,2002.0,12,0,12
IND,ATG,2005.0,1,0,1
,MKD,1996.0,20,0,20
GUY,NLD,2004.0,1,0,1
,BRB,1995.0,4,0,4
GEO,,2004.0,30,0,30
TON,NZL,2006.0,2,0,2
JPN,LVA,2003.0,1,0,1
TUN,CIV,1999.0,2,0,2
HND,POL,2012.0,1,0,1
VGB,,2009.0,2,0,2
IRL,POL,2001.0,4,0,4
IRN,HUN,2004.0,1,0,1
CAN,GRC,2000.0,2,0,2
TWN,SWE,1997.0,1,0,1
KGZ,,2005.0,1,0,1
GBR,FRO,2020.0,2,0,2
,ATG,2003.0,2,0,2
FRA,NER,2013.0,3,0,3
COL,SWE,2004.0,3,0,3
,PRY,1994.0,6,0,6
POL,ARG,2015.0,4,0,4
GMB,QAT,2018.0,1,0,1
BLR,DEU,2016.0,5,0,5
SHN,,2023.0,2,0,2
LBN,,2007.0,45,0,45
GUF,,2016.0,7,0,7
BGR,ISR,2001.0,1,0,1
UGA,SWE,2008.0,2,0,2
,REU,2007.0,8,0,8
MYS,MWI,2017.0,1,0,1
ITA,LUX,2013.0,9,0,9
CMR,DEU,2018.0,10,0,10
GBR,TUN,2014.0,2,0,2
SWE,ALB,2017.0,1,0,1
BRA,TWN,2015.0,2,0,2
ROU,TUR,2013.0,5,0,5
THA,BTN,2012.0,3,0,3
CHN,LVA,2022.0,1,0,1
,CPV,2012.0,10,0,10
BRA,ZAF,1999.0,3,0,3
SRB,ESP,2019.0,4,0,4
GLP,,2017.0,11,0,11
UKR,GRC,2001.0,4,0,4
LTU,AUT,2008.0,1,0,1
MCO,,2004.0,2,0,2
SRB,MNE,2001.0,2,0,2
CYP,LBN,2004.0,1,0,1
ITA,PRY,2005.0,1,0,1
,QAT,2005.0,56,0,56
COL,PRT,2005.0,1,0,1
BOL,FRA,2021.0,2,0,2
BLR,IRN,2014.0,1,0,1
CYP,CHE,2006.0,1,0,1
COG,BEL,2022.0,5,0,5
ESP,QAT,2015.0,7,0,7
EST,CHN,2017.0,3,0,3
MYS,TUN,2018.0,2,0,2
GNB,,2016.0,7,0,7
IRQ,,2005.0,9,0,9
GNB,PRT,2016.0,1,0,1
MKD,SVN,2015.0,1,0,1
CAN,ISL,2008.0,3,0,3
BRN,TWN,2010.0,1,0,1
,TCD,1995.0,4,0,4
BTN,USA,2007.0,1,0,1
ARG,ZAF,2005.0,1,0,1
IRQ,,2002.0,2,0,2
MWI,TZA,2012.0,1,0,1
PLW,,2007.0,2,0,2
CMR,ITA,2002.0,1,0,1
COM,CAF,2005.0,1,0,1
KOR,ISR,2001.0,1,0,1
VEN,ARG,2000.0,2,0,2
,BMU,1999.0,8,0,8
NER,AUS,2014.0,1,0,1
,SMR,2014.0,2,0,2
NOR,KEN,2005.0,1,0,1
MEX,LVA,2022.0,1,0,1
GBR,SLB,2016.0,1,0,1
IRQ,SYR,2020.0,1,0,1
BEN,ITA,2016.0,2,0,2
NLD,GEO,2014.0,1,0,1
UKR,UZB,2006.0,1,0,1
RUS,MYS,2009.0,1,0,1
MLT,,2005.0,3,0,3
MMR,,2016.0,10,0,10
BEN,PER,2004.0,1,0,1
ARG,BEL,2004.0,1,0,1
CAN,BHR,2014.0,3,0,3
CHE,GMB,2004.0,2,0,2
ARE,SVN,2021.0,1,0,1
SWE,LKA,2013.0,4,0,4
TTO,SGP,2020.0,1,0,1
PRT,JPN,2000.0,1,0,1
JPN,QAT,2020.0,2,0,2
URY,CAN,2022.0,1,0,1
MDA,EST,2015.0,1,0,1
IRN,KAZ,2013.0,1,0,1
ZAF,KWT,2020.0,1,0,1
TUN,QAT,2014.0,10,0,10
KOR,TZA,2016.0,2,0,2
SWE,SVN,1998.0,1,0,1
BRA,CIV,2020.0,1,0,1
NOR,ZMB,2019.0,1,0,1
,DOM,2003.0,6,0,6
PSE,BHR,2018.0,1,0,1
,TGO,2016.0,33,0,33
MYS,POL,2022.0,2,0,2
COL,KOR,2020.0,1,0,1
ZWE,NAM,2022.0,1,0,1
SAU,BRN,2018.0,1,0,1
EST,LVA,2017.0,4,0,4
AUS,SVK,2006.0,2,0,2
BLR,IRL,2011.0,1,0,1
BLR,LTU,2011.0,1,0,1
BEN,SEN,2014.0,2,0,2
JPN,TZA,2003.0,3,0,3
IRN,PAK,2003.0,1,0,1
CHE,PRT,2000.0,5,0,5
BHR,PAK,2022.0,1,0,1
LVA,AUT,2011.0,1,0,1
MDG,DEU,2010.0,1,0,1
GMB,NZL,2018.0,2,0,2
IRN,YEM,2020.0,1,0,1
BRA,THA,2014.0,1,0,1
IRN,CHL,2018.0,1,0,1
BEN,GAB,2018.0,1,0,1
TUN,CZE,2019.0,4,0,4
PAN,EGY,2004.0,1,0,1
GHA,CMR,2020.0,1,0,1
CHE,UKR,2022.0,1,0,1
NAM,MOZ,2022.0,1,0,1
IND,IDN,2004.0,1,0,1
AFG,FRA,2003.0,1,0,1
IND,ARE,2002.0,1,0,1
BEL,MTQ,2010.0,1,0,1
NZL,BHR,2017.0,1,0,1
GNB,NAM,2018.0,1,0,1
ISR,TZA,2005.0,1,0,1
DEU,QAT,2003.0,1,0,1
QAT,IRL,2005.0,1,0,1
GHA,TZA,2000.0,1,0,1
DEU,NCL,2001.0,1,0,1
SVK,ISR,2012.0,1,0,1
CHL,ITA,2001.0,2,0,2
DNK,HRV,1998.0,1,0,1
RUS,JOR,2006.0,1,0,1
POL,ISL,2022.0,1,0,1
ITA,PRI,2006.0,1,0,1
MDG,MCO,2015.0,1,0,1
USA,GTM,2002.0,1,0,1
BEL,TWN,2000.0,2,0,2
DZA,SVN,2016.0,1,0,1
DEU,IRQ,2006.0,1,0,1
MOZ,PAK,2006.0,1,0,1
TUN,DEU,2003.0,1,0,1
PHL,ESP,2009.0,2,0,2
JOR,NLD,2022.0,1,0,1
GBR,MAR,2019.0,3,0,3
MEX,PRY,2008.0,3,0,3
THA,LAO,2008.0,1,0,1
UZB,PAK,2014.0,1,0,1
CZE,LUX,2018.0,1,0,1
MLI,BFA,2011.0,2,0,2
ARM,CHL,2020.0,1,0,1
NGA,CMR,2013.0,4,0,4
DEU,COL,1998.0,1,0,1
FRA,WLF,2016.0,1,0,1
URY,ECU,2010.0,2,0,2
SEN,USA,1999.0,1,0,1
ISR,PRT,2002.0,1,0,1
MTQ,BRA,2020.0,1,0,1
GLP,USA,2001.0,1,0,1
UKR,BFA,2008.0,1,0,1
BEN,,2012.0,4,0,4
CAN,PRI,2016.0,1,0,1
ISR,LUX,2017.0,1,0,1
ISR,YEM,2012.0,1,0,1
ITA,TZA,2011.0,1,0,1
GBR,TCA,2018.0,1,0,1
LSO,BWA,1997.0,1,0,1
MNE,BIH,2007.0,1,0,1
ISR,PRT,2005.0,1,0,1
CHN,BGR,2009.0,2,0,2
GRL,,2021.0,6,0,6
ETH,AUT,2007.0,1,0,1
AUS,HND,2008.0,1,0,1
JAM,CUB,2019.0,1,0,1
TUR,BRA,2015.0,2,0,2
,BLZ,2006.0,3,0,3
ESP,LBN,2012.0,2,0,2
ESP,SEN,2001.0,1,0,1
COG,ZAF,2014.0,2,0,2
IND,SRB,2012.0,2,0,2
MDG,ITA,2020.0,1,0,1
MDA,DEU,2001.0,2,0,2
JOR,PSE,2020.0,3,0,3
CHN,VNM,2011.0,2,0,2
FLK,GBR,2016.0,2,0,2
SDN,OMN,2021.0,2,0,2
UKR,NOR,2014.0,2,0,2
DNK,EST,2013.0,2,0,2
TUN,HRV,2018.0,1,0,1
PSE,LBN,2020.0,1,0,1
PER,FIN,2007.0,1,0,1
ARM,EST,2012.0,1,0,1
LTU,JPN,2016.0,1,0,1
,COD,1996.0,1,0,1
NLD,COL,1999.0,1,0,1
JOR,NZL,2020.0,1,0,1
MDA,GBR,1998.0,1,0,1
NOR,COG,2005.0,1,0,1
FJI,GBR,2010.0,2,0,2
GLP,ITA,2012.0,1,0,1
TWN,ARM,2014.0,1,0,1
CMR,BFA,2010.0,1,0,1
FIN,KWT,2017.0,2,0,2
PHL,CAN,2014.0,3,0,3
PNG,BEL,2018.0,1,0,1
POL,MYS,2016.0,4,0,4
COG,IND,2021.0,1,0,1
KHM,SGP,2021.0,1,0,1
MUS,USA,2001.0,1,0,1
BEL,CIV,2016.0,3,0,3
,WSM,2016.0,9,0,9
JPN,LBN,2018.0,1,0,1
ISR,LTU,2001.0,1,0,1
ETH,CAN,2004.0,1,0,1
TUR,KGZ,2008.0,1,0,1
SVK,AUT,1998.0,2,0,2
MYS,MWI,2010.0,1,0,1
GRC,BGR,2013.0,2,0,2
DEU,SAU,2003.0,3,0,3
GLP,,2010.0,2,0,2
LKA,DNK,2003.0,1,0,1
MAR,RUS,2017.0,1,0,1
NZL,NOR,2004.0,1,0,1
NOR,COG,2002.0,1,0,1
CUB,DOM,2012.0,1,0,1
KHM,CHN,2014.0,1,0,1
KHM,IND,2017.0,1,0,1
KHM,IND,2019.0,1,0,1
FIN,KWT,2010.0,2,0,2
AUS,SYR,2013.0,1,0,1
TUN,GHA,2009.0,1,0,1
CHE,ISL,2014.0,1,0,1
CZE,HKG,2006.0,1,0,1
HUN,SRB,2001.0,1,0,1
AUS,BGR,2021.0,1,0,1
BRN,UKR,2017.0,1,0,1
PRI,CRI,2010.0,1,0,1
FRA,BIH,2001.0,1,0,1
BRA,SRB,2007.0,1,0,1
MYS,KNA,2016.0,1,0,1
GUM,DEU,2005.0,1,0,1
SRB,QAT,2013.0,1,0,1
PRI,CRI,2019.0,2,0,2
UZB,ESP,2010.0,1,0,1
SVN,BIH,2021.0,1,0,1
PSE,ITA,2010.0,1,0,1
SDN,TUN,2020.0,1,0,1
JPN,KEN,2022.0,3,0,3
DNK,LKA,2020.0,1,0,1
MEX,GRC,2007.0,1,0,1
PRT,MKD,2016.0,1,0,1
,DJI,1994.0,1,0,1
IND,BRB,2020.0,1,0,1
MAR,HUN,2020.0,2,0,2
MLT,CYP,2008.0,1,0,1
ALB,CAN,2020.0,2,0,2
ARG,AUS,2001.0,4,0,4
PAK,UZB,2022.0,1,0,1
BEL,SRB,2008.0,2,0,2
AUT,KAZ,2009.0,1,0,1
BEL,PSE,2014.0,2,0,2
SRB,KAZ,2018.0,1,0,1
FJI,USA,2005.0,2,0,2
VEN,BRA,1998.0,1,0,1
KEN,COG,2022.0,3,0,3
USA,PRY,2006.0,1,0,1
NGA,NAM,2011.0,1,0,1
NOR,ETH,1999.0,2,0,2
IND,NGA,2000.0,1,0,1
NZL,TON,2019.0,1,0,1
GHA,CHE,2017.0,2,0,2
TZA,NGA,2005.0,1,0,1
THA,ESP,2010.0,1,0,1
MTQ,,2013.0,2,0,2
HKG,AUT,2009.0,1,0,1
PAK,NLD,2001.0,2,0,2
MNG,TWN,2011.0,1,0,1
ISL,IRL,2012.0,1,0,1
MNP,,2020.0,1,0,1
BGD,,2000.0,4,0,4
ZAF,QAT,2015.0,1,0,1
PER,BHR,2019.0,1,0,1
POL,NAM,2012.0,1,0,1
CPV,POL,2019.0,1,0,1
NER,NGA,2022.0,1,0,1
FJI,ATG,2021.0,1,0,1
POL,PHL,2014.0,1,0,1
ETH,KWT,2007.0,1,0,1
NPL,VCT,2017.0,1,0,1
FRA,ZWE,2018.0,2,0,2
BGR,DNK,2016.0,1,0,1
POL,HUN,2016.0,3,0,3
TUN,ARE,2009.0,1,0,1
,JAM,2019.0,17,0,17
MYS,CYP,2018.0,1,0,1
ARE,BEL,2022.0,2,0,2
LBY,AUS,2016.0,2,0,2
ETH,IRL,2020.0,1,0,1
ARG,EGY,2020.0,1,0,1
NGA,MLI,2014.0,2,0,2
HUN,ARE,2021.0,2,0,2
CYP,ISR,2016.0,1,0,1
MYS,ZAF,2005.0,1,0,1
FIN,ROU,2001.0,2,0,2
ARG,KEN,2019.0,1,0,1
GMB,BEL,2004.0,1,0,1
BEN,CIV,2018.0,4,0,4
SOM,EGY,2018.0,1,0,1
AUS,SEN,2017.0,1,0,1
MKD,GRC,2005.0,1,0,1
AUT,GRC,1998.0,1,0,1
SYR,GBR,2004.0,1,0,1
NGA,AUS,2000.0,1,0,1
IND,VNM,2003.0,2,0,2
UGA,CAN,2001.0,1,0,1
BLR,ISR,2008.0,1,0,1
IDN,VEN,2001.0,1,0,1
BRA,ARE,2012.0,1,0,1
CHE,PER,2022.0,2,0,2
SWE,GTM,2020.0,1,0,1
AFG,ARM,2016.0,1,0,1
LUX,SWE,2019.0,1,0,1
BFA,CHE,2016.0,1,0,1
KEN,NOR,2021.0,1,0,1
RWA,ZMB,2020.0,2,0,2
FRA,MMR,2021.0,1,0,1
JOR,VNM,2019.0,1,0,1
CMR,CIV,2018.0,1,0,1
ISR,BLR,2004.0,1,0,1
GRC,KOR,2008.0,2,0,2
CAN,MWI,2016.0,1,0,1
MNE,ARE,2016.0,1,0,1
ARM,SGP,2012.0,1,0,1
NLD,BLR,2009.0,2,0,2
MLT,CHE,2009.0,1,0,1
FRA,MUS,2000.0,1,0,1
AUS,UKR,2010.0,1,0,1
PRT,GEO,2009.0,1,0,1
FIN,ISR,2021.0,1,0,1
DOM,ECU,2008.0,1,0,1
BHR,AUS,2014.0,1,0,1
COL,DNK,2012.0,1,0,1
MYS,SOM,2019.0,1,0,1
NOR,SOM,2021.0,1,0,1
BRA,AGO,2020.0,1,0,1
EGY,BHR,2007.0,1,0,1
ESP,KEN,2003.0,1,0,1
CHL,TWN,2007.0,1,0,1
CAN,GMB,2007.0,1,0,1
MYS,PHL,2020.0,1,0,1
MEX,MAC,2017.0,1,0,1
THA,ETH,2019.0,1,0,1
GRC,ESP,1999.0,3,0,3
TKM,,2016.0,3,0,3
NLD,ABW,2013.0,1,0,1
SEN,GAB,2020.0,1,0,1
BEL,BIH,2016.0,1,0,1
MEX,BEN,2017.0,1,0,1
,DMA,2013.0,2,0,2
JPN,GEO,2012.0,1,0,1
MEX,PAK,2006.0,1,0,1
GBR,GAB,2006.0,1,0,1
CHE,SWZ,2013.0,1,0,1
MYS,TUR,2012.0,2,0,2
MDG,DEU,2017.0,1,0,1
LKA,ZAF,2008.0,1,0,1
DNK,MLT,2022.0,1,0,1
URY,AUS,2013.0,1,0,1
CHN,FJI,2021.0,1,0,1
ARM,COL,2011.0,1,0,1
GRC,GRL,2012.0,1,0,1
URY,ECU,2019.0,2,0,2
HKG,ISR,2021.0,4,0,4
HRV,POL,2021.0,1,0,1
JPN,OMN,2022.0,1,0,1
,ARE,2020.0,4,0,4
PHL,IDN,2013.0,1,0,1
TGO,SEN,2021.0,1,0,1
MCO,SDN,2021.0,1,0,1
CAN,PSE,2007.0,1,0,1
RWA,BEL,2005.0,1,0,1
PRT,UKR,2018.0,2,0,2
SUR,,2005.0,1,0,1
BIH,USA,1999.0,1,0,1
YEM,OMN,2012.0,1,0,1
SAU,BHR,2005.0,1,0,1
ETH,OMN,2008.0,1,0,1
IDN,TUR,2009.0,1,0,1
NGA,TZA,2002.0,1,0,1
BLR,SAU,2021.0,1,0,1
HKG,RUS,2006.0,1,0,1
LUX,AUT,2006.0,1,0,1
UKR,CHE,1998.0,1,0,1
KOR,NOR,2006.0,1,0,1
UKR,KOR,2017.0,1,0,1
HKG,PHL,2007.0,1,0,1
IRQ,BHR,2003.0,1,0,1
SWZ,GBR,2009.0,2,0,2
ITA,MCO,2011.0,1,0,1
ISL,FRO,2019.0,1,0,1
GEO,SWE,2001.0,1,0,1
,TKM,2008.0,1,0,1
BGD,FJI,2016.0,2,0,2
AZE,AUS,2017.0,1,0,1
BRA,MAC,2018.0,1,0,1
LIE,ITA,2015.0,1,0,1
SDN,IRL,2011.0,2,0,2
CIV,BEL,2019.0,1,0,1
DNK,HKG,2010.0,1,0,1
BMU,GBR,2010.0,1,0,1
ROU,SVN,2021.0,1,0,1
BTN,,2014.0,1,0,1
PER,CZE,2020.0,1,0,1
LVA,EST,2022.0,1,0,1
ARG,LUX,2021.0,1,0,1
KEN,MWI,2022.0,2,0,2
MAR,SGP,2020.0,1,0,1
IRL,BGD,2000.0,1,0,1
TWN,MWI,2021.0,1,0,1
GRC,SAU,2012.0,1,0,1
USA,AZE,2006.0,1,0,1
KNA,DNK,2019.0,1,0,1
MAC,ARE,2018.0,1,0,1
POL,LUX,2016.0,2,0,2
KHM,NLD,2003.0,1,0,1
IRL,TZA,2022.0,1,0,1
KAZ,NOR,2020.0,1,0,1
ZAF,,2025.0,1,0,1
AIA,USA,2019.0,1,0,1
PAN,MEX,2018.0,1,0,1
GBR,AGO,2015.0,1,0,1
COD,TZA,2016.0,1,0,1
FIN,HKG,2022.0,1,0,1
MUS,ZAF,2022.0,1,0,1
KAZ,TUR,2001.0,1,0,1
NCL,GUF,2014.0,1,0,1
HKG,GRC,2006.0,1,0,1
RUS,EST,2012.0,1,0,1
HUN,LBY,2003.0,1,0,1
FIN,GUM,1998.0,1,0,1
MWI,BEL,2006.0,1,0,1
GEO,GBR,2007.0,1,0,1
,CUW,1994.0,1,0,1
BFA,ZAF,2006.0,1,0,1
GTM,USA,1999.0,1,0,1
PSE,,2003.0,1,0,1
NLD,MOZ,2003.0,1,0,1
AUS,BRB,2018.0,1,0,1
MEX,ZWE,2022.0,1,0,1
TLS,,2009.0,1,0,1
TUN,VNM,2019.0,1,0,1
UZB,USA,1998.0,1,0,1
BGR,NZL,2022.0,1,0,1
ABW,USA,2015.0,1,0,1
DEU,ZWE,2016.0,1,0,1
PSE,GRD,2019.0,1,0,1
KGZ,NGA,2021.0,1,0,1
GHA,AUT,2021.0,1,0,1
OMN,IRQ,2021.0,1,0,1
AZE,CHN,2007.0,1,0,1
USA,BMU,1999.0,1,0,1
NLD,AIA,2016.0,1,0,1
NLD,SLE,2013.0,1,0,1
PRY,MEX,2009.0,1,0,1
SYR,CHN,2018.0,1,0,1
SRB,BRA,2004.0,1,0,1
ARG,ISR,2007.0,1,0,1
ZWE,USA,1998.0,1,0,1
ECU,JPN,2021.0,1,0,1
DEU,MKD,2005.0,1,0,1
SVK,NLD,1997.0,1,0,1
TUR,COD,2019.0,1,0,1
BTN,NPL,2020.0,1,0,1
RUS,LIE,2012.0,1,0,1
UGA,JPN,2022.0,1,0,1
EST,HUN,2017.0,1,0,1
BLR,UKR,2009.0,2,0,2
MLI,ZAF,2022.0,1,0,1
NGA,ISR,2018.0,1,0,1
NIC,CHL,2010.0,1,0,1
GBR,FRA,2014.0,400,430,-30
GBR,NZL,2015.0,98,109,-11
RUS,SRB,2021.0,3,2,1
DEU,NLD,2003.0,170,146,24
NZL,PRT,2014.0,3,2,1
USA,TUR,2011.0,248,199,49
CHE,CHN,2003.0,12,9,3
USA,JPN,2020.0,649,677,-28
USA,GBR,2011.0,1288,1477,-189
DEU,SWE,2007.0,97,90,7
GBR,USA,2015.0,1543,1525,18
IRL,NZL,2008.0,8,5,3
USA,CAN,2003.0,1300,1372,-72
HKG,THA,2021.0,8,3,5
PAK,IND,2013.0,24,22,2
BRA,USA,2014.0,378,340,38
SWE,USA,2014.0,207,204,3
IND,GBR,2007.0,135,86,49
USA,PAK,2012.0,53,74,-21
ITA,USA,2004.0,387,368,19
IND,KOR,2008.0,116,34,82
GBR,JOR,2012.0,24,8,16
DNK,USA,2015.0,131,150,-19
POL,DEU,2009.0,70,60,10
USA,PRT,2002.0,46,27,19
GBR,ZAF,2006.0,43,59,-16
ESP,BEL,2019.0,85,53,32
FRA,BFA,2012.0,16,17,-1
NLD,TUR,2013.0,14,25,-11
PRT,ESP,2014.0,74,90,-16
CAN,ARG,2016.0,16,16,0
USA,SAU,2020.0,303,134,169
AUS,AUT,2010.0,13,18,-5
SVK,CHE,2006.0,3,2,1
IRL,USA,2022.0,46,49,-3
GBR,CHE,2008.0,149,174,-25
ZMB,USA,2011.0,8,8,0
CHL,DEU,2020.0,44,28,16
FRA,CHL,2007.0,27,25,2
USA,TUN,2006.0,5,4,1
USA,RUS,2013.0,139,134,5
MEX,ZWE,2016.0,4,2,2
KOR,IND,2017.0,130,240,-110
MOZ,USA,2007.0,1,1,0
POL,USA,1997.0,18,18,0
THA,USA,2009.0,89,143,-54
MEX,ESP,2003.0,42,61,-19
FIN,GBR,2013.0,34,41,-7
DNK,SWE,2021.0,59,58,1
USA,ARE,2013.0,68,18,50
FRA,JPN,2012.0,61,68,-7
MYS,AUS,2004.0,9,13,-4
TUN,SAU,2017.0,88,19,69
ITA,CHE,2018.0,271,138,133
UZB,KOR,2009.0,3,1,2
GBR,ESP,2003.0,150,156,-6
ITA,VNM,2013.0,2,1,1
BFA,FRA,2010.0,10,4,6
JPN,CHN,2020.0,447,326,121
ARG,GBR,2016.0,11,16,-5
CAN,IND,2018.0,89,152,-63
JPN,BGD,2015.0,57,34,23
BGD,MYS,2011.0,24,11,13
IRN,DEU,2007.0,19,16,3
ESP,CHL,2020.0,115,93,22
RUS,NOR,2014.0,8,3,5
MYS,USA,2021.0,25,22,3
CAN,BRA,2021.0,53,136,-83
CHN,IRL,2012.0,11,16,-5
DEU,JPN,1999.0,63,47,16
GBR,LBN,2018.0,10,8,2
SWE,IND,2013.0,20,58,-38
BGD,AUS,2021.0,54,45,9
CAN,FRA,2020.0,249,258,-9
PRT,GBR,2016.0,122,73,49
BFA,FRA,2017.0,9,12,-3
AUS,SWE,2020.0,58,43,15
NPL,USA,2019.0,37,12,25
DNK,GBR,2022.0,45,64,-19
GBR,IRL,2020.0,248,216,32
CHE,ROU,2014.0,5,4,1
ETH,AUS,2021.0,21,3,18
CHN,CAN,2022.0,152,196,-44
IRL,AUS,2015.0,42,35,7
ARM,DEU,2016.0,3,3,0
HUN,ITA,2008.0,11,6,5
USA,EGY,2016.0,103,92,11
MYS,SAU,2016.0,67,12,55
SVN,GBR,2014.0,13,6,7
IND,NZL,2011.0,9,7,2
DNK,AUS,2015.0,25,24,1
CHE,PER,2016.0,1,3,-2
AUS,KOR,2018.0,23,58,-35
NOR,SWE,2022.0,27,39,-12
JPN,ISR,2008.0,6,3,3
ITA,PRT,2020.0,32,29,3
GBR,MYS,2015.0,158,61,97
DEU,POL,2015.0,67,124,-57
ITA,ISR,2016.0,18,14,4
CHN,FRA,2013.0,114,143,-29
CAN,NLD,2021.0,47,28,19
BEL,DEU,2011.0,81,79,2
JPN,PHL,2016.0,31,19,12
ARE,FRA,2016.0,4,17,-13
IND,MYS,2018.0,44,68,-24
AUS,NZL,2020.0,132,155,-23
KAZ,ITA,2017.0,2,4,-2
ROU,USA,2019.0,15,13,2
GBR,KWT,2018.0,12,4,8
RUS,SWE,2009.0,16,12,4
SAU,QAT,2021.0,13,3,10
IND,SVK,2020.0,5,3,2
BRA,AUT,2017.0,7,7,0
HKG,SGP,2015.0,30,24,6
BEL,IND,2018.0,22,28,-6
ITA,DNK,2022.0,21,15,6
AUS,DNK,2015.0,24,25,-1
USA,NPL,2020.0,22,32,-10
TUR,CHN,2021.0,10,1,9
BEL,ZAF,2021.0,6,10,-4
GBR,IRQ,2020.0,106,8,98
BRA,NLD,2015.0,41,20,21
KOR,IND,2019.0,153,234,-81
ROU,ESP,2013.0,7,7,0
SEN,BEL,2016.0,2,1,1
POL,CHN,2005.0,1,1,0
CAN,ISR,2019.0,54,54,0
AUT,ITA,2018.0,49,78,-29
GHA,DEU,2018.0,11,8,3
CAN,MAR,2022.0,4,3,1
MEX,COL,2014.0,32,25,7
ISR,RUS,2000.0,5,7,-2
USA,ESP,1998.0,84,76,8
MEX,DEU,2016.0,46,22,24
BFA,FRA,2019.0,6,12,-6
ROU,GRC,2019.0,2,1,1
CHN,GBR,2001.0,64,65,-1
COL,ESP,2015.0,38,121,-83
IRL,TUR,2008.0,3,2,1
CHN,ARE,2021.0,14,3,11
GEO,USA,2004.0,7,11,-4
EGY,GBR,2020.0,53,61,-8
AUS,SGP,2018.0,105,81,24
DEU,IND,2021.0,93,153,-60
DNK,NOR,2017.0,48,20,28
BFA,BEL,2022.0,2,3,-1
TWN,IDN,2021.0,32,32,0
GLP,FRA,2003.0,6,15,-9
GBR,KAZ,2018.0,9,5,4
GBR,AUT,2008.0,38,62,-24
FIN,ESP,2008.0,10,17,-7
IRQ,IND,2021.0,4,4,0
DEU,RUS,2004.0,84,163,-79
MEX,ARG,2019.0,21,18,3
KOR,SAU,2022.0,6,5,1
SRB,USA,2018.0,24,7,17
KOR,USA,2009.0,646,787,-141
CHE,LUX,2010.0,4,2,2
CAN,EGY,2017.0,52,38,14
NLD,USA,2021.0,237,284,-47
IRL,FRA,2021.0,32,23,9
BRA,AUT,2019.0,11,2,9
SYR,CHN,2019.0,2,1,1
HKG,KOR,2021.0,14,7,7
CZE,IRL,2019.0,3,4,-1
ECU,PER,2021.0,5,7,-2
SAU,PAK,1998.0,1,1,0
NZL,AUS,2003.0,99,99,0
SWE,AUT,2009.0,8,9,-1
GRC,CYP,2013.0,41,13,28
TUN,SAU,2019.0,143,29,114
SWE,SAU,2014.0,5,3,2
IRN,ITA,2012.0,30,8,22
POL,DNK,2020.0,10,7,3
MYS,IRN,2012.0,79,73,6
ARE,USA,2010.0,15,47,-32
TUR,CYP,2011.0,11,6,5
CMR,DEU,2010.0,3,4,-1
CMR,DEU,2017.0,7,6,1
NPL,IND,2010.0,28,16,12
GBR,COL,2005.0,10,3,7
DEU,THA,2012.0,24,23,1
MEX,ARG,2010.0,13,7,6
CZE,IRL,2010.0,5,2,3
FIN,JPN,2020.0,11,14,-3
USA,NGA,2022.0,14,33,-19
ARG,ITA,2011.0,6,20,-14
ARG,URY,2014.0,4,5,-1
RWA,USA,2010.0,4,3,1
THA,HRV,2016.0,1,1,0
IND,NLD,2007.0,11,5,6
FRA,LBN,2007.0,24,14,10
CHE,CAN,2014.0,73,91,-18
MYS,BGD,2008.0,2,10,-8
ESP,BEL,2010.0,35,43,-8
TUR,CHE,2009.0,8,7,1
CHN,IND,2009.0,10,17,-7
JPN,BRA,2000.0,6,4,2
NOR,NLD,2019.0,15,34,-19
SGP,HKG,2012.0,19,27,-8
USA,TWN,2000.0,85,35,50
KOR,MYS,2016.0,15,15,0
DNK,ITA,1999.0,5,7,-2
EGY,NLD,2022.0,1,1,0
BRA,BEL,2011.0,10,9,1
CZE,FRA,2005.0,18,7,11
JPN,FIN,2007.0,8,4,4
ITA,TUR,2002.0,4,6,-2
BGD,GBR,2008.0,13,11,2
CHE,RUS,2001.0,22,16,6
NPL,NOR,2010.0,1,3,-2
ITA,SAU,2009.0,4,1,3
ROU,USA,2010.0,24,31,-7
RUS,BLR,2003.0,8,17,-9
BRA,FRA,1998.0,16,22,-6
SRB,BIH,2017.0,11,12,-1
CHN,AUT,2001.0,11,4,7
POL,RUS,2017.0,8,11,-3
HUN,USA,2022.0,17,16,1
CYP,DEU,2018.0,8,6,2
HRV,IND,2020.0,3,2,1
DNK,NOR,2019.0,58,33,25
USA,ECU,2014.0,18,5,13
GBR,HUN,2006.0,17,22,-5
BEL,ESP,2009.0,37,21,16
TUR,AZE,2006.0,3,1,2
CAN,EGY,2019.0,51,52,-1
HRV,BRA,2019.0,3,1,2
PAK,USA,2022.0,67,35,32
PRT,SWE,2022.0,6,5,1
NPL,IND,2019.0,12,32,-20
BRA,COL,2014.0,24,44,-20
CHL,AUS,2021.0,24,3,21
MMR,JPN,2021.0,3,8,-5
MEX,AUT,2020.0,8,4,4
NGA,USA,2022.0,33,14,19
SGP,TWN,2020.0,9,11,-2
MLT,FRA,2018.0,1,1,0
UKR,HUN,2017.0,3,1,2
HUN,POL,2021.0,2,4,-2
SEN,CAN,2015.0,3,2,1
GRC,ITA,2018.0,28,26,2
ARG,COL,2022.0,6,5,1
MYS,ARE,2020.0,31,4,27
LBN,GBR,2004.0,6,7,-1
RUS,SVN,2020.0,5,1,4
FRA,SAU,2017.0,28,14,14
DEU,SGP,2012.0,29,30,-1
MEX,CZE,2022.0,4,2,2
FRA,AUT,1997.0,1,3,-2
CHE,ARG,2019.0,5,7,-2
JOR,QAT,2020.0,13,5,8
ESP,AND,2008.0,5,1,4
CHE,ARG,2017.0,7,10,-3
LKA,USA,2003.0,7,4,3
FIN,AUS,2010.0,6,6,0
RUS,POL,2009.0,6,12,-6
ARE,USA,2017.0,54,79,-25
LBN,EGY,2017.0,5,4,1
FRA,BEN,2011.0,15,8,7
ISR,FRA,2009.0,17,19,-2
CZE,FRA,2002.0,18,10,8
COL,CRI,2010.0,1,2,-1
AUS,OMN,2009.0,5,5,0
LTU,CHE,2012.0,1,2,-1
SWE,SGP,2008.0,7,3,4
ITA,CHL,2013.0,13,5,8
USA,UGA,2007.0,12,9,3
ITA,AUS,2007.0,23,16,7
FRA,ARG,2007.0,11,11,0
BRA,PRT,2000.0,15,9,6
USA,PRT,2005.0,30,33,-3
BEL,JPN,2006.0,10,15,-5
FRA,NER,2008.0,3,2,1
RUS,GBR,2008.0,39,22,17
SWE,IRN,2008.0,13,6,7
CAN,ITA,2002.0,31,35,-4
SAU,TUR,2005.0,3,1,2
USA,VNM,2005.0,8,4,4
IRL,AUT,2002.0,1,2,-1
GBR,COL,2002.0,11,3,8
TUR,DEU,2005.0,20,17,3
URY,FRA,2013.0,4,2,2
DEU,HUN,2004.0,34,44,-10
SWE,FRA,2004.0,33,34,-1
ITA,GRC,2001.0,18,7,11
AUS,HKG,2001.0,31,12,19
POL,CHN,2002.0,3,1,2
QAT,JOR,2019.0,4,10,-6
BEL,CAN,2012.0,29,20,9
DEU,GRC,2012.0,42,53,-11
NZL,FRA,2001.0,9,7,2
DEU,ZAF,2001.0,16,7,9
MEX,BRA,2003.0,5,7,-2
TUR,DEU,2002.0,8,11,-3
TUN,SAU,2010.0,20,2,18
EGY,TUR,2008.0,1,2,-1
DEU,IDN,2001.0,5,3,2
BRA,CHE,2007.0,7,5,2
PRT,DEU,2011.0,24,30,-6
NOR,NLD,2010.0,5,26,-21
IND,SGP,2001.0,9,6,3
ROU,DNK,2006.0,2,1,1
TUN,DEU,2001.0,1,2,-1
HRV,NLD,2019.0,6,2,4
CHE,COL,2003.0,1,1,0
FRA,ZWE,2010.0,3,1,2
HRV,AUT,2016.0,6,4,2
LKA,HKG,2018.0,1,1,0
MDA,DEU,2003.0,2,1,1
RUS,MEX,2003.0,12,8,4
CAN,KEN,2003.0,4,4,0
BEL,BRA,2003.0,8,7,1
BRA,MEX,2007.0,8,7,1
AUS,IRL,1999.0,13,5,8
CAN,LBN,2004.0,5,2,3
SWE,PAK,2013.0,9,4,5
PRT,FRA,2002.0,12,39,-27
ARG,CAN,2011.0,11,9,2
FIN,NOR,2002.0,2,9,-7
AUT,FRA,1998.0,6,3,3
ARE,USA,2019.0,77,112,-35
GBR,UKR,2018.0,7,11,-4
USA,UZB,2011.0,1,3,-2
SRB,MNE,2003.0,1,1,0
RUS,KOR,1999.0,10,1,9
USA,HRV,2014.0,11,12,-1
EGY,ARE,1999.0,3,2,1
HKG,GBR,2001.0,21,29,-8
BGR,USA,2001.0,23,5,18
ZAF,FRA,2005.0,8,7,1
CHE,AUS,2013.0,52,40,12
JPN,RUS,2020.0,16,16,0
CAN,EGY,2010.0,24,20,4
ITA,IRL,2000.0,1,2,-1
VNM,JPN,2022.0,12,14,-2
ISR,CHN,2006.0,5,8,-3
CHE,ISR,2015.0,17,17,0
GRC,NLD,2006.0,7,10,-3
TWN,CHN,2006.0,25,40,-15
JPN,BEL,2013.0,18,12,6
RUS,FIN,2008.0,12,15,-3
ITA,ZAF,2011.0,7,1,6
LUX,IRL,2020.0,2,1,1
GRD,TTO,2020.0,1,1,0
BEL,SYR,2010.0,1,2,-1
IDN,GBR,2018.0,14,29,-15
POL,FIN,2000.0,4,2,2
TUR,FRA,2007.0,7,14,-7
NZL,JPN,2007.0,4,9,-5
RUS,ISR,2012.0,6,15,-9
BGD,CHN,2016.0,17,8,9
PRT,IRL,2015.0,9,2,7
ZAF,RWA,2014.0,5,2,3
NOR,ISL,2013.0,5,7,-2
SWE,AUS,2011.0,25,35,-10
URY,CAN,2016.0,2,5,-3
ARG,AUS,2003.0,8,3,5
ARG,CHL,2016.0,20,12,8
CHN,PAK,2012.0,37,35,2
IRL,IND,2017.0,7,24,-17
IRN,CHE,2013.0,25,2,23
UKR,CAN,2007.0,9,2,7
CAN,CHL,2018.0,19,18,1
ROU,GBR,2011.0,13,8,5
HKG,MAC,2014.0,18,5,13
PAK,BRA,2012.0,5,2,3
IND,NPL,2011.0,17,20,-3
KOR,NZL,2019.0,7,4,3
THA,PAK,2012.0,7,2,5
FRA,SAU,2019.0,25,10,15
SAU,BEL,2018.0,2,7,-5
ITA,ISL,2015.0,4,3,1
BEN,COG,2012.0,1,1,0
NZL,PAK,2015.0,6,3,3
FIN,AUS,2019.0,18,17,1
CZE,MEX,2012.0,1,3,-2
DEU,BGD,2008.0,1,2,-1
TUN,RUS,2018.0,2,1,1
GBR,MAR,2018.0,3,4,-1
SRB,AUT,2015.0,5,2,3
KOR,NLD,2019.0,4,9,-5
USA,LAO,2020.0,2,1,1
PAN,MEX,2017.0,1,1,0
KWT,CAN,2009.0,5,8,-3
DOM,USA,2019.0,2,5,-3
IRN,NLD,2018.0,33,22,11
THA,AUS,2018.0,14,33,-19
CHE,LUX,2019.0,9,5,4
AUS,AUT,2019.0,19,18,1
HKG,SAU,2019.0,3,6,-3
VNM,SWE,2021.0,4,4,0
KOR,NLD,2017.0,4,6,-2
ARE,QAT,2021.0,6,9,-3
DNK,TWN,2014.0,1,2,-1
SWE,CHN,2004.0,23,25,-2
SRB,BIH,2019.0,7,8,-1
IRN,CHL,2017.0,1,1,0
PAK,JPN,2013.0,10,14,-4
DZA,BEL,2019.0,2,5,-3
ZAF,SEN,2015.0,2,1,1
IND,CZE,2011.0,3,1,2
USA,CMR,2021.0,6,9,-3
POL,FRA,2022.0,14,8,6
NLD,UGA,2021.0,5,2,3
CHE,MEX,2019.0,5,8,-3
GHA,GBR,2021.0,14,17,-3
TUR,NLD,2012.0,20,15,5
CZE,CAN,2003.0,6,5,1
USA,ESP,1997.0,47,39,8
ITA,VEN,2015.0,2,1,1
DNK,NOR,2010.0,23,16,7
IRQ,USA,2012.0,8,2,6
ROU,USA,2017.0,18,28,-10
CAN,ITA,2005.0,30,34,-4
RUS,BEL,1999.0,5,4,1
SDN,GBR,2020.0,3,4,-1
SVK,GBR,1999.0,3,2,1
USA,MYS,1998.0,2,1,1
SGP,BEL,2014.0,6,5,1
GHA,CHE,2018.0,3,3,0
DEU,HRV,2009.0,11,6,5
ETH,JPN,2014.0,1,2,-1
HRV,BRA,2010.0,1,4,-3
CAN,TUN,2020.0,8,9,-1
MEX,JPN,2014.0,6,9,-3
JPN,KEN,2016.0,10,4,6
AZE,TUR,2021.0,1,5,-4
NOR,NLD,2017.0,5,37,-32
ZAF,NLD,2020.0,17,26,-9
JOR,IRQ,2020.0,7,3,4
POL,RUS,2019.0,16,11,5
KHM,CHE,2017.0,3,2,1
AUS,ROU,2013.0,3,1,2
COL,DEU,2002.0,8,5,3
DEU,LTU,2014.0,4,3,1
HKG,CAN,2022.0,12,12,0
RWA,UGA,2012.0,1,1,0
MEX,IND,2012.0,2,8,-6
CZE,IRL,2017.0,4,1,3
ZAF,CHN,2016.0,10,6,4
LKA,GBR,2014.0,6,12,-6
DZA,BEL,2017.0,2,1,1
CHN,CYP,2021.0,2,1,1
GUY,FRA,2012.0,1,1,0
CAN,HKG,2020.0,19,25,-6
ITA,HKG,2020.0,3,1,2
LUX,NLD,2020.0,8,10,-2
RWA,USA,2017.0,12,9,3
IRN,AFG,2014.0,1,1,0
EST,LVA,2018.0,3,3,0
ISL,USA,1999.0,4,2,2
PAK,NOR,2014.0,2,3,-1
BHR,PAK,2016.0,1,1,0
ISR,ZAF,2021.0,2,1,1
MAR,ESP,2020.0,7,19,-12
POL,JPN,2007.0,2,8,-6
THA,LAO,2013.0,4,4,0
CZE,AUS,2011.0,3,2,1
BEL,THA,2013.0,3,1,2
CHN,THA,2012.0,6,3,3
CHE,MEX,2010.0,3,3,0
CRI,MEX,2004.0,1,1,0
ITA,POL,2006.0,7,13,-6
AUT,FIN,2003.0,2,6,-4
USA,AGO,2012.0,1,1,0
AUT,SWE,2003.0,7,6,1
JAM,USA,2016.0,6,4,2
BRA,FRA,1997.0,8,11,-3
NLD,SWE,1998.0,6,6,0
AUS,CZE,2006.0,1,4,-3
PRT,AUT,2009.0,5,3,2
VNM,RUS,2003.0,1,2,-1
ZAF,NAM,2001.0,1,1,0
TWN,HKG,2015.0,6,8,-2
KEN,GBR,2009.0,11,14,-3
ITA,JPN,2004.0,11,10,1
GBR,LKA,2001.0,2,5,-3
AUS,BRA,2009.0,10,17,-7
CHE,MEX,2017.0,5,8,-3
KOR,NLD,2010.0,8,2,6
AUT,HRV,2012.0,1,8,-7
SWE,ARG,2014.0,3,4,-1
ECU,FRA,2016.0,3,13,-10
DNK,HKG,2018.0,3,5,-2
SWE,LKA,2008.0,2,1,1
MYS,BRN,2015.0,5,2,3
USA,VEN,2016.0,7,27,-20
LAO,FRA,2013.0,6,4,2
ARM,ITA,2018.0,2,1,1
ARG,BEL,2014.0,3,3,0
IRL,CZE,2005.0,1,2,-1
THA,IND,2009.0,3,4,-1
IRL,CAN,2006.0,22,19,3
BEL,SRB,2013.0,5,3,2
NOR,IND,2003.0,3,1,2
BFA,BEN,2015.0,1,1,0
IRL,IND,2019.0,11,42,-31
SGP,LUX,2012.0,2,1,1
JPN,PAK,2021.0,12,4,8
MEX,CHL,2009.0,4,9,-5
TZA,SWE,2011.0,2,3,-1
FRA,CUB,2014.0,2,7,-5
BLZ,USA,2020.0,3,1,2
DNK,FRA,2013.0,14,38,-24
THA,ESP,2018.0,2,4,-2
RWA,USA,2019.0,9,11,-2
PAN,MEX,2010.0,1,1,0
HKG,SAU,2017.0,2,6,-4
WSM,AUS,2018.0,1,1,0
HKG,ZAF,2008.0,1,1,0
MAR,DEU,2019.0,5,1,4
GUF,FRA,2004.0,1,13,-12
PRT,DNK,2011.0,4,4,0
FJI,GBR,2018.0,1,1,0
NLD,TZA,2016.0,3,2,1
CHE,ARG,2010.0,3,7,-4
MYS,MAR,2020.0,2,1,1
KAZ,ITA,2019.0,3,2,1
NPL,NOR,2019.0,1,1,0
BGD,DEU,2004.0,2,3,-1
CAN,PHL,2020.0,5,5,0
SDN,EGY,2018.0,2,1,1
TUR,UKR,2021.0,1,1,0
SWE,BEL,2022.0,6,10,-4
CAN,RUS,2003.0,17,22,-5
GBR,VEN,2004.0,5,2,3
ESP,CHE,1998.0,8,7,1
BRA,AUT,2010.0,4,3,1
KOR,NZL,2010.0,3,3,0
URY,USA,2007.0,10,7,3
AUS,ISL,2016.0,1,2,-1
YEM,JOR,2020.0,1,2,-1
ZAF,MOZ,2021.0,2,1,1
SGP,MYS,2020.0,17,28,-11
GAB,DEU,2014.0,2,1,1
IND,ETH,2005.0,7,3,4
NLD,ROU,2020.0,4,3,1
AUT,FRA,1997.0,3,1,2
DOM,USA,2017.0,3,4,-1
NOR,VNM,2011.0,1,1,0
ESP,CZE,2009.0,5,9,-4
ESP,ETH,2020.0,2,2,0
AUT,SRB,2021.0,4,3,1
NOR,FRA,1999.0,3,8,-5
DEU,TUN,2005.0,2,1,1
KHM,THA,2015.0,1,1,0
MYS,GBR,2003.0,12,40,-28
CAN,BGR,2006.0,2,1,1
CAN,CZE,2013.0,9,8,1
COL,SWE,2014.0,1,4,-3
PAK,DNK,2009.0,2,2,0
PAK,BRN,2019.0,2,3,-1
HRV,NLD,2017.0,4,1,3
TUR,KGZ,2013.0,3,3,0
NOR,AUT,2020.0,7,12,-5
LTU,RUS,2013.0,1,1,0
UGA,JPN,2016.0,1,2,-1
NOR,TZA,2012.0,2,3,-1
GBR,ARG,2003.0,10,17,-7
KHM,AUS,2016.0,3,2,1
ESP,RUS,2015.0,7,2,5
PNG,AUS,2013.0,6,1,5
AUT,BEL,2021.0,10,15,-5
BRA,UKR,2014.0,1,1,0
ARE,SWE,2021.0,5,5,0
CHN,UGA,2020.0,4,1,3
NPL,NOR,2017.0,5,4,1
SVK,POL,2015.0,3,8,-5
PAK,BRN,2017.0,1,1,0
PER,COL,2022.0,2,2,0
NOR,ZAF,2018.0,1,3,-2
DEU,HKG,2004.0,4,5,-1
HUN,PRT,2011.0,3,1,2
SWE,CYP,2021.0,2,3,-1
UKR,AUT,2008.0,5,1,4
FRA,URY,2009.0,5,1,4
NPL,USA,2010.0,12,5,7
CHN,ZAF,2009.0,5,6,-1
GBR,YEM,2004.0,2,1,1
ARE,TUN,2020.0,2,4,-2
MLI,FRA,2011.0,3,4,-1
ROU,FIN,2005.0,1,2,-1
TZA,NLD,2002.0,1,1,0
RUS,AUS,1999.0,4,1,3
HRV,BEL,2015.0,3,2,1
ISR,NOR,2002.0,2,2,0
AUT,POL,2007.0,3,8,-5
USA,GMB,2006.0,1,3,-2
KEN,SAU,2012.0,1,1,0
SVK,DEU,2001.0,18,10,8
AUS,BEL,2007.0,9,14,-5
NLD,UKR,2000.0,1,2,-1
JPN,NPL,2006.0,5,2,3
BRA,URY,2012.0,6,1,5
CMR,USA,2006.0,6,2,4
FIN,HUN,2002.0,5,2,3
GBR,MDG,2020.0,2,2,0
FIN,HUN,2005.0,4,3,1
BWA,USA,2005.0,5,3,2
OMN,USA,1999.0,1,3,-2
ESP,MAR,2011.0,3,7,-4
CHN,POL,2007.0,2,1,1
MEX,NZL,2011.0,2,5,-3
CZE,FIN,2007.0,4,2,2
BWA,USA,2002.0,3,2,1
CHN,PRT,2016.0,3,13,-10
COL,GTM,2008.0,2,1,1
CHE,LUX,2017.0,5,6,-1
DZA,CAN,2007.0,2,1,1
KOR,THA,2011.0,3,5,-2
SVN,SRB,2008.0,3,1,2
JOR,DEU,2008.0,4,13,-9
HND,GTM,2018.0,1,1,0
TTO,NZL,2011.0,2,1,1
SRB,CHE,2019.0,4,5,-1
SRB,MKD,2019.0,5,6,-1
ZAF,TUR,2018.0,2,4,-2
URY,ESP,2014.0,6,12,-6
AUS,LKA,2022.0,14,13,1
NOR,UGA,2020.0,3,1,2
THA,FIN,2004.0,1,2,-1
PSE,FRA,2021.0,2,6,-4
SRB,BIH,2010.0,3,2,1
NPL,JPN,2014.0,6,9,-3
BEL,SVK,2013.0,2,1,1
ARE,NGA,2020.0,2,2,0
ISR,PSE,2006.0,6,1,5
ETH,KOR,2018.0,4,4,0
PHL,SWE,2007.0,1,2,-1
TZA,NLD,2005.0,1,1,0
MAC,HKG,2011.0,3,10,-7
GRC,BGR,2008.0,1,1,0
ARE,EGY,2004.0,6,7,-1
ESP,PAN,2016.0,7,2,5
FIN,NOR,2005.0,7,6,1
IRN,DNK,2009.0,6,6,0
BOL,CHL,2011.0,1,2,-1
NAM,USA,2017.0,3,4,-1
IND,MEX,2009.0,4,7,-3
USA,BIH,2009.0,3,1,2
BGR,BEL,2009.0,7,2,5
AUS,SRB,2014.0,2,1,1
USA,SRB,2007.0,10,12,-2
VNM,IRN,2021.0,3,9,-6
CHE,TUR,2004.0,2,5,-3
NLD,SWE,1997.0,2,1,1
SGP,CHE,2006.0,3,8,-5
VEN,CAN,2003.0,3,3,0
CAN,OMN,2002.0,3,2,1
NLD,OMN,2015.0,2,1,1
BGR,ISR,2003.0,2,1,1
PAN,VEN,2015.0,1,1,0
KHM,IND,2018.0,1,2,-1
ISR,CHL,2021.0,2,4,-2
FRA,UKR,2015.0,7,21,-14
ROU,GRC,2017.0,2,1,1
SRB,MKD,2010.0,2,12,-10
QAT,DEU,2012.0,1,1,0
POL,CHL,2017.0,2,1,1
GHA,COG,2015.0,2,1,1
ARE,JOR,2007.0,4,6,-2
NOR,CAN,2001.0,7,2,5
HRV,TWN,2011.0,1,1,0
NER,FRA,2014.0,4,2,2
MAR,COG,2016.0,2,1,1
TWN,CHE,2014.0,5,7,-2
PRT,GRC,2013.0,2,5,-3
POL,CHL,2019.0,2,2,0
SRB,MKD,2017.0,3,5,-2
MAR,RUS,2018.0,2,1,1
CZE,GBR,2000.0,8,12,-4
CHE,IRN,2021.0,9,33,-24
LBY,USA,2022.0,1,1,0
SAU,BGD,2014.0,2,5,-3
DZA,BEL,2010.0,1,3,-2
NGA,DEU,2006.0,6,5,1
SAU,BRN,2017.0,2,1,1
EST,CHE,2014.0,4,2,2
ISL,DEU,2018.0,2,5,-3
JPN,HUN,2014.0,4,5,-1
USA,VNM,2002.0,3,3,0
LKA,NPL,2013.0,2,1,1
CMR,BWA,2019.0,1,1,0
SYR,GBR,2014.0,3,2,1
CHL,JPN,2005.0,3,2,1
GBR,SRB,2004.0,3,8,-5
USA,PNG,2011.0,3,3,0
PSE,GBR,2006.0,1,3,-2
NOR,CHL,2016.0,1,1,0
NOR,AUS,2022.0,5,11,-6
PAK,ARE,2012.0,7,3,4
ESP,BOL,1999.0,1,1,0
SGP,BRN,2015.0,6,4,2
SYR,DZA,2011.0,1,1,0
ISR,AUS,2008.0,4,12,-8
POL,LTU,2014.0,2,1,1
IND,COL,2015.0,2,1,1
NGA,UGA,2020.0,4,3,1
DNK,COL,2019.0,3,1,2
SVN,CHE,2013.0,2,2,0
MYS,PSE,2012.0,3,2,1
ITA,CYP,2017.0,2,2,0
GAB,BEL,2007.0,1,1,0
CYP,BEL,2016.0,1,2,-1
SYR,CHN,2010.0,1,1,0
GRC,KOR,2013.0,1,1,0
BEL,IRL,2012.0,5,8,-3
BEL,ISR,2015.0,6,7,-1
MAR,DEU,2010.0,1,1,0
FIN,POL,2008.0,2,3,-1
BEL,HKG,2020.0,3,2,1
AIA,USA,2018.0,1,1,0
NLD,ECU,2021.0,2,1,1
GBR,PER,2020.0,5,8,-3
SWE,VNM,2007.0,3,1,2
DNK,EST,2008.0,2,1,1
DEU,MAR,2002.0,1,2,-1
KOR,VNM,2005.0,2,2,0
SWE,CZE,2007.0,2,3,-1
MAR,SAU,2006.0,1,1,0
MYS,THA,2005.0,1,1,0
USA,JAM,1998.0,1,1,0
TUR,BEL,2004.0,1,3,-2
DNK,TZA,2009.0,1,2,-1
TWN,JPN,2000.0,3,9,-6
BOL,USA,2013.0,1,8,-7
BGD,TWN,2020.0,1,2,-1
HKG,FRA,2004.0,2,3,-1
KWT,USA,2007.0,6,7,-1
ISR,DNK,2013.0,4,2,2
ARM,FRA,2018.0,1,1,0
OMN,PAK,2016.0,5,5,0
USA,LKA,2007.0,3,11,-8
DEU,PRI,2018.0,1,1,0
ETH,BEL,2021.0,2,7,-5
NZL,GHA,2022.0,2,1,1
AUS,ARG,2018.0,2,7,-5
SWE,COL,2018.0,6,5,1
LUX,FIN,2008.0,1,3,-2
BEL,FIN,2006.0,4,2,2
ISR,JPN,1999.0,2,4,-2
SRB,SVK,2011.0,2,1,1
QAT,ITA,2021.0,3,5,-2
ARE,IDN,2021.0,1,1,0
CMR,CIV,2019.0,1,1,0
ISR,ESP,2007.0,4,5,-1
COL,DEU,2005.0,2,4,-2
NPL,CHN,2013.0,4,2,2
ITA,NGA,1998.0,1,1,0
TGO,BFA,2011.0,1,1,0
CHE,ISL,2004.0,1,1,0
GNB,DNK,2006.0,3,2,1
HRV,NLD,2010.0,2,1,1
DEU,MWI,2008.0,3,1,2
VNM,SRB,2020.0,2,2,0
QAT,TUN,2019.0,1,8,-7
KEN,ZAF,2008.0,3,3,0
LBY,GBR,2017.0,2,6,-4
MAR,DEU,2017.0,2,4,-2
PRT,THA,2011.0,2,1,1
RUS,KGZ,2013.0,1,1,0
HKG,GHA,2020.0,2,3,-1
ZWE,CHN,2016.0,1,2,-1
RUS,HKG,2007.0,1,1,0
CHL,PER,2007.0,4,2,2
ARE,SGP,2006.0,1,1,0
PRT,UKR,2010.0,2,1,1
LBN,EGY,2010.0,2,3,-1
MNG,AUS,2018.0,1,2,-1
NLD,SDN,2002.0,2,1,1
FIN,HKG,2016.0,1,3,-2
PER,MEX,2013.0,3,1,2
IRL,JPN,2021.0,2,5,-3
CHN,PRK,2020.0,5,4,1
COG,FRA,2006.0,4,2,2
AUS,VUT,2015.0,1,1,0
ESP,LTU,2020.0,2,2,0
TUN,JPN,2010.0,3,2,1
CHE,PHL,2003.0,1,2,-1
FRA,CRI,2005.0,2,1,1
PAK,EGY,2007.0,2,1,1
AUS,TZA,2007.0,1,1,0
SAU,GRC,2018.0,2,5,-3
COL,CHL,2007.0,2,6,-4
PRT,MYS,2015.0,1,1,0
GRC,FIN,2020.0,1,1,0
KGZ,CHN,2021.0,1,2,-1
ROU,TUR,2008.0,1,1,0
VNM,HUN,2019.0,1,2,-1
GRC,CZE,2016.0,3,1,2
JAM,BRB,2021.0,1,3,-2
SLV,ARG,2020.0,1,1,0
MLI,CIV,2012.0,2,1,1
UGA,ZAF,2022.0,2,3,-1
QAT,TUN,2017.0,1,5,-4
PER,PRI,2004.0,1,1,0
OMN,FRA,2006.0,1,1,0
FRA,NGA,2006.0,1,2,-1
NLD,ARG,2006.0,4,5,-1
CMR,DEU,2019.0,1,5,-4
GEO,RUS,2013.0,1,5,-4
PSE,ARE,2006.0,2,1,1
CHL,ISR,2020.0,1,2,-1
NOR,SVN,2019.0,1,2,-1
DZA,JPN,2008.0,1,2,-1
IRL,BRA,2011.0,1,2,-1
UGA,BEL,2012.0,2,3,-1
TUR,RUS,2000.0,1,1,0
CAN,DZA,2008.0,1,5,-4
IRN,RUS,2022.0,2,3,-1
BEL,IDN,2013.0,1,2,-1
BEL,PRT,2013.0,2,6,-4
TWN,ISR,2022.0,1,2,-1
AUT,KOR,2008.0,1,6,-5
PRY,ARG,2014.0,2,2,0
JPN,RWA,2019.0,1,1,0
AUT,SVN,2004.0,3,4,-1
DNK,AUT,2000.0,1,3,-2
PHL,CAN,2004.0,2,1,1
KOR,CHL,2016.0,1,3,-2
DNK,PRT,1999.0,2,1,1
TJK,RUS,2012.0,1,1,0
KOR,IRN,2007.0,2,2,0
NLD,ISR,2003.0,4,7,-3
LVA,SWE,2009.0,1,4,-3
AUT,HKG,2016.0,1,2,-1
DNK,URY,2013.0,1,1,0
SAU,MYS,2012.0,3,36,-33
ITA,URY,2020.0,1,1,0
JPN,PER,2008.0,1,1,0
PNG,GBR,2002.0,2,2,0
EGY,HRV,2018.0,1,1,0
ETH,DEU,2016.0,4,16,-12
TUN,JPN,2019.0,1,1,0
PRI,BRA,2009.0,2,2,0
SEN,GIN,2019.0,1,2,-1
ARG,PAN,2008.0,1,1,0
LUX,CHE,2012.0,1,1,0
FRA,GEO,2007.0,1,1,0
NOR,COL,2014.0,1,1,0
ESP,ZAF,2011.0,2,1,1
CHL,ITA,2003.0,3,3,0
RUS,SVK,1999.0,2,1,1
DNK,VNM,2005.0,1,1,0
SAU,KWT,2001.0,1,2,-1
POL,PRT,2021.0,2,6,-4
SGP,VNM,2022.0,3,4,-1
UZB,BEL,2004.0,1,1,0
CHE,UKR,2016.0,2,7,-5
POL,KOR,2008.0,2,1,1
IRL,VNM,2017.0,3,2,1
GRC,MLT,2021.0,2,2,0
LBN,EGY,2019.0,1,10,-9
SAU,BRA,2016.0,1,2,-1
CZE,ROU,2013.0,1,1,0
KAZ,AUS,2021.0,1,2,-1
COL,CRI,2017.0,1,1,0
GRC,ROU,2019.0,1,2,-1
NZL,NGA,2009.0,1,2,-1
CAN,SVK,2019.0,1,1,0
LKA,MYS,2018.0,2,3,-1
ETH,ZAF,2012.0,2,7,-5
LKA,NZL,2019.0,4,4,0
IRL,MEX,2021.0,2,1,1
NGA,JPN,2020.0,1,4,-3
NOR,NAM,2005.0,1,2,-1
ESP,LVA,2011.0,1,2,-1
KWT,IRN,2004.0,1,1,0
SVN,ESP,2004.0,1,2,-1
BGD,USA,1998.0,1,1,0
IRN,CHN,2006.0,1,2,-1
AUT,UKR,2011.0,1,2,-1
NGA,KOR,2013.0,1,1,0
PHL,TWN,2012.0,1,2,-1
SVK,HUN,2022.0,1,5,-4
JOR,PAK,2019.0,1,3,-2
GIN,SEN,2007.0,1,2,-1
EST,NLD,2013.0,1,2,-1
LUX,SWE,2018.0,1,3,-2
GBR,PSE,2020.0,3,3,0
HRV,BRA,2017.0,1,2,-1
IRL,PRT,2009.0,1,4,-3
JPN,IRN,2022.0,1,2,-1
ROU,JPN,2010.0,1,1,0
USA,JAM,1997.0,1,1,0
CAN,BHR,2004.0,1,2,-1
BEN,BEL,2005.0,1,3,-2
NOR,PRT,2009.0,1,1,0
KOR,VNM,2002.0,1,6,-5
LKA,NZL,2017.0,1,4,-3
DNK,ZAF,2012.0,1,5,-4
KOR,POL,2016.0,1,5,-4
GRC,AUT,2005.0,1,3,-2
NLD,SRB,2004.0,1,2,-1
NLD,RWA,2021.0,1,1,0
FIN,MEX,2020.0,1,2,-1
AZE,USA,2020.0,1,1,0
COL,CRI,2019.0,1,3,-2
BGD,DNK,2022.0,1,1,0
FRA,MCO,2011.0,5,3,2
BEL,USA,2008.0,108,106,2
AUT,DEU,2016.0,321,328,-7
COD,COG,2016.0,14,34,-20
AUS,FRA,2013.0,71,117,-46
KOR,IND,2010.0,86,150,-64
ESP,BEL,2017.0,78,35,43
ITA,DEU,2017.0,300,192,108
SAU,USA,2014.0,68,143,-75
IRL,ESP,2006.0,7,6,1
NZL,NOR,2014.0,10,5,5
SRB,CHE,2017.0,8,4,4
CHN,TWN,2000.0,16,9,7
PAK,CHN,2015.0,131,65,66
BRA,DNK,2016.0,18,8,10
CHN,SWE,2014.0,71,56,15
JPN,SWE,2021.0,19,9,10
CHE,SWE,2018.0,63,51,12
SRB,AUS,2015.0,3,2,1
PHL,JPN,2022.0,6,6,0
IND,IDN,2014.0,5,5,0
FRA,IRQ,2017.0,9,1,8
BEL,LUX,2021.0,6,5,1
ZAF,CHE,2015.0,19,15,4
CAN,ISR,2017.0,53,67,-14
KOR,DEU,2006.0,19,18,1
ITA,ROU,2007.0,11,10,1
ZAF,NGA,2015.0,42,59,-17
DEU,CZE,2009.0,29,24,5
DOM,USA,2010.0,1,2,-1
DEU,ARG,2018.0,23,29,-6
NZL,USA,2014.0,102,103,-1
NER,CHE,2020.0,1,1,0
ZAF,TZA,2012.0,4,2,2
FIN,AUS,2017.0,13,13,0
GBR,TUN,2004.0,3,1,2
NPL,USA,2017.0,28,20,8
RWA,NLD,2011.0,2,1,1
DNK,EGY,2020.0,5,1,4
VNM,USA,2007.0,6,6,0
FIN,LTU,2012.0,3,1,2
CHL,MEX,2022.0,4,2,2
AUS,DEU,2016.0,148,156,-8
CAN,ISR,2010.0,30,54,-24
QAT,JOR,2017.0,4,6,-2
HUN,CHE,1999.0,4,3,1
CHE,ZAF,2003.0,3,4,-1
POL,RUS,2010.0,9,4,5
BGD,SAU,2015.0,8,2,6
CAN,HRV,2002.0,2,1,1
GBR,PHL,2021.0,4,11,-7
NLD,GBR,1999.0,57,48,9
ZAF,FRA,2002.0,11,10,1
USA,COL,1999.0,10,8,2
UKR,USA,2013.0,23,17,6
IND,KWT,2001.0,2,5,-3
FIN,CZE,2006.0,1,2,-1
CUB,USA,2011.0,12,3,9
JPN,ZAF,2008.0,3,3,0
RUS,BRA,2006.0,6,4,2
PRT,FRA,2005.0,21,18,3
CAN,OMN,2005.0,4,1,3
ITA,TUR,2005.0,1,5,-4
EGY,QAT,2011.0,13,2,11
FRA,AUT,1998.0,3,6,-3
GBR,TWN,2004.0,26,12,14
ESP,PRT,2001.0,18,18,0
KOR,EGY,2013.0,5,3,2
ARG,MEX,2006.0,5,8,-3
MYS,SGP,2004.0,5,8,-3
IRL,IND,2010.0,10,16,-6
COG,BEL,2016.0,5,9,-4
MEX,ARG,2017.0,25,25,0
VNM,NPL,2019.0,1,1,0
NPL,IND,2017.0,12,34,-22
HUN,SGP,2018.0,1,1,0
LVA,EST,2016.0,6,2,4
CHL,VEN,2007.0,3,3,0
FRA,TWN,2012.0,17,13,4
PRT,RUS,2015.0,8,3,5
HUN,GBR,2018.0,47,32,15
LUX,ESP,2020.0,5,9,-4
USA,KAZ,2008.0,4,6,-2
BTN,THA,2020.0,2,2,0
FRA,KOR,1998.0,2,2,0
COL,NLD,2013.0,4,4,0
TZA,KEN,2015.0,4,5,-1
ESP,CHE,1997.0,12,5,7
BGD,USA,1997.0,1,2,-1
MEX,CUB,2003.0,6,23,-17
GMB,BEL,2014.0,1,1,0
BEL,BOL,2011.0,1,1,0
DZA,DEU,2006.0,3,4,-1
CRI,ARG,2012.0,1,1,0
SRB,ESP,2018.0,4,1,3
TZA,DEU,2011.0,4,1,3
POL,HUN,2022.0,1,2,-1
BWA,GBR,1999.0,2,2,0
VEN,PRI,2010.0,1,2,-1
AUT,SGP,2008.0,6,1,5
BEL,BGR,2016.0,2,1,1
SGP,MAC,2014.0,3,1,2
NGA,DNK,2013.0,1,1,0
CZE,IND,2013.0,3,12,-9
HKG,ESP,2014.0,2,1,1
ROU,JPN,2017.0,2,6,-4
KOR,NZL,2017.0,9,3,6
CAN,NPL,2018.0,2,2,0
AUT,ISR,2021.0,6,8,-2
NGA,SLE,2019.0,1,2,-1
POL,USA,1998.0,20,27,-7
JPN,NOR,2016.0,6,6,0
ITA,SRB,2011.0,6,1,5
USA,SLE,2013.0,4,1,3
GRC,ROU,2017.0,1,2,-1
KOR,PHL,2007.0,2,3,-1
LBY,GBR,2010.0,2,5,-3
PRT,CHE,2009.0,6,8,-2
USA,SYR,2018.0,1,1,0
SWZ,USA,2013.0,1,1,0
RUS,TJK,2013.0,5,2,3
YEM,CHN,2021.0,2,3,-1
LUX,USA,2012.0,5,3,2
USA,PSE,2012.0,6,1,5
ETH,ZWE,2006.0,1,1,0
SGP,SAU,2016.0,9,3,6
POL,BLR,2002.0,2,2,0
DNK,GRL,2014.0,2,4,-2
USA,ZMB,2009.0,4,5,-1
SVK,DNK,2008.0,1,1,0
AUS,MEX,2002.0,2,3,-1
NLD,MYS,2002.0,3,1,2
MYS,JOR,2006.0,2,2,0
CHN,JOR,2017.0,1,2,-1
BEL,UGA,2020.0,4,3,1
UKR,BLR,2014.0,1,1,0
FRA,TUR,2004.0,5,8,-3
ESP,SVN,2006.0,2,2,0
MUS,ZAF,2016.0,1,1,0
NZL,SGP,2001.0,1,3,-2
LUX,JPN,2016.0,2,1,1
TTO,JAM,2014.0,1,2,-1
NGA,AUT,2006.0,1,2,-1
AUS,HUN,2022.0,1,2,-1
GMB,NGA,2012.0,1,2,-1
NOR,HUN,2018.0,2,5,-3
HKG,DNK,2009.0,1,1,0
EST,CHN,2018.0,1,3,-2
ARG,SWE,2022.0,2,1,1
QAT,JOR,2010.0,1,5,-4
LVA,GBR,2018.0,1,3,-2
NOR,FRO,2015.0,2,1,1
MYS,THA,2002.0,1,2,-1
ROU,IND,2008.0,1,1,0
PHL,BGD,2014.0,1,1,0
CHN,,2024.0,869482,0,869482
SWE,,2024.0,28227,0,28227
DZA,,2012.0,143,0,143
IND,,2024.0,148278,0,148278
KOR,,2015.0,9257,0,9257
,POL,2004.0,4865,0,4865
FRA,,2021.0,20894,0,20894
,DNK,2008.0,2292,0,2292
TUR,,2015.0,3420,0,3420
NLD,,2012.0,2805,0,2805
,RUS,2001.0,7510,0,7510
TWN,MYS,2007.0,1,0,1
CAN,,2015.0,8368,0,8368
MYS,,2006.0,139,0,139
,NZL,1994.0,847,0,847
KAZ,,2000.0,10,0,10
,CHN,2015.0,175864,0,175864
AUS,,2000.0,163,0,163
ITA,,2001.0,252,0,252
HKG,,2009.0,746,0,746
VEN,,2010.0,346,0,346
,POL,1996.0,2641,0,2641
ISR,,2020.0,2797,0,2797
COL,,2022.0,4252,0,4252
GUF,,2022.0,31,0,31
SRB,,2022.0,2377,0,2377
,SVK,2001.0,683,0,683
,IRN,2013.0,11610,0,11610
PSE,SWE,2015.0,1,0,1
URY,,2014.0,67,0,67
,SWE,2012.0,3802,0,3802
BGD,,2023.0,3566,0,3566
BRN,,2012.0,7,0,7
,BWA,2006.0,40,0,40
,TLS,2003.0,1,0,1
ZWE,LSO,2006.0,1,0,1
TJK,,2018.0,20,0,20
IRL,,2020.0,1668,0,1668
VEN,,2019.0,597,0,597
BLR,,2002.0,55,0,55
GEO,,2014.0,60,0,60
,PSE,2005.0,55,0,55
,PSE,2002.0,22,0,22
ESP,,2004.0,2296,0,2296
SVK,,2004.0,156,0,156
,BEN,2004.0,52,0,52
TUR,DNK,2001.0,4,0,4
BFA,,2022.0,196,0,196
,ZAF,2007.0,1736,0,1736
,ROU,2016.0,1627,0,1627
,TZA,2010.0,204,0,204
VEN,,2017.0,554,0,554
MKD,,2016.0,65,0,65
,ARM,2010.0,147,0,147
,GRD,2010.0,17,0,17
,LBN,2010.0,311,0,311
,GEO,2011.0,145,0,145
GNB,,2022.0,13,0,13
,GHA,2013.0,460,0,460
,IRQ,2018.0,2445,0,2445
BIH,,2015.0,91,0,91
,PAN,2011.0,61,0,61
,TJK,2009.0,10,0,10
,MAC,2008.0,72,0,72
IDN,DNK,2008.0,1,0,1
MAC,,2021.0,133,0,133
CZE,LUX,2019.0,3,0,3
CHN,ZMB,2022.0,2,0,2
YEM,,2020.0,48,0,48
USA,MKD,2020.0,2,0,2
BLR,CHE,2016.0,1,0,1
,ARM,2017.0,137,0,137
MMR,,2022.0,100,0,100
,TZA,2017.0,299,0,299
NZL,,2005.0,299,0,299
TGO,,2022.0,85,0,85
,LBN,2017.0,572,0,572
,HTI,2015.0,30,0,30
,TTO,2009.0,62,0,62
,COD,2014.0,22,0,22
,MKD,2014.0,144,0,144
BLR,,2005.0,151,0,151
,NGA,2018.0,2506,0,2506
,BHR,2016.0,99,0,99
ARG,PRY,2022.0,1,0,1
,GRD,2017.0,16,0,16
,LBN,2019.0,287,0,287
,GAB,2016.0,31,0,31
BEL,MOZ,2020.0,4,0,4
BRA,MAC,2019.0,2,0,2
HRV,SAU,2016.0,1,0,1
,CMR,2018.0,414,0,414
,JAM,2018.0,21,0,21
,PNG,2012.0,40,0,40
BEN,CIV,2019.0,5,0,5
,ECU,1995.0,18,0,18
ISR,HRV,2012.0,1,0,1
NPL,,2012.0,62,0,62
,MLT,2007.0,53,0,53
KOR,LBY,2004.0,1,0,1
TUR,URY,2015.0,1,0,1
NZL,,2002.0,68,0,68
,CRI,1995.0,54,0,54
IND,TWN,1998.0,6,0,6
THA,CHE,1998.0,1,0,1
,KGZ,2012.0,23,0,23
,OMN,1997.0,10,0,10
AFG,GBR,2007.0,3,0,3
,SLE,1999.0,5,0,5
UKR,MDA,2018.0,1,0,1
JPN,SDN,2007.0,1,0,1
NAM,CHN,2020.0,1,0,1
ITA,CYP,2019.0,2,0,2
,NER,2003.0,16,0,16
,LAO,2016.0,43,0,43
,SEN,1999.0,116,0,116
KHM,CZE,2020.0,1,0,1
FIN,LUX,2004.0,1,0,1
,TZA,2019.0,158,0,158
MKD,DEU,2012.0,4,0,4
,SOM,2013.0,5,0,5
BWA,,2007.0,10,0,10
,ALB,2000.0,26,0,26
MLI,,2015.0,18,0,18
THA,ETH,2018.0,1,0,1
GHA,CIV,2018.0,3,0,3
ERI,,2010.0,5,0,5
LBY,,2008.0,15,0,15
,OMN,1998.0,152,0,152
AZE,UZB,2017.0,1,0,1
JOR,PAK,2017.0,2,0,2
,ATG,2001.0,1,0,1
POL,BRA,2000.0,4,0,4
TUN,CZE,2018.0,1,0,1
ISL,,2004.0,18,0,18
RUS,COL,2020.0,2,0,2
IDN,CHE,2003.0,2,0,2
LAO,IDN,2002.0,1,0,1
PAN,,2011.0,12,0,12
DEU,NPL,2006.0,2,0,2
,BEN,1996.0,5,0,5
TTO,,2016.0,33,0,33
BHR,AUS,2004.0,1,0,1
FIN,ARE,2011.0,3,0,3
HRV,ITA,2003.0,3,0,3
,MUS,2005.0,17,0,17
AUS,KWT,2006.0,3,0,3
JPN,GRC,2000.0,1,0,1
VEN,ITA,2006.0,4,0,4
,NCL,2002.0,12,0,12
NZL,COL,2010.0,1,0,1
SEN,CHE,2022.0,2,0,2
CHN,EGY,2009.0,5,0,5
BLR,POL,2001.0,4,0,4
GHA,OMN,2019.0,1,0,1
SWE,GRL,2008.0,1,0,1
UKR,FRA,1998.0,4,0,4
PAK,CHE,1999.0,1,0,1
LBY,ARE,2006.0,1,0,1
SLV,URY,2012.0,1,0,1
DEU,GMB,2005.0,2,0,2
JPN,HKG,2000.0,3,0,3
,NCL,2005.0,11,0,11
ROU,SGP,2015.0,1,0,1
SLV,,2011.0,2,0,2
NZL,LKA,2007.0,2,0,2
TUN,KWT,2005.0,2,0,2
MDV,AUS,2012.0,1,0,1
ZAF,CIV,2017.0,1,0,1
BIH,ITA,2016.0,2,0,2
,MUS,2002.0,14,0,14
PAK,BRN,2010.0,1,0,1
,MRT,2006.0,5,0,5
LTU,ITA,2004.0,2,0,2
GRC,ROU,2010.0,2,0,2
KOR,MNG,2015.0,10,0,10
JPN,LBY,2007.0,1,0,1
CHN,HRV,2015.0,1,0,1
,GUF,2007.0,5,0,5
AUS,GHA,2009.0,1,0,1
GBR,BIH,2018.0,4,0,4
CUB,CHL,2020.0,8,0,8
JOR,GRC,2013.0,1,0,1
ROU,POL,2013.0,8,0,8
BIH,BGR,2018.0,1,0,1
TWN,BHR,2016.0,1,0,1
NGA,FIN,2012.0,2,0,2
MAR,SEN,2010.0,2,0,2
ETH,CAN,2014.0,3,0,3
BEN,GAB,2019.0,2,0,2
COL,KHM,2016.0,1,0,1
NER,CIV,2018.0,2,0,2
LKA,,2004.0,16,0,16
ISR,THA,2012.0,1,0,1
NAM,KEN,2012.0,1,0,1
MNG,RUS,2003.0,1,0,1
YEM,HUN,1999.0,2,0,2
GMB,NLD,2020.0,1,0,1
SAU,OMN,2007.0,2,0,2
SOM,GBR,2018.0,1,0,1
ITA,MKD,2012.0,3,0,3
NZL,SVK,2014.0,1,0,1
GUY,,2021.0,8,0,8
GRC,ARM,2020.0,1,0,1
SRB,KAZ,2017.0,1,0,1
ISR,CZE,2020.0,5,0,5
,MCO,2009.0,7,0,7
NZL,KEN,2002.0,1,0,1
PAK,MEX,2022.0,1,0,1
,GRD,2019.0,11,0,11
CZE,BHR,2007.0,1,0,1
SWE,EGY,2004.0,3,0,3
BEL,DZA,2008.0,1,0,1
JPN,MKD,2015.0,1,0,1
AUT,LUX,2008.0,1,0,1
COG,,2006.0,9,0,9
MUS,USA,2003.0,2,0,2
,LSO,2000.0,4,0,4
FRA,SAU,2010.0,13,0,13
ZWE,NLD,2002.0,3,0,3
BLR,ISR,2013.0,1,0,1
DEU,SAU,2001.0,1,0,1
COG,ITA,2015.0,2,0,2
BMU,,2020.0,2,0,2
AUS,EGY,1998.0,1,0,1
KNA,AUS,2016.0,1,0,1
ARE,MAR,2014.0,2,0,2
COG,KEN,2016.0,1,0,1
UGA,,2005.0,14,0,14
SRB,ARG,2008.0,1,0,1
NGA,SGP,2004.0,1,0,1
COL,BHS,2021.0,1,0,1
GMB,NZL,2010.0,1,0,1
FJI,WSM,2008.0,1,0,1
NGA,JAM,2009.0,2,0,2
NGA,BRA,2013.0,3,0,3
FIN,KWT,2018.0,2,0,2
NOR,ZMB,2018.0,2,0,2
HKG,BGD,2016.0,3,0,3
ITA,MDA,2016.0,2,0,2
SYR,ARE,2005.0,1,0,1
THA,KHM,2014.0,2,0,2
SWZ,NGA,2014.0,1,0,1
ERI,,2017.0,4,0,4
PAK,CYP,2020.0,2,0,2
MYS,OMN,2022.0,5,0,5
VUT,,2016.0,2,0,2
BGD,LTU,2022.0,1,0,1
BEN,DEU,2019.0,1,0,1
BEL,PHL,2005.0,1,0,1
CIV,CHN,2014.0,1,0,1
CZE,BGR,2004.0,1,0,1
CMR,ZAF,2001.0,1,0,1
,MTQ,2006.0,5,0,5
,MMR,2008.0,21,0,21
TUR,SYR,2005.0,1,0,1
MCO,,2014.0,8,0,8
,ARM,2019.0,39,0,39
SGP,EGY,2021.0,6,0,6
HUN,SVN,2022.0,1,0,1
FRA,CAF,2003.0,8,0,8
FIN,TWN,2002.0,1,0,1
GIB,BEL,2010.0,1,0,1
HRV,CHE,2011.0,5,0,5
DJI,,2021.0,3,0,3
SGP,MEX,2015.0,3,0,3
HRV,DNK,2015.0,3,0,3
HND,SWE,2008.0,1,0,1
PSE,MOZ,2020.0,1,0,1
LUX,ZAF,2018.0,1,0,1
ZAF,TUN,2017.0,2,0,2
GIB,ISR,2018.0,1,0,1
GLP,,2018.0,5,0,5
CAN,UGA,2012.0,2,0,2
CAN,MAC,2013.0,1,0,1
LKA,NZL,2010.0,4,0,4
NPL,QAT,2018.0,1,0,1
IRN,CHL,2019.0,4,0,4
UGA,SWE,2013.0,1,0,1
JPN,IRL,2016.0,5,0,5
ERI,,2019.0,1,0,1
COL,KEN,2005.0,1,0,1
AUS,SLE,2018.0,1,0,1
ITA,LUX,2008.0,1,0,1
ESP,COG,2007.0,1,0,1
JPN,LBN,2010.0,1,0,1
GHA,IRN,2012.0,1,0,1
MAR,SWE,2002.0,1,0,1
ROU,HKG,2002.0,1,0,1
DEU,MCO,2019.0,4,0,4
LVA,FRA,2000.0,1,0,1
ROU,FIN,2002.0,1,0,1
KEN,DNK,2013.0,2,0,2
SWE,GRC,1999.0,2,0,2
TZA,POL,2000.0,1,0,1
ISR,UKR,2014.0,1,0,1
MNG,BWA,2017.0,1,0,1
IRL,FIN,1997.0,1,0,1
BGD,IND,1998.0,3,0,3
JPN,SEN,2013.0,2,0,2
IND,ROU,2011.0,1,0,1
EGY,PAK,2000.0,1,0,1
SGP,CZE,2018.0,6,0,6
BEL,IRQ,2013.0,1,0,1
NER,GBR,2013.0,1,0,1
BGD,NZL,2003.0,1,0,1
SWZ,,2007.0,3,0,3
SVN,KWT,2021.0,1,0,1
SRB,ALB,2009.0,1,0,1
BHS,,2007.0,1,0,1
SEN,CHN,2014.0,1,0,1
RUS,ISL,2016.0,1,0,1
COM,,2014.0,4,0,4
EST,BEL,2015.0,1,0,1
SRB,CHE,2010.0,4,0,4
SWE,MNG,2013.0,1,0,1
RWA,EGY,2020.0,1,0,1
IRN,,1999.0,2,0,2
UKR,HUN,2019.0,2,0,2
CHE,GUF,2003.0,1,0,1
CUB,SWE,2000.0,2,0,2
IND,EST,2007.0,1,0,1
ARE,ROU,2016.0,1,0,1
BLR,DEU,2022.0,1,0,1
,DOM,2001.0,5,0,5
GHA,GMB,2006.0,1,0,1
CZE,SRB,1997.0,1,0,1
CHE,EGY,2006.0,2,0,2
ZWE,NLD,2005.0,2,0,2
UZB,MYS,2005.0,2,0,2
CZE,NOR,2002.0,2,0,2
IND,ETH,2002.0,1,0,1
NOR,SVN,2017.0,1,0,1
TWN,FIN,2012.0,4,0,4
HUN,LBY,2001.0,1,0,1
GRC,AUT,2002.0,3,0,3
ISR,SGP,2004.0,1,0,1
BWA,IND,2022.0,2,0,2
GBR,BMU,2012.0,1,0,1
BGR,NOR,2021.0,1,0,1
BGD,IND,1997.0,1,0,1
MWI,MAR,2017.0,1,0,1
CMR,JPN,2015.0,1,0,1
ESP,ZWE,2006.0,1,0,1
UGA,GIN,2018.0,1,0,1
SRB,BRA,2014.0,1,0,1
SVN,ZAF,2008.0,1,0,1
AUT,REU,2017.0,1,0,1
QAT,IRQ,2014.0,1,0,1
CMR,BWA,2017.0,1,0,1
FRA,JOR,2013.0,2,0,2
DEU,MCO,2017.0,1,0,1
ASM,PHL,2016.0,1,0,1
GUF,SUR,2015.0,1,0,1
IRQ,ROU,2015.0,1,0,1
POL,NZL,2018.0,3,0,3
FJI,FRA,2016.0,1,0,1
ROU,TWN,2009.0,2,0,2
SVK,NZL,2004.0,1,0,1
CHN,LKA,2014.0,2,0,2
ITA,MWI,2013.0,1,0,1
TZA,NAM,2021.0,1,0,1
PRT,NZL,2013.0,1,0,1
ESP,GRL,2021.0,1,0,1
LBN,CHE,2011.0,1,0,1
SRB,BGR,2009.0,1,0,1
EST,POL,2004.0,1,0,1
BGR,PRT,2002.0,3,0,3
ZWE,ZAF,1999.0,2,0,2
KAZ,PAK,2008.0,1,0,1
TWN,NOR,2007.0,1,0,1
CAN,GHA,2007.0,2,0,2
ITA,CYP,2010.0,3,0,3
ITA,UGA,2006.0,1,0,1
ROU,ISR,2008.0,1,0,1
ROU,NLD,2022.0,1,0,1
HKG,SAU,2010.0,2,0,2
NGA,CZE,2014.0,1,0,1
LTU,SGP,2016.0,1,0,1
ITA,TGO,2014.0,2,0,2
PHL,LAO,2017.0,3,0,3
POL,ISL,2016.0,2,0,2
TWN,BGR,2017.0,2,0,2
DEU,NER,2020.0,1,0,1
MYS,CYP,2019.0,1,0,1
PHL,KAZ,2020.0,1,0,1
,NIC,1999.0,2,0,2
MWI,GMB,2005.0,1,0,1
MNG,DNK,2017.0,1,0,1
LTU,NOR,2020.0,1,0,1
TJK,ITA,2012.0,1,0,1
KHM,NPL,2015.0,1,0,1
TGO,BEL,2020.0,1,0,1
SEN,,2000.0,2,0,2
CHL,ISL,2009.0,1,0,1
CZE,LVA,2007.0,1,0,1
WSM,IND,2017.0,1,0,1
GBR,QAT,2006.0,3,0,3
MEX,GTM,2005.0,1,0,1
BGR,TUR,1999.0,1,0,1
IND,TWN,1997.0,1,0,1
TKM,,2022.0,2,0,2
JPN,CRI,2017.0,2,0,2
ARG,CRI,2020.0,2,0,2
BIH,DEU,2022.0,2,0,2
JPN,KWT,2003.0,3,0,3
ESP,IDN,2022.0,2,0,2
ITA,PHL,2005.0,1,0,1
CAN,BOL,2003.0,1,0,1
CIV,DEU,1999.0,1,0,1
VEN,FRA,2022.0,2,0,2
SWE,MAR,2013.0,1,0,1
NGA,GMB,2003.0,1,0,1
ZAF,CHL,2014.0,2,0,2
PSE,IRQ,2009.0,1,0,1
CHL,SGP,2016.0,1,0,1
GBR,NPL,2001.0,2,0,2
GHA,KAZ,2022.0,1,0,1
ZAF,SDN,2022.0,1,0,1
FRA,AND,2015.0,1,0,1
ARG,POL,2009.0,1,0,1
JOR,RWA,2004.0,1,0,1
FRA,TGO,2008.0,4,0,4
ECU,IND,2021.0,1,0,1
RWA,BFA,2017.0,1,0,1
ESP,HRV,2006.0,1,0,1
NLD,CMR,2020.0,2,0,2
HKG,KAZ,2020.0,1,0,1
PRT,SDN,2008.0,1,0,1
TUN,DZA,2005.0,1,0,1
BEN,SEN,2004.0,1,0,1
ZWE,ZMB,2021.0,1,0,1
USA,BEN,2012.0,2,0,2
CAN,BWA,2003.0,1,0,1
HKG,BRN,2006.0,1,0,1
MWI,DEU,2013.0,1,0,1
KAZ,ITA,2010.0,2,0,2
CHL,MDA,2015.0,1,0,1
SVK,KOR,2015.0,1,0,1
ESP,GUM,2019.0,1,0,1
UGA,PER,2008.0,3,0,3
PHL,CIV,2019.0,1,0,1
ZAF,COD,2020.0,2,0,2
PRT,CHN,1998.0,1,0,1
UZB,ESP,2018.0,1,0,1
SVN,NOR,2010.0,1,0,1
SAU,SWE,2023.0,1,0,1
CIV,BDI,2018.0,1,0,1
ZAF,ARE,2022.0,2,0,2
DEU,MCO,2010.0,1,0,1
TUR,PAK,2008.0,2,0,2
ZWE,KOR,2021.0,1,0,1
DNK,UGA,2007.0,1,0,1
MLI,CHE,2008.0,2,0,2
ARE,CZE,2016.0,2,0,2
BWA,CAN,2012.0,1,0,1
HUN,QAT,2014.0,1,0,1
BRN,TWN,2018.0,2,0,2
CUB,POL,2011.0,1,0,1
TGO,CIV,2014.0,2,0,2
CAF,VNM,2008.0,1,0,1
MYS,CHE,2003.0,1,0,1
CHN,MDA,2017.0,1,0,1
PAK,KAZ,2015.0,1,0,1
MYS,MWI,2018.0,1,0,1
NCL,SEN,2017.0,2,0,2
GBR,BLZ,2016.0,1,0,1
DNK,GEO,2004.0,1,0,1
JOR,LBY,2020.0,1,0,1
AFG,NLD,2020.0,1,0,1
BEL,SAU,2009.0,1,0,1
HTI,NPL,2020.0,1,0,1
ARE,DZA,2019.0,1,0,1
TON,,2021.0,2,0,2
HRV,CAN,1998.0,1,0,1
ROU,SAU,2013.0,1,0,1
RWA,FRA,1998.0,1,0,1
CMR,RUS,2022.0,1,0,1
MOZ,CHE,2005.0,1,0,1
GMB,ZAF,2010.0,1,0,1
BEL,LBY,2005.0,1,0,1
MDG,GBR,2001.0,1,0,1
MAR,CHE,2009.0,1,0,1
SYR,TUN,2020.0,1,0,1
TON,CAN,2002.0,2,0,2
CAN,SEN,2022.0,1,0,1
ISR,MKD,2009.0,1,0,1
BEN,CIV,2010.0,1,0,1
ZWE,NGA,2009.0,1,0,1
BIH,SWE,2012.0,1,0,1
MTQ,,2008.0,4,0,4
UKR,FRA,1997.0,1,0,1
KHM,PHL,2008.0,1,0,1
FIN,TWN,2005.0,1,0,1
SWE,VEN,1999.0,1,0,1
IRN,NZL,2004.0,1,0,1
TWN,MEX,2015.0,1,0,1
ITA,GNB,2011.0,1,0,1
CAN,COG,2014.0,1,0,1
NZL,COL,2017.0,1,0,1
SGP,BRA,2022.0,1,0,1
JOR,PAK,2010.0,1,0,1
VEN,PRI,2017.0,2,0,2
ROU,RUS,2022.0,1,0,1
MYS,BWA,2020.0,1,0,1
HKG,LUX,2021.0,1,0,1
BGR,PRT,2005.0,1,0,1
UZB,PRT,2007.0,1,0,1
CHL,BWA,2019.0,1,0,1
CHN,SLE,2020.0,4,0,4
ISR,BLR,2014.0,1,0,1
FIN,TZA,2016.0,1,0,1
COG,ZAF,2004.0,1,0,1
ITA,SMR,2004.0,1,0,1
BGR,AUS,2019.0,1,0,1
NOR,QAT,2005.0,1,0,1
COL,THA,2013.0,1,0,1
BGD,NIC,2002.0,1,0,1
NLD,ETH,2005.0,2,0,2
VUT,KHM,2018.0,1,0,1
AUS,BRB,2017.0,1,0,1
CHE,DZA,2011.0,1,0,1
BEN,DEU,2010.0,1,0,1
SYR,JOR,2015.0,2,0,2
GLP,CUB,2002.0,1,0,1
ISR,ISL,2016.0,1,0,1
VNM,,2000.0,2,0,2
TUN,GIN,2008.0,1,0,1
JPN,RWA,2017.0,1,0,1
BLR,PRT,2015.0,1,0,1
THA,IRL,2017.0,1,0,1
NOR,BGD,2020.0,1,0,1
NLD,BFA,2017.0,2,0,2
LBN,BEL,2022.0,1,0,1
ZAF,TUN,2019.0,1,0,1
VUT,GBR,2006.0,1,0,1
LBR,BEL,2015.0,1,0,1
ISL,RUS,2021.0,1,0,1
GMB,ZAF,2019.0,1,0,1
ESP,ARM,2003.0,1,0,1
AUT,URY,2014.0,1,0,1
TWN,FJI,2018.0,1,0,1
SRB,FIN,2022.0,1,0,1
KWT,LBN,2006.0,1,0,1
COL,UGA,2005.0,1,0,1
SGP,ROU,2020.0,2,0,2
CZE,BOL,2018.0,1,0,1
MDG,TUN,2012.0,1,0,1
MUS,AUS,2014.0,1,0,1
BEL,OMN,2016.0,1,0,1
BLR,DNK,2017.0,1,0,1
CAN,PRI,2022.0,1,0,1
AZE,DEU,2004.0,1,0,1
IRL,BHR,2007.0,1,0,1
UKR,SVK,2012.0,3,0,3
RUS,BWA,2012.0,1,0,1
NGA,SLE,2017.0,1,0,1
GNQ,,2014.0,1,0,1
ZAF,SVK,2015.0,1,0,1
CMR,KHM,2009.0,1,0,1
MDG,CMR,2007.0,1,0,1
HKG,MYS,2003.0,2,0,2
CHE,IRL,1998.0,1,0,1
JPN,LBN,2017.0,1,0,1
PRT,HKG,2015.0,1,0,1
THA,RUS,2010.0,1,0,1
MDA,JOR,2006.0,1,0,1
MAR,SEN,2019.0,1,0,1
DEU,LBY,2009.0,1,0,1
BHR,IRQ,2014.0,2,0,2
LBR,GBR,2019.0,1,0,1
NER,MRT,2000.0,1,0,1
NZL,SVN,2013.0,1,0,1
AUT,LKA,2012.0,1,0,1
SYR,IRN,2012.0,1,0,1
SYR,IRQ,2016.0,2,0,2
RUS,IRQ,2014.0,1,0,1
DNK,MLT,2016.0,1,0,1
BGR,KOR,2009.0,1,0,1
COL,CHN,2016.0,1,0,1
MLI,SWE,2011.0,1,0,1
,MWI,1995.0,2,0,2
TUR,PRT,2009.0,1,0,1
TCA,,2020.0,1,0,1
IRL,MLT,2012.0,2,0,2
SEN,CAF,2008.0,1,0,1
PHL,PRT,2012.0,1,0,1
PSE,,2001.0,1,0,1
MKD,SRB,2022.0,1,0,1
URY,PER,2018.0,1,0,1
ZMB,AUS,2015.0,1,0,1
MYS,LVA,2019.0,1,0,1
SGP,GHA,2020.0,1,0,1
IND,LAO,2000.0,1,0,1
MCO,SVK,2007.0,1,0,1
SRB,CZE,2015.0,2,0,2
EST,LTU,2016.0,1,0,1
BLR,EST,2014.0,1,0,1
MNE,BRA,2012.0,1,0,1
GMB,QAT,2019.0,1,0,1
DNK,BOL,2002.0,1,0,1
UGA,,2002.0,1,0,1
TGO,KEN,2022.0,1,0,1
MDA,FIN,2009.0,2,0,2
BEN,BEL,2002.0,1,0,1
LVA,ESP,2014.0,1,0,1
VNM,TUR,2022.0,1,0,1
ITA,KAZ,2006.0,1,0,1
BRA,THA,2004.0,1,0,1
POL,TWN,2000.0,1,0,1
ZMB,BWA,2006.0,1,0,1
DNK,BGR,2003.0,1,0,1
USA,MYS,1997.0,1,0,1
FRA,CRI,2002.0,2,0,2
MYS,MDA,2015.0,1,0,1
SWE,SDN,2015.0,1,0,1
FIN,SGP,1998.0,1,0,1
FRA,UGA,2008.0,1,0,1
DEU,MLI,2019.0,1,0,1
ZAF,PSE,2018.0,1,0,1
BIH,CZE,2021.0,1,0,1
SVK,NOR,2016.0,1,0,1
KOR,MUS,2019.0,1,0,1
SDN,TZA,2019.0,1,0,1
CZE,CMR,2018.0,1,0,1
,DZA,2020.0,1,0,1
IRQ,JOR,2002.0,1,0,1
UKR,NOR,2004.0,2,0,2
ZMB,TZA,1999.0,1,0,1
GUM,IRQ,2018.0,1,0,1
BRA,IDN,2012.0,1,0,1
SAU,LBN,2004.0,1,0,1
ARG,FIN,2007.0,1,0,1
SWE,GNB,2016.0,1,0,1
NOR,ISR,1997.0,1,0,1
TCA,OMN,2007.0,1,0,1
LVA,DEU,1997.0,1,0,1
TZA,SGP,2019.0,1,0,1
DEU,MDA,1997.0,1,0,1
COM,BFA,2003.0,1,0,1
IRQ,HUN,2014.0,1,0,1
SAU,GHA,2014.0,1,0,1
NAM,USA,2010.0,1,0,1
BRA,SVN,2022.0,1,0,1
TUR,KEN,2021.0,1,0,1
MMR,AUS,2014.0,1,0,1
PRT,LUX,2018.0,1,0,1
FRA,USA,2005.0,636,526,110
ITA,FRA,2006.0,190,170,20
NOR,DEU,2019.0,42,69,-27
IND,FRA,2009.0,70,39,31
ROU,SGP,2004.0,2,1,1
ARE,SAU,2003.0,6,5,1
SGP,USA,2009.0,167,211,-44
IND,USA,2010.0,902,568,334
SWE,ROU,2012.0,1,5,-4
AUT,AUS,2010.0,18,13,5
HKG,AUS,2022.0,15,25,-10
HRV,GBR,2009.0,3,7,-4
USA,SWE,2006.0,142,212,-70
GBR,NZL,2004.0,105,74,31
POL,ITA,2014.0,71,17,54
ESP,USA,2020.0,453,369,84
CAN,CRI,2019.0,2,8,-6
NLD,FRA,2006.0,77,87,-10
CAN,USA,2003.0,1372,1300,72
USA,FRA,2009.0,649,681,-32
GBR,USA,2004.0,1327,964,363
USA,AUT,2009.0,93,86,7
CHE,DEU,2019.0,471,582,-111
LTU,USA,2013.0,2,10,-8
NZL,IND,2019.0,13,11,2
ITA,USA,2015.0,490,325,165
IND,USA,2019.0,1345,712,633
CHE,USA,2012.0,427,519,-92
MEX,USA,2016.0,197,200,-3
JPN,ESP,2016.0,12,24,-12
AUS,GBR,2010.0,381,535,-154
USA,ZWE,2014.0,5,3,2
RUS,GBR,2007.0,55,18,37
SWE,CAN,2016.0,36,39,-3
BRA,ARG,2011.0,24,21,3
CHN,BRA,2002.0,2,6,-4
CHN,NOR,2009.0,13,9,4
GBR,NOR,2001.0,27,22,5
ITA,FIN,2014.0,18,13,5
FIN,DEU,2009.0,42,24,18
CHE,ISL,2015.0,3,1,2
AUT,POL,2008.0,5,10,-5
GBR,CAN,2002.0,230,220,10
ZAF,SYC,2018.0,1,2,-1
POL,GBR,2011.0,53,80,-27
VEN,USA,2012.0,23,14,9
BEL,TUN,2019.0,5,4,1
ESP,GBR,2018.0,450,340,110
USA,HKG,2005.0,61,98,-37
TWN,NLD,2010.0,6,2,4
USA,ITA,2000.0,144,193,-49
CHN,AUS,2006.0,61,66,-5
JPN,DEU,2006.0,102,85,17
IND,USA,2017.0,1221,676,545
CHN,FIN,2009.0,8,14,-6
GRC,POL,2010.0,4,2,2
ESP,MEX,2001.0,26,45,-19
DNK,USA,2004.0,97,73,24
USA,PHL,2003.0,23,14,9
IND,GBR,2008.0,140,97,43
MAR,FRA,2009.0,33,61,-28
GBR,PRT,2014.0,64,88,-24
SGP,DEU,2010.0,20,30,-10
GBR,CAN,2005.0,300,212,88
USA,POL,2001.0,56,98,-42
DEU,GBR,2003.0,362,389,-27
PHL,USA,2009.0,20,21,-1
CHE,ITA,2017.0,99,279,-180
IRN,AUS,2010.0,53,22,31
USA,MEX,2001.0,86,115,-29
FRA,IRN,2009.0,19,6,13
UKR,POL,2006.0,14,11,3
AUS,GBR,2017.0,518,562,-44
FRA,TUN,2009.0,92,79,13
GBR,AUS,1999.0,139,102,37
CHN,DEU,2016.0,325,317,8
CHN,BEL,2018.0,57,60,-3
USA,BRA,2022.0,139,253,-114
GBR,THA,2009.0,51,22,29
MYS,CAN,2014.0,20,11,9
PER,USA,2009.0,30,33,-3
IND,POL,2011.0,21,3,18
USA,LBN,2016.0,56,69,-13
JPN,FRA,2021.0,63,88,-25
AUS,GBR,2019.0,565,584,-19
ESP,ECU,2014.0,37,4,33
MYS,AUS,2015.0,105,110,-5
TWN,NLD,2019.0,3,1,2
USA,ARG,2022.0,28,51,-23
CHE,ITA,2019.0,155,250,-95
USA,IND,2001.0,152,329,-177
DEU,CHE,2022.0,241,188,53
MYS,SGP,2015.0,12,15,-3
ESP,AUT,2017.0,27,18,9
MYS,CHN,2020.0,65,20,45
BEL,FRA,2002.0,131,133,-2
BEL,FRA,2005.0,108,132,-24
IRN,AUS,2019.0,200,34,166
NLD,ITA,2017.0,78,128,-50
MAC,CHN,2014.0,25,38,-13
GBR,TWN,2015.0,22,24,-2
MYS,PAK,2018.0,146,44,102
TWN,SAU,2015.0,17,2,15
ZAF,UGA,2019.0,10,5,5
FRA,USA,2002.0,756,591,165
AUS,MYS,2018.0,102,131,-29
KOR,SGP,2017.0,27,21,6
SWE,TZA,2012.0,6,3,3
ESP,AUT,2019.0,30,28,2
SWE,FRA,2015.0,45,82,-37
ISR,IND,2021.0,52,106,-54
POL,AUS,2014.0,23,5,18
BEL,NLD,2013.0,117,136,-19
PRT,AUS,2015.0,16,3,13
USA,CHE,2020.0,510,488,22
NOR,DEU,2010.0,34,51,-17
BEL,CHE,2011.0,48,27,21
KOR,FIN,2017.0,9,3,6
NLD,ITA,2019.0,75,124,-49
MEX,FRA,2019.0,47,43,4
POL,UKR,2021.0,14,22,-8
GBR,DEU,2022.0,293,206,87
NOR,FIN,2020.0,23,27,-4
EGY,KOR,2017.0,2,7,-5
DEU,ETH,2018.0,9,2,7
SWE,JPN,2020.0,17,35,-18
LTU,FRA,2014.0,3,3,0
OMN,QAT,2009.0,1,2,-1
JPN,MEX,2018.0,7,8,-1
SWE,JOR,2019.0,1,2,-1
GBR,KOR,2019.0,42,80,-38
BGR,DEU,2017.0,5,15,-10
ZAF,AUS,2014.0,35,26,9
THA,GBR,2018.0,42,92,-50
AUS,ZAF,2020.0,31,46,-15
COG,CMR,2018.0,1,1,0
CHL,BEL,2019.0,6,9,-3
MDG,FRA,2019.0,6,6,0
TUN,FRA,2021.0,61,34,27
CHL,ESP,2018.0,71,110,-39
JPN,KOR,2013.0,131,96,35
CAN,KOR,2014.0,36,48,-12
SAU,GBR,2014.0,34,113,-79
KOR,UZB,2019.0,3,3,0
THA,DEU,2017.0,8,25,-17
MEX,PER,2022.0,4,2,2
IRN,KOR,2021.0,22,4,18
VNM,CHN,2017.0,6,24,-18
CHN,IDN,2018.0,5,4,1
TWN,USA,2022.0,70,64,6
MYS,HKG,2021.0,2,2,0
JPN,MYS,2014.0,94,18,76
ESP,LUX,2015.0,7,4,3
ITA,CHN,2022.0,32,35,-3
FRA,SEN,2019.0,38,18,20
PAK,CZE,2021.0,3,2,1
MYS,LBY,2019.0,18,1,17
AUT,AUS,2019.0,18,19,-1
TUR,AUS,2017.0,19,8,11
DNK,IRL,2020.0,7,6,1
ESP,SGP,2020.0,5,7,-2
FRA,THA,2020.0,15,9,6
USA,BGD,2009.0,17,17,0
USA,KHM,2020.0,5,2,3
PAK,HKG,2021.0,10,2,8
BRN,MYS,2019.0,5,6,-1
GBR,RUS,2021.0,38,39,-1
IND,CAN,2009.0,84,50,34
SWE,LVA,1998.0,2,1,1
ARE,PAK,2021.0,4,14,-10
ESP,RUS,2004.0,8,7,1
AUT,AUS,2017.0,32,22,10
CHE,DEU,2010.0,387,558,-171
SRB,GBR,2011.0,4,6,-2
GUF,FRA,2015.0,14,22,-8
DEU,RUS,2015.0,72,95,-23
HKG,SGP,2004.0,22,17,5
NPL,AUS,2022.0,8,5,3
QAT,EGY,2022.0,4,2,2
TWN,CAN,2020.0,17,11,6
LBN,GBR,2015.0,3,9,-6
AUS,ECU,2020.0,4,1,3
IND,KOR,2007.0,101,25,76
IRN,USA,2006.0,54,36,18
POL,JPN,2008.0,7,8,-1
ESP,AUT,2010.0,12,13,-1
DEU,SWE,2008.0,103,79,24
ESP,AUS,2016.0,56,30,26
EGY,IRL,2013.0,1,1,0
TUR,AUS,2019.0,17,5,12
CAN,QAT,2014.0,15,2,13
CZE,GRC,2021.0,5,6,-1
SWE,NOR,2005.0,55,19,36
MEX,FRA,2010.0,32,46,-14
THA,FRA,2017.0,19,17,2
AUS,JOR,2016.0,8,4,4
UKR,CHN,2014.0,6,2,4
BEL,ITA,2011.0,34,79,-45
NAM,DEU,2020.0,4,2,2
FRA,SGP,2011.0,34,12,22
BHR,USA,2019.0,3,4,-1
GBR,ISL,2003.0,10,10,0
UGA,KEN,2011.0,3,2,1
CHE,ESP,2009.0,34,44,-10
RUS,CHE,2006.0,29,7,22
ZAF,NZL,2016.0,6,8,-2
RUS,ZAF,2016.0,2,3,-1
SWE,LTU,2018.0,3,4,-1
CZE,BEL,2009.0,6,4,2
AUS,RUS,2020.0,5,10,-5
FRA,FIN,2012.0,20,19,1
FRA,SEN,2017.0,26,33,-7
IRN,PRT,2015.0,17,1,16
RUS,IRN,2002.0,4,1,3
PAK,SGP,2020.0,5,2,3
SGP,DEU,2017.0,30,39,-9
CAN,PAK,2018.0,24,29,-5
GBR,KOR,2010.0,47,32,15
KOR,CAN,2005.0,26,26,0
CHL,FRA,2016.0,32,47,-15
IND,HKG,2018.0,22,16,6
KEN,GHA,2018.0,4,2,2
AUS,CHL,2018.0,25,13,12
VNM,CHN,2019.0,9,26,-17
MYS,LBY,2017.0,9,2,7
BRA,PRY,2016.0,6,1,5
EST,ITA,2021.0,4,1,3
ARG,USA,2000.0,47,38,9
DNK,AUS,2004.0,13,11,2
ITA,NLD,2001.0,38,49,-11
FRA,SEN,2010.0,18,19,-1
FRA,NLD,1999.0,28,17,11
GBR,ISR,2006.0,23,31,-8
FRA,COL,2005.0,2,7,-5
ESP,SWE,2020.0,66,65,1
CHE,GBR,1999.0,49,39,10
ARG,DEU,2003.0,22,12,10
GBR,FIN,2005.0,25,39,-14
MYS,JPN,2017.0,41,56,-15
ECU,CRI,2015.0,1,1,0
VNM,THA,2022.0,5,6,-1
AUS,FJI,2020.0,6,6,0
USA,NZL,1999.0,33,29,4
AUT,CHN,2013.0,16,11,5
USA,SRB,2008.0,15,12,3
IND,BEL,2012.0,21,7,14
PAK,QAT,2022.0,3,2,1
GBR,KOR,2017.0,58,52,6
ESP,ARE,2020.0,6,4,2
THA,DEU,2019.0,16,21,-5
IND,THA,2017.0,17,6,11
YEM,MYS,2018.0,5,18,-13
CIV,FRA,2005.0,11,14,-3
JPN,BGD,2004.0,22,15,7
NZL,DEU,2017.0,29,28,1
SWE,NZL,2018.0,5,13,-8
ARG,FRA,2014.0,31,22,9
SWE,CZE,2008.0,5,7,-2
TUR,NOR,2021.0,6,2,4
BHR,IRL,2021.0,7,2,5
UZB,RUS,2018.0,6,7,-1
ISR,GBR,2006.0,31,23,8
ITA,CAN,1999.0,12,13,-1
IND,ESP,2020.0,27,15,12
NLD,KOR,2003.0,2,6,-4
FRA,CHL,2008.0,13,25,-12
TUR,BEL,2015.0,10,4,6
RUS,SGP,2020.0,6,2,4
GBR,GHA,2021.0,17,14,3
GBR,SEN,2007.0,1,1,0
EGY,KOR,2019.0,6,8,-2
RUS,ARM,2000.0,1,4,-3
FIN,MAR,2022.0,1,6,-5
CHL,BRA,2019.0,15,47,-32
DEU,POL,2004.0,40,53,-13
TUR,FRA,2008.0,10,16,-6
GBR,TZA,2005.0,6,3,3
BRA,MEX,2008.0,6,10,-4
POL,SRB,2014.0,9,1,8
AUT,TUR,2014.0,11,3,8
KEN,ETH,2015.0,2,1,1
NLD,MEX,2006.0,3,3,0
CYP,GBR,2012.0,14,36,-22
NZL,CAN,2013.0,33,38,-5
ECU,CHL,2018.0,11,17,-6
SRB,HRV,2003.0,4,4,0
AUT,NLD,2003.0,16,20,-4
USA,UKR,2013.0,17,23,-6
GBR,MEX,2005.0,32,11,21
SWE,SGP,2007.0,9,3,6
USA,UGA,2008.0,21,16,5
NOR,RUS,2006.0,7,7,0
SWE,IRN,2007.0,7,9,-2
ZAF,UGA,2017.0,10,4,6
NLD,CAN,2003.0,49,22,27
FRA,GUF,2012.0,14,19,-5
GBR,AUT,2007.0,32,49,-17
JPN,NZL,2010.0,13,10,3
SWE,BRA,2003.0,9,9,0
SVK,POL,2004.0,2,2,0
SWE,NOR,2002.0,45,35,10
ZMB,GBR,2014.0,1,5,-4
URY,USA,2008.0,11,11,0
NLD,ITA,2010.0,48,79,-31
JPN,IDN,2000.0,7,1,6
NOR,DEU,2017.0,40,68,-28
ZAF,CAN,2001.0,19,4,15
HUN,CAN,2016.0,9,7,2
KEN,ZAF,2007.0,10,7,3
HUN,DEU,2000.0,18,13,5
IRL,AUS,2004.0,12,23,-11
ITA,ROU,2008.0,9,14,-5
ITA,AUS,2008.0,17,12,5
NZL,ARE,2009.0,6,3,3
CAN,DZA,2007.0,1,2,-1
USA,ZAF,1999.0,18,28,-10
CAN,ESP,2006.0,27,24,3
BGR,ESP,2002.0,4,1,3
ARE,GBR,2018.0,22,62,-40
GBR,MEX,2002.0,36,14,22
CHN,TUR,2012.0,2,3,-1
ROU,FRA,2003.0,23,13,10
FIN,BEL,2003.0,3,1,2
GBR,TZA,2002.0,6,4,2
FRA,ARG,2008.0,21,14,7
ZAF,CMR,2017.0,1,6,-5
POL,ARG,2014.0,4,1,3
PRT,AGO,2016.0,3,3,0
UKR,RUS,2001.0,43,34,9
FRA,BGR,2002.0,5,4,1
FRA,IND,2000.0,11,15,-4
FRA,HRV,2005.0,4,3,1
USA,BEL,1998.0,28,28,0
FRA,ESP,1999.0,61,44,17
KWT,ARE,2002.0,2,2,0
CIV,FRA,2002.0,18,10,8
NLD,DEU,2000.0,43,72,-29
FRA,SVN,2002.0,2,2,0
FIN,FRA,2003.0,9,7,2
BRN,AUS,2006.0,2,3,-1
CAN,LBN,2015.0,14,11,3
DNK,CAN,2003.0,22,13,9
TWN,BEL,2019.0,8,2,6
AUS,BEL,2008.0,12,7,5
AUS,THA,2003.0,17,6,11
JPN,DNK,2000.0,4,3,1
NLD,NOR,1999.0,6,4,2
JPN,ITA,2003.0,17,17,0
ISR,AUS,2007.0,12,7,5
GRL,DNK,2014.0,4,2,2
BRA,AUS,1998.0,1,2,-1
HUN,KOR,2019.0,2,1,1
EGY,BHR,2013.0,3,2,1
USA,CHL,1998.0,8,1,7
PNG,USA,2002.0,2,2,0
HUN,ESP,2000.0,2,1,1
REU,FRA,2009.0,10,8,2
ZAF,DEU,2003.0,13,25,-12
AUS,CHE,1998.0,5,8,-3
COL,AUT,2020.0,6,1,5
TWN,HKG,2004.0,4,3,1
HKG,TWN,2011.0,9,6,3
NOR,NPL,2019.0,1,1,0
ESP,CUB,2016.0,16,16,0
MEX,FRA,2017.0,41,51,-10
IND,TUR,2009.0,4,4,0
DEU,KEN,2012.0,9,8,1
TUR,GBR,2009.0,22,30,-8
IND,BGD,2001.0,7,5,2
CHL,CHE,2017.0,8,11,-3
CZE,ESP,2016.0,7,18,-11
AUS,IRN,2006.0,15,3,12
IDN,BEL,2010.0,1,4,-3
EST,FIN,2016.0,20,14,6
NLD,SRB,2015.0,6,1,5
EST,GBR,2005.0,1,4,-3
FRA,QAT,2019.0,10,1,9
CHE,TUR,2015.0,11,13,-2
NLD,NGA,2010.0,2,3,-1
DEU,HUN,2015.0,26,42,-16
HUN,FRA,2003.0,12,11,1
FRA,IRL,2012.0,26,37,-11
JOR,DEU,2007.0,7,7,0
AUT,THA,2017.0,7,9,-2
UGA,GBR,2022.0,7,8,-1
SGP,FRA,2006.0,7,7,0
USA,TTO,2002.0,5,6,-1
GRC,CAN,2016.0,14,4,10
ROU,HUN,2009.0,5,8,-3
ZAF,BEL,2013.0,6,9,-3
DEU,MDG,2011.0,1,1,0
FRA,ZAF,2014.0,25,17,8
CAN,COL,2012.0,10,17,-7
DZA,CAN,2008.0,5,1,4
MYS,JPN,2010.0,12,47,-35
TZA,GBR,2009.0,5,4,1
NZL,ZAF,2016.0,8,6,2
ITA,NZL,2018.0,6,4,2
IDN,NLD,2012.0,4,12,-8
MYS,TWN,2018.0,13,7,6
VNM,AUS,2011.0,6,4,2
SGP,DEU,2019.0,33,22,11
SVK,BEL,2020.0,1,4,-3
ESP,POL,2012.0,31,19,12
IDN,USA,2011.0,10,28,-18
DEU,HKG,2015.0,11,7,4
ROU,CAN,2013.0,4,4,0
IND,MAR,2020.0,4,1,3
NZL,ITA,2014.0,1,6,-5
JPN,FIN,2008.0,12,5,7
AUT,IND,2020.0,8,11,-3
SAU,AUS,2014.0,18,29,-11
POL,NLD,2016.0,18,18,0
ISR,VNM,2020.0,1,1,0
THA,FRA,2019.0,10,12,-2
DEU,EGY,2022.0,11,10,1
SVK,CZE,2022.0,12,26,-14
POL,TUR,2014.0,9,2,7
IRN,NZL,2015.0,9,3,6
ZAF,SAU,2011.0,3,3,0
DNK,THA,2014.0,4,3,1
IND,THA,2019.0,15,8,7
EST,DEU,2009.0,3,4,-1
POL,IRL,2018.0,5,5,0
JOR,ITA,2016.0,2,4,-2
CZE,CHN,2019.0,8,21,-13
AUT,SVK,2009.0,5,8,-3
ARM,CHN,2021.0,1,1,0
NLD,NGA,2019.0,6,5,1
CHL,BRA,2017.0,17,37,-20
LKA,AUS,2016.0,17,21,-4
USA,MOZ,2015.0,8,4,4
CHE,SGP,2022.0,7,12,-5
TWN,AUT,2020.0,3,2,1
CHE,GHA,2021.0,3,2,1
USA,LUX,2009.0,3,3,0
SRB,SWE,2017.0,1,5,-4
JPN,NZL,2019.0,9,9,0
LVA,FIN,2018.0,2,1,1
SVK,ITA,2021.0,3,6,-3
MYS,ITA,2015.0,6,1,5
CHN,GHA,2020.0,32,18,14
HUN,ISR,2020.0,3,1,2
IRN,BRA,2015.0,10,2,8
GRC,POL,2019.0,2,2,0
BRA,FIN,2022.0,6,4,2
THA,CAN,2020.0,7,11,-4
KOR,UZB,2017.0,1,1,0
DEU,NGA,2022.0,5,8,-3
CHE,IDN,2017.0,2,1,1
CHE,ZWE,2016.0,5,3,2
FRA,GLP,2005.0,11,9,2
IND,NLD,2008.0,17,14,3
NLD,CHL,2011.0,3,3,0
USA,KAZ,2007.0,3,2,1
DEU,JOR,2003.0,9,5,4
GBR,LTU,2012.0,7,9,-2
GBR,VEN,2015.0,2,8,-6
ISR,SGP,2015.0,4,5,-1
KOR,CAN,2002.0,20,14,6
ESP,NZL,2008.0,3,2,1
COL,ESP,2004.0,9,20,-11
IND,NOR,2010.0,9,2,7
ITA,LBN,2018.0,2,1,1
IRN,OMN,2018.0,4,1,3
GBR,SRB,2015.0,9,3,6
OMN,EGY,2013.0,4,1,3
ZAF,CMR,2019.0,6,4,2
PAK,ZAF,2017.0,4,2,2
NLD,RUS,2001.0,8,29,-21
ISR,DEU,2001.0,26,22,4
POL,SWE,1999.0,3,2,1
IND,NOR,2019.0,18,12,6
IND,NOR,2017.0,11,9,2
NLD,TWN,2017.0,7,1,6
BEL,GRC,2011.0,11,5,6
CZE,EGY,2013.0,3,2,1
HUN,NLD,2009.0,14,6,8
HRV,DEU,2011.0,7,8,-1
KEN,ESP,2019.0,3,2,1
ROU,AUT,2020.0,3,3,0
BHR,USA,2017.0,1,1,0
SWE,IDN,2022.0,1,1,0
NLD,CZE,2005.0,1,4,-3
AUT,THA,2019.0,4,4,0
TUR,AUS,2010.0,8,4,4
VNM,USA,2008.0,6,16,-10
CAN,YEM,2022.0,1,1,0
TUR,IRN,2022.0,7,25,-18
BHR,IND,2021.0,2,4,-2
QAT,PAK,2016.0,3,6,-3
TWN,DEU,2001.0,10,5,5
FIN,AUT,2021.0,5,9,-4
FRA,TGO,2007.0,4,2,2
NZL,JPN,2008.0,8,12,-4
YEM,EGY,2014.0,3,5,-2
RUS,PRT,2003.0,6,6,0
HKG,JPN,2003.0,9,10,-1
ISR,ITA,2013.0,6,15,-9
RUS,FIN,2007.0,13,4,9
USA,URY,2002.0,5,8,-3
VNM,GBR,2012.0,8,12,-4
BRA,PAK,2014.0,4,9,-5
NLD,LUX,2009.0,3,1,2
DEU,ROU,1998.0,4,3,1
TUR,KAZ,2011.0,2,1,1
MEX,RUS,2005.0,2,11,-9
SVN,SVK,2003.0,1,2,-1
JPN,ZAF,2007.0,5,1,4
NGA,KWT,2007.0,1,1,0
ISR,ESP,2008.0,7,2,5
FRA,EGY,2009.0,13,14,-1
SVK,CAN,2009.0,2,2,0
IND,EGY,2018.0,6,3,3
IRL,CHE,2018.0,11,17,-6
CRI,DEU,1999.0,1,1,0
EGY,IND,2005.0,4,2,2
SAU,IND,2001.0,5,5,0
USA,LTU,2009.0,5,5,0
DEU,SRB,2006.0,13,9,4
ETH,USA,2005.0,7,3,4
BRA,POL,2014.0,5,34,-29
CMR,NGA,2005.0,2,1,1
CZE,FIN,2008.0,1,2,-1
DEU,PHL,1998.0,2,1,1
ARG,NLD,2011.0,2,1,1
PER,FRA,2020.0,4,3,1
BRA,CHE,2008.0,10,7,3
CHN,IRN,2009.0,2,4,-2
IDN,CAN,2008.0,1,1,0
USA,TZA,2014.0,10,10,0
JPN,SAU,2006.0,4,3,1
MAR,BEL,2016.0,2,4,-2
RUS,LTU,2004.0,3,1,2
KAZ,ARE,2019.0,2,2,0
OMN,CAN,2016.0,5,8,-3
CHL,PER,2008.0,3,2,1
SEN,BFA,2013.0,4,2,2
AUT,SVN,2015.0,3,6,-3
GEO,USA,2015.0,10,13,-3
SGP,NLD,2005.0,5,2,3
SYR,DEU,2005.0,2,3,-1
COL,PER,2005.0,1,1,0
SAU,LBN,2015.0,5,4,1
TUR,BRA,2014.0,2,1,1
FRA,IDN,2022.0,1,4,-3
SRB,SWE,2019.0,4,1,3
VNM,KOR,2022.0,31,37,-6
BEL,DNK,2014.0,15,9,6
IND,BRN,2012.0,2,2,0
PAK,TUR,2016.0,8,8,0
TUN,ESP,2015.0,1,4,-3
SAU,ITA,2014.0,5,13,-8
AUS,NLD,2001.0,20,19,1
UZB,FRA,2019.0,2,1,1
KOR,BEL,2013.0,9,1,8
DEU,SYR,2019.0,4,4,0
MLT,ITA,2017.0,3,11,-8
GBR,VNM,2009.0,2,7,-5
CHL,CHE,2010.0,8,6,2
SAU,ZAF,2020.0,1,8,-7
ARE,EGY,2015.0,5,6,-1
PAK,SWE,2018.0,9,7,2
BRA,IRL,2022.0,9,3,6
BGD,DEU,2015.0,8,8,0
MOZ,USA,2008.0,2,1,1
KWT,USA,2008.0,6,8,-2
ITA,JPN,2015.0,17,20,-3
ARG,IND,2009.0,2,1,1
USA,BWA,2009.0,12,4,8
BEL,HRV,2012.0,3,1,2
GRC,POL,2017.0,4,1,3
MYS,BRA,2016.0,1,1,0
CYP,PAK,2018.0,1,1,0
DNK,CHE,1999.0,3,5,-2
AUS,VNM,2009.0,4,3,1
COL,AUS,2002.0,1,4,-3
AUT,DNK,2006.0,3,3,0
JPN,NZL,2017.0,2,6,-4
IND,PAK,2009.0,12,10,2
CHL,MYS,2016.0,1,1,0
CAN,PAN,2010.0,3,3,0
LTU,GBR,2013.0,3,7,-4
TWN,TUR,2019.0,3,3,0
BEL,PSE,2015.0,3,2,1
BHS,USA,2012.0,1,1,0
FRA,QAT,2017.0,8,1,7
NOR,NPL,2010.0,3,1,2
BEL,TUN,2017.0,2,5,-3
BEL,KEN,2020.0,4,4,0
BEL,SGP,2016.0,6,5,1
NLD,TWN,2010.0,2,6,-4
HUN,DNK,2002.0,5,4,1
VNM,DEU,2022.0,4,7,-3
SDN,ZAF,2020.0,2,6,-4
NPL,DNK,2016.0,1,1,0
USA,BFA,2019.0,1,1,0
UGA,KOR,2021.0,2,1,1
GHA,ZAF,2021.0,8,20,-12
MLT,GBR,2006.0,5,8,-3
DEU,VNM,2022.0,7,4,3
BRN,GBR,2019.0,4,4,0
FIN,IRN,2021.0,3,39,-36
TUR,NGA,2015.0,2,2,0
COG,COD,2006.0,3,4,-1
CHE,ISR,2004.0,4,10,-6
CAN,KWT,2012.0,6,6,0
CYP,GRC,1998.0,3,1,2
NLD,CZE,2002.0,3,3,0
IRN,TUR,2006.0,1,1,0
ARE,JOR,2008.0,4,5,-1
MYS,NLD,2003.0,1,3,-2
CHL,CHE,2019.0,7,6,1
BHR,EGY,2020.0,5,1,4
MEX,GBR,1999.0,3,18,-15
JAM,CAN,2019.0,3,3,0
CAN,CHE,1998.0,12,14,-2
IRL,ZAF,2009.0,1,3,-2
QAT,USA,2003.0,2,7,-5
SWE,EGY,2015.0,3,3,0
ISL,NLD,2006.0,2,2,0
DNK,CHN,1999.0,2,6,-4
KEN,IND,2015.0,3,3,0
HRV,AUS,2019.0,3,3,0
KOR,SGP,2010.0,20,14,6
CHE,SVK,2001.0,2,6,-4
NLD,SVN,2007.0,3,1,2
BRA,ECU,2009.0,3,6,-3
TUR,SGP,2011.0,2,1,1
NZL,IND,2010.0,4,5,-1
ZAF,UGA,2010.0,4,5,-1
LAO,CHE,2013.0,1,2,-1
BEL,MAR,2009.0,4,2,2
IDN,IND,2019.0,3,8,-5
ITA,CZE,2014.0,14,9,5
BGR,DEU,2019.0,3,7,-4
CHL,BEL,2010.0,2,6,-4
CHL,BEL,2017.0,6,17,-11
ROU,BRA,2020.0,1,2,-1
CHN,BRA,2005.0,2,2,0
SEN,CMR,2018.0,2,1,1
EST,AUT,2016.0,1,2,-1
MEX,PRT,2009.0,6,1,5
IRL,SWE,2021.0,11,4,7
CZE,LTU,2016.0,1,2,-1
NLD,EGY,2016.0,3,2,1
CHE,PNG,2014.0,2,2,0
IRN,TUN,2015.0,1,1,0
CYP,SGP,2020.0,1,1,0
DEU,SYR,2017.0,2,4,-2
TWN,NLD,2017.0,1,7,-6
MAR,DZA,2021.0,1,4,-3
KOR,FIN,2010.0,4,2,2
PRY,USA,2019.0,2,1,1
POL,ARE,2020.0,2,3,-1
MEX,CRI,2014.0,1,1,0
PAK,FRA,2013.0,8,33,-25
ZAF,BWA,2021.0,3,6,-3
ITA,TWN,2021.0,3,2,1
USA,ISL,1998.0,3,2,1
PRT,BGR,2021.0,1,1,0
ITA,VEN,2004.0,2,1,1
BEL,ISR,2004.0,8,1,7
SGP,MEX,2004.0,1,1,0
BRA,JPN,1997.0,2,2,0
CAN,POL,2000.0,7,7,0
GRC,AUS,2011.0,3,3,0
GBR,PRI,2000.0,1,1,0
TWN,TUR,2017.0,1,1,0
SAU,SDN,2006.0,4,3,1
NAM,ZAF,2012.0,3,7,-4
AUT,JPN,2014.0,6,11,-5
LVA,USA,2014.0,5,2,3
CAN,CRI,2017.0,6,1,5
LBN,CAN,2016.0,9,10,-1
DNK,LVA,2017.0,1,1,0
CHL,COL,2003.0,2,3,-1
EGY,IRN,2013.0,2,1,1
CZE,BGR,2015.0,1,1,0
DZA,USA,2017.0,1,2,-1
CHL,VEN,2008.0,2,4,-2
GIN,SEN,2008.0,1,1,0
ITA,SMR,2015.0,3,1,2
GTM,MEX,2013.0,2,4,-2
GRC,NOR,2009.0,4,1,3
HND,USA,2009.0,2,3,-1
MLT,ITA,2010.0,1,2,-1
AUT,THA,2010.0,3,4,-1
POL,SVK,2013.0,6,4,2
RUS,IRN,2005.0,1,1,0
MDG,FRA,2010.0,13,6,7
FRA,PYF,2009.0,9,2,7
DNK,FIN,2009.0,4,10,-6
CZE,AUT,2012.0,8,5,3
AUT,CHL,2015.0,3,1,2
PRT,EGY,2006.0,1,1,0
GBR,FLK,2018.0,1,2,-1
NZL,MEX,2016.0,2,3,-1
ZAF,PAK,2014.0,1,5,-4
VEN,CUB,2013.0,3,1,2
USA,MAR,2020.0,4,7,-3
SWE,HKG,2016.0,1,9,-8
TUR,DZA,2016.0,1,2,-1
ECU,DEU,2020.0,5,8,-3
CAN,ARE,2022.0,6,12,-6
BEL,MEX,2001.0,3,4,-1
USA,GAB,2015.0,2,2,0
FRA,NCL,1999.0,2,1,1
IRL,PAK,2020.0,9,12,-3
CHL,POL,2012.0,1,2,-1
HND,CAN,2019.0,1,1,0
CUB,ARG,2020.0,6,2,4
CZE,CHN,2017.0,5,9,-4
EGY,SDN,2020.0,2,2,0
JPN,ARG,2001.0,2,1,1
LBN,USA,1999.0,1,16,-15
FRA,BGR,2005.0,3,6,-3
ARG,PAN,2007.0,1,1,0
CAN,SVN,1999.0,1,1,0
IRL,CYP,2018.0,1,1,0
NOR,BEL,2012.0,1,6,-5
CAN,THA,2022.0,4,5,-1
FRA,HKG,2013.0,4,3,1
BHR,USA,2010.0,3,3,0
CMR,AUS,2011.0,1,1,0
NZL,RUS,2019.0,3,1,2
TUR,BGR,2016.0,1,1,0
NZL,IND,2017.0,7,21,-14
KEN,ESP,2017.0,1,1,0
BGD,BTN,2019.0,2,1,1
LVA,UKR,2019.0,2,1,1
JAM,CAN,2010.0,3,1,2
SVN,IND,2009.0,1,1,0
LTU,FIN,2022.0,1,1,0
LBN,DEU,2016.0,3,7,-4
AUS,MAC,2020.0,1,1,0
PAK,ZAF,2010.0,3,3,0
HRV,AUS,2017.0,1,3,-2
ARE,DEU,2014.0,2,6,-4
UGA,NLD,2021.0,2,5,-3
RUS,LVA,2016.0,2,2,0
HUN,RUS,2003.0,1,1,0
NPL,PAK,2021.0,1,1,0
DEU,CUB,2006.0,2,4,-2
GMB,USA,2014.0,3,1,2
USA,URY,2005.0,6,8,-2
SWE,THA,2006.0,3,5,-2
BEN,GBR,2011.0,1,1,0
IRL,NZL,2007.0,3,5,-2
IDN,BEL,2019.0,1,8,-7
ISL,DNK,2002.0,3,2,1
CMR,FRA,2000.0,4,4,0
FRA,NER,2007.0,6,1,5
BGR,ESP,2005.0,1,2,-1
AUT,KOR,2007.0,1,3,-2
EGY,FRA,2006.0,4,6,-2
SAU,COL,2017.0,2,1,1
AUT,ROU,2012.0,1,4,-3
SWE,TUR,2014.0,4,7,-3
BGR,FRA,2016.0,6,5,1
CRI,MEX,2015.0,2,2,0
PAK,ZAF,2019.0,3,4,-1
VUT,FRA,2019.0,1,1,0
TWN,KOR,2001.0,3,4,-1
USA,BLR,2022.0,1,1,0
ISL,PRT,2019.0,3,1,2
SRB,GRC,2020.0,2,1,1
NLD,BGR,2011.0,1,2,-1
PSE,USA,2020.0,4,5,-1
SGP,SWE,2011.0,4,6,-2
TWN,NZL,2003.0,1,2,-1
PRT,CAN,2011.0,3,7,-4
BRN,MYS,2017.0,2,10,-8
FRA,VEN,2014.0,1,4,-3
AUS,TUR,2013.0,4,3,1
NZL,HUN,2021.0,1,1,0
DNK,ISL,2003.0,1,3,-2
ISL,DNK,2005.0,3,5,-2
BRA,JPN,1998.0,2,2,0
KGZ,RUS,2018.0,3,4,-1
GRC,BGR,2007.0,3,2,1
DEU,BGD,2007.0,1,2,-1
CAN,SGP,1998.0,3,1,2
ARG,ISR,2013.0,1,1,0
IND,FJI,2011.0,2,1,1
GRC,IRL,2012.0,1,3,-2
CAN,TTO,2021.0,1,2,-1
AUT,ETH,2020.0,2,2,0
MYS,DNK,2008.0,1,1,0
TZA,KEN,2004.0,1,2,-1
CMR,NLD,2013.0,2,1,1
MKD,USA,2008.0,1,1,0
BEN,CAN,2018.0,2,2,0
AUT,EGY,2001.0,1,3,-2
ETH,SWE,2014.0,1,4,-3
GTM,VEN,2015.0,1,1,0
FRA,UKR,2004.0,5,6,-1
SAU,HKG,2012.0,1,4,-3
BEL,BFA,2017.0,1,4,-3
TWN,MAC,2019.0,3,2,1
CHN,USA,2023.0,2,2,0
PRT,DZA,2019.0,2,1,1
RUS,MKD,2020.0,1,1,0
SEN,GHA,2020.0,2,1,1
GBR,PRY,2021.0,1,1,0
FIN,LUX,2015.0,2,1,1
BFA,CAN,2014.0,2,2,0
PRI,IND,2010.0,2,1,1
BGR,ITA,1997.0,1,1,0
ITA,UKR,2022.0,2,3,-1
BRA,NLD,2004.0,4,7,-3
EGY,KOR,2010.0,1,6,-5
USA,CYP,1999.0,2,1,1
KEN,FRA,2009.0,1,2,-1
SWE,HUN,2006.0,1,8,-7
MEX,DNK,1999.0,1,3,-2
BGR,AUT,2012.0,3,1,2
ZAF,ITA,2001.0,2,3,-1
SGP,JPN,1997.0,2,1,1
NOR,NZL,2003.0,2,3,-1
ZAF,MEX,2014.0,2,2,0
CAN,CIV,2013.0,1,1,0
ARE,OMN,2012.0,1,1,0
DZA,ITA,2012.0,1,2,-1
CHE,TUN,2020.0,1,1,0
RWA,SWE,2020.0,1,1,0
USA,NCL,2020.0,1,2,-1
NOR,EST,2021.0,1,2,-1
BWA,DEU,2016.0,1,1,0
CAN,UZB,2002.0,1,2,-1
ESP,ROU,1999.0,1,1,0
TWN,BEL,2010.0,1,3,-2
QAT,HKG,2018.0,2,1,1
NLD,TWN,2019.0,1,3,-2
POL,BGR,2003.0,3,2,1
TWN,FRA,1999.0,1,1,0
FIN,SVN,2002.0,1,2,-1
USA,AFG,2013.0,1,4,-3
CHE,IDN,2010.0,1,2,-1
CHE,MLI,2019.0,2,1,1
ISR,MEX,2012.0,1,2,-1
USA,BFA,2017.0,3,4,-1
IDN,BEL,2017.0,1,4,-3
ARE,BGD,2019.0,2,1,1
GAB,USA,2020.0,2,3,-1
THA,KOR,2012.0,3,3,0
KOR,UZB,2010.0,1,3,-2
BGR,CAN,2012.0,3,1,2
VNM,CHN,2010.0,1,3,-2
AUT,RUS,2011.0,3,11,-8
BGR,SAU,2017.0,1,1,0
LVA,NLD,2018.0,2,1,1
EGY,AUS,2000.0,1,1,0
ARG,NOR,2011.0,1,1,0
ARG,JPN,2006.0,1,2,-1
ISL,BEL,2020.0,1,1,0
KEN,CAN,2009.0,2,1,1
RUS,NZL,2012.0,2,1,1
UZB,KAZ,2015.0,2,3,-1
GRC,CHN,2022.0,1,3,-2
KOR,GRC,2018.0,1,1,0
CHE,VNM,2003.0,1,1,0
DNK,ISR,2011.0,2,3,-1
URY,SWE,2012.0,1,1,0
AFG,USA,2011.0,1,5,-4
SGP,IRL,2009.0,2,2,0
SVN,ESP,2015.0,2,3,-1
EST,SWE,2013.0,2,4,-2
MEX,SVN,2012.0,1,1,0
CHN,QAT,2021.0,1,4,-3
CZE,BIH,2014.0,1,1,0
GBR,KHM,2021.0,2,3,-1
CZE,KAZ,2020.0,1,3,-2
GBR,MOZ,2020.0,1,1,0
AZE,DEU,2015.0,1,1,0
DEU,SYR,2010.0,1,2,-1
COL,PER,2002.0,1,2,-1
EGY,CHE,2003.0,1,1,0
NLD,BGD,2013.0,2,2,0
EGY,BEL,2011.0,1,1,0
ARM,SWE,2022.0,1,1,0
ITA,CMR,2015.0,3,5,-2
KOR,IRN,2008.0,1,1,0
JPN,SVK,2000.0,1,4,-3
KEN,SDN,2017.0,2,1,1
JOR,EGY,2009.0,1,2,-1
BHR,MYS,2014.0,1,3,-2
GBR,NAM,2009.0,1,1,0
NZL,RUS,2010.0,1,4,-3
GBR,CRI,2021.0,1,2,-1
RUS,PAK,2021.0,1,1,0
KOR,NPL,2014.0,2,9,-7
TTO,IND,2016.0,2,5,-3
MYS,BGD,2007.0,1,2,-1
HRV,FRA,2011.0,1,4,-3
USA,WSM,2021.0,1,1,0
USA,ROU,1998.0,1,6,-5
AUS,PER,2012.0,1,2,-1
GHA,IRL,2020.0,1,1,0
MKD,SVN,2014.0,1,1,0
IRN,FIN,2006.0,1,1,0
USA,BFA,2010.0,1,1,0
FRA,HRV,2002.0,1,3,-2
TUR,MYS,2002.0,1,1,0
ZAF,NGA,2004.0,1,8,-7
SRB,AUT,2004.0,1,1,0
POL,ISR,1997.0,1,2,-1
NLD,SGP,1999.0,1,1,0
VNM,TWN,2000.0,1,1,0
PRT,COL,2009.0,2,1,1
CAN,PER,2009.0,1,3,-2
COL,AUS,2005.0,2,1,1
DZA,USA,2010.0,1,1,0
MKD,NLD,2014.0,1,2,-1
HUN,IND,2014.0,1,3,-2
ZWE,CAN,2017.0,1,1,0
AUS,KEN,2021.0,1,3,-2
EST,BEL,2004.0,1,1,0
BRA,QAT,2021.0,1,2,-1
PHL,MYS,2018.0,1,2,-1
HUN,BIH,2019.0,1,2,-1
POL,KOR,2007.0,1,1,0
DEU,ROU,1997.0,1,5,-4
KEN,COL,2015.0,1,1,0
THA,TWN,2002.0,1,1,0
URY,BRA,2012.0,1,6,-5
VNM,NZL,2021.0,1,4,-3
KEN,ZMB,2022.0,1,1,0
SRB,TWN,2016.0,1,2,-1
ITA,SVK,2002.0,1,8,-7
ROU,TUR,2007.0,1,4,-3
DEU,ARE,2006.0,1,1,0
USA,ROU,1997.0,1,2,-1
LVA,LTU,2008.0,1,3,-2
KOR,FIN,2019.0,1,4,-3
KEN,ITA,2012.0,1,3,-2
CHL,ZAF,2022.0,1,1,0
KOR,CHN,1998.0,1,3,-2
GHA,DNK,2020.0,1,2,-1
ARG,BOL,2020.0,1,1,0
TWN,BEL,2017.0,1,3,-2
AFG,IND,2021.0,2,2,0
KOR,BGD,2006.0,1,6,-5
THA,DEU,2010.0,16,17,-1
USA,NLD,2009.0,249,303,-54
THA,JPN,2009.0,27,71,-44
BEL,USA,2007.0,124,97,27
NOR,DNK,2018.0,35,56,-21
IND,SAU,2018.0,175,54,121
CAN,NZL,2006.0,32,21,11
ESP,DEU,2016.0,259,163,96
USA,ISR,2001.0,177,246,-69
BRA,ITA,2009.0,29,26,3
SWE,CHN,2015.0,64,92,-28
THA,FRA,2010.0,8,18,-10
GBR,CHL,2018.0,40,47,-7
GRC,CHE,2018.0,30,13,17
FIN,DNK,2006.0,11,12,-1
UGA,USA,2013.0,18,16,2
COL,CHL,2008.0,6,2,4
FRA,BEL,2020.0,211,198,13
CHN,NGA,2009.0,3,1,2
GBR,SGP,2009.0,70,50,20
CHE,POL,2022.0,8,6,2
UKR,JPN,2000.0,8,2,6
ITA,IND,2018.0,34,45,-11
GBR,FIN,2002.0,44,44,0
CHE,AUT,2014.0,38,63,-25
NLD,AUS,2020.0,77,59,18
KOR,SGP,2019.0,30,33,-3
FRA,TUR,2015.0,17,12,5
GBR,KEN,2018.0,27,21,6
FRA,LBN,2008.0,24,17,7
MYS,JPN,2019.0,52,36,16
ITA,SWE,2022.0,33,32,1
FRA,CZE,2020.0,34,24,10
CHN,BGD,2020.0,28,21,7
LUX,ITA,2020.0,4,16,-12
GAB,FRA,2020.0,4,6,-2
CHL,BRA,2010.0,8,16,-8
FRA,GLP,2002.0,6,12,-6
GBR,CHE,2007.0,142,165,-23
NOR,NPL,2017.0,4,5,-1
COL,BRA,2012.0,28,25,3
FRA,PRT,2014.0,22,45,-23
DNK,NLD,2011.0,12,21,-9
FRA,LUX,2006.0,14,4,10
CHE,ITA,2010.0,91,178,-87
CHL,CAN,2012.0,13,19,-6
CHE,NOR,2016.0,31,8,23
GBR,MYS,2004.0,33,20,13
GBR,CYP,2012.0,36,14,22
JPN,ISR,2007.0,2,4,-2
RUS,VNM,2014.0,9,1,8
BEL,SWE,1999.0,6,7,-1
IDN,DEU,1999.0,3,1,2
POL,ESP,2021.0,10,18,-8
NLD,ESP,2022.0,29,46,-17
HKG,IND,2016.0,8,17,-9
NZL,DEU,2010.0,24,25,-1
COL,ITA,2022.0,5,1,4
MWI,GBR,2011.0,10,11,-1
BRA,CHL,2006.0,8,3,5
MDG,FRA,2017.0,7,8,-1
FIN,ESP,2007.0,7,5,2
PHL,THA,2012.0,3,2,1
JOR,MYS,2009.0,6,9,-3
COG,ZWE,2005.0,1,1,0
ITA,BRA,2006.0,12,25,-13
NZL,DEU,2019.0,28,33,-5
MEX,RUS,2002.0,14,11,3
JOR,USA,2011.0,23,46,-23
MLT,ITA,2019.0,6,9,-3
GRC,USA,2000.0,20,20,0
GBR,GRC,2000.0,37,10,27
IND,UKR,2005.0,1,1,0
SYR,FRA,2008.0,2,4,-2
USA,HKG,2002.0,91,115,-24
NLD,FIN,2003.0,10,9,1
NLD,CHN,2003.0,5,20,-15
SRB,FRA,2003.0,3,2,1
USA,BEL,1997.0,17,13,4
MAR,USA,2006.0,3,7,-4
ESP,VEN,2013.0,17,29,-12
GBR,GMB,2001.0,6,4,2
FRA,SVN,2005.0,3,3,0
LKA,SGP,2005.0,2,1,1
CUB,BRA,2014.0,16,4,12
ECU,AUS,2017.0,2,5,-3
LTU,DEU,2016.0,5,4,1
BGD,GBR,2007.0,8,11,-3
SVK,DNK,2007.0,2,1,1
CAN,ZAF,2003.0,10,16,-6
NOR,ITA,2006.0,8,11,-3
IRN,DEU,2008.0,17,18,-1
CHE,TWN,2013.0,4,5,-1
AUS,DNK,2004.0,11,13,-2
RUS,SAU,2013.0,3,1,2
MAR,CAN,2016.0,9,8,1
NOR,POL,2020.0,8,8,0
PRT,BEL,2020.0,20,11,9
PER,PRT,2020.0,2,1,1
USA,LKA,2008.0,5,5,0
CAN,CHE,1997.0,8,9,-1
OMN,IND,2009.0,3,11,-8
ROU,PRT,2020.0,2,4,-2
MEX,MAR,2020.0,1,2,-1
IRL,IRN,2017.0,3,3,0
SEN,CAF,2007.0,1,1,0
COL,JPN,2011.0,2,3,-1
BEL,QAT,2018.0,2,1,1
MEX,URY,2014.0,3,1,2
MEX,NOR,2014.0,4,2,2
PRT,KOR,2016.0,2,4,-2
ESP,EGY,2012.0,7,6,1
IND,THA,2010.0,7,4,3
ZAF,CMR,2010.0,1,3,-2
ZWE,COG,2015.0,2,1,1
CHN,POL,2008.0,1,4,-3
USA,CHL,1997.0,9,10,-1
POL,MEX,2000.0,3,1,2
BGR,DEU,2010.0,15,11,4
LTU,DNK,2003.0,3,1,2
ISR,KOR,2014.0,1,1,0
RUS,AZE,2011.0,5,5,0
AUS,FIN,2006.0,9,7,2
DEU,OMN,2018.0,3,2,1
DEU,BLR,2006.0,7,10,-3
UKR,AUT,2007.0,5,1,4
TUR,KOR,2009.0,2,1,1
AUS,CHE,1997.0,2,1,1
PRI,IND,2017.0,3,1,2
BRN,SAU,2017.0,1,2,-1
CHN,PHL,2009.0,1,3,-2
SVK,FRA,2016.0,5,4,1
IND,DNK,2000.0,3,1,2
NOR,SRB,2011.0,3,1,2
HKG,FRA,2015.0,7,7,0
FRA,UGA,2007.0,3,2,1
BRA,NGA,2009.0,1,2,-1
EST,GBR,2002.0,2,1,1
JPN,CZE,2000.0,1,1,0
CAN,PAN,2019.0,1,1,0
AUS,ITA,1999.0,2,5,-3
THA,NPL,2012.0,1,3,-2
VNM,KAZ,2021.0,1,1,0
SWE,ETH,2020.0,3,6,-3
BRN,GBR,2010.0,1,2,-1
BRA,BOL,2013.0,1,1,0
UKR,BEL,2022.0,1,1,0
LTU,LVA,2022.0,1,2,-1
FIN,POL,2007.0,2,1,1
JOR,CAN,2003.0,4,3,1
ITA,MAR,2005.0,5,1,4
FRA,AND,2004.0,1,1,0
CZE,UKR,2012.0,2,3,-1
CZE,RUS,2022.0,5,8,-3
SAU,OMN,2008.0,1,1,0
KOR,TUR,2011.0,2,3,-1
ISR,TWN,2012.0,1,2,-1
PRT,ARG,2020.0,1,3,-2
NGA,SWE,2012.0,1,2,-1
PRY,USA,2017.0,2,2,0
TUN,PRT,2021.0,1,2,-1
IRN,DZA,2010.0,1,1,0
SGP,NLD,2002.0,1,2,-1
MOZ,GBR,2008.0,1,2,-1
ROU,CHE,2021.0,3,3,0
BGR,POL,1998.0,1,2,-1
IRN,GRC,2014.0,1,1,0
SAU,RUS,2015.0,1,3,-2
SGP,JPN,1998.0,1,6,-5
FRA,COL,2002.0,1,6,-5
CHL,RUS,2016.0,1,2,-1
CYP,USA,1999.0,1,2,-1
PSE,AUS,2016.0,1,1,0
KAZ,CAN,2017.0,1,4,-3
KWT,SWE,2008.0,1,1,0
,CHN,2004.0,72312,0,72312
,CHN,1996.0,9630,0,9630
CHN,,2023.0,430090,0,430090
RUS,,2021.0,19028,0,19028
GBR,,2021.0,29330,0,29330
IND,,2023.0,84784,0,84784
,THA,1995.0,306,0,306
,ARG,2001.0,2132,0,2132
,UKR,2000.0,1555,0,1555
TUN,,2019.0,1226,0,1226
KOR,,2004.0,1976,0,1976
CHE,,2010.0,2208,0,2208
SWE,,2023.0,15605,0,15605
ESP,,2015.0,7759,0,7759
,ZAF,2008.0,1822,0,1822
ZAF,,2022.0,4384,0,4384
CHE,,2019.0,4663,0,4663
PAK,ZMB,2022.0,1,0,1
HUN,,2009.0,660,0,660
,SRB,1999.0,689,0,689
,TUR,1994.0,1614,0,1614
,DNK,2007.0,2132,0,2132
,SAU,1998.0,767,0,767
,BLR,1997.0,213,0,213
GHA,,2006.0,21,0,21
PRT,,2003.0,148,0,148
CHE,,2017.0,3628,0,3628
,GRC,2011.0,2266,0,2266
,NPL,1999.0,111,0,111
POL,,2021.0,7265,0,7265
BGD,,2024.0,6195,0,6195
CAN,,2004.0,2486,0,2486
SVK,,2015.0,543,0,543
PAK,,2022.0,5408,0,5408
CRI,,2020.0,101,0,101
AUT,,2011.0,1219,0,1219
,JOR,2000.0,233,0,233
SAU,,2009.0,208,0,208
,BRA,2016.0,21217,0,21217
,POL,2015.0,5370,0,5370
,GBR,2018.0,17774,0,17774
,EGY,2010.0,3432,0,3432
PER,,2009.0,61,0,61
,AZE,1995.0,84,0,84
,AUT,2006.0,2350,0,2350
TUN,,2017.0,768,0,768
PNG,,2020.0,30,0,30
MEX,GRC,2013.0,2,0,2
JOR,ARE,2009.0,9,0,9
KHM,,2016.0,26,0,26
,CUB,2000.0,624,0,624
,MYS,2012.0,5229,0,5229
,VEN,1994.0,317,0,317
,ZWE,2000.0,87,0,87
TUR,,2004.0,419,0,419
MAR,,2012.0,250,0,250
LKA,,2015.0,78,0,78
TUN,,2010.0,291,0,291
JAM,,2021.0,79,0,79
,SYR,1999.0,61,0,61
CHL,,2013.0,679,0,679
,EGY,2017.0,4230,0,4230
,LUX,2002.0,39,0,39
,MMR,2007.0,28,0,28
,CHE,2013.0,4422,0,4422
,BIH,2017.0,210,0,210
,UZB,2011.0,126,0,126
,NAM,2011.0,43,0,43
ALB,,2016.0,82,0,82
,UGA,2013.0,329,0,329
,BIH,2010.0,209,0,209
,LTU,2013.0,542,0,542
ISL,,2015.0,84,0,84
PHL,,2018.0,270,0,270
,PRT,2014.0,3061,0,3061
,CIV,2012.0,134,0,134
BGR,COG,2016.0,1,0,1
TTO,ITA,2016.0,1,0,1
SDN,,2020.0,91,0,91
,HUN,2016.0,1562,0,1562
,EGY,2019.0,2577,0,2577
IDN,FIN,2020.0,2,0,2
REU,,2021.0,5,0,5
,BEN,2015.0,118,0,118
IRL,LBY,2018.0,1,0,1
,COG,2016.0,86,0,86
CAF,,2022.0,14,0,14
SLE,,2010.0,2,0,2
DEU,COG,2018.0,2,0,2
LAO,,2019.0,28,0,28
NIC,,2020.0,21,0,21
BRA,GHA,2018.0,1,0,1
MYS,AUT,2018.0,2,0,2
SEN,ETH,2019.0,1,0,1
,CYP,2009.0,120,0,120
,SWZ,2016.0,15,0,15
LBR,,2021.0,15,0,15
,SAU,1997.0,232,0,232
JPN,FRO,2018.0,1,0,1
ITA,ALB,2014.0,3,0,3
SWE,LKA,2007.0,2,0,2
,BLR,1998.0,422,0,422
NPL,BRN,2016.0,1,0,1
JPN,ARE,2016.0,5,0,5
,MNP,2006.0,1,0,1
ZAF,QAT,2014.0,2,0,2
LUX,,2014.0,41,0,41
ESP,TWN,1999.0,1,0,1
AUT,MEX,2006.0,1,0,1
NOR,ARE,1999.0,1,0,1
,FJI,2000.0,28,0,28
LBN,,2013.0,85,0,85
ZWE,CAN,2019.0,3,0,3
,AGO,2014.0,19,0,19
IDN,IRL,2022.0,1,0,1
MWI,,2018.0,46,0,46
CZE,GHA,2021.0,2,0,2
,MLT,2008.0,58,0,58
BLR,FRA,1999.0,2,0,2
PAN,CHL,2021.0,1,0,1
NER,,2009.0,8,0,8
JOR,,2001.0,3,0,3
EST,,2001.0,10,0,10
,MNG,1995.0,3,0,3
UZB,,2000.0,16,0,16
,HTI,2004.0,10,0,10
BRN,THA,2007.0,2,0,2
KEN,,2001.0,2,0,2
AND,USA,2011.0,1,0,1
MLI,USA,2013.0,5,0,5
,KWT,1994.0,173,0,173
PRI,,2006.0,30,0,30
MDA,ESP,2016.0,2,0,2
SVN,FRA,1998.0,1,0,1
,MDA,2018.0,44,0,44
,GMB,1994.0,18,0,18
NPL,PHL,2002.0,1,0,1
NGA,FRA,2001.0,1,0,1
BGR,,1999.0,6,0,6
JPN,SVN,2008.0,1,0,1
SVN,,2001.0,8,0,8
ARE,YEM,2013.0,1,0,1
MWI,ITA,2016.0,1,0,1
IRL,TUR,2007.0,1,0,1
QAT,,2011.0,32,0,32
TUR,KWT,2012.0,1,0,1
AUS,ARE,2000.0,2,0,2
KWT,VEN,1998.0,1,0,1
,SDN,1994.0,15,0,15
ESP,PER,1998.0,2,0,2
CUB,DEU,1999.0,5,0,5
DEU,MWI,2007.0,3,0,3
,LUX,2005.0,64,0,64
HUN,KOR,2017.0,2,0,2
BRA,HRV,2003.0,2,0,2
CAN,EST,2006.0,1,0,1
TUN,IND,2016.0,1,0,1
ESP,QAT,2014.0,9,0,9
MTQ,,2007.0,3,0,3
PHL,NOR,2007.0,1,0,1
BGR,NLD,2009.0,1,0,1
ZMB,RWA,2017.0,1,0,1
TUR,ARE,2009.0,3,0,3
PAK,CHN,2004.0,2,0,2
TUR,IRL,2009.0,1,0,1
CHN,NPL,2012.0,2,0,2
GHA,BRA,2008.0,1,0,1
,MAC,2007.0,51,0,51
,GUF,2008.0,5,0,5
FRA,MNE,2021.0,1,0,1
SGP,GIB,2021.0,1,0,1
SWE,AZE,2016.0,3,0,3
TUN,QAT,2015.0,5,0,5
ESP,KNA,2021.0,1,0,1
NGA,MLI,2015.0,1,0,1
KWT,QAT,2021.0,1,0,1
UKR,IRQ,2017.0,2,0,2
MRT,,2021.0,21,0,21
CHE,SEN,2015.0,4,0,4
PRK,CHN,2013.0,4,0,4
FRA,KWT,2014.0,2,0,2
HND,IRL,2016.0,1,0,1
BEN,NER,2021.0,1,0,1
IND,RWA,2019.0,4,0,4
SLE,,2019.0,24,0,24
THA,IDN,2007.0,1,0,1
OMN,,2006.0,27,0,27
MLI,,2004.0,4,0,4
LVA,ARM,2004.0,1,0,1
BEL,GUF,2018.0,1,0,1
IND,RWA,2017.0,2,0,2
FRO,,2012.0,4,0,4
UZB,TJK,2013.0,3,0,3
EST,POL,2015.0,2,0,2
,TCD,2009.0,4,0,4
ESP,KWT,2021.0,1,0,1
MDV,ESP,2016.0,1,0,1
FIN,PAK,2011.0,1,0,1
BIH,QAT,2020.0,1,0,1
VNM,PHL,2021.0,1,0,1
SYR,MAR,2016.0,3,0,3
BRA,ETH,2018.0,1,0,1
BHS,,2008.0,1,0,1
BIH,,2004.0,14,0,14
UZB,SYR,2016.0,1,0,1
ISL,FRA,2016.0,1,0,1
MWI,KOR,2013.0,1,0,1
MYS,LBY,2010.0,3,0,3
GBR,PNG,2001.0,2,0,2
NLD,BIH,2017.0,1,0,1
FRA,QAT,2010.0,5,0,5
EGY,JOR,1998.0,1,0,1
IRL,ISL,2003.0,1,0,1
ESP,DOM,2005.0,1,0,1
USA,GRD,2005.0,1,0,1
NGA,CMR,2007.0,1,0,1
HUN,DNK,2005.0,1,0,1
PLW,,2013.0,2,0,2
BWA,,2008.0,16,0,16
VNM,FRA,2001.0,4,0,4
LBN,JOR,2016.0,2,0,2
BEL,DZA,2007.0,2,0,2
ESP,IRQ,2005.0,1,0,1
ARM,MEX,2005.0,1,0,1
BLR,PRT,2004.0,2,0,2
BTN,,2015.0,5,0,5
NLD,NAM,2013.0,2,0,2
KIR,,2017.0,2,0,2
STP,,2009.0,2,0,2
FJI,PRI,2008.0,1,0,1
IND,CHL,2006.0,2,0,2
BEN,BFA,2016.0,1,0,1
GAB,,2011.0,9,0,9
BWA,NGA,2016.0,3,0,3
LAO,,2017.0,17,0,17
MAR,YEM,2016.0,3,0,3
NPL,IDN,2019.0,1,0,1
ETH,SEN,2004.0,1,0,1
ALB,ITA,2022.0,2,0,2
UKR,IRQ,2019.0,1,0,1
,BIH,2019.0,76,0,76
SWE,MMR,2021.0,1,0,1
LVA,DNK,2008.0,2,0,2
DNK,LVA,2010.0,1,0,1
CHN,PRI,2006.0,1,0,1
BEL,BFA,2010.0,2,0,2
,GRL,2000.0,7,0,7
PAK,SAU,2001.0,3,0,3
FJI,BRA,2020.0,1,0,1
TWN,TUR,2010.0,2,0,2
BRA,AUS,1997.0,1,0,1
TCD,CHE,2016.0,1,0,1
CAN,BHR,2015.0,2,0,2
FRA,ALB,2012.0,2,0,2
SWE,VNM,2008.0,3,0,3
COG,TUN,2008.0,1,0,1
BGD,SAU,2004.0,1,0,1
GEO,GBR,2013.0,2,0,2
TWN,MAC,2017.0,3,0,3
RWA,MWI,2022.0,1,0,1
PAN,IRL,2020.0,1,0,1
NIC,ARG,2021.0,1,0,1
,USA,2020.0,5,0,5
THA,ARE,2012.0,1,0,1
LBY,,2007.0,14,0,14
,KHM,1998.0,8,0,8
PNG,PAK,2022.0,1,0,1
BEL,RWA,2006.0,1,0,1
SAU,PER,2014.0,1,0,1
MEX,NPL,2003.0,1,0,1
HKG,ZAF,2007.0,2,0,2
CIV,MLI,2008.0,1,0,1
KEN,ROU,2004.0,1,0,1
FJI,PAK,2016.0,1,0,1
,LBY,1995.0,4,0,4
BEL,BFA,2019.0,4,0,4
IRL,MTQ,2013.0,1,0,1
NPL,MEX,2010.0,1,0,1
AUS,FSM,2005.0,1,0,1
BRA,BGR,2001.0,1,0,1
KNA,CHE,2010.0,1,0,1
TTO,USA,1998.0,2,0,2
HRV,NOR,2004.0,1,0,1
AUT,NOR,2000.0,1,0,1
PRI,DNK,2008.0,1,0,1
PER,FIN,2013.0,1,0,1
SAU,CYP,2019.0,1,0,1
BFA,GIN,2013.0,2,0,2
LAO,,2010.0,7,0,7
,CAF,2000.0,2,0,2
MLI,LBR,2019.0,1,0,1
TUN,ARG,2013.0,1,0,1
CHL,HKG,2014.0,1,0,1
POL,OMN,2017.0,1,0,1
AFG,,2018.0,1,0,1
GRC,PRT,2021.0,3,0,3
LVA,UKR,2017.0,1,0,1
HND,VEN,2009.0,1,0,1
TWN,CZE,2022.0,2,0,2
JPN,GHA,2000.0,1,0,1
MTQ,BEL,2011.0,1,0,1
POL,BGD,2014.0,1,0,1
SVK,ESP,1999.0,2,0,2
UZB,BRA,2012.0,1,0,1
BLR,ITA,2012.0,2,0,2
JPN,BRN,2006.0,1,0,1
SWZ,,2008.0,3,0,3
BWA,ZAF,2000.0,2,0,2
CMR,PAK,2002.0,1,0,1
PAK,CMR,2003.0,1,0,1
CUB,GTM,2007.0,1,0,1
COL,BOL,2013.0,2,0,2
CHE,JOR,2015.0,1,0,1
CYP,GRC,1997.0,2,0,2
ESP,AND,2007.0,2,0,2
BFA,NER,2017.0,2,0,2
UKR,SVN,2013.0,1,0,1
MYS,PER,2019.0,1,0,1
BHS,AUS,2014.0,1,0,1
PNG,UGA,2019.0,1,0,1
HKG,VNM,2020.0,3,0,3
KWT,DMA,2010.0,1,0,1
SRB,KWT,2013.0,3,0,3
BEN,TZA,2021.0,1,0,1
KNA,USA,2018.0,2,0,2
TJK,USA,2017.0,1,0,1
TTO,USA,1997.0,1,0,1
HKG,MWI,2021.0,1,0,1
POL,EST,2005.0,1,0,1
NAM,,2003.0,2,0,2
JPN,CHL,2006.0,4,0,4
DZA,ARE,2002.0,1,0,1
,HTI,1996.0,1,0,1
ROU,CZE,2010.0,2,0,2
GBR,UZB,2005.0,2,0,2
SVN,ZAF,2007.0,1,0,1
FRA,GEO,2008.0,2,0,2
BGR,KWT,2018.0,1,0,1
CAN,GMB,2013.0,1,0,1
GRD,CAN,2020.0,1,0,1
BRN,POL,2013.0,1,0,1
ITA,LBY,2012.0,1,0,1
KEN,VNM,2014.0,2,0,2
JAM,GBR,2020.0,3,0,3
JOR,FIN,2015.0,1,0,1
CHN,ERI,2015.0,1,0,1
AUS,VUT,2004.0,2,0,2
DNK,GRC,1998.0,1,0,1
,MOZ,1994.0,3,0,3
SAU,ROU,2019.0,1,0,1
EGY,TUR,2007.0,1,0,1
QAT,IND,2006.0,1,0,1
CYP,QAT,2007.0,1,0,1
ISL,PRT,2017.0,1,0,1
BRA,TUR,2009.0,1,0,1
BGR,SAU,2019.0,1,0,1
DNK,IDN,2011.0,1,0,1
BRA,BLR,2002.0,1,0,1
PHL,MOZ,2009.0,1,0,1
CHE,TGO,2011.0,1,0,1
TWN,LVA,2009.0,1,0,1
SYR,NLD,2013.0,1,0,1
MHL,,2007.0,1,0,1
BRA,BLR,2005.0,1,0,1
CYP,BRA,2001.0,1,0,1
BRA,CYP,2003.0,1,0,1
FRO,DNK,1999.0,1,0,1
GLP,MDG,2021.0,1,0,1
IRL,SAU,2009.0,1,0,1
KAZ,VNM,2020.0,1,0,1
CUB,MYS,2015.0,2,0,2
UKR,NOR,2015.0,2,0,2
RUS,MNE,2004.0,1,0,1
NAM,NZL,2005.0,1,0,1
CUB,JAM,2004.0,1,0,1
MAR,SYR,2006.0,1,0,1
PRT,CPV,2008.0,1,0,1
GRC,TUR,2009.0,1,0,1
MMR,DEU,2022.0,1,0,1
SLE,,2017.0,12,0,12
ITA,PSE,2018.0,3,0,3
,PLW,2010.0,3,0,3
TLS,COL,2018.0,1,0,1
VCT,,2021.0,3,0,3
KOR,CMR,2018.0,1,0,1
IRQ,THA,2021.0,1,0,1
CAN,MTQ,2014.0,1,0,1
SRB,OMN,2015.0,1,0,1
PHL,IDN,2007.0,1,0,1
SEN,TGO,2013.0,2,0,2
CHE,IDN,2019.0,3,0,3
POL,LBN,2006.0,1,0,1
SAU,NGA,2006.0,3,0,3
SEN,NLD,2002.0,1,0,1
TUR,BHR,2018.0,1,0,1
BLR,CHN,2000.0,1,0,1
SWZ,ETH,2018.0,1,0,1
BLR,BEL,2001.0,1,0,1
USA,GRD,2002.0,1,0,1
DEU,KGZ,2001.0,1,0,1
PRT,ZAF,2006.0,3,0,3
BEN,SEN,2015.0,1,0,1
KHM,GAB,2017.0,1,0,1
LTU,KOR,2014.0,1,0,1
,BRB,2009.0,4,0,4
ZWE,AUS,2010.0,1,0,1
SGP,BGD,2011.0,3,0,3
MYS,PER,2010.0,1,0,1
ZAF,LSO,1999.0,1,0,1
KIR,,2019.0,1,0,1
SEN,MAR,2021.0,1,0,1
AFG,CHE,2009.0,1,0,1
FIN,GRC,2009.0,1,0,1
ESP,THA,2011.0,1,0,1
CIV,KEN,2016.0,1,0,1
IRN,DZA,2017.0,1,0,1
LKA,OMN,2010.0,1,0,1
VEN,NZL,1999.0,1,0,1
AUT,EST,2012.0,1,0,1
BLR,SVK,2000.0,1,0,1
AUS,MMR,2018.0,2,0,2
ECU,DOM,2016.0,1,0,1
GBR,YEM,2015.0,2,0,2
COL,URY,2020.0,1,0,1
GBR,BRN,2022.0,1,0,1
CUB,JPN,2018.0,2,0,2
GBR,MAC,2003.0,1,0,1
,ASM,2017.0,1,0,1
ARM,UKR,2021.0,1,0,1
TWN,IRN,2015.0,1,0,1
HUN,MAR,2011.0,2,0,2
UGA,IRL,2018.0,1,0,1
MOZ,CUB,1999.0,1,0,1
BEL,PAK,2016.0,1,0,1
ERI,COG,2022.0,1,0,1
MYS,SVK,2022.0,1,0,1
CHN,SDN,2011.0,1,0,1
KWT,ROU,2007.0,1,0,1
CHE,BIH,2006.0,1,0,1
HUN,ZAF,2004.0,1,0,1
ROU,COL,2008.0,1,0,1
AGO,,2012.0,1,0,1
GRC,MKD,2009.0,2,0,2
TTO,,2025.0,2,0,2
CUB,GRC,2007.0,1,0,1
ITA,LUX,2007.0,2,0,2
NLD,QAT,2006.0,1,0,1
ROU,IRN,2018.0,1,0,1
PRT,SVN,2019.0,1,0,1
,REU,2013.0,2,0,2
TUR,CHL,2014.0,1,0,1
LTU,TWN,2019.0,1,0,1
ATG,USA,2018.0,1,0,1
TUN,KOR,2020.0,2,0,2
URY,AUS,2007.0,1,0,1
ISL,POL,2015.0,1,0,1
MWI,CHE,2013.0,1,0,1
NZL,KNA,2012.0,1,0,1
KEN,NPL,2021.0,1,0,1
KAZ,ARE,2017.0,2,0,2
ARE,POL,2013.0,2,0,2
CMR,KOR,2012.0,1,0,1
PNG,UGA,2017.0,1,0,1
SAU,CYP,2017.0,1,0,1
MSR,NZL,2008.0,1,0,1
JOR,SWE,2009.0,2,0,2
CIV,CMR,2009.0,2,0,2
IND,KAZ,2003.0,1,0,1
LBY,SAU,2003.0,1,0,1
COL,CZE,2014.0,1,0,1
NPL,MEX,2019.0,1,0,1
GRC,ETH,2017.0,1,0,1
TWN,IRQ,2015.0,1,0,1
JPN,PER,2007.0,1,0,1
MWI,IRL,2020.0,1,0,1
CUB,ZAF,2019.0,1,0,1
TUR,NER,2022.0,1,0,1
PAK,CHL,2022.0,1,0,1
BFA,CMR,2020.0,1,0,1
FRA,BRN,2006.0,1,0,1
CHE,MYS,2013.0,2,0,2
BWA,TZA,2012.0,1,0,1
HKG,POL,2021.0,1,0,1
BLR,KOR,2014.0,1,0,1
CUB,AUT,2015.0,1,0,1
BOL,URY,2019.0,1,0,1
SWE,QAT,2016.0,2,0,2
HKG,MUS,2010.0,1,0,1
THA,FIN,2015.0,2,0,2
MEX,PRI,2001.0,1,0,1
BRB,CAN,2010.0,1,0,1
TWN,ARM,2015.0,1,0,1
DJI,IRN,2019.0,1,0,1
ARE,IRN,2022.0,1,0,1
LBN,NGA,2019.0,1,0,1
GAB,COG,2020.0,1,0,1
GMB,ITA,2010.0,1,0,1
JPN,DOM,2002.0,1,0,1
LKA,SGP,2002.0,1,0,1
CMR,NGA,2002.0,1,0,1
GRC,BHR,2013.0,1,0,1
CHL,LTU,2020.0,1,0,1
UKR,FIN,2022.0,1,0,1
MUS,ARE,2019.0,1,0,1
ISR,TUR,1999.0,2,0,2
MDG,JPN,2021.0,1,0,1
SYR,AFG,2012.0,1,0,1
KWT,ARE,2005.0,1,0,1
MYS,JAM,2017.0,1,0,1
LKA,KOR,2012.0,1,0,1
SGP,BRN,2004.0,1,0,1
SMR,,2015.0,1,0,1
MAC,BEL,2015.0,1,0,1
NPL,GBR,1999.0,1,0,1
NGA,CUB,2005.0,1,0,1
GMB,CMR,2005.0,1,0,1
SVK,PER,2008.0,1,0,1
PAK,IRN,1998.0,1,0,1
KWT,BRB,2001.0,1,0,1
NER,CAN,2007.0,1,0,1
RUS,ARG,2018.0,1,0,1
HKG,LKA,2006.0,1,0,1
GTM,CHL,2013.0,1,0,1
ZWE,AUS,2017.0,1,0,1
UKR,BGR,2016.0,1,0,1
ISR,EST,2014.0,1,0,1
MAR,ZAF,2006.0,1,0,1
SAU,POL,2022.0,1,0,1
COL,PRY,2010.0,1,0,1
HRV,BEL,2004.0,1,0,1
ETH,USA,2002.0,1,0,1
PRT,MCO,1998.0,1,0,1
SWE,ARE,2000.0,1,0,1
ROU,CZE,2019.0,2,0,2
ECU,AUS,2010.0,1,0,1
CAN,PAN,2017.0,1,0,1
GIN,BFA,2009.0,1,0,1
BEN,KOR,2019.0,1,0,1
NGA,IRQ,2019.0,1,0,1
IRL,GHA,2015.0,1,0,1
NGA,IRQ,2017.0,1,0,1
CHE,SSD,2017.0,1,0,1
CRI,KEN,2022.0,1,0,1
CHE,MAR,2014.0,1,0,1
SGP,MNG,2021.0,1,0,1
CHE,PRI,2008.0,1,0,1
SGP,QAT,2011.0,2,0,2
BEL,TUN,2010.0,1,0,1
ZMB,DNK,2013.0,1,0,1
BIH,SVN,2020.0,1,0,1
CHL,KEN,2006.0,1,0,1
TTO,UKR,2007.0,1,0,1
AUS,KAZ,2014.0,1,0,1
GIN,NZL,2020.0,1,0,1
IND,ZMB,2011.0,1,0,1
NZL,JOR,2012.0,2,0,2
BRB,CAN,2019.0,1,0,1
SWE,ZMB,1999.0,1,0,1
BRA,SAU,2005.0,1,0,1
ITA,TCD,2006.0,1,0,1
TZA,,1999.0,1,0,1
GHA,BEL,2003.0,1,0,1
BGR,ITA,1998.0,2,0,2
UKR,ZAF,2009.0,1,0,1
RWA,POL,2012.0,1,0,1
POL,NOR,1999.0,1,0,1
ZWE,CAN,2010.0,2,0,2
BFA,NER,2019.0,1,0,1
AUT,MYS,2011.0,1,0,1
BHR,CAN,2022.0,1,0,1
BEL,JOR,2016.0,1,0,1
HUN,THA,2016.0,1,0,1
CMR,FIN,2017.0,1,0,1
THA,AFG,2018.0,1,0,1
SGP,SRB,2022.0,1,0,1
SGP,IDN,2005.0,1,0,1
DNK,MNG,2004.0,1,0,1
MHL,AUS,2006.0,1,0,1
PRT,HKG,2004.0,1,0,1
ZAF,BEN,2009.0,1,0,1
BGR,BRA,2005.0,1,0,1
USA,LIE,2003.0,1,0,1
TUR,GEO,2003.0,1,0,1
MMR,SGP,2011.0,1,0,1
NLD,DZA,2017.0,1,0,1
MYS,QAT,2008.0,1,0,1
KOR,MEX,1998.0,1,0,1
BRA,LKA,2002.0,1,0,1
NLD,NPL,2013.0,1,0,1
HKG,EGY,2001.0,1,0,1
NGA,IRN,1997.0,1,0,1
IRN,NGA,1998.0,1,0,1
LUX,CAN,2014.0,1,0,1
,SMR,2015.0,2,0,2
PER,GHA,2021.0,1,0,1
ARG,ROU,2019.0,1,0,1
MYS,COL,2003.0,1,0,1
ISL,NZL,2011.0,1,0,1
GEO,CHE,2018.0,1,0,1
KAZ,FIN,2014.0,1,0,1
NZL,PHL,2016.0,1,0,1
LCA,,2018.0,1,0,1
CYP,HUN,2020.0,1,0,1
CIV,USA,2002.0,1,0,1
HUN,KOR,2010.0,1,0,1
BLR,SGP,2014.0,1,0,1
PHL,ITA,2002.0,1,0,1
BEL,NER,2020.0,1,0,1
HUN,LVA,2013.0,1,0,1
DZA,TWN,2017.0,1,0,1
USA,IRQ,2023.0,1,0,1
GBR,USA,2014.0,1575,1602,-27
USA,AUS,2009.0,488,386,102
MYS,TWN,2010.0,3,4,-1
GBR,FRA,2015.0,390,468,-78
JPN,KOR,2008.0,143,89,54
DEU,SWE,2013.0,166,107,59
ARG,FIN,2013.0,3,2,1
DEU,ITA,2009.0,118,183,-65
AUT,USA,2011.0,107,111,-4
COL,CHL,2013.0,11,13,-2
IND,USA,2018.0,1317,712,605
DEU,CHE,2016.0,626,435,191
AUS,FRA,2007.0,45,58,-13
ISR,CAN,2009.0,46,36,10
CHN,SWE,2015.0,92,64,28
ESP,GBR,2019.0,406,355,51
GBR,ITA,2011.0,212,361,-149
ESP,GBR,2017.0,463,298,165
CAN,USA,2001.0,1028,784,244
USA,THA,2011.0,204,101,103
USA,MEX,2003.0,182,135,47
DEU,CAN,2005.0,136,86,50
ZAF,CHE,2014.0,10,6,4
GBR,IRN,2005.0,46,10,36
FIN,GBR,2007.0,42,32,10
DEU,MEX,1997.0,1,5,-4
SWE,GBR,2005.0,82,71,11
CHE,CAN,2015.0,73,94,-21
BRA,GBR,2020.0,132,84,48
DEU,CHL,2012.0,31,18,13
EGY,SAU,2021.0,294,133,161
AUS,USA,2020.0,567,515,52
KOR,ESP,2009.0,4,1,3
ESP,GBR,2010.0,226,272,-46
CHN,SGP,2009.0,167,118,49
TWN,USA,2016.0,263,259,4
USA,ISR,2003.0,249,365,-116
IND,NLD,2013.0,26,19,7
GBR,DEU,2016.0,571,678,-107
GBR,KEN,2017.0,22,26,-4
CHN,JPN,2009.0,247,376,-129
CAN,AUS,2012.0,162,133,29
NOR,GBR,2006.0,25,43,-18
ITA,AUS,2013.0,53,21,32
AUS,MYS,2010.0,49,57,-8
JPN,CAN,2012.0,77,66,11
IND,GBR,2013.0,137,148,-11
CHN,HKG,2006.0,188,188,0
MEX,FRA,2018.0,35,50,-15
ROU,DEU,2012.0,29,15,14
CAN,GBR,2006.0,236,284,-48
USA,KOR,2020.0,704,766,-62
SWE,USA,2015.0,211,229,-18
IRL,CHE,2017.0,19,5,14
IRL,AUS,2014.0,51,33,18
ARE,GBR,2017.0,17,69,-52
BRA,ESP,2009.0,56,47,9
FRA,SYR,2009.0,7,2,5
LBY,IND,2011.0,6,7,-1
GBR,CHL,2010.0,17,14,3
BEL,NLD,2008.0,105,99,6
ZAF,NGA,2014.0,21,38,-17
BRA,USA,2015.0,410,352,58
GBR,NLD,1999.0,48,57,-9
FRA,MAR,2020.0,67,45,22
TWN,GBR,2005.0,16,37,-21
AUS,CHN,2011.0,90,181,-91
USA,IND,2003.0,264,517,-253
FRA,CHL,2013.0,29,24,5
CHE,DEU,2018.0,462,635,-173
ZAF,CHL,2015.0,4,1,3
JPN,THA,2009.0,71,27,44
ITA,SWE,2016.0,75,29,46
CAN,PAK,2017.0,17,12,5
CHN,BEL,2017.0,61,64,-3
IND,SAU,2017.0,145,56,89
CZE,CHN,2018.0,8,19,-11
MEX,COL,2015.0,37,22,15
IND,THA,2018.0,18,8,10
ITA,BLR,2017.0,1,1,0
NZL,USA,2015.0,116,121,-5
GBR,NZL,2014.0,107,115,-8
ITA,CHN,2016.0,47,34,13
CHN,POL,2013.0,16,9,7
PAK,CHN,2014.0,84,64,20
AUS,MYS,2017.0,119,147,-28
AUS,GBR,2018.0,537,549,-12
IND,SAU,2010.0,58,6,52
ECU,CHL,2017.0,7,8,-1
SVK,CZE,2016.0,59,53,6
DEU,EGY,2016.0,46,28,18
ESP,DEU,2022.0,104,99,5
SWE,LTU,2019.0,1,7,-6
MYS,JPN,2018.0,35,60,-25
THA,GBR,2017.0,37,75,-38
PRT,ESP,2015.0,64,103,-39
DEU,CAN,2002.0,124,121,3
VNM,CHN,2018.0,4,28,-24
NOR,USA,2012.0,40,71,-31
MYS,PAK,2017.0,114,37,77
POL,CAN,2020.0,6,10,-4
GBR,CHL,2019.0,54,42,12
MEX,USA,2022.0,103,61,42
GRC,DEU,2020.0,68,41,27
ESP,CHN,2020.0,43,46,-3
NLD,ESP,2016.0,63,82,-19
CHN,ISR,2006.0,8,5,3
NOR,DEU,2018.0,38,80,-42
IND,SAU,2019.0,141,64,77
DEU,LUX,2020.0,32,30,2
CHN,DEU,2022.0,181,280,-99
MEX,PER,2016.0,7,5,2
CHE,ITA,2018.0,138,271,-133
USA,POL,2003.0,95,142,-47
FIN,BEL,2001.0,1,5,-4
FRA,CIV,2001.0,16,13,3
CZE,ESP,2022.0,11,11,0
CAN,PAK,2019.0,19,24,-5
ZAF,UGA,2018.0,17,17,0
AUS,CAN,2001.0,66,74,-8
AUS,JOR,2022.0,2,1,1
IRN,AUS,2018.0,148,37,111
DNK,DEU,2020.0,100,135,-35
SGP,AUS,2012.0,54,54,0
NPL,CHN,2007.0,1,1,0
CHE,NOR,2022.0,11,8,3
ARE,GBR,2019.0,29,79,-50
CHL,ESP,2017.0,73,116,-43
ITA,AUT,2020.0,49,36,13
IND,AUS,2012.0,80,32,48
PHL,MYS,2017.0,1,3,-2
DEU,ISR,2020.0,61,67,-6
CHL,PER,2013.0,4,2,2
TUR,IRN,2016.0,14,23,-9
ITA,IND,2017.0,44,46,-2
SGP,DEU,2018.0,43,25,18
AUS,ESP,2020.0,38,39,-1
ESP,FRA,2021.0,190,151,39
USA,CRI,2021.0,11,15,-4
CHN,BEL,2019.0,70,64,6
COL,ESP,2014.0,39,92,-53
SAU,POL,2016.0,2,4,-2
NZL,IND,2018.0,10,20,-10
CHL,ESP,2019.0,85,130,-45
CHN,IDN,2019.0,7,8,-1
RUS,ZAF,2022.0,2,1,1
MYS,PAK,2019.0,126,46,80
NGA,ZAF,2021.0,62,66,-4
ESP,IRN,2021.0,3,23,-20
GBR,ARM,2017.0,1,1,0
EGY,DEU,2002.0,18,22,-4
CHN,DNK,2020.0,92,69,23
GBR,MLT,2020.0,18,6,12
JPN,FIN,2013.0,14,15,-1
THA,VNM,2020.0,24,4,20
ATG,USA,2019.0,3,1,2
JPN,MEX,2019.0,5,4,1
ZAF,AUT,2020.0,5,3,2
AUS,SAU,2021.0,41,17,24
USA,LBN,2022.0,14,69,-55
GBR,ROU,2020.0,15,18,-3
ESP,AUT,2018.0,40,24,16
GBR,KEN,2019.0,26,20,6
CHN,USA,2000.0,396,100,296
KEN,AUS,2020.0,8,7,1
GBR,KOR,2018.0,60,56,4
IND,IRN,2020.0,9,2,7
ECU,USA,2020.0,25,29,-4
MYS,LBY,2018.0,13,1,12
IND,BGD,2003.0,7,9,-2
HKG,AUS,2016.0,25,39,-14
USA,DEU,1999.0,429,561,-132
MEX,BEL,2021.0,6,4,2
SAU,JOR,2021.0,20,16,4
KOR,AUS,2021.0,30,30,0
VNM,KOR,2016.0,20,60,-40
BRA,PRY,2022.0,3,2,1
KOR,LKA,2022.0,5,4,1
GRC,CHE,2019.0,40,16,24
ISR,DEU,2003.0,34,25,9
GHA,JPN,2021.0,5,3,2
CAN,BEL,2011.0,27,40,-13
BRA,ISR,2011.0,2,3,-1
CHL,USA,2012.0,84,103,-19
EGY,ZAF,2018.0,2,1,1
BGD,JPN,2012.0,34,65,-31
NLD,IND,2009.0,8,36,-28
KOR,HKG,2020.0,17,21,-4
VNM,ITA,2019.0,5,5,0
IDN,TWN,2020.0,34,27,7
DZA,CAN,2013.0,3,5,-2
USA,ARG,2016.0,62,71,-9
CHE,AUS,2007.0,46,37,9
MAR,BEL,2022.0,4,3,1
DEU,TUR,2020.0,41,87,-46
AUS,CHL,2010.0,6,8,-2
USA,QAT,2009.0,18,5,13
ECU,ESP,2011.0,3,7,-4
NLD,ITA,2018.0,90,131,-41
USA,UKR,2008.0,20,22,-2
TUR,SWE,2009.0,8,3,5
USA,SEN,2009.0,3,4,-1
MEX,AUS,2009.0,6,3,3
GBR,DNK,2009.0,70,47,23
PAK,SWE,2010.0,7,4,3
AUT,AUS,2018.0,14,18,-4
BHR,USA,2018.0,2,3,-1
IRN,DEU,2013.0,74,23,51
CAN,ARE,2016.0,35,12,23
BMU,USA,2011.0,4,3,1
IRN,CHE,2007.0,7,5,2
CHL,ESP,2010.0,44,55,-11
CHE,SGP,2016.0,19,16,3
DEU,NOR,1999.0,14,6,8
ITA,NZL,2017.0,11,3,8
HRV,ESP,2002.0,7,2,5
TWN,KOR,2003.0,3,6,-3
JPN,TWN,2012.0,33,35,-2
TUR,AUS,2018.0,16,12,4
FRA,ROU,2016.0,25,27,-2
NZL,GBR,2000.0,25,25,0
ARG,DEU,2001.0,16,7,9
NZL,DEU,2018.0,25,41,-16
BRN,MYS,2018.0,6,4,2
DEU,IRL,2009.0,39,17,22
DEU,UKR,2011.0,25,27,-2
RUS,NLD,2012.0,14,10,4
HUN,FRA,2001.0,14,11,3
AUS,CHL,2019.0,20,27,-7
KOR,SGP,2018.0,34,33,1
NPL,AUS,2016.0,12,4,8
JPN,MNG,2021.0,4,3,1
DZA,MAR,2020.0,7,3,4
AUS,TWN,2021.0,17,13,4
CHN,BEL,2010.0,29,20,9
NZL,MYS,2011.0,13,11,2
BGD,SAU,2014.0,5,2,3
HUN,AUS,2021.0,6,4,2
TWN,MAC,2018.0,3,5,-2
SWE,NZL,2017.0,9,11,-2
TUN,MAR,2020.0,8,1,7
BRA,CHE,2013.0,15,14,1
PSE,MYS,2017.0,2,9,-7
IRL,CHE,2019.0,16,16,0
LBN,CAN,2022.0,11,2,9
BRA,IRL,2016.0,7,3,4
CAN,SWE,1999.0,12,11,1
NLD,POL,2020.0,8,18,-10
KAZ,ARE,2018.0,2,2,0
BRA,COL,2015.0,33,50,-17
ISR,USA,1999.0,98,125,-27
FIN,PRT,2020.0,5,4,1
ZAF,RWA,2015.0,5,11,-6
ESP,AUS,2022.0,10,26,-16
USA,CIV,2021.0,2,1,1
USA,HUN,1999.0,27,43,-16
KOR,FRA,2021.0,48,15,33
TWN,NLD,2018.0,5,7,-2
BEL,CZE,2021.0,12,2,10
SRB,SVN,2020.0,6,4,2
ECU,ITA,2021.0,5,2,3
FRA,ETH,2021.0,4,1,3
IRN,GBR,2006.0,11,55,-44
NLD,THA,2009.0,6,8,-2
PAN,USA,2012.0,15,10,5
SWE,GBR,2002.0,80,80,0
FRA,QAT,2018.0,8,6,2
CZE,HUN,2001.0,1,1,0
SGP,BEL,2015.0,6,11,-5
EGY,DEU,2005.0,7,31,-24
COL,BEL,2013.0,7,3,4
IND,NOR,2018.0,18,4,14
ECU,CHL,2019.0,8,4,4
USA,RUS,2007.0,121,186,-65
USA,PER,2012.0,25,23,2
ZAF,IND,2009.0,11,21,-10
TUR,FRA,2013.0,12,13,-1
GBR,BHR,2021.0,2,1,1
SWE,CZE,2013.0,5,7,-2
MAR,ITA,2005.0,1,5,-4
PAK,GBR,2006.0,16,23,-7
TUR,CAN,2012.0,16,18,-2
PRI,COL,2011.0,5,1,4
KGZ,RUS,2010.0,3,1,2
SWE,UKR,2009.0,1,6,-5
AUS,THA,2001.0,5,5,0
MEX,ITA,2011.0,10,9,1
ESP,MEX,2003.0,61,42,19
EGY,YEM,2006.0,4,1,3
ARE,CAN,2005.0,5,7,-2
ROU,FRA,2001.0,17,12,5
AUS,CHL,2017.0,21,18,3
ZAF,DEU,2001.0,7,16,-9
NLD,IDN,2009.0,13,1,12
LTU,GBR,2008.0,1,3,-2
NZL,CAN,2008.0,25,26,-1
ZAF,CAN,2003.0,16,10,6
GRC,CYP,2007.0,24,6,18
MAR,GBR,2003.0,1,2,-1
NLD,CAN,2001.0,26,30,-4
ITA,RUS,2002.0,25,43,-18
UKR,RUS,2003.0,41,42,-1
PHL,CHE,2020.0,4,4,0
FRA,VUT,2019.0,1,1,0
GBR,BLR,2005.0,1,1,0
UKR,BLR,2015.0,2,3,-1
UKR,DEU,2000.0,19,1,18
FRA,ARE,2019.0,22,7,15
ITA,NLD,2003.0,57,41,16
SAU,CAN,2005.0,11,20,-9
USA,ARE,2007.0,23,9,14
BEL,IDN,2007.0,1,1,0
ZAF,ITA,2003.0,3,4,-1
RUS,TJK,2007.0,1,1,0
DNK,IND,2006.0,3,3,0
CHE,AUT,2004.0,28,24,4
BGR,JPN,2000.0,2,2,0
FIN,FRA,2001.0,9,10,-1
JPN,BEL,2007.0,12,9,3
TUR,UZB,2019.0,3,1,2
AUT,CHE,2002.0,33,16,17
GBR,IRN,2002.0,35,8,27
IDN,AUS,2002.0,5,8,-3
AUT,JPN,2004.0,6,6,0
JPN,ITA,2001.0,22,17,5
CHE,BRA,2001.0,5,3,2
AUS,VEN,2005.0,2,1,1
SWE,IRL,2020.0,12,7,5
UZB,RUS,2019.0,4,7,-3
CZE,USA,2009.0,36,38,-2
DEU,JOR,2001.0,2,4,-2
CAN,ZAF,2001.0,4,19,-15
FRA,PRT,2004.0,33,12,21
FRA,ZAF,2004.0,9,6,3
SWE,CAN,2022.0,20,11,9
GBR,NOR,2003.0,29,28,1
USA,JOR,1999.0,6,2,4
AUS,PAK,2012.0,7,16,-9
DNK,FRA,2007.0,14,32,-18
CAN,NOR,2006.0,17,6,11
SAU,AUS,2004.0,4,5,-1
BRA,BGR,2003.0,1,1,0
RUS,PRT,2001.0,3,3,0
FRA,UKR,2014.0,9,15,-6
ARE,CAN,2002.0,2,8,-6
CAN,DNK,1999.0,4,11,-7
SGP,MEX,2014.0,2,1,1
RUS,CHN,2012.0,4,8,-4
PRT,CPV,2013.0,2,2,0
ZAF,BRA,2002.0,2,1,1
DNK,GRL,2015.0,3,4,-1
PAN,BRA,2002.0,1,1,0
ITA,RUS,2005.0,24,19,5
SVN,AUT,2003.0,5,2,3
DEU,KOR,2000.0,12,4,8
BEL,RUS,1998.0,5,5,0
CAN,KOR,2004.0,15,26,-11
ZAF,GBR,1999.0,13,13,0
AUS,JPN,1997.0,9,6,3
CAN,CHN,2000.0,12,45,-33
JPN,NZL,2018.0,6,13,-7
PAK,IND,2007.0,6,13,-7
MYS,CAN,2004.0,1,1,0
ITA,SVN,2011.0,7,3,4
HUN,SWE,2011.0,8,4,4
POL,IRL,2010.0,8,3,5
ROU,POL,2007.0,4,1,3
PHL,FRA,2009.0,2,1,1
IND,KEN,2006.0,3,3,0
ISR,ITA,2008.0,7,8,-1
ZAF,CMR,2018.0,8,6,2
KEN,BEL,2011.0,3,2,1
ZAF,RUS,2011.0,4,2,2
ISL,SWE,2009.0,3,2,1
TWN,GBR,2002.0,17,22,-5
UGA,USA,2008.0,16,21,-5
FRA,SRB,2015.0,7,4,3
TWN,MYS,2013.0,7,5,2
IRL,NOR,2009.0,3,1,2
SVK,IRL,2006.0,1,1,0
NGA,GBR,2000.0,5,6,-1
CHE,ISR,2014.0,15,18,-3
NLD,TUR,2007.0,3,9,-6
FRA,HKG,2008.0,9,7,2
CHL,FRA,2022.0,15,12,3
DEU,ISL,2020.0,2,6,-4
IND,IDN,2015.0,6,2,4
FRA,LBN,2013.0,62,18,44
SGP,THA,2011.0,3,9,-6
UKR,CAN,2013.0,6,2,4
CZE,DEU,2012.0,32,36,-4
BRA,FIN,2016.0,3,8,-5
PAK,SWE,2017.0,5,12,-7
ROU,ITA,2012.0,11,5,6
ITA,ROU,2013.0,10,14,-4
POL,SVK,2008.0,1,3,-2
AUS,TZA,2013.0,2,1,1
DNK,AUS,2014.0,18,26,-8
AUT,CHN,2008.0,5,6,-1
IRL,IRN,2018.0,3,11,-8
SYR,EGY,2016.0,1,1,0
COL,SWE,2015.0,5,1,4
SAU,ROU,2018.0,1,1,0
ROU,CZE,2018.0,4,1,3
THA,DEU,2018.0,14,28,-14
VNM,DEU,2016.0,3,16,-13
MYS,TWN,2017.0,11,2,9
MEX,JPN,2015.0,6,10,-4
PAK,CHL,2016.0,1,1,0
TLS,AUS,2021.0,2,1,1
NPL,JPN,2015.0,2,7,-5
CHE,ROU,2015.0,4,10,-6
SWE,NZL,2019.0,7,8,-1
TTO,JAM,2015.0,3,1,2
MYS,VNM,2021.0,5,8,-3
KOR,DNK,2012.0,3,3,0
THA,FRA,2018.0,10,27,-17
BRA,MEX,2013.0,9,13,-4
MYS,BRA,2022.0,2,1,1
IDN,BEL,2018.0,3,4,-1
RWA,CAN,2021.0,2,2,0
IRQ,ROU,2014.0,1,1,0
CZE,VNM,2021.0,4,5,-1
RUS,CAN,2020.0,14,15,-1
VEN,MEX,2021.0,3,1,2
KEN,ESP,2018.0,2,4,-2
NLD,EGY,2022.0,1,1,0
KGZ,RUS,2019.0,3,3,0
ITA,ARG,2009.0,19,17,2
GBR,SVN,2021.0,10,4,6
ITA,VEN,2014.0,1,1,0
GBR,PRT,2004.0,47,25,22
KOR,BEL,2008.0,3,2,1
FRA,ISR,2000.0,7,8,-1
CUB,ITA,2011.0,3,2,1
PRT,GRC,2007.0,3,1,2
ITA,CZE,2004.0,8,6,2
GBR,EST,2001.0,3,4,-1
RUS,ESP,2000.0,11,5,6
USA,PHL,2001.0,10,10,0
NOR,NZL,2001.0,1,4,-3
VNM,NLD,2011.0,1,1,0
KHM,USA,2015.0,7,3,4
IND,EGY,2010.0,1,4,-3
UKR,GBR,1999.0,9,3,6
IND,FIN,2009.0,9,2,7
LUX,FRA,2011.0,16,26,-10
HKG,MAC,2015.0,17,7,10
CHE,POL,2016.0,16,23,-7
BRN,GBR,2018.0,2,10,-8
IRQ,GBR,2021.0,14,51,-37
RUS,NOR,2015.0,7,5,2
DEU,SVK,2021.0,4,6,-2
ITA,IND,2010.0,20,41,-21
BEL,MEX,2003.0,6,1,5
OMN,CAN,2022.0,3,2,1
EGY,CHN,2004.0,1,1,0
GAB,DEU,2015.0,2,3,-1
ITA,LBN,2019.0,4,4,0
BEL,CHN,1997.0,2,1,1
GRC,CHN,2016.0,4,1,3
SRB,SWE,2018.0,6,1,5
COL,CAN,2011.0,5,6,-1
GRC,CAN,2022.0,7,5,2
ARE,GBR,2010.0,7,19,-12
EGY,KOR,2018.0,8,10,-2
FRA,IDN,2016.0,14,3,11
TWN,CHE,2015.0,7,6,1
IRL,BHR,2013.0,2,1,1
YEM,MYS,2017.0,4,15,-11
MYS,TWN,2019.0,11,8,3
FRA,MLI,2006.0,5,2,3
ARE,JOR,2013.0,4,12,-8
URY,FRA,2007.0,1,3,-2
CAN,AUT,2012.0,15,18,-3
NLD,ARM,2001.0,1,1,0
SWE,NZL,2010.0,6,7,-1
CAN,PAK,2010.0,6,14,-8
ITA,NOR,2021.0,18,15,3
SWE,EST,2012.0,8,1,7
JPN,ESP,2022.0,10,11,-1
ARE,KWT,2016.0,3,2,1
GBR,ARE,2009.0,19,2,17
IRL,CYP,2017.0,2,1,1
MYS,LKA,2012.0,3,2,1
PAK,ZAF,2018.0,3,2,1
POL,ITA,2004.0,10,7,3
DEU,TWN,2011.0,19,14,5
IND,PHL,2001.0,5,2,3
NZL,PRT,2015.0,2,1,1
JPN,MYS,2004.0,11,3,8
SAU,ITA,2004.0,2,1,1
BEL,GMB,2014.0,1,1,0
BLR,RUS,2000.0,6,7,-1
BGR,FRA,2022.0,1,1,0
ISR,ROU,1999.0,1,1,0
ESP,NOR,2006.0,5,4,1
MEX,CAN,1999.0,3,9,-6
KOR,IRN,2013.0,6,14,-8
HUN,ZAF,2014.0,2,1,1
CHE,JPN,1997.0,6,2,4
TWN,IND,2006.0,13,43,-30
NLD,IRN,2003.0,4,1,3
MYS,IRL,2009.0,1,2,-1
FRA,VEN,2004.0,2,4,-2
BEL,PRT,2007.0,4,3,1
MLT,ITA,2018.0,3,5,-2
USA,UGA,2013.0,16,18,-2
NLD,FIN,2001.0,6,3,3
ITA,NZL,2010.0,3,3,0
CHL,GBR,2009.0,13,22,-9
ESP,FIN,2012.0,17,12,5
AUT,CZE,2012.0,5,8,-3
BRB,JAM,2011.0,1,2,-1
MEX,VEN,2006.0,4,3,1
SRB,AUT,2014.0,3,2,1
ETH,CAN,2015.0,2,1,1
QAT,EGY,2016.0,6,9,-3
IRL,CHE,2010.0,8,11,-3
SWE,SRB,2021.0,1,4,-3
VNM,USA,2013.0,8,29,-21
KEN,ZMB,2016.0,1,2,-1
AUT,POL,2013.0,10,11,-1
ARG,URY,2015.0,7,4,3
USA,RWA,2021.0,6,16,-10
QAT,KOR,2013.0,2,7,-5
SRB,NLD,2006.0,3,2,1
SVK,IND,2020.0,3,5,-2
ITA,BGR,2021.0,3,1,2
CAN,TUR,2006.0,10,12,-2
CZE,LTU,2022.0,2,2,0
LBN,CZE,2021.0,1,1,0
FRA,ARE,2017.0,10,3,7
BRB,CAN,2018.0,1,1,0
LVA,NLD,2010.0,1,1,0
KWT,USA,2013.0,6,10,-4
PAK,TUR,2022.0,9,12,-3
USA,ETH,2011.0,9,9,0
BEL,DNK,2004.0,3,5,-2
GEO,DEU,2005.0,3,5,-2
USA,FJI,2010.0,6,1,5
SWE,ESP,2009.0,24,30,-6
ITA,FIN,2004.0,4,6,-2
USA,OMN,2009.0,4,5,-1
NGA,TTO,2019.0,1,1,0
GHA,AUS,2012.0,2,1,1
IRN,AUT,2009.0,4,2,2
RUS,HUN,2011.0,3,2,1
CHE,COD,2022.0,1,1,0
DEU,NGA,2016.0,8,5,3
SVN,USA,2006.0,10,11,-1
BEL,POL,2006.0,4,8,-4
USA,ARM,2011.0,5,6,-1
PAK,JPN,2007.0,6,9,-3
TWN,BEL,2018.0,4,4,0
JPN,MEX,2017.0,5,12,-7
UKR,BEL,2016.0,2,1,1
USA,PAN,2000.0,1,1,0
BEL,ISR,2014.0,4,6,-2
DEU,MEX,1998.0,4,3,1
USA,SRB,2013.0,12,9,3
CAN,FIN,1999.0,3,4,-1
NLD,CHN,2001.0,6,15,-9
EGY,IRN,2008.0,1,2,-1
GRL,DNK,2004.0,1,7,-6
TWN,MEX,2014.0,1,1,0
VNM,POL,2012.0,6,2,4
DEU,ETH,2017.0,5,8,-3
BRB,GBR,2005.0,3,1,2
USA,NIC,2011.0,1,1,0
PER,MEX,2007.0,2,1,1
AUT,THA,2018.0,4,4,0
NCL,USA,2019.0,2,1,1
MYS,YEM,2020.0,18,4,14
KGZ,RUS,2017.0,2,2,0
URY,ESP,2015.0,5,11,-6
PER,AUS,2021.0,5,1,4
USA,LKA,2013.0,9,17,-8
EST,FIN,2022.0,5,5,0
ESP,CUB,2022.0,5,7,-2
AUT,PRT,2021.0,7,8,-1
GTM,ESP,2014.0,1,1,0
IRL,LBN,2020.0,1,1,0
SVK,USA,2020.0,6,9,-3
YEM,MYS,2019.0,5,20,-15
BEL,SGP,2022.0,1,1,0
GBR,ISL,2001.0,2,3,-1
ESP,DZA,2021.0,4,3,1
CUB,BRA,2004.0,8,2,6
PAK,FRA,2008.0,1,1,0
LKA,GBR,2015.0,8,21,-13
GBR,LSO,2018.0,1,1,0
CHL,CHE,2018.0,10,8,2
PSE,QAT,2022.0,1,1,0
NLD,TWN,2018.0,7,5,2
THA,KHM,2015.0,1,1,0
CHN,IDN,2017.0,2,2,0
FRA,PHL,2002.0,2,1,1
ARG,FRA,2004.0,13,16,-3
COL,ARG,1999.0,4,5,-1
UZB,RUS,2017.0,5,6,-1
SAU,CAN,2002.0,13,19,-6
CHL,COL,2001.0,3,1,2
BDI,FRA,2002.0,2,1,1
CUB,FRA,1998.0,1,1,0
GBR,BWA,2005.0,3,2,1
CHE,MAR,2004.0,1,3,-2
LKA,AUS,2022.0,13,14,-1
FRA,JOR,2007.0,1,2,-1
DNK,ISL,2001.0,3,2,1
USA,ZWE,2004.0,2,6,-4
AUS,TUR,2008.0,5,5,0
SWE,BRA,2001.0,5,6,-1
NZL,DNK,1999.0,1,1,0
MEX,CRI,2004.0,1,1,0
ARE,CYP,2019.0,3,2,1
KNA,USA,2017.0,6,2,4
EGY,AUT,2020.0,2,3,-1
PAK,SAU,2003.0,4,4,0
BEL,AUT,1998.0,1,3,-2
IND,CHN,1999.0,1,1,0
COL,GBR,1999.0,3,2,1
SVN,DEU,1997.0,1,1,0
PRT,NLD,2002.0,6,11,-5
TWN,NZL,2001.0,1,1,0
PAN,BRA,2005.0,1,2,-1
HKG,JPN,2001.0,9,6,3
SGP,RUS,2014.0,2,5,-3
NOR,ISL,2007.0,2,1,1
NZL,RUS,2018.0,1,5,-4
GBR,ZWE,2005.0,1,6,-5
HRV,AUS,2018.0,1,1,0
JPN,LKA,2005.0,4,4,0
USA,CUB,2016.0,3,6,-3
CZE,PRT,2011.0,1,2,-1
ESP,ECU,2004.0,1,2,-1
DEU,SYR,2018.0,2,4,-2
DEU,ETH,2010.0,2,4,-2
CZE,FIN,2013.0,2,2,0
POL,JPN,2013.0,13,30,-17
UKR,FIN,2016.0,5,1,4
USA,MNG,2011.0,1,1,0
CAN,ISL,2007.0,1,1,0
NLD,SVK,2012.0,2,1,1
SRB,ITA,2021.0,5,6,-1
SRB,FRA,2001.0,2,4,-2
PSE,MYS,2019.0,2,8,-6
NLD,NGA,2018.0,6,4,2
PRT,IRL,2014.0,3,3,0
SMR,ITA,2020.0,2,2,0
RUS,UZB,2021.0,4,4,0
SGP,SRB,2016.0,1,3,-2
EGY,LBN,2005.0,1,1,0
IND,RUS,1998.0,3,3,0
LTU,DEU,2022.0,1,4,-3
SYR,GBR,2015.0,5,4,1
HRV,BEL,2014.0,2,1,1
ISR,DNK,2007.0,3,2,1
IDN,ESP,2016.0,1,4,-3
EST,SWE,2008.0,6,10,-4
BEL,THA,2007.0,3,2,1
ARE,SAU,2001.0,2,4,-2
EGY,KWT,2011.0,4,11,-7
SVK,PRT,2014.0,1,1,0
SLV,SVN,2020.0,1,1,0
AUT,NLD,2001.0,3,10,-7
GMB,USA,2004.0,4,2,2
IRL,CHN,2003.0,2,3,-1
NZL,JPN,2013.0,9,14,-5
DEU,URY,2005.0,2,1,1
RUS,JPN,2021.0,3,8,-5
RUS,MAR,2018.0,1,2,-1
NZL,PAK,2014.0,9,6,3
CHL,SWE,2020.0,2,2,0
ZAF,BEL,2008.0,5,7,-2
USA,HRV,2015.0,10,20,-10
TWN,TUR,2018.0,1,7,-6
SAU,NLD,2021.0,4,9,-5
CHE,RWA,2020.0,1,1,0
BEL,PAK,2022.0,1,1,0
NPL,CZE,2020.0,2,1,1
NOR,MYS,2021.0,2,2,0
MAC,CHN,2004.0,1,5,-4
RUS,KGZ,2007.0,1,2,-1
NZL,NOR,2015.0,5,1,4
NOR,CZE,2016.0,4,4,0
BGD,PHL,2020.0,2,1,1
MEX,PAN,2008.0,3,1,2
KOR,PHL,2013.0,7,3,4
VEN,CUB,2008.0,1,1,0
DEU,OMN,2019.0,2,3,-1
USA,GEO,1999.0,1,4,-3
TWN,DEU,2003.0,5,7,-2
LAO,FRA,2007.0,3,1,2
SWE,TUR,2004.0,4,1,3
AUS,ROU,2007.0,2,3,-1
CHL,BEL,2018.0,6,8,-2
JPN,HUN,2015.0,3,10,-7
ISR,GRC,2016.0,4,3,1
IND,HKG,2010.0,3,6,-3
VEN,ESP,1999.0,2,4,-2
IRN,HUN,2015.0,1,1,0
NZL,SAU,2021.0,2,2,0
MEX,ECU,2012.0,2,2,0
ESP,HUN,1999.0,1,1,0
USA,COG,2021.0,1,2,-1
USA,BOL,2011.0,4,4,0
USA,BLR,2016.0,5,2,3
PNG,AUS,2007.0,2,3,-1
CMR,MLI,2007.0,1,1,0
ITA,HUN,2000.0,1,5,-4
IDN,AUS,2005.0,5,14,-9
BEL,BEN,2005.0,3,1,2
ETH,UGA,2020.0,2,1,1
CIV,GBR,2005.0,1,1,0
NZL,ITA,2004.0,2,2,0
DZA,USA,2018.0,4,3,1
PHL,MYS,2019.0,2,2,0
POL,AUS,2004.0,1,5,-4
JPN,BGR,1997.0,1,2,-1
DNK,RUS,2012.0,2,5,-3
FIN,EST,2000.0,3,2,1
ESP,NZL,2013.0,3,5,-2
JAM,CAN,2018.0,5,2,3
AUS,SRB,2015.0,2,3,-1
PRT,NLD,2005.0,7,8,-1
FRA,MYS,2011.0,4,3,1
DEU,LTU,2015.0,4,3,1
PHL,RUS,2011.0,1,1,0
BEL,QAT,2017.0,2,1,1
UGA,NGA,2012.0,1,1,0
CAN,MLT,2005.0,1,1,0
LSO,USA,2021.0,1,1,0
CRI,FRA,2021.0,1,1,0
POL,IRL,2017.0,6,2,4
USA,SDN,2001.0,2,1,1
USA,MWI,2012.0,4,16,-12
DNK,BEL,2006.0,5,3,2
CRI,SWE,2020.0,2,1,1
BFA,NER,2018.0,2,1,1
TUR,POL,2006.0,1,1,0
SRB,BEL,2012.0,2,3,-1
HUN,BEL,2021.0,3,5,-2
PAN,ESP,2014.0,3,2,1
LTU,USA,2008.0,2,7,-5
ITA,ARE,2011.0,2,1,1
RUS,GEO,2002.0,2,3,-1
FRA,KEN,2013.0,1,3,-2
GBR,ZWE,2002.0,4,5,-1
ESP,RUS,2014.0,5,10,-5
SWE,PAK,2007.0,1,3,-2
ITA,UKR,2016.0,2,7,-5
SAU,SGP,2021.0,2,4,-2
MYS,DNK,2013.0,4,2,2
UKR,LTU,2020.0,3,2,1
LBY,EGY,2020.0,3,2,1
SVK,FRA,2022.0,3,2,1
SRB,AUS,2014.0,1,2,-1
CHE,PNG,2004.0,1,1,0
MOZ,USA,2013.0,1,2,-1
MMR,AUS,2015.0,3,2,1
SGP,PHL,2021.0,2,2,0
JOR,CHN,2020.0,1,4,-3
NZL,ZAF,2022.0,1,4,-3
CHE,GEO,2003.0,1,1,0
SWE,QAT,2022.0,1,1,0
USA,FJI,2019.0,2,1,1
DNK,LVA,2018.0,1,1,0
LAO,KOR,2020.0,1,1,0
ETH,IRN,2020.0,2,7,-5
CZE,DNK,2021.0,1,5,-4
CAN,UKR,2021.0,1,4,-3
KEN,AUT,2019.0,1,2,-1
SWE,TWN,2003.0,1,3,-2
SVN,CHE,2007.0,1,1,0
RUS,VNM,2004.0,1,1,0
CUB,MOZ,2001.0,1,2,-1
VNM,THA,2016.0,1,8,-7
IND,EGY,2017.0,2,3,-1
IRL,THA,2022.0,1,1,0
CHL,VEN,2013.0,3,4,-1
JOR,DZA,2011.0,1,1,0
POL,EGY,2020.0,1,2,-1
MDA,TUR,2011.0,1,1,0
JPN,UZB,2008.0,1,1,0
GEO,DEU,2002.0,1,3,-2
AUT,BGR,2009.0,1,1,0
DNK,BRA,2009.0,3,5,-2
JPN,CUB,2007.0,1,1,0
NZL,LKA,2013.0,1,5,-4
HUN,IRN,2011.0,1,1,0
ITA,VNM,2007.0,1,1,0
LTU,AUS,2017.0,1,1,0
MYS,NZL,2009.0,3,5,-2
KOR,FIN,2018.0,1,5,-4
SWE,SAU,2015.0,3,4,-1
ISL,FRA,2022.0,1,4,-3
ALB,ROU,2014.0,1,1,0
POL,LTU,2015.0,1,2,-1
IRL,TWN,2019.0,1,1,0
SWE,HKG,2022.0,1,4,-3
GBR,ZMB,2020.0,3,6,-3
ITA,DZA,2011.0,2,1,1
MKD,USA,2013.0,3,3,0
TWN,CZE,2016.0,2,2,0
SEN,BFA,2008.0,1,4,-3
BLR,SWE,2005.0,2,1,1
COL,NLD,2007.0,1,2,-1
IRN,SWE,2006.0,3,7,-4
ISR,NZL,2020.0,2,1,1
CHE,PSE,2020.0,2,1,1
ARG,ECU,2020.0,1,10,-9
GBR,FLK,2017.0,1,2,-1
DEU,URY,2002.0,1,1,0
MOZ,DEU,2018.0,1,1,0
BEL,CHN,1998.0,2,2,0
QAT,PAK,2022.0,2,3,-1
HKG,DEU,2006.0,7,5,2
IRN,OMN,2017.0,3,1,2
VNM,ITA,2017.0,1,9,-8
CHE,SVK,2003.0,1,4,-3
HUN,JPN,1999.0,3,3,0
JPN,ARG,2003.0,1,2,-1
IDN,ITA,2011.0,1,5,-4
PSE,MYS,2010.0,3,1,2
NOR,BGR,2017.0,3,1,2
YEM,MYS,2010.0,2,5,-3
BRA,GRC,2012.0,1,2,-1
HUN,CAN,2022.0,1,1,0
PRI,GBR,2015.0,3,1,2
CAN,PRT,2000.0,1,1,0
BFA,USA,2003.0,1,1,0
ITA,NZL,2019.0,3,7,-4
FRA,LTU,2021.0,1,3,-2
HUN,NZL,2016.0,1,2,-1
KEN,AUT,2017.0,2,1,1
PER,DEU,2009.0,1,1,0
NOR,NPL,2018.0,2,3,-1
USA,TZA,2004.0,1,5,-4
NCL,AUS,2006.0,2,1,1
GBR,URY,2013.0,2,3,-1
AUS,MCO,2015.0,1,1,0
SVN,DEU,1998.0,1,1,0
JPN,SDN,2013.0,1,1,0
EGY,BHR,2008.0,1,1,0
ETH,JPN,2015.0,1,3,-2
HRV,NOR,2014.0,1,1,0
POL,BGR,2001.0,1,3,-2
JOR,CAN,2001.0,2,2,0
MAR,CAN,2022.0,3,4,-1
CAN,CRI,2018.0,2,2,0
ETH,DNK,2020.0,1,2,-1
ZAF,DNK,2021.0,1,2,-1
CZE,HRV,2016.0,1,2,-1
ALB,ITA,2016.0,1,5,-4
SVN,NZL,2014.0,1,1,0
GBR,JAM,2015.0,2,1,1
ZAF,MAR,2020.0,3,2,1
SVK,RUS,2016.0,1,3,-2
LVA,USA,2004.0,1,2,-1
CUB,PRT,2010.0,1,2,-1
FIN,UKR,2000.0,1,1,0
RUS,GEO,2005.0,2,4,-2
ZWE,AUS,2018.0,1,2,-1
ISR,CHE,2000.0,1,5,-4
ISR,BEL,1999.0,2,3,-1
UKR,ISR,2006.0,1,2,-1
JOR,ITA,2022.0,1,3,-2
ECU,CHL,2010.0,1,2,-1
BLR,ISR,2007.0,1,1,0
HUN,KOR,2018.0,1,3,-2
SEN,CHN,2015.0,1,1,0
VEN,PER,2012.0,1,1,0
ZAF,MYS,2016.0,1,5,-4
SYR,IND,2021.0,1,3,-2
GRC,MEX,2020.0,1,1,0
BEL,RUS,1997.0,2,4,-2
BRA,ETH,2019.0,1,1,0
ETH,TWN,2022.0,1,6,-5
BEN,CAN,2019.0,1,1,0
CHE,IDN,2018.0,1,1,0
FRA,BRA,2009.0,70,78,-8
MLI,USA,2008.0,2,1,1
JPN,USA,2012.0,810,831,-21
UKR,USA,2007.0,25,18,7
USA,CZE,2021.0,36,42,-6
JPN,BGD,2014.0,60,42,18
IND,JPN,2009.0,80,63,17
BRN,BGD,2016.0,3,4,-1
FIN,SWE,2009.0,27,41,-14
GBR,MYS,2014.0,135,64,71
LBN,ARE,2021.0,7,1,6
DEU,POL,2014.0,70,164,-94
JPN,GBR,2012.0,86,122,-36
NGA,BRA,2007.0,1,1,0
CAN,THA,2016.0,26,11,15
DEU,GBR,2001.0,290,290,0
DNK,USA,2014.0,131,133,-2
CZE,SVK,2000.0,10,8,2
UGA,GBR,2016.0,38,9,29
USA,BRA,2016.0,370,471,-101
AUS,JPN,1998.0,9,8,1
CHN,FRA,2007.0,43,37,6
HKG,IND,2022.0,8,11,-3
NOR,DNK,2017.0,20,48,-28
AUS,MYS,2019.0,94,139,-45
PRT,BRA,2011.0,75,69,6
IND,RWA,2018.0,2,1,1
CHN,CHE,2006.0,13,15,-2
CHL,BRA,2018.0,11,43,-32
NOR,DNK,2019.0,33,58,-25
RWA,KEN,2020.0,3,4,-1
EGY,USA,2021.0,84,92,-8
AUT,CHE,2005.0,31,29,2
CZE,RUS,2016.0,17,9,8
DEU,VNM,2016.0,16,3,13
AUS,DNK,2014.0,26,18,8
THA,GBR,2010.0,19,53,-34
JPN,IND,2009.0,63,80,-17
ZAF,AUS,2004.0,23,19,4
FIN,ZAF,2015.0,4,3,1
DNK,CAN,2001.0,6,9,-3
AUS,BEL,2013.0,10,26,-16
USA,ECU,2015.0,33,9,24
MLI,GMB,2020.0,1,1,0
NPL,IDN,2018.0,1,1,0
ITA,COL,2021.0,4,10,-6
NLD,PRT,2020.0,20,27,-7
KAZ,CAN,2018.0,3,5,-2
GBR,KEN,2010.0,16,18,-2
DEU,PRT,2006.0,26,14,12
FJI,NZL,2011.0,3,1,2
GTM,CHE,2022.0,1,1,0
ARM,RUS,2006.0,2,3,-1
USA,NOR,2000.0,25,13,12
NLD,RUS,2003.0,10,17,-7
AUS,NLD,2003.0,35,31,4
ESP,VEN,2008.0,11,14,-3
GRC,CHE,2010.0,21,9,12
CAN,CZE,2007.0,5,9,-4
FRA,MDG,2000.0,4,3,1
ITA,HRV,2012.0,7,3,4
GBR,CHL,2017.0,52,40,12
ESP,JPN,2009.0,12,16,-4
URY,USA,2013.0,8,9,-1
BRA,NLD,2014.0,24,25,-1
SRB,HRV,2001.0,5,1,4
OMN,GBR,2007.0,4,14,-10
DNK,THA,2004.0,3,2,1
FIN,RUS,2009.0,9,14,-5
SVN,GBR,2015.0,10,5,5
MYS,PAK,2010.0,5,13,-8
ISR,KOR,2004.0,2,1,1
BGD,THA,2006.0,2,1,1
SEN,FRA,2021.0,17,14,3
HKG,SGP,2014.0,31,18,13
DEU,ETH,2019.0,9,2,7
COL,ITA,2016.0,5,11,-6
SWE,ZAF,2020.0,9,11,-2
POL,BEL,2021.0,3,8,-5
MDG,FRA,2018.0,12,16,-4
SAU,BGD,2015.0,2,8,-6
PAK,SWE,2019.0,5,12,-7
POL,IRL,2019.0,4,2,2
SWE,LTU,2017.0,3,4,-1
GRC,CHE,2017.0,31,10,21
SWE,CHE,2021.0,31,46,-15
MYS,BRN,2014.0,6,7,-1
GBR,SDN,2020.0,4,3,1
FRA,ARG,2013.0,24,32,-8
TWN,HKG,2014.0,13,10,3
CAN,GHA,2013.0,5,4,1
ITA,CHL,2007.0,2,7,-5
SAU,IND,2003.0,3,4,-1
NOR,DNK,2010.0,16,23,-7
SDN,DEU,2006.0,4,4,0
ZWE,GBR,1999.0,6,2,4
VNM,FRA,2003.0,5,4,1
TZA,JPN,2002.0,4,5,-1
KOR,EGY,2007.0,3,3,0
IND,HKG,2017.0,16,5,11
CAN,VEN,2000.0,3,1,2
USA,IDN,2006.0,13,11,2
DEU,OMN,2017.0,5,3,2
IND,HKG,2019.0,11,15,-4
SAU,GBR,2004.0,7,26,-19
CHN,TUN,2020.0,2,7,-5
MWI,FIN,2019.0,1,1,0
CHE,JPN,1998.0,10,1,9
IRL,MYS,2009.0,2,1,1
FRA,CUB,2015.0,4,6,-2
SWE,IND,2007.0,10,10,0
SWE,ARG,2015.0,3,3,0
KOR,UZB,2018.0,2,2,0
SRB,CZE,2014.0,2,1,1
USA,BFA,2018.0,2,2,0
ZAF,BGR,2014.0,1,1,0
ZAF,NZL,2022.0,4,1,3
HKG,NLD,2012.0,7,3,4
SWE,LTU,2010.0,5,3,2
SAU,OMN,2013.0,3,3,0
GEO,GBR,2008.0,1,2,-1
KEN,NLD,2009.0,1,3,-2
NLD,BGD,2008.0,1,3,-2
ROU,CAN,2008.0,5,2,3
LVA,NLD,2017.0,1,1,0
TUR,JOR,2021.0,3,3,0
ITA,LBN,2010.0,1,1,0
KWT,EGY,2002.0,2,4,-2
AUT,TWN,2020.0,2,3,-1
PRY,USA,2018.0,3,2,1
NOR,KOR,2011.0,3,3,0
POL,NLD,2022.0,5,7,-2
NZL,CHE,2006.0,4,6,-2
CAN,ZWE,2017.0,1,1,0
GBR,ECU,2021.0,1,2,-1
OMN,AUS,2009.0,5,5,0
SAU,CHE,2014.0,2,5,-3
TZA,CHE,2005.0,1,3,-2
ECU,AUS,2018.0,2,2,0
JPN,MEX,2010.0,5,5,0
BRA,HRV,2001.0,1,1,0
NCL,PYF,2018.0,2,1,1
JPN,LKA,2002.0,2,3,-1
EST,CHE,2015.0,3,1,2
SWE,BFA,2009.0,1,1,0
LTU,SWE,2006.0,3,4,-1
BFA,CIV,2006.0,1,4,-3
KWT,JOR,2021.0,1,2,-1
AUT,MAR,2014.0,1,1,0
BGR,DEU,2018.0,2,14,-12
ASM,USA,2011.0,1,1,0
DZA,AUS,2018.0,1,1,0
PSE,ZAF,2017.0,1,1,0
KGZ,TUR,2020.0,1,3,-2
UGA,SWE,2007.0,1,2,-1
NLD,EST,2012.0,1,1,0
TWN,VNM,2009.0,1,2,-1
AUS,,2024.0,69355,0,69355
CHE,,2018.0,4088,0,4088
,PRT,1996.0,692,0,692
,MAR,2011.0,1004,0,1004
,CHN,2014.0,163435,0,163435
BEL,,2009.0,1402,0,1402
KOR,,2014.0,7895,0,7895
KAZ,,2024.0,3446,0,3446
,PRT,2004.0,1987,0,1987
,DEU,1994.0,21362,0,21362
,MEX,1999.0,3497,0,3497
,IRN,2007.0,8607,0,8607
PAK,,2016.0,1260,0,1260
CZE,,2012.0,1061,0,1061
CAN,,2014.0,7833,0,7833
ROU,,2011.0,648,0,648
TWN,,2012.0,3961,0,3961
,ARG,2003.0,1881,0,1881
MEX,,2020.0,4771,0,4771
CHN,,2000.0,1464,0,1464
,ITA,1994.0,16310,0,16310
,COL,2002.0,564,0,564
,UGA,2008.0,233,0,233
JPN,,1999.0,1289,0,1289
VNM,,2024.0,7718,0,7718
SVK,EST,2009.0,1,0,1
,GBR,2010.0,20325,0,20325
TUR,,2014.0,3072,0,3072
HRV,,2009.0,308,0,308
,CHE,2008.0,3912,0,3912
,CAN,2016.0,12146,0,12146
ZAF,,2016.0,1184,0,1184
EGY,,2011.0,504,0,504
,AUS,2011.0,9461,0,9461
,FRA,2012.0,15067,0,15067
UZB,,2023.0,755,0,755
CHL,,2008.0,379,0,379
,IRL,2012.0,1676,0,1676
IND,,2000.0,447,0,447
LAO,,2018.0,22,0,22
CUB,,2012.0,446,0,446
PHL,,2019.0,349,0,349
GEO,,2015.0,64,0,64
GRC,,2005.0,470,0,470
PHL,,2010.0,72,0,72
,GBR,2019.0,11147,0,11147
MDA,,2020.0,75,0,75
,NOR,2016.0,1937,0,1937
ARG,,2006.0,535,0,535
,COL,2005.0,944,0,944
CYP,,2021.0,286,0,286
,TJK,1995.0,11,0,11
SEN,,2024.0,641,0,641
TUN,,2018.0,1044,0,1044
,ZAF,2013.0,2425,0,2425
URY,,2015.0,70,0,70
LVA,,2012.0,47,0,47
,SGP,2011.0,2193,0,2193
ALB,,2022.0,124,0,124
,GBR,2017.0,19073,0,19073
,LTU,2008.0,559,0,559
,MDA,2010.0,64,0,64
,EST,2011.0,364,0,364
,EGY,2018.0,4033,0,4033
PHL,,2017.0,243,0,243
CZE,EGY,2008.0,3,0,3
PRY,FIN,2016.0,1,0,1
,LVA,2006.0,238,0,238
VNM,ITA,2010.0,2,0,2
GTM,,2023.0,148,0,148
MWI,,2019.0,87,0,87
COL,,2025.0,9,0,9
POL,SAU,2001.0,1,0,1
BWA,SWZ,2018.0,1,0,1
,GHA,2007.0,221,0,221
,MDA,2017.0,43,0,43
WSM,,2024.0,31,0,31
,MLT,2013.0,99,0,99
BGD,AUT,2005.0,2,0,2
,MDA,2019.0,11,0,11
CHN,KEN,2009.0,3,0,3
PRK,,2020.0,17,0,17
,COD,2015.0,32,0,32
,CRI,2009.0,109,0,109
MDA,RUS,2021.0,4,0,4
ITA,PSE,2019.0,2,0,2
PHL,SAU,2021.0,1,0,1
,ETH,2016.0,1151,0,1151
PER,IND,2021.0,1,0,1
ARG,ROU,2018.0,1,0,1
SGP,OMN,2013.0,3,0,3
,BFA,2016.0,92,0,92
,BIH,2018.0,181,0,181
KHM,,2022.0,100,0,100
BWA,,2013.0,43,0,43
,GIN,2016.0,11,0,11
,PLW,2018.0,2,0,2
,ECU,2009.0,80,0,80
IND,JOR,2007.0,3,0,3
,SVN,2011.0,733,0,733
,MKD,2015.0,122,0,122
GRC,,2002.0,62,0,62
USA,CPV,2016.0,1,0,1
GIN,,2011.0,5,0,5
PRT,KWT,2016.0,1,0,1
,PYF,1999.0,13,0,13
CAN,PAN,2018.0,1,0,1
BGD,BRN,2013.0,2,0,2
ZMB,,2020.0,91,0,91
SLE,,2018.0,18,0,18
BEL,TUN,2018.0,6,0,6
BLZ,,2024.0,18,0,18
HUN,THA,2022.0,1,0,1
,KEN,1994.0,109,0,109
NER,KEN,2001.0,1,0,1
,HTI,2014.0,23,0,23
COL,NOR,2022.0,4,0,4
CMR,,2009.0,46,0,46
AZE,,2009.0,39,0,39
GBR,GUF,2017.0,1,0,1
MLI,,2014.0,28,0,28
BIH,,2014.0,91,0,91
GRC,PSE,2012.0,1,0,1
MWI,,2017.0,34,0,34
CMR,KEN,2009.0,2,0,2
POL,DZA,2006.0,1,0,1
,TTO,1995.0,19,0,19
,GTM,1999.0,15,0,15
LBN,,2008.0,72,0,72
NGA,KOR,2007.0,1,0,1
NLD,ERI,2006.0,2,0,2
UZB,BLR,2013.0,1,0,1
SWE,,2000.0,95,0,95
,MWI,2009.0,98,0,98
SYR,,2005.0,14,0,14
CAN,BHS,2013.0,1,0,1
EST,,2003.0,22,0,22
RWA,MWI,2016.0,1,0,1
PRT,,2001.0,26,0,26
GHA,GNB,2015.0,2,0,2
BFA,BEN,2014.0,1,0,1
KEN,AUT,2010.0,2,0,2
FRA,ECU,2012.0,2,0,2
PER,AUT,2007.0,1,0,1
POL,NGA,2017.0,1,0,1
BRA,TWN,2004.0,1,0,1
SVN,SVK,2001.0,3,0,3
MCO,,2015.0,5,0,5
,MCO,1995.0,3,0,3
PYF,CHE,2014.0,1,0,1
VEN,KWT,2000.0,1,0,1
,MSR,1999.0,2,0,2
BRA,PAN,2001.0,1,0,1
TWN,BRA,2011.0,1,0,1
MEX,CHE,1999.0,1,0,1
FRA,BOL,1998.0,2,0,2
POL,CZE,1999.0,2,0,2
AUS,KAZ,2004.0,1,0,1
BGD,ARE,2012.0,1,0,1
NCL,USA,2010.0,1,0,1
BFA,GHA,2014.0,1,0,1
DZA,IRN,2020.0,1,0,1
PHL,BRN,2016.0,1,0,1
IND,PNG,2016.0,1,0,1
AFG,,2017.0,9,0,9
TJK,IRN,2016.0,2,0,2
IRL,JAM,2017.0,1,0,1
NPL,NZL,2021.0,2,0,2
ESP,CYP,2015.0,2,0,2
DEU,PRK,2020.0,1,0,1
PSE,SWE,2014.0,1,0,1
,GNQ,2009.0,3,0,3
DNK,SAU,2012.0,1,0,1
EST,AUT,2022.0,2,0,2
ITA,ISL,2014.0,2,0,2
NER,GHA,2020.0,1,0,1
SVN,,2003.0,56,0,56
CAN,NGA,2006.0,1,0,1
MCO,USA,2022.0,1,0,1
BLR,BRA,2000.0,2,0,2
QAT,IRQ,2015.0,1,0,1
MDG,,2005.0,8,0,8
ROU,ESP,2007.0,5,0,5
AUS,MMR,2017.0,1,0,1
DEU,LKA,2020.0,1,0,1
GNB,GMB,2008.0,1,0,1
DEU,COG,2010.0,2,0,2
IND,LTU,2021.0,1,0,1
SEN,CMR,2019.0,4,0,4
SWE,VNM,2013.0,2,0,2
,GUF,2013.0,9,0,9
IND,EST,2013.0,2,0,2
BEL,BFA,2018.0,4,0,4
TWN,IRL,2022.0,1,0,1
ESP,GTM,2005.0,3,0,3
CUB,COL,2021.0,2,0,2
BWA,BEN,2019.0,1,0,1
IDN,SGP,2002.0,1,0,1
EGY,IDN,2022.0,2,0,2
EGY,PSE,2003.0,6,0,6
MUS,,2005.0,3,0,3
SWE,KEN,2005.0,2,0,2
ZMB,GBR,2004.0,2,0,2
BLR,MNE,2000.0,1,0,1
BRA,UKR,2015.0,1,0,1
YEM,EGY,2004.0,1,0,1
SDN,SAU,2000.0,2,0,2
LBN,SYR,2005.0,1,0,1
MDA,BEL,1999.0,2,0,2
LTU,RUS,2007.0,2,0,2
NGA,CIV,2019.0,2,0,2
AUT,TUR,2004.0,2,0,2
ZMB,CZE,1998.0,1,0,1
KNA,,2004.0,1,0,1
DEU,MNG,2006.0,1,0,1
LBN,POL,2007.0,1,0,1
ITA,PAN,2022.0,1,0,1
IDN,NZL,2002.0,1,0,1
KEN,,2003.0,15,0,15
PER,FIN,2008.0,1,0,1
TWN,COL,2015.0,2,0,2
TCD,,2009.0,2,0,2
AUT,NPL,2007.0,1,0,1
NLD,NPL,2008.0,1,0,1
SWE,MYS,2003.0,1,0,1
MWI,,2010.0,11,0,11
CHE,LVA,2006.0,1,0,1
KEN,DNK,2007.0,1,0,1
POL,IND,2005.0,3,0,3
COM,,2015.0,1,0,1
CHE,MYS,2008.0,2,0,2
BEL,GHA,2009.0,2,0,2
DEU,SWZ,2011.0,1,0,1
FIN,PSE,2016.0,1,0,1
ARE,IRN,2016.0,2,0,2
TWN,NOR,2013.0,2,0,2
HUN,EST,2018.0,1,0,1
SWE,IDN,2016.0,4,0,4
PRT,EST,2020.0,1,0,1
GHA,COG,2014.0,1,0,1
UKR,IRQ,2018.0,1,0,1
JOR,SAU,1998.0,2,0,2
MEX,NIC,2019.0,1,0,1
HRV,MNE,2021.0,1,0,1
TUR,TWN,2008.0,3,0,3
MYS,QAT,2013.0,3,0,3
JOR,,2003.0,12,0,12
LUX,,2004.0,6,0,6
AUS,NCL,2011.0,1,0,1
UKR,NLD,2006.0,3,0,3
MCO,CAN,2018.0,1,0,1
IRN,OMN,2019.0,4,0,4
CHL,NOR,2006.0,4,0,4
HKG,SVN,2020.0,1,0,1
TUN,AUS,2013.0,1,0,1
LBN,DEU,2022.0,2,0,2
USA,AIA,2022.0,3,0,3
,FSM,1999.0,4,0,4
,REU,2008.0,9,0,9
ESP,PNG,2010.0,1,0,1
ESP,PNG,2017.0,1,0,1
BGR,ROU,2012.0,1,0,1
MAR,PRT,2013.0,1,0,1
MAC,CHE,2017.0,1,0,1
GBR,BRN,2016.0,9,0,9
ISR,BHS,2015.0,1,0,1
BRA,AZE,2019.0,1,0,1
MMR,CHE,2020.0,2,0,2
,GUY,2016.0,3,0,3
ZAF,MUS,2021.0,3,0,3
TGO,CIV,2015.0,1,0,1
DNK,UGA,2013.0,1,0,1
THA,GHA,2018.0,2,0,2
SWE,SDN,2014.0,1,0,1
CAF,COD,2021.0,1,0,1
HUN,UKR,2002.0,1,0,1
SWZ,,2013.0,5,0,5
USA,BHS,2011.0,1,0,1
CAF,,2016.0,7,0,7
USA,LBY,2014.0,3,0,3
MDG,,2002.0,2,0,2
FRA,ARE,2010.0,5,0,5
SGP,MAC,2015.0,5,0,5
BGR,CZE,2013.0,2,0,2
ZAF,ESP,2008.0,3,0,3
MAR,EGY,2020.0,3,0,3
KEN,MEX,2002.0,1,0,1
GUF,GUY,2003.0,1,0,1
AUS,BRN,1998.0,1,0,1
CAN,BRN,2003.0,1,0,1
NOR,LUX,2021.0,2,0,2
ISR,SVN,2002.0,3,0,3
VEN,AUS,2011.0,1,0,1
LIE,,2012.0,6,0,6
GBR,MAC,2001.0,1,0,1
BEL,NOR,2000.0,2,0,2
BEL,GUF,2010.0,1,0,1
,SYC,2002.0,2,0,2
PRT,BOL,2020.0,1,0,1
AUT,LTU,2013.0,1,0,1
FRA,NIC,2005.0,1,0,1
ETH,LBN,2019.0,1,0,1
CHE,ARE,2005.0,2,0,2
RWA,COG,2018.0,1,0,1
LUX,RWA,2014.0,1,0,1
AUT,ZAF,2009.0,2,0,2
CHN,GIN,2014.0,1,0,1
GBR,COG,2012.0,1,0,1
BGD,POL,2019.0,1,0,1
KOR,MOZ,2018.0,1,0,1
DZA,GBR,1999.0,1,0,1
ISR,FIN,2006.0,1,0,1
BEL,SRB,2007.0,4,0,4
KAZ,KGZ,2016.0,3,0,3
ITA,ALB,2004.0,1,0,1
SVN,VNM,2017.0,1,0,1
SYR,CAN,2015.0,2,0,2
CUB,JPN,2010.0,2,0,2
ETH,SEN,2014.0,1,0,1
SAU,MLT,2010.0,1,0,1
,AGO,2004.0,4,0,4
IRL,ARG,2012.0,1,0,1
KOR,NPL,2004.0,1,0,1
KNA,USA,2019.0,1,0,1
MDG,SEN,2012.0,1,0,1
CHN,SRB,2020.0,2,0,2
ROU,BEL,2000.0,2,0,2
GBR,DZA,2011.0,2,0,2
PAN,VEN,2014.0,1,0,1
HKG,CYP,2004.0,1,0,1
EGY,FIN,2006.0,1,0,1
KGZ,DEU,2006.0,1,0,1
AUS,MWI,2012.0,1,0,1
BLR,KOR,2004.0,1,0,1
LAO,CHE,2008.0,1,0,1
IND,TON,2015.0,1,0,1
HUN,EGY,2000.0,1,0,1
FIN,THA,2016.0,1,0,1
KOR,CMR,2017.0,2,0,2
,FRO,2011.0,4,0,4
UZB,DNK,2018.0,1,0,1
MAR,YEM,2022.0,1,0,1
NAM,SWE,2019.0,1,0,1
JOR,IDN,2020.0,2,0,2
CHE,FIN,2000.0,2,0,2
TUR,DZA,2022.0,1,0,1
PHL,TUR,2021.0,1,0,1
UZB,NLD,2019.0,2,0,2
IND,AIA,2018.0,1,0,1
BLR,SWE,2002.0,3,0,3
AZE,JPN,1999.0,1,0,1
CUB,VEN,1998.0,1,0,1
AUS,BRN,1997.0,1,0,1
RUS,URY,2006.0,1,0,1
AFG,,2010.0,1,0,1
JPN,LBY,2013.0,1,0,1
CHN,IDN,2010.0,3,0,3
ITA,GIN,2017.0,1,0,1
MYS,AUT,2019.0,2,0,2
GHA,MCO,2017.0,1,0,1
CHE,THA,2003.0,1,0,1
BFA,TUN,2020.0,2,0,2
ZMB,ZAF,1999.0,1,0,1
MAR,IRN,2009.0,1,0,1
ROU,IRQ,2022.0,1,0,1
THA,PRT,2006.0,1,0,1
MNG,AUT,2008.0,1,0,1
DEU,COG,2017.0,1,0,1
LKA,KWT,2008.0,1,0,1
IND,WSM,2018.0,1,0,1
SYR,JOR,2014.0,2,0,2
SAU,BGR,2021.0,2,0,2
TUR,HUN,2003.0,1,0,1
DEU,OMN,2010.0,2,0,2
EGY,OMN,1998.0,1,0,1
DNK,UKR,2009.0,1,0,1
UKR,DNK,2012.0,2,0,2
SWE,KEN,2002.0,3,0,3
COG,PRT,2016.0,1,0,1
ABW,GBR,2006.0,1,0,1
LAO,PHL,2006.0,1,0,1
ROU,KWT,2003.0,1,0,1
NZL,EGY,2002.0,1,0,1
FIN,KEN,2001.0,1,0,1
BHS,,2013.0,3,0,3
RUS,LVA,2022.0,2,0,2
SEN,MLI,2003.0,1,0,1
BIH,FRA,2003.0,1,0,1
GUM,CHN,2011.0,1,0,1
SEN,ETH,2018.0,1,0,1
KHM,COL,2017.0,1,0,1
AUT,UGA,2014.0,1,0,1
GNQ,,2015.0,1,0,1
AFG,,2019.0,4,0,4
KHM,COL,2010.0,1,0,1
SVK,BRA,2022.0,1,0,1
HRV,ESP,2005.0,1,0,1
BGD,IRL,2020.0,3,0,3
MEX,DZA,2015.0,1,0,1
GMB,GHA,2007.0,1,0,1
NGA,PRT,2003.0,1,0,1
TZA,DNK,2010.0,1,0,1
MAC,CAN,2007.0,1,0,1
ITA,PSE,2017.0,2,0,2
MYS,AUT,2010.0,1,0,1
FRA,VUT,2017.0,1,0,1
FIN,UGA,2021.0,1,0,1
,LCA,2016.0,1,0,1
HRV,KOR,2020.0,2,0,2
SWE,CUB,2004.0,1,0,1
SWZ,CHE,2011.0,1,0,1
AFG,GBR,2013.0,3,0,3
IRL,SLE,2013.0,1,0,1
,ERI,2012.0,3,0,3
SVN,ZWE,2020.0,1,0,1
UKR,MEX,2000.0,5,0,5
NZL,THA,2012.0,3,0,3
SVN,JPN,2001.0,3,0,3
ETH,MLI,2015.0,1,0,1
EST,JPN,1997.0,1,0,1
KWT,SWE,2013.0,1,0,1
CHE,BLR,2012.0,1,0,1
HND,FRA,2017.0,1,0,1
ARM,ISR,2012.0,2,0,2
POL,CUB,2015.0,1,0,1
GUY,USA,2020.0,1,0,1
LVA,SAU,2019.0,1,0,1
SLB,CHE,2002.0,1,0,1
LBN,OMN,2022.0,2,0,2
MMR,CAN,2022.0,1,0,1
ETH,AUT,2008.0,1,0,1
ISL,SGP,2022.0,1,0,1
PYF,,2006.0,2,0,2
,SSD,2011.0,1,0,1
THA,KEN,2002.0,1,0,1
AUS,MMR,2019.0,5,0,5
CUB,CRI,2011.0,1,0,1
EGY,HKG,2011.0,2,0,2
JOR,OMN,2002.0,1,0,1
DEU,BTN,2022.0,1,0,1
KOR,MNG,2014.0,4,0,4
ZAF,AIA,2013.0,1,0,1
TWN,ARE,2014.0,2,0,2
IRL,TWN,2017.0,1,0,1
CUB,PRT,2017.0,2,0,2
PHL,MWI,2016.0,1,0,1
IRL,LTU,2019.0,1,0,1
MWI,MYS,2021.0,1,0,1
IDN,PRT,2021.0,1,0,1
BGD,EGY,2000.0,1,0,1
VUT,WSM,2020.0,1,0,1
SYR,,2002.0,1,0,1
EGY,ISR,2008.0,1,0,1
IND,ISL,2017.0,1,0,1
AIA,NGA,2016.0,1,0,1
RUS,VEN,2004.0,1,0,1
DEU,KGZ,2003.0,1,0,1
UZB,PRT,2013.0,1,0,1
CZE,ROU,2007.0,1,0,1
AZE,ITA,2007.0,1,0,1
LIE,AUT,2005.0,1,0,1
POL,SRB,2004.0,1,0,1
IND,CIV,2002.0,1,0,1
KEN,GHA,2019.0,2,0,2
NER,CMR,2017.0,1,0,1
UKR,HRV,2015.0,1,0,1
CIV,EGY,2011.0,1,0,1
BGR,MKD,2013.0,1,0,1
ARG,BEL,2015.0,4,0,4
EGY,MEX,2016.0,1,0,1
MYS,AUT,2017.0,1,0,1
ESP,MNG,2019.0,1,0,1
MDG,BRA,2016.0,2,0,2
LBN,KEN,2017.0,1,0,1
BFA,DEU,2011.0,1,0,1
CIV,MLI,2013.0,3,0,3
IND,EGY,2019.0,3,0,3
MNE,,2003.0,1,0,1
NOR,PRI,2003.0,1,0,1
IRL,LBY,2019.0,1,0,1
USA,GLP,2007.0,1,0,1
LTU,TWN,2018.0,1,0,1
IND,MUS,2012.0,1,0,1
TWN,MMR,2020.0,1,0,1
KNA,GBR,2021.0,1,0,1
EGY,KEN,2015.0,1,0,1
GBR,PNG,2003.0,1,0,1
IRL,SVK,2005.0,1,0,1
IRN,ARE,2006.0,1,0,1
IND,ISL,2010.0,1,0,1
USA,MTQ,2012.0,1,0,1
MYS,PAN,2009.0,1,0,1
KAZ,USA,1999.0,1,0,1
KEN,GMB,2002.0,1,0,1
AUT,LBN,2011.0,1,0,1
ITA,ETH,2011.0,2,0,2
MSR,TTO,2015.0,1,0,1
LVA,DNK,2013.0,1,0,1
USA,AFG,2008.0,1,0,1
,SOM,2007.0,3,0,3
CMR,IRN,2010.0,1,0,1
CUB,ZAF,2018.0,2,0,2
SAU,IRQ,2009.0,1,0,1
MDG,KHM,2009.0,1,0,1
BTN,USA,2008.0,1,0,1
TUR,BGR,2022.0,1,0,1
EGY,ISL,2017.0,1,0,1
BHS,GBR,2011.0,1,0,1
,SYC,2005.0,2,0,2
FJI,BHR,2021.0,1,0,1
ECU,AUT,2011.0,1,0,1
RUS,GRC,2009.0,1,0,1
GMB,BEL,2015.0,1,0,1
MNG,GBR,2010.0,1,0,1
AUS,UZB,2002.0,1,0,1
EST,NLD,2007.0,1,0,1
BRA,TUN,2020.0,1,0,1
PHL,MYS,2010.0,1,0,1
FRA,PHL,2005.0,1,0,1
CIV,CAN,2011.0,2,0,2
QAT,SEN,2017.0,1,0,1
MKD,AUS,2006.0,2,0,2
BEN,CAN,2017.0,1,0,1
CHN,ECU,2015.0,1,0,1
SWZ,TWN,2016.0,1,0,1
PRI,MEX,2011.0,1,0,1
NZL,PHL,2022.0,1,0,1
CHE,SVN,1998.0,1,0,1
MLI,NLD,2008.0,1,0,1
,MHL,2016.0,1,0,1
DEU,YEM,2003.0,1,0,1
KEN,PHL,2021.0,1,0,1
CAN,YEM,2016.0,1,0,1
ITA,CIV,2011.0,1,0,1
BGR,KWT,2010.0,1,0,1
DEU,DZA,2001.0,1,0,1
BOL,BRA,2005.0,1,0,1
POL,TUR,2004.0,1,0,1
FIN,LBY,2012.0,2,0,2
SVK,KEN,2006.0,1,0,1
UZB,NLD,2017.0,1,0,1
JPN,BHR,2018.0,1,0,1
ISR,LKA,2015.0,1,0,1
GRC,ISL,2001.0,1,0,1
PAK,KAZ,2014.0,1,0,1
KOR,LTU,2011.0,1,0,1
HUN,IND,2004.0,2,0,2
AUT,LIE,2003.0,1,0,1
IND,GRC,2005.0,1,0,1
SWE,ARM,2021.0,1,0,1
GUM,ESP,2013.0,1,0,1
DNK,TWN,2015.0,1,0,1
LTU,IRN,2005.0,1,0,1
ARM,CAN,2020.0,1,0,1
NGA,CIV,2017.0,1,0,1
NAM,IRL,2013.0,1,0,1
HUN,IRL,2000.0,1,0,1
KOR,SVK,2020.0,1,0,1
GBR,MRT,2009.0,1,0,1
ETH,LBN,2017.0,1,0,1
QAT,MAR,2013.0,1,0,1
BTN,CHN,2017.0,1,0,1
COL,POL,2018.0,1,0,1
CYP,PAK,2019.0,1,0,1
RUS,TUN,2021.0,1,0,1
,TKM,2007.0,1,0,1
GRD,TCA,2019.0,1,0,1
NGA,DMA,2017.0,1,0,1
MAR,LUX,2004.0,1,0,1
FJI,PYF,2012.0,1,0,1
PAK,POL,2012.0,1,0,1
AUS,VUT,2014.0,1,0,1
USA,TCA,2021.0,1,0,1
BGR,VNM,2009.0,1,0,1
CHE,GMB,2015.0,1,0,1
URY,ITA,2015.0,1,0,1
RUS,MNE,2014.0,1,0,1
GLP,CMR,2008.0,1,0,1
JAM,ITA,2017.0,1,0,1
ZWE,KEN,2003.0,1,0,1
OMN,NLD,2000.0,1,0,1
BOL,VEN,2008.0,1,0,1
LKA,ZAF,2007.0,1,0,1
EGY,CHE,2001.0,1,0,1
PAN,PHL,2010.0,1,0,1
IRL,CMR,2011.0,1,0,1
THA,LKA,2009.0,1,0,1
KEN,GHA,2010.0,1,0,1
RUS,ARG,2019.0,1,0,1
CUB,VEN,1997.0,1,0,1
,ABW,2011.0,1,0,1
PRK,CHN,2008.0,1,0,1
ZAF,IDN,2015.0,1,0,1
SWE,JOR,2018.0,1,0,1
PRI,CZE,2015.0,1,0,1
EST,BEL,2014.0,1,0,1
LTU,AUS,2019.0,1,0,1
KEN,LKA,2008.0,1,0,1
ITA,SEN,2001.0,1,0,1
KAZ,CHE,2015.0,1,0,1
NLD,AZE,2001.0,1,0,1
POL,NGA,2010.0,1,0,1
BRA,MYS,2007.0,1,0,1
PAK,EGY,2013.0,1,0,1
NPL,CHE,2015.0,1,0,1
LTU,LUX,2017.0,1,0,1
ROU,IRN,2010.0,1,0,1
GBR,MUS,2016.0,2,0,2
NZL,KOR,2003.0,1,0,1
POL,PER,2020.0,1,0,1
IND,ISL,2019.0,1,0,1
ARG,SLV,2008.0,1,0,1
BGR,LVA,2015.0,1,0,1
KOR,CMR,2019.0,1,0,1
NER,GBR,2007.0,1,0,1
ITA,THA,2009.0,1,0,1
ZMB,SWE,2007.0,1,0,1
TUN,NER,2004.0,1,0,1
SWZ,ZMB,2013.0,1,0,1
TUN,ZAF,2018.0,1,0,1
RUS,IRQ,2015.0,1,0,1
EGY,LBN,2002.0,1,0,1
MWI,FIN,2010.0,1,0,1
GRC,TUN,2019.0,1,0,1
FRA,USA,2014.0,892,691,201
IRL,GBR,2009.0,145,188,-43
FRA,PER,2011.0,3,6,-3
CAN,FRA,2013.0,218,368,-150
SAU,ARE,2001.0,4,2,2
SWE,GBR,2004.0,76,67,9
GBR,CAN,2014.0,364,351,13
DNK,SWE,2016.0,75,85,-10
CAN,CHN,2018.0,310,274,36
USA,ITA,2017.0,363,590,-227
USA,ESP,2012.0,345,492,-147
IRN,CAN,2009.0,109,44,65
FRA,DEU,2011.0,310,330,-20
AUS,USA,2007.0,413,478,-65
CHE,IRL,2012.0,8,15,-7
GBR,PRT,2005.0,40,34,6
DEU,NOR,2003.0,32,22,10
BGR,RUS,2011.0,6,1,5
NLD,DEU,2010.0,211,193,18
IND,PRT,2010.0,21,5,16
JPN,IDN,2019.0,158,59,99
NLD,GRC,2009.0,11,18,-7
BRA,FRA,2012.0,69,99,-30
GRC,USA,2010.0,110,100,10
CHN,USA,2018.0,2756,2736,20
FRA,NLD,2001.0,54,52,2
JPN,IDN,2010.0,78,22,56
JPN,CHN,2013.0,516,306,210
DEU,NZL,2008.0,29,21,8
GBR,GRC,2010.0,152,124,28
ITA,RUS,2004.0,17,15,2
GRC,CYP,2020.0,51,22,29
GBR,IRL,2013.0,178,239,-61
RUS,DEU,2011.0,108,76,32
FRA,ITA,2022.0,130,118,12
NLD,DEU,2019.0,302,312,-10
POL,USA,2012.0,89,251,-162
COL,MEX,2011.0,19,18,1
MAC,SGP,2007.0,1,1,0
SWE,IRL,2007.0,6,3,3
USA,JPN,2013.0,818,819,-1
POL,ZAF,2010.0,2,1,1
JPN,TUR,2008.0,8,1,7
USA,RUS,2020.0,111,167,-56
SAU,CAN,2004.0,21,18,3
CAN,POL,2010.0,18,15,3
NLD,DEU,2017.0,319,287,32
BEL,FRA,2014.0,170,210,-40
AUT,DEU,2021.0,229,285,-56
USA,NZL,2001.0,72,83,-11
MEX,NLD,2021.0,10,8,2
FIN,USA,2006.0,66,62,4
GBR,JPN,2009.0,108,114,-6
ESP,MEX,1999.0,25,11,14
ESP,URY,2009.0,7,7,0
JPN,RUS,2013.0,11,7,4
ITA,ISR,2021.0,15,9,6
GBR,IRN,2004.0,54,12,42
JPN,IDN,2017.0,158,57,101
GBR,GRC,2019.0,172,226,-54
HUN,DEU,2017.0,48,30,18
JPN,CZE,2010.0,6,4,2
CAN,JPN,2015.0,59,75,-16
ESP,JOR,2018.0,7,2,5
NOR,ISL,2020.0,7,6,1
DEU,IND,2016.0,132,189,-57
USA,MEX,1999.0,52,38,14
CAN,KOR,2002.0,14,20,-6
IND,IRN,2007.0,9,2,7
USA,GTM,2015.0,11,4,7
MYS,IRQ,2017.0,109,12,97
COL,USA,2015.0,84,74,10
CHE,AUS,2020.0,84,54,30
NLD,USA,2016.0,393,338,55
IND,USA,2000.0,156,69,87
CHE,DEU,2000.0,94,155,-61
USA,ITA,2019.0,334,538,-204
BRA,CAN,2022.0,55,38,17
PNG,AUS,2020.0,4,3,1
SGP,NLD,2014.0,7,21,-14
NLD,BEL,2022.0,70,83,-13
CHE,FIN,2018.0,20,25,-5
GHA,CAN,2015.0,5,5,0
TWN,AUS,2018.0,17,11,6
USA,ISR,1999.0,125,98,27
ESP,CHL,2013.0,100,43,57
BEL,IDN,2020.0,4,2,2
JPN,AUS,2008.0,53,38,15
IND,DNK,2017.0,22,11,11
GBR,TZA,2014.0,13,5,8
GBR,IRQ,2013.0,16,8,8
AUS,BGD,2022.0,22,39,-17
ITA,MEX,2015.0,12,15,-3
GBR,CHN,2001.0,65,64,1
ETH,USA,2014.0,18,19,-1
CAN,POL,2019.0,14,12,2
GBR,GRC,2017.0,122,256,-134
DEU,FRA,2022.0,114,149,-35
MYS,SAU,2021.0,42,18,24
USA,NOR,2018.0,102,75,27
GBR,AUS,2001.0,215,230,-15
CHN,FRA,2020.0,163,201,-38
ARG,GBR,2021.0,9,10,-1
SAU,QAT,2016.0,16,2,14
SWE,NOR,2014.0,74,45,29
SGP,MYS,2013.0,14,13,1
HUN,AUT,2015.0,18,12,6
MYS,IRQ,2019.0,141,21,120
DNK,FRA,2020.0,40,49,-9
BEL,PRT,2020.0,11,20,-9
NGA,GBR,2018.0,45,83,-38
DNK,MYS,2018.0,5,4,1
KOR,JPN,2008.0,89,143,-54
KOR,CHL,2021.0,2,5,-3
HKG,THA,2016.0,2,3,-1
AUS,NPL,2015.0,1,5,-4
SYR,USA,2017.0,6,2,4
FRA,MTQ,2009.0,14,16,-2
IDN,JPN,2015.0,28,142,-114
JPN,DNK,2019.0,12,10,2
PRT,GBR,2021.0,66,58,8
CAN,NLD,2016.0,59,65,-6
CHN,NLD,2015.0,108,100,8
USA,VEN,2021.0,5,8,-3
GBR,BRA,2022.0,35,55,-20
GRC,USA,2019.0,106,74,32
SGP,GBR,2015.0,81,142,-61
CHN,IRQ,2019.0,16,2,14
NLD,SWE,2012.0,48,44,4
FRA,KOR,2012.0,15,19,-4
HKG,BRA,2012.0,1,1,0
EGY,AUS,2017.0,9,7,2
IRN,MYS,2017.0,16,175,-159
FRA,MEX,2022.0,10,17,-7
JPN,KAZ,2018.0,3,3,0
CMR,FRA,2017.0,17,13,4
PRT,CHN,2012.0,9,7,2
CHN,MYS,2018.0,12,56,-44
GRC,USA,2017.0,120,58,62
KOR,GBR,2015.0,45,49,-4
AUS,ITA,2001.0,12,11,1
POL,CHE,2022.0,6,8,-2
IND,SWE,2022.0,28,18,10
HUN,ESP,2017.0,3,4,-1
GBR,NLD,2003.0,135,149,-14
MEX,DEU,2021.0,34,23,11
IRN,MYS,2019.0,30,98,-68
THA,SWE,2022.0,2,2,0
KOR,EGY,2020.0,10,3,7
IND,ARE,2015.0,23,12,11
AUS,POL,2018.0,6,11,-5
SAU,BHR,2015.0,8,2,6
HRV,SRB,2019.0,5,7,-2
PAK,ITA,2022.0,16,2,14
SRB,DEU,2015.0,12,7,5
USA,ARE,2020.0,95,80,15
SWE,IND,2020.0,35,68,-33
TUN,USA,2015.0,7,3,4
IND,DNK,2019.0,17,14,3
ETH,AUS,2016.0,11,1,10
NZL,GBR,2018.0,87,99,-12
POL,MEX,2017.0,3,1,2
ITA,CHL,2020.0,15,15,0
IRN,CHE,2020.0,35,11,24
SWE,DEU,2022.0,61,61,0
BIH,SRB,2015.0,8,11,-3
USA,POL,1999.0,33,46,-13
NLD,NZL,2011.0,4,6,-2
ITA,VNM,2020.0,7,1,6
NLD,ITA,2000.0,19,14,5
JPN,PHL,2021.0,17,14,3
PRI,USA,2022.0,24,20,4
CHL,ECU,2019.0,4,8,-4
GRC,CZE,2021.0,6,5,1
DEU,BRA,2006.0,44,51,-7
DNK,IRN,2018.0,5,19,-14
BEL,LUX,2016.0,15,5,10
IND,PRT,2019.0,15,16,-1
EGY,DEU,2004.0,12,22,-10
DEU,CAN,2004.0,132,75,57
ISR,USA,2003.0,365,249,116
IRN,MYS,2010.0,43,30,13
IND,ISR,2006.0,14,5,9
MYS,USA,2016.0,41,33,8
ESP,CHE,2012.0,61,48,13
GBR,FIN,2014.0,48,56,-8
AUT,NOR,2017.0,9,8,1
CZE,SVK,2018.0,44,68,-24
RUS,KAZ,2009.0,4,9,-5
RUS,FRA,2008.0,47,19,28
FRA,MAR,2007.0,68,28,40
DNK,DEU,2007.0,50,66,-16
ARG,FRA,2005.0,15,14,1
ESP,NLD,2008.0,48,52,-4
CHE,SRB,2019.0,5,4,1
USA,GRC,2015.0,77,128,-51
BEL,KOR,2018.0,8,14,-6
NLD,NOR,2001.0,5,7,-2
BRA,GBR,2007.0,40,43,-3
FRA,DZA,2009.0,59,46,13
DEU,IRN,2015.0,30,87,-57
ITA,AUT,2007.0,26,24,2
AUT,PER,2009.0,1,1,0
HUN,CHN,2017.0,3,3,0
AUS,ARE,2017.0,19,17,2
JPN,MYS,2005.0,7,6,1
ISR,BEL,2003.0,4,3,1
IND,OMN,2015.0,21,13,8
ARG,VEN,2009.0,5,5,0
PHL,CHE,2007.0,3,3,0
AUS,SWE,2013.0,35,38,-3
PER,MEX,2020.0,3,8,-5
POL,EGY,2007.0,2,1,1
ARG,CHE,2009.0,4,2,2
TUN,SWE,2017.0,4,2,2
FRA,DNK,2006.0,25,20,5
AUT,CHE,2004.0,24,28,-4
GBR,ZWE,2004.0,4,5,-1
ITA,NLD,1999.0,28,26,2
UKR,GBR,2003.0,12,8,4
NZL,POL,2011.0,7,2,5
EST,GBR,2014.0,7,6,1
KOR,CAN,2014.0,48,36,12
ITA,FIN,2002.0,5,8,-3
AUT,ISR,2016.0,7,2,5
CHE,ITA,2000.0,41,37,4
CAN,FIN,2003.0,12,15,-3
ARG,CHL,2021.0,17,12,5
HUN,DEU,2019.0,45,30,15
RUS,AUT,2008.0,8,5,3
JPN,GHA,2017.0,6,8,-2
FRA,COL,2014.0,20,17,3
HUN,IRL,2018.0,5,3,2
EGY,AUS,2019.0,10,12,-2
CHN,PRT,2021.0,9,10,-1
HUN,VNM,2019.0,2,1,1
AUS,ARE,2019.0,27,19,8
PRY,BRA,2018.0,5,5,0
FRA,ISR,2018.0,25,26,-1
NGA,BRA,2020.0,10,5,5
BRA,MOZ,2017.0,6,4,2
NGA,IND,2017.0,6,8,-2
CHE,SLE,2020.0,3,1,2
KOR,MYS,2021.0,7,8,-1
TWN,SGP,2019.0,16,17,-1
CAN,TWN,2011.0,15,16,-1
GRC,FIN,2013.0,5,2,3
IND,ITA,2022.0,14,16,-2
RUS,CAN,2007.0,27,11,16
JOR,GBR,2022.0,5,10,-5
POL,MEX,2010.0,3,3,0
VNM,SGP,2018.0,5,9,-4
FRA,ESP,2001.0,88,103,-15
ISR,CHE,2018.0,20,12,8
FRA,AUT,2012.0,21,32,-11
NGA,ITA,2019.0,2,5,-3
IND,TWN,2012.0,45,30,15
ITA,PAK,2012.0,7,1,6
IDN,KOR,2011.0,4,6,-2
CAN,HKG,2013.0,25,15,10
BGD,AUS,2016.0,48,23,25
MEX,URY,2005.0,1,1,0
DEU,UZB,2001.0,2,1,1
ITA,PRT,2013.0,27,23,4
ECU,PER,2016.0,6,2,4
ROU,ESP,2020.0,3,8,-5
ETH,IND,2019.0,16,63,-47
CHN,BRA,2014.0,3,6,-3
LSO,ZAF,2022.0,1,1,0
CAN,MAC,2020.0,2,1,1
PAK,IND,2020.0,30,45,-15
FRA,POL,2008.0,22,29,-7
USA,PAN,2018.0,17,15,2
GBR,MEX,2014.0,44,31,13
BWA,ZAF,2017.0,6,12,-6
COL,PER,2014.0,3,5,-2
THA,CHE,2012.0,5,3,2
FRA,PHL,2004.0,2,1,1
HRV,SRB,2010.0,10,3,7
SWE,ITA,2006.0,22,19,3
BLR,USA,2006.0,10,2,8
GBR,POL,2006.0,19,30,-11
EGY,GBR,2013.0,26,47,-21
IND,LKA,2009.0,4,3,1
CIV,SEN,2016.0,1,1,0
BGR,DEU,2000.0,14,4,10
FIN,NLD,2008.0,14,17,-3
CAN,BRA,2016.0,48,105,-57
GRC,DEU,2007.0,45,40,5
AUS,EGY,2012.0,4,4,0
CMR,FRA,2010.0,20,13,7
PRT,ITA,2011.0,11,27,-16
ZAF,GBR,2003.0,67,47,20
POL,ZAF,2017.0,4,2,2
ITA,CAN,2001.0,24,24,0
USA,LBR,2018.0,3,1,2
GBR,ROU,2007.0,10,10,0
USA,HUN,2003.0,67,62,5
CHE,NPL,2007.0,1,1,0
AUT,JPN,2002.0,6,6,0
VEN,ESP,2003.0,16,18,-2
UKR,RUS,1999.0,20,31,-11
FRA,PRT,2002.0,39,12,27
AUS,GBR,2000.0,87,99,-12
MEX,CAN,2003.0,16,11,5
SVN,AUT,1999.0,2,2,0
FRA,MDG,2018.0,16,12,4
AUT,ESP,2011.0,17,18,-1
NLD,PRT,2007.0,18,8,10
GBR,UGA,2009.0,7,5,2
ZAF,CHN,2021.0,13,9,4
LUX,CAN,2002.0,1,1,0
MEX,GBR,2001.0,15,13,2
CAN,SWE,2003.0,29,28,1
NLD,RUS,1999.0,6,14,-8
DEU,TUR,2007.0,18,31,-13
GBR,PRT,2002.0,56,25,31
CHE,AUT,2005.0,29,31,-2
ISR,DEU,1999.0,11,17,-6
ARE,CAN,2004.0,4,13,-9
COL,GBR,2003.0,4,14,-10
FIN,JPN,2013.0,15,14,1
RUS,UKR,2006.0,22,35,-13
CAN,IRL,2006.0,19,22,-3
ETH,SWE,2002.0,4,6,-2
FRA,ZAF,2002.0,10,11,-1
HUN,DEU,2010.0,35,25,10
ITA,NGA,2012.0,3,3,0
DEU,BGR,2011.0,13,9,4
POL,CZE,2003.0,6,4,2
POL,CAN,2007.0,15,9,6
CHE,IND,1998.0,2,1,1
POL,ITA,2002.0,15,16,-1
NOR,JPN,2011.0,1,7,-6
RUS,ISR,1998.0,15,4,11
TWN,DEU,1999.0,1,6,-5
ZAF,NLD,2013.0,11,18,-7
BEL,PER,2001.0,1,1,0
KWT,IND,2011.0,3,4,-1
HUN,HRV,2015.0,2,1,1
JPN,NOR,2021.0,6,5,1
EST,USA,2009.0,2,8,-6
JPN,MYS,2002.0,13,3,10
POL,ITA,2005.0,8,9,-1
NOR,CHN,2011.0,9,18,-9
GRC,BEL,2001.0,9,5,4
ESP,HUN,2003.0,4,3,1
SAU,CHN,2019.0,43,42,1
MYS,CAN,2005.0,5,1,4
DNK,CHE,2001.0,10,7,3
USA,PAK,1998.0,5,3,2
KEN,PAK,2011.0,8,1,7
FRA,JPN,1997.0,9,10,-1
NLD,CMR,2013.0,1,2,-1
FRA,ZAF,2005.0,7,8,-1
SWE,ZAF,2007.0,3,4,-1
LVA,DEU,2012.0,4,3,1
TWN,SGP,2010.0,8,13,-5
QAT,CAN,2019.0,12,23,-11
DEU,GHA,2010.0,3,2,1
NLD,KEN,2006.0,3,1,2
NLD,CZE,2014.0,10,6,4
GBR,MLT,2007.0,5,1,4
HRV,SRB,2017.0,10,7,3
ZAF,CAN,1999.0,3,2,1
NLD,HUN,2009.0,6,14,-8
BLR,RUS,2018.0,15,11,4
DEU,ISR,2007.0,19,24,-5
CHL,DEU,2013.0,23,27,-4
JPN,PRT,2009.0,3,1,2
CAN,PHL,2013.0,4,5,-1
NLD,ZAF,2011.0,15,15,0
AUT,HUN,2008.0,7,14,-7
SGP,HKG,1998.0,5,4,1
CHE,HKG,2014.0,3,5,-2
GBR,SVK,2011.0,3,5,-2
ESP,MLT,2015.0,2,1,1
GBR,SDN,2007.0,2,3,-1
AUT,BEL,2016.0,6,22,-16
ESP,CHN,2007.0,4,9,-5
MEX,AUT,2013.0,5,1,4
ROU,SWE,2015.0,2,2,0
SWE,ISL,2011.0,8,8,0
JOR,IRQ,2013.0,2,1,1
MYS,KOR,2014.0,10,22,-12
TUR,MYS,2014.0,1,2,-1
NGA,CAN,2011.0,7,1,6
ZAF,GHA,2016.0,10,10,0
THA,NLD,2006.0,4,4,0
CZE,IND,2020.0,12,37,-25
KOR,NOR,2011.0,3,3,0
USA,SVN,2011.0,17,12,5
LUX,IRL,2013.0,1,2,-1
IRL,MEX,2016.0,1,2,-1
THA,TWN,2014.0,4,11,-7
KWT,ARE,2014.0,2,1,1
CAN,MYS,2009.0,8,6,2
NZL,CHN,2022.0,32,15,17
CHL,NLD,2019.0,14,7,7
NGA,NZL,2019.0,4,2,2
QAT,NOR,2022.0,1,1,0
BGD,USA,2012.0,35,19,16
FRA,GLP,2014.0,14,18,-4
SYR,AUS,2016.0,1,1,0
GBR,PER,2013.0,1,5,-4
ITA,FIN,2005.0,9,12,-3
IND,CHN,2003.0,4,3,1
USA,MYS,2012.0,26,26,0
JPN,BEL,2020.0,12,8,4
AUT,SRB,2016.0,6,3,3
BGD,IND,2012.0,9,6,3
AFG,JPN,2020.0,2,5,-3
BGD,HKG,2017.0,2,1,1
HKG,BGD,2021.0,3,1,2
SGP,ISR,2018.0,9,1,8
TUR,ESP,2018.0,12,4,8
KEN,JPN,2015.0,6,7,-1
SAU,CHN,2017.0,38,33,5
CAN,QAT,2005.0,4,1,3
BEL,SVK,2020.0,4,1,3
USA,MAC,2012.0,10,1,9
CMR,FRA,2019.0,14,19,-5
IND,BRA,2011.0,6,6,0
BRA,MOZ,2019.0,6,7,-1
NLD,TZA,2021.0,3,1,2
JAM,USA,2021.0,3,3,0
DEU,GAB,2019.0,2,4,-2
HUN,CHN,2019.0,3,6,-3
NLD,SGP,2001.0,1,1,0
NZL,IRL,2017.0,6,6,0
CHL,PRY,2019.0,2,1,1
JPN,KEN,2021.0,5,1,4
ETH,DEU,2021.0,2,6,-4
POL,SWE,2001.0,9,10,-1
USA,SLE,2020.0,7,1,6
ECU,FRA,2021.0,2,5,-3
SVN,HRV,2011.0,7,6,1
LIE,DEU,2012.0,1,3,-2
BEL,ZAF,2016.0,11,5,6
USA,JOR,2003.0,18,8,10
NGA,IND,2019.0,5,7,-2
IDN,DEU,2001.0,3,5,-2
CHE,GBR,2001.0,98,87,11
RUS,ITA,2011.0,16,7,9
FRA,JPN,1998.0,27,7,20
LTU,FRA,2002.0,1,2,-1
POL,DNK,2013.0,9,13,-4
AUS,ARE,2010.0,9,4,5
PER,CUB,2005.0,5,1,4
KEN,MEX,2004.0,1,1,0
SAU,AUS,2005.0,2,2,0
KOR,HUN,2018.0,3,1,2
LUX,NLD,2013.0,2,11,-9
DNK,SVN,2008.0,4,1,3
JPN,DNK,2017.0,7,6,1
GBR,IDN,2015.0,25,4,21
GBR,PSE,2013.0,4,3,1
ESP,ETH,2013.0,1,1,0
FRA,HRV,2014.0,6,5,1
ITA,HUN,2018.0,11,9,2
COL,AUS,2014.0,3,6,-3
ARG,IRL,2019.0,3,1,2
CHE,CHL,2015.0,9,7,2
RUS,ESP,2018.0,8,15,-7
AUT,FRA,2012.0,32,21,11
NZL,DEU,2000.0,9,6,3
SYR,DEU,2014.0,2,2,0
JPN,GHA,2019.0,4,5,-1
LBN,USA,2001.0,7,17,-10
AUT,NZL,2017.0,3,5,-2
LUX,BEL,2019.0,8,14,-6
IRL,FIN,2012.0,3,2,1
ZAF,JPN,2017.0,6,3,3
UKR,FRA,2012.0,18,7,11
NZL,TWN,2009.0,2,2,0
KHM,GBR,2021.0,3,2,1
SVN,NLD,2018.0,8,4,4
KEN,UGA,2018.0,6,9,-3
THA,BEL,2017.0,5,4,1
ARM,IRN,2012.0,5,1,4
ARG,PER,2008.0,1,1,0
COL,NLD,2020.0,10,9,1
USA,PAK,1997.0,3,2,1
URY,CAN,2021.0,2,1,1
LUX,BEL,2017.0,11,16,-5
CHE,PER,2021.0,4,1,3
GHA,GBR,2016.0,11,18,-7
FSM,USA,2019.0,1,1,0
LBY,FRA,2012.0,2,1,1
DEU,SDN,2018.0,2,1,1
JPN,DNK,2010.0,8,7,1
FRA,VEN,2005.0,9,6,3
IRL,FRA,2016.0,30,30,0
USA,CYP,2001.0,6,1,5
EGY,IND,2014.0,2,2,0
RUS,GEO,2004.0,4,2,2
SRB,CAN,2006.0,4,2,2
UKR,CHN,2002.0,1,1,0
ZAF,AUS,2005.0,17,10,7
QAT,CAN,2017.0,7,17,-10
ISL,NOR,2001.0,1,2,-1
DZA,GBR,2003.0,2,1,1
SAU,GBR,2002.0,7,19,-12
DNK,ESP,2009.0,10,14,-4
TUR,BRA,2005.0,2,1,1
GBR,GMB,1999.0,3,6,-3
ZAF,BRA,2004.0,3,2,1
AUS,ESP,2007.0,10,14,-4
MEX,FRA,2000.0,7,20,-13
CAN,KOR,2005.0,26,26,0
SAU,GBR,2005.0,12,21,-9
DEU,LVA,2012.0,3,4,-1
SWE,TUR,2005.0,3,2,1
POL,ZAF,2019.0,4,2,2
ESP,SVK,2003.0,1,1,0
NLD,AUT,2011.0,18,14,4
ITA,CZE,2005.0,5,7,-2
KEN,DEU,2006.0,2,1,1
USA,NPL,2013.0,5,21,-16
FRA,SVK,2009.0,4,5,-1
CHN,IRQ,2017.0,7,2,5
GBR,HRV,2017.0,8,21,-13
IRL,ROU,2019.0,3,2,1
HUN,ESP,2010.0,7,3,4
IND,PRT,2017.0,13,19,-6
ARE,SWE,2016.0,2,4,-2
TWN,GBR,2004.0,12,26,-14
TUR,CHN,2016.0,4,3,1
NLD,BEN,2014.0,1,1,0
CMR,ITA,2015.0,5,3,2
SDN,MYS,2011.0,1,3,-2
ARE,QAT,2016.0,9,7,2
ITA,TUN,2018.0,5,3,2
CAN,CZE,2020.0,9,5,4
ARE,ESP,2021.0,2,6,-4
RUS,CZE,2015.0,13,2,11
USA,URY,2014.0,9,6,3
NZL,ESP,2015.0,4,8,-4
AUS,NLD,1999.0,4,9,-5
SWE,ARE,2017.0,5,2,3
USA,CMR,2016.0,2,8,-6
JPN,UKR,2015.0,2,8,-6
UKR,IND,2019.0,1,4,-3
SWE,CUB,2005.0,1,1,0
RUS,EGY,2019.0,12,3,9
NGA,SAU,2019.0,9,5,4
GTM,CRI,2019.0,1,1,0
SWE,PAK,2020.0,6,6,0
COL,CUB,2008.0,1,3,-2
CHN,UKR,2003.0,1,1,0
MDG,FRA,2000.0,3,4,-1
ESP,GRC,2012.0,10,23,-13
CUB,CHL,2013.0,6,1,5
IDN,AUS,2004.0,5,10,-5
JAM,BRB,2016.0,1,1,0
DEU,VEN,2016.0,3,4,-1
GBR,HRV,2019.0,5,17,-12
PNG,USA,2014.0,2,1,1
HKG,KOR,2016.0,8,13,-5
RUS,MDA,2015.0,5,2,3
CYP,FRA,2016.0,5,2,3
VNM,TWN,2017.0,5,31,-26
OMN,PAK,2021.0,4,6,-2
AUS,ISL,2021.0,2,1,1
ESP,ECU,2002.0,1,2,-1
ETH,SWE,2005.0,2,5,-3
CZE,BRA,2022.0,2,9,-7
NZL,BGD,2012.0,1,1,0
THA,SGP,2015.0,5,5,0
USA,ZWE,2005.0,4,7,-3
CAN,TUN,2013.0,8,7,1
JOR,OMN,2004.0,1,2,-1
CUB,BRA,2002.0,4,3,1
DNK,CHN,2001.0,4,11,-7
ARE,AUS,2012.0,5,8,-3
PRT,MEX,2018.0,3,5,-2
PYF,FRA,2011.0,5,16,-11
CAN,ARG,2021.0,7,10,-3
TWN,JOR,2018.0,3,1,2
PRT,GRC,2020.0,3,1,2
TUR,KGZ,2020.0,3,1,2
BRN,SGP,2017.0,2,1,1
FRA,BGR,2014.0,7,7,0
TWN,IDN,2016.0,22,16,6
HRV,AUT,2021.0,5,3,2
GBR,KOR,2000.0,11,3,8
CHN,ARE,2016.0,6,5,1
FRA,SVN,2014.0,5,4,1
MAC,CAN,2020.0,1,2,-1
USA,KGZ,2021.0,3,1,2
ECU,BRA,2009.0,6,3,3
SWE,ARE,2019.0,9,3,6
SGP,ARE,2008.0,4,2,2
BEL,CYP,2020.0,2,1,1
ECU,USA,2007.0,8,6,2
CHL,AUT,2018.0,2,3,-1
SGP,AUT,2018.0,5,3,2
BRA,KOR,2015.0,2,5,-3
PAK,JPN,2020.0,5,7,-2
FRA,BFA,1998.0,3,3,0
USA,ZWE,2002.0,3,9,-6
CAN,SRB,2001.0,2,1,1
ZMB,GBR,2002.0,4,4,0
BWA,ZAF,2010.0,3,5,-2
PSE,ISR,2022.0,3,10,-7
NER,USA,2016.0,2,1,1
ARE,NZL,2011.0,1,3,-2
ITA,MAR,2014.0,5,1,4
HUN,NOR,2003.0,2,3,-1
GEO,DEU,2004.0,3,2,1
BGR,JPN,2018.0,1,1,0
USA,GEO,2003.0,3,12,-9
GBR,NOR,1999.0,7,11,-4
NLD,BRA,2009.0,12,19,-7
KWT,GRC,2017.0,1,2,-1
TWN,ESP,2008.0,1,1,0
DNK,JPN,2011.0,7,8,-1
ESP,PRI,2015.0,5,2,3
UKR,CHN,2005.0,2,1,1
TWN,GRC,2008.0,1,1,0
FSM,USA,2017.0,1,1,0
POL,AUS,2005.0,2,1,1
ARE,DEU,2002.0,1,5,-4
ITA,EST,2008.0,1,1,0
JPN,CZE,2019.0,8,7,1
ETH,IND,2010.0,6,8,-2
NGA,JPN,2013.0,6,5,1
MWI,ZMB,2017.0,3,1,2
JPN,PAK,2016.0,10,6,4
MYS,ESP,2014.0,4,5,-1
PRT,TWN,2020.0,2,1,1
TTO,GBR,2018.0,2,2,0
BRN,SGP,2019.0,2,3,-1
DNK,GHA,2018.0,4,2,2
PSE,EGY,2012.0,1,4,-3
BWA,ZAF,2019.0,5,15,-10
EGY,TWN,2021.0,1,2,-1
AUS,COL,2022.0,6,4,2
NLD,POL,2007.0,7,11,-4
UZB,DEU,2006.0,3,1,2
MAR,ITA,2004.0,2,2,0
ZAF,JPN,2019.0,5,3,2
ZWE,GBR,2003.0,6,4,2
CHL,SWE,2007.0,1,1,0
GBR,MNG,2014.0,1,1,0
CAF,FRA,2008.0,3,3,0
CHL,ECU,2017.0,8,7,1
MWI,ZAF,2006.0,2,2,0
ETH,CHN,2022.0,3,14,-11
NZL,IRL,2019.0,9,12,-3
SWE,ARE,2010.0,4,2,2
AUT,TUR,2002.0,6,4,2
EGY,CHN,2005.0,2,1,1
SGP,TWN,2013.0,13,12,1
GRC,BRA,2008.0,1,2,-1
NOR,DEU,2000.0,2,10,-8
USA,TZA,2005.0,2,5,-3
BRA,RUS,2011.0,5,1,4
CAN,ROU,2003.0,3,5,-2
MYS,IRQ,2010.0,2,10,-8
USA,TTO,2014.0,3,4,-1
SRB,NOR,2011.0,1,3,-2
NGA,NLD,2008.0,1,2,-1
GBR,ZMB,2007.0,2,1,1
SVN,ITA,2009.0,2,2,0
USA,GHA,2009.0,3,3,0
PHL,GBR,2011.0,3,4,-1
CRI,COL,2014.0,2,2,0
FRA,NCL,2001.0,5,1,4
FRA,PRT,2005.0,18,21,-3
AUT,JPN,2005.0,3,6,-3
QAT,ITA,2016.0,1,10,-9
SAU,AUS,2002.0,3,3,0
KWT,EGY,2004.0,3,9,-6
NOR,AUT,2013.0,5,7,-2
ISR,PRT,2015.0,2,2,0
ZAF,MOZ,2016.0,1,2,-1
ROU,AUS,2022.0,1,1,0
FIN,MYS,2017.0,1,1,0
DEU,ISL,2007.0,2,1,1
LAO,FRA,2020.0,2,4,-2
PSE,FRA,2016.0,2,2,0
MKD,HRV,2020.0,3,1,2
CZE,CHL,2019.0,3,5,-2
BLR,CAN,2011.0,2,1,1
NGA,ITA,2017.0,2,4,-2
CHN,TZA,2022.0,3,3,0
KOR,DZA,2021.0,1,2,-1
FRA,VEN,2002.0,8,5,3
QAT,GBR,2008.0,2,8,-6
PER,GBR,2006.0,2,2,0
FRA,EST,2006.0,2,1,1
BHR,JOR,2008.0,1,1,0
IRN,FRA,2008.0,5,18,-13
FRA,MOZ,2013.0,1,1,0
SWE,CUB,2002.0,2,1,1
CMR,GBR,2015.0,2,3,-1
ITA,MWI,2020.0,1,1,0
DEU,EST,2015.0,2,8,-6
HUN,EGY,2018.0,3,3,0
MMR,JPN,2016.0,1,6,-5
IRN,JPN,2022.0,2,1,1
EGY,MAR,2019.0,3,1,2
BOL,USA,2020.0,4,5,-1
MEX,IND,1997.0,1,1,0
SVK,ESP,2001.0,2,1,1
MYS,JPN,2000.0,2,1,1
SGP,DEU,2000.0,3,4,-1
AND,ESP,2008.0,1,5,-4
ZAF,POL,2021.0,5,1,4
SVK,SVN,2019.0,2,2,0
NLD,MAR,2016.0,2,1,1
HUN,FIN,2006.0,1,1,0
LTU,BEL,2012.0,2,1,1
DEU,ALB,2006.0,2,1,1
ETH,KEN,2012.0,2,3,-1
ESP,AUT,2000.0,2,3,-1
GBR,HRV,2010.0,6,4,2
LKA,JPN,2012.0,1,4,-3
ZAF,MEX,2005.0,2,2,0
IND,BGD,1999.0,1,3,-2
NOR,SGP,2009.0,2,2,0
JPN,LKA,2004.0,4,4,0
AUS,HRV,2003.0,2,1,1
TUN,SWE,2010.0,1,1,0
SGP,IDN,2014.0,2,2,0
IND,ATG,2015.0,1,1,0
MAR,ESP,2013.0,3,13,-10
ETH,IND,2017.0,15,60,-45
ECU,ARG,2012.0,3,2,1
FIN,BGR,2013.0,1,2,-1
SDN,GBR,2013.0,2,2,0
IRN,HKG,2012.0,3,1,2
URY,FRA,2020.0,2,6,-4
USA,PYF,2016.0,2,1,1
USA,GRD,2014.0,3,4,-1
NGA,UGA,2013.0,2,3,-1
MWI,DEU,2020.0,1,2,-1
ALB,SRB,2020.0,5,2,3
THA,LAO,2020.0,4,1,3
POL,GRC,1998.0,1,1,0
BEL,CUB,2018.0,1,2,-1
IRL,HRV,2017.0,1,4,-3
BGD,ITA,2015.0,7,4,3
COG,BEL,2021.0,1,6,-5
EST,NLD,2020.0,2,7,-5
BGR,ESP,2014.0,2,1,1
JPN,NZL,2000.0,5,3,2
DZA,QAT,2018.0,1,1,0
TUR,SAU,2009.0,1,6,-5
LUX,ESP,2013.0,1,5,-4
UKR,JPN,2017.0,2,2,0
MEX,RUS,2014.0,4,1,3
VNM,TWN,2010.0,2,3,-1
EST,ARG,2016.0,1,1,0
IRN,CZE,2014.0,3,2,1
TUR,FIN,2018.0,3,1,2
JPN,OMN,2021.0,1,1,0
BLZ,USA,2013.0,1,1,0
NZL,ITA,2005.0,1,2,-1
ISR,ROU,2003.0,3,1,2
HUN,BGR,2007.0,1,1,0
USA,GUM,2003.0,2,4,-2
BRB,GBR,2004.0,1,1,0
QAT,GRC,2015.0,2,3,-1
HUN,ESP,2019.0,2,8,-6
ZAF,PAK,2002.0,1,2,-1
FRA,TWN,1998.0,1,2,-1
CAN,VEN,2018.0,1,3,-2
AUS,KHM,2011.0,3,1,2
ZAF,NOR,2015.0,3,7,-4
CZE,CHL,2017.0,3,2,1
COL,PRT,2015.0,1,1,0
BRA,NZL,2022.0,2,3,-1
MAR,TUN,2011.0,1,2,-1
JPN,CZE,2017.0,6,9,-3
GBR,PRI,2017.0,1,2,-1
QAT,SAU,2022.0,2,7,-5
AUS,EST,2022.0,6,1,5
TZA,NOR,2016.0,3,5,-2
BEL,ETH,2012.0,4,1,3
POL,MEX,2019.0,1,4,-3
BEL,THA,2020.0,3,2,1
BEL,CAN,1998.0,2,7,-5
THA,BEL,2019.0,2,2,0
ARE,DEU,2005.0,1,1,0
MLI,SEN,2016.0,1,1,0
GBR,BGR,2011.0,5,9,-4
USA,JAM,2012.0,6,3,3
CHL,BRA,2000.0,1,4,-3
TZA,JPN,2004.0,3,6,-3
CHL,PRY,2017.0,2,1,1
ARE,FRA,2021.0,5,14,-9
ZMB,CHN,2018.0,1,4,-3
NLD,CRI,2003.0,1,2,-1
GMB,CHE,2013.0,1,1,0
IDN,BEL,2000.0,1,1,0
RUS,CHL,2002.0,2,2,0
IRL,GRC,2006.0,1,1,0
GMB,USA,2002.0,3,1,2
NZL,ITA,2002.0,2,2,0
AUT,TUR,2005.0,2,3,-1
KOR,NPL,2005.0,1,1,0
CHE,MUS,2018.0,1,1,0
IRL,ROU,2010.0,2,3,-1
MEX,IND,1998.0,1,1,0
ISR,DNK,2020.0,3,3,0
SWE,MEX,2015.0,4,5,-1
PHL,BEL,2018.0,2,3,-1
FJI,MYS,2018.0,1,1,0
ZAF,KNA,2017.0,2,1,1
MOZ,CUB,2001.0,2,1,1
SWE,GHA,2007.0,1,2,-1
EGY,AUT,2007.0,2,4,-2
ITA,SVK,2014.0,2,1,1
ZAF,MWI,2008.0,1,5,-4
CZE,SWE,2009.0,2,9,-7
CHL,ECU,2010.0,2,1,1
EGY,CHN,2002.0,1,1,0
GBR,MDG,2013.0,1,3,-2
NZL,NLD,2022.0,1,2,-1
NZL,IRL,2010.0,3,5,-2
UKR,JPN,2019.0,1,3,-2
BEL,SRB,2020.0,2,2,0
BEL,SWE,2001.0,2,10,-8
SWE,KOR,2011.0,2,7,-5
PRT,TTO,2010.0,1,1,0
CZE,CHL,2010.0,1,1,0
CHN,IRQ,2010.0,5,1,4
ESP,CRI,2003.0,2,2,0
VNM,MYS,2012.0,2,4,-2
CYP,CHE,2011.0,1,3,-2
RUS,ISR,1997.0,1,1,0
DNK,LBN,2022.0,1,1,0
PER,CUB,2002.0,1,2,-1
AUT,NZL,2010.0,2,1,1
GBR,PRI,2019.0,2,1,1
BGD,HKG,2019.0,3,2,1
ZAF,JPN,2010.0,2,4,-2
LTU,FRA,2005.0,1,3,-2
ARG,IRL,2017.0,1,1,0
COL,NZL,2018.0,3,2,1
RUS,VNM,2005.0,1,1,0
SYR,USA,2010.0,2,1,1
NOR,PHL,2021.0,1,1,0
KAZ,AUS,2016.0,1,3,-2
DZA,ARE,2014.0,2,1,1
LIE,AUT,2004.0,1,1,0
CHE,IND,1997.0,2,2,0
DNK,MEX,2022.0,1,6,-5
SAU,PSE,2015.0,1,2,-1
NOR,ISR,2012.0,1,1,0
CAN,IDN,2006.0,1,1,0
AUT,IRL,2015.0,1,5,-4
GBR,BLR,2004.0,1,2,-1
USA,MLI,2008.0,1,2,-1
MEX,CHE,2003.0,2,2,0
JPN,GHA,2010.0,2,3,-1
NAM,ZWE,2015.0,1,2,-1
DEU,MDA,2012.0,2,3,-1
BEL,MEX,1999.0,1,1,0
PRT,ECU,2016.0,1,1,0
NGA,CYP,2022.0,1,1,0
SYC,GBR,2009.0,1,1,0
USA,MDG,2022.0,1,2,-1
CHN,YEM,2022.0,4,1,3
RUS,IRN,2014.0,1,1,0
IRL,IDN,2020.0,1,1,0
VNM,SWE,2016.0,1,2,-1
CUB,BRA,2005.0,3,6,-3
CAN,ISL,2020.0,2,2,0
CYP,BEL,2021.0,1,1,0
JOR,NZL,2008.0,1,1,0
CHN,ARG,2020.0,1,2,-1
LVA,USA,2005.0,1,2,-1
DEU,PER,2009.0,1,1,0
HKG,SWE,2008.0,1,1,0
ZAF,AUT,2007.0,3,1,2
OMN,ARE,2009.0,1,2,-1
EGY,MYS,2001.0,1,2,-1
KWT,GRC,2019.0,1,1,0
BRA,CZE,2008.0,1,1,0
QAT,CAN,2010.0,1,6,-5
MWI,NLD,2015.0,1,1,0
MNG,JPN,2003.0,1,2,-1
MYS,CAN,2002.0,2,1,1
ARE,TUN,2013.0,1,3,-2
KWT,IRL,2019.0,1,2,-1
DEU,LBN,2012.0,1,2,-1
FIN,SGP,2012.0,2,2,0
YEM,EGY,2005.0,1,1,0
PAN,GBR,2018.0,2,1,1
NZL,IND,2000.0,1,1,0
SLV,USA,2008.0,1,1,0
SAU,CHN,2010.0,1,13,-12
DZA,AUT,2018.0,1,2,-1
FIN,MYS,2019.0,1,3,-2
ISR,KOR,2002.0,1,3,-2
USA,DEU,2003.0,1106,1215,-109
USA,KOR,2007.0,752,604,148
GBR,SAU,2015.0,112,41,71
ARG,USA,2010.0,81,107,-26
SAU,FRA,2014.0,8,39,-31
HKG,CHN,2008.0,245,251,-6
USA,ITA,2010.0,320,491,-171
USA,HKG,2014.0,141,110,31
IND,DNK,2010.0,15,4,11
SDN,SAU,2018.0,23,16,7
BEL,GBR,2009.0,76,75,1
POL,PRT,2016.0,3,5,-2
UKR,DEU,2018.0,35,15,20
AUS,IDN,2012.0,27,11,16
USA,SGP,2022.0,73,57,16
FIN,GBR,2020.0,52,73,-21
AUS,FRA,2020.0,69,79,-10
FRA,IND,2017.0,71,123,-52
IRL,ITA,2008.0,8,24,-16
CHN,DNK,2007.0,5,9,-4
CAN,PRT,2018.0,6,14,-8
DEU,KOR,2018.0,53,76,-23
USA,SAU,2013.0,137,60,77
AUS,NZL,2013.0,96,173,-77
ARG,USA,2017.0,107,70,37
NCL,FRA,2008.0,16,16,0
USA,EGY,2021.0,92,84,8
BRA,DNK,2021.0,22,1,21
BGD,CHN,2021.0,23,35,-12
DEU,GHA,2017.0,6,6,0
BEL,ROU,2009.0,5,5,0
SAU,PAK,2012.0,15,48,-33
FRA,IND,2019.0,61,86,-25
USA,IRQ,2018.0,43,9,34
JPN,SWE,2016.0,31,21,10
UKR,USA,2020.0,22,10,12
COD,COG,2021.0,26,58,-32
PRT,FIN,2015.0,7,3,4
IDN,MYS,2012.0,13,29,-16
IRN,ISR,2011.0,1,3,-2
USA,ZAF,2001.0,39,52,-13
IRQ,AUS,2012.0,3,1,2
CAN,POL,2017.0,16,9,7
DEU,GRC,1998.0,8,7,1
NGA,TZA,2015.0,3,2,1
USA,IND,1999.0,72,151,-79
CHL,NLD,2017.0,9,9,0
SWZ,USA,2020.0,1,3,-2
SVK,USA,2007.0,19,12,7
VNM,TWN,2019.0,18,49,-31
FIN,CHN,2022.0,31,17,14
DEU,LUX,2007.0,17,1,16
FRA,GRC,2016.0,35,40,-5
CIV,FRA,2014.0,19,18,1
BRA,SWE,2011.0,13,8,5
HUN,JPN,2003.0,6,10,-4
ARG,FRA,2002.0,27,11,16
KAZ,RUS,2011.0,4,11,-7
CYP,USA,2001.0,1,6,-5
GBR,MWI,2006.0,7,7,0
GBR,PAK,2015.0,69,43,26
DEU,GRC,1997.0,3,5,-2
PRT,NLD,2004.0,8,15,-7
ISR,BRA,2011.0,3,2,1
POL,AUT,2011.0,3,26,-23
DEU,ARM,2011.0,2,3,-1
OMN,GBR,2020.0,10,16,-6
ITA,KEN,2008.0,2,3,-1
RUS,DNK,2015.0,4,3,1
TWN,SGP,2017.0,20,13,7
BEL,NOR,2018.0,7,7,0
LUX,BEL,2010.0,3,13,-10
KOR,RUS,2015.0,7,7,0
KOR,HKG,2007.0,2,5,-3
AUT,NZL,2019.0,6,6,0
DEU,GHA,2019.0,17,13,4
NPL,CHN,2020.0,14,25,-11
FIN,EST,2018.0,7,8,-1
PRI,ESP,1998.0,1,1,0
AUT,NOR,2010.0,6,7,-1
BGD,KOR,2022.0,10,13,-3
CZE,CHE,2008.0,8,7,1
KOR,POL,2021.0,3,3,0
JPN,AUT,2008.0,10,9,1
SGP,SAU,2021.0,4,2,2
LVA,EST,2021.0,2,3,-1
AUT,NOR,2019.0,14,13,1
USA,PRY,2011.0,2,2,0
KEN,USA,2011.0,27,27,0
BRA,IND,2006.0,2,6,-4
CHE,IRN,2016.0,6,20,-14
IRL,NLD,2009.0,13,14,-1
NZL,DNK,2003.0,3,5,-2
CHE,SRB,2017.0,4,8,-4
USA,SVK,2008.0,12,16,-4
CHL,NLD,2010.0,1,4,-3
GRC,IRN,2014.0,1,1,0
PRT,VNM,2019.0,2,1,1
JPN,IRL,2021.0,5,2,3
VNM,PRT,2021.0,1,1,0
CAN,DNK,2003.0,13,22,-9
KOR,AUT,2012.0,4,4,0
FRA,KAZ,2020.0,4,4,0
CZE,SRB,2012.0,3,1,2
TZA,UGA,2014.0,1,1,0
FIN,BRA,2012.0,3,5,-2
RUS,ARM,2017.0,2,10,-8
BEL,HUN,2006.0,4,5,-1
AUT,AUS,2000.0,5,6,-1
FRA,SEN,2000.0,6,21,-15
BEL,DNK,2002.0,6,7,-1
POL,NOR,2001.0,2,2,0
RUS,ARM,2019.0,2,3,-1
GRL,DNK,2005.0,2,5,-3
UZB,JPN,2008.0,1,1,0
USA,MKD,2013.0,3,3,0
TWN,FRA,2001.0,2,7,-5
RUS,TJK,2020.0,5,1,4
JPN,NGA,2001.0,4,2,2
BOL,ESP,2011.0,2,2,0
LVA,USA,2002.0,2,2,0
MYS,FRA,2009.0,3,2,1
COL,VEN,2012.0,4,7,-3
SVN,CHE,2020.0,2,3,-1
VEN,DEU,2003.0,2,2,0
DEU,GAB,2017.0,2,6,-4
ITA,CZE,2002.0,4,11,-7
ISR,KOR,2005.0,2,2,0
FIN,TUR,2003.0,1,2,-1
IRL,SVK,2004.0,1,2,-1
ITA,URY,2013.0,1,2,-1
COL,ARG,2003.0,3,3,0
RUS,SRB,2016.0,2,4,-2
BEL,DNK,2005.0,4,3,1
THA,BEL,2010.0,1,3,-2
RUS,EGY,2017.0,3,7,-4
BEL,CAN,1997.0,1,1,0
ESP,ECU,2005.0,5,1,4
PRT,NZL,2020.0,3,2,1
SYR,USA,2019.0,7,3,4
DEU,MKD,2015.0,1,4,-3
POL,ARG,2002.0,1,1,0
BEN,NLD,2012.0,1,2,-1
ROU,BEL,2018.0,3,3,0
NOR,LTU,2012.0,2,2,0
OMN,DEU,2009.0,3,5,-2
RUS,ARM,2010.0,1,1,0
TZA,NGA,2015.0,2,3,-1
CMR,NGA,2014.0,1,7,-6
SWE,KEN,2004.0,1,1,0
GEO,RUS,2020.0,2,3,-1
NLD,ROU,2013.0,5,5,0
EGY,BGD,2021.0,1,3,-2
LTU,BLR,2018.0,1,1,0
PRT,POL,2022.0,1,1,0
IRL,HRV,2019.0,1,1,0
THA,NGA,2019.0,1,3,-2
GRD,USA,2003.0,1,1,0
AZE,TUR,2016.0,2,7,-5
NLD,JOR,2009.0,1,1,0
SAU,MEX,2022.0,1,2,-1
YEM,EGY,2002.0,1,3,-2
SDN,JPN,2013.0,1,1,0
CHN,CIV,2020.0,1,1,0
BEL,HKG,2013.0,1,1,0
ESP,KOR,2009.0,1,4,-3
USA,,2011.0,51901,0,51901
FRA,,2016.0,11124,0,11124
UKR,,2022.0,5731,0,5731
,JPN,2011.0,23456,0,23456
CHN,,2018.0,91744,0,91744
IRL,,2013.0,831,0,831
IND,,2018.0,19442,0,19442
THA,,2022.0,4610,0,4610
LTU,,2015.0,313,0,313
PHL,,2023.0,2118,0,2118
MKD,,2021.0,241,0,241
,MEX,2003.0,3123,0,3123
,PRT,2005.0,2032,0,2032
,KOR,2009.0,13918,0,13918
,ARG,1999.0,3358,0,3358
,VNM,2009.0,554,0,554
FIN,,2009.0,1146,0,1146
,SWE,1997.0,2170,0,2170
,COL,2004.0,823,0,823
SGP,,2015.0,1229,0,1229
,PAK,1995.0,207,0,207
JPN,,2003.0,8463,0,8463
GRC,,2004.0,329,0,329
,PRT,2002.0,1868,0,1868
UZB,,2010.0,54,0,54
ISR,,2013.0,1442,0,1442
,TWN,2011.0,7056,0,7056
,SRB,2001.0,648,0,648
SWE,,2018.0,3319,0,3319
,SWE,1998.0,7249,0,7249
,NLD,2015.0,6156,0,6156
,BEL,2007.0,3232,0,3232
,EGY,2000.0,1405,0,1405
YEM,,2013.0,20,0,20
BOL,,2022.0,102,0,102
,QAT,2015.0,273,0,273
,UKR,2010.0,1583,0,1583
CHE,,2000.0,120,0,120
BRA,,2006.0,1562,0,1562
UZB,,2019.0,96,0,96
TTO,,2021.0,91,0,91
,ROU,1994.0,861,0,861
ETH,,2009.0,44,0,44
,UKR,2017.0,4075,0,4075
MDA,NLD,2014.0,1,0,1
,HRV,1995.0,476,0,476
GTM,,2019.0,32,0,32
COD,ZWE,2010.0,1,0,1
MWI,,2023.0,384,0,384
POL,,2025.0,34,0,34
MEX,HUN,2013.0,1,0,1
,TUN,2006.0,1065,0,1065
,PRI,2008.0,169,0,169
DEU,NAM,2019.0,3,0,3
,CUB,2010.0,643,0,643
,ZWE,2010.0,115,0,115
,IDN,2015.0,5318,0,5318
,DZA,2013.0,1619,0,1619
IRQ,,2015.0,81,0,81
AFG,,2023.0,69,0,69
,JOR,2010.0,435,0,435
MAC,,2016.0,38,0,38
,URY,2011.0,245,0,245
,JOR,2017.0,779,0,779
,NZL,2016.0,1453,0,1453
,UKR,2019.0,1169,0,1169
MEX,,2007.0,674,0,674
,PHL,2009.0,362,0,362
POL,KEN,2014.0,3,0,3
MYS,ARE,2013.0,9,0,9
,OMN,2012.0,161,0,161
,PER,2008.0,350,0,350
BRA,EGY,2017.0,1,0,1
FRA,GTM,2011.0,1,0,1
UZB,,2017.0,69,0,69
IDN,,2012.0,97,0,97
,NPL,2001.0,184,0,184
,ZWE,2019.0,63,0,63
JPN,JOR,2018.0,1,0,1
,SLV,1995.0,3,0,3
,VUT,2013.0,6,0,6
,FJI,2010.0,31,0,31
,LUX,2014.0,132,0,132
VEN,NLD,2016.0,4,0,4
,ARE,2008.0,157,0,157
MOZ,,2022.0,117,0,117
DOM,JAM,2019.0,2,0,2
TJK,,2024.0,59,0,59
,KGZ,1998.0,22,0,22
,CUB,2017.0,333,0,333
,ZWE,2017.0,124,0,124
,JOR,2019.0,494,0,494
,FJI,2019.0,17,0,17
HUN,CHN,2010.0,2,0,2
,COL,1996.0,119,0,119
ESP,SAU,2011.0,3,0,3
,KAZ,2007.0,109,0,109
,MDG,2006.0,67,0,67
,MLI,2006.0,47,0,47
GTM,,2017.0,24,0,24
ARE,,2011.0,84,0,84
POL,COL,2015.0,4,0,4
CAN,FJI,2015.0,1,0,1
RUS,,2025.0,38,0,38
,BIH,2000.0,122,0,122
ESP,PAN,2021.0,4,0,4
NER,CHE,2013.0,1,0,1
KWT,IRQ,2016.0,1,0,1
GMB,USA,2005.0,3,0,3
BGD,QAT,2017.0,1,0,1
,PNG,1998.0,35,0,35
ISR,NZL,2007.0,4,0,4
RUS,BGD,2018.0,1,0,1
TUR,MEX,2001.0,1,0,1
ETH,VNM,2020.0,3,0,3
GBR,UZB,2014.0,2,0,2
BHR,,2008.0,14,0,14
MUS,,2004.0,4,0,4
NLD,LTU,2012.0,2,0,2
SEN,SWE,2006.0,1,0,1
NCL,,2012.0,11,0,11
,SYR,2001.0,35,0,35
GRL,,2022.0,16,0,16
UGA,MEX,2008.0,1,0,1
SAU,PER,2005.0,3,0,3
CIV,,2003.0,7,0,7
MLT,,2015.0,16,0,16
SVK,SVN,2017.0,8,0,8
DNK,SVK,2015.0,2,0,2
IRL,MNG,2014.0,1,0,1
,PNG,1997.0,15,0,15
FRA,COM,2010.0,2,0,2
BRA,LUX,2011.0,2,0,2
BGR,,2001.0,24,0,24
BLR,KOR,2005.0,2,0,2
UKR,SVK,1998.0,2,0,2
USA,NAM,2011.0,1,0,1
DNK,THA,2002.0,2,0,2
CIV,YEM,2019.0,2,0,2
BEL,BDI,2007.0,1,0,1
BDI,,2011.0,2,0,2
FJI,,2008.0,10,0,10
UKR,LVA,2001.0,1,0,1
JPN,IRQ,2011.0,1,0,1
IRQ,QAT,2013.0,1,0,1
GLP,,2024.0,5,0,5
BGR,HUN,2001.0,1,0,1
NOR,BWA,2006.0,1,0,1
BGR,UKR,2012.0,1,0,1
IDN,SWE,2006.0,3,0,3
EGY,AUS,2010.0,3,0,3
DNK,MOZ,2012.0,1,0,1
,GAB,1994.0,2,0,2
JAM,TTO,2009.0,1,0,1
SVK,MEX,2006.0,1,0,1
MNG,,2009.0,13,0,13
URY,CHL,2012.0,5,0,5
MDA,,2007.0,18,0,18
BLR,LTU,2006.0,1,0,1
HRV,ESP,2004.0,1,0,1
TUR,UKR,2016.0,2,0,2
KEN,,1999.0,8,0,8
ITA,TZA,2006.0,1,0,1
,GTM,2003.0,19,0,19
,AGO,2005.0,5,0,5
,ASM,2000.0,2,0,2
,YEM,2009.0,47,0,47
BRA,GTM,2019.0,1,0,1
CHL,GRL,2015.0,1,0,1
ETH,TZA,2012.0,1,0,1
FRA,PSE,2015.0,3,0,3
DEU,LAO,2009.0,1,0,1
KGZ,,2015.0,11,0,11
ISL,ROU,2020.0,2,0,2
,CAF,2010.0,12,0,12
NLD,UGA,2016.0,4,0,4
,GRL,2019.0,3,0,3
GHA,HKG,2014.0,1,0,1
ROU,DZA,2016.0,1,0,1
ISR,ECU,2017.0,2,0,2
,CUB,2019.0,157,0,157
ZWE,NAM,2021.0,1,0,1
KEN,SSD,2018.0,1,0,1
GLP,NGA,2008.0,1,0,1
TUN,,2000.0,8,0,8
SAU,SYR,2022.0,3,0,3
TUN,MAR,2007.0,2,0,2
ZMB,COG,2011.0,2,0,2
,FJI,2017.0,40,0,40
PHL,DNK,2018.0,1,0,1
SYR,,2004.0,6,0,6
,BHR,1994.0,34,0,34
NLD,PER,2005.0,1,0,1
,FSM,2003.0,8,0,8
,SYC,2004.0,5,0,5
GBR,,2025.0,27,0,27
,RWA,2007.0,41,0,41
BRN,GBR,2000.0,1,0,1
GMB,TWN,2011.0,1,0,1
DZA,MYS,2015.0,1,0,1
ARM,DEU,2021.0,3,0,3
,AND,2013.0,2,0,2
,BDI,2013.0,7,0,7
,CAF,2017.0,7,0,7
AUT,BTN,2018.0,1,0,1
FRA,ARM,2015.0,1,0,1
SWE,ZMB,2001.0,1,0,1
LUX,,2005.0,6,0,6
NLD,COG,2019.0,1,0,1
USA,MNE,2003.0,1,0,1
ISR,CHL,2016.0,1,0,1
TUN,TUR,2021.0,3,0,3
ZMB,,2007.0,9,0,9
BIH,NLD,2015.0,1,0,1
ZAF,ARG,2004.0,1,0,1
,KGZ,1997.0,5,0,5
NCL,MEX,2015.0,1,0,1
BFA,CAN,2002.0,4,0,4
SEN,ITA,1998.0,2,0,2
IDN,SGP,2004.0,1,0,1
CRI,IDN,2004.0,1,0,1
KAZ,USA,2003.0,1,0,1
TUR,ISR,2001.0,3,0,3
BHR,USA,2000.0,1,0,1
CRI,GTM,2003.0,1,0,1
BOL,GBR,1998.0,1,0,1
NLD,URY,2011.0,3,0,3
,LIE,1995.0,2,0,2
DNK,EGY,2013.0,5,0,5
CIV,GBR,2004.0,2,0,2
BIH,AUT,2001.0,1,0,1
BLR,SWE,2004.0,1,0,1
,PYF,2003.0,8,0,8
SLE,NGA,2009.0,1,0,1
SRB,SVN,2007.0,1,0,1
CZE,DZA,2009.0,1,0,1
PNG,DEU,2010.0,1,0,1
PRT,SGP,2018.0,5,0,5
CHN,NER,2016.0,1,0,1
PRY,ESP,2008.0,1,0,1
NLD,RWA,2016.0,2,0,2
SWE,MAR,2020.0,2,0,2
CRI,NLD,2022.0,3,0,3
CHL,ISR,2013.0,3,0,3
NOR,TWN,2014.0,2,0,2
,CCK,2015.0,2,0,2
URY,NLD,2020.0,2,0,2
PAK,IDN,2020.0,3,0,3
ESP,DOM,2014.0,3,0,3
,GRL,2017.0,6,0,6
MLT,MYS,2022.0,1,0,1
JOR,,1999.0,1,0,1
,PLW,2000.0,5,0,5
KEN,AUS,2007.0,5,0,5
MEX,PRY,2020.0,2,0,2
GHA,NLD,2009.0,1,0,1
ZWE,NZL,2016.0,1,0,1
PRT,VNM,2017.0,2,0,2
PAK,TWN,2014.0,2,0,2
PRT,MRT,2005.0,1,0,1
AUS,PRT,2001.0,2,0,2
ZWE,COL,2011.0,1,0,1
LUX,NZL,2019.0,1,0,1
PRT,LBN,2018.0,1,0,1
HUN,DNK,2014.0,4,0,4
ITA,IDN,2014.0,2,0,2
TUN,EGY,2009.0,2,0,2
GUY,,2016.0,3,0,3
MKD,GRC,2015.0,1,0,1
MDG,CHN,2018.0,1,0,1
ARG,CRI,2013.0,1,0,1
NGA,LSO,2022.0,1,0,1
SVN,ROU,2017.0,1,0,1
NGA,KOR,2020.0,3,0,3
,LAO,1994.0,1,0,1
SVN,,1999.0,5,0,5
CUB,DEU,2001.0,3,0,3
SWE,TUR,2002.0,5,0,5
AUS,LBN,2012.0,2,0,2
GBR,BWA,2004.0,5,0,5
DEU,GUM,2007.0,1,0,1
DEU,GAB,2010.0,1,0,1
NOR,MUS,2007.0,1,0,1
LBY,EGY,2007.0,1,0,1
DEU,AZE,2006.0,1,0,1
GTM,,2010.0,7,0,7
SWE,LUX,2004.0,1,0,1
SRB,PRT,2001.0,2,0,2
KWT,CZE,2006.0,1,0,1
NGA,SAU,2010.0,2,0,2
UKR,MEX,2018.0,1,0,1
BGD,IRL,2007.0,3,0,3
PAK,AFG,2008.0,1,0,1
NZL,BRN,2003.0,1,0,1
ETH,UGA,2007.0,1,0,1
CHL,EGY,1999.0,1,0,1
LBY,IRQ,2008.0,1,0,1
SYR,MYS,2009.0,1,0,1
EST,RUS,1998.0,1,0,1
MEX,PAK,2011.0,2,0,2
MAC,CHN,2002.0,2,0,2
BRA,TWN,2002.0,1,0,1
JOR,YEM,2003.0,1,0,1
JPN,LTU,2008.0,3,0,3
NOR,SVK,2008.0,1,0,1
KEN,KWT,2014.0,1,0,1
NGA,BWA,2001.0,1,0,1
BWA,PAK,2021.0,1,0,1
AUS,QAT,2009.0,2,0,2
MDA,TWN,2004.0,1,0,1
ITA,MCO,2006.0,1,0,1
VUT,,2021.0,6,0,6
TTO,ZAF,2012.0,1,0,1
MNG,DEU,2005.0,2,0,2
VEN,ECU,2012.0,2,0,2
CIV,USA,2014.0,3,0,3
ARG,ZAF,2015.0,3,0,3
ARG,ECU,2007.0,2,0,2
SVN,CZE,2011.0,1,0,1
NGA,SWZ,2019.0,2,0,2
NZL,SVN,2020.0,2,0,2
,GRL,2010.0,2,0,2
CZE,ROU,2020.0,1,0,1
FRA,JOR,2020.0,1,0,1
FRO,ISL,2017.0,1,0,1
OMN,CZE,2020.0,1,0,1
LTU,EST,2021.0,1,0,1
YEM,IRQ,2013.0,1,0,1
MDG,,2004.0,5,0,5
PAN,NIC,2013.0,1,0,1
HKG,GHA,2013.0,1,0,1
GIN,CHN,2013.0,1,0,1
TUN,IRL,2019.0,2,0,2
ARE,CZE,2021.0,1,0,1
SEN,ESP,2017.0,5,0,5
MAR,DNK,2014.0,1,0,1
BRA,MOZ,2010.0,1,0,1
LBN,KWT,2018.0,1,0,1
IRN,GRC,2002.0,1,0,1
JOR,PSE,2008.0,2,0,2
PAK,JOR,2004.0,3,0,3
PSE,LBN,2008.0,1,0,1
DEU,IRQ,2011.0,2,0,2
JPN,LAO,2014.0,1,0,1
LAO,GEO,2013.0,3,0,3
,GNB,1995.0,3,0,3
COG,GHA,2012.0,1,0,1
THA,KAZ,2015.0,1,0,1
LBY,PAK,2012.0,2,0,2
IRL,CHL,2021.0,1,0,1
ZWE,UGA,2013.0,1,0,1
,IRN,2020.0,10,0,10
TLS,CHE,2010.0,1,0,1
ARE,MLT,2015.0,1,0,1
CZE,ARM,2017.0,2,0,2
NPL,ITA,2011.0,1,0,1
QAT,EST,2018.0,1,0,1
MEX,ISR,2006.0,2,0,2
TUR,MKD,2018.0,1,0,1
AUT,THA,2000.0,1,0,1
NGA,FIN,1998.0,1,0,1
JOR,QAT,2013.0,4,0,4
,GUM,2006.0,3,0,3
NOR,ARE,2001.0,1,0,1
POL,GEO,2012.0,1,0,1
HKG,RUS,2011.0,2,0,2
EGY,LBN,2004.0,1,0,1
LBN,HKG,2013.0,1,0,1
ARM,USA,2008.0,4,0,4
MNE,ROU,2016.0,1,0,1
MYS,PHL,2008.0,2,0,2
CZE,ZAF,2011.0,1,0,1
BRA,EGY,2019.0,3,0,3
IND,SEN,2014.0,1,0,1
NLD,ECU,2016.0,2,0,2
CZE,ARM,2010.0,1,0,1
AUS,LBY,2018.0,5,0,5
LTU,AUT,2020.0,1,0,1
ZAF,TGO,2019.0,1,0,1
GAB,COD,2020.0,1,0,1
MYS,SWE,2008.0,2,0,2
ISR,HUN,2011.0,1,0,1
HUN,VNM,2017.0,2,0,2
CHE,GEO,1999.0,1,0,1
HKG,LUX,2016.0,1,0,1
BLR,FRA,2001.0,2,0,2
FIN,LTU,1997.0,1,0,1
KOR,PRY,2014.0,1,0,1
,AGO,2002.0,2,0,2
CHE,MAR,2002.0,1,0,1
EGY,DNK,2003.0,1,0,1
PNG,EGY,2004.0,1,0,1
CZE,CUB,1998.0,1,0,1
USA,NER,2001.0,2,0,2
ETH,BWA,2011.0,1,0,1
ISR,GEO,2002.0,1,0,1
SVN,PRT,2008.0,1,0,1
TTO,BHR,2004.0,1,0,1
EST,RUS,1997.0,1,0,1
MLI,VNM,2010.0,1,0,1
SGP,HKG,1997.0,2,0,2
LSO,,2009.0,4,0,4
DNK,ZAF,1997.0,1,0,1
AUS,VEN,2004.0,1,0,1
SWE,CYP,2016.0,1,0,1
USA,AZE,2011.0,1,0,1
NGA,GIN,2001.0,1,0,1
BLR,JPN,2006.0,2,0,2
CZE,CYP,2012.0,1,0,1
PRT,ARE,2014.0,3,0,3
GRC,MLT,2016.0,1,0,1
CZE,KOR,2011.0,1,0,1
NLD,BTN,2021.0,1,0,1
NPL,TZA,2013.0,1,0,1
HKG,OMN,2011.0,1,0,1
RUS,JOR,2011.0,2,0,2
CHE,CRI,2018.0,1,0,1
HND,PER,2021.0,1,0,1
ETH,NPL,2010.0,1,0,1
SVN,ISR,2013.0,2,0,2
SYC,,2009.0,1,0,1
ITA,MOZ,2015.0,1,0,1
IRN,LUX,2014.0,3,0,3
CHN,GEO,2019.0,1,0,1
HKG,ARE,2022.0,1,0,1
CUB,AUS,2016.0,3,0,3
GUF,MTQ,2012.0,1,0,1
GTM,GBR,2008.0,1,0,1
ZAF,TWN,2022.0,2,0,2
JOR,GRC,2020.0,1,0,1
TWN,KOR,1999.0,1,0,1
VNM,FRA,1999.0,1,0,1
RWA,,2012.0,6,0,6
GTM,HND,2012.0,1,0,1
SUR,,2015.0,3,0,3
COG,GBR,2008.0,1,0,1
IRN,YEM,2008.0,1,0,1
DEU,CYP,2006.0,2,0,2
HRV,COL,2016.0,1,0,1
BLR,CHN,2017.0,2,0,2
SGP,MMR,2015.0,1,0,1
DEU,PSE,1999.0,1,0,1
ESP,TUR,2001.0,1,0,1
CMR,GAB,2018.0,1,0,1
SRB,CHN,2018.0,2,0,2
ALB,NOR,2019.0,1,0,1
CHE,PNG,2002.0,1,0,1
MEX,ROU,1997.0,2,0,2
URY,PRY,2011.0,1,0,1
NOR,BGD,2013.0,2,0,2
IRN,MEX,2015.0,1,0,1
BEL,ARM,2020.0,1,0,1
THA,ITA,2001.0,1,0,1
ROU,ECU,2020.0,4,0,4
KEN,MDG,2017.0,1,0,1
,BLZ,2011.0,3,0,3
COG,JPN,2022.0,1,0,1
CHN,ISL,2019.0,2,0,2
MKD,RUS,2018.0,1,0,1
GRC,KOR,2020.0,1,0,1
KEN,BRA,2012.0,1,0,1
DNK,KWT,2019.0,1,0,1
TUR,SRB,2019.0,2,0,2
SLE,UGA,2019.0,1,0,1
ESP,PYF,2015.0,1,0,1
NLD,COG,2017.0,1,0,1
BEL,LBN,2006.0,2,0,2
FJI,FSM,2008.0,1,0,1
FIN,ISL,2003.0,1,0,1
TUN,SYR,2012.0,1,0,1
DEU,BEN,2016.0,2,0,2
AUS,SVN,2006.0,1,0,1
USA,BFA,2000.0,1,0,1
GBR,JOR,1998.0,1,0,1
GRC,JOR,2003.0,1,0,1
NGA,MYS,2003.0,1,0,1
DEU,JAM,2003.0,1,0,1
KOR,LUX,2016.0,2,0,2
COL,IND,2016.0,1,0,1
SOM,CHE,1997.0,1,0,1
THA,NGA,2010.0,1,0,1
QAT,BGD,2016.0,1,0,1
CMR,CAN,2009.0,4,0,4
URY,GBR,2003.0,1,0,1
EGY,ETH,2016.0,1,0,1
LTU,NOR,2013.0,2,0,2
TUR,SRB,2017.0,2,0,2
ROU,MEX,2022.0,1,0,1
MYS,ZAF,2015.0,1,0,1
USA,LAO,2013.0,1,0,1
CHN,EST,2022.0,2,0,2
TGO,FRA,2022.0,1,0,1
BLR,ISR,2020.0,1,0,1
TWN,TUR,2000.0,1,0,1
PER,ITA,2003.0,1,0,1
BRA,EGY,2010.0,2,0,2
SVN,DNK,2012.0,4,0,4
USA,GRL,2021.0,1,0,1
VUT,NZL,2006.0,1,0,1
THA,ZAF,2001.0,2,0,2
UGA,LBR,2016.0,1,0,1
VEN,URY,2008.0,1,0,1
NZL,TUR,2006.0,1,0,1
ITA,PER,2011.0,1,0,1
MDG,BWA,2008.0,1,0,1
BGR,BRA,2014.0,1,0,1
BFA,CHN,2018.0,1,0,1
GHA,MLI,2018.0,1,0,1
CHN,LVA,2021.0,1,0,1
,SYC,1996.0,1,0,1
BGR,IRL,2001.0,1,0,1
POL,TUR,2005.0,1,0,1
ITA,BFA,2011.0,1,0,1
BEL,COL,2006.0,1,0,1
KHM,LAO,2017.0,2,0,2
CHN,SLE,2013.0,1,0,1
PNG,CAN,2020.0,1,0,1
ZAF,NER,2020.0,1,0,1
CHN,FJI,2022.0,1,0,1
TUN,CMR,2013.0,1,0,1
ESP,SMR,2021.0,1,0,1
URY,GTM,1999.0,1,0,1
ROU,SAU,2020.0,1,0,1
CYP,IRL,2022.0,1,0,1
TTO,BHS,2017.0,1,0,1
KEN,DNK,2020.0,1,0,1
PRI,AUS,2018.0,1,0,1
IRQ,USA,1998.0,1,0,1
NZL,ISR,2003.0,2,0,2
PAN,CAN,2006.0,1,0,1
PAK,BHR,2004.0,1,0,1
ITA,JOR,2011.0,2,0,2
NOR,UZB,2012.0,1,0,1
DJI,,2016.0,1,0,1
PRT,NGA,2017.0,1,0,1
LKA,ZAF,2020.0,1,0,1
PRT,LTU,2019.0,1,0,1
NPL,NLD,2007.0,2,0,2
MLT,JOR,2007.0,1,0,1
FRA,COM,2019.0,2,0,2
TWN,SVK,2014.0,1,0,1
COG,BEN,2009.0,1,0,1
BLR,CHN,2010.0,1,0,1
LBY,QAT,2020.0,1,0,1
BEL,MOZ,2013.0,1,0,1
GBR,MMR,2012.0,1,0,1
AUT,ARE,2012.0,1,0,1
BRA,PAK,2002.0,1,0,1
CAN,GRD,2013.0,1,0,1
HKG,SRB,2012.0,1,0,1
DEU,LKA,2007.0,1,0,1
BEN,NGA,2004.0,1,0,1
BLR,HKG,2005.0,1,0,1
HKG,FIN,2004.0,1,0,1
SEN,NER,2009.0,1,0,1
NOR,MEX,2009.0,1,0,1
BMU,NOR,2017.0,1,0,1
OMN,NLD,2018.0,2,0,2
TON,FJI,2019.0,1,0,1
EGY,BIH,2016.0,1,0,1
FRA,TZA,2014.0,1,0,1
BGD,ETH,2018.0,1,0,1
LBY,POL,2002.0,1,0,1
IND,MOZ,2020.0,1,0,1
LKA,BGD,2005.0,1,0,1
SEN,IND,2002.0,1,0,1
KHM,CHL,2007.0,1,0,1
LBN,FIN,2019.0,1,0,1
NZL,LBN,2018.0,1,0,1
BEL,ISL,2015.0,1,0,1
GRC,CHL,2013.0,1,0,1
DEU,SGP,1998.0,3,0,3
BRN,OMN,2011.0,1,0,1
ZAF,TGO,2017.0,1,0,1
RUS,COL,2013.0,1,0,1
BLR,CHN,2019.0,1,0,1
PAK,SAU,1999.0,1,0,1
GAB,CIV,2016.0,1,0,1
BRA,SLV,2022.0,1,0,1
SRB,MLT,2018.0,2,0,2
RUS,KGZ,2020.0,3,0,3
CHN,ISL,2010.0,1,0,1
EGY,NGA,2022.0,1,0,1
,CAF,2019.0,1,0,1
DNK,SYR,2018.0,1,0,1
SVN,ROU,2019.0,1,0,1
BRA,PAK,2005.0,1,0,1
MOZ,AUS,2006.0,1,0,1
ISR,CZE,2013.0,2,0,2
SVN,SAU,2021.0,1,0,1
NLD,ARE,2008.0,1,0,1
SMR,USA,2015.0,1,0,1
ITA,ALB,2005.0,1,0,1
NGA,COG,2012.0,1,0,1
PRY,NLD,2021.0,1,0,1
GAB,NLD,2022.0,1,0,1
COL,CHN,2021.0,1,0,1
BDI,FRA,2004.0,1,0,1
CUB,BEL,2001.0,1,0,1
GMB,GHA,2020.0,1,0,1
DNK,BIH,2013.0,1,0,1
TJK,RUS,1997.0,1,0,1
BGR,UZB,2019.0,1,0,1
PYF,NCL,2009.0,1,0,1
VNM,CHN,2000.0,1,0,1
IND,THA,2000.0,1,0,1
NOR,UGA,2013.0,1,0,1
KAZ,KOR,2003.0,1,0,1
NLD,BRB,2013.0,1,0,1
DZA,MAR,2007.0,1,0,1
JPN,QAT,2008.0,1,0,1
ESP,UGA,2018.0,1,0,1
TUN,SVK,2018.0,1,0,1
IND,AGO,2009.0,1,0,1
ZAF,KOR,2022.0,1,0,1
IRL,LKA,2017.0,1,0,1
KWT,MYS,2008.0,1,0,1
MYS,PAK,2023.0,2,0,2
EST,,1999.0,1,0,1
ARM,CAN,2007.0,1,0,1
YEM,CHN,2016.0,1,0,1
ESP,IRQ,2014.0,1,0,1
ZMB,GBR,2005.0,2,0,2
KWT,DEU,2013.0,1,0,1
IND,TZA,2009.0,1,0,1
NLD,HTI,2013.0,1,0,1
ITA,SDN,2018.0,1,0,1
CIV,BWA,2010.0,1,0,1
ROU,KWT,1999.0,1,0,1
TUR,MWI,2010.0,1,0,1
ETH,COG,2009.0,1,0,1
VEN,FIN,2018.0,1,0,1
CMR,IRL,2004.0,1,0,1
DNK,BLR,1999.0,1,0,1
DNK,OMN,2001.0,1,0,1
MEX,ROU,1998.0,1,0,1
NOR,CHL,2021.0,1,0,1
GRC,UGA,2020.0,1,0,1
IND,SAU,2023.0,1,0,1
FSM,USA,2010.0,1,0,1
LKA,NOR,2015.0,1,0,1
BEL,IRQ,2020.0,1,0,1
,COM,2015.0,1,0,1
FIN,ISR,2022.0,1,0,1
ZMB,AUT,2000.0,1,0,1
BWA,ITA,2020.0,1,0,1
GBR,USA,2005.0,1275,1051,224
SWE,DEU,2016.0,126,180,-54
USA,CHN,2009.0,1137,1644,-507
NZL,GBR,2010.0,100,127,-27
JPN,CHN,2008.0,345,240,105
GBR,IRN,2014.0,35,41,-6
CHN,USA,2017.0,2744,2588,156
DEU,AUT,2009.0,245,213,32
IRL,CAN,2011.0,35,34,1
CMR,USA,2011.0,8,2,6
ESP,USA,2007.0,295,321,-26
ROU,GBR,2006.0,11,7,4
USA,NOR,2010.0,80,59,21
USA,NOR,2019.0,102,71,31
CAN,CHN,2019.0,348,312,36
SWE,GBR,2014.0,124,164,-40
EGY,JPN,2009.0,23,46,-23
ITA,PRT,2008.0,14,7,7
DNK,GBR,2021.0,78,99,-21
USA,JPN,2008.0,888,1012,-124
TWN,HKG,2005.0,4,3,1
CAN,ITA,2015.0,45,80,-35
MEX,KOR,2013.0,1,1,0
CAN,FRA,2008.0,176,259,-83
DNK,SWE,2022.0,32,41,-9
USA,GBR,2006.0,1197,1282,-85
FRA,USA,2004.0,606,545,61
USA,TUR,2006.0,193,165,28
JPN,CZE,2018.0,11,9,2
DEU,KOR,2017.0,45,61,-16
KOR,VNM,2015.0,47,15,32
CAN,HKG,2008.0,24,15,9
IND,ESP,2007.0,16,3,13
ESP,NLD,2013.0,83,54,29
UKR,DEU,2017.0,40,14,26
PRT,MEX,2017.0,5,3,2
MYS,USA,2022.0,24,12,12
GBR,IRL,2008.0,170,155,15
NGA,SWZ,2018.0,3,1,2
AUS,MYS,2000.0,1,3,-2
RUS,AUT,2013.0,9,9,0
GRC,NLD,2011.0,19,7,12
SAU,CHN,2018.0,32,43,-11
TWN,GBR,2014.0,29,28,1
USA,SGP,2016.0,202,198,4
GBR,MEX,2004.0,28,23,5
NGA,GBR,2017.0,32,73,-41
RUS,FRA,2013.0,39,38,1
DEU,POL,2005.0,42,69,-27
KEN,UGA,2017.0,6,6,0
CAN,DEU,2009.0,99,155,-56
USA,SAU,2008.0,50,30,20
CHL,MEX,2021.0,4,19,-15
ARE,QAT,2022.0,3,6,-3
FRA,ITA,2016.0,231,348,-117
DEU,CAN,2014.0,166,189,-23
ZWE,MEX,2014.0,1,1,0
SWE,NOR,2004.0,47,32,15
JPN,TUR,2013.0,12,5,7
DEU,GBR,1999.0,152,109,43
USA,DEU,2001.0,823,959,-136
CHE,ISR,2005.0,8,10,-2
USA,HUN,2001.0,51,52,-1
NLD,BEL,2016.0,156,153,3
FRA,ESP,2003.0,122,123,-1
CAN,USA,1999.0,532,350,182
USA,CHE,2007.0,334,308,26
IRL,ITA,2013.0,26,25,1
ITA,TUR,2015.0,17,12,5
ZAF,NGA,2005.0,7,6,1
BEL,FRA,2004.0,106,125,-19
DNK,USA,2005.0,86,73,13
FRA,MEX,2016.0,47,42,5
CHE,HUN,2012.0,5,18,-13
CHN,USA,2019.0,2863,2887,-24
GBR,AUT,2020.0,121,72,49
FIN,NOR,2015.0,20,9,11
USA,KAZ,2020.0,10,15,-5
FRA,IND,2018.0,87,86,1
JPN,IDN,2018.0,150,40,110
MYS,IRQ,2018.0,164,9,155
HKG,CHN,2013.0,389,340,49
DEU,KOR,2019.0,49,83,-34
POL,IND,2014.0,36,9,27
CAN,CHN,2017.0,271,293,-22
GBR,CHN,2003.0,93,104,-11
GBR,NLD,2001.0,100,124,-24
BEL,USA,2020.0,149,132,17
TZA,BEL,2016.0,3,1,2
HUN,USA,2021.0,31,21,10
JPN,KAZ,2017.0,3,2,1
IND,KOR,2020.0,217,153,64
GBR,LUX,2009.0,6,3,3
IND,ROU,2006.0,1,1,0
ISR,CHN,2011.0,7,12,-5
BGD,AUS,2022.0,39,22,17
DNK,CZE,2021.0,5,1,4
NZL,IRL,2018.0,8,14,-6
GBR,AUS,2003.0,409,322,87
CYP,FRA,2022.0,4,2,2
GBR,CHE,2020.0,316,263,53
SAU,CAN,2014.0,39,107,-68
CAN,NLD,2022.0,22,20,2
KOR,JPN,2013.0,96,131,-35
DEU,KOR,2010.0,40,36,4
FRA,POL,2013.0,87,36,51
GRC,USA,2018.0,103,78,25
NLD,USA,2022.0,134,149,-15
TWN,AUS,2019.0,16,11,5
CHN,CAN,2021.0,254,328,-74
AUT,BEL,2022.0,8,4,4
CIV,FRA,2004.0,12,12,0
HUN,ESP,2018.0,5,5,0
CHN,IRQ,2018.0,20,2,18
DNK,VNM,2015.0,3,1,2
JPN,SWE,2022.0,11,8,3
CHN,BEL,2000.0,8,3,5
CMR,FRA,2018.0,12,18,-6
HUN,IRL,2017.0,5,2,3
KOR,CAN,2004.0,26,15,11
DEU,IND,2022.0,55,73,-18
MYS,BGD,2020.0,63,27,36
USA,NOR,2017.0,99,57,42
PRT,IND,2012.0,13,33,-20
AUS,NZL,2008.0,107,171,-64
CHL,NLD,2018.0,11,7,4
AUT,SGP,2020.0,1,3,-2
AUS,LKA,2021.0,14,21,-7
ESP,GBR,2000.0,57,56,1
PAK,ITA,2016.0,9,23,-14
PRT,FRA,2015.0,57,30,27
SVN,BEL,2015.0,4,2,2
AUT,CHE,2014.0,63,38,25
GBR,USA,2002.0,1404,1086,318
GBR,NZL,2002.0,69,87,-18
GBR,BRA,2016.0,83,130,-47
BRA,BEL,2006.0,6,7,-1
DNK,USA,2002.0,117,95,22
CZE,FRA,2015.0,25,23,2
BLR,RUS,2017.0,12,22,-10
PRY,BRA,2019.0,4,2,2
IRL,USA,2021.0,85,108,-23
CHN,ARE,2022.0,5,7,-2
VNM,NOR,2020.0,3,1,2
ITA,LUX,2020.0,16,4,12
MAR,ESP,2008.0,11,7,4
BEL,NOR,2017.0,11,6,5
JPN,SGP,2012.0,26,14,12
FIN,CHN,2016.0,28,16,12
CAN,BRA,2022.0,38,55,-17
IRL,AUS,2002.0,19,15,4
POL,FRA,2021.0,19,30,-11
ARG,COL,2021.0,12,7,5
RUS,ESP,2019.0,14,5,9
IRN,RUS,2021.0,6,3,3
VNM,JPN,2021.0,21,58,-37
CHN,MYS,2019.0,11,55,-44
FRA,ISR,2019.0,27,28,-1
ISR,CHE,2019.0,18,22,-4
BGR,ESP,2004.0,3,2,1
BRA,CAN,2016.0,105,48,57
EGY,DEU,2014.0,25,62,-37
POL,CHE,2016.0,23,16,7
PAK,USA,2021.0,93,60,33
GBR,PER,2008.0,3,5,-2
IRN,MYS,2018.0,28,106,-78
GBR,GRC,2018.0,166,204,-38
ESP,CHL,2008.0,29,38,-9
ISR,TUR,2003.0,4,2,2
RUS,ESP,2017.0,7,11,-4
SVN,AUS,2012.0,2,1,1
THA,IDN,2020.0,16,6,10
KOR,DEU,2011.0,45,32,13
MYS,OMN,2021.0,15,3,12
USA,LBR,2019.0,8,4,4
NOR,SWE,2021.0,49,61,-12
ITA,ECU,2015.0,5,1,4
GBR,ZWE,2014.0,7,3,4
KEN,UGA,2019.0,7,8,-1
NZL,SWE,2012.0,7,9,-2
UKR,DEU,2010.0,38,9,29
ITA,HUN,2019.0,8,10,-2
GAB,FRA,2007.0,5,4,1
JPN,JOR,2017.0,1,2,-1
GBR,HUN,2011.0,21,41,-20
USA,PAN,2010.0,15,15,0
CZE,NOR,2015.0,5,5,0
FRA,HUN,2009.0,12,9,3
FRA,CRI,2015.0,2,1,1
TWN,AUS,2017.0,23,8,15
IRL,BEL,2012.0,8,5,3
HKG,CHE,2009.0,6,6,0
CHE,GBR,2003.0,112,161,-49
CHN,ITA,1998.0,5,8,-3
PRT,USA,1998.0,7,2,5
SGP,NLD,2004.0,2,2,0
SWE,JPN,2007.0,22,22,0
USA,PAN,2019.0,13,17,-4
IRL,CZE,2015.0,3,1,2
BGD,HKG,2018.0,6,4,2
ESP,HUN,2001.0,1,1,0
IND,NPL,2006.0,14,15,-1
POL,VNM,2015.0,3,1,2
DEU,URY,2014.0,1,1,0
IND,SWE,2016.0,58,35,23
USA,IRQ,2017.0,25,12,13
FRA,GRC,2022.0,13,14,-1
ZAF,GBR,2001.0,53,19,34
TWN,CAN,2007.0,11,13,-2
ITA,RUS,2014.0,18,11,7
GBR,ZAF,2011.0,74,71,3
LUX,BEL,2018.0,10,20,-10
FRA,THA,2007.0,7,7,0
AUS,CAN,1999.0,29,28,1
DEU,NZL,2013.0,28,30,-2
MEX,GBR,2003.0,22,18,4
MYS,THA,2015.0,4,3,1
COL,DEU,2015.0,9,16,-7
PAN,GBR,2017.0,1,1,0
USA,NZL,2003.0,92,104,-12
RUS,IRN,2004.0,3,1,2
AUS,ARE,2018.0,18,17,1
GBR,MYS,2002.0,29,17,12
AUS,BGD,2016.0,23,48,-25
CZE,SVK,2010.0,27,30,-3
FIN,EST,2017.0,11,12,-1
GHA,GBR,2022.0,7,7,0
PHL,BEL,2017.0,3,2,1
USA,IRQ,2019.0,53,19,34
MEX,RUS,2004.0,8,5,3
HUN,IRL,2019.0,3,3,0
NGA,SAU,2018.0,8,6,2
ETH,AUS,2022.0,12,4,8
DNK,MEX,2016.0,4,2,2
SWE,SGP,2020.0,8,10,-2
IRL,FRA,2022.0,15,22,-7
ITA,KOR,2021.0,4,9,-5
PRT,SWE,2021.0,12,6,6
NZL,GHA,2021.0,1,1,0
SGP,ZAF,2015.0,1,1,0
CHN,NZL,2012.0,14,12,2
AUT,KOR,2020.0,4,8,-4
ARG,ITA,2006.0,10,11,-1
IRN,FRA,2013.0,20,17,3
FIN,POL,2020.0,8,6,2
NLD,CAN,1999.0,8,10,-2
AUT,NOR,2018.0,11,4,7
AUS,POL,2019.0,6,10,-4
NLD,PAK,2013.0,7,5,2
PER,COL,2021.0,6,2,4
AUS,PSE,2016.0,1,1,0
GBR,MYS,2005.0,42,19,23
SRB,CHN,2019.0,4,1,3
UKR,JPN,2018.0,5,2,3
TZA,USA,2009.0,7,9,-2
CAN,SAU,2009.0,50,14,36
CAN,PHL,2008.0,2,1,1
FRA,CZE,2007.0,12,12,0
GBR,FIN,2004.0,40,28,12
SWE,RUS,2012.0,13,24,-11
IDN,AUS,2014.0,15,48,-33
EGY,LBN,2014.0,6,2,4
RUS,GBR,2020.0,48,40,8
BEL,SWE,2003.0,14,5,9
FIN,JPN,2008.0,5,12,-7
CHE,FIN,2010.0,6,12,-6
CHE,BEL,2009.0,22,34,-12
MNG,JPN,2001.0,4,2,2
VEN,BRA,2012.0,3,4,-1
IDN,NZL,2014.0,3,4,-1
JPN,CHE,2012.0,44,30,14
ESP,SVN,2011.0,2,1,1
RUS,ARM,2018.0,5,3,2
SWE,BRA,1999.0,2,2,0
UZB,RUS,2000.0,8,2,6
DEU,POL,2002.0,57,63,-6
USA,FIN,2012.0,69,63,6
ISL,NOR,2003.0,7,3,4
FRA,CIV,1999.0,1,2,-1
FRA,UKR,2002.0,13,11,2
GBR,NZL,2005.0,121,80,41
ITA,CAN,2003.0,36,35,1
NLD,ETH,2015.0,4,1,3
BRA,NLD,2005.0,12,19,-7
USA,ZAF,2003.0,52,101,-49
AUS,DNK,2002.0,16,17,-1
USA,HKG,2004.0,63,99,-36
TUR,AZE,2011.0,5,2,3
JPN,BGD,2002.0,17,13,4
GRC,SRB,2013.0,4,2,2
GBR,TUR,1998.0,13,6,7
CZE,POL,2012.0,14,10,4
NLD,NOR,2003.0,17,5,12
USA,MDG,2016.0,5,6,-1
NZL,FIN,2009.0,1,5,-4
POL,DNK,2008.0,10,5,5
FRA,ISR,2017.0,37,28,9
AUT,HUN,2013.0,12,16,-4
BLR,RUS,2010.0,15,6,9
SGP,ISR,2019.0,6,7,-1
CAN,HUN,2009.0,5,7,-2
OMN,JOR,2016.0,4,2,2
BRA,NLD,2002.0,11,6,5
HUN,DNK,2004.0,1,1,0
PSE,DEU,2010.0,4,5,-1
USA,JOR,2001.0,10,11,-1
DZA,FRA,1997.0,2,2,0
FIN,NZL,2003.0,4,1,3
CUB,DEU,2003.0,3,1,2
USA,TUN,2011.0,4,9,-5
ITA,POL,2011.0,31,16,15
CYP,USA,2003.0,7,6,1
AUT,CAN,2009.0,22,13,9
CHN,RUS,1997.0,3,1,2
USA,MAR,2007.0,1,4,-3
NCL,FRA,2013.0,13,23,-10
POL,SWE,2003.0,10,8,2
UKR,GBR,2001.0,18,4,14
ARG,DEU,1999.0,8,5,3
IND,ETH,2015.0,26,10,16
FIN,FRA,1999.0,5,4,1
TZA,JPN,2014.0,1,5,-4
CHE,NGA,2003.0,1,2,-1
CAN,FIN,2001.0,10,8,2
CHE,NLD,1997.0,6,4,2
ZAF,TWN,2016.0,2,5,-3
ITA,SRB,2006.0,6,9,-3
USA,PRT,2015.0,57,65,-8
ITA,HUN,2010.0,9,11,-2
NLD,AUS,2007.0,42,29,13
SWE,NZL,2000.0,2,1,1
IRL,AUS,2005.0,28,21,7
IND,CHE,1997.0,2,2,0
SAU,FRA,2004.0,1,6,-5
PRT,DEU,2006.0,14,26,-12
COL,ESP,2002.0,6,12,-6
AUS,DNK,2005.0,13,9,4
GBR,COL,2015.0,19,11,8
CAN,SWE,2001.0,18,28,-10
KEN,THA,2011.0,1,2,-1
PRT,USA,1997.0,1,3,-2
HKG,SGP,2005.0,14,12,2
AUS,MAC,2007.0,2,1,1
PRT,NLD,2014.0,19,18,1
JPN,RUS,2008.0,18,14,4
BEL,JPN,2011.0,15,15,0
MWI,NOR,2014.0,1,1,0
LBN,USA,2003.0,15,22,-7
NGA,DEU,2011.0,3,6,-3
AUS,SWE,2008.0,22,35,-13
USA,URY,2004.0,6,9,-3
JAM,GBR,2007.0,4,3,1
ZAF,CHE,2005.0,9,5,4
FIN,EST,2019.0,11,14,-3
ISR,CHE,2010.0,15,6,9
IRQ,ARE,2012.0,1,1,0
NGA,IND,2018.0,11,15,-4
FIN,ESP,2020.0,16,24,-8
FIN,NLD,2013.0,13,14,-1
CZE,ITA,2009.0,7,5,2
KWT,EGY,2014.0,9,12,-3
CHE,SRB,2018.0,4,6,-2
HKG,SWE,2013.0,5,2,3
ARE,CAN,2014.0,14,34,-20
GBR,TUR,1997.0,3,2,1
IRL,ESP,2011.0,13,20,-7
TWN,SGP,2018.0,12,14,-2
IND,NZL,2006.0,5,3,2
FRA,MCO,2006.0,7,3,4
SAU,SYR,2016.0,1,2,-1
ETH,IND,2018.0,20,58,-38
MYS,JOR,2011.0,10,3,7
BGR,JPN,2017.0,5,2,3
ZAF,NLD,2008.0,12,20,-8
SVK,CHE,2011.0,1,4,-3
RUS,EGY,2018.0,4,5,-1
QAT,SRB,2016.0,1,1,0
FRA,MDG,2019.0,6,6,0
JOR,GBR,2016.0,12,22,-10
TWN,ESP,2013.0,4,2,2
NZL,CHN,2016.0,23,27,-4
FRA,CMR,2012.0,25,11,14
ESP,JOR,2017.0,1,1,0
DEU,GHA,2018.0,8,11,-3
FRA,UGA,2020.0,3,1,2
ITA,HUN,2017.0,7,10,-3
NZL,NLD,2016.0,11,13,-2
BGD,CAN,2009.0,10,6,4
DEU,COL,2012.0,13,9,4
USA,PAN,2017.0,12,8,4
ZAF,FRA,2015.0,17,23,-6
USA,NGA,2021.0,31,62,-31
AUS,THA,1999.0,2,2,0
FRA,MDG,2017.0,8,7,1
TUR,ESP,2017.0,6,9,-3
BLR,RUS,2019.0,17,10,7
POL,MEX,2018.0,4,2,2
BGD,PAK,2012.0,3,6,-3
MAC,AUS,2015.0,3,2,1
SDN,SAU,2017.0,25,4,21
CHN,MYS,2017.0,10,40,-30
CHE,FIN,2019.0,13,13,0
DNK,GHA,2019.0,6,2,4
VNM,TUR,2021.0,1,1,0
CAN,OMN,2015.0,5,3,2
AUS,COL,2016.0,3,9,-6
BEL,KOR,2019.0,8,5,3
USA,CMR,2022.0,1,1,0
TWN,HKG,2002.0,3,7,-4
HUN,CHN,2018.0,5,7,-2
PRT,ISR,2014.0,1,1,0
TTO,GBR,2017.0,3,5,-2
ISL,AUT,2017.0,2,1,1
TUR,FIN,2019.0,19,4,15
POL,CHN,2015.0,11,7,4
USA,MDA,2009.0,3,4,-1
JPN,BGD,2005.0,38,26,12
IRL,NZL,2020.0,11,10,1
SVN,NLD,2019.0,3,3,0
ARG,CRI,2008.0,2,2,0
DEU,NOR,2001.0,11,9,2
FRA,BEN,2006.0,9,4,5
BEN,NGA,2014.0,2,1,1
TWN,UKR,2016.0,2,1,1
HUN,CZE,2016.0,7,1,6
JPN,NPL,2011.0,8,3,5
SVK,HUN,2021.0,4,4,0
SGP,POL,2011.0,2,1,1
SGP,AUT,2010.0,1,3,-2
BEL,KOR,2010.0,2,2,0
USA,IRQ,2010.0,2,6,-4
DEU,GAB,2018.0,6,3,3
CAN,PRT,2019.0,12,13,-1
GAB,NLD,2016.0,3,2,1
DNK,MYS,2019.0,2,1,1
DZA,FRA,1998.0,4,5,-1
FRA,ISR,2010.0,17,20,-3
ISR,PSE,2011.0,12,10,2
MYS,SWE,2013.0,4,5,-1
ROU,BEL,2017.0,3,4,-1
ZAF,ZMB,2016.0,3,4,-1
DEU,BGD,2020.0,12,5,7
SVK,AUT,2012.0,6,8,-2
AUS,PHL,2012.0,5,6,-1
ISR,AUS,2020.0,16,20,-4
EGY,NLD,2021.0,4,4,0
TUN,SWE,2018.0,4,1,3
BEL,LUX,2022.0,8,2,6
ESP,RUS,2005.0,5,12,-7
IND,PRT,2018.0,7,17,-10
IRL,TUR,2020.0,6,5,1
UKR,AUT,2020.0,2,2,0
JPN,GHA,2018.0,2,5,-3
ROU,BEL,2019.0,5,8,-3
DEU,NPL,2011.0,1,1,0
CZE,CHE,2013.0,9,12,-3
EGY,SWE,2016.0,3,1,2
IRN,JPN,2016.0,10,8,2
AUS,ZAF,2007.0,15,21,-6
ETH,CHN,2016.0,7,2,5
MEX,IRL,2016.0,2,1,1
GBR,PHL,2022.0,4,4,0
THA,BEL,2018.0,2,3,-1
COL,ARG,2001.0,3,6,-3
KOR,BRA,2016.0,5,2,3
CMR,JPN,2005.0,1,1,0
GRC,SVN,2011.0,1,1,0
THA,AUT,2012.0,2,4,-2
BEL,NOR,2010.0,6,2,4
COL,ESP,2005.0,10,21,-11
MAR,ITA,2014.0,1,5,-4
GBR,TZA,2004.0,5,4,1
USA,GMB,2011.0,2,3,-1
DNK,AUS,2002.0,17,16,1
VEN,ESP,2001.0,5,6,-1
CIV,USA,2004.0,3,1,2
CHE,ISR,2002.0,10,5,5
SAU,ARE,2003.0,5,6,-1
ZWE,GBR,2001.0,3,4,-1
AUS,RUS,2007.0,4,8,-4
KEN,UGA,2010.0,5,2,3
LBN,QAT,2012.0,3,1,2
GRC,BGR,2020.0,2,2,0
AZE,TUR,2022.0,4,3,1
USA,KWT,2009.0,13,6,7
IDN,DEU,2003.0,1,5,-4
FRA,BGR,2004.0,4,7,-3
USA,NPL,2008.0,5,8,-3
MEX,CAN,2001.0,14,14,0
COG,FRA,2011.0,5,5,0
QAT,CAN,2018.0,11,13,-2
THA,CAN,2007.0,8,11,-3
ROU,FRA,1999.0,10,6,4
ROU,DNK,2011.0,4,2,2
ARM,USA,2013.0,8,2,6
DEU,SDN,2010.0,4,2,2
DNK,AUS,2005.0,9,13,-4
BEL,ISR,2002.0,4,4,0
GBR,HRV,2018.0,9,14,-5
PRY,BRA,2010.0,3,1,2
PER,BEL,2013.0,3,2,1
DNK,MYS,2010.0,1,1,0
RUS,IND,2012.0,3,3,0
TWN,PHL,2009.0,1,1,0
GBR,IRQ,2008.0,2,2,0
IND,GRC,2014.0,3,3,0
NLD,ROU,2008.0,5,3,2
IND,QAT,2012.0,7,3,4
ESP,ISR,2012.0,6,2,4
ESP,IND,2009.0,8,20,-12
ITA,TUN,2019.0,1,2,-1
ECU,PER,2022.0,2,3,-1
SAU,TUR,2015.0,4,10,-6
GBR,BWA,2014.0,2,2,0
NPL,KOR,2012.0,5,2,3
DNK,CHN,2003.0,5,6,-1
SGP,BRA,2021.0,2,3,-1
HUN,ITA,2020.0,8,10,-2
ITA,NER,2009.0,1,1,0
FIN,TWN,2015.0,3,1,2
DNK,IRL,2007.0,5,3,2
BWA,ZAF,2018.0,3,21,-18
LUX,POL,2018.0,1,1,0
JPN,JOR,2019.0,2,2,0
CHL,ECU,2018.0,17,11,6
AUT,ISR,2022.0,1,5,-4
SDN,TUR,2020.0,3,1,2
ZAF,JPN,2018.0,4,7,-3
DEU,SDN,2017.0,1,4,-3
JPN,NLD,1997.0,2,4,-2
YEM,CHN,2022.0,1,4,-3
CHN,ITA,1997.0,5,5,0
PRI,CAN,2015.0,2,5,-3
CHL,ESP,2000.0,7,10,-3
PHL,IDN,2020.0,2,2,0
ITA,EGY,2009.0,3,1,2
BRA,MOZ,2018.0,5,7,-2
CUB,CAN,2009.0,5,1,4
RUS,ESP,2010.0,10,4,6
VNM,DNK,2017.0,3,1,2
PRT,DNK,2006.0,1,2,-1
BEL,NOR,2019.0,8,9,-1
ESP,RUS,2002.0,9,12,-3
PRY,ESP,2013.0,1,1,0
JPN,DZA,2016.0,1,1,0
DNK,IRN,2019.0,5,39,-34
JPN,IRN,2021.0,8,11,-3
KEN,ZAF,2020.0,11,22,-11
GIB,GBR,2020.0,1,4,-3
FIN,EST,2010.0,4,6,-2
HKG,KOR,2022.0,6,7,-1
EGY,RUS,2011.0,1,2,-1
SAU,TWN,2021.0,4,3,1
BEL,ISR,2005.0,3,5,-2
GBR,RWA,2015.0,2,2,0
BGD,SGP,2003.0,1,2,-1
OMN,NLD,2019.0,1,2,-1
FJI,AUS,2012.0,8,2,6
SGP,AUT,2017.0,2,4,-2
AUS,POL,2010.0,4,5,-1
MAR,SWE,2015.0,1,1,0
ALB,ESP,2014.0,1,2,-1
ZAF,ARE,2021.0,7,2,5
GHA,USA,2009.0,3,3,0
BWA,USA,2015.0,10,10,0
THA,NOR,2019.0,2,1,1
TUR,ESP,2019.0,5,10,-5
ESP,AND,2020.0,2,2,0
MEX,CZE,2021.0,9,1,8
BLR,DEU,2021.0,4,1,3
ZAF,GHA,2022.0,8,9,-1
TTO,GBR,2010.0,5,6,-1
JPN,LTU,2013.0,1,1,0
SGP,TWN,2008.0,5,4,1
USA,SVK,2013.0,8,12,-4
SVK,ESP,2003.0,1,1,0
JPN,AUT,2013.0,13,6,7
HUN,FRA,1999.0,6,6,0
AUT,NLD,1999.0,5,5,0
FRA,SVN,2004.0,1,1,0
COL,PER,2004.0,1,1,0
ESP,ROU,2003.0,3,4,-1
PSE,DEU,2019.0,3,5,-2
BEL,UGA,2008.0,3,1,2
ITA,SVK,2004.0,1,4,-3
JOR,CAN,1999.0,1,1,0
ZAF,DEU,1999.0,5,5,0
CHE,EST,2012.0,2,5,-3
RUS,PRT,1999.0,7,1,6
ZAF,NGA,2002.0,1,2,-1
USA,KNA,2017.0,2,6,-4
SGP,CHE,2011.0,6,8,-2
USA,MKD,2008.0,1,1,0
ESP,MAR,2006.0,4,4,0
COL,GBR,2001.0,4,7,-3
KWT,ARE,2004.0,3,1,2
BRA,VEN,2006.0,3,4,-1
AUS,POL,2017.0,2,8,-6
NLD,SGP,2003.0,1,2,-1
USA,PHL,1999.0,6,3,3
RUS,SGP,2007.0,1,3,-2
VEN,DEU,2001.0,2,2,0
DNK,KEN,2009.0,1,2,-1
IDN,SGP,2014.0,2,2,0
CAN,SEN,2021.0,1,3,-2
TUN,GBR,2012.0,4,1,3
TWN,THA,2012.0,4,3,1
CHN,BRA,2004.0,2,1,1
ISL,AUT,2019.0,1,2,-1
PRT,SGP,2017.0,1,2,-1
TUR,FIN,2010.0,2,7,-5
NGA,JPN,2008.0,3,4,-1
PHL,BEL,2019.0,3,3,0
CAN,TUN,2008.0,6,5,1
EGY,QAT,2006.0,1,2,-1
JPN,SRB,2009.0,2,1,1
FSM,USA,2018.0,1,1,0
KOR,CHE,2012.0,8,5,3
VNM,BEL,2012.0,4,6,-2
SVN,SRB,2020.0,4,6,-2
DEU,SDN,2019.0,3,3,0
SVK,SVN,2018.0,5,8,-3
AUS,LTU,2020.0,1,1,0
PSE,DEU,2017.0,1,6,-5
SAU,QAT,2022.0,7,2,5
EGY,TUR,2020.0,7,4,3
NLD,SVN,2020.0,2,2,0
HUN,EGY,2017.0,1,2,-1
CAN,VEN,2019.0,1,2,-1
UKR,ESP,2012.0,3,2,1
NLD,FIN,1999.0,5,1,4
NLD,OMN,2002.0,3,1,2
ITA,VEN,2005.0,1,1,0
TTO,GBR,2019.0,4,6,-2
SWE,CHL,2017.0,2,7,-5
LUX,ESP,2008.0,2,3,-1
KOR,KAZ,2016.0,1,3,-2
UGA,TZA,2015.0,1,1,0
ETH,GHA,2020.0,1,1,0
COL,KEN,2015.0,1,1,0
ROU,ALB,2014.0,1,1,0
HUN,IRL,2010.0,7,1,6
JPN,ZMB,2001.0,1,2,-1
IND,CHN,2001.0,5,5,0
PHL,HKG,2009.0,2,1,1
CHL,JPN,2015.0,2,3,-1
GRC,AUT,2015.0,10,5,5
BEL,VEN,2016.0,1,1,0
AUS,ITA,2003.0,14,20,-6
EGY,DNK,2001.0,4,1,3
RUS,LTU,2002.0,4,1,3
PSE,USA,2007.0,1,4,-3
UKR,CZE,1998.0,2,1,1
JPN,CMR,2009.0,1,2,-1
GBR,PSE,2008.0,4,1,3
AUS,CZE,2011.0,2,3,-1
ESP,JOR,2010.0,1,1,0
ITA,MAR,2004.0,2,2,0
BEL,NZL,2012.0,3,2,1
QAT,SDN,2020.0,1,2,-1
FRA,MDG,2010.0,6,13,-7
AUT,LVA,2010.0,1,2,-1
CHN,MYS,2010.0,4,3,1
PAN,ESP,2002.0,1,1,0
ITA,MLT,2013.0,3,1,2
PHL,BEL,2010.0,2,3,-1
CAN,POL,2018.0,11,12,-1
JPN,ZAF,2020.0,4,2,2
JPN,PSE,2015.0,1,2,-1
HKG,ARE,2016.0,2,1,1
CHE,BRA,1999.0,3,2,1
DEU,MWI,2020.0,2,1,1
CAN,ECU,2012.0,1,2,-1
NGA,CMR,2020.0,3,4,-1
POL,SVN,2012.0,2,6,-4
FRA,MOZ,2008.0,1,1,0
IRL,SVK,2014.0,1,1,0
FRA,NER,2020.0,5,3,2
NZL,FJI,2016.0,1,2,-1
PER,CHE,2020.0,2,1,1
QAT,NLD,2020.0,3,4,-1
CUB,USA,2006.0,3,4,-1
HRV,QAT,2019.0,1,1,0
TUR,FIN,2017.0,2,2,0
PAN,GBR,2010.0,1,2,-1
CAN,SRB,2003.0,2,2,0
NLD,CHN,1999.0,1,7,-6
MEX,CHE,2001.0,2,2,0
PHL,KOR,2012.0,2,9,-7
JPN,ISR,2020.0,4,6,-2
BEL,ZAF,2022.0,3,2,1
BLR,FRA,2003.0,1,1,0
GNB,DNK,2011.0,2,3,-1
FIN,ARG,2016.0,2,1,1
PNG,USA,2004.0,2,1,1
IRL,LKA,2018.0,1,1,0
KAZ,MYS,2021.0,1,3,-2
ITA,TUN,2017.0,6,4,2
TWN,AUS,2010.0,9,20,-11
CZE,SVN,2009.0,1,1,0
LSO,ZAF,2016.0,1,3,-2
ROU,TUR,2020.0,4,1,3
TZA,NLD,2015.0,2,2,0
PAK,MEX,2021.0,1,1,0
POL,SGP,2009.0,3,2,1
MYS,ARE,2008.0,1,3,-2
AUS,MEX,2015.0,4,23,-19
HRV,CZE,2012.0,1,1,0
BGR,PRT,2015.0,1,1,0
NLD,HKG,2012.0,3,7,-4
DNK,CHE,2003.0,11,10,1
CZE,IRN,2021.0,2,11,-9
CUB,MEX,1998.0,2,3,-1
SVN,SVK,1999.0,1,1,0
CHE,EGY,2011.0,2,2,0
SWE,LUX,2014.0,3,1,2
LAO,THA,2016.0,2,5,-3
NOR,DNK,2000.0,3,9,-6
SWE,SDN,2002.0,1,1,0
TUR,ITA,1997.0,1,1,0
LKA,SGP,2004.0,1,1,0
FRO,DNK,2003.0,2,2,0
ESP,IDN,2021.0,1,2,-1
TUR,ESP,2010.0,4,6,-2
DOM,BRA,2020.0,1,1,0
SAU,CHE,2005.0,1,1,0
CZE,AUS,2006.0,4,1,3
CZE,NLD,1997.0,1,1,0
CAN,GRD,2008.0,1,1,0
ROU,AUT,2007.0,3,2,1
HRV,ESP,2014.0,4,7,-3
GRC,ARM,2008.0,1,1,0
BGD,SAU,2002.0,1,1,0
OMN,NLD,2010.0,1,3,-2
SGP,ISR,2017.0,5,4,1
SWE,KEN,2014.0,2,1,1
DEU,KAZ,2015.0,2,1,1
CHL,PRT,2016.0,2,5,-3
ITA,IND,2000.0,2,2,0
CHE,IRN,2022.0,1,13,-12
BFA,CHE,2021.0,1,2,-1
MEX,KEN,2015.0,4,2,2
AUS,PRT,2003.0,1,1,0
CAN,PAK,2000.0,1,3,-2
ARE,AUT,2014.0,2,2,0
ZWE,BWA,2009.0,1,1,0
GBR,QAT,2011.0,6,5,1
PAK,JOR,2014.0,1,1,0
AUT,SRB,2022.0,1,1,0
JPN,PAK,2022.0,4,3,1
BEL,HKG,2008.0,2,1,1
POL,CZE,2001.0,4,6,-2
LAO,GBR,2012.0,1,2,-1
ITA,TUN,2010.0,3,2,1
BEL,KOR,2017.0,9,13,-4
TZA,SWE,2006.0,1,3,-2
ZAF,KOR,2016.0,4,3,1
NZL,BEL,2009.0,1,1,0
DZA,DEU,2011.0,1,4,-3
BEL,FIN,2011.0,3,5,-2
THA,SWE,2016.0,3,8,-5
HKG,JPN,1999.0,2,7,-5
ARE,GBR,2000.0,1,5,-4
BGR,JPN,2019.0,1,4,-3
SEN,CHE,2021.0,1,1,0
IRN,KAZ,2020.0,1,1,0
ROU,IND,2020.0,1,4,-3
USA,LBR,2017.0,3,2,1
LUX,IRN,2022.0,1,2,-1
BIH,DEU,2021.0,2,1,1
VEN,FRA,2021.0,2,2,0
CHN,EST,2016.0,2,2,0
BRA,NZL,2016.0,4,1,3
IRL,AUT,2015.0,5,1,4
LIE,CHE,2015.0,1,3,-2
QAT,NOR,2016.0,1,3,-2
SGP,ISR,2010.0,2,3,-1
BGD,BEL,2020.0,2,5,-3
BEL,PER,2003.0,1,1,0
THA,DNK,2009.0,1,1,0
ROU,VNM,2020.0,1,1,0
BGR,GRC,2009.0,1,4,-3
BGD,MYS,2006.0,4,5,-1
ESP,TUR,2003.0,1,2,-1
AUS,HUN,2021.0,4,6,-2
ETH,BEL,2022.0,1,2,-1
TZA,KEN,2005.0,1,3,-2
CHL,AUT,2017.0,1,2,-1
IRQ,ITA,2017.0,1,3,-2
MEX,GTM,2015.0,1,1,0
SAU,ZAF,2007.0,1,2,-1
SVN,NLD,2017.0,4,5,-1
KHM,BEL,2006.0,1,1,0
KEN,CMR,2012.0,1,3,-2
KOR,HUN,2019.0,1,2,-1
CAN,PRT,2010.0,2,1,1
ARE,LBN,2014.0,2,1,1
ZAF,MWI,2013.0,2,3,-1
BGR,JPN,2010.0,2,1,1
NLD,CRI,2001.0,2,1,1
PRT,BEL,2007.0,3,4,-1
PRT,RUS,2002.0,1,9,-8
BGR,HUN,2003.0,2,1,1
MAC,HKG,2006.0,3,8,-5
SAU,PRT,2014.0,2,6,-4
GBR,CHL,2000.0,1,2,-1
ETH,USA,2004.0,2,6,-4
JPN,MDG,2003.0,1,1,0
VNM,SGP,2019.0,2,13,-11
ZMB,USA,2006.0,2,7,-5
CHE,HRV,2007.0,2,5,-3
KEN,MEX,2014.0,1,4,-3
BFA,BEL,2021.0,2,2,0
JPN,PER,2020.0,2,2,0
NZL,IRN,2011.0,1,2,-1
POL,KOR,2020.0,1,4,-3
CRI,USA,1998.0,3,1,2
IDN,FRA,2012.0,2,7,-5
ZAF,SDN,2021.0,1,1,0
POL,PRT,2022.0,1,1,0
CAN,ROU,2001.0,2,7,-5
AUS,PRI,2004.0,2,1,1
NLD,ARG,2011.0,1,2,-1
FIN,KOR,2007.0,2,1,1
CZE,HUN,1999.0,2,1,1
TUR,TZA,2021.0,1,1,0
TWN,ITA,2009.0,1,1,0
EGY,ITA,2009.0,1,3,-2
AUS,IRQ,2012.0,1,3,-2
UGA,ZAF,2021.0,5,6,-1
PNG,NZL,2019.0,1,1,0
BEL,CUB,2010.0,1,3,-2
ITA,ZAF,2006.0,3,5,-2
ZWE,NOR,2001.0,1,1,0
PRT,SGP,2019.0,3,3,0
LBN,KWT,2017.0,2,2,0
AUT,NZL,2018.0,1,2,-1
CAN,DZA,2020.0,5,3,2
SGP,VNM,2021.0,4,4,0
DNK,ISL,1999.0,1,2,-1
SVK,NLD,2012.0,1,2,-1
HKG,ISR,2016.0,2,2,0
BWA,ETH,2018.0,1,3,-2
GEO,DEU,2014.0,1,4,-3
SWE,CHL,2019.0,2,6,-4
MLI,FRA,2006.0,2,5,-3
NPL,GBR,2003.0,2,1,1
KOR,BRN,2017.0,1,1,0
EST,NOR,2012.0,2,1,1
SYR,USA,2018.0,1,1,0
CHE,GIN,2015.0,1,1,0
CZE,CHL,2018.0,1,2,-1
BEL,CUB,2017.0,1,4,-3
POL,BLR,2015.0,1,2,-1
DNK,IRN,2010.0,2,7,-5
AUT,UKR,2006.0,1,2,-1
CAN,VEN,2017.0,1,3,-2
SWE,LTU,2000.0,3,3,0
TUR,ISR,2003.0,2,4,-2
FRA,PHL,2014.0,1,4,-3
RUS,BRA,2011.0,1,5,-4
TWN,ISR,2021.0,1,2,-1
KAZ,JPN,2006.0,1,1,0
GRC,SVK,2019.0,1,2,-1
JPN,JOR,2010.0,1,1,0
VNM,CAN,2009.0,1,1,0
ARG,PRY,2021.0,1,1,0
PRT,MEX,2010.0,2,5,-3
ROU,MDA,2012.0,1,3,-2
IRL,JPN,2022.0,1,2,-1
BFA,AUT,2015.0,1,1,0
BEL,CUB,2019.0,1,3,-2
CHE,CRI,2019.0,1,5,-4
MLI,MAR,2017.0,1,3,-2
ZWE,BEL,2013.0,1,1,0
ITA,HKG,2008.0,2,2,0
TUR,CHN,2022.0,3,6,-3
MDA,CHE,2020.0,2,1,1
ECU,PRT,2020.0,1,1,0
QAT,GBR,2013.0,1,24,-23
CYP,IRN,2020.0,1,3,-2
MYS,PHL,2013.0,1,1,0
BFA,COG,2019.0,2,1,1
LUX,FIN,2020.0,1,3,-2
BRB,GBR,2014.0,1,2,-1
VEN,ITA,2011.0,1,1,0
ROU,ISR,2020.0,2,1,1
IDN,SAU,2020.0,1,6,-5
HKG,THA,2022.0,2,1,1
GRC,BRA,2013.0,1,2,-1
ESP,HRV,2011.0,1,1,0
BRA,CZE,2013.0,1,5,-4
PAN,GBR,2019.0,2,5,-3
NGA,OMN,2019.0,1,1,0
DEU,RWA,2014.0,1,1,0
EST,GBR,2004.0,1,2,-1
FRA,BLR,2016.0,1,2,-1
GRC,BEL,2003.0,3,10,-7
BIH,SVN,2007.0,1,1,0
URY,MEX,2007.0,1,2,-1
URY,GBR,2001.0,2,1,1
JOR,PSE,2013.0,1,1,0
ETH,ITA,2015.0,1,4,-3
PSE,JOR,2021.0,1,2,-1
DZA,CHE,2007.0,1,2,-1
FRA,JAM,2014.0,1,1,0
DNK,LTU,2013.0,1,3,-2
JOR,ESP,2012.0,1,1,0
SVK,POL,2005.0,1,1,0
QAT,TUR,2020.0,1,4,-3
ISR,SVN,2014.0,1,1,0
CYP,QAT,2020.0,1,2,-1
SYR,DEU,2004.0,1,2,-1
BGD,DNK,2021.0,1,3,-2
LBY,ARE,2011.0,1,1,0
DEU,NAM,2018.0,1,1,0
BEL,BOL,2006.0,1,1,0
NPL,LKA,2009.0,1,2,-1
CRI,ECU,2020.0,1,2,-1
COG,CAN,2018.0,1,1,0
BGD,PRT,2021.0,1,1,0
FIN,CZE,2011.0,5,2,3
NLD,DEU,2018.0,339,305,34
CHN,USA,2010.0,1889,1390,499
JPN,AUS,2013.0,61,48,13
CAN,CHN,2010.0,160,199,-39
FRA,BEL,2007.0,159,126,33
ISR,USA,2001.0,246,177,69
TWN,FRA,2003.0,4,3,1
ARE,SAU,1999.0,3,2,1
GBR,CAN,2004.0,293,207,86
PRT,POL,2016.0,5,3,2
DEU,FRA,2016.0,356,360,-4
TUR,DEU,2015.0,42,41,1
USA,ITA,2018.0,356,581,-225
ARG,MEX,2011.0,6,9,-3
BEL,BEN,2014.0,4,1,3
CZE,SVK,2017.0,63,41,22
CZE,SVK,2019.0,38,72,-34
CHE,FRA,1998.0,30,49,-19
SDN,SAU,2019.0,30,14,16
NZL,GBR,2017.0,101,104,-3
HUN,DEU,2018.0,55,15,40
VNM,TWN,2018.0,9,38,-29
SWE,AUS,2006.0,36,27,9
AUT,GBR,2012.0,57,79,-22
PRI,USA,2016.0,88,83,5
NZL,GBR,2019.0,116,130,-14
POL,HUN,2021.0,4,2,2
NGA,USA,2021.0,62,31,31
IND,DNK,2018.0,22,13,9
NGA,GBR,2019.0,51,84,-33
BGD,GBR,2020.0,21,25,-4
DNK,EST,2020.0,1,2,-1
ITA,DNK,2021.0,37,21,16
RUS,FIN,2020.0,29,12,17
HKG,CAN,2021.0,21,17,4
ECU,BEL,2021.0,4,4,0
SWE,IRN,2020.0,11,56,-45
FLK,GBR,2021.0,1,1,0
PHL,JPN,2021.0,14,17,-3
KOR,TZA,2021.0,3,2,1
JPN,KAZ,2019.0,7,2,5
BEL,NGA,2013.0,3,1,2
EGY,AUS,2018.0,12,7,5
TWN,IDN,2022.0,21,15,6
CAN,PRT,2017.0,6,8,-2
TWN,CHN,2011.0,61,65,-4
SVK,POL,2002.0,6,4,2
FRA,UKR,2005.0,7,9,-2
DEU,MAR,2015.0,7,1,6
UKR,DEU,2019.0,29,14,15
IND,ITA,2016.0,37,45,-8
ISR,BEL,2001.0,3,4,-1
CAN,MAR,2021.0,6,3,3
BGD,KOR,2016.0,24,21,3
KOR,ROU,2019.0,1,1,0
BEL,KEN,2007.0,10,2,8
JPN,LKA,2014.0,10,1,9
NOR,AUS,2021.0,11,17,-6
HRV,SRB,2018.0,8,6,2
DEU,JOR,1999.0,1,1,0
FRA,GLP,2004.0,9,6,3
POL,NOR,2003.0,4,1,3
BEL,DEU,2006.0,45,65,-20
FRA,COL,2004.0,7,1,6
CAN,ZAF,1999.0,2,3,-1
CAN,CYP,2021.0,3,1,2
ZAF,CHE,2002.0,6,3,3
ARG,CAN,2006.0,12,5,7
CHE,FRA,1997.0,19,29,-10
DNK,CAN,1999.0,11,4,7
IND,COL,2005.0,1,1,0
HUN,POL,2022.0,2,1,1
PRT,MEX,2019.0,4,5,-1
NGA,GBR,2010.0,26,28,-2
JOR,KWT,2017.0,6,3,3
MAR,SAU,2011.0,6,1,5
QAT,SAU,2016.0,2,16,-14
ESP,GTM,2014.0,1,1,0
USA,VNM,2015.0,28,16,12
SDN,SAU,2010.0,10,2,8
TUR,SRB,2018.0,1,1,0
DNK,IRN,2017.0,5,14,-9
KOR,SAU,2021.0,15,6,9
EGY,GBR,2008.0,17,28,-11
CAN,DNK,2001.0,9,6,3
NOR,POL,2007.0,2,4,-2
SWE,BEL,2021.0,17,22,-5
FRA,NLD,2003.0,80,78,2
SWE,PRT,2003.0,4,4,0
CHE,FIN,2017.0,19,17,2
VNM,SGP,2017.0,2,11,-9
FRA,NCL,2003.0,12,7,5
USA,GEO,2001.0,6,5,1
HRV,USA,2012.0,19,13,6
ESP,SWE,2007.0,14,29,-15
CHE,NLD,1998.0,9,12,-3
HUN,EGY,2019.0,2,3,-1
JPN,NLD,1998.0,3,6,-3
USA,TTO,2004.0,6,5,1
TWN,SWE,2012.0,3,1,2
FIN,ISR,2016.0,1,2,-1
FRA,COG,2016.0,3,7,-4
IRN,CHN,2011.0,3,5,-2
TZA,FIN,2014.0,1,1,0
ZMB,MWI,2016.0,1,2,-1
GBR,ISL,1999.0,4,1,3
CMR,GAB,2019.0,2,2,0
JPN,DNK,2018.0,6,6,0
IRN,IND,2021.0,4,3,1
SLE,ZAF,2013.0,1,1,0
NOR,FIN,2007.0,7,5,2
FIN,HUN,2015.0,1,4,-3
ISL,DNK,2004.0,2,4,-2
DEU,CMR,2012.0,5,1,4
TGO,MAR,2015.0,1,4,-3
PAK,CHN,2005.0,4,1,3
IRQ,JOR,2015.0,4,5,-1
JPN,NGA,2003.0,4,1,3
RUS,GEO,2014.0,1,2,-1
JOR,QAT,2008.0,2,2,0
USA,CYP,2003.0,6,7,-1
PRT,RUS,2005.0,3,3,0
GRC,FIN,2008.0,1,2,-1
NZL,DNK,2001.0,2,1,1
HUN,JPN,2001.0,4,9,-5
NOR,AUT,2008.0,3,1,2
CZE,BRA,2016.0,4,3,1
KHM,LAO,2018.0,1,1,0
RUS,LTU,2005.0,3,3,0
PSE,ISR,2016.0,3,14,-11
TUR,PAK,2020.0,11,10,1
ROU,BEL,2010.0,5,8,-3
CHL,AUT,2019.0,3,2,1
ZAF,BRA,2014.0,1,1,0
ETH,SAU,2021.0,1,2,-1
ROU,FIN,2015.0,3,3,0
DNK,PAK,2009.0,2,2,0
ITA,VEN,2002.0,2,1,1
HRV,CHE,2006.0,3,5,-2
AUT,LUX,2020.0,2,1,1
AUS,VEN,2014.0,1,4,-3
RUS,MNG,2016.0,3,1,2
ZWE,USA,2012.0,2,3,-1
NLD,MYS,2015.0,10,3,7
THA,GBR,2000.0,4,6,-2
AND,ESP,2013.0,1,2,-1
NAM,AUS,2012.0,1,2,-1
ZWE,FRA,2010.0,1,3,-2
SGP,NZL,2012.0,5,10,-5
TZA,CHE,2014.0,4,3,1
UZB,USA,2012.0,1,3,-2
CHL,AUT,2010.0,2,1,1
MMR,JPN,2022.0,2,1,1
CUB,ARG,2007.0,1,1,0
AUS,EST,2016.0,1,1,0
PER,CHL,2003.0,3,2,1
NLD,CZE,2004.0,3,3,0
PRY,BRA,2017.0,3,7,-4
SOM,CHN,2020.0,1,1,0
ROU,RUS,2021.0,3,1,2
BEL,GMB,2005.0,1,1,0
PAN,BRA,2014.0,1,1,0
FRA,TGO,2020.0,3,3,0
THA,TWN,2004.0,1,2,-1
NGA,THA,2021.0,2,4,-2
KOR,THA,2006.0,2,3,-1
DZA,ESP,2011.0,1,1,0
GBR,GTM,2019.0,1,1,0
PSE,FRA,2022.0,2,1,1
DEU,BEN,2022.0,1,1,0
TZA,DEU,2006.0,1,3,-2
CHN,TZA,2016.0,1,3,-2
PHL,DNK,2019.0,2,1,1
ESP,SVK,2001.0,1,2,-1
SVK,GRC,2021.0,2,2,0
JPN,KAZ,2010.0,1,1,0
BEL,AUS,1998.0,1,3,-2
EGY,NOR,2021.0,1,1,0
BFA,COG,2017.0,1,1,0
FIN,MYS,2018.0,1,2,-1
TUR,ITA,1998.0,1,1,0
VNM,SGP,2010.0,1,5,-4
SWE,,2019.0,3870,0,3870
NOR,,2012.0,815,0,815
,CHN,2002.0,51158,0,51158
CHN,,2010.0,29808,0,29808
BLR,,2015.0,191,0,191
CHN,,2017.0,80656,0,80656
,CHN,2005.0,72845,0,72845
CHN,,2019.0,104359,0,104359
,USA,2007.0,82701,0,82701
IND,,2010.0,4936,0,4936
FRA,,2022.0,29519,0,29519
NZL,,2015.0,850,0,850
SWE,,2010.0,1952,0,1952
TUN,,2023.0,4247,0,4247
,GBR,2000.0,22868,0,22868
IND,,2019.0,21257,0,21257
COL,,2021.0,2716,0,2716
,ISR,1998.0,5050,0,5050
TGO,,2021.0,74,0,74
,IND,1994.0,7551,0,7551
SWE,,2017.0,2992,0,2992
BFA,,2021.0,161,0,161
UKR,,2016.0,1092,0,1092
GRC,,2014.0,1553,0,1553
,HKG,1998.0,1996,0,1996
CAN,,2002.0,590,0,590
MYS,,2011.0,426,0,426
CHE,,2023.0,17444,0,17444
IRL,,2008.0,446,0,446
,ESP,1994.0,10065,0,10065
IND,,2017.0,16884,0,16884
,BGD,1998.0,354,0,354
SRB,,2021.0,1587,0,1587
,MEX,2001.0,2991,0,2991
JPN,,2001.0,1064,0,1064
UGA,,2015.0,87,0,87
NGA,,2009.0,264,0,264
,ISR,1997.0,911,0,911
,SRB,2003.0,695,0,695
ISR,,2008.0,1148,0,1148
VEN,,2024.0,525,0,525
AUT,PYF,2008.0,1,0,1
THA,,2016.0,1143,0,1143
PRT,,1999.0,9,0,9
,NPL,2003.0,204,0,204
,LUX,2004.0,51,0,51
BHR,,2013.0,28,0,28
,CZE,2016.0,2418,0,2418
,UKR,2018.0,3252,0,3252
,DZA,2008.0,940,0,940
,MDA,2000.0,40,0,40
CAN,,2005.0,2872,0,2872
MDG,,2014.0,36,0,36
ARM,MDA,2019.0,1,0,1
HKG,GUM,2009.0,1,0,1
LAO,,2023.0,116,0,116
,COL,2014.0,2546,0,2546
KOR,,2005.0,2355,0,2355
BEL,PHL,2015.0,1,0,1
,MNE,2016.0,39,0,39
LBY,,2020.0,58,0,58
,BWA,2011.0,68,0,68
BOL,,2016.0,29,0,29
,HKG,1997.0,508,0,508
,LKA,2012.0,257,0,257
LUX,NZL,2018.0,1,0,1
ZWE,FRA,2017.0,1,0,1
,PER,2013.0,504,0,504
,ISL,1998.0,112,0,112
SLE,,2023.0,75,0,75
,JOR,2018.0,817,0,817
,ARE,2013.0,373,0,373
MAC,,2022.0,194,0,194
UZB,,2018.0,88,0,88
MTQ,,2020.0,12,0,12
,PRI,2013.0,119,0,119
,FJI,2018.0,46,0,46
,NCL,2015.0,15,0,15
,MUS,2015.0,36,0,36
,PSE,2015.0,95,0,95
,PRY,2016.0,41,0,41
SAU,HRV,2013.0,1,0,1
UGA,ITA,2020.0,1,0,1
,ZWE,2018.0,111,0,111
GTM,,2018.0,17,0,17
,GEO,2006.0,129,0,129
MKD,SRB,2021.0,3,0,3
PRY,CZE,2015.0,1,0,1
KOR,,2002.0,439,0,439
USA,AND,2017.0,1,0,1
TUR,,2005.0,600,0,600
,LBR,2016.0,20,0,20
GBR,SEN,2020.0,1,0,1
,CUB,2018.0,399,0,399
AUS,AFG,2014.0,1,0,1
,PAN,2006.0,26,0,26
TCD,DEU,2012.0,1,0,1
,BGD,1997.0,80,0,80
AUS,ARM,2015.0,1,0,1
NGA,NLD,2013.0,3,0,3
ISR,ZAF,2022.0,2,0,2
GEO,FRA,2013.0,17,0,17
IND,HKG,2000.0,7,0,7
DJI,,2022.0,10,0,10
MMR,,2021.0,39,0,39
FJI,,2013.0,6,0,6
PRT,PSE,2016.0,1,0,1
CYP,MYS,2022.0,2,0,2
SGP,ZMB,2019.0,1,0,1
TUR,OMN,2006.0,2,0,2
GUY,,2022.0,12,0,12
ERI,,2024.0,26,0,26
BGR,,2003.0,81,0,81
NGA,UGA,2008.0,1,0,1
JPN,MEX,2000.0,5,0,5
BEL,DZA,2020.0,3,0,3
ARG,IRL,2018.0,3,0,3
MUS,,2014.0,12,0,12
DNK,KWT,2018.0,1,0,1
ITA,UGA,2011.0,2,0,2
IDN,GHA,2004.0,1,0,1
,FSM,2001.0,4,0,4
COG,,2011.0,17,0,17
,SYR,2003.0,38,0,38
CRI,,2007.0,26,0,26
,BDI,2008.0,10,0,10
,AND,2008.0,3,0,3
CAF,CHN,2006.0,1,0,1
TUN,ETH,2017.0,1,0,1
SDN,,2007.0,17,0,17
EST,AUS,2006.0,1,0,1
BIH,,2005.0,8,0,8
UKR,HKG,2001.0,1,0,1
SRB,PRT,2003.0,1,0,1
BIH,,2002.0,1,0,1
,ISL,1997.0,75,0,75
BLR,BRA,2019.0,1,0,1
SGP,RUS,2002.0,4,0,4
TZA,,2003.0,9,0,9
QAT,ITA,2022.0,1,0,1
JPN,LAO,2004.0,3,0,3
BIH,KWT,2016.0,2,0,2
PER,MYS,2015.0,3,0,3
GBR,GEO,2015.0,2,0,2
PLW,FJI,2012.0,1,0,1
TWN,ZAF,2014.0,10,0,10
FRA,AGO,2007.0,1,0,1
EGY,POL,2003.0,1,0,1
TTO,FJI,2010.0,1,0,1
PAN,,2006.0,2,0,2
NOR,VNM,2006.0,1,0,1
FIN,MEX,2008.0,1,0,1
JPN,MAR,2010.0,2,0,2
BLR,PRT,2005.0,3,0,3
MOZ,,2016.0,18,0,18
,TGO,1994.0,7,0,7
ETH,SWZ,2021.0,1,0,1
,ATA,1998.0,5,0,5
ESP,UGA,2010.0,1,0,1
ISR,PAN,2015.0,1,0,1
,VUT,2008.0,4,0,4
CUB,CHL,2008.0,3,0,3
COL,UGA,2015.0,1,0,1
,BOL,2009.0,41,0,41
VEN,BEL,2010.0,2,0,2
BEL,CIV,2021.0,2,0,2
GRL,,2016.0,3,0,3
TCD,CHN,2015.0,1,0,1
ITA,PHL,2015.0,2,0,2
SGP,ARE,2013.0,4,0,4
MNG,FRA,2014.0,1,0,1
CZE,ARM,2018.0,1,0,1
NGA,NZL,2018.0,3,0,3
KWT,ESP,2020.0,1,0,1
,HTI,2002.0,6,0,6
MOZ,SEN,2017.0,1,0,1
PRT,VNM,2018.0,2,0,2
KHM,NOR,2021.0,1,0,1
UGA,NZL,2018.0,2,0,2
TUR,,2002.0,91,0,91
HUN,EGY,2010.0,2,0,2
SYR,,2014.0,41,0,41
,LUX,1996.0,16,0,16
LVA,FIN,2000.0,1,0,1
PRT,SGP,2010.0,2,0,2
GUF,,2021.0,8,0,8
IDN,CMR,2009.0,2,0,2
VNM,IRN,2022.0,12,0,12
,MRT,2011.0,7,0,7
NIC,GBR,2019.0,1,0,1
EGY,HUN,2011.0,3,0,3
FLK,CAN,2020.0,1,0,1
UKR,CHE,2012.0,4,0,4
VEN,PRT,2012.0,1,0,1
ECU,RWA,2021.0,1,0,1
CAN,MLT,2014.0,1,0,1
NIC,GBR,2017.0,1,0,1
IND,UGA,2009.0,1,0,1
ARG,PAN,2020.0,1,0,1
AUS,ZMB,2017.0,1,0,1
QAT,CUB,2019.0,2,0,2
GNB,,2021.0,5,0,5
MLI,,2005.0,6,0,6
IDN,KEN,2002.0,2,0,2
VNM,KEN,2022.0,2,0,2
ESP,PHL,2003.0,1,0,1
ITA,SYR,2004.0,2,0,2
,ZMB,1998.0,20,0,20
NLD,LBY,2016.0,1,0,1
BRA,LKA,2004.0,1,0,1
,PYF,2001.0,12,0,12
EGY,IND,2004.0,2,0,2
NOR,FRO,2005.0,2,0,2
PAK,SWE,2000.0,1,0,1
FRA,LIE,1998.0,1,0,1
NGA,CUB,2004.0,2,0,2
AZE,DNK,2013.0,1,0,1
SVN,ZAF,2020.0,1,0,1
PNG,,2007.0,12,0,12
,HTI,2005.0,8,0,8
NZL,PNG,2012.0,1,0,1
SYR,MEX,2013.0,2,0,2
CHL,PRY,2018.0,1,0,1
NLD,ARE,2013.0,3,0,3
BMU,,2008.0,1,0,1
SYR,ARE,2015.0,3,0,3
JOR,KWT,2010.0,5,0,5
KEN,HUN,2021.0,3,0,3
AUS,LBY,2017.0,2,0,2
VNM,DNK,2010.0,2,0,2
JPN,TUN,2003.0,1,0,1
NGA,MDV,2021.0,1,0,1
IRN,LBN,2014.0,1,0,1
BTN,GBR,2019.0,2,0,2
BOL,COL,2015.0,2,0,2
CHE,SOM,2018.0,1,0,1
UKR,MEX,2017.0,2,0,2
COL,NZL,2019.0,4,0,4
AUT,QAT,2020.0,1,0,1
TUR,TCD,2021.0,1,0,1
PAK,BHR,2014.0,1,0,1
,ZMB,1997.0,8,0,8
CAN,GRL,2022.0,1,0,1
AND,,2011.0,2,0,2
AZE,USA,2008.0,1,0,1
JPN,UGA,2021.0,2,0,2
ROU,AUS,2016.0,3,0,3
HTI,,2014.0,6,0,6
TWN,JOR,2017.0,2,0,2
ESP,MYS,2009.0,3,0,3
SGP,BRN,2005.0,1,0,1
SVN,PRT,2013.0,1,0,1
BRA,GTM,2018.0,1,0,1
OMN,KAZ,2019.0,1,0,1
ALB,NLD,2012.0,1,0,1
JPN,MAR,2019.0,1,0,1
GTM,GBR,2013.0,1,0,1
BFA,DNK,2018.0,1,0,1
EGY,BRN,2015.0,2,0,2
GBR,SYR,2021.0,2,0,2
MNE,AUT,2022.0,1,0,1
EGY,BGR,2020.0,1,0,1
PRT,MAC,2004.0,1,0,1
HRV,ISR,2019.0,1,0,1
LBN,BGD,2020.0,1,0,1
SWE,GRL,2020.0,1,0,1
HRV,DNK,2005.0,1,0,1
SGP,MEX,2005.0,1,0,1
GHA,UGA,2021.0,2,0,2
IRL,BGR,2012.0,1,0,1
CZE,MYS,2013.0,2,0,2
YEM,,2008.0,15,0,15
USA,LBY,2002.0,3,0,3
UZB,KGZ,2012.0,1,0,1
HUN,ARE,2016.0,2,0,2
LAO,TWN,2008.0,1,0,1
SAU,LBY,2008.0,1,0,1
ISR,ETH,2006.0,1,0,1
SVN,TUR,1998.0,3,0,3
AUS,PRY,2001.0,1,0,1
,GTM,2001.0,10,0,10
FJI,JAM,2004.0,1,0,1
NLD,OMN,2005.0,2,0,2
DNK,LKA,2013.0,1,0,1
NIC,USA,2001.0,1,0,1
UZB,CHN,2013.0,1,0,1
BEL,LVA,2012.0,1,0,1
KEN,MYS,2014.0,1,0,1
ISR,QAT,2011.0,1,0,1
HKG,ZAF,2020.0,5,0,5
MDG,MEX,2013.0,1,0,1
ROU,SVN,2016.0,1,0,1
,MTQ,2011.0,5,0,5
,GLP,2016.0,2,0,2
NGA,VNM,2020.0,2,0,2
TUR,NZL,2013.0,3,0,3
FIN,BGR,2008.0,1,0,1
CMR,CHE,2013.0,3,0,3
ISR,CHL,2022.0,1,0,1
ARG,SWE,2021.0,5,0,5
BGD,EGY,2017.0,1,0,1
AUT,GAB,2021.0,2,0,2
TON,,2022.0,2,0,2
BGD,SAU,2005.0,2,0,2
SVN,BIH,2016.0,1,0,1
NIC,,2007.0,5,0,5
TUR,CYP,2006.0,2,0,2
VEN,SAU,2015.0,1,0,1
MEX,NZL,2006.0,3,0,3
KEN,AUT,2000.0,1,0,1
TTO,BEL,2019.0,1,0,1
ESP,CRI,2001.0,1,0,1
DNK,NER,2006.0,1,0,1
FIN,BEL,1999.0,3,0,3
PHL,GRC,2005.0,1,0,1
BFA,BEN,2005.0,2,0,2
TUN,ETH,2019.0,1,0,1
ROU,SGP,2005.0,2,0,2
SEN,TWN,2010.0,1,0,1
MLT,USA,1998.0,1,0,1
SVK,BEL,2007.0,3,0,3
SUR,USA,2012.0,1,0,1
ARM,CZE,2020.0,1,0,1
NER,JPN,2011.0,1,0,1
POL,LUX,2021.0,2,0,2
NZL,GUM,2018.0,1,0,1
THA,HKG,1997.0,1,0,1
NLD,SDN,2015.0,1,0,1
CHL,ARG,1998.0,1,0,1
FJI,MYS,2010.0,2,0,2
ECU,CAN,2013.0,1,0,1
UGA,DNK,2021.0,1,0,1
HRV,ISR,2017.0,3,0,3
KOR,JOR,2014.0,3,0,3
NGA,ESP,2020.0,1,0,1
FRA,SDN,2019.0,1,0,1
CHE,MUS,2017.0,1,0,1
CHN,ZMB,2021.0,4,0,4
ECU,DEU,2007.0,2,0,2
POL,IDN,2019.0,1,0,1
,SYC,2014.0,3,0,3
SWE,LKA,2020.0,1,0,1
BEL,NER,2007.0,1,0,1
MDA,KOR,2009.0,1,0,1
CIV,BFA,2009.0,4,0,4
EST,BEL,2005.0,2,0,2
MEX,AUT,2008.0,2,0,2
CAF,FRA,2013.0,2,0,2
COL,LKA,2017.0,1,0,1
NZL,UGA,2006.0,1,0,1
GNQ,TZA,2019.0,2,0,2
CHE,MNG,2007.0,1,0,1
CHL,TUN,2018.0,1,0,1
TUN,IRL,2018.0,1,0,1
DZA,TGO,2020.0,1,0,1
POL,PAK,2017.0,1,0,1
BRA,SVN,2021.0,1,0,1
TUN,OMN,2001.0,1,0,1
FRA,AND,2005.0,1,0,1
KEN,GMB,2014.0,1,0,1
ZWE,LSO,2011.0,1,0,1
TWN,AUT,2007.0,2,0,2
OMN,IRQ,2016.0,2,0,2
SLV,,2006.0,3,0,3
CZE,YEM,2012.0,2,0,2
SRB,FIN,2021.0,1,0,1
KHM,RUS,2017.0,1,0,1
,HND,1998.0,4,0,4
SWE,SDN,2005.0,1,0,1
NAM,DEU,2007.0,1,0,1
SEN,COG,2006.0,1,0,1
BWA,HUN,2016.0,1,0,1
OMN,BHR,2013.0,1,0,1
AUT,IRN,2003.0,1,0,1
TUR,UKR,2022.0,1,0,1
TUR,MEX,2003.0,1,0,1
,BRN,1995.0,7,0,7
TTO,TCA,2020.0,1,0,1
SEN,CIV,2012.0,3,0,3
MYS,SDN,2003.0,1,0,1
TWN,EGY,2004.0,1,0,1
CAN,SLB,2001.0,1,0,1
GRC,CHE,2000.0,3,0,3
SVK,PRT,2002.0,1,0,1
ESP,ZAF,2006.0,3,0,3
CYP,IRL,2016.0,1,0,1
NLD,CMR,2008.0,1,0,1
NPL,RUS,2006.0,1,0,1
CHE,TUN,2007.0,3,0,3
RWA,ZMB,2013.0,1,0,1
ZAF,SGP,2012.0,2,0,2
IND,ECU,2014.0,2,0,2
IRN,AUS,2023.0,1,0,1
MCO,ROU,2019.0,1,0,1
CHE,SWZ,2020.0,1,0,1
GHA,JAM,2019.0,1,0,1
NCL,FJI,2020.0,2,0,2
RWA,SLE,2020.0,1,0,1
LAO,DEU,2013.0,1,0,1
LBN,KWT,2010.0,1,0,1
SRB,HUN,2003.0,1,0,1
NLD,SUR,2011.0,1,0,1
COG,IND,2016.0,1,0,1
CHE,MUS,2019.0,3,0,3
PNG,FRA,2004.0,1,0,1
HUN,ZAF,2005.0,1,0,1
SEN,MDG,2009.0,1,0,1
POL,HKG,2012.0,1,0,1
SVK,CHN,2020.0,2,0,2
THA,ITA,2003.0,1,0,1
CHN,UKR,2001.0,2,0,2
CHL,THA,2003.0,1,0,1
USA,GRD,2004.0,2,0,2
IRL,CHE,2000.0,1,0,1
SDN,USA,1998.0,1,0,1
SDN,JPN,2008.0,2,0,2
VEN,IDN,2019.0,1,0,1
CYP,ARE,2014.0,1,0,1
GRC,MAR,2019.0,1,0,1
NOR,QAT,2015.0,2,0,2
TUN,BEL,2012.0,3,0,3
QAT,VNM,2019.0,1,0,1
ARM,CHL,2013.0,1,0,1
CZE,IDN,2016.0,1,0,1
PAN,COL,2020.0,2,0,2
FRA,TZA,2004.0,1,0,1
IND,COL,2002.0,2,0,2
IRN,MAR,2005.0,1,0,1
GRC,SVK,2017.0,1,0,1
KWT,PAN,2018.0,1,0,1
MDG,CHN,2019.0,1,0,1
CZE,NPL,2019.0,1,0,1
GAB,USA,2007.0,1,0,1
SVK,FIN,2011.0,1,0,1
GBR,PRI,2018.0,1,0,1
ERI,NAM,2009.0,1,0,1
NZL,EGY,2014.0,1,0,1
ARE,TUN,2008.0,1,0,1
TUR,MKD,2019.0,1,0,1
MEX,VNM,2019.0,2,0,2
SDN,ETH,2011.0,1,0,1
TZA,COL,2020.0,1,0,1
BEL,LKA,2021.0,1,0,1
AUS,NAM,2013.0,1,0,1
GHA,ISR,2011.0,1,0,1
GBR,NCL,2016.0,1,0,1
PHL,NOR,2020.0,2,0,2
MOZ,CUB,2003.0,1,0,1
DEU,NIC,2010.0,1,0,1
AUS,KNA,2022.0,1,0,1
MDA,POL,2015.0,1,0,1
NLD,KGZ,2017.0,1,0,1
AUS,BGR,2016.0,1,0,1
MCO,ESP,2020.0,1,0,1
TZA,UGA,2004.0,1,0,1
THA,NOR,2010.0,2,0,2
BFA,NGA,2003.0,2,0,2
TWN,SRB,2005.0,1,0,1
USA,LAO,2008.0,1,0,1
COL,AUS,2004.0,2,0,2
PRT,IRL,2002.0,2,0,2
BLR,PRT,2002.0,1,0,1
SEN,CAN,2005.0,1,0,1
TUR,PSE,2004.0,1,0,1
BFA,ITA,2003.0,1,0,1
COL,ISR,2009.0,1,0,1
ITA,EST,2013.0,3,0,3
SGP,GHA,2008.0,1,0,1
ZMB,CHN,2017.0,1,0,1
ITA,NCL,2018.0,1,0,1
ARG,NIC,2017.0,1,0,1
THA,CYP,2019.0,1,0,1
ZWE,NZL,2022.0,1,0,1
USA,BRN,2001.0,3,0,3
PAK,AFG,2013.0,1,0,1
GBR,MOZ,2007.0,1,0,1
MKD,GBR,2003.0,1,0,1
JAM,DEU,2001.0,1,0,1
COG,ZWE,2004.0,1,0,1
HUN,GEO,2011.0,1,0,1
SGP,HRV,2017.0,1,0,1
,DJI,2016.0,5,0,5
CIV,SEN,2022.0,1,0,1
UKR,MEX,2010.0,2,0,2
HUN,KGZ,2017.0,1,0,1
SRB,AUT,2005.0,1,0,1
TWN,MEX,2005.0,1,0,1
NCL,DEU,2010.0,1,0,1
DNK,GHA,2017.0,1,0,1
VEN,BEL,2019.0,2,0,2
NZL,KHM,2016.0,1,0,1
TWN,JOR,2019.0,3,0,3
CHE,ARE,2014.0,1,0,1
TUN,CMR,2008.0,1,0,1
FIN,TUR,2001.0,1,0,1
HUN,NOR,2001.0,2,0,2
USA,NCL,2007.0,1,0,1
HKG,TUR,2003.0,2,0,2
KGZ,RUS,2000.0,1,0,1
EGY,MYS,2003.0,1,0,1
DNK,PSE,2011.0,1,0,1
SGP,RUS,2005.0,2,0,2
TWN,LTU,2016.0,1,0,1
BHR,QAT,2012.0,1,0,1
KOR,LBN,2019.0,1,0,1
SYR,TWN,2006.0,1,0,1
QAT,TWN,2010.0,1,0,1
KEN,SSD,2017.0,1,0,1
URY,AUT,2002.0,1,0,1
TUR,BIH,2012.0,2,0,2
ERI,THA,2019.0,1,0,1
NLD,SLE,2020.0,3,0,3
BGD,KWT,2009.0,1,0,1
MLI,SEN,2022.0,1,0,1
IND,GHA,2001.0,1,0,1
TCD,FRA,2003.0,1,0,1
SGP,CYP,2011.0,1,0,1
KOR,ARE,2012.0,1,0,1
ITA,KEN,2013.0,1,0,1
TWN,QAT,2014.0,1,0,1
LTU,BLR,2010.0,1,0,1
HRV,BEL,2005.0,1,0,1
POL,MYS,2021.0,1,0,1
VEN,KWT,2017.0,1,0,1
CHN,HUN,2015.0,1,0,1
PHL,IND,2004.0,2,0,2
KWT,IRQ,2022.0,1,0,1
ZAF,SEN,2005.0,1,0,1
GBR,REU,2010.0,1,0,1
FRA,BHR,2015.0,1,0,1
CUB,PRT,2000.0,1,0,1
BGR,BGD,2010.0,1,0,1
PAK,YEM,2009.0,1,0,1
JOR,POL,2021.0,1,0,1
MEX,BLZ,2019.0,1,0,1
GRL,GRC,2014.0,1,0,1
PNG,FIN,2021.0,1,0,1
ZWE,FRA,2019.0,1,0,1
CHE,IRQ,2014.0,1,0,1
OMN,KAZ,2017.0,1,0,1
HKG,ROU,2008.0,1,0,1
ETH,NOR,2004.0,2,0,2
COL,IRN,2020.0,1,0,1
VEN,FIN,2019.0,1,0,1
NCL,DEU,2019.0,1,0,1
BGR,DNK,2021.0,2,0,2
SYR,GHA,2012.0,1,0,1
CUB,JPN,2000.0,1,0,1
GBR,MDG,2008.0,2,0,2
TUN,KWT,2015.0,1,0,1
GBR,EST,1999.0,1,0,1
BLR,MEX,2016.0,1,0,1
GHA,LKA,2011.0,1,0,1
MCO,AUS,2019.0,1,0,1
SWE,ZWE,2011.0,1,0,1
BOL,FRA,2016.0,1,0,1
AFG,NLD,2008.0,1,0,1
BDI,RWA,2016.0,1,0,1
ITA,COG,2012.0,1,0,1
FJI,WSM,2020.0,1,0,1
HRV,GRC,2020.0,1,0,1
COG,MLI,2019.0,1,0,1
SGP,EGY,2022.0,1,0,1
PHL,GRC,2002.0,2,0,2
SEN,ESP,2018.0,1,0,1
TTO,TUR,2020.0,1,0,1
MYS,NLD,1999.0,1,0,1
IRL,JOR,2018.0,1,0,1
MDG,BEL,2014.0,1,0,1
UKR,PRI,2006.0,1,0,1
ZWE,SWE,2006.0,1,0,1
,GRL,2018.0,3,0,3
HUN,PRT,2006.0,1,0,1
NZL,KEN,2015.0,2,0,2
FRO,ISL,2018.0,1,0,1
ZWE,DEU,2013.0,1,0,1
BRA,AGO,2013.0,1,0,1
MNG,CHN,2012.0,1,0,1
BEL,GMB,2002.0,1,0,1
GBR,KOR,2023.0,1,0,1
NOR,UGA,2008.0,1,0,1
TUR,ALB,2014.0,1,0,1
TWN,CRI,2013.0,1,0,1
DZA,QAT,2019.0,1,0,1
SWZ,CMR,2011.0,1,0,1
KWT,ITA,2014.0,2,0,2
QAT,CZE,2016.0,1,0,1
PRT,LTU,2018.0,1,0,1
UGA,SVK,2019.0,2,0,2
,CAF,2018.0,1,0,1
MRT,MAR,2016.0,1,0,1
VNM,EST,2016.0,1,0,1
ROU,CMR,2015.0,1,0,1
MKD,CZE,2020.0,1,0,1
PER,PRT,2007.0,1,0,1
DNK,SVN,2013.0,1,0,1
MLI,BEN,2009.0,1,0,1
NLD,UGA,2022.0,1,0,1
NGA,PAK,2005.0,1,0,1
ROU,PRT,2007.0,1,0,1
BFA,COG,2010.0,1,0,1
AUS,SLV,2013.0,1,0,1
CAN,BGR,2011.0,2,0,2
THA,SEN,2010.0,1,0,1
NER,BFA,1998.0,1,0,1
GHA,BWA,2003.0,1,0,1
BGR,BRA,2004.0,1,0,1
ETH,MEX,2004.0,1,0,1
RUS,CMR,2011.0,1,0,1
MEX,OMN,2004.0,1,0,1
DZA,AUT,2019.0,1,0,1
TUR,SDN,2013.0,1,0,1
VEN,COL,1999.0,1,0,1
JOR,OMN,2014.0,3,0,3
CRI,NIC,2018.0,1,0,1
TWN,GRC,2013.0,1,0,1
ITA,NAM,2014.0,1,0,1
JPN,QAT,2013.0,1,0,1
NOR,ROU,2016.0,1,0,1
MYS,ESP,2004.0,1,0,1
OMN,TCA,2015.0,1,0,1
AUS,LBY,2010.0,1,0,1
SDN,KWT,2021.0,1,0,1
GUM,GLP,2021.0,1,0,1
DJI,ETH,2021.0,1,0,1
ALB,SWE,2003.0,1,0,1
SAU,TUN,1998.0,1,0,1
USA,MNE,2001.0,1,0,1
GMB,JPN,1999.0,1,0,1
ZMB,ZAF,2001.0,1,0,1
NGA,ITA,2018.0,1,0,1
RUS,SRB,2022.0,1,0,1
ISR,ARG,2012.0,1,0,1
COL,AUT,2007.0,1,0,1
MYS,HUN,2000.0,1,0,1
SLB,JPN,2002.0,1,0,1
MCO,AUS,2010.0,1,0,1
CHN,ROU,2005.0,1,0,1
BGD,JOR,2002.0,1,0,1
VNM,ITA,2000.0,1,0,1
VEN,BEL,2017.0,1,0,1
TTO,AUS,2012.0,1,0,1
BEL,MOZ,2008.0,1,0,1
DNK,PRY,2007.0,1,0,1
POL,NGA,2000.0,1,0,1
BRA,ETH,2000.0,1,0,1
BRA,PRI,2003.0,1,0,1
HRV,KWT,2011.0,1,0,1
THA,BRA,2013.0,1,0,1
RUS,ARG,2000.0,1,0,1
JPN,MAR,2017.0,1,0,1
BLR,LBY,2020.0,1,0,1
CHE,ITA,2023.0,1,0,1
CHE,MRT,2015.0,1,0,1
KOR,LUX,2022.0,1,0,1
SVN,SWE,2009.0,1,0,1
HUN,VNM,2018.0,1,0,1
EST,IRL,1998.0,1,0,1
MYS,ISL,2022.0,1,0,1
ITA,USA,2005.0,403,310,93
DEU,RUS,2005.0,84,125,-41
DNK,DEU,2013.0,78,95,-17
GBR,IND,2017.0,174,191,-17
DEU,CHN,2010.0,133,188,-55
GBR,TWN,2005.0,37,16,21
CHN,AUS,2011.0,181,90,91
ARE,JOR,2020.0,10,24,-14
USA,CAN,1999.0,350,532,-182
CAN,EST,2011.0,3,1,2
GBR,SWE,2010.0,112,110,2
FRA,USA,2015.0,848,673,175
SWE,DNK,2006.0,63,42,21
USA,SWE,2011.0,203,180,23
GBR,MEX,2015.0,59,46,13
BEL,FRA,2015.0,171,203,-32
FRA,MAR,2013.0,88,34,54
CAN,JPN,2014.0,63,80,-17
LBN,ARE,2016.0,1,1,0
FRA,COL,2015.0,13,18,-5
USA,KOR,2013.0,1018,719,299
GBR,CAN,2015.0,364,372,-8
GRC,GBR,2009.0,121,134,-13
SWE,NOR,2015.0,57,50,7
BRA,GBR,2013.0,53,63,-10
FRA,BEL,2008.0,165,143,22
BRA,CHL,2011.0,15,13,2
GBR,IND,2019.0,171,274,-103
ITA,BRA,2011.0,36,33,3
CAN,FRA,2007.0,210,244,-34
NLD,GBR,2003.0,149,135,14
ESP,USA,2008.0,331,319,12
ITA,FRA,2011.0,310,152,158
JPN,CHN,2007.0,368,201,167
EGY,SAU,2016.0,176,188,-12
GBR,SWE,2017.0,177,124,53
THA,VNM,2013.0,5,2,3
ITA,BEL,2010.0,64,29,35
PAK,DEU,2011.0,17,20,-3
GBR,IND,2010.0,114,119,-5
JPN,GRC,2018.0,2,1,1
CHN,DNK,2013.0,39,19,20
NLD,CZE,2015.0,11,6,5
ESP,FRA,2016.0,302,185,117
ITA,USA,2002.0,502,469,33
MOZ,BRA,2009.0,3,1,2
ESP,SWE,2008.0,26,33,-7
IND,CHL,2011.0,2,2,0
COL,CHL,2020.0,38,23,15
DEU,RUS,2002.0,106,207,-101
NLD,MEX,2011.0,9,13,-4
IND,GBR,2020.0,317,195,122
FRA,RUS,2010.0,25,47,-22
USA,GRD,2015.0,7,10,-3
USA,GRC,2014.0,70,140,-70
CAN,THA,2021.0,9,7,2
TUR,USA,2017.0,306,253,53
BEL,ITA,2006.0,30,29,1
JPN,USA,1997.0,130,205,-75
USA,DNK,2009.0,113,82,31
BRA,CHE,2020.0,33,15,18
AUS,USA,2013.0,444,640,-196
IRN,USA,2011.0,229,52,177
CAN,GRC,2010.0,7,9,-2
USA,CZE,2016.0,50,44,6
MYS,SGP,2005.0,3,7,-4
USA,PRT,2004.0,36,28,8
IRN,BEL,2012.0,13,10,3
SVK,USA,2013.0,12,8,4
DNK,AUT,2018.0,9,9,0
JPN,BGR,2012.0,2,2,0
ESP,BRA,2019.0,70,98,-28
RUS,CHE,2011.0,35,9,26
SWE,CHN,2002.0,21,28,-7
TUR,USA,2019.0,298,253,45
IND,NLD,2020.0,54,37,17
DEU,CHN,2019.0,394,389,5
SVK,CZE,2021.0,39,34,5
AUS,SAU,2016.0,60,16,44
ITA,IRL,2018.0,43,19,24
TWN,JPN,2018.0,62,43,19
DEU,SWE,2020.0,189,144,45
DEU,CHN,2017.0,333,341,-8
BGD,DEU,2002.0,4,1,3
NLD,POL,2013.0,31,16,15
GBR,DEU,2021.0,513,431,82
BEL,ECU,2019.0,7,3,4
ESP,BRA,2017.0,86,90,-4
CUB,ESP,2010.0,26,12,14
GBR,PAK,2014.0,64,34,30
FIN,THA,2021.0,1,2,-1
FRA,PAK,2017.0,23,7,16
USA,BRA,2021.0,234,449,-215
CAN,ARE,2021.0,14,22,-8
FRA,PAK,2019.0,14,12,2
CHN,NLD,2014.0,90,63,27
HKG,AUS,2021.0,35,25,10
CHE,LKA,2019.0,3,1,2
EGY,USA,2016.0,92,103,-11
GBR,NGA,2017.0,73,32,41
FRA,ROU,2021.0,17,9,8
IRN,DEU,2020.0,137,23,114
SRB,ITA,2016.0,6,8,-2
FRA,RUS,2019.0,37,45,-8
EST,GBR,2015.0,7,6,1
JPN,VNM,2019.0,71,30,41
JPN,FRA,2022.0,25,32,-7
ETH,USA,2015.0,21,22,-1
IRN,KOR,2022.0,14,3,11
GHA,ZAF,2022.0,9,8,1
KOR,AUS,2016.0,46,28,18
GBR,EGY,2018.0,38,25,13
ZAF,ZWE,2019.0,35,25,10
ISR,IND,2022.0,44,41,3
GBR,FIN,2015.0,51,65,-14
GBR,NGA,2019.0,84,51,33
KOR,FRA,2016.0,27,24,3
IND,ARE,2014.0,32,8,24
AUS,PNG,2019.0,8,10,-2
FRA,SWE,2019.0,90,69,21
CHN,TWN,2018.0,81,205,-124
POL,GBR,2006.0,30,19,11
ITA,CHN,2021.0,48,49,-1
HKG,TWN,2006.0,10,4,6
IRQ,GBR,2016.0,18,41,-23
USA,CRI,2016.0,26,13,13
CHE,DNK,2009.0,25,15,10
CHN,BRA,2015.0,5,5,0
NZL,BRA,2012.0,4,4,0
TWN,USA,2021.0,157,133,24
ZAF,ZWE,2017.0,23,23,0
JPN,VNM,2017.0,63,22,41
GBR,IDN,2014.0,14,9,5
GBR,CZE,2017.0,33,34,-1
BIH,SRB,2014.0,11,11,0
BEL,IRN,2019.0,14,18,-4
AUS,NOR,2018.0,18,15,3
TUR,IRN,2021.0,14,41,-27
FIN,CAN,2019.0,19,13,6
ITA,BEL,2019.0,117,79,38
DEU,NLD,1999.0,82,47,35
FRA,CHL,2020.0,34,37,-3
IRN,PSE,2019.0,1,1,0
BRA,FIN,2021.0,18,2,16
BRA,PRT,2018.0,128,132,-4
ITA,AUT,2013.0,41,34,7
GBR,SWE,2019.0,184,147,37
COL,ECU,2017.0,5,5,0
AUS,BEL,2020.0,23,35,-12
GHA,CAN,2014.0,6,4,2
AUS,IND,2009.0,33,73,-40
DNK,TUR,2018.0,4,12,-8
ITA,AUS,2020.0,45,40,5
FRA,RUS,2017.0,53,41,12
GBR,SAU,2014.0,113,34,79
TUN,MAR,2013.0,1,1,0
IND,OMN,2014.0,18,13,5
GBR,HKG,2017.0,54,55,-1
NGA,AUS,2019.0,12,4,8
DEU,EGY,2021.0,27,26,1
BRA,IRL,2021.0,14,3,11
IRN,ESP,2019.0,30,9,21
ITA,SWE,2021.0,51,34,17
IDN,JPN,2014.0,23,142,-119
GBR,HKG,2019.0,47,73,-26
DEU,ISR,2013.0,41,43,-2
CHE,CZE,2019.0,12,19,-7
ITA,BEL,2017.0,102,66,36
SAU,EGY,2001.0,18,26,-8
FRA,IDN,2021.0,6,2,4
FRA,SWE,2017.0,83,50,33
ESP,EST,2018.0,2,4,-2
ITA,CHE,2000.0,37,41,-4
DEU,JPN,2003.0,69,103,-34
GBR,HKG,2010.0,36,42,-6
SWE,NLD,2009.0,28,29,-1
ARE,PAK,2022.0,7,10,-3
GRC,DEU,2013.0,87,41,46
CAN,ESP,2011.0,44,46,-2
JPN,USA,1998.0,249,263,-14
HTI,USA,2018.0,5,4,1
UKR,POL,2011.0,11,9,2
VNM,USA,2020.0,29,48,-19
SAU,SWE,2019.0,3,7,-4
FRA,SWE,2010.0,53,57,-4
NGA,CHE,2018.0,6,4,2
BEL,IRN,2010.0,7,11,-4
DEU,SRB,2011.0,8,10,-2
FRA,PAK,2010.0,9,10,-1
GBR,MNG,2015.0,2,1,1
BEL,AUT,2012.0,5,8,-3
JOR,BHR,2009.0,1,1,0
GBR,MUS,2021.0,1,2,-1
FIN,CAN,2010.0,11,15,-4
TUR,AUT,2018.0,13,4,9
IND,NGA,2010.0,3,2,1
AUS,JPN,2012.0,46,66,-20
SGP,SWE,2006.0,4,6,-2
SGP,CAN,2009.0,26,28,-2
CHE,SVN,2012.0,1,5,-4
SGP,GBR,2014.0,73,123,-50
IND,DEU,2001.0,42,34,8
DEU,IRN,2014.0,32,77,-45
FIN,CHE,2009.0,17,5,12
NLD,VNM,2018.0,6,4,2
GBR,IRL,2007.0,156,126,30
USA,URY,2015.0,12,12,0
FIN,ITA,2014.0,13,18,-5
BEL,CMR,2009.0,1,4,-3
IRL,DEU,2009.0,17,39,-22
JPN,FIN,2020.0,14,11,3
JPN,GBR,1998.0,27,24,3
SGP,CHN,2001.0,12,59,-47
EGY,ESP,2018.0,7,13,-6
PRT,CAN,2006.0,3,4,-1
AUS,IRL,2003.0,24,14,10
ESP,CHL,2007.0,32,14,18
ESP,ITA,2001.0,50,58,-8
FRA,GBR,2000.0,94,88,6
NZL,AUS,1999.0,33,21,12
GAB,USA,2008.0,2,1,1
IRN,ETH,2018.0,2,4,-2
ITA,NOR,2016.0,25,11,14
SRB,DEU,2014.0,15,7,8
POL,CAN,2013.0,17,31,-14
MAR,SDN,2020.0,1,1,0
IND,NGA,2017.0,8,6,2
MCO,FRA,2018.0,6,7,-1
CHN,CHL,2019.0,6,5,1
BEL,IRN,2017.0,7,14,-7
BEL,TWN,2010.0,3,1,2
VEN,ARG,2017.0,1,1,0
ISL,LUX,2018.0,1,1,0
TWN,DNK,2019.0,2,2,0
NPL,AUS,2021.0,11,4,7
MDA,ROU,2017.0,5,2,3
TUR,FRA,2020.0,24,10,14
SYR,EGY,2021.0,3,1,2
MWI,USA,2009.0,7,12,-5
NLD,PRT,2013.0,15,20,-5
CHE,PAK,2018.0,7,6,1
GBR,URY,2020.0,2,3,-1
SEN,KEN,2019.0,1,1,0
SAU,JOR,2016.0,34,32,2
SRB,GBR,2006.0,5,6,-1
USA,PER,1998.0,3,3,0
CHE,SGP,2021.0,9,18,-9
NLD,ESP,2021.0,50,69,-19
USA,DOM,2019.0,5,2,3
ALB,ITA,2021.0,6,5,1
GBR,ESP,1999.0,62,52,10
IRN,IRL,2018.0,11,3,8
DEU,SVK,2016.0,7,10,-3
ETH,NOR,2015.0,4,2,2
KOR,VNM,2004.0,2,1,1
GUF,FRA,2005.0,9,2,7
AUS,ESP,2013.0,13,47,-34
EGY,GBR,2007.0,18,25,-7
DEU,HUN,2005.0,35,39,-4
NGA,AUS,2010.0,1,1,0
ITA,MYS,2018.0,3,5,-2
USA,KEN,2009.0,23,22,1
BHR,SAU,2012.0,1,1,0
ESP,BRA,2010.0,46,48,-2
CAN,ETH,2010.0,2,1,1
LKA,IND,2009.0,3,4,-1
FIN,CAN,2017.0,18,14,4
ISR,GBR,2011.0,39,33,6
SWE,JPN,2008.0,23,30,-7
RUS,CUB,2017.0,1,2,-1
NLD,MKD,2016.0,2,3,-1
HKG,FRA,2005.0,4,2,2
FRA,HRV,2015.0,7,7,0
CRI,COL,2015.0,5,2,3
FRA,GLP,2015.0,11,18,-7
JPN,POL,2019.0,9,8,1
NLD,AUS,2008.0,48,39,9
CAN,AUS,1998.0,21,10,11
GEO,USA,2005.0,7,13,-6
SWE,FRA,2005.0,36,29,7
UKR,ITA,2009.0,4,1,3
CAN,AUS,1997.0,7,17,-10
ECU,USA,2013.0,16,19,-3
MEX,ESP,1999.0,11,25,-14
AUS,SWE,2007.0,27,27,0
BWA,USA,2004.0,3,4,-1
FRA,NOR,2010.0,28,14,14
SRB,USA,2000.0,13,5,8
RUS,MEX,1999.0,10,3,7
LBN,FRA,2001.0,8,13,-5
GMB,GBR,2009.0,9,6,3
DEU,HUN,2002.0,34,41,-7
VNM,CHE,2010.0,1,2,-1
GRC,ITA,2000.0,3,8,-5
SGP,IND,2001.0,6,9,-3
CYP,CAN,2009.0,1,1,0
GBR,KWT,2000.0,2,2,0
CHL,USA,1997.0,10,9,1
KOR,BGD,2011.0,16,11,5
JPN,RUS,2007.0,18,20,-2
ESP,CAN,2001.0,19,19,0
SWE,FRA,2002.0,47,45,2
ZAF,SWE,2009.0,3,4,-1
HRV,BIH,2011.0,9,4,5
MYS,GBR,1999.0,4,8,-4
PRT,FRA,2004.0,12,33,-21
BRA,NOR,2016.0,7,6,1
ITA,JPN,2005.0,14,14,0
RUS,NLD,1997.0,5,4,1
GRC,ESP,2001.0,6,6,0
BEN,FRA,2003.0,6,3,3
SVK,RUS,2021.0,4,3,1
CAN,ITA,2004.0,25,31,-6
VNM,CHE,2019.0,5,5,0
CAN,ETH,2019.0,7,6,1
MEX,CUB,1999.0,4,3,1
USA,TTO,2015.0,7,2,5
JPN,EGY,2009.0,46,23,23
JOR,SAU,2012.0,34,7,27
CAN,NZL,2011.0,30,28,2
ZWE,CHE,2012.0,2,1,1
FRA,CRI,2004.0,2,3,-1
GBR,TWN,2002.0,22,17,5
CHE,SWE,2000.0,5,7,-2
SGP,MYS,2007.0,8,1,7
RUS,BLR,1999.0,3,9,-6
ARG,NLD,2006.0,5,4,1
DNK,ITA,2003.0,11,12,-1
SYR,DEU,2015.0,6,4,2
ITA,JPN,2002.0,19,21,-2
ISL,USA,2003.0,11,11,0
ROU,DEU,1997.0,5,1,4
FRA,TUR,2002.0,5,4,1
HRV,ITA,1999.0,3,1,2
SWE,HUN,2011.0,4,8,-4
FRA,CZE,2008.0,15,12,3
JOR,USA,2006.0,11,34,-23
AUT,POL,2020.0,5,10,-5
HUN,CHE,2003.0,10,5,5
BRA,ZAF,2001.0,2,1,1
SWE,POL,2009.0,12,13,-1
AUS,SGP,2000.0,7,7,0
NLD,IRL,2019.0,14,15,-1
DNK,RUS,1997.0,6,5,1
ISR,ESP,2020.0,8,15,-7
DNK,IRL,2008.0,4,2,2
NLD,IRL,2017.0,13,16,-3
SAU,LBN,2005.0,1,1,0
USA,PER,1997.0,3,2,1
ROU,DEU,1998.0,3,4,-1
SWE,CHE,2016.0,38,60,-22
CHL,VEN,2020.0,2,22,-20
AUT,SVN,2005.0,2,2,0
AUS,ZAF,2008.0,15,36,-21
RUS,CAN,2013.0,16,14,2
GBR,ARG,1999.0,10,4,6
ISR,JPN,2003.0,3,3,0
MEX,BRA,1999.0,5,3,2
TUN,USA,2014.0,5,5,0
PHL,AUS,2009.0,5,6,-1
NOR,FRA,2003.0,5,11,-6
CAN,HKG,2007.0,23,20,3
BRA,CHN,2001.0,1,2,-1
AUS,TWN,2016.0,11,19,-8
LUX,GBR,2010.0,3,5,-2
FRA,NOR,2017.0,32,19,13
EGY,BEL,2006.0,4,2,2
IND,ESP,2008.0,16,9,7
CMR,ITA,2014.0,2,2,0
ESP,CHN,2013.0,15,24,-9
TUN,BHR,2019.0,1,2,-1
NGA,UGA,2007.0,1,1,0
CHE,JPN,2012.0,30,44,-14
URY,ARG,2019.0,9,9,0
RUS,KOR,2003.0,13,13,0
MDG,USA,2009.0,5,1,4
GBR,ETH,2003.0,7,6,1
KOR,TWN,2001.0,4,3,1
MWI,GBR,2006.0,7,7,0
HUN,GBR,2000.0,8,8,0
EGY,DZA,2019.0,2,1,1
DEU,FIN,2001.0,17,14,3
EGY,FRA,2011.0,7,15,-8
USA,BRB,2017.0,1,2,-1
CAN,AUT,1997.0,2,2,0
MYS,ZAF,2014.0,3,2,1
THA,SGP,2014.0,3,8,-5
ETH,GBR,2009.0,4,3,1
SWE,ZAF,2013.0,9,6,3
CAN,UKR,2016.0,2,6,-4
USA,ARG,2021.0,48,95,-47
JPN,MNG,2016.0,10,4,6
PRI,DEU,2010.0,2,1,1
MAC,SGP,2013.0,1,1,0
CHL,DEU,2007.0,12,21,-9
MYS,YEM,2013.0,4,2,2
URY,DEU,2018.0,3,1,2
RUS,JPN,2016.0,8,17,-9
NOR,CZE,2021.0,4,3,1
KWT,USA,2020.0,12,25,-13
ZAF,AUT,2013.0,3,2,1
ZAF,BWA,2022.0,4,3,1
URY,ARG,2017.0,9,9,0
HUN,HRV,2014.0,1,1,0
CHE,CHL,2014.0,3,8,-5
POL,TUN,2018.0,2,1,1
HUN,ROU,2003.0,2,1,1
CHE,PRT,2017.0,16,19,-3
MDA,ROU,2019.0,5,3,2
SAU,SDN,2011.0,10,6,4
UKR,CAN,2020.0,3,3,0
CIV,FRA,2015.0,13,20,-7
JPN,TWN,1998.0,3,2,1
LUX,GBR,2017.0,2,8,-6
MYS,HKG,2022.0,3,1,2
USA,GTM,2014.0,3,4,-1
USA,NPL,2007.0,3,9,-6
QAT,KOR,2020.0,2,3,-1
IND,NGA,2019.0,7,5,2
DEU,NGA,2021.0,6,10,-4
MYS,KOR,2015.0,13,11,2
RUS,BGR,2019.0,8,3,5
PRT,ZAF,2011.0,4,2,2
SAU,SGP,2016.0,3,9,-6
UGA,GBR,2021.0,10,10,0
USA,UGA,2020.0,29,22,7
KOR,IRN,2020.0,6,25,-19
SGP,AUS,1998.0,5,4,1
USA,MWI,1997.0,3,1,2
PRT,BEL,2008.0,6,3,3
GBR,VEN,2005.0,8,4,4
SEN,FRA,2016.0,23,33,-10
SAU,DEU,2009.0,2,13,-11
BRA,ARG,2006.0,14,21,-7
ESP,BGR,2001.0,3,3,0
SGP,IDN,2015.0,9,5,4
CHE,QAT,2017.0,5,1,4
UKR,SWE,2009.0,6,1,5
MYS,AUS,2002.0,10,6,4
ITA,PRT,2007.0,8,5,3
CHE,KOR,2001.0,1,2,-1
NLD,CMR,2007.0,2,1,1
ITA,COL,2016.0,11,5,6
VNM,KHM,2012.0,2,2,0
CHE,GRC,2018.0,13,30,-17
FRA,KEN,2020.0,3,3,0
CAN,RUS,1999.0,3,30,-27
HUN,BEL,2016.0,8,6,2
JPN,SAU,2011.0,8,1,7
IRQ,SAU,2017.0,2,2,0
PRT,HRV,2019.0,1,3,-2
RUS,DZA,2021.0,3,1,2
USA,DOM,2017.0,4,3,1
SAU,SWE,2010.0,1,2,-1
AUS,NPL,2014.0,5,7,-2
COL,PER,2015.0,5,1,4
SVK,SRB,2019.0,2,1,1
NOR,RUS,2011.0,5,5,0
VEN,MEX,2016.0,7,3,4
VEN,CHL,2012.0,3,5,-2
JPN,CHL,2011.0,3,2,1
SVN,DEU,2012.0,10,12,-2
FRA,GEO,2020.0,18,24,-6
NZL,JPN,2020.0,10,9,1
CZE,HRV,2021.0,1,3,-2
KEN,NGA,2019.0,4,5,-1
JPN,POL,2017.0,7,12,-5
IND,EST,2020.0,6,1,5
GBR,RUS,2022.0,19,28,-9
MEX,BEL,2016.0,8,7,1
AUS,PNG,2017.0,8,12,-4
IDN,ESP,2021.0,2,1,1
DNK,RUS,1998.0,3,4,-1
FRA,GIN,2018.0,9,1,8
AUS,FIN,2011.0,12,11,1
VNM,THA,2021.0,4,21,-17
SWE,EGY,2005.0,2,2,0
PRT,HUN,2011.0,1,3,-2
AUT,SAU,2017.0,2,3,-1
GBR,ECU,2016.0,7,8,-1
CUB,CHL,2007.0,3,1,2
GBR,SRB,2005.0,5,10,-5
GBR,MLT,2013.0,7,5,2
ITA,LTU,2018.0,6,3,3
ITA,UKR,2021.0,4,7,-3
NLD,ROU,2007.0,4,3,1
POL,FIN,2018.0,9,6,3
ROU,AUT,2008.0,3,1,2
DEU,ARG,2000.0,10,5,5
AUT,RUS,2006.0,4,5,-1
CHE,HKG,2015.0,5,5,0
NOR,USA,1998.0,8,16,-8
GAB,FRA,2008.0,3,6,-3
FRA,GAB,2009.0,10,1,9
FRA,ARM,2014.0,2,1,1
MYS,SGP,2002.0,3,2,1
GBR,SRB,2002.0,5,6,-1
ARE,EGY,2005.0,7,10,-3
IND,MYS,2000.0,3,1,2
MAC,USA,2019.0,12,3,9
FRA,VNM,2012.0,17,7,10
USA,VNM,2004.0,3,4,-1
BEL,CHE,2006.0,22,13,9
URY,ARG,2010.0,2,3,-1
BEL,RUS,2012.0,3,12,-9
COL,ECU,2019.0,7,7,0
ZAF,MAR,2013.0,1,1,0
ITA,BGR,2016.0,6,5,1
BWA,GBR,2003.0,5,6,-1
SWE,SRB,2016.0,2,6,-4
DEU,ARE,2011.0,6,1,5
CAN,IND,2000.0,5,25,-20
GBR,MDG,2007.0,1,1,0
NOR,ITA,2011.0,7,9,-2
BEL,RWA,2011.0,5,1,4
DEU,EST,2014.0,6,1,5
DEU,BLR,2011.0,3,8,-5
NLD,CHL,2006.0,3,1,2
ZAF,ZWE,2010.0,4,18,-14
AUS,FJI,2008.0,4,4,0
PAK,AUT,2009.0,7,9,-2
JPN,BRA,2018.0,16,11,5
MAR,ESP,2007.0,3,6,-3
ITA,HRV,1998.0,2,1,1
ESP,PRI,2014.0,3,1,2
BRN,IND,2014.0,2,3,-1
SAU,FRA,2015.0,9,32,-23
TUN,SAU,2023.0,1,1,0
HRV,RUS,2019.0,1,2,-1
GBR,TZA,2015.0,13,2,11
CUB,COL,2016.0,6,1,5
USA,BGR,2018.0,12,6,6
SWE,MEX,2014.0,4,6,-2
BEL,CHN,2012.0,25,34,-9
CZE,GRC,2022.0,4,2,2
BWA,AUS,2016.0,2,6,-4
ITA,MEX,2014.0,11,10,1
ESP,NZL,2020.0,4,5,-1
URY,USA,2020.0,12,11,1
POL,JPN,2020.0,6,9,-3
FIN,NOR,2004.0,4,3,1
TWN,MYS,2020.0,4,12,-8
MYS,AUS,2005.0,11,13,-2
ITA,SVK,2015.0,2,7,-5
PHL,CHE,2013.0,3,8,-5
COL,AUS,2015.0,11,4,7
COL,BEL,2020.0,6,2,4
ISR,RUS,2018.0,5,12,-7
CHN,ESP,2009.0,10,4,6
BHR,IRL,2022.0,4,5,-1
CHL,NZL,2017.0,3,5,-2
MAR,DZA,2022.0,2,5,-3
ISR,SWE,2018.0,4,8,-4
PAK,QAT,2021.0,5,3,2
GBR,BRN,2021.0,3,1,2
MYS,ARE,2007.0,3,2,1
NLD,BGR,2006.0,2,2,0
CHL,ITA,1999.0,2,1,1
NOR,USA,1997.0,7,8,-1
DEU,MEX,2012.0,23,28,-5
EGY,TUN,2012.0,1,1,0
DZA,SAU,2012.0,4,8,-4
AUT,PRT,2016.0,3,10,-7
NOR,FIN,2008.0,4,14,-10
PAK,EGY,2020.0,7,6,1
ARE,GRC,2022.0,2,3,-1
PAN,USA,1998.0,1,2,-1
GBR,VEN,2002.0,9,3,6
GBR,NGA,2010.0,28,26,2
USA,SRB,2020.0,11,12,-1
SWE,ETH,2008.0,1,1,0
EGY,OMN,2012.0,7,2,5
RUS,BEL,2003.0,9,11,-2
EGY,ARE,2003.0,6,9,-3
ROU,SWE,2014.0,1,1,0
BEL,TWN,2019.0,2,8,-6
THA,CAN,2008.0,12,13,-1
SRB,SVN,2013.0,5,5,0
FIN,KOR,2008.0,2,1,1
HUN,AUS,2016.0,7,3,4
ESP,DOM,2015.0,1,1,0
KOR,HKG,2013.0,9,7,2
AUS,GRC,2018.0,4,11,-7
SWE,VNM,2020.0,5,4,1
TWN,DNK,2017.0,2,3,-1
CHN,RWA,2017.0,2,2,0
COL,PRT,2014.0,2,3,-1
CHE,LKA,2017.0,1,1,0
CAN,GHA,2020.0,8,8,0
SWZ,TWN,2021.0,1,1,0
NZL,LKA,2020.0,4,6,-2
MAC,USA,2017.0,4,7,-3
DZA,IRN,2013.0,1,1,0
NLD,UKR,2018.0,2,8,-6
FJI,USA,2014.0,1,1,0
ZAF,EGY,2009.0,1,1,0
GBR,SVN,2016.0,9,12,-3
SWE,IRL,2013.0,3,16,-13
PHL,EGY,2020.0,2,1,1
CZE,FRA,2004.0,8,13,-5
BEL,GRC,2006.0,8,14,-6
FIN,IRL,2009.0,3,1,2
USA,BRB,2019.0,2,4,-2
VEN,ARG,2010.0,3,1,2
AUT,SVN,2002.0,1,2,-1
LBY,EGY,2013.0,4,2,2
GBR,COL,2004.0,5,5,0
ZAF,IRL,2001.0,2,2,0
NGA,JPN,2007.0,4,2,2
PER,CAN,2011.0,2,2,0
ESP,DJI,2010.0,1,1,0
CZE,JPN,2001.0,8,1,7
BRN,AUS,2011.0,1,1,0
GTM,USA,2001.0,2,1,1
KGZ,TUR,2013.0,3,3,0
FRA,SGP,2006.0,7,7,0
ARE,EGY,2002.0,6,11,-5
BLR,HUN,2000.0,1,1,0
IND,ETH,2004.0,3,2,1
LTU,ITA,2002.0,3,1,2
BGD,JPN,1997.0,2,1,1
CHE,KEN,2012.0,3,1,2
HKG,FRA,2002.0,2,8,-6
SGP,FRA,2011.0,12,34,-22
JAM,GBR,2008.0,1,2,-1
USA,CUB,2021.0,2,3,-1
FRA,THA,2008.0,13,10,3
IDN,CAN,2020.0,2,8,-6
AUS,PNG,2010.0,3,3,0
GBR,UZB,2015.0,3,2,1
NGA,MEX,2011.0,1,2,-1
IDN,TWN,2013.0,5,8,-3
SWE,GHA,2013.0,1,1,0
SWE,THA,2011.0,2,9,-7
JPN,HKG,2018.0,10,10,0
BGD,SWE,2011.0,3,4,-1
RUS,DNK,2014.0,4,5,-1
EGY,AUT,2013.0,2,4,-2
GRC,PRT,2022.0,1,1,0
GEO,CAN,2019.0,1,1,0
CHL,NZL,2010.0,1,3,-2
SYR,FRA,2020.0,3,4,-1
RUS,HKG,2020.0,3,5,-2
POL,BRA,2018.0,9,8,1
GBR,LAO,2017.0,3,3,0
GHA,JPN,2016.0,2,2,0
SGP,TWN,2007.0,4,5,-1
IRQ,SAU,2019.0,1,2,-1
CHE,ISL,2002.0,1,1,0
JPN,POL,2010.0,12,7,5
GBR,GEO,2004.0,1,2,-1
NOR,UKR,2009.0,2,1,1
RUS,SVK,2003.0,4,2,2
USA,DZA,2018.0,3,4,-1
BGD,CHE,2018.0,3,2,1
BEL,UKR,2018.0,2,2,0
AUT,CZE,1998.0,3,2,1
CAN,TUN,2007.0,1,1,0
BRN,DEU,2006.0,1,1,0
KEN,IND,2005.0,1,4,-3
DNK,FRO,2018.0,2,1,1
IRL,AUT,2004.0,1,3,-2
GRC,AUS,2006.0,1,1,0
SGP,NLD,2015.0,8,25,-17
SAU,NGA,2011.0,1,3,-2
SDN,GBR,2007.0,3,2,1
ZWE,NLD,2004.0,1,2,-1
GBR,MOZ,2008.0,2,1,1
MWI,KEN,2011.0,1,1,0
GHA,DNK,2008.0,1,1,0
SAU,BHR,2014.0,3,1,2
SGP,PHL,2016.0,4,7,-3
IND,RUS,2012.0,3,3,0
ISR,NZL,2013.0,1,2,-1
ESP,DZA,2016.0,6,3,3
EST,ESP,2019.0,2,3,-1
GBR,BHR,2016.0,3,3,0
LTU,NLD,2018.0,3,2,1
MLT,GBR,2011.0,6,4,2
ESP,TUN,2018.0,3,3,0
VNM,DEU,2021.0,7,16,-9
BHR,CAN,2021.0,1,2,-1
CZE,MAR,2022.0,1,1,0
COL,ITA,2021.0,10,4,6
CIV,BEN,2003.0,2,1,1
CHE,TUR,2005.0,6,4,2
USA,DOM,2010.0,2,1,1
GRC,IRN,2015.0,1,3,-2
SAU,OMN,2020.0,3,4,-1
BEL,KEN,2008.0,2,5,-3
IND,FJI,2006.0,1,1,0
TWN,CAN,2008.0,10,16,-6
NLD,ISR,1999.0,2,5,-3
UKR,TUR,1999.0,3,1,2
CZE,RUS,2021.0,4,17,-13
DEU,MAR,2004.0,4,1,3
GHA,NGA,2003.0,1,1,0
GBR,SDN,2013.0,2,2,0
DNK,SVK,2014.0,1,2,-1
ARG,JPN,2011.0,1,2,-1
MNE,SRB,2009.0,3,1,2
HUN,SVK,1999.0,1,1,0
SAU,SVK,2018.0,1,2,-1
SAU,NLD,2016.0,2,11,-9
IDN,CHN,2012.0,2,1,1
FIN,SVK,2012.0,2,2,0
ARG,NZL,2012.0,1,1,0
KOR,TUR,2006.0,1,2,-1
ROU,CHE,2022.0,2,4,-2
GBR,PAN,2020.0,2,4,-2
LUX,GBR,2019.0,3,15,-12
RUS,BGR,2017.0,3,2,1
CHN,BGD,2008.0,2,1,1
CHN,RWA,2019.0,8,2,6
GRC,LUX,2011.0,1,1,0
LVA,FRA,2018.0,1,3,-2
BEL,CZE,2016.0,7,4,3
HRV,JPN,2013.0,2,1,1
NZL,SAU,2016.0,2,3,-1
GBR,PSE,2007.0,2,1,1
JOR,QAT,2007.0,2,1,1
CMR,NGA,2015.0,1,4,-3
CAN,LBN,2005.0,2,2,0
FRA,TUR,2005.0,3,6,-3
ZAF,ETH,2003.0,2,2,0
CHL,FIN,2006.0,1,1,0
AUT,ITA,2000.0,3,5,-2
UGA,KEN,2006.0,3,1,2
ZAF,GRC,2022.0,1,1,0
VNM,CHE,2017.0,2,4,-2
POL,BLR,2004.0,1,3,-2
GRC,CHN,2021.0,5,4,1
BEL,IND,2000.0,2,2,0
PSE,USA,2008.0,3,1,2
CZE,DEU,1998.0,5,5,0
KEN,NGA,2017.0,3,3,0
IRQ,DEU,2018.0,3,7,-4
AUT,IND,2008.0,4,5,-1
CAN,BGD,2009.0,6,10,-4
BRA,PER,2012.0,4,9,-5
AUT,MEX,2011.0,2,1,1
GRD,CAN,2008.0,1,1,0
NOR,LUX,2016.0,2,1,1
POL,UKR,2022.0,8,10,-2
CHL,USA,1998.0,1,8,-7
CRI,ESP,2018.0,3,6,-3
IRN,CZE,2015.0,8,1,7
MAR,PRT,2020.0,3,2,1
USA,MAR,2008.0,2,4,-2
CHE,LTU,2019.0,3,4,-1
FIN,IND,2009.0,2,9,-7
CHE,CZE,2017.0,11,19,-8
LUX,DEU,2001.0,1,3,-2
IRL,SWE,2022.0,5,10,-5
DEU,CUB,2011.0,2,6,-4
CHE,HRV,2008.0,1,6,-5
MOZ,USA,2020.0,2,6,-4
MLT,CAN,2006.0,1,1,0
AUS,KEN,2022.0,2,1,1
TUR,BEL,2005.0,5,5,0
DEU,MKD,2014.0,1,2,-1
CAN,LBN,2002.0,3,2,1
USA,FSM,2003.0,1,1,0
DEU,HKG,2005.0,3,5,-2
BEL,TWN,2017.0,3,1,2
CAN,AUT,1998.0,3,3,0
NOR,IRN,2011.0,1,5,-4
NZL,OMN,2013.0,2,1,1
HKG,LKA,2011.0,1,3,-2
MYS,CHN,2008.0,2,3,-1
GBR,CRI,2022.0,1,3,-2
QAT,ARE,2012.0,1,1,0
IRN,AZE,2009.0,1,5,-4
RUS,IRN,2015.0,2,8,-6
POL,EGY,2013.0,2,4,-2
MEX,FIN,2018.0,2,2,0
ZAF,DNK,2016.0,4,4,0
LTU,LVA,2021.0,2,1,1
BRA,KOR,2014.0,3,6,-3
ITA,TWN,2022.0,1,3,-2
CAN,OMN,2004.0,3,3,0
MAC,USA,2010.0,2,8,-6
NOR,TWN,2015.0,1,1,0
AUT,SWE,1999.0,1,2,-1
ZAF,SAU,2006.0,1,1,0
IND,LBY,2012.0,3,10,-7
DNK,SRB,2012.0,2,2,0
DEU,LIE,2021.0,2,1,1
SVK,SRB,2017.0,1,3,-2
IND,AUS,1997.0,3,2,1
TWN,IRN,2005.0,1,1,0
TWN,CZE,2021.0,2,2,0
SAU,VNM,2020.0,2,1,1
IRL,HUN,2010.0,1,7,-6
FRA,MUS,2017.0,1,1,0
HUN,NZL,2021.0,1,1,0
ARE,IRN,2021.0,2,1,1
ISR,SRB,2016.0,1,1,0
SGP,ZAF,2004.0,1,2,-1
USA,CIV,2016.0,2,2,0
IDN,GBR,2000.0,1,2,-1
AUT,DNK,2011.0,4,6,-2
ROU,FIN,2004.0,1,1,0
PAK,KEN,2009.0,3,4,-1
CHN,CHL,2017.0,3,3,0
AUT,DZA,2018.0,2,1,1
ZAF,MUS,2016.0,1,1,0
RUS,MDA,2014.0,2,1,1
MKD,GRC,2014.0,1,2,-1
AUS,RUS,2008.0,2,7,-5
DNK,ISR,2006.0,2,2,0
AUS,MEX,2004.0,2,1,1
FRA,BOL,2012.0,3,4,-1
DEU,CHL,1997.0,2,1,1
THA,SAU,2017.0,1,2,-1
ECU,GBR,2018.0,2,8,-6
CHE,ZAF,1999.0,2,3,-1
LUX,NLD,2007.0,1,2,-1
MYS,DNK,2020.0,4,3,1
IRQ,FRA,2022.0,3,2,1
FIN,HUN,2004.0,2,4,-2
DEU,CHL,1998.0,3,4,-1
ETH,NLD,2003.0,2,5,-3
KEN,PHL,2016.0,1,1,0
MAC,GBR,2011.0,1,3,-2
CHN,SDN,2006.0,1,2,-1
BOL,PER,2019.0,2,1,1
FRA,BGR,2015.0,2,5,-3
CPV,PRT,2019.0,2,2,0
RUS,CHN,1997.0,1,3,-2
FIN,JPN,2007.0,4,8,-4
ZAF,KEN,2009.0,4,5,-1
BGR,CZE,2020.0,1,1,0
JPN,LBY,2020.0,1,1,0
ROU,ITA,1998.0,1,1,0
CHE,CHN,1999.0,2,3,-1
GUF,FRA,2002.0,2,7,-5
TUN,SGP,2012.0,1,1,0
ZAF,GMB,2012.0,1,2,-1
POL,KAZ,2016.0,2,2,0
AUS,KOR,2000.0,1,1,0
USA,COG,2016.0,3,3,0
SRB,ARE,2022.0,1,2,-1
ITA,IDN,2015.0,1,1,0
FIN,MAR,2021.0,1,1,0
SVK,ITA,2022.0,2,3,-1
SGP,AUS,1997.0,1,3,-2
GRC,AUT,2004.0,1,2,-1
SWE,EGY,2002.0,1,1,0
SWE,URY,2008.0,1,1,0
CIV,USA,2015.0,2,1,1
ESP,SRB,2018.0,1,4,-3
MYS,DZA,2018.0,1,1,0
ZAF,IRN,2017.0,1,6,-5
GHA,TZA,2019.0,1,1,0
LBN,GBR,2005.0,1,5,-4
DEU,GTM,2018.0,1,1,0
HRV,FRA,2006.0,1,2,-1
DEU,TZA,2018.0,3,3,0
COG,ETH,2019.0,1,1,0
CIV,MLI,2020.0,1,2,-1
PRT,JPN,2010.0,3,1,2
PRY,CHL,2021.0,1,3,-2
MYS,ETH,2009.0,1,3,-2
FRA,MUS,2010.0,1,1,0
THA,GRC,2017.0,1,1,0
CHE,MDG,2018.0,1,1,0
ECU,ITA,2016.0,2,5,-3
PHL,SWE,2020.0,1,2,-1
IDN,THA,2012.0,1,6,-5
EST,JPN,2012.0,1,1,0
KWT,GBR,2001.0,1,3,-2
RUS,TUR,2009.0,1,3,-2
MEX,CHN,2001.0,1,2,-1
ALB,DEU,2012.0,1,1,0
RUS,PAK,2022.0,1,2,-1
ATG,IND,2015.0,1,1,0
MOZ,GBR,2020.0,1,1,0
KWT,SAU,2012.0,2,2,0
KEN,CHE,2012.0,1,3,-2
SWE,MOZ,2019.0,1,1,0
BGR,CHN,2016.0,1,1,0
CHL,ZAF,2021.0,2,3,-1
TUR,MYS,2015.0,1,12,-11
AUS,MAC,2008.0,2,2,0
ESP,FIN,1997.0,1,2,-1
SVN,POL,2014.0,2,2,0
HKG,NLD,1998.0,1,1,0
BGR,MKD,2020.0,1,2,-1
CAN,CHL,2000.0,1,2,-1
CZE,SGP,2020.0,1,3,-2
GEO,BEL,2009.0,2,1,1
ISR,PRT,2014.0,1,1,0
CAN,PHL,2007.0,1,1,0
NOR,IDN,2018.0,1,1,0
CZE,FIN,2020.0,1,5,-4
PRT,CPV,2020.0,1,1,0
EGY,PAK,2018.0,1,2,-1
IND,BWA,2011.0,1,2,-1
UZB,TUR,2006.0,1,1,0
GBR,KHM,2022.0,1,2,-1
TJK,CHN,2020.0,1,1,0
FRA,NOR,2019.0,57,24,33
USA,JPN,2007.0,964,1019,-55
NLD,FRA,2011.0,87,74,13
KOR,CAN,2015.0,44,35,9
JPN,VNM,2010.0,27,3,24
TUR,USA,2010.0,178,225,-47
DEU,CHE,2021.0,448,309,139
CYP,TUR,2018.0,36,84,-48
RUS,AUS,2003.0,15,5,10
GBR,CZE,2019.0,56,41,15
SWE,CZE,2020.0,12,23,-11
JOR,IRQ,2007.0,1,3,-2
AUS,NZL,2007.0,92,146,-54
IRN,TUR,2011.0,10,4,6
USA,IRN,2009.0,49,126,-77
COL,USA,2014.0,83,70,13
CZE,GBR,2018.0,38,35,3
CAN,GRC,2017.0,10,16,-6
VNM,KOR,2021.0,46,91,-45
SGP,KOR,2018.0,33,34,-1
FRA,LBN,2020.0,61,65,-4
FRA,ARG,2020.0,19,38,-19
USA,HKG,2015.0,127,142,-15
CUB,ESP,2017.0,16,10,6
GBR,LBY,2018.0,17,3,14
VNM,CZE,2018.0,4,7,-3
TUN,FRA,2022.0,29,22,7
DEU,TUR,2013.0,52,26,26
SWE,CHN,2005.0,25,23,2
DEU,VNM,2021.0,16,7,9
JPN,DEU,2011.0,100,105,-5
IRN,ESP,2017.0,17,2,15
USA,COL,2003.0,36,25,11
AUS,IRN,2011.0,29,61,-32
IND,IRN,2013.0,25,8,17
MEX,SGP,2010.0,2,1,1
USA,SAU,2007.0,55,16,39
CAN,MEX,2009.0,22,15,7
GBR,CZE,2010.0,30,25,5
KOR,GBR,2014.0,42,43,-1
IRN,NOR,2018.0,11,4,7
JPN,CAN,1998.0,30,28,2
IDN,USA,2006.0,11,13,-2
CYP,DEU,2000.0,2,1,1
RUS,BGR,2010.0,4,1,3
CHL,PER,2020.0,13,4,9
IRL,HUN,2017.0,2,5,-3
PAK,CZE,2022.0,2,4,-2
PAK,HKG,2022.0,5,4,1
FRA,LUX,2011.0,26,16,10
CHL,NZL,2019.0,5,5,0
CHE,POL,2021.0,11,18,-7
DEU,KAZ,2004.0,2,2,0
CAN,GRC,2019.0,12,11,1
NOR,POL,2008.0,4,5,-1
DEU,HKG,2002.0,6,9,-3
BEL,BRA,1999.0,11,1,10
HRV,DEU,2006.0,6,7,-1
DEU,LUX,2013.0,32,8,24
FIN,DNK,2011.0,15,10,5
JPN,CAN,1997.0,8,16,-8
CZE,DEU,1997.0,5,6,-1
BGR,TUR,2003.0,1,2,-1
DNK,ROU,2001.0,1,4,-3
MTQ,FRA,1998.0,4,16,-12
CHE,PRT,2010.0,9,8,1
BHR,EGY,2008.0,1,1,0
RUS,UZB,2016.0,7,3,4
RUS,AZE,2006.0,7,2,5
PRT,FIN,2014.0,10,4,6
CAN,IRN,2009.0,44,109,-65
USA,LVA,2012.0,6,5,1
ARG,ECU,2013.0,4,8,-4
USA,RWA,2016.0,13,13,0
NZL,ESP,2014.0,4,11,-7
JPN,GBR,1997.0,14,22,-8
SGP,IRN,2018.0,4,10,-6
LVA,JPN,2018.0,1,2,-1
CHE,CZE,2010.0,7,7,0
MYS,QAT,2020.0,12,1,11
CHN,POL,2020.0,16,16,0
KOR,PHL,2020.0,11,8,3
MEX,PER,2021.0,6,8,-2
RUS,CZE,2014.0,11,2,9
GBR,GHA,2022.0,7,7,0
GBR,ZMB,2013.0,8,2,6
GBR,ISR,2011.0,33,39,-6
DNK,NLD,2006.0,11,16,-5
PHL,IND,2015.0,3,8,-5
HUN,AUT,2014.0,18,9,9
NGA,AUS,2017.0,8,1,7
MYS,ESP,2015.0,2,3,-1
BRA,MEX,2020.0,28,20,8
CZE,DNK,2016.0,5,6,-1
POL,DNK,2007.0,8,5,3
ITA,ROU,2020.0,9,11,-2
CUB,ESP,2019.0,15,3,12
IND,AUS,1998.0,3,3,0
KOR,RUS,2014.0,11,8,3
TUR,PSE,2015.0,2,1,1
NOR,ARG,2013.0,3,1,2
NGA,BEL,2005.0,1,1,0
ZWE,COG,2005.0,1,1,0
GUM,USA,2003.0,4,2,2
DNK,BGD,2019.0,2,1,1
NLD,IRL,2010.0,9,12,-3
RWA,KEN,2013.0,1,1,0
ESP,IRN,2016.0,6,16,-10
GBR,ROU,2013.0,13,14,-1
OMN,USA,2003.0,6,6,0
QAT,EGY,2021.0,10,6,4
PRT,AUS,2005.0,4,1,3
DOM,ESP,2017.0,1,8,-7
RUS,NLD,1998.0,8,4,4
THA,NZL,2001.0,2,1,1
SVK,GBR,2003.0,7,5,2
IRL,HUN,2019.0,3,3,0
CAN,ETH,2017.0,1,2,-1
BLR,GBR,2001.0,3,2,1
UZB,KAZ,2002.0,1,1,0
SWE,EST,1997.0,1,1,0
BGR,CHE,2001.0,5,2,3
TUR,BEL,2002.0,2,2,0
ZAF,FRA,2004.0,6,9,-3
IRN,FIN,2011.0,6,8,-2
SAU,SWE,2017.0,5,4,1
DNK,GNB,2019.0,1,3,-2
FRA,SVN,2015.0,2,1,1
GIN,SEN,2020.0,1,3,-2
KEN,ETH,2005.0,2,1,1
ARE,FIN,2018.0,1,1,0
FIN,SAU,2012.0,2,4,-2
ARE,PRT,2020.0,1,1,0
NLD,HRV,2001.0,1,1,0
JPN,LAO,2015.0,6,1,5
BEL,ISL,2014.0,2,1,1
KEN,JPN,2014.0,3,12,-9
GBR,PER,2007.0,5,3,2
GEO,USA,2002.0,4,2,2
TZA,UGA,2015.0,1,1,0
CMR,GBR,2014.0,3,1,2
ISL,DNK,2015.0,1,4,-3
ARG,PRT,2003.0,3,1,2
CHE,TUR,2002.0,1,4,-3
ECU,NLD,2021.0,1,2,-1
PRT,HRV,2010.0,1,2,-1
ESP,PAK,1999.0,2,1,1
PER,AUS,2016.0,1,1,0
SWZ,BWA,2009.0,1,1,0
SYR,BEL,2012.0,2,3,-1
GBR,IRQ,2007.0,3,2,1
FIN,IRN,2022.0,5,18,-13
DZA,CAN,2020.0,3,5,-2
MEX,RUS,2015.0,1,2,-1
UKR,BEL,2021.0,3,3,0
AUT,IRL,2014.0,3,4,-1
COG,ZWE,2015.0,1,2,-1
USA,EST,2000.0,1,1,0
USA,GAB,2002.0,2,2,0
MEX,KEN,2004.0,1,1,0
HRV,RUS,2017.0,1,1,0
SAU,PSE,2014.0,3,3,0
ITA,CMR,2005.0,1,1,0
ESP,COG,2020.0,1,1,0
SMR,ITA,2013.0,1,4,-3
GRC,MYS,2018.0,1,1,0
TTO,CAN,2009.0,1,2,-1
CAN,BEN,2012.0,1,1,0
ISR,HKG,2020.0,2,2,0
NOR,IRL,2012.0,1,2,-1
EGY,SGP,2018.0,1,1,0
THA,AUS,2000.0,1,4,-3
NOR,AUT,2007.0,2,6,-4
THA,TWN,2015.0,1,4,-3
GRC,HRV,2009.0,1,1,0
ISR,IRL,2012.0,1,6,-5
USA,BLR,2021.0,1,4,-3
GBR,,2022.0,39633,0,39633
,FRA,1997.0,7663,0,7663
,FRA,1998.0,27032,0,27032
TUN,,2024.0,6567,0,6567
,NGA,2000.0,790,0,790
RUS,,2022.0,27476,0,27476
CHE,,2024.0,30658,0,30658
ZAF,,2021.0,3038,0,3038
,USA,2008.0,84909,0,84909
AUS,,2018.0,7454,0,7454
,NOR,1994.0,1205,0,1205
SGP,ROU,2007.0,1,0,1
,CAN,1994.0,8723,0,8723
CHE,LTU,2010.0,2,0,2
LTU,,2014.0,298,0,298
AUT,,2006.0,803,0,803
,GRC,2006.0,2726,0,2726
MEX,,2013.0,2223,0,2223
POL,,2022.0,10869,0,10869
ESP,,2002.0,765,0,765
,IRL,1998.0,1230,0,1230
,BEN,2002.0,52,0,52
,KOR,1995.0,2819,0,2819
,ITA,2016.0,13250,0,13250
,POL,2005.0,4546,0,4546
,NLD,2014.0,6247,0,6247
ISR,,2007.0,940,0,940
,POL,2002.0,5001,0,5001
VEN,,2023.0,787,0,787
,PSE,2004.0,45,0,45
NLD,SRB,2005.0,2,0,2
PAK,,2021.0,3379,0,3379
,BEL,2013.0,3526,0,3526
,BGR,2001.0,552,0,552
ESP,,2005.0,2626,0,2626
,MUS,2004.0,15,0,15
SWE,PSE,2017.0,4,0,4
KAZ,,2018.0,409,0,409
SVK,,2002.0,80,0,80
,IDN,2014.0,4002,0,4002
GHA,,2011.0,33,0,33
BGD,,2017.0,503,0,503
VNM,,2018.0,403,0,403
,SEN,2003.0,100,0,100
,FIN,2010.0,2141,0,2141
SEN,RWA,2010.0,1,0,1
PRI,,2011.0,79,0,79
,CHL,2001.0,996,0,996
,DZA,2007.0,1096,0,1096
,AUT,2011.0,2609,0,2609
,DEU,2016.0,22757,0,22757
,NIC,2003.0,21,0,21
BGD,,2010.0,129,0,129
BGD,,2019.0,438,0,438
,IRL,1997.0,251,0,251
,HRV,2009.0,1266,0,1266
,KNA,2010.0,2,0,2
IRQ,,2014.0,76,0,76
LAO,,2024.0,127,0,127
,PAK,2009.0,2982,0,2982
,RWA,2013.0,55,0,55
,KAZ,2013.0,1208,0,1208
ARG,FIN,2020.0,4,0,4
BRN,BGD,2021.0,1,0,1
,KEN,2016.0,520,0,520
,LUX,2015.0,128,0,128
IRL,HKG,2012.0,2,0,2
SEN,,2018.0,136,0,136
,QAT,2014.0,319,0,319
KWT,OMN,2016.0,1,0,1
LBY,CAN,2018.0,3,0,3
,FIN,2017.0,1790,0,1790
BWA,,2020.0,81,0,81
,IRQ,2000.0,50,0,50
SDN,,2008.0,15,0,15
SVK,,2005.0,192,0,192
CHE,ARM,2019.0,2,0,2
IND,PNG,2021.0,1,0,1
,ALB,2018.0,61,0,61
SWE,GRC,2003.0,9,0,9
MAR,NER,2020.0,2,0,2
TUN,AUS,2020.0,1,0,1
JAM,,2022.0,79,0,79
,FIN,2019.0,921,0,921
FRA,MUS,2019.0,1,0,1
CZE,VNM,2016.0,2,0,2
NOR,MYS,2016.0,3,0,3
,YEM,1995.0,7,0,7
SGP,,2014.0,1106,0,1106
AUT,SAU,2019.0,2,0,2
SLE,,2024.0,127,0,127
IRL,,2007.0,381,0,381
,NAM,2006.0,11,0,11
NZL,,2004.0,239,0,239
PRT,JPN,2017.0,2,0,2
CYP,,2016.0,83,0,83
,UZB,2006.0,90,0,90
OMN,,2011.0,41,0,41
MDA,,2013.0,34,0,34
IRQ,BIH,2010.0,1,0,1
MAR,ARE,2009.0,1,0,1
RUS,SGP,2008.0,2,0,2
THA,,2025.0,49,0,49
IRL,DNK,2009.0,4,0,4
,JAM,2000.0,52,0,52
RUS,SVN,2007.0,1,0,1
EST,ESP,2010.0,3,0,3
SWZ,,2020.0,12,0,12
YEM,,2007.0,7,0,7
TZA,NGA,2014.0,3,0,3
,VNM,1995.0,59,0,59
RUS,LUX,2020.0,3,0,3
,PHL,1995.0,65,0,65
CAF,,2021.0,11,0,11
COL,JPN,2006.0,3,0,3
MRT,,2022.0,25,0,25
HKG,POL,2022.0,2,0,2
USA,MWI,1998.0,1,0,1
,LSO,2018.0,13,0,13
LKA,,2005.0,23,0,23
ERI,,2023.0,20,0,20
,SLB,2018.0,4,0,4
BEL,ECU,2017.0,7,0,7
LTU,MDA,2015.0,1,0,1
BRA,TUN,2013.0,2,0,2
NZL,HRV,2006.0,1,0,1
IRN,,2003.0,46,0,46
VEN,RUS,2012.0,1,0,1
ECU,,2012.0,21,0,21
ISR,MNG,2017.0,1,0,1
QAT,,2006.0,11,0,11
UKR,,2025.0,45,0,45
CRI,,2008.0,28,0,28
BLR,,2004.0,107,0,107
LBN,GBR,2002.0,4,0,4
,NCL,2004.0,18,0,18
,BEN,2005.0,64,0,64
SWZ,ZAF,2001.0,1,0,1
WSM,,2018.0,2,0,2
GLP,FRA,1999.0,3,0,3
CZE,JOR,2005.0,1,0,1
POL,COL,2014.0,2,0,2
CHE,ISL,2005.0,1,0,1
QAT,SVN,2020.0,1,0,1
CUB,NLD,2003.0,1,0,1
GBR,BGD,2001.0,6,0,6
GAB,,2006.0,4,0,4
SYR,ARE,2004.0,1,0,1
,ETH,1994.0,28,0,28
ZWE,ZAF,2003.0,7,0,7
UGA,CAN,1999.0,1,0,1
KAZ,TWN,2004.0,2,0,2
ZMB,,2013.0,20,0,20
ESP,BIH,2004.0,1,0,1
MDA,RUS,2016.0,9,0,9
UKR,KOR,2000.0,3,0,3
AUT,CZE,1997.0,2,0,2
LVA,ITA,1999.0,1,0,1
ITA,HKG,2007.0,1,0,1
BGR,IRN,2016.0,1,0,1
,SLV,2009.0,12,0,12
HKG,MYS,1999.0,1,0,1
BEL,PHL,2004.0,1,0,1
CHE,GHA,2022.0,1,0,1
DZA,ARE,2015.0,2,0,2
MLT,,2014.0,16,0,16
UGA,,2004.0,3,0,3
ISL,,2005.0,23,0,23
,AND,2007.0,3,0,3
MYS,BIH,2010.0,1,0,1
,PSE,1996.0,12,0,12
POL,LAO,2019.0,1,0,1
IRQ,IRN,2009.0,1,0,1
GRD,GBR,2010.0,1,0,1
BGR,ESP,2015.0,1,0,1
FIN,LKA,2019.0,1,0,1
SVN,CHN,2019.0,1,0,1
ITA,PRY,2014.0,1,0,1
JPN,DOM,2015.0,1,0,1
IRL,ALB,2014.0,1,0,1
THA,SAU,2019.0,1,0,1
PRT,IRQ,2020.0,2,0,2
NGA,GRC,2012.0,1,0,1
CAN,TJK,2013.0,1,0,1
TLS,AUS,2016.0,1,0,1
SLB,GBR,2020.0,1,0,1
NLD,LVA,2012.0,1,0,1
KWT,QAT,2022.0,1,0,1
,CMR,2000.0,144,0,144
CHE,KWT,2018.0,1,0,1
LTU,FIN,2021.0,3,0,3
SVK,BEL,2008.0,2,0,2
KWT,ARE,2015.0,4,0,4
,VUT,2007.0,1,0,1
MAR,BEN,2018.0,2,0,2
PHL,IRL,2019.0,2,0,2
VEN,ARG,2019.0,7,0,7
PRT,CRI,2020.0,1,0,1
NIC,,2008.0,7,0,7
GUM,,2009.0,1,0,1
,WLF,2003.0,1,0,1
UZB,ITA,2021.0,1,0,1
DOM,,2012.0,4,0,4
IND,MAR,2008.0,1,0,1
PRT,HRV,2017.0,3,0,3
FRA,GHA,2019.0,3,0,3
MDG,JPN,2022.0,1,0,1
DEU,TUN,2004.0,3,0,3
,ERI,1998.0,4,0,4
BWA,NAM,2021.0,1,0,1
USA,NCL,2008.0,1,0,1
ARE,HUN,2007.0,4,0,4
AUT,TWN,2013.0,3,0,3
PRT,SYC,2002.0,3,0,3
CRI,CYP,2011.0,1,0,1
PER,CHN,2016.0,1,0,1
CMR,AUS,2006.0,2,0,2
NOR,UGA,2007.0,5,0,5
KEN,ETH,2002.0,2,0,2
KWT,AUS,2011.0,1,0,1
REU,,2022.0,9,0,9
DNK,IDN,2006.0,2,0,2
ISR,NOR,2004.0,1,0,1
RWA,IND,2016.0,1,0,1
EUE,ESP,2009.0,1,0,1
PAK,GMB,2007.0,1,0,1
GNQ,ESP,2012.0,2,0,2
FRA,MOZ,2007.0,3,0,3
KOR,IDN,2009.0,5,0,5
GHA,FIN,2011.0,1,0,1
CUB,FRA,2012.0,2,0,2
BRB,,2012.0,3,0,3
,LIE,2009.0,5,0,5
SAU,ZAF,2008.0,3,0,3
CHE,RWA,2013.0,1,0,1
ARE,KWT,2021.0,1,0,1
NOR,ZMB,2000.0,1,0,1
IND,MLI,2010.0,2,0,2
CAN,BFA,2022.0,1,0,1
,GNB,2009.0,4,0,4
LIE,FRA,2018.0,1,0,1
CZE,MLT,2017.0,1,0,1
ROU,ITA,1997.0,4,0,4
ZAF,FIN,2001.0,1,0,1
SEN,IRL,2010.0,1,0,1
PRI,PAN,2001.0,1,0,1
BEL,NAM,2015.0,1,0,1
GRC,SDN,2010.0,1,0,1
ITA,MAR,2015.0,4,0,4
PER,PRT,2008.0,1,0,1
LBN,CHL,2010.0,1,0,1
ZAF,NOR,2014.0,4,0,4
KAZ,IRN,2014.0,1,0,1
ISR,GRC,2021.0,2,0,2
CHN,GTM,2020.0,1,0,1
,NER,1999.0,11,0,11
KGZ,,2014.0,9,0,9
IRL,BHR,2020.0,4,0,4
GIN,CMR,2019.0,1,0,1
SWE,VEN,2003.0,1,0,1
TZA,OMN,2013.0,1,0,1
PRT,AUS,2002.0,3,0,3
KAZ,EGY,2013.0,2,0,2
KOR,PRY,2015.0,1,0,1
ISL,NLD,2011.0,1,0,1
FRA,ETH,2016.0,2,0,2
DEU,PRK,2013.0,1,0,1
IRN,ESP,2010.0,9,0,9
FIN,PRT,2013.0,2,0,2
MYS,BIH,2019.0,1,0,1
NZL,KWT,2015.0,1,0,1
EGY,IND,2015.0,2,0,2
ESP,THA,2006.0,1,0,1
MWI,NLD,2014.0,3,0,3
TWN,NOR,2020.0,3,0,3
FRA,COD,2019.0,4,0,4
LBN,IRN,2018.0,1,0,1
PHL,CAN,2002.0,1,0,1
CZE,IRQ,2022.0,1,0,1
,MUS,1996.0,5,0,5
GMB,,2012.0,3,0,3
RUS,COL,2007.0,1,0,1
SWE,EST,1998.0,1,0,1
DEU,PRI,2000.0,3,0,3
THA,YEM,2010.0,1,0,1
KEN,NGA,2010.0,3,0,3
NLD,LIE,2001.0,1,0,1
CHE,JAM,2007.0,1,0,1
,BMU,2001.0,2,0,2
,BFA,1994.0,10,0,10
CHE,UGA,2009.0,2,0,2
TTO,BRB,2020.0,1,0,1
ISR,CZE,2007.0,1,0,1
,BDI,2007.0,2,0,2
UKR,LTU,2013.0,1,0,1
HRV,PRT,2012.0,2,0,2
HUN,BGD,2010.0,1,0,1
NLD,BEN,2015.0,2,0,2
BLZ,,2018.0,2,0,2
IND,GUY,2018.0,2,0,2
SVN,CHN,2017.0,3,0,3
LBR,,2022.0,10,0,10
BEL,AZE,2014.0,1,0,1
MYS,THA,2004.0,3,0,3
DMA,PRI,2008.0,1,0,1
RWA,BEL,2014.0,2,0,2
MYS,VNM,2016.0,1,0,1
MKD,SVK,2016.0,2,0,2
PSE,OMN,2016.0,1,0,1
IND,MLI,2017.0,1,0,1
UZB,AUT,2019.0,1,0,1
SGP,MMR,2014.0,1,0,1
MYS,ITA,2002.0,1,0,1
CZE,JOR,2002.0,1,0,1
ARE,TUR,2004.0,1,0,1
USA,GAB,2005.0,1,0,1
BWA,ISR,2013.0,1,0,1
DMA,,2014.0,1,0,1
IND,SEN,2015.0,1,0,1
BEL,UGA,2007.0,2,0,2
HRV,ARE,2018.0,2,0,2
BRA,CRI,2009.0,2,0,2
CHE,MKD,2016.0,1,0,1
ESP,LTU,2007.0,1,0,1
NPL,MYS,2017.0,1,0,1
LBR,MWI,2012.0,1,0,1
DEU,SEN,2022.0,1,0,1
HUN,LBN,2016.0,1,0,1
IDN,FIN,2008.0,1,0,1
CUB,IRL,2013.0,1,0,1
LVA,DNK,2020.0,1,0,1
NPL,MYS,2019.0,2,0,2
FRO,SWE,2015.0,1,0,1
KEN,BWA,2018.0,1,0,1
TWN,EGY,2015.0,1,0,1
CHL,SWE,2013.0,4,0,4
HKG,MWI,2022.0,1,0,1
SWE,IDN,2021.0,2,0,2
JPN,NAM,2020.0,1,0,1
BRN,MDV,2021.0,2,0,2
JPN,SDN,2020.0,3,0,3
IRQ,THA,2022.0,1,0,1
PAN,FRA,2009.0,1,0,1
JPN,AZE,2008.0,1,0,1
USA,TCA,2016.0,2,0,2
UKR,FIN,2021.0,2,0,2
FIN,CRI,2006.0,1,0,1
CUB,ARG,2008.0,2,0,2
HRV,BGR,2015.0,2,0,2
CHE,QAT,2019.0,2,0,2
PRT,ARE,2015.0,4,0,4
AUT,CYP,2020.0,1,0,1
DNK,PRT,2003.0,2,0,2
BEL,GAB,2009.0,1,0,1
TZA,MYS,2016.0,2,0,2
BGD,OMN,2007.0,2,0,2
LVA,GBR,2000.0,2,0,2
LTU,CAN,2006.0,1,0,1
PRT,KHM,2006.0,1,0,1
FJI,JPN,2008.0,1,0,1
FIN,GRL,2010.0,1,0,1
HUN,DNK,2015.0,3,0,3
BEL,CRI,2019.0,1,0,1
SGP,BGD,2006.0,1,0,1
MEX,SGP,2017.0,4,0,4
,COM,2014.0,2,0,2
QAT,KWT,2004.0,1,0,1
DEU,BHR,2018.0,1,0,1
YEM,IRQ,2007.0,1,0,1
DEU,PRY,2019.0,1,0,1
LBY,KWT,2006.0,1,0,1
SGP,QAT,2006.0,1,0,1
BWA,CHE,2022.0,1,0,1
CHN,CUB,2019.0,2,0,2
USA,BRB,2010.0,2,0,2
ARM,CAN,2013.0,5,0,5
FRA,HTI,2014.0,1,0,1
MEX,NAM,2021.0,1,0,1
USA,MKD,2007.0,4,0,4
SAU,SVN,2003.0,1,0,1
IRL,SDN,2004.0,2,0,2
SWE,PSE,2019.0,1,0,1
UZB,KAZ,2005.0,1,0,1
ITA,BOL,2011.0,1,0,1
TUN,DZA,2004.0,1,0,1
RUS,HRV,2012.0,1,0,1
DNK,BGR,1999.0,1,0,1
HUN,BGR,2013.0,2,0,2
TUR,CAN,1997.0,1,0,1
DEU,ECU,2003.0,2,0,2
BGD,MEX,2009.0,1,0,1
HUN,ARG,2002.0,1,0,1
GBR,TUN,2002.0,2,0,2
CHL,DOM,2012.0,2,0,2
ETH,MYS,2011.0,1,0,1
,NCL,1996.0,2,0,2
GBR,LBN,2000.0,2,0,2
TWN,ARM,2005.0,1,0,1
UKR,ROU,2009.0,1,0,1
UZB,POL,2009.0,1,0,1
CAN,FJI,2014.0,1,0,1
MAC,NLD,2018.0,1,0,1
CYP,NZL,2009.0,1,0,1
PRI,DEU,2019.0,1,0,1
OMN,TUR,2011.0,2,0,2
IND,MAC,2018.0,2,0,2
,SUR,2009.0,2,0,2
HUN,BGD,2017.0,1,0,1
SVN,MNE,2015.0,2,0,2
LAO,KOR,2013.0,1,0,1
CHN,BOL,2020.0,2,0,2
IRQ,JOR,2004.0,1,0,1
NER,DZA,2020.0,1,0,1
SEN,USA,2001.0,1,0,1
EST,KAZ,2006.0,1,0,1
SVN,ISR,2007.0,1,0,1
KAZ,TUR,1999.0,1,0,1
ATG,,2009.0,1,0,1
ESP,NGA,2013.0,1,0,1
AUT,SAU,2010.0,1,0,1
PNG,USA,2015.0,1,0,1
BEL,LTU,2011.0,1,0,1
BGR,PRT,2004.0,2,0,2
BLR,AUT,2022.0,1,0,1
CHE,PRI,2020.0,1,0,1
ROU,HRV,1998.0,1,0,1
ISR,SGP,2002.0,2,0,2
MAR,ZAF,2011.0,1,0,1
SVK,LTU,2021.0,2,0,2
ARE,IRQ,2020.0,1,0,1
CZE,BGR,2002.0,1,0,1
SVN,ESP,2002.0,1,0,1
PNG,,2008.0,8,0,8
PAK,CHL,2021.0,1,0,1
NAM,IRL,2020.0,1,0,1
LBN,PSE,2009.0,1,0,1
CYP,AUS,2022.0,2,0,2
JPN,TWN,1997.0,2,0,2
AUS,PAK,1998.0,1,0,1
AUT,CMR,2017.0,1,0,1
CHL,DNK,2011.0,1,0,1
LKA,SGP,2015.0,1,0,1
NPL,MYS,2010.0,2,0,2
CHN,PRI,2011.0,1,0,1
CUB,NZL,2013.0,1,0,1
GUF,JPN,2008.0,1,0,1
UKR,NOR,2002.0,2,0,2
EGY,DZA,2017.0,1,0,1
UKR,SGP,2022.0,1,0,1
,KNA,2017.0,7,0,7
IND,POL,2006.0,1,0,1
TON,USA,2019.0,1,0,1
UKR,MNG,2015.0,1,0,1
GAB,COG,2008.0,1,0,1
TUR,RUS,2018.0,2,0,2
,GIN,1994.0,1,0,1
IRN,FJI,2016.0,1,0,1
POL,MOZ,2020.0,1,0,1
HUN,HKG,2007.0,1,0,1
AGO,USA,2015.0,2,0,2
IRN,MEX,2014.0,1,0,1
PRI,DEU,2017.0,1,0,1
KAZ,SWE,2020.0,1,0,1
IRL,SLE,2020.0,1,0,1
CAN,NCL,2019.0,1,0,1
BEL,MAC,2019.0,1,0,1
TUR,NOR,2022.0,2,0,2
CRI,FRA,2016.0,2,0,2
IRL,EST,2018.0,1,0,1
GHA,HKG,2015.0,1,0,1
CAN,VCT,2021.0,1,0,1
BRA,SAU,2015.0,1,0,1
ITA,URY,2007.0,1,0,1
POL,CHN,2004.0,1,0,1
CZE,CAN,1999.0,1,0,1
GMB,NLD,2007.0,2,0,2
BGR,SRB,2001.0,1,0,1
BIH,UKR,2008.0,4,0,4
GRC,QAT,2012.0,2,0,2
ETH,NGA,2001.0,1,0,1
JOR,CYP,2017.0,1,0,1
NZL,SRB,2010.0,1,0,1
MLI,GMB,2013.0,1,0,1
SLV,HND,2013.0,1,0,1
PHL,SGP,2003.0,1,0,1
MEX,GTM,2004.0,2,0,2
HUN,BWA,2012.0,1,0,1
BIH,MNE,2012.0,1,0,1
,ERI,1997.0,1,0,1
BEL,BDI,2013.0,1,0,1
SDN,ARE,2019.0,3,0,3
IRN,KEN,2002.0,1,0,1
GHA,TUR,2019.0,2,0,2
PRT,MAC,2015.0,1,0,1
RUS,MKD,2008.0,1,0,1
SLV,SVK,2013.0,2,0,2
AFG,USA,2006.0,1,0,1
MYS,DEU,2001.0,1,0,1
BHS,,2020.0,2,0,2
MNG,CAN,2011.0,1,0,1
IRL,BGD,2019.0,2,0,2
ISL,,2002.0,3,0,3
OMN,BGD,2015.0,2,0,2
RUS,CHN,1998.0,1,0,1
CUB,SWE,2018.0,2,0,2
CHL,GRC,2020.0,3,0,3
LKA,,2002.0,1,0,1
UZB,BEL,2002.0,1,0,1
SVK,NZL,2005.0,1,0,1
IND,YEM,2018.0,6,0,6
ZWE,MWI,2009.0,2,0,2
GIB,CAN,2011.0,1,0,1
KAZ,KGZ,2021.0,1,0,1
MWI,JPN,2007.0,1,0,1
NLD,COL,2001.0,1,0,1
CAN,GEO,2018.0,1,0,1
NOR,BIH,2021.0,1,0,1
TWN,NGA,2022.0,1,0,1
PHL,CAN,2005.0,1,0,1
EGY,DZA,2010.0,1,0,1
NOR,BOL,2015.0,1,0,1
OMN,ISR,2003.0,1,0,1
TWN,LUX,2022.0,1,0,1
CHN,CHL,2010.0,2,0,2
VEN,SWE,2012.0,1,0,1
CHN,TKM,2014.0,1,0,1
GRD,GBR,2019.0,1,0,1
KWT,SWE,2020.0,1,0,1
SWE,MMR,2022.0,1,0,1
THA,PHL,2001.0,1,0,1
HKG,IRL,2001.0,1,0,1
REU,GBR,2009.0,1,0,1
BEN,USA,2001.0,1,0,1
SWE,PER,2002.0,2,0,2
GRC,FIN,2007.0,1,0,1
CUB,MYS,2002.0,1,0,1
UKR,PAK,2017.0,1,0,1
GUY,CHN,2016.0,1,0,1
SGP,CUB,2021.0,1,0,1
BFA,MOZ,2012.0,1,0,1
GRC,NPL,2021.0,1,0,1
TWN,BGD,2012.0,2,0,2
PRK,,2013.0,2,0,2
MWI,SWZ,2018.0,1,0,1
PHL,SAU,2016.0,1,0,1
SGP,SRB,2021.0,1,0,1
BGD,BRN,2020.0,1,0,1
TUN,QAT,2005.0,1,0,1
ESP,SGP,2008.0,2,0,2
MYS,BHR,2011.0,1,0,1
CZE,NGA,2022.0,1,0,1
ZMB,NZL,2014.0,1,0,1
RUS,NGA,2006.0,1,0,1
BRA,QAT,2022.0,2,0,2
ZAF,PER,2008.0,1,0,1
HKG,UKR,2014.0,1,0,1
CAN,GAB,2020.0,1,0,1
CAN,BHR,2005.0,2,0,2
FJI,GBR,2000.0,1,0,1
SVN,SLV,2004.0,1,0,1
NER,BEN,2014.0,1,0,1
KEN,PNG,1999.0,1,0,1
KAZ,UKR,1998.0,1,0,1
ISR,PAK,2010.0,1,0,1
CRI,MEX,2002.0,1,0,1
HKG,BLR,2011.0,1,0,1
BRA,GUF,2016.0,1,0,1
AZE,USA,2007.0,1,0,1
IRN,SYR,2013.0,1,0,1
COL,RUS,1997.0,1,0,1
MYS,BIH,2017.0,1,0,1
IRL,ARE,2001.0,2,0,2
THA,FIN,2002.0,1,0,1
SWE,COL,2000.0,1,0,1
HKG,HRV,2004.0,1,0,1
AUS,SLB,2018.0,1,0,1
ESP,LUX,2002.0,1,0,1
LUX,PAK,2017.0,1,0,1
DNK,QAT,2015.0,1,0,1
MMR,DEU,2021.0,1,0,1
IRL,LBN,2013.0,1,0,1
SGP,OMN,2020.0,2,0,2
DNK,EGY,2007.0,1,0,1
PAK,LTU,2018.0,1,0,1
CRI,PRY,2016.0,1,0,1
PRT,BGR,2022.0,1,0,1
,KNA,2019.0,1,0,1
CIV,ZWE,2005.0,1,0,1
USA,MMR,2003.0,1,0,1
IRN,LUX,2015.0,1,0,1
BLR,FIN,2018.0,1,0,1
MRT,ITA,2011.0,1,0,1
HRV,MNE,2016.0,1,0,1
TUN,PRT,2022.0,1,0,1
FRA,PSE,2014.0,1,0,1
CHN,AGO,2021.0,1,0,1
MDG,CHE,2016.0,1,0,1
KIR,,2024.0,2,0,2
ROU,ISL,2019.0,1,0,1
BEL,PSE,2005.0,1,0,1
PAK,ECU,2018.0,1,0,1
FRA,COD,2010.0,1,0,1
BGR,TWN,2001.0,1,0,1
COD,BEL,2012.0,1,0,1
LBY,SDN,2018.0,1,0,1
UZB,BEL,2005.0,1,0,1
BEN,BEL,2004.0,1,0,1
CRI,MEX,2005.0,1,0,1
ZAF,TUR,2000.0,1,0,1
ITA,MOZ,2014.0,1,0,1
CHE,NPL,2013.0,2,0,2
MEX,HND,2003.0,1,0,1
HND,JPN,2006.0,1,0,1
ESP,BOL,2003.0,1,0,1
HRV,ZAF,2014.0,1,0,1
MEX,AUT,2007.0,1,0,1
EST,DNK,2011.0,1,0,1
ETH,MEX,2015.0,1,0,1
MAR,SWE,2004.0,1,0,1
AUS,CIV,2019.0,1,0,1
IRL,PAK,2008.0,1,0,1
ITA,IRQ,2012.0,1,0,1
TCA,USA,2012.0,1,0,1
MWI,BEN,2022.0,1,0,1
AUT,CHL,2005.0,1,0,1
GBR,YEM,2005.0,1,0,1
,SLE,2003.0,2,0,2
MAR,CMR,2003.0,1,0,1
CHN,BDI,2015.0,1,0,1
JPN,SVN,2020.0,1,0,1
NGA,MLI,2002.0,1,0,1
ITA,TUR,2004.0,1,0,1
FRA,BDI,2018.0,1,0,1
KAZ,KWT,2009.0,1,0,1
NOR,MLI,2004.0,1,0,1
ARG,AUS,1999.0,1,0,1
IND,SVN,2003.0,1,0,1
BFA,IRN,2012.0,1,0,1
LTU,ITA,2005.0,1,0,1
COG,ETH,2017.0,1,0,1
CHN,MDG,2022.0,1,0,1
MTQ,FRA,1997.0,1,0,1
CAN,PYF,2012.0,1,0,1
CHE,LTU,2017.0,2,0,2
ARM,POL,2022.0,1,0,1
BEN,CHN,2012.0,1,0,1
NZL,IDN,2009.0,1,0,1
NZL,SRB,2019.0,1,0,1
MKD,ESP,2021.0,1,0,1
IND,ATG,2014.0,1,0,1
IRQ,KHM,2016.0,1,0,1
IND,SVK,2007.0,1,0,1
ITA,GBR,2009.0,315,168,147
CAN,NOR,2011.0,10,7,3
USA,KOR,2008.0,811,610,201
PRT,FRA,2014.0,45,22,23
AUS,USA,2008.0,396,507,-111
GBR,ITA,2006.0,195,182,13
USA,ROU,2012.0,27,12,15
ESP,USA,2013.0,468,348,120
SWE,FIN,2009.0,41,27,14
BRA,PRT,2017.0,104,136,-32
GBR,FRA,2005.0,249,306,-57
BRA,USA,2005.0,248,243,5
BRA,COL,2005.0,13,8,5
GBR,HKG,2018.0,59,63,-4
GBR,CZE,2018.0,35,38,-3
SGP,GBR,2004.0,35,45,-10
ITA,BEL,2018.0,115,81,34
CHN,TWN,2017.0,96,176,-80
TUR,USA,2018.0,311,274,37
AUT,USA,2006.0,88,68,20
CAN,GBR,2011.0,291,344,-53
USA,CHE,2013.0,503,450,53
TWN,CAN,2013.0,13,19,-6
BRA,USA,2002.0,257,250,7
SAU,CAN,2015.0,63,91,-28
JPN,BRA,2017.0,12,12,0
DNK,FRO,2010.0,5,1,4
NGA,ZAF,2022.0,42,39,3
ITA,IRL,2019.0,45,14,31
USA,BEL,2012.0,141,162,-21
RUS,CZE,2004.0,5,4,1
DEU,ISR,2008.0,17,31,-14
ESP,BRA,2018.0,94,86,8
PRT,JPN,2018.0,7,6,1
DEU,CHN,2018.0,417,395,22
DEU,DNK,2009.0,90,45,45
SVN,GBR,2005.0,6,7,-1
FRA,RUS,2018.0,47,39,8
IDN,JPN,2004.0,10,27,-17
NLD,GBR,2001.0,124,100,24
FIN,IRN,2016.0,12,12,0
HKG,CHN,2007.0,208,216,-8
ESP,SWE,2013.0,52,35,17
SWE,USA,2002.0,265,190,75
KOR,CHN,2012.0,143,60,83
NLD,BOL,2008.0,1,1,0
DEU,NZL,2007.0,28,22,6
GBR,ROU,2008.0,9,14,-5
EGY,DEU,2015.0,36,61,-25
SWE,USA,2005.0,188,155,33
ZWE,NLD,2014.0,1,5,-4
IRN,FRA,2007.0,8,12,-4
BEL,NLD,2020.0,171,154,17
GBR,SWE,2018.0,194,164,30
CAN,JOR,2009.0,10,4,6
EGY,AUT,2008.0,3,2,1
FRA,CHE,2003.0,247,169,78
KOR,JPN,2007.0,83,144,-61
FRA,BEL,2013.0,194,195,-1
JPN,BRA,2019.0,12,12,0
CZE,GBR,2010.0,25,30,-5
LTU,NLD,2019.0,2,4,-2
MCO,FRA,2010.0,4,6,-2
PER,BEL,2007.0,3,2,1
ARG,PER,2007.0,1,1,0
ITA,IRL,2010.0,25,14,11
CHE,USA,1998.0,95,114,-19
HTI,USA,2017.0,5,11,-6
USA,VNM,2014.0,26,21,5
POL,CHN,2014.0,33,4,29
TUN,FRA,2016.0,64,120,-56
COL,ECU,2018.0,8,5,3
URY,DEU,2017.0,5,5,0
ESP,DEU,2021.0,164,173,-9
ESP,FRA,2022.0,79,104,-25
ROU,FIN,2014.0,4,3,1
KOR,VNM,2014.0,50,18,32
GBR,IND,2018.0,157,238,-81
CHN,SWE,2005.0,23,25,-2
IND,DEU,2003.0,79,45,34
TWN,JPN,2010.0,22,44,-22
CHN,TWN,2019.0,93,225,-132
HKG,GBR,1999.0,14,11,3
GBR,RUS,2016.0,43,48,-5
FIN,NOR,2014.0,15,6,9
ALB,FRA,2019.0,1,1,0
CHE,GRC,2019.0,16,40,-24
GRC,FRA,2006.0,22,20,2
NLD,MYS,2014.0,8,3,5
MWI,CHE,2020.0,1,2,-1
LIE,AUT,2015.0,2,1,1
IRN,KOR,2016.0,17,8,9
AUS,NOR,2017.0,25,11,14
CHE,GRC,2017.0,10,31,-21
CHN,DEU,2021.0,319,415,-96
HTI,USA,2019.0,7,4,3
MEX,USA,2021.0,174,96,78
GBR,EGY,2010.0,46,18,28
BEN,BEL,2014.0,1,4,-3
MAC,USA,2018.0,9,13,-4
ECU,GBR,2019.0,10,9,1
ETH,CHE,2009.0,4,1,3
SAU,EGY,2003.0,29,35,-6
GBR,EGY,2019.0,48,45,3
PER,BRA,2012.0,9,4,5
JPN,FRA,2016.0,76,96,-20
SGP,CHN,2003.0,52,86,-34
ESP,CHN,2008.0,5,9,-4
GBR,ECU,2022.0,7,2,5
TWN,JPN,2019.0,80,30,50
POL,NLD,2021.0,10,9,1
IRN,NOR,2019.0,9,3,6
ZAF,ZWE,2018.0,32,31,1
ESP,AUS,2021.0,28,37,-9
NLD,IRL,2018.0,17,24,-7
GBR,NGA,2018.0,83,45,38
JPN,VNM,2018.0,90,21,69
JPN,KOR,2020.0,106,82,24
DEU,CAN,2015.0,160,176,-16
ZAF,BEL,2020.0,12,14,-2
SGP,IRN,2019.0,7,8,-1
USA,GRC,2004.0,97,81,16
FRA,NOR,2018.0,46,24,22
CRI,ESP,2019.0,8,8,0
SGP,KOR,2019.0,33,30,3
CHE,NOR,2021.0,24,9,15
USA,CRI,2022.0,2,9,-7
USA,LBN,2021.0,25,64,-39
LTU,DEU,2021.0,8,3,5
DEU,JPN,2001.0,79,82,-3
GBR,FRA,2002.0,296,320,-24
AUT,CHN,2020.0,15,18,-3
USA,DOM,2018.0,4,1,3
SAU,JOR,2022.0,9,5,4
ITA,DEU,2000.0,58,48,10
AUS,HKG,1999.0,19,7,12
SGP,PHL,2022.0,2,2,0
HKG,DEU,2011.0,8,7,1
CHN,BGD,2013.0,4,9,-5
SWE,LVA,2012.0,3,3,0
CHL,FRA,2021.0,30,26,4
ZAF,MWI,2007.0,4,2,2
SWE,GBR,2015.0,112,176,-64
DEU,TWN,2006.0,17,4,13
CHN,TWN,2010.0,62,57,5
BRA,PRT,2010.0,76,57,19
DEU,PAK,2009.0,11,18,-7
FRA,AUS,2009.0,81,59,22
TWN,GBR,2015.0,24,22,2
NOR,GBR,2011.0,35,68,-33
SWE,IRL,2008.0,10,4,6
SGP,KOR,2010.0,14,20,-6
FRA,CHN,2009.0,48,79,-31
IND,ZAF,2009.0,21,11,10
IRN,SWE,2011.0,24,17,7
AUT,PRT,2022.0,11,9,2
IND,ETH,2014.0,26,6,20
AUS,CHE,2012.0,43,55,-12
BRA,DEU,2009.0,49,55,-6
NZL,USA,2002.0,113,96,17
ESP,IRL,2009.0,12,13,-1
NOR,POL,2013.0,6,7,-1
ESP,PER,2012.0,12,7,5
MYS,NGA,2011.0,9,9,0
BGR,ITA,2012.0,2,2,0
TWN,IND,2011.0,38,47,-9
JPN,HKG,2017.0,14,11,3
CHN,GBR,1999.0,45,22,23
DEU,FIN,2003.0,23,31,-8
IRN,GBR,2011.0,36,41,-5
AUS,TUR,2020.0,7,13,-6
POL,TWN,2017.0,3,2,1
KOR,GBR,2004.0,18,32,-14
FRA,SWE,2018.0,97,59,38
ESP,TUN,2019.0,3,4,-1
DEU,KAZ,2014.0,2,2,0
CAN,ITA,2014.0,36,65,-29
POL,FIN,2017.0,9,4,5
FRA,MAR,2008.0,71,33,38
HUN,CHE,2001.0,5,10,-5
AUS,ISR,2012.0,11,12,-1
ESP,ITA,2003.0,69,76,-7
CHE,KOR,2003.0,11,7,4
USA,BGR,2010.0,15,14,1
URY,ESP,2005.0,6,1,5
KEN,NGA,2018.0,2,1,1
DEU,TZA,2017.0,4,3,1
ECU,GBR,2017.0,4,6,-2
EGY,USA,2022.0,45,33,12
BRA,PRY,2021.0,6,2,4
CHE,PRT,2018.0,18,17,1
CZE,GBR,2019.0,41,56,-15
RUS,FRA,2007.0,37,28,9
JPN,POL,2018.0,10,8,2
AUS,NOR,2019.0,19,16,3
MYS,CHN,2013.0,7,5,2
COL,DEU,2014.0,14,11,3
DNK,DEU,2008.0,46,63,-17
MDA,ROU,2018.0,2,1,1
NOR,FRA,2001.0,12,9,3
NLD,PRT,2008.0,19,17,2
ETH,AUT,2020.0,2,2,0
IRQ,GBR,2022.0,8,13,-5
AUS,SAU,2022.0,26,13,13
IND,YEM,2019.0,11,2,9
PAK,TUR,2021.0,15,13,2
IRN,ETH,2019.0,3,1,2
LUX,DEU,2003.0,6,6,0
LUX,FRA,2006.0,4,14,-10
CHE,PAK,2019.0,5,4,1
TUR,DZA,2021.0,2,3,-1
FIN,AUT,2016.0,12,12,0
BEL,CZE,2022.0,8,11,-3
GBR,EGY,2017.0,48,23,25
AUS,GRC,2019.0,5,10,-5
PAK,FRA,2020.0,9,14,-5
CYP,TUR,2019.0,51,63,-12
CYP,TUR,2017.0,24,55,-31
DNK,IND,2011.0,11,11,0
HUN,SWE,2006.0,8,1,7
DEU,IRN,2004.0,10,4,6
GBR,LBY,2010.0,5,2,3
LKA,GBR,2005.0,6,7,-1
JPN,BRA,2010.0,9,14,-5
RUS,CAN,2008.0,16,7,9
LTU,NLD,2010.0,4,2,2
PRT,NLD,2015.0,28,21,7
BGR,USA,1999.0,16,4,12
AUS,BWA,2016.0,6,2,4
GBR,LBY,2017.0,6,2,4
COL,CHE,2009.0,2,1,1
GBR,JAM,2005.0,1,1,0
ESP,VEN,2020.0,6,17,-11
USA,IDN,2011.0,28,10,18
POL,ISR,2012.0,3,4,-1
AUS,GRC,2017.0,5,7,-2
NZL,CHE,2011.0,9,4,5
GBR,COL,2014.0,15,9,6
GBR,SAU,2004.0,26,7,19
RUS,SVK,2001.0,3,2,1
EGY,CAN,2009.0,15,21,-6
NZL,USA,2005.0,83,104,-21
ESP,NLD,2007.0,32,57,-25
TTO,USA,2012.0,6,4,2
IRL,HUN,2018.0,3,5,-2
USA,MAR,2013.0,4,3,1
ROU,USA,2000.0,19,5,14
CHE,CAN,2005.0,52,38,14
DEU,PRT,2011.0,30,24,6
IND,BEL,1997.0,1,2,-1
POL,UKR,2016.0,13,31,-18
BIH,SRB,2004.0,2,4,-2
NOR,NLD,2000.0,6,6,0
BRA,GBR,2008.0,42,37,5
FIN,NLD,2007.0,18,13,5
CHE,USA,1997.0,43,54,-11
MEX,ITA,2006.0,9,3,6
CAN,BEL,2006.0,19,25,-6
ITA,MYS,2017.0,2,8,-6
RUS,BEL,2001.0,19,4,15
DEU,UKR,2006.0,17,28,-11
FRA,POL,2007.0,19,36,-17
USA,KHM,2013.0,2,1,1
PRT,ESP,2005.0,20,26,-6
ISR,ITA,2020.0,14,16,-2
GRC,BRA,2007.0,1,2,-1
GBR,PAK,2004.0,18,12,6
AUS,ESP,2008.0,11,11,0
SAU,USA,2005.0,20,36,-16
ISL,USA,2001.0,2,15,-13
USA,SVK,2007.0,12,19,-7
POL,RUS,2000.0,3,14,-11
JPN,TUR,2007.0,8,6,2
EGY,ARE,2001.0,6,7,-1
ISR,JPN,2001.0,11,6,5
VEN,USA,1997.0,3,4,-1
GBR,LKA,1999.0,3,2,1
COL,USA,2004.0,25,24,1
ESP,POL,1997.0,3,2,1
GMB,BEL,2005.0,1,1,0
DEU,LUX,2008.0,17,3,14
CHE,CAN,2002.0,41,42,-1
RUS,DNK,2004.0,7,3,4
DNK,PRT,2001.0,3,1,2
BRA,AUS,2012.0,31,9,22
GRC,CAN,2021.0,10,10,0
CPV,PRT,2018.0,1,1,0
ESP,PRT,1999.0,5,4,1
MCO,FRA,2017.0,8,9,-1
HKG,ESP,2005.0,2,1,1
DNK,ITA,2001.0,13,11,2
TUR,POL,2011.0,7,1,6
CZE,FRA,2014.0,14,16,-2
ESP,TUN,2010.0,3,2,1
NLD,JPN,2009.0,14,14,0
CHN,CHE,2011.0,31,24,7
HKG,NZL,2003.0,4,1,3
HKG,SWE,2007.0,4,1,3
GBR,BGD,2003.0,5,4,1
MEX,COL,2002.0,4,2,2
CAN,SGP,2012.0,27,27,0
ESP,CAN,2003.0,14,15,-1
DNK,NOR,2000.0,9,3,6
NLD,POL,2008.0,13,16,-3
IDN,AUS,2015.0,23,73,-50
ITA,AUT,2008.0,34,16,18
LTU,NLD,2017.0,2,4,-2
CHL,JPN,2014.0,4,7,-3
NOR,ESP,2009.0,5,13,-8
ESP,PRY,2011.0,5,1,4
NZL,SGP,1999.0,4,2,2
SWE,JPN,2013.0,17,22,-5
CHN,NLD,2004.0,15,19,-4
ZAF,FRA,2014.0,17,25,-8
DEU,ROU,2012.0,15,29,-14
TUR,AUT,2017.0,7,5,2
IRL,AUT,2014.0,4,3,1
AUS,PNG,2018.0,10,7,3
DNK,AUT,2017.0,12,11,1
EGY,LBN,2015.0,6,4,2
IRL,ISR,2012.0,6,1,5
PRT,ESP,2002.0,16,32,-16
ESP,TUN,2017.0,6,5,1
JPN,GRC,2010.0,2,1,1
JPN,GRC,2019.0,4,3,1
ARM,USA,2007.0,8,1,7
IRQ,JOR,2014.0,2,4,-2
EGY,ESP,2017.0,4,13,-9
ZAF,BWA,2016.0,13,9,4
POL,BRA,2017.0,7,5,2
CHE,CZE,2018.0,12,15,-3
IND,ESP,2013.0,20,19,1
FRA,THA,2013.0,18,11,7
PAK,IRN,2012.0,4,1,3
CHN,ISR,2011.0,12,7,5
KOR,TWN,2003.0,6,3,3
EGY,JOR,2012.0,1,1,0
JPN,HKG,2019.0,14,8,6
FIN,CAN,2018.0,24,15,9
PAK,KOR,2012.0,15,13,2
GRC,PRT,2016.0,2,2,0
RUS,SGP,2013.0,4,3,1
AUS,ZAF,2013.0,20,45,-25
NZL,CAN,2020.0,45,27,18
IDN,NZL,2015.0,3,2,1
KOR,SWE,2009.0,9,3,6
USA,ECU,2002.0,5,4,1
FIN,ITA,2004.0,6,4,2
AUS,KEN,2016.0,5,5,0
SVN,CHN,2018.0,2,1,1
KOR,LKA,2021.0,5,1,4
SWE,CAN,2021.0,25,33,-8
ARG,ISR,2020.0,6,1,5
ISR,IND,2016.0,21,120,-99
TWN,NGA,2016.0,1,1,0
MYS,THA,2014.0,6,6,0
ESP,UKR,2016.0,3,4,-1
MNG,AUT,2020.0,1,3,-2
FJI,JPN,2013.0,1,1,0
CUB,ARG,2013.0,2,3,-1
FRA,PAK,2018.0,15,11,4
CZE,ESP,2021.0,14,22,-8
RUS,NOR,2005.0,8,6,2
TUR,AUT,2019.0,16,4,12
USA,BGR,2019.0,7,9,-2
SWE,HKG,2021.0,3,6,-3
ITA,COL,2022.0,1,5,-4
SEN,FRA,2022.0,8,9,-1
VNM,CZE,2017.0,2,1,1
USA,UKR,2020.0,10,22,-12
LKA,AUS,2021.0,21,14,7
DOM,ESP,2018.0,3,3,0
NGA,CHE,2019.0,8,4,4
ITA,NOR,2022.0,16,9,7
LAO,JPN,2020.0,2,2,0
OMN,CAN,2021.0,2,2,0
CHL,NZL,2018.0,7,2,5
POL,IND,2015.0,14,10,4
EST,AUT,2021.0,1,1,0
JPN,ROU,2009.0,3,1,2
USA,HRV,2005.0,12,11,1
CZE,JPN,2003.0,7,10,-3
AUT,HUN,2007.0,7,7,0
ARG,URY,2002.0,3,2,1
MWI,NOR,2015.0,3,2,1
GBR,ZMB,2008.0,2,1,1
SGP,BEL,2002.0,1,1,0
TUN,MAR,2008.0,3,3,0
SWE,ETH,2013.0,2,1,1
CAN,OMN,2014.0,3,4,-1
ARE,FIN,2019.0,1,1,0
GBR,IRN,2015.0,31,43,-12
IND,IRN,2008.0,5,3,2
CHE,TUN,2013.0,2,2,0
NLD,VNM,2017.0,11,3,8
CHE,QAT,2018.0,2,1,1
LTU,GBR,2020.0,6,6,0
SAU,ZAF,2013.0,5,4,1
ARE,CAN,2015.0,5,26,-21
KEN,AUS,2008.0,5,1,4
SVK,GBR,2001.0,7,1,6
NOR,COL,2005.0,1,1,0
KEN,MEX,2015.0,2,4,-2
NCL,FRA,2007.0,8,11,-3
POL,FIN,2019.0,7,8,-1
COG,DEU,2021.0,2,1,1
KOR,AUS,2022.0,17,25,-8
FRA,MYS,2006.0,3,1,2
BEL,IRN,2018.0,15,22,-7
ARE,PAK,2016.0,3,15,-12
ROU,CAN,2020.0,7,4,3
KWT,GBR,2003.0,4,7,-3
IRL,PAK,2013.0,4,5,-1
GRC,AUT,2014.0,6,1,5
FIN,HUN,2014.0,3,6,-3
UGA,USA,2020.0,22,29,-7
SAU,NLD,2022.0,5,3,2
PAK,GBR,2011.0,42,55,-13
DNK,AUT,2019.0,5,16,-11
HUN,UKR,2015.0,3,1,2
RUS,KOR,2001.0,6,6,0
LBN,FRA,2003.0,11,24,-13
ARG,BEL,2002.0,3,2,1
USA,NIC,2006.0,1,2,-1
SWE,ZAF,2008.0,4,3,1
DEU,LTU,2005.0,8,5,3
TUR,AUT,2010.0,2,1,1
MAR,BEL,2021.0,2,5,-3
AUT,BRA,2009.0,4,3,1
MAR,DEU,2000.0,1,1,0
UKR,BLR,2002.0,4,1,3
FRA,GIN,2017.0,5,5,0
CHN,GRC,2012.0,3,3,0
JPN,AUT,2007.0,7,11,-4
COL,BOL,2020.0,2,1,1
LKA,GBR,2002.0,8,3,5
DEU,CRI,2009.0,1,1,0
LBY,IND,2006.0,1,1,0
DEU,SVK,2022.0,2,1,1
SVN,GBR,2002.0,2,5,-3
AUS,RUS,2013.0,5,8,-3
HUN,AUT,2004.0,5,7,-2
FRA,FIN,1998.0,3,2,1
FRA,BDI,2019.0,2,1,1
ZMB,JPN,2004.0,1,1,0
TZA,ZAF,2011.0,3,5,-2
CHE,LTU,2018.0,1,4,-3
NOR,FIN,2013.0,8,15,-7
BRA,ZAF,2003.0,2,2,0
KOR,HKG,2008.0,2,7,-5
NPL,JPN,2005.0,3,6,-3
POL,BRA,2019.0,9,7,2
DNK,NZL,2012.0,3,4,-1
MUS,GBR,2012.0,1,1,0
HUN,BEL,2022.0,1,1,0
GBR,MLT,2008.0,7,2,5
ISR,AUT,2012.0,7,3,4
USA,BGR,2017.0,7,7,0
IND,IRQ,2009.0,3,1,2
ESP,NOR,2011.0,6,4,2
PRT,NOR,2012.0,2,3,-1
HKG,BEL,2011.0,2,1,1
DEU,TZA,2010.0,3,2,1
NLD,VNM,2019.0,7,3,4
BEL,TWN,2018.0,4,4,0
IRL,ITA,2007.0,7,10,-3
GBR,GEO,2014.0,2,2,0
LBY,CAN,2017.0,1,3,-2
RWA,CHE,2015.0,2,1,1
CHN,HUN,2014.0,3,1,2
ETH,ITA,2014.0,6,2,4
ISR,SWE,2017.0,2,1,1
LTU,USA,2020.0,8,9,-1
KOR,FRA,2022.0,7,12,-5
TZA,CHE,2015.0,4,4,0
BRA,JPN,2012.0,8,18,-10
ESP,IRN,2022.0,8,12,-4
NOR,IDN,2017.0,4,2,2
DEU,TZA,2019.0,12,2,10
EGY,KWT,2006.0,5,2,3
GEO,DEU,2015.0,5,2,3
MEX,COL,2005.0,7,4,3
BGR,SRB,2003.0,2,3,-1
POL,CAN,2008.0,14,9,5
FRA,DJI,2012.0,3,3,0
POL,TWN,2010.0,3,2,1
CHN,QAT,2016.0,2,1,1
JOR,AUS,2012.0,1,7,-6
BHR,IND,2016.0,1,2,-1
KOR,IRL,2009.0,6,2,4
FRA,REU,2012.0,15,17,-2
CYP,GRC,2012.0,7,30,-23
CUB,CHE,2011.0,2,1,1
USA,ETH,2006.0,6,5,1
CHE,PAK,2010.0,4,1,3
ARE,USA,2000.0,1,7,-6
CYP,TUR,2010.0,7,7,0
SGP,IRN,2017.0,5,9,-4
LTU,POL,2003.0,3,3,0
AUS,NOR,2010.0,7,10,-3
NPL,DEU,2012.0,4,5,-1
TTO,IND,2021.0,2,1,1
BEL,EGY,2012.0,6,1,5
IND,KEN,2011.0,1,1,0
DNK,GNB,2018.0,3,3,0
AUS,TWN,2022.0,9,5,4
MEX,CHN,2003.0,3,2,1
TUR,ALB,2015.0,3,1,2
RUS,LVA,2021.0,3,4,-1
MEX,FIN,2019.0,4,1,3
TUR,RUS,2017.0,6,2,4
ARE,POL,2020.0,3,2,1
GTM,CHL,2020.0,1,1,0
ISL,FRA,2021.0,1,1,0
BEL,PAK,2021.0,5,3,2
UKR,NLD,2011.0,2,1,1
DNK,BEL,2011.0,5,6,-1
POL,FIN,2010.0,3,3,0
ITA,GRC,1999.0,5,8,-3
DNK,TUR,2017.0,5,5,0
COL,FRA,2009.0,7,16,-9
CHE,MDG,2019.0,2,1,1
PAK,CZE,2016.0,3,1,2
RUS,NOR,2002.0,12,7,5
CAN,TUR,2011.0,21,18,3
SGP,BEL,2005.0,4,1,3
ZAF,ETH,2001.0,1,3,-2
POL,BEL,2022.0,7,7,0
ISR,SWE,2010.0,3,2,1
SRB,DEU,2004.0,12,13,-1
MEX,JPN,2002.0,2,7,-5
SVK,DEU,1999.0,4,10,-6
JPN,TZA,1999.0,1,1,0
BWA,GBR,2001.0,1,2,-1
EGY,PAK,2010.0,1,3,-2
MAR,CAN,2021.0,3,6,-3
MEX,ARG,2000.0,4,3,1
COL,CAN,2006.0,5,2,3
IND,ARE,2004.0,4,1,3
BRA,COL,2002.0,6,1,5
USA,GTM,2004.0,5,1,4
JPN,HUN,2002.0,7,11,-4
SEN,USA,2003.0,1,1,0
FRA,LAO,2012.0,3,3,0
DEU,EST,2004.0,2,2,0
ARM,RUS,2011.0,8,3,5
BFA,DEU,2006.0,1,2,-1
AUS,GRC,2010.0,4,1,3
ZAF,ESP,2020.0,6,9,-3
CZE,UKR,1998.0,1,2,-1
ISR,UKR,2002.0,3,7,-4
IND,KWT,1999.0,2,2,0
CHE,CHL,2004.0,3,2,1
BFA,FRA,2000.0,8,4,4
NZL,HUN,2016.0,2,1,1
CHE,RUS,1999.0,4,9,-5
FRA,GIN,2010.0,2,2,0
KWT,EGY,2015.0,13,9,4
IRL,NGA,2013.0,2,1,1
COG,USA,2012.0,5,2,3
GBR,IDN,2004.0,4,2,2
NGA,NLD,2007.0,2,1,1
SAU,DZA,2009.0,2,6,-4
IND,AUT,2009.0,10,6,4
URY,ARG,2018.0,1,10,-9
DEU,KEN,1998.0,1,1,0
CAN,ISR,2000.0,6,7,-1
NPL,JPN,2002.0,1,3,-2
UKR,AUS,2012.0,3,2,1
LTU,SWE,2011.0,2,3,-1
THA,CAN,2013.0,6,18,-12
IND,MAC,2019.0,3,1,2
SAU,BGD,2002.0,1,1,0
BHR,EGY,2013.0,2,3,-1
JPN,UKR,2004.0,1,9,-8
POL,TWN,2019.0,1,3,-2
NLD,ETH,2014.0,2,6,-4
RUS,JPN,2022.0,6,3,3
NLD,BGD,2020.0,3,3,0
HUN,CAN,2021.0,3,5,-2
MWI,NLD,2004.0,1,1,0
SWE,GRC,2001.0,2,1,1
AUT,IND,2013.0,5,11,-6
DEU,ZAF,1999.0,5,5,0
SWE,BGR,2013.0,2,1,1
NZL,MYS,2006.0,3,1,2
FIN,KOR,2013.0,1,10,-9
SRB,NLD,2011.0,1,1,0
EGY,ESP,2010.0,2,6,-4
ISL,BEL,2013.0,1,1,0
FRA,SRB,2005.0,1,1,0
CAN,TTO,2016.0,1,1,0
CHN,RWA,2018.0,3,2,1
CAN,GRC,2018.0,1,10,-9
URY,ESP,2002.0,4,8,-4
GTM,USA,2003.0,3,4,-1
IND,TTO,2012.0,1,1,0
TUR,JPN,2009.0,7,8,-1
BHR,GBR,2003.0,2,2,0
OMN,SDN,2000.0,1,1,0
DEU,SVN,2009.0,6,8,-2
AUS,UGA,2009.0,1,1,0
DEU,LTU,2002.0,4,2,2
PHL,CHE,2008.0,1,1,0
ITA,SVN,2006.0,3,4,-1
FRA,IRL,1997.0,1,3,-2
NZL,ZAF,2021.0,1,7,-6
USA,MNG,2006.0,2,1,1
BHR,IRL,2016.0,2,4,-2
SVK,BEL,2013.0,1,2,-1
BOL,COL,2014.0,1,1,0
DNK,IRL,2013.0,3,7,-4
MEX,PAN,2020.0,1,1,0
SRB,IRL,2012.0,1,1,0
LUX,IND,2019.0,2,5,-3
CAN,ETH,2018.0,2,6,-4
DEU,URY,2015.0,1,2,-1
TZA,FRA,2016.0,2,1,1
EGY,PAK,2017.0,5,1,4
HUN,ROU,2001.0,3,4,-1
ZAF,IRN,2018.0,2,7,-5
LBN,DEU,2021.0,5,1,4
HKG,NGA,2020.0,3,1,2
ITA,MYS,2019.0,1,2,-1
VEN,USA,1998.0,7,4,3
PRI,CAN,2014.0,1,2,-1
SLV,SVK,2008.0,1,2,-1
CHE,ROU,2005.0,1,1,0
CRI,ESP,2017.0,3,7,-4
NLD,EGY,2021.0,4,4,0
LUX,GBR,2018.0,5,12,-7
MAR,DZA,2016.0,3,4,-1
HUN,ISR,2013.0,7,4,3
USA,ARM,2006.0,2,7,-5
SAU,IRL,2012.0,3,3,0
KOR,IND,2000.0,2,3,-1
MEX,KEN,2014.0,4,1,3
NLD,LBN,2012.0,1,1,0
TUR,NOR,2016.0,6,2,4
NLD,UKR,2010.0,2,7,-5
SAU,TUR,2014.0,5,4,1
COL,CUB,2007.0,2,5,-3
BWA,USA,2014.0,5,12,-7
MYS,DEU,2003.0,1,2,-1
AUS,SLB,2017.0,2,1,1
GBR,BHR,2022.0,1,2,-1
GAB,FRA,2013.0,2,8,-6
MEX,JPN,2005.0,2,3,-1
IDN,SGP,2015.0,5,9,-4
PRI,COL,2006.0,2,3,-1
OMN,EGY,2020.0,3,2,1
BEL,SEN,2011.0,2,1,1
CHL,NOR,2011.0,4,1,3
GBR,SVN,2022.0,3,1,2
NLD,HRV,2003.0,1,1,0
EGY,LBY,2012.0,4,4,0
SRB,SVN,2008.0,1,3,-2
IND,ARG,2009.0,1,2,-1
NZL,NOR,2002.0,3,1,2
GRC,ESP,2003.0,5,1,4
BEN,DEU,2000.0,1,1,0
DNK,TUR,2010.0,3,1,2
SWE,SAU,2005.0,1,1,0
UZB,JPN,2007.0,1,2,-1
PRT,BGR,2016.0,1,1,0
ZAF,SVN,2017.0,1,1,0
RUS,AUT,2007.0,5,7,-2
SGP,PAK,2012.0,4,5,-1
BGR,POL,2012.0,4,1,3
CAN,JAM,1998.0,1,1,0
HND,MEX,2018.0,2,2,0
NER,FRA,2005.0,1,1,0
NZL,NOR,2005.0,3,2,1
AUS,MEX,2014.0,6,9,-3
AUS,NGA,2009.0,2,2,0
HRV,ARE,2017.0,2,1,1
SRB,GRC,2013.0,2,4,-2
LBN,AUS,2017.0,1,3,-2
SVK,SRB,2018.0,1,1,0
ZAF,DNK,2022.0,2,1,1
HKG,PHL,2020.0,3,3,0
GTM,MEX,2020.0,2,3,-1
IND,YEM,2010.0,4,1,3
NER,FRA,2002.0,4,3,1
GBR,JAM,2002.0,2,1,1
MAR,IND,2012.0,2,1,1
DNK,TUR,2019.0,6,4,2
EGY,NZL,2007.0,2,1,1
CAN,LTU,2015.0,2,2,0
EGY,ESP,2019.0,6,7,-1
KEN,GMB,2015.0,1,1,0
GHA,CAN,2004.0,2,1,1
BEN,FRA,2001.0,1,3,-2
FRA,MLI,2011.0,4,3,1
CMR,CHE,2007.0,1,2,-1
PRI,GBR,2002.0,2,4,-2
POL,LTU,2002.0,1,1,0
TWN,DNK,2018.0,2,1,1
LVA,RUS,1997.0,1,3,-2
MYS,PHL,2007.0,1,1,0
PRT,ARG,2013.0,2,2,0
ESP,SRB,2010.0,3,2,1
IRQ,DEU,2019.0,3,13,-10
SAU,SGP,2022.0,3,1,2
FRA,PHL,2015.0,2,3,-1
TWN,ZAF,2015.0,1,3,-2
CHE,GHA,2016.0,4,1,3
PRI,DEU,2018.0,1,1,0
BEL,MAC,2018.0,1,1,0
URY,DEU,2019.0,4,2,2
CRI,GBR,2012.0,1,1,0
NOR,IDN,2019.0,4,2,2
GEO,FRA,2007.0,1,1,0
ZAF,BRA,2015.0,1,8,-7
KAZ,CZE,2019.0,4,2,2
URY,DEU,2010.0,1,2,-1
GRC,IRL,1997.0,1,1,0
THA,SAU,2018.0,1,2,-1
CAN,HRV,2014.0,2,1,1
PAK,BGD,1999.0,1,1,0
DEU,PHL,2012.0,3,8,-5
HKG,POL,2016.0,2,1,1
DNK,POL,1999.0,1,4,-3
DNK,AUT,2010.0,3,10,-7
DNK,GRC,2012.0,1,9,-8
MYS,VNM,2022.0,2,4,-2
ISR,FIN,2011.0,1,1,0
OMN,USA,2001.0,1,3,-2
RUS,ZAF,2021.0,4,1,3
BMU,USA,2006.0,1,2,-1
EST,CHE,2002.0,1,1,0
IND,OMN,2004.0,4,2,2
SRB,POL,2003.0,1,1,0
ISR,RUS,2010.0,3,9,-6
JPN,HUN,2005.0,1,2,-1
MYS,IDN,2001.0,2,2,0
JOR,OMN,2015.0,2,2,0
GUY,USA,2008.0,1,1,0
CRI,ESP,2010.0,2,2,0
ISR,UKR,2005.0,2,1,1
ESP,HKG,2009.0,1,1,0
UKR,ISR,2011.0,2,1,1
NOR,EST,2016.0,1,1,0
KOR,JOR,2015.0,3,1,2
POL,BLR,2014.0,3,1,2
TUR,RUS,2019.0,5,5,0
CAN,BFA,2016.0,1,2,-1
SWE,KEN,2015.0,2,1,1
EST,ESP,2018.0,4,2,2
CHN,CHL,2018.0,2,7,-5
RUS,PAK,2016.0,1,3,-2
TWN,CHE,2005.0,2,2,0
SEN,BFA,2020.0,2,2,0
HUN,AUS,2022.0,2,1,1
HRV,JPN,2008.0,1,1,0
CZE,EGY,2020.0,2,2,0
LIE,CHE,2014.0,4,3,1
CHE,ROU,2002.0,1,8,-7
TUR,RUS,2010.0,4,2,2
DZA,CHE,2013.0,1,1,0
ARE,GRC,2016.0,1,7,-6
SWE,MOZ,2018.0,2,1,1
SWE,ARM,2022.0,1,1,0
MEX,BEL,2022.0,1,2,-1
RWA,CAN,2022.0,3,2,1
AUT,SAU,2018.0,1,1,0
PRT,ISR,2015.0,2,2,0
PRT,CZE,2022.0,1,1,0
FRA,CRI,2014.0,2,1,1
PRT,CHL,2012.0,1,4,-3
USA,BOL,2006.0,2,1,1
PAN,BRA,2015.0,2,1,1
LBY,CAN,2019.0,1,2,-1
IND,BEL,1998.0,2,2,0
SAU,KWT,1999.0,3,1,2
BGR,CHE,2003.0,1,2,-1
SRB,BRA,2002.0,1,2,-1
ASM,USA,2006.0,1,2,-1
SAU,PRT,2015.0,1,6,-5
GBR,BWA,2015.0,1,1,0
URY,MEX,2013.0,2,1,1
NZL,SAU,2022.0,2,1,1
NZL,FRA,1999.0,1,3,-2
SEN,GBR,2009.0,1,1,0
MEX,GRC,2020.0,1,1,0
CZE,AUT,1998.0,2,3,-1
SGP,ZAF,2014.0,1,2,-1
CAN,GEO,2019.0,1,1,0
CAN,NGA,2011.0,1,7,-6
NOR,CAN,1999.0,1,4,-3
RUS,MDA,2004.0,1,3,-2
EGY,BHR,2020.0,1,5,-4
TTO,GRD,2020.0,1,1,0
SDN,LBN,2019.0,1,1,0
SWE,BGD,2012.0,1,7,-6
CZE,GRC,2016.0,1,3,-2
FRA,GIN,2019.0,2,2,0
AUT,IRL,2004.0,3,1,2
CRI,DNK,2016.0,1,1,0
BEL,ZWE,2009.0,1,2,-1
MCO,FRA,2019.0,2,16,-14
USA,HND,2011.0,1,1,0
PAN,BEL,2011.0,1,2,-1
ARE,FIN,2017.0,1,1,0
ITA,MYS,2010.0,1,2,-1
THA,NZL,2003.0,1,1,0
LBY,SRB,2019.0,1,2,-1
NOR,LBN,2020.0,1,1,0
IRL,EST,2017.0,1,1,0
GHA,SWE,2011.0,1,1,0
SAU,JPN,2012.0,1,11,-10
ESP,PRI,2004.0,1,2,-1
RUS,UZB,2022.0,1,2,-1
MAC,PRT,2020.0,1,2,-1
EGY,SGP,2017.0,1,1,0
ESP,VNM,2020.0,1,4,-3
SYC,FRA,2015.0,1,3,-2
FRA,LTU,2022.0,1,1,0
MYS,NOR,2021.0,2,2,0
ZAF,RUS,2006.0,1,2,-1
SAU,BHR,2004.0,1,1,0
USA,RWA,2022.0,1,5,-4
EGY,IRN,2020.0,1,1,0
BEN,KEN,2021.0,1,1,0
BOL,PER,2018.0,1,2,-1
ITA,LTU,2017.0,1,2,-1
UZB,GBR,2010.0,1,1,0
NOR,BEL,1998.0,1,1,0
DEU,BRN,2012.0,1,1,0
JOR,KOR,2015.0,1,3,-2
EGY,YEM,2011.0,1,4,-3
TZA,NLD,2014.0,1,5,-4
GRC,THA,2017.0,1,1,0
ZWE,MEX,2015.0,1,1,0
SEN,KEN,2018.0,1,2,-1
DNK,FRO,2019.0,1,1,0
ESP,DZA,2022.0,3,3,0
IRL,CZE,2014.0,1,3,-2
ARG,AUT,2021.0,1,1,0
BEL,GEO,2019.0,1,2,-1
USA,HTI,2003.0,1,1,0
FRA,SRB,2002.0,1,3,-2
TZA,ITA,2022.0,1,4,-3
NZL,PRT,2005.0,1,1,0
GBR,LAO,2018.0,1,1,0
USA,BMU,2003.0,1,3,-2
USA,AFG,2020.0,1,1,0
GAB,CMR,2020.0,1,2,-1
BGD,ITA,2004.0,1,1,0
LBN,AUS,2010.0,1,1,0
KAZ,FRA,2011.0,1,1,0
LBN,IRN,2019.0,1,1,0
BGD,CHE,2019.0,1,1,0
ARG,SLV,2020.0,1,1,0
VEN,CUB,2020.0,1,2,-1
CZE,ARE,2022.0,1,1,0
NLD,TUN,2019.0,1,1,0
CHE,ZWE,2021.0,1,2,-1
DEU,USA,2009.0,1120,995,125
USA,TWN,2017.0,207,269,-62
JPN,AUS,2007.0,47,28,19
SGP,JPN,2012.0,14,26,-12
USA,TWN,2019.0,209,234,-25
ESP,COL,2009.0,31,46,-15
USA,THA,2006.0,159,70,89
QAT,GBR,2007.0,2,1,1
USA,CHL,2012.0,103,84,19
CAN,CHE,2012.0,82,79,3
CHN,DNK,2008.0,15,11,4
NLD,AUS,2013.0,79,44,35
SWE,CHE,2022.0,22,23,-1
BRA,PRT,2019.0,158,98,60
AUT,CHE,2015.0,84,52,32
HKG,IND,2021.0,6,17,-11
JPN,ESP,2021.0,18,6,12
JPN,LKA,2015.0,12,1,11
VEN,ARG,2018.0,8,4,4
ITA,RUS,2015.0,29,12,17
CHN,HKG,2011.0,297,371,-74
SGP,KOR,2017.0,21,27,-6
ITA,IRL,2017.0,41,16,25
GBR,LBY,2019.0,16,3,13
BGD,CHE,2017.0,3,3,0
IRN,ESP,2018.0,25,7,18
TWN,JPN,2017.0,63,41,22
IRN,NOR,2017.0,14,3,11
ISR,SWE,2019.0,5,2,3
QAT,PAK,2021.0,3,5,-2
EGY,SAU,2022.0,149,108,41
DEU,ESP,2009.0,149,133,16
POL,ESP,2016.0,18,19,-1
CHE,MYS,2020.0,3,2,1
SVK,FRA,2021.0,6,2,4
BRA,NOR,2022.0,6,5,1
CAN,JPN,2004.0,65,87,-22
USA,IRL,2009.0,133,111,22
BEL,ECU,2018.0,2,4,-2
PAK,HKG,2016.0,4,2,2
FRA,CZE,2013.0,27,12,15
THA,CHN,2012.0,3,6,-3
RUS,SAU,2020.0,6,3,3
CZE,GBR,2017.0,34,33,1
POL,SVK,2020.0,2,7,-5
CHN,SWE,2002.0,28,21,7
MEX,GTM,2014.0,2,2,0
ZAF,AUT,2008.0,3,3,0
NGA,AUS,2018.0,9,4,5
EGY,IRL,2020.0,5,1,4
ECU,USA,2008.0,7,10,-3
BEL,SGP,2021.0,5,6,-1
JPN,UZB,2020.0,1,1,0
LBN,CAN,2021.0,18,8,10
BTN,IND,2021.0,2,3,-1
CUB,ESP,2018.0,18,6,12
GBR,GHA,2016.0,18,11,7
GHA,ZAF,2016.0,10,10,0
CZE,CHE,2007.0,6,4,2
BEL,POL,2011.0,20,9,11
ROU,JPN,2000.0,1,1,0
KOR,RUS,2004.0,16,10,6
USA,HRV,2002.0,12,22,-10
SWE,MEX,2004.0,4,3,1
JOR,ITA,2021.0,1,2,-1
SVK,USA,2008.0,16,12,4
USA,COL,2001.0,12,17,-5
BGR,AUS,2000.0,1,2,-1
DNK,GRL,2005.0,5,2,3
MYS,IND,2009.0,26,42,-16
SVN,FRA,2012.0,6,6,0
FJI,USA,2004.0,3,1,2
SVN,USA,2011.0,12,17,-5
TUN,USA,2004.0,3,6,-3
ECU,DEU,2013.0,3,7,-4
SWE,SRB,2022.0,2,2,0
ZAF,NZL,2021.0,7,1,6
ITA,TUR,2014.0,14,12,2
DEU,TUR,2008.0,23,20,3
ROU,AUT,2013.0,2,3,-1
USA,NCL,2013.0,2,1,1
IND,NGA,2018.0,15,11,4
MEX,FIN,2017.0,2,2,0
NGA,CHE,2017.0,13,5,8
KEN,NZL,2020.0,1,2,-1
PRK,CHN,2020.0,4,5,-1
SGP,IND,2003.0,10,21,-11
PSE,USA,2013.0,2,3,-1
PRT,BRA,2006.0,28,42,-14
EST,SWE,2020.0,3,6,-3
AUS,AUT,2000.0,6,5,1
USA,DZA,2010.0,1,1,0
CHN,AUT,1999.0,1,6,-5
BRA,AUT,2000.0,2,2,0
SRB,RUS,2009.0,2,2,0
SAU,SWE,2018.0,4,8,-4
NLD,VNM,2010.0,6,1,5
AUS,FJI,2013.0,5,12,-7
ISR,RUS,2017.0,7,14,-7
USA,ISL,2012.0,13,12,1
PRT,KOR,2021.0,1,2,-1
MEX,VEN,2011.0,3,8,-5
COL,AUT,2013.0,2,2,0
ITA,DZA,2006.0,1,2,-1
EST,CHE,2005.0,1,1,0
IRL,SWE,2016.0,6,11,-5
CHE,TWN,2020.0,3,8,-5
ARG,URY,2005.0,4,4,0
VEN,GBR,2003.0,5,9,-4
USA,CZE,2022.0,14,21,-7
KOR,ITA,2011.0,11,3,8
ROU,CHE,2016.0,4,6,-2
FRA,GHA,2018.0,1,2,-1
SWE,ROU,1998.0,1,1,0
HRV,SVN,2012.0,8,5,3
DNK,FRO,2017.0,1,1,0
LKA,BRN,2013.0,4,1,3
JAM,GBR,2013.0,2,3,-1
ISR,RUS,2019.0,9,17,-8
ESP,CUB,2021.0,5,7,-2
TUR,TWN,2020.0,4,2,2
ITA,MEX,2004.0,4,2,2
ZAF,IRL,2003.0,3,4,-1
SVN,BEL,2014.0,4,2,2
USA,ECU,2005.0,2,5,-3
FRA,CUB,2005.0,4,1,3
CHE,ARE,2015.0,5,2,3
IRQ,DEU,2017.0,1,9,-8
CRI,CAN,2003.0,3,1,2
SDN,DEU,2011.0,1,3,-2
ITA,TWN,2016.0,7,3,4
VEN,AUS,2006.0,2,1,1
THA,PRT,2011.0,1,2,-1
DEU,MYS,2003.0,2,1,1
IND,GRC,2015.0,3,1,2
CZE,VNM,2022.0,2,2,0
OMN,NZL,1999.0,1,2,-1
POL,BRA,2010.0,2,4,-2
DNK,LTU,2007.0,3,4,-1
GHA,JPN,2022.0,1,3,-2
BRA,BOL,2020.0,3,1,2
FRA,HKG,2020.0,6,5,1
FRA,IRL,1998.0,1,2,-1
NGA,GHA,2012.0,2,2,0
PAK,SGP,2013.0,2,1,1
BIH,HRV,2009.0,5,4,1
RUS,BGR,2018.0,3,7,-4
THA,VNM,2008.0,2,2,0
CHE,GRC,2010.0,9,21,-12
CAF,FRA,2007.0,5,4,1
UZB,MYS,2014.0,3,1,2
NLD,TUN,2017.0,1,1,0
AUS,JOR,2021.0,4,6,-2
PAK,IRL,2003.0,1,1,0
NOR,LUX,2022.0,1,1,0
PHL,NLD,2012.0,2,2,0
IRN,IRL,2017.0,3,3,0
BRA,SRB,2020.0,2,1,1
VNM,NZL,2016.0,2,3,-1
NOR,CYP,2020.0,2,2,0
ETH,TWN,2021.0,2,7,-5
AUS,NPL,2004.0,1,1,0
USA,DZA,2017.0,2,1,1
ESP,BEL,2000.0,4,12,-8
DEU,UGA,2012.0,1,1,0
PER,FRA,2013.0,1,3,-2
ESP,SRB,2017.0,2,1,1
ESP,EST,2019.0,3,2,1
TWN,IRL,2021.0,1,1,0
TUN,CHE,2016.0,3,1,2
NZL,ESP,2004.0,1,2,-1
BEL,NER,2013.0,1,1,0
PYF,ESP,2007.0,1,1,0
JPN,HKG,2010.0,2,7,-5
CMR,BEL,2011.0,1,3,-2
TUN,PRT,2016.0,1,1,0
GBR,LTU,1998.0,1,1,0
DEU,IDN,1999.0,1,3,-2
AUS,NCL,2006.0,1,2,-1
TUR,BGR,2021.0,1,1,0
DNK,BGD,2018.0,1,3,-2
AUS,,2010.0,3251,0,3251
,NLD,2004.0,5346,0,5346
CHL,,2020.0,1982,0,1982
,ARM,2000.0,135,0,135
GBR,,2016.0,14340,0,14340
DNK,,2009.0,875,0,875
PHL,,2024.0,2544,0,2544
DEU,,2012.0,12359,0,12359
,RUS,1999.0,11692,0,11692
RUS,,2016.0,5543,0,5543
NZL,,2014.0,872,0,872
,CHL,2003.0,1117,0,1117
AUS,,2019.0,8344,0,8344
,AUS,2006.0,7349,0,7349
,IDN,2004.0,401,0,401
GRC,,2015.0,1690,0,1690
AUS,,2017.0,6597,0,6597
ARG,,2011.0,860,0,860
,BRA,1994.0,3469,0,3469
,BEL,2008.0,3122,0,3122
MEX,,2008.0,827,0,827
LBN,,2020.0,373,0,373
,USA,2013.0,91288,0,91288
MWI,,2024.0,587,0,587
,NLD,1996.0,3012,0,3012
ALB,,2021.0,87,0,87
IDN,PHL,2001.0,1,0,1
SEN,,2019.0,160,0,160
,SEN,2001.0,127,0,127
CYP,,2022.0,402,0,402
BGD,,2018.0,516,0,516
BLR,,2014.0,189,0,189
,BGR,2003.0,488,0,488
POL,,2016.0,3236,0,3236
VNM,,2017.0,300,0,300
,FRO,2006.0,6,0,6
,QAT,2004.0,59,0,59
EGY,,2006.0,236,0,236
,SGP,2006.0,1518,0,1518
ITA,,1999.0,364,0,364
,HUN,1994.0,1404,0,1404
,MAR,2006.0,566,0,566
,COD,2002.0,5,0,5
VNM,,2010.0,87,0,87
,SVK,1999.0,866,0,866
ROU,,2006.0,243,0,243
KEN,SVK,2021.0,2,0,2
,IDN,1996.0,106,0,106
,SVN,2006.0,668,0,668
KAZ,,2019.0,632,0,632
,PRI,2007.0,125,0,125
,ARE,2007.0,191,0,191
,TZA,2000.0,84,0,84
SGP,,2004.0,316,0,316
,CIV,1997.0,36,0,36
,EST,2006.0,325,0,325
,MYS,1997.0,179,0,179
CRI,,2013.0,41,0,41
SEN,,2017.0,100,0,100
,COL,2015.0,2439,0,2439
,SAU,2012.0,1864,0,1864
,LVA,2011.0,341,0,341
KAZ,,2017.0,187,0,187
,BRN,2009.0,34,0,34
,ALB,2010.0,114,0,114
,PER,2007.0,333,0,333
,MKD,2002.0,62,0,62
PYF,BRB,2017.0,1,0,1
KHM,,2021.0,109,0,109
CHL,CAN,1998.0,1,0,1
VNM,,2019.0,539,0,539
SVK,SDN,2016.0,1,0,1
COL,NOR,2021.0,2,0,2
,BLR,2012.0,223,0,223
,MUS,2014.0,31,0,31
,MYS,1998.0,758,0,758
,FIN,2018.0,1599,0,1599
FRA,MUS,2018.0,3,0,3
,PSE,2014.0,85,0,85
FRA,,2025.0,27,0,27
,NCL,2014.0,16,0,16
BWA,ZMB,2020.0,1,0,1
,BTN,2016.0,24,0,24
,ALB,2019.0,40,0,40
TJK,,2023.0,99,0,99
KEN,ISR,2017.0,1,0,1
IND,YEM,2017.0,2,0,2
COL,TWN,2021.0,1,0,1
,KWT,2016.0,200,0,200
,KAZ,2008.0,124,0,124
,VEN,2016.0,146,0,146
BGR,IRN,2022.0,1,0,1
,GMB,2016.0,14,0,14
,ALB,2017.0,68,0,68
,PRK,2016.0,61,0,61
VNM,CZE,2010.0,1,0,1
AFG,,2024.0,135,0,135
,TUR,2016.0,6765,0,6765
SYR,ARE,2014.0,1,0,1
,SDN,2016.0,133,0,133
CMR,BWA,2000.0,1,0,1
IRN,IRL,2010.0,3,0,3
GRC,THA,2010.0,1,0,1
,MKD,2005.0,93,0,93
SEN,,2010.0,45,0,45
POL,JOR,2006.0,1,0,1
MDG,,2015.0,43,0,43
KAZ,,2010.0,49,0,49
,LBN,2000.0,196,0,196
THA,KEN,2015.0,2,0,2
WSM,,2019.0,4,0,4
,KHM,2012.0,55,0,55
HKG,MAC,2005.0,6,0,6
LAO,MYS,2005.0,3,0,3
GBR,AFG,2004.0,3,0,3
NIC,,2013.0,8,0,8
ETH,SGP,2015.0,1,0,1
,MOZ,2016.0,80,0,80
MLT,,2004.0,4,0,4
THA,EGY,2020.0,5,0,5
IND,MAC,2017.0,5,0,5
ESP,GTM,2015.0,2,0,2
MEX,EST,2018.0,2,0,2
,SWZ,1994.0,2,0,2
BTN,KHM,2019.0,1,0,1
GLP,,2023.0,15,0,15
IRN,PAK,1999.0,1,0,1
RUS,GEO,2015.0,4,0,4
IDN,UZB,2020.0,1,0,1
,CIV,1998.0,88,0,88
SDN,,2013.0,72,0,72
ZMB,,2008.0,11,0,11
PNG,,2013.0,13,0,13
IRN,,2001.0,10,0,10
JAM,,2016.0,36,0,36
BHR,,2007.0,18,0,18
MAR,BEN,2019.0,1,0,1
SYR,,2015.0,53,0,53
KEN,SYR,2009.0,1,0,1
LTU,,2004.0,32,0,32
PLW,USA,2006.0,5,0,5
ITA,SGP,2003.0,3,0,3
ESP,CYP,2002.0,1,0,1
VEN,,2000.0,19,0,19
NER,ITA,2002.0,1,0,1
BGR,CAN,1997.0,1,0,1
MUS,,2015.0,13,0,13
NPL,CHE,2002.0,1,0,1
FIN,AUS,2000.0,3,0,3
URY,,2005.0,17,0,17
HUN,IRN,2006.0,1,0,1
ESP,POL,1998.0,3,0,3
ISR,NZL,2008.0,4,0,4
SWE,ARG,2002.0,10,0,10
USA,BRB,2018.0,4,0,4
LKA,NOR,2004.0,1,0,1
SGP,ARE,2007.0,2,0,2
HUN,SAU,2013.0,1,0,1
GEO,,2002.0,14,0,14
SMR,ITA,2008.0,1,0,1
PRT,FIN,2004.0,1,0,1
NOR,MYS,2022.0,1,0,1
BEL,KEN,2013.0,5,0,5
NLD,NPL,2020.0,2,0,2
,NIC,2001.0,6,0,6
ARM,GBR,2016.0,1,0,1
CHE,BHR,2017.0,2,0,2
MEX,KOR,2007.0,2,0,2
HTI,,2015.0,6,0,6
ESP,NGA,2008.0,1,0,1
ALB,MYS,2009.0,1,0,1
GUM,USA,2001.0,4,0,4
PAN,PER,2019.0,1,0,1
IRN,IRL,2019.0,14,0,14
AUT,ETH,2013.0,2,0,2
,KNA,2018.0,6,0,6
LKA,AFG,2016.0,1,0,1
LBN,ARE,2022.0,9,0,9
,RWA,2008.0,29,0,29
YEM,USA,2015.0,2,0,2
ROU,ISL,2018.0,1,0,1
IRL,EST,2019.0,1,0,1
CRI,HND,2010.0,1,0,1
ISR,IRN,2016.0,1,0,1
ESP,KWT,2016.0,1,0,1
CAN,CIV,2020.0,3,0,3
CHE,TZA,2003.0,1,0,1
PAK,BHR,2015.0,2,0,2
CZE,DNK,2022.0,2,0,2
NLD,UKR,2017.0,4,0,4
CUB,PER,2022.0,1,0,1
UGA,,2014.0,83,0,83
DEU,MAR,2014.0,3,0,3
GEO,,2005.0,27,0,27
BEL,SDN,2005.0,1,0,1
HND,ESP,2015.0,2,0,2
TUR,LTU,2016.0,2,0,2
SDN,ARE,2018.0,3,0,3
COG,GBR,2007.0,1,0,1
MDG,BEL,2015.0,2,0,2
KEN,MYS,2015.0,2,0,2
SWE,SVK,2006.0,2,0,2
AFG,EGY,2015.0,1,0,1
PHL,IRN,2011.0,1,0,1
EGY,SGP,2019.0,3,0,3
,LSO,2010.0,11,0,11
CHN,MLI,2014.0,2,0,2
BGD,CHE,2010.0,2,0,2
MNP,,2007.0,2,0,2
,BHS,2016.0,3,0,3
LKA,CHE,2016.0,3,0,3
CHE,CIV,2021.0,2,0,2
BLR,SWE,2015.0,2,0,2
KOR,BEL,2020.0,12,0,12
KAZ,CHE,2005.0,1,0,1
CUB,NGA,2010.0,1,0,1
DNK,NAM,2014.0,1,0,1
MDA,,2008.0,17,0,17
,SLE,2001.0,4,0,4
GAB,DEU,2002.0,3,0,3
,BOL,1995.0,10,0,10
ARG,BEL,2005.0,3,0,3
CAN,EGY,2000.0,3,0,3
FJI,,2007.0,5,0,5
PLW,,2020.0,7,0,7
IDN,FIN,2013.0,2,0,2
ZWE,POL,2013.0,2,0,2
AUS,PAN,2007.0,2,0,2
NZL,AUT,1999.0,1,0,1
,DOM,1999.0,4,0,4
GBR,CYP,1998.0,3,0,3
GRL,NOR,2008.0,1,0,1
,COD,2005.0,4,0,4
TWN,COL,2002.0,2,0,2
USA,DZA,2019.0,6,0,6
GIN,,2006.0,1,0,1
EGY,SMR,2017.0,1,0,1
PRI,ARG,2009.0,3,0,3
CHE,MLT,2008.0,1,0,1
CHE,ARM,2018.0,3,0,3
IRN,NOR,2010.0,6,0,6
ROU,SWE,2004.0,2,0,2
ARG,BOL,2013.0,1,0,1
JOR,IRN,2018.0,2,0,2
POL,VNM,2014.0,5,0,5
DEU,ISL,2008.0,3,0,3
LBY,CAN,2010.0,1,0,1
CIV,TUR,2016.0,1,0,1
AUT,KEN,2012.0,1,0,1
LAO,CHE,2020.0,1,0,1
GBR,MKD,2012.0,1,0,1
ARE,OMN,1998.0,1,0,1
,QAT,1996.0,5,0,5
AUS,MAC,2013.0,2,0,2
NLD,SDN,2014.0,1,0,1
KOR,BHS,2020.0,1,0,1
ROU,LUX,2019.0,1,0,1
GBR,MOZ,2013.0,1,0,1
HKG,ESP,2002.0,1,0,1
,BMU,2003.0,6,0,6
ITA,BGR,2022.0,2,0,2
IND,BRB,2007.0,1,0,1
CUB,SWE,2019.0,2,0,2
FRA,CUB,2002.0,1,0,1
ITA,PHL,2014.0,1,0,1
UKR,IRL,2009.0,3,0,3
,LSO,2017.0,13,0,13
JPN,HRV,2005.0,1,0,1
NOR,BLR,2016.0,1,0,1
ZAF,BFA,2020.0,1,0,1
BRA,PHL,2018.0,1,0,1
HKG,MAC,2002.0,3,0,3
SWE,VEN,2001.0,1,0,1
WSM,,2017.0,2,0,2
MLI,USA,2020.0,4,0,4
EST,BRA,2012.0,1,0,1
PRT,SRB,2014.0,1,0,1
ITA,LTU,2010.0,3,0,3
VNM,CHE,2018.0,2,0,2
REU,,2016.0,2,0,2
BLZ,,2019.0,7,0,7
IRN,ETH,2017.0,1,0,1
PSE,QAT,2021.0,4,0,4
FIN,PRT,2008.0,1,0,1
BGD,EST,2020.0,1,0,1
NPL,PAK,2016.0,2,0,2
BGR,FRA,2021.0,3,0,3
DNK,VNM,2014.0,2,0,2
GRC,HKG,2012.0,1,0,1
TUN,DZA,2014.0,4,0,4
GUM,FRA,2018.0,1,0,1
BFA,MRT,2010.0,1,0,1
GBR,LVA,1998.0,1,0,1
DOM,USA,2000.0,2,0,2
CRI,IDN,2015.0,1,0,1
PRT,AGO,2021.0,5,0,5
ETH,JPN,2005.0,3,0,3
SWE,SAU,2002.0,2,0,2
GUY,NLD,2002.0,1,0,1
URY,,2002.0,5,0,5
MDA,ITA,1998.0,1,0,1
FRA,ZWE,2000.0,1,0,1
URY,COL,2011.0,1,0,1
CHE,TTO,2017.0,1,0,1
DEU,LKA,2008.0,1,0,1
NLD,COL,2003.0,2,0,2
ARM,KOR,2003.0,1,0,1
PRY,ARG,2005.0,1,0,1
TCD,USA,2005.0,1,0,1
PER,VEN,2006.0,1,0,1
CZE,SAU,2011.0,2,0,2
ZWE,GRC,2011.0,1,0,1
PER,PRT,2013.0,1,0,1
LAO,MDG,2015.0,1,0,1
LBN,OMN,2021.0,1,0,1
MYS,HKG,2016.0,4,0,4
BOL,BRA,2015.0,1,0,1
EGY,PAK,2019.0,1,0,1
POL,PRY,2019.0,1,0,1
DNK,MAR,2012.0,1,0,1
,SYC,2015.0,1,0,1
BRN,IND,2004.0,1,0,1
GBR,MLI,2011.0,1,0,1
UKR,KWT,2011.0,1,0,1
DEU,ERI,2004.0,1,0,1
KOR,NLD,2000.0,1,0,1
FJI,PAK,2021.0,1,0,1
MLI,ESP,2020.0,1,0,1
PAK,LTU,2019.0,1,0,1
GBR,DZA,2006.0,2,0,2
TUN,CHN,2014.0,1,0,1
FRA,ETH,2022.0,1,0,1
DZA,BEL,2000.0,1,0,1
USA,ALB,2009.0,1,0,1
NPL,USA,2000.0,1,0,1
GEO,ITA,2016.0,4,0,4
SDN,FRA,2009.0,1,0,1
TTO,SGP,2007.0,1,0,1
GRC,HUN,2011.0,2,0,2
FRA,NIC,2015.0,1,0,1
MEX,MAR,2013.0,2,0,2
BEL,LBY,2014.0,1,0,1
GAB,GBR,2009.0,2,0,2
SVN,FIN,2012.0,1,0,1
MWI,LUX,2007.0,1,0,1
GBR,CIV,2020.0,1,0,1
GEO,NLD,2020.0,1,0,1
DZA,ITA,1998.0,2,0,2
MYS,DZA,2017.0,3,0,3
DZA,KEN,2018.0,1,0,1
PAK,UGA,2019.0,1,0,1
IDN,PNG,2001.0,1,0,1
ARG,SGP,2011.0,1,0,1
CUB,QAT,2014.0,1,0,1
MRT,CIV,2004.0,1,0,1
TWN,PRI,2005.0,1,0,1
EGY,SDN,2013.0,2,0,2
ITA,LTU,2019.0,2,0,2
BGR,CAN,1998.0,1,0,1
KWT,FJI,2002.0,1,0,1
IRL,UKR,2012.0,3,0,3
SWE,GTM,2007.0,1,0,1
SRB,ARE,2016.0,1,0,1
USA,BHR,2009.0,4,0,4
HRV,ARE,2019.0,1,0,1
ROU,PRT,2013.0,3,0,3
IND,GUY,2010.0,1,0,1
CYP,AUS,2016.0,1,0,1
GTM,GBR,2007.0,1,0,1
,TON,2012.0,2,0,2
KAZ,CZE,2017.0,2,0,2
ROU,PAK,2021.0,1,0,1
MLI,MRT,2018.0,1,0,1
NLD,MWI,2006.0,1,0,1
MRT,,2016.0,3,0,3
SDN,MAR,2021.0,3,0,3
UKR,SVN,2020.0,2,0,2
BIH,BWA,2016.0,1,0,1
PRY,ARG,2002.0,1,0,1
COG,ETH,2018.0,1,0,1
HUN,HRV,2004.0,1,0,1
FRA,ISL,2006.0,2,0,2
KGZ,,2004.0,4,0,4
MYS,DZA,2019.0,2,0,2
MLI,DEU,2006.0,1,0,1
BWA,SVN,2005.0,1,0,1
UKR,BLR,2005.0,1,0,1
ZWE,RWA,2010.0,1,0,1
ESP,ARE,2013.0,5,0,5
SAU,SVK,2019.0,1,0,1
GBR,SDN,2008.0,3,0,3
DNK,CYP,2014.0,2,0,2
ITA,UZB,1997.0,1,0,1
FRA,MLT,2001.0,1,0,1
RUS,ROU,2004.0,1,0,1
BEL,BEN,2015.0,1,0,1
FRA,IRQ,2000.0,1,0,1
SYR,MAR,2021.0,1,0,1
POL,LTU,2005.0,2,0,2
UKR,SGP,2016.0,2,0,2
BRB,GBR,2015.0,2,0,2
ARG,SAU,2015.0,1,0,1
NOR,MLI,2014.0,2,0,2
LBR,,2016.0,4,0,4
IND,HRV,2011.0,1,0,1
ERI,IRL,2013.0,1,0,1
MAR,SWE,2014.0,2,0,2
PER,IDN,2021.0,3,0,3
ITA,ECU,2014.0,3,0,3
GMB,COG,2017.0,1,0,1
LCA,,2024.0,3,0,3
TLS,AUS,2022.0,1,0,1
BIH,QAT,2013.0,1,0,1
MCO,,2005.0,2,0,2
IRQ,,2004.0,7,0,7
ZAF,HRV,2003.0,1,0,1
CYP,ARE,2015.0,1,0,1
HUN,BGR,2008.0,2,0,2
IRN,LBN,2015.0,2,0,2
SVN,BRA,2012.0,1,0,1
BRA,QAT,2016.0,1,0,1
,SLB,2010.0,6,0,6
DNK,GRL,2002.0,1,0,1
GUY,JPN,2021.0,1,0,1
BGR,MEX,2009.0,1,0,1
TWN,RUS,2011.0,2,0,2
COL,SWE,2005.0,1,0,1
MRT,ARE,2018.0,1,0,1
DEU,BHR,2019.0,2,0,2
IRN,ZWE,2019.0,1,0,1
FIN,ZAF,2002.0,2,0,2
ARE,CHE,2003.0,1,0,1
KWT,QAT,2016.0,4,0,4
FRA,PRY,2003.0,1,0,1
VEN,GRD,2017.0,1,0,1
PYF,,2011.0,5,0,5
SRB,CHE,2000.0,1,0,1
PAN,POL,1998.0,2,0,2
FIN,VNM,2003.0,1,0,1
IND,IDN,2002.0,1,0,1
PNG,GBR,2014.0,2,0,2
MCO,USA,2021.0,1,0,1
KOR,LTU,2006.0,1,0,1
BLZ,,2017.0,3,0,3
FRA,PSE,2004.0,1,0,1
NPL,FIN,2016.0,1,0,1
LVA,CAN,2015.0,1,0,1
MYS,BIH,2018.0,1,0,1
UGA,CHN,2012.0,1,0,1
ZWE,IRL,2017.0,1,0,1
NOR,NAM,2014.0,1,0,1
JOR,TUR,2018.0,4,0,4
KOR,UKR,2006.0,1,0,1
MLI,ETH,2019.0,1,0,1
NZL,KEN,2014.0,1,0,1
POL,EGY,2008.0,3,0,3
LKA,FJI,2013.0,1,0,1
MDA,UKR,2001.0,3,0,3
CAN,LKA,2001.0,1,0,1
,ATG,1999.0,1,0,1
LUX,SRB,2017.0,1,0,1
MWI,KOR,2020.0,1,0,1
NOR,RWA,2020.0,1,0,1
PHL,ZAF,2017.0,1,0,1
GRC,BGD,2004.0,1,0,1
LBY,SDN,2019.0,1,0,1
CHL,CRI,2012.0,1,0,1
TUR,BGD,2020.0,2,0,2
NPL,BGD,2021.0,1,0,1
ECU,ITA,2022.0,2,0,2
,COG,1994.0,4,0,4
GRD,GBR,2018.0,1,0,1
SVN,SLV,2014.0,1,0,1
TTO,BRA,2012.0,1,0,1
LVA,FRA,2017.0,2,0,2
NOR,PSE,2009.0,1,0,1
SWZ,ZAF,2003.0,1,0,1
SEN,GAB,2007.0,1,0,1
CAN,TON,2003.0,1,0,1
IDN,NLD,1998.0,1,0,1
TUR,MDA,2009.0,1,0,1
PRT,HRV,2018.0,1,0,1
ITA,CUB,2016.0,1,0,1
THA,SGP,2004.0,2,0,2
CHE,BGD,2006.0,1,0,1
CAN,GUY,2003.0,1,0,1
SYR,GBR,2005.0,3,0,3
SEN,CHN,2005.0,1,0,1
HRV,RUS,2018.0,1,0,1
AUS,SLB,2019.0,1,0,1
CZE,NAM,2018.0,1,0,1
DNK,MAC,2016.0,1,0,1
,LSO,2019.0,3,0,3
KGZ,PAK,2013.0,1,0,1
,GIB,2012.0,1,0,1
USA,COG,2022.0,3,0,3
NGA,CHE,2010.0,1,0,1
PHL,BGD,2005.0,1,0,1
HRV,HUN,2006.0,1,0,1
ALB,CHE,2015.0,1,0,1
MLT,POL,2011.0,1,0,1
ZWE,BRB,2000.0,1,0,1
MHL,USA,2001.0,1,0,1
TUR,JOR,2022.0,1,0,1
SRB,SEN,2020.0,1,0,1
,CCK,2004.0,1,0,1
NLD,ARE,2007.0,1,0,1
UKR,HUN,2000.0,1,0,1
TZA,RWA,2009.0,2,0,2
ZAF,KWT,2007.0,1,0,1
LKA,MNE,2009.0,1,0,1
TWN,QAT,2015.0,1,0,1
DEU,GTM,2019.0,1,0,1
LBN,NZL,2011.0,1,0,1
FRA,MNE,2016.0,1,0,1
BEL,HRV,1998.0,1,0,1
CAN,COL,1998.0,1,0,1
MLT,DEU,2003.0,1,0,1
COL,PRT,2004.0,1,0,1
LVA,ROU,2016.0,1,0,1
MYS,KGZ,2021.0,1,0,1
ARG,PRT,2001.0,1,0,1
MLI,CHN,2015.0,1,0,1
FIN,ZAF,2005.0,1,0,1
AUT,BWA,2014.0,1,0,1
AZE,GEO,2014.0,1,0,1
CHE,GMB,2002.0,1,0,1
GMB,AUT,2016.0,1,0,1
NLD,TUN,2010.0,1,0,1
BTN,USA,2020.0,1,0,1
LVA,FRA,2019.0,1,0,1
,SLB,2017.0,2,0,2
ECU,RUS,2012.0,1,0,1
BEL,ARG,1999.0,1,0,1
TUN,SAU,2000.0,1,0,1
CHE,MEX,2000.0,1,0,1
DEU,WSM,2013.0,1,0,1
IDN,ITA,2006.0,1,0,1
CYP,AUT,2013.0,1,0,1
ARE,TUR,2014.0,1,0,1
ESP,EST,2017.0,1,0,1
SVK,IRL,2011.0,1,0,1
ALB,ESP,2015.0,1,0,1
SWE,MLT,2012.0,1,0,1
CHE,COD,2021.0,1,0,1
PHL,ARG,2021.0,1,0,1
CUB,SWE,2017.0,2,0,2
CHE,BWA,2016.0,1,0,1
FRA,UZB,2020.0,1,0,1
SDN,ITA,2012.0,1,0,1
LAO,IDN,2014.0,1,0,1
USA,BTN,2012.0,1,0,1
PER,AUS,2022.0,1,0,1
BGD,NOR,2021.0,1,0,1
BRN,USA,2019.0,3,0,3
GEO,JPN,1997.0,1,0,1
PAK,CHE,2001.0,1,0,1
GAB,CAN,2017.0,1,0,1
CRI,FRA,2022.0,1,0,1
ZAF,NAM,1999.0,1,0,1
NPL,CHE,2005.0,1,0,1
HKG,IRL,2003.0,1,0,1
FJI,MHL,2015.0,1,0,1
CZE,PSE,2018.0,1,0,1
ARG,NPL,2013.0,1,0,1
LBN,AUS,2019.0,1,0,1
RUS,IRQ,2005.0,1,0,1
NZL,PHL,2021.0,1,0,1
MAR,YEM,2021.0,1,0,1
MMR,RUS,2020.0,1,0,1
SLV,SVN,2008.0,1,0,1
BHR,IRQ,2002.0,1,0,1
URY,ITA,2002.0,2,0,2
HTI,USA,2010.0,2,0,2
USA,DJI,2009.0,1,0,1
USA,BHS,2006.0,1,0,1
LBY,BGD,2009.0,1,0,1
NCL,VUT,2012.0,1,0,1
ARG,PRI,2003.0,1,0,1
CHN,MAC,2003.0,2,0,2
,GRD,2000.0,1,0,1
GHA,BRN,2015.0,1,0,1
GHA,TUR,2018.0,1,0,1
MKD,NOR,2018.0,1,0,1
NPL,NOR,2000.0,1,0,1
GUM,AUS,2009.0,1,0,1
LBN,JOR,2021.0,1,0,1
NGA,MWI,2021.0,1,0,1
THA,GRC,2018.0,1,0,1
SEN,TGO,2020.0,1,0,1
BOL,CHE,2021.0,1,0,1
ISL,EST,2011.0,1,0,1
MKD,JOR,2018.0,1,0,1
IRL,IND,2000.0,1,0,1
CUB,ITA,2006.0,1,0,1
PRT,ETH,2020.0,1,0,1
ROU,IRQ,2021.0,1,0,1
MEX,HKG,2009.0,1,0,1
CIV,GBR,2015.0,1,0,1
SAU,MDV,2020.0,1,0,1
BEL,MCO,2011.0,1,0,1
GRC,SRB,2007.0,1,0,1
CUB,SWE,2010.0,1,0,1
UKR,TTO,2008.0,1,0,1
TUR,SYR,2014.0,1,0,1
CZE,NZL,2021.0,1,0,1
SWE,PAN,2017.0,1,0,1
ZWE,ZAF,2001.0,1,0,1
MAR,BEN,2017.0,1,0,1
ROU,GRC,2000.0,1,0,1
MDG,GBR,1999.0,1,0,1
UZB,AUT,2018.0,1,0,1
ETH,MLI,2005.0,1,0,1
TUN,KOR,2013.0,1,0,1
DNK,ARG,2009.0,1,0,1
CHE,LVA,2011.0,1,0,1
EST,MYS,2010.0,1,0,1
TUR,SVN,2012.0,1,0,1
ISR,KEN,2019.0,1,0,1
UGA,ESP,2007.0,1,0,1
MEX,FIN,2010.0,1,0,1
BEL,GEO,2010.0,1,0,1
GHA,MYS,2022.0,1,0,1
IRN,ARE,2011.0,1,0,1
CHE,URY,2014.0,1,0,1
BLZ,,2010.0,1,0,1
SLB,MYS,2012.0,1,0,1
DEU,FJI,2010.0,1,0,1
NPL,MYS,2018.0,1,0,1
IRL,SDN,2014.0,1,0,1
MYS,YEM,2008.0,1,0,1
ARM,MYS,2003.0,1,0,1
NGA,GRD,2020.0,1,0,1
AZE,CHN,2020.0,1,0,1
AUS,PLW,2016.0,1,0,1
,SLB,2019.0,1,0,1
ECU,CAN,2007.0,1,0,1
NPL,SWE,2009.0,1,0,1
ETH,CAN,2005.0,1,0,1
MEX,TZA,2008.0,1,0,1
BWA,PRT,2008.0,1,0,1
KEN,ISR,2010.0,1,0,1
ISL,IRQ,2017.0,1,0,1
LKA,ETH,2019.0,1,0,1
GAB,USA,2013.0,1,0,1
LBN,MYS,2020.0,1,0,1
USA,FRA,2010.0,649,736,-87
THA,JPN,2019.0,85,110,-25
IND,FRA,2010.0,86,40,46
USA,GBR,2016.0,1495,1604,-109
IND,USA,2009.0,860,498,362
BEL,DEU,2016.0,93,90,3
GBR,USA,2013.0,1564,1415,149
SGP,USA,2019.0,218,206,12
CHE,DEU,2009.0,402,590,-188
PRT,DNK,2016.0,13,4,9
CHE,ITA,2009.0,72,151,-79
NLD,ITA,2009.0,44,65,-21
ITA,CHL,2015.0,16,4,12
AUS,DEU,2011.0,120,148,-28
USA,FRA,2017.0,668,917,-249
GBR,FRA,2007.0,311,338,-27
HKG,CHN,2002.0,137,144,-7
BEL,NLD,2004.0,79,60,19
SWE,DEU,2006.0,89,78,11
GBR,ARE,2018.0,62,22,40
DEU,NZL,2005.0,30,13,17
NZL,CHN,2006.0,5,4,1
BRA,USA,2007.0,255,276,-21
SAU,EGY,2012.0,105,190,-85
USA,FRA,2019.0,611,839,-228
USA,SGP,2006.0,143,115,28
GBR,MYS,2013.0,184,54,130
FRA,TUN,2010.0,105,72,33
IRN,AUS,2009.0,34,24,10
USA,QAT,2018.0,48,65,-17
CAN,KOR,2008.0,31,36,-5
NZL,DEU,2009.0,36,40,-4
AUT,THA,2009.0,7,2,5
ESP,ITA,2012.0,116,171,-55
THA,LAO,2015.0,2,1,1
CHE,AUS,2015.0,65,60,5
CAN,USA,1998.0,294,193,101
SWE,ISL,2021.0,15,14,1
AUS,GBR,2009.0,366,528,-162
LBN,FRA,2012.0,22,63,-41
FRA,LBN,2014.0,70,23,47
ITA,MEX,2020.0,12,22,-10
ZAF,CHE,2013.0,8,5,3
FRA,ITA,2006.0,170,190,-20
PHL,USA,2019.0,36,32,4
CAN,CRI,2009.0,5,1,4
FRA,TUN,2017.0,118,68,50
CZE,AUS,2016.0,6,6,0
MEX,FRA,2009.0,27,33,-6
SGP,CHN,2012.0,183,205,-22
ESP,CAN,2012.0,64,44,20
IND,GBR,2014.0,121,147,-26
KEN,CAN,2010.0,5,4,1
FRA,CHE,2012.0,303,175,128
FRA,EGY,2010.0,8,9,-1
DEU,LTU,2007.0,9,9,0
SWE,USA,2007.0,189,163,26
USA,RUS,2015.0,143,141,2
DEU,FRA,2006.0,246,248,-2
GRC,NOR,2019.0,9,6,3
CAN,USA,1997.0,163,123,40
CAN,CHE,2003.0,54,53,1
NZL,USA,2007.0,83,110,-27
FRA,DEU,2021.0,257,231,26
USA,CHL,2003.0,63,54,9
PRT,ESP,2007.0,41,36,5
CAN,JPN,2020.0,71,53,18
ITA,ISR,2011.0,8,5,3
FRA,IRN,2010.0,27,13,14
JPN,AUS,2005.0,42,35,7
JPN,IRL,2011.0,3,5,-2
ESP,ZAF,2016.0,9,3,6
SWE,ITA,2022.0,32,33,-1
RUS,FRA,2005.0,47,31,16
IND,CAN,2010.0,102,64,38
COD,COG,2011.0,11,5,6
SAU,ESP,2013.0,1,7,-6
BEL,DNK,2008.0,6,8,-2
GBR,THA,2019.0,77,43,34
IND,DEU,2012.0,111,110,1
CHN,JPN,2018.0,281,465,-184
KEN,USA,2021.0,33,27,6
DNK,FIN,2019.0,14,19,-5
IRN,CHE,2015.0,34,8,26
BRA,ESP,2018.0,86,94,-8
IRL,NOR,2018.0,6,4,2
FRA,ZAF,2008.0,13,7,6
CHN,NLD,2020.0,158,153,5
AUS,BEL,2014.0,19,30,-11
IND,PAK,2017.0,43,33,10
IND,PAK,2019.0,50,32,18
KOR,THA,2016.0,15,8,7
COL,ESP,2013.0,42,86,-44
COL,USA,2020.0,125,89,36
COL,PRT,2020.0,4,4,0
AUT,SVK,2019.0,10,12,-2
HKG,SGP,2013.0,28,27,1
IRN,DEU,2014.0,77,32,45
SGP,USA,2010.0,146,231,-85
FIN,DEU,2019.0,55,54,1
GBR,VNM,2019.0,38,8,30
JPN,IND,2018.0,86,90,-4
CHN,FRA,2015.0,128,172,-44
FIN,DEU,2017.0,55,42,13
CHN,SGP,2018.0,262,374,-112
CHN,NOR,2010.0,21,5,16
BRA,CHE,2014.0,23,11,12
RUS,DEU,2021.0,90,53,37
GBR,SGP,2017.0,141,93,48
BGD,MYS,2016.0,31,30,1
GBR,SGP,2019.0,99,106,-7
CHN,LUX,2017.0,2,3,-1
AUT,ESP,2021.0,21,21,0
USA,AUT,2019.0,102,137,-35
THA,SGP,2020.0,7,7,0
AUS,VNM,2017.0,23,18,5
CHN,FIN,2010.0,18,11,7
NOR,CHN,2021.0,28,19,9
POL,JPN,2014.0,52,9,43
GBR,JPN,2000.0,40,42,-2
ZAF,EST,2014.0,1,1,0
ROU,GBR,2016.0,17,10,7
ISR,ESP,2014.0,8,8,0
GBR,BGD,2012.0,14,12,2
IDN,JPN,2020.0,60,181,-121
CZE,USA,2018.0,37,69,-32
BRA,ECU,2019.0,20,5,15
USA,NLD,2019.0,325,386,-61
IND,NPL,2016.0,19,20,-1
CHN,SWE,2007.0,22,35,-13
BRA,ITA,2019.0,64,49,15
FIN,SWE,2018.0,70,50,20
DNK,FRA,2015.0,35,35,0
IND,CAN,2017.0,151,57,94
USA,GRC,2020.0,77,99,-22
KOR,ZAF,2012.0,5,3,2
JOR,ARE,2019.0,28,11,17
PRT,DEU,2016.0,42,31,11
FRA,BRA,2018.0,94,119,-25
AFG,JPN,2015.0,1,1,0
NLD,TUR,2015.0,26,14,12
GBR,KOR,2009.0,27,33,-6
USA,LUX,2019.0,12,9,3
BRA,ITA,2017.0,52,60,-8
CHN,FIN,2017.0,20,23,-3
DNK,JPN,2021.0,6,5,1
IND,FRA,2019.0,86,61,25
ISL,SWE,2018.0,17,11,6
CHL,GBR,2018.0,47,40,7
PHL,USA,2017.0,31,33,-2
ARE,IND,2017.0,14,70,-56
SUR,NLD,2021.0,2,2,0
BRA,BEL,2016.0,12,16,-4
SGP,GBR,2020.0,101,104,-3
IND,ISR,2022.0,41,44,-3
JPN,BEL,2015.0,15,13,2
KOR,GBR,2020.0,61,55,6
IND,ARE,2020.0,69,31,38
GBR,BGR,2021.0,3,2,1
AUS,VNM,2019.0,54,29,25
NLD,IDN,2018.0,39,18,21
GBR,SAU,2020.0,190,56,134
JOR,MYS,2019.0,12,27,-15
CZE,BEL,2019.0,8,7,1
TUR,KOR,2017.0,5,1,4
COG,CHN,2017.0,2,3,-1
BRB,USA,2019.0,4,2,2
NOR,JPN,2021.0,5,6,-1
TUR,SWE,2018.0,25,5,20
ZMB,USA,2016.0,22,10,12
RUS,ITA,2021.0,16,17,-1
ISR,CAN,2018.0,51,53,-2
CHN,MNG,2018.0,2,3,-1
CHN,NGA,2019.0,23,34,-11
CHN,FIN,2019.0,38,27,11
FRA,TUN,2019.0,97,111,-14
USA,BGD,2017.0,44,73,-29
CHN,NOR,2019.0,29,26,3
BRA,NGA,2017.0,6,2,4
ITA,ESP,2021.0,170,156,14
KAZ,RUS,2021.0,17,30,-13
FIN,USA,2022.0,26,22,4
RWA,BEL,2020.0,3,2,1
FRA,IRN,2019.0,20,36,-16
GBR,PAK,2020.0,87,56,31
KEN,CAN,2019.0,9,7,2
GBR,POL,2022.0,17,16,1
EST,SWE,2004.0,5,10,-5
USA,AZE,2021.0,1,2,-1
GBR,VNM,2017.0,42,9,33
FIN,RUS,2018.0,16,34,-18
IDN,KOR,2021.0,21,21,0
USA,EGY,2011.0,91,55,36
ESP,RUS,2013.0,11,8,3
SRB,DEU,2020.0,15,5,10
JPN,BGD,2013.0,64,38,26
SVN,HRV,2021.0,3,8,-5
FRA,DNK,2022.0,20,13,7
RUS,FRA,2002.0,48,34,14
DEU,ITA,2018.0,215,345,-130
IND,CAN,2019.0,158,85,73
GBR,NZL,2013.0,117,98,19
PER,USA,2019.0,53,46,7
DEU,SWE,2014.0,140,105,35
JPN,THA,2018.0,122,55,67
TUR,IRQ,2018.0,9,2,7
FRA,PRT,2008.0,34,21,13
GBR,DNK,2018.0,111,96,15
HKG,MAC,2007.0,15,7,8
AUS,CAN,1997.0,17,7,10
MAR,FRA,2010.0,47,76,-29
GBR,SGP,2010.0,85,32,53
FIN,GBR,2015.0,65,51,14
FRA,SEN,2009.0,24,22,2
PRT,GRC,2015.0,2,4,-2
IND,TUR,2017.0,7,3,4
DEU,BRA,2022.0,29,42,-13
JPN,MYS,2008.0,36,9,27
THA,JPN,2010.0,44,82,-38
DNK,FIN,2017.0,17,28,-11
ITA,LVA,2022.0,2,1,1
ESP,NZL,2014.0,11,4,7
BRA,ITA,2010.0,22,37,-15
USA,AUT,2010.0,99,94,5
URY,AUT,2013.0,1,1,0
MYS,JPN,2009.0,11,46,-35
PHL,USA,2010.0,15,25,-10
THA,DEU,2009.0,8,13,-5
DEU,FIN,2012.0,36,50,-14
NOR,DEU,2009.0,13,62,-49
GBR,PRT,2008.0,44,40,4
BRA,CAN,2006.0,22,38,-16
AUS,VNM,2010.0,8,6,2
DNK,USA,2013.0,117,143,-26
CHE,ESP,2019.0,83,103,-20
GBR,BRA,2006.0,48,34,14
BRA,LUX,2021.0,3,2,1
TUR,GBR,2010.0,33,44,-11
TUR,FRA,2014.0,14,8,6
TUR,IRL,2019.0,10,3,7
REU,FRA,2019.0,18,8,10
DNK,CHL,2022.0,2,1,1
ZAF,CHN,2011.0,7,7,0
PRT,GBR,2011.0,46,78,-32
TUR,GBR,2019.0,82,67,15
GRC,CYP,2015.0,39,12,27
IND,NLD,2014.0,24,26,-2
MEX,JPN,2007.0,2,4,-2
MEX,PRT,2019.0,5,4,1
AUS,FRA,2015.0,83,99,-16
CHN,MAC,2012.0,20,4,16
COL,MEX,2021.0,33,24,9
ARE,IND,2019.0,23,59,-36
USA,BGD,2019.0,57,105,-48
CHE,JPN,2001.0,11,15,-4
IRN,FRA,2005.0,10,12,-2
CRI,USA,1999.0,2,1,1
TZA,GBR,2019.0,8,4,4
JOR,GBR,2006.0,3,17,-14
THA,FRA,2009.0,8,10,-2
PRT,USA,1999.0,13,8,5
AUT,SVK,2017.0,11,6,5
MAR,FRA,2017.0,35,77,-42
IND,JPN,2018.0,90,86,4
FRA,BLR,2006.0,3,1,2
HUN,IND,2008.0,2,1,1
SGP,DEU,2009.0,16,25,-9
TUR,CYP,2016.0,61,19,42
IRN,CAN,2000.0,6,4,2
TWN,HKG,2013.0,12,5,7
TUR,GBR,2017.0,63,65,-2
MEX,PRT,2017.0,3,5,-2
REU,FRA,2017.0,14,17,-3
ARG,GBR,2011.0,12,14,-2
TZA,GBR,2017.0,7,7,0
CUB,USA,2016.0,6,3,3
IRN,AUT,2018.0,13,10,3
FRA,EGY,2019.0,17,7,10
JPN,AUS,2002.0,58,41,17
FRA,IRN,2017.0,21,22,-1
PAK,IND,2015.0,24,35,-11
IRL,SAU,2019.0,8,4,4
MAR,FRA,2019.0,39,80,-41
NLD,ZAF,2021.0,15,13,2
BRA,RUS,2021.0,3,8,-5
KOR,CZE,2019.0,3,3,0
NLD,COL,2012.0,5,9,-4
HND,USA,2019.0,1,4,-3
CHL,BRA,2009.0,10,13,-3
OMN,IND,2019.0,9,24,-15
OMN,QAT,2019.0,5,3,2
ROU,ESP,2015.0,8,2,6
RUS,CZE,2020.0,19,7,12
ARM,USA,2002.0,6,3,3
PER,GBR,2022.0,4,6,-2
AUS,NPL,2020.0,10,17,-7
IND,PAK,2010.0,18,16,2
GBR,IDN,2020.0,33,16,17
BRA,CHN,2012.0,3,2,1
PAK,NZL,2022.0,2,6,-4
SVK,UKR,2018.0,4,3,1
MYS,SAU,2011.0,23,3,20
IND,NOR,2009.0,12,2,10
DEU,GBR,1998.0,108,109,-1
USA,BEL,2003.0,112,124,-12
QAT,BRA,2021.0,2,1,1
ARG,DEU,1998.0,3,4,-1
ZAF,IND,2018.0,32,42,-10
DEU,IRN,2020.0,23,137,-114
GBR,THA,2017.0,75,37,38
PRT,IRL,2013.0,5,4,1
DEU,MYS,2012.0,5,6,-1
LVA,LTU,2014.0,1,4,-3
PRI,USA,2006.0,36,50,-14
JPN,UKR,2020.0,1,1,0
BRA,POL,2008.0,2,2,0
CAN,ARG,2011.0,9,11,-2
BRA,COL,2007.0,15,7,8
BEL,TUN,2009.0,4,1,3
IND,CZE,2016.0,15,15,0
ITA,SGP,2012.0,6,1,5
JOR,EGY,2019.0,5,1,4
NLD,BEL,2006.0,61,89,-28
PER,USA,2010.0,29,21,8
LKA,GBR,2007.0,4,8,-4
JOR,ARE,2017.0,12,9,3
UGA,USA,2004.0,7,9,-2
PNG,AUS,2015.0,7,4,3
CHN,ROU,2013.0,1,1,0
URY,FRA,2015.0,5,2,3
CHL,PER,2014.0,3,1,2
FIN,NLD,2005.0,9,8,1
DEU,GBR,1997.0,58,52,6
ARG,FIN,2014.0,2,1,1
ESP,MAR,2016.0,13,6,7
USA,UGA,2014.0,19,22,-3
MKD,USA,2014.0,4,3,1
CZE,CHE,2005.0,10,5,5
NZL,ITA,2008.0,3,5,-2
USA,ROU,2003.0,16,38,-22
USA,BGD,2010.0,21,29,-8
CHN,NGA,2010.0,8,3,5
FRA,POL,2005.0,21,25,-4
HRV,BEL,2013.0,2,2,0
ISR,ITA,2004.0,13,8,5
FRA,POL,2002.0,37,27,10
ARG,ITA,2016.0,16,28,-12
DNK,HUN,2019.0,3,8,-5
DEU,NZL,2002.0,17,6,11
SRB,SWE,2009.0,2,1,1
NLD,LUX,2019.0,5,5,0
MEX,COL,2007.0,8,5,3
CHE,ESP,2010.0,46,55,-9
SAU,GBR,2008.0,10,34,-24
JPN,KOR,2004.0,127,85,42
JPN,AUT,2005.0,6,3,3
BEL,GBR,2000.0,25,19,6
ESP,NLD,2005.0,31,29,2
GMB,USA,2008.0,3,1,2
POL,CHE,2006.0,9,6,3
DEU,PHL,2003.0,1,1,0
JPN,FIN,2014.0,7,10,-3
DEU,MEX,2001.0,14,10,4
NGA,TZA,2020.0,3,4,-1
SVK,POL,2013.0,4,6,-2
FRA,COG,2006.0,2,4,-2
BGR,ITA,2003.0,5,7,-2
SWE,BRA,1998.0,2,1,1
TTO,USA,2003.0,5,4,1
TUR,ITA,1999.0,1,3,-2
FRA,KAZ,2015.0,3,2,1
BGR,DEU,2009.0,16,20,-4
IRL,GBR,2000.0,35,39,-4
DEU,SYR,2009.0,6,1,5
IRL,MYS,2018.0,4,7,-3
HND,USA,2017.0,2,1,1
BGD,ITA,2020.0,4,2,2
ARM,USA,2005.0,8,3,5
FRA,PYF,2017.0,6,15,-9
PYF,FRA,2021.0,11,10,1
JPN,TUR,2005.0,4,7,-3
DNK,ESP,2000.0,4,4,0
ITA,ZAF,2016.0,9,8,1
MYS,DEU,2012.0,6,5,1
FRA,MCO,2016.0,4,7,-3
JPN,ITA,1997.0,5,5,0
AUT,HUN,2002.0,5,11,-6
CZE,CHE,2002.0,8,4,4
FRA,UKR,2013.0,8,17,-9
BRA,ECU,2017.0,8,6,2
ESP,ECU,2008.0,1,6,-5
SWE,IND,2015.0,20,50,-30
KOR,PHL,2014.0,9,3,6
IND,OMN,2020.0,18,14,4
KOR,CHN,2003.0,24,23,1
GBR,THA,2010.0,53,19,34
FIN,NLD,2002.0,17,7,10
RUS,AUT,2002.0,7,12,-5
UKR,USA,2015.0,24,11,13
JAM,USA,2011.0,3,3,0
CYP,GRC,2003.0,4,2,2
USA,LUX,2010.0,11,3,8
BRA,AUS,2003.0,11,10,1
USA,VEN,2011.0,13,25,-12
FIN,DEU,2010.0,38,34,4
NPL,CHE,2007.0,1,1,0
HUN,ZAF,2013.0,1,1,0
MEX,DEU,2011.0,32,20,12
MEX,PRT,2010.0,5,2,3
NZL,CAN,2004.0,27,19,8
TWN,BEL,2009.0,2,1,1
AUT,AUS,2009.0,20,13,7
DNK,AUS,2013.0,26,24,2
TZA,KEN,2013.0,5,5,0
IRN,JPN,2006.0,5,9,-4
SAU,AUS,2008.0,7,10,-3
FIN,ITA,2020.0,22,34,-12
NLD,TWN,2009.0,3,3,0
POL,AUS,2008.0,6,5,1
BRA,ZAF,2012.0,2,1,1
NGA,CAN,2021.0,6,4,2
BRA,NGA,2010.0,1,1,0
KOR,ESP,2018.0,9,5,4
CHE,ROU,2007.0,4,3,1
AUT,SVK,2010.0,7,10,-3
AUS,CAN,1998.0,10,21,-11
SRB,FRA,1998.0,1,1,0
COL,SWE,2007.0,3,1,2
DNK,FIN,2010.0,5,11,-6
MYS,NZL,2018.0,21,11,10
FRA,SYR,2018.0,9,3,6
FRA,CHL,2014.0,50,24,26
LBN,CHE,2016.0,4,4,0
POL,AUT,2021.0,9,6,3
IRL,KOR,2012.0,3,4,-1
KEN,NLD,2018.0,4,2,2
PRT,FIN,2020.0,4,5,-1
BEL,THA,2015.0,2,3,-1
CHL,VEN,2014.0,3,4,-1
COL,NLD,2015.0,10,4,6
CHN,KEN,2018.0,8,11,-3
SWE,PAK,2015.0,15,5,10
BRA,NLD,2013.0,16,15,1
NPL,CHN,2015.0,2,3,-1
NLD,LUX,2017.0,4,4,0
UKR,BRA,2018.0,4,2,2
SVN,CHE,2015.0,10,1,9
HUN,GRC,2017.0,2,1,1
EST,DEU,2019.0,6,5,1
THA,NLD,2022.0,4,4,0
USA,LTU,2019.0,5,7,-2
KWT,GBR,2012.0,4,9,-5
MYS,GHA,2017.0,1,1,0
FRA,JOR,2015.0,1,3,-2
CAN,QAT,2008.0,7,2,5
ROU,HUN,2017.0,14,6,8
RUS,UKR,2022.0,22,11,11
SWE,AUS,2016.0,43,48,-5
USA,LUX,2017.0,6,9,-3
SWZ,ZAF,2012.0,9,2,7
IND,RUS,2001.0,6,2,4
RUS,ROU,2020.0,3,1,2
MYS,GHA,2019.0,3,2,1
KOR,NOR,2021.0,7,4,3
PAK,ESP,2019.0,4,8,-4
HUN,NLD,2010.0,8,8,0
TZA,GBR,2010.0,7,10,-3
JPN,HUN,2007.0,6,6,0
IND,SWE,2006.0,15,7,8
SWE,LVA,2003.0,4,2,2
TZA,NGA,2020.0,4,3,1
IRL,AUS,2013.0,49,23,26
ROU,FRA,1998.0,4,6,-2
ROU,HUN,2010.0,4,15,-11
USA,SVK,2002.0,10,16,-6
IRL,ITA,2002.0,7,8,-1
DNK,NZL,2003.0,5,3,2
SAU,USA,2007.0,16,55,-39
SWE,ESP,2018.0,40,95,-55
FIN,GRC,2017.0,1,3,-2
CZE,JPN,2012.0,6,3,3
CZE,BEL,2017.0,7,6,1
AUT,ZAF,2018.0,5,2,3
AUS,DNK,2013.0,24,26,-2
GBR,MWI,2022.0,4,7,-3
ITA,THA,2018.0,4,4,0
MEX,AUS,2018.0,13,7,6
HRV,NOR,2013.0,1,3,-2
DZA,MYS,2020.0,2,4,-2
USA,OMN,2018.0,3,1,2
CAN,CMR,2021.0,3,3,0
GHA,CAN,2020.0,8,8,0
FRA,OMN,2018.0,2,1,1
GRC,ESP,2012.0,23,10,13
DZA,FRA,1999.0,6,13,-7
COL,CUB,2005.0,2,1,1
CAN,SGP,2003.0,9,24,-15
USA,SVK,2005.0,12,20,-8
SEN,BEN,2016.0,2,1,1
TUR,ARE,2019.0,6,4,2
POL,ITA,2008.0,9,14,-5
BGD,SAU,2013.0,6,1,5
RUS,NOR,2007.0,5,6,-1
IRL,BRA,2016.0,3,7,-4
SVK,QAT,2016.0,1,1,0
BEL,VNM,2012.0,6,4,2
ARG,CAN,2016.0,16,16,0
SWE,KOR,2021.0,5,23,-18
NLD,AUT,2021.0,21,27,-6
KEN,CAN,2017.0,5,7,-2
PAK,FIN,2019.0,8,2,6
TUR,ARE,2017.0,11,3,8
KEN,DEU,2022.0,1,7,-6
JPN,NLD,1999.0,12,6,6
PRT,COL,2017.0,3,1,2
CZE,IND,2015.0,8,19,-11
CHN,LUX,2019.0,3,1,2
PHL,GBR,2021.0,11,4,7
SVN,IND,2019.0,2,5,-3
CAN,IRL,2022.0,29,16,13
AUS,BRN,2001.0,4,1,3
SVN,EST,2020.0,1,1,0
TWN,MYS,2014.0,5,6,-1
SDN,KEN,2017.0,1,2,-1
CMR,GBR,2020.0,3,1,2
HRV,SVN,2003.0,2,2,0
GRC,TUR,2017.0,5,5,0
IDN,IND,2009.0,2,2,0
KOR,MNG,2013.0,4,1,3
ROU,CAN,2004.0,7,1,6
RUS,KGZ,2015.0,3,7,-4
ZAF,DEU,1998.0,2,3,-1
CHE,NLD,1999.0,17,11,6
CHE,ISR,2013.0,13,9,4
ESP,JPN,2018.0,16,15,1
QAT,IRL,2020.0,3,5,-2
CHN,PHL,2019.0,3,8,-5
FRA,VEN,2008.0,2,3,-1
AUS,CHE,2003.0,22,34,-12
BEL,GMB,2013.0,1,1,0
RUS,MDA,2020.0,4,3,1
USA,TZA,2008.0,4,4,0
AUS,TUR,2004.0,1,2,-1
CHN,POL,2014.0,4,33,-29
CHL,CHE,2009.0,6,3,3
SVN,BIH,2006.0,3,2,1
DNK,HUN,2010.0,1,5,-4
ISR,AUT,2003.0,3,2,1
CUB,FRA,2001.0,2,1,1
MYS,CAN,2008.0,2,5,-3
ZAF,NGA,2013.0,18,38,-20
NZL,ESP,2020.0,5,4,1
LTU,FRA,2008.0,3,2,1
KEN,FRA,2017.0,1,3,-2
FRA,SRB,2007.0,6,6,0
KOR,TWN,2012.0,5,11,-6
COL,BEL,2014.0,1,3,-2
USA,SEN,2018.0,3,9,-6
ARG,CHL,2011.0,15,16,-1
SWE,MAR,2015.0,1,1,0
CAN,GHA,2014.0,4,6,-2
ARM,DEU,2011.0,3,2,1
SGP,IRL,2010.0,1,9,-8
PAK,EGY,2014.0,1,3,-2
IND,ATG,2020.0,2,1,1
ISR,HUN,2021.0,3,3,0
MDG,FRA,2009.0,5,8,-3
ESP,BGR,2012.0,1,3,-2
ARE,JOR,2014.0,4,11,-7
MAC,HKG,2016.0,8,15,-7
ITA,ARG,2018.0,12,10,2
NGA,BRA,2015.0,9,5,4
ITA,PER,2021.0,1,4,-3
AUS,BGD,2006.0,3,6,-3
SRB,AUT,2013.0,5,1,4
KEN,FRA,2019.0,3,1,2
KWT,TUR,2019.0,2,6,-4
EST,DEU,2017.0,9,4,5
BRA,TUR,2019.0,1,2,-1
CHE,MOZ,2016.0,2,1,1
BRA,KOR,2020.0,3,2,1
SYR,SWE,2018.0,1,1,0
KOR,MYS,2011.0,13,6,7
CHN,ITA,1999.0,4,10,-6
JPN,ITA,1998.0,5,9,-4
AUT,IRL,2020.0,6,5,1
JPN,KEN,2011.0,6,4,2
IRL,ZAF,2019.0,1,3,-2
FRA,DZA,2000.0,4,13,-9
USA,UZB,2016.0,2,3,-1
USA,ZWE,2008.0,5,5,0
MYS,BRN,2013.0,7,2,5
OMN,IND,2017.0,11,25,-14
DNK,CAN,1998.0,4,6,-2
VEN,CUB,2004.0,1,4,-3
LTU,GBR,2004.0,5,1,4
MOZ,USA,2014.0,1,4,-3
ZMB,JPN,2020.0,3,5,-2
NCL,FRA,2002.0,8,8,0
DEU,ROU,2003.0,9,25,-16
IND,TUR,2019.0,10,5,5
JOR,AUS,2003.0,2,1,1
BEL,SRB,2015.0,6,1,5
ZAF,SWZ,2022.0,3,3,0
NLD,CAN,1997.0,3,6,-3
PRT,CUB,2011.0,1,4,-3
BEL,CHN,2001.0,3,9,-6
BEL,ISR,2013.0,3,2,1
CHE,ETH,2016.0,2,5,-3
AUS,PYF,2018.0,2,1,1
REU,FRA,2010.0,10,12,-2
EGY,QAT,2016.0,9,6,3
JOR,EGY,2017.0,3,1,2
CIV,CMR,2019.0,1,1,0
BRN,CHN,2017.0,1,3,-2
FRA,PYF,2019.0,11,10,1
KOR,IRQ,2022.0,1,2,-1
BGR,CZE,2014.0,2,2,0
PRT,COL,2019.0,2,6,-4
ARE,NZL,2021.0,3,5,-2
PRI,GBR,2007.0,1,1,0
POL,LTU,2007.0,2,3,-1
NZL,JPN,2014.0,5,7,-2
FRA,HKG,2004.0,3,2,1
USA,LTU,2010.0,8,3,5
MLI,USA,2004.0,1,4,-3
IND,ITA,2006.0,10,11,-1
THA,PHL,2012.0,2,3,-1
ARE,FRA,2011.0,1,7,-6
SWE,SAU,2007.0,3,2,1
CZE,SWE,2000.0,1,2,-1
BEL,AUT,2001.0,5,2,3
GBR,VNM,2010.0,9,9,0
URY,USA,2014.0,6,9,-3
AUS,COL,2006.0,2,1,1
HUN,FRA,1998.0,4,3,1
KWT,USA,2014.0,4,10,-6
ARG,DEU,1997.0,5,1,4
KOR,CHL,2011.0,2,1,1
JPN,TUR,2002.0,9,8,1
EST,DEU,2010.0,6,4,2
FRA,KEN,2014.0,1,2,-1
USA,PNG,2016.0,2,1,1
ROU,IRL,2003.0,1,1,0
SGP,RUS,2013.0,3,4,-1
PAN,ESP,2013.0,2,5,-3
BRA,VEN,2016.0,3,5,-2
FIN,CHN,2006.0,11,1,10
GBR,JAM,2007.0,3,4,-1
CHN,PRT,2011.0,9,9,0
AUT,HUN,2005.0,9,12,-3
EGY,KOR,2009.0,4,4,0
SVK,CAN,2017.0,1,1,0
MEX,CRI,2008.0,3,1,2
ROU,CHN,2022.0,1,2,-1
CZE,BEL,2010.0,2,3,-1
USA,LBY,2013.0,6,2,4
JOR,NLD,2011.0,1,1,0
OMN,GBR,2015.0,3,15,-12
SEN,BEL,2011.0,1,2,-1
SWE,VNM,2014.0,2,1,1
CHN,IRN,2017.0,3,22,-19
FRA,BEN,2016.0,9,8,1
BIH,SRB,2020.0,9,9,0
MYS,DNK,2014.0,6,1,5
AUS,SYC,2018.0,1,1,0
ARE,KAZ,2022.0,1,1,0
OMN,AUS,2018.0,2,6,-4
IND,MOZ,2015.0,1,1,0
LUX,AUT,2021.0,3,2,1
CHN,MMR,2019.0,2,7,-5
KOR,FIN,2009.0,4,1,3
AUT,IDN,2012.0,1,2,-1
NZL,NLD,2006.0,9,11,-2
NGA,GHA,2003.0,1,1,0
JPN,AUT,2002.0,6,6,0
SVN,GBR,2007.0,12,5,7
KWT,SWE,2014.0,1,1,0
NLD,NZL,2021.0,10,9,1
ZAF,DEU,1997.0,4,4,0
SWE,CZE,2014.0,2,11,-9
CRI,CAN,2012.0,3,1,2
SAU,BHR,2020.0,8,5,3
TZA,DEU,2016.0,2,6,-4
AUT,TUR,2008.0,2,1,1
KEN,MWI,2011.0,1,1,0
TUR,NZL,2005.0,1,1,0
GEO,FRA,2005.0,1,1,0
MAR,IND,2003.0,1,1,0
CHL,KOR,2010.0,1,1,0
NLD,BRA,2000.0,4,3,1
NZL,FLK,2013.0,1,1,0
PAK,FIN,2017.0,5,2,3
GNQ,GIN,2018.0,1,1,0
KOR,IRN,2014.0,3,14,-11
TUR,ZAF,2018.0,4,2,2
GRC,RUS,2021.0,2,3,-1
GBR,URY,2014.0,3,1,2
AUT,UKR,2016.0,2,6,-4
NOR,ISL,2015.0,4,6,-2
PRT,NOR,2003.0,3,1,2
ESP,PER,2003.0,1,3,-2
CHE,TZA,2012.0,1,4,-3
POL,SRB,2008.0,1,1,0
EST,CZE,2022.0,1,1,0
IDN,THA,2001.0,1,1,0
MUS,GBR,2003.0,1,1,0
CHL,CZE,2018.0,2,1,1
CYP,CHE,2021.0,2,1,1
CAN,PER,2019.0,5,2,3
KEN,JPN,2020.0,5,5,0
NOR,ETH,2012.0,4,6,-2
ITA,VNM,2015.0,2,2,0
AUS,SVN,2022.0,1,1,0
GRC,EST,2012.0,1,1,0
NOR,HKG,2018.0,1,2,-1
IDN,CAN,2014.0,2,2,0
ESP,SAU,2021.0,7,3,4
CYP,CHN,2021.0,1,2,-1
BOL,USA,2015.0,2,6,-4
BRA,NZL,2006.0,3,1,2
BRA,TUR,2017.0,2,1,1
CZE,ZAF,2021.0,1,2,-1
DNK,CAN,1997.0,2,3,-1
ROU,HUN,2019.0,11,12,-1
SVN,POL,2020.0,1,1,0
MKD,GRC,2020.0,1,1,0
SGP,JPN,2003.0,8,14,-6
OMN,IND,2010.0,3,20,-17
SEN,GAB,2005.0,1,1,0
ROU,POL,2015.0,3,3,0
KEN,PAK,2021.0,8,1,7
BRA,IND,2022.0,6,1,5
IRL,IRN,2009.0,2,3,-1
TUR,IRL,2017.0,2,1,1
USA,GTM,2020.0,7,8,-1
CHN,RUS,1999.0,4,2,2
ECU,FRA,2011.0,4,6,-2
TZA,PAK,2017.0,3,1,2
BEL,MAR,2019.0,3,3,0
NZL,LKA,2014.0,2,1,1
BGD,CHN,2011.0,2,8,-6
BGR,RUS,2021.0,2,3,-1
LTU,USA,2004.0,4,6,-2
KWT,SAU,2001.0,2,1,1
DNK,GRC,2003.0,2,2,0
FIN,FRA,1998.0,2,3,-1
NLD,NGA,2009.0,1,1,0
CHE,BRA,1997.0,1,2,-1
FIN,TZA,2011.0,2,1,1
DNK,THA,2008.0,1,3,-2
MEX,CHN,2012.0,3,1,2
COL,CUB,2002.0,4,1,3
THA,IRN,2018.0,1,1,0
DZA,CAN,2014.0,1,8,-7
TZA,PAK,2010.0,2,1,1
ZAF,BEN,2010.0,1,1,0
ITA,CZE,2008.0,9,3,6
MWI,DEU,2015.0,2,1,1
IRL,ZAF,2017.0,2,6,-4
IND,BRA,2021.0,8,4,4
SWE,UKR,2018.0,3,5,-2
HRV,CHE,2016.0,4,4,0
AUS,ROU,2015.0,2,2,0
HKG,SWE,2005.0,1,2,-1
IRL,GRC,2022.0,2,3,-1
ITA,NPL,2021.0,2,2,0
THA,SWE,2006.0,5,3,2
BWA,SWZ,2009.0,1,1,0
ALB,SRB,2015.0,6,1,5
PAK,ESP,2017.0,2,3,-1
MYS,KWT,2021.0,3,1,2
DNK,LTU,2005.0,3,1,2
IRN,FRA,2002.0,2,4,-2
DEU,BGR,2021.0,2,6,-4
USA,LVA,2001.0,3,1,2
GHA,ITA,2021.0,1,1,0
IND,THA,2009.0,4,3,1
FIN,GRC,2010.0,1,3,-2
OMN,EGY,2004.0,2,2,0
GBR,CMR,2001.0,1,1,0
JPN,BGR,2001.0,5,2,3
GTM,USA,2012.0,3,8,-5
ARG,DNK,2001.0,2,1,1
FRA,CIV,1997.0,1,2,-1
RUS,PRT,1997.0,1,1,0
GBR,NAM,2017.0,1,1,0
IDN,KEN,2013.0,1,1,0
EGY,CHN,2008.0,2,3,-1
BRA,PAK,2008.0,2,1,1
PRT,MYS,2013.0,1,3,-2
BGR,NLD,2019.0,1,2,-1
CHE,CYP,2012.0,1,1,0
ETH,DEU,2011.0,4,11,-7
NGA,KOR,2015.0,2,1,1
TUR,AUS,2009.0,4,1,3
MDG,NER,2005.0,1,2,-1
CMR,KEN,2018.0,1,2,-1
ROU,SVN,2006.0,2,1,1
ZAF,BEL,2004.0,3,9,-6
CAN,PER,2010.0,3,1,2
PAK,NPL,2017.0,3,1,2
AUS,TZA,2014.0,1,1,0
USA,CHN,2023.0,2,2,0
BEL,AUS,1999.0,2,3,-1
CMR,CAN,2000.0,1,1,0
FJI,USA,2020.0,4,2,2
CHL,BEL,2009.0,2,6,-4
ROU,FRA,1997.0,5,4,1
HRV,AUT,2011.0,4,4,0
USA,MLI,2005.0,6,1,5
BGR,POL,2003.0,2,3,-1
TWN,CHE,2007.0,2,3,-1
TWN,NLD,2009.0,3,3,0
HKG,CZE,2017.0,1,1,0
FIN,ARE,2016.0,3,1,2
CUB,BRA,2008.0,3,4,-1
PAK,JPN,2015.0,3,7,-4
PRT,NZL,2015.0,1,2,-1
SYR,FRA,2014.0,2,8,-6
ITA,SRB,2016.0,8,6,2
IND,COL,2013.0,1,2,-1
THA,BGD,2017.0,2,1,1
GBR,SVK,2021.0,5,3,2
BRB,USA,2017.0,2,1,1
RUS,DNK,2020.0,6,3,3
ECU,CAN,2005.0,1,1,0
TWN,UKR,2006.0,1,2,-1
IRL,SAU,2017.0,1,6,-5
SVK,CAN,2019.0,1,1,0
SVN,CZE,2021.0,1,2,-1
LKA,NOR,2020.0,1,2,-1
SGP,MAC,2007.0,1,1,0
ITA,TZA,2022.0,4,1,3
USA,PRY,2021.0,4,2,2
NPL,CAN,2018.0,2,2,0
DNK,HUN,2017.0,1,4,-3
ZMB,GBR,2008.0,1,2,-1
RUS,TJK,2015.0,4,2,2
IRN,SGP,2022.0,2,3,-1
BEL,BGD,2021.0,3,2,1
IRQ,MYS,2012.0,6,23,-17
JPN,MWI,2019.0,2,2,0
IND,HUN,2022.0,3,1,2
NOR,ROU,2006.0,1,1,0
SYR,JOR,2013.0,1,1,0
MAC,TWN,2021.0,1,2,-1
KAZ,SAU,2018.0,3,3,0
SGP,IRL,2017.0,2,8,-6
AUS,CYP,2018.0,1,2,-1
LSO,ZAF,2006.0,1,2,-1
BEL,EGY,2003.0,1,1,0
AUS,ISR,2003.0,3,13,-10
IRL,ZAF,2010.0,4,4,0
NZL,NOR,2007.0,1,1,0
LVA,USA,2008.0,1,1,0
CMR,CHE,2002.0,1,1,0
ESP,URY,2000.0,2,1,1
USA,PHL,1998.0,1,1,0
GRC,POL,2009.0,1,5,-4
CHE,CHL,2020.0,5,4,1
BGD,KOR,2006.0,6,1,5
CHE,TWN,2004.0,2,1,1
HRV,DNK,2013.0,2,1,1
CHN,MAR,2018.0,3,2,1
SGP,PRT,2022.0,1,1,0
KGZ,USA,2019.0,1,2,-1
PHL,NLD,2003.0,3,2,1
BLR,GBR,2012.0,1,4,-3
CHL,ARG,1999.0,1,3,-2
BHR,GBR,2012.0,2,5,-3
SRB,CZE,2013.0,1,1,0
ROU,CZE,2009.0,1,1,0
QAT,SWE,2019.0,3,1,2
ECU,CUB,2020.0,5,8,-3
BEL,CYP,2015.0,1,1,0
CAF,FRA,2002.0,1,1,0
UGA,CHE,2012.0,4,3,1
YEM,EGY,2008.0,1,2,-1
FIN,GRC,2019.0,2,2,0
ISR,BLR,2007.0,1,1,0
SVN,SVK,1998.0,1,2,-1
ZWE,CAN,2009.0,3,1,2
TGO,FRA,2006.0,1,7,-6
EST,USA,2000.0,1,1,0
PAK,ZAF,2009.0,1,1,0
BRA,ECU,2010.0,1,2,-1
NLD,HRV,2012.0,1,6,-5
FRA,PSE,2020.0,1,1,0
CYP,ITA,2017.0,2,2,0
PER,KOR,2017.0,1,1,0
ESP,MLT,2020.0,1,1,0
CMR,ITA,2020.0,1,4,-3
ISR,BRA,2021.0,2,3,-1
QAT,SAU,2006.0,1,2,-1
ITA,ARM,2003.0,1,1,0
BEL,HUN,2022.0,1,1,0
LBY,JPN,2020.0,1,1,0
FRA,MTQ,2000.0,1,8,-7
NLD,TZA,2011.0,2,1,1
ETH,SWE,2008.0,1,1,0
FRA,PER,2021.0,3,3,0
CRI,VEN,2010.0,1,1,0
DNK,GRL,2007.0,1,3,-2
COG,BEL,2011.0,3,3,0
ITA,ISL,2013.0,2,1,1
JOR,SWE,2019.0,2,1,1
CAN,VNM,2012.0,3,1,2
LUX,CAN,2008.0,1,2,-1
ARG,PER,2002.0,1,3,-2
OMN,PAK,2011.0,1,4,-3
EGY,JOR,2003.0,1,3,-2
ITA,ALB,2008.0,1,1,0
BIH,USA,2012.0,2,6,-4
KEN,DNK,2015.0,1,2,-1
PRT,COL,2010.0,1,1,0
ITA,KEN,2002.0,1,2,-1
QAT,GRC,2020.0,2,6,-4
CAN,CIV,2004.0,1,2,-1
FRA,ARM,2020.0,1,1,0
GUY,CAN,2009.0,1,1,0
POL,ISR,2003.0,2,1,1
GBR,AZE,2000.0,1,1,0
NER,FRA,2007.0,1,6,-5
AUS,SRB,2007.0,2,2,0
BRA,JPN,2003.0,4,18,-14
ISL,CAN,2016.0,1,3,-2
RUS,EST,1999.0,1,1,0
HUN,GRC,2010.0,1,1,0
CHN,MMR,2017.0,3,1,2
EGY,CZE,2018.0,1,2,-1
NLD,KEN,2022.0,1,2,-1
LKA,IRL,2018.0,1,1,0
BEL,ISL,2020.0,1,1,0
PSE,ISR,2006.0,1,6,-5
COD,ZAF,2021.0,1,2,-1
SEN,USA,2012.0,2,3,-1
ISR,POL,2022.0,1,1,0
CZE,KOR,2021.0,1,3,-2
MEX,PRY,2015.0,1,1,0
ZAF,BEN,2017.0,1,1,0
ISR,DNK,2015.0,1,1,0
ARE,IND,2010.0,1,15,-14
SAU,NOR,2022.0,2,1,1
NZL,NPL,2020.0,1,2,-1
KWT,KOR,2020.0,1,1,0
BLR,USA,2022.0,1,1,0
NOR,KEN,2020.0,1,1,0
KOR,BEL,2004.0,2,1,1
HUN,GRC,2019.0,1,3,-2
BEL,NGA,2005.0,1,1,0
AGO,PRT,2002.0,1,1,0
PAK,FRA,2004.0,1,1,0
ISR,UKR,2007.0,1,2,-1
IND,BHR,2003.0,1,2,-1
SGP,BEL,2007.0,1,3,-2
OMN,JOR,2006.0,1,1,0
NOR,NPL,2009.0,1,2,-1
NLD,GRC,2000.0,1,3,-2
NLD,HUN,2000.0,1,5,-4
DEU,MKD,2020.0,1,1,0
IRL,NLD,2000.0,1,1,0
MEX,PAK,2021.0,1,1,0
CHE,BRA,1998.0,1,2,-1
IRQ,PAK,2017.0,2,1,1
CAN,KHM,2019.0,1,2,-1
LAO,USA,2005.0,1,1,0
ARE,BGD,2009.0,1,1,0
HUN,FRA,1997.0,1,3,-2
LAO,FRA,2015.0,1,2,-1
OMN,BHR,2005.0,1,1,0
NOR,CHL,2011.0,1,4,-3
MWI,NLD,2020.0,1,1,0
ARG,URY,2007.0,1,3,-2
CHL,KOR,2017.0,1,4,-3
ISR,KOR,2008.0,1,1,0
POL,TUR,2008.0,1,1,0
URY,PRY,2021.0,1,1,0
MOZ,ZAF,2003.0,1,1,0
SVN,CAN,2010.0,1,1,0
ZAF,CMR,2009.0,1,3,-2
ISR,ETH,2016.0,1,2,-1
MLT,BRA,2020.0,1,1,0
TUR,IRL,2010.0,1,2,-1
DNK,MEX,2006.0,1,2,-1
ARG,BEL,2007.0,1,3,-2
CAN,IDN,2022.0,1,1,0
HKG,RUS,2021.0,1,2,-1
KAZ,IRN,2020.0,1,1,0
AUT,DEU,2011.0,248,308,-60
KOR,JPN,2005.0,76,149,-73
USA,AUS,2018.0,581,655,-74
CHE,ESP,2017.0,65,103,-38
DEU,POL,2013.0,120,82,38
KOR,SGP,2009.0,18,12,6
USA,NLD,2010.0,301,272,29
KOR,JPN,2002.0,71,124,-53
ZAF,AUS,2008.0,36,15,21
USA,NLD,2017.0,363,370,-7
ARE,DEU,2008.0,1,6,-5
USA,AUT,2017.0,106,129,-23
USA,ECU,2007.0,6,8,-2
HKG,CHN,2005.0,196,169,27
CHL,KOR,2019.0,9,2,7
USA,SVN,2021.0,12,3,9
RUS,AUT,2005.0,10,5,5
SGP,USA,2017.0,204,228,-24
THA,JPN,2017.0,53,100,-47
USA,TUR,2016.0,280,242,38
JOR,MYS,2017.0,8,18,-10
CHN,NOR,2017.0,14,25,-11
BRA,MEX,2014.0,12,26,-14
USA,ARE,2015.0,82,42,40
BRA,SWE,2021.0,24,9,15
SGP,KAZ,2017.0,2,2,0
CHN,NGA,2017.0,8,17,-9
SGP,IRL,2019.0,11,5,6
USA,BWA,2019.0,18,14,4
TWN,VNM,2018.0,38,9,29
DNK,BRA,2018.0,7,19,-12
DEU,IRL,2018.0,38,47,-9
BRA,NGA,2019.0,10,10,0
PRT,ITA,2021.0,30,32,-2
SGP,IND,2012.0,34,69,-35
PAK,CHN,2013.0,44,46,-2
IND,FIN,2018.0,19,5,14
NPL,JPN,2007.0,4,10,-6
ITA,AUS,2014.0,37,17,20
NZL,PAK,2013.0,8,2,6
SAU,PSE,2020.0,4,1,3
KOR,RUS,2020.0,5,14,-9
THA,BGD,2019.0,1,4,-3
NLD,IND,2018.0,43,29,14
KOR,EGY,2015.0,7,5,2
NCL,FRA,2005.0,8,13,-5
ESP,NLD,2002.0,38,39,-1
CHE,FRA,1999.0,67,55,12
HUN,NLD,2017.0,7,10,-3
JPN,NZL,2009.0,11,8,3
FRA,EGY,2017.0,15,10,5
ZAF,NOR,2020.0,8,2,6
USA,LKA,2014.0,16,4,12
MYS,IRL,2018.0,7,4,3
PER,USA,2017.0,37,34,3
PRT,RUS,2013.0,1,1,0
ARG,FRA,2008.0,14,21,-7
GEO,GBR,2004.0,2,1,1
URY,ESP,2007.0,8,1,7
ESP,AUT,2009.0,12,20,-8
GRL,DNK,2008.0,3,7,-4
GRC,NOR,2010.0,5,1,4
GBR,TUR,1999.0,30,5,25
SWE,MEX,2020.0,7,9,-2
USA,UKR,2004.0,11,43,-32
AUS,JPN,2001.0,39,38,1
IRL,ITA,2005.0,6,9,-3
USA,HRV,2007.0,17,9,8
USA,MLI,2002.0,5,2,3
USA,ISL,2003.0,11,11,0
FRA,MEX,2006.0,30,20,10
USA,SRB,2014.0,18,12,6
NLD,CAN,1998.0,6,8,-2
AUT,JPN,2008.0,9,10,-1
THA,BGD,2010.0,1,1,0
KOR,UZB,2009.0,1,3,-2
CHN,PHL,2010.0,2,2,0
CAN,CZE,2015.0,10,8,2
ESP,MOZ,2010.0,4,2,2
CHN,IRN,2019.0,13,60,-47
HRV,GBR,2017.0,21,8,13
FRA,ARG,2014.0,22,31,-9
BEL,SVK,2015.0,2,4,-2
TUR,KOR,2019.0,6,2,4
HUN,AUT,2020.0,15,8,7
ESP,VEN,2004.0,16,20,-4
KHM,AUS,2011.0,1,3,-2
MEX,IRL,2006.0,1,2,-1
TUN,USA,2020.0,8,3,5
TUR,KGZ,2015.0,4,3,1
USA,HTI,2012.0,4,11,-7
LUX,DEU,2012.0,8,27,-19
AUT,POL,2014.0,7,21,-14
DEU,EST,2020.0,8,6,2
AZE,RUS,2000.0,3,4,-1
ARG,ISR,2004.0,6,1,5
USA,BWA,2010.0,7,8,-1
PER,MEX,2015.0,3,7,-4
JOR,MYS,2010.0,2,8,-6
CZE,CHN,2009.0,2,1,1
HRV,GBR,2010.0,4,6,-2
BEL,PRT,2015.0,7,24,-17
NLD,ZMB,2014.0,1,1,0
MEX,NZL,2016.0,3,2,1
UKR,CAN,2014.0,5,1,4
FIN,LBN,2021.0,1,1,0
QAT,SWE,2017.0,3,1,2
USA,BWA,2017.0,6,9,-3
QAT,ESP,2017.0,3,6,-3
NOR,IRL,2001.0,3,3,0
CHE,KOR,2012.0,5,8,-3
CHN,IRN,2010.0,2,2,0
ITA,ROU,2014.0,4,11,-7
HUN,NLD,2019.0,9,12,-3
NPL,ITA,2021.0,2,2,0
CZE,FIN,2014.0,4,2,2
NZL,IND,2009.0,2,9,-7
FRA,REU,2003.0,2,2,0
FRA,PYF,2010.0,4,2,2
BEL,RUS,2001.0,4,19,-15
JPN,NOR,2011.0,7,1,6
ZAF,IRL,2012.0,1,2,-1
AUT,CHN,2004.0,2,3,-1
SVN,DEU,2001.0,5,1,4
KOR,POL,2011.0,3,1,2
DEU,IRQ,2021.0,3,4,-1
CAN,TWN,2021.0,6,9,-3
FRA,GEO,2014.0,5,5,0
LTU,POL,2012.0,2,1,1
TZA,PAK,2019.0,2,1,1
DNK,UKR,2018.0,1,2,-1
GRC,NOR,2017.0,7,1,6
USA,SLE,2015.0,3,5,-2
AUT,ARG,1999.0,1,1,0
ARG,IND,2019.0,3,1,2
RUS,PHL,2014.0,1,1,0
POL,BGR,1998.0,2,1,1
USA,LTU,2017.0,2,4,-2
KOR,CZE,2017.0,3,5,-2
UGA,SWE,2015.0,1,1,0
IND,CHE,1999.0,1,3,-2
NZL,ARE,2017.0,2,2,0
AUT,BGR,2018.0,3,1,2
MYS,ZAF,2020.0,2,1,1
GBR,BFA,2014.0,1,1,0
IDN,SWE,2022.0,1,1,0
HKG,BGD,2011.0,1,1,0
IRQ,DNK,2019.0,1,1,0
PRY,ESP,2002.0,1,1,0
PRT,THA,2016.0,1,2,-1
RUS,VNM,2008.0,4,1,3
BGR,CHE,2012.0,1,4,-3
TZA,GHA,2019.0,1,1,0
CAN,PER,2017.0,4,4,0
ROU,SWE,2020.0,2,1,1
HUN,PRT,2016.0,1,1,0
RUS,LTU,2013.0,1,1,0
CHN,VNM,2022.0,6,6,0
MEX,URY,2008.0,1,1,0
EST,AUS,2016.0,1,1,0
IND,TUR,2010.0,2,3,-1
SVN,RUS,1997.0,1,1,0
OMN,QAT,2017.0,1,1,0
PRT,POL,2006.0,1,3,-2
TZA,BEL,2006.0,1,3,-2
EGY,ZAF,2009.0,1,1,0
TUN,,2009.0,281,0,281
CAN,,2013.0,6854,0,6854
,LTU,2004.0,645,0,645
BRA,,2022.0,39255,0,39255
KOR,,2013.0,7148,0,7148
USA,,2021.0,131687,0,131687
,BLR,2003.0,247,0,247
TUR,,2013.0,2643,0,2643
,HKG,1999.0,1951,0,1951
NGA,,2023.0,7515,0,7515
,KOR,2000.0,8634,0,8634
HRV,,2018.0,749,0,749
,CHE,2004.0,3564,0,3564
,UGA,2004.0,124,0,124
,KHM,2003.0,33,0,33
,CHN,2013.0,155898,0,155898
DEU,,2003.0,5435,0,5435
,JPN,1994.0,31545,0,31545
,TWN,1994.0,2010,0,2010
CHE,,2009.0,2050,0,2050
DNK,LKA,2005.0,2,0,2
,ISR,1999.0,4585,0,4585
HUN,,2019.0,1439,0,1439
BEL,,2018.0,3177,0,3177
,ARE,2002.0,103,0,103
SAU,,2010.0,233,0,233
,ISL,1999.0,167,0,167
SAU,,2017.0,884,0,884
SGP,,2020.0,2146,0,2146
,CZE,2006.0,2136,0,2136
HUN,,2010.0,694,0,694
LTU,,2020.0,559,0,559
,CHE,1996.0,1804,0,1804
,PRT,2008.0,2698,0,2698
HUN,,2017.0,1170,0,1170
,EGY,2009.0,3325,0,3325
,SAU,2003.0,435,0,435
LUX,,2008.0,24,0,24
SAU,,2019.0,1313,0,1313
AZE,,2018.0,147,0,147
BWA,,2014.0,29,0,29
MWI,DNK,2012.0,1,0,1
CMR,,2018.0,194,0,194
DEU,JOR,1998.0,1,0,1
,BGD,1999.0,369,0,369
,LTU,1996.0,126,0,126
TTO,,2011.0,32,0,32
,ROU,2011.0,2237,0,2237
BIH,,2013.0,101,0,101
PER,,2017.0,238,0,238
,BIH,2009.0,215,0,215
,PRI,2002.0,133,0,133
ARE,,2021.0,499,0,499
,IRN,2015.0,11386,0,11386
IRQ,,2020.0,406,0,406
VUT,,2011.0,1,0,1
,PER,2005.0,259,0,259
,NGA,1995.0,182,0,182
,VNM,2000.0,132,0,132
,ZAF,2014.0,2664,0,2664
MLI,BEL,2003.0,1,0,1
GUM,,2024.0,18,0,18
DNK,UGA,2014.0,1,0,1
,BGR,2012.0,492,0,492
PER,,2019.0,295,0,295
CHN,LTU,2021.0,1,0,1
,CHL,2012.0,2084,0,2084
,LAO,2011.0,34,0,34
SUR,,2020.0,3,0,3
,CYP,2010.0,136,0,136
PAN,,2016.0,32,0,32
,BHR,2011.0,50,0,50
,PER,2002.0,175,0,175
,GHA,2015.0,536,0,536
TTO,ESP,2019.0,1,0,1
,CRI,2018.0,172,0,172
,MLT,2014.0,91,0,91
SRB,POL,2012.0,4,0,4
KHM,SWE,2011.0,1,0,1
NER,,2019.0,22,0,22
,HTI,2013.0,33,0,33
CHL,,2004.0,142,0,142
,GUF,2014.0,15,0,15
MLT,,2020.0,66,0,66
KGZ,,2020.0,40,0,40
TZA,ZWE,2019.0,1,0,1
,CYP,2017.0,182,0,182
SOM,,2023.0,23,0,23
,GEO,2016.0,176,0,176
ZAF,UGA,2009.0,5,0,5
AUT,,2025.0,5,0,5
ATG,,2024.0,8,0,8
,ECU,2018.0,741,0,741
,PAN,2016.0,51,0,51
,CYP,2019.0,108,0,108
,MWI,2018.0,110,0,110
,MKD,2007.0,103,0,103
PER,,2010.0,58,0,58
MKD,,2011.0,38,0,38
,ARE,2005.0,132,0,132
,PHL,2000.0,249,0,249
NOR,VNM,2016.0,1,0,1
CZE,HUN,1997.0,1,0,1
MDG,AUS,2014.0,1,0,1
THA,TZA,2013.0,2,0,2
TWN,ESP,2002.0,3,0,3
CMR,SEN,2003.0,1,0,1
AUS,TTO,2018.0,4,0,4
NER,,2010.0,4,0,4
SGP,UGA,2022.0,3,0,3
,PRI,2005.0,157,0,157
BIH,JPN,2018.0,1,0,1
CHN,KWT,2020.0,1,0,1
MEX,SWE,2022.0,6,0,6
UKR,,2006.0,516,0,516
SWE,KAZ,2021.0,2,0,2
,SOM,2015.0,7,0,7
NZL,MAC,2022.0,1,0,1
THA,,2006.0,216,0,216
,BRB,2017.0,5,0,5
URY,,2007.0,30,0,30
,CMR,1995.0,19,0,19
,ZMB,1999.0,43,0,43
SOM,TUN,2007.0,1,0,1
SVN,BRA,2003.0,1,0,1
GEO,,2007.0,30,0,30
BRN,SAU,2009.0,1,0,1
IRL,BWA,2019.0,2,0,2
MLI,,2013.0,16,0,16
SVK,CAN,2010.0,2,0,2
HUN,MKD,2002.0,1,0,1
JOR,NZL,2002.0,1,0,1
,YEM,2000.0,10,0,10
NLD,OMN,2013.0,1,0,1
BDI,,2021.0,8,0,8
NER,,2017.0,17,0,17
ERI,SDN,2018.0,1,0,1
LBN,,2004.0,30,0,30
BEN,GMB,2012.0,1,0,1
BOL,,2006.0,9,0,9
SGP,MEX,2013.0,3,0,3
JPN,LTU,2002.0,1,0,1
SLB,AUS,2003.0,1,0,1
FIN,,2000.0,63,0,63
,JAM,1995.0,19,0,19
NER,NGA,2011.0,1,0,1
DNK,ROU,2012.0,3,0,3
,IRQ,1995.0,16,0,16
ROU,MEX,2006.0,1,0,1
,GLP,2006.0,7,0,7
,URY,1994.0,52,0,52
PRT,BLR,2011.0,1,0,1
PER,ISR,2011.0,1,0,1
FJI,CAN,2012.0,1,0,1
ISR,HKG,2014.0,2,0,2
AUS,THA,1997.0,2,0,2
JOR,SAU,2001.0,3,0,3
GMB,BEL,2007.0,2,0,2
IRN,HUN,2007.0,1,0,1
DEU,BIH,2012.0,2,0,2
MCO,,2007.0,4,0,4
JPN,MNE,2003.0,1,0,1
FRA,KWT,2008.0,1,0,1
DEU,DZA,1998.0,1,0,1
HKG,ESP,2007.0,1,0,1
DEU,PER,2000.0,1,0,1
GBR,ERI,2019.0,1,0,1
CAN,MYS,2000.0,1,0,1
GBR,UGA,2000.0,3,0,3
ARG,CHE,2000.0,2,0,2
NZL,FJI,2006.0,3,0,3
CHN,HRV,2013.0,1,0,1
IRL,BHR,2014.0,3,0,3
BGR,SGP,2021.0,1,0,1
MYS,QAT,2014.0,3,0,3
HUN,CZE,2006.0,2,0,2
DEU,ALB,2022.0,1,0,1
,PRY,2006.0,16,0,16
NOR,SAU,2012.0,5,0,5
FRA,FRO,2008.0,1,0,1
RUS,ISL,2011.0,2,0,2
PER,KOR,2010.0,1,0,1
OMN,BRN,2019.0,1,0,1
CAN,ISL,2015.0,2,0,2
ETH,BWA,2021.0,2,0,2
,GAB,2011.0,29,0,29
BRN,FRA,2021.0,1,0,1
SGP,KAZ,2019.0,3,0,3
IRN,ISR,2021.0,1,0,1
TCD,,2018.0,5,0,5
MKD,BGR,2016.0,1,0,1
MEX,POL,2022.0,3,0,3
LVA,EST,2011.0,1,0,1
SVK,JPN,2017.0,2,0,2
BGD,VNM,2019.0,1,0,1
MYS,AFG,2020.0,5,0,5
GRD,CHE,2019.0,1,0,1
IRQ,MAR,2018.0,1,0,1
SGP,SAU,2011.0,13,0,13
ETH,CAN,2007.0,1,0,1
BEL,IDN,2015.0,2,0,2
JOR,ARE,2010.0,11,0,11
ZAF,TWN,2006.0,1,0,1
,UGA,1996.0,21,0,21
PAN,CHE,2002.0,1,0,1
HKG,NZL,2012.0,4,0,4
,BRB,2010.0,8,0,8
SWE,CRI,2018.0,4,0,4
JPN,CUB,2015.0,1,0,1
TWN,POL,2018.0,1,0,1
UZB,JPN,2005.0,4,0,4
VEN,DOM,2018.0,2,0,2
LKA,THA,2006.0,1,0,1
,TCD,2010.0,3,0,3
IRN,MEX,2020.0,5,0,5
PAK,FIN,2010.0,1,0,1
CHE,SDN,2020.0,2,0,2
CAN,KHM,2017.0,1,0,1
MYS,ISR,2004.0,3,0,3
MEX,SUR,2021.0,1,0,1
MOZ,,2006.0,8,0,8
BLR,LTU,2022.0,4,0,4
ITA,PRY,2020.0,1,0,1
CIV,CRI,2014.0,3,0,3
EGY,SWE,2006.0,3,0,3
GAB,MAR,2017.0,1,0,1
MNG,NLD,2018.0,1,0,1
MDA,USA,2006.0,2,0,2
ZAF,POL,2011.0,7,0,7
MNG,DEU,2008.0,1,0,1
COL,VNM,2011.0,1,0,1
EGY,IRN,2004.0,1,0,1
AUS,GUM,2007.0,1,0,1
ESP,PAN,2011.0,3,0,3
,AGO,2008.0,9,0,9
NGA,BEN,2003.0,3,0,3
SVK,JPN,2010.0,1,0,1
NLD,CIV,2009.0,1,0,1
SWZ,,2014.0,5,0,5
SLB,,2018.0,2,0,2
TWN,TUR,2009.0,2,0,2
MLI,COG,2006.0,1,0,1
LAO,,2009.0,3,0,3
NLD,ARE,2002.0,2,0,2
FRA,LAO,2003.0,1,0,1
TTO,JAM,2007.0,1,0,1
SVK,NOR,2011.0,1,0,1
KEN,TWN,2011.0,1,0,1
BEL,TTO,2015.0,1,0,1
MYS,SWE,2002.0,1,0,1
HRV,NZL,1998.0,1,0,1
JPN,OMN,2011.0,1,0,1
ZAF,ZMB,2006.0,1,0,1
BRA,DNK,2011.0,4,0,4
MKD,SWE,2021.0,1,0,1
RUS,GRC,2018.0,1,0,1
GHA,RWA,2010.0,1,0,1
BGR,SRB,2012.0,3,0,3
BEL,BFA,2009.0,4,0,4
,COD,2007.0,9,0,9
ZWE,AUS,2009.0,2,0,2
CAN,GAB,2014.0,3,0,3
SLE,MLI,2017.0,1,0,1
GRC,BRA,2005.0,1,0,1
URY,ISR,2015.0,1,0,1
DZA,SAU,2001.0,3,0,3
NER,ITA,2007.0,1,0,1
IND,PAN,2006.0,1,0,1
BEL,EST,2018.0,4,0,4
CHN,COD,2021.0,2,0,2
,TCD,2017.0,10,0,10
IDN,BGD,2016.0,1,0,1
ETH,HKG,2022.0,1,0,1
SLV,,2016.0,4,0,4
BMU,FRA,2011.0,1,0,1
TUR,ARE,2010.0,1,0,1
LBY,TUN,2019.0,1,0,1
GRL,,2006.0,1,0,1
THA,CHN,2003.0,2,0,2
TUN,NLD,2020.0,2,0,2
SRB,DNK,2022.0,2,0,2
TWN,GRC,2002.0,1,0,1
VEN,URY,2002.0,1,0,1
IND,ROU,2016.0,2,0,2
HKG,QAT,2022.0,1,0,1
,AFG,1999.0,1,0,1
SEN,UGA,2013.0,1,0,1
JOR,SWE,2010.0,2,0,2
GBR,GRL,2021.0,1,0,1
SGP,BRN,2013.0,2,0,2
BEL,MAR,2017.0,7,0,7
PHL,AUT,2017.0,1,0,1
OMN,NGA,2017.0,1,0,1
ZAF,LBY,2019.0,2,0,2
DEU,CYP,2022.0,2,0,2
NLD,CHN,1998.0,3,0,3
TTO,ESP,2017.0,1,0,1
USA,COD,2013.0,2,0,2
FRA,EST,2022.0,2,0,2
ZWE,CHE,2001.0,1,0,1
BEL,MAR,2010.0,3,0,3
KWT,,1999.0,4,0,4
ZAF,RWA,2007.0,1,0,1
ISL,BRA,2002.0,1,0,1
CZE,BRA,2006.0,1,0,1
ALB,CAN,2002.0,1,0,1
IND,LBY,2001.0,2,0,2
USA,GHA,2000.0,3,0,3
BEN,BRA,2001.0,1,0,1
KWT,POL,2012.0,1,0,1
UZB,AZE,2012.0,1,0,1
SRB,FRA,1997.0,1,0,1
DEU,UGA,2003.0,1,0,1
VNM,KHM,2001.0,1,0,1
GBR,BRB,2021.0,1,0,1
FRA,AFG,2006.0,1,0,1
KHM,USA,2007.0,1,0,1
ZAF,ESP,2004.0,1,0,1
SAU,SYR,2006.0,1,0,1
LUX,BRA,2007.0,1,0,1
JAM,CAN,2009.0,2,0,2
,MNE,2006.0,34,0,34
IND,NER,2022.0,1,0,1
SVN,LVA,2018.0,1,0,1
JOR,EGY,2010.0,2,0,2
NAM,CHE,2021.0,1,0,1
ZAF,FIN,2012.0,5,0,5
NER,IND,2020.0,2,0,2
ITA,MLT,2005.0,1,0,1
KOR,LAO,2018.0,1,0,1
DNK,SGP,2022.0,2,0,2
UGA,NER,2020.0,1,0,1
IRN,PHL,2004.0,1,0,1
SVK,SWE,1999.0,1,0,1
GBR,BEN,2006.0,1,0,1
NLD,LUX,2010.0,2,0,2
MMR,NLD,2005.0,1,0,1
SWE,COG,2018.0,1,0,1
,HND,1999.0,2,0,2
FRA,CIV,1998.0,1,0,1
CHE,ERI,2018.0,1,0,1
CUB,ZAF,2009.0,1,0,1
JPN,MWI,2010.0,1,0,1
USA,NAM,2021.0,5,0,5
FRA,QAT,2009.0,2,0,2
QAT,CHE,2012.0,1,0,1
ESP,QAT,2008.0,1,0,1
LTU,HKG,2021.0,1,0,1
GIN,UGA,2017.0,1,0,1
ROU,QAT,2013.0,1,0,1
SVK,PRT,2013.0,2,0,2
DNK,LUX,2003.0,1,0,1
NZL,GRC,2003.0,1,0,1
BEL,GHA,2018.0,1,0,1
MAR,GAB,2016.0,2,0,2
BGD,BRN,2014.0,3,0,3
ETH,BDI,2018.0,1,0,1
URY,CAN,2011.0,1,0,1
KOR,CZE,2010.0,2,0,2
SWZ,USA,2015.0,1,0,1
DOM,ECU,2015.0,1,0,1
MWI,BEL,2021.0,1,0,1
ESP,LIE,2021.0,1,0,1
HUN,KWT,2017.0,1,0,1
MYS,CZE,2022.0,3,0,3
JPN,NAM,2014.0,2,0,2
SAU,UKR,2020.0,1,0,1
SAU,BGD,2007.0,1,0,1
AFG,CHE,2019.0,2,0,2
DNK,NER,2016.0,1,0,1
FIN,BEL,1998.0,3,0,3
PHL,UZB,2008.0,1,0,1
ROU,SAU,2015.0,3,0,3
NGA,NAM,2022.0,2,0,2
HTI,LBR,2017.0,1,0,1
CAN,COG,2007.0,1,0,1
FJI,TUR,2007.0,1,0,1
CHE,GLP,2009.0,1,0,1
FJI,,2005.0,4,0,4
ZAF,SRB,2004.0,1,0,1
,REU,2004.0,5,0,5
LKA,COL,2014.0,1,0,1
GAB,DEU,2007.0,2,0,2
SWE,DZA,2003.0,1,0,1
ETH,,2000.0,1,0,1
ZMB,AUT,2009.0,1,0,1
SWE,NIC,2003.0,3,0,3
FIN,JOR,2022.0,1,0,1
AUT,COL,2016.0,1,0,1
AZE,GBR,2014.0,1,0,1
HUN,HRV,2020.0,1,0,1
MUS,MDG,2021.0,1,0,1
FRA,HTI,2020.0,2,0,2
MNG,USA,2018.0,2,0,2
CYP,BEL,2011.0,1,0,1
BGR,TWN,2012.0,1,0,1
IRN,MAR,2013.0,1,0,1
CRI,CUB,2019.0,1,0,1
ARG,IND,2010.0,1,0,1
,NRU,1999.0,1,0,1
ESP,TZA,2006.0,1,0,1
BHR,,2002.0,2,0,2
UKR,AUS,2003.0,1,0,1
ITA,GTM,2006.0,1,0,1
PER,CZE,2002.0,1,0,1
IRQ,SYR,2005.0,1,0,1
NPL,DEU,2003.0,1,0,1
ZWE,DEU,2002.0,1,0,1
CZE,EGY,2004.0,1,0,1
AUS,BGR,2006.0,1,0,1
GEO,AUT,2006.0,1,0,1
BIH,ITA,2011.0,2,0,2
ARG,DZA,2003.0,1,0,1
SEN,GAB,2002.0,1,0,1
IDN,NCL,2017.0,1,0,1
OMN,QAT,2010.0,2,0,2
TZA,COG,2013.0,1,0,1
MUS,ZAF,2011.0,1,0,1
RUS,TZA,2013.0,1,0,1
USA,GNQ,2013.0,1,0,1
SEN,COG,2016.0,2,0,2
CHE,PYF,2022.0,1,0,1
PAK,AFG,2005.0,1,0,1
LVA,NOR,2018.0,1,0,1
MYS,BEL,2021.0,2,0,2
BWA,SVN,2007.0,1,0,1
AZE,SWE,2000.0,1,0,1
SEN,TUN,2006.0,1,0,1
HKG,ISR,2006.0,1,0,1
GBR,GAB,2021.0,1,0,1
MYS,PER,2009.0,1,0,1
GMB,GHA,2015.0,2,0,2
NLD,CHN,1997.0,2,0,2
IRQ,NLD,2015.0,1,0,1
,TCD,2019.0,4,0,4
DZA,SVK,2003.0,1,0,1
POL,MDA,2003.0,1,0,1
IND,EST,2014.0,1,0,1
BRA,SVK,2019.0,1,0,1
TWN,MEX,2013.0,1,0,1
ZWE,BEL,2002.0,1,0,1
NGA,ARG,2007.0,1,0,1
ARE,CZE,2011.0,2,0,2
CHE,SLE,2015.0,2,0,2
UKR,CHL,2002.0,1,0,1
MCO,CAN,2009.0,1,0,1
RUS,CHL,2008.0,2,0,2
JPN,SDN,2014.0,2,0,2
NLD,DZA,2009.0,1,0,1
AUT,HKG,2011.0,1,0,1
AND,ESP,2005.0,4,0,4
GRC,CZE,2011.0,1,0,1
NZL,POL,2021.0,1,0,1
FIN,NPL,2012.0,1,0,1
EGY,TWN,2011.0,1,0,1
EST,COL,2013.0,1,0,1
KHM,THA,2013.0,1,0,1
LVA,DNK,2014.0,1,0,1
UKR,ZAF,2019.0,2,0,2
ARE,ETH,2016.0,1,0,1
AUS,BTN,2021.0,3,0,3
CHN,LSO,2021.0,1,0,1
KOR,KHM,2021.0,1,0,1
MOZ,SWE,2021.0,1,0,1
SGP,ARE,2005.0,2,0,2
DEU,KWT,2018.0,1,0,1
NGA,GUY,2021.0,1,0,1
HTI,LBR,2019.0,1,0,1
GLP,TTO,2010.0,1,0,1
GHA,CMR,2005.0,1,0,1
NLD,PAK,2002.0,1,0,1
AFG,GBR,2014.0,1,0,1
PNG,FJI,2003.0,1,0,1
BHR,,2005.0,4,0,4
OMN,NGA,2010.0,1,0,1
TUN,AUS,2014.0,1,0,1
ITA,MCO,2022.0,1,0,1
CZE,HUN,1998.0,2,0,2
TUN,PSE,2021.0,2,0,2
NLD,FIN,1998.0,2,0,2
GRD,FRA,2001.0,1,0,1
HRV,ROU,2011.0,1,0,1
BRA,TWN,2008.0,1,0,1
NLD,PER,2008.0,2,0,2
JPN,SVN,2014.0,1,0,1
GHA,SEN,2013.0,1,0,1
,GNQ,2018.0,1,0,1
AZE,QAT,2021.0,1,0,1
CUB,MOZ,1997.0,1,0,1
ISR,TZA,2020.0,1,0,1
FSM,,2012.0,1,0,1
BGR,NLD,2010.0,1,0,1
RUS,JOR,2021.0,2,0,2
USA,MDG,2006.0,1,0,1
FIN,FRA,1997.0,1,0,1
EST,CHE,2007.0,1,0,1
ITA,MLI,2000.0,1,0,1
KWT,NZL,2016.0,1,0,1
COM,FRA,2012.0,1,0,1
MKD,SVN,2008.0,1,0,1
MWI,UGA,2018.0,1,0,1
BGR,SAU,2009.0,2,0,2
PYF,CHE,2013.0,1,0,1
ROU,ZAF,2015.0,1,0,1
HRV,IRL,2018.0,3,0,3
,BMU,2012.0,3,0,3
COL,SGP,2012.0,1,0,1
AZE,KAZ,2019.0,1,0,1
KHM,NGA,2017.0,1,0,1
THA,GUF,2002.0,1,0,1
NLD,ARE,2005.0,2,0,2
OMN,CRI,2007.0,1,0,1
OMN,MYS,1998.0,1,0,1
CHE,DZA,2016.0,2,0,2
ZMB,MYS,2022.0,1,0,1
GEO,NOR,2021.0,1,0,1
UGA,GHA,2022.0,1,0,1
CHE,KEN,2001.0,2,0,2
LIE,ITA,2008.0,1,0,1
NER,UGA,2014.0,1,0,1
GRC,LKA,2012.0,1,0,1
EGY,NGA,2006.0,1,0,1
CAN,ZAF,1997.0,1,0,1
THA,EST,2019.0,2,0,2
BHR,SGP,2010.0,2,0,2
BHS,,2014.0,2,0,2
PAN,ARE,2010.0,1,0,1
MNG,AUT,2004.0,1,0,1
MMR,BEL,2004.0,1,0,1
USA,KGZ,2011.0,2,0,2
MYS,UZB,2021.0,3,0,3
ROU,SRB,2011.0,2,0,2
IRL,CHL,2011.0,1,0,1
MLT,DEU,2012.0,1,0,1
JOR,PSE,2005.0,2,0,2
GRC,TUR,2010.0,3,0,3
SRB,AUS,2013.0,1,0,1
TWN,EST,2020.0,1,0,1
MYS,SRB,2019.0,1,0,1
UKR,CHL,2005.0,1,0,1
MYS,POL,2011.0,1,0,1
JPN,MWI,2017.0,1,0,1
EST,CAN,2022.0,1,0,1
MDA,MYS,2006.0,3,0,3
IDN,EGY,2020.0,1,0,1
CIV,MDG,2004.0,1,0,1
MAC,CAN,2015.0,1,0,1
SVK,MEX,2022.0,2,0,2
SWE,ARG,2007.0,1,0,1
ARE,LBY,2022.0,1,0,1
ARM,TWN,2018.0,1,0,1
DMA,,2020.0,1,0,1
BGD,VNM,2017.0,1,0,1
RUS,PRT,1998.0,1,0,1
USA,PHL,1997.0,1,0,1
KEN,COG,2011.0,1,0,1
VEN,GBR,2012.0,2,0,2
GBR,HND,2017.0,1,0,1
LTU,AUT,2015.0,1,0,1
CHN,BEN,2016.0,1,0,1
HND,USA,2010.0,1,0,1
MAR,UGA,2016.0,1,0,1
GBR,ISL,1998.0,1,0,1
MDG,KHM,2018.0,1,0,1
GUY,SAU,2022.0,1,0,1
,IDN,2020.0,5,0,5
SRB,IND,2001.0,1,0,1
ITA,EST,2005.0,1,0,1
BRA,PER,2001.0,1,0,1
KEN,TZA,1999.0,2,0,2
HRV,AUS,2009.0,1,0,1
HRV,ZAF,2020.0,1,0,1
HKG,CZE,2019.0,1,0,1
TUR,BRA,2008.0,1,0,1
CAN,LIE,2020.0,1,0,1
SWE,SEN,2008.0,1,0,1
TWN,MAC,2009.0,1,0,1
TUN,MRT,2006.0,1,0,1
ITA,MDA,2011.0,1,0,1
JPN,CIV,2010.0,1,0,1
ITA,SLV,2016.0,1,0,1
NGA,BRN,2018.0,1,0,1
OMN,ARE,2000.0,1,0,1
GIN,USA,2018.0,1,0,1
BRN,ESP,2011.0,1,0,1
IRL,IDN,2015.0,2,0,2
JOR,PSE,2002.0,1,0,1
SVN,MKD,2012.0,1,0,1
LKA,CAN,1998.0,1,0,1
COL,KHM,2011.0,1,0,1
TUR,SDN,2005.0,1,0,1
NOR,ERI,2003.0,1,0,1
LBY,TUN,2017.0,1,0,1
ISL,ITA,2017.0,1,0,1
CHL,PRT,2006.0,1,0,1
GIN,SEN,2014.0,1,0,1
THA,LKA,2018.0,3,0,3
BOL,ECU,2017.0,1,0,1
TJK,MYS,2014.0,1,0,1
AUS,MAR,2009.0,1,0,1
ARG,PER,2005.0,1,0,1
ISR,PRT,2020.0,1,0,1
ZAF,NER,2015.0,1,0,1
HRV,MKD,2012.0,1,0,1
MUS,ARE,2009.0,1,0,1
MLT,SRB,2020.0,1,0,1
POL,BGR,1997.0,1,0,1
RUS,LUX,2014.0,1,0,1
URY,KOR,2015.0,1,0,1
AUT,CYP,2014.0,1,0,1
CAF,COG,2015.0,1,0,1
BWA,FJI,2014.0,1,0,1
IDN,VUT,2003.0,1,0,1
,ASM,2009.0,1,0,1
EGY,BHR,2004.0,1,0,1
CAN,BEN,2001.0,1,0,1
MAR,TUN,2021.0,2,0,2
ZAF,BFA,2004.0,1,0,1
HKG,JPN,1997.0,1,0,1
FJI,,2002.0,1,0,1
PRY,USA,2009.0,1,0,1
SWE,BRA,1997.0,1,0,1
GRC,BRA,2002.0,1,0,1
FRA,AND,2013.0,1,0,1
KOR,KAZ,2006.0,1,0,1
FIN,HKG,2011.0,2,0,2
ETH,NGA,2012.0,1,0,1
RUS,HKG,2014.0,1,0,1
SLE,ZAF,2002.0,1,0,1
SLE,ZAF,2005.0,1,0,1
TCA,OMN,2014.0,1,0,1
SWE,BFA,2018.0,1,0,1
SVN,CAN,2019.0,1,0,1
AUT,MAR,2013.0,1,0,1
CYP,UKR,2020.0,1,0,1
MYS,TUR,1999.0,1,0,1
ETH,IDN,2020.0,1,0,1
NOR,FRO,2013.0,1,0,1
ECU,,2001.0,2,0,2
SAU,IRQ,2018.0,1,0,1
CHN,CIV,2015.0,1,0,1
TGO,BFA,2016.0,1,0,1
ZWE,,1999.0,1,0,1
BRA,UKR,2007.0,2,0,2
GBR,NAM,2019.0,1,0,1
JOR,BGD,2004.0,1,0,1
CHL,COL,1997.0,1,0,1
USA,BDI,2010.0,1,0,1
ARE,BHR,2003.0,1,0,1
JPN,VEN,2011.0,1,0,1
EST,NLD,2015.0,2,0,2
NGA,ETH,2004.0,1,0,1
LKA,OMN,2009.0,1,0,1
ITA,AZE,2022.0,1,0,1
NLD,FIN,1997.0,1,0,1
BRA,AGO,2005.0,1,0,1
FJI,SAU,2017.0,1,0,1
COG,ITA,2013.0,1,0,1
BGR,SVK,1998.0,1,0,1
CHE,LBN,1998.0,1,0,1
CHE,MLI,2009.0,1,0,1
THA,BRA,2002.0,1,0,1
CIV,CMR,2017.0,1,0,1
IND,LUX,2018.0,1,0,1
,DJI,2006.0,1,0,1
PSE,SAU,2012.0,1,0,1
CZE,URY,2010.0,1,0,1
KEN,IRN,2011.0,1,0,1
GBR,EST,1997.0,1,0,1
SWE,KWT,2001.0,1,0,1
USA,AFG,2004.0,1,0,1
THA,GUF,2005.0,1,0,1
PAK,NOR,2007.0,1,0,1
LKA,BRA,2006.0,1,0,1
,NLD,2020.0,1,0,1
MLT,IND,2022.0,1,0,1
GIN,SWE,2018.0,1,0,1
ISL,PAK,2020.0,1,0,1
,BRB,2019.0,1,0,1
PRT,PAK,2022.0,1,0,1
GBR,ARE,2010.0,19,7,12
USA,FRA,2018.0,633,870,-237
JPN,BGD,2008.0,36,39,-3
GBR,USA,2008.0,1250,1289,-39
USA,JPN,2005.0,882,1144,-262
USA,QAT,2010.0,21,10,11
ITA,ARG,2017.0,16,20,-4
USA,AUS,2019.0,586,602,-16
IND,GBR,2004.0,98,50,48
USA,AUS,2017.0,533,610,-77
AUS,IRL,2012.0,32,59,-27
CAN,MAR,2011.0,7,5,2
COL,ESP,2008.0,20,27,-7
CHN,SGP,2010.0,177,141,36
DEU,SWE,2004.0,81,73,8
CHN,JPN,2017.0,291,464,-173
FIN,DEU,2018.0,69,56,13
MKD,SRB,2011.0,7,2,5
CHN,CAN,2011.0,169,187,-18
ESP,GBR,2009.0,239,223,16
NLD,USA,2006.0,234,204,30
ITA,USA,2007.0,441,328,113
USA,AUS,2010.0,544,432,112
JPN,CHN,2005.0,331,205,126
ZAF,BEL,2014.0,6,10,-4
BRA,NLD,2008.0,12,11,1
BRA,ESP,2019.0,98,70,28
CAN,FRA,2005.0,127,217,-90
NLD,ARG,2021.0,1,2,-1
GBR,DNK,2017.0,114,104,10
DNK,SWE,2006.0,42,63,-21
FRA,BRA,2017.0,126,98,28
JPN,IND,2010.0,74,70,4
DEU,AUT,2000.0,83,59,24
GHA,GBR,2006.0,5,8,-3
IND,NLD,2004.0,14,5,9
USA,NLD,2018.0,346,418,-72
IND,CAN,2018.0,152,89,63
GBR,IRL,2005.0,140,122,18
MWI,UGA,2019.0,1,1,0
SGP,USA,2018.0,229,199,30
USA,TUR,2022.0,72,77,-5
CAN,PAK,2009.0,9,12,-3
JPN,CHN,2002.0,233,219,14
AUS,NZL,2005.0,93,121,-28
USA,JPN,2002.0,1061,1304,-243
JPN,KOR,2014.0,170,97,73
CHE,ESP,2018.0,66,113,-47
DEU,ITA,2017.0,192,300,-108
CHN,SGP,2019.0,247,423,-176
ISR,AUS,2015.0,15,8,7
IND,KOR,2015.0,226,115,111
THA,GBR,2009.0,22,51,-29
POL,DNK,2005.0,3,6,-3
USA,LTU,2018.0,5,10,-5
USA,UGA,2004.0,9,7,2
JPN,RUS,2005.0,29,20,9
SWE,FRA,2007.0,42,46,-4
AUS,JPN,2003.0,37,48,-11
JPN,THA,2010.0,82,44,38
FIN,SWE,2010.0,46,36,10
ESP,SVN,2021.0,6,3,3
KOR,SAU,2011.0,20,1,19
ZAF,ESP,2014.0,2,7,-5
EST,CZE,2016.0,3,1,2
AUS,VNM,2018.0,41,22,19
FIN,SWE,2017.0,74,47,27
MEX,AUS,2010.0,8,7,1
BEL,DNK,2013.0,10,8,2
CHN,SGP,2017.0,250,331,-81
FRA,CHL,2004.0,13,10,3
GBR,ARE,2017.0,69,17,52
USA,QAT,2017.0,59,47,12
THA,NLD,2016.0,6,8,-2
IND,PAK,2018.0,26,29,-3
AUT,CHN,2014.0,10,13,-3
SWE,IRN,2015.0,22,18,4
NLD,THA,2017.0,8,7,1
IND,JPN,2017.0,92,56,36
BGD,AUS,2006.0,6,3,3
CAN,HKG,2002.0,23,24,-1
IRN,AUT,2019.0,20,5,15
GBR,ZAF,2021.0,53,70,-17
IND,FRA,2018.0,86,87,-1
SWE,ESP,2017.0,41,103,-62
SVN,SRB,2015.0,2,5,-3
UZB,DEU,2016.0,2,1,1
THA,JPN,2018.0,55,122,-67
EST,SWE,2014.0,11,3,8
GBR,ARE,2019.0,79,29,50
KOR,VNM,2020.0,131,32,99
USA,AUT,2018.0,121,126,-5
BGD,GBR,2015.0,12,6,6
GBR,AUT,2015.0,81,70,11
SWE,AUS,2022.0,11,27,-16
AUS,TUR,2014.0,3,11,-8
BEL,NLD,2014.0,121,141,-20
LIE,CHE,2020.0,4,4,0
FIN,USA,2016.0,86,66,20
NLD,IND,2017.0,37,23,14
ESP,VEN,2014.0,26,19,7
USA,VNM,2020.0,48,29,19
IND,ISR,2016.0,120,21,99
NLD,IDN,2019.0,48,22,26
CZE,USA,2017.0,62,47,15
ZAF,IND,2017.0,38,49,-11
BEL,DEU,2022.0,42,42,0
ITA,THA,2019.0,4,4,0
IND,JPN,2019.0,98,79,19
GRC,NLD,2021.0,14,10,4
ARG,ITA,2022.0,11,6,5
ZAF,IND,2019.0,45,52,-7
IND,FIN,2017.0,15,8,7
CZE,USA,2019.0,59,52,7
GTM,FRA,2016.0,1,1,0
CHN,JPN,2019.0,295,470,-175
BRA,ITA,2018.0,61,50,11
POL,SRB,2013.0,3,6,-3
CHN,NGA,2018.0,9,19,-10
FIN,POL,2015.0,7,4,3
USA,KAZ,2015.0,22,6,16
MYS,CAN,2013.0,17,10,7
ZWE,ZAF,2012.0,19,7,12
IND,ETH,2020.0,70,27,43
SAU,AUS,2013.0,9,26,-17
CZE,BEL,2018.0,12,6,6
FRA,OMN,2019.0,2,1,1
GBR,POL,2016.0,44,80,-36
CHN,KEN,2019.0,14,6,8
IRL,CAN,2021.0,29,42,-13
CHL,GBR,2017.0,40,52,-12
CHN,JPN,2010.0,249,433,-184
FIN,SWE,2019.0,76,50,26
PHL,USA,2018.0,34,33,1
DEU,BGD,2015.0,8,8,0
BEL,JPN,2021.0,8,11,-3
DEU,HKG,2007.0,6,8,-2
MYS,THA,2020.0,11,4,7
USA,ISR,1998.0,94,62,32
NLD,ETH,2020.0,9,4,5
MAR,FRA,2018.0,40,87,-47
BRA,IND,2016.0,7,31,-24
GBR,IRL,2002.0,158,92,66
TUR,DEU,2020.0,87,41,46
USA,QAT,2019.0,42,56,-14
JPN,THA,2019.0,110,85,25
USA,BGD,2018.0,38,108,-70
ISR,POL,2016.0,1,4,-3
FRA,JPN,1999.0,32,21,11
TUR,IRQ,2019.0,21,4,17
NOR,VNM,2022.0,1,2,-1
GRC,NOR,2018.0,20,1,19
RUS,UKR,2016.0,42,218,-176
TUR,ZAF,2017.0,4,2,2
GRC,AUT,2020.0,7,7,0
POL,FRA,2011.0,23,105,-82
TWN,CHN,2021.0,109,91,18
BRA,TUR,2018.0,3,1,2
FRA,BRA,2019.0,97,123,-26
POL,BLR,2020.0,4,2,2
MNG,USA,2019.0,7,2,5
FRA,IRN,2018.0,18,30,-12
ARG,MEX,2021.0,12,11,1
SGP,CHE,2021.0,18,9,9
CHN,FIN,2018.0,26,30,-4
CHL,JPN,2020.0,4,2,2
TUR,SWE,2019.0,28,5,23
BWA,USA,2020.0,9,7,2
GBR,HUN,2021.0,18,23,-5
FRA,PRT,2013.0,45,35,10
ISR,JPN,2012.0,2,1,1
CHN,MNG,2019.0,4,1,3
TUR,ARE,2018.0,4,2,2
CHE,PNG,2013.0,1,2,-1
CHL,DEU,2005.0,17,18,-1
USA,UKR,2014.0,30,20,10
IRL,ESP,2021.0,24,22,2
IND,CZE,2022.0,17,4,13
NOR,HKG,2017.0,2,1,1
FRA,EGY,2018.0,16,8,8
MYS,JOR,2021.0,27,5,22
CAN,FRA,2002.0,144,216,-72
GBR,SGP,2018.0,130,109,21
CAN,DEU,2000.0,19,42,-23
CHL,KOR,2018.0,1,3,-2
SAU,IRQ,2017.0,2,2,0
ISR,CAN,2017.0,67,53,14
DEU,IND,2006.0,58,103,-45
IRN,CHN,2021.0,42,22,20
IRL,NZL,2015.0,5,11,-6
FIN,RUS,2019.0,16,22,-6
NLD,LUX,2018.0,3,6,-3
LKA,CHN,2019.0,4,4,0
JPN,PAK,2006.0,10,5,5
UKR,RUS,1997.0,32,18,14
GBR,NZL,2008.0,111,102,9
CUB,BRA,2013.0,7,6,1
BRA,ESP,2010.0,48,46,2
USA,CHN,2000.0,100,396,-296
SWE,ESP,2019.0,36,83,-47
DEU,POL,2008.0,53,73,-20
USA,PAK,1999.0,5,4,1
USA,NGA,2011.0,8,31,-23
MYS,AUS,2007.0,19,23,-4
CAN,PER,2018.0,6,5,1
DEU,IRL,2010.0,52,33,19
GBR,CHL,2009.0,22,13,9
CHL,GBR,2010.0,14,17,-3
TUR,SWE,2010.0,1,2,-1
SWE,TUR,2013.0,7,8,-1
HUN,FIN,2016.0,5,2,3
BRA,POL,2013.0,13,14,-1
HUN,NLD,2018.0,17,8,9
DNK,GBR,2011.0,44,71,-27
NGA,USA,2011.0,31,8,23
GRC,CHE,2009.0,15,10,5
ZAF,AUS,2013.0,45,20,25
USA,SEN,2017.0,6,3,3
FRA,TUN,2018.0,80,88,-8
FRA,SYR,2017.0,4,7,-3
DNK,FIN,2018.0,16,21,-5
DEU,HUN,2007.0,27,21,6
USA,IND,1998.0,46,79,-33
GBR,TWN,2007.0,36,22,14
IRL,FRA,2006.0,17,26,-9
CHN,HUN,2020.0,12,6,6
FRA,TUR,2007.0,14,7,7
UKR,RUS,1998.0,24,23,1
CHE,BEL,2000.0,3,11,-8
CAN,KOR,2013.0,39,39,0
USA,ISL,2001.0,15,2,13
KOR,CHN,2001.0,11,19,-8
JPN,RUS,2002.0,54,43,11
GBR,PRT,2013.0,56,74,-18
JPN,MYS,2013.0,71,20,51
NLD,IND,2019.0,29,58,-29
ROU,CAN,2014.0,2,3,-1
JPN,IND,2019.0,79,98,-19
FIN,CZE,2021.0,7,5,2
MYS,NZL,2019.0,15,14,1
NPL,CAN,2019.0,10,2,8
USA,ISR,1997.0,34,43,-9
NER,CMR,2009.0,1,1,0
USA,POL,1998.0,27,20,7
BRA,CHE,2004.0,6,6,0
USA,BEL,2001.0,72,106,-34
SWE,BEL,2011.0,10,16,-6
USA,MEX,1997.0,16,9,7
BEL,COL,2016.0,6,5,1
CHN,MEX,2021.0,7,7,0
HRV,MYS,2015.0,5,1,4
MYS,NZL,2010.0,8,12,-4
MAC,CHN,2013.0,18,22,-4
CAN,TGO,2021.0,1,1,0
SVK,CAN,2018.0,3,2,1
CAN,OMN,2020.0,10,7,3
ZAF,FRA,2020.0,12,10,2
KOR,BEL,2014.0,8,6,2
CHL,CZE,2019.0,5,3,2
IRN,AUT,2017.0,11,6,5
KOR,CZE,2018.0,8,2,6
ITA,ARG,2019.0,16,16,0
CAN,SGP,2001.0,11,7,4
IRN,SGP,2016.0,5,8,-3
BRA,NGA,2018.0,6,5,1
HUN,USA,2011.0,65,53,12
IRL,CZE,2020.0,4,3,1
HUN,POL,2006.0,4,1,3
KAZ,SAU,2019.0,2,2,0
IRL,AUS,2008.0,24,30,-6
JOR,MYS,2018.0,5,25,-20
BGD,MYS,2022.0,12,18,-6
DEU,SGP,1999.0,7,1,6
FRA,LBN,2004.0,19,14,5
DEU,JPN,2012.0,80,114,-34
NOR,FRA,2012.0,30,28,2
ITA,ZAF,2022.0,3,4,-1
DNK,SGP,2016.0,6,9,-3
REU,FRA,2018.0,14,23,-9
DNK,USA,2008.0,74,74,0
CAN,IDN,2016.0,7,2,5
BEL,DZA,2015.0,4,1,3
NLD,IDN,2010.0,15,4,11
PHL,IDN,2015.0,2,1,1
NLD,CMR,2005.0,1,1,0
EST,DEU,2018.0,9,8,1
IRL,ZAF,2018.0,4,6,-2
DEU,ETH,2009.0,3,4,-1
ARE,JOR,2004.0,5,2,3
CMR,KEN,2017.0,3,1,2
NLD,KEN,2016.0,9,6,3
NOR,DNK,2009.0,22,25,-3
USA,SRB,2004.0,11,14,-3
RUS,BEL,2012.0,12,3,9
FRA,DNK,2016.0,34,48,-14
LTU,ITA,2007.0,1,1,0
ESP,CHL,2005.0,28,18,10
NLD,IDN,2017.0,22,15,7
LAO,CHE,2014.0,3,1,2
CHL,ESP,2009.0,26,44,-18
RUS,GBR,2015.0,42,45,-3
FRA,HUN,2000.0,8,10,-2
PER,GBR,2016.0,4,8,-4
BEN,CAN,2009.0,3,2,1
FRA,VEN,2013.0,7,4,3
CAN,CIV,2014.0,2,1,1
CAN,BRA,2006.0,38,22,16
DNK,BRA,2010.0,2,6,-4
GBR,NER,2016.0,3,1,2
GBR,SRB,2007.0,5,5,0
ITA,NZL,2009.0,6,3,3
DEU,GRC,1999.0,17,5,12
USA,IND,1997.0,19,30,-11
CHE,EGY,2021.0,5,5,0
IND,RUS,2003.0,4,1,3
DNK,AUS,2008.0,21,18,3
HKG,CAN,2011.0,28,16,12
MLI,USA,2014.0,7,2,5
ZAF,NGA,2008.0,8,14,-6
FIN,JPN,2005.0,8,8,0
VNM,USA,2004.0,4,3,1
USA,ROU,2001.0,9,29,-20
SVN,DEU,2003.0,4,7,-3
NLD,THA,2010.0,5,7,-2
SWE,CZE,2004.0,3,7,-4
USA,POL,1997.0,18,18,0
DEU,ROU,2001.0,6,18,-12
SGP,MYS,2002.0,2,3,-1
ZAF,NLD,2002.0,13,9,4
CZE,ITA,2000.0,3,2,1
MYS,USA,2006.0,13,18,-5
POL,CHN,2020.0,16,16,0
USA,NPL,2005.0,5,3,2
AUT,CAN,2000.0,5,4,1
AUS,NZL,2002.0,74,81,-7
IRQ,JOR,2020.0,3,7,-4
USA,SAU,2005.0,36,20,16
KEN,NLD,2010.0,4,4,0
QAT,BEL,2016.0,3,3,0
ARE,HUN,2005.0,4,2,2
ARG,ISR,2014.0,2,1,1
NOR,SWE,2011.0,38,62,-24
IRL,JPN,2006.0,4,5,-1
SRB,CAN,2016.0,2,4,-2
NOR,AUS,2011.0,8,14,-6
FRA,BFA,1999.0,2,2,0
PER,DEU,2019.0,10,5,5
FRA,VNM,2003.0,4,5,-1
IRN,DEU,2004.0,4,10,-6
ZMB,GBR,2013.0,2,8,-6
FRA,ARG,2004.0,16,13,3
USA,MEX,1998.0,26,21,5
AUS,SWE,2002.0,30,29,1
CIV,BFA,2000.0,1,1,0
ARE,HUN,2002.0,2,2,0
KWT,USA,2004.0,5,14,-9
TUR,FRA,2004.0,8,5,3
AUS,NLD,1998.0,5,10,-5
USA,CHL,2001.0,30,25,5
ESP,CHL,2002.0,21,19,2
USA,OMN,2010.0,6,2,4
RUS,HKG,2004.0,4,1,3
AUS,MYS,2009.0,36,36,0
DNK,ITA,2012.0,21,24,-3
DEU,MEX,2003.0,15,18,-3
BRA,JPN,2001.0,8,6,2
SWE,BGD,2001.0,1,1,0
ARE,EGY,2007.0,10,10,0
NOR,AUT,2002.0,2,2,0
ISR,DEU,1997.0,6,7,-1
ZAF,NLD,2005.0,5,16,-11
ITA,FIN,2013.0,14,11,3
JPN,SWE,2006.0,19,30,-11
SWE,ESP,2010.0,30,31,-1
MYS,PAK,2009.0,5,9,-4
PHL,MYS,2009.0,1,2,-1
CAN,HUN,2000.0,5,3,2
TWN,DEU,1998.0,2,1,1
FIN,JPN,2002.0,10,17,-7
GUF,FRA,2007.0,5,11,-6
IRL,NOR,2019.0,7,4,3
HKG,FRA,2007.0,6,8,-2
ISR,ITA,2014.0,8,16,-8
HUN,ROU,2012.0,7,3,4
VEN,FRA,2011.0,8,8,0
ITA,PRT,2005.0,6,5,1
ESP,NIC,2012.0,1,3,-2
PRT,MYS,2008.0,1,1,0
ZAF,ETH,2012.0,7,2,5
CZE,IRN,2011.0,1,1,0
ESP,ECU,2013.0,18,2,16
FIN,RUS,2017.0,19,17,2
CAN,HKG,2005.0,12,26,-14
IRN,AUT,2010.0,9,3,6
FRA,ZAF,2013.0,22,16,6
TUR,SWE,2017.0,22,7,15
ARE,DNK,2012.0,1,2,-1
LTU,USA,2014.0,4,6,-2
JPN,PER,2015.0,3,3,0
JOR,ARE,2018.0,22,10,12
GRL,DNK,2013.0,3,4,-1
FIN,ESP,2015.0,11,23,-12
YEM,GBR,2017.0,2,1,1
MEX,SWE,2016.0,6,5,1
HUN,ITA,2015.0,9,6,3
EGY,CHN,2013.0,3,9,-6
SWE,SGP,2015.0,5,8,-3
TUN,DZA,2020.0,7,7,0
SWE,GRC,2012.0,7,14,-7
AUS,LKA,2011.0,9,8,1
DNK,PRT,2012.0,4,8,-4
TUR,IRQ,2017.0,15,3,12
RUS,BRA,2021.0,8,3,5
SWE,UKR,2019.0,4,6,-2
AUT,SVK,2018.0,6,9,-3
GRC,TUR,2018.0,5,3,2
SGP,POL,2021.0,3,2,1
NLD,MYS,2020.0,7,6,1
GBR,MWI,2016.0,11,13,-2
TWN,HKG,2008.0,11,7,4
PAK,CHN,2008.0,5,15,-10
ITA,LUX,2015.0,11,4,7
DNK,CHL,2016.0,2,1,1
ESP,IND,2000.0,2,2,0
CZE,FRA,2020.0,24,34,-10
SVK,UKR,2019.0,2,4,-2
DEU,IRL,2017.0,32,35,-3
SRB,AUT,2008.0,4,1,3
TZA,KOR,2019.0,1,3,-2
NLD,THA,2019.0,12,4,8
MYS,NZL,2017.0,14,21,-7
MAR,SAU,2021.0,2,6,-4
MEX,AUS,2019.0,15,5,10
GBR,COL,2020.0,22,14,8
BEL,RUS,2003.0,11,9,2
NZL,IRN,2021.0,3,7,-4
LBY,MYS,2021.0,1,9,-8
IRL,MYS,2017.0,7,5,2
CHN,IRN,2018.0,11,35,-24
FRA,KEN,2004.0,1,2,-1
JOR,SAU,2003.0,2,3,-1
ARE,IND,2018.0,19,58,-39
DEU,RUS,2007.0,68,111,-43
CHE,TWN,2014.0,7,5,2
NLD,ROU,2005.0,1,4,-3
CAN,ITA,2020.0,55,73,-18
TWN,DEU,1997.0,3,1,2
LBN,GBR,2007.0,3,4,-1
AUS,ISR,2001.0,6,5,1
FIN,RUS,2010.0,9,24,-15
FRA,BRA,2010.0,87,70,17
CAN,NLD,2006.0,27,45,-18
ARG,FRA,2013.0,32,24,8
ITA,CZE,2013.0,12,10,2
GMB,USA,2013.0,3,2,1
POL,KOR,2015.0,8,2,6
NGA,DEU,2021.0,10,6,4
BRA,PAK,2013.0,7,6,1
ROU,HUN,2018.0,9,11,-2
ISR,AZE,2016.0,1,1,0
PAK,NZL,2016.0,6,10,-4
JOR,EGY,2018.0,2,1,1
IRL,MYS,2019.0,8,6,2
SAU,TUR,2020.0,4,3,1
MEX,GTM,2020.0,3,2,1
HUN,CHE,2012.0,18,5,13
CHL,MEX,2011.0,8,18,-10
AUT,VNM,2012.0,4,1,3
CAN,QAT,2013.0,11,2,9
SAU,ITA,2013.0,3,13,-10
BRA,BEL,2022.0,20,6,14
PAK,USA,2011.0,46,49,-3
BEL,ZAF,2006.0,4,7,-3
IND,SAU,2009.0,29,6,23
AUS,DNK,2008.0,18,21,-3
MYS,BGD,2015.0,22,37,-15
MYS,IRL,2017.0,5,7,-2
VNM,ITA,2009.0,3,3,0
MEX,AUS,2017.0,8,13,-5
THA,IDN,2015.0,6,1,5
AUS,MEX,2020.0,11,6,5
ISR,NOR,2020.0,2,4,-2
DEU,KAZ,2020.0,3,2,1
DEU,MAR,2020.0,4,5,-1
PHL,FRA,2017.0,4,3,1
CMR,USA,2021.0,9,6,3
VNM,NOR,2015.0,1,3,-2
ETH,SWE,2013.0,1,2,-1
AUS,SVN,2016.0,1,3,-2
USA,NPL,2002.0,4,2,2
KEN,CHE,2003.0,2,2,0
AUS,CHE,2001.0,24,15,9
POL,GRC,1999.0,1,1,0
ESP,NZL,2004.0,2,1,1
PRT,SWE,2011.0,10,6,4
CAN,LBN,2007.0,4,7,-3
ZAF,GHA,2006.0,4,2,2
MEX,POL,2016.0,1,2,-1
USA,MKD,2005.0,3,1,2
UKR,AUT,2015.0,2,2,0
ITA,KOR,2011.0,3,11,-8
AUS,BEL,2004.0,8,7,1
CHL,PER,2004.0,2,1,1
ESP,RUS,2008.0,7,12,-5
EGY,HUN,2021.0,2,4,-2
RUS,KOR,2012.0,8,11,-3
DNK,BRA,2019.0,12,15,-3
JPN,ZAF,2015.0,6,1,5
PHL,FRA,2019.0,2,4,-2
AUS,HUN,2011.0,4,4,0
SEN,TGO,2014.0,4,1,3
ITA,IND,2009.0,17,38,-21
CUB,VEN,2003.0,3,1,2
TTO,USA,2001.0,5,1,4
ARG,SWE,2011.0,1,3,-2
JPN,IRN,2011.0,16,9,7
TZA,SWE,2022.0,2,3,-1
CHE,IRN,2006.0,2,5,-3
IRL,AUT,2020.0,5,6,-1
GBR,KEN,2009.0,14,11,3
KEN,AUT,2009.0,1,1,0
AUS,CZE,2021.0,4,2,2
RUS,COL,2005.0,3,1,2
ARG,COL,2011.0,5,6,-1
QAT,ESP,2018.0,2,6,-4
BEL,LUX,2006.0,9,3,6
ISR,DEU,1998.0,10,14,-4
NGA,CHN,2012.0,4,5,-1
IRL,MYS,2010.0,5,3,2
MYS,OMN,2011.0,4,2,2
BEL,CAN,1999.0,3,6,-3
ITA,ALB,2013.0,3,3,0
FRA,ARE,2009.0,5,1,4
EGY,GBR,2002.0,9,14,-5
ESP,AND,2015.0,2,2,0
PER,CUB,2013.0,1,1,0
AUS,TTO,2017.0,1,1,0
USA,OMN,2019.0,4,8,-4
IRN,IND,2011.0,7,19,-12
IND,BTN,2013.0,1,1,0
IRL,BRA,2022.0,3,9,-6
FRA,CRI,2020.0,4,4,0
JPN,NPL,2021.0,7,1,6
KEN,CAN,2018.0,7,4,3
OMN,IND,2018.0,16,36,-20
POL,JPN,2004.0,5,7,-2
ITA,THA,2010.0,1,3,-2
VEN,CHL,2003.0,1,1,0
TUR,NLD,1999.0,2,1,1
ITA,NLD,1998.0,17,13,4
BLR,KOR,2013.0,1,1,0
IRL,CHE,2009.0,6,17,-11
TUR,CYP,2022.0,22,22,0
BRA,AUS,2001.0,4,5,-1
GBR,VEN,2007.0,8,7,1
TZA,DNK,2009.0,2,1,1
CRI,MEX,2007.0,3,1,2
CHN,VNM,2016.0,13,1,12
CHE,GIN,2020.0,1,4,-3
TWN,POL,2010.0,2,3,-1
CHL,DEU,2002.0,10,13,-3
JPN,BGR,2003.0,3,5,-2
BEL,LBN,2016.0,3,4,-1
TZA,GBR,2018.0,3,7,-4
PAK,HUN,2021.0,3,1,2
SGP,VNM,2011.0,2,2,0
BLR,USA,2016.0,2,5,-3
LTU,JPN,2011.0,1,2,-1
GBR,QAT,2021.0,20,18,2
BEN,FRA,2012.0,8,7,1
PAK,CHE,2012.0,3,1,2
POL,ITA,2013.0,12,40,-28
ISR,PSE,2021.0,5,9,-4
CHN,KEN,2017.0,13,5,8
AUS,TTO,2010.0,1,1,0
ITA,TUR,2020.0,8,16,-8
DNK,HUN,2018.0,2,5,-3
KAZ,BLR,2016.0,1,1,0
SRB,DNK,2016.0,1,1,0
IND,NZL,2022.0,5,5,0
MWI,RWA,2020.0,1,1,0
FRA,BEN,2022.0,2,6,-4
HUN,PRT,2022.0,1,1,0
AUT,KOR,2015.0,5,3,2
RUS,ISR,1999.0,17,1,16
USA,AFG,2014.0,4,1,3
RUS,FIN,2015.0,20,23,-3
DEU,GMB,2020.0,1,1,0
POL,IRL,2009.0,5,2,3
AUT,ISR,2006.0,2,2,0
NGA,JPN,2002.0,4,2,2
CHE,KEN,2003.0,2,2,0
GBR,ETH,2012.0,6,5,1
NGA,JPN,2005.0,2,2,0
BLR,DEU,2011.0,8,3,5
AUT,POL,2004.0,3,3,0
AUS,CYP,2019.0,1,2,-1
CHN,LUX,2018.0,2,3,-1
ISR,CZE,2005.0,1,3,-2
SWE,NZL,2009.0,9,5,4
SVK,POL,2008.0,3,1,2
POL,SVK,2014.0,4,3,1
NGA,CMR,2015.0,4,1,3
HRV,SVN,2001.0,4,4,0
ARE,GBR,2009.0,2,19,-17
NLD,RUS,1998.0,4,8,-4
GBR,NOR,1998.0,7,8,-1
LTU,NOR,2002.0,1,2,-1
BEL,CHN,2003.0,7,5,2
NOR,HKG,2010.0,1,1,0
JPN,MEX,2009.0,2,6,-4
CUB,CHL,2005.0,2,1,1
NZL,BRA,2003.0,2,2,0
TUR,UKR,2006.0,1,1,0
DEU,VEN,2006.0,1,2,-1
SGP,HKG,1999.0,3,7,-4
HUN,IND,2013.0,4,1,3
USA,LUX,2018.0,9,10,-1
ZAF,IND,2010.0,8,30,-22
TUR,PAK,2015.0,1,16,-15
PRT,SRB,2020.0,1,2,-1
IND,HKG,2009.0,1,9,-8
BLR,PRT,2008.0,3,1,2
MYS,NPL,2012.0,1,1,0
MEX,ISR,2016.0,3,3,0
KOR,ESP,2010.0,4,1,3
SGP,FIN,2012.0,2,2,0
CYP,GRC,2001.0,6,4,2
PER,DEU,2010.0,1,2,-1
NZL,ARG,2012.0,1,1,0
BRA,VEN,2022.0,1,3,-2
AUT,TUR,2013.0,4,8,-4
LTU,GBR,2014.0,5,8,-3
IND,NER,2016.0,1,2,-1
COG,FRA,2021.0,1,1,0
SVN,CAN,2018.0,1,1,0
USA,LAO,2005.0,1,1,0
FRA,SYR,2019.0,6,4,2
UGA,TZA,2020.0,4,6,-2
BEL,HUN,2016.0,6,8,-2
DNK,CZE,2011.0,4,3,1
MEX,PRT,2018.0,5,3,2
CHN,MMR,2018.0,2,4,-2
TZA,ESP,2017.0,2,1,1
ESP,MAR,2022.0,5,6,-1
BWA,IND,2011.0,2,1,1
PAK,FRA,2014.0,6,43,-37
PAK,ESP,2018.0,2,3,-1
ZMB,USA,2022.0,4,5,-1
TZA,KEN,2008.0,4,2,2
GBR,URY,2004.0,1,2,-1
JOR,QAT,2005.0,2,1,1
USA,LVA,2003.0,3,1,2
AUT,ZAF,2010.0,3,2,1
BRA,MEX,2004.0,7,10,-3
GTM,MEX,2014.0,2,2,0
MLI,BFA,2016.0,2,2,0
AUT,BEL,2006.0,3,8,-5
DEU,BEN,2006.0,2,1,1
URY,USA,2004.0,9,6,3
FRA,SYR,2010.0,9,1,8
NLD,BGD,2014.0,1,3,-2
IRN,POL,2016.0,1,4,-3
PAK,FIN,2018.0,1,3,-2
TUR,ZAF,2010.0,1,1,0
ETH,AUT,2014.0,4,2,2
UKR,CAN,2004.0,8,1,7
ITA,PRT,2002.0,5,4,1
SWE,LVA,2001.0,1,2,-1
DEU,AZE,2016.0,3,1,2
GIN,SEN,2004.0,1,1,0
CHE,KHM,2017.0,2,3,-1
IDN,CAN,2004.0,1,1,0
BGD,DEU,2007.0,2,1,1
THA,BGD,2018.0,5,2,3
MYS,IRL,2010.0,3,5,-2
RUS,VNM,2013.0,7,4,3
PRT,RUS,2008.0,2,6,-4
HRV,IRL,2017.0,4,1,3
MAC,HKG,2022.0,7,8,-1
DZA,DEU,2021.0,4,2,2
MYS,GHA,2018.0,3,1,2
EGY,IRN,2014.0,2,2,0
CHE,TUR,2007.0,4,4,0
MAR,POL,2020.0,2,1,1
FIN,OMN,2012.0,1,2,-1
GBR,PER,2005.0,1,1,0
SDN,GBR,2005.0,3,2,1
ZAF,MEX,2013.0,1,1,0
NOR,AUT,2005.0,3,3,0
AUT,JPN,2013.0,6,13,-7
CUB,CHL,2002.0,1,3,-2
MYS,TWN,2009.0,1,2,-1
LTU,FRA,2013.0,4,4,0
NZL,TUR,2016.0,1,3,-2
SAU,NOR,2016.0,2,2,0
GBR,PHL,2006.0,4,4,0
THA,IRN,2019.0,2,1,1
ZWE,NLD,2020.0,1,2,-1
TZA,ESP,2019.0,2,17,-15
AUS,LAO,2016.0,4,2,2
IRL,SAU,2018.0,6,3,3
LKA,CHN,2017.0,1,4,-3
DEU,NPL,2021.0,1,3,-2
ZAF,SWZ,2016.0,2,4,-2
FRA,TWN,1999.0,1,1,0
ZWE,BWA,2000.0,1,1,0
ETH,NLD,2012.0,1,6,-5
OMN,AUS,2019.0,2,10,-8
IRN,RUS,2011.0,1,1,0
DNK,GRC,2001.0,3,3,0
YEM,MYS,2009.0,3,4,-1
MEX,NIC,2009.0,2,1,1
EGY,GBR,2005.0,3,19,-16
USA,SEN,2019.0,2,4,-2
IDN,SAU,2015.0,2,3,-1
PER,ARG,2003.0,2,2,0
GEO,GBR,2014.0,2,2,0
DEU,OMN,2009.0,5,3,2
ITA,EGY,2000.0,2,1,1
GBR,NOR,1997.0,2,2,0
CUB,FRA,2003.0,2,2,0
SGP,TWN,2002.0,4,5,-1
USA,MOZ,2007.0,1,1,0
SEN,BFA,2014.0,2,4,-2
KWT,TUR,2018.0,1,6,-5
MWI,ZAF,2016.0,6,4,2
KHM,KOR,2017.0,1,1,0
SVN,BEL,2020.0,2,4,-2
ISR,KOR,2013.0,3,6,-3
SWE,UKR,2010.0,2,4,-2
BWA,GBR,2012.0,3,2,1
NOR,IRL,2003.0,2,1,1
CAN,TUN,2002.0,5,1,4
AUT,BGD,2016.0,2,1,1
SAU,IRQ,2019.0,2,1,1
IND,LUX,2019.0,5,2,3
MNG,DEU,2013.0,1,2,-1
SGP,TWN,2005.0,4,1,3
CZE,EGY,2014.0,3,2,1
USA,ZWE,2013.0,2,8,-6
PRT,AUS,2007.0,3,3,0
SGP,IRL,2018.0,2,2,0
NOR,HKG,2019.0,4,4,0
FLK,GBR,2011.0,1,2,-1
IDN,THA,2003.0,1,3,-2
KOR,MNG,2008.0,2,1,1
DNK,THA,2013.0,2,2,0
DZA,CAN,2004.0,3,1,2
AUT,UKR,2022.0,4,1,3
BLR,IRN,2007.0,1,1,0
LKA,SWE,2021.0,1,1,0
NZL,PAK,2008.0,1,1,0
SVK,HUN,2011.0,1,4,-3
PAK,SAU,1998.0,1,1,0
BGD,BEL,2015.0,5,5,0
PHL,SGP,2012.0,3,1,2
MLI,FRA,2022.0,2,2,0
FRA,NGA,2021.0,1,1,0
MYS,ARE,2005.0,1,1,0
NZL,KEN,2020.0,2,1,1
GMB,MLI,2020.0,1,1,0
CHL,VEN,2004.0,3,3,0
FRA,UGA,2015.0,1,1,0
MEX,CZE,2011.0,3,2,1
ISR,SGP,2007.0,1,1,0
EGY,CZE,2010.0,1,3,-2
PHL,CAN,2007.0,1,1,0
ITA,VEN,2008.0,4,1,3
OMN,AUS,2017.0,3,5,-2
EGY,GHA,2020.0,1,2,-1
POL,TUR,2013.0,2,5,-3
NZL,ITA,2013.0,3,11,-8
PRT,COL,2018.0,2,4,-2
DNK,NZL,2001.0,1,2,-1
TZA,NLD,2020.0,2,5,-3
ARG,FIN,2004.0,1,2,-1
CAN,GHA,2004.0,1,2,-1
CMR,KEN,2019.0,1,4,-3
CAN,ZWE,2009.0,1,3,-2
THA,LKA,2017.0,2,2,0
THA,LKA,2019.0,2,1,1
IRQ,DNK,2018.0,1,1,0
ESP,ZAF,2022.0,1,4,-3
MYS,KAZ,2021.0,3,1,2
ETH,BEL,2006.0,1,1,0
EGY,ITA,2000.0,1,2,-1
SAU,IND,1998.0,1,1,0
AUT,BGR,2019.0,1,3,-2
CHE,ISR,2008.0,2,14,-12
TGO,BEN,2007.0,2,1,1
COL,BOL,2014.0,1,1,0
SDN,GBR,2002.0,2,2,0
ROU,NLD,2011.0,3,2,1
GEO,ESP,2018.0,1,1,0
CHN,MAR,2019.0,1,6,-5
MWI,CAN,2015.0,1,1,0
EST,RUS,1999.0,1,1,0
AUT,ZAF,2019.0,1,5,-4
GBR,GMB,1997.0,1,1,0
AUS,NLD,1997.0,3,3,0
QAT,TUR,2015.0,2,2,0
BFA,CAN,2013.0,1,1,0
DNK,SRB,2003.0,1,1,0
PAN,IND,2020.0,1,2,-1
KEN,ETH,2007.0,1,1,0
SWE,VNM,2004.0,3,1,2
ZWE,CHE,2003.0,1,2,-1
HUN,BRA,2016.0,2,2,0
ARG,DNK,2003.0,1,3,-2
ECU,BOL,2013.0,1,1,0
ARE,DEU,2013.0,1,7,-6
AUT,SGP,2015.0,2,7,-5
HKG,CZE,2018.0,2,2,0
TWN,POL,2017.0,2,3,-1
HRV,CHE,2022.0,1,1,0
POL,HUN,2011.0,1,9,-8
EST,CAN,2016.0,1,1,0
COL,PRI,2017.0,1,4,-3
IDN,DNK,2015.0,1,1,0
PAK,SWE,2009.0,4,3,1
LBY,POL,2013.0,1,1,0
GUY,GBR,2019.0,1,1,0
ZAF,PAK,2013.0,2,3,-1
CRI,ECU,2015.0,1,1,0
DEU,MWI,2015.0,1,2,-1
ITA,ARM,2001.0,1,2,-1
ARE,TUR,2020.0,1,5,-4
RWA,KOR,2022.0,1,2,-1
BGD,CZE,2021.0,1,2,-1
EGY,QAT,2022.0,2,4,-2
FIN,GRC,2018.0,1,4,-3
QAT,KWT,2020.0,1,1,0
JOR,QAT,2002.0,2,1,1
USA,CMR,2006.0,2,6,-4
BEL,ISR,2008.0,1,4,-3
EST,IND,2020.0,1,6,-5
NZL,ARE,2018.0,3,3,0
AUS,PYF,2017.0,1,1,0
CRI,TWN,2019.0,1,1,0
EST,AUS,2022.0,1,6,-5
URY,AUS,2015.0,2,1,1
IRL,NOR,2010.0,1,1,0
DEU,ALB,2016.0,2,2,0
SVK,UKR,2010.0,1,1,0
COD,UGA,2022.0,1,1,0
NOR,KAZ,2019.0,1,1,0
MNG,USA,2010.0,2,1,1
ROU,RUS,2011.0,1,1,0
ECU,CHL,2009.0,1,2,-1
UZB,TJK,2014.0,1,1,0
NER,USA,2006.0,1,2,-1
CHE,SVN,2003.0,1,2,-1
EGY,BHR,2014.0,1,3,-2
ARE,SWE,2006.0,1,1,0
IRL,MEX,2006.0,2,1,1
PHL,FRA,2010.0,2,4,-2
AUS,KWT,2021.0,1,1,0
ESP,PER,2001.0,2,2,0
USA,UZB,2022.0,1,1,0
ESP,BOL,2012.0,1,3,-2
DEU,ECU,2012.0,1,3,-2
ZAF,MOZ,2006.0,2,1,1
AUT,BGR,2010.0,1,2,-1
OMN,KWT,2006.0,1,1,0
NLD,SVN,2015.0,1,4,-3
CAN,BLR,1999.0,1,1,0
IRL,TUR,2015.0,2,3,-1
JAM,BHS,2019.0,1,1,0
BGR,NLD,2018.0,1,2,-1
AZE,TUR,2006.0,1,3,-2
PRY,GBR,2021.0,1,1,0
DNK,EST,2015.0,1,1,0
AUS,CYP,2017.0,1,1,0
PRT,DNK,2022.0,2,2,0
KEN,FRA,2018.0,2,4,-2
IRL,OMN,2020.0,1,1,0
IND,ROU,2022.0,1,1,0
UKR,NOR,2007.0,1,1,0
RUS,HRV,2003.0,1,1,0
FRA,EST,2016.0,1,1,0
ARE,SGP,2021.0,1,4,-3
MAC,AUS,2020.0,1,1,0
GIN,USA,2017.0,1,1,0
ARG,CHN,2019.0,1,2,-1
SAU,QAT,2006.0,2,1,1
IRN,BEL,2003.0,1,1,0
BOL,ECU,2018.0,1,1,0
SWE,MCO,2012.0,1,1,0
CAN,BHR,2007.0,1,1,0
KHM,KOR,2019.0,2,5,-3
IRQ,LBY,2006.0,1,1,0
CHL,CZE,2010.0,1,1,0
MYS,SGP,2007.0,1,8,-7
CHE,ISL,2007.0,1,1,0
THA,LKA,2010.0,1,1,0
MEX,AUT,2005.0,1,2,-1
LBY,USA,2011.0,1,1,0
PSE,JOR,2011.0,1,1,0
BLR,JPN,2016.0,1,1,0
LUX,FIN,2015.0,1,2,-1
CIV,BEN,2012.0,1,1,0
RUS,GRC,2019.0,1,1,0
PRK,CHN,2014.0,1,1,0
IND,EGY,2009.0,1,2,-1
VNM,AUT,2013.0,1,2,-1
USA,TUN,2021.0,1,4,-3
MEX,URY,2013.0,1,2,-1
EGY,CZE,2019.0,1,2,-1
USA,GBR,2022.0,570,602,-32
DEU,ITA,2010.0,131,221,-90
BRA,ESP,2017.0,90,86,4
CHN,BEL,2009.0,20,6,14
IND,JPN,2010.0,70,74,-4
TUR,GBR,2018.0,85,73,12
DEU,BRA,2016.0,96,98,-2
AUS,SWE,2005.0,16,36,-20
GBR,CHE,2015.0,240,240,0
TUR,KOR,2018.0,3,2,1
CAN,IRL,2016.0,38,33,5
CAN,CHE,2001.0,24,44,-20
USA,KWT,2000.0,3,2,1
DEU,ITA,2019.0,214,307,-93
ISR,CAN,2019.0,54,54,0
GBR,THA,2018.0,92,42,50
GBR,MYS,2008.0,90,28,62
BEL,USA,2015.0,154,138,16
JPN,THA,2017.0,100,53,47
SWE,ITA,2016.0,29,75,-46
POL,AUS,2013.0,14,23,-9
GBR,DNK,2019.0,106,102,4
OMN,EGY,2014.0,3,4,-1
USA,PRT,2020.0,58,51,7
BRA,ECU,2018.0,18,4,14
FIN,NOR,2020.0,27,23,4
GBR,DNK,2010.0,63,45,18
KOR,ESP,2017.0,6,5,1
NLD,GBR,2012.0,218,176,42
IND,TUR,2018.0,5,6,-1
JPN,IND,2017.0,56,92,-36
ESP,JPN,2019.0,24,27,-3
ITA,DNK,2011.0,38,11,27
TWN,VNM,2017.0,31,5,26
PER,USA,2018.0,42,35,7
KOR,THA,2022.0,4,5,-1
KEN,ZAF,2015.0,16,15,1
IND,FIN,2019.0,17,11,6
KOR,DEU,2021.0,55,54,1
CHN,NOR,2018.0,29,25,4
ITA,POL,2021.0,19,21,-2
HND,USA,2018.0,3,1,2
IND,NPL,2022.0,10,6,4
CHE,JPN,2003.0,34,22,12
GBR,VNM,2018.0,92,16,76
JPN,FIN,2004.0,2,7,-5
ISR,CHN,2021.0,31,32,-1
CZE,USA,2010.0,35,30,5
CHE,AUT,2013.0,50,76,-26
POL,PRT,2006.0,3,1,2
USA,COL,2012.0,85,86,-1
BFA,BEL,2011.0,4,4,0
UGA,USA,2014.0,22,19,3
CAN,LKA,2012.0,2,2,0
HKG,SGP,2008.0,21,22,-1
SWE,CHN,2007.0,35,22,13
NZL,CAN,2014.0,36,31,5
CAN,SAU,2000.0,3,4,-1
PAN,CAN,2016.0,3,1,2
CHL,GBR,2019.0,42,54,-12
ARE,KAZ,2016.0,1,2,-1
ISL,SWE,2017.0,8,14,-6
TUN,CHN,2020.0,7,2,5
DZA,ESP,2021.0,3,4,-1
CZE,NOR,2020.0,7,5,2
ISL,USA,2012.0,12,13,-1
DEU,IRL,2019.0,41,39,2
ROU,GBR,2022.0,8,6,2
CAN,DZA,2015.0,8,7,1
MYS,IRL,2019.0,6,8,-2
USA,TZA,2013.0,15,11,4
GRC,FIN,2005.0,1,1,0
IRN,BLR,2007.0,1,1,0
ISL,SWE,2010.0,9,13,-4
FRA,GRC,2006.0,20,22,-2
USA,SAU,2002.0,33,28,5
ITA,AUS,2004.0,18,17,1
ETH,ITA,2020.0,6,5,1
ITA,JPN,2007.0,18,17,1
ISR,ESP,2004.0,6,4,2
NLD,IND,2010.0,14,34,-20
CAN,TUN,2005.0,4,2,2
GEO,USA,2007.0,9,8,1
USA,LKA,2004.0,7,8,-1
POL,DNK,2002.0,8,2,6
TUR,BEL,2007.0,5,4,1
SVN,FRA,2001.0,1,1,0
NLD,RUS,1997.0,4,5,-1
KEN,DEU,2016.0,6,16,-10
USA,SEN,2010.0,5,4,1
CHE,IND,1999.0,3,1,2
DNK,BRA,2017.0,10,17,-7
USA,OMN,2017.0,7,3,4
BOL,COL,2020.0,1,2,-1
GUM,USA,2012.0,5,5,0
HRV,GBR,2018.0,14,9,5
GBR,NAM,2018.0,1,1,0
PER,DEU,2017.0,6,2,4
NLD,SUR,2021.0,2,2,0
USA,BWA,2018.0,9,12,-3
GNQ,GIN,2019.0,8,1,7
ESP,HRV,2021.0,2,3,-1
CHN,PHL,2018.0,2,8,-6
ESP,MOZ,2018.0,3,3,0
TUR,AZE,2021.0,5,1,4
SAU,GBR,2013.0,22,104,-82
EGY,RUS,2021.0,7,7,0
IND,FIN,2010.0,8,1,7
MYS,IDN,2012.0,29,13,16
ISL,SWE,2019.0,13,20,-7
ITA,THA,2017.0,5,4,1
KOR,ESP,2019.0,10,4,6
EGY,ARE,2012.0,10,9,1
CHL,AUS,2006.0,4,2,2
FRA,PYF,2018.0,20,10,10
MAR,ESP,2005.0,5,3,2
RUS,SRB,2006.0,3,5,-2
KEN,NLD,2017.0,4,5,-1
COL,DEU,2020.0,29,8,21
ITA,NLD,1997.0,9,5,4
NLD,ROU,2002.0,4,11,-7
KOR,NPL,2013.0,4,3,1
MKD,USA,2004.0,3,1,2
GRC,ZAF,2000.0,2,1,1
FRA,HKG,2014.0,7,6,1
SVK,GBR,2012.0,9,2,7
TWN,POL,2019.0,3,1,2
ARG,CAN,2022.0,9,2,7
CYP,ITA,2018.0,3,1,2
GHA,NGA,2012.0,2,2,0
BEL,FIN,2021.0,10,1,9
BGR,ITA,2001.0,4,1,3
DEU,PSE,1998.0,1,1,0
FRA,MCO,2022.0,5,1,4
NAM,NOR,2005.0,2,1,1
JOR,DEU,2015.0,7,13,-6
HRV,IRL,2019.0,1,1,0
HRV,IRN,2016.0,1,1,0
PSE,GBR,2021.0,3,4,-1
SWE,LTU,2009.0,8,3,5
BRA,BGR,1998.0,1,1,0
DEU,CYP,2016.0,5,4,1
AUT,HRV,1999.0,4,3,1
TWN,VNM,2010.0,3,2,1
DNK,UKR,2017.0,1,2,-1
CAN,HRV,2020.0,4,4,0
AUS,CHL,2009.0,4,6,-2
SGP,MYS,2005.0,7,3,4
TUR,ZAF,2019.0,1,1,0
CHL,CZE,2017.0,2,3,-1
CYP,FRA,2006.0,1,1,0
PHL,DEU,2021.0,3,6,-3
CAN,MTQ,2013.0,1,2,-1
TZA,NOR,2006.0,1,1,0
SWE,EGY,2007.0,3,1,2
PHL,NZL,2011.0,2,2,0
BGR,POL,2001.0,3,1,2
NPL,CAN,2017.0,2,1,1
IRL,NOR,2017.0,2,3,-1
TZA,KOR,2017.0,1,1,0
COL,KEN,2020.0,1,1,0
HUN,HKG,2002.0,1,1,0
SVK,UKR,2017.0,2,4,-2
QAT,SWE,2018.0,2,1,1
EGY,IRL,2014.0,1,4,-3
KWT,SAU,2003.0,1,1,0
NZL,JPN,2004.0,3,9,-6
SAU,JPN,2001.0,1,1,0
SVN,SLV,2020.0,1,1,0
SDN,AUS,2021.0,1,1,0
DEU,PHL,2001.0,1,2,-1
URY,CUB,2017.0,1,2,-1
UGA,ZAF,2011.0,1,3,-2
CHN,MLI,2020.0,1,2,-1
RUS,SAU,2014.0,1,1,0
FIN,BGR,2002.0,1,2,-1
CUB,PRT,2009.0,1,1,0
HUN,,2018.0,1331,0,1331
,ZAF,2004.0,1559,0,1559
KOR,,2008.0,3914,0,3914
BEL,,2019.0,3372,0,3372
DNK,,2024.0,19607,0,19607
FIN,,2023.0,8194,0,8194
HRV,,2019.0,957,0,957
BRA,,2016.0,10113,0,10113
,SWE,1999.0,6862,0,6862
,GBR,2009.0,19640,0,19640
,CHN,2008.0,91433,0,91433
CAN,,2008.0,4559,0,4559
ETH,,2023.0,2870,0,2870
,PRT,2013.0,3217,0,3217
NZL,,2020.0,1617,0,1617
SAU,,2018.0,1029,0,1029
IRN,,2012.0,1376,0,1376
DEU,,2001.0,1316,0,1316
,TUN,2016.0,1285,0,1285
IRL,,2002.0,60,0,60
HRV,,2010.0,351,0,351
PRT,IRL,2008.0,3,0,3
,PNG,1999.0,38,0,38
CHL,,2014.0,825,0,825
BEL,,2017.0,2816,0,2816
,ZAF,1996.0,620,0,620
FRA,,2006.0,5246,0,5246
,SAU,2001.0,505,0,505
BEL,,2010.0,1512,0,1512
,DZA,2002.0,496,0,496
,ESP,2011.0,14253,0,14253
MYS,,2021.0,5495,0,5495
,ARG,1998.0,3273,0,3273
TUR,,2008.0,1402,0,1402
PER,,2018.0,236,0,236
,IND,2011.0,29179,0,29179
,CRI,2017.0,166,0,166
,ARG,1997.0,1164,0,1164
,POL,2007.0,4990,0,4990
,CHE,2014.0,4645,0,4645
HRV,,2017.0,693,0,693
NLD,,1999.0,142,0,142
COL,,2011.0,237,0,237
CHN,KEN,2010.0,5,0,5
CMR,,2017.0,147,0,147
,DZA,2005.0,749,0,749
ESP,,2007.0,3577,0,3577
SRB,,2011.0,254,0,254
BFA,,2011.0,25,0,25
ISR,,2002.0,137,0,137
COL,CHL,2004.0,8,0,8
,DNK,2015.0,2694,0,2694
,GUF,2004.0,4,0,4
LBN,,2014.0,101,0,101
PHL,,2009.0,63,0,63
EGY,,2025.0,98,0,98
AZE,,2019.0,186,0,186
BWA,,2004.0,6,0,6
MNG,,2023.0,263,0,263
BIH,,2008.0,41,0,41
BLR,,2020.0,284,0,284
,CRI,2010.0,92,0,92
,BLR,2001.0,328,0,328
CMR,,2019.0,253,0,253
AUT,ZAF,2017.0,4,0,4
OMN,AUS,2010.0,3,0,3
,NZL,2006.0,1252,0,1252
,SEN,2012.0,143,0,143
,ECU,2010.0,130,0,130
,TGO,2011.0,63,0,63
,NIC,2012.0,12,0,12
PAN,,2022.0,96,0,96
,MAC,2015.0,221,0,221
ISR,,2005.0,686,0,686
,LTU,2014.0,543,0,543
,SLE,2012.0,36,0,36
,UGA,2014.0,265,0,265
TCD,,2019.0,12,0,12
ROU,,2025.0,23,0,23
CHN,BEN,2022.0,2,0,2
COG,,2021.0,100,0,100
,CYP,2018.0,163,0,163
SYR,FIN,2016.0,1,0,1
AZE,HUN,2018.0,1,0,1
,ECU,2019.0,365,0,365
,ECU,2017.0,844,0,844
HUN,GMB,2019.0,1,0,1
,MWI,2017.0,108,0,108
,MDG,2016.0,77,0,77
SGP,KAZ,2018.0,3,0,3
,MWI,2010.0,72,0,72
PHL,MEX,2017.0,1,0,1
,LBN,1995.0,53,0,53
SYC,,2023.0,15,0,15
SLV,,2022.0,16,0,16
AUT,BGR,2017.0,1,0,1
LBN,CHE,2022.0,5,0,5
,CRI,2019.0,58,0,58
UGA,,2020.0,216,0,216
LSO,,2023.0,38,0,38
SVK,,2007.0,233,0,233
SEN,CAF,2015.0,3,0,3
BRA,SGP,2012.0,2,0,2
,TZA,1995.0,39,0,39
,KGZ,1999.0,12,0,12
ISL,,2007.0,42,0,42
AUT,SVN,2007.0,7,0,7
HKG,KOR,2006.0,6,0,6
LUX,,2013.0,47,0,47
DOM,,2003.0,2,0,2
,HTI,2008.0,10,0,10
TUR,IRL,2018.0,6,0,6
,MMR,2015.0,57,0,57
ZAF,BEN,2018.0,3,0,3
TUR,UZB,2009.0,1,0,1
,AGO,2013.0,16,0,16
AZE,,2017.0,97,0,97
IRN,PRT,2007.0,1,0,1
ROU,HKG,2020.0,1,0,1
,ARM,1995.0,124,0,124
FIN,ARE,2022.0,1,0,1
PAK,NPL,2018.0,3,0,3
GIN,USA,2019.0,1,0,1
,REU,2014.0,7,0,7
AUS,PYF,2019.0,1,0,1
ROU,CHN,2016.0,2,0,2
GBR,TUN,2007.0,1,0,1
AUT,UZB,2020.0,1,0,1
,BOL,2000.0,35,0,35
GBR,CMR,2003.0,3,0,3
TCD,,2017.0,8,0,8
,MWI,2019.0,62,0,62
,MLI,2016.0,36,0,36
IRL,,2005.0,267,0,267
CMR,,2010.0,46,0,46
AUT,UGA,2008.0,2,0,2
PER,COL,2011.0,3,0,3
NGA,,2000.0,7,0,7
GRC,BGR,2015.0,2,0,2
,BWA,1994.0,20,0,20
LBY,,2015.0,55,0,55
,MDA,2009.0,57,0,57
SWZ,TZA,2019.0,1,0,1
SVN,AUT,1997.0,1,0,1
NOR,BGD,2002.0,2,0,2
NGA,FJI,2021.0,1,0,1
HRV,BEL,2008.0,2,0,2
CZE,SGP,2004.0,1,0,1
SWZ,NZL,2010.0,1,0,1
MTQ,,2015.0,7,0,7
DEU,KWT,2017.0,3,0,3
ARE,CYP,2009.0,1,0,1
LKA,,2007.0,26,0,26
CHN,SVN,2012.0,2,0,2
TGO,,2011.0,8,0,8
CIV,TUN,1998.0,2,0,2
SEN,CHE,2011.0,3,0,3
NCL,NZL,2017.0,1,0,1
AUS,BRN,2003.0,2,0,2
BEL,EGY,2001.0,4,0,4
,MTQ,1994.0,14,0,14
MYS,ARE,2002.0,2,0,2
MEX,CRI,2013.0,2,0,2
,GUF,1996.0,3,0,3
FRA,BOL,2003.0,3,0,3
ARM,BRA,2012.0,1,0,1
ISR,IRL,2003.0,2,0,2
CHE,KHM,2010.0,4,0,4
ZAF,CAN,1998.0,2,0,2
SLE,KEN,2002.0,1,0,1
RUS,LTU,2008.0,1,0,1
PAN,SWE,2014.0,1,0,1
MDV,,2024.0,24,0,24
NGA,THA,2011.0,1,0,1
IND,HUN,2016.0,6,0,6
KWT,PRT,2017.0,1,0,1
AZE,IRN,2012.0,4,0,4
FRA,TGO,2015.0,4,0,4
GAB,CMR,2014.0,1,0,1
,FLK,2011.0,3,0,3
MCO,MAR,2014.0,1,0,1
NER,,2018.0,25,0,25
STP,,2018.0,2,0,2
TWN,IDN,2006.0,1,0,1
PAK,RUS,2012.0,1,0,1
CUB,USA,2022.0,4,0,4
MAR,KOR,2022.0,3,0,3
,BRB,2018.0,4,0,4
ISL,ITA,2018.0,3,0,3
CIV,MLI,2004.0,1,0,1
,TCD,2018.0,6,0,6
IND,VEN,2001.0,1,0,1
,BEN,2007.0,61,0,61
GEO,PAK,2010.0,1,0,1
AZE,,2010.0,65,0,65
SWE,TWN,1998.0,2,0,2
IRL,JAM,2009.0,1,0,1
NGA,POL,2012.0,2,0,2
DNK,VNM,2020.0,5,0,5
TWN,KEN,2021.0,1,0,1
VEN,IND,2002.0,1,0,1
,MLT,2004.0,29,0,29
CHE,KHM,2019.0,1,0,1
KAZ,SYR,2019.0,1,0,1
VEN,CUB,2014.0,3,0,3
AUS,CYP,2010.0,2,0,2
UGA,ITA,2015.0,3,0,3
NOR,SDN,2017.0,1,0,1
MEX,PAN,2014.0,4,0,4
RUS,SVK,2012.0,1,0,1
,KHM,2001.0,16,0,16
SLE,USA,1999.0,1,0,1
BEL,MAR,2018.0,4,0,4
USA,LBY,2008.0,2,0,2
MWI,,2009.0,15,0,15
ARG,CRI,2005.0,3,0,3
IND,LBN,2020.0,3,0,3
,BDI,2005.0,4,0,4
GUF,,2011.0,6,0,6
ESP,NER,2015.0,1,0,1
VEN,TTO,2009.0,1,0,1
SYR,LBN,2016.0,1,0,1
RUS,SVN,2002.0,2,0,2
ZAF,PRT,2016.0,3,0,3
JPN,UGA,2011.0,2,0,2
PAN,ESP,2008.0,2,0,2
NLD,SLE,2015.0,1,0,1
MAC,,2006.0,6,0,6
QAT,BHR,2022.0,2,0,2
MLI,,2008.0,5,0,5
CHN,UGA,2005.0,1,0,1
BEN,ITA,2011.0,1,0,1
DJI,,2006.0,1,0,1
GMB,SWZ,2008.0,1,0,1
PER,SAU,2000.0,1,0,1
ECU,,2003.0,2,0,2
,MLT,1996.0,6,0,6
COL,MOZ,2004.0,1,0,1
SVK,CHN,2015.0,3,0,3
FRA,OMN,2010.0,1,0,1
MEX,NOR,2013.0,1,0,1
BRA,SVN,2011.0,1,0,1
CHL,SRB,2010.0,2,0,2
GEO,CHE,2009.0,1,0,1
IRL,GHA,2007.0,1,0,1
IRN,NPL,2007.0,1,0,1
THA,TUN,2021.0,1,0,1
BRA,MCO,2003.0,3,0,3
RUS,CHL,2013.0,1,0,1
IND,LUX,2010.0,1,0,1
BEL,HKG,2005.0,1,0,1
KOR,IRQ,2016.0,1,0,1
FRA,NER,2015.0,4,0,4
AUS,KAZ,2013.0,1,0,1
AUT,COL,2022.0,1,0,1
GMB,,2003.0,1,0,1
TUR,OMN,2022.0,2,0,2
MHL,NCL,2010.0,1,0,1
LKA,CHN,2010.0,1,0,1
,AND,2005.0,2,0,2
BRA,BOL,2014.0,2,0,2
MKD,DNK,2016.0,2,0,2
CHN,MNG,2017.0,1,0,1
CMR,MWI,2016.0,1,0,1
SAU,PHL,2017.0,1,0,1
GNQ,ESP,2003.0,2,0,2
SGP,BRN,2008.0,2,0,2
HKG,QAT,2016.0,3,0,3
BEL,CAF,2018.0,1,0,1
SLB,,2017.0,7,0,7
CMR,NLD,2014.0,1,0,1
ARG,DOM,2022.0,3,0,3
VEN,DOM,2019.0,3,0,3
AND,,2021.0,3,0,3
BEL,BOL,2022.0,1,0,1
SWE,BFA,2010.0,2,0,2
IND,LUX,2017.0,1,0,1
EGY,CZE,2017.0,3,0,3
BEL,GHA,2010.0,1,0,1
GUY,GBR,2010.0,1,0,1
CHN,SLE,2005.0,1,0,1
GRC,ARM,2005.0,1,0,1
GHA,KEN,2003.0,1,0,1
CAN,ALB,2001.0,1,0,1
ARG,NZL,2003.0,1,0,1
CRI,GBR,2001.0,1,0,1
UKR,CHN,2013.0,1,0,1
SAU,IND,1997.0,1,0,1
IRL,BHR,2004.0,1,0,1
SRB,KWT,2014.0,2,0,2
ARM,TWN,2010.0,2,0,2
BRA,URY,1999.0,2,0,2
BLR,LVA,2019.0,2,0,2
SRB,HKG,1998.0,1,0,1
BHS,,2004.0,1,0,1
FIN,MEX,2005.0,1,0,1
CHE,GRD,2016.0,2,0,2
RWA,TTO,2004.0,1,0,1
MMR,,2011.0,2,0,2
SRB,QAT,2015.0,4,0,4
GHA,IND,2013.0,2,0,2
TWN,ARM,2007.0,1,0,1
,BDI,2002.0,4,0,4
JPN,UZB,2014.0,1,0,1
TZA,BFA,2008.0,1,0,1
THA,EGY,2014.0,1,0,1
CHL,PAK,2020.0,1,0,1
SYC,AUS,2014.0,1,0,1
GRC,ALB,2015.0,2,0,2
DZA,HUN,2017.0,1,0,1
GUF,CHE,2004.0,1,0,1
UGA,BWA,2019.0,1,0,1
,GNQ,2017.0,4,0,4
BOL,KOR,2020.0,1,0,1
BHR,OMN,2021.0,1,0,1
MAR,NER,2004.0,2,0,2
BLR,SGP,2013.0,1,0,1
BRA,VNM,2011.0,1,0,1
GUM,MYS,2008.0,1,0,1
JOR,RUS,2007.0,1,0,1
AZE,DEU,2007.0,2,0,2
BRA,ROU,2021.0,1,0,1
MDA,EST,2013.0,1,0,1
LKA,IRL,2019.0,1,0,1
ITA,ECU,2020.0,7,0,7
GBR,JOR,1999.0,1,0,1
GBR,SYR,2011.0,4,0,4
UGA,MOZ,2017.0,1,0,1
JOR,AUS,2001.0,3,0,3
NZL,FIN,2000.0,1,0,1
ITA,LBN,2009.0,1,0,1
EGY,OMN,2003.0,2,0,2
ZAF,BFA,2014.0,2,0,2
CHE,SWZ,2015.0,1,0,1
MDA,CHE,2015.0,2,0,2
KOR,LAO,2017.0,1,0,1
CAN,PSE,2014.0,3,0,3
RUS,GIN,2019.0,1,0,1
BOL,SWE,2021.0,1,0,1
YEM,GBR,2019.0,1,0,1
DZA,SAU,2003.0,3,0,3
GBR,PNG,1998.0,1,0,1
,AND,2002.0,2,0,2
GBR,PSE,2005.0,2,0,2
COG,CMR,2009.0,1,0,1
BEL,AUT,2003.0,2,0,2
BRN,PAK,2016.0,2,0,2
GHA,BFA,2013.0,2,0,2
AUT,GEO,2017.0,1,0,1
BGD,PRT,2011.0,1,0,1
UKR,SVN,2014.0,1,0,1
FRA,DJI,2001.0,1,0,1
ROU,ISR,2015.0,3,0,3
GTM,BRA,2015.0,2,0,2
SVK,EST,2017.0,1,0,1
CUB,THA,2021.0,1,0,1
ARE,QAT,2006.0,1,0,1
FRA,OMN,2017.0,1,0,1
CHL,IRL,2022.0,4,0,4
SWE,CRI,2019.0,2,0,2
CUB,NLD,2012.0,1,0,1
FIN,JOR,2016.0,1,0,1
IRN,PHL,2014.0,1,0,1
NLD,OMN,2008.0,3,0,3
NER,AUS,2007.0,1,0,1
ROU,CMR,2020.0,1,0,1
GRC,OMN,2016.0,1,0,1
DNK,EGY,2005.0,3,0,3
LTU,CZE,2001.0,1,0,1
USA,GNQ,2008.0,1,0,1
NOR,UGA,2005.0,1,0,1
TTO,ESP,2018.0,3,0,3
CAN,CYP,2011.0,1,0,1
KGZ,ISR,2003.0,1,0,1
SYR,BEL,2003.0,1,0,1
KWT,DEU,2002.0,1,0,1
PRI,HRV,2012.0,1,0,1
MAR,NLD,2003.0,1,0,1
USA,MHL,2005.0,1,0,1
SWE,SDN,2008.0,2,0,2
CAN,BEN,2003.0,4,0,4
MLI,SEN,2006.0,1,0,1
KWT,DEU,2005.0,1,0,1
BRA,GEO,2018.0,1,0,1
ESP,LUX,2007.0,1,0,1
ZAF,SYC,2009.0,1,0,1
GNB,,2011.0,1,0,1
UGA,GHA,2016.0,1,0,1
COL,MYS,2019.0,1,0,1
TUN,KWT,2020.0,1,0,1
LBY,JOR,2018.0,1,0,1
BEL,UGA,2005.0,1,0,1
MEX,LIE,2021.0,1,0,1
ALB,DEU,2003.0,1,0,1
MAR,CMR,2012.0,2,0,2
ESP,MEX,1997.0,3,0,3
ROU,KWT,1998.0,1,0,1
ZAF,ITA,1997.0,1,0,1
CHN,PAK,1999.0,1,0,1
MWI,CHE,2014.0,3,0,3
DEU,COG,2009.0,1,0,1
NZL,TTO,2016.0,1,0,1
CYP,ARG,2010.0,1,0,1
ARE,BRB,2006.0,1,0,1
GBR,YEM,2007.0,3,0,3
NGA,BEN,2001.0,1,0,1
MUS,CHE,2011.0,1,0,1
DEU,UGA,2001.0,3,0,3
QAT,SDN,2015.0,1,0,1
YEM,,2005.0,2,0,2
USA,GIN,2002.0,1,0,1
CHL,ISR,2005.0,1,0,1
ETH,SWZ,2011.0,2,0,2
BRA,PER,2003.0,2,0,2
BEL,IRL,1999.0,3,0,3
ISR,ZMB,2014.0,1,0,1
LCA,,2009.0,1,0,1
NOR,BGD,2005.0,1,0,1
IND,BHR,2001.0,2,0,2
CHE,AFG,2012.0,1,0,1
ECU,NZL,2013.0,1,0,1
PAK,IRN,2001.0,1,0,1
OMN,DZA,2006.0,1,0,1
POL,GHA,2014.0,1,0,1
SWZ,NZL,2017.0,1,0,1
MYS,BTN,2018.0,1,0,1
AUT,LUX,2015.0,1,0,1
URY,BEL,2019.0,1,0,1
AUS,YEM,2003.0,1,0,1
FRA,LAO,2001.0,1,0,1
ITA,UGA,2021.0,1,0,1
KOR,LAO,2010.0,1,0,1
BRN,,1999.0,1,0,1
BHR,IDN,2021.0,1,0,1
TGO,MAR,2020.0,1,0,1
HND,BRA,2022.0,1,0,1
BRA,TWN,2013.0,2,0,2
OMN,FRA,2021.0,1,0,1
JPN,ARG,1998.0,2,0,2
CAN,AZE,2013.0,1,0,1
ITA,TZA,2016.0,2,0,2
NOR,MAR,2020.0,2,0,2
CHN,PER,2021.0,3,0,3
ETH,SDN,2009.0,1,0,1
MEX,DOM,2013.0,2,0,2
DZA,UKR,2017.0,1,0,1
SVK,CHE,2021.0,1,0,1
MAC,JPN,1999.0,1,0,1
ROU,NOR,2003.0,1,0,1
USA,MCO,2004.0,2,0,2
PRT,OMN,2022.0,1,0,1
KOR,PRI,2007.0,1,0,1
NGA,IDN,2017.0,1,0,1
,GNQ,2019.0,2,0,2
SWE,PER,2007.0,2,0,2
SAU,ESP,2008.0,1,0,1
JPN,MKD,2008.0,1,0,1
ISL,ESP,2007.0,1,0,1
LTU,HRV,2002.0,1,0,1
GRC,JPN,1998.0,1,0,1
SRB,IRL,2001.0,1,0,1
UKR,AUS,2001.0,1,0,1
CHE,VUT,2022.0,1,0,1
HUN,ZAF,2008.0,1,0,1
TUN,NER,2013.0,1,0,1
ZAF,SDN,2011.0,2,0,2
MYS,QAT,2004.0,1,0,1
NGA,BFA,2000.0,1,0,1
SWE,COG,2019.0,1,0,1
SHN,GBR,2016.0,1,0,1
SYR,TUN,2005.0,1,0,1
UGA,AUS,2021.0,1,0,1
NLD,SDN,2020.0,1,0,1
ROU,TUR,2015.0,2,0,2
CIV,MDG,2014.0,1,0,1
,GUM,2016.0,1,0,1
TWN,MEX,2008.0,1,0,1
CUB,KHM,2001.0,1,0,1
CAN,MUS,2017.0,1,0,1
MYS,DNK,2004.0,1,0,1
GUY,,2006.0,2,0,2
COL,EST,2008.0,1,0,1
ARE,BRA,2022.0,1,0,1
IRN,MAR,2008.0,1,0,1
FIN,BGR,2005.0,1,0,1
MYS,MAR,2005.0,1,0,1
VEN,NLD,2006.0,1,0,1
GMB,CHE,2005.0,1,0,1
NLD,NAM,2014.0,1,0,1
TJK,TUR,2016.0,1,0,1
MAC,PRT,2014.0,1,0,1
ESP,HTI,2012.0,1,0,1
HUN,GRC,2018.0,1,0,1
CHN,LAO,2020.0,3,0,3
EGY,NOR,2011.0,1,0,1
MYS,CZE,2016.0,2,0,2
QAT,FIN,2022.0,1,0,1
BWA,FIN,2018.0,1,0,1
PRY,SWE,2020.0,2,0,2
OMN,QAT,2018.0,1,0,1
SYR,ARE,2020.0,1,0,1
FRA,BHR,2020.0,1,0,1
,VUT,2002.0,3,0,3
JPN,ISR,2015.0,4,0,4
MYS,IRN,1999.0,1,0,1
IRQ,PAK,2018.0,2,0,2
NCL,NZL,2019.0,2,0,2
ARE,NGA,2005.0,1,0,1
CHE,ETH,2022.0,2,0,2
GBR,CAF,2022.0,1,0,1
MWI,FRA,2009.0,1,0,1
GHA,GMB,2021.0,1,0,1
MKD,BGR,2022.0,2,0,2
SWE,KWT,2003.0,1,0,1
IRL,LBY,2009.0,1,0,1
BGR,YEM,2019.0,2,0,2
PER,FIN,2014.0,1,0,1
CHL,ISR,2002.0,1,0,1
BFA,NOR,2017.0,1,0,1
,SMR,2007.0,1,0,1
ARM,CZE,2015.0,1,0,1
GRC,PAK,2015.0,1,0,1
BLR,LTU,2016.0,1,0,1
ROU,IND,2015.0,1,0,1
VNM,NGA,2014.0,1,0,1
PRT,HND,2013.0,1,0,1
KWT,CZE,2016.0,2,0,2
MDG,KHM,2019.0,1,0,1
TKM,,2011.0,2,0,2
TUR,BGD,2014.0,1,0,1
ARG,PRY,2011.0,1,0,1
PHL,MEX,2010.0,1,0,1
COG,ITA,2008.0,1,0,1
GUY,IND,2014.0,1,0,1
SYR,SWE,2019.0,1,0,1
ARG,IND,2018.0,1,0,1
IRN,ITA,1999.0,1,0,1
ARE,UZB,2021.0,1,0,1
DZA,,1999.0,2,0,2
AUS,TZA,2004.0,1,0,1
PRT,URY,2011.0,1,0,1
RUS,AGO,2005.0,1,0,1
COL,PRI,2010.0,3,0,3
ARE,IRQ,2004.0,1,0,1
NER,MDG,1999.0,2,0,2
CAN,MUS,2019.0,1,0,1
CMR,CAF,2012.0,1,0,1
RUS,THA,2020.0,1,0,1
LVA,NOR,2019.0,1,0,1
ESP,COG,2004.0,1,0,1
CHL,HND,2001.0,1,0,1
MMR,BEL,2014.0,1,0,1
CAN,NER,2006.0,1,0,1
HRV,SVK,2003.0,1,0,1
IND,LBY,2003.0,1,0,1
QAT,ARE,2003.0,3,0,3
SRB,KOR,2016.0,1,0,1
BEL,UGA,2002.0,1,0,1
RWA,BDI,2020.0,1,0,1
SYC,BRA,2010.0,1,0,1
THA,HUN,2003.0,1,0,1
PRT,COG,2011.0,1,0,1
SWE,LBY,2007.0,1,0,1
KHM,CHN,2007.0,1,0,1
BEN,GHA,2021.0,2,0,2
CHN,ARE,2006.0,1,0,1
ZMB,IND,2017.0,1,0,1
BGD,DNK,2011.0,1,0,1
UZB,IND,2012.0,1,0,1
BEL,TGO,2019.0,1,0,1
TWN,PSE,2019.0,1,0,1
GBR,SWZ,2006.0,1,0,1
CZE,THA,2012.0,1,0,1
BRA,CPV,2016.0,1,0,1
CUB,AUS,2006.0,1,0,1
GRC,VNM,2009.0,1,0,1
BGR,VNM,2017.0,1,0,1
SEN,ZAF,2016.0,1,0,1
JPN,SLB,2021.0,1,0,1
AUT,MCO,2016.0,1,0,1
ITA,LVA,2016.0,1,0,1
BEL,GHA,2019.0,1,0,1
MEX,NZL,2022.0,2,0,2
NOR,KAZ,2017.0,1,0,1
ARM,CHE,2016.0,1,0,1
MYS,PAN,2010.0,1,0,1
,VUT,2005.0,1,0,1
NLD,GMB,2006.0,1,0,1
TTO,IRL,2018.0,1,0,1
LVA,GRC,2007.0,1,0,1
YEM,,2002.0,1,0,1
NOR,TZA,1999.0,1,0,1
IND,PSE,2007.0,1,0,1
JPN,ALB,2002.0,2,0,2
TON,,2006.0,1,0,1
HKG,THA,2006.0,1,0,1
NAM,NOR,2002.0,1,0,1
EST,BEL,2008.0,1,0,1
USA,LAO,2002.0,1,0,1
SEN,SWE,2016.0,1,0,1
JOR,DNK,1998.0,1,0,1
AZE,USA,2005.0,1,0,1
ESP,ETH,2005.0,1,0,1
DEU,KWT,2010.0,1,0,1
KOR,GMB,2002.0,1,0,1
ITA,SMR,2007.0,1,0,1
IRL,ISR,2001.0,1,0,1
UKR,BRA,2010.0,1,0,1
SVN,IND,2018.0,1,0,1
VNM,COL,2016.0,1,0,1
AUS,SYC,2010.0,1,0,1
SWE,LKA,2015.0,1,0,1
KWT,PRT,2019.0,1,0,1
QAT,YEM,2003.0,1,0,1
MEX,HND,2012.0,1,0,1
CHL,SRB,2017.0,1,0,1
DZA,CIV,2010.0,1,0,1
CRI,PRI,2011.0,1,0,1
TWN,PSE,2017.0,1,0,1
BHR,HKG,2019.0,1,0,1
CZE,ISL,2016.0,1,0,1
AUS,JAM,2003.0,1,0,1
ITA,MAC,2008.0,1,0,1
IRN,BRA,2007.0,1,0,1
ISR,CYP,2022.0,1,0,1
ITA,MCO,2016.0,1,0,1
CZE,FIN,2004.0,1,0,1
COD,BEL,2003.0,1,0,1
BHR,MYS,2013.0,1,0,1
TZA,PAK,2018.0,1,0,1
GBR,SOM,2011.0,1,0,1
NCL,CHE,2013.0,1,0,1
BLR,CZE,2016.0,1,0,1
BLR,LVA,2017.0,1,0,1
GBR,PSE,2002.0,1,0,1
PLW,,2014.0,1,0,1
SWE,BHR,2003.0,1,0,1
MEX,ISL,2020.0,1,0,1
FRA,GEO,2004.0,1,0,1
SDN,ETH,2021.0,1,0,1
PRI,PRT,2016.0,1,0,1
IND,PER,2002.0,1,0,1
IDN,ROU,2016.0,1,0,1
BEL,PSE,2007.0,1,0,1
SWE,BFA,2017.0,1,0,1
PAK,EGY,2004.0,1,0,1
ROU,SVK,2002.0,1,0,1
UGA,SDN,2010.0,1,0,1
CMR,COD,2015.0,1,0,1
BEL,EST,2010.0,1,0,1
PSE,ARE,2021.0,1,0,1
COG,GIN,2021.0,1,0,1
UKR,BRA,2017.0,1,0,1
PYF,JPN,2013.0,1,0,1
PAN,COL,2015.0,1,0,1
PRT,PAK,2016.0,1,0,1
JPN,PSE,2020.0,1,0,1
VUT,NZL,2016.0,1,0,1
CAN,KHM,2018.0,1,0,1
CMR,MYS,2006.0,1,0,1
FJI,WSM,2015.0,1,0,1
AFG,CHE,2018.0,1,0,1
,DMA,2015.0,1,0,1
COD,SEN,2021.0,1,0,1
ISR,IRQ,2018.0,1,0,1
USA,BRA,2011.0,340,304,36
DEU,RUS,2008.0,74,105,-31
DEU,BEL,2017.0,106,106,0
FRA,USA,2020.0,709,587,122
FRA,GBR,2009.0,347,286,61
ITA,USA,2008.0,491,356,135
CHN,NZL,2003.0,4,5,-1
GBR,AUS,2012.0,655,349,306
PRT,ESP,2013.0,58,101,-43
USA,CHE,2002.0,348,353,-5
DEU,SWE,2015.0,180,112,68
NLD,FRA,2021.0,68,90,-22
USA,ESP,2001.0,199,273,-74
FRA,TUR,2008.0,16,10,6
USA,SWE,2021.0,174,156,18
BEL,FRA,2020.0,198,211,-13
USA,CHE,2005.0,324,315,9
NLD,CHE,2010.0,58,41,17
GBR,USA,2007.0,1225,1244,-19
GBR,DEU,2011.0,531,468,63
GBR,CHN,2012.0,290,186,104
PRT,BRA,2016.0,140,85,55
ARG,BRA,2019.0,28,38,-10
FRA,MYS,2016.0,9,5,4
USA,RUS,2014.0,144,140,4
GRC,BEL,2012.0,14,7,7
ARG,ESP,2010.0,76,61,15
SWE,USA,2013.0,171,207,-36
USA,ARE,2014.0,83,32,51
FIN,GBR,2014.0,56,48,8
ESP,USA,2002.0,287,322,-35
CHE,NZL,2017.0,10,14,-4
AUS,HKG,1998.0,5,6,-1
USA,KAZ,2004.0,5,3,2
CAN,LBN,2008.0,4,8,-4
CHE,GBR,2012.0,182,254,-72
MYS,SDN,2012.0,5,2,3
CHN,KOR,2010.0,62,110,-48
RUS,FIN,2004.0,16,11,5
BRA,USA,2013.0,363,299,64
AUS,BRA,2018.0,29,72,-43
ZAF,NGA,2007.0,5,17,-12
DNK,AUS,2007.0,16,16,0
FRA,BEL,2005.0,132,108,24
GBR,ITA,2016.0,251,581,-330
PAK,CHN,2007.0,11,6,5
ITA,CHN,2011.0,19,25,-6
AUS,FRA,2014.0,81,100,-19
ITA,IRN,2010.0,8,8,0
CZE,RUS,2011.0,3,10,-7
BEL,USA,2004.0,127,83,44
AUS,SGP,2009.0,52,53,-1
KOR,USA,2018.0,725,759,-34
CAN,BEL,2016.0,28,48,-20
USA,CYP,2012.0,21,4,17
GBR,MEX,2020.0,39,51,-12
GRC,CYP,2014.0,31,11,20
GBR,FRA,2013.0,378,375,3
ITA,CHL,2014.0,8,4,4
BRA,CHE,2015.0,20,18,2
NLD,CHE,2017.0,115,84,31
FRA,CAN,2019.0,331,241,90
MEX,COL,2013.0,17,22,-5
GBR,CHE,2004.0,130,92,38
GBR,CAN,2020.0,400,366,34
AUT,PAK,2012.0,22,3,19
FIN,AUT,2006.0,3,2,1
USA,HKG,2020.0,153,147,6
GBR,FIN,2020.0,73,52,21
RUS,USA,2019.0,168,120,48
USA,THA,2016.0,218,100,118
IND,GBR,2015.0,165,147,18
AUS,CHN,2016.0,260,313,-53
FRA,CAN,2017.0,304,247,57
IRN,USA,2021.0,296,81,215
GBR,TWN,2008.0,35,13,22
DEU,AUS,2019.0,165,132,33
KEN,ZAF,2004.0,3,5,-2
ETH,USA,2020.0,28,18,10
LBN,USA,2012.0,39,53,-14
GBR,ISR,2021.0,48,51,-3
GBR,BEL,2017.0,118,157,-39
DEU,BEL,2019.0,105,107,-2
CHN,GBR,1997.0,11,8,3
ARG,ESP,2019.0,69,53,16
POL,JPN,2015.0,20,4,16
CHN,AUS,2021.0,253,429,-176
FJI,NZL,2016.0,2,1,1
HKG,AUS,2011.0,31,18,13
ESP,ARG,2018.0,66,73,-7
IRN,DEU,2015.0,87,30,57
CHE,ROU,2013.0,3,8,-5
USA,PRI,2019.0,69,105,-36
PRT,CHE,2018.0,17,18,-1
HKG,TWN,2022.0,9,6,3
JPN,FRA,2006.0,60,73,-13
SWE,DNK,2022.0,41,32,9
CHE,IRL,2001.0,5,1,4
RUS,USA,2017.0,155,134,21
USA,PRI,2017.0,65,91,-26
NZL,MYS,2016.0,28,15,13
SWE,AUT,2018.0,18,29,-11
ITA,AUS,2015.0,56,31,25
SWE,NOR,2020.0,68,49,19
MAC,GBR,2021.0,4,3,1
VNM,AUS,2022.0,24,18,6
CHN,CZE,2017.0,9,5,4
CHN,KOR,2017.0,86,179,-93
NOR,CHE,2017.0,15,17,-2
USA,ARG,2011.0,94,82,12
ITA,VNM,2014.0,6,2,4
CHN,KOR,2019.0,110,252,-142
RUS,IRN,2020.0,4,10,-6
NZL,CHL,2010.0,3,1,2
AUS,IRN,2021.0,26,108,-82
IRN,FIN,2021.0,39,3,36
NOR,LKA,2018.0,2,1,1
PAK,AUS,2019.0,44,23,21
COG,COD,2021.0,58,26,32
POL,USA,2001.0,98,56,42
BEL,ITA,2022.0,41,51,-10
USA,FIN,2003.0,88,72,16
ITA,BRA,2021.0,21,56,-35
NLD,CHE,2019.0,115,70,45
YEM,SAU,2019.0,8,3,5
NLD,ESP,2011.0,69,54,15
AUT,USA,2016.0,119,122,-3
QAT,IND,2021.0,4,6,-2
UKR,CAN,2015.0,4,1,3
PAK,DEU,2021.0,16,23,-7
PAK,IND,2014.0,23,24,-1
NZL,JPN,2015.0,9,2,7
CHN,SWE,2013.0,69,49,20
GBR,BEL,2019.0,133,128,5
THA,IND,2018.0,8,18,-10
JPN,FIN,2015.0,12,8,4
IRN,IRQ,2018.0,15,7,8
BGR,MKD,2015.0,2,1,1
USA,URY,2020.0,11,12,-1
ISR,FRA,2018.0,26,25,1
CHN,IND,2018.0,51,239,-188
FRA,NZL,2019.0,23,14,9
DNK,USA,2007.0,84,82,2
DNK,NLD,2022.0,17,19,-2
PRT,IRN,2017.0,6,9,-3
SAU,FRA,2020.0,8,42,-34
FIN,EGY,2019.0,3,1,2
NOR,ITA,2021.0,15,18,-3
CAN,ESP,2021.0,57,42,15
ITA,CAN,2012.0,59,31,28
GRC,FRA,2016.0,40,35,5
CIV,FRA,2020.0,8,19,-11
MLT,GBR,2021.0,5,7,-2
BRA,CHL,2021.0,25,14,11
ESP,CZE,2018.0,27,16,11
THA,USA,2018.0,89,198,-109
MYS,KOR,2020.0,12,9,3
NLD,DNK,2019.0,40,43,-3
ITA,SAU,2018.0,12,8,4
GRC,LUX,2021.0,4,3,1
IND,POL,2022.0,20,4,16
PHL,IND,2020.0,13,6,7
DEU,BEL,2010.0,76,69,7
DNK,FRA,2014.0,30,27,3
CHE,HKG,2020.0,2,10,-8
ITA,IRN,2019.0,17,59,-42
FRA,LUX,2021.0,15,18,-3
BIH,CHE,2019.0,3,3,0
CHN,KAZ,2022.0,4,2,2
RUS,CHE,2021.0,27,6,21
AUT,POL,2015.0,18,7,11
BRA,FRA,2001.0,40,41,-1
IND,CHL,2021.0,10,3,7
RUS,GBR,2004.0,49,35,14
AUT,DNK,2021.0,11,12,-1
USA,NZL,2012.0,126,112,14
TUR,SOM,2021.0,2,1,1
FRA,ARG,2015.0,26,38,-12
CHN,FRA,2014.0,133,154,-21
NOR,FIN,2002.0,9,2,7
LUX,FRA,2016.0,15,28,-13
POL,DEU,2018.0,84,71,13
PAK,AUS,2017.0,28,17,11
SWE,HUN,2021.0,6,9,-3
AUT,RUS,2022.0,6,9,-3
ITA,CHE,2009.0,151,72,79
USA,DNK,2000.0,21,36,-15
GBR,NZL,2007.0,132,101,31
NLD,AUS,2005.0,27,24,3
USA,ZAF,2012.0,83,66,17
AUS,BEL,2015.0,22,26,-4
BRA,COL,2013.0,22,31,-9
MEX,GBR,2012.0,34,40,-6
THA,CAN,2002.0,4,8,-4
CAN,ARE,2011.0,18,4,14
ARG,BRA,2010.0,17,25,-8
ESP,ROU,2012.0,4,6,-2
MEX,RUS,2020.0,6,4,2
USA,SRB,2015.0,16,14,2
FRA,ESP,2012.0,177,191,-14
DNK,CHE,2012.0,15,15,0
USA,MYS,2001.0,8,7,1
ESP,TUR,2012.0,6,6,0
AUS,KOR,2009.0,10,14,-4
SWE,ISR,2017.0,1,2,-1
USA,UGA,2015.0,16,23,-7
SWE,VNM,2015.0,5,1,4
GBR,BEL,2010.0,72,72,0
SWE,PAK,2014.0,18,6,12
CAN,GHA,2015.0,5,5,0
NLD,DNK,2017.0,56,27,29
NLD,DNK,2010.0,22,10,12
CIV,CAN,2016.0,2,1,1
FRA,BGD,2012.0,4,2,2
BEL,IND,2009.0,4,14,-10
BRA,MEX,2015.0,13,20,-7
THA,MYS,2010.0,4,5,-1
VNM,NLD,2016.0,5,5,0
MYS,EGY,2017.0,7,6,1
CUB,DEU,2012.0,6,1,5
RUS,USA,2010.0,167,135,32
USA,ETH,2016.0,15,30,-15
ITA,ROU,2015.0,19,17,2
JPN,CHE,2003.0,22,34,-12
DNK,KOR,2019.0,7,11,-4
PER,MEX,2014.0,2,6,-4
IND,NLD,2015.0,35,25,10
ESP,RUS,2007.0,8,9,-1
PHL,ESP,2019.0,2,2,0
CHE,SWE,2009.0,24,30,-6
BGR,USA,1998.0,9,4,5
IND,TWN,2001.0,20,6,14
CAN,BHS,2015.0,2,1,1
NLD,AUS,2002.0,21,34,-13
NLD,SWE,2001.0,21,20,1
SWE,RUS,2003.0,21,32,-11
FIN,ZAF,2013.0,2,1,1
NOR,CHE,2019.0,15,23,-8
UKR,SWE,2000.0,6,1,5
DEU,AUS,2017.0,141,152,-11
DEU,EGY,2011.0,52,31,21
DEU,HKG,2008.0,6,10,-4
AUT,GBR,2003.0,30,24,6
AUS,OMN,2018.0,6,2,4
FRA,NCL,2012.0,21,10,11
CHL,PER,2015.0,7,4,3
MYS,EGY,2019.0,10,5,5
HKG,SGP,2007.0,23,13,10
NLD,CHL,2022.0,5,5,0
GRC,DNK,2019.0,12,6,6
DNK,ISR,2022.0,2,1,1
ISR,NLD,2017.0,11,11,0
DEU,MWI,2004.0,2,1,1
EGY,FRA,2021.0,7,16,-9
LKA,NLD,2019.0,2,1,1
COL,CAN,2016.0,22,10,12
IRN,TUR,2021.0,41,14,27
FRA,LBN,2015.0,66,30,36
ARG,BRA,2017.0,32,25,7
IRN,CZE,2020.0,21,1,20
FRA,BEL,2002.0,133,131,2
USA,GRD,2020.0,13,6,7
NZL,SWE,2003.0,6,1,5
AUS,DNK,2007.0,16,16,0
MYS,BHR,2021.0,3,1,2
USA,PRI,2010.0,78,54,24
JPN,DEU,2021.0,77,76,1
BRA,NLD,2007.0,10,13,-3
NOR,IRN,2021.0,5,25,-20
QAT,EGY,2011.0,2,13,-11
AUT,ITA,2009.0,20,41,-21
SGP,IDN,2020.0,5,7,-2
EGY,KWT,2016.0,5,9,-4
JPN,COL,2017.0,2,3,-1
DEU,HUN,2008.0,33,33,0
TWN,ETH,2018.0,5,1,4
ISR,NLD,2010.0,5,5,0
SAU,ARE,2012.0,6,8,-2
NOR,ISL,2014.0,6,6,0
GBR,JAM,2013.0,3,2,1
DEU,AUS,2010.0,132,93,39
RUS,POL,2018.0,17,12,5
GRC,ITA,2009.0,20,21,-1
FRA,ROU,2011.0,32,34,-2
USA,KEN,2000.0,6,5,1
SGP,THA,2016.0,8,5,3
ITA,UKR,2011.0,3,1,2
NOR,POL,2002.0,2,2,0
VNM,USA,2015.0,16,28,-12
GBR,UKR,2009.0,8,10,-2
UKR,USA,2014.0,20,30,-10
FRA,CMR,2003.0,17,4,13
JAM,GBR,2005.0,1,1,0
BGR,GBR,2010.0,9,5,4
FIN,DNK,2021.0,13,13,0
PHL,AUS,2000.0,2,1,1
USA,MAR,2005.0,3,7,-4
IRL,AUS,2007.0,30,20,10
SWE,JPN,2002.0,31,38,-7
IRL,SWE,2006.0,4,7,-3
AUT,IND,2002.0,3,1,2
ARE,KWT,2011.0,3,1,2
HKG,GBR,1998.0,6,17,-11
ESP,DNK,2000.0,4,4,0
BEL,SWE,2012.0,15,12,3
BEL,KEN,2002.0,4,3,1
NLD,SGP,2012.0,14,9,5
IND,ESP,2005.0,7,3,4
KOR,BGD,2021.0,24,13,11
FRA,KOR,2001.0,2,3,-1
PRT,IRL,2007.0,2,1,1
USA,ECU,2013.0,19,16,3
DEU,LVA,2001.0,3,3,0
ROU,TUR,2004.0,2,1,1
CHE,HRV,2002.0,2,5,-3
DEU,COL,2003.0,6,3,3
URY,USA,2015.0,12,12,0
AUS,IND,2000.0,6,8,-2
CHE,AUS,2014.0,64,62,2
OMN,FIN,2012.0,2,1,1
IRL,DEU,2000.0,3,8,-5
SWE,ETH,2002.0,6,4,2
DEU,ZAF,1998.0,3,2,1
ISR,AUS,2004.0,11,5,6
IDN,GBR,2009.0,3,11,-8
KEN,ETH,2008.0,2,3,-1
ARE,EGY,2008.0,5,5,0
GBR,SRB,2008.0,10,3,7
AUT,IRN,2012.0,4,4,0
FRA,THA,2002.0,8,4,4
POL,GBR,2022.0,16,17,-1
USA,TTO,2020.0,4,7,-3
FRA,AUT,2001.0,16,15,1
TWN,CAN,2002.0,8,8,0
PRT,AUS,2008.0,7,2,5
NLD,NOR,2012.0,22,12,10
FRA,TGO,2004.0,5,5,0
USA,MAR,2002.0,4,11,-7
HRV,HUN,2016.0,1,2,-1
DEU,VNM,2011.0,10,3,7
DEU,ARG,2009.0,11,21,-10
POL,SWE,2012.0,17,18,-1
RUS,SWE,2018.0,21,12,9
NOR,CHE,2010.0,14,11,3
VEN,USA,1999.0,8,9,-1
USA,JAM,2001.0,4,4,0
PAN,AUS,2010.0,2,1,1
GMB,BEL,2013.0,1,1,0
SWE,NLD,2000.0,11,14,-3
USA,BOL,2016.0,4,6,-2
ESP,PRT,1997.0,2,1,1
IND,ESP,2002.0,5,4,1
JPN,SGP,2003.0,14,8,6
BGD,GBR,2004.0,6,5,1
FRA,URY,2018.0,4,3,1
DNK,HKG,2009.0,1,1,0
ESP,CHE,2001.0,15,16,-1
AUS,FJI,2005.0,5,3,2
HKG,GBR,1997.0,4,4,0
IND,KOR,2004.0,39,13,26
PNG,AUS,2014.0,5,5,0
TWN,CAN,2005.0,9,10,-1
AUS,HKG,1997.0,8,1,7
ESP,SWE,2002.0,22,21,1
AUS,IDN,2001.0,3,2,1
HUN,SWE,2016.0,13,5,8
COL,ESP,2007.0,23,30,-7
SWE,IND,2014.0,26,40,-14
VNM,THA,2011.0,3,5,-2
HUN,ZAF,2007.0,1,1,0
USA,BHS,2016.0,3,3,0
DNK,CHN,2012.0,23,32,-9
IRL,PRT,2018.0,2,4,-2
ESP,UKR,2006.0,1,1,0
CHN,GBR,1998.0,19,21,-2
FRA,UKR,2007.0,2,7,-5
GUF,FRA,2008.0,9,12,-3
MKD,FRA,2006.0,1,3,-2
DEU,TWN,2016.0,17,18,-1
FRA,THA,2005.0,8,1,7
IRN,NLD,2009.0,20,15,5
MEX,PER,2011.0,7,5,2
TUN,ESP,2008.0,3,4,-1
CUB,BEL,2012.0,2,1,1
FRA,CZE,2005.0,7,18,-11
IDN,FRA,2003.0,3,8,-5
GEO,USA,2008.0,7,8,-1
GBR,KWT,2009.0,5,5,0
BEL,TUR,2019.0,7,21,-14
PSE,USA,2002.0,3,2,1
IRN,DNK,2018.0,19,5,14
CHN,POL,2015.0,7,11,-4
SWE,ARG,2013.0,3,4,-1
UGA,GBR,2011.0,4,9,-5
ISR,ESP,2015.0,4,14,-10
BLR,UKR,2010.0,1,6,-5
SWE,PRT,2012.0,7,6,1
PRT,AUT,2018.0,4,4,0
COL,ITA,2011.0,1,6,-5
JPN,BEL,2014.0,12,21,-9
SDN,CHN,2010.0,2,1,1
USA,HRV,2013.0,20,17,3
NPL,AUS,2011.0,2,2,0
FRA,KEN,2015.0,3,2,1
SDN,CHN,2017.0,7,6,1
IND,MEX,2018.0,12,11,1
COL,AUT,2005.0,1,1,0
ECU,ESP,2016.0,20,54,-34
URY,ITA,2013.0,2,1,1
ROU,ESP,2014.0,7,4,3
VNM,KOR,2011.0,9,23,-14
IRL,NZL,2004.0,4,5,-1
KOR,IRN,2015.0,6,14,-8
NZL,CHL,2017.0,5,3,2
NZL,VNM,2018.0,4,6,-2
ITA,MAR,2020.0,4,6,-2
DEU,SRB,2021.0,10,11,-1
DEU,HRV,2018.0,14,15,-1
ISR,IND,2006.0,5,14,-9
MEX,ITA,2016.0,7,25,-18
FRA,COL,2020.0,12,17,-5
COL,AUS,2020.0,7,6,1
GBR,TZA,2020.0,2,9,-7
NLD,CZE,2020.0,3,8,-5
BRN,IDN,2018.0,2,1,1
MYS,EGY,2010.0,1,5,-4
TWN,EGY,2020.0,2,2,0
THA,TWN,2020.0,9,16,-7
BGD,DEU,2008.0,2,1,1
LKA,DEU,2019.0,5,5,0
AUT,KOR,2004.0,2,2,0
CHN,BRA,2020.0,7,18,-11
COL,PER,2020.0,8,6,2
THA,AUS,2009.0,14,34,-20
DZA,CAN,2015.0,7,8,-1
ITA,VEN,2007.0,2,1,1
ZAF,SWE,2000.0,1,3,-2
GBR,RUS,2006.0,19,45,-26
LBN,SAU,2010.0,3,2,1
GRC,GBR,2000.0,10,37,-27
CHE,HRV,2005.0,3,1,2
SVK,DEU,1997.0,1,5,-4
FRA,CHL,2015.0,49,23,26
SVK,BEL,2005.0,2,2,0
FJI,AUS,2003.0,6,4,2
HUN,DNK,2020.0,6,5,1
CAN,THA,2011.0,7,13,-6
RUS,KGZ,2014.0,3,3,0
ZWE,IND,2019.0,1,1,0
IDN,USA,2022.0,5,7,-2
SGP,NLD,2020.0,17,10,7
HUN,GBR,2009.0,27,20,7
ITA,JPN,2008.0,23,10,13
FRA,NZL,2017.0,13,11,2
JOR,USA,2022.0,18,15,3
PRT,ARE,2020.0,1,1,0
COL,BEL,2015.0,1,2,-1
LKA,HKG,2009.0,2,1,1
GBR,DZA,2016.0,5,1,4
BRA,IRN,2016.0,2,6,-4
SWE,THA,2021.0,6,4,2
NGA,BWA,2012.0,3,1,2
DEU,GEO,2019.0,4,5,-1
ESP,TWN,2012.0,1,4,-3
USA,CUB,2011.0,3,12,-9
UKR,POL,2021.0,22,14,8
LBY,IND,2016.0,3,2,1
NPL,JPN,2013.0,3,5,-2
LBN,SAU,2017.0,3,4,-1
MYS,QAT,2015.0,6,1,5
DEU,UKR,2016.0,10,42,-32
ETH,NOR,2020.0,4,9,-5
RUS,NOR,2013.0,8,7,1
IRN,ARM,2010.0,4,1,3
ITA,IDN,2020.0,2,2,0
SAU,SDN,2021.0,7,23,-16
IRL,BHR,2015.0,2,1,1
ROU,CHE,2006.0,3,5,-2
PHL,CHN,2019.0,8,3,5
ARG,URY,2013.0,5,3,2
KOR,MNG,2007.0,2,1,1
AUT,FRA,2001.0,15,16,-1
ESP,LUX,2008.0,3,2,1
SWE,IDN,2011.0,2,2,0
DNK,GRL,2013.0,4,3,1
GEO,RUS,2014.0,2,1,1
CHN,AUT,1998.0,3,2,1
JPN,SVN,2015.0,1,4,-3
NOR,FIN,2005.0,6,7,-1
HRV,USA,2003.0,12,24,-12
RUS,TWN,2019.0,4,2,2
PAK,AUS,2010.0,8,7,1
NPL,GBR,2012.0,7,1,6
IND,ERI,2010.0,2,2,0
NZL,HKG,2003.0,1,4,-3
ISR,SGP,2008.0,1,3,-2
FRA,FIN,1999.0,4,5,-1
CMR,NGA,2020.0,4,3,1
JPN,NGA,2012.0,3,3,0
BEL,DZA,2004.0,2,3,-1
POL,NOR,2012.0,6,4,2
SRB,AUT,2007.0,2,1,1
BGR,GBR,2019.0,5,4,1
CHE,SGP,2011.0,8,6,2
CAN,ISL,2014.0,3,1,2
BFA,ITA,2012.0,2,2,0
SYR,SAU,2012.0,3,2,1
USA,ARM,2016.0,2,10,-8
AUS,ZAF,2005.0,10,17,-7
UGA,KEN,2022.0,4,4,0
FRA,IDN,2011.0,8,2,6
NLD,ZWE,2010.0,1,3,-2
CHE,NZL,2010.0,7,5,2
BGR,CZE,2015.0,1,1,0
AUS,ARG,2009.0,2,3,-1
SVN,CHE,2014.0,4,1,3
BEL,TUR,2017.0,11,11,0
NOR,PRT,2018.0,5,9,-4
IRL,SGP,2012.0,6,3,3
NOR,RUS,2021.0,4,12,-8
PRI,COL,2016.0,3,1,2
NOR,KOR,2016.0,5,2,3
TUR,IRN,2011.0,4,10,-6
URY,ESP,2013.0,6,13,-7
FRA,GEO,2015.0,8,5,3
SYR,FRA,2015.0,5,8,-3
ESP,NZL,2015.0,8,4,4
TUR,CHE,2018.0,21,14,7
ITA,GRC,1997.0,2,4,-2
NOR,TUR,2017.0,2,6,-4
CHE,HUN,2003.0,5,10,-5
HUN,IRN,2016.0,2,1,1
PAK,BEL,2019.0,3,5,-2
TZA,UGA,2020.0,6,4,2
PAK,JPN,2014.0,7,13,-6
PRT,IRN,2019.0,3,12,-9
CYP,RUS,2021.0,1,1,0
IDN,DEU,2012.0,5,28,-23
CHN,SDN,2022.0,5,2,3
NZL,SVN,2014.0,1,1,0
USA,SLE,2014.0,5,1,4
RUS,IRL,2010.0,2,2,0
GRC,DNK,2010.0,3,4,-1
SWE,URY,2005.0,1,1,0
JPN,SAU,2021.0,4,2,2
BEL,GRC,2022.0,4,5,-1
GRC,DNK,2017.0,12,5,7
IRN,CHE,2014.0,26,10,16
CAN,MEX,2000.0,6,3,3
TUR,BEL,2008.0,2,4,-2
BGD,PAK,2003.0,5,2,3
TWN,HKG,2007.0,4,4,0
DNK,IRL,2005.0,1,1,0
JPN,COL,2019.0,3,1,2
OMN,CHN,2019.0,2,2,0
CZE,FIN,2015.0,3,6,-3
CUB,ARG,2002.0,2,1,1
NGA,BRA,2014.0,3,3,0
DNK,KOR,2017.0,6,10,-4
ITA,SVN,2016.0,5,12,-7
SYC,ZAF,2018.0,2,1,1
ETH,ESP,2018.0,4,6,-2
LVA,DEU,2001.0,3,3,0
JOR,IND,2017.0,3,1,2
IRN,ZAF,2018.0,7,2,5
NGA,TUR,2019.0,2,6,-4
BGD,SWE,2021.0,3,1,2
MNG,ITA,2020.0,1,1,0
KWT,AUS,2021.0,1,1,0
KWT,CAN,2018.0,11,8,3
LVA,SWE,2018.0,3,3,0
KOR,PHL,2015.0,9,5,4
ARG,SVN,2011.0,1,1,0
SRB,USA,2009.0,7,18,-11
BLR,TWN,2016.0,1,1,0
COG,ZWE,2020.0,1,1,0
ARM,FRA,2009.0,2,1,1
ESP,ISR,2003.0,3,4,-1
GBR,MAR,2009.0,1,1,0
FRA,IRL,1999.0,6,7,-1
EGY,POL,2012.0,6,2,4
USA,EST,2009.0,8,2,6
LKA,GBR,2013.0,7,14,-7
CZE,POL,2003.0,4,6,-2
BLR,POL,1998.0,1,1,0
DEU,LTU,2013.0,10,5,5
MKD,USA,2015.0,4,4,0
ITA,GRC,1998.0,8,6,2
ESP,PRT,1998.0,5,3,2
SVK,AUT,2003.0,8,5,3
DEU,ZAF,1997.0,4,4,0
BRA,SAU,2020.0,1,1,0
BEL,ARG,1997.0,1,1,0
BGD,IND,2001.0,5,7,-2
CIV,USA,2020.0,6,3,3
UKR,AUT,2004.0,4,4,0
ZWE,USA,2003.0,5,7,-2
CHE,RUS,1998.0,1,10,-9
BGD,USA,2001.0,9,8,1
CAN,BRB,2004.0,1,1,0
USA,MNG,2016.0,5,1,4
NOR,TUR,2019.0,3,4,-1
IRN,EGY,2010.0,2,1,1
RUS,IND,2003.0,1,4,-3
CHL,IND,2001.0,2,1,1
SVN,GBR,2013.0,8,1,7
LBN,GBR,2008.0,6,3,3
BRA,IRL,2011.0,2,1,1
ESP,SWE,2005.0,14,17,-3
URY,MEX,2005.0,1,1,0
TTO,JAM,2013.0,2,3,-1
TWN,CZE,2011.0,1,2,-1
HKG,FRA,2008.0,7,9,-2
CHE,TUR,2008.0,2,3,-1
KWT,USA,2015.0,9,18,-9
SWE,CZE,2015.0,6,4,2
ARE,JOR,2015.0,2,10,-8
RUS,ETH,2022.0,4,1,3
NGA,KEN,2017.0,3,3,0
CHN,UZB,2022.0,4,2,2
EGY,BEL,2022.0,2,1,1
ESP,DOM,2020.0,3,2,1
DEU,KEN,1999.0,1,1,0
IND,SGP,1998.0,5,2,3
LAO,AUS,2019.0,2,1,1
MAR,USA,2021.0,4,7,-3
JPN,EGY,2000.0,3,4,-1
HRV,BIH,2021.0,1,4,-3
PHL,CHN,2010.0,2,2,0
NLD,SVN,2004.0,2,1,1
UKR,NOR,2008.0,3,1,2
USA,BIH,2018.0,7,1,6
TWN,SWE,2003.0,3,1,2
TWN,CHE,2013.0,5,4,1
KEN,CMR,2003.0,1,1,0
IDN,NLD,1999.0,4,1,3
GBR,VEN,2008.0,3,4,-1
TUR,ROU,2019.0,2,2,0
CHL,URY,2019.0,2,1,1
CMR,BFA,2009.0,1,1,0
ITA,IRN,2017.0,14,43,-29
IND,UKR,2020.0,1,1,0
YEM,SAU,2017.0,7,2,5
THA,CAN,2005.0,4,3,1
SVK,ITA,2006.0,3,2,1
IND,BEL,1999.0,7,4,3
SWE,ETH,2005.0,5,2,3
COL,DOM,2019.0,1,1,0
JPN,ZAF,2004.0,2,1,1
CZE,AUT,1999.0,1,6,-5
EGY,MYS,2012.0,5,3,2
SWE,URY,2002.0,2,2,0
NOR,TUR,2010.0,2,6,-4
SWE,SVK,2016.0,2,4,-2
BHR,IND,2006.0,1,5,-4
NLD,MEX,2021.0,8,10,-2
PRT,GRC,2014.0,1,3,-2
UKR,KOR,2009.0,1,3,-2
SRB,HUN,2012.0,2,1,1
RUS,MYS,2017.0,2,1,1
CHE,RUS,1997.0,3,7,-4
ETH,MEX,2020.0,1,2,-1
CHE,TUN,2002.0,3,2,1
ARE,IRQ,2015.0,1,1,0
NOR,POL,2005.0,1,2,-1
AUT,MEX,2021.0,1,4,-3
ISL,DEU,2009.0,5,2,3
ITA,SYR,2020.0,2,1,1
PAK,TWN,2020.0,6,4,2
ZWE,IND,2017.0,1,1,0
EGY,IND,2020.0,8,13,-5
KWT,ARE,2020.0,2,4,-2
UKR,ESP,2003.0,2,2,0
JPN,COL,2010.0,3,1,2
IRN,HUN,2013.0,2,2,0
GBR,LBN,2009.0,5,5,0
FIN,PAK,2022.0,2,2,0
MEX,DNK,2012.0,3,3,0
WSM,USA,2018.0,1,2,-1
ITA,ETH,2016.0,1,1,0
CMR,IDN,2018.0,1,2,-1
DNK,KOR,2010.0,2,4,-2
BLR,ITA,1999.0,1,1,0
CYP,GBR,1999.0,1,3,-2
CHN,AUT,1997.0,1,1,0
CHE,ISR,2007.0,5,7,-2
PAN,POL,1999.0,1,1,0
BEL,CYP,2014.0,1,1,0
FRA,SGP,2022.0,6,13,-7
NLD,SRB,2008.0,1,1,0
MYS,DNK,2015.0,1,5,-4
RUS,TUR,2000.0,1,1,0
POL,HRV,2019.0,2,3,-1
THA,MYS,2019.0,3,9,-6
ISR,DNK,2014.0,2,3,-1
ETH,THA,2013.0,1,1,0
MYS,CHN,2002.0,2,3,-1
DJI,FRA,2004.0,1,1,0
KOR,BLR,2019.0,1,2,-1
SRB,ALB,2018.0,1,3,-2
NLD,QAT,2021.0,1,1,0
KAZ,ESP,2016.0,2,1,1
URY,CHL,2001.0,1,2,-1
ISL,DNK,2020.0,6,5,1
SWE,HRV,2010.0,3,2,1
FRA,GUY,2003.0,1,1,0
UZB,USA,2003.0,2,2,0
LTU,FIN,2011.0,1,3,-2
ARG,FIN,2015.0,1,1,0
MAR,PRT,2015.0,1,1,0
ITA,DZA,2016.0,3,1,2
NOR,SRB,2022.0,1,1,0
KOR,TUR,2022.0,4,3,1
TUN,BEL,2003.0,1,2,-1
DEU,LIE,2011.0,3,4,-1
HKG,AUT,2019.0,2,2,0
ALB,SRB,2014.0,3,5,-2
DEU,GEO,2017.0,3,4,-1
AUS,PHL,2003.0,2,7,-5
JPN,HUN,2013.0,5,2,3
FRA,HRV,2020.0,5,4,1
FIN,THA,2011.0,2,1,1
ROU,PRT,2005.0,1,3,-2
CAN,IRN,2000.0,4,6,-2
AUS,RUS,2005.0,6,8,-2
GAB,FRA,2002.0,2,12,-10
ZAF,COL,2011.0,2,1,1
URY,FRA,2014.0,1,5,-4
UGA,NOR,2003.0,3,1,2
SWE,SAU,2013.0,5,2,3
CZE,ROU,2014.0,1,4,-3
GHA,DEU,2009.0,1,3,-2
SWE,IRN,2004.0,2,1,1
IDN,BRA,2006.0,1,1,0
UKR,BLR,2013.0,1,1,0
BRA,MYS,2014.0,1,2,-1
DEU,BOL,2010.0,2,1,1
THA,LAO,2014.0,1,1,0
BGR,BEL,2018.0,1,2,-1
USA,SYR,2009.0,2,4,-2
HRV,CZE,2003.0,3,2,1
CMR,JPN,2007.0,1,2,-1
PER,CAN,2021.0,3,1,2
SGP,BEL,2013.0,3,3,0
ISR,UKR,2013.0,1,1,0
CHE,DNK,2000.0,6,5,1
MMR,IND,2018.0,1,3,-2
NLD,BEN,2020.0,1,2,-1
LTU,ITA,2008.0,4,4,0
SAU,DEU,2000.0,3,2,1
LAO,FRA,2014.0,2,2,0
USA,GAB,2008.0,1,2,-1
ARG,BEL,2013.0,3,3,0
TWN,MYS,2015.0,6,3,3
ARE,NLD,2019.0,2,8,-6
ESP,GRC,2001.0,6,6,0
HKG,IDN,2021.0,1,1,0
SWE,POL,2000.0,3,8,-5
AUT,IND,2005.0,5,5,0
KOR,COL,2015.0,1,1,0
NLD,HKG,2003.0,2,1,1
CZE,ISR,2009.0,1,1,0
FRA,AGO,2005.0,1,1,0
ETH,CAN,2013.0,2,3,-1
DNK,IRL,2002.0,2,1,1
CZE,GRC,2006.0,1,1,0
KEN,BEL,2016.0,5,7,-2
BLR,FRA,2012.0,2,3,-1
TUR,MEX,2012.0,1,2,-1
BGR,USA,1997.0,4,1,3
SRB,BGR,2018.0,1,1,0
EGY,MEX,2011.0,2,1,1
HKG,ESP,2013.0,1,2,-1
GEO,KAZ,2019.0,1,1,0
SWZ,CHE,2016.0,1,3,-2
NOR,COL,2013.0,1,2,-1
MEX,TWN,2019.0,1,1,0
IDN,MYS,2001.0,2,2,0
FRA,GAB,2000.0,2,6,-4
DEU,TJK,2019.0,1,2,-1
NOR,PAK,2017.0,3,2,1
ZAF,CHL,2013.0,1,1,0
FJI,GBR,2009.0,1,1,0
KWT,PAK,2012.0,1,1,0
ESP,CYP,2013.0,4,2,2
MDA,FRA,2019.0,1,2,-1
GAB,FRA,2005.0,3,1,2
JPN,CHL,2021.0,2,1,1
BTN,BGD,2020.0,1,1,0
CAN,UZB,2020.0,1,1,0
MYS,PRT,2022.0,1,1,0
AUS,FJI,2002.0,1,2,-1
PRT,TUN,2018.0,2,3,-1
TUR,KGZ,2014.0,2,1,1
SVN,ESP,2008.0,3,2,1
USA,BLR,2011.0,1,5,-4
LTU,CHN,2018.0,1,1,0
PRT,CPV,2015.0,2,2,0
CRI,AUS,2016.0,1,2,-1
IRL,BEL,2003.0,3,2,1
PRT,BGR,2006.0,1,2,-1
MYS,BGD,2004.0,2,1,1
AGO,FRA,2005.0,1,1,0
SVK,POL,2007.0,2,3,-1
NZL,SGP,1997.0,1,3,-2
QAT,MAR,2015.0,1,1,0
PRY,JPN,2003.0,1,2,-1
UKR,TWN,2003.0,1,1,0
FRA,JOR,2014.0,3,1,2
THA,AUT,2003.0,2,5,-3
HUN,ITA,2004.0,4,4,0
POL,ESP,2006.0,4,9,-5
GHA,BRA,2015.0,1,1,0
NOR,BRA,2019.0,3,10,-7
PAK,NOR,2013.0,3,6,-3
PRT,NZL,2014.0,2,3,-1
JPN,EST,2022.0,1,2,-1
CHN,BGR,2010.0,1,1,0
SGP,NZL,2003.0,1,4,-3
SGP,ITA,2018.0,2,14,-12
MEX,JPN,2013.0,5,4,1
CHE,GMB,2013.0,1,1,0
ZAF,ISR,2000.0,1,2,-1
EST,NOR,2003.0,1,2,-1
SVK,NLD,2003.0,2,5,-3
BOL,USA,2014.0,3,5,-2
CHN,LKA,2013.0,1,3,-2
AUS,TLS,2017.0,1,1,0
SYR,DEU,2020.0,1,3,-2
AUT,SGP,2004.0,1,1,0
PHL,CAN,2008.0,1,2,-1
BLR,UKR,2017.0,2,3,-1
JPN,SDN,2015.0,1,1,0
GRC,BGR,2004.0,2,1,1
ARE,NLD,2017.0,2,4,-2
BEL,NPL,2012.0,1,3,-2
NGA,TUR,2017.0,4,4,0
KEN,ZWE,2018.0,1,2,-1
PRT,RUS,2007.0,2,8,-6
SGP,SWE,2022.0,5,3,2
CAN,BHR,2008.0,1,1,0
PRI,BRA,2018.0,1,1,0
FIN,POL,2004.0,2,2,0
PER,AUT,2014.0,1,1,0
SRB,AUS,2007.0,2,2,0
ZMB,CHE,2010.0,1,1,0
LUX,BRA,2013.0,1,2,-1
PRT,CYP,2020.0,1,1,0
SAU,OMN,2015.0,3,4,-1
IRN,ARM,2019.0,1,1,0
MAR,ZAF,2021.0,1,5,-4
NOR,PAK,2019.0,1,3,-2
URY,NLD,2014.0,1,1,0
PNG,USA,2020.0,1,3,-2
MAR,AUT,2009.0,1,1,0
MLT,CHE,2017.0,1,2,-1
IRL,TUR,2004.0,1,1,0
FIN,IRL,2000.0,2,1,1
GBR,SEN,2004.0,1,1,0
RUS,TWN,2010.0,1,6,-5
CHE,ISL,2008.0,1,1,0
SYR,GBR,2013.0,1,9,-8
CHL,DNK,2021.0,1,2,-1
BEL,CMR,2000.0,1,1,0
ISL,NZL,2022.0,1,1,0
VNM,IDN,2022.0,1,2,-1
FIN,IRN,2006.0,1,1,0
ZAF,BWA,2006.0,1,4,-3
FRA,SRB,2013.0,3,4,-1
NPL,CHN,2014.0,1,4,-3
SVK,ESP,2012.0,1,2,-1
CHN,ARG,2014.0,1,1,0
PHL,ESP,2017.0,2,2,0
MMR,USA,2022.0,2,1,1
PRT,MAC,2020.0,2,1,1
CHN,BGR,2017.0,1,1,0
AUT,KAZ,2019.0,1,1,0
LKA,NLD,2017.0,1,1,0
CZE,HRV,2011.0,1,2,-1
IRN,EGY,2019.0,1,1,0
IND,IDN,2013.0,2,2,0
BMU,USA,2016.0,1,1,0
TWN,BRA,2016.0,1,2,-1
ITA,SVK,2020.0,1,3,-2
JPN,TUN,2012.0,1,1,0
MEX,MAR,2002.0,1,2,-1
PER,FRA,2002.0,1,2,-1
VEN,BRA,2003.0,1,9,-8
FJI,IND,2003.0,1,1,0
LKA,JPN,2001.0,1,1,0
THA,MYS,2017.0,2,12,-10
ALB,TUR,2019.0,1,2,-1
TUR,NOR,2006.0,1,2,-1
ZMB,CHE,2017.0,1,3,-2
DEU,UZB,2012.0,1,3,-2
PRY,MEX,2019.0,1,2,-1
ISR,ARG,2003.0,2,2,0
CAN,SVN,2012.0,1,1,0
AUS,TLS,2019.0,1,2,-1
RUS,HKG,2015.0,1,2,-1
CRI,COL,2020.0,1,1,0
ROU,PRT,2002.0,1,1,0
KEN,IRL,2022.0,1,1,0
JAM,IND,2020.0,1,1,0
FRA,CAN,2010.0,257,233,24
ESP,USA,2005.0,249,275,-26
NZL,USA,2013.0,117,114,3
ARG,ESP,2017.0,56,86,-30
CHE,CAN,2013.0,66,86,-20
NLD,TUR,2014.0,17,22,-5
DEU,CHE,2011.0,645,371,274
AUS,ITA,2012.0,25,36,-11
AUS,RUS,2002.0,6,13,-7
DEU,CZE,2018.0,54,59,-5
TWN,USA,2011.0,255,288,-33
GBR,AUT,2004.0,25,34,-9
MYS,AUS,2008.0,28,21,7
SWE,JPN,2005.0,27,23,4
BRB,JAM,2016.0,1,1,0
FRA,NLD,2012.0,106,99,7
CHN,ZAF,2018.0,8,10,-2
DEU,POL,2007.0,50,74,-24
BGR,GBR,2017.0,12,3,9
CAN,NZL,2021.0,19,21,-2
TWN,FRA,2012.0,13,17,-4
KOR,CAN,2020.0,61,27,34
FRA,SVN,2020.0,7,1,6
CHN,CZE,2019.0,21,8,13
ITA,FRA,2021.0,242,264,-22
BEL,SAU,2018.0,7,2,5
OMN,GBR,2014.0,6,13,-7
AUS,GHA,2018.0,11,19,-8
GBR,MYS,2007.0,80,28,52
BEL,ESP,2018.0,51,70,-19
ISR,GBR,2021.0,51,48,3
AUS,FIN,2021.0,18,12,6
BRA,ISR,2016.0,3,5,-2
ITA,SWE,2011.0,40,27,13
MWI,GBR,2022.0,7,4,3
EST,GBR,2020.0,4,7,-3
CHN,EGY,2018.0,18,20,-2
BEL,CHE,2022.0,34,23,11
BOL,BEL,2018.0,1,2,-1
RUS,HUN,2016.0,1,2,-1
CHE,USA,1999.0,184,127,57
BRA,ARG,2022.0,10,9,1
FRA,KHM,2012.0,6,5,1
SGP,RUS,2007.0,3,1,2
BRA,FIN,2011.0,3,2,1
FRA,LBY,2012.0,1,2,-1
PAK,BEL,2017.0,4,1,3
PAK,DNK,2018.0,5,5,0
TUR,PRT,2018.0,4,6,-2
GHA,HKG,2020.0,3,2,1
SVK,CZE,2011.0,40,19,21
DEU,NGA,2011.0,6,3,3
JOR,DEU,2004.0,4,6,-2
POL,UKR,2006.0,11,14,-3
TUN,FRA,2006.0,57,61,-4
GBR,GHA,2006.0,8,5,3
ZAF,CHE,2007.0,9,3,6
SWE,CHN,2008.0,41,49,-8
SWE,FRA,2008.0,48,39,9
SVK,BEL,2002.0,4,1,3
FIN,LUX,2008.0,3,1,2
ETH,KEN,2001.0,3,1,2
CAN,CHL,2009.0,8,11,-3
FRA,GLP,2020.0,6,10,-4
FIN,ESP,2004.0,3,3,0
DNK,POL,1997.0,3,3,0
KEN,GBR,2018.0,21,27,-6
CAN,IND,2009.0,50,84,-34
UKR,CHE,2003.0,3,2,1
COL,NLD,2014.0,6,6,0
SRB,ESP,2009.0,1,2,-1
HKG,MAC,2013.0,18,2,16
BEL,TUR,2010.0,6,7,-1
CAN,CZE,2014.0,9,5,4
TUN,CAN,2017.0,9,9,0
ISR,NLD,2019.0,24,12,12
FRA,NZL,2010.0,13,9,4
AUS,ZAF,2002.0,20,29,-9
COL,CHL,2015.0,19,25,-6
JPN,BGD,2007.0,34,24,10
CRI,MEX,2008.0,1,3,-2
CYP,USA,2012.0,4,21,-17
ESP,POL,1999.0,3,2,1
ISL,NLD,2021.0,3,2,1
NOR,BRA,2017.0,6,4,2
HKG,DNK,2018.0,5,3,2
DEU,ARE,2021.0,13,4,9
MOZ,USA,2015.0,4,8,-4
LBY,QAT,2014.0,3,1,2
GBR,CYP,1999.0,3,1,2
KOR,CHE,2003.0,7,11,-4
GMB,UGA,2007.0,1,2,-1
ERI,IND,2010.0,2,2,0
TUR,FRA,2015.0,12,17,-5
SGP,FRA,2021.0,17,24,-7
CHE,NZL,2019.0,9,5,4
RUS,IRL,2019.0,3,3,0
MYS,ESP,2020.0,3,1,2
PAK,PRT,2018.0,3,1,2
EST,CHE,2013.0,2,1,1
DEU,BOL,2019.0,2,1,1
ATG,IND,2020.0,1,2,-1
UKR,FRA,2001.0,10,4,6
AUT,GRC,2003.0,3,4,-1
FRA,CZE,2002.0,10,18,-8
JAM,GBR,2002.0,1,2,-1
TWN,THA,2003.0,2,1,1
NZL,CHL,2019.0,5,5,0
USA,ZMB,2018.0,4,7,-3
SAU,NGA,2021.0,5,8,-3
CMR,PAK,2020.0,1,1,0
NGA,KEN,2019.0,5,4,1
POL,EST,2020.0,3,1,2
SDN,CHN,2019.0,7,11,-4
NOR,ISR,2001.0,1,1,0
FRA,BGR,2020.0,4,1,3
SVK,DEU,1998.0,4,8,-4
MYS,SGP,2008.0,11,14,-3
NZL,NOR,2013.0,4,3,1
TUR,MYS,2020.0,2,13,-11
HRV,CAN,2001.0,2,3,-1
KHM,USA,2013.0,1,2,-1
SGP,BRN,2007.0,1,1,0
DEU,CUB,2021.0,2,3,-1
SGP,MAC,2013.0,1,1,0
POL,HRV,2017.0,5,1,4
PSE,USA,2005.0,3,4,-1
BEL,PRT,2014.0,7,12,-5
TUR,KAZ,2022.0,2,3,-1
UZB,KOR,2018.0,2,2,0
SWE,ISR,2010.0,2,3,-1
JPN,ISR,2004.0,2,7,-5
BRA,UZB,2008.0,1,1,0
CAN,DZA,2004.0,1,3,-2
SWE,ISR,2019.0,2,5,-3
NOR,CZE,2011.0,1,6,-5
TUN,CAN,2010.0,3,7,-4
HRV,DEU,2022.0,4,1,3
USA,IRN,2000.0,3,4,-1
FJI,JPN,2002.0,2,1,1
CAN,KWT,1999.0,2,1,1
ROU,AUT,2005.0,1,1,0
BRN,AUS,2021.0,1,1,0
PNG,CHE,2006.0,1,3,-2
AUT,SVN,2008.0,5,4,1
ARG,NLD,2022.0,4,2,2
LBN,SAU,2019.0,3,3,0
GHA,ZAF,2006.0,2,4,-2
MEX,SAU,2018.0,3,1,2
PRT,CHN,2001.0,2,1,1
DEU,BLR,2021.0,1,4,-3
NOR,ZAF,2009.0,2,2,0
DEU,CMR,2003.0,1,3,-2
DEU,BGD,2004.0,3,2,1
PRT,ZAF,2021.0,2,1,1
CHN,BLR,2016.0,1,1,0
SWE,NGA,2012.0,2,1,1
SAU,LBN,2008.0,1,5,-4
SWE,EGY,2008.0,1,2,-1
NOR,BRA,2010.0,2,6,-4
BGD,SGP,2012.0,2,5,-3
SAU,BGD,2013.0,1,6,-5
FRA,MDA,2008.0,2,1,1
JPN,HRV,2013.0,1,2,-1
GHA,CYP,2021.0,1,1,0
FIN,EGY,2017.0,1,4,-3
CZE,SGP,2015.0,1,2,-1
,USA,2002.0,85930,0,85930
,USA,2005.0,82072,0,82072
ESP,,2008.0,4192,0,4192
,DNK,2004.0,1761,0,1761
DNK,,2023.0,9983,0,9983
FIN,,2024.0,15450,0,15450
ARM,,2019.0,129,0,129
,CHN,2007.0,86110,0,86110
ZAF,,2011.0,653,0,653
,AUS,2016.0,9702,0,9702
BGR,,2012.0,274,0,274
GBR,,2006.0,7382,0,7382
,RUS,1998.0,12452,0,12452
,AUT,1994.0,2106,0,2106
,RUS,1997.0,5948,0,5948
,OMN,2001.0,88,0,88
GHA,,2021.0,414,0,414
AUT,,2022.0,4816,0,4816
,DNK,1996.0,1001,0,1001
,TUR,2006.0,6106,0,6106
ARM,,2010.0,63,0,63
,CAN,2011.0,12268,0,12268
RUS,,2006.0,3376,0,3376
,HRV,2000.0,1102,0,1102
,IRN,2014.0,12305,0,12305
EGY,,2016.0,1151,0,1151
ROU,,2016.0,1252,0,1252
,NGA,2009.0,1669,0,1669
,POL,2008.0,5015,0,5015
,THA,2010.0,2476,0,2476
CAN,,2007.0,4038,0,4038
NOR,,2003.0,211,0,211
,SRB,2012.0,1204,0,1204
,PAK,2000.0,827,0,827
PAK,,2011.0,521,0,521
,KWT,2006.0,166,0,166
KOR,,2007.0,3234,0,3234
BRA,,2025.0,494,0,494
ETH,,2024.0,5375,0,5375
ZAF,COG,2012.0,1,0,1
,SVK,1998.0,912,0,912
,MAC,2004.0,31,0,31
LKA,,2008.0,23,0,23
GEO,,2013.0,66,0,66
,NOR,2011.0,1854,0,1854
PRI,,2021.0,190,0,190
,VEN,2006.0,738,0,738
,LKA,2003.0,129,0,129
URY,,2013.0,84,0,84
FRA,KAZ,2014.0,4,0,4
,THA,2017.0,2859,0,2859
GRC,ARE,2012.0,5,0,5
,SVK,1997.0,469,0,469
,EGY,1995.0,628,0,628
THA,ETH,2009.0,1,0,1
,IRQ,2009.0,392,0,392
,MNG,2010.0,59,0,59
,MLT,2015.0,91,0,91
SVK,,2008.0,287,0,287
,AZE,2010.0,118,0,118
,MYS,1999.0,704,0,704
,SGP,2016.0,2229,0,2229
,ETH,2011.0,503,0,503
,CMR,2009.0,294,0,294
,LBY,2010.0,42,0,42
QAT,,2022.0,468,0,468
,MAR,2016.0,1474,0,1474
PRT,NPL,2017.0,1,0,1
ARM,,2017.0,94,0,94
,SVN,2016.0,491,0,491
,NPL,2012.0,269,0,269
,THA,2019.0,1700,0,1700
DEU,LBY,2018.0,1,0,1
NOR,GEO,2014.0,1,0,1
,BFA,2011.0,111,0,111
,ZAF,2015.0,2618,0,2618
CHN,ETH,2013.0,2,0,2
,CIV,1999.0,90,0,90
,GHA,2014.0,564,0,564
MNG,,2024.0,329,0,329
,SYR,2012.0,118,0,118
OMN,,2021.0,202,0,202
,MKD,2013.0,181,0,181
POL,,2006.0,1308,0,1308
,GIN,2011.0,13,0,13
LBY,,2004.0,8,0,8
,EST,2016.0,246,0,246
GAB,,2022.0,44,0,44
,AZE,2017.0,195,0,195
TUN,CAN,2019.0,12,0,12
PHL,ITA,2020.0,2,0,2
MWI,KEN,2021.0,2,0,2
,GMB,2006.0,20,0,20
GRD,,2012.0,6,0,6
,TJK,2018.0,32,0,32
LSO,,2024.0,41,0,41
,TTO,2018.0,32,0,32
HKG,,2018.0,1257,0,1257
,GUF,2015.0,17,0,17
,SDN,2006.0,77,0,77
TZA,,2012.0,60,0,60
LVA,ESP,2013.0,1,0,1
PRT,HUN,2021.0,4,0,4
,BTN,2006.0,4,0,4
GIN,,2016.0,12,0,12
,DOM,1998.0,6,0,6
MDV,,2023.0,11,0,11
DEU,SAU,1998.0,2,0,2
TUR,,2007.0,1082,0,1082
CHN,ESP,2000.0,1,0,1
BHR,KWT,2022.0,2,0,2
,MNG,2017.0,83,0,83
KEN,COD,2020.0,2,0,2
SYC,,2024.0,24,0,24
GHA,CZE,2019.0,1,0,1
NOR,MKD,2019.0,1,0,1
EGY,HKG,2016.0,2,0,2
,FRO,2016.0,9,0,9
TUN,GBR,2003.0,2,0,2
USA,NCL,2005.0,1,0,1
NGA,DNK,2014.0,8,0,8
,LBY,2017.0,31,0,31
LVA,GBR,2009.0,1,0,1
,MOZ,2006.0,31,0,31
IRN,LUX,2020.0,3,0,3
ITA,ARE,2016.0,17,0,17
CPV,BRA,2019.0,1,0,1
LAO,AUS,2017.0,2,0,2
BFA,CMR,2005.0,1,0,1
ZWE,COG,2008.0,2,0,2
MKD,ESP,2011.0,1,0,1
BWA,,2015.0,34,0,34
BIH,,2007.0,25,0,25
GBR,PRY,2006.0,1,0,1
ZAF,MYS,2011.0,3,0,3
,BHS,2006.0,5,0,5
BHS,,2015.0,4,0,4
KWT,IRN,2008.0,1,0,1
GLP,,2009.0,5,0,5
AUT,ETH,2002.0,2,0,2
CRI,,2005.0,16,0,16
ISL,,2008.0,35,0,35
FIN,NZL,2012.0,2,0,2
MAR,,1999.0,6,0,6
IND,SDN,2009.0,2,0,2
FRA,NER,2004.0,7,0,7
ESP,MLI,2007.0,1,0,1
BEL,MLI,2009.0,1,0,1
,BIH,1995.0,3,0,3
MDA,ITA,1999.0,1,0,1
AGO,FRA,2002.0,1,0,1
KOR,EGY,2014.0,7,0,7
SWZ,,2015.0,4,0,4
DZA,ITA,1999.0,1,0,1
GRC,LBN,2010.0,2,0,2
PNG,,2005.0,11,0,11
SRB,TUR,2005.0,3,0,3
MDA,FRA,2010.0,2,0,2
,HTI,2007.0,2,0,2
CAF,,2011.0,2,0,2
MCO,,2013.0,9,0,9
KWT,PNG,1999.0,1,0,1
PNG,,2002.0,2,0,2
CAN,BFA,2006.0,2,0,2
VNM,BEL,2003.0,2,0,2
GBR,LKA,1998.0,1,0,1
,DOM,1997.0,2,0,2
BLR,NLD,1999.0,1,0,1
ARE,OMN,1999.0,2,0,2
UKR,ITA,2000.0,1,0,1
ZAF,GRD,2016.0,1,0,1
SGP,CZE,2009.0,2,0,2
CHL,URY,2010.0,3,0,3
JAM,,2006.0,13,0,13
VNM,GBR,1999.0,7,0,7
CUB,ARG,2005.0,2,0,2
CRI,DEU,2012.0,8,0,8
LKA,DEU,2017.0,3,0,3
MDA,CAN,2016.0,2,0,2
SWE,BGR,2005.0,2,0,2
CZE,AFG,2007.0,1,0,1
USA,YEM,2009.0,1,0,1
ISL,NOR,2012.0,10,0,10
CMR,NCL,2016.0,1,0,1
,SLV,2000.0,7,0,7
YEM,DZA,2018.0,1,0,1
CIV,MLI,2015.0,2,0,2
CHN,CZE,2010.0,2,0,2
GIN,SEN,2015.0,3,0,3
LKA,SGP,2020.0,2,0,2
,JAM,2009.0,39,0,39
SWE,LBY,2008.0,2,0,2
SYR,EGY,2011.0,1,0,1
,SMR,2008.0,1,0,1
LVA,CRI,2015.0,1,0,1
TZA,ROU,2021.0,1,0,1
BEL,IDN,2014.0,5,0,5
ZWE,TZA,2017.0,1,0,1
LSO,BWA,2003.0,2,0,2
USA,SMR,2011.0,1,0,1
SLB,GBR,2015.0,2,0,2
OMN,BGD,2020.0,3,0,3
BGR,KOR,2018.0,1,0,1
AUS,MAC,2005.0,2,0,2
GUF,CAN,2019.0,2,0,2
TLS,,2019.0,5,0,5
RUS,NZL,1999.0,2,0,2
SDN,,2005.0,10,0,10
NIC,,2005.0,5,0,5
CAN,TTO,2006.0,1,0,1
TWN,SRB,2007.0,1,0,1
,GNB,2000.0,7,0,7
HUN,SGP,2009.0,4,0,4
TTO,FRA,2009.0,1,0,1
,BEN,2008.0,61,0,61
UKR,BEL,2011.0,3,0,3
SVK,PRT,2007.0,2,0,2
,MNG,2019.0,45,0,45
HKG,SRB,2001.0,2,0,2
,GUY,2011.0,10,0,10
CZE,PRT,2016.0,6,0,6
ARG,POL,2018.0,1,0,1
CHL,URY,2017.0,8,0,8
,COD,2013.0,9,0,9
SAU,MAC,2020.0,1,0,1
NZL,LKA,2015.0,3,0,3
QAT,CHN,2022.0,2,0,2
GHA,FIN,2021.0,1,0,1
DNK,IDN,2022.0,2,0,2
NGA,MEX,2021.0,1,0,1
YEM,SAU,2010.0,1,0,1
ISR,TUR,2012.0,7,0,7
SEN,CAN,2007.0,3,0,3
LKA,CHE,2006.0,1,0,1
FIN,KOR,2002.0,2,0,2
MLI,,2007.0,5,0,5
MYS,CHN,2005.0,2,0,2
MLI,TCD,2012.0,1,0,1
PRY,,2012.0,11,0,11
AZE,TWN,2012.0,3,0,3
AUS,TLS,2010.0,1,0,1
FIN,TUN,2010.0,1,0,1
CAN,KAZ,2012.0,4,0,4
HKG,TUR,2012.0,1,0,1
SWZ,GBR,2019.0,1,0,1
PRT,EGY,2021.0,2,0,2
POL,JOR,2016.0,1,0,1
BEL,RWA,2021.0,2,0,2
CAN,TZA,2018.0,1,0,1
MEX,BLR,1999.0,1,0,1
NLD,ISL,2019.0,5,0,5
TUN,ARE,2019.0,6,0,6
ARE,GRC,2006.0,1,0,1
CHE,BIH,2021.0,2,0,2
,MAC,1996.0,2,0,2
AUS,ROU,2014.0,2,0,2
,AIA,2017.0,3,0,3
CPV,ESP,2022.0,1,0,1
GBR,UZB,2020.0,1,0,1
BMU,GBR,2009.0,1,0,1
ESP,GNQ,2010.0,1,0,1
MAR,CHL,2009.0,1,0,1
RUS,JAM,2003.0,1,0,1
ISR,MEX,1999.0,2,0,2
MAC,BEL,2008.0,1,0,1
NZL,BGD,2001.0,1,0,1
MYS,TTO,2017.0,1,0,1
NLD,SYC,2003.0,1,0,1
,LBY,2019.0,35,0,35
PHL,CHN,2017.0,3,0,3
GRC,PRT,2006.0,1,0,1
SEN,MRT,2016.0,3,0,3
ARM,ITA,2009.0,1,0,1
,MMR,2004.0,12,0,12
KAZ,IND,2011.0,1,0,1
ZAF,SAU,2022.0,2,0,2
IRN,VNM,2019.0,14,0,14
DEU,AGO,2018.0,1,0,1
ITA,CMR,2008.0,2,0,2
VGB,,2017.0,1,0,1
IRN,EGY,2017.0,1,0,1
CUB,CHN,2022.0,3,0,3
ECU,DEU,2005.0,2,0,2
CAN,GAB,2015.0,3,0,3
GEO,ITA,2006.0,2,0,2
GBR,GUY,2003.0,1,0,1
ROU,AUT,2002.0,3,0,3
GRC,UKR,2002.0,3,0,3
AUS,ECU,2002.0,3,0,3
SWE,PER,2008.0,3,0,3
PAN,CHL,2006.0,1,0,1
NGA,CMR,2004.0,4,0,4
GAB,BEN,2008.0,1,0,1
POL,YEM,2013.0,1,0,1
BGR,UKR,2001.0,4,0,4
BEL,NZL,2003.0,5,0,5
KAZ,KGZ,2011.0,2,0,2
LBN,BRA,2007.0,1,0,1
HUN,ISR,2005.0,2,0,2
KEN,MLI,2012.0,1,0,1
MTQ,,2004.0,2,0,2
SWE,SGP,2004.0,4,0,4
PRI,ECU,2014.0,2,0,2
SGP,KWT,2016.0,1,0,1
GIN,CAN,2013.0,1,0,1
DNK,URY,2014.0,1,0,1
PRY,CHL,2011.0,2,0,2
VEN,AUS,2016.0,2,0,2
ZAF,KAZ,2021.0,1,0,1
KOR,UKR,2016.0,1,0,1
SSD,,2016.0,1,0,1
GBR,BRN,2011.0,4,0,4
TTO,BRB,2015.0,1,0,1
PLW,USA,2016.0,2,0,2
ESP,ISL,2022.0,1,0,1
IND,ERI,2017.0,4,0,4
FIN,KOR,2005.0,6,0,6
KWT,BGD,2017.0,1,0,1
CYP,NGA,2019.0,1,0,1
BEL,URY,2008.0,2,0,2
LTU,RUS,2014.0,3,0,3
,AZE,2019.0,78,0,78
UKR,SGP,2006.0,2,0,2
CZE,KAZ,2002.0,2,0,2
KGZ,UZB,2010.0,2,0,2
BLR,PRT,2007.0,1,0,1
IRL,SEN,2002.0,1,0,1
CAN,MAC,2014.0,1,0,1
,DMA,2004.0,2,0,2
COD,,2012.0,4,0,4
,SOM,2014.0,2,0,2
POL,ALB,2020.0,1,0,1
SEN,MEX,2000.0,1,0,1
CHE,NGA,2012.0,2,0,2
ZAF,TUR,2009.0,1,0,1
BEL,KEN,2005.0,1,0,1
BGR,LUX,2001.0,1,0,1
AUS,EGY,2001.0,1,0,1
MEX,TTO,2014.0,1,0,1
PAN,VEN,2007.0,1,0,1
VEN,PAN,2012.0,2,0,2
IRN,NZL,2008.0,1,0,1
CHN,BIH,2005.0,1,0,1
,LIE,2000.0,2,0,2
,MMR,1996.0,1,0,1
URY,AUS,2004.0,2,0,2
TUN,ARE,2017.0,3,0,3
TJK,,2009.0,6,0,6
,PRK,2006.0,1,0,1
TLS,,2017.0,6,0,6
NZL,SGP,1998.0,1,0,1
AND,PRT,2012.0,1,0,1
TLS,PRT,2019.0,1,0,1
ZAF,PRI,2001.0,1,0,1
VEN,JPN,2013.0,1,0,1
MEX,EGY,2019.0,3,0,3
IRN,AFG,2013.0,1,0,1
IND,UZB,2007.0,1,0,1
MNP,USA,2018.0,1,0,1
BWA,UGA,2020.0,2,0,2
BEN,CMR,2003.0,1,0,1
GBR,LTU,1999.0,1,0,1
EST,POL,2008.0,2,0,2
PAK,EGY,2015.0,3,0,3
CHN,MUS,2016.0,2,0,2
DEU,BOL,2017.0,1,0,1
NZL,HRV,2022.0,1,0,1
DEU,TJK,2017.0,1,0,1
SEN,NOR,2016.0,1,0,1
MDA,FIN,2018.0,1,0,1
TUR,PSE,2020.0,5,0,5
MOZ,GBR,2015.0,1,0,1
NLD,ZWE,2017.0,2,0,2
PHL,BGD,2013.0,2,0,2
COL,SWE,2013.0,3,0,3
CHE,GHA,2006.0,1,0,1
CUB,AUT,2008.0,1,0,1
BEL,THA,2014.0,4,0,4
AFG,JPN,2014.0,1,0,1
TUN,AUS,2015.0,1,0,1
POL,IRQ,2019.0,3,0,3
IND,BWA,2021.0,5,0,5
HUN,MAR,2022.0,1,0,1
ARM,DNK,2010.0,1,0,1
JOR,TWN,2010.0,1,0,1
ISR,MKD,2018.0,1,0,1
ECU,NLD,2011.0,1,0,1
TUR,ROU,2010.0,1,0,1
AUT,ETH,2005.0,1,0,1
TUR,COL,2019.0,2,0,2
IRN,QAT,2003.0,1,0,1
SAU,BLR,2014.0,1,0,1
MLT,CHE,2010.0,1,0,1
MNG,KAZ,2011.0,1,0,1
FRA,BWA,2005.0,1,0,1
MWI,USA,2000.0,1,0,1
SRB,GRC,2005.0,1,0,1
SGP,TUR,1998.0,1,0,1
HKG,POL,2006.0,2,0,2
ITA,TWN,2006.0,3,0,3
DNK,UGA,2015.0,1,0,1
ZWE,IND,2010.0,1,0,1
GTM,DOM,2012.0,1,0,1
BEN,SEN,2008.0,1,0,1
JPN,AZE,2005.0,1,0,1
ZAF,CZE,1997.0,1,0,1
MEX,TWN,2010.0,3,0,3
ESP,PHL,2012.0,1,0,1
GBR,MUS,2011.0,1,0,1
CZE,GEO,2006.0,2,0,2
IRN,PRT,2008.0,2,0,2
MAR,CHE,2018.0,1,0,1
ERI,ITA,2010.0,1,0,1
FIN,IND,2000.0,1,0,1
LAO,DNK,2021.0,2,0,2
LIE,MEX,2020.0,1,0,1
COL,URY,2005.0,1,0,1
PHL,OMN,2012.0,1,0,1
TUR,BIH,2003.0,1,0,1
ROU,YEM,2007.0,1,0,1
PHL,SWE,2015.0,1,0,1
EST,MDA,2012.0,1,0,1
UGA,TCD,2019.0,1,0,1
USA,KHM,2005.0,2,0,2
BIH,ALB,2018.0,2,0,2
NPL,KOR,2003.0,1,0,1
BFA,MWI,2004.0,1,0,1
PHL,KOR,2003.0,2,0,2
TUR,COL,2010.0,1,0,1
IDN,BTN,2021.0,1,0,1
CIV,AUS,2008.0,1,0,1
PRY,ARG,2013.0,2,0,2
KAZ,AUT,2015.0,2,0,2
PER,NLD,2018.0,1,0,1
,AIA,2010.0,1,0,1
ESP,UZB,2021.0,1,0,1
RUS,IRQ,2013.0,1,0,1
MAR,DNK,2020.0,1,0,1
GMB,BEN,2017.0,1,0,1
ARE,LUX,2017.0,1,0,1
CHL,AGO,2019.0,1,0,1
MEX,ARE,2022.0,1,0,1
SVK,NZL,2008.0,1,0,1
IRN,KOR,2006.0,1,0,1
UZB,KGZ,2003.0,1,0,1
ISR,HKG,2015.0,2,0,2
PSE,BEL,2016.0,1,0,1
BEL,PER,2012.0,1,0,1
UKR,BHR,2019.0,1,0,1
SAU,ARG,2010.0,1,0,1
IDN,,2001.0,3,0,3
HKG,MMR,2018.0,1,0,1
KOR,SVN,2016.0,1,0,1
FIN,HRV,2016.0,1,0,1
MLI,DEU,2016.0,1,0,1
NGA,ARE,2018.0,2,0,2
FJI,HKG,2009.0,1,0,1
MMR,AUS,2013.0,1,0,1
SRB,LVA,2011.0,1,0,1
MYS,GMB,2021.0,1,0,1
NZL,RWA,2021.0,1,0,1
JPN,KHM,2022.0,3,0,3
POL,SVN,2003.0,1,0,1
IRL,FJI,2013.0,1,0,1
IDN,HRV,2010.0,1,0,1
RUS,AZE,2022.0,2,0,2
IRQ,NOR,2021.0,1,0,1
NLD,GHA,2018.0,2,0,2
TUR,PAK,2004.0,1,0,1
,MCO,2018.0,4,0,4
KOR,GEO,2017.0,1,0,1
DEU,MDG,2022.0,1,0,1
ROU,MDA,2003.0,1,0,1
EGY,ZMB,2009.0,1,0,1
RUS,LUX,2015.0,1,0,1
SAU,ZAF,2005.0,1,0,1
CZE,UKR,1999.0,1,0,1
BTN,,2008.0,2,0,2
LVA,RUS,1999.0,2,0,2
SMR,,2008.0,1,0,1
UGA,RWA,2009.0,2,0,2
TUR,GHA,2011.0,1,0,1
FIN,SVN,2020.0,1,0,1
NER,CIV,2009.0,1,0,1
GRC,LBN,2019.0,1,0,1
BRA,COG,2012.0,1,0,1
UZB,AUS,2012.0,1,0,1
UKR,MYS,2016.0,1,0,1
AUS,TZA,2015.0,1,0,1
SRB,NPL,2019.0,1,0,1
DNK,ZMB,2017.0,1,0,1
TUR,SGP,2022.0,1,0,1
NGA,DZA,2022.0,1,0,1
MNP,MEX,2018.0,1,0,1
CHE,EST,2003.0,1,0,1
PAK,BGD,1998.0,1,0,1
TUN,KOR,2002.0,1,0,1
UGA,ITA,2004.0,1,0,1
RUS,IRL,2017.0,3,0,3
GBR,YEM,2008.0,2,0,2
GLP,BRA,2003.0,1,0,1
PAK,MUS,2007.0,1,0,1
ZAF,WSM,2003.0,1,0,1
SWE,MTQ,2017.0,1,0,1
HUN,NZL,2011.0,1,0,1
CAN,SRB,2012.0,1,0,1
DZA,CHE,2005.0,1,0,1
ARG,JPN,2021.0,2,0,2
GRC,CHN,2011.0,2,0,2
CZE,JOR,2008.0,1,0,1
BTN,SWE,2007.0,1,0,1
PRT,PER,2012.0,1,0,1
BIH,AUT,2012.0,1,0,1
NLD,MWI,2016.0,1,0,1
TWN,PRT,2012.0,1,0,1
NLD,ZMB,2015.0,2,0,2
BDI,BEL,1998.0,1,0,1
CRI,,2002.0,2,0,2
THA,KOR,1999.0,1,0,1
IRL,TUN,2014.0,1,0,1
ITA,ISL,2007.0,1,0,1
GUY,BRA,2002.0,1,0,1
SWZ,USA,2014.0,2,0,2
NZL,EST,2022.0,1,0,1
MEX,TWN,2017.0,1,0,1
IDN,KEN,2007.0,1,0,1
KAZ,PHL,2021.0,1,0,1
SEN,CIV,2003.0,1,0,1
BLR,EST,2013.0,1,0,1
MYS,MDA,2007.0,1,0,1
FIN,KWT,2009.0,1,0,1
FLK,CHL,2008.0,1,0,1
EST,LVA,2009.0,1,0,1
FLK,ECU,2011.0,1,0,1
SYR,RUS,1998.0,1,0,1
ARM,DNK,2019.0,2,0,2
COL,ARM,2010.0,1,0,1
JOR,IND,2010.0,2,0,2
HKG,ARG,2006.0,1,0,1
CMR,BRA,2016.0,2,0,2
,SSD,2016.0,1,0,1
SWE,TZA,1999.0,2,0,2
CHN,ROU,2007.0,1,0,1
PER,FRA,2005.0,2,0,2
USA,NER,2012.0,2,0,2
IND,FJI,2022.0,1,0,1
CUB,JOR,2011.0,1,0,1
TUN,BEN,2016.0,1,0,1
MDG,GUF,1999.0,1,0,1
VEN,ECU,2001.0,1,0,1
NIC,,2002.0,2,0,2
THA,OMN,2012.0,1,0,1
PER,JPN,2012.0,1,0,1
NIC,SWE,2012.0,1,0,1
AGO,EGY,2008.0,1,0,1
ESP,SYC,2011.0,1,0,1
PSE,EGY,2001.0,1,0,1
AUS,SEN,2009.0,1,0,1
JPN,MDG,2012.0,1,0,1
CHN,KHM,2009.0,1,0,1
YEM,LBN,2012.0,1,0,1
BIH,CHE,2017.0,1,0,1
IRN,VNM,2017.0,1,0,1
CHN,TGO,2016.0,1,0,1
JPN,BRN,2021.0,1,0,1
ERI,IND,2019.0,1,0,1
ESP,IRQ,2020.0,2,0,2
ETH,ISR,2017.0,1,0,1
EST,KAZ,2022.0,1,0,1
VEN,BOL,2009.0,1,0,1
GAB,BEL,2015.0,1,0,1
GHA,ARE,2020.0,1,0,1
LKA,POL,2020.0,1,0,1
NGA,PAK,2007.0,1,0,1
AGO,USA,2020.0,1,0,1
NIC,PRI,2020.0,1,0,1
NLD,ISL,2017.0,1,0,1
JPN,BOL,2002.0,1,0,1
ITA,BHR,2019.0,1,0,1
UGA,FRA,2016.0,1,0,1
MRT,DEU,2016.0,1,0,1
FJI,TON,2021.0,1,0,1
PHL,RUS,2016.0,1,0,1
BTN,CHE,2017.0,1,0,1
NLD,MLT,2005.0,1,0,1
KAZ,SWE,2015.0,1,0,1
USA,MCO,2015.0,1,0,1
IND,PSE,2008.0,2,0,2
NLD,ISL,2010.0,1,0,1
MNG,AUS,2009.0,1,0,1
,SUR,2000.0,1,0,1
NZL,IDN,2000.0,1,0,1
GBR,URY,2015.0,1,0,1
SDN,ZAF,2002.0,1,0,1
RUS,OMN,2021.0,1,0,1
COG,MAR,2012.0,1,0,1
CMR,UGA,2022.0,1,0,1
,VGB,2014.0,1,0,1
LKA,MYS,2009.0,1,0,1
ETH,MAR,2021.0,1,0,1
USA,NIC,2016.0,1,0,1
NIC,ITA,2017.0,1,0,1
KEN,POL,2008.0,1,0,1
POL,GRL,2012.0,1,0,1
CHE,TJK,2020.0,1,0,1
GBR,BIH,2009.0,1,0,1
COG,SWE,2020.0,1,0,1
IND,PNG,2011.0,2,0,2
SVN,MEX,2018.0,1,0,1
CMR,BEN,2001.0,1,0,1
BLR,IRN,2008.0,1,0,1
KOR,BLR,2017.0,1,0,1
BHR,AUS,2008.0,1,0,1
HUN,CMR,2014.0,1,0,1
BFA,COM,2007.0,1,0,1
ETH,BRA,2003.0,1,0,1
ARE,PSE,2020.0,1,0,1
IRQ,CAN,2018.0,1,0,1
SVK,DNK,2004.0,1,0,1
BGR,FIN,2018.0,1,0,1
AFG,GBR,2015.0,1,0,1
ARG,NOR,2022.0,1,0,1
PRI,GBR,2013.0,1,0,1
QAT,HUN,2020.0,1,0,1
,AIA,2019.0,1,0,1
SVK,PRI,2001.0,1,0,1
IND,EST,2015.0,1,0,1
NZL,TON,2009.0,1,0,1
SRB,SGP,2018.0,1,0,1
IDN,RUS,2021.0,1,0,1
BRA,ISL,2019.0,1,0,1
SRB,CZE,2007.0,1,0,1
CHE,BGD,2016.0,1,0,1
BHS,CHE,2021.0,1,0,1
SWE,USA,2008.0,189,151,38
KOR,USA,2010.0,646,859,-213
GBR,FRA,2008.0,315,379,-64
ROU,USA,2009.0,20,31,-11
ITA,USA,2013.0,540,325,215
FRA,CAN,2018.0,310,254,56
BGD,USA,2003.0,12,11,1
ITA,JPN,2013.0,21,14,7
USA,KOR,2005.0,637,533,104
EGY,USA,2006.0,38,72,-34
USA,DEU,2012.0,1117,1110,7
FIN,POL,2014.0,4,12,-8
BRA,USA,2008.0,335,234,101
GBR,CHE,2014.0,270,260,10
KOR,USA,2019.0,685,738,-53
ESP,DEU,2011.0,143,148,-5
CAN,AUT,1999.0,6,1,5
NGA,ZAF,2006.0,9,6,3
ZAF,GBR,2012.0,69,100,-31
THA,USA,2019.0,96,201,-105
ESP,CHE,2003.0,31,25,6
FRA,AUT,2003.0,18,20,-2
DEU,DNK,2000.0,24,14,10
THA,USA,2010.0,112,169,-57
BEL,ESP,2017.0,35,78,-43
GBR,NLD,2012.0,176,218,-42
SAU,USA,2008.0,30,50,-20
TUN,JPN,2009.0,1,1,0
CAN,GBR,2021.0,278,277,1
USA,RUS,2004.0,180,251,-71
BEL,USA,2014.0,193,127,66
JPN,USA,1999.0,537,434,103
CAN,SWE,2012.0,43,32,11
BEL,CHE,2016.0,66,64,2
GBR,SVN,2006.0,2,4,-2
ESP,FRA,2006.0,132,130,2
DEU,CAN,2020.0,164,148,16
THA,USA,2017.0,105,204,-99
SWE,GBR,2020.0,135,186,-51
EGY,CHN,2007.0,2,2,0
RUS,SWE,2010.0,12,15,-3
CAN,ISR,2009.0,36,46,-10
USA,CAN,1997.0,123,163,-40
POL,CAN,2005.0,15,7,8
DEU,USA,2000.0,552,333,219
KEN,GBR,2017.0,26,22,4
AUS,FRA,2004.0,31,31,0
KWT,CAN,2019.0,9,17,-8
NLD,ZWE,2018.0,2,3,-1
USA,CAN,1998.0,193,294,-101
FRA,TUR,2013.0,13,12,1
NZL,USA,2008.0,83,112,-29
CHE,CAN,2008.0,79,74,5
CHN,DEU,2011.0,217,184,33
PRT,ESP,2008.0,42,46,-4
CAN,EGY,2009.0,21,15,6
POL,ITA,2007.0,18,12,6
ITA,AUT,2005.0,20,16,4
USA,JOR,2012.0,42,32,10
AUS,BRA,2010.0,10,33,-23
POL,DEU,2010.0,64,62,2
ESP,ARG,2017.0,86,56,30
ISR,NLD,2018.0,10,11,-1
DEU,AUS,2018.0,171,139,32
GBR,TWN,2013.0,41,22,19
ITA,IRN,2018.0,19,43,-24
PRT,CHE,2019.0,17,14,3
DEU,ESP,2000.0,42,38,4
RUS,AZE,2016.0,9,4,5
ARG,ESP,2018.0,73,66,7
TUR,CHE,2019.0,24,14,10
RUS,GBR,2014.0,35,40,-5
KWT,CAN,2010.0,5,7,-2
EGY,BEL,2016.0,3,7,-4
IND,FJI,2016.0,5,1,4
PAK,AUS,2018.0,41,19,22
CAN,NOR,2021.0,20,10,10
LKA,AUS,2011.0,8,9,-1
AUS,AUT,2009.0,13,20,-7
POL,DEU,2019.0,69,69,0
AUS,CHN,2022.0,265,178,87
IND,POL,2016.0,12,8,4
AUT,SVN,2013.0,3,9,-6
CHL,FRA,2011.0,21,24,-3
MWI,GBR,2016.0,13,11,2
CHN,HKG,2021.0,643,746,-103
AUT,USA,2022.0,42,43,-1
AUS,TUR,2015.0,10,5,5
MYS,AUS,2013.0,91,96,-5
DNK,BEL,2021.0,15,13,2
CHN,IND,2019.0,55,252,-197
DEU,CZE,2017.0,47,53,-6
RUS,POL,2017.0,11,8,3
ESP,CZE,2017.0,19,13,6
RUS,USA,2018.0,152,145,7
TUR,SGP,2016.0,9,3,6
NLD,SWE,2003.0,35,36,-1
IDN,NZL,2020.0,1,5,-4
GBR,ITA,2022.0,219,156,63
USA,KAZ,2014.0,21,4,17
DEU,HRV,2010.0,14,11,3
MEX,EGY,2018.0,3,1,2
CHN,EGY,2019.0,27,40,-13
MNG,JPN,2012.0,4,3,1
DNK,CRI,2016.0,1,1,0
TUR,KAZ,2016.0,8,2,6
GTM,MEX,2015.0,1,1,0
IRN,SWE,2021.0,45,11,34
PAK,GBR,2021.0,63,46,17
AUS,GHA,2019.0,8,13,-5
PAK,TUR,2011.0,3,5,-2
CHE,CHN,1998.0,3,1,2
NLD,CHE,2018.0,96,84,12
CAN,LBN,2013.0,11,6,5
DEU,CZE,2019.0,62,57,5
CAN,TUR,2021.0,11,33,-22
GBR,BEL,2018.0,100,152,-52
USA,IRL,2000.0,12,22,-10
SWE,FRA,2013.0,39,69,-30
HUN,SWE,2022.0,2,2,0
FRA,URY,2019.0,4,2,2
AUS,BRA,2019.0,21,61,-40
CHN,CHE,2021.0,47,74,-27
USA,PRI,2018.0,59,107,-48
NLD,GHA,2017.0,11,4,7
KOR,AUS,2006.0,18,17,1
GBR,BWA,2020.0,2,2,0
CHN,ISR,2021.0,32,31,1
DNK,IND,2021.0,10,23,-13
IRN,GBR,2021.0,74,15,59
JPN,LKA,2020.0,11,2,9
KAZ,POL,2018.0,4,6,-2
ARE,CAN,2020.0,18,31,-13
DEU,TWN,2022.0,15,8,7
CHN,KOR,2018.0,113,210,-97
TWN,IND,2021.0,32,72,-40
PRT,BRA,2022.0,53,75,-22
IND,MEX,2019.0,14,8,6
IRN,PRT,2013.0,12,2,10
PRT,CHE,2017.0,19,16,3
PRT,NLD,2020.0,27,20,7
IND,KOR,2014.0,177,113,64
USA,THA,2022.0,55,47,8
DNK,DEU,2002.0,47,65,-18
USA,ECU,2008.0,10,7,3
CAN,ROU,2012.0,9,3,6
RUS,CAN,2005.0,25,10,15
CHE,NZL,2018.0,11,19,-8
JPN,BEL,2004.0,10,10,0
TUR,EGY,2021.0,7,2,5
BEL,ITA,2016.0,54,90,-36
JPN,KOR,2015.0,119,80,39
RUS,FIN,2014.0,22,15,7
POL,DEU,2017.0,88,70,18
BGR,BEL,2019.0,3,3,0
SWE,TUR,2007.0,4,2,2
DEU,HUN,2013.0,30,40,-10
ESP,VEN,2015.0,22,17,5
ESP,AUS,2011.0,36,13,23
HKG,ZAF,2014.0,2,1,1
CAN,SVK,2009.0,2,2,0
AUS,USA,2002.0,496,388,108
ESP,BEL,2009.0,21,37,-16
IRN,DNK,2010.0,7,2,5
VEN,DEU,2012.0,2,2,0
BWA,NGA,2011.0,2,1,1
DNK,DEU,2005.0,42,48,-6
SRB,MKD,2009.0,3,12,-9
CAN,FIN,2012.0,23,15,8
CHE,NOR,2011.0,6,11,-5
ISR,FRA,2010.0,20,17,3
SRB,NLD,2021.0,4,2,2
BRA,FRA,2003.0,44,71,-27
KEN,PER,2019.0,3,1,2
SRB,BIH,2009.0,7,8,-1
ARE,EGY,2013.0,13,7,6
DEU,UKR,2022.0,4,5,-1
UGA,USA,2015.0,23,16,7
DEU,HKG,2013.0,7,8,-1
POL,GBR,2016.0,80,44,36
GBR,PRT,2007.0,38,33,5
SGP,ITA,2010.0,3,3,0
NGA,MYS,2012.0,22,11,11
CHN,FRA,2004.0,22,41,-19
CHE,AUS,2004.0,31,31,0
SWE,RUS,2001.0,13,38,-25
RUS,SWE,2019.0,16,14,2
DNK,FRA,2004.0,13,21,-8
GBR,ESP,1998.0,39,43,-4
SWE,FIN,2000.0,8,23,-15
THA,IND,2019.0,8,15,-7
VEN,ESP,2012.0,30,15,15
IRN,DNK,2017.0,14,5,9
JPN,CHE,2001.0,15,11,4
CHE,AUT,2007.0,36,41,-5
DEU,BEL,2018.0,99,117,-18
NZL,CAN,2015.0,37,40,-3
KEN,GBR,2019.0,20,26,-6
CAN,RWA,2020.0,2,1,1
CAN,CZE,2004.0,7,5,2
BEL,GRC,2016.0,9,22,-13
MEX,CHL,2010.0,8,10,-2
IND,MEX,2017.0,23,10,13
FRA,ISL,2022.0,4,1,3
IDN,AUS,2020.0,31,64,-33
CHN,IND,2017.0,39,171,-132
AUT,FRA,2003.0,20,18,2
AUS,TWN,2006.0,9,5,4
ITA,SAU,2019.0,13,11,2
AUS,OMN,2017.0,5,3,2
USA,ETH,2022.0,7,13,-6
DEU,NLD,1997.0,16,26,-10
RUS,HUN,2022.0,1,2,-1
SWE,IRL,2005.0,5,1,4
GBR,AUT,2014.0,64,75,-11
NOR,GBR,2021.0,32,95,-63
FRA,MAR,2002.0,54,47,7
FRA,MAR,2005.0,51,40,11
IDN,SGP,2020.0,7,5,2
NLD,DNK,2018.0,44,31,13
DEU,LUX,2005.0,6,4,2
HKG,DEU,2021.0,17,10,7
PAK,FRA,2015.0,7,28,-21
KOR,NLD,2009.0,6,4,2
SVN,SRB,2014.0,1,4,-3
JOR,USA,2016.0,31,59,-28
USA,ARE,2004.0,15,5,10
USA,HND,2021.0,5,3,2
EGY,DEU,2020.0,39,38,1
MEX,CHE,2012.0,5,5,0
ISR,FRA,2019.0,28,27,1
PRT,AUS,2013.0,11,6,5
RUS,NLD,1999.0,14,6,8
USA,TZA,2007.0,7,6,1
JPN,ESP,2011.0,14,17,-3
IDN,USA,2016.0,16,31,-15
PHL,CAN,2013.0,5,4,1
TUR,CHE,2010.0,8,12,-4
CHE,TUR,2013.0,17,9,8
CMR,DEU,2009.0,4,1,3
PHL,IDN,2014.0,1,1,0
MAR,CAN,2011.0,5,7,-2
SGP,PHL,2006.0,5,3,2
SWE,EGY,2013.0,7,3,4
CHE,ROU,2008.0,4,5,-1
ISR,AUS,2014.0,17,12,5
DEU,MDG,2016.0,2,1,1
ARG,BRA,2018.0,20,38,-18
ESP,CUB,2011.0,14,30,-16
FRA,NER,2014.0,2,4,-2
TUN,SAU,2009.0,14,2,12
BRA,GBR,2005.0,31,44,-13
GRC,ROU,2009.0,4,4,0
SVK,USA,2002.0,16,10,6
EGY,SAU,2006.0,47,38,9
DEU,SVK,2006.0,17,9,8
ITA,FIN,2007.0,5,9,-4
SGP,SWE,2016.0,9,15,-6
IND,AUT,2000.0,2,1,1
SWE,SAU,2008.0,4,1,3
NPL,USA,2009.0,10,3,7
FRA,URY,2017.0,6,1,5
HUN,BGR,2002.0,3,1,2
GBR,ROU,2002.0,7,10,-3
USA,UKR,2015.0,11,24,-13
RUS,SWE,2017.0,19,10,9
SVK,USA,2005.0,20,12,8
CAN,AUS,1999.0,28,29,-1
DEU,COL,2001.0,1,5,-4
DEU,ISR,2002.0,41,33,8
ESP,FIN,1999.0,4,2,2
HRV,ITA,1998.0,1,2,-1
IND,TWN,2003.0,36,16,20
RUS,CAN,2002.0,29,15,14
USA,MYS,2003.0,19,11,8
FRA,AUS,2000.0,6,8,-2
USA,BIH,2017.0,2,1,1
GUF,FRA,2013.0,19,13,6
ZWE,USA,2001.0,16,2,14
NLD,POL,2002.0,8,12,-4
DEU,CZE,2010.0,28,29,-1
SAU,JOR,2006.0,3,6,-3
USA,HUN,2012.0,42,57,-15
UKR,GBR,2012.0,9,14,-5
DEU,ISR,2005.0,20,37,-17
ZMB,ZWE,1999.0,1,1,0
POL,SVK,2015.0,8,3,5
NOR,ISL,2004.0,3,2,1
SAU,AUS,2007.0,3,6,-3
FRA,MDA,2013.0,2,1,1
ITA,SAU,2017.0,22,3,19
ITA,CZE,2007.0,8,8,0
LVA,SWE,2017.0,5,5,0
USA,PER,1999.0,2,4,-2
POL,RUS,2009.0,12,6,6
SGP,BEL,2008.0,3,1,2
BRA,GBR,2002.0,38,59,-21
FRA,PRT,2007.0,28,15,13
FRA,CHN,2000.0,7,15,-8
GRC,DEU,2002.0,25,39,-14
ECU,USA,2005.0,5,2,3
GBR,ESP,1997.0,29,20,9
RUS,CHN,1999.0,2,4,-2
USA,IDN,2021.0,21,23,-2
RUS,JPN,2006.0,17,20,-3
RUS,IND,2001.0,2,6,-4
CAN,QAT,2007.0,6,1,5
NPL,JPN,2008.0,3,8,-5
ROU,ESP,2004.0,3,2,1
SWE,ZAF,2002.0,5,5,0
SVK,AUT,2001.0,8,5,3
SWE,AUT,2017.0,15,29,-14
FRA,CMR,2001.0,7,9,-2
NZL,AUS,1998.0,22,20,2
NZL,CHE,2021.0,5,7,-2
CZE,POL,2001.0,6,4,2
ETH,DNK,2002.0,2,1,1
CHL,USA,1999.0,18,17,1
GBR,ARG,1998.0,4,4,0
UKR,AUT,2014.0,5,2,3
GBR,MLT,2005.0,3,1,2
ARE,AUT,2020.0,2,2,0
SVN,GBR,2008.0,9,4,5
MEX,COL,2008.0,11,8,3
LUX,FRA,2022.0,7,10,-3
AUT,SWE,1998.0,2,1,1
ARE,LBN,2020.0,1,6,-5
SRB,ITA,2006.0,9,6,3
RUS,MEX,1998.0,9,4,5
KOR,NZL,2009.0,2,6,-4
AUT,JPN,2007.0,11,7,4
KOR,HKG,2002.0,2,3,-1
JPN,SGP,2001.0,13,7,6
IND,AUS,1999.0,9,5,4
CAN,URY,2016.0,5,2,3
FRA,KOR,2003.0,6,1,5
AUS,ESP,2002.0,8,13,-5
ARE,USA,2009.0,11,45,-34
RUS,UZB,2006.0,5,5,0
CYP,SWE,2019.0,1,3,-2
ITA,RUS,2020.0,14,22,-8
URY,ESP,2008.0,11,6,5
GRC,DEU,2005.0,19,31,-12
BEL,SAU,2017.0,9,2,7
SEN,FRA,2006.0,24,29,-5
KEN,GBR,2010.0,18,16,2
USA,CZE,2006.0,45,47,-2
HUN,NOR,2012.0,5,2,3
CZE,ESP,2011.0,5,7,-2
USA,GUM,2012.0,5,5,0
ETH,ESP,2010.0,1,2,-1
USA,LBN,2011.0,30,42,-12
ISR,FRA,2017.0,28,37,-9
EST,FIN,2011.0,7,10,-3
GBR,JAM,2008.0,2,1,1
FRA,SAU,2009.0,6,2,4
NZL,ITA,2007.0,2,4,-2
SDN,CHN,2018.0,8,16,-8
SWE,ZAF,2005.0,3,3,0
MEX,ARG,2009.0,9,8,1
HRV,FRA,2016.0,6,7,-1
LTU,USA,2015.0,5,6,-1
CHE,TWN,2015.0,6,7,-1
DEU,LTU,2008.0,8,8,0
IRL,TUR,2014.0,5,2,3
DNK,GRL,2008.0,7,3,4
GRC,DNK,2018.0,8,4,4
FRA,URY,2010.0,2,2,0
KWT,EGY,2020.0,12,10,2
CHL,URY,2018.0,3,3,0
NPL,IND,2009.0,27,27,0
CAN,TZA,2017.0,1,1,0
SWE,IRN,2014.0,13,35,-22
IRL,PRT,2019.0,6,11,-5
GBR,ZWE,2020.0,3,7,-4
LBN,CAN,2011.0,10,3,7
PRT,AUT,2017.0,12,2,10
ARG,NLD,2016.0,4,4,0
COL,ARG,2012.0,10,7,3
EGY,BHR,2015.0,3,2,1
GBR,IRN,2020.0,32,102,-70
BEL,TUR,2018.0,10,9,1
SGP,ITA,2019.0,9,6,3
RUS,SAU,2015.0,3,1,2
EST,SWE,2015.0,10,3,7
VNM,AUS,2016.0,21,24,-3
AUS,BRA,2017.0,24,48,-24
TUN,CAN,2018.0,6,9,-3
LIE,AUT,2020.0,1,2,-1
TWN,CHE,2008.0,6,2,4
SVN,USA,2021.0,3,12,-9
RUS,NGA,2016.0,1,1,0
JOR,DEU,2014.0,5,13,-8
KOR,ITA,2021.0,9,4,5
FIN,KAZ,2020.0,1,2,-1
BEL,SAU,2019.0,6,1,5
YEM,SAU,2018.0,8,5,3
ITA,SVN,2022.0,3,4,-1
TUR,CHE,2017.0,13,11,2
HUN,JOR,2021.0,3,2,1
EGY,YEM,2021.0,3,3,0
HKG,BEL,2021.0,2,1,1
DEU,BGD,2014.0,10,5,5
CAN,LUX,2021.0,3,2,1
UZB,KOR,2019.0,3,3,0
JPN,MYS,2007.0,16,9,7
GBR,VEN,2013.0,3,2,1
GRC,AUS,2016.0,13,4,9
ITA,AUT,2002.0,15,11,4
USA,FIN,2001.0,61,63,-2
FIN,GBR,2004.0,28,40,-12
ECU,ESP,2022.0,20,16,4
BRA,DEU,2000.0,10,20,-10
MEX,BEL,2006.0,2,3,-1
SWE,CAN,2011.0,31,32,-1
SGP,AUS,1999.0,7,17,-10
HKG,MAC,2008.0,5,3,2
CHE,LVA,2021.0,2,3,-1
SEN,BFA,2015.0,3,1,2
FRA,NZL,2018.0,16,21,-5
USA,AFG,2015.0,2,4,-2
LTU,DEU,2011.0,8,4,4
PAN,BEL,2021.0,1,2,-1
CHN,SDN,2016.0,7,7,0
TUR,ROU,2018.0,2,3,-1
LBN,EGY,2009.0,1,2,-1
CZE,DEU,1999.0,10,10,0
POL,KOR,2014.0,8,2,6
IRL,PRT,2017.0,5,6,-1
NLD,BGD,2015.0,2,2,0
EGY,KWT,2022.0,5,2,3
NOR,USA,1999.0,17,19,-2
DEU,TUR,2002.0,11,8,3
DNK,NLD,2016.0,23,31,-8
RUS,POL,2010.0,4,9,-5
BGD,GBR,2014.0,12,14,-2
HRV,DEU,2016.0,21,17,4
MEX,TWN,2018.0,2,1,1
DEU,URY,2020.0,4,1,3
KEN,MYS,2020.0,2,1,1
TWN,GBR,2020.0,19,31,-12
IND,PRI,2011.0,3,3,0
MYS,BGD,2014.0,25,25,0
IRN,NZL,2013.0,10,1,9
TUR,PAK,2014.0,4,3,1
USA,COG,2006.0,2,1,1
ISR,SGP,2013.0,1,2,-1
HUN,IRN,2022.0,1,2,-1
KOR,SVN,2022.0,1,1,0
DEU,MDA,2003.0,1,2,-1
ZWE,MEX,2020.0,2,1,1
VEN,CUB,2015.0,2,3,-1
NLD,PRT,2005.0,8,7,1
AUT,GBR,2001.0,29,17,12
NOR,PAK,2018.0,3,2,1
MYS,CAN,2007.0,4,7,-3
POL,CAN,2002.0,5,6,-1
NAM,CAN,2003.0,1,1,0
ITA,SMR,2013.0,4,1,3
ESP,COL,2000.0,5,3,2
SAU,PAK,2003.0,4,4,0
BFA,FRA,2009.0,4,9,-5
KOR,IND,2009.0,41,119,-78
GBR,MLT,2002.0,3,2,1
ESP,CRI,2012.0,7,2,5
MYS,GBR,1997.0,1,3,-2
RUS,MEX,1997.0,3,1,2
NGA,CMR,2014.0,7,1,6
ARE,AUS,2003.0,2,3,-1
PHL,CHN,2018.0,8,2,6
ISL,GBR,2003.0,10,10,0
IND,KEN,2021.0,5,2,3
GEO,DEU,2020.0,5,5,0
PRT,TUN,2017.0,2,1,1
RWA,CHN,2015.0,4,2,2
FRA,SRB,2008.0,4,2,2
ITA,SAU,2010.0,4,1,3
POL,NLD,2011.0,15,22,-7
CAN,DZA,2014.0,8,1,7
RUS,NOR,2008.0,10,3,7
ZAF,ESP,2015.0,6,9,-3
SGP,ITA,2017.0,6,10,-4
JPN,PER,2014.0,1,4,-3
IND,MEX,2010.0,2,1,1
OMN,EGY,2015.0,2,5,-3
NOR,NLD,2009.0,7,24,-17
ROU,GRC,2009.0,4,4,0
HKG,FRA,2013.0,3,4,-1
FRA,VEN,2007.0,7,6,1
PRT,CHE,2010.0,8,9,-1
KOR,FRA,2006.0,9,19,-10
BGR,FRA,2011.0,6,4,2
GRC,CAN,2011.0,7,4,3
CAN,TZA,2010.0,1,2,-1
MEX,JPN,2008.0,2,3,-1
LBN,SAU,2018.0,2,1,1
DEU,HRV,2019.0,8,14,-6
CZE,EGY,2015.0,4,1,3
ITA,LUX,2014.0,10,2,8
DEU,LBY,2017.0,1,1,0
GRC,FRA,2022.0,14,13,1
ITA,PAK,2003.0,2,1,1
MYS,SGP,2013.0,13,14,-1
GBR,SEN,2014.0,2,1,1
LKA,JPN,2003.0,2,6,-4
GBR,TTO,2017.0,5,3,2
KEN,ZAF,2014.0,12,20,-8
BEL,SRB,2004.0,2,2,0
SVN,CHE,2004.0,2,1,1
DZA,JPN,2014.0,1,1,0
DNK,KOR,2018.0,2,8,-6
CHE,ARE,2020.0,4,1,3
IND,HRV,2021.0,1,1,0
ITA,ETH,2022.0,4,2,2
ZAF,BRA,2020.0,4,7,-3
MLI,CHN,2020.0,2,1,1
UKR,NLD,2021.0,3,1,2
AUT,CZE,1999.0,6,1,5
SGP,BGD,2016.0,1,3,-2
PAK,DNK,2019.0,6,1,5
BEL,PRT,2004.0,3,5,-2
SWE,IND,2004.0,7,9,-2
BEL,DZA,2014.0,4,2,2
USA,CRI,2006.0,9,10,-1
MEX,CRI,2007.0,1,3,-2
AUS,SAU,2006.0,2,7,-5
BEL,CZE,2006.0,5,1,4
CHE,ISL,2013.0,2,1,1
IRL,PRT,2010.0,5,4,1
BEN,NGA,2020.0,4,1,3
CHE,COG,2021.0,2,6,-4
IRQ,CAN,2017.0,2,2,0
USA,ZMB,2019.0,13,6,7
FRA,MLI,2021.0,4,5,-1
SWE,IRL,2002.0,6,2,4
KWT,CAN,2017.0,7,16,-9
AUS,ESP,2005.0,10,9,1
QAT,CHN,2016.0,1,2,-1
NOR,ESP,2000.0,2,3,-1
MAC,CHN,2007.0,5,2,3
IRL,NZL,2014.0,9,10,-1
GRL,DNK,2007.0,3,1,2
CHE,EST,2001.0,1,1,0
AUT,RUS,2016.0,6,10,-4
TUR,BGR,2011.0,1,2,-1
SWE,SGP,2014.0,8,9,-1
ZAF,DNK,2006.0,2,3,-1
MAR,DEU,2009.0,2,1,1
EGY,TUR,2014.0,1,2,-1
EST,GRC,2016.0,1,2,-1
SRB,GBR,2016.0,9,4,5
JPN,ISR,2014.0,3,2,1
JPN,LUX,2015.0,1,1,0
LVA,SWE,2010.0,2,5,-3
AUT,LUX,2014.0,3,1,2
LTU,GBR,2015.0,4,10,-6
QAT,FRA,2016.0,5,14,-9
POL,CZE,2012.0,10,14,-4
ZAF,SAU,2016.0,2,3,-1
HKG,DNK,2019.0,3,1,2
RUS,TWN,2018.0,3,2,1
GEO,USA,2013.0,9,14,-5
HRV,MYS,2014.0,1,1,0
THA,MYS,2018.0,3,19,-16
NOR,BRA,2018.0,6,13,-7
IRN,LBN,2020.0,1,1,0
IRQ,RUS,2021.0,2,1,1
GBR,SDN,2002.0,2,2,0
NZL,SWE,2001.0,4,2,2
LKA,GBR,2008.0,5,7,-2
ARG,POL,2017.0,1,1,0
TZA,ZAF,2021.0,4,8,-4
PSE,ESP,2017.0,3,2,1
PHL,RUS,2022.0,1,1,0
COL,GBR,2012.0,15,10,5
HUN,ITA,2014.0,6,5,1
JOR,OMN,2020.0,2,1,1
RUS,GEO,2020.0,3,2,1
RUS,IRL,2018.0,4,1,3
NLD,SRB,2013.0,4,1,3
KEN,ZWE,2010.0,1,1,0
PAN,USA,1999.0,3,1,2
GBR,ZMB,2002.0,4,4,0
QAT,JOR,2009.0,4,2,2
CZE,CAN,1998.0,3,2,1
LTU,RUS,2004.0,1,3,-2
BEL,SVK,2004.0,2,1,1
ISR,BGR,2019.0,1,1,0
ITA,BGR,2006.0,2,8,-6
BEL,IDN,2004.0,3,1,2
VEN,MEX,2006.0,3,4,-1
SWE,HRV,2018.0,1,9,-8
BGD,IRL,2005.0,1,2,-1
RUS,POL,2019.0,11,16,-5
SGP,ARG,2016.0,1,2,-1
NLD,JPN,2000.0,8,4,4
KOR,BEL,2015.0,7,7,0
GAB,DEU,2008.0,1,1,0
ITA,CHL,2004.0,2,1,1
GBR,ROU,2005.0,4,5,-1
CHE,MEX,2009.0,6,7,-1
EGY,AUT,2005.0,1,4,-3
LUX,SGP,2012.0,1,2,-1
MEX,URY,2007.0,2,1,1
CYP,SWE,2017.0,4,2,2
COL,JPN,2016.0,1,1,0
JPN,COL,2018.0,3,2,1
ISR,BEL,2012.0,3,1,2
NZL,DNK,2012.0,4,3,1
EGY,HKG,2022.0,2,2,0
DEU,GEO,2018.0,4,1,3
NZL,VNM,2019.0,5,4,1
PAK,PRT,2019.0,3,1,2
POL,IND,2020.0,7,26,-19
SLE,GBR,2021.0,1,2,-1
HUN,BEL,2006.0,5,4,1
NOR,ISR,2003.0,2,1,1
HKG,TWN,2016.0,12,14,-2
AUS,ROU,2004.0,1,1,0
SWE,ISR,2018.0,8,4,4
SRB,CHE,2009.0,2,5,-3
FRA,PHL,2020.0,4,1,3
MYS,EGY,2018.0,10,9,1
MEX,ITA,2022.0,10,1,9
SWE,HKG,2011.0,2,1,1
ITA,NGA,2003.0,4,3,1
UGA,KEN,2016.0,4,7,-3
POL,IRQ,2018.0,1,1,0
BFA,CIV,2021.0,1,1,0
NOR,PRT,2010.0,1,3,-2
CAN,UKR,2006.0,4,6,-2
VEN,PRI,2009.0,3,1,2
ESP,AND,2014.0,2,1,1
PRT,CHN,2003.0,2,5,-3
MWI,DEU,2004.0,1,2,-1
PRT,SAU,2016.0,7,1,6
FIN,TUR,2012.0,2,7,-5
SVK,NLD,2001.0,4,3,1
THA,AUT,2001.0,1,1,0
THA,FIN,2013.0,2,2,0
PAK,JPN,2004.0,2,5,-3
NIC,ESP,2012.0,3,1,2
USA,GEO,2012.0,7,13,-6
FIN,EGY,2018.0,4,4,0
NOR,PRT,2017.0,2,11,-9
THA,IDN,2014.0,3,3,0
NZL,MYS,2022.0,4,10,-6
DEU,LVA,2003.0,4,3,1
CRI,SWE,2005.0,1,1,0
VNM,NLD,2022.0,2,2,0
CAN,NGA,2021.0,4,6,-2
MDG,CAN,2022.0,1,1,0
BIH,CHE,2018.0,2,2,0
ZAF,MEX,2007.0,1,1,0
NZL,NGA,2019.0,2,4,-2
ISR,IDN,2016.0,1,1,0
BGD,DEU,2013.0,5,8,-3
SWE,AUT,2010.0,8,11,-3
PRT,AUT,2010.0,2,6,-4
HKG,IND,2011.0,6,5,1
AUT,CHL,2013.0,1,2,-1
POL,ARM,2018.0,1,1,0
BEL,BRA,1997.0,3,1,2
RUS,BLR,1998.0,4,13,-9
LBY,GBR,2009.0,1,6,-5
MEX,PAN,2015.0,2,1,1
LBN,GBR,2013.0,6,6,0
BOL,BRA,2020.0,1,3,-2
CAN,RUS,1997.0,2,7,-5
AUT,BRA,2000.0,2,2,0
UZB,KOR,2010.0,3,1,2
CHL,SWE,2002.0,2,4,-2
AUS,GHA,2010.0,4,1,3
IRL,IND,2009.0,4,16,-12
COL,SWE,2008.0,1,1,0
SRB,SVN,2005.0,1,3,-2
ESP,HKG,2000.0,1,1,0
AFG,USA,2016.0,2,1,1
BEL,ETH,2003.0,1,2,-1
THA,IND,2017.0,6,17,-11
MDA,RUS,2006.0,2,2,0
KOR,HKG,2005.0,1,10,-9
ETH,SWE,2007.0,2,2,0
NLD,TUR,2004.0,2,1,1
BEL,SGP,2011.0,6,8,-2
ARG,URY,2008.0,1,3,-2
NOR,COL,2008.0,1,1,0
BGD,BEL,2014.0,2,1,1
ZMB,ZAF,2012.0,4,2,2
MYS,IND,2000.0,1,3,-2
AUT,KOR,2014.0,1,7,-6
BGR,SWE,2011.0,2,1,1
CHE,CIV,2011.0,1,1,0
MMR,USA,2016.0,2,1,1
CHE,ARG,2009.0,2,4,-2
CUB,CHN,2016.0,2,4,-2
USA,ZWE,2007.0,2,8,-6
RUS,ZAF,2011.0,2,4,-2
OMN,CAN,2011.0,1,13,-12
CAN,RUS,1998.0,3,7,-4
SWE,SRB,2006.0,2,2,0
CRI,FRA,2006.0,2,1,1
SWE,PAK,2004.0,2,1,1
ZWE,GBR,2012.0,2,3,-1
DNK,COL,2009.0,1,2,-1
ESP,CHN,2002.0,1,1,0
DEU,LBN,2003.0,1,2,-1
NER,FRA,2008.0,2,3,-1
KOR,CHE,2001.0,2,1,1
BGR,BEL,2010.0,5,2,3
SAU,LBN,2013.0,5,5,0
NLD,HKG,2001.0,1,3,-2
BEL,DNK,2007.0,3,2,1
CZE,TWN,2017.0,2,3,-1
IDN,POL,2020.0,3,1,2
TUN,GBR,2001.0,1,2,-1
USA,LSO,2020.0,1,2,-1
BGD,JPN,1999.0,1,9,-8
NZL,CHL,2018.0,2,7,-5
GBR,TTO,2019.0,6,4,2
COL,CAN,2022.0,3,2,1
UKR,BLR,2008.0,1,4,-3
USA,GUY,2018.0,2,1,1
DNK,RUS,1999.0,2,3,-1
KEN,COL,2013.0,1,2,-1
PAK,JOR,2020.0,3,2,1
CZE,IRL,2009.0,3,1,2
PRT,TUN,2019.0,1,1,0
BRA,AUT,2009.0,3,4,-1
AUT,PRT,2006.0,1,2,-1
DEU,LUX,2002.0,1,2,-1
SYR,GBR,2008.0,2,5,-3
AUT,SGP,2014.0,2,2,0
SGP,ESP,2012.0,4,7,-3
BEN,DEU,2009.0,2,3,-1
GBR,BHR,2006.0,1,1,0
PER,NLD,2017.0,2,1,1
NZL,ZAF,2011.0,4,10,-6
SVK,ROU,2016.0,2,1,1
DNK,ISR,2016.0,2,3,-1
SWE,UGA,2012.0,2,1,1
TWN,ETH,2017.0,4,3,1
LIE,DEU,2003.0,3,2,1
SRB,ALB,2017.0,1,2,-1
IRQ,ESP,2018.0,2,1,1
UGA,ITA,2014.0,4,2,2
EGY,IRN,2015.0,1,2,-1
UZB,USA,2001.0,2,1,1
NOR,PRT,2019.0,2,12,-10
NGA,BRA,2004.0,1,1,0
MEX,VEN,2021.0,1,3,-2
EGY,LBN,2020.0,1,7,-6
ESP,THA,2016.0,2,1,1
KOR,NPL,2007.0,1,2,-1
ARG,BEL,2008.0,3,1,2
BGD,NOR,2011.0,2,1,1
JPN,KHM,2016.0,2,1,1
JOR,PAK,2009.0,1,2,-1
CAN,LTU,2020.0,1,1,0
GHA,SWE,2021.0,3,2,1
CAN,PSE,2015.0,1,1,0
ITA,ARE,2022.0,1,2,-1
MLI,GIN,2011.0,2,1,1
KOR,AUT,2003.0,1,1,0
GBR,SRB,2013.0,4,4,0
ARM,RUS,2021.0,2,1,1
BOL,BEL,2010.0,1,2,-1
BEN,SEN,2013.0,2,1,1
ESP,GRC,2003.0,1,5,-4
ROU,JPN,2009.0,1,3,-2
HUN,AUS,2006.0,2,3,-1
ARG,AUS,1998.0,1,1,0
KWT,OMN,2006.0,1,1,0
TUR,CAN,1999.0,2,1,1
NLD,POL,2005.0,3,10,-7
HUN,BGR,2005.0,2,1,1
IND,ZAF,2000.0,1,2,-1
USA,CIV,2006.0,2,1,1
OMN,CHN,2018.0,3,1,2
USA,BIH,2010.0,1,1,0
KEN,PER,2017.0,1,1,0
URY,FRA,2004.0,1,2,-1
IND,ECU,2020.0,1,1,0
HKG,DNK,2017.0,1,2,-1
THA,IND,2010.0,4,7,-3
COD,FRA,2022.0,1,1,0
MDG,CIV,2016.0,1,1,0
SVK,IRN,2022.0,1,4,-3
POL,GEO,2003.0,1,1,0
NZL,PRT,2008.0,1,1,0
IRN,BLR,2013.0,1,1,0
IRQ,CAN,2019.0,2,5,-3
NZL,PHL,2011.0,2,2,0
NLD,SVN,2014.0,1,3,-2
JPN,CUB,2004.0,1,1,0
LVA,SWE,2019.0,1,2,-1
MNP,USA,2019.0,1,1,0
SRB,SGP,2019.0,1,1,0
ITA,ALB,2007.0,2,1,1
KEN,ETH,2013.0,1,3,-2
GHA,TTO,2008.0,1,1,0
DEU,PAK,2000.0,1,1,0
QAT,SGP,2016.0,1,2,-1
LTU,FRA,2007.0,1,2,-1
AUS,ETH,2012.0,1,6,-5
ARG,ISR,2015.0,1,1,0
IRN,ARE,2021.0,1,2,-1
MEX,SAU,2019.0,4,1,3
KOR,DNK,1999.0,1,1,0
SAU,PRT,2020.0,2,1,1
GRD,USA,2012.0,4,2,2
RUS,VNM,2007.0,3,2,1
ARG,AUT,2011.0,1,1,0
LVA,DEU,2003.0,3,4,-1
RUS,MYS,2018.0,2,3,-1
AFG,IRN,2022.0,1,1,0
UKR,ESP,2001.0,2,1,1
KEN,AUS,2005.0,2,1,1
BFA,MLI,2016.0,2,2,0
ZAF,MAR,2005.0,1,1,0
IRL,SRB,2012.0,1,1,0
GBR,SYC,2016.0,1,1,0
CUB,BRA,2007.0,3,5,-2
ESP,PRY,2021.0,1,2,-1
AUS,HRV,2012.0,1,3,-2
ARE,MAR,2008.0,2,1,1
KHM,CHE,2009.0,1,1,0
NGA,BEL,2013.0,1,3,-2
JPN,HRV,2008.0,1,1,0
MMR,SGP,2016.0,1,1,0
BTN,USA,2015.0,1,1,0
AUT,TUR,2007.0,3,1,2
JPN,ROU,2000.0,1,1,0
ESP,ECU,2007.0,2,3,-1
PRI,GBR,2008.0,1,1,0
MAR,CHE,2010.0,1,1,0
COG,DEU,2011.0,1,1,0
PNG,AUS,2004.0,1,6,-5
PAN,AUS,2018.0,1,2,-1
IRQ,GBR,2006.0,1,1,0
GBR,TUN,2013.0,1,1,0
LUX,FIN,2014.0,2,2,0
SAU,ITA,2007.0,2,1,1
ARG,HND,2019.0,1,2,-1
HRV,NLD,2009.0,1,1,0
FIN,LUX,2013.0,1,1,0
DEU,BOL,2018.0,2,2,0
CHE,MYS,2015.0,1,2,-1
GRC,BGR,2014.0,2,3,-1
USA,BHS,2022.0,1,2,-1
AUS,SDN,2021.0,1,1,0
ETH,ESP,2017.0,2,1,1
HND,ESP,2020.0,2,1,1
KEN,EGY,2020.0,1,2,-1
RUS,LVA,2011.0,1,1,0
PHL,IRN,2021.0,1,2,-1
BLR,IRN,2013.0,1,1,0
LKA,DEU,2018.0,1,2,-1
HRV,ESP,2020.0,2,2,0
MAR,CHE,2019.0,1,3,-2
USA,SWZ,2020.0,3,1,2
ECU,AUT,2022.0,1,1,0
NLD,PAN,2012.0,1,1,0
RWA,CHE,2020.0,1,1,0
BEN,MAR,2008.0,1,1,0
DNK,THA,2007.0,1,1,0
UZB,KOR,2017.0,1,1,0
SDN,QAT,2013.0,1,1,0
SWE,GHA,2005.0,1,1,0
FRA,LTU,2006.0,1,1,0
ESP,IRL,2000.0,1,2,-1
JAM,DEU,2012.0,1,1,0
JOR,TWN,2018.0,1,3,-2
FIN,PAK,2016.0,1,4,-3
DNK,ARG,2000.0,1,1,0
SWE,RWA,2021.0,1,1,0
PRT,KOR,2011.0,1,9,-8
GAB,CMR,2015.0,1,2,-1
IDN,DNK,2014.0,1,2,-1
MAR,CHN,2022.0,1,5,-4
BRA,POL,2007.0,1,1,0
ISR,ROU,2012.0,1,1,0
DEU,ISL,2002.0,1,2,-1
LAO,JPN,2015.0,1,6,-5
NZL,COL,2009.0,1,2,-1
NGA,KEN,2018.0,1,2,-1
PRT,IND,2001.0,1,3,-2
THA,VNM,2002.0,1,1,0
NLD,SVK,1999.0,1,1,0
SWE,PER,2013.0,1,3,-2
ARE,DEU,2007.0,1,6,-5
CMR,ESP,2004.0,1,1,0
PAK,PRT,2017.0,1,2,-1
ARE,NLD,2018.0,1,7,-6
SWE,CHN,2013.0,49,69,-20
ITA,DEU,2009.0,183,118,65
ISR,USA,2012.0,348,314,34
ESP,ARG,2019.0,53,69,-16
ESP,ARG,2010.0,61,76,-15
ESP,CZE,2019.0,27,11,16
BEL,NLD,2015.0,132,180,-48
ZAF,USA,2000.0,24,15,9
AUS,USA,2005.0,464,376,88
SWE,DNK,2016.0,85,75,10
GRC,CYP,2004.0,5,5,0
ITA,GBR,2000.0,70,64,6
MEX,USA,2011.0,187,153,34
USA,KOR,2002.0,448,455,-7
JPN,TWN,1999.0,8,1,7
USA,HRV,2008.0,19,12,7
AUT,CHN,2015.0,17,15,2
KOR,USA,2017.0,678,766,-88
DEU,RUS,2013.0,75,90,-15
AUT,CHE,2020.0,72,62,10
USA,ESP,2003.0,296,291,5
SAU,CAN,2020.0,53,140,-87
SVN,ESP,2013.0,1,4,-3
JPN,GBR,1999.0,45,60,-15
SVK,DNK,2014.0,2,1,1
PRT,CAN,2016.0,12,8,4
CZE,PRT,2022.0,1,1,0
ISR,ITA,2015.0,9,14,-5
ROU,DEU,1999.0,9,2,7
MEX,CHL,2019.0,22,12,10
MYS,NGA,2021.0,68,21,47
CHN,SWE,2008.0,49,41,8
IRN,DNK,2019.0,39,5,34
TWN,ETH,2019.0,5,5,0
IND,CHN,2012.0,21,15,6
DEU,PRT,2021.0,31,28,3
DEU,HRV,2017.0,12,15,-3
PAK,BEL,2018.0,7,2,5
IRN,IRQ,2019.0,23,3,20
ESP,NOR,2021.0,16,14,2
IRN,IRQ,2017.0,7,3,4
SWE,AUT,2019.0,15,33,-18
LTU,SWE,2021.0,3,4,-1
CHN,ZAF,2017.0,7,12,-5
JPN,CAN,1999.0,41,43,-2
MEX,SAU,2017.0,4,1,3
KAZ,GBR,2021.0,7,8,-1
AUS,JOR,2011.0,6,5,1
FRA,TGO,2014.0,2,2,0
AUS,IDN,2003.0,12,6,6
BRA,ARG,2016.0,24,40,-16
DEU,NOR,2012.0,59,22,37
NLD,PRT,2002.0,11,6,5
UKR,USA,2004.0,43,11,32
CHN,DNK,2002.0,11,4,7
CAN,BEL,2022.0,14,20,-6
PHL,CHE,2002.0,3,2,1
DEU,NLD,1998.0,42,36,6
CHN,EGY,2017.0,12,18,-6
ZAF,AUS,2007.0,21,15,6
FRA,SGP,2016.0,35,22,13
BRA,COL,2008.0,12,5,7
SAU,GBR,2007.0,14,26,-12
FRA,UZB,2015.0,2,3,-1
ARG,POL,2010.0,2,1,1
POL,EGY,2002.0,5,1,4
HKG,USA,1999.0,33,54,-21
UKR,FRA,2003.0,14,9,5
HRV,USA,2001.0,17,8,9
SWE,CHE,2006.0,39,16,23
ARG,FRA,2007.0,11,11,0
USA,MOZ,2013.0,2,1,1
CHE,IRL,2003.0,8,7,1
MEX,BRA,1998.0,3,3,0
ITA,NOR,2006.0,11,8,3
MEX,ESP,1998.0,8,15,-7
ZAF,NZL,2011.0,10,4,6
CAN,DNK,2012.0,17,27,-10
NZL,AUS,1997.0,8,7,1
FRA,ZAF,2007.0,9,6,3
CAN,KOR,2007.0,37,37,0
CHN,EGY,2010.0,3,1,2
CHN,ZAF,2010.0,6,4,2
MEX,CAN,2012.0,34,28,6
TUR,BEL,2013.0,7,5,2
ESP,LUX,2013.0,5,1,4
USA,ZMB,2017.0,10,8,2
AUS,GHA,2017.0,6,11,-5
TZA,CHE,2020.0,8,6,2
ESP,ISR,2001.0,4,3,1
CHN,ZAF,2019.0,7,19,-12
BGD,THA,2021.0,2,1,1
CHN,IND,2010.0,5,15,-10
CHE,HUN,2001.0,10,5,5
PAN,COL,2014.0,2,2,0
AUS,OMN,2019.0,10,2,8
SWE,KEN,2020.0,3,5,-2
DNK,NOR,2009.0,25,22,3
USA,JAM,2003.0,4,4,0
GBR,SDN,2005.0,2,3,-1
NOR,KOR,2022.0,2,4,-2
NLD,CHL,2016.0,7,8,-1
GEO,RUS,2004.0,2,4,-2
GBR,TTO,2010.0,6,5,1
MTQ,FRA,1999.0,6,2,4
DJI,FRA,2014.0,3,3,0
POL,LTU,2008.0,2,3,-1
FIN,AUS,2009.0,9,7,2
ZAF,BEL,2015.0,4,14,-10
NLD,ISL,2018.0,2,3,-1
BEL,POL,2021.0,8,3,5
MAR,ITA,2020.0,6,4,2
HKG,AUT,2018.0,2,2,0
AUS,NCL,2022.0,2,1,1
BEL,MDG,2008.0,1,1,0
SRB,RUS,2000.0,6,1,5
NLD,NPL,2015.0,1,1,0
BOL,BEL,2019.0,2,3,-1
BGR,GBR,2018.0,4,5,-1
ROU,ITA,1999.0,2,3,-1
SGP,NZL,2001.0,3,1,2
RUS,BLR,1997.0,6,11,-5
SWE,EST,1999.0,2,2,0
ECU,USA,2002.0,4,5,-1
FRA,HKG,2015.0,7,7,0
PER,ESP,2003.0,3,1,2
IRN,ZAF,2017.0,6,1,5
POL,HRV,2018.0,2,1,1
NZL,EST,2016.0,1,1,0
BFA,SEN,2003.0,1,1,0
EGY,IRL,2015.0,1,2,-1
MAR,BEL,2011.0,1,11,-10
CHN,ARM,2021.0,1,1,0
PRT,AUT,2019.0,4,4,0
CYP,ARE,2020.0,1,2,-1
DZA,GBR,2012.0,3,2,1
PAK,BHR,2020.0,4,1,3
HUN,CAN,2011.0,4,2,2
ARE,HKG,2020.0,2,1,1
IND,KHM,2018.0,2,1,1
ESP,SVK,2012.0,2,1,1
ESP,HUN,2012.0,3,11,-8
MYS,GBR,1998.0,1,1,0
MEX,CUB,1998.0,3,2,1
UKR,AZE,2016.0,1,1,0
SGP,QAT,2016.0,2,1,1
NPL,NOR,2009.0,2,1,1
FRA,MYS,2022.0,3,3,0
PAK,BRN,2009.0,1,1,0
NZL,MEX,2011.0,5,2,3
LTU,ITA,2013.0,3,1,2
KAZ,USA,2012.0,2,11,-9
CHL,RUS,2011.0,1,2,-1
DEU,MNG,2021.0,1,1,0
PAK,DNK,2017.0,2,1,1
JPN,ARE,2011.0,2,1,1
ZAF,RUS,2022.0,1,2,-1
ITA,HRV,1999.0,1,3,-2
ZMB,GBR,2007.0,1,2,-1
USA,ARM,2022.0,3,3,0
PAK,IND,2004.0,2,11,-9
DNK,EST,2014.0,1,2,-1
SVN,MEX,2017.0,1,1,0
SVN,HUN,2017.0,1,1,0
BFA,CAN,2007.0,1,1,0
ISL,AUS,2019.0,2,2,0
DEU,JAM,2012.0,1,1,0
BEL,URY,2013.0,1,1,0
UKR,PRT,2006.0,1,1,0
USA,ZMB,2010.0,3,5,-2
SAU,RUS,2013.0,1,3,-2
MLI,USA,2015.0,3,3,0
ETH,AUT,2015.0,1,2,-1
JPN,HUN,2008.0,2,6,-4
NZL,NOR,2008.0,1,1,0
,IRN,2004.0,4593,0,4593
JPN,,2012.0,18648,0,18648
,FRA,1999.0,25375,0,25375
NGA,,2024.0,9752,0,9752
ROU,,2022.0,3521,0,3521
HKG,,2019.0,1367,0,1367
AUT,,2016.0,1777,0,1777
GRC,,2020.0,2523,0,2523
,DEU,2006.0,19885,0,19885
EGY,,2022.0,6181,0,6181
,BEL,2002.0,2965,0,2965
,GHA,2004.0,124,0,124
ARG,,2021.0,3730,0,3730
,GBR,1995.0,13470,0,13470
ESP,,2013.0,6331,0,6331
,ITA,2006.0,13461,0,13461
,IRL,1999.0,1361,0,1361
HKG,,2017.0,1082,0,1082
,PRT,2007.0,2456,0,2456
HKG,,2010.0,843,0,843
SVK,,2013.0,432,0,432
,BEL,2005.0,3072,0,3072
,CHE,2015.0,4542,0,4542
YEM,AUS,2005.0,1,0,1
CHL,,2015.0,825,0,825
,LTU,2015.0,475,0,475
,BRA,2011.0,20153,0,20153
MEX,,2002.0,98,0,98
CIV,,2012.0,63,0,63
TWN,,1999.0,71,0,71
,GRC,2016.0,2154,0,2154
,MEX,2012.0,5243,0,5243
LKA,,2013.0,74,0,74
,POL,2013.0,6094,0,6094
,SOM,2004.0,2,0,2
SOM,,2024.0,57,0,57
SYC,ZAF,2017.0,1,0,1
,LKA,2001.0,115,0,115
SWE,LKA,2014.0,2,0,2
VEN,,2009.0,294,0,294
,NER,1998.0,20,0,20
NLD,EGY,2011.0,5,0,5
AUT,GTM,2014.0,1,0,1
CZE,,1999.0,42,0,42
MEX,,2005.0,446,0,446
JOR,NOR,2007.0,1,0,1
JPN,ZAF,2014.0,6,0,6
NOR,,2001.0,22,0,22
,DNK,2014.0,2851,0,2851
,HUN,2011.0,1559,0,1559
,COG,2011.0,103,0,103
QAT,,2016.0,73,0,73
LBN,,2015.0,121,0,121
,LBN,2009.0,290,0,290
,KEN,2006.0,343,0,343
ITA,ATA,2019.0,1,0,1
TUR,MAC,2018.0,1,0,1
,SWZ,2011.0,10,0,10
,GTM,2012.0,46,0,46
USA,MNG,2022.0,4,0,4
,PYF,2012.0,19,0,19
SYR,,2020.0,111,0,111
HTI,,2020.0,19,0,19
,KAZ,2002.0,76,0,76
,TZA,2009.0,182,0,182
,MAC,2014.0,170,0,170
IND,IRN,2005.0,8,0,8
BEL,BEN,2020.0,2,0,2
,THA,2018.0,2655,0,2655
,BEN,2013.0,101,0,101
UKR,ISR,2021.0,2,0,2
GUM,,2023.0,19,0,19
,UGA,2015.0,329,0,329
,MMR,2014.0,51,0,51
KOR,ECU,2020.0,1,0,1
BRN,KAZ,2015.0,1,0,1
,TJK,2017.0,26,0,26
TUN,ARE,2018.0,4,0,4
,TJK,2019.0,14,0,14
DNK,,2000.0,35,0,35
,NAM,2016.0,44,0,44
,TTO,2017.0,53,0,53
,UZB,2016.0,100,0,100
,MCO,2017.0,7,0,7
YEM,USA,2020.0,1,0,1
,IRN,1996.0,235,0,235
,AZE,2018.0,166,0,166
,LBY,2018.0,78,0,78
GIN,,2022.0,31,0,31
MDG,,2020.0,66,0,66
,MNG,2018.0,63,0,63
ARM,,2018.0,107,0,107
DNK,ZMB,2018.0,1,0,1
,KAZ,2005.0,100,0,100
IRN,BRA,2013.0,5,0,5
BRN,NPL,2013.0,1,0,1
,OMN,2003.0,78,0,78
SXM,,2022.0,1,0,1
RUS,ETH,2016.0,9,0,9
RWA,LUX,2010.0,1,0,1
,ARM,2009.0,154,0,154
MYS,NOR,2011.0,2,0,2
CHE,PHL,1998.0,1,0,1
BGR,KOR,2010.0,4,0,4
MDA,DNK,2017.0,1,0,1
EST,KAZ,2016.0,2,0,2
BLR,SWE,2020.0,1,0,1
,LVA,1994.0,179,0,179
KHM,,2011.0,11,0,11
GAB,GBR,2000.0,1,0,1
NZL,VNM,2017.0,3,0,3
,MDA,1995.0,54,0,54
KEN,BEL,2022.0,5,0,5
CMR,POL,2020.0,1,0,1
MUS,,2020.0,24,0,24
BRA,EST,2022.0,1,0,1
GEO,KAZ,2018.0,2,0,2
,REU,2015.0,7,0,7
BRA,ISR,2022.0,1,0,1
PHL,SLV,2021.0,1,0,1
THA,TUR,2021.0,1,0,1
THA,POL,2020.0,1,0,1
IRN,ZAF,2019.0,13,0,13
EGY,FIN,2021.0,3,0,3
,MKD,2008.0,125,0,125
URY,,2008.0,37,0,37
,TTO,2010.0,38,0,38
CUB,AUT,2013.0,2,0,2
GEO,,2008.0,66,0,66
,RWA,2002.0,12,0,12
MDA,BEL,2012.0,1,0,1
ISL,,2013.0,47,0,47
,TJK,2010.0,21,0,21
MEX,UGA,2011.0,1,0,1
,BRN,2000.0,7,0,7
IDN,,2003.0,22,0,22
,RWA,2005.0,14,0,14
LUX,,2007.0,15,0,15
NLD,KHM,2008.0,1,0,1
KEN,SVK,2011.0,1,0,1
CHN,TUN,2002.0,1,0,1
IDN,MYS,2003.0,1,0,1
NOR,LUX,2006.0,2,0,2
MDG,CHE,2006.0,1,0,1
MDA,,2005.0,12,0,12
CUB,,1999.0,31,0,31
ZAF,AUT,2005.0,2,0,2
SEN,PAK,2000.0,1,0,1
UZB,KAZ,2013.0,6,0,6
IND,IRN,2002.0,3,0,3
FJI,AUS,2001.0,1,0,1
MDA,,2002.0,3,0,3
FIN,SRB,2002.0,1,0,1
VEN,CAN,1998.0,1,0,1
CHE,ZWE,2011.0,2,0,2
,VGB,2004.0,3,0,3
,NER,1997.0,4,0,4
CUB,PER,2006.0,6,0,6
NZL,VNM,2010.0,2,0,2
PRT,AGO,2011.0,4,0,4
UKR,HUN,2009.0,1,0,1
COL,NLD,2004.0,1,0,1
ROU,MDA,2001.0,1,0,1
UKR,GRC,1997.0,1,0,1
MTQ,,2014.0,6,0,6
BGR,ZAF,2005.0,1,0,1
PYF,,2021.0,27,0,27
POL,AUS,2007.0,7,0,7
MAC,ZAF,2012.0,1,0,1
KOR,ISR,1998.0,2,0,2
JPN,ISL,2015.0,1,0,1
ZMB,,2002.0,1,0,1
AUT,SWE,1997.0,2,0,2
MYS,BRA,2011.0,1,0,1
MMR,ESP,2020.0,1,0,1
ZAF,RWA,2008.0,2,0,2
VNM,IDN,2016.0,1,0,1
,AGO,2007.0,10,0,10
LBY,,2014.0,34,0,34
JPN,ZMB,2012.0,2,0,2
NGA,JAM,2017.0,1,0,1
AUT,PHL,2021.0,1,0,1
,COD,2008.0,4,0,4
SRB,BGR,2017.0,1,0,1
NGA,NER,2018.0,2,0,2
GMB,FRA,2011.0,1,0,1
GRC,JOR,2012.0,2,0,2
TUR,POL,2021.0,3,0,3
SSD,,2022.0,2,0,2
ESP,GTM,2020.0,2,0,2
BRA,UKR,2008.0,1,0,1
IND,GRC,2020.0,2,0,2
RWA,DEU,2021.0,3,0,3
GBR,MLI,2021.0,1,0,1
BFA,JPN,2010.0,1,0,1
DNK,TZA,2017.0,4,0,4
UKR,CHE,2001.0,7,0,7
IDN,FRA,2001.0,3,0,3
HRV,BRA,2009.0,2,0,2
AGO,COL,2008.0,3,0,3
PER,NLD,2010.0,2,0,2
AUS,RWA,2021.0,2,0,2
ALB,,2011.0,5,0,5
GHA,BFA,2007.0,3,0,3
BOL,NLD,2011.0,2,0,2
WSM,CHN,2012.0,1,0,1
FIN,PRT,2005.0,1,0,1
TUR,PRT,2017.0,3,0,3
ARG,KOR,2022.0,1,0,1
JOR,DZA,2022.0,3,0,3
JPN,EST,2016.0,1,0,1
MAR,MYS,2016.0,1,0,1
BDI,FRA,2020.0,1,0,1
FIN,ISL,2012.0,3,0,3
SRB,BGR,2019.0,1,0,1
BWA,AUS,2006.0,3,0,3
CAN,ECU,2001.0,2,0,2
LUX,CHN,2008.0,1,0,1
UKR,TUR,1998.0,4,0,4
IRL,BEL,2001.0,2,0,2
,GHA,1996.0,22,0,22
ISR,DNK,2004.0,3,0,3
AZE,SAU,2016.0,1,0,1
TWN,QAT,2020.0,1,0,1
ESP,NGA,2005.0,1,0,1
TJK,FRA,2010.0,1,0,1
NLD,GHA,2010.0,2,0,2
USA,MAC,2003.0,1,0,1
ETH,TZA,2003.0,1,0,1
ERI,,2009.0,8,0,8
AUS,GUM,2008.0,1,0,1
NCL,,2003.0,2,0,2
AUT,FJI,2016.0,1,0,1
PRI,GTM,2019.0,1,0,1
GBR,MMR,2003.0,2,0,2
BEL,MLT,2010.0,1,0,1
SRB,SGP,2017.0,1,0,1
HKG,FIN,2020.0,3,0,3
NPL,LAO,2018.0,1,0,1
SVK,MKD,2021.0,1,0,1
LTU,CHN,2019.0,4,0,4
IND,CIV,2020.0,1,0,1
PRT,ETH,2015.0,1,0,1
NGA,HUN,2018.0,1,0,1
CRI,CHE,2021.0,2,0,2
CPV,ESP,2016.0,3,0,3
LTU,BEL,2003.0,1,0,1
TUN,HUN,2020.0,2,0,2
CYP,,2006.0,9,0,9
PRT,GRC,2004.0,1,0,1
AUT,TWN,2005.0,1,0,1
DEU,LKA,2005.0,2,0,2
SRB,BGR,2010.0,1,0,1
ITA,COL,2006.0,1,0,1
CHE,ZAF,1998.0,2,0,2
TUR,JPN,2000.0,1,0,1
DEU,CHL,1999.0,4,0,4
JOR,TUN,2019.0,2,0,2
PRY,KOR,2016.0,1,0,1
ISR,MOZ,2011.0,1,0,1
,GRD,2009.0,21,0,21
UKR,NOR,2013.0,1,0,1
IRN,VNM,2018.0,3,0,3
USA,BIH,2019.0,3,0,3
GAB,,2016.0,17,0,17
SAU,BGD,2008.0,2,0,2
BLR,NOR,2005.0,3,0,3
PRT,VEN,1999.0,1,0,1
MYS,ISR,2015.0,1,0,1
KEN,IND,2013.0,3,0,3
MDA,FRA,2018.0,2,0,2
LAO,AUS,2018.0,1,0,1
ITA,AGO,2011.0,1,0,1
MCO,,2008.0,4,0,4
HKG,ESP,2008.0,1,0,1
BOL,USA,2004.0,3,0,3
IDN,TWN,2002.0,1,0,1
PHL,LAO,2009.0,1,0,1
PHL,CHE,2005.0,3,0,3
FLK,,2012.0,1,0,1
LVA,,1999.0,5,0,5
YEM,ITA,2014.0,1,0,1
IND,JOR,2004.0,3,0,3
CAN,JOR,2000.0,1,0,1
,ERI,1999.0,3,0,3
AZE,UZB,2009.0,1,0,1
DEU,SVN,2000.0,2,0,2
POL,CHL,2009.0,1,0,1
CHN,NZL,2001.0,3,0,3
GBR,LIE,2001.0,1,0,1
TWN,RUS,2021.0,2,0,2
ZAF,SGP,2001.0,2,0,2
MDA,DEU,1998.0,2,0,2
NLD,PER,2007.0,1,0,1
SAU,SGP,2006.0,1,0,1
NER,GBR,2004.0,1,0,1
UGA,OMN,2012.0,1,0,1
RUS,IRQ,2008.0,1,0,1
SVN,MEX,2010.0,1,0,1
MWI,NZL,2009.0,1,0,1
ZMB,NAM,2003.0,1,0,1
CHE,GRL,2015.0,1,0,1
DEU,LBY,2010.0,5,0,5
HUN,MLT,2015.0,1,0,1
BFA,UGA,2020.0,1,0,1
,MCO,2010.0,9,0,9
IRL,GHA,2013.0,1,0,1
BGD,NPL,2017.0,1,0,1
BEN,GBR,2016.0,1,0,1
KEN,TUR,2019.0,1,0,1
LBN,ARE,2006.0,2,0,2
NLD,GHA,2019.0,2,0,2
NOR,KGZ,2020.0,1,0,1
RWA,BFA,2009.0,1,0,1
BGR,MEX,2000.0,2,0,2
CHE,JOR,2013.0,1,0,1
ESP,VNM,2015.0,2,0,2
TUN,QAT,2013.0,3,0,3
GNQ,,2008.0,1,0,1
ROU,CAN,2015.0,4,0,4
URY,CHL,2003.0,1,0,1
CIV,MRT,2006.0,1,0,1
MEX,DOM,2007.0,2,0,2
NPL,NLD,2005.0,1,0,1
SRB,MNE,1997.0,1,0,1
USA,BOL,2022.0,1,0,1
ZAF,MLI,2005.0,1,0,1
FIN,PER,2006.0,1,0,1
IND,JAM,2011.0,2,0,2
ISL,NZL,2016.0,1,0,1
NPL,BRN,2011.0,1,0,1
BRA,MHL,2020.0,1,0,1
MKD,TUR,2015.0,2,0,2
TWN,TZA,2008.0,1,0,1
SVN,ARG,2015.0,1,0,1
ETH,CAN,2008.0,2,0,2
NZL,THA,1999.0,2,0,2
NCL,JPN,2014.0,1,0,1
AFG,DEU,2013.0,1,0,1
PRT,SYC,2013.0,1,0,1
COL,GTM,2014.0,4,0,4
CHN,UKR,2012.0,1,0,1
MMR,FIN,2016.0,3,0,3
NOR,SEN,2018.0,1,0,1
AUS,TLS,2018.0,1,0,1
KGZ,DEU,2021.0,1,0,1
IRN,SAU,2021.0,1,0,1
ETH,ARE,2020.0,1,0,1
ISL,FRA,2011.0,3,0,3
SEN,TCD,2013.0,1,0,1
LTU,CAN,2016.0,3,0,3
,TTO,2019.0,14,0,14
TWN,ZAF,2020.0,1,0,1
NZL,HKG,2001.0,2,0,2
DEU,MCO,2009.0,1,0,1
COL,NOR,2011.0,1,0,1
AUS,LBN,2003.0,1,0,1
IND,URY,2015.0,1,0,1
NCL,CAN,2006.0,1,0,1
CAN,ISL,2004.0,1,0,1
DNK,TZA,2019.0,1,0,1
WSM,USA,2017.0,1,0,1
JOR,FIN,2013.0,2,0,2
YEM,TUR,2022.0,1,0,1
KOR,SWE,2000.0,2,0,2
AUS,PHL,2001.0,7,0,7
CHN,TGO,2022.0,1,0,1
KGZ,TUR,2005.0,1,0,1
PRT,UGA,2022.0,1,0,1
FRA,MRT,1999.0,3,0,3
GRL,NOR,2005.0,1,0,1
BGD,PAK,2001.0,1,0,1
MDG,BEL,2020.0,3,0,3
ZAF,MLI,2002.0,1,0,1
NZL,NGA,2010.0,1,0,1
NZL,EGY,2020.0,3,0,3
LTU,AUT,2004.0,1,0,1
SDN,SWE,2000.0,1,0,1
ZAF,AUT,2002.0,1,0,1
CHE,MAR,2007.0,1,0,1
HRV,CZE,2001.0,2,0,2
ESP,DZA,2006.0,2,0,2
HKG,SAU,2009.0,1,0,1
BRA,TWN,2007.0,1,0,1
MDA,FIN,2019.0,1,0,1
PAK,MYS,1997.0,1,0,1
BRA,HUN,2001.0,1,0,1
ISR,NZL,2005.0,1,0,1
URY,KOR,2004.0,1,0,1
SGP,MAC,2008.0,2,0,2
ETH,ISR,2018.0,1,0,1
ESP,GLP,2014.0,1,0,1
JAM,CHE,2009.0,1,0,1
YEM,QAT,2020.0,1,0,1
BOL,GEO,2019.0,1,0,1
CUB,PRI,2011.0,1,0,1
JOR,RUS,2013.0,2,0,2
AFG,PNG,2019.0,1,0,1
PRT,ROU,1998.0,1,0,1
SWE,SVN,2001.0,2,0,2
UKR,IRL,2000.0,2,0,2
CZE,ARE,2006.0,1,0,1
TWN,SAU,2013.0,2,0,2
BRA,NOR,2006.0,3,0,3
ARG,NOR,2016.0,3,0,3
CAN,MAC,2004.0,2,0,2
THA,RUS,2009.0,1,0,1
SYR,PRT,2016.0,1,0,1
RUS,CHL,2007.0,1,0,1
CUB,GBR,2003.0,3,0,3
HRV,JPN,2002.0,1,0,1
USA,BRN,2012.0,1,0,1
ETH,UGA,2005.0,1,0,1
VEN,ISR,1998.0,1,0,1
KAZ,KOR,2012.0,1,0,1
BWA,COG,2021.0,1,0,1
BGD,KEN,2007.0,1,0,1
NLD,BLR,2018.0,1,0,1
TZA,BEN,2013.0,1,0,1
CHE,REU,2020.0,1,0,1
ARG,HND,2017.0,2,0,2
ATA,FRA,2018.0,1,0,1
GHA,IND,2007.0,1,0,1
,FSM,2012.0,1,0,1
ATG,,2023.0,2,0,2
DNK,TWN,2008.0,1,0,1
SYR,CAN,2008.0,1,0,1
TWN,BGR,2009.0,1,0,1
BEL,SAU,2010.0,1,0,1
BEL,ALB,2014.0,1,0,1
TUR,PRT,2019.0,6,0,6
ETH,LSO,2006.0,1,0,1
GRD,DEU,2011.0,1,0,1
UKR,TWN,2001.0,3,0,3
ISR,KOR,2007.0,1,0,1
HKG,SVK,2002.0,1,0,1
DZA,MDG,2020.0,1,0,1
FIN,GHA,2012.0,1,0,1
UGA,COG,2012.0,1,0,1
KOR,IRL,2000.0,1,0,1
THA,VNM,2005.0,2,0,2
CHN,ZWE,2015.0,1,0,1
BEN,PER,2008.0,1,0,1
ROU,EGY,2020.0,3,0,3
,MCO,2019.0,7,0,7
NGA,DNK,2004.0,1,0,1
BFA,TCD,2017.0,1,0,1
NPL,KOR,2001.0,1,0,1
EST,NOR,2001.0,2,0,2
GUF,MDG,2018.0,1,0,1
SRB,BHS,2016.0,1,0,1
BIH,POL,2012.0,1,0,1
BGD,PHL,2002.0,1,0,1
ESP,ISL,2016.0,2,0,2
CHN,COG,2012.0,1,0,1
UGA,FRA,2022.0,1,0,1
NLD,BGR,2016.0,3,0,3
MEX,LUX,2017.0,1,0,1
ERI,IND,2018.0,2,0,2
BGR,FIN,2010.0,1,0,1
VNM,FJI,2020.0,1,0,1
BEL,NZL,2001.0,2,0,2
MDA,GBR,2001.0,1,0,1
IND,ARG,2000.0,2,0,2
KEN,IRL,2016.0,1,0,1
VNM,BEL,2001.0,2,0,2
MUS,PAK,2020.0,1,0,1
LBN,JOR,2011.0,1,0,1
MWI,CHE,2015.0,1,0,1
BRA,BFA,2019.0,2,0,2
GTM,VEN,2013.0,1,0,1
IRN,ARM,2018.0,1,0,1
ECU,SWE,2011.0,1,0,1
TUR,ALB,2020.0,1,0,1
PLW,,2015.0,1,0,1
UKR,KEN,2018.0,1,0,1
DZA,ISR,2013.0,1,0,1
COL,ZWE,2007.0,1,0,1
TUR,PRT,2010.0,2,0,2
CRI,ECU,2014.0,1,0,1
TUR,BRA,2007.0,2,0,2
SVN,HUN,2010.0,2,0,2
CRI,PAN,2009.0,1,0,1
YEM,DZA,2010.0,2,0,2
CYP,JOR,2019.0,1,0,1
BGD,AUT,2020.0,1,0,1
MYS,ITA,2013.0,2,0,2
UKR,SVN,2015.0,1,0,1
LKA,BWA,2011.0,1,0,1
IRN,GRC,2007.0,1,0,1
CHN,KAZ,2016.0,1,0,1
CHE,LUX,2009.0,3,0,3
ITA,DZA,2022.0,3,0,3
MAR,BRA,2016.0,1,0,1
BLR,KOR,2007.0,1,0,1
TCD,ESP,2013.0,1,0,1
ISL,AUS,2017.0,1,0,1
SVN,NOR,2009.0,1,0,1
ARG,HND,2010.0,1,0,1
SRB,ARG,2014.0,1,0,1
GAB,TGO,2019.0,1,0,1
CMR,MOZ,2019.0,1,0,1
COL,NAM,2017.0,1,0,1
BRN,TZA,2018.0,1,0,1
MUS,JPN,2021.0,1,0,1
SMR,ITA,2002.0,1,0,1
SWE,ARG,2008.0,1,0,1
NPL,DNK,2011.0,1,0,1
GMB,ZAF,2009.0,1,0,1
AUS,MUS,2021.0,1,0,1
,SMR,2013.0,1,0,1
MDA,CHE,2014.0,1,0,1
ERI,ITA,2018.0,1,0,1
IRN,NPL,2013.0,1,0,1
BES,,2023.0,1,0,1
NOR,RWA,2015.0,1,0,1
USA,IRN,2023.0,1,0,1
NZL,SVN,2004.0,1,0,1
AUS,UZB,2020.0,2,0,2
IND,GHA,2012.0,1,0,1
SGP,THA,2022.0,3,0,3
GTM,COL,2020.0,2,0,2
ZMB,COD,2019.0,1,0,1
PER,NLD,2019.0,1,0,1
MLI,GBR,1999.0,1,0,1
CHE,PNG,2007.0,1,0,1
BRA,SRB,2015.0,1,0,1
THA,KHM,2008.0,1,0,1
NPL,NZL,2006.0,1,0,1
CHE,LSO,2012.0,1,0,1
NPL,ISR,2018.0,1,0,1
ZWE,KWT,2004.0,1,0,1
SWZ,NGA,2008.0,1,0,1
FRA,GUY,2001.0,1,0,1
JOR,ESP,2001.0,1,0,1
SVK,IND,2002.0,1,0,1
NLD,ISR,1997.0,1,0,1
ISR,MAR,2000.0,1,0,1
SWE,PRI,1997.0,1,0,1
POL,UZB,2003.0,1,0,1
SGP,NOR,2003.0,1,0,1
SEN,SGP,2011.0,1,0,1
IRL,SVK,2020.0,1,0,1
BTN,,2013.0,1,0,1
PHL,VNM,2011.0,1,0,1
FJI,WSM,2014.0,1,0,1
UKR,HKG,2012.0,1,0,1
KEN,PER,2010.0,1,0,1
NOR,GRL,2020.0,1,0,1
SEN,DEU,2001.0,1,0,1
AUS,GEO,2006.0,1,0,1
IRN,ZAF,2010.0,1,0,1
ISR,MYS,2011.0,1,0,1
CHE,IRQ,2020.0,1,0,1
POL,DZA,2021.0,1,0,1
LBN,SYR,2020.0,1,0,1
MMR,RUS,2015.0,1,0,1
,AIA,2018.0,1,0,1
BEL,PSE,2013.0,2,0,2
KWT,BHR,2020.0,1,0,1
MAR,TWN,2021.0,1,0,1
MEX,CUB,1997.0,1,0,1
CMR,MEX,2010.0,1,0,1
EST,NLD,2004.0,1,0,1
NZL,NGA,2017.0,1,0,1
,KIR,2018.0,2,0,2
BGR,HRV,2001.0,1,0,1
CHE,PSE,2002.0,1,0,1
SEN,TGO,2015.0,1,0,1
ITA,PAN,2011.0,1,0,1
BGD,NPL,2019.0,1,0,1
CZE,SAU,2021.0,1,0,1
WSM,USA,2019.0,1,0,1
SWE,UZB,2018.0,1,0,1
UZB,KGZ,2001.0,1,0,1
UGA,PER,2014.0,1,0,1
BEL,SYR,2009.0,1,0,1
UGA,IND,2002.0,1,0,1
ZAF,CHL,2008.0,1,0,1
HKG,MYS,1997.0,1,0,1
AUS,FLK,2002.0,1,0,1
OMN,AUT,2016.0,1,0,1
MWI,AUS,2001.0,1,0,1
BFA,GMB,2000.0,1,0,1
COL,VEN,2003.0,1,0,1
DEU,LBY,2019.0,1,0,1
VUT,TON,2020.0,1,0,1
KEN,MEX,2020.0,1,0,1
ETH,IRQ,2020.0,1,0,1
GIN,RUS,2017.0,1,0,1
LVA,ESP,2008.0,1,0,1
GUF,CAF,2005.0,1,0,1
VNM,MAC,2007.0,1,0,1
NZL,BRN,2012.0,1,0,1
CUB,IRL,2002.0,1,0,1
CHN,LKA,2008.0,1,0,1
HUN,UKR,2020.0,2,0,2
GAB,CHE,2016.0,1,0,1
BEL,ERI,2013.0,1,0,1
ARG,ECU,2005.0,1,0,1
CHN,CMR,2003.0,1,0,1
ISR,UKR,2008.0,1,0,1
NIC,USA,2012.0,1,0,1
SWZ,GBR,2018.0,2,0,2
PER,PRI,2013.0,1,0,1
BWA,MOZ,1997.0,1,0,1
NER,AUS,2013.0,1,0,1
CMR,IDN,2019.0,1,0,1
NLD,GEO,2013.0,1,0,1
AUS,KAZ,2007.0,1,0,1
SRB,ZAF,2022.0,1,0,1
IRN,ROU,2022.0,1,0,1
BEL,BRA,1998.0,1,0,1
PAK,ROU,2019.0,1,0,1
MLI,CHE,2014.0,1,0,1
CIV,BRA,2009.0,1,0,1
PSE,IRQ,2019.0,1,0,1
PRT,JOR,2020.0,1,0,1
PRY,MEX,2018.0,1,0,1
ZMB,SWZ,2020.0,1,0,1
DEU,FRA,2017.0,343,364,-21
KOR,CAN,2012.0,35,27,8
CAN,USA,2007.0,1250,1314,-64
FRA,ITA,2010.0,181,248,-67
PRI,USA,2010.0,54,78,-24
USA,SGP,2019.0,206,218,-12
JPN,DEU,2009.0,125,89,36
USA,CAN,2008.0,1344,1402,-58
USA,FRA,2006.0,602,641,-39
GBR,DEU,2000.0,112,161,-49
CHE,CHN,2008.0,22,24,-2
DEU,NLD,2008.0,220,175,45
IRN,USA,2009.0,126,49,77
VEN,USA,2002.0,34,18,16
DNK,SWE,2018.0,93,75,18
IRL,DEU,2011.0,44,30,14
USA,ESP,2014.0,309,534,-225
DEU,GBR,2007.0,467,315,152
GBR,SGP,2006.0,55,50,5
GBR,ESP,2008.0,197,180,17
CHN,GBR,2013.0,193,331,-138
ESP,CHE,2014.0,112,39,73
GRC,USA,2022.0,39,30,9
USA,NZL,2020.0,115,93,22
BEL,FRA,2012.0,169,182,-13
BGD,AUS,2018.0,70,40,30
BRA,FRA,2014.0,90,109,-19
NLD,BEL,2019.0,178,166,12
TWN,NZL,2007.0,2,2,0
PAK,DEU,2009.0,18,11,7
HKG,AUS,2000.0,5,17,-12
DNK,FRA,2001.0,15,14,1
DEU,SRB,2009.0,14,10,4
SWE,DEU,2017.0,125,155,-30
USA,NOR,2016.0,74,65,9
FRA,USA,2012.0,789,689,100
GBR,CHN,2020.0,590,481,109
AUS,COL,2017.0,8,10,-2
FRA,MEX,2010.0,46,32,14
NLD,FRA,2009.0,85,83,2
FRA,IRL,2005.0,27,18,9
CHN,AUS,2009.0,128,69,59
POL,USA,2014.0,306,83,223
USA,AUT,2006.0,68,88,-20
FRA,MEX,2017.0,51,41,10
FRA,MEX,2019.0,43,47,-4
RUS,BLR,2008.0,5,9,-4
ITA,FRA,2009.0,252,156,96
NZL,FRA,2013.0,18,10,8
SWE,NOR,2012.0,70,44,26
GBR,AUS,2020.0,528,477,51
MEX,ESP,2008.0,71,60,11
FRA,IRN,2006.0,18,7,11
USA,DNK,2011.0,124,85,39
SWE,DEU,2010.0,106,102,4
USA,SGP,2017.0,228,204,24
USA,FIN,2004.0,70,72,-2
NLD,SWE,2014.0,53,35,18
GLP,FRA,2008.0,11,19,-8
FRA,ITA,2017.0,232,358,-126
JOR,GBR,2010.0,9,19,-10
SVK,AUT,2004.0,9,7,2
NLD,BEL,2010.0,125,113,12
USA,KEN,2011.0,27,27,0
USA,PAN,2016.0,15,7,8
GBR,CAN,2012.0,339,321,18
PRI,USA,2017.0,91,65,26
CAN,IND,2021.0,64,116,-52
DEU,IND,2018.0,137,186,-49
MYS,GBR,2008.0,28,90,-62
MYS,ESP,2012.0,3,1,2
ESP,DNK,2011.0,15,12,3
CHE,USA,2002.0,353,348,5
AUS,JPN,2015.0,49,52,-3
FRA,NLD,2020.0,113,95,18
MYS,USA,2018.0,67,27,40
USA,ITA,2022.0,175,176,-1
CYP,NLD,2017.0,3,3,0
ITA,GRC,2013.0,16,37,-21
CHE,GBR,2020.0,263,316,-53
CHE,IRN,2018.0,11,28,-17
ETH,AUS,2018.0,15,4,11
ZAF,KOR,2017.0,1,3,-2
IDN,MYS,2014.0,11,67,-56
IND,SGP,2013.0,65,57,8
CAN,CHL,2021.0,15,21,-6
AUS,SGP,2021.0,68,54,14
BGD,KOR,2017.0,26,31,-5
FRA,ITA,2019.0,274,348,-74
HKG,KOR,2018.0,12,13,-1
USA,CHE,1999.0,127,184,-57
CZE,ISR,2021.0,5,4,1
FRA,GRC,2018.0,36,46,-10
SWE,DEU,2019.0,141,162,-21
CUB,FRA,2015.0,6,4,2
AUS,IRN,2009.0,24,34,-10
AUT,GBR,2004.0,34,25,9
PRI,USA,2019.0,105,69,36
HUN,CZE,2019.0,9,4,5
CAN,BRA,2018.0,59,127,-68
BRA,CAN,2019.0,148,49,99
USA,SWE,2009.0,184,183,1
EGY,SWE,2019.0,6,3,3
KEN,UGA,2016.0,7,4,3
USA,IRN,2011.0,52,229,-177
GBR,BRA,2017.0,84,120,-36
FRA,ESP,2020.0,221,195,26
SVN,DNK,2014.0,1,1,0
AUS,BGD,2019.0,57,82,-25
BRA,CAN,2017.0,97,71,26
JPN,IDN,2022.0,34,34,0
CHE,USA,2005.0,315,324,-9
GBR,GRC,2022.0,73,51,22
BEL,KOR,2016.0,9,5,4
AUT,ITA,2021.0,36,48,-12
IRN,NLD,2021.0,31,16,15
AUT,BEL,2018.0,19,14,5
LTU,DNK,2007.0,4,3,1
BLR,RUS,2016.0,19,12,7
FRA,BOL,2015.0,1,4,-3
DEU,SAU,2013.0,20,3,17
FRA,GBR,2021.0,293,323,-30
GBR,BRA,2019.0,94,126,-32
ITA,CHE,2021.0,162,124,38
USA,URY,2012.0,9,8,1
BEL,ZAF,2018.0,9,16,-7
NZL,CHN,2019.0,44,33,11
IND,FRA,2006.0,52,23,29
ITA,BRA,2009.0,26,29,-3
FRA,KOR,2014.0,34,26,8
HKG,GBR,2013.0,39,57,-18
JOR,JPN,2021.0,2,1,1
ITA,HUN,2016.0,8,10,-2
GRC,BEL,2020.0,16,13,3
BRA,MOZ,2022.0,5,2,3
SAU,CHN,2022.0,32,23,9
JOR,GBR,2019.0,14,36,-22
USA,CYP,2020.0,16,7,9
AUT,PAK,2020.0,5,2,3
LBN,USA,2020.0,90,53,37
IND,SWE,2017.0,42,22,20
IDN,GBR,2021.0,20,36,-16
CHE,NGA,2020.0,17,8,9
IND,SWE,2010.0,25,13,12
JPN,SWE,2018.0,23,13,10
SAU,QAT,2018.0,15,4,11
KOR,KAZ,2019.0,2,9,-7
PRT,MEX,2016.0,6,2,4
POL,SWE,2020.0,19,17,2
CHE,SWE,2021.0,46,31,15
IRL,FRA,2018.0,17,24,-7
IND,KOR,2003.0,26,9,17
USA,MYS,2014.0,35,41,-6
GHA,DEU,2021.0,14,11,3
NLD,DEU,2022.0,121,145,-24
IND,SWE,2019.0,54,26,28
RUS,GBR,2003.0,58,47,11
AUS,COL,2019.0,7,13,-6
CHN,EST,2019.0,5,1,4
NZL,GBR,2016.0,114,112,2
KWT,PAK,2020.0,1,2,-1
ISL,DEU,2021.0,2,2,0
IRN,MYS,2022.0,7,12,-5
DNK,MYS,2016.0,4,6,-2
FIN,CHN,2019.0,27,38,-11
MEX,GBR,2020.0,51,39,12
RUS,EGY,2022.0,7,2,5
JPN,CHL,2009.0,3,2,1
GBR,CHE,2003.0,161,112,49
FRA,IND,2022.0,25,48,-23
UKR,POL,2009.0,12,10,2
THA,AUS,2021.0,14,9,5
FRA,COG,2019.0,3,2,1
JOR,CAN,2007.0,6,6,0
USA,NLD,2006.0,204,234,-30
ARG,USA,2022.0,51,28,23
HRV,POL,2019.0,3,2,1
IRL,FIN,2014.0,6,3,3
NLD,USA,2018.0,418,346,72
IRN,BEL,2015.0,14,9,5
IRN,AZE,2011.0,3,12,-9
BRA,CHL,2009.0,13,10,3
ESP,PRT,2013.0,101,58,43
COG,COD,2009.0,13,6,7
JPN,ISR,2003.0,3,3,0
USA,ZAF,2020.0,59,111,-52
MAR,FRA,2006.0,37,58,-21
NLD,BEL,2017.0,158,148,10
SVK,DEU,2013.0,9,9,0
ITA,CHN,2000.0,8,8,0
FRA,BGR,2012.0,7,2,5
IRN,TUR,2009.0,6,1,5
CHE,DNK,2011.0,27,18,9
CAN,IRN,2011.0,48,212,-164
USA,BWA,2006.0,7,3,4
DEU,MEX,2015.0,35,39,-4
JPN,EGY,2011.0,52,10,42
GBR,UKR,2021.0,5,3,2
IND,TWN,2014.0,50,48,2
BRA,NZL,2010.0,4,4,0
PHL,USA,2006.0,15,17,-2
SWE,USA,1997.0,28,29,-1
GAB,FRA,1999.0,3,2,1
FRA,BEL,1999.0,44,49,-5
GBR,ISR,2009.0,16,34,-18
USA,MAC,2014.0,16,5,11
GBR,THA,2006.0,46,21,25
BEL,USA,2003.0,124,112,12
CHL,AUT,2016.0,2,2,0
CHE,RUS,2013.0,10,29,-19
MYS,SDN,2020.0,9,1,8
TWN,CAN,1999.0,1,4,-3
JPN,CHE,2004.0,20,13,7
ESP,PHL,2020.0,4,1,3
CHN,ESP,2011.0,8,10,-2
SGP,NZL,2004.0,11,3,8
BGD,IND,2014.0,11,12,-1
BEL,SWE,2020.0,20,23,-3
NZL,USA,1997.0,9,8,1
SWE,POL,2011.0,18,15,3
AUS,CAN,2007.0,108,125,-17
ESP,SWE,1999.0,9,6,3
SWE,JPN,1999.0,17,19,-2
NZL,FJI,2019.0,4,2,2
SYR,SAU,2020.0,2,1,1
CHN,MYS,2016.0,7,16,-9
USA,RUS,2001.0,114,328,-214
USA,TTO,2012.0,4,6,-2
HUN,ITA,2003.0,12,7,5
AUS,FIN,2009.0,7,9,-2
SWE,USA,1998.0,45,47,-2
FIN,DEU,2006.0,27,22,5
NZL,CHN,2017.0,24,26,-2
ESP,ISR,2004.0,4,6,-2
GBR,FRA,1997.0,31,30,1
GBR,TZA,2012.0,8,10,-2
BRA,USA,1998.0,42,54,-12
ETH,NOR,2012.0,6,4,2
TUR,ESP,2016.0,5,4,1
ARG,DEU,2007.0,24,13,11
RUS,PRT,2007.0,8,2,6
BGR,AUT,2005.0,2,3,-1
CHE,AUS,2001.0,15,24,-9
NZL,AUT,2013.0,6,3,3
GBR,AUT,2003.0,24,30,-6
NZL,AUS,2008.0,171,107,64
DEU,KOR,2016.0,50,62,-12
IND,BEL,2002.0,7,3,4
AUT,NOR,2022.0,3,8,-5
GBR,LBN,2021.0,8,11,-3
AUS,ITA,2020.0,40,45,-5
GRC,ITA,2021.0,19,22,-3
BGD,USA,2014.0,54,23,31
SGP,DNK,2013.0,3,5,-2
POL,CHE,2019.0,24,18,6
MYS,IRQ,2022.0,39,12,27
MEX,DNK,2020.0,7,4,3
ARE,SWE,2018.0,3,3,0
NER,MAR,2018.0,1,1,0
NGA,GBR,2016.0,29,52,-23
GBR,KWT,2021.0,12,5,7
ZAF,LSO,2020.0,3,1,2
SAU,PAK,2014.0,23,63,-40
CAN,NLD,2018.0,59,59,0
FRA,NER,2003.0,5,3,2
AUS,ZAF,1999.0,7,11,-4
GBR,KAZ,2021.0,8,7,1
USA,IRQ,2016.0,14,14,0
FRA,VNM,2015.0,33,17,16
PHL,AUS,2011.0,6,9,-3
PRT,TUR,2014.0,3,2,1
RUS,CHE,2009.0,16,12,4
CHL,AUS,2018.0,13,25,-12
TUN,BEL,2004.0,4,3,1
VEN,USA,2005.0,28,27,1
UKR,USA,2001.0,45,22,23
RUS,ESP,2016.0,7,12,-5
CAN,ESP,2009.0,25,34,-9
CHE,ESP,2006.0,31,27,4
NLD,CAN,2007.0,34,35,-1
KEN,CAN,2006.0,3,1,2
AUS,THA,2007.0,18,16,2
SAU,DEU,2011.0,3,18,-15
CAN,LBY,2020.0,3,2,1
GBR,MEX,2012.0,40,34,6
NOR,LTU,2014.0,1,2,-1
ISR,AUS,2003.0,13,3,10
JOR,SAU,2015.0,26,22,4
BEL,RUS,2015.0,5,6,-1
CRI,COL,2012.0,2,1,1
AUT,SVK,2006.0,8,8,0
COL,BRA,2005.0,8,13,-5
MWI,KEN,2009.0,2,1,1
GBR,CYP,2005.0,10,2,8
UKR,DEU,2016.0,42,10,32
CZE,AUT,2002.0,14,10,4
AUS,FRA,2001.0,28,31,-3
CHE,ZAF,2008.0,5,7,-2
FRA,LUX,2009.0,24,4,20
REU,FRA,2006.0,3,12,-9
NLD,SAU,2008.0,3,1,2
CZE,POL,2004.0,4,2,2
NZL,NLD,2010.0,6,15,-9
NOR,IND,2008.0,5,8,-3
QAT,SAU,2019.0,4,22,-18
USA,BRA,2000.0,60,73,-13
AUS,IND,2011.0,43,68,-25
FRA,IRL,2002.0,18,8,10
FIN,CHE,2011.0,23,8,15
JPN,SGP,2004.0,14,10,4
USA,LTU,2006.0,7,6,1
ROU,TUR,2003.0,2,1,1
GBR,LVA,2002.0,2,2,0
USA,BGD,2006.0,8,7,1
HRV,GBR,2006.0,2,2,0
DNK,HUN,2006.0,4,2,2
FRA,CZE,1999.0,19,3,16
FRA,GUF,2005.0,2,9,-7
GBR,CYP,2002.0,7,2,5
ZWE,CHE,2015.0,2,1,1
ITA,SWE,2000.0,7,12,-5
DNK,POL,2013.0,13,9,4
RUS,FIN,2003.0,18,23,-5
CAN,KWT,2002.0,4,2,2
CAN,ZAF,2007.0,10,20,-10
GBR,ISL,2007.0,5,5,0
HRV,USA,2004.0,14,22,-8
ISR,IRL,2015.0,2,1,1
USA,ARG,2000.0,38,47,-9
MEX,CUB,2008.0,7,9,-2
HRV,BIH,2009.0,4,5,-1
BRA,ITA,2006.0,25,12,13
POL,CHE,2010.0,21,12,9
SWE,COL,2021.0,1,3,-2
TUR,GBR,2006.0,20,28,-8
IRQ,IRN,2011.0,1,1,0
SVK,CZE,2000.0,8,10,-2
PHL,THA,2005.0,1,1,0
USA,HRV,1998.0,5,5,0
BRA,USA,1997.0,16,29,-13
GBR,FIN,2012.0,51,40,11
ROU,FRA,2007.0,24,36,-12
DNK,FIN,2006.0,12,11,1
FIN,DNK,2009.0,10,4,6
VNM,GBR,2002.0,6,9,-3
CAN,CZE,2001.0,7,5,2
FRA,ROU,2000.0,11,8,3
FRA,CMR,2004.0,9,14,-5
CAN,PRT,2016.0,8,12,-4
EST,DEU,2006.0,3,3,0
USA,ARE,2001.0,6,2,4
CHE,HUN,2004.0,7,14,-7
GRC,IRL,2005.0,3,4,-1
SAU,USA,1998.0,6,5,1
AUS,HKG,2013.0,27,56,-29
CHN,NZL,2004.0,1,5,-4
TWN,USA,2000.0,35,85,-50
RUS,TUR,2011.0,3,1,2
PRT,ESP,1998.0,3,5,-2
PAK,MYS,2008.0,6,2,4
USA,PHL,2007.0,16,14,2
PRT,CHN,2014.0,8,6,2
PAK,IND,2001.0,11,1,10
FRA,SVN,2012.0,6,6,0
NOR,NZL,2007.0,1,1,0
DEU,QAT,2013.0,7,1,6
GHA,CHE,2021.0,2,3,-1
SWE,THA,2009.0,5,6,-1
CHE,IRL,2014.0,10,9,1
CZE,HUN,2007.0,3,3,0
BEL,ARG,2013.0,3,3,0
NZL,NLD,2017.0,8,21,-13
UKR,ESP,2004.0,2,2,0
CHL,CAN,2002.0,4,1,3
ISR,ARG,2004.0,1,6,-5
CAN,KWT,2005.0,5,3,2
KOR,BRA,2019.0,2,3,-1
IRN,JPN,2010.0,19,22,-3
CHL,IND,2014.0,2,7,-5
CHE,HKG,2012.0,2,5,-3
AUT,ARE,2014.0,2,2,0
HKG,JPN,2007.0,7,5,2
IND,ITA,2010.0,41,20,21
DEU,ZAF,2013.0,27,18,9
URY,CHL,2014.0,6,1,5
UKR,CHE,2004.0,3,1,2
TUN,DEU,2013.0,2,3,-1
FRA,ISR,2016.0,31,22,9
ISR,GBR,2009.0,34,16,18
POL,ZAF,2022.0,1,4,-3
DNK,IRN,2016.0,5,27,-22
CAN,MEX,2011.0,26,27,-1
CHE,PHL,2008.0,1,1,0
CRI,CHL,2011.0,2,2,0
RUS,MEX,2008.0,4,3,1
AUS,ARE,2022.0,15,8,7
POL,NOR,2020.0,8,8,0
KOR,AUT,2014.0,7,1,6
GMB,GBR,2011.0,10,8,2
BEL,NOR,2016.0,4,6,-2
USA,EST,2021.0,7,6,1
CHL,CAN,2005.0,7,4,3
THA,SWE,2017.0,7,8,-1
GBR,NPL,2013.0,8,2,6
IND,PRT,2022.0,4,6,-2
HKG,TUR,2020.0,1,1,0
IDN,PAK,2021.0,5,3,2
SAU,ARE,2020.0,30,11,19
TUR,VNM,2020.0,2,2,0
ESP,TUR,2020.0,14,10,4
SWE,PRT,2020.0,14,14,0
THA,TWN,2012.0,3,4,-1
VEN,ECU,2014.0,11,1,10
QAT,CAN,2022.0,8,2,6
LAO,THA,2017.0,4,6,-2
KEN,CHN,2020.0,7,12,-5
CHN,TZA,2019.0,9,2,7
UKR,FRA,2014.0,15,9,6
CHN,IRN,2006.0,2,1,1
NGA,SAU,2022.0,6,1,5
SVK,ESP,2020.0,2,2,0
DEU,VEN,2018.0,2,6,-4
NLD,ESP,2000.0,10,16,-6
TUR,MEX,2020.0,2,1,1
FRA,CIV,2007.0,30,6,24
DEU,JOR,2007.0,7,7,0
SVK,NLD,2004.0,4,1,3
USA,JAM,2014.0,9,6,3
THA,IDN,2003.0,3,1,2
FIN,GBR,2001.0,24,30,-6
HUN,FRA,2007.0,11,13,-2
FRA,FIN,2005.0,8,8,0
SGP,IDN,2012.0,3,1,2
CHE,UGA,2011.0,2,2,0
HUN,DNK,2012.0,4,2,2
DEU,BLR,2009.0,5,10,-5
NLD,MAR,2018.0,1,2,-1
CHE,JPN,2015.0,38,34,4
MEX,SVN,2002.0,1,1,0
FRA,BGD,2020.0,3,4,-1
AUS,EGY,2014.0,6,3,3
CAN,RUS,2008.0,7,16,-9
ZAF,ZMB,2017.0,6,6,0
JPN,TZA,2013.0,2,2,0
FIN,BRA,2014.0,6,1,5
CRI,DEU,2020.0,7,1,6
AGO,USA,2012.0,1,1,0
TWN,AUS,2016.0,19,11,8
CHN,PRI,2009.0,4,2,2
CUB,BEL,2020.0,2,2,0
NZL,IRL,2022.0,6,1,5
JPN,BEL,2001.0,9,7,2
DNK,CAN,2007.0,18,15,3
JPN,NGA,2020.0,4,1,3
FIN,SVK,2015.0,2,1,1
GHA,KEN,2015.0,1,2,-1
KOR,IDN,2011.0,6,4,2
MWI,USA,2011.0,4,8,-4
ARE,AUS,2014.0,8,20,-12
SVN,DEU,2015.0,15,2,13
IND,PHL,2007.0,7,3,4
FIN,IRL,2011.0,2,2,0
JPN,GHA,2022.0,3,1,2
ECU,COL,2020.0,8,10,-2
RUS,SRB,2018.0,4,4,0
HUN,DEU,2022.0,10,10,0
ZAF,MOZ,2018.0,1,1,0
ISL,NOR,2020.0,6,7,-1
CAN,SVN,2020.0,2,3,-1
MEX,IRL,2017.0,2,1,1
PRT,BEL,1999.0,2,2,0
JOR,GBR,2017.0,9,22,-13
BEL,PRT,2001.0,4,1,3
BGD,KOR,2010.0,11,11,0
NZL,SWE,2004.0,4,7,-3
CHN,SWE,1997.0,5,3,2
SWE,RUS,2004.0,16,40,-24
PAK,ITA,2019.0,14,19,-5
ESP,GRC,2014.0,16,14,2
DEU,ARG,2021.0,9,37,-28
PSE,ISR,2017.0,5,9,-4
HKG,MYS,2008.0,4,3,1
FRA,PYF,2006.0,5,3,2
AUS,PHL,2004.0,6,9,-3
ETH,IND,2022.0,13,13,0
BEL,CMR,2011.0,3,1,2
AUS,CRI,2013.0,2,1,1
FRA,EGY,2006.0,6,4,2
CAN,COL,2002.0,6,3,3
LSO,ZAF,2017.0,1,2,-1
DEU,LTU,1998.0,2,1,1
VEN,CAN,2008.0,4,1,3
URY,BRA,2002.0,5,5,0
NLD,TUR,2001.0,3,3,0
ESP,POL,2002.0,5,8,-3
SWE,BRA,2007.0,8,9,-1
THA,NPL,2005.0,2,2,0
TUR,KOR,2006.0,2,1,1
VNM,BEL,2004.0,2,1,1
ESP,EGY,2005.0,5,1,4
DEU,KEN,2005.0,4,4,0
ZAF,LKA,2012.0,1,2,-1
CHE,FIN,2016.0,12,20,-8
NOR,CAN,2013.0,7,19,-12
AUS,EST,2010.0,1,1,0
USA,BLR,2000.0,2,6,-4
TTO,GBR,2016.0,3,3,0
FIN,POL,2003.0,3,2,1
NGA,GMB,2008.0,5,1,4
HUN,NLD,2006.0,5,5,0
GBR,ARG,2008.0,13,20,-7
NLD,MEX,2009.0,3,8,-5
VNM,GBR,2005.0,3,5,-2
OMN,MYS,2007.0,2,1,1
DNK,IRL,1999.0,1,3,-2
PAK,AUT,2011.0,6,19,-13
AUS,PSE,2010.0,1,1,0
EGY,SWE,2010.0,2,2,0
AUS,COL,2010.0,3,3,0
GHA,EGY,2021.0,2,1,1
NLD,ISR,2008.0,4,10,-6
USA,CMR,2018.0,11,5,6
DEU,LBN,2014.0,3,3,0
VNM,ESP,2011.0,2,1,1
TWN,MWI,2010.0,1,1,0
EGY,AUS,2022.0,4,3,1
SGP,ISR,2016.0,4,5,-1
ZAF,SWE,2011.0,6,4,2
ZAF,KEN,2011.0,8,10,-2
ITA,PAK,2014.0,10,12,-2
IRQ,IRL,2019.0,2,2,0
ISR,CHE,2016.0,10,11,-1
QAT,ARE,2015.0,2,6,-4
HUN,GBR,2021.0,23,18,5
HUN,ARE,2019.0,1,2,-1
ESP,TWN,2020.0,2,2,0
THA,SWE,2010.0,6,4,2
ETH,KEN,2014.0,3,4,-1
PSE,FRA,2018.0,2,7,-5
NLD,LTU,2014.0,1,2,-1
FRA,COG,2017.0,5,4,1
ZAF,DEU,2007.0,9,26,-17
AUS,RUS,1999.0,1,4,-3
FIN,ESP,2003.0,8,5,3
AUS,SRB,1998.0,1,1,0
AUS,ARG,2021.0,4,6,-2
AUT,NLD,2007.0,15,14,1
BEL,AUT,2015.0,13,9,4
JPN,PAK,2018.0,8,9,-1
LKA,JPN,2014.0,1,10,-9
ZAF,ZMB,2019.0,9,5,4
MLT,GBR,2009.0,5,5,0
ZAF,TWN,2017.0,4,2,2
GRC,ARE,2020.0,5,3,2
NLD,SGP,2020.0,10,17,-7
DEU,BGD,2003.0,2,2,0
QAT,SAU,2017.0,5,16,-11
IRL,SGP,2020.0,3,3,0
IND,BEL,2005.0,6,7,-1
SAU,FRA,2012.0,6,34,-28
POL,KOR,2003.0,4,1,3
FIN,FRA,2007.0,14,13,1
CHN,ARG,2001.0,1,1,0
NAM,ZAF,2002.0,4,2,2
HKG,ISR,2019.0,3,1,2
USA,LVA,2015.0,11,3,8
ITA,TUN,2016.0,7,8,-1
ISR,MEX,2002.0,5,1,4
ARG,AUS,2008.0,5,4,1
FIN,BEL,2007.0,3,5,-2
JPN,DNK,2022.0,4,5,-1
UGA,DEU,2007.0,3,1,2
MEX,BLR,2002.0,2,1,1
EGY,FRA,2009.0,14,13,1
SGP,FRA,2009.0,4,27,-23
SWE,PRI,2008.0,1,1,0
TWN,SGP,2022.0,4,8,-4
CHN,SWE,1998.0,3,2,1
SYR,DEU,2012.0,4,4,0
ROU,HUN,2006.0,2,7,-5
FIN,CHN,2010.0,11,18,-7
NGA,CMR,2003.0,2,2,0
ETH,MYS,2009.0,3,1,2
LKA,THA,2010.0,1,1,0
AUS,POL,2016.0,1,8,-7
CUB,DEU,2020.0,8,4,4
IRN,JPN,2017.0,19,17,2
MEX,RUS,2012.0,2,4,-2
IND,DNK,2022.0,11,9,2
USA,LBR,2016.0,2,1,1
CMR,FRA,2022.0,4,4,0
PER,ESP,2014.0,7,14,-7
IDN,NLD,2002.0,5,3,2
ZAF,KOR,2019.0,7,3,4
IRN,CYP,2020.0,3,1,2
AUT,JOR,2020.0,1,1,0
AFG,PAK,2021.0,1,1,0
HUN,CHN,2022.0,1,6,-5
CYP,DEU,2021.0,3,6,-3
CYP,USA,2020.0,7,16,-9
CHL,COL,2007.0,6,2,4
HRV,FIN,2013.0,1,1,0
ARM,IRN,2014.0,4,2,2
ARE,OMN,2002.0,5,1,4
EST,LVA,2021.0,3,2,1
GBR,MAR,2021.0,2,3,-1
GBR,LTU,2002.0,1,2,-1
LKA,IND,2011.0,3,1,2
BWA,TZA,2005.0,1,1,0
DZA,ITA,2002.0,1,1,0
AUT,FIN,2008.0,5,5,0
UKR,AUT,2003.0,7,2,5
JPN,DZA,2017.0,1,1,0
AUT,DNK,2009.0,5,11,-6
FRA,GUF,2002.0,7,2,5
URY,BRA,2005.0,3,1,2
JOR,MYS,2006.0,2,2,0
NLD,FIN,2007.0,13,18,-5
KEN,ZAF,2003.0,4,2,2
NLD,KOR,2007.0,6,6,0
BGR,USA,2013.0,6,10,-4
SVN,NLD,2016.0,3,2,1
USA,KNA,2016.0,4,4,0
IRL,NZL,2003.0,3,2,1
CAN,COL,2005.0,2,2,0
OMN,GBR,2001.0,1,4,-3
ESP,POL,2005.0,4,13,-9
SWZ,LSO,2018.0,1,1,0
VNM,SGP,2016.0,1,8,-7
CHL,BOL,2020.0,2,4,-2
VNM,MYS,2014.0,1,6,-5
LVA,DEU,2014.0,2,3,-1
SAU,SDN,2009.0,3,5,-2
DEU,GAB,2022.0,2,1,1
HKG,ITA,2011.0,2,2,0
MYS,KOR,2012.0,8,7,1
PER,CRI,2015.0,1,2,-1
ETH,BEL,2018.0,3,10,-7
EST,JPN,2015.0,2,2,0
ZMB,MWI,2017.0,1,3,-2
DNK,GHA,2016.0,3,1,2
RUS,MNG,2019.0,1,1,0
NZL,NLD,2019.0,7,15,-8
ESP,TZA,2019.0,17,2,15
ETH,KOR,2021.0,5,5,0
NLD,UGA,2018.0,3,3,0
AUT,GRC,2004.0,2,1,1
TWN,FRA,2020.0,5,4,1
NLD,CHN,2007.0,18,31,-13
LKA,THA,2017.0,2,2,0
IRL,POL,2008.0,1,8,-7
JOR,ARE,2006.0,6,3,3
IDN,FRA,2004.0,3,4,-1
GBR,LTU,2005.0,2,3,-1
CAN,THA,2000.0,2,3,-1
EGY,MYS,2020.0,2,14,-12
IND,ESP,1999.0,1,4,-3
MEX,JPN,1998.0,2,1,1
GBR,LVA,2005.0,1,2,-1
CHL,DNK,2009.0,1,1,0
MEX,IRL,2019.0,3,1,2
MNG,AUS,2021.0,2,1,1
KOR,BGD,2009.0,5,14,-9
CHN,IRQ,2022.0,3,2,1
NGA,ITA,2022.0,1,1,0
AUS,ZWE,2018.0,2,1,1
LTU,RUS,2001.0,1,2,-1
NLD,AUS,1999.0,9,4,5
NPL,GBR,2020.0,2,13,-11
NOR,RUS,2009.0,5,8,-3
KEN,CHE,2015.0,3,1,2
HKG,THA,2018.0,3,1,2
SRB,HRV,2007.0,3,6,-3
IRL,DNK,2011.0,2,5,-3
MAR,USA,2009.0,1,6,-5
PAK,ITA,2010.0,4,3,1
KOR,BRA,2017.0,3,3,0
BGR,JPN,2016.0,2,4,-2
QAT,SAU,2010.0,4,1,3
PAK,BGD,2013.0,8,4,4
ALB,USA,2011.0,1,1,0
RUS,MNG,2017.0,2,1,1
CUB,VEN,2015.0,3,2,1
IRQ,SWE,2020.0,3,2,1
IND,PAK,2006.0,9,8,1
KEN,ITA,2002.0,2,1,1
SWE,HUN,2009.0,5,12,-7
ZMB,CHN,2016.0,2,3,-1
ISR,CHL,2018.0,1,3,-2
JPN,CZE,2022.0,4,2,2
VNM,TWN,2022.0,11,32,-21
DNK,ISL,2007.0,4,2,2
NLD,BEN,2012.0,2,1,1
SGP,NLD,2012.0,9,14,-5
BGR,AUT,2002.0,1,4,-3
ESP,KEN,2013.0,1,1,0
ITA,NGA,2014.0,2,4,-2
LUX,BEL,2022.0,2,8,-6
FRO,NOR,2015.0,1,2,-1
SVN,KWT,2018.0,1,1,0
BGD,SGP,2020.0,1,4,-3
UGA,ETH,2015.0,1,1,0
THA,MMR,2013.0,1,1,0
NLD,LUX,2006.0,1,1,0
DNK,MEX,2017.0,4,4,0
SWE,IND,2001.0,3,7,-4
DEU,LVA,2014.0,3,2,1
CYP,IRL,2017.0,1,2,-1
UKR,ITA,2011.0,1,3,-2
IRN,FIN,2009.0,1,2,-1
CMR,NGA,2012.0,2,2,0
IDN,THA,2015.0,1,6,-5
PER,ECU,2007.0,1,1,0
IRL,JPN,2018.0,3,8,-5
COL,AUS,2012.0,4,2,2
CHL,ITA,2008.0,3,8,-5
AZE,TUR,2018.0,2,9,-7
TUR,DNK,2013.0,2,2,0
USA,GRD,2012.0,2,4,-2
THA,CHE,2014.0,2,5,-3
SVN,GRC,2015.0,1,1,0
POL,PRT,2018.0,2,5,-3
LUX,MLI,2018.0,1,1,0
ESP,TZA,2017.0,1,2,-1
IND,RUS,2015.0,6,1,5
BEL,ETH,2014.0,2,4,-2
FJI,GBR,2021.0,1,1,0
THA,SWE,2019.0,3,7,-4
THA,ITA,2020.0,3,2,1
GHA,NOR,2017.0,1,1,0
PRY,JPN,2004.0,1,2,-1
PAK,KEN,2011.0,1,8,-7
BGR,NLD,2006.0,2,2,0
FIN,ISR,2019.0,3,1,2
CHN,NOR,2006.0,5,7,-2
AUT,SRB,2018.0,2,6,-4
CMR,ZAF,2013.0,6,3,3
JPN,ZAF,2003.0,1,4,-3
SRB,FRA,2007.0,6,6,0
HRV,CZE,2004.0,1,2,-1
FRA,CUB,1998.0,1,1,0
SWE,ETH,1999.0,1,1,0
OMN,NZL,2013.0,1,2,-1
URY,SWE,2002.0,2,2,0
ZAF,SGP,2004.0,2,1,1
URY,SWE,2005.0,1,1,0
TZA,UGA,2012.0,3,1,2
AUT,SWE,2008.0,6,14,-8
RUS,NOR,1998.0,1,5,-4
NPL,PHL,2012.0,1,1,0
OMN,IND,2006.0,1,5,-4
NZL,CHN,2010.0,5,5,0
RUS,NOR,1997.0,1,4,-3
TWN,THA,2004.0,2,1,1
NOR,BEL,2002.0,1,1,0
FRA,GAB,2011.0,2,7,-5
SGP,AUT,2016.0,3,2,1
NOR,IRL,2015.0,1,5,-4
ARE,SAU,2007.0,3,10,-7
HKG,ARE,2017.0,2,3,-1
AUS,BRN,2015.0,1,3,-2
VNM,DNK,2016.0,1,5,-4
AUS,LBN,2014.0,2,3,-1
GBR,VNM,2006.0,1,4,-3
LBN,NLD,2019.0,5,6,-1
DEU,BEN,2018.0,5,2,3
RUS,IND,2004.0,1,4,-3
SAU,RWA,2013.0,2,1,1
IND,JOR,2001.0,2,2,0
FJI,CHE,2011.0,1,1,0
CAN,VEN,2016.0,2,1,1
IRN,CZE,2012.0,1,2,-1
CHL,PRT,2017.0,4,6,-2
ZAF,EGY,2011.0,2,1,1
AUT,IRN,2020.0,3,28,-25
CZE,BRA,2017.0,1,3,-2
SWE,TZA,2005.0,1,1,0
NLD,SVN,2003.0,2,2,0
USA,LIE,2007.0,1,1,0
HKG,ISR,2010.0,1,1,0
DEU,CMR,2004.0,2,4,-2
BFA,SEN,2014.0,4,2,2
GNQ,ESP,2015.0,1,1,0
URY,FRA,2001.0,1,1,0
FRA,BLR,2019.0,1,1,0
NPL,THA,2007.0,2,2,0
MDG,USA,2011.0,1,5,-4
USA,MDG,2017.0,3,6,-3
MNE,SRB,2011.0,3,6,-3
BEN,NLD,2014.0,1,1,0
BEL,IND,2021.0,9,29,-20
KWT,AUS,2009.0,1,2,-1
BWA,ZAF,2022.0,3,4,-1
ETH,GBR,2011.0,6,4,2
SRB,PRT,2020.0,2,1,1
AUT,NZL,2022.0,1,2,-1
TTO,ZAF,2014.0,3,1,2
ROU,NOR,2015.0,1,2,-1
DZA,SAU,2015.0,1,1,0
BEL,RWA,2009.0,1,2,-1
NOR,ISL,2001.0,2,1,1
FIN,UKR,2016.0,1,5,-4
TJK,UZB,2014.0,1,1,0
CHE,COL,2008.0,2,3,-1
BEL,PER,2020.0,2,3,-1
IDN,PER,2019.0,1,1,0
PSE,EGY,2014.0,1,2,-1
HUN,IRL,2016.0,1,2,-1
DNK,MEX,2019.0,2,3,-1
CAN,SRB,2020.0,1,4,-3
BRA,NZL,2017.0,6,1,5
LAO,THA,2019.0,4,5,-1
TGO,FRA,2017.0,2,5,-3
MYS,NLD,2007.0,1,3,-2
DEU,SDN,2016.0,1,1,0
MDG,GBR,2013.0,3,1,2
AUT,KOR,2003.0,1,1,0
LUX,SWE,2021.0,1,4,-3
GRC,MKD,2006.0,1,1,0
LTU,FIN,2000.0,3,1,2
NOR,BEL,2005.0,1,1,0
SVN,SVK,2007.0,2,4,-2
AUT,ROU,2005.0,1,1,0
ESP,BLR,2001.0,2,1,1
COL,IND,2018.0,1,1,0
SWE,CHL,2016.0,1,4,-3
CAN,KEN,2008.0,1,2,-1
LKA,CAN,2007.0,1,1,0
IDN,NLD,2005.0,2,4,-2
QAT,TWN,2016.0,1,2,-1
FRA,AFG,2017.0,3,1,2
BLR,POL,2013.0,4,6,-2
ISL,DNK,2012.0,1,4,-3
DNK,PHL,2015.0,2,1,1
ALB,DEU,2015.0,1,2,-1
QAT,CUB,2016.0,3,1,2
ITA,IDN,2012.0,2,1,1
IRQ,IND,2018.0,2,9,-7
TGO,FRA,2019.0,2,1,1
CHL,NLD,2022.0,5,5,0
AUS,EST,2017.0,2,1,1
IND,CHL,2009.0,2,1,1
DNK,MEX,2010.0,1,3,-2
EGY,NGA,2019.0,1,3,-2
EGY,BRA,2020.0,1,4,-3
BGD,PAK,2004.0,1,5,-4
CHN,BRA,2012.0,2,3,-1
SGP,EGY,2018.0,1,1,0
BHR,SAU,2015.0,2,8,-6
BRA,EGY,2022.0,1,2,-1
IRQ,AUS,2014.0,2,2,0
ROU,ISR,2003.0,1,3,-2
MYS,FJI,2018.0,1,1,0
ISR,TWN,2005.0,2,1,1
BEL,LTU,2009.0,1,1,0
QAT,ITA,2018.0,2,5,-3
TUR,GRC,2008.0,1,1,0
NOR,ARE,2020.0,1,3,-2
PRT,PER,2020.0,1,2,-1
FIN,NZL,2020.0,1,3,-2
PRT,MAR,2020.0,2,3,-1
AUT,ISR,2018.0,3,5,-2
CHN,YEM,2017.0,1,1,0
NGA,SWE,2005.0,1,2,-1
MMR,JPN,2018.0,4,8,-4
BDI,RWA,2019.0,1,1,0
IRL,HKG,2015.0,1,1,0
MEX,JPN,1997.0,1,3,-2
LKA,MYS,2021.0,1,6,-5
TGO,FRA,2010.0,3,3,0
BOL,FRA,2017.0,2,1,1
JPN,CUB,2001.0,1,1,0
ARG,JPN,2009.0,1,2,-1
FIN,BGD,2011.0,1,1,0
ZAF,TWN,2010.0,1,2,-1
SAU,MEX,2019.0,1,4,-3
SAU,USA,1997.0,1,6,-5
IND,PAN,2017.0,1,1,0
SGP,IRL,2006.0,2,1,1
KEN,NOR,2017.0,1,2,-1
BEL,CUB,2016.0,1,3,-2
PSE,DEU,2016.0,2,7,-5
GHA,AUT,2017.0,1,1,0
VNM,SWE,2018.0,1,2,-1
FRA,SRB,1998.0,1,1,0
RUS,MNG,2010.0,1,1,0
ARM,FRA,2021.0,2,1,1
CAN,JAM,2005.0,1,1,0
ESP,AND,2003.0,1,1,0
PRT,ECU,2018.0,1,2,-1
MYS,BGD,2003.0,2,1,1
USA,ECU,1998.0,1,1,0
HUN,RUS,2007.0,2,1,1
VEN,BRA,2004.0,2,2,0
UKR,MEX,2016.0,1,1,0
THA,ZAF,2020.0,1,2,-1
CHN,FIN,2006.0,1,11,-10
CRI,BRA,2013.0,1,2,-1
SDN,SSD,2020.0,1,1,0
CZE,SRB,2014.0,1,2,-1
THA,KOR,2002.0,1,3,-2
TWN,PRT,2020.0,1,2,-1
HRV,POL,2017.0,1,5,-4
NGA,IND,2022.0,2,5,-3
THA,AUT,2004.0,2,2,0
YEM,CHN,2018.0,1,3,-2
BGD,HKG,2022.0,1,3,-2
FJI,IND,2004.0,1,3,-2
HKG,ISR,2017.0,1,3,-2
LKA,THA,2019.0,1,2,-1
BOL,FRA,2019.0,1,2,-1
GHA,NOR,2019.0,1,4,-3
NZL,NCL,2015.0,1,2,-1
RUS,SGP,1999.0,2,1,1
PRT,ESP,1997.0,1,2,-1
WSM,AUS,2021.0,1,1,0
CHE,SVN,2015.0,1,10,-9
CZE,BRA,2019.0,3,11,-8
CIV,USA,2012.0,1,2,-1
TGO,USA,2011.0,1,1,0
JOR,EGY,2006.0,1,3,-2
IND,BWA,2009.0,1,1,0
SWE,ROU,2002.0,1,3,-2
ARG,BEL,1997.0,1,1,0
COL,NZL,2016.0,2,1,1
HKG,LKA,2009.0,1,2,-1
NOR,ROU,2010.0,1,3,-2
SAU,BEL,2021.0,1,4,-3
BRN,KOR,2017.0,1,1,0
LKA,KEN,2009.0,1,1,0
COL,BRA,2002.0,1,6,-5
BOL,FRA,2010.0,1,1,0
IDN,CHN,2015.0,1,2,-1
OMN,JOR,2010.0,1,2,-1
NOR,HUN,2021.0,1,3,-2
GAB,NLD,2019.0,1,1,0
CZE,IDN,2019.0,1,2,-1
ITA,SEN,2007.0,1,1,0
VNM,RUS,2008.0,1,4,-3
MAR,RUS,2021.0,1,2,-1
LAO,KHM,2018.0,1,1,0
KOR,BRA,2010.0,1,1,0
ZAF,KOR,2010.0,1,2,-1
ROU,AUS,2017.0,1,1,0
SGP,HRV,2016.0,1,1,0
SRB,CHN,2016.0,1,4,-3
TUR,UKR,2018.0,1,2,-1
VNM,EST,2019.0,1,2,-1
CHN,USA,2016.0,2592,2460,132
SAU,KWT,2013.0,7,2,5
TZA,NOR,2018.0,4,9,-5
DEU,FRA,2019.0,312,389,-77
DEU,FRA,2010.0,265,324,-59
CAN,CHN,2016.0,272,304,-32
GBR,HRV,2022.0,6,1,5
CZE,BEL,2006.0,1,5,-4
USA,HKG,2012.0,135,129,6
BRA,CAN,2010.0,67,39,28
SDN,SAU,2016.0,25,7,18
USA,SGP,2010.0,231,146,85
SGP,USA,2006.0,115,143,-28
AUS,KOR,2021.0,30,30,0
SWE,NLD,2011.0,38,47,-9
IND,ITA,2017.0,46,44,2
FRA,AUT,2014.0,38,22,16
AUT,FRA,2014.0,22,38,-16
IND,MYS,2021.0,40,43,-3
HRV,CAN,2014.0,1,2,-1
ITA,CAN,2020.0,73,55,18
BGD,SWE,2009.0,3,4,-1
AUS,BGD,2010.0,6,10,-4
BEL,CHN,2015.0,39,34,5
CZE,SVK,2016.0,53,59,-6
KOR,CHE,2004.0,5,5,0
HUN,POL,2018.0,4,4,0
TWN,IDN,2018.0,37,17,20
DNK,CHN,2020.0,69,92,-23
FRA,NCL,2020.0,20,17,3
IND,CAN,2006.0,58,36,22
FRA,MDG,2016.0,8,7,1
PAK,ITA,2017.0,13,18,-5
ZAF,GHA,2018.0,18,20,-2
USA,MDG,2019.0,5,2,3
ESP,ROU,2020.0,8,3,5
CHE,POL,2000.0,7,6,1
IND,ITA,2019.0,55,28,27
IDN,DEU,2020.0,8,24,-16
ETH,CHN,2019.0,12,12,0
ETH,CHN,2017.0,10,1,9
GHA,GBR,2018.0,14,17,-3
DEU,IDN,2013.0,16,5,11
GBR,PHL,2018.0,6,5,1
DEU,CHE,2000.0,155,94,61
SGP,CAN,2011.0,20,18,2
POL,CHE,2017.0,25,20,5
AUS,IDN,2014.0,48,15,33
HUN,CZE,2017.0,7,3,4
ESP,USA,1999.0,150,115,35
CZE,CAN,2008.0,12,8,4
NZL,USA,1998.0,16,11,5
DZA,PRT,2019.0,1,2,-1
GBR,FRA,1998.0,44,54,-10
PER,JPN,2020.0,2,2,0
NLD,NOR,2020.0,23,15,8
FRA,TUN,2006.0,61,57,4
PER,USA,2006.0,12,25,-13
UKR,SWE,2011.0,9,3,6
GBR,EST,2007.0,3,2,1
CIV,FRA,2012.0,9,31,-22
FIN,EST,2016.0,14,20,-6
FRA,GLP,2012.0,15,17,-2
FRA,FIN,2002.0,19,18,1
SAU,MEX,2017.0,1,4,-3
NOR,ITA,2009.0,6,16,-10
ISR,ZAF,2018.0,2,2,0
CYP,GBR,2002.0,2,7,-5
JOR,DEU,2003.0,5,9,-4
MEX,BRA,2008.0,10,6,4
EGY,OMN,2015.0,5,2,3
FIN,CHN,2017.0,23,20,3
CZE,AUT,2005.0,7,8,-1
NZL,SGP,2013.0,7,4,3
ZWE,USA,2004.0,6,2,4
NZL,HKG,2004.0,2,6,-4
BEL,BRA,2008.0,10,8,2
FRA,COL,2012.0,10,10,0
NLD,CZE,2012.0,7,6,1
GBR,LKA,2013.0,14,7,7
SRB,VNM,2018.0,2,2,0
COL,VEN,2014.0,3,21,-18
BEL,LUX,2018.0,20,10,10
ROU,BEL,2016.0,10,2,8
ETH,USA,2012.0,13,10,3
COL,PER,2012.0,3,1,2
DEU,GHA,2022.0,7,5,2
NOR,ZAF,2021.0,2,6,-4
PER,CHL,2020.0,4,13,-9
PRT,POL,2017.0,6,5,1
GRC,QAT,2015.0,3,2,1
LKA,USA,2008.0,5,5,0
DNK,CHE,2020.0,38,31,7
AUS,PRT,2020.0,7,8,-1
EGY,POL,2020.0,2,1,1
JPN,ITA,2007.0,17,18,-1
AUS,BGD,2017.0,30,65,-35
TZA,GBR,2006.0,7,8,-1
GRC,CYP,2001.0,4,6,-2
CHE,CAN,1997.0,9,8,1
JPN,HUN,1998.0,2,2,0
AUS,EST,2019.0,2,2,0
DEU,EGY,2000.0,7,9,-2
LSO,ZAF,2010.0,5,2,3
ISL,NLD,2009.0,3,2,1
BGD,KOR,2019.0,17,33,-16
CHN,ARE,2018.0,7,5,2
DEU,KEN,2002.0,2,3,-1
FRA,COG,2010.0,6,5,1
CAN,POL,2022.0,7,3,4
ITA,MAR,2012.0,3,1,2
CHL,PRT,2019.0,4,4,0
TUR,FIN,2016.0,4,3,1
NZL,ARE,2006.0,2,2,0
CHL,ECU,2022.0,7,4,3
NLD,ECU,2018.0,5,1,4
SRB,HUN,2020.0,5,2,3
VEN,BEL,2016.0,1,1,0
PSE,ISR,2010.0,6,17,-11
SWE,ROU,2005.0,2,3,-1
PNG,AUS,2001.0,2,2,0
ZWE,ZMB,2018.0,2,1,1
CYP,NLD,2019.0,4,3,1
FRA,CAF,2008.0,3,3,0
EST,FRA,2011.0,1,4,-3
KOR,ROU,2016.0,2,1,1
QAT,EGY,2000.0,1,3,-2
EGY,SWE,2017.0,5,4,1
KOR,ISR,2008.0,1,1,0
UZB,USA,2004.0,4,2,2
TUN,GBR,2004.0,1,3,-2
CYP,GBR,2005.0,2,10,-8
POL,BGR,2007.0,3,1,2
PRT,POL,2010.0,5,6,-1
IRN,JPN,2019.0,16,14,2
ARE,QAT,2018.0,4,8,-4
KWT,SAU,2015.0,4,3,1
ZAF,NAM,2013.0,6,2,4
IRL,MEX,2018.0,1,2,-1
BGD,GBR,2003.0,4,5,-1
MLI,SEN,2018.0,2,3,-1
TUR,CHN,2018.0,9,4,5
GBR,CMR,2015.0,3,2,1
PAK,JPN,2001.0,1,1,0
THA,BGD,2006.0,1,2,-1
PHL,IND,2012.0,3,2,1
FIN,IND,2011.0,2,17,-15
VEN,COL,2007.0,3,5,-2
PRT,POL,2019.0,8,3,5
IRL,BEL,2004.0,2,4,-2
BLR,ITA,2002.0,4,1,3
EST,GBR,2012.0,3,7,-4
IRN,PAK,2013.0,1,2,-1
CRI,NLD,2019.0,2,1,1
SAU,NGA,2009.0,1,1,0
NZL,FJI,2017.0,2,3,-1
PER,CAN,2009.0,3,1,2
EST,DNK,2009.0,1,1,0
NOR,TWN,2012.0,1,2,-1
JPN,JOR,2016.0,2,1,1
SWE,IRN,2003.0,2,1,1
USA,SYR,2021.0,4,1,3
MDA,USA,2017.0,1,1,0
CAN,BWA,2008.0,1,2,-1
MDA,DEU,2008.0,3,1,2
EST,CHN,2021.0,1,2,-1
PER,ARG,2015.0,3,4,-1
NCL,DEU,2016.0,1,1,0
YEM,MAR,2020.0,1,2,-1
SWE,SVN,2004.0,1,1,0
PRY,BRA,2016.0,1,6,-5
CAN,BTN,2019.0,1,1,0
TWN,BGD,2015.0,1,1,0
CAN,BGD,2011.0,2,13,-11
TTO,CAN,2011.0,1,3,-2
MLI,MAR,2016.0,1,1,0
DNK,HKG,2021.0,1,5,-4
,IRN,2001.0,1917,0,1917
,USA,1999.0,139192,0,139192
IND,,2016.0,14606,0,14606
CHN,,2016.0,68724,0,68724
FRA,,2018.0,13446,0,13446
,NOR,2000.0,1956,0,1956
UKR,,2010.0,561,0,561
THA,,2019.0,1897,0,1897
,CAN,2000.0,12315,0,12315
,LKA,2004.0,129,0,129
,JPN,1995.0,19989,0,19989
UZB,,2022.0,454,0,454
,MYS,2005.0,1430,0,1430
IDN,,2014.0,161,0,161
,DNK,2003.0,1794,0,1794
,ETH,2000.0,135,0,135
ITA,,2013.0,7064,0,7064
,PAK,2011.0,3184,0,3184
,NGA,1994.0,211,0,211
SWE,,2016.0,2751,0,2751
THA,,2017.0,1294,0,1294
UKR,,2019.0,1634,0,1634
TJK,,2021.0,35,0,35
,MYS,2002.0,891,0,891
,JAM,1994.0,41,0,41
,TWN,1995.0,1545,0,1545
THA,,2010.0,487,0,487
TUR,IRL,2006.0,2,0,2
UKR,,2017.0,1236,0,1236
,RUS,2013.0,15290,0,15290
,CZE,2019.0,1048,0,1048
PRI,,2009.0,61,0,61
BGR,,2020.0,625,0,625
NER,KEN,2007.0,1,0,1
MKD,GBR,2020.0,1,0,1
,AUT,2009.0,2650,0,2650
,CYP,2006.0,101,0,101
TZA,,2020.0,227,0,227
MOZ,,2010.0,13,0,13
HUN,,2006.0,471,0,471
BRA,NGA,2006.0,1,0,1
,CZE,2010.0,2644,0,2644
,CIV,2005.0,145,0,145
TUR,PSE,2012.0,4,0,4
HUN,MEX,2011.0,2,0,2
KOR,KAZ,2010.0,2,0,2
,SVK,2013.0,1108,0,1108
MOZ,,2017.0,32,0,32
FRA,GUY,2004.0,1,0,1
MKD,,2024.0,497,0,497
,PRY,2010.0,35,0,35
DOM,,2015.0,9,0,9
ALB,,2023.0,298,0,298
,LBR,2010.0,7,0,7
CYP,IRL,2019.0,3,0,3
,DOM,2013.0,18,0,18
BOL,,2017.0,40,0,40
ZMB,ITA,2013.0,1,0,1
,CZE,2017.0,2361,0,2361
,LUX,2012.0,143,0,143
MAC,,2018.0,58,0,58
PER,,2006.0,31,0,31
MOZ,,2019.0,58,0,58
KHM,,2023.0,162,0,162
SOM,KEN,2015.0,1,0,1
BOL,,2010.0,15,0,15
ZAF,,2000.0,34,0,34
,OMN,2014.0,187,0,187
BRN,BFA,2018.0,3,0,3
NGA,LSO,2017.0,1,0,1
,MAC,2003.0,23,0,23
BRA,NZL,2019.0,11,0,11
JPN,BHS,2021.0,1,0,1
MNG,NOR,2018.0,1,0,1
MAR,,2005.0,150,0,150
SAU,,2006.0,163,0,163
IRN,TWN,2013.0,4,0,4
GRD,,2020.0,21,0,21
COD,,2020.0,28,0,28
ROU,ARG,2009.0,3,0,3
,NZL,2018.0,1203,0,1203
,PRY,2017.0,77,0,77
GTM,,2022.0,76,0,76
PRY,,2020.0,39,0,39
CHL,PRY,2022.0,1,0,1
MAC,MOZ,2021.0,1,0,1
BRA,SLV,2019.0,1,0,1
PRT,,2007.0,340,0,340
,MNE,2017.0,39,0,39
,HRV,2011.0,1027,0,1027
TTO,,2024.0,233,0,233
CUB,GBR,2014.0,1,0,1
,MNE,2010.0,52,0,52
,TCD,2006.0,1,0,1
NOR,,2004.0,294,0,294
KHM,SGP,2019.0,1,0,1
GRC,MLT,2018.0,1,0,1
ARG,LUX,2017.0,1,0,1
JPN,KAZ,2016.0,4,0,4
,SLV,2011.0,7,0,7
ERI,GBR,2014.0,1,0,1
,CMR,1994.0,44,0,44
,MKD,1998.0,58,0,58
BLR,NLD,2005.0,2,0,2
BIH,NOR,2020.0,3,0,3
GRC,NZL,2020.0,2,0,2
ECU,,2015.0,42,0,42
UGA,LBR,2018.0,1,0,1
DEU,UZB,2020.0,3,0,3
ITA,SWZ,2020.0,1,0,1
DJI,,2018.0,5,0,5
,LBR,2017.0,18,0,18
,BFA,2000.0,80,0,80
NCL,,2014.0,7,0,7
,GHA,2001.0,110,0,110
,CIV,2002.0,110,0,110
CMR,GAB,2016.0,2,0,2
JPN,BGR,2015.0,3,0,3
AUT,LVA,2016.0,2,0,2
NAM,,2007.0,12,0,12
CIV,GHA,2016.0,3,0,3
,LKA,1996.0,37,0,37
,GLP,2010.0,11,0,11
RWA,,2014.0,14,0,14
PHL,COL,2020.0,1,0,1
ZMB,MWI,2010.0,1,0,1
PSE,,2013.0,23,0,23
GMB,,2015.0,11,0,11
IRQ,BHR,2013.0,1,0,1
BEL,MAR,2006.0,1,0,1
GHA,,2009.0,21,0,21
,URY,1995.0,47,0,47
FIN,SAU,2015.0,3,0,3
AUS,CUB,1999.0,1,0,1
MDA,ITA,2005.0,1,0,1
AUT,SGP,2003.0,2,0,2
NOR,ZWE,1999.0,1,0,1
ITA,COG,2004.0,1,0,1
,MKD,1997.0,14,0,14
CHN,GUM,2018.0,1,0,1
NER,FRA,1997.0,1,0,1
BRA,HUN,2004.0,1,0,1
ESP,MDA,2000.0,3,0,3
PAK,,2000.0,12,0,12
MYS,ARG,2011.0,1,0,1
OMN,,2009.0,32,0,32
BGD,,2025.0,28,0,28
PAK,NLD,2008.0,3,0,3
KWT,ARE,2012.0,2,0,2
,DJI,2010.0,7,0,7
SVK,HRV,2001.0,4,0,4
HND,,2007.0,1,0,1
NER,,2006.0,2,0,2
GBR,MAC,2007.0,2,0,2
,MMR,2003.0,12,0,12
PHL,KOR,2004.0,1,0,1
DEU,MDA,2014.0,3,0,3
FRA,MKD,2011.0,1,0,1
USA,MLT,2013.0,1,0,1
BOL,,2019.0,38,0,38
NZL,NAM,2008.0,1,0,1
JOR,KWT,2016.0,4,0,4
,NER,2008.0,12,0,12
ALB,SWE,2020.0,1,0,1
SDN,OMN,2017.0,3,0,3
ZAF,CZE,2013.0,1,0,1
SGP,CZE,2021.0,2,0,2
SWE,ARE,2022.0,3,0,3
GRL,,2019.0,6,0,6
,SUR,2011.0,6,0,6
ECU,ISR,2015.0,1,0,1
BGR,NOR,2018.0,3,0,3
DZA,PRT,2017.0,1,0,1
DZA,NOR,2007.0,1,0,1
CHN,ISL,2022.0,1,0,1
AUS,SLE,2021.0,1,0,1
EGY,NGA,2017.0,2,0,2
UKR,KOR,2021.0,1,0,1
BGR,HUN,2020.0,1,0,1
SVK,RUS,2000.0,3,0,3
SYR,OMN,2013.0,3,0,3
OMN,IRQ,2017.0,2,0,2
GUM,CAN,2006.0,1,0,1
,GNB,2011.0,11,0,11
NZL,KHM,2019.0,1,0,1
MAR,,2002.0,21,0,21
,LIE,2011.0,5,0,5
TZA,BEL,2019.0,1,0,1
NLD,MMR,2021.0,1,0,1
SDN,BRA,2001.0,1,0,1
CAF,CMR,2020.0,1,0,1
AUS,VNM,2006.0,6,0,6
AZE,FRA,2020.0,2,0,2
MDA,USA,2010.0,1,0,1
CZE,ARG,2011.0,1,0,1
TUR,YEM,2005.0,1,0,1
MEX,SYR,2008.0,2,0,2
CMR,JOR,2001.0,1,0,1
ITA,MUS,2014.0,2,0,2
RUS,NZL,2002.0,1,0,1
HUN,CZE,2010.0,3,0,3
HUN,SGP,2021.0,1,0,1
JPN,SAU,2009.0,8,0,8
CHN,NGA,2006.0,1,0,1
ZAF,VNM,2004.0,1,0,1
,COD,1998.0,1,0,1
,GIN,2000.0,4,0,4
ARM,MEX,2012.0,1,0,1
SRB,MNE,2008.0,7,0,7
HUN,SVK,2008.0,1,0,1
EUE,ESP,2011.0,2,0,2
BDI,UGA,2015.0,1,0,1
GRC,HRV,2011.0,1,0,1
SAU,NPL,2004.0,1,0,1
ROU,SVN,2010.0,1,0,1
,MDV,2007.0,2,0,2
SVK,CAN,2006.0,1,0,1
FIN,NGA,2015.0,4,0,4
MWI,BWA,2002.0,1,0,1
BWA,MWI,2012.0,1,0,1
GUY,,2018.0,5,0,5
JPN,FJI,2016.0,4,0,4
GHA,BEN,2016.0,1,0,1
FRO,CAN,2013.0,1,0,1
GBR,BEN,2017.0,2,0,2
CHN,TZA,2017.0,5,0,5
CAN,ISL,2001.0,2,0,2
CUB,AUS,2018.0,1,0,1
CHN,SAU,2007.0,1,0,1
IRL,ROU,2022.0,2,0,2
UKR,LVA,2020.0,2,0,2
ROU,PRT,1999.0,2,0,2
CHE,SRB,2022.0,2,0,2
ITA,LBY,2005.0,1,0,1
GBR,TGO,2007.0,1,0,1
MDA,GBR,2004.0,1,0,1
PRT,ZAF,2009.0,2,0,2
SVK,DNK,2003.0,2,0,2
JPN,LAO,2012.0,2,0,2
ARG,DNK,2015.0,3,0,3
SRB,ESP,2021.0,3,0,3
BRA,GTM,2022.0,1,0,1
ETH,TZA,2014.0,3,0,3
MEX,PRT,2006.0,3,0,3
USA,MUS,2009.0,1,0,1
PHL,IDN,2003.0,1,0,1
ITA,SVK,2012.0,3,0,3
GRC,KEN,2011.0,2,0,2
PRY,DEU,2021.0,1,0,1
TUN,CZE,2021.0,2,0,2
CRI,NLD,2017.0,3,0,3
URY,PER,2021.0,1,0,1
NZL,MUS,2017.0,1,0,1
SVN,BLR,2020.0,1,0,1
,PRY,2019.0,25,0,25
,GLP,2019.0,1,0,1
,DJI,2017.0,4,0,4
RUS,ARM,2022.0,7,0,7
NGA,NZL,2022.0,2,0,2
LBY,,2003.0,7,0,7
BGD,ETH,2016.0,1,0,1
NOR,CZE,2000.0,1,0,1
FRA,CUB,1997.0,2,0,2
GRC,TUR,2006.0,1,0,1
RUS,BEN,2012.0,1,0,1
GRL,,2017.0,6,0,6
GHA,SLE,2019.0,1,0,1
ZWE,TGO,2001.0,1,0,1
QAT,RUS,2015.0,2,0,2
CHN,TUR,2002.0,4,0,4
SVN,IRL,2007.0,1,0,1
SYR,ITA,2017.0,1,0,1
AUS,BHR,2010.0,1,0,1
ESP,SGP,1999.0,1,0,1
PRI,NLD,2017.0,2,0,2
MEX,IRL,2010.0,2,0,2
PRT,MOZ,2002.0,2,0,2
SEN,ESP,2022.0,1,0,1
DEU,KNA,2004.0,1,0,1
DEU,ARE,2009.0,2,0,2
,BRB,2006.0,13,0,13
DEU,NIC,2016.0,1,0,1
AUS,BHR,2019.0,2,0,2
URY,ESP,1998.0,1,0,1
VUT,,2024.0,23,0,23
AUT,BTN,2016.0,1,0,1
KWT,MAR,2011.0,1,0,1
HRV,PRT,2015.0,3,0,3
LBN,KWT,2016.0,2,0,2
TWN,KAZ,2019.0,1,0,1
THA,MDG,2007.0,1,0,1
FRA,TGO,2003.0,2,0,2
CRI,,1999.0,5,0,5
ESP,JOR,2016.0,3,0,3
,IRQ,1994.0,20,0,20
SVN,MNE,2012.0,1,0,1
BIH,RUS,2011.0,1,0,1
ARG,LUX,2019.0,2,0,2
MAR,CHL,2021.0,2,0,2
ZMB,MWI,2019.0,2,0,2
UGA,SOM,2020.0,2,0,2
BEL,IDN,2001.0,1,0,1
BEL,COD,2004.0,1,0,1
RUS,HRV,2015.0,2,0,2
SVN,BIH,2010.0,1,0,1
TTO,ESP,2006.0,1,0,1
HND,USA,2006.0,3,0,3
PAN,POL,2002.0,1,0,1
TCA,USA,2015.0,2,0,2
TCA,NOR,2018.0,1,0,1
NZL,IDN,2011.0,2,0,2
MSR,,2020.0,4,0,4
BGR,IND,2011.0,1,0,1
GBR,NCL,2010.0,1,0,1
FIN,ISR,2017.0,4,0,4
ROU,MEX,2017.0,1,0,1
THA,NGA,2022.0,2,0,2
BIH,KWT,2019.0,1,0,1
MYS,ISL,2018.0,1,0,1
MYS,SOM,2021.0,2,0,2
UGA,NOR,2004.0,1,0,1
BGR,CAN,2002.0,2,0,2
ARM,KAZ,2008.0,1,0,1
GEO,JPN,2002.0,1,0,1
BFA,COG,2016.0,1,0,1
ROU,BRA,1999.0,2,0,2
NOR,ROU,2017.0,1,0,1
CPV,,2015.0,3,0,3
HRV,ITA,2008.0,2,0,2
PRT,LUX,2021.0,4,0,4
AUT,EST,2002.0,1,0,1
DZA,JPN,2003.0,2,0,2
ISR,NGA,2012.0,1,0,1
GRC,IRL,2002.0,2,0,2
HUN,EGY,2016.0,3,0,3
HKG,ARE,2019.0,2,0,2
SGP,NOR,2014.0,5,0,5
ROU,UKR,2013.0,2,0,2
SDN,OMN,2019.0,2,0,2
AUS,PSE,2017.0,1,0,1
MRT,MAR,2010.0,1,0,1
NER,FRA,1998.0,5,0,5
TON,,2018.0,1,0,1
BEL,NPL,2020.0,1,0,1
HUN,ARE,2010.0,1,0,1
CZE,ROU,2001.0,1,0,1
VNM,KEN,2018.0,1,0,1
MAR,ARE,2011.0,2,0,2
PRT,ROU,2008.0,4,0,4
KHM,FRA,2007.0,3,0,3
PAK,NPL,2006.0,1,0,1
UGA,CUB,2009.0,1,0,1
NGA,COG,2014.0,2,0,2
DEU,LIE,2000.0,3,0,3
JPN,CIV,2006.0,1,0,1
URY,NLD,2001.0,1,0,1
SWE,ARG,1997.0,1,0,1
VEN,CHL,2015.0,4,0,4
OMN,DZA,2018.0,1,0,1
JPN,PRI,2011.0,1,0,1
MDG,GUF,2002.0,1,0,1
JAM,GBR,1999.0,3,0,3
MWI,BWA,2005.0,1,0,1
ARG,ALB,2016.0,1,0,1
ZMB,THA,2020.0,1,0,1
ARM,GRC,2010.0,1,0,1
AUS,BGR,2017.0,1,0,1
BGR,IRL,2020.0,2,0,2
THA,CZE,2011.0,1,0,1
CHN,CAF,2018.0,2,0,2
GBR,GTM,2016.0,2,0,2
CHN,NER,2018.0,1,0,1
SRB,MCO,2017.0,1,0,1
PNG,FRA,2012.0,1,0,1
TWN,SWZ,2015.0,1,0,1
POL,PAK,2016.0,1,0,1
ERI,THA,2016.0,1,0,1
SAU,GRC,2021.0,4,0,4
LKA,HKG,2021.0,1,0,1
RUS,TKM,2000.0,1,0,1
SDN,OMN,2010.0,1,0,1
GUM,,2011.0,3,0,3
FIN,ARG,2017.0,1,0,1
LBN,SWE,2004.0,1,0,1
IRL,SVN,2004.0,1,0,1
ARM,SWE,2000.0,1,0,1
URY,DNK,2007.0,1,0,1
PNG,CAN,2001.0,3,0,3
GBR,JAM,1998.0,1,0,1
POL,ECU,2015.0,1,0,1
KOR,HUN,2016.0,2,0,2
UKR,EST,2013.0,2,0,2
OMN,IRL,2015.0,1,0,1
CYP,ITA,2006.0,1,0,1
TUN,MRT,2010.0,1,0,1
BEL,MLI,2021.0,1,0,1
AUS,BIH,2017.0,1,0,1
DEU,COL,2004.0,2,0,2
ISR,MLT,2021.0,1,0,1
VNM,KHM,2015.0,1,0,1
ARG,IRL,2022.0,1,0,1
AGO,NOR,2014.0,1,0,1
NGA,LTU,2022.0,2,0,2
TWN,FJI,2021.0,1,0,1
SEN,CAF,2003.0,1,0,1
CHN,NPL,2002.0,1,0,1
URY,AUS,2003.0,1,0,1
IRQ,NOR,2009.0,1,0,1
TUN,MRT,2017.0,1,0,1
VEN,ISR,2008.0,1,0,1
CUB,MCO,2017.0,1,0,1
BMU,GBR,2021.0,1,0,1
BGR,CAN,2005.0,2,0,2
GAB,AUT,2015.0,1,0,1
CMR,PHL,2015.0,1,0,1
ZAF,UKR,2000.0,1,0,1
,MNE,2019.0,23,0,23
MTQ,,2003.0,3,0,3
CAN,LSO,2013.0,1,0,1
ZWE,FRA,2016.0,2,0,2
,MHL,2000.0,2,0,2
DZA,QAT,2016.0,1,0,1
CAF,GHA,2016.0,1,0,1
RUS,ECU,2020.0,2,0,2
AUT,PSE,2018.0,1,0,1
PRT,SGP,2016.0,2,0,2
TUR,PAK,2003.0,2,0,2
MWI,ZMB,2022.0,1,0,1
BGD,IDN,2013.0,1,0,1
ISL,AUT,2016.0,1,0,1
EGY,TUR,2003.0,2,0,2
IDN,YEM,2022.0,1,0,1
ISR,MEX,2005.0,3,0,3
MLT,AUS,2015.0,2,0,2
MWI,CAN,2003.0,1,0,1
IND,VNM,2013.0,2,0,2
UKR,COL,2005.0,1,0,1
CIV,COG,2005.0,1,0,1
GEO,ZAF,2008.0,2,0,2
BRN,TWN,2021.0,1,0,1
PER,MEX,2001.0,1,0,1
BLR,ISR,2001.0,1,0,1
ROU,AUT,1999.0,1,0,1
URY,MEX,1999.0,2,0,2
USA,HRV,1997.0,1,0,1
AUS,URY,2011.0,1,0,1
GUF,USA,2008.0,1,0,1
CHL,PRT,2010.0,3,0,3
KEN,ITA,2005.0,1,0,1
CHE,BIH,2009.0,1,0,1
BRA,SAU,2012.0,1,0,1
ROU,MEX,2019.0,2,0,2
PNG,MYS,2016.0,1,0,1
KOR,KAZ,2017.0,3,0,3
SYR,USA,2022.0,1,0,1
BGD,QAT,2022.0,1,0,1
LBN,TUR,2022.0,1,0,1
CAN,BTN,2017.0,1,0,1
OMN,NLD,2016.0,1,0,1
ARG,NZL,2015.0,1,0,1
BRB,,2015.0,2,0,2
POL,IDN,2016.0,1,0,1
CZE,CMR,2021.0,2,0,2
NZL,BOL,2007.0,1,0,1
ISR,OMN,2002.0,1,0,1
ZAF,BEN,2006.0,1,0,1
SVN,BIH,2017.0,1,0,1
SWE,BRB,2011.0,1,0,1
ISR,EGY,2007.0,1,0,1
BRA,PAN,2007.0,1,0,1
ARM,PRT,2018.0,2,0,2
LUX,POL,2022.0,1,0,1
USA,ATG,2015.0,1,0,1
TUR,ARE,2006.0,1,0,1
LKA,ITA,2015.0,1,0,1
QAT,NOR,2019.0,1,0,1
ITA,IRQ,2015.0,1,0,1
SEN,TUN,2019.0,1,0,1
LUX,ZAF,2021.0,1,0,1
KHM,CMR,2010.0,1,0,1
NPL,HKG,2002.0,1,0,1
PHL,DNK,2016.0,2,0,2
SWZ,BWA,2011.0,1,0,1
AUS,LVA,2006.0,1,0,1
BRA,GNB,2016.0,1,0,1
GRD,ITA,2020.0,1,0,1
ARM,HUN,1997.0,2,0,2
IDN,NOR,2004.0,1,0,1
AUS,ROU,2001.0,2,0,2
MCO,CHN,2008.0,1,0,1
NGA,LSO,2019.0,2,0,2
PRT,STP,2020.0,1,0,1
,DJI,2019.0,1,0,1
,ATG,2013.0,1,0,1
ITA,TTO,2014.0,1,0,1
CHE,EST,2004.0,1,0,1
UKR,BEL,2000.0,1,0,1
POL,SAU,2007.0,2,0,2
LAO,THA,2010.0,1,0,1
REU,DEU,2015.0,1,0,1
ARG,HUN,2021.0,1,0,1
CHE,VNM,2007.0,1,0,1
GLP,,2021.0,3,0,3
BGD,NLD,2004.0,1,0,1
NZL,PER,2015.0,1,0,1
,LBR,2019.0,5,0,5
CHE,SGP,2000.0,1,0,1
DEU,WSM,1999.0,1,0,1
COG,IND,2010.0,1,0,1
COD,ZWE,2022.0,1,0,1
THA,KOR,2005.0,1,0,1
CAN,BEN,2015.0,1,0,1
CHN,MWI,2020.0,4,0,4
COD,GUF,2022.0,1,0,1
,GUY,2000.0,2,0,2
ESP,KAZ,2021.0,1,0,1
NGA,KWT,2003.0,1,0,1
DEU,BWA,2002.0,1,0,1
MDA,CHE,2003.0,1,0,1
SVN,CHE,2001.0,2,0,2
GRC,UKR,1999.0,1,0,1
PAN,ISR,2001.0,1,0,1
COL,SWE,1997.0,1,0,1
GBR,JAM,1997.0,1,0,1
MCO,GRC,2000.0,1,0,1
BFA,ITA,2020.0,1,0,1
GBR,LBR,2020.0,1,0,1
PAN,ARG,2004.0,1,0,1
IRL,UGA,2013.0,1,0,1
SYR,AUS,2018.0,1,0,1
FRA,KAZ,2001.0,1,0,1
TUN,DNK,2013.0,1,0,1
ERI,NOR,2005.0,1,0,1
SRB,BRA,1998.0,1,0,1
ARM,BEL,2013.0,1,0,1
DNK,LBN,2017.0,1,0,1
NGA,BRA,2001.0,1,0,1
SWE,NGA,2020.0,1,0,1
MUS,IND,2018.0,1,0,1
ESP,SYR,2014.0,1,0,1
FIN,SGP,2014.0,1,0,1
IRN,LUX,2012.0,1,0,1
DEU,MMR,2017.0,1,0,1
BEL,KAZ,2015.0,1,0,1
PHL,FIN,2017.0,1,0,1
PHL,LVA,2016.0,1,0,1
PAK,MAR,2014.0,1,0,1
CHN,EST,2010.0,1,0,1
GEO,AUT,2019.0,1,0,1
IDN,IRQ,2019.0,1,0,1
NOR,MWI,2020.0,2,0,2
SRB,THA,2015.0,1,0,1
AIA,USA,2021.0,1,0,1
NZL,KHM,2017.0,1,0,1
QAT,NOR,2017.0,1,0,1
CHE,BOL,2012.0,2,0,2
BFA,NGA,2020.0,1,0,1
DNK,LBN,2019.0,1,0,1
SRB,MLT,2016.0,1,0,1
MKD,EGY,2019.0,1,0,1
CZE,CHL,2022.0,1,0,1
BHR,EGY,1999.0,1,0,1
FRA,SUR,2005.0,1,0,1
MCO,ITA,2021.0,1,0,1
NZL,KAZ,2020.0,1,0,1
ESP,PSE,2008.0,1,0,1
DEU,BWA,2005.0,1,0,1
MAR,MRT,2008.0,1,0,1
ZWE,NZL,2018.0,1,0,1
SAU,AFG,2021.0,1,0,1
CAN,PER,2006.0,1,0,1
AUS,BGR,2010.0,1,0,1
SWE,URY,1999.0,1,0,1
LUX,ITA,1999.0,1,0,1
BRN,AUS,2009.0,1,0,1
ZWE,MWI,2011.0,1,0,1
MDA,USA,2019.0,1,0,1
QAT,SRB,2019.0,1,0,1
ROU,POL,2001.0,1,0,1
ETH,MEX,2012.0,1,0,1
HUN,PHL,2015.0,1,0,1
ISL,RUS,2018.0,1,0,1
DOM,PER,2005.0,1,0,1
USA,CAF,2007.0,1,0,1
KOR,TUN,2012.0,1,0,1
BOL,ITA,2009.0,1,0,1
ISR,TWN,2002.0,1,0,1
FRA,TZA,2012.0,1,0,1
MAC,BRA,2013.0,1,0,1
MLI,COG,2017.0,1,0,1
ESP,GHA,2011.0,1,0,1
KHM,NLD,2013.0,1,0,1
FRA,MMR,2017.0,1,0,1
ZAF,JPN,2022.0,1,0,1
KHM,IND,2021.0,1,0,1
,GLP,2017.0,1,0,1
PNG,KHM,2015.0,1,0,1
RUS,KGZ,2001.0,1,0,1
TUN,IRN,2014.0,1,0,1
BEN,CMR,2004.0,1,0,1
HRV,QAT,2016.0,1,0,1
PNG,NZL,2016.0,1,0,1
TKM,ISR,2002.0,1,0,1
GEO,RUS,2001.0,1,0,1
NOR,MOZ,2005.0,1,0,1
COG,IND,2019.0,1,0,1
CHN,TZA,2010.0,1,0,1
FIN,ARG,2019.0,1,0,1
ATG,,2011.0,1,0,1
GBR,KNA,2013.0,1,0,1
NOR,SOM,2017.0,1,0,1
HKG,ARE,2010.0,1,0,1
CYP,ROU,2017.0,1,0,1
HRV,POL,2010.0,2,0,2
ERI,NOR,2002.0,1,0,1
USA,TLS,2020.0,1,0,1
TLS,IDN,2017.0,1,0,1
BLR,SAU,2017.0,1,0,1
TWN,MWI,2019.0,1,0,1
ESP,TZA,2010.0,1,0,1
HUN,KGZ,2016.0,1,0,1
NLD,RWA,2018.0,1,0,1
USA,NER,2020.0,1,0,1
NOR,ZMB,2021.0,1,0,1
ISR,USA,2020.0,362,336,26
HUN,DEU,2016.0,60,27,33
CUB,GBR,2004.0,3,1,2
ZAF,BRA,2012.0,1,2,-1
DEU,USA,2011.0,1168,1047,121
NLD,USA,2010.0,272,301,-29
POL,PRT,2017.0,5,6,-1
USA,CAN,2013.0,1394,1650,-256
USA,ISR,2007.0,224,343,-119
DNK,SWE,2010.0,50,79,-29
AUT,GBR,2014.0,75,64,11
CHN,HKG,2009.0,263,243,20
USA,AUS,2006.0,416,369,47
TUN,SAU,2021.0,91,39,52
USA,DEU,2020.0,1037,1001,36
NOR,NLD,2021.0,21,30,-9
KOR,CHN,2015.0,171,68,103
ITA,NLD,2007.0,68,57,11
EGY,GRC,2005.0,1,1,0
EGY,DEU,2012.0,23,67,-44
USA,IND,2007.0,406,716,-310
GBR,IRN,2012.0,54,26,28
USA,ESP,2004.0,261,286,-25
AUT,BEL,2010.0,9,5,4
GBR,ESP,2013.0,246,360,-114
AUT,CHE,2012.0,87,54,33
JPN,IDN,2016.0,148,27,121
DEU,PAK,2011.0,20,17,3
ZAF,ZMB,2018.0,11,7,4
FRA,GRC,2017.0,22,39,-17
DEU,CAN,2012.0,172,171,1
POL,RUS,2021.0,16,11,5
CAN,AUS,2002.0,78,79,-1
GRC,USA,2016.0,124,77,47
FRA,GRC,2019.0,28,35,-7
RUS,CAN,1999.0,30,3,27
CHL,AUS,2010.0,8,6,2
BRA,ESP,2006.0,22,25,-3
DEU,NLD,2013.0,211,228,-17
FRA,CMR,2014.0,20,12,8
ESP,MEX,2007.0,81,72,9
BRA,AUS,2015.0,44,31,13
USA,IRL,2011.0,115,135,-20
DNK,IND,2009.0,2,11,-9
CAN,AUS,2005.0,100,100,0
IND,SGP,2008.0,41,17,24
TUR,JPN,2011.0,10,10,0
ESP,PRT,2008.0,46,42,4
FRA,BRA,2006.0,66,52,14
NLD,IND,2006.0,11,18,-7
GBR,TWN,1998.0,2,1,1
NZL,CHN,2018.0,19,29,-10
HKG,THA,2019.0,2,5,-3
CHN,SGP,2006.0,73,103,-30
AUS,HKG,2008.0,21,34,-13
USA,MEX,2007.0,161,143,18
USA,ITA,2016.0,300,567,-267
DNK,NOR,2021.0,45,35,10
AUS,BGR,2018.0,2,2,0
JPN,USA,2002.0,1304,1061,243
GBR,GRC,2016.0,112,250,-138
JPN,CAN,2005.0,96,58,38
SDN,SAU,2022.0,14,6,8
USA,HND,2009.0,3,2,1
ITA,USA,1997.0,80,157,-77
CZE,USA,2006.0,47,45,2
DEU,ESP,2011.0,148,143,5
FRA,AUS,2011.0,84,64,20
NLD,EST,2005.0,2,1,1
NZL,SWE,2014.0,15,4,11
JAM,BRB,2019.0,1,1,0
JPN,CAN,2002.0,91,85,6
GBR,NOR,2007.0,44,28,16
NLD,USA,2017.0,370,363,7
FRA,GRC,2010.0,17,30,-13
SAU,CHN,2016.0,25,31,-6
PRT,NLD,2012.0,23,22,1
POL,USA,2004.0,128,97,31
CHE,ZAF,2013.0,5,8,-3
RUS,BLR,2013.0,11,12,-1
CAN,NLD,2010.0,58,48,10
GBR,NLD,2020.0,293,296,-3
CHN,JPN,2006.0,207,318,-111
ISR,DEU,2007.0,24,19,5
AUT,SRB,2010.0,2,2,0
BEL,KOR,2022.0,3,4,-1
USA,BEL,2015.0,138,154,-16
CHN,DEU,2000.0,48,30,18
TWN,IDN,2019.0,39,24,15
NZL,DNK,2020.0,5,5,0
TUR,CHN,2019.0,11,4,7
NLD,USA,2019.0,386,325,61
CZE,SVK,2022.0,26,12,14
FRA,CHN,2011.0,90,116,-26
KOR,IND,2021.0,105,173,-68
ITA,DEU,2021.0,213,211,2
DEU,IND,2019.0,143,179,-36
SVK,AUT,2014.0,9,8,1
CHN,GBR,2008.0,134,144,-10
JPN,IND,2006.0,54,53,1
SWE,DEU,2018.0,145,167,-22
FRA,ITA,2018.0,279,337,-58
USA,RUS,2003.0,216,290,-74
NGA,GBR,2022.0,36,15,21
BRA,CAN,2018.0,127,59,68
MYS,IRQ,2016.0,92,17,75
EGY,SWE,2018.0,7,5,2
CHN,ISR,2009.0,8,12,-4
SLB,AUS,2015.0,1,3,-2
DEU,IND,2017.0,111,184,-73
IRL,IND,2021.0,14,28,-14
IND,SWE,2018.0,68,22,46
IND,ITA,2018.0,45,34,11
NLD,DEU,2016.0,290,266,24
DNK,MYS,2022.0,1,1,0
JPN,SGP,2014.0,31,27,4
CAN,SWE,2020.0,37,30,7
CAN,POL,2016.0,22,17,5
IND,CHN,2020.0,220,87,133
CAN,NLD,2019.0,64,60,4
CAN,CHN,2022.0,196,152,44
CAN,DNK,2020.0,35,24,11
THA,SWE,2018.0,2,5,-3
TUR,CHN,2017.0,11,3,8
ETH,AUS,2017.0,11,5,6
ARG,USA,2016.0,71,62,9
ETH,IND,2016.0,8,49,-41
AUS,AUT,2021.0,12,12,0
SAU,YEM,2015.0,2,12,-10
CIV,SEN,2017.0,1,1,0
USA,KOR,1999.0,217,133,84
NLD,JPN,2011.0,14,14,0
MTQ,FRA,2002.0,9,7,2
JPN,SWE,2017.0,23,31,-8
CHL,PRT,2018.0,6,3,3
PER,BRA,2015.0,7,20,-13
NLD,BEL,2018.0,164,170,-6
USA,HUN,2020.0,37,49,-12
CAN,NOR,2009.0,13,8,5
KOR,ARE,2014.0,7,1,6
BEL,LUX,2019.0,14,8,6
NGA,KOR,2003.0,1,1,0
DEU,NOR,2020.0,66,46,20
THA,BEL,2016.0,3,3,0
CHN,MYS,2022.0,22,28,-6
GHA,GBR,2019.0,20,29,-9
MYS,GBR,2013.0,54,184,-130
LUX,BEL,2016.0,5,15,-10
CAN,NLD,2017.0,56,70,-14
BRA,MOZ,2016.0,8,6,2
CHL,AUS,2019.0,27,20,7
MEX,IRL,2018.0,2,1,1
JPN,TWN,2005.0,23,15,8
FRA,MLI,2009.0,8,5,3
MYS,USA,2019.0,59,43,16
NPL,KOR,2014.0,9,2,7
KOR,NLD,2021.0,14,7,7
NZL,NLD,2018.0,12,11,1
USA,JOR,2020.0,45,46,-1
POL,CZE,2020.0,27,14,13
MEX,CAN,2020.0,53,30,23
USA,NOR,2022.0,46,33,13
PAK,ITA,2018.0,12,20,-8
JPN,GBR,2005.0,96,106,-10
PSE,FRA,2019.0,6,5,1
ARE,USA,2021.0,71,67,4
BEL,ZAF,2019.0,6,9,-3
MMR,JPN,2017.0,5,2,3
BGD,AUS,2019.0,82,57,25
CAN,BRA,2019.0,49,148,-99
JPN,SWE,2019.0,26,26,0
AUT,NZL,2016.0,5,2,3
ESP,BEL,2021.0,63,52,11
KAZ,AUS,2019.0,2,3,-1
IND,JPN,2006.0,53,54,-1
ESP,DEU,2000.0,38,42,-4
ESP,COL,2011.0,50,38,12
CHE,SVK,2007.0,5,1,4
NGA,MYS,2020.0,29,90,-61
GBR,CHE,2001.0,87,98,-11
JPN,ZMB,2020.0,5,3,2
IRL,MEX,2019.0,1,3,-2
JPN,GBR,2002.0,111,125,-14
DEU,IND,2010.0,66,122,-56
BGD,PAK,2014.0,6,11,-5
EGY,CAN,2011.0,22,26,-4
NPL,USA,2021.0,37,16,21
SWE,GBR,2012.0,108,146,-38
CAN,EGY,2021.0,32,36,-4
IRN,MYS,2016.0,29,170,-141
AUS,ARE,2016.0,21,7,14
RUS,GBR,2001.0,70,20,50
BRA,DEU,2011.0,60,67,-7
HRV,SVN,2015.0,9,6,3
GRD,USA,2020.0,6,13,-7
DEU,TUR,1999.0,5,2,3
EGY,YEM,2009.0,5,1,4
IRL,FRA,2017.0,17,35,-18
CZE,DEU,2005.0,24,21,3
USA,ISL,2015.0,17,13,4
DEU,RUS,1997.0,36,36,0
ARE,CHN,2013.0,3,1,2
ZAF,USA,2011.0,55,70,-15
DEU,DNK,2011.0,94,62,32
SAU,CAN,2012.0,26,84,-58
PAK,MYS,2013.0,30,18,12
USA,FIN,2014.0,62,66,-4
IRL,FRA,2019.0,26,44,-18
USA,ROU,2015.0,20,20,0
AUS,USA,1999.0,145,161,-16
TWN,DEU,2007.0,8,14,-6
CAN,SGP,2015.0,25,22,3
HRV,USA,2014.0,12,11,1
IND,AUS,2005.0,40,13,27
SWE,ESP,2006.0,18,12,6
HRV,SRB,2016.0,6,5,1
SGP,JPN,2015.0,29,44,-15
CHE,IRN,2017.0,13,25,-12
ITA,GRC,2008.0,23,10,13
CAN,BRA,2010.0,39,67,-28
HUN,POL,2010.0,2,2,0
CAN,RUS,2013.0,14,16,-2
IRN,SWE,2009.0,6,14,-8
CAN,JOR,2011.0,11,9,2
CHN,YEM,2018.0,3,1,2
IND,TWN,2004.0,36,13,23
ETH,AUS,2019.0,22,10,12
CHN,CHE,2009.0,30,37,-7
PAN,USA,2002.0,7,8,-1
IND,TTO,2015.0,5,1,4
CAN,CHE,2015.0,94,73,21
POL,SVN,2014.0,2,2,0
MEX,ARG,2021.0,11,12,-1
HKG,GBR,2008.0,39,35,4
JPN,GHA,2016.0,2,2,0
IND,KOR,2001.0,17,4,13
CHL,USA,2002.0,35,63,-28
SWE,EST,2005.0,5,2,3
KOR,SWE,2011.0,7,2,5
HKG,DEU,2009.0,13,5,8
NOR,GBR,2009.0,25,46,-21
AUT,NOR,2016.0,14,9,5
MYS,USA,2017.0,59,41,18
CZE,DEU,2002.0,27,25,2
FRA,SAU,2021.0,20,13,7
CHE,CHN,2013.0,32,36,-4
TWN,GBR,2012.0,20,30,-10
USA,PER,2002.0,21,15,6
USA,ASM,2011.0,1,1,0
PAN,USA,2005.0,5,14,-9
MEX,USA,2000.0,61,36,25
AUT,BEL,2019.0,20,11,9
SRB,BIH,2021.0,8,7,1
FIN,AUS,2021.0,12,18,-6
TWN,IDN,2017.0,30,13,17
RUS,ESP,2022.0,7,1,6
NIC,USA,2020.0,1,1,0
TWN,SGP,2016.0,18,13,5
PRI,CHN,2009.0,2,4,-2
VNM,RUS,2013.0,4,7,-3
JOR,OMN,2012.0,1,3,-2
CYP,FRA,2019.0,1,4,-3
RUS,MEX,2013.0,2,2,0
DNK,BEL,2009.0,6,4,2
GBR,ZWE,2012.0,3,2,1
ITA,HUN,2022.0,3,4,-1
MMR,JPN,2019.0,2,22,-20
JOR,GBR,2018.0,13,31,-18
ZAF,GBR,2020.0,98,60,38
CYP,GRC,2015.0,12,39,-27
AUS,BGD,2018.0,40,70,-30
ARE,CAN,2012.0,14,20,-6
CAN,FIN,2020.0,11,19,-8
DEU,KOR,2022.0,25,25,0
CRI,NLD,2018.0,1,1,0
NLD,CRI,2020.0,4,4,0
DEU,ROU,2015.0,24,27,-3
CAN,CZE,2003.0,5,6,-1
VEN,DEU,2020.0,6,1,5
USA,GUM,2020.0,5,3,2
HKG,SAU,2021.0,3,5,-2
SVK,DEU,2008.0,19,11,8
BGD,NLD,2014.0,3,1,2
POL,CHE,2018.0,22,20,2
PRT,IND,2014.0,15,15,0
NOR,USA,2002.0,68,68,0
CAN,PRT,2022.0,10,4,6
SGP,AUS,2005.0,42,34,8
ITA,USA,1998.0,132,129,3
BRA,NZL,2018.0,4,4,0
FRA,ISR,2022.0,11,13,-2
KOR,PAK,2007.0,8,5,3
AUT,BRA,2011.0,4,5,-1
IRL,POL,2013.0,11,5,6
NLD,IRN,2007.0,9,9,0
NZL,FJI,2018.0,3,4,-1
DEU,CMR,2014.0,9,2,7
JPN,THA,2006.0,56,20,36
ARE,QAT,2017.0,12,8,4
ISL,SWE,2006.0,13,8,5
CAN,AUT,2005.0,14,16,-2
IND,AUT,2011.0,8,4,4
ZAF,GHA,2017.0,18,12,6
DNK,UKR,2006.0,1,1,0
AUS,ISR,2015.0,8,15,-7
NGA,ITA,2016.0,1,2,-1
NOR,HKG,2006.0,1,1,0
ESP,PER,2015.0,16,8,8
SWE,RUS,2014.0,15,12,3
TUR,CAN,2005.0,7,6,1
AUT,FRA,2004.0,10,13,-3
DEU,GHA,2016.0,8,8,0
USA,MDG,2018.0,3,3,0
USA,PER,2005.0,15,23,-8
AUT,ZAF,2006.0,3,2,1
IDN,FRA,2014.0,4,13,-9
MNG,USA,2006.0,1,2,-1
SGP,AUS,2002.0,27,34,-7
BRA,FRA,2004.0,31,55,-24
CHL,FRA,2000.0,4,6,-2
BLR,POL,2008.0,4,4,0
RUS,FIN,2001.0,17,6,11
BGD,USA,2004.0,9,5,4
IND,FIN,2006.0,2,1,1
USA,ARE,2003.0,16,7,9
GRC,CYP,2003.0,2,4,-2
OMN,GBR,2003.0,6,4,2
FIN,ESP,2001.0,4,1,3
RUS,NLD,2005.0,14,9,5
PAK,JPN,2003.0,2,3,-1
ITA,RUS,2012.0,14,15,-1
NOR,USA,2005.0,46,50,-4
DEU,CHL,2002.0,13,10,3
DEU,ZAF,2008.0,19,11,8
IND,ZAF,2011.0,28,10,18
POL,CAN,1999.0,5,3,2
GLP,FRA,2013.0,13,16,-3
IND,IRN,1999.0,1,3,-2
FIN,CHN,2018.0,30,26,4
NLD,SVK,2005.0,1,3,-2
FRA,AUT,2004.0,13,10,3
BOL,DEU,2002.0,1,1,0
NLD,SVK,2002.0,1,7,-6
ROU,ITA,2005.0,11,7,4
AUT,BGR,2006.0,2,3,-1
QAT,SAU,2018.0,4,15,-11
JPN,ROU,2011.0,2,1,1
FRA,MAR,1999.0,23,11,12
DEU,PHL,2015.0,6,5,1
ROU,ITA,2002.0,7,2,5
CHE,PHL,2013.0,8,3,5
HRV,ITA,2013.0,6,4,2
UKR,USA,2003.0,42,34,8
DEU,CHL,2005.0,18,17,1
USA,MYS,2004.0,20,7,13
SVK,USA,1999.0,8,8,0
DEU,HUN,1997.0,8,4,4
DEU,HUN,1998.0,12,10,2
IND,AUS,2002.0,22,12,10
NZL,SGP,2008.0,13,7,6
BRA,GBR,1999.0,11,18,-7
HUN,CHN,2016.0,6,2,4
BEL,BRA,2013.0,18,12,6
SWE,CAN,2000.0,7,5,2
DNK,DEU,1999.0,17,26,-9
CAN,AUT,2002.0,9,10,-1
ESP,IRL,2011.0,20,13,7
IRN,GBR,2009.0,35,51,-16
VNM,SWE,2017.0,2,2,0
IRL,JPN,2010.0,4,7,-3
NZL,FRA,2008.0,11,13,-2
LTU,SWE,2009.0,3,8,-5
ESP,ISR,2014.0,8,8,0
EST,FIN,2000.0,2,3,-1
TUR,HUN,2007.0,2,1,1
ISR,ROU,2020.0,1,2,-1
FRA,IND,2016.0,72,85,-13
NZL,IRL,2016.0,4,10,-6
ECU,JPN,2018.0,2,2,0
AUS,ESP,1999.0,4,5,-1
ESP,CHE,2004.0,19,32,-13
MEX,VEN,2009.0,6,3,3
VEN,ESP,2020.0,17,6,11
BGD,KOR,2018.0,17,36,-19
GBR,GMB,2007.0,4,6,-2
MAR,GBR,2007.0,4,1,3
AUS,VEN,2012.0,1,2,-1
QAT,ITA,2017.0,4,3,1
CAN,ISR,2021.0,45,47,-2
NLD,THA,2006.0,4,4,0
ZAF,CAN,2007.0,20,10,10
NOR,IND,2013.0,7,10,-3
HKG,FIN,2012.0,3,1,2
CHE,RUS,2008.0,13,18,-5
CHN,NZL,2014.0,17,20,-3
CHE,COG,2009.0,1,1,0
DNK,POL,2008.0,5,10,-5
COL,CHE,2011.0,5,3,2
RUS,GRC,2006.0,4,3,1
NOR,ESP,2011.0,4,6,-2
FRA,REU,2015.0,7,8,-1
MYS,USA,2010.0,10,37,-27
TUN,OMN,2020.0,3,2,1
SAU,IND,2007.0,4,9,-5
ESP,NOR,2009.0,13,5,8
MOZ,ZAF,2015.0,1,1,0
ESP,AUS,2000.0,3,3,0
DEU,GAB,2016.0,2,3,-1
EGY,AUS,2016.0,9,2,7
SWE,KEN,2012.0,2,2,0
AUT,SWE,2013.0,15,13,2
AUT,SRB,2019.0,2,4,-2
IDN,CHE,2013.0,3,1,2
BWA,ZAF,2016.0,9,13,-4
IRL,BEL,2014.0,11,6,5
KOR,CHE,2014.0,13,6,7
BGD,JPN,2005.0,26,38,-12
LIE,AUT,2012.0,2,1,1
COG,USA,2015.0,5,1,4
COL,ARG,2020.0,18,18,0
NLD,ECU,2017.0,2,5,-3
TWN,ZAF,2012.0,1,1,0
CZE,BRA,2018.0,2,10,-8
SWE,FRA,1998.0,12,10,2
LAO,THA,2018.0,4,5,-1
CMR,DEU,2021.0,3,4,-1
SRB,MNE,2013.0,4,2,2
AUS,PHL,2014.0,6,11,-5
PRT,CHL,2015.0,3,3,0
CMR,FRA,2016.0,12,16,-4
VEN,BRA,2014.0,9,1,8
JPN,CZE,2016.0,12,10,2
NGA,IND,2016.0,8,5,3
UKR,NLD,2009.0,2,1,1
AUT,ISR,2017.0,3,6,-3
PAK,GBR,2009.0,23,34,-11
DNK,IRN,2022.0,7,16,-9
BEL,NOR,2022.0,5,2,3
SGP,ESP,2020.0,7,5,2
DEU,NAM,2016.0,1,1,0
UKR,GBR,2020.0,9,6,3
KOR,ISR,2013.0,6,3,3
BEL,LUX,2017.0,16,11,5
CHL,NLD,2016.0,8,7,1
UKR,DEU,2022.0,5,4,1
CHE,FIN,2022.0,7,8,-1
SWE,IRL,1999.0,2,1,1
MAR,DEU,2021.0,11,4,7
ETH,BEL,2017.0,1,4,-3
GBR,BEN,2018.0,1,1,0
CHE,ARG,2021.0,5,4,1
BEL,ZAF,2017.0,8,1,7
HUN,ESP,2016.0,2,4,-2
ZMB,ZAF,2020.0,7,15,-8
USA,IRQ,2022.0,14,7,7
MEX,CHE,2020.0,13,3,10
LKA,NZL,2021.0,2,4,-2
PSE,ISR,2018.0,10,11,-1
TWN,RUS,2009.0,5,4,1
UKR,RUS,2007.0,32,32,0
MYS,BGD,2001.0,2,1,1
AUS,FRA,2003.0,39,50,-11
DNK,FRA,2003.0,22,30,-8
DEU,ISR,1999.0,17,11,6
CHE,AUS,2003.0,34,22,12
NOR,GRC,2002.0,4,1,3
ROU,USA,2021.0,8,11,-3
JPN,PAK,2010.0,9,4,5
HKG,KOR,2010.0,7,4,3
CHN,IRQ,2016.0,18,2,16
URY,NLD,2003.0,1,1,0
OMN,JOR,2018.0,3,7,-4
BEL,EGY,2015.0,10,4,6
GBR,HRV,2016.0,4,11,-7
SVN,USA,2009.0,10,13,-3
CZE,CAN,2013.0,8,9,-1
AUT,FIN,2013.0,7,6,1
BFA,FRA,2021.0,4,8,-4
ITA,HRV,2002.0,5,5,0
NER,MAR,2017.0,1,1,0
IRL,FRA,2010.0,26,29,-3
POL,PRT,2010.0,6,5,1
CHE,HUN,2014.0,10,19,-9
AUT,BEL,2017.0,9,12,-3
MEX,BRA,2013.0,13,9,4
JPN,TWN,2002.0,20,17,3
TWN,IND,2009.0,26,59,-33
GBR,PHL,2010.0,5,2,3
TUN,BEL,2014.0,8,2,6
NLD,ECU,2019.0,4,2,2
AZE,TUR,2017.0,3,10,-7
LSO,ZAF,2018.0,2,6,-4
KAZ,AUS,2017.0,3,1,2
PAK,THA,2013.0,3,15,-12
CHE,LUX,2021.0,6,2,4
JPN,ISR,2001.0,6,11,-5
SAU,QAT,2017.0,16,5,11
SRB,CHN,2022.0,1,2,-1
SGP,PAK,2015.0,6,3,3
BRA,MLT,2020.0,1,1,0
RUS,CHN,2002.0,4,7,-3
HKG,KOR,2019.0,19,18,1
SWE,EST,2002.0,13,6,7
GEO,RUS,2003.0,6,2,4
CAN,KEN,2013.0,4,5,-1
FRA,LAO,2015.0,2,1,1
FRA,ECU,2002.0,3,1,2
GBR,ARE,2006.0,6,3,3
HKG,MYS,2013.0,5,1,4
ITA,AUT,1999.0,4,8,-4
NLD,RUS,2007.0,7,12,-5
UKR,DNK,2002.0,2,2,0
ISR,CHE,2022.0,10,3,7
PRT,NOR,2015.0,10,2,8
SAU,JPN,2015.0,4,20,-16
ROU,DEU,2005.0,17,17,0
CHE,IRL,2004.0,3,5,-2
BGR,USA,2008.0,8,7,1
CHE,NOR,2000.0,3,2,1
DZA,GBR,2020.0,3,2,1
MLI,SEN,2019.0,1,1,0
ECU,PER,2017.0,5,1,4
ISR,DNK,2003.0,4,1,3
KWT,EGY,2012.0,7,11,-4
CAN,LBN,1997.0,1,1,0
JOR,PAK,2021.0,3,3,0
RUS,KGZ,2003.0,2,2,0
IRL,JPN,2017.0,11,6,5
ROU,DEU,2002.0,20,8,12
EGY,LBN,2012.0,3,4,-1
FRA,OMN,2006.0,1,1,0
NLD,ISR,2013.0,6,7,-1
COL,GBR,2020.0,14,22,-8
SRB,NLD,2009.0,3,1,2
SAU,SYR,2018.0,1,2,-1
TZA,NOR,2019.0,4,5,-1
CHN,ARE,2019.0,9,3,6
IND,PRT,2016.0,10,11,-1
BGD,IND,2004.0,4,8,-4
QAT,CAN,2016.0,8,25,-17
ETH,BEL,2019.0,3,8,-5
CHL,GBR,2006.0,8,10,-2
GEO,DEU,2012.0,4,3,1
IND,GRC,2012.0,3,2,1
JPN,PAK,2017.0,8,3,5
VNM,SWE,2010.0,2,4,-2
CHE,IRN,2019.0,11,43,-32
ISR,ZAF,2017.0,2,3,-1
AUT,CZE,2002.0,10,14,-4
TWN,IDN,2010.0,1,2,-1
CZE,POL,2014.0,10,13,-3
USA,CMR,2010.0,3,4,-1
TWN,THA,2014.0,11,4,7
GRC,DEU,1999.0,5,17,-12
VEN,NLD,2017.0,1,1,0
TUR,SWE,2006.0,6,2,4
USA,OMN,2006.0,3,1,2
TUR,GRC,2013.0,3,2,1
KOR,KAZ,2018.0,8,1,7
BRA,JPN,2015.0,10,13,-3
IRL,HRV,2016.0,3,2,1
BEL,MYS,2014.0,2,4,-2
SWE,BGD,2015.0,2,5,-3
RUS,EGY,2016.0,2,2,0
BGD,AUS,2010.0,10,6,4
SEN,GIN,2021.0,2,2,0
LKA,USA,2013.0,17,9,8
NLD,IDN,2006.0,7,3,4
USA,MWI,2005.0,3,3,0
GBR,BLR,2012.0,4,1,3
SAU,MAR,2011.0,1,6,-5
USA,QAT,2006.0,9,1,8
DNK,MEX,2018.0,2,3,-1
KAZ,KOR,2020.0,4,8,-4
PAK,IND,2003.0,6,8,-2
JPN,BEL,2003.0,15,7,8
ITA,JPN,1998.0,9,5,4
SWE,IND,2003.0,7,9,-2
SWE,FRA,1997.0,4,8,-4
POL,IND,2012.0,3,16,-13
KOR,NZL,2021.0,3,4,-1
USA,ALB,2011.0,1,1,0
CZE,IRL,2021.0,5,5,0
HUN,CZE,2018.0,8,4,4
IDN,AUS,2012.0,11,27,-16
TWN,MWI,2018.0,2,1,1
DEU,CRI,2011.0,2,2,0
PAK,NLD,2013.0,5,7,-2
UGA,AUT,2012.0,2,1,1
BEL,NZL,2014.0,2,3,-1
IND,KEN,2009.0,1,2,-1
SVK,NLD,2014.0,6,4,2
DNK,NPL,2020.0,1,1,0
MNG,JPN,2020.0,5,8,-3
URY,GBR,2020.0,3,2,1
JPN,CHE,2014.0,29,30,-1
RWA,ZAF,2020.0,2,6,-4
DEU,SVN,2011.0,5,8,-3
ZWE,GBR,2020.0,7,3,4
BLR,RUS,2022.0,4,8,-4
CAN,NGA,2009.0,1,2,-1
ITA,NGA,2004.0,2,1,1
GBR,PNG,2007.0,2,1,1
NZL,GRC,2015.0,2,1,1
TUR,CAN,2002.0,9,4,5
ESP,JPN,2006.0,5,5,0
CMR,BEL,2009.0,4,1,3
SWE,SGP,2001.0,1,2,-1
SEN,DEU,2014.0,1,1,0
NOR,CAN,2008.0,4,11,-7
ROU,ESP,2003.0,4,3,1
SWE,LVA,2015.0,4,2,2
NZL,THA,2002.0,1,1,0
AUS,ROU,2003.0,3,2,1
JPN,CYP,2003.0,1,1,0
PAK,SAU,2007.0,12,11,1
ESP,FIN,2005.0,3,5,-2
EST,NLD,2003.0,1,3,-2
GBR,MLI,2009.0,1,1,0
SWE,TWN,2007.0,1,1,0
QAT,SRB,2018.0,3,3,0
TWN,POL,2006.0,1,1,0
CHL,ITA,2013.0,5,13,-8
DEU,SAU,2008.0,2,1,1
TZA,NOR,2017.0,2,7,-5
GBR,NCL,2018.0,1,1,0
AUS,POL,2022.0,5,2,3
HKG,THA,2017.0,3,2,1
RUS,ARM,2016.0,3,2,1
BEN,CIV,2021.0,1,1,0
SVK,SVN,2016.0,2,1,1
SWE,CHN,1997.0,3,5,-2
FIN,RUS,2006.0,10,10,0
COL,FRA,2011.0,8,14,-6
ISR,CHL,2017.0,2,2,0
JPN,ZAF,2001.0,2,1,1
BOL,FRA,2018.0,2,1,1
CAN,ROU,2020.0,4,7,-3
KOR,LUX,2017.0,2,1,1
SGP,NOR,2004.0,1,1,0
IRQ,TUR,2013.0,1,2,-1
USA,BHR,2011.0,4,1,3
ISR,ARG,2014.0,1,2,-1
IND,KWT,2008.0,5,2,3
ZWE,USA,2014.0,3,5,-2
PYF,USA,2002.0,2,1,1
PER,ESP,2004.0,1,5,-4
AUS,COL,2018.0,7,10,-3
MEX,AUS,2006.0,5,2,3
FRA,TGO,2001.0,4,1,3
COL,RUS,2005.0,1,3,-2
RUS,IND,2014.0,1,6,-5
NLD,POL,1999.0,3,3,0
HRV,ESP,2012.0,6,1,5
ROU,BEL,2022.0,3,4,-1
DNK,NZL,2015.0,2,8,-6
CHN,TZA,2018.0,3,3,0
SWE,CYP,2019.0,3,1,2
CHL,ECU,2016.0,8,3,5
IRL,VNM,2021.0,1,1,0
FRA,KOR,2004.0,5,8,-3
HUN,EGY,2022.0,1,4,-3
LKA,JPN,2004.0,4,4,0
UKR,JPN,2016.0,3,5,-2
AUS,PAK,2002.0,1,1,0
SAU,IRN,2022.0,1,2,-1
ETH,CYP,2021.0,1,1,0
AUT,GRC,2014.0,1,6,-5
NOR,GRC,2005.0,1,2,-1
PNG,AUS,2003.0,3,6,-3
FRA,TUR,1997.0,1,1,0
ARG,AUS,2013.0,4,4,0
TUR,DNK,2008.0,4,2,2
ARE,SWE,2019.0,3,9,-6
LBN,ITA,2007.0,2,2,0
CHE,EST,2014.0,2,4,-2
PSE,EGY,2004.0,1,1,0
VNM,IND,2020.0,2,8,-6
AUT,ISR,2019.0,4,3,1
QAT,AUS,2011.0,2,3,-1
TZA,ZAF,2009.0,1,1,0
CYP,IRL,2018.0,1,1,0
GBR,ARG,2013.0,12,17,-5
ISR,BEL,2020.0,1,7,-6
ZAF,SGP,2014.0,2,1,1
ARM,RUS,2009.0,5,7,-2
RUS,SRB,2019.0,5,5,0
AUS,PAK,2005.0,5,3,2
CAN,TUR,2009.0,10,13,-3
ISR,CHL,2010.0,3,1,2
USA,JAM,2004.0,4,4,0
SWE,CYP,2017.0,2,4,-2
KOR,DNK,2002.0,2,2,0
FIN,EST,2022.0,5,5,0
NZL,ISR,2020.0,1,2,-1
HKG,KOR,2017.0,9,10,-1
KEN,UGA,2022.0,4,4,0
RUS,GEO,2012.0,2,1,1
UGA,NOR,2014.0,1,1,0
FRA,JOR,2003.0,1,1,0
JPN,LKA,2012.0,4,1,3
PRT,NGA,2016.0,1,1,0
GBR,ZMB,1999.0,1,1,0
UZB,KAZ,1997.0,1,1,0
POL,NLD,2000.0,3,3,0
BRN,SGP,2016.0,1,3,-2
IND,BHR,2015.0,4,1,3
ITA,JPN,1997.0,5,5,0
THA,IDN,2001.0,1,1,0
EST,NOR,2014.0,1,1,0
ETH,BEL,2010.0,3,2,1
LBN,QAT,2014.0,2,1,1
HUN,SRB,2013.0,3,1,2
SWE,SVN,2014.0,2,3,-1
LUX,NOR,2013.0,1,3,-2
NLD,RWA,2019.0,1,1,0
VNM,BEL,2014.0,4,9,-5
PRT,ECU,2017.0,2,1,1
SVN,AUS,2014.0,1,1,0
CHN,ARE,2017.0,1,3,-2
BGD,EGY,2022.0,1,1,0
CHE,COL,2013.0,2,6,-4
TTO,USA,2015.0,2,7,-5
UZB,USA,2014.0,1,1,0
BGR,NOR,2017.0,1,3,-2
SWE,ARE,2016.0,4,2,2
ZAF,AUT,1999.0,2,4,-2
EGY,DNK,2020.0,1,5,-4
ZAF,TWN,2018.0,1,2,-1
COL,PRI,2006.0,3,2,1
DOM,USA,2021.0,1,1,0
MLI,SEN,2017.0,1,1,0
ITA,TUN,2022.0,5,4,1
SAU,DZA,2011.0,2,8,-6
ARE,DZA,2021.0,2,1,1
FRA,SYR,2006.0,3,1,2
NZL,AUT,2008.0,1,3,-2
HUN,ITA,2001.0,1,3,-2
URY,FRA,2003.0,3,1,2
HKG,NLD,2002.0,2,1,1
DEU,BGD,2001.0,1,3,-2
KOR,MEX,2015.0,1,3,-2
MNG,KOR,2007.0,1,2,-1
SVN,CHE,2003.0,2,1,1
ZAF,ITA,2007.0,2,2,0
SRB,VNM,2019.0,3,1,2
ZAF,KOR,2018.0,1,3,-2
HUN,POL,2019.0,3,3,0
JOR,AUS,2015.0,2,9,-7
GBR,BWA,2012.0,2,3,-1
GHA,GBR,2010.0,4,11,-7
ROU,JPN,2021.0,1,2,-1
DEU,VEN,2010.0,1,5,-4
ESP,CRI,2020.0,2,9,-7
CAN,SVK,2021.0,1,1,0
BIH,CZE,2019.0,1,1,0
HKG,ARE,2018.0,2,1,1
SVN,BIH,2018.0,1,1,0
ISL,RUS,2019.0,1,1,0
NOR,ISL,2003.0,3,7,-4
ITA,THA,2006.0,2,1,1
COL,VEN,2004.0,1,2,-1
MEX,BGD,2008.0,1,2,-1
IRN,AUT,2006.0,1,1,0
ECU,PER,2019.0,3,4,-1
DNK,RUS,2005.0,3,4,-1
DNK,RUS,2002.0,3,11,-8
BEL,THA,2003.0,2,1,1
BEL,MEX,2007.0,2,3,-1
DEU,HKG,1998.0,1,4,-3
SWE,BOL,2013.0,2,2,0
HKG,EGY,2007.0,1,1,0
QAT,ITA,2019.0,2,7,-5
CYP,NLD,2018.0,1,1,0
NPL,TWN,2013.0,1,1,0
BFA,GBR,2014.0,1,1,0
HKG,THA,2010.0,1,1,0
IRQ,IRL,2018.0,2,3,-1
KOR,BRA,2018.0,2,4,-2
PER,BOL,2020.0,2,1,1
THA,AUT,2014.0,5,4,1
BIH,HRV,2011.0,4,9,-5
MAR,IND,2015.0,1,3,-2
LVA,DEU,2004.0,1,1,0
MAR,ITA,2012.0,1,3,-2
MWI,ZMB,2016.0,2,1,1
ZAF,CZE,2008.0,2,1,1
DNK,GRC,2015.0,2,8,-6
MAR,CAN,2000.0,1,2,-1
ARE,SWE,2010.0,2,4,-2
BEL,ZWE,2011.0,1,1,0
FJI,IND,2014.0,1,4,-3
MYS,NZL,2006.0,1,3,-2
ZAF,IND,2006.0,4,9,-5
HKG,NLD,2005.0,2,1,1
TZA,CMR,2014.0,1,1,0
GBR,PHL,2017.0,2,2,0
DEU,URY,2012.0,1,2,-1
KOR,DNK,2005.0,1,2,-1
CRI,GBR,2015.0,1,3,-2
AUS,LBN,2004.0,1,1,0
GBR,NPL,2008.0,1,3,-2
CYP,FRA,2017.0,1,5,-4
MYS,NGA,2009.0,1,4,-3
NLD,PHL,2011.0,1,1,0
SRB,IRL,2015.0,1,1,0
AUS,EST,2018.0,2,3,-1
PER,MEX,2003.0,1,1,0
RUS,SRB,2010.0,1,1,0
EGY,JOR,2015.0,2,2,0
MUS,IND,2017.0,1,1,0
SRB,JPN,2009.0,1,2,-1
SVN,KOR,2022.0,1,1,0
ISR,KAZ,2020.0,2,3,-1
YEM,CHN,2017.0,1,1,0
DZA,EGY,2005.0,1,1,0
EGY,PSE,2007.0,1,3,-2
LIE,USA,2007.0,1,1,0
GRC,JPN,2007.0,1,3,-2
MDA,DEU,2013.0,2,1,1
CHE,IRN,2010.0,1,14,-13
MYS,SGP,1998.0,1,1,0
ZAF,MOZ,2010.0,1,2,-1
IND,QAT,2014.0,4,3,1
POL,MEX,2016.0,2,1,1
GBR,GRD,2015.0,1,1,0
UGA,NZL,2016.0,1,1,0
JOR,YEM,2020.0,2,1,1
LBY,GBR,2021.0,1,2,-1
TGO,FRA,2018.0,2,3,-1
VNM,KEN,2019.0,1,1,0
IDN,SGP,2012.0,1,3,-2
KOR,AUT,2004.0,2,2,0
NGA,EGY,2008.0,1,1,0
UKR,IND,2016.0,1,1,0
BEL,ARM,2003.0,1,1,0
IRL,CHN,2007.0,1,5,-4
TZA,NOR,2010.0,2,9,-7
PRY,BRA,2022.0,2,3,-1
PRT,SGP,2022.0,1,1,0
ETH,AUS,2010.0,1,1,0
DEU,VEN,2017.0,2,12,-10
KEN,NOR,2018.0,1,3,-2
TUR,UKR,2017.0,1,1,0
TUR,ALB,2012.0,1,1,0
CHE,MEX,2021.0,2,12,-10
FIN,TUR,2020.0,1,9,-8
NZL,OMN,1999.0,2,1,1
IDN,PER,2018.0,1,2,-1
PRI,ARG,2011.0,1,2,-1
URY,COL,2009.0,1,1,0
AUT,LIE,2007.0,1,1,0
QAT,JOR,2021.0,1,8,-7
MDG,SEN,2002.0,1,5,-4
FIN,ISL,2020.0,2,1,1
SWE,NPL,2014.0,1,1,0
FRA,MRT,2002.0,1,2,-1
IRL,MEX,2017.0,1,2,-1
CAN,LTU,2012.0,2,1,1
SVK,ZAF,2011.0,2,1,1
FRA,ECU,2005.0,1,3,-2
ISR,AUS,2001.0,5,6,-1
ROU,IRL,2015.0,1,1,0
AZE,TUR,2019.0,2,6,-4
THA,NGA,2016.0,1,1,0
NGA,GMB,2013.0,1,2,-1
LAO,GBR,2014.0,1,1,0
BGR,ITA,2015.0,2,7,-5
GTM,COL,2012.0,1,2,-1
ZAF,JPN,2016.0,2,2,0
SAU,MEX,2018.0,1,3,-2
ARE,JPN,2020.0,1,5,-4
NLD,RWA,2017.0,1,1,0
PER,ITA,2020.0,3,6,-3
DNK,GHA,2022.0,1,1,0
CMR,SEN,2015.0,1,1,0
VNM,SWE,2019.0,1,8,-7
GBR,MLT,1999.0,1,1,0
CHN,GRC,2015.0,2,3,-1
CHN,COG,2020.0,1,1,0
ARE,HKG,2012.0,1,1,0
CHE,ZMB,2014.0,1,1,0
PER,DEU,2006.0,1,2,-1
ZWE,KEN,2007.0,1,3,-2
NGA,FRA,2007.0,1,2,-1
AUS,HRV,2020.0,1,3,-2
IRL,BGR,2014.0,1,3,-2
CHL,SWE,1999.0,1,2,-1
NOR,NGA,2020.0,1,1,0
AUT,ISR,2010.0,1,2,-1
IRL,UKR,2015.0,1,1,0
TZA,CAN,2020.0,1,2,-1
CIV,CHE,2011.0,1,1,0
NGA,NZL,2016.0,1,1,0
SWE,HKG,2000.0,1,1,0
YEM,USA,2012.0,1,2,-1
SAU,PRT,2012.0,1,2,-1
TUN,JPN,2021.0,1,2,-1
BEL,ARG,2008.0,1,3,-2
IDN,NOR,2014.0,1,1,0
MEX,PRI,2007.0,1,1,0
NLD,SVN,2001.0,1,1,0
FIN,POL,2001.0,1,4,-3
PSE,DEU,2022.0,1,2,-1
SAU,QAT,2010.0,1,4,-3
GRC,MLT,2019.0,1,1,0
GBR,SRB,1998.0,1,2,-1
CHL,NIC,2015.0,1,1,0
ESP,PAK,2013.0,1,2,-1
BEL,CUB,2022.0,1,1,0
ITA,GBR,2011.0,361,212,149
USA,SGP,2018.0,199,229,-30
HKG,USA,2005.0,98,61,37
SWE,FIN,2011.0,31,40,-9
JPN,USA,2005.0,1144,882,262
IRL,SRB,2020.0,3,1,2
DEU,ITA,2006.0,139,133,6
CAN,GBR,2009.0,321,343,-22
IRL,ISR,2015.0,1,2,-1
FRA,COG,2018.0,4,4,0
GBR,MKD,2015.0,1,1,0
DNK,SWE,2017.0,97,87,10
CHL,USA,2005.0,49,51,-2
ISR,CAN,2006.0,56,12,44
MEX,ESP,2013.0,95,135,-40
AUS,CHE,2015.0,60,65,-5
DNK,BRA,2006.0,5,3,2
AUT,EGY,2007.0,4,2,2
ZAF,GHA,2019.0,16,10,6
DNK,SWE,2019.0,102,103,-1
CHN,USA,2022.0,1003,1796,-793
CHN,EST,2018.0,3,1,2
BGD,AUS,2017.0,65,30,35
SGP,NZL,2014.0,7,7,0
USA,GEO,2020.0,14,13,1
DEU,COL,2014.0,11,14,-3
FIN,GBR,2003.0,35,47,-12
DEU,FRA,2018.0,306,372,-66
CAN,BRA,2017.0,71,97,-26
PAK,KOR,2015.0,38,27,11
VNM,TWN,2016.0,4,35,-31
POL,PRT,2019.0,3,8,-5
PRI,USA,2018.0,107,59,48
FRA,BLR,2018.0,1,1,0
VNM,SGP,2022.0,4,3,1
GBR,DNK,2006.0,34,65,-31
FJI,AUS,2014.0,6,14,-8
SGP,ISR,2022.0,2,2,0
MYS,IND,2011.0,27,54,-27
GBR,BRA,2018.0,102,128,-26
IRN,JPN,2018.0,11,10,1
KAZ,USA,2020.0,15,10,5
NPL,IND,2021.0,17,25,-8
ARE,MYS,2008.0,3,1,2
ETH,CHN,2018.0,10,11,-1
BEL,LUX,2010.0,13,3,10
DEU,IRL,2006.0,33,20,13
BEL,USA,2001.0,106,72,34
NZL,GBR,2022.0,44,36,8
BRA,AUT,2021.0,10,1,9
FRA,MEX,2018.0,50,35,15
CHN,AUT,2008.0,6,5,1
AUS,ETH,2020.0,12,15,-3
TUR,FIN,2022.0,5,1,4
VNM,FRA,2007.0,5,9,-4
DEU,PRT,2009.0,23,25,-2
AUS,NLD,2007.0,29,42,-13
JOR,DEU,2001.0,4,2,2
RUS,NLD,2002.0,27,15,12
HKG,USA,2002.0,115,91,24
FIN,SWE,2006.0,35,31,4
ARE,SWE,2017.0,2,5,-3
ESP,FIN,2002.0,6,4,2
USA,LBN,2000.0,4,4,0
HUN,JPN,2020.0,4,3,1
USA,KAZ,2001.0,1,1,0
RUS,CHN,2005.0,9,5,4
NLD,SWE,2004.0,27,23,4
TZA,JPN,2012.0,3,5,-2
SAU,PAK,2004.0,11,9,2
HUN,CAN,2000.0,3,5,-2
DEU,RUS,1998.0,33,49,-16
ITA,ARG,2006.0,11,10,1
AZE,TUR,2010.0,6,9,-3
KEN,ZAF,2001.0,2,3,-1
TWN,KOR,2007.0,8,4,4
AUT,CZE,2005.0,8,7,1
RWA,USA,2021.0,16,6,10
DEU,IDN,2008.0,14,4,10
IND,DNK,2016.0,21,11,10
BEL,SVN,2013.0,1,2,-1
BEL,POL,2009.0,6,5,1
NLD,HKG,2014.0,9,3,6
HUN,NOR,2020.0,6,1,5
ARE,QAT,2019.0,6,4,2
CHL,AUS,2017.0,18,21,-3
PRT,POL,2018.0,5,2,3
SAU,QAT,2019.0,22,4,18
IND,SYR,2013.0,2,1,1
GBR,LKA,2008.0,7,5,2
DZA,TUN,2015.0,5,2,3
NGA,GHA,2015.0,2,7,-5
TWN,AUS,2022.0,5,9,-4
GHA,NOR,2018.0,1,3,-2
CHN,FRA,2003.0,39,40,-1
GBR,AUT,2001.0,17,29,-12
CHN,UKR,2020.0,9,10,-1
UKR,FRA,2004.0,6,5,1
ISR,FIN,2009.0,2,1,1
SDN,FRA,2011.0,1,1,0
POL,HKG,2014.0,1,1,0
JPN,PAK,2019.0,8,3,5
PAK,IRN,2015.0,2,2,0
NZL,HKG,2014.0,3,4,-1
ESP,HUN,2020.0,2,5,-3
MTQ,FRA,2005.0,11,11,0
NZL,CHE,2009.0,8,11,-3
NLD,UGA,2019.0,5,3,2
USA,PAN,2022.0,3,10,-7
BLR,CHN,2016.0,1,1,0
NLD,TUR,2003.0,2,11,-9
CHL,AUT,2022.0,3,1,2
TUR,MDA,2011.0,1,1,0
JOR,SYR,2013.0,1,1,0
IRL,JPN,2019.0,3,10,-7
IND,BGD,2007.0,7,3,4
GHA,GBR,2017.0,11,24,-13
NPL,NOR,2021.0,2,1,1
HUN,ARE,2018.0,2,1,1
CAN,DZA,2001.0,1,1,0
THA,CHN,2015.0,14,9,5
CHN,DNK,1999.0,6,2,4
PAK,BGD,2008.0,3,4,-1
SAU,IRL,2015.0,1,2,-1
SWE,CHN,1998.0,2,3,-1
PAK,JOR,2012.0,1,1,0
TZA,MWI,2020.0,2,1,1
GBR,PHL,2019.0,3,6,-3
OMN,AUS,2006.0,4,1,3
USA,BTN,2015.0,1,1,0
MEX,CUB,2013.0,6,18,-12
BEL,PRT,2003.0,4,3,1
TUR,SRB,2016.0,1,3,-2
PHL,KOR,2014.0,3,9,-6
ESP,CUB,2000.0,3,15,-12
ESP,SVK,2020.0,2,2,0
HUN,IRL,2022.0,1,1,0
AUT,BIH,2005.0,3,1,2
CAN,BWA,2013.0,1,2,-1
ISL,CHN,2020.0,2,1,1
ITA,HRV,2005.0,2,3,-1
ZWE,ETH,2006.0,1,1,0
BRA,KEN,2007.0,1,1,0
FIN,MYS,2016.0,4,4,0
ZAF,GHA,2010.0,3,3,0
HRV,POL,2018.0,1,2,-1
JPN,ESP,2000.0,5,2,3
USA,CMR,2017.0,2,9,-7
DEU,LVA,2004.0,1,1,0
FRA,NER,2001.0,2,6,-4
CYP,FRA,2010.0,1,1,0
SVN,FRA,2015.0,1,2,-1
JPN,TZA,2008.0,1,2,-1
BEL,SRB,2003.0,1,2,-1
IDN,MYS,2004.0,1,2,-1
LTU,RUS,2003.0,3,1,2
ECU,VEN,2014.0,1,11,-10
NLD,PRT,1999.0,1,3,-2
ISL,THA,2015.0,1,1,0
GBR,ROU,1999.0,3,2,1
HUN,POL,2017.0,2,1,1
ISL,GBR,2004.0,1,1,0
ESP,GRC,2004.0,3,2,1
HRV,NLD,2021.0,1,3,-2
FIN,BRA,2004.0,1,1,0
DEU,SDN,2022.0,1,1,0
FIN,GHA,2020.0,3,1,2
KAZ,FRA,2009.0,1,1,0
DEU,MDA,2004.0,2,1,1
PAK,BRN,2021.0,1,2,-1
GIN,FRA,2011.0,1,3,-2
FRA,MDG,2022.0,1,2,-1
ARE,EGY,1998.0,1,2,-1
KEN,NLD,2006.0,1,3,-2
FRA,,2010.0,7398,0,7398
,OMN,2004.0,70,0,70
,FRA,2002.0,14228,0,14228
CHN,,2022.0,226576,0,226576
,BRA,2000.0,9836,0,9836
JPN,,2020.0,28775,0,28775
COL,,2024.0,8512,0,8512
DEU,,2015.0,16182,0,16182
FRA,,2019.0,15132,0,15132
IND,,2022.0,45035,0,45035
SRB,,2024.0,7455,0,7455
UZB,,2016.0,65,0,65
,IRL,2002.0,1187,0,1187
,IRN,2003.0,3655,0,3655
NOR,,2014.0,1125,0,1125
FRA,,2017.0,12024,0,12024
,FRA,2005.0,13877,0,13877
,POL,1998.0,6748,0,6748
UKR,,2018.0,1353,0,1353
,DNK,2001.0,1932,0,1932
PAK,,2023.0,11422,0,11422
ITA,,2008.0,5121,0,5121
,BEL,1999.0,4568,0,4568
DNK,,2011.0,936,0,936
ZAF,,2023.0,8877,0,8877
,IRL,2005.0,1279,0,1279
TWN,,2005.0,1309,0,1309
,HUN,2000.0,1559,0,1559
SWE,,2022.0,7663,0,7663
,POL,1997.0,2383,0,2383
GRC,,2012.0,1447,0,1447
,UKR,2016.0,3407,0,3407
ARG,,2009.0,665,0,665
EGY,MAR,2016.0,1,0,1
,RUS,2008.0,7290,0,7290
THA,,2018.0,1522,0,1522
MDG,,2012.0,30,0,30
KOR,IRL,2011.0,3,0,3
TWN,,2002.0,174,0,174
,GHA,2003.0,118,0,118
BFA,,2024.0,593,0,593
BEL,,2006.0,1007,0,1007
,NZL,2010.0,1406,0,1406
VEN,,2021.0,592,0,592
MEX,,1999.0,39,0,39
,MMR,2001.0,8,0,8
,ARM,1994.0,201,0,201
PSE,TUR,2005.0,1,0,1
BOL,,2018.0,41,0,41
,LKA,2014.0,343,0,343
,LVA,2009.0,293,0,293
MWI,NAM,2013.0,1,0,1
MMR,,2024.0,157,0,157
,SAU,2015.0,2299,0,2299
,COL,2012.0,1926,0,1926
AUS,BHR,2018.0,2,0,2
CIV,,2020.0,178,0,178
,ARG,2007.0,2484,0,2484
TGO,,2024.0,223,0,223
BEN,CMR,2014.0,1,0,1
,SVK,2008.0,881,0,881
CZE,,2005.0,440,0,440
GTM,,2016.0,15,0,15
TWN,KHM,2015.0,1,0,1
SVN,,2007.0,98,0,98
CZE,CHL,2016.0,1,0,1
CZE,,2002.0,137,0,137
MOZ,,2018.0,26,0,26
,NER,2013.0,25,0,25
,ZWE,2016.0,116,0,116
,NZL,2017.0,1377,0,1377
GRL,,2018.0,4,0,4
,CZE,2018.0,2005,0,2005
,BWA,1995.0,27,0,27
CZE,LUX,2021.0,1,0,1
MAC,,2017.0,55,0,55
,JOR,2016.0,660,0,660
,BLR,2015.0,252,0,252
TWN,QAT,2012.0,1,0,1
GUF,,2024.0,84,0,84
CAF,,2023.0,43,0,43
,KHM,2015.0,42,0,42
,CRI,2006.0,92,0,92
GNB,,2024.0,31,0,31
,NZL,2019.0,794,0,794
DZA,SVK,2015.0,2,0,2
,CUB,2016.0,354,0,354
ERI,,2021.0,10,0,10
AUS,,2025.0,41,0,41
,LBN,1994.0,50,0,50
CAN,GRL,2019.0,1,0,1
,MWI,2006.0,63,0,63
,DJI,2018.0,3,0,3
,MNE,2018.0,45,0,45
FRA,PAN,2022.0,2,0,2
JOR,,2007.0,43,0,43
MAC,,2010.0,9,0,9
MUS,,2012.0,8,0,8
ARM,CZE,2001.0,1,0,1
GHA,KOR,2013.0,3,0,3
MAC,,2019.0,100,0,100
AUT,ISL,2009.0,1,0,1
,BRN,2011.0,43,0,43
CUB,,2002.0,142,0,142
PAN,BRA,2012.0,2,0,2
DJI,,2017.0,4,0,4
,PRY,2018.0,39,0,39
GLP,BRA,2014.0,1,0,1
CUB,,2005.0,169,0,169
,FJI,2016.0,31,0,31
LBN,EGY,2021.0,10,0,10
,GRL,2016.0,5,0,5
SYR,,2012.0,33,0,33
,ECU,2006.0,68,0,68
,KAZ,1999.0,132,0,132
KEN,,2007.0,51,0,51
AUT,KEN,2015.0,3,0,3
CMR,,2006.0,22,0,22
POL,BHR,2015.0,1,0,1
,COG,2000.0,29,0,29
ZAF,ARG,2012.0,2,0,2
PSE,,2008.0,8,0,8
SRB,BEL,2005.0,4,0,4
BDI,COG,2012.0,1,0,1
HTI,,2012.0,9,0,9
LVA,,2002.0,11,0,11
MYS,UGA,2015.0,1,0,1
LTU,DEU,2000.0,2,0,2
,TZA,1994.0,29,0,29
GUY,,2017.0,5,0,5
MCO,GBR,2005.0,2,0,2
NGA,COG,2004.0,1,0,1
LVA,,2005.0,37,0,37
,BEN,1997.0,13,0,13
ARE,LBN,2012.0,6,0,6
CHE,LAO,2007.0,1,0,1
BGR,SWE,2000.0,2,0,2
MYS,AUS,1997.0,1,0,1
COG,DEU,2000.0,1,0,1
ARE,EGY,1997.0,1,0,1
IDN,,2004.0,28,0,28
DEU,ZMB,2016.0,1,0,1
,OMN,1996.0,30,0,30
GTM,DEU,1999.0,2,0,2
SRB,TWN,2000.0,1,0,1
ARM,TWN,2006.0,2,0,2
UKR,KWT,2009.0,1,0,1
BOL,USA,2003.0,5,0,5
PAK,PYF,2007.0,1,0,1
KAZ,UKR,2005.0,2,0,2
UGA,COG,2020.0,2,0,2
NLD,UGA,2017.0,4,0,4
NGA,ZMB,2004.0,1,0,1
CAN,DJI,2008.0,1,0,1
PRY,ITA,2003.0,1,0,1
ALB,NLD,2014.0,2,0,2
,ERI,2005.0,8,0,8
,BEN,1998.0,27,0,27
PSE,FRA,2010.0,2,0,2
CHN,CAF,2019.0,2,0,2
ZAF,MOZ,2019.0,3,0,3
ESP,GTM,2012.0,1,0,1
TUN,POL,2012.0,3,0,3
UKR,GRC,2013.0,1,0,1
ESP,HKG,2011.0,3,0,3
ETH,CHE,2011.0,2,0,2
ZAF,MOZ,2017.0,5,0,5
BEL,COD,2014.0,5,0,5
HUN,SVK,2013.0,5,0,5
PAN,ARG,2014.0,1,0,1
PHL,FRA,2006.0,1,0,1
ROU,DZA,2019.0,1,0,1
FLK,,2020.0,2,0,2
LUX,NZL,2016.0,1,0,1
TWN,SVN,2013.0,2,0,2
UKR,AUS,2015.0,3,0,3
GEO,AUS,2019.0,1,0,1
EST,,2007.0,43,0,43
CHN,KEN,2006.0,3,0,3
RUS,ZAF,2000.0,2,0,2
PRT,LTU,2016.0,1,0,1
SWE,UKR,2006.0,1,0,1
,DOM,2008.0,10,0,10
KEN,CMR,2014.0,3,0,3
CHN,CYP,2019.0,1,0,1
MLI,SEN,2010.0,3,0,3
,LBR,2018.0,12,0,12
HRV,,2006.0,181,0,181
,ATG,2008.0,1,0,1
IRL,SVK,2012.0,2,0,2
BFA,ETH,2015.0,1,0,1
SVN,NOR,2021.0,1,0,1
IND,GHA,2020.0,6,0,6
QAT,CZE,2018.0,2,0,2
BIH,MYS,2014.0,1,0,1
CRI,NIC,2016.0,1,0,1
BDI,FRA,2012.0,1,0,1
TUN,MYS,2017.0,1,0,1
DJI,,2019.0,4,0,4
ARM,GRC,2018.0,1,0,1
ECU,IND,2019.0,2,0,2
ZAF,KNA,2016.0,2,0,2
MEX,VNM,2022.0,1,0,1
MDA,,1999.0,6,0,6
VNM,,2025.0,13,0,13
,CAF,2016.0,11,0,11
SWE,LUX,2012.0,2,0,2
SRB,CHE,2021.0,4,0,4
ARG,DZA,2015.0,1,0,1
TCD,,2006.0,3,0,3
ESP,PRY,2009.0,6,0,6
,ERI,2002.0,5,0,5
UKR,CHE,2014.0,6,0,6
LKA,CZE,2006.0,1,0,1
BEL,DZA,2001.0,1,0,1
PRT,NZL,2003.0,2,0,2
SVK,FRA,2000.0,6,0,6
SWE,BIH,2005.0,1,0,1
BEL,JOR,2000.0,1,0,1
,MAC,2001.0,15,0,15
AZE,,2006.0,26,0,26
NLD,SAU,2013.0,7,0,7
FJI,BWA,2016.0,1,0,1
JAM,DEU,2020.0,2,0,2
BGD,BEL,2001.0,2,0,2
BIH,IRQ,2007.0,1,0,1
SWE,IRN,2001.0,3,0,3
BEN,TGO,2008.0,1,0,1
SWE,BLR,2011.0,1,0,1
MEX,ARM,2011.0,1,0,1
KEN,AUS,1999.0,2,0,2
MWI,NOR,2012.0,1,0,1
UGA,LBR,2017.0,1,0,1
ZAF,NAM,2008.0,1,0,1
NIC,FRA,2010.0,1,0,1
FJI,MYS,2022.0,1,0,1
NGA,SAU,2016.0,3,0,3
LBN,TUR,2016.0,1,0,1
MYS,SGP,1997.0,1,0,1
ARE,SOM,2014.0,1,0,1
FRA,IRQ,2021.0,2,0,2
SEN,DJI,2014.0,1,0,1
PRT,SEN,2005.0,1,0,1
UGA,ITA,2001.0,1,0,1
AUT,KOR,2001.0,1,0,1
HKG,NOR,2007.0,1,0,1
GAB,NLD,2018.0,1,0,1
NLD,MNG,2014.0,1,0,1
TUN,PAK,2020.0,1,0,1
OMN,KWT,2010.0,1,0,1
USA,MAC,2004.0,2,0,2
LIE,,2005.0,2,0,2
NPL,SWE,2011.0,1,0,1
AUT,LVA,2022.0,1,0,1
TUR,ESP,2022.0,8,0,8
POL,ZAF,2016.0,5,0,5
ARM,PRT,2010.0,1,0,1
VEN,CAN,2013.0,4,0,4
FIN,COL,2013.0,1,0,1
ISR,GIB,2015.0,1,0,1
BLR,SVK,2016.0,1,0,1
GBR,GUY,2014.0,2,0,2
VEN,CZE,2020.0,3,0,3
,TON,2015.0,2,0,2
ROU,SVN,2018.0,1,0,1
MYS,CYP,2021.0,1,0,1
CMR,CIV,2021.0,1,0,1
NGA,ISR,2021.0,1,0,1
SGP,DNK,2008.0,3,0,3
BRA,MAR,2002.0,1,0,1
CIV,THA,2002.0,1,0,1
NGA,SLE,2021.0,1,0,1
ESP,AND,2001.0,1,0,1
ALB,SRB,2003.0,1,0,1
POL,GEO,2004.0,1,0,1
AUT,LUX,2001.0,2,0,2
DOM,ARG,2003.0,1,0,1
ARE,QAT,2010.0,2,0,2
UKR,AUT,2001.0,2,0,2
DEU,LBN,2004.0,1,0,1
KAZ,TTO,2002.0,1,0,1
GUF,FRA,1998.0,2,0,2
QAT,TWN,2022.0,1,0,1
GBR,TWN,1997.0,1,0,1
,GIB,2015.0,2,0,2
CAN,ECU,2014.0,1,0,1
UGA,CAN,2013.0,3,0,3
IND,IRQ,2011.0,1,0,1
USA,MLT,2008.0,3,0,3
NPL,BEL,2007.0,1,0,1
IRL,LKA,2016.0,2,0,2
MAR,MRT,2013.0,2,0,2
PHL,DNK,2022.0,2,0,2
KEN,EGY,2012.0,1,0,1
ROU,EGY,2012.0,1,0,1
JPN,DZA,2018.0,1,0,1
SEN,NGA,2015.0,1,0,1
FIN,BWA,2019.0,1,0,1
BTN,JPN,2014.0,1,0,1
JOR,ETH,2016.0,1,0,1
YEM,CHN,2019.0,2,0,2
TUN,MAR,1999.0,1,0,1
AUT,PSE,2010.0,1,0,1
ROU,TZA,2011.0,1,0,1
CUB,ECU,2013.0,6,0,6
PNG,MYS,2022.0,1,0,1
BEL,TZA,2011.0,1,0,1
LAO,KHM,2019.0,1,0,1
AUT,SGP,2001.0,2,0,2
EST,AUT,2000.0,1,0,1
,SWZ,2000.0,6,0,6
SYR,JPN,2015.0,1,0,1
NLD,MAR,2010.0,1,0,1
MEX,BOL,2004.0,1,0,1
CMR,GAB,2022.0,1,0,1
DNK,BLR,2007.0,1,0,1
HKG,KEN,2003.0,1,0,1
BEN,NGA,2012.0,2,0,2
KOR,LUX,2010.0,1,0,1
KHM,ETH,2015.0,1,0,1
NLD,UGA,2010.0,2,0,2
SDN,OMN,2018.0,1,0,1
GUY,,2019.0,6,0,6
NZL,UKR,2011.0,1,0,1
DZA,NZL,2012.0,1,0,1
UGA,COL,2018.0,1,0,1
LTU,CZE,2015.0,2,0,2
IRN,QAT,2014.0,2,0,2
KGZ,KAZ,2009.0,1,0,1
JOR,AUT,2022.0,1,0,1
ESP,HND,2013.0,1,0,1
HKG,SRB,2004.0,2,0,2
ETH,NZL,2012.0,1,0,1
CMR,IND,2020.0,1,0,1
IDN,POL,2012.0,1,0,1
UKR,ISR,2009.0,2,0,2
AUS,CMR,2007.0,3,0,3
NOR,MNE,2014.0,1,0,1
MAR,ROU,2009.0,1,0,1
TWN,PAK,2013.0,1,0,1
ESP,PSE,2013.0,2,0,2
CHE,LSO,2020.0,8,0,8
NGA,IRN,2015.0,1,0,1
FRA,DJI,2015.0,3,0,3
GUY,,2010.0,4,0,4
JPN,JAM,2010.0,1,0,1
USA,LSO,2012.0,1,0,1
KEN,MEX,2012.0,3,0,3
PHL,CHE,1999.0,2,0,2
SWE,LKA,2001.0,1,0,1
MDA,ISR,2004.0,1,0,1
TZA,ETH,2015.0,2,0,2
PAK,CUB,2011.0,1,0,1
CZE,ESP,2000.0,2,0,2
PHL,IRN,2009.0,1,0,1
LKA,PHL,2017.0,1,0,1
NGA,ROU,2009.0,1,0,1
FIN,SGP,2004.0,1,0,1
GAB,GBR,2011.0,1,0,1
KOR,HUN,2022.0,1,0,1
MNE,AUT,2019.0,2,0,2
SVK,CHN,2001.0,2,0,2
DNK,SAU,2002.0,1,0,1
DZA,SWE,2004.0,1,0,1
PAN,GHA,2014.0,1,0,1
POL,KOR,2001.0,2,0,2
ZWE,ZMB,2019.0,3,0,3
,TLS,2013.0,8,0,8
ROU,TUR,2001.0,4,0,4
DNK,COL,2021.0,1,0,1
SAU,ISR,2015.0,2,0,2
NLD,LTU,2004.0,1,0,1
TKM,,2024.0,4,0,4
CHE,CMR,2008.0,2,0,2
CAN,SYR,2007.0,1,0,1
GRC,KWT,2014.0,2,0,2
TUR,HKG,2002.0,1,0,1
NER,USA,2010.0,1,0,1
ITA,GHA,2011.0,2,0,2
GEO,USA,1997.0,2,0,2
ROU,POL,2003.0,1,0,1
OMN,KWT,2017.0,1,0,1
UKR,DNK,2005.0,1,0,1
NGA,BRA,2003.0,1,0,1
COL,TWN,2000.0,1,0,1
MNE,,2007.0,1,0,1
VEN,PRI,2021.0,1,0,1
CZE,SRB,2004.0,2,0,2
NLD,VEN,2014.0,1,0,1
COL,RUS,2002.0,1,0,1
ISR,SVN,2012.0,1,0,1
ROU,AUS,2018.0,4,0,4
CAN,ISL,2003.0,2,0,2
FRA,ZWE,2021.0,1,0,1
JOR,FRA,2008.0,2,0,2
HTI,CAN,2006.0,1,0,1
HUN,TUR,2015.0,3,0,3
FRA,TTO,2012.0,1,0,1
DEU,QAT,2008.0,1,0,1
JPN,JAM,2017.0,1,0,1
SYR,USA,2016.0,4,0,4
IND,PAN,2018.0,3,0,3
BEN,PHL,2018.0,1,0,1
SYR,AUS,2017.0,1,0,1
SAU,BRN,2021.0,2,0,2
ZWE,FRA,2022.0,1,0,1
USA,PYF,2019.0,1,0,1
,MRT,1995.0,1,0,1
DZA,PRT,2018.0,3,0,3
NLD,EGY,2000.0,1,0,1
AUS,MWI,2005.0,1,0,1
CMR,ZAF,2008.0,2,0,2
AUT,NPL,2003.0,1,0,1
UKR,BRA,2006.0,1,0,1
PAK,LKA,2005.0,1,0,1
LBN,KWT,2022.0,1,0,1
PRI,PER,2007.0,1,0,1
,RWA,1999.0,4,0,4
TZA,BWA,2000.0,1,0,1
EGY,PRT,2002.0,1,0,1
PAN,GBR,2022.0,2,0,2
BEL,CYP,2003.0,1,0,1
NZL,EGY,2012.0,1,0,1
ISR,ZAF,2010.0,1,0,1
JPN,LBN,2021.0,1,0,1
BOL,BRA,2012.0,1,0,1
TUN,JAM,2009.0,1,0,1
SGP,AUT,2022.0,1,0,1
SRB,VNM,2017.0,1,0,1
CRI,SWE,1999.0,1,0,1
PER,NZL,2014.0,1,0,1
BTN,GBR,2022.0,1,0,1
IRN,CHL,2021.0,1,0,1
TUR,TUN,2008.0,1,0,1
NOR,ROU,2018.0,1,0,1
BGD,DEU,1997.0,1,0,1
USA,BRN,2020.0,2,0,2
URY,CUB,2006.0,1,0,1
IRN,CHE,2003.0,1,0,1
IND,ARG,2011.0,1,0,1
LVA,CAN,2012.0,1,0,1
SRB,MYS,2016.0,1,0,1
OMN,NZL,2008.0,1,0,1
LBN,SYR,2012.0,1,0,1
HRV,IRL,2006.0,1,0,1
ITA,PAK,2004.0,1,0,1
BDI,BEL,2008.0,1,0,1
ECU,USA,1999.0,1,0,1
MAR,LBY,2020.0,1,0,1
PYF,,2009.0,2,0,2
CRI,ECU,2001.0,1,0,1
SGP,NPL,2013.0,1,0,1
FRA,TUR,1998.0,3,0,3
HRV,SGP,2011.0,1,0,1
NLD,GEO,1998.0,1,0,1
SDN,LBR,2016.0,1,0,1
BEL,AFG,2018.0,1,0,1
THA,IRL,2021.0,1,0,1
BEL,IDN,2003.0,2,0,2
CHL,IND,2004.0,2,0,2
SWE,UGA,2020.0,2,0,2
GAB,MLI,2004.0,1,0,1
NZL,THA,2005.0,2,0,2
IRQ,NZL,2019.0,1,0,1
KOR,UGA,2022.0,1,0,1
JOR,KWT,2022.0,1,0,1
SEN,ESP,2016.0,2,0,2
KAZ,UKR,2002.0,1,0,1
MDG,KHM,2006.0,1,0,1
MAR,ARG,2015.0,1,0,1
ZWE,MDG,2018.0,1,0,1
BHR,NZL,2022.0,1,0,1
VNM,ISL,2012.0,1,0,1
DEU,LUX,1999.0,2,0,2
SYR,ITA,2018.0,1,0,1
SWE,NIC,2015.0,1,0,1
ARG,MYS,2005.0,1,0,1
SWE,MLT,2015.0,2,0,2
DEU,BRN,2015.0,2,0,2
GMB,KEN,2008.0,2,0,2
SWE,RWA,2009.0,1,0,1
SVN,FIN,2015.0,2,0,2
NLD,CUB,2007.0,1,0,1
IRQ,NZL,2017.0,1,0,1
HRV,CZE,2014.0,1,0,1
TWN,KAZ,2018.0,1,0,1
BEL,SEN,2009.0,1,0,1
ITA,GTM,2018.0,1,0,1
CIV,TZA,2019.0,1,0,1
LBY,,2001.0,1,0,1
BLR,BEL,2007.0,1,0,1
AUS,JOR,2000.0,1,0,1
GRC,PSE,2002.0,1,0,1
NER,GAB,2006.0,1,0,1
IRQ,ARE,2014.0,1,0,1
ZWE,KOR,2017.0,1,0,1
SDN,YEM,2020.0,1,0,1
MDA,USA,2018.0,1,0,1
IND,PSE,1997.0,1,0,1
IRL,MYS,2006.0,1,0,1
THA,RUS,2021.0,2,0,2
KOR,HKG,1999.0,1,0,1
GNB,BRA,2007.0,1,0,1
GBR,SRB,1997.0,2,0,2
NLD,MAR,2017.0,1,0,1
ZWE,ZMB,2010.0,1,0,1
IRQ,LUX,2014.0,1,0,1
EGY,BFA,2018.0,1,0,1
POL,ISR,2015.0,5,0,5
KWT,IRL,2016.0,1,0,1
UGA,CHN,2015.0,2,0,2
,SYC,2012.0,1,0,1
ZMB,FRA,2019.0,1,0,1
BDI,RWA,2018.0,1,0,1
CIV,MAR,2022.0,1,0,1
LKA,DNK,2008.0,3,0,3
NZL,PNG,2014.0,1,0,1
TON,,2017.0,1,0,1
MDG,MKD,2016.0,1,0,1
CAN,MAC,2003.0,1,0,1
JAM,JPN,2006.0,1,0,1
,GLP,2018.0,1,0,1
BEN,DEU,2021.0,1,0,1
HRV,ISR,2022.0,1,0,1
UZB,BEL,1998.0,1,0,1
GRC,MEX,1999.0,1,0,1
NGA,CMR,2001.0,2,0,2
GEO,PAK,2006.0,1,0,1
ITA,COG,2014.0,1,0,1
BGR,NOR,2010.0,1,0,1
NER,USA,2017.0,1,0,1
IRL,JOR,2016.0,1,0,1
VNM,ECU,2020.0,1,0,1
AZE,SGP,2017.0,1,0,1
SAU,CHL,2020.0,1,0,1
NGA,MAR,2021.0,1,0,1
LBY,ETH,2011.0,1,0,1
NLD,RWA,2010.0,2,0,2
VEN,IRL,2017.0,1,0,1
ESP,TTO,2020.0,1,0,1
BEL,SGP,2000.0,1,0,1
PAN,BEL,2009.0,1,0,1
URY,CHL,2004.0,1,0,1
GTM,EGY,2011.0,1,0,1
NCL,,2004.0,1,0,1
CHE,THA,2007.0,3,0,3
UGA,NGA,2005.0,1,0,1
ROU,IND,2001.0,1,0,1
NAM,GBR,2005.0,1,0,1
DMA,ECU,2016.0,1,0,1
AUT,SVN,1998.0,1,0,1
ISL,JPN,2002.0,1,0,1
DEU,YEM,2007.0,1,0,1
BWA,SWE,2009.0,1,0,1
CAN,MLT,2012.0,1,0,1
BRB,TTO,2008.0,1,0,1
MHL,FJI,2017.0,1,0,1
ECU,PER,2010.0,1,0,1
SWE,LBN,2013.0,1,0,1
MWI,DEU,2003.0,1,0,1
CZE,IDN,2018.0,1,0,1
THA,ISL,2020.0,1,0,1
KOR,EGY,2003.0,1,0,1
BEL,PAN,2013.0,2,0,2
ROU,DZA,2010.0,1,0,1
ZAF,FJI,2018.0,1,0,1
EGY,AUT,1999.0,1,0,1
AUS,UGA,2011.0,1,0,1
UGA,SWE,2003.0,1,0,1
CMR,KEN,2006.0,1,0,1
NZL,BRN,2020.0,1,0,1
SVN,DNK,2004.0,1,0,1
USA,DJI,2011.0,1,0,1
CHL,RUS,2000.0,1,0,1
IRL,ROU,2016.0,2,0,2
VEN,PRT,2014.0,1,0,1
BGD,NZL,2013.0,1,0,1
LBN,JPN,2014.0,1,0,1
PHL,UGA,2021.0,1,0,1
SWE,OMN,2020.0,2,0,2
NIC,ESP,2020.0,1,0,1
PRT,MEX,2022.0,1,0,1
PRT,DOM,2019.0,1,0,1
FSM,USA,2016.0,1,0,1
THA,IRQ,2016.0,1,0,1
COG,JPN,2018.0,1,0,1
DZA,QAT,2022.0,2,0,2
CRI,PAN,2021.0,1,0,1
NZL,ROU,2017.0,1,0,1
CZE,PNG,2019.0,1,0,1
ZMB,,1999.0,2,0,2
ARE,IRL,2008.0,1,0,1
TON,,2019.0,1,0,1
NLD,GTM,2016.0,1,0,1
CAN,LBN,1998.0,1,0,1
PRT,PSE,2018.0,1,0,1
QAT,TUR,2001.0,1,0,1
CHE,CRI,2022.0,1,0,1
USA,KNA,2022.0,1,0,1
LVA,CZE,2018.0,1,0,1
JPN,PLW,2004.0,1,0,1
,MTQ,1995.0,1,0,1
SVK,AUS,2009.0,1,0,1
URY,AUS,2001.0,1,0,1
TUN,IRN,2004.0,1,0,1
UKR,HKG,2020.0,1,0,1
EGY,IDN,2000.0,1,0,1
BGR,ISR,2013.0,1,0,1
PRT,AUS,1997.0,1,0,1
ZAF,NZL,2000.0,2,0,2
GRC,SGP,2013.0,1,0,1
NIC,CRI,2010.0,1,0,1
HKG,BEL,2009.0,1,0,1
CRI,BRA,2008.0,1,0,1
NOR,LTU,2004.0,1,0,1
KEN,GMB,2012.0,1,0,1
UKR,TUR,2013.0,1,0,1
CHL,SRB,2006.0,1,0,1
GTM,ITA,2012.0,1,0,1
SLB,MYS,2015.0,1,0,1
LAO,MDG,2012.0,1,0,1
USA,LBR,2022.0,1,0,1
NLD,GLP,2014.0,1,0,1
CMR,ZMB,2019.0,1,0,1
SWE,PHL,2011.0,1,0,1
AUT,ARE,2004.0,1,0,1
BWA,KEN,2014.0,2,0,2
KAZ,DEU,2002.0,1,0,1
TUR,MKD,2022.0,1,0,1
GBR,VEN,1997.0,2,0,2
DEU,BEN,2017.0,2,0,2
CZE,RUS,2023.0,1,0,1
KAZ,AUS,2010.0,1,0,1
SAU,THA,2015.0,1,0,1
DNK,ARG,2011.0,1,0,1
DEU,MLI,2021.0,1,0,1
GBR,SWZ,2010.0,1,0,1
IDN,NZL,2012.0,1,0,1
GRC,MLT,2017.0,1,0,1
MKD,IRL,2020.0,1,0,1
FIN,KAZ,2012.0,1,0,1
MUS,IND,2010.0,1,0,1
AUS,CYP,2006.0,1,0,1
NER,USA,2019.0,1,0,1
BRN,THA,2001.0,1,0,1
FRA,SDN,2022.0,1,0,1
COL,PHL,2021.0,1,0,1
CAN,USA,2013.0,1650,1394,256
RUS,DEU,2009.0,124,64,60
FRA,DZA,2011.0,95,31,64
USA,ESP,2015.0,298,537,-239
BRA,FRA,2015.0,93,112,-19
USA,IND,2008.0,426,807,-381
DEU,SWE,2001.0,49,48,1
FRA,CAN,2006.0,237,141,96
USA,MYS,2015.0,40,41,-1
DEU,GBR,2013.0,543,551,-8
GBR,JPN,2011.0,104,90,14
RUS,USA,2006.0,195,137,58
FRA,DEU,2009.0,272,308,-36
ESP,PRT,2007.0,36,41,-5
CHN,GBR,2007.0,112,138,-26
DEU,BEL,2006.0,65,45,20
SAU,JOR,2018.0,39,25,14
IRL,GBR,2011.0,211,154,57
AUS,HKG,2007.0,26,32,-6
GBR,SAU,2012.0,86,11,75
DNK,DZA,2018.0,1,1,0
NLD,AUT,2009.0,8,8,0
CHN,ITA,2005.0,5,10,-5
FRA,MTQ,2011.0,22,11,11
GBR,UGA,2011.0,9,4,5
AUS,CAN,2013.0,133,202,-69
ZAF,DEU,2013.0,18,27,-9
CHE,DEU,2021.0,309,448,-139
ISR,IRL,2014.0,3,2,1
DEU,MEX,2014.0,22,32,-10
USA,MEX,2008.0,144,123,21
VEN,ECU,2015.0,18,1,17
CHE,SVK,2008.0,3,2,1
SEN,USA,2020.0,4,8,-4
ESP,MEX,2008.0,60,71,-11
KOR,NOR,2009.0,3,2,1
GBR,USA,1997.0,154,171,-17
RUS,MDA,2012.0,2,4,-2
NLD,ZWE,2006.0,1,1,0
USA,POL,2008.0,89,121,-32
DNK,POL,2007.0,5,8,-3
ZAF,BWA,2017.0,12,6,6
EGY,USA,2018.0,112,113,-1
USA,PHL,2013.0,16,19,-3
AUT,DEU,2000.0,59,83,-24
CHE,FRA,2002.0,153,177,-24
GBR,PAK,2012.0,82,33,49
GBR,USA,1998.0,289,287,2
IRN,CAN,2011.0,212,48,164
HKG,SGP,1998.0,4,5,-1
JPN,TZA,2007.0,3,1,2
SVN,HRV,2009.0,3,6,-3
FRA,CHE,2020.0,358,210,148
ESP,CHE,2015.0,118,50,68
ISR,NLD,2006.0,9,1,8
KEN,USA,2009.0,22,23,-1
DEU,FIN,2020.0,51,45,6
ESP,FRA,2018.0,270,198,72
AUS,SAU,2018.0,53,25,28
ESP,AUT,2021.0,21,21,0
GBR,GHA,2017.0,24,11,13
AUS,EGY,2015.0,6,12,-6
GTM,USA,2020.0,8,7,1
GBR,EGY,2016.0,43,15,28
AUS,GBR,2021.0,357,421,-64
ESP,ITA,2020.0,164,164,0
BEL,AUT,2014.0,13,10,3
IND,USA,2021.0,921,528,393
POL,USA,2015.0,138,85,53
SGP,KOR,2016.0,24,41,-17
SGP,IND,2020.0,77,85,-8
HKG,NZL,2020.0,7,3,4
ISR,IND,2017.0,52,95,-43
CHN,MAC,2020.0,103,117,-14
JPN,KOR,2003.0,146,79,67
THA,DEU,2021.0,13,13,0
IDN,JPN,2012.0,20,83,-63
NLD,SWE,2015.0,67,34,33
EGY,SAU,2018.0,175,183,-8
DEU,CHN,2022.0,280,181,99
CHE,ITA,2021.0,124,162,-38
ITA,NOR,2018.0,41,15,26
ITA,BEL,2022.0,51,41,10
COL,USA,2012.0,86,85,1
KOR,JPN,1999.0,28,43,-15
IND,DEU,2020.0,182,113,69
ROU,CHE,2010.0,4,8,-4
JPN,FRA,2017.0,84,70,14
GNQ,ESP,2014.0,2,1,1
ESP,CAN,2020.0,57,47,10
NLD,ITA,2021.0,67,80,-13
CHN,SAU,2013.0,25,8,17
NZL,SAU,2018.0,3,3,0
SGP,CHN,2020.0,387,302,85
IND,TWN,2015.0,53,49,4
GBR,BHR,2018.0,4,1,3
DNK,AUT,2016.0,10,9,1
HKG,GBR,2007.0,52,38,14
GBR,HKG,2022.0,35,39,-4
NGA,ZAF,2018.0,79,61,18
NPL,NZL,2018.0,1,2,-1
BEL,CHL,2005.0,3,1,2
KOR,CHN,2004.0,35,21,14
JPN,FRA,2019.0,80,91,-11
IRN,AUS,2021.0,108,26,82
IRN,BEL,2014.0,16,10,6
POL,FIN,2016.0,9,4,5
SGP,GBR,2012.0,69,102,-33
HKG,JPN,2013.0,10,21,-11
BHR,IRL,2017.0,3,2,1
HKG,CHN,1999.0,38,47,-9
KOR,FRA,2018.0,23,46,-23
NOR,DEU,2021.0,45,66,-21
AUS,KEN,2019.0,7,5,2
LBN,AUS,2016.0,5,1,4
POL,ESP,2010.0,16,10,6
FRA,NOR,2022.0,19,9,10
FRA,KOR,2015.0,22,21,1
NZL,DEU,2021.0,26,19,7
GBR,KOR,2021.0,51,52,-1
CHN,KOR,2006.0,41,45,-4
VEN,COL,2013.0,12,2,10
BGD,USA,2015.0,81,24,57
FRA,SWE,2022.0,37,31,6
IRN,ESP,2022.0,12,8,4
GBR,GHA,2019.0,29,20,9
TUR,USA,2022.0,77,72,5
GBR,IND,2022.0,96,137,-41
SEN,FRA,2018.0,27,37,-10
GBR,NZL,1998.0,20,16,4
AUS,CHE,2004.0,31,31,0
GRC,SWE,2002.0,6,5,1
ITA,PAK,2015.0,21,8,13
FIN,CAN,2022.0,5,6,-1
TUR,AUS,2021.0,12,5,7
NLD,CHN,2013.0,54,55,-1
POL,KAZ,2018.0,6,4,2
ARG,ESP,2006.0,83,46,37
USA,HTI,2020.0,7,2,5
IND,BGD,2008.0,6,11,-5
GBR,BGD,2020.0,25,21,4
FIN,AUT,2019.0,11,11,0
ZAF,UGA,2021.0,6,5,1
NOR,EST,2019.0,3,4,-1
RUS,ITA,2009.0,14,18,-4
KOR,TWN,2020.0,13,10,3
RUS,JPN,2018.0,10,15,-5
IND,GBR,2001.0,51,41,10
USA,GRC,2012.0,83,142,-59
CHE,JPN,2014.0,30,29,1
USA,UKR,2003.0,34,42,-8
MLT,ITA,2021.0,4,3,1
RUS,UZB,2018.0,7,6,1
BIH,SRB,2012.0,13,11,2
JPN,VNM,2022.0,14,12,2
SGP,DEU,2021.0,22,21,1
JPN,HKG,2016.0,9,17,-8
CZE,GBR,2016.0,40,36,4
TUN,FRA,2019.0,111,97,14
GBR,ECU,2018.0,8,2,6
ZAF,ZWE,2022.0,10,18,-8
THA,PHL,2020.0,6,1,5
MYS,JPN,2021.0,29,17,12
IND,NOR,2021.0,20,7,13
KAZ,CAN,2021.0,4,1,3
USA,CRI,2018.0,18,24,-6
JPN,BRA,2016.0,20,9,11
ISR,IND,2019.0,53,128,-75
ISR,IND,2010.0,14,22,-8
IRL,SWE,2010.0,12,17,-5
IDN,MYS,2015.0,13,66,-53
NLD,FIN,2013.0,14,13,1
HUN,FRA,2013.0,13,11,2
POL,ESP,2017.0,13,24,-11
CUB,FRA,2014.0,7,2,5
CHN,TWN,2016.0,64,164,-100
AUS,THA,2013.0,35,18,17
DNK,ESP,2011.0,12,15,-3
USA,CHL,2004.0,45,32,13
IRN,NOR,2016.0,10,5,5
ESP,URY,2011.0,3,8,-5
JOR,SAU,2014.0,41,19,22
CAN,TWN,2009.0,16,12,4
NLD,KOR,2013.0,10,7,3
NLD,CAN,2013.0,63,47,16
JPN,FRA,2010.0,97,76,21
DEU,IRN,2012.0,28,58,-30
IRN,KOR,2019.0,19,8,11
ITA,NLD,2008.0,68,45,23
GBR,TUR,2005.0,21,14,7
ARG,CHE,2011.0,4,4,0
DEU,POL,1998.0,29,14,15
AUS,JPN,2014.0,37,56,-19
KOR,GBR,2012.0,25,51,-26
TWN,DEU,2008.0,17,16,1
AUS,KEN,2017.0,5,5,0
IND,THA,2021.0,16,10,6
MYS,LBY,2021.0,9,1,8
ITA,TWN,2019.0,7,8,-1
NZL,CAN,2003.0,28,27,1
ESP,VEN,2003.0,18,16,2
GBR,BEL,2006.0,58,77,-19
NLD,RUS,2008.0,12,12,0
URY,DEU,2016.0,4,4,0
FIN,ITA,2012.0,7,10,-3
DEU,POL,1997.0,30,23,7
ITA,COL,2018.0,17,8,9
NZL,BRA,2014.0,5,1,4
PRT,USA,2002.0,27,46,-19
TUR,ITA,2002.0,6,4,2
FRA,HKG,2003.0,5,6,-1
NLD,CHE,2006.0,50,33,17
AUS,TWN,2018.0,11,17,-6
UKR,UZB,2009.0,1,2,-1
CHN,RUS,2005.0,5,9,-4
USA,CZE,2018.0,69,37,32
CZE,CHN,2021.0,11,14,-3
UKR,RUS,2008.0,19,38,-19
PRT,CHN,2015.0,11,8,3
GBR,SVK,2009.0,7,6,1
PAK,CAN,2005.0,9,3,6
USA,COG,2018.0,6,4,2
POL,UKR,2019.0,18,35,-17
MDG,CHE,2018.0,1,1,0
ITA,SGP,2020.0,7,8,-1
PRT,BGD,2020.0,2,1,1
GBR,NGA,2022.0,15,36,-21
SWZ,ZAF,2020.0,5,4,1
USA,BEL,2004.0,83,127,-44
DEU,SVK,2018.0,12,5,7
GBR,RUS,2017.0,37,37,0
RUS,TUN,2018.0,1,2,-1
BGR,DEU,2021.0,6,2,4
NGA,CHE,2016.0,3,3,0
GBR,SWE,2022.0,55,53,2
RUS,IRL,2006.0,6,2,4
KEN,RWA,2020.0,4,3,1
TWN,MAC,2021.0,2,1,1
MYS,HKG,2019.0,9,9,0
IRQ,CHN,2020.0,4,10,-6
NOR,ETH,2020.0,9,4,5
VNM,FRA,2008.0,6,5,1
IRN,DEU,2001.0,5,4,1
AUT,SAU,2022.0,1,4,-3
ZAF,CMR,2021.0,3,2,1
SAU,SWE,2022.0,6,5,1
KEN,ESP,2021.0,2,3,-1
AUT,AUS,2021.0,12,12,0
ISR,SWE,2016.0,9,5,4
DEU,AUS,2006.0,108,70,38
BEL,GBR,2011.0,64,88,-24
POL,JPN,2001.0,13,11,2
BEL,UZB,2021.0,1,1,0
GBR,TUR,2002.0,49,20,29
DNK,USA,1998.0,27,34,-7
NZL,AUT,2007.0,2,2,0
GBR,SVN,2018.0,10,11,-1
PAK,HKG,2017.0,6,1,5
CHL,CHE,2021.0,8,4,4
TUR,RUS,2016.0,1,2,-1
BHR,GBR,2020.0,4,5,-1
USA,SVN,2009.0,13,10,3
CZE,HUN,2013.0,6,2,4
NLD,BRA,2011.0,13,14,-1
ISR,AUT,2004.0,1,1,0
ROU,FRA,2013.0,34,31,3
IND,CHE,2005.0,12,12,0
ISR,DEU,2008.0,31,17,14
JPN,BGR,2014.0,4,2,2
USA,ISL,2004.0,13,6,7
CUB,MEX,2005.0,9,8,1
ITA,GRC,2007.0,17,26,-9
CHN,ITA,2002.0,17,8,9
FRA,CHL,2001.0,9,6,3
CHE,FRA,2005.0,126,219,-93
AUS,BEL,2001.0,7,4,3
DZA,FRA,2002.0,24,26,-2
FRA,ARG,2001.0,17,13,4
CUB,MEX,2002.0,18,16,2
GBR,RUS,2019.0,40,62,-22
IND,RUS,2014.0,6,1,5
AUS,DEU,2000.0,16,28,-12
BRA,AUS,2004.0,15,6,9
ARE,NZL,2009.0,3,6,-3
KWT,USA,2001.0,3,6,-3
FRA,REU,2004.0,4,1,3
FIN,BRA,2015.0,1,8,-7
NLD,LTU,2015.0,1,2,-1
LTU,NLD,2016.0,4,2,2
USA,PRI,2006.0,50,36,14
USA,BGR,2016.0,8,8,0
BEL,AUS,2002.0,15,7,8
CHE,NLD,2005.0,37,43,-6
PRT,FIN,2012.0,4,2,2
IND,NLD,2001.0,8,6,2
DZA,FRA,2005.0,27,21,6
NLD,HRV,2020.0,3,7,-4
CHE,NZL,2006.0,6,4,2
GBR,OMN,2005.0,13,4,9
BEL,RUS,2014.0,12,8,4
RUS,KAZ,2011.0,11,4,7
JPN,GRC,2016.0,1,5,-4
BRA,MEX,2001.0,4,5,-1
SVK,SWE,2002.0,2,3,-1
HRV,AUT,2000.0,4,1,3
ESP,NLD,1999.0,19,15,4
DEU,PER,2011.0,2,1,1
CHN,RUS,2002.0,7,4,3
IRL,ISR,2004.0,1,1,0
SWE,ISL,2009.0,2,3,-1
TUR,NOR,2010.0,6,2,4
USA,SVK,1999.0,8,8,0
DNK,USA,1997.0,24,21,3
CHE,LBN,2013.0,3,1,2
TUN,CHE,2010.0,3,1,2
IND,KWT,2007.0,9,1,8
CYP,TUR,2016.0,19,61,-42
NOR,SGP,2011.0,3,3,0
CHE,NLD,2002.0,32,29,3
RUS,FRA,1999.0,30,34,-4
URY,ARG,2022.0,4,8,-4
ITA,AUS,2001.0,11,12,-1
BEL,AUS,2005.0,7,5,2
IND,IRL,2002.0,2,1,1
DNK,AUS,1998.0,2,3,-1
MEX,DEU,2000.0,10,6,4
FRA,NZL,2006.0,12,5,7
ISR,ESP,2001.0,3,4,-1
ZAF,BEL,2003.0,6,5,1
FIN,FRA,2013.0,15,21,-6
GBR,GMB,2008.0,8,2,6
SWE,BRA,2013.0,3,8,-5
NZL,KOR,2008.0,2,3,-1
USA,LKA,2001.0,1,4,-3
SGP,PHL,2018.0,4,2,2
RUS,CZE,2012.0,5,1,4
COL,CHL,2001.0,1,3,-2
NLD,DNK,2006.0,16,11,5
IRL,SWE,2017.0,10,13,-3
AUT,CHN,2003.0,5,4,1
ARG,DEU,2013.0,25,21,4
CAN,SGP,2004.0,12,15,-3
CAN,ARG,2000.0,5,5,0
JPN,FIN,2001.0,10,8,2
PAK,KOR,2004.0,2,1,1
SYR,IND,2018.0,4,1,3
SVK,SWE,2005.0,3,1,2
CHN,AUT,2007.0,5,3,2
BEL,CHN,2014.0,45,33,12
FRA,AUT,2015.0,47,30,17
ALB,FRA,2016.0,1,2,-1
CZE,SWE,2011.0,6,3,3
JPN,NLD,2005.0,12,15,-3
IND,ARE,2012.0,23,4,19
ZAF,DNK,2018.0,5,4,1
GBR,OMN,2002.0,4,2,2
UGA,USA,2003.0,8,8,0
DMA,USA,2010.0,1,1,0
PRT,GBR,2000.0,9,15,-6
DEU,BGR,2009.0,20,16,4
AUT,ESP,2009.0,20,12,8
MEX,CHN,2020.0,4,8,-4
JPN,UKR,2012.0,6,1,5
NGA,CAN,2009.0,2,1,1
GBR,GHA,2010.0,11,4,7
CRI,ESP,2016.0,6,4,2
ITA,IRL,2016.0,28,15,13
JOR,CAN,2013.0,4,6,-2
PAK,HKG,2019.0,11,5,6
IND,NGA,2022.0,5,2,3
POL,AUT,2009.0,7,8,-1
USA,GHA,2011.0,15,10,5
CMR,ITA,2012.0,3,1,2
FIN,AUT,2017.0,8,8,0
GBR,NOR,2008.0,46,32,14
GRC,ESP,2020.0,13,8,5
CHL,COL,2013.0,13,11,2
SRB,NOR,2009.0,2,6,-4
AUS,NPL,2012.0,6,6,0
TWN,NLD,2021.0,4,4,0
IRL,SWE,2019.0,18,15,3
IRN,KOR,2017.0,20,7,13
SRB,ITA,2018.0,3,5,-2
CHE,IRL,2015.0,11,14,-3
MYS,VNM,2018.0,10,1,9
CAN,ZAF,2013.0,13,22,-9
ARG,GBR,2000.0,5,4,1
IRN,IRL,2016.0,5,4,1
KOR,AUT,2015.0,3,5,-2
ITA,TWN,2017.0,5,4,1
GRC,PRT,2019.0,2,3,-1
FIN,IRN,2017.0,6,17,-11
CZE,DNK,2018.0,4,2,2
MDA,ROU,2022.0,1,1,0
KOR,FIN,2021.0,13,3,10
AUT,FRA,2015.0,30,47,-17
NLD,COL,2020.0,9,10,-1
MEX,BEL,2018.0,6,9,-3
ISR,SRB,2018.0,1,2,-1
GBR,CRI,2017.0,4,2,2
CRI,CAN,2020.0,4,5,-1
KWT,GBR,2020.0,5,19,-14
DEU,ROU,2004.0,15,17,-2
NLD,IRL,2022.0,9,13,-4
ZAF,IRL,2020.0,7,3,4
PSE,SAU,2020.0,1,4,-3
FRA,PAK,2022.0,7,5,2
MAR,DZA,2017.0,3,4,-1
JPN,NZL,2021.0,6,5,1
PAK,SAU,2008.0,16,6,10
JPN,MNG,2018.0,14,7,7
DEU,ZAF,2007.0,26,9,17
IRL,AUS,1997.0,1,5,-4
DNK,JPN,2009.0,9,12,-3
FRA,POL,1999.0,12,11,1
GBR,LKA,2007.0,8,4,4
CHL,ARG,2002.0,4,9,-5
ROU,CAN,2003.0,5,3,2
SVK,DEU,2007.0,15,9,6
BEL,VNM,2020.0,15,7,8
ZAF,FIN,2020.0,4,2,2
AUT,NLD,2013.0,21,20,1
IND,OMN,2012.0,7,8,-1
ROU,SWE,2012.0,5,1,4
LTU,BEL,2015.0,3,2,1
EGY,ESP,2016.0,4,18,-14
DNK,CAN,2013.0,16,19,-3
CHE,CZE,2022.0,3,7,-4
SVN,DNK,2015.0,5,1,4
CHN,RWA,2022.0,4,1,3
ITA,MYS,2016.0,2,7,-5
CHE,KEN,2014.0,2,2,0
AUS,SLB,2016.0,2,2,0
UGA,NLD,2019.0,3,5,-2
IDN,BEL,2021.0,4,5,-1
NZL,RUS,2021.0,1,1,0
FRA,CIV,2013.0,35,15,20
NZL,ESP,2012.0,7,12,-5
FIN,AUT,2010.0,6,4,2
ETH,KEN,2015.0,1,2,-1
IRQ,GBR,2018.0,12,130,-118
HTI,USA,2016.0,6,5,1
SVN,DEU,2014.0,13,3,10
USA,JAM,2015.0,3,7,-4
RUS,HRV,2014.0,2,1,1
NLD,HUN,2011.0,8,11,-3
GBR,RUS,2010.0,31,37,-6
NZL,CHL,2006.0,2,1,1
SVN,POL,2012.0,6,2,4
ESP,KOR,2011.0,2,4,-2
CAN,TTO,2017.0,6,1,5
CAN,MYS,2011.0,5,6,-1
MYS,HKG,2017.0,4,5,-1
LUX,GBR,2022.0,3,4,-1
BHR,IRL,2019.0,6,1,5
AUS,NOR,2016.0,18,14,4
TZA,AUS,2011.0,1,2,-1
THA,NZL,2020.0,6,3,3
COL,ESP,1998.0,1,3,-2
ECU,GBR,2016.0,8,7,1
UGA,CHE,2020.0,3,2,1
TUN,DEU,2007.0,1,3,-2
CHE,CHL,2012.0,7,6,1
CAN,ETH,2022.0,2,4,-2
PAK,CAN,2002.0,8,2,6
THA,FRA,2021.0,9,18,-9
BEL,ARE,2020.0,3,1,2
VNM,PHL,2019.0,1,2,-1
MEX,FIN,2016.0,2,3,-1
CZE,JPN,2020.0,4,10,-6
CHE,TZA,2020.0,6,8,-2
FRA,QAT,2021.0,9,10,-1
MYS,FRA,2011.0,3,4,-1
EST,ITA,2019.0,2,9,-7
FRA,SVK,2011.0,4,5,-1
CRI,USA,2002.0,5,13,-8
BGR,SRB,2020.0,1,1,0
IND,IRL,2005.0,4,1,3
CYP,GRC,2004.0,5,5,0
BLR,UKR,2006.0,1,1,0
LTU,USA,2003.0,3,7,-4
FRA,COD,2022.0,1,1,0
ARE,JOR,2001.0,2,3,-1
SWE,CZE,2001.0,4,3,1
DNK,FRO,2016.0,4,1,3
DEU,EST,2012.0,4,3,1
BRA,RUS,2009.0,3,3,0
NLD,NZL,2009.0,11,5,6
ISR,BRA,2009.0,1,2,-1
AUT,IRL,2012.0,6,7,-1
KOR,BEL,2003.0,1,3,-2
SRB,DEU,2012.0,10,17,-7
KWT,QAT,2017.0,2,1,1
SVN,ITA,2011.0,3,7,-4
BRA,CUB,2005.0,6,3,3
USA,CIV,2018.0,4,1,3
AUS,LBN,2015.0,5,1,4
IND,PHL,2013.0,5,6,-1
VNM,CHE,2022.0,4,1,3
MLI,CMR,2007.0,1,1,0
NOR,CAN,2007.0,6,8,-2
BGR,USA,2007.0,10,15,-5
POL,TWN,2016.0,1,2,-1
NLD,ZAF,2009.0,13,16,-3
NZL,SGP,2007.0,6,7,-1
FIN,BEL,2013.0,5,1,4
KOR,NGA,2011.0,1,1,0
AUT,HUN,1999.0,3,2,1
BEL,TUN,2021.0,6,2,4
ESP,UKR,2019.0,1,1,0
ITA,JOR,2009.0,1,1,0
ITA,MEX,2012.0,11,10,1
USA,MAC,2015.0,14,1,13
URY,CHL,2015.0,5,5,0
CAN,GRC,2022.0,5,7,-2
AUT,PRT,2018.0,4,4,0
DEU,TZA,2016.0,6,2,4
BEL,ARG,2007.0,3,1,2
IDN,THA,2014.0,3,3,0
CZE,NLD,2005.0,4,1,3
AUS,BWA,2017.0,2,1,1
EST,ITA,2017.0,2,2,0
VEN,CHL,2014.0,4,3,1
RUS,ROU,2012.0,1,1,0
BEL,ETH,2015.0,4,3,1
ARE,GRC,2017.0,2,6,-4
IDN,IND,2021.0,1,2,-1
NPL,PAK,2017.0,1,3,-2
FRA,RUS,2022.0,14,21,-7
ITA,ISR,2000.0,5,3,2
BGD,ITA,2012.0,3,4,-1
NOR,NZL,2013.0,3,4,-1
ROU,CZE,2021.0,1,1,0
TUR,AUT,2016.0,12,5,7
SVK,ITA,2019.0,2,4,-2
CUB,GBR,2015.0,2,1,1
IRQ,AUS,2015.0,4,6,-2
NOR,NPL,2021.0,1,2,-1
IRQ,MYS,2020.0,17,118,-101
NZL,IND,2021.0,4,11,-7
TUN,CHE,2019.0,3,4,-1
CHE,PRT,2022.0,5,6,-1
DEU,MYS,2020.0,5,13,-8
TUN,PRT,2019.0,1,1,0
USA,BRB,2022.0,1,1,0
NPL,THA,2013.0,1,6,-5
ITA,PER,2009.0,2,1,1
GBR,NPL,2007.0,2,4,-2
USA,UGA,2001.0,7,2,5
AUT,POL,2001.0,4,6,-2
NLD,VNM,2016.0,5,5,0
BRA,JPN,2004.0,10,6,4
FRA,LBN,2001.0,13,8,5
POL,BGR,2013.0,7,2,5
CHL,ARG,2005.0,7,11,-4
THA,SGP,2012.0,5,11,-6
DZA,SAU,2014.0,4,1,3
NOR,CHN,2009.0,9,13,-4
BEL,CZE,2018.0,6,12,-6
KEN,JPN,2012.0,3,5,-2
ISL,GBR,2015.0,1,7,-6
FIN,NAM,2020.0,1,1,0
CHE,ISR,1998.0,2,4,-2
PER,ARG,2014.0,4,3,1
SRB,HRV,2013.0,5,11,-6
BEL,TUR,2006.0,2,1,1
KOR,ZAF,2020.0,4,6,-2
GBR,URY,2001.0,1,2,-1
TUR,IND,2002.0,2,3,-1
DNK,SRB,2014.0,2,2,0
KEN,CHE,2014.0,2,2,0
SVK,ITA,2017.0,2,6,-4
BGD,IND,2015.0,11,12,-1
CRI,USA,2005.0,3,4,-1
GHA,THA,2013.0,1,1,0
PAK,AUS,2006.0,3,2,1
TUR,NOR,2019.0,4,3,1
USA,LVA,2014.0,2,5,-3
LKA,CAN,2013.0,4,6,-2
KOR,UZB,2021.0,4,5,-1
NOR,TUR,2006.0,2,1,1
BGR,GBR,2006.0,5,3,2
HKG,PHL,2003.0,2,1,1
EST,SWE,2003.0,3,10,-7
SAU,BHR,2012.0,1,1,0
RUS,DNK,2012.0,5,2,3
TUR,ITA,2005.0,5,1,4
CHE,SVN,2014.0,1,4,-3
CAN,BFA,2010.0,2,2,0
ZAF,HKG,2008.0,1,1,0
EGY,OMN,2014.0,4,3,1
POL,SVK,2003.0,3,2,1
KWT,JOR,2018.0,3,5,-2
GRC,DNK,2006.0,3,5,-2
NLD,GRC,2011.0,7,19,-12
MCO,DEU,2013.0,2,2,0
USA,SRB,2001.0,10,23,-13
DEU,PSE,2008.0,4,4,0
NOR,JPN,2009.0,2,5,-3
PYF,FRA,2009.0,2,9,-7
ARG,ISR,2003.0,2,2,0
KEN,TZA,2005.0,3,1,2
ISR,ITA,2003.0,9,5,4
ARM,USA,1999.0,1,1,0
AUS,DNK,1998.0,3,2,1
JPN,AUT,1999.0,2,3,-1
ITA,BGR,2018.0,5,1,4
BRA,CHN,2020.0,18,7,11
BHR,IND,2010.0,1,3,-2
ARG,FIN,2001.0,1,1,0
CHN,PRT,2000.0,2,1,1
JPN,BGD,1997.0,1,2,-1
NZL,TWN,2011.0,4,1,3
USA,VEN,2000.0,6,11,-5
HUN,HRV,2012.0,1,1,0
NER,BEN,2012.0,1,1,0
GHA,ZAF,2010.0,3,3,0
DNK,GRC,2004.0,3,2,1
ESP,TUN,2016.0,9,4,5
FIN,SGP,2015.0,1,3,-2
GBR,IDN,2012.0,12,4,8
BHR,SAU,2014.0,1,3,-2
PRT,TUR,2015.0,2,4,-2
EGY,CHE,2013.0,2,6,-4
DNK,TUR,2016.0,1,7,-6
LAO,JPN,2003.0,1,1,0
SAU,NLD,2018.0,6,10,-4
CHE,RUS,2007.0,6,15,-9
BLR,POL,2007.0,4,4,0
SAU,IND,2008.0,8,21,-13
AUS,QAT,2011.0,3,2,1
ZAF,TTO,2014.0,1,3,-2
AUS,KHM,2009.0,1,1,0
USA,DZA,2016.0,9,1,8
NLD,TWN,2021.0,4,4,0
CAN,UKR,2018.0,4,3,1
URY,DNK,2013.0,1,1,0
MDA,RUS,2018.0,2,1,1
HRV,SVN,2004.0,1,1,0
USA,DOM,2022.0,3,2,1
QAT,ARE,2014.0,1,12,-11
SVK,ITA,2010.0,1,7,-6
DNK,ISL,2013.0,5,6,-1
NOR,IDN,2016.0,2,1,1
CHN,CZE,2006.0,1,1,0
SWE,KOR,2009.0,3,9,-6
BGR,RUS,2009.0,2,1,1
GBR,BGR,2009.0,2,4,-2
LTU,GBR,2003.0,3,4,-1
KWT,IND,2009.0,3,8,-5
ITA,IRN,2006.0,2,4,-2
ARE,PAK,2019.0,6,20,-14
VEN,CUB,2003.0,1,3,-2
DEU,JOR,2013.0,5,9,-4
USA,ROU,2004.0,11,19,-8
BRA,UGA,2020.0,1,1,0
LTU,DNK,2013.0,3,1,2
TUR,LTU,2017.0,1,1,0
CHN,QAT,2019.0,4,3,1
IDN,BRA,2019.0,1,2,-1
ITA,CUB,2010.0,2,3,-1
BHS,CAN,2017.0,1,1,0
SAU,KWT,2007.0,4,1,3
CZE,VNM,2018.0,7,4,3
IRQ,FRA,2017.0,1,9,-8
CHE,LBR,2019.0,2,7,-5
EGY,KOR,2021.0,4,9,-5
POL,ROU,2011.0,4,3,1
CHL,CRI,2004.0,1,1,0
NOR,CHE,2006.0,6,7,-1
CAN,TTO,2010.0,1,1,0
AUS,DNK,1997.0,1,1,0
AUT,IDN,2020.0,4,1,3
MLT,DEU,2020.0,1,1,0
GHA,CAN,2012.0,3,3,0
ITA,CUB,2017.0,1,3,-2
DEU,LBN,2015.0,2,5,-3
IRQ,FRA,2019.0,1,14,-13
ITA,NGA,2015.0,3,4,-1
BRA,SWE,2009.0,5,6,-1
BEL,EGY,2004.0,1,1,0
PRT,RUS,1997.0,1,1,0
CZE,GRC,2019.0,2,11,-9
FIN,IRN,2010.0,3,5,-2
MYS,HKG,2010.0,3,5,-2
SRB,ARE,2017.0,1,1,0
IRL,ARE,2020.0,2,2,0
GBR,CMR,2014.0,1,3,-2
MAR,NLD,2014.0,2,1,1
ROU,CHE,2017.0,7,5,2
DOM,ESP,2022.0,1,2,-1
CHE,CMR,2007.0,2,1,1
ARE,NOR,2020.0,3,1,2
IRL,KOR,2020.0,4,3,1
MNE,USA,2002.0,1,1,0
AUT,ARG,2002.0,1,1,0
TWN,KOR,2008.0,4,9,-5
BEL,MEX,2008.0,2,3,-1
SGP,NOR,2015.0,3,3,0
AUS,GRC,2016.0,4,13,-9
CZE,TUR,2013.0,1,2,-1
COL,MEX,2009.0,7,2,5
TUR,ROU,2006.0,2,2,0
MMR,IDN,2017.0,1,1,0
SAU,COL,2021.0,2,2,0
JPN,POL,2022.0,6,6,0
BIH,USA,2020.0,5,1,4
POL,IRN,2011.0,1,3,-2
GRC,JPN,2008.0,1,1,0
KWT,QAT,2019.0,2,1,1
AZE,RUS,2011.0,5,5,0
RUS,AUT,1999.0,2,1,1
DEU,GEO,2006.0,1,6,-5
ITA,ROU,2001.0,2,6,-4
LTU,CZE,2004.0,1,1,0
BRA,CHE,2001.0,3,5,-2
BGR,ITA,2004.0,1,9,-8
DZA,CAN,2001.0,1,1,0
DEU,ARM,2009.0,1,2,-1
COL,DNK,2005.0,1,1,0
CHE,BGR,2009.0,2,2,0
RUS,EST,2002.0,2,1,1
AUS,ISR,2004.0,5,11,-6
DNK,NZL,2004.0,3,6,-3
MYS,EGY,2006.0,2,1,1
ROU,UKR,2007.0,1,1,0
AUS,KEN,2010.0,3,3,0
MAC,USA,2022.0,2,2,0
GHA,NLD,2011.0,2,2,0
PER,BRA,2004.0,4,5,-1
NOR,SAU,2020.0,3,2,1
JPN,PRT,2011.0,4,3,1
MAR,DZA,2019.0,3,2,1
NZL,HUN,2017.0,1,1,0
ZAF,ITA,2008.0,4,5,-1
RWA,IND,2018.0,1,2,-1
HKG,NOR,2008.0,1,1,0
COL,ECU,2022.0,1,1,0
KEN,PHL,2018.0,1,1,0
CZE,NLD,2002.0,3,3,0
DEU,NZL,1999.0,6,3,3
TWN,NZL,2013.0,3,2,1
ARE,BGD,2021.0,1,1,0
MYS,NLD,2013.0,5,6,-1
MWI,NLD,2012.0,2,2,0
POL,SAU,2013.0,4,4,0
BRA,CUB,2002.0,3,4,-1
SWE,KWT,2014.0,1,1,0
GBR,MYS,1997.0,3,1,2
ZAF,NOR,2012.0,6,1,5
CHE,THA,2008.0,3,3,0
ARE,AUS,2015.0,4,15,-11
ZAF,GRC,2017.0,1,4,-3
CHL,BEL,2021.0,4,3,1
LBN,CZE,2018.0,1,1,0
MYS,BEL,2009.0,3,2,1
BRN,MYS,2021.0,1,6,-5
CYP,AUS,2019.0,2,1,1
BFA,SEN,2015.0,1,3,-2
ECU,AUS,2021.0,3,3,0
GBR,MYS,1998.0,1,1,0
LVA,DEU,2015.0,3,3,0
BGR,CHE,2020.0,2,2,0
ESP,SRB,2016.0,2,2,0
CAN,CRI,2021.0,2,1,1
GRC,POL,2021.0,2,1,1
TZA,IND,2013.0,2,1,1
CHE,LBR,2017.0,1,1,0
ARE,CHE,2020.0,1,4,-3
BRA,NLD,1998.0,1,1,0
ARE,PAK,2010.0,2,3,-1
QAT,CHE,2020.0,1,1,0
IRL,HKG,2014.0,3,2,1
CHL,IND,2015.0,2,6,-4
NOR,HRV,2014.0,1,1,0
SWE,SRB,2018.0,1,6,-5
CYP,AUS,2017.0,1,1,0
BEL,COG,2005.0,2,2,0
TUR,TWN,2003.0,2,1,1
COG,GHA,2015.0,1,2,-1
CZE,GRC,2010.0,1,1,0
IND,ERI,2006.0,2,1,1
OMN,MYS,2013.0,1,6,-5
JOR,FRA,2007.0,2,1,1
ESP,UKR,2017.0,3,1,2
PRT,ITA,2009.0,4,18,-14
MAR,TUN,2009.0,1,2,-1
IRL,HUN,2022.0,1,1,0
SDN,CHN,2006.0,2,1,1
ARM,DEU,2000.0,2,3,-1
PAK,ZAF,2021.0,2,5,-3
ARE,GRC,2019.0,1,5,-4
LKA,NOR,2012.0,3,1,2
IRL,FIN,2015.0,1,5,-4
CHE,PAK,2016.0,2,2,0
MLI,CAN,2008.0,2,1,1
RUS,PRT,2013.0,1,1,0
JAM,TTO,2011.0,1,3,-2
CHE,GHA,2019.0,2,7,-5
SWE,MEX,2012.0,3,9,-6
KEN,NGA,2022.0,2,2,0
MAR,DZA,2010.0,1,1,0
BEL,BGR,2000.0,3,1,2
CHE,ISR,1997.0,2,3,-1
GHA,MYS,2018.0,1,3,-2
SRB,FRA,2013.0,4,3,1
POL,THA,2013.0,1,2,-1
FRA,CYP,2011.0,1,1,0
MDG,GBR,2007.0,1,1,0
BEL,CHL,2002.0,1,3,-2
CUB,COL,2018.0,3,3,0
DEU,MDA,2015.0,1,1,0
FIN,SAU,2014.0,1,1,0
ITA,CUB,2019.0,1,1,0
NOR,MYS,2018.0,2,7,-5
TUN,IRN,2015.0,1,1,0
TUN,BHR,2022.0,1,1,0
NZL,JPN,2001.0,2,7,-5
UKR,CAN,2001.0,3,2,1
SDN,BHR,2013.0,1,2,-1
RUS,BGR,2022.0,1,3,-2
ITA,TWN,2010.0,2,1,1
IRQ,DEU,2016.0,3,5,-2
NPL,BEL,2008.0,1,1,0
ZAF,IRN,2022.0,1,4,-3
USA,BFA,2021.0,1,1,0
FRA,BOL,2014.0,3,3,0
BEN,TGO,2007.0,1,2,-1
BOL,ESP,2009.0,1,1,0
BEL,BFA,2021.0,2,2,0
IND,LKA,2011.0,1,3,-2
CAN,BFA,2019.0,1,3,-2
IRN,ISR,2009.0,1,1,0
PNG,CHE,2010.0,1,1,0
TUN,ITA,2002.0,1,2,-1
CHL,NZL,2022.0,1,2,-1
FRA,PER,2009.0,1,5,-4
SVN,AUT,2008.0,4,5,-1
LKA,CHE,2019.0,1,3,-2
BRN,GBR,2021.0,1,3,-2
GIN,MLI,2012.0,2,2,0
RUS,EST,2005.0,1,1,0
AUT,PER,2011.0,1,1,0
LKA,DEU,2006.0,1,2,-1
BRN,IND,2012.0,2,2,0
OMN,DEU,2011.0,1,4,-3
KEN,NZL,2003.0,1,1,0
COG,USA,2004.0,1,1,0
ESP,RUS,1997.0,1,2,-1
SWE,ECU,2013.0,1,1,0
CRI,FRA,2018.0,1,4,-3
NLD,UKR,2016.0,1,5,-4
PER,AUS,2018.0,3,2,1
GEO,UKR,2019.0,1,1,0
LSO,USA,2018.0,2,1,1
PAK,CZE,2019.0,1,5,-4
FIN,NLD,1999.0,1,5,-4
BGD,FRA,2013.0,1,1,0
TWN,BEL,2021.0,1,3,-2
BOL,PER,2022.0,1,1,0
TWN,TUR,2021.0,2,4,-2
LBY,SRB,2016.0,1,3,-2
DEU,SEN,2019.0,1,1,0
TUN,PRT,2017.0,1,2,-1
BRA,JAM,2021.0,1,1,0
ARE,PAK,2017.0,2,11,-9
NOR,LUX,2018.0,1,2,-1
NZL,BGD,2015.0,1,1,0
UKR,SGP,2017.0,1,1,0
BRA,BOL,2003.0,1,2,-1
CHL,URY,2006.0,1,3,-2
SLE,CHN,2011.0,1,1,0
KEN,NPL,2019.0,1,1,0
CHN,TJK,2019.0,1,3,-2
IRL,AUS,1998.0,1,1,0
OMN,SAU,2008.0,1,1,0
TUN,CAN,2006.0,1,4,-3
MYS,TUR,2002.0,1,1,0
CZE,FIN,2001.0,1,1,0
VNM,PHL,2017.0,1,1,0
FRA,ETH,2018.0,2,1,1
BHR,IND,2017.0,1,1,0
ROU,NOR,2014.0,1,2,-1
SVN,FRA,2004.0,1,1,0
ARE,ZAF,2004.0,1,1,0
SDN,USA,2005.0,1,3,-2
LKA,CHE,2017.0,1,1,0
BEL,UKR,2016.0,1,2,-1
NCL,FRA,1999.0,1,2,-1
BHR,IND,2019.0,1,5,-4
TWN,BGD,2014.0,1,1,0
POL,MAR,2020.0,1,2,-1
NOR,BLR,2019.0,1,3,-2
ISR,HUN,2009.0,1,3,-2
HKG,IRL,2020.0,1,1,0
LKA,JPN,2015.0,1,12,-11
DNK,BGD,2022.0,1,1,0
BEL,NLD,2003.0,97,78,19
AUS,NLD,2008.0,39,48,-9
ZAF,CAN,2008.0,22,14,8
JPN,NLD,2002.0,24,16,8
USA,ISR,2008.0,241,339,-98
THA,CHN,2004.0,2,2,0
PAK,BGD,2007.0,4,5,-1
JPN,ITA,2013.0,14,21,-7
GHA,ZAF,2017.0,12,18,-6
USA,GTM,2012.0,8,3,5
KHM,FRA,2013.0,3,4,-1
AUS,IDN,2015.0,73,23,50
CAN,CHE,2004.0,51,41,10
FRA,MWI,2020.0,1,1,0
USA,EGY,2000.0,16,16,0
CHN,NLD,2012.0,79,46,33
FRA,VNM,2014.0,46,13,33
SAU,EGY,2020.0,172,251,-79
KOR,AUS,2018.0,58,23,35
GBR,NZL,1997.0,9,5,4
LBN,FRA,2020.0,65,61,4
ESP,BRA,2022.0,21,41,-20
TUN,FRA,2017.0,68,118,-50
VEN,MEX,2018.0,14,4,10
KOR,SGP,2021.0,20,25,-5
LUX,DEU,2020.0,30,32,-2
PRT,USA,2005.0,33,30,3
CHL,BRA,2021.0,14,25,-11
ITA,ESP,2009.0,154,81,73
CAN,JPN,2012.0,66,77,-11
TUN,FRA,2010.0,72,105,-33
COL,VEN,2015.0,4,18,-14
TWN,JPN,2016.0,53,41,12
SAU,PAK,2015.0,24,71,-47
IRL,EGY,2013.0,1,1,0
SEN,BFA,2003.0,1,1,0
POL,UKR,2010.0,14,16,-2
PER,ESP,2015.0,8,16,-8
ROU,CHE,2019.0,6,5,1
FRA,GIN,2016.0,5,3,2
FIN,IRN,2019.0,2,31,-29
MYS,DEU,2020.0,13,5,8
NLD,IRN,2008.0,10,14,-4
CHE,GRC,2016.0,9,37,-28
MEX,FRA,2021.0,32,26,6
AUT,EGY,2008.0,2,3,-1
EST,USA,2011.0,5,5,0
CHE,BRA,2013.0,14,15,-1
HUN,AUT,2012.0,14,9,5
NLD,ISL,2006.0,2,2,0
SGP,DNK,2007.0,2,2,0
RUS,LTU,1998.0,2,1,1
DEU,UGA,2004.0,1,1,0
ISR,RUS,2016.0,11,6,5
JPN,AUS,1999.0,15,25,-10
ESP,PER,2004.0,5,1,4
IND,SGP,2007.0,32,23,9
FRA,DJI,2004.0,1,1,0
SGP,JPN,2004.0,10,14,-4
ARG,BRA,2006.0,21,14,7
BEL,ROU,2011.0,8,6,2
SWE,CHE,2018.0,51,63,-12
VNM,CHN,2021.0,7,17,-10
CHN,CHL,2022.0,3,3,0
GHA,JPN,2018.0,5,2,3
SGP,IRN,2016.0,8,5,3
BRA,PER,2014.0,14,11,3
THA,HUN,2014.0,1,1,0
HUN,BEL,2018.0,7,6,1
DEU,IDN,2007.0,10,3,7
CUB,ESP,2022.0,7,5,2
IND,BRA,2009.0,5,6,-1
UKR,FRA,2015.0,21,7,14
DEU,LVA,2015.0,3,3,0
BRA,ZAF,2020.0,7,4,3
ESP,IRN,2018.0,7,25,-18
SAU,SGP,2018.0,5,7,-2
CRI,DNK,2017.0,1,2,-1
IND,CHE,2002.0,11,6,5
NZL,FRA,2007.0,7,10,-3
QAT,USA,2013.0,16,44,-28
TUR,FRA,2001.0,3,2,1
ERI,IND,2006.0,1,2,-1
GBR,CZE,2022.0,15,21,-6
PSE,EGY,2015.0,3,4,-1
POL,ESP,2019.0,20,25,-5
IRL,NLD,2011.0,13,9,4
TTO,USA,2004.0,5,6,-1
ARE,SAU,2013.0,8,9,-1
CAN,BFA,2017.0,5,2,3
PRI,VEN,2016.0,1,2,-1
CAN,VNM,2020.0,7,2,5
PAK,IRN,2004.0,1,2,-1
URY,USA,2001.0,7,4,3
ESP,DZA,2018.0,6,3,3
ARG,CHL,2000.0,1,4,-3
KAZ,RUS,2009.0,9,4,5
KWT,SAU,2014.0,2,3,-1
TUN,USA,2012.0,4,9,-5
HUN,AUS,2018.0,6,3,3
KEN,PAK,2009.0,4,3,1
ECU,ITA,2018.0,6,7,-1
KOR,PAK,2008.0,3,5,-2
VNM,NZL,2019.0,4,5,-1
FRA,SEN,2021.0,14,17,-3
THA,CHE,2015.0,3,3,0
MDG,FRA,2021.0,3,4,-1
SGP,PAK,2004.0,3,2,1
USA,SDN,2013.0,1,1,0
GBR,KHM,2017.0,2,4,-2
RUS,MAR,2021.0,2,1,1
GHA,ZAF,2019.0,10,16,-6
MCO,FRA,2016.0,7,4,3
COG,CHE,2005.0,1,1,0
ESP,GRC,2015.0,11,17,-6
ESP,RUS,1998.0,8,6,2
SRB,SWE,2021.0,4,1,3
KOR,POL,2000.0,2,1,1
ARE,MYS,2007.0,2,3,-1
PHL,GBR,2009.0,3,2,1
MAR,MEX,2002.0,2,1,1
TUR,NOR,2017.0,6,2,4
GBR,ISL,2013.0,6,7,-1
ZAF,BWA,2010.0,5,3,2
CHN,GRC,2004.0,1,1,0
EGY,ZAF,2021.0,1,3,-2
MOZ,FRA,2013.0,1,1,0
DEU,DZA,2013.0,1,1,0
FRA,GHA,2022.0,1,2,-1
ARE,FIN,2016.0,1,3,-2
GBR,KHM,2019.0,2,2,0
SAU,KOR,2011.0,1,20,-19
USA,GUY,2006.0,2,1,1
COL,SGP,2020.0,1,2,-1
BLR,CAN,2009.0,2,1,1
HRV,MKD,2020.0,1,3,-2
FJI,USA,2012.0,1,2,-1
JPN,PHL,2000.0,1,2,-1
BRA,PAN,2013.0,1,2,-1
MNG,KOR,2008.0,1,2,-1
ZAF,NAM,2007.0,1,3,-2
DNK,AUS,1997.0,1,1,0
NLD,JOR,2011.0,1,1,0
CHE,TWN,2003.0,2,1,1
JPN,NOR,2000.0,1,3,-2
RUS,,2019.0,10584,0,10584
GBR,,2010.0,10325,0,10325
RUS,,2010.0,3887,0,3887
COL,,2023.0,7803,0,7803
,CHN,1997.0,11774,0,11774
,CHE,2003.0,3538,0,3538
USA,,2009.0,46972,0,46972
RUS,,2017.0,6641,0,6641
GBR,,2017.0,15376,0,15376
POL,,2019.0,4970,0,4970
,CHN,1998.0,25282,0,25282
,RUS,2007.0,7260,0,7260
,BLR,1996.0,290,0,290
CHE,,2021.0,6410,0,6410
,ZAF,2001.0,1403,0,1403
,SAU,2004.0,445,0,445
PAK,,2024.0,21010,0,21010
ZAF,,2024.0,14091,0,14091
SRB,,2023.0,5056,0,5056
SGP,,2012.0,836,0,836
,ISR,2002.0,2579,0,2579
BFA,,2023.0,425,0,425
GBR,,2019.0,19600,0,19600
,THA,2006.0,1980,0,1980
,JPN,2009.0,23394,0,23394
,ISR,2005.0,2345,0,2345
DEU,,2004.0,7219,0,7219
,AUT,1995.0,1414,0,1414
,TUR,2017.0,6502,0,6502
JOR,LBN,2018.0,2,0,2
POL,,2010.0,1946,0,1946
,HKG,2002.0,1522,0,1522
AUS,,2016.0,5952,0,5952
,NLD,2012.0,6505,0,6505
TUN,,2021.0,1728,0,1728
,SVK,2007.0,723,0,723
,BLR,2004.0,276,0,276
FIN,,2011.0,1116,0,1116
,TUR,2010.0,7213,0,7213
PRT,,2013.0,880,0,880
,KOR,2011.0,15705,0,15705
SVN,,2008.0,148,0,148
,VNM,2011.0,728,0,728
,ROU,2000.0,980,0,980
,TWN,2009.0,7469,0,7469
ITA,,2007.0,4407,0,4407
POL,,2017.0,3745,0,3745
MNG,,2011.0,8,0,8
,LTU,2003.0,605,0,605
BGD,,2022.0,1436,0,1436
,ARG,2008.0,2668,0,2668
,PRI,1999.0,164,0,164
,QAT,2012.0,232,0,232
LTU,,2012.0,214,0,214
SVK,BDI,2019.0,2,0,2
VNM,,2016.0,220,0,220
ECU,,2014.0,30,0,30
,URY,2009.0,237,0,237
,HKG,2005.0,1356,0,1356
,TUR,2019.0,4469,0,4469
CAN,LVA,2022.0,1,0,1
IDN,,2015.0,213,0,213
,EGY,1994.0,835,0,835
HND,,2013.0,4,0,4
MMR,,2023.0,228,0,228
,GUF,2001.0,7,0,7
GUF,DEU,2005.0,1,0,1
LAO,,2021.0,71,0,71
,ARE,1999.0,150,0,150
IRQ,,2012.0,41,0,41
,SAU,1996.0,281,0,281
,SDN,2010.0,107,0,107
CHL,,2003.0,104,0,104
,DEU,2018.0,19302,0,19302
JAM,,2019.0,62,0,62
,VEN,2010.0,417,0,417
,KWT,2010.0,143,0,143
,PHL,2011.0,416,0,416
KAZ,,2016.0,163,0,163
,IDN,2012.0,2262,0,2262
,BGD,2002.0,352,0,352
,ITA,2018.0,14680,0,14680
,BTN,2010.0,7,0,7
,BGD,2005.0,518,0,518
LBR,KEN,2015.0,1,0,1
SEN,,2016.0,68,0,68
FJI,BHR,2018.0,1,0,1
,YEM,2011.0,43,0,43
,KWT,2017.0,189,0,189
CYP,,2018.0,105,0,105
TGO,,2023.0,123,0,123
,KEN,2018.0,502,0,502
PRT,CZE,2018.0,11,0,11
GUF,,2023.0,59,0,59
,PER,1999.0,174,0,174
BEN,USA,2020.0,4,0,4
,OMN,2015.0,139,0,139
,MNG,2006.0,38,0,38
ARE,,2009.0,61,0,61
,VEN,2017.0,140,0,140
,ALB,2016.0,43,0,43
FSM,,2020.0,4,0,4
,AZE,2006.0,186,0,186
IND,LTU,2018.0,1,0,1
,MOZ,2017.0,66,0,66
,SDN,2017.0,151,0,151
FIN,VNM,2020.0,5,0,5
,PRK,2017.0,103,0,103
CAF,,2024.0,25,0,25
,LSO,2016.0,4,0,4
,ISL,2002.0,128,0,128
PNG,CHE,2017.0,2,0,2
DNK,UGA,2001.0,1,0,1
,PRK,2019.0,57,0,57
,KWT,2019.0,118,0,118
GNB,,2023.0,10,0,10
,KHM,2004.0,25,0,25
RWA,,2015.0,12,0,12
NCL,,2015.0,14,0,14
,UGA,2003.0,130,0,130
MLT,,2012.0,15,0,15
,ISL,2005.0,108,0,108
,ZMB,2005.0,44,0,44
,LBY,2006.0,37,0,37
,DOM,2007.0,9,0,9
JOR,,2008.0,61,0,61
HTI,HUN,2014.0,1,0,1
ALB,DEU,2014.0,1,0,1
,CPV,2005.0,1,0,1
MRT,,2019.0,15,0,15
VEN,GBR,2020.0,3,0,3
EGY,THA,2022.0,4,0,4
BRA,QAT,2019.0,2,0,2
GUM,DEU,2012.0,1,0,1
,SDN,2019.0,86,0,86
,MOZ,2010.0,34,0,34
KEN,,2008.0,74,0,74
SLE,,2021.0,31,0,31
,GMB,2017.0,34,0,34
IDN,TZA,2021.0,1,0,1
JAM,,2010.0,33,0,33
,ZMB,2002.0,33,0,33
,BHR,2000.0,31,0,31
EST,,2008.0,51,0,51
ETH,,2011.0,43,0,43
ARM,,2006.0,59,0,59
NPL,PAK,2010.0,1,0,1
,LAO,2000.0,5,0,5
SWE,LVA,2004.0,5,0,5
SUR,NLD,2009.0,1,0,1
,MLT,2001.0,28,0,28
CAN,GEO,2016.0,1,0,1
,HND,2002.0,6,0,6
MAR,GBR,2008.0,4,0,4
BEL,ISR,1997.0,1,0,1
REU,,2010.0,5,0,5
GMB,,2014.0,10,0,10
JOR,AUS,2004.0,3,0,3
ESP,SAU,2009.0,2,0,2
HKG,PNG,2017.0,1,0,1
BEN,,2005.0,5,0,5
KWT,,2005.0,43,0,43
IRN,KOR,2010.0,4,0,4
JPN,BLR,2002.0,2,0,2
GTM,HND,2015.0,1,0,1
NGA,TZA,2012.0,2,0,2
DEU,IRQ,2009.0,1,0,1
GRC,QAT,2014.0,7,0,7
ZAF,BGR,1997.0,1,0,1
ARG,PRI,2020.0,4,0,4
KWT,,2002.0,12,0,12
LBN,,2003.0,25,0,25
DNK,MOZ,2015.0,1,0,1
WSM,,2016.0,2,0,2
PER,GHA,2017.0,1,0,1
EGY,TUN,2014.0,2,0,2
BRN,CAN,2001.0,1,0,1
LVA,JPN,2016.0,1,0,1
PAK,SVK,2015.0,1,0,1
BGR,SGP,2009.0,1,0,1
TUN,CHE,2017.0,6,0,6
JAM,,2017.0,30,0,30
SVN,JPN,2013.0,2,0,2
IND,NAM,2008.0,1,0,1
FIN,ETH,2014.0,2,0,2
PAK,CHN,1998.0,1,0,1
IRN,DZA,2021.0,1,0,1
GBR,KHM,2010.0,3,0,3
GRC,NGA,2015.0,1,0,1
,GMB,2010.0,15,0,15
FRA,PSE,2012.0,3,0,3
,AFG,2005.0,3,0,3
KGZ,,2012.0,4,0,4
IRN,PER,2020.0,3,0,3
KOR,QAT,2008.0,2,0,2
JPN,GIN,2019.0,1,0,1
SEN,HUN,2016.0,2,0,2
GBR,PLW,2017.0,1,0,1
DOM,,2014.0,4,0,4
TUR,SAU,2011.0,2,0,2
LBR,,2017.0,3,0,3
IRQ,THA,2019.0,1,0,1
,PRK,2010.0,4,0,4
,GAB,2000.0,8,0,8
,MDV,2013.0,4,0,4
LBR,,2019.0,9,0,9
MLI,ZAF,2000.0,1,0,1
SVN,CHN,2022.0,2,0,2
BEL,TWN,2022.0,3,0,3
NAM,AGO,2020.0,1,0,1
MYS,PER,2021.0,1,0,1
,BHS,2017.0,1,0,1
,BTN,2017.0,24,0,24
TTO,ZAF,2015.0,1,0,1
,REU,2003.0,3,0,3
RUS,TWN,2006.0,2,0,2
CHN,BGR,2006.0,1,0,1
ESP,PRI,2012.0,2,0,2
NLD,BGD,2003.0,1,0,1
TCA,USA,2014.0,1,0,1
BEL,KAZ,2014.0,1,0,1
IRL,NPL,2019.0,1,0,1
BEL,ECU,2022.0,2,0,2
AUT,THA,2021.0,1,0,1
UGA,BGD,2014.0,1,0,1
AUT,CRI,2020.0,2,0,2
NIC,SLV,2005.0,1,0,1
,VEN,2019.0,59,0,59
PRT,GNB,2013.0,1,0,1
ZWE,,2005.0,15,0,15
PRI,UKR,2021.0,1,0,1
MNE,,2008.0,3,0,3
GBR,CIV,2003.0,1,0,1
PHL,NLD,2004.0,3,0,3
RUS,HKG,2001.0,2,0,2
,MNP,1995.0,1,0,1
,GIB,2004.0,2,0,2
SDN,USA,2002.0,2,0,2
BWA,CHE,2019.0,2,0,2
BLZ,,2016.0,1,0,1
NGA,GHA,2004.0,1,0,1
NLD,DZA,2021.0,2,0,2
DEU,SAU,2007.0,6,0,6
ZAF,ESP,2003.0,3,0,3
ARM,ESP,2012.0,1,0,1
HUN,USA,2023.0,1,0,1
PAK,HKG,2010.0,1,0,1
MCO,CAN,2021.0,1,0,1
LBN,ARE,2018.0,9,0,9
HUN,TUR,2004.0,1,0,1
TUN,EGY,2011.0,2,0,2
,HND,2005.0,5,0,5
HUN,ZAF,1998.0,2,0,2
PHL,MAC,2013.0,1,0,1
ARM,IRN,2015.0,3,0,3
MRT,,2017.0,6,0,6
FIN,LVA,2011.0,1,0,1
KAZ,BWA,2022.0,1,0,1
EGY,SGP,2016.0,4,0,4
NPL,MYS,2022.0,1,0,1
IND,MAC,2016.0,2,0,2
ARG,TUR,2014.0,1,0,1
GBR,LSO,2021.0,1,0,1
ERI,USA,2020.0,1,0,1
COL,BEL,2001.0,2,0,2
FRA,YEM,2010.0,1,0,1
CHE,LKA,2022.0,1,0,1
SWE,ISR,2006.0,2,0,2
PRT,SVK,2020.0,1,0,1
CHE,GHA,2010.0,1,0,1
BGD,BTN,2021.0,2,0,2
ESP,YEM,2005.0,1,0,1
DEU,BOL,2006.0,1,0,1
BGR,CZE,2001.0,1,0,1
BGD,FIN,2013.0,3,0,3
JAM,USA,2000.0,4,0,4
ARM,POL,2019.0,1,0,1
MNE,DEU,2017.0,2,0,2
PSE,OMN,2018.0,1,0,1
AFG,BEL,2017.0,1,0,1
GEO,ITA,2019.0,1,0,1
TUR,LBY,2007.0,1,0,1
DZA,EST,2019.0,1,0,1
BRB,,2014.0,6,0,6
TUN,SYR,2015.0,1,0,1
SWE,PAN,2016.0,2,0,2
LUX,IND,2016.0,2,0,2
CHL,UKR,2006.0,1,0,1
BEN,IND,2008.0,1,0,1
TUR,SDN,1999.0,1,0,1
BRA,ISL,2006.0,1,0,1
UKR,ETH,2009.0,1,0,1
SVN,ARG,2003.0,1,0,1
RUS,GRL,2013.0,1,0,1
ARE,BHR,2004.0,1,0,1
KGZ,UZB,2006.0,2,0,2
NPL,LAO,2006.0,1,0,1
JPN,BGD,1998.0,3,0,3
CHL,VEN,2001.0,1,0,1
OMN,ARE,2011.0,1,0,1
BLR,AUT,2010.0,1,0,1
ITA,MDA,2000.0,1,0,1
NPL,MHL,2002.0,1,0,1
JOR,NZL,1999.0,1,0,1
MAR,PRT,2001.0,3,0,3
USA,MCO,2001.0,1,0,1
HRV,DNK,1997.0,1,0,1
BHR,,1999.0,1,0,1
THA,MYS,2006.0,1,0,1
CHE,LTU,2022.0,1,0,1
PSE,,2007.0,3,0,3
IRL,BHR,2001.0,1,0,1
ITA,QAT,2013.0,3,0,3
TUN,ARE,2006.0,1,0,1
CZE,GHA,2010.0,1,0,1
CMR,CAN,2011.0,1,0,1
CHE,CYP,2020.0,2,0,2
ESP,EST,2016.0,4,0,4
GRC,PRT,2017.0,3,0,3
MYS,SAU,2000.0,1,0,1
,BHS,2010.0,1,0,1
HKG,CHL,2016.0,2,0,2
ARM,POL,2017.0,1,0,1
,COM,2012.0,3,0,3
ETH,PHL,2019.0,1,0,1
CHE,BFA,2007.0,1,0,1
SLV,USA,1999.0,1,0,1
SWZ,,2001.0,1,0,1
GBR,GRL,2009.0,2,0,2
CUB,PER,2018.0,2,0,2
USA,NAM,2009.0,1,0,1
GBR,BRB,2009.0,1,0,1
DEU,QAT,2007.0,2,0,2
GTM,MEX,2003.0,1,0,1
BOL,IDN,2012.0,1,0,1
IND,BGR,2021.0,1,0,1
NAM,,2013.0,5,0,5
MRT,,2010.0,1,0,1
COD,COG,2000.0,1,0,1
,BIH,1994.0,3,0,3
JPN,KEN,2000.0,1,0,1
REU,,2019.0,2,0,2
MYS,KWT,2009.0,1,0,1
OMN,NZL,2007.0,1,0,1
NLD,NPL,2003.0,1,0,1
CUB,AGO,2005.0,1,0,1
FRA,ARM,2012.0,2,0,2
GIB,,2020.0,2,0,2
GHA,KEN,2014.0,2,0,2
CHE,SAU,2013.0,2,0,2
MEX,PRI,2008.0,1,0,1
NER,IND,2012.0,2,0,2
OMN,CHN,2006.0,1,0,1
TON,IND,2018.0,1,0,1
EGY,BHR,2003.0,1,0,1
SAU,TUN,2002.0,1,0,1
TUR,GEO,2013.0,2,0,2
FIN,UGA,2018.0,1,0,1
IND,YEM,2016.0,6,0,6
SVK,MLT,2006.0,1,0,1
HKG,POL,2019.0,2,0,2
KAZ,UZB,2020.0,3,0,3
NGA,AUS,2022.0,5,0,5
NOR,IRQ,2016.0,1,0,1
MNE,SVN,2020.0,1,0,1
GRC,EST,2020.0,1,0,1
TUR,RWA,2021.0,2,0,2
HND,MEX,2022.0,1,0,1
UZB,,2025.0,6,0,6
JPN,GEO,2005.0,1,0,1
PHL,CZE,2003.0,1,0,1
CUB,SWE,2016.0,2,0,2
ITA,NPL,2009.0,1,0,1
LTU,ESP,2013.0,1,0,1
MYS,PNG,2018.0,2,0,2
TWN,HKG,1997.0,1,0,1
MEX,BGD,2007.0,2,0,2
NLD,BIH,2021.0,1,0,1
IRL,EST,2016.0,2,0,2
MLT,IRL,2005.0,1,0,1
CAN,TTO,2019.0,2,0,2
VNM,ROU,2018.0,1,0,1
DNK,ZWE,2002.0,1,0,1
ARM,JPN,1999.0,1,0,1
NGA,PAK,1998.0,1,0,1
MKD,USA,2001.0,2,0,2
BEL,NGA,1999.0,1,0,1
KOR,MDA,2019.0,1,0,1
AUT,LIE,2008.0,1,0,1
CUB,UGA,2014.0,1,0,1
EST,SAU,2020.0,1,0,1
TUR,TUN,2007.0,1,0,1
FRA,LTU,2018.0,3,0,3
PHL,CHN,2006.0,5,0,5
BEL,BGD,2009.0,1,0,1
MKD,NOR,2022.0,1,0,1
TUN,ZAF,2021.0,1,0,1
BLR,ESP,2012.0,2,0,2
TZA,POL,2016.0,1,0,1
VEN,SWE,2014.0,1,0,1
,SLB,2016.0,8,0,8
CAN,HTI,2021.0,2,0,2
IND,LBY,2014.0,3,0,3
HUN,TWN,2006.0,1,0,1
,MOZ,2019.0,36,0,36
CHN,TKM,2012.0,1,0,1
ARM,NLD,2017.0,1,0,1
GBR,MAC,2013.0,2,0,2
CUB,MOZ,2013.0,1,0,1
SLB,FJI,2013.0,1,0,1
UKR,CZE,2002.0,3,0,3
AUS,TUR,2003.0,1,0,1
ARM,GBR,2019.0,2,0,2
AUT,KWT,2016.0,1,0,1
PRT,IRN,2006.0,1,0,1
HUN,BWA,2014.0,1,0,1
ZWE,,2002.0,3,0,3
CAF,NCL,2001.0,1,0,1
SRB,PAN,2005.0,1,0,1
ESP,MLT,2012.0,1,0,1
PAK,OMN,2005.0,3,0,3
CAN,GMB,2003.0,1,0,1
COM,NGA,2004.0,1,0,1
HRV,CAN,2015.0,1,0,1
PYF,BEL,2020.0,1,0,1
MYS,FIN,2011.0,1,0,1
COG,BFA,2011.0,1,0,1
GHA,CHN,2011.0,2,0,2
IRN,SVN,2013.0,1,0,1
FIN,NPL,2020.0,1,0,1
IRQ,NGA,2015.0,1,0,1
POL,BRA,2016.0,7,0,7
MWI,TZA,2002.0,1,0,1
ISR,KEN,2016.0,1,0,1
BFA,LAO,2007.0,2,0,2
DEU,PHL,2004.0,1,0,1
MLI,GAB,2005.0,1,0,1
GRC,PHL,2018.0,1,0,1
ESP,LSO,2003.0,1,0,1
AUT,TTO,2008.0,1,0,1
NZL,HUN,2010.0,1,0,1
ERI,ETH,2007.0,1,0,1
JPN,TUR,1999.0,2,0,2
MEX,TWN,2006.0,3,0,3
ZAF,GRC,2019.0,2,0,2
BFA,GAB,2016.0,1,0,1
BWA,GHA,2015.0,1,0,1
,KHM,1996.0,1,0,1
AUT,ARE,2015.0,1,0,1
AUS,BWA,2010.0,2,0,2
MNE,HRV,2017.0,2,0,2
SLV,JPN,2013.0,1,0,1
GHA,FRA,2008.0,1,0,1
LBY,SAU,2013.0,1,0,1
KEN,LUX,2012.0,1,0,1
CHN,QAT,2017.0,1,0,1
CHE,TCD,2019.0,1,0,1
BWA,,2001.0,3,0,3
EGY,RWA,2022.0,2,0,2
NGA,NLD,1999.0,2,0,2
JPN,IRL,2000.0,2,0,2
NLD,CUW,2015.0,1,0,1
ISL,LUX,2016.0,1,0,1
,BLZ,2009.0,3,0,3
CZE,ARE,2018.0,1,0,1
JPN,IRQ,2009.0,1,0,1
,AFG,2002.0,2,0,2
MLT,ESP,2018.0,1,0,1
HRV,MNE,2018.0,3,0,3
BEN,CHE,2014.0,1,0,1
UGA,KOR,2017.0,1,0,1
DZA,IRL,2018.0,1,0,1
NCL,PYF,2021.0,1,0,1
IRL,ISL,2013.0,1,0,1
SOM,IND,2016.0,1,0,1
SLV,ESP,2009.0,1,0,1
LTU,POL,2020.0,2,0,2
BEN,NER,2017.0,1,0,1
CZE,MLT,2022.0,1,0,1
,GMB,2019.0,13,0,13
MKD,,2000.0,1,0,1
IDN,CAN,2001.0,1,0,1
GTM,GBR,1999.0,1,0,1
NGA,LBR,2012.0,1,0,1
SVK,PRT,1997.0,1,0,1
KEN,MLT,2009.0,1,0,1
PAN,SWE,2003.0,1,0,1
SWE,TWN,2008.0,2,0,2
ZWE,KNA,2006.0,1,0,1
NGA,EGY,2007.0,1,0,1
DNK,SVK,2012.0,1,0,1
IND,SRB,2002.0,1,0,1
CHE,CUB,2008.0,1,0,1
RUS,PAK,2010.0,1,0,1
KWT,KOR,2012.0,1,0,1
REU,,2017.0,1,0,1
PRT,DZA,2021.0,1,0,1
IRN,HKG,2015.0,6,0,6
RWA,CAN,2018.0,2,0,2
BRA,CYP,2013.0,1,0,1
LSO,,2011.0,1,0,1
ESP,BGR,2020.0,3,0,3
MDG,ZAF,2018.0,2,0,2
LSO,SYC,2021.0,1,0,1
ETH,RWA,2022.0,1,0,1
VEN,NOR,2011.0,1,0,1
RUS,ARE,2002.0,1,0,1
ITA,SYC,2021.0,1,0,1
KEN,IDN,2005.0,1,0,1
OMN,RUS,2011.0,1,0,1
SDN,ARE,2022.0,1,0,1
UGA,ETH,2014.0,2,0,2
ETH,NGA,2020.0,1,0,1
MKD,GRC,2012.0,1,0,1
AUS,TGO,2010.0,1,0,1
,HTI,1998.0,5,0,5
JPN,ARG,2008.0,1,0,1
MEX,UZB,2013.0,1,0,1
BGR,POL,2004.0,1,0,1
SGP,OMN,2001.0,1,0,1
GBR,VUT,2016.0,1,0,1
PAK,KGZ,2010.0,1,0,1
GAB,CAN,2016.0,1,0,1
USA,AZE,2009.0,1,0,1
PLW,GBR,2018.0,1,0,1
IRL,PHL,2012.0,1,0,1
HKG,EST,2019.0,1,0,1
TKM,CHN,2018.0,1,0,1
CIV,TGO,2009.0,1,0,1
JPN,MMR,2005.0,1,0,1
TUN,NLD,2012.0,1,0,1
PER,CHN,2018.0,1,0,1
URY,ZAF,2005.0,1,0,1
BHR,SWE,2015.0,1,0,1
TWN,LUX,2019.0,1,0,1
,BTN,2019.0,12,0,12
ETH,LBR,2019.0,1,0,1
CUB,FIN,2014.0,1,0,1
KAZ,BEL,2021.0,1,0,1
ISR,SAU,2012.0,1,0,1
HUN,LUX,2011.0,1,0,1
CZE,CHE,1999.0,3,0,3
UKR,CZE,2005.0,1,0,1
TUN,BGD,2007.0,1,0,1
DEU,SEN,2017.0,1,0,1
ARM,GBR,2010.0,3,0,3
NOR,LAO,2020.0,1,0,1
HRV,ARE,2016.0,1,0,1
DNK,ROU,2020.0,1,0,1
HKG,POL,2010.0,1,0,1
NOR,IRL,2014.0,1,0,1
CAN,MNE,2013.0,1,0,1
NOR,ISR,2015.0,1,0,1
BRA,KOR,2012.0,2,0,2
BHS,CAN,2019.0,1,0,1
ETH,FRA,2011.0,1,0,1
YEM,OMN,2005.0,1,0,1
EST,SGP,2016.0,1,0,1
NCL,CAN,2018.0,1,0,1
JPN,LVA,2007.0,1,0,1
PLW,,2003.0,1,0,1
CIV,GUF,2002.0,1,0,1
MYS,LAO,2008.0,1,0,1
SYC,GBR,2011.0,1,0,1
ARM,CHN,2019.0,1,0,1
HRV,SVK,2014.0,1,0,1
,TON,2004.0,1,0,1
NZL,NPL,2012.0,2,0,2
AUS,BTN,2009.0,1,0,1
RUS,KEN,2002.0,1,0,1
FRA,BDI,2016.0,2,0,2
BDI,,2009.0,2,0,2
BRB,TTO,2007.0,1,0,1
ITA,BFA,2009.0,1,0,1
FRA,LIE,2002.0,1,0,1
SVN,PRT,1999.0,1,0,1
CPV,,2014.0,1,0,1
IND,VNM,2007.0,1,0,1
EST,IRL,2005.0,1,0,1
,ATG,2007.0,1,0,1
FRA,PRY,2020.0,1,0,1
AGO,AUS,2014.0,1,0,1
MLT,USA,2005.0,1,0,1
ROU,TTO,2015.0,1,0,1
BEN,CHN,2014.0,1,0,1
NLD,NGA,2021.0,1,0,1
TKM,,2023.0,1,0,1
THA,HKG,2005.0,1,0,1
SRB,TUN,2021.0,1,0,1
GLP,MTQ,2016.0,1,0,1
NZL,POL,2009.0,1,0,1
MDA,FRA,2006.0,1,0,1
CHN,LBR,2020.0,1,0,1
COL,POL,2021.0,1,0,1
IRN,PSE,2022.0,2,0,2
DNK,GNB,2022.0,1,0,1
LSO,IND,2011.0,1,0,1
UKR,SGP,2010.0,1,0,1
SDN,POL,2012.0,2,0,2
ITA,IRQ,2014.0,1,0,1
UGA,JPN,2000.0,1,0,1
BLR,GBR,2020.0,1,0,1
VNM,LAO,2008.0,1,0,1
UKR,SGP,2019.0,1,0,1
DNK,ECU,2018.0,2,0,2
MEX,KAZ,2009.0,1,0,1
SAU,YEM,2004.0,1,0,1
JPN,MMR,2002.0,1,0,1
ZAF,MUS,2018.0,1,0,1
YEM,SAU,2006.0,1,0,1
ROU,GAB,2002.0,1,0,1
GEO,FRA,1999.0,1,0,1
CUB,DOM,2005.0,1,0,1
NER,DEU,2000.0,1,0,1
NOR,BLR,2017.0,1,0,1
MCO,SWE,2011.0,1,0,1
CHL,EGY,2008.0,1,0,1
LKA,NLD,2006.0,1,0,1
BWA,ZMB,2003.0,1,0,1
PRI,IND,2021.0,1,0,1
RWA,COG,2021.0,1,0,1
IRL,MDA,2009.0,1,0,1
MLI,IND,2021.0,1,0,1
SRB,HKG,2008.0,1,0,1
SRB,ROU,2017.0,1,0,1
FJI,KOR,2018.0,2,0,2
,BGR,2020.0,1,0,1
CMR,NLD,2003.0,1,0,1
RWA,ZWE,2018.0,1,0,1
CZE,EGY,2003.0,1,0,1
MWI,TZA,2005.0,1,0,1
UGA,IDN,2011.0,1,0,1
KOR,MAC,2003.0,1,0,1
REU,NCL,2013.0,1,0,1
GEO,UKR,2017.0,2,0,2
MYS,DZA,2016.0,1,0,1
BGD,UZB,2019.0,1,0,1
KOR,ARM,2008.0,1,0,1
ESP,NZL,2001.0,1,0,1
MDG,SDN,2005.0,1,0,1
MKD,TUR,2003.0,1,0,1
CAN,BRN,2008.0,1,0,1
ZWE,MYS,2007.0,2,0,2
SDN,MYS,2009.0,1,0,1
FIN,MDA,2008.0,1,0,1
IRL,QAT,2015.0,1,0,1
IND,KAZ,2013.0,1,0,1
CMR,GBR,2012.0,1,0,1
CHL,DOM,2014.0,1,0,1
GLP,ZAF,2000.0,1,0,1
NZL,ISL,2013.0,1,0,1
CHE,MKD,2018.0,1,0,1
NIC,ARG,2019.0,1,0,1
HKG,KHM,2015.0,1,0,1
PAN,PER,2016.0,1,0,1
HKG,MWI,2019.0,1,0,1
IDN,PRT,2018.0,1,0,1
PER,IND,2018.0,1,0,1
GBR,CRI,2019.0,1,0,1
NOR,PER,2016.0,1,0,1
PRT,CHL,2004.0,1,0,1
PSE,CAN,2013.0,1,0,1
TWN,BFA,2020.0,1,0,1
VEN,ARG,2022.0,1,0,1
PRT,BGR,2019.0,1,0,1
MNE,HRV,2019.0,1,0,1
SVK,THA,2022.0,1,0,1
USA,CHN,2011.0,1713,1966,-253
DEU,CHN,2016.0,317,325,-8
KOR,CHN,2014.0,142,59,83
NOR,FRA,2020.0,27,47,-20
USA,CAN,2007.0,1314,1250,64
USA,CZE,2017.0,47,62,-15
GBR,EST,2008.0,5,6,-1
USA,IND,2013.0,759,922,-163
USA,BIH,2006.0,7,4,3
GBR,CZE,2016.0,36,40,-4
EGY,SAU,2010.0,183,58,125
DEU,GBR,2008.0,579,328,251
GBR,ESP,2007.0,181,166,15
TWN,CHN,2009.0,63,44,19
GBR,IND,2016.0,158,165,-7
NLD,CHN,2008.0,26,27,-1
CAN,DEU,2011.0,147,165,-18
JPN,KOR,2001.0,85,67,18
POL,DEU,2006.0,54,60,-6
USA,BEL,2014.0,127,193,-66
ESP,MEX,2013.0,135,95,40
USA,ISR,2013.0,304,341,-37
DEU,NLD,2007.0,187,149,38
USA,CHL,2014.0,118,96,22
TUR,USA,2016.0,242,280,-38
NLD,CAN,2008.0,42,40,2
NLD,GBR,2020.0,296,293,3
TWN,DEU,2013.0,20,16,4
ESP,FRA,2010.0,158,235,-77
CHL,COL,2008.0,2,6,-4
AUT,GBR,2015.0,70,81,-11
AUT,POL,2003.0,7,2,5
ESP,BRA,2016.0,117,61,56
KOR,USA,2006.0,592,689,-97
FRA,CIV,2008.0,27,16,11
AUS,MYS,2021.0,38,45,-7
BRA,AUS,2014.0,41,16,25
ESP,GBR,2021.0,235,289,-54
CZE,FRA,2012.0,22,14,8
USA,POL,2013.0,232,117,115
BEL,NLD,2001.0,67,51,16
NZL,JPN,2003.0,12,10,2
EGY,SAU,2017.0,147,154,-7
SRB,IRL,2014.0,2,1,1
USA,UKR,2001.0,22,45,-23
EGY,SAU,2019.0,207,206,1
CHE,BEL,2011.0,27,48,-21
GBR,RUS,2018.0,44,40,4
CYP,TUR,2022.0,22,22,0
FRA,JPN,2005.0,80,68,12
FRA,VNM,2004.0,5,2,3
FIN,AUT,2018.0,9,8,1
KOR,AUS,2017.0,57,25,32
VEN,BRA,2015.0,6,1,5
ISR,DEU,2013.0,43,41,2
GBR,NGA,2016.0,52,29,23
SVN,AUT,2013.0,9,3,6
USA,FIN,2015.0,65,71,-6
SEN,FRA,2017.0,33,26,7
JPN,MNG,2019.0,18,10,8
NGA,ZAF,2019.0,82,65,17
SGP,PHL,2019.0,11,2,9
ITA,TUR,2012.0,12,7,5
IRL,CHN,2013.0,21,14,7
GBR,HKG,2016.0,52,53,-1
ESP,PER,2014.0,14,7,7
SAU,JOR,2019.0,37,20,17
JPN,FRA,2018.0,79,91,-12
NGA,CHN,2020.0,27,21,6
IND,GBR,2003.0,71,73,-2
SGP,NZL,2015.0,21,11,10
FIN,IRN,2018.0,1,15,-14
ZAF,DNK,2019.0,5,1,4
AUS,TWN,2019.0,11,16,-5
PRT,FRA,2012.0,25,38,-13
ESP,FRA,2019.0,244,238,6
NZL,AUS,2007.0,146,92,54
USA,TWN,2022.0,64,70,-6
IND,HKG,2021.0,17,6,11
KOR,VNM,2012.0,32,11,21
EGY,USA,2019.0,107,118,-11
USA,JPN,1999.0,434,537,-103
FRA,SWE,2016.0,80,54,26
GBR,SWE,2016.0,148,145,3
FRA,NOR,2016.0,40,9,31
ITA,POL,2009.0,16,11,5
EGY,ARE,2020.0,20,14,6
ISR,CHN,2009.0,12,8,4
NLD,RUS,2013.0,11,17,-6
CHE,GRC,2022.0,13,8,5
SDN,CHE,2013.0,1,2,-1
JPN,SGP,2015.0,44,29,15
KOR,AUS,2019.0,59,26,33
NLD,IRL,2016.0,9,14,-5
CAN,CHE,2014.0,91,73,18
AUS,SAU,2010.0,13,3,10
RWA,GBR,2015.0,2,2,0
MEX,BEL,2017.0,9,7,2
FRA,LTU,2017.0,2,7,-5
CUB,ESP,2016.0,16,16,0
HRV,SVN,2014.0,10,6,4
BEL,IRN,2016.0,12,25,-13
AUS,SAU,2017.0,62,17,45
KOR,FRA,2017.0,26,24,2
SWE,BGD,2014.0,3,4,-1
GBR,GHA,2018.0,17,14,3
DEU,SWE,2003.0,83,83,0
CHN,NZL,2015.0,12,19,-7
DEU,JPN,2020.0,104,113,-9
ITA,NOR,2017.0,24,12,12
USA,CRI,2017.0,14,16,-2
USA,MEX,2013.0,153,196,-43
FRA,PAK,2016.0,17,6,11
FRA,CMR,2015.0,18,10,8
MYS,PAK,2021.0,100,37,63
KAZ,CHN,2020.0,4,3,1
EGY,USA,2017.0,106,100,6
RUS,SWE,2006.0,20,18,2
EST,SVN,2020.0,1,1,0
USA,ISL,2014.0,10,8,2
SWE,CHE,2019.0,54,52,2
IRQ,GBR,2017.0,10,63,-53
IND,SAU,2021.0,72,48,24
CUB,COL,2019.0,5,3,2
GBR,CHL,2021.0,34,33,1
GBR,BHR,2019.0,3,1,2
POL,ESP,2018.0,23,23,0
IRN,KOR,2018.0,18,5,13
MYS,VNM,2017.0,6,3,3
PAK,HKG,2018.0,9,9,0
ZAF,ETH,2020.0,14,8,6
AUT,PRT,2019.0,4,4,0
SEN,FRA,2019.0,18,38,-20
SAU,NLD,2019.0,10,13,-3
PAK,CHE,2020.0,5,9,-4
CZE,THA,2020.0,2,1,1
CZE,GBR,2022.0,21,15,6
SVK,ITA,2018.0,3,5,-2
AUS,IRL,2020.0,43,35,8
DEU,AUT,2011.0,308,248,60
GBR,JOR,2005.0,7,4,3
CHN,TWN,2022.0,47,66,-19
AZE,IRN,2020.0,2,2,0
DNK,PRT,2020.0,9,7,2
AUS,SAU,2019.0,61,31,30
HUN,ROU,2020.0,12,11,1
GBR,EGY,2022.0,21,28,-7
JPN,CHE,2015.0,34,38,-4
GBR,ECU,2019.0,9,10,-1
BEL,JPN,2009.0,10,14,-4
USA,SRB,2003.0,11,14,-3
KWT,QAT,2018.0,3,2,1
ECU,ROU,2021.0,1,1,0
IND,YEM,2022.0,10,1,9
CAN,ITA,2012.0,31,59,-28
CUB,VEN,2004.0,4,1,3
ISR,IND,2018.0,42,116,-74
CAN,PAK,2021.0,12,23,-11
USA,CZE,2019.0,52,59,-7
ITA,NOR,2019.0,28,14,14
SWE,CHE,2017.0,50,42,8
JPN,CHN,1999.0,72,93,-21
UKR,RUS,2013.0,52,28,24
JPN,MNG,2010.0,8,2,6
LUX,GBR,2016.0,11,9,2
THA,USA,2006.0,70,159,-89
VEN,MEX,2017.0,14,5,9
HUN,CHE,2020.0,14,6,8
EGY,USA,2010.0,46,121,-75
GBR,HUN,2009.0,20,27,-7
AUS,CHE,2014.0,62,64,-2
BEL,ECU,2016.0,5,4,1
FRA,JPN,2002.0,69,61,8
KHM,VNM,2017.0,1,1,0
FRA,HUN,2011.0,11,19,-8
ZAF,BWA,2018.0,21,3,18
ZAF,DNK,2017.0,3,3,0
ESP,IRN,2017.0,2,17,-15
TUR,CHE,2006.0,6,6,0
FIN,FRA,2008.0,16,8,8
DEU,THA,2005.0,12,3,9
MYS,JOR,2009.0,9,6,3
GRC,NLD,2009.0,18,11,7
BEL,ESP,2006.0,23,11,12
ROU,FRA,2008.0,23,43,-20
USA,CRI,2010.0,9,18,-9
BGR,BEL,2006.0,8,3,5
NLD,IRN,2013.0,9,33,-24
KOR,DEU,2009.0,23,39,-16
CZE,NOR,2012.0,3,2,1
ARG,MEX,2009.0,8,9,-1
VNM,FRA,2013.0,13,20,-7
ITA,NLD,2013.0,98,61,37
AUT,NLD,2008.0,6,16,-10
HKG,CHE,2011.0,13,1,12
AUT,PRT,2010.0,6,2,4
JPN,HKG,2022.0,9,10,-1
MEX,ESP,2007.0,72,81,-9
CAN,SAU,2011.0,76,19,57
HUN,AUS,2010.0,5,3,2
SWE,CZE,2003.0,2,2,0
JPN,RUS,1999.0,16,31,-15
RUS,JPN,2010.0,10,20,-10
CHN,CAN,2000.0,45,12,33
GBR,IRL,1999.0,53,48,5
FRA,ARE,2021.0,14,5,9
PER,BRA,2014.0,11,14,-3
EST,ITA,2018.0,4,7,-3
NOR,SWE,2000.0,9,17,-8
AUS,SWE,1999.0,15,8,7
ISR,ITA,2001.0,7,12,-5
LVA,DNK,2003.0,1,1,0
CHE,JPN,2004.0,13,20,-7
PRT,IND,2015.0,14,19,-5
SVN,SVK,2008.0,7,2,5
AUS,CAN,2008.0,103,121,-18
GRC,AUT,2012.0,5,4,1
ZAF,ZWE,2016.0,14,16,-2
ZWE,ZAF,2020.0,38,29,9
PAK,KOR,2014.0,31,21,10
KOR,AUS,2010.0,34,22,12
DEU,GRC,2002.0,39,25,14
IRL,AUT,2012.0,7,6,1
MYS,TWN,2021.0,6,3,3
CYP,AUS,2018.0,2,1,1
NGA,AUS,2016.0,4,1,3
USA,CRI,2019.0,23,11,12
BRA,QAT,2018.0,1,1,0
FRA,GUY,2015.0,2,2,0
DEU,COL,2015.0,16,9,7
TWN,JPN,2022.0,11,22,-11
SGP,JPN,2014.0,27,31,-4
ITA,NZL,2021.0,10,3,7
JPN,POL,2016.0,18,12,6
ECU,CHL,2021.0,8,7,1
SAU,JOR,2017.0,29,27,2
IRN,ETH,2022.0,2,3,-1
GBR,NOR,2013.0,69,47,22
MAR,DZA,2018.0,6,5,1
MYS,HKG,2018.0,5,2,3
ARE,GBR,2021.0,27,47,-20
BEL,CAN,2005.0,29,14,15
BRA,NOR,2019.0,10,3,7
VEN,ARG,2016.0,5,1,4
RUS,AUS,2020.0,10,5,5
IRN,IRL,2022.0,10,1,9
RUS,UZB,2019.0,7,4,3
ESP,DZA,2019.0,8,3,5
CZE,GRC,2018.0,1,7,-6
ITA,LBN,2021.0,1,3,-2
GBR,TTO,2006.0,2,1,1
ITA,IRL,2022.0,13,11,2
BRA,PRT,2022.0,75,53,22
AUS,THA,2008.0,29,16,13
POL,UKR,2018.0,17,32,-15
CAN,OMN,2012.0,10,5,5
USA,RWA,2017.0,9,12,-3
CHN,IRL,2005.0,6,3,3
DEU,CZE,2006.0,25,22,3
MOZ,ZAF,2014.0,1,2,-1
USA,ROU,2014.0,13,18,-5
DEU,SVK,2010.0,12,7,5
FRA,RUS,2016.0,32,33,-1
ESP,ISR,2015.0,14,4,10
SEN,FRA,2010.0,19,18,1
MEX,GTM,2012.0,7,1,6
IRL,ISR,2014.0,2,3,-1
MEX,BEL,2010.0,4,4,0
USA,VNM,2012.0,18,9,9
USA,PAK,2005.0,31,27,4
LVA,SWE,2006.0,2,5,-3
CYP,GRC,2014.0,11,31,-20
FRA,CHL,2003.0,13,10,3
DEU,MEX,2004.0,14,9,5
ESP,DZA,2017.0,4,5,-1
BEL,AUT,2004.0,6,5,1
MEX,CUB,2007.0,9,19,-10
IND,ETH,2012.0,19,6,13
GNB,DNK,2009.0,5,2,3
MYS,GBR,2007.0,28,80,-52
POL,SVK,2001.0,2,2,0
GBR,PRT,1998.0,13,4,9
BEL,CAN,2002.0,32,21,11
DEU,HRV,2006.0,7,6,1
TUR,DEU,2012.0,36,29,7
PAK,ARE,2005.0,4,3,1
TUR,SVN,2014.0,1,1,0
USA,CIV,2017.0,2,3,-1
SWE,RUS,2015.0,12,22,-10
CAN,CUB,2008.0,2,5,-3
HUN,USA,2000.0,36,10,26
CAN,HKG,1999.0,6,9,-3
CHN,POL,2003.0,3,2,1
ROU,RUS,2000.0,1,2,-1
ARG,AUS,2007.0,8,5,3
AUS,NZL,1999.0,21,33,-12
USA,PAK,2002.0,19,24,-5
ARG,DEU,2008.0,15,40,-25
PRT,CHE,2006.0,7,7,0
USA,COG,2019.0,4,5,-1
POL,GRC,2005.0,4,2,2
CHE,IND,2005.0,12,12,0
CHE,THA,2013.0,4,5,-1
USA,NGA,2000.0,4,2,2
ESP,CHL,1999.0,12,11,1
GBR,BHR,2017.0,9,3,6
FIN,BEL,2008.0,3,2,1
GBR,ZAF,2009.0,57,67,-10
RUS,SVK,2020.0,6,3,3
OMN,SAU,2013.0,3,3,0
JPN,ITA,2008.0,10,23,-13
SWE,VNM,2003.0,2,1,1
TZA,USA,2011.0,11,2,9
RUS,POL,2006.0,14,3,11
CHL,ITA,2007.0,7,2,5
DEU,PSE,2013.0,4,4,0
IND,MEX,2006.0,5,2,3
RUS,UZB,2017.0,6,5,1
ISR,FRA,2006.0,14,22,-8
GBR,ISL,2008.0,11,6,5
HUN,FRA,2008.0,13,9,4
ESP,VEN,2001.0,6,5,1
GBR,COL,2012.0,10,15,-5
NGA,USA,2000.0,2,4,-2
RUS,JPN,2019.0,11,7,4
POL,FRA,2000.0,12,13,-1
KWT,JOR,2017.0,3,6,-3
MDA,RUS,2019.0,6,2,4
ECU,ITA,2017.0,3,7,-4
ZAF,BEL,2001.0,5,6,-1
BRA,MEX,2003.0,7,5,2
GLP,FRA,2007.0,15,10,5
ESP,IND,2011.0,7,9,-2
CAN,KOR,1998.0,5,1,4
AUS,JPN,2004.0,22,43,-21
FRA,BFA,2002.0,11,6,5
NZL,CAN,2001.0,25,14,11
DEU,SGP,2002.0,9,9,0
JPN,NPL,2009.0,7,4,3
LKA,USA,2007.0,11,3,8
CHE,IND,2002.0,6,11,-5
GBR,GMB,2013.0,6,7,-1
LTU,USA,2001.0,5,3,2
QAT,USA,2008.0,3,19,-16
SWE,BRA,2008.0,7,11,-4
TUR,AZE,2009.0,5,8,-3
ITA,DNK,2000.0,4,6,-2
FRA,HKG,2001.0,4,1,3
KOR,FRA,2010.0,26,18,8
ESP,ARG,2006.0,46,83,-37
SGP,HKG,2002.0,8,21,-13
HKG,CAN,2000.0,7,5,2
SGP,PHL,2010.0,5,1,4
FIN,CAN,2016.0,14,14,0
GBR,KHM,2018.0,2,2,0
FRA,REU,2014.0,5,17,-12
AUS,BEL,2003.0,14,10,4
MCO,FRA,2022.0,1,5,-4
IRL,ESP,2009.0,13,12,1
PER,GHA,2018.0,2,1,1
IRL,SWE,2018.0,10,12,-2
MLI,USA,2001.0,6,4,2
CHE,CHN,2007.0,11,30,-19
CZE,HUN,2008.0,2,1,1
IND,RUS,2004.0,4,1,3
KEN,NGA,2016.0,2,3,-1
FRA,LBN,2003.0,24,11,13
IRN,ESP,2016.0,16,6,10
AUS,KWT,2009.0,2,1,1
USA,TZA,1998.0,5,1,4
CAN,SGP,2014.0,15,31,-16
SRB,ITA,2010.0,2,2,0
RUS,ISR,2005.0,13,10,3
AUT,EGY,2013.0,4,2,2
THA,CHN,2014.0,7,8,-1
AUT,CAN,2011.0,17,22,-5
EGY,CHE,2008.0,1,4,-3
ARE,PAK,2018.0,6,5,1
BWA,USA,2012.0,11,8,3
SAU,SGP,2019.0,4,6,-2
KOR,CHE,2015.0,9,5,4
ROU,MDA,2015.0,5,1,4
ITA,COL,2019.0,9,4,5
SAU,IND,2013.0,19,100,-81
NZL,SAU,2017.0,4,7,-3
OMN,USA,2020.0,7,6,1
ZAF,CAN,2013.0,22,13,9
AUS,PHL,2015.0,10,10,0
SGP,HKG,2005.0,12,14,-2
SAU,SWE,2016.0,2,6,-4
CAN,BFA,2018.0,3,3,0
MDA,ROU,2016.0,3,7,-4
SAU,TUR,2012.0,5,7,-2
IND,BGD,2013.0,9,8,1
TUN,BEL,2015.0,3,4,-1
MYS,THA,2012.0,3,5,-2
POL,SGP,2011.0,1,2,-1
SVK,AUT,2015.0,10,4,6
GHA,JPN,2017.0,8,6,2
RUS,IND,2015.0,1,6,-5
RUS,JPN,2017.0,14,8,6
LBN,QAT,2015.0,2,2,0
SWE,GRC,2020.0,12,31,-19
BEL,CHN,2004.0,11,7,4
DNK,ITA,2020.0,34,57,-23
NZL,SWE,2015.0,11,9,2
SAU,NLD,2017.0,4,7,-3
BEN,FRA,2020.0,4,10,-6
BHR,IRL,2018.0,5,4,1
ITA,LTU,2022.0,1,1,0
GHA,JPN,2019.0,5,4,1
IND,EGY,2021.0,7,2,5
ECU,GBR,2022.0,2,7,-5
DEU,JOR,2008.0,13,4,9
CAN,FRA,1999.0,50,65,-15
AUT,HRV,2002.0,5,1,4
FIN,NOR,2012.0,15,6,9
RUS,ISR,2002.0,14,8,6
GBR,SVN,2019.0,9,9,0
VEN,FRA,2000.0,2,1,1
DNK,GBR,2000.0,14,21,-7
USA,BRB,2016.0,3,6,-3
GBR,ARG,2007.0,12,6,6
KWT,CAN,2006.0,4,8,-4
BEL,MEX,2013.0,5,7,-2
GBR,ECU,2017.0,6,4,2
USA,CZE,2010.0,30,35,-5
BEL,CZE,2017.0,6,7,-1
VNM,USA,2003.0,2,7,-5
AUT,GRC,2015.0,5,10,-5
USA,DOM,2016.0,2,5,-3
TWN,NZL,2008.0,1,3,-2
DEU,THA,2002.0,7,3,4
PAK,USA,2000.0,6,4,2
BWA,AUS,2017.0,1,2,-1
USA,PHL,2008.0,31,23,8
SWE,SRB,2019.0,1,4,-3
DNK,BGD,2016.0,1,2,-1
URY,ARG,2016.0,8,3,5
BGR,ITA,2014.0,2,3,-1
BFA,USA,2013.0,6,2,4
CZE,DNK,2019.0,6,2,4
TWN,SWE,2015.0,6,5,1
ITA,COL,2017.0,9,3,6
MAC,USA,2016.0,8,8,0
ISL,USA,2020.0,9,8,1
LBN,ARE,2017.0,4,4,0
ISR,PSE,2009.0,7,3,4
AUT,SWE,2007.0,7,6,1
CYP,PAK,2021.0,3,1,2
ZMB,TZA,2020.0,1,1,0
CZE,POL,2015.0,8,22,-14
RUS,BEL,2020.0,14,4,10
KEN,AUT,2021.0,1,1,0
GHA,ZAF,2018.0,20,18,2
IRL,PRT,2006.0,2,2,0
LKA,CAN,2008.0,1,2,-1
PRT,NOR,2014.0,13,2,11
NPL,KOR,2015.0,6,8,-2
USA,PSE,2002.0,2,3,-1
POL,LVA,2011.0,2,1,1
FRA,NGA,2009.0,2,1,1
GBR,PRT,1997.0,7,4,3
UKR,CAN,2003.0,7,3,4
CHL,BGR,2005.0,1,1,0
POL,AUS,1998.0,2,2,0
HKG,JPN,2008.0,6,12,-6
USA,ZMB,2006.0,7,2,5
BRA,NOR,2010.0,6,2,4
AUS,ISR,2014.0,12,17,-5
NER,MDG,2005.0,2,1,1
FRA,BFA,2005.0,6,5,1
DEU,SVK,2017.0,14,6,8
ITA,NOR,2010.0,17,5,12
GHA,MYS,2019.0,2,3,-1
MKD,DEU,2002.0,3,2,1
KWT,USA,2003.0,7,13,-6
USA,MCO,2003.0,1,1,0
HRV,ITA,2007.0,1,3,-2
AUS,CMR,2013.0,1,1,0
ITA,BGR,2010.0,3,4,-1
USA,COG,2017.0,4,8,-4
ETH,ZAF,2005.0,3,3,0
TWN,KOR,2013.0,15,8,7
IND,PHL,2008.0,4,4,0
CHE,BRA,2008.0,7,10,-3
NLD,TUN,2022.0,2,2,0
HKG,PAK,2011.0,2,1,1
ITA,BGD,2013.0,4,3,1
CHE,MKD,2017.0,1,2,-1
DEU,ROU,2014.0,12,26,-14
NGA,CHE,2022.0,4,4,0
RUS,PRT,2008.0,6,2,4
ITA,ROU,2003.0,4,6,-2
CHE,PHL,2007.0,3,3,0
TUR,GRC,2007.0,2,2,0
COL,ECU,2016.0,7,2,5
SWE,NZL,2021.0,5,8,-3
FRA,BOL,2004.0,3,1,2
HRV,SWE,2020.0,3,1,2
DEU,SGP,2005.0,14,8,6
AUT,SAU,2016.0,3,1,2
LBY,DEU,2017.0,1,1,0
KNA,GBR,2017.0,2,2,0
TUN,PRT,2018.0,3,2,1
BRA,JPN,2014.0,7,20,-13
BEL,TWN,2016.0,2,2,0
FRA,ETH,2017.0,3,1,2
HUN,RUS,2008.0,2,1,1
GBR,ETH,2020.0,4,7,-3
AUS,TWN,2017.0,8,23,-15
BEL,EGY,2014.0,5,2,3
BEL,CZE,2019.0,7,8,-1
ROU,IRN,2021.0,1,4,-3
DNK,VNM,2012.0,4,1,3
CHN,CUB,2016.0,4,2,2
CHE,AUT,1997.0,13,7,6
MOZ,FRA,2008.0,1,1,0
RUS,ARG,2021.0,1,1,0
HUN,BEL,2010.0,3,3,0
BEL,DNK,1997.0,1,1,0
VEN,COL,2008.0,5,2,3
AUS,BRA,2006.0,14,10,4
UZB,USA,2015.0,1,2,-1
USA,KWT,2011.0,10,2,8
SAU,JPN,2014.0,3,18,-15
AUS,MEX,2012.0,11,14,-3
ITA,BGR,2017.0,4,1,3
GBR,LUX,2011.0,10,2,8
COL,DEU,2012.0,9,13,-4
LBN,ARE,2010.0,4,1,3
NOR,IND,2007.0,3,3,0
GBR,SVN,2017.0,7,14,-7
DEU,SVK,2019.0,5,7,-2
GRC,CHE,2021.0,22,12,10
BRA,CHE,2003.0,10,10,0
BLR,DEU,2000.0,9,4,5
MUS,GBR,2014.0,1,2,-1
DNK,ZAF,2002.0,1,1,0
DEU,MAR,2012.0,2,2,0
NLD,ETH,2012.0,6,1,5
NLD,LBN,2014.0,1,2,-1
AUS,IRQ,2015.0,6,4,2
PHL,NLD,2014.0,4,1,3
ETH,NLD,2020.0,4,9,-5
LSO,USA,2019.0,1,1,0
SGP,IRN,2022.0,3,2,1
IRL,CHE,2021.0,4,10,-6
UKR,PRT,2010.0,1,2,-1
CZE,MEX,2002.0,1,3,-2
CHN,IDN,2021.0,5,6,-1
HUN,BEL,2019.0,6,6,0
IRQ,GBR,2019.0,18,153,-135
ITA,BGR,2019.0,6,3,3
CHE,COL,2007.0,1,2,-1
PRI,ESP,2002.0,2,2,0
RUS,MEX,2007.0,3,4,-1
IRN,CHN,2009.0,4,2,2
DEU,DZA,2008.0,2,1,1
ZAF,IRN,2016.0,3,6,-3
SGP,LKA,2005.0,1,2,-1
CHN,IND,2006.0,8,11,-3
AUT,CHN,2001.0,4,11,-7
ECU,VEN,2015.0,1,18,-17
FIN,LTU,2005.0,3,1,2
NZL,FIN,2011.0,2,1,1
GBR,JOR,2002.0,3,2,1
JPN,BGR,2004.0,3,4,-1
URY,USA,2003.0,7,9,-2
USA,TUN,2009.0,1,3,-2
CAN,GRC,2016.0,4,14,-10
UGA,USA,2001.0,2,7,-5
ARG,CUB,2002.0,1,2,-1
SAU,JOR,2010.0,5,37,-32
ARG,SWE,2000.0,3,1,2
GBR,SVN,2010.0,4,4,0
IDN,FRA,2015.0,3,6,-3
FIN,CZE,2009.0,2,1,1
ETH,AUT,2001.0,1,1,0
POL,ITA,1997.0,1,2,-1
FRA,PRT,1997.0,1,6,-5
NGA,DEU,2009.0,3,7,-4
RUS,BRA,2009.0,3,3,0
LKA,SWE,2009.0,1,1,0
CAN,KEN,2007.0,5,1,4
TWN,ITA,2011.0,2,2,0
ITA,KOR,2000.0,2,2,0
MDA,RUS,2010.0,2,2,0
MEX,CHL,2006.0,5,2,3
TWN,THA,2015.0,4,1,3
ZAF,DEU,2008.0,11,19,-8
UKR,TWN,2015.0,1,1,0
NLD,GHA,2006.0,1,2,-1
BGR,POL,2014.0,1,6,-5
TZA,ITA,2010.0,2,1,1
CHN,EGY,2006.0,3,1,2
THA,DNK,2011.0,4,1,3
GHA,USA,2011.0,10,15,-5
ARG,PRT,2020.0,3,1,2
JPN,MEX,2021.0,2,3,-1
POL,AUS,1997.0,1,1,0
SWE,SRB,2017.0,5,1,4
DNK,GRC,2014.0,4,15,-11
THA,IND,2006.0,3,7,-4
TTO,USA,2014.0,4,3,1
IRN,NOR,2022.0,5,3,2
POL,ISR,2014.0,9,3,6
CHN,IRL,2002.0,3,2,1
THA,AUT,2015.0,2,7,-5
AUS,CHL,2021.0,3,24,-21
POL,FIN,2022.0,2,3,-1
CHN,QAT,2018.0,2,4,-2
SEN,KEN,2016.0,2,1,1
PRT,CZE,2010.0,3,1,2
PHL,SGP,2020.0,2,1,1
KGZ,RUS,2021.0,1,2,-1
IRL,HUN,2016.0,2,1,1
PHL,MYS,2021.0,1,3,-2
JOR,SAU,2004.0,2,4,-2
CUB,FRA,2004.0,1,3,-2
CAN,KOR,1997.0,3,1,2
NLD,KOR,2008.0,2,4,-2
ROU,CHE,2018.0,5,3,2
NPL,DEU,2014.0,6,3,3
ESP,TUN,2022.0,1,2,-1
USA,CIV,2019.0,4,2,2
FRA,GHA,2016.0,2,1,1
USA,SAU,1999.0,10,12,-2
CHE,LBN,2008.0,1,1,0
USA,WSM,2018.0,2,1,1
PNG,GBR,2012.0,1,1,0
SGP,MYS,1999.0,1,1,0
BGD,NLD,2015.0,2,2,0
BEL,RUS,2004.0,3,8,-5
HUN,AUS,2017.0,3,1,2
BEL,SVN,2007.0,1,1,0
LBN,ARE,2019.0,3,2,1
AUS,NOR,2022.0,11,5,6
ARE,GRC,2018.0,1,8,-7
GUM,USA,2020.0,3,5,-2
LAO,GBR,2015.0,2,1,1
CZE,DNK,2017.0,4,5,-1
NLD,ISR,2007.0,3,7,-4
CHE,PRT,2016.0,10,18,-8
NLD,ARG,2009.0,2,6,-4
HKG,NOR,2013.0,1,1,0
KOR,ARE,2015.0,5,2,3
BEL,MYS,2015.0,2,3,-1
MYS,NPL,2020.0,1,2,-1
SVN,AUS,2015.0,2,1,1
MEX,BEL,2019.0,3,7,-4
EST,NOR,2015.0,3,1,2
ISR,JPN,2020.0,6,4,2
MDA,CZE,2020.0,1,1,0
FRA,LAO,2014.0,2,2,0
TLS,AUS,2019.0,2,1,1
LBN,SDN,2019.0,1,1,0
CIV,BEN,2020.0,1,1,0
MEX,FIN,2022.0,4,2,2
GHA,NGA,2020.0,3,5,-2
AUS,OMN,2006.0,1,4,-3
ROU,DNK,2009.0,1,3,-2
BEL,NZL,2015.0,4,2,2
EGY,PAK,2022.0,7,1,6
GHA,JPN,2010.0,3,2,1
ISR,AUT,2014.0,2,5,-3
GBR,LAO,2016.0,2,1,1
DNK,NZL,2014.0,3,9,-6
EST,SWE,2001.0,2,2,0
CHL,PER,2003.0,2,3,-1
HRV,CZE,2015.0,3,1,2
CHL,JPN,2012.0,3,5,-2
MEX,ROU,2002.0,1,1,0
MAR,GBR,2013.0,1,2,-1
SWE,SVN,2015.0,2,7,-5
CAN,UKR,2010.0,3,6,-3
CAN,UKR,2017.0,2,5,-3
IRL,POL,2007.0,2,2,0
IRL,TWN,2021.0,1,1,0
ITA,TWN,2018.0,2,4,-2
CZE,ITA,2011.0,6,4,2
UKR,ESP,2015.0,5,4,1
USA,RWA,2010.0,3,4,-1
POL,BRA,2022.0,1,11,-10
TKM,CHN,2017.0,1,2,-1
ITA,COL,2010.0,4,6,-2
POL,DNK,1999.0,4,1,3
CMR,USA,2009.0,4,2,2
POL,ITA,1998.0,3,8,-5
RUS,UZB,2010.0,2,3,-1
FRA,ZAF,1998.0,3,2,1
FRA,URY,2006.0,2,3,-1
BEN,TUN,2013.0,1,2,-1
ARG,FRA,1998.0,5,6,-1
SWE,TWN,2013.0,3,2,1
SVN,DEU,2004.0,6,1,5
USA,LKA,2003.0,4,7,-3
ARE,JOR,2003.0,3,3,0
ARG,DNK,2004.0,1,1,0
IRQ,EGY,2011.0,1,1,0
NZL,BEL,2011.0,1,4,-3
RUS,HKG,2003.0,4,2,2
ITA,FIN,1997.0,2,5,-3
MAR,ESP,1999.0,2,1,1
FRA,KEN,2003.0,1,3,-2
ARG,COL,2000.0,2,12,-10
USA,PSE,2005.0,4,3,1
GBR,CUB,2016.0,1,2,-1
JOR,CAN,2008.0,4,9,-5
PRT,JPN,2016.0,4,4,0
TUR,BIH,2015.0,2,1,1
KNA,ZAF,2017.0,1,2,-1
CRI,ESP,2022.0,3,5,-2
SVK,GBR,2020.0,4,4,0
LTU,NLD,2022.0,1,1,0
CYP,ESP,2021.0,1,1,0
ZWE,NLD,2012.0,1,1,0
USA,BEN,2002.0,3,1,2
DZA,ESP,2009.0,3,3,0
OMN,TUN,2011.0,2,1,1
DNK,DZA,2019.0,1,1,0
ISR,IRL,2004.0,1,1,0
ISR,ARG,2015.0,1,1,0
GBR,BOL,2002.0,1,1,0
SRB,FRA,2008.0,2,4,-2
GRC,DZA,2010.0,1,1,0
NLD,VEN,2015.0,1,2,-1
NOR,BLR,2018.0,2,2,0
SGP,ITA,2006.0,2,1,1
NZL,MDV,2018.0,1,1,0
VEN,CRI,2008.0,1,1,0
DNK,BGR,2007.0,1,2,-1
ARG,RUS,2006.0,1,1,0
UGA,NLD,2018.0,3,3,0
DEU,PHL,2014.0,4,3,1
ESP,UKR,2018.0,3,4,-1
DOM,ESP,2016.0,1,7,-6
KAZ,TUR,2007.0,1,1,0
CHE,GHA,2018.0,3,3,0
SGP,PHL,2017.0,3,4,-1
EGY,LBY,2014.0,2,2,0
IRQ,SAU,2016.0,2,1,1
CYP,GHA,2021.0,1,1,0
MYS,NLD,2008.0,1,3,-2
GBR,GRD,2014.0,1,2,-1
VEN,CHL,2004.0,3,3,0
ARE,TUR,2012.0,1,2,-1
EGY,OMN,2004.0,2,2,0
CZE,EGY,2001.0,1,1,0
LBN,ITA,2013.0,2,2,0
JPN,ARG,2013.0,3,1,2
BEN,BEL,2012.0,2,3,-1
CZE,ARE,2019.0,1,1,0
BEL,PHL,2012.0,3,2,1
USA,BGR,2022.0,1,2,-1
PAK,SDN,2014.0,1,1,0
CHE,PAK,2022.0,1,4,-3
RWA,CAN,2019.0,3,1,2
CAN,ETH,2016.0,2,1,1
DZA,TUR,2020.0,1,1,0
COL,CHL,2003.0,3,2,1
CRI,FRA,2017.0,1,4,-3
ESP,CZE,2006.0,3,2,1
IRN,ITA,2005.0,1,2,-1
NPL,NZL,2017.0,1,3,-2
ISR,SWE,2022.0,2,2,0
BHR,SAU,2004.0,1,1,0
CHE,SVN,2004.0,1,2,-1
PRT,AUT,2006.0,2,1,1
BRA,URY,2005.0,1,3,-2
CUB,CAN,2011.0,3,1,2
BEL,HKG,1999.0,1,1,0
NZL,KOR,2013.0,3,3,0
MDA,FIN,2006.0,2,1,1
NGA,BEN,2014.0,1,2,-1
ISR,ARE,2018.0,1,1,0
USA,GMB,2009.0,2,1,1
NOR,EST,2018.0,2,2,0
CHL,NZL,2016.0,1,7,-6
POL,CYP,2020.0,1,2,-1
ZAF,SGP,2015.0,1,1,0
SAU,NLD,2010.0,1,2,-1
FIN,HUN,2012.0,6,4,2
ZAF,GRC,2018.0,1,3,-2
CHN,SVN,2020.0,1,1,0
POL,CHN,2012.0,2,18,-16
PER,AUS,2017.0,1,2,-1
NPL,NZL,2019.0,1,2,-1
VNM,CHE,2016.0,2,4,-2
USA,DZA,2022.0,1,2,-1
LUX,USA,2005.0,1,1,0
NOR,MYS,2010.0,1,3,-2
FJI,IND,2015.0,1,2,-1
PER,ECU,2008.0,2,1,1
CZE,TUR,2008.0,2,1,1
ZAF,AUS,1997.0,1,3,-2
BEL,DNK,1998.0,1,1,0
USA,MKD,1999.0,1,1,0
EST,RUS,2005.0,1,1,0
FIN,ROU,2007.0,1,1,0
UGA,DEU,2008.0,1,4,-3
DEU,OMN,2021.0,1,1,0
NOR,MYS,2017.0,2,1,1
THA,MEX,2019.0,1,1,0
GEO,UKR,2018.0,1,1,0
OMN,MYS,2008.0,1,2,-1
SVK,NLD,2015.0,1,1,0
IRQ,ARE,2015.0,1,1,0
ESP,BOL,2020.0,1,2,-1
VNM,CZE,2022.0,2,2,0
EGY,ESP,2022.0,2,6,-4
POL,VNM,2012.0,2,6,-4
SAU,BGR,2017.0,1,1,0
IRN,IND,2000.0,1,1,0
VNM,RUS,2007.0,2,3,-1
DZA,DEU,2009.0,1,1,0
BRA,ROU,2009.0,1,1,0
DEU,NPL,2009.0,1,2,-1
KEN,CMR,2015.0,2,1,1
UGA,NOR,2015.0,3,6,-3
ISR,NOR,2012.0,1,1,0
PER,AUS,2019.0,1,1,0
PRI,ESP,2005.0,2,3,-1
FRA,LTU,2010.0,1,4,-3
BGR,FIN,2006.0,1,1,0
TJK,RUS,2005.0,1,1,0
BRA,PER,2004.0,5,4,1
BOL,GBR,2002.0,1,1,0
EGY,GBR,1999.0,1,2,-1
AUS,HUN,2000.0,2,1,1
UGA,AUS,2009.0,1,1,0
PSE,ESP,2006.0,1,1,0
LTU,CHE,2005.0,1,2,-1
GBR,BHR,2010.0,1,1,0
SEN,MLI,2013.0,2,1,1
TUR,FRA,2003.0,3,9,-6
FIN,JPN,1999.0,1,3,-2
VNM,CAN,2011.0,1,2,-1
POL,JPN,2003.0,3,10,-7
SRB,ARE,2018.0,1,1,0
SYR,IND,2019.0,2,1,1
GRC,JPN,2013.0,2,2,0
KWT,SAU,2004.0,1,4,-3
THA,MEX,2017.0,1,1,0
PRT,CZE,2019.0,2,1,1
BEN,CAN,2021.0,1,3,-2
SWE,ZWE,2009.0,1,1,0
GEO,GBR,2001.0,1,1,0
ISL,CHE,2009.0,1,1,0
GBR,FLK,2021.0,1,1,0
IRQ,FRA,2018.0,1,15,-14
TWN,PHL,2011.0,1,4,-3
IRQ,DEU,2022.0,1,2,-1
BEL,FIN,2009.0,2,4,-2
ITA,CUB,2018.0,1,2,-1
URY,DEU,2022.0,1,1,0
FRA,LTU,2019.0,2,2,0
DEU,COG,2021.0,1,2,-1
NLD,VNM,2022.0,2,2,0
SGP,FIN,2020.0,2,4,-2
CHE,AFG,2020.0,1,4,-3
BEL,UKR,2022.0,1,1,0
SWE,BEL,2000.0,1,2,-1
MNG,KOR,2013.0,1,4,-3
BWA,ZWE,2013.0,1,1,0
BGR,CHN,2010.0,1,1,0
CHE,EST,2015.0,1,3,-2
CZE,VNM,2017.0,1,2,-1
BGR,CHN,2017.0,1,1,0
IDN,BRA,2018.0,1,1,0
PAK,RUS,2020.0,1,2,-1
BWA,KEN,2015.0,1,1,0
MWI,AUS,2015.0,1,1,0
SYR,IND,2017.0,1,1,0
DNK,KEN,2011.0,1,1,0
SYR,FRA,2003.0,1,3,-2
COL,BEL,2003.0,1,2,-1
USA,LVA,2004.0,2,1,1
MRT,SEN,2002.0,1,1,0
BOL,BEL,2006.0,1,1,0
LTU,GBR,2001.0,1,1,0
CAN,HUN,2011.0,2,4,-2
IND,BHR,2014.0,1,1,0
IRN,DNK,2006.0,1,1,0
ITA,ECU,2012.0,1,1,0
CHL,VEN,2003.0,1,1,0
IDN,NOR,2015.0,2,4,-2
CHE,LIE,2008.0,1,1,0
POL,IRL,2021.0,2,1,1
LBR,USA,2015.0,1,5,-4
MDG,CHE,2019.0,1,2,-1
TWN,NGA,2018.0,1,1,0
IRL,SDN,2012.0,1,1,0
BGR,KOR,2006.0,1,1,0
TZA,NLD,2012.0,1,1,0
CHL,CHN,2002.0,1,2,-1
USA,ERI,2019.0,1,2,-1
AUS,MLT,2008.0,1,1,0
SRB,HRV,2008.0,1,8,-7
ISL,UGA,2020.0,1,1,0
ISR,CZE,1999.0,1,2,-1
TZA,ITA,2019.0,1,1,0
GHA,MYS,2017.0,1,1,0
NOR,LUX,2019.0,1,1,0
TLS,AUS,2017.0,1,1,0
MMR,IDN,2018.0,1,1,0
CAN,USA,2008.0,1402,1344,58
AUS,TWN,2010.0,20,9,11
ESP,FRA,2017.0,290,216,74
RUS,KOR,2020.0,14,5,9
JOR,AUS,2014.0,3,7,-4
CHN,BEL,2021.0,57,57,0
ITA,BEL,2016.0,90,54,36
NOR,DNK,2021.0,35,45,-10
JPN,VNM,2016.0,59,18,41
AUS,PNG,2016.0,6,9,-3
DEU,ETH,2021.0,6,2,4
NGA,ZAF,2017.0,77,53,24
TUN,FRA,2018.0,88,80,8
NZL,SAU,2019.0,3,6,-3
USA,RWA,2019.0,11,9,2
ITA,IND,2021.0,18,38,-20
VNM,ITA,2021.0,2,1,1
DNK,ISL,2008.0,4,2,2
VEN,MEX,2010.0,11,3,8
KOR,FRA,2019.0,24,44,-20
EGY,JPN,2011.0,10,52,-42
MYS,IDN,2020.0,62,24,38
DEU,GRC,2005.0,31,19,12
AUS,NLD,2013.0,44,79,-35
USA,PRT,2012.0,57,48,9
BGD,CAN,2011.0,13,2,11
CHE,HUN,2015.0,9,19,-10
SWE,AUT,2006.0,7,6,1
FRA,ETH,2019.0,4,2,2
EGY,PSE,2013.0,3,7,-4
UZB,RUS,2021.0,4,4,0
PRT,CZE,2017.0,4,2,2
IDN,PHL,2020.0,2,2,0
NGA,ZAF,2010.0,26,11,15
VEN,SWE,2004.0,1,1,0
HRV,USA,2015.0,20,10,10
NLD,FIN,2008.0,17,14,3
CHE,LAO,2013.0,2,1,1
ITA,AUS,2003.0,20,14,6
ROU,CAN,2001.0,7,2,5
IRN,DEU,2003.0,5,4,1
ISR,ESP,2003.0,4,3,1
SRB,ITA,2017.0,5,4,1
IRL,USA,2000.0,22,12,10
IND,NLD,2003.0,8,10,-2
IND,TTO,2014.0,4,4,0
IRL,CAN,2009.0,20,30,-10
CHE,ZAF,2007.0,3,9,-6
DEU,CMR,2015.0,6,4,2
USA,UGA,2003.0,8,8,0
SWE,CHE,2010.0,30,41,-11
ARE,SAU,2008.0,1,7,-6
AUT,HRV,2005.0,4,4,0
POL,BEL,2017.0,11,11,0
ZWE,USA,2015.0,17,2,15
MKD,CHE,2017.0,2,1,1
RUS,TUN,2019.0,2,2,0
AUT,PRT,2017.0,2,12,-10
ITA,PRT,1999.0,8,1,7
FRA,ARG,2003.0,15,18,-3
FJI,AUS,2015.0,12,8,4
ZAF,ITA,2013.0,5,9,-4
THA,GBR,2021.0,23,44,-21
LUX,IND,2022.0,3,1,2
ITA,FIN,1998.0,3,1,2
DNK,AUT,2022.0,5,6,-1
KOR,QAT,2013.0,7,2,5
PRT,CHL,2014.0,10,1,9
BEL,CZE,2010.0,3,2,1
CAN,MAR,2000.0,2,1,1
BEL,BRA,2007.0,16,10,6
CHE,SVK,2013.0,1,4,-3
JPN,FIN,2003.0,7,14,-7
RUS,BGR,2016.0,1,4,-3
PHL,DEU,2009.0,3,2,1
HUN,AUS,2019.0,2,1,1
BEL,IRL,2002.0,2,2,0
IRQ,JOR,2012.0,3,5,-2
FRA,DJI,2014.0,3,3,0
ITA,CZE,1998.0,4,5,-1
CHE,CZE,2016.0,13,11,2
BHR,SDN,2013.0,2,1,1
ESP,PAK,2007.0,1,1,0
CZE,CAN,2007.0,9,5,4
ISR,RUS,2022.0,2,10,-8
SGP,TWN,1999.0,2,1,1
ESP,IRN,2019.0,9,30,-21
TUN,CHE,2018.0,3,3,0
CAN,RUS,2007.0,11,27,-16
SRB,ITA,2019.0,5,5,0
VNM,BEL,2015.0,3,16,-13
IRL,BEL,2015.0,7,8,-1
VNM,NZL,2018.0,6,4,2
FRA,CAF,2007.0,4,5,-1
PHL,JPN,2000.0,2,1,1
COG,FRA,2009.0,4,6,-2
BRA,HUN,2015.0,2,1,1
KEN,GBR,2006.0,11,6,5
SGP,CHE,2009.0,3,7,-4
LTU,BRA,2018.0,1,1,0
DEU,ECU,2020.0,8,5,3
BRA,SGP,2020.0,1,2,-1
SAU,SGP,2017.0,2,7,-5
KEN,ZWE,2006.0,2,1,1
CHN,THA,2005.0,1,1,0
FRA,TWN,2002.0,3,5,-2
CHN,ZAF,2006.0,6,5,1
LUX,GRC,2011.0,1,1,0
SWE,LVA,2014.0,1,3,-2
HUN,BEL,2017.0,6,8,-2
IRN,QAT,2015.0,3,2,1
NLD,HKG,2015.0,5,3,2
BRA,URY,2002.0,5,5,0
MEX,IND,2002.0,3,2,1
SWE,LTU,2021.0,4,3,1
CHE,EGY,2009.0,2,2,0
RUS,BLR,2007.0,9,10,-1
SWE,MYS,2013.0,5,4,1
ITA,CZE,1997.0,2,3,-1
AUS,CZE,2009.0,2,6,-4
NLD,MYS,2012.0,4,4,0
MDA,DEU,2007.0,3,2,1
FRA,TWN,2005.0,4,2,2
SGP,POL,2009.0,2,3,-1
NZL,HKG,2015.0,2,9,-7
SWE,MLT,2014.0,1,2,-1
LTU,NOR,1999.0,1,1,0
FIN,BGR,1999.0,1,1,0
IND,NGA,2016.0,5,8,-3
ARE,CYP,2021.0,1,1,0
TZA,DNK,2021.0,1,1,0
PAK,CZE,2018.0,3,4,-1
EST,RUS,2002.0,1,2,-1
ITA,UGA,2009.0,1,1,0
CHN,PAK,2005.0,1,4,-3
UZB,KOR,2006.0,1,2,-1
NOR,NZL,2008.0,1,1,0
GBR,LBY,2022.0,3,2,1
TUR,HUN,2013.0,1,2,-1
TUR,AUT,2022.0,2,1,1
PRI,CAN,2012.0,1,1,0
JPN,WSM,2011.0,1,1,0
NLD,SAU,2007.0,1,1,0
ZAF,HKG,2013.0,1,1,0
AUS,KEN,2018.0,1,5,-4
COG,USA,2014.0,1,9,-8
MEX,PRI,2013.0,1,1,0
MKD,SVK,2019.0,1,2,-1
AUS,MOZ,2009.0,1,1,0
ITA,MYS,2022.0,1,1,0
RUS,,2018.0,8560,0,8560
GBR,,2018.0,17331,0,17331
DEU,,2014.0,14679,0,14679
,SWE,2002.0,3804,0,3804
IRN,,2020.0,8716,0,8716
,CHE,2001.0,3371,0,3371
AUS,,2022.0,17322,0,17322
MYS,,2009.0,229,0,229
,IND,2000.0,11529,0,11529
NZL,,2012.0,666,0,666
POL,,2018.0,4426,0,4426
,ESP,2000.0,13124,0,13124
NOR,,2015.0,1127,0,1127
,GBR,1994.0,19042,0,19042
,ITA,2010.0,14144,0,14144
,DEU,2010.0,23487,0,23487
VNM,,2022.0,2322,0,2322
EST,,2013.0,162,0,162
JOR,,2013.0,156,0,156
,PRT,1997.0,598,0,598
HKG,,2006.0,544,0,544
CHN,,2025.0,2414,0,2414
CUB,PER,2019.0,1,0,1
,SWE,2005.0,3438,0,3438
,TGO,2000.0,28,0,28
PRT,,2008.0,401,0,401
SVN,,2013.0,277,0,277
IND,,2025.0,565,0,565
TTO,,2023.0,172,0,172
,TUR,2018.0,6383,0,6383
,ZAF,2003.0,1401,0,1401
CHN,PAK,2002.0,5,0,5
NGA,,2011.0,406,0,406
,ITA,2017.0,13663,0,13663
,PRT,1998.0,1979,0,1979
NLD,,2002.0,376,0,376
,ARG,2013.0,2615,0,2615
ISR,,1999.0,35,0,35
FRA,MNG,2009.0,1,0,1
,LTU,2001.0,550,0,550
SEN,,2022.0,303,0,303
,MUS,2012.0,32,0,32
,TTO,2006.0,49,0,49
CHN,MEX,2009.0,3,0,3
,PNG,2005.0,21,0,21
,ITA,2019.0,8705,0,8705
MKD,,2023.0,465,0,465
NLD,,2005.0,1548,0,1548
BLR,,2012.0,164,0,164
KAZ,,2022.0,2102,0,2102
,UGA,2001.0,115,0,115
,DEU,2017.0,21427,0,21427
,KEN,2010.0,413,0,413
GTM,ARG,2014.0,2,0,2
BGD,,2016.0,399,0,399
,SAU,2014.0,2205,0,2205
,FIN,2016.0,1933,0,1933
,SDN,2018.0,119,0,119
PHL,,2021.0,613,0,613
SUR,USA,2015.0,1,0,1
CYP,,2019.0,156,0,156
MAR,IND,2014.0,1,0,1
KHM,,2024.0,190,0,190
,BOL,2011.0,36,0,36
SVN,CHN,2016.0,2,0,2
,LKA,2015.0,362,0,362
FIN,UGA,2019.0,1,0,1
,DZA,1999.0,391,0,391
FIN,UGA,2017.0,1,0,1
CAN,PRI,2000.0,1,0,1
,NCL,2012.0,17,0,17
MAR,NOR,2019.0,1,0,1
,KHM,2014.0,50,0,50
,KEN,2017.0,488,0,488
CHN,CHL,2016.0,5,0,5
,LVA,1995.0,81,0,81
,BLR,2014.0,255,0,255
SWE,,2025.0,17,0,17
MYS,VNM,2019.0,7,0,7
TUR,NOR,2018.0,9,0,9
CZE,VNM,2019.0,9,0,9
CUB,COL,2017.0,12,0,12
SEN,MAR,2018.0,1,0,1
CYP,,2017.0,88,0,88
,PRK,2018.0,68,0,68
BWA,SEN,2004.0,1,0,1
ESP,EST,2022.0,3,0,3
JPN,CMR,2011.0,2,0,2
,KWT,2018.0,165,0,165
,KEN,2019.0,291,0,291
,VEN,2018.0,113,0,113
ALB,,2024.0,270,0,270
,DEU,2019.0,11797,0,11797
,PSE,2012.0,78,0,78
CHE,MAR,1997.0,1,0,1
CHE,LBR,2018.0,7,0,7
,MOZ,2018.0,62,0,62
,GUF,2003.0,12,0,12
AUS,BFA,2019.0,1,0,1
IRL,CZE,2012.0,1,0,1
HKG,DNK,2006.0,3,0,3
BLZ,,2022.0,9,0,9
KEN,,2013.0,158,0,158
ITA,EGY,2011.0,8,0,8
UKR,TJK,2006.0,1,0,1
AUT,JPN,1998.0,1,0,1
SAU,OMN,2003.0,3,0,3
POL,KAZ,2017.0,4,0,4
,PNG,2002.0,14,0,14
ARM,GBR,2018.0,2,0,2
AUS,GRC,2022.0,4,0,4
MWI,,2021.0,115,0,115
SRB,,2000.0,14,0,14
,BTN,2018.0,35,0,35
CHL,,2001.0,30,0,30
,AGO,1998.0,6,0,6
COG,,2009.0,22,0,22
,KGZ,2002.0,21,0,21
DZA,,2005.0,19,0,19
,NER,2007.0,21,0,21
,MDA,1994.0,90,0,90
BRA,BGR,2013.0,1,0,1
BWA,SLE,2014.0,1,0,1
USA,BEN,2005.0,1,0,1
UGA,,2012.0,48,0,48
CAN,GHA,2003.0,3,0,3
VUT,,2023.0,13,0,13
EGY,ISR,2001.0,1,0,1
MAR,NLD,2004.0,2,0,2
NPL,,2005.0,11,0,11
,TJK,2006.0,11,0,11
DNK,UGA,2003.0,2,0,2
IRL,,1999.0,13,0,13
SWE,SRB,2010.0,3,0,3
FRA,VEN,1998.0,3,0,3
CAN,UGA,2005.0,1,0,1
HUN,SRB,2007.0,1,0,1
BRB,,2004.0,2,0,2
BRA,POL,1997.0,2,0,2
LBN,,2001.0,2,0,2
IRN,SDN,2008.0,1,0,1
MEX,SGP,2016.0,2,0,2
JPN,UZB,2001.0,1,0,1
MNE,JPN,2002.0,2,0,2
URY,GTM,2013.0,1,0,1
JAM,,2018.0,42,0,42
LVA,USA,1998.0,2,0,2
CYP,,2010.0,26,0,26
,FLK,2000.0,5,0,5
POL,MDA,2014.0,1,0,1
EGY,TUN,2004.0,1,0,1
ZAF,AUS,1998.0,2,0,2
GBR,BMU,2002.0,2,0,2
REU,,2018.0,2,0,2
MKD,BEL,2012.0,1,0,1
AND,,2009.0,1,0,1
BEL,IRL,2005.0,4,0,4
IND,NAM,2013.0,2,0,2
CHE,VNM,2008.0,2,0,2
GBR,BMU,2005.0,1,0,1
MDG,CMR,2003.0,1,0,1
ITA,GMB,2014.0,1,0,1
GMB,,2004.0,3,0,3
BGR,SVK,2008.0,1,0,1
KHM,FRA,2008.0,4,0,4
NZL,GRC,2014.0,2,0,2
IRL,BGD,2016.0,2,0,2
CHE,ZMB,2015.0,1,0,1
DEU,KAZ,2012.0,4,0,4
NPL,VNM,2017.0,1,0,1
ROU,ISL,2016.0,1,0,1
NZL,HUN,2018.0,1,0,1
THA,SAU,2016.0,2,0,2
,BWA,2009.0,55,0,55
CHE,CUB,2013.0,1,0,1
TUN,BHR,2016.0,2,0,2
BGR,GRC,2011.0,4,0,4
BHR,MLT,2015.0,1,0,1
BFA,GBR,2015.0,2,0,2
KOR,MEX,2014.0,2,0,2
ARE,DNK,2020.0,2,0,2
CHE,TCD,2018.0,1,0,1
MNE,,2013.0,11,0,11
CHN,HUN,2012.0,3,0,3
AFG,,2021.0,30,0,30
LBN,CZE,2019.0,1,0,1
ISR,SRB,2019.0,2,0,2
ROU,KOR,2002.0,2,0,2
ZAF,TZA,2005.0,2,0,2
ARG,ISR,2001.0,2,0,2
MDA,POL,2012.0,1,0,1
MOZ,USA,2003.0,1,0,1
IRQ,GBR,2010.0,3,0,3
CZE,MEX,2005.0,1,0,1
NGA,GHA,2014.0,2,0,2
POL,KAZ,2019.0,3,0,3
NGA,CIV,2021.0,2,0,2
,KGZ,2005.0,11,0,11
FRA,VEN,1997.0,2,0,2
DEU,ZWE,2000.0,1,0,1
DZA,SAU,2004.0,2,0,2
GRC,PRT,2018.0,8,0,8
NOR,THA,2013.0,2,0,2
HUN,TUR,2014.0,2,0,2
MDG,CHE,2017.0,1,0,1
PHL,SAU,2019.0,2,0,2
UKR,PRT,2019.0,2,0,2
GUY,CHN,2017.0,1,0,1
BWA,AUS,2019.0,3,0,3
GRC,PHL,2017.0,1,0,1
SDN,AUS,2009.0,1,0,1
WSM,,2022.0,6,0,6
DEU,GTM,2022.0,1,0,1
USA,LIE,2008.0,2,0,2
,GMB,2018.0,30,0,30
,BHS,2018.0,2,0,2
CHE,MDG,2022.0,1,0,1
IND,SVN,2020.0,4,0,4
HKG,MYS,2007.0,2,0,2
LVA,NLD,2021.0,1,0,1
CMR,SEN,2014.0,2,0,2
USA,MDA,2011.0,1,0,1
DZA,,2002.0,8,0,8
ARE,DEU,1998.0,1,0,1
PSE,CAN,2008.0,1,0,1
ECU,,2004.0,10,0,10
SVK,CHE,2009.0,3,0,3
NOR,TZA,2002.0,6,0,6
FRA,ZAF,1997.0,3,0,3
VEN,CAN,2007.0,4,0,4
SEN,BFA,2001.0,3,0,3
NLD,ZMB,2003.0,1,0,1
BEL,PRI,2003.0,1,0,1
ISL,AUS,2006.0,2,0,2
CMR,COG,2011.0,1,0,1
IRN,ZAF,2006.0,1,0,1
SEN,CMR,2021.0,3,0,3
CAN,IRQ,2011.0,1,0,1
MRT,,2018.0,4,0,4
,MLT,2003.0,16,0,16
,MTQ,2009.0,7,0,7
IRQ,KOR,2013.0,1,0,1
BEL,COD,2015.0,1,0,1
CHL,HND,2014.0,1,0,1
FRA,ETH,2010.0,2,0,2
GBR,GEO,2012.0,2,0,2
GHA,LKA,2009.0,1,0,1
JPN,MNG,2017.0,8,0,8
AUS,BWA,2018.0,3,0,3
HUN,LBN,2019.0,1,0,1
AUT,VNM,2020.0,1,0,1
LKA,ISR,2021.0,1,0,1
GBR,SLV,2021.0,1,0,1
KWT,SRB,2012.0,1,0,1
SRB,MNE,2007.0,5,0,5
MAR,SAU,2009.0,2,0,2
HRV,RUS,2016.0,3,0,3
IND,ISL,2021.0,2,0,2
,AND,1999.0,2,0,2
SEN,DEU,2015.0,2,0,2
IRN,OMN,2021.0,3,0,3
IRL,KWT,2005.0,1,0,1
TTO,BRB,2003.0,1,0,1
PAK,TZA,2013.0,5,0,5
AUT,KEN,2014.0,3,0,3
AUT,LIE,2013.0,2,0,2
LBN,PRT,2016.0,1,0,1
FIN,BFA,2014.0,1,0,1
JPN,SDN,2003.0,2,0,2
IRN,COL,2017.0,1,0,1
GHA,TUR,2016.0,1,0,1
CAN,TTO,2018.0,5,0,5
ZWE,SSD,2021.0,1,0,1
SLB,AUS,2014.0,3,0,3
TUN,GBR,2015.0,5,0,5
ARE,CHN,2007.0,2,0,2
ZAF,VGB,2016.0,1,0,1
AUS,MMR,2021.0,7,0,7
BIH,FRA,2013.0,2,0,2
,MRT,2009.0,15,0,15
DNK,LUX,2014.0,2,0,2
DNK,ECU,2019.0,3,0,3
PAK,NLD,2007.0,2,0,2
PHL,SAU,2010.0,2,0,2
IDN,CAN,2003.0,1,0,1
,BDI,1999.0,2,0,2
ITA,LKA,2011.0,3,0,3
GUY,FRA,2005.0,1,0,1
ROU,FIN,2012.0,2,0,2
KNA,USA,2021.0,2,0,2
BRA,IDN,2005.0,1,0,1
VNM,BRA,2014.0,1,0,1
TUN,CMR,1999.0,1,0,1
ECU,FJI,2017.0,1,0,1
SVN,ISR,1999.0,2,0,2
BHR,DEU,2011.0,1,0,1
GBR,QAT,2009.0,4,0,4
DEU,BFA,2002.0,1,0,1
BRA,PAN,2008.0,1,0,1
NAM,,2008.0,3,0,3
SLE,USA,2002.0,3,0,3
SAU,AUS,1998.0,1,0,1
GRL,CAN,2018.0,1,0,1
NLD,SDN,2012.0,1,0,1
MYS,UGA,2014.0,1,0,1
MYS,KHM,2016.0,2,0,2
VEN,MEX,2019.0,7,0,7
RUS,COL,1999.0,2,0,2
,TON,2014.0,1,0,1
MKD,USA,2003.0,1,0,1
,VUT,1999.0,4,0,4
COL,,2000.0,3,0,3
BEL,SAU,2006.0,1,0,1
BLR,ZAF,2002.0,1,0,1
UGA,ETH,2004.0,1,0,1
NLD,NIU,2006.0,1,0,1
DEU,DOM,2014.0,1,0,1
HND,,2008.0,2,0,2
PHL,TWN,2002.0,1,0,1
HUN,GEO,2009.0,1,0,1
PAK,ARE,2002.0,1,0,1
POL,BHR,2014.0,1,0,1
PAK,FJI,2020.0,1,0,1
LUX,DNK,2007.0,1,0,1
ITA,MKD,2002.0,1,0,1
BRN,,2002.0,2,0,2
,AGO,1997.0,1,0,1
DEU,LSO,2011.0,1,0,1
MKD,CHE,2010.0,1,0,1
NCL,CAN,2010.0,1,0,1
DEU,TUN,2012.0,3,0,3
LVA,USA,1997.0,1,0,1
OMN,EGY,2001.0,1,0,1
MEX,ROU,2005.0,1,0,1
PRT,HRV,2016.0,1,0,1
RUS,PRI,2000.0,1,0,1
PRT,BGR,2018.0,2,0,2
HUN,SDN,2013.0,1,0,1
POL,SVN,2015.0,5,0,5
CZE,GHA,2018.0,2,0,2
AGO,KHM,2017.0,1,0,1
MAR,CMR,2020.0,2,0,2
USA,FRO,2020.0,1,0,1
BEN,NER,2018.0,2,0,2
ROU,TWN,2006.0,2,0,2
JPN,IRN,2000.0,1,0,1
LBR,,2018.0,5,0,5
UGA,KOR,2018.0,1,0,1
USA,ERI,2017.0,1,0,1
SEN,RWA,2016.0,1,0,1
CUB,ARE,2020.0,2,0,2
IRN,NGA,2014.0,1,0,1
IND,KAZ,2008.0,1,0,1
CHE,URY,2012.0,1,0,1
ISR,HRV,2005.0,1,0,1
KEN,CHL,2009.0,1,0,1
GBR,FJI,2005.0,1,0,1
MOZ,NLD,2002.0,4,0,4
POL,BGR,2008.0,3,0,3
BWA,,2003.0,6,0,6
NOR,IRL,2004.0,2,0,2
COL,SLV,2008.0,1,0,1
DEU,SLE,2018.0,1,0,1
NZL,CZE,2013.0,1,0,1
TWN,DNK,2016.0,2,0,2
ARE,BRN,2020.0,1,0,1
IND,MLI,2016.0,1,0,1
UZB,MYS,2012.0,1,0,1
IDN,KHM,2019.0,1,0,1
ESP,MKD,2020.0,1,0,1
ISR,HRV,2002.0,2,0,2
ROU,KOR,2005.0,1,0,1
OMN,FRA,2009.0,1,0,1
MEX,LTU,2002.0,1,0,1
ZWE,CMR,2003.0,1,0,1
CZE,TWN,2006.0,1,0,1
ECU,ITA,2010.0,2,0,2
MEX,SAU,2006.0,1,0,1
,MCO,2006.0,6,0,6
UKR,CHE,2015.0,1,0,1
CUB,PER,2017.0,1,0,1
PRT,FJI,2020.0,1,0,1
MOZ,ESP,2011.0,3,0,3
VEN,CUB,2001.0,2,0,2
HKG,EST,2018.0,1,0,1
USA,COG,2010.0,3,0,3
DEU,FRO,2009.0,1,0,1
ESP,VNM,2001.0,1,0,1
KEN,CHE,2004.0,3,0,3
NOR,TZA,2005.0,1,0,1
GUY,AUS,2008.0,1,0,1
DEU,CIV,2002.0,1,0,1
ISR,LTU,2007.0,2,0,2
BGR,PRT,2012.0,1,0,1
JPN,SVN,2003.0,2,0,2
KWT,DEU,1999.0,1,0,1
ZMB,GBR,1997.0,1,0,1
ARE,ZAF,2014.0,2,0,2
COG,MYS,2001.0,1,0,1
EGY,DZA,2016.0,1,0,1
EGY,CMR,2002.0,1,0,1
BHR,ARE,2009.0,2,0,2
BOL,PER,2016.0,1,0,1
GRC,KWT,2015.0,3,0,3
GRC,SVN,2009.0,1,0,1
RUS,TUN,2017.0,1,0,1
BEL,GUF,2021.0,1,0,1
DNK,ECU,2017.0,1,0,1
IRL,BGR,2015.0,2,0,2
TTO,DEU,2017.0,1,0,1
JPN,MNE,2014.0,1,0,1
MAR,QAT,2020.0,3,0,3
SVN,SWE,2011.0,3,0,3
CAN,LAO,2010.0,1,0,1
CAN,UGA,2002.0,2,0,2
ZWE,BWA,2011.0,3,0,3
JPN,KWT,2007.0,1,0,1
JPN,YEM,2015.0,1,0,1
GRC,BOL,2008.0,1,0,1
LBY,NZL,2020.0,1,0,1
,KNA,2016.0,5,0,5
CHE,SAU,2008.0,1,0,1
YEM,BHR,2016.0,1,0,1
DNK,ECU,2010.0,1,0,1
NGA,GMB,2007.0,1,0,1
MEX,CZE,2000.0,1,0,1
DNK,ZAF,2005.0,3,0,3
MNG,RUS,2007.0,1,0,1
ARG,LVA,2010.0,1,0,1
LKA,CHE,2018.0,2,0,2
BEL,QAT,2021.0,1,0,1
LTU,CZE,2014.0,1,0,1
LBR,IND,2020.0,1,0,1
DNK,CZE,2000.0,1,0,1
UGA,AGO,2014.0,1,0,1
LIE,USA,2013.0,1,0,1
UKR,SGP,2018.0,1,0,1
AIA,,2015.0,1,0,1
IRL,LTU,2021.0,1,0,1
MDA,RUS,2017.0,2,0,2
RUS,THA,2012.0,2,0,2
BRN,DNK,2022.0,1,0,1
SWE,ARM,2019.0,1,0,1
MEX,THA,2005.0,1,0,1
UKR,BRN,2014.0,1,0,1
GRC,DZA,2017.0,1,0,1
KOR,IRN,2003.0,1,0,1
MEX,TUN,2013.0,1,0,1
SDN,SVK,2012.0,1,0,1
BLR,FIN,2022.0,1,0,1
ISR,KEN,2022.0,1,0,1
URY,CHE,2007.0,1,0,1
KWT,JOR,2019.0,2,0,2
CHE,TWN,2001.0,1,0,1
GBR,CRI,2018.0,1,0,1
IRN,ITA,2002.0,1,0,1
SLE,ITA,2020.0,1,0,1
CRI,ZAF,2018.0,1,0,1
USA,MMR,2020.0,1,0,1
VNM,PHL,2018.0,1,0,1
PAK,EGY,2003.0,2,0,2
MAR,SWE,2012.0,1,0,1
ITA,PSE,2021.0,3,0,3
BEL,MAC,2016.0,1,0,1
IND,LTU,2017.0,2,0,2
GBR,PAN,2003.0,1,0,1
NZL,ISL,2008.0,1,0,1
TUR,JOR,2010.0,1,0,1
ARE,SDN,2011.0,1,0,1
CUB,COL,2010.0,1,0,1
ZAF,VEN,2017.0,1,0,1
SRB,FIN,2000.0,1,0,1
SWZ,,2003.0,1,0,1
GRC,HKG,2014.0,1,0,1
IDN,CMR,2011.0,1,0,1
NLD,SEN,2015.0,1,0,1
PRI,VEN,2022.0,1,0,1
SYR,CHE,2013.0,1,0,1
USA,SYC,2013.0,2,0,2
GBR,GIB,2009.0,1,0,1
CUB,PAN,2011.0,1,0,1
KEN,GHA,2021.0,1,0,1
EST,GHA,2022.0,1,0,1
GEO,ITA,2018.0,1,0,1
SWZ,MOZ,2020.0,1,0,1
CUB,BRA,1997.0,1,0,1
NER,KEN,2008.0,1,0,1
BEN,COG,2005.0,1,0,1
AFG,SDN,2009.0,1,0,1
TUR,PRT,2006.0,1,0,1
SAU,ITA,1997.0,1,0,1
RUS,SVN,1999.0,1,0,1
RWA,LUX,2006.0,1,0,1
MKD,MNE,2018.0,1,0,1
TZA,ITA,2017.0,1,0,1
SDN,PAK,2019.0,1,0,1
CHL,ROU,2020.0,1,0,1
IRL,COL,2014.0,1,0,1
PRT,PRY,2018.0,1,0,1
AUT,FIN,2007.0,1,0,1
LTU,IRL,2008.0,1,0,1
CAN,SYR,2013.0,1,0,1
UKR,PRT,2017.0,2,0,2
MKD,CAN,2014.0,1,0,1
SYR,GUY,2014.0,1,0,1
TKM,CHN,2019.0,1,0,1
TUR,JOR,2017.0,2,0,2
MNG,TUR,2020.0,1,0,1
CHN,TJK,2018.0,3,0,3
HRV,PAK,2010.0,1,0,1
MEX,ZAF,2020.0,2,0,2
DNK,NAM,2012.0,1,0,1
KNA,ZAF,2019.0,1,0,1
GBR,RWA,2012.0,2,0,2
IRL,CYP,2021.0,1,0,1
CAN,NCL,2016.0,1,0,1
USA,TCA,2017.0,1,0,1
PRT,TUN,2006.0,1,0,1
ISR,SRB,2010.0,1,0,1
PAN,NLD,2008.0,1,0,1
MOZ,NGA,2014.0,2,0,2
AUT,TUN,2016.0,1,0,1
SVK,SRB,2016.0,1,0,1
PAK,MYS,2007.0,1,0,1
DNK,SRB,2004.0,1,0,1
LTU,ESP,2008.0,1,0,1
MKD,SVK,2017.0,1,0,1
DEU,TZA,2022.0,1,0,1
IRN,COL,2019.0,1,0,1
CHN,RWA,2016.0,2,0,2
CRI,BEL,2018.0,2,0,2
CAN,LAO,2017.0,1,0,1
TTO,DEU,2019.0,1,0,1
SVN,FIN,2014.0,1,0,1
MHL,USA,2020.0,1,0,1
,WSM,2000.0,1,0,1
GTM,AUT,2016.0,1,0,1
BEL,BRN,2000.0,1,0,1
FJI,GUY,2002.0,1,0,1
ESP,NZL,2003.0,4,0,4
CRI,JPN,2002.0,1,0,1
GRC,TWN,2009.0,1,0,1
CZE,ARE,2010.0,1,0,1
NOR,OMN,2011.0,1,0,1
TZA,FRA,2018.0,1,0,1
VEN,PRT,2015.0,1,0,1
NLD,UKR,2022.0,2,0,2
JAM,NGA,2013.0,1,0,1
LVA,LTU,2003.0,1,0,1
ROU,NLD,2000.0,1,0,1
SYR,BEL,2004.0,1,0,1
CHL,CHN,2005.0,1,0,1
GHA,NER,2015.0,1,0,1
PRT,CRI,2003.0,1,0,1
MAR,CIV,2013.0,1,0,1
PRY,CUB,2014.0,1,0,1
NGA,JOR,2015.0,1,0,1
GBR,CMR,2004.0,4,0,4
OMN,THA,2009.0,1,0,1
NPL,LKA,2011.0,1,0,1
IRL,KEN,2009.0,2,0,2
REU,ESP,2020.0,1,0,1
VEN,PRY,2016.0,1,0,1
ALB,GRC,2020.0,1,0,1
COL,HKG,2021.0,1,0,1
BGR,CHN,2019.0,1,0,1
SWE,MOZ,2016.0,3,0,3
SEN,CIV,2015.0,1,0,1
TGO,MAR,2012.0,1,0,1
BHR,QAT,2015.0,1,0,1
MYS,IRN,2002.0,1,0,1
PER,CHN,2019.0,1,0,1
PAK,PRT,2006.0,1,0,1
CUB,FIN,2004.0,1,0,1
KAZ,CZE,2022.0,1,0,1
GEO,NLD,2001.0,1,0,1
ROU,CUB,2015.0,1,0,1
ECU,URY,2013.0,1,0,1
NGA,JPN,1999.0,1,0,1
NAM,AUS,2015.0,1,0,1
SRB,IND,2004.0,1,0,1
PRT,QAT,2013.0,1,0,1
ZMB,NLD,2020.0,1,0,1
TON,VUT,2018.0,1,0,1
SAU,MYS,2002.0,1,0,1
EST,BRA,2014.0,1,0,1
CUB,CZE,2014.0,1,0,1
KAZ,OMN,2018.0,1,0,1
NLD,KWT,2020.0,1,0,1
POL,GRC,2002.0,1,0,1
MAR,MAC,2020.0,1,0,1
BOL,SWE,2009.0,1,0,1
BWA,CAN,2002.0,1,0,1
DOM,MEX,2002.0,1,0,1
OMN,TCA,2012.0,1,0,1
FRA,BDI,2022.0,1,0,1
JPN,MYS,1997.0,1,0,1
NPL,,2002.0,1,0,1
LBY,ARE,2009.0,2,0,2
ZAF,DNK,2010.0,1,0,1
PRT,SWE,2000.0,1,0,1
NPL,FIN,2018.0,1,0,1
NIC,PER,2021.0,1,0,1
VEN,SAU,2012.0,1,0,1
MLT,AUS,2004.0,1,0,1
JOR,DNK,2013.0,1,0,1
JOR,BRN,2021.0,1,0,1
NRU,NCL,2015.0,1,0,1
CIV,BFA,2011.0,1,0,1
CHL,IDN,2018.0,1,0,1
USA,FJI,2021.0,1,0,1
EGY,COL,2007.0,1,0,1
BRN,,2005.0,1,0,1
TUR,JOR,2019.0,1,0,1
TZA,MYS,2017.0,1,0,1
CUB,NLD,2020.0,1,0,1
USA,IRN,2021.0,81,296,-215
RUS,NLD,2013.0,17,11,6
USA,GBR,2018.0,1512,1717,-205
ESP,NZL,2012.0,12,7,5
CAN,AUS,2013.0,202,133,69
FRA,BRA,2016.0,113,118,-5
FRA,ESP,2015.0,179,289,-110
CAN,IRL,2010.0,28,25,3
ITA,CHE,2011.0,156,81,75
GBR,DEU,2009.0,436,505,-69
CHE,SWE,2011.0,21,36,-15
ARE,OMN,2008.0,2,3,-1
IND,MYS,2011.0,54,27,27
CHE,USA,2008.0,387,394,-7
GBR,ARE,2016.0,34,23,11
GBR,JOR,2007.0,14,6,8
GBR,ESP,2005.0,141,157,-16
USA,CAN,2005.0,1210,1243,-33
NLD,DEU,2006.0,185,184,1
CHL,USA,2013.0,102,85,17
JPN,GBR,2013.0,109,112,-3
FIN,USA,2010.0,72,53,19
GBR,AUS,2015.0,595,456,139
USA,ZAF,2015.0,84,86,-2
USA,AUS,2016.0,556,592,-36
USA,CAN,2002.0,1160,1286,-126
USA,TUR,2018.0,274,311,-37
ESP,FIN,2013.0,14,17,-3
GBR,POL,2019.0,63,72,-9
GBR,CHN,2015.0,357,287,70
BGR,SRB,2014.0,2,1,1
BRA,BEL,2018.0,15,17,-2
FRA,IRL,2008.0,32,17,15
GBR,HRV,2006.0,2,2,0
NZL,AUS,2005.0,121,93,28
NOR,USA,2013.0,68,84,-16
FRA,GBR,2011.0,356,411,-55
CAN,RUS,2002.0,15,29,-14
FRA,ARG,2012.0,25,23,2
NZL,JPN,2012.0,10,8,2
GBR,CYP,2008.0,14,6,8
USA,ARG,2009.0,80,94,-14
AUS,JPN,2020.0,60,49,11
SWE,ITA,2019.0,35,80,-45
IND,AUS,2013.0,88,53,35
CAN,KWT,2008.0,8,5,3
DEU,BRA,2017.0,94,96,-2
USA,PAK,2007.0,35,37,-2
MEX,ESP,2002.0,40,59,-19
DEU,NLD,2005.0,158,154,4
FRA,LBN,2012.0,63,22,41
RUS,UKR,2017.0,44,178,-134
USA,ITA,2006.0,347,421,-74
GBR,DNK,2016.0,97,94,3
TUR,CAN,2013.0,16,18,-2
ITA,USA,1999.0,206,200,6
CHE,GBR,2015.0,240,240,0
MTQ,FRA,2013.0,26,19,7
GBR,ESP,2002.0,145,131,14
GBR,COL,2003.0,14,4,10
USA,NZL,2015.0,121,116,5
GRC,GBR,2021.0,118,119,-1
HUN,DEU,2006.0,30,32,-2
JPN,CAN,2013.0,80,77,3
FRA,FIN,2008.0,8,16,-8
CHE,ESP,2022.0,36,48,-12
ARE,JOR,2012.0,1,19,-18
ITA,SWE,2009.0,24,21,3
FRA,ROU,2009.0,37,27,10
BEL,SWE,2015.0,22,17,5
ESP,CAN,2014.0,75,33,42
TWN,USA,2009.0,243,320,-77
DEU,SWE,2012.0,134,73,61
SWE,ESP,2016.0,39,73,-34
TZA,GBR,2022.0,4,2,2
IND,DEU,2014.0,161,107,54
ESP,ITA,2014.0,180,135,45
GRC,ITA,2011.0,31,15,16
SGP,CHN,2014.0,247,195,52
EGY,QAT,2018.0,16,7,9
IRL,NOR,2016.0,6,3,3
IND,FRA,2022.0,48,25,23
CHN,SGP,2016.0,234,309,-75
AUS,SGP,2011.0,48,66,-18
USA,LVA,2020.0,2,2,0
FRA,DNK,2019.0,65,36,29
URY,USA,2012.0,8,9,-1
IRN,DEU,2012.0,58,28,30
RUS,UKR,2010.0,48,28,20
FRA,CHL,2012.0,36,13,23
IND,CAN,2022.0,63,57,6
DEU,CHL,2013.0,27,23,4
LBN,USA,2015.0,41,47,-6
LBN,FRA,2014.0,23,70,-47
CHN,JPN,2016.0,272,482,-210
IND,ISR,2019.0,128,53,75
SAU,EGY,2014.0,162,177,-15
USA,FRA,2022.0,257,267,-10
CHN,IRL,2007.0,5,1,4
TUR,GBR,2022.0,25,29,-4
NLD,COL,2014.0,6,6,0
ARE,IND,2022.0,21,28,-7
IRQ,MYS,2014.0,9,36,-27
MYS,SDN,2015.0,6,4,2
TUR,IRQ,2016.0,12,5,7
IND,ISR,2017.0,95,52,43
FIN,NOR,2003.0,11,5,6
USA,KOR,1997.0,75,47,28
CHN,VNM,2017.0,24,6,18
AUS,VNM,2022.0,18,24,-6
BEL,GHA,2016.0,1,1,0
SGP,USA,2022.0,57,73,-16
BEL,CHN,2020.0,83,63,20
AUT,IRN,2015.0,10,9,1
HUN,GBR,2011.0,41,21,20
USA,DNK,2021.0,127,100,27
IRL,GRC,2019.0,5,9,-4
IDN,THA,2020.0,6,16,-10
ESP,ZAF,2018.0,12,2,10
IND,RUS,2020.0,22,2,20
ESP,TWN,2015.0,4,2,2
CHN,ESP,2021.0,39,43,-4
SWE,NLD,2021.0,49,41,8
TUR,ARE,2022.0,3,1,2
ITA,CAN,2015.0,80,45,35
USA,QAT,2016.0,66,29,37
DNK,PHL,2020.0,1,1,0
MEX,GBR,2015.0,46,59,-13
BRA,PER,2020.0,52,14,38
MYS,NZL,2016.0,15,28,-13
HKG,USA,2013.0,130,147,-17
TWN,FRA,2015.0,6,12,-6
FRA,NLD,2015.0,121,130,-9
GBR,MWI,2019.0,14,13,1
CRI,DEU,2015.0,3,7,-4
MAR,FRA,2022.0,24,25,-1
FRA,TUN,2022.0,22,29,-7
JPN,IDN,2006.0,39,8,31
FRA,DNK,2017.0,65,32,33
AUS,IND,2021.0,61,94,-33
NLD,IDN,2016.0,27,9,18
MEX,NZL,2018.0,3,1,2
PRT,DEU,2018.0,45,30,15
OMN,USA,2004.0,7,5,2
DEU,JPN,2004.0,86,112,-26
IND,JPN,2016.0,100,61,39
DEU,FIN,2014.0,56,38,18
MEX,ISR,2017.0,3,2,1
USA,BGD,2022.0,23,81,-58
ESP,DNK,2021.0,27,20,7
KAZ,JPN,2018.0,3,3,0
USA,GRC,2001.0,61,47,14
FRA,BEN,2018.0,11,9,2
MEX,POL,2019.0,4,1,3
ARG,USA,2006.0,122,74,48
DEU,MEX,2020.0,24,53,-29
TUR,CYP,2018.0,84,36,48
CAN,IRL,2019.0,42,49,-7
DEU,IRL,2016.0,34,46,-12
UKR,ROU,2021.0,1,1,0
IND,HUN,2019.0,9,3,6
FRA,IND,2006.0,23,52,-29
CHN,NOR,2022.0,15,16,-1
SGP,AUS,2013.0,82,68,14
IRN,BEL,2020.0,33,4,29
CHN,FIN,2022.0,17,31,-14
GBR,SGP,2022.0,38,42,-4
BEL,HUN,2019.0,6,6,0
GBR,THA,2022.0,23,12,11
MWI,ZAF,2019.0,3,10,-7
FIN,DEU,2022.0,25,25,0
SWE,ITA,2017.0,35,82,-47
CHN,PAK,2007.0,6,11,-5
MWI,USA,2021.0,15,8,7
FRA,IRN,2022.0,6,20,-14
IND,FIN,2016.0,14,6,8
ITA,BRA,2000.0,17,13,4
CAN,MEX,2021.0,21,39,-18
NZL,AUS,2002.0,81,74,7
USA,AUT,2022.0,43,42,1
DEU,CHE,2009.0,590,402,188
THA,JPN,2022.0,22,36,-14
FIN,IND,2021.0,5,23,-18
GBR,MWI,2017.0,23,11,12
DNK,CHN,2015.0,30,55,-25
MEX,ESP,2005.0,40,74,-34
BRA,ITA,2022.0,22,6,16
BRA,CHE,2012.0,14,19,-5
FRA,SYR,2016.0,8,3,5
UKR,JPN,2006.0,5,3,2
FRA,DNK,2010.0,22,21,1
JPN,EGY,2021.0,37,15,22
GBR,LBN,2011.0,6,4,2
USA,PER,2013.0,31,30,1
MWI,ZAF,2010.0,3,3,0
ARM,FRA,2011.0,1,4,-3
CAN,CHL,2011.0,14,16,-2
VEN,USA,2008.0,31,20,11
NLD,IND,2016.0,29,49,-20
NLD,GBR,2004.0,128,129,-1
SAU,DNK,2015.0,3,2,1
CHN,VNM,2019.0,26,9,17
FRA,JPN,2007.0,60,65,-5
IND,PRT,2006.0,11,2,9
GBR,POL,2017.0,53,101,-48
VNM,KOR,2009.0,6,10,-4
TWN,BGD,2020.0,2,1,1
THA,AUS,2011.0,19,22,-3
JPN,TWN,2013.0,28,25,3
CAN,AUT,2013.0,15,12,3
POL,SWE,2015.0,23,9,14
EGY,CZE,2016.0,1,4,-3
DNK,DEU,1998.0,9,10,-1
CAN,POL,2006.0,11,13,-2
RUS,CHN,2013.0,8,4,4
CAN,JPN,2001.0,54,83,-29
AUS,ARE,2006.0,5,5,0
SGP,GBR,2001.0,24,32,-8
FRA,GEO,2012.0,1,3,-2
USA,KOR,1998.0,131,61,70
DEU,HKG,1999.0,7,1,6
AUS,USA,1998.0,86,102,-16
AUS,BRN,2020.0,6,5,1
PER,CHL,2015.0,4,7,-3
JOR,ARE,2022.0,9,8,1
CHL,GBR,2016.0,43,41,2
KOR,IDN,2021.0,21,21,0
DNK,DEU,1997.0,10,13,-3
JPN,DEU,2000.0,47,43,4
IDN,SWE,2019.0,3,1,2
DEU,RUS,1999.0,53,98,-45
FRA,NCL,2015.0,14,24,-10
CHN,MNG,2016.0,1,1,0
SVN,DEU,2020.0,11,9,2
CAN,ITA,2003.0,35,36,-1
DEU,NLD,2002.0,181,129,52
IND,BEL,2008.0,6,8,-2
BEL,IND,2011.0,14,17,-3
SVK,SVN,2006.0,5,5,0
SWE,ITA,2010.0,12,39,-27
OMN,AUS,2016.0,4,3,1
GBR,POL,2010.0,41,60,-19
PER,JPN,2015.0,3,3,0
DEU,ALB,2017.0,1,2,-1
BRA,CRI,2021.0,3,2,1
BEL,LBN,2017.0,10,4,6
JPN,IND,2016.0,61,100,-39
ZAF,IND,2016.0,29,75,-46
NZL,BRA,2020.0,3,9,-6
MAC,HKG,2018.0,6,17,-11
VNM,USA,2012.0,9,18,-9
FRA,EGY,2022.0,7,5,2
HRV,GBR,2022.0,1,6,-5
GBR,ARG,2002.0,12,12,0
OMN,IND,2022.0,4,7,-3
CHE,JPN,2020.0,33,30,3
BRA,TUR,2022.0,1,2,-1
ZAF,KEN,2021.0,18,5,13
ARG,ITA,2018.0,10,12,-2
PAK,NZL,2019.0,7,9,-2
NLD,NOR,2015.0,36,12,24
CHN,NGA,2022.0,12,8,4
SVK,USA,1998.0,6,2,4
FRA,MCO,2018.0,7,6,1
KOR,PRT,2019.0,4,1,3
USA,SWE,2000.0,59,67,-8
IRL,DNK,2021.0,12,7,5
SGP,CAN,2021.0,24,10,14
SWE,POL,2021.0,9,15,-6
ZAF,ISR,2021.0,1,2,-1
SWE,CZE,2012.0,5,7,-2
USA,SRB,2012.0,15,4,11
HUN,CHE,2004.0,14,7,7
MEX,ECU,2013.0,1,2,-1
PAK,IRL,2014.0,3,5,-2
IRN,AUT,2016.0,15,6,9
BEL,MAR,2022.0,3,4,-1
KEN,CAN,2022.0,3,1,2
GBR,PAK,2001.0,14,6,8
VEN,CHL,2020.0,22,2,20
NZL,KEN,2003.0,1,1,0
URY,BRA,2008.0,2,4,-2
BFA,TGO,2010.0,3,1,2
CAN,ARE,2009.0,19,7,12
CZE,DEU,2013.0,28,30,-2
BEL,COL,2017.0,6,5,1
EGY,FRA,2000.0,2,1,1
BWA,ZAF,2006.0,4,1,3
KEN,DEU,2017.0,8,14,-6
UKR,CAN,2012.0,6,1,5
SYR,SAU,2015.0,3,1,2
BEL,BRA,2005.0,5,6,-1
RUS,BLR,2005.0,11,12,-1
NZL,TUR,2019.0,2,2,0
ARG,CUB,2007.0,1,1,0
SAU,ARE,2015.0,20,6,14
FIN,NZL,2015.0,4,2,2
TWN,SGP,2006.0,4,5,-1
JPN,CZE,2006.0,5,5,0
MYS,GBR,2002.0,17,29,-12
DEU,ARG,2011.0,18,24,-6
BRA,GBR,1998.0,9,16,-7
CZE,ISR,2011.0,3,1,2
IDN,JPN,2001.0,13,10,3
NOR,FRA,2004.0,10,19,-9
CHN,AUS,2000.0,16,9,7
RUS,CAN,1997.0,7,2,5
KOR,VNM,2003.0,6,2,4
JPN,UKR,2001.0,9,5,4
GRC,TUR,2022.0,1,2,-1
USA,VNM,2003.0,7,2,5
RUS,CAN,1998.0,7,3,4
BGR,CAN,2008.0,4,2,2
SWE,ARE,2006.0,1,1,0
RUS,BEL,2004.0,8,3,5
RUS,MEX,2002.0,11,14,-3
CMR,FRA,2006.0,7,6,1
DEU,ISR,1997.0,7,6,1
CHE,CHN,2002.0,10,12,-2
CHE,IND,2007.0,9,24,-15
DEU,SGP,2007.0,15,9,6
HRV,ITA,2005.0,3,2,1
HRV,SRB,2006.0,8,3,5
GBR,ISR,2000.0,16,10,6
GBR,ARG,2005.0,8,10,-2
SRB,DEU,2001.0,11,2,9
SAU,TUR,2003.0,1,3,-2
NLD,ESP,2009.0,60,55,5
ITA,CHN,2009.0,13,17,-4
GBR,IDN,2001.0,5,2,3
GBR,UKR,2011.0,7,9,-2
CAN,ESP,2000.0,6,7,-1
RUS,CHE,2000.0,6,6,0
BEL,RUS,2020.0,4,14,-10
TUN,USA,2001.0,1,2,-1
RUS,KOR,2004.0,10,16,-6
SWE,EST,2013.0,4,2,2
ISL,USA,2004.0,6,13,-7
ROU,CHN,2017.0,2,2,0
NLD,FRA,2000.0,21,32,-11
ARG,AUS,2002.0,6,5,1
GRC,DEU,1997.0,5,3,2
USA,PRT,2003.0,53,33,20
SWE,MEX,2001.0,2,1,1
ZAF,FRA,2003.0,7,15,-8
SWE,FRA,1999.0,17,21,-4
CAN,OMN,2003.0,4,1,3
CAN,THA,2009.0,12,15,-3
UGA,GBR,2009.0,5,7,-2
QAT,SWE,2022.0,1,1,0
KOR,TWN,2014.0,6,8,-2
GBR,TWN,1999.0,10,3,7
COL,USA,2001.0,17,12,5
FRA,PYF,2022.0,4,3,1
DNK,SGP,2017.0,7,9,-2
ESP,EGY,2008.0,4,1,3
IRL,BHR,2012.0,2,2,0
COL,ITA,2009.0,2,2,0
FRA,MAR,1997.0,11,5,6
RUS,CZE,2001.0,7,8,-1
HKG,AUS,2009.0,41,26,15
USA,LKA,2012.0,12,12,0
IND,NLD,2012.0,24,26,-2
NLD,ISR,2002.0,9,7,2
CZE,CAN,2002.0,16,5,11
BEL,CAN,2007.0,24,17,7
AUT,POL,2012.0,18,15,3
POL,NOR,2015.0,12,7,5
GBR,BGD,2014.0,14,12,2
JPN,MAC,2017.0,1,1,0
HUN,AUT,2001.0,7,8,-1
CHE,CHL,2001.0,2,1,1
CZE,JPN,2014.0,6,8,-2
KOR,GBR,2001.0,12,17,-5
ECU,USA,1998.0,1,1,0
DEU,GHA,2006.0,5,1,4
KOR,ISR,2002.0,3,1,2
ZAF,PRT,2010.0,3,1,2
SGP,HKG,2007.0,13,23,-10
JPN,NGA,2015.0,1,3,-2
GRC,BEL,2015.0,18,11,7
DNK,SGP,2010.0,2,3,-1
FRA,KEN,2012.0,3,4,-1
FIN,CHL,2021.0,2,3,-1
FRA,BFA,2007.0,14,6,8
KEN,DEU,2010.0,7,7,0
MEX,CUB,2005.0,8,9,-1
ITA,HRV,2013.0,4,6,-2
AUS,BEL,2012.0,13,27,-14
CAN,MLI,2008.0,1,2,-1
ISR,NOR,2003.0,1,2,-1
GBR,KWT,2011.0,10,4,6
CHL,CAN,2008.0,6,10,-4
EST,FRA,2021.0,3,4,-1
FRA,IDN,2009.0,5,1,4
MEX,CHN,2014.0,2,3,-1
CZE,RUS,2009.0,7,6,1
LKA,USA,2005.0,8,10,-2
ITA,TUR,2003.0,1,1,0
KEN,RWA,2014.0,1,1,0
JPN,BGR,2020.0,2,2,0
ESP,JPN,2016.0,24,12,12
DNK,SAU,2013.0,1,2,-1
THA,NZL,2014.0,1,6,-5
ZAF,SWZ,2017.0,5,2,3
IDN,NLD,2008.0,6,10,-4
NLD,SGP,2015.0,25,8,17
BRA,MEX,2012.0,6,7,-1
CMR,KEN,2016.0,2,1,1
ESP,MAR,2018.0,13,3,10
PAK,DEU,2000.0,1,1,0
ITA,IRQ,2020.0,1,2,-1
MEX,IND,2007.0,4,4,0
ZAF,SWZ,2019.0,9,4,5
AUT,DNK,2000.0,3,1,2
BEL,HUN,2017.0,8,6,2
ISL,NOR,2015.0,6,4,2
SAU,NOR,2017.0,1,1,0
DNK,ITA,2004.0,11,9,2
PRT,FRA,2003.0,10,32,-22
SWE,PRT,2015.0,9,13,-4
ROU,HUN,2022.0,7,1,6
BEL,COL,2019.0,7,2,5
THA,NLD,2019.0,4,12,-8
MNE,SRB,2021.0,16,6,10
JOR,BHR,2021.0,1,1,0
ROU,GBR,2018.0,12,17,-5
IND,NPL,2018.0,25,9,16
CHL,DOM,2020.0,1,1,0
BEL,LBN,2019.0,5,7,-2
CHE,COL,2005.0,1,2,-1
PHL,USA,2022.0,10,8,2
EGY,ARE,2004.0,7,6,1
PER,ARG,2020.0,5,4,1
TUR,IRL,2022.0,4,1,3
AUT,ITA,2011.0,39,31,8
DEU,THA,2007.0,8,12,-4
CAN,LKA,2004.0,2,1,1
JOR,SAU,2020.0,26,20,6
BGR,AUT,2008.0,2,1,1
IND,PAK,2022.0,22,21,1
CHN,NLD,2001.0,15,6,9
NLD,KEN,2019.0,8,6,2
RUS,ISR,2007.0,4,3,1
IRQ,USA,2007.0,3,3,0
CAN,NZL,2000.0,12,5,7
CHE,PHL,2002.0,2,3,-1
AUT,CZE,2013.0,6,10,-4
IRN,NLD,2011.0,27,14,13
ITA,SGP,2014.0,13,12,1
GRC,ESP,2014.0,14,16,-2
FIN,RUS,2016.0,25,21,4
SAU,DEU,2021.0,13,14,-1
AUS,PAK,2013.0,11,22,-11
USA,MWI,2013.0,16,7,9
KOR,ESP,2016.0,10,8,2
TUR,CZE,2021.0,5,2,3
GHA,DEU,2011.0,4,7,-3
ISR,CAN,2016.0,55,52,3
BRA,ECU,2022.0,4,2,2
DNK,CHE,2015.0,27,26,1
GHA,RUS,2020.0,2,3,-1
DEU,CYP,2019.0,4,1,3
COG,MAR,2015.0,2,1,1
USA,CYP,2015.0,6,5,1
CZE,FIN,2012.0,3,4,-1
SRB,SVK,2018.0,1,1,0
BEL,VNM,2014.0,9,4,5
CAN,BGD,2021.0,15,27,-12
MEX,DNK,2015.0,3,5,-2
IRN,ITA,2007.0,4,4,0
VNM,GBR,2008.0,3,8,-5
COL,BRA,2008.0,5,12,-7
BGD,SGP,2015.0,1,2,-1
SVK,UKR,2016.0,1,5,-4
THA,NLD,2017.0,7,8,-1
HUN,BRA,2017.0,4,1,3
PAK,NZL,2017.0,6,14,-8
PAK,ESP,2022.0,5,1,4
ISR,JPN,2004.0,7,2,5
DZA,FIN,2020.0,3,1,2
IRL,SAU,2022.0,3,2,1
PER,USA,2022.0,22,12,10
AUT,ZAF,2016.0,4,4,0
IND,CZE,2018.0,15,10,5
HUN,CHN,2006.0,2,3,-1
QAT,KOR,2012.0,1,1,0
GMB,GBR,2021.0,9,9,0
MNG,TWN,2010.0,2,1,1
DNK,BRA,2016.0,8,18,-10
SEN,ITA,2007.0,1,1,0
THA,PHL,2014.0,2,2,0
HRV,ITA,2002.0,5,5,0
ESP,PAK,2002.0,1,1,0
MUS,USA,2005.0,1,1,0
FRA,GUF,2008.0,12,9,3
CHL,VEN,2012.0,5,3,2
VEN,GBR,2014.0,2,4,-2
BGR,PRT,2003.0,3,2,1
AUS,USA,1997.0,35,47,-12
PAN,USA,2013.0,5,12,-7
ITA,TZA,2019.0,1,1,0
ISR,GBR,2000.0,10,16,-6
ESP,POL,2008.0,5,11,-6
SVK,GBR,2004.0,4,2,2
CHN,PHL,2022.0,2,2,0
DEU,CYP,2010.0,1,2,-1
CAN,KEN,2002.0,2,2,0
BRA,CHL,2000.0,4,1,3
CAN,COL,2008.0,4,7,-3
DEU,MAR,2003.0,3,2,1
POL,NZL,2011.0,2,7,-5
PRI,ESP,2007.0,3,2,1
NGA,IND,2006.0,4,1,3
CZE,CAN,2005.0,6,3,3
BIH,AUT,2015.0,3,1,2
ZMB,JPN,2001.0,2,1,1
CYP,USA,2015.0,5,6,-1
USA,LTU,2022.0,6,4,2
ISR,ESP,2012.0,2,6,-4
URY,SWE,2008.0,1,1,0
FIN,DNK,2000.0,4,2,2
GBR,MUS,2009.0,1,1,0
GAB,BEL,2012.0,2,1,1
GRC,IRL,2008.0,3,4,-1
PER,GBR,2017.0,6,7,-1
UZB,DEU,2017.0,1,5,-4
SWE,VNM,2012.0,1,1,0
CHE,SGP,2009.0,7,3,4
ECU,COL,2015.0,1,4,-3
TUR,KOR,2022.0,3,4,-1
QAT,BEL,2017.0,1,2,-1
USA,BLZ,2019.0,2,3,-1
DNK,FIN,2022.0,7,9,-2
IND,TUR,2022.0,8,2,6
CZE,BEL,2022.0,11,8,3
GBR,MWI,2010.0,9,8,1
IRN,POL,2017.0,4,1,3
CZE,AUS,2018.0,5,5,0
SRB,USA,2011.0,8,26,-18
PER,GBR,2019.0,9,5,4
DNK,BGR,2002.0,1,4,-3
TTO,NZL,2018.0,1,1,0
USA,HTI,2014.0,10,6,4
ETH,IND,2006.0,3,4,-1
GRC,ARE,2015.0,3,1,2
GNQ,GIN,2016.0,1,3,-2
KEN,CHN,2015.0,1,7,-6
BRA,IND,2017.0,12,22,-10
VNM,THA,2009.0,1,6,-5
ARG,CAN,2018.0,11,14,-3
BFA,TGO,2017.0,3,2,1
IRL,HKG,2020.0,1,1,0
BOL,CHL,2018.0,2,1,1
DZA,POL,2018.0,1,1,0
SAU,NOR,2019.0,5,3,2
QAT,ESP,2022.0,1,1,0
PHL,AUS,2021.0,9,5,4
MEX,SWE,2019.0,5,7,-2
BGD,MYS,2018.0,13,68,-55
GBR,SAU,2001.0,10,12,-2
UKR,POL,2000.0,12,3,9
BEL,PER,2015.0,2,3,-1
BEL,ARE,2014.0,2,1,1
BHR,SAU,2020.0,5,8,-3
YEM,MAR,2015.0,1,1,0
MYS,IRN,2007.0,5,8,-3
MWI,ZAF,2017.0,6,8,-2
BRA,IND,2019.0,16,19,-3
FIN,LBY,2013.0,1,1,0
TUR,SWE,2016.0,11,7,4
EGY,MYS,2015.0,7,9,-2
MYS,LKA,2013.0,4,1,3
FIN,IRL,2021.0,5,4,1
COL,BEL,2012.0,2,2,0
CHE,KOR,2014.0,6,13,-7
SHN,GBR,2017.0,1,1,0
SRB,CAN,2019.0,5,3,2
BGD,ESP,2014.0,1,1,0
URY,PER,2011.0,1,1,0
CHN,MWI,2015.0,1,3,-2
MYS,CZE,2017.0,2,2,0
DEU,AZE,2017.0,2,2,0
ZAF,EGY,2021.0,3,1,2
BRA,NGA,2022.0,6,3,3
KOR,ZAF,2014.0,2,1,1
KEN,DEU,2019.0,10,15,-5
MAR,ARE,2021.0,4,1,3
GBR,VNM,2022.0,7,4,3
QAT,ARE,2020.0,7,6,1
TZA,SWE,2018.0,4,3,1
IRL,KOR,2014.0,3,4,-1
SGP,IRL,2022.0,3,1,2
UKR,ITA,2021.0,7,4,3
NGA,BWA,2015.0,1,3,-2
TWN,MYS,2012.0,3,2,1
EST,DEU,2022.0,3,3,0
RUS,TUR,2021.0,5,4,1
IRN,SGP,2019.0,8,7,1
NZL,IDN,2021.0,5,1,4
ZAF,SWE,2021.0,8,4,4
COD,BEL,2020.0,3,9,-6
DEU,KWT,2016.0,1,1,0
NOR,UKR,2021.0,1,1,0
AUT,FIN,2005.0,6,3,3
KEN,CHE,2020.0,6,9,-3
BRB,USA,2022.0,1,1,0
DEU,UZB,2015.0,3,3,0
CRI,CAN,2014.0,2,3,-1
USA,PSE,2007.0,4,1,3
BEN,FRA,2004.0,3,4,-1
NOR,CZE,2009.0,1,2,-1
JOR,IRL,2005.0,1,1,0
AUT,NOR,2006.0,3,3,0
ZAF,IRL,2014.0,2,8,-6
CHE,CHN,2005.0,12,14,-2
NLD,MYS,2003.0,3,1,2
ITA,UZB,2008.0,1,1,0
ITA,AUT,1998.0,1,1,0
AUS,ARG,2011.0,1,5,-4
AUS,MEX,2003.0,4,2,2
NZL,IRL,2006.0,4,3,1
FIN,HUN,2003.0,2,5,-3
MEX,BRA,2002.0,1,9,-8
TWN,NOR,2012.0,2,1,1
IRN,USA,2000.0,4,3,1
BRA,ZAF,2014.0,1,1,0
EGY,AUS,2006.0,3,2,1
ESP,ROU,2015.0,2,8,-6
ITA,TZA,2010.0,1,2,-1
SWE,CHN,1999.0,5,16,-11
DNK,CHL,2010.0,1,1,0
SRB,ESP,2011.0,2,2,0
GHA,KEN,2020.0,1,5,-4
LVA,CHE,2021.0,3,2,1
FIN,LTU,2007.0,1,2,-1
USA,LUX,2022.0,3,4,-1
NOR,HRV,2020.0,1,3,-2
ESP,CHN,1998.0,3,2,1
GBR,CMR,2020.0,1,3,-2
MEX,SWE,2017.0,3,3,0
CHN,IRN,2022.0,4,18,-14
DNK,CHL,2017.0,5,3,2
KOR,ISR,2005.0,2,2,0
NPL,GBR,2015.0,4,6,-2
ZMB,USA,2018.0,7,4,3
KOR,RUS,2001.0,6,6,0
ITA,AUT,1997.0,2,1,1
SYR,USA,2006.0,1,7,-6
IRL,MYS,2016.0,8,6,2
GUM,USA,2004.0,3,2,1
UKR,SWE,2021.0,2,2,0
ARE,IRQ,2012.0,1,1,0
CAN,VNM,2014.0,4,3,1
MEX,AUS,2016.0,6,9,-3
CAN,IDN,2019.0,5,3,2
PAK,EGY,2012.0,2,1,1
COL,DEU,2003.0,3,6,-3
NLD,POL,1998.0,3,1,2
MDG,USA,2021.0,3,5,-2
HUN,HRV,2001.0,1,1,0
KOR,PRT,2010.0,3,1,2
HKG,FRA,1999.0,1,1,0
CAN,GHA,2012.0,3,3,0
ITA,MEX,2001.0,5,2,3
TUR,GRC,2005.0,1,6,-5
DEU,VNM,2009.0,8,4,4
NOR,BEL,2008.0,1,6,-5
ITA,THA,2016.0,6,3,3
IRL,POL,2002.0,1,1,0
NOR,GRC,2013.0,1,3,-2
VNM,DEU,2009.0,4,8,-4
QAT,LBY,2014.0,1,3,-2
LTU,POL,2014.0,1,2,-1
REU,FRA,2022.0,3,10,-7
NLD,ETH,2003.0,5,2,3
SWE,GRC,2004.0,3,2,1
EST,CAN,2019.0,1,2,-1
NLD,PRT,1998.0,2,1,1
DNK,ARE,2018.0,3,2,1
CAN,LBY,2015.0,2,1,1
MYS,DEU,2014.0,5,14,-9
KEN,NLD,2016.0,6,9,-3
PRT,COL,2022.0,1,3,-2
MEX,ISR,2019.0,4,3,1
BEL,COL,2010.0,1,2,-1
GRC,QAT,2020.0,6,2,4
ISR,IRL,2020.0,2,5,-3
ISL,CAN,2018.0,3,3,0
SAU,KAZ,2021.0,1,4,-3
MDA,UKR,2004.0,2,2,0
PER,GBR,2010.0,2,2,0
IDN,CAN,2012.0,2,6,-4
JPN,DNK,2006.0,7,5,2
THA,BEL,2006.0,2,3,-1
ISL,DEU,2011.0,3,7,-4
PSE,TUR,2013.0,1,4,-3
ARE,ETH,2018.0,1,1,0
HKG,NZL,2014.0,4,3,1
KOR,KEN,2014.0,2,1,1
IDN,SWE,2010.0,2,1,1
LBN,PSE,2021.0,1,1,0
ARE,KWT,2009.0,1,1,0
GTM,USA,2014.0,4,3,1
DNK,ROU,2014.0,2,3,-1
AUT,FIN,2002.0,4,2,2
UZB,ITA,2009.0,1,1,0
ARE,EGY,1999.0,2,3,-1
ECU,CHN,2018.0,3,2,1
ESP,TUR,2015.0,8,9,-1
CZE,MEX,2007.0,3,2,1
NOR,ZAF,2011.0,1,2,-1
IRN,HRV,2016.0,1,1,0
SVK,RUS,2009.0,1,6,-5
IRL,SGP,2015.0,9,1,8
HUN,ESP,2006.0,3,2,1
SEN,USA,2014.0,3,5,-2
USA,SEN,2016.0,4,5,-1
ISR,POL,2019.0,2,5,-3
HKG,ITA,2021.0,2,6,-4
KOR,IRN,2012.0,2,5,-3
JOR,EGY,2022.0,4,3,1
EGY,PRT,2013.0,2,2,0
NLD,SRB,1999.0,1,1,0
PRT,MAR,2015.0,1,1,0
IRQ,CHN,2014.0,3,3,0
KWT,SAU,2020.0,1,10,-9
OMN,SWE,2015.0,1,1,0
SGP,PRT,2019.0,3,3,0
IRN,AZE,2021.0,2,1,1
CHE,ETH,2018.0,4,9,-5
UKR,TUR,2002.0,1,5,-4
SRB,HUN,2015.0,3,2,1
HUN,FIN,2010.0,2,1,1
USA,CUB,2009.0,4,8,-4
KWT,GBR,2014.0,1,19,-18
HRV,CHE,2018.0,5,7,-2
PRT,PER,2015.0,3,1,2
TZA,DEU,2018.0,3,3,0
AUT,SVK,2022.0,2,3,-1
HKG,NLD,2013.0,1,4,-3
USA,PLW,2004.0,3,1,2
FRO,DNK,2015.0,2,1,1
NOR,TZA,2007.0,2,5,-3
PRT,ROU,2005.0,3,1,2
DEU,EST,2001.0,2,2,0
MEX,BRA,2005.0,3,12,-9
MEX,PER,2009.0,3,2,1
NLD,EST,2013.0,2,1,1
UZB,BRA,2008.0,1,1,0
VEN,CAN,2002.0,2,4,-2
IND,DNK,2006.0,3,3,0
THA,NLD,2010.0,7,5,2
USA,BLR,2009.0,2,3,-1
BEL,IRL,2007.0,3,4,-1
CHN,VNM,2010.0,3,1,2
BGR,CHE,2014.0,2,2,0
FIN,JOR,2010.0,1,1,0
TUR,FRA,2012.0,11,17,-6
SAU,IRQ,2016.0,1,2,-1
MYS,DNK,2012.0,2,1,1
MYS,AUS,1999.0,2,1,1
PAK,AUT,2021.0,2,3,-1
LSO,GBR,2008.0,1,1,0
UKR,BEL,2009.0,1,2,-1
IRN,MYS,2006.0,2,2,0
SRB,CAN,2010.0,3,3,0
DNK,HKG,2011.0,2,1,1
AUS,PRT,2015.0,3,16,-13
BWA,USA,2003.0,2,8,-6
LKA,IND,2021.0,1,2,-1
DEU,TUR,1998.0,1,2,-1
FRA,ARM,2001.0,1,5,-4
USA,SYR,2011.0,3,2,1
UGA,CHE,2014.0,2,1,1
FIN,ROU,2005.0,2,1,1
CHE,ZAF,2002.0,3,6,-3
JPN,SDN,2012.0,2,1,1
IND,ETH,2003.0,3,2,1
ZAF,NOR,2001.0,3,4,-1
SAU,POL,2009.0,1,1,0
OMN,LKA,2017.0,1,1,0
POL,CHN,2003.0,2,3,-1
DEU,ALB,2010.0,2,1,1
AZE,TWN,2015.0,1,1,0
HUN,ROU,2004.0,1,5,-4
DEU,CYP,2017.0,2,7,-5
ITA,BIH,2009.0,1,1,0
ROU,CHN,2019.0,1,1,0
MKD,USA,2012.0,1,4,-3
PRT,ROU,2002.0,1,1,0
VNM,POL,2013.0,2,2,0
KWT,PAK,2015.0,3,2,1
EST,JPN,2020.0,2,2,0
ZWE,NLD,2003.0,1,1,0
NLD,HRV,2014.0,2,5,-3
NZL,TUR,2010.0,1,1,0
SAU,BEL,2011.0,1,2,-1
CUB,RUS,2014.0,1,1,0
IRL,ZAF,2022.0,3,5,-2
MKD,BGR,2018.0,5,2,3
OMN,KOR,2020.0,1,2,-1
USA,BMU,2014.0,1,3,-2
LKA,HKG,2011.0,3,1,2
PRT,PAK,2019.0,1,3,-2
FRA,EST,2017.0,2,6,-4
FRA,KHM,2015.0,3,5,-2
PER,DEU,2016.0,1,6,-5
HND,USA,2022.0,1,1,0
ITA,ZAF,2018.0,3,5,-2
THA,BGD,2022.0,2,3,-1
GRC,NOR,2022.0,1,3,-2
LKA,CHN,2016.0,1,6,-5
MEX,POL,2010.0,3,3,0
LUX,BEL,2006.0,3,9,-6
PAK,MYS,2005.0,1,2,-1
MYS,THA,2003.0,1,1,0
CUB,BEL,2015.0,2,1,1
MNG,USA,2016.0,1,5,-4
LUX,CHE,2007.0,1,1,0
ZAF,FIN,2014.0,1,4,-3
HRV,IRL,2016.0,2,3,-1
UGA,NGA,2013.0,3,2,1
CMR,GBR,2001.0,1,1,0
PAK,FIN,2022.0,2,2,0
CYP,ITA,2022.0,2,1,1
POL,CAN,1997.0,2,5,-3
FJI,USA,2001.0,1,1,0
ZAF,SWZ,2010.0,2,2,0
TJK,RUS,2007.0,1,1,0
ISR,TUR,2015.0,1,1,0
TGO,GBR,2020.0,1,1,0
LKA,USA,2002.0,2,3,-1
AUS,ESP,1998.0,2,3,-1
COG,SEN,2020.0,1,1,0
PHL,FRA,2016.0,4,2,2
BHR,GBR,2014.0,1,5,-4
FRA,EST,2019.0,1,1,0
ETH,ZAF,2007.0,1,3,-2
FRA,ECU,2013.0,4,2,2
HUN,FIN,2017.0,2,1,1
IDN,GBR,2011.0,2,8,-6
CHN,KEN,2016.0,3,3,0
HUN,AZE,2020.0,1,1,0
ISR,POL,2017.0,1,6,-5
NLD,SVK,2013.0,1,1,0
TTO,CAN,2021.0,2,1,1
VNM,ESP,2021.0,1,2,-1
KOR,KWT,2020.0,1,1,0
CHE,SVN,2020.0,3,2,1
AUT,UKR,2018.0,2,4,-2
NOR,HUN,2011.0,1,4,-3
COL,PRI,2016.0,1,3,-2
FRA,BOL,2020.0,1,2,-1
LTU,FIN,2009.0,1,1,0
CHL,JPN,2003.0,1,2,-1
EGY,OMN,2020.0,2,3,-1
TUR,ISR,2015.0,1,1,0
IRQ,DNK,2022.0,1,1,0
DNK,SGP,2019.0,4,9,-5
SVN,IND,2022.0,1,1,0
RUS,GRC,2016.0,1,2,-1
PRT,PAK,2017.0,2,1,1
MYS,CZE,2019.0,2,1,1
HUN,SVK,2005.0,1,1,0
CZE,UKR,2008.0,3,2,1
SGP,OMN,2012.0,1,2,-1
ITA,MCO,2017.0,1,1,0
VEN,CAN,2005.0,2,1,1
GBR,PAN,2012.0,1,1,0
PAK,ARE,2007.0,1,1,0
ESP,BGR,2014.0,1,2,-1
MEX,SWE,2010.0,1,3,-2
NPL,CAN,2016.0,1,1,0
CIV,MLI,2012.0,1,2,-1
MYS,SGP,1999.0,1,1,0
CAN,SRB,2015.0,2,1,1
BLR,ESP,2001.0,1,2,-1
FRO,NOR,2020.0,1,1,0
SEN,ZAF,2019.0,1,1,0
MDA,DEU,2005.0,1,1,0
ISR,MEX,2008.0,1,1,0
MLT,GBR,2000.0,1,3,-2
GRC,NZL,2015.0,1,2,-1
MLI,BFA,2010.0,1,1,0
DZA,ITA,2008.0,2,1,1
TUR,IRN,2009.0,1,6,-5
MLI,BFA,2019.0,1,1,0
CHL,ITA,2002.0,2,1,1
SGP,PRT,2017.0,2,1,1
BOL,DEU,2013.0,1,1,0
FRA,GAB,2021.0,1,2,-1
CYP,CAN,2021.0,1,3,-2
HND,ITA,2021.0,1,1,0
CHN,THA,2007.0,1,2,-1
GBR,VEN,1999.0,1,1,0
MKD,GBR,2015.0,1,1,0
ITA,LVA,2010.0,1,1,0
HUN,BRA,2019.0,1,1,0
DNK,HUN,2022.0,2,2,0
SVN,ROU,2006.0,1,2,-1
HUN,MEX,2021.0,1,3,-2
VNM,RUS,2005.0,1,1,0
ZAF,JPN,2006.0,1,1,0
PER,SWE,2018.0,2,1,1
USA,FSM,2004.0,1,1,0
LVA,AUT,2010.0,2,1,1
CHE,KAZ,2020.0,1,1,0
PRT,SVK,2014.0,1,1,0
KEN,JPN,2001.0,1,2,-1
SRB,MNE,2005.0,1,1,0
EST,CAN,2017.0,1,1,0
BRN,PAK,2019.0,3,2,1
AUS,URY,2021.0,1,1,0
LVA,LTU,2012.0,1,1,0
BLR,NLD,2008.0,1,1,0
VEN,PAN,2015.0,1,1,0
GBR,NER,2017.0,2,1,1
AUS,LAO,2019.0,1,2,-1
BRA,GBR,1997.0,2,10,-8
SVN,CAN,2022.0,1,1,0
DNK,CHL,2019.0,1,3,-2
SVN,MKD,2014.0,1,1,0
CHN,KHM,2011.0,1,1,0
PAK,POL,2013.0,1,2,-1
MDG,DEU,2011.0,1,1,0
AUT,CUB,2017.0,1,2,-1
IRL,AUT,2003.0,1,3,-2
IRN,THA,2013.0,1,1,0
PAK,KEN,2021.0,1,8,-7
CHL,SWE,1997.0,1,1,0
KOR,LAO,2016.0,1,1,0
SRB,POL,2014.0,1,9,-8
FIN,ARE,2018.0,1,1,0
BIH,USA,2014.0,1,1,0
IND,GBR,2012.0,138,132,6
USA,BRA,2009.0,258,366,-108
FRA,CHE,2014.0,329,203,126
IND,ISR,2010.0,22,14,8
FIN,USA,2019.0,71,86,-15
ITA,ROU,2012.0,5,11,-6
GBR,GRC,2006.0,142,84,58
JPN,FIN,2012.0,9,5,4
GRC,USA,2006.0,73,105,-32
DEU,GRC,2007.0,40,45,-5
BEL,DEU,2018.0,117,99,18
RUS,MEX,2005.0,11,2,9
DEU,MYS,2014.0,14,5,9
JPN,THA,2016.0,88,79,9
DEU,ITA,2016.0,176,296,-120
ITA,ARG,2016.0,28,16,12
USA,NLD,2022.0,149,134,15
DEU,ISR,1998.0,14,10,4
SWE,AUS,2018.0,49,57,-8
CHN,MAC,2014.0,38,25,13
CZE,USA,2016.0,44,50,-6
TWN,VNM,2016.0,35,4,31
CUB,USA,2018.0,14,8,6
CAN,IRN,2021.0,37,270,-233
FIN,USA,2017.0,90,63,27
CHN,POL,2012.0,18,2,16
DZA,CAN,2012.0,3,2,1
IND,NZL,2018.0,20,10,10
FRA,TWN,2007.0,8,2,6
BRA,ESP,2016.0,61,117,-56
FRA,VNM,2020.0,64,27,37
SGP,IND,2014.0,50,82,-32
KOR,THA,2018.0,11,10,1
CUB,DEU,2015.0,2,2,0
CHE,DNK,2021.0,31,37,-6
ITA,FRA,2000.0,57,90,-33
CAN,IND,2011.0,59,119,-60
DEU,EGY,2009.0,28,25,3
PRT,DNK,2018.0,11,4,7
ISL,SWE,2016.0,12,15,-3
ROU,DEU,2013.0,25,18,7
USA,UGA,2012.0,20,23,-3
BRA,CHN,2014.0,6,3,3
ITA,JPN,1999.0,9,14,-5
BGR,CZE,2012.0,1,1,0
IRL,DEU,2021.0,23,27,-4
BGD,JPN,2013.0,38,64,-26
PAN,CAN,2019.0,1,1,0
IRN,POL,2019.0,12,2,10
USA,KEN,2021.0,27,33,-6
FRA,MAR,1998.0,19,3,16
IRQ,IRN,2021.0,2,15,-13
IDN,CHN,2020.0,7,7,0
UGA,GHA,2019.0,2,2,0
SWE,UKR,2016.0,6,8,-2
USA,EST,2011.0,5,5,0
CZE,FRA,2003.0,16,16,0
SRB,CAN,2017.0,6,3,3
AUS,IRL,2004.0,23,12,11
FIN,ITA,2001.0,8,6,2
SWE,VEN,2004.0,1,1,0
AUS,ITA,2015.0,31,56,-25
USA,COL,2004.0,24,25,-1
SAU,OMN,2012.0,6,2,4
SWE,HUN,2000.0,5,10,-5
TWN,POL,2016.0,2,1,1
ZAF,PRT,2019.0,1,1,0
MYS,GBR,2005.0,19,42,-23
DEU,NGA,2009.0,7,3,4
GLP,FRA,2002.0,12,6,6
CHE,TZA,2014.0,3,4,-1
DZA,SAU,2020.0,6,5,1
CAN,IRL,2017.0,31,38,-7
CZE,AUT,2008.0,6,5,1
AUT,PAK,2015.0,19,3,16
MLI,FRA,2018.0,3,3,0
TUR,NLD,2007.0,9,3,6
AUT,BIH,2013.0,4,1,3
JPN,TUN,2015.0,6,1,5
BEL,AUT,2020.0,15,14,1
LUX,DEU,2014.0,12,37,-25
IRN,SGP,2017.0,9,5,4
BTN,PNG,2016.0,1,1,0
DNK,RUS,2013.0,4,6,-2
NOR,IRL,2020.0,3,3,0
ROU,ITA,2013.0,14,10,4
MNG,TWN,2017.0,2,3,-1
USA,BWA,2022.0,6,5,1
BLR,USA,2019.0,4,1,3
COL,CHL,2012.0,10,11,-1
RUS,BLR,2002.0,30,8,22
RUS,UKR,2019.0,38,88,-50
NLD,ISR,2005.0,8,9,-1
TUR,DEU,2003.0,17,15,2
NLD,KEN,2017.0,5,4,1
KWT,USA,2012.0,4,12,-8
BEL,BOL,2018.0,2,1,1
IND,SYR,2005.0,1,1,0
DEU,HUN,1999.0,19,22,-3
AUT,IDN,2014.0,3,1,2
HKG,IRL,2014.0,2,3,-1
BEL,HUN,2010.0,3,3,0
POL,JPN,2012.0,5,40,-35
CYP,GBR,2008.0,6,14,-8
GEO,USA,1999.0,4,1,3
AUT,SWE,2002.0,9,5,4
DEU,IRN,2001.0,4,5,-1
MEX,CUB,2002.0,16,18,-2
CHE,ZAF,2005.0,5,9,-4
NOR,MWI,2015.0,2,3,-1
MYS,IDN,2004.0,2,1,1
KOR,PHL,2012.0,9,2,7
AUS,KOR,2011.0,17,26,-9
IDN,DEU,2015.0,7,23,-16
BRN,PAK,2017.0,1,1,0
MYS,IRL,2016.0,6,8,-2
BEL,BRA,2002.0,11,5,6
FRA,SYC,2015.0,3,1,2
GLP,FRA,2005.0,9,11,-2
CHE,SRB,2006.0,3,1,2
FIN,CHE,2021.0,9,14,-5
CUB,VEN,2020.0,2,1,1
IRL,RUS,2013.0,4,3,1
USA,GTM,2001.0,1,2,-1
JOR,JPN,2011.0,2,1,1
GBR,LTU,2008.0,3,1,2
RUS,ARM,2006.0,3,2,1
DEU,KEN,2008.0,5,4,1
BEL,EST,2016.0,1,3,-2
NLD,THA,2016.0,8,6,2
IND,HUN,2010.0,4,1,3
AUT,SWE,2005.0,3,9,-6
NLD,KEN,2010.0,4,4,0
RUS,DNK,2001.0,5,2,3
LKA,MYS,2011.0,1,1,0
SRB,BEL,2013.0,3,5,-2
TZA,PAK,2022.0,2,6,-4
IRL,BRA,2018.0,4,13,-9
CHE,POL,2009.0,6,13,-7
BRA,GRC,2013.0,2,1,1
ITA,SRB,2018.0,5,3,2
ARE,KAZ,2019.0,2,2,0
MEX,POL,2017.0,1,3,-2
ETH,GBR,2021.0,5,3,2
AUS,SVN,2017.0,2,2,0
JOR,MYS,2022.0,3,10,-7
RUS,SVK,2004.0,3,1,2
IND,HUN,2017.0,5,1,4
AUS,TZA,2012.0,1,1,0
SVK,USA,1997.0,4,4,0
USA,OMN,2016.0,11,6,5
SWE,TZA,2008.0,3,2,1
CAN,KEN,2005.0,2,1,1
AUT,SVN,1999.0,2,2,0
OMN,IRL,2020.0,1,1,0
FRA,CAF,2002.0,1,1,0
ZAF,ETH,2004.0,1,5,-4
AUT,ROU,2008.0,1,3,-2
QAT,EGY,2009.0,2,5,-3
CHL,ITA,2005.0,1,4,-3
DEU,BLR,2000.0,4,9,-5
AUT,HRV,2007.0,3,3,0
MOZ,AUS,2019.0,1,1,0
BGD,HKG,2006.0,1,1,0
BRA,URY,2007.0,2,3,-1
PSE,SAU,2014.0,3,3,0
DOM,CHL,2020.0,1,1,0
SWE,COL,2011.0,2,2,0
DEU,BFA,2007.0,1,1,0
SWE,NGA,2015.0,1,1,0
UGA,ETH,2020.0,1,2,-1
ZAF,PRT,2017.0,1,4,-3
BRA,IND,2010.0,2,11,-9
BLR,USA,2010.0,1,3,-2
ITA,UKR,2009.0,1,4,-3
CHL,NLD,2006.0,1,3,-2
,AUT,2000.0,2313,0,2313
USA,,2024.0,551174,0,551174
,NOR,2009.0,1906,0,1906
HUN,,2022.0,3067,0,3067
CZE,,2013.0,1189,0,1189
ARE,,2024.0,4056,0,4056
TWN,,2013.0,4757,0,4757
ARG,,2023.0,11786,0,11786
BRA,,2019.0,16310,0,16310
BRA,,2017.0,11742,0,11742
BRA,,2010.0,4293,0,4293
,BEL,1998.0,4654,0,4654
BEL,,2016.0,2528,0,2528
,GUY,2009.0,6,0,6
SAU,,2022.0,3513,0,3513
ZAF,,2009.0,580,0,580
,JOR,2006.0,445,0,445
,CAN,2009.0,11698,0,11698
,ROU,1995.0,633,0,633
NLD,,2007.0,2065,0,2065
,NLD,2001.0,5530,0,5530
,BEL,1997.0,1180,0,1180
PAK,,2009.0,313,0,313
,POL,1999.0,6799,0,6799
TZA,,2015.0,77,0,77
,SEN,2004.0,89,0,89
BGR,,2015.0,339,0,339
,PSE,2003.0,31,0,31
LVA,GBR,2011.0,2,0,2
HRV,,2016.0,635,0,635
,HRV,1994.0,571,0,571
PER,,2022.0,1063,0,1063
THA,KOR,2008.0,5,0,5
,SWE,2007.0,3400,0,3400
CMR,,2016.0,110,0,110
,MYS,2008.0,3590,0,3590
SVK,,1999.0,17,0,17
CUB,,2013.0,651,0,651
,NER,2002.0,16,0,16
NER,,2022.0,70,0,70
GLP,,2011.0,4,0,4
,IRL,2013.0,1632,0,1632
ESP,,1999.0,201,0,201
,FRA,2013.0,14454,0,14454
,CHL,2014.0,2171,0,2171
DNK,SRB,2020.0,2,0,2
,MLI,2010.0,46,0,46
,ZAF,2012.0,2602,0,2602
,UKR,2006.0,1208,0,1208
,TUN,2010.0,1109,0,1109
,IDN,2001.0,232,0,232
,CIV,2008.0,125,0,125
,CMR,2011.0,270,0,270
,NGA,2011.0,1527,0,1527
,PAK,1994.0,229,0,229
IRN,,2004.0,81,0,81
,SRB,2015.0,1050,0,1050
,TUN,2017.0,1090,0,1090
,IRQ,2011.0,395,0,395
PAN,,2018.0,33,0,33
DZA,,2007.0,49,0,49
,CUB,2006.0,663,0,663
URY,BEL,2016.0,1,0,1
,ETH,2009.0,297,0,297
LBN,DNK,2020.0,1,0,1
STP,,2022.0,2,0,2
,BFA,2009.0,95,0,95
,KAZ,1998.0,94,0,94
,BGR,2014.0,497,0,497
SWZ,BWA,2021.0,1,0,1
DOM,,2020.0,21,0,21
CMR,KOR,2008.0,1,0,1
SLV,,2018.0,11,0,11
ROU,NOR,2020.0,1,0,1
,ECU,2016.0,779,0,779
THA,CZE,2021.0,1,0,1
ECU,,2020.0,357,0,357
,NPL,2015.0,372,0,372
NZL,,2003.0,149,0,149
BWA,,2012.0,29,0,29
TTO,SLV,2017.0,1,0,1
KAZ,SAU,2016.0,2,0,2
,SYR,2015.0,89,0,89
NOR,VNM,2018.0,3,0,3
GMB,,2020.0,13,0,13
,TUN,2019.0,529,0,529
BEL,CMR,2021.0,3,0,3
,CRI,2016.0,145,0,145
CUB,FRA,2020.0,4,0,4
,GEO,2018.0,81,0,81
,MLI,2017.0,37,0,37
ECU,ISR,2020.0,1,0,1
,BMU,2014.0,3,0,3
,MDG,2017.0,62,0,62
,QAT,2001.0,58,0,58
MYS,CHE,2005.0,3,0,3
,MLT,2012.0,84,0,84
,MWI,2016.0,108,0,108
,PAN,2018.0,53,0,53
CAF,MDG,2018.0,1,0,1
FSM,,2014.0,3,0,3
,ZWE,2006.0,90,0,90
AZE,,2016.0,92,0,92
MAR,,2008.0,162,0,162
,GAB,1995.0,7,0,7
NZL,MAC,2010.0,1,0,1
LVA,,2013.0,64,0,64
KOR,DNK,2013.0,4,0,4
NPL,,2007.0,33,0,33
NLD,POL,1997.0,4,0,4
NZL,PER,2020.0,1,0,1
,MDG,2019.0,50,0,50
ESP,GHA,2021.0,1,0,1
,MUS,2003.0,15,0,15
FRA,MAC,2018.0,1,0,1
CUW,,2022.0,1,0,1
PYF,,2023.0,49,0,49
CRI,NOR,2019.0,1,0,1
LUX,DNK,2005.0,1,0,1
DEU,LUX,1998.0,1,0,1
,FJI,2006.0,20,0,20
SVN,QAT,2017.0,1,0,1
,NCL,2003.0,25,0,25
BEN,ZAF,2021.0,1,0,1
BLR,,2003.0,91,0,91
UZB,,2006.0,50,0,50
,KAZ,1997.0,40,0,40
CMR,MWI,2017.0,1,0,1
CAN,IDN,2010.0,3,0,3
,MDG,2010.0,55,0,55
SWZ,,2012.0,8,0,8
FIN,KWT,2011.0,1,0,1
PRY,,2015.0,11,0,11
PRI,IRL,2010.0,1,0,1
,PNG,2007.0,16,0,16
,BEN,1999.0,18,0,18
LTU,,2001.0,17,0,17
SEN,BEN,2018.0,2,0,2
CYP,DEU,2011.0,3,0,3
PRI,CAN,2003.0,1,0,1
,COM,2001.0,1,0,1
,SEN,1996.0,80,0,80
IND,SDN,2011.0,2,0,2
HRV,BIH,2000.0,1,0,1
ETH,ITA,2003.0,2,0,2
NLD,KWT,2004.0,1,0,1
SGP,,2001.0,27,0,27
PAK,NZL,2010.0,3,0,3
PRI,,2000.0,4,0,4
GUM,,2021.0,5,0,5
TUR,SRB,2006.0,4,0,4
UKR,IND,2006.0,1,0,1
IND,IRN,1997.0,1,0,1
LVA,ITA,2005.0,2,0,2
MEX,HND,2004.0,2,0,2
UGA,,2003.0,7,0,7
ETH,NLD,2004.0,1,0,1
SWE,ROU,2008.0,3,0,3
IRL,PSE,2019.0,1,0,1
CHL,BOL,2015.0,4,0,4
DEU,GMB,2003.0,2,0,2
,NER,2005.0,23,0,23
MAR,NLD,2020.0,1,0,1
MYS,QAT,2012.0,4,0,4
,KGZ,2007.0,20,0,20
POL,ZAF,2006.0,2,0,2
ZWE,CHE,2020.0,4,0,4
CHE,DZA,2018.0,3,0,3
HUN,SEN,2018.0,3,0,3
BHR,RUS,2016.0,1,0,1
NOR,SAU,2014.0,4,0,4
ARE,CMR,2019.0,1,0,1
MOZ,CUB,2015.0,1,0,1
PRY,TZA,2016.0,1,0,1
IDN,TLS,2014.0,1,0,1
NOR,SDN,2016.0,2,0,2
,JAM,2011.0,28,0,28
PRT,STP,2015.0,2,0,2
SYR,LBN,2019.0,2,0,2
KAZ,DEU,2013.0,3,0,3
EST,HUN,2011.0,1,0,1
NER,BEN,2001.0,2,0,2
GRC,PSE,2013.0,2,0,2
GHA,AUS,2013.0,3,0,3
,GUF,2012.0,14,0,14
BEL,MNE,2014.0,1,0,1
KEN,MLI,2015.0,1,0,1
EST,CZE,2019.0,4,0,4
CHL,IRL,2018.0,2,0,2
TUR,MEX,2015.0,1,0,1
BDI,,2024.0,29,0,29
VEN,ISR,2002.0,3,0,3
AGO,,2008.0,1,0,1
SWE,IDN,2009.0,2,0,2
IRL,MWI,2008.0,1,0,1
KWT,NZL,2018.0,2,0,2
IND,BWA,2000.0,1,0,1
BRB,,2020.0,14,0,14
,GNQ,2016.0,6,0,6
NER,MLI,2021.0,1,0,1
MOZ,GBR,2012.0,1,0,1
BHS,,2012.0,2,0,2
BGR,QAT,2017.0,1,0,1
SVK,SLV,2009.0,3,0,3
CAN,IDN,2017.0,5,0,5
GBR,ETH,2004.0,11,0,11
CHE,COL,2002.0,3,0,3
VNM,COL,2010.0,1,0,1
IND,ROU,2018.0,2,0,2
ITA,ECU,2003.0,2,0,2
ARG,IRL,2006.0,2,0,2
PRT,CRI,2012.0,1,0,1
UGA,RWA,2011.0,3,0,3
MDA,DEU,2002.0,3,0,3
CAN,UGA,2007.0,3,0,3
SYC,NLD,2017.0,1,0,1
JOR,SYR,2005.0,1,0,1
POL,MAR,2014.0,2,0,2
LUX,USA,2007.0,2,0,2
DZA,EGY,2013.0,1,0,1
NLD,COD,2020.0,1,0,1
VEN,HUN,2002.0,1,0,1
ZWE,ZAF,2004.0,7,0,7
GBR,GEO,2003.0,2,0,2
ARG,NZL,2020.0,3,0,3
GBR,URY,2012.0,3,0,3
HND,GTM,2011.0,1,0,1
AUS,LIE,2010.0,1,0,1
LIE,,2013.0,6,0,6
LTU,LVA,2009.0,2,0,2
PRY,CHL,2009.0,1,0,1
SEN,NCL,2018.0,1,0,1
MAR,GAB,2018.0,2,0,2
HUN,NZL,2009.0,4,0,4
IRN,CYP,2015.0,1,0,1
GBR,PRI,2006.0,4,0,4
GBR,BOL,2007.0,1,0,1
AZE,GBR,2012.0,1,0,1
TUR,QAT,2008.0,1,0,1
LTU,CHE,2007.0,1,0,1
HKG,CZE,2022.0,1,0,1
GBR,BFA,2012.0,1,0,1
SLE,TWN,2020.0,1,0,1
MYS,BHR,2000.0,1,0,1
ESP,PRI,2001.0,1,0,1
CAN,EST,2000.0,1,0,1
MAC,FIN,2016.0,1,0,1
DNK,UGA,2012.0,1,0,1
KOR,CZE,2022.0,2,0,2
ECU,HUN,2021.0,1,0,1
POL,GRC,2007.0,2,0,2
CAF,,2009.0,1,0,1
,BHR,1995.0,12,0,12
ARG,PRT,2004.0,4,0,4
SEN,ZAF,2017.0,3,0,3
AUS,GUF,2021.0,1,0,1
CAN,KAZ,2015.0,3,0,3
CHE,CYP,2014.0,2,0,2
BFA,NGA,2015.0,2,0,2
KOR,IRQ,2019.0,1,0,1
NOR,ETH,2014.0,1,0,1
CHN,BEN,2018.0,1,0,1
CAN,SVN,2015.0,2,0,2
ARE,CHN,2002.0,2,0,2
JPN,GHA,2006.0,2,0,2
EGY,BRA,2015.0,1,0,1
GRD,,2015.0,8,0,8
IRN,SGP,2010.0,9,0,9
,GIN,2009.0,5,0,5
,GRL,2006.0,3,0,3
FIN,VNM,2014.0,1,0,1
GBR,MLT,1998.0,2,0,2
TCD,,2016.0,4,0,4
CAN,BMU,2012.0,1,0,1
MEX,SVN,2008.0,1,0,1
KEN,ECU,2021.0,1,0,1
IND,BRN,2008.0,1,0,1
IRQ,JOR,2003.0,1,0,1
SRB,IND,2020.0,1,0,1
CPV,,2020.0,5,0,5
GRC,MDG,2005.0,1,0,1
ZWE,ITA,2019.0,2,0,2
PAK,BRA,2007.0,2,0,2
IND,ZWE,2003.0,3,0,3
TJK,,2011.0,3,0,3
BGR,TUR,2004.0,1,0,1
TUR,TTO,2008.0,1,0,1
MAR,USA,2000.0,2,0,2
BGR,MKD,2012.0,2,0,2
IND,GRD,2013.0,2,0,2
AUT,VNM,2004.0,1,0,1
RUS,ECU,2015.0,1,0,1
POL,CAN,1998.0,3,0,3
UKR,FIN,2009.0,2,0,2
IRQ,SWE,2015.0,3,0,3
CAN,BHR,1999.0,1,0,1
TUR,BEL,1999.0,1,0,1
PHL,SGP,2004.0,2,0,2
UKR,KOR,2011.0,3,0,3
CHL,PRY,2006.0,1,0,1
ISR,AZE,2017.0,1,0,1
CHL,PER,2012.0,1,0,1
CAN,JAM,2008.0,2,0,2
UKR,TUR,2005.0,1,0,1
NLD,PRT,1997.0,1,0,1
BLR,GBR,2014.0,2,0,2
,NIC,1996.0,2,0,2
ZAF,BHR,2008.0,1,0,1
GRC,IRQ,2013.0,1,0,1
,NIC,2004.0,14,0,14
SDN,EGY,2011.0,3,0,3
,GUM,2010.0,3,0,3
KAZ,BLR,2019.0,1,0,1
HUN,FIN,2019.0,1,0,1
DEU,AZE,2019.0,1,0,1
ESP,MOZ,2022.0,1,0,1
CUB,FIN,2020.0,1,0,1
GRC,EGY,2021.0,1,0,1
POL,TTO,2018.0,1,0,1
JPN,LBY,2012.0,1,0,1
AUS,IRN,2000.0,4,0,4
NOR,ARE,2015.0,2,0,2
CIV,BWA,2006.0,1,0,1
BRN,,2007.0,3,0,3
GBR,RWA,2003.0,1,0,1
NLD,LVA,2020.0,2,0,2
BEL,KAZ,2020.0,2,0,2
SLB,,2016.0,1,0,1
RWA,SAU,2020.0,2,0,2
QAT,RUS,2020.0,1,0,1
KEN,TON,2018.0,1,0,1
BRN,AUS,2000.0,1,0,1
,LIE,1994.0,4,0,4
PAN,FRA,2021.0,1,0,1
ZWE,SWZ,2021.0,1,0,1
NGA,NAM,2019.0,1,0,1
GTM,,2006.0,2,0,2
ARG,FIN,2012.0,1,0,1
ARG,AUS,2005.0,1,0,1
NLD,MEX,2000.0,2,0,2
CAN,LBN,1999.0,2,0,2
,TLS,2005.0,2,0,2
COL,PAN,2007.0,1,0,1
USA,BEN,2007.0,1,0,1
AUS,MWI,2013.0,1,0,1
IRL,VEN,2004.0,1,0,1
VNM,TWN,2006.0,1,0,1
HKG,LTU,2017.0,1,0,1
TZA,TWN,2005.0,1,0,1
JPN,SVN,2012.0,1,0,1
,CAF,2006.0,5,0,5
PYF,USA,2013.0,1,0,1
RUS,EGY,2006.0,2,0,2
NZL,COG,2005.0,1,0,1
,LAO,1995.0,2,0,2
ARG,DNK,2020.0,8,0,8
PHL,MEX,2016.0,2,0,2
CHN,CRI,2019.0,1,0,1
COL,HUN,2021.0,1,0,1
BEN,BRA,2020.0,1,0,1
SAU,FJI,2019.0,1,0,1
KAZ,NLD,2007.0,1,0,1
NZL,OMN,1997.0,1,0,1
SVK,QAT,2018.0,1,0,1
HTI,TZA,2009.0,1,0,1
GBR,BRN,2009.0,4,0,4
LBR,BGD,2020.0,1,0,1
LSO,CHE,2013.0,2,0,2
IRL,ARE,2014.0,4,0,4
MNE,NOR,2013.0,1,0,1
BLR,ITA,2008.0,2,0,2
GBR,BHS,2007.0,1,0,1
COL,KEN,2003.0,1,0,1
CZE,QAT,2002.0,1,0,1
GBR,KAZ,2011.0,1,0,1
FRO,,2008.0,1,0,1
CHL,ECU,2006.0,2,0,2
FRA,AZE,2014.0,1,0,1
EST,CZE,2017.0,1,0,1
IDN,BRN,2019.0,1,0,1
DEU,PAN,2014.0,1,0,1
THA,OMN,2015.0,2,0,2
VEN,SWE,2020.0,1,0,1
POL,BLR,2003.0,4,0,4
MOZ,AUS,2017.0,1,0,1
CHN,DNK,1998.0,2,0,2
GRC,LIE,2016.0,1,0,1
ARG,MLT,2020.0,1,0,1
ALB,DEU,2020.0,2,0,2
NOR,ECU,2015.0,1,0,1
GBR,ZMB,1998.0,1,0,1
UZB,DEU,2010.0,3,0,3
FIN,ETH,2020.0,1,0,1
MNG,RUS,2005.0,2,0,2
MEX,ISR,2010.0,1,0,1
SMR,ITA,1998.0,1,0,1
FIN,TTO,2003.0,1,0,1
COL,UGA,2003.0,1,0,1
KAZ,TUR,2005.0,1,0,1
IRQ,BEL,2010.0,1,0,1
BLR,CZE,2017.0,1,0,1
HRV,ZAF,2001.0,1,0,1
IND,OMN,2001.0,4,0,4
ESP,CHN,1997.0,1,0,1
ROU,CHN,2010.0,3,0,3
UKR,VNM,2018.0,1,0,1
HKG,QAT,2019.0,2,0,2
ESP,HND,2002.0,1,0,1
AUT,EST,2008.0,1,0,1
MAC,AUS,2003.0,1,0,1
ZMB,ZWE,2013.0,1,0,1
POL,MEX,2006.0,1,0,1
HUN,SGP,2011.0,1,0,1
THA,ZAF,2015.0,1,0,1
POL,MOZ,2012.0,1,0,1
IND,PNG,2009.0,1,0,1
GIB,,2014.0,2,0,2
NOR,IRN,2000.0,1,0,1
MNE,SVN,2014.0,2,0,2
AUT,BHR,2011.0,1,0,1
FJI,CHE,2021.0,1,0,1
ITA,LBY,2008.0,1,0,1
ARG,SVN,2009.0,2,0,2
EST,RUS,2007.0,1,0,1
PER,CRI,2020.0,1,0,1
USA,BLZ,2017.0,3,0,3
USA,GAB,1999.0,1,0,1
BEL,SVN,2002.0,3,0,3
JPN,SAU,2000.0,4,0,4
SWE,LBN,2002.0,1,0,1
GUF,FRA,1999.0,2,0,2
IRL,KAZ,2021.0,2,0,2
BEN,CHN,2020.0,2,0,2
AUS,JAM,2020.0,1,0,1
TUN,MAR,1997.0,1,0,1
,ERI,2013.0,5,0,5
ZAF,COG,2015.0,4,0,4
FRA,CAF,2005.0,6,0,6
TTO,FRA,2011.0,1,0,1
BLR,FRA,2015.0,2,0,2
LUX,NOR,2005.0,1,0,1
KOR,HKG,1998.0,1,0,1
RUS,NZL,2008.0,1,0,1
SRB,DNK,2019.0,1,0,1
,SLE,2004.0,3,0,3
MLT,EGY,2007.0,1,0,1
JAM,TUN,2010.0,1,0,1
MYS,ETH,2021.0,2,0,2
SYR,AUT,2015.0,1,0,1
NLD,ALB,2013.0,1,0,1
ETH,KOR,2011.0,1,0,1
LVA,AUT,2017.0,1,0,1
EGY,SVK,2008.0,1,0,1
QAT,BHR,2018.0,1,0,1
GMB,CHN,2020.0,1,0,1
AUS,PER,2008.0,1,0,1
IND,ARE,2001.0,2,0,2
,MLI,2019.0,31,0,31
SGP,UKR,2015.0,1,0,1
NLD,SDN,2003.0,1,0,1
DNK,BWA,2015.0,1,0,1
MAR,PRT,2012.0,2,0,2
NLD,CYP,2021.0,1,0,1
OMN,NOR,2020.0,1,0,1
NPL,UZB,2020.0,1,0,1
SVN,POL,2001.0,1,0,1
IND,CHL,2000.0,1,0,1
USA,BLZ,2010.0,1,0,1
MAR,IRN,2016.0,1,0,1
BMU,GBR,2011.0,1,0,1
KEN,CIV,2015.0,1,0,1
RWA,KOR,2018.0,1,0,1
BEN,DNK,2001.0,1,0,1
SYR,KOR,2016.0,2,0,2
AUT,COL,2018.0,1,0,1
PAK,TTO,2018.0,1,0,1
,GUM,2019.0,1,0,1
TZA,BGD,2015.0,1,0,1
NGA,GMB,2005.0,1,0,1
MDA,ITA,2008.0,1,0,1
BEL,NPL,2015.0,1,0,1
AZE,ISR,2013.0,1,0,1
SAU,LBN,1999.0,1,0,1
AUT,CUB,2010.0,1,0,1
GEO,KHM,2016.0,1,0,1
NOR,GHA,2013.0,1,0,1
KOR,IRQ,2017.0,1,0,1
GHA,NAM,2019.0,1,0,1
HKG,QAT,2017.0,3,0,3
USA,FLK,2021.0,1,0,1
BGD,DEU,1999.0,1,0,1
HUN,SRB,2005.0,1,0,1
CHN,DNK,1997.0,2,0,2
NLD,AFG,2007.0,1,0,1
COD,,2015.0,2,0,2
AZE,FRA,2015.0,1,0,1
MHL,USA,2004.0,1,0,1
DEU,GAB,2006.0,1,0,1
CIV,BEN,2004.0,2,0,2
CHN,MAR,2016.0,2,0,2
CUB,NLD,2004.0,1,0,1
CAF,ITA,1997.0,1,0,1
IDN,ESP,2009.0,1,0,1
BWA,CAN,2007.0,1,0,1
ARM,ESP,2001.0,1,0,1
CHE,TUR,1999.0,3,0,3
FRA,BIH,2002.0,1,0,1
SYR,EGY,2009.0,1,0,1
MKD,DEU,2007.0,1,0,1
NZL,TTO,2017.0,1,0,1
ZAF,GMB,2020.0,1,0,1
NGA,BRN,2016.0,1,0,1
BLR,JPN,2019.0,1,0,1
SYC,USA,2001.0,1,0,1
ZWE,MAR,2022.0,1,0,1
GBR,YEM,1999.0,1,0,1
SGP,SRB,2009.0,1,0,1
CHN,NPL,2008.0,1,0,1
GBR,MAR,2011.0,2,0,2
CHL,KOR,2022.0,1,0,1
HKG,QAT,2010.0,1,0,1
LVA,AUT,2019.0,1,0,1
ISL,CZE,2021.0,1,0,1
QAT,BEL,2019.0,1,0,1
FIN,MYS,2006.0,1,0,1
IDN,RUS,2000.0,1,0,1
PAK,LKA,2013.0,1,0,1
,SMR,1999.0,2,0,2
TWN,CZE,2009.0,2,0,2
BRA,FIN,2009.0,2,0,2
THA,UKR,2011.0,1,0,1
IRN,POL,2010.0,1,0,1
OMN,BRN,2022.0,1,0,1
POL,GRL,2015.0,1,0,1
NZL,ARE,2022.0,1,0,1
CHE,MCO,2014.0,1,0,1
MLT,DNK,2021.0,1,0,1
IRQ,BEL,2019.0,1,0,1
MEX,SYR,2005.0,1,0,1
TKM,RUS,2018.0,1,0,1
DEU,ARE,2000.0,1,0,1
ISL,BGD,2020.0,1,0,1
ESP,UZB,2000.0,1,0,1
BRA,PRI,2015.0,2,0,2
LVA,BRA,2014.0,1,0,1
CHE,PYF,2017.0,1,0,1
NZL,KAZ,2015.0,1,0,1
BEL,PAN,2005.0,1,0,1
USA,MMR,2004.0,1,0,1
PSE,KWT,2017.0,1,0,1
HRV,MKD,2014.0,1,0,1
CAN,HRV,2003.0,1,0,1
CIV,TWN,2008.0,1,0,1
AUS,BMU,2005.0,1,0,1
BHR,LBY,2013.0,1,0,1
IDN,PNG,2004.0,1,0,1
CAF,NLD,2003.0,1,0,1
UKR,LVA,2015.0,1,0,1
FRA,LBY,2015.0,2,0,2
USA,MCO,2012.0,1,0,1
PRI,SGP,2016.0,1,0,1
TUN,LBN,2013.0,1,0,1
UKR,COL,2008.0,1,0,1
TWN,PSE,2016.0,1,0,1
PAK,THA,2005.0,1,0,1
ESP,NIC,2004.0,2,0,2
WSM,FJI,2018.0,1,0,1
THA,NPL,2008.0,1,0,1
LBN,BIH,2021.0,1,0,1
NPL,YEM,2022.0,1,0,1
BGR,HUN,2015.0,1,0,1
NZL,MAC,2019.0,1,0,1
HKG,TUR,2015.0,1,0,1
LBR,PAK,2018.0,1,0,1
MMR,DEU,2009.0,1,0,1
AUT,CYP,2012.0,1,0,1
,SLE,1996.0,1,0,1
DZA,ISR,1999.0,1,0,1
SWE,BFA,2016.0,1,0,1
FRA,GRD,2013.0,1,0,1
ISR,POL,2010.0,1,0,1
HUN,BRA,2010.0,1,0,1
CAN,PYF,2020.0,1,0,1
HUN,PHL,2020.0,1,0,1
ECU,SVN,2019.0,1,0,1
JOR,SWE,2022.0,1,0,1
ISR,CYP,2018.0,1,0,1
MEX,NAM,2009.0,1,0,1
SUR,GUF,2009.0,1,0,1
PHL,OMN,2015.0,1,0,1
BGD,BRN,2012.0,1,0,1
KWT,SWE,2012.0,1,0,1
GBR,CAF,2018.0,1,0,1
GBR,HND,2022.0,1,0,1
OMN,QAT,2022.0,1,0,1
CHN,MMR,2022.0,1,0,1
ETH,FJI,2016.0,1,0,1
GEO,CZE,2004.0,1,0,1
LAO,LUX,2020.0,1,0,1
USA,TGO,2015.0,1,0,1
IND,NER,2017.0,1,0,1
KAZ,HUN,2009.0,1,0,1
SRB,PRT,2015.0,1,0,1
GBR,TUN,1999.0,1,0,1
ARE,LBY,2010.0,1,0,1
VEN,NZL,2015.0,1,0,1
ISL,,1999.0,1,0,1
VEN,CHE,2000.0,1,0,1
BLR,JPN,2010.0,1,0,1
LIE,CHE,2003.0,1,0,1
ISL,NLD,2000.0,1,0,1
SWZ,ZAF,2014.0,2,0,2
CUW,NLD,2002.0,1,0,1
TUN,MCO,2011.0,1,0,1
UKR,NOR,1999.0,1,0,1
PAK,MYS,2002.0,1,0,1
BGD,NZL,2005.0,1,0,1
ESP,PHL,2015.0,1,0,1
CRI,CIV,2019.0,3,0,3
FIN,JOR,2019.0,1,0,1
IRL,OMN,2003.0,1,0,1
ARE,TCA,2022.0,1,0,1
KGZ,,2001.0,1,0,1
,LCA,2009.0,1,0,1
CHL,SAU,2022.0,1,0,1
VNM,ZAF,2008.0,1,0,1
ETH,HKG,2019.0,1,0,1
,GUM,2017.0,1,0,1
BIH,MNE,2020.0,1,0,1
BRA,MCO,2020.0,1,0,1
NOR,NAM,2003.0,1,0,1
LKA,,1999.0,1,0,1
ZAF,COL,2009.0,1,0,1
SWE,NCL,2014.0,1,0,1
DEU,KAZ,2003.0,1,0,1
FRA,CRI,2003.0,1,0,1
ROU,IDN,2019.0,1,0,1
CHL,QAT,2016.0,1,0,1
SEN,MTQ,2011.0,1,0,1
LVA,SGP,2001.0,1,0,1
TZA,GHA,2022.0,1,0,1
BRA,IRL,2009.0,2,0,2
FJI,NLD,2021.0,1,0,1
OMN,MAR,2010.0,1,0,1
ISL,HRV,2021.0,1,0,1
SYR,DZA,2018.0,1,0,1
HUN,SRB,2002.0,1,0,1
TTO,BRB,2012.0,1,0,1
ARG,IND,2022.0,1,0,1
FIN,JOR,2017.0,1,0,1
USA,TJK,2021.0,1,0,1
KEN,BFA,2021.0,1,0,1
IRN,ECU,2020.0,1,0,1
NIC,CHL,2011.0,1,0,1
PRT,HUN,2000.0,1,0,1
FIN,MWI,2008.0,1,0,1
USA,VUT,2019.0,1,0,1
BFA,BRN,2021.0,1,0,1
HRV,SVK,2020.0,1,0,1
NPL,EGY,2017.0,1,0,1
ESP,COL,2021.0,62,57,5
CHN,GBR,2002.0,98,71,27
GBR,NLD,2015.0,224,330,-106
CHN,USA,2006.0,1021,719,302
JPN,KOR,2012.0,129,97,32
USA,GBR,2017.0,1502,1735,-233
DEU,KAZ,2001.0,1,1,0
CAN,AUS,2008.0,121,103,18
FRA,CHE,2004.0,220,161,59
USA,TUR,2010.0,225,178,47
USA,GBR,2010.0,1284,1467,-183
PAN,USA,2008.0,9,9,0
CHE,USA,2013.0,450,503,-53
USA,DEU,2015.0,1060,1184,-124
KOR,CHN,2020.0,231,100,131
CHN,NGA,2016.0,8,6,2
USA,NLD,2016.0,338,393,-55
IND,DEU,2004.0,89,49,40
USA,FRA,2016.0,674,873,-199
ESP,DEU,2009.0,133,149,-16
DEU,FIN,2004.0,22,18,4
ISR,BEL,2015.0,7,6,1
CHN,DEU,2009.0,186,128,58
SGP,USA,2016.0,198,202,-4
GRC,NOR,2016.0,13,2,11
USA,LBN,2009.0,38,46,-8
USA,AUT,2016.0,122,119,3
IND,AUS,2008.0,66,17,49
SGP,CHN,2004.0,76,68,8
KOR,IND,2011.0,81,140,-59
CAN,ITA,2001.0,24,24,0
BRA,DEU,2021.0,96,40,56
USA,IRQ,2006.0,4,1,3
SWE,AUS,2010.0,34,35,-1
JPN,HUN,1999.0,3,3,0
ROU,GBR,2010.0,15,5,10
DEU,JPN,2014.0,102,121,-19
BEL,NLD,2012.0,113,121,-8
BEL,AUS,2007.0,14,9,5
NOR,GRC,2008.0,2,5,-3
BRA,ITA,2016.0,37,64,-27
AUS,JOR,2009.0,9,3,6
BEL,DEU,2017.0,106,106,0
SGP,GBR,2003.0,47,36,11
ITA,GBR,2021.0,324,349,-25
PRT,USA,2007.0,25,38,-13
FIN,USA,2018.0,95,63,32
USA,TUR,2017.0,253,306,-53
ESP,CAN,2004.0,24,19,5
CHL,USA,2008.0,81,71,10
USA,GBR,2019.0,1514,1674,-160
CHN,GBR,2005.0,101,106,-5
JPN,GBR,2008.0,124,102,22
IND,SGP,2005.0,21,14,7
ITA,DEU,2011.0,242,133,109
HKG,SAU,2011.0,3,1,2
IND,NPL,2010.0,16,28,-12
NZL,GBR,2006.0,78,142,-64
GBR,ARE,2022.0,28,12,16
FRA,GUF,2013.0,13,19,-6
USA,JOR,2015.0,52,23,29
CHE,NLD,2007.0,31,39,-8
DNK,ITA,2014.0,16,34,-18
TWN,AUS,2006.0,5,9,-4
CHN,HKG,2000.0,94,34,60
COL,GBR,2015.0,11,19,-8
DEU,BRA,2018.0,80,116,-36
DEU,NOR,2015.0,64,42,22
IND,FRA,2016.0,85,72,13
GBR,SGP,2016.0,136,87,49
CAN,EGY,2011.0,26,22,4
DEU,USA,2021.0,757,757,0
ESP,MAR,2019.0,9,10,-1
CHN,VNM,2018.0,28,4,24
AUS,IRL,2014.0,33,51,-18
CHE,ESP,2016.0,64,127,-63
KOR,THA,2019.0,8,15,-7
CHN,JPN,2022.0,157,239,-82
GBR,NPL,2005.0,1,2,-1
FIN,DEU,2016.0,60,53,7
SVK,CAN,2016.0,1,1,0
GBR,POL,2018.0,73,76,-3
BRA,IND,2018.0,14,12,2
FRA,BRA,2022.0,31,50,-19
NOR,USA,2008.0,33,76,-43
NZL,CAN,2012.0,27,35,-8
AUT,IRL,2003.0,3,1,2
CHN,NOR,2016.0,31,20,11
FRA,AUS,2021.0,40,57,-17
PRT,DNK,2019.0,10,7,3
AUS,CHE,2020.0,54,84,-30
ITA,HUN,2006.0,6,6,0
DEU,ECU,2014.0,6,1,5
SVK,DEU,2002.0,19,15,4
GRD,USA,2015.0,10,7,3
USA,HUN,2015.0,59,62,-3
DEU,ALB,2018.0,1,3,-2
CAN,GBR,2000.0,65,59,6
OMN,EGY,2012.0,2,7,-5
VEN,USA,2013.0,34,9,25
CAN,CHE,2020.0,98,90,8
USA,TUR,2019.0,253,298,-45
IND,ISR,2018.0,116,42,74
PHL,USA,2016.0,30,30,0
CHN,SGP,2022.0,163,260,-97
KOR,BEL,2012.0,7,3,4
FRA,CHN,2021.0,175,104,71
SAU,EGY,2004.0,18,33,-15
FRA,MCO,2019.0,16,2,14
KOR,NLD,2011.0,5,10,-5
FRA,BEL,1997.0,27,23,4
USA,IRL,2021.0,108,85,23
CZE,USA,2022.0,21,14,7
NGA,MYS,2015.0,22,34,-12
BRA,AUS,2020.0,56,26,30
GBR,DNK,2022.0,64,45,19
FRA,DNK,2018.0,84,51,33
COL,FRA,2021.0,15,6,9
BRA,ESP,2022.0,41,21,20
FRA,IRL,2013.0,33,27,6
RUS,UKR,2018.0,53,108,-55
GBR,FRA,1999.0,97,97,0
KOR,ETH,2021.0,5,5,0
BHS,USA,2013.0,1,1,0
DEU,DNK,2021.0,96,90,6
ARG,ITA,2017.0,20,16,4
ZAF,USA,2021.0,93,60,33
IND,NPL,2019.0,32,12,20
AUT,UKR,2019.0,3,4,-1
PER,GBR,2018.0,4,9,-5
NOR,FRA,2014.0,18,31,-13
BEL,HUN,2018.0,6,7,-1
IND,CZE,2019.0,24,7,17
MYS,IND,2021.0,43,40,3
MEX,SWE,2018.0,14,4,10
CZE,DEU,2008.0,28,30,-2
USA,GRC,2003.0,130,59,71
ARG,CAN,2019.0,17,10,7
CHN,UKR,2015.0,2,2,0
KOR,SWE,2021.0,23,5,18
THA,CHN,2020.0,32,38,-6
DEU,UGA,2020.0,3,4,-1
ROU,GBR,2019.0,22,18,4
USA,CHL,2020.0,92,109,-17
ESP,AUS,2009.0,17,13,4
MYS,IRL,2022.0,5,2,3
ESP,IRL,2021.0,22,24,-2
HRV,SVN,2020.0,14,10,4
BEL,EST,2022.0,2,2,0
DEU,PAK,2021.0,23,16,7
BGD,MYS,2010.0,11,6,5
NLD,IDN,2022.0,14,8,6
AUS,HKG,2002.0,25,26,-1
ESP,JPN,2022.0,11,10,1
FRA,REU,2020.0,7,9,-2
JPN,IND,2022.0,33,23,10
BRA,JPN,2020.0,19,3,16
IRN,AUT,2022.0,11,2,9
DEU,IRL,2022.0,13,19,-6
BRA,BEL,2019.0,24,18,6
CHN,KEN,2022.0,7,1,6
USA,BGD,2016.0,31,55,-24
IND,CHN,2015.0,88,23,65
DEU,CYP,2018.0,6,8,-2
ROU,HUN,2016.0,7,5,2
HKG,USA,2008.0,124,100,24
ESP,EGY,2013.0,5,1,4
DZA,FRA,2007.0,20,48,-28
TUN,ITA,2007.0,1,1,0
BEL,DEU,2010.0,69,76,-7
JPN,TWN,2008.0,30,20,10
TUR,CYP,2010.0,7,7,0
ISL,ITA,2016.0,1,2,-1
GRC,IRL,2013.0,6,3,3
FIN,SWE,2022.0,17,14,3
ITA,ZAF,2017.0,7,5,2
CHE,LUX,2011.0,7,5,2
EST,CAN,2018.0,3,1,2
SWE,USA,1999.0,66,88,-22
HUN,CAN,2009.0,7,5,2
AUS,PAK,2008.0,4,4,0
IND,CHE,2007.0,24,9,15
VEN,ESP,2015.0,17,22,-5
FRA,EGY,2016.0,14,6,8
MYS,IDN,2014.0,67,11,56
TUR,GBR,2016.0,43,51,-8
IRL,GRC,2018.0,4,11,-7
CZE,SVK,2006.0,24,28,-4
SAU,HKG,2013.0,1,1,0
IND,BEL,2013.0,16,19,-3
CZE,NLD,2007.0,8,5,3
CAN,DNK,2015.0,26,21,5
NOR,ESP,2021.0,14,16,-2
FRA,IRN,2016.0,27,25,2
CHE,CAN,1999.0,17,22,-5
CHN,AUT,2005.0,5,7,-2
SWE,JPN,1997.0,8,3,5
CHN,ISR,2000.0,7,1,6
NZL,USA,1999.0,29,33,-4
GBR,THA,2016.0,89,36,53
IND,PAK,2016.0,27,26,1
IND,KWT,2005.0,6,4,2
THA,JPN,2016.0,79,88,-9
RUS,ESP,2006.0,9,6,3
FRA,MCO,2017.0,9,8,1
ESP,USA,1997.0,39,47,-8
ARG,ITA,2019.0,16,16,0
THA,NPL,2013.0,6,1,5
MKD,BGR,2017.0,1,4,-3
NGA,GBR,2006.0,13,14,-1
USA,CHE,1997.0,54,43,11
ARE,USA,2011.0,14,48,-34
KAZ,USA,2015.0,6,22,-16
UKR,BLR,1999.0,3,1,2
BEL,CHL,2007.0,4,1,3
FRA,CZE,1998.0,5,10,-5
JPN,ESP,2009.0,16,12,4
CHN,MAR,2022.0,5,1,4
DEU,AZE,2018.0,2,3,-1
ZWE,ZAF,2014.0,26,15,11
USA,ROU,2020.0,21,9,12
HKG,IND,2009.0,9,1,8
TUR,CYP,2017.0,55,24,31
ESP,ZAF,2010.0,5,4,1
NLD,IND,2022.0,14,17,-3
CAN,JOR,2021.0,8,9,-1
CHN,FIN,2016.0,16,28,-12
BRA,GLP,2010.0,1,1,0
DNK,HUN,2016.0,3,9,-6
SEN,GBR,2021.0,1,1,0
SWE,ITA,2018.0,38,77,-39
NPL,CAN,2022.0,2,4,-2
USA,CHE,1998.0,114,95,19
IND,JPN,2022.0,23,33,-10
PRT,CHL,2020.0,2,5,-3
SWE,EST,2008.0,10,6,4
SVN,FRA,2020.0,1,7,-6
PAK,SDN,2020.0,2,1,1
ISR,CAN,2022.0,23,20,3
BRA,ECU,2016.0,9,1,8
ROU,IRL,2020.0,5,3,2
GBR,LKA,2002.0,3,8,-5
LTU,GBR,2012.0,9,7,2
ZAF,SWZ,2018.0,7,4,3
ZAF,GBR,2015.0,82,105,-23
PRT,DEU,2019.0,47,30,17
POL,CZE,2015.0,22,8,14
SGP,AUS,2008.0,49,55,-6
CAN,SWE,2015.0,40,44,-4
HUN,NLD,2016.0,9,8,1
TUR,JPN,2021.0,3,4,-1
TUR,CYP,2019.0,63,51,12
NOR,VNM,2019.0,2,1,1
CAN,JPN,2003.0,75,106,-31
JPN,UZB,2012.0,2,1,1
FRA,BEN,2010.0,12,5,7
EST,FIN,2009.0,5,6,-1
SVK,DEU,2005.0,20,15,5
ESP,SWE,1997.0,4,2,2
USA,LTU,2016.0,7,4,3
SVK,GBR,2014.0,7,3,4
USA,HRV,1999.0,4,7,-3
AUT,UKR,2010.0,4,5,-1
ESP,POL,2013.0,35,16,19
DEU,ZAF,2005.0,12,7,5
PAK,FRA,2012.0,8,23,-15
ARG,CAN,2010.0,8,8,0
DEU,BIH,2004.0,1,3,-2
AUT,CZE,2008.0,5,6,-1
CZE,AUT,2013.0,10,6,4
IND,JAM,2009.0,1,1,0
CYP,GBR,2013.0,9,26,-17
BGR,USA,2005.0,20,13,7
HUN,ROU,2014.0,8,10,-2
UGA,USA,2012.0,23,20,3
ETH,AUT,2012.0,2,3,-1
CZE,JPN,2004.0,4,5,-1
ESP,PRT,2002.0,32,16,16
CYP,GRC,2020.0,22,51,-29
BRA,USA,1999.0,84,95,-11
BRA,GRC,2008.0,2,1,1
UKR,GBR,2015.0,9,7,2
MTQ,FRA,2008.0,14,8,6
TGO,BFA,2010.0,1,3,-2
FIN,AUS,2011.0,11,12,-1
PAK,CAN,2007.0,4,9,-5
ESP,ITA,2004.0,49,88,-39
ESP,BOL,2014.0,1,1,0
NLD,AUS,1997.0,3,3,0
NLD,SVK,2008.0,2,5,-3
IDN,JPN,2003.0,7,25,-18
USA,PRT,2001.0,27,33,-6
ESP,VEN,2012.0,15,30,-15
NAM,ZAF,2013.0,2,6,-4
JPN,TZA,2002.0,5,4,1
RUS,NOR,1999.0,3,1,2
NPL,USA,2011.0,12,5,7
CUB,MEX,2007.0,19,9,10
JPN,NLD,2007.0,16,16,0
USA,IDN,2000.0,5,3,2
ESP,FIN,2008.0,17,10,7
RUS,DNK,2003.0,2,7,-5
FIN,ITA,2003.0,10,6,4
PRT,FRA,2001.0,26,9,17
HKG,DEU,2000.0,3,2,1
JPN,UKR,2003.0,4,7,-3
GBR,COL,2001.0,7,4,3
CAN,COL,2013.0,9,13,-4
DEU,SDN,2006.0,4,4,0
CAN,AUT,2008.0,9,14,-5
EGY,ARE,2014.0,12,9,3
COL,USA,2003.0,25,36,-11
ESP,PRY,2000.0,1,1,0
HKG,GBR,2002.0,29,30,-1
NOR,CAN,2005.0,11,3,8
TUR,CAN,2008.0,8,14,-6
GBR,LKA,2005.0,7,6,1
DNK,NOR,2011.0,26,27,-1
GBR,PAK,2003.0,23,17,6
FRA,FIN,2013.0,21,15,6
NOR,CAN,2002.0,9,9,0
MEX,VEN,2000.0,3,4,-1
MYS,NZL,2022.0,10,4,6
CHE,RUS,2005.0,11,19,-8
AUT,BGD,2018.0,2,1,1
USA,PER,2008.0,23,25,-2
ITA,GRC,2005.0,11,11,0
RUS,CZE,2003.0,12,5,7
BGR,CHE,2004.0,5,2,3
BRB,USA,2016.0,6,3,3
ETH,RUS,2021.0,5,7,-2
CHE,ROU,1999.0,1,2,-1
COL,BRA,2013.0,31,22,9
ARE,OMN,2013.0,1,5,-4
ITA,MEX,2003.0,11,14,-3
MLI,USA,2012.0,2,1,1
USA,NOR,2006.0,51,49,2
AUS,MEX,2001.0,2,4,-2
TWN,CAN,1997.0,2,1,1
TWN,IND,2000.0,3,9,-6
CAN,FIN,2015.0,11,16,-5
BWA,GBR,2014.0,2,2,0
USA,PAN,2006.0,9,3,6
CMR,DEU,2011.0,5,4,1
FRA,SAU,2011.0,27,1,26
HKG,NLD,2008.0,2,1,1
KOR,GBR,2003.0,26,20,6
HUN,CHE,2014.0,19,10,9
MAR,FRA,2016.0,37,85,-48
CZE,IRL,2011.0,4,4,0
SVK,SWE,2007.0,4,1,3
KOR,RUS,2003.0,13,13,0
CUB,USA,2017.0,9,2,7
SEN,TGO,2012.0,1,1,0
BGD,JPN,2008.0,39,36,3
CHL,FRA,2009.0,30,21,9
FRA,ALB,2013.0,3,1,2
ROU,DEU,2008.0,15,32,-17
ROU,USA,2011.0,30,18,12
IRL,IND,2011.0,9,8,1
CUB,USA,2010.0,4,8,-4
AUS,POL,2006.0,5,4,1
THA,BGD,2016.0,5,2,3
RWA,ZAF,2015.0,11,5,6
POL,ISR,2020.0,7,2,5
SAU,MAR,2021.0,6,2,4
ALB,GBR,2007.0,1,1,0
GTM,MEX,2012.0,1,7,-6
BRA,BEL,2010.0,14,8,6
TZA,GBR,2016.0,6,4,2
CHL,CAN,2013.0,16,11,5
CHE,NOR,2009.0,16,5,11
TUR,SWE,2022.0,7,4,3
ESP,ZAF,2017.0,11,7,4
JOR,ARE,2016.0,8,5,3
NLD,JPN,2021.0,15,12,3
IND,BHR,2020.0,5,1,4
ETH,NLD,2014.0,6,2,4
DOM,USA,2011.0,4,4,0
CAN,KWT,2013.0,7,2,5
BEL,BOL,2019.0,3,2,1
ZAF,ESP,2012.0,2,8,-6
IND,AUT,2021.0,10,8,2
AUT,CHN,2012.0,12,14,-2
BGD,MYS,2017.0,18,56,-38
IND,TUR,2016.0,12,4,8
IND,IRL,2007.0,11,3,8
BEL,COL,2018.0,7,5,2
OMN,IND,2016.0,5,18,-13
CUB,USA,2019.0,11,5,6
AUS,VNM,2016.0,24,21,3
SAU,YEM,2020.0,7,25,-18
USA,GEO,2015.0,13,10,3
PAK,GBR,2000.0,2,7,-5
BLR,RUS,2006.0,7,12,-5
GBR,VNM,2016.0,12,24,-12
MAC,HKG,2019.0,4,11,-7
COL,ARG,2015.0,17,9,8
CHN,NPL,2013.0,2,4,-2
KOR,THA,2017.0,15,8,7
ISL,USA,2014.0,8,10,-2
ZAF,BEL,2012.0,7,6,1
IRN,SGP,2018.0,10,4,6
DEU,SVN,2021.0,10,7,3
PAK,TUR,2009.0,3,1,2
NOR,HKG,2022.0,1,2,-1
ESP,ZAF,2019.0,6,7,-1
DEU,ROU,2020.0,12,15,-3
SWE,BGD,2020.0,5,1,4
ZAF,PRT,2018.0,1,3,-2
RWA,KOR,2019.0,2,1,1
NGA,BEN,2020.0,1,4,-3
DNK,POL,2002.0,2,8,-6
NLD,THA,2022.0,4,4,0
IND,ARG,2021.0,1,2,-1
CHL,IRL,2010.0,3,2,1
ESP,HUN,2015.0,7,1,6
LKA,GBR,1999.0,2,3,-1
CHN,RUS,2007.0,4,5,-1
SRB,DEU,2003.0,8,6,2
HND,USA,2016.0,4,2,2
EGY,QAT,2017.0,16,9,7
ROU,CAN,2012.0,3,9,-6
ITA,ZAF,2010.0,3,3,0
BRA,AUT,2011.0,5,4,1
DEU,IDN,2005.0,7,2,5
DNK,FIN,2016.0,13,24,-11
SRB,CHE,2011.0,5,4,1
DNK,GRC,2020.0,8,9,-1
BRA,BEL,2017.0,25,9,16
NZL,TTO,2018.0,1,1,0
CZE,BEL,2016.0,4,7,-3
MEX,ARG,2011.0,9,6,3
CHL,GBR,2022.0,19,17,2
ESP,MOZ,2016.0,3,1,2
TWN,CAN,1998.0,3,1,2
USA,QAT,2022.0,18,28,-10
THA,NLD,2018.0,7,12,-5
BLR,USA,2018.0,6,1,5
CMR,TZA,2014.0,1,1,0
EGY,QAT,2019.0,10,11,-1
NLD,KEN,2018.0,2,4,-2
KEN,CAN,2016.0,7,9,-2
BGD,MYS,2019.0,21,54,-33
ZAF,IND,2022.0,13,18,-5
ARE,IND,2016.0,13,33,-20
AUT,COL,2019.0,4,4,0
HKG,QAT,2018.0,1,2,-1
SGP,ESP,2015.0,4,9,-5
DEU,PRT,2000.0,7,2,5
LBN,DEU,2009.0,3,1,2
PER,BRA,2020.0,14,52,-38
NPL,DEU,2020.0,4,2,2
BEL,LBN,2018.0,7,3,4
MEX,AUS,2022.0,4,2,2
USA,FSM,2014.0,1,1,0
FRA,HKG,2012.0,5,5,0
ESP,CRI,2015.0,9,5,4
KEN,UGA,2006.0,1,3,-2
CHL,ARG,2007.0,9,11,-2
LKA,AUS,2009.0,6,5,1
SGP,DNK,2005.0,2,2,0
AUS,ETH,2015.0,2,5,-3
AUT,SVK,2016.0,5,12,-7
BRA,VEN,2019.0,5,7,-2
CZE,AUS,2017.0,7,9,-2
SAU,TUR,2001.0,1,1,0
BEL,SGP,2009.0,6,3,3
SWE,JPN,1998.0,5,13,-8
GBR,IDN,2003.0,3,3,0
AUT,ZAF,2022.0,3,3,0
BFA,FRA,2011.0,16,9,7
BGR,FRA,2009.0,10,6,4
EGY,IRN,2012.0,2,5,-3
BRA,CUB,2007.0,5,3,2
SWE,CAN,2009.0,35,27,8
BEL,KOR,2006.0,5,3,2
NLD,EST,2008.0,1,1,0
MEX,COL,1999.0,4,1,3
IRN,GBR,2000.0,4,5,-1
ITA,TUR,2001.0,3,3,0
RUS,BEL,2014.0,8,12,-4
USA,HTI,2004.0,3,5,-2
REU,FRA,2016.0,6,8,-2
MAR,BEL,2009.0,2,4,-2
ISR,ITA,2012.0,6,13,-7
JPN,KAZ,2006.0,1,1,0
CAN,VEN,2006.0,2,7,-5
BEL,HRV,2013.0,2,2,0
SAU,JPN,2020.0,8,11,-3
QAT,TUN,2011.0,1,1,0
FRA,BEN,2017.0,12,8,4
ISR,MEX,2013.0,2,2,0
CAN,IRL,2018.0,34,48,-14
HRV,GBR,2016.0,11,4,7
KEN,FRA,2016.0,4,7,-3
LBN,EGY,2011.0,1,2,-1
BEN,FRA,2014.0,6,19,-13
TUR,ITA,2007.0,5,4,1
MAR,DEU,2011.0,2,1,1
MOZ,ZAF,2020.0,2,3,-1
FRA,MDG,2006.0,9,9,0
IND,CZE,2017.0,16,5,11
AUS,HKG,2005.0,15,24,-9
GRC,ROU,2011.0,2,3,-1
BRA,NGA,2016.0,3,2,1
NZL,DNK,2015.0,8,2,6
MKD,BGR,2019.0,2,1,1
OMN,USA,2014.0,5,16,-11
RWA,NLD,2017.0,1,1,0
SVN,CAN,2016.0,1,1,0
IND,ROU,2019.0,3,3,0
BGR,ITA,2020.0,2,2,0
CHL,IRL,2017.0,1,2,-1
EST,CZE,2018.0,1,7,-6
IDN,SWE,2018.0,3,2,1
ITA,ZAF,2019.0,5,8,-3
KAZ,JPN,2019.0,2,7,-5
NPL,SWE,2021.0,2,1,1
ARG,IND,2016.0,2,1,1
VNM,GBR,2013.0,12,6,6
COL,ZAF,2011.0,1,2,-1
CAN,IDN,2018.0,5,1,4
SRB,CAN,2018.0,4,3,1
DNK,POL,2005.0,6,3,3
COG,USA,2020.0,6,8,-2
NOR,BEL,2013.0,5,6,-1
BRA,SRB,2012.0,1,1,0
IRL,SRB,2015.0,1,1,0
DEU,IRN,2003.0,4,5,-1
DEU,MAR,2001.0,2,3,-1
PAK,IRN,2020.0,1,9,-8
DZA,CHN,2020.0,5,17,-12
KEN,DEU,2018.0,6,12,-6
POL,NLD,2009.0,13,14,-1
PRT,NOR,2020.0,5,1,4
LKA,NZL,2011.0,2,1,1
SYR,CHN,2011.0,1,1,0
TUN,SAU,2011.0,23,4,19
RUS,KOR,2014.0,8,11,-3
CHE,RUS,2002.0,12,32,-20
CHN,CHE,2000.0,7,2,5
CHN,MAC,2004.0,5,1,4
CRI,USA,2007.0,7,14,-7
CZE,AUS,2019.0,7,11,-4
HRV,CHE,2010.0,2,3,-1
RUS,SVK,2014.0,3,2,1
GBR,LVA,2013.0,1,1,0
PRT,DNK,2017.0,11,10,1
JOR,MYS,2016.0,8,24,-16
FRA,PYF,2016.0,7,11,-4
HKG,NZL,2004.0,6,2,4
DNK,SGP,2018.0,3,7,-4
FIN,RUS,2022.0,3,14,-11
MEX,ISR,2018.0,6,1,5
ESP,HKG,2021.0,2,2,0
PAK,BGD,2002.0,3,1,2
KOR,NZL,2011.0,3,4,-1
ISR,AUT,2020.0,10,3,7
TZA,DEU,2017.0,3,4,-1
DNK,ARE,2019.0,3,6,-3
ITA,GRC,2002.0,14,13,1
TTO,ESP,2016.0,3,1,2
HRV,SWE,2014.0,4,2,2
CAN,TUR,2000.0,5,1,4
QAT,JOR,2011.0,1,3,-2
USA,GTM,2003.0,4,3,1
SWE,MEX,2003.0,2,2,0
DEU,PAN,2004.0,1,1,0
DEU,LTU,1999.0,7,3,4
AUS,SVN,2018.0,4,1,3
PRT,ESP,1999.0,4,5,-1
BRA,ZAF,2004.0,2,3,-1
DEU,MKD,2003.0,1,1,0
HUN,IRL,2006.0,1,1,0
MAC,HKG,2010.0,4,5,-1
ZAF,IRL,2004.0,3,3,0
BRA,VEN,2017.0,1,6,-5
IND,NZL,2010.0,5,4,1
BEL,VNM,2004.0,1,2,-1
NZL,SGP,2002.0,7,5,2
IRL,BRA,2010.0,1,1,0
PAK,CHE,2014.0,2,4,-2
DNK,CHL,2018.0,2,3,-1
GRC,ESP,2004.0,2,3,-1
THA,SGP,2003.0,3,1,2
PHL,NLD,2020.0,3,5,-2
LBN,CAN,2009.0,9,5,4
MEX,CHE,2015.0,6,5,1
CAN,JAM,2013.0,3,2,1
NLD,LUX,2016.0,4,5,-1
ARE,BRN,2014.0,1,1,0
BOL,CHL,2019.0,3,2,1
TUR,OMN,2017.0,2,1,1
SWE,GRC,2014.0,4,23,-19
EGY,JOR,2020.0,2,5,-3
MEX,ZAF,2014.0,2,2,0
ZMB,USA,2017.0,8,10,-2
ARE,KAZ,2018.0,2,2,0
ISL,CAN,2019.0,1,3,-2
JOR,AUS,2020.0,7,15,-8
SAU,IRL,2020.0,4,17,-13
IND,ESP,1998.0,2,1,1
ECU,MEX,2021.0,4,3,1
MYS,NPL,2014.0,1,1,0
TUR,IRQ,2022.0,5,5,0
MWI,ZAF,2018.0,3,4,-1
AUS,TUR,2012.0,8,2,6
MEX,NZL,2017.0,6,3,3
CHE,ZWE,2009.0,1,1,0
ISL,FRA,2009.0,1,2,-1
CAN,LKA,2014.0,4,1,3
TZA,DEU,2010.0,2,3,-1
NZL,THA,2008.0,3,1,2
BEL,EGY,2020.0,7,1,6
GRC,AUT,2001.0,3,1,2
PER,KEN,2021.0,2,2,0
ITA,THA,2022.0,3,2,1
COL,CHE,2021.0,4,1,3
HUN,PRT,2019.0,2,2,0
ITA,GHA,2021.0,1,1,0
ARG,ITA,2010.0,9,13,-4
AZE,IRN,2014.0,2,1,1
IND,TTO,2020.0,1,3,-2
LBN,CHE,2019.0,4,3,1
CHL,KOR,2016.0,3,1,2
USA,AFG,2012.0,6,1,5
GRC,SWE,2007.0,5,7,-2
LTU,SWE,2000.0,3,3,0
CHE,CHL,2003.0,3,3,0
CHE,MEX,2011.0,4,5,-1
ZAF,HUN,2013.0,1,1,0
IND,FIN,2022.0,5,3,2
SRB,IRL,2020.0,1,3,-2
PSE,DEU,2006.0,4,2,2
DZA,TUN,2020.0,7,7,0
AUT,ROU,2013.0,3,2,1
CZE,AUS,2010.0,5,3,2
PAK,NZL,2018.0,3,10,-7
CHN,GRC,2020.0,5,3,2
ZAF,FRA,2001.0,3,5,-2
DNK,NZL,2020.0,5,5,0
CRI,CIV,2018.0,2,3,-1
CZE,EGY,2012.0,3,2,1
MAC,HKG,2017.0,3,10,-7
GBR,LTU,2013.0,7,3,4
DZA,ITA,2013.0,2,3,-1
SAU,NOR,2018.0,2,3,-1
CZE,THA,2014.0,2,1,1
NLD,HRV,2004.0,3,1,2
NGA,CHN,2014.0,7,10,-3
GIN,FRA,2021.0,2,2,0
CHN,ITA,2007.0,12,13,-1
MEX,PRT,2016.0,2,6,-4
SGP,IRL,2016.0,3,7,-4
TZA,SWE,2019.0,2,2,0
SRB,SVK,2017.0,3,1,2
AUS,NGA,2021.0,3,4,-1
IRL,SAU,2016.0,3,5,-2
POL,RUS,2011.0,6,12,-6
RUS,MDA,2003.0,2,2,0
DEU,KEN,2013.0,6,5,1
THA,IRN,2022.0,1,2,-1
IRL,ZAF,2016.0,3,3,0
MAR,IND,2020.0,1,4,-3
CHL,JPN,2001.0,1,1,0
IND,MUS,2008.0,1,1,0
TUN,DEU,2005.0,1,2,-1
JPN,BFA,2013.0,1,1,0
EGY,IRL,2012.0,1,1,0
ARG,AUT,2009.0,1,2,-1
KHM,BEL,2010.0,1,1,0
EST,DEU,2016.0,3,8,-5
RUS,CHN,2008.0,5,1,4
CHE,KOR,2004.0,5,5,0
DNK,PRT,2014.0,5,9,-4
CHN,PHL,2016.0,1,2,-1
NZL,AUT,2002.0,2,3,-1
SWE,HKG,2009.0,3,5,-2
DNK,NPL,2015.0,2,1,1
IND,IRQ,2021.0,4,4,0
BIH,HRV,2021.0,4,1,3
PHL,DNK,2006.0,1,1,0
PRT,DNK,2010.0,4,4,0
TUR,ARE,2016.0,3,4,-1
KOR,IRL,2021.0,2,1,1
RUS,AUS,2014.0,7,11,-4
NGA,GHA,2020.0,5,3,2
BGR,SWE,2009.0,1,1,0
IND,ARE,2003.0,1,1,0
KAZ,DEU,2008.0,3,1,2
ZMB,ZAF,2015.0,3,3,0
NPL,NOR,2011.0,5,1,4
CMR,BEL,2000.0,1,1,0
RUS,ZAF,2009.0,1,1,0
SAU,DZA,2021.0,7,3,4
SRB,RUS,2021.0,2,3,-1
UKR,NLD,2000.0,2,1,1
KEN,JPN,2003.0,4,1,3
THA,NZL,2004.0,1,3,-2
FIN,GRC,2016.0,2,6,-4
LTU,USA,2012.0,3,5,-2
USA,BMU,2004.0,2,1,1
CHL,IRL,2019.0,1,2,-1
FRA,BEN,2019.0,6,6,0
SWE,IRQ,2013.0,1,1,0
PRT,IDN,2020.0,1,1,0
USA,MWI,2008.0,1,5,-4
ARE,BHR,2020.0,1,1,0
KWT,NLD,2018.0,1,1,0
DNK,IND,2000.0,1,3,-2
LUX,DEU,2004.0,1,7,-6
BGR,POL,2020.0,1,1,0
BEL,ARG,2002.0,2,3,-1
GBR,GEO,2001.0,1,1,0
ROU,SWE,2003.0,2,1,1
VEN,GBR,2004.0,2,5,-3
CAN,PRT,2006.0,4,3,1
ZMB,USA,2010.0,5,3,2
IRL,MYS,2022.0,2,5,-3
ISR,UKR,1999.0,1,3,-2
PRT,COL,2016.0,4,3,1
TUR,IRL,2016.0,3,1,2
CHL,POL,2013.0,2,1,1
FRA,EST,2018.0,3,3,0
DNK,IRN,2006.0,1,1,0
IND,ESP,1997.0,2,2,0
KOR,TWN,2004.0,7,4,3
PRT,BEL,1998.0,1,1,0
SGP,KAZ,2016.0,1,2,-1
SWE,LVA,2020.0,2,1,1
OMN,CAN,2009.0,2,10,-8
TZA,SWE,2010.0,1,2,-1
NOR,VNM,2017.0,2,1,1
CAN,ARM,2012.0,1,2,-1
SVK,ZAF,2021.0,1,1,0
NLD,CRI,2015.0,1,1,0
TUR,ESP,2006.0,1,2,-1
BEL,COG,2007.0,2,1,1
UKR,CZE,2007.0,3,2,1
GAB,FRA,1998.0,1,3,-2
TZA,CAN,2015.0,1,1,0
KHM,BEL,2017.0,1,2,-1
GBR,BGD,2004.0,5,6,-1
MEX,CHN,2004.0,1,2,-1
ARE,JPN,2015.0,1,2,-1
NOR,NGA,2015.0,1,1,0
OMN,QAT,2016.0,1,1,0
BLR,POL,2002.0,2,2,0
MUS,GBR,2020.0,1,1,0
POL,CHL,2011.0,1,2,-1
DEU,EST,2003.0,2,3,-1
SEN,BEN,2017.0,2,1,1
ERI,SDN,2022.0,1,1,0
LKA,CHN,2022.0,1,1,0
IND,LUX,2022.0,1,3,-2
ZAF,ETH,2014.0,3,4,-1
CAN,HRV,2001.0,3,2,1
SWE,UGA,2015.0,1,1,0
BRA,SGP,2014.0,2,3,-1
USA,PNG,2017.0,3,2,1
GBR,ETH,2014.0,3,4,-1
KOR,ITA,2000.0,2,2,0
ARE,MYS,2005.0,1,1,0
MAR,CAN,2009.0,4,8,-4
KWT,GBR,2004.0,4,5,-1
MAC,IND,2021.0,2,1,1
ISL,CAN,2017.0,1,3,-2
MNG,JPN,2015.0,1,8,-7
BOL,CHL,2017.0,1,5,-4
UGA,GHA,2018.0,1,2,-1
JOR,EGY,2016.0,3,1,2
ISR,POL,2018.0,2,4,-2
ROU,BEL,2006.0,4,2,2
NZL,ISR,2015.0,1,2,-1
BRA,CHN,2004.0,1,2,-1
CRI,BRA,2005.0,1,1,0
IRN,TWN,2005.0,1,1,0
CAN,PER,2016.0,2,4,-2
CHE,VUT,2019.0,1,1,0
CHN,MNG,2022.0,1,2,-1
LTU,DEU,2009.0,2,3,-1
NOR,SVN,2011.0,1,1,0
GEO,TUR,2014.0,1,1,0
BFA,CIV,2000.0,1,1,0
AUT,KEN,2020.0,2,1,1
NOR,EGY,2021.0,1,1,0
LBN,CHE,2017.0,1,2,-1
THA,ISL,2015.0,1,1,0
ARG,PRT,2014.0,3,2,1
EGY,QAT,2010.0,2,2,0
DEU,TUN,2001.0,2,1,1
UGA,CHN,2020.0,1,4,-3
EST,AUS,2010.0,1,1,0
CHN,LUX,2016.0,1,2,-1
USA,OMN,2022.0,2,4,-2
UZB,CAN,2002.0,2,1,1
ISR,NOR,2001.0,1,1,0
ESP,SWE,1998.0,1,4,-3
SVN,NLD,2006.0,1,2,-1
IDN,BRN,2018.0,1,2,-1
SVN,USA,2000.0,1,3,-2
NOR,CYP,2012.0,1,2,-1
KEN,NLD,2022.0,2,1,1
CMR,SAU,2019.0,1,1,0
SRB,SVK,2019.0,1,2,-1
DEU,CRI,2021.0,3,5,-2
AUS,HRV,2015.0,1,2,-1
KOR,ESP,2022.0,1,5,-4
ARM,BEL,2002.0,1,1,0
MLI,BFA,2018.0,2,3,-1
DEU,PHL,2020.0,4,7,-3
MEX,POL,2018.0,2,4,-2
SEN,ZAF,2018.0,1,1,0
DZA,BEL,2011.0,1,2,-1
LTU,UKR,2020.0,2,3,-1
NLD,SDN,2001.0,4,1,3
KOR,THA,2010.0,1,4,-3
TUR,IND,2007.0,1,4,-3
BLR,LTU,2018.0,1,1,0
USA,UZB,2010.0,1,2,-1
MWI,CHE,2012.0,1,1,0
JPN,ROU,2021.0,2,1,1
IND,CZE,2010.0,3,1,2
ZAF,NOR,2003.0,1,2,-1
PHL,FRA,2022.0,1,1,0
JPN,GEO,2007.0,1,1,0
IND,KWT,2002.0,1,11,-10
FIN,HUN,2001.0,1,6,-5
BIH,SRB,2003.0,2,2,0
IRL,RUS,2008.0,1,5,-4
IRL,BRA,2019.0,2,19,-17
ZMB,NLD,2014.0,1,1,0
JOR,BEL,2015.0,1,1,0
SLB,AUS,2020.0,1,1,0
DNK,COL,2011.0,1,1,0
QAT,ESP,2016.0,1,4,-3
ITA,UZB,2013.0,1,2,-1
AUT,BRA,2021.0,1,10,-9
LBY,IRL,2014.0,2,1,1
ITA,SGP,2004.0,2,1,1
DNK,BRA,2022.0,1,8,-7
ETH,CHE,2021.0,1,4,-3
ARE,BRA,2019.0,1,2,-1
TGO,CAN,2021.0,1,1,0
AUT,UKR,2017.0,1,4,-3
SVN,IND,2016.0,1,2,-1
FIN,ARE,2017.0,1,1,0
DNK,LUX,2020.0,1,1,0
SAU,THA,2020.0,1,1,0
SVN,SLV,2001.0,1,1,0
SEN,USA,2004.0,1,1,0
CHE,CMR,2002.0,1,1,0
TUN,USA,2003.0,1,3,-2
SGP,PAK,2020.0,2,5,-3
ISL,SWE,2022.0,2,5,-3
SWE,OMN,2015.0,1,1,0
URY,BRA,2013.0,1,6,-5
HUN,NOR,2015.0,1,1,0
MYS,THA,2001.0,1,2,-1
DZA,GBR,2015.0,1,3,-2
TUR,QAT,2013.0,2,1,1
COD,JPN,2020.0,1,1,0
BFA,MAR,2016.0,1,2,-1
ESP,NIC,2014.0,1,1,0
IND,SVN,2014.0,1,1,0
PER,SWE,2010.0,1,1,0
CAN,NOR,2000.0,1,2,-1
EGY,CZE,2022.0,1,1,0
GBR,NAM,2016.0,1,3,-2
CHE,FRA,2007.0,185,247,-62
AUS,AUT,2011.0,20,25,-5
JPN,USA,2008.0,1012,888,124
CAN,CHN,2006.0,109,121,-12
NLD,GBR,2014.0,289,218,71
DEU,CHL,2008.0,23,21,2
USA,BEL,2020.0,132,149,-17
ISR,USA,2015.0,363,309,54
MEX,USA,2009.0,157,156,1
SAU,USA,1999.0,12,10,2
ESP,BGR,2004.0,2,3,-1
QAT,CYP,2020.0,2,1,1
USA,AUS,2022.0,187,294,-107
GBR,CYP,2013.0,26,9,17
GBR,OMN,2007.0,14,4,10
UKR,DEU,2006.0,28,17,11
SWE,AUS,2017.0,38,64,-26
ESP,BEL,2011.0,33,32,1
AUT,BIH,2008.0,3,1,2
BEL,MAR,2016.0,4,2,2
CHE,ETH,2017.0,3,8,-5
IND,CAN,2016.0,130,101,29
SWE,ESP,2022.0,26,32,-6
PRT,DEU,2017.0,60,24,36
AUS,ISR,2020.0,20,16,4
SWE,AUS,2019.0,33,47,-14
PAK,FIN,2016.0,4,1,3
DEU,ITA,2022.0,126,125,1
CHE,FIN,2006.0,8,7,1
NZL,FRA,2005.0,6,5,1
SWE,FIN,2021.0,46,53,-7
USA,COL,2014.0,70,83,-13
FIN,TUR,2015.0,3,5,-2
DEU,ESP,2021.0,173,164,9
ESP,PER,2020.0,23,14,9
EGY,CAN,2021.0,36,32,4
CAN,OMN,2001.0,2,1,1
FRA,BEL,1998.0,43,28,15
TWN,VNM,2022.0,32,11,21
MEX,CAN,2015.0,32,36,-4
USA,LUX,2016.0,9,6,3
ROU,ITA,2008.0,14,9,5
CAN,SGP,2020.0,27,25,2
ROU,GBR,2017.0,18,10,8
QAT,AUS,2021.0,6,5,1
NPL,IND,2011.0,20,17,3
HRV,CHE,2019.0,4,2,2
LBN,FRA,2004.0,14,19,-5
PAK,KOR,2020.0,57,95,-38
TGO,BFA,2017.0,2,3,-1
HRV,CHE,2017.0,8,2,6
JPN,THA,2022.0,36,22,14
CAN,ISR,2011.0,50,55,-5
PER,USA,2016.0,40,28,12
SGP,JPN,2020.0,23,26,-3
IND,ZAF,2021.0,26,27,-1
GRC,CAN,2009.0,14,7,7
IDN,NLD,2013.0,10,19,-9
BRA,PRY,2009.0,2,3,-1
BLR,POL,2005.0,4,2,2
FRA,ISR,2006.0,22,14,8
ESP,MAR,2010.0,12,5,7
USA,UKR,2012.0,19,21,-2
ESP,CUB,2009.0,19,29,-10
COL,DEU,2001.0,5,1,4
HKG,GBR,2005.0,37,18,19
ESP,PRT,2005.0,26,20,6
DEU,KOR,2006.0,18,19,-1
PRT,DEU,2010.0,24,30,-6
IND,SGP,2002.0,15,6,9
ZAF,NZL,2009.0,12,3,9
HUN,AUT,2003.0,10,10,0
ZAF,NAM,2002.0,2,4,-2
CHN,SWE,1999.0,16,5,11
NLD,EGY,2009.0,1,1,0
CZE,UKR,2013.0,3,9,-6
HUN,JPN,2015.0,10,3,7
CHN,NLD,2003.0,20,5,15
ARG,CAN,2017.0,11,6,5
IRL,BRA,2017.0,10,10,0
IND,NZL,2017.0,21,7,14
NOR,GBR,2000.0,7,12,-5
MLI,FRA,2019.0,8,6,2
PAK,IRQ,2017.0,1,2,-1
IRL,ISR,2020.0,5,2,3
DEU,ZAF,2002.0,12,24,-12
NLD,AUS,1998.0,10,5,5
CHE,TWN,2012.0,6,3,3
USA,ISL,2020.0,8,9,-1
IND,HUN,2018.0,5,2,3
ESP,MAR,2017.0,12,7,5
ITA,SRB,2010.0,2,2,0
CHN,AUT,2002.0,8,4,4
GBR,MWI,2018.0,16,18,-2
SRB,BIH,2011.0,13,6,7
GBR,SAU,2003.0,19,14,5
DNK,RUS,2008.0,6,1,5
ZMB,USA,2019.0,6,13,-7
FIN,EST,2006.0,6,2,4
NOR,NLD,2011.0,8,21,-13
IND,NZL,2019.0,11,13,-2
FIN,ARE,2019.0,1,1,0
TZA,SWE,2017.0,5,1,4
RWA,USA,2011.0,4,2,2
NZL,FRA,2002.0,7,4,3
BEL,BOL,2010.0,2,1,1
ARM,RUS,2000.0,4,1,3
ROU,JPN,2011.0,1,2,-1
CHE,ETH,2019.0,4,6,-2
CHE,DZA,2019.0,3,1,2
ISR,JPN,2014.0,2,3,-1
THA,KOR,2013.0,6,8,-2
TZA,ETH,2020.0,2,1,1
TZA,DEU,2019.0,2,12,-10
KOR,CZE,2016.0,3,2,1
ITA,SRB,2017.0,4,5,-1
ROU,GRC,2011.0,3,2,1
EST,SWE,2012.0,1,8,-7
FIN,NOR,2001.0,8,2,6
TTO,GBR,2006.0,1,2,-1
IDN,PHL,2014.0,1,1,0
NZL,SGP,2005.0,3,7,-4
SWE,TZA,2013.0,3,1,2
CHN,IRN,2016.0,4,23,-19
TTO,USA,2020.0,7,4,3
ITA,ARG,2022.0,6,11,-5
MLI,FRA,2010.0,3,4,-1
TUR,DEU,2001.0,6,5,1
CHE,ARG,2011.0,4,4,0
BEL,TZA,2021.0,2,1,1
USA,UZB,2017.0,3,1,2
FRA,MCO,2010.0,6,4,2
KHM,CHE,2011.0,2,1,1
USA,BWA,2016.0,6,6,0
FRA,LAO,2020.0,4,2,2
AUS,ZAF,1997.0,3,1,2
PHL,SGP,2014.0,4,3,1
LBY,GBR,2011.0,1,5,-4
CAN,SVK,2011.0,4,1,3
ESP,NOR,2000.0,3,2,1
SRB,MKD,2011.0,2,7,-5
FRA,CZE,1997.0,5,2,3
IDN,HKG,2021.0,1,1,0
TUR,DNK,2005.0,1,1,0
SVK,FRA,2009.0,5,4,1
BLR,GBR,2004.0,2,1,1
MKD,ITA,2015.0,1,1,0
QAT,BEL,2018.0,1,2,-1
HUN,FIN,2018.0,3,4,-1
NZL,TUR,2018.0,1,5,-4
MMR,THA,2013.0,1,1,0
MEX,NZL,2019.0,3,2,1
SVN,NOR,2011.0,1,1,0
PRT,PAK,2018.0,1,3,-2
IND,GHA,2015.0,2,2,0
ITA,SRB,2019.0,5,5,0
EST,AUS,2017.0,1,2,-1
NZL,AUT,2005.0,1,3,-2
TWN,NPL,2010.0,1,1,0
BRN,PAK,2018.0,1,1,0
KAZ,JPN,2010.0,1,1,0
JOR,ITA,2009.0,1,1,0
NZL,KNA,2013.0,1,1,0
EGY,LBY,2020.0,2,3,-1
POL,SVK,2012.0,1,6,-5
KAZ,JPN,2017.0,2,3,-1
NZL,ZAF,2009.0,3,12,-9
IDN,BGD,2010.0,1,1,0
AUS,MNG,2021.0,1,2,-1
GTM,USA,2004.0,1,5,-4
CHL,CRI,2020.0,2,3,-1
MLI,GIN,2009.0,1,2,-1
HRV,NLD,2011.0,1,5,-4
KOR,PRT,2018.0,1,1,0
AUS,RUS,1997.0,2,5,-3
POL,CHN,2001.0,1,3,-2
PHL,THA,2013.0,1,1,0
RWA,NLD,2019.0,1,1,0
EGY,SYR,2021.0,1,3,-2
,RUS,2002.0,6607,0,6607
TWN,,2008.0,2382,0,2382
JPN,,2015.0,21733,0,21733
,CHL,2004.0,1399,0,1399
,NLD,2003.0,5424,0,5424
VEN,,2011.0,467,0,467
,USA,1998.0,156259,0,156259
,IND,1995.0,5131,0,5131
CHN,,2006.0,10306,0,10306
,RUS,2005.0,7078,0,7078
DNK,,2021.0,3563,0,3563
HRV,,2022.0,2090,0,2090
DEU,,2020.0,26220,0,26220
CUB,,2008.0,300,0,300
,BGR,2004.0,431,0,431
ITA,,2002.0,801,0,801
,USA,1997.0,31809,0,31809
,FRA,2008.0,14291,0,14291
MYS,,2024.0,21506,0,21506
BRA,,2018.0,13542,0,13542
BEL,,2022.0,6126,0,6126
CZE,,2008.0,699,0,699
CMR,,2022.0,633,0,633
,ESP,1995.0,8677,0,8677
,IRL,2008.0,1716,0,1716
,SVK,2002.0,697,0,697
,CHL,1996.0,415,0,415
,CHE,2012.0,4563,0,4563
HUN,,2016.0,1087,0,1087
,SEN,2014.0,158,0,158
,BRA,2009.0,18505,0,18505
,IDN,2003.0,347,0,347
IRN,,2014.0,2766,0,2766
OMN,,2023.0,698,0,698
CHL,,2012.0,650,0,650
ITA,,2005.0,3353,0,3353
PER,,2016.0,178,0,178
,BGR,1996.0,295,0,295
,MEX,2015.0,5090,0,5090
IND,,2006.0,3083,0,3083
,TUN,2018.0,962,0,962
,MKD,1999.0,75,0,75
SAU,,2016.0,729,0,729
PAN,,2019.0,45,0,45
GHA,,2023.0,1744,0,1744
,SVK,2005.0,786,0,786
NPL,BGD,2009.0,1,0,1
,HUN,2009.0,1524,0,1524
ARG,,2000.0,60,0,60
COG,,2024.0,227,0,227
MAR,,2013.0,284,0,284
PHL,PAK,2019.0,2,0,2
LBN,,2012.0,100,0,100
TUR,FIN,2006.0,3,0,3
SGP,MMR,2003.0,3,0,3
,HKG,2007.0,1412,0,1412
,CIV,2013.0,103,0,103
PRI,,2023.0,395,0,395
CIV,,2015.0,91,0,91
FIN,GHA,2015.0,4,0,4
,ISR,2007.0,2307,0,2307
,ISL,2007.0,133,0,133
SAU,KWT,2005.0,5,0,5
JPN,MAC,2018.0,1,0,1
,ARM,2011.0,139,0,139
,MYS,2013.0,5802,0,5802
SGP,,2003.0,247,0,247
AZE,,2022.0,425,0,425
,LBN,2011.0,333,0,333
,UGA,2012.0,297,0,297
,TZA,2011.0,187,0,187
SWE,,2006.0,1357,0,1357
,GEO,2010.0,141,0,141
,PAN,2010.0,52,0,52
SLV,,2017.0,6,0,6
,BGD,2007.0,603,0,603
,CYP,2016.0,208,0,208
PRT,OMN,2017.0,2,0,2
KAZ,ITA,2011.0,1,0,1
,LTU,2012.0,581,0,581
HKG,,2025.0,16,0,16
,AFG,2007.0,5,0,5
,PSE,2001.0,31,0,31
AND,,2024.0,17,0,17
IRN,POL,2018.0,7,0,7
TWN,NPL,2019.0,1,0,1
,GTM,2015.0,38,0,38
,PYF,2015.0,10,0,10
,FSM,2015.0,3,0,3
IRN,NGA,2020.0,1,0,1
,TCD,2016.0,13,0,13
,BMU,2004.0,3,0,3
,MLI,2018.0,31,0,31
,MDG,2018.0,71,0,71
,PAN,2019.0,32,0,32
,PAN,2017.0,63,0,63
,ZMB,2007.0,52,0,52
VEN,DEU,2015.0,8,0,8
PAN,,2017.0,27,0,27
MAC,NZL,2012.0,1,0,1
CAN,FJI,2003.0,2,0,2
ZAF,LBY,2016.0,1,0,1
,NCL,2001.0,10,0,10
NGA,NAM,2018.0,1,0,1
,SLE,2014.0,40,0,40
,NIC,2014.0,17,0,17
,LVA,2000.0,105,0,105
PAN,,2010.0,10,0,10
,COG,2009.0,70,0,70
HKG,CZE,2016.0,2,0,2
,GEO,2017.0,126,0,126
PAK,BRN,2011.0,1,0,1
TCD,,2022.0,16,0,16
ALB,,2009.0,7,0,7
LVA,,2008.0,37,0,37
NGA,TWN,2007.0,1,0,1
HRV,ISR,2006.0,1,0,1
ZAF,CIV,2011.0,3,0,3
KWT,,2007.0,63,0,63
KEN,NAM,2011.0,1,0,1
KHM,,2009.0,9,0,9
TUN,CHN,2001.0,1,0,1
ZWE,,2007.0,22,0,22
LTU,,2003.0,29,0,29
ZAF,TUN,2011.0,1,0,1
DEU,MNE,2005.0,3,0,3
DEU,ERI,2003.0,1,0,1
CHN,HUN,2001.0,4,0,4
LIE,,2008.0,7,0,7
COL,KEN,2001.0,1,0,1
RUS,SGP,1998.0,1,0,1
BLR,,2001.0,29,0,29
ISR,CHE,2006.0,9,0,9
,TGO,1995.0,5,0,5
RUS,FLK,2000.0,1,0,1
LKA,DNK,2002.0,1,0,1
CAF,GUF,2022.0,1,0,1
ITA,TZA,2018.0,3,0,3
IRQ,,2003.0,3,0,3
BRA,COL,1999.0,1,0,1
SRB,TWN,2009.0,1,0,1
ITA,MCO,2018.0,2,0,2
DEU,IDN,2002.0,4,0,4
IND,OMN,2003.0,5,0,5
,BRN,1994.0,13,0,13
GAB,FRA,1997.0,1,0,1
MWI,NLD,2003.0,5,0,5
NZL,COL,2011.0,2,0,2
NZL,,2001.0,16,0,16
BEL,MKD,2014.0,2,0,2
,QAT,2003.0,66,0,66
ESP,PRI,2003.0,1,0,1
POL,LIE,2011.0,2,0,2
JPN,BLR,2007.0,2,0,2
NER,,2016.0,24,0,24
ERI,,2011.0,2,0,2
,DOM,2005.0,9,0,9
CHE,TZA,2004.0,2,0,2
ZWE,GBR,2015.0,4,0,4
ESP,CPV,2021.0,1,0,1
USA,DMA,2009.0,1,0,1
ESP,HTI,2014.0,1,0,1
VEN,SLV,2007.0,1,0,1
CHE,PYF,2018.0,1,0,1
SAU,CHL,2015.0,1,0,1
HUN,EGY,2006.0,7,0,7
NGA,GRD,2012.0,1,0,1
MYS,VUT,2014.0,1,0,1
PRT,THA,2019.0,2,0,2
AUT,COL,2010.0,1,0,1
GRC,JOR,2015.0,2,0,2
GAB,CMR,2012.0,1,0,1
FJI,MAR,2021.0,1,0,1
MTQ,GBR,2021.0,1,0,1
SLB,,2022.0,13,0,13
CHE,GRD,2018.0,1,0,1
GEO,ESP,2016.0,1,0,1
JPN,JOR,2006.0,1,0,1
KOR,MEX,2020.0,4,0,4
,MUS,2001.0,13,0,13
ITA,SDN,2006.0,1,0,1
FRA,ARM,2003.0,3,0,3
,HND,2007.0,8,0,8
BGD,VNM,2016.0,1,0,1
ISR,KAZ,2015.0,1,0,1
IND,ETH,2001.0,1,0,1
PHL,BEL,2006.0,3,0,3
PRT,BHS,2014.0,1,0,1
OMN,NGA,2016.0,2,0,2
GMB,KHM,2018.0,1,0,1
MEX,IDN,2021.0,1,0,1
,GRD,2011.0,21,0,21
BRA,MLT,2015.0,3,0,3
RUS,GRC,2022.0,2,0,2
,GEO,2019.0,33,0,33
SLV,,2019.0,8,0,8
GEO,,1999.0,10,0,10
,COD,1999.0,6,0,6
BEN,,2007.0,5,0,5
HUN,PRT,2010.0,2,0,2
CAN,SLE,2016.0,1,0,1
ARG,ZAF,2003.0,1,0,1
ISR,CRI,2003.0,1,0,1
PER,DEU,2022.0,3,0,3
MOZ,DNK,2016.0,1,0,1
ZAF,NAM,2005.0,1,0,1
BRA,ARE,2007.0,1,0,1
PRI,AUS,2006.0,1,0,1
FRA,ECU,2008.0,2,0,2
JPN,TZA,2005.0,6,0,6
CIV,DEU,2014.0,1,0,1
JOR,KWT,2006.0,2,0,2
MUS,KWT,2004.0,1,0,1
ITA,TUN,2006.0,4,0,4
CMR,SWE,2007.0,2,0,2
CAN,VNM,2004.0,1,0,1
TUR,KOR,2016.0,5,0,5
UZB,CAN,2005.0,1,0,1
DZA,MYS,2003.0,1,0,1
IRL,NOR,2022.0,2,0,2
TUN,JPN,2011.0,2,0,2
ECU,ARE,2019.0,1,0,1
PER,BOL,2015.0,1,0,1
VNM,CHL,2015.0,2,0,2
QAT,JPN,2021.0,1,0,1
LBN,IND,2012.0,1,0,1
LAO,NPL,2019.0,1,0,1
URY,PRT,2009.0,1,0,1
CAF,TUN,2019.0,1,0,1
GNQ,GIN,2022.0,1,0,1
TUR,OMN,2019.0,2,0,2
VNM,IND,2015.0,1,0,1
ITA,ARM,2020.0,1,0,1
BRA,TUR,2016.0,2,0,2
DOM,COL,2021.0,2,0,2
COG,BDI,2021.0,1,0,1
PAK,IRQ,2019.0,2,0,2
CHE,TUN,1997.0,1,0,1
NZL,CHE,2000.0,3,0,3
SEN,BEN,2010.0,4,0,4
MEX,NZL,2010.0,5,0,5
YEM,GBR,2022.0,1,0,1
KGZ,DEU,2000.0,1,0,1
TGO,BFA,2019.0,3,0,3
NLD,LAO,2006.0,2,0,2
AGO,,2013.0,4,0,4
JPN,ZMB,2015.0,2,0,2
TWN,POL,2022.0,1,0,1
,SWZ,2009.0,7,0,7
FRA,UZB,2012.0,1,0,1
ARM,PHL,2017.0,1,0,1
ROU,CHN,2018.0,1,0,1
ZWE,SWE,2017.0,1,0,1
USA,UZB,2019.0,3,0,3
SDN,SWE,2021.0,1,0,1
SWE,GEO,2021.0,1,0,1
SRB,DNK,2018.0,1,0,1
ESP,JOR,2006.0,1,0,1
CZE,NPL,2006.0,1,0,1
SAU,PNG,2017.0,1,0,1
SRB,NLD,2000.0,2,0,2
BHR,EGY,1997.0,1,0,1
BGR,SRB,2004.0,3,0,3
DEU,MYS,2004.0,3,0,3
PAK,FJI,2014.0,1,0,1
GBR,NPL,2002.0,1,0,1
IRQ,CHN,2004.0,1,0,1
UKR,ISR,2000.0,5,0,5
URY,JPN,2003.0,1,0,1
NZL,NOR,1999.0,2,0,2
ZMB,JPN,2003.0,2,0,2
AUS,FJI,1998.0,1,0,1
CHL,SVK,2002.0,1,0,1
KGZ,,2003.0,6,0,6
,BMU,1996.0,5,0,5
NAM,GBR,2008.0,1,0,1
CHN,BEN,2010.0,1,0,1
,ATG,2005.0,2,0,2
ARE,CHE,2004.0,1,0,1
CHE,CMR,2005.0,1,0,1
SVK,AZE,2009.0,3,0,3
MYS,CZE,2018.0,3,0,3
VEN,DNK,2013.0,1,0,1
NGA,BRN,2022.0,1,0,1
BGR,ZWE,2018.0,1,0,1
BEL,PRY,2015.0,1,0,1
SEN,COG,2017.0,1,0,1
AUT,IRQ,2015.0,1,0,1
AUT,MKD,2007.0,1,0,1
PRI,MWI,2009.0,1,0,1
USA,SEN,2022.0,3,0,3
FIN,ISL,2015.0,5,0,5
,DOM,2002.0,5,0,5
,ERI,2008.0,5,0,5
AUT,VNM,2014.0,1,0,1
PLW,JPN,2007.0,1,0,1
UKR,VNM,2010.0,1,0,1
IRQ,PAK,2016.0,2,0,2
SAU,ZAF,1997.0,1,0,1
PRI,CAN,2001.0,2,0,2
BGR,AUT,2013.0,2,0,2
EST,ISR,2004.0,1,0,1
CRI,PAN,2011.0,2,0,2
HKG,IRL,2004.0,4,0,4
BTN,IND,2009.0,1,0,1
VEN,PRI,2011.0,1,0,1
COL,CRI,2011.0,3,0,3
BLR,JPN,2018.0,1,0,1
POL,CYP,2014.0,1,0,1
RUS,YEM,2013.0,1,0,1
USA,VNM,2001.0,2,0,2
JPN,BEN,2014.0,2,0,2
TKM,RUS,2017.0,1,0,1
MLI,BEL,2020.0,1,0,1
MAR,KOR,2019.0,1,0,1
CAN,MDG,2021.0,1,0,1
LKA,GRC,2018.0,1,0,1
FRA,DJI,2020.0,2,0,2
GRL,USA,2012.0,1,0,1
ESP,SVK,2015.0,1,0,1
USA,MNE,2015.0,1,0,1
,GUM,2018.0,5,0,5
SEN,BEN,2019.0,1,0,1
GBR,HND,2016.0,1,0,1
SGP,DNK,2002.0,2,0,2
SRB,JPN,2000.0,1,0,1
KOR,ROU,2006.0,1,0,1
NGA,ISR,2011.0,1,0,1
HTI,MTQ,2008.0,1,0,1
MWI,MMR,2012.0,1,0,1
HUN,LBY,2005.0,1,0,1
NGA,RWA,2008.0,1,0,1
NGA,MAR,2011.0,1,0,1
TTO,GRD,2012.0,1,0,1
,SAU,2020.0,10,0,10
GAB,SLE,2017.0,1,0,1
MDV,,2021.0,1,0,1
QAT,BHR,2019.0,1,0,1
SVN,BRA,2020.0,1,0,1
MLT,SRB,2003.0,1,0,1
KAZ,BLR,2018.0,1,0,1
MAR,ARG,2020.0,1,0,1
CZE,ISL,2018.0,1,0,1
ARG,CHN,2022.0,1,0,1
FRO,,2013.0,1,0,1
JPN,PRY,2007.0,1,0,1
MEX,ECU,2008.0,1,0,1
TZA,MLI,2014.0,1,0,1
UKR,HUN,2011.0,1,0,1
ZAF,BHR,2013.0,1,0,1
ARE,KOR,2008.0,1,0,1
SEN,GMB,2021.0,1,0,1
ARG,SLV,2012.0,1,0,1
CYP,CZE,2013.0,1,0,1
TUN,OMN,2015.0,1,0,1
GMB,ZAF,2011.0,1,0,1
MAR,GAB,2019.0,1,0,1
URY,MEX,1998.0,1,0,1
LVA,RUS,2013.0,1,0,1
CAN,CIV,2012.0,2,0,2
GBR,MOZ,1998.0,1,0,1
SWE,CHL,2006.0,1,0,1
MDA,POL,2001.0,1,0,1
RUS,THA,2001.0,1,0,1
ISR,LVA,2008.0,1,0,1
FJI,HUN,2011.0,1,0,1
TWN,PER,2019.0,1,0,1
CHE,BFA,2002.0,1,0,1
DEU,GMB,2001.0,1,0,1
ROU,VEN,1997.0,1,0,1
IRL,ARE,2004.0,1,0,1
SRB,BRA,1999.0,1,0,1
TZA,PAK,2016.0,1,0,1
PER,FIN,2012.0,1,0,1
ISR,ETH,2010.0,1,0,1
IRQ,VNM,2020.0,2,0,2
LUX,QAT,2016.0,1,0,1
ESP,LVA,2019.0,1,0,1
GRC,TUR,2016.0,3,0,3
PAN,SGP,2014.0,1,0,1
KOR,IRQ,2018.0,1,0,1
JOR,FRA,2005.0,1,0,1
KAZ,EST,2000.0,3,0,3
POL,LBY,2004.0,1,0,1
BOL,CHE,2009.0,1,0,1
BGR,AUS,2011.0,1,0,1
ROU,IRQ,2009.0,1,0,1
BLR,BRA,2006.0,1,0,1
BFA,TGO,2018.0,2,0,2
PRI,JPN,2004.0,1,0,1
ROU,PRT,1997.0,1,0,1
THA,PHL,2004.0,1,0,1
NLD,BGD,2012.0,2,0,2
EGY,PRT,2008.0,1,0,1
PLW,,2012.0,1,0,1
TUR,BGD,2012.0,1,0,1
USA,PNG,2010.0,2,0,2
YEM,CZE,2005.0,1,0,1
LBR,PAK,2017.0,1,0,1
OMN,ISR,2014.0,1,0,1
AUT,SDN,2010.0,1,0,1
SVN,QAT,2018.0,1,0,1
NOR,KAZ,2022.0,1,0,1
CHN,MMR,2016.0,2,0,2
IND,BRN,2013.0,1,0,1
BRA,CPV,2018.0,1,0,1
DEU,MLI,2011.0,1,0,1
MYS,GHA,2016.0,1,0,1
ESP,LVA,2017.0,1,0,1
BLR,KGZ,2022.0,1,0,1
FRA,PRY,2004.0,1,0,1
ITA,LVA,2018.0,1,0,1
BEL,SYR,2011.0,1,0,1
FIN,ARE,2010.0,2,0,2
IND,SRB,2007.0,1,0,1
DZA,TUR,2014.0,1,0,1
BWA,FRA,2017.0,1,0,1
SEN,CZE,1999.0,1,0,1
BDI,BEL,2005.0,1,0,1
KOR,MMR,2008.0,1,0,1
NGA,SWE,2013.0,1,0,1
TGO,MLI,2016.0,1,0,1
LTU,KWT,2010.0,1,0,1
PAK,IRQ,2010.0,1,0,1
CZE,ECU,2020.0,1,0,1
,REU,2012.0,2,0,2
DZA,MEX,2012.0,1,0,1
GRC,BWA,2009.0,1,0,1
CHN,CRI,2018.0,1,0,1
NLD,LBN,2020.0,1,0,1
KOR,DNK,2008.0,4,0,4
SEN,BFA,2012.0,2,0,2
SVK,MEX,2018.0,1,0,1
MLT,,2003.0,2,0,2
BRA,VEN,2010.0,1,0,1
TUR,SVK,2020.0,1,0,1
JPN,BOL,1998.0,1,0,1
THA,HKG,2007.0,1,0,1
FRA,BHR,2001.0,1,0,1
SUR,,2003.0,1,0,1
AUS,ZMB,2006.0,1,0,1
DNK,SAU,2008.0,1,0,1
CAF,CAN,2006.0,1,0,1
GBR,AFG,2003.0,1,0,1
BWA,CHL,2020.0,1,0,1
SGP,TUR,2005.0,1,0,1
VEN,KOR,2018.0,1,0,1
PRY,BRA,2006.0,1,0,1
NZL,ARG,2014.0,1,0,1
KEN,SWE,2007.0,1,0,1
ISR,MNE,2009.0,1,0,1
LKA,LAO,2013.0,1,0,1
NGA,SLE,2011.0,2,0,2
UZB,DEU,2018.0,3,0,3
FRO,BEL,2013.0,1,0,1
BRA,JOR,2007.0,1,0,1
RWA,LKA,2003.0,1,0,1
SAU,AUT,2000.0,1,0,1
PRT,OMN,2019.0,1,0,1
JPN,CRI,2011.0,1,0,1
KEN,TZA,2007.0,1,0,1
AZE,AUT,2018.0,1,0,1
ESP,OMN,2021.0,1,0,1
BEN,BEL,2001.0,2,0,2
GBR,SHN,2012.0,1,0,1
ZMB,ITA,2002.0,1,0,1
ISL,IRL,2007.0,1,0,1
PHL,MMR,2004.0,1,0,1
JPN,ARE,2009.0,2,0,2
NZL,PHL,2009.0,1,0,1
BRA,KOR,2003.0,1,0,1
COL,TWN,2009.0,1,0,1
SGP,COL,2013.0,1,0,1
MAR,CMR,2014.0,1,0,1
ARG,TWN,2008.0,1,0,1
MYS,BRA,2009.0,1,0,1
HUN,HRV,2003.0,1,0,1
PRI,KEN,2012.0,1,0,1
ISR,TWN,2013.0,1,0,1
MAC,PRT,2012.0,1,0,1
KOR,MAC,2012.0,1,0,1
PAK,EST,2013.0,1,0,1
NZL,UGA,2017.0,1,0,1
MAR,IRN,2022.0,1,0,1
PSE,,2005.0,4,0,4
SVK,ISR,2007.0,1,0,1
TUR,MAR,2002.0,1,0,1
RUS,NZL,2013.0,1,0,1
SRB,SVK,2010.0,1,0,1
IND,PRI,2009.0,3,0,3
NLD,PSE,2019.0,1,0,1
NIC,COL,2020.0,1,0,1
CRI,GBR,2020.0,3,0,3
,BRB,2016.0,6,0,6
KOR,LKA,2009.0,1,0,1
JPN,LVA,2005.0,1,0,1
CHE,TUN,1998.0,1,0,1
BLR,DNK,2011.0,1,0,1
SYR,POL,2012.0,1,0,1
GUM,USA,2014.0,3,0,3
DEU,MCO,2011.0,1,0,1
SVK,BRA,2009.0,1,0,1
CHN,SVN,2014.0,1,0,1
UKR,SVN,2012.0,1,0,1
IRN,HRV,2022.0,2,0,2
TUN,EST,2021.0,1,0,1
SAU,BRN,2011.0,1,0,1
FJI,SAU,2016.0,1,0,1
AUS,NPL,2003.0,1,0,1
DEU,SLB,2018.0,1,0,1
GEO,NLD,2012.0,1,0,1
DZA,HRV,2020.0,1,0,1
POL,MLT,2014.0,1,0,1
BRN,PNG,2011.0,1,0,1
FLK,,2015.0,1,0,1
BEN,TGO,2002.0,1,0,1
FRA,SRB,1999.0,2,0,2
AUS,FJI,1997.0,1,0,1
BGD,BWA,2007.0,1,0,1
RUS,SYR,2006.0,1,0,1
NOR,VNM,2010.0,2,0,2
USA,KNA,2006.0,1,0,1
LKA,KOR,2013.0,1,0,1
UGA,,2001.0,1,0,1
BLR,ESP,2003.0,1,0,1
ZWE,NLD,2001.0,1,0,1
BEL,BOL,2017.0,1,0,1
SEN,GIN,2011.0,1,0,1
PER,FRA,1997.0,1,0,1
ZWE,SWE,2010.0,1,0,1
ARE,ETH,2017.0,1,0,1
SEN,SWE,2018.0,1,0,1
URY,SWE,2013.0,1,0,1
FJI,USA,2003.0,1,0,1
ISR,BLR,1999.0,1,0,1
VEN,PER,2008.0,1,0,1
LTU,POL,2004.0,1,0,1
POL,JAM,2014.0,1,0,1
AUS,PYF,2022.0,1,0,1
IRQ,KWT,2010.0,1,0,1
IND,ROU,2017.0,1,0,1
HND,ARG,2015.0,1,0,1
FIN,PHL,2016.0,1,0,1
CZE,BLR,2019.0,1,0,1
CHN,BEN,2019.0,1,0,1
MYS,UGA,2020.0,1,0,1
SEN,NCL,2019.0,1,0,1
SAU,PHL,2022.0,2,0,2
TTO,NZL,2010.0,1,0,1
GBR,GRD,2020.0,1,0,1
UKR,IRN,2016.0,1,0,1
BGD,GMB,2017.0,1,0,1
NGA,IDN,2022.0,1,0,1
UKR,ZAF,2016.0,1,0,1
DEU,CAF,2009.0,1,0,1
SVN,BEL,2001.0,1,0,1
IDN,LAO,2020.0,1,0,1
CHL,TWN,2012.0,1,0,1
PER,KOR,2016.0,1,0,1
MYS,ISR,2012.0,1,0,1
SWE,MLT,2020.0,1,0,1
UKR,BRA,2022.0,1,0,1
ARG,DZA,2020.0,1,0,1
NOR,KEN,2003.0,1,0,1
NOR,GHA,2008.0,1,0,1
CUB,QAT,2001.0,1,0,1
DEU,SAU,2002.0,1,0,1
CZE,NOR,2001.0,1,0,1
ZAF,THA,2007.0,1,0,1
DEU,JAM,2015.0,1,0,1
ECU,DEU,1998.0,1,0,1
,CPV,2007.0,1,0,1
SVK,BEL,1997.0,1,0,1
UKR,HKG,2015.0,1,0,1
COL,DNK,2007.0,1,0,1
SVK,TUN,2016.0,1,0,1
SAU,IRQ,2022.0,1,0,1
GUM,AUS,2021.0,1,0,1
LVA,CHN,2005.0,1,0,1
KEN,RWA,2004.0,1,0,1
RUS,MKD,1997.0,1,0,1
COL,RUS,2008.0,1,0,1
BRB,TTO,2005.0,1,0,1
ZAF,FIN,2004.0,1,0,1
IRQ,ITA,2006.0,1,0,1
IRN,CHL,2011.0,1,0,1
FIN,JOR,2018.0,1,0,1
SWE,UKR,2022.0,1,0,1
BWA,USA,2001.0,1,0,1
MDG,GBR,2005.0,1,0,1
ITA,PHL,2001.0,1,0,1
DEU,KWT,2022.0,1,0,1
DEU,TGO,2011.0,1,0,1
,MSR,2015.0,2,0,2
PRT,BEL,1997.0,1,0,1
IRL,KOR,2004.0,1,0,1
TWN,SLB,2012.0,1,0,1
BEL,GHA,2022.0,1,0,1
DEU,QAT,2002.0,1,0,1
ARE,SVK,2018.0,1,0,1
GUM,PHL,2019.0,1,0,1
AGO,ITA,2021.0,1,0,1
SYR,YEM,2022.0,1,0,1
BEL,AUS,2008.0,7,12,-5
USA,DEU,2004.0,963,1076,-113
SAU,EGY,2015.0,183,161,22
GBR,IND,2006.0,83,111,-28
CHE,NLD,2008.0,47,48,-1
GBR,NLD,2004.0,129,128,1
JPN,USA,2007.0,1019,964,55
USA,IND,2005.0,304,601,-297
COD,COG,2009.0,6,13,-7
USA,THA,2018.0,198,89,109
POL,SWE,2014.0,29,12,17
FRA,MTQ,2021.0,15,10,5
CHE,AUS,2012.0,55,43,12
SWE,DNK,2017.0,87,97,-10
DEU,NOR,2004.0,28,18,10
NOR,TZA,2013.0,3,5,-2
CAN,HKG,1997.0,3,1,2
FRA,ESP,2014.0,169,304,-135
LUX,DEU,2015.0,11,25,-14
FRA,USA,2001.0,553,456,97
IND,USA,2011.0,872,618,254
DEU,FIN,2015.0,52,46,6
ISR,USA,2004.0,346,190,156
USA,JPN,1998.0,263,249,14
AUS,CHN,2018.0,371,401,-30
POL,DEU,2016.0,81,64,17
MEX,GBR,2014.0,31,44,-13
ITA,CAN,2014.0,65,36,29
PAK,CAN,2008.0,13,7,6
USA,ZAF,2014.0,105,75,30
MEX,DEU,2009.0,36,28,8
GBR,ITA,2018.0,349,564,-215
IRN,CAN,2021.0,270,37,233
ROU,ITA,2007.0,10,11,-1
SWZ,ZAF,2015.0,1,4,-3
AUT,DEU,2009.0,213,245,-32
USA,ISR,2005.0,196,325,-129
FRA,CHE,2015.0,341,240,101
SGP,CHN,2015.0,264,243,21
JOR,USA,2017.0,35,63,-28
POL,NOR,2014.0,21,3,18
DNK,RUS,2007.0,1,6,-5
AUS,GBR,2011.0,409,576,-167
USA,IND,2002.0,245,489,-244
SAU,MYS,2013.0,13,46,-33
GRC,FRA,2018.0,46,36,10
AUS,DEU,2009.0,103,131,-28
FRA,SWE,2006.0,29,42,-13
GBR,CAN,2001.0,188,147,41
MYS,SAU,2009.0,6,3,3
CHE,TZA,2015.0,4,4,0
KOR,SGP,2011.0,16,11,5
POL,GBR,2019.0,72,63,9
PRT,SVN,2011.0,1,2,-1
RUS,USA,2022.0,58,42,16
TUR,KAZ,2017.0,10,5,5
USA,POL,2005.0,87,129,-42
USA,EGY,2009.0,104,56,48
DEU,CHN,2006.0,124,94,30
GBR,CHN,2014.0,325,259,66
LBY,IND,2018.0,4,1,3
DEU,SGP,2013.0,46,14,32
ZAF,GBR,2004.0,53,50,3
BRA,DNK,2009.0,5,3,2
ESP,ARG,2016.0,74,48,26
NLD,ITA,2011.0,55,91,-36
MAC,JPN,2013.0,1,1,0
KOR,USA,2016.0,690,868,-178
IDN,MYS,2020.0,24,62,-38
DEU,TWN,2018.0,11,20,-9
ZMB,BEL,2006.0,2,2,0
CHN,PAK,2013.0,46,44,2
BEL,ITA,2017.0,66,102,-36
MEX,CHL,2016.0,15,19,-4
DNK,NLD,2017.0,27,56,-29
ESP,CAN,2015.0,76,40,36
CMR,BEN,2020.0,1,1,0
JOR,USA,2019.0,40,60,-20
USA,NZL,2014.0,103,102,1
FRA,NLD,2014.0,101,122,-21
FRA,SGP,2017.0,23,19,4
THA,USA,2016.0,100,218,-118
IRL,GBR,2021.0,181,209,-28
BEL,GBR,2021.0,99,112,-13
HRV,FRA,2017.0,7,9,-2
MWI,GBR,2019.0,13,14,-1
CHE,GBR,2014.0,260,270,-10
HKG,TWN,2019.0,20,14,6
CHN,KOR,2022.0,92,115,-23
AUT,USA,2018.0,126,121,5
TJK,JPN,2015.0,1,1,0
THA,IND,2016.0,7,9,-2
SGP,SWE,2017.0,11,9,2
USA,RUS,2012.0,118,140,-22
DNK,IDN,2010.0,1,1,0
CAN,FRA,1998.0,33,38,-5
USA,ETH,2018.0,27,22,5
TUR,AUS,2011.0,6,7,-1
LBN,USA,2014.0,70,49,21
GBR,BEL,2022.0,52,63,-11
POL,GRC,2013.0,3,8,-5
SGP,HKG,2013.0,27,28,-1
THA,ITA,2014.0,5,1,4
FRA,DZA,2021.0,32,35,-3
ISR,TUR,2014.0,2,4,-2
USA,ISR,2002.0,267,334,-67
ESP,ITA,2015.0,161,138,23
POL,USA,2020.0,96,64,32
BEL,CAN,2013.0,31,28,3
BRA,FRA,2020.0,131,94,37
IND,DEU,2015.0,150,117,33
BGD,USA,2020.0,103,65,38
ISR,FRA,2016.0,22,31,-9
IRQ,CHN,2015.0,1,10,-9
USA,HUN,2004.0,64,61,3
IND,MEX,2016.0,14,6,8
ZAF,SAU,2010.0,18,1,17
FRA,BFA,2013.0,11,7,4
DEU,AUS,2022.0,34,75,-41
NLD,CHL,2017.0,9,9,0
VEN,ECU,2020.0,22,7,15
AUS,BRA,2016.0,39,42,-3
ITA,ARE,2018.0,9,5,4
UKR,FRA,2020.0,8,2,6
POL,GBR,2010.0,60,41,19
ESP,CHE,2020.0,111,77,34
FRA,TWN,2013.0,11,13,-2
FRA,NCL,2014.0,12,10,2
BGD,JPN,2007.0,24,34,-10
CHN,THA,2013.0,6,5,1
BEL,ESP,2016.0,45,73,-28
JPN,KHM,2019.0,3,1,2
KHM,JPN,2021.0,2,4,-2
ECU,ESP,2018.0,30,58,-28
GHA,NLD,2021.0,3,2,1
ECU,ARG,2020.0,10,1,9
BEL,GRC,2019.0,20,25,-5
MEX,ITA,2018.0,17,16,1
IND,POL,2019.0,23,4,19
FRA,AUT,2020.0,43,31,12
SGP,AUS,2007.0,62,41,21
CHE,BGD,2018.0,2,3,-1
MYS,IRN,2013.0,102,98,4
CHN,IND,2016.0,29,129,-100
POL,GBR,2017.0,101,53,48
RUS,SWE,2016.0,9,20,-11
FRA,JPN,2013.0,93,71,22
BRA,ARG,2019.0,38,28,10
DNK,ISR,2019.0,2,5,-3
NLD,SWE,2020.0,64,63,1
FRA,CAN,2022.0,106,79,27
DNK,ESP,2021.0,20,27,-7
CHN,IRL,2013.0,14,21,-7
IND,AUS,2007.0,47,17,30
KOR,CAN,2001.0,17,9,8
KWT,CAN,2016.0,9,11,-2
NOR,CHE,2022.0,8,11,-3
IND,TWN,2020.0,85,43,42
RUS,KAZ,2021.0,30,17,13
CHN,SDN,2019.0,11,7,4
PRT,CHN,2020.0,12,6,6
SWE,AUT,2016.0,20,24,-4
AUT,PAK,2014.0,19,10,9
BTN,CAN,2019.0,1,1,0
GMB,USA,1999.0,1,1,0
PRT,AUT,2016.0,10,3,7
CHN,MAC,2015.0,55,28,27
ARG,ESP,2022.0,30,13,17
USA,PAK,2013.0,59,69,-10
BEL,ETH,2020.0,8,1,7
DEU,BEL,2022.0,42,42,0
PAK,AUS,2022.0,17,10,7
ITA,PAK,2020.0,17,18,-1
GBR,JPN,2021.0,92,60,32
IND,POL,2017.0,15,10,5
CAN,MYS,2021.0,7,19,-12
TUR,SAU,2021.0,7,4,3
GRC,AUS,2010.0,1,4,-3
NGA,RUS,2021.0,4,2,2
DEU,CAN,2003.0,137,106,31
CHE,DEU,2011.0,371,645,-274
USA,JAM,2020.0,4,7,-3
USA,MWI,2007.0,4,1,3
ESP,FIN,2007.0,5,7,-2
SAU,PAK,2020.0,63,81,-18
SLE,CHN,2021.0,2,3,-1
DOM,CUB,2020.0,1,2,-1
FRA,RUS,2006.0,35,46,-11
PRT,BRA,2018.0,132,128,4
DNK,FRA,2012.0,40,21,19
JPN,CHN,1998.0,40,50,-10
USA,HTI,2015.0,9,5,4
ESP,AUT,2011.0,18,17,1
SAU,IND,2002.0,5,10,-5
ITA,SGP,2015.0,14,4,10
THA,DEU,2011.0,12,25,-13
JPN,GBR,2007.0,112,90,22
NOR,DEU,2011.0,29,53,-24
RUS,DEU,2000.0,106,58,48
GRC,BEL,2014.0,18,7,11
LUX,USA,2013.0,4,6,-2
KEN,DNK,2012.0,2,2,0
IRN,CHE,2012.0,22,6,16
CHE,PRT,2006.0,7,7,0
TUR,CAN,2007.0,12,12,0
GBR,TUR,2008.0,32,15,17
CRI,USA,2008.0,9,10,-1
DEU,TCD,2017.0,1,1,0
GRC,CYP,2012.0,30,7,23
DEU,THA,2013.0,30,15,15
BEL,CHE,2017.0,58,47,11
GBR,SWE,2006.0,64,109,-45
AUS,EGY,2020.0,10,14,-4
BEL,CHE,2019.0,70,37,33
PRT,GBR,2009.0,53,54,-1
GRC,ESP,2015.0,17,11,6
IND,CHE,2008.0,27,12,15
FRA,SGP,2019.0,36,20,16
ESP,CZE,2016.0,18,7,11
GBR,KOR,2011.0,46,26,20
DNK,CHE,2014.0,29,31,-2
AUS,FRA,2012.0,65,115,-50
GBR,GMB,2005.0,6,8,-2
USA,CYP,2014.0,17,10,7
JPN,BEL,2012.0,13,20,-7
TWN,FRA,2014.0,12,9,3
BEL,SAU,2016.0,4,5,-1
TWN,KOR,2002.0,5,4,1
PRT,CAN,2017.0,8,6,2
SVN,HUN,2016.0,1,1,0
NZL,VNM,2016.0,3,2,1
COL,CAN,2018.0,9,4,5
CHL,DEU,1998.0,4,3,1
POL,IND,2003.0,4,1,3
VEN,ESP,2004.0,20,16,4
AUS,NLD,2002.0,34,21,13
SWE,GBR,2003.0,87,91,-4
CHE,IND,2013.0,26,38,-12
CHL,CHE,2011.0,4,3,1
AUT,EGY,2005.0,4,1,3
ITA,ESP,2000.0,22,28,-6
THA,FRA,2011.0,10,19,-9
USA,MEX,2002.0,183,174,9
JPN,CAN,2007.0,79,58,21
BEL,SWE,2014.0,18,17,1
ITA,NLD,2002.0,52,57,-5
BEL,FRA,2001.0,88,96,-8
VNM,NLD,2018.0,4,6,-2
ARE,AUS,2020.0,13,25,-12
ARG,NLD,2017.0,5,3,2
RUS,ETH,2019.0,16,17,-1
SAU,KOR,2021.0,6,15,-9
KOR,TWN,2015.0,8,11,-3
JPN,CHN,1997.0,19,30,-11
HUN,LUX,2021.0,1,1,0
FJI,NZL,2018.0,4,3,1
AUT,IRN,2014.0,7,12,-5
PAK,IND,2012.0,31,18,13
THA,CHE,2020.0,5,2,3
ARG,NLD,2019.0,7,3,4
CHE,IRL,2020.0,9,14,-5
CHN,CZE,2022.0,5,10,-5
TUR,SGP,2019.0,3,6,-3
SWE,NOR,2001.0,33,32,1
IRL,RUS,2007.0,1,3,-2
NGA,COG,2020.0,1,1,0
SVN,DNK,2020.0,1,1,0
SWE,PAK,2012.0,4,2,2
HRV,DEU,2019.0,14,8,6
GHA,CHN,2021.0,15,54,-39
CHL,USA,2007.0,50,70,-20
IND,NOR,2011.0,9,4,5
KEN,GBR,2016.0,24,14,10
PAN,USA,2007.0,8,12,-4
FRA,VEN,1999.0,4,1,3
LBN,FRA,2015.0,30,66,-36
IND,FJI,2017.0,3,3,0
NPL,GBR,2014.0,9,10,-1
DNK,NLD,2019.0,43,40,3
ISL,NOR,2014.0,6,6,0
GBR,CZE,2006.0,26,35,-9
USA,GHA,2021.0,18,20,-2
DNK,NLD,2010.0,10,22,-12
NLD,CHE,2022.0,49,33,16
FIN,GBR,2012.0,40,51,-11
BEL,ITA,2010.0,29,64,-35
TUR,KAZ,2019.0,5,6,-1
NLD,HRV,2015.0,1,3,-2
SRB,SGP,2016.0,3,1,2
KWT,EGY,2003.0,6,2,4
SGP,ITA,2016.0,8,10,-2
NLD,CHL,2019.0,7,14,-7
UKR,RUS,2005.0,34,29,5
CAN,GRC,2006.0,11,5,6
DEU,CZE,2016.0,51,53,-2
BRA,URY,2013.0,6,1,5
KEN,BEL,2018.0,5,6,-1
NOR,SRB,2019.0,1,1,0
USA,ARE,2012.0,57,10,47
DZA,FRA,2008.0,27,41,-14
PAK,SAU,2005.0,9,5,4
ITA,SVN,2018.0,13,8,5
GBR,NOR,2005.0,42,23,19
RUS,GEO,2003.0,2,6,-4
MEX,CAN,2004.0,12,21,-9
ROU,DEU,2007.0,25,20,5
GBR,PRT,1999.0,21,7,14
LAO,FRA,2012.0,3,3,0
GBR,NOR,2002.0,46,38,8
GBR,IRN,2003.0,40,16,24
RUS,ITA,2000.0,15,22,-7
CHE,SVK,2005.0,2,4,-2
ARG,FRA,1999.0,4,8,-4
DEU,HRV,2016.0,17,21,-4
GBR,GMB,2002.0,8,10,-2
RUS,NLD,2007.0,12,7,5
CAN,DNK,2004.0,11,19,-8
ITA,BEL,2006.0,29,30,-1
DEU,CHL,2007.0,21,12,9
NLD,IRN,2005.0,2,5,-3
UGA,KEN,2017.0,6,6,0
CAN,SWE,2004.0,26,27,-1
EGY,GBR,1998.0,2,1,1
ISR,DEU,2002.0,33,41,-8
JPN,TWN,2007.0,38,21,17
GRC,POL,2011.0,4,1,3
UKR,GBR,2004.0,7,7,0
BFA,USA,2002.0,2,3,-1
GBR,NGA,2006.0,14,13,1
JAM,USA,2009.0,4,3,1
CHE,AUT,1999.0,17,11,6
FRA,HRV,2001.0,5,1,4
ETH,SWE,1999.0,1,1,0
UKR,RUS,2002.0,46,45,1
BRA,ARG,2010.0,25,17,8
NGA,FRA,2002.0,1,3,-2
SGP,QAT,2019.0,3,1,2
FRA,PRT,1999.0,11,4,7
ESP,CHL,1998.0,7,1,6
JPN,ZMB,2004.0,1,1,0
CAN,FRA,1997.0,25,12,13
USA,JOR,2004.0,24,10,14
NLD,SGP,2014.0,21,7,14
TWN,NLD,2011.0,9,2,7
CAN,AUT,2007.0,11,14,-3
DEU,BGR,2000.0,4,14,-10
BEL,ITA,2019.0,79,117,-38
ZAF,AUS,1999.0,11,7,4
CAN,TWN,2000.0,5,2,3
HND,MEX,2006.0,2,1,1
FIN,JPN,1998.0,1,2,-1
ITA,SAU,2016.0,21,6,15
JPN,NZL,2011.0,4,8,-4
NOR,JPN,2000.0,3,1,2
USA,SAU,1998.0,5,6,-1
MMR,USA,2019.0,6,4,2
ZAF,BRA,2003.0,2,2,0
CIV,FRA,2001.0,13,16,-3
PRT,ITA,2000.0,3,1,2
DEU,MYS,2015.0,5,11,-6
SGP,DEU,2011.0,17,30,-13
ZAF,ITA,2005.0,3,2,1
CHL,ARG,2008.0,13,12,1
IND,BGD,2005.0,10,7,3
ZAF,IRL,2015.0,5,1,4
CHE,CZE,2006.0,6,7,-1
HKG,NZL,2015.0,9,2,7
NLD,RUS,2002.0,15,27,-12
TUR,ITA,2008.0,6,1,5
CZE,JPN,2015.0,6,8,-2
CAN,HKG,1998.0,10,2,8
JOR,USA,2010.0,20,41,-21
GBR,HKG,2006.0,26,42,-16
NOR,CHN,2000.0,1,3,-2
SWE,ISL,2000.0,5,3,2
USA,MAC,2020.0,13,5,8
NZL,DNK,2004.0,6,3,3
GBR,IRL,1997.0,17,11,6
SAU,GBR,1999.0,4,6,-2
JPN,POL,2006.0,7,6,1
FIN,EGY,2022.0,1,3,-2
SWE,IND,2012.0,10,40,-30
CYP,USA,2014.0,10,17,-7
CHL,BRA,2011.0,13,15,-2
USA,PER,2007.0,22,29,-7
ARE,LBN,2003.0,1,1,0
JPN,NLD,2008.0,18,13,5
GBR,TTO,2016.0,3,3,0
EGY,BEL,2017.0,4,2,2
USA,BOL,2018.0,7,2,5
GBR,JOR,2013.0,18,6,12
NZL,DEU,2011.0,27,28,-1
IND,IRL,2008.0,9,2,7
PNG,AUS,2012.0,9,5,4
BOL,DEU,2007.0,3,1,2
CZE,DEU,2007.0,27,24,3
SRB,GBR,2019.0,8,6,2
NLD,GRC,2021.0,10,14,-4
BRN,MYS,2011.0,2,3,-1
SGP,QAT,2017.0,3,1,2
AUT,FRA,2020.0,31,43,-12
SGP,SAU,2009.0,2,1,1
MYS,DEU,2015.0,11,5,6
MYS,PSE,2013.0,5,1,4
NOR,SRB,2010.0,4,2,2
MEX,IND,2013.0,4,7,-3
NLD,NOR,2014.0,25,12,13
VNM,AUS,2019.0,29,54,-25
ZAF,UGA,2011.0,3,1,2
BOL,USA,2012.0,6,1,5
DEU,PAN,2015.0,1,3,-2
TUR,SGP,2010.0,1,1,0
MYS,SDN,2014.0,5,3,2
THA,PAK,2013.0,15,3,12
ETH,ZAF,2013.0,4,3,1
TUR,NLD,2013.0,25,14,11
CHN,PRT,2009.0,8,4,4
ESP,TUR,2014.0,6,8,-2
NLD,TWN,2011.0,2,9,-7
IRN,ITA,2013.0,32,11,21
IDN,USA,2019.0,13,28,-15
ESP,ROU,2014.0,4,7,-3
LUX,AUS,2021.0,2,5,-3
BGR,CHE,2015.0,5,7,-2
CZE,SWE,2021.0,10,14,-4
RUS,ETH,2017.0,17,2,15
THA,HKG,2008.0,1,1,0
IDN,USA,2017.0,21,52,-31
MDG,FRA,2011.0,13,9,4
OMN,GBR,2012.0,4,10,-6
NGA,TUR,2022.0,2,2,0
NZL,MYS,2018.0,11,21,-10
COL,VEN,2020.0,13,29,-16
MEX,CHE,2004.0,1,6,-5
FIN,CAN,2006.0,15,6,9
NLD,BRA,2021.0,19,40,-21
JPN,PHL,2009.0,16,10,6
ITA,NLD,2005.0,40,43,-3
ETH,USA,2001.0,2,1,1
BGD,AUT,2003.0,1,1,0
SVN,CHE,2012.0,5,1,4
AUS,NLD,2005.0,24,27,-3
USA,ARM,2018.0,3,4,-1
ITA,MAR,2001.0,5,3,2
EGY,MYS,2014.0,8,2,6
IRL,FIN,2020.0,4,6,-2
USA,SAU,1997.0,6,1,5
TUR,ISR,2014.0,4,2,2
BRA,ZAF,2015.0,8,1,7
AUT,THA,2011.0,6,2,4
SWE,PRT,2014.0,10,17,-7
THA,NZL,2015.0,5,2,3
SRB,GBR,2010.0,7,7,0
GRC,AUS,2017.0,7,5,2
CAN,FIN,2004.0,7,17,-10
SRB,ALB,2016.0,5,4,1
CUB,ESP,2006.0,14,15,-1
FRA,KOR,2020.0,34,32,2
AUT,AUS,2011.0,25,20,5
DEU,UZB,2014.0,3,3,0
CHE,NZL,2022.0,4,5,-1
AUT,RUS,2017.0,6,7,-1
ZAF,CAN,2002.0,17,12,5
JPN,IRL,2009.0,9,3,6
SGP,NOR,2020.0,4,1,3
EST,USA,2021.0,6,7,-1
MWI,GBR,2010.0,8,9,-1
NOR,PRT,2016.0,6,9,-3
ESP,CRI,2004.0,5,2,3
MMR,MYS,2017.0,1,4,-3
RUS,IRL,2022.0,16,1,15
ZAF,SAU,2017.0,6,2,4
PRY,USA,2011.0,2,2,0
CAN,KOR,1999.0,4,10,-6
ESP,URY,2021.0,7,5,2
KOR,ZAF,2015.0,3,1,2
IRN,SVK,2020.0,5,1,4
VEN,GBR,2015.0,8,2,6
IRQ,MYS,2015.0,7,46,-39
PAK,BRA,2013.0,6,7,-1
ARG,NLD,2010.0,1,4,-3
AFG,USA,2017.0,6,3,3
BRA,RUS,2000.0,1,6,-5
SGP,THA,2018.0,6,4,2
USA,GEO,2004.0,11,7,4
DEU,BIH,2015.0,2,2,0
CAN,VNM,2015.0,2,1,1
GEO,DEU,2003.0,2,3,-1
KOR,PAK,2005.0,1,2,-1
JPN,LKA,2003.0,6,2,4
NLD,IRL,2006.0,9,3,6
ZWE,GBR,2004.0,5,4,1
CAN,ROU,2004.0,1,7,-6
HUN,DNK,2001.0,5,1,4
UZB,KOR,2016.0,1,2,-1
JPN,RUS,1997.0,11,3,8
AUS,SWE,1998.0,4,4,0
USA,BMU,2015.0,1,3,-2
KWT,IND,2000.0,3,1,2
FRA,ECU,2007.0,1,2,-1
IDN,AUS,2003.0,6,12,-6
IND,BRA,2000.0,2,1,1
ITA,CHL,2012.0,5,6,-1
KEN,USA,2000.0,5,6,-1
BEL,SVK,2012.0,1,3,-2
NGA,BWA,2014.0,3,2,1
NGA,FRA,2005.0,2,1,1
PRI,DEU,2006.0,1,1,0
URY,ARG,2006.0,3,2,1
KAZ,RUS,2000.0,5,3,2
IRL,ARE,2015.0,1,1,0
IRL,SGP,2014.0,5,8,-3
IND,BGD,2002.0,11,2,9
GRC,DNK,2022.0,5,3,2
UGA,KEN,2019.0,8,7,1
BEL,IRN,2006.0,1,2,-1
ZAF,CHN,2009.0,6,5,1
BEL,ARE,2015.0,2,1,1
QAT,FRA,2019.0,1,10,-9
GRC,ISR,2008.0,3,1,2
QAT,SGP,2019.0,1,3,-2
USA,NIC,2018.0,1,3,-2
NZL,IND,2011.0,7,9,-2
BEL,MEX,2005.0,5,3,2
CAN,LBY,2014.0,2,1,1
SRB,SWE,2011.0,2,1,1
CAN,CZE,2012.0,8,5,3
JPN,VNM,2006.0,10,2,8
EGY,KOR,2011.0,7,6,1
FIN,PAK,2017.0,2,5,-3
GBR,BGD,2015.0,6,12,-6
PSE,SAU,2015.0,2,1,1
BEL,CHL,2008.0,4,2,2
DEU,KGZ,2002.0,1,1,0
MEX,PRY,2012.0,2,1,1
HUN,IRN,2018.0,1,3,-2
MAR,CHN,2018.0,2,3,-1
HKG,TWN,2017.0,8,15,-7
ISL,DNK,2001.0,2,3,-1
ESP,GRC,2020.0,8,13,-5
THA,MYS,2022.0,3,7,-4
AUT,RUS,2019.0,6,14,-8
PAK,DNK,2016.0,1,1,0
FIN,PAK,2019.0,2,8,-6
ARG,CHL,2009.0,7,8,-1
QAT,CHN,2019.0,3,4,-1
UZB,TUR,2019.0,1,3,-2
SAU,CAN,2003.0,15,12,3
NLD,RUS,2005.0,9,14,-5
QAT,CHE,2015.0,1,1,0
TUR,CHE,2016.0,19,2,17
SVK,ESP,2014.0,1,1,0
ZWE,NGA,2016.0,1,1,0
IRN,HKG,2020.0,4,3,1
ARG,CUB,2013.0,3,2,1
AUS,NZL,1997.0,7,8,-1
MWI,GBR,2017.0,11,23,-12
ITA,ISR,2009.0,11,11,0
IND,CHN,2004.0,8,3,5
COL,NLD,2012.0,9,5,4
CHN,EGY,2016.0,10,9,1
CRI,DEU,2014.0,3,4,-1
HKG,DNK,2016.0,2,1,1
IRL,KOR,2015.0,3,4,-1
SGP,SWE,2019.0,14,8,6
CAN,CMR,2000.0,1,1,0
RUS,AZE,2019.0,8,5,3
PRT,TUR,2020.0,1,6,-5
GBR,OMN,2008.0,9,4,5
ARE,CHE,2015.0,2,5,-3
KWT,GBR,2015.0,9,14,-5
JOR,IND,2022.0,2,1,1
ITA,IRN,2022.0,4,43,-39
EGY,ZAF,2011.0,1,2,-1
BGR,FIN,2016.0,1,1,0
PHL,CHN,2022.0,2,2,0
PAK,BEL,2022.0,1,1,0
AFG,USA,2019.0,2,1,1
USA,BHS,2018.0,4,7,-3
BEL,MEX,2002.0,3,3,0
SVN,AUT,2005.0,2,2,0
DNK,CMR,2010.0,1,1,0
GRC,SWE,2008.0,4,8,-4
IRL,HUN,2006.0,1,1,0
ITA,NGA,2020.0,1,6,-5
PNG,USA,2001.0,3,1,2
NZL,RUS,2011.0,2,1,1
CHE,SVK,2002.0,3,7,-4
CAN,ARG,2009.0,10,13,-3
VEN,ARG,2006.0,1,2,-1
RUS,KGZ,2012.0,2,2,0
AUS,SWE,1997.0,2,1,1
PRT,GRC,2012.0,1,4,-3
PAK,ARE,2013.0,7,1,6
NLD,AUT,2000.0,3,5,-2
AUT,RUS,2010.0,4,8,-4
FIN,LTU,2013.0,3,2,1
FRA,ZAF,1999.0,2,1,1
AUS,GHA,2016.0,6,13,-7
LIE,DEU,2020.0,1,1,0
SWE,TWN,2002.0,1,1,0
ARE,ESP,2009.0,1,2,-1
BRA,CHN,2015.0,5,5,0
CUB,DEU,2014.0,2,2,0
LUX,CHE,2013.0,3,5,-2
OMN,ARE,2021.0,3,1,2
CZE,IND,2012.0,1,5,-4
FIN,SGP,2020.0,4,2,2
ISR,DNK,2012.0,6,1,5
BRA,CUB,2008.0,4,3,1
SRB,GBR,2017.0,9,8,1
GMB,NGA,2013.0,2,1,1
GMB,AUS,2017.0,1,1,0
FRA,KHM,2014.0,2,4,-2
HRV,FRA,2019.0,6,7,-1
TWN,MNG,2021.0,1,1,0
ZAF,FIN,2015.0,3,4,-1
IRL,QAT,2020.0,5,3,2
MNG,JPN,2004.0,2,2,0
BIH,USA,2015.0,1,1,0
AUS,OMN,2016.0,3,4,-1
BHR,GBR,2015.0,2,3,-1
MEX,DNK,2014.0,7,2,5
JPN,KEN,2009.0,6,2,4
POL,ITA,1999.0,5,4,1
IRL,PRT,2016.0,6,6,0
DNK,ZAF,2013.0,5,2,3
NOR,ETH,2015.0,2,4,-2
PRT,NZL,2012.0,1,1,0
NOR,MWI,2014.0,1,1,0
NZL,CHL,2022.0,2,1,1
BRA,SWE,2000.0,3,2,1
EGY,KWT,2018.0,4,8,-4
ESP,CHL,1997.0,5,4,1
GBR,BGR,2000.0,4,10,-6
URY,CHL,2020.0,6,3,3
AZE,RUS,2021.0,5,1,4
DNK,EGY,1998.0,2,1,1
BRA,GRC,2007.0,2,1,1
PRT,CAN,2010.0,1,2,-1
VEN,DEU,2004.0,3,1,2
SGP,BGD,2019.0,4,1,3
FRA,MRT,2007.0,1,2,-1
SAU,AUS,1999.0,1,1,0
NZL,KOR,2002.0,1,2,-1
GRC,KOR,2012.0,1,1,0
KEN,TZA,2008.0,2,4,-2
SRB,HUN,2014.0,2,1,1
YEM,SAU,2022.0,10,5,5
CZE,NLD,2008.0,5,6,-1
SGP,MYS,1998.0,1,1,0
BEL,GRC,2017.0,7,26,-19
CHL,BEL,2011.0,3,7,-4
PRT,TUN,2016.0,1,1,0
SAU,IDN,2021.0,3,1,2
MYS,PRT,2017.0,3,1,2
AUS,LBN,2020.0,4,2,2
CHN,LBN,2019.0,2,1,1
TWN,DEU,2005.0,6,11,-5
NOR,BRA,2022.0,5,6,-1
PAK,JPN,2012.0,4,10,-6
MTQ,FRA,2007.0,14,15,-1
LKA,ZAF,2012.0,2,1,1
PHL,IND,2001.0,2,5,-3
MEX,RUS,2001.0,3,19,-16
BRA,ZWE,2011.0,1,1,0
USA,BIH,2016.0,1,1,0
AFG,USA,2010.0,3,1,2
KEN,MLI,2014.0,1,1,0
NLD,IRN,2002.0,2,5,-3
POL,AUS,1999.0,2,1,1
ITA,VNM,2012.0,2,1,1
TUR,PRT,2016.0,2,4,-2
ECU,COL,2014.0,1,1,0
HRV,AUT,2009.0,3,3,0
BGR,IRL,2014.0,3,1,2
ECU,FRA,2009.0,1,2,-1
USA,VEN,2009.0,22,25,-3
CHN,KAZ,2019.0,3,5,-2
THA,LAO,2012.0,2,2,0
ESP,TWN,2014.0,3,3,0
IRQ,AUS,2020.0,6,37,-31
JPN,KHM,2017.0,3,2,1
BGR,TWN,2015.0,1,1,0
CMR,AUS,2017.0,1,2,-1
COL,MEX,2000.0,3,2,1
UGA,NAM,2019.0,1,1,0
ETH,FRA,2021.0,1,4,-3
CHN,UZB,2019.0,1,3,-2
USA,MYS,2020.0,18,48,-30
NOR,ISR,2020.0,4,2,2
NOR,NPL,2011.0,1,5,-4
IRQ,CAN,2016.0,2,2,0
CHN,RUS,2008.0,1,5,-4
GRC,RUS,2000.0,1,6,-5
FRA,JOR,2012.0,2,2,0
BGR,ESP,2001.0,3,3,0
SWE,HRV,2022.0,1,1,0
AUT,BIH,2007.0,2,1,1
POL,CZE,2004.0,2,4,-2
USA,TZA,1999.0,2,1,1
BGR,RUS,2000.0,3,3,0
PRT,BLR,2009.0,1,1,0
ZAF,THA,2008.0,1,1,0
JOR,OMN,2003.0,2,2,0
DEU,ARM,2000.0,3,2,1
DNK,ISR,2010.0,2,2,0
NLD,BGR,2019.0,2,1,1
USA,GUM,2004.0,2,3,-1
SGP,UKR,2014.0,1,1,0
IRN,EGY,2022.0,1,3,-2
QAT,DEU,2013.0,1,7,-6
PRI,MEX,2018.0,1,1,0
RUS,POL,2016.0,4,14,-10
IRQ,USA,2013.0,6,10,-4
FIN,BRA,2020.0,3,16,-13
PRT,IRN,2022.0,1,12,-11
KOR,DNK,2007.0,2,2,0
LVA,DEU,2020.0,2,1,1
KEN,CHN,2014.0,3,4,-1
FRA,COL,2001.0,3,1,2
BRB,GBR,2003.0,1,1,0
AUT,ESP,2000.0,3,2,1
ITA,MKD,2013.0,1,1,0
ESP,THA,2017.0,1,2,-1
BFA,SEN,2020.0,2,2,0
PRI,IND,2011.0,3,3,0
JAM,CAN,2011.0,1,4,-3
LTU,POL,2015.0,2,1,1
KWT,ARE,2001.0,2,1,1
FRA,NZL,2022.0,6,10,-4
DNK,KOR,2022.0,3,3,0
ECU,AUS,2011.0,1,1,0
EST,GBR,2001.0,4,3,1
FRA,URY,2016.0,2,2,0
ARE,DEU,1999.0,1,1,0
TWN,DEU,2002.0,1,8,-7
IND,POL,2010.0,4,1,3
IND,FJI,2019.0,3,1,2
HUN,MAR,2017.0,1,1,0
BIH,ITA,2009.0,1,1,0
BRA,IRN,2018.0,3,7,-4
TWN,DNK,2006.0,1,1,0
CZE,MEX,2013.0,3,3,0
TUN,ARE,2022.0,4,2,2
BEL,IDN,2012.0,1,2,-1
CHL,FIN,2019.0,2,1,1
KOR,TUR,2019.0,2,6,-4
HKG,AUT,2022.0,2,1,1
DNK,CRI,2017.0,2,1,1
AUS,QAT,2021.0,5,6,-1
LKA,JPN,2020.0,2,11,-9
MKD,DEU,2013.0,1,1,0
ROU,ZAF,2012.0,2,1,1
CRI,CAN,2015.0,4,3,1
CHE,IDN,2011.0,1,2,-1
CMR,CAN,2021.0,3,3,0
SWE,ISR,2022.0,2,2,0
SAU,IND,2005.0,3,10,-7
MEX,CHN,2015.0,3,1,2
ARM,DEU,2009.0,2,1,1
PER,NLD,2016.0,1,1,0
ZAF,RUS,2018.0,2,1,1
KOR,NGA,2021.0,2,5,-3
FRA,SVK,2021.0,2,6,-4
ARG,NOR,2019.0,1,1,0
NLD,ZWE,2022.0,1,1,0
CYP,NGA,2022.0,1,1,0
CUB,GBR,2020.0,1,1,0
IND,NGA,2006.0,1,4,-3
LBN,SAU,2022.0,1,1,0
JAM,TTO,2021.0,1,2,-1
BRB,CAN,2011.0,1,2,-1
QAT,SGP,2017.0,1,3,-2
BLR,CAN,2000.0,1,1,0
MLT,CAN,2017.0,2,1,1
CHL,FIN,2017.0,2,4,-2
PRT,SAU,2019.0,1,1,0
GTM,USA,2015.0,4,11,-7
JPN,EST,2017.0,1,1,0
BEL,ROU,2021.0,2,4,-2
EGY,BEL,2010.0,4,4,0
UGA,CHE,2015.0,4,2,2
SWE,JOR,2011.0,1,1,0
SEN,USA,2015.0,4,5,-1
AUS,VEN,2003.0,2,1,1
UGA,FRA,2018.0,2,3,-1
CUB,ITA,2018.0,2,1,1
PSE,EGY,2020.0,4,4,0
MYS,PRT,2019.0,2,3,-1
ITA,PRT,1998.0,2,1,1
QAT,FRA,2017.0,1,8,-7
USA,TTO,2001.0,1,5,-4
USA,BRN,2004.0,1,2,-1
GEO,RUS,2012.0,1,2,-1
USA,PSE,2013.0,3,2,1
CHL,BOL,2014.0,1,3,-2
BHR,KWT,2019.0,2,1,1
CAN,SRB,2014.0,2,1,1
KEN,SWE,2008.0,1,1,0
BGR,GBR,2022.0,1,1,0
POL,ROU,2021.0,3,1,2
MYS,FIN,2021.0,2,2,0
SVK,ROU,2017.0,1,2,-1
DNK,ISR,2017.0,2,3,-1
ARG,RUS,2016.0,1,1,0
BEN,NLD,2020.0,2,1,1
NZL,HRV,2019.0,1,1,0
AFG,IRN,2018.0,1,3,-2
CHE,PER,2009.0,1,2,-1
SAU,SWE,2006.0,1,5,-4
KOR,TUR,2017.0,1,5,-4
JPN,ARG,2002.0,1,2,-1
GMB,AUS,2019.0,1,1,0
SGP,SWE,2010.0,4,8,-4
IND,LKA,2021.0,2,1,1
SGP,NLD,2001.0,1,1,0
ZAF,ITA,2002.0,1,2,-1
ISR,BEL,2004.0,1,8,-7
BOL,BRA,2003.0,2,1,1
COL,ARG,2004.0,2,2,0
KHM,AUS,2009.0,1,1,0
HRV,FRA,2010.0,1,6,-5
URY,FRA,2012.0,1,8,-7
IRL,IRN,2011.0,3,6,-3
ROU,POL,2012.0,1,3,-2
CHN,SDN,2010.0,1,2,-1
ITA,ETH,2018.0,2,2,0
CHN,BRA,2001.0,2,1,1
RUS,ISL,2009.0,1,1,0
LVA,SWE,2016.0,1,1,0
JPN,PRT,2021.0,1,1,0
MAR,GBR,2005.0,2,2,0
NGA,AUS,2006.0,2,2,0
AUT,ARE,2020.0,2,2,0
DNK,JPN,2000.0,3,4,-1
BRA,PRI,2014.0,1,1,0
BGR,BEL,2016.0,1,2,-1
PRT,JPN,2006.0,1,3,-2
ARE,CAN,2003.0,1,10,-9
BEL,THA,2012.0,2,3,-1
TWN,BEL,2011.0,1,1,0
ZAF,ZWE,2006.0,2,12,-10
EGY,BEL,2019.0,2,4,-2
LTU,RUS,2012.0,1,1,0
DEU,BOL,2022.0,1,1,0
AUS,ROU,2012.0,1,2,-1
ESP,THA,2019.0,1,2,-1
CHL,GTM,2020.0,1,1,0
LTU,BEL,2020.0,1,1,0
IND,AFG,2021.0,2,2,0
MYS,FRA,2021.0,3,6,-3
MYS,EGY,2022.0,1,5,-4
EGY,POL,2014.0,1,10,-9
ROU,SRB,2009.0,1,1,0
CZE,SRB,2020.0,2,4,-2
ETH,KEN,2020.0,1,8,-7
MAR,CHE,2016.0,1,1,0
CHE,NGA,2014.0,1,2,-1
KHM,PAK,2019.0,1,1,0
BEL,SRB,2012.0,3,2,1
RUS,TJK,2012.0,1,1,0
JOR,NLD,2009.0,1,1,0
URY,CAN,2009.0,1,2,-1
GBR,TZA,2001.0,1,7,-6
UGA,NGA,2007.0,1,1,0
EGY,PSE,2002.0,1,2,-1
POL,DNK,1998.0,1,5,-4
CHE,UKR,2009.0,1,2,-1
DJI,ESP,2010.0,1,1,0
MYS,CAN,1999.0,1,1,0
DEU,BFA,2013.0,1,2,-1
MMR,USA,2017.0,1,3,-2
SWZ,CHE,2018.0,1,2,-1
DNK,IDN,2019.0,2,1,1
BFA,MLI,2019.0,1,1,0
BWA,CMR,2018.0,1,1,0
TZA,CAN,2004.0,1,2,-1
AUT,TUR,1999.0,1,2,-1
NGA,TWN,2008.0,1,1,0
SVN,AUT,2002.0,2,1,1
AUT,JOR,2014.0,2,1,1
CHE,NCL,2018.0,1,1,0
PER,CHL,2014.0,1,3,-2
HKG,IRL,2015.0,1,1,0
NAM,UGA,2019.0,1,1,0
MLT,GRC,2019.0,1,1,0
AUT,IDN,2015.0,1,3,-2
MLT,CAN,2019.0,1,2,-1
JPN,MYS,1999.0,1,1,0
HKG,USA,2007.0,83,99,-16
IDN,USA,2010.0,16,22,-6
CHE,FRA,2008.0,202,232,-30
IRN,AUS,2011.0,61,29,32
GBR,AUS,2014.0,651,456,195
TUR,USA,2006.0,165,193,-28
CAN,AUS,2007.0,125,108,17
USA,ESP,2020.0,369,453,-84
SWE,DNK,2010.0,79,50,29
ZAF,CAN,2005.0,15,8,7
MEX,FRA,2011.0,28,47,-19
TWN,GBR,2003.0,18,30,-12
SWE,DNK,2019.0,103,102,1
PAK,IRL,2015.0,7,6,1
USA,POL,2002.0,84,142,-58
CHE,ITA,2011.0,81,156,-75
IRN,ZAF,2016.0,6,3,3
SGP,IND,2015.0,53,74,-21
GBR,FIN,2001.0,30,24,6
GBR,IRL,1998.0,23,15,8
CHN,FRA,2012.0,121,122,-1
AUS,IDN,2020.0,64,31,33
BEL,TUR,2022.0,7,4,3
ECU,AUT,2018.0,2,1,1
ESP,KOR,2021.0,4,8,-4
NLD,DNK,2022.0,19,17,2
DEU,UKR,2018.0,15,35,-20
DEU,GRC,2013.0,41,87,-46
IRL,NLD,2021.0,14,16,-2
FRA,SEN,2011.0,23,18,5
USA,JPN,1997.0,205,130,75
BGD,IND,2020.0,26,23,3
MYS,JPN,2011.0,15,62,-47
BRA,ARG,2017.0,25,32,-7
PRT,CAN,2019.0,13,12,1
ISR,DEU,2005.0,37,20,17
FRA,DEU,2000.0,73,95,-22
ESP,MEX,2005.0,74,40,34
MEX,NLD,2009.0,8,3,5
KEN,MWI,2009.0,1,2,-1
IRN,DNK,2016.0,27,5,22
NOR,USA,2007.0,30,66,-36
ITA,RUS,2003.0,28,25,3
NLD,TUR,2012.0,15,20,-5
FRA,NOR,2006.0,20,8,12
CHN,SDN,2017.0,6,7,-1
ARE,NLD,2022.0,2,3,-1
JPN,NOR,2009.0,5,2,3
GBR,MEX,2001.0,13,15,-2
GBR,UGA,2021.0,10,10,0
USA,MEX,2005.0,132,123,9
VNM,MYS,2020.0,6,16,-10
KOR,AUT,2020.0,8,4,4
SVN,ITA,2021.0,4,11,-7
CHE,KOR,2015.0,5,9,-4
FRA,SGP,2010.0,18,9,9
UGA,SWE,2012.0,1,2,-1
BEL,CHE,2010.0,31,30,1
COG,BEL,2009.0,3,3,0
PRT,NLD,2003.0,9,9,0
BHR,USA,2011.0,1,4,-3
VNM,FRA,2002.0,2,3,-1
CUB,DOM,2008.0,2,1,1
AUS,NCL,2018.0,4,4,0
USA,HKG,2001.0,67,70,-3
CHL,DEU,1997.0,1,2,-1
CUB,MEX,2008.0,9,7,2
AUT,JPN,1999.0,3,2,1
RUS,HUN,2018.0,1,2,-1
ROU,ESP,2012.0,6,4,2
HUN,SWE,2018.0,12,4,8
PAK,SAU,2002.0,5,1,4
USA,SVN,2000.0,3,1,2
PRT,USA,2008.0,38,47,-9
JPN,RUS,1998.0,9,15,-6
POL,DNK,1997.0,3,3,0
CHN,ITA,2008.0,11,14,-3
UKR,USA,2012.0,21,19,2
BEL,IRL,2013.0,3,7,-4
AUS,ITA,2014.0,17,37,-20
DNK,CHN,2014.0,35,41,-6
CHN,ZAF,2016.0,6,10,-4
FRA,MYS,2018.0,10,4,6
CAN,BEL,2018.0,37,40,-3
ZAF,SAU,2019.0,11,1,10
NZL,THA,2007.0,3,2,1
KOR,EGY,2012.0,2,12,-10
HRV,DEU,2017.0,15,12,3
USA,ZMB,2016.0,10,22,-12
IDN,DEU,2014.0,12,12,0
AUS,NZL,1998.0,20,22,-2
THA,PHL,2015.0,4,1,3
VNM,AUS,2017.0,18,23,-5
NOR,SGP,2021.0,3,3,0
RUS,ISR,2013.0,4,9,-5
USA,PRI,2022.0,20,24,-4
PRT,CHE,2016.0,18,10,8
PER,JPN,2014.0,4,1,3
IRL,CHN,2005.0,3,6,-3
FRA,SVN,2001.0,1,1,0
LUX,FRA,2018.0,21,24,-3
TUR,SGP,2017.0,8,2,6
BEL,PRT,2012.0,8,6,2
ZAF,TZA,2013.0,8,5,3
COL,JPN,2017.0,3,2,1
ISL,GBR,2020.0,7,4,3
HUN,IND,1999.0,1,3,-2
PER,ESP,2020.0,14,23,-9
CHN,CMR,2020.0,2,1,1
SAU,ARE,2014.0,19,6,13
GBR,BWA,2003.0,6,5,1
GBR,ZWE,2003.0,4,6,-2
RUS,AZE,2017.0,4,4,0
KAZ,USA,2004.0,3,5,-2
ZMB,GBR,1999.0,1,1,0
ISL,AUS,2016.0,2,1,1
ITA,HRV,2007.0,3,1,2
RUS,NGA,2019.0,3,3,0
NLD,CHL,2010.0,4,1,3
IRL,CHN,2002.0,2,3,-1
HKG,TWN,2010.0,5,8,-3
BGR,DEU,2011.0,9,13,-4
CZE,TWN,2016.0,2,2,0
ECU,BRA,2021.0,4,6,-2
CHL,NZL,2006.0,1,2,-1
RUS,AZE,2010.0,4,3,1
ARG,GBR,2009.0,9,8,1
ISR,NLD,2022.0,8,3,5
COL,GBR,2004.0,5,5,0
GRC,JPN,2005.0,3,3,0
BEL,GRC,2010.0,12,12,0
FIN,HKG,2009.0,2,2,0
KAZ,UZB,2015.0,3,2,1
NOR,SAU,2015.0,2,3,-1
TUR,KGZ,2012.0,1,1,0
VNM,FRA,2005.0,3,2,1
RUS,SVN,1997.0,1,1,0
NGA,KEN,2022.0,2,2,0
USA,URY,2001.0,4,7,-3
FIN,NZL,2014.0,2,1,1
AUT,HRV,2013.0,1,7,-6
NLD,TZA,2009.0,6,1,5
ETH,DEU,2009.0,4,3,1
NLD,HUN,2021.0,8,8,0
DZA,USA,2011.0,5,1,4
VNM,AUS,2010.0,6,8,-2
NLD,GHA,2016.0,3,3,0
DEU,LBN,2020.0,6,8,-2
RUS,CHN,2007.0,5,4,1
HRV,CAN,2020.0,4,4,0
KOR,MYS,2009.0,5,2,3
ZAF,POL,2009.0,1,1,0
ARG,CHE,2021.0,4,5,-1
SDN,CHN,2022.0,2,5,-3
HRV,AUS,2011.0,2,1,1
TJK,RUS,2013.0,2,5,-3
DEU,PER,2021.0,1,3,-2
AUS,PRT,2014.0,4,11,-7
BWA,CAN,2013.0,2,1,1
NLD,CRI,2004.0,1,1,0
ARE,FRA,2009.0,1,5,-4
IND,THA,2011.0,4,4,0
COL,JPN,2019.0,1,3,-2
OMN,DEU,2021.0,1,1,0
AUS,PAK,2007.0,2,3,-1
NOR,PAK,2022.0,2,6,-4
COL,JPN,2010.0,1,3,-2
SLE,USA,2013.0,1,4,-3
EGY,DNK,2004.0,2,1,1
DEU,MDA,2020.0,3,1,2
BEL,BGR,2009.0,2,7,-5
GRC,CZE,2009.0,1,1,0
AUT,CZE,2007.0,3,8,-5
NOR,SRB,2017.0,1,2,-1
RUS,EST,2008.0,1,1,0
NLD,COL,2015.0,4,10,-6
UKR,CZE,2008.0,2,3,-1
NGA,ZMB,2020.0,1,1,0
BEL,BFA,2011.0,4,4,0
TWN,KOR,2005.0,3,3,0
ETH,TZA,2020.0,1,2,-1
KAZ,NLD,2013.0,2,1,1
USA,DOM,2006.0,2,1,1
HKG,BGD,2009.0,1,1,0
TZA,CHN,2013.0,1,2,-1
NZL,BGD,2020.0,4,1,3
NZL,NGA,2016.0,1,1,0
DNK,GNB,2006.0,2,3,-1
GBR,PNG,2002.0,2,2,0
EST,NLD,2012.0,1,1,0
GBR,SVK,2000.0,1,3,-2
PYF,FRA,2000.0,2,1,1
IDN,NPL,2018.0,1,1,0
BFA,MLI,2010.0,1,1,0
DEU,PSE,2002.0,1,1,0
NCL,GBR,2018.0,1,1,0
,CAN,1995.0,5853,0,5853
,DZA,1997.0,94,0,94
,MEX,2004.0,3267,0,3267
,JPN,2000.0,33563,0,33563
AUT,,2017.0,1955,0,1955
AUT,,2019.0,2423,0,2423
FIN,,2021.0,2866,0,2866
MYS,,2023.0,14249,0,14249
NLD,,2013.0,3304,0,3304
CHE,,2011.0,2118,0,2118
EGY,,2018.0,1784,0,1784
GHA,,2024.0,3124,0,3124
,FRA,2007.0,14330,0,14330
USA,,2000.0,3130,0,3130
JPN,,2004.0,12329,0,12329
OMN,,2024.0,1167,0,1167
,PRT,1999.0,2184,0,2184
,DZA,1998.0,267,0,267
AUT,,2010.0,1144,0,1144
,TWN,2000.0,5321,0,5321
,MEX,1996.0,1408,0,1408
,ARG,2005.0,2240,0,2240
,NOR,1995.0,917,0,917
ROU,,2018.0,1641,0,1641
BGR,,2014.0,264,0,264
,KOR,1994.0,3412,0,3412
,ISL,2008.0,151,0,151
,ARG,2002.0,2102,0,2102
TUN,,2011.0,376,0,376
IDN,,2020.0,1595,0,1595
,GRC,2010.0,2275,0,2275
,FIN,2006.0,2006,0,2006
,URY,2000.0,168,0,168
,IRN,2012.0,11928,0,11928
,ZMB,2008.0,55,0,55
TWN,,2007.0,1816,0,1816
COG,,2023.0,187,0,187
,COL,2003.0,634,0,634
,ROU,2009.0,2533,0,2533
HKG,,2016.0,1050,0,1050
AUT,NPL,2012.0,1,0,1
,PYF,2004.0,7,0,7
PYF,USA,2007.0,1,0,1
CUB,,2007.0,223,0,223
,HKG,2008.0,1500,0,1500
QAT,,2010.0,38,0,38
,EGY,2011.0,3255,0,3255
KWT,,2008.0,76,0,76
,IRL,2007.0,1579,0,1579
ETH,,2021.0,590,0,590
,ISR,2008.0,2326,0,2326
,SWE,2013.0,3691,0,3691
PRI,,2024.0,464,0,464
,BGD,2008.0,658,0,658
MNG,,2021.0,93,0,93
,NAM,2010.0,29,0,29
,AUS,2018.0,8581,0,8581
,SGP,2018.0,2125,0,2125
ARM,,2022.0,297,0,297
,BIH,2011.0,229,0,229
RWA,,2020.0,55,0,55
,UZB,2010.0,76,0,76
UZB,AUS,2014.0,1,0,1
,PNG,2013.0,20,0,20
,SRB,2014.0,1168,0,1168
,SVN,2018.0,471,0,471
,CHL,2015.0,2133,0,2133
,BGR,2015.0,472,0,472
DZA,,2013.0,191,0,191
UGA,BEL,2013.0,1,0,1
,GRC,2019.0,1326,0,1326
,GHA,2012.0,388,0,388
,NPL,2014.0,340,0,340
,TTO,2016.0,44,0,44
MEX,BOL,2020.0,3,0,3
BRA,ISR,2018.0,5,0,5
,GRC,2017.0,2014,0,2014
NPL,,2013.0,59,0,59
AND,,2023.0,16,0,16
QAT,,2019.0,185,0,185
MAR,BGD,2018.0,1,0,1
SAU,,2025.0,163,0,163
,SOM,2012.0,1,0,1
ARG,CZE,2021.0,3,0,3
QAT,,2017.0,98,0,98
TWN,ETH,2016.0,2,0,2
WLF,FRA,2020.0,1,0,1
GIN,,2018.0,15,0,15
JPN,KHM,2010.0,1,0,1
,NAM,2017.0,50,0,50
CZE,,2007.0,573,0,573
SVN,,2002.0,23,0,23
CHN,KAZ,2017.0,4,0,4
NCL,,2020.0,30,0,30
TLS,,2022.0,8,0,8
,MAR,2018.0,1697,0,1697
,SYR,2014.0,114,0,114
,MCO,2016.0,11,0,11
,UZB,2019.0,74,0,74
,TJK,2016.0,26,0,26
BFA,UGA,2003.0,1,0,1
BMU,USA,2018.0,2,0,2
BIH,ARE,2020.0,2,0,2
,EST,2018.0,256,0,256
,UZB,2017.0,331,0,331
SLE,,2011.0,3,0,3
TUN,CAN,2022.0,4,0,4
GRC,,2003.0,212,0,212
NLD,MDA,2008.0,1,0,1
BRN,,2013.0,7,0,7
KEN,IRL,2019.0,1,0,1
FRA,QAT,2011.0,7,0,7
BRA,LIE,2011.0,1,0,1
PRI,COL,2018.0,2,0,2
,PHL,1994.0,54,0,54
EST,,2002.0,5,0,5
BEL,BEN,2003.0,5,0,5
CZE,CYP,2020.0,1,0,1
MAR,ITA,2003.0,3,0,3
EST,,2005.0,31,0,31
,KGZ,2013.0,17,0,17
,BHR,2009.0,35,0,35
SVK,ROU,2019.0,1,0,1
SWZ,USA,2012.0,1,0,1
IRQ,KAZ,2021.0,1,0,1
BGD,,2006.0,67,0,67
HTI,BEL,2015.0,1,0,1
MAC,FRA,2019.0,2,0,2
LVA,,2007.0,28,0,28
CAN,HTI,2011.0,1,0,1
,VNM,1994.0,55,0,55
COL,KHM,2009.0,2,0,2
TZA,,2014.0,68,0,68
BEL,COG,2008.0,2,0,2
GAB,,2019.0,32,0,32
ZWE,,2008.0,23,0,23
AUT,EGY,2002.0,3,0,3
KEN,PER,2016.0,3,0,3
FRA,SYC,2014.0,2,0,2
ISR,IDN,2017.0,2,0,2
BEN,,2008.0,7,0,7
FRA,GRL,2003.0,1,0,1
CIV,,2004.0,20,0,20
IRQ,SWE,2014.0,2,0,2
KEN,,2002.0,13,0,13
MYS,LBY,2011.0,3,0,3
GRC,PSE,2007.0,1,0,1
SVN,,2005.0,101,0,101
LIE,,2007.0,3,0,3
NGA,LKA,2010.0,1,0,1
CHL,PRI,2003.0,1,0,1
,AGO,1999.0,5,0,5
EGY,PRT,2007.0,1,0,1
MKD,,2009.0,14,0,14
HRV,ESP,2003.0,2,0,2
TWN,VEN,2015.0,1,0,1
JOR,,2005.0,38,0,38
,LUX,2001.0,29,0,29
,BFA,1995.0,20,0,20
PHL,GUM,2008.0,1,0,1
AUS,HRV,2004.0,3,0,3
LVA,SVN,2005.0,1,0,1
NGA,LUX,2001.0,1,0,1
LTU,IRN,2003.0,2,0,2
EGY,TWN,2009.0,1,0,1
USA,MKD,1997.0,1,0,1
POL,AUT,2000.0,2,0,2
GRC,ARE,2014.0,6,0,6
OMN,CHE,2005.0,4,0,4
FIN,MEX,1997.0,1,0,1
USA,ZWE,1999.0,3,0,3
ERI,GBR,2020.0,1,0,1
NZL,KOR,2005.0,6,0,6
NOR,AUT,1998.0,1,0,1
PAK,SVK,2020.0,2,0,2
TWN,MAC,2011.0,1,0,1
PRY,,2014.0,13,0,13
KEN,,2005.0,26,0,26
VUT,,2009.0,2,0,2
CMR,NOR,2009.0,1,0,1
FRA,TTO,2003.0,1,0,1
BRA,ISL,2022.0,1,0,1
,ERI,2007.0,2,0,2
GAB,,2017.0,27,0,27
COL,CHN,2009.0,1,0,1
,HND,2008.0,8,0,8
DNK,TZA,2016.0,2,0,2
HRV,MKD,2015.0,3,0,3
MMR,SGP,2019.0,3,0,3
BRA,MYS,2012.0,1,0,1
NER,MDG,2013.0,1,0,1
TWN,VUT,2014.0,1,0,1
GAB,,2010.0,6,0,6
,CPV,2008.0,3,0,3
KOR,UKR,2018.0,1,0,1
KEN,RWA,2015.0,3,0,3
IRQ,NGA,2020.0,1,0,1
RWA,AUS,2020.0,2,0,2
DNK,CRI,2019.0,2,0,2
IRL,LUX,2021.0,4,0,4
NLD,CUB,2002.0,1,0,1
GHA,ITA,2000.0,1,0,1
RUS,NGA,2010.0,1,0,1
BFA,MLI,2017.0,5,0,5
UGA,GMB,2003.0,1,0,1
HTI,GBR,2019.0,1,0,1
MMR,IND,2016.0,1,0,1
,AFG,2008.0,14,0,14
NOR,ARE,2014.0,2,0,2
,LAO,2009.0,33,0,33
CAN,TZA,2016.0,2,0,2
HRV,HUN,2018.0,5,0,5
KNA,HKG,2022.0,1,0,1
ZMB,ZAF,2004.0,1,0,1
DEU,GEO,2022.0,2,0,2
COL,PAK,2021.0,2,0,2
LSO,,2021.0,16,0,16
JPN,NGA,2014.0,7,0,7
DEU,YEM,2005.0,1,0,1
POL,HRV,2022.0,1,0,1
MDG,,2003.0,4,0,4
,VUT,1998.0,1,0,1
MNE,,2005.0,4,0,4
RUS,CHL,1999.0,1,0,1
FIN,TUR,2004.0,2,0,2
GRC,JPN,2002.0,6,0,6
CAN,PAN,2011.0,3,0,3
TWN,ARG,2004.0,1,0,1
IDN,NZL,2003.0,1,0,1
CUB,BRA,1999.0,3,0,3
SYR,,2003.0,5,0,5
CMR,AUS,2010.0,2,0,2
GBR,BLR,2003.0,6,0,6
JOR,,2002.0,14,0,14
CHE,HKG,2001.0,2,0,2
BEN,GBR,2019.0,3,0,3
FJI,ZMB,2018.0,1,0,1
TTO,,2009.0,19,0,19
TTO,NGA,2013.0,1,0,1
KAZ,ARE,2011.0,1,0,1
TUR,MEX,2014.0,1,0,1
CHE,ECU,2013.0,1,0,1
HUN,PAK,2016.0,2,0,2
,GAB,2009.0,23,0,23
ITA,DZA,2018.0,5,0,5
TUN,CIV,2015.0,1,0,1
BLR,CHL,2003.0,1,0,1
EGY,HKG,2018.0,1,0,1
,TKM,2012.0,6,0,6
ESP,BFA,2020.0,1,0,1
CHE,LTU,2006.0,2,0,2
CHN,CHL,2006.0,1,0,1
SAU,DNK,2014.0,1,0,1
CYP,ARE,2003.0,1,0,1
MUS,,2003.0,4,0,4
EGY,PSE,2005.0,3,0,3
MLT,PRT,2018.0,1,0,1
JOR,QAT,1998.0,2,0,2
NOR,UZB,2020.0,1,0,1
CHN,BLR,2018.0,2,0,2
DEU,MDG,2019.0,1,0,1
URY,ISR,2012.0,2,0,2
ESP,SLV,2007.0,1,0,1
,GTM,2004.0,18,0,18
PER,URY,2020.0,1,0,1
PRY,PRT,2016.0,1,0,1
JPN,CUB,2012.0,2,0,2
CMR,UGA,2010.0,2,0,2
YEM,KWT,2003.0,1,0,1
FRA,ISL,2018.0,3,0,3
BLR,TWN,2018.0,1,0,1
WLF,,2019.0,1,0,1
EGY,LBN,2003.0,1,0,1
CUB,ROU,2007.0,1,0,1
CYP,CHE,2000.0,1,0,1
,ETH,1995.0,10,0,10
,GIN,1995.0,7,0,7
CIV,TUN,2002.0,1,0,1
NLD,NZL,2000.0,3,0,3
PAK,ZAF,2011.0,1,0,1
CAN,QAT,1999.0,1,0,1
NPL,MYS,2006.0,1,0,1
COL,POL,2011.0,2,0,2
COL,AUS,2001.0,2,0,2
CRI,COL,2001.0,1,0,1
KOR,FIN,2011.0,5,0,5
NER,MEX,2015.0,1,0,1
,FSM,2004.0,1,0,1
NGA,MYS,2004.0,1,0,1
CHE,CUB,2005.0,1,0,1
FJI,BRN,2020.0,1,0,1
JOR,YEM,2004.0,1,0,1
BGD,CHN,2009.0,2,0,2
BRB,JAM,2018.0,2,0,2
MMR,SGP,2010.0,1,0,1
MUS,NLD,2011.0,1,0,1
BGD,NPL,2016.0,4,0,4
TWN,FIN,2013.0,1,0,1
HUN,KAZ,2018.0,3,0,3
RUS,ECU,2014.0,1,0,1
FRA,GNQ,2018.0,1,0,1
GBR,MDV,2018.0,1,0,1
SYC,GBR,2021.0,1,0,1
,YEM,1994.0,4,0,4
GMB,DEU,2021.0,1,0,1
USA,NER,2014.0,2,0,2
FRA,PRY,2015.0,1,0,1
GRC,JOR,2004.0,1,0,1
HUN,NOR,2004.0,2,0,2
,ASM,2011.0,2,0,2
JPN,TUN,2014.0,2,0,2
,KNA,2006.0,4,0,4
BIH,CHE,2022.0,1,0,1
,FRO,2018.0,7,0,7
BEL,SWZ,2004.0,1,0,1
CHL,FIN,2010.0,1,0,1
CHL,URY,2022.0,3,0,3
ITA,SVK,2001.0,4,0,4
FRA,PAK,2006.0,2,0,2
BEL,PER,2014.0,4,0,4
JPN,EST,2010.0,1,0,1
ETH,NOR,2001.0,3,0,3
LTU,EST,2009.0,1,0,1
MUS,KEN,2007.0,1,0,1
ARE,HKG,2003.0,1,0,1
MOZ,AUT,2019.0,1,0,1
LAO,,2011.0,6,0,6
MDA,TUR,2018.0,1,0,1
MEX,ECU,2007.0,1,0,1
BIH,AUT,2014.0,2,0,2
DNK,OMN,2014.0,2,0,2
SYR,SAU,2014.0,3,0,3
SYR,DEU,2001.0,1,0,1
BLR,GBR,2015.0,1,0,1
ARE,LUX,2022.0,1,0,1
EST,GRC,2019.0,1,0,1
CHE,BGR,2000.0,1,0,1
NER,NGA,2009.0,2,0,2
FIN,SVN,2001.0,2,0,2
NLD,BGR,2017.0,2,0,2
SGP,QAT,2010.0,2,0,2
MAR,GBR,2002.0,2,0,2
RUS,BGR,2006.0,4,0,4
PAK,MAR,2020.0,1,0,1
AUS,GRL,2017.0,1,0,1
,SYC,2003.0,2,0,2
LBY,QAT,2012.0,1,0,1
ZWE,CAN,2011.0,1,0,1
AUT,ARG,2008.0,2,0,2
CUB,ZAF,2011.0,1,0,1
PLW,JPN,2008.0,2,0,2
BFA,NER,2011.0,1,0,1
NLD,NGA,2011.0,2,0,2
PNG,FRA,2001.0,1,0,1
COL,PAN,2013.0,1,0,1
CZE,CHN,2011.0,3,0,3
PRT,BGD,2015.0,1,0,1
IDN,KOR,2000.0,6,0,6
KOR,MMR,2007.0,1,0,1
,NAM,2019.0,15,0,15
RUS,VEN,1999.0,1,0,1
IRL,SRB,2004.0,1,0,1
AZE,ISR,2007.0,1,0,1
HUN,,2025.0,1,0,1
DZA,SWE,2020.0,2,0,2
GTM,ECU,2018.0,2,0,2
AUS,PRI,2001.0,1,0,1
ISR,KOR,1999.0,1,0,1
JOR,SDN,2010.0,1,0,1
DNK,SAU,2007.0,1,0,1
LTU,FRA,1999.0,1,0,1
GNQ,USA,2009.0,1,0,1
HRV,NPL,2005.0,1,0,1
SYR,IRQ,2009.0,1,0,1
RUS,VNM,1999.0,1,0,1
IND,SEN,2001.0,1,0,1
WSM,NZL,2013.0,1,0,1
JPN,ALB,1997.0,1,0,1
NOR,CHL,2009.0,4,0,4
NLD,CUW,2020.0,6,0,6
AUT,SAU,2006.0,1,0,1
SVK,NOR,2009.0,1,0,1
BOL,ESP,2000.0,3,0,3
SWE,MOZ,2006.0,1,0,1
LBN,CHN,2018.0,2,0,2
ZAF,BRN,2004.0,1,0,1
BWA,MWI,2001.0,1,0,1
PAK,OMN,2008.0,2,0,2
BFA,CAN,1999.0,1,0,1
BEL,ARM,2012.0,1,0,1
FRA,LBY,2014.0,3,0,3
COD,,2014.0,4,0,4
BLR,CHE,2009.0,1,0,1
LBN,POL,2012.0,1,0,1
JPN,ETH,2013.0,1,0,1
KOR,TUR,2010.0,4,0,4
GRC,SAU,2008.0,1,0,1
HTI,CUB,2013.0,2,0,2
USA,AGO,2013.0,1,0,1
NLD,LTU,2020.0,1,0,1
ALB,POL,2017.0,1,0,1
MAR,DNK,2001.0,1,0,1
USA,SLE,2012.0,2,0,2
MKD,ITA,2004.0,1,0,1
LTU,CHE,2013.0,2,0,2
COL,DNK,2008.0,1,0,1
MEX,SAU,2016.0,4,0,4
DZA,VNM,2019.0,1,0,1
GRD,,2014.0,4,0,4
CUB,BEL,2014.0,2,0,2
SRB,MEX,2003.0,1,0,1
HKG,EGY,2002.0,2,0,2
DZA,EGY,2007.0,2,0,2
IRN,ESP,2006.0,1,0,1
SYR,AUT,2014.0,1,0,1
PNG,AUT,2000.0,1,0,1
JPN,MMR,2008.0,1,0,1
TWN,SVK,2001.0,1,0,1
MAR,MEX,2008.0,2,0,2
THA,TWN,2001.0,1,0,1
COL,ECU,2006.0,1,0,1
JPN,OMN,2009.0,2,0,2
GBR,SYC,2010.0,1,0,1
PSE,NLD,2009.0,1,0,1
NPL,MEX,2011.0,1,0,1
DNK,IDN,2017.0,1,0,1
PRT,SAU,2017.0,5,0,5
FRA,CYP,2021.0,4,0,4
GHA,AUS,2007.0,1,0,1
IRN,LBY,2022.0,2,0,2
IND,LVA,2022.0,2,0,2
AZE,CZE,2021.0,1,0,1
DNK,NGA,2017.0,1,0,1
TWN,PRT,2014.0,2,0,2
SGP,TWN,1997.0,1,0,1
CHN,TGO,2018.0,1,0,1
DNK,URY,2012.0,2,0,2
,GUY,1995.0,1,0,1
ZAF,PRI,2020.0,1,0,1
,BLZ,2000.0,2,0,2
NER,DEU,2009.0,2,0,2
LSO,SSD,2015.0,1,0,1
GBR,SYC,2017.0,1,0,1
TWN,BFA,2015.0,1,0,1
NLD,LIE,2015.0,1,0,1
PRY,MEX,2022.0,1,0,1
LBN,BLR,2020.0,1,0,1
CYP,KOR,2017.0,1,0,1
KAZ,DEU,2007.0,1,0,1
SYC,,2021.0,3,0,3
TUR,IND,2008.0,2,0,2
,ABW,2018.0,1,0,1
SGP,BGD,2010.0,1,0,1
YEM,IRL,2015.0,1,0,1
NIU,,2021.0,1,0,1
URY,CHN,2018.0,1,0,1
ITA,PRT,1997.0,1,0,1
LVA,ARE,2012.0,1,0,1
SVN,PAK,2017.0,1,0,1
NIC,DEU,2008.0,1,0,1
PAK,JOR,2003.0,1,0,1
BOL,PER,2006.0,1,0,1
DEU,KGZ,2005.0,1,0,1
ITA,NAM,2003.0,1,0,1
ESP,ISL,2010.0,1,0,1
PHL,URY,2016.0,1,0,1
TUR,HKG,2007.0,1,0,1
MYS,UZB,2000.0,1,0,1
KHM,CUB,2003.0,1,0,1
NIC,SWE,2014.0,1,0,1
POL,MNE,2014.0,1,0,1
ETH,SYR,2012.0,1,0,1
KOR,KEN,2015.0,1,0,1
ARG,ROU,2011.0,1,0,1
IRL,BGD,2006.0,1,0,1
ZMB,PHL,2019.0,1,0,1
ISL,NZL,2017.0,1,0,1
NLD,AFG,2013.0,1,0,1
RUS,PER,2019.0,1,0,1
TUN,HKG,2020.0,1,0,1
GBR,PNG,2005.0,1,0,1
MAR,TGO,2013.0,1,0,1
MNP,USA,2016.0,2,0,2
LVA,USA,1999.0,2,0,2
SEN,NER,2021.0,1,0,1
BLR,BEL,2002.0,1,0,1
IRL,KWT,2013.0,1,0,1
ZWE,KEN,2005.0,1,0,1
KEN,IDN,2008.0,1,0,1
CZE,ROU,2012.0,1,0,1
GRC,NGA,2020.0,1,0,1
HKG,BRA,2020.0,1,0,1
CAN,KAZ,2014.0,1,0,1
,SSD,2018.0,2,0,2
TUR,ROU,2022.0,1,0,1
ISR,SVN,2003.0,2,0,2
USA,LSO,2003.0,1,0,1
CYP,MEX,2016.0,1,0,1
TWN,TUR,2011.0,3,0,3
NOR,GHA,2007.0,1,0,1
ISR,HRV,2013.0,1,0,1
SVN,MAR,2018.0,1,0,1
GBR,BOL,2013.0,1,0,1
LKA,NPL,2012.0,1,0,1
BEL,NPL,2014.0,1,0,1
ITA,IDN,2001.0,1,0,1
NGA,BRA,2012.0,3,0,3
ISR,ISL,2009.0,2,0,2
,MSR,2004.0,1,0,1
NLD,DOM,2022.0,1,0,1
BIH,FRA,2005.0,1,0,1
AUT,LBN,2018.0,1,0,1
GLP,ESP,2007.0,1,0,1
MAC,FRA,2017.0,1,0,1
TUN,EGY,2021.0,1,0,1
ZAF,MAC,2019.0,1,0,1
CHN,MUS,2018.0,1,0,1
BIH,ALB,2016.0,1,0,1
SEN,ITA,2013.0,1,0,1
BGR,SAU,2011.0,1,0,1
CHE,CYP,2015.0,1,0,1
BEL,IRQ,2012.0,1,0,1
IDN,SGP,2003.0,1,0,1
GUY,FRA,2013.0,1,0,1
LBY,FRA,2020.0,1,0,1
MDA,FIN,2016.0,1,0,1
PHL,TWN,2013.0,1,0,1
IRQ,JPN,2012.0,1,0,1
BEL,MLT,2016.0,1,0,1
SWE,NGA,2014.0,1,0,1
EST,MDA,2014.0,1,0,1
JPN,GEO,2008.0,2,0,2
BEL,PNG,2021.0,1,0,1
HUN,GHA,2021.0,1,0,1
CHE,MAR,1999.0,1,0,1
CHE,LAO,2002.0,1,0,1
RUS,LBN,2018.0,1,0,1
ROU,NGA,2019.0,1,0,1
BEN,USA,2015.0,1,0,1
COG,MAR,2014.0,1,0,1
FIN,JPN,1997.0,1,0,1
MEX,TWN,2022.0,2,0,2
SGP,ESP,2004.0,2,0,2
USA,TGO,2014.0,1,0,1
BRA,EST,2018.0,2,0,2
COL,PRY,2011.0,1,0,1
COG,CIV,2007.0,1,0,1
BLR,SWE,2003.0,2,0,2
TUR,BRA,1999.0,1,0,1
CUB,CHN,2017.0,1,0,1
AUS,UZB,2003.0,1,0,1
PAK,ZWE,2013.0,1,0,1
PRT,HRV,2006.0,1,0,1
NGA,DZA,2010.0,1,0,1
SLV,FRA,2005.0,1,0,1
CHL,KAZ,2004.0,1,0,1
NGA,JAM,2016.0,1,0,1
NOR,JOR,2008.0,1,0,1
USA,MRT,2007.0,1,0,1
LBY,LBN,2001.0,2,0,2
MUS,CAN,2006.0,1,0,1
BGD,ZAF,2011.0,1,0,1
,PLW,2011.0,2,0,2
LBN,MAR,2008.0,1,0,1
KGZ,AUS,2018.0,1,0,1
TUN,TUR,2009.0,1,0,1
TCD,FRA,2014.0,1,0,1
TTO,BGD,2009.0,1,0,1
SLV,SWE,2013.0,1,0,1
GNQ,GNB,2015.0,1,0,1
SGP,LKA,2013.0,1,0,1
OMN,CYP,2007.0,1,0,1
TUR,MAC,2022.0,1,0,1
PHL,SEN,2014.0,1,0,1
IRN,LTU,2018.0,1,0,1
MDG,CIV,2019.0,1,0,1
ZWE,NAM,2009.0,1,0,1
BEL,GRL,2017.0,1,0,1
MYS,LSO,2016.0,1,0,1
ISR,HTI,2014.0,1,0,1
NGA,COD,2019.0,1,0,1
NOR,SSD,2020.0,1,0,1
DNK,MOZ,2020.0,1,0,1
BRN,DEU,2017.0,2,0,2
PRT,PER,2014.0,1,0,1
CZE,LAO,2014.0,1,0,1
SVK,SAU,2008.0,1,0,1
FLK,,2004.0,1,0,1
ZAF,BDI,2020.0,1,0,1
HKG,TUR,2014.0,1,0,1
RWA,TZA,2012.0,1,0,1
HND,CRI,2008.0,1,0,1
BLR,FRA,2014.0,1,0,1
CYP,JPN,2019.0,1,0,1
CAN,PHL,1997.0,1,0,1
ISR,ROU,2004.0,1,0,1
IDN,UGA,2009.0,1,0,1
THA,KEN,2003.0,1,0,1
KOR,PAK,2002.0,1,0,1
BEL,HKG,1997.0,1,0,1
VUT,CHE,2004.0,1,0,1
ECU,CHE,2008.0,1,0,1
CIV,USA,2001.0,2,0,2
BWA,SYC,2021.0,1,0,1
AZE,PRT,2011.0,1,0,1
NZL,EST,2010.0,1,0,1
SWE,ZMB,2014.0,1,0,1
SAU,FRA,2001.0,1,0,1
ARE,CZE,2009.0,1,0,1
DZA,MRT,2021.0,1,0,1
KEN,ZWE,2016.0,1,0,1
CRI,JPN,2013.0,1,0,1
SVK,BGR,2001.0,1,0,1
NLD,BIH,2011.0,1,0,1
TUR,HUN,2002.0,1,0,1
CMR,IDN,2016.0,1,0,1
SRB,HKG,2002.0,1,0,1
RUS,TWN,2022.0,1,0,1
CHN,CUB,2006.0,1,0,1
NGA,HUN,2022.0,1,0,1
CZE,PRY,2012.0,1,0,1
ITA,KHM,2003.0,1,0,1
PRT,SAU,2010.0,1,0,1
TTO,ZAF,2020.0,2,0,2
KHM,PAK,2010.0,1,0,1
LKA,GHA,2018.0,1,0,1
USA,GLP,2012.0,1,0,1
JOR,DZA,2018.0,1,0,1
ITA,BGD,2005.0,1,0,1
FRA,TCD,2021.0,1,0,1
POL,GRL,2014.0,1,0,1
MRT,SEN,2013.0,1,0,1
PER,NIC,2018.0,1,0,1
CHE,SLE,2012.0,1,0,1
PER,AUT,2012.0,1,0,1
AZE,ROU,2015.0,1,0,1
SGP,BGD,2017.0,1,0,1
,OMN,2020.0,1,0,1
KAZ,LTU,2021.0,1,0,1
GBR,CHN,2004.0,89,108,-19
IND,FJI,2018.0,3,1,2
AUS,CHN,2017.0,304,367,-63
NLD,GBR,2015.0,330,224,106
USA,HKG,2003.0,72,97,-25
GBR,AUS,2004.0,385,300,85
SWE,NGA,2004.0,1,1,0
CHE,NLD,2013.0,53,81,-28
CHL,MEX,2009.0,9,4,5
USA,DEU,2014.0,1057,1226,-169
GBR,CHE,2012.0,254,182,72
BEL,USA,2012.0,162,141,21
GBR,ITA,2010.0,181,333,-152
DEU,SGP,2008.0,34,13,21
AUT,SGP,2012.0,7,3,4
ESP,GBR,2011.0,252,270,-18
SWE,BEL,2009.0,7,6,1
DNK,GBR,2009.0,47,70,-23
CAN,FIN,2014.0,18,19,-1
CAN,BEL,2010.0,44,42,2
GBR,USA,1999.0,527,493,34
PAK,USA,2009.0,37,48,-11
POL,GBR,2018.0,76,73,3
ARG,NLD,2018.0,5,5,0
USA,THA,2017.0,204,105,99
DNK,ITA,2015.0,20,52,-32
ROU,FRA,2002.0,26,25,1
GRC,FRA,2017.0,39,22,17
MWI,GBR,2018.0,18,16,2
CAN,DEU,2021.0,101,124,-23
ROU,FRA,2005.0,26,23,3
BEL,COG,2013.0,4,6,-2
AUS,MYS,2011.0,73,52,21
MEX,ITA,2017.0,14,17,-3
BEL,FRA,2003.0,145,136,9
SWE,RUS,2020.0,15,18,-3
GBR,NLD,2014.0,218,289,-71
CAN,KWT,2007.0,8,1,7
USA,CHN,2021.0,2747,1973,774
CAN,PAK,2011.0,9,22,-13
JPN,ITA,2005.0,14,14,0
SGP,ESP,2014.0,3,5,-2
GBR,ITA,2019.0,396,485,-89
GBR,ITA,2017.0,268,595,-327
NLD,MWI,2017.0,5,2,3
CHE,GBR,2004.0,92,130,-38
DEU,THA,2008.0,23,17,6
DEU,JPN,2015.0,97,104,-7
DEU,GBR,2002.0,387,363,24
DEU,CAN,2001.0,105,72,33
FRA,ESP,2004.0,118,97,21
SWE,DNK,2018.0,75,93,-18
AUT,USA,2019.0,137,102,35
PRT,USA,2013.0,68,60,8
USA,THA,2010.0,169,112,57
POL,FRA,2009.0,25,29,-4
AUS,CHN,2019.0,396,405,-9
BRA,PRT,2006.0,42,28,14
ITA,IND,2011.0,31,32,-1
GUY,FRA,2008.0,1,1,0
NLD,NOR,2004.0,14,5,9
IND,SAU,2011.0,89,8,81
ETH,ZAF,2008.0,4,3,1
CHE,USA,2007.0,308,334,-26
ARG,ESP,2016.0,48,74,-26
PRT,BRA,2017.0,136,104,32
FRA,CAN,2016.0,360,252,108
KOR,USA,2022.0,306,273,33
IND,KOR,2012.0,165,75,90
ITA,SVN,2017.0,10,4,6
UKR,GBR,2014.0,15,4,11
FRA,JPN,2008.0,60,81,-21
USA,FIN,2020.0,71,81,-10
CHL,ESP,2011.0,51,58,-7
NGA,MYS,2014.0,20,22,-2
GBR,CAN,2003.0,280,228,52
TWN,JPN,2006.0,8,32,-24
PRT,BRA,2019.0,98,158,-60
RUS,USA,2016.0,151,148,3
PAK,CHE,2015.0,3,2,1
FRA,UKR,1999.0,6,5,1
GBR,BEL,2016.0,98,129,-31
USA,THA,2019.0,201,96,105
NLD,BGR,2018.0,2,1,1
AUT,USA,2017.0,129,106,23
BEL,ITA,2018.0,81,115,-34
DEU,BEL,2016.0,90,93,-3
MAR,CHN,2019.0,6,1,5
DEU,AUT,2021.0,285,229,56
JPN,SGP,2020.0,26,23,3
AUT,GBR,2020.0,72,121,-49
CHN,IND,2022.0,68,34,34
FRA,BFA,2008.0,8,8,0
NLD,KOR,2005.0,6,2,4
GRC,SWE,2013.0,22,6,16
DNK,NLD,2018.0,31,44,-13
AUS,IRL,2015.0,35,42,-7
NLD,CHE,2016.0,83,76,7
JOR,USA,2018.0,39,47,-8
CAN,SWE,2014.0,44,33,11
SWE,AUT,2022.0,6,5,1
CHN,KOR,2016.0,93,168,-75
SGP,NZL,2020.0,14,11,3
IDN,USA,2018.0,19,37,-18
FIN,EGY,2016.0,5,2,3
IND,POL,2018.0,13,9,4
SDN,CHN,2016.0,7,7,0
CHE,ISR,1999.0,3,4,-1
SGP,HKG,2008.0,22,21,1
CAN,ZAF,2005.0,8,15,-7
CHE,BEL,2021.0,42,44,-2
USA,ETH,2017.0,15,18,-3
VNM,NLD,2019.0,3,7,-4
CHN,EGY,2022.0,35,13,22
MEX,CHE,2014.0,6,6,0
CHN,NZL,2020.0,44,47,-3
JOR,DEU,2012.0,9,10,-1
ECU,ESP,2019.0,40,53,-13
JPN,BGD,1999.0,9,1,8
NLD,MWI,2019.0,2,2,0
GRC,FRA,2019.0,35,28,7
USA,CYP,2004.0,13,3,10
BEL,CHL,2013.0,5,10,-5
GRC,AUS,2018.0,11,4,7
ITA,LKA,2021.0,2,2,0
DNK,PAK,2021.0,5,4,1
BRA,ISR,2019.0,9,1,8
POL,DEU,2022.0,29,32,-3
BGD,CAN,2021.0,27,15,12
IRN,ZAF,2022.0,4,1,3
AUS,IRQ,2020.0,37,6,31
KOR,UKR,2019.0,3,3,0
CAN,HUN,2021.0,5,3,2
MYS,IDN,2015.0,66,13,53
COL,CAN,2019.0,17,12,5
SVN,SWE,2021.0,4,4,0
TUN,BEL,2020.0,9,3,6
AUT,CAN,2021.0,15,17,-2
CZE,GBR,2006.0,35,26,9
HUN,CHE,2015.0,19,9,10
GBR,ZAF,2000.0,9,13,-4
AUS,CAN,2002.0,79,78,1
AUS,CAN,2005.0,100,100,0
THA,USA,2022.0,47,55,-8
VNM,AUS,2018.0,22,41,-19
EGY,KWT,2019.0,18,12,6
USA,ETH,2019.0,26,31,-5
USA,HUN,2014.0,56,60,-4
FRA,NLD,2004.0,76,68,8
GRC,DNK,2016.0,9,2,7
AUT,USA,2010.0,94,99,-5
USA,JOR,2014.0,47,29,18
CHE,PAK,2006.0,2,3,-1
PHL,MYS,2011.0,2,2,0
USA,FJI,2011.0,1,1,0
BEL,ESP,2022.0,32,22,10
IRN,DNK,2022.0,16,7,9
JPN,NLD,2013.0,18,18,0
HKG,TZA,2020.0,1,1,0
RUS,KOR,2015.0,7,7,0
NOR,KOR,2010.0,2,4,-2
USA,PAK,2008.0,36,30,6
HUN,USA,2009.0,77,44,33
VEN,ESP,2014.0,19,26,-7
CYP,GBR,2007.0,5,18,-13
ZAF,SAU,2018.0,9,5,4
AUT,NLD,2002.0,12,14,-2
CZE,PRT,2019.0,1,2,-1
RUS,HUN,2017.0,2,1,1
GBR,CYP,2007.0,18,5,13
NLD,DNK,2016.0,31,23,8
DEU,UKR,2010.0,9,38,-29
PAK,CAN,2013.0,20,18,2
GRC,IRL,2007.0,5,1,4
FRA,ARE,2011.0,7,1,6
GBR,EGY,2006.0,21,8,13
DZA,FRA,2013.0,31,77,-46
SWE,NPL,2020.0,1,1,0
NZL,CHL,2016.0,7,1,6
DEU,UKR,2019.0,14,29,-15
CZE,CHE,1998.0,5,1,4
ITA,ETH,2010.0,2,1,1
ITA,DNK,2009.0,28,16,12
SGP,THA,2010.0,3,3,0
FIN,ESP,2012.0,12,17,-5
AUS,NOR,2006.0,6,6,0
QAT,SGP,2018.0,4,3,1
GBR,JOR,2008.0,19,3,16
ZAF,RUS,2010.0,3,3,0
DEU,TWN,2017.0,20,20,0
DNK,USA,1999.0,58,50,8
ITA,SVN,2019.0,11,5,6
ZAF,GBR,2014.0,70,90,-20
KEN,IDN,2013.0,1,1,0
ARG,PRT,2015.0,5,7,-2
PRT,CAN,2018.0,14,6,8
ISL,USA,2015.0,13,17,-4
FRA,POL,1998.0,11,6,5
MEX,CAN,2014.0,35,27,8
NLD,CHN,2002.0,18,19,-1
ESP,RUS,1999.0,8,6,2
CHN,TWN,2006.0,40,25,15
HKG,CHN,1998.0,16,21,-5
ITA,RUS,2001.0,23,24,-1
SWE,GBR,2001.0,53,48,5
MEX,GBR,2004.0,23,28,-5
DEU,TWN,2010.0,8,13,-5
SGP,QAT,2018.0,3,4,-1
JPN,KHM,2018.0,8,3,5
FIN,POL,2012.0,15,7,8
HUN,ROU,2015.0,8,6,2
RUS,FRA,1998.0,27,17,10
IRL,PRT,2022.0,4,2,2
DEU,POL,1999.0,27,25,2
GBR,IRN,2001.0,23,5,18
IND,CHE,2013.0,38,26,12
BRA,IRN,2017.0,5,11,-6
USA,SVK,1998.0,2,6,-4
FJI,AUS,2020.0,6,6,0
JPN,LAO,2003.0,1,1,0
NGA,CHN,2015.0,11,11,0
FRA,CMR,2020.0,18,9,9
NOR,SWE,2009.0,28,59,-31
SRB,GBR,2018.0,9,10,-1
NZL,MYS,2017.0,21,14,7
ZWE,ZAF,2015.0,19,13,6
UGA,KEN,2018.0,9,6,3
ESP,ISR,2020.0,15,8,7
IND,CHN,2014.0,57,30,27
CZE,ITA,2021.0,18,16,2
KOR,ARE,2020.0,18,3,15
SVK,AUT,2020.0,7,7,0
AUS,THA,2002.0,11,5,6
THA,IND,2022.0,5,11,-6
JPN,CHE,2020.0,30,33,-3
BEL,GRC,2018.0,8,23,-15
USA,TUN,2000.0,2,2,0
BLR,DEU,2009.0,10,5,5
NLD,ISL,2016.0,2,2,0
BGD,PAK,2020.0,12,10,2
ESP,CRI,2014.0,6,3,3
BGD,RUS,2013.0,1,1,0
GRC,FRA,2010.0,30,17,13
CUB,CAN,2021.0,5,2,3
USA,SLV,2021.0,2,1,1
USA,NZL,2004.0,103,105,-2
USA,NGA,2009.0,22,23,-1
EGY,DEU,2001.0,9,9,0
CHN,BGR,2016.0,1,1,0
TZA,USA,2021.0,12,10,2
USA,KWT,2021.0,13,4,9
DEU,CMR,2020.0,8,6,2
IRL,NZL,2012.0,5,1,4
MEX,ITA,2010.0,10,5,5
SWE,BRA,2002.0,5,5,0
IRN,IND,2009.0,10,12,-2
LUX,FIN,2012.0,2,1,1
NLD,FIN,2005.0,8,9,-1
VEN,BRA,2020.0,13,5,8
UGA,DEU,2005.0,2,2,0
LTU,NLD,2006.0,1,5,-4
FRA,CIV,2005.0,14,11,3
NZL,DNK,2014.0,9,3,6
GBR,DZA,2019.0,6,4,2
IDN,PHL,2015.0,1,2,-1
VEN,USA,2007.0,30,24,6
CUB,PRT,2011.0,4,1,3
TUN,ITA,2013.0,2,3,-1
TUN,ARE,2016.0,2,1,1
KEN,CHN,2004.0,1,2,-1
PRT,BRA,2010.0,57,76,-19
JOR,CAN,2002.0,2,3,-1
IND,BEL,2007.0,9,8,1
ISR,NLD,2016.0,15,9,6
FRA,MYS,2017.0,6,9,-3
GBR,DZA,2017.0,6,1,5
DEU,UKR,2017.0,14,40,-26
ZAF,DEU,2002.0,24,12,12
USA,ZAF,2004.0,50,68,-18
DEU,TWN,2019.0,12,18,-6
ITA,IRL,2006.0,7,5,2
GBR,FIN,2003.0,47,35,12
POL,SWE,2004.0,14,6,8
USA,PHL,2005.0,12,14,-2
AUS,THA,2005.0,24,5,19
DEU,JOR,2002.0,6,4,2
FIN,FRA,2002.0,18,19,-1
RUS,FRA,1997.0,14,15,-1
NLD,CAN,2002.0,25,39,-14
FRA,MYS,2019.0,8,9,-1
ARG,COL,2009.0,5,11,-6
CMR,NGA,2003.0,2,2,0
USA,ETH,2010.0,12,3,9
DEU,NOR,2014.0,63,36,27
TJK,RUS,2008.0,2,1,1
EGY,KWT,2010.0,6,5,1
BEN,FRA,2015.0,11,9,2
ARG,DEU,2002.0,17,19,-2
KWT,EGY,2001.0,8,4,4
FRA,GUF,2007.0,11,5,6
CUB,MEX,2013.0,18,6,12
LBN,USA,2004.0,33,24,9
CIV,FRA,2003.0,16,28,-12
HUN,FRA,2002.0,14,11,3
IND,PHL,2005.0,7,2,5
POL,IRL,2011.0,2,4,-2
GBR,TZA,2003.0,6,3,3
GBR,NZL,1999.0,27,27,0
GBR,LVA,2007.0,3,1,2
LBN,SAU,2016.0,5,5,0
ZAF,DEU,2005.0,7,12,-5
ISL,DNK,2003.0,3,1,2
CHE,BRA,2002.0,7,7,0
POL,BGR,2005.0,1,1,0
TUR,NLD,2008.0,15,7,8
HUN,SWE,2017.0,13,7,6
ITA,ARE,2017.0,15,3,12
RUS,ETH,2018.0,24,7,17
DNK,ISL,2002.0,2,3,-1
HUN,SWE,2010.0,12,7,5
DNK,CHE,2004.0,15,11,4
NZL,MYS,2010.0,12,8,4
ESP,NLD,1998.0,8,10,-2
CIV,USA,2003.0,1,1,0
ITA,SAU,2022.0,7,7,0
KOR,UKR,2010.0,1,1,0
GRC,BEL,2004.0,6,10,-4
BGD,GBR,2012.0,12,14,-2
NLD,LKA,2010.0,3,2,1
PRT,CHE,2022.0,6,5,1
FRA,FIN,2007.0,13,14,-1
SAU,CAN,2001.0,8,6,2
JPN,AUS,1998.0,8,9,-1
ARG,DEU,2005.0,22,13,9
BEL,CAN,2008.0,31,20,11
GBR,MEX,2003.0,18,22,-4
KOR,JPN,1997.0,8,9,-1
USA,KAZ,2012.0,11,2,9
HKG,CHN,1997.0,14,17,-3
HKG,CAN,2009.0,28,23,5
DEU,GEO,2016.0,1,4,-3
IRL,CHE,2011.0,7,6,1
JPN,BRA,2006.0,12,9,3
ESP,EGY,2007.0,4,2,2
MKD,SRB,2009.0,12,3,9
HUN,FRA,2005.0,7,4,3
ESP,IND,2021.0,13,23,-10
BGD,BEL,2012.0,3,2,1
CHL,URY,2016.0,3,2,1
TWN,CHN,2000.0,9,16,-7
TWN,FRA,2004.0,5,7,-2
GBR,TUR,2013.0,53,42,11
RUS,FIN,2012.0,20,8,12
CHL,COL,2005.0,7,5,2
PRT,IRN,2016.0,6,12,-6
NOR,DNK,2011.0,27,26,1
NLD,SVN,2012.0,1,2,-1
HUN,ITA,2012.0,7,7,0
ITA,IRN,2016.0,17,35,-18
LUX,USA,2008.0,2,3,-1
IRL,AUS,1999.0,5,13,-8
NOR,KOR,2017.0,3,4,-1
LUX,FRA,2019.0,18,33,-15
HRV,HUN,2017.0,4,2,2
UKR,CZE,2013.0,9,3,6
RUS,GBR,2012.0,39,28,11
GHA,NGA,2015.0,7,2,5
CZE,POL,2020.0,14,27,-13
ITA,NZL,2011.0,5,4,1
IRN,RUS,2009.0,1,4,-3
PAK,OMN,2013.0,9,1,8
FRA,ISL,2010.0,3,1,2
KEN,TZA,2013.0,5,5,0
BEL,TUR,2016.0,10,6,4
NOR,FRA,2015.0,17,26,-9
SGP,SWE,2018.0,13,5,8
FRA,NZL,2016.0,16,13,3
FRA,UGA,2012.0,3,1,2
ITA,ARE,2019.0,15,2,13
MYS,PAK,2011.0,7,17,-10
PHL,KOR,2020.0,8,11,-3
LTU,CAN,2018.0,2,1,1
IND,IRL,2013.0,10,8,2
AUT,KOR,2012.0,4,4,0
FRA,SGP,2018.0,39,22,17
BEL,AUS,2013.0,26,10,16
LUX,FRA,2017.0,14,36,-22
CHE,NZL,2016.0,10,12,-2
JPN,HKG,2006.0,3,2,1
COL,GBR,2014.0,9,15,-6
KOR,CHE,2020.0,18,15,3
CHN,ITA,2013.0,21,36,-15
POL,SVN,2020.0,1,1,0
COL,CAN,2017.0,20,12,8
ESP,BOL,2015.0,7,3,4
TWN,BRA,2017.0,4,1,3
GRC,BGR,2012.0,1,1,0
USA,NIC,2017.0,1,4,-3
ISR,RUS,2006.0,10,8,2
ESP,ROU,2004.0,2,3,-1
CHN,BEL,2011.0,32,18,14
KOR,TUR,2018.0,2,3,-1
BEL,MYS,2020.0,3,3,0
TUR,KAZ,2018.0,5,8,-3
AUS,BRA,2022.0,12,28,-16
AUS,CHL,2011.0,7,10,-3
IDN,FRA,2020.0,3,11,-8
KEN,GBR,2022.0,12,13,-1
BFA,MLI,2018.0,3,2,1
SVN,AUS,2020.0,3,5,-2
ESP,ARG,2022.0,13,30,-17
CIV,BFA,2021.0,1,1,0
LKA,DEU,2016.0,2,2,0
GTM,ECU,2019.0,3,1,2
HKG,DNK,2022.0,2,3,-1
HKG,CHE,2021.0,8,5,3
PRT,IND,2020.0,20,8,12
HKG,JPN,2005.0,4,4,0
CAN,BEL,2017.0,38,50,-12
GBR,OMN,2013.0,12,5,7
DEU,KEN,2007.0,12,3,9
ISR,AUS,2012.0,12,11,1
DEU,JOR,2005.0,6,7,-1
ITA,CAN,2004.0,31,25,6
SGP,KOR,2006.0,8,6,2
COL,ESP,1999.0,1,1,0
ESP,HUN,2014.0,4,7,-3
ZWE,IND,2016.0,1,1,0
UGA,FRA,2019.0,4,1,3
USA,PRI,2016.0,83,88,-5
EGY,BEL,2018.0,4,8,-4
EGY,ITA,2021.0,8,14,-6
ECU,ESP,2017.0,22,72,-50
THA,IDN,2012.0,6,1,5
ISR,FRA,2022.0,13,11,2
PAK,AUS,2016.0,35,20,15
SGP,FIN,2015.0,3,1,2
JPN,MMR,2013.0,3,1,2
POL,CZE,2014.0,13,10,3
TUR,ITA,2013.0,10,12,-2
ZAF,ETH,2015.0,4,7,-3
AUS,PHL,2020.0,10,15,-5
VNM,NLD,2017.0,3,11,-8
GBR,LUX,2021.0,9,7,2
ITA,DZA,2017.0,2,1,1
SGP,THA,2017.0,4,5,-1
TUR,SGP,2018.0,5,2,3
ITA,DZA,2010.0,2,3,-1
TWN,PHL,2021.0,8,6,2
USA,ARM,2019.0,4,4,0
BEL,SWE,2004.0,6,9,-3
ITA,EGY,2021.0,14,8,6
HKG,TWN,2018.0,17,12,5
CHN,SDN,2018.0,16,8,8
CAN,MAR,2009.0,8,4,4
HUN,SWE,2019.0,4,1,3
MYS,BGD,2012.0,12,24,-12
ITA,KOR,2009.0,4,5,-1
FRA,BGR,2003.0,12,5,7
VEN,DEU,2014.0,1,4,-3
SWE,PRT,2004.0,5,6,-1
NLD,KOR,2002.0,4,5,-1
USA,BOL,2019.0,3,1,2
SVK,GRC,2009.0,2,2,0
SWE,SGP,2012.0,15,8,7
UZB,RUS,2011.0,2,5,-3
SAU,MYS,2008.0,2,5,-3
RUS,HUN,2019.0,3,1,2
EGY,JPN,2021.0,15,37,-22
GBR,SYR,2009.0,6,1,5
AUT,ROU,2007.0,2,3,-1
NOR,BEL,2007.0,4,4,0
CRI,USA,2013.0,12,13,-1
CIV,CAN,2017.0,3,1,2
DNK,EST,2012.0,2,2,0
DNK,AUT,2006.0,3,3,0
KOR,JPN,1998.0,18,28,-10
SWE,NZL,2011.0,3,5,-2
DNK,ISL,2005.0,5,3,2
AUT,RUS,2018.0,4,5,-1
IND,BRN,2007.0,1,2,-1
AUT,NLD,2005.0,6,5,1
DNK,AUS,1999.0,6,8,-2
VEN,FRA,2009.0,5,6,-1
USA,PHL,2002.0,17,12,5
RUS,PRT,2002.0,9,1,8
ETH,USA,2003.0,6,2,4
NOR,TUR,2016.0,2,6,-4
IRL,KWT,2008.0,1,1,0
DEU,NZL,1998.0,5,4,1
NPL,THA,2005.0,2,2,0
FRA,POL,1997.0,13,10,3
DNK,CAN,2002.0,9,21,-12
COL,BRA,2007.0,7,15,-8
CIV,CAN,2019.0,2,3,-1
COL,CAN,2010.0,4,2,2
CZE,AUT,2007.0,8,3,5
THA,NPL,2007.0,2,2,0
SLE,USA,2008.0,2,2,0
PAK,SWE,2011.0,8,4,4
JOR,CAN,2005.0,4,3,1
NOR,BRA,2016.0,6,7,-1
USA,ZMB,2022.0,5,4,1
BRA,SGP,2015.0,6,3,3
PHL,TWN,2008.0,2,1,1
LAO,AUS,2016.0,2,4,-2
HRV,FRA,2018.0,5,6,-1
VNM,NOR,2012.0,1,1,0
VNM,JPN,2009.0,10,20,-10
DNK,KOR,2016.0,7,10,-3
PAN,COL,2012.0,3,2,1
FIN,TUR,2014.0,1,1,0
GRC,NLD,2000.0,3,1,2
PSE,BEL,2019.0,1,3,-2
ETH,ISR,2016.0,2,1,1
CZE,HUN,2002.0,2,2,0
DEU,COL,2020.0,8,29,-21
CHL,FIN,2018.0,2,2,0
CZE,UKR,2007.0,2,3,-1
GBR,LTU,2007.0,4,5,-1
MEX,ITA,2019.0,11,21,-10
TWN,ETH,2022.0,6,1,5
BEL,NZL,2020.0,2,3,-1
SWE,SVN,2020.0,3,5,-2
CAN,DZA,2012.0,2,3,-1
LBR,USA,2020.0,6,2,4
ESP,CZE,2022.0,11,11,0
DNK,PRT,2015.0,3,18,-15
ZAF,CHE,1999.0,3,2,1
SWE,BRA,2005.0,6,3,3
RUS,SVK,2015.0,2,6,-4
COL,JPN,2018.0,2,3,-1
VEN,COL,2005.0,1,3,-2
ITA,POL,2000.0,11,3,8
CHN,SVN,2015.0,2,2,0
AUT,GRC,2020.0,7,7,0
SWE,SVK,2017.0,3,3,0
IND,HKG,2011.0,5,6,-1
ESP,POL,2007.0,3,6,-3
MYS,EGY,2016.0,8,5,3
IRL,ESP,2000.0,2,1,1
CHN,IRL,2008.0,2,4,-2
RUS,SWE,2022.0,8,8,0
NZL,BEL,2021.0,2,1,1
CHN,UKR,2014.0,2,6,-4
BGR,CAN,2007.0,3,1,2
ROU,NLD,2009.0,4,4,0
SVN,SRB,2012.0,5,2,3
BEL,COD,2020.0,9,3,6
RUS,BEL,2015.0,6,5,1
ESP,ISL,2018.0,2,4,-2
HRV,CZE,2020.0,5,1,4
NLD,LKA,2017.0,1,1,0
GBR,ETH,2015.0,3,8,-5
DEU,CZE,2022.0,21,20,1
DEU,HRV,2022.0,1,4,-3
ESP,MYS,2021.0,2,1,1
NLD,CRI,2014.0,1,2,-1
HKG,AUT,2016.0,2,1,1
HUN,IRN,2017.0,2,3,-1
IDN,NLD,2007.0,2,7,-5
NLD,FIN,2002.0,7,17,-10
UKR,SVK,2008.0,2,1,1
PRI,MEX,2017.0,1,1,0
DEU,DZA,2002.0,2,2,0
GMB,NGA,2008.0,1,5,-4
USA,URY,2003.0,9,7,2
EGY,CHE,2002.0,2,2,0
PRT,NLD,2001.0,4,8,-4
JOR,OMN,2001.0,3,2,1
LBN,QAT,2020.0,2,1,1
ESP,HRV,2000.0,3,1,2
BRA,NLD,1999.0,3,1,2
COL,GTM,2012.0,2,1,1
CZE,MEX,2008.0,2,3,-1
SWE,LKA,2012.0,3,1,2
CHE,HUN,2020.0,6,14,-8
BRA,PAN,2002.0,1,1,0
HKG,SGP,1999.0,7,3,4
USA,GEO,2014.0,11,12,-1
KEN,ZAF,2012.0,9,12,-3
PAK,BRA,2008.0,1,2,-1
USA,NIC,2010.0,3,1,2
GRC,KWT,2020.0,1,2,-1
JPN,ISR,2012.0,1,2,-1
CZE,PRT,2010.0,1,3,-2
BWA,KEN,2020.0,2,1,1
MEX,IND,2008.0,2,2,0
DNK,ISR,2018.0,2,6,-4
BRA,URY,2008.0,4,2,2
QAT,OMN,2009.0,2,1,1
CHN,TUR,2007.0,1,1,0
KAZ,KOR,2014.0,1,3,-2
MYS,OMN,2009.0,3,1,2
KNA,USA,2011.0,2,1,1
NOR,CHE,2016.0,8,31,-23
MNG,JPN,2014.0,4,11,-7
SRB,FRA,2002.0,3,1,2
BGR,TUR,2015.0,1,1,0
CMR,BRA,2017.0,2,1,1
PRT,AUT,2022.0,9,11,-2
GBR,ISL,2002.0,10,4,6
ECU,VEN,2020.0,7,22,-15
RUS,BRA,2000.0,6,1,5
ARG,MEX,2000.0,3,4,-1
BLR,ITA,2007.0,3,1,2
UGA,FRA,2017.0,2,1,1
POL,KOR,2012.0,2,3,-1
CUB,ITA,2017.0,3,1,2
DEU,OMN,2011.0,4,1,3
JPN,AUS,1997.0,6,9,-3
SVK,GBR,2015.0,5,6,-1
ZAF,RUS,2017.0,5,3,2
ESP,NLD,1997.0,5,5,0
ITA,SVK,2003.0,4,4,0
POL,MLT,2015.0,1,1,0
AUS,LKA,2009.0,5,6,-1
FIN,BEL,2002.0,3,2,1
TUR,AUT,2006.0,3,5,-2
UGA,COG,2014.0,1,1,0
BIH,DEU,2009.0,3,2,1
MEX,DNK,2004.0,1,1,0
CAN,COL,2007.0,5,7,-2
ZAF,TZA,2008.0,3,3,0
NLD,MWI,2010.0,2,1,1
MYS,NLD,2002.0,1,3,-2
BFA,DEU,2017.0,1,1,0
FRA,COL,2003.0,5,5,0
DNK,CHN,2004.0,7,7,0
CYP,KOR,2018.0,1,1,0
DNK,CAN,2005.0,6,15,-9
IRL,SRB,2014.0,1,2,-1
FIN,GHA,2014.0,1,1,0
RUS,IRL,2016.0,2,1,1
GEO,TUR,2015.0,1,1,0
ITA,ETH,2017.0,2,6,-4
FJI,NZL,2019.0,2,4,-2
EST,NOR,2020.0,3,2,1
CHN,ZAF,2022.0,4,6,-2
DNK,ZAF,2008.0,1,1,0
THA,DNK,2021.0,3,2,1
VNM,BEL,2020.0,7,15,-8
ZWE,USA,2020.0,1,10,-9
ISR,TUR,2004.0,5,5,0
CYP,USA,2004.0,3,13,-10
ESP,THA,2018.0,4,2,2
SWE,SVK,2010.0,3,4,-1
PER,COL,2009.0,1,3,-2
TUR,CHE,2022.0,6,4,2
JPN,MEX,2011.0,2,3,-1
USA,BHS,2019.0,3,2,1
TUR,BIH,2020.0,3,2,1
QAT,CHN,2018.0,4,2,2
RWA,ZAF,2014.0,2,5,-3
MAR,ITA,2001.0,3,5,-2
FRA,HRV,2003.0,1,2,-1
TWN,SWE,2020.0,7,2,5
USA,SVK,1997.0,4,4,0
USA,BOL,2010.0,4,3,1
LKA,SWE,2000.0,1,2,-1
CRI,ESP,2006.0,1,1,0
NCL,USA,2011.0,2,1,1
ESP,TUR,2004.0,3,1,2
RUS,ISR,2008.0,3,9,-6
NOR,TZA,2008.0,6,5,1
IDN,AUS,2001.0,2,3,-1
COL,CUB,1998.0,1,3,-2
ROU,ISR,2012.0,1,1,0
YEM,SAU,2016.0,7,2,5
SGP,ITA,2022.0,5,1,4
ECU,BEL,2009.0,1,1,0
EGY,ARE,2015.0,6,5,1
FIN,PAK,2018.0,3,1,2
CRI,DEU,2004.0,2,1,1
KAZ,USA,2014.0,4,21,-17
ESP,ALB,2014.0,2,1,1
SAU,TUN,2013.0,5,38,-33
IND,PHL,2002.0,3,1,2
LBN,SWE,2020.0,2,2,0
OMN,MYS,2005.0,1,1,0
SWE,ROU,2007.0,1,1,0
SRB,HRV,2005.0,4,1,3
GBR,DZA,2010.0,2,2,0
CUB,BEL,2004.0,1,2,-1
TUR,ISR,2004.0,5,5,0
DNK,FRO,2006.0,1,1,0
GBR,EST,2005.0,4,1,3
AUS,HUN,2009.0,2,2,0
ZAF,HUN,2007.0,1,1,0
BEL,ISR,1999.0,3,2,1
AUT,LUX,2012.0,3,1,2
ARE,SAU,2002.0,4,3,1
KEN,BEL,2010.0,3,3,0
PRT,SWE,2009.0,3,11,-8
EGY,ESP,2006.0,3,1,2
TWN,GBR,2001.0,3,26,-23
ITA,UZB,2007.0,2,1,1
PAK,ARE,2008.0,1,1,0
RUS,TWN,2016.0,2,1,1
FRA,HUN,2021.0,4,9,-5
BHS,USA,2007.0,1,1,0
UGA,ITA,2012.0,1,1,0
THA,MYS,2016.0,4,10,-6
TUN,GBR,2020.0,2,1,1
COL,ARE,2020.0,1,1,0
DJI,FRA,2012.0,3,3,0
IRQ,EGY,2021.0,4,4,0
CAN,ROU,2014.0,3,2,1
CHN,NPL,2007.0,1,1,0
ISR,CHN,2000.0,1,7,-6
HTI,USA,2006.0,2,10,-8
SWZ,CHE,2019.0,2,1,1
NAM,ZAF,2007.0,3,1,2
RUS,LTU,1999.0,2,2,0
NLD,ARG,2000.0,1,1,0
CHN,UZB,2018.0,1,5,-4
RUS,NZL,2007.0,2,1,1
RUS,HUN,2010.0,2,2,0
EGY,TUR,2012.0,1,1,0
ARE,GBR,2011.0,3,25,-22
JPN,LKA,2001.0,1,1,0
BWA,IND,2009.0,1,1,0
DNK,TUR,2006.0,1,1,0
BGR,BRA,2003.0,1,1,0
PHL,CHN,2016.0,2,1,1
AUS,GRC,2006.0,1,1,0
RUS,MYS,2016.0,1,4,-3
AUT,IRN,2004.0,1,3,-2
LBY,IND,2017.0,2,1,1
SRB,FRA,2005.0,1,1,0
IND,EGY,2011.0,2,1,1
PHL,ESP,2016.0,3,1,2
ZMB,ZAF,2014.0,3,5,-2
POL,BGR,2002.0,1,2,-1
SEN,CIV,2020.0,2,3,-1
BHS,GBR,2017.0,1,1,0
SGP,THA,2019.0,3,4,-1
PRI,MEX,2019.0,1,1,0
IRN,EGY,2016.0,3,2,1
BMU,USA,2010.0,2,2,0
DNK,CZE,2009.0,2,3,-1
NGA,KEN,2016.0,3,2,1
BRN,LKA,2013.0,1,4,-3
EGY,KWT,2017.0,7,14,-7
BRA,IRN,2010.0,1,3,-2
MEX,SAU,2022.0,2,1,1
KAZ,CHN,2015.0,1,2,-1
IDN,ITA,2017.0,2,1,1
ATG,USA,2011.0,2,1,1
POL,GRC,2008.0,1,1,0
CAN,IRQ,2021.0,2,1,1
ISR,BEL,2014.0,6,4,2
BEL,DZA,2012.0,2,1,1
IRL,DZA,2020.0,1,2,-1
DEU,BOL,2016.0,1,2,-1
YEM,MYS,2011.0,1,6,-5
USA,ARM,2017.0,4,4,0
SGP,RUS,1999.0,1,2,-1
POL,HUN,2009.0,2,2,0
RUS,PRT,2005.0,3,3,0
CRI,AUS,2017.0,1,2,-1
SWE,ISR,2016.0,5,9,-4
POL,SGP,2021.0,2,3,-1
CHL,COL,2002.0,1,1,0
TJK,KAZ,2013.0,1,1,0
MAR,QAT,2015.0,1,1,0
IRL,LBY,2011.0,2,1,1
MYS,NLD,2005.0,2,2,0
NGA,CMR,2012.0,2,2,0
ZAF,NGA,1999.0,1,1,0
SVK,POL,1999.0,1,2,-1
KGZ,RUS,2011.0,3,1,2
CAN,CYP,2009.0,1,1,0
NLD,CZE,2003.0,1,5,-4
TUR,IND,2013.0,3,3,0
SWE,KEN,2001.0,2,1,1
GBR,FLK,2011.0,2,1,1
BLR,NLD,2007.0,1,1,0
GBR,ISL,2005.0,2,7,-5
FIN,BEL,2005.0,4,3,1
GRC,ISR,2013.0,2,2,0
RUS,NGA,2018.0,3,1,2
CHE,ZMB,2020.0,1,1,0
NOR,KOR,2019.0,3,10,-7
VNM,NLD,2010.0,1,6,-5
TTO,PRT,2010.0,1,1,0
IDN,AUT,2013.0,1,2,-1
SWZ,CHE,2017.0,2,1,1
ITA,VEN,1999.0,1,2,-1
PER,CHL,2004.0,1,2,-1
COL,ARG,2014.0,8,10,-2
BGD,NLD,2020.0,3,3,0
ZAF,BRA,2001.0,1,2,-1
NOR,NZL,2005.0,2,3,-1
URY,AUS,2012.0,1,2,-1
USA,GRD,2003.0,1,1,0
KHM,FRA,2005.0,1,3,-2
GBR,BLR,2001.0,2,3,-1
NOR,NZL,2002.0,1,3,-2
SAU,FRA,2003.0,1,3,-2
SAU,ARE,2004.0,2,3,-1
KEN,GHA,2011.0,1,1,0
PAK,KWT,2021.0,1,1,0
NIC,USA,2014.0,1,2,-1
BLR,FRA,2004.0,1,2,-1
PHL,SGP,2015.0,2,6,-4
CHE,BGD,2017.0,3,3,0
KOR,SDN,2021.0,1,1,0
CAN,LKA,2015.0,2,1,1
IDN,ITA,2010.0,1,1,0
GEO,KAZ,2016.0,2,1,1
PNG,USA,2003.0,1,1,0
NZL,FIN,2021.0,4,1,3
CAN,BRB,2012.0,1,1,0
IND,MEX,2022.0,2,11,-9
ITA,DZA,2019.0,3,3,0
MUS,FRA,2017.0,1,1,0
CHN,SYR,2020.0,1,1,0
HKG,PAK,2021.0,2,10,-8
ROU,RUS,2009.0,2,2,0
CZE,HUN,2005.0,1,2,-1
BRN,USA,2006.0,1,2,-1
CHE,BGD,2019.0,1,1,0
QAT,USA,2002.0,1,2,-1
THA,PAK,2008.0,1,1,0
VNM,ITA,2011.0,1,1,0
IRN,ARM,2016.0,1,4,-3
ERI,IND,2016.0,1,2,-1
IND,UGA,2021.0,1,1,0
JPN,CMR,2021.0,1,1,0
ARG,SWE,2009.0,2,2,0
IRL,ITA,1997.0,1,2,-1
LKA,CAN,2002.0,1,1,0
GBR,BWA,2001.0,2,1,1
IDN,ITA,2019.0,1,2,-1
MUS,FRA,2010.0,1,1,0
QAT,USA,2005.0,2,6,-4
ECU,CHL,2011.0,1,2,-1
THA,TWN,2003.0,1,2,-1
UKR,AUT,2012.0,2,1,1
ITA,SVN,2010.0,1,4,-3
GRD,USA,2014.0,4,3,1
USA,MNG,2019.0,2,7,-5
DEU,DZA,2005.0,2,2,0
LTU,DNK,2005.0,1,3,-2
ITA,ETH,2019.0,5,5,0
IDN,NOR,2020.0,2,1,1
PNG,IND,2018.0,1,4,-3
USA,PSE,2008.0,1,3,-2
POL,IND,2001.0,1,2,-1
USA,BRN,2014.0,2,1,1
LBN,CHN,2019.0,1,2,-1
SGP,NLD,2003.0,2,1,1
SDN,USA,2013.0,1,1,0
DEU,TZA,2006.0,3,1,2
POL,TWN,2006.0,1,1,0
SEN,DEU,2020.0,1,1,0
MWI,FIN,2011.0,1,1,0
NIC,ESP,2014.0,1,1,0
NLD,LKA,2019.0,1,2,-1
CUB,ITA,2019.0,1,1,0
DEU,BFA,2008.0,1,2,-1
CZE,PRT,2017.0,2,4,-2
BRA,IRN,2019.0,1,12,-11
NLD,GHA,2022.0,1,2,-1
RUS,IND,2020.0,2,22,-20
CHN,DZA,2013.0,1,1,0
SVN,SVK,2002.0,1,3,-2
USA,MDA,2021.0,1,1,0
GEO,JPN,2007.0,1,1,0
PRT,RUS,1999.0,1,7,-6
CUB,DEU,2004.0,1,5,-4
MEX,ZAF,2015.0,1,2,-1
POL,NOR,2004.0,1,2,-1
CHE,NGA,2004.0,1,1,0
UZB,KOR,2022.0,1,4,-3
UGA,NOR,2020.0,1,3,-2
BEN,CMR,2020.0,1,1,0
AUS,ETH,2014.0,1,6,-5
USA,ARM,2010.0,2,9,-7
SDN,ERI,2022.0,1,1,0
CHE,VNM,2005.0,1,1,0
GBR,EST,2002.0,1,2,-1
BEN,GBR,2018.0,1,1,0
ETH,NLD,2015.0,1,4,-3
HRV,HUN,2019.0,1,1,0
CAN,BGR,2000.0,1,1,0
EGY,HKG,2019.0,1,1,0
KAZ,POL,2016.0,2,2,0
CHE,SAU,2005.0,1,1,0
QAT,HRV,2020.0,1,1,0
CHE,TGO,2018.0,1,2,-1
ISR,ARG,2020.0,1,6,-5
CAN,USA,2002.0,1286,1160,126
CAN,USA,2005.0,1243,1210,33
BRA,ARG,2018.0,38,20,18
DEU,GBR,2005.0,431,338,93
HUN,JPN,2014.0,5,4,1
IRL,USA,2009.0,111,133,-22
CHN,CAN,2009.0,162,114,48
CHN,PAK,2008.0,15,5,10
CHE,FRA,2013.0,197,317,-120
ISR,USA,2014.0,364,303,61
CZE,NLD,2013.0,9,8,1
SWE,LTU,2011.0,3,2,1
FRA,USA,2003.0,751,646,105
USA,TWN,2006.0,306,212,94
AUS,CHN,2010.0,64,139,-75
OMN,USA,2015.0,2,7,-5
NGA,USA,2009.0,23,22,1
CHN,CZE,2016.0,8,8,0
IRL,BEL,2020.0,11,6,5
DEU,AUS,2016.0,156,148,8
SRB,HRV,2002.0,5,9,-4
KEN,PER,2022.0,2,1,1
AUS,GHA,2022.0,4,8,-4
BRB,JAM,2019.0,1,1,0
NZL,MYS,2019.0,14,15,-1
BEL,CHE,2018.0,64,44,20
ZAF,RUS,2019.0,7,5,2
SWE,NOR,2003.0,49,43,6
KOR,CAN,2003.0,24,23,1
GBR,AUT,2012.0,79,57,22
USA,COL,2015.0,74,84,-10
CAN,SAU,2021.0,69,37,32
GBR,CHL,2011.0,29,16,13
GRC,CHE,2011.0,17,10,7
PHL,JPN,2009.0,10,16,-6
SWE,IRN,2012.0,14,30,-16
THA,GBR,2011.0,31,68,-37
DEU,BGD,2012.0,7,7,0
NLD,CAN,2005.0,35,24,11
FRA,NCL,2004.0,13,7,6
QAT,FRA,2018.0,6,8,-2
CHE,IND,2008.0,12,27,-15
FRA,TWN,2008.0,8,6,2
LUX,FRA,2010.0,8,28,-20
CAN,ECU,2020.0,2,7,-5
IND,QAT,2020.0,17,8,9
HRV,ESP,2001.0,2,1,1
GBR,KEN,2011.0,19,18,1
JPN,IRN,2009.0,19,8,11
DEU,ETH,2011.0,11,4,7
DEU,GRC,2008.0,37,28,9
NOR,AUS,2009.0,8,13,-5
FRA,CIV,2002.0,10,18,-8
HKG,JPN,2002.0,5,7,-2
CHE,GRC,2006.0,7,9,-2
FRA,IRL,2007.0,28,12,16
FIN,FRA,2005.0,8,8,0
IRQ,USA,2008.0,7,2,5
ESP,AND,2012.0,1,3,-2
AUT,CHE,2001.0,14,14,0
CAN,DNK,2014.0,24,19,5
NLD,CHN,2005.0,19,10,9
EST,RUS,2008.0,1,1,0
CAN,BEL,2019.0,32,45,-13
SVK,HUN,2009.0,2,2,0
USA,BGR,2006.0,10,13,-3
IRL,CAN,2000.0,5,1,4
TWN,ITA,2021.0,2,3,-1
MYS,IRN,2008.0,2,15,-13
BRA,CUB,2013.0,6,7,-1
FJI,NZL,2017.0,3,2,1
HRV,USA,2020.0,9,13,-4
UKR,ESP,2020.0,4,3,1
ROU,MDA,2020.0,1,7,-6
NLD,HKG,2020.0,4,12,-8
HRV,DEU,2018.0,15,14,1
UKR,CHE,2020.0,12,2,10
DNK,HRV,2020.0,2,4,-2
JPN,ITA,2002.0,21,19,2
NLD,CHL,2018.0,7,11,-4
SWE,GRC,2015.0,6,26,-20
MYS,TUR,2013.0,3,2,1
KOR,DEU,2000.0,4,12,-8
HUN,DNK,2003.0,3,10,-7
LUX,GRC,2021.0,3,4,-1
PRI,COL,2017.0,4,1,3
BGR,GBR,2016.0,5,3,2
CHL,CAN,2007.0,7,8,-1
TZA,MWI,2014.0,1,1,0
MCO,FRA,2006.0,3,7,-4
CRI,ARG,2008.0,2,2,0
BEL,IRL,2008.0,6,5,1
FRA,GLP,2003.0,15,6,9
CHE,BRA,2005.0,15,12,3
CHL,ARG,2013.0,5,17,-12
AUS,DNK,1999.0,8,6,2
RUS,AUS,2015.0,12,9,3
JPN,COL,2016.0,1,1,0
BRA,ISR,2017.0,3,1,2
GBR,MYS,1999.0,8,4,4
NPL,GBR,2004.0,4,4,0
RUS,AZE,2018.0,4,1,3
ARE,CAN,2001.0,4,5,-1
USA,NER,2004.0,1,1,0
ARE,SAU,2005.0,1,7,-6
ZWE,GBR,2014.0,3,7,-4
USA,TTO,2003.0,4,5,-1
USA,BHS,2017.0,2,3,-1
TUN,CAN,2016.0,3,15,-12
GBR,HUN,2000.0,8,8,0
USA,GUY,2016.0,1,1,0
THA,AUT,2020.0,1,5,-4
BWA,CAN,2008.0,2,1,1
AUT,HRV,2008.0,2,3,-1
VNM,GBR,2007.0,3,4,-1
CHN,RUS,2013.0,4,8,-4
DEU,UZB,2004.0,1,2,-1
ESP,SVK,2014.0,1,1,0
FRA,MYS,2010.0,7,3,4
JPN,GRC,2006.0,9,2,7
NLD,SGP,2004.0,2,2,0
NGA,SWE,2007.0,1,1,0
USA,SDN,2005.0,3,1,2
IDN,NZL,2001.0,1,1,0
UGA,BEL,2008.0,1,3,-2
MKD,DEU,2008.0,3,2,1
CZE,SVN,2021.0,2,1,1
IRN,IRQ,2022.0,7,1,6
MDA,CAN,2010.0,1,1,0
ISL,NOR,2004.0,2,3,-1
AUS,NCL,2017.0,4,4,0
EGY,CHE,2005.0,3,2,1
TUR,AZE,2000.0,1,5,-4
URY,BRA,2007.0,3,2,1
LKA,CAN,2005.0,1,2,-1
IND,ERI,2016.0,2,1,1
MEX,CHL,2022.0,2,4,-2
BRA,PAN,2005.0,2,1,1
KEN,SWE,2013.0,2,3,-1
FRA,GIN,2006.0,1,1,0
URY,GBR,2014.0,1,3,-2
BWA,GBR,2015.0,1,1,0
NOR,PAK,2016.0,3,1,2
EGY,NLD,2009.0,1,1,0
DEU,COG,2011.0,1,1,0
CUB,ITA,2010.0,3,2,1
NZL,HKG,2020.0,3,7,-4
IRL,SVN,2020.0,2,1,1
OMN,JPN,2021.0,1,1,0
BWA,CMR,2019.0,1,1,0
POL,JOR,2019.0,1,1,0
KEN,BEL,2019.0,1,2,-1
PHL,THA,2007.0,1,2,-1
BEL,UKR,2006.0,1,2,-1
USA,MNG,2010.0,1,2,-1
AUS,NCL,2019.0,1,1,0
USA,,2023.0,343410,0,343410
,CHN,1999.0,30306,0,30306
,ESP,2009.0,14144,0,14144
JPN,,2014.0,19873,0,19873
NOR,,2020.0,2242,0,2242
AUT,,2018.0,2278,0,2278
EGY,,2010.0,373,0,373
NLD,,2008.0,2209,0,2209
,SRB,2004.0,823,0,823
,SGP,2010.0,2089,0,2089
IRN,,2015.0,3303,0,3303
ARG,,2024.0,14894,0,14894
,BRA,1995.0,3182,0,3182
,MYS,2007.0,3146,0,3146
ROU,,2010.0,469,0,469
,IND,2009.0,27398,0,27398
PRT,,2002.0,56,0,56
NPL,,2008.0,53,0,53
ARE,,2023.0,1970,0,1970
,NPL,2004.0,185,0,185
,SRB,1996.0,305,0,305
EGY,,2017.0,1358,0,1358
EGY,,2019.0,1838,0,1838
NGA,,2021.0,2217,0,2217
ROU,,2017.0,1435,0,1435
DZA,,2008.0,53,0,53
,GBR,2011.0,20744,0,20744
,DNK,2012.0,3095,0,3095
MWI,,2011.0,23,0,23
COL,,2009.0,164,0,164
,MDA,2011.0,46,0,46
,SWE,2008.0,3355,0,3355
,AUS,2010.0,8764,0,8764
,LUX,2003.0,52,0,52
,MEX,2014.0,4997,0,4997
PYF,,2024.0,56,0,56
IRL,TUR,2012.0,4,0,4
,HUN,1995.0,1288,0,1288
CAN,,1999.0,194,0,194
,COL,2001.0,435,0,435
BGR,,2004.0,101,0,101
TGO,,2009.0,3,0,3
,AUS,2017.0,9369,0,9369
KWT,,2013.0,153,0,153
GUF,,2009.0,3,0,3
ROU,,2019.0,1591,0,1591
KOR,,1999.0,130,0,130
,MDV,2005.0,2,0,2
SRB,,2009.0,135,0,135
,BWA,2000.0,51,0,51
BEN,,2013.0,16,0,16
,SYR,2004.0,36,0,36
,BGD,2013.0,921,0,921
ZWE,,2013.0,18,0,18
QAT,,2018.0,177,0,177
,EST,2010.0,377,0,377
,SVN,2010.0,675,0,675
,EST,2017.0,267,0,267
,MAR,2010.0,872,0,872
,SGP,2019.0,1387,0,1387
,AZE,2016.0,206,0,206
,AUS,2019.0,5664,0,5664
,SGP,2017.0,2119,0,2119
,MAC,2012.0,136,0,136
,HKG,2013.0,1837,0,1837
,MAR,2017.0,1631,0,1631
AUS,,2006.0,2119,0,2119
,GRC,2018.0,2077,0,2077
RWA,GBR,2020.0,3,0,3
SGP,BGD,2018.0,3,0,3
,THA,2016.0,2973,0,2973
,PER,1997.0,91,0,91
,PER,1998.0,144,0,144
DEU,ECU,2015.0,5,0,5
PHL,NOR,2012.0,1,0,1
PER,CHE,2012.0,2,0,2
,MAR,2019.0,1173,0,1173
,LSO,2006.0,6,0,6
,SVN,2017.0,473,0,473
KEN,ISL,2014.0,1,0,1
,MMR,2012.0,35,0,35
,ZMB,2013.0,103,0,103
,ISL,2013.0,130,0,130
,NAM,2018.0,55,0,55
POL,MKD,2017.0,1,0,1
,PYF,2014.0,9,0,9
,GTM,2014.0,49,0,49
MAR,,2007.0,169,0,169
,SEN,2015.0,143,0,143
ISL,AUS,2022.0,1,0,1
BLR,VNM,2020.0,1,0,1
,NIC,2015.0,15,0,15
,MNG,2016.0,85,0,85
,SVN,2019.0,258,0,258
IND,TJK,2018.0,1,0,1
USA,FSM,2015.0,1,0,1
RUS,POL,2022.0,10,0,10
,SLE,2015.0,35,0,35
MKD,ITA,2014.0,2,0,2
,LBY,2016.0,46,0,46
,UZB,2018.0,335,0,335
BGD,NPL,2022.0,1,0,1
HKG,,2022.0,2571,0,2571
IND,GHA,2014.0,3,0,3
,ISR,2013.0,2526,0,2526
CUB,CHN,2018.0,5,0,5
HRV,,2025.0,26,0,26
PHL,,2011.0,96,0,96
MLI,DEU,2010.0,2,0,2
CIV,,2014.0,81,0,81
PRT,,2005.0,268,0,268
,ALB,2006.0,32,0,32
ISR,KAZ,2014.0,2,0,2
NOR,MOZ,2007.0,1,0,1
NCL,REU,2008.0,1,0,1
ITA,LUX,2012.0,10,0,10
LBY,,2012.0,50,0,50
HUN,HTI,2016.0,1,0,1
,NPL,1996.0,9,0,9
GIN,,2019.0,18,0,18
,ARE,1998.0,144,0,144
EGY,VNM,2018.0,2,0,2
MAR,CMR,2015.0,2,0,2
MAR,CHN,2017.0,2,0,2
EST,ALB,2017.0,1,0,1
,AFG,2013.0,5,0,5
BDI,,2023.0,28,0,28
CMR,UGA,2018.0,2,0,2
,EST,2019.0,122,0,122
SRB,ALB,2022.0,2,0,2
BIH,CHE,2016.0,3,0,3
,CIV,2007.0,159,0,159
,PRI,1997.0,66,0,66
,COG,1995.0,2,0,2
,PRI,1998.0,157,0,157
ARM,,2016.0,87,0,87
,BOL,1994.0,9,0,9
,PNG,2008.0,39,0,39
,MRT,2000.0,5,0,5
IRL,BIH,2012.0,1,0,1
GRC,,2001.0,24,0,24
VNM,,2006.0,36,0,36
CAN,UGA,2008.0,2,0,2
FRA,SVN,2003.0,2,0,2
IRN,NOR,2006.0,1,0,1
BEL,,2025.0,6,0,6
SVN,TUR,2013.0,1,0,1
TUR,RUS,2006.0,2,0,2
,ARE,1997.0,33,0,33
TZA,FIN,2001.0,1,0,1
TUR,,1999.0,25,0,25
ECU,ESP,2010.0,2,0,2
GAB,,2018.0,28,0,28
KAZ,,2006.0,29,0,29
CMR,USA,2000.0,3,0,3
FRA,FJI,2015.0,2,0,2
CHN,SAU,2005.0,1,0,1
NGA,CHE,2006.0,3,0,3
IRL,ITA,1998.0,1,0,1
KWT,MYS,1998.0,1,0,1
CHE,HKG,2003.0,2,0,2
YEM,USA,2001.0,1,0,1
MYS,,2000.0,12,0,12
MEX,BLR,2007.0,1,0,1
ZAF,ARE,2009.0,2,0,2
QAT,TUR,2012.0,1,0,1
MKD,CZE,2012.0,1,0,1
USA,MNG,2017.0,6,0,6
HUN,NOR,2014.0,7,0,7
ASM,USA,2010.0,2,0,2
TZA,DNK,2011.0,2,0,2
GRC,SAU,2013.0,4,0,4
,HTI,1999.0,1,0,1
FRO,,2007.0,1,0,1
LTU,AUS,2011.0,1,0,1
VNM,CAN,2021.0,2,0,2
TZA,CAN,2014.0,2,0,2
SDN,YEM,2014.0,1,0,1
USA,FRO,2015.0,2,0,2
NZL,ISR,2014.0,3,0,3
MDA,CZE,2015.0,1,0,1
,FRO,2010.0,3,0,3
SVN,RUS,2005.0,7,0,7
IDN,DNK,2012.0,2,0,2
NGA,DZA,2018.0,1,0,1
ARM,DNK,2016.0,1,0,1
NGA,NER,2016.0,2,0,2
KAZ,ESP,2017.0,1,0,1
,CPV,2013.0,12,0,12
AZE,POL,2017.0,1,0,1
SOM,,2021.0,5,0,5
GEO,DEU,2001.0,3,0,3
LVA,NLD,2011.0,2,0,2
KHM,SAU,2020.0,6,0,6
,ABW,2017.0,3,0,3
TUR,PRT,2022.0,2,0,2
POL,HKG,2020.0,3,0,3
SEN,,2006.0,23,0,23
CAN,LTU,2001.0,1,0,1
TUR,NZL,1997.0,1,0,1
BFA,,2009.0,17,0,17
TWN,SRB,1999.0,1,0,1
CRI,COL,2003.0,1,0,1
IND,TUN,2019.0,1,0,1
LIE,POL,2010.0,2,0,2
MEX,GIN,2018.0,1,0,1
ITA,LTU,2006.0,7,0,7
,TGO,2009.0,40,0,40
DZA,TUR,2015.0,1,0,1
,KGZ,2008.0,11,0,11
FLK,GBR,2009.0,1,0,1
,HND,2013.0,16,0,16
CRI,AUT,2018.0,2,0,2
FRA,ISL,2017.0,4,0,4
CRI,AUS,2019.0,1,0,1
VEN,PRT,2020.0,2,0,2
,MTQ,2000.0,4,0,4
,FRO,2017.0,9,0,9
PER,DNK,2021.0,1,0,1
IRN,ISL,2021.0,1,0,1
MAR,MDG,2020.0,1,0,1
UGA,NAM,2018.0,1,0,1
CHE,LBN,2005.0,1,0,1
MYS,KEN,2021.0,2,0,2
CAN,SEN,2009.0,1,0,1
CHL,BOL,2004.0,1,0,1
RUS,EST,2013.0,5,0,5
,SYR,1996.0,8,0,8
BHR,JOR,1998.0,1,0,1
NLD,GRD,2013.0,1,0,1
SWE,PAN,2006.0,1,0,1
,SYC,2001.0,3,0,3
AUT,PAK,2004.0,1,0,1
BGD,SGP,2004.0,2,0,2
ARE,ECU,2013.0,1,0,1
ARG,SRB,2010.0,3,0,3
TWN,ISR,2009.0,2,0,2
JPN,ZMB,2014.0,4,0,4
RUS,PRI,2009.0,1,0,1
FRA,TGO,2012.0,6,0,6
KEN,ITA,2007.0,2,0,2
ZAF,ROU,2010.0,1,0,1
JOR,DZA,2010.0,2,0,2
MHL,,2012.0,1,0,1
CHN,IDN,2011.0,2,0,2
NLD,VNM,2006.0,5,0,5
EGY,NOR,2009.0,1,0,1
ITA,ARE,2010.0,1,0,1
ESP,TUN,2006.0,2,0,2
THA,HKG,2013.0,2,0,2
YEM,TUR,2019.0,1,0,1
ISR,IDN,2018.0,1,0,1
IRN,ITA,2008.0,10,0,10
CAN,TZA,2022.0,2,0,2
IND,SRB,2013.0,1,0,1
FRA,NGA,2000.0,1,0,1
GIN,,2010.0,6,0,6
AUS,PAN,1997.0,1,0,1
IND,TUN,2017.0,1,0,1
LVA,RUS,2007.0,1,0,1
VEN,AUS,2010.0,1,0,1
SEN,PRT,2002.0,1,0,1
PHL,IND,2003.0,2,0,2
TUR,ROU,2016.0,1,0,1
GIN,,2017.0,12,0,12
PRI,COL,2019.0,2,0,2
ISR,TWN,2007.0,2,0,2
BRA,HUN,2020.0,7,0,7
PER,VEN,2010.0,2,0,2
MMR,MYS,2018.0,1,0,1
CZE,CUB,2008.0,1,0,1
PRT,MLT,2019.0,1,0,1
SHN,USA,2020.0,1,0,1
NZL,IRN,2000.0,1,0,1
POL,FIN,2006.0,3,0,3
BHR,THA,2016.0,1,0,1
SVK,IRN,2017.0,1,0,1
BEL,LVA,2020.0,4,0,4
PRT,NAM,2017.0,1,0,1
SEN,MRT,2019.0,1,0,1
MWI,CAN,2012.0,2,0,2
PRT,MLT,2017.0,2,0,2
IND,DZA,2014.0,1,0,1
HUN,SVN,2009.0,1,0,1
NAM,,2005.0,4,0,4
JPN,ETH,2008.0,2,0,2
GRL,RUS,2005.0,1,0,1
JPN,BFA,2007.0,1,0,1
TUR,BHR,2011.0,1,0,1
SWE,ZMB,2004.0,1,0,1
KWT,PAK,2004.0,1,0,1
NGA,BFA,2021.0,2,0,2
CHE,VNM,2002.0,2,0,2
CHN,BRA,2003.0,4,0,4
FJI,SUR,2019.0,1,0,1
BFA,NGA,2004.0,3,0,3
ETH,ZWE,2000.0,1,0,1
MMR,,2009.0,5,0,5
ECU,ZAF,2016.0,1,0,1
PRT,ISR,2001.0,1,0,1
SWE,ZWE,2000.0,1,0,1
COL,PER,2003.0,1,0,1
VEN,TWN,1999.0,1,0,1
LTU,JPN,2009.0,2,0,2
MDA,TUR,2010.0,1,0,1
IRN,KAZ,2012.0,1,0,1
GEO,HUN,2006.0,1,0,1
YEM,RUS,2007.0,1,0,1
LKA,KOR,2007.0,1,0,1
FRA,NER,2012.0,6,0,6
MLT,LVA,2001.0,1,0,1
MOZ,AGO,2008.0,1,0,1
IND,SVN,2015.0,2,0,2
NZL,SLB,2008.0,1,0,1
CHN,TGO,2017.0,1,0,1
FIN,HRV,2017.0,1,0,1
THA,BTN,2013.0,3,0,3
CMR,COG,2021.0,1,0,1
BRB,JAM,2017.0,1,0,1
ZAF,SGP,2020.0,1,0,1
GRL,SWE,2007.0,1,0,1
,FRO,2019.0,3,0,3
,ABW,2019.0,3,0,3
NCL,GBR,2019.0,1,0,1
PHL,HKG,2021.0,5,0,5
CMR,DNK,2004.0,1,0,1
ISR,SVK,2009.0,1,0,1
UGA,DEU,2002.0,4,0,4
AUS,MNE,2011.0,1,0,1
GMB,AUS,2018.0,1,0,1
MOZ,ESP,2021.0,3,0,3
AZE,EGY,2019.0,1,0,1
PRY,BEL,2016.0,1,0,1
BFA,GBR,2020.0,1,0,1
GBR,MNG,2003.0,1,0,1
GRC,TUN,2011.0,1,0,1
GMB,SEN,2017.0,1,0,1
ERI,SAU,2019.0,1,0,1
FJI,NZL,2010.0,2,0,2
ETH,NOR,2003.0,3,0,3
SRB,ZAF,2017.0,1,0,1
MWI,BWA,2007.0,1,0,1
BGR,HUN,2004.0,1,0,1
AGO,,2007.0,2,0,2
ITA,PSE,2011.0,2,0,2
LBY,USA,2009.0,1,0,1
PAN,SGP,2015.0,1,0,1
LTU,IRL,2005.0,1,0,1
ARM,CZE,2012.0,1,0,1
BLR,FIN,2006.0,1,0,1
,WSM,2009.0,1,0,1
IRL,MLT,2008.0,1,0,1
CAN,LBY,2004.0,2,0,2
BEL,QAT,2011.0,2,0,2
BMU,USA,2019.0,1,0,1
ITA,NER,2021.0,1,0,1
SVK,CHN,2012.0,1,0,1
CUB,NGA,2006.0,4,0,4
MLT,ARE,2012.0,1,0,1
MTQ,,2012.0,2,0,2
MEX,ROU,2008.0,1,0,1
SWZ,MOZ,2015.0,1,0,1
AUT,LBN,2017.0,1,0,1
ZWE,DEU,1998.0,1,0,1
DNK,LTU,1998.0,1,0,1
USA,DZA,2006.0,2,0,2
SVK,SAU,2013.0,1,0,1
FJI,ITA,2018.0,1,0,1
ESP,NIC,2015.0,1,0,1
ISL,NZL,2018.0,1,0,1
TUN,CHL,2016.0,1,0,1
HRV,SWE,2015.0,5,0,5
ARG,NOR,2018.0,2,0,2
PER,NLD,2022.0,2,0,2
USA,NIC,2019.0,2,0,2
DNK,KEN,2021.0,1,0,1
NOR,ARE,2004.0,1,0,1
BGR,PAK,2008.0,1,0,1
SEN,CHE,2009.0,1,0,1
FIN,OMN,2015.0,1,0,1
BIH,EGY,2021.0,1,0,1
GRC,PRI,2000.0,1,0,1
ZMB,CHE,2016.0,3,0,3
JOR,SDN,2018.0,1,0,1
ISR,MEX,2007.0,4,0,4
FRA,LIE,2013.0,1,0,1
THA,KWT,2016.0,1,0,1
TUR,PSE,2003.0,1,0,1
SAU,DNK,2004.0,1,0,1
JPN,TUR,1998.0,1,0,1
NGA,DEU,2000.0,1,0,1
ECU,CAN,1998.0,1,0,1
BGR,GRC,2021.0,2,0,2
AUT,HUN,1998.0,4,0,4
SVN,IRL,2002.0,2,0,2
MAR,BRA,2018.0,1,0,1
CRI,AUS,2010.0,3,0,3
RUS,AUT,1997.0,3,0,3
,SWZ,1995.0,4,0,4
PER,BOL,2014.0,1,0,1
URY,DNK,2005.0,1,0,1
NLD,PYF,2007.0,1,0,1
BRN,,2008.0,2,0,2
SWE,TUN,2015.0,2,0,2
RUS,IRN,2003.0,1,0,1
DEU,MAC,2008.0,1,0,1
PYF,CAN,2021.0,1,0,1
,DMA,2012.0,1,0,1
CYP,SWE,2022.0,1,0,1
JOR,NPL,2017.0,1,0,1
NGA,MOZ,2020.0,1,0,1
NLD,SLE,2012.0,2,0,2
YEM,PAK,2020.0,1,0,1
SRB,AUS,1999.0,2,0,2
CIV,BEN,2015.0,1,0,1
SYR,ETH,2005.0,1,0,1
ZMB,SEN,2015.0,1,0,1
SWE,OMN,2014.0,1,0,1
HKG,TUR,2004.0,1,0,1
DEU,MDG,2018.0,2,0,2
IRN,LVA,2021.0,1,0,1
JPN,MLT,2004.0,1,0,1
BFA,SDN,2018.0,1,0,1
TUN,OMN,2014.0,3,0,3
RWA,SGP,2020.0,1,0,1
MNE,USA,2013.0,1,0,1
ZWE,BWA,2021.0,1,0,1
JPN,MDG,2004.0,1,0,1
JPN,NGA,2004.0,3,0,3
SGP,VNM,2009.0,1,0,1
AZE,TWN,2004.0,1,0,1
SWE,MCO,2015.0,1,0,1
ETH,PER,2014.0,1,0,1
ROU,NZL,2016.0,1,0,1
AUT,KAZ,2016.0,3,0,3
UGA,OMN,2014.0,1,0,1
RWA,BWA,2002.0,1,0,1
ZAF,LSO,2004.0,1,0,1
MDA,BLR,2020.0,1,0,1
PRY,AUS,2018.0,1,0,1
HND,ARG,2014.0,1,0,1
,SSD,2017.0,3,0,3
FRA,DEU,2023.0,1,0,1
TZA,,2004.0,11,0,11
MOZ,FRA,2002.0,1,0,1
SGP,KWT,2010.0,1,0,1
SAU,TWN,2009.0,1,0,1
CAN,MWI,2009.0,1,0,1
PAK,KHM,2021.0,1,0,1
SWE,UGA,2014.0,2,0,2
GBR,FJI,2008.0,1,0,1
,SLB,2006.0,3,0,3
SSD,,2019.0,3,0,3
GBR,TTO,2022.0,3,0,3
IRN,LTU,2017.0,1,0,1
POL,HRV,2016.0,7,0,7
IND,COL,1999.0,1,0,1
PYF,GLP,2008.0,1,0,1
MMR,SGP,2018.0,2,0,2
NCL,GBR,2017.0,1,0,1
CHL,ISL,2022.0,1,0,1
IRL,TWN,2011.0,1,0,1
LTU,DNK,2002.0,1,0,1
BLR,MKD,2019.0,1,0,1
PRT,NPL,2016.0,1,0,1
ZAF,VNM,2020.0,3,0,3
IND,YEM,2006.0,1,0,1
SVK,SWE,2013.0,1,0,1
LBN,BEL,2009.0,1,0,1
MYS,SDN,2004.0,1,0,1
OMN,AUT,2018.0,1,0,1
VEN,AUS,2017.0,3,0,3
EGY,PAK,2006.0,1,0,1
SVN,ARM,2018.0,1,0,1
BLR,SWE,2001.0,1,0,1
ARM,USA,1997.0,2,0,2
BLZ,,2006.0,1,0,1
DZA,NGA,2007.0,1,0,1
NZL,JOR,2007.0,1,0,1
NPL,CAF,2021.0,1,0,1
ARM,GEO,2016.0,1,0,1
KOR,GRC,2011.0,1,0,1
SRB,MEX,2001.0,1,0,1
GHA,COD,2018.0,1,0,1
TUR,ISL,2020.0,1,0,1
KOR,SAU,2009.0,1,0,1
MDG,CAN,2019.0,1,0,1
IRL,ISL,2005.0,1,0,1
COG,,2000.0,3,0,3
BEL,BLR,2008.0,1,0,1
GUM,USA,2015.0,4,0,4
BRB,GBR,2001.0,1,0,1
CUB,NLD,2015.0,1,0,1
KEN,PRT,2020.0,1,0,1
KOR,AZE,2010.0,1,0,1
IRN,OMN,2011.0,1,0,1
CHL,CPV,2018.0,1,0,1
TUN,BEN,2017.0,1,0,1
PER,LUX,2021.0,1,0,1
VNM,BWA,2018.0,1,0,1
AUT,ECU,2013.0,1,0,1
JOR,DZA,2019.0,1,0,1
ESP,PNG,2011.0,1,0,1
ZAF,MAC,2018.0,1,0,1
NGA,TTO,2011.0,1,0,1
DEU,NZL,1997.0,2,0,2
TZA,UGA,2003.0,1,0,1
PRY,MEX,2016.0,3,0,3
KOR,BHR,2010.0,1,0,1
BRA,SVN,2009.0,1,0,1
URY,SWE,2007.0,1,0,1
PRY,,2004.0,2,0,2
DNK,NPL,2014.0,1,0,1
CZE,PAK,2013.0,1,0,1
NOR,OMN,2021.0,1,0,1
ZMB,CAN,2007.0,1,0,1
PNG,NLD,2018.0,1,0,1
NZL,VNM,2022.0,1,0,1
BHR,ARE,2000.0,1,0,1
UKR,MYS,2019.0,1,0,1
ECU,GBR,2006.0,1,0,1
GRC,JOR,2014.0,1,0,1
NZL,PNG,2020.0,1,0,1
MWI,AUS,2020.0,1,0,1
FRA,URY,2022.0,1,0,1
EGY,POL,2004.0,2,0,2
PAK,PRI,2010.0,1,0,1
TZA,JPN,2001.0,1,0,1
BEL,CIV,2009.0,1,0,1
KWT,THA,2019.0,1,0,1
AFG,ALB,2020.0,1,0,1
GNB,DNK,2000.0,1,0,1
ITA,SEN,2005.0,1,0,1
BGR,ESP,2003.0,1,0,1
ETH,GHA,2012.0,1,0,1
SRB,PRT,2004.0,1,0,1
AFG,,2011.0,5,0,5
CHN,MUS,2019.0,2,0,2
CHN,TTO,2021.0,1,0,1
ZAF,ROU,2019.0,2,0,2
NLD,PAN,2014.0,1,0,1
ARG,KOR,2017.0,2,0,2
CUB,DOM,2013.0,1,0,1
DOM,JPN,2003.0,1,0,1
SEN,MRT,2017.0,2,0,2
MDG,,2001.0,1,0,1
ISR,KEN,2006.0,1,0,1
GIN,GNB,2004.0,1,0,1
KOR,SRB,2014.0,1,0,1
TTO,QAT,2006.0,1,0,1
POL,THA,2002.0,1,0,1
CAF,SEN,2010.0,1,0,1
COL,PAN,2008.0,1,0,1
GBR,SYC,2018.0,2,0,2
TJK,NGA,2014.0,1,0,1
NIC,NLD,2020.0,1,0,1
JOR,TWN,2016.0,2,0,2
,ABW,2010.0,1,0,1
ARE,ARM,2021.0,1,0,1
OMN,MYS,2002.0,1,0,1
ROU,BGR,2007.0,1,0,1
FRA,ALB,2007.0,1,0,1
COL,ARM,2016.0,1,0,1
SRB,SAU,2013.0,1,0,1
COL,ISR,2021.0,1,0,1
PHL,IDN,2012.0,1,0,1
MEX,LUX,2022.0,1,0,1
ROU,CIV,2016.0,1,0,1
FIN,HRV,2019.0,1,0,1
COL,DOM,2016.0,1,0,1
KOR,GAB,2020.0,1,0,1
VEN,PAK,2017.0,1,0,1
THA,KOR,2007.0,1,0,1
DZA,YEM,2015.0,1,0,1
VUT,AUS,2021.0,1,0,1
BRB,NLD,2018.0,1,0,1
UKR,ISL,2020.0,1,0,1
ITA,OMN,2020.0,2,0,2
NZL,BRN,2014.0,1,0,1
SWE,HRV,2016.0,1,0,1
IDN,SDN,2022.0,1,0,1
KWT,SYR,2021.0,1,0,1
ESP,MKD,2015.0,1,0,1
QAT,SDN,2012.0,1,0,1
HRV,BGR,2003.0,1,0,1
PHL,RUS,2017.0,1,0,1
NGA,ARE,2022.0,1,0,1
EST,KAZ,2018.0,1,0,1
USA,BIH,2022.0,1,0,1
MYS,MUS,2021.0,1,0,1
,AIA,2016.0,1,0,1
FLK,,2014.0,1,0,1
MEX,CMR,2009.0,1,0,1
USA,TGO,2004.0,1,0,1
IDN,NPL,2017.0,1,0,1
URY,CHN,2019.0,1,0,1
QAT,MYS,2007.0,1,0,1
IND,KAZ,2005.0,1,0,1
DNK,LKA,1998.0,1,0,1
KWT,ARE,2003.0,1,0,1
MEX,KOR,1997.0,1,0,1
PRT,IRL,1999.0,1,0,1
THA,ARE,2007.0,1,0,1
BRA,CZE,1998.0,1,0,1
EST,GBR,2003.0,1,0,1
NPL,PHL,2003.0,1,0,1
TLS,,2016.0,1,0,1
GBR,GUY,2020.0,1,0,1
MAC,VNM,2008.0,1,0,1
HUN,PAK,2022.0,1,0,1
HUN,MNG,2011.0,1,0,1
AUS,PRT,2004.0,1,0,1
CHE,LIE,2005.0,1,0,1
NGA,BWA,2004.0,1,0,1
NGA,TWN,2013.0,1,0,1
NLD,PRI,2014.0,1,0,1
MUS,THA,2020.0,2,0,2
TWN,NZL,2005.0,1,0,1
FJI,OMN,2001.0,1,0,1
HKG,SWE,1998.0,1,0,1
JPN,HND,2005.0,1,0,1
DEU,MWI,2012.0,1,0,1
BGD,BWA,2013.0,1,0,1
MDA,CAN,2017.0,1,0,1
,MDV,2002.0,1,0,1
IRQ,CAN,2022.0,1,0,1
FRA,KHM,2004.0,1,0,1
MKD,PRT,2018.0,1,0,1
PRT,GNB,2002.0,1,0,1
NPL,ISR,2016.0,1,0,1
GNB,,2009.0,1,0,1
BOL,ETH,2017.0,1,0,1
MLI,,1999.0,1,0,1
AUS,LUX,2007.0,1,0,1
IRN,TJK,2017.0,1,0,1
MYS,PSE,2008.0,1,0,1
ISL,GEO,2014.0,1,0,1
MEX,CZE,2009.0,1,0,1
MLI,DEU,2017.0,1,0,1
GBR,MDV,2019.0,1,0,1
SLE,ETH,2018.0,1,0,1
CHN,TGO,2019.0,1,0,1
IRL,MMR,2019.0,1,0,1
BTN,JPN,2020.0,1,0,1
BGR,CAN,2016.0,1,1,0
KOR,IND,2015.0,115,226,-111
USA,FRA,2013.0,677,816,-139
SRB,RUS,2020.0,2,1,1
GBR,USA,2010.0,1467,1284,183
USA,AUS,2008.0,507,396,111
ISR,USA,2011.0,317,302,15
CHN,USA,2005.0,928,657,271
NZL,DEU,2004.0,13,27,-14
FRA,DEU,2003.0,245,232,13
USA,NLD,2013.0,280,358,-78
USA,DEU,2011.0,1047,1168,-121
BEL,TUR,2007.0,4,5,-1
DEU,IRL,2008.0,41,21,20
NLD,ISL,2007.0,3,2,1
USA,TZA,2018.0,16,13,3
USA,UKR,2009.0,16,17,-1
GBR,SGP,2013.0,84,55,29
DEU,CHL,2022.0,17,12,5
GBR,MYS,2010.0,110,55,55
ESP,HUN,2011.0,3,2,1
GBR,USA,2019.0,1674,1514,160
CAN,SWE,2011.0,32,31,1
DNK,NOR,2015.0,49,31,18
FRA,CAN,2007.0,244,210,34
DNK,USA,2010.0,89,97,-8
DEU,ZAF,2006.0,21,10,11
ESP,DEU,2012.0,194,188,6
USA,HUN,2011.0,53,65,-12
IND,USA,2004.0,579,237,342
ZWE,GBR,2011.0,2,3,-1
TUR,GBR,2013.0,42,53,-11
BGR,USA,2006.0,13,10,3
GBR,DNK,2008.0,66,55,11
CHN,USA,2002.0,787,428,359
DEU,AUS,2007.0,127,81,46
FRA,TUN,2013.0,116,74,42
CAN,CHN,2005.0,66,118,-52
HRV,GBR,2013.0,8,5,3
GBR,THA,2013.0,67,39,28
JPN,CAN,2022.0,20,35,-15
FRA,BRA,2008.0,62,82,-20
BRA,GRC,2022.0,1,1,0
CHE,USA,2016.0,494,561,-67
CZE,USA,2008.0,43,54,-11
JPN,KOR,2009.0,135,105,30
USA,LBN,2012.0,53,39,14
CUB,BRA,2018.0,19,3,16
ESP,VEN,2009.0,24,27,-3
CHN,GBR,2006.0,114,112,2
CHE,NOR,2012.0,13,14,-1
JPN,BGD,2010.0,52,44,8
CHL,FRA,2012.0,13,36,-23
JPN,MYS,2018.0,60,35,25
DEU,ITA,2008.0,121,168,-47
TZA,KEN,2010.0,5,6,-1
GBR,MYS,2017.0,104,76,28
GBR,USA,2017.0,1735,1502,233
ITA,GBR,2020.0,477,385,92
IRL,MYS,2008.0,1,1,0
CHN,DEU,2012.0,242,199,43
FIN,TUR,2011.0,6,3,3
BFA,FRA,2015.0,22,14,8
CAN,KWT,2016.0,11,9,2
GBR,PRT,2018.0,78,116,-38
ESP,GBR,2014.0,440,219,221
SGP,USA,2013.0,189,243,-54
CHN,SGP,2008.0,121,117,4
RUS,USA,2007.0,186,121,65
BRA,ITA,2013.0,25,43,-18
FIN,DEU,2013.0,36,36,0
KHM,THA,2010.0,1,1,0
ITA,IND,2014.0,34,46,-12
GBR,BEL,2007.0,53,74,-21
IND,CHN,2011.0,22,8,14
DNK,USA,2019.0,154,152,2
SGP,RUS,2017.0,5,2,3
PHL,USA,2013.0,19,16,3
SVN,FRA,2021.0,8,4,4
BRA,NLD,2017.0,35,22,13
RUS,VNM,2018.0,20,3,17
JPN,GBR,2022.0,53,48,5
IRL,AUS,2019.0,45,47,-2
HRV,SVN,2021.0,8,3,5
AUS,AUT,2015.0,15,24,-9
PAK,CHN,2017.0,221,127,94
KOR,CHN,2021.0,195,125,70
JPN,USA,2022.0,245,288,-43
MYS,IND,2020.0,65,50,15
CAN,PAK,2014.0,12,20,-8
GBR,CYP,2016.0,43,19,24
AUS,MYS,2014.0,128,73,55
ZAF,USA,2020.0,111,59,52
IND,ZAF,2020.0,35,35,0
ESP,CUB,2012.0,13,37,-24
MAC,CHN,2018.0,84,67,17
AUS,CHE,2021.0,54,41,13
AUS,GBR,2004.0,300,385,-85
ZAF,CHE,2019.0,16,6,10
DEU,POL,2010.0,62,64,-2
PAK,CHN,2019.0,298,267,31
CYP,GRC,2021.0,23,34,-11
CHN,KOR,2007.0,55,71,-16
ITA,DEU,2015.0,279,173,106
AUT,BRA,2020.0,4,18,-14
ESP,RUS,2017.0,11,7,4
IND,TUR,2013.0,3,3,0
ESP,BEL,2015.0,77,44,33
GBR,NZL,2019.0,130,116,14
HKG,SGP,2019.0,33,36,-3
JPN,MEX,2014.0,9,6,3
DEU,DNK,2020.0,135,100,35
POL,ITA,2018.0,25,32,-7
DEU,ETH,2014.0,6,5,1
SRB,BIH,2015.0,11,8,3
HKG,USA,2022.0,56,92,-36
KOR,MNG,2019.0,10,6,4
USA,BEL,2021.0,97,124,-27
CHN,NOR,2013.0,18,16,2
ARE,USA,2015.0,42,82,-40
SAU,CHE,2019.0,6,4,2
IND,BEL,2016.0,26,27,-1
FRA,ZAF,2018.0,28,13,15
AUS,DNK,2019.0,48,42,6
CAN,CHE,2021.0,74,47,27
ZAF,NGA,2019.0,65,82,-17
NLD,AUT,2003.0,20,16,4
AUS,HKG,2006.0,24,36,-12
DEU,KEN,2016.0,16,6,10
ROU,USA,2015.0,20,20,0
DNK,USA,2017.0,129,140,-11
DEU,POL,2019.0,69,69,0
FRA,AUS,2020.0,79,69,10
CHN,AUT,2006.0,7,2,5
BRA,AUS,2021.0,57,23,34
PRT,IRL,2017.0,6,5,1
JPN,TWN,2022.0,22,11,11
CAN,QAT,2018.0,13,11,2
ZAF,NGA,2017.0,53,77,-24
CHL,USA,2022.0,46,29,17
ITA,FIN,2018.0,26,18,8
TTO,USA,2021.0,7,1,6
ZAF,AUS,2018.0,44,20,24
USA,ZWE,2018.0,6,6,0
FRA,REU,2021.0,5,10,-5
KOR,MEX,2021.0,2,3,-1
PAK,KOR,2021.0,43,63,-20
FRA,PRT,2018.0,41,38,3
IND,AUS,2022.0,48,32,16
GRC,NOR,2013.0,3,1,2
SWE,IRQ,2016.0,4,4,0
POL,ISR,2021.0,1,3,-2
KOR,NLD,2015.0,12,7,5
MYS,PAK,2014.0,30,61,-31
CZE,DEU,2022.0,20,21,-1
NZL,GBR,2002.0,87,69,18
ESP,QAT,2018.0,6,2,4
GBR,MYS,2019.0,105,92,13
EGY,CHN,2018.0,20,18,2
ESP,IRL,2020.0,43,24,19
ITA,ESP,2003.0,76,69,7
SAU,AUS,2018.0,25,53,-28
USA,CHL,2021.0,64,92,-28
IND,JPN,2008.0,73,54,19
BFA,GHA,2019.0,2,2,0
NLD,JPN,2020.0,18,30,-12
BRA,NLD,2019.0,32,16,16
NOR,ESP,2020.0,27,24,3
LTU,GBR,2009.0,7,2,5
GBR,LTU,2016.0,7,10,-3
ESP,ECU,2018.0,58,30,28
CAN,AUS,2022.0,51,61,-10
SRB,AUS,2019.0,3,3,0
PAK,NGA,2022.0,1,1,0
BRA,JPN,2021.0,9,4,5
JPN,IND,2008.0,54,73,-19
KOR,ETH,2020.0,10,1,9
ISR,CHE,2005.0,10,8,2
UKR,DEU,2005.0,37,17,20
BEL,DNK,2018.0,16,9,7
FIN,SWE,2008.0,28,28,0
EGY,CAN,2020.0,31,46,-15
USA,PRI,2007.0,59,44,15
CHE,DEU,2004.0,244,435,-191
CMR,JPN,2010.0,1,1,0
IND,FRA,2013.0,71,53,18
MYS,BRN,2017.0,10,2,8
PER,BRA,2021.0,12,33,-21
IND,PAK,2013.0,22,24,-2
IND,CAN,2013.0,121,87,34
ESP,EGY,2016.0,18,4,14
NLD,IND,2008.0,14,17,-3
BEL,ISR,2019.0,8,5,3
CAN,DNK,2011.0,20,20,0
CAN,ISR,2015.0,57,51,6
JPN,BGD,2019.0,97,41,56
THA,JPN,2013.0,45,85,-40
POL,RUS,2015.0,14,9,5
ECU,MEX,2020.0,9,11,-2
CHE,AUT,2018.0,77,64,13
DEU,POL,2017.0,70,88,-18
NZL,PAK,2017.0,14,6,8
SGP,AUS,2022.0,27,18,9
FIN,AUS,2015.0,13,16,-3
SYR,JOR,2017.0,5,1,4
LTU,DEU,2012.0,3,4,-1
SGP,RUS,2010.0,1,5,-4
GBR,ARE,2008.0,21,7,14
CHE,ITA,2004.0,58,75,-17
CAN,FIN,2011.0,9,10,-1
CHL,GBR,2008.0,17,12,5
VEN,ESP,2011.0,29,17,12
SWE,ESP,2008.0,33,26,7
ZAF,GBR,2011.0,71,74,-3
FRA,EGY,2013.0,20,9,11
AUS,JOR,2012.0,7,1,6
UKR,CHN,2018.0,16,3,13
DEU,KOR,2005.0,22,20,2
MAR,FRA,2013.0,34,88,-54
ZAF,NGA,2010.0,11,26,-15
POL,NLD,2012.0,13,25,-12
PAN,ESP,2017.0,3,4,-1
ESP,POL,2016.0,19,18,1
BRA,NLD,2010.0,16,12,4
AUS,CHN,1999.0,11,31,-20
CHE,ISR,2017.0,17,18,-1
TWN,HKG,2019.0,14,20,-6
IDN,KEN,2010.0,3,2,1
IDN,KEN,2017.0,3,1,2
IRL,AUS,2017.0,41,40,1
NOR,CHE,2007.0,4,13,-9
CAN,CHN,2002.0,39,104,-65
BRB,TTO,2006.0,2,2,0
DEU,CAN,2000.0,42,19,23
NZL,ZAF,2012.0,5,6,-1
GRC,CHE,2014.0,35,11,24
KOR,DEU,2001.0,11,12,-1
REU,FRA,2013.0,19,5,14
NZL,CAN,2009.0,25,43,-18
DEU,SVN,2020.0,9,11,-2
MYS,JPN,2004.0,3,11,-8
MEX,CAN,2011.0,27,26,1
GBR,CHL,2014.0,42,28,14
NOR,NLD,2015.0,12,36,-24
RUS,NLD,2022.0,12,10,2
BRA,RUS,2003.0,10,10,0
SVK,POL,2019.0,5,3,2
ESP,RUS,2019.0,5,14,-9
AUT,JPN,2018.0,7,12,-5
ITA,HUN,2005.0,7,6,1
NGA,GBR,2002.0,21,14,7
IND,SGP,2006.0,27,15,12
ECU,CHL,2014.0,2,1,1
LVA,RUS,2016.0,2,2,0
IND,FIN,2008.0,5,6,-1
AUT,USA,1999.0,46,46,0
SAU,IRL,2021.0,2,4,-2
USA,NOR,2005.0,50,46,4
JOR,ARE,2013.0,12,4,8
CAN,SGP,2021.0,10,24,-14
SGP,DEU,2004.0,8,12,-4
JPN,ESP,2012.0,8,12,-4
RUS,DEU,2003.0,166,116,50
ARE,ZAF,2021.0,2,7,-5
KEN,USA,2003.0,15,23,-8
BEL,QAT,2014.0,2,1,1
COL,ESP,2017.0,49,125,-76
RUS,LTU,2019.0,2,4,-2
DEU,PAK,2020.0,32,34,-2
USA,ISL,2021.0,11,5,6
TWN,HKG,2017.0,15,8,7
SAU,GBR,2018.0,46,163,-117
HRV,DNK,2019.0,2,1,1
POL,IRL,2014.0,6,2,4
NAM,ZAF,2016.0,3,10,-7
ZMB,GBR,2018.0,8,1,7
BRA,PAK,2018.0,11,7,4
GBR,ZAF,2001.0,19,53,-34
ZAF,CHE,2017.0,20,6,14
TUR,CAN,2022.0,10,13,-3
BIH,HRV,2020.0,9,6,3
MYS,TWN,2014.0,6,5,1
EGY,LBY,2021.0,4,1,3
COL,BRA,2016.0,41,37,4
PAN,USA,2022.0,10,3,7
USA,PER,2022.0,12,22,-10
SVK,POL,2017.0,5,6,-1
CAN,EGY,2015.0,39,23,16
SGP,PAK,2021.0,4,5,-1
TUN,SAU,2015.0,57,9,48
CHL,CHE,2004.0,2,3,-1
THA,CHN,2021.0,24,21,3
JOR,AUS,2021.0,6,4,2
QAT,AUS,2020.0,11,10,1
ETH,RUS,2020.0,6,8,-2
MYS,BRN,2019.0,6,5,1
PAK,IRN,2021.0,1,3,-2
HUN,NLD,2013.0,10,9,1
HUN,NOR,2011.0,4,1,3
AFG,CHE,2013.0,1,1,0
AUS,DNK,2017.0,26,25,1
IRL,IND,2015.0,16,14,2
BGR,GBR,2007.0,2,4,-2
MEX,ARG,2015.0,12,13,-1
HUN,CAN,2012.0,7,6,1
MYS,CAN,2018.0,28,8,20
LKA,AUS,2012.0,16,10,6
AUS,VNM,2013.0,12,8,4
ESP,JPN,2008.0,8,16,-8
KEN,NAM,2015.0,1,1,0
USA,QAT,2008.0,19,3,16
ITA,LBN,2014.0,5,1,4
IND,HKG,2014.0,8,8,0
DEU,BEL,2007.0,63,48,15
HRV,NLD,2015.0,3,1,2
BEL,ISR,2010.0,6,2,4
ITA,GRC,2006.0,18,10,8
IRN,AUS,2004.0,5,13,-8
GMB,USA,2018.0,3,1,2
MEX,CHE,2011.0,5,4,1
DNK,FIN,2013.0,12,9,3
ZAF,RUS,1999.0,3,3,0
CAN,PRT,2002.0,3,7,-4
CHE,NZL,2007.0,9,7,2
NGA,DEU,2001.0,6,6,0
KAZ,RUS,2003.0,8,5,3
BLR,RUS,2005.0,12,11,1
CHE,ARG,2015.0,7,8,-1
BHS,USA,2016.0,3,3,0
SWE,ISL,2003.0,15,13,2
DNK,AUS,2017.0,25,26,-1
NLD,ITA,2004.0,42,45,-3
ESP,PRT,2006.0,33,22,11
GBR,KOR,2004.0,32,18,14
UGA,USA,2009.0,14,11,3
ITA,HUN,2002.0,11,10,1
FIN,EST,2002.0,5,7,-2
GBR,ITA,1999.0,66,93,-27
GBR,SVK,2003.0,5,7,-2
RUS,ESP,2005.0,12,5,7
JPN,NZL,2004.0,9,3,6
ESP,AUS,2012.0,37,20,17
NOR,DEU,2004.0,18,28,-10
USA,SVN,2003.0,15,5,10
GBR,BGR,2003.0,9,9,0
BLR,RUS,2002.0,8,30,-22
DEU,SDN,2005.0,1,3,-2
URY,BRA,2016.0,2,8,-6
ESP,RUS,2010.0,4,10,-6
SVK,CHE,2001.0,6,2,4
SWE,UKR,2008.0,3,2,1
AUS,DNK,2010.0,19,16,3
DEU,ARM,2003.0,4,5,-1
HRV,ESP,2000.0,1,3,-2
OMN,QAT,2013.0,2,1,1
MEX,FRA,2004.0,18,37,-19
JPN,MAR,2005.0,1,1,0
ECU,AUS,2004.0,1,2,-1
KGZ,RUS,2014.0,3,3,0
NOR,CAN,2006.0,6,17,-11
NLD,NZL,2003.0,6,4,2
HUN,SWE,1999.0,3,1,2
AUT,ESP,2003.0,9,9,0
DEU,KOR,2002.0,13,22,-9
FRA,SEN,2004.0,25,23,2
DEU,BGR,2003.0,20,22,-2
AUS,POL,2005.0,1,2,-1
CAN,BEL,1999.0,6,3,3
IRL,AUS,2010.0,43,31,12
FRA,MDG,2002.0,9,7,2
AUS,POL,2002.0,4,6,-2
ROU,BEL,2002.0,6,3,3
RUS,ESP,2002.0,12,9,3
CZE,SVK,2005.0,20,27,-7
SWE,CHL,2002.0,4,2,2
COL,ARG,2011.0,6,5,1
CHE,RUS,2006.0,7,29,-22
POL,ESP,1997.0,2,3,-1
PRT,IRL,2010.0,4,5,-1
KWT,EGY,2000.0,5,2,3
CAN,ROU,2011.0,6,7,-1
THA,DEU,2004.0,6,11,-5
USA,PAN,2005.0,14,5,9
PER,USA,2013.0,30,31,-1
SAU,HUN,2019.0,2,1,1
FRA,UKR,2010.0,6,9,-3
COL,ESP,2010.0,61,50,11
GRC,DNK,2007.0,7,2,5
KEN,NLD,2008.0,1,2,-1
SVK,DEU,2006.0,9,17,-8
CZE,BEL,2013.0,10,9,1
PAK,CHN,2010.0,14,24,-10
ARE,IND,2013.0,6,28,-22
AUT,TUR,2018.0,4,13,-9
SWE,LTU,2014.0,7,3,4
GRC,CAN,2012.0,7,3,4
FRA,MDG,2005.0,4,3,1
FRA,ALB,2016.0,2,1,1
USA,LTU,2013.0,10,2,8
NLD,LUX,2013.0,11,2,9
MEX,PRT,2013.0,3,3,0
ITA,ARG,2008.0,21,12,9
SGP,BRN,2017.0,1,2,-1
SWE,ROU,2016.0,3,2,1
ISR,ITA,2009.0,11,11,0
NLD,DNK,2007.0,13,7,6
USA,GEO,2011.0,13,11,2
KOR,MNG,2017.0,7,1,6
AUS,NGA,2020.0,5,9,-4
FRA,IRL,2016.0,30,30,0
USA,LBY,2017.0,4,1,3
SGP,JPN,2021.0,21,14,7
CAN,KOR,2018.0,32,55,-23
IND,BTN,2018.0,3,1,2
CHN,MYS,2002.0,3,2,1
IND,EGY,2014.0,2,2,0
ROU,JPN,2015.0,2,6,-4
RWA,USA,2015.0,13,9,4
NGA,GBR,2005.0,12,8,4
MOZ,ZAF,2021.0,1,2,-1
AUS,CHL,2014.0,12,19,-7
GHA,IND,2018.0,2,7,-5
BRA,AUT,2015.0,4,4,0
OMN,CAN,2012.0,5,10,-5
AUT,CZE,2022.0,9,4,5
PRT,MOZ,2016.0,2,1,1
ARE,GBR,2014.0,12,25,-13
KOR,SWE,2020.0,20,8,12
TWN,HKG,2010.0,8,5,3
CMR,JPN,2017.0,1,2,-1
CHE,TWN,2009.0,4,2,2
CHN,ROU,2017.0,2,2,0
BRA,POL,2018.0,8,9,-1
PRT,IRL,2019.0,11,6,5
SRB,CHE,2015.0,9,7,2
CHN,GRC,2021.0,4,5,-1
TUR,KOR,2013.0,6,3,3
SAU,YEM,2021.0,3,8,-5
SAU,JPN,2021.0,2,4,-2
ESP,MOZ,2013.0,3,1,2
NOR,CHN,2003.0,4,5,-1
ARG,ESP,2007.0,61,62,-1
CHE,ESP,2013.0,49,73,-24
PRT,NLD,2000.0,4,2,2
CAN,CMR,2003.0,1,1,0
IDN,BEL,2004.0,1,3,-2
TUR,ROU,2007.0,4,1,3
SDN,SAU,2005.0,3,3,0
DEU,BOL,2007.0,1,3,-2
AUT,CHE,2000.0,11,6,5
USA,OMN,2008.0,4,2,2
ZAF,CHE,2010.0,4,11,-7
BGR,DEU,2004.0,23,12,11
SAU,ESP,2017.0,3,6,-3
TZA,GBR,2013.0,9,15,-6
ITA,SVN,1999.0,1,2,-1
CAN,PRT,2005.0,4,4,0
FRA,FIN,2016.0,32,22,10
FRA,HKG,2009.0,6,5,1
SWE,CAN,2012.0,32,43,-11
KOR,IRL,2020.0,3,4,-1
CHN,FIN,2013.0,22,18,4
GBR,HUN,2001.0,18,11,7
COL,FRA,2020.0,17,12,5
FRA,IRN,2013.0,17,20,-3
UKR,DEU,2002.0,50,21,29
SGP,RUS,2019.0,4,2,2
OMN,AUS,2008.0,3,3,0
BEL,TZA,2020.0,3,1,2
GBR,KEN,2014.0,21,10,11
FRA,UKR,2019.0,6,16,-10
CYP,GBR,2016.0,19,43,-24
NLD,IDN,2008.0,10,6,4
AUT,KEN,2021.0,1,1,0
NZL,SGP,2006.0,4,6,-2
POL,TUR,2018.0,1,2,-1
FRA,ARE,2014.0,10,2,8
ESP,PER,2021.0,14,17,-3
NPL,DEU,2021.0,3,1,2
PAK,BGD,2006.0,3,5,-2
MMR,THA,2016.0,3,3,0
PRT,BRA,1999.0,4,4,0
GBR,VNM,2013.0,6,12,-6
ARE,JPN,2011.0,1,2,-1
DEU,OMN,2014.0,5,2,3
IND,PRI,2012.0,1,2,-1
SAU,CHE,2017.0,12,4,8
NZL,PAK,2019.0,9,7,2
ARG,FRA,2018.0,31,26,5
COG,FRA,2001.0,3,1,2
TUN,DEU,2006.0,1,1,0
MAR,CAN,2012.0,5,10,-5
IND,ERI,2007.0,3,2,1
USA,BHR,2020.0,6,3,3
AZE,UKR,2016.0,1,1,0
DNK,HUN,2013.0,4,3,1
CHE,CMR,2006.0,1,3,-2
GBR,RUS,1998.0,9,24,-15
DOM,USA,2015.0,2,3,-1
JPN,FRA,1997.0,10,9,1
LVA,FIN,2014.0,1,1,0
ISR,HUN,2003.0,2,2,0
DEU,TWN,1999.0,6,1,5
DNK,JPN,2003.0,6,13,-7
IRL,CAN,2001.0,7,11,-4
SDN,SWE,2020.0,1,2,-1
SWE,KOR,2003.0,6,3,3
GBR,NPL,2006.0,2,4,-2
CMR,USA,2001.0,3,8,-5
SAU,KWT,2006.0,1,2,-1
GBR,IRN,2000.0,5,4,1
POL,UKR,1998.0,4,6,-2
UKR,GBR,2011.0,9,7,2
CZE,ESP,2012.0,10,8,2
BGR,JPN,2005.0,4,4,0
NPL,NOR,2015.0,2,2,0
FRA,PYF,2013.0,16,7,9
PSE,DEU,2005.0,2,1,1
NZL,FRA,2006.0,5,12,-7
CHE,ZWE,2012.0,1,2,-1
NOR,SVN,2015.0,1,2,-1
VEN,CUB,2009.0,3,3,0
ESP,SVK,2011.0,2,1,1
BEL,SGP,2012.0,4,3,1
CHE,ISR,2010.0,6,15,-9
PAK,FRA,2009.0,7,5,2
ARG,MEX,2001.0,4,3,1
BRA,PRY,2012.0,2,1,1
SVN,NOR,2015.0,2,1,1
GRD,USA,2011.0,6,3,3
ISR,IND,1998.0,3,4,-1
NCL,CHE,2018.0,1,1,0
CAN,AUT,2022.0,10,11,-1
USA,COD,2019.0,1,2,-1
GRL,DNK,2018.0,5,2,3
AUS,PAK,2022.0,10,17,-7
NGA,MYS,2011.0,9,9,0
TUR,QAT,2016.0,4,1,3
LVA,USA,2018.0,2,3,-1
NPL,IND,2015.0,19,33,-14
FRA,SYR,2008.0,4,2,2
AUT,AUS,2004.0,13,11,2
PRT,MYS,2019.0,3,2,1
ESP,AUT,2004.0,8,7,1
BEL,JPN,2001.0,7,9,-2
ITA,IRN,2007.0,4,4,0
CZE,AUT,2016.0,16,10,6
COL,GBR,2011.0,6,7,-1
DEU,PHL,2021.0,6,3,3
ISR,AUT,2021.0,8,6,2
SDN,SAU,2002.0,2,3,-1
BGD,SAU,2017.0,3,3,0
COL,MEX,2003.0,5,8,-3
EST,FIN,2012.0,7,19,-12
CHE,FIN,2005.0,3,5,-2
EGY,DEU,2000.0,9,7,2
PHL,THA,2016.0,3,1,2
BGR,JPN,2002.0,6,3,3
OMN,IND,2013.0,6,19,-13
SWE,HKG,2012.0,1,3,-2
NZL,RUS,2004.0,1,1,0
UKR,HUN,2015.0,1,3,-2
BGR,SWE,2012.0,2,1,1
VEN,DEU,2011.0,4,3,1
CAN,COL,2016.0,10,22,-12
ROU,HUN,2013.0,9,6,3
NGA,GHA,2021.0,8,3,5
HRV,BEL,2017.0,3,3,0
IRN,THA,2022.0,2,1,1
NGA,PAK,2017.0,1,1,0
NOR,HKG,2008.0,1,1,0
CHN,MEX,2001.0,2,1,1
BRA,ECU,2013.0,4,2,2
DEU,CRI,2020.0,1,7,-6
SRB,CZE,2019.0,2,2,0
ITA,GHA,2020.0,3,3,0
MYS,LKA,2022.0,3,3,0
DZA,TUN,2021.0,3,5,-2
USA,BFA,2004.0,1,2,-1
AUS,ISR,2021.0,14,13,1
UGA,CHN,2021.0,2,1,1
PRT,NOR,2021.0,8,7,1
BEL,ISR,2017.0,5,2,3
TUR,AZE,2001.0,2,2,0
TUR,FIN,2005.0,2,1,1
SGP,ESP,2011.0,3,6,-3
GRC,NLD,2001.0,8,6,2
BEL,FIN,2001.0,5,1,4
DEU,UKR,1999.0,7,20,-13
SVK,CAN,2013.0,2,3,-1
KEN,FRA,2013.0,3,1,2
ROU,DNK,2001.0,4,1,3
UKR,MEX,2002.0,3,1,2
UZB,RUS,2014.0,5,3,2
KWT,IND,2003.0,2,11,-9
DEU,ROU,2021.0,13,12,1
FRA,PER,2003.0,2,3,-1
TWN,BEL,2004.0,1,1,0
SAU,CAN,2000.0,4,3,1
CHN,TUR,2016.0,3,4,-1
LBY,GBR,2015.0,3,16,-13
AUS,HRV,2011.0,1,2,-1
CHL,BEL,2004.0,1,2,-1
CRI,PER,2015.0,2,1,1
SRB,BEL,2022.0,2,1,1
BRA,SRB,2009.0,2,1,1
ZAF,IND,2008.0,3,15,-12
RUS,ZAF,2012.0,1,2,-1
TZA,KEN,2019.0,4,8,-4
TZA,KEN,2017.0,6,9,-3
RUS,LTU,2017.0,4,1,3
BGR,ITA,2021.0,1,3,-2
GBR,LVA,2016.0,4,4,0
TUN,FRA,1998.0,4,9,-5
SRB,IRL,2021.0,3,1,2
MYS,NZL,2008.0,4,5,-1
SVN,FIN,2021.0,1,1,0
BEL,EGY,2021.0,2,2,0
NZL,THA,2022.0,3,2,1
SWE,TUR,2018.0,5,25,-20
KNA,USA,2014.0,1,2,-1
USA,PAN,2002.0,8,7,1
ISL,ITA,2013.0,1,2,-1
FRA,KWT,2018.0,1,1,0
IRL,CHE,2014.0,9,10,-1
ROU,ITA,2022.0,4,1,3
MEX,CRI,2018.0,8,4,4
NOR,BEL,2016.0,6,4,2
GHA,AUS,2022.0,8,4,4
YEM,MYS,2014.0,6,7,-1
DEU,IDN,2006.0,4,4,0
MDG,FRA,2004.0,2,5,-3
TUR,AUS,2004.0,2,1,1
CHL,CZE,2008.0,1,1,0
FIN,EST,2005.0,3,4,-1
TWN,GBR,2000.0,2,10,-8
IRN,AUT,2008.0,4,1,3
SVN,HRV,2003.0,2,2,0
MEX,NOR,2018.0,2,1,1
RUS,TWN,2007.0,3,1,2
PRT,KOR,2012.0,2,3,-1
ISR,BEL,2011.0,3,5,-2
PAN,ESP,2019.0,1,6,-5
NLD,PHL,2020.0,5,3,2
KAZ,USA,2011.0,4,7,-3
BOL,ECU,2013.0,1,1,0
ECU,BOL,2018.0,1,1,0
CHL,POL,2016.0,2,2,0
IND,IRQ,2020.0,9,2,7
VNM,ITA,2014.0,2,6,-4
GHA,NZL,2022.0,1,2,-1
MEX,URY,2018.0,3,2,1
CYP,ETH,2021.0,1,1,0
SVK,POL,2010.0,2,3,-1
GIN,FRA,2020.0,4,4,0
AUT,CHN,2009.0,6,7,-1
BEL,MAR,2013.0,4,2,2
DNK,THA,2018.0,3,1,2
MUS,GBR,2021.0,2,1,1
PSE,TUR,2022.0,1,2,-1
BGR,FRA,2012.0,2,7,-5
FRA,VEN,2018.0,3,5,-2
CAN,ZWE,2014.0,1,2,-1
CYP,ITA,2013.0,1,1,0
JOR,MYS,2013.0,6,15,-9
POL,SVK,2009.0,2,5,-3
SRB,MKD,2015.0,1,2,-1
EST,DEU,2013.0,2,6,-4
DNK,KOR,2007.0,2,2,0
CHN,NPL,2016.0,4,9,-5
USA,GUM,2011.0,6,1,5
TZA,DNK,2014.0,1,3,-2
KEN,ITA,2016.0,1,3,-2
BWA,NGA,2012.0,1,3,-2
GRC,TUR,2013.0,2,3,-1
CMR,DEU,2015.0,4,6,-2
ITA,NZL,2014.0,6,1,5
ROU,DEU,2022.0,3,8,-5
MNG,DEU,2018.0,1,1,0
ISR,MEX,2016.0,3,3,0
DNK,BRA,2008.0,1,3,-2
MYS,IRL,2008.0,1,1,0
SWE,NZL,2014.0,4,15,-11
ISL,SWE,2008.0,2,11,-9
ZMB,ZAF,2011.0,3,3,0
DNK,POL,2006.0,2,4,-2
ITA,JOR,2003.0,2,1,1
BEL,UZB,2004.0,1,1,0
BGR,POL,2021.0,2,1,1
HRV,NOR,2019.0,1,1,0
DEU,GEO,2007.0,3,6,-3
TWN,BGR,2015.0,1,1,0
SWE,EST,2022.0,2,3,-1
LUX,CAN,2018.0,3,3,0
PHL,CHN,2007.0,1,3,-2
JAM,CAN,2004.0,3,2,1
SRB,SWE,2004.0,5,1,4
NZL,IND,2004.0,1,8,-7
DNK,MYS,2002.0,2,1,1
IRN,EGY,2007.0,1,1,0
BEL,TUN,2004.0,3,4,-1
ROU,CAN,2009.0,1,7,-6
IND,KWT,2006.0,3,4,-1
MYS,NOR,2012.0,1,1,0
NOR,GRC,2022.0,3,1,2
KOR,DNK,2022.0,3,3,0
GTM,ESP,2019.0,1,3,-2
VNM,HUN,2015.0,2,1,1
TWN,MEX,2019.0,1,1,0
NLD,LBN,2021.0,3,1,2
TWN,AUS,2002.0,3,12,-9
IDN,AUS,2000.0,1,2,-1
KEN,UGA,2005.0,2,1,1
RUS,BRA,2001.0,4,9,-5
CUB,ITA,1999.0,1,1,0
HKG,RUS,2003.0,2,4,-2
PER,IDN,2012.0,1,1,0
DNK,LUX,2021.0,2,1,1
CHN,IRN,2013.0,4,9,-5
TWN,IRL,2012.0,1,2,-1
GBR,BLR,2000.0,1,2,-1
FRA,LAO,2021.0,1,2,-1
ZAF,BEL,2009.0,3,4,-1
EGY,DNK,2011.0,1,2,-1
NLD,URY,2003.0,1,1,0
BEL,NOR,2005.0,1,1,0
EST,SWE,2009.0,2,9,-7
BFA,CAN,2018.0,3,3,0
EGY,RUS,2001.0,1,1,0
NLD,BGD,2009.0,2,2,0
CHN,PHL,2013.0,1,2,-1
KGZ,UZB,2007.0,1,2,-1
HUN,GRC,2013.0,1,3,-2
HKG,PHL,2009.0,1,2,-1
SGP,BRN,2019.0,3,2,1
PAN,CRI,2014.0,1,1,0
HRV,SGP,2020.0,1,1,0
ARE,KOR,2022.0,2,7,-5
ITA,CYP,2015.0,3,3,0
CHE,MEX,2015.0,5,6,-1
PHL,DEU,2001.0,2,1,1
ESP,HRV,2001.0,1,2,-1
SAU,HKG,2016.0,1,5,-4
IRQ,ROU,2017.0,2,1,1
MAR,IND,2021.0,2,3,-1
BRN,BWA,2010.0,1,1,0
KOR,MNG,2010.0,1,1,0
VNM,POL,2022.0,2,1,1
ZAF,PAK,2018.0,2,3,-1
IRL,RUS,2022.0,1,16,-15
MYS,AUT,2014.0,1,2,-1
DZA,USA,2004.0,1,2,-1
PAK,ESP,2013.0,2,1,1
MYS,EGY,2007.0,2,1,1
NGA,KEN,2007.0,1,2,-1
BGR,RUS,2003.0,5,8,-3
IRL,ESP,2001.0,1,3,-2
COG,USA,2021.0,2,1,1
ERI,IND,2007.0,2,3,-1
LBN,CAN,2012.0,4,14,-10
SRB,AUS,2017.0,1,1,0
SVN,IND,2013.0,2,1,1
USA,LUX,2013.0,6,4,2
TUR,DNK,2006.0,1,1,0
PRT,CHL,2021.0,3,3,0
ECU,RUS,2021.0,1,1,0
AUS,UGA,2020.0,1,5,-4
ESP,HKG,2020.0,1,3,-2
MNG,GBR,2014.0,1,1,0
MYS,GHA,2013.0,3,3,0
GHA,COG,2019.0,1,1,0
DOM,COL,2020.0,1,1,0
ROU,IRN,2014.0,1,2,-1
SAU,HUN,2017.0,3,1,2
RUS,IRL,2007.0,3,1,2
ITA,GEO,2002.0,1,3,-2
KOR,SGP,2004.0,2,4,-2
CHE,LUX,2015.0,3,6,-3
BRB,CAN,2004.0,1,1,0
TWN,AUS,2005.0,1,12,-11
JPN,UZB,2009.0,1,2,-1
BOL,DEU,2022.0,1,1,0
GAB,CMR,2009.0,1,1,0
COL,FIN,2018.0,2,4,-2
KOR,ESP,2008.0,1,2,-1
CHN,NGA,2013.0,3,2,1
NLD,BLR,2007.0,1,1,0
ESP,UKR,1997.0,2,4,-2
SGP,KWT,1999.0,1,1,0
TWN,POL,2008.0,3,1,2
IRL,ISR,2021.0,1,3,-2
ITA,TUN,2002.0,2,1,1
AUS,PER,2016.0,1,1,0
SWE,MLT,2021.0,2,1,1
DNK,NZL,2021.0,1,3,-2
SRB,AUT,2010.0,2,2,0
MAR,DEU,2015.0,1,7,-6
KWT,HUN,2001.0,1,3,-2
COG,ITA,2010.0,1,1,0
JOR,EGY,2013.0,1,2,-1
ETH,CHE,2020.0,4,4,0
QAT,SWE,2013.0,1,1,0
NGA,SWE,2016.0,1,3,-2
IRN,PAK,2006.0,1,1,0
LTU,BLR,2005.0,1,1,0
SGP,IRL,2013.0,1,5,-4
ESP,BGD,2016.0,3,2,1
RUS,GRC,2008.0,1,3,-2
CHN,ROU,2019.0,1,1,0
GMB,UGA,2017.0,1,1,0
CAN,JAM,2016.0,1,4,-3
FIN,MWI,2016.0,1,2,-1
SEN,CAN,2019.0,1,1,0
HKG,NLD,2022.0,1,4,-3
NOR,FRO,2017.0,1,1,0
NLD,NPL,2009.0,1,1,0
GBR,AGO,2018.0,1,1,0
BHR,USA,2004.0,1,1,0
CAN,VEN,2005.0,1,2,-1
THA,BGD,2013.0,2,2,0
COL,CRI,2015.0,2,5,-3
PSE,DEU,2002.0,1,1,0
CHE,BGR,2003.0,2,1,1
POL,CHL,2015.0,2,2,0
PER,KEN,2020.0,1,4,-3
LBY,FIN,2011.0,1,1,0
THA,MYS,2007.0,1,1,0
UKR,MEX,2005.0,1,3,-2
PAK,AUS,2007.0,3,2,1
DNK,COL,2015.0,1,2,-1
DZA,CHN,2021.0,1,4,-3
ZAF,SEN,2019.0,1,1,0
ETH,AUT,2009.0,1,3,-2
QAT,DNK,2016.0,1,1,0
QAT,MYS,2016.0,1,9,-8
NGA,MWI,2012.0,1,1,0
JPN,FJI,2002.0,1,2,-1
ETH,SWE,2018.0,1,4,-3
AUS,TUR,2009.0,1,4,-3
COD,NLD,2018.0,1,1,0
TUR,BRA,2018.0,1,3,-2
PRT,AGO,2012.0,1,1,0
CAN,PER,2013.0,1,2,-1
JOR,NOR,2018.0,1,1,0
ROU,SGP,2019.0,1,1,0
KAZ,ITA,2015.0,1,2,-1
BGD,EGY,2002.0,1,1,0
DZA,ITA,2016.0,1,3,-2
CZE,MDA,2020.0,1,1,0
ARE,ISR,2018.0,1,1,0
IDN,HKG,2020.0,1,1,0
OMN,DNK,2018.0,1,1,0
GTM,ESP,2017.0,1,1,0
KHM,THA,2019.0,2,4,-2
SWE,MAC,2016.0,1,1,0
IDN,KEN,2019.0,1,2,-1
DEU,SDN,2002.0,1,2,-1
PHL,GBR,2003.0,2,2,0
KEN,NZL,2009.0,1,1,0
MNG,JPN,2011.0,2,4,-2
BEL,ARG,2006.0,1,1,0
PRT,MYS,2017.0,1,3,-2
NGA,RWA,2022.0,1,1,0
LAO,JPN,2009.0,1,3,-2
IRL,LBY,2014.0,1,2,-1
BEL,NOR,2002.0,1,1,0
BEL,KOR,2002.0,1,1,0
USA,ALB,2020.0,1,1,0
IND,TTO,2021.0,1,2,-1
SGP,ISL,2019.0,1,2,-1
PSE,CHE,2020.0,1,2,-1
IND,BRA,2003.0,2,5,-3
LBY,TUR,2018.0,1,1,0
SRB,CZE,2017.0,3,2,1
NPL,SWE,2020.0,1,1,0
EGY,JOR,2021.0,1,3,-2
CHL,KOR,2013.0,1,5,-4
SYR,JOR,2019.0,1,1,0
NZL,PHL,2012.0,1,1,0
ITA,VEN,2017.0,1,1,0
GRC,TUN,2014.0,1,1,0
NLD,EST,2022.0,1,1,0
DEU,ESP,2020.0,211,248,-37
DEU,USA,2020.0,1001,1037,-36
SWE,FIN,2020.0,57,71,-14
ISR,CAN,2008.0,49,20,29
USA,JOR,2011.0,46,23,23
GBR,NZL,2010.0,127,100,27
GBR,NLD,2011.0,209,200,9
CHL,CAN,2016.0,18,18,0
JPN,THA,2008.0,63,23,40
USA,AUT,2013.0,110,121,-11
ZAF,NZL,2012.0,6,5,1
CHN,JPN,2008.0,240,345,-105
KOR,NZL,2015.0,3,3,0
FRA,CHN,2020.0,201,163,38
CHN,BEL,2014.0,33,45,-12
JPN,BGD,2017.0,57,56,1
HKG,SGP,2010.0,22,13,9
GBR,NZL,2017.0,104,101,3
USA,IRL,2020.0,103,149,-46
ARE,DEU,2018.0,8,13,-5
HKG,GBR,2006.0,42,26,16
VEN,USA,2016.0,27,7,20
FRA,SAU,2015.0,32,9,23
HKG,SGP,2017.0,37,29,8
ISR,KOR,2018.0,7,4,3
USA,THA,1999.0,25,9,16
CHN,JOR,2015.0,2,1,1
ESP,COL,2020.0,85,90,-5
COL,ESP,2019.0,77,88,-11
RUS,CHN,2022.0,13,14,-1
NGA,PAK,2019.0,4,1,3
USA,BGD,2013.0,33,35,-2
NLD,CHE,2007.0,39,31,8
CAN,JOR,2020.0,15,15,0
BGD,JPN,2022.0,15,24,-9
TUR,JPN,2020.0,6,6,0
NOR,USA,2022.0,33,46,-13
NOR,DNK,2014.0,27,37,-10
ARG,BRA,2007.0,18,30,-12
BEL,NLD,2009.0,95,126,-31
IRL,ZAF,2013.0,9,2,7
IDN,NLD,2016.0,9,27,-18
CZE,SVK,2002.0,14,27,-13
MEX,ITA,1999.0,5,2,3
DNK,AUS,2019.0,42,48,-6
CHL,ESP,2014.0,46,120,-74
ITA,ALB,2018.0,10,6,4
USA,MWI,2022.0,11,9,2
DNK,AUS,2010.0,16,19,-3
CAN,BGR,2001.0,5,3,2
DEU,NOR,2011.0,53,29,24
NZL,GBR,2005.0,80,121,-41
CHE,FIN,2002.0,3,10,-7
USA,NOR,2002.0,68,68,0
FRA,ISR,2005.0,14,22,-8
FIN,RUS,2008.0,15,12,3
FRA,NZL,2007.0,10,7,3
NLD,THA,2008.0,7,4,3
USA,ARM,1999.0,1,1,0
ITA,RUS,2000.0,22,15,7
RUS,ITA,2003.0,25,28,-3
LBN,EGY,2015.0,4,6,-2
PRT,RUS,2019.0,4,2,2
GBR,RUS,1997.0,13,17,-4
FRA,ISR,2002.0,35,21,14
GBR,LKA,2006.0,7,4,3
RUS,NZL,2016.0,1,2,-1
CHL,BRA,2004.0,3,9,-6
THA,GBR,2014.0,30,74,-44
CHN,HRV,2010.0,2,1,1
TWN,CHN,2001.0,19,29,-10
VNM,DNK,2005.0,1,1,0
ISR,NLD,2007.0,7,3,4
NZL,DNK,2011.0,4,5,-1
KEN,CAN,2013.0,5,4,1
ISR,CHE,2002.0,5,10,-5
POL,AUS,2018.0,11,6,5
SAU,DZA,2020.0,5,6,-1
BGD,SAU,2019.0,5,7,-2
BHR,MYS,2018.0,1,4,-3
SRB,AUT,2019.0,4,2,2
FIN,GRC,2013.0,2,5,-3
SWE,GBR,2000.0,29,27,2
FRA,UKR,2017.0,18,16,2
BRB,USA,2013.0,4,2,2
USA,ROU,2021.0,11,8,3
CHL,URY,2007.0,1,1,0
FIN,CZE,2001.0,1,1,0
USA,BWA,2013.0,6,6,0
AUT,ZAF,2008.0,3,3,0
ROU,BEL,2005.0,8,3,5
HUN,JPN,2011.0,3,4,-1
SWE,SDN,2019.0,1,1,0
CAN,VEN,2002.0,4,2,2
NPL,USA,2015.0,13,17,-4
ISR,CHN,2001.0,5,3,2
DNK,GRC,2021.0,6,5,1
THA,NPL,2016.0,5,3,2
POL,CZE,2011.0,5,15,-10
VNM,GBR,2016.0,24,12,12
HKG,IND,2012.0,4,7,-3
PAK,SWE,2014.0,6,18,-12
TUR,ARE,2013.0,4,4,0
KOR,BEL,2009.0,1,3,-2
PRT,RUS,2017.0,6,5,1
COL,CHE,2020.0,7,4,3
BLR,POL,2006.0,3,1,2
KOR,NPL,2018.0,10,8,2
SAU,MAR,2020.0,6,3,3
IND,AUT,2020.0,11,8,3
YEM,EGY,2018.0,1,2,-1
SRB,AUT,2017.0,1,3,-2
TTO,IND,2012.0,1,1,0
THA,FRA,2004.0,3,4,-1
CHL,RUS,2012.0,3,2,1
PRT,ITA,2003.0,3,17,-14
JPN,ROU,2020.0,3,2,1
EGY,KWT,1999.0,4,3,1
ESP,CRI,2011.0,5,2,3
NZL,ITA,2018.0,4,6,-2
SWE,BGD,2021.0,1,3,-2
DEU,SYR,2004.0,2,1,1
NLD,OMN,2019.0,2,1,1
ITA,VEN,2010.0,2,4,-2
AUT,SVK,2013.0,9,9,0
NLD,EGY,2012.0,3,2,1
MEX,AUS,2008.0,6,3,3
PSE,GBR,2001.0,1,1,0
SVN,CZE,2003.0,1,3,-2
MLI,GIN,2012.0,2,2,0
AUT,EST,2016.0,2,1,1
SAU,ITA,2018.0,8,12,-4
PSE,MYS,2014.0,3,5,-2
FRA,IRQ,2015.0,1,2,-1
NGA,BEN,2021.0,2,2,0
OMN,EGY,2009.0,4,1,3
PRT,MEX,2005.0,1,1,0
USA,SEN,2008.0,1,4,-3
CZE,IRL,2015.0,1,3,-2
SWE,PHL,2020.0,2,1,1
NZL,CHL,2007.0,2,3,-1
SAU,ESP,2019.0,3,15,-12
LBN,DEU,2012.0,2,1,1
TUN,JPN,2015.0,1,6,-5
OMN,NLD,2002.0,1,3,-2
TUN,OMN,2011.0,1,2,-1
NLD,ZWE,2007.0,1,1,0
JPN,FRA,1998.0,7,27,-20
POL,AUT,2003.0,2,7,-5
YEM,SAU,2007.0,1,2,-1
SVK,UKR,2008.0,1,2,-1
DZA,BEL,2015.0,1,4,-3
CRI,GBR,2021.0,2,1,1
SEN,CAN,2017.0,2,2,0
PAN,MEX,2015.0,1,2,-1
NIC,USA,2011.0,1,1,0
UGA,NGA,2022.0,2,1,1
PHL,MYS,2014.0,1,1,0
SVN,NLD,2005.0,1,4,-3
TUR,FIN,2002.0,3,1,2
RWA,ZAF,2011.0,1,2,-1
SGP,MEX,2010.0,1,2,-1
VEN,ITA,2001.0,1,1,0
BLR,CAN,2003.0,1,2,-1
TUN,CAN,2007.0,1,1,0
AUT,BGR,2008.0,1,2,-1
HUN,IND,2018.0,2,5,-3
IRL,NOR,2008.0,3,1,2
QAT,JOR,2015.0,1,5,-4
MWI,NGA,2012.0,1,1,0
SGP,AUT,2005.0,1,1,0
ARE,OMN,2016.0,1,3,-2
PER,FIN,2009.0,1,1,0
PYF,FRA,2003.0,3,9,-6
GBR,BRB,2003.0,1,1,0
TUN,FRA,1997.0,1,2,-1
JPN,NPL,2001.0,2,2,0
HUN,EGY,2002.0,1,1,0
USA,TUN,2001.0,2,1,1
USA,FJI,2014.0,1,1,0
CAN,,2019.0,12417,0,12417
,BIH,2004.0,149,0,149
,JPN,2003.0,25614,0,25614
CAN,,2017.0,10230,0,10230
,GBR,2014.0,22031,0,22031
,CHN,2017.0,218579,0,218579
,EGY,2004.0,1584,0,1584
CZE,,2022.0,4776,0,4776
KOR,,2010.0,6022,0,6022
,THA,2007.0,2132,0,2132
NZL,,2024.0,10039,0,10039
DEU,,2021.0,30391,0,30391
,TWN,2003.0,5828,0,5828
KOR,,2019.0,13871,0,13871
JPN,,2011.0,19765,0,19765
CAN,,2010.0,5744,0,5744
TUR,,2010.0,1664,0,1664
TUR,,2017.0,4822,0,4822
UGA,,2024.0,1854,0,1854
,TUR,1998.0,4987,0,4987
TUR,,2019.0,6781,0,6781
,AUS,1999.0,11270,0,11270
TWN,,2022.0,10304,0,10304
,DNK,1995.0,1421,0,1421
USA,,2003.0,17966,0,17966
CHN,,2002.0,3034,0,3034
KOR,,2017.0,11753,0,11753
,RUS,2006.0,7057,0,7057
,CHN,2010.0,114827,0,114827
BLR,,2024.0,1310,0,1310
,SAU,1994.0,444,0,444
GBR,GHA,1998.0,2,0,2
ITA,,2006.0,3994,0,3994
,TUR,1997.0,2409,0,2409
UKR,AUS,2021.0,2,0,2
BEL,,2008.0,1315,0,1315
,VEN,1998.0,731,0,731
,BRA,2012.0,20275,0,20275
DNK,,2020.0,2934,0,2934
CUB,,2022.0,1021,0,1021
,CHE,2009.0,4028,0,4028
,EST,1999.0,314,0,314
CHN,,2005.0,7371,0,7371
IND,,2002.0,715,0,715
,SVN,1999.0,706,0,706
HUN,,2013.0,783,0,783
,SDN,1998.0,62,0,62
CMR,,2008.0,34,0,34
IND,,2005.0,2701,0,2701
SWE,,2005.0,1217,0,1217
,LTU,2009.0,659,0,659
LBN,,2009.0,75,0,75
CHL,,2009.0,507,0,507
,SGP,1999.0,1429,0,1429
VEN,,2015.0,482,0,482
,AZE,2007.0,245,0,245
,COL,2000.0,481,0,481
,SVK,2006.0,802,0,802
,BLR,1994.0,642,0,642
,EGY,1996.0,467,0,467
,MAR,1999.0,869,0,869
SWE,,2002.0,312,0,312
,MEX,2011.0,5275,0,5275
,BWA,2001.0,57,0,57
TUR,SWE,2008.0,10,0,10
GRC,IRL,2016.0,9,0,9
CIV,,2011.0,61,0,61
LVA,,2022.0,477,0,477
,HUN,2012.0,1674,0,1674
CHE,,2004.0,1051,0,1051
MWI,,2014.0,24,0,24
SAU,,2013.0,352,0,352
DZA,JAM,2016.0,1,0,1
,CRI,2008.0,97,0,97
,CHN,2019.0,174836,0,174836
MAR,,2016.0,570,0,570
,PRT,2018.0,2995,0,2995
,UGA,2009.0,265,0,265
USA,GNQ,2017.0,3,0,3
,MYS,2016.0,5199,0,5199
,PYF,2011.0,6,0,6
,GMB,1998.0,14,0,14
,LBN,2015.0,497,0,497
MLI,,2019.0,82,0,82
,URY,2003.0,161,0,161
,COG,2012.0,136,0,136
BIH,,2017.0,103,0,103
,SWZ,2012.0,5,0,5
,BRB,2013.0,9,0,9
KNA,,2018.0,4,0,4
,MAC,1995.0,2,0,2
GHA,SEN,2019.0,1,0,1
,MDA,2014.0,64,0,64
,TZA,2015.0,274,0,274
PSE,HUN,2019.0,1,0,1
GHA,PAK,2020.0,1,0,1
PER,,2013.0,129,0,129
,ARM,2015.0,99,0,99
BRA,MAR,2022.0,2,0,2
,GRD,2015.0,32,0,32
NLD,,2025.0,34,0,34
ECU,NZL,2018.0,1,0,1
JAM,NLD,2020.0,1,0,1
USA,GMB,2001.0,3,0,3
,AGO,2018.0,14,0,14
,CIV,2016.0,135,0,135
ISR,COL,2020.0,2,0,2
ROU,,1999.0,40,0,40
FRA,ZWE,2015.0,2,0,2
,HTI,2017.0,27,0,27
LUX,,2018.0,126,0,126
,ECU,2008.0,114,0,114
,CYP,2013.0,144,0,144
CHE,KHM,2008.0,1,0,1
,MWI,2008.0,79,0,79
,KWT,1997.0,54,0,54
HKG,PRT,2018.0,1,0,1
ETH,LBN,2014.0,1,0,1
NPL,BRN,2012.0,1,0,1
,DOM,2006.0,15,0,15
DZA,,2025.0,41,0,41
PHL,,2014.0,118,0,118
PER,BGD,2020.0,1,0,1
BIH,,2019.0,174,0,174
SWE,TZA,2016.0,6,0,6
,KWT,1998.0,270,0,270
KOR,CZE,2013.0,3,0,3
,GTM,2011.0,22,0,22
,VEN,1997.0,311,0,311
AUT,OMN,2011.0,1,0,1
GBR,GAB,2003.0,1,0,1
FRA,SDN,2005.0,1,0,1
GMB,UGA,2019.0,1,0,1
AZE,,2008.0,41,0,41
MYS,UGA,2021.0,1,0,1
NER,,2013.0,10,0,10
BGD,JOR,2017.0,1,0,1
CHL,HKG,2018.0,2,0,2
IRN,NGA,2021.0,3,0,3
GHA,BFA,2018.0,4,0,4
ISR,TWN,2016.0,2,0,2
DEU,KWT,2008.0,1,0,1
TUR,SVN,2021.0,1,0,1
LKA,TWN,2019.0,1,0,1
BIH,,2010.0,53,0,53
,BIH,1996.0,8,0,8
PAN,GTM,2021.0,1,0,1
MYS,ALB,2008.0,1,0,1
HRV,,2008.0,250,0,250
RUS,VEN,2018.0,1,0,1
ALB,,2012.0,14,0,14
,LBY,2007.0,68,0,68
NZL,ARE,2013.0,4,0,4
CUB,PRT,2014.0,1,0,1
EGY,,1999.0,16,0,16
SWE,UGA,2011.0,4,0,4
COL,PRI,2008.0,2,0,2
,MNG,2007.0,47,0,47
MLI,,2010.0,13,0,13
ZAF,ECU,2001.0,1,0,1
MLI,,2017.0,25,0,25
NAM,USA,2015.0,4,0,4
,MOZ,1998.0,16,0,16
POL,IND,2000.0,2,0,2
KGZ,MYS,2011.0,1,0,1
MYS,KGZ,2012.0,1,0,1
NCL,USA,2014.0,1,0,1
ROU,CZE,2004.0,2,0,2
ARM,,2007.0,46,0,46
PHL,BEL,2002.0,1,0,1
BEL,GMB,2019.0,1,0,1
JPN,BFA,2016.0,2,0,2
PSE,,2006.0,13,0,13
PHL,MEX,2008.0,1,0,1
TUR,KWT,2016.0,7,0,7
ARE,,2003.0,15,0,15
KWT,TUR,2013.0,1,0,1
,BHS,1997.0,1,0,1
FRA,ISL,1999.0,2,0,2
BEL,GMB,2017.0,1,0,1
JPN,ARE,2012.0,2,0,2
BEL,CUB,2005.0,1,0,1
JPN,CIV,2013.0,1,0,1
,MTQ,2001.0,2,0,2
VEN,PER,2022.0,2,0,2
ARG,AUT,2012.0,2,0,2
BLR,PRT,2010.0,2,0,2
SRB,CHN,2005.0,1,0,1
PAK,ZAF,2004.0,2,0,2
SYR,,2000.0,4,0,4
,BTN,1998.0,2,0,2
ASM,,2023.0,2,0,2
AGO,,2016.0,7,0,7
DEU,URY,2000.0,2,0,2
,KHM,1994.0,2,0,2
GBR,NAM,2013.0,5,0,5
NGA,ETH,2009.0,2,0,2
BWA,TZA,2016.0,1,0,1
MAC,IRL,2020.0,2,0,2
JAM,BHS,2008.0,1,0,1
KHM,,2012.0,17,0,17
SVK,FRA,2012.0,5,0,5
LTU,AUS,2014.0,1,0,1
SWE,SDN,2017.0,2,0,2
BEL,KOR,2005.0,3,0,3
THA,AFG,2014.0,1,0,1
SEN,NGA,2021.0,1,0,1
LIE,,2022.0,7,0,7
BLR,PRT,2019.0,1,0,1
THA,MAC,2008.0,2,0,2
GBR,ZWE,2000.0,1,0,1
GRC,,2000.0,18,0,18
POL,BOL,2019.0,1,0,1
,SDN,1997.0,3,0,3
TUN,,2004.0,73,0,73
MYS,BRN,2010.0,3,0,3
DZA,CZE,2018.0,1,0,1
TWN,ARE,2019.0,1,0,1
GMB,ITA,2004.0,1,0,1
ZAF,BGR,2019.0,1,0,1
JPN,TZA,2006.0,3,0,3
THA,ARE,2016.0,1,0,1
NZL,TZA,2022.0,1,0,1
ALB,JPN,2017.0,1,0,1
ITA,HRV,2022.0,2,0,2
,HTI,2019.0,10,0,10
PHL,ARE,2016.0,2,0,2
IRN,GHA,2022.0,2,0,2
BEL,JOR,2012.0,1,0,1
ZAF,UGA,2004.0,1,0,1
TUR,ESP,2005.0,5,0,5
CMR,ZAF,2006.0,2,0,2
PRT,SGP,2005.0,1,0,1
PHL,ESP,2007.0,1,0,1
CAN,BFA,1998.0,2,0,2
LKA,LAO,2016.0,1,0,1
ERI,SWE,1999.0,1,0,1
MYS,,2001.0,11,0,11
IRL,SWE,1998.0,2,0,2
NZL,AUT,2006.0,1,0,1
KOR,FIN,2004.0,1,0,1
AUS,KAZ,2018.0,2,0,2
ZWE,FRA,2005.0,1,0,1
ITA,GEO,2005.0,1,0,1
CHL,SRB,2008.0,1,0,1
PAN,ESP,2010.0,3,0,3
TCD,,2008.0,2,0,2
BOL,NLD,2012.0,2,0,2
BEL,BGD,2003.0,4,0,4
TUR,BGR,2012.0,3,0,3
,MRT,2001.0,1,0,1
ISR,PSE,2001.0,2,0,2
HUN,IRL,2005.0,1,0,1
USA,MNE,2011.0,1,0,1
LAO,AUS,2007.0,2,0,2
MDG,GBR,2006.0,3,0,3
NOR,TUR,2007.0,2,0,2
SVN,ARE,2022.0,1,0,1
CAN,CIV,2009.0,1,0,1
AFG,,2014.0,8,0,8
AUT,ROU,2016.0,3,0,3
MKD,POL,2021.0,1,0,1
BGR,NLD,2013.0,2,0,2
MOZ,PER,2019.0,2,0,2
MYS,SRB,2013.0,1,0,1
CAN,FRO,2014.0,1,0,1
SVN,CAN,2013.0,2,0,2
,FSM,2011.0,4,0,4
ZAF,QAT,2018.0,4,0,4
SVN,NLD,2002.0,2,0,2
UKR,TUN,2015.0,1,0,1
MOZ,PER,2017.0,1,0,1
JOR,PAK,2015.0,1,0,1
CZE,LUX,2015.0,1,0,1
LTU,CZE,2021.0,2,0,2
DZA,KOR,2018.0,1,0,1
SYR,JPN,2021.0,2,0,2
HKG,SAU,2015.0,2,0,2
CHE,ALB,2012.0,1,0,1
NIC,ESP,2011.0,1,0,1
BRA,LUX,2003.0,1,0,1
RUS,LVA,2012.0,2,0,2
GMB,ZAF,2015.0,1,0,1
ISL,AUT,2002.0,1,0,1
,SYC,2000.0,4,0,4
NOR,FRO,2010.0,2,0,2
NGA,CIV,2014.0,1,0,1
BEL,SYR,2015.0,1,0,1
IRL,SAU,2013.0,3,0,3
IRN,OMN,2014.0,3,0,3
HRV,DNK,2017.0,3,0,3
BEN,GAB,2015.0,1,0,1
CHE,PNG,2018.0,2,0,2
,HTI,2010.0,13,0,13
SGP,DNK,2006.0,1,0,1
SVK,PRT,2017.0,1,0,1
JOR,KWT,2002.0,2,0,2
CIV,GIN,2017.0,1,0,1
ESP,OMN,2020.0,1,0,1
SEN,GMB,2020.0,3,0,3
GBR,COG,2022.0,1,0,1
TTO,ATG,2012.0,1,0,1
PRT,UKR,2015.0,1,0,1
FRA,LVA,2015.0,2,0,2
TJK,USA,2004.0,1,0,1
TTO,OMN,2002.0,1,0,1
TWN,BLR,2020.0,1,0,1
CHE,MLI,2004.0,1,0,1
ZMB,CHL,2011.0,2,0,2
CAN,CRI,2004.0,1,0,1
LUX,AUT,2003.0,1,0,1
JPN,JOR,2005.0,1,0,1
ROU,MYS,2012.0,1,0,1
BRA,ISR,1999.0,1,0,1
FIN,ISL,2011.0,1,0,1
GRC,PRT,1998.0,2,0,2
AUS,KEN,1998.0,2,0,2
HUN,KOR,2004.0,1,0,1
SWE,CHL,2005.0,2,0,2
USA,IRQ,2005.0,4,0,4
MYS,HKG,1998.0,1,0,1
SGP,ISR,2005.0,1,0,1
EGY,KOR,2004.0,1,0,1
HKG,CZE,2013.0,2,0,2
ROU,NZL,2007.0,1,0,1
VNM,UKR,2007.0,1,0,1
MEX,UGA,2012.0,1,0,1
IRN,MAR,2019.0,1,0,1
PNG,CHE,1998.0,2,0,2
SVN,NZL,2019.0,2,0,2
BLR,KAZ,2020.0,1,0,1
TUN,GRC,2020.0,2,0,2
GRC,MKD,2013.0,1,0,1
COL,CZE,2018.0,1,0,1
NCL,VUT,2021.0,1,0,1
MWI,CHE,2009.0,2,0,2
ARM,TWN,2008.0,1,0,1
BEN,NER,1997.0,1,0,1
COL,NOR,2012.0,1,0,1
USA,AFG,2009.0,9,0,9
ITA,TUN,2005.0,1,0,1
,BLZ,2003.0,2,0,2
LBN,JOR,2012.0,1,0,1
EST,BEL,2017.0,2,0,2
LVA,SAU,2014.0,1,0,1
NLD,OMN,2017.0,2,0,2
PAK,HUN,2001.0,1,0,1
IRL,SVK,2000.0,1,0,1
BGD,ETH,2005.0,2,0,2
TUR,NOR,1998.0,1,0,1
BGR,SAU,2004.0,1,0,1
PHL,DNK,2005.0,1,0,1
KEN,MNG,2005.0,1,0,1
MCO,BEL,2019.0,1,0,1
COL,MYS,2008.0,1,0,1
SLE,BFA,2015.0,1,0,1
ESP,GNQ,2007.0,1,0,1
,GMB,1997.0,3,0,3
DJI,BEL,2016.0,1,0,1
AUT,MOZ,2013.0,1,0,1
PHL,NLD,2021.0,6,0,6
,REU,2009.0,4,0,4
ITA,PSE,2014.0,2,0,2
SGP,ISL,2017.0,1,0,1
MDG,MLT,2016.0,1,0,1
DEU,UGA,2021.0,4,0,4
CIV,COG,2016.0,2,0,2
,TCD,2013.0,8,0,8
MLI,USA,2009.0,7,0,7
USA,BRN,2011.0,2,0,2
COL,BOL,2009.0,1,0,1
GRC,RUS,2003.0,2,0,2
NPL,CAN,2008.0,1,0,1
GRC,ROU,2015.0,2,0,2
ZMB,AUS,2019.0,1,0,1
IND,KGZ,2018.0,1,0,1
COL,ISL,2019.0,1,0,1
ARG,ISR,2009.0,1,0,1
GLP,GUF,2009.0,1,0,1
AUT,LVA,2002.0,3,0,3
CHN,UKR,2011.0,1,0,1
IRL,BWA,2013.0,1,0,1
LBN,SAU,2007.0,3,0,3
DEU,SAU,2006.0,3,0,3
BGR,AUT,2016.0,3,0,3
ZWE,ETH,2008.0,1,0,1
CRI,BRA,2006.0,1,0,1
LBY,CHN,2014.0,1,0,1
ISR,EST,2018.0,2,0,2
GTM,ESP,2010.0,1,0,1
MYS,ISR,2009.0,1,0,1
MAR,NGA,2019.0,1,0,1
EST,BEL,2019.0,1,0,1
LBN,TUN,2016.0,1,0,1
EGY,LUX,2020.0,2,0,2
QAT,PAK,2012.0,2,0,2
NGA,SLE,2015.0,1,0,1
TZA,THA,2020.0,1,0,1
PAK,TUR,2012.0,2,0,2
UGA,SWZ,2020.0,1,0,1
MDV,,2020.0,3,0,3
SRB,MLT,2002.0,1,0,1
MEX,DOM,2018.0,4,0,4
IND,ARG,2020.0,3,0,3
ERI,,2015.0,2,0,2
GEO,DEU,2000.0,2,0,2
TWN,ARE,2017.0,1,0,1
LVA,KAZ,2015.0,1,0,1
FRO,,2016.0,2,0,2
ZAF,SVK,2019.0,1,0,1
SEN,TGO,2009.0,1,0,1
CZE,KWT,2004.0,1,0,1
GRL,USA,2009.0,1,0,1
IRQ,CZE,2016.0,1,0,1
PSE,SWE,2010.0,1,0,1
RUS,LBY,2005.0,1,0,1
MEX,TUR,2006.0,1,0,1
SEN,MRT,1999.0,1,0,1
,PLW,2004.0,1,0,1
PLW,USA,1999.0,2,0,2
,ASM,2004.0,2,0,2
CYP,ESP,2014.0,2,0,2
AUS,MOZ,2001.0,1,0,1
MWI,ITA,2012.0,1,0,1
CIV,CMR,2013.0,1,0,1
SDN,CHN,2007.0,1,0,1
SAU,AZE,2006.0,1,0,1
ERI,SAU,1999.0,1,0,1
NLD,CRI,2011.0,1,0,1
JPN,FJI,2005.0,1,0,1
ETH,CIV,2021.0,1,0,1
DZA,NER,2021.0,1,0,1
HUN,TUR,2021.0,1,0,1
ISR,KAZ,2011.0,1,0,1
PAN,DEU,2006.0,1,0,1
CAN,ALB,2021.0,1,0,1
,FRO,1999.0,2,0,2
LBN,BRA,2019.0,1,0,1
SRB,ZAF,1999.0,1,0,1
EGY,IRN,2009.0,3,0,3
BEN,CAN,2014.0,1,0,1
IDN,MDG,2019.0,1,0,1
ISR,LVA,2022.0,2,0,2
USA,GUY,2007.0,1,0,1
RUS,BHR,2017.0,1,0,1
CHE,YEM,2021.0,1,0,1
TUN,NER,2018.0,1,0,1
HKG,GRC,2003.0,2,0,2
CZE,EGY,2009.0,1,0,1
BWA,BRN,2012.0,1,0,1
KEN,THA,2001.0,1,0,1
IRL,LTU,2014.0,1,0,1
CIV,GHA,2005.0,1,0,1
TWN,AZE,2014.0,1,0,1
IRQ,GRC,2021.0,2,0,2
FRA,JAM,2000.0,1,0,1
NOR,GHA,2022.0,2,0,2
NPL,DNK,2012.0,1,0,1
SEN,SGP,2012.0,1,0,1
BWA,ARE,2020.0,1,0,1
ABW,USA,2018.0,1,0,1
PRI,ITA,2015.0,1,0,1
ITA,ETH,1999.0,1,0,1
EGY,SYR,2020.0,1,0,1
PNG,FJI,2021.0,1,0,1
ECU,PRI,2020.0,1,0,1
RUS,HUN,1999.0,1,0,1
MEX,PAN,2009.0,1,0,1
CAN,ARM,2009.0,1,0,1
IND,MUS,2022.0,2,0,2
VEN,BEL,2002.0,1,0,1
BRA,MAC,2015.0,1,0,1
PAK,POL,2022.0,4,0,4
ARE,BHR,2021.0,4,0,4
CHN,OMN,2021.0,3,0,3
UKR,COL,2016.0,1,0,1
DEU,NPL,2001.0,1,0,1
NLD,MAC,2012.0,1,0,1
UGA,COG,2011.0,1,0,1
TZA,RWA,2020.0,4,0,4
PAK,NPL,2013.0,3,0,3
THA,TZA,2017.0,1,0,1
IRL,VNM,2015.0,1,0,1
JOR,YEM,2011.0,1,0,1
PHL,DNK,2002.0,1,0,1
USA,COD,2017.0,1,0,1
NGA,ISR,2015.0,2,0,2
PAK,SVN,2019.0,1,0,1
LTU,UKR,2021.0,2,0,2
CHN,GIN,2019.0,1,0,1
JPN,COG,2017.0,1,0,1
JPN,JOR,2002.0,1,0,1
SRB,KAZ,2015.0,1,0,1
AUS,ZMB,2005.0,1,0,1
MDA,TUR,1999.0,1,0,1
JPN,GTM,2001.0,1,0,1
ITA,CUB,1998.0,1,0,1
CHL,BWA,2015.0,1,0,1
,GNQ,2008.0,1,0,1
ETH,TUN,2021.0,1,0,1
MEX,PAK,2003.0,1,0,1
BEN,NGA,2000.0,1,0,1
NLD,TWN,2004.0,1,0,1
MDG,SEN,2022.0,1,0,1
COG,TCD,2012.0,1,0,1
FIN,ECU,2021.0,1,0,1
CZE,ECU,2021.0,1,0,1
MAR,TUN,2003.0,1,0,1
RUS,GEO,2000.0,1,0,1
TUN,ARE,2007.0,1,0,1
HUN,LBY,2006.0,1,0,1
SAU,BRN,2015.0,1,0,1
IND,MMR,2020.0,2,0,2
IND,COL,2019.0,1,0,1
BEL,MMR,2020.0,1,0,1
FRA,FRO,2018.0,1,0,1
IND,COL,2017.0,1,0,1
MWI,UGA,2008.0,1,0,1
,MOZ,1997.0,2,0,2
BGD,TUR,2016.0,1,0,1
GHA,BEN,2002.0,1,0,1
ZMB,AUS,2010.0,1,0,1
PRI,AUS,2005.0,2,0,2
DEU,MLT,2016.0,1,0,1
CZE,NZL,2012.0,1,0,1
SGP,BRN,2010.0,1,0,1
SEN,BFA,2009.0,1,0,1
BEL,TGO,2008.0,2,0,2
COL,CAN,1999.0,2,0,2
CHL,UKR,2007.0,1,0,1
UZB,SYR,2012.0,1,0,1
ETH,TWN,2012.0,1,0,1
KHM,ETH,2021.0,1,0,1
BDI,TCD,2011.0,1,0,1
AUT,MNG,2012.0,1,0,1
MKD,NLD,2018.0,1,0,1
RUS,SAU,2009.0,2,0,2
IND,NOR,2004.0,1,0,1
THA,ISR,2020.0,1,0,1
IRN,BGR,2012.0,1,0,1
USA,NAM,2003.0,1,0,1
SGP,TUR,2006.0,2,0,2
ARM,BEL,2006.0,1,0,1
MWI,BRA,2021.0,1,0,1
BIH,BEL,2012.0,1,0,1
MDA,IRN,2019.0,1,0,1
TUR,CHL,2018.0,2,0,2
BFA,GHA,2010.0,1,0,1
EGY,SVK,2016.0,1,0,1
AUT,MAR,2019.0,1,0,1
FRA,MYS,1999.0,1,0,1
PLW,,2009.0,1,0,1
GUF,CIV,2018.0,1,0,1
RUS,JOR,2003.0,1,0,1
CAN,PSE,2009.0,1,0,1
NZL,ISR,2011.0,1,0,1
NLD,MLI,2011.0,2,0,2
IND,THA,2004.0,2,0,2
EGY,PRT,2022.0,1,0,1
SSD,ZWE,2019.0,1,0,1
ISR,NPL,2019.0,1,0,1
KOR,GRC,2014.0,1,0,1
ZAF,AGO,2017.0,1,0,1
IRN,CHL,2015.0,1,0,1
FIN,AUT,1998.0,1,0,1
AZE,NLD,2020.0,1,0,1
LBN,KWT,2005.0,2,0,2
SDN,CAN,2009.0,1,0,1
CIV,CAN,1999.0,1,0,1
ZAF,BWA,1997.0,1,0,1
RUS,PAK,1997.0,1,0,1
MTQ,USA,2015.0,1,0,1
FLK,ZAF,2010.0,1,0,1
,ATG,2006.0,2,0,2
CIV,BRA,2015.0,1,0,1
TWN,ISL,2017.0,1,0,1
FRA,KGZ,2013.0,1,0,1
PRT,MYS,2010.0,1,0,1
MOZ,SWE,2003.0,1,0,1
BRA,TWN,2018.0,1,0,1
MEX,BGD,2006.0,1,0,1
USA,BTN,2021.0,1,0,1
ESP,JOR,2005.0,1,0,1
ZWE,AUT,2017.0,1,0,1
ITA,ISL,2010.0,1,0,1
LSO,IRL,2011.0,1,0,1
GBR,GRD,2021.0,1,0,1
DEU,MNE,2006.0,1,0,1
ITA,THA,2008.0,2,0,2
AUS,SVK,2003.0,1,0,1
NZL,IRN,2001.0,1,0,1
NZL,BWA,2002.0,1,0,1
MRT,GBR,2003.0,1,0,1
JOR,KWT,2005.0,1,0,1
BGD,SAU,2010.0,1,0,1
AUT,UGA,2019.0,1,0,1
LTU,PRT,2012.0,1,0,1
ALB,PAK,2020.0,1,0,1
FRA,ECU,2022.0,1,0,1
SVK,TWN,2021.0,1,0,1
BEL,BWA,2016.0,1,0,1
SLE,,2004.0,1,0,1
CMR,KEN,2008.0,1,0,1
MDG,RWA,2020.0,1,0,1
COD,CAN,2022.0,1,0,1
LBR,GHA,2020.0,1,0,1
CAN,AZE,2018.0,1,0,1
BGD,KEN,2018.0,1,0,1
LAO,,2004.0,1,0,1
UZB,SRB,2010.0,1,0,1
GUF,SUR,2010.0,1,0,1
GUF,SUR,2019.0,1,0,1
GRC,CMR,2010.0,1,0,1
PYF,JPN,2018.0,1,0,1
MNG,CHE,2020.0,1,0,1
ALB,JPN,2019.0,1,0,1
SVK,ITA,1997.0,2,0,2
COL,RUS,2022.0,1,0,1
ETH,MWI,2012.0,1,0,1
UKR,SGP,1998.0,1,0,1
VIR,USA,2011.0,1,0,1
SLB,MYS,2021.0,1,0,1
PER,ZAF,2020.0,1,0,1
NZL,POL,2003.0,1,0,1
DEU,TGO,2015.0,1,0,1
NZL,BWA,2005.0,1,0,1
NGA,CAN,2003.0,1,0,1
COL,NZL,2002.0,1,0,1
ARE,CAN,2000.0,2,0,2
MKD,RUS,2002.0,1,0,1
ESP,UGA,2002.0,1,0,1
LTU,BLR,2002.0,1,0,1
DEU,JAM,2011.0,1,0,1
LVA,CAN,2000.0,1,0,1
GMB,KEN,2006.0,1,0,1
GBR,CIV,2009.0,1,0,1
ESP,CPV,2020.0,1,0,1
LBY,IND,1999.0,1,0,1
VEN,PRI,2015.0,1,0,1
HRV,BRA,2015.0,1,0,1
VNM,ZAF,2016.0,1,0,1
SYC,MUS,2017.0,1,0,1
DEU,BRN,2021.0,1,0,1
THA,TZA,2019.0,1,0,1
,MMR,1995.0,1,0,1
KOR,ARG,1998.0,1,0,1
DNK,TUN,2016.0,1,0,1
FRA,LKA,2022.0,1,0,1
JPN,ISL,2009.0,1,0,1
LBR,NGA,2016.0,1,0,1
VEN,KAZ,2014.0,1,0,1
GBR,QAT,2001.0,1,0,1
AUS,VUT,2019.0,1,0,1
USA,CUW,2018.0,1,0,1
AUS,CYP,2008.0,1,0,1
FIN,AUT,1997.0,1,0,1
GIN,JPN,2009.0,1,0,1
SDN,FRA,2020.0,2,0,2
SVK,FIN,2001.0,1,0,1
NZL,COL,2015.0,1,0,1
CHE,IDN,2004.0,1,0,1
GMB,FRA,2012.0,1,0,1
CHN,LUX,2013.0,1,0,1
CHL,CRI,2021.0,1,0,1
BEN,MLI,2022.0,1,0,1
LBR,GBR,2015.0,1,0,1
NOR,BRA,2007.0,1,0,1
OMN,TTO,2012.0,1,0,1
JOR,OMN,2000.0,1,0,1
CHL,AUT,2002.0,1,0,1
QAT,CYP,2021.0,1,0,1
ETH,ISR,2007.0,1,0,1
NGA,NOR,2016.0,1,0,1
CIV,JPN,2020.0,1,0,1
SAU,ISR,2021.0,1,0,1
QAT,NZL,2022.0,1,0,1
SLE,CHE,2022.0,1,0,1
NLD,BFA,2015.0,1,0,1
COL,ZAF,2015.0,1,0,1
GBR,LCA,2014.0,1,0,1
SVK,VNM,2016.0,1,0,1
PAK,KAZ,2017.0,1,0,1
COD,JPN,2021.0,1,0,1
COL,EST,2019.0,1,0,1
FRA,TUN,2008.0,92,60,32
JPN,GBR,2016.0,100,121,-21
BEL,ITA,1999.0,20,17,3
LBN,USA,2011.0,42,30,12
IND,USA,2014.0,903,761,142
DEU,SWE,2009.0,116,74,42
SWE,NLD,2020.0,63,64,-1
GBR,GRC,2005.0,127,77,50
USA,BRA,2012.0,304,282,22
FRA,ESP,2011.0,178,197,-19
USA,ITA,2002.0,469,502,-33
GBR,AUS,2011.0,576,409,167
USA,NZL,2011.0,123,99,24
USA,FRA,2008.0,584,672,-88
USA,ARG,2012.0,81,93,-12
EST,DEU,2008.0,4,7,-3
DEU,CHE,2012.0,596,417,179
CHE,ITA,2014.0,103,254,-151
DEU,IRL,2013.0,25,47,-22
AUS,GBR,2014.0,456,651,-195
DEU,ITA,2013.0,151,292,-141
KOR,SGP,2014.0,26,19,7
USA,NLD,2008.0,265,242,23
ITA,CAN,2011.0,53,42,11
CHE,DEU,2014.0,453,646,-193
ARG,FRA,2019.0,37,31,6
CHE,GBR,2011.0,161,230,-69
JPN,IND,2013.0,68,94,-26
DNK,CHN,2011.0,11,32,-21
JPN,USA,2016.0,732,765,-33
GBR,ARE,2013.0,32,13,19
ISR,CAN,2013.0,44,45,-1
GBR,THA,2008.0,50,16,34
USA,CAN,2006.0,1349,1239,110
CAN,KOR,2010.0,42,49,-7
THA,USA,2007.0,83,141,-58
ITA,HRV,2016.0,11,9,2
FRA,PRT,2010.0,35,36,-1
HKG,AUS,2012.0,40,39,1
SGP,USA,2008.0,157,184,-27
THA,JPN,2008.0,23,63,-40
IND,JPN,2013.0,94,68,26
CHN,JPN,2013.0,306,516,-210
KOR,USA,2007.0,604,752,-148
DEU,ARG,2015.0,18,28,-10
AUT,SVK,2008.0,8,13,-5
NLD,ESP,2012.0,56,56,0
CHE,ESP,2008.0,41,41,0
BEL,BRA,2006.0,7,6,1
GBR,DEU,2012.0,563,489,74
CAN,AUS,2016.0,178,134,44
ESP,GBR,2004.0,119,157,-38
AUT,JPN,2017.0,9,16,-7
PER,USA,2008.0,25,23,2
GBR,PRT,2019.0,85,104,-19
GBR,USA,2018.0,1717,1512,205
BRA,IRL,2012.0,4,5,-1
CHN,SGP,2013.0,196,216,-20
JPN,THA,2013.0,85,45,40
FIN,DEU,2008.0,37,31,6
AUT,PAK,2011.0,19,6,13
TWN,USA,2012.0,273,311,-38
SGP,CZE,2015.0,2,1,1
USA,AUT,2008.0,86,98,-12
NLD,DEU,2005.0,154,158,-4
EGY,CHN,2019.0,40,27,13
JPN,BGD,2018.0,72,53,19
MAR,FRA,2008.0,33,71,-38
FRA,GBR,2015.0,468,390,78
AUT,AUS,2014.0,28,19,9
AUS,DNK,2018.0,28,24,4
GBR,CHN,2011.0,261,176,85
MEX,GBR,2011.0,29,55,-26
AUS,SGP,2015.0,67,80,-13
FRA,IRN,2008.0,18,5,13
TUR,FRA,2009.0,7,12,-5
GRC,GBR,2020.0,187,150,37
AUT,NOR,2005.0,3,3,0
ITA,CHE,2015.0,251,100,151
POL,GBR,1999.0,12,9,3
SGP,DEU,2014.0,34,31,3
MYS,CAN,2019.0,32,8,24
ESP,FRA,1998.0,34,33,1
TZA,GBR,2008.0,5,7,-2
BEL,FRA,2000.0,33,39,-6
ITA,SWE,2012.0,50,18,32
CHN,NGA,2008.0,2,1,1
JPN,CAN,2016.0,71,72,-1
IRN,NLD,2015.0,27,17,10
FRA,VNM,2021.0,27,13,14
ZAF,NGA,2018.0,61,79,-18
FRA,USA,2000.0,253,138,115
CHL,CAN,2022.0,10,6,4
FRA,QAT,2014.0,19,4,15
THA,FRA,2014.0,14,11,3
IND,MYS,2015.0,96,65,31
MYS,LBY,2014.0,10,1,9
JPN,MYS,2017.0,56,41,15
ESP,ECU,2017.0,72,22,50
AUS,ITA,2011.0,11,42,-31
MEX,FRA,2014.0,34,33,1
ZAF,UGA,2014.0,7,5,2
CHL,USA,2016.0,107,135,-28
MAC,CHN,2017.0,44,55,-11
BGD,JPN,2016.0,49,60,-11
ESP,DNK,2020.0,40,30,10
SAU,AUS,2019.0,31,61,-30
KOR,IDN,2020.0,42,21,21
IND,NLD,2009.0,36,8,28
ZMB,GBR,2019.0,6,4,2
IND,THA,2014.0,7,2,5
BEL,CHN,2021.0,57,57,0
CHL,BRA,2014.0,16,19,-3
UKR,CHN,2017.0,20,5,15
FRA,SEN,2014.0,27,14,13
RUS,NLD,2016.0,23,18,5
BRA,ESP,2013.0,47,76,-29
IRN,AUS,2014.0,136,17,119
CAN,AUT,2016.0,27,12,15
MAC,CHN,2019.0,140,64,76
NOR,USA,2016.0,65,74,-9
USA,TZA,2017.0,17,14,3
ESP,ECU,2019.0,53,40,13
DNK,USA,2018.0,142,149,-7
AUT,IRN,2011.0,5,8,-3
DNK,NLD,1999.0,9,6,3
BEL,AUT,2021.0,15,10,5
CAN,IRN,2020.0,54,421,-367
FRA,NLD,2011.0,74,87,-13
SAU,ESP,2018.0,2,7,-5
EST,LVA,2015.0,8,1,7
FIN,SWE,2013.0,45,42,3
ROU,DEU,2016.0,22,13,9
GBR,ESP,2006.0,158,144,14
GBR,CYP,2022.0,14,6,8
CHE,AUT,2017.0,73,76,-3
CZE,ARG,2020.0,2,3,-1
ARE,KOR,2016.0,2,7,-5
AUS,JPN,2021.0,41,34,7
HUN,GBR,2015.0,37,23,14
USA,ZWE,2017.0,15,6,9
THA,CZE,2020.0,1,2,-1
LUX,CAN,2019.0,2,4,-2
POL,NOR,2011.0,6,3,3
CHN,ESP,2020.0,46,43,3
ESP,QAT,2017.0,6,3,3
NLD,IND,2013.0,19,26,-7
MOZ,BRA,2020.0,4,7,-3
IND,AUS,2016.0,110,62,48
HKG,USA,2016.0,139,145,-6
FRA,LBN,2009.0,25,14,11
GBR,NZL,2018.0,99,87,12
SWE,ESP,2013.0,35,52,-17
USA,PER,2016.0,28,40,-12
MDG,USA,2020.0,8,4,4
BRA,PAK,2017.0,13,4,9
ITA,CZE,2019.0,27,12,15
COL,ESP,2018.0,63,100,-37
BGD,TUR,2022.0,4,1,3
CHE,JPN,2021.0,25,22,3
BEL,CMR,2020.0,6,6,0
JPN,IDN,2005.0,35,4,31
CAN,MEX,2020.0,30,53,-23
CHE,USA,2022.0,174,218,-44
IDN,THA,2021.0,9,10,-1
EGY,CHN,2017.0,18,12,6
DEU,MEX,2021.0,23,34,-11
RUS,VNM,2019.0,12,5,7
PRT,IRL,2018.0,4,2,2
USA,DNK,2020.0,136,134,2
ZAF,KEN,2020.0,22,11,11
JPN,EGY,2020.0,41,17,24
ZAF,SWE,2020.0,11,9,2
SVK,CZE,2012.0,54,29,25
FRA,UKR,2018.0,16,10,6
ESP,RUS,2018.0,15,8,7
ESP,FRA,1997.0,13,19,-6
ZAF,AUS,2019.0,44,19,25
TUR,CZE,2020.0,11,5,6
FRA,IND,2005.0,25,29,-4
NLD,ITA,2014.0,52,108,-56
NLD,NOR,2011.0,21,8,13
ESP,AUT,2014.0,30,17,13
PER,ARG,2021.0,6,4,2
SAU,GBR,2017.0,41,153,-112
VNM,ESP,2020.0,4,1,3
ZAF,PAK,2010.0,3,3,0
ITA,CZE,2017.0,10,13,-3
PAK,CHN,2018.0,269,208,61
IRN,DEU,2009.0,28,21,7
FRA,ZAF,2017.0,22,18,4
MYS,CAN,2017.0,31,6,25
GHA,AUS,2016.0,13,6,7
USA,ZWE,2019.0,8,7,1
FRA,DEU,2001.0,196,200,-4
CHE,AUT,2019.0,59,75,-16
ARG,FRA,2017.0,31,35,-4
FRA,CHL,2009.0,21,30,-9
NZL,AUS,2006.0,134,103,31
ITA,FIN,2010.0,15,5,10
ZMB,GBR,2017.0,2,8,-6
ISL,SWE,2013.0,15,8,7
IDN,DEU,2011.0,8,11,-3
MEX,CUB,2006.0,11,8,3
LVA,USA,2017.0,6,2,4
IND,CAN,2008.0,85,39,46
AUS,PAK,2016.0,20,35,-15
NOR,DEU,2014.0,36,63,-27
BRA,POL,2010.0,4,2,2
MEX,BRA,2006.0,10,9,1
CUB,BRA,2019.0,15,4,11
IRL,CAN,2003.0,12,11,1
BEL,BFA,2014.0,1,1,0
BEL,SWE,2011.0,16,10,6
FRA,PRT,2019.0,32,37,-5
SAU,GBR,2019.0,55,178,-123
JPN,TWN,2016.0,41,53,-12
IRL,AUS,2018.0,30,34,-4
CHE,POL,2012.0,34,11,23
ISR,ESP,2009.0,7,5,2
ESP,JPN,2013.0,13,11,2
CAN,KOR,2017.0,30,64,-34
SVK,POL,2018.0,11,5,6
CAN,BGD,2020.0,22,42,-20
NLD,NGA,2014.0,2,4,-2
VNM,USA,2009.0,7,10,-3
CHN,FIN,2008.0,14,3,11
CHE,CHN,2006.0,15,13,2
GBR,CAN,2000.0,59,65,-6
GBR,KOR,2014.0,43,42,1
ITA,POL,2003.0,22,16,6
ISR,CHN,2003.0,7,6,1
TWN,CHN,2003.0,31,31,0
MEX,DNK,2011.0,4,2,2
KOR,AUS,1997.0,3,1,2
GBR,PRT,2010.0,67,50,17
TTO,CAN,2020.0,2,3,-1
TWN,FRA,2011.0,8,16,-8
CAN,QAT,2019.0,23,12,11
ZAF,QAT,2019.0,1,1,0
GHA,IND,2019.0,2,5,-3
AUT,JPN,2010.0,9,10,-1
IRL,DNK,2020.0,6,7,-1
CAN,IND,2015.0,80,115,-35
TUR,AUS,2014.0,11,3,8
DEU,SVK,1998.0,8,4,4
ITA,THA,2013.0,3,2,1
PRT,AUT,2007.0,2,1,1
NOR,NPL,2014.0,4,2,2
SRB,BEL,2016.0,4,3,1
UKR,CHN,2019.0,13,5,8
AUS,PRT,2011.0,5,3,2
SWE,DNK,1999.0,20,16,4
USA,LUX,2008.0,3,2,1
RUS,ITA,2001.0,24,23,1
LKA,ITA,2021.0,2,2,0
KOR,DEU,2003.0,21,18,3
CAN,KOR,2019.0,46,45,1
COL,BRA,2022.0,12,24,-12
FRA,VEN,2010.0,7,5,2
ESP,POL,2022.0,9,13,-4
MEX,ESP,2006.0,59,63,-4
YEM,EGY,2019.0,2,11,-9
CUB,BRA,2017.0,27,4,23
POL,AUS,2019.0,10,6,4
CHN,NPL,2022.0,7,3,4
ARG,NZL,2021.0,4,1,3
AUT,TUR,2019.0,4,16,-12
USA,KEN,2020.0,41,35,6
ETH,GBR,2020.0,7,4,3
ITA,FIN,2019.0,37,15,22
GBR,KWT,2015.0,14,9,5
CZE,UKR,2022.0,3,2,1
SWE,NZL,2004.0,7,4,3
IRQ,IRN,2020.0,7,20,-13
GMB,GBR,2020.0,11,10,1
NPL,AUS,2012.0,6,6,0
HKG,NLD,2016.0,9,6,3
AUT,NZL,2005.0,3,1,2
ISR,IRL,2021.0,3,1,2
CZE,USA,2013.0,40,47,-7
USA,CYP,2011.0,17,7,10
JPN,FIN,2009.0,7,7,0
GBR,DNK,2013.0,66,58,8
SAU,CHE,2018.0,4,10,-6
HKG,SGP,2018.0,39,43,-4
BRA,POL,2019.0,7,9,-2
BRA,CHE,2009.0,12,11,1
POL,ITA,2019.0,28,42,-14
THA,KOR,2022.0,5,4,1
CHE,DNK,2020.0,31,38,-7
GBR,GRC,2002.0,102,47,55
FRA,FIN,2022.0,11,5,6
GBR,UKR,2015.0,7,9,-2
LUX,BEL,2005.0,1,8,-7
IND,FRA,2008.0,83,24,59
PHL,USA,2008.0,23,31,-8
COD,BEL,2021.0,6,12,-6
AUT,THA,2014.0,4,5,-1
GBR,CHL,2004.0,10,7,3
CHN,IRN,2008.0,1,4,-3
MEX,CHL,2007.0,10,4,6
USA,UGA,2009.0,11,14,-3
BEL,DNK,2010.0,7,3,4
FRA,KEN,2009.0,2,1,1
SAU,GBR,2010.0,24,62,-38
CAN,THA,2012.0,14,7,7
CAN,GHA,2009.0,2,3,-1
KWT,USA,2009.0,6,13,-7
CHE,SWE,2015.0,40,52,-12
EGY,AUS,2002.0,2,1,1
HRV,ITA,2006.0,2,4,-2
JPN,MYS,2019.0,36,52,-16
GLP,FRA,2006.0,17,10,7
PAK,MYS,2006.0,5,5,0
RUS,UZB,1998.0,3,1,2
CUB,JPN,2004.0,1,1,0
CMR,FRA,2002.0,11,13,-2
AUS,BEL,2009.0,8,13,-5
GBR,BGR,2001.0,2,20,-18
CHE,SRB,2002.0,2,3,-1
USA,QAT,2013.0,44,16,28
DEU,BGR,2001.0,3,29,-26
GBR,HUN,2003.0,24,24,0
RUS,UZB,1997.0,5,1,4
HRV,SRB,2005.0,1,4,-3
JPN,SVK,2005.0,3,1,2
USA,ZAF,2011.0,70,55,15
MYS,GBR,2006.0,14,59,-45
DEU,ARM,2001.0,7,3,4
DEU,HRV,2007.0,10,6,4
GBR,KEN,2004.0,20,10,10
THA,NPL,2022.0,3,3,0
SWE,LTU,2004.0,4,3,1
HUN,ESP,2002.0,3,1,2
DNK,CHE,2011.0,18,27,-9
DEU,GHA,2002.0,2,1,1
CHN,MEX,2003.0,2,3,-1
CAN,BWA,2006.0,3,1,2
BRA,MEX,2009.0,10,6,4
BEL,ESP,2007.0,20,17,3
JPN,IDN,2002.0,29,12,17
KEN,USA,2001.0,10,11,-1
FRA,ARG,2009.0,16,16,0
CZE,CAN,2006.0,9,3,6
HUN,NLD,2008.0,10,8,2
AUS,ARE,2005.0,9,3,6
GBR,MEX,2000.0,11,8,3
IND,BRA,2001.0,5,6,-1
JPN,CZE,2005.0,8,3,5
NLD,AUT,2001.0,10,3,7
CAN,POL,2005.0,7,15,-8
RUS,JPN,1998.0,15,9,6
GBR,SVK,2001.0,1,7,-6
RUS,BRA,2003.0,10,10,0
MYS,PAK,2004.0,4,2,2
QAT,DNK,2022.0,1,3,-2
GRC,RUS,2001.0,3,5,-2
HRV,SRB,2002.0,9,5,4
BRA,ITA,2008.0,24,35,-11
ARG,MEX,2003.0,8,13,-5
RUS,SWE,2007.0,15,14,1
EGY,USA,1997.0,5,3,2
POL,DEU,2007.0,74,50,24
CAN,UKR,1997.0,2,1,1
SRB,USA,2015.0,14,16,-2
EGY,USA,1998.0,10,7,3
ISR,PSE,2003.0,4,4,0
KEN,ITA,2022.0,2,2,0
EGY,SAU,1997.0,5,5,0
BEL,CHE,1999.0,15,7,8
KOR,CAN,2000.0,8,5,3
CAN,ARE,2012.0,20,14,6
PRT,ITA,2001.0,6,5,1
USA,URY,2000.0,2,1,1
CAN,RUS,2006.0,10,24,-14
GBR,VNM,2008.0,8,3,5
AUT,POL,2009.0,8,7,1
DEU,VNM,2012.0,10,5,5
NGA,SAU,2002.0,2,1,1
CHE,ISR,2018.0,12,20,-8
RUS,MEX,2006.0,2,8,-6
CYP,USA,2011.0,7,17,-10
FRA,IDN,2012.0,7,2,5
BGD,SAU,2018.0,4,7,-3
JPN,SVK,2002.0,2,5,-3
IRL,ZAF,2008.0,2,4,-2
ARG,FRA,2010.0,28,18,10
ZAF,IND,2013.0,22,52,-30
FIN,RUS,2013.0,9,15,-6
CUB,BRA,2010.0,9,8,1
GBR,BRN,2012.0,4,3,1
GBR,TTO,2007.0,4,4,0
THA,GBR,2004.0,15,50,-35
IND,SAU,2004.0,6,5,1
USA,HKG,2000.0,28,36,-8
KEN,NLD,2013.0,2,3,-1
NOR,DNK,2004.0,9,19,-10
KEN,GBR,2007.0,12,15,-3
ROU,ITA,2016.0,7,12,-5
GBR,MUS,2012.0,1,1,0
POL,AUT,2001.0,6,4,2
JPN,NGA,2011.0,4,3,1
LKA,CHN,2013.0,3,1,2
QAT,PRT,2018.0,1,1,0
KOR,PHL,2009.0,3,2,1
TUR,QAT,2022.0,2,1,1
RUS,VNM,2010.0,5,1,4
NZL,DEU,2014.0,30,31,-1
IRL,CHE,2004.0,5,3,2
MDA,DEU,2006.0,3,2,1
CHN,POL,2009.0,1,2,-1
BRN,MYS,2014.0,7,6,1
SGP,CAN,2020.0,25,27,-2
TWN,VNM,2013.0,8,1,7
FRA,NCL,2011.0,14,22,-8
TUR,IRN,2012.0,7,17,-10
BEL,TUN,2014.0,2,8,-6
AUT,JPN,2019.0,13,14,-1
GTM,ESP,2018.0,3,1,2
SWE,TUR,2017.0,7,22,-15
SWE,TUR,2010.0,2,1,1
FRA,ROU,2012.0,29,30,-1
AUS,ARG,2015.0,6,3,3
FIN,SAU,2021.0,1,1,0
RUS,POL,2007.0,3,6,-3
DEU,LIE,2012.0,3,1,2
TWN,SGP,2002.0,5,4,1
MYS,CAN,2010.0,9,9,0
NLD,IDN,2013.0,19,10,9
TWN,HKG,2018.0,12,17,-5
ARE,DEU,2017.0,3,6,-3
FRA,KHM,2011.0,3,2,1
EGY,OMN,2021.0,3,5,-2
IRN,AUT,2013.0,13,4,9
ISR,TWN,2022.0,2,1,1
UKR,ITA,2020.0,4,2,2
ZMB,NGA,2022.0,3,1,2
IND,PAK,2008.0,9,11,-2
MYS,NZL,2013.0,12,19,-7
SRB,AUT,2018.0,6,2,4
SWE,EST,2016.0,6,8,-2
NAM,ZAF,2022.0,2,5,-3
RUS,CHN,2016.0,12,16,-4
KOR,NPL,2017.0,7,2,5
IDN,NLD,2022.0,8,14,-6
FIN,CHE,2020.0,11,14,-3
CHL,CHE,2014.0,8,3,5
RUS,CHL,2017.0,1,1,0
VNM,CHN,2014.0,7,10,-3
IDN,CHN,2021.0,6,5,1
ITA,FIN,2017.0,22,11,11
FRA,ZAF,2019.0,18,18,0
NZL,JPN,2009.0,8,11,-3
MYS,JPN,2014.0,18,94,-76
YEM,EGY,2010.0,1,2,-1
ZWE,CHE,2021.0,2,1,1
USA,CZE,1998.0,8,7,1
MEX,CRI,2019.0,2,3,-1
ETH,IND,2005.0,3,7,-4
GBR,CMR,2021.0,5,8,-3
SRB,AUS,2018.0,3,1,2
DEU,ETH,2004.0,4,4,0
SAU,HUN,2018.0,1,1,0
GBR,ZAF,2003.0,47,67,-20
AUT,NZL,2002.0,3,2,1
BEL,ISR,2018.0,6,3,3
GRC,NLD,2003.0,8,9,-1
LKA,USA,2006.0,5,6,-1
FRA,EGY,2008.0,10,7,3
ITA,ROU,2009.0,18,8,10
NZL,ITA,2010.0,3,3,0
VNM,KOR,2012.0,11,32,-21
ZAF,AUS,2010.0,31,13,18
POL,ITA,2010.0,8,19,-11
RUS,BLR,2006.0,12,7,5
TUR,SWE,2013.0,8,7,1
ZAF,CHE,2018.0,13,8,5
FIN,IND,2020.0,10,23,-13
PYF,FRA,2001.0,3,1,2
EGY,ZAF,2014.0,1,3,-2
IND,RUS,2021.0,9,10,-1
AUS,BRA,2007.0,12,14,-2
AUT,ITA,2015.0,24,41,-17
QAT,ARE,2021.0,9,6,3
IND,FIN,2013.0,20,8,12
NLD,THA,2013.0,8,3,5
IRL,PRT,2007.0,1,2,-1
IND,PRT,2005.0,9,3,6
CHE,AUT,2010.0,39,57,-18
SAU,ARE,2011.0,6,11,-5
VNM,DEU,2012.0,5,10,-5
JOR,SAU,2021.0,16,20,-4
PAN,USA,2016.0,7,15,-8
ESP,FIN,2016.0,19,18,1
SRB,CZE,2018.0,4,3,1
CMR,JPN,2018.0,2,1,1
KOR,MMR,2016.0,1,2,-1
IRN,DZA,2014.0,1,1,0
RUS,LTU,2018.0,2,1,1
SGP,RUS,2018.0,3,4,-1
CAN,PAK,2004.0,7,8,-1
COL,ITA,2012.0,3,6,-3
ZAF,ISR,2020.0,5,3,2
MEX,CRI,2017.0,3,5,-2
DNK,PHL,2021.0,1,1,0
SYR,JOR,2018.0,1,1,0
NZL,ITA,2017.0,3,11,-8
CHL,DOM,2021.0,2,3,-1
EGY,HUN,2003.0,2,2,0
FRA,URY,2007.0,3,1,2
AUS,MYS,2004.0,13,9,4
NLD,SGP,2011.0,12,6,6
ISR,GRC,2012.0,1,2,-1
PHL,BRA,2013.0,2,1,1
USA,SYR,2015.0,2,3,-1
ESP,NZL,2009.0,3,3,0
URY,USA,2009.0,15,11,4
JPN,NPL,2003.0,3,2,1
GRC,BEL,2011.0,5,11,-6
USA,LTU,2008.0,7,2,5
PHL,GBR,2001.0,2,3,-1
BGR,DEU,2014.0,9,9,0
ISR,FRA,2007.0,21,13,8
SEN,FRA,1998.0,8,5,3
DNK,JPN,2001.0,7,11,-4
CHE,SGP,2012.0,9,9,0
PSE,GBR,2003.0,2,1,1
CHE,ZAF,2006.0,5,6,-1
DEU,SYR,2014.0,2,2,0
NZL,IRL,2005.0,5,4,1
GRL,DNK,2010.0,3,4,-1
AUT,NOR,2002.0,2,2,0
MEX,RUS,2000.0,3,7,-4
CAN,QAT,2017.0,17,7,10
NLD,NZL,2001.0,5,4,1
SYR,USA,2005.0,1,2,-1
BEL,JPN,2003.0,7,15,-8
HRV,GBR,2008.0,2,4,-2
ISL,NOR,2011.0,5,2,3
CHE,COL,2006.0,3,1,2
SVN,HRV,2001.0,4,4,0
CHN,IND,2007.0,8,11,-3
USA,BGD,2008.0,13,19,-6
RUS,EGY,2005.0,2,1,1
USA,ZWE,2010.0,3,6,-3
DEU,CZE,2007.0,24,27,-3
NPL,GBR,2011.0,7,4,3
CHN,KEN,2013.0,4,4,0
FRA,ZAF,2010.0,19,13,6
LVA,USA,2019.0,2,4,-2
SRB,MNE,2006.0,2,6,-4
GRC,NOR,2008.0,5,2,3
SWE,IDN,2012.0,2,1,1
VEN,CAN,2006.0,7,2,5
COG,FRA,2003.0,3,2,1
NLD,ARG,2003.0,6,1,5
CRI,VEN,2008.0,1,1,0
TUR,IRL,2008.0,2,3,-1
POL,SWE,2011.0,15,18,-3
MYS,IRL,2013.0,5,6,-1
TWN,MYS,2009.0,2,1,1
AUT,SWE,2006.0,6,7,-1
SWE,AUT,2007.0,6,7,-1
CHL,GBR,2013.0,23,25,-2
CYP,GBR,2022.0,6,14,-8
CMR,USA,2003.0,1,5,-4
PER,JPN,2011.0,4,1,3
ESP,EGY,2022.0,6,2,4
SLE,CHE,2016.0,1,1,0
THA,IND,2007.0,4,2,2
KOR,FRA,1998.0,2,2,0
CHL,BEL,2014.0,6,8,-2
KEN,CHE,2021.0,5,4,1
GBR,KAZ,2015.0,6,4,2
TWN,NLD,2014.0,5,4,1
LVA,CHE,2020.0,1,1,0
JOR,JPN,2015.0,1,3,-2
AUT,TUR,2017.0,5,7,-2
MYS,LKA,2016.0,3,4,-1
UKR,BEL,2012.0,2,1,1
USA,LBY,2018.0,4,2,2
BEN,CHN,2021.0,2,1,1
CHN,HRV,2018.0,1,1,0
SVN,DEU,2021.0,7,10,-3
IND,BTN,2017.0,4,2,2
IND,BEL,2022.0,8,4,4
TWN,MAC,2014.0,2,1,1
LVA,GBR,2015.0,3,2,1
BRA,CRI,2020.0,6,2,4
BRA,POL,2017.0,5,7,-2
PHL,DEU,2003.0,1,1,0
CAN,KEN,2006.0,1,3,-2
IRL,POL,2006.0,2,2,0
ITA,IND,2004.0,7,12,-5
USA,OMN,2013.0,3,3,0
USA,FJI,2004.0,1,3,-2
COL,CHL,2009.0,13,7,6
QAT,EGY,2012.0,6,5,1
BEL,DNK,2019.0,21,18,3
GRL,DNK,2017.0,3,5,-2
MEX,URY,2019.0,3,3,0
IND,DNK,2005.0,5,5,0
ITA,ARG,2013.0,15,14,1
IDN,ZAF,2004.0,1,1,0
JPN,DNK,2002.0,8,7,1
BGD,NZL,2006.0,1,1,0
USA,SRB,2009.0,18,7,11
TUR,AZE,2003.0,2,8,-6
MOZ,USA,2009.0,2,5,-3
SGP,SWE,1999.0,2,3,-1
IND,MDV,2022.0,1,1,0
MEX,AUS,2013.0,9,9,0
PYF,USA,2016.0,1,2,-1
GBR,LBN,2015.0,9,3,6
ZAF,TUR,2015.0,3,1,2
THA,IRN,2013.0,1,1,0
NZL,IND,2014.0,10,10,0
NOR,ZAF,2015.0,7,3,4
EGY,BRA,2011.0,1,2,-1
SRB,SWE,2014.0,4,3,1
MYS,BRN,2018.0,4,6,-2
GBR,LTU,2022.0,2,4,-2
GRC,TUR,2008.0,1,1,0
BWA,ZAF,2002.0,3,1,2
LTU,FRA,2019.0,2,2,0
KOR,DNK,2016.0,10,7,3
JPN,NZL,2014.0,7,5,2
FRA,VEN,2019.0,2,2,0
GHA,BFA,2019.0,2,2,0
PAN,ESP,2018.0,2,3,-1
YEM,EGY,2017.0,2,6,-4
ITA,VEN,2018.0,1,5,-4
LUX,CAN,2017.0,5,2,3
BHR,SAU,2021.0,3,6,-3
FIN,THA,2012.0,1,1,0
USA,TUN,2003.0,3,1,2
USA,BIH,2007.0,3,3,0
ISL,DEU,2015.0,5,7,-2
KOR,NPL,2019.0,3,3,0
USA,CIV,1997.0,3,1,2
BRA,RUS,2001.0,9,4,5
AUS,KAZ,2019.0,3,2,1
URY,BEL,2013.0,1,1,0
AUS,CZE,2003.0,4,2,2
LVA,USA,2010.0,7,2,5
FRA,GEO,2009.0,1,1,0
USA,SVN,2001.0,3,7,-4
NGA,SAU,2005.0,1,2,-1
UKR,JPN,2005.0,1,4,-3
FRA,PYF,2008.0,6,6,0
SEN,FRA,1997.0,5,4,1
USA,CUB,2012.0,2,5,-3
RUS,ARM,2002.0,3,3,0
UZB,RUS,2004.0,6,5,1
IND,COL,2018.0,1,1,0
LTU,FIN,2012.0,1,3,-2
USA,CZE,1997.0,12,7,5
AZE,ISR,2016.0,1,1,0
BGR,NLD,2008.0,3,2,1
IND,MEX,2007.0,4,4,0
NZL,IRL,2002.0,2,5,-3
VNM,GBR,2022.0,4,7,-3
RUS,ARM,2005.0,2,2,0
JPN,DNK,2005.0,3,11,-8
CUB,DEU,2011.0,6,2,4
EGY,POL,2011.0,7,1,6
MYS,SDN,2011.0,3,1,2
ZWE,CAN,2014.0,2,1,1
GRC,CHN,2012.0,3,3,0
POL,AUS,2010.0,5,4,1
LKA,IND,2020.0,4,3,1
UZB,KOR,2007.0,3,1,2
PAK,AUT,2020.0,2,5,-3
IRN,CHN,2003.0,1,1,0
JAM,CAN,2014.0,2,2,0
MEX,NOR,2019.0,4,1,3
MTQ,GLP,2014.0,1,4,-3
NOR,BEL,2022.0,2,5,-3
SAU,AUS,2017.0,17,62,-45
EGY,MYS,2011.0,3,4,-1
VNM,AUT,2017.0,3,3,0
BRA,PAK,2019.0,2,7,-5
USA,COD,2018.0,2,1,1
ETH,KOR,2015.0,4,2,2
CRI,CHL,2020.0,3,2,1
SWE,TZA,2022.0,3,2,1
ZMB,GBR,2010.0,1,2,-1
CHN,BEL,2004.0,7,11,-4
CHN,PHL,2008.0,2,2,0
NLD,ZAF,2001.0,5,9,-4
BRA,PAK,2010.0,3,3,0
AUT,ESP,2001.0,7,9,-2
MAR,TUN,2001.0,2,1,1
GRC,CHE,2004.0,8,8,0
OMN,IND,2008.0,3,10,-7
DNK,HUN,2008.0,4,1,3
CAN,POL,2002.0,6,5,1
COL,MEX,2001.0,1,2,-1
SAU,ITA,2017.0,3,22,-19
CAN,BEN,2021.0,3,1,2
PHL,FRA,2013.0,1,1,0
ESP,ROU,2011.0,3,2,1
KAZ,RUS,2001.0,4,10,-6
DZA,SAU,2021.0,3,7,-4
BGR,BRA,2000.0,2,1,1
SAU,BEL,2015.0,3,5,-2
UGA,NGA,2016.0,1,2,-1
CHN,EGY,2007.0,2,2,0
BRA,GRC,2016.0,2,1,1
KWT,CAN,2007.0,1,8,-7
MDA,RUS,1997.0,1,1,0
ARE,GBR,2004.0,3,11,-8
PRT,CHE,2007.0,6,6,0
KEN,ESP,2014.0,1,1,0
HRV,BEL,2018.0,3,1,2
DZA,KOR,2019.0,1,1,0
QAT,KOR,2009.0,1,1,0
IRL,SGP,2011.0,5,2,3
CHE,PNG,2010.0,1,1,0
IRL,IRN,2014.0,2,7,-5
NOR,CZE,2012.0,2,3,-1
JOR,BHR,2020.0,4,1,3
CHE,MDA,2020.0,1,2,-1
DEU,KEN,2022.0,7,1,6
HUN,IND,2017.0,1,5,-4
BHR,USA,2014.0,1,2,-1
OMN,AUS,2013.0,1,4,-3
SAU,AUS,2010.0,3,13,-10
GHA,DEU,2015.0,4,5,-1
BHS,USA,2022.0,2,1,1
ZAF,PAK,2019.0,4,3,1
IRL,MYS,2013.0,6,5,1
MNG,DEU,2019.0,1,2,-1
BFA,CAN,2019.0,3,1,2
KAZ,DEU,2016.0,3,6,-3
ETH,SWE,2017.0,2,4,-2
NOR,IRL,2021.0,3,1,2
ESP,SVN,2003.0,3,1,2
ESP,CZE,2007.0,3,1,2
JOR,NOR,2019.0,1,1,0
MDG,FRA,2014.0,3,6,-3
VEN,USA,2022.0,3,1,2
JOR,USA,1999.0,2,6,-4
PSE,TUR,2016.0,2,3,-1
SWE,ISL,2001.0,5,2,3
SGP,IRL,2008.0,2,1,1
BEL,SAU,2007.0,1,1,0
LBY,POL,2010.0,1,1,0
IDN,VNM,2020.0,1,1,0
CHN,NOR,2008.0,8,5,3
TWN,POL,2013.0,2,3,-1
AFG,GBR,2009.0,1,2,-1
GHA,CHE,2015.0,5,2,3
NGA,PAK,2018.0,3,2,1
MLI,IND,2014.0,1,1,0
MEX,URY,2017.0,4,3,1
KOR,ESP,2013.0,5,5,0
KOR,FIN,2014.0,3,3,0
NLD,PER,2017.0,1,2,-1
UGA,ETH,2021.0,2,1,1
CHN,GIN,2018.0,2,2,0
TUR,CHE,2007.0,4,4,0
QAT,MYS,2022.0,1,2,-1
CHE,SVN,2021.0,1,4,-3
NGA,GMB,2006.0,2,2,0
MKD,SVN,2019.0,3,1,2
SWE,CHE,1997.0,2,3,-1
SAU,OMN,2009.0,4,1,3
ARG,RUS,2007.0,1,1,0
CZE,FIN,2009.0,1,2,-1
GHA,BWA,2011.0,1,1,0
NOR,IND,2006.0,6,4,2
HRV,DEU,1999.0,2,6,-4
NZL,RUS,2014.0,2,3,-1
KEN,CHN,2011.0,2,2,0
HUN,AUS,1998.0,1,1,0
VEN,ITA,2003.0,1,1,0
CAN,SRB,2011.0,3,4,-1
ZWE,AUS,2014.0,1,2,-1
MYS,DNK,2009.0,2,1,1
SWE,CHE,1998.0,4,3,1
IND,DNK,2002.0,4,2,2
PRT,MOZ,2022.0,2,2,0
DNK,RUS,2016.0,1,5,-4
AUT,TUR,2010.0,1,2,-1
CHL,ITA,2006.0,2,10,-8
SWE,COL,2015.0,1,5,-4
ARE,IND,2008.0,3,5,-2
SVK,EGY,2021.0,1,1,0
UZB,ESP,2015.0,1,1,0
NOR,HKG,2013.0,1,1,0
DEU,UZB,2011.0,1,2,-1
GBR,COG,2016.0,1,1,0
ZAF,HUN,2022.0,1,1,0
NGA,DEU,2003.0,3,5,-2
IRL,RUS,2016.0,1,2,-1
PAK,ZAF,2014.0,5,1,4
PNG,USA,2000.0,1,1,0
ALB,USA,2020.0,1,1,0
IDN,USA,1999.0,1,7,-6
USA,ZMB,2007.0,3,4,-1
ITA,BGR,1997.0,1,1,0
IND,RWA,2014.0,1,1,0
AUT,FIN,2006.0,2,3,-1
LBN,IRL,2020.0,1,1,0
KWT,IND,2001.0,5,2,3
AUS,TWN,1997.0,1,1,0
SGP,CHE,2003.0,1,4,-3
CAN,BGR,2003.0,1,8,-7
ETH,SWE,2010.0,1,6,-5
AUT,ZAF,2013.0,2,3,-1
IND,PNG,2012.0,1,2,-1
ZAF,SEN,2018.0,1,1,0
USA,SEN,2013.0,4,1,3
SAU,KAZ,2020.0,3,2,1
FRA,KWT,2019.0,4,2,2
SWE,UKR,2013.0,2,4,-2
GRL,DNK,2019.0,3,6,-3
DZA,USA,2014.0,2,6,-4
MNG,AUS,2015.0,1,1,0
NZL,IDN,2020.0,5,1,4
GBR,HRV,2005.0,3,3,0
DZA,FIN,2021.0,1,1,0
VNM,ZAF,2022.0,2,1,1
MNG,DEU,2017.0,1,1,0
MEX,NOR,2010.0,2,1,1
FIN,DZA,2016.0,1,1,0
BRN,GBR,2014.0,1,4,-3
PRY,USA,2014.0,1,2,-1
NZL,THA,2016.0,3,1,2
GRC,POL,2014.0,3,11,-8
HUN,IND,2019.0,3,9,-6
USA,BFA,2014.0,2,1,1
VNM,RUS,2006.0,1,1,0
ARE,OMN,2022.0,1,2,-1
COL,CZE,2019.0,3,2,1
BEL,MAR,2008.0,3,2,1
ITA,NZL,2004.0,2,2,0
NOR,CHN,2001.0,2,1,1
CHN,BRA,2000.0,4,1,3
ECU,NLD,2012.0,2,1,1
SWE,TUR,2019.0,5,28,-23
MAR,ARE,2020.0,1,3,-2
LKA,KOR,2022.0,4,5,-1
DNK,BGR,2006.0,1,1,0
BRA,FIN,2012.0,5,3,2
CHN,SEN,2015.0,1,1,0
EST,CHN,2015.0,1,1,0
PAK,EGY,2009.0,3,1,2
SVK,CAN,2008.0,1,2,-1
NGA,IND,2002.0,2,4,-2
BRA,TWN,2017.0,1,4,-3
BIH,TUR,2020.0,2,3,-1
NCL,NZL,2013.0,1,1,0
BEL,PER,2011.0,2,1,1
GRC,IRL,2022.0,3,2,1
IDN,GBR,2015.0,4,25,-21
POL,BEL,1998.0,1,2,-1
USA,BLR,2012.0,1,5,-4
RUS,JPN,1997.0,3,11,-8
BEL,CZE,1997.0,1,1,0
IND,HKG,2004.0,1,5,-4
ITA,UKR,2012.0,1,3,-2
DNK,SAU,2016.0,1,1,0
GMB,USA,2019.0,1,1,0
PER,DEU,2013.0,2,2,0
VNM,POL,2016.0,2,4,-2
SAU,HKG,2022.0,2,2,0
PRT,CAN,1999.0,3,2,1
USA,TGO,2011.0,1,1,0
POL,ARG,2010.0,1,2,-1
BFA,CAN,2017.0,2,5,-3
MEX,ECU,2016.0,3,2,1
ITA,MNG,2020.0,1,1,0
MDA,RUS,1998.0,1,1,0
CHE,IDN,2014.0,2,1,1
ZAF,PAK,2017.0,2,4,-2
SRB,ESP,2015.0,2,3,-1
BEL,FIN,2003.0,1,3,-2
GBR,HRV,2002.0,3,2,1
ITA,COL,1997.0,2,2,0
POL,ARG,2017.0,1,1,0
IND,PRT,2002.0,1,2,-1
BWA,ZAF,2005.0,2,1,1
ITA,SAU,2007.0,1,2,-1
FIN,NZL,2011.0,1,2,-1
TUR,MEX,2011.0,1,2,-1
SDN,EGY,2015.0,1,2,-1
CYP,DEU,2015.0,2,1,1
CHL,BOL,2011.0,2,1,1
POL,TUR,2019.0,1,3,-2
CAN,CRI,2014.0,3,2,1
IRL,HKG,2021.0,2,6,-4
VNM,THA,2012.0,1,5,-4
MNG,USA,2013.0,2,4,-2
SVK,SVN,2002.0,3,1,2
PRT,LUX,2015.0,2,1,1
FIN,LBY,2016.0,1,2,-1
PHL,THA,2022.0,1,1,0
RUS,CHL,2019.0,2,1,1
KHM,THA,2018.0,1,3,-2
IDN,KEN,2018.0,2,1,1
BOL,DEU,2016.0,2,1,1
SAU,ITA,2010.0,1,4,-3
CHE,BGR,2001.0,2,5,-3
AUT,RUS,1999.0,1,2,-1
CHL,PER,2009.0,2,3,-1
CMR,BFA,2015.0,1,1,0
NGA,BWA,2011.0,1,2,-1
EGY,CHN,2010.0,1,3,-2
ARE,DEU,2010.0,2,4,-2
CMR,KEN,2013.0,1,2,-1
IRQ,SWE,2011.0,1,4,-3
SRB,HUN,2011.0,1,2,-1
JOR,CHE,2022.0,1,2,-1
KWT,SAU,2021.0,2,4,-2
LVA,SWE,2007.0,2,3,-1
CZE,CHN,2014.0,1,5,-4
NZL,BRA,2021.0,1,11,-10
SGP,ITA,2007.0,2,3,-1
DNK,HKG,2015.0,2,1,1
URY,BRA,2022.0,2,5,-3
GRC,QAT,2021.0,1,1,0
UGA,RWA,2015.0,2,1,1
FRA,SGP,1999.0,1,1,0
ZAF,CMR,2014.0,2,4,-2
PHL,AUT,2008.0,1,2,-1
TUR,BRA,2017.0,1,2,-1
USA,GMB,2003.0,2,3,-1
POL,ZAF,2002.0,1,1,0
ESP,PSE,2006.0,1,1,0
HKG,DNK,2007.0,1,1,0
HUN,GRC,2008.0,1,1,0
CZE,PHL,2022.0,1,1,0
LBY,TUR,2019.0,1,3,-2
MWI,GBR,1999.0,1,1,0
CAN,COL,2022.0,2,3,-1
ECU,COL,2011.0,1,1,0
VNM,AUT,2019.0,1,5,-4
GEO,BEL,2020.0,2,4,-2
COL,PRI,2013.0,1,1,0
AUS,BRN,2021.0,1,1,0
IND,BTN,2010.0,1,1,0
MLT,ITA,2014.0,1,1,0
BGD,ARE,2016.0,1,1,0
CHL,VEN,2009.0,1,5,-4
BHR,MYS,2017.0,1,3,-2
COL,FIN,2017.0,1,1,0
FJI,NLD,2020.0,1,1,0
CHE,SRB,2005.0,1,1,0
SAU,POL,2012.0,1,1,0
HUN,SRB,2006.0,1,1,0
FIN,ROU,2006.0,1,1,0
HUN,AZE,2021.0,1,3,-2
GBR,URY,2009.0,1,1,0
SYR,USA,2002.0,1,5,-4
MNG,DEU,2010.0,1,2,-1
BGR,BEL,2007.0,1,1,0
EST,FRA,2020.0,2,4,-2
POL,SRB,2010.0,1,1,0
GUY,GBR,2013.0,1,2,-1
JPN,GHA,2005.0,1,2,-1
THA,ITA,2011.0,1,3,-2
NLD,EST,2016.0,1,1,0
SLE,GHA,2021.0,1,1,0
ETH,SWE,2019.0,1,4,-3
NOR,JPN,2001.0,1,5,-4
NGA,ITA,2005.0,1,1,0
CHE,EGY,2003.0,1,1,0
SDN,NLD,2001.0,1,4,-3
SVN,CAN,2008.0,2,1,1
NOR,HUN,2015.0,1,1,0
TZA,KOR,2013.0,1,3,-2
CHE,KHM,2013.0,1,1,0
UKR,PRT,1998.0,1,1,0
GBR,ARM,2004.0,1,1,0
TWN,SGP,2005.0,1,4,-3
CZE,BIH,2019.0,1,1,0
NIC,CHL,2015.0,1,1,0
FRA,VEN,2017.0,1,3,-2
THA,BEL,2005.0,1,1,0
QAT,CAN,2005.0,1,4,-3
MKD,SVN,2010.0,1,1,0
NLD,ISR,2006.0,1,9,-8
DEU,NLD,2006.0,184,185,-1
TUR,GBR,2008.0,15,32,-17
FRA,BRA,2013.0,103,59,44
USA,AUS,2013.0,640,444,196
USA,ITA,2005.0,310,403,-93
ARG,USA,2002.0,119,84,35
SGP,AUS,2016.0,74,81,-7
IRL,NOR,2013.0,3,1,2
ZAF,AUS,2017.0,34,30,4
AUS,IND,2020.0,75,133,-58
JOR,ARE,2008.0,5,4,1
IRL,DEU,2020.0,33,32,1
THA,AUS,2015.0,17,43,-26
KOR,MNG,2018.0,16,5,11
ESP,ARG,2007.0,62,61,1
TUR,CAN,2016.0,20,21,-1
GBR,SGP,2008.0,58,47,11
AUS,KOR,2015.0,20,32,-12
USA,IRN,2020.0,108,461,-353
GRC,USA,2002.0,79,101,-22
DEU,EGY,2012.0,67,23,44
POL,AUS,2017.0,8,2,6
GBR,MYS,2018.0,144,89,55
GBR,PRT,2017.0,83,131,-48
DEU,CHL,2016.0,39,33,6
CAN,CHL,2015.0,19,17,2
BRA,PER,2021.0,33,12,21
CHN,TUR,2022.0,6,3,3
ISR,KOR,2010.0,3,1,2
BLR,KOR,2019.0,2,1,1
CZE,DEU,2016.0,53,51,2
USA,MWI,2016.0,19,9,10
TUR,BRA,2019.0,2,1,1
GRC,ITA,2015.0,42,22,20
FIN,IRL,2020.0,6,4,2
PHL,AUS,2020.0,15,10,5
FRA,GAB,2020.0,6,4,2
ROU,CZE,2014.0,4,1,3
IRN,BEL,2021.0,27,5,22
HUN,IND,2010.0,1,4,-3
JPN,MYS,2010.0,47,12,35
LTU,FRA,2010.0,4,1,3
ISR,KOR,2019.0,5,7,-2
BEL,IND,2015.0,22,17,5
ITA,CHN,2012.0,28,25,3
MAC,CHN,2010.0,15,24,-9
DEU,POL,2018.0,71,84,-13
NLD,DEU,2002.0,129,181,-52
DNK,THA,2017.0,2,2,0
CHL,ESP,2004.0,17,29,-12
CAN,TWN,2001.0,7,4,3
DNK,ETH,2020.0,2,1,1
NZL,PAK,2018.0,10,3,7
REU,FRA,2008.0,9,11,-2
GRC,USA,2005.0,80,89,-9
FIN,GRC,2008.0,2,1,1
ARE,DEU,2019.0,6,14,-8
DNK,AUS,2018.0,24,28,-4
POL,ZAF,2005.0,1,3,-2
ESP,TUR,2011.0,6,8,-2
IDN,IND,2014.0,5,5,0
GBR,ARG,2006.0,15,10,5
BRA,SWE,2001.0,6,5,1
SWE,POL,2020.0,17,19,-2
RUS,DEU,2001.0,159,77,82
EGY,SAU,1998.0,4,5,-1
HUN,DEU,2002.0,41,34,7
SAU,ITA,2019.0,11,13,-2
ITA,AUS,2009.0,23,8,15
UKR,JPN,2002.0,10,2,8
LUX,BEL,2002.0,3,4,-1
ITA,ESP,2001.0,58,50,8
CMR,FRA,2005.0,9,11,-2
HRV,FRA,1999.0,1,1,0
USA,LKA,2009.0,8,9,-1
VNM,TWN,2002.0,1,1,0
SWE,NOR,2000.0,17,9,8
GBR,PRI,2002.0,4,2,2
LTU,FRA,2017.0,7,2,5
MNE,SRB,2020.0,9,5,4
DEU,NGA,2012.0,6,4,2
ROU,HUN,2008.0,5,6,-1
DNK,FIN,2008.0,12,8,4
CZE,AUT,2022.0,4,9,-5
NAM,GBR,2016.0,3,1,2
NLD,TWN,2014.0,4,5,-1
ITA,ALB,2017.0,6,2,4
FRA,IND,2002.0,16,32,-16
MWI,USA,2020.0,21,29,-8
FRA,IRL,2022.0,22,15,7
RUS,VNM,2017.0,9,1,8
PAK,KEN,2020.0,4,8,-4
HUN,DEU,2005.0,39,35,4
CHE,UGA,2020.0,2,3,-1
BRA,ARG,1999.0,5,19,-14
POL,ITA,2017.0,20,22,-2
AUT,CZE,2016.0,10,16,-6
ISR,KOR,2017.0,5,2,3
CHE,MAR,2019.0,3,1,2
SYR,FRA,2009.0,2,7,-5
TZA,KEN,2018.0,7,1,6
USA,TZA,2019.0,13,19,-6
USA,BWA,2008.0,7,8,-1
CAN,QAT,2010.0,6,1,5
LTU,LVA,2012.0,1,1,0
SWE,CZE,2009.0,9,2,7
FRA,PRT,2017.0,28,47,-19
NZL,ITA,2019.0,7,3,4
ITA,CZE,2010.0,7,12,-5
DNK,BRA,2013.0,5,5,0
CZE,HRV,2012.0,1,1,0
FRA,GUF,2022.0,9,14,-5
SVK,CHE,2003.0,4,1,3
IND,BTN,2019.0,4,1,3
GBR,TZA,2000.0,2,3,-1
GBR,FIN,2000.0,12,24,-12
CAN,UKR,1998.0,2,3,-1
KWT,SVN,2018.0,1,1,0
HKG,ITA,2020.0,1,3,-2
BFA,CAN,2010.0,2,2,0
TUR,IRQ,2013.0,2,1,1
POL,JPN,2009.0,3,5,-2
BEL,RUS,2021.0,2,13,-11
TWN,SWZ,2021.0,1,1,0
TUR,ZAF,2013.0,2,1,1
CHE,KEN,2021.0,4,5,-1
PER,CHL,2011.0,4,2,2
KEN,CAN,2008.0,2,1,1
UKR,CAN,2009.0,4,3,1
CUB,COL,1998.0,3,1,2
DOM,CHL,2021.0,3,2,1
IRN,AZE,2020.0,2,2,0
SWE,PRT,2011.0,6,10,-4
UGA,GBR,2012.0,4,15,-11
IRL,JOR,2005.0,1,1,0
USA,NER,2011.0,1,1,0
CHE,MAR,2010.0,1,1,0
USA,TZA,2010.0,4,5,-1
EGY,CZE,2013.0,2,3,-1
CRI,DEU,2011.0,2,2,0
BEN,CHE,2021.0,1,3,-2
KOR,NPL,2010.0,1,3,-2
KOR,IRN,2009.0,2,2,0
POL,TUR,2010.0,1,2,-1
CHN,ZAF,2007.0,6,3,3
KEN,VNM,2019.0,1,1,0
PAK,SWE,2004.0,1,2,-1
NOR,PRT,2007.0,3,1,2
HUN,ESP,2005.0,2,2,0
CZE,KOR,2001.0,1,1,0
NPL,CAN,2013.0,2,4,-2
DZA,CAN,2009.0,2,3,-1
MYS,CHL,2016.0,1,1,0
NOR,GRC,2016.0,2,13,-11
AFG,PAK,2015.0,1,1,0
PRT,ROU,2006.0,1,2,-1
AUS,KAZ,2017.0,1,3,-2
HUN,DNK,2000.0,1,1,0
ZAF,JPN,2005.0,1,4,-3
UKR,TUR,2006.0,1,1,0
TWN,MEX,2018.0,1,2,-1
POL,TUR,2017.0,1,5,-4
ZAF,MEX,2010.0,1,1,0
USA,CRI,1998.0,1,3,-2
UKR,IND,2005.0,1,1,0
,GBR,2004.0,18564,0,18564
LTU,,2024.0,3560,0,3560
,DEU,1998.0,29362,0,29362
,TWN,2001.0,5018,0,5018
,JPN,2001.0,28477,0,28477
CHE,,2014.0,2775,0,2775
CAN,,2018.0,10998,0,10998
,UZB,1999.0,165,0,165
CZE,,2016.0,1636,0,1636
TUR,,2018.0,6674,0,6674
,ITA,1998.0,23512,0,23512
KOR,,2018.0,12935,0,12935
,URY,2001.0,164,0,164
,GBR,1996.0,11398,0,11398
,UKR,2002.0,1135,0,1135
TWN,,2016.0,6745,0,6745
USA,,2001.0,2308,0,2308
,DEU,1997.0,10727,0,10727
AUT,,1999.0,40,0,40
,ITA,1997.0,4932,0,4932
SAU,,2008.0,218,0,218
BWA,,2009.0,25,0,25
SGP,,2024.0,11938,0,11938
GRC,,2023.0,8760,0,8760
,CAN,2012.0,12307,0,12307
HUN,,2008.0,553,0,553
CUB,,2016.0,673,0,673
HKG,,2007.0,616,0,616
TUN,,2014.0,504,0,504
,MDA,2004.0,41,0,41
BGR,,2011.0,276,0,276
BEL,,2013.0,1783,0,1783
ARG,IRL,2005.0,1,0,1
,GRC,1999.0,3531,0,3531
ZAF,,2012.0,638,0,638
MAR,,2022.0,2201,0,2201
FRA,BGR,2000.0,2,0,2
PAK,,2012.0,571,0,571
,ZWE,2002.0,63,0,63
,LUX,2000.0,29,0,29
,JOR,2005.0,310,0,310
,PRT,2010.0,3141,0,3141
SVK,SLV,2012.0,1,0,1
,FRA,2016.0,12747,0,12747
MLT,,2024.0,476,0,476
,CUB,2005.0,663,0,663
,ZAF,2009.0,2014,0,2014
ECU,,2021.0,631,0,631
PAK,ESP,2008.0,2,0,2
,CUB,2002.0,590,0,590
SYR,,2023.0,341,0,341
HRV,,2013.0,561,0,561
MUS,,2023.0,105,0,105
FRA,COL,2000.0,3,0,3
LVA,,2016.0,130,0,130
,IRN,1995.0,254,0,254
IRQ,,2024.0,6380,0,6380
BIH,,2018.0,118,0,118
CMR,,2013.0,104,0,104
,NGA,2015.0,1925,0,1925
,NPL,2011.0,251,0,251
,SRB,2011.0,1503,0,1503
,IRL,2016.0,1649,0,1649
LUX,,2019.0,87,0,87
,FJI,2002.0,25,0,25
,AGO,2010.0,18,0,18
,KEN,1998.0,276,0,276
,NOR,2012.0,2009,0,2009
,EGY,2014.0,3944,0,3944
MLI,,2018.0,27,0,27
,PRT,2017.0,3146,0,3146
,ECU,2013.0,320,0,320
,SYR,2011.0,117,0,117
,ETH,2012.0,587,0,587
,UKR,2005.0,1137,0,1137
KNA,,2017.0,1,0,1
,MWI,2013.0,98,0,98
,PRT,2019.0,1874,0,1874
,BFA,2012.0,117,0,117
MLT,NLD,2021.0,2,0,2
FIN,ETH,2021.0,1,0,1
MDG,,2023.0,291,0,291
ISR,ALB,2020.0,1,0,1
,CMR,2015.0,405,0,405
BEL,MLI,2015.0,1,0,1
ALB,NGA,2016.0,1,0,1
TWN,PRT,2011.0,1,0,1
ARG,DNK,2021.0,3,0,3
,CRI,2013.0,114,0,114
LUX,,2017.0,102,0,102
PER,,2008.0,52,0,52
,MLT,2009.0,60,0,60
MEX,PRT,2008.0,4,0,4
HTI,,2023.0,87,0,87
BRB,,2021.0,17,0,17
,BIH,2014.0,207,0,207
,CYP,2008.0,116,0,116
POL,NZL,2015.0,4,0,4
,TTO,2007.0,53,0,53
DOM,,2021.0,23,0,23
,ERI,2016.0,13,0,13
,HTI,2018.0,22,0,22
ITA,IRQ,2021.0,3,0,3
CAN,KWT,2022.0,2,0,2
,AGO,2017.0,16,0,16
,CHN,2018.0,218284,0,218284
AGO,,2022.0,35,0,35
,IRQ,2015.0,1348,0,1348
KGZ,,2024.0,153,0,153
SWE,NGA,2011.0,2,0,2
AZE,,2013.0,122,0,122
,FJI,2005.0,25,0,25
,MTQ,2003.0,10,0,10
,JOR,2002.0,222,0,222
LAO,,2014.0,12,0,12
,GIN,2012.0,22,0,22
JPN,MEX,2004.0,3,0,3
MYS,,2003.0,73,0,73
GBR,PRI,2005.0,1,0,1
GBR,PAN,2009.0,1,0,1
,ZWE,2005.0,83,0,83
ITA,MAR,2000.0,1,0,1
UKR,SWE,2020.0,6,0,6
KGZ,RUS,2004.0,1,0,1
HUN,ZAF,2018.0,3,0,3
,PAK,2020.0,41,0,41
LTU,IND,2020.0,1,0,1
FRO,,2022.0,7,0,7
ZAF,AGO,2018.0,1,0,1
GMB,,2021.0,23,0,23
SEN,CAN,2018.0,2,0,2
TUR,BDI,2020.0,1,0,1
SUR,,2024.0,21,0,21
BWA,SEN,2021.0,1,0,1
NLD,LUX,2008.0,4,0,4
,GUF,2009.0,18,0,18
CUB,FRA,2021.0,1,0,1
,TJK,2007.0,7,0,7
JPN,SDN,2009.0,3,0,3
TJK,,2015.0,17,0,17
HRV,TUR,2013.0,3,0,3
CAN,LBY,2011.0,1,0,1
CHL,NLD,2005.0,3,0,3
KOR,ZMB,2022.0,1,0,1
,GRL,2002.0,4,0,4
KEN,VNM,2010.0,1,0,1
ITA,ALB,2010.0,3,0,3
SVK,SVN,2005.0,10,0,10
,CAF,2002.0,5,0,5
AUS,VNM,2008.0,8,0,8
UZB,,2002.0,19,0,19
ITA,UGA,2003.0,1,0,1
LUX,,2010.0,22,0,22
MEX,NIC,2004.0,1,0,1
,TKM,1995.0,4,0,4
,BWA,2003.0,56,0,56
ARG,AUS,2006.0,3,0,3
CZE,BEL,2008.0,5,0,5
MOZ,SWE,2001.0,2,0,2
PHL,MYS,2004.0,1,0,1
OMN,NGA,2008.0,2,0,2
,MDA,1996.0,29,0,29
TZA,,2011.0,51,0,51
MWI,,2004.0,8,0,8
,KEN,1997.0,39,0,39
CYP,CAN,2020.0,1,0,1
UZB,,2005.0,42,0,42
AUS,VUT,2018.0,2,0,2
THA,IRQ,2005.0,1,0,1
ITA,NOR,1998.0,1,0,1
SAU,PER,2010.0,1,0,1
PHL,,2004.0,31,0,31
MEX,ETH,2006.0,1,0,1
DEU,GRD,2003.0,1,0,1
NGA,ZAF,1998.0,3,0,3
ISL,ITA,2008.0,1,0,1
ECU,MCO,2007.0,2,0,2
HKG,TWN,1999.0,1,0,1
AZE,GBR,2009.0,1,0,1
COL,HUN,2020.0,1,0,1
LBR,BWA,2020.0,1,0,1
CAN,KNA,2014.0,2,0,2
CUB,PRT,2004.0,4,0,4
DNK,TZA,2007.0,2,0,2
BLR,CAN,2001.0,2,0,2
ARG,ROU,2014.0,1,0,1
MEX,CRI,2010.0,4,0,4
JOR,EGY,2008.0,3,0,3
NZL,FLK,2018.0,1,0,1
ECU,AUS,2014.0,1,0,1
,GRL,2005.0,9,0,9
EGY,AUS,2005.0,3,0,3
CAN,MUS,2013.0,1,0,1
RUS,GRC,2013.0,2,0,2
,CAF,2005.0,4,0,4
BHS,KWT,2016.0,1,0,1
GRC,NZL,2011.0,1,0,1
TWN,TUR,2014.0,1,0,1
JAM,BHS,2013.0,1,0,1
FRA,SYR,2013.0,12,0,12
NZL,ARE,2008.0,4,0,4
BRA,ROU,2003.0,1,0,1
ISR,LUX,2015.0,1,0,1
POL,ARG,2019.0,2,0,2
ECU,NZL,2019.0,1,0,1
IDN,HUN,2021.0,3,0,3
CPV,,2021.0,4,0,4
,NER,2006.0,15,0,15
HRV,PRT,2021.0,1,0,1
ALB,DEU,2021.0,2,0,2
MEX,DOM,2019.0,1,0,1
,AGO,2019.0,4,0,4
UKR,FIN,2012.0,2,0,2
SVN,ARE,2016.0,1,0,1
LUX,SVN,2012.0,1,0,1
,BRB,2008.0,6,0,6
THA,BGD,2008.0,2,0,2
BRA,TWN,2010.0,1,0,1
SLV,GBR,2018.0,1,0,1
,GUY,2012.0,7,0,7
AUT,UGA,2018.0,1,0,1
ARE,ISR,2019.0,2,0,2
GHA,CUB,2020.0,1,0,1
NZL,IRN,2003.0,1,0,1
,GHA,1995.0,15,0,15
,NAM,1999.0,26,0,26
FSM,USA,2002.0,1,0,1
KNA,,2019.0,4,0,4
BRA,NOR,1998.0,1,0,1
FJI,THA,2003.0,1,0,1
GUM,,2020.0,4,0,4
GRC,COL,2016.0,2,0,2
SWE,LBN,2006.0,1,0,1
THA,BEL,2002.0,2,0,2
SYR,SWE,2013.0,1,0,1
ZMB,RWA,2014.0,1,0,1
TCD,FRA,2011.0,1,0,1
BRA,SVK,2008.0,1,0,1
ESP,QAT,2019.0,5,0,5
LIE,,2016.0,7,0,7
BEL,EST,2013.0,1,0,1
POL,OMN,2014.0,1,0,1
IRL,JOR,2002.0,1,0,1
SGP,SRB,2012.0,1,0,1
JAM,FRA,2016.0,1,0,1
ITA,NPL,2001.0,1,0,1
EST,HKG,2016.0,1,0,1
USA,TTO,2000.0,2,0,2
MDA,CHN,2020.0,2,0,2
,MRT,2003.0,1,0,1
ITA,UZB,2022.0,1,0,1
ISL,MYS,2012.0,1,0,1
UKR,BRA,2013.0,1,0,1
ITA,ALB,2019.0,12,0,12
OMN,KOR,2021.0,5,0,5
TUR,ISR,2011.0,2,0,2
BLR,FRA,2011.0,1,0,1
,JAM,2015.0,21,0,21
TUN,RUS,2015.0,1,0,1
ZAF,BGR,2018.0,1,0,1
GRD,,2011.0,6,0,6
JPN,SVN,2009.0,2,0,2
COD,RWA,2020.0,1,0,1
GMB,USA,2017.0,5,0,5
UGA,ZWE,2017.0,1,0,1
,MCO,2007.0,4,0,4
TUN,ZAF,2014.0,2,0,2
NZL,KAZ,2011.0,1,0,1
HRV,DNK,2018.0,3,0,3
MYS,ETH,2020.0,4,0,4
PAK,NGA,2016.0,1,0,1
THA,ETH,2015.0,1,0,1
IND,KGZ,2017.0,1,0,1
KAZ,FIN,2017.0,1,0,1
ISR,EST,2019.0,2,0,2
SDN,RUS,2022.0,1,0,1
MAC,KOR,2020.0,1,0,1
KEN,AUT,2004.0,1,0,1
IND,SDN,2015.0,2,0,2
ROU,DNK,2003.0,1,0,1
MDA,EST,2010.0,2,0,2
RUS,CMR,2003.0,1,0,1
COG,,2003.0,1,0,1
,GNQ,2013.0,2,0,2
NER,,2008.0,5,0,5
TZA,KWT,2014.0,1,0,1
BWA,NAM,2012.0,1,0,1
DZA,ESP,2003.0,1,0,1
MEX,BEL,1998.0,1,0,1
HKG,PER,2003.0,1,0,1
MYS,UZB,2001.0,1,0,1
NLD,CYP,2020.0,4,0,4
SAU,FRA,2000.0,1,0,1
POL,SRB,2019.0,2,0,2
ARE,,2001.0,1,0,1
AUS,SAU,1997.0,1,0,1
DNK,ISR,1999.0,1,0,1
SWE,KOR,2001.0,4,0,4
NLD,GHA,2007.0,1,0,1
OMN,QAT,2008.0,1,0,1
CAF,,2012.0,5,0,5
CAN,KAZ,2011.0,2,0,2
IDN,COD,2010.0,1,0,1
MCO,CAN,2014.0,1,0,1
GRC,PSE,2016.0,2,0,2
,TCD,2008.0,2,0,2
FRA,OMN,2013.0,2,0,2
IRN,MAR,2018.0,1,0,1
ALB,ROU,2018.0,1,0,1
NOR,FRO,2018.0,3,0,3
NOR,HRV,2021.0,2,0,2
ZAF,MEX,2017.0,4,0,4
SVN,HUN,2007.0,1,0,1
PRT,TUN,2007.0,1,0,1
FRA,LTU,1997.0,1,0,1
CAN,SVN,2011.0,3,0,3
USA,LVA,2021.0,2,0,2
LVA,TUR,2019.0,1,0,1
DMA,,2024.0,1,0,1
GHA,BFA,2017.0,1,0,1
LUX,REU,2022.0,1,0,1
PNG,NLD,1999.0,1,0,1
BWA,CHN,2012.0,1,0,1
DEU,SLV,2014.0,1,0,1
PRI,UKR,2014.0,1,0,1
COD,,2011.0,5,0,5
UGA,AUS,2003.0,1,0,1
GRC,TWN,2003.0,1,0,1
DZA,DEU,2003.0,2,0,2
KAZ,TUR,2006.0,1,0,1
FRA,KWT,2010.0,1,0,1
,TLS,2006.0,1,0,1
ATG,,2020.0,2,0,2
CAN,NPL,2015.0,2,0,2
SLE,,2014.0,3,0,3
SVK,PRT,2018.0,1,0,1
BEL,CZE,1998.0,2,0,2
JPN,BGR,2021.0,1,0,1
GRC,IRQ,2016.0,1,0,1
IDN,JOR,2019.0,1,0,1
KWT,NGA,2020.0,1,0,1
COG,SEN,2021.0,1,0,1
NGA,CAN,2001.0,1,0,1
GBR,MNG,2000.0,1,0,1
ZAF,FSM,2002.0,1,0,1
HUN,VNM,2002.0,1,0,1
POL,IRL,2004.0,3,0,3
BEL,KHM,2016.0,2,0,2
SWE,BHR,2021.0,1,0,1
IND,UZB,2018.0,1,0,1
MAR,CZE,2021.0,1,0,1
BGR,AUT,2022.0,1,0,1
THA,ESP,2015.0,2,0,2
IND,BRN,2022.0,2,0,2
NOR,YEM,2008.0,1,0,1
CZE,SYR,2018.0,1,0,1
ITA,LBN,2004.0,1,0,1
RUS,TZA,2018.0,1,0,1
USA,NAM,2001.0,1,0,1
PRY,,2011.0,4,0,4
GRC,MKD,2008.0,1,0,1
MYS,QAT,2009.0,2,0,2
IRL,TWN,2004.0,1,0,1
CZE,MNG,2016.0,1,0,1
GMB,USA,2010.0,1,0,1
UKR,DNK,2016.0,1,0,1
HRV,AUS,2014.0,4,0,4
CUB,UGA,2021.0,1,0,1
PRI,DNK,2009.0,1,0,1
SLB,,2013.0,2,0,2
SGP,MEX,2018.0,1,0,1
CZE,ISR,2015.0,2,0,2
ISL,JPN,2016.0,1,0,1
GBR,LVA,2022.0,2,0,2
VEN,CHL,2021.0,4,0,4
LVA,UKR,2014.0,1,0,1
FRA,LTU,1998.0,2,0,2
PSE,ROU,2020.0,1,0,1
URY,RUS,2005.0,1,0,1
IRL,ROU,2005.0,2,0,2
FRA,MRT,2016.0,5,0,5
MUS,USA,2006.0,1,0,1
IRN,MYS,2005.0,1,0,1
LKA,IRL,2013.0,2,0,2
GNQ,GIN,2013.0,1,0,1
IND,MUS,2016.0,1,0,1
KOR,GRC,2004.0,1,0,1
CAN,GAB,2009.0,1,0,1
IRN,DNK,2007.0,1,0,1
BLR,LUX,2006.0,1,0,1
ISR,MLI,2006.0,1,0,1
NGA,ITA,2002.0,1,0,1
COG,ZWE,2000.0,1,0,1
VEN,PAN,2011.0,1,0,1
MYS,BEL,2001.0,1,0,1
DEU,NAM,2005.0,1,0,1
ARE,PSE,2000.0,1,0,1
COL,MYS,2013.0,2,0,2
POL,MEX,2002.0,1,0,1
BRB,USA,2008.0,2,0,2
NLD,ZMB,2009.0,1,0,1
CHL,CZE,2013.0,1,0,1
URY,IRL,2018.0,1,0,1
MTQ,PYF,2015.0,1,0,1
NGA,SWE,2022.0,4,0,4
GEO,ARM,2020.0,1,0,1
IND,BHS,2020.0,2,0,2
KOR,FRA,1997.0,1,0,1
MLT,BEL,2019.0,1,0,1
MAR,PRT,2009.0,1,0,1
AZE,KOR,2020.0,1,0,1
SWZ,,2009.0,4,0,4
ISR,GEO,2010.0,1,0,1
HKG,MYS,2006.0,2,0,2
CYP,ITA,2008.0,1,0,1
HUN,NZL,2012.0,1,0,1
SYR,YEM,2013.0,1,0,1
THA,LBY,2005.0,1,0,1
GLP,,2015.0,4,0,4
CHN,KHM,2015.0,1,0,1
ITA,JOR,2001.0,1,0,1
IRQ,GBR,1998.0,1,0,1
PNG,FRA,2000.0,1,0,1
BRN,ARE,2003.0,1,0,1
SAU,SGP,1997.0,1,0,1
MYS,JOR,2003.0,1,0,1
MEX,PER,2012.0,1,0,1
BRB,FRA,2009.0,1,0,1
GTM,FIN,2019.0,1,0,1
TZA,COG,2018.0,1,0,1
MKD,NLD,2019.0,3,0,3
GTM,,2005.0,2,0,2
GHA,GNQ,2016.0,1,0,1
NCL,PYF,2014.0,1,0,1
BHR,PHL,2018.0,1,0,1
ZAF,PSE,2015.0,1,0,1
ZMB,AUS,2018.0,1,0,1
CHL,PHL,2020.0,1,0,1
SGP,BRN,2018.0,1,0,1
AUS,BMU,2006.0,1,0,1
ITA,BIH,2012.0,1,0,1
TUN,BGR,2016.0,1,0,1
UKR,ZAF,2008.0,1,0,1
CZE,DNK,1997.0,1,0,1
NER,MLI,2020.0,2,0,2
AUS,ARE,2002.0,2,0,2
TCD,,2013.0,3,0,3
,BLZ,2001.0,5,0,5
KOR,ISR,2006.0,1,0,1
BFA,TWN,2012.0,1,0,1
BHS,AUS,2019.0,1,0,1
ITA,NOR,1997.0,1,0,1
UKR,IRQ,2014.0,1,0,1
COL,FIN,2019.0,1,0,1
ALB,IRQ,2012.0,1,0,1
CZE,CMR,2015.0,2,0,2
ITA,COL,1998.0,1,0,1
CHE,KAZ,2021.0,1,0,1
ITA,ZWE,2020.0,1,0,1
BFA,NGA,2011.0,1,0,1
GBR,MAR,2015.0,3,0,3
TWN,ROU,2011.0,1,0,1
ARM,MEX,2000.0,1,0,1
BRN,PHL,2018.0,1,0,1
AUS,TZA,2009.0,1,0,1
BOL,ECU,2008.0,1,0,1
ESP,SEN,2006.0,1,0,1
BHR,SGP,2008.0,1,0,1
PRT,SVN,2014.0,1,0,1
UGA,BEN,2020.0,1,0,1
SVN,GRC,2021.0,1,0,1
FIN,NGA,2021.0,2,0,2
BGD,MEX,2020.0,1,0,1
SWE,PRI,2006.0,1,0,1
TUR,ARE,2008.0,2,0,2
SVN,IND,2008.0,1,0,1
SRB,SGP,2007.0,1,0,1
MWI,SLE,2010.0,1,0,1
LAO,NZL,2015.0,1,0,1
NZL,KNA,2022.0,1,0,1
AUT,ROU,2022.0,3,0,3
ITA,MDG,2003.0,2,0,2
ITA,SVK,2000.0,2,0,2
KGZ,GBR,2007.0,1,0,1
GRC,EGY,2020.0,2,0,2
DEU,LBY,2007.0,1,0,1
ECU,BOL,2019.0,1,0,1
THA,SOM,2020.0,1,0,1
IDN,CAN,2009.0,2,0,2
HKG,TUR,2011.0,1,0,1
LCA,CAN,2012.0,1,0,1
MKD,NLD,2010.0,1,0,1
ZAF,MEX,2019.0,2,0,2
BGR,EGY,2019.0,1,0,1
ERI,IRQ,2012.0,1,0,1
PHL,ARE,2022.0,1,0,1
GTM,JPN,2019.0,1,0,1
PRI,CUB,2002.0,1,0,1
SRB,IND,2021.0,1,0,1
NAM,JPN,2021.0,1,0,1
MDV,JPN,2022.0,2,0,2
CMR,KOR,2022.0,1,0,1
CUB,BEL,2011.0,1,0,1
SGP,POL,2003.0,1,0,1
CUB,URY,2020.0,2,0,2
LVA,TUR,2017.0,1,0,1
MOZ,BEL,2017.0,1,0,1
SYR,QAT,2020.0,1,0,1
SWE,CMR,2020.0,1,0,1
NER,BEL,2003.0,1,0,1
MNG,NLD,2013.0,1,0,1
URY,BOL,2021.0,1,0,1
KNA,IRL,2020.0,1,0,1
GBR,BIH,2015.0,1,0,1
AUS,TWN,1998.0,1,0,1
DEU,NAM,2002.0,1,0,1
AUS,LUX,2022.0,1,0,1
LKA,BGD,2017.0,1,0,1
BEL,GMB,2018.0,2,0,2
HUN,CHN,2005.0,1,0,1
ZAF,TGO,2005.0,1,0,1
DEU,GAB,2005.0,1,0,1
KWT,LBN,2003.0,1,0,1
NER,GAB,2013.0,1,0,1
VNM,ITA,2004.0,1,0,1
THA,OMN,2011.0,2,0,2
LUX,SWE,2015.0,1,0,1
GBR,LSO,2014.0,1,0,1
RWA,SAU,2021.0,1,0,1
CAN,HTI,2014.0,1,0,1
BRA,TWN,2019.0,3,0,3
MYS,LTU,2018.0,1,0,1
AUS,MKD,2007.0,1,0,1
ZAF,KHM,2021.0,1,0,1
FIN,LAO,2018.0,1,0,1
COL,BEL,2009.0,1,0,1
LKA,UZB,2009.0,1,0,1
YEM,NLD,2020.0,1,0,1
CHE,PNG,2019.0,1,0,1
BTN,NLD,2011.0,1,0,1
NGA,NOR,2022.0,1,0,1
BHS,,2009.0,1,0,1
BGR,ISR,2006.0,1,0,1
SWE,ARE,2002.0,2,0,2
CHE,NGA,2011.0,1,0,1
NCL,USA,2004.0,1,0,1
SRB,GBR,1999.0,2,0,2
KNA,,2010.0,1,0,1
GRL,ISL,2017.0,1,0,1
ATA,GBR,2019.0,1,0,1
IRQ,CAN,2007.0,1,0,1
JPN,MWI,2008.0,1,0,1
AUS,URY,2020.0,1,0,1
JAM,CUB,2015.0,1,0,1
BIH,RUS,2020.0,1,0,1
COL,AUS,2000.0,1,0,1
PYF,JPN,2019.0,1,0,1
LIE,ITA,2019.0,1,0,1
GBR,ALB,2014.0,1,0,1
CHN,PNG,2016.0,1,0,1
GHA,EGY,2015.0,1,0,1
IND,CYP,2016.0,1,0,1
MEX,BEL,1997.0,1,0,1
VNM,MAC,2017.0,1,0,1
DZA,CZE,2017.0,1,0,1
PER,TUR,2021.0,1,0,1
PAK,VEN,2018.0,1,0,1
URY,ECU,2015.0,1,0,1
HKG,PRT,2010.0,1,0,1
GRD,ZAF,2018.0,1,0,1
KOR,KGZ,2020.0,1,0,1
TWN,BEL,2014.0,1,0,1
TZA,PAK,2008.0,1,0,1
NOR,MWI,2011.0,1,0,1
CHE,MAR,2017.0,2,0,2
IRN,IDN,2012.0,2,0,2
ZMB,DEU,2022.0,1,0,1
PER,CRI,2021.0,1,0,1
CUB,VEN,2021.0,2,0,2
SLV,AUS,2020.0,1,0,1
KEN,OMN,2019.0,1,0,1
HUN,MEX,2020.0,1,0,1
TON,FJI,2005.0,1,0,1
CRI,COL,2000.0,1,0,1
GBR,QAT,2003.0,2,0,2
NLD,SAU,2006.0,1,0,1
BFA,ZAF,2001.0,1,0,1
HKG,IRN,2003.0,1,0,1
KEN,FRA,2008.0,1,0,1
JPN,SLB,2003.0,1,0,1
PSE,ARE,2003.0,1,0,1
AUT,CYP,2009.0,1,0,1
PNG,ARE,2003.0,1,0,1
NOR,TWN,2000.0,1,0,1
FRA,ARE,2004.0,1,0,1
MNG,RUS,2006.0,1,0,1
TGO,ITA,2013.0,1,0,1
NLD,TTO,2002.0,1,0,1
TTO,CHN,2016.0,1,0,1
FIN,SVK,2021.0,1,0,1
PRI,CRI,2015.0,1,0,1
NLD,BIH,2014.0,1,0,1
TGO,USA,2020.0,1,0,1
TUR,PSE,2000.0,1,0,1
RUS,NZL,2022.0,2,0,2
,HRV,2020.0,1,0,1
UGA,FIN,2010.0,1,0,1
KEN,GHA,2004.0,1,0,1
GHA,GMB,2003.0,1,0,1
TUR,KOR,2008.0,1,0,1
LIE,GBR,2015.0,1,0,1
EGY,BEL,1999.0,1,0,1
MCO,BRA,2021.0,1,0,1
BLR,NLD,2022.0,1,0,1
AUS,CCK,2016.0,1,0,1
MOZ,BEL,2010.0,1,0,1
BEL,GRC,1999.0,1,0,1
PAK,KAZ,2018.0,1,0,1
PRT,KWT,2012.0,1,0,1
AUS,MMR,2004.0,1,0,1
VUT,FJI,2009.0,1,0,1
TWN,ARE,2018.0,1,0,1
NAM,SAU,2008.0,1,0,1
ARM,SAU,2020.0,1,0,1
BEN,JPN,2022.0,1,0,1
BEL,UZB,2014.0,1,0,1
BWA,AUS,1998.0,1,0,1
LTU,AUS,2004.0,1,0,1
FIN,MAR,2012.0,1,0,1
MYS,CMR,2009.0,1,0,1
SWE,JOR,2014.0,1,0,1
KAZ,FIN,2010.0,1,0,1
NOR,GHA,2016.0,1,0,1
SVK,BGR,2000.0,1,0,1
IDN,IRL,2012.0,1,0,1
CHL,HKG,2017.0,1,0,1
SYR,DEU,2000.0,1,0,1
SDN,SSD,2011.0,1,0,1
PAK,NLD,2006.0,1,0,1
ECU,HUN,2020.0,1,0,1
PAN,FRA,2020.0,1,0,1
BIH,MNE,2021.0,1,0,1
USA,NLD,2007.0,221,294,-73
JPN,ITA,2006.0,25,6,19
NZL,USA,2010.0,96,131,-35
GBR,BEL,2013.0,97,79,18
CHN,SWE,2010.0,61,50,11
USA,TWN,2005.0,279,172,107
SAU,RUS,2018.0,3,3,0
DEU,JPN,2011.0,105,100,5
ITA,USA,2018.0,581,356,225
USA,FRA,2007.0,579,643,-64
ITA,KOR,2012.0,8,7,1
GBR,FRA,2010.0,389,345,44
GBR,TUR,2016.0,51,43,8
KOR,USA,2008.0,610,811,-201
DEU,GBR,2006.0,484,273,211
MYS,OMN,2012.0,3,3,0
FRA,CAN,2013.0,368,218,150
RUS,AUS,2011.0,13,5,8
USA,CHN,2020.0,2985,2893,92
BRA,USA,2010.0,355,293,62
JPN,IRN,2012.0,12,11,1
FRA,TUN,2007.0,99,59,40
IRN,DNK,2008.0,4,2,2
FIN,AUS,2014.0,15,11,4
CAN,ISR,2014.0,51,45,6
NLD,GBR,2011.0,200,209,-9
IRL,CHE,2015.0,14,11,3
VEN,FRA,2012.0,5,2,3
BRA,ITA,2007.0,25,22,3
CHN,CAN,2012.0,184,223,-39
PRT,ESP,2010.0,61,47,14
CAN,USA,2006.0,1239,1349,-110
CHE,FRA,2016.0,212,397,-185
POL,DEU,2008.0,73,53,20
IND,SAU,2015.0,167,27,140
AUS,THA,2006.0,29,11,18
CHN,PHL,2007.0,3,1,2
SGP,KOR,2005.0,10,3,7
USA,AUT,2007.0,84,73,11
GBR,FRA,2017.0,359,488,-129
CHN,SWE,2019.0,87,102,-15
USA,NGA,2012.0,29,29,0
KOR,NZL,2014.0,5,4,1
FRA,GBR,2004.0,316,255,61
BRA,USA,2019.0,633,329,304
DEU,AUS,2013.0,161,113,48
USA,FIN,2021.0,44,57,-13
SWE,USA,2010.0,208,198,10
THA,USA,2008.0,98,193,-95
KEN,ZAF,2009.0,5,4,1
ITA,CHE,2004.0,75,58,17
NLD,CHE,2013.0,81,53,28
KWT,CAN,2008.0,5,8,-3
CHE,CAN,2017.0,83,115,-32
ESP,ARG,2008.0,58,64,-6
LVA,GBR,2004.0,4,5,-1
USA,TUR,1999.0,37,45,-8
TUR,DEU,2000.0,5,3,2
AUS,BGR,1998.0,3,1,2
ARE,USA,2014.0,32,83,-51
DEU,AUT,2020.0,360,285,75
BGR,GBR,2013.0,5,5,0
CHE,ESP,2007.0,39,21,18
ROU,NLD,2012.0,7,6,1
NLD,DNK,2013.0,32,13,19
USA,GBR,1999.0,493,527,-34
ROU,FRA,2006.0,20,22,-2
GBR,CHE,2009.0,184,177,7
GBR,AUT,2009.0,39,62,-23
NOR,FRA,2011.0,17,32,-15
AUS,CAN,2006.0,104,107,-3
DEU,JOR,2006.0,11,3,8
PRT,USA,2016.0,79,55,24
ITA,NZL,2015.0,7,4,3
PRT,ESP,2017.0,93,96,-3
FRA,SAU,2014.0,39,8,31
IND,FRA,2007.0,46,27,19
DZA,FRA,2016.0,36,81,-45
CHL,ARG,2016.0,12,20,-8
USA,SGP,1998.0,15,7,8
CHN,RUS,2016.0,16,12,4
SWE,USA,2017.0,220,214,6
GBR,CHL,2015.0,31,24,7
THA,GBR,2015.0,28,93,-65
ITA,DEU,2014.0,283,162,121
GBR,FRA,2019.0,444,461,-17
LKA,GBR,2017.0,10,17,-7
SWE,SGP,2009.0,7,8,-1
MYS,AUS,2018.0,131,102,29
GBR,SGP,2007.0,63,47,16
PAK,CAN,2016.0,22,23,-1
ESP,IND,2020.0,15,27,-12
GHA,USA,2020.0,34,25,9
NZL,PRT,2017.0,2,2,0
SVK,AUT,2021.0,8,6,2
NOR,NLD,2014.0,12,25,-13
BGD,GBR,2009.0,15,2,13
BRA,AUT,2014.0,9,2,7
KOR,IND,2014.0,113,177,-64
SGP,USA,2007.0,146,156,-10
ITA,IND,2015.0,42,47,-5
THA,KHM,2019.0,4,2,2
SWE,EGY,2018.0,5,7,-2
CHN,PAK,2022.0,231,126,105
CAN,IND,2004.0,18,53,-35
MEX,COL,2017.0,36,27,9
NPL,IND,2014.0,20,11,9
SWE,USA,2019.0,227,235,-8
ESP,MYS,2020.0,1,3,-2
AUS,MYS,2015.0,110,105,5
CHE,NLD,2016.0,76,83,-7
CHN,AUS,2003.0,47,46,1
GRC,CHE,2015.0,44,14,30
CHN,BEL,2015.0,34,39,-5
CHN,NOR,2007.0,8,2,6
BRA,COL,2017.0,59,55,4
USA,PAK,2022.0,35,67,-32
CHN,SWE,2017.0,86,102,-16
SAU,USA,2017.0,124,200,-76
DNK,NOR,2014.0,37,27,10
USA,ECU,2017.0,23,15,8
RUS,IND,2021.0,10,9,1
CAN,DEU,2020.0,148,164,-16
BGD,CAN,2020.0,42,22,20
USA,COL,2011.0,60,66,-6
OMN,TUN,2020.0,2,3,-1
BRA,COL,2019.0,95,50,45
FRA,ITA,1997.0,38,41,-3
HUN,USA,2012.0,57,42,15
NZL,USA,2017.0,130,102,28
PRT,HUN,2003.0,2,3,-1
HKG,CAN,2012.0,19,17,2
SVN,GBR,2017.0,14,7,7
CHE,BEL,2020.0,33,49,-16
USA,ECU,2019.0,29,13,16
DEU,HKG,2018.0,19,13,6
FRA,TUR,2018.0,13,25,-12
SAU,USA,2019.0,125,276,-151
FRA,EGY,2007.0,16,8,8
DEU,GRC,2022.0,20,23,-3
FRA,ITA,1998.0,56,48,8
TUR,NLD,2022.0,11,6,5
ITA,JPN,2018.0,31,24,7
CHE,IND,2022.0,16,15,1
GBR,LUX,2020.0,9,8,1
JPN,MMR,2016.0,6,1,5
AUS,SRB,2019.0,3,3,0
BEL,CAN,2022.0,20,14,6
DEU,BEL,2013.0,83,78,5
FRA,JPN,2022.0,32,25,7
LKA,GBR,2019.0,14,14,0
PRT,ESP,2019.0,103,107,-4
JPN,CHE,2021.0,22,25,-3
CZE,POL,2021.0,9,12,-3
IRQ,EGY,2020.0,7,9,-2
GUF,FRA,2018.0,26,26,0
DEU,RUS,2018.0,95,92,3
IRQ,HUN,2019.0,3,1,2
URY,ESP,2019.0,10,7,3
PRT,AUS,2018.0,7,3,4
DEU,HUN,2018.0,15,55,-40
MEX,COL,2019.0,46,52,-6
CHN,NZL,2021.0,31,35,-4
CHE,TUR,2018.0,14,21,-7
USA,KWT,2020.0,25,12,13
DEU,CZE,2008.0,30,28,2
AUT,GBR,2021.0,55,83,-28
NZL,USA,2019.0,114,125,-11
CHN,IRL,2022.0,18,14,4
TWN,PHL,2020.0,7,11,-4
FRA,LUX,2003.0,4,2,2
MEX,COL,2010.0,13,11,2
IND,CHE,2016.0,39,30,9
CHN,IDN,2015.0,2,1,1
IRN,ITA,2022.0,43,4,39
USA,TWN,2002.0,236,164,72
AUS,SGP,2004.0,26,25,1
POL,SVN,2021.0,1,1,0
SWE,CHN,2018.0,90,94,-4
SAU,MYS,2022.0,9,14,-5
AUS,KOR,2004.0,13,5,8
IND,IDN,2019.0,8,3,5
CHE,CAN,2010.0,74,91,-17
USA,BGR,2005.0,13,20,-7
RUS,NOR,2010.0,14,7,7
USA,SWE,2003.0,208,237,-29
MYS,IDN,2011.0,15,12,3
ESP,CZE,2008.0,2,6,-4
CHN,FIN,2007.0,8,6,2
CAN,EGY,2014.0,44,30,14
IND,CAN,2007.0,86,31,55
IRL,USA,2012.0,171,113,58
IND,MEX,2008.0,2,2,0
BEL,USA,2009.0,125,106,19
ROU,USA,2014.0,18,13,5
NPL,JPN,2010.0,2,3,-1
FIN,ESP,2009.0,9,9,0
DNK,GBR,2012.0,54,72,-18
BGR,NLD,2007.0,5,1,4
ITA,BRA,2003.0,24,16,8
LKA,CAN,2006.0,6,1,5
SRB,MKD,2014.0,2,3,-1
URY,ESP,2010.0,5,18,-13
IDN,MEX,2017.0,1,1,0
SGP,FRA,2003.0,3,1,2
HKG,MAC,2017.0,10,3,7
KOR,NLD,2014.0,10,5,5
FRA,CMR,2021.0,13,9,4
KOR,CHE,2021.0,15,14,1
NGA,USA,2012.0,29,29,0
NPL,JPN,2019.0,4,12,-8
CAN,GBR,2001.0,147,188,-41
CUB,MEX,2016.0,27,3,24
AUS,PHL,2021.0,5,9,-4
ARG,COL,2012.0,7,10,-3
CHN,THA,2022.0,23,14,9
KOR,SAU,2012.0,10,2,8
CHN,ITA,2016.0,34,47,-13
FIN,POL,2009.0,3,5,-2
CZE,GBR,2002.0,28,22,6
NLD,FRA,2003.0,78,80,-2
GBR,ISR,2003.0,18,38,-20
CZE,BGR,2018.0,2,1,1
DEU,FRA,1997.0,55,44,11
PHL,HKG,2020.0,3,3,0
SGP,HKG,2022.0,30,20,10
DEU,COL,2021.0,13,18,-5
HKG,FRA,2018.0,8,10,-2
MEX,JPN,2017.0,12,5,7
DEU,FRA,1998.0,67,77,-10
MEX,ARG,2014.0,18,14,4
RUS,GBR,2009.0,42,27,15
JPN,HUN,2017.0,4,3,1
PAK,ARE,2022.0,10,7,3
FRA,SRB,2019.0,7,8,-1
AUT,CAN,2020.0,19,9,10
GBR,TWN,2018.0,28,24,4
SAU,BGD,2017.0,3,3,0
CZE,NLD,2016.0,10,10,0
SWE,NZL,2015.0,9,11,-2
AZE,DEU,2018.0,3,2,1
TWN,CHE,2010.0,7,2,5
DEU,LTU,2019.0,8,12,-4
CHN,TWN,2002.0,26,33,-7
UKR,KAZ,2020.0,2,3,-1
GRC,SWE,2016.0,22,7,15
CHE,ROU,2017.0,5,7,-2
MYS,ITA,2018.0,5,3,2
SYR,GBR,2019.0,3,1,2
IRQ,USA,2022.0,7,14,-7
IRN,NZL,2018.0,25,2,23
IND,ITA,1998.0,6,4,2
IND,IRL,2016.0,21,11,10
NLD,CHN,2006.0,28,20,8
JPN,SGP,2021.0,14,21,-7
MEX,IND,2022.0,11,2,9
FJI,AUS,2021.0,6,7,-1
BGR,BEL,2008.0,3,1,2
GBR,THA,2007.0,34,25,9
AUS,IRL,2011.0,24,36,-12
ARG,BRA,2013.0,24,20,4
AUS,FIN,2003.0,8,11,-3
ITA,FRA,2003.0,155,159,-4
BLR,DEU,2012.0,5,1,4
CHE,CAN,2019.0,88,106,-18
BRA,CUB,2016.0,7,27,-20
PER,USA,2007.0,29,22,7
RUS,FIN,2009.0,14,9,5
HRV,NLD,2014.0,5,2,3
JPN,UGA,2012.0,2,1,1
SWE,BRA,2006.0,7,3,4
CHE,GRC,2005.0,15,6,9
EGY,FRA,2003.0,2,6,-4
VEN,BRA,2021.0,9,6,3
SRB,HRV,2006.0,3,8,-5
POL,RUS,2014.0,11,11,0
CHE,SWE,2004.0,17,22,-5
ITA,IRL,2002.0,8,7,1
ITA,DNK,2012.0,24,21,3
COL,CRI,2014.0,2,2,0
LKA,GBR,2010.0,13,4,9
ZWE,ZAF,2011.0,14,6,8
BRA,PRT,2005.0,29,31,-2
ISR,AUS,2009.0,23,8,15
NER,FRA,2017.0,2,3,-1
SRB,USA,2004.0,14,11,3
ZWE,BWA,2020.0,3,1,2
GBR,LBN,2004.0,7,6,1
SAU,TUN,2016.0,20,64,-44
FIN,DNK,2003.0,14,9,5
DNK,HRV,2021.0,2,1,1
SVN,GBR,2010.0,4,4,0
JPN,DEU,2003.0,103,69,34
TUR,AUT,2005.0,3,2,1
BRA,PRT,2002.0,25,16,9
IND,MYS,2004.0,9,8,1
KEN,CMR,2021.0,1,3,-2
CAN,DZA,2009.0,3,2,1
SWE,THA,2003.0,8,1,7
AUS,NOR,2005.0,12,5,7
SAU,NGA,2003.0,3,2,1
BEN,FRA,2011.0,8,15,-7
JPN,BRA,2002.0,14,12,2
GRC,DNK,2013.0,10,5,5
USA,IDN,2001.0,13,7,6
IRN,USA,2003.0,23,32,-9
SAU,BGD,2019.0,7,5,2
MAR,USA,2003.0,2,9,-7
AUT,ITA,2004.0,17,14,3
AUT,NLD,2006.0,8,11,-3
TUR,GBR,2007.0,14,23,-9
AUS,LKA,2012.0,10,16,-6
POL,FIN,2002.0,1,6,-5
CAN,ITA,2000.0,6,7,-1
FRA,NER,2009.0,5,5,0
USA,SYR,2004.0,5,1,4
ISR,GBR,2003.0,38,18,20
PRT,ZAF,2003.0,1,4,-3
MCO,FRA,2005.0,2,3,-1
EST,NOR,2021.0,2,1,1
GEO,USA,2018.0,17,13,4
CAN,CHL,2004.0,7,10,-3
FRA,CIV,2006.0,16,19,-3
USA,PHL,2006.0,17,15,2
SWE,AUT,2008.0,14,6,8
UKR,POL,2003.0,22,11,11
DEU,ARG,2004.0,8,21,-13
ISR,RUS,2005.0,10,13,-3
AZE,IRN,2011.0,12,3,9
KEN,GBR,2008.0,12,10,2
TZA,GBR,2007.0,4,5,-1
GBR,BRA,1997.0,10,2,8
DNK,CAN,2006.0,19,13,6
USA,HRV,2010.0,23,16,7
PRT,DEU,1999.0,5,6,-1
CHE,GRC,2002.0,13,7,6
ROU,HUN,2007.0,3,2,1
BEL,COG,2016.0,9,5,4
ARE,EGY,2018.0,6,21,-15
PAK,DEU,2003.0,2,3,-1
FIN,NOR,2000.0,1,3,-2
DEU,HRV,2008.0,15,5,10
CAN,TUR,2001.0,6,10,-4
GBR,UKR,2004.0,7,7,0
BRA,PAN,2006.0,1,2,-1
ISR,SWE,2002.0,4,2,2
JPN,COL,2013.0,3,1,2
ESP,SRB,2002.0,4,2,2
SRB,ESP,2004.0,6,2,4
SWE,AUS,1999.0,8,15,-7
CIV,BFA,2020.0,1,3,-2
PHL,SGP,2011.0,1,1,0
UZB,RUS,2015.0,5,4,1
ISR,RUS,2002.0,8,14,-6
TWN,ISR,2012.0,2,1,1
TWN,JPN,2005.0,15,23,-8
CAN,NZL,2003.0,27,28,-1
ESP,AND,2009.0,4,1,3
USA,PRI,2013.0,48,97,-49
CAN,ESP,2003.0,15,14,1
BEL,AUS,2016.0,43,25,18
DNK,ITA,2011.0,11,38,-27
GBR,TTO,2008.0,6,2,4
ZAF,SGP,2021.0,1,1,0
AUS,IRN,2003.0,7,2,5
JPN,ISR,2009.0,6,3,3
CHN,IRN,2007.0,3,2,1
CAN,LBN,2018.0,10,10,0
JOR,EGY,2007.0,2,1,1
CYP,TUR,2005.0,3,4,-1
USA,HRV,2017.0,14,10,4
DEU,PRT,2001.0,5,5,0
PHL,USA,2007.0,14,16,-2
RUS,PRT,2006.0,10,8,2
PAK,AUS,2013.0,22,11,11
ISR,FRA,2008.0,24,11,13
AUT,GRC,2021.0,5,3,2
MEX,VEN,2001.0,2,2,0
ZAF,DEU,2006.0,10,21,-11
VNM,JPN,2012.0,15,28,-13
TUR,BEL,2018.0,9,10,-1
CZE,BEL,2007.0,1,3,-2
ARE,GBR,2015.0,10,43,-33
ROU,MDA,2021.0,2,1,1
HUN,ROU,2011.0,4,3,1
PAK,CHE,2011.0,3,2,1
CAN,MAR,2012.0,10,5,5
BEL,IRL,2022.0,7,7,0
GBR,TUN,2018.0,6,4,2
DNK,GRL,2017.0,5,3,2
SWE,GRC,2011.0,4,16,-12
SWE,BEL,2012.0,12,15,-3
PHL,JPN,2012.0,12,19,-7
HKG,MAC,2010.0,5,4,1
GAB,DEU,2019.0,4,2,2
NPL,USA,2014.0,17,15,2
KOR,ARE,2021.0,10,4,6
NOR,AUS,2012.0,14,17,-3
NZL,SWE,2021.0,8,5,3
ARE,MAR,2017.0,2,2,0
HKG,MAC,2019.0,11,4,7
NOR,ITA,2003.0,7,9,-2
BEL,CHL,2016.0,8,6,2
RWA,USA,2014.0,7,14,-7
ARG,URY,2019.0,9,9,0
PRT,IRN,2013.0,2,12,-10
LBN,GBR,2018.0,8,10,-2
NLD,HKG,2021.0,7,5,2
LBY,GBR,2014.0,4,14,-10
ZAF,ETH,2011.0,5,6,-1
ARG,BEL,2019.0,3,5,-2
HRV,USA,2021.0,12,10,2
SVK,SWE,2016.0,4,2,2
RUS,KOR,2011.0,15,13,2
ECU,CHL,2015.0,2,8,-6
NZL,NOR,2019.0,6,6,0
MYS,AUT,2015.0,1,1,0
PHL,IDN,2009.0,1,1,0
ISL,USA,2011.0,5,11,-6
SVN,SWE,2020.0,5,3,2
MEX,JPN,2019.0,4,5,-1
PAK,SWE,2015.0,5,15,-10
JPN,SRB,2020.0,1,1,0
BEL,ESP,2008.0,21,38,-17
ETH,ZAF,2022.0,2,3,-1
TUR,IND,2016.0,4,12,-8
ZAF,RWA,2017.0,6,1,5
GAB,DEU,2017.0,6,2,4
SVN,GBR,2019.0,9,9,0
PRI,GBR,2017.0,2,1,1
QAT,JOR,2014.0,3,7,-4
HKG,ESP,2019.0,2,2,0
HUN,ITA,2009.0,14,5,9
CHN,ETH,2019.0,12,12,0
HKG,PAK,2020.0,9,6,3
GRC,ISR,2016.0,3,4,-1
MOZ,ESP,2020.0,1,2,-1
BGD,NLD,2021.0,2,5,-3
BEL,CIV,2012.0,4,1,3
GBR,OMN,2016.0,11,6,5
NPL,KOR,2021.0,3,4,-1
IRL,BEL,2021.0,10,9,1
HUN,QAT,2019.0,1,2,-1
RUS,NOR,2019.0,5,9,-4
EGY,JPN,2020.0,17,41,-24
URY,ESP,2017.0,7,15,-8
SRB,BIH,2014.0,11,11,0
AUS,OMN,2008.0,3,3,0
NOR,GBR,2001.0,22,27,-5
CAN,CYP,2012.0,2,1,1
NLD,FIN,2006.0,11,7,4
POL,CHE,1998.0,8,5,3
JPN,HUN,2019.0,2,9,-7
GBR,ISL,2006.0,6,7,-1
ISL,ESP,2018.0,4,2,2
THA,JPN,2007.0,31,64,-33
PRT,POL,1997.0,2,1,1
HUN,GBR,2004.0,18,17,1
CHL,MEX,2012.0,12,8,4
ZAF,RWA,2010.0,1,2,-1
NOR,RUS,2003.0,11,7,4
CUB,SWE,2002.0,1,2,-1
TUN,ESP,2018.0,3,3,0
FRA,ARE,2015.0,23,4,19
NOR,PAK,2013.0,6,3,3
SWE,NPL,2021.0,1,2,-1
DNK,GRL,2019.0,6,3,3
OMN,SDN,2014.0,1,1,0
PAK,ESP,2007.0,1,1,0
SWE,HUN,2003.0,13,7,6
ARG,ESP,2013.0,44,63,-19
JPN,NLD,2016.0,16,26,-10
GBR,VNM,2007.0,4,3,1
GBR,EGY,2005.0,19,3,16
LKA,NZL,2014.0,1,2,-1
SVK,HUN,2012.0,3,4,-1
KHM,USA,2019.0,7,1,6
ARG,URY,2017.0,9,9,0
KEN,IND,2018.0,4,8,-4
EGY,ARE,2011.0,10,7,3
PRT,CHE,2008.0,10,6,4
ITA,IRN,2013.0,11,32,-21
POL,SGP,2020.0,2,4,-2
IRL,IND,2014.0,16,15,1
TUR,CHE,2008.0,3,2,1
AUT,SVN,2018.0,5,6,-1
BGD,DEU,2018.0,6,7,-1
MYS,IRN,2022.0,12,7,5
DEU,LTU,2017.0,4,7,-3
CAN,IRQ,2020.0,5,5,0
EGY,ITA,2020.0,7,18,-11
CHN,LKA,2017.0,4,1,3
FRA,IRN,2007.0,12,8,4
SRB,CHE,2014.0,3,3,0
IND,QAT,2021.0,6,4,2
ECU,VEN,2021.0,11,11,0
CHE,JOR,2018.0,2,1,1
ZWE,USA,2021.0,3,2,1
TZA,USA,2020.0,20,16,4
PRT,FRA,2000.0,8,8,0
JPN,GRC,2005.0,3,3,0
UKR,AUT,2009.0,3,1,2
ZAF,VNM,2021.0,1,5,-4
THA,AUS,2004.0,7,19,-12
IND,PAK,2007.0,13,6,7
TUN,GBR,2021.0,2,1,1
DEU,LTU,2010.0,6,4,2
CMR,SWE,2016.0,1,1,0
FIN,BLR,2003.0,3,1,2
JPN,BRA,2005.0,8,6,2
TUR,RUS,2005.0,4,5,-1
RUS,POL,2008.0,10,8,2
CAN,HUN,2020.0,6,5,1
HUN,FRA,2006.0,10,4,6
DEU,SRB,2003.0,6,8,-2
POL,BRA,2002.0,1,1,0
NLD,BEL,1997.0,14,11,3
SWE,DEU,1998.0,14,20,-6
SWE,HRV,2013.0,1,3,-2
CAN,ZAF,2006.0,11,13,-2
ESP,NOR,2001.0,7,3,4
NLD,ZWE,2013.0,3,3,0
KOR,ITA,2001.0,1,2,-1
CHN,CHE,2001.0,15,9,6
DNK,IND,2001.0,3,2,1
HKG,DEU,2001.0,2,4,-2
GBR,KWT,2004.0,5,4,1
GRC,ITA,2004.0,11,15,-4
BGR,TUR,2011.0,2,1,1
BOL,BEL,2008.0,1,1,0
NGA,CMR,2009.0,2,1,1
KGZ,RUS,2015.0,7,3,4
TWN,AZE,2015.0,1,1,0
BRA,COL,2010.0,17,13,4
NPL,THA,2006.0,1,2,-1
SWE,ISR,2013.0,4,2,2
ARG,URY,2010.0,3,2,1
ARE,IND,2007.0,4,6,-2
ETH,NLD,2011.0,3,1,2
KOR,GRC,2015.0,3,4,-1
GUM,USA,2011.0,1,6,-5
CAN,ECU,2021.0,2,4,-2
FRA,TGO,2009.0,4,6,-2
NOR,CHE,2013.0,5,19,-14
FRA,LVA,2014.0,2,2,0
CHE,NZL,2013.0,12,18,-6
BGR,DNK,2012.0,2,1,1
CZE,FRA,2000.0,4,8,-4
DEU,ETH,2015.0,8,7,1
BEL,DEU,1999.0,16,31,-15
FRA,MEX,1998.0,7,5,2
SVN,SVK,2006.0,5,5,0
AUS,IRQ,2021.0,14,8,6
KHM,FRA,2006.0,3,1,2
TUR,ARG,2018.0,2,1,1
PAK,KHM,2020.0,1,2,-1
UZB,KOR,2008.0,2,1,1
TWN,IND,2001.0,6,20,-14
CHE,BRA,2006.0,7,6,1
AUT,SVK,2007.0,3,8,-5
HTI,USA,2005.0,1,2,-1
AUS,GRC,2005.0,1,1,0
CRI,ESP,2005.0,3,2,1
CHN,TWN,2005.0,16,30,-14
ETH,CAN,2010.0,1,2,-1
FIN,FRA,2006.0,11,5,6
BEL,POL,2001.0,5,7,-2
THA,PAK,2022.0,5,3,2
LBN,EGY,2014.0,2,6,-4
CHE,EST,2021.0,2,2,0
SWE,LTU,2015.0,4,4,0
TWN,CHE,2019.0,11,8,3
CZE,IRL,2014.0,3,1,2
SWE,ARG,2017.0,3,4,-1
KHM,USA,2017.0,8,8,0
NZL,FIN,2020.0,3,1,2
OMN,USA,2011.0,8,7,1
SWE,IRN,2009.0,14,6,8
ARG,SWE,2012.0,4,1,3
DNK,PRT,2011.0,4,4,0
BEL,ZMB,2006.0,2,2,0
RUS,BEL,2011.0,5,3,2
PRI,USA,1997.0,4,2,2
CHE,ROU,2010.0,8,4,4
DNK,TWN,2019.0,2,2,0
BRA,ECU,2007.0,3,1,2
TUN,QAT,2018.0,4,3,1
DEU,OMN,2015.0,3,2,1
BFA,CHE,2012.0,1,1,0
ARE,MAR,2019.0,4,1,3
PRT,IND,2021.0,6,8,-2
NZL,NOR,2017.0,7,1,6
LUX,CHN,2019.0,1,3,-2
PHL,CAN,2018.0,4,4,0
TUR,ITA,2016.0,8,11,-3
SGP,NZL,2021.0,8,6,2
PAK,NOR,2017.0,2,3,-1
PHL,CHN,2013.0,2,1,1
ARG,ITA,1999.0,11,5,6
LTU,ITA,2018.0,3,6,-3
BFA,FRA,2014.0,10,18,-8
PHL,TWN,2022.0,4,3,1
GBR,JAM,2017.0,2,1,1
TUN,BEL,2021.0,2,6,-4
HKG,CHE,2020.0,10,2,8
HUN,NLD,2007.0,6,7,-1
ARE,SDN,2020.0,2,3,-1
IDN,NOR,2021.0,1,1,0
CHE,HUN,2021.0,10,11,-1
IRN,ISL,2020.0,4,1,3
TUN,ARE,2013.0,3,1,2
ITA,IRL,2005.0,9,6,3
ITA,LTU,2002.0,1,3,-2
CHL,COL,2006.0,5,2,3
SVK,JPN,2007.0,2,1,1
DEU,LBY,2008.0,2,1,1
MCO,FRA,2002.0,1,5,-4
LTU,SWE,2001.0,10,2,8
LUX,CHN,2017.0,3,2,1
FRA,PYF,2007.0,3,4,-1
COG,ZAF,2018.0,1,1,0
CMR,BEL,2001.0,1,1,0
BRA,URY,2022.0,5,2,3
UKR,BLR,2010.0,6,1,5
BRA,CAN,1997.0,8,2,6
QAT,USA,2006.0,1,9,-8
CHN,ISR,2001.0,3,5,-2
IND,ITA,1997.0,3,6,-3
MEX,CHL,2008.0,9,5,4
IND,KEN,2001.0,1,1,0
AUS,VNM,2007.0,6,2,4
SEN,CMR,2015.0,1,1,0
JOR,DEU,2009.0,6,8,-2
CHE,PAK,2005.0,1,1,0
TTO,JAM,2017.0,1,4,-3
RUS,TWN,2013.0,2,2,0
SGP,VNM,2012.0,2,3,-1
ROU,RUS,2012.0,1,1,0
CHE,ROU,2019.0,5,6,-1
GBR,SEN,2009.0,1,1,0
DNK,PAK,2020.0,6,8,-2
NZL,CHL,2013.0,1,6,-5
ECU,BEL,2012.0,2,1,1
MYS,TUR,2016.0,4,1,3
LUX,USA,2022.0,4,3,1
SRB,FRA,2006.0,3,2,1
HKG,ESP,2017.0,1,4,-3
ROU,GRC,2014.0,1,3,-2
NGA,THA,2012.0,1,1,0
RUS,ISR,2022.0,10,2,8
PAK,KWT,2020.0,2,1,1
IDN,MEX,2019.0,1,1,0
BGD,PAK,2021.0,6,2,4
GRC,TUR,2007.0,2,2,0
BEL,MAR,2007.0,4,1,3
POL,BLR,2000.0,1,1,0
IRL,NZL,2009.0,6,4,2
DZA,BEL,2014.0,2,4,-2
BEL,TUR,2013.0,5,7,-2
CRI,MEX,2018.0,4,8,-4
FRA,TWN,2022.0,3,8,-5
GBR,JOR,2022.0,10,5,5
CAN,EST,2003.0,2,1,1
THA,IND,2008.0,4,3,1
NOR,COL,2017.0,3,1,2
ARM,RUS,2001.0,3,2,1
LBN,BEL,2012.0,1,4,-3
CZE,SVN,2020.0,1,2,-1
IRN,GBR,2001.0,5,23,-18
FRA,SRB,2010.0,2,2,0
CUB,SWE,2005.0,1,1,0
KEN,TZA,2016.0,6,1,5
SVN,USA,2001.0,7,3,4
POL,HUN,2012.0,2,7,-5
CZE,ITA,2020.0,13,29,-16
ARM,EST,2016.0,1,1,0
USA,HRV,2019.0,6,23,-17
UKR,NLD,2001.0,2,2,0
SYR,GBR,2017.0,8,2,6
RWA,GBR,2021.0,2,2,0
EST,CHE,2017.0,4,1,3
SWE,ARG,2010.0,1,2,-1
KEN,SWE,2016.0,4,3,1
NZL,PRT,2019.0,4,3,1
VNM,BEL,2021.0,2,12,-10
KHM,USA,2010.0,3,3,0
MLT,USA,2016.0,1,1,0
CUB,USA,1999.0,2,1,1
FRA,BFA,2022.0,2,3,-1
POL,BGR,2006.0,1,4,-3
DEU,BOL,2013.0,1,1,0
NZL,NOR,2010.0,4,1,3
UGA,ZAF,2012.0,4,7,-3
KEN,BEN,2021.0,1,1,0
IRL,GHA,2018.0,1,1,0
TTO,JAM,2019.0,2,4,-2
BGR,GRC,2020.0,2,2,0
USA,ECU,2010.0,8,19,-11
NZL,ARE,2007.0,1,1,0
BGD,THA,2001.0,1,3,-2
MEX,JPN,2010.0,5,5,0
NOR,TUR,2013.0,2,3,-1
PRT,SWE,2012.0,6,7,-1
MEX,CZE,2012.0,3,1,2
BWA,GBR,2011.0,2,3,-1
COL,DNK,2016.0,2,4,-2
NLD,ISL,2013.0,1,1,0
COL,SWE,2017.0,2,3,-1
HRV,CHN,2020.0,1,1,0
ARE,DZA,2014.0,1,2,-1
CZE,IRN,2012.0,2,1,1
MYS,KEN,2020.0,1,2,-1
ITA,SMR,2018.0,3,3,0
ROU,GBR,1999.0,2,3,-1
TZA,CHN,2022.0,3,3,0
FRA,COG,1998.0,3,1,2
HKG,BLR,2003.0,1,1,0
USA,BIH,2008.0,3,1,2
BRA,CHL,2003.0,5,4,1
SGP,BEL,2017.0,4,6,-2
ISL,POL,2018.0,2,1,1
ETH,CAN,2017.0,2,1,1
THA,IDN,2009.0,2,2,0
COG,COD,2003.0,2,2,0
TUN,CAN,2013.0,7,8,-1
CHE,ARG,2014.0,3,6,-3
HUN,SGP,2004.0,3,1,2
DEU,DZA,2006.0,4,3,1
ARE,SAU,2006.0,1,5,-4
NLD,GEO,2018.0,2,1,1
IDN,FRA,2021.0,2,6,-4
UKR,MDA,2004.0,2,2,0
AUS,HUN,2012.0,1,3,-2
NLD,LUX,2007.0,2,1,1
LTU,DNK,2006.0,3,1,2
POL,CHE,1997.0,3,4,-1
DEU,ECU,2011.0,3,1,2
DNK,FIN,2007.0,5,7,-2
JPN,HKG,2005.0,4,4,0
TUR,AUT,2002.0,4,6,-2
POL,IRL,2015.0,4,4,0
BGD,DNK,2012.0,2,1,1
ITA,LUX,2009.0,4,1,3
RUS,IRL,2013.0,3,4,-1
DNK,ZAF,2022.0,1,2,-1
PAK,NOR,2019.0,3,1,2
CHN,SVN,2011.0,2,2,0
CHN,IND,2008.0,3,6,-3
KEN,GHA,2015.0,2,1,1
NPL,JPN,2017.0,1,14,-13
ETH,CAN,2019.0,6,7,-1
ECU,CRI,2018.0,1,1,0
GRC,ROU,2014.0,3,1,2
NOR,ZMB,2004.0,1,1,0
URY,DEU,2002.0,1,1,0
SVN,IRL,2006.0,1,1,0
JPN,HUN,2010.0,3,5,-2
AUT,UKR,1999.0,1,1,0
CAN,SVK,2014.0,2,5,-3
TUR,ARE,2007.0,3,1,2
SGP,KOR,2002.0,3,5,-2
AUT,HRV,2022.0,2,4,-2
JOR,ARE,2007.0,6,4,2
PRY,ARG,2017.0,2,2,0
GBR,LBY,2005.0,2,1,1
NZL,CHE,2001.0,3,1,2
PRT,COL,2007.0,1,1,0
TUR,PAK,2009.0,1,3,-2
CHE,LUX,2014.0,4,5,-1
SLE,USA,2022.0,2,1,1
USA,ZMB,2008.0,5,1,4
DNK,CZE,2012.0,1,3,-2
POL,HRV,2013.0,3,15,-12
NGA,TWN,2016.0,1,1,0
CMR,DEU,2014.0,2,9,-7
VEN,COL,2006.0,2,6,-4
CHN,LKA,2019.0,4,4,0
USA,MOZ,2018.0,2,4,-2
EST,GEO,2020.0,1,1,0
RUS,IRQ,2017.0,5,1,4
ITA,CMR,2018.0,2,1,1
GBR,EST,2006.0,1,4,-3
NPL,NOR,2014.0,2,4,-2
IRQ,POL,2018.0,1,1,0
UGA,NOR,2021.0,2,2,0
PHL,NZL,2012.0,1,1,0
CAN,LKA,2011.0,3,2,1
HKG,ESP,2010.0,2,1,1
GHA,NGA,2011.0,2,3,-1
TWN,CHE,2017.0,9,4,5
BRA,GHA,2015.0,1,1,0
POL,GRC,2022.0,2,1,1
COD,USA,2022.0,3,1,2
EST,RUS,2022.0,1,2,-1
SGP,MAC,2019.0,1,4,-3
NAM,USA,2014.0,2,1,1
GBR,ETH,2011.0,4,6,-2
POL,LTU,2017.0,1,1,0
TWN,IRN,2018.0,1,5,-4
KOR,RWA,2022.0,2,1,1
FIN,ZAF,2017.0,3,1,2
FRA,SRB,2017.0,3,10,-7
BEL,UKR,2002.0,2,5,-3
PAK,BEL,2013.0,1,4,-3
DNK,AUT,2002.0,6,4,2
AUT,KOR,2009.0,2,4,-2
USA,FRO,2011.0,1,1,0
ECU,GBR,2005.0,1,3,-2
COL,SWE,2010.0,3,1,2
MLI,BEN,2020.0,1,1,0
MNG,GBR,2015.0,1,2,-1
ZAF,TZA,2022.0,2,4,-2
BEL,NZL,2021.0,1,2,-1
CHN,CZE,2013.0,2,2,0
NGA,CHN,2011.0,4,4,0
BOL,GBR,2022.0,1,1,0
GHA,ETH,2019.0,1,1,0
UGA,ITA,2009.0,1,1,0
NLD,UKR,2002.0,1,4,-3
ESP,MAR,1999.0,1,2,-1
SVN,SRB,2009.0,1,4,-3
FRA,MCO,1999.0,1,1,0
UGA,MYS,2017.0,1,2,-1
NPL,TUR,2018.0,1,1,0
FIN,BEL,2006.0,2,4,-2
COL,PAN,2022.0,1,1,0
DOM,USA,2014.0,1,4,-3
DEU,MLI,2014.0,1,1,0
ARG,BEL,2017.0,2,2,0
IRL,ZAF,2007.0,2,6,-4
BFA,BEL,2012.0,2,1,1
EST,DEU,2007.0,1,6,-5
CUB,PRT,2015.0,1,1,0
FIN,LTU,2022.0,1,1,0
EGY,NLD,2012.0,2,3,-1
CZE,PAK,2016.0,1,3,-2
VNM,ITA,2015.0,2,2,0
TWN,SWE,2021.0,4,6,-2
KOR,BLR,2013.0,1,1,0
PRT,AUT,2008.0,1,3,-2
AUS,NOR,2002.0,4,9,-5
NLD,VNM,2005.0,2,1,1
URY,ITA,2019.0,1,2,-1
ZAF,FRA,2000.0,3,5,-2
SWE,SAU,2010.0,2,1,1
MKD,DEU,2022.0,1,1,0
AUS,GRC,2002.0,2,1,1
BRA,NGA,2007.0,1,1,0
TWN,COL,2019.0,1,1,0
ITA,CYP,2014.0,3,2,1
CHE,LIE,2006.0,1,1,0
DNK,ISL,2006.0,2,5,-3
DZA,ARG,2009.0,1,1,0
SYR,GBR,2010.0,2,3,-1
NZL,BEL,2020.0,3,2,1
DEU,BLR,2003.0,3,14,-11
CHN,ZAF,2008.0,2,7,-5
IRN,FIN,2003.0,1,1,0
CHN,COL,2020.0,1,1,0
ISR,ARG,2021.0,1,1,0
COG,CMR,2015.0,2,1,1
FIN,ZAF,2019.0,1,4,-3
MWI,FIN,2015.0,1,2,-1
FIN,CHN,1998.0,1,1,0
EGY,LTU,2020.0,1,1,0
PAK,BRA,2022.0,2,4,-2
ARG,PRY,2012.0,2,3,-1
SVK,KWT,2003.0,1,2,-1
TZA,DNK,2015.0,1,2,-1
BEN,ITA,2012.0,1,2,-1
POL,TWN,2005.0,1,1,0
GUF,SEN,2001.0,1,1,0
FRA,CUB,2017.0,2,7,-5
MEX,PRT,2007.0,1,4,-3
CHN,DZA,2016.0,1,1,0
CHN,ETH,2017.0,1,10,-9
GBR,VEN,2018.0,1,4,-3
MEX,IRL,1998.0,1,1,0
SGP,IRL,2007.0,1,1,0
SGP,FIN,2011.0,1,4,-3
DNK,TUR,2005.0,1,1,0
EGY,ESP,2005.0,1,5,-4
PER,CHE,2009.0,2,1,1
MDA,FRA,2013.0,1,2,-1
PER,COL,2012.0,1,3,-2
NER,BFA,2016.0,1,1,0
CZE,MEX,2022.0,2,4,-2
SGP,LUX,2022.0,1,1,0
SVK,NZL,2018.0,1,2,-1
UKR,KOR,2004.0,3,3,0
IRN,EGY,2013.0,1,2,-1
BFA,GBR,2021.0,1,3,-2
AUS,SRB,2017.0,1,1,0
BWA,KEN,2021.0,1,1,0
HUN,IRQ,2019.0,1,3,-2
NCL,USA,2015.0,1,1,0
TUR,RUS,2002.0,3,7,-4
AUS,MMR,2015.0,2,3,-1
FRA,MEX,1997.0,1,5,-4
GBR,BOL,2022.0,1,1,0
USA,VNM,2000.0,1,3,-2
JPN,BLR,2016.0,1,1,0
URY,DEU,2005.0,1,2,-1
KEN,CAN,2007.0,1,5,-4
RUS,EST,2016.0,1,3,-2
THA,KHM,2010.0,1,1,0
DZA,JPN,2009.0,1,1,0
SLE,NLD,2017.0,1,1,0
GRC,IND,2016.0,1,1,0
KEN,BWA,2002.0,1,1,0
CHN,NGA,2007.0,1,1,0
FIN,EGY,2013.0,1,2,-1
KOR,GHA,2022.0,2,1,1
VNM,CAN,2020.0,2,7,-5
MWI,TZA,2016.0,1,1,0
NLD,UKR,2005.0,1,3,-2
IDN,AUT,2016.0,1,7,-6
KAZ,CHE,2017.0,1,1,0
DEU,MAR,2000.0,1,1,0
CHN,PRI,2003.0,1,1,0
CHL,HRV,2014.0,1,1,0
FRA,GIN,2002.0,1,5,-4
TWN,RUS,2001.0,1,3,-2
USA,LTU,2007.0,10,4,6
FRA,NZL,2013.0,10,18,-8
BRA,USA,2017.0,522,319,203
POL,FRA,2012.0,29,78,-49
NLD,CAN,2006.0,45,27,18
ESP,BEL,2014.0,64,31,33
ESP,GBR,2015.0,508,252,256
HRV,GBR,2007.0,3,2,1
IND,KOR,2009.0,119,41,78
NOR,DNK,2015.0,31,49,-18
RUS,USA,2013.0,134,139,-5
GRC,SAU,2016.0,6,1,5
HUN,CHE,2011.0,18,5,13
ESP,ISR,2021.0,10,4,6
CAN,SAU,2020.0,140,53,87
SWE,FRA,2018.0,59,97,-38
MYS,BGD,2009.0,5,12,-7
ARG,DEU,2006.0,30,17,13
MYS,PAK,2015.0,60,44,16
CRI,USA,2016.0,13,26,-13
YEM,MYS,2015.0,3,15,-12
PSE,MYS,2015.0,2,5,-3
ROU,JPN,2014.0,6,1,5
CHN,KOR,2013.0,61,162,-101
PRI,GBR,2019.0,1,2,-1
CHE,MEX,2014.0,6,6,0
TWN,THA,2021.0,13,7,6
RUS,IRQ,2019.0,9,3,6
CHN,HKG,2001.0,100,126,-26
IRN,BRA,2018.0,7,3,4
MAR,FRA,2007.0,28,68,-40
GBR,KEN,2015.0,21,21,0
THA,MYS,2013.0,6,6,0
JPN,HKG,2002.0,7,5,2
TWN,JPN,2002.0,17,20,-3
USA,PRT,2000.0,14,8,6
GBR,EGY,2002.0,14,9,5
IND,TUR,2007.0,4,1,3
CHL,CHN,2022.0,3,3,0
CZE,GBR,2005.0,18,10,8
ESP,BOL,2011.0,2,2,0
COL,SWE,2019.0,8,3,5
USA,EST,2004.0,7,3,4
FIN,HUN,2000.0,1,4,-3
SVK,GBR,2011.0,5,3,2
BEL,IND,2004.0,1,6,-5
DNK,GRL,2010.0,4,3,1
RUS,SWE,2008.0,16,14,2
LBN,SAU,2013.0,5,5,0
SAU,USA,2010.0,27,103,-76
SWE,DEU,1997.0,7,22,-15
POL,TWN,2002.0,3,2,1
NLD,BEL,1998.0,21,15,6
USA,BGR,2002.0,8,26,-18
NOR,SWE,2012.0,44,70,-26
TWN,SAU,2018.0,7,2,5
ARG,BEL,2010.0,6,5,1
TUN,SAU,2014.0,36,6,30
MYS,EGY,2013.0,4,8,-4
MYS,PSE,2022.0,2,1,1
JOR,ESP,2021.0,2,1,1
SWE,SVN,2021.0,4,4,0
SWE,SAU,2019.0,7,3,4
PAK,OMN,2016.0,5,5,0
ITA,EGY,2020.0,18,7,11
PHL,KOR,2021.0,4,12,-8
RUS,CHE,2003.0,13,7,6
SGP,BEL,2019.0,7,9,-2
GBR,BRA,1998.0,16,9,7
PAK,GBR,2001.0,6,14,-8
AUS,AUT,2014.0,19,28,-9
ISR,NLD,2013.0,7,6,1
JPN,MEX,2015.0,10,6,4
IRN,IND,2012.0,5,20,-15
ESP,LUX,2018.0,5,4,1
JPN,CMR,2020.0,1,2,-1
SWE,RUS,2021.0,6,12,-6
SVN,ESP,2018.0,6,5,1
ISR,JPN,2011.0,7,2,5
LUX,GRC,2020.0,2,5,-3
JPN,CRI,2014.0,1,1,0
PHL,BGD,2017.0,1,1,0
SWE,SAU,2017.0,4,5,-1
DEU,MWI,2009.0,2,1,1
KEN,ETH,2018.0,7,4,3
AUS,CHL,2015.0,14,26,-12
IRN,HUN,2017.0,3,2,1
FRA,HUN,2020.0,6,16,-10
ITA,LBN,2015.0,4,3,1
CAN,PRI,2012.0,1,1,0
DEU,CMR,2021.0,4,3,1
SEN,CHE,2012.0,1,2,-1
POL,KOR,2009.0,1,3,-2
USA,BGD,2007.0,10,13,-3
CAN,NOR,2001.0,2,7,-5
NLD,KOR,2006.0,6,2,4
IND,SWE,1998.0,4,1,3
DNK,TWN,2017.0,3,2,1
HKG,SAU,2014.0,4,1,3
DEU,SGP,2022.0,14,15,-1
JOR,PAK,2014.0,1,1,0
GBR,COL,2000.0,2,2,0
NLD,MEX,2003.0,9,4,5
GRC,BGR,2009.0,4,1,3
TUN,ITA,2016.0,8,7,1
AUS,BRA,2008.0,4,21,-17
HRV,CZE,2021.0,3,1,2
IRN,ARM,2013.0,3,4,-1
UZB,KAZ,2018.0,1,3,-2
RUS,NOR,2017.0,9,8,1
PRI,USA,1998.0,4,9,-5
DEU,CUB,2003.0,1,3,-2
HKG,JPN,2006.0,2,3,-1
MDA,USA,1998.0,1,1,0
TWN,ITA,2020.0,3,1,2
SVN,AUS,2021.0,2,2,0
GBR,SRB,2018.0,10,9,1
NER,FRA,2019.0,2,4,-2
OMN,IND,2007.0,4,6,-2
SAU,LBN,2018.0,1,2,-1
THA,HKG,2016.0,3,2,1
CZE,EST,2016.0,1,3,-2
FRA,BDI,2002.0,1,2,-1
IDN,DNK,2009.0,1,1,0
DNK,HUN,2007.0,1,2,-1
CHL,URY,2013.0,2,1,1
SGP,ITA,2008.0,2,1,1
JPN,CHL,2003.0,2,1,1
PHL,BGD,2010.0,1,1,0
KOR,SDN,2020.0,4,1,3
IDN,GBR,2004.0,2,4,-2
GBR,JAM,2019.0,2,1,1
DEU,GEO,2013.0,1,5,-4
NGA,BEL,2018.0,1,1,0
MAC,BEL,2018.0,1,1,0
YEM,SAU,2013.0,4,2,2
SYR,CAN,2017.0,2,1,1
MYS,TWN,2015.0,3,6,-3
DNK,EST,2009.0,1,1,0
ISR,SGP,2018.0,1,9,-8
DNK,AUT,2005.0,2,4,-2
MAR,SEN,2014.0,1,1,0
CZE,LUX,2014.0,1,1,0
UKR,BLR,2017.0,3,2,1
AUS,SYR,2009.0,1,1,0
PRY,ARG,2010.0,1,1,0
PAK,RUS,2011.0,2,1,1
THA,DNK,2020.0,1,2,-1
QAT,LBN,2012.0,1,3,-2
NGA,CHE,2005.0,2,1,1
BRA,CAN,1998.0,1,9,-8
USA,MDA,2020.0,1,1,0
ARG,JPN,2003.0,2,1,1
IRN,NOR,2002.0,1,1,0
BRA,BEL,1999.0,1,11,-10
HRV,GRC,2009.0,1,1,0
JOR,CAN,2006.0,1,5,-4
AUT,DNK,2003.0,2,4,-2
AUS,MEX,2000.0,1,2,-1
CRI,PAN,2014.0,1,1,0
,CZE,1997.0,1111,0,1111
,NGA,2004.0,1352,0,1352
GRC,,2024.0,16595,0,16595
KGZ,,2023.0,146,0,146
SGP,,2023.0,6938,0,6938
SVK,,2018.0,725,0,725
NLD,,2022.0,11936,0,11936
ESP,,2018.0,11469,0,11469
DZA,,2022.0,2837,0,2837
ARG,,2001.0,63,0,63
LTU,,2023.0,2270,0,2270
,CMR,2004.0,198,0,198
,ESP,2012.0,14086,0,14086
KWT,,2016.0,130,0,130
,AUT,2003.0,2031,0,2031
,MKD,2010.0,148,0,148
,CZE,1998.0,2499,0,2499
,GBR,2015.0,20361,0,20361
NOR,,2021.0,2908,0,2908
IRN,,2011.0,932,0,932
,DNK,2009.0,2550,0,2550
SRB,,2012.0,240,0,240
,NGA,1996.0,131,0,131
VEN,,2014.0,517,0,517
,IND,2012.0,32164,0,32164
MDG,,2024.0,340,0,340
HKG,,2008.0,709,0,709
,IRQ,2004.0,91,0,91
IRQ,,2023.0,5337,0,5337
LBY,,2009.0,24,0,24
HUN,,2007.0,486,0,486
,CYP,2007.0,137,0,137
SGP,MAC,2010.0,2,0,2
ZWE,,2016.0,58,0,58
AUS,,2005.0,1906,0,1906
,JAM,2004.0,40,0,40
COL,,2012.0,361,0,361
,LTU,1995.0,127,0,127
CHE,LBN,2006.0,1,0,1
,CHE,1995.0,2377,0,2377
NGA,,2020.0,1443,0,1443
DEU,TZA,2002.0,1,0,1
MCO,,2010.0,8,0,8
TWN,,2025.0,19,0,19
MUS,,2024.0,167,0,167
,LVA,2001.0,100,0,100
AUS,,2002.0,425,0,425
NPL,,2022.0,613,0,613
ARM,,2013.0,88,0,88
SAU,,2007.0,206,0,206
,THA,2013.0,2463,0,2463
BEN,,2016.0,35,0,35
,MAC,2009.0,57,0,57
JPN,SAU,2003.0,2,0,2
,MKD,2017.0,83,0,83
PRY,MEX,2013.0,2,0,2
,SEN,2011.0,157,0,157
BEN,CMR,2021.0,1,0,1
HTI,,2024.0,73,0,73
URY,,2019.0,183,0,183
,ALB,2005.0,30,0,30
BEN,PER,2017.0,1,0,1
MLT,,2023.0,319,0,319
PHL,,2015.0,138,0,138
GEO,,2017.0,107,0,107
GEO,,2019.0,177,0,177
,LBN,2014.0,461,0,461
,ISR,2016.0,2556,0,2556
SYR,,2024.0,454,0,454
URY,,2010.0,51,0,51
,HKG,2016.0,2048,0,2048
,POL,2018.0,5294,0,5294
LKA,,2018.0,118,0,118
SVK,NLD,2021.0,2,0,2
,NIC,2011.0,14,0,14
,NCL,2000.0,15,0,15
NLD,TUN,2002.0,2,0,2
ISL,,2018.0,107,0,107
NER,ITA,2019.0,1,0,1
,WSM,2012.0,7,0,7
IRN,CHL,2014.0,3,0,3
ZWE,FIN,2018.0,1,0,1
,TZA,2014.0,279,0,279
IRQ,HUN,2017.0,3,0,3
IRN,PRT,2018.0,17,0,17
,TGO,2012.0,44,0,44
,MNG,2013.0,69,0,69
IND,HKG,2015.0,18,0,18
SUR,,2023.0,42,0,42
,LBY,2013.0,34,0,34
CUB,AUT,2018.0,1,0,1
,BGD,2016.0,1018,0,1018
CUB,CAN,2020.0,8,0,8
IRN,HUN,2019.0,4,0,4
,ISL,2016.0,135,0,135
ZAF,RWA,2019.0,8,0,8
,ZMB,2016.0,115,0,115
BRN,,2022.0,58,0,58
KEN,SAU,2022.0,1,0,1
,COD,2017.0,30,0,30
BRN,GHA,2017.0,3,0,3
,CMR,1996.0,38,0,38
,HND,2016.0,32,0,32
,BEN,2018.0,97,0,97
GBR,LIE,2021.0,1,0,1
,AZE,2013.0,169,0,169
URY,,2017.0,102,0,102
,ARM,2014.0,135,0,135
IRN,OMN,2015.0,4,0,4
GHA,GNB,2017.0,1,0,1
MEX,THA,2022.0,1,0,1
HND,SWE,2009.0,2,0,2
JAM,AUS,2008.0,1,0,1
SEN,,2002.0,1,0,1
PRT,,2006.0,277,0,277
,GEO,1999.0,107,0,107
GHA,ETH,2017.0,2,0,2
KAZ,NGA,2012.0,1,0,1
GEO,,2010.0,52,0,52
MCO,,2019.0,12,0,12
IND,YEM,2005.0,1,0,1
DEU,ARE,2003.0,3,0,3
,MDA,2015.0,36,0,36
,AIA,2013.0,1,0,1
THA,KHM,2017.0,2,0,2
PHL,HUN,2018.0,3,0,3
SEN,CHN,2019.0,2,0,2
UKR,CHE,2021.0,4,0,4
THA,KWT,2013.0,1,0,1
,CPV,2016.0,9,0,9
CHE,ETH,1999.0,1,0,1
,MKD,2019.0,29,0,29
,COD,2019.0,44,0,44
CHN,ETH,2010.0,1,0,1
,LKA,1994.0,43,0,43
,TJK,2008.0,18,0,18
,ALB,2002.0,14,0,14
IRN,QAT,2021.0,2,0,2
MMR,,2012.0,10,0,10
,BRB,2007.0,6,0,6
UZB,SWE,2012.0,1,0,1
,PAN,1999.0,22,0,22
IRL,LBY,2015.0,2,0,2
CMR,BDI,2017.0,1,0,1
NGA,JAM,2008.0,1,0,1
BLR,,2000.0,26,0,26
KAZ,,2005.0,22,0,22
HRV,BIH,2003.0,13,0,13
TUR,EGY,2001.0,2,0,2
VNM,,2005.0,30,0,30
LVA,FRA,2005.0,1,0,1
,PSE,2000.0,34,0,34
PRI,,2003.0,21,0,21
,MNE,1998.0,8,0,8
TUN,ZWE,2016.0,1,0,1
NER,NLD,2014.0,1,0,1
MLI,FRA,1999.0,2,0,2
PNG,NGA,2009.0,1,0,1
HRV,CHE,1999.0,2,0,2
,JAM,1996.0,19,0,19
ZWE,COG,2018.0,3,0,3
ISL,DEU,2004.0,2,0,2
TJK,,2004.0,3,0,3
GHA,,2003.0,3,0,3
THA,RUS,2014.0,2,0,2
,LSO,2002.0,2,0,2
TGO,,2012.0,6,0,6
USA,LIE,2006.0,2,0,2
NZL,TON,2004.0,1,0,1
COG,CHE,2016.0,2,0,2
ITA,BOL,2003.0,1,0,1
ITA,TUR,2000.0,2,0,2
DEU,GTM,2002.0,1,0,1
,IRQ,1996.0,8,0,8
NGA,CHE,2002.0,1,0,1
SEN,,2005.0,25,0,25
FRA,BLR,1997.0,1,0,1
IND,YEM,2002.0,1,0,1
NZL,,2000.0,21,0,21
BGD,CHE,2005.0,1,0,1
IRQ,CAN,2008.0,2,0,2
BMU,GBR,2004.0,1,0,1
POL,LTU,2010.0,4,0,4
CHE,BIH,2003.0,1,0,1
MMR,CHN,2006.0,1,0,1
PRT,GEO,2013.0,1,0,1
YEM,ARE,2016.0,1,0,1
BEL,DZA,2009.0,3,0,3
POL,NGA,2015.0,2,0,2
GBR,SYR,2012.0,6,0,6
,UGA,1995.0,14,0,14
FJI,GBR,2004.0,1,0,1
DNK,FRO,2002.0,1,0,1
PRI,GBR,2010.0,2,0,2
MWI,,2015.0,38,0,38
SYR,IRN,2022.0,2,0,2
ITA,PSE,2015.0,3,0,3
ZMB,NLD,2011.0,1,0,1
NZL,GHA,2012.0,1,0,1
,MMR,2009.0,24,0,24
CZE,,2025.0,15,0,15
IRL,FJI,2019.0,1,0,1
UKR,NOR,2018.0,3,0,3
ZAF,SYC,2015.0,1,0,1
BHR,IRQ,2017.0,1,0,1
UKR,CZE,2016.0,11,0,11
IND,SWE,1997.0,1,0,1
MLT,CHE,2013.0,1,0,1
AUS,MDG,2016.0,1,0,1
SVK,ISR,2016.0,1,0,1
BTN,,2018.0,6,0,6
BWA,QAT,2017.0,1,0,1
SDN,NOR,2019.0,1,0,1
JOR,HUN,2017.0,3,0,3
VNM,IRL,2022.0,2,0,2
,AFG,2016.0,29,0,29
KAZ,,2002.0,8,0,8
BLR,IRN,2018.0,2,0,2
MNG,CHN,2021.0,3,0,3
BRA,HUN,2021.0,3,0,3
,TTO,2008.0,38,0,38
FRA,MLI,2001.0,1,0,1
GMB,KOR,2001.0,2,0,2
ARM,GRC,1997.0,1,0,1
UKR,ISR,2001.0,3,0,3
VNM,,2002.0,7,0,7
BEL,SAU,2008.0,3,0,3
MUS,AUS,2019.0,5,0,5
SDN,QAT,2018.0,3,0,3
,TCD,2007.0,5,0,5
AFG,LKA,2018.0,1,0,1
BEL,PSE,2018.0,1,0,1
VNM,ISR,2017.0,1,0,1
IRN,AFG,2017.0,1,0,1
CIV,NGA,2020.0,1,0,1
AUT,LBY,2006.0,1,0,1
PER,,2007.0,35,0,35
BHR,IRQ,2010.0,1,0,1
,MUS,2000.0,20,0,20
EGY,TUR,2009.0,2,0,2
DNK,MEX,1998.0,3,0,3
SVN,NOR,2014.0,4,0,4
,GRD,2014.0,16,0,16
SYR,HUN,2017.0,2,0,2
MCO,PYF,2018.0,1,0,1
PAN,ARG,2021.0,1,0,1
IRL,SAU,2007.0,3,0,3
OMN,,2003.0,10,0,10
HUN,GRC,2007.0,2,0,2
USA,MNP,2003.0,2,0,2
PAK,NOR,2010.0,5,0,5
KWT,ROU,2009.0,1,0,1
IND,MKD,2017.0,1,0,1
ITA,LKA,2020.0,2,0,2
NLD,MNG,2021.0,1,0,1
,PRY,1998.0,8,0,8
ESP,CYP,2017.0,1,0,1
,GLP,1997.0,13,0,13
HRV,POL,1997.0,1,0,1
EST,CHE,2010.0,2,0,2
BFA,,2012.0,23,0,23
AUS,GHA,2008.0,1,0,1
ESP,TUN,2005.0,1,0,1
MYS,BHR,2003.0,1,0,1
NCL,AUS,2001.0,1,0,1
IND,IDN,2017.0,8,0,8
PAN,AUS,2013.0,1,0,1
NAM,,2006.0,3,0,3
TUR,OMN,1999.0,1,0,1
ERI,IND,2013.0,4,0,4
LTU,NLD,2005.0,5,0,5
DEU,TZA,2005.0,2,0,2
NLD,KWT,2011.0,1,0,1
DEU,PRI,2004.0,1,0,1
FRA,GIN,2005.0,9,0,9
NOR,PRT,2008.0,4,0,4
ARG,PRT,2011.0,3,0,3
MDV,USA,2010.0,1,0,1
USA,FJI,2015.0,2,0,2
IDN,CMR,2020.0,2,0,2
MTQ,,2009.0,2,0,2
,LSO,2005.0,5,0,5
CMR,IDN,2008.0,1,0,1
PAK,PRT,2008.0,1,0,1
DEU,BMU,2018.0,1,0,1
NGA,SEN,2009.0,1,0,1
GRC,KAZ,2016.0,3,0,3
JOR,MYS,2007.0,3,0,3
SWZ,ESP,2014.0,1,0,1
,COD,2010.0,6,0,6
LBN,QAT,2021.0,5,0,5
,SLE,2011.0,9,0,9
ZMB,NOR,2003.0,1,0,1
BRA,MUS,2004.0,1,0,1
SWZ,NGA,2010.0,1,0,1
ETH,SDN,2015.0,1,0,1
CHN,ECU,2019.0,1,0,1
ISL,CAN,1999.0,1,0,1
TUR,NGA,2018.0,3,0,3
LSO,BWA,2021.0,1,0,1
DEU,CIV,2022.0,1,0,1
KHM,SAU,2021.0,1,0,1
ARM,FRA,2004.0,3,0,3
,GLP,1998.0,17,0,17
USA,FSM,2011.0,2,0,2
TKM,,2012.0,3,0,3
DEU,KAZ,2000.0,2,0,2
BLR,MEX,1998.0,1,0,1
LAO,SGP,2017.0,1,0,1
RUS,ARE,2016.0,1,0,1
UKR,ESP,2021.0,1,0,1
PAN,CRI,2015.0,1,0,1
AUT,ISL,2001.0,1,0,1
SYR,WSM,2013.0,1,0,1
LTU,JPN,2012.0,1,0,1
CAN,COG,2017.0,1,0,1
IRN,RUS,2012.0,1,0,1
JPN,PRY,2016.0,2,0,2
MCO,,2017.0,8,0,8
POL,QAT,2015.0,2,0,2
POL,CHL,2014.0,6,0,6
GMB,NGA,2022.0,3,0,3
QAT,DEU,2022.0,5,0,5
AUT,ALB,2012.0,1,0,1
SGP,LKA,2022.0,1,0,1
,MCO,2008.0,6,0,6
GNQ,,2019.0,2,0,2
USA,DZA,2005.0,3,0,3
ITA,SRB,1999.0,1,0,1
MCO,SEN,2007.0,1,0,1
SEN,MCO,2008.0,1,0,1
HKG,CZE,2007.0,2,0,2
CHL,TUR,2003.0,1,0,1
MYS,NLD,2006.0,2,0,2
MHL,,2009.0,2,0,2
IND,BWA,2003.0,1,0,1
GBR,FLK,2015.0,1,0,1
IDN,PNG,2011.0,1,0,1
SRB,NLD,2001.0,3,0,3
JOR,POL,2012.0,2,0,2
BEL,SYR,2014.0,1,0,1
ZWE,IRL,2005.0,1,0,1
ROU,IND,2009.0,1,0,1
NZL,PRT,2010.0,1,0,1
TGO,BEN,2018.0,2,0,2
BOL,ECU,2007.0,1,0,1
MKD,SRB,2012.0,5,0,5
BTN,JPN,2021.0,1,0,1
COL,ARM,2013.0,1,0,1
TWN,BGR,2014.0,2,0,2
ROU,MAR,2014.0,1,0,1
CZE,PER,2017.0,1,0,1
DEU,MTQ,2015.0,1,0,1
NZL,CHN,1997.0,1,0,1
COM,,2017.0,2,0,2
,PRY,1997.0,2,0,2
SEN,CIV,2021.0,2,0,2
KEN,COL,2018.0,4,0,4
UKR,SVK,2022.0,2,0,2
AUT,VNM,2011.0,1,0,1
SYR,CAN,2010.0,3,0,3
IRN,NOR,2005.0,1,0,1
TTO,GEO,2015.0,1,0,1
MWI,AUS,2021.0,1,0,1
HND,,2006.0,2,0,2
FRA,URY,2008.0,4,0,4
SVK,CAN,2007.0,2,0,2
RUS,SVK,2011.0,1,0,1
SYR,LKA,2008.0,1,0,1
LBN,MAR,2016.0,2,0,2
SEN,CHN,2017.0,1,0,1
SDN,USA,2016.0,2,0,2
NLD,LBR,2008.0,1,0,1
EST,MEX,2020.0,1,0,1
BEL,UKR,2005.0,5,0,5
NER,,2007.0,1,0,1
UZB,GBR,2002.0,3,0,3
IRN,LVA,2020.0,1,0,1
KWT,NZL,1999.0,1,0,1
PER,ECU,2006.0,1,0,1
NGA,NER,2013.0,1,0,1
IRN,NLD,2004.0,3,0,3
SEN,DEU,2021.0,1,0,1
IND,ROU,1999.0,1,0,1
POL,LUX,2012.0,1,0,1
BEL,MDG,2017.0,2,0,2
TZA,BEN,2018.0,3,0,3
HUN,RUS,2006.0,1,0,1
JOR,HUN,2019.0,3,0,3
MEX,ZAF,2011.0,1,0,1
,MDV,2006.0,1,0,1
IND,UGA,2020.0,1,0,1
MDG,BEN,2018.0,1,0,1
JPN,ZAF,2009.0,3,0,3
MCO,MDG,2012.0,1,0,1
SVN,CAN,2007.0,2,0,2
ETH,THA,2017.0,2,0,2
IND,SYC,2020.0,1,0,1
ETH,CZE,2019.0,1,0,1
GUF,GLP,2011.0,1,0,1
ROU,TUR,2009.0,1,0,1
MAR,TWN,2001.0,1,0,1
CRI,CHE,2001.0,1,0,1
POL,CHN,2000.0,2,0,2
BEL,LKA,2012.0,1,0,1
NGA,SLE,2014.0,1,0,1
GBR,MAC,2006.0,2,0,2
CHN,ZMB,2012.0,1,0,1
CZE,PER,2019.0,1,0,1
CHN,SAU,2006.0,1,0,1
PRI,CHN,2001.0,1,0,1
COM,,2019.0,1,0,1
HUN,CHL,2020.0,1,0,1
BHR,QAT,2021.0,1,0,1
FJI,DEU,2018.0,1,0,1
NZL,CHN,1998.0,1,0,1
ISR,UKR,2010.0,1,0,1
NLD,PNG,2013.0,1,0,1
ESP,EST,2002.0,1,0,1
LVA,,2025.0,2,0,2
MHL,IND,2002.0,1,0,1
,MNE,1997.0,7,0,7
LUX,BLR,2013.0,1,0,1
PHL,NGA,2002.0,1,0,1
LTU,ESP,2006.0,1,0,1
DEU,BGD,2009.0,3,0,3
LVA,ISR,2003.0,1,0,1
ROU,IRN,2015.0,3,0,3
ISR,KEN,2002.0,1,0,1
SAU,GHA,2017.0,1,0,1
FIN,TUN,2013.0,1,0,1
HRV,SWE,2011.0,1,0,1
ESP,SRB,2005.0,5,0,5
UGA,EGY,2011.0,1,0,1
ISR,BGR,2008.0,2,0,2
CHE,VNM,2006.0,1,0,1
VNM,ETH,2017.0,1,0,1
ZAF,IDN,2017.0,1,0,1
CMR,CIV,2014.0,1,0,1
SMR,,2018.0,1,0,1
MYS,RWA,2008.0,1,0,1
ESP,CYP,2019.0,4,0,4
IRL,VNM,2014.0,1,0,1
ATG,GRD,2021.0,1,0,1
BRA,VEN,1999.0,1,0,1
KWT,AUS,2003.0,1,0,1
AFG,,2015.0,2,0,2
NLD,KHM,2019.0,1,0,1
DZA,OMN,1998.0,1,0,1
KOR,TZA,2012.0,2,0,2
GBR,KGZ,2016.0,1,0,1
OMN,QAT,2007.0,1,0,1
MHL,USA,2011.0,1,0,1
ZAF,CHL,2010.0,1,0,1
ISR,SWE,2005.0,2,0,2
FLK,GBR,2012.0,2,0,2
NZL,ARG,2011.0,2,0,2
SEN,BRA,2021.0,1,0,1
THA,ETH,2004.0,1,0,1
MEX,MYS,2018.0,1,0,1
ARG,CAN,1999.0,5,0,5
UKR,IRN,2007.0,1,0,1
SWZ,GBR,2013.0,1,0,1
NLD,GHA,2008.0,1,0,1
LTU,AUS,2015.0,1,0,1
ALB,NLD,2021.0,1,0,1
AUT,ARG,2016.0,2,0,2
NCL,ITA,2017.0,1,0,1
YEM,DEU,2016.0,1,0,1
TUR,PER,2019.0,1,0,1
UGA,BEL,2022.0,3,0,3
MEX,LTU,2022.0,1,0,1
BIH,EGY,2020.0,1,0,1
VNM,LUX,2018.0,1,0,1
MAC,KEN,2022.0,1,0,1
SGP,MAC,2017.0,2,0,2
SYR,CAN,2019.0,1,0,1
NAM,POL,2020.0,1,0,1
ZAF,TWN,1997.0,1,0,1
DNK,TWN,2010.0,1,0,1
KEN,MDV,2015.0,1,0,1
MEX,DZA,2010.0,1,0,1
IND,ETH,2000.0,1,0,1
BEL,HTI,2018.0,1,0,1
BIH,JAM,2019.0,1,0,1
THA,AFG,2015.0,1,0,1
PER,BEN,2010.0,1,0,1
BRA,THA,2018.0,1,0,1
TTO,EGY,2015.0,1,0,1
BGD,POL,2015.0,1,0,1
SOM,,2020.0,1,0,1
ARM,DNK,2013.0,2,0,2
ITA,MKD,2022.0,1,0,1
CHN,JOR,2014.0,1,0,1
CIV,BEN,2011.0,1,0,1
SRB,ISR,2003.0,1,0,1
SWZ,FIN,2002.0,1,0,1
KEN,FRA,2007.0,2,0,2
SWE,PAN,2002.0,1,0,1
LBN,AUS,2005.0,1,0,1
SVK,DNK,2009.0,2,0,2
BRA,SGP,2011.0,1,0,1
CUB,AGO,2016.0,1,0,1
GRD,ROU,2015.0,1,0,1
AUS,TLS,2013.0,2,0,2
LVA,SAU,2015.0,1,0,1
AFG,PAK,2004.0,2,0,2
NIC,MEX,2005.0,1,0,1
REU,BEL,2010.0,1,0,1
MUS,CHE,2012.0,1,0,1
IND,SVN,2011.0,1,0,1
ITA,SAU,2008.0,1,0,1
BIH,CHE,2013.0,1,0,1
GNB,,2012.0,2,0,2
TGO,CIV,2010.0,1,0,1
TZA,ZAF,2001.0,1,0,1
IND,NPL,1999.0,3,0,3
BWA,USA,2000.0,1,0,1
UGA,DEU,2006.0,1,0,1
TWN,SEN,2011.0,1,0,1
GUF,,2012.0,4,0,4
BEL,URY,2018.0,1,0,1
PAK,BRN,2014.0,1,0,1
IRN,AFG,2019.0,6,0,6
ESP,AGO,2020.0,1,0,1
DMA,,2023.0,4,0,4
UKR,BLR,2019.0,2,0,2
IRQ,TWN,2017.0,2,0,2
NLD,SVN,2009.0,1,0,1
POL,YEM,2010.0,1,0,1
LBY,USA,2012.0,3,0,3
IND,ISL,2015.0,1,0,1
CAN,BHR,2018.0,2,0,2
BOL,PAK,2020.0,1,0,1
SRB,OMN,2018.0,1,0,1
WSM,NZL,2022.0,1,0,1
EGY,PAK,2002.0,1,0,1
AUS,LVA,2007.0,1,0,1
IRL,OMN,2000.0,1,0,1
IRQ,JOR,2000.0,1,0,1
MUS,AUS,2010.0,2,0,2
KEN,ZWE,2008.0,1,0,1
IND,MLT,2019.0,2,0,2
ETH,CZE,2010.0,1,0,1
ETH,THA,2010.0,1,0,1
USA,MMR,2011.0,1,0,1
MCO,ESP,2009.0,1,0,1
HUN,TWN,2013.0,1,0,1
,SLB,2005.0,1,0,1
MLT,IRL,2016.0,1,0,1
CHL,UKR,2013.0,1,0,1
ESP,LBN,2016.0,1,0,1
IRN,KEN,2018.0,1,0,1
NGA,VNM,2009.0,1,0,1
EGY,ESP,2002.0,1,0,1
KHM,BRA,2017.0,1,0,1
MAC,DEU,2020.0,1,0,1
CYP,LBN,2017.0,1,0,1
LVA,JPN,2002.0,1,0,1
UKR,HRV,2017.0,2,0,2
AUS,SRB,2010.0,1,0,1
JAM,CHE,2014.0,1,0,1
TLS,PRT,2013.0,1,0,1
CHN,HUN,2000.0,1,0,1
RWA,LUX,2008.0,1,0,1
MAR,ZAF,2003.0,1,0,1
GMB,ZAF,2014.0,1,0,1
NGA,ARG,2019.0,1,0,1
CHE,MDG,2005.0,1,0,1
NGA,POL,2011.0,3,0,3
QAT,SDN,2009.0,1,0,1
ITA,ZAF,1999.0,1,0,1
ZMB,USA,1999.0,2,0,2
ISR,EGY,2006.0,1,0,1
PAN,FIN,2019.0,1,0,1
SAU,BEL,2004.0,1,0,1
CRI,ECU,2009.0,1,0,1
ITA,OMN,2021.0,1,0,1
BEL,SDN,2017.0,1,0,1
ARG,PAN,2009.0,1,0,1
MEX,DZA,2017.0,1,0,1
CHE,ISL,2018.0,1,0,1
DEU,COG,2015.0,1,0,1
MDG,FIN,2002.0,1,0,1
BEL,MUS,2020.0,1,0,1
ESP,MOZ,2007.0,2,0,2
ETH,LBN,2015.0,1,0,1
SYR,CHN,2014.0,1,0,1
,ATA,2016.0,2,0,2
AIA,,2021.0,1,0,1
GHA,PER,2003.0,1,0,1
LBY,SAU,2006.0,1,0,1
ETH,ESP,2008.0,2,0,2
MEX,EGY,2013.0,1,0,1
NCL,ITA,2010.0,1,0,1
BEL,MDG,2019.0,1,0,1
BRN,JPN,2020.0,1,0,1
BOL,CAN,2018.0,1,0,1
BRN,NPL,2018.0,1,0,1
BHR,IRQ,2019.0,1,0,1
CAN,FRO,2015.0,1,0,1
FJI,IND,2021.0,1,0,1
GTM,NZL,2020.0,1,0,1
NGA,CZE,2019.0,1,0,1
JPN,KGZ,2020.0,2,0,2
PRY,JPN,2021.0,1,0,1
NLD,KHM,2017.0,1,0,1
CHN,NAM,2011.0,1,0,1
VNM,ETH,2019.0,1,0,1
BHR,JPN,2019.0,1,0,1
NGA,HKG,2016.0,1,0,1
GEO,KOR,2019.0,1,0,1
FRA,CRI,2000.0,1,0,1
IND,PHL,2006.0,1,0,1
ECU,CHE,2016.0,1,0,1
TUR,PRT,2008.0,1,0,1
POL,IRQ,2013.0,1,0,1
CYP,GHA,2015.0,1,0,1
CHN,AZE,2010.0,1,0,1
UKR,BIH,2011.0,1,0,1
SEN,NCL,1999.0,1,0,1
BEL,GEO,2002.0,1,0,1
IND,CHL,2003.0,1,0,1
SWE,KNA,2015.0,1,0,1
KEN,BWA,2005.0,1,0,1
RUS,MYS,2013.0,1,0,1
PRI,VEN,2005.0,1,0,1
UZB,BEL,2018.0,1,0,1
KAZ,GBR,2001.0,1,0,1
SRB,BRA,2017.0,2,0,2
MKD,KWT,2018.0,1,0,1
SRB,BRA,2019.0,1,0,1
SRB,ARG,2009.0,1,0,1
GMB,MWI,2019.0,1,0,1
NZL,NGA,2008.0,1,0,1
MAR,JPN,2020.0,1,0,1
IND,MKD,2019.0,1,0,1
ARE,GEO,2022.0,1,0,1
MLT,MLI,2002.0,1,0,1
NZL,SVK,2010.0,1,0,1
PAK,DNK,2008.0,1,0,1
IRN,TUN,2018.0,1,0,1
TUR,KOR,2007.0,1,0,1
DEU,ZWE,2012.0,1,0,1
ITA,BLR,2015.0,1,0,1
CHE,PAK,2002.0,1,0,1
ESP,IDN,2012.0,1,0,1
COL,PHL,2014.0,1,0,1
NPL,SGP,2012.0,1,0,1
USA,SHN,2021.0,1,0,1
COL,SAU,2018.0,1,0,1
TWN,COL,2017.0,1,0,1
JPN,HRV,2017.0,1,0,1
ROU,AZE,2012.0,1,0,1
PAK,MAC,2019.0,1,0,1
FIN,URY,2020.0,1,0,1
JOR,IND,2013.0,1,0,1
BRA,LTU,2020.0,1,0,1
KAZ,NLD,2022.0,1,0,1
SGP,CHN,2011.0,163,195,-32
JPN,THA,2007.0,64,31,33
CHN,JPN,2007.0,201,368,-167
GBR,FRA,2018.0,410,502,-92
SWE,FRA,2010.0,57,53,4
CHN,SGP,2007.0,103,92,11
ITA,USA,2010.0,491,320,171
KOR,SGP,2015.0,22,31,-9
DEU,CHN,2005.0,84,114,-30
USA,IND,2006.0,321,648,-327
CHN,HKG,2003.0,146,169,-23
SGP,HKG,2016.0,27,31,-4
IRL,PRT,2013.0,4,5,-1
KHM,USA,2018.0,5,3,2
BRA,ESP,2007.0,38,34,4
MYS,SGP,2010.0,15,13,2
ESP,CAN,2011.0,46,44,2
TUR,USA,2002.0,125,180,-55
ITA,DEU,2004.0,127,132,-5
DEU,AUS,2008.0,133,91,42
AUS,SGP,2014.0,73,69,4
AUS,DEU,2012.0,136,147,-11
AUS,GBR,2015.0,456,595,-139
CHE,DEU,2015.0,459,593,-134
GBR,NOR,2006.0,43,25,18
JPN,IND,2007.0,57,56,1
SAU,USA,2018.0,129,254,-125
FRA,CAN,2008.0,259,176,83
TUR,USA,2005.0,146,187,-41
ISR,NLD,2008.0,10,4,6
GRC,ITA,2014.0,34,22,12
DEU,ITA,2007.0,128,158,-30
USA,AUS,2007.0,478,413,65
SRB,MKD,2004.0,14,1,13
KEN,GBR,2013.0,19,16,3
SWE,CHN,2017.0,102,86,16
PRT,ESP,2018.0,88,111,-23
CHN,EGY,2013.0,9,3,6
SGP,IND,2011.0,30,44,-14
ISR,CAN,2007.0,44,27,17
ARG,BRA,2008.0,25,22,3
FRA,DZA,2020.0,57,54,3
DEU,GRC,2016.0,45,64,-19
IND,MYS,2014.0,94,30,64
KEN,ETH,2019.0,8,7,1
MEX,COL,2018.0,62,43,19
KOR,USA,2013.0,719,1018,-299
NLD,USA,1997.0,44,32,12
GBR,BEL,2008.0,71,67,4
GEO,RUS,2009.0,3,3,0
RUS,USA,2008.0,171,137,34
FRA,BFA,2016.0,15,8,7
MYS,SAU,2012.0,36,3,33
GHA,NLD,2020.0,6,7,-1
USA,ARE,2009.0,45,11,34
SAU,EGY,2011.0,84,190,-106
CHE,PRT,2002.0,7,4,3
POL,RUS,2004.0,6,6,0
DEU,LTU,2018.0,4,8,-4
DEU,RUS,2010.0,70,126,-56
IRN,CAN,2020.0,421,54,367
THA,AUS,2014.0,21,34,-13
ESP,BEL,2004.0,14,19,-5
IND,DEU,2011.0,141,97,44
ITA,USA,2017.0,590,363,227
CHN,FRA,2009.0,79,48,31
ESP,CHE,2021.0,75,61,14
AUS,FRA,2009.0,59,81,-22
NLD,HRV,2011.0,5,1,4
FRA,SEN,2015.0,27,20,7
SWE,FRA,2017.0,50,83,-33
SRB,BIH,2004.0,4,2,2
DEU,CHN,2002.0,57,112,-55
BEL,PRT,2009.0,6,3,3
CHE,AUS,2009.0,45,48,-3
HUN,GBR,2014.0,41,26,15
VNM,MYS,2021.0,8,5,3
BGD,USA,2021.0,80,45,35
TUR,NLD,2016.0,23,26,-3
NLD,USA,1998.0,67,54,13
ITA,USA,2019.0,538,334,204
DNK,ESP,2020.0,30,40,-10
MYS,AUS,2017.0,147,119,28
USA,ESP,2021.0,285,320,-35
NLD,GRC,2020.0,27,22,5
AUS,IDN,2021.0,43,19,24
IRN,AUS,2015.0,144,26,118
CHN,PAK,2016.0,129,160,-31
IRL,GBR,2020.0,216,248,-32
USA,PAK,2016.0,68,100,-32
ESP,AUT,2015.0,41,11,30
RUS,ISR,2016.0,6,11,-5
NOR,DEU,2015.0,42,64,-22
FRA,GBR,2014.0,430,400,30
LBN,GBR,2010.0,2,4,-2
LBN,FRA,2011.0,20,41,-21
GBR,TUR,2022.0,29,25,4
FRA,JPN,2016.0,96,76,20
BRA,COL,2018.0,70,52,18
CHE,IND,2016.0,30,39,-9
GBR,HKG,2002.0,30,29,1
FRA,CHE,2011.0,263,216,47
BRA,FRA,2021.0,117,57,60
MYS,IRN,2016.0,170,29,141
KOR,CHL,2012.0,1,1,0
FRA,CYP,2020.0,4,1,3
BEL,ROU,2020.0,7,4,3
MYS,AUS,2019.0,139,94,45
PRT,AUS,2017.0,17,2,15
NLD,ITA,2015.0,79,104,-25
GBR,TWN,2017.0,21,39,-18
BGR,DEU,2015.0,8,8,0
ESP,ARG,2013.0,63,44,19
FRA,KOR,2021.0,15,48,-33
THA,DEU,2015.0,10,23,-13
GBR,POL,1999.0,9,12,-3
NLD,DNK,2008.0,21,18,3
USA,SEN,2007.0,7,2,5
FRA,CUB,2018.0,2,4,-2
ZAF,TZA,2016.0,8,5,3
DEU,BEL,2008.0,61,41,20
RUS,NOR,2018.0,5,4,1
LVA,EST,2012.0,2,1,1
USA,HRV,2018.0,12,12,0
CRI,USA,2022.0,9,2,7
CHN,ETH,2018.0,11,10,1
CHE,CAN,2018.0,87,86,1
IND,IRL,2022.0,28,6,22
BEL,CAN,2016.0,48,28,20
CZE,MEX,2016.0,3,4,-1
CHE,FRA,2022.0,88,124,-36
GBR,JOR,2016.0,22,12,10
CHN,IRL,2016.0,16,29,-13
TUR,BEL,2019.0,21,7,14
BEL,GBR,2020.0,112,161,-49
PRT,GBR,2012.0,63,48,15
ITA,FRA,2001.0,132,146,-14
SWE,CHN,2019.0,102,87,15
IND,THA,2015.0,9,8,1
AUT,SVN,2019.0,6,9,-3
TWN,CHE,2018.0,11,11,0
GBR,KOR,2015.0,49,45,4
SVN,GBR,2018.0,11,10,1
PER,ESP,2021.0,17,14,3
LBN,GBR,2017.0,10,8,2
ITA,JPN,2017.0,33,18,15
IRN,BRA,2017.0,11,5,6
HKG,FRA,2019.0,12,9,3
FRA,TUR,2010.0,13,10,3
DEU,RUS,2017.0,77,104,-27
IRN,PRT,2019.0,12,3,9
LUX,CHN,2018.0,3,2,1
CHE,ITA,2015.0,100,251,-151
NGA,RUS,2020.0,3,3,0
AUS,KOR,2014.0,25,39,-14
KEN,ETH,2017.0,5,3,2
IND,TWN,2021.0,72,32,40
ARG,URY,2018.0,10,1,9
NGA,HKG,2022.0,3,1,2
ESP,URY,2020.0,11,13,-2
IND,JPN,2007.0,56,57,-1
ESP,LUX,2019.0,11,8,3
CZE,SWE,2020.0,23,12,11
POL,LTU,2018.0,1,1,0
UKR,CZE,2022.0,2,3,-1
IRN,ITA,2016.0,35,17,18
IRN,NZL,2019.0,32,2,30
LKA,GBR,2018.0,9,18,-9
POL,USA,2021.0,85,59,26
ISL,GBR,2021.0,6,3,3
SAU,PAK,2021.0,44,50,-6
IRL,NLD,2020.0,19,20,-1
CHN,RUS,2022.0,14,13,1
ITA,SMR,2019.0,5,2,3
GUF,FRA,2017.0,25,30,-5
BGD,IND,2021.0,13,13,0
CHL,IND,2021.0,3,10,-7
CHN,ITA,2022.0,35,32,3
COL,VEN,2021.0,9,14,-5
CAN,GBR,2003.0,228,280,-52
IND,NOR,2015.0,11,8,3
ITA,CHE,2014.0,254,103,151
AUS,IRN,2001.0,5,1,4
RUS,KAZ,2020.0,30,32,-2
IRN,SVK,2021.0,3,1,2
PAK,ARE,2016.0,15,3,12
CHE,NLD,2022.0,33,49,-16
GEO,USA,2019.0,16,17,-1
USA,ISR,2006.0,211,376,-165
BEL,ESP,2013.0,26,57,-31
CHE,TUR,2019.0,14,24,-10
SRB,USA,2014.0,12,18,-6
CHL,BRA,2015.0,15,21,-6
NLD,BRA,2020.0,21,55,-34
CHL,GBR,2007.0,19,9,10
USA,EGY,2012.0,96,51,45
GBR,TWN,2019.0,33,26,7
KOR,NLD,2004.0,2,4,-2
AUT,THA,2015.0,7,2,5
USA,POL,2006.0,95,129,-34
NLD,CHE,2008.0,48,47,1
DEU,THA,2016.0,22,11,11
SAU,MYS,2016.0,12,67,-55
MEX,NLD,2012.0,6,6,0
SWE,PAK,2009.0,3,4,-1
FRA,URY,2013.0,2,4,-2
DEU,IRL,2007.0,35,19,16
PAK,IRL,2011.0,2,1,1
AUT,DEU,2012.0,251,310,-59
KOR,ZAF,2011.0,1,3,-2
ITA,JPN,2010.0,21,19,2
KOR,EGY,2009.0,4,4,0
USA,GRC,2000.0,20,20,0
ITA,ARG,2007.0,17,17,0
ITA,BRA,2001.0,12,13,-1
AUS,QAT,2020.0,10,11,-1
DEU,FIN,2011.0,29,42,-13
COG,BEL,2012.0,1,5,-4
FRA,TWN,2016.0,12,8,4
TUR,PRT,2013.0,3,2,1
CHN,MAC,2011.0,19,5,14
GBR,PAK,2000.0,7,2,5
PRT,JPN,2002.0,9,2,7
JPN,NOR,2012.0,4,4,0
TWN,IND,2003.0,16,36,-20
HKG,FRA,2010.0,9,5,4
TWN,DEU,2006.0,4,17,-13
JPN,SWE,1998.0,13,5,8
BRA,URY,2016.0,8,2,6
KOR,FIN,2015.0,3,3,0
THA,CHE,2021.0,5,4,1
MEX,FRA,2015.0,26,49,-23
PRT,USA,2022.0,23,16,7
GEO,USA,2017.0,15,19,-4
NZL,USA,2018.0,123,125,-2
NLD,FRA,2001.0,52,54,-2
ITA,BEL,2002.0,28,33,-5
IRL,FRA,1997.0,3,1,2
KOR,IND,2004.0,13,39,-26
JPN,DEU,2001.0,82,79,3
JPN,POL,2002.0,12,5,7
COL,USA,2000.0,12,6,6
ROU,JPN,2004.0,5,6,-1
CUB,ESP,2002.0,14,18,-4
MDG,KHM,2007.0,1,1,0
DEU,HUN,2010.0,25,35,-10
FRA,RUS,2002.0,34,48,-14
ITA,NLD,2006.0,54,50,4
ISR,FRA,2013.0,22,26,-4
PAK,ROU,2013.0,1,1,0
FIN,CAN,2002.0,23,15,8
ITA,MEX,2000.0,5,4,1
BLR,UKR,2008.0,4,1,3
AUS,EGY,2021.0,8,9,-1
TWN,FIN,2016.0,7,2,5
USA,SWE,2001.0,145,220,-75
SGP,ITA,2013.0,5,15,-10
NLD,IND,2007.0,5,11,-6
SRB,ESP,2014.0,3,2,1
GRC,ROU,2004.0,1,2,-1
MYS,AUS,2010.0,57,49,8
UGA,BEL,2016.0,4,5,-1
KEN,IND,2017.0,1,2,-1
CHN,CHE,2003.0,9,12,-3
VEN,ECU,2021.0,11,11,0
GUY,FRA,2016.0,2,1,1
PAK,NOR,2018.0,2,3,-1
CHE,SWE,2014.0,44,50,-6
BRA,IND,1999.0,2,6,-4
SLE,USA,2016.0,4,3,1
ARG,GBR,2012.0,11,18,-7
BEL,ETH,2021.0,7,2,5
CHN,THA,2016.0,8,21,-13
ITA,JPN,2019.0,19,18,1
ARG,CHE,2020.0,13,5,8
TUN,ESP,2019.0,4,3,1
GBR,SWE,2002.0,80,80,0
IRN,USA,2001.0,14,9,5
CHE,CZE,2002.0,4,8,-4
PNG,AUS,2009.0,5,4,1
SAU,SWE,2005.0,1,1,0
CHN,CMR,2021.0,5,4,1
CHE,KOR,2011.0,7,8,-1
CAN,ISL,2009.0,2,2,0
THA,KHM,2018.0,3,1,2
RUS,IRQ,2018.0,7,2,5
PHL,CAN,2017.0,2,2,0
CAN,NLD,1998.0,8,6,2
IND,CHE,2022.0,15,16,-1
CHE,LAO,2006.0,1,1,0
AUS,NLD,2006.0,17,43,-26
SWE,FRA,2019.0,69,90,-21
GBR,IND,2005.0,75,102,-27
NZL,BGD,2021.0,3,2,1
BGD,DEU,2019.0,6,6,0
USA,PSE,2016.0,7,4,3
IRN,AFG,2018.0,3,1,2
CHE,TUR,2017.0,11,13,-2
GBR,DNK,2007.0,38,49,-11
ARG,ESP,2008.0,64,58,6
NLD,IRL,2005.0,10,10,0
FIN,GBR,2009.0,54,28,26
ZAF,POL,2012.0,12,3,9
PRT,AUS,2019.0,9,4,5
BGD,CHN,2012.0,8,4,4
USA,VEN,2012.0,14,23,-9
CZE,USA,2007.0,38,37,1
ZAF,ZWE,2005.0,1,14,-13
GBR,BGD,2011.0,13,7,6
GRC,SWE,2022.0,5,6,-1
CAN,ISR,2004.0,27,53,-26
USA,HTI,2011.0,4,1,3
ECU,AUS,2015.0,2,2,0
DNK,NOR,2004.0,19,9,10
KEN,DEU,1999.0,1,1,0
POL,DEU,2013.0,82,120,-38
IRN,GBR,2003.0,16,40,-24
IRN,EGY,2008.0,2,1,1
USA,DOM,2005.0,4,1,3
NER,FRA,2018.0,3,7,-4
CUB,ESP,2005.0,20,13,7
GBR,NGA,2005.0,8,12,-4
SAU,BGD,2018.0,7,4,3
UKR,USA,2009.0,17,16,1
NLD,IRL,2002.0,7,7,0
FRA,GRC,1998.0,5,5,0
USA,OMN,2007.0,8,3,5
GBR,ARE,2007.0,20,9,11
FIN,SWE,2007.0,28,44,-16
HKG,DEU,2003.0,9,8,1
SVN,USA,2003.0,5,15,-10
AUT,SVN,2010.0,2,4,-2
SWE,MEX,2000.0,1,1,0
URY,ARG,2005.0,4,4,0
FRA,DNK,1999.0,12,6,6
KEN,COL,2010.0,1,1,0
FIN,USA,1999.0,50,30,20
TWN,NLD,2015.0,10,3,7
AUT,AUS,2015.0,24,15,9
FRA,RUS,2005.0,31,47,-16
DEU,EST,2000.0,4,1,3
CAN,GRC,2002.0,13,9,4
LTU,SWE,2003.0,2,2,0
CAN,EGY,2004.0,11,12,-1
SDN,DEU,2003.0,2,1,1
JPN,VNM,2002.0,5,3,2
ESP,BRA,2002.0,25,23,2
GBR,TWN,2010.0,40,23,17
PAK,GBR,2003.0,17,23,-6
CAN,ESP,2001.0,19,19,0
BEL,IND,2014.0,17,29,-12
UKR,RUS,2006.0,35,22,13
ESP,JPN,2007.0,8,14,-6
DEU,ARG,2014.0,23,20,3
JPN,VNM,2005.0,9,5,4
CHE,NZL,2008.0,5,4,1
FRA,MLI,2003.0,3,2,1
JPN,ARG,2006.0,2,1,1
CAN,IRL,1999.0,4,3,1
ISR,DEU,2006.0,27,24,3
NOR,CHE,2008.0,7,8,-1
FRA,NOR,2005.0,10,12,-2
DNK,SWE,1997.0,7,6,1
NOR,GBR,2003.0,28,29,-1
DEU,PER,2020.0,7,5,2
DEU,HUN,2017.0,30,48,-18
AUT,BEL,1998.0,3,1,2
CAN,IND,2014.0,66,110,-44
BEL,VNM,2011.0,4,3,1
CAN,JPN,2000.0,23,23,0
DEU,PRT,2003.0,22,14,8
OMN,GBR,2009.0,2,7,-5
NZL,DEU,2015.0,35,22,13
SVN,ESP,2010.0,3,1,2
KOR,TWN,2011.0,9,13,-4
SWE,ITA,1999.0,22,15,7
DEU,IND,1998.0,13,23,-10
MWI,DEU,2009.0,1,2,-1
NPL,IND,2004.0,10,11,-1
SWE,EGY,2017.0,4,5,-1
DNK,ROU,2011.0,2,4,-2
DEU,HKG,2010.0,12,6,6
FRA,NZL,2008.0,13,11,2
ISR,GBR,2001.0,18,29,-11
NLD,IDN,2007.0,7,2,5
PRT,CHE,2013.0,13,14,-1
FRA,BRA,2007.0,57,58,-1
BRN,AUS,2001.0,1,4,-3
IRL,MEX,1998.0,1,1,0
PAK,AUS,2008.0,4,4,0
AUS,BRA,2013.0,18,34,-16
JPN,SWE,1997.0,3,8,-5
ECU,BRA,2020.0,7,18,-11
GBR,HKG,2005.0,18,37,-19
CHE,IRL,2021.0,10,4,6
MEX,CHL,2013.0,19,11,8
JPN,PHL,2012.0,19,12,7
ARE,EGY,2010.0,9,13,-4
NLD,RUS,2006.0,8,19,-11
CAN,CZE,2009.0,8,10,-2
GRC,ESP,2011.0,15,13,2
THA,USA,2013.0,96,190,-94
BEL,CHL,2022.0,4,1,3
ESP,ITA,2011.0,88,183,-95
JPN,KEN,2012.0,5,3,2
ITA,CMR,2017.0,3,1,2
IND,BGD,2006.0,8,4,4
SWE,ISR,2008.0,1,5,-4
RUS,TWN,2008.0,6,2,4
MYS,FRA,2020.0,9,3,6
USA,MAC,2021.0,11,2,9
CAN,LBN,2010.0,6,4,2
IRN,CHE,2009.0,11,3,8
AUT,ARE,2021.0,2,1,1
USA,IDN,2003.0,11,12,-1
IRL,FIN,2021.0,4,5,-1
TUR,CHE,2013.0,9,17,-8
NZL,NOR,2018.0,9,3,6
GMB,DEU,2020.0,1,1,0
JPN,ETH,2016.0,5,2,3
NZL,IND,2015.0,7,9,-2
CHE,ISL,2010.0,1,2,-1
GBR,UGA,2020.0,22,11,11
NPL,CHN,2009.0,1,2,-1
SWE,AUT,2013.0,13,15,-2
CHN,ZAF,2013.0,7,7,0
GBR,TUN,2010.0,3,1,2
BGR,BEL,2013.0,3,4,-1
NLD,NGA,2015.0,4,2,2
ARE,EGY,2017.0,9,12,-3
BRA,DNK,2012.0,7,1,6
AUS,OMN,2013.0,4,1,3
ARG,BEL,2018.0,5,2,3
THA,FRA,2015.0,8,21,-13
ETH,NGA,2011.0,1,1,0
SGP,DEU,2015.0,28,39,-11
MYS,SGP,2019.0,21,11,10
GHA,DEU,2014.0,5,3,2
AUT,ITA,2014.0,24,50,-26
JPN,NZL,2015.0,2,9,-7
DEU,BRA,1999.0,23,8,15
IRL,CHN,2006.0,8,9,-1
BIH,USA,2011.0,2,5,-3
JOR,FIN,2010.0,1,1,0
IND,LKA,2020.0,3,4,-1
SAU,RUS,2019.0,1,5,-4
IRN,BRA,2019.0,12,1,11
IRN,HUN,2018.0,3,1,2
COL,PAN,2016.0,2,2,0
HKG,MAC,2018.0,17,6,11
AZE,DEU,2017.0,2,2,0
PAK,CAN,2022.0,16,9,7
OMN,PAK,2012.0,2,5,-3
FRA,QAT,2015.0,29,5,24
PSE,EGY,2021.0,10,2,8
IRL,IRN,2015.0,3,9,-6
LUX,DEU,2011.0,4,32,-28
ARG,PRI,2011.0,2,1,1
ETH,ZAF,2016.0,3,7,-4
ISL,ESP,2019.0,2,1,1
DZA,FRA,2022.0,26,9,17
NGA,BEL,2017.0,3,2,1
ROU,USA,2004.0,19,11,8
CHE,LUX,2004.0,1,1,0
UKR,POL,2001.0,17,10,7
ESP,BRA,2005.0,28,24,4
CHN,AUS,2001.0,37,19,18
GTM,USA,2011.0,4,4,0
BGD,DEU,2010.0,3,2,1
FRA,TUR,2017.0,25,16,9
ARG,CZE,2020.0,3,2,1
ITA,SAU,2013.0,13,3,10
SWE,UKR,2007.0,9,2,7
GUF,FRA,2010.0,9,15,-6
IRN,NLD,2014.0,31,11,20
BEN,SEN,2017.0,1,2,-1
FRA,TUR,2019.0,18,17,1
CHE,GMB,2018.0,2,2,0
JPN,IRL,2012.0,3,5,-2
CUB,AUT,2017.0,2,1,1
UKR,FRA,2021.0,7,2,5
PRT,AUS,2010.0,2,5,-3
CAN,BRA,1998.0,9,1,8
ZAF,IND,2007.0,9,11,-2
DEU,MYS,2011.0,7,7,0
POL,NZL,2014.0,9,2,7
COD,COG,2012.0,5,4,1
BRA,CHL,2001.0,5,4,1
NLD,LTU,2021.0,2,1,1
JPN,NLD,2022.0,10,11,-1
NLD,TWN,2015.0,3,10,-7
AUT,EGY,2006.0,4,1,3
TUR,AUS,2015.0,5,10,-5
SWE,SAU,2018.0,8,4,4
TUR,BEL,2017.0,11,11,0
ESP,LUX,2017.0,7,4,3
MEX,IND,2016.0,6,14,-8
OMN,DEU,2020.0,1,3,-2
ARG,CHL,2012.0,15,15,0
GBR,SRB,2019.0,6,8,-2
FRA,SRB,2018.0,4,10,-6
THA,PAK,2016.0,7,4,3
SAU,KOR,2020.0,12,27,-15
USA,MOZ,2010.0,2,2,0
SWE,EGY,2019.0,3,6,-3
GBR,CZE,2002.0,22,28,-6
IND,ERI,2008.0,4,2,2
GHA,CHN,2020.0,18,32,-14
ESP,GRC,2021.0,10,8,2
AZE,RUS,2020.0,5,4,1
GBR,SRB,2017.0,8,9,-1
BGD,DEU,2017.0,6,12,-6
IRL,FRA,1998.0,2,1,1
TUR,ITA,2022.0,9,3,6
GBR,VEN,2017.0,2,1,1
TJK,USA,2015.0,1,1,0
ESP,NOR,2003.0,5,5,0
ZAF,CAN,2006.0,13,11,2
GBR,CUB,2002.0,3,2,1
CAN,GRC,2005.0,9,7,2
PRI,ESP,2016.0,2,2,0
IND,KEN,2003.0,3,4,-1
MYS,LBY,2015.0,6,1,5
UGA,CHE,2011.0,2,2,0
GRC,CYP,2009.0,25,11,14
CAN,ARG,2012.0,11,17,-6
BEL,POL,2003.0,8,9,-1
NLD,ZWE,2008.0,2,1,1
FIN,LVA,2020.0,1,1,0
UGA,JPN,2012.0,1,2,-1
IND,HUN,1999.0,3,1,2
TWN,BEL,2015.0,6,1,5
NOR,RUS,2001.0,9,7,2
BEL,ECU,2005.0,1,1,0
GAB,DEU,2018.0,3,6,-3
DZA,USA,2015.0,2,3,-1
COG,ZAF,2019.0,1,4,-3
ARG,VEN,2020.0,2,11,-9
SWE,COL,2014.0,4,1,3
COL,SWE,2018.0,5,6,-1
CHE,TUR,2010.0,12,8,4
ITA,THA,2007.0,2,1,1
PAK,SAU,2006.0,4,11,-7
GEO,USA,2010.0,12,7,5
IDN,HRV,2008.0,1,1,0
ETH,DEU,2012.0,7,8,-1
ROU,ESP,2009.0,7,3,4
CHN,ECU,2018.0,2,3,-1
BEL,BGR,2012.0,4,8,-4
IRL,NOR,2007.0,4,1,3
DEU,SYR,2015.0,4,6,-2
KOR,POL,2012.0,3,2,1
LUX,USA,2016.0,6,9,-3
CHL,BEL,2015.0,10,7,3
ARM,DEU,2012.0,4,3,1
ZAF,CHL,2018.0,2,4,-2
DEU,HRV,2013.0,3,12,-9
SYR,GBR,2018.0,5,3,2
JAM,USA,2012.0,3,6,-3
EST,USA,2020.0,9,7,2
CHN,PRT,2012.0,7,9,-2
ARE,MAR,2018.0,1,2,-1
URY,ARG,2002.0,2,3,-1
SWE,HUN,2001.0,3,12,-9
CHE,LTU,2005.0,2,1,1
TUN,SAU,2004.0,1,1,0
BEL,IRL,2016.0,8,10,-2
PHL,TWN,2016.0,3,4,-1
NLD,HUN,2020.0,5,8,-3
TUN,ESP,2017.0,5,6,-1
IDN,GBR,2014.0,9,14,-5
CHN,ISR,2003.0,6,7,-1
PAK,OMN,2022.0,7,2,5
KEN,ETH,2010.0,3,4,-1
URY,CHL,2021.0,2,1,1
BEL,MEX,2006.0,3,2,1
DNK,TZA,2013.0,3,3,0
EGY,PSE,2006.0,6,2,4
BEL,TUR,2008.0,4,2,2
LBN,GBR,2019.0,6,4,2
ITA,SGP,2011.0,6,1,5
LUX,SWE,2014.0,1,3,-2
NPL,USA,2004.0,4,6,-2
CMR,DEU,2004.0,4,2,2
USA,ZMB,2013.0,8,9,-1
TUR,ROU,2008.0,1,1,0
RUS,ROU,2000.0,2,1,1
KOR,ITA,2003.0,6,1,5
CZE,TWN,2013.0,1,2,-1
POL,GRC,2016.0,2,3,-1
VEN,ARG,2002.0,2,1,1
ZAF,ITA,2006.0,5,3,2
PRI,IND,2015.0,1,2,-1
URY,ESP,2018.0,6,21,-15
IRQ,CHN,2011.0,2,2,0
BEL,PSE,2019.0,3,1,2
SAU,IDN,2020.0,6,1,5
TZA,CHN,2016.0,3,1,2
VNM,CHN,2015.0,6,10,-4
TUR,SAU,2020.0,3,4,-1
USA,BFA,2015.0,4,2,2
COG,ZAF,2017.0,1,2,-1
HKG,FRA,2017.0,4,14,-10
CHL,ARG,2022.0,5,15,-10
RUS,CHE,2001.0,16,22,-6
NOR,ITA,2001.0,9,3,6
CZE,BGR,2017.0,2,1,1
FIN,DNK,2001.0,7,7,0
KOR,ESP,2007.0,2,2,0
IRL,BGD,2005.0,2,1,1
GBR,ISR,2001.0,29,18,11
HUN,AUT,2000.0,5,3,2
CHE,SVK,2006.0,2,3,-1
UKR,NLD,2003.0,3,1,2
ARE,FRA,2012.0,1,7,-6
DNK,BEL,2003.0,5,4,1
NZL,CHE,2003.0,7,5,2
COL,PRI,2007.0,2,1,1
AUS,FIN,2001.0,3,3,0
RUS,DNK,2000.0,4,3,1
NGA,BRA,2009.0,2,1,1
NZL,KOR,2006.0,3,4,-1
AUT,MEX,2001.0,1,1,0
AUT,BEL,1997.0,1,1,0
AUT,DNK,2001.0,1,1,0
MEX,VEN,2003.0,4,2,2
SGP,MAC,2018.0,2,3,-1
HRV,AUS,2015.0,2,1,1
UKR,SVK,2016.0,5,1,4
IRN,AUT,2007.0,2,2,0
RUS,IRL,2008.0,5,1,4
USA,SYR,2014.0,3,7,-4
TUN,ESP,2010.0,2,3,-1
EGY,KOR,2015.0,5,7,-2
KEN,DNK,2009.0,2,1,1
JPN,HUN,2018.0,6,1,5
BOL,USA,2009.0,3,2,1
BEN,USA,2011.0,1,1,0
CUB,MEX,2022.0,5,3,2
FRA,SAU,2004.0,6,1,5
SEN,USA,2011.0,7,1,6
DNK,HKG,2014.0,3,2,1
UZB,FRA,2015.0,3,2,1
TUN,QAT,2017.0,5,1,4
CRI,MEX,2017.0,5,3,2
ARE,EGY,2019.0,4,15,-11
ISR,FIN,2003.0,2,2,0
IND,MEX,2013.0,7,4,3
AUT,IDN,2011.0,2,2,0
ZWE,KEN,2006.0,1,2,-1
DEU,BLR,2001.0,9,10,-1
MDG,FRA,2015.0,10,11,-1
JPN,POL,2005.0,2,9,-7
ISR,DNK,2009.0,5,1,4
MYS,DEU,2011.0,7,7,0
AUS,SRB,2018.0,1,3,-2
IRN,NZL,2017.0,12,9,3
IRL,GHA,2019.0,2,1,1
IND,NGA,2002.0,4,2,2
PHL,CAN,2019.0,8,2,6
ITA,ISR,2012.0,13,6,7
CHE,MEX,2004.0,6,1,5
IND,ISR,1999.0,8,4,4
FRA,OMN,2007.0,2,2,0
CHN,NLD,2000.0,10,1,9
NLD,TUR,2009.0,6,16,-10
MYS,USA,1998.0,1,2,-1
FIN,RUS,2007.0,4,13,-9
NGA,FRA,2006.0,2,1,1
CZE,JPN,2011.0,5,9,-4
FIN,VNM,2011.0,1,1,0
ISL,DEU,2014.0,3,2,1
CHE,CZE,2005.0,5,10,-5
SGP,NOR,2021.0,3,3,0
ITA,CHL,2009.0,8,6,2
NOR,NLD,2004.0,5,14,-9
MAR,DEU,2004.0,1,4,-3
ARM,FRA,2014.0,1,2,-1
DEU,PSE,2006.0,2,4,-2
QAT,DEU,2016.0,3,4,-1
USA,GAB,2019.0,4,4,0
KOR,BGD,2001.0,1,2,-1
TWN,SAU,2017.0,3,3,0
LUX,AUS,2020.0,4,1,3
DEU,LBN,2021.0,1,5,-4
SVN,AUT,2006.0,1,1,0
PRT,LUX,2014.0,3,1,2
LUX,CHE,2016.0,3,5,-2
HKG,IRL,2011.0,2,1,1
ITA,SMR,2017.0,2,1,1
CZE,EST,2022.0,1,1,0
ZMB,JPN,2000.0,1,1,0
USA,JAM,2021.0,3,3,0
USA,MOZ,2017.0,3,4,-1
MDA,FRA,2008.0,1,2,-1
CHE,TZA,2011.0,1,4,-3
CAN,BRA,1997.0,2,8,-6
BGR,FIN,2013.0,2,1,1
IDN,CZE,2019.0,2,1,1
IDN,JPN,2000.0,1,7,-6
PAK,JPN,2009.0,3,11,-8
CAN,COG,2018.0,1,1,0
TUR,HUN,2006.0,1,1,0
FRA,MDA,2019.0,2,1,1
TWN,KOR,2006.0,4,5,-1
MKD,DEU,2016.0,4,2,2
KHM,GBR,2012.0,1,2,-1
IND,BWA,2001.0,1,1,0
GRC,POL,2015.0,2,5,-3
VNM,FRA,2006.0,1,12,-11
MEX,JPN,2018.0,8,7,1
ITA,PAK,2021.0,8,22,-14
EST,CHE,2018.0,5,4,1
TWN,IRN,2019.0,1,4,-3
CAN,SVK,2004.0,2,1,1
LTU,ITA,2017.0,2,1,1
ZWE,COG,2019.0,2,1,1
EST,RUS,2016.0,3,1,2
LUX,GBR,2002.0,2,1,1
RWA,USA,2004.0,1,1,0
GBR,SAU,2000.0,6,3,3
BEN,DEU,2004.0,1,2,-1
ROU,GRC,2004.0,2,1,1
BEL,HUN,1999.0,2,3,-1
KOR,GHA,2016.0,1,1,0
TUN,USA,2000.0,2,2,0
CHE,PRT,2005.0,4,4,0
IND,FIN,2007.0,2,3,-1
VNM,CHE,2005.0,1,1,0
GBR,BIH,2014.0,1,2,-1
NLD,BLR,2008.0,1,1,0
SDN,QAT,2017.0,1,1,0
SWE,PER,2010.0,1,1,0
BEL,THA,2009.0,1,1,0
GRC,DNK,2008.0,4,6,-2
GBR,TTO,2013.0,2,2,0
ESP,KOR,2020.0,2,11,-9
GBR,IDN,2000.0,2,1,1
ETH,FRA,2020.0,2,3,-1
CZE,NLD,2022.0,2,4,-2
LKA,JPN,2021.0,2,4,-2
URY,FRA,2009.0,1,5,-4
LAO,FRA,2009.0,2,1,1
BRA,UKR,2018.0,2,4,-2
ITA,VNM,2009.0,3,3,0
DNK,URY,2009.0,1,1,0
ZAF,FIN,2011.0,1,1,0
ETH,KOR,2014.0,2,2,0
SWE,MYS,2006.0,1,1,0
AUT,CHL,2017.0,2,1,1
GBR,TUN,2017.0,1,5,-4
SGP,GBR,2000.0,6,15,-9
JOR,JPN,2014.0,2,3,-1
KEN,IND,2010.0,1,1,0
PER,PRI,2010.0,1,1,0
SWE,JOR,2015.0,2,1,1
KEN,MWI,2012.0,1,1,0
RUS,BGR,2002.0,2,6,-4
SGP,FRA,2001.0,2,1,1
BGR,GBR,2008.0,2,6,-4
UGA,SWE,2009.0,1,2,-1
SWE,EGY,2010.0,2,2,0
BWA,CAN,2016.0,1,1,0
FIN,SGP,2021.0,1,2,-1
JPN,PRT,2020.0,5,2,3
GBR,MWI,1999.0,1,1,0
MYS,NZL,2007.0,3,2,1
NOR,TZA,2016.0,5,3,2
COL,SAU,2017.0,1,2,-1
NZL,SVK,2018.0,2,1,1
LKA,OMN,2015.0,1,2,-1
CZE,CHN,2015.0,4,4,0
MYS,TUR,2022.0,5,3,2
ETH,KEN,2021.0,3,2,1
ZAF,CHN,2012.0,4,3,1
GBR,VEN,2010.0,1,5,-4
KHM,AUS,2012.0,3,1,2
ARG,JPN,2001.0,1,2,-1
BRA,ZAF,2011.0,1,5,-4
SAU,BEL,2014.0,1,4,-3
VNM,FIN,2011.0,1,1,0
NLD,SRB,2010.0,2,1,1
MLT,ITA,2015.0,3,2,1
TUN,ITA,2022.0,4,5,-1
TWN,RUS,2003.0,1,4,-3
CHN,DZA,2022.0,4,1,3
LIE,DEU,2021.0,1,2,-1
EGY,KEN,2018.0,1,1,0
IRQ,NGA,2021.0,1,1,0
CHE,JOR,2017.0,3,1,2
THA,NZL,2011.0,1,4,-3
COG,CHE,2022.0,1,3,-2
WSM,AUS,2014.0,1,2,-1
CRI,MEX,2019.0,3,2,1
FIN,ITA,2000.0,2,3,-1
ISL,SWE,2007.0,4,11,-7
FRA,EST,1999.0,1,2,-1
DEU,SRB,2001.0,2,11,-9
IND,CHL,2001.0,1,2,-1
FRA,LUX,2001.0,1,1,0
RUS,BGR,2005.0,1,3,-2
NER,NGA,2012.0,1,1,0
PER,DEU,2007.0,3,1,2
BRA,CHN,2011.0,4,4,0
IRN,BRA,2010.0,3,1,2
FIN,ZAF,2018.0,3,4,-1
DEU,CIV,2016.0,2,1,1
AUT,SVN,2017.0,3,7,-4
IRN,TUN,2019.0,1,1,0
IDN,IND,2015.0,2,6,-4
DEU,PRI,2014.0,1,1,0
IRN,SWE,2003.0,1,2,-1
DNK,GRL,2018.0,2,5,-3
SWZ,ZAF,2011.0,1,1,0
SVN,MKD,2011.0,1,1,0
NLD,BFA,2004.0,1,1,0
UKR,NOR,2019.0,2,2,0
BRA,KEN,2006.0,1,1,0
GHA,SWE,2003.0,1,1,0
AUT,ECU,2022.0,1,1,0
ROU,SRB,2012.0,1,1,0
PRT,AUT,2013.0,2,4,-2
SDN,QAT,2010.0,1,1,0
EGY,ZAF,2015.0,2,2,0
FRA,SVK,2020.0,4,2,2
NZL,TWN,2020.0,1,2,-1
BOL,BEL,2013.0,2,1,1
JPN,SAU,2001.0,1,1,0
BEL,SVK,2009.0,2,2,0
BEL,SAU,2013.0,2,1,1
HRV,TUR,2007.0,1,1,0
SLV,MEX,2011.0,1,1,0
MOZ,NLD,2016.0,2,1,1
PRT,GRC,2009.0,2,1,1
EST,LVA,2014.0,2,1,1
POL,PRT,1997.0,1,2,-1
IRQ,MYS,2011.0,2,14,-12
PHL,CHN,2008.0,2,2,0
CAN,UGA,2016.0,1,4,-3
NOR,PRT,2013.0,2,4,-2
URY,CAN,2012.0,1,2,-1
CHE,IDN,2015.0,1,1,0
SAU,SDN,2001.0,1,2,-1
SAU,NGA,2001.0,1,1,0
MAR,AUT,2014.0,1,1,0
UZB,KAZ,2019.0,1,5,-4
USA,MOZ,2019.0,2,1,1
UZB,KAZ,2017.0,2,1,1
BGD,SWE,2001.0,1,1,0
BEL,TUN,2015.0,4,3,1
HKG,NOR,2006.0,1,1,0
EGY,FRA,2001.0,1,1,0
SLE,NGA,2020.0,1,1,0
TWN,POL,2007.0,1,2,-1
NGA,AUS,2005.0,1,2,-1
PER,AUT,2009.0,1,1,0
ARE,CHE,2011.0,1,3,-2
LKA,NPL,2009.0,2,1,1
GBR,YEM,2017.0,1,2,-1
CHN,CHL,2002.0,2,1,1
CZE,IND,2009.0,2,5,-3
CZE,SRB,2021.0,1,2,-1
NLD,SRB,2017.0,1,6,-5
GRC,CZE,2012.0,3,1,2
BFA,JPN,2013.0,1,1,0
CAN,VNM,2011.0,2,1,1
GBR,KAZ,2014.0,3,4,-1
SEN,GIN,2004.0,1,1,0
GBR,MMR,2021.0,1,2,-1
RUS,GRC,2007.0,1,3,-2
LBY,GBR,2004.0,1,3,-2
BRN,MYS,2015.0,2,5,-3
EGY,DZA,2005.0,1,1,0
NOR,NPL,2015.0,2,2,0
BWA,SWZ,2015.0,1,1,0
NOR,SGP,2020.0,1,4,-3
MYS,ITA,2019.0,2,1,1
ECU,CRI,2019.0,1,4,-3
NLD,TZA,2012.0,1,1,0
KEN,COL,2017.0,1,2,-1
CAN,BHR,2019.0,1,2,-1
NZL,ESP,2000.0,1,1,0
POL,IRN,2020.0,1,20,-19
AUT,ZAF,2007.0,1,3,-2
TUR,IND,2022.0,2,8,-6
CAN,MCO,2020.0,1,1,0
ERI,USA,2011.0,1,1,0
ROU,KOR,2016.0,1,2,-1
MUS,CAN,2002.0,1,1,0
KOR,UZB,2015.0,1,2,-1
SDN,QAT,2019.0,1,1,0
NER,DEU,2012.0,1,1,0
HRV,BIH,2001.0,1,2,-1
HRV,NLD,2004.0,1,3,-2
ISR,POL,1999.0,1,1,0
POL,PAN,1999.0,1,1,0
PRY,USA,2015.0,1,3,-2
LTU,POL,2011.0,1,1,0
PRT,JPN,2005.0,1,1,0
LKA,EGY,2018.0,1,1,0
HKG,ESP,2018.0,1,1,0
PHL,BGD,2018.0,1,1,0
FRA,PAK,2005.0,1,2,-1
BWA,ZWE,2006.0,1,3,-2
ITA,CMR,2010.0,1,2,-1
KEN,TZA,2022.0,1,2,-1
KEN,NLD,2007.0,1,3,-2
UKR,GEO,2020.0,1,1,0
SWZ,NGA,2018.0,1,3,-2
TTO,JAM,2018.0,1,2,-1
JAM,ARE,2018.0,1,1,0
BGR,AUS,2004.0,1,1,0
HKG,BGD,2012.0,2,2,0
TWN,MNG,2020.0,1,1,0
ETH,JPN,2018.0,1,3,-2
THA,HKG,2022.0,1,2,-1
THA,IND,2013.0,2,9,-7
KWT,CAN,2013.0,2,7,-5
SDN,EGY,2014.0,1,3,-2
IRL,QAT,2021.0,1,1,0
PRI,CHN,2003.0,1,1,0
FRA,SWE,2005.0,29,36,-7
GBR,JPN,2020.0,119,90,29
LBN,SAU,2008.0,5,1,4
USA,MEX,2006.0,133,159,-26
IND,USA,2015.0,901,742,159
DEU,HKG,2017.0,14,14,0
MEX,DEU,2012.0,28,23,5
GBR,SWE,2005.0,71,82,-11
SRB,CHE,2004.0,3,1,2
CAN,CHL,2014.0,22,18,4
DEU,SGP,2016.0,41,36,5
DEU,HUN,2019.0,30,45,-15
AUT,FRA,2021.0,24,45,-21
MYS,JPN,2015.0,33,63,-30
USA,ECU,2018.0,29,26,3
CHN,SWE,2018.0,94,90,4
FRA,AUT,2021.0,45,24,21
LVA,SWE,2013.0,5,4,1
SWE,CHN,2010.0,50,61,-11
USA,GHA,2020.0,25,34,-9
CAN,LBN,2017.0,6,12,-6
FRA,MTQ,2020.0,10,19,-9
ISR,SGP,2019.0,7,6,1
GUF,FRA,2019.0,24,18,6
FRA,SWE,2002.0,45,47,-2
USA,MYS,2021.0,22,25,-3
OMN,ARE,2020.0,4,1,3
DEU,RUS,2019.0,75,124,-49
CHN,KOR,2008.0,68,63,5
RUS,UKR,1999.0,31,20,11
SAU,TUN,2022.0,23,47,-24
ITA,BEL,2005.0,28,42,-14
CHN,IND,2013.0,18,38,-20
ESP,MEX,2006.0,63,59,4
GBR,CZE,2005.0,10,18,-8
GBR,IND,2002.0,50,83,-33
MYS,SGP,2017.0,24,14,10
BFA,FRA,2004.0,6,3,3
CAN,NLD,1997.0,6,3,3
SAU,LBN,2010.0,2,3,-1
FIN,CAN,2005.0,17,11,6
FIN,AUS,2004.0,11,3,8
NLD,SWE,2021.0,41,49,-8
TUR,SWE,2007.0,2,4,-2
PAK,BRA,2016.0,3,8,-5
SAU,LBN,2019.0,3,3,0
ETH,CAN,2018.0,6,2,4
IRQ,AUS,2021.0,8,14,-6
CAN,LBN,2019.0,16,15,1
AUS,LBN,2021.0,3,3,0
TUN,QAT,2019.0,8,1,7
DEU,IND,1997.0,13,11,2
IDN,MYS,2021.0,21,42,-21
USA,PRI,2008.0,60,50,10
USA,BMU,2011.0,3,4,-1
DEU,CZE,2013.0,30,28,2
CHE,LKA,2005.0,1,1,0
AUT,HRV,2016.0,4,6,-2
SVN,ITA,2020.0,10,7,3
GBR,NGA,2002.0,14,21,-7
ESP,BGR,2011.0,2,6,-4
NLD,MEX,2001.0,2,2,0
GBR,SRB,2010.0,7,7,0
SWE,IND,2009.0,9,27,-18
THA,PHL,2011.0,4,1,3
CAN,NOR,2003.0,4,7,-3
MEX,ARG,2004.0,6,10,-4
MLT,GBR,2001.0,1,5,-4
FRA,NOR,2002.0,21,13,8
THA,MYS,2008.0,2,2,0
THA,FIN,2010.0,2,1,1
ZAF,CMR,2015.0,7,6,1
DNK,ZAF,2016.0,4,4,0
IRN,DNK,2013.0,7,3,4
CHE,ISL,2019.0,6,1,5
ESP,CZE,2013.0,18,5,13
ZAF,UGA,2015.0,6,7,-1
RUS,SWE,2013.0,18,13,5
ETH,ESP,2013.0,1,1,0
CHL,CHE,2015.0,7,9,-2
PAK,IND,2009.0,10,12,-2
TUR,NGA,2017.0,4,4,0
GBR,UKR,2014.0,4,15,-11
GRC,JPN,2006.0,2,9,-7
PRT,CHN,2021.0,10,9,1
RUS,POL,2013.0,3,11,-8
JPN,BEL,2009.0,14,10,4
ISR,SGP,2017.0,4,5,-1
IRQ,USA,2016.0,14,14,0
ARE,AUS,2021.0,17,14,3
AUS,ARG,2014.0,4,13,-9
MYS,RUS,2016.0,4,1,3
CAN,MYS,2020.0,9,25,-16
DNK,SWE,1998.0,16,15,1
BEL,AUS,2022.0,6,16,-10
DEU,GEO,2008.0,9,3,6
USA,EST,2014.0,5,10,-5
CAN,NZL,2001.0,14,25,-11
GBR,KWT,2014.0,19,1,18
AUS,AUT,2004.0,11,13,-2
MYS,ITA,2017.0,8,2,6
NLD,THA,2007.0,4,3,1
NLD,IRN,2006.0,5,3,2
PRT,SVN,2015.0,2,2,0
MAR,USA,2001.0,4,2,2
CHE,CYP,2011.0,3,1,2
FRA,KAZ,2009.0,1,1,0
CZE,PAK,2022.0,4,2,2
ESP,LUX,2010.0,3,1,2
SVN,ESP,2019.0,6,4,2
KOR,AUT,2021.0,3,3,0
NPL,JPN,2018.0,4,12,-8
ERI,IND,2008.0,2,4,-2
NLD,COL,2011.0,4,4,0
CHE,ROU,2018.0,3,5,-2
IND,IDN,2018.0,4,4,0
CAN,CRI,2015.0,3,4,-1
CHE,THA,2006.0,2,1,1
KOR,RUS,2000.0,2,2,0
ZAF,IRL,2011.0,2,4,-2
CAN,BHR,2017.0,1,1,0
HKG,NZL,2011.0,3,1,2
GBR,LBN,2014.0,8,4,4
PRT,UKR,2004.0,1,1,0
BRA,AUT,2004.0,4,2,2
DZA,BEL,2004.0,3,2,1
RUS,EST,2022.0,2,1,1
FIN,HKG,2012.0,1,3,-2
SAU,LBN,2017.0,4,3,1
FIN,MDA,2006.0,1,2,-1
JPN,UKR,2000.0,2,8,-6
ARE,ESP,2012.0,1,2,-1
SAU,IND,2006.0,5,9,-4
ZAF,ZWE,2002.0,2,8,-6
JAM,TTO,2020.0,1,1,0
KWT,GBR,2011.0,4,10,-6
NOR,ETH,2011.0,3,2,1
PAK,DEU,2001.0,4,1,3
USA,GUY,2008.0,1,1,0
NZL,CHL,2008.0,1,1,0
ARM,ITA,2014.0,1,1,0
BHR,USA,2015.0,1,4,-3
TWN,SAU,2019.0,2,7,-5
ARM,RUS,2003.0,4,4,0
KOR,NZL,2004.0,3,1,2
IRL,IND,2004.0,2,6,-4
FJI,GBR,2014.0,2,5,-3
AUT,CHL,2019.0,2,3,-1
FRA,PAK,2002.0,1,2,-1
TGO,BEN,2010.0,1,1,0
FIN,BRA,2021.0,2,18,-16
SGP,BEL,2018.0,3,3,0
CZE,ISR,2014.0,1,1,0
CZE,ROU,2009.0,1,1,0
MYS,ITA,2010.0,2,1,1
GBR,FJI,2016.0,1,3,-2
ARE,SRB,2022.0,2,1,1
NLD,SRB,2019.0,1,7,-6
AUS,TTO,2007.0,1,1,0
ESP,PAN,2012.0,2,1,1
IRL,LUX,2020.0,1,2,-1
BEL,GHA,2007.0,1,2,-1
FRA,GRC,1997.0,2,1,1
SRB,NLD,2003.0,1,1,0
UKR,ISR,2003.0,1,3,-2
NLD,KEN,1999.0,1,2,-1
JPN,MMR,2022.0,1,2,-1
,BIH,2015.0,245,0,245
HKG,,2013.0,850,0,850
CHE,,2015.0,3035,0,3035
,FIN,2005.0,1903,0,1903
ESP,,2019.0,12595,0,12595
,TZA,2004.0,177,0,177
,FIN,2002.0,2016,0,2016
,NLD,2000.0,6718,0,6718
,LBN,2004.0,231,0,231
FIN,,2020.0,2380,0,2380
ESP,,2010.0,5547,0,5547
NZL,,2023.0,5608,0,5608
TUN,,2015.0,599,0,599
,THA,2008.0,2309,0,2309
NLD,,2016.0,4133,0,4133
,TUN,1999.0,870,0,870
,ZAF,1995.0,729,0,729
ESP,,2017.0,9819,0,9819
IDN,,2021.0,3384,0,3384
,NZL,1998.0,2398,0,2398
,ARG,2006.0,2311,0,2311
,AUT,2001.0,2137,0,2137
,ARM,2004.0,117,0,117
SVK,,2019.0,910,0,910
NPL,,2016.0,110,0,110
EST,,2006.0,53,0,53
ISL,,2017.0,98,0,98
,CHL,2011.0,1995,0,1995
BLR,,2023.0,1232,0,1232
SGP,SAU,2012.0,4,0,4
,IRN,2009.0,11963,0,11963
SWE,LBY,2017.0,3,0,3
,POL,2010.0,5983,0,5983
,IDN,2000.0,271,0,271
,NZL,1997.0,513,0,513
SVK,,2010.0,313,0,313
KWT,,2022.0,446,0,446
LKA,,2010.0,45,0,45
,BGR,2011.0,554,0,554
,LVA,2003.0,97,0,97
,LBN,1996.0,38,0,38
UGA,,2023.0,1203,0,1203
MNG,,2020.0,48,0,48
TLS,,2008.0,1,0,1
BRA,,1999.0,66,0,66
EGY,TWN,2012.0,2,0,2
,MNG,2008.0,56,0,56
SVK,,2017.0,652,0,652
SVN,,2006.0,112,0,112
MEX,CHN,2011.0,2,0,2
DZA,,2016.0,378,0,378
,GRD,2004.0,10,0,10
ISL,,2019.0,128,0,128
GLP,,2014.0,4,0,4
,POL,2017.0,5497,0,5497
ITA,BEN,2005.0,1,0,1
,POL,2019.0,2778,0,2778
ZWE,,2022.0,177,0,177
LAO,,2015.0,16,0,16
BEL,,2007.0,1104,0,1104
LKA,,2017.0,119,0,119
,BEN,2010.0,104,0,104
,CRI,2007.0,88,0,88
URY,,2018.0,152,0,152
,SWE,2016.0,3264,0,3264
,ROU,2012.0,2032,0,2032
GEO,,2018.0,155,0,155
,GHA,2009.0,315,0,315
LKA,,2019.0,179,0,179
,EGY,2015.0,3388,0,3388
PRY,DEU,2014.0,2,0,2
,NGA,2014.0,1699,0,1699
MDG,DEU,2014.0,5,0,5
RWA,,2021.0,71,0,71
ETH,,2020.0,407,0,407
DEU,BIH,2011.0,5,0,5
BEN,,2022.0,174,0,174
MAR,,2025.0,92,0,92
,IRQ,2014.0,1003,0,1003
BGD,,2002.0,12,0,12
LSO,,2020.0,12,0,12
,LAO,2012.0,37,0,37
,GAB,2012.0,30,0,30
,CMR,2014.0,417,0,417
,JAM,2014.0,30,0,30
,ECU,2007.0,97,0,97
ECU,ARG,2021.0,2,0,2
,MCO,2013.0,6,0,6
SLE,,2015.0,3,0,3
TGO,DEU,2018.0,1,0,1
TTO,,2012.0,31,0,31
ARG,,2003.0,245,0,245
,KGZ,2016.0,47,0,47
,AZE,2008.0,208,0,208
,COD,2018.0,65,0,65
COL,DNK,2022.0,2,0,2
IND,NGA,2005.0,5,0,5
,LBY,2008.0,59,0,59
PRT,TWN,2009.0,1,0,1
CRI,ARG,2016.0,3,0,3
,PNG,2016.0,18,0,18
,PLW,2015.0,3,0,3
,MKD,2018.0,70,0,70
VEN,,2004.0,113,0,113
,MLT,1995.0,7,0,7
DEU,MCO,2004.0,1,0,1
ISL,,2010.0,50,0,50
DEU,LBY,2013.0,1,0,1
GBR,ALB,2015.0,1,0,1
ITA,CMR,2019.0,3,0,3
UKR,KOR,2014.0,4,0,4
,BHR,2012.0,69,0,69
MYS,LAO,2006.0,3,0,3
NCL,,2021.0,34,0,34
MKD,,2012.0,23,0,23
,TTO,2013.0,34,0,34
EST,POL,2019.0,1,0,1
SEN,CHN,2018.0,1,0,1
ETH,SYR,2009.0,1,0,1
CMR,LBR,2020.0,1,0,1
RUS,CZE,2000.0,2,0,2
IRN,IRQ,2013.0,4,0,4
AFG,MYS,2019.0,1,0,1
BRA,KNA,2021.0,1,0,1
AZE,,2007.0,41,0,41
,MLI,1999.0,39,0,39
ARM,,2008.0,56,0,56
HRV,,2007.0,242,0,242
FRA,ZWE,2004.0,1,0,1
KEN,,2006.0,35,0,35
,QAT,2000.0,62,0,62
JOR,,2006.0,43,0,43
TUN,BRA,2011.0,1,0,1
BEL,IDN,2009.0,3,0,3
,MDG,1999.0,43,0,43
,GUM,1999.0,10,0,10
CMR,,2007.0,28,0,28
CHE,ARM,2005.0,1,0,1
,TJK,2013.0,14,0,14
NAM,USA,2004.0,2,0,2
,ARM,1996.0,90,0,90
YEM,GRC,2012.0,1,0,1
CHE,COG,2003.0,1,0,1
MCO,,2018.0,11,0,11
BGR,CHE,2011.0,6,0,6
RUS,MDA,2000.0,2,0,2
ISL,ESP,2017.0,3,0,3
BGD,,2005.0,53,0,53
,OMN,1994.0,34,0,34
POL,NCL,2005.0,1,0,1
,TZA,1996.0,25,0,25
SRB,CAN,1999.0,2,0,2
ZWE,BRB,2004.0,1,0,1
GRC,HUN,2003.0,1,0,1
AZE,TUR,1997.0,3,0,3
GBR,MAR,2014.0,2,0,2
HUN,BRA,1999.0,1,0,1
DEU,VEN,1998.0,2,0,2
IRL,GRC,1999.0,2,0,2
KWT,BGD,2008.0,1,0,1
DNK,BLR,2006.0,1,0,1
SDN,TWN,2013.0,1,0,1
THA,IRN,2007.0,1,0,1
DEU,ARE,2001.0,1,0,1
LTU,RUS,2009.0,2,0,2
TUR,ECU,2017.0,1,0,1
PRY,ITA,2009.0,1,0,1
ARG,ROU,2015.0,1,0,1
ARG,POL,2013.0,2,0,2
KEN,ZWE,2013.0,3,0,3
NLD,GHA,2013.0,3,0,3
,MWI,2007.0,60,0,60
POL,ISL,2012.0,1,0,1
THA,LAO,2009.0,2,0,2
HUN,EST,2015.0,1,0,1
BRA,NER,2013.0,1,0,1
TJK,,2014.0,6,0,6
IRN,HKG,2021.0,7,0,7
BRN,,2016.0,29,0,29
USA,BIH,2013.0,2,0,2
TWN,SAU,2010.0,1,0,1
JOR,GRC,2009.0,1,0,1
ARE,LUX,2008.0,1,0,1
ROU,CZE,2015.0,2,0,2
MDV,ITA,2019.0,1,0,1
BEL,TWN,2002.0,1,0,1
ZAF,RWA,2018.0,10,0,10
LKA,CHN,2007.0,2,0,2
ISL,POL,2019.0,2,0,2
,BEN,2017.0,133,0,133
CHN,LVA,2012.0,1,0,1
NPL,CHE,2018.0,6,0,6
MYS,FIN,2020.0,2,0,2
CHL,NZL,2002.0,1,0,1
DEU,LBR,2021.0,1,0,1
IRN,ZAF,2013.0,8,0,8
BLR,GBR,2011.0,2,0,2
IRN,PRT,2010.0,3,0,3
UGA,RWA,2014.0,2,0,2
GBR,AZE,2020.0,2,0,2
VUT,,2012.0,1,0,1
TUN,EGY,2020.0,1,0,1
IRQ,CAN,2013.0,1,0,1
IND,AFG,2020.0,1,0,1
LVA,MLT,2017.0,1,0,1
PRI,ITA,2004.0,1,0,1
MLI,SEN,1997.0,1,0,1
BGR,LVA,2018.0,1,0,1
DJI,SEN,2011.0,1,0,1
RWA,COG,2015.0,3,0,3
UKR,NOR,2017.0,3,0,3
OMN,AUS,2007.0,2,0,2
AZE,TUR,1998.0,4,0,4
EST,PRT,2006.0,1,0,1
CZE,CYP,2021.0,2,0,2
BIH,SWE,2016.0,4,0,4
LTU,,2000.0,5,0,5
AFG,NPL,2014.0,1,0,1
SVK,NOR,2012.0,3,0,3
AUT,ISL,2003.0,2,0,2
BEL,PSE,2010.0,1,0,1
USA,QAT,2007.0,8,0,8
JPN,OMN,2012.0,3,0,3
LTU,CHE,2016.0,3,0,3
AUS,ISL,2012.0,2,0,2
MEX,GRD,2017.0,1,0,1
SYR,HUN,2018.0,2,0,2
CHN,LKA,2018.0,3,0,3
IND,VUT,2017.0,1,0,1
EST,IRL,2022.0,1,0,1
SGP,,2000.0,19,0,19
SWE,TWN,2006.0,3,0,3
PER,CAN,2001.0,2,0,2
USA,VIR,2002.0,1,0,1
TGO,NZL,2013.0,1,0,1
AUS,CYP,2007.0,2,0,2
ZMB,BEL,2005.0,1,0,1
FSM,,2011.0,7,0,7
COL,NLD,2009.0,2,0,2
,VGB,2009.0,1,0,1
THA,ETH,2014.0,2,0,2
NZL,PRT,2018.0,1,0,1
NLD,CUW,2021.0,2,0,2
CHE,SEN,2019.0,2,0,2
AUT,ISR,1997.0,2,0,2
CHE,BDI,2017.0,1,0,1
JPN,SLE,2003.0,1,0,1
RUS,SRB,1997.0,1,0,1
NZL,RUS,2015.0,2,0,2
FRA,IRQ,2004.0,1,0,1
USA,HND,2003.0,2,0,2
VEN,PRI,2004.0,1,0,1
ESP,PRI,2000.0,1,0,1
ARM,KOR,2011.0,1,0,1
BEL,LUX,1998.0,1,0,1
DNK,UKR,2007.0,3,0,3
UZB,PAK,2010.0,1,0,1
COG,SLE,2009.0,1,0,1
TCD,TUR,2013.0,1,0,1
GRC,EST,2011.0,1,0,1
UZB,AZE,2011.0,1,0,1
UGA,GIN,2014.0,1,0,1
TCD,GBR,2015.0,4,0,4
COL,CHN,2012.0,1,0,1
HKG,DNK,2013.0,3,0,3
MKD,KWT,2019.0,1,0,1
NOR,LTU,2021.0,2,0,2
NGA,KEN,2008.0,2,0,2
EST,CAN,1999.0,1,0,1
BHR,SDN,2006.0,1,0,1
GEO,POL,2002.0,1,0,1
TUN,QAT,2010.0,1,0,1
YEM,POL,2012.0,1,0,1
DNK,GNB,2002.0,5,0,5
USA,GUF,2011.0,2,0,2
MEX,LUX,2013.0,1,0,1
ROU,POL,2009.0,5,0,5
TUR,IRQ,2007.0,1,0,1
GEO,LAO,2017.0,5,0,5
,SMR,2017.0,3,0,3
PSE,SAU,2011.0,2,0,2
PHL,HUN,2017.0,1,0,1
AUT,HKG,2012.0,1,0,1
BOL,PER,2005.0,2,0,2
FSM,NZL,2005.0,1,0,1
BTN,,2010.0,1,0,1
CAN,PAN,2015.0,2,0,2
KOR,BLR,2008.0,1,0,1
HUN,PAK,2013.0,1,0,1
,GNQ,2007.0,1,0,1
SVN,SAU,2012.0,1,0,1
SAU,ARG,2008.0,1,0,1
,SOM,2009.0,2,0,2
BLR,EST,2018.0,1,0,1
KAZ,THA,2014.0,1,0,1
SVK,MLT,2008.0,1,0,1
SWE,CRI,2007.0,1,0,1
ITA,SYC,2015.0,1,0,1
OMN,SGP,2003.0,1,0,1
JPN,BWA,2014.0,4,0,4
DNK,GNB,2005.0,2,0,2
SWE,PER,2019.0,1,0,1
BLR,BEL,2006.0,1,0,1
,BEN,2019.0,60,0,60
RUS,SRB,1998.0,2,0,2
RUS,KGZ,2009.0,3,0,3
LKA,NZL,2004.0,1,0,1
MLT,USA,2022.0,3,0,3
PAK,ZAF,2015.0,1,0,1
GBR,OMN,2022.0,4,0,4
KEN,NGA,2005.0,2,0,2
MKD,AUT,2016.0,1,0,1
PAK,DNK,2013.0,2,0,2
AUT,SAU,2002.0,2,0,2
DNK,SGP,1999.0,2,0,2
NGA,KOR,2009.0,2,0,2
BLR,USA,1999.0,3,0,3
BEL,EST,2007.0,1,0,1
NOR,PAK,2008.0,2,0,2
ZMB,NAM,2021.0,1,0,1
GBR,YEM,2010.0,2,0,2
PRY,ARG,2018.0,2,0,2
MKD,ISR,2019.0,1,0,1
CHN,CZE,2008.0,2,0,2
ITA,PRK,2020.0,1,0,1
BGR,KOR,2013.0,1,0,1
SUR,GBR,2012.0,1,0,1
LKA,NLD,2008.0,1,0,1
IRQ,POL,2017.0,1,0,1
IRQ,HUN,2018.0,1,0,1
THA,BTN,2022.0,1,0,1
ARE,DZA,2004.0,1,0,1
MLI,SEN,1998.0,1,0,1
UZB,KAZ,2010.0,2,0,2
MYS,EGY,2008.0,3,0,3
CIV,AUS,2017.0,1,0,1
DOM,MEX,2016.0,2,0,2
ITA,BHR,2008.0,1,0,1
IDN,AUT,2022.0,1,0,1
BTN,,2019.0,12,0,12
IDN,UGA,2012.0,1,0,1
GBR,LAO,2005.0,1,0,1
AUT,PHL,2003.0,2,0,2
GRC,ISR,2022.0,1,0,1
NGA,NER,2008.0,2,0,2
IRL,FJI,2018.0,1,0,1
PRT,CUB,2012.0,1,0,1
KOR,PRI,2010.0,1,0,1
KEN,COL,2019.0,1,0,1
HRV,PRI,2017.0,1,0,1
QAT,TZA,2017.0,1,0,1
CHL,SRB,2007.0,1,0,1
CHE,FJI,2005.0,1,0,1
EST,DNK,2001.0,2,0,2
UZB,AUT,2002.0,1,0,1
ARG,CYP,2003.0,1,0,1
NGA,ISR,2004.0,1,0,1
BHR,GBR,2011.0,2,0,2
NOR,SAU,2011.0,1,0,1
GBR,BOL,2016.0,1,0,1
SEN,TCD,2019.0,2,0,2
BLR,IRN,2010.0,1,0,1
GRC,SAU,2022.0,2,0,2
BEL,BFA,2015.0,2,0,2
ZAF,IDN,2018.0,1,0,1
ERI,CHE,2017.0,2,0,2
AUS,BLR,2003.0,2,0,2
HTI,NGA,2021.0,1,0,1
DEU,LVA,2021.0,1,0,1
SVK,IRQ,2016.0,2,0,2
TJK,UZB,2021.0,1,0,1
POL,HRV,2008.0,1,0,1
SRB,DEU,2000.0,4,0,4
ITA,GAB,2013.0,1,0,1
CYP,BRA,2006.0,1,0,1
NGA,TUR,2008.0,1,0,1
PHL,MEX,2007.0,1,0,1
GBR,JAM,2018.0,1,0,1
MUS,ZAF,2012.0,1,0,1
ETH,CZE,2018.0,2,0,2
PER,NGA,2022.0,2,0,2
POL,DZA,2003.0,1,0,1
CHE,SEN,2017.0,2,0,2
BGD,NPL,2013.0,1,0,1
SVK,IRL,2003.0,3,0,3
COG,GMB,2018.0,1,0,1
OMN,RUS,2020.0,1,0,1
TCD,,2007.0,2,0,2
IND,PSE,2010.0,1,0,1
BEL,CYP,2009.0,1,0,1
NGA,AUS,2002.0,2,0,2
CHE,LTU,2002.0,1,0,1
KEN,NGA,2002.0,2,0,2
HKG,BEL,2003.0,1,0,1
YEM,SAU,2008.0,3,0,3
BRA,BGR,2006.0,1,0,1
PRY,ISL,2010.0,1,0,1
BLR,JPN,1999.0,2,0,2
AUT,LIE,2006.0,1,0,1
FRA,PSE,2000.0,1,0,1
KWT,AUS,2001.0,1,0,1
BGR,TWN,2011.0,1,0,1
USA,GAB,2017.0,1,0,1
CMR,NER,2012.0,1,0,1
MDA,CHL,2014.0,1,0,1
CUB,CHE,2003.0,1,0,1
TZA,AUS,2020.0,1,0,1
PYF,POL,2012.0,1,0,1
ITA,MKD,2016.0,1,0,1
URY,EGY,2019.0,1,0,1
DNK,LVA,2015.0,1,0,1
ESP,CYP,2018.0,1,0,1
GNQ,,2018.0,1,0,1
NOR,ISL,2009.0,1,0,1
ERI,GBR,2021.0,1,0,1
QAT,JOR,2004.0,2,0,2
VEN,BOL,2014.0,1,0,1
ZAF,GAB,2020.0,2,0,2
DEU,BFA,2016.0,1,0,1
AUS,CIV,2005.0,1,0,1
GBR,MCO,2003.0,1,0,1
PYF,NCL,2020.0,2,0,2
MAR,TGO,2016.0,1,0,1
MEX,DZA,2018.0,1,0,1
BGD,SDN,2008.0,1,0,1
IDN,MMR,2022.0,1,0,1
PER,UGA,2022.0,1,0,1
ISR,LKA,2018.0,1,0,1
KAZ,LTU,2020.0,1,0,1
TJK,DEU,2011.0,1,0,1
TUR,CHN,1998.0,1,0,1
CZE,BGR,2019.0,1,0,1
NGA,COG,2021.0,1,0,1
FIN,LUX,2019.0,1,0,1
SVN,DNK,2021.0,5,0,5
BEL,PYF,2022.0,1,0,1
TJK,RUS,2016.0,2,0,2
JOR,ISL,2021.0,1,0,1
NLD,ISL,2008.0,3,0,3
BLR,BGR,2015.0,1,0,1
ZMB,FIN,2002.0,1,0,1
GBR,SWZ,1998.0,1,0,1
BEL,COL,1999.0,1,0,1
NZL,TUR,1999.0,1,0,1
SMR,,2017.0,1,0,1
SEN,BEL,2012.0,1,0,1
KGZ,,2000.0,1,0,1
DEU,PAN,2011.0,2,0,2
FJI,CAN,2011.0,1,0,1
MAR,PYF,2010.0,1,0,1
ISR,UZB,2011.0,1,0,1
IRN,NPL,2019.0,1,0,1
TWN,IRN,2017.0,1,0,1
DEU,BMU,2017.0,1,0,1
LVA,ESP,2018.0,1,0,1
LBN,PAK,2021.0,2,0,2
USA,TCD,2021.0,1,0,1
ITA,MDA,2012.0,1,0,1
BEL,ARE,2011.0,1,0,1
THA,SGP,2000.0,1,0,1
BLR,IRN,2017.0,1,0,1
BGR,LTU,2003.0,1,0,1
ROU,ISL,2002.0,1,0,1
FIN,LTU,2016.0,3,0,3
BEL,MLT,2013.0,1,0,1
NIC,DNK,2012.0,1,0,1
EGY,BGD,2012.0,2,0,2
MYS,TTO,2008.0,1,0,1
BEL,SEN,2003.0,2,0,2
SAU,QAT,1998.0,1,0,1
ERI,,2004.0,1,0,1
TZA,NOR,1998.0,1,0,1
SRB,ALB,2013.0,1,0,1
MKD,HUN,2013.0,1,0,1
CAN,BHR,2010.0,1,0,1
CAN,TZA,2013.0,2,0,2
SYC,,2020.0,2,0,2
KHM,CHN,2019.0,2,0,2
CUB,HND,2016.0,1,0,1
SEN,TUR,2015.0,1,0,1
CZE,FRA,2023.0,1,0,1
IND,MOZ,2009.0,1,0,1
CHE,KHM,2007.0,1,0,1
MUS,SWE,2010.0,1,0,1
KOR,PAN,2017.0,1,0,1
,SMR,2019.0,1,0,1
KHM,SWE,2012.0,1,0,1
AUT,BGR,2007.0,1,0,1
BEL,PSE,2017.0,1,0,1
TWN,ARM,2019.0,1,0,1
UKR,BLR,2018.0,2,0,2
IRL,ARE,2011.0,1,0,1
MAC,JPN,2016.0,1,0,1
AUT,NPL,2009.0,2,0,2
,SMR,2010.0,1,0,1
THA,RUS,2004.0,1,0,1
CHE,GEO,2006.0,1,0,1
BEL,MDG,2018.0,1,0,1
KWT,FIN,2012.0,1,0,1
PYF,AUS,2020.0,1,0,1
BEL,IRN,2005.0,2,0,2
PHL,IRN,2003.0,1,0,1
NLD,BTN,2012.0,1,0,1
CAN,HTI,2015.0,2,0,2
FJI,FRA,2012.0,1,0,1
UKR,OMN,2012.0,1,0,1
MEX,THA,2016.0,1,0,1
TUR,NGA,2010.0,1,0,1
TWN,TZA,2018.0,1,0,1
MKD,KWT,2017.0,1,0,1
GHA,PNG,2001.0,1,0,1
SYR,PAK,2008.0,1,0,1
TWN,VNM,2007.0,2,0,2
YEM,DEU,2022.0,1,0,1
DEU,IRN,2000.0,2,0,2
MEX,BTN,2017.0,1,0,1
NIU,,2020.0,1,0,1
,MNP,2001.0,1,0,1
NPL,CAN,2007.0,1,0,1
CRI,CHE,2003.0,1,0,1
ZAF,HKG,2006.0,1,0,1
BIH,FRA,2006.0,1,0,1
ESP,GUM,2004.0,1,0,1
MYS,POL,2012.0,1,0,1
BEL,LUX,1997.0,1,0,1
NOR,ZMB,2014.0,1,0,1
MNG,USA,2007.0,1,0,1
TGO,BEN,2017.0,1,0,1
COL,MAR,2021.0,1,0,1
DZA,ISR,2017.0,1,0,1
NZL,SDN,2014.0,1,0,1
,BMU,2011.0,1,0,1
SVN,GHA,2019.0,1,0,1
IRQ,KAZ,2020.0,2,0,2
SYR,TUR,2003.0,1,0,1
MYS,IRL,2007.0,1,0,1
PRY,CAN,2005.0,1,0,1
ZMB,SWE,2009.0,1,0,1
BRA,IDN,2016.0,1,0,1
GHA,IRN,2016.0,1,0,1
ETH,ISR,2008.0,1,0,1
AUT,SRB,1998.0,1,0,1
CYP,DEU,2014.0,1,0,1
MCO,ITA,2014.0,1,0,1
VNM,IRL,2016.0,1,0,1
ESP,KAZ,2014.0,1,0,1
FIN,NAM,2011.0,1,0,1
CHE,NER,2016.0,1,0,1
NLD,JOR,2020.0,1,0,1
RUS,KEN,2022.0,1,0,1
ZWE,NAM,2012.0,1,0,1
,VIR,2001.0,1,0,1
PER,IRN,2021.0,1,0,1
ARG,HND,2013.0,1,0,1
BTN,,2017.0,3,0,3
TWN,IRQ,2019.0,1,0,1
,KOR,2020.0,4,0,4
KEN,FIN,2012.0,1,0,1
IRN,NZL,2010.0,2,0,2
ESP,GRD,2017.0,1,0,1
SVK,NZL,2017.0,1,0,1
CYP,BEL,2012.0,1,0,1
RUS,CYP,2016.0,1,0,1
PHL,PAN,2020.0,1,0,1
DEU,BMU,2019.0,1,0,1
MEX,POL,1999.0,2,0,2
DNK,BRA,2007.0,2,0,2
HRV,RUS,2002.0,1,0,1
CHL,PAN,2020.0,1,0,1
URY,ITA,2018.0,1,0,1
MDG,COM,2020.0,1,0,1
MEX,EGY,2008.0,1,0,1
SVK,SWE,2022.0,1,0,1
ZWE,ETH,2007.0,1,0,1
TUN,JPN,2004.0,1,0,1
SLB,,2007.0,1,0,1
MWI,KEN,2001.0,1,0,1
CHE,CHL,2000.0,1,0,1
GMB,KOR,2003.0,2,0,2
EGY,DZA,2002.0,1,0,1
PRI,,2001.0,1,0,1
BRA,LIE,2015.0,1,0,1
SAU,ABW,2021.0,1,0,1
SVK,THA,2005.0,1,0,1
EST,CHN,2014.0,1,0,1
AUS,UKR,2014.0,1,0,1
MEX,ZWE,2012.0,1,0,1
EST,POL,2017.0,1,0,1
HUN,KOR,2015.0,1,0,1
GHA,TGO,2018.0,1,0,1
JOR,HUN,2018.0,1,0,1
MEX,SVK,2020.0,1,0,1
DEU,MAC,2016.0,1,0,1
IRQ,IND,1998.0,1,0,1
ARE,MEX,2018.0,1,0,1
SDN,ARE,2005.0,1,0,1
BGD,AUS,1998.0,1,0,1
NOR,JOR,2022.0,1,0,1
IDN,PAK,2014.0,1,0,1
PRY,BEL,2008.0,1,0,1
SEN,TCD,2017.0,1,0,1
ISL,NLD,2001.0,1,0,1
GTM,FRA,1999.0,1,0,1
GLP,BEL,2002.0,1,0,1
CHE,MLI,2015.0,1,0,1
CUB,YEM,2005.0,1,0,1
HUN,QAT,2018.0,1,0,1
ISR,LUX,2014.0,1,0,1
,YEM,2020.0,1,0,1
NZL,COL,2004.0,1,0,1
HRV,EGY,2021.0,1,0,1
CHN,JOR,2004.0,1,0,1
,VNM,2020.0,1,0,1
GBR,PHL,1998.0,1,0,1
FIN,KWT,2014.0,1,0,1
NOR,GBR,2012.0,27,62,-35
CHN,USA,2008.0,1385,937,448
NZL,GBR,2008.0,102,111,-9
MYS,NGA,2012.0,11,22,-11
GBR,NLD,2021.0,287,191,96
JPN,USA,2006.0,1082,911,171
HKG,USA,2006.0,109,74,35
GBR,IND,2007.0,86,135,-49
USA,CHN,2014.0,2263,2391,-128
TUR,USA,2007.0,155,215,-60
USA,JPN,2010.0,907,893,14
USA,CAN,2016.0,1363,1919,-556
CAN,GBR,2012.0,321,339,-18
CHL,USA,2006.0,64,62,2
USA,CHL,2011.0,83,92,-9
ZAF,USA,2015.0,86,84,2
USA,JPN,2019.0,667,719,-52
GBR,HKG,2007.0,38,52,-14
CAN,ISR,2020.0,51,68,-17
UKR,MEX,2008.0,4,1,3
BEL,POL,2012.0,21,6,15
USA,BEL,2011.0,128,119,9
AUS,SWE,2019.0,47,33,14
POL,DNK,2010.0,15,4,11
AUT,CHE,2009.0,54,39,15
USA,EGY,2003.0,80,35,45
USA,AUS,2002.0,388,496,-108
USA,ITA,2013.0,325,540,-215
DEU,IRL,2005.0,30,12,18
DEU,DNK,2015.0,118,67,51
USA,SAU,2010.0,103,27,76
GBR,IRL,2010.0,193,155,38
AUT,DEU,2003.0,186,197,-11
FRA,SWE,2007.0,46,42,4
AUS,NZL,2010.0,92,155,-63
NLD,HUN,2004.0,5,8,-3
RUS,GRC,2005.0,2,1,1
UKR,DEU,2008.0,19,15,4
JPN,IDN,2013.0,105,25,80
BGD,JPN,2006.0,32,35,-3
USA,AUS,2005.0,376,464,-88
ITA,GBR,2015.0,527,296,231
USA,JPN,2017.0,697,763,-66
ROU,CAN,2000.0,5,1,4
NOR,SWE,2001.0,32,33,-1
DEU,ITA,2005.0,121,135,-14
NLD,DEU,2013.0,228,211,17
USA,SAU,2017.0,200,124,76
GBR,GRC,2013.0,118,168,-50
DEU,NOR,2021.0,66,45,21
DEU,CAN,2009.0,155,99,56
DEU,NLD,2016.0,266,290,-24
ESP,COL,2015.0,121,38,83
CAN,FRA,2010.0,233,257,-24
LTU,SWE,2012.0,3,4,-1
SWE,GBR,2009.0,112,105,7
FRA,PAK,2007.0,2,1,1
KOR,CHN,2011.0,133,64,69
CHE,FIN,2008.0,8,12,-4
RUS,AZE,1998.0,2,3,-1
USA,SAU,2019.0,276,125,151
TWN,AUS,2008.0,11,13,-2
MYS,ARE,2019.0,17,4,13
JPN,THA,2005.0,68,31,37
ITA,PRT,2017.0,34,25,9
LUX,NLD,2017.0,4,4,0
FRA,MTQ,2004.0,17,4,13
BEL,GBR,2004.0,59,44,15
CHE,BEL,2014.0,38,38,0
CAN,FRA,2017.0,247,304,-57
DNK,GBR,2001.0,34,30,4
CAN,CHE,2011.0,78,75,3
IRL,GBR,2004.0,106,134,-28
DEU,SVN,2015.0,2,15,-13
DEU,CHN,2007.0,128,126,2
IRN,GBR,2012.0,26,54,-28
ETH,DEU,2003.0,3,1,2
ITA,PRT,2019.0,32,29,3
HRV,AUT,2003.0,3,3,0
MEX,ESP,2016.0,126,158,-32
ZAF,GBR,2021.0,70,53,17
BRA,JPN,2011.0,9,17,-8
DEU,ESP,2015.0,138,273,-135
GBR,IRQ,2017.0,63,10,53
USA,NOR,2008.0,76,33,43
CAN,FRA,2019.0,241,331,-90
HKG,CHN,2018.0,658,515,143
JPN,THA,2002.0,29,35,-6
CHE,CHN,2016.0,39,59,-20
POL,CZE,2021.0,12,9,3
ESP,IND,2014.0,16,17,-1
DEU,AUT,2014.0,335,308,27
JPN,CHN,2019.0,470,295,175
ESP,CHL,2019.0,130,85,45
JPN,TUR,2018.0,10,9,1
GBR,IRN,2009.0,51,35,16
FRA,CHN,2015.0,172,128,44
ITA,DEU,2020.0,292,239,53
CHE,SRB,2013.0,4,5,-1
IRL,IND,2020.0,14,27,-13
GBR,IRL,2019.0,263,231,32
ISR,USA,2021.0,267,265,2
CAN,CHN,2008.0,134,151,-17
SRB,MNE,2016.0,10,2,8
ITA,CYP,2020.0,7,4,3
ESP,BEL,2020.0,71,59,12
KOR,IRL,2015.0,4,3,1
DEU,PHL,2011.0,5,3,2
TUR,JPN,2015.0,4,7,-3
QAT,GBR,2018.0,24,45,-21
CAN,KEN,2016.0,9,7,2
ITA,EGY,2014.0,6,7,-1
DNK,EGY,2019.0,6,1,5
CZE,ITA,2014.0,9,14,-5
CAN,SWE,2021.0,33,25,8
BRA,AUS,2011.0,27,11,16
POL,RUS,2020.0,8,18,-10
USA,IRL,2015.0,109,157,-48
CHL,NZL,2007.0,3,2,1
ARE,USA,2020.0,80,95,-15
KOR,JPN,2018.0,107,107,0
CHN,SGP,2005.0,85,98,-13
ISR,CAN,2002.0,36,16,20
GBR,PER,2017.0,7,6,1
EGY,CAN,2015.0,23,39,-16
AUS,NZL,2017.0,110,144,-34
UGA,CAN,2016.0,4,1,3
CHN,JPN,2002.0,219,233,-14
CAN,JOR,2015.0,13,8,5
ITA,HKG,2019.0,3,7,-4
IND,JPN,2005.0,48,40,8
TUN,SAU,2020.0,133,31,102
CAN,TUR,2012.0,18,16,2
CHN,GBR,2022.0,231,364,-133
DEU,PAK,2015.0,35,17,18
RUS,FRA,2018.0,39,47,-8
FRA,SAU,2020.0,42,8,34
BEL,BRA,2016.0,16,12,4
ISR,BEL,2021.0,5,1,4
EGY,IRQ,2018.0,5,1,4
NZL,AUT,2022.0,2,1,1
IRL,USA,2001.0,42,45,-3
BEL,EGY,2011.0,1,1,0
USA,ROU,2011.0,18,30,-12
NPL,IND,2020.0,31,36,-5
GIN,FRA,2015.0,7,2,5
AUS,DEU,2003.0,78,69,9
CZE,CAN,2016.0,12,8,4
CAN,DNK,2021.0,25,15,10
ZAF,NLD,2019.0,24,27,-3
SDN,GBR,2019.0,2,2,0
SWE,FIN,2015.0,49,60,-11
CHN,BRN,2017.0,3,1,2
CAN,FIN,2021.0,25,9,16
JOR,IRQ,2019.0,3,4,-1
VNM,IND,2021.0,11,1,10
CAN,EGY,2020.0,46,31,15
FIN,RUS,2002.0,17,17,0
COL,CUB,2018.0,3,3,0
MAR,ESP,2019.0,10,9,1
DNK,NOR,2020.0,52,27,25
IND,SGP,2022.0,23,42,-19
USA,JOR,2021.0,24,40,-16
JPN,AUS,2018.0,62,61,1
EGY,GBR,2019.0,45,48,-3
DEU,IRL,2002.0,16,13,3
MEX,ARG,2020.0,16,13,3
HKG,GBR,2022.0,39,35,4
CAN,AUS,2006.0,107,104,3
KOR,IND,2020.0,153,217,-64
RUS,JPN,1999.0,31,16,15
NPL,USA,2020.0,32,22,10
CHN,AUT,2022.0,6,15,-9
THA,IRL,2020.0,2,2,0
ITA,EST,2018.0,7,4,3
IND,JPN,2002.0,70,65,5
CAN,PRT,2008.0,9,3,6
DEU,CHL,2006.0,17,12,5
SWE,EST,2006.0,6,3,3
MYS,IND,2015.0,65,96,-31
SRB,MKD,2020.0,5,3,2
SWE,CHE,1999.0,10,6,4
PAK,GBR,2012.0,33,82,-49
COL,GBR,2021.0,8,7,1
BGD,TWN,2019.0,2,1,1
ITA,PRT,2010.0,31,7,24
FRA,AUS,2015.0,99,83,16
NZL,AUS,2016.0,144,108,36
AUT,HUN,2018.0,7,17,-10
IND,AUT,2015.0,9,12,-3
MYS,SWE,2018.0,1,6,-5
PAK,MYS,2016.0,33,71,-38
SGP,MYS,2019.0,11,21,-10
BRA,DEU,2015.0,84,81,3
ROU,USA,2020.0,9,21,-12
DEU,NZL,2018.0,41,25,16
DEU,PRT,2012.0,36,30,6
FRA,IND,2013.0,53,71,-18
NOR,USA,2006.0,49,51,-2
USA,PER,2006.0,25,12,13
NOR,ESP,2015.0,9,26,-17
ZAF,BRA,2009.0,5,4,1
PAK,USA,2001.0,26,16,10
AUS,ARE,2013.0,11,4,7
ETH,IND,2013.0,6,16,-10
SGP,MYS,2010.0,13,15,-2
CHN,UKR,2021.0,7,9,-2
BRA,ESP,2005.0,24,28,-4
CHE,ZAF,2016.0,11,14,-3
ROU,ITA,2006.0,11,7,4
DEU,GHA,2013.0,8,4,4
CAN,SGP,2011.0,18,20,-2
USA,UKR,2000.0,7,43,-36
NOR,IND,2016.0,9,13,-4
MEX,CHE,2021.0,12,2,10
IND,ZAF,2015.0,68,30,38
SWE,ESP,2002.0,21,22,-1
SAU,CHN,2013.0,8,25,-17
CHN,CAN,2001.0,82,32,50
JPN,GBR,2006.0,96,92,4
JPN,CAN,2006.0,91,60,31
CHN,PRT,2003.0,5,2,3
FRA,REU,2011.0,15,14,1
TWN,GBR,2009.0,18,36,-18
CAN,HKG,2019.0,28,18,10
CAN,POL,2013.0,31,17,14
IRN,MYS,2013.0,98,102,-4
CHL,DEU,2019.0,32,35,-3
FRA,RUS,2007.0,28,37,-9
CUB,ESP,2007.0,16,15,1
CAN,HUN,2014.0,4,5,-1
ITA,BEL,2007.0,34,31,3
NGA,IND,2013.0,8,6,2
FRA,NOR,2007.0,21,17,4
BRA,AUT,2020.0,18,4,14
ARE,CHN,2016.0,5,6,-1
DEU,ROU,2011.0,22,16,6
COG,GBR,2018.0,2,3,-1
CMR,MAR,2016.0,3,2,1
DEU,ITA,2002.0,131,133,-2
KAZ,TUR,2016.0,2,8,-6
FIN,JPN,2017.0,16,13,3
TWN,IND,2012.0,30,45,-15
MYS,ARE,2017.0,17,4,13
FIN,MEX,2019.0,1,4,-3
SDN,GBR,2017.0,3,2,1
MEX,CAN,2021.0,39,21,18
ISL,SWE,2005.0,6,9,-3
CUB,ECU,2016.0,24,1,23
TWN,SGP,2013.0,12,13,-1
USA,MWI,2006.0,5,5,0
CHE,MEX,2020.0,3,13,-10
SGP,AUS,2006.0,53,31,22
CZE,SWE,2004.0,7,3,4
ARG,PER,2018.0,2,1,1
NGA,UGA,2019.0,2,3,-1
LBN,EGY,2020.0,7,1,6
FRA,POL,2018.0,34,24,10
RWA,USA,2020.0,10,12,-2
TTO,USA,2011.0,5,6,-1
NLD,BRA,2004.0,7,4,3
JPN,IND,2002.0,65,70,-5
LUX,BEL,2013.0,7,12,-5
CUB,CHL,2010.0,8,2,6
BEL,NLD,2000.0,28,35,-7
ESP,PER,2011.0,12,9,3
MWI,JPN,2019.0,2,2,0
ISR,CAN,2005.0,54,20,34
IND,AUS,2006.0,44,19,25
FRA,BRA,2002.0,71,52,19
BEL,NGA,2018.0,1,1,0
TUR,SWE,2005.0,2,3,-1
DNK,BEL,2012.0,12,5,7
BGD,HKG,2013.0,1,2,-1
ISR,AUT,2011.0,5,4,1
SWE,RWA,2012.0,1,1,0
JOR,IRQ,2017.0,6,3,3
OMN,AUS,2005.0,1,2,-1
CHL,ITA,2016.0,11,18,-7
GBR,MDG,2010.0,3,1,2
CZE,USA,2005.0,49,37,12
POL,GBR,1998.0,8,5,3
ESP,FIN,2006.0,6,3,3
ITA,ARG,2005.0,15,16,-1
AUS,ISR,2011.0,7,19,-12
TWN,POL,2002.0,2,3,-1
ESP,JPN,2002.0,6,8,-2
VEN,ESP,2021.0,6,4,2
CAN,NGA,2012.0,4,6,-2
USA,NGA,2001.0,7,9,-2
EGY,USA,1999.0,9,14,-5
GEO,FRA,2018.0,45,8,37
GLP,FRA,2016.0,22,6,16
NLD,IDN,2002.0,3,5,-2
MEX,DEU,2003.0,18,15,3
DNK,CZE,2001.0,2,1,1
IRL,NLD,2004.0,9,7,2
SAU,SWE,2007.0,2,3,-1
FIN,SWE,2002.0,38,33,5
BEL,BGR,2003.0,2,4,-2
IND,POL,1997.0,1,1,0
FIN,SWE,2005.0,26,21,5
NLD,THA,2002.0,4,1,3
CZE,USA,2002.0,55,35,20
RUS,GEO,2009.0,3,3,0
FRA,MDG,2008.0,11,6,5
TUR,CAN,2006.0,12,10,2
EGY,LBN,2009.0,2,1,1
IND,FIN,2002.0,2,1,1
PRT,NLD,2009.0,12,14,-2
CHL,DEU,2010.0,26,15,11
MEX,NLD,2003.0,4,9,-5
GBR,ARE,2005.0,10,8,2
CAN,AUT,2006.0,8,16,-8
ESP,URY,2004.0,9,1,8
HRV,SVN,2011.0,6,7,-1
FRA,SVK,2004.0,4,3,1
BRA,ESP,2002.0,23,25,-2
BEN,NGA,2009.0,4,1,3
NGA,BEN,2011.0,2,1,1
ITA,HUN,2008.0,6,11,-5
USA,VEN,2003.0,35,32,3
CZE,CHE,2018.0,15,12,3
EGY,GBR,2017.0,23,48,-25
RUS,GRC,2002.0,5,6,-1
AUS,CHE,2011.0,53,57,-4
VNM,JPN,2001.0,1,3,-2
CHL,DEU,2017.0,35,28,7
RUS,ESP,2008.0,12,7,5
GBR,DNK,2005.0,41,55,-14
USA,GEO,2021.0,8,14,-6
SEN,FRA,1999.0,17,8,9
NGA,ZAF,1999.0,1,1,0
USA,SVK,2018.0,12,6,6
NLD,IRL,2007.0,14,10,4
JPN,PHL,2003.0,14,6,8
GRD,USA,2021.0,10,3,7
HUN,SVK,2016.0,7,6,1
GBR,UGA,2004.0,4,5,-1
BEL,GRC,1997.0,2,2,0
AUT,BGR,2002.0,4,1,3
ITA,DNK,2001.0,11,13,-2
ESP,FRA,1999.0,44,61,-17
DEU,SVK,1999.0,10,4,6
MEX,VEN,2012.0,3,7,-4
AUS,POL,2008.0,5,6,-1
SWE,BEL,2001.0,10,2,8
CAF,FRA,2018.0,4,1,3
RUS,CHN,2006.0,5,12,-7
FIN,EST,2008.0,10,8,2
LKA,USA,2016.0,8,18,-10
BWA,NOR,2008.0,1,1,0
USA,OMN,2005.0,9,1,8
ZAF,BEL,2000.0,1,2,-1
CHL,GBR,2005.0,8,21,-13
IDN,USA,1997.0,6,1,5
FRA,ECU,2006.0,2,2,0
KEN,NGA,2007.0,2,1,1
GBR,CUB,2007.0,1,2,-1
ZAF,IND,2002.0,9,5,4
AUT,BRA,2015.0,4,4,0
GBR,LUX,2014.0,5,5,0
JPN,KOR,2000.0,39,34,5
SGP,TWN,2019.0,17,16,1
RUS,NLD,2006.0,19,8,11
SVN,FRA,2011.0,7,4,3
CYP,GRC,2011.0,9,28,-19
USA,IDN,2012.0,18,10,8
BFA,FRA,2020.0,8,9,-1
IRN,FRA,2018.0,30,18,12
KWT,EGY,2009.0,10,12,-2
BGD,CAN,2014.0,27,12,15
PRT,NOR,2011.0,8,1,7
IDN,AUS,2009.0,6,22,-16
USA,GHA,2004.0,9,4,5
NGA,GHA,2011.0,3,2,1
NZL,BEL,2014.0,3,2,1
CHE,PRT,2007.0,6,6,0
ESP,NOR,2012.0,9,10,-1
DNK,IND,2012.0,9,18,-9
FIN,RUS,2005.0,5,12,-7
SRB,BEL,2006.0,2,5,-3
RUS,BLR,2016.0,12,19,-7
NGA,GBR,2008.0,14,13,1
KOR,ESP,2002.0,3,2,1
ESP,IRL,2015.0,38,15,23
ARE,CAN,2009.0,7,19,-12
GBR,NGA,2007.0,15,19,-4
IND,DNK,2013.0,15,14,1
BLZ,USA,2019.0,3,2,1
BEL,NOR,2008.0,6,1,5
CHN,UGA,2019.0,3,1,2
JPN,AUT,2018.0,12,7,5
CAN,NOR,2012.0,9,11,-2
CZE,SVK,2008.0,8,34,-26
MEX,BRA,2016.0,20,21,-1
AUT,CAN,2014.0,22,23,-1
CAN,TUN,2017.0,9,9,0
PAN,USA,2006.0,3,9,-6
CAN,GRC,2007.0,9,7,2
CAN,TUN,2010.0,7,3,4
MAR,IND,2011.0,4,2,2
BRA,MOZ,2013.0,3,2,1
PRY,BRA,2008.0,3,1,2
ZAF,NLD,2017.0,18,34,-16
FIN,JPN,2010.0,8,15,-7
USA,NPL,2019.0,12,37,-25
JPN,DNK,2013.0,7,6,1
NLD,ROU,2019.0,3,2,1
CHL,NLD,2013.0,8,4,4
TZA,USA,2014.0,10,10,0
COL,CHE,2015.0,5,3,2
DEU,SAU,2022.0,7,10,-3
BGR,USA,2022.0,2,1,1
CHN,MYS,2008.0,3,2,1
MAR,ESP,2017.0,7,12,-5
CAN,RUS,2016.0,10,15,-5
MEX,AUT,2019.0,7,3,4
SGP,TWN,2010.0,13,8,5
PAK,BGD,2022.0,7,3,4
NOR,UGA,2017.0,2,2,0
EGY,ITA,2014.0,7,6,1
CAN,HKG,2017.0,21,26,-5
ARM,USA,2018.0,4,3,1
ZMB,ZAF,2021.0,1,10,-9
CMR,DEU,2020.0,6,8,-2
CHN,PRK,2019.0,11,3,8
KOR,AUS,1999.0,4,6,-2
FIN,JPN,2019.0,8,13,-5
POL,DNK,2019.0,7,10,-3
LBR,CHN,2021.0,1,1,0
AUS,PNG,2007.0,3,2,1
JPN,IND,2005.0,40,48,-8
ROU,DEU,2006.0,22,17,5
NGA,USA,2001.0,9,7,2
JPN,IRL,2003.0,5,1,4
USA,PAN,2008.0,9,9,0
ISR,CHE,2008.0,14,2,12
SVN,SWE,2014.0,3,2,1
AUS,SWE,2010.0,35,34,1
POL,HUN,2001.0,1,1,0
ROU,JPN,2020.0,2,3,-1
USA,ALB,2015.0,4,1,3
AZE,USA,2019.0,8,1,7
JPN,RUS,2019.0,7,11,-4
ZAF,MWI,2018.0,4,3,1
DNK,ESP,2004.0,10,9,1
CYP,NOR,2018.0,2,1,1
IND,VNM,2022.0,3,5,-2
SRB,CHE,2020.0,8,5,3
ISL,SWE,2002.0,4,16,-12
ZAF,IND,2005.0,2,12,-10
NLD,IND,2002.0,5,9,-4
NCL,FRA,2018.0,17,24,-7
THA,DNK,2014.0,3,4,-1
NLD,SAU,2016.0,11,2,9
NZL,CAN,2000.0,5,12,-7
BLR,CHN,2013.0,4,2,2
JPN,RUS,2010.0,20,10,10
SRB,BIH,2020.0,9,9,0
CAN,HKG,2010.0,16,29,-13
NOR,SVN,2020.0,1,1,0
EGY,AUS,2013.0,7,6,1
SGP,TWN,2017.0,13,20,-7
RUS,MEX,2016.0,5,2,3
SGP,ROU,2019.0,1,1,0
URY,ARG,2007.0,3,1,2
CMR,ZAF,2022.0,1,3,-2
DEU,ZAF,2022.0,7,8,-1
JPN,KEN,2003.0,1,4,-3
GBR,NPL,2022.0,4,3,1
PAK,KOR,2011.0,14,9,5
BEN,DEU,2020.0,3,4,-1
BHR,JOR,2018.0,2,1,1
AUT,ISL,2012.0,1,1,0
ITA,KEN,2018.0,3,2,1
USA,CZE,1999.0,19,38,-19
FIN,TUR,2021.0,5,6,-1
GRC,FIN,2019.0,2,2,0
ESP,JPN,2005.0,10,7,3
SYR,USA,2013.0,8,1,7
KEN,NLD,2002.0,2,1,1
CMR,CHN,2018.0,4,1,3
DEU,KOR,2008.0,24,33,-9
ITA,THA,2002.0,1,3,-2
NGA,JPN,2017.0,4,6,-2
KEN,NLD,2005.0,1,1,0
ISR,SVK,2001.0,1,1,0
NLD,ISR,2016.0,9,15,-6
IND,NGA,2007.0,4,4,0
NZL,IRL,2013.0,3,6,-3
VNM,RUS,2016.0,4,13,-9
HRV,DEU,1998.0,4,1,3
CAN,ARG,2003.0,12,20,-8
VEN,MEX,1999.0,2,1,1
BWA,ZAF,2013.0,5,6,-1
BEL,KOR,2008.0,2,3,-1
POL,IND,2009.0,2,1,1
SWE,LVA,2011.0,2,1,1
SDN,SAU,2008.0,3,3,0
ARG,COL,2001.0,6,3,3
IRQ,TUR,2016.0,5,12,-7
BGR,ITA,2011.0,4,6,-2
NLD,THA,2005.0,3,4,-1
BEL,ROU,2004.0,5,6,-1
ESP,VEN,2000.0,5,5,0
AUS,PAK,2006.0,2,3,-1
NLD,IDN,2005.0,4,2,2
USA,NPL,2010.0,5,12,-7
JPN,POL,2007.0,8,2,6
LUX,NOR,2016.0,1,2,-1
COG,USA,2011.0,5,3,2
CHE,LUX,2020.0,3,6,-3
NLD,JPN,2015.0,15,16,-1
ITA,MLT,2018.0,5,3,2
USA,GUM,2021.0,4,4,0
EGY,GBR,2010.0,18,46,-28
JOR,AUS,2011.0,5,6,-1
USA,MHL,2010.0,1,1,0
SGP,JPN,2011.0,18,34,-16
ESP,MYS,2014.0,5,4,1
NLD,IND,2005.0,14,10,4
KOR,SWE,2015.0,10,9,1
NOR,EGY,2015.0,3,2,1
DNK,GHA,2008.0,1,1,0
AND,ESP,2018.0,2,1,1
HKG,SWE,2018.0,8,5,3
CUB,IND,2018.0,1,1,0
TWN,ESP,2018.0,5,5,0
GRC,FIN,2017.0,3,1,2
PHL,FRA,2002.0,1,2,-1
CHN,ISR,2012.0,6,9,-3
HRV,BRA,2020.0,1,3,-2
HRV,ITA,2016.0,9,11,-2
TUR,NZL,2018.0,5,1,4
JPN,JOR,2008.0,1,1,0
TUR,SDN,2018.0,1,1,0
ZAF,CZE,2022.0,3,1,2
NZL,FRA,2022.0,10,6,4
JPN,VNM,2007.0,10,5,5
SRB,RUS,2015.0,6,2,4
ECU,BRA,2004.0,1,1,0
ZAF,JPN,2013.0,1,4,-3
COL,PRI,2005.0,3,2,1
GBR,SLE,2019.0,4,5,-1
RUS,KAZ,2004.0,4,5,-1
IRN,ESP,2007.0,1,1,0
BGR,POL,2011.0,5,1,4
FIN,MEX,2017.0,2,2,0
POL,SGP,2014.0,8,3,5
DEU,NCL,2016.0,1,1,0
ESP,HUN,2021.0,3,3,0
IRL,ITA,2018.0,19,43,-24
NCL,AUS,2012.0,2,2,0
BRA,ARG,1997.0,3,7,-4
KOR,ETH,2015.0,2,4,-2
FIN,NLD,2018.0,12,22,-10
BEL,ITA,1997.0,3,4,-1
LUX,POL,2013.0,1,2,-1
CUB,CHL,2017.0,10,3,7
ZWE,GBR,2021.0,6,3,3
COL,ARG,2021.0,7,12,-5
NLD,PAK,2018.0,14,1,13
QAT,TUN,2020.0,2,11,-9
TZA,ZAF,2012.0,2,4,-2
IND,GHA,2021.0,2,1,1
CMR,CHE,2018.0,1,1,0
BEL,HKG,2017.0,2,1,1
CHE,ARG,2020.0,5,13,-8
DEU,IDN,2022.0,9,6,3
MYS,PHL,2018.0,2,1,1
NOR,UGA,2019.0,2,1,1
NZL,DNK,2021.0,3,1,2
MAR,DEU,2020.0,5,4,1
DEU,JAM,2021.0,1,1,0
ROU,IRL,2011.0,2,1,1
TZA,CHE,2009.0,2,1,1
FRA,ISR,2008.0,11,24,-13
AUS,HUN,2001.0,2,3,-1
AZE,RUS,2004.0,4,5,-1
PSE,DEU,2008.0,4,4,0
BLR,RUS,2008.0,9,5,4
BLR,DEU,2001.0,10,9,1
SWE,DNK,1997.0,6,7,-1
PRT,VEN,2006.0,1,2,-1
IRL,RUS,2006.0,2,6,-4
DNK,BRA,2005.0,3,1,2
BIH,HRV,2015.0,3,9,-6
USA,QAT,2002.0,2,1,1
JPN,CZE,2013.0,10,5,5
USA,HND,2012.0,1,2,-1
CHE,CZE,2007.0,4,6,-2
OMN,SGP,2012.0,2,1,1
CHL,ISR,2010.0,1,3,-2
USA,KWT,2014.0,10,4,6
ESP,LTU,2019.0,3,3,0
UKR,JPN,2013.0,3,2,1
RUS,SVN,2019.0,1,2,-1
USA,BHR,2015.0,4,1,3
NZL,CHE,2012.0,8,8,0
FRA,MLI,2012.0,2,3,-1
ITA,HKG,2010.0,1,1,0
CRI,GBR,2011.0,2,2,0
ITA,GHA,2015.0,1,1,0
VNM,CAN,2014.0,3,4,-1
UZB,CHN,2018.0,5,1,4
AUS,MNG,2015.0,1,1,0
HKG,GHA,2019.0,3,1,2
HKG,SAU,2020.0,5,6,-1
SEN,GIN,2020.0,3,1,2
SDN,JPN,2017.0,2,3,-1
HUN,JPN,2021.0,3,2,1
KOR,POL,2003.0,1,4,-3
CMR,IND,2021.0,2,1,1
BGR,GRC,2014.0,3,2,1
CZE,MNG,2006.0,1,1,0
NAM,USA,2020.0,3,2,1
JOR,IRQ,2010.0,4,2,2
RUS,UZB,1999.0,3,4,-1
DNK,RUS,2006.0,5,7,-2
POL,BEL,1999.0,2,3,-1
DNK,NLD,1997.0,2,5,-3
SRB,GBR,1998.0,2,1,1
ZAF,CHN,2003.0,1,1,0
BWA,IND,2001.0,1,1,0
EGY,JPN,2014.0,12,51,-39
MAR,ESP,2010.0,5,12,-7
CHN,PRK,2017.0,5,1,4
MNG,JPN,2021.0,3,4,-1
RUS,AUT,2018.0,5,4,1
AUS,ETH,2021.0,3,21,-18
TZA,JPN,2009.0,2,4,-2
CHL,GBR,2002.0,7,8,-1
PHL,JPN,2001.0,4,5,-1
IND,FIN,2005.0,3,1,2
PAK,THA,2016.0,4,7,-3
GBR,ARE,2002.0,9,3,6
CIV,GHA,2008.0,1,1,0
GEO,DEU,2009.0,3,7,-4
TUR,ZAF,2005.0,1,2,-1
SWE,UKR,2002.0,2,10,-8
NLD,SVK,2006.0,1,3,-2
CAN,ROU,2021.0,3,1,2
POL,ISR,2011.0,1,9,-8
DNK,GRC,2011.0,3,8,-5
SLV,USA,2018.0,2,1,1
HUN,SRB,2016.0,3,5,-2
CAN,VEN,2008.0,1,4,-3
CHN,URY,2020.0,1,1,0
ROU,BEL,2008.0,3,10,-7
PHL,NLD,2011.0,1,1,0
FIN,ROU,2016.0,2,1,1
UKR,NLD,2012.0,2,1,1
AUS,TWN,1999.0,1,1,0
BGR,JPN,2008.0,2,1,1
ESP,PAN,2003.0,3,1,2
AUT,CZE,2006.0,2,11,-9
GBR,SLE,2017.0,1,2,-1
YEM,CAN,2022.0,1,1,0
CHN,BWA,2018.0,1,1,0
HKG,CHE,2014.0,5,3,2
JPN,ZMB,2021.0,3,3,0
MNG,RUS,2016.0,1,3,-2
PRT,JPN,2007.0,2,2,0
CHN,JOR,2020.0,4,1,3
ECU,KOR,2021.0,2,2,0
BRA,ARG,1998.0,6,7,-1
USA,IRQ,2008.0,2,7,-5
GLP,USA,2016.0,2,1,1
TWN,PHL,2014.0,5,3,2
JOR,QAT,2017.0,6,4,2
IND,SVK,2017.0,1,1,0
IND,SVK,2019.0,3,2,1
KAZ,ITA,2020.0,1,2,-1
JPN,LKA,2009.0,7,2,5
ECU,MEX,2015.0,4,12,-8
ZWE,BWA,2014.0,1,1,0
ZWE,FRA,2008.0,1,1,0
QAT,JOR,2020.0,5,13,-8
CHE,PHL,2016.0,2,3,-1
PAK,NGA,2006.0,1,1,0
RUS,BGR,2007.0,1,2,-1
SAU,MAR,2015.0,2,4,-2
DNK,IRN,2008.0,2,4,-2
DNK,GNB,2007.0,2,1,1
DEU,SDN,2008.0,2,1,1
HUN,ESP,2013.0,5,4,1
CAN,MYS,2004.0,1,1,0
PAK,JOR,2009.0,2,1,1
ISR,FIN,2012.0,1,1,0
CMR,GHA,2019.0,3,1,2
BEL,SVN,2016.0,3,5,-2
SGP,HUN,2012.0,2,2,0
HRV,NLD,2020.0,7,3,4
SAU,NZL,2018.0,3,3,0
GBR,PER,2019.0,5,9,-4
BGD,NZL,2016.0,1,2,-1
EGY,PRT,2006.0,1,1,0
SAU,JPN,2011.0,1,8,-7
DOM,USA,2020.0,2,5,-3
NGA,JPN,2019.0,7,7,0
PAK,IRN,2011.0,2,1,1
DNK,LTU,2018.0,4,8,-4
JOR,SYR,2016.0,2,5,-3
TUR,FIN,2008.0,3,4,-1
ITA,KOR,2001.0,2,1,1
SWE,CRI,2005.0,1,1,0
GHA,JPN,1999.0,1,1,0
HUN,BEL,1999.0,3,2,1
SVN,ITA,2004.0,1,4,-3
UGA,USA,2000.0,1,1,0
KOR,MEX,2011.0,1,1,0
DNK,BRA,2002.0,1,2,-1
NOR,CAN,2022.0,2,8,-6
ESP,KOR,2004.0,2,2,0
HRV,DEU,1997.0,4,4,0
JOR,QAT,2010.0,5,1,4
SGP,ISR,2008.0,3,1,2
GBR,HRV,2013.0,5,8,-3
VNM,SGP,2008.0,3,1,2
CAN,LUX,2012.0,1,2,-1
NZL,SGP,2022.0,7,9,-2
JPN,ROU,2015.0,6,2,4
AUT,NOR,2013.0,7,5,2
HUN,NOR,2021.0,3,1,2
AUS,AUT,2020.0,13,21,-8
SVN,NOR,2020.0,1,1,0
AUT,NZL,2013.0,3,6,-3
ARE,IRL,2022.0,1,2,-1
KAZ,USA,2021.0,3,9,-6
TUR,TUN,2022.0,1,1,0
PRT,CHL,2011.0,1,1,0
CHN,SVK,2021.0,2,2,0
CIV,CHE,2015.0,1,1,0
TZA,ESP,2002.0,2,1,1
DNK,UKR,2002.0,2,2,0
EST,SWE,2000.0,1,2,-1
MKD,SRB,2001.0,1,1,0
MDA,RUS,1999.0,3,1,2
KWT,FIN,2003.0,2,1,1
PRT,SWE,2001.0,3,2,1
JAM,TTO,2004.0,1,2,-1
VEN,CAN,2016.0,1,2,-1
LTU,GBR,2000.0,2,1,1
MYS,NZL,2002.0,2,2,0
AUS,PRK,2011.0,1,1,0
SWE,GNB,2003.0,2,1,1
KOR,FRA,1999.0,3,2,1
BEN,CIV,2020.0,1,1,0
GHA,SWE,2012.0,1,3,-2
LUX,ESP,2017.0,4,7,-3
DZA,GBR,2021.0,1,3,-2
NAM,CHN,2019.0,1,1,0
BLR,POL,2022.0,2,1,1
COL,CRI,2020.0,1,1,0
PAK,BRN,2020.0,1,1,0
ISR,ROU,2021.0,2,2,0
ISR,CZE,2010.0,1,1,0
CHL,MEX,2001.0,3,2,1
ARE,AUT,2009.0,1,1,0
USA,MLI,2018.0,2,3,-1
OMN,JPN,2014.0,2,1,1
NZL,FIN,2014.0,1,2,-1
POL,CHL,2020.0,3,1,2
EGY,SYR,2015.0,1,3,-2
LKA,NZL,2020.0,6,4,2
TWN,ITA,2014.0,4,7,-3
IRN,JOR,2021.0,1,1,0
FRA,LVA,2020.0,1,1,0
GRC,ZAF,2014.0,2,1,1
ARE,THA,2014.0,1,2,-1
NOR,SGP,2004.0,1,1,0
KEN,TUN,2012.0,1,1,0
ARE,LBN,2009.0,1,2,-1
JOR,USA,1997.0,1,2,-1
BEL,CIV,2001.0,2,3,-1
SGP,AUT,2008.0,1,6,-5
BEL,CHE,1998.0,2,4,-2
MYS,CHE,2016.0,1,2,-1
ITA,URY,2019.0,2,1,1
RUS,COL,2019.0,2,1,1
BEL,UGA,2019.0,1,2,-1
LBN,ISR,2009.0,1,1,0
USA,MDA,2014.0,1,1,0
IRL,IRQ,2019.0,2,2,0
POL,MEX,2013.0,2,4,-2
CHE,LSO,2021.0,1,2,-1
BEL,IRN,2007.0,2,3,-1
PER,BEL,2018.0,4,1,3
CAN,MUS,2002.0,1,1,0
TWN,RUS,2012.0,1,2,-1
UKR,GBR,2021.0,3,5,-2
BGD,THA,2012.0,3,1,2
AUS,PAN,2018.0,2,1,1
ECU,CAN,2018.0,2,3,-1
KOR,ISR,2016.0,1,3,-2
SGP,SWE,1998.0,1,1,0
AUS,SAU,1999.0,1,1,0
DEU,NER,2017.0,1,1,0
NOR,BGD,2010.0,1,2,-1
MEX,CUB,2016.0,3,27,-24
HRV,IND,2017.0,1,1,0
SWE,OMN,2021.0,1,1,0
NOR,AUS,2001.0,3,4,-1
SYR,CHN,2020.0,1,1,0
OMN,SDN,2020.0,1,2,-1
VNM,POL,2006.0,1,1,0
JPN,GHA,2013.0,1,3,-2
PAK,NLD,2016.0,2,18,-16
NGA,SLE,2020.0,1,1,0
ARM,RUS,2012.0,2,1,1
LBY,GBR,2020.0,5,17,-12
PER,DEU,2002.0,2,1,1
JOR,PAK,2020.0,2,3,-1
USA,MKD,2019.0,1,2,-1
CAN,BWA,2016.0,1,1,0
MYS,FRA,2004.0,1,1,0
OMN,ARE,2004.0,2,3,-1
THA,CHN,2011.0,1,5,-4
KEN,EGY,2009.0,1,3,-2
ARE,HKG,2009.0,1,1,0
ESP,LTU,2017.0,1,3,-2
SDN,GBR,2010.0,1,4,-3
PAK,UKR,2009.0,1,2,-1
NGA,UGA,2017.0,2,2,0
NLD,CMR,2019.0,1,1,0
AUS,NGA,2015.0,2,4,-2
GBR,PER,2010.0,2,2,0
ARE,MYS,2022.0,1,8,-7
MYS,NZL,2005.0,1,1,0
VNM,SRB,2019.0,1,3,-2
FRA,ZWE,2020.0,1,2,-1
IRN,PAK,2022.0,1,2,-1
FRA,CAF,2016.0,1,2,-1
CMR,BEL,2012.0,1,5,-4
TUR,EGY,2012.0,1,1,0
SVK,DEU,2022.0,1,2,-1
THA,BEL,2013.0,1,3,-2
ESP,ETH,2010.0,2,1,1
VNM,TWN,2013.0,1,8,-7
SAU,KWT,2022.0,1,1,0
ZWE,BEL,2018.0,1,2,-1
FSM,USA,2013.0,1,1,0
IRL,SRB,2021.0,1,3,-2
SDN,FRA,2015.0,1,2,-1
IRN,AUT,2005.0,1,2,-1
USA,GIN,2017.0,1,1,0
CZE,IRL,2020.0,3,4,-1
CHE,UKR,2003.0,2,3,-1
AUS,MWI,2006.0,1,1,0
AUT,CHN,2000.0,1,8,-7
USA,CRI,1999.0,1,2,-1
DZA,CHN,2011.0,1,2,-1
NPL,CAN,2002.0,1,1,0
JAM,DEU,2021.0,1,1,0
IND,BHR,2011.0,1,2,-1
JOR,OMN,2009.0,1,2,-1
NPL,DEU,2011.0,1,1,0
MDA,DEU,2016.0,1,1,0
HKG,GHA,2017.0,1,1,0
SLE,GBR,2012.0,1,2,-1
HKG,PAK,2014.0,1,1,0
CHE,COG,2012.0,1,1,0
BEL,KHM,2006.0,1,1,0
CHL,CRI,2011.0,2,2,0
YEM,JOR,2019.0,1,2,-1
GRC,SRB,2018.0,1,1,0
TWN,POL,2005.0,1,1,0
MDG,GBR,2022.0,1,5,-4
ESP,GTM,2009.0,1,1,0
LAO,USA,2018.0,2,2,0
NPL,NOR,2020.0,1,2,-1
POL,ZAF,2013.0,1,6,-5
BGD,OMN,2019.0,1,2,-1
TWN,VNM,2002.0,1,1,0
RUS,AGO,2017.0,1,1,0
CHE,VEN,2014.0,1,2,-1
BGD,TWN,2010.0,1,1,0
USA,DOM,2007.0,1,1,0
NGA,UGA,2010.0,1,1,0
CHN,JPN,2005.0,205,331,-126
GBR,ARG,2016.0,16,11,5
JPN,CHN,2010.0,433,249,184
GRC,USA,2013.0,115,80,35
GBR,SWE,2007.0,90,111,-21
DEU,USA,2015.0,1184,1060,124
CAN,DEU,2014.0,189,166,23
ESP,BRA,2007.0,34,38,-4
CHN,HKG,2012.0,297,427,-130
USA,DEU,2021.0,757,757,0
GBR,ESP,2016.0,243,502,-259
GBR,DNK,2002.0,55,49,6
ESP,NLD,2018.0,75,61,14
AUS,NZL,2019.0,144,147,-3
GBR,IRL,2017.0,184,237,-53
JPN,CHN,2017.0,464,291,173
GBR,IRQ,2019.0,153,18,135
ESP,CHL,2017.0,116,73,43
GBR,JPN,2004.0,95,81,14
CAN,SAU,2014.0,107,39,68
IRN,CAN,2004.0,31,30,1
NGA,MYS,2021.0,21,68,-47
AUS,SWE,2017.0,64,38,26
POL,DNK,2017.0,12,6,6
USA,OMN,2002.0,3,9,-6
FIN,AUS,2020.0,10,21,-11
USA,NPL,2017.0,20,28,-8
IND,PRT,2013.0,15,11,4
KOR,NLD,2020.0,17,7,10
MYS,GBR,2016.0,91,127,-36
MTQ,FRA,2006.0,15,9,6
HKG,CAN,2001.0,19,9,10
IRN,SWE,2012.0,30,14,16
HUN,IRL,2008.0,2,2,0
PER,BRA,2011.0,14,9,5
HUN,DEU,2013.0,40,30,10
AUT,BGR,2005.0,3,2,1
ZAF,NLD,2010.0,15,14,1
JPN,TWN,2006.0,32,8,24
FRA,BRA,2005.0,63,62,1
ARG,CHL,2003.0,21,4,17
ARG,AUS,2016.0,6,8,-2
ARE,HUN,2019.0,2,1,1
UZB,JPN,2018.0,2,1,1
USA,HUN,2021.0,21,31,-10
PRT,GBR,2003.0,25,47,-22
ESP,PRT,2022.0,46,54,-8
CAN,PHL,2017.0,2,2,0
TUR,ESP,2008.0,8,1,7
GBR,MDG,2019.0,4,4,0
ARG,GBR,2003.0,17,10,7
POL,FRA,2001.0,20,30,-10
SWE,ESP,2005.0,17,14,3
CZE,DEU,2006.0,22,25,-3
HUN,USA,2001.0,52,51,1
SGP,ARE,2018.0,3,2,1
USA,ISL,2011.0,11,5,6
GBR,CZE,2007.0,26,30,-4
ISR,ITA,2000.0,3,5,-2
ITA,ARG,2002.0,12,15,-3
JOR,USA,1998.0,3,5,-2
BEL,ITA,1998.0,3,4,-1
CAN,UKR,1999.0,2,6,-4
JAM,USA,2003.0,4,4,0
JPN,RUS,2017.0,8,14,-6
NLD,GRC,2004.0,13,6,7
CMR,FRA,2013.0,6,15,-9
PRI,CHN,2012.0,3,3,0
AUS,HKG,2022.0,25,15,10
HKG,DEU,2012.0,16,7,9
AUT,FIN,2016.0,12,12,0
GHA,USA,2014.0,15,23,-8
FRA,HUN,2014.0,14,12,2
SRB,NLD,2012.0,7,1,6
KOR,ITA,2012.0,7,8,-1
CHN,CHE,2012.0,32,36,-4
NOR,AUT,2017.0,8,9,-1
ARG,CRI,2019.0,2,1,1
SGP,MYS,2017.0,14,24,-10
LUX,NLD,2019.0,5,5,0
CAN,PHL,2019.0,2,8,-6
TUN,DEU,2022.0,1,3,-2
SWE,DNK,1998.0,15,16,-1
ITA,RUS,2009.0,18,14,4
GBR,PSE,2019.0,8,2,6
FIN,CAN,2007.0,9,10,-1
SVN,USA,2012.0,8,13,-5
COL,FRA,2015.0,18,13,5
NGA,SAU,2013.0,3,6,-3
EGY,DEU,2009.0,25,28,-3
MYS,IRQ,2013.0,36,5,31
CHE,RUS,2022.0,6,10,-4
ISR,CZE,2019.0,4,4,0
BEN,GAB,2020.0,1,1,0
ITA,HRV,2006.0,4,2,2
ECU,FRA,2003.0,4,3,1
SWE,UKR,2005.0,3,6,-3
ARG,SWE,2001.0,5,3,2
UKR,DNK,2006.0,1,1,0
GRC,FIN,2010.0,3,1,2
QAT,CAN,2013.0,2,11,-9
BRA,CZE,2018.0,10,2,8
IRL,POL,2016.0,5,4,1
SWE,BGD,2011.0,4,3,1
HRV,SRB,2013.0,11,5,6
FRA,IRQ,2020.0,9,1,8
NLD,ARE,2018.0,7,1,6
GBR,LKA,2022.0,4,5,-1
PER,ITA,2021.0,4,1,3
BFA,NLD,2004.0,1,1,0
EGY,JOR,2011.0,1,2,-1
EST,USA,2004.0,3,7,-4
DNK,NLD,1998.0,3,5,-2
COD,COG,2003.0,2,2,0
ARM,DEU,2003.0,5,4,1
BEL,CHE,1997.0,5,2,3
MEX,AUS,2002.0,3,2,1
NLD,ROU,2010.0,4,5,-1
CMR,KEN,2002.0,1,1,0
PRT,ROU,2016.0,3,1,2
DEU,CRI,2015.0,7,3,4
TTO,GBR,2008.0,2,6,-4
SAU,CAN,2009.0,14,50,-36
COG,BEL,2003.0,2,4,-2
IRQ,ITA,2008.0,1,1,0
BEL,GRC,1998.0,3,2,1
MAC,USA,2007.0,1,6,-5
NGA,NLD,2018.0,4,6,-2
ZAF,NAM,2022.0,5,2,3
SVK,HUN,2001.0,1,1,0
ROU,NLD,2001.0,3,1,2
SGP,PAK,2011.0,2,1,1
VEN,FRA,2001.0,5,1,4
ISR,CZE,2017.0,1,2,-1
ITA,ISR,2003.0,5,9,-4
COL,RUS,2006.0,4,4,0
BRA,DNK,2003.0,3,3,0
MOZ,ZAF,2011.0,2,1,1
EGY,SAU,1999.0,3,6,-3
MEX,BEL,1999.0,1,1,0
HKG,FIN,2009.0,2,2,0
ROU,SVK,2017.0,2,1,1
CHE,COL,2016.0,2,3,-1
MEX,AUT,2017.0,4,2,2
PAN,MEX,2020.0,1,1,0
BEL,UGA,2017.0,2,1,1
LBY,USA,2001.0,1,1,0
IND,KWT,2022.0,1,1,0
ESP,ETH,2017.0,1,2,-1
DNK,MYS,2008.0,1,1,0
CHL,ISR,2017.0,2,2,0
SGP,ESP,2021.0,2,4,-2
UKR,IRL,2015.0,1,1,0
BTN,THA,2017.0,2,1,1
AZE,USA,2010.0,1,2,-1
IRL,VNM,2020.0,2,1,1
KOR,NZL,2020.0,4,3,1
GHA,KOR,2016.0,1,1,0
AUT,LVA,2008.0,1,1,0
CMR,GHA,2017.0,1,1,0
FRA,PHL,2009.0,1,2,-1
JPN,,2021.0,32832,0,32832
,KOR,2004.0,9922,0,9922
DEU,,2011.0,12345,0,12345
,DEU,1999.0,29242,0,29242
CHN,,2008.0,21047,0,21047
,ESP,2001.0,11816,0,11816
TWN,,2006.0,1604,0,1604
IND,,2008.0,3997,0,3997
DNK,,2015.0,1415,0,1415
,FRA,2006.0,13915,0,13915
ITA,,2022.0,25133,0,25133
,ITA,1999.0,22105,0,22105
ISR,,2010.0,1334,0,1334
,TGO,2001.0,17,0,17
,CHE,2000.0,3872,0,3872
CHN,KAZ,1998.0,1,0,1
,SAU,2011.0,1701,0,1701
ETH,EGY,2013.0,1,0,1
,VNM,2004.0,236,0,236
,KEN,1999.0,314,0,314
,FIN,2007.0,1988,0,1988
,MEX,1994.0,1701,0,1701
,ROU,2003.0,1105,0,1105
SWE,,2008.0,1834,0,1834
GRC,,2009.0,1105,0,1105
ISR,,2017.0,1902,0,1902
CZE,,2006.0,538,0,538
MTQ,,2024.0,27,0,27
,IND,2001.0,11302,0,11302
ISR,,2019.0,2286,0,2286
NGA,,2014.0,757,0,757
CIV,,2021.0,256,0,256
,YEM,2004.0,28,0,28
,KOR,1996.0,2675,0,2675
,GRC,1998.0,3448,0,3448
ARG,,2012.0,952,0,952
IRL,,2019.0,1342,0,1342
,PHL,2004.0,191,0,191
IRL,,2017.0,1133,0,1133
SDN,DEU,2012.0,3,0,3
BWA,,2023.0,296,0,296
IRL,ISR,2011.0,9,0,9
IRL,,2010.0,551,0,551
,LTU,2000.0,590,0,590
PRT,,2025.0,13,0,13
,COL,2009.0,1487,0,1487
VEN,,2020.0,541,0,541
,UKR,2013.0,2129,0,2129
BEL,,2005.0,913,0,913
,UZB,1998.0,180,0,180
,IRL,2006.0,1490,0,1490
,PHL,1996.0,73,0,73
ZAF,SRB,2000.0,1,0,1
,LVA,2012.0,241,0,241
SYR,,2009.0,21,0,21
,DZA,2010.0,1164,0,1164
BHR,,2018.0,55,0,55
UZB,,2013.0,110,0,110
,GRC,1997.0,589,0,589
CUB,CAN,2014.0,5,0,5
,BLR,2011.0,281,0,281
GBR,PSE,2010.0,3,0,3
TZA,RWA,2015.0,1,0,1
,BOL,2014.0,46,0,46
,KHM,2011.0,59,0,59
,BRN,2015.0,40,0,40
,JOR,2013.0,375,0,375
FJI,,2018.0,21,0,21
BGD,,2007.0,71,0,71
PSE,,2022.0,215,0,215
,VUT,2010.0,2,0,2
ESP,TTO,2021.0,1,0,1
,DZA,2017.0,1289,0,1289
CUB,CHL,2019.0,8,0,8
,ZWE,2013.0,101,0,101
MYS,MAR,2017.0,3,0,3
,FJI,2013.0,21,0,21
,CUB,2013.0,475,0,475
,GRL,2013.0,7,0,7
,ARE,2018.0,668,0,668
,PER,2018.0,969,0,969
LBY,,2024.0,217,0,217
YEM,,2019.0,48,0,48
BHS,,2023.0,17,0,17
PAK,KWT,2014.0,2,0,2
AZE,USA,2017.0,1,0,1
UKR,EST,2022.0,1,0,1
,DZA,2019.0,636,0,636
MOZ,PRT,2018.0,5,0,5
BLR,ZWE,2019.0,1,0,1
ITA,TUN,2008.0,2,0,2
,UGA,2000.0,108,0,108
SWZ,,2023.0,39,0,39
,PRI,2018.0,90,0,90
CHN,SLE,2019.0,1,0,1
,MWI,2002.0,35,0,35
JPN,AFG,2022.0,5,0,5
,BHR,2003.0,47,0,47
MCO,GBR,2006.0,1,0,1
FIN,ISL,2021.0,2,0,2
,ECU,2005.0,89,0,89
ARE,JPN,2021.0,1,0,1
YEM,,2017.0,38,0,38
,CRI,2005.0,85,0,85
MKD,CAN,2011.0,1,0,1
AUT,KEN,2011.0,2,0,2
BEL,,2002.0,232,0,232
JPN,SLE,2012.0,1,0,1
MEX,IDN,2015.0,1,0,1
ETH,,2004.0,12,0,12
FIN,,2004.0,559,0,559
SEN,KEN,2007.0,2,0,2
,ECU,2002.0,78,0,78
CUB,,2006.0,168,0,168
HRV,,2005.0,173,0,173
SGP,GHA,2017.0,1,0,1
SRB,,2001.0,12,0,12
TWN,PAK,2016.0,2,0,2
TUR,DNK,2022.0,5,0,5
,NER,2016.0,23,0,23
BGD,IDN,2022.0,2,0,2
COL,,2001.0,11,0,11
ESP,ETH,2019.0,5,0,5
USA,SWZ,2009.0,1,0,1
FRA,TCD,2004.0,3,0,3
EGY,NZL,2018.0,3,0,3
,CRI,2002.0,78,0,78
HRV,,2002.0,53,0,53
LSO,,2004.0,1,0,1
LTU,NOR,2010.0,3,0,3
MDG,,2009.0,15,0,15
EST,ESP,2007.0,1,0,1
LVA,,2006.0,24,0,24
MNG,,2004.0,5,0,5
MKD,,2003.0,6,0,6
,UZB,1997.0,66,0,66
,WSM,2001.0,2,0,2
NPL,NAM,2014.0,1,0,1
AZE,,2005.0,20,0,20
GTM,,2013.0,14,0,14
,MUS,1995.0,2,0,2
UKR,BRA,2005.0,1,0,1
CMR,,2005.0,16,0,16
SDN,JPN,2019.0,3,0,3
SVN,NLD,2008.0,3,0,3
,GAB,2003.0,19,0,19
,GTM,1994.0,16,0,16
,YEM,1996.0,4,0,4
RUS,LKA,2011.0,1,0,1
AZE,,2002.0,4,0,4
SWE,ARE,2013.0,5,0,5
PAK,GMB,2019.0,2,0,2
SRB,MLT,2008.0,1,0,1
COL,NZL,2008.0,1,0,1
IDN,USA,1998.0,1,0,1
GUF,SEN,2012.0,1,0,1
,VNM,1996.0,40,0,40
NIC,USA,2021.0,3,0,3
SWE,CRI,2002.0,2,0,2
USA,KNA,2008.0,1,0,1
CHE,PAN,2004.0,1,0,1
AUT,BIH,2006.0,1,0,1
,PSE,1995.0,5,0,5
NPL,MYS,2007.0,1,0,1
SWE,BOL,2016.0,1,0,1
FRA,OMN,2005.0,2,0,2
,LAO,2003.0,12,0,12
TTO,,2003.0,6,0,6
EGY,GRC,2006.0,2,0,2
AFG,CZE,2010.0,1,0,1
ETH,LBY,2010.0,1,0,1
DEU,AFG,2022.0,1,0,1
NIC,NOR,2007.0,1,0,1
IRQ,AUT,2006.0,1,0,1
NZL,THA,2006.0,1,0,1
LBY,ITA,2019.0,1,0,1
CRI,POL,2007.0,1,0,1
SAU,CMR,2018.0,1,0,1
,KNA,2007.0,1,0,1
GRL,AUT,2020.0,1,0,1
ESP,PAK,2016.0,2,0,2
MEX,KOR,2018.0,4,0,4
BFA,DNK,2013.0,1,0,1
UGA,OMN,2021.0,1,0,1
ITA,HKG,2017.0,4,0,4
ITA,URY,2017.0,3,0,3
UZB,UKR,2011.0,2,0,2
BGD,OMN,2010.0,1,0,1
MEX,HUN,2019.0,4,0,4
SVK,SRB,2007.0,1,0,1
MOZ,ESP,2014.0,3,0,3
IND,TTO,2011.0,5,0,5
NLD,PHL,2015.0,6,0,6
SWE,KEN,2009.0,2,0,2
LTU,EST,2003.0,1,0,1
VEN,DEU,2021.0,1,0,1
ERI,,2020.0,11,0,11
UKR,AUS,2011.0,1,0,1
,MWI,2005.0,69,0,69
CAN,NCL,2007.0,1,0,1
VNM,BIH,2021.0,1,0,1
EGY,BEL,1998.0,1,0,1
IRN,TWN,2022.0,6,0,6
IDN,SGP,2009.0,1,0,1
TJK,GBR,2014.0,1,0,1
CMR,SEN,2011.0,2,0,2
ISL,CHN,2021.0,2,0,2
CHE,MWI,2016.0,2,0,2
SAU,FIN,2022.0,1,0,1
PAK,CYP,2017.0,1,0,1
BRA,AGO,2018.0,3,0,3
JAM,BHS,2005.0,1,0,1
CHL,,2000.0,32,0,32
CRI,PAN,2020.0,2,0,2
NIC,ESP,2021.0,1,0,1
BLR,CHE,2003.0,1,0,1
TUN,JPN,2020.0,2,0,2
MUS,,2009.0,3,0,3
TGO,KEN,2001.0,1,0,1
COG,RWA,2011.0,1,0,1
PAN,BRA,2009.0,2,0,2
,NAM,1998.0,5,0,5
RUS,EGY,2013.0,3,0,3
SYC,,2004.0,4,0,4
THA,ISR,2015.0,1,0,1
ARG,TWN,2006.0,2,0,2
DNK,EGY,2010.0,1,0,1
NOR,SVK,2018.0,3,0,3
UGA,MLI,2015.0,1,0,1
DEU,GAB,2013.0,5,0,5
BEL,UGA,2010.0,2,0,2
BEL,TZA,2015.0,4,0,4
NOR,LVA,2021.0,1,0,1
SWE,MLT,2011.0,1,0,1
KHM,GBR,2003.0,1,0,1
ISR,MWI,2014.0,1,0,1
,BDI,2010.0,13,0,13
HUN,IDN,2016.0,1,0,1
BRA,GRC,2006.0,1,0,1
SAU,URY,2018.0,1,0,1
NGA,SWZ,2013.0,1,0,1
ESP,CPV,2015.0,1,0,1
PHL,DNK,2008.0,1,0,1
CAN,MAR,2001.0,3,0,3
YEM,,2010.0,10,0,10
JPN,SVK,2013.0,1,0,1
RUS,AZE,1997.0,3,0,3
LBY,ETH,2015.0,1,0,1
FRA,SYR,2002.0,2,0,2
BFA,,2001.0,2,0,2
BEL,MAC,2007.0,1,0,1
OMN,BHR,2018.0,1,0,1
CAN,IRQ,2014.0,3,0,3
NAM,NOR,2017.0,1,0,1
USA,MDV,2014.0,1,0,1
JPN,NOR,2003.0,7,0,7
ITA,SDN,2008.0,1,0,1
SYR,TUN,2019.0,1,0,1
JOR,PSE,2018.0,5,0,5
,SYC,2009.0,2,0,2
BEL,BEN,2009.0,4,0,4
BRA,EGY,2013.0,1,0,1
HKG,NLD,2006.0,4,0,4
KOR,PRK,2016.0,1,0,1
ESP,CRI,2021.0,9,0,9
PHL,LAO,2020.0,1,0,1
NOR,BGD,2017.0,4,0,4
HKG,PSE,2022.0,1,0,1
UGA,LSO,2016.0,1,0,1
PAK,PSE,2004.0,1,0,1
HTI,,2009.0,6,0,6
CMR,COG,2014.0,2,0,2
BLR,LVA,2002.0,1,0,1
TKM,TUR,2017.0,1,0,1
CAN,ARM,2000.0,1,0,1
SEN,BFA,2000.0,2,0,2
SVK,PSE,2022.0,1,0,1
CZE,DZA,2004.0,1,0,1
ZWE,DNK,2007.0,1,0,1
BMU,,2019.0,7,0,7
JPN,IRN,2001.0,2,0,2
YEM,IRQ,2010.0,1,0,1
DNK,KEN,2014.0,1,0,1
IRL,HUN,2007.0,2,0,2
GTM,COL,2009.0,2,0,2
KOR,CHL,2003.0,1,0,1
NLD,TZA,2003.0,1,0,1
SEN,NER,2004.0,2,0,2
LBN,MLT,2016.0,1,0,1
IRL,MYS,2002.0,1,0,1
ECU,PRI,2015.0,1,0,1
IRL,NOR,2005.0,1,0,1
MEX,ETH,2016.0,2,0,2
FIN,UKR,2008.0,2,0,2
VGB,CAN,2008.0,1,0,1
HUN,CHN,2013.0,1,0,1
NPL,SWE,2015.0,3,0,3
FRA,DJI,2011.0,4,0,4
IND,KEN,2012.0,3,0,3
TUN,OMN,2021.0,4,0,4
VEN,IND,2019.0,1,0,1
KEN,MEX,2009.0,1,0,1
IND,UGA,2014.0,1,0,1
,AND,2010.0,2,0,2
TUN,CYP,2019.0,1,0,1
DEU,COD,2020.0,1,0,1
IRN,CHL,2020.0,5,0,5
ARG,CHN,2002.0,1,0,1
,NAM,1997.0,5,0,5
MLI,GBR,2006.0,1,0,1
COL,UKR,2018.0,1,0,1
USA,MKD,2017.0,3,0,3
BRA,CMR,2012.0,1,0,1
BRA,SRB,2000.0,1,0,1
DEU,SWE,2023.0,1,0,1
BRA,CIV,2018.0,1,0,1
FRA,MOZ,2019.0,1,0,1
HUN,AUS,1999.0,1,0,1
BRA,PHL,2007.0,2,0,2
ARE,HUN,2017.0,1,0,1
DNK,SAU,2006.0,1,0,1
FRA,PAN,2008.0,1,0,1
KHM,DEU,2010.0,1,0,1
UKR,PRT,1999.0,1,0,1
UKR,BRA,2002.0,1,0,1
MNE,NOR,2006.0,1,0,1
LBN,,2000.0,1,0,1
SWE,CHL,2008.0,2,0,2
ITA,DOM,2015.0,1,0,1
NCL,VUT,2011.0,1,0,1
KEN,MYS,2009.0,2,0,2
CMR,GHA,2010.0,1,0,1
GRC,SGP,2016.0,3,0,3
IND,IRQ,2015.0,7,0,7
URY,MNE,2015.0,1,0,1
ESP,AGO,2014.0,1,0,1
MYS,ROU,2016.0,1,0,1
BRA,HKG,2022.0,3,0,3
,CAF,2013.0,6,0,6
RUS,SVN,2017.0,1,0,1
UKR,HKG,2021.0,1,0,1
,BDI,2017.0,13,0,13
GMB,SLE,2018.0,2,0,2
BEL,EST,2002.0,1,0,1
GRC,SVK,2008.0,2,0,2
NZL,SRB,2007.0,1,0,1
ESP,PSE,2016.0,3,0,3
BEL,MOZ,2019.0,2,0,2
CMR,KEN,2005.0,2,0,2
NLD,KAZ,2009.0,1,0,1
ZAF,COD,2019.0,3,0,3
MHL,,2024.0,1,0,1
TUN,PAK,2021.0,1,0,1
CZE,DNK,1999.0,2,0,2
ZAF,SAU,1998.0,1,0,1
AUT,RUS,1998.0,3,0,3
NZL,TWN,2004.0,1,0,1
,ERI,2006.0,1,0,1
DEU,RWA,2009.0,1,0,1
IRQ,QAT,2010.0,2,0,2
KWT,BHR,2009.0,1,0,1
AUS,MUS,2012.0,1,0,1
LUX,MAR,2014.0,1,0,1
KOR,DNK,2006.0,1,0,1
TUR,LBY,2022.0,2,0,2
SYR,JPN,2011.0,1,0,1
YEM,IRQ,2019.0,1,0,1
FLK,,2021.0,1,0,1
TUN,DNK,2022.0,1,0,1
UKR,ISR,2012.0,4,0,4
SWE,LAO,2012.0,1,0,1
FRA,SYR,2005.0,3,0,3
SEN,GBR,2015.0,2,0,2
CAN,SEN,2001.0,1,0,1
MWI,GBR,1998.0,1,0,1
NAM,GBR,2006.0,1,0,1
SVN,PRT,2018.0,1,0,1
CAN,LVA,2007.0,1,0,1
DNK,EGY,2017.0,2,0,2
PYF,,2012.0,2,0,2
GMB,CHE,2019.0,1,0,1
RWA,CIV,2005.0,1,0,1
FRA,GHA,2007.0,1,0,1
CHE,MMR,2015.0,2,0,2
IND,LUX,2005.0,1,0,1
ARG,NLD,1998.0,2,0,2
AUT,GEO,2005.0,1,0,1
DNK,ARM,2002.0,1,0,1
CZE,VNM,1999.0,1,0,1
GBR,SVN,1999.0,2,0,2
AUS,VEN,2009.0,1,0,1
NPL,TWN,2016.0,2,0,2
DZA,EGY,2006.0,2,0,2
YEM,FIN,2018.0,1,0,1
QAT,ZAF,2021.0,1,0,1
NIC,PRT,2010.0,1,0,1
MNE,BGR,2015.0,1,0,1
DMA,REU,2015.0,1,0,1
TUR,BRN,2018.0,1,0,1
SWE,BWA,2001.0,1,0,1
,VUT,2017.0,4,0,4
PRT,CAN,1997.0,2,0,2
JOR,LBN,1999.0,1,0,1
HKG,KAZ,2019.0,1,0,1
MEX,AUT,2010.0,1,0,1
GRC,CHL,2017.0,3,0,3
CAN,PHL,2010.0,2,0,2
JOR,LBY,2017.0,1,0,1
FRA,MRT,2006.0,1,0,1
USA,MKD,2010.0,4,0,4
BHR,DEU,2014.0,2,0,2
ZAF,DNK,1999.0,1,0,1
EGY,CZE,2005.0,1,0,1
,FLK,2001.0,2,0,2
IRL,CHL,2003.0,1,0,1
SWE,MOZ,2007.0,1,0,1
JPN,ISL,2000.0,1,0,1
TUR,SAU,2004.0,1,0,1
NGA,AUS,2007.0,1,0,1
CAN,MCO,2004.0,1,0,1
JPN,EST,1998.0,1,0,1
JPN,PAN,2003.0,1,0,1
CAN,ERI,2002.0,1,0,1
GBR,SLE,2010.0,2,0,2
KEN,BDI,2006.0,1,0,1
NGA,JPN,2010.0,2,0,2
NGA,GMB,2016.0,3,0,3
ZAF,CYP,2016.0,1,0,1
ARE,ZAF,2011.0,1,0,1
FRA,SGP,1998.0,1,0,1
CAF,ARE,2018.0,1,0,1
CUW,NLD,2016.0,1,0,1
TUN,KEN,2010.0,1,0,1
HRV,FIN,2022.0,2,0,2
CHN,PSE,2022.0,1,0,1
CAN,MDG,2015.0,1,0,1
AUT,PHL,2012.0,1,0,1
MYS,MAR,2019.0,2,0,2
SLB,AUS,2011.0,2,0,2
MLI,TGO,2017.0,1,0,1
USA,LAO,2017.0,1,0,1
POL,ETH,2014.0,1,0,1
IRN,AUT,2002.0,1,0,1
,AND,2019.0,3,0,3
LTU,SVN,2016.0,1,0,1
IND,BRB,2018.0,1,0,1
ESP,HKG,2015.0,3,0,3
LBY,IRQ,2018.0,1,0,1
VCT,BRB,2021.0,1,0,1
GBR,SYR,2001.0,1,0,1
BEL,TWN,2007.0,2,0,2
BWA,JAM,2002.0,1,0,1
ARE,BHR,2011.0,2,0,2
SRB,FIN,2001.0,1,0,1
GNB,SWE,2001.0,1,0,1
NGA,ETH,2000.0,1,0,1
OMN,EGY,2000.0,1,0,1
NPL,CAN,2005.0,3,0,3
NZL,LBN,2008.0,1,0,1
KEN,GMB,2009.0,1,0,1
BMU,,2017.0,1,0,1
SLV,GTM,2007.0,1,0,1
NGA,BFA,2014.0,1,0,1
ESP,SLV,2006.0,1,0,1
LVA,KAZ,2020.0,1,0,1
FIN,COL,2016.0,1,0,1
IRQ,QAT,2019.0,2,0,2
HRV,ESP,2009.0,2,0,2
ABW,,2019.0,2,0,2
GRC,UZB,2016.0,1,0,1
GRC,ROU,2020.0,1,0,1
BEN,TGO,2022.0,1,0,1
PAN,ITA,2021.0,2,0,2
ARE,TUN,2010.0,1,0,1
,VUT,2019.0,11,0,11
AUS,ISL,2003.0,1,0,1
AUS,LKA,2001.0,1,0,1
CPV,CHL,2014.0,1,0,1
ITA,REU,2020.0,1,0,1
MEX,SGP,2007.0,1,0,1
MWI,ZMB,2013.0,1,0,1
AUT,PRT,1999.0,1,0,1
SEN,CHE,2001.0,1,0,1
NLD,ERI,2012.0,1,0,1
CMR,GAB,2008.0,1,0,1
SOM,,2014.0,1,0,1
PHL,HKG,2014.0,1,0,1
CHN,UGA,2017.0,2,0,2
VEN,URY,2018.0,2,0,2
BFA,FIN,2018.0,1,0,1
URY,BGR,2020.0,1,0,1
BGD,HUN,2022.0,1,0,1
,TLS,2016.0,6,0,6
KEN,SEN,2022.0,1,0,1
SVK,UKR,2005.0,1,0,1
ARG,IRL,2013.0,1,0,1
NER,CHE,2010.0,1,0,1
THA,MMR,2022.0,1,0,1
CHN,MKD,2013.0,1,0,1
NLD,BFA,2020.0,1,0,1
MAR,ITA,2009.0,1,0,1
ROU,CHL,2021.0,1,0,1
,GIB,2011.0,1,0,1
CHL,AUT,2008.0,1,0,1
UZB,ARE,2010.0,1,0,1
PNG,DEU,2013.0,1,0,1
ALB,CAN,2018.0,1,0,1
GBR,MKD,2011.0,1,0,1
HRV,CHN,2014.0,1,0,1
GTM,ARG,2011.0,1,0,1
GMB,NLD,2010.0,1,0,1
IND,DZA,2021.0,1,0,1
STP,PRT,2021.0,1,0,1
AUS,MDV,2018.0,1,0,1
USA,MRT,2006.0,1,0,1
NZL,EGY,2009.0,1,0,1
,FSM,1994.0,1,0,1
ESP,HND,2016.0,1,0,1
LAO,DEU,2018.0,1,0,1
ZAF,GAB,2004.0,1,0,1
TUN,AUT,2015.0,1,0,1
MAR,BFA,2018.0,1,0,1
NLD,BRB,2017.0,1,0,1
CHN,SSD,2018.0,1,0,1
UZB,ARE,2019.0,1,0,1
URY,CHE,2016.0,1,0,1
ARM,NOR,2016.0,1,0,1
BFA,GMB,2015.0,1,0,1
NLD,MOZ,2022.0,1,0,1
MEX,GRC,2000.0,1,0,1
LTU,IRN,2009.0,1,0,1
AFG,IRQ,2019.0,1,0,1
BTN,NPL,2018.0,1,0,1
URY,CAN,2003.0,1,0,1
NLD,GTM,2013.0,1,0,1
GEO,SWE,2016.0,2,0,2
GRC,BRA,2018.0,1,0,1
LTU,USA,2000.0,2,0,2
MEX,AUS,2005.0,1,0,1
GBR,REU,2008.0,1,0,1
MYS,MAR,2010.0,1,0,1
CMR,BWA,2020.0,1,0,1
USA,MHL,2017.0,1,0,1
IND,POL,1998.0,3,0,3
LTU,JPN,2001.0,2,0,2
ITA,NOR,1999.0,1,0,1
DNK,PAK,2014.0,2,0,2
AUS,UZB,2009.0,1,0,1
DZA,SGP,2004.0,1,0,1
GBR,GRD,2011.0,1,0,1
USA,LAO,2010.0,1,0,1
THA,LKA,2005.0,1,0,1
CHN,SLE,2010.0,1,0,1
KGZ,DEU,2012.0,2,0,2
CHL,SGP,2003.0,1,0,1
RUS,SVN,2010.0,1,0,1
SGP,PRI,2012.0,1,0,1
KAZ,IRQ,2017.0,2,0,2
MDG,ESP,2021.0,1,0,1
NLD,NIC,2018.0,1,0,1
PAK,SYR,2011.0,1,0,1
EGY,GTM,2012.0,1,0,1
GRC,AUS,1998.0,1,0,1
TUN,SWE,2013.0,2,0,2
LBY,BRN,2009.0,1,0,1
SAU,IRL,2011.0,1,0,1
LAO,SWE,2011.0,1,0,1
BIH,BRN,2019.0,1,0,1
CHN,COG,2021.0,1,0,1
ZAF,CIV,2020.0,1,0,1
RWA,ZAF,2021.0,1,0,1
GBR,LAO,2007.0,1,0,1
SWE,MLI,2012.0,1,0,1
DEU,KHM,2017.0,1,0,1
TUR,MAR,2022.0,1,0,1
HUN,EGY,2008.0,2,0,2
FJI,SWE,2017.0,1,0,1
IRL,ETH,2019.0,2,0,2
NLD,PRI,2021.0,1,0,1
ARE,ISL,2022.0,1,0,1
BTN,GBR,2008.0,1,0,1
USA,BRB,2007.0,1,0,1
CZE,LUX,2020.0,1,0,1
VNM,DNK,2008.0,1,0,1
BEL,PAN,2016.0,1,0,1
UKR,OMN,2003.0,1,0,1
DNK,KNA,2018.0,1,0,1
NLD,EST,2006.0,1,0,1
IRL,ETH,2017.0,1,0,1
IND,SYR,2016.0,1,0,1
HND,GBR,2020.0,1,0,1
GHA,PRT,2021.0,1,0,1
DNK,NPL,2021.0,1,0,1
BDI,FRA,2009.0,1,0,1
LTU,HRV,2019.0,1,0,1
LTU,BLR,2008.0,1,0,1
JPN,KAZ,2008.0,1,0,1
CYP,,1999.0,2,0,2
DOM,ESP,2007.0,1,0,1
BEN,MEX,2009.0,1,0,1
MKD,POL,2011.0,1,0,1
BHR,FRA,1997.0,1,0,1
ARG,CHE,2004.0,2,0,2
ITA,THA,2005.0,1,0,1
CUB,CHE,2012.0,1,0,1
PHL,MEX,2005.0,1,0,1
GRL,BGD,2013.0,1,0,1
DEU,MNG,2012.0,1,0,1
VNM,SAU,2022.0,1,0,1
AUS,RWA,2012.0,1,0,1
EST,ROU,2018.0,1,0,1
CHL,TUN,2013.0,1,0,1
CZE,SLV,2018.0,1,0,1
TCD,ITA,2017.0,1,0,1
IRN,SAU,2012.0,1,0,1
AUS,CYP,2005.0,1,0,1
SGP,GHA,2019.0,1,0,1
SYR,RUS,2022.0,1,0,1
CIV,BFA,2014.0,1,0,1
JPN,OMN,2003.0,1,0,1
NZL,ISR,2021.0,1,0,1
QAT,CUB,2008.0,1,0,1
SVK,LUX,2008.0,1,0,1
LIE,,2006.0,1,0,1
AUS,TTO,2005.0,1,0,1
HUN,HKG,2010.0,1,0,1
BEL,HKG,2010.0,1,0,1
DNK,BIH,2019.0,1,0,1
ISR,VEN,2001.0,1,0,1
THA,SAU,2007.0,1,0,1
BGR,DNK,2001.0,1,0,1
ESP,PRY,2012.0,1,0,1
DOM,CHE,2001.0,1,0,1
MDA,AUT,2002.0,1,0,1
CHE,PER,2003.0,1,0,1
DEU,BRN,2011.0,1,0,1
CHL,ISR,2019.0,1,0,1
JOR,PRT,2019.0,2,0,2
BEL,CUB,2008.0,1,0,1
KWT,GRC,2013.0,1,0,1
IND,PER,2019.0,1,0,1
USA,MHL,2019.0,1,0,1
IRL,SVK,2009.0,1,0,1
CZE,BEL,2002.0,5,7,-2
USA,HKG,2009.0,127,114,13
NZL,GBR,2013.0,98,117,-19
FRA,USA,2009.0,681,649,32
RUS,FRA,2010.0,47,25,22
GRC,GBR,2015.0,250,125,125
FIN,DNK,2012.0,13,8,5
USA,ITA,2008.0,356,491,-135
USA,MLI,2019.0,2,3,-1
FRA,POL,2010.0,29,35,-6
NLD,DEU,2008.0,175,220,-45
JPN,DEU,2012.0,114,80,34
USA,FRA,2005.0,526,636,-110
IRL,DEU,2015.0,39,47,-8
GBR,IRL,2018.0,251,241,10
IND,GBR,2000.0,22,15,7
USA,NOR,2013.0,84,68,16
BEL,CHN,2011.0,18,32,-14
BEL,GBR,2014.0,112,99,13
GBR,MEX,2009.0,31,30,1
AUT,CAN,2004.0,22,9,13
USA,IRN,2015.0,87,506,-419
BEL,SWE,2021.0,22,17,5
USA,JPN,2018.0,693,693,0
USA,KEN,2015.0,42,60,-18
DEU,MEX,2011.0,20,32,-12
JPN,TUR,2017.0,7,7,0
USA,SWE,2012.0,175,205,-30
USA,NZL,2021.0,92,82,10
CAN,CHN,2013.0,216,223,-7
ITA,ROU,2000.0,1,2,-1
NLD,FRA,2012.0,99,106,-7
CHN,GBR,2016.0,305,395,-90
SGP,USA,2005.0,101,102,-1
ITA,GRC,2016.0,25,40,-15
CHN,USA,2013.0,2107,2063,44
CHN,AUS,2012.0,175,125,50
IND,FRA,2002.0,32,16,16
DEU,NZL,2010.0,25,24,1
USA,CAN,2022.0,604,624,-20
ITA,BRA,2012.0,44,18,26
GBR,GRC,2008.0,180,106,74
THA,JPN,2005.0,31,68,-37
CUB,CHL,2018.0,17,1,16
FRA,IND,2008.0,24,83,-59
USA,CHN,2004.0,597,805,-208
AUT,ITA,2020.0,36,49,-13
HKG,CHN,2010.0,316,291,25
ESP,NLD,2017.0,74,48,26
LKA,USA,2022.0,9,11,-2
CMR,FRA,2008.0,6,14,-8
CHE,GBR,2021.0,199,255,-56
NOR,ITA,2012.0,7,13,-6
AUS,NZL,2018.0,142,143,-1
CHE,USA,2006.0,330,329,1
IRN,USA,2012.0,321,47,274
FRA,GBR,2020.0,426,427,-1
IRL,GBR,2014.0,265,183,82
IRL,ITA,2010.0,14,25,-11
GRC,USA,2008.0,98,99,-1
GBR,CHN,2021.0,506,392,114
ISR,GBR,2012.0,34,34,0
TWN,AUS,2013.0,8,15,-7
KOR,JPN,2010.0,96,113,-17
USA,SVK,2017.0,11,7,4
IRN,CAN,2014.0,259,59,200
CHL,CAN,2006.0,10,13,-3
BLR,DEU,2003.0,14,3,11
DEU,NLD,2022.0,145,121,24
USA,PAN,2013.0,12,5,7
GBR,THA,2005.0,63,15,48
FRA,DZA,2014.0,107,31,76
SGP,FRA,2012.0,21,24,-3
USA,SVK,2010.0,14,9,5
GBR,EGY,2007.0,25,18,7
CAN,IRN,2015.0,62,273,-211
NOR,AUS,2003.0,7,4,3
SWE,NLD,2015.0,34,67,-33
HKG,CHN,2019.0,768,604,164
FRA,VNM,2011.0,14,7,7
IRN,BEL,2011.0,14,14,0
HKG,CHN,2017.0,601,428,173
NLD,CYP,2015.0,2,1,1
USA,LAO,2018.0,2,2,0
USA,SAU,2018.0,254,129,125
CAN,MEX,2015.0,36,32,4
EST,CHN,2020.0,3,4,-1
KOR,BGD,2012.0,18,10,8
NGA,GBR,2013.0,26,31,-5
GHA,CHN,2014.0,8,3,5
USA,TWN,2007.0,316,213,103
ITA,FRA,2012.0,323,171,152
MEX,ESP,2022.0,28,31,-3
ECU,BRA,2014.0,2,3,-1
JPN,AUS,2019.0,62,40,22
MEX,KOR,2017.0,3,2,1
SGP,USA,2002.0,119,84,35
IND,CAN,2002.0,48,23,25
IRN,TUR,2012.0,17,7,10
SWE,POL,2015.0,9,23,-14
ESP,NLD,2019.0,76,60,16
AUS,HKG,2016.0,39,25,14
IDN,DEU,2021.0,15,14,1
POL,SWE,2021.0,15,9,6
GBR,ESP,2022.0,160,129,31
SAU,ARE,2021.0,18,7,11
KOR,JPN,2019.0,94,92,2
ITA,CHE,2020.0,219,158,61
NCL,FRA,2019.0,23,17,6
FIN,NLD,2019.0,13,17,-4
AUS,SWE,2018.0,57,49,8
CHN,PRK,2018.0,7,2,5
USA,AUT,2005.0,80,88,-8
BLR,RUS,2013.0,12,11,1
IND,SGP,2016.0,86,63,23
CHN,CAN,2003.0,87,54,33
GRC,ITA,2020.0,22,18,4
ECU,COL,2021.0,3,4,-1
PAK,DEU,2012.0,12,35,-23
USA,CYP,2021.0,4,7,-3
ETH,GBR,2015.0,8,3,5
POL,NOR,2021.0,4,7,-3
SAU,DEU,2015.0,6,21,-15
FRA,NLD,2021.0,90,68,22
SGP,MYS,2018.0,15,17,-2
MYS,PHL,2019.0,2,2,0
NZL,AUT,2016.0,2,5,-3
UKR,POL,2012.0,13,10,3
MEX,KOR,2019.0,8,1,7
USA,IRQ,2013.0,10,6,4
DNK,CHN,2021.0,65,59,6
AUS,DEU,2001.0,51,53,-2
FRA,KHM,2021.0,6,2,4
PER,USA,2002.0,15,21,-6
JPN,QAT,2017.0,1,1,0
AUS,ITA,2021.0,28,16,12
CHN,ESP,2015.0,24,22,2
TWN,JPN,2007.0,21,38,-17
AUS,POL,2013.0,23,14,9
JPN,AUS,2017.0,49,67,-18
KOR,JPN,2017.0,101,125,-24
JOR,IRQ,2018.0,5,1,4
LUX,NOR,2022.0,1,1,0
GBR,PER,2018.0,9,4,5
DEU,NZL,2019.0,33,28,5
BEL,ROU,2014.0,6,6,0
SAU,NZL,2017.0,7,4,3
UZB,CHN,2019.0,3,1,2
BRA,CZE,2019.0,11,3,8
CHE,SWE,2020.0,58,44,14
AUS,KOR,2020.0,28,48,-20
USA,NPL,2018.0,15,35,-20
JOR,SAU,2011.0,38,6,32
IRN,NLD,2020.0,47,11,36
BEL,BRA,2022.0,6,20,-14
USA,FRA,2002.0,591,756,-165
DEU,AUT,2004.0,209,147,62
TWN,ESP,2017.0,3,4,-1
GRC,BEL,2021.0,11,14,-3
GBR,KWT,2020.0,19,5,14
MYS,ARE,2018.0,25,4,21
NOR,RUS,2012.0,6,7,-1
IRQ,SWE,2021.0,4,1,3
KEN,CHN,2021.0,4,14,-10
AUS,IND,2015.0,56,110,-54
IND,CAN,2005.0,66,26,40
FRA,ISR,2013.0,26,22,4
ESP,KEN,2016.0,1,3,-2
CAN,FRA,2018.0,254,310,-56
FRA,ESP,2021.0,151,190,-39
IDN,GBR,2020.0,16,33,-17
ETH,KOR,2020.0,1,10,-9
CZE,GBR,2007.0,30,26,4
ITA,PRT,2018.0,42,35,7
AUS,FIN,2012.0,10,13,-3
CHE,SRB,2008.0,2,2,0
SVN,DEU,2011.0,8,5,3
LBN,USA,2021.0,64,25,39
IRL,USA,2003.0,77,82,-5
HRV,SRB,2008.0,8,1,7
CHL,DEU,2018.0,48,34,14
IRL,DNK,2015.0,7,4,3
BRA,MEX,2000.0,2,3,-1
DNK,ESP,2014.0,14,32,-18
ETH,USA,2009.0,11,3,8
CMR,CHE,2019.0,4,2,2
FIN,IND,2015.0,7,25,-18
DEU,PER,2014.0,3,4,-1
JPN,AUT,2010.0,10,9,1
IRL,NLD,2014.0,11,11,0
USA,ZAF,2021.0,60,93,-33
KOR,IDN,2015.0,14,7,7
NGA,SWE,2006.0,3,1,2
NCL,FRA,2010.0,23,7,16
BRA,ITA,2002.0,16,23,-7
SDN,SAU,2013.0,18,4,14
ESP,URY,2014.0,12,6,6
JPN,AUS,2010.0,57,54,3
SGP,CAN,2015.0,22,25,-3
CHE,JPN,2011.0,28,30,-2
BEL,FRA,2009.0,136,179,-43
FIN,CHE,2015.0,19,13,6
CHE,HKG,2009.0,6,6,0
ESP,LTU,2018.0,6,1,5
FRA,MTQ,2014.0,12,26,-14
BLR,FRA,2021.0,1,1,0
ESP,PRT,2016.0,106,65,41
JPN,IDN,2008.0,46,10,36
KOR,CAN,2009.0,43,32,11
AUT,DEU,2001.0,107,109,-2
AUT,USA,1998.0,32,22,10
ITA,EST,2019.0,9,2,7
CHE,FIN,2013.0,18,13,5
NCL,FRA,2017.0,14,22,-8
GBR,ITA,1997.0,22,22,0
MAR,FRA,2002.0,47,54,-7
CAN,BEL,1998.0,7,2,5
BEL,UGA,2018.0,8,2,6
GBR,ISR,2012.0,34,34,0
HKG,SWE,2010.0,2,4,-2
IRL,IRQ,2018.0,3,2,1
RUS,FRA,2019.0,45,37,8
SAU,SDN,2012.0,3,10,-7
ZAF,NLD,2018.0,19,21,-2
SVK,JPN,2005.0,1,3,-2
CAN,MYS,2014.0,11,20,-9
AUS,SGP,2020.0,73,81,-8
MYS,MMR,2017.0,4,1,3
EGY,IRQ,2019.0,10,1,9
GTM,GBR,2019.0,1,1,0
DNK,CHE,2021.0,37,31,6
TUN,DEU,2016.0,3,3,0
NOR,UGA,2018.0,3,2,1
CAN,TUN,2018.0,9,6,3
TWN,FRA,2021.0,4,4,0
SRB,ESP,2020.0,4,2,2
GHA,DEU,2020.0,7,17,-10
HUN,GBR,2020.0,28,28,0
DNK,SVN,2019.0,5,1,4
CHN,MWI,2021.0,5,2,3
NLD,PAK,2017.0,17,4,13
MYS,GBR,2022.0,37,29,8
EGY,FRA,2012.0,5,15,-10
USA,NLD,2002.0,261,264,-3
HKG,GBR,2016.0,53,52,1
AUS,JPN,2011.0,45,69,-24
ITA,CAN,2021.0,36,40,-4
KOR,ISR,2022.0,5,2,3
FIN,JPN,2018.0,11,9,2
IND,PRT,2008.0,14,1,13
TUR,GRC,2022.0,2,1,1
CAN,RUS,2022.0,3,7,-4
BGD,CAN,2004.0,5,2,3
CMR,NGA,2009.0,1,2,-1
AUS,NOR,2007.0,10,11,-1
GBR,HRV,2008.0,4,2,2
CIV,FRA,2009.0,26,14,12
BGR,JPN,2013.0,2,5,-3
TUR,RUS,2007.0,1,2,-1
KWT,MYS,2019.0,2,2,0
FRA,GAB,2015.0,13,1,12
CZE,SWE,2014.0,11,2,9
IRN,MYS,2008.0,15,2,13
GEO,FRA,2019.0,48,11,37
ITA,SVK,2009.0,7,3,4
CZE,CHE,2017.0,19,11,8
FRA,FIN,2006.0,5,11,-6
KOR,BGR,2015.0,3,1,2
CZE,AUT,2006.0,11,2,9
BRA,PRT,2007.0,31,37,-6
RUS,KAZ,2014.0,23,13,10
EST,USA,2014.0,10,5,5
CYP,GBR,2006.0,7,10,-3
RUS,ESP,2013.0,8,11,-3
IND,LKA,2014.0,5,3,2
BGR,ESP,2009.0,3,4,-1
ERI,ETH,2016.0,1,1,0
ESP,DNK,2015.0,48,10,38
ARM,USA,2010.0,9,2,7
BGR,NLD,2002.0,5,5,0
LTU,JPN,2003.0,5,1,4
NOR,SWE,2003.0,43,49,-6
DEU,IDN,2016.0,30,7,23
ARM,USA,2019.0,4,4,0
FRA,TUN,2005.0,74,33,41
USA,BGR,2007.0,15,10,5
POL,HUN,2003.0,5,1,4
AUS,ARE,2008.0,11,5,6
FRA,IRL,2006.0,26,17,9
TUN,FRA,1999.0,9,22,-13
PER,USA,2005.0,23,15,8
SWE,NOR,2009.0,59,28,31
CZE,SVK,2013.0,39,64,-25
GBR,VNM,2002.0,9,6,3
IND,BEL,2006.0,7,6,1
VEN,CHL,2011.0,4,1,3
KEN,FRA,2002.0,1,1,0
JPN,FRA,1999.0,21,32,-11
ARG,GBR,2001.0,15,8,7
LTU,NLD,2007.0,4,3,1
GBR,SGP,2005.0,48,32,16
JAM,USA,2001.0,4,4,0
JPN,IRL,2001.0,6,2,4
ARG,PER,2010.0,4,5,-1
NLD,GRC,2014.0,16,28,-12
POL,ESP,1999.0,2,3,-1
IND,FRA,2005.0,29,25,4
USA,VEN,2001.0,19,24,-5
AUT,SVK,2002.0,8,7,1
HKG,CAN,2003.0,30,24,6
CHE,BEL,2004.0,8,29,-21
HRV,AUT,2001.0,2,1,1
ITA,IRL,2007.0,10,7,3
SWE,BEL,2003.0,5,14,-9
USA,NGA,2003.0,10,9,1
FRA,EGY,2005.0,6,5,1
FRA,HUN,2004.0,8,8,0
MEX,RUS,2009.0,7,5,2
GBR,LKA,2016.0,15,2,13
CHE,ESP,2002.0,28,25,3
CZE,BEL,2005.0,4,2,2
FRA,LUX,2012.0,34,18,16
GBR,ITA,1998.0,32,48,-16
FIN,NLD,2017.0,20,20,0
GRC,TUR,2005.0,6,1,5
FRA,BOL,2011.0,3,3,0
DEU,SWE,2000.0,31,20,11
JPN,PHL,2001.0,5,4,1
ISR,ESP,2000.0,3,1,2
AUT,USA,1997.0,14,9,5
POL,JPN,2000.0,7,3,4
PHL,JPN,2003.0,6,14,-8
ARG,SWE,2003.0,6,4,2
CHE,ESP,2005.0,26,29,-3
AUS,VNM,2005.0,3,3,0
FIN,EST,2013.0,7,5,2
BRA,DNK,2001.0,2,1,1
PRT,BRA,1998.0,3,5,-2
FRA,ARG,2000.0,4,4,0
JPN,EGY,2015.0,43,14,29
FRA,COL,2009.0,16,7,9
JAM,TTO,2014.0,2,1,1
COL,NZL,2013.0,1,1,0
KWT,PAK,2021.0,1,1,0
FRA,BGR,2009.0,6,10,-4
IND,NLD,2000.0,6,1,5
CHN,FIN,2005.0,7,10,-3
DEU,SAU,2016.0,29,9,20
DEU,ARE,2012.0,5,2,3
CHE,RUS,2016.0,9,21,-12
RUS,AUT,2010.0,8,4,4
ITA,MLT,2019.0,9,6,3
JPN,CHL,2012.0,5,3,2
NLD,ARE,2019.0,8,2,6
CHE,NGA,2021.0,7,7,0
SWE,ROU,2006.0,5,3,2
GHA,USA,2004.0,4,9,-5
EST,FRA,2015.0,1,2,-1
NLD,PAK,2019.0,7,4,3
GBR,VNM,2005.0,5,3,2
CAN,PHL,2018.0,4,4,0
BEL,MAR,2002.0,1,5,-4
ROU,BEL,2013.0,7,6,1
ISL,DNK,2009.0,5,3,2
SVK,DEU,2016.0,10,7,3
NZL,JPN,2000.0,3,5,-2
NOR,AUT,2018.0,4,11,-7
QAT,GBR,2019.0,16,55,-39
PER,BEL,2010.0,1,3,-2
ARG,VEN,2014.0,1,3,-2
GEO,FRA,2017.0,40,6,34
IRL,ITA,2019.0,14,45,-31
JPN,TUR,2019.0,10,11,-1
NLD,MOZ,2016.0,1,2,-1
PRT,PER,2021.0,2,1,1
BRA,CHL,2012.0,13,11,2
JPN,RUS,2018.0,15,10,5
JOR,QAT,2018.0,5,6,-1
CAN,NZL,2012.0,35,27,8
FIN,NLD,2010.0,16,13,3
JPN,AUT,2017.0,16,9,7
LVA,GBR,2020.0,4,5,-1
JPN,NOR,2001.0,5,1,4
CHN,TWN,2007.0,32,45,-13
CZE,CHE,2019.0,19,12,7
NGA,JPN,2018.0,2,8,-6
ZAF,KEN,2015.0,15,16,-1
ZAF,LSO,2021.0,5,4,1
HKG,GHA,2018.0,1,5,-4
EGY,GBR,2018.0,25,38,-13
CAN,BGD,2015.0,12,27,-15
ISR,RUS,2007.0,3,4,-1
GHA,NLD,2014.0,3,1,2
THA,AUS,2020.0,16,36,-20
THA,BGD,2005.0,1,2,-1
ARM,USA,2017.0,4,4,0
BFA,BEL,2003.0,3,4,-1
TUR,FRA,2000.0,4,6,-2
USA,GHA,2014.0,23,15,8
TTO,CAN,2015.0,1,3,-2
ITA,DNK,2003.0,12,11,1
NGA,RUS,2014.0,1,2,-1
IND,DNK,2008.0,7,2,5
SGP,DNK,2016.0,9,6,3
FRA,IRN,2005.0,12,10,2
HUN,SVK,2022.0,5,1,4
MWI,USA,2015.0,10,17,-7
PAK,CYP,2018.0,1,1,0
GBR,KAZ,2020.0,9,3,6
NOR,IND,2022.0,4,8,-4
COL,KOR,2019.0,1,1,0
ECU,CAN,2019.0,2,2,0
AGO,PRT,2019.0,5,1,4
TWN,PAK,2022.0,1,5,-4
SWE,THA,2012.0,4,5,-1
ESP,MOZ,2005.0,1,1,0
SRB,PRT,2021.0,2,1,1
CYP,USA,2021.0,7,4,3
RUS,IRN,2009.0,4,1,3
USA,BGD,2005.0,11,7,4
USA,TTO,2009.0,8,6,2
USA,EGY,2001.0,30,45,-15
DNK,FIN,2002.0,11,6,5
NZL,ARE,2005.0,3,1,2
UKR,DEU,2013.0,26,13,13
TZA,GBR,2002.0,4,6,-2
PAK,NLD,2022.0,2,2,0
JPN,DNK,2008.0,10,8,2
FRA,GLP,2009.0,13,19,-6
HKG,SWE,2017.0,4,6,-2
DNK,POL,2016.0,3,8,-5
KOR,CZE,2002.0,1,1,0
BLR,POL,2016.0,4,4,0
HND,USA,2005.0,2,1,1
FRA,SVN,2009.0,5,2,3
PAK,BGD,2016.0,5,8,-3
PAK,KEN,2015.0,5,4,1
AUS,CHN,1998.0,4,11,-7
CHL,NLD,2008.0,3,2,1
SGP,TWN,2018.0,14,12,2
SGP,KOR,2007.0,14,5,9
MCO,FRA,2007.0,3,8,-5
DEU,ZAF,2016.0,27,23,4
LUX,ESP,2018.0,4,5,-1
SAU,KOR,2014.0,3,19,-16
ESP,ETH,2018.0,6,4,2
ROU,HUN,2005.0,4,4,0
CRI,DEU,2021.0,5,3,2
GBR,PSE,2018.0,5,3,2
CHL,AUT,2013.0,2,1,1
POL,IRN,2014.0,2,2,0
CAN,NPL,2020.0,1,4,-3
MEX,GBR,2021.0,33,45,-12
RUS,AUT,2017.0,7,6,1
HKG,ITA,2015.0,2,6,-4
FRA,CHL,2000.0,6,4,2
IND,LBY,2011.0,7,6,1
USA,MLI,2017.0,4,2,2
AND,ESP,2019.0,2,3,-1
SDN,EGY,2020.0,2,2,0
CHN,IRQ,2008.0,2,1,1
AUT,MEX,2012.0,1,3,-2
BEL,CMR,2015.0,5,2,3
JPN,BRA,2007.0,6,8,-2
AUT,DNK,2012.0,7,10,-3
ITA,HKG,2018.0,5,1,4
OMN,SWE,2021.0,1,1,0
VNM,RUS,2022.0,6,3,3
HKG,SWE,2019.0,2,3,-1
ARG,PER,2017.0,9,1,8
NPL,GBR,2021.0,11,1,10
FRA,SDN,2013.0,1,2,-1
CHN,AUT,2016.0,21,8,13
ESP,ROU,2021.0,3,3,0
DNK,IRN,2013.0,3,7,-4
IRN,FRA,2017.0,22,21,1
USA,MKD,2018.0,1,1,0
AUS,PRT,2021.0,7,6,1
KWT,IRL,2008.0,1,1,0
DZA,SAU,2011.0,8,2,6
GBR,TZA,2009.0,4,5,-1
JPN,KEN,2001.0,2,1,1
CAN,POL,2008.0,9,14,-5
MWI,BWA,2006.0,1,1,0
LKA,IND,2015.0,2,4,-2
FRA,NCL,2021.0,11,8,3
CHE,GRC,2007.0,4,12,-8
THA,NPL,2006.0,2,1,1
USA,LTU,2005.0,2,8,-6
PRT,HUN,2012.0,3,1,2
GBR,THA,2002.0,31,13,18
BGR,CAN,2006.0,1,2,-1
DEU,GAB,2008.0,1,1,0
HRV,GBR,2002.0,2,3,-1
CHL,PER,2000.0,1,1,0
DNK,HUN,2002.0,4,5,-1
NLD,HUN,2014.0,8,9,-1
ZAF,JPN,2008.0,3,3,0
NOR,CAN,2016.0,11,16,-5
SWE,ARE,2008.0,2,1,1
GBR,RUS,1999.0,7,40,-33
HUN,SWE,1997.0,1,2,-1
DNK,FRO,2007.0,1,1,0
OMN,IND,2005.0,7,6,1
GLP,FRA,2022.0,4,2,2
IND,PAK,2005.0,9,10,-1
CAN,MAR,2003.0,5,6,-1
NLD,MEX,2012.0,6,6,0
BRA,CHE,2000.0,2,2,0
AUT,SVK,2005.0,5,11,-6
ITA,ISR,2001.0,12,7,5
GHA,CHE,2020.0,4,4,0
DEU,SRB,2012.0,17,10,7
SAU,NGA,2012.0,7,5,2
EST,LVA,2020.0,3,3,0
PHL,IND,2009.0,5,3,2
THA,ITA,2021.0,4,2,2
UKR,MEX,2013.0,2,1,1
IDN,NLD,2006.0,3,7,-4
ITA,MLT,2017.0,11,3,8
NZL,ARE,2002.0,1,1,0
CAN,KWT,2006.0,8,4,4
COL,BRA,2006.0,6,4,2
BGR,USA,2016.0,8,8,0
GBR,ARG,2022.0,6,5,1
MYS,SWE,2019.0,7,2,5
CAF,FRA,2010.0,2,2,0
AUS,CRI,2016.0,2,1,1
CHN,NOR,2002.0,9,2,7
CAN,PRT,2013.0,8,13,-5
ZWE,BEL,2017.0,1,1,0
FRA,GUF,2006.0,15,7,8
CHN,PRI,2012.0,3,3,0
USA,BGD,2002.0,13,20,-7
NLD,SGP,2021.0,7,14,-7
TUR,CZE,2015.0,5,2,3
HUN,NLD,2002.0,8,6,2
NZL,SGP,2016.0,14,5,9
MYS,FRA,2014.0,6,11,-5
GBR,NPL,2016.0,3,7,-4
SDN,GBR,2018.0,3,2,1
ESP,TUR,2021.0,8,10,-2
SLV,USA,2019.0,3,3,0
BEL,HKG,2018.0,3,1,2
JPN,NGA,2021.0,4,3,1
UKR,EST,2016.0,2,1,1
MEX,DEU,2001.0,10,14,-4
TUR,GBR,2005.0,14,21,-7
JPN,SAU,2012.0,11,1,10
SGP,ARE,2019.0,2,2,0
VEN,FRA,2003.0,4,8,-4
BWA,ZAF,2008.0,8,2,6
MDG,USA,2015.0,4,7,-3
ZAF,HUN,2006.0,1,2,-1
IRN,TWN,2016.0,5,2,3
ZAF,NAM,2016.0,10,3,7
JPN,FIN,2000.0,1,4,-3
TZA,USA,2004.0,5,1,4
QAT,ARE,2011.0,2,6,-4
KEN,FRA,2005.0,1,1,0
FRA,CYP,2014.0,4,3,1
ALB,CAN,2019.0,2,2,0
DEU,UKR,1998.0,4,13,-9
ISR,IND,1999.0,4,8,-4
VNM,JPN,2003.0,5,10,-5
ZAF,CHN,2001.0,2,8,-6
IRN,FIN,2012.0,3,2,1
BHR,SAU,2011.0,4,3,1
QAT,CAN,2008.0,2,7,-5
EGY,IND,2009.0,2,1,1
GBR,CYP,2006.0,10,7,3
RUS,EGY,2008.0,1,1,0
MEX,BRA,2022.0,3,6,-3
NOR,ZAF,2020.0,2,8,-6
SWZ,BWA,2015.0,1,1,0
BEL,NOR,2013.0,6,5,1
UKR,ITA,2015.0,1,2,-1
JPN,IRN,2003.0,5,4,1
AUT,HUN,2019.0,9,18,-9
ARG,PER,2019.0,3,6,-3
PAK,AFG,2019.0,1,2,-1
ISL,NOR,2021.0,5,5,0
SWE,HUN,2012.0,3,12,-9
GBR,MDG,2018.0,1,1,0
TUR,IRL,2005.0,3,1,2
IND,PAK,2002.0,4,4,0
MLT,GBR,2012.0,3,9,-6
BRA,ITA,2005.0,17,23,-6
FRA,PYF,2002.0,5,7,-2
USA,URY,2009.0,11,15,-4
POL,FIN,2007.0,1,2,-1
ESP,IND,2004.0,3,7,-4
ARM,DEU,2001.0,3,7,-4
KEN,CAN,2002.0,2,2,0
SVK,JPN,2002.0,5,2,3
DEU,BLR,2012.0,1,5,-4
BRA,ISR,1997.0,1,2,-1
AZE,RUS,2014.0,9,4,5
CMR,CHE,2017.0,3,3,0
GRC,FRA,1998.0,5,5,0
NZL,BRA,2011.0,2,4,-2
GBR,UGA,2014.0,8,11,-3
BLR,ITA,2006.0,1,3,-2
SWE,TZA,2006.0,3,1,2
FRA,MDG,2013.0,7,12,-5
AGO,PRT,2017.0,6,2,4
USA,ETH,1998.0,1,1,0
GMB,GBR,2015.0,4,5,-1
TTO,GBR,2013.0,2,2,0
BEL,MAR,2005.0,3,1,2
ITA,HUN,2013.0,12,9,3
CZE,CAN,2022.0,3,3,0
IND,AFG,2014.0,1,1,0
USA,BWA,2005.0,3,5,-2
TUR,FIN,2013.0,2,1,1
BRA,PER,2011.0,9,14,-5
FRA,HRV,2009.0,2,4,-2
USA,LVA,2011.0,3,3,0
TWN,ESP,2019.0,4,6,-2
NGA,NLD,2010.0,3,2,1
PRY,ESP,2017.0,1,2,-1
CHE,BIH,2012.0,3,1,2
PER,BEL,2017.0,1,2,-1
EGY,MYS,2021.0,5,15,-10
UKR,SWE,2015.0,5,4,1
NGA,NLD,2019.0,5,6,-1
GIN,CHN,2018.0,2,2,0
TZA,GBR,2005.0,3,6,-3
TWN,SGP,2008.0,4,5,-1
ESP,PAK,2022.0,1,5,-4
RUS,MEX,2022.0,3,3,0
PAK,ESP,2002.0,1,1,0
IRQ,TUR,2022.0,5,5,0
ESP,PHL,2021.0,3,1,2
CZE,MYS,2019.0,1,2,-1
ARE,HUN,2018.0,1,2,-1
EGY,ESP,2007.0,2,4,-2
USA,MDA,2004.0,1,3,-2
DNK,LTU,2010.0,1,4,-3
KWT,SAU,2011.0,4,6,-2
ETH,IND,2008.0,6,7,-1
COL,AUS,2009.0,2,3,-1
DNK,EGY,2018.0,1,1,0
ITA,KEN,2019.0,3,3,0
VNM,GBR,2006.0,4,1,3
SRB,MNE,2022.0,3,5,-2
OMN,BGD,2009.0,1,1,0
NGA,ITA,2008.0,1,2,-1
PAN,CHE,2019.0,1,2,-1
USA,THA,1998.0,9,4,5
SAU,NZL,2019.0,6,3,3
DEU,TWN,1997.0,1,3,-2
COG,UGA,2014.0,1,1,0
AUS,BEL,2000.0,2,3,-1
CMR,CHN,2017.0,1,4,-3
GBR,LTU,2006.0,3,5,-2
SGP,TUR,2016.0,3,9,-6
USA,LUX,2005.0,1,1,0
SVK,CAN,2002.0,2,1,1
SAU,FRA,2009.0,2,6,-4
BEL,UKR,2007.0,2,4,-2
TUR,ESP,2013.0,6,7,-1
THA,ESP,2020.0,2,2,0
BGR,AUT,2006.0,3,2,1
CHN,PHL,2005.0,2,1,1
SWE,PRT,2021.0,6,12,-6
TZA,AUS,2014.0,1,1,0
GRC,NOR,2005.0,2,1,1
KWT,ARE,2009.0,1,1,0
URY,BRA,2006.0,2,3,-1
ZAF,MWI,2010.0,3,3,0
PER,ARG,2011.0,2,4,-2
JPN,BGR,2011.0,3,2,1
JPN,TUR,2010.0,8,4,4
DNK,MYS,2013.0,2,4,-2
BEL,ARG,2016.0,5,2,3
RUS,BGD,2013.0,1,1,0
SGP,ARE,2017.0,5,4,1
BEL,KOR,2013.0,1,9,-8
EST,GBR,2009.0,2,3,-1
FIN,MEX,2018.0,2,2,0
EST,DEU,2005.0,2,5,-3
ESP,KOR,2014.0,5,6,-1
MAR,ESP,2018.0,3,13,-10
MAR,HUN,2017.0,1,1,0
KEN,CAN,2005.0,1,2,-1
USA,GRD,2009.0,2,8,-6
IRL,SGP,2021.0,4,4,0
TUR,SDN,2019.0,1,3,-2
TZA,ZMB,2019.0,2,1,1
NLD,SAU,2022.0,3,5,-2
GBR,LBY,2007.0,6,3,3
GHA,CMR,2017.0,1,1,0
AUS,URY,2015.0,1,2,-1
AUS,QAT,2014.0,10,2,8
USA,THA,1997.0,4,4,0
CAN,ARG,2001.0,9,6,3
DNK,SVN,2017.0,1,1,0
CAF,FRA,2019.0,2,6,-4
ITA,MLT,2010.0,2,1,1
NOR,IRN,2012.0,2,10,-8
CHL,DNK,2012.0,1,1,0
ITA,GEO,2013.0,1,1,0
NOR,ZMB,2020.0,2,1,1
NLD,ISR,2022.0,3,8,-5
POL,DNK,2018.0,7,2,5
SVN,ISR,2018.0,1,1,0
IRN,PAK,2016.0,2,3,-1
AND,ESP,2010.0,1,2,-1
AUS,GRC,2007.0,5,4,1
IRQ,IRN,2015.0,1,5,-4
UKR,ROU,2015.0,1,2,-1
HUN,SWE,1998.0,3,3,0
BEL,BGR,2001.0,2,9,-7
MOZ,BRA,2015.0,2,10,-8
JPN,TUN,2021.0,2,1,1
DNK,SRB,2011.0,2,1,1
IRQ,SYR,2010.0,1,1,0
ITA,EST,2017.0,2,2,0
ESP,EGY,2006.0,1,3,-2
AUT,NOR,2008.0,1,3,-2
EGY,NLD,2003.0,1,3,-2
MEX,KOR,2010.0,2,1,1
CZE,UKR,2006.0,2,5,-3
USA,KGZ,2001.0,1,1,0
EGY,OMN,2011.0,2,2,0
CAN,BEL,1997.0,1,1,0
DEU,UKR,1997.0,2,2,0
ARE,JOR,2000.0,2,4,-2
AND,ESP,2017.0,1,4,-3
HTI,USA,2007.0,1,2,-1
IRL,ROU,2008.0,1,2,-1
HUN,ESP,2008.0,2,2,0
TUR,SAU,2014.0,4,5,-1
USA,SVK,2019.0,4,7,-3
CAN,KEN,2022.0,1,3,-2
CHN,BWA,2019.0,2,1,1
SGP,ISR,2013.0,2,1,1
IRL,HKG,2011.0,1,2,-1
MMR,NLD,2019.0,1,1,0
SAU,DNK,2021.0,2,4,-2
EGY,ITA,2004.0,3,1,2
CHE,UGA,2015.0,2,4,-2
AUS,VNM,2002.0,2,3,-1
EST,DNK,2012.0,2,2,0
MEX,ITA,1998.0,2,4,-2
ROU,CHE,1999.0,2,1,1
RUS,ARM,2008.0,3,2,1
ESP,UKR,1999.0,1,2,-1
USA,MLI,2010.0,3,3,0
CMR,CHE,2010.0,2,4,-2
HUN,NLD,2005.0,4,7,-3
BIH,TUR,2015.0,1,2,-1
IRL,ZAF,2005.0,1,5,-4
JPN,GHA,2008.0,1,2,-1
NLD,UKR,2007.0,1,6,-5
DEU,TWN,1998.0,1,2,-1
THA,BEL,2008.0,2,1,1
ESP,NZL,2000.0,1,1,0
MEX,PRT,2005.0,1,1,0
AUS,CHN,1997.0,2,3,-1
CUB,CAN,2004.0,2,2,0
KEN,CHE,2011.0,1,1,0
BRB,TTO,2016.0,1,1,0
TZA,ZMB,2010.0,1,1,0
POL,BRA,2007.0,1,1,0
BGR,GRC,2004.0,1,2,-1
TZA,UGA,2009.0,1,1,0
SWE,COL,2020.0,3,3,0
CHL,MEX,2003.0,3,2,1
SVK,SVN,2008.0,2,7,-5
MYS,FIN,2014.0,3,3,0
LKA,MYS,2020.0,2,7,-5
CHN,PRT,2001.0,1,2,-1
NZL,IRL,2008.0,5,8,-3
THA,MMR,2016.0,3,3,0
PAK,THA,2022.0,3,5,-2
CHN,BRA,2009.0,2,1,1
BEL,RUS,2011.0,3,5,-2
NLD,VNM,2007.0,2,2,0
ECU,FRA,2001.0,3,1,2
SYR,USA,2008.0,4,2,2
DNK,AUT,2007.0,2,1,1
USA,BWA,2002.0,2,3,-1
IRL,POL,2022.0,4,1,3
LUX,BEL,2008.0,2,5,-3
MEX,HUN,2018.0,2,3,-1
PRT,MEX,2013.0,3,3,0
EGY,POL,2021.0,4,3,1
AUT,PAK,2021.0,3,2,1
PAN,FRA,2015.0,1,2,-1
EGY,BGD,2001.0,1,1,0
JOR,PSE,2019.0,3,1,2
TUR,NZL,2019.0,2,2,0
LUX,NLD,2018.0,6,3,3
GHA,EGY,2020.0,2,1,1
TUR,VNM,2021.0,1,1,0
RUS,ECU,2021.0,1,1,0
KEN,SEN,2016.0,1,2,-1
EGY,PAK,2007.0,1,2,-1
FIN,GRC,2005.0,1,1,0
MYS,PHL,2017.0,3,1,2
KGZ,USA,2002.0,1,1,0
OMN,IND,2002.0,2,2,0
LVA,RUS,2006.0,1,2,-1
BRA,AGO,2017.0,1,1,0
GBR,SYR,2003.0,2,1,1
DNK,LTU,2019.0,1,1,0
KEN,UGA,2013.0,2,8,-6
AUT,PER,2014.0,1,1,0
ARE,IRL,2016.0,1,6,-5
ARE,OMN,2006.0,4,3,1
POL,UKR,1999.0,4,9,-5
ITA,KOR,2003.0,1,6,-5
FIN,LVA,2014.0,1,1,0
GHA,KEN,2011.0,1,1,0
DEU,QAT,2016.0,4,3,1
BEL,NGA,2017.0,2,3,-1
REU,FRA,2005.0,2,4,-2
ETH,NOR,2009.0,1,3,-2
SAU,KWT,2016.0,4,2,2
NOR,ARE,2021.0,1,3,-2
SVN,NLD,2013.0,1,2,-1
GBR,GHA,1999.0,1,1,0
SEN,BEL,2001.0,1,1,0
PRT,SWE,2003.0,4,4,0
NLD,BEN,2009.0,1,1,0
TUR,NZL,2010.0,1,1,0
MYS,SWE,2010.0,2,2,0
CHL,BOL,2021.0,1,1,0
FRA,PAN,2013.0,1,1,0
THA,DNK,2004.0,2,3,-1
GMB,CHE,2018.0,2,2,0
EGY,NZL,2019.0,2,1,1
FRA,BGD,2021.0,1,2,-1
JOR,JPN,2020.0,2,1,1
PRY,DEU,2020.0,1,2,-1
NOR,SVK,2019.0,1,2,-1
CAN,KAZ,2021.0,1,4,-3
MEX,NLD,2001.0,2,2,0
AUS,HUN,2003.0,2,2,0
BGD,OMN,2018.0,2,1,1
MWI,KEN,2012.0,1,1,0
IRN,IRL,2007.0,1,1,0
CAN,PER,2005.0,2,1,1
GNB,SWE,2003.0,1,2,-1
CHL,THA,2021.0,1,1,0
IRN,NOR,2007.0,1,3,-2
SGP,CZE,2020.0,3,1,2
BRA,CRI,2015.0,1,3,-2
GRC,IRL,2006.0,1,1,0
RUS,TUR,2015.0,3,2,1
GRC,FRA,1997.0,1,2,-1
NOR,MEX,2014.0,2,4,-2
DEU,TZA,2007.0,1,2,-1
NLD,CMR,2018.0,1,2,-1
GHA,KOR,2022.0,1,2,-1
THA,TWN,2009.0,1,1,0
NLD,CZE,2009.0,3,3,0
MEX,UKR,1998.0,1,2,-1
ECU,GTM,2019.0,1,3,-2
CHL,CUB,2014.0,1,5,-4
ITA,LTU,2007.0,1,1,0
CHE,ZAF,2022.0,3,7,-4
TWN,CRI,2019.0,1,1,0
URY,ECU,2020.0,2,1,1
KEN,BWA,2007.0,2,1,1
JPN,PRT,2014.0,1,1,0
CAN,PER,2002.0,1,1,0
SVN,ROU,2008.0,1,1,0
SYR,TUN,2018.0,1,1,0
FIN,NZL,2021.0,1,4,-3
LBN,KWT,2013.0,1,1,0
CZE,MYS,2017.0,2,2,0
USA,MLT,2016.0,1,1,0
AUT,ROU,2006.0,1,2,-1
PAN,CHE,2017.0,1,1,0
SLV,USA,2017.0,1,1,0
AZE,FRA,2021.0,1,1,0
BGD,TWN,2018.0,1,1,0
BGR,BRA,2009.0,1,1,0
PRT,LUX,2020.0,1,1,0
MDG,ITA,2017.0,1,1,0
DNK,HKG,2020.0,1,5,-4
PER,BEL,2019.0,1,2,-1
CIV,BEL,2020.0,1,1,0
GHA,CIV,2020.0,1,1,0
VNM,USA,2000.0,3,1,2
DEU,CUB,2012.0,1,6,-5
USA,LBR,2013.0,1,1,0
CAF,FRA,2017.0,1,4,-3
USA,UGA,2000.0,1,1,0
CUB,URY,2015.0,1,1,0
ARG,CHL,2001.0,1,6,-5
USA,ATG,2011.0,1,2,-1
ITA,AUS,2000.0,2,3,-1
MYS,ETH,2015.0,1,1,0
URY,USA,2000.0,1,2,-1
NOR,BGD,2018.0,1,5,-4
CZE,CHL,2008.0,1,1,0
MOZ,PRT,2019.0,2,3,-1
HKG,MYS,2022.0,1,3,-2
THA,BGD,2002.0,1,1,0
ITA,CUB,1999.0,1,1,0
USA,SYR,2020.0,1,1,0
PRY,BRA,2013.0,1,6,-5
EST,ROU,2019.0,1,1,0
CMR,CHN,2019.0,1,1,0
GRC,SRB,2017.0,2,3,-1
SAU,FIN,2016.0,1,2,-1
FIN,ROU,2022.0,1,1,0
SVN,SWE,2004.0,1,1,0
BFA,COG,2013.0,1,1,0
IRQ,BHR,2016.0,1,1,0
COG,GBR,2010.0,1,1,0
KWT,AUS,2012.0,1,3,-2
AUS,ARG,2020.0,1,9,-8
CHE,KEN,2011.0,1,1,0
IRQ,DEU,2007.0,1,1,0
NGA,SAU,2008.0,1,4,-3
ZAF,ISR,2015.0,2,3,-1
CAN,DEU,2004.0,75,132,-57
CAN,ESP,2012.0,44,64,-20
GBR,CAN,2009.0,343,321,22
EGY,JPN,2004.0,14,27,-13
CHE,DNK,2015.0,26,27,-1
AUS,IRN,2012.0,24,90,-66
FRO,DNK,2021.0,3,4,-1
CAN,IND,2020.0,84,165,-81
USA,DNK,2015.0,150,131,19
USA,AUT,2002.0,104,119,-15
GBR,AUS,2021.0,421,357,64
CAN,CHL,2020.0,15,16,-1
FRA,TUN,2002.0,47,29,18
JPN,CHN,2018.0,465,281,184
GBR,JPN,2014.0,119,100,19
ESP,CHL,2018.0,110,71,39
CHN,FIN,2002.0,8,8,0
PAK,USA,2003.0,26,26,0
PER,CHL,2021.0,8,6,2
ISR,CHE,2013.0,9,13,-4
IND,MYS,2020.0,50,65,-15
FRA,POL,2019.0,35,33,2
RUS,FRA,2017.0,41,53,-12
GBR,IRQ,2018.0,130,12,118
MNE,SRB,2015.0,3,3,0
FRA,POL,2017.0,23,24,-1
ZAF,MWI,2017.0,8,6,2
NZL,AUS,2022.0,75,44,31
COL,CUB,2019.0,3,5,-2
AUT,HUN,2017.0,9,23,-14
CAN,HKG,2018.0,27,27,0
MEX,AUT,2018.0,4,3,1
ARG,USA,2008.0,101,89,12
MEX,DNK,2021.0,1,4,-3
GBR,UKR,2020.0,6,9,-3
DEU,NZL,2017.0,28,29,-1
FIN,IRL,2015.0,5,1,4
VEN,USA,2006.0,36,31,5
GBR,FIN,2009.0,28,54,-26
MAR,FRA,2005.0,40,51,-11
NLD,BRA,2014.0,25,24,1
IRN,FRA,2019.0,36,20,16
USA,NLD,2005.0,219,218,1
TUR,GBR,2002.0,20,49,-29
RUS,CHE,2012.0,28,9,19
AUS,PAN,2010.0,1,2,-1
AUS,BRN,2011.0,1,1,0
GBR,SGP,2002.0,38,36,2
JOR,ARE,2002.0,4,3,1
FIN,DEU,2005.0,22,24,-2
DEU,KOR,2013.0,39,44,-5
IRL,ITA,2017.0,16,41,-25
NZL,FRA,2016.0,13,16,-3
GBR,FRO,2019.0,1,1,0
CHE,CHN,2022.0,44,34,10
THA,JPN,2002.0,35,29,6
ISL,DEU,2020.0,6,2,4
PHL,USA,2005.0,14,12,2
USA,EST,2020.0,7,9,-2
REU,FRA,2002.0,2,2,0
MKD,SRB,2003.0,2,4,-2
NGA,USA,2003.0,9,10,-1
DNK,GBR,2003.0,40,59,-19
NLD,NOR,2021.0,30,21,9
USA,LKA,2000.0,1,5,-4
ITA,KEN,2017.0,5,4,1
PHL,USA,2002.0,12,17,-5
JPN,CZE,2008.0,6,6,0
HUN,DEU,2008.0,33,33,0
ESP,NLD,2010.0,61,72,-11
MYS,KOR,2009.0,2,5,-3
CAN,COL,2006.0,2,5,-3
UKR,CAN,2000.0,5,2,3
FIN,DEU,2002.0,31,27,4
AUT,HUN,2010.0,5,12,-7
DEU,KEN,2006.0,1,2,-1
FRA,PYF,2005.0,5,2,3
JAM,IND,2009.0,1,1,0
ITA,TUN,2013.0,3,2,1
ZAF,SWE,2015.0,8,5,3
JPN,HKG,2007.0,5,7,-2
POL,FRA,2003.0,22,16,6
CAN,SAU,2004.0,18,21,-3
SVN,ITA,2014.0,10,6,4
PHL,AUS,2015.0,10,10,0
CUB,DEU,2021.0,3,2,1
NLD,GAB,2016.0,2,3,-1
RUS,AUT,2019.0,14,6,8
ARE,CHN,2022.0,7,5,2
CHN,MYS,2013.0,5,7,-2
MEX,CUB,2022.0,3,5,-2
ZAF,MWI,2019.0,10,3,7
JPN,LAO,2009.0,3,1,2
IND,KWT,2016.0,4,3,1
HRV,GBR,2005.0,3,3,0
CZE,ITA,2004.0,6,8,-2
FRA,LBN,2000.0,8,3,5
JPN,GRC,2007.0,3,1,2
BEL,AUT,2011.0,8,3,5
NLD,ARE,2017.0,4,2,2
WSM,AUS,2020.0,1,1,0
KAZ,TUR,2022.0,3,2,1
SRB,USA,2020.0,12,11,1
JPN,AUT,2019.0,14,13,1
USA,SRB,2000.0,5,13,-8
UKR,JPN,2008.0,2,8,-6
IDN,THA,2011.0,4,4,0
KWT,USA,2000.0,2,3,-1
USA,KWT,2004.0,14,5,9
FRA,IRN,2002.0,4,2,2
BGD,SWE,2012.0,7,1,6
NOR,IRL,2011.0,2,2,0
CHE,SVN,2011.0,2,2,0
CMR,ZAF,2016.0,5,3,2
NLD,ROU,2018.0,6,4,2
IND,TZA,2014.0,5,1,4
QAT,IND,2012.0,3,7,-4
GBR,LBN,2020.0,6,13,-7
IND,SVK,2018.0,2,2,0
CHN,NOR,2005.0,3,4,-1
GBR,MAR,2020.0,3,2,1
COL,PER,2009.0,3,1,2
CHL,ISR,2018.0,3,1,2
AZE,GBR,2000.0,1,1,0
ROU,NLD,2003.0,4,1,3
GRC,NOR,2002.0,1,4,-3
AUT,NZL,2008.0,3,1,2
JPN,FJI,2013.0,1,1,0
IND,TUR,2002.0,3,2,1
ARG,CHE,2014.0,6,3,3
GBR,CMR,2011.0,3,2,1
POL,TWN,2007.0,2,1,1
KEN,ITA,2006.0,1,1,0
DEU,SDN,2013.0,2,1,1
BEL,LTU,2012.0,1,2,-1
GRC,BRA,2019.0,2,1,1
SWE,CZE,2000.0,2,1,1
SGP,NLD,2009.0,9,7,2
TUR,AUT,2007.0,1,3,-2
JOR,ARE,2005.0,4,3,1
SYR,DEU,2009.0,1,6,-5
PRT,MAR,2021.0,3,2,1
COG,COD,2012.0,4,5,-1
TWN,PRT,2021.0,1,1,0
USA,TJK,2015.0,1,1,0
GRC,FIN,2018.0,4,1,3
CAN,HUN,2004.0,5,9,-4
DNK,FIN,2005.0,8,9,-1
TUR,DNK,2016.0,7,1,6
FIN,GRC,2002.0,1,2,-1
DZA,ITA,2006.0,2,1,1
SLE,CHN,2014.0,1,1,0
NOR,HUN,2020.0,1,6,-5
ZAF,EGY,2015.0,2,2,0
TUN,CZE,2020.0,2,1,1
SVN,GRC,2011.0,1,1,0
VNM,SRB,2018.0,2,2,0
BRA,CZE,2017.0,3,1,2
SAU,GRC,2020.0,1,5,-4
GBR,PRI,2008.0,1,1,0
ARM,FRA,2020.0,1,1,0
UZB,JPN,2019.0,1,1,0
CHE,COL,2022.0,2,3,-1
CYP,TUR,2007.0,2,3,-1
BRA,TUR,2005.0,1,2,-1
SGP,AUT,2013.0,3,8,-5
LVA,ITA,2022.0,1,2,-1
CYP,DEU,2020.0,1,6,-5
BHR,JOR,2019.0,2,7,-5
GBR,SLE,2018.0,2,2,0
CHL,ITA,2022.0,1,2,-1
PHL,DNK,2013.0,1,1,0
NZL,TWN,2014.0,1,1,0
ARE,IND,2005.0,2,1,1
SAU,CMR,2019.0,1,1,0
CAN,EST,2012.0,1,2,-1
SVK,ITA,1999.0,1,2,-1
ITA,EGY,2004.0,1,3,-2
OMN,DEU,2014.0,2,5,-3
JPN,LTU,2019.0,1,2,-1
CRI,BRA,2016.0,1,4,-3
ALB,USA,2015.0,1,4,-3
CAN,SVN,2021.0,1,1,0
IND,,2013.0,8856,0,8856
CHN,,2013.0,41149,0,41149
CHL,,2023.0,8628,0,8628
,IND,2003.0,12435,0,12435
,AUS,1998.0,12068,0,12068
ITA,,2016.0,9007,0,9007
,SGP,1997.0,406,0,406
,BOL,2004.0,38,0,38
FIN,,2014.0,1357,0,1357
,ESP,2003.0,11830,0,11830
GBR,,1999.0,547,0,547
,AUS,1997.0,2721,0,2721
,ZAF,2000.0,1562,0,1562
,AUT,2012.0,2818,0,2818
,SVN,1998.0,713,0,713
,TUR,1999.0,6129,0,6129
,SGP,1998.0,1675,0,1675
,EST,1998.0,300,0,300
FJI,,2019.0,27,0,27
IRL,,2018.0,1295,0,1295
,NLD,1995.0,3229,0,3229
,ROU,2001.0,976,0,976
SWE,,2013.0,2136,0,2136
,IDN,1995.0,105,0,105
ISR,,2018.0,2216,0,2216
GMB,,2011.0,11,0,11
LBN,,2023.0,1650,0,1650
,UKR,2008.0,1266,0,1266
,MAR,1997.0,203,0,203
,PAK,2015.0,3965,0,3965
,CIV,2006.0,182,0,182
,RUS,2016.0,16241,0,16241
RUS,,1999.0,627,0,627
,MYS,2006.0,2150,0,2150
BRA,SAU,2009.0,1,0,1
,MAR,1998.0,790,0,790
LSO,,2014.0,3,0,3
,CYP,2005.0,82,0,82
HUN,,2005.0,371,0,371
BGR,,2021.0,739,0,739
IRL,EST,2007.0,1,0,1
ZAF,OMN,2012.0,1,0,1
PRY,,2021.0,60,0,60
ZAF,COD,2018.0,2,0,2
PRI,,2012.0,84,0,84
UZB,CHN,2017.0,4,0,4
SRB,,2003.0,63,0,63
UZB,,2008.0,36,0,36
AUT,FIN,2022.0,6,0,6
,SVN,1997.0,289,0,289
,BRB,2002.0,16,0,16
,EST,1997.0,151,0,151
,ARE,2010.0,218,0,218
PSE,,2016.0,50,0,50
,PER,2010.0,334,0,334
,PRI,2010.0,150,0,150
OMN,BHR,2017.0,2,0,2
,KOR,2014.0,16268,0,16268
,JOR,2008.0,511,0,511
AUS,,2007.0,2377,0,2377
,PER,2019.0,643,0,643
,ARE,2017.0,608,0,608
YEM,,2018.0,27,0,27
TZA,,2021.0,310,0,310
,VNM,2014.0,1131,0,1131
BHR,,2017.0,34,0,34
,HRV,2015.0,949,0,949
,SVK,2016.0,965,0,965
,DZA,2018.0,1104,0,1104
,SRB,1994.0,419,0,419
JPN,LTU,2010.0,1,0,1
,PHL,2014.0,595,0,595
SLV,TTO,2009.0,1,0,1
,YEM,2014.0,31,0,31
BOL,NOR,2018.0,2,0,2
,BHR,2001.0,43,0,43
AUS,UKR,2020.0,2,0,2
,LIE,2015.0,7,0,7
BHR,,2019.0,49,0,49
GRD,,2021.0,22,0,22
,GNB,2015.0,9,0,9
,MOZ,1999.0,28,0,28
PLW,,2023.0,9,0,9
,ARE,2019.0,443,0,443
BOL,ITA,2012.0,1,0,1
,PRI,2017.0,94,0,94
SAU,,2005.0,176,0,176
MAR,,2006.0,147,0,147
HUN,,2002.0,141,0,141
,PER,2017.0,889,0,889
COD,,2021.0,57,0,57
,CUB,2008.0,748,0,748
BHR,,2010.0,30,0,30
,KWT,1999.0,257,0,257
GRC,LUX,2012.0,1,0,1
,VEN,1999.0,712,0,712
NAM,ZAF,2006.0,2,0,2
ECU,,2011.0,23,0,23
DOM,,2011.0,5,0,5
POL,NZL,2020.0,1,0,1
ETH,,2014.0,97,0,97
CHE,CMR,2016.0,3,0,3
JOR,MYS,2005.0,1,0,1
UZB,JPN,2010.0,1,0,1
,SYR,1994.0,11,0,11
ZAF,URY,2015.0,3,0,3
JOR,BHR,2015.0,1,0,1
GHA,,2012.0,53,0,53
BWA,FJI,2000.0,1,0,1
OMN,,2012.0,49,0,49
YEM,IRQ,2018.0,1,0,1
,LUX,2009.0,106,0,106
KOR,CHL,2001.0,1,0,1
JOR,,2025.0,23,0,23
,GMB,1999.0,20,0,20
MOZ,PRT,2017.0,2,0,2
TJK,,2020.0,20,0,20
CUB,ECU,2022.0,2,0,2
LUX,SWE,2020.0,2,0,2
MYS,SDN,2021.0,4,0,4
ALB,CZE,2017.0,1,0,1
,DOM,2016.0,30,0,30
MYS,DZA,2007.0,1,0,1
FJI,,2017.0,10,0,10
,SLV,2015.0,10,0,10
,LAO,2001.0,10,0,10
VNM,,2007.0,45,0,45
,CYP,2002.0,72,0,72
ZWE,RWA,2007.0,2,0,2
,ALB,2007.0,68,0,68
,MLT,2000.0,25,0,25
,GAB,2001.0,15,0,15
POL,,1999.0,78,0,78
FRA,EGY,2002.0,5,0,5
,BOL,1996.0,12,0,12
MNG,,2014.0,31,0,31
HUN,DNK,2009.0,7,0,7
,TCD,2005.0,1,0,1
PRT,SGP,2013.0,5,0,5
KWT,SYR,2004.0,1,0,1
,TGO,2003.0,7,0,7
ARM,BEL,2016.0,2,0,2
TUR,ARE,2005.0,1,0,1
GLP,MTQ,2007.0,1,0,1
,FRO,1998.0,2,0,2
PER,,2005.0,32,0,32
GMB,DEU,2014.0,1,0,1
,GUF,2000.0,7,0,7
CUB,NGA,2007.0,1,0,1
CYP,NOR,2017.0,2,0,2
,ABW,1998.0,1,0,1
CYP,CAN,2015.0,1,0,1
SAU,,2002.0,32,0,32
PER,,2002.0,5,0,5
HUN,KWT,2005.0,1,0,1
ITA,MDA,2001.0,1,0,1
CAN,CYP,2003.0,1,0,1
CHL,SAU,2005.0,1,0,1
,ZWE,2008.0,59,0,59
CPV,,2011.0,1,0,1
,FJI,2008.0,24,0,24
ARE,FRA,2001.0,2,0,2
TUR,KWT,2006.0,1,0,1
UGA,NLD,1999.0,1,0,1
MWI,RUS,2014.0,1,0,1
TTO,SDN,2009.0,1,0,1
FRA,MYS,1998.0,2,0,2
TUR,ARE,2002.0,1,0,1
SWE,SVK,1998.0,1,0,1
CRI,HND,2007.0,1,0,1
GTM,,2008.0,3,0,3
USA,BOL,1998.0,1,0,1
COL,,2003.0,34,0,34
GAB,CAN,2007.0,1,0,1
FRA,ISL,1998.0,1,0,1
GUM,,2015.0,8,0,8
JPN,NER,2004.0,1,0,1
IND,TUR,2005.0,1,0,1
SEN,,2007.0,22,0,22
FJI,,2010.0,13,0,13
RUS,YEM,2006.0,1,0,1
SGP,ARE,2010.0,7,0,7
IRN,CZE,2009.0,3,0,3
SLE,GIN,2003.0,1,0,1
SVK,BGR,2009.0,2,0,2
MAC,GBR,2012.0,1,0,1
,TCD,2002.0,5,0,5
ROU,NOR,2011.0,3,0,3
GAB,IND,2015.0,1,0,1
CAN,GRD,2018.0,3,0,3
CUB,IND,2019.0,1,0,1
FIN,BGD,2015.0,1,0,1
POL,ROU,2014.0,7,0,7
GHA,BWA,2021.0,1,0,1
VNM,SGP,2013.0,3,0,3
ARG,JPN,2012.0,1,0,1
BEL,NGA,2019.0,2,0,2
JOR,PSE,2010.0,3,0,3
ARE,LVA,2022.0,1,0,1
HKG,TUR,2021.0,3,0,3
,BDI,2018.0,2,0,2
,SDN,1999.0,45,0,45
NGA,,2004.0,71,0,71
VEN,NOR,2014.0,1,0,1
VNM,KHM,2011.0,1,0,1
PRT,PHL,2010.0,1,0,1
ZAF,POL,2001.0,2,0,2
MEX,UKR,1997.0,1,0,1
ZMB,NGA,2006.0,1,0,1
UKR,ZAF,2005.0,2,0,2
NLD,JOR,2014.0,1,0,1
MOZ,KEN,2017.0,1,0,1
EGY,IRQ,2017.0,9,0,9
ISR,CZE,2018.0,4,0,4
FIN,SAU,2011.0,2,0,2
,VUT,2018.0,2,0,2
MLT,NLD,2011.0,1,0,1
TUN,FIN,2017.0,1,0,1
KEN,ISR,2007.0,1,0,1
CHN,NPL,2006.0,2,0,2
,SUR,2015.0,7,0,7
CZE,FIN,2000.0,2,0,2
,PRI,2019.0,57,0,57
LVA,CHE,2015.0,2,0,2
ITA,ERI,2017.0,1,0,1
CHE,CRI,2013.0,1,0,1
KAZ,,2007.0,22,0,22
DEU,GHA,2008.0,2,0,2
BIH,DEU,2003.0,2,0,2
NZL,FIN,2004.0,1,0,1
TUN,CHE,1999.0,1,0,1
GBR,DZA,1998.0,1,0,1
BRB,USA,2002.0,4,0,4
FJI,SGP,2009.0,1,0,1
TZA,ZWE,2002.0,1,0,1
WSM,,2007.0,2,0,2
NGA,IND,2008.0,4,0,4
LBN,TUN,2006.0,1,0,1
PRY,ESP,2010.0,1,0,1
ARG,IRL,2008.0,1,0,1
IND,MDV,2006.0,1,0,1
LVA,POL,2005.0,1,0,1
NLD,ARE,2010.0,2,0,2
ISR,SWE,2007.0,2,0,2
FJI,TON,2012.0,1,0,1
,BRB,2005.0,9,0,9
TWN,GRC,2019.0,1,0,1
,CAF,2008.0,6,0,6
GRC,SVK,2013.0,1,0,1
NGA,GRC,2011.0,2,0,2
KWT,FIN,2001.0,1,0,1
MEX,TUR,2016.0,1,0,1
MYS,ECU,2020.0,2,0,2
SRB,IND,2011.0,1,0,1
IDN,CHE,2022.0,1,0,1
GRC,NZL,2021.0,1,0,1
CHN,UGA,2018.0,4,0,4
SRB,HUN,2021.0,4,0,4
SWE,NGA,2021.0,1,0,1
CHN,HND,2019.0,1,0,1
AIA,USA,2020.0,3,0,3
ARG,SVK,2021.0,1,0,1
BFA,,2003.0,4,0,4
CIV,USA,2009.0,1,0,1
,MNP,2012.0,4,0,4
ESP,TUN,2007.0,3,0,3
PER,JPN,2021.0,2,0,2
OMN,BHR,2010.0,1,0,1
ZWE,DEU,2017.0,2,0,2
USA,SLV,2004.0,1,0,1
COL,UKR,2019.0,1,0,1
ZMB,VNM,2020.0,1,0,1
GLP,,2020.0,4,0,4
VEN,URY,2010.0,2,0,2
THA,BHR,2017.0,3,0,3
NLD,QAT,2012.0,1,0,1
IND,VNM,2016.0,1,0,1
ZAF,BHR,2006.0,1,0,1
HUN,HKG,2018.0,1,0,1
BFA,ESP,2016.0,2,0,2
CUB,IND,2017.0,2,0,2
THA,BRA,2017.0,1,0,1
ETH,KAZ,2009.0,1,0,1
SGP,IRL,2002.0,2,0,2
MYS,MAR,2018.0,4,0,4
BRB,,2011.0,7,0,7
,LSO,2007.0,10,0,10
CHL,DOM,2011.0,2,0,2
NLD,LUX,2002.0,1,0,1
VEN,IND,2018.0,2,0,2
VEN,URY,2019.0,6,0,6
CHL,PHL,2015.0,1,0,1
LUX,ISR,2012.0,1,0,1
ISR,NGA,2009.0,2,0,2
TGO,,2003.0,2,0,2
GRC,ARE,2021.0,3,0,3
SDN,BEL,2002.0,1,0,1
TUR,TKM,2016.0,1,0,1
GBR,CRI,1999.0,1,0,1
JOR,EGY,2002.0,1,0,1
AUS,LVA,2005.0,1,0,1
PSE,SVK,2020.0,1,0,1
NZL,BEL,2004.0,2,0,2
CHL,POL,2006.0,1,0,1
SVK,HUN,2003.0,2,0,2
ITA,TWN,1999.0,2,0,2
OMN,NGA,2005.0,2,0,2
TUR,NZL,2017.0,5,0,5
MKD,RUS,2013.0,1,0,1
GNB,PRT,2003.0,1,0,1
CAF,CHE,2006.0,1,0,1
SLV,USA,2010.0,1,0,1
BRA,CZE,2010.0,1,0,1
PRT,EGY,2012.0,1,0,1
UGA,MEX,2010.0,2,0,2
EST,HUN,2020.0,1,0,1
TCA,,2018.0,1,0,1
BEL,RWA,2012.0,2,0,2
NCL,PNG,2013.0,1,0,1
LKA,SYR,2009.0,1,0,1
OMN,KOR,2011.0,1,0,1
NGA,UGA,2018.0,8,0,8
COL,KOR,2017.0,1,0,1
BTN,NPL,2019.0,2,0,2
BRA,GAB,2019.0,1,0,1
MAR,LBN,2013.0,1,0,1
JOR,SYR,2022.0,1,0,1
ISL,NLD,2012.0,1,0,1
USA,ARM,1998.0,1,0,1
COG,BEL,2001.0,1,0,1
GBR,FRO,2017.0,1,0,1
PRT,BRA,1997.0,1,0,1
UKR,CYP,2016.0,1,0,1
JOR,KWT,2013.0,4,0,4
LTU,NOR,2018.0,1,0,1
CUB,FRA,2011.0,1,0,1
IRQ,PAK,2005.0,1,0,1
MAR,ARE,2015.0,4,0,4
TUN,RUS,2020.0,1,0,1
THA,ZMB,2012.0,1,0,1
OMN,ARE,2014.0,6,0,6
SGP,THA,1998.0,1,0,1
GNQ,ESP,2011.0,1,0,1
MOZ,SWZ,2017.0,1,0,1
CIV,CPV,2011.0,1,0,1
SYR,QAT,2015.0,1,0,1
HUN,BHR,2005.0,1,0,1
JOR,NLD,2001.0,1,0,1
CHE,BGD,1998.0,1,0,1
CYP,SAU,2006.0,1,0,1
LAO,USA,2019.0,1,0,1
ZAF,GRC,1999.0,1,0,1
RUS,PRI,2003.0,1,0,1
COG,BFA,2014.0,1,0,1
HUN,IRL,2013.0,1,0,1
OMN,NZL,2016.0,1,0,1
KOR,MYS,2001.0,1,0,1
MYS,BWA,2018.0,2,0,2
NAM,CHN,2018.0,2,0,2
SAU,HKG,2006.0,2,0,2
,WSM,2003.0,1,0,1
TGO,GBR,2011.0,1,0,1
VEN,URY,2017.0,1,0,1
BEN,ZAF,2015.0,1,0,1
DEU,GTM,2007.0,1,0,1
POL,IDN,2013.0,1,0,1
GRC,SRB,2010.0,1,0,1
TWN,ESP,2010.0,4,0,4
MAR,BFA,2019.0,2,0,2
JPN,ARM,2006.0,1,0,1
DZA,ARE,2009.0,1,0,1
GBR,NAM,2002.0,1,0,1
GHA,CRI,2004.0,1,0,1
GEO,FRA,2010.0,2,0,2
ESP,MOZ,2002.0,1,0,1
NLD,LUX,2005.0,1,0,1
SAU,EST,2021.0,1,0,1
ITA,GLP,2011.0,1,0,1
AUS,PER,2006.0,1,0,1
CRI,COL,2009.0,4,0,4
VEN,BEL,2013.0,1,0,1
NPL,IRL,2020.0,1,0,1
NOR,URY,2011.0,1,0,1
IRQ,OMN,2012.0,1,0,1
GNB,GNQ,2018.0,3,0,3
LKA,FRA,2001.0,1,0,1
CAN,SRB,2021.0,4,0,4
BMU,,2018.0,1,0,1
ABW,,2018.0,1,0,1
NLD,TZA,2001.0,3,0,3
CMR,COG,2004.0,3,0,3
DEU,NAM,2008.0,2,0,2
COG,GBR,2019.0,1,0,1
CMR,TCD,2016.0,2,0,2
SEN,MUS,2019.0,1,0,1
AUS,NCL,1998.0,1,0,1
JPN,PYF,2015.0,1,0,1
UKR,LVA,2021.0,2,0,2
TZA,PAK,2005.0,1,0,1
TKM,,2003.0,1,0,1
ITA,IDN,2009.0,1,0,1
HTI,FRA,2016.0,2,0,2
BHS,IND,2018.0,1,0,1
JOR,PSE,2017.0,1,0,1
SEN,NER,2014.0,1,0,1
ZWE,GHA,2007.0,1,0,1
,NPL,1994.0,2,0,2
CYP,ISR,2003.0,1,0,1
NER,,2005.0,3,0,3
SAU,NZL,2010.0,1,0,1
IRL,ZAF,2002.0,1,0,1
VNM,NLD,1998.0,1,0,1
OMN,BHR,2019.0,1,0,1
CYP,ITA,2005.0,1,0,1
DNK,MKD,2003.0,1,0,1
GAB,SEN,2003.0,1,0,1
MAR,JPN,2004.0,1,0,1
ITA,SVN,1997.0,1,0,1
AUS,LBY,2013.0,2,0,2
BMU,GBR,2020.0,1,0,1
BRA,LTU,2004.0,1,0,1
,BTN,1999.0,2,0,2
TUN,VNM,2020.0,1,0,1
IND,BRN,2006.0,2,0,2
CRI,PRI,2003.0,1,0,1
ESP,UZB,2012.0,1,0,1
LUX,IRL,2018.0,1,0,1
BGR,HUN,2021.0,1,0,1
HUN,MKD,2019.0,1,0,1
POL,GRL,2021.0,1,0,1
IDN,ARE,2009.0,1,0,1
HRV,ROU,2001.0,1,0,1
BLR,BGD,2005.0,1,0,1
BHR,IND,1999.0,1,0,1
MLT,QAT,2018.0,1,0,1
MYS,GRC,2012.0,1,0,1
SAU,AFG,2020.0,1,0,1
ASM,,2009.0,1,0,1
URY,DEU,2007.0,1,0,1
MYS,MMR,2019.0,1,0,1
CIV,IND,2004.0,1,0,1
USA,KNA,2013.0,3,0,3
CUB,SWE,2007.0,1,0,1
PER,CAN,2012.0,2,0,2
AUS,LKA,2003.0,3,0,3
NER,,2002.0,1,0,1
DZA,CAN,2000.0,1,0,1
SWE,KWT,2011.0,1,0,1
LBY,USA,2003.0,1,0,1
GEO,ISR,2007.0,1,0,1
IND,BRB,2010.0,1,0,1
GRC,BRA,2017.0,1,0,1
NLD,TUN,2007.0,1,0,1
GBR,VGB,2014.0,1,0,1
BLR,BRA,2013.0,2,0,2
ESP,MRT,2016.0,1,0,1
,SLB,2007.0,2,0,2
,GRL,2008.0,6,0,6
FRA,GNB,2014.0,1,0,1
HUN,MYS,2015.0,1,0,1
DZA,ZAF,2014.0,1,0,1
EST,,2025.0,1,0,1
BLR,NGA,2019.0,1,0,1
GEO,IRN,2022.0,1,0,1
SGP,NPL,2022.0,1,0,1
KWT,SGP,2014.0,1,0,1
JAM,,1999.0,1,0,1
DEU,FJI,2007.0,1,0,1
KOR,SVN,1997.0,1,0,1
FRA,GIN,2007.0,5,0,5
IND,MWI,2015.0,1,0,1
BGD,NZL,2022.0,2,0,2
BGD,HKG,2008.0,2,0,2
MAR,BFA,2010.0,1,0,1
MMR,LAO,2022.0,1,0,1
TUN,COL,2017.0,1,0,1
GRC,CHL,2018.0,1,0,1
BIH,DNK,2020.0,1,0,1
EGY,NZL,2017.0,1,0,1
NGA,NLD,2017.0,2,0,2
,IRQ,2020.0,1,0,1
ECU,ESP,1998.0,1,0,1
SVK,HKG,2000.0,1,0,1
ARG,CZE,2014.0,2,0,2
MYS,ARG,2015.0,1,0,1
DNK,TUR,2007.0,2,0,2
MAR,HUN,2019.0,1,0,1
VEN,IRQ,2021.0,1,0,1
CZE,ARG,2015.0,1,0,1
LVA,SRB,2017.0,1,0,1
IRN,YEM,2017.0,1,0,1
ARE,TTO,2011.0,1,0,1
UKR,IRN,2002.0,1,0,1
TCA,USA,2011.0,3,0,3
ESP,PSE,2022.0,1,0,1
IDN,NGA,2021.0,1,0,1
CZE,NPL,2013.0,1,0,1
JPN,SVK,2008.0,1,0,1
NOR,BEL,2006.0,1,0,1
AUT,HKG,2001.0,1,0,1
CHE,MDG,2007.0,1,0,1
UZB,GBR,2007.0,1,0,1
ITA,UZB,2006.0,1,0,1
TUR,NOR,1999.0,1,0,1
ITA,SYR,2009.0,2,0,2
DEU,UZB,2021.0,3,0,3
IND,CHL,2012.0,1,0,1
CUB,HUN,2014.0,1,0,1
SVN,PRT,2017.0,1,0,1
PRI,CHL,2014.0,2,0,2
KOR,HUN,2013.0,1,0,1
MYS,SOM,2020.0,2,0,2
FJI,SLB,2011.0,1,0,1
IRQ,SYR,2019.0,1,0,1
IND,YEM,2007.0,3,0,3
ITA,TKM,2011.0,1,0,1
PNG,MYS,2013.0,1,0,1
SRB,ISR,2012.0,1,0,1
MEX,PRT,2002.0,1,0,1
PHL,ZAF,2007.0,1,0,1
JPN,GAB,2011.0,1,0,1
CAN,LBY,2021.0,2,0,2
GRC,SGP,2022.0,1,0,1
LVA,AUS,2015.0,1,0,1
YEM,JOR,2018.0,1,0,1
CHL,PAN,2014.0,1,0,1
CHE,PAN,2014.0,1,0,1
MWI,PER,2020.0,1,0,1
IND,SYR,2022.0,1,0,1
BEL,HRV,2006.0,1,0,1
GBR,LUX,2004.0,2,0,2
CIV,GHA,2013.0,1,0,1
BLR,NLD,2006.0,1,0,1
CAN,MLI,2006.0,1,0,1
TUR,TJK,2018.0,1,0,1
VEN,SWE,2011.0,1,0,1
CAN,BWA,2022.0,2,0,2
GTM,TWN,2020.0,1,0,1
LBN,ESP,2022.0,2,0,2
PAK,LBY,2011.0,1,0,1
ROU,SVK,2018.0,1,0,1
LBN,BEL,2003.0,2,0,2
,FLK,2003.0,1,0,1
DNK,TUN,2006.0,1,0,1
JPN,AFG,2016.0,1,0,1
EGY,AUS,2008.0,2,0,2
JPN,BWA,2020.0,1,0,1
EST,ARM,2009.0,1,0,1
,QAT,1995.0,1,0,1
BLZ,USA,2018.0,2,0,2
CUB,PAN,2004.0,1,0,1
OMN,TUR,2012.0,1,0,1
KWT,NGA,2015.0,1,0,1
LKA,SGP,2009.0,1,0,1
KOR,NGA,2014.0,1,0,1
AUS,ZMB,2013.0,1,0,1
MWI,PAK,2018.0,1,0,1
MYS,MEX,2016.0,2,0,2
PHL,KAZ,2018.0,2,0,2
MKD,NZL,2017.0,1,0,1
COG,MAR,2021.0,1,0,1
,ATG,2016.0,2,0,2
JPN,QAT,2010.0,1,0,1
FRA,LBY,2021.0,1,0,1
HUN,IDN,2022.0,2,0,2
ITA,EST,2010.0,1,0,1
MDG,ITA,2010.0,1,0,1
TWN,FJI,2020.0,1,0,1
ETH,EGY,2008.0,1,0,1
SVK,ESP,2021.0,1,0,1
BWA,MWI,2009.0,1,0,1
SYR,AFG,2006.0,1,0,1
AUS,NAM,2017.0,1,0,1
CZE,IRN,2003.0,2,0,2
DEU,MNE,2016.0,1,0,1
NOR,IDN,2007.0,1,0,1
COG,ZWE,2009.0,1,0,1
BEN,TGO,2016.0,1,0,1
GHA,BEN,2013.0,1,0,1
GRC,HRV,2015.0,1,0,1
JOR,MAR,2021.0,1,0,1
FRA,MOZ,2018.0,1,0,1
UZB,JPN,2017.0,1,0,1
,AND,2018.0,1,0,1
ROU,RUS,2003.0,1,0,1
ISR,SVK,2003.0,1,0,1
PAK,ISR,2013.0,2,0,2
TWN,GRC,2010.0,1,0,1
PHL,HKG,2004.0,1,0,1
ZWE,CHN,2001.0,2,0,2
DNK,LKA,2010.0,1,0,1
SGP,ROU,2018.0,1,0,1
JOR,CHE,2006.0,1,0,1
TWN,CIV,2012.0,1,0,1
MYS,BHR,2012.0,1,0,1
SVK,NOR,2001.0,2,0,2
LBN,IRL,2015.0,1,0,1
TWN,BGD,2011.0,1,0,1
ESP,KAZ,2020.0,2,0,2
TWN,CRI,2017.0,1,0,1
TWN,ISR,2003.0,2,0,2
PRI,HND,2019.0,1,0,1
BRA,AGO,2019.0,1,0,1
JPN,MWI,2002.0,1,0,1
YEM,CZE,2016.0,1,0,1
HUN,EGY,2013.0,1,0,1
CMR,MAR,2022.0,1,0,1
MWI,JPN,2018.0,1,0,1
PNG,CZE,2022.0,1,0,1
NZL,KAZ,2021.0,1,0,1
PHL,KHM,2018.0,1,0,1
RUS,HKG,2000.0,1,0,1
LVA,BEL,2011.0,1,0,1
IRL,KAZ,2015.0,1,0,1
HUN,SRB,2022.0,1,0,1
TWN,CHL,2016.0,1,0,1
BEL,CIV,2003.0,1,0,1
MNG,AUS,2020.0,1,0,1
USA,MUS,2012.0,1,0,1
PER,NOR,2018.0,1,0,1
HUN,MKD,2017.0,1,0,1
GBR,GNB,2021.0,1,0,1
IND,BWA,2012.0,1,0,1
BLR,TUR,2006.0,1,0,1
UKR,SGP,1999.0,1,0,1
THA,ARE,2006.0,1,0,1
FRA,GEO,2000.0,1,0,1
POL,KEN,2009.0,1,0,1
QAT,POL,2011.0,1,0,1
ATG,,2015.0,1,0,1
AUS,MDV,2017.0,1,0,1
MAR,PSE,2006.0,1,0,1
PRT,PHL,2017.0,1,0,1
OMN,PAK,2001.0,1,0,1
CAF,DEU,2010.0,1,0,1
CUB,FIN,2011.0,1,0,1
SAU,KAZ,2015.0,1,0,1
NGA,MEX,2012.0,1,0,1
MNP,,2017.0,1,0,1
OMN,HUN,2004.0,1,0,1
BWA,MEX,2004.0,1,0,1
THA,CZE,2015.0,1,0,1
IRQ,QAT,2018.0,1,0,1
SDN,SLE,2021.0,1,0,1
LBY,IDN,2018.0,1,0,1
ZWE,BEL,2019.0,1,0,1
ZAF,BEN,2005.0,1,0,1
,BHS,1999.0,1,0,1
ESP,DOM,2009.0,1,0,1
EST,ZAF,2012.0,1,0,1
TCD,SEN,2008.0,1,0,1
MYS,IRQ,2008.0,1,0,1
MAR,HUN,2010.0,1,0,1
ROU,UKR,2016.0,1,0,1
MAR,USA,2012.0,2,0,2
CHE,PER,2001.0,1,0,1
LKA,BEL,2001.0,1,0,1
ITA,ETH,1998.0,1,0,1
USA,BDI,2005.0,1,0,1
MOZ,USA,2000.0,1,0,1
MLI,MAR,2013.0,1,0,1
PER,ISR,2001.0,1,0,1
HKG,BGD,2001.0,1,0,1
AGO,,2006.0,1,0,1
MCO,SWE,2014.0,1,0,1
KAZ,SRB,2021.0,1,0,1
BRA,TUR,2002.0,1,0,1
KEN,BEL,1997.0,1,0,1
MEX,FIN,2007.0,1,0,1
VEN,CHE,2012.0,1,0,1
ECU,GTM,2017.0,1,0,1
VNM,MEX,2018.0,1,0,1
GUF,,2003.0,1,0,1
EGY,HRV,2020.0,1,0,1
UZB,HKG,2018.0,1,0,1
HUN,CHN,2008.0,1,0,1
MYS,OMN,2003.0,1,0,1
HKG,CHE,2004.0,1,0,1
EST,ARE,2022.0,1,0,1
CHN,BWA,2017.0,1,0,1
ESP,USA,2018.0,523,382,141
FRA,SWE,2013.0,69,39,30
TUR,USA,2013.0,240,238,2
DEU,ESP,2014.0,129,263,-134
DEU,CHE,2003.0,414,293,121
ITA,AUT,2017.0,92,49,43
AUS,USA,2010.0,432,544,-112
RUS,AUS,2021.0,11,5,6
AUS,USA,2019.0,602,586,16
DEU,TUR,2017.0,41,58,-17
DEU,USA,2014.0,1226,1057,169
ITA,BEL,2013.0,78,60,18
AUT,GBR,2011.0,54,62,-8
MEX,CHL,2005.0,6,3,3
KOR,USA,2005.0,533,637,-104
USA,KOR,2010.0,859,646,213
USA,CHN,2015.0,2442,2491,-49
GBR,IND,2013.0,148,137,11
CAN,USA,2022.0,624,604,20
DEU,EGY,2003.0,31,13,18
GRC,GBR,2004.0,61,99,-38
GBR,GRC,2007.0,133,92,41
CAN,IRN,2004.0,30,31,-1
CAN,ITA,2009.0,42,55,-13
CHN,IRL,2006.0,9,8,1
ITA,GBR,2014.0,460,254,206
BRA,DEU,2014.0,80,60,20
UKR,ITA,2004.0,3,1,2
DEU,TUR,2010.0,41,43,-2
MEX,USA,2001.0,115,86,29
USA,FIN,2011.0,46,71,-25
AUS,ESP,2017.0,21,53,-32
FRA,AUS,2014.0,100,81,19
ESP,MEX,2016.0,158,126,32
GBR,DEU,2003.0,389,362,27
DNK,DEU,2019.0,106,106,0
FRA,CHN,2014.0,154,133,21
CUB,ESP,2013.0,25,11,14
USA,BRA,2003.0,293,228,65
DEU,CHN,2013.0,216,253,-37
USA,POL,2016.0,76,117,-41
GBR,EGY,2008.0,28,17,11
DEU,PAK,2014.0,30,18,12
NLD,AUS,2018.0,81,85,-4
IND,PRT,2007.0,8,4,4
CAN,DEU,2015.0,176,160,16
GBR,ZAF,2012.0,100,69,31
FRA,IND,2007.0,27,46,-19
BEL,JPN,2012.0,20,13,7
JPN,IDN,2007.0,49,12,37
ESP,BRA,2013.0,76,47,29
BRA,PRT,2008.0,52,35,17
USA,KOR,2019.0,738,685,53
USA,CUB,2003.0,5,3,2
ZAF,USA,2014.0,75,105,-30
USA,KOR,2017.0,766,678,88
GBR,JOR,2006.0,17,3,14
FRA,TWN,2006.0,6,5,1
ARG,MEX,2012.0,13,8,5
FRA,MAR,2010.0,76,47,29
USA,CHE,2018.0,518,561,-43
GRC,NLD,2012.0,23,13,10
PRT,FRA,2009.0,28,32,-4
CHE,SRB,2007.0,2,3,-1
TUR,DEU,2009.0,32,27,5
ITA,IRL,2008.0,24,8,16
NLD,PRT,2019.0,24,25,-1
GRC,DEU,2010.0,50,25,25
NGA,CHN,2021.0,23,24,-1
JPN,HKG,2008.0,12,6,6
NLD,IRL,2013.0,16,16,0
AUS,NOR,2008.0,15,2,13
SWE,FIN,2014.0,41,56,-15
NLD,JPN,2014.0,23,21,2
MYS,JOR,2012.0,13,5,8
DEU,AUT,2015.0,339,295,44
AUS,ZAF,2018.0,20,44,-24
ZAF,FRA,2009.0,8,22,-14
NLD,UKR,2008.0,2,4,-2
BRA,GBR,2017.0,120,84,36
DEU,ISR,2017.0,54,57,-3
ITA,NLD,2016.0,126,62,64
FRA,BEL,2018.0,205,205,0
GRC,JPN,2016.0,5,1,4
MYS,IND,2014.0,30,94,-64
DEU,LUX,2017.0,31,23,8
TWN,CHN,2012.0,94,37,57
GRC,DEU,2019.0,73,43,30
OMN,SAU,2016.0,8,3,5
SWE,LTU,2020.0,6,5,1
ARE,GBR,2020.0,31,58,-27
CAN,PAK,2020.0,13,28,-15
TZA,USA,2015.0,16,17,-1
KOR,USA,2002.0,455,448,7
CAN,SAU,2015.0,91,63,28
NLD,POL,2017.0,19,23,-4
GBR,ZMB,2017.0,8,2,6
FRA,MAR,2019.0,80,39,41
POL,CAN,2017.0,9,16,-7
NOR,FIN,2018.0,13,44,-31
IRL,PAK,2018.0,9,6,3
ESP,COL,2014.0,92,39,53
BEL,CAN,2006.0,25,19,6
DEU,LUX,2019.0,32,15,17
PRT,BEL,2018.0,18,11,7
VNM,FRA,2016.0,10,54,-44
MYS,CHN,2018.0,56,12,44
CHE,LIE,2022.0,1,3,-2
CHN,DNK,2017.0,59,49,10
USA,TWN,2008.0,296,230,66
USA,COL,2021.0,47,100,-53
ESP,CHN,2019.0,51,32,19
GBR,NGA,2013.0,31,26,5
ZAF,CAN,2016.0,26,19,7
ISR,FRA,2002.0,21,35,-14
HUN,ROU,2021.0,8,8,0
JPN,POL,2013.0,30,13,17
IND,ESP,2018.0,21,11,10
MAR,FIN,2022.0,6,1,5
HUN,BGR,2017.0,1,1,0
CHN,SAU,2022.0,23,32,-9
USA,ISR,2016.0,307,408,-101
CHN,DEU,2001.0,88,62,26
BEL,IRN,2013.0,3,13,-10
ECU,USA,2017.0,15,23,-8
IRL,CHE,2020.0,14,9,5
VNM,CAN,2015.0,1,2,-1
FRA,CIV,2022.0,4,1,3
IND,ZAF,2014.0,72,14,58
AUS,MYS,2020.0,82,82,0
NLD,CHN,2022.0,90,76,14
CHN,DNK,2019.0,66,57,9
SWE,MYS,2016.0,6,6,0
BRA,GBR,2010.0,40,54,-14
RUS,FIN,2000.0,14,2,12
MNG,KOR,2016.0,2,11,-9
JPN,VNM,2013.0,31,10,21
PAK,SAU,2016.0,91,33,58
USA,ARG,2003.0,96,139,-43
USA,PHL,2022.0,8,10,-2
USA,BRB,2013.0,2,4,-2
GBR,MLT,2019.0,21,12,9
RUS,BEL,2021.0,13,2,11
THA,VNM,2017.0,7,6,1
AUS,ESP,2019.0,41,41,0
ZWE,ZAF,2021.0,29,20,9
CUB,ARG,2018.0,3,1,2
NLD,CAN,2022.0,20,22,-2
TWN,KOR,2016.0,15,16,-1
USA,KHM,2018.0,3,5,-2
AUT,IND,2018.0,7,16,-9
CHN,IDN,2020.0,7,7,0
GBR,EST,2022.0,11,2,9
ITA,AUT,2019.0,53,38,15
SWE,JPN,2018.0,13,23,-10
SVN,MEX,2002.0,1,1,0
NPL,KOR,2011.0,3,1,2
TWN,USA,2003.0,174,262,-88
GBR,CHL,2020.0,37,43,-6
DEU,TUR,2019.0,37,92,-55
IRL,CAN,2012.0,32,34,-2
MYS,IDN,2021.0,42,21,21
THA,VNM,2019.0,23,10,13
GHA,NGA,2021.0,3,8,-5
UGA,GBR,2003.0,6,11,-5
NOR,DNK,2020.0,27,52,-25
AUS,PHL,2011.0,9,6,3
ISR,DEU,2016.0,42,39,3
POL,CAN,2019.0,12,14,-2
SAU,ZAF,2018.0,5,9,-4
CAN,ZAF,2022.0,9,14,-5
DNK,DEU,2010.0,51,85,-34
DEU,ISR,2010.0,27,26,1
QAT,USA,2022.0,28,18,10
KOR,PAK,2016.0,60,28,32
AUT,LIE,2016.0,1,2,-1
MYS,YEM,2017.0,15,4,11
DEU,LKA,2019.0,5,5,0
ECU,DEU,2018.0,5,14,-9
YEM,IND,2019.0,2,11,-9
TUN,MAR,2019.0,4,3,1
SWE,NLD,2004.0,23,27,-4
ISL,USA,2021.0,5,11,-6
ESP,ARG,2002.0,53,52,1
NLD,HKG,2011.0,4,2,2
THA,GBR,2020.0,38,92,-54
NLD,ESP,2003.0,32,34,-2
CMR,FRA,2007.0,14,10,4
CHE,BEL,2015.0,37,42,-5
JPN,CHE,2011.0,30,28,2
THA,USA,2005.0,65,158,-93
BRA,CRI,2004.0,1,1,0
FJI,AUS,2011.0,8,8,0
ARE,CYP,2020.0,2,1,1
DNK,DEU,2017.0,81,128,-47
DNK,ITA,2021.0,21,37,-16
AUS,NLD,2016.0,66,83,-17
MAC,USA,2013.0,3,8,-5
ISR,CHN,2012.0,9,6,3
GBR,HKG,2013.0,57,39,18
IRN,ESP,2013.0,18,4,14
FRA,ARE,2020.0,20,7,13
ISR,NZL,2017.0,4,3,1
FRA,JPN,2006.0,73,60,13
SGP,CAN,2004.0,15,12,3
CHN,TWN,2008.0,39,53,-14
POL,DEU,2005.0,69,42,27
KEN,AUS,2017.0,5,5,0
POL,CHN,2009.0,2,1,1
HRV,USA,2011.0,26,10,16
RUS,SWE,2002.0,36,29,7
FRA,DNK,1998.0,8,5,3
FRA,CZE,2018.0,36,13,23
GBR,LBY,2008.0,9,2,7
ARG,AUT,2001.0,3,1,2
JPN,DNK,2007.0,9,9,0
USA,IRN,2004.0,26,26,0
AUT,NOR,2007.0,6,2,4
KEN,GBR,2002.0,14,14,0
LTU,DEU,2001.0,3,2,1
BEL,ECU,2013.0,2,5,-3
DEU,ECU,2021.0,6,5,1
TUN,MAR,2017.0,4,3,1
GBR,KEN,2020.0,31,31,0
BEL,ESP,2005.0,17,20,-3
NZL,ZAF,2001.0,5,6,-1
CAN,POL,2007.0,9,15,-6
MYS,TWN,2020.0,12,4,8
IND,IRN,2010.0,25,3,22
FRA,THA,2018.0,27,10,17
IND,HKG,2020.0,16,7,9
KOR,HKG,2019.0,18,19,-1
JPN,ITA,2022.0,11,10,1
AUS,IRL,2021.0,36,23,13
ITA,IND,2020.0,25,52,-27
POL,TWN,2008.0,1,3,-2
CHL,SWE,2017.0,7,2,5
DEU,JPN,2021.0,76,77,-1
SWE,NZL,2020.0,7,8,-1
ESP,CHN,2017.0,45,34,11
ESP,IND,2015.0,16,13,3
AUS,FJI,2018.0,9,6,3
JPN,SWE,1999.0,19,17,2
VEN,COL,2022.0,9,3,6
ISR,PSE,2012.0,18,4,14
ESP,DEU,2001.0,57,71,-14
GRC,DEU,2017.0,82,31,51
SWE,ETH,2018.0,4,1,3
UZB,RUS,2020.0,6,11,-5
RUS,KOR,2021.0,8,12,-4
ARG,DEU,2022.0,12,13,-1
FIN,FRA,2022.0,5,11,-6
GBR,CHE,2000.0,31,45,-14
USA,DNK,2004.0,73,97,-24
ZAF,ETH,2021.0,7,5,2
USA,MMR,2021.0,6,1,5
IND,PHL,2022.0,3,5,-2
LBY,EGY,2019.0,6,2,4
DNK,ISL,2022.0,6,3,3
COL,DEU,2009.0,7,11,-4
MAC,SGP,2019.0,4,1,3
JPN,SGP,2011.0,34,18,16
DEU,CZE,2005.0,21,24,-3
USA,PAK,2006.0,32,34,-2
KWT,CAN,2005.0,3,5,-2
SWE,RUS,2011.0,9,12,-3
FRA,NOR,2013.0,33,25,8
CHE,IND,2006.0,19,17,2
IRN,CHN,2012.0,6,5,1
ITA,ECU,2009.0,1,1,0
POL,CAN,2010.0,15,18,-3
DEU,PSE,2016.0,7,2,5
DEU,GRC,2006.0,25,27,-2
ECU,CHL,2020.0,9,16,-7
BEL,FIN,2012.0,3,3,0
NGA,DEU,2012.0,4,6,-2
FRA,CMR,2011.0,14,8,6
DEU,COL,2011.0,11,11,0
CHE,HRV,2018.0,7,5,2
GNB,DNK,2012.0,4,1,3
IRQ,JOR,2009.0,3,1,2
ITA,UKR,2003.0,2,4,-2
ISR,FRA,2005.0,22,14,8
GBR,QAT,2012.0,16,2,14
EGY,JPN,2015.0,14,43,-29
CAN,OMN,2009.0,10,2,8
NLD,RUS,2016.0,18,23,-5
USA,KEN,2004.0,19,16,3
SVK,CZE,2003.0,31,28,3
SWE,LKA,2000.0,2,1,1
MWI,USA,2004.0,2,2,0
CAN,MEX,2004.0,21,12,9
RUS,PRT,2022.0,4,2,2
BIH,HRV,2014.0,11,10,1
FRA,MAR,2017.0,77,35,42
BWA,GBR,2021.0,4,4,0
ZWE,USA,2011.0,4,1,3
CAN,THA,2003.0,9,3,6
DEU,THA,2006.0,13,11,2
MNE,SRB,2004.0,1,3,-2
CHE,ARM,2013.0,1,1,0
ITA,POL,2012.0,40,10,30
EGY,CHE,2022.0,4,2,2
ESP,ARG,2005.0,41,76,-35
IRL,FRA,1999.0,7,6,1
THA,USA,2002.0,52,95,-43
USA,DOM,2013.0,4,4,0
THA,IND,2002.0,2,2,0
BGR,BEL,2002.0,4,1,3
HUN,ITA,2000.0,5,1,4
GBR,SDN,2010.0,4,1,3
AUS,OMN,2005.0,2,1,1
FIN,PRT,2019.0,6,6,0
SAU,TUR,2009.0,6,1,5
SGP,CHE,2012.0,9,9,0
FRA,ROU,2003.0,13,23,-10
GBR,ROU,2010.0,5,15,-10
IDN,FRA,2011.0,2,8,-6
FRA,URY,2005.0,4,2,2
EGY,CAN,2014.0,30,44,-14
SVK,FRA,2001.0,5,3,2
BRA,URY,2006.0,3,2,1
RUS,SWE,2005.0,21,17,4
DEU,NGA,2003.0,5,3,2
RUS,UKR,1997.0,18,32,-14
TWN,JPN,2008.0,20,30,-10
DEU,LUX,2010.0,23,9,14
VEN,ARG,2013.0,3,2,1
RUS,ARM,2007.0,2,1,1
EST,FIN,2001.0,2,6,-4
GUM,USA,2021.0,4,4,0
COG,FRA,2012.0,4,3,1
SWE,ITA,1998.0,10,7,3
JPN,EGY,2004.0,27,14,13
DEU,CZE,2002.0,25,27,-2
IRN,KWT,2004.0,1,1,0
JPN,CZE,2007.0,6,8,-2
CZE,ESP,2001.0,5,1,4
DNK,TZA,2002.0,4,2,2
POL,MEX,2007.0,2,1,1
RUS,POL,2005.0,6,14,-8
CAN,BRA,1999.0,13,10,3
FIN,USA,1998.0,21,15,6
TUR,CHE,2002.0,4,1,3
RUS,POL,2002.0,14,14,0
NOR,FRA,2021.0,25,28,-3
DZA,IRN,2010.0,1,1,0
AUS,ARE,2007.0,6,3,3
DEU,BRA,1998.0,9,6,3
SWE,AUT,2005.0,9,3,6
SWE,CAN,2001.0,28,18,10
RUS,CAN,2019.0,20,10,10
USA,BLR,2003.0,5,17,-12
DEU,IND,1999.0,17,40,-23
SVK,SVN,2007.0,4,2,2
PHL,KOR,2011.0,3,5,-2
DEU,BRA,1997.0,5,10,-5
TUR,CHE,2005.0,4,6,-2
DEU,BFA,2006.0,2,1,1
NLD,PRT,2010.0,24,18,6
FIN,USA,1997.0,12,17,-5
DEU,CRI,2014.0,4,3,1
HUN,CAN,2001.0,7,5,2
FIN,CHE,2004.0,9,6,3
DEU,SGP,2006.0,16,13,3
MAC,AUS,2009.0,2,1,1
KNA,USA,2020.0,5,2,3
ZAF,SGP,2011.0,2,1,1
SVN,BEL,2009.0,4,2,2
RUS,ISR,2006.0,8,10,-2
CZE,GBR,2008.0,27,26,1
IRL,DEU,2004.0,10,19,-9
SWE,GRC,2021.0,12,25,-13
BEL,UKR,2008.0,1,2,-1
USA,KWT,2015.0,18,9,9
UZB,KOR,2005.0,3,1,2
GBR,LUX,2015.0,10,6,4
CAN,ARE,2003.0,10,1,9
BWA,CAN,2006.0,1,3,-2
NLD,ETH,2009.0,2,2,0
SGP,HKG,2006.0,12,20,-8
FIN,NOR,2009.0,9,4,5
PHL,AUS,2004.0,9,6,3
KOR,DEU,2012.0,38,36,2
ROU,FIN,2009.0,1,2,-1
EGY,ARE,2021.0,19,5,14
JPN,ROU,2014.0,1,6,-5
CAN,GRC,2013.0,5,13,-8
CAN,ECU,2011.0,2,1,1
POL,FIN,2008.0,3,2,1
ESP,AUS,2001.0,11,5,6
SWE,ZAF,2019.0,8,14,-6
ITA,LTU,2008.0,4,4,0
CHE,THA,2016.0,7,1,6
SWE,HKG,2001.0,1,1,0
CHL,SWE,2019.0,6,2,4
ETH,CHE,2014.0,2,3,-1
CHN,BGD,2018.0,16,22,-6
AUS,KWT,2012.0,3,1,2
CHE,PRT,2013.0,14,13,1
SGP,KOR,2008.0,12,15,-3
PER,FRA,2018.0,11,12,-1
RUS,CAN,2010.0,19,15,4
ARG,ECU,2017.0,6,1,5
NLD,PRT,2017.0,20,28,-8
RUS,CAN,2017.0,17,15,2
NPL,NLD,2019.0,3,5,-2
CAN,JOR,2014.0,10,8,2
BEN,FRA,2021.0,5,6,-1
SVK,USA,2017.0,7,11,-4
NCL,USA,2020.0,2,1,1
ITA,CHN,2003.0,15,10,5
ITA,BGD,2016.0,7,1,6
ESP,DNK,2004.0,9,10,-1
ESP,TUN,2008.0,4,3,1
AUS,IRQ,2011.0,2,3,-1
HUN,SAU,2018.0,1,1,0
TUR,BHR,2020.0,1,1,0
ARM,CAN,2017.0,1,1,0
AUT,LKA,2006.0,1,1,0
QAT,CAN,2007.0,1,6,-5
TWN,CAN,2018.0,14,10,4
KHM,FRA,2022.0,1,3,-2
AUT,TWN,2019.0,2,1,1
GBR,SDN,2017.0,2,3,-1
IND,DNK,2007.0,4,2,2
CZE,LBN,2018.0,1,1,0
KOR,QAT,2016.0,5,1,4
SVN,SWE,2015.0,7,2,5
HKG,AUS,2003.0,22,28,-6
IND,EGY,2020.0,13,8,5
NLD,VNM,2008.0,2,1,1
SRB,SVN,2019.0,6,4,2
ISR,RUS,2008.0,9,3,6
ECU,USA,2010.0,19,8,11
POL,DEU,2002.0,63,57,6
BEL,USA,2000.0,45,26,19
RUS,GBR,2000.0,39,17,22
FRA,GRC,1999.0,13,3,10
CHE,POL,2003.0,11,12,-1
NZL,IRL,2007.0,5,3,2
KGZ,TUR,2017.0,2,2,0
HKG,CHE,2015.0,5,5,0
ROU,MDA,2011.0,2,1,1
SRB,GRC,2018.0,1,1,0
GBR,CZE,2013.0,27,25,2
BHR,DEU,2015.0,2,1,1
NLD,KOR,2022.0,3,6,-3
COL,CHE,2014.0,5,4,1
CHL,COL,2022.0,14,15,-1
HUN,RUS,2022.0,2,1,1
AUT,CAN,2015.0,16,23,-7
CHN,NZL,2011.0,7,17,-10
SVK,FIN,2012.0,2,2,0
VNM,BEL,2011.0,3,4,-1
IND,SVN,2021.0,6,1,5
PAK,SWE,2020.0,6,6,0
ITA,SWE,2003.0,27,19,8
SVK,NLD,2011.0,8,1,7
NLD,MYS,2009.0,4,4,0
AUS,ECU,2018.0,2,2,0
MYS,YEM,2019.0,20,5,15
TWN,DEU,2016.0,18,17,1
FIN,IDN,2017.0,3,1,2
BEL,BDI,2017.0,1,1,0
PAK,SGP,2018.0,1,5,-4
IND,IRN,2017.0,13,5,8
USA,SLV,2015.0,1,1,0
DEU,HRV,2002.0,9,10,-1
ZAF,NZL,2001.0,6,5,1
BGD,PHL,2017.0,1,1,0
QAT,EGY,2003.0,3,4,-1
LUX,CZE,2022.0,1,1,0
KEN,AUS,2010.0,3,3,0
SVK,AUT,2011.0,6,6,0
MAR,SAU,2012.0,5,2,3
CHN,DNK,2010.0,29,17,12
THA,BEL,2007.0,2,3,-1
ZAF,AUT,2019.0,5,1,4
NLD,GHA,2002.0,2,3,-1
MAR,BEL,2001.0,1,1,0
FRA,DNK,1997.0,9,4,5
SVK,USA,2010.0,9,14,-5
SLV,SVK,2010.0,2,1,1
TUR,NLD,2006.0,3,2,1
GBR,POL,1998.0,5,8,-3
FRA,BFA,2006.0,5,8,-3
CZE,RUS,2003.0,5,12,-7
CRI,ESP,2008.0,2,4,-2
FIN,IND,2004.0,1,1,0
ISR,SWE,2008.0,5,1,4
RWA,KEN,2019.0,5,6,-1
KOR,SWE,2014.0,11,6,5
ESP,CUB,2001.0,12,20,-8
CMR,USA,2012.0,7,2,5
SGP,NZL,2011.0,10,8,2
POL,IRL,2020.0,2,4,-2
BWA,ZAF,2007.0,5,6,-1
POL,SVN,2011.0,3,4,-1
TUR,RUS,2008.0,2,3,-1
ARE,ITA,2022.0,2,1,1
DEU,SVN,2014.0,3,13,-10
BRA,IDN,2006.0,1,1,0
LUX,GBR,2013.0,5,9,-4
NZL,ARG,2021.0,1,4,-3
FIN,PRT,2010.0,4,1,3
KWT,CAN,2002.0,2,4,-2
NLD,ARG,2012.0,4,4,0
QAT,AUS,2014.0,2,10,-8
GUY,FRA,2006.0,1,1,0
NAM,AUS,2011.0,3,1,2
GHA,USA,2015.0,16,27,-11
SWE,ITA,1997.0,7,4,3
DEU,ETH,2020.0,12,18,-6
CHE,BRA,2022.0,5,13,-8
CHL,NZL,2013.0,6,1,5
USA,BHR,2014.0,2,1,1
KOR,HKG,2010.0,4,7,-3
NLD,PHL,2014.0,1,4,-3
FRA,NGA,2012.0,1,1,0
DNK,ZAF,2006.0,3,2,1
CHE,RWA,2017.0,1,2,-1
PSE,USA,2018.0,5,5,0
IRL,BEL,2011.0,5,6,-1
LBY,EGY,2010.0,2,5,-3
HUN,FRA,2022.0,3,1,2
BGR,CHL,2005.0,1,1,0
KOR,VNM,2009.0,10,6,4
FIN,SRB,2019.0,2,1,1
GRC,AUT,2009.0,5,4,1
NOR,POL,2018.0,6,13,-7
ESP,CHN,2010.0,7,8,-1
MEX,CHL,2002.0,5,3,2
AUT,ETH,2018.0,4,3,1
ETH,IRN,2019.0,1,3,-2
DZA,MAR,2019.0,2,3,-1
EGY,RUS,2012.0,1,2,-1
CHN,SVN,2021.0,1,2,-1
CHE,SGP,2003.0,4,1,3
IDN,PHL,2021.0,1,1,0
LBY,EGY,2017.0,1,6,-5
HKG,JPN,2022.0,10,9,1
MYS,IRQ,2007.0,1,3,-2
PRT,QAT,2016.0,2,1,1
PHL,CHE,2019.0,5,2,3
IND,IRQ,2014.0,5,2,3
USA,BIH,2005.0,3,1,2
MYS,NLD,2022.0,2,1,1
IND,BGD,2016.0,10,15,-5
ISR,JPN,2021.0,6,4,2
CAN,BGD,2004.0,2,5,-3
ECU,USA,2019.0,13,29,-16
GBR,MLT,2010.0,8,7,1
USA,ZMB,2005.0,5,2,3
ETH,IND,2007.0,2,9,-7
NZL,KOR,2016.0,6,5,1
JPN,ESP,2001.0,5,5,0
HTI,USA,2008.0,1,1,0
NOR,PRT,2002.0,2,1,1
ESP,SGP,2018.0,6,3,3
DNK,PRT,2021.0,7,7,0
MYS,IRN,2006.0,2,2,0
ZAF,ZWE,2013.0,19,14,5
IRN,ITA,2006.0,4,2,2
ZAF,MAR,2019.0,2,4,-2
USA,VNM,2009.0,10,7,3
AUS,RUS,2018.0,9,13,-4
PAK,KWT,2015.0,2,3,-1
BLR,KAZ,2014.0,1,2,-1
BEL,TWN,2013.0,3,2,1
DEU,JOR,2022.0,2,5,-3
ARE,SAU,2022.0,4,9,-5
ZAF,DEU,2022.0,8,7,1
KOR,IRL,2014.0,4,3,1
TUN,GRC,2014.0,1,1,0
DNK,PAK,2015.0,1,3,-2
PAK,CHE,2021.0,7,3,4
AUS,MAC,2018.0,1,2,-1
UKR,SWE,2004.0,5,2,3
GBR,ZMB,2010.0,2,1,1
SRB,RUS,2014.0,1,2,-1
IND,ISR,1998.0,4,3,1
SMR,ITA,2019.0,2,5,-3
NZL,MEX,2001.0,1,1,0
AUT,GRC,2011.0,2,6,-4
CAN,HUN,2015.0,5,6,-1
UKR,BEL,2003.0,4,2,2
FRA,GAB,2004.0,3,4,-1
CHE,NOR,2001.0,3,5,-2
UKR,FIN,2003.0,1,1,0
DZA,MAR,2010.0,1,1,0
KEN,GBR,2005.0,6,9,-3
MEX,POL,1997.0,4,1,3
JPN,GHA,2007.0,1,1,0
HUN,FIN,1997.0,1,1,0
UZB,IND,2021.0,1,2,-1
BWA,USA,2009.0,4,12,-8
CHE,DNK,2004.0,11,15,-4
AUS,GRC,2008.0,3,1,2
BGR,FIN,2002.0,2,1,1
EGY,AUT,2017.0,3,2,1
ETH,NLD,2021.0,2,3,-1
BRA,IND,1997.0,3,1,2
BGD,GBR,2000.0,5,4,1
GBR,GMB,2016.0,6,4,2
SWE,GHA,2010.0,1,1,0
OMN,USA,2021.0,4,2,2
PRT,IND,2011.0,7,21,-14
CHN,PAK,2006.0,2,3,-1
USA,BGR,2008.0,7,8,-1
CHN,ZAF,2005.0,4,3,1
IRL,DNK,2004.0,5,2,3
CHE,LAO,2016.0,2,2,0
NOR,BGR,2020.0,1,1,0
LUX,HUN,2021.0,1,1,0
GRC,MEX,2019.0,1,1,0
LBY,MYS,2012.0,1,9,-8
NZL,HKG,2011.0,1,3,-2
KEN,DEU,1998.0,1,1,0
HRV,SWE,2021.0,3,1,2
DEU,GHA,2007.0,4,2,2
CHE,EGY,2012.0,1,4,-3
IRN,OMN,2020.0,12,1,11
PHL,CHE,2017.0,4,2,2
MEX,IND,2006.0,2,5,-3
HUN,POL,1999.0,1,2,-1
AUS,CZE,2012.0,3,2,1
LBN,CAN,2001.0,3,1,2
COL,URY,2018.0,1,1,0
CZE,POL,2011.0,15,5,10
GBR,FLK,2020.0,2,1,1
NOR,ESP,2014.0,7,16,-9
BEN,CAN,2020.0,2,2,0
LVA,SWE,2002.0,3,2,1
URY,ARG,2013.0,3,5,-2
AUS,NGA,2014.0,1,5,-4
DNK,SWE,1999.0,16,20,-4
ESP,SRB,2008.0,1,2,-1
CAN,ETH,2013.0,3,2,1
SWE,AUT,2002.0,5,9,-4
CZE,FRA,2009.0,15,17,-2
SMR,ITA,2017.0,1,2,-1
HRV,SRB,2007.0,6,3,3
KOR,CHE,2011.0,8,7,1
IDN,TWN,2010.0,2,1,1
AUS,BRA,2002.0,7,13,-6
SGP,POL,2012.0,2,2,0
CHN,IND,2002.0,2,4,-2
CAN,IRL,1998.0,4,2,2
UGA,NOR,2011.0,2,1,1
CHN,SRB,2019.0,1,4,-3
TUR,HUN,2016.0,2,2,0
CHE,HUN,2011.0,5,18,-13
RUS,SGP,2018.0,4,3,1
GBR,ISL,2022.0,3,2,1
COL,ECU,2013.0,1,3,-2
SRB,SVN,2017.0,2,3,-1
CIV,BEN,2021.0,1,1,0
DEU,LIE,2003.0,2,3,-1
USA,MAR,2018.0,2,3,-1
FRA,GIN,2008.0,2,6,-4
TUR,AZE,2012.0,9,2,7
DEU,OMN,2020.0,3,1,2
BEL,TZA,2014.0,3,1,2
DZA,TUR,2021.0,3,2,1
SWE,POL,2004.0,6,14,-8
IND,ETH,2009.0,5,7,-2
LUX,BEL,2007.0,2,8,-6
CHN,SYR,2011.0,1,1,0
HKG,IRN,2012.0,1,3,-2
AUT,BRA,2014.0,2,9,-7
CZE,ITA,2015.0,6,16,-10
TZA,DNK,2020.0,2,1,1
LUX,ITA,2018.0,2,14,-12
ROU,PRT,2018.0,1,2,-1
BRA,SGP,2021.0,3,2,1
FIN,HUN,2009.0,2,3,-1
GBR,PHL,1999.0,1,1,0
PRY,JPN,2011.0,1,1,0
SDN,ZAF,2018.0,2,3,-1
AZE,IRN,2021.0,1,2,-1
CHN,MEX,2012.0,1,3,-2
ETH,UGA,2019.0,2,2,0
KGZ,TUR,2019.0,1,1,0
DZA,ESP,2012.0,1,6,-5
YEM,IND,2010.0,1,4,-3
USA,DZA,2008.0,4,2,2
SAU,SWE,2013.0,2,5,-3
GRC,CAN,2001.0,4,8,-4
ISR,POL,1997.0,2,1,1
NGA,IND,2007.0,4,4,0
BEL,IRL,2006.0,2,2,0
DEU,BGD,2000.0,3,2,1
IRL,GRC,1997.0,1,1,0
ESP,CZE,2005.0,3,2,1
MEX,PER,2003.0,1,1,0
FRA,NER,2000.0,1,1,0
EGY,ITA,2015.0,5,8,-3
KAZ,EGY,2010.0,1,1,0
URY,MEX,2018.0,2,3,-1
IRN,NOR,2008.0,2,1,1
HRV,CZE,2011.0,2,1,1
KEN,GHA,2020.0,5,1,4
RUS,BRA,2012.0,2,1,1
GMB,NGA,2006.0,2,2,0
FIN,CZE,2012.0,4,3,1
DEU,MAR,2009.0,1,2,-1
EGY,ESP,2008.0,1,4,-3
POL,BRA,2008.0,2,2,0
CPV,PRT,2013.0,2,2,0
AUT,TWN,2017.0,1,1,0
THA,DNK,2015.0,1,4,-3
BIH,SVN,2018.0,1,1,0
UGA,IND,2019.0,2,2,0
DNK,IRL,2018.0,7,7,0
FIN,BEL,2022.0,4,4,0
GBR,MUS,2003.0,1,1,0
IRN,SYR,2017.0,1,1,0
CAN,HRV,2009.0,1,2,-1
NZL,FIN,2015.0,2,4,-2
SVK,IND,2017.0,1,1,0
MAR,GBR,2016.0,1,2,-1
DEU,HRV,2005.0,4,6,-2
NOR,TZA,2006.0,1,1,0
AUT,NZL,2007.0,2,2,0
GBR,HRV,2007.0,2,3,-1
TWN,PHL,2015.0,3,3,0
DNK,AUT,2008.0,5,6,-1
TUN,DZA,2009.0,1,1,0
CHE,PAK,2008.0,1,1,0
BLR,NOR,2019.0,3,1,2
MWI,FRA,2020.0,1,1,0
CHE,QAT,2013.0,2,1,1
SVK,BEL,2018.0,1,3,-2
VUT,AUS,2015.0,1,1,0
IRL,ROU,2007.0,1,2,-1
HKG,PAK,2015.0,2,7,-5
SVK,USA,2019.0,7,4,3
NGA,PRT,2016.0,1,1,0
VNM,ITA,2020.0,1,7,-6
EGY,AUT,2019.0,3,2,1
NPL,NLD,2017.0,1,1,0
ITA,UGA,2012.0,1,1,0
AGO,FRA,2018.0,2,1,1
ZAF,SWE,2004.0,1,4,-3
DEU,CMR,2011.0,4,5,-1
CHN,EGY,2005.0,1,2,-1
FIN,PRT,2017.0,2,4,-2
IRN,SYR,2019.0,2,1,1
JPN,ISR,2000.0,1,2,-1
GHA,FRA,2016.0,1,2,-1
RWA,KEN,2017.0,2,1,1
NAM,DEU,2018.0,1,1,0
NZL,ISL,2022.0,1,1,0
NPL,THA,2022.0,3,3,0
BGD,PAK,2011.0,5,8,-3
IDN,CMR,2015.0,1,3,-2
PER,ECU,2022.0,3,2,1
RUS,BGR,2013.0,3,3,0
DNK,GNB,2013.0,1,2,-1
UGA,TZA,2009.0,1,1,0
MYS,AUT,2020.0,2,1,1
EGY,AUT,2010.0,1,3,-2
CHE,VNM,2022.0,1,4,-3
CYP,AUT,2018.0,1,1,0
DNK,CAN,2022.0,6,9,-3
PAK,RUS,2021.0,1,1,0
UKR,LTU,2017.0,1,2,-1
HKG,IND,2001.0,5,4,1
RUS,SRB,1999.0,4,1,3
MCO,FRA,2008.0,3,14,-11
DEU,CYP,1998.0,1,1,0
TUN,MAR,2010.0,1,1,0
UKR,ESP,2011.0,2,3,-1
CAN,SYR,2016.0,1,1,0
CHL,NLD,2007.0,1,1,0
AUT,EGY,2016.0,3,1,2
CIV,BFA,2015.0,1,1,0
POL,BLR,2009.0,2,1,1
ESP,ISR,2011.0,3,6,-3
MYS,ZMB,2021.0,1,1,0
ESP,HRV,2012.0,1,6,-5
CAN,BGR,2012.0,1,3,-2
SYR,USA,2007.0,2,1,1
NGA,IRL,2015.0,2,2,0
SAU,DZA,2014.0,1,4,-3
EST,FRA,2004.0,1,2,-1
IRL,CZE,2009.0,1,3,-2
CZE,TWN,2005.0,1,1,0
MAR,EGY,2019.0,1,3,-2
GIN,FRA,2014.0,1,3,-2
USA,CMR,1999.0,1,1,0
CHN,ESP,2004.0,2,5,-3
DEU,KGZ,2016.0,2,1,1
NZL,IRN,2012.0,1,9,-8
BGR,TUR,2021.0,1,1,0
TUR,AUT,2008.0,1,2,-1
IRQ,USA,2006.0,1,4,-3
SRB,CAN,1998.0,1,1,0
ARG,CUB,2006.0,1,1,0
LTU,DNK,2022.0,2,1,1
DNK,VNM,2009.0,1,2,-1
SEN,MLI,2016.0,1,1,0
CYP,ESP,2020.0,2,1,1
LVA,FIN,2020.0,1,1,0
ESP,NGA,2010.0,1,1,0
EGY,SDN,2018.0,1,2,-1
PHL,CHE,2010.0,4,3,1
PSE,MYS,2020.0,4,10,-6
IRL,EGY,2022.0,1,2,-1
AUS,PNG,2013.0,1,6,-5
DNK,BRN,2014.0,1,1,0
SVK,RUS,2003.0,2,4,-2
GHA,DNK,2018.0,2,4,-2
SVK,IND,2019.0,2,3,-1
SRB,TUR,2018.0,1,1,0
MMR,GBR,2022.0,1,2,-1
AUS,UGA,2014.0,1,2,-1
OMN,CAN,2001.0,1,2,-1
CUB,PRI,2001.0,1,2,-1
SVK,CHE,2012.0,3,1,2
TZA,NLD,2009.0,1,6,-5
IDN,FIN,2018.0,1,2,-1
POL,SGP,2015.0,2,1,1
AUS,DZA,2018.0,1,1,0
MCO,DEU,2022.0,1,1,0
GHA,IRL,2018.0,1,1,0
QAT,HKG,2020.0,1,2,-1
LBR,IND,2021.0,1,1,0
ESP,NGA,2019.0,1,1,0
KOR,ARE,2011.0,1,1,0
CHE,VEN,2015.0,1,1,0
LVA,CHE,2004.0,1,1,0
MOZ,ESP,2015.0,2,4,-2
RUS,EGY,2007.0,3,2,1
GBR,SDN,2019.0,2,2,0
KAZ,GEO,2016.0,1,2,-1
CAN,BLR,2006.0,1,1,0
ETH,ZAF,2006.0,1,4,-3
GBR,PRI,2007.0,1,1,0
CZE,SVN,2015.0,1,2,-1
IRL,MEX,1999.0,1,1,0
BRA,PAN,2022.0,1,1,0
CMR,COG,2015.0,1,2,-1
CAN,LKA,2021.0,1,1,0
ITA,LBN,2020.0,4,4,0
ISR,ZAF,1999.0,1,1,0
NOR,ARG,2019.0,1,1,0
CYP,TUR,2008.0,3,6,-3
LAO,GBR,2011.0,1,3,-2
PRI,ESP,2006.0,1,6,-5
VNM,KOR,2003.0,2,6,-4
SGP,KHM,2012.0,1,1,0
ZWE,BWA,2015.0,1,4,-3
SWE,BRA,2022.0,2,18,-16
NLD,KWT,2021.0,1,1,0
SEN,GBR,2014.0,1,2,-1
USA,FJI,2020.0,2,4,-2
JPN,GRC,2008.0,1,1,0
EGY,SYR,2014.0,1,2,-1
CRI,CHL,2004.0,1,1,0
ZAF,JPN,2007.0,1,5,-4
BGD,HKG,2007.0,1,1,0
MWI,AUS,2011.0,1,1,0
SWE,ZAF,2010.0,2,4,-2
ECU,IRL,2019.0,1,1,0
FIN,POL,2000.0,2,4,-2
FRA,AGO,2018.0,1,2,-1
UKR,SAU,2016.0,1,1,0
SRB,SVN,2010.0,4,2,2
TUR,UZB,2020.0,1,1,0
BHR,EGY,2018.0,1,2,-1
TUR,UKR,1999.0,1,3,-2
GHA,GBR,1999.0,1,1,0
ESP,CZE,2002.0,1,1,0
NPL,BEL,2016.0,1,2,-1
AZE,TUR,1999.0,1,1,0
KOR,FJI,2010.0,1,2,-1
BRA,PHL,2013.0,1,2,-1
IRL,LTU,2020.0,1,2,-1
COL,PAN,2006.0,1,2,-1
DNK,TUR,2008.0,2,4,-2
USA,LBN,2001.0,17,7,10
USA,IND,2016.0,671,1046,-375
HUN,ESP,2007.0,4,2,2
GRC,USA,2007.0,85,117,-32
USA,ITA,2007.0,328,441,-113
NLD,GBR,2021.0,191,287,-96
DEU,DNK,2014.0,87,79,8
AUS,USA,2017.0,610,533,77
USA,PRT,2009.0,50,41,9
IND,SAU,2020.0,138,41,97
ARG,USA,2007.0,97,89,8
USA,MEX,2016.0,200,197,3
NLD,DEU,2007.0,149,187,-38
THA,CAN,2018.0,11,10,1
UKR,RUS,2016.0,218,42,176
IRL,CHN,2016.0,29,16,13
USA,IRL,2014.0,120,140,-20
ESP,SWE,2018.0,95,40,55
BGD,CAN,2015.0,27,12,15
BRA,GBR,2019.0,126,94,32
AUS,CAN,2022.0,61,51,10
ESP,GBR,2020.0,317,403,-86
NLD,FIN,2022.0,9,11,-2
NLD,USA,1999.0,109,98,11
JPN,NPL,2012.0,7,3,4
IDN,TWN,2017.0,13,30,-17
DEU,ISR,2019.0,50,64,-14
IDN,TWN,2019.0,24,39,-15
CHL,ESP,2020.0,93,115,-22
GBR,ROU,2017.0,10,18,-8
AUT,NLD,2022.0,11,19,-8
GBR,AUT,2000.0,10,6,4
DEU,GBR,2022.0,206,293,-87
PHL,SGP,2021.0,2,2,0
NLD,POL,2019.0,19,17,2
JPN,BRA,2008.0,11,12,-1
NZL,KEN,2009.0,1,1,0
FRA,PAK,2013.0,33,8,25
MYS,THA,2009.0,4,3,1
USA,TUN,2012.0,9,4,5
GBR,NOR,2016.0,77,56,21
AUS,ESP,2010.0,20,23,-3
ITA,AUT,2010.0,34,24,10
AUS,CHL,2020.0,9,19,-10
FIN,KOR,2018.0,5,1,4
FRA,CRI,2009.0,2,4,-2
CHE,CZE,2013.0,12,9,3
GRC,CHE,2020.0,22,21,1
DEU,ISL,2017.0,5,5,0
BEL,ESP,2002.0,18,28,-10
JOR,CAN,2022.0,5,6,-1
HUN,DEU,2007.0,21,27,-6
THA,VNM,2010.0,6,1,5
GBR,ROU,2019.0,18,22,-4
SVK,GBR,2021.0,3,5,-2
NLD,POL,2010.0,19,25,-6
IND,MEX,2002.0,2,3,-1
FRA,IDN,2003.0,8,3,5
GMB,GBR,2004.0,6,11,-5
ROU,FRA,2022.0,8,9,-1
NZL,SWE,2011.0,5,3,2
PHL,DEU,2012.0,8,3,5
RUS,UKR,1998.0,23,24,-1
AUS,IND,2004.0,7,20,-13
ESP,IRL,2014.0,24,19,5
GUF,GUY,2016.0,1,1,0
USA,GMB,2012.0,1,1,0
PRT,CHE,2002.0,4,7,-3
PRT,CHE,2005.0,4,4,0
SAU,IND,2016.0,36,169,-133
MAR,BEN,2008.0,1,1,0
IND,NGA,2013.0,6,8,-2
FIN,CAN,2013.0,15,13,2
BGD,NLD,2011.0,3,3,0
GBR,HUN,2012.0,16,25,-9
MDA,ROU,2013.0,2,4,-2
JPN,MEX,2020.0,6,7,-1
COL,FRA,2014.0,17,20,-3
CHE,MLT,2017.0,2,1,1
LBN,ITA,2016.0,4,1,3
SWE,ZAF,2017.0,7,9,-2
CUB,CAN,2015.0,3,1,2
GAB,FRA,2018.0,5,7,-2
GBR,MLT,2017.0,11,12,-1
CHN,IND,2005.0,3,9,-6
KEN,AUS,2019.0,5,7,-2
AUS,THA,2022.0,11,11,0
DEU,ISL,2019.0,6,5,1
DZA,MAR,2017.0,4,3,1
CHN,GHA,2018.0,14,12,2
ARE,SGP,2012.0,1,7,-6
IRL,ESP,2012.0,18,7,11
IND,KOR,2000.0,3,2,1
ZAF,MAR,2017.0,3,1,2
ZAF,KEN,2004.0,5,3,2
FRA,HUN,2015.0,11,14,-3
UZB,USA,2011.0,3,1,2
DEU,ISL,2010.0,5,1,4
IRL,AUT,2009.0,4,5,-1
BEL,MEX,2016.0,7,8,-1
ITA,EGY,2015.0,8,5,3
JPN,SVK,2007.0,1,2,-1
ESP,SVN,2012.0,4,4,0
DNK,BGD,2013.0,2,2,0
KWT,FRA,2016.0,1,1,0
CHL,FRA,2001.0,6,9,-3
MYS,YEM,2010.0,5,2,3
IRN,MYS,2007.0,8,5,3
NPL,SWE,2014.0,1,1,0
BRN,SGP,2007.0,1,1,0
ESP,MYS,2015.0,3,2,1
NLD,IRN,2016.0,11,33,-22
HUN,CHE,2021.0,11,10,1
IND,AUT,2014.0,12,5,7
KOR,HKG,2017.0,10,9,1
TWN,SGP,2007.0,5,4,1
BEL,NZL,2011.0,4,1,3
GBR,ZMB,2019.0,4,6,-2
PRT,AUT,2005.0,1,2,-1
DNK,KEN,2015.0,2,1,1
RUS,SVK,2021.0,3,4,-1
IRN,EST,2022.0,3,1,2
SVN,AUT,2016.0,8,3,5
KAZ,CHN,2021.0,4,7,-3
NZL,BEL,2015.0,2,4,-2
ZAF,ITA,2016.0,8,9,-1
UKR,JPN,2007.0,4,1,3
BEL,NER,2018.0,1,1,0
GBR,ETH,2021.0,3,5,-2
TWN,THA,2011.0,2,4,-2
SGP,ZAF,2009.0,3,1,2
SWE,ARE,2007.0,3,1,2
ESP,HKG,2014.0,1,2,-1
BGR,SWE,2001.0,2,2,0
DEU,NPL,2012.0,5,4,1
THA,AUT,2011.0,2,6,-4
CZE,HRV,2003.0,2,3,-1
ITA,TUR,2009.0,5,3,2
CHE,GRC,2008.0,5,9,-4
AUS,MEX,2009.0,3,6,-3
CZE,NOR,2009.0,2,1,1
POL,KOR,2000.0,1,2,-1
MWI,IRL,2018.0,2,1,1
BGD,PHL,2010.0,1,1,0
ZAF,AUT,2010.0,2,3,-1
CHL,JPN,2009.0,2,3,-1
LTU,AUS,2020.0,1,1,0
LVA,SWE,2005.0,2,4,-2
ZWE,ZMB,1999.0,1,1,0
LKA,SWE,2012.0,1,3,-2
KOR,ETH,2014.0,2,2,0
ARG,ECU,2019.0,3,4,-1
KEN,AUT,2020.0,1,2,-1
JOR,CHN,2017.0,2,1,1
FJI,IND,2011.0,1,2,-1
MAR,QAT,2021.0,2,1,1
MAC,THA,2021.0,1,1,0
CHE,TUN,2018.0,3,3,0
CZE,MEX,2006.0,1,1,0
ITA,NZL,2020.0,3,9,-6
SGP,FIN,2021.0,2,1,1
AUT,HRV,2006.0,2,1,1
TUR,JPN,2014.0,1,9,-8
EST,ESP,2013.0,1,3,-2
NZL,QAT,2017.0,1,1,0
USA,FSM,2021.0,1,1,0
POL,HKG,2011.0,1,4,-3
CHN,EGY,2002.0,1,1,0
FRA,NPL,2018.0,1,1,0
BEL,SGP,2001.0,1,1,0
FIN,SRB,2010.0,1,1,0
HUN,BGR,2019.0,1,1,0
ARG,PRT,2021.0,1,1,0
BRA,ROU,2012.0,1,2,-1
CHE,SAU,2022.0,1,2,-1
ETH,TUR,2022.0,1,2,-1
,CAN,2003.0,10839,0,10839
BLR,,2009.0,175,0,175
CHL,,2024.0,10601,0,10601
,HRV,2004.0,925,0,925
AUS,,2008.0,2774,0,2774
,BRA,2001.0,9180,0,9180
LBN,,2024.0,2291,0,2291
,NOR,2003.0,1685,0,1685
MYS,,2012.0,580,0,580
,PAK,2004.0,1378,0,1378
,BEL,2010.0,3447,0,3447
MEX,,2019.0,3819,0,3819
MEX,,2010.0,1179,0,1179
DNK,,2014.0,1206,0,1206
NOR,,2011.0,742,0,742
,BFA,2003.0,63,0,63
PRT,,2022.0,5336,0,5336
,UKR,2007.0,1349,0,1349
,SWE,2006.0,3255,0,3255
NZL,,2009.0,563,0,563
,COG,2001.0,30,0,30
,DNK,2000.0,2264,0,2264
,TUN,1998.0,603,0,603
,HUN,2001.0,1312,0,1312
MEX,,2017.0,2760,0,2760
,NZL,1999.0,2173,0,2173
IRN,,2021.0,11427,0,11427
,HRV,1996.0,478,0,478
PNG,,2018.0,26,0,26
PHL,,2020.0,414,0,414
,PAK,1996.0,175,0,175
MDA,,2017.0,38,0,38
SVN,,2016.0,454,0,454
,TTO,2002.0,44,0,44
NLD,,2006.0,1740,0,1740
,USA,2018.0,79966,0,79966
KEN,,2016.0,237,0,237
,ARG,2016.0,2487,0,2487
,TUN,1997.0,188,0,188
MDA,,2019.0,73,0,73
,PSE,2009.0,39,0,39
BGD,,2013.0,203,0,203
NGA,,2015.0,709,0,709
BRA,MOZ,2007.0,6,0,6
,SEN,1994.0,131,0,131
,COL,1995.0,143,0,143
,FIN,2013.0,2142,0,2142
,MCO,2005.0,9,0,9
EST,,2016.0,240,0,240
,MUS,2009.0,21,0,21
ZWE,NLD,2009.0,3,0,3
CRI,,2018.0,96,0,96
,PNG,2006.0,24,0,24
,RWA,2010.0,52,0,52
,KAZ,2010.0,334,0,334
,LKA,2011.0,242,0,242
,JOR,2007.0,431,0,431
,BEL,2017.0,2976,0,2976
NAM,,2022.0,84,0,84
ITA,,2025.0,68,0,68
,CUB,2007.0,756,0,756
,BEL,2019.0,1722,0,1722
NIC,,2018.0,21,0,21
SDN,,2018.0,86,0,86
ZMB,,2019.0,72,0,72
GTM,DEU,2017.0,1,0,1
,BWA,2012.0,73,0,73
HKG,,2005.0,409,0,409
JOR,,2016.0,191,0,191
EST,LUX,2019.0,1,0,1
,KAZ,2017.0,1153,0,1153
MWI,,2020.0,96,0,96
,ALB,2008.0,86,0,86
IRN,IRQ,2002.0,1,0,1
USA,ALB,2014.0,4,0,4
,RWA,2019.0,75,0,75
,BRN,2014.0,57,0,57
,BOL,2015.0,56,0,56
TUR,GEO,2022.0,1,0,1
HND,,2022.0,45,0,45
,RWA,2017.0,119,0,119
,ETH,2003.0,121,0,121
NGA,POL,2021.0,3,0,3
,KAZ,2019.0,407,0,407
IND,PRI,2001.0,1,0,1
ZAF,SYC,2020.0,2,0,2
,FJI,2007.0,17,0,17
PLW,,2024.0,6,0,6
UZB,,2007.0,51,0,51
FRA,,1999.0,385,0,385
VEN,BRA,2011.0,4,0,4
HKG,CHL,2008.0,1,0,1
HKG,,2002.0,89,0,89
POL,NGA,2020.0,2,0,2
PAK,,2003.0,82,0,82
,MDG,1998.0,66,0,66
AUT,SAU,2013.0,3,0,3
COG,,2012.0,23,0,23
PAK,ARE,2006.0,1,0,1
MNE,,2016.0,17,0,17
ZAF,,2003.0,211,0,211
NPL,ERI,2015.0,1,0,1
BLR,NZL,2021.0,1,0,1
NGA,CMR,2000.0,2,0,2
IRN,ISL,2015.0,1,0,1
KAZ,,2008.0,32,0,32
ARM,SWE,2003.0,1,0,1
NZL,WSM,2016.0,3,0,3
,MTQ,2012.0,13,0,13
VNM,,2008.0,57,0,57
ZMB,,2017.0,32,0,32
BEL,SAU,2002.0,1,0,1
AND,,2012.0,9,0,9
PRK,,2019.0,7,0,7
CHE,MLT,2019.0,1,0,1
ZMB,TZA,2021.0,1,0,1
ITA,PSE,2020.0,4,0,4
SEN,CMR,2020.0,2,0,2
LKA,CAN,2022.0,3,0,3
BLR,USA,1998.0,6,0,6
ZMB,MOZ,2020.0,1,0,1
COM,EGY,2020.0,1,0,1
CAN,ZWE,2020.0,1,0,1
IRN,IRL,2008.0,2,0,2
,GNB,2004.0,4,0,4
GIN,RUS,2005.0,1,0,1
GTM,,2007.0,6,0,6
KEN,CMR,2011.0,2,0,2
ZAF,ISR,2004.0,2,0,2
DNK,TZA,2005.0,4,0,4
MDA,,2010.0,19,0,19
SEN,,2008.0,25,0,25
RUS,TUR,2004.0,12,0,12
,TJK,2002.0,16,0,16
DZA,,2006.0,35,0,35
AFG,,2020.0,12,0,12
NGA,AUS,2013.0,5,0,5
GBR,TTO,2005.0,6,0,6
ESP,EST,2008.0,1,0,1
,MLI,1997.0,9,0,9
,MDG,1997.0,4,0,4
DEU,GMB,2009.0,1,0,1
UGA,,2009.0,34,0,34
TUR,BGR,2001.0,1,0,1
BGR,FRA,2001.0,8,0,8
BEL,COL,1998.0,2,0,2
MEX,SWE,1998.0,2,0,2
COL,KEN,2009.0,1,0,1
VEN,ITA,2012.0,3,0,3
,TTO,2005.0,49,0,49
,MCO,2002.0,9,0,9
IRL,NZL,2000.0,2,0,2
BEL,HUN,1998.0,1,0,1
CHN,IRQ,2007.0,1,0,1
,MLI,1998.0,18,0,18
ISR,NOR,2009.0,2,0,2
AFG,ZAF,2014.0,1,0,1
MYS,USA,1999.0,4,0,4
ARG,RUS,2002.0,2,0,2
,NIC,1994.0,3,0,3
NGA,CHE,2008.0,1,0,1
,SUR,1996.0,2,0,2
,MMR,2000.0,12,0,12
IRL,JPN,1999.0,2,0,2
ARG,ECU,2010.0,1,0,1
NPL,,2006.0,21,0,21
POL,VNM,2009.0,1,0,1
HKG,DNK,2002.0,1,0,1
MDA,POL,2009.0,3,0,3
JPN,GUM,2012.0,1,0,1
UZB,MYS,2009.0,2,0,2
MNG,CHN,2011.0,1,0,1
UKR,SVK,2006.0,1,0,1
ZMB,,2010.0,13,0,13
,GIN,2003.0,6,0,6
,TJK,2005.0,14,0,14
SLV,SVN,2019.0,1,0,1
,GUM,1997.0,2,0,2
,ZWE,2007.0,49,0,49
PAK,VNM,2022.0,2,0,2
THA,ECU,2012.0,1,0,1
,KNA,2013.0,4,0,4
GUY,USA,2017.0,1,0,1
MNG,CHE,2014.0,1,0,1
,MRT,2012.0,12,0,12
ESP,ARE,2018.0,9,0,9
CUB,NZL,2017.0,1,0,1
LBY,YEM,2009.0,1,0,1
PRI,ARG,2014.0,2,0,2
POL,EGY,2017.0,2,0,2
NLD,GTM,2007.0,1,0,1
USA,PSE,2006.0,6,0,6
CHE,NPL,2010.0,1,0,1
ISL,UGA,2021.0,1,0,1
NOR,THA,2016.0,2,0,2
BEL,BDI,2010.0,2,0,2
ARG,BOL,2018.0,1,0,1
DEU,PRK,2019.0,1,0,1
LUX,SAU,2022.0,1,0,1
BHS,NOR,2019.0,1,0,1
SVN,SVK,2022.0,1,0,1
ROU,AUT,2018.0,5,0,5
UKR,LTU,2019.0,5,0,5
MTQ,,2000.0,8,0,8
IRQ,IDN,2018.0,1,0,1
BRA,IND,1998.0,2,0,2
SVN,CHN,2013.0,3,0,3
TUR,IDN,2017.0,1,0,1
ISR,GRC,2003.0,2,0,2
NGA,ITA,2007.0,2,0,2
ISR,NZL,2010.0,2,0,2
NOR,QAT,2009.0,1,0,1
MDG,USA,2004.0,4,0,4
CRI,SWE,2010.0,1,0,1
ITA,COG,2011.0,1,0,1
GBR,BRN,2003.0,1,0,1
BRN,,2006.0,4,0,4
SAU,QAT,1999.0,1,0,1
GUM,,2004.0,2,0,2
CHN,ZAF,2002.0,1,0,1
CZE,COG,2008.0,1,0,1
GBR,COL,2009.0,8,0,8
,SLV,2004.0,11,0,11
KOR,IDN,2004.0,2,0,2
TON,FJI,2007.0,1,0,1
UKR,CHE,2011.0,3,0,3
SDN,ARE,2013.0,4,0,4
,CAF,2007.0,4,0,4
IRL,BGD,2013.0,1,0,1
GBR,TTO,2002.0,3,0,3
WSM,USA,2005.0,1,0,1
CHE,FJI,2013.0,1,0,1
VNM,LAO,2016.0,4,0,4
DEU,PRY,2013.0,1,0,1
BLR,JPN,1998.0,1,0,1
BEL,MYS,2011.0,3,0,3
NOR,ARG,2017.0,2,0,2
IND,ARG,2014.0,2,0,2
MMR,CHE,2019.0,3,0,3
DEU,VEN,1999.0,1,0,1
,LIE,2004.0,7,0,7
KGZ,GBR,2002.0,1,0,1
DEU,CIV,2006.0,1,0,1
MAR,MLI,2012.0,1,0,1
BEL,BHR,2006.0,1,0,1
SAU,DEU,2004.0,2,0,2
ETH,AUS,1999.0,1,0,1
MYS,BIH,2013.0,1,0,1
TWN,DNK,2013.0,3,0,3
BEL,QAT,2020.0,2,0,2
,NCL,2009.0,9,0,9
GRL,NOR,2010.0,2,0,2
BWA,ZWE,2016.0,2,0,2
HRV,JPN,2010.0,1,0,1
MOZ,LBR,2017.0,1,0,1
GEO,CZE,2021.0,1,0,1
,MAC,2000.0,12,0,12
MAR,IRQ,2022.0,2,0,2
QAT,PHL,2005.0,1,0,1
,GUY,2003.0,3,0,3
BIH,QAT,2018.0,1,0,1
IRL,HRV,2007.0,1,0,1
GRC,MEX,2010.0,1,0,1
USA,ZMB,2002.0,3,0,3
ISL,AUS,2002.0,1,0,1
SWE,IDN,2003.0,2,0,2
GRC,BGR,2000.0,2,0,2
AUS,FLK,2010.0,2,0,2
IRN,ZAF,2002.0,2,0,2
SRB,ALB,2005.0,1,0,1
JPN,ETH,2006.0,1,0,1
AUT,BEL,1999.0,2,0,2
GEO,POL,2013.0,1,0,1
BRA,FIN,2003.0,1,0,1
MDA,FIN,2002.0,1,0,1
,SWZ,2001.0,6,0,6
ZWE,IDN,2004.0,1,0,1
FIN,CHL,2004.0,1,0,1
GBR,POL,1997.0,3,0,3
HND,MEX,2013.0,1,0,1
DEU,KAZ,2009.0,1,0,1
TUR,SRB,2007.0,1,0,1
TWN,SWE,2011.0,3,0,3
ECU,VEN,2011.0,1,0,1
CAN,GIN,2012.0,1,0,1
MKD,DEU,2006.0,2,0,2
PRI,DEU,2013.0,1,0,1
IRQ,ARE,2011.0,1,0,1
TUR,BIH,2011.0,4,0,4
CHE,NPL,2019.0,2,0,2
SVK,SRB,2013.0,1,0,1
POL,ARE,2018.0,1,0,1
IND,QAT,2011.0,4,0,4
LCA,,2020.0,2,0,2
BOL,DNK,2015.0,2,0,2
NPL,ETH,2020.0,1,0,1
POL,THA,2022.0,1,0,1
CZE,HUN,2022.0,3,0,3
AUT,VNM,2021.0,2,0,2
,KGZ,2006.0,6,0,6
UGA,PER,2000.0,1,0,1
HUN,ISR,2018.0,3,0,3
UZB,GBR,2008.0,1,0,1
AUS,SLB,2008.0,1,0,1
ROU,EST,2009.0,2,0,2
ROU,BRA,2018.0,3,0,3
,SLB,2008.0,2,0,2
KAZ,EGY,2019.0,1,0,1
CUB,NOR,2006.0,1,0,1
UGA,DEU,2022.0,4,0,4
IND,YEM,2008.0,2,0,2
TUN,BEL,2011.0,2,0,2
BRA,EGY,2007.0,1,0,1
BOL,BEL,2002.0,1,0,1
KEN,THA,2012.0,2,0,2
PHL,TWN,2006.0,1,0,1
BRN,USA,2008.0,1,0,1
GRC,KEN,2004.0,1,0,1
UZB,NLD,2020.0,1,0,1
TUR,PRT,2005.0,1,0,1
SYR,CHE,2016.0,1,0,1
HKG,THA,1999.0,1,0,1
BGD,NPL,2002.0,1,0,1
FRO,DEU,2018.0,1,0,1
SOM,,2015.0,2,0,2
COG,NOR,2015.0,1,0,1
COL,UGA,2009.0,1,0,1
SEN,GHA,2018.0,1,0,1
MAR,TCD,2020.0,1,0,1
SYR,BGD,2020.0,1,0,1
FRA,FJI,2021.0,1,0,1
AUT,BGD,1998.0,1,0,1
ITA,BRN,2016.0,1,0,1
PRI,CAN,2009.0,1,0,1
NZL,PNG,2011.0,1,0,1
LAO,KOR,2019.0,1,0,1
,SUR,2004.0,5,0,5
GBR,MAC,2022.0,4,0,4
HKG,GUM,2015.0,1,0,1
MAR,SVN,2022.0,1,0,1
IND,ISL,2020.0,1,0,1
BEL,HUN,1997.0,1,0,1
GTM,CAN,2004.0,1,0,1
ZWE,MWI,2004.0,1,0,1
PRT,PRI,2014.0,1,0,1
KAZ,BLR,1997.0,3,0,3
TTO,CAN,2004.0,1,0,1
FIN,SRB,2017.0,1,0,1
NZL,UKR,2014.0,1,0,1
GBR,COD,2020.0,1,0,1
CHN,CHL,2013.0,1,0,1
PER,KEN,2014.0,2,0,2
TUN,CHN,2009.0,1,0,1
KOR,FJI,2017.0,1,0,1
CHE,RWA,2019.0,1,0,1
AUS,MLT,2022.0,2,0,2
CRI,DOM,2016.0,1,0,1
CZE,KAZ,2018.0,1,0,1
THA,CZE,2004.0,1,0,1
PRI,BEL,2020.0,1,0,1
IDN,ZAF,2020.0,1,0,1
RUS,ZAF,2001.0,4,0,4
PRK,,2010.0,1,0,1
LIE,GRC,2017.0,1,0,1
BLZ,,2008.0,1,0,1
JPN,ARG,2016.0,1,0,1
ISL,LUX,2008.0,1,0,1
,LIE,1996.0,2,0,2
POL,EGY,2010.0,1,0,1
FLK,PRT,2009.0,1,0,1
MEX,POL,1998.0,2,0,2
DNK,FRO,2008.0,2,0,2
ITA,SAU,2002.0,3,0,3
MLI,GHA,2011.0,1,0,1
HRV,RUS,2013.0,1,0,1
ITA,MKD,2006.0,1,0,1
ISR,ARG,2011.0,2,0,2
BEL,LUX,1999.0,1,0,1
SEN,MDG,2015.0,1,0,1
UKR,KAZ,2015.0,1,0,1
DEU,VNM,2003.0,3,0,3
AUT,SGP,2000.0,1,0,1
ARE,SYR,2007.0,1,0,1
EGY,CMR,2006.0,1,0,1
NZL,OMN,2017.0,1,0,1
NOR,EGY,2014.0,1,0,1
SWE,MNE,2012.0,1,0,1
ZAF,HKG,2016.0,2,0,2
,GRL,2007.0,4,0,4
BIH,AUS,2019.0,3,0,3
SWE,IND,2023.0,1,0,1
ISR,GMB,2020.0,1,0,1
LTU,NLD,2008.0,3,0,3
POL,BGR,2022.0,1,0,1
TUR,PAK,2000.0,1,0,1
KOR,CMR,2020.0,2,0,2
PRI,KOR,2013.0,1,0,1
GBR,LAO,2013.0,1,0,1
BOL,NZL,2014.0,1,0,1
SGP,MAR,2006.0,1,0,1
BGD,NOR,2001.0,1,0,1
FJI,CHE,2004.0,1,0,1
SGP,LKA,2006.0,2,0,2
KHM,,2001.0,1,0,1
ZWE,NZL,1999.0,2,0,2
ESP,MDA,2003.0,1,0,1
IND,MEX,2005.0,4,0,4
PHL,LKA,2014.0,1,0,1
RWA,GBR,2011.0,1,0,1
EGY,PAK,2008.0,3,0,3
KEN,NGA,2013.0,2,0,2
CAN,LVA,2013.0,1,0,1
BEL,SAU,2005.0,1,0,1
,LSO,2008.0,4,0,4
LTU,NZL,2012.0,1,0,1
SVK,BLR,2003.0,1,0,1
EGY,AUS,2007.0,1,0,1
MDA,ESP,2001.0,1,0,1
HRV,JPN,2019.0,2,0,2
SVN,VEN,2011.0,1,0,1
POL,PER,2017.0,1,0,1
BEL,GIN,2016.0,1,0,1
FRA,MLT,2021.0,1,0,1
ISR,BGR,2005.0,2,0,2
JPN,BOL,2018.0,2,0,2
,GUM,1998.0,2,0,2
THA,NGA,2007.0,1,0,1
IND,UGA,2015.0,1,0,1
IND,ISR,1997.0,2,0,2
MLI,CAN,2016.0,1,0,1
GTM,SWE,2018.0,1,0,1
PRT,KAZ,2019.0,1,0,1
PRT,BHR,2015.0,1,0,1
AUS,MNG,2014.0,1,0,1
GEO,CHE,2020.0,1,0,1
ZAF,MLI,2017.0,1,0,1
DZA,LUX,2017.0,1,0,1
SWE,BEN,2017.0,1,0,1
GAB,USA,2018.0,2,0,2
SLE,EGY,2020.0,1,0,1
AZE,GEO,2009.0,1,0,1
RUS,IND,2011.0,1,0,1
AZE,KOR,2004.0,1,0,1
TZA,SYR,2010.0,1,0,1
UKR,NZL,2001.0,1,0,1
NOR,CZE,2003.0,2,0,2
HKG,ITA,2004.0,1,0,1
GTM,CHE,2001.0,1,0,1
NLD,EGY,2001.0,1,0,1
CRI,OMN,2008.0,1,0,1
GBR,RWA,2009.0,1,0,1
GIN,ITA,2009.0,1,0,1
GRC,TWN,2012.0,2,0,2
ISL,CHE,2012.0,2,0,2
HRV,SGP,2014.0,1,0,1
ZAF,MYS,2003.0,1,0,1
IRQ,DEU,2008.0,2,0,2
SVN,LTU,2014.0,1,0,1
CHL,VNM,2021.0,1,0,1
MNG,GBR,2020.0,1,0,1
BGD,PHL,2019.0,1,0,1
NGA,TTO,2020.0,2,0,2
NZL,IDN,2004.0,1,0,1
DEU,TUN,2009.0,2,0,2
BFA,KOR,2020.0,1,0,1
ITA,MNE,2018.0,2,0,2
CHN,NAM,2021.0,1,0,1
MOZ,MDG,2020.0,1,0,1
CMR,CAF,2021.0,1,0,1
MWI,RWA,2009.0,1,0,1
JAM,NZL,2005.0,1,0,1
BRA,SUR,2013.0,1,0,1
COL,ITA,2003.0,2,0,2
IRQ,CAN,2005.0,1,0,1
THA,QAT,2018.0,1,0,1
ROU,HKG,2009.0,1,0,1
PHL,GEO,2021.0,1,0,1
MEX,NPL,2022.0,1,0,1
BEL,BDI,2019.0,1,0,1
BGR,MEX,2014.0,1,0,1
NLD,BOL,2017.0,2,0,2
POL,ETH,2015.0,1,0,1
PAK,CMR,2022.0,1,0,1
PRT,GNB,2022.0,1,0,1
LBY,ARE,2012.0,1,0,1
GEO,PHL,2018.0,1,0,1
NGA,SOM,2020.0,1,0,1
ALB,,2001.0,2,0,2
BRA,GHA,2020.0,1,0,1
SDN,NGA,2015.0,1,0,1
ZWE,RWA,2008.0,1,0,1
CZE,PRI,2010.0,1,0,1
FJI,BRA,2018.0,2,0,2
MLT,TUN,2010.0,1,0,1
THA,SAU,2013.0,1,0,1
EST,NZL,2014.0,1,0,1
ARG,RUS,2005.0,2,0,2
SRB,HRV,2022.0,1,0,1
THA,AFG,2020.0,1,0,1
LBN,QAT,2011.0,1,0,1
MAR,EGY,2017.0,2,0,2
CUB,JPN,2020.0,1,0,1
UGA,AUS,2012.0,1,0,1
BGD,POL,2020.0,1,0,1
BRA,TUN,2019.0,1,0,1
MDA,GBR,2011.0,1,0,1
MYS,NPL,2021.0,1,0,1
MYS,HUN,2020.0,1,0,1
EST,TWN,2018.0,1,0,1
OMN,BEL,2019.0,1,0,1
SMR,ITA,2010.0,2,0,2
PSE,,2025.0,1,0,1
PER,ZAF,2014.0,1,0,1
USA,BIH,2002.0,2,0,2
SAU,ETH,2012.0,1,0,1
KOR,MKD,2018.0,1,0,1
THA,IND,2005.0,1,0,1
NLD,AFG,2006.0,1,0,1
LAO,NLD,2014.0,1,0,1
GBR,PNG,2016.0,1,0,1
IRL,TUR,2000.0,1,0,1
ISR,AUS,2000.0,1,0,1
BLR,USA,1997.0,1,0,1
BEL,ZWE,2014.0,1,0,1
ETH,MWI,2001.0,1,0,1
MEX,ISR,1997.0,1,0,1
BEL,ZAF,1999.0,1,0,1
ETH,ITA,2009.0,1,0,1
BEN,GHA,2012.0,1,0,1
ISR,VNM,2018.0,1,0,1
MOZ,FRA,2022.0,1,0,1
CAN,TZA,2002.0,1,0,1
FIN,IRL,2004.0,1,0,1
MEX,ZAF,2021.0,1,0,1
IRN,SYR,2010.0,1,0,1
PRT,KAZ,2017.0,1,0,1
GRC,ZAF,2015.0,1,0,1
PHL,HKG,2015.0,1,0,1
CHE,NAM,2012.0,1,0,1
IDN,LBY,2022.0,1,0,1
,GBR,2020.0,3,0,3
IND,NAM,2016.0,2,0,2
EGY,THA,2013.0,1,0,1
MEX,NIC,2020.0,2,0,2
ISL,FIN,2014.0,1,0,1
GUY,CUB,2018.0,3,0,3
COG,CMR,2020.0,1,0,1
SOM,NOR,2020.0,1,0,1
EGY,BDI,2022.0,1,0,1
KWT,LKA,2018.0,1,0,1
NGA,QAT,2018.0,1,0,1
THA,IDN,2000.0,1,0,1
GMB,ESP,2018.0,1,0,1
LBY,,2000.0,1,0,1
USA,NCL,2018.0,3,0,3
ITA,DOM,2014.0,1,0,1
BRA,NIC,2017.0,1,0,1
PAK,BGR,2009.0,1,0,1
HUN,TTO,2010.0,1,0,1
SWE,GHA,2019.0,1,0,1
NGA,URY,2013.0,2,0,2
LUX,USA,2006.0,1,0,1
ITA,KAZ,2012.0,1,0,1
SWE,PHL,2014.0,1,0,1
TWN,BRN,2006.0,1,0,1
LKA,IND,2004.0,1,0,1
CAN,TZA,2005.0,2,0,2
ETH,ZWE,2012.0,1,0,1
SWE,IRN,2000.0,1,0,1
ETH,RWA,2013.0,1,0,1
BEN,BFA,2001.0,1,0,1
PSE,ARE,2012.0,1,0,1
VEN,GRC,2012.0,1,0,1
LVA,HKG,1999.0,1,0,1
BHR,OMN,2012.0,1,0,1
,GNB,1996.0,1,0,1
VNM,CHE,2013.0,1,0,1
SWE,URY,2018.0,1,0,1
NOR,ZWE,2018.0,1,0,1
HRV,ARE,2008.0,1,0,1
GBR,FJI,2006.0,1,0,1
,MHL,2003.0,1,0,1
NGA,MOZ,2011.0,1,0,1
SVN,LBN,2018.0,1,0,1
CHN,RWA,2013.0,1,0,1
BFA,USA,2016.0,1,0,1
PRT,HRV,2013.0,1,0,1
ETH,SDN,2020.0,1,0,1
TUR,IDN,2019.0,3,0,3
NOR,MMR,2018.0,1,0,1
CZE,IND,2023.0,1,0,1
BEL,CMR,2004.0,2,0,2
HND,NIC,2001.0,1,0,1
FJI,EST,2018.0,1,0,1
FLK,AUS,2013.0,1,0,1
GRC,THA,2008.0,1,0,1
FRA,RWA,2012.0,1,0,1
PNG,GBR,2009.0,1,0,1
ITA,MYS,2008.0,1,0,1
CHE,LKA,2013.0,1,0,1
USA,BEN,2006.0,1,0,1
KOR,FJI,2019.0,1,0,1
GHA,THA,2022.0,1,0,1
TWN,NZL,2022.0,1,0,1
HUN,FIN,1998.0,1,0,1
BGD,FRA,2022.0,1,0,1
ARG,IRL,2007.0,1,0,1
POL,PAN,1997.0,1,0,1
GRL,NOR,2019.0,1,0,1
FRA,GHA,2013.0,1,0,1
JPN,YEM,2011.0,1,0,1
THA,GRC,2013.0,1,0,1
USA,KAZ,2000.0,1,0,1
NZL,CZE,2016.0,1,0,1
BRA,HRV,2022.0,1,0,1
HUN,DZA,2020.0,2,0,2
NZL,OMN,2019.0,1,0,1
MAR,CIV,2016.0,1,0,1
MDA,CZE,2021.0,1,0,1
DEU,CHE,2001.0,281,214,67
AUS,NLD,2022.0,37,28,9
GBR,DEU,2001.0,290,290,0
DEU,GBR,2016.0,678,571,107
FRA,AUT,2011.0,31,26,5
NLD,AUS,2010.0,54,35,19
BRA,FRA,2011.0,85,88,-3
FRA,CAN,2002.0,216,144,72
CAN,USA,2016.0,1919,1363,556
DEU,AUS,2005.0,102,78,24
USA,TWN,2013.0,298,265,33
GRC,GBR,2014.0,226,123,103
PSE,EGY,2011.0,5,4,1
ESP,USA,2019.0,444,368,76
USA,CHE,2017.0,532,567,-35
AUS,USA,2018.0,655,581,74
USA,NOR,2007.0,66,30,36
FRA,BEL,2017.0,190,208,-18
USA,CHE,2010.0,437,407,30
DEU,CHN,2008.0,134,137,-3
TUR,USA,2008.0,183,197,-14
DEU,USA,2004.0,1076,963,113
RUS,USA,2005.0,238,133,105
ITA,BEL,2008.0,43,46,-3
USA,PAN,2007.0,12,8,4
CHN,USA,2007.0,1196,829,367
ESP,USA,2017.0,529,352,177
FRA,DEU,2012.0,322,290,32
ESP,CHE,2011.0,82,43,39
SGP,KOR,2013.0,19,26,-7
GRC,DEU,2018.0,78,35,43
FRA,SVK,2015.0,3,4,-1
ZAF,NZL,2003.0,9,5,4
GBR,PAK,2009.0,34,23,11
CAN,TWN,2012.0,12,18,-6
AUS,GBR,2020.0,477,528,-51
CHL,NZL,2008.0,1,1,0
ARG,ESP,2005.0,76,41,35
AUS,THA,2016.0,37,20,17
THA,CAN,2010.0,16,17,-1
FRA,CHN,2004.0,41,22,19
USA,CHE,2019.0,533,520,13
USA,ESP,2011.0,400,465,-65
AUT,FRA,2011.0,26,31,-5
IND,TWN,2011.0,47,38,9
USA,KOR,2018.0,759,725,34
ARG,ESP,2002.0,52,53,-1
GBR,TUR,2006.0,28,20,8
FIN,ITA,2009.0,11,12,-1
ARG,BRA,2002.0,21,25,-4
DNK,DEU,2018.0,109,139,-30
ITA,AUT,2018.0,78,49,29
ESP,ARE,2019.0,12,2,10
GBR,BEL,2002.0,59,62,-3
ESP,COL,2004.0,20,9,11
CUB,MEX,2006.0,8,11,-3
FRA,CAN,2005.0,217,127,90
CHN,NLD,2009.0,35,31,4
HUN,ISR,2010.0,2,1,1
KOR,GBR,2009.0,33,27,6
ESP,USA,2010.0,361,372,-11
COL,USA,2009.0,38,48,-10
CYP,TUR,2013.0,5,31,-26
CHL,FRA,2003.0,10,13,-3
GBR,JPN,2015.0,124,112,12
TUR,JPN,2004.0,13,9,4
USA,GBR,1998.0,287,289,-2
COL,MEX,2012.0,17,18,-1
SGP,CAN,2014.0,31,15,16
CAN,IRN,2014.0,59,259,-200
IRN,CAN,2015.0,273,62,211
ITA,GBR,2004.0,196,142,54
CAN,ARE,2001.0,5,4,1
NLD,FIN,2016.0,12,19,-7
POL,USA,2011.0,81,261,-180
SRB,DEU,2009.0,10,14,-4
ESP,SWE,2010.0,31,30,1
CHN,DEU,2003.0,126,70,56
CAN,JOR,2004.0,3,6,-3
RUS,ESP,2007.0,9,8,1
ZWE,RWA,2013.0,1,2,-1
JPN,VNM,2008.0,15,2,13
FRA,THA,2019.0,12,10,2
NLD,CHN,2016.0,115,107,8
SWE,NLD,2014.0,35,53,-18
NOR,FIN,2017.0,13,17,-4
POL,BRA,2013.0,14,13,1
BHR,USA,2020.0,3,6,-3
IRN,AUS,2020.0,178,29,149
FRA,CHE,2021.0,229,173,56
FRA,DZA,2015.0,89,30,59
IRL,DEU,2014.0,46,29,17
RUS,TUR,2014.0,3,3,0
IRL,GBR,2015.0,257,211,46
BRA,GBR,2018.0,128,102,26
AUS,CAN,2016.0,134,178,-44
USA,MEX,2022.0,61,103,-42
DEU,PAK,2004.0,4,4,0
POL,AUT,2012.0,15,18,-3
NLD,NZL,2012.0,14,5,9
DEU,KOR,2007.0,29,18,11
SGP,CHN,2021.0,395,220,175
CZE,HUN,2016.0,1,7,-6
JPN,ITA,2016.0,20,25,-5
PAK,CAN,2006.0,6,8,-2
ECU,USA,2018.0,26,29,-3
CAN,CHN,2007.0,133,122,11
ESP,SGP,2017.0,6,8,-2
AUT,AUS,2020.0,21,13,8
USA,ISR,2022.0,141,116,25
GBR,BEL,2005.0,62,54,8
MYS,CHN,2017.0,40,10,30
IRL,NLD,2015.0,15,13,2
CHN,DNK,2018.0,56,45,11
NLD,DNK,2002.0,21,23,-2
BRA,PRT,2013.0,66,82,-16
BEL,DEU,1997.0,8,6,2
SWE,JPN,2019.0,26,26,0
KAZ,RUS,2012.0,7,15,-8
CHE,DEU,2020.0,408,629,-221
JOR,CAN,2016.0,12,10,2
TWN,USA,2001.0,106,172,-66
DEU,FIN,2021.0,37,39,-2
AUT,IND,2019.0,5,16,-11
ZAF,CAN,2022.0,14,9,5
MAR,CAN,2003.0,6,5,1
DNK,ESP,2015.0,10,48,-38
CHN,TWN,2013.0,62,102,-40
NZL,DEU,2020.0,26,24,2
VEN,COL,2016.0,35,7,28
ESP,SWE,2017.0,103,41,62
FRA,KOR,2011.0,25,19,6
BRA,CRI,2014.0,3,1,2
CAN,CRI,2020.0,5,4,1
THA,VNM,2018.0,21,8,13
FRA,BEL,2010.0,174,155,19
THA,DEU,2020.0,13,17,-4
ZAF,HKG,2022.0,1,1,0
NOR,DEU,2020.0,46,66,-20
DEU,ISR,2018.0,57,45,12
DEU,LUX,2018.0,35,24,11
IND,THA,2020.0,22,5,17
IRL,DNK,2014.0,9,1,8
SAU,KOR,2015.0,6,16,-10
PAK,SAU,2022.0,29,26,3
KWT,GBR,2021.0,5,12,-7
FIN,PRT,2018.0,2,6,-4
DEU,JOR,2016.0,14,11,3
JPN,BRA,2013.0,15,5,10
CUB,ARG,2017.0,3,3,0
HUN,FRA,2016.0,16,15,1
DEU,AUS,2002.0,89,65,24
TTO,CAN,2014.0,1,3,-2
FRA,CZE,2019.0,18,30,-12
HUN,AUT,2009.0,15,13,2
CZE,CHN,2020.0,12,16,-4
IRL,PAK,2019.0,6,9,-3
ESP,MEX,2022.0,31,28,3
ARE,NOR,2021.0,3,1,2
FRA,SWE,2008.0,39,48,-9
HKG,JPN,2016.0,17,9,8
LUX,ITA,2019.0,8,10,-2
KOR,HKG,2018.0,13,12,1
KGZ,TUR,2018.0,4,2,2
ISR,BRA,2012.0,6,2,4
DEU,TUR,2018.0,37,84,-47
FRA,MAR,2018.0,87,40,47
NLD,PRT,2018.0,20,26,-6
LBN,FRA,2021.0,48,46,2
FIN,CAN,2008.0,15,14,1
ISR,DEU,2022.0,26,26,0
AUT,NLD,2016.0,18,22,-4
BGD,IND,2011.0,8,7,1
ITA,NLD,2022.0,55,36,19
RUS,USA,2002.0,386,188,198
BRA,DEU,2004.0,36,38,-2
KOR,PAK,2022.0,25,25,0
HKG,AUS,2001.0,12,31,-19
ROU,BEL,2007.0,6,6,0
TUN,MAR,2018.0,7,2,5
GAB,FRA,2019.0,4,15,-11
BGD,USA,2011.0,29,16,13
CHE,DNK,2014.0,31,29,2
BRA,CHN,2021.0,13,2,11
TWN,BEL,2020.0,3,3,0
BEL,GBR,2015.0,117,98,19
BEL,VNM,2021.0,12,2,10
CHL,BRA,2020.0,15,40,-25
LBY,EGY,2018.0,3,2,1
USA,KEN,2014.0,47,48,-1
RUS,KAZ,2015.0,18,15,3
PAK,IRL,2021.0,10,2,8
IND,USA,2020.0,1324,723,601
GBR,IND,2008.0,97,140,-43
USA,IRN,2014.0,101,433,-332
USA,SGP,1999.0,32,19,13
NLD,AUS,2019.0,78,80,-2
DEU,FRA,1999.0,111,102,9
ITA,ESP,2012.0,171,116,55
ESP,IRL,2004.0,3,6,-3
SGP,NOR,2011.0,3,3,0
BOL,ESP,2012.0,3,1,2
GBR,ROU,2018.0,17,12,5
NOR,FIN,2019.0,17,25,-8
GBR,SWE,2008.0,90,119,-29
FRA,THA,2010.0,18,8,10
SWE,ISL,2012.0,9,11,-2
GHA,CAN,2009.0,3,2,1
DZA,FRA,2006.0,20,35,-15
THA,SGP,2009.0,5,2,3
GBR,MAC,2016.0,4,1,3
FRA,CZE,2017.0,29,21,8
DEU,DNK,2004.0,38,47,-9
DNK,TUR,2013.0,2,2,0
RUS,CAN,2018.0,19,18,1
GHA,NLD,2015.0,2,2,0
AUS,RUS,2017.0,9,7,2
USA,BRA,2001.0,167,173,-6
NOR,CHN,2012.0,9,26,-17
NOR,POL,2017.0,4,8,-4
ZAF,KEN,2014.0,20,12,8
SAU,IND,2022.0,23,21,2
NOR,JPN,2012.0,4,4,0
SWE,FIN,2004.0,29,30,-1
DNK,CAN,2016.0,31,25,6
NLD,ESP,2001.0,27,24,3
FRA,ISR,2007.0,13,21,-8
FRA,MDG,2007.0,11,7,4
NLD,SWE,2011.0,47,38,9
BEL,ETH,2011.0,4,2,2
FIN,IND,2014.0,3,15,-12
POL,CHE,1999.0,13,8,5
FRA,BEL,2019.0,195,184,11
SAU,PAK,2011.0,16,31,-15
FRA,THA,2017.0,17,19,-2
USA,TUR,1997.0,12,4,8
CHE,FRA,2006.0,157,235,-78
NOR,NZL,2016.0,5,3,2
IRN,IRL,2013.0,8,1,7
JPN,NZL,2020.0,9,10,-1
USA,PRI,2005.0,35,47,-12
BEL,KEN,2019.0,2,1,1
JPN,EGY,2014.0,51,12,39
UKR,USA,2000.0,43,7,36
CHN,KOR,2002.0,18,16,2
AZE,RUS,2015.0,2,3,-1
IND,ESP,2017.0,20,17,3
JPN,HKG,2013.0,21,10,11
SWE,JPN,2017.0,31,23,8
TWN,JPN,2013.0,25,28,-3
ESP,GRC,2011.0,13,15,-2
AUT,THA,2020.0,5,1,4
CAN,PAN,2020.0,1,2,-1
CUB,ARG,2019.0,5,1,4
AUS,FRA,2000.0,8,6,2
ESP,URY,2015.0,11,5,6
IND,ESP,2019.0,19,21,-2
CHE,HRV,2019.0,2,4,-2
KOR,NOR,2012.0,3,2,1
NLD,POL,2018.0,19,14,5
MEX,FRA,2020.0,44,29,15
FRA,SEN,2020.0,28,23,5
POL,NLD,2003.0,13,8,5
MEX,CHN,2021.0,7,7,0
USA,BLR,2001.0,5,10,-5
AUS,RUS,2019.0,8,11,-3
NOR,ETH,2021.0,4,3,1
GBR,NOR,2022.0,47,20,27
TWN,AUT,2017.0,1,1,0
NZL,IND,2020.0,11,33,-22
VNM,FRA,2022.0,8,15,-7
BRA,RUS,2012.0,1,2,-1
NZL,GBR,2007.0,101,132,-31
BEN,USA,2021.0,3,1,2
AUT,IDN,2021.0,4,1,3
SGP,IND,2021.0,53,53,0
FRA,AUS,2004.0,31,31,0
ITA,CHN,2001.0,9,10,-1
PRT,BEL,2017.0,17,12,5
KOR,SGP,2020.0,26,34,-8
GBR,BGD,2021.0,18,15,3
ZAF,CMR,2020.0,10,5,5
AUS,IDN,2011.0,34,9,25
UKR,SWE,2014.0,10,2,8
ISR,NLD,2005.0,9,8,1
TUR,AUT,2013.0,8,4,4
AUS,GRC,2013.0,5,19,-14
USA,GRC,2009.0,109,97,12
SWZ,ZAF,2021.0,3,5,-2
POL,FIN,2013.0,5,2,3
CZE,SVK,2007.0,17,27,-10
BEL,ROU,2015.0,6,9,-3
BLR,RUS,2007.0,10,9,1
LBY,CAN,2013.0,3,1,2
CHE,GRC,2013.0,11,32,-21
AUS,NOR,2013.0,22,9,13
GBR,SAU,2009.0,36,16,20
PHL,GBR,2012.0,3,2,1
ITA,SWE,2001.0,15,24,-9
CUB,ESP,2008.0,28,19,9
UKR,RUS,2022.0,11,22,-11
AUS,ZAF,2010.0,13,31,-18
CAN,JPN,2009.0,80,79,1
TUR,AUS,2020.0,13,7,6
LTU,DEU,2003.0,4,5,-1
EST,FIN,2003.0,5,12,-7
GBR,IDN,2009.0,11,3,8
DEU,BGR,2012.0,9,13,-4
LTU,DNK,2016.0,4,4,0
NLD,CHE,2002.0,29,32,-3
CUB,USA,1998.0,2,1,1
USA,ARG,2001.0,53,113,-60
PHL,AUS,2014.0,11,6,5
ESP,CUB,2003.0,12,24,-12
DEU,NGA,2001.0,6,6,0
IND,ITA,1999.0,7,5,2
BGR,GBR,2002.0,6,6,0
DEU,BEL,2005.0,47,43,4
LIE,DEU,2011.0,4,3,1
PRT,USA,2006.0,34,46,-12
IND,CHE,2006.0,17,19,-2
USA,RUS,2000.0,49,220,-171
USA,PRI,2002.0,33,42,-9
NLD,CHE,2005.0,43,37,6
GRC,SWE,2006.0,2,3,-1
NLD,DNK,2005.0,12,3,9
USA,ARE,2000.0,7,1,6
ZAF,USA,2004.0,68,50,18
PRT,ARG,2017.0,3,1,2
TUN,CAN,2002.0,1,5,-4
BEL,MEX,2022.0,2,1,1
SWE,MEX,2009.0,4,3,1
ZWE,FRA,2007.0,1,1,0
FRA,ROU,2001.0,12,17,-5
BRA,CAN,1999.0,10,13,-3
FRA,ITA,1999.0,66,87,-21
JPN,POL,2008.0,8,7,1
DNK,AUT,2013.0,6,10,-4
GBR,OMN,2006.0,9,6,3
SWE,ISR,2002.0,2,4,-2
SWE,IND,2000.0,1,5,-4
CHL,BEL,2020.0,11,9,2
GBR,EGY,2013.0,47,26,21
DNK,KOR,2002.0,2,2,0
IRN,KWT,2014.0,1,1,0
ESP,DNK,2014.0,32,14,18
HUN,RUS,2016.0,2,1,1
CZE,RUS,2001.0,8,7,1
RUS,CZE,2009.0,6,7,-1
USA,GTM,2009.0,5,2,3
RUS,ZAF,2003.0,7,1,6
ARG,VEN,2015.0,3,2,1
USA,MYS,2011.0,36,17,19
LBN,DEU,2003.0,2,1,1
ITA,UKR,2001.0,3,2,1
CAN,ZAF,2016.0,19,26,-7
CHE,POL,2001.0,12,8,4
PRI,USA,1999.0,13,16,-3
BEL,TUR,2002.0,2,2,0
BGR,JPN,2007.0,2,9,-7
GBR,SDN,2018.0,2,3,-1
GBR,CZE,2008.0,26,27,-1
RUS,SGP,2010.0,5,1,4
NLD,ZAF,2012.0,19,17,2
UKR,FRA,2011.0,12,12,0
GBR,BRA,1999.0,18,11,7
ESP,AUS,2003.0,14,10,4
GBR,HKG,2008.0,35,39,-4
CHE,IRL,2011.0,6,7,-1
KOR,NGA,2015.0,1,2,-1
AUS,PNG,2008.0,2,2,0
DNK,MEX,1999.0,3,1,2
SWE,CAN,2003.0,28,29,-1
AUS,ZAF,2019.0,19,44,-25
ARG,CAN,1998.0,4,1,3
USA,SVN,2012.0,13,8,5
IDN,MYS,2011.0,12,15,-3
SVK,PAK,2019.0,2,1,1
TUR,FIN,2007.0,8,2,6
CHL,COL,2016.0,21,18,3
BGR,GBR,2005.0,7,3,4
CHE,CZE,2008.0,7,8,-1
NOR,SGP,2015.0,3,3,0
USA,MAC,2011.0,6,2,4
MAC,TWN,2012.0,1,3,-2
GBR,NGA,2008.0,13,14,-1
AUT,ESP,2012.0,20,18,2
ISL,GBR,2011.0,7,6,1
CAN,GRC,2008.0,8,10,-2
FRA,CZE,2010.0,21,17,4
GAB,FRA,2017.0,5,5,0
AUS,FJI,2019.0,4,8,-4
SWE,POL,2014.0,12,29,-17
ROU,FRA,2016.0,27,25,2
CZE,GBR,2013.0,25,27,-2
THA,CHE,2011.0,3,3,0
GBR,MLT,2018.0,17,17,0
GTM,DEU,2018.0,1,1,0
USA,JAM,2011.0,3,3,0
RWA,KEN,2018.0,3,7,-4
TWN,CAN,2017.0,12,9,3
FRA,GAB,2014.0,8,3,5
ESP,EST,2013.0,3,1,2
DEU,LVA,2011.0,4,2,2
FIN,FRA,2016.0,22,32,-10
CHE,BRA,2016.0,15,23,-8
FIN,BEL,2016.0,7,8,-1
ZAF,DEU,2016.0,23,27,-4
FIN,BRA,2011.0,2,3,-1
IRN,AZE,2014.0,1,2,-1
CHE,TZA,2021.0,6,5,1
NOR,POL,2019.0,5,11,-6
IDN,TWN,2018.0,17,37,-20
GBR,LBY,2013.0,7,1,6
USA,MAR,2017.0,8,4,4
NLD,BRA,2015.0,20,41,-21
BRA,ZAF,2021.0,6,3,3
GRC,ESP,2021.0,8,10,-2
PRT,BEL,2019.0,16,7,9
ECU,DEU,2017.0,4,5,-1
USA,MAR,2019.0,8,12,-4
IND,PHL,2016.0,5,10,-5
FIN,UKR,2007.0,1,1,0
POL,SAU,2016.0,4,2,2
SWE,AUS,1998.0,4,4,0
POL,IRN,2015.0,4,2,2
MLI,KEN,2014.0,1,1,0
PSE,USA,2017.0,2,5,-3
AUS,MAC,2010.0,1,1,0
MYS,LBY,2020.0,10,4,6
HKG,EGY,2022.0,2,2,0
ECU,DEU,2019.0,8,7,1
MAC,SGP,2018.0,3,2,1
FRA,NZL,2005.0,5,6,-1
AUT,IND,2017.0,6,13,-7
ZAF,UGA,2020.0,10,3,7
DZA,MAR,2018.0,5,6,-1
GHA,IRL,2019.0,1,2,-1
DEU,GEO,2002.0,3,1,2
SVN,RUS,2016.0,3,1,2
EGY,SDN,2019.0,1,2,-1
USA,BGR,2013.0,10,6,4
ITA,MEX,2009.0,9,6,3
ARE,SAU,2016.0,13,33,-20
CHE,NLD,2006.0,33,50,-17
NLD,IRL,2008.0,11,5,6
CHN,RUS,2006.0,12,5,7
IND,ARE,2009.0,15,3,12
TUR,ROU,2005.0,2,1,1
BGR,FRA,2003.0,5,12,-7
USA,TUR,1998.0,25,20,5
URY,FRA,2000.0,1,1,0
FRA,NZL,2002.0,4,7,-3
KEN,USA,2012.0,32,34,-2
FIN,CHE,2014.0,11,11,0
NLD,HUN,2015.0,7,8,-1
MYS,NLD,2016.0,7,8,-1
NOR,ISR,2011.0,2,1,1
USA,POL,2022.0,34,47,-13
CHN,KOR,2005.0,41,42,-1
BEL,KEN,2010.0,3,3,0
BEL,AUS,2006.0,8,7,1
USA,KHM,2017.0,8,8,0
MWI,IRL,2019.0,1,1,0
CHN,GHA,2019.0,24,19,5
ESP,AUT,2020.0,24,20,4
MOZ,BRA,2014.0,3,3,0
ZAF,ITA,2022.0,4,3,1
IND,BGD,2022.0,8,11,-3
VNM,CHN,2020.0,8,30,-22
THA,PHL,2021.0,4,5,-1
ESP,BRA,2008.0,33,45,-12
CMR,GBR,2009.0,3,3,0
LUX,AUS,2015.0,1,1,0
CHN,GHA,2017.0,13,15,-2
AUS,RUS,2010.0,1,9,-8
PRT,JPN,2008.0,1,2,-1
SRB,NOR,2012.0,1,1,0
AUT,IRL,2009.0,5,4,1
CAN,CMR,2012.0,1,4,-3
ISR,NZL,2018.0,3,4,-1
SRB,FRA,2016.0,1,3,-2
HKG,IRL,2021.0,6,2,4
PER,FRA,2019.0,6,4,2
AUS,ECU,2019.0,4,1,3
CRI,USA,2006.0,10,9,1
CHE,THA,2022.0,4,3,1
BEL,NOR,2007.0,4,4,0
CAN,BGD,2014.0,12,27,-15
SWE,JPN,2010.0,24,31,-7
POL,ARE,2017.0,1,1,0
ROU,PRT,2010.0,2,3,-1
AUS,FJI,2017.0,8,7,1
DEU,IRN,2009.0,21,28,-7
NLD,JPN,2004.0,16,14,2
MDG,FRA,2020.0,6,9,-3
KOR,TWN,2021.0,10,14,-4
GBR,UGA,2015.0,7,31,-24
CHE,VNM,2016.0,4,2,2
SRB,RUS,2004.0,3,6,-3
SAU,SWE,2008.0,1,4,-3
PRT,ITA,2012.0,7,30,-23
PRT,BEL,2010.0,4,8,-4
TTO,GBR,2007.0,4,4,0
CHE,NOR,2003.0,9,6,3
NOR,ESP,2004.0,4,7,-3
COL,VEN,2011.0,7,11,-4
IRL,FIN,2011.0,2,2,0
NLD,EGY,2003.0,3,1,2
FIN,GBR,2000.0,24,12,12
SWE,KOR,2012.0,13,11,2
HKG,IND,2003.0,4,3,1
IRL,KOR,2021.0,1,2,-1
BEL,DEU,1998.0,6,12,-6
NZL,NLD,1999.0,2,2,0
ARG,BRA,2005.0,10,14,-4
MYS,IND,2004.0,8,9,-1
EGY,AUT,2018.0,2,5,-3
IND,OMN,2009.0,11,3,8
CAN,THA,2001.0,4,6,-2
URY,ARG,2008.0,3,1,2
SMR,ITA,2018.0,3,3,0
LVA,FRA,2013.0,1,1,0
EGY,ESP,2013.0,1,5,-4
KOR,RUS,2009.0,7,12,-5
AUS,BGR,1999.0,1,1,0
CHL,URY,2005.0,1,1,0
LKA,JPN,2011.0,2,11,-9
GBR,ISL,2016.0,6,5,1
UKR,MEX,2007.0,1,2,-1
CHE,PRT,2008.0,6,10,-4
VEN,ARG,2008.0,1,3,-2
NLD,TWN,2020.0,11,4,7
POL,TWN,2013.0,3,2,1
TUR,RUS,2013.0,2,3,-1
IDN,KOR,2012.0,2,13,-11
LUX,AUT,2012.0,1,3,-2
SAU,IDN,2015.0,3,2,1
ESP,KOR,2015.0,7,1,6
DNK,IRL,2017.0,8,7,1
ROU,AUT,2017.0,5,5,0
GBR,BGR,2012.0,6,6,0
IND,IRN,2018.0,13,6,7
GBR,SVK,2012.0,2,9,-7
RUS,PRT,2016.0,4,7,-3
FRA,RUS,2008.0,19,47,-28
EGY,KOR,2020.0,3,10,-7
GAB,COG,2019.0,1,2,-1
TUR,ITA,2006.0,2,6,-4
LUX,ITA,2017.0,4,13,-9
NPL,THA,2016.0,3,5,-2
DEU,TZA,2013.0,2,3,-1
USA,NCL,2019.0,1,2,-1
NLD,IRN,2022.0,5,16,-11
DNK,ISL,2016.0,5,5,0
TWN,KOR,2022.0,10,2,8
POL,CAN,2018.0,12,11,1
MAR,GBR,2022.0,1,2,-1
FRA,PAK,2008.0,1,1,0
CHE,FIN,2007.0,5,10,-5
ALB,ITA,2001.0,1,1,0
JPN,ESP,2003.0,2,6,-4
IRL,NGA,2010.0,2,1,1
BEL,TUN,2020.0,3,9,-6
SVN,ITA,2015.0,3,8,-5
RUS,JOR,2012.0,1,1,0
IRN,NOR,2013.0,15,5,10
NGA,AUS,2008.0,1,1,0
URY,MEX,2019.0,3,3,0
IRQ,MYS,2021.0,15,72,-57
PYF,FRA,2012.0,5,11,-6
ETH,GBR,2014.0,4,3,1
USA,GHA,2015.0,27,16,11
GBR,EST,2016.0,3,10,-7
MAC,NLD,2013.0,1,1,0
SVK,USA,2018.0,6,12,-6
UKR,CZE,2006.0,5,2,3
AUT,LVA,2007.0,1,1,0
RUS,ROU,2009.0,2,2,0
BRN,IND,2009.0,1,2,-1
ESP,SGP,2010.0,4,1,3
IND,SWE,1999.0,2,1,1
CHE,NZL,2002.0,6,3,3
NZL,MEX,2003.0,3,2,1
GAB,USA,2019.0,4,4,0
FIN,CHL,2014.0,3,1,2
CZE,NLD,2006.0,2,3,-1
CMR,ITA,2009.0,1,1,0
PER,ESP,2011.0,9,12,-3
TWN,MAC,2020.0,5,2,3
IDN,FIN,2017.0,1,3,-2
NLD,COL,2021.0,10,14,-4
AUS,ECU,2017.0,5,2,3
RUS,SGP,2017.0,2,5,-3
SRB,SWE,2020.0,6,2,4
CHN,ITA,2006.0,10,13,-3
ITA,SGP,2021.0,7,4,3
PAK,SGP,2017.0,3,4,-1
RUS,BGR,2008.0,5,1,4
GTM,USA,2021.0,5,5,0
THA,CAN,2017.0,11,11,0
THA,CAN,2019.0,5,13,-8
NLD,UKR,2013.0,3,5,-2
FIN,CHN,1999.0,1,6,-5
USA,AZE,2012.0,2,1,1
ETH,KEN,2011.0,1,5,-4
IRN,ESP,2008.0,1,2,-1
POL,ROU,2015.0,3,3,0
ETH,IRN,2018.0,4,2,2
ARE,CHE,2021.0,2,1,1
BIH,USA,2021.0,2,2,0
ECU,AUS,2020.0,1,4,-3
BRA,CUB,2006.0,5,5,0
SVK,BEL,2010.0,4,3,1
USA,DZA,2013.0,1,1,0
CHE,ZWE,2003.0,2,1,1
NOR,POL,2010.0,6,8,-2
NZL,POL,2012.0,7,1,6
PRI,DEU,2008.0,1,2,-1
RWA,BEL,2009.0,2,1,1
DEU,EGY,2001.0,9,9,0
BHR,EGY,2019.0,3,2,1
PAK,TZA,2022.0,6,2,4
GRC,RUS,2012.0,1,1,0
BIH,HRV,2004.0,4,9,-5
NZL,ESP,2009.0,3,3,0
NOR,BRA,2005.0,1,1,0
ARG,ITA,1998.0,2,2,0
BIH,SRB,2009.0,8,7,1
MLT,ITA,2020.0,3,2,1
JPN,UKR,2009.0,2,4,-2
QAT,CHE,2021.0,1,3,-2
LBN,SAU,2005.0,1,1,0
USA,BHR,2004.0,1,1,0
SWE,AUS,1997.0,1,2,-1
EGY,CAN,2004.0,12,11,1
DNK,JPN,2012.0,3,8,-5
HUN,CAN,2003.0,5,2,3
CHE,MNG,2017.0,1,1,0
MAR,BEL,2003.0,3,8,-5
MEX,MAR,2019.0,2,3,-1
FIN,KOR,2017.0,3,9,-6
ECU,GBR,2013.0,2,3,-1
ISR,SWE,2013.0,2,4,-2
PNG,AUS,2000.0,4,2,2
HRV,RUS,2008.0,1,1,0
SVK,CZE,2001.0,9,17,-8
IRL,ARE,2021.0,3,3,0
TWN,AUS,2007.0,4,11,-7
CRI,ESP,2013.0,2,8,-6
NGA,CHE,2013.0,1,3,-2
PER,FRA,2010.0,4,6,-2
FIN,SGP,2011.0,4,1,3
SGP,IRN,2013.0,4,18,-14
IRQ,DEU,2013.0,3,2,1
UKR,ITA,2014.0,3,4,-1
SAU,KAZ,2014.0,2,1,1
NLD,RUS,2022.0,10,12,-2
IRQ,AUS,2011.0,3,2,1
MLI,FRA,1998.0,1,1,0
BHR,EGY,2017.0,3,2,1
IRL,EGY,2016.0,1,1,0
SWE,ZAF,2018.0,10,16,-6
KEN,ESP,2020.0,4,1,3
AGO,BRA,2017.0,1,1,0
IRL,PAK,2017.0,4,3,1
THA,FRA,2020.0,9,15,-6
FIN,EST,2007.0,3,8,-5
COL,POL,2020.0,1,2,-1
KEN,RWA,2021.0,3,2,1
TUN,CAN,2005.0,2,4,-2
NLD,GRC,2015.0,8,26,-18
GRC,DNK,2005.0,6,1,5
FRA,PER,2012.0,7,5,2
SVK,RUS,2001.0,2,3,-1
KEN,IDN,2006.0,1,1,0
BEL,BFA,2020.0,5,4,1
GRC,POL,2020.0,5,4,1
IRQ,CHN,2021.0,3,10,-7
AUT,IND,2010.0,7,13,-6
LVA,CHE,2014.0,2,1,1
CHE,HRV,2017.0,2,8,-6
BEL,PRT,2000.0,1,2,-1
PSE,USA,2019.0,3,3,0
PSE,USA,2010.0,3,2,1
NZL,ZAF,2003.0,5,9,-4
ZAF,EGY,2014.0,3,1,2
OMN,MYS,2016.0,3,5,-2
SAU,ZAF,2019.0,1,11,-10
ECU,DEU,2010.0,1,1,0
BEN,NLD,2011.0,2,1,1
ITA,TUN,2007.0,1,1,0
NGA,CAN,2012.0,6,4,2
LTU,POL,2021.0,3,1,2
ZAF,AUT,2018.0,2,5,-3
DEU,EST,2009.0,4,3,1
CHL,CHE,2020.0,4,5,-1
URY,MEX,2017.0,3,4,-1
AUS,EGY,2011.0,3,2,1
ESP,SGP,2019.0,4,8,-4
CZE,SWE,2015.0,4,6,-2
CZE,KAZ,2019.0,2,4,-2
NLD,KOR,2016.0,8,6,2
TWN,TUR,2020.0,2,4,-2
DEU,SYR,2020.0,3,1,2
BHR,GBR,2021.0,1,2,-1
KEN,SWE,2006.0,1,1,0
SWE,ETH,2010.0,6,1,5
DNK,FRA,2000.0,5,8,-3
SVN,SVK,2016.0,1,2,-1
NLD,CYP,2014.0,1,1,0
ESP,ARE,2017.0,10,5,5
LVA,DEU,2011.0,2,4,-2
FRA,NPL,2010.0,1,1,0
UKR,LTU,2018.0,1,2,-1
ISR,NLD,2002.0,7,9,-2
OMN,DEU,2015.0,2,3,-1
ISR,DNK,2000.0,2,1,1
URY,MEX,2010.0,1,3,-2
ESP,SRB,2013.0,2,2,0
CHN,CMR,2011.0,2,1,1
PRT,FIN,2009.0,2,1,1
ITA,HUN,2007.0,4,6,-2
BRN,MYS,2020.0,3,11,-8
PHL,CHE,2018.0,2,2,0
IRL,IRN,2020.0,2,16,-14
NOR,TUR,2002.0,2,2,0
NOR,FIN,2010.0,5,13,-8
AUT,ETH,2017.0,1,1,0
FRA,CYP,2015.0,1,2,-1
BGR,DEU,2020.0,6,8,-2
ROU,ESP,2000.0,2,1,1
SDN,SAU,2007.0,3,4,-1
NOR,CHE,2002.0,6,2,4
DEU,BIH,2021.0,1,2,-1
USA,MAR,2010.0,2,1,1
AUT,ARE,2011.0,1,1,0
ESP,BGR,2021.0,2,2,0
VNM,DEU,2001.0,1,1,0
RUS,DNK,2009.0,2,2,0
AUT,BRA,2004.0,2,4,-2
CAN,PRT,2007.0,3,3,0
HKG,NOR,2022.0,2,1,1
KHM,FRA,2016.0,5,4,1
ALB,FRA,2013.0,1,3,-2
ESP,PRI,2009.0,2,5,-3
GHA,CHN,2015.0,4,5,-1
ROU,PRT,2017.0,2,1,1
THA,GHA,2020.0,2,1,1
TUR,BGR,2003.0,2,1,1
BHR,EGY,2010.0,1,1,0
LUX,GBR,2008.0,2,4,-2
DEU,ARM,2012.0,3,4,-1
SDN,ZAF,2017.0,2,2,0
KOR,KHM,2012.0,1,1,0
SVK,FRA,2003.0,3,5,-2
DEU,BOL,2002.0,1,1,0
EGY,CHE,2016.0,4,7,-3
CHE,NZL,2005.0,5,8,-3
GBR,AFG,2009.0,2,1,1
THA,MYS,2002.0,2,1,1
ARE,AUS,2011.0,2,9,-7
DNK,GNB,2008.0,1,2,-1
GMB,GBR,2014.0,5,4,1
PHL,CHN,2005.0,1,2,-1
AUT,EGY,2022.0,1,1,0
KOR,ZAF,2021.0,1,1,0
AUS,FJI,2010.0,3,8,-5
FIN,KOR,2019.0,4,1,3
PAK,SGP,2019.0,4,2,2
IDN,IND,2020.0,3,12,-9
ETH,BWA,2012.0,1,1,0
PER,FRA,2017.0,3,8,-5
ARG,ROU,2020.0,1,1,0
IND,BRA,2012.0,6,7,-1
FRA,GIN,2013.0,1,2,-1
ISR,PRT,2009.0,2,1,1
IRL,PAK,2010.0,2,1,1
NLD,MLT,2017.0,1,1,0
CHE,HRV,2010.0,3,2,1
MYS,CHN,2010.0,3,4,-1
SRB,GRC,2017.0,3,2,1
ITA,BFA,2012.0,2,2,0
DEU,IRQ,2012.0,1,1,0
CHN,LBR,2021.0,1,1,0
UGA,DEU,2016.0,3,8,-5
SVK,IND,2018.0,2,2,0
CMR,CAN,2015.0,2,4,-2
TWN,AUT,2019.0,1,2,-1
ZAF,NOR,2009.0,2,2,0
GBR,GMB,2022.0,3,6,-3
RUS,SGP,2019.0,2,4,-2
MYS,FRA,2015.0,2,5,-3
PRT,BGD,2021.0,1,1,0
KWT,FRA,2022.0,1,1,0
PAK,AUS,2002.0,1,1,0
BFA,CMR,2017.0,2,1,1
MCO,USA,2003.0,1,1,0
DEU,PER,2015.0,5,1,4
SDN,ZAF,2019.0,1,6,-5
FRA,AZE,2021.0,1,1,0
ITA,BGD,2022.0,3,2,1
CHE,PAK,2013.0,1,1,0
DEU,CRI,2004.0,1,2,-1
NOR,CHE,2005.0,2,11,-9
QAT,EGY,2001.0,1,2,-1
ARG,CAN,1997.0,1,1,0
KEN,UGA,2007.0,1,2,-1
BLR,NOR,2018.0,2,2,0
MYS,FIN,2015.0,1,1,0
PAK,IND,2000.0,2,1,1
ERI,IND,2005.0,1,1,0
USA,CUB,2001.0,1,6,-5
SAU,ZAF,2010.0,1,18,-17
DEU,PAN,2021.0,3,2,1
KEN,TZA,2006.0,2,2,0
ITA,IRN,2005.0,2,1,1
TWN,NZL,2016.0,2,4,-2
IDN,BEL,2020.0,2,4,-2
ECU,IRL,2018.0,1,1,0
ZMB,USA,1997.0,1,1,0
COL,ECU,2008.0,3,1,2
CHE,BGR,2012.0,4,1,3
LBN,NOR,2020.0,1,1,0
USA,IRQ,2007.0,3,3,0
PRT,DEU,1998.0,1,5,-4
GHA,FRA,2022.0,2,1,1
DEU,VNM,2001.0,1,1,0
HRV,AUS,2020.0,3,1,2
DNK,ARG,2004.0,1,1,0
CHE,CHL,2009.0,3,6,-3
BGR,RUS,2012.0,1,1,0
GRD,GBR,2008.0,2,1,1
LTU,IRL,2016.0,1,1,0
CHE,TUN,2010.0,1,3,-2
NOR,MEX,2015.0,1,1,0
GUY,USA,2018.0,1,2,-1
SWE,TWN,2022.0,1,2,-1
GHA,BEL,2016.0,1,1,0
ITA,GEO,2007.0,1,1,0
TUN,KOR,2017.0,1,2,-1
CHE,LIE,2016.0,1,3,-2
IRQ,KOR,2022.0,2,1,1
IRL,HUN,2008.0,2,2,0
NLD,HRV,2021.0,3,1,2
ETH,NGA,2021.0,1,1,0
CYP,CHE,2012.0,1,1,0
COL,AUT,2019.0,4,4,0
SAU,BHR,2009.0,1,1,0
SWE,BGR,2010.0,1,3,-2
ITA,NGA,2011.0,2,1,1
AUS,KHM,2012.0,1,3,-2
PHL,NPL,2012.0,1,1,0
CHL,CUB,2015.0,1,10,-9
MYS,ETH,2014.0,2,2,0
IND,MAR,2019.0,1,3,-2
HUN,SAU,2019.0,1,2,-1
BEL,BGD,2012.0,2,3,-1
ETH,FRA,2015.0,1,1,0
IRQ,IRN,2014.0,1,4,-3
CYP,AUT,2010.0,1,1,0
SVN,NLD,2007.0,1,3,-2
AUS,JOR,2003.0,1,2,-1
POL,ARE,2019.0,1,1,0
DEU,SVN,2004.0,1,6,-5
ARE,KWT,2001.0,1,2,-1
GBR,MOZ,2019.0,2,1,1
PAK,AUS,2005.0,3,5,-2
SGP,ISR,2007.0,1,1,0
LTU,ESP,2016.0,1,1,0
CHE,SAU,2016.0,2,3,-1
FRA,ARM,2009.0,1,2,-1
SVN,JPN,2016.0,2,1,1
MOZ,FRA,2016.0,1,2,-1
JPN,PRT,2015.0,2,3,-1
IND,ERI,2005.0,1,1,0
HUN,SAU,2017.0,1,3,-2
TUR,ROU,2002.0,1,4,-3
BGD,PHL,2018.0,1,1,0
NOR,LTU,2011.0,1,2,-1
UGA,GBR,2001.0,1,1,0
GRC,CYP,2000.0,1,2,-1
GRC,CAN,2003.0,3,13,-10
GRC,ISR,2006.0,1,3,-2
BGD,FRA,2016.0,2,1,1
MMR,KOR,2018.0,1,1,0
URY,CHL,2011.0,1,2,-1
KEN,SDN,2020.0,1,1,0
NOR,NPL,2020.0,2,1,1
EST,FRA,2014.0,3,4,-1
PER,PRT,2019.0,2,1,1
PER,URY,2011.0,1,1,0
MAR,AUS,2016.0,1,1,0
EGY,PSE,2022.0,2,4,-2
FIN,IDN,2018.0,2,1,1
FJI,BRA,2017.0,1,1,0
IRL,LBN,2018.0,1,1,0
ETH,UGA,2018.0,1,2,-1
JPN,ARG,2022.0,1,2,-1
COL,CHE,2004.0,1,1,0
BRA,BEL,1997.0,1,3,-2
CHN,CZE,2002.0,1,1,0
DNK,IRL,2010.0,1,7,-6
ARG,ITA,1997.0,1,2,-1
DNK,FRO,2013.0,1,1,0
ITA,PAK,2011.0,1,7,-6
DZA,USA,2020.0,3,5,-2
GHA,DNK,2019.0,2,6,-4
ITA,LTU,2013.0,1,3,-2
PAK,ZAF,2020.0,2,5,-3
TUR,GEO,2016.0,1,1,0
MEX,IRL,1999.0,1,1,0
SWE,CHL,2007.0,1,1,0
COL,FRA,2004.0,1,7,-6
BWA,GHA,2011.0,1,1,0
USA,KHM,2019.0,1,7,-6
MEX,SLV,2019.0,1,1,0
DEU,MDA,2011.0,1,2,-1
BIH,GBR,2016.0,1,1,0
CHE,CYP,2021.0,1,2,-1
GBR,ZMB,2018.0,1,8,-7
SWE,URY,2017.0,1,1,0
BFA,USA,2022.0,1,1,0
HKG,ISR,1999.0,1,1,0
TWN,CAN,2010.0,12,17,-5
USA,IND,2022.0,335,475,-140
GBR,KOR,2020.0,55,61,-6
USA,GBR,1997.0,171,154,17
DEU,ESP,2004.0,72,77,-5
RUS,DEU,2012.0,101,86,15
ARG,AUT,2003.0,2,4,-2
USA,PHL,2016.0,30,30,0
FRA,NOR,2008.0,30,8,22
CHE,ITA,2020.0,158,219,-61
IND,ESP,2010.0,17,11,6
ESP,DEU,2003.0,95,92,3
ESP,SWE,2019.0,83,36,47
IRL,CHN,2022.0,14,18,-4
IND,DEU,2021.0,153,93,60
AUS,ZAF,2017.0,30,34,-4
CHN,MAC,2021.0,108,147,-39
ESP,ITA,2021.0,156,170,-14
MYS,YEM,2018.0,18,5,13
NLD,BEL,1999.0,30,37,-7
SGP,DEU,2020.0,38,31,7
FRA,CIV,2016.0,31,8,23
MYS,JPN,2020.0,28,27,1
MEX,USA,2003.0,135,182,-47
USA,LBN,2003.0,22,15,7
MYS,CHN,2019.0,55,11,44
ESP,CAN,2021.0,42,57,-15
AUS,ESP,2018.0,43,51,-8
NLD,ITA,2020.0,88,113,-25
SAU,EGY,2021.0,133,294,-161
NLD,AUS,2017.0,93,62,31
CHN,BGD,2019.0,22,27,-5
GBR,CUB,2008.0,2,1,1
PRT,MEX,2007.0,4,1,3
CHE,TUN,2019.0,4,3,1
LUX,DEU,2021.0,15,26,-11
USA,HTI,2021.0,4,3,1
CAN,MEX,2014.0,27,35,-8
IND,NOR,2020.0,32,15,17
CHN,SAU,2016.0,31,25,6
TUR,SAU,2015.0,10,4,6
CHN,FRA,2000.0,15,7,8
USA,IRL,2004.0,88,86,2
ARG,DEU,2016.0,21,22,-1
CHN,BGD,2017.0,19,19,0
USA,DNK,2014.0,133,131,2
SRB,HRV,2016.0,5,6,-1
KOR,IDN,2014.0,12,5,7
DEU,ISL,2018.0,5,2,3
SEN,GBR,2004.0,1,1,0
FRA,QAT,2020.0,8,3,5
DNK,IRL,2019.0,8,5,3
AUS,IND,2014.0,53,97,-44
SGP,GBR,2009.0,50,70,-20
NLD,LTU,2011.0,3,3,0
NGA,GBR,2007.0,19,15,4
ARG,CHE,2015.0,8,7,1
SWE,BRA,2016.0,17,15,2
KEN,JPN,2009.0,2,6,-4
DEU,BEL,2002.0,54,68,-14
GRC,DNK,2002.0,6,2,4
SEN,GUF,2001.0,1,1,0
BEL,IRN,2008.0,6,4,2
UKR,DEU,2007.0,29,24,5
LKA,IND,2014.0,3,5,-2
CHE,AUS,2000.0,5,7,-2
NOR,TUR,2005.0,2,1,1
FRA,MEX,1999.0,14,15,-1
RUS,MDA,2009.0,1,1,0
RUS,ITA,2012.0,15,14,1
QAT,USA,2016.0,29,66,-37
USA,KHM,2010.0,3,3,0
ITA,QAT,2016.0,10,1,9
TUR,ESP,2007.0,4,1,3
JPN,NLD,2006.0,9,25,-16
CHL,ARG,2006.0,10,14,-4
MDG,USA,2014.0,7,2,5
GAB,FRA,2010.0,3,3,0
MWI,USA,2014.0,13,13,0
IDN,JPN,2009.0,10,70,-60
CHN,ESP,2014.0,23,17,6
NLD,VNM,2013.0,9,3,6
SVN,HRV,2012.0,5,8,-3
SAU,ZAF,2017.0,2,6,-4
ROU,PRT,2019.0,1,2,-1
IND,LKA,2015.0,4,2,2
OMN,SAU,2022.0,1,1,0
MYS,DEU,2021.0,8,4,4
ROU,AUT,2019.0,1,3,-2
SDN,MYS,2012.0,2,5,-3
NLD,AUT,2012.0,24,14,10
SWE,DEU,1999.0,25,43,-18
ZAF,SWE,2014.0,8,11,-3
PER,ECU,2016.0,2,6,-4
ZAF,ZWE,2008.0,1,20,-19
BRA,UGA,2021.0,1,1,0
ZAF,IRL,2021.0,7,5,2
RUS,TWN,2002.0,5,6,-1
CZE,ESP,2003.0,3,5,-2
LKA,CAN,2016.0,1,1,0
DEU,GEO,2005.0,5,3,2
JPN,ROU,2004.0,6,5,1
JPN,GRC,2013.0,2,2,0
TUN,USA,2009.0,3,1,2
BEL,CMR,2014.0,5,1,4
FIN,IRL,2014.0,3,6,-3
HUN,CZE,1999.0,1,2,-1
DEU,MYS,2021.0,4,8,-4
HUN,ISR,2019.0,4,2,2
CUB,ARG,2010.0,6,1,5
ISR,RUS,2013.0,9,4,5
CAN,MYS,2015.0,13,21,-8
PAK,AUT,2014.0,10,19,-9
CHE,UGA,2014.0,1,2,-1
HTI,USA,2013.0,10,6,4
DEU,PSE,2022.0,2,1,1
CRI,CAN,2021.0,1,2,-1
CHE,MNG,2019.0,1,2,-1
PAK,BEL,2002.0,1,1,0
BLR,UKR,2002.0,1,4,-3
PRT,CHN,2011.0,9,9,0
OMN,ARE,2015.0,4,1,3
KAZ,UZB,2021.0,3,1,2
ARG,ECU,2018.0,7,4,3
IND,TZA,2015.0,2,1,1
CHN,ARG,2000.0,1,1,0
AUT,UKR,1998.0,3,2,1
RUS,TWN,2005.0,1,2,-1
TWN,NLD,2020.0,4,11,-7
CHE,LBN,2016.0,4,4,0
PAK,KEN,2014.0,3,1,2
SWE,ETH,2017.0,4,2,2
CZE,JPN,2021.0,7,2,5
JAM,GBR,2017.0,1,2,-1
DNK,KOR,2005.0,2,1,1
NZL,IDN,2014.0,4,3,1
PRY,USA,2020.0,1,4,-3
ISR,HUN,2012.0,2,4,-2
EGY,SDN,2017.0,2,1,1
BEL,TUR,2005.0,5,5,0
ESP,ARE,2010.0,1,1,0
BEL,IDN,2000.0,1,1,0
OMN,CAN,2003.0,1,4,-3
KEN,AUS,2018.0,5,1,4
NLD,NGA,2020.0,2,4,-2
ISL,PRT,2020.0,2,1,1
FIN,KOR,2010.0,2,4,-2
COL,PRT,2009.0,1,2,-1
BEL,CHL,2006.0,2,8,-6
MCO,FRA,2013.0,2,9,-7
DZA,CHE,2019.0,1,3,-2
JAM,CAN,2020.0,2,1,1
JAM,GBR,2019.0,1,2,-1
GIN,MLI,2009.0,2,1,1
JOR,ITA,2003.0,1,2,-1
LBN,CAN,2003.0,1,6,-5
SAU,TUN,2006.0,1,1,0
SDN,ZAF,2010.0,2,1,1
ZMB,JPN,2009.0,1,3,-2
JOR,CHN,2018.0,1,1,0
BGD,BTN,2020.0,1,1,0
CHL,IND,2011.0,2,2,0
CHE,SVK,2022.0,1,3,-2
KEN,PAK,2012.0,3,1,2
THA,MYS,2005.0,1,1,0
JAM,TTO,2015.0,1,3,-2
THA,CZE,2014.0,1,2,-1
MCO,CAN,2020.0,1,1,0
,BRA,2003.0,10384,0,10384
,USA,2010.0,89562,0,89562
USA,,2012.0,53623,0,53623
,CHL,1994.0,639,0,639
SGP,,2009.0,712,0,712
FIN,,2015.0,1410,0,1410
MEX,,2018.0,3062,0,3062
,CAN,2001.0,10893,0,10893
,USA,2017.0,85275,0,85275
CHN,,2007.0,15307,0,15307
,THA,2005.0,1764,0,1764
,NLD,2009.0,6344,0,6344
,NOR,2001.0,1645,0,1645
,IRN,2000.0,1638,0,1638
,FIN,2008.0,2078,0,2078
AUS,,2013.0,4128,0,4128
JOR,,2022.0,1043,0,1043
EST,,2022.0,710,0,710
IND,,2007.0,3527,0,3527
CHE,,2020.0,5250,0,5250
DNK,,2004.0,515,0,515
IDN,,2011.0,83,0,83
SWE,,2007.0,1531,0,1531
SVN,,2022.0,1245,0,1245
,USA,2019.0,48141,0,48141
,CZE,1999.0,2547,0,2547
PRT,,2016.0,1435,0,1435
KEN,,2022.0,931,0,931
,HUN,2003.0,1355,0,1355
MNE,,2022.0,90,0,90
,HKG,2006.0,1353,0,1353
LBY,,2023.0,198,0,198
IRQ,,2009.0,15,0,15
,PAK,2014.0,3626,0,3626
TUN,,2020.0,1395,0,1395
,YEM,2015.0,47,0,47
,HND,2006.0,15,0,15
,ISL,2006.0,115,0,115
,JPN,2012.0,23559,0,23559
,THA,2002.0,1282,0,1282
UKR,,1999.0,117,0,117
,ISR,2006.0,2317,0,2317
LTU,,2009.0,170,0,170
BGD,,2008.0,82,0,82
PRT,DZA,2020.0,4,0,4
IND,IRL,2006.0,11,0,11
BWA,,2024.0,477,0,477
SVN,IRL,2016.0,2,0,2
,GEO,1997.0,81,0,81
LAO,,2020.0,46,0,46
,ALB,2013.0,58,0,58
,LBY,2002.0,19,0,19
,TWN,2012.0,6538,0,6538
JPN,AZE,2017.0,1,0,1
ARE,,2012.0,97,0,97
,COG,2003.0,65,0,65
NAM,DEU,2017.0,1,0,1
CUB,GBR,2011.0,4,0,4
,BGD,2006.0,510,0,510
CRI,,2017.0,66,0,66
CRI,,2019.0,106,0,106
,KOR,2015.0,16309,0,16309
,QAT,2009.0,115,0,115
,URY,2012.0,284,0,284
ETH,,2015.0,98,0,98
,OMN,2011.0,162,0,162
,KAZ,2018.0,841,0,841
SDN,,2019.0,99,0,99
TUN,ZAF,2020.0,3,0,3
,BEL,2018.0,2884,0,2884
HND,,2016.0,13,0,13
MDA,,2018.0,67,0,67
SWE,GHA,2018.0,1,0,1
BEL,KEN,2017.0,6,0,6
PNG,,2019.0,25,0,25
COD,RWA,2014.0,1,0,1
NIC,,2017.0,14,0,14
,VNM,2015.0,1235,0,1235
,PHL,2015.0,573,0,573
,SUR,2014.0,9,0,9
ZAF,,2001.0,42,0,42
,BGR,1994.0,418,0,418
PYF,BEL,2021.0,1,0,1
DZA,TZA,2019.0,1,0,1
BIH,SVN,2019.0,3,0,3
SLE,,2020.0,36,0,36
,AZE,2002.0,141,0,141
NER,GHA,2018.0,1,0,1
,RWA,2018.0,118,0,118
NLD,MLT,2019.0,3,0,3
RUS,IRL,2002.0,4,0,4
,IDN,2009.0,1116,0,1116
ZMB,,2018.0,62,0,62
,HRV,2014.0,883,0,883
,ZMB,2006.0,49,0,49
SDN,,2017.0,65,0,65
MYS,BEL,2012.0,4,0,4
CRI,,2010.0,50,0,50
SRB,TUR,2010.0,1,0,1
,AZE,2005.0,172,0,172
MYS,SYR,2019.0,2,0,2
SVN,AUT,2022.0,6,0,6
,PAN,1997.0,7,0,7
ZWE,,2006.0,15,0,15
PNG,,2017.0,19,0,19
ARM,,2002.0,23,0,23
AUT,TWN,2018.0,1,0,1
VNM,,2013.0,136,0,136
SGP,ETH,2019.0,2,0,2
,LIE,2014.0,11,0,11
BHS,,2024.0,22,0,22
PAK,UGA,2013.0,1,0,1
NZL,CZE,2022.0,3,0,3
KOR,FIN,2020.0,6,0,6
ESP,NGA,2018.0,1,0,1
BFA,NER,2020.0,2,0,2
HTI,CHN,2018.0,1,0,1
,ETH,2001.0,110,0,110
FJI,USA,2009.0,3,0,3
IND,AIA,2020.0,1,0,1
KOR,UZB,2020.0,11,0,11
UZB,GBR,2013.0,1,0,1
,GIN,2001.0,6,0,6
BGD,NOR,2003.0,1,0,1
,SOM,2000.0,2,0,2
KGZ,,2009.0,2,0,2
,GHA,2000.0,108,0,108
MLT,,2009.0,5,0,5
,BFA,2001.0,58,0,58
SEN,,2013.0,35,0,35
NCL,,2011.0,4,0,4
PNG,,2010.0,12,0,12
LUX,MDG,2022.0,1,0,1
LSO,,2015.0,5,0,5
USA,CAF,2016.0,1,0,1
FRA,TCD,2015.0,1,0,1
,PAN,1998.0,19,0,19
,GLP,1999.0,8,0,8
MNG,,2015.0,22,0,22
PAK,,2001.0,5,0,5
TUR,SLE,2009.0,1,0,1
SWE,MDA,2014.0,1,0,1
USA,UZB,1997.0,1,0,1
IND,ZAF,2004.0,9,0,9
CHE,SGP,2001.0,4,0,4
KWT,,2006.0,55,0,55
MYS,TUR,2006.0,1,0,1
LTU,NLD,2013.0,2,0,2
RUS,IDN,2003.0,1,0,1
RUS,CIV,2010.0,2,0,2
ARM,,2005.0,34,0,34
IND,NZL,1998.0,2,0,2
FJI,RUS,2009.0,1,0,1
,BRN,2004.0,3,0,3
TUR,MDA,2004.0,1,0,1
KAZ,,2013.0,34,0,34
BFA,ZAF,2012.0,1,0,1
PRI,NLD,1999.0,1,0,1
,PRY,1999.0,16,0,16
THA,,1999.0,12,0,12
EGY,SDN,2010.0,2,0,2
PHL,ESP,2005.0,2,0,2
URY,DNK,2016.0,2,0,2
CHE,FJI,2008.0,1,0,1
CZE,AUS,1998.0,1,0,1
PHL,CHN,2002.0,2,0,2
NZL,PHL,2003.0,1,0,1
PER,EGY,2010.0,1,0,1
TUR,IND,2006.0,2,0,2
ESP,MAR,1997.0,1,0,1
NCL,GAB,2009.0,1,0,1
SVK,PAK,2010.0,1,0,1
AUS,LBY,2007.0,1,0,1
,SWZ,2003.0,6,0,6
FRA,MKD,2014.0,2,0,2
COG,CHE,2006.0,1,0,1
BEL,ZMB,2016.0,3,0,3
,LBY,2005.0,21,0,21
,LUX,1995.0,8,0,8
,MNG,2005.0,41,0,41
BRA,PAN,2016.0,1,0,1
FRA,PSE,2009.0,4,0,4
RWA,,2011.0,4,0,4
SWZ,,2024.0,50,0,50
NPL,MYS,2008.0,1,0,1
AUS,QAT,2015.0,6,0,6
SDN,BRA,2000.0,1,0,1
ETH,DNK,2018.0,2,0,2
MEX,FIN,2013.0,2,0,2
TUR,CYP,1998.0,1,0,1
BRA,FJI,2021.0,2,0,2
NGA,QAT,2017.0,1,0,1
BEL,BDI,2018.0,4,0,4
NIC,,2019.0,21,0,21
ESP,MDV,2017.0,1,0,1
CZE,UZB,2016.0,1,0,1
IND,RWA,2020.0,3,0,3
MTQ,,2023.0,10,0,10
RUS,MAR,2020.0,1,0,1
SGP,AUT,2007.0,1,0,1
,GEO,1998.0,146,0,146
,MNG,2002.0,30,0,30
CAN,NCL,2008.0,1,0,1
AUT,ETH,2010.0,4,0,4
RUS,EST,2006.0,2,0,2
MTQ,CHE,2004.0,1,0,1
NAM,,2016.0,13,0,13
SGP,SRB,2001.0,2,0,2
AGO,FRA,2010.0,3,0,3
CZE,IND,2000.0,1,0,1
BTN,IND,2003.0,1,0,1
UGA,CHE,2021.0,1,0,1
IRL,ISL,2016.0,1,0,1
NLD,MLT,2010.0,1,0,1
ESP,GNQ,2005.0,1,0,1
,GNB,2014.0,6,0,6
,BRN,1996.0,5,0,5
EGY,DZA,2008.0,5,0,5
IND,YEM,2013.0,4,0,4
,LSO,2013.0,4,0,4
PRK,,2018.0,6,0,6
LBN,ITA,2022.0,2,0,2
SDN,,2010.0,34,0,34
BOL,PER,2008.0,1,0,1
DEU,LBN,2011.0,4,0,4
YEM,AUS,2018.0,1,0,1
ISR,LBN,2021.0,1,0,1
,GUY,2001.0,5,0,5
PAK,LBR,2019.0,1,0,1
NOR,BRA,2002.0,1,0,1
JPN,JOR,2007.0,3,0,3
GBR,MUS,2001.0,2,0,2
,MNE,1999.0,6,0,6
ECU,NOR,2020.0,1,0,1
KWT,NGA,2014.0,1,0,1
FSM,,2021.0,5,0,5
CIV,CHE,2004.0,2,0,2
PSE,DEU,2007.0,2,0,2
JOR,KWT,2007.0,1,0,1
UKR,BEL,2001.0,6,0,6
PSE,ISR,1999.0,1,0,1
RUS,IRL,2005.0,6,0,6
ZMB,USA,1998.0,2,0,2
JAM,GBR,2010.0,3,0,3
CHN,GHA,2010.0,1,0,1
VEN,SLV,2006.0,1,0,1
,DJI,1999.0,2,0,2
ITA,MUS,2011.0,1,0,1
ESP,SAU,2012.0,2,0,2
BGD,ITA,2009.0,4,0,4
CZE,COL,2015.0,2,0,2
AUS,NPL,2009.0,2,0,2
CZE,KOR,2012.0,1,0,1
KEN,PRI,2008.0,1,0,1
LUX,CZE,2016.0,1,0,1
HUN,EGY,2007.0,3,0,3
USA,BFA,2020.0,2,0,2
GBR,MOZ,2010.0,1,0,1
BGR,CYP,2012.0,1,0,1
SWE,HRV,2005.0,1,0,1
GRC,JPN,2022.0,4,0,4
PER,KEN,2004.0,1,0,1
,SLV,2014.0,4,0,4
MEX,SLV,2017.0,1,0,1
ZAF,FIN,2021.0,8,0,8
FRA,AGO,2017.0,1,0,1
EGY,ZAF,2020.0,2,0,2
PAN,AUS,2002.0,1,0,1
BGR,CHE,2021.0,2,0,2
VEN,CHN,2018.0,1,0,1
BGD,IRL,2018.0,1,0,1
SRB,HKG,2022.0,1,0,1
LBN,SAU,2002.0,2,0,2
MEX,SGP,2008.0,2,0,2
BEL,GAB,2014.0,3,0,3
BEL,TWN,2008.0,1,0,1
,KNA,2008.0,2,0,2
KOR,BLR,2002.0,2,0,2
NLD,CIV,2020.0,1,0,1
CRI,NLD,1999.0,2,0,2
ZMB,BEL,2008.0,1,0,1
EST,USA,2015.0,3,0,3
YEM,NGA,2019.0,1,0,1
THA,MOZ,2015.0,1,0,1
PSE,SLE,2013.0,1,0,1
AGO,RUS,2012.0,1,0,1
CHE,LKA,2008.0,1,0,1
HUN,BIH,2020.0,3,0,3
,BLZ,2012.0,3,0,3
CUB,NZL,2018.0,1,0,1
USA,PNG,1997.0,1,0,1
MAR,EGY,2018.0,2,0,2
OMN,NLD,2007.0,2,0,2
SRB,SVN,2018.0,3,0,3
,EGY,2020.0,8,0,8
PAN,GBR,2007.0,2,0,2
COG,ARE,2015.0,1,0,1
BEN,,2006.0,4,0,4
THA,JOR,2003.0,1,0,1
PRT,ARG,2010.0,2,0,2
PHL,ESP,2002.0,1,0,1
ROU,GBR,1998.0,3,0,3
BIH,BEL,2003.0,1,0,1
CHN,CZE,2005.0,2,0,2
URY,NZL,2019.0,1,0,1
FIN,GRD,2010.0,1,0,1
CHL,SWE,2018.0,7,0,7
AUT,UKR,1997.0,1,0,1
CZE,BRA,1999.0,2,0,2
BEL,ARM,2000.0,1,0,1
PAK,JPN,2000.0,1,0,1
CHL,PAN,2015.0,1,0,1
ISR,JOR,2003.0,1,0,1
AUT,ETH,2019.0,6,0,6
NZL,MWI,2012.0,2,0,2
PHL,DNK,2007.0,1,0,1
COG,BFA,2015.0,1,0,1
FRA,SDN,2007.0,3,0,3
ZAF,ISR,2014.0,3,0,3
EGY,AZE,2015.0,1,0,1
UKR,IRQ,2020.0,2,0,2
BTN,MWI,2015.0,1,0,1
LTU,TUN,2017.0,1,0,1
GRL,NOR,2018.0,1,0,1
NOR,MMR,2017.0,1,0,1
AUT,LIE,2022.0,1,0,1
USA,NAM,2012.0,2,0,2
NIC,,2010.0,5,0,5
URY,ZAF,2006.0,1,0,1
AUS,MNG,2004.0,1,0,1
NCL,MYS,2011.0,1,0,1
CHN,MYS,2007.0,4,0,4
ROU,GBR,1997.0,1,0,1
SVK,BEL,2019.0,1,0,1
BHR,ZAF,2005.0,1,0,1
KOR,GTM,2012.0,1,0,1
BLR,FIN,2013.0,1,0,1
PRI,CHL,2015.0,1,0,1
NAM,ITA,2019.0,1,0,1
LAO,ITA,2017.0,1,0,1
BEL,NER,2017.0,1,0,1
SVN,POL,2009.0,1,0,1
LBY,OMN,2015.0,1,0,1
IRL,BGD,2008.0,3,0,3
TZA,THA,2004.0,1,0,1
BEL,ECU,2008.0,1,0,1
USA,NCL,2017.0,2,0,2
DZA,TWN,2020.0,1,0,1
IND,BGR,2020.0,2,0,2
ESP,CMR,2012.0,1,0,1
CHE,SDN,2009.0,1,0,1
MCO,ARG,1999.0,1,0,1
DZA,CHE,2017.0,3,0,3
,COM,2009.0,4,0,4
KEN,KOR,2016.0,2,0,2
SYC,,2015.0,4,0,4
BGD,GRC,2015.0,2,0,2
,MDV,2016.0,4,0,4
BRA,KOR,2009.0,2,0,2
,AFG,2006.0,5,0,5
ARM,IRN,2011.0,3,0,3
ZAF,MLI,2018.0,1,0,1
MAC,ESP,2021.0,1,0,1
OMN,JOR,1999.0,1,0,1
FIN,BGD,2014.0,2,0,2
SRB,POL,2021.0,1,0,1
ZAF,MAR,2018.0,2,0,2
TGO,FRA,1999.0,1,0,1
ISL,BEL,2017.0,1,0,1
GBR,AZE,2015.0,2,0,2
JPN,SYR,2001.0,1,0,1
SWE,URY,2010.0,2,0,2
BEL,CRI,2008.0,1,0,1
CHE,PAN,2015.0,2,0,2
MWI,NLD,2009.0,1,0,1
CUB,PRI,2003.0,2,0,2
IRN,HKG,2011.0,2,0,2
BIH,TUR,2014.0,4,0,4
SEN,NER,2015.0,1,0,1
CHL,AUT,2007.0,1,0,1
JOR,BHR,2014.0,1,0,1
JPN,BHR,2020.0,1,0,1
EST,SGP,2013.0,2,0,2
ESP,TUN,2013.0,3,0,3
JPN,BEL,2000.0,3,0,3
IND,BHS,2014.0,1,0,1
SWE,CMR,2014.0,2,0,2
NRU,USA,2003.0,1,0,1
ALB,,2003.0,2,0,2
FRO,DEU,2010.0,1,0,1
GUM,,2014.0,3,0,3
MDA,JPN,2006.0,1,0,1
TUR,COL,2002.0,1,0,1
ESP,MAR,1998.0,1,0,1
NGA,COL,2003.0,1,0,1
SDN,USA,2006.0,1,0,1
BEL,SGP,2003.0,1,0,1
MEX,TWN,2002.0,1,0,1
KHM,CAN,2016.0,1,0,1
,TKM,2000.0,2,0,2
CMR,RWA,2011.0,1,0,1
CRI,CHL,2014.0,1,0,1
COL,URY,2010.0,1,0,1
SAU,ERI,2002.0,1,0,1
PHL,ZAF,2013.0,1,0,1
HKG,VNM,2010.0,1,0,1
GHA,ITA,2012.0,1,0,1
UGA,ZMB,2012.0,1,0,1
GBR,NCL,1999.0,1,0,1
ALB,BIH,2020.0,1,0,1
MCO,DEU,2016.0,1,0,1
NGA,PRT,2022.0,1,0,1
POL,BGR,2016.0,1,0,1
COL,NGA,2006.0,1,0,1
JPN,MAR,2007.0,1,0,1
HKG,RUS,2012.0,2,0,2
TWN,BFA,2021.0,1,0,1
BFA,CHN,2007.0,1,0,1
MLT,DEU,2021.0,1,0,1
BRA,STP,2006.0,1,0,1
NLD,ISL,2005.0,1,0,1
KWT,TWN,2019.0,1,0,1
ESP,LBN,2006.0,1,0,1
FRA,MWI,2021.0,1,0,1
NLD,LIE,2021.0,1,0,1
IND,KAZ,2016.0,1,0,1
BGR,SAU,2020.0,1,0,1
NPL,ITA,2012.0,1,0,1
HKG,NZL,2021.0,2,0,2
LBN,AUS,2013.0,1,0,1
DEU,DZA,2016.0,4,0,4
CIV,TGO,2012.0,1,0,1
PNG,NZL,2007.0,1,0,1
COG,TZA,2019.0,1,0,1
,SLB,2013.0,8,0,8
BHR,UKR,2018.0,1,0,1
MDA,BGR,2020.0,1,0,1
NPL,CZE,2018.0,1,0,1
ARG,BOL,2010.0,1,0,1
HRV,KOR,2018.0,1,0,1
LKA,BRN,2010.0,1,0,1
FIN,SRB,2018.0,2,0,2
LBY,NPL,2010.0,1,0,1
MYS,KHM,2008.0,1,0,1
BEN,GMB,2021.0,1,0,1
UGA,IND,2018.0,1,0,1
SUR,,2009.0,1,0,1
LBY,SAU,2016.0,2,0,2
KAZ,BGD,2019.0,1,0,1
FRA,AGO,2019.0,1,0,1
COG,UGA,2015.0,1,0,1
TUN,ARE,2002.0,1,0,1
SWE,JOR,2020.0,4,0,4
GBR,BEN,1999.0,1,0,1
ZMB,EGY,2021.0,1,0,1
SYR,PAK,2002.0,1,0,1
POL,EGY,2018.0,3,0,3
SVN,CHN,2008.0,1,0,1
FIN,THA,2001.0,1,0,1
UKR,FIN,2001.0,2,0,2
NGA,HUN,2005.0,1,0,1
GNB,GIN,2006.0,2,0,2
IND,LAO,2013.0,1,0,1
FLK,AUS,2008.0,1,0,1
DNK,MYS,2007.0,1,0,1
PRT,DEU,1997.0,1,0,1
AZE,ITA,2000.0,1,0,1
ITA,BHR,2002.0,1,0,1
NAM,TZA,2008.0,1,0,1
DNK,GHA,2007.0,1,0,1
KWT,IND,2012.0,1,0,1
SDN,AFG,2013.0,1,0,1
ISL,SVK,2019.0,2,0,2
JPN,FJI,2007.0,1,0,1
KGZ,CHE,2009.0,1,0,1
,CPV,2006.0,2,0,2
POL,COL,2009.0,1,0,1
TUN,SYR,2011.0,1,0,1
SRB,TUN,2020.0,1,0,1
ERI,GBR,2011.0,1,0,1
LTU,NPL,2012.0,1,0,1
BFA,BRA,2018.0,1,0,1
CYP,AUT,2017.0,2,0,2
GBR,ALB,2020.0,2,0,2
GEO,ISR,2013.0,1,0,1
IRL,NGA,2017.0,3,0,3
IND,LSO,2003.0,1,0,1
NAM,GHA,2020.0,2,0,2
CZE,LBN,2017.0,1,0,1
TUR,IRN,2001.0,1,0,1
SYR,ETH,2016.0,1,0,1
CRI,ITA,2013.0,1,0,1
GHA,IRL,2017.0,1,0,1
DZA,AUS,2020.0,1,0,1
IND,NPL,1997.0,1,0,1
NLD,ISL,2002.0,1,0,1
ROU,AUS,1999.0,2,0,2
DZA,NOR,2016.0,1,0,1
KAZ,CZE,2013.0,1,0,1
SWZ,BWA,2014.0,1,0,1
CZE,NZL,2003.0,1,0,1
SEN,COD,2016.0,1,0,1
FJI,EST,2019.0,1,0,1
QAT,IRL,2009.0,1,0,1
GIB,,2021.0,1,0,1
TWN,LTU,1999.0,1,0,1
BRA,ARE,2006.0,1,0,1
GAB,USA,2010.0,1,0,1
PAK,SGP,2010.0,1,0,1
MWI,SWE,2020.0,1,0,1
NZL,OMN,2018.0,1,0,1
ZWE,ARE,2021.0,1,0,1
TUN,KOR,2019.0,1,0,1
MHL,,2023.0,2,0,2
LSO,ZWE,2013.0,1,0,1
MKD,MDG,2020.0,1,0,1
ZWE,KEN,2022.0,1,0,1
ITA,PER,2012.0,1,0,1
SVK,BEL,2017.0,1,0,1
BRN,SAU,2020.0,2,0,2
KEN,SGP,2021.0,1,0,1
MNG,KOR,2022.0,1,0,1
VNM,FIN,2021.0,2,0,2
MEX,SLV,2010.0,1,0,1
NGA,SYR,2005.0,1,0,1
TZA,SWE,1998.0,1,0,1
JOR,TUR,2008.0,1,0,1
VCT,TTO,2014.0,1,0,1
WLF,FRA,2011.0,1,0,1
IRL,KAZ,2014.0,1,0,1
FIN,LVA,2015.0,1,0,1
ESP,GHA,2014.0,1,0,1
TUN,GLP,2011.0,1,0,1
AUT,KWT,2013.0,1,0,1
GRC,SDN,2008.0,1,0,1
MEX,MAR,2010.0,2,0,2
BLR,CAN,2012.0,1,0,1
NOR,ARM,2020.0,1,0,1
DNK,JOR,2011.0,1,0,1
PHL,GUM,2006.0,1,0,1
EGY,QAT,1998.0,2,0,2
IND,TCD,2009.0,1,0,1
FIN,GRD,2017.0,1,0,1
LTU,LVA,2001.0,1,0,1
GRC,MYS,2013.0,1,0,1
BLZ,,2013.0,1,0,1
UZB,ITA,2001.0,1,0,1
PYF,NCL,2015.0,1,0,1
KAZ,ISR,2016.0,1,0,1
LUX,IND,2013.0,1,0,1
PAN,NLD,2016.0,1,0,1
FJI,CHE,2014.0,2,0,2
NPL,EST,2015.0,1,0,1
VEN,CRI,2016.0,1,0,1
POL,THA,2016.0,1,0,1
TUR,IDN,2018.0,2,0,2
MNG,SWE,2021.0,1,0,1
ITA,SDN,2007.0,1,0,1
SEN,NCL,1998.0,1,0,1
,CUW,1999.0,1,0,1
CAN,LVA,2008.0,1,0,1
TUR,LUX,2015.0,1,0,1
SRB,GRC,2019.0,2,0,2
ITA,SEN,2016.0,1,0,1
GEO,CAN,2008.0,1,0,1
NLD,CUB,2022.0,1,0,1
FJI,JPN,2010.0,1,0,1
BGR,LUX,2011.0,1,0,1
USA,LIE,2016.0,1,0,1
IRN,SVN,2016.0,1,0,1
TUN,NGA,2010.0,1,0,1
PHL,MAC,2016.0,1,0,1
IRL,SYC,2019.0,1,0,1
ZAF,PER,2017.0,2,0,2
TWN,HUN,2012.0,1,0,1
VNM,PER,2008.0,1,0,1
GMB,ITA,2020.0,1,0,1
ARG,BOL,2017.0,1,0,1
LBN,AUT,2019.0,2,0,2
GUY,CUB,2019.0,2,0,2
CRI,SGP,2021.0,1,0,1
IRL,QAT,2011.0,1,0,1
PRT,SVN,2020.0,1,0,1
EGY,SYR,2004.0,1,0,1
CMR,GAB,2007.0,1,0,1
YEM,SAU,2005.0,1,0,1
MEX,BOL,2011.0,1,0,1
CZE,DZA,2015.0,1,0,1
HUN,LUX,2015.0,1,0,1
CHL,PRT,1999.0,1,0,1
PYF,GBR,2021.0,1,0,1
OMN,TTO,2003.0,1,0,1
BGD,CHE,2013.0,1,0,1
TWN,NER,2013.0,1,0,1
BEN,ZAF,2014.0,1,0,1
GMB,ESP,2017.0,1,0,1
UKR,UZB,2012.0,1,0,1
DNK,ZMB,2002.0,1,0,1
UKR,BGR,2003.0,1,0,1
KEN,LUX,2009.0,1,0,1
IRN,CHE,2000.0,1,0,1
AUT,NGA,2003.0,1,0,1
IDN,EGY,2009.0,1,0,1
KOR,BRA,1999.0,1,0,1
MKD,RUS,2007.0,1,0,1
GBR,BRB,2012.0,1,0,1
LKA,DEU,2002.0,1,0,1
ESP,DJI,2008.0,1,0,1
COL,HRV,2001.0,1,0,1
DZA,CHE,2010.0,1,0,1
TKM,RUS,1998.0,1,0,1
CHE,MLT,2018.0,3,0,3
ISR,TZA,2009.0,1,0,1
GBR,REU,2007.0,1,0,1
NOR,IDN,2013.0,1,0,1
SDN,IRN,2015.0,1,0,1
PRY,MEX,2005.0,1,0,1
VNM,DNK,2007.0,1,0,1
IDN,HRV,2005.0,1,0,1
PRT,AGO,2003.0,1,0,1
MMR,CHE,2018.0,1,0,1
NER,IND,2009.0,1,0,1
BGD,ZAF,2020.0,1,0,1
BGD,MYS,1997.0,1,0,1
KWT,LKA,2019.0,1,0,1
HKG,AUT,2005.0,1,0,1
ROU,KWT,2022.0,1,0,1
MYS,ARG,2014.0,1,0,1
PHL,ASM,2007.0,1,0,1
MDA,USA,1999.0,1,0,1
BGR,SWE,2003.0,1,0,1
ITA,ZAF,1998.0,1,0,1
MYS,PER,2020.0,1,0,1
COG,ETH,2008.0,1,0,1
BEL,GEO,2013.0,1,0,1
BDI,,2012.0,1,0,1
PER,EGY,2019.0,1,0,1
DEU,SLV,2020.0,1,0,1
ARE,SRB,2006.0,1,0,1
FRA,NPL,2019.0,1,0,1
FLK,USA,2010.0,1,0,1
NOR,PAK,2005.0,1,0,1
AUT,MLT,2020.0,1,0,1
CMR,TGO,2018.0,1,0,1
IDN,FIN,2019.0,1,0,1
CHE,RWA,2018.0,1,0,1
SWE,ECU,2016.0,1,0,1
IND,KOR,2011.0,140,81,59
FIN,NOR,2021.0,22,15,7
JPN,CHN,2006.0,318,207,111
NLD,USA,2005.0,218,219,-1
USA,TUR,2008.0,197,183,14
ESP,FIN,2017.0,17,13,4
GBR,USA,2022.0,602,570,32
CAN,FRA,2006.0,141,237,-96
DNK,SWE,2005.0,49,42,7
MEX,USA,2014.0,186,166,20
DEU,CHE,2004.0,435,244,191
BRA,ARG,2007.0,30,18,12
JPN,USA,2010.0,893,907,-14
CAN,IRL,2013.0,25,43,-18
JPN,CAN,2017.0,57,68,-11
SGP,AUS,2010.0,62,49,13
CHL,USA,2019.0,105,117,-12
JPN,USA,2019.0,719,667,52
PRT,KOR,2014.0,6,3,3
NLD,GBR,2009.0,194,202,-8
GBR,DEU,2004.0,307,364,-57
FRA,GRC,2005.0,23,13,10
CAN,QAT,2016.0,25,8,17
SWE,EST,2017.0,3,4,-1
ROU,ITA,2017.0,12,13,-1
HKG,USA,2010.0,138,127,11
USA,PER,2010.0,21,29,-8
NOR,SWE,2015.0,50,57,-7
NOR,USA,2017.0,57,99,-42
POL,GBR,2007.0,53,22,31
JPN,USA,2017.0,763,697,66
FRA,ROU,2004.0,22,19,3
TZA,SWE,2008.0,2,3,-1
THA,GBR,2012.0,34,75,-41
HKG,USA,2019.0,161,139,22
HUN,ITA,2011.0,8,10,-2
HKG,USA,2017.0,124,153,-29
DEU,BRA,2013.0,76,86,-10
BEL,GRC,2007.0,10,5,5
USA,KAZ,2011.0,7,4,3
BEL,USA,2011.0,119,128,-9
CAN,AUS,2017.0,175,145,30
LBN,CAN,2014.0,11,6,5
CHL,DEU,2006.0,12,17,-5
DEU,CHL,2010.0,15,26,-11
USA,CUB,2004.0,4,6,-2
SWE,LTU,2012.0,4,3,1
CZE,DEU,2019.0,57,62,-5
CAN,ITA,2021.0,40,36,4
DEU,JPN,2009.0,89,125,-36
ZAF,NGA,2022.0,39,42,-3
DEU,CHL,2017.0,28,35,-7
AUS,NZL,2006.0,103,134,-31
AUS,SWE,2006.0,27,36,-9
TWN,USA,2004.0,179,255,-76
MYS,IDN,2009.0,17,3,14
EST,IND,2021.0,2,3,-1
CAN,AUS,2019.0,157,171,-14
USA,LBN,2014.0,49,70,-21
TWN,CHN,2020.0,192,95,97
CHL,CAN,2018.0,18,19,-1
SWE,NZL,2012.0,9,7,2
DNK,USA,2022.0,53,72,-19
KOR,USA,1999.0,133,217,-84
IND,SAU,2012.0,107,23,84
FRA,ECU,2010.0,1,2,-1
CAN,ARE,2004.0,13,4,9
ESP,DEU,2014.0,263,129,134
CHN,CAN,2015.0,261,262,-1
BGD,JPN,2010.0,44,52,-8
IND,BRN,2018.0,5,2,3
JPN,GBR,2017.0,108,111,-3
IRL,USA,2015.0,157,109,48
DEU,ETH,2012.0,8,7,1
MYS,OMN,2015.0,10,2,8
CHL,USA,2017.0,121,135,-14
PAK,USA,2015.0,85,72,13
PAN,COL,2011.0,3,4,-1
NGA,SWE,2018.0,4,2,2
JPN,MYS,2016.0,61,24,37
JPN,GBR,2010.0,100,104,-4
IND,AUS,2019.0,124,63,61
DEU,IND,2005.0,50,86,-36
ITA,IND,2012.0,30,56,-26
MAR,BEL,2014.0,3,1,2
MYS,LKA,2019.0,6,3,3
VNM,JPN,2015.0,16,49,-33
UGA,ZAF,2015.0,7,6,1
THA,NLD,2013.0,3,8,-5
IND,ISR,2013.0,34,14,20
GBR,AUT,2011.0,62,54,8
CHL,USA,2010.0,73,84,-11
JPN,BGD,2022.0,24,15,9
LBN,DEU,2014.0,3,3,0
EGY,NLD,2015.0,4,4,0
JPN,CAN,2019.0,70,72,-2
IRN,CHN,2020.0,80,13,67
JPN,GBR,2019.0,105,126,-21
KOR,SAU,2015.0,16,6,10
DEU,CHL,2019.0,35,32,3
KOR,DEU,2020.0,71,49,22
THA,NPL,2018.0,5,4,1
TUR,DEU,2021.0,61,17,44
NZL,ITA,2016.0,5,7,-2
RUS,CHN,2019.0,34,18,16
NGA,USA,2015.0,34,38,-4
BGD,GBR,2011.0,7,13,-6
IRL,ESP,2020.0,24,43,-19
GMB,GBR,2003.0,6,11,-5
ESP,ECU,2016.0,54,20,34
FRA,MRT,2019.0,2,4,-2
CAN,BRA,2002.0,25,22,3
SWE,BEL,2015.0,17,22,-5
GBR,CYP,2018.0,39,25,14
GRC,CAN,2014.0,17,8,9
DEU,POL,2022.0,32,29,3
IRN,RUS,2015.0,8,2,6
ESP,EGY,2018.0,13,7,6
MYS,TWN,2012.0,2,3,-1
IND,AUS,2017.0,127,63,64
CHN,DEU,2014.0,326,240,86
AUS,LKA,2015.0,13,13,0
KAZ,UKR,2017.0,2,1,1
IDN,NLD,2018.0,18,39,-21
ISL,FRA,2014.0,3,3,0
TUR,CAN,2010.0,17,13,4
ISR,PSE,2020.0,18,8,10
GBR,HUN,2020.0,28,28,0
ARG,FRA,2016.0,34,30,4
POL,FRA,2015.0,78,30,48
USA,NGA,2015.0,38,34,4
VEN,USA,2018.0,28,9,19
SWE,TUR,2016.0,7,11,-4
ITA,DNK,2015.0,52,20,32
MEX,ECU,2019.0,17,6,11
BGD,JPN,2017.0,56,57,-1
PAN,USA,2019.0,17,13,4
BGD,JPN,2019.0,41,97,-56
POL,CHN,2021.0,3,15,-12
GBR,NZL,2022.0,36,44,-8
IRL,CAN,2020.0,38,42,-4
SGP,CHE,2020.0,22,23,-1
ESP,FIN,2019.0,28,22,6
FIN,CZE,2020.0,5,1,4
SGP,AUS,2017.0,79,86,-7
FRA,VEN,2016.0,2,6,-4
ROU,DEU,2017.0,20,21,-1
DEU,KEN,2018.0,12,6,6
ITA,KOR,2015.0,8,9,-1
IRL,AUS,2022.0,12,22,-10
POL,ITA,2016.0,21,10,11
BRA,NLD,2022.0,25,8,17
COL,ESP,2022.0,28,18,10
GBR,MYS,2022.0,29,37,-8
IND,AUS,2010.0,79,32,47
MLI,FRA,2008.0,2,10,-8
MYS,THA,2021.0,10,2,8
GBR,POL,2013.0,91,54,37
GHA,AUS,2017.0,11,6,5
ITA,FIN,2016.0,18,7,11
CUB,BRA,2016.0,27,7,20
CAN,NLD,2002.0,39,25,14
ISR,AUS,2011.0,19,7,12
RUS,NLD,2019.0,18,18,0
MYS,JOR,2020.0,29,7,22
ISR,CHN,2020.0,22,28,-6
HKG,CAN,2015.0,30,19,11
CAN,AUT,2019.0,19,18,1
ZWE,NLD,2021.0,2,3,-1
THA,KOR,2018.0,10,11,-1
ITA,POL,2020.0,21,12,9
ZAF,FRA,2021.0,22,15,7
KOR,VNM,2021.0,91,46,45
PRT,FRA,2021.0,22,23,-1
COL,DEU,2021.0,18,13,5
POL,VNM,2021.0,3,3,0
IND,BEL,2018.0,28,22,6
CMR,USA,2020.0,9,6,3
USA,TZA,2016.0,16,20,-4
USA,TUN,2020.0,3,8,-5
HKG,AUS,2004.0,27,19,8
MAC,CHN,2016.0,33,69,-36
GBR,SWE,1998.0,16,10,6
EGY,RUS,2020.0,7,8,-1
VNM,GBR,2018.0,16,92,-76
ITA,GBR,2001.0,144,161,-17
AUS,PAK,2019.0,23,44,-21
GBR,QAT,2020.0,42,17,25
RUS,FIN,2011.0,19,7,12
SWE,IRQ,2018.0,3,1,2
ARG,COL,2015.0,9,17,-8
GRC,AUT,2021.0,3,5,-2
IND,ZWE,2021.0,1,1,0
GBR,ZAF,2020.0,60,98,-38
IND,ETH,2021.0,40,24,16
RUS,BEL,2009.0,12,5,7
PER,GBR,2013.0,5,1,4
CAN,KWT,2018.0,8,11,-3
DZA,DEU,2020.0,4,4,0
USA,VNM,2021.0,51,28,23
FIN,USA,2013.0,76,60,16
USA,IRL,2001.0,45,42,3
DNK,RUS,2017.0,6,7,-1
ESP,BRA,1998.0,5,2,3
IRL,JPN,2005.0,3,6,-3
MTQ,FRA,2010.0,16,15,1
AUS,MYS,2012.0,78,65,13
ISL,USA,2009.0,10,13,-3
CZE,DEU,2010.0,29,28,1
DNK,GBR,2015.0,97,100,-3
FRA,IRL,2018.0,24,17,7
NOR,USA,2010.0,59,80,-21
SWE,ITA,2013.0,20,57,-37
FIN,ESP,2011.0,13,16,-3
GBR,PER,2006.0,2,2,0
JPN,TWN,2019.0,30,80,-50
USA,COL,2009.0,48,38,10
UKR,CHN,2016.0,8,4,4
AUS,IRL,2009.0,26,38,-12
GRC,CHE,2012.0,24,15,9
CAN,AUS,2010.0,168,116,52
ESP,FIN,2010.0,8,13,-5
MYS,BGD,2011.0,11,24,-13
CHN,IND,1999.0,1,1,0
CZE,ESP,2014.0,6,22,-16
ITA,HRV,2019.0,10,10,0
ESP,CHL,2006.0,27,24,3
BGD,MYS,2008.0,10,2,8
AUS,CHL,2012.0,6,10,-4
BEL,CHE,2007.0,17,28,-11
MYS,PAK,2012.0,13,29,-16
HKG,TWN,2007.0,4,4,0
TWN,HKG,2022.0,6,9,-3
DEU,CHN,1998.0,28,27,1
CAN,MEX,2003.0,11,16,-5
PAN,USA,2010.0,15,15,0
RUS,CHN,2017.0,28,12,16
FRA,PRT,2016.0,38,50,-12
AUT,BEL,2002.0,7,8,-1
RUS,SWE,1999.0,25,6,19
AUT,CZE,2019.0,18,12,6
MYS,USA,2005.0,12,17,-5
ARE,TUR,2021.0,4,5,-1
BGR,FIN,1999.0,1,1,0
USA,PER,2019.0,46,53,-7
VNM,AUS,2007.0,2,6,-4
CAN,KOR,2016.0,36,40,-4
RUS,UKR,2013.0,28,52,-24
BHS,USA,2018.0,7,4,3
ITA,CHN,2004.0,13,10,3
CHL,FRA,2014.0,24,50,-26
SAU,GBR,2016.0,53,111,-58
ZAF,USA,2001.0,52,39,13
CAN,HKG,2006.0,15,16,-1
BEL,SGP,2014.0,5,6,-1
SRB,BEL,2019.0,2,3,-1
MAC,AUS,2021.0,1,2,-1
NOR,GHA,2019.0,4,1,3
USA,MWI,2017.0,17,12,5
GRC,IRL,2018.0,11,4,7
JPN,ESP,2014.0,11,27,-16
COL,BRA,2018.0,52,70,-18
BOL,SWE,2020.0,3,3,0
MEX,SWE,2013.0,7,2,5
AUS,CZE,2020.0,12,8,4
GBR,SWE,1997.0,13,5,8
USA,FIN,2000.0,22,27,-5
UGA,NGA,2010.0,1,1,0
RUS,GBR,2011.0,33,24,9
CHE,AUT,2016.0,66,70,-4
SGP,CAN,2003.0,24,9,15
SAU,ETH,2020.0,3,2,1
CHN,NPL,2018.0,16,12,4
KAZ,DEU,2019.0,6,4,2
CZE,FRA,2021.0,11,29,-18
GBR,IND,1998.0,15,8,7
SWE,FIN,2001.0,38,28,10
USA,LBY,2022.0,1,1,0
ZAF,GHA,2002.0,2,1,1
IRL,CHE,2012.0,15,8,7
TUR,BHR,2012.0,2,1,1
NOR,FRA,2009.0,14,31,-17
USA,IRN,2003.0,32,23,9
TUR,HKG,2017.0,3,1,2
TUR,PAK,2011.0,5,3,2
YEM,MYS,2012.0,5,11,-6
SVN,BEL,2021.0,1,3,-2
FRA,DNK,2013.0,38,14,24
USA,PER,2017.0,34,37,-3
BEL,ITA,2007.0,31,34,-3
DEU,ESP,2001.0,71,57,14
USA,ARG,2004.0,59,160,-101
NGA,JPN,2006.0,2,3,-1
NLD,BGR,2007.0,1,5,-4
USA,SAU,2006.0,56,22,34
MMR,THA,2018.0,2,5,-3
LKA,AUS,2014.0,18,14,4
TUR,JPN,2001.0,4,2,2
SVK,CZE,2004.0,19,23,-4
AUT,CZE,2010.0,10,5,5
AUT,CZE,2017.0,12,14,-2
DEU,CHN,1997.0,18,15,3
USA,CMR,2002.0,8,3,5
MEX,NOR,2016.0,2,2,0
USA,FJI,2012.0,2,1,1
PAN,USA,2017.0,8,12,-4
DNK,SWE,2002.0,52,60,-8
SWE,DNK,2007.0,56,38,18
CHE,NOR,2014.0,14,7,7
DEU,NGA,2004.0,6,1,5
GHA,GBR,2002.0,2,3,-1
SRB,GBR,2007.0,5,5,0
GBR,KEN,2012.0,21,13,8
GRC,GBR,2003.0,64,129,-65
HRV,USA,2000.0,6,5,1
ZAF,AUS,2016.0,37,29,8
NLD,ESP,2004.0,39,35,4
HUN,USA,2015.0,62,59,3
CHE,IRN,2002.0,1,1,0
NOR,GRC,2017.0,1,7,-6
JPN,CAN,2010.0,85,72,13
MYS,USA,2002.0,17,9,8
BRA,DEU,2001.0,30,33,-3
FRA,RUS,1998.0,17,27,-10
MEX,CHL,1999.0,1,1,0
JPN,SWE,2005.0,23,27,-4
USA,BLR,2004.0,10,11,-1
UGA,GBR,2004.0,5,4,1
CAN,AUT,2010.0,10,22,-12
USA,KEN,2003.0,23,15,8
ZWE,USA,2000.0,1,1,0
DNK,ITA,2009.0,16,28,-12
GBR,MWI,2013.0,13,10,3
DEU,DNK,2001.0,35,43,-8
EGY,CAN,2001.0,7,5,2
DNK,ARG,2001.0,1,2,-1
CAN,THA,2004.0,3,11,-8
NLD,SVK,2019.0,4,5,-1
POL,DNK,2006.0,4,2,2
FIN,POL,2011.0,11,8,3
NLD,SVN,2011.0,4,2,2
NLD,JPN,2001.0,21,12,9
MTQ,FRA,2017.0,22,18,4
FRA,MCO,2008.0,14,3,11
FRA,AUS,2001.0,31,28,3
NZL,THA,2017.0,7,3,4
MEX,POL,2013.0,4,2,2
NOR,AUS,2015.0,11,14,-3
FIN,CHE,2003.0,7,11,-4
SGP,FIN,2009.0,4,2,2
LIE,CHE,2021.0,2,3,-1
DEU,IND,2002.0,48,73,-25
FIN,CAN,1998.0,5,2,3
BEL,ZAF,2002.0,7,2,5
GBR,CHL,2012.0,24,19,5
FRA,ZAF,2016.0,23,21,2
AUT,RUS,2007.0,7,5,2
PHL,AUS,2003.0,7,2,5
ESP,RUS,2022.0,1,7,-6
ARG,ITA,2008.0,12,21,-9
BGD,SAU,2022.0,6,4,2
CHE,DNK,2003.0,10,11,-1
IND,AUT,2001.0,2,1,1
JPN,EGY,2003.0,14,10,4
JPN,PAK,2002.0,5,6,-1
NLD,CHL,2007.0,1,1,0
FRA,SGP,2007.0,13,10,3
GBR,PHL,2005.0,4,4,0
MWI,GBR,2007.0,8,7,1
AUS,IND,2003.0,20,25,-5
SWE,EST,2010.0,11,6,5
IND,NPL,2008.0,18,17,1
AUT,ISR,2005.0,3,4,-1
EGY,ARE,2009.0,6,10,-4
ESP,CUB,2014.0,14,26,-12
HKG,NLD,2010.0,6,4,2
ARE,KOR,2017.0,2,12,-10
JPN,PER,2011.0,1,4,-3
PRT,DEU,2008.0,11,16,-5
BEL,LUX,2002.0,4,3,1
ZAF,ETH,2009.0,3,2,1
NGA,CHN,2009.0,1,3,-2
BGR,FRA,2014.0,7,7,0
POL,PRT,2005.0,2,1,1
DEU,EGY,2004.0,22,12,10
BWA,USA,2021.0,8,11,-3
FRA,IDN,2004.0,4,3,1
KOR,PRT,2013.0,3,1,2
USA,MWI,2010.0,5,11,-6
NZL,IRN,2020.0,5,23,-18
GBR,PHL,2002.0,4,3,1
SVN,SRB,2011.0,5,3,2
NLD,KEN,2013.0,3,2,1
CAN,PRI,2015.0,5,2,3
POL,AUS,2016.0,8,1,7
ROU,DEU,2010.0,18,21,-3
SWE,CAN,2014.0,33,44,-11
RUS,NLD,2010.0,13,9,4
BEL,DNK,2016.0,14,21,-7
PRT,AGO,2014.0,3,2,1
YEM,EGY,2016.0,2,4,-2
USA,ZWE,2016.0,8,5,3
PHL,THA,2018.0,4,1,3
ITA,CZE,2016.0,15,9,6
CAN,AUT,2017.0,24,14,10
CHE,ISR,2022.0,3,10,-7
THA,IDN,2011.0,4,4,0
NLD,MYS,2021.0,4,5,-1
PRT,SWE,2015.0,13,9,4
FRA,TGO,2011.0,4,2,2
NOR,BEL,2018.0,7,7,0
USA,PRT,2021.0,33,29,4
UGA,ZWE,2016.0,1,1,0
JPN,TWN,2017.0,41,63,-22
DNK,RUS,2019.0,4,4,0
BEL,JPN,2020.0,8,12,-4
PHL,JPN,2015.0,14,29,-15
IRN,POL,2013.0,3,4,-1
DEU,MAR,2021.0,4,11,-7
HUN,THA,2014.0,1,1,0
FRA,ECU,2019.0,6,4,2
BEL,FIN,2020.0,9,7,2
FRA,GRC,2002.0,21,23,-2
KEN,ITA,2018.0,2,3,-1
CHN,VNM,2013.0,6,1,5
URY,BRA,2018.0,8,11,-3
AUS,PER,2018.0,2,3,-1
HKG,SGP,2022.0,20,30,-10
GNB,DNK,2020.0,1,3,-2
TUR,AZE,2020.0,6,2,4
CZE,NOR,2021.0,3,4,-1
CHE,EGY,2020.0,5,1,4
DEU,KAZ,2021.0,5,5,0
KOR,DNK,2017.0,10,6,4
BHR,OMN,2020.0,3,2,1
GRC,NLD,2020.0,22,27,-5
GBR,COL,2021.0,7,8,-1
JPN,IRN,2015.0,11,11,0
FRA,ECU,2017.0,8,2,6
SVK,AUT,2000.0,4,2,2
ROU,DEU,2019.0,22,9,13
HKG,IRN,2020.0,3,4,-1
ZAF,MEX,2016.0,1,3,-2
CHN,HUN,2021.0,12,5,7
NGA,DEU,2020.0,3,7,-4
RUS,CHN,2010.0,6,4,2
NLD,USA,2002.0,264,261,3
ZAF,CHE,2022.0,7,3,4
BRA,IND,2013.0,2,11,-9
CZE,POL,2000.0,2,3,-1
BEL,ESP,1999.0,11,6,5
ESP,DNK,2003.0,14,8,6
IRL,DEU,2003.0,7,16,-9
AUS,SVN,2013.0,1,2,-1
GBR,IND,1997.0,7,9,-2
IRN,SGP,2013.0,18,4,14
ITA,HRV,2017.0,12,4,8
TUR,KWT,2018.0,6,1,5
ESP,POL,2018.0,23,23,0
HKG,NLD,2019.0,8,9,-1
MEX,URY,2016.0,6,3,3
SGP,TWN,2006.0,5,4,1
OMN,USA,2009.0,5,4,1
TUR,USA,1998.0,20,25,-5
HKG,KOR,2005.0,10,1,9
PAK,MEX,2015.0,2,1,1
ITA,ALB,2016.0,5,1,4
HUN,CAN,2014.0,5,4,1
SAU,CHE,2022.0,2,1,1
TUN,CHN,2021.0,6,1,5
ISR,MEX,2018.0,1,6,-5
PRT,CAN,2007.0,3,3,0
CAN,COL,2018.0,4,9,-5
DNK,CZE,2015.0,3,4,-1
EGY,GRC,2019.0,2,1,1
NGA,NOR,2018.0,1,2,-1
CHN,ROU,2022.0,2,1,1
GBR,RWA,2021.0,2,2,0
ROU,ITA,2010.0,6,17,-11
ROU,ITA,2019.0,13,12,1
BEL,HUN,2013.0,3,3,0
GHA,IND,2016.0,3,4,-1
ITA,NZL,2012.0,2,4,-2
FRA,FIN,2018.0,23,28,-5
EGY,CHN,2016.0,9,10,-1
NAM,ZAF,2018.0,8,6,2
NOR,GRC,2019.0,6,9,-3
RUS,AUS,2009.0,10,4,6
BEL,LUX,2005.0,8,1,7
GBR,CZE,1997.0,9,5,4
CUB,USA,2008.0,4,5,-1
AUT,JPN,2016.0,5,12,-7
ARE,GBR,2012.0,11,22,-11
ARE,KAZ,2013.0,2,1,1
ESP,HKG,2001.0,2,1,1
ITA,BEL,1997.0,4,3,1
RUS,IND,2000.0,3,2,1
AUS,HUN,2015.0,3,1,2
ARG,CAN,2008.0,8,10,-2
PRT,DNK,2008.0,4,1,3
BRA,VEN,2008.0,1,5,-4
ETH,SWE,2016.0,2,1,1
AUT,UKR,2008.0,1,5,-4
GBR,IRQ,2006.0,1,1,0
DEU,BEN,2002.0,3,1,2
ISR,ZAF,2002.0,2,1,1
GHA,NGA,2009.0,3,4,-1
SWE,RUS,2000.0,7,25,-18
FRA,BEN,2008.0,9,5,4
BEN,FRA,2009.0,7,11,-4
NLD,ROU,2006.0,4,3,1
HKG,NLD,2017.0,8,7,1
ESP,QAT,2016.0,4,1,3
CHL,IRL,2008.0,2,1,1
ESP,IDN,2015.0,2,2,0
AUS,PAK,2010.0,7,8,-1
ARE,KOR,2019.0,2,14,-12
BRA,TWN,2016.0,2,1,1
ITA,LUX,2011.0,6,2,4
PAK,SWE,2012.0,2,4,-2
DNK,CHL,2013.0,2,1,1
SVK,GBR,2009.0,6,7,-1
RUS,LVA,2014.0,2,3,-1
SAU,TWN,2015.0,2,17,-15
MEX,CRI,2016.0,3,2,1
NZL,PAK,2022.0,6,2,4
EGY,HUN,2020.0,2,6,-4
NLD,ARG,2020.0,5,4,1
SGP,VNM,2015.0,5,2,3
NLD,EST,2017.0,3,2,1
BEL,KHM,2017.0,2,1,1
NZL,THA,2019.0,5,4,1
FRA,CHN,2001.0,15,25,-10
ESP,HRV,2020.0,2,2,0
HUN,ROU,2009.0,8,5,3
BGR,ROU,2017.0,2,1,1
ESP,COL,2001.0,10,5,5
PRT,THA,2008.0,2,1,1
GBR,PSE,2006.0,3,1,2
HRV,DEU,2007.0,6,10,-4
HUN,CHE,2009.0,13,4,9
PAN,ESP,2022.0,1,3,-2
ITA,PRT,2006.0,12,6,6
NLD,IRL,1998.0,3,2,1
POL,DEU,1999.0,25,27,-2
FRA,SWE,1998.0,10,12,-2
DNK,RUS,2010.0,6,7,-1
BRA,BEL,2008.0,8,10,-2
MYS,BRA,2014.0,2,1,1
COL,FRA,2001.0,1,3,-2
RUS,POL,1999.0,11,7,4
NLD,SVK,2010.0,2,5,-3
SWE,SGP,2011.0,6,4,2
VEN,ARG,1997.0,1,1,0
EGY,PRT,2010.0,1,1,0
IND,FJI,2007.0,1,3,-2
BEL,COL,2013.0,3,7,-4
BIH,HRV,2001.0,2,1,1
FRA,ARE,2012.0,7,1,6
CAN,LKA,2009.0,1,2,-1
CHL,MEX,2015.0,8,18,-10
IRL,CZE,2021.0,5,5,0
SGP,CYP,2020.0,1,1,0
CAN,MWI,2015.0,1,1,0
DEU,ALB,2013.0,1,1,0
SWE,BIH,2017.0,1,1,0
IND,CMR,2019.0,2,1,1
CZE,UKR,2018.0,5,13,-8
ITA,TUR,2021.0,7,9,-2
SGP,POL,2020.0,4,2,2
GBR,HKG,1997.0,4,4,0
BWA,NGA,2014.0,2,3,-1
GEO,CHE,2012.0,1,1,0
SWE,ROU,2018.0,3,4,-1
UKR,ITA,2003.0,4,2,2
TTO,IND,2014.0,4,4,0
CHE,IRN,2005.0,3,2,1
IDN,USA,2007.0,10,17,-7
AUT,GBR,2000.0,6,10,-4
THA,USA,1999.0,9,25,-16
ISR,ZAF,2005.0,1,1,0
BGR,BEL,1999.0,1,2,-1
NOR,ESP,2001.0,3,7,-4
NLD,EGY,2014.0,5,4,1
HKG,IND,2014.0,8,8,0
UGA,NGA,2019.0,3,2,1
ETH,GBR,2003.0,6,7,-1
IRL,RUS,2010.0,2,2,0
SVK,RUS,2004.0,1,3,-2
MYS,IND,2001.0,3,2,1
NCL,USA,2012.0,1,2,-1
NZL,SWE,2000.0,1,2,-1
RUS,BGR,1998.0,2,1,1
USA,NPL,2006.0,4,6,-2
GBR,LVA,2018.0,3,1,2
NLD,IRL,1997.0,1,3,-2
CUB,ESP,1998.0,2,3,-1
GHA,GBR,2005.0,4,5,-1
LUX,NLD,2006.0,1,1,0
NZL,HKG,2000.0,2,1,1
AUS,MEX,2021.0,5,7,-2
FJI,AUS,2000.0,1,2,-1
SGP,SWE,2007.0,3,9,-6
MCO,GBR,2010.0,1,2,-1
BIH,DEU,2015.0,2,2,0
BEN,CAN,2012.0,1,1,0
SWE,GRC,2009.0,2,10,-8
CAN,DZA,2011.0,4,4,0
SAU,ITA,2016.0,6,21,-15
IRL,RUS,2019.0,3,3,0
CAN,MAR,2015.0,8,5,3
ITA,SRB,2008.0,2,4,-2
ITA,LBN,2012.0,1,1,0
UZB,RUS,2012.0,2,3,-1
GBR,SYR,2015.0,4,5,-1
ROU,NLD,2015.0,7,3,4
LVA,USA,2016.0,4,3,1
MYS,BRN,2022.0,5,4,1
LTU,FIN,2004.0,2,3,-1
JOR,DEU,2011.0,6,9,-3
OMN,CAN,2014.0,4,3,1
NPL,BGD,2014.0,1,1,0
IRL,ARG,2019.0,1,3,-2
IRN,IND,2015.0,4,23,-19
CHE,POL,2004.0,6,13,-7
CAN,MLI,2018.0,3,2,1
ESP,MAR,2008.0,7,11,-4
USA,CMR,2005.0,5,5,0
RUS,KOR,2009.0,12,7,5
UZB,ITA,2004.0,3,1,2
JPN,CHE,2000.0,5,9,-4
AFG,USA,2007.0,1,2,-1
JPN,RUS,2006.0,20,17,3
ITA,ZAF,2008.0,5,4,1
KOR,NPL,2016.0,6,3,3
SAU,TUR,2021.0,4,7,-3
DNK,NLD,2007.0,7,13,-6
SAU,HKG,2018.0,7,2,5
HUN,POL,2002.0,1,6,-5
UZB,USA,2000.0,2,1,1
SAU,NOR,2013.0,2,1,1
AUT,TUR,2016.0,5,12,-7
BGD,ARE,2019.0,1,2,-1
SGP,BRA,2015.0,3,6,-3
CAN,BRB,2011.0,2,1,1
SDN,GBR,2006.0,1,2,-1
GBR,ETH,2009.0,3,4,-1
IRL,GRC,2013.0,3,6,-3
UZB,DEU,2013.0,4,2,2
UGA,NGA,2017.0,2,2,0
MAR,CAN,2014.0,3,9,-6
MYS,CHL,2019.0,1,1,0
ITA,HRV,2010.0,1,4,-3
MNE,SRB,2003.0,1,1,0
HUN,ZAF,2022.0,1,1,0
DEU,HRV,1999.0,6,2,4
BOL,DEU,2019.0,1,2,-1
NLD,EST,2019.0,3,1,2
AUS,KWT,2020.0,6,2,4
FRA,CMR,2000.0,4,4,0
SWE,EST,2019.0,5,8,-3
BRA,ROU,2020.0,2,1,1
ITA,KAZ,2020.0,2,1,1
PHL,DEU,2020.0,7,4,3
IRN,GHA,2019.0,2,2,0
RUS,BRA,2020.0,5,9,-4
VEN,FRA,2015.0,6,2,4
CHE,MAR,2016.0,1,1,0
KGZ,RUS,2012.0,2,2,0
PRT,CHE,1999.0,4,1,3
GRC,AUS,2007.0,4,5,-1
EST,FIN,2014.0,7,14,-7
FRA,GAB,2003.0,3,9,-6
DZA,EGY,2019.0,1,2,-1
BTN,AUS,2020.0,7,3,4
OMN,FRA,2020.0,1,1,0
UKR,BEL,2004.0,3,5,-2
GRC,CHN,2004.0,1,1,0
ISR,GRC,2004.0,2,1,1
MEX,ISR,2013.0,2,2,0
TUR,CYP,2008.0,6,3,3
ARG,NLD,2007.0,1,3,-2
USA,PYF,2002.0,1,2,-1
NZL,ZAF,2014.0,3,3,0
ARM,CHE,2013.0,1,1,0
LBY,MYS,2020.0,4,10,-6
IRL,ARG,2017.0,1,1,0
PAK,NZL,2013.0,2,8,-6
RUS,CHL,2016.0,2,1,1
MAC,HKG,2008.0,3,5,-2
CAN,URY,2007.0,1,1,0
POL,HUN,2015.0,3,2,1
ARE,OMN,2018.0,4,7,-3
SWE,TZA,2018.0,3,4,-1
KEN,DEU,2013.0,5,6,-1
PAK,HUN,2020.0,2,1,1
FIN,BGR,2006.0,1,1,0
TUR,OMN,2008.0,2,1,1
ARG,PRT,2009.0,1,1,0
QAT,OMN,2015.0,2,2,0
SRB,BEL,2017.0,3,2,1
CAN,JOR,2001.0,2,2,0
ZMB,GBR,2016.0,5,5,0
AUT,SGP,2011.0,2,2,0
MAR,SWE,2021.0,2,1,1
CHN,ESP,2003.0,4,3,1
IND,ZAF,2001.0,2,7,-5
LUX,FIN,2011.0,1,1,0
IRL,DNK,2003.0,2,3,-1
SVK,DNK,2011.0,2,1,1
IDN,PHL,2009.0,1,1,0
KNA,USA,2012.0,1,3,-2
IRL,THA,2014.0,1,1,0
JOR,ITA,2014.0,1,3,-2
ZAF,PAK,2016.0,2,2,0
IRN,THA,2019.0,1,2,-1
KOR,GRC,2012.0,1,1,0
NPL,AUS,2004.0,1,1,0
PSE,TUR,2019.0,2,4,-2
AUT,VNM,2009.0,2,1,1
RUS,ZAF,2014.0,4,1,3
UGA,AUS,2020.0,5,1,4
CHN,AFG,2020.0,2,1,1
MEX,GTM,2021.0,3,2,1
ESP,ISR,2000.0,1,3,-2
MEX,CZE,2015.0,1,2,-1
SYR,ARE,2021.0,1,1,0
TUR,QAT,2018.0,6,2,4
CZE,HRV,2004.0,2,1,1
ISR,CZE,2006.0,1,1,0
ETH,NLD,2009.0,2,2,0
MLI,BFA,2013.0,1,2,-1
BRA,GRC,2019.0,1,2,-1
MAR,ESP,2006.0,4,4,0
ITA,URY,2006.0,1,1,0
BGR,CAN,2018.0,2,3,-1
BEL,DZA,2011.0,2,1,1
PRT,SRB,2021.0,1,2,-1
NLD,HKG,2000.0,1,1,0
KOR,DNK,2010.0,4,2,2
JPN,ISR,2011.0,2,7,-5
FRA,NOR,1997.0,2,1,1
DEU,BGD,2011.0,4,8,-4
GBR,COG,2010.0,1,1,0
OMN,KWT,2005.0,1,1,0
ETH,ITA,2021.0,3,4,-1
DEU,TUN,2021.0,3,4,-1
BRA,PRY,2014.0,2,2,0
ZAF,KEN,2003.0,2,4,-2
SDN,ARE,1997.0,1,1,0
HKG,KOR,2002.0,3,2,1
BHR,ARE,2020.0,1,1,0
TZA,NLD,2021.0,1,3,-2
UGA,KEN,2007.0,2,1,1
ARG,AUT,2014.0,5,1,4
LSO,GBR,2018.0,1,1,0
ESP,IRL,2001.0,3,1,2
KAZ,DEU,2017.0,4,5,-1
SWE,HKG,2014.0,1,8,-7
ZAF,SWE,2003.0,3,6,-3
VNM,BEL,2000.0,1,1,0
SAU,QAT,2005.0,1,2,-1
HUN,FIN,2013.0,2,2,0
ETH,TWN,2014.0,2,1,1
ZAF,PRT,2013.0,1,1,0
CAN,SEN,2015.0,2,3,-1
IRQ,JOR,2021.0,1,4,-3
NAM,GBR,2017.0,1,1,0
LBR,NGA,2018.0,1,1,0
BEL,BOL,2008.0,1,1,0
UKR,DNK,2017.0,2,1,1
BLR,USA,2013.0,2,4,-2
RUS,TUR,2003.0,6,5,1
NLD,ETH,2021.0,3,2,1
JPN,ROU,2001.0,2,7,-5
LKA,KOR,2018.0,2,4,-2
CAN,TUN,2006.0,4,1,3
FIN,CAN,1997.0,2,1,1
MWI,USA,2003.0,1,6,-5
ISR,FRA,1999.0,8,13,-5
RUS,COL,2006.0,4,4,0
ESP,BRA,1997.0,2,6,-4
CHL,AUS,2005.0,1,1,0
USA,COD,2022.0,1,3,-2
PHL,SGP,2009.0,2,3,-1
ZAF,NZL,2014.0,3,3,0
ZMB,USA,2008.0,1,5,-4
CZE,NZL,2014.0,2,2,0
BOL,DEU,2010.0,1,2,-1
SVK,CHE,2020.0,2,4,-2
CAN,OMN,2021.0,2,2,0
CHE,HUN,2000.0,2,5,-3
COG,NGA,2020.0,1,1,0
DEU,NPL,2020.0,2,4,-2
EGY,GHA,2021.0,1,2,-1
UKR,SWE,2003.0,3,1,2
KOR,TZA,2015.0,1,1,0
ARE,QAT,2005.0,1,1,0
CHN,IDN,2012.0,1,2,-1
IRL,JPN,2002.0,1,3,-2
ZAF,SWZ,2013.0,1,1,0
QAT,EGY,2004.0,1,5,-4
CHL,AUS,2002.0,3,2,1
CAF,MDG,2008.0,2,1,1
BEL,LBN,2013.0,2,3,-1
MWI,ZAF,2013.0,3,2,1
CHL,ROU,2009.0,2,1,1
MYS,AUT,2012.0,1,4,-3
PSE,GBR,2020.0,3,3,0
MNG,DEU,2016.0,1,1,0
NLD,SVK,2017.0,2,5,-3
IND,MUS,2017.0,1,1,0
DZA,ESP,2020.0,3,11,-8
SWE,AUT,1999.0,2,1,1
PSE,TUR,2017.0,1,4,-3
VNM,NOR,2011.0,1,1,0
NLD,PER,2016.0,1,1,0
ECU,BEL,2015.0,1,5,-4
DNK,SAU,2019.0,1,3,-2
TZA,KEN,2022.0,2,1,1
BGD,NOR,2014.0,2,1,1
IRL,MWI,2018.0,1,2,-1
VNM,SWE,2005.0,2,1,1
AUS,MWI,2017.0,1,1,0
FRA,NER,2011.0,2,5,-3
SVK,POL,2022.0,1,2,-1
ROU,CHN,2013.0,1,1,0
PRT,MYS,2022.0,1,1,0
CHE,CZE,1998.0,1,5,-4
MAR,SAU,2020.0,3,6,-3
PHL,MYS,2012.0,1,1,0
SRB,CAN,2013.0,1,2,-1
NZL,PHL,2014.0,1,3,-2
NOR,TUN,2018.0,1,1,0
NZL,BLR,2018.0,1,1,0
GHA,AUS,2010.0,1,4,-3
VEN,NLD,2005.0,1,1,0
ROU,IRQ,2014.0,1,1,0
ESP,AND,2011.0,1,7,-6
AUT,BIH,2019.0,2,1,1
SGP,ZAF,2021.0,1,1,0
TTO,CAN,2003.0,1,1,0
EGY,NOR,2015.0,2,3,-1
DEU,OMN,2012.0,3,1,2
COG,ESP,2018.0,1,2,-1
CUB,ESP,1997.0,1,3,-2
CZE,AUS,2008.0,1,3,-2
BEL,KHM,2010.0,1,1,0
DNK,CYP,2021.0,1,1,0
ZAF,ISR,2003.0,1,3,-2
SGP,RUS,2022.0,1,2,-1
BEL,PAK,2014.0,1,1,0
ARE,SGP,2020.0,2,10,-8
BGR,AUT,2018.0,1,3,-2
USA,BLZ,2013.0,1,1,0
CHL,JPN,2021.0,1,2,-1
BGR,PRT,2021.0,1,1,0
NZL,THA,2010.0,3,5,-2
QAT,LBN,2015.0,2,2,0
SWE,QAT,2014.0,1,1,0
RUS,SRB,2005.0,1,1,0
BGR,NOR,2002.0,1,1,0
VNM,DEU,2004.0,2,2,0
DEU,VNM,2004.0,2,2,0
ARE,DNK,2009.0,1,1,0
IND,ROU,2008.0,1,1,0
LUX,PRT,2015.0,1,2,-1
IND,HUN,2013.0,1,4,-3
DEU,VEN,2002.0,3,2,1
LBN,CHE,2008.0,1,1,0
SDN,IRL,2013.0,1,1,0
GMB,USA,2016.0,1,4,-3
DZA,DNK,2019.0,1,1,0
VNM,POL,2019.0,2,3,-1
NOR,GHA,2017.0,1,1,0
KAZ,UKR,2019.0,2,1,1
AUS,PHL,2000.0,1,2,-1
BRA,FIN,2004.0,1,1,0
JOR,CHE,2018.0,1,2,-1
JPN,BEN,2009.0,1,1,0
SRB,AUT,2022.0,1,1,0
PER,COL,2015.0,1,5,-4
IND,SVN,2009.0,1,1,0
BFA,CAN,2016.0,2,1,1
COG,FRA,2020.0,1,1,0
ESP,GBR,2012.0,283,247,36
GBR,IRL,2006.0,158,123,35
CHE,USA,2018.0,561,518,43
KEN,ZAF,2011.0,10,8,2
DEU,USA,2001.0,959,823,136
USA,GBR,2008.0,1289,1250,39
FRA,GUF,2018.0,26,26,0
CHL,ESP,2012.0,43,68,-25
USA,BRA,2004.0,221,224,-3
GBR,CHE,2011.0,230,161,69
ITA,SWE,2004.0,18,12,6
USA,JPN,2006.0,911,1082,-171
TUR,CAN,2019.0,45,15,30
SWE,NLD,2003.0,36,35,1
POL,NLD,2014.0,43,12,31
CYP,GBR,2018.0,25,39,-14
PAK,CHN,2022.0,126,231,-105
BGR,SWE,2014.0,5,1,4
CHN,BEL,2012.0,34,25,9
MYS,CAN,2016.0,14,9,5
SGP,AUS,2019.0,95,79,16
RUS,NLD,2017.0,18,18,0
RUS,VNM,2016.0,13,4,9
MEX,ECU,2017.0,14,5,9
SAU,ESP,2022.0,2,5,-3
GHA,AUS,2019.0,13,8,5
AUS,MWI,2019.0,2,3,-1
CZE,DEU,2017.0,53,47,6
BEN,BEL,2021.0,3,3,0
USA,DNK,2003.0,87,106,-19
CAN,IRN,2003.0,30,30,0
EGY,PRT,2017.0,1,1,0
ROU,GBR,2008.0,14,9,5
IRL,TUR,2011.0,4,4,0
JPN,TWN,2010.0,44,22,22
NOR,USA,2019.0,71,102,-31
TUR,CHL,2016.0,1,1,0
JPN,NPL,2020.0,11,6,5
GBR,HKG,1998.0,17,6,11
FRA,RUS,1997.0,15,14,1
JOR,USA,2007.0,18,47,-29
CZE,IRN,2015.0,1,8,-7
TUN,DZA,2021.0,5,3,2
CZE,AUT,2018.0,17,14,3
AUS,PAK,2017.0,17,28,-11
KOR,DNK,2019.0,11,7,4
SAU,AUS,2016.0,16,60,-44
ISR,KOR,2016.0,3,1,2
FIN,JPN,2006.0,4,8,-4
USA,MWI,2019.0,17,26,-9
ZAF,NLD,2006.0,6,11,-5
POL,IRL,2012.0,5,2,3
NOR,DNK,2012.0,15,22,-7
CAN,BRA,2005.0,27,37,-10
ESP,ARG,1999.0,21,14,7
TUR,UKR,2002.0,5,1,4
SWE,AUS,2008.0,35,22,13
GBR,CZE,1998.0,13,6,7
GBR,GIB,2020.0,4,1,3
BEL,DEU,2008.0,41,61,-20
SGP,NZL,2000.0,5,6,-1
BEL,ZAF,2005.0,5,4,1
AZE,TUR,2005.0,5,2,3
ISR,JPN,2009.0,3,6,-3
AUS,BRA,1999.0,4,2,2
HRV,FRA,2007.0,5,1,4
LTU,CAN,2007.0,1,2,-1
AZE,IRN,2009.0,5,1,4
EST,BEL,2022.0,2,2,0
UKR,AUT,2011.0,2,1,1
MYS,NPL,2009.0,1,1,0
MKD,NLD,2016.0,3,2,1
AUS,JOR,2014.0,7,3,4
DEU,CZE,1999.0,10,10,0
DNK,AUS,2022.0,10,14,-4
JPN,SWE,2002.0,38,31,7
SWE,IRN,2011.0,17,24,-7
KWT,CAN,1999.0,1,2,-1
GBR,LTU,2018.0,7,12,-5
EGY,GBR,2006.0,8,21,-13
IND,HKG,2012.0,7,4,3
ARE,DEU,2016.0,2,10,-8
MYS,LKA,2017.0,7,3,4
UGA,TZA,2021.0,4,2,2
PSE,MYS,2012.0,2,3,-1
NOR,AUT,2006.0,3,3,0
CZE,RUS,2004.0,4,5,-1
SGP,MYS,2006.0,10,9,1
DNK,ISR,2007.0,2,3,-1
JPN,ZAF,2011.0,4,1,3
ZWE,ZAF,2009.0,21,2,19
MKD,SRB,2015.0,2,1,1
CAN,PAK,2012.0,6,19,-13
CHN,TUR,2018.0,4,9,-5
LBN,BEL,2015.0,3,3,0
PRT,RUS,2022.0,2,4,-2
COL,RUS,2019.0,1,2,-1
FRA,NGA,2020.0,1,5,-4
JPN,MEX,2012.0,4,3,1
ZAF,SAU,2007.0,2,1,1
TUR,USA,1997.0,4,12,-8
POL,KOR,2011.0,1,3,-2
ESP,SVN,2020.0,2,6,-4
FRA,KWT,2016.0,1,1,0
AUS,DNK,2022.0,14,10,4
PAK,TUR,2014.0,3,4,-1
SWE,POL,2003.0,8,10,-2
JPN,POL,1997.0,3,7,-4
RUS,SVK,2009.0,6,1,5
IND,NZL,2008.0,9,2,7
RUS,NZL,2018.0,5,1,4
FIN,HUN,2021.0,2,2,0
ARG,SWE,2015.0,3,3,0
FRA,SWE,1997.0,8,4,4
ISR,POL,2013.0,10,6,4
IRL,BRA,2008.0,3,4,-1
JPN,MAC,2013.0,1,1,0
BRA,PAK,2016.0,8,3,5
GHA,SEN,2022.0,1,1,0
IRL,AUT,2021.0,4,2,2
ITA,ECU,2021.0,2,5,-3
DEU,PAK,2001.0,1,4,-3
KOR,LKA,2014.0,2,2,0
HRV,CHE,2008.0,6,1,5
VNM,KOR,2004.0,1,2,-1
TUR,KAZ,2007.0,1,1,0
ITA,BEL,1998.0,4,3,1
DEU,SVN,2001.0,1,5,-4
SVK,HUN,2015.0,2,7,-5
IRL,NZL,2011.0,2,8,-6
GHA,NZL,2019.0,3,4,-1
POL,BLR,2021.0,2,2,0
DEU,MLT,2018.0,3,1,2
BHR,CAN,2004.0,2,1,1
COL,IND,2005.0,1,1,0
COL,NOR,2014.0,1,1,0
NGA,PAK,2022.0,1,1,0
FRA,NOR,1998.0,2,1,1
DNK,SGP,2013.0,5,3,2
AUS,LUX,2018.0,1,3,-2
PRT,IRL,2022.0,2,4,-2
NOR,GRC,2010.0,1,5,-4
CHL,POL,2018.0,2,3,-1
IRL,TWN,2012.0,2,1,1
QAT,NZL,2017.0,1,1,0
NZL,GHA,2015.0,1,1,0
ITA,UKR,2004.0,1,3,-2
PAK,NGA,2017.0,1,1,0
PSE,JOR,2015.0,1,1,0
CAN,JAM,2018.0,2,5,-3
SRB,DNK,2013.0,1,1,0
MYS,LKA,2010.0,1,2,-1
BLR,CZE,2013.0,1,1,0
AUS,KAZ,2016.0,3,1,2
VNM,ITA,2012.0,1,2,-1
BGD,AUS,2002.0,2,1,1
FRA,CRI,2021.0,1,1,0
AUS,PNG,1997.0,1,1,0
BEL,HRV,2018.0,1,3,-2
VEN,BRA,2000.0,1,4,-3
BHR,MYS,2016.0,1,1,0
ITA,UZB,2018.0,1,1,0
EGY,BEL,2007.0,1,3,-2
,NOR,2004.0,1761,0,1761
,CAN,2004.0,10934,0,10934
DEU,,2024.0,129793,0,129793
,HRV,2003.0,862,0,862
TWN,,2017.0,6525,0,6525
CAN,,2022.0,23168,0,23168
,BFA,2004.0,87,0,87
BFA,,2015.0,44,0,44
IRN,,2009.0,546,0,546
TWN,,2010.0,3159,0,3159
TUR,,2022.0,12981,0,12981
CZE,,2010.0,911,0,911
BRA,,2013.0,6805,0,6805
,CAN,1996.0,4443,0,4443
IDN,,2023.0,14798,0,14798
SRB,,2015.0,627,0,627
,NZL,2005.0,1414,0,1414
,FRA,2010.0,14782,0,14782
BLR,,2021.0,454,0,454
AUT,,2007.0,852,0,852
,ETH,2004.0,163,0,163
FRA,,2002.0,1371,0,1371
,GBR,2012.0,20508,0,20508
TWN,,2019.0,6563,0,6563
KOR,,2022.0,24320,0,24320
,FIN,1997.0,1379,0,1379
,ESP,2015.0,13421,0,13421
,MEX,1995.0,1574,0,1574
,NOR,1996.0,721,0,721
BIH,,2022.0,453,0,453
,IRL,2019.0,998,0,998
NZL,,2021.0,2175,0,2175
NOR,,2000.0,48,0,48
,IND,2015.0,30069,0,30069
LVA,,2017.0,171,0,171
CZE,,2017.0,1740,0,1740
,UZB,2007.0,90,0,90
,GRC,2007.0,2848,0,2848
,PAK,2003.0,1141,0,1141
ROU,ISR,2011.0,1,0,1
FRO,,2018.0,4,0,4
,NZL,2002.0,1268,0,1268
CUB,AUS,2005.0,1,0,1
CZE,,2019.0,2456,0,2456
FRA,,2005.0,4669,0,4669
TZA,DNK,2012.0,2,0,2
COG,,2020.0,99,0,99
MYS,,2020.0,3814,0,3814
COL,,2015.0,605,0,605
,HUN,2014.0,1613,0,1613
RWA,,2023.0,288,0,288
CUB,,2010.0,354,0,354
UGA,,2021.0,330,0,330
CUB,,2017.0,692,0,692
CUB,,2019.0,719,0,719
,BRA,2014.0,20891,0,20891
PHL,,2012.0,89,0,89
MAR,,2018.0,716,0,716
,FRA,2017.0,11489,0,11489
,PRT,2016.0,3024,0,3024
,FIN,1998.0,3693,0,3693
LBY,,2011.0,33,0,33
IRL,LBY,2012.0,3,0,3
IRL,CIV,2011.0,1,0,1
,IRL,2010.0,1671,0,1671
,TUN,2013.0,1481,0,1481
,DNK,2011.0,2763,0,2763
MLI,,2022.0,122,0,122
,DZA,2006.0,907,0,907
,FRA,2019.0,5613,0,5613
MYS,NOR,2014.0,2,0,2
,MYS,2018.0,4283,0,4283
ALB,,2014.0,29,0,29
,MAC,2011.0,124,0,124
VEN,PER,2017.0,5,0,5
,MDA,2012.0,67,0,67
LVA,,2019.0,200,0,200
LUX,,2016.0,92,0,92
BGD,TUR,2018.0,1,0,1
IRL,,2006.0,307,0,307
,SEN,2009.0,143,0,143
VNM,MAC,2016.0,1,0,1
,COG,2014.0,102,0,102
SVK,FIN,2020.0,1,0,1
,IRL,2017.0,1637,0,1637
,LKA,2000.0,149,0,149
,MLI,2013.0,38,0,38
ZAF,ARE,2015.0,3,0,3
NCL,,2023.0,71,0,71
,TGO,2015.0,33,0,33
ROU,ARM,2020.0,1,0,1
MEX,BLR,2018.0,1,0,1
ISR,,2006.0,821,0,821
,CIV,2018.0,69,0,69
,GEO,2008.0,104,0,104
LVA,,2010.0,55,0,55
LIE,,2017.0,7,0,7
KHM,COL,2012.0,3,0,3
PAK,,2004.0,130,0,130
HKG,THA,2002.0,1,0,1
MWI,,2012.0,20,0,20
DNK,SAU,2017.0,3,0,3
UKR,ESP,2000.0,4,0,4
BWA,GBR,2009.0,4,0,4
AUT,KOR,2011.0,10,0,10
NZL,MAC,2013.0,1,0,1
,MMR,2011.0,18,0,18
,ETH,1996.0,17,0,17
ZAF,,2004.0,278,0,278
,NAM,2007.0,13,0,13
DNK,,2001.0,38,0,38
PAK,EST,2018.0,2,0,2
,MDG,2013.0,67,0,67
,AND,2006.0,2,0,2
GHA,NZL,2017.0,4,0,4
PAN,,2008.0,7,0,7
,SWZ,2014.0,12,0,12
CZE,KGZ,2020.0,1,0,1
KEN,GBR,1999.0,4,0,4
MYS,KAZ,2020.0,3,0,3
VEN,ITA,2020.0,1,0,1
,NIC,2009.0,34,0,34
LIE,,2019.0,7,0,7
NGA,RWA,2019.0,1,0,1
AGO,,2018.0,11,0,11
MDA,LTU,2016.0,1,0,1
QAT,,2007.0,22,0,22
LTU,FRA,2016.0,4,0,4
GUY,,2005.0,4,0,4
,SUR,2003.0,3,0,3
CHN,LBY,2009.0,1,0,1
MTQ,,2011.0,6,0,6
IND,POL,2007.0,7,0,7
,LIE,2003.0,13,0,13
BGD,AUS,2005.0,3,0,3
CUB,AUS,2002.0,2,0,2
KNA,,2016.0,3,0,3
POL,SVN,2000.0,2,0,2
GBR,NGA,1997.0,1,0,1
POL,ZMB,2006.0,1,0,1
DOM,ESP,1998.0,1,0,1
LIE,,2010.0,9,0,9
MYS,ARE,2006.0,5,0,5
,MCO,1999.0,6,0,6
,GUM,2013.0,7,0,7
,VUT,2006.0,4,0,4
BLR,DEU,2015.0,4,0,4
NLD,CYP,2003.0,1,0,1
POL,PRT,2002.0,3,0,3
HUN,ETH,2006.0,1,0,1
YEM,,2006.0,4,0,4
JPN,ARE,2014.0,1,0,1
VEN,IND,2006.0,1,0,1
HKG,,1999.0,26,0,26
KOR,CHE,2000.0,3,0,3
SRB,BEL,2010.0,2,0,2
RUS,SRB,2002.0,1,0,1
,SLE,2009.0,15,0,15
IND,CZE,2008.0,2,0,2
SVK,FRA,2014.0,4,0,4
ARG,NOR,2007.0,1,0,1
BHR,TUR,2005.0,2,0,2
TGO,,2015.0,15,0,15
BEL,CIV,2015.0,5,0,5
ITA,AGO,2014.0,1,0,1
AZE,TUR,2002.0,2,0,2
GIN,GNQ,2020.0,4,0,4
,PAN,2008.0,44,0,44
PHL,NZL,2015.0,5,0,5
NZL,BRB,2011.0,1,0,1
NCL,CHE,2016.0,1,0,1
EST,CZE,2013.0,3,0,3
CUB,CHL,2006.0,3,0,3
UKR,DNK,2019.0,1,0,1
LTU,PRT,2014.0,1,0,1
VNM,AUT,2016.0,2,0,2
QAT,PRT,2022.0,1,0,1
GHA,BFA,2016.0,1,0,1
ZAF,JOR,2017.0,2,0,2
JOR,POL,2015.0,1,0,1
,AGO,2016.0,10,0,10
,TTO,1999.0,56,0,56
,BFA,1996.0,24,0,24
ATG,USA,2012.0,1,0,1
KHM,,2014.0,13,0,13
,GIN,2004.0,18,0,18
ESP,SLV,2017.0,1,0,1
,GNB,2003.0,5,0,5
GNB,,2015.0,6,0,6
THA,MWI,2012.0,1,0,1
GHA,SGP,2016.0,2,0,2
KAZ,TTO,2017.0,1,0,1
MCO,GBR,2019.0,1,0,1
ZAF,QAT,2016.0,5,0,5
,ERI,2017.0,15,0,15
FJI,CHE,2003.0,1,0,1
BFA,GBR,2000.0,1,0,1
,PSE,1994.0,9,0,9
AUT,SRB,2002.0,1,0,1
ZAF,MOZ,2005.0,2,0,2
NLD,PHL,2001.0,3,0,3
GBR,NIC,2011.0,1,0,1
CAN,GRC,1998.0,2,0,2
IND,MWI,2003.0,1,0,1
SGP,EGY,2002.0,1,0,1
NGA,KWT,2011.0,1,0,1
KEN,IRL,2007.0,1,0,1
TTO,NZL,2008.0,1,0,1
GAB,,2007.0,5,0,5
CIV,DEU,2009.0,1,0,1
CAN,IDN,2013.0,5,0,5
NOR,QAT,2021.0,2,0,2
COL,TWN,2014.0,1,0,1
NOR,UGA,2006.0,1,0,1
,SLV,2003.0,3,0,3
BEN,KEN,2014.0,1,0,1
SLV,,2008.0,4,0,4
SVN,ARE,2017.0,1,0,1
BEL,CMR,2003.0,3,0,3
GRC,OMN,2013.0,1,0,1
SWE,NER,2013.0,1,0,1
GRC,TWN,2020.0,1,0,1
MKD,DNK,2013.0,1,0,1
UKR,TWN,2000.0,1,0,1
GUF,,2015.0,5,0,5
CAN,PHL,2006.0,3,0,3
GBR,SLE,2006.0,1,0,1
LVA,FIN,2012.0,1,0,1
ROU,RUS,2015.0,1,0,1
IRN,GRC,2016.0,1,0,1
JPN,KHM,2007.0,2,0,2
TWN,ARE,2022.0,3,0,3
ETH,SWZ,2015.0,1,0,1
THA,IND,1999.0,1,0,1
MAC,,2005.0,1,0,1
GRC,ALB,2011.0,2,0,2
TZA,DEU,2008.0,2,0,2
ZAF,COL,2004.0,2,0,2
AUS,CCK,2010.0,1,0,1
EGY,TUR,2011.0,1,0,1
NOR,VNM,2008.0,1,0,1
PRT,YEM,2015.0,1,0,1
PHL,CHL,2021.0,1,0,1
SWE,ERI,2004.0,1,0,1
DNK,MKD,2015.0,1,0,1
GRC,PSE,2019.0,2,0,2
POL,ARG,2016.0,1,0,1
,BRN,2001.0,4,0,4
JPN,SGP,2000.0,5,0,5
PAK,CHE,2009.0,2,0,2
BFA,MLI,2007.0,2,0,2
DZA,CMR,2006.0,1,0,1
RUS,KWT,2015.0,1,0,1
VEN,DNK,2018.0,1,0,1
BGR,EGY,2016.0,1,0,1
EGY,GRC,2017.0,2,0,2
AND,,2020.0,2,0,2
ISL,SGP,2014.0,1,0,1
IND,MUS,2019.0,3,0,3
PAK,POL,2019.0,2,0,2
BWA,IND,2015.0,1,0,1
MMR,,2015.0,6,0,6
FIN,MWI,2018.0,1,0,1
ESP,SLV,2019.0,3,0,3
TKM,,2015.0,1,0,1
NCL,FJI,2011.0,1,0,1
DEU,LBY,1999.0,1,0,1
LKA,PHL,2005.0,1,0,1
TWN,IDN,2005.0,1,0,1
GUM,FSM,2014.0,1,0,1
CHE,SGP,2004.0,6,0,6
NOR,CZE,2004.0,2,0,2
RUS,AZE,2007.0,1,0,1
FIN,AGO,2013.0,1,0,1
AFG,,2012.0,5,0,5
BGD,POL,2012.0,1,0,1
PSE,FRA,2005.0,2,0,2
OMN,MAR,2013.0,2,0,2
USA,MHL,2006.0,2,0,2
NLD,RWA,2005.0,1,0,1
BRA,IRL,2004.0,1,0,1
RUS,BGR,1997.0,2,0,2
HUN,PAK,1999.0,1,0,1
YEM,IRQ,2006.0,1,0,1
CUB,CHN,2007.0,1,0,1
MEX,KEN,2021.0,1,0,1
DZA,RUS,2019.0,1,0,1
GMB,CHE,2006.0,1,0,1
TUR,CHN,2005.0,1,0,1
JOR,SDN,2007.0,1,0,1
IRL,KEN,2020.0,2,0,2
BEL,HKG,2006.0,1,0,1
MLI,CHE,2011.0,1,0,1
CHN,LAO,2021.0,2,0,2
BLR,KOR,2016.0,1,0,1
ESP,MLI,2022.0,1,0,1
DNK,CMR,2007.0,1,0,1
KEN,SVN,2010.0,1,0,1
BRA,SGP,2009.0,1,0,1
DNK,ETH,2003.0,2,0,2
LKA,IND,2003.0,1,0,1
SWE,SVN,2000.0,1,0,1
IND,UZB,2022.0,2,0,2
MEX,EST,1998.0,1,0,1
CAN,HRV,2021.0,1,0,1
ISL,NZL,2007.0,1,0,1
AUS,OMN,1999.0,1,0,1
MUS,IND,2005.0,1,0,1
BEL,PHL,2021.0,2,0,2
ZWE,MWI,2003.0,1,0,1
IRQ,LBY,2002.0,1,0,1
,GUY,1996.0,1,0,1
,ERI,2010.0,2,0,2
PAK,AUT,2003.0,2,0,2
AUT,BLR,2015.0,1,0,1
KEN,GHA,2012.0,1,0,1
SYR,AUS,2002.0,1,0,1
BEL,LBR,2011.0,1,0,1
SVK,BRA,2014.0,1,0,1
MEX,NIC,2012.0,2,0,2
SYR,MAR,2014.0,4,0,4
DNK,THA,2016.0,3,0,3
NZL,MEX,2014.0,3,0,3
PER,CUB,2016.0,1,0,1
CHN,MLI,2021.0,1,0,1
MLI,SEN,2005.0,2,0,2
ITA,TZA,2013.0,2,0,2
ETH,SAU,2015.0,3,0,3
MWI,CAN,2011.0,4,0,4
CYP,PRT,2015.0,1,0,1
CHN,NAM,2009.0,2,0,2
SEN,CAF,2011.0,1,0,1
KWT,HUN,2020.0,1,0,1
MCO,NLD,2007.0,1,0,1
COL,IRL,2018.0,3,0,3
KEN,BDI,2019.0,1,0,1
BHR,IDN,2020.0,1,0,1
MAR,MLI,2020.0,1,0,1
ARM,ISR,2019.0,1,0,1
,GUY,2004.0,5,0,5
BHR,KWT,2007.0,1,0,1
ITA,SAU,1999.0,1,0,1
URY,HUN,1999.0,1,0,1
UKR,CHE,2000.0,1,0,1
ARG,PAN,2011.0,1,0,1
SRB,FIN,2015.0,1,0,1
URY,NOR,2017.0,1,0,1
IRN,THA,2017.0,2,0,2
KWT,NLD,2013.0,1,0,1
CHN,UGA,2006.0,1,0,1
AUT,MNG,2014.0,2,0,2
DEU,MWI,2011.0,1,0,1
CZE,ISL,2013.0,1,0,1
MAR,LUX,2016.0,1,0,1
IRL,ARG,2010.0,1,0,1
NLD,TGO,2015.0,1,0,1
GRC,SVN,2020.0,1,0,1
HRV,SWE,2009.0,1,0,1
NIC,CRI,2002.0,1,0,1
BRA,CRI,2003.0,1,0,1
FRA,UGA,2011.0,2,0,2
GEO,TUR,2009.0,1,0,1
LUX,CAN,2016.0,2,0,2
ERI,CHN,2021.0,3,0,3
MDG,MUS,2018.0,1,0,1
CUB,NLD,2009.0,1,0,1
CMR,CAF,2009.0,2,0,2
ARM,CZE,2011.0,1,0,1
DEU,BEN,2005.0,1,0,1
IND,SVK,2006.0,1,0,1
GBR,NGA,1998.0,2,0,2
NAM,AUS,2000.0,1,0,1
,MUS,1994.0,5,0,5
SEN,DNK,2002.0,1,0,1
IND,EGY,2012.0,2,0,2
ARE,HUN,2006.0,1,0,1
GBR,MDA,2003.0,1,0,1
TZA,NAM,2002.0,1,0,1
FIN,IRL,2003.0,1,0,1
GUM,,2003.0,1,0,1
CHN,ZAF,1999.0,1,0,1
JAM,NLD,2001.0,1,0,1
SEN,NCL,2008.0,1,0,1
ARE,MAC,2022.0,1,0,1
GRC,FIN,2006.0,1,0,1
,MHL,2004.0,1,0,1
HKG,ITA,2003.0,2,0,2
QAT,NZL,2019.0,2,0,2
ZWE,EGY,2015.0,1,0,1
PER,IRL,2013.0,1,0,1
ZAF,SYC,2012.0,1,0,1
SGP,UGA,2013.0,1,0,1
DEU,AZE,2013.0,1,0,1
QAT,NZL,2010.0,1,0,1
MEX,UGA,2014.0,1,0,1
PYF,USA,2017.0,1,0,1
CZE,THA,2009.0,1,0,1
SEN,BRA,2000.0,1,0,1
MWI,JPN,2006.0,1,0,1
TUN,IND,2014.0,1,0,1
BEN,MLI,2010.0,2,0,2
TWN,KEN,2020.0,2,0,2
MAR,MAC,2009.0,1,0,1
ZWE,SWZ,2003.0,2,0,2
,TJK,1999.0,6,0,6
AUS,SYR,2011.0,1,0,1
HUN,PRT,2008.0,2,0,2
MCO,USA,2014.0,2,0,2
PAK,PNG,2007.0,1,0,1
GRC,ARM,2006.0,1,0,1
CAN,GRD,2006.0,1,0,1
CUB,HTI,2012.0,3,0,3
SWE,IDN,2004.0,2,0,2
AUS,UGA,2001.0,2,0,2
SDN,FRA,2001.0,2,0,2
DNK,EGY,2006.0,1,0,1
LBY,USA,2015.0,2,0,2
FSM,PLW,2005.0,2,0,2
ZAF,JOR,2019.0,1,0,1
ZAF,MYS,2004.0,1,0,1
GRC,IRQ,2019.0,2,0,2
CIV,BEN,2009.0,1,0,1
PRT,URY,2015.0,1,0,1
MMR,SGP,2007.0,1,0,1
FIN,LBY,2010.0,1,0,1
IDN,KEN,2022.0,3,0,3
ZWE,LSO,2020.0,1,0,1
IND,COL,2022.0,2,0,2
NZL,SLE,2015.0,1,0,1
LBY,TUR,2016.0,1,0,1
NZL,JOR,2018.0,1,0,1
COG,GIN,2020.0,1,0,1
CAN,BGR,2020.0,1,0,1
ARG,PRY,2015.0,2,0,2
TWN,PAN,2018.0,1,0,1
POL,TUR,2016.0,1,0,1
,LCA,2004.0,1,0,1
NGA,ESP,2011.0,3,0,3
NLD,PYF,2018.0,1,0,1
TUR,SGP,2007.0,1,0,1
ISR,JOR,2014.0,1,0,1
UKR,TJK,1999.0,1,0,1
TUR,HKG,2019.0,1,0,1
USA,PLW,2009.0,1,0,1
CHN,FRO,2018.0,1,0,1
ABW,USA,2016.0,1,0,1
PAN,DOM,2001.0,1,0,1
LBN,OMN,2014.0,1,0,1
,ERI,2019.0,6,0,6
CHE,PRT,1998.0,1,0,1
TUR,CZE,2003.0,2,0,2
SLE,COG,2020.0,1,0,1
TON,,2005.0,1,0,1
SAU,MAR,2001.0,1,0,1
IRN,UKR,2019.0,1,0,1
BRN,THA,2011.0,1,0,1
ITA,AZE,2013.0,1,0,1
DNK,GNB,1998.0,1,0,1
ITA,OMN,2000.0,1,0,1
IRL,BGR,2000.0,1,0,1
USA,MTQ,2010.0,1,0,1
ZWE,NZL,2002.0,1,0,1
AUT,GRC,2000.0,1,0,1
ISR,TWN,2018.0,1,0,1
CHN,SYR,2000.0,1,0,1
ISR,NOR,2021.0,1,0,1
DNK,VNM,2021.0,1,0,1
IRQ,CZE,2018.0,1,0,1
UKR,BGR,2014.0,1,0,1
JPN,BIH,2015.0,1,0,1
DNK,GTM,2019.0,1,0,1
SYR,LBN,2013.0,1,0,1
KOR,PNG,2017.0,1,0,1
MAR,PSE,2018.0,1,0,1
DEU,NER,2006.0,2,0,2
RWA,NLD,2008.0,1,0,1
BEL,JOR,2014.0,1,0,1
IND,ISL,2012.0,1,0,1
HRV,KWT,2020.0,1,0,1
KOR,PNG,2019.0,1,0,1
MYS,EST,2020.0,1,0,1
BLR,JPN,2013.0,1,0,1
IRN,UKR,2017.0,1,0,1
DEU,ECU,2009.0,2,0,2
BGD,BEL,2011.0,1,0,1
TUR,SYR,2021.0,1,0,1
NOR,GHA,2010.0,1,0,1
GBR,CUB,1997.0,1,0,1
,PYF,1995.0,1,0,1
JOR,HRV,2013.0,1,0,1
QAT,SDN,2011.0,1,0,1
MAC,MEX,2018.0,1,0,1
NGA,RWA,2017.0,1,0,1
SEN,ZAF,2013.0,1,0,1
ZAF,EGY,2003.0,1,0,1
MTQ,BEL,2007.0,1,0,1
AUS,MWI,2010.0,2,0,2
POL,MYS,2015.0,1,0,1
ISR,OMN,2018.0,1,0,1
ROU,LVA,2017.0,1,0,1
AUS,ARM,2021.0,1,0,1
SWZ,BWA,2003.0,1,0,1
OMN,GHA,2011.0,1,0,1
ETH,AUS,2002.0,1,0,1
MAC,NOR,2007.0,1,0,1
PER,CHE,2011.0,1,0,1
DEU,TCD,2007.0,1,0,1
CYP,SAU,2018.0,1,0,1
BEN,GHA,2020.0,2,0,2
DNK,NAM,2021.0,1,0,1
MWI,PNG,2012.0,1,0,1
CAN,NER,2005.0,1,0,1
BIH,BEL,2014.0,1,0,1
URY,IRL,2022.0,1,0,1
AUT,BFA,2020.0,1,0,1
TUR,LVA,2022.0,1,0,1
PAK,LKA,2019.0,1,0,1
MLI,GIN,2014.0,4,0,4
FRA,EST,2013.0,1,0,1
IND,JAM,2014.0,1,0,1
MEX,ECU,2010.0,1,0,1
BGD,GMB,2008.0,1,0,1
POL,SRB,2016.0,2,0,2
TWN,ISR,2015.0,3,0,3
VNM,MYS,2023.0,1,0,1
SVN,EGY,2016.0,1,0,1
AUT,UGA,2022.0,1,0,1
GIN,FRA,2001.0,2,0,2
ZWE,BLR,2006.0,1,0,1
TUR,BGR,2014.0,1,0,1
,WSM,2015.0,1,0,1
BRA,GRC,2010.0,1,0,1
SEN,IND,2016.0,1,0,1
SGP,MEX,2022.0,1,0,1
DZA,BRA,2018.0,1,0,1
FRA,AND,2022.0,1,0,1
NZL,HRV,2007.0,2,0,2
SWE,LKA,2011.0,1,0,1
AUT,MCO,2013.0,1,0,1
ZAF,ZWE,1997.0,1,0,1
ZAF,SEN,2022.0,1,0,1
AUS,NGA,2001.0,1,0,1
HKG,ZAF,2011.0,1,0,1
,BDI,2006.0,1,0,1
CHN,HRV,2022.0,1,0,1
SEN,CMR,2012.0,2,0,2
LUX,IRL,2006.0,1,0,1
GRC,PSE,2010.0,1,0,1
SYR,NGA,2001.0,1,0,1
JPN,SYR,2004.0,1,0,1
TUN,LBN,2019.0,1,0,1
BGD,LBY,2006.0,1,0,1
NER,CAN,2011.0,1,0,1
IRN,GHA,2017.0,1,0,1
USA,PYF,2005.0,1,0,1
ISR,MYS,2014.0,1,0,1
GRC,IRQ,2010.0,1,0,1
AUS,LAO,2013.0,1,0,1
AZE,KOR,2003.0,1,0,1
BGD,TWN,2006.0,1,0,1
JPN,PNG,2020.0,1,0,1
LBY,ARE,2020.0,1,0,1
KWT,CZE,2013.0,1,0,1
,FLK,2015.0,2,0,2
SRB,SVK,2008.0,1,0,1
BFA,CHE,2015.0,1,0,1
HRV,BEL,2022.0,1,0,1
PAK,NGA,2010.0,1,0,1
SAU,PAK,2023.0,1,0,1
KOR,IRL,2001.0,1,0,1
MUS,DEU,2020.0,1,0,1
USA,GNQ,2022.0,1,0,1
KOR,MMR,2019.0,1,0,1
GRD,ESP,2019.0,1,0,1
AUS,MOZ,2020.0,1,0,1
AGO,ESP,2009.0,1,0,1
IRL,OMN,2021.0,1,0,1
DEU,LIE,2004.0,1,0,1
KWT,ISR,2009.0,1,0,1
IDN,ESP,2004.0,1,0,1
MAR,YEM,2014.0,1,0,1
MMR,FRA,2020.0,2,0,2
TGO,KEN,2015.0,1,0,1
KOR,BLZ,2017.0,1,0,1
SVN,ARE,2010.0,1,0,1
BGR,KWT,2012.0,1,0,1
,GTM,1995.0,1,0,1
DNK,PSE,2020.0,1,0,1
BWA,COD,2021.0,1,0,1
MKD,SVN,2016.0,1,0,1
NGA,AUS,1997.0,1,0,1
CHE,UGA,2003.0,1,0,1
HKG,LVA,2003.0,1,0,1
AUT,BRA,2001.0,1,0,1
CHE,VUT,2008.0,1,0,1
TWN,IRL,2014.0,1,0,1
IRN,OMN,2012.0,1,0,1
GBR,BRN,2004.0,1,0,1
NGA,AUT,2020.0,1,0,1
SAU,HUN,2022.0,1,0,1
NOR,PRT,1999.0,1,0,1
EGY,MEX,2004.0,1,0,1
POL,QAT,2012.0,1,0,1
MCO,GRC,2004.0,1,0,1
GRC,PSE,2017.0,1,0,1
PAN,FRA,2003.0,1,0,1
VEN,PER,2019.0,1,0,1
SEN,SWE,2013.0,1,0,1
KEN,BFA,2003.0,1,0,1
,BWA,2020.0,1,0,1
ZMB,ZWE,2017.0,1,0,1
BWA,ARE,2001.0,1,0,1
ETH,SEN,2022.0,1,0,1
SVN,VNM,2012.0,1,0,1
CHE,ZWE,2014.0,1,0,1
BRA,VNM,2015.0,1,0,1
SYR,SDN,2016.0,1,0,1
BGR,ROU,2019.0,1,0,1
ETH,HUN,2018.0,1,0,1
LVA,AUT,2013.0,1,0,1
LKA,NGA,2018.0,1,0,1
ITA,BHS,2020.0,1,0,1
ETH,CMR,2022.0,1,0,1
IND,CMR,2017.0,1,0,1
BEL,SVK,2011.0,3,4,-1
DEU,FRA,2002.0,256,260,-4
FRA,CHE,2009.0,244,190,54
JPN,USA,2018.0,693,693,0
ITA,SWE,2014.0,72,23,49
GBR,BEL,1999.0,24,22,2
SWE,ROU,2019.0,5,3,2
FRA,CAN,1999.0,65,50,15
NOR,USA,2018.0,75,102,-27
EST,BEL,2016.0,3,1,2
BEL,DNK,2022.0,11,9,2
DEU,FRA,2005.0,221,229,-8
IRL,AUS,2016.0,46,28,18
AUS,DEU,2015.0,142,156,-14
USA,TUR,2013.0,238,240,-2
USA,GRC,2021.0,48,76,-28
SRB,AUT,2016.0,3,6,-3
HKG,CHN,2006.0,188,188,0
IRN,JPN,2005.0,8,16,-8
ITA,UKR,2014.0,4,3,1
ESP,EGY,2010.0,6,2,4
GBR,DEU,2014.0,577,616,-39
GBR,ITA,2007.0,162,236,-74
KOR,JPN,2006.0,101,126,-25
USA,ARE,2011.0,48,14,34
JPN,GBR,2018.0,94,131,-37
CHE,USA,2010.0,407,437,-30
BRA,CAN,2005.0,37,27,10
DEU,USA,2003.0,1215,1106,109
JPN,BGD,2016.0,60,49,11
ISR,GRC,2014.0,2,3,-1
DNK,CHL,2008.0,1,2,-1
NLD,TUR,2011.0,15,21,-6
ZAF,NGA,2016.0,54,70,-16
GBR,CYP,2010.0,24,8,16
AUT,DEU,2015.0,295,339,-44
USA,IRL,2003.0,82,77,5
TWN,USA,2014.0,268,285,-17
GBR,BRA,2005.0,44,31,13
SGP,CHN,2009.0,118,167,-49
DNK,USA,2016.0,147,142,5
ITA,ESP,2020.0,164,164,0
ESP,ITA,2009.0,81,154,-73
USA,BRA,2014.0,340,378,-38
AUT,AUS,2012.0,16,17,-1
LTU,DEU,2004.0,2,11,-9
DEU,EGY,2014.0,62,25,37
SWE,DEU,2005.0,69,63,6
ITA,GBR,2003.0,189,220,-31
CYP,GBR,2010.0,8,24,-16
CZE,JPN,2009.0,11,8,3
USA,THA,2007.0,141,83,58
PAK,CHN,2016.0,160,129,31
CZE,DEU,2018.0,59,54,5
SGP,DEU,2012.0,30,29,1
IND,BEL,2010.0,27,7,20
PAN,USA,2018.0,15,17,-2
ESP,CAN,2009.0,34,25,9
GBR,NZL,2016.0,112,114,-2
FRA,ITA,2005.0,137,194,-57
IRN,AUS,2012.0,90,24,66
BEL,DEU,2013.0,78,83,-5
PRT,BRA,2007.0,37,31,6
NZL,DEU,2012.0,29,34,-5
CHE,USA,2019.0,520,533,-13
COL,BRA,2017.0,55,59,-4
CHE,USA,2017.0,567,532,35
SGP,AUS,2018.0,81,105,-24
KEN,MWI,2015.0,1,1,0
PHL,GBR,2020.0,5,10,-5
AUS,CHN,2007.0,44,69,-25
MEX,DEU,2015.0,39,35,4
IND,AUS,2018.0,132,65,67
KEN,USA,2020.0,35,41,-6
RUS,UKR,2008.0,38,19,19
HKG,SGP,2016.0,31,27,4
MYS,BEL,2020.0,3,3,0
CHL,USA,2018.0,108,116,-8
IND,ARE,2021.0,47,22,25
USA,ARG,2014.0,71,86,-15
PYF,FRA,2020.0,21,11,10
OMN,GBR,2011.0,4,7,-3
FIN,CHN,2005.0,10,7,3
MEX,FRA,2012.0,22,37,-15
FRA,SEN,2012.0,28,18,10
FRA,DEU,2020.0,377,329,48
CAN,AUS,2018.0,193,161,32
JPN,TWN,2018.0,43,62,-19
AUS,FRA,2011.0,64,84,-20
BRA,LUX,2020.0,2,1,1
FRA,IRL,2019.0,44,26,18
PRT,GBR,2015.0,120,51,69
SVK,CZE,2014.0,71,33,38
CZE,AUT,2019.0,12,18,-6
USA,EGY,2015.0,103,84,19
DEU,ARM,2020.0,3,5,-2
ZAF,CHE,2016.0,14,11,3
COL,ITA,2014.0,10,6,4
GBR,PAK,2021.0,46,63,-17
ITA,ISR,2015.0,14,9,5
KOR,GBR,2021.0,52,51,1
CAN,ARG,2015.0,16,13,3
NLD,CHE,1999.0,11,17,-6
ZAF,USA,2003.0,101,52,49
NOR,CHN,2020.0,32,30,2
COL,ESP,2016.0,50,83,-33
KOR,MYS,2015.0,11,13,-2
BRA,RUS,2020.0,9,5,4
CAN,ARE,2014.0,34,14,20
ARE,BEL,2015.0,1,2,-1
ARE,KOR,2018.0,6,16,-10
MAC,CHN,2022.0,88,67,21
DEU,IRN,2021.0,24,92,-68
HKG,USA,2018.0,150,142,8
CAN,COL,2017.0,12,20,-8
SAU,ESP,2016.0,3,14,-11
MYS,LKA,2018.0,3,2,1
FRA,ITA,2002.0,199,146,53
POL,USA,2000.0,56,28,28
IND,NPL,2013.0,14,16,-2
USA,MWI,2018.0,24,14,10
CHN,NLD,2021.0,121,141,-20
CHE,BGR,2020.0,2,2,0
FRA,IDN,2014.0,13,4,9
GBR,PRT,2022.0,35,19,16
CHN,DEU,2004.0,101,92,9
USA,RUS,2011.0,122,139,-17
USA,SGP,2005.0,102,101,1
RUS,DEU,2020.0,118,72,46
CHN,FRA,2011.0,116,90,26
NLD,ESP,2014.0,63,106,-43
RUS,DNK,2021.0,9,4,5
SWE,ITA,2008.0,23,34,-11
CHN,PRT,2015.0,8,11,-3
IDN,JPN,2021.0,49,97,-48
SRB,DEU,2021.0,11,10,1
SAU,ITA,2022.0,7,7,0
IRN,THA,2018.0,1,1,0
MEX,NLD,2015.0,13,7,6
RUS,NLD,2018.0,22,9,13
NOR,GHA,2018.0,3,1,2
HUN,AUT,2021.0,12,7,5
JPN,CAN,2018.0,75,79,-4
FRA,PRT,2022.0,11,16,-5
CHL,CAN,2017.0,14,21,-7
JPN,PHL,2015.0,29,14,15
ZAF,AUS,2022.0,8,16,-8
USA,GTM,2021.0,5,5,0
VEN,USA,2017.0,28,11,17
BGR,CHE,2009.0,2,2,0
MAR,TUN,2020.0,1,8,-7
FRA,MRT,2018.0,3,1,2
USA,TWN,1997.0,41,17,24
DZA,MYS,2021.0,2,2,0
ZAF,NOR,2021.0,6,2,4
USA,DNK,2001.0,84,86,-2
ITA,CHN,2014.0,36,34,2
BOL,ESP,2020.0,2,1,1
SWE,AUS,2013.0,38,35,3
PRT,DEU,2013.0,33,22,11
USA,ESP,2000.0,90,134,-44
SAU,AUS,2022.0,13,26,-13
AUT,JPN,2022.0,4,2,2
COL,USA,2021.0,100,47,53
DEU,AUS,1999.0,36,22,14
THA,KOR,2010.0,4,1,3
IRN,MEX,2021.0,5,1,4
FRA,ROU,2014.0,31,31,0
GBR,SAU,2021.0,129,47,82
ITA,PER,2020.0,6,3,3
NOR,DEU,2012.0,22,59,-37
ESP,FIN,2018.0,21,17,4
IND,HUN,2008.0,1,2,-1
COL,BRA,2010.0,13,17,-4
KOR,MNG,2016.0,11,2,9
GRC,CYP,2011.0,28,9,19
SVK,FRA,2004.0,3,4,-1
IND,ITA,2005.0,12,12,0
TWN,NLD,2012.0,4,6,-2
RUS,FRA,2006.0,46,35,11
MYS,LBY,2012.0,9,1,8
ISR,LBN,2009.0,1,1,0
ROU,GBR,2013.0,14,13,1
QAT,IRN,2015.0,2,3,-1
IND,ISR,2008.0,16,9,7
NLD,BEL,2005.0,83,75,8
CHE,SGP,2014.0,18,18,0
KOR,TWN,2009.0,10,11,-1
ARG,CAN,2013.0,16,10,6
FRA,FIN,2017.0,32,21,11
GBR,KOR,2012.0,51,25,26
CHE,POL,2014.0,12,53,-41
HKG,IRL,2009.0,5,1,4
RUS,ITA,2020.0,22,14,8
DEU,BRA,2008.0,43,46,-3
MYS,PHL,2006.0,1,1,0
NGA,SWE,2019.0,4,1,3
ITA,SVN,2007.0,6,3,3
AUT,COL,2013.0,2,2,0
IRN,CHE,2011.0,16,9,7
SWE,NLD,2001.0,20,21,-1
NLD,JPN,2003.0,14,21,-7
PRT,ITA,2020.0,29,32,-3
DEU,ESP,2003.0,92,95,-3
IND,BEL,2017.0,36,18,18
IDN,NLD,2017.0,15,22,-7
AUS,PER,2017.0,2,1,1
IND,BEL,2019.0,33,24,9
BGD,CHN,2015.0,9,5,4
VNM,GBR,2017.0,9,42,-33
ESP,EGY,2019.0,7,6,1
NGA,CAN,2020.0,16,3,13
JPN,ROU,2003.0,7,8,-1
JPN,AUS,2006.0,50,35,15
IND,THA,2012.0,5,6,-1
IRL,DEU,2001.0,11,14,-3
NLD,BEL,2002.0,80,90,-10
SWE,CAN,2004.0,27,26,1
ESP,CUB,2004.0,13,7,6
BGD,MYS,2013.0,30,21,9
PRI,USA,2005.0,47,35,12
MYS,BRN,2016.0,9,3,6
RUS,USA,1999.0,267,41,226
MYS,SAU,2015.0,62,15,47
ESP,CHE,2000.0,19,10,9
AUT,USA,2007.0,73,84,-11
CHE,ITA,2012.0,88,206,-118
UKR,USA,2011.0,26,11,15
COL,NLD,2011.0,4,4,0
ESP,DNK,2001.0,10,3,7
CHN,TUR,2019.0,4,11,-7
TWN,HKG,2016.0,14,12,2
FRA,GUF,2019.0,18,24,-6
FRA,GUF,2017.0,30,25,5
SAU,HKG,2017.0,6,2,4
CAN,AUT,2018.0,25,18,7
ARG,GBR,2015.0,14,11,3
COL,BRA,2019.0,50,95,-45
CHE,AUT,2022.0,25,37,-12
AUT,CZE,2018.0,14,17,-3
FRA,FIN,2019.0,36,23,13
BRA,PAK,2022.0,4,2,2
CAN,JPN,2021.0,47,49,-2
HKG,NLD,2018.0,5,7,-2
LVA,USA,2022.0,3,1,2
USA,PER,2018.0,35,42,-7
FRA,DNK,2008.0,25,21,4
IND,OMN,2021.0,14,12,2
SVN,HRV,2020.0,10,14,-4
DEU,EST,2021.0,6,8,-2
ITA,FIN,2022.0,8,15,-7
CZE,KOR,2020.0,4,4,0
IDN,KOR,2020.0,21,42,-21
CHL,FRA,2004.0,10,13,-3
VEN,USA,2019.0,32,4,28
IDN,NLD,2019.0,22,48,-26
KOR,NOR,2020.0,11,3,8
USA,SVN,2020.0,10,8,2
TUR,KWT,2019.0,6,2,4
JPN,ESP,2004.0,4,9,-5
ISR,TWN,2019.0,2,1,1
TUR,QAT,2017.0,4,2,2
NAM,ZAF,2017.0,5,17,-12
NOR,BEL,2019.0,9,8,1
VNM,GBR,2019.0,8,38,-30
YEM,EGY,2022.0,1,2,-1
USA,SVK,2006.0,11,16,-5
FRA,ECU,2018.0,10,3,7
QAT,EGY,2014.0,7,10,-3
GHA,CAN,2021.0,7,3,4
USA,TWN,1998.0,66,20,46
SAU,PAK,2000.0,1,1,0
SWE,DEU,2002.0,83,58,25
IRQ,BEL,2008.0,1,1,0
CMR,GBR,2021.0,8,5,3
ROU,ITA,2018.0,13,18,-5
CAN,KWT,2019.0,17,9,8
POL,ITA,2022.0,9,13,-4
ROU,POL,2011.0,3,4,-1
FRA,MEX,2005.0,55,31,24
TUR,QAT,2019.0,7,4,3
AUS,DNK,2016.0,25,35,-10
ROU,DEU,2018.0,10,26,-16
DNK,AUS,2016.0,35,25,10
SWE,ISL,2020.0,15,14,1
FRA,COG,2005.0,11,1,10
ECU,FRA,2015.0,5,4,1
THA,PHL,2009.0,3,1,2
PER,GBR,2008.0,5,3,2
DEU,NGA,2014.0,6,8,-2
JPN,KEN,2015.0,7,6,1
CAN,THA,2014.0,11,10,1
GBR,CYP,2019.0,43,19,24
BGD,USA,2000.0,3,1,2
GRC,SRB,2006.0,1,1,0
BEL,BGR,2015.0,4,4,0
BLR,USA,2008.0,3,4,-1
FIN,USA,2008.0,56,63,-7
FRA,GUF,2010.0,15,9,6
ESP,AUS,2004.0,4,1,3
SWE,FIN,2003.0,48,36,12
CHE,AUS,2011.0,57,53,4
UKR,SWE,2001.0,5,3,2
FRA,MCO,2013.0,9,2,7
FIN,CHE,2001.0,6,4,2
AUT,ESP,2020.0,20,24,-4
TUR,JPN,2003.0,10,12,-2
BRA,DEU,2003.0,44,39,5
ARM,DEU,2015.0,10,1,9
FIN,GBR,2011.0,37,50,-13
DEU,UKR,2007.0,24,29,-5
ARG,ESP,1999.0,14,21,-7
POL,CHE,2005.0,10,9,1
EGY,CAN,2003.0,4,11,-7
EGY,KOR,2012.0,12,2,10
DEU,CHL,2018.0,34,48,-14
JPN,EGY,2001.0,9,13,-4
QAT,SAU,2005.0,2,1,1
HRV,AUS,2012.0,3,1,2
LUX,FRA,2007.0,9,28,-19
AUT,FRA,2000.0,8,5,3
PRT,NZL,2011.0,3,2,1
MAR,CAN,2004.0,6,4,2
ESP,NLD,2006.0,29,45,-16
FRA,MEX,2002.0,29,25,4
TUN,ZAF,2012.0,1,1,0
SGP,CAN,2001.0,7,11,-4
GRC,GBR,2001.0,29,51,-22
SVK,POL,2016.0,5,4,1
USA,KEN,2001.0,11,10,1
USA,IRN,2001.0,9,14,-5
NZL,FJI,2005.0,2,1,1
THA,DEU,2012.0,23,24,-1
NLD,KEN,2008.0,2,1,1
IND,ITA,2002.0,7,10,-3
MAR,BEL,2004.0,2,7,-5
BRA,FRA,2000.0,23,22,1
NLD,DNK,1999.0,6,9,-3
IND,SWE,2002.0,8,6,2
SRB,SWE,2012.0,3,1,2
BGR,FRA,2004.0,7,4,3
BRN,MYS,2012.0,3,5,-2
ARG,BRA,1999.0,19,5,14
SWE,POL,2001.0,10,9,1
CAN,IRN,2001.0,9,10,-1
NLD,TWN,2012.0,6,4,2
TUR,CYP,2013.0,31,5,26
LBN,FRA,2009.0,14,25,-11
HRV,AUT,2015.0,5,2,3
EST,FIN,2004.0,8,4,4
BRA,ZAF,2009.0,4,5,-1
FRA,AUT,2000.0,5,8,-3
ECU,ESP,2007.0,3,2,1
PSE,ISR,2002.0,2,1,1
IND,ZAF,2003.0,5,2,3
CHE,DNK,2001.0,7,10,-3
PNG,AUS,2011.0,4,6,-2
FRA,IRL,2017.0,35,17,18
PAK,JPN,2011.0,8,10,-2
CHE,NOR,2004.0,10,6,4
CAN,BEL,2007.0,17,24,-7
KOR,SWE,2003.0,3,6,-3
THA,NPL,2010.0,1,4,-3
PRT,IRL,2016.0,6,6,0
DNK,ROU,2009.0,3,1,2
DEU,POL,2016.0,64,81,-17
HRV,TWN,2013.0,1,1,0
KOR,EGY,2011.0,6,7,-1
CHN,TWN,1998.0,3,15,-12
CHL,BRA,2012.0,11,13,-2
SWE,ROU,2017.0,3,12,-9
JPN,AUT,2006.0,8,7,1
FRA,PER,2020.0,3,4,-1
ISR,MEX,2019.0,3,4,-1
ARM,USA,2006.0,7,2,5
NOR,BEL,2017.0,6,11,-5
IND,CZE,2013.0,12,3,9
THA,KOR,2019.0,15,8,7
UGA,GBR,2014.0,11,8,3
GRC,IRL,2019.0,9,5,4
ESP,MAR,2013.0,13,3,10
TZA,SWE,2013.0,1,3,-2
CAN,COL,2019.0,12,17,-5
DEU,VNM,2014.0,14,7,7
AUS,PAK,2018.0,19,41,-22
ESP,EGY,2017.0,13,4,9
DEU,KEN,2019.0,15,10,5
ISR,TWN,2017.0,2,4,-2
GBR,CYP,2017.0,25,14,11
CZE,AUT,2017.0,14,12,2
CZE,RUS,2014.0,2,11,-9
GTM,ESP,2016.0,2,6,-4
SWE,IRQ,2017.0,3,2,1
ROU,SGP,2016.0,1,1,0
SWE,IRQ,2019.0,7,1,6
VNM,DEU,2014.0,7,14,-7
GBR,BRN,2014.0,4,1,3
CAN,KOR,2022.0,11,25,-14
SRB,CZE,2016.0,2,1,1
BGD,SAU,2016.0,4,4,0
QAT,MYS,2019.0,3,10,-7
TWN,MAC,2012.0,3,1,2
KEN,PAK,2020.0,8,4,4
KAZ,DEU,2018.0,3,2,1
THA,NPL,2019.0,5,4,1
FRA,ZAF,2022.0,6,6,0
PAK,NGA,2018.0,2,3,-1
DEU,MYS,2009.0,6,3,3
DEU,IRQ,2020.0,6,5,1
UGA,MWI,2019.0,1,1,0
HKG,RUS,2020.0,5,3,2
ITA,ISL,2016.0,2,1,1
POL,AUS,2022.0,2,5,-3
CHN,NPL,2019.0,15,9,6
NZL,NLD,2005.0,4,7,-3
NGA,NOR,2010.0,1,1,0
PRI,COL,2007.0,1,2,-1
COL,CAN,2007.0,7,5,2
ESP,BGR,2009.0,4,3,1
VEN,USA,2010.0,25,20,5
USA,LBN,2004.0,24,33,-9
NLD,AUT,2020.0,17,37,-20
ESP,AUT,2012.0,18,20,-2
JAM,USA,2015.0,7,3,4
TZA,NGA,2021.0,3,1,2
CZE,ESP,2004.0,1,3,-2
ARG,ITA,2013.0,14,15,-1
ESP,COL,2003.0,15,17,-2
IND,AUT,2003.0,4,4,0
IND,NOR,2012.0,10,6,4
FRA,BEN,2013.0,9,7,2
ITA,VNM,2011.0,1,1,0
PRT,DNK,2013.0,8,3,5
BRA,IRL,2014.0,6,5,1
MWI,ZAF,2008.0,5,1,4
NER,NGA,2015.0,1,2,-1
ARE,IRN,2014.0,1,2,-1
TZA,DEU,2013.0,3,2,1
MAR,COG,2015.0,1,2,-1
IND,BRA,2020.0,11,22,-11
CHL,CAN,2010.0,7,11,-4
KOR,NPL,2022.0,2,2,0
NPL,AUS,2014.0,7,5,2
ITA,KEN,2006.0,1,1,0
CAN,IRL,2008.0,20,25,-5
LUX,DEU,2009.0,8,18,-10
FIN,ITA,2021.0,9,26,-17
SAU,GBR,2022.0,36,54,-18
KOR,SGP,2012.0,14,29,-15
MYS,IND,2003.0,8,11,-3
CYP,GBR,2019.0,19,43,-24
IND,NZL,2013.0,12,5,7
GTM,USA,2009.0,2,5,-3
BGR,CAN,2019.0,2,2,0
TZA,KEN,2016.0,1,6,-5
VNM,GBR,2010.0,9,9,0
ZWE,AUS,2012.0,1,3,-2
CAN,CZE,2011.0,7,11,-4
ISR,DNK,2011.0,3,2,1
TUN,USA,2021.0,4,1,3
COL,PRT,2021.0,3,2,1
PER,SWE,2013.0,3,1,2
CAN,KWT,2017.0,16,7,9
PRT,MOZ,2019.0,3,2,1
URY,SWE,2017.0,1,1,0
QAT,MYS,2017.0,3,3,0
ECU,CAN,2006.0,3,1,2
JPN,TUR,2006.0,7,7,0
ITA,JOR,2020.0,2,1,1
KEN,JPN,2021.0,1,5,-4
NZL,ESP,2021.0,6,3,3
ITA,MEX,2021.0,8,16,-8
PHL,THA,2017.0,4,1,3
GBR,BGR,2020.0,8,6,2
ARG,FRA,2022.0,9,12,-3
JPN,DZA,2002.0,2,1,1
PSE,TUR,2018.0,1,3,-2
CAN,QAT,2022.0,2,8,-6
PER,MEX,2011.0,5,7,-2
MEX,PER,2014.0,6,2,4
BFA,DEU,2007.0,1,1,0
CMR,CHE,2006.0,3,1,2
PER,ESP,2000.0,2,1,1
JPN,NOR,2015.0,6,9,-3
NOR,JPN,2020.0,5,7,-2
THA,FRA,2012.0,10,14,-4
USA,PRI,1999.0,16,13,3
KOR,UKR,2007.0,1,4,-3
ZAF,NZL,2004.0,9,7,2
SWE,ISR,1999.0,1,1,0
CZE,GBR,1997.0,5,9,-4
GBR,MWI,2008.0,11,7,4
DNK,RUS,2018.0,5,7,-2
HUN,CZE,2002.0,2,2,0
BRA,KOR,2021.0,3,1,2
KOR,RUS,2021.0,12,8,4
TWN,BEL,2012.0,2,3,-1
TUR,SDN,2006.0,1,1,0
NOR,ESP,2003.0,5,5,0
CHN,KOR,1999.0,4,4,0
BRA,DNK,2015.0,12,8,4
MYS,DEU,2009.0,3,6,-3
IRL,ITA,2006.0,5,7,-2
GRC,CAN,2004.0,3,11,-8
SRB,BEL,2018.0,3,2,1
THA,ARE,2017.0,1,1,0
BGR,CAN,2010.0,1,3,-2
NZL,MYS,2007.0,2,3,-1
CHN,MAC,2009.0,11,5,6
KEN,DEU,2008.0,4,5,-1
KOR,POL,2015.0,2,8,-6
CHE,CHL,2021.0,4,8,-4
AUT,UKR,2013.0,2,4,-2
TUR,IRN,2014.0,4,26,-22
MEX,ITA,2007.0,3,11,-8
ZMB,USA,2013.0,9,8,1
KEN,DNK,2011.0,1,1,0
BEL,HUN,2008.0,7,4,3
VNM,KOR,2014.0,18,50,-32
CHE,TZA,2009.0,1,2,-1
MMR,THA,2010.0,1,2,-1
NOR,GRC,2018.0,1,20,-19
FRA,MYS,2007.0,5,2,3
NLD,NZL,2020.0,10,10,0
MMR,THA,2019.0,6,4,2
DZA,ITA,2010.0,3,2,1
CHN,NPL,2017.0,9,6,3
AUS,BTN,2020.0,3,7,-4
GBR,SVK,2020.0,4,4,0
SGP,SAU,2015.0,8,1,7
DZA,ITA,2019.0,3,3,0
HUN,CAN,2004.0,9,5,4
CZE,AUS,2013.0,6,1,5
ZAF,SWZ,2008.0,2,2,0
SGP,THA,2007.0,5,4,1
GRC,CZE,2015.0,5,1,4
BRA,POL,2022.0,11,1,10
MOZ,SWE,2020.0,1,2,-1
SAU,BHR,2021.0,6,3,3
ISL,GBR,2000.0,2,2,0
AUT,IRL,2021.0,2,4,-2
ESP,ECU,2022.0,16,20,-4
NGA,TZA,2021.0,1,3,-2
AUT,HUN,2006.0,9,11,-2
IND,TWN,2000.0,9,3,6
BEL,PRT,2011.0,10,4,6
HUN,ARE,2005.0,2,4,-2
BGR,DEU,2012.0,13,9,4
CZE,PRT,2007.0,1,3,-2
NZL,ZAF,2004.0,7,9,-2
JPN,IRL,2015.0,1,6,-5
MDG,FRA,2012.0,6,10,-4
UKR,BEL,2014.0,2,4,-2
GBR,LVA,2019.0,3,4,-1
AUT,HKG,2015.0,1,3,-2
IND,SWE,2005.0,15,6,9
EGY,KWT,2007.0,10,6,4
CAN,JOR,2003.0,3,4,-1
AUS,IND,2001.0,7,15,-8
UKR,FRA,2000.0,9,3,6
GBR,BEN,2005.0,2,1,1
MLI,FRA,2013.0,5,2,3
BGD,KOR,2005.0,7,2,5
AUS,COL,2002.0,4,1,3
VNM,THA,2014.0,3,3,0
USA,BLR,2014.0,2,8,-6
AUS,NPL,2021.0,4,11,-7
KOR,THA,2013.0,8,6,2
URY,BRA,2019.0,6,15,-9
PRT,FIN,2021.0,5,3,2
GRL,DNK,2022.0,1,2,-1
CHL,BEL,2012.0,2,3,-1
BHS,USA,2017.0,3,2,1
MEX,SVN,2017.0,1,1,0
KOR,CHL,2015.0,1,1,0
HKG,BGD,2015.0,2,1,1
CHN,TUR,2017.0,3,11,-8
AUS,LUX,2017.0,2,2,0
GHA,ITA,2020.0,3,3,0
KEN,BEL,2007.0,2,10,-8
USA,ZWE,2022.0,3,3,0
BHS,USA,2019.0,2,3,-1
MEX,KOR,2006.0,1,1,0
FRA,UKR,2016.0,6,13,-7
CZE,BLR,2013.0,1,1,0
NCL,FRA,2006.0,8,10,-2
ROU,MEX,2002.0,1,1,0
COL,CHE,2003.0,1,1,0
DZA,USA,2012.0,3,1,2
CZE,UKR,2019.0,7,16,-9
CHL,CHE,2012.0,6,7,-1
HUN,SWE,2007.0,6,10,-4
DNK,JPN,2020.0,6,11,-5
AUS,NOR,1998.0,2,1,1
BRA,VEN,2013.0,2,6,-4
NLD,PHL,2003.0,2,3,-1
RUS,AUT,2006.0,5,4,1
KEN,ITA,2017.0,4,5,-1
ISR,NLD,1999.0,5,2,3
TUR,KGZ,2011.0,3,1,2
AUS,NCL,2007.0,1,1,0
SWE,EST,2018.0,7,7,0
USA,TZA,2022.0,5,6,-1
SVK,RUS,2014.0,2,3,-1
BRA,PRT,1998.0,5,3,2
NOR,ETH,2009.0,3,1,2
CAN,JAM,2010.0,1,3,-2
CAN,MEX,2001.0,14,14,0
USA,BGR,1998.0,4,9,-5
HUN,ARE,2002.0,2,2,0
EGY,QAT,2013.0,5,1,4
CZE,AUT,2010.0,5,10,-5
NZL,IND,2012.0,4,8,-4
BRA,NZL,2005.0,2,1,1
FIN,ARG,2002.0,1,1,0
NZL,NLD,2002.0,8,5,3
BRA,CHN,2009.0,1,2,-1
LKA,AUS,2004.0,4,3,1
CZE,CHE,2006.0,7,6,1
KWT,IND,2020.0,2,3,-1
CHE,IDN,2012.0,2,1,1
ISR,BRA,2020.0,5,5,0
PAN,CAN,2008.0,2,1,1
ZAF,IRL,2009.0,3,1,2
VEN,GBR,2009.0,5,3,2
LKA,KOR,2010.0,3,1,2
BIH,ITA,2015.0,1,1,0
UKR,DNK,2018.0,2,1,1
CAN,COL,2010.0,2,4,-2
DEU,SYR,2012.0,4,4,0
SWE,ROU,2010.0,3,1,2
USA,COD,2016.0,2,1,1
MEX,URY,2022.0,1,1,0
GBR,LTU,2019.0,8,7,1
GBR,MUS,2014.0,2,1,1
SRB,NOR,2020.0,4,2,2
ZAF,CHN,2015.0,2,8,-6
BEL,BGD,2020.0,5,2,3
BRA,BEL,2013.0,12,18,-6
UKR,ITA,2001.0,2,3,-1
MYS,KWT,2020.0,2,1,1
ESP,BGD,2019.0,5,2,3
UKR,CHN,2022.0,10,7,3
DEU,KEN,2010.0,7,7,0
CAN,PAN,2012.0,1,1,0
GBR,LTU,2010.0,3,7,-4
USA,PRY,2020.0,4,1,3
RUS,TUR,2001.0,2,2,0
COL,FRA,2003.0,5,5,0
EGY,CHN,2022.0,13,35,-22
FIN,THA,2014.0,2,1,1
JPN,BRA,1998.0,2,2,0
DNK,LTU,2006.0,1,3,-2
NLD,EGY,2004.0,3,2,1
DEU,BGR,2020.0,8,6,2
POL,CHE,2002.0,7,10,-3
ITA,IRL,1997.0,2,1,1
ITA,MLT,2006.0,1,2,-1
CHE,BLR,2018.0,1,2,-1
JOR,GBR,2002.0,2,3,-1
SWE,PAK,2011.0,4,8,-4
BRB,CAN,2012.0,1,1,0
SAU,SRB,2017.0,1,1,0
PRI,MEX,2007.0,1,1,0
JPN,BRA,1997.0,2,2,0
NZL,IDN,2001.0,1,1,0
GRC,RUS,2020.0,2,1,1
LVA,RUS,2019.0,1,3,-2
AUS,LUX,2019.0,1,2,-1
SVN,CZE,2020.0,2,1,1
CAF,SEN,2007.0,1,1,0
IRN,JPN,2002.0,5,4,1
AUT,ROU,2019.0,3,1,2
MAC,TWN,2020.0,2,5,-3
AUS,IDN,2000.0,2,1,1
TWN,ESP,2006.0,1,3,-2
BHR,MYS,2022.0,1,1,0
USA,MLI,2006.0,3,2,1
BEL,NGA,2006.0,1,1,0
NGA,SWE,2017.0,1,3,-2
DEU,CYP,2008.0,1,1,0
DEU,BIH,2009.0,2,3,-1
SAU,HKG,2019.0,6,3,3
PRT,THA,2013.0,1,2,-1
JPN,NZL,2012.0,8,10,-2
AUS,BGR,2002.0,2,4,-2
FIN,NLD,2006.0,7,11,-4
CHN,CZE,1999.0,1,1,0
ITA,CHL,2011.0,5,6,-1
KHM,GBR,2015.0,2,1,1
NLD,EST,2018.0,4,3,1
NLD,TZA,2015.0,2,2,0
AUT,THA,2012.0,4,2,2
VNM,CHN,2012.0,2,4,-2
USA,AZE,2020.0,1,1,0
CHE,KOR,2009.0,6,7,-1
SWE,TZA,2017.0,1,5,-4
CYP,GBR,2017.0,14,25,-11
BGD,TUR,2019.0,2,1,1
THA,SGP,2021.0,3,7,-4
AUS,EGY,2000.0,1,1,0
BMU,USA,2007.0,1,3,-2
LBN,CHE,2013.0,1,3,-2
NGA,NOR,2019.0,3,1,2
MEX,CRI,2022.0,1,2,-1
URY,CAN,2015.0,1,1,0
POL,NLD,2004.0,8,4,4
ZWE,DEU,2006.0,1,1,0
CZE,UKR,2017.0,2,11,-9
IDN,BEL,2012.0,2,1,1
MDA,USA,2005.0,1,1,0
CZE,GBR,1998.0,6,13,-7
FRA,ALB,2019.0,1,1,0
AUS,PER,2019.0,1,1,0
GBR,EGY,1998.0,1,2,-1
BLR,UKR,1999.0,1,3,-2
RUS,ZAF,2004.0,5,1,4
BGR,GBR,1999.0,3,3,0
NOR,SVK,2006.0,1,1,0
TGO,FRA,2005.0,2,3,-1
KEN,ITA,2019.0,3,3,0
ESP,GRC,2000.0,2,2,0
NZL,CHN,2002.0,2,4,-2
URY,BRA,2010.0,4,4,0
FRA,JOR,2011.0,1,1,0
USA,UZB,2013.0,1,1,0
BEL,HRV,2017.0,3,3,0
ISR,UZB,2009.0,1,1,0
CZE,IND,2011.0,1,3,-2
BGR,AUT,2019.0,3,1,2
CYP,BEL,2015.0,1,1,0
UZB,DEU,2008.0,2,1,1
NZL,RUS,2012.0,1,2,-1
HUN,CZE,2005.0,2,1,1
FIN,ISR,2002.0,1,3,-2
LBN,CAN,2004.0,2,5,-3
RUS,HUN,2007.0,1,2,-1
IDN,ESP,2014.0,1,1,0
SVN,CHE,2011.0,2,2,0
TGO,FRA,2002.0,2,4,-2
IRL,FIN,2000.0,1,2,-1
UGA,FRA,2007.0,2,3,-1
QAT,IRL,2021.0,1,1,0
DZA,ITA,2017.0,1,2,-1
FRA,NZL,1999.0,3,1,2
IRL,BRA,2013.0,3,7,-4
BRA,FIN,2014.0,1,6,-5
ISR,RUS,1997.0,1,1,0
AUT,ROU,2017.0,5,5,0
SWE,TZA,2010.0,2,1,1
BEL,THA,2011.0,3,1,2
PHL,THA,2010.0,3,2,1
SWE,IDN,2014.0,1,1,0
PRT,POL,2005.0,1,2,-1
GEO,RUS,2011.0,4,3,1
QAT,PRT,2016.0,1,2,-1
CRI,CAN,2009.0,1,5,-4
DNK,KOR,1999.0,1,1,0
NAM,ZAF,2010.0,3,1,2
THA,NZL,2009.0,2,3,-1
NOR,BEL,2010.0,2,6,-4
ROU,BGR,2017.0,1,2,-1
NLD,ALB,2018.0,1,1,0
KOR,MMR,2018.0,1,1,0
AUS,COL,2005.0,1,2,-1
POL,AUT,2020.0,10,5,5
THA,NPL,2017.0,4,1,3
CHE,SDN,2021.0,1,5,-4
URY,FRA,2011.0,4,5,-1
IRL,GRC,2008.0,4,3,1
TWN,JPN,1998.0,2,3,-1
CHN,TWN,1997.0,2,8,-6
AUT,EST,2017.0,2,2,0
NGA,KOR,2011.0,1,1,0
BGR,RUS,2020.0,2,5,-3
DEU,PAK,2003.0,3,2,1
ISR,HUN,2020.0,1,3,-2
SWE,TZA,2019.0,2,2,0
HKG,NZL,2009.0,2,2,0
CHL,POL,2019.0,2,2,0
KHM,THA,2016.0,1,2,-1
LUX,AUT,2020.0,1,2,-1
LUX,JPN,2015.0,1,1,0
RUS,LTU,2016.0,1,2,-1
VNM,NLD,2007.0,2,2,0
SWE,SVK,2007.0,1,4,-3
MEX,UKR,2007.0,2,1,1
ZAF,KEN,2001.0,3,2,1
USA,ARM,2007.0,1,8,-7
RUS,LVA,2004.0,1,1,0
SGP,RUS,2016.0,1,3,-2
AUS,KHM,2020.0,3,1,2
IRL,CHL,2015.0,1,2,-1
BRA,IND,2008.0,5,7,-2
NAM,GBR,2018.0,1,1,0
FRA,ARM,2021.0,1,2,-1
MEX,SWE,2008.0,2,2,0
HRV,NOR,2016.0,1,1,0
GBR,COG,2018.0,3,2,1
RUS,ROU,2021.0,1,3,-2
CYP,DNK,2021.0,1,1,0
RUS,NZL,2010.0,4,1,3
CHE,BEN,2021.0,3,1,2
DEU,BWA,2017.0,1,1,0
CAN,GUY,2009.0,1,1,0
ZMB,JPN,2021.0,3,3,0
PAK,NZL,2008.0,1,1,0
BEL,BFA,2012.0,1,2,-1
BOL,CHL,2013.0,1,1,0
BOL,DEU,2018.0,2,2,0
SYR,EGY,2014.0,2,1,1
BGD,ITA,2021.0,2,5,-3
QAT,FIN,2013.0,1,1,0
CYP,CHN,2020.0,1,1,0
USA,MYS,2000.0,2,3,-1
PSE,ISR,2005.0,3,13,-10
TUR,AUS,2012.0,2,8,-6
TUR,BRA,2022.0,2,1,1
TUN,NLD,2021.0,1,1,0
FRA,KAZ,2011.0,1,1,0
CMR,JPN,2016.0,1,3,-2
ETH,BWA,2020.0,1,1,0
AUT,TUR,2022.0,1,2,-1
IRL,RUS,2018.0,1,4,-3
QAT,GRC,2021.0,1,1,0
RWA,NLD,2013.0,1,3,-2
BEL,ISR,2016.0,4,2,2
PRI,IND,2012.0,2,1,1
ISR,MEX,2017.0,2,3,-1
IRL,DNK,2001.0,1,3,-2
BGD,IND,2000.0,1,2,-1
FRA,KWT,2022.0,1,1,0
CHE,NZL,1999.0,1,2,-1
HUN,HRV,2021.0,2,1,1
DZA,DNK,2018.0,1,1,0
FIN,IND,2001.0,2,2,0
EST,CAN,2008.0,1,1,0
BEL,BOL,2013.0,1,2,-1
TWN,UKR,2005.0,2,1,1
GBR,LVA,2010.0,1,1,0
ARE,OMN,2010.0,1,2,-1
ROU,ESP,2011.0,2,3,-1
PAN,ESP,2016.0,2,7,-5
SDN,MYS,2020.0,1,9,-8
DEU,MLT,2017.0,1,1,0
IND,BRN,2019.0,2,2,0
ZAF,POL,2015.0,2,10,-8
BEL,SRB,2011.0,2,1,1
ARE,OMN,2019.0,2,11,-9
NZL,CHN,2005.0,1,3,-2
COL,IRL,2019.0,1,1,0
RUS,VNM,2022.0,3,6,-3
SWE,HKG,2004.0,1,2,-1
NOR,BWA,2008.0,1,1,0
CHE,DZA,2013.0,1,1,0
NLD,NGA,2012.0,1,3,-2
GHA,IND,2022.0,1,1,0
BWA,TZA,2010.0,1,1,0
SWE,SDN,2016.0,1,2,-1
ZAF,PAK,2022.0,1,1,0
BEL,CMR,2001.0,1,1,0
TUR,RUS,1998.0,1,1,0
CIV,CAN,2007.0,1,1,0
MEX,ISR,2008.0,1,1,0
COL,IRL,2010.0,1,2,-1
NZL,MEX,2004.0,1,2,-1
ZMB,ZWE,2018.0,1,2,-1
NZL,FJI,2002.0,1,1,0
NOR,UKR,2001.0,1,1,0
COL,VNM,2015.0,1,1,0
BHR,GBR,2009.0,1,4,-3
EST,NLD,2011.0,1,3,-2
EGY,HKG,2007.0,1,1,0
RUS,NZL,2019.0,1,3,-2
CZE,LTU,2004.0,1,1,0
LTU,POL,2009.0,1,1,0
ESP,TZA,2002.0,1,2,-1
BHR,USA,2012.0,1,3,-2
KHM,AUS,2015.0,1,2,-1
JOR,CHE,2017.0,1,3,-2
FIN,MWI,2019.0,1,1,0
TUR,THA,2020.0,1,1,0
ESP,QAT,2022.0,1,1,0
PRT,CUB,2015.0,1,1,0
GBR,USA,2016.0,1604,1495,109
IND,USA,2012.0,927,682,245
CHE,DEU,2012.0,417,596,-179
COD,COG,2015.0,21,18,3
AUS,GBR,2012.0,349,655,-306
BGR,AUT,2010.0,2,1,1
USA,GBR,2013.0,1415,1564,-149
DEU,CHE,2014.0,646,453,193
GBR,POL,2008.0,27,66,-39
PRI,USA,2002.0,42,33,9
FRA,FIN,2010.0,18,17,1
KAZ,RUS,2020.0,32,30,2
GRC,FRA,2007.0,19,27,-8
GBR,MYS,2016.0,127,91,36
FRA,POL,2006.0,17,21,-4
FRA,CHN,2003.0,40,39,1
GBR,BRA,2002.0,59,38,21
SAU,EGY,2009.0,53,159,-106
JPN,MYS,2022.0,7,3,4
BGD,JPN,2018.0,53,72,-19
GBR,LTU,2017.0,9,7,2
NLD,ZAF,2020.0,26,17,9
TUR,CAN,2018.0,35,22,13
SGP,GBR,2021.0,77,83,-6
ESP,POL,2019.0,25,20,5
FRA,PSE,2021.0,6,2,4
MEX,ECU,2018.0,8,8,0
MTQ,FRA,2018.0,23,26,-3
LKA,KOR,2019.0,1,5,-4
GBR,IDN,2021.0,36,20,16
NLD,ITA,2012.0,57,98,-41
DEU,TWN,2007.0,14,8,6
MEX,USA,2004.0,121,146,-25
BRA,NLD,2016.0,41,25,16
NZL,PAK,2016.0,10,6,4
USA,NAM,2020.0,2,3,-1
SGP,IND,2009.0,20,51,-31
NZL,THA,2018.0,6,3,3
COL,MEX,2020.0,42,55,-13
HKG,AUS,2014.0,44,26,18
ITA,CZE,2022.0,19,5,14
USA,BMU,2009.0,2,2,0
NAM,ZAF,2019.0,5,21,-16
ETH,DEU,2015.0,7,8,-1
CHL,CAN,2019.0,18,22,-4
THA,NLD,2008.0,4,7,-3
RUS,CHN,2018.0,19,20,-1
IRN,FRA,2006.0,7,18,-11
ESP,SAU,2020.0,6,6,0
DNK,FRA,2011.0,21,24,-3
FRA,AUS,2003.0,50,39,11
ESP,RUS,2016.0,12,7,5
ESP,POL,2017.0,24,13,11
BRA,CAN,2002.0,22,25,-3
LTU,LVA,2014.0,4,1,3
DEU,DNK,2003.0,57,53,4
SEN,USA,2009.0,4,3,1
DEU,NZL,2006.0,22,14,8
HKG,IND,2004.0,5,1,4
JPN,LTU,2006.0,2,1,1
URY,BRA,2017.0,5,13,-8
ESP,POL,2010.0,10,16,-6
USA,VEN,2015.0,8,18,-10
ITA,ZAF,2013.0,9,5,4
FRA,IRL,2010.0,29,26,3
TWN,SRB,2016.0,2,1,1
KWT,GBR,2009.0,5,5,0
NLD,SWE,2000.0,14,11,3
CUB,USA,2013.0,8,5,3
SYR,JOR,2016.0,5,2,3
SAU,CHE,2016.0,3,2,1
SWE,KOR,2020.0,8,20,-12
BRN,GBR,2012.0,3,4,-1
CAN,TWN,2020.0,11,17,-6
ARG,CHL,2015.0,19,28,-9
THA,KOR,2017.0,8,15,-7
MYS,JPN,2012.0,25,56,-31
MAC,HKG,2013.0,2,18,-16
ARE,FRA,2015.0,4,23,-19
ITA,HRV,2018.0,12,6,6
KOR,UZB,2012.0,1,1,0
GRC,ESP,2009.0,10,8,2
EGY,SWE,2005.0,2,2,0
JOR,GBR,2005.0,4,7,-3
BIH,SRB,2021.0,7,8,-1
SWE,IND,2011.0,22,44,-22
CAN,IDN,2008.0,1,1,0
SEN,BEN,2013.0,1,2,-1
ZAF,UGA,2012.0,7,4,3
AUS,ROU,2011.0,2,4,-2
OMN,PAK,2015.0,6,9,-3
IRL,IRN,2012.0,7,4,3
ROU,AUS,2002.0,3,1,2
MYS,CAN,2022.0,11,1,10
SWE,TUR,2022.0,4,7,-3
FRA,KOR,2000.0,5,1,4
HUN,IND,2022.0,1,3,-2
DEU,KEN,2017.0,14,8,6
PAK,IND,2011.0,12,19,-7
NOR,ISL,2011.0,2,5,-3
IRL,KOR,2009.0,2,6,-4
ZAF,CMR,2012.0,3,3,0
SVN,POL,2021.0,1,1,0
CAN,CRI,2012.0,1,3,-2
ZAF,SWE,2001.0,3,1,2
SWE,MEX,2021.0,3,5,-2
USA,CUB,2014.0,8,8,0
BOL,USA,2011.0,4,4,0
USA,ETH,2007.0,7,2,5
FIN,CHN,2002.0,8,8,0
EGY,PRT,2018.0,2,2,0
BIH,USA,2009.0,1,3,-2
SGP,ARE,2006.0,1,1,0
BLR,ITA,2017.0,1,1,0
LVA,AUT,2008.0,1,1,0
BEL,VNM,2009.0,1,2,-1
LTU,FRA,2022.0,1,1,0
CHE,ISR,2016.0,11,10,1
THA,LAO,2011.0,2,2,0
CAN,VNM,2009.0,1,1,0
DNK,ARG,2003.0,3,1,2
PER,AUT,2011.0,1,1,0
KAZ,UKR,2018.0,1,1,0
AUT,BRA,2003.0,2,3,-1
TWN,NPL,2013.0,1,1,0
NOR,KOR,2007.0,2,1,1
HUN,FIN,2008.0,4,1,3
IDN,NLD,2010.0,4,15,-11
PHL,THA,2019.0,3,4,-1
CHE,GRC,1997.0,2,1,1
CAN,JAM,2019.0,3,3,0
PRT,CHN,2000.0,1,2,-1
SGP,BRN,2016.0,3,1,2
MYS,AFG,2021.0,2,3,-1
ZWE,NAM,2015.0,2,1,1
BOL,FRA,2002.0,4,2,2
ZAF,MYS,2014.0,2,3,-1
DEU,MLT,2019.0,1,1,0
FIN,ARG,2005.0,1,1,0
KAZ,KGZ,2014.0,1,1,0
USA,LBY,2016.0,2,2,0
ZAF,MWI,2006.0,2,2,0
PAK,ITA,2002.0,1,1,0
ISR,RUS,1998.0,4,15,-11
MLI,BFA,2008.0,1,1,0
RUS,KGZ,2011.0,1,3,-2
USA,BFA,2012.0,4,1,3
USA,BGR,1997.0,1,4,-3
CHL,POL,2017.0,1,2,-1
ISR,KOR,2022.0,2,5,-3
OMN,CAN,2004.0,3,3,0
NLD,HRV,2009.0,1,1,0
ARE,DEU,2022.0,1,3,-2
DNK,MEX,2005.0,1,3,-2
MCO,GBR,2018.0,1,2,-1
MMR,THA,2017.0,1,3,-2
GBR,BGD,2009.0,2,15,-13
LBY,IRQ,2006.0,1,1,0
MLI,DEU,2007.0,1,1,0
AUS,BGD,2002.0,1,2,-1
LVA,EST,2015.0,1,8,-7
BLR,MEX,2002.0,1,2,-1
IRL,MWI,2019.0,1,1,0
MYS,SWE,2006.0,1,1,0
USA,,2020.0,110554,0,110554
,BRA,2004.0,14491,0,14491
,HUN,2004.0,1318,0,1318
,CZE,2002.0,1952,0,1952
CAN,,2016.0,9196,0,9196
NOR,,2023.0,9151,0,9151
,BRA,1996.0,2999,0,2999
CHE,,2012.0,2305,0,2305
,AUS,2007.0,7771,0,7771
,CZE,2005.0,2260,0,2260
CUB,,2018.0,683,0,683
DNK,,2003.0,321,0,321
,PAN,2013.0,57,0,57
,NLD,1994.0,5190,0,5190
TWN,,2018.0,6552,0,6552
BRA,,2008.0,2595,0,2595
KOR,,2016.0,9965,0,9965
TUR,,2016.0,3848,0,3848
,THA,1999.0,1413,0,1413
CZE,,2018.0,2015,0,2015
UGA,PAK,2021.0,1,0,1
EGY,,2007.0,270,0,270
SGP,,2021.0,2428,0,2428
,CHN,2016.0,196679,0,196679
,HRV,2001.0,999,0,999
,MYS,2017.0,5059,0,5059
TUN,,2012.0,481,0,481
MAR,,2010.0,203,0,203
,SVN,2007.0,693,0,693
,CHL,2009.0,1782,0,1782
ZAF,,2014.0,822,0,822
LIE,,2018.0,13,0,13
MAR,,2017.0,614,0,614
LUX,,2022.0,251,0,251
IRQ,,2021.0,1289,0,1289
TUN,MRT,2005.0,1,0,1
,CAN,2014.0,12222,0,12222
,FRA,2018.0,10354,0,10354
,COG,2004.0,46,0,46
,ROU,2015.0,1647,0,1647
,ARE,2006.0,154,0,154
,HUN,1996.0,1078,0,1078
MKD,,2015.0,69,0,69
MAR,,2019.0,905,0,905
UGA,MWI,2017.0,1,0,1
LTU,,2021.0,675,0,675
LVA,,2018.0,179,0,179
KEN,ZMB,2014.0,1,0,1
UKR,,2005.0,529,0,529
ZAF,ROU,2007.0,3,0,3
,SRB,1995.0,331,0,331
,MYS,2010.0,4647,0,4647
,IRN,2011.0,11893,0,11893
ARE,,2020.0,362,0,362
,AZE,1999.0,86,0,86
GRC,CHN,2014.0,7,0,7
,SGP,2007.0,1626,0,1626
DZA,JAM,2019.0,1,0,1
,EGY,2012.0,3155,0,3155
ECU,,2024.0,2118,0,2118
,NOR,2014.0,1976,0,1976
,CIV,2010.0,153,0,153
AGO,,2017.0,14,0,14
KNA,,2022.0,9,0,9
,TUN,2008.0,1195,0,1195
,BGR,2009.0,438,0,438
,MAR,2007.0,671,0,671
,BIH,2012.0,212,0,212
,MYS,2019.0,2487,0,2487
BIH,,2016.0,92,0,92
,PAK,2001.0,805,0,805
,GHA,2011.0,336,0,336
FIN,MWI,2017.0,1,0,1
,ETH,2014.0,737,0,737
GMB,,2024.0,131,0,131
,IRL,2018.0,1573,0,1573
,GIN,2014.0,31,0,31
,BFA,2014.0,100,0,100
,OMN,2000.0,84,0,84
,GEO,2013.0,171,0,171
AUT,BGD,2008.0,2,0,2
ESP,,2025.0,47,0,47
SUR,,2021.0,10,0,10
NGA,LBR,2021.0,4,0,4
RUS,YEM,2017.0,1,0,1
MLT,,2021.0,109,0,109
,GAB,2015.0,31,0,31
TUN,GUF,2017.0,1,0,1
,PER,2006.0,267,0,267
,LAO,2015.0,36,0,36
KGZ,,2021.0,50,0,50
DOM,,2024.0,116,0,116
LAO,IND,2019.0,1,0,1
AGO,,2019.0,19,0,19
,HTI,2016.0,18,0,18
,IDN,1994.0,92,0,92
,CIV,2017.0,114,0,114
,ALB,1997.0,3,0,3
ROU,,2007.0,268,0,268
ETH,SWE,2022.0,2,0,2
KGZ,CHE,2021.0,2,0,2
PAK,,2014.0,975,0,975
,EST,2007.0,327,0,327
,BHR,2015.0,85,0,85
,PRI,2006.0,160,0,160
DEU,LIE,2014.0,2,0,2
ITA,SGP,2009.0,6,0,6
VEN,PER,2018.0,6,0,6
CHN,ARG,2011.0,1,0,1
,PRY,2005.0,12,0,12
GBR,LBY,1998.0,1,0,1
SLE,ZAF,2006.0,1,0,1
ECU,CUB,2021.0,4,0,4
VUT,PHL,2020.0,1,0,1
MEX,POL,2008.0,1,0,1
AIA,,2023.0,2,0,2
,CIV,2019.0,60,0,60
,ERI,2018.0,12,0,12
,PRY,2002.0,19,0,19
THA,,2005.0,194,0,194
,NPL,1995.0,14,0,14
LKA,ESP,2016.0,1,0,1
,MNG,1999.0,21,0,21
BMU,THA,2015.0,1,0,1
BDI,,2020.0,12,0,12
SLE,,2012.0,4,0,4
,MNE,2005.0,17,0,17
UKR,,2002.0,237,0,237
ITA,ETH,2007.0,3,0,3
BOL,,2005.0,12,0,12
,MDG,2008.0,63,0,63
QAT,NZL,2018.0,2,0,2
,SUR,2001.0,2,0,2
THA,,2002.0,45,0,45
,LIE,2001.0,6,0,6
,MNE,2002.0,7,0,7
ARM,,1999.0,11,0,11
,GLP,2002.0,7,0,7
SVN,BIH,2005.0,1,0,1
ECU,JPN,2005.0,1,0,1
UKR,BGR,2004.0,2,0,2
,COG,1996.0,3,0,3
ITA,GHA,2003.0,2,0,2
BEL,LBN,2008.0,1,0,1
CRI,NLD,2002.0,1,0,1
RUS,FJI,2002.0,1,0,1
BRB,AUS,2003.0,1,0,1
KWT,NGA,2001.0,1,0,1
IRN,DZA,2012.0,1,0,1
QAT,CHE,2009.0,1,0,1
ESP,IRL,2003.0,8,0,8
BRB,,2024.0,39,0,39
,LBY,1999.0,22,0,22
AZE,UKR,2017.0,1,0,1
ARG,LBY,2004.0,1,0,1
ARE,NLD,1999.0,1,0,1
NIC,MEX,1998.0,1,0,1
ZAF,HUN,2010.0,3,0,3
SEN,ZAF,2008.0,2,0,2
BEL,TZA,2003.0,1,0,1
ZAF,ZMB,2005.0,1,0,1
GRC,POL,2012.0,6,0,6
BEL,SGP,2004.0,2,0,2
DEU,PAN,2009.0,3,0,3
PRY,USA,2012.0,2,0,2
CPV,,2024.0,25,0,25
,BRN,2003.0,13,0,13
ITA,LBY,2017.0,1,0,1
ESP,EUE,2005.0,2,0,2
PAK,IRL,2009.0,3,0,3
NLD,PSE,2013.0,2,0,2
BRN,IND,2021.0,1,0,1
SLV,,2013.0,7,0,7
FRA,QAT,2012.0,18,0,18
,SWZ,1996.0,5,0,5
,FRO,2007.0,3,0,3
,MLI,2008.0,41,0,41
TUR,OMN,2013.0,4,0,4
BGR,SAU,2012.0,1,0,1
DEU,AZE,2008.0,2,0,2
RWA,FRA,2000.0,1,0,1
SLV,HRV,2016.0,1,0,1
BEL,UZB,2012.0,2,0,2
AUT,ARM,2016.0,1,0,1
IND,BRN,2017.0,3,0,3
,LSO,1997.0,3,0,3
CHN,LTU,2020.0,2,0,2
,GUY,2014.0,5,0,5
ZAF,TWN,2005.0,1,0,1
MLT,LBY,2019.0,2,0,2
SVK,,2025.0,5,0,5
ZAF,HUN,2019.0,4,0,4
SAU,PSE,2021.0,5,0,5
MNG,DEU,2022.0,3,0,3
HRV,DNK,2016.0,3,0,3
IRN,ISR,2020.0,2,0,2
AUT,MAR,2016.0,1,0,1
AUS,MNG,2003.0,3,0,3
FJI,,2006.0,7,0,7
FSM,,2009.0,3,0,3
AUS,NGA,2003.0,2,0,2
ITA,MCO,2008.0,2,0,2
PAN,,2013.0,16,0,16
CAF,,2014.0,2,0,2
IRN,SGP,2008.0,4,0,4
TTO,,2015.0,39,0,39
SLE,CHE,2018.0,2,0,2
FIN,LBY,2018.0,1,0,1
NIC,BEL,2006.0,2,0,2
LAO,,2012.0,8,0,8
,SYR,1995.0,13,0,13
NLD,ARE,2006.0,2,0,2
PAK,QAT,2014.0,7,0,7
MYS,PER,2012.0,1,0,1
DOM,PER,2017.0,2,0,2
MLI,,2016.0,30,0,30
ISR,CRI,2021.0,1,0,1
NGA,NLD,2006.0,2,0,2
NZL,ITA,2022.0,1,0,1
IDN,EGY,2021.0,2,0,2
HKG,ISR,2005.0,2,0,2
RUS,MCO,2008.0,1,0,1
AUT,ROU,2010.0,3,0,3
BHR,,2006.0,10,0,10
DEU,LBN,2000.0,1,0,1
CRI,AUS,2007.0,1,0,1
ARE,LBY,2008.0,1,0,1
BEN,KEN,2004.0,2,0,2
LKA,BRA,2005.0,2,0,2
HRV,BEL,2016.0,2,0,2
MDG,NER,2006.0,1,0,1
SYR,LBN,2008.0,1,0,1
ESP,HKG,2003.0,1,0,1
KEN,NOR,2002.0,1,0,1
,ALB,1998.0,9,0,9
KEN,COG,2015.0,1,0,1
NGA,CYP,2005.0,1,0,1
GTM,FRA,2008.0,1,0,1
,GLP,2005.0,5,0,5
TUR,KWT,2017.0,12,0,12
TUN,JOR,2016.0,1,0,1
ROU,ZAF,2011.0,1,0,1
ISR,PER,2015.0,1,0,1
PRT,MOZ,2010.0,1,0,1
ECU,SWE,2004.0,1,0,1
ZAF,BHR,2017.0,1,0,1
RUS,IRL,1999.0,2,0,2
GRC,IRL,2017.0,11,0,11
SLV,USA,2006.0,1,0,1
TUN,CAF,2016.0,1,0,1
HRV,CHE,2013.0,2,0,2
GBR,NCL,2005.0,1,0,1
THA,NAM,2019.0,1,0,1
CCK,,2020.0,1,0,1
CUB,JOR,2014.0,1,0,1
FRO,,2019.0,5,0,5
CIV,JPN,2003.0,1,0,1
ESP,CMR,2020.0,1,0,1
FRO,,2017.0,2,0,2
NLD,YEM,2001.0,1,0,1
SYR,IRQ,2015.0,1,0,1
FIN,ARE,2013.0,1,0,1
SVN,IRN,2006.0,1,0,1
ISR,HND,2018.0,1,0,1
,BMU,2009.0,4,0,4
GBR,NCL,2002.0,1,0,1
PNG,ESP,2016.0,1,0,1
ESP,PAN,2015.0,1,0,1
LTU,AUT,2011.0,2,0,2
KOR,ZAF,2009.0,1,0,1
UGA,HKG,2012.0,1,0,1
KOR,DZA,2015.0,1,0,1
CHN,HRV,2016.0,2,0,2
RWA,AUT,2017.0,1,0,1
ISL,PRT,2012.0,1,0,1
LSO,DEU,2019.0,1,0,1
RUS,NZL,2017.0,1,0,1
LKA,NOR,2021.0,1,0,1
BDI,USA,2014.0,1,0,1
IRQ,MYS,2009.0,2,0,2
ISR,SWE,1997.0,2,0,2
ITA,NPL,2020.0,2,0,2
PSE,SWE,2016.0,1,0,1
IDN,KEN,2016.0,3,0,3
ETH,GBR,2001.0,4,0,4
,GNB,2001.0,1,0,1
ARM,SWE,2014.0,1,0,1
,SWZ,2004.0,3,0,3
CYP,NOR,2006.0,1,0,1
SDN,OMN,2005.0,1,0,1
,LSO,1998.0,2,0,2
COL,POL,2012.0,3,0,3
TUN,MRT,2002.0,1,0,1
UKR,COL,2017.0,1,0,1
OMN,JOR,2005.0,4,0,4
SVK,QAT,2013.0,1,0,1
JOR,CHE,2010.0,2,0,2
FRA,MKD,2001.0,1,0,1
IND,PNG,2014.0,2,0,2
ITA,AFG,2017.0,1,0,1
MEX,IRL,2005.0,4,0,4
GIN,,2007.0,2,0,2
BLR,GBR,2009.0,1,0,1
ZAF,PRT,2008.0,1,0,1
BRA,TWN,2022.0,2,0,2
ESP,ZAF,2013.0,9,0,9
ITA,GNB,2013.0,1,0,1
MDG,MUS,2017.0,2,0,2
PRT,KWT,2014.0,1,0,1
BEL,IDN,2011.0,1,0,1
ESP,MLT,2021.0,1,0,1
UKR,FIN,2014.0,1,0,1
GUF,NLD,2016.0,2,0,2
JPN,OMN,2015.0,2,0,2
SUR,NLD,2020.0,2,0,2
POL,ARG,2022.0,1,0,1
ISL,CAN,2013.0,2,0,2
LUX,KOR,2014.0,1,0,1
,PLW,2012.0,4,0,4
TZA,IRL,2019.0,1,0,1
PAK,IRQ,2013.0,2,0,2
ZMB,GBR,2022.0,2,0,2
DZA,CZE,2022.0,1,0,1
TUR,AUT,1998.0,1,0,1
LBN,POL,2011.0,1,0,1
JOR,BHR,2001.0,4,0,4
KWT,KOR,2021.0,1,0,1
MOZ,,2005.0,2,0,2
GRC,EGY,2001.0,1,0,1
IND,NER,2008.0,1,0,1
IND,PRI,2004.0,1,0,1
AGO,,2010.0,1,0,1
GBR,CAF,2013.0,1,0,1
BOL,,2002.0,3,0,3
,QAT,1994.0,10,0,10
ISL,FRA,2004.0,1,0,1
BRN,USA,1998.0,1,0,1
KHM,SGP,2005.0,1,0,1
ZAF,ISR,2001.0,3,0,3
BGR,SWE,2004.0,3,0,3
USA,BOL,2007.0,2,0,2
ROU,AUS,2005.0,2,0,2
KOR,PRT,2008.0,1,0,1
IDN,PER,2002.0,1,0,1
ARG,AUT,2004.0,1,0,1
GIB,,2009.0,1,0,1
COL,FIN,2022.0,1,0,1
CAN,CMR,2020.0,1,0,1
RUS,CHL,2022.0,2,0,2
BRN,SAU,2012.0,1,0,1
NGA,DNK,2011.0,1,0,1
MYS,EGY,1999.0,1,0,1
BGD,KOR,2002.0,1,0,1
NOR,ARM,2012.0,1,0,1
RWA,TZA,2011.0,1,0,1
LSO,CHE,2018.0,2,0,2
,SOM,2011.0,2,0,2
CHN,GIN,2016.0,1,0,1
,ASM,2012.0,1,0,1
BLR,CAN,2020.0,2,0,2
BDI,CHN,2020.0,2,0,2
ZAF,SVK,2016.0,1,0,1
EGY,SVK,2019.0,1,0,1
NZL,MWI,2020.0,1,0,1
FRA,ISL,2007.0,1,0,1
BHS,USA,2010.0,1,0,1
CHL,POL,2010.0,2,0,2
NLD,SVK,2018.0,1,0,1
USA,DZA,1997.0,1,0,1
AUT,IDN,2009.0,3,0,3
CUB,JAM,2016.0,1,0,1
KEN,MAR,2021.0,1,0,1
EST,COL,2016.0,1,0,1
RUS,TWN,1999.0,4,0,4
NOR,NPL,2012.0,1,0,1
SDN,JOR,2015.0,1,0,1
SAU,MEX,2005.0,1,0,1
RWA,MLT,2019.0,1,0,1
ITA,UZB,2010.0,1,0,1
ZAF,QAT,2022.0,2,0,2
LKA,THA,2002.0,2,0,2
MOZ,,2002.0,2,0,2
CAN,MKD,2013.0,1,0,1
MYS,UZB,2020.0,2,0,2
AUT,EST,2019.0,1,0,1
AUT,UGA,2016.0,1,0,1
SGP,MMR,2021.0,2,0,2
TWN,GRC,2006.0,1,0,1
EGY,ZAF,2012.0,3,0,3
NGA,RWA,2018.0,1,0,1
QAT,COL,2016.0,1,0,1
ETH,POL,2021.0,2,0,2
ALB,,2004.0,1,0,1
PRT,SEN,2018.0,1,0,1
CYP,MLT,2005.0,1,0,1
HRV,EGY,2000.0,1,0,1
MLT,ITA,2012.0,1,0,1
KEN,ITA,2010.0,1,0,1
CAN,GUM,2020.0,1,0,1
USA,MDG,2005.0,2,0,2
GBR,DZA,2007.0,2,0,2
JOR,PSE,2006.0,2,0,2
CIV,RWA,2004.0,1,0,1
PAK,AUS,1999.0,2,0,2
DEU,CRI,2003.0,4,0,4
PHL,GRC,2016.0,1,0,1
CZE,BRA,2002.0,1,0,1
JOR,NLD,2015.0,1,0,1
LSO,GBR,2019.0,1,0,1
DZA,EGY,2018.0,1,0,1
VNM,MLI,2009.0,1,0,1
KOR,BOL,2019.0,1,0,1
ETH,SYR,2011.0,1,0,1
DNK,ARE,2013.0,1,0,1
ARM,GRC,2002.0,1,0,1
ESP,MCO,2015.0,1,0,1
SWZ,ZAF,2009.0,2,0,2
ITA,MAC,2016.0,1,0,1
MEX,NZL,2013.0,4,0,4
SRB,AUS,2016.0,2,0,2
SWE,JOR,2012.0,1,0,1
LUX,COL,2019.0,1,0,1
IRQ,CZE,2019.0,1,0,1
URY,SWE,2019.0,4,0,4
PAK,EST,2017.0,3,0,3
IDN,ITA,2007.0,1,0,1
IDN,,2000.0,4,0,4
REU,USA,2008.0,1,0,1
LVA,DEU,2000.0,5,0,5
IRL,THA,2004.0,1,0,1
DZA,PRT,2002.0,1,0,1
GTM,ECU,2007.0,1,0,1
NLD,ZWE,1999.0,1,0,1
ZAF,UKR,2014.0,1,0,1
TWN,ARE,2016.0,1,0,1
CAN,MLI,2019.0,2,0,2
DNK,SAU,2018.0,2,0,2
PRI,JPN,2009.0,2,0,2
FIN,MAR,2014.0,1,0,1
SYR,MEX,2006.0,1,0,1
SGP,ARM,2005.0,1,0,1
GMB,GHA,2011.0,3,0,3
RUS,MNE,2016.0,1,0,1
DEU,ALB,2008.0,1,0,1
ISR,JOR,2004.0,2,0,2
CRI,CHL,2001.0,1,0,1
COL,TUR,2017.0,2,0,2
POL,TWN,1997.0,1,0,1
POL,LBY,2009.0,1,0,1
FIN,BRA,2000.0,1,0,1
SRB,DNK,2008.0,2,0,2
CAN,MAC,2011.0,2,0,2
UGA,JPN,2015.0,1,0,1
SGP,SEN,2015.0,2,0,2
COL,IRL,2017.0,2,0,2
ETH,BFA,2018.0,1,0,1
MLI,MDG,2003.0,1,0,1
QAT,SAU,2002.0,1,0,1
GIN,BEL,2015.0,1,0,1
CAF,USA,2009.0,1,0,1
GBR,AFG,2021.0,1,0,1
DNK,SVK,2021.0,1,0,1
ZAF,LAO,2007.0,1,0,1
PSE,LBN,2006.0,1,0,1
TZA,PHL,2017.0,1,0,1
IRQ,CZE,2017.0,1,0,1
SGP,KOR,1997.0,1,0,1
TGO,BFA,2013.0,1,0,1
ITA,NGA,2000.0,1,0,1
PSE,QAT,2004.0,1,0,1
KOR,SVN,2007.0,1,0,1
GBR,ALB,2012.0,1,0,1
TUN,LUX,2022.0,2,0,2
KOR,HRV,2021.0,1,0,1
USA,PNG,2013.0,1,0,1
PRT,KOR,2004.0,1,0,1
JPN,IRQ,2020.0,1,0,1
ZMB,CAN,2017.0,1,0,1
FIN,JOR,2008.0,1,0,1
SRB,LVA,2014.0,1,0,1
COL,CHN,2015.0,2,0,2
ETH,HUN,2019.0,1,0,1
GBR,LVA,2017.0,1,0,1
JPN,MKD,2016.0,1,0,1
LKA,GHA,2007.0,1,0,1
NOR,VNM,2013.0,1,0,1
LTU,BGR,2001.0,1,0,1
SRB,TWN,2004.0,1,0,1
PRT,MYS,2016.0,3,0,3
VNM,ZAF,2010.0,1,0,1
USA,BLZ,2008.0,1,0,1
MWI,BWA,2019.0,1,0,1
FLK,ZAF,2016.0,1,0,1
SAU,HUN,2016.0,1,0,1
TUR,HKG,2018.0,1,0,1
NZL,UGA,2013.0,2,0,2
IDN,IRL,2014.0,1,0,1
MEX,CYP,2017.0,1,0,1
RWA,COG,2012.0,1,0,1
MAR,JOR,2022.0,1,0,1
NIC,ROU,2020.0,1,0,1
MYS,ZAF,2021.0,1,0,1
NOR,LTU,2000.0,1,0,1
ITA,PAK,2000.0,1,0,1
CUB,ITA,2007.0,3,0,3
CAN,KNA,2012.0,2,0,2
BEL,HRV,2019.0,2,0,2
BEL,ISL,2021.0,1,0,1
NCL,PYF,2012.0,1,0,1
ITA,UZB,2019.0,1,0,1
ETH,IDN,2021.0,1,0,1
HUN,CYP,2003.0,1,0,1
POL,MKD,2007.0,1,0,1
PHL,ARE,2019.0,1,0,1
LKA,JPN,2000.0,3,0,3
TTO,IND,2004.0,1,0,1
HRV,MKD,2009.0,1,0,1
HKG,GRC,2020.0,1,0,1
RUS,TJK,2011.0,2,0,2
IRL,LVA,2014.0,1,0,1
BLR,PRT,2016.0,3,0,3
TUR,LBN,2015.0,1,0,1
GBR,GAB,2020.0,1,0,1
PYF,USA,2018.0,1,0,1
ITA,SRB,2013.0,1,0,1
ARE,AFG,2020.0,2,0,2
NPL,HKG,2019.0,2,0,2
,TKM,2011.0,4,0,4
URY,IRL,2016.0,1,0,1
FIN,HKG,2015.0,1,0,1
NPL,BGD,2004.0,1,0,1
CIV,NER,2021.0,1,0,1
CYP,CZE,2019.0,2,0,2
CHE,PER,2015.0,2,0,2
IRN,IDN,2014.0,1,0,1
OMN,PSE,2019.0,1,0,1
ARG,GTM,2020.0,1,0,1
CHE,CYP,2009.0,1,0,1
JAM,CAN,2012.0,1,0,1
LKA,IND,2001.0,1,0,1
GEO,JPN,2010.0,1,0,1
ZMB,COG,2020.0,1,0,1
FIN,MAC,2015.0,1,0,1
MWI,USA,2001.0,2,0,2
EGY,NZL,2006.0,2,0,2
GRC,IRL,2010.0,3,0,3
CAF,CHE,2017.0,1,0,1
ITA,LVA,2008.0,1,0,1
KWT,NLD,2008.0,1,0,1
AUS,ISL,2015.0,2,0,2
JAM,KAZ,2008.0,1,0,1
ARG,SRB,2007.0,1,0,1
ZWE,CAN,2012.0,1,0,1
CMR,FIN,2012.0,1,0,1
PYF,CHE,2016.0,1,0,1
GUY,BWA,2014.0,1,0,1
ETH,KNA,2015.0,1,0,1
CRI,IND,2013.0,1,0,1
IRL,PHL,2021.0,1,0,1
SVN,ARE,2018.0,1,0,1
SEN,MYS,2018.0,1,0,1
NOR,TUN,2010.0,1,0,1
IRL,URY,2013.0,1,0,1
IND,BGR,2012.0,2,0,2
CHE,GRC,1998.0,2,0,2
,GUM,2008.0,2,0,2
BRB,JAM,2007.0,1,0,1
TJK,IRN,2014.0,2,0,2
LBR,NGA,2019.0,1,0,1
LVA,CHE,2001.0,1,0,1
URY,PRT,2004.0,2,0,2
ESP,OMN,2003.0,1,0,1
HUN,MEX,2001.0,1,0,1
LBY,BGD,2003.0,1,0,1
TUR,TTO,2017.0,1,0,1
PSE,EGY,2000.0,1,0,1
UZB,GBR,1998.0,1,0,1
GBR,EGY,1997.0,1,0,1
DNK,THA,2022.0,1,0,1
ARE,SWZ,2020.0,1,0,1
USA,ASM,2003.0,1,0,1
CUB,RUS,2009.0,1,0,1
,DJI,2005.0,1,0,1
MDA,USA,2002.0,1,0,1
LBR,PAK,2013.0,1,0,1
USA,BHR,2003.0,1,0,1
CAF,FRA,2006.0,1,0,1
HRV,CAN,2000.0,1,0,1
AUS,GRC,1997.0,1,0,1
ECU,AUS,2012.0,1,0,1
IRQ,ROU,2016.0,1,0,1
ZAF,MEX,2022.0,1,0,1
FRA,ALB,2010.0,1,0,1
NGA,SYR,1999.0,1,0,1
KHM,,2004.0,1,0,1
AUS,BIH,2005.0,1,0,1
NOR,CZE,2014.0,2,0,2
ESP,SLV,2018.0,1,0,1
USA,MDG,2002.0,1,0,1
GHA,NOR,2002.0,1,0,1
COG,PRT,2014.0,1,0,1
GBR,BLZ,2015.0,1,0,1
POL,GEO,2000.0,1,0,1
,LBR,2002.0,1,0,1
MLI,SWE,2013.0,1,0,1
FIN,TZA,2015.0,1,0,1
TKM,KAZ,2013.0,1,0,1
DZA,RUS,2018.0,1,0,1
GRL,,2002.0,1,0,1
DMA,,2021.0,1,0,1
SVN,NZL,2016.0,1,0,1
COL,EGY,2019.0,1,0,1
BLR,ITA,2019.0,1,0,1
,TWN,2020.0,2,0,2
JPN,CUB,2011.0,1,0,1
GEO,ARE,2015.0,1,0,1
DEU,MLT,2010.0,1,0,1
SVN,BIH,2002.0,1,0,1
SWE,GTM,2006.0,1,0,1
MUS,ZAF,2015.0,1,0,1
CAN,ISL,2011.0,1,0,1
KAZ,CZE,1997.0,1,0,1
LKA,NLD,1999.0,1,0,1
FIN,IRL,2001.0,1,0,1
UGA,ESP,2006.0,1,0,1
NPL,IDN,2012.0,1,0,1
PAK,ITA,2005.0,1,0,1
MTQ,SEN,2013.0,1,0,1
MWI,BWA,2010.0,1,0,1
AFG,TUR,2021.0,1,0,1
ESP,PYF,2021.0,1,0,1
COL,CUB,2006.0,1,0,1
BGR,NZL,2015.0,1,0,1
ERI,USA,2009.0,1,0,1
VNM,MAC,2022.0,1,0,1
PAK,EST,2019.0,1,0,1
DNK,MLT,2015.0,1,0,1
CAN,MLI,2017.0,2,0,2
GMB,ITA,2012.0,1,0,1
SMR,CAN,2016.0,1,0,1
OMN,HRV,2019.0,1,0,1
HKG,ARE,2005.0,1,0,1
OMN,FJI,2004.0,1,0,1
FRA,EST,2008.0,1,0,1
BFA,CAF,2003.0,1,0,1
NOR,BRA,1999.0,1,0,1
TUR,QAT,2010.0,1,0,1
,SLB,1998.0,1,0,1
IND,KGZ,2022.0,2,0,2
SWE,CMR,2001.0,1,0,1
GEO,UZB,2013.0,1,0,1
BEN,MLI,2018.0,1,0,1
BHR,ETH,2019.0,1,0,1
PAK,AFG,2006.0,1,0,1
EST,CZE,2008.0,1,0,1
IND,MDV,2017.0,1,0,1
THA,ARE,2019.0,1,0,1
PHL,ARE,2017.0,1,0,1
TUN,GUF,2019.0,1,0,1
,JPN,2020.0,2,0,2
JPN,ARE,2004.0,1,0,1
CYP,PSE,2018.0,1,0,1
BRN,CZE,2019.0,1,0,1
DEU,TUR,2006.0,19,23,-4
ESP,DEU,2015.0,273,138,135
ITA,USA,2016.0,567,300,267
ESP,AUS,2015.0,70,28,42
FRA,BRA,1999.0,35,16,19
BEL,CHE,2013.0,55,38,17
NGA,MYS,2009.0,4,1,3
USA,DEU,2009.0,995,1120,-125
ISR,USA,2009.0,364,285,79
IND,CHN,2009.0,17,10,7
AUS,AUT,2012.0,17,16,1
BRA,ARG,2013.0,20,24,-4
CAN,ISR,2012.0,48,59,-11
GRC,SAU,2018.0,5,2,3
GBR,IRN,2021.0,15,74,-59
USA,KOR,2006.0,689,592,97
POL,GBR,2013.0,54,91,-37
IRL,USA,2014.0,140,120,20
KOR,IND,2012.0,75,165,-90
NLD,DEU,1997.0,26,16,10
GRC,IND,2018.0,1,2,-1
ESP,NOR,2020.0,24,27,-3
HUN,USA,2014.0,60,56,4
BRA,IND,2007.0,8,3,5
DEU,BRA,2007.0,45,64,-19
ESP,FRA,2005.0,115,107,8
USA,IDN,2020.0,31,17,14
GRC,FRA,2008.0,19,23,-4
TUR,ITA,2018.0,19,8,11
ITA,DEU,2012.0,256,154,102
GRC,SWE,2018.0,22,6,16
BEL,NLD,2011.0,102,126,-24
DEU,GRC,2017.0,31,82,-51
USA,JOR,2009.0,40,11,29
NOR,GBR,2020.0,52,104,-52
FRA,TWN,2010.0,10,5,5
AUS,CHN,2008.0,62,107,-45
MYS,IRN,2019.0,98,30,68
GRD,USA,2009.0,8,2,6
VNM,JPN,2014.0,16,38,-22
FRA,MAR,2006.0,58,37,21
CAN,DEU,2001.0,72,105,-33
GBR,ROU,2006.0,7,11,-4
FRA,SAU,2012.0,34,6,28
CHN,PAK,2017.0,127,221,-94
SVK,USA,2006.0,16,11,5
AUT,DEU,2004.0,147,209,-62
GRC,USA,1997.0,7,18,-11
USA,CHN,2001.0,250,642,-392
KOR,AUS,2005.0,11,20,-9
FRA,SGP,2013.0,25,20,5
OMN,CAN,2015.0,3,5,-2
AUS,TWN,2005.0,12,1,11
SAU,MYS,2017.0,17,89,-72
SWE,DNK,2013.0,57,65,-8
BEL,AUS,2018.0,26,27,-1
FRA,TWN,2019.0,14,6,8
BEL,ITA,2013.0,60,78,-18
IRN,SWE,2020.0,56,11,45
CHN,DEU,2015.0,312,276,36
DZA,FRA,2018.0,51,85,-34
MYS,AUS,2016.0,117,98,19
AUT,USA,2008.0,98,86,12
FRA,JPN,2017.0,70,84,-14
KAZ,NLD,2017.0,2,1,1
DEU,HKG,2016.0,8,10,-2
KOR,TZA,2014.0,4,1,3
CHE,NLD,2018.0,84,96,-12
IRN,ITA,2017.0,43,14,29
NGA,USA,2014.0,33,31,2
PRT,USA,2018.0,68,48,20
IND,CHE,2018.0,56,23,33
CHN,PAK,2019.0,267,298,-31
CHN,HKG,2020.0,618,777,-159
CHL,FRA,2015.0,23,49,-26
AUS,DEU,2004.0,62,87,-25
VNM,AUS,2013.0,8,12,-4
BEL,CAN,2017.0,50,38,12
CHN,DNK,2006.0,14,6,8
FRA,DNK,2007.0,32,14,18
SWE,FRA,2016.0,54,80,-26
CHE,FRA,2018.0,237,343,-106
CHE,IND,2019.0,30,45,-15
IRN,GBR,2020.0,102,32,70
MEX,USA,2015.0,193,192,1
USA,AUS,1999.0,161,145,16
POL,FRA,2014.0,124,27,97
DEU,SVK,2005.0,15,20,-5
PAK,ARE,2019.0,20,6,14
PER,COL,2014.0,5,3,2
DEU,THA,2017.0,25,8,17
ARG,COL,2014.0,10,8,2
TUR,NLD,2019.0,29,19,10
DNK,GBR,2014.0,80,97,-17
DEU,ITA,1999.0,63,62,1
PAK,GBR,2020.0,56,87,-31
CAN,UGA,2019.0,2,4,-2
DEU,RUS,2016.0,69,109,-40
FRA,TWN,2017.0,15,11,4
LKA,AUS,2015.0,13,13,0
GBR,TUR,2018.0,73,85,-12
CHE,CAN,2022.0,36,45,-9
CHN,CAN,2014.0,267,205,62
USA,CZE,2005.0,37,49,-12
FRA,JPN,2019.0,91,80,11
RUS,ISR,2019.0,17,9,8
SWE,GBR,2021.0,88,153,-65
DEU,TWN,2008.0,16,17,-1
CHN,ITA,2018.0,32,42,-10
IRN,PRT,2016.0,12,6,6
DEU,PRT,2020.0,33,42,-9
GBR,BWA,2021.0,4,4,0
SWE,CHE,2005.0,17,20,-3
CAN,LUX,2020.0,4,2,2
KOR,OMN,2020.0,2,1,1
CAN,TUR,2020.0,15,43,-28
NZL,USA,2022.0,39,23,16
CHN,CHE,2020.0,89,72,17
BEL,CAN,2019.0,45,32,13
EGY,FIN,2020.0,4,3,1
SAU,USA,2022.0,50,90,-40
KAZ,GBR,2020.0,3,9,-6
MEX,CAN,2009.0,15,22,-7
NZL,CHE,2020.0,6,16,-10
PRT,NLD,2021.0,19,14,5
IDN,SGP,2021.0,3,5,-2
HKG,DEU,2020.0,21,6,15
CHN,ISR,2020.0,28,22,6
FRA,MLI,2020.0,7,7,0
UGA,BEL,2019.0,2,1,1
SAU,CAN,2021.0,37,69,-32
TUN,ITA,2018.0,3,5,-2
MYS,NGA,2020.0,90,29,61
PAK,ARE,2017.0,11,2,9
BEL,COG,2018.0,10,5,5
CHL,CHN,2019.0,5,6,-1
CRI,USA,2018.0,24,18,6
CHN,SWE,2022.0,44,71,-27
MYS,PSE,2019.0,8,2,6
DEU,AUT,2001.0,109,107,2
GBR,JOR,2019.0,36,14,22
TWN,IND,2020.0,43,85,-42
USA,PAK,2019.0,87,120,-33
TZA,CHN,2019.0,2,9,-7
DEU,SGP,2019.0,22,33,-11
IRQ,RUS,2020.0,3,4,-1
CHN,THA,2019.0,28,20,8
GBR,TWN,2016.0,35,33,2
PAK,FRA,2011.0,8,12,-4
BRA,URY,2019.0,15,6,9
PAK,BRA,2019.0,7,2,5
CAN,FIN,2009.0,9,17,-8
CZE,USA,1999.0,38,19,19
DEU,GRC,2019.0,43,73,-30
NLD,DEU,1998.0,36,42,-6
AUS,CHE,2000.0,7,5,2
CAN,EGY,2012.0,40,21,19
MYS,NOR,2015.0,1,1,0
AUT,CHE,2021.0,43,61,-18
AUS,TWN,2002.0,12,3,9
JPN,LKA,2021.0,4,2,2
USA,LSO,2021.0,1,1,0
BEL,CAN,2010.0,42,44,-2
PHL,JPN,2014.0,13,23,-10
SWE,CHN,2016.0,66,80,-14
DEU,HUN,2016.0,27,60,-33
HKG,MAC,2022.0,8,7,1
DEU,SGP,2017.0,39,30,9
EGY,DEU,2021.0,26,27,-1
GBR,FRA,2022.0,146,127,19
GBR,NLD,2009.0,202,194,8
FRA,BFA,2017.0,12,9,3
BRA,ESP,1999.0,7,12,-5
DEU,ISR,2006.0,24,27,-3
URY,GBR,2009.0,1,1,0
ECU,USA,2006.0,13,3,10
PHL,TWN,2010.0,2,1,1
KEN,DEU,2007.0,3,12,-9
JPN,IRL,2004.0,5,1,4
DEU,NOR,2009.0,62,13,49
KOR,SAU,2014.0,19,3,16
SGP,BRA,2014.0,3,2,1
PRT,BRA,2008.0,35,52,-17
RUS,UKR,2007.0,32,32,0
NZL,CAN,2011.0,28,30,-2
CHE,IND,2010.0,15,36,-21
CAN,HUN,2001.0,5,7,-2
DEU,SVK,2002.0,15,19,-4
SRB,GBR,2013.0,4,4,0
CAN,NOR,2020.0,32,14,18
FRA,LTU,2005.0,3,1,2
JAM,USA,2004.0,4,4,0
KOR,GHA,2019.0,4,1,3
IRN,ITA,2010.0,8,8,0
HUN,FIN,2007.0,4,5,-1
ITA,AUT,2006.0,17,20,-3
ESP,BEL,2012.0,42,22,20
IDN,USA,2013.0,14,24,-10
NOR,TZA,2010.0,9,2,7
CHN,IRL,2010.0,13,5,8
USA,NGA,2014.0,31,33,-2
DNK,CZE,2014.0,3,4,-1
USA,ITA,1998.0,129,132,-3
GBR,JPN,2003.0,94,124,-30
DEU,SGP,2010.0,30,20,10
DEU,IRL,1999.0,8,2,6
TZA,CHE,2021.0,5,6,-1
USA,PAK,2017.0,73,122,-49
CHN,SGP,1999.0,45,6,39
ARG,USA,1997.0,7,10,-3
VNM,IRL,2017.0,2,3,-1
GTM,MEX,2011.0,2,5,-3
NOR,TZA,2017.0,7,2,5
GBR,DNK,1999.0,18,19,-1
COG,ZAF,2016.0,2,1,1
CAN,CHE,2000.0,20,19,1
USA,CZE,2002.0,35,55,-20
GBR,UGA,2003.0,11,6,5
NZL,DNK,2009.0,10,5,5
JPN,MMR,2018.0,8,4,4
ARG,USA,1998.0,23,13,10
PRT,ESP,2022.0,54,46,8
POL,SVK,2011.0,3,5,-2
ZAF,TUN,2012.0,1,1,0
SGP,HKG,2017.0,29,37,-8
COL,DNK,2018.0,4,2,2
IRQ,USA,2017.0,12,25,-13
IRN,ITA,2019.0,59,17,42
IRQ,USA,2019.0,19,53,-34
CUB,MEX,2018.0,32,9,23
MYS,TUR,2018.0,8,1,7
UKR,CZE,2018.0,13,5,8
SAU,MYS,2019.0,18,68,-50
FRA,BFA,2019.0,12,6,6
BEL,BGR,2004.0,6,6,0
POL,CAN,2006.0,13,11,2
PHL,TWN,2019.0,11,8,3
URY,ESP,2022.0,5,1,4
TWN,GBR,2021.0,18,27,-9
USA,HUN,2009.0,44,77,-33
UKR,SVK,2017.0,4,2,2
TUR,NLD,2010.0,23,9,14
HKG,SAU,2012.0,4,1,3
CHL,MEX,2014.0,8,17,-9
GBR,SRB,2016.0,4,9,-5
BRA,AUS,2000.0,3,1,2
HKG,ESP,2022.0,1,1,0
PHL,TWN,2017.0,4,8,-4
MEX,ARG,2012.0,8,13,-5
COL,CAN,2008.0,7,4,3
POL,RUS,2012.0,9,17,-8
GAB,CMR,2011.0,2,1,1
USA,CRI,2005.0,4,3,1
ESP,VEN,2011.0,17,29,-12
AUT,PRT,2005.0,2,1,1
GRC,DEU,2006.0,27,25,2
CZE,EST,2018.0,7,1,6
RUS,ISR,2010.0,9,3,6
BEL,SYR,2012.0,3,2,1
RUS,JPN,2005.0,20,29,-9
IND,ISR,2007.0,21,11,10
FIN,AUS,2012.0,13,10,3
BEL,BEN,2021.0,3,3,0
TUR,SAU,2003.0,3,1,2
HUN,SWE,2008.0,10,5,5
ITA,DNK,2014.0,34,16,18
SWE,ITA,2007.0,26,21,5
JPN,MNG,2002.0,5,2,3
UGA,USA,2011.0,27,22,5
MEX,NLD,2004.0,4,3,1
USA,UKR,2011.0,11,26,-15
NLD,BRA,2003.0,10,6,4
HUN,BEL,2005.0,5,6,-1
CYP,GRC,2000.0,2,1,1
BGR,FRA,2015.0,5,2,3
MYS,ITA,2016.0,7,2,5
DNK,ESP,2003.0,8,14,-6
GHA,USA,2001.0,3,2,1
DEU,GRC,2010.0,25,50,-25
ESP,URY,2003.0,8,5,3
BRA,GBR,2006.0,34,48,-14
USA,GHA,2003.0,5,5,0
CHE,BEL,2001.0,13,11,2
USA,EGY,2004.0,61,43,18
GBR,GRC,1998.0,16,14,2
SVN,ITA,2003.0,3,1,2
NOR,SWE,2014.0,45,74,-29
EGY,SAU,2002.0,19,29,-10
VEN,ESP,2009.0,27,24,3
IRN,CAN,2003.0,30,30,0
RUS,JPN,2002.0,43,54,-11
ITA,ISR,2004.0,8,13,-5
IND,POL,2013.0,31,5,26
ARM,RUS,2020.0,3,9,-6
NLD,POL,2006.0,4,9,-5
NLD,GRC,2003.0,9,8,1
FIN,RUS,1999.0,5,9,-4
RUS,UZB,2002.0,10,2,8
FRA,SVK,2003.0,5,3,2
BEL,IRL,2010.0,8,5,3
ARE,EGY,2016.0,10,9,1
HUN,BGR,2006.0,1,2,-1
IRL,NLD,2003.0,8,9,-1
HUN,JPN,2009.0,3,7,-4
CAN,BEL,2008.0,20,31,-11
USA,BEL,2000.0,26,45,-19
SEN,FRA,2005.0,22,20,2
IND,JPN,1999.0,26,11,15
CAN,IRL,2007.0,22,25,-3
RUS,ISR,2017.0,14,7,7
BEL,SGP,2015.0,11,6,5
IDN,MMR,2018.0,1,1,0
KEN,ETH,2016.0,4,3,1
SWE,CHE,2002.0,24,19,5
RUS,CAN,2006.0,24,10,14
EGY,USA,2002.0,39,38,1
NZL,MYS,2008.0,5,4,1
CHE,UKR,2004.0,1,3,-2
ARG,GBR,2004.0,19,11,8
LKA,GBR,2022.0,5,4,1
SEN,FRA,2002.0,23,17,6
MLT,GRC,2013.0,1,1,0
ARE,USA,2012.0,10,57,-47
GBR,OMN,2018.0,15,9,6
IRL,IND,2012.0,12,13,-1
USA,CHL,2000.0,16,12,4
BEL,CZE,2005.0,2,4,-2
ISL,SWE,1999.0,2,3,-1
AUT,ZAF,1999.0,4,2,2
CHE,MEX,2012.0,5,5,0
DEU,ROU,2000.0,5,7,-2
SRB,ITA,2002.0,8,1,7
BEL,IRL,2017.0,9,10,-1
ZAF,NZL,2015.0,9,3,6
EGY,KWT,2008.0,11,8,3
ESP,SVK,2009.0,3,1,2
JPN,IND,1999.0,11,26,-15
ECU,ESP,2008.0,6,1,5
GBR,FJI,2019.0,3,2,1
BRA,ISR,2008.0,2,1,1
ZAF,DNK,2002.0,1,1,0
USA,CRI,2002.0,13,5,8
CMR,NLD,2011.0,2,1,1
UKR,SVK,2010.0,1,1,0
NGA,FIN,2017.0,1,2,-1
USA,BOL,2008.0,3,4,-1
CHE,IND,2017.0,37,30,7
ZAF,BEL,2011.0,6,6,0
CAN,SWE,2009.0,27,35,-8
ESP,LUX,2016.0,7,4,3
CAN,ROU,2009.0,7,1,6
KEN,COG,2004.0,1,1,0
JPN,IRN,2014.0,15,11,4
POL,GRC,2017.0,1,4,-3
DEU,UKR,2008.0,15,19,-4
THA,NLD,2007.0,3,4,-1
AUT,SVN,2016.0,3,8,-5
AUS,TUR,2011.0,7,6,1
RWA,USA,2012.0,2,3,-1
GRC,CAN,2015.0,19,8,11
BFA,FRA,2012.0,17,16,1
MEX,BEL,2002.0,3,3,0
HRV,AUT,2004.0,3,1,2
ZAF,SAU,2013.0,4,5,-1
CHN,LKA,2022.0,1,1,0
DNK,ISR,2013.0,2,4,-2
TUR,NLD,2017.0,21,20,1
SWE,UGA,2009.0,2,1,1
BRA,AUT,2012.0,3,4,-1
CHN,THA,2017.0,23,25,-2
JPN,ESP,2015.0,10,24,-14
BGD,DEU,2016.0,7,4,3
PAK,ARE,2010.0,3,2,1
SWE,HKG,2015.0,4,4,0
DEU,URY,2021.0,1,1,0
AUT,HRV,2017.0,3,5,-2
PRT,AUS,2016.0,11,7,4
BEL,POL,2020.0,10,4,6
SAU,MYS,2010.0,5,16,-11
SGP,VNM,2014.0,5,6,-1
DNK,NLD,2013.0,13,32,-19
UKR,NLD,2020.0,7,1,6
ZAF,SDN,2014.0,3,1,2
ROU,JPN,2012.0,2,3,-1
USA,RWA,2005.0,1,1,0
MEX,IND,2019.0,8,14,-6
TUR,BEL,2016.0,6,10,-4
CHE,ARE,2021.0,1,2,-1
ARG,URY,2022.0,8,4,4
LBN,BEL,2014.0,5,1,4
BEL,HUN,2007.0,3,4,-1
MLI,CIV,2017.0,2,2,0
ARG,CUB,2010.0,1,6,-5
USA,PSE,2010.0,2,3,-1
HND,ESP,2021.0,1,1,0
LUX,USA,2017.0,9,6,3
SGP,GRC,2015.0,2,4,-2
BRA,URY,2017.0,13,5,8
USA,PSE,2017.0,5,2,3
CHE,ZWE,2015.0,1,2,-1
NLD,EGY,2015.0,4,4,0
ARE,CAN,2021.0,22,14,8
SVN,USA,2020.0,8,10,-2
LUX,CHE,2017.0,6,5,1
KOR,RWA,2019.0,1,2,-1
GRC,AUS,2013.0,19,5,14
MKD,DEU,2017.0,4,1,3
CZE,IRN,2014.0,2,3,-1
SLB,KOR,2020.0,1,1,0
KEN,BEL,2008.0,5,2,3
KHM,USA,2022.0,1,1,0
RUS,EST,2018.0,1,2,-1
TWN,CHE,2022.0,4,3,1
EGY,USA,2005.0,47,56,-9
USA,PAK,2010.0,44,51,-7
ROU,USA,2012.0,12,27,-15
EGY,JPN,2001.0,13,9,4
CAN,DNK,2009.0,18,12,6
KWT,OMN,2005.0,1,1,0
ESP,JPN,1999.0,9,4,5
GBR,ARE,1999.0,4,2,2
ITA,JPN,2016.0,25,20,5
KEN,SWE,2018.0,3,5,-2
NPL,IND,2012.0,17,17,0
KOR,FRA,2005.0,5,11,-6
MLI,USA,2011.0,1,3,-2
PAK,TUR,2015.0,16,1,15
USA,HRV,2022.0,5,7,-2
DNK,IND,2020.0,13,33,-20
IRN,NZL,2016.0,20,3,17
PRT,CAN,2013.0,13,8,5
AUS,LKA,2014.0,14,18,-4
PRI,ESP,2019.0,1,2,-1
HRV,ESP,2021.0,3,2,1
RUS,KAZ,2003.0,5,8,-3
FIN,SWE,1999.0,19,13,6
CHE,NOR,2015.0,26,6,20
MYS,OMN,2014.0,8,4,4
CZE,BGR,2016.0,2,3,-1
KEN,NLD,1999.0,2,1,1
SAU,RUS,2016.0,1,3,-2
FIN,LTU,2019.0,2,2,0
NOR,NLD,2012.0,12,22,-10
MEX,ITA,2008.0,7,8,-1
CHN,PAK,2010.0,24,14,10
COL,JPN,2013.0,1,3,-2
SWE,SAU,2022.0,5,6,-1
MEX,COL,2022.0,13,13,0
HKG,FRA,2016.0,10,6,4
USA,ECU,2022.0,9,11,-2
USA,VEN,2004.0,24,36,-12
LBN,DEU,2015.0,5,2,3
PAK,BRA,2017.0,4,13,-9
ESP,CUB,2015.0,13,29,-16
PAK,OMN,2018.0,3,4,-1
EST,FIN,2015.0,14,15,-1
CRI,ARG,2019.0,1,2,-1
JPN,NOR,2004.0,5,2,3
HUN,AUS,2002.0,1,1,0
TWN,ISR,2014.0,1,1,0
ETH,CAN,2022.0,4,2,2
IND,IRN,2006.0,11,3,8
USA,ISL,2000.0,3,1,2
BRA,JPN,2000.0,4,6,-2
SWE,ZAF,2006.0,6,4,2
MEX,THA,2017.0,1,1,0
FRA,BFA,2010.0,4,10,-6
ITA,NOR,2002.0,9,11,-2
ESP,IND,2001.0,6,4,2
DEU,LUX,2006.0,11,2,9
SWE,ESP,1999.0,6,9,-3
HKG,TWN,2013.0,5,12,-7
CHE,ARG,2012.0,3,5,-2
DNK,SDN,2001.0,1,1,0
JPN,THA,1999.0,5,1,4
ESP,KOR,2003.0,1,1,0
TUN,JPN,2012.0,1,1,0
IND,GRC,2021.0,1,2,-1
BRA,DNK,2004.0,3,2,1
TUR,IND,2018.0,6,5,1
IRL,GRC,2007.0,1,5,-4
OMN,EGY,2011.0,2,2,0
ETH,DEU,2004.0,4,4,0
JPN,ZMB,2009.0,3,1,2
ISR,BEL,2009.0,3,3,0
CHE,CIV,2015.0,1,1,0
GEO,GBR,2011.0,3,1,2
QAT,DEU,2019.0,6,3,3
CZE,MEX,2017.0,3,2,1
NLD,PRT,2006.0,9,9,0
MWI,GBR,2013.0,10,13,-3
CZE,NLD,2018.0,9,5,4
VEN,MEX,2005.0,5,1,4
CAN,SAU,2001.0,6,8,-2
ISL,FRA,2015.0,3,1,2
CAN,LBN,2016.0,10,9,1
NOR,AUS,2014.0,6,14,-8
GBR,ECU,2005.0,3,1,2
GHA,IRN,2019.0,2,2,0
MEX,CHE,2009.0,7,6,1
ETH,ZAF,2017.0,7,11,-4
SGP,QAT,2013.0,4,1,3
JOR,USA,2013.0,29,49,-20
DEU,BFA,2017.0,1,1,0
SRB,CHE,2012.0,4,4,0
HRV,BRA,2012.0,1,2,-1
DOM,USA,2012.0,1,4,-3
THA,PAK,2017.0,8,3,5
ISR,FIN,2020.0,4,3,1
SDN,USA,2018.0,4,2,2
EGY,NLD,2014.0,4,5,-1
GBR,FJI,2017.0,3,3,0
THA,PAK,2019.0,6,5,1
SAU,BGD,2022.0,4,6,-2
CRI,CHE,2020.0,1,4,-3
NOR,TZA,2019.0,5,4,1
ESP,PRY,2020.0,4,2,2
IRN,AFG,2022.0,1,1,0
JPN,PHL,2004.0,15,8,7
SVK,SVN,1998.0,2,1,1
USA,ROU,2000.0,5,19,-14
NOR,CYP,2011.0,1,1,0
DEU,ISL,2006.0,2,1,1
BEL,GRC,2013.0,5,34,-29
AUT,CHN,2011.0,5,7,-2
ITA,CMR,2016.0,8,3,5
UKR,SVK,2019.0,4,2,2
GBR,MLT,2006.0,8,5,3
NER,BFA,2018.0,1,2,-1
ISR,CAN,1999.0,7,10,-3
JPN,ARE,2015.0,2,1,1
KOR,BEL,2011.0,4,2,2
CHE,LUX,2012.0,1,1,0
CHN,IRL,2019.0,15,30,-15
GBR,SVN,2002.0,5,2,3
MKD,AUT,2017.0,3,1,2
CAN,ARM,2011.0,1,1,0
GBR,MWI,2007.0,7,8,-1
SGP,THA,2008.0,1,7,-6
BWA,NGA,2015.0,3,1,2
LTU,GBR,2011.0,1,4,-3
IDN,AUS,2021.0,19,43,-24
SRB,CHL,2020.0,1,1,0
TUN,ESP,2016.0,4,9,-5
KEN,IDN,2018.0,1,2,-1
CMR,CAN,2003.0,1,1,0
CRI,MEX,2016.0,2,3,-1
CZE,MEX,2019.0,1,4,-3
USA,SWZ,2021.0,2,5,-3
CZE,PAK,2018.0,4,3,1
ARE,SRB,2018.0,1,1,0
MAR,TGO,2017.0,4,1,3
SVK,SAU,2018.0,2,1,1
TJK,RUS,2019.0,2,7,-5
CHN,THA,2010.0,3,3,0
SLE,USA,2017.0,5,9,-4
CUB,COL,2002.0,1,4,-3
UKR,NOR,2016.0,3,1,2
MAR,ITA,2021.0,5,3,2
RUS,IRQ,2022.0,2,2,0
DNK,SGP,2007.0,2,2,0
FRA,HUN,2001.0,11,14,-3
CAN,MAR,2014.0,9,3,6
GRC,ROU,2012.0,4,3,1
HUN,CAN,2015.0,6,5,1
RUS,ZAF,2015.0,2,1,1
LTU,SWE,2020.0,5,6,-1
ZMB,ZAF,2009.0,3,1,2
ISR,POL,2007.0,2,1,1
AUT,CAN,2001.0,11,12,-1
NOR,KOR,2008.0,2,4,-2
GRC,USA,1998.0,10,22,-12
USA,GEO,2009.0,9,5,4
UKR,JPN,1997.0,2,1,1
JPN,SVK,1998.0,2,2,0
KEN,TZA,2018.0,1,7,-6
LUX,FRA,2008.0,6,21,-15
SWE,SRB,2005.0,3,2,1
JPN,PRT,2003.0,6,3,3
NGA,ZAF,2002.0,2,1,1
KOR,AUS,2002.0,12,8,4
QAT,LBN,2014.0,1,2,-1
NPL,JPN,2022.0,4,1,3
CHL,GBR,1999.0,2,1,1
GHA,JPN,2005.0,2,1,1
KOR,CHN,2000.0,4,10,-6
NZL,TWN,2003.0,2,1,1
POL,BEL,2005.0,5,9,-4
EST,SWE,2011.0,3,9,-6
BEL,CHL,2018.0,8,6,2
QAT,PAK,2015.0,1,7,-6
ESP,CHN,2006.0,3,4,-1
SAU,LBN,2016.0,5,5,0
IRQ,USA,2010.0,6,2,4
SRB,NLD,2020.0,3,4,-1
NLD,CHL,2013.0,4,8,-4
NLD,SRB,2016.0,1,7,-6
NLD,BGD,2011.0,3,3,0
BFA,DEU,2008.0,2,1,1
QAT,FRA,2013.0,3,12,-9
ITA,KOR,2014.0,3,7,-4
LTU,DEU,2015.0,3,4,-1
LTU,CHE,2019.0,4,3,1
MAR,YEM,2015.0,1,1,0
BFA,CIV,2020.0,3,1,2
HKG,BEL,2020.0,2,3,-1
CHN,IRL,2017.0,10,26,-16
CRI,FRA,2005.0,1,2,-1
NLD,KEN,2007.0,3,1,2
GEO,USA,2016.0,9,29,-20
POL,CZE,2009.0,4,1,3
EGY,DNK,2009.0,1,3,-2
GBR,SVN,2005.0,7,6,1
LBN,EGY,2012.0,4,3,1
BEL,CZE,2002.0,7,5,2
LBN,GBR,2016.0,4,10,-6
TUR,EGY,2020.0,4,7,-3
CHE,COG,2020.0,2,3,-1
KOR,LKA,2015.0,5,3,2
ROU,KOR,2019.0,1,1,0
CZE,SAU,2020.0,1,1,0
RUS,AZE,2013.0,3,5,-2
EGY,BEL,2013.0,4,1,3
MYS,PSE,2017.0,9,2,7
PAK,JOR,2021.0,3,3,0
BFA,MLI,2013.0,2,1,1
ZAF,CHL,2022.0,1,1,0
ESP,HUN,2009.0,4,9,-5
ROU,CAN,2011.0,7,6,1
CMR,AUS,2013.0,1,1,0
CZE,PRT,2008.0,1,3,-2
ZAF,TZA,2010.0,4,4,0
PHL,NZL,2014.0,3,1,2
MDA,RUS,2002.0,2,2,0
JPN,DNK,1998.0,3,3,0
COL,PAN,2019.0,3,1,2
SVK,FRA,2015.0,4,3,1
ITA,ARG,1999.0,5,11,-6
FRA,MYS,2008.0,3,5,-2
ARE,LBN,2021.0,1,7,-6
LUX,USA,2010.0,3,11,-8
NZL,ZAF,2015.0,3,9,-6
NLD,MWI,2008.0,1,1,0
DNK,NGA,2013.0,1,1,0
TWN,IRN,2016.0,2,5,-3
LVA,AUT,2007.0,1,1,0
IRL,KWT,2019.0,2,1,1
GHA,JPN,2002.0,2,1,1
EST,RUS,2017.0,4,1,3
BEL,IRL,2019.0,9,19,-10
FRA,ZWE,2012.0,1,1,0
JPN,ISL,2011.0,1,1,0
ESP,IDN,2014.0,1,1,0
KAZ,FRA,2020.0,4,4,0
TWN,FIN,2019.0,1,1,0
CAN,UGA,2010.0,1,1,0
PER,GBR,2007.0,3,5,-2
RWA,UGA,2017.0,3,1,2
NLD,IND,1999.0,1,6,-5
MKD,ARE,2016.0,1,1,0
ETH,LKA,2011.0,1,1,0
TWN,RUS,2020.0,5,3,2
AFG,USA,2013.0,4,1,3
SLE,USA,2019.0,5,3,2
MEX,BEL,2005.0,3,5,-2
ETH,FRA,2003.0,2,2,0
GBR,SYR,2014.0,2,3,-1
DEU,MNG,2020.0,1,3,-2
LUX,PRT,2014.0,1,3,-2
TUR,SVN,2000.0,1,1,0
ARG,NOR,2013.0,1,3,-2
ARG,NLD,2013.0,4,4,0
ZAF,ROU,2008.0,2,1,1
NCL,AUS,2020.0,2,2,0
LBY,GBR,2012.0,1,11,-10
TUR,BGR,2015.0,1,1,0
ZAF,BRA,2021.0,3,6,-3
MYS,PRT,2013.0,3,1,2
BLR,DEU,2014.0,2,3,-1
VEN,FRA,2014.0,4,1,3
EST,CHE,2022.0,1,2,-1
CHE,ROU,2022.0,4,2,2
BGR,SWE,2015.0,2,1,1
CHE,LVA,2020.0,1,1,0
POL,GRC,2019.0,2,2,0
SWE,KEN,2021.0,2,2,0
NGA,ETH,2011.0,1,1,0
ETH,AUT,2011.0,1,2,-1
DNK,GRL,2022.0,2,1,1
OMN,IRN,2020.0,1,12,-11
BHR,KWT,2013.0,1,1,0
HUN,BEL,2002.0,3,6,-3
MKD,SRB,2014.0,3,2,1
VNM,NLD,2008.0,1,2,-1
NLD,HUN,2003.0,7,6,1
GMB,NGA,2019.0,1,1,0
GBR,SDN,2006.0,2,1,1
GAB,DEU,2022.0,1,2,-1
BOL,BRA,2021.0,1,3,-2
BGR,POL,2000.0,1,1,0
GBR,GRC,1997.0,5,3,2
CZE,DNK,2002.0,2,1,1
ARG,CHE,2003.0,4,1,3
MEX,IND,2010.0,1,2,-1
ARG,CHL,2004.0,4,5,-1
TUN,MAR,2006.0,1,1,0
COL,CRI,2012.0,1,2,-1
IRN,RUS,2014.0,1,1,0
UZB,DEU,2007.0,2,2,0
THA,PRT,2020.0,1,3,-2
TUR,BGD,2011.0,1,1,0
CZE,ESP,2015.0,4,33,-29
NGA,ITA,1998.0,1,1,0
OMN,ARE,2003.0,1,1,0
GUY,USA,2006.0,1,2,-1
ITA,CYP,2012.0,1,2,-1
UGA,KEN,2013.0,8,2,6
SGP,BEL,2022.0,1,1,0
BFA,NLD,2003.0,1,1,0
ISR,SGP,2016.0,5,4,1
MEX,GRC,2011.0,1,1,0
MAR,CAN,2015.0,5,8,-3
BGR,ITA,2000.0,1,2,-1
BLR,IRL,2007.0,1,1,0
ITA,ETH,2008.0,2,3,-1
THA,PAK,2010.0,3,1,2
BEL,ROU,2003.0,2,3,-1
CZE,MEX,2010.0,2,1,1
PRT,KOR,2015.0,1,2,-1
POL,HUN,2014.0,7,3,4
QAT,SGP,2013.0,1,4,-3
SDN,DEU,2020.0,4,1,3
CAN,UGA,2017.0,4,2,2
LUX,CHE,2010.0,2,4,-2
FRA,MTQ,2003.0,6,5,1
ARG,CUB,2017.0,3,3,0
CHL,CHN,2017.0,3,3,0
ITA,MKD,2017.0,1,1,0
AUT,MKD,2018.0,1,1,0
CMR,FRA,1997.0,1,1,0
CAN,NGA,2020.0,3,16,-13
KEN,IND,2016.0,2,1,1
IND,IDN,2022.0,1,1,0
EGY,ITA,2001.0,1,1,0
BEN,NGA,2021.0,2,2,0
ARM,CAN,2006.0,1,1,0
CUB,PER,2002.0,2,1,1
RUS,NOR,2022.0,3,3,0
EGY,AUT,2006.0,1,4,-3
CAN,PRI,2014.0,2,1,1
ETH,SGP,2021.0,1,2,-1
AUS,SAU,2002.0,3,3,0
CMR,DEU,2012.0,1,5,-4
MLI,CIV,2010.0,2,2,0
IRL,MLT,2019.0,4,1,3
MMR,AUS,2022.0,2,6,-4
CHE,ISL,2016.0,2,3,-1
BWA,DEU,2015.0,1,2,-1
USA,BEN,2019.0,1,2,-1
NOR,ALB,2014.0,1,1,0
PRI,ESP,2017.0,2,2,0
ESP,THA,2013.0,1,1,0
MEX,THA,2019.0,1,1,0
NIC,USA,2009.0,2,2,0
JOR,ITA,2015.0,2,2,0
POL,GRC,2010.0,2,4,-2
ETH,TWN,2015.0,2,1,1
LTU,EGY,2020.0,1,1,0
SWE,RWA,2020.0,1,1,0
LUX,CHE,2019.0,5,9,-4
NGA,HKG,2018.0,3,1,2
TWN,ZAF,2021.0,1,1,0
ARG,VEN,2003.0,1,1,0
RUS,ARM,1998.0,1,1,0
AZE,RUS,2003.0,3,6,-3
SEN,CHE,2014.0,1,3,-2
USA,OMN,1999.0,3,1,2
AUS,SAU,2005.0,2,2,0
SWE,SRB,2002.0,2,3,-1
GMB,ZAF,2012.0,2,1,1
FRA,LTU,2002.0,2,1,1
PER,ITA,2009.0,1,2,-1
NZL,ISR,2009.0,1,2,-1
BIH,SWE,2017.0,1,1,0
KEN,EGY,2021.0,2,3,-1
IRN,SAU,2020.0,3,1,2
NGA,FIN,2019.0,1,1,0
THA,TUR,2020.0,1,1,0
CAN,RWA,2021.0,2,2,0
BEN,CIV,2012.0,1,1,0
ETH,ZAF,2010.0,1,2,-1
FIN,PRT,2006.0,1,2,-1
BRA,PRY,2015.0,2,2,0
RUS,UZB,2005.0,4,3,1
COG,KEN,2004.0,1,1,0
MEX,UKR,2008.0,1,4,-3
ROU,CHL,2009.0,1,2,-1
MNG,JPN,2009.0,1,4,-3
TTO,IND,2015.0,1,5,-4
UZB,ISR,2009.0,1,1,0
QAT,JOR,2012.0,2,5,-3
IRN,TUN,2016.0,2,2,0
NOR,JOR,2018.0,1,1,0
MWI,ZAF,2007.0,2,4,-2
ESP,LBN,2018.0,1,1,0
MDV,NZL,2018.0,1,1,0
BRA,URY,2010.0,4,4,0
SRB,JPN,2020.0,1,1,0
MYS,PSE,2010.0,1,3,-2
USA,PSE,2019.0,3,3,0
CYP,ARE,2021.0,1,1,0
NGA,BEL,2016.0,2,1,1
DEU,PER,2003.0,2,1,1
BGD,THA,2020.0,2,6,-4
FIN,LUX,2016.0,3,2,1
LUX,BRA,2022.0,1,3,-2
BFA,CHE,2014.0,1,1,0
BWA,CAN,2010.0,1,1,0
MOZ,NLD,2019.0,1,2,-1
JPN,KHM,2013.0,1,1,0
JOR,OMN,2021.0,3,1,2
POL,CHL,2012.0,2,1,1
IND,PRI,2015.0,2,1,1
THA,VNM,2006.0,1,2,-1
COD,USA,2019.0,2,1,1
ZAF,CHN,2004.0,1,2,-1
GBR,BOL,2010.0,1,1,0
BRA,NOR,2005.0,1,1,0
MDA,RUS,2005.0,1,6,-5
IND,FIN,1999.0,2,1,1
CHL,ARE,2018.0,1,1,0
ZAF,POL,2004.0,1,1,0
CHN,DZA,2018.0,3,1,2
NZL,EGY,2021.0,1,1,0
JPN,DNK,1997.0,1,1,0
CUB,PER,2005.0,1,5,-4
GBR,TUN,2016.0,2,3,-1
USA,GAB,2016.0,2,3,-1
FRA,HKG,2011.0,1,6,-5
AZE,DEU,2016.0,1,3,-2
SYR,IRN,2017.0,1,1,0
JOR,YEM,2009.0,1,1,0
GBR,BHS,2017.0,1,1,0
ECU,BEL,2014.0,1,2,-1
ZAF,RWA,2022.0,2,1,1
IDN,POL,2021.0,2,1,1
GBR,ZWE,2021.0,3,6,-3
MAR,BEL,2015.0,1,8,-7
IDN,NZL,2021.0,1,5,-4
SVN,GBR,2022.0,1,3,-2
CIV,GBR,2021.0,1,2,-1
KGZ,KAZ,2020.0,1,2,-1
DZA,BEL,2012.0,1,2,-1
BFA,BEL,2014.0,1,1,0
PHL,KEN,2020.0,1,1,0
ZAF,RUS,2008.0,2,1,1
KOR,UKR,2008.0,1,2,-1
ESP,PER,2000.0,1,2,-1
MEX,POL,2007.0,1,2,-1
USA,HND,2020.0,1,2,-1
NGA,TGO,2016.0,1,1,0
USA,ETH,2008.0,1,5,-4
POL,MEX,1997.0,1,4,-3
ESP,VNM,2011.0,1,2,-1
EGY,IRN,2011.0,1,3,-2
NLD,IDN,1999.0,1,4,-3
CAN,URY,2013.0,2,1,1
SWE,EGY,2016.0,1,3,-2
ZAF,SWZ,2007.0,1,1,0
ZAF,AUT,2006.0,2,3,-1
SYR,IND,2005.0,1,1,0
LAO,JPN,2011.0,1,2,-1
AUS,HUN,2014.0,1,1,0
RUS,HUN,2008.0,1,2,-1
ARE,AUT,2021.0,1,2,-1
JOR,PAK,2012.0,1,1,0
PER,UGA,2018.0,1,1,0
IND,GHA,2009.0,1,2,-1
MWI,CHN,2019.0,1,1,0
NPL,DNK,2015.0,1,2,-1
CHN,ZMB,2014.0,1,1,0
NGA,TWN,2018.0,1,1,0
RUS,CYP,2019.0,1,2,-1
THA,HKG,2018.0,1,3,-2
FIN,ZAF,2022.0,1,1,0
DNK,NOR,2012.0,22,15,7
FRA,JPN,2010.0,76,97,-21
AUS,USA,2006.0,369,416,-47
GBR,DZA,2008.0,3,2,1
EST,USA,2003.0,2,5,-3
JPN,KOR,2011.0,128,97,31
USA,THA,2008.0,193,98,95
NPL,USA,2012.0,17,5,12
NGA,ZAF,2005.0,6,7,-1
IRL,GBR,2003.0,89,163,-74
GUF,FRA,2016.0,17,27,-10
USA,LBN,2015.0,47,41,6
ZAF,GBR,2009.0,67,57,10
GBR,POL,2007.0,22,53,-31
AUT,RUS,2013.0,9,9,0
MYS,IRN,2017.0,175,16,159
USA,ITA,1997.0,157,80,77
SWE,CAN,2015.0,44,40,4
LUX,USA,2019.0,9,12,-3
PRT,SWE,2014.0,17,10,7
DEU,CAN,2021.0,124,101,23
PAK,USA,2014.0,78,65,13
GBR,JOR,2017.0,22,9,13
BRA,COL,2022.0,24,12,12
AUT,CHL,2016.0,2,2,0
IND,IRL,2018.0,35,5,30
SGP,LUX,2017.0,4,1,3
CHN,ETH,2022.0,14,3,11
AUS,ESP,2006.0,9,12,-3
KWT,EGY,2021.0,5,7,-2
BEL,GBR,2003.0,67,63,4
HKG,CAN,2014.0,25,22,3
CHN,JPN,1999.0,93,72,21
KOR,ITA,2020.0,10,6,4
DEU,THA,2019.0,21,16,5
CHN,RUS,2018.0,20,19,1
TUN,SAU,2012.0,31,3,28
ROU,GRC,2012.0,3,4,-1
MYS,IRN,2010.0,30,43,-13
SAU,TUN,2018.0,32,86,-54
SWE,BEL,2014.0,17,18,-1
PRT,GBR,2004.0,25,47,-22
MEX,IND,2017.0,10,23,-13
JPN,NLD,2018.0,25,22,3
GBR,ITA,2008.0,175,239,-64
COL,ARG,2009.0,11,5,6
ESP,FRA,2002.0,123,136,-13
SWE,USA,2022.0,70,90,-20
TZA,ZAF,2020.0,4,8,-4
PAK,NOR,2022.0,6,2,4
LBN,ZAF,2007.0,1,1,0
LBN,CAN,2015.0,11,14,-3
SGP,HKG,2019.0,36,33,3
PAN,BRA,2021.0,2,3,-1
MEX,JPN,2022.0,3,2,1
SWE,IRL,2006.0,7,4,3
HRV,FRA,2013.0,6,4,2
BEN,SEN,2016.0,1,2,-1
FRA,DZA,2003.0,29,26,3
CAN,MYS,2003.0,2,2,0
VEN,DEU,2009.0,6,4,2
DEU,LTU,2022.0,4,1,3
EGY,SAU,2005.0,36,21,15
KOR,FRA,2002.0,5,7,-2
LTU,USA,2011.0,4,10,-6
AUT,HRV,2010.0,3,2,1
POL,BEL,2002.0,8,8,0
SGP,HKG,2010.0,13,22,-9
HUN,DEU,1998.0,10,12,-2
CHL,ARG,2018.0,25,31,-6
CAN,ARG,2004.0,15,12,3
VEN,MEX,2002.0,5,2,3
MEX,DEU,2004.0,9,14,-5
FRA,IND,1997.0,5,4,1
ITA,NOR,2005.0,14,3,11
USA,KWT,2001.0,6,3,3
KOR,NGA,2003.0,1,1,0
KOR,TUR,2013.0,3,6,-3
GBR,JOR,2010.0,19,9,10
HRV,DEU,2013.0,12,3,9
FIN,USA,2007.0,57,44,13
MYS,SGP,2016.0,18,12,6
IRN,IND,2014.0,6,24,-18
KOR,NLD,2012.0,8,5,3
TTO,NGA,2019.0,1,1,0
CHE,TWN,2011.0,6,3,3
ZAF,TZA,2019.0,7,4,3
EST,RUS,2019.0,3,3,0
SGP,LUX,2019.0,2,2,0
DNK,DEU,2006.0,42,62,-20
BLR,CHE,2004.0,1,2,-1
FRA,TUR,2016.0,19,16,3
UKR,ISR,2020.0,2,3,-1
EGY,YEM,2020.0,7,1,6
CMR,BEL,2020.0,6,6,0
CUB,COL,2005.0,1,2,-1
HUN,DEU,1997.0,4,8,-4
ARG,SWE,2014.0,4,3,1
SVN,ESP,2016.0,4,4,0
AUT,HRV,2019.0,3,9,-6
MWI,ETH,2010.0,1,1,0
BOL,GBR,2010.0,1,1,0
USA,MOZ,2016.0,4,4,0
CHE,TUR,2016.0,2,19,-17
IRN,HUN,2022.0,2,1,1
SGP,PHL,2005.0,1,3,-2
CAN,POL,1997.0,5,2,3
BLR,USA,2007.0,6,8,-2
BEN,BFA,2015.0,1,1,0
COG,CHE,2018.0,3,9,-6
BWA,CAN,2017.0,2,2,0
QAT,TUN,2012.0,1,2,-1
ROU,NLD,2014.0,10,4,6
JPN,CZE,1998.0,1,1,0
CHE,SRB,1998.0,1,1,0
TWN,SAU,2016.0,9,3,6
CZE,EGY,2011.0,2,1,1
UGA,ZAF,2014.0,5,7,-2
HRV,NLD,2012.0,6,1,5
RWA,UGA,2019.0,4,3,1
CYP,ISR,2014.0,1,1,0
BRA,IDN,2019.0,2,1,1
RUS,ARM,1997.0,2,1,1
CZE,SWE,2003.0,2,2,0
DEU,LKA,2006.0,2,1,1
SGP,SWE,2013.0,9,9,0
MAC,JPN,2017.0,1,1,0
IRN,BRA,2016.0,6,2,4
CUB,ITA,2008.0,4,4,0
SAU,JOR,2005.0,1,3,-2
ITA,BGR,2002.0,7,4,3
USA,AFG,2011.0,5,1,4
MLT,CAN,2013.0,1,2,-1
PAK,BRA,2010.0,3,3,0
SRB,BIH,2012.0,11,13,-2
CZE,ITA,2001.0,2,5,-3
EST,RUS,2010.0,2,4,-2
ISR,ITA,2011.0,5,8,-3
OMN,PAK,2004.0,1,2,-1
ETH,ZAF,2019.0,7,15,-8
DNK,ZAF,2019.0,1,5,-4
DNK,GRC,2000.0,1,1,0
ESP,DZA,2005.0,1,1,0
ITA,DZA,2008.0,1,2,-1
IND,KEN,2020.0,1,2,-1
ESP,CRI,2009.0,2,3,-1
BRA,CUB,2018.0,3,19,-16
PER,IDN,2015.0,1,2,-1
MEX,CZE,2014.0,1,2,-1
SYR,IRN,2019.0,1,2,-1
ECU,SWE,2015.0,1,2,-1
PER,FIN,2011.0,1,1,0
ITA,EGY,2001.0,1,1,0
ZAF,ESP,2011.0,1,2,-1
AUS,NCL,2008.0,1,2,-1
CZE,NZL,2015.0,1,1,0
UGA,BEL,2017.0,1,2,-1
ARG,CUB,2019.0,1,5,-4
BEL,JOR,2015.0,1,1,0
CUB,CHE,2020.0,1,1,0
COG,BEL,2004.0,1,2,-1
DNK,ZAF,2017.0,3,3,0
MAR,DEU,2012.0,2,2,0
CHL,RUS,2015.0,1,1,0
MYS,RUS,2017.0,1,2,-1
SWE,ARG,2022.0,1,2,-1
FRA,SYR,1999.0,2,1,1
ESP,CYP,2022.0,1,1,0
JPN,MNG,2005.0,1,1,0
ARG,PRY,2014.0,2,2,0
KOR,ECU,2021.0,2,2,0
SVN,ARG,2011.0,1,1,0
,KOR,2003.0,9223,0,9223
JPN,,2009.0,18203,0,18203
,ITA,2002.0,13411,0,13411
NLD,,2019.0,6040,0,6040
BRA,,2007.0,2061,0,2061
NOR,,2024.0,16293,0,16293
,ESP,2014.0,13536,0,13536
CHL,,2011.0,590,0,590
AUT,,2013.0,1395,0,1395
,DEU,2005.0,19509,0,19509
,ROU,2004.0,1179,0,1179
,DEU,2002.0,19009,0,19009
NLD,,2017.0,4610,0,4610
GRC,,2021.0,3129,0,3129
NLD,,2010.0,2720,0,2720
ESP,,2016.0,8660,0,8660
,ITA,2005.0,13621,0,13621
,AUS,2008.0,8087,0,8087
,ROU,1996.0,535,0,535
SRB,,2014.0,477,0,477
EGY,,2008.0,278,0,278
ISL,,2016.0,95,0,95
DEU,,2000.0,1439,0,1439
DZA,,2019.0,1046,0,1046
,KEN,2002.0,257,0,257
MEX,,2006.0,547,0,547
CRI,AUS,2008.0,1,0,1
ARG,,2020.0,2875,0,2875
,UKR,1998.0,1912,0,1912
,BEL,2006.0,3094,0,3094
COL,,2014.0,497,0,497
,SGP,2008.0,1797,0,1797
,CUB,1998.0,800,0,800
CAN,,2025.0,46,0,46
,BHR,2004.0,45,0,45
,VNM,2003.0,168,0,168
,IND,2014.0,31528,0,31528
,BRA,2015.0,21461,0,21461
DZA,,2010.0,103,0,103
NPL,,2010.0,64,0,64
SVK,,2016.0,605,0,605
URY,,2022.0,462,0,462
,LTU,2011.0,521,0,521
,TUN,2007.0,1169,0,1169
DZA,,2017.0,514,0,514
ECU,,2023.0,1804,0,1804
,KEN,2005.0,283,0,283
LBN,,2011.0,101,0,101
SVK,KEN,2020.0,4,0,4
,MEX,2009.0,4258,0,4258
,CUB,1997.0,531,0,531
GEO,,2022.0,371,0,371
,SWE,2010.0,3894,0,3894
,LAO,2004.0,26,0,26
,SAU,2000.0,586,0,586
,ECU,1999.0,44,0,44
,UKR,1997.0,1242,0,1242
,JOR,1997.0,72,0,72
,KAZ,2006.0,99,0,99
,NAM,2013.0,28,0,28
ALB,,2015.0,58,0,58
MAC,JPN,2019.0,1,0,1
,KGZ,2010.0,25,0,25
,MAR,2008.0,816,0,816
,UGA,2011.0,321,0,321
,TZA,2012.0,275,0,275
,POL,2016.0,5527,0,5527
LKA,,2016.0,92,0,92
,SWE,2017.0,2888,0,2888
KOR,,2025.0,52,0,52
HTI,,2021.0,27,0,27
KWT,,2018.0,161,0,161
,PNG,2010.0,29,0,29
,REU,2011.0,7,0,7
BRN,,2019.0,41,0,41
,ISR,2018.0,2163,0,2163
ROU,,2008.0,286,0,286
,LBN,2012.0,383,0,383
,PHL,2003.0,220,0,220
GMB,,2023.0,118,0,118
,GTM,2009.0,21,0,21
,JOR,1998.0,281,0,281
,BGD,2018.0,1759,0,1759
,GRC,2013.0,2182,0,2182
,ISL,2018.0,105,0,105
NPL,,2019.0,185,0,185
,SVN,2008.0,708,0,708
,ARM,2012.0,123,0,123
,GRD,2012.0,23,0,23
PYF,,2020.0,19,0,19
NPL,,2017.0,109,0,109
,PNG,2019.0,11,0,11
DOM,,2023.0,97,0,97
MUS,,2021.0,38,0,38
,UZB,2013.0,79,0,79
ZAF,THA,2018.0,2,0,2
MDG,,2021.0,98,0,98
,WSM,2014.0,7,0,7
,BLR,2000.0,315,0,315
,SWE,2019.0,1540,0,1540
COD,KOR,2017.0,1,0,1
,HKG,2018.0,2154,0,2154
SYR,,2021.0,111,0,111
,TGO,2014.0,52,0,52
,BEN,2016.0,124,0,124
MCO,,2022.0,13,0,13
NPL,CHE,2022.0,1,0,1
JPN,GHA,1998.0,3,0,3
ZWE,,2018.0,61,0,61
ESP,FRO,2021.0,1,0,1
,HND,2018.0,31,0,31
ETH,CZE,2022.0,1,0,1
,ZMB,2018.0,92,0,92
,KGZ,2017.0,62,0,62
BLR,EST,2022.0,1,0,1
,CHE,2011.0,4522,0,4522
,HUN,2015.0,1468,0,1468
FIN,,2003.0,418,0,418
ITA,KWT,2019.0,1,0,1
,COG,2015.0,91,0,91
,AFG,2018.0,54,0,54
,CPV,2018.0,14,0,14
BEL,CIV,2014.0,1,0,1
BEL,,1999.0,57,0,57
PRT,PAK,2007.0,1,0,1
DZA,GBR,2009.0,3,0,3
,ZWE,1998.0,139,0,139
CPV,,2023.0,22,0,22
KEN,NZL,2011.0,1,0,1
IRN,SGP,2007.0,2,0,2
,EST,2008.0,321,0,321
FRA,DOM,2018.0,1,0,1
BRN,,2017.0,32,0,32
JPN,KEN,2004.0,4,0,4
CHN,PRT,2004.0,6,0,6
TUR,EST,2019.0,1,0,1
PRT,AGO,2015.0,8,0,8
GNB,,2014.0,3,0,3
TWN,LKA,2020.0,1,0,1
IND,HUN,2007.0,2,0,2
BRB,BGD,2021.0,1,0,1
BRA,ARE,2018.0,5,0,5
,MWI,1999.0,48,0,48
BRB,,2023.0,25,0,25
LIE,AUT,2021.0,3,0,3
,MDG,2007.0,63,0,63
,SWZ,2015.0,15,0,15
,MLI,2007.0,75,0,75
,COL,1994.0,143,0,143
TUR,,2025.0,51,0,51
VEN,,2012.0,442,0,442
,RWA,2006.0,25,0,25
UGA,COG,2009.0,2,0,2
SDN,QAT,2016.0,1,0,1
ROU,KOR,2017.0,1,0,1
NGA,,2001.0,15,0,15
,CRI,1999.0,88,0,88
,ZWE,1997.0,30,0,30
FIN,LTU,2010.0,2,0,2
BFA,,2014.0,32,0,32
MKD,,2004.0,10,0,10
,LAO,1996.0,5,0,5
BGR,CHN,2005.0,1,0,1
ITA,COL,2005.0,2,0,2
IRN,LBN,2021.0,3,0,3
BEN,,2018.0,52,0,52
COL,PHL,2012.0,1,0,1
,TON,2000.0,3,0,3
,BOL,2001.0,24,0,24
CRI,ARG,2010.0,2,0,2
ITA,SVN,2008.0,6,0,6
,FJI,1998.0,10,0,10
CMR,TGO,2006.0,1,0,1
USA,GUM,2009.0,5,0,5
GUF,,2014.0,6,0,6
HRV,,1999.0,12,0,12
SVN,FRA,2000.0,1,0,1
KWT,CZE,2007.0,2,0,2
,SEN,1995.0,64,0,64
RWA,UGA,2010.0,1,0,1
CIV,,2009.0,34,0,34
THA,DNK,2001.0,1,0,1
UZB,KAZ,2016.0,3,0,3
,FRO,2008.0,6,0,6
KWT,NLD,2007.0,1,0,1
CYP,,2002.0,2,0,2
GBR,KGZ,2018.0,2,0,2
CAN,SEN,2014.0,3,0,3
,CAF,1998.0,8,0,8
ZWE,NAM,2004.0,1,0,1
HUN,NOR,2009.0,3,0,3
,FJI,1997.0,10,0,10
QAT,,2013.0,44,0,44
FJI,NZL,2008.0,3,0,3
,GAB,1996.0,14,0,14
FIN,LVA,2003.0,5,0,5
URY,CAN,2004.0,1,0,1
MAR,SEN,2012.0,1,0,1
COL,PAN,2010.0,2,0,2
FLK,GBR,2014.0,1,0,1
USA,MNG,2008.0,1,0,1
ITA,LVA,2007.0,1,0,1
HUN,IRN,2008.0,1,0,1
IND,DNK,1998.0,4,0,4
,NIC,1995.0,13,0,13
GAB,,2013.0,14,0,14
ESP,PAN,2004.0,2,0,2
FLK,,2009.0,1,0,1
BLR,IRN,2016.0,2,0,2
IND,TZA,2003.0,1,0,1
TZA,PRT,1999.0,1,0,1
KOR,IRQ,2007.0,1,0,1
,KHM,2000.0,17,0,17
TGO,,2014.0,16,0,16
KOR,RWA,2010.0,1,0,1
SRB,TWN,2015.0,1,0,1
GBR,BOL,2019.0,1,0,1
POL,LUX,2014.0,5,0,5
TKM,,2014.0,5,0,5
VNM,CAN,2001.0,1,0,1
JOR,DZA,2008.0,2,0,2
RWA,ZAF,2009.0,2,0,2
TTO,,2004.0,17,0,17
HND,JPN,2013.0,1,0,1
IND,FJI,2013.0,2,0,2
PSE,JOR,2014.0,1,0,1
BEN,DEU,2012.0,1,0,1
THA,BTN,2018.0,1,0,1
JPN,BIH,2014.0,2,0,2
CHN,SDN,2013.0,2,0,2
HUN,THA,2015.0,1,0,1
GNB,PRT,2014.0,1,0,1
,GAB,2004.0,19,0,19
FIN,LTU,2017.0,3,0,3
IRN,ARE,2020.0,3,0,3
SLE,AUS,2020.0,1,0,1
RUS,BWA,2019.0,1,0,1
KGZ,DEU,2020.0,4,0,4
LBN,SYR,2021.0,1,0,1
BHR,CHN,2018.0,1,0,1
,PNG,2017.0,30,0,30
NGA,BRN,1999.0,1,0,1
CAN,SGP,2000.0,5,0,5
AZE,,1999.0,11,0,11
VEN,AUS,2008.0,2,0,2
KHM,JPN,2003.0,1,0,1
PER,AUS,2005.0,1,0,1
NPL,SGP,2014.0,2,0,2
SVK,IDN,2015.0,1,0,1
MCO,IRL,2020.0,1,0,1
,YEM,2003.0,27,0,27
CHL,FIN,2013.0,3,0,3
POL,MYS,2014.0,3,0,3
ZWE,NOR,2009.0,1,0,1
NGA,SLE,2012.0,1,0,1
NZL,EST,2013.0,1,0,1
PHL,CAN,2016.0,7,0,7
DEU,CIV,2017.0,2,0,2
THA,KHM,2022.0,2,0,2
GRC,ISR,2018.0,3,0,3
COL,SAU,2016.0,2,0,2
UKR,HUN,2012.0,1,0,1
JPN,ETH,2019.0,5,0,5
USA,AGO,2017.0,1,0,1
MLI,GIN,2015.0,1,0,1
COG,BEN,2003.0,1,0,1
GNB,GIN,2018.0,4,0,4
NLD,KHM,2022.0,1,0,1
LTU,KAZ,2014.0,1,0,1
IRQ,HUN,2022.0,3,0,3
UKR,AUS,2000.0,1,0,1
ARG,BEL,2022.0,2,0,2
,SLE,1995.0,4,0,4
BIH,AUS,2006.0,1,0,1
ISR,AUT,2000.0,2,0,2
KHM,,2015.0,33,0,33
BEL,COL,2007.0,1,0,1
IDN,ITA,2008.0,3,0,3
DNK,NZL,2000.0,1,0,1
MEX,ZMB,2021.0,1,0,1
,GRL,1998.0,2,0,2
LKA,NZL,2012.0,3,0,3
ZMB,,2006.0,13,0,13
,GNQ,1999.0,3,0,3
CHN,KAZ,2013.0,1,0,1
CIV,CAN,2008.0,2,0,2
QAT,DEU,2010.0,1,0,1
MMR,,2014.0,9,0,9
,GUM,2007.0,2,0,2
ARE,KAZ,2007.0,1,0,1
ARG,ECU,2006.0,2,0,2
SRB,SAU,2018.0,1,0,1
UKR,SVN,2011.0,2,0,2
KOR,GHA,2017.0,3,0,3
HKG,NGA,2011.0,1,0,1
NGA,BFA,2001.0,1,0,1
CAN,BHR,2016.0,5,0,5
AIA,,2024.0,5,0,5
BGR,GRC,2001.0,7,0,7
ZAF,MLI,2006.0,1,0,1
BEN,GBR,2013.0,1,0,1
BTN,,2016.0,3,0,3
BRN,VNM,2018.0,1,0,1
CUB,NOR,2019.0,1,0,1
KHM,MYS,2019.0,1,0,1
CHN,BFA,2010.0,2,0,2
GNQ,,2022.0,5,0,5
YEM,LBY,2008.0,1,0,1
BRN,,2010.0,9,0,9
ETH,SAU,2014.0,1,0,1
GBR,BMU,2019.0,1,0,1
KOR,POL,2004.0,1,0,1
CMR,DZA,2004.0,1,0,1
MNG,AUT,2011.0,1,0,1
SYR,CHN,2012.0,1,0,1
NGA,MLI,2016.0,1,0,1
GBR,SOM,2014.0,1,0,1
CAN,FLK,2012.0,1,0,1
SAU,NLD,2002.0,2,0,2
KOR,RWA,2017.0,2,0,2
CHN,BFA,2019.0,1,0,1
ARG,SGP,2020.0,1,0,1
,KGZ,2019.0,26,0,26
BGD,LBN,2018.0,1,0,1
NZL,NOR,2022.0,3,0,3
SYR,GBR,2022.0,1,0,1
HUN,AUS,2005.0,1,0,1
,PYF,2009.0,8,0,8
AUT,RWA,2015.0,1,0,1
USA,SLB,2019.0,1,0,1
MYS,BRA,2015.0,1,0,1
MMR,TWN,2019.0,2,0,2
,BHR,1996.0,14,0,14
SYR,PRT,2013.0,2,0,2
JPN,IDN,1998.0,1,0,1
LSO,USA,2005.0,1,0,1
NLD,TZA,2004.0,1,0,1
ASM,USA,2008.0,1,0,1
ETH,,2003.0,4,0,4
ERI,,2012.0,4,0,4
ISR,NZL,2006.0,3,0,3
EST,CAN,2007.0,1,0,1
JPN,SRB,2001.0,2,0,2
MDA,,2006.0,13,0,13
LUX,MTQ,2019.0,1,0,1
UKR,BRA,1999.0,2,0,2
MYS,NZL,1999.0,1,0,1
USA,NIC,2008.0,3,0,3
POL,JOR,2008.0,1,0,1
JPN,CRI,2012.0,1,0,1
AUT,LKA,2017.0,1,0,1
NZL,MAC,2007.0,1,0,1
FIN,PAK,2013.0,1,0,1
MWI,ZWE,2013.0,1,0,1
CHL,NOR,2020.0,2,0,2
SGP,HUN,2020.0,1,0,1
BRA,HND,2013.0,1,0,1
COL,SWE,2022.0,1,0,1
NER,COG,2019.0,1,0,1
PER,BOL,2009.0,1,0,1
DEU,MAC,2019.0,3,0,3
,SMR,2016.0,1,0,1
ETH,JPN,2022.0,2,0,2
ABW,GBR,2020.0,1,0,1
YEM,DEU,2018.0,1,0,1
ARM,DEU,2004.0,2,0,2
NZL,IRL,1998.0,2,0,2
AUS,CYP,1999.0,1,0,1
PRI,ESP,2010.0,3,0,3
CHN,VNM,2007.0,1,0,1
NIC,PAN,2011.0,1,0,1
IRN,UZB,2009.0,1,0,1
GRC,CZE,2004.0,1,0,1
BOL,CHE,2015.0,2,0,2
DEU,BFA,2019.0,2,0,2
CUB,DOM,2018.0,2,0,2
DOM,MEX,2010.0,1,0,1
ECU,FRA,2004.0,2,0,2
NGA,NAM,2007.0,1,0,1
DEU,BRN,2000.0,1,0,1
COL,LBN,2003.0,1,0,1
KHM,CHE,2012.0,2,0,2
TUR,SGP,2013.0,3,0,3
TUR,JOR,2002.0,1,0,1
QAT,IRN,2004.0,1,0,1
CHN,SRB,2006.0,1,0,1
NLD,BFA,2012.0,1,0,1
SAU,NLD,2005.0,1,0,1
DZA,CHL,2010.0,1,0,1
SAU,CZE,2015.0,1,0,1
JPN,CZE,1997.0,1,0,1
CAN,LAO,2002.0,1,0,1
ETH,MLI,2022.0,1,0,1
BRA,DOM,2019.0,2,0,2
BMU,USA,2008.0,2,0,2
SWE,SVK,2008.0,2,0,2
BEN,KEN,2015.0,1,0,1
MYS,RUS,2019.0,2,0,2
ZAF,ARG,2021.0,2,0,2
EGY,ISR,2011.0,1,0,1
SRB,LBY,2020.0,3,0,3
UGA,AUT,2021.0,1,0,1
SEN,KOR,2020.0,1,0,1
NER,ITA,2022.0,2,0,2
PHL,IRN,2020.0,1,0,1
SYR,MAR,2015.0,5,0,5
SYR,HUN,2022.0,1,0,1
SAU,BGR,2005.0,1,0,1
FRA,ETH,2005.0,4,0,4
GIN,,2008.0,2,0,2
SLE,GBR,2020.0,3,0,3
SGP,KWT,2008.0,1,0,1
DEU,LAO,2003.0,1,0,1
POL,LTU,2022.0,2,0,2
JPN,ETH,2010.0,2,0,2
UKR,NZL,2015.0,1,0,1
VEN,CUB,2011.0,4,0,4
ISR,ROU,2009.0,1,0,1
FIN,MCO,2015.0,1,0,1
UGA,THA,2021.0,1,0,1
MCO,KOR,2007.0,1,0,1
KOR,PRT,2007.0,2,0,2
DEU,JAM,2009.0,1,0,1
NPL,BGD,2015.0,1,0,1
SOM,USA,2021.0,1,0,1
GUY,FRA,2017.0,1,0,1
HUN,MNE,2019.0,1,0,1
BHR,AUS,2016.0,1,0,1
KAZ,USA,2009.0,1,0,1
COG,COL,2000.0,1,0,1
HUN,TUR,2000.0,2,0,2
IND,NER,2007.0,1,0,1
NOR,CHL,2004.0,1,0,1
NLD,CRI,2009.0,1,0,1
FRA,MDA,2016.0,1,0,1
CRI,PAN,2012.0,2,0,2
ISL,IRL,2018.0,1,0,1
CUB,CHN,2013.0,2,0,2
SGP,BGD,2013.0,4,0,4
COG,NOR,2001.0,2,0,2
CYP,,2005.0,5,0,5
BGD,NOR,2015.0,1,0,1
USA,AIA,2015.0,1,0,1
BRB,ITA,2004.0,1,0,1
,CAF,1997.0,1,0,1
COD,COG,2004.0,1,0,1
CZE,DNK,2005.0,2,0,2
BWA,AUS,2002.0,1,0,1
ZWE,GBR,2009.0,4,0,4
CIV,GAB,2011.0,1,0,1
LUX,AUS,2003.0,1,0,1
JPN,MDA,2005.0,1,0,1
LKA,FRA,2004.0,1,0,1
HRV,SVN,2000.0,2,0,2
SVK,NOR,2004.0,1,0,1
NGA,SAU,1997.0,1,0,1
UKR,BRN,2000.0,1,0,1
USA,BHS,2008.0,1,0,1
CHL,CRI,2000.0,1,0,1
JPN,GUF,2007.0,1,0,1
IRL,TTO,2010.0,1,0,1
CMR,CIV,2012.0,1,0,1
KEN,HUN,2014.0,1,0,1
NZL,QAT,2006.0,1,0,1
CHE,ECU,2017.0,1,0,1
MAC,NOR,2013.0,1,0,1
MAC,ARE,2012.0,1,0,1
ZAF,PHL,2020.0,2,0,2
TUR,ALB,2021.0,2,0,2
NER,MDG,2010.0,1,0,1
,TUV,2001.0,1,0,1
POL,ISR,2000.0,1,0,1
PRT,CZE,2002.0,2,0,2
TZA,ATG,2005.0,1,0,1
BEL,BHR,2017.0,1,0,1
KEN,AUS,2006.0,2,0,2
GBR,BMU,2017.0,1,0,1
DEU,MDG,2013.0,1,0,1
SAU,PRT,2021.0,2,0,2
DEU,CYP,2007.0,3,0,3
PLW,USA,2008.0,1,0,1
COM,,2022.0,8,0,8
VNM,IRQ,2021.0,3,0,3
FRA,SRB,2022.0,3,0,3
USA,VUT,2007.0,1,0,1
VEN,PRI,2012.0,1,0,1
CHE,MKD,2005.0,1,0,1
CYP,BEL,2004.0,1,0,1
UZB,UKR,2000.0,1,0,1
SVK,MKD,2020.0,1,0,1
PER,NGA,2018.0,1,0,1
PRT,SAU,2013.0,2,0,2
MKD,DEU,2019.0,2,0,2
CHL,NLD,1997.0,1,0,1
COG,POL,2013.0,2,0,2
BRA,DOM,2017.0,1,0,1
PRI,GBR,2022.0,1,0,1
SVK,BRA,2015.0,1,0,1
PAN,MEX,2012.0,2,0,2
NIC,SLV,2018.0,1,0,1
GEO,NLD,2011.0,1,0,1
SVK,ROU,2013.0,2,0,2
PNG,EGY,2021.0,1,0,1
BEL,HTI,2016.0,1,0,1
JPN,ETH,2017.0,1,0,1
ROU,EGY,2021.0,3,0,3
GRC,KAZ,2018.0,2,0,2
KOR,EST,2019.0,1,0,1
,ATA,2018.0,1,0,1
GIN,USA,1999.0,1,0,1
ZAF,JPN,1997.0,1,0,1
POL,EGY,2006.0,3,0,3
ITA,KWT,2017.0,2,0,2
CAN,MLT,2021.0,1,0,1
BIH,SWE,2019.0,2,0,2
IRL,SVK,2021.0,1,0,1
SSD,SDN,2014.0,1,0,1
,GIB,2000.0,1,0,1
SRB,BRA,2022.0,1,0,1
GBR,BHR,2005.0,1,0,1
ISL,VNM,2017.0,1,0,1
HUN,MNE,2017.0,1,0,1
TUN,HUN,2021.0,1,0,1
AUS,AFG,2021.0,1,0,1
MNE,USA,2018.0,1,0,1
TWN,IRQ,2016.0,1,0,1
VNM,EGY,2016.0,1,0,1
VNM,IRL,2019.0,1,0,1
MMR,KOR,2006.0,1,0,1
SEN,BFA,2011.0,1,0,1
JPN,SVK,1997.0,1,0,1
FRA,CUB,2022.0,1,0,1
BLZ,JPN,2016.0,1,0,1
UKR,BGR,2015.0,2,0,2
NZL,ARM,2006.0,1,0,1
USA,GRL,2004.0,1,0,1
PRT,URY,2014.0,2,0,2
LUX,CHN,2022.0,2,0,2
BGD,SOM,2012.0,1,0,1
PAK,ZWE,2019.0,1,0,1
SGP,SVN,2015.0,1,0,1
MNG,,2003.0,2,0,2
NGA,SAU,1998.0,1,0,1
EGY,JOR,2000.0,1,0,1
UKR,JPN,1998.0,3,0,3
ECU,AUT,2008.0,1,0,1
KEN,COL,2016.0,1,0,1
CAN,PSE,2011.0,1,0,1
PAK,BHR,2021.0,3,0,3
CRI,JPN,2010.0,1,0,1
MOZ,ZAF,2000.0,1,0,1
JPN,ZWE,2014.0,1,0,1
SVN,SGP,2014.0,1,0,1
IRN,CHL,2012.0,1,0,1
SRB,CAN,2007.0,2,0,2
PAN,SWE,2011.0,1,0,1
CMR,TWN,2019.0,1,0,1
SDN,KOR,2010.0,1,0,1
CAN,IDN,2007.0,2,0,2
BOL,CAN,2016.0,1,0,1
BRA,MDG,2020.0,2,0,2
KHM,MYS,2017.0,1,0,1
KHM,AUS,2004.0,1,0,1
VEN,ZAF,2016.0,1,0,1
ETH,COG,2003.0,1,0,1
GBR,ZMB,2006.0,2,0,2
BRA,MAC,2012.0,1,0,1
PRI,ZMB,2012.0,1,0,1
TZA,HRV,2019.0,1,0,1
KOR,LBY,2016.0,1,0,1
MDG,BEL,2021.0,1,0,1
AUS,SDN,2020.0,1,0,1
NLD,JOR,2003.0,1,0,1
SWE,BWA,2014.0,1,0,1
PSE,QAT,2015.0,1,0,1
FIN,ALB,2019.0,1,0,1
SWE,QAT,2015.0,4,0,4
PYF,PRT,2005.0,1,0,1
BWA,PRT,2006.0,1,0,1
REU,ITA,2021.0,1,0,1
GBR,LUX,2001.0,1,0,1
URY,VEN,2007.0,1,0,1
GMB,FRA,2015.0,1,0,1
TTO,GRD,2011.0,1,0,1
LTU,ITA,2016.0,2,0,2
KAZ,MYS,2014.0,1,0,1
NIC,ESP,2009.0,1,0,1
GUY,BEL,2015.0,1,0,1
BOL,AUS,2003.0,1,0,1
KOR,CYP,2011.0,1,0,1
BLR,SWE,2021.0,1,0,1
YEM,USA,2021.0,1,0,1
JPN,IDN,1997.0,2,0,2
TTO,NGA,2010.0,1,0,1
SWE,OMN,2009.0,1,0,1
UGA,TWN,2017.0,1,0,1
CYP,FIN,2014.0,1,0,1
ESP,GTM,2021.0,1,0,1
GTM,ITA,2021.0,1,0,1
ISL,SGP,2015.0,2,0,2
HKG,PAK,2001.0,1,0,1
AUT,BGR,1999.0,1,0,1
NGA,ROU,2020.0,1,0,1
LKA,GHA,2008.0,1,0,1
GMB,NGA,2017.0,1,0,1
KHM,FIN,2016.0,1,0,1
RUS,CYP,2017.0,1,0,1
EST,AUT,2015.0,1,0,1
BGR,SVN,2012.0,1,0,1
GMB,BEL,2022.0,1,0,1
PAK,ARM,2020.0,1,0,1
MLT,IRL,2018.0,1,0,1
NPL,ARG,2020.0,1,0,1
BRA,IDN,2017.0,1,0,1
ARG,PHL,2020.0,1,0,1
SDN,NOR,2022.0,1,0,1
SUR,BEL,2016.0,2,0,2
ARG,HKG,2004.0,1,0,1
JPN,RWA,2012.0,1,0,1
TUR,NGA,2016.0,2,0,2
GBR,ECU,2002.0,2,0,2
DOM,MEX,2017.0,2,0,2
KWT,FIN,2004.0,1,0,1
ITA,ARE,2008.0,1,0,1
TJK,RUS,2010.0,1,0,1
MUS,AUS,2022.0,1,0,1
UKR,HKG,2009.0,1,0,1
BWA,ZAF,1998.0,1,0,1
AUS,GEO,2002.0,1,0,1
UKR,PRT,2002.0,1,0,1
USA,RWA,2002.0,1,0,1
EGY,BHR,2011.0,1,0,1
AUT,IRQ,2009.0,1,0,1
DNK,IDN,2013.0,1,0,1
BEL,SUR,2017.0,1,0,1
BEN,COG,2019.0,1,0,1
EST,LTU,2004.0,1,0,1
ZAF,PRT,2007.0,1,0,1
BEL,BDI,2006.0,1,0,1
KGZ,PSE,2010.0,1,0,1
CRI,SWE,2006.0,1,0,1
MRT,BEL,2004.0,1,0,1
MDG,CHE,2002.0,1,0,1
MWI,NGA,2015.0,1,0,1
ESP,GUM,2012.0,1,0,1
VNM,IND,2009.0,1,0,1
PAN,CAN,2007.0,1,0,1
GUF,IDN,2012.0,1,0,1
TUR,KAZ,2013.0,2,0,2
MAR,MEX,2018.0,1,0,1
PRT,UKR,2012.0,1,0,1
WSM,NZL,2019.0,1,0,1
BEL,SEN,2020.0,1,0,1
CHN,JAM,2020.0,1,0,1
AZE,SAU,2013.0,1,0,1
GUF,MOZ,2019.0,1,0,1
CHE,AZE,2018.0,1,0,1
TUR,EST,2017.0,1,0,1
MKD,SAU,2018.0,1,0,1
PRI,CHN,2020.0,1,0,1
LTU,HUN,2022.0,1,0,1
CUB,GUY,2017.0,1,0,1
NZL,PRT,2022.0,1,0,1
RWA,DEU,2020.0,1,0,1
AUS,SRB,2022.0,1,0,1
BLR,ZAF,2010.0,1,0,1
KOR,PER,2014.0,1,0,1
SLE,SEN,2021.0,1,0,1
MKD,AUT,2019.0,1,0,1
HKG,COL,2017.0,1,0,1
KEN,SAU,2019.0,1,0,1
GHA,BRN,2021.0,1,0,1
BRB,BLZ,2015.0,1,0,1
CHE,SEN,2016.0,1,0,1
LKA,BEL,2004.0,1,0,1
CHE,IRQ,2021.0,1,0,1
SWE,ARM,2002.0,1,0,1
DEU,UGA,2000.0,1,0,1
FIN,IDN,2006.0,1,0,1
DNK,UKR,1999.0,1,0,1
RUS,GRC,1999.0,1,0,1
NPL,NLD,2006.0,1,0,1
ZWE,MEX,2021.0,2,0,2
TUN,QAT,2016.0,1,0,1
DEU,PHL,2000.0,1,0,1
ETH,ZMB,2021.0,1,0,1
GMB,NGA,2010.0,1,0,1
ITA,TZA,2007.0,1,0,1
ZAF,SLE,2004.0,1,0,1
SRB,FIN,2014.0,1,0,1
GHA,UGA,2014.0,1,0,1
FRA,IRQ,2012.0,1,0,1
AUT,TWN,2006.0,1,0,1
BEL,LBN,2007.0,1,0,1
OMN,SDN,2012.0,1,0,1
TWN,SGP,1998.0,1,0,1
RUS,PRI,2014.0,1,0,1
MAC,PHL,2018.0,2,0,2
ROU,RUS,2014.0,1,0,1
BOL,DNK,2001.0,1,0,1
TUR,JOR,2005.0,1,0,1
ARG,TTO,2008.0,1,0,1
BWA,IND,2014.0,1,0,1
DZA,CHL,2019.0,1,0,1
BGD,DNK,2014.0,1,0,1
CAN,BLR,2019.0,1,0,1
POL,SGP,2001.0,1,0,1
VUT,NZL,2007.0,1,0,1
GMB,CAN,2020.0,1,0,1
EGY,UZB,2022.0,1,0,1
ARG,SAU,2021.0,1,0,1
DEU,CIV,2010.0,1,0,1
NOR,ERI,2000.0,1,0,1
MEX,PAN,2011.0,1,0,1
MOZ,AUS,2007.0,1,0,1
SOM,CHE,2017.0,1,0,1
GRD,DEU,2015.0,1,0,1
PAK,MEX,2014.0,1,0,1
CUB,AUT,2016.0,1,0,1
FJI,BGD,2020.0,1,0,1
MYS,LUX,2018.0,1,0,1
SRB,SVN,2006.0,1,0,1
SAU,JOR,2002.0,1,0,1
HUN,QAT,2022.0,1,0,1
QAT,GHA,2020.0,1,0,1
MOZ,ITA,2018.0,1,0,1
SEN,ITA,2019.0,1,0,1
AUS,BEL,2011.0,22,24,-2
ESP,USA,2006.0,281,292,-11
GBR,ITA,2013.0,227,386,-159
LBN,USA,2009.0,46,38,8
GBR,AUS,2009.0,528,366,162
PRT,ESP,2016.0,65,106,-41
CHE,GBR,2009.0,177,184,-7
RUS,ARE,2019.0,3,1,2
FRA,NLD,2009.0,83,85,-2
GBR,CHN,2009.0,177,143,34
USA,ZAF,2009.0,52,70,-18
COG,COD,2020.0,100,16,84
USA,CHE,2006.0,329,330,-1
BRA,USA,2016.0,471,370,101
USA,TUR,2007.0,215,155,60
ITA,CHE,2012.0,206,88,118
USA,NOR,1998.0,16,8,8
NZL,USA,2016.0,136,87,49
MEX,COL,2016.0,39,22,17
USA,GBR,2007.0,1244,1225,19
USA,BRA,2015.0,352,410,-58
ARG,GBR,2014.0,18,11,7
GBR,MEX,2021.0,45,33,12
JOR,USA,2008.0,14,54,-40
FRA,BEL,2006.0,132,140,-8
CHE,FRA,2017.0,205,371,-166
GBR,JPN,2001.0,86,92,-6
CHE,FRA,2010.0,176,254,-78
PRT,USA,2019.0,55,48,7
USA,FRA,1999.0,234,321,-87
ITA,USA,2022.0,176,175,1
DEU,CHE,2015.0,593,459,134
BRA,VEN,2007.0,6,2,4
BEL,DEU,2007.0,48,63,-15
JPN,TUN,2009.0,1,1,0
RUS,CHE,2020.0,27,18,9
DEU,UKR,2013.0,13,26,-13
AUS,CHN,2013.0,148,232,-84
CHN,USA,1998.0,159,101,58
IND,GBR,2011.0,125,142,-17
FRA,ARG,2011.0,18,26,-8
GRC,SWE,2010.0,8,5,3
AUT,DEU,2014.0,308,335,-27
GRC,ISR,2010.0,3,4,-1
GBR,FRA,2016.0,348,503,-155
IND,MYS,2012.0,61,30,31
CZE,NLD,2010.0,5,5,0
GRC,BEL,2009.0,8,9,-1
CHE,SWE,2012.0,44,39,5
PRT,GBR,2014.0,88,64,24
IRL,USA,2004.0,86,88,-2
SAU,USA,2016.0,98,147,-49
IRN,DEU,2011.0,44,24,20
USA,THA,2013.0,190,96,94
GBR,DEU,2015.0,563,664,-101
SAU,SDN,2020.0,14,29,-15
ITA,FRA,2020.0,301,250,51
ITA,CAN,2009.0,55,42,13
KEN,TZA,2010.0,6,5,1
AUS,SGP,2012.0,54,54,0
TUR,ITA,2017.0,14,9,5
AUT,RUS,2008.0,5,8,-3
MEX,NLD,2014.0,8,4,4
DZA,FRA,2017.0,34,91,-57
GRC,SAU,2019.0,9,1,8
USA,HKG,2021.0,123,122,1
CHE,FRA,2019.0,231,349,-118
CHE,NLD,2010.0,41,58,-17
CHE,DZA,2007.0,2,1,1
MEX,DEU,2014.0,32,22,10
CHN,SWE,2016.0,80,66,14
BEL,RUS,2000.0,5,12,-7
CHN,AUS,2020.0,318,421,-103
USA,EGY,2014.0,101,73,28
MYS,TUR,2017.0,11,1,10
BRA,ARG,2008.0,22,25,-3
SWE,USA,2016.0,216,243,-27
GBR,FIN,2021.0,67,44,23
SWE,NOR,2021.0,61,49,12
UGA,BEL,2018.0,2,8,-6
CHN,PAK,2018.0,208,269,-61
ISR,GBR,2020.0,46,44,2
DEU,VNM,2015.0,26,5,21
IRN,USA,2020.0,461,108,353
FRA,JPN,2018.0,91,79,12
USA,URY,2021.0,12,7,5
CHN,CAN,2004.0,100,76,24
NLD,ESP,2015.0,56,80,-24
IND,IDN,2016.0,4,2,2
BEL,AUS,2017.0,24,28,-4
MYS,IRN,2018.0,106,28,78
PAK,CAN,2010.0,14,6,8
KOR,CAN,2021.0,42,22,20
IDN,AUT,2019.0,1,3,-2
USA,CHN,2003.0,585,832,-247
DNK,CHN,2009.0,9,11,-2
JPN,FIN,2011.0,10,8,2
USA,PAK,2018.0,84,119,-35
SVK,CZE,2015.0,70,52,18
JPN,NLD,2019.0,25,34,-9
SGP,NLD,2021.0,14,7,7
VNM,THA,2015.0,9,5,4
TUR,IRN,2015.0,9,21,-12
SWE,CHN,2022.0,71,44,27
GBR,OMN,2017.0,14,13,1
NLD,FRA,2020.0,95,113,-18
NLD,QAT,2020.0,4,3,1
GBR,TZA,2021.0,9,5,4
CAN,DEU,2003.0,106,137,-31
DZA,FRA,2019.0,51,108,-57
BRA,COL,2016.0,37,41,-4
DEU,ARE,2020.0,13,6,7
CHE,CAN,2016.0,81,100,-19
UKR,POL,2020.0,31,30,1
CAN,ESP,2020.0,47,57,-10
BRA,DOM,2018.0,1,1,0
BEL,FRA,2021.0,142,159,-17
TUN,FRA,2002.0,29,47,-18
USA,ARG,2015.0,108,92,16
BEL,CAN,2018.0,40,37,3
CHN,ITA,2019.0,47,60,-13
TWN,USA,2015.0,277,305,-28
AUT,DNK,2020.0,9,18,-9
NOR,RUS,2020.0,5,7,-2
CHE,ROU,2016.0,6,4,2
FRA,ROU,2015.0,33,37,-4
PAK,CAN,2019.0,24,19,5
ZAF,TZA,2018.0,9,9,0
CIV,FRA,2021.0,7,8,-1
FRA,COL,2021.0,6,15,-9
CHE,NLD,2019.0,70,115,-45
BEL,IRL,2018.0,18,13,5
CHN,RUS,2017.0,12,28,-16
IND,IRL,2019.0,42,11,31
AUS,IRN,2020.0,29,178,-149
MYS,SGP,2022.0,9,12,-3
ITA,BRA,2020.0,52,53,-1
SGP,HKG,2018.0,43,39,4
DNK,GBR,2004.0,47,49,-2
TUR,NLD,2018.0,31,12,19
FRA,BEN,2007.0,8,2,6
AUS,DEU,2014.0,116,148,-32
CZE,PAK,2019.0,5,1,4
TUR,FRA,2011.0,13,15,-2
SAU,TUN,2019.0,29,143,-114
NPL,JPN,2016.0,8,8,0
KEN,SLE,2011.0,1,1,0
FRA,HRV,2021.0,4,3,1
IRN,HUN,2016.0,1,2,-1
GBR,TUR,2019.0,67,82,-15
GRC,ITA,2012.0,25,28,-3
GUF,FRA,2022.0,14,9,5
BRA,FIN,2015.0,8,1,7
CAN,NZL,2020.0,27,45,-18
USA,AUT,1999.0,46,46,0
YEM,DEU,2017.0,2,1,1
THA,PAK,2018.0,13,1,12
GBR,JOR,2018.0,31,13,18
SWE,FRA,2022.0,31,37,-6
CRI,USA,2019.0,11,23,-12
SGP,FRA,2020.0,29,28,1
ISL,DNK,2021.0,5,4,1
ETH,USA,2021.0,15,19,-4
GBR,RUS,2002.0,42,76,-34
IRN,PRT,2022.0,12,1,11
USA,NLD,1999.0,98,109,-11
FRA,TWN,2018.0,10,5,5
BRA,ITA,1999.0,11,12,-1
FIN,SVN,2021.0,1,1,0
BRA,CUB,2019.0,4,15,-11
DEU,SGP,2018.0,25,43,-18
SWE,CHL,1997.0,1,1,0
MYS,AUS,2022.0,33,26,7
CAN,CHL,2012.0,19,13,6
SVN,GBR,2016.0,12,9,3
FRA,ESP,2009.0,162,158,4
UKR,CZE,2017.0,11,2,9
CRI,USA,2010.0,18,9,9
NLD,AUS,2006.0,43,17,26
MEX,ITA,2013.0,8,10,-2
CHN,RUS,2019.0,18,34,-16
AUT,USA,2013.0,121,110,11
HRV,DEU,2008.0,5,15,-10
SAU,TUN,2017.0,19,88,-69
JAM,USA,2014.0,6,9,-3
PER,CAN,2020.0,4,2,2
JPN,FRA,2005.0,68,80,-12
CAN,CHN,1998.0,6,25,-19
FRA,LUX,2020.0,19,17,2
AUS,SEN,2012.0,1,1,0
SAU,OMN,2011.0,3,6,-3
GBR,TUR,2010.0,44,33,11
AUT,POL,2011.0,26,3,23
EST,LVA,2012.0,1,2,-1
USA,MAR,2006.0,7,3,4
ARE,BEL,2014.0,1,2,-1
TUR,ITA,2019.0,17,15,2
PRT,USA,2010.0,42,75,-33
GBR,TUR,2017.0,65,63,2
JPN,NOR,2014.0,9,3,6
GBR,KWT,2012.0,9,4,5
DNK,IRL,2006.0,7,2,5
BRA,BEL,2007.0,10,16,-6
PRT,USA,2017.0,73,46,27
SGP,USA,1999.0,19,32,-13
USA,NZL,2009.0,108,119,-11
CHL,ARG,2019.0,21,29,-8
CHN,DZA,2019.0,13,3,10
BEL,CHE,2008.0,24,25,-1
ZAF,BWA,2002.0,1,3,-2
MEX,PER,2015.0,7,3,4
JPN,PHL,2014.0,23,13,10
IRN,CAN,2001.0,10,9,1
FRA,IDN,2015.0,6,3,3
DEU,AUT,2003.0,197,186,11
ITA,SWE,2015.0,78,31,47
MWI,GBR,2008.0,7,11,-4
JPN,DEU,2020.0,113,104,9
HUN,GBR,2012.0,25,16,9
KHM,USA,2016.0,7,2,5
EST,GBR,2021.0,13,7,6
IRL,GBR,2001.0,63,89,-26
POL,ESP,2002.0,8,5,3
GBR,SGP,1999.0,16,6,10
FRA,TUN,1999.0,22,9,13
SDN,USA,2019.0,4,4,0
GHA,HKG,2021.0,3,3,0
HUN,USA,2004.0,61,64,-3
VEN,FRA,2004.0,4,2,2
CHE,ESP,1999.0,12,13,-1
FRA,ISR,1998.0,6,6,0
POL,GBR,2008.0,66,27,39
TUN,FRA,2005.0,33,74,-41
DEU,GRC,2018.0,35,78,-43
POL,ESP,2005.0,13,4,9
EGY,KWT,2013.0,12,10,2
GIN,CHE,2020.0,4,1,3
CHL,VEN,2011.0,1,4,-3
CHN,THA,2018.0,21,27,-6
DNK,NLD,2008.0,18,21,-3
AUS,KOR,2012.0,13,32,-19
TUN,ITA,2017.0,4,6,-2
NZL,JPN,2011.0,8,4,4
CHE,NLD,2017.0,84,115,-31
CUB,MEX,2019.0,27,7,20
BRN,AUS,2020.0,5,6,-1
BEL,RWA,2020.0,2,3,-1
IRN,FIN,2020.0,45,7,38
NER,FRA,2016.0,4,3,1
PAK,CAN,2017.0,12,17,-5
IRL,SWE,2002.0,2,6,-4
PAK,DEU,2020.0,34,32,2
IRN,TUR,2020.0,38,8,30
CYP,USA,2009.0,4,16,-12
GHA,FIN,2020.0,1,3,-2
GBR,THA,1999.0,5,3,2
NLD,MEX,2020.0,7,11,-4
KOR,PHL,2011.0,5,3,2
CAN,SAU,2003.0,12,15,-3
IDN,CAN,2011.0,1,3,-2
TZA,UGA,2021.0,2,4,-2
ESP,DOM,2021.0,1,2,-1
CAN,IND,2012.0,64,121,-57
VNM,IRL,2018.0,1,2,-1
IND,CAN,1999.0,20,15,5
JPN,IRL,2014.0,2,4,-2
BEL,AUS,2019.0,48,26,22
CAN,ARE,2015.0,26,5,21
PER,USA,1999.0,4,2,2
ESP,UKR,2005.0,1,4,-3
HKG,MAC,2016.0,15,8,7
DEU,THA,2018.0,28,14,14
NOR,FIN,2006.0,4,11,-7
DZA,FRA,2010.0,33,66,-33
BEL,IND,2012.0,7,21,-14
BEL,CHL,2017.0,17,6,11
BIH,DEU,2004.0,3,1,2
USA,HRV,2016.0,26,12,14
USA,UGA,2011.0,22,27,-5
MEX,GBR,2009.0,30,31,-1
BOL,GBR,2018.0,1,1,0
IND,NZL,2007.0,4,2,2
IDN,GBR,2012.0,4,12,-8
EST,USA,2001.0,3,2,1
FRA,LBN,2011.0,41,20,21
SWE,JPN,2006.0,30,19,11
FRA,VNM,2000.0,2,1,1
JPN,NLD,2010.0,16,16,0
FRA,CZE,2006.0,10,13,-3
SWE,BEL,2004.0,9,6,3
RUS,ESP,1998.0,6,8,-2
QAT,EGY,2015.0,8,11,-3
BEL,GRC,2008.0,8,12,-4
ARE,PAK,2005.0,3,4,-1
GBR,GHA,2005.0,5,4,1
NOR,AUS,2004.0,6,6,0
ITA,SRB,2007.0,5,2,3
FRA,MCO,2007.0,8,3,5
ISR,CHE,1997.0,3,2,1
NLD,BRA,2001.0,5,10,-5
PHL,JPN,2004.0,8,15,-7
MWI,KEN,2020.0,2,1,1
SGP,SWE,2008.0,3,7,-4
MOZ,USA,2011.0,2,2,0
FRA,SGP,2008.0,16,6,10
SVK,RUS,2015.0,6,2,4
SRB,GRC,2006.0,1,1,0
SAU,BGD,2016.0,4,4,0
CAN,BEL,2013.0,28,31,-3
FIN,DEU,1999.0,5,10,-5
FRA,DZA,2001.0,29,17,12
JPN,FRA,2002.0,61,69,-8
ITA,AUS,2011.0,42,11,31
KEN,SWE,2017.0,8,2,6
USA,KWT,2003.0,13,7,6
IND,ESP,2006.0,15,7,8
ROU,NLD,2004.0,7,3,4
JPN,SAU,2020.0,11,8,3
KOR,IRN,2011.0,5,6,-1
THA,CAN,2006.0,13,11,2
GRC,FRA,2013.0,56,14,42
PAK,OMN,2010.0,5,1,4
ISR,IND,2002.0,9,13,-4
IND,FRA,1999.0,11,7,4
ROU,CHE,2002.0,8,1,7
IRL,NLD,2001.0,4,4,0
ROU,AUT,2006.0,2,1,1
LUX,FRA,2013.0,20,20,0
BLR,RUS,1998.0,13,4,9
BEL,AUS,2010.0,14,16,-2
USA,NOR,1997.0,8,7,1
CHE,JPN,2000.0,9,5,4
POL,UKR,2002.0,13,22,-9
GBR,LBN,2012.0,9,4,5
HKG,TWN,2008.0,7,11,-4
HKG,CAN,2004.0,16,15,1
BEL,ITA,2008.0,46,43,3
RUS,ESP,1997.0,2,1,1
EGY,FRA,2020.0,12,13,-1
MAR,FRA,1999.0,11,23,-12
PRT,SWE,2004.0,6,5,1
USA,CYP,2009.0,16,4,12
ITA,HUN,1998.0,2,1,1
DNK,FIN,1999.0,5,2,3
NLD,GRC,2001.0,6,8,-2
AUS,ZAF,2006.0,14,20,-6
NGA,USA,2004.0,15,13,2
TWN,AUS,1997.0,1,1,0
CHN,USA,1997.0,64,146,-82
TTO,JAM,2016.0,6,2,4
AUS,JPN,2000.0,14,5,9
THA,DNK,2003.0,3,3,0
DEU,TWN,2013.0,16,20,-4
IND,NLD,2011.0,17,17,0
SGP,SAU,2014.0,12,1,11
POL,UKR,2005.0,8,15,-7
ARG,ITA,2007.0,17,17,0
ESP,SWE,2006.0,12,18,-6
CAN,MAR,2004.0,4,6,-2
ZAF,GRC,2002.0,2,3,-1
FRA,CHL,2011.0,24,21,3
KWT,NZL,2007.0,1,1,0
URY,USA,2011.0,7,11,-4
ARG,NLD,2008.0,1,5,-4
PRT,DEU,2007.0,15,26,-11
UGA,GBR,2015.0,31,7,24
ECU,ESP,2013.0,2,18,-16
ISR,ESP,2011.0,6,3,3
AUT,MKD,2017.0,1,3,-2
ITA,ISR,2014.0,16,8,8
ARE,EGY,2022.0,4,16,-12
GRC,SWE,2017.0,38,6,32
CUB,ITA,2013.0,4,3,1
COL,CHL,2011.0,13,12,1
NLD,TZA,2014.0,5,1,4
CRI,USA,2017.0,16,14,2
KEN,TZA,2017.0,9,6,3
IRN,NLD,2012.0,33,9,24
AUS,TZA,2011.0,2,1,1
MOZ,NLD,2018.0,1,2,-1
NZL,LKA,2011.0,1,2,-1
SVK,SWE,2017.0,3,3,0
ETH,CAN,2016.0,1,2,-1
BRA,CUB,2010.0,8,9,-1
MYS,TUR,2019.0,10,2,8
AUS,ITA,2009.0,8,23,-15
SWE,HUN,2020.0,6,5,1
COG,CHE,2017.0,2,2,0
COD,COG,2014.0,12,9,3
GRC,SWE,2019.0,33,14,19
SWE,SAU,2016.0,6,2,4
BRA,DNK,2014.0,10,5,5
CHL,CHN,2018.0,7,2,5
DEU,HKG,2022.0,7,6,1
CHE,SGP,2015.0,21,16,5
IND,CHE,2019.0,45,30,15
AUT,HRV,2018.0,4,9,-5
AUS,FIN,2020.0,21,10,11
JPN,ETH,2018.0,3,1,2
ISR,IND,2005.0,6,12,-6
CIV,MLI,2011.0,1,3,-2
NOR,TZA,2018.0,9,4,5
VNM,DEU,2015.0,5,26,-21
IND,BWA,2020.0,4,1,3
FIN,DNK,2020.0,12,17,-5
CHN,IRL,2018.0,22,31,-9
NLD,CZE,2021.0,7,8,-1
MAR,USA,2020.0,7,4,3
KEN,TZA,2019.0,8,4,4
GRC,LUX,2020.0,5,2,3
CHL,DNK,2020.0,7,1,6
URY,CAN,2014.0,2,1,1
LUX,USA,2018.0,10,9,1
CHE,HKG,2021.0,5,8,-3
ETH,NOR,2021.0,3,4,-1
TJK,KAZ,2019.0,1,1,0
FRA,ISR,1997.0,2,3,-1
COG,ZWE,2021.0,2,2,0
PAK,TWN,2021.0,7,7,0
EGY,IND,2021.0,2,7,-5
UKR,CZE,2019.0,16,7,9
USA,MOZ,2022.0,3,1,2
AUT,CAN,2003.0,12,17,-5
FIN,UKR,1998.0,2,1,1
AUS,POL,1998.0,2,2,0
AUT,SVK,1999.0,3,4,-1
USA,LKA,2011.0,12,8,4
FRA,MTQ,2001.0,6,12,-6
UKR,MEX,1998.0,2,1,1
KOR,BGD,2020.0,44,17,27
TUN,ITA,2010.0,2,3,-1
NPL,GBR,2009.0,4,3,1
DNK,CHE,2009.0,15,25,-10
CAN,THA,2015.0,18,10,8
QAT,KOR,2011.0,1,2,-1
GHA,ETH,2016.0,2,1,1
NGA,HKG,2017.0,3,1,2
THA,AUS,2012.0,15,31,-16
DEU,CUB,2020.0,4,8,-4
NLD,NOR,2009.0,24,7,17
AUS,HUN,2004.0,1,4,-3
GHA,USA,2003.0,5,5,0
NLD,CHL,2008.0,2,3,-1
CHE,POL,2015.0,17,33,-16
ARG,URY,2016.0,3,8,-5
BRA,URY,2018.0,11,8,3
NZL,NOR,2016.0,3,5,-2
ZAF,CHN,2014.0,5,11,-6
CAN,SRB,2009.0,4,4,0
GBR,OMN,2019.0,20,9,11
BEL,CHL,2019.0,9,6,3
MEX,RUS,2021.0,8,1,7
TUN,BEN,2013.0,2,1,1
YEM,DEU,2019.0,1,1,0
COL,ITA,2015.0,5,16,-11
CAN,LBN,2022.0,2,11,-9
KHM,GBR,2014.0,4,2,2
ITA,ROU,2011.0,7,5,2
KHM,MYS,2018.0,3,1,2
SAU,MYS,2018.0,26,78,-52
RUS,NOR,2016.0,11,6,5
ETH,ZAF,2018.0,6,11,-5
PAK,QAT,2015.0,7,1,6
AUS,LKA,2004.0,3,4,-1
CHE,TUR,2022.0,4,6,-2
TUR,BEL,2022.0,4,7,-3
AUT,ITA,2012.0,28,33,-5
COG,CHE,2010.0,1,3,-2
TUN,ESP,2022.0,2,1,1
BRA,ISR,2013.0,2,2,0
PHL,CAN,2022.0,2,1,1
EGY,QAT,2007.0,8,2,6
URY,ESP,2016.0,5,11,-6
NIC,SWE,2009.0,2,1,1
NLD,SGP,2009.0,7,9,-2
RUS,KAZ,2001.0,10,4,6
TZA,DEU,2007.0,2,1,1
AZE,RUS,2001.0,4,4,0
TUR,ITA,2010.0,9,8,1
FIN,AUT,2002.0,2,4,-2
ZAF,ARE,2004.0,1,1,0
PER,FRA,2006.0,1,1,0
BRB,JAM,2013.0,1,1,0
FRA,NCL,2009.0,13,9,4
CHE,FIN,1998.0,3,2,1
CZE,AUS,2007.0,4,2,2
IDN,DEU,2009.0,8,8,0
MKD,AUT,2018.0,1,1,0
CZE,FIN,2011.0,2,5,-3
ITA,KOR,2004.0,3,1,2
DEU,HUN,2022.0,10,10,0
HUN,IRN,2013.0,2,2,0
DEU,KOR,1998.0,3,5,-2
AUT,ARG,2019.0,2,2,0
ITA,CUB,2002.0,4,6,-2
FIN,NZL,2009.0,5,1,4
QAT,IND,2020.0,8,17,-9
FIN,ZAF,2016.0,5,2,3
PRT,ZAF,2020.0,5,2,3
PER,COL,2004.0,1,1,0
GBR,UKR,2012.0,14,9,5
SVK,BEL,2006.0,6,4,2
ITA,DZA,2013.0,3,2,1
BGR,IRL,2009.0,2,1,1
CHL,MEX,2004.0,4,4,0
FRA,ISL,2013.0,5,1,4
JPN,KEN,2014.0,12,3,9
CUB,USA,2007.0,7,3,4
ARG,CAN,2007.0,12,10,2
SGP,THA,2013.0,5,9,-4
EGY,MEX,2015.0,1,2,-1
USA,BOL,2013.0,8,1,7
DNK,ZAF,2018.0,4,5,-1
FIN,TZA,2014.0,1,1,0
THA,HKG,2019.0,5,2,3
UGA,RWA,2012.0,1,1,0
CHN,LKA,2016.0,6,1,5
SVN,TUR,2017.0,3,1,2
DEU,NGA,2015.0,5,5,0
IRQ,USA,2018.0,9,43,-34
CUB,MEX,2017.0,18,5,13
BRA,CHL,2020.0,40,15,25
IDN,ISR,2016.0,1,1,0
LUX,CHN,2016.0,2,1,1
SYR,EGY,2015.0,3,1,2
AUS,NCL,2013.0,1,1,0
FRA,MYS,2013.0,10,1,9
BRA,PRI,2009.0,2,2,0
COD,USA,2018.0,1,2,-1
BEL,COG,2019.0,2,8,-6
PHL,TWN,2018.0,6,4,2
CZE,NLD,2019.0,6,15,-9
SAU,NGA,2020.0,5,4,1
GBR,TWN,2022.0,13,9,4
SYR,CAN,2016.0,1,1,0
ARG,VEN,2001.0,5,1,4
GBR,CRI,2005.0,1,1,0
USA,SRB,2011.0,26,8,18
VNM,JPN,2004.0,4,6,-2
SWE,PRT,2009.0,11,3,8
MEX,JPN,2016.0,4,9,-5
PHL,HKG,2003.0,1,2,-1
CHN,RUS,2010.0,4,6,-2
IDN,USA,2008.0,6,13,-7
BEL,SWE,2009.0,6,7,-1
USA,NGA,2004.0,13,15,-2
CHN,PRT,2014.0,6,8,-2
GRC,PRT,2002.0,3,1,2
ZAF,POL,2014.0,1,14,-13
BRA,IRL,2015.0,7,4,3
COG,BEL,2014.0,3,8,-5
ECU,FRA,2014.0,3,5,-2
BRA,ARE,2019.0,2,1,1
ITA,SVN,2013.0,5,6,-1
THA,HKG,2017.0,2,3,-1
NOR,ITA,2020.0,16,27,-11
GRC,CHN,2015.0,3,2,1
SGP,LKA,2018.0,4,1,3
KEN,SWE,2019.0,3,6,-3
COL,PER,2021.0,2,6,-4
FIN,LTU,2018.0,1,1,0
MLT,GBR,2020.0,6,18,-12
MLT,IRL,2019.0,1,4,-3
PAK,ARE,2018.0,5,6,-1
DEU,SRB,2020.0,5,15,-10
HRV,BIH,2020.0,6,9,-3
DNK,CZE,2004.0,3,4,-1
CHE,BEL,2003.0,19,16,3
AUT,UKR,2007.0,1,5,-4
COL,AUS,2021.0,8,4,4
USA,VEN,2014.0,9,25,-16
AUT,ARG,2017.0,3,2,1
FRA,THA,2006.0,6,7,-1
BLR,RUS,1997.0,11,6,5
ROU,CHE,2005.0,1,1,0
GAB,FRA,2006.0,4,6,-2
BLR,DEU,2004.0,8,6,2
SRB,GBR,2008.0,3,10,-7
GBR,UGA,2001.0,1,1,0
PRT,CAN,2008.0,3,9,-6
AUT,IND,2006.0,3,9,-6
UKR,DEU,1998.0,13,4,9
GEO,ITA,2002.0,3,1,2
JPN,IRN,2004.0,10,3,7
ESP,IND,2003.0,11,9,2
PRI,ESP,2018.0,4,2,2
NOR,POL,2006.0,2,3,-1
USA,GAB,2022.0,5,1,4
IND,NPL,2007.0,11,15,-4
TWN,CHE,2016.0,4,5,-1
TWN,CAN,2006.0,6,13,-7
TZA,GBR,1999.0,4,2,2
CHN,BRA,2021.0,2,13,-11
GRC,SAU,2017.0,3,3,0
AUS,FJI,2006.0,3,2,1
USA,ARM,2013.0,2,8,-6
ESP,MAR,2007.0,6,3,3
ITA,UKR,2015.0,2,1,1
SVN,ITA,2001.0,1,3,-2
DNK,ISR,2008.0,3,2,1
LTU,CHE,2018.0,4,1,3
TWN,EGY,2021.0,2,1,1
GHA,DEU,2012.0,2,4,-2
USA,MNG,2013.0,4,2,2
HUN,SWE,2013.0,9,6,3
MAR,MEX,2019.0,3,2,1
ESP,UKR,2002.0,4,2,2
EST,RUS,2018.0,2,1,1
CHN,ETH,2016.0,2,7,-5
BGD,DEU,2022.0,3,2,1
GBR,GHA,2002.0,3,2,1
CAN,GHA,2011.0,1,3,-2
DEU,MEX,2000.0,6,10,-4
TUR,NOR,2002.0,2,2,0
ARE,MAR,2016.0,1,1,0
FRA,SVN,2021.0,4,8,-4
UKR,FIN,2015.0,5,1,4
FRA,TUR,2022.0,4,4,0
ZMB,USA,2007.0,4,3,1
CZE,SVN,2003.0,3,1,2
TUR,NOR,2005.0,1,2,-1
USA,PSE,2018.0,5,5,0
CRI,MEX,2022.0,2,1,1
PAK,OMN,2019.0,10,3,7
IDN,AUT,2010.0,2,3,-1
FRA,HUN,2003.0,11,12,-1
NPL,AUS,2015.0,5,1,4
BEL,ROU,2001.0,2,3,-1
USA,BEN,2018.0,4,1,3
POL,NOR,2009.0,3,2,1
BRA,MEX,2011.0,5,3,2
ITA,DNK,2004.0,9,11,-2
TUR,CYP,2007.0,3,2,1
AUT,IRN,2009.0,2,4,-2
MAC,GBR,2020.0,3,7,-4
SVK,ESP,2009.0,1,3,-2
JPN,CHL,2020.0,2,4,-2
GHA,ZAF,2002.0,1,2,-1
MKD,USA,2011.0,2,2,0
TUR,IND,2019.0,5,10,-5
CIV,CAN,2013.0,1,1,0
HKG,FRA,2022.0,3,3,0
EST,DNK,2020.0,2,1,1
JPN,HUN,2016.0,6,4,2
BRA,IDN,2018.0,1,1,0
SWE,THA,2020.0,3,9,-6
FRA,SVK,2001.0,3,5,-2
THA,BTN,2017.0,1,2,-1
ITA,JPN,2022.0,10,11,-1
CHN,FIN,1999.0,6,1,5
IRQ,FIN,2018.0,1,1,0
SEN,ITA,2018.0,1,2,-1
HUN,SGP,2012.0,2,2,0
SWE,ETH,2006.0,3,3,0
RUS,PHL,2011.0,1,1,0
CAN,UGA,2018.0,1,5,-4
MAR,ZAF,2020.0,2,3,-1
CMR,PAK,2021.0,2,2,0
FRA,GLP,2021.0,4,2,2
SWE,COL,2012.0,2,1,1
MKD,DEU,2018.0,2,2,0
FRA,CUB,2016.0,3,6,-3
SGP,IDN,2021.0,5,3,2
CUB,ARG,2006.0,1,1,0
KEN,IDN,2010.0,2,3,-1
AUS,POL,1997.0,1,1,0
DNK,HUN,1999.0,1,1,0
CHE,GHA,2002.0,2,2,0
CZE,RUS,2015.0,2,13,-11
LTU,CAN,2008.0,1,2,-1
TUR,GBR,1999.0,5,30,-25
AUS,UKR,2012.0,2,3,-1
USA,NIC,2013.0,3,3,0
KEN,IDN,2017.0,1,3,-2
PRT,BEL,2006.0,4,2,2
SVK,SWE,2010.0,4,3,1
KEN,IDN,2019.0,2,1,1
BEL,CHL,2010.0,6,2,4
MYS,DNK,2011.0,1,4,-3
BEL,CHN,2000.0,3,8,-5
ARE,ESP,2014.0,2,2,0
CIV,BEL,2012.0,1,4,-3
GRC,ISR,2017.0,1,2,-1
IRL,SGP,2009.0,2,2,0
GBR,JAM,2016.0,3,2,1
CMR,NGA,2021.0,1,4,-3
PHL,IND,2021.0,3,6,-3
USA,TTO,2021.0,1,7,-6
MAC,HKG,2007.0,7,15,-8
USA,BLR,2015.0,2,3,-1
JAM,GBR,2006.0,3,2,1
PER,CHL,2009.0,3,2,1
ARE,FRA,2014.0,2,10,-8
ARG,BEL,2016.0,2,5,-3
NZL,HUN,2005.0,1,1,0
LKA,CHE,2005.0,1,1,0
CZE,SVK,1998.0,4,4,0
NLD,HUN,2001.0,1,5,-4
KOR,UKR,2013.0,2,1,1
BRA,CHE,2011.0,11,7,4
KWT,USA,2011.0,2,10,-8
ZAF,RUS,2013.0,1,1,0
SWE,CZE,2011.0,3,6,-3
MEX,NZL,2007.0,3,1,2
CAN,CHN,1997.0,4,7,-3
MAR,SYR,2020.0,1,4,-3
BEL,BGR,2014.0,3,5,-2
CZE,NLD,2017.0,4,8,-4
EGY,BEL,2008.0,1,4,-3
NOR,ZAF,2012.0,1,6,-5
SAU,RUS,2022.0,1,1,0
THA,KHM,2016.0,2,1,1
BMU,USA,2013.0,5,2,3
UKR,SVK,2018.0,3,4,-1
NGA,HKG,2019.0,7,4,3
BIH,AUT,2009.0,1,2,-1
SRB,USA,2012.0,4,15,-11
ISL,CAN,2007.0,1,1,0
USA,KHM,2006.0,1,2,-1
IND,RUS,2000.0,2,3,-1
JPN,PRT,2001.0,2,1,1
GAB,DEU,2016.0,3,2,1
BFA,MLI,2008.0,1,1,0
KEN,IND,2022.0,2,2,0
RUS,ARE,2017.0,3,1,2
NLD,BGR,2008.0,2,3,-1
BGD,MYS,2007.0,2,1,1
AFG,GBR,2011.0,2,1,1
DZA,GRC,2010.0,1,1,0
IRL,SWE,2005.0,1,5,-4
SDN,USA,2017.0,3,2,1
IND,LBR,2021.0,1,1,0
MYS,QAT,2011.0,1,2,-1
GBR,OMN,2010.0,2,3,-1
LKA,GBR,2016.0,2,15,-13
CHN,BLR,2013.0,2,4,-2
PAK,NOR,2016.0,1,3,-2
BFA,DEU,2013.0,2,1,1
NZL,PRT,2016.0,1,2,-1
BHR,IND,2005.0,2,5,-3
CZE,SVK,1997.0,3,4,-1
PER,UGA,2017.0,1,1,0
GEO,USA,2022.0,3,4,-1
AUS,PRT,2009.0,2,2,0
SRB,SAU,2017.0,1,1,0
EST,IRL,2017.0,1,1,0
MWI,CHN,2018.0,1,3,-2
BWA,CAN,2018.0,2,3,-1
SLE,USA,2018.0,3,5,-2
BHR,IRQ,2016.0,1,1,0
TJK,RUS,2018.0,3,4,-1
PAK,EGY,2011.0,1,1,0
KAZ,SGP,2016.0,2,1,1
CHE,JOR,2022.0,2,1,1
PRI,COL,2013.0,1,1,0
AFG,MYS,2022.0,2,2,0
ARG,CUB,2018.0,1,3,-2
SAU,TUN,2010.0,2,20,-18
FIN,AUT,2005.0,3,6,-3
BGR,JPN,1997.0,2,1,1
MOZ,ITA,2010.0,1,1,0
FRA,EGY,1999.0,3,1,2
NZL,TWN,2001.0,1,1,0
IDN,ESP,2015.0,2,2,0
QAT,DEU,2018.0,4,4,0
GMB,NGA,2018.0,1,4,-3
CAN,NPL,2012.0,1,1,0
LUX,CHE,2018.0,2,5,-3
POL,HUN,2004.0,1,1,0
USA,GHA,2001.0,2,3,-1
CHE,BIH,2020.0,2,3,-1
SGP,BEL,2016.0,5,6,-1
ARE,IRN,2015.0,1,1,0
UKR,DEU,1997.0,2,2,0
SVN,ESP,2022.0,1,1,0
ZMB,NOR,2020.0,1,2,-1
CRI,DEU,2009.0,1,1,0
POL,LTU,2016.0,3,1,2
CIV,USA,2021.0,1,2,-1
IRQ,OMN,2020.0,2,1,1
ITA,MAR,2021.0,3,5,-2
LKA,MYS,2012.0,2,3,-1
BHR,ITA,2009.0,1,1,0
ITA,ZAF,2007.0,2,2,0
ZAF,RWA,2016.0,1,5,-4
BEL,NOR,1998.0,1,1,0
VEN,GTM,2015.0,1,1,0
BGR,CZE,2011.0,1,1,0
GBR,MAR,2012.0,1,2,-1
IDN,ITA,2013.0,1,2,-1
MEX,UKR,2013.0,1,2,-1
ZWE,FRA,1998.0,1,1,0
NOR,JOR,2019.0,1,1,0
GBR,BOL,2018.0,1,1,0
CAN,EST,2020.0,1,2,-1
KEN,ETH,2022.0,2,1,1
CZE,MEX,2018.0,2,3,-1
JPN,MMR,2017.0,2,5,-3
SRB,ISR,2020.0,1,3,-2
EGY,NLD,2004.0,2,3,-1
SAU,ZAF,2006.0,1,1,0
BGD,SWE,2020.0,1,5,-4
TZA,CHN,2018.0,3,3,0
NGA,FIN,2018.0,2,1,1
PSE,DEU,1998.0,1,1,0
UKR,KOR,2012.0,1,4,-3
IRN,IND,2004.0,1,12,-11
SYR,SAU,2009.0,1,1,0
TUR,NGA,2022.0,2,2,0
GRC,IND,2010.0,1,1,0
KEN,MWI,2014.0,3,1,2
ETH,JPN,2016.0,2,5,-3
MLT,USA,2017.0,1,1,0
ESP,LBN,2019.0,3,1,2
USA,GRD,2021.0,3,10,-7
SAU,MRT,2017.0,1,1,0
SWE,NGA,2009.0,1,2,-1
ITA,CUB,2005.0,1,3,-2
THA,JPN,1999.0,1,5,-4
NER,NGA,2014.0,1,1,0
MKD,SRB,2004.0,1,14,-13
BLR,FRA,2009.0,1,1,0
NZL,FIN,2003.0,1,4,-3
NOR,IRN,2020.0,1,26,-25
LVA,EST,2014.0,1,2,-1
MYS,ESP,2021.0,1,2,-1
URY,MEX,2006.0,2,1,1
TUR,SAU,2001.0,1,1,0
THA,HKG,2010.0,1,1,0
ALB,ITA,2015.0,2,9,-7
OMN,TUR,2020.0,1,1,0
ZAF,THA,2017.0,1,1,0
RUS,EST,2017.0,1,4,-3
NOR,CHL,2014.0,1,1,0
LTU,ITA,2022.0,1,1,0
SEN,BEL,2014.0,1,1,0
CHN,ERI,2022.0,1,2,-1
NGA,MEX,2020.0,1,2,-1
ECU,DEU,2006.0,1,1,0
PRY,ARG,2016.0,1,1,0
BEL,LTU,2020.0,1,1,0
DNK,HKG,2012.0,1,3,-2
CHL,ZAF,2015.0,1,4,-3
JPN,KHM,2008.0,1,3,-2
IRN,RUS,2004.0,1,3,-2
SRB,ESP,2012.0,1,1,0
GBR,FJI,2018.0,1,1,0
HRV,IDN,2008.0,1,1,0
FRA,KEN,2011.0,1,2,-1
MMR,AUS,2016.0,1,1,0
RWA,ETH,2020.0,1,1,0
PRI,MEX,2013.0,1,1,0
USA,BHS,2013.0,1,1,0
IDN,MMR,2017.0,1,1,0
JPN,OMN,2014.0,1,2,-1
ESP,ARE,2006.0,1,1,0
ZAF,BWA,2005.0,1,2,-1
FRA,GEO,2011.0,1,4,-3
EST,CHE,2016.0,1,4,-3
SWE,ARG,2016.0,1,2,-1
TUN,CHE,2002.0,2,3,-1
CHE,FIN,1997.0,1,2,-1
POL,NZL,2012.0,1,7,-6
PAK,ESP,1999.0,1,2,-1
JPN,NGA,2009.0,1,3,-2
ROU,ARG,2020.0,1,1,0
LKA,AUT,2006.0,1,1,0
IDN,ARE,2021.0,1,1,0
HKG,IDN,2020.0,1,1,0
NLD,MWI,2013.0,1,3,-2
COL,DNK,2019.0,1,3,-2
GRC,AUS,2008.0,1,3,-2
ROU,BEL,1998.0,1,4,-3
KOR,GHA,2018.0,1,3,-2
AUS,ISL,2014.0,1,2,-1
LKA,SGP,2021.0,1,2,-1
DEU,SWE,2011.0,135,93,42
HKG,AUS,2015.0,47,24,23
RUS,ISR,2018.0,12,5,7
FRA,USA,2021.0,552,424,128
GBR,CAN,2021.0,277,278,-1
SWE,AUS,2007.0,27,27,0
POL,FRA,2004.0,27,16,11
MYS,SAU,2014.0,55,15,40
JPN,MMR,2019.0,22,2,20
IND,IRL,2017.0,24,7,17
IRL,BHR,2011.0,1,1,0
MYS,RUS,2018.0,3,2,1
ITA,CHN,2015.0,44,19,25
KWT,AUS,2020.0,2,6,-4
IRN,ITA,2018.0,43,19,24
BEL,GBR,2001.0,49,51,-2
GBR,ISR,2020.0,44,46,-2
BGD,CHN,2014.0,6,1,5
ARG,CHL,2014.0,23,17,6
CRI,AUS,2013.0,1,2,-1
DEU,EGY,2015.0,61,36,25
CHN,POL,2011.0,10,3,7
IRN,CZE,2021.0,11,2,9
MEX,IND,2018.0,11,12,-1
THA,TWN,2021.0,7,13,-6
SAU,FRA,2021.0,13,20,-7
PRT,BRA,2013.0,82,66,16
KOR,MYS,2014.0,22,10,12
NOR,CZE,2015.0,5,5,0
POL,SWE,2009.0,13,12,1
CUB,MEX,2010.0,9,11,-2
DEU,ARG,2012.0,27,37,-10
USA,ETH,2013.0,4,21,-17
CHN,ITA,2017.0,42,47,-5
ARG,DNK,2000.0,1,1,0
LBN,GBR,2022.0,7,5,2
BGD,CAN,2003.0,6,1,5
EGY,JPN,2003.0,10,14,-4
IND,CHE,2017.0,30,37,-7
BGR,ESP,2021.0,2,2,0
NOR,SWE,2004.0,32,47,-15
TUR,IND,2010.0,3,2,1
IND,IRL,2010.0,16,10,6
USA,ECU,2016.0,31,16,15
SWE,DNK,2008.0,91,42,49
ESP,TUR,2009.0,5,5,0
MYS,KOR,2021.0,8,7,1
PHL,USA,1999.0,3,6,-3
CHE,IND,2018.0,23,56,-33
SAU,ARE,2009.0,7,6,1
HRV,AUT,2014.0,8,3,5
FRA,KHM,2009.0,5,2,3
GBR,RUS,2005.0,27,43,-16
VNM,KOR,2015.0,15,47,-32
DNK,ESP,2001.0,3,10,-7
CHL,ARG,2010.0,11,11,0
JPN,BGR,2000.0,2,2,0
RUS,EST,2010.0,4,2,2
IND,CHE,2010.0,36,15,21
HUN,PRT,2007.0,2,1,1
NZL,GBR,1998.0,16,20,-4
USA,EST,2012.0,3,5,-2
CHN,DZA,2017.0,5,3,2
ETH,DEU,2014.0,5,6,-1
NZL,MYS,2013.0,19,12,7
AUT,CHL,2022.0,1,3,-2
PAK,USA,2004.0,24,23,1
DEU,RUS,2022.0,29,57,-28
MYS,ITA,2022.0,1,1,0
MEX,IRN,2021.0,1,5,-4
RUS,EST,2019.0,3,3,0
CAN,ARG,2014.0,13,14,-1
CAN,HUN,2003.0,2,5,-3
ESP,ROU,2009.0,3,7,-4
ISR,CHE,1998.0,4,2,2
AUT,PAK,2009.0,9,7,2
VNM,NLD,2013.0,3,9,-6
ARG,COL,2004.0,2,2,0
BEL,COG,2010.0,1,5,-4
FRA,BFA,2018.0,16,10,6
CZE,ITA,2003.0,4,6,-2
DZA,CAN,2011.0,4,4,0
ESP,PAN,2014.0,2,3,-1
ITA,SVK,2021.0,6,3,3
DEU,LTU,2016.0,4,5,-1
VNM,USA,2011.0,9,22,-13
BIH,SVN,2006.0,2,3,-1
OMN,PAK,2014.0,2,11,-9
ECU,NLD,2015.0,2,4,-2
BRA,CUB,2017.0,4,27,-23
CHE,HRV,2006.0,5,3,2
HUN,DNK,2021.0,6,4,2
CAN,MYS,2001.0,1,4,-3
BGR,DNK,2004.0,2,1,1
MEX,CZE,2004.0,1,2,-1
HRV,HUN,2013.0,2,2,0
MYS,PRT,2008.0,1,1,0
TUR,IND,2017.0,3,7,-4
DEU,UZB,2009.0,1,1,0
CHL,PER,2011.0,2,4,-2
CYP,BEL,2014.0,1,1,0
IND,POL,2008.0,5,1,4
POL,JPN,2011.0,3,28,-25
SVK,ITA,2002.0,8,1,7
MYS,OMN,2004.0,1,1,0
BHR,FRA,2008.0,1,1,0
IND,FJI,2008.0,1,1,0
SGP,UKR,2009.0,1,1,0
PAK,BRA,2018.0,7,11,-4
RUS,IRN,2021.0,3,6,-3
FJI,NZL,2013.0,1,1,0
ARE,JOR,2011.0,4,9,-5
HRV,CHE,2007.0,5,2,3
CZE,HRV,2015.0,1,3,-2
PNG,USA,2021.0,1,1,0
DZA,ARE,2021.0,1,2,-1
FRA,SRB,2016.0,3,1,2
USA,YEM,2012.0,2,1,1
NOR,HUN,2012.0,2,5,-3
ESP,ZAF,2007.0,1,3,-2
ROU,PRT,2006.0,2,1,1
ESP,CYP,2016.0,2,1,1
ARE,SRB,2017.0,1,1,0
SWE,VNM,2011.0,2,1,1
COL,BEL,2011.0,3,2,1
ESP,LUX,2022.0,3,1,2
USA,MUS,2020.0,1,1,0
USA,PAN,1998.0,2,1,1
UGA,FRA,2013.0,3,2,1
PHL,BGD,2016.0,1,1,0
CZE,SWE,2001.0,3,4,-1
USA,BGD,1999.0,2,5,-3
COG,CHE,2019.0,1,7,-6
SVN,CAN,1999.0,1,1,0
FIN,HRV,2013.0,1,1,0
AUS,RUS,2006.0,2,10,-8
UKR,NOR,2022.0,1,1,0
AUS,ARG,2012.0,2,5,-3
PRT,MAC,2021.0,1,2,-1
EST,GRC,2008.0,1,1,0
SAU,LBN,2022.0,1,1,0
SVN,NLD,1998.0,1,2,-1
SYR,GBR,2016.0,2,2,0
IDN,DZA,2018.0,2,1,1
ITA,BIH,2015.0,1,1,0
ISR,SGP,2022.0,2,2,0
ARE,GEO,2018.0,1,1,0
KAZ,KGZ,2015.0,1,3,-2
ITA,ETH,2013.0,1,2,-1
CUB,BEL,2009.0,1,1,0
MEX,ZWE,2014.0,1,1,0
JPN,SDN,2011.0,1,2,-1
DEU,,2023.0,76586,0,76586
,KOR,2001.0,8386,0,8386
,IND,2004.0,13518,0,13518
,ESP,2004.0,12892,0,12892
,USA,2006.0,80782,0,80782
NLD,,2018.0,5459,0,5459
ESP,,2022.0,27063,0,27063
,SRB,2009.0,1683,0,1683
,TUR,2002.0,5927,0,5927
,ZAF,2011.0,2263,0,2263
GBR,,2005.0,6570,0,6570
ZAF,,2015.0,933,0,933
,BOL,2003.0,33,0,33
,ESP,1996.0,6461,0,6461
,ISR,2010.0,2421,0,2421
,PHL,2001.0,195,0,195
RUS,,2002.0,1421,0,1421
,AUS,2013.0,9765,0,9765
SVK,,2022.0,1868,0,1868
GBR,,2002.0,1887,0,1887
PAK,,2015.0,1022,0,1022
IDN,,2024.0,20492,0,20492
ZWE,,2019.0,93,0,93
,NOR,2015.0,1989,0,1989
,TUR,2005.0,5948,0,5948
EGY,,2013.0,745,0,745
BWA,,2011.0,38,0,38
ISL,,2022.0,332,0,332
,GRC,2008.0,2428,0,2428
,WSM,2004.0,5,0,5
RWA,,2024.0,459,0,459
ROU,,2013.0,929,0,929
,IND,1996.0,4281,0,4281
NPL,,2018.0,141,0,141
FRO,DNK,2009.0,3,0,3
QAT,,2008.0,33,0,33
YEM,IDN,2018.0,1,0,1
,KWT,2005.0,172,0,172
AUT,,2008.0,939,0,939
POL,,2002.0,280,0,280
POL,,2005.0,954,0,954
MAR,GAB,2007.0,1,0,1
KWT,,2010.0,100,0,100
GBR,BIH,2012.0,3,0,3
DZA,,2018.0,848,0,848
GHA,,2020.0,260,0,260
,VEN,2005.0,628,0,628
RUS,,2005.0,3279,0,3279
,BGR,1995.0,338,0,338
,UZB,2008.0,102,0,102
,TGO,2004.0,21,0,21
,MOZ,2005.0,20,0,20
AUT,ARG,2010.0,2,0,2
,CAN,2015.0,12392,0,12392
,VEN,2002.0,499,0,499
GBR,URY,2011.0,1,0,1
,CHL,1995.0,585,0,585
,ROU,2014.0,1748,0,1748
,HKG,2010.0,1605,0,1605
NOR,JOR,2017.0,2,0,2
,SVN,2013.0,628,0,628
,KWT,2002.0,158,0,158
KWT,,2017.0,137,0,137
ZWE,,2010.0,35,0,35
,ISR,2017.0,2164,0,2164
,BGD,2010.0,829,0,829
,ZMB,2010.0,67,0,67
,ISL,2010.0,145,0,145
,AFG,2010.0,11,0,11
LKA,,2022.0,515,0,515
ZWE,,2017.0,50,0,50
,BFA,2015.0,105,0,105
,NGA,2012.0,1677,0,1677
,SGP,2013.0,2267,0,2267
,IRQ,2012.0,441,0,441
THA,FIN,2022.0,1,0,1
,BGD,2019.0,1311,0,1311
,BGD,2017.0,1270,0,1270
,HND,2010.0,17,0,17
SGP,MAC,2016.0,4,0,4
,NPL,2009.0,228,0,228
,CMR,2012.0,327,0,327
TUR,SOM,2020.0,2,0,2
,HKG,2019.0,1684,0,1684
LTU,LVA,2015.0,6,0,6
OMN,,2020.0,145,0,145
,EST,2013.0,308,0,308
,MLT,2011.0,73,0,73
,ISR,2019.0,1326,0,1326
HKG,LKA,2020.0,1,0,1
KWT,,2019.0,154,0,154
,MAR,2013.0,1236,0,1236
NCL,,2024.0,90,0,90
PRI,,2020.0,161,0,161
,SWE,2018.0,2610,0,2610
,BHR,2014.0,69,0,69
MSR,USA,2019.0,1,0,1
KOR,NGA,2001.0,2,0,2
MYS,BHR,2020.0,7,0,7
,HKG,2017.0,2101,0,2101
IND,CHL,2020.0,13,0,13
,SDN,2002.0,55,0,55
,ETH,2015.0,924,0,924
NGA,,2003.0,49,0,49
MAR,RWA,2020.0,1,0,1
,ISL,2017.0,125,0,125
,GAB,2014.0,31,0,31
,LAO,2014.0,31,0,31
,GIN,2015.0,18,0,18
AUT,ECU,2019.0,1,0,1
,COD,2016.0,46,0,46
,ZMB,2017.0,87,0,87
,MKD,2016.0,107,0,107
KEN,CAN,1999.0,3,0,3
BRA,SAU,2021.0,6,0,6
BEN,,2017.0,49,0,49
,GUF,2011.0,13,0,13
,JAM,2012.0,37,0,37
IRN,NZL,2022.0,6,0,6
GEO,,2016.0,81,0,81
COL,KHM,2014.0,1,0,1
MKD,,2014.0,52,0,52
NGA,BWA,2009.0,3,0,3
BFA,AUS,2016.0,1,0,1
RUS,SGP,2006.0,5,0,5
GBR,DZA,2013.0,3,0,3
CAN,BMU,2011.0,1,0,1
,SDN,2005.0,85,0,85
POL,GRC,2018.0,3,0,3
URY,,2016.0,125,0,125
BEN,,2019.0,58,0,58
BRA,PER,2000.0,4,0,4
,ISL,2019.0,66,0,66
,VNM,2001.0,148,0,148
,GEO,2007.0,138,0,138
SGP,ARG,2008.0,1,0,1
DNK,QAT,2021.0,2,0,2
MYS,PSE,2018.0,11,0,11
NIC,,2006.0,4,0,4
,ZMB,2019.0,62,0,62
,SYR,2009.0,88,0,88
KWT,IRN,2022.0,1,0,1
CAN,GTM,2019.0,1,0,1
,GUY,2015.0,15,0,15
SYR,DEU,2021.0,2,0,2
ISR,TUR,2009.0,3,0,3
,PRK,2005.0,4,0,4
SYR,HUN,2016.0,1,0,1
ETH,MEX,2021.0,1,0,1
BRA,LKA,2021.0,1,0,1
EGY,SRB,2015.0,1,0,1
BTN,,2022.0,38,0,38
GIN,,2013.0,4,0,4
,AFG,2019.0,40,0,40
GBR,BRN,2015.0,10,0,10
,HND,2017.0,35,0,35
,KGZ,2018.0,41,0,41
BGR,,2009.0,171,0,171
TZA,,2009.0,48,0,48
CUB,DEU,2009.0,4,0,4
GAB,,2008.0,9,0,9
BEN,,2010.0,10,0,10
MAR,DZA,2005.0,1,0,1
ALB,GBR,2017.0,1,0,1
FIN,,2001.0,58,0,58
,YEM,2001.0,16,0,16
EGY,MYS,2009.0,4,0,4
,GMB,2002.0,14,0,14
SRB,,2004.0,78,0,78
TJK,KAZ,2017.0,1,0,1
THA,HRV,2014.0,1,0,1
SEN,CHN,2016.0,2,0,2
PER,VEN,2013.0,1,0,1
,PAN,2007.0,34,0,34
SAU,,1999.0,22,0,22
KEN,SAU,2018.0,2,0,2
PAK,SEN,2003.0,1,0,1
ITA,EGY,2003.0,3,0,3
BRA,BLR,2021.0,1,0,1
COL,,2004.0,46,0,46
LVA,LTU,2011.0,1,0,1
MCO,,2016.0,10,0,10
,CYP,1999.0,44,0,44
BEL,MLI,2012.0,2,0,2
TTO,,2014.0,42,0,42
,LUX,1994.0,8,0,8
YEM,SDN,2001.0,1,0,1
JPN,HRV,2016.0,3,0,3
SRB,FIN,2004.0,2,0,2
PER,JPN,2009.0,1,0,1
KEN,COG,2014.0,2,0,2
JPN,SRB,2003.0,4,0,4
GBR,KGZ,2010.0,2,0,2
TUR,FIN,1997.0,1,0,1
UKR,CZE,2010.0,3,0,3
BLR,TWN,2013.0,1,0,1
HRV,SVK,2000.0,2,0,2
VNM,PHL,2005.0,1,0,1
HUN,,1999.0,38,0,38
FIN,EST,1998.0,1,0,1
,MOZ,2002.0,21,0,21
HUN,EGY,1998.0,1,0,1
BGR,JPN,1998.0,1,0,1
GBR,KHM,2005.0,1,0,1
CHN,PHL,1999.0,3,0,3
TWN,MYS,2011.0,5,0,5
MKD,MNE,2005.0,1,0,1
ARG,FIN,2011.0,1,0,1
MAR,JPN,2003.0,2,0,2
TJK,,2012.0,7,0,7
NAM,IND,2007.0,1,0,1
,BHS,2005.0,6,0,6
,GMB,2005.0,15,0,15
JOR,HUN,2016.0,2,0,2
DNK,MLT,2014.0,2,0,2
BRN,,2018.0,31,0,31
JPN,MMR,2010.0,2,0,2
BIH,DNK,2012.0,1,0,1
IND,AZE,2009.0,1,0,1
COL,MOZ,2011.0,1,0,1
SMR,,2022.0,6,0,6
CAF,,2015.0,3,0,3
ARM,SWE,2015.0,1,0,1
COL,VNM,2014.0,1,0,1
IRN,LUX,2021.0,2,0,2
SGP,ECU,2019.0,2,0,2
DNK,GRL,2016.0,5,0,5
ZWE,COG,2022.0,2,0,2
,AFG,2017.0,43,0,43
ETH,MLI,2016.0,2,0,2
,NAM,2008.0,14,0,14
MSR,,2009.0,3,0,3
CRI,,2006.0,24,0,24
PRT,BLR,2014.0,1,0,1
CHN,BDI,2021.0,2,0,2
,PNG,2018.0,30,0,30
CHL,GRC,2011.0,2,0,2
GUF,CHE,2011.0,1,0,1
VEN,SWE,2000.0,1,0,1
JOR,ZAF,2021.0,1,0,1
TUR,EST,2018.0,2,0,2
ARM,EST,2017.0,1,0,1
ARG,JPN,2020.0,2,0,2
SWE,IDN,2015.0,4,0,4
LVA,ESP,2016.0,4,0,4
SVK,BGR,2021.0,2,0,2
TZA,SVN,2019.0,1,0,1
ISR,SVK,2004.0,1,0,1
PNG,,2006.0,12,0,12
MKD,JPN,2002.0,1,0,1
DNK,BFA,2008.0,1,0,1
,TGO,1996.0,11,0,11
PRY,,2009.0,1,0,1
RWA,UGA,2018.0,1,0,1
ITA,CMR,2022.0,1,0,1
,BRB,1999.0,13,0,13
GLP,,2012.0,3,0,3
SDN,,2006.0,21,0,21
AUS,GUM,2016.0,1,0,1
ROU,BHR,2014.0,1,0,1
GBR,CRI,2002.0,1,0,1
DNK,SDN,2003.0,1,0,1
TUN,PRT,2005.0,3,0,3
PRT,HUN,2020.0,3,0,3
PRT,ARG,2006.0,3,0,3
TWN,CZE,2015.0,1,0,1
CHE,PER,2014.0,2,0,2
,PRK,2002.0,2,0,2
JPN,LAO,2021.0,1,0,1
,TCD,1999.0,1,0,1
ISR,THA,2018.0,1,0,1
MEX,MYS,2022.0,1,0,1
BRA,GLP,2007.0,1,0,1
ETH,KOR,2012.0,1,0,1
MWI,TZA,2010.0,1,0,1
SGP,BGD,2008.0,1,0,1
UGA,NLD,2005.0,1,0,1
PRT,TLS,2018.0,1,0,1
JPN,BLR,2017.0,2,0,2
SAU,MAC,2021.0,1,0,1
,FRO,2013.0,5,0,5
NLD,IRQ,2021.0,1,0,1
MYS,FRA,2001.0,3,0,3
UGA,DNK,2004.0,1,0,1
TUN,QAT,2022.0,1,0,1
FRA,LBY,2009.0,3,0,3
CHE,NGA,2009.0,2,0,2
CHN,AZE,2016.0,1,0,1
,FLK,2004.0,1,0,1
DNK,KEN,2003.0,3,0,3
BRA,THA,2022.0,2,0,2
JPN,EST,2008.0,2,0,2
ITA,ARE,2013.0,1,0,1
GRC,CZE,2014.0,5,0,5
PRI,GBR,2016.0,1,0,1
SLV,NLD,2013.0,1,0,1
TCD,ZAF,2009.0,1,0,1
HUN,MAR,2008.0,1,0,1
SWE,LBY,2022.0,1,0,1
MYS,CHN,2006.0,3,0,3
BIH,SWE,2018.0,1,0,1
ZWE,NAM,2014.0,3,0,3
CZE,BGR,2022.0,3,0,3
,CPV,2017.0,5,0,5
RUS,HUN,2013.0,4,0,4
ETH,THA,2016.0,1,0,1
GBR,MUS,2015.0,2,0,2
FIN,HKG,2014.0,2,0,2
NAM,ESP,2020.0,1,0,1
PHL,ITA,2021.0,1,0,1
KEN,IRN,2014.0,1,0,1
AUT,LKA,2018.0,1,0,1
TGO,,2004.0,3,0,3
IND,CZE,2007.0,2,0,2
CZE,BEL,1999.0,1,0,1
NOR,COL,2016.0,3,0,3
ESP,TWN,2009.0,2,0,2
POL,ISL,2014.0,1,0,1
UKR,SGP,2002.0,1,0,1
CAN,TTO,2005.0,3,0,3
BFA,NLD,2001.0,2,0,2
ECU,MYS,2017.0,1,0,1
ITA,TUN,1997.0,1,0,1
JAM,,2005.0,9,0,9
PHL,OMN,2009.0,1,0,1
MRT,,2005.0,2,0,2
LUX,ZAF,2012.0,1,0,1
KOR,CHL,2014.0,6,0,6
NER,NCL,1999.0,1,0,1
MKD,FRA,2005.0,1,0,1
,BTN,2002.0,4,0,4
GUF,,2004.0,1,0,1
CAN,TTO,2002.0,3,0,3
GNB,,2004.0,1,0,1
RWA,NLD,2007.0,1,0,1
ZMB,THA,2009.0,1,0,1
LKA,CHE,2002.0,1,0,1
AUS,MAC,2006.0,1,0,1
BLR,CHE,2014.0,1,0,1
USA,TGO,2009.0,2,0,2
GBR,KAZ,2012.0,5,0,5
UKR,CAN,2011.0,2,0,2
FRA,IRN,1999.0,3,0,3
YEM,DEU,2010.0,1,0,1
,BTN,2005.0,4,0,4
DEU,SWZ,2013.0,1,0,1
NIC,DEU,2019.0,1,0,1
BGD,LUX,2021.0,1,0,1
SDN,QAT,2022.0,3,0,3
VEN,JPN,2016.0,1,0,1
BEN,MAR,2016.0,2,0,2
MYS,HKG,2005.0,1,0,1
PAK,LBN,2017.0,2,0,2
ITA,SMR,2022.0,1,0,1
DEU,LIE,2015.0,2,0,2
CRI,COL,2021.0,4,0,4
GBR,BHS,2018.0,2,0,2
GRL,DEU,2018.0,1,0,1
BEL,AUT,2000.0,3,0,3
GMB,BEL,2016.0,2,0,2
POL,PRI,2005.0,1,0,1
FRA,YEM,2005.0,1,0,1
DEU,SEN,2005.0,1,0,1
SDN,SAU,1998.0,1,0,1
ECU,,2000.0,1,0,1
UKR,ZAF,1999.0,1,0,1
PAN,,2007.0,2,0,2
CHN,SDN,2008.0,2,0,2
BHS,,2011.0,2,0,2
IND,MAR,2006.0,1,0,1
IRN,CYP,2009.0,1,0,1
GHA,EGY,2012.0,1,0,1
SRB,OMN,2022.0,1,0,1
TWN,NOR,2011.0,1,0,1
DEU,BFA,2018.0,1,0,1
BHS,CHE,2020.0,1,0,1
LVA,GBR,2012.0,2,0,2
UKR,BEL,2015.0,1,0,1
TZA,BEN,2022.0,1,0,1
AZE,EGY,2013.0,1,0,1
BGD,RUS,2010.0,1,0,1
SVK,NOR,2014.0,4,0,4
PRT,ARE,2021.0,2,0,2
CAN,SVN,2009.0,2,0,2
BRN,BGD,2015.0,2,0,2
GRC,NPL,2015.0,1,0,1
TUR,PSE,2021.0,1,0,1
SVK,NZL,2022.0,1,0,1
,HND,2019.0,18,0,18
THA,BTN,2019.0,2,0,2
GRC,KAZ,2017.0,3,0,3
BRN,LKA,2017.0,1,0,1
SRB,PRT,2009.0,1,0,1
SWZ,,2011.0,1,0,1
HRV,TWN,2007.0,1,0,1
PRT,THA,2007.0,1,0,1
POL,PRI,2002.0,1,0,1
GBR,PAN,2011.0,1,0,1
ALB,AUT,2010.0,1,0,1
AUS,MCO,2016.0,1,0,1
,ABW,2013.0,2,0,2
DOM,ITA,2021.0,1,0,1
BWA,MWI,2021.0,1,0,1
MOZ,ZWE,2020.0,1,0,1
NZL,IRQ,2021.0,1,0,1
ALB,GBR,2010.0,1,0,1
TWN,SAU,2022.0,3,0,3
BGR,GRC,2003.0,4,0,4
GBR,LUX,2003.0,1,0,1
GRC,KAZ,2019.0,1,0,1
AUT,JOR,2009.0,1,0,1
CHN,NGA,1999.0,1,0,1
ARM,POL,2002.0,1,0,1
USA,LUX,1999.0,1,0,1
HRV,GBR,1999.0,1,0,1
EST,ITA,2002.0,1,0,1
TZA,SWE,2007.0,1,0,1
IRL,CMR,2013.0,1,0,1
BFA,,2004.0,3,0,3
USA,LTU,1999.0,1,0,1
PNG,CHE,2005.0,3,0,3
LIE,AUS,2015.0,1,0,1
MDG,NCL,2002.0,1,0,1
OMN,ARE,2001.0,2,0,2
JOR,ARE,1999.0,1,0,1
MKD,JPN,2005.0,1,0,1
NGA,VEN,2009.0,1,0,1
IRL,SAU,1999.0,1,0,1
MLI,FRA,2007.0,2,0,2
MDA,CAN,2013.0,1,0,1
QAT,HUN,2021.0,1,0,1
FJI,GBR,2012.0,1,0,1
BEL,PSE,2022.0,1,0,1
,CPV,2010.0,4,0,4
ITA,IDN,2021.0,2,0,2
SLV,CAN,2018.0,1,0,1
BEN,SEN,2022.0,1,0,1
USA,SYR,2012.0,2,0,2
IRL,CHL,2014.0,1,0,1
LTU,BRA,2002.0,1,0,1
COG,GMB,2016.0,1,0,1
CMR,BRA,2013.0,1,0,1
MKD,GBR,2009.0,1,0,1
ARM,AUT,2009.0,1,0,1
ITA,TWN,2005.0,3,0,3
HUN,QAT,2016.0,2,0,2
LUX,ISR,2020.0,1,0,1
POL,YEM,2016.0,1,0,1
CYP,MAR,2011.0,1,0,1
MRT,,2002.0,2,0,2
ECU,BRA,2001.0,1,0,1
BEL,NOR,1997.0,1,0,1
GNB,SWE,2004.0,1,0,1
LBY,IRN,2019.0,1,0,1
GBR,TJK,2006.0,1,0,1
BFA,LUX,2017.0,1,0,1
GNB,GIN,2019.0,1,0,1
CZE,SGP,2011.0,1,0,1
RUS,IRQ,2016.0,2,0,2
CUB,DOM,2019.0,2,0,2
POL,NAM,2019.0,1,0,1
BEL,URY,2022.0,1,0,1
GBR,BDI,2020.0,1,0,1
EGY,SDN,2006.0,1,0,1
DZA,NLD,2007.0,1,0,1
BEL,PYF,2019.0,1,0,1
NLD,KHM,2016.0,1,0,1
GBR,SRB,2022.0,2,0,2
KEN,CIV,2009.0,1,0,1
FIN,CMR,2010.0,1,0,1
THA,BGR,2020.0,1,0,1
GRC,ISR,2019.0,2,0,2
VEN,AUS,2013.0,1,0,1
SDN,USA,2010.0,1,0,1
CHN,TGO,2013.0,1,0,1
JOR,DZA,2013.0,1,0,1
BWA,UGA,2021.0,1,0,1
TUR,LBN,2014.0,1,0,1
BGR,NLD,1999.0,2,0,2
KEN,FRA,1999.0,1,0,1
PRI,SWE,2005.0,1,0,1
ZAF,MLT,2013.0,1,0,1
ROU,HUN,1999.0,2,0,2
ARM,NLD,2002.0,1,0,1
HUN,NLD,1999.0,4,0,4
SWE,SWZ,2004.0,1,0,1
LTU,EST,2014.0,1,0,1
NZL,SVK,2016.0,1,0,1
UKR,BLR,2016.0,1,0,1
TUN,NOR,2020.0,1,0,1
CAN,LBY,2009.0,1,0,1
NOR,JOR,2010.0,1,0,1
NGA,DZA,2008.0,1,0,1
BEL,KEN,2006.0,1,0,1
NOR,BIH,2015.0,1,0,1
NPL,CHE,2016.0,1,0,1
HND,USA,1999.0,1,0,1
HND,CRI,2017.0,2,0,2
HUN,ALB,2018.0,1,0,1
COG,KHM,2020.0,1,0,1
CHN,ECU,2016.0,1,0,1
DNK,ZWE,2017.0,1,0,1
BRA,STP,2019.0,1,0,1
NAM,BWA,2001.0,1,0,1
AUT,AZE,2020.0,1,0,1
ROU,ARE,2021.0,1,0,1
,CPV,2019.0,3,0,3
SAU,DNK,2009.0,1,0,1
JPN,CMR,2003.0,1,0,1
FIN,UKR,1997.0,1,0,1
PSE,ITA,2012.0,1,0,1
RUS,LUX,2011.0,1,0,1
MEX,NGA,2017.0,1,0,1
ARM,DEU,2014.0,2,0,2
KEN,TWN,2014.0,1,0,1
ROU,KOR,2018.0,1,0,1
MOZ,TZA,2016.0,1,0,1
TUN,MLT,2007.0,1,0,1
UZB,KAZ,2022.0,1,0,1
CMR,SVK,2021.0,1,0,1
SVN,SWE,2003.0,1,0,1
CUB,HND,2018.0,1,0,1
AZE,DEU,2022.0,1,0,1
MLI,CIV,2018.0,3,0,3
FRA,TCD,2001.0,1,0,1
CHE,SVN,2000.0,1,0,1
BEL,PER,2009.0,2,0,2
USA,CPV,2015.0,1,0,1
JPN,BWA,2012.0,1,0,1
FJI,TON,2020.0,1,0,1
MDV,ITA,2022.0,1,0,1
GBR,KGZ,2019.0,1,0,1
LKA,PAK,2007.0,1,0,1
SRB,ROU,2005.0,1,0,1
KOR,COL,2011.0,1,0,1
BEL,MDG,2016.0,2,0,2
CHN,COL,2003.0,1,0,1
GHA,ZAF,2005.0,1,0,1
ISL,NLD,2020.0,2,0,2
MNE,CAN,2016.0,1,0,1
CZE,PAK,2017.0,1,0,1
NGA,TWN,2017.0,1,0,1
SWE,BGR,2006.0,3,0,3
BRN,VNM,2017.0,1,0,1
COL,AUT,2006.0,2,0,2
GUY,TTO,2007.0,1,0,1
ZAF,COG,2009.0,1,0,1
CMR,CAN,2001.0,1,0,1
MEX,THA,2018.0,1,0,1
CHL,CUB,2001.0,1,0,1
MYS,HKG,2002.0,1,0,1
NER,MDG,2018.0,1,0,1
GRC,NZL,2009.0,1,0,1
NGA,TWN,2010.0,1,0,1
ZAF,CHL,2016.0,1,0,1
MDA,NOR,2021.0,1,0,1
CAN,URY,2008.0,1,0,1
SVK,ROU,2008.0,2,0,2
CAN,VEN,1997.0,1,0,1
MEX,HRV,1999.0,1,0,1
HKG,PAK,2003.0,1,0,1
TWN,ITA,2003.0,1,0,1
ROU,BEL,1997.0,1,0,1
CHL,MCO,2005.0,1,0,1
PAK,HKG,2005.0,1,0,1
DZA,BHR,2014.0,1,0,1
ARG,COG,2019.0,1,0,1
MNG,ITA,2021.0,1,0,1
EST,CHN,2012.0,1,0,1
LKA,BEL,2014.0,1,0,1
MDG,JPN,2002.0,1,0,1
MAR,BGD,2013.0,1,0,1
AGO,GHA,2011.0,1,0,1
LTU,FIN,2015.0,1,0,1
BGD,BRN,2011.0,1,0,1
BHR,KWT,2008.0,1,0,1
ARM,ITA,2012.0,1,0,1
IRN,BRA,2022.0,1,0,1
CAN,COD,2020.0,1,0,1
MAC,BEL,2022.0,1,0,1
PER,,1999.0,2,0,2
COL,DNK,2017.0,2,0,2
NZL,KWT,2021.0,1,0,1
HUN,LTU,2021.0,1,0,1
IRN,GUF,2003.0,1,0,1
HKG,COL,2018.0,1,0,1
MEX,OMN,2021.0,1,0,1
PER,NGA,2017.0,1,0,1
LVA,MAR,2018.0,1,0,1
MOZ,UGA,2020.0,1,0,1
TCD,CMR,2020.0,1,0,1
MMR,,2004.0,1,0,1
FIN,IRN,2005.0,2,0,2
KEN,IRL,2008.0,1,0,1
MNG,CAN,2020.0,1,0,1
IRL,GHA,2022.0,1,0,1
MAR,KOR,2007.0,1,0,1
CHE,TUN,2006.0,1,0,1
FIN,LVA,2001.0,1,0,1
ITA,CIV,2013.0,1,0,1
ZAF,GRC,2005.0,1,0,1
KHM,BEL,2007.0,1,0,1
CZE,NGA,2002.0,1,0,1
SWE,URY,2006.0,1,0,1
ARE,ARM,2003.0,1,0,1
,BMU,1995.0,1,0,1
ETH,,2001.0,2,0,2
ECU,COL,2009.0,1,0,1
MCO,TUN,2015.0,1,0,1
FLK,GBR,2004.0,1,0,1
ITA,GEO,1998.0,1,0,1
ISR,IRL,2000.0,1,0,1
USA,MCO,2011.0,1,0,1
TWN,URY,2004.0,1,0,1
HTI,NLD,2006.0,1,0,1
NLD,LKA,2013.0,1,0,1
ARE,MEX,2016.0,1,0,1
CHE,ETH,2007.0,1,0,1
UGA,JPN,2014.0,1,0,1
CHE,ECU,2018.0,1,0,1
IRL,KWT,2018.0,1,0,1
IDN,MMR,2019.0,1,0,1
CUB,CHN,2008.0,1,0,1
BGD,ISR,2020.0,1,0,1
PAK,AZE,2022.0,1,0,1
VEN,BOL,2012.0,1,0,1
BRN,FJI,2014.0,1,0,1
BRA,UKR,2016.0,1,0,1
PER,GHA,2002.0,1,0,1
MDA,KOR,2003.0,1,0,1
AUS,KEN,2002.0,1,0,1
QAT,IRQ,2016.0,1,0,1
TUN,CHE,2005.0,1,0,1
ESP,SGP,2006.0,1,0,1
PHL,BWA,2018.0,1,0,1
CAN,CYP,2004.0,2,0,2
GBR,DOM,2020.0,1,0,1
ARM,EST,2019.0,1,0,1
CHL,TUR,2020.0,1,0,1
IND,EST,2011.0,1,0,1
AUS,ZMB,1998.0,1,0,1
ISL,SVN,2019.0,1,0,1
DEU,MDV,2018.0,1,0,1
CIV,IND,2003.0,1,0,1
HUN,NZL,2015.0,1,0,1
CUB,CAN,2003.0,1,0,1
ARE,SRB,2010.0,1,0,1
PER,DNK,2003.0,1,0,1
NOR,ZWE,2006.0,1,0,1
MOZ,GBR,2011.0,1,0,1
SVK,ISR,2010.0,1,0,1
ZAF,CPV,2005.0,1,0,1
GBR,KGZ,2017.0,1,0,1
BGD,RUS,2017.0,1,0,1
USA,GBR,2005.0,1051,1275,-224
IRL,AUS,2006.0,31,22,9
IND,KOR,2021.0,173,105,68
DEU,POL,2006.0,60,54,6
BRA,NLD,2006.0,11,21,-10
TWN,IND,2014.0,48,50,-2
JOR,FRA,2010.0,1,3,-2
TWN,CHN,2015.0,135,67,68
SWE,DEU,2013.0,107,166,-59
USA,CHN,2012.0,1949,2024,-75
GBR,USA,2006.0,1282,1197,85
PAK,GBR,2014.0,34,64,-30
USA,PRT,2011.0,56,56,0
USA,CAN,2018.0,1348,1924,-576
RUS,BEL,2000.0,12,5,7
USA,VNM,2011.0,22,9,13
JPN,DEU,2004.0,112,86,26
NZL,AUS,2018.0,143,142,1
DEU,FRA,2013.0,317,321,-4
DNK,SWE,2008.0,42,91,-49
GBR,ESP,2018.0,340,450,-110
DEU,AUT,2012.0,310,251,59
JPN,TZA,2010.0,4,1,3
SWE,BEL,2020.0,23,20,3
TUN,FRA,2007.0,59,99,-40
MEX,ESP,2018.0,119,166,-47
GBR,QAT,2015.0,38,10,28
CHN,CHE,2014.0,40,41,-1
SWE,THA,2004.0,2,2,0
CHN,GBR,2019.0,422,511,-89
USA,FIN,2009.0,57,59,-2
JPN,AUS,2016.0,42,63,-21
AUS,HKG,2017.0,39,26,13
GBR,GHA,2007.0,13,6,7
GHA,GBR,2008.0,4,16,-12
CAN,DEU,2012.0,171,172,-1
FJI,AUS,2009.0,7,2,5
PRI,USA,2013.0,97,48,49
BEL,ZAF,2008.0,7,5,2
BEL,ARG,2010.0,5,6,-1
CAN,BRA,2008.0,25,40,-15
DEU,ZAF,2017.0,24,29,-5
SAU,KWT,2010.0,5,3,2
ITA,FRA,2004.0,139,146,-7
IRL,SWE,2007.0,3,6,-3
JPN,AUT,2016.0,12,5,7
AUT,GBR,2009.0,62,39,23
ZAF,BWA,2007.0,6,5,1
DEU,NLD,2018.0,305,339,-34
UGA,NLD,2007.0,1,2,-1
DEU,IDN,2010.0,17,1,16
USA,SWE,2004.0,182,200,-18
MYS,GBR,2018.0,89,144,-55
GLP,FRA,2018.0,22,6,16
CHN,GBR,2010.0,175,194,-19
IND,SGP,2010.0,51,30,21
FIN,NLD,2016.0,19,12,7
ITA,GRC,2010.0,20,18,2
THA,MMR,2010.0,2,1,1
CHE,BEL,2012.0,37,39,-2
USA,TUR,2005.0,187,146,41
FRA,GRC,2008.0,23,19,4
FRA,MEX,2013.0,43,29,14
CZE,ITA,2012.0,3,4,-1
IND,SGP,2019.0,91,71,20
SWE,AUS,2005.0,36,16,20
FRA,NGA,2015.0,5,3,2
DEU,IDN,2019.0,16,14,2
ZAF,GHA,2008.0,3,1,2
NLD,ISR,2018.0,11,10,1
KOR,DEU,2015.0,50,43,7
CHN,AUT,2010.0,11,4,7
USA,JPN,2022.0,288,245,43
HKG,GBR,2017.0,55,54,1
BGD,CAN,2012.0,26,12,14
CHN,GBR,2017.0,345,426,-81
SAU,KWT,2019.0,9,2,7
HKG,GBR,2019.0,73,47,26
BRA,CAN,2013.0,83,36,47
GBR,MYS,2006.0,59,14,45
MYS,OMN,2020.0,18,4,14
GBR,BEL,1997.0,10,5,5
AUS,NZL,2022.0,44,75,-31
DEU,NZL,2016.0,19,25,-6
GBR,ZAF,2015.0,105,82,23
USA,TWN,1999.0,111,56,55
CAN,FRA,2022.0,79,106,-27
CHN,CAN,2020.0,302,366,-64
IND,SGP,2017.0,95,67,28
MYS,BGD,2021.0,27,17,10
AUS,BGD,2013.0,11,48,-37
USA,GBR,2002.0,1086,1404,-318
IRL,USA,2020.0,149,103,46
KOR,JPN,2016.0,95,114,-19
CHN,AUS,2004.0,54,46,8
DNK,GBR,2020.0,98,106,-8
AUS,HKG,2019.0,37,49,-12
GBR,CHE,2021.0,255,199,56
DEU,AUS,1997.0,15,6,9
GRC,NLD,2015.0,26,8,18
ESP,NLD,2016.0,82,63,19
JPN,CHN,2022.0,239,157,82
DNK,LTU,2016.0,4,4,0
AUT,SWE,2018.0,29,18,11
IND,ITA,2013.0,45,38,7
DOM,BRA,2021.0,2,1,1
GBR,NPL,2010.0,4,4,0
IRL,CAN,2015.0,42,33,9
BEL,USA,2021.0,124,97,27
ITA,GRC,2019.0,27,35,-8
CZE,CHE,2016.0,11,13,-2
DEU,IDN,2017.0,23,9,14
ZAF,NAM,2017.0,17,5,12
CHN,ISR,2014.0,10,8,2
ISR,CHN,2015.0,10,11,-1
MEX,CZE,2020.0,8,2,6
GBR,AUT,2021.0,83,55,28
CHL,DEU,2022.0,12,17,-5
RUS,USA,1997.0,63,41,22
NOR,CAN,2019.0,14,18,-4
EGY,FIN,2014.0,3,1,2
LKA,USA,2018.0,14,25,-11
HKG,CAN,2020.0,25,19,6
BGD,PRT,2020.0,1,2,-1
DNK,POL,2019.0,10,7,3
PAK,USA,2020.0,118,79,39
PAK,MYS,2018.0,44,146,-102
SVN,USA,2014.0,14,8,6
HUN,ITA,2021.0,5,10,-5
RUS,BLR,2018.0,11,15,-4
AUS,CZE,2015.0,8,3,5
BEL,IND,2003.0,6,4,2
EGY,GBR,2022.0,28,21,7
ARG,MEX,2015.0,13,12,1
ITA,DNK,2020.0,57,34,23
NZL,SGP,2019.0,15,12,3
BGD,MYS,2005.0,3,2,1
JPN,IRN,2020.0,15,14,1
BGD,GBR,2021.0,15,18,-3
VEN,BRA,2009.0,2,4,-2
RUS,GBR,2021.0,39,38,1
TUN,DEU,2019.0,10,3,7
JPN,BGD,2006.0,35,32,3
USA,SAU,2022.0,90,50,40
KAZ,TUR,2018.0,8,5,3
HUN,USA,2020.0,49,37,12
BRA,BEL,2005.0,6,5,1
DEU,AUS,1998.0,24,17,7
JOR,DEU,2021.0,4,8,-4
GBR,IRL,2022.0,95,83,12
ARG,SWE,2020.0,6,4,2
CHE,RUS,2019.0,15,27,-12
ROU,USA,2001.0,29,9,20
USA,KAZ,2021.0,9,3,6
HKG,CHN,2016.0,569,460,109
AUS,SGP,2003.0,30,38,-8
ARG,COL,2020.0,18,18,0
GBR,BRA,2013.0,63,53,10
KOR,ITA,2014.0,7,3,4
FRA,POL,2016.0,27,52,-25
IRL,ESP,2015.0,15,38,-23
ARE,MYS,2017.0,4,17,-13
CAN,SAU,2012.0,84,26,58
DEU,ZAF,2010.0,16,23,-7
RUS,FRA,2016.0,33,32,1
EGY,YEM,2014.0,5,3,2
GEO,FRA,2016.0,13,18,-5
JPN,CHE,2009.0,27,24,3
IND,VNM,2019.0,5,2,3
PRT,FRA,2011.0,28,39,-11
BEL,BRA,2018.0,17,15,2
NZL,FRA,2010.0,9,13,-4
KOR,VNM,2011.0,23,9,14
TGO,FRA,2013.0,3,1,2
BGD,KOR,2013.0,13,26,-13
FRA,ITA,2013.0,209,360,-151
ARM,USA,2016.0,10,2,8
IRN,TWN,2019.0,4,1,3
HRV,CHE,2005.0,1,3,-2
AUS,KOR,2003.0,16,9,7
LSO,ZAF,2013.0,3,1,2
CAN,IND,2003.0,26,41,-15
NPL,KOR,2009.0,2,2,0
IND,SWE,2013.0,58,20,38
USA,IDN,2014.0,20,20,0
EGY,KAZ,2010.0,1,1,0
CHE,RUS,2017.0,13,18,-5
AUT,FIN,2018.0,8,9,-1
CAN,TUR,2014.0,25,16,9
MYS,NGA,2014.0,22,20,2
GNB,DNK,2015.0,1,3,-2
CUB,ECU,2018.0,20,6,14
JPN,SGP,2009.0,26,14,12
SWE,AUS,2002.0,29,30,-1
HKG,SWE,2016.0,9,1,8
KAZ,GBR,2014.0,4,3,1
ITA,PRT,2022.0,18,16,2
IRN,USA,2004.0,26,26,0
CHE,RUS,2010.0,8,18,-10
NLD,GBR,2000.0,52,44,8
ROU,JPN,2001.0,7,2,5
USA,NGA,2020.0,40,73,-33
ITA,DEU,2001.0,108,98,10
DEU,JPN,2000.0,43,47,-4
DEU,ZAF,2019.0,21,35,-14
ARG,ESP,1998.0,12,13,-1
RUS,FIN,2021.0,27,9,18
GHA,DEU,2003.0,3,3,0
NGA,PAK,2006.0,1,1,0
KGZ,KAZ,2014.0,1,1,0
RUS,CHE,2004.0,18,7,11
DEU,BEL,1998.0,12,6,6
NGA,CMR,2021.0,4,1,3
ZAF,SDN,2020.0,6,2,4
GHA,KOR,2018.0,3,1,2
SRB,MNE,2018.0,2,8,-6
TWN,ITA,2012.0,5,2,3
BEL,DEU,2005.0,43,47,-4
IRN,GBR,2014.0,41,35,6
SGP,MYS,2022.0,12,9,3
IND,MYS,2003.0,11,8,3
DEU,SAU,2019.0,30,22,8
IRN,FRA,2016.0,25,27,-2
ZAF,NAM,2019.0,21,5,16
GBR,HUN,2015.0,23,37,-14
MKD,BIH,2017.0,1,1,0
PHL,IDN,2021.0,1,1,0
USA,SVK,2016.0,8,11,-3
USA,PRI,1998.0,9,4,5
DEU,PRT,2014.0,23,60,-37
MYS,ARE,2022.0,8,1,7
IRN,PAK,2019.0,2,3,-1
JOR,QAT,2022.0,10,1,9
KOR,CHE,2009.0,7,6,1
SAU,KWT,2017.0,7,2,5
DEU,MWI,2021.0,2,2,0
ITA,CHE,2003.0,80,67,13
THA,IDN,2021.0,10,9,1
ARG,ITA,2005.0,16,15,1
CAN,ITA,2011.0,42,53,-11
CZE,FRA,2011.0,20,14,6
FRA,NER,2021.0,2,2,0
NLD,MYS,2011.0,11,4,7
PSE,ISR,2013.0,12,7,5
VEN,CAN,2018.0,3,1,2
BOL,FRA,2013.0,4,1,3
THA,SWE,2013.0,6,7,-1
HRV,BIH,2004.0,9,4,5
DNK,IND,2014.0,15,13,2
IDN,KEN,2006.0,1,1,0
GRC,AUT,2011.0,6,2,4
BGR,GRC,2012.0,1,1,0
ESP,PRT,2010.0,47,61,-14
MEX,TUR,2017.0,2,4,-2
HRV,USA,2009.0,12,13,-1
NGA,DEU,2015.0,5,5,0
IND,NPL,2005.0,21,8,13
LTU,SWE,2014.0,3,7,-4
IRQ,JOR,2011.0,2,4,-2
RUS,AUT,2016.0,10,6,4
NGA,USA,2020.0,73,40,33
CZE,BRA,2013.0,5,1,4
PAK,DEU,2004.0,4,4,0
SVK,ITA,2007.0,2,2,0
ZMB,NOR,2004.0,1,1,0
FRA,MCO,2002.0,5,1,4
GBR,RUS,2007.0,18,55,-37
FRA,CAN,1998.0,38,33,5
ARG,BRA,1998.0,7,6,1
BGD,MYS,2002.0,1,2,-1
AUT,UKR,2005.0,5,3,2
ESP,BEL,2001.0,23,14,9
AUT,ITA,2003.0,24,21,3
ARG,ESP,1997.0,10,11,-1
CAN,ISR,2001.0,21,12,9
KOR,THA,2002.0,3,1,2
USA,MLI,2016.0,10,1,9
AUS,FIN,2004.0,3,11,-8
NPL,USA,2001.0,6,1,5
SGP,FRA,2004.0,6,2,4
GBR,BEL,1998.0,10,12,-2
ZAF,NGA,2006.0,6,9,-3
CAN,ESP,2004.0,19,24,-5
BEL,POL,2014.0,8,17,-9
USA,PRI,1997.0,2,4,-2
ITA,MLT,2016.0,4,3,1
DEU,BEL,1997.0,6,8,-2
DEU,CUB,2004.0,5,1,4
BEL,NZL,2009.0,1,1,0
JPN,SWE,2008.0,30,23,7
FRA,CAN,1997.0,12,25,-13
CHE,SWE,2003.0,18,21,-3
POL,RUS,2001.0,14,10,4
GBR,UKR,2003.0,8,12,-4
MAR,USA,2004.0,7,1,6
POL,UKR,2007.0,6,13,-7
FRA,COG,2013.0,8,1,7
SWE,RUS,2009.0,12,16,-4
TWN,RUS,2014.0,5,2,3
AUS,IRQ,2009.0,1,1,0
AUS,DNK,2006.0,12,11,1
ROU,CHE,2007.0,3,4,-1
NZL,CHE,2014.0,11,7,4
IRN,SWE,2014.0,35,13,22
BLR,POL,2010.0,2,5,-3
ARG,ITA,2002.0,15,12,3
SAU,NGA,2004.0,6,1,5
BEL,GMB,2006.0,1,1,0
NOR,RUS,2004.0,2,6,-4
IRL,ITA,2016.0,15,28,-13
BEL,DEU,2002.0,68,54,14
ESP,RUS,2006.0,6,9,-3
ITA,BRA,2004.0,13,17,-4
CZE,GBR,1999.0,17,10,7
NLD,DNK,1997.0,5,2,3
GRC,ITA,2003.0,10,19,-9
IRL,JPN,2008.0,6,7,-1
ISR,IND,2007.0,11,21,-10
TWN,HKG,2006.0,4,10,-6
SAU,TWN,2020.0,7,6,1
DNK,AUS,2006.0,11,12,-1
PAK,KWT,2012.0,1,1,0
ESP,CHL,2022.0,35,32,3
ZAF,SGP,2009.0,1,3,-2
ISR,RUS,1999.0,1,17,-16
SGP,CHE,2015.0,16,21,-5
AZE,TUR,2008.0,6,6,0
ITA,TUR,2011.0,5,9,-4
BEL,LUX,2008.0,5,2,3
COL,ESP,2006.0,12,21,-9
ARG,CAN,2002.0,16,9,7
ITA,ZAF,2005.0,2,3,-1
POL,BLR,2011.0,2,3,-1
UKR,TUR,2018.0,2,1,1
NCL,FRA,2016.0,11,21,-10
AUS,IRN,2004.0,13,5,8
ZAF,FRA,2011.0,14,24,-10
ESP,NOR,2014.0,16,7,9
CAN,SEN,2020.0,4,2,2
SVN,SRB,2021.0,1,4,-3
BEN,DEU,2001.0,1,1,0
USA,KWT,2012.0,12,4,8
CUB,CAN,2012.0,5,1,4
JPN,TUR,2016.0,11,5,6
POL,CHE,2013.0,29,16,13
NLD,ARG,2015.0,2,4,-2
IND,ETH,2011.0,18,4,14
PRT,SWE,2020.0,14,14,0
NZL,FRA,2019.0,14,23,-9
FRA,HUN,2012.0,10,15,-5
PAK,BGD,2017.0,9,8,1
IRL,AUT,2011.0,4,2,2
CAN,NOR,2014.0,16,12,4
ISR,PSE,2015.0,9,9,0
CMR,USA,2015.0,9,11,-2
SVN,AUS,2009.0,2,1,1
MEX,BRA,2018.0,18,26,-8
AUS,LKA,2020.0,24,31,-7
USA,CMR,2008.0,4,7,-3
BRA,NZL,2013.0,5,1,4
HUN,CZE,2013.0,2,6,-4
EGY,RUS,2015.0,3,3,0
ZWE,USA,2009.0,7,2,5
CHN,TZA,2013.0,2,1,1
GEO,SWE,2018.0,1,1,0
SYR,ITA,2013.0,1,1,0
SGP,TUR,2019.0,6,3,3
TUR,AZE,2015.0,5,3,2
SGP,VNM,2020.0,14,3,11
SGP,DNK,2017.0,9,7,2
NOR,AUS,2020.0,16,27,-11
IRL,POL,2018.0,5,5,0
CHE,CHN,2018.0,44,52,-8
NGA,NLD,2016.0,3,6,-3
BEL,JPN,2015.0,13,15,-2
PAK,ITA,2013.0,5,7,-2
TWN,SWE,2009.0,1,1,0
JPN,ISR,2021.0,4,6,-2
BRA,CHL,2004.0,9,3,6
TUR,POL,2014.0,2,9,-7
TUR,LBY,2019.0,3,1,2
NLD,DNK,1998.0,5,3,2
CAN,BWA,2018.0,3,2,1
VNM,JPN,2020.0,18,92,-74
IRN,CHN,2015.0,16,8,8
EGY,NLD,2020.0,4,5,-1
AUS,HUN,2020.0,8,2,6
KOR,SAU,2020.0,27,12,15
TUR,PAK,2021.0,13,15,-2
MAR,ESP,2022.0,6,5,1
ESP,IND,2012.0,10,19,-9
AUT,HUN,2016.0,11,28,-17
JPN,FRA,2007.0,65,60,5
SAU,QAT,2008.0,2,1,1
CHE,MEX,2001.0,2,2,0
SVK,DEU,2010.0,7,12,-5
UGA,CAN,2018.0,5,1,4
IND,NPL,2002.0,7,9,-2
ROU,GBR,2005.0,5,4,1
ESP,ISR,2009.0,5,7,-2
JOR,FRA,2017.0,3,4,-1
NLD,PAK,2016.0,18,2,16
MEX,CUB,2018.0,9,32,-23
CHL,MEX,2020.0,6,20,-14
CAN,HKG,2022.0,12,12,0
CAN,HUN,2012.0,6,7,-1
DEU,KAZ,2011.0,1,1,0
AUS,SWE,2022.0,27,11,16
CAN,RUS,2018.0,18,19,-1
AUS,NOR,1999.0,3,2,1
CYP,NLD,2013.0,1,1,0
SWE,IRN,2021.0,11,45,-34
CMR,ZAF,2017.0,6,1,5
NZL,FRA,2017.0,11,13,-2
ARE,MYS,2019.0,4,17,-13
HRV,POL,2013.0,15,3,12
MDG,GBR,2010.0,1,3,-2
SVK,HUN,2020.0,6,9,-3
RUS,BRA,2015.0,9,7,2
VNM,RUS,2018.0,3,20,-17
PSE,GBR,2015.0,2,4,-2
NZL,SGP,2017.0,15,9,6
SWE,HUN,2004.0,5,3,2
ISR,ZAF,2008.0,2,1,1
THA,MMR,2019.0,4,6,-2
FIN,JPN,2022.0,3,6,-3
KOR,IND,2001.0,4,17,-13
LAO,THA,2013.0,4,4,0
CHN,AUT,2017.0,16,14,2
CHN,AUT,2019.0,17,27,-10
CMR,ZAF,2019.0,4,6,-2
AUS,PHL,2009.0,6,5,1
PRT,DEU,2005.0,14,15,-1
USA,NPL,2022.0,7,13,-6
ZWE,BWA,2012.0,2,1,1
GRC,PRT,2007.0,1,3,-2
FRA,BEN,2002.0,2,1,1
USA,SYR,2003.0,5,1,4
BLR,POL,2019.0,4,4,0
THA,AUS,2003.0,6,17,-11
JPN,PAK,2008.0,16,5,11
RUS,AUS,2000.0,3,2,1
DEU,SRB,2004.0,13,12,1
GBR,LBN,2003.0,4,4,0
FIN,NOR,2011.0,17,7,10
UKR,POL,2004.0,10,13,-3
AUT,DNK,2004.0,7,4,3
CHE,HUN,2009.0,4,13,-9
PRT,IRL,2006.0,2,2,0
CHN,TWN,1999.0,11,6,5
SAU,SDN,2004.0,3,2,1
IND,NZL,2002.0,3,2,1
ROU,IND,2021.0,4,1,3
MLT,GBR,2004.0,3,2,1
ISR,AUS,2021.0,13,14,-1
POL,CHN,2011.0,3,10,-7
PRT,DEU,2002.0,6,16,-10
IRN,NLD,2003.0,1,4,-3
MEX,BGD,2017.0,1,1,0
IRL,CZE,2011.0,4,4,0
ITA,TWN,2007.0,1,1,0
ITA,EGY,2012.0,5,5,0
PAK,CHN,2006.0,3,2,1
NZL,SGP,2010.0,10,8,2
ESP,ZAF,2002.0,1,1,0
BEL,FIN,2015.0,6,6,0
NZL,SWE,2009.0,5,9,-4
AUT,BEL,2008.0,3,5,-2
CAN,MAR,2020.0,10,3,7
TUR,DNK,2010.0,1,3,-2
SVK,NLD,2009.0,4,4,0
AUT,CAN,2012.0,18,15,3
EGY,JPN,2012.0,18,70,-52
BGR,USA,2010.0,14,15,-1
IND,KWT,2017.0,7,3,4
GHA,USA,2012.0,12,22,-10
CUB,USA,2005.0,5,1,4
CRI,BRA,2010.0,3,3,0
HKG,MYS,2018.0,2,5,-3
BGD,AUS,2008.0,18,4,14
NZL,FJI,2013.0,1,1,0
UKR,ESP,2009.0,2,2,0
AUS,COL,2013.0,2,8,-6
AUS,MEX,2011.0,2,10,-8
USA,HND,2014.0,2,3,-1
IRN,JPN,2013.0,8,12,-4
MYS,PHL,2016.0,2,1,1
SVK,POL,2006.0,3,3,0
DEU,BLR,2004.0,6,8,-2
TWN,PAK,2018.0,4,6,-2
ISR,FIN,2014.0,2,3,-1
ITA,KEN,2016.0,3,1,2
DNK,AUT,1999.0,2,2,0
GRC,CHL,2022.0,1,1,0
HKG,DEU,2014.0,13,12,1
SWE,SGP,2021.0,6,15,-9
POL,FIN,1999.0,4,1,3
CAN,EGY,2001.0,5,7,-2
GBR,ISR,2004.0,20,33,-13
BRA,BEL,2002.0,5,11,-6
DEU,COL,2009.0,11,7,4
CZE,AUS,2002.0,1,2,-1
IDN,GBR,2003.0,3,3,0
MYS,USA,2008.0,16,27,-11
AUS,KWT,2015.0,4,3,1
ARG,PER,2016.0,5,1,4
ARG,BRA,1997.0,7,3,4
CAF,FRA,2016.0,2,1,1
NOR,FRA,2000.0,8,5,3
DNK,KEN,2012.0,2,2,0
MEX,ARG,2001.0,3,4,-1
POL,SGP,2012.0,2,2,0
PHL,DEU,2015.0,5,6,-1
ECU,CAN,2016.0,3,3,0
HUN,SVN,2020.0,1,1,0
DEU,ARG,2003.0,12,22,-10
GBR,LUX,2012.0,11,1,10
FRA,MLI,2014.0,5,2,3
BWA,USA,2011.0,10,4,6
ESP,SVN,2015.0,3,2,1
COL,DEU,2011.0,11,11,0
MYS,JOR,2015.0,17,5,12
BEL,MYS,2009.0,2,3,-1
SAU,NZL,2016.0,3,2,1
IRQ,TUR,2018.0,2,9,-7
BRA,CZE,2016.0,3,4,-1
MEX,GTM,2011.0,5,2,3
USA,TUN,2015.0,3,7,-4
POL,HUN,2020.0,5,2,3
CHL,ITA,2018.0,10,20,-10
USA,COL,2000.0,6,12,-6
UZB,CZE,2010.0,1,1,0
GBR,NPL,2019.0,10,8,2
IRN,RUS,2020.0,10,4,6
IRL,NZL,2021.0,5,9,-4
CHN,NZL,2009.0,10,3,7
GBR,MDG,2022.0,5,1,4
ZAF,NLD,2022.0,11,4,7
JPN,HKG,1999.0,7,2,5
SGP,TUR,2017.0,2,8,-6
IRL,FRA,2008.0,17,32,-15
PER,BEL,2016.0,2,3,-1
JPN,TZA,2019.0,9,1,8
PRT,POL,2013.0,5,3,2
AUT,GRC,2009.0,4,5,-1
USA,EST,2003.0,5,2,3
KEN,BWA,1999.0,1,1,0
ZWE,SWE,2002.0,1,1,0
BEL,ISR,2006.0,2,2,0
SRB,ESP,2003.0,3,8,-5
RUS,SRB,2008.0,2,2,0
NZL,BEL,2012.0,2,3,-1
NLD,CHE,1997.0,4,6,-2
ROU,GBR,2002.0,10,7,3
GBR,MAR,2003.0,2,1,1
BFA,BEL,2020.0,4,5,-1
GBR,KWT,2003.0,7,4,3
ARE,TUN,2022.0,2,4,-2
SEN,CIV,2009.0,3,1,2
BRA,PRT,1999.0,4,4,0
NLD,CHE,1998.0,12,9,3
CAN,CHL,2003.0,6,4,2
SVN,BEL,2011.0,2,4,-2
NCL,AUS,2014.0,2,2,0
CHN,KOR,1998.0,3,1,2
EGY,SWE,2013.0,3,7,-4
CAN,KEN,2018.0,4,7,-3
RUS,IND,2009.0,3,1,2
USA,MLT,2017.0,1,1,0
NZL,AUT,2010.0,1,2,-1
CZE,CAN,2018.0,5,6,-1
FRA,GUY,2009.0,1,1,0
KEN,SEN,2019.0,1,1,0
SVK,AUT,2009.0,8,5,3
IRL,BEL,2009.0,4,4,0
CHN,PRK,2022.0,1,2,-1
CUB,USA,2002.0,4,3,1
JOR,GBR,2013.0,6,18,-12
POL,ESP,2007.0,6,3,3
MYS,SWE,2016.0,6,6,0
EGY,ITA,2012.0,5,5,0
NZL,AUT,2017.0,5,3,2
JPN,ZAF,2021.0,1,4,-3
LBN,ESP,2018.0,1,1,0
THA,MMR,2017.0,3,1,2
MAR,BFA,2016.0,2,1,1
NOR,IND,2018.0,4,18,-14
TUN,DEU,2017.0,6,3,3
CRI,BRA,2017.0,3,1,2
TZA,KEN,2006.0,2,2,0
ESP,IDN,2020.0,3,2,1
PHL,NZL,2020.0,1,2,-1
BGD,THA,2014.0,3,3,0
DEU,VEN,2008.0,3,4,-1
SVK,CHE,2015.0,5,4,1
DNK,PRT,2000.0,1,1,0
SRB,CHE,2001.0,3,3,0
DNK,ITA,2000.0,6,4,2
IND,NZL,2005.0,2,2,0
AUS,AUT,2001.0,8,7,1
SVK,GBR,2000.0,3,1,2
COG,GBR,2016.0,1,1,0
FIN,CHN,2013.0,18,22,-4
NGA,GMB,2018.0,4,1,3
DNK,POL,2010.0,4,15,-11
CMR,ZAF,2010.0,3,1,2
MEX,VEN,2014.0,5,8,-3
ARM,BEL,2017.0,1,1,0
DEU,BGD,2021.0,5,4,1
NOR,HUN,2003.0,3,2,1
DNK,MEX,2013.0,3,4,-1
BGD,PAK,2009.0,10,5,5
ARG,CAN,2005.0,13,11,2
AUS,CRI,2017.0,2,1,1
ITA,LUX,2021.0,8,5,3
HKG,CHE,2012.0,5,2,3
RUS,KOR,2000.0,2,2,0
FIN,ARG,2013.0,2,3,-1
BGR,GBR,1997.0,1,1,0
ZWE,NLD,2011.0,3,2,1
HUN,ZAF,2006.0,2,1,1
GBR,COL,2011.0,7,6,1
TWN,THA,2009.0,1,1,0
TZA,USA,2012.0,3,15,-12
CZE,POL,2009.0,1,4,-3
SAU,FIN,2019.0,3,1,2
JPN,AFG,2017.0,3,1,2
FIN,DNK,2004.0,5,8,-3
FRA,UKR,2006.0,5,7,-2
CYP,NOR,2016.0,1,1,0
DNK,VNM,2011.0,1,1,0
ETH,SAU,2020.0,2,3,-1
RWA,DEU,2014.0,1,1,0
ROU,NLD,2020.0,3,4,-1
AUT,PHL,2014.0,1,1,0
USA,MDG,2013.0,4,4,0
ZAF,CZE,2019.0,4,2,2
ECU,BEL,2020.0,6,4,2
UKR,EST,2019.0,4,2,2
HRV,ITA,2018.0,6,12,-6
ZAF,CHE,2006.0,6,5,1
TZA,NOR,2008.0,5,6,-1
CZE,GRC,2007.0,3,1,2
URY,AUS,2021.0,1,1,0
DNK,CZE,2020.0,7,3,4
IRL,BGR,2009.0,1,2,-1
USA,SLV,2012.0,1,1,0
BEL,SVN,2018.0,4,4,0
ESP,PRY,2014.0,1,3,-2
MLI,FRA,2005.0,1,5,-4
GHA,CHE,2003.0,1,2,-1
ROU,ISR,2021.0,2,2,0
NOR,ITA,2004.0,5,4,1
KOR,ISR,2018.0,4,7,-3
FIN,IRN,2007.0,2,4,-2
EGY,FRA,2004.0,3,2,1
HTI,FRA,2010.0,1,1,0
ARE,IRL,2017.0,1,2,-1
NGA,EGY,2019.0,3,1,2
ISR,CZE,2022.0,4,1,3
TUR,NZL,2016.0,3,1,2
CAN,PHL,2022.0,1,2,-1
BEL,HKG,2022.0,1,2,-1
TUR,MAR,2019.0,2,1,1
BEL,ARG,2019.0,5,3,2
JPN,AFG,2019.0,5,2,3
NLD,SAU,2018.0,10,6,4
PAN,DEU,2010.0,2,1,1
FRA,CAF,2018.0,1,4,-3
CMR,CHN,2016.0,1,3,-2
FIN,MEX,2022.0,2,4,-2
COG,FRA,2015.0,4,5,-1
FRA,MCO,2005.0,3,2,1
CZE,AUS,2005.0,2,4,-2
TZA,ZAF,2014.0,4,8,-4
BEN,FRA,2000.0,2,2,0
ARM,ITA,2003.0,1,1,0
MCO,FRA,1999.0,1,1,0
MUS,IND,2008.0,1,1,0
HUN,ROU,2000.0,2,3,-1
ISR,JPN,2000.0,2,1,1
DEU,PRI,2003.0,1,1,0
JPN,RUS,2022.0,3,6,-3
UKR,KOR,2003.0,4,1,3
BEN,BEL,2011.0,2,3,-1
IDN,CHE,2018.0,1,1,0
CHE,MWI,2018.0,2,3,-1
LUX,NOR,2018.0,2,1,1
BGD,BEL,2021.0,2,3,-1
EGY,ARE,2000.0,2,2,0
NZL,AUT,2019.0,6,6,0
NZL,NLD,2013.0,3,11,-8
ARE,CHN,2018.0,5,7,-2
QAT,TUR,2021.0,2,4,-2
ITA,KOR,2020.0,6,10,-4
QAT,SAU,2013.0,1,4,-3
PRY,ESP,2016.0,2,2,0
OMN,USA,2000.0,1,1,0
TUR,CYP,2005.0,4,3,1
RUS,MEX,2018.0,2,4,-2
CHE,CMR,2017.0,3,3,0
CHE,EGY,2015.0,4,1,3
MDA,USA,2013.0,2,1,1
AGO,PRT,2016.0,3,3,0
KWT,CHN,2019.0,1,1,0
TUR,AUT,1999.0,2,1,1
CAN,BFA,2007.0,1,1,0
UGA,NOR,2009.0,2,3,-1
NLD,GAB,2019.0,1,1,0
TUR,EGY,2014.0,2,1,1
NZL,GHA,2020.0,1,1,0
ISL,CHE,2015.0,1,3,-2
AUT,UKR,2002.0,1,7,-6
LBN,BEL,2020.0,7,9,-2
TZA,SWE,2005.0,1,1,0
ZAF,NAM,2010.0,1,3,-2
ZAF,KOR,2013.0,1,1,0
TWN,HRV,2011.0,1,1,0
VNM,TUR,2020.0,2,2,0
KEN,ZAF,2021.0,5,18,-13
MEX,KOR,2016.0,1,3,-2
ESP,KEN,2017.0,1,1,0
ROU,AUS,2013.0,1,3,-2
TWN,ESP,2016.0,3,5,-2
MOZ,PRT,2016.0,1,2,-1
GRC,SGP,2018.0,1,3,-2
ARE,USA,2001.0,2,6,-4
BTN,AUS,2015.0,2,1,1
MAR,SAU,2015.0,4,2,2
ITA,KAZ,2015.0,2,1,1
CHL,NOR,2014.0,1,1,0
CHL,AUS,2008.0,2,3,-1
NOR,CHE,1998.0,3,2,1
CZE,IRN,2020.0,1,21,-20
DEU,QAT,2019.0,3,6,-3
FRA,TGO,2021.0,3,2,1
SGP,TUR,2010.0,1,1,0
IRN,PAK,2017.0,2,1,1
CRI,BRA,2019.0,3,4,-1
SVK,CHN,2021.0,2,2,0
PAK,BGD,2019.0,10,6,4
SGP,NZL,2009.0,3,5,-2
IRL,IND,2001.0,1,3,-2
BGD,DNK,2020.0,2,3,-1
QAT,DZA,2018.0,1,1,0
HRV,CHE,2002.0,5,2,3
USA,PLW,2000.0,2,1,1
ARM,RUS,2014.0,4,4,0
ISL,USA,2000.0,1,3,-2
PHL,SGP,2000.0,2,1,1
BEL,UKR,1999.0,1,2,-1
HKG,THA,2008.0,1,1,0
BEN,TGO,2010.0,1,1,0
KOR,PRK,2018.0,1,1,0
SLV,USA,2016.0,1,2,-1
CHE,COL,2018.0,5,5,0
VEN,FRA,2020.0,1,3,-2
PSE,MAR,2020.0,1,1,0
USA,BGR,1999.0,4,16,-12
MAR,DEU,2001.0,3,2,1
CAN,NGA,2014.0,2,5,-3
ARE,IRL,2019.0,1,4,-3
ROU,RUS,2020.0,1,3,-2
NLD,UKR,1999.0,2,2,0
NAM,NLD,2019.0,1,1,0
USA,PNG,2002.0,2,2,0
USA,GMB,2015.0,3,1,2
BRA,HKG,2019.0,1,2,-1
SDN,DNK,2001.0,1,1,0
IRN,FIN,2004.0,1,1,0
LBY,GBR,2001.0,1,1,0
CHE,PHL,2018.0,2,2,0
AUT,ALB,2020.0,1,2,-1
QAT,NLD,2021.0,1,1,0
MDA,DEU,2018.0,2,3,-1
HKG,BEL,2014.0,1,1,0
TUR,RUS,1999.0,1,2,-1
BHR,IND,2007.0,1,1,0
JOR,FRA,2019.0,1,2,-1
HKG,ZAF,2021.0,1,4,-3
HRV,NLD,2001.0,1,1,0
ISL,IRN,2020.0,1,4,-3
PER,CHE,2021.0,1,4,-3
PAK,BGD,2010.0,2,9,-7
ISR,SWE,1999.0,1,1,0
SDN,DEU,2014.0,1,3,-2
NLD,MOZ,2019.0,2,1,1
CHE,CMR,2019.0,2,4,-2
BEL,ARG,2017.0,2,2,0
SRB,MKD,2001.0,1,1,0
USA,UZB,2005.0,4,1,3
CHE,LVA,2014.0,1,2,-1
NOR,ZAF,2003.0,2,1,1
GHA,ZAF,2007.0,1,3,-2
PRT,DNK,2005.0,2,2,0
TUN,DEU,2010.0,1,2,-1
PHL,KOR,2009.0,2,3,-1
BEL,NGA,2016.0,1,2,-1
CMR,BEL,2014.0,1,5,-4
CAN,DZA,2021.0,1,3,-2
PAN,CHE,2016.0,1,1,0
FIN,KWT,2003.0,1,2,-1
GBR,PHL,2008.0,2,1,1
AUS,IRL,2000.0,3,5,-2
VNM,BEL,2009.0,2,1,1
SAU,RWA,2017.0,1,1,0
AUT,COL,2005.0,1,1,0
DEU,MAR,2011.0,1,2,-1
PRT,ROU,2018.0,2,1,1
IRN,IND,2020.0,2,9,-7
ITA,SRB,2002.0,1,8,-7
NPL,IND,2001.0,2,6,-4
IND,ROU,2005.0,1,1,0
TUN,BEL,2009.0,1,4,-3
AUT,SRB,2008.0,1,4,-3
DEU,CMR,2009.0,1,4,-3
GRC,ROU,2001.0,1,2,-1
ESP,HND,2018.0,2,2,0
NGA,THA,2020.0,1,5,-4
THA,AUT,2009.0,2,7,-5
FRA,CRI,2011.0,1,1,0
SLE,GBR,2014.0,1,3,-2
ARM,GBR,2007.0,1,1,0
MEX,BGD,2019.0,1,1,0
NLD,HKG,2009.0,1,4,-3
IRN,SAU,2014.0,1,1,0
LUX,PRT,2020.0,1,1,0
LBY,MYS,2015.0,1,6,-5
BGD,OMN,2022.0,1,1,0
JOR,SYR,2018.0,1,1,0
SGP,KHM,2015.0,1,1,0
SAU,SYR,2013.0,2,2,0
VNM,SAU,2019.0,1,1,0
SSD,SDN,2020.0,1,1,0
BLR,AUS,2016.0,1,1,0
SVK,FIN,2015.0,1,2,-1
IDN,SAU,2021.0,1,3,-2
LUX,ESP,2022.0,1,3,-2
AUT,LUX,2021.0,2,3,-1
IND,SVK,2022.0,1,1,0
MKD,AUS,2014.0,1,1,0
PAK,AFG,2016.0,1,2,-1
IRN,ARE,2014.0,2,1,1
PAK,THA,2018.0,1,13,-12
NGA,UGA,2022.0,1,2,-1
TZA,NLD,2011.0,1,2,-1
USA,DZA,1999.0,1,2,-1
BGR,GBR,1998.0,1,1,0
AUS,ZWE,2008.0,1,1,0
SGP,ZAF,2011.0,1,2,-1
BWA,IND,2020.0,1,4,-3
CRI,NLD,2013.0,1,1,0
BRA,VEN,2002.0,1,4,-3
GBR,SEN,2021.0,1,1,0
GRC,ZAF,2012.0,1,1,0
UKR,CHE,2009.0,2,1,1
SGP,POL,2015.0,1,2,-1
VNM,CAN,2012.0,1,3,-2
IND,CZE,2005.0,1,1,0
EGY,QAT,2002.0,2,4,-2
GBR,KNA,2017.0,2,2,0
PRT,ISL,2019.0,1,3,-2
HTI,FRA,2017.0,1,2,-1
BGD,NLD,2009.0,2,2,0
ARE,PAK,2007.0,1,1,0
TWN,JPN,1999.0,1,8,-7
HKG,GHA,2022.0,1,2,-1
GEO,ITA,2007.0,1,1,0
BDI,BEL,2017.0,1,1,0
HUN,SRB,2018.0,1,6,-5
ZWE,LSO,2015.0,1,1,0
LBY,USA,2020.0,1,4,-3
HKG,BRN,2015.0,1,1,0
VEN,ITA,2015.0,1,2,-1
CAN,GBR,2014.0,351,364,-13
CYP,PRT,2020.0,1,1,0
FIN,ESP,2021.0,17,14,3
ISR,GBR,2004.0,33,20,13
NLD,FRA,2004.0,68,76,-8
HKG,GBR,2010.0,42,36,6
AUS,HKG,2010.0,35,40,-5
GBR,NZL,2006.0,142,78,64
ESP,PRT,2019.0,107,103,4
PAK,PHL,2012.0,1,1,0
KWT,MYS,2016.0,1,2,-1
USA,SGP,2013.0,243,189,54
ARE,QAT,2008.0,2,1,1
CAN,OMN,2011.0,13,1,12
GBR,ARG,2018.0,14,13,1
CHN,HKG,2014.0,361,472,-111
SGP,DNK,2019.0,9,4,5
GBR,LKA,2017.0,17,10,7
DNK,USA,2006.0,76,88,-12
USA,TUR,2002.0,180,125,55
ESP,PRT,2017.0,96,93,3
FIN,CZE,2015.0,6,3,3
NZL,CHN,2013.0,19,11,8
ZAF,MWI,2016.0,4,6,-2
NOR,SWE,2020.0,49,68,-19
NOR,AUT,2022.0,8,3,5
POL,FRA,2020.0,24,26,-2
DNK,BEL,2014.0,9,15,-6
ITA,GRC,2017.0,25,24,1
PHL,NOR,2021.0,1,1,0
TWN,PHL,2012.0,2,1,1
NLD,BEL,2013.0,136,117,19
TUR,DEU,2011.0,39,28,11
FRA,CMR,2009.0,12,12,0
NOR,CAN,2010.0,7,16,-9
DEU,IND,2008.0,56,95,-39
IRL,TUR,2021.0,3,6,-3
ZAF,TWN,2013.0,7,1,6
BGR,USA,2019.0,9,7,2
SVK,DEU,2017.0,6,14,-8
NOR,NLD,2001.0,7,5,2
RUS,USA,1998.0,152,37,115
NZL,IRN,2015.0,3,9,-6
ESP,PAK,2018.0,3,2,1
SVK,DEU,2019.0,7,5,2
GBR,IRQ,2022.0,13,8,5
SGP,TWN,2022.0,8,4,4
CHE,ZAF,2018.0,8,13,-5
CZE,NOR,2011.0,6,1,5
JPN,NPL,2015.0,7,2,5
PER,COL,2020.0,6,8,-2
NLD,MEX,2004.0,3,4,-1
SWE,COL,2003.0,2,1,1
DNK,NOR,2001.0,5,23,-18
CAN,NLD,2008.0,40,42,-2
ARE,SWE,2008.0,1,2,-1
ZMB,USA,2005.0,2,5,-3
DZA,DEU,2015.0,2,2,0
MLI,FRA,2002.0,3,1,2
AUS,ARG,2003.0,3,8,-5
SRB,USA,2003.0,14,11,3
HUN,GBR,2003.0,24,24,0
FIN,AUS,2001.0,3,3,0
CHE,CMR,2010.0,4,2,2
GBR,NPL,2017.0,4,10,-6
HKG,SGP,2006.0,20,12,8
ITA,POL,2015.0,20,32,-12
DNK,POL,2017.0,6,12,-6
PHL,JPN,2020.0,14,23,-9
FIN,POL,2021.0,8,6,2
CZE,ISR,2003.0,1,3,-2
CAN,NZL,2004.0,19,27,-8
GHA,SWE,2014.0,2,1,1
QAT,GBR,2016.0,13,53,-40
ESP,MAR,2005.0,3,5,-2
HKG,KOR,2008.0,7,2,5
ISR,NOR,2011.0,1,2,-1
SVN,PRT,2016.0,2,1,1
GBR,PER,2022.0,6,4,2
MKD,SRB,2020.0,3,5,-2
TUR,DNK,2017.0,5,5,0
PRT,RUS,2006.0,8,10,-2
MDG,GBR,2019.0,4,4,0
AUT,BFA,2015.0,1,1,0
SGP,ARE,2016.0,4,1,3
BGR,PRT,2011.0,2,2,0
JPN,BRA,1999.0,4,1,3
BGR,USA,2017.0,7,7,0
GRC,BRA,2016.0,1,2,-1
BRA,VEN,2005.0,3,4,-1
OMN,BHR,2016.0,1,1,0
EGY,TUR,2021.0,2,7,-5
BFA,FRA,2001.0,4,1,3
SGP,BRA,2020.0,2,1,1
NLD,SVN,2021.0,3,1,2
IRN,KOR,2007.0,2,2,0
UGA,ZAF,2020.0,3,10,-7
ITA,ZAF,2002.0,2,1,1
ZAF,ZMB,2013.0,2,2,0
GBR,EGY,1999.0,2,1,1
ZWE,SWE,2005.0,2,2,0
ECU,PER,2008.0,1,2,-1
NLD,ETH,2011.0,1,3,-2
BEL,SEN,2014.0,1,1,0
HUN,CHE,2000.0,5,2,3
CHN,ZMB,2020.0,4,3,1
GBR,LKA,2010.0,4,13,-9
GBR,GEO,2011.0,1,3,-2
PRT,IND,2009.0,6,13,-7
POL,KOR,2021.0,3,3,0
DZA,ESP,2015.0,1,2,-1
FIN,COL,2018.0,4,2,2
TUR,GRC,2018.0,3,5,-2
NZL,HKG,2009.0,2,2,0
AUT,KOR,2021.0,3,3,0
FIN,HUN,2011.0,1,5,-4
IDN,FRA,2009.0,1,5,-4
VNM,NOR,2021.0,3,1,2
LAO,USA,2016.0,2,2,0
GRC,SVN,2015.0,1,1,0
IND,KEN,2014.0,4,1,3
AFG,FRA,2017.0,1,3,-2
SGP,DNK,2010.0,3,2,1
AUT,ISR,2008.0,4,2,2
CHL,JPN,2011.0,2,3,-1
CHL,PRT,2013.0,2,3,-1
TWN,ISR,2020.0,2,2,0
QAT,LBN,2020.0,1,2,-1
MDG,CAF,2008.0,1,2,-1
CHN,MEX,2015.0,1,3,-2
SWE,LKA,2021.0,1,1,0
SWE,BOL,2018.0,3,2,1
ROU,GRC,2001.0,2,1,1
BEL,CIV,2020.0,1,1,0
AZE,USA,2022.0,1,1,0
FLK,GBR,2020.0,1,2,-1
ESP,KEN,2019.0,2,3,-1
DEU,ZWE,2020.0,1,2,-1
NER,BEL,2015.0,1,3,-2
GRC,TWN,2015.0,1,2,-1
CHE,BFA,2017.0,1,2,-1
PAK,NLD,2018.0,1,14,-13
BGD,IDN,2010.0,1,1,0
BRA,AGO,2016.0,1,1,0
IND,SYR,2018.0,1,4,-3
ESP,MYS,2012.0,1,3,-2
AUT,SGP,2021.0,1,4,-3
ITA,,2010.0,6198,0,6198
,TUR,2007.0,6902,0,6902
FRA,,2008.0,6474,0,6474
JPN,,2024.0,127733,0,127733
,CHN,2006.0,79757,0,79757
,AUT,2004.0,2083,0,2083
ITA,,2017.0,10270,0,10270
ISR,,2022.0,4905,0,4905
,THA,1998.0,1354,0,1354
IRL,,2022.0,2881,0,2881
,DNK,1994.0,1661,0,1661
ITA,,2019.0,12591,0,12591
NOR,,2009.0,695,0,695
THA,,2013.0,849,0,849
GBR,,2007.0,8278,0,8278
NZL,,2011.0,629,0,629
CAN,,2006.0,3325,0,3325
,RUS,2010.0,8486,0,8486
GRD,POL,2011.0,1,0,1
JPN,CMR,2012.0,2,0,2
COL,,2020.0,1943,0,1943
ARG,,2014.0,1201,0,1201
,NGA,2003.0,937,0,937
YEM,,2022.0,91,0,91
UKR,,2013.0,811,0,811
SRB,,2020.0,1290,0,1290
MYS,BRN,2006.0,2,0,2
,CMR,2003.0,200,0,200
,KWT,2007.0,149,0,149
AUS,,1999.0,105,0,105
,RUS,2017.0,14497,0,14497
,GEO,2005.0,126,0,126
,CZE,2013.0,2906,0,2906
NGA,,2012.0,564,0,564
BFA,,2020.0,117,0,117
RUS,,2007.0,3366,0,3366
CHN,LAO,2011.0,1,0,1
,SVK,2010.0,944,0,944
,LKA,2009.0,201,0,201
,LBN,2001.0,204,0,204
POL,,2007.0,1506,0,1506
,RUS,2019.0,4760,0,4760
,BLR,1995.0,412,0,412
IND,BWA,2004.0,2,0,2
UGA,,2011.0,47,0,47
POL,DNK,2022.0,3,0,3
,AUT,1996.0,1043,0,1043
MYS,,2015.0,1283,0,1283
KOR,,2006.0,2884,0,2884
CIV,,2024.0,540,0,540
PSE,,2017.0,50,0,50
,SAU,1995.0,308,0,308
JAM,,2007.0,21,0,21
BLR,,2011.0,182,0,182
NIC,CRI,2008.0,1,0,1
,DOM,2010.0,21,0,21
LBY,,2021.0,76,0,76
,LVA,2014.0,229,0,229
,NZL,2008.0,1510,0,1510
GNB,,2020.0,3,0,3
,PSE,2011.0,68,0,68
,MUS,2011.0,23,0,23
TGO,,2020.0,54,0,54
,SDN,2007.0,129,0,129
,BOL,2012.0,47,0,47
,PER,2016.0,718,0,718
KOR,NLD,2001.0,3,0,3
,PRI,2016.0,126,0,126
MTQ,,2021.0,7,0,7
,SVK,2019.0,364,0,364
USA,LAO,2022.0,2,0,2
CHN,PSE,2019.0,1,0,1
,ARE,2016.0,590,0,590
MMR,,2020.0,49,0,49
,MNE,2013.0,55,0,55
,IRQ,2003.0,49,0,49
BEN,CMR,2009.0,2,0,2
,SVK,2017.0,882,0,882
ESP,AND,2021.0,6,0,6
,SLE,2000.0,4,0,4
,MTQ,2015.0,11,0,11
,TZA,2001.0,101,0,101
,BWA,2015.0,108,0,108
IDN,PSE,2019.0,2,0,2
IND,PER,2022.0,1,0,1
JPN,NCL,2017.0,1,0,1
NCL,JPN,2021.0,1,0,1
,DOM,2017.0,24,0,24
,VEN,2007.0,627,0,627
TUR,,2006.0,815,0,815
PRI,CHN,2014.0,2,0,2
,ATG,2017.0,1,0,1
MYS,CHE,2018.0,6,0,6
PYF,,2014.0,9,0,9
,SEN,2000.0,117,0,117
,GEO,2002.0,89,0,89
ISL,CAN,2005.0,4,0,4
COG,,2015.0,50,0,50
TUR,OMN,2005.0,2,0,2
MLT,BGR,2019.0,1,0,1
BHR,OMN,2015.0,1,0,1
LBY,GRC,2010.0,1,0,1
MDG,GBR,2017.0,1,0,1
BMU,,2022.0,7,0,7
SVK,LBY,2019.0,1,0,1
FJI,,2016.0,11,0,11
,JAM,2003.0,45,0,45
BIH,,2006.0,19,0,19
ZAF,ARE,2020.0,5,0,5
VEN,,2001.0,16,0,16
PAN,,2005.0,5,0,5
,PAN,2002.0,28,0,28
BEL,MOZ,2022.0,2,0,2
,PRY,2013.0,36,0,36
,MRT,2015.0,8,0,8
CAN,MWI,2020.0,1,0,1
NLD,SUR,2015.0,5,0,5
FRA,UGA,2021.0,2,0,2
COL,GTM,2021.0,3,0,3
,NER,2018.0,16,0,16
USA,GIN,2022.0,1,0,1
SDN,GBR,2022.0,2,0,2
,THA,1997.0,293,0,293
EGY,IRQ,2016.0,9,0,9
FLK,,2024.0,8,0,8
PSE,,2019.0,76,0,76
,ARM,2001.0,118,0,118
MOZ,,2013.0,12,0,12
MAR,GAB,2005.0,1,0,1
,MOZ,2007.0,28,0,28
MEX,,2025.0,55,0,55
ISR,IRN,2007.0,1,0,1
,ALB,1999.0,11,0,11
CUB,AUS,2008.0,1,0,1
,AZE,1997.0,39,0,39
TTO,SUR,2014.0,1,0,1
CAN,MNG,2009.0,1,0,1
BOL,,2013.0,30,0,30
,MNG,1998.0,22,0,22
,AZE,1998.0,78,0,78
GMB,SLE,2016.0,1,0,1
MKD,ALB,2020.0,2,0,2
ITA,IRL,1999.0,4,0,4
DZA,YEM,2000.0,1,0,1
,NIC,2000.0,9,0,9
OMN,,2004.0,21,0,21
UKR,AUT,2021.0,5,0,5
IRN,QAT,2009.0,1,0,1
SEN,,1999.0,3,0,3
CMR,BFA,2003.0,2,0,2
TZA,SWZ,1997.0,1,0,1
,SLB,1999.0,4,0,4
ESP,LTU,2022.0,1,0,1
PRI,,2004.0,15,0,15
LTU,NLD,1999.0,1,0,1
IDN,RUS,2004.0,1,0,1
CHE,GRC,1999.0,6,0,6
SVN,BIH,2013.0,1,0,1
MKD,CZE,2021.0,1,0,1
ZAF,CIV,2001.0,2,0,2
JPN,SAU,2004.0,1,0,1
IRQ,LBN,2019.0,2,0,2
,MNG,1997.0,3,0,3
JPN,CHL,2004.0,2,0,2
VUT,AUS,2012.0,1,0,1
IND,CZE,2002.0,2,0,2
JPN,GRC,1999.0,1,0,1
OMN,ZAF,2015.0,1,0,1
GUM,USA,2000.0,3,0,3
VNM,PHL,2007.0,1,0,1
CIV,SEN,2008.0,8,0,8
ROU,DNK,2015.0,3,0,3
ITA,SRB,2005.0,4,0,4
BLR,PRT,2006.0,3,0,3
HRV,CHN,2012.0,1,0,1
TTO,AUS,2009.0,3,0,3
BHR,,2016.0,37,0,37
TON,,2008.0,1,0,1
KAZ,,1999.0,4,0,4
ARG,HUN,2003.0,2,0,2
PSE,ARE,2015.0,2,0,2
RWA,ZMB,2016.0,1,0,1
GRC,LUX,2004.0,1,0,1
SDN,OMN,2013.0,1,0,1
AUS,MDV,2016.0,2,0,2
JAM,BRB,2008.0,1,0,1
ESP,HRV,2015.0,3,0,3
BRN,PHL,2006.0,1,0,1
VEN,NLD,2008.0,3,0,3
IND,VNM,2017.0,4,0,4
IND,GAB,2018.0,1,0,1
VNM,PAK,2021.0,7,0,7
SVN,CHL,2014.0,1,0,1
THA,PRT,2014.0,1,0,1
JPN,KWT,2018.0,1,0,1
ZAF,CZE,2017.0,1,0,1
,NCL,2011.0,13,0,13
DEU,NPL,2015.0,4,0,4
DNK,LKA,2016.0,2,0,2
COD,NGA,2022.0,1,0,1
ESP,TZA,2013.0,1,0,1
CYP,TUR,1999.0,1,0,1
GUF,,2020.0,13,0,13
KEN,FJI,2019.0,1,0,1
USA,SOM,2018.0,4,0,4
ABW,,2022.0,6,0,6
PHL,KEN,2014.0,2,0,2
SWE,MKD,2005.0,1,0,1
,LBY,1998.0,17,0,17
PSE,,2010.0,13,0,13
PNG,BWA,2000.0,1,0,1
GNB,GHA,2016.0,2,0,2
CUB,NLD,2000.0,1,0,1
POL,PRT,2008.0,2,0,2
SVK,GRC,2020.0,2,0,2
BLR,DNK,2001.0,1,0,1
VNM,,1999.0,4,0,4
,PAN,2005.0,28,0,28
GAB,NLD,2013.0,1,0,1
DEU,BEN,2008.0,2,0,2
YEM,CAN,2019.0,1,0,1
UGA,ISR,2015.0,1,0,1
TUR,CRI,2018.0,1,0,1
UZB,CHN,2016.0,2,0,2
SAU,FIN,2017.0,2,0,2
,GMB,2007.0,18,0,18
CUB,CHE,2014.0,5,0,5
TZA,NZL,2018.0,1,0,1
MAR,MRT,2018.0,2,0,2
GBR,SLE,2022.0,1,0,1
BLR,DEU,2020.0,5,0,5
NLD,BRN,2007.0,1,0,1
GBR,SOM,2020.0,3,0,3
,IND,2020.0,43,0,43
,DOM,2019.0,20,0,20
GRC,FIN,2022.0,2,0,2
GIB,,2023.0,11,0,11
DNK,KOR,1998.0,1,0,1
,LSO,1999.0,4,0,4
CAN,NER,2008.0,1,0,1
DNK,EST,2021.0,4,0,4
IND,KWT,2010.0,4,0,4
LAO,PHL,2014.0,1,0,1
TUN,DZA,2011.0,2,0,2
MKD,BGR,2005.0,2,0,2
ARE,HUN,2022.0,2,0,2
CHE,DZA,2002.0,1,0,1
RUS,SVN,2022.0,1,0,1
FJI,GBR,2003.0,2,0,2
GHA,,2004.0,11,0,11
LBN,SWE,2009.0,1,0,1
PNG,SWZ,2002.0,1,0,1
ZAF,BGR,2006.0,1,0,1
TJK,,2003.0,5,0,5
FSM,,2023.0,3,0,3
NZL,GMB,2002.0,1,0,1
IRQ,IND,2008.0,1,0,1
DEU,MNE,2010.0,1,0,1
IRN,KAZ,2021.0,5,0,5
JAM,IRL,2004.0,1,0,1
VEN,URY,2016.0,1,0,1
,HTI,2006.0,8,0,8
GBR,KNA,2019.0,1,0,1
FRA,LUX,2004.0,17,0,17
TUR,LBY,2017.0,1,0,1
ECU,PRT,2021.0,3,0,3
,TLS,2018.0,7,0,7
NGA,ESP,2021.0,1,0,1
CMR,DEU,2001.0,1,0,1
HUN,ARE,2013.0,4,0,4
UKR,CYP,2010.0,1,0,1
MRT,,2007.0,1,0,1
GUF,SEN,2014.0,1,0,1
MEX,NZL,2002.0,1,0,1
CHE,NZL,1998.0,1,0,1
NGA,IRL,2012.0,2,0,2
CZE,SAU,2014.0,1,0,1
MWI,AUS,2009.0,2,0,2
NLD,SEN,2009.0,1,0,1
ARE,MYS,2010.0,1,0,1
LBN,BHR,2011.0,1,0,1
CZE,SVN,2012.0,1,0,1
UKR,NLD,2014.0,4,0,4
GAB,JPN,2014.0,1,0,1
BHR,ARE,2015.0,2,0,2
NLD,ARE,2016.0,6,0,6
AFG,AUS,2015.0,2,0,2
TUR,SDN,2016.0,3,0,3
IRN,,2000.0,2,0,2
EGY,PHL,2018.0,2,0,2
MAR,POL,2011.0,1,0,1
CUB,CHL,2022.0,2,0,2
GBR,GUY,2009.0,2,0,2
SWE,LAO,2014.0,2,0,2
ARE,ARG,2010.0,3,0,3
UGA,AUS,2015.0,2,0,2
LBN,QAT,2009.0,1,0,1
UKR,TUN,2001.0,1,0,1
PER,CAN,2004.0,1,0,1
USA,MLT,2010.0,1,0,1
QAT,BHR,2005.0,1,0,1
CRI,ESP,1999.0,1,0,1
SVK,KOR,2006.0,1,0,1
AUT,MEX,2004.0,1,0,1
DNK,KNA,2016.0,1,0,1
FRA,BLR,2013.0,1,0,1
JAM,NOR,2010.0,1,0,1
CAN,BGR,2015.0,2,0,2
TZA,SWE,2002.0,1,0,1
BGD,SAU,2006.0,2,0,2
ARG,SGP,2014.0,1,0,1
CHN,KOR,1997.0,3,0,3
KOR,PER,2020.0,1,0,1
SEN,CAN,2006.0,2,0,2
AUT,ISL,2014.0,2,0,2
KOR,OMN,2014.0,1,0,1
MYS,KAZ,2015.0,2,0,2
ARG,TUN,2012.0,1,0,1
GMB,KEN,2019.0,1,0,1
SRB,JPN,2014.0,1,0,1
KOR,KAZ,2013.0,2,0,2
,BTN,2007.0,4,0,4
BEL,BHS,2003.0,1,0,1
BIH,MKD,2018.0,1,0,1
SVN,SWE,2012.0,2,0,2
MEX,KEN,2011.0,2,0,2
,BHS,2007.0,1,0,1
LTU,NOR,2022.0,2,0,2
TCA,,2022.0,5,0,5
ARE,ARG,2019.0,1,0,1
HKG,SAU,2001.0,1,0,1
TUR,TUN,2017.0,1,0,1
IDN,BRA,2007.0,1,0,1
NOR,BLR,2007.0,1,0,1
FRA,GIN,1999.0,1,0,1
BMU,GBR,2003.0,1,0,1
VEN,OMN,2001.0,1,0,1
,PRK,2007.0,7,0,7
JOR,PSE,2016.0,3,0,3
KHM,ITA,2004.0,1,0,1
EST,AUS,2002.0,1,0,1
PRT,SRB,2011.0,1,0,1
PAK,CHE,2000.0,2,0,2
IRQ,ARE,2009.0,4,0,4
NOR,MNE,2009.0,1,0,1
GRL,,2013.0,4,0,4
AUS,BWA,2007.0,1,0,1
FJI,PRT,2014.0,1,0,1
IRN,ISL,2012.0,1,0,1
BOL,COL,2011.0,1,0,1
,LBR,2013.0,16,0,16
BEL,MCO,2014.0,1,0,1
GBR,MCO,2014.0,1,0,1
PNG,THA,2018.0,1,0,1
MRT,MLI,2021.0,2,0,2
SWE,BWA,2020.0,1,0,1
KEN,HUN,2020.0,1,0,1
PRT,MKD,2020.0,1,0,1
UZB,IND,2000.0,1,0,1
MUS,CHE,2020.0,3,0,3
DEU,FRO,2015.0,2,0,2
KEN,KHM,2016.0,1,0,1
KWT,HUN,2015.0,1,0,1
ZMB,ITA,2019.0,2,0,2
BEL,DZA,2021.0,1,0,1
TWN,KEN,2015.0,2,0,2
ZAF,PHL,2014.0,1,0,1
BGD,CHE,1999.0,1,0,1
DEU,QAT,2017.0,7,0,7
ZAF,ETH,2000.0,2,0,2
CMR,COG,2012.0,1,0,1
UZB,MYS,2011.0,4,0,4
DEU,MMR,2013.0,1,0,1
AFG,ITA,2005.0,1,0,1
GMB,CAN,2014.0,1,0,1
JPN,SRB,2012.0,2,0,2
BOL,DNK,2012.0,1,0,1
CMR,MAR,2018.0,1,0,1
NLD,ABW,2021.0,1,0,1
NCL,FJI,2021.0,1,0,1
AUS,LTU,2021.0,1,0,1
HKG,LKA,2004.0,2,0,2
GBR,PSE,2022.0,3,0,3
IND,BMU,2013.0,1,0,1
MYS,TZA,2018.0,3,0,3
ZAF,FJI,2013.0,1,0,1
TWN,LTU,2013.0,1,0,1
BLR,MDA,2016.0,1,0,1
TUN,SAU,2001.0,1,0,1
LSO,SWZ,2017.0,1,0,1
MLI,COG,2013.0,1,0,1
IND,ZWE,2011.0,1,0,1
MLT,SWE,2010.0,1,0,1
IND,GUY,1999.0,1,0,1
USA,YEM,2003.0,1,0,1
RUS,IRL,1998.0,1,0,1
MAC,,2008.0,6,0,6
SLB,CAN,2002.0,1,0,1
ZWE,MYS,2019.0,1,0,1
ARM,GRC,2013.0,1,0,1
SRB,AUT,2006.0,1,0,1
UZB,USA,2009.0,1,0,1
ZAF,OMN,2004.0,1,0,1
SRB,QAT,2021.0,1,0,1
SWE,GRC,2000.0,1,0,1
BIH,DEU,2020.0,2,0,2
SWE,SWZ,2020.0,1,0,1
JOR,IRQ,2022.0,1,0,1
ZAF,CZE,2010.0,1,0,1
CAN,BDI,2016.0,1,0,1
SVN,CMR,2017.0,1,0,1
PAK,GMB,2022.0,1,0,1
TUR,MAR,2017.0,1,0,1
SAU,BEL,2003.0,1,0,1
PSE,MOZ,2022.0,1,0,1
LBY,UKR,2021.0,1,0,1
MLI,,2006.0,2,0,2
BEL,GUM,2009.0,1,0,1
KGZ,FRA,2005.0,1,0,1
MMR,FRA,2015.0,2,0,2
CHN,GUM,2008.0,1,0,1
NOR,EST,2007.0,1,0,1
SRB,FIN,2020.0,1,0,1
NOR,BGD,2022.0,2,0,2
PAK,CYP,2022.0,1,0,1
BWA,KEN,2009.0,2,0,2
BEN,ETH,2014.0,1,0,1
VEN,PRT,2009.0,1,0,1
RUS,TWN,1998.0,1,0,1
ESP,MAR,2002.0,5,0,5
MEX,AUT,2022.0,4,0,4
UGA,KOR,2007.0,1,0,1
MYS,IDN,2000.0,1,0,1
ETH,SWZ,2020.0,1,0,1
TKM,RUS,2002.0,1,0,1
ISR,NLD,1998.0,1,0,1
SEN,AGO,2015.0,1,0,1
OMN,NZL,2010.0,1,0,1
IDN,VEN,2018.0,1,0,1
CZE,IDN,2013.0,1,0,1
GAB,KHM,2018.0,1,0,1
AUT,TZA,2011.0,1,0,1
SEN,GAB,2016.0,1,0,1
OMN,TUN,2012.0,2,0,2
ITA,GUF,2017.0,1,0,1
NGA,EGY,2010.0,3,0,3
UKR,MAR,2011.0,1,0,1
DJI,,2008.0,1,0,1
PRT,PHL,2016.0,1,0,1
MYS,MDV,2020.0,3,0,3
EST,IDN,2020.0,1,0,1
NGA,JPN,2022.0,5,0,5
GMB,UGA,2006.0,1,0,1
CHL,IRL,2005.0,2,0,2
MYS,MEX,2019.0,1,0,1
EST,ITA,2007.0,2,0,2
,MAC,1994.0,2,0,2
BFA,KEN,2015.0,1,0,1
GHA,HUN,2020.0,1,0,1
LAO,KHM,2008.0,1,0,1
ERI,ETH,2019.0,1,0,1
USA,LBY,2006.0,1,0,1
IND,SDN,2003.0,1,0,1
ISR,MLI,2018.0,1,0,1
UGA,TZA,2011.0,2,0,2
ESP,PSE,2018.0,3,0,3
EGY,HUN,2015.0,3,0,3
GRC,SRB,2016.0,2,0,2
NLD,CMR,2022.0,1,0,1
SWE,RWA,2014.0,1,0,1
CIV,NGA,2012.0,1,0,1
EGY,PNG,2022.0,1,0,1
NGA,BGD,2022.0,1,0,1
VEN,ISR,2018.0,1,0,1
,ATG,2010.0,1,0,1
DNK,MDA,2018.0,1,0,1
LBY,IRQ,2016.0,2,0,2
SEN,COG,2005.0,1,0,1
CHE,LUX,2001.0,1,0,1
ITA,PNG,2002.0,1,0,1
BLR,UKR,1997.0,1,0,1
NOR,SVN,2001.0,1,0,1
GMB,MLI,2011.0,1,0,1
NZL,ZWE,2005.0,1,0,1
COL,ROU,2009.0,1,0,1
ISR,ETH,2005.0,1,0,1
IND,PAN,2013.0,1,0,1
DEU,MLI,2001.0,1,0,1
SGP,HUN,2014.0,1,0,1
IND,ERI,1998.0,1,0,1
ROU,SVN,2013.0,1,0,1
CHE,BFA,2010.0,1,0,1
NLD,GAB,2017.0,2,0,2
BRA,HKG,2017.0,1,0,1
LUX,IRL,2022.0,1,0,1
SDN,JPN,2022.0,2,0,2
HUN,CHL,2012.0,1,0,1
HKG,ISR,2013.0,3,0,3
MWI,CAN,2021.0,1,0,1
IRL,MEX,2008.0,1,0,1
CYP,IRL,2013.0,1,0,1
MYS,MMR,2016.0,1,0,1
SOM,,2012.0,1,0,1
HKG,NPL,2003.0,1,0,1
MDA,GBR,2009.0,1,0,1
ERI,,2001.0,1,0,1
HTI,ZAF,2001.0,2,0,2
USA,PNG,2005.0,4,0,4
TTO,SAU,2015.0,1,0,1
DEU,PYF,2013.0,1,0,1
CAF,MDG,2005.0,1,0,1
HUN,MKD,2016.0,1,0,1
KWT,CHN,2017.0,1,0,1
ITA,ECU,2011.0,1,0,1
NLD,MOZ,2017.0,1,0,1
PNG,CZE,2018.0,2,0,2
AFG,IRQ,2022.0,2,0,2
LUX,NLD,2022.0,2,0,2
JPN,QAT,2016.0,2,0,2
GEO,AUS,2008.0,1,0,1
PAN,IRN,2022.0,1,0,1
MAR,MLI,2015.0,2,0,2
DEU,MNG,2014.0,1,0,1
ESP,KHM,2018.0,1,0,1
JPN,PSE,2011.0,4,0,4
CAN,GIN,2015.0,1,0,1
ARE,VNM,2019.0,1,0,1
UZB,CZE,2017.0,1,0,1
PNG,GHA,2004.0,1,0,1
AUT,MAR,2006.0,1,0,1
DNK,EGY,2022.0,1,0,1
SGP,MEX,2006.0,1,0,1
COG,AUS,2007.0,1,0,1
YEM,CHN,2008.0,1,0,1
BLR,SRB,2010.0,1,0,1
USA,MLT,2019.0,1,0,1
,GLP,2013.0,3,0,3
MEX,HUN,2022.0,1,0,1
ITA,IRN,1998.0,2,0,2
NOR,UGA,2022.0,1,0,1
GTM,BRA,2021.0,1,0,1
ARM,POL,2007.0,1,0,1
GBR,KAZ,2003.0,2,0,2
EGY,UKR,1998.0,1,0,1
BGD,BGR,2009.0,1,0,1
POL,VNM,2011.0,1,0,1
MNG,RUS,2018.0,1,0,1
,ESP,2020.0,1,0,1
DEU,ARE,2004.0,1,0,1
GBR,SWZ,2008.0,1,0,1
DEU,NCL,2018.0,1,0,1
BGR,TUR,2000.0,1,0,1
WSM,CAN,2003.0,1,0,1
AUT,QAT,2021.0,1,0,1
HKG,REU,2008.0,1,0,1
SRB,BIH,2001.0,1,0,1
BLR,FIN,1999.0,1,0,1
CZE,BLR,2005.0,1,0,1
ESP,LVA,2002.0,2,0,2
VUT,GBR,2015.0,1,0,1
ITA,COG,2009.0,1,0,1
TWN,BEN,2012.0,1,0,1
TTO,GUY,2006.0,1,0,1
ESP,TGO,2020.0,1,0,1
GEO,AUT,2013.0,1,0,1
TUN,RUS,2003.0,1,0,1
AGO,DNK,2015.0,1,0,1
ITA,HKG,2022.0,2,0,2
BEL,BOL,2005.0,3,0,3
MHL,,2021.0,2,0,2
MLT,SWE,2019.0,1,0,1
,LBY,1997.0,2,0,2
BRA,HUN,2009.0,1,0,1
ZAF,SEN,2006.0,2,0,2
MAR,RUS,2003.0,1,0,1
TWN,IDN,2008.0,1,0,1
GBR,GUM,2004.0,1,0,1
BOL,SWE,2015.0,1,0,1
BRA,VNM,2020.0,2,0,2
EGY,SSD,2020.0,1,0,1
BGD,NZL,2018.0,2,0,2
BGD,LTU,2020.0,1,0,1
JPN,UGA,2020.0,3,0,3
IND,UZB,2006.0,1,0,1
DZA,NLD,2002.0,1,0,1
BLR,NGA,2016.0,1,0,1
ITA,EST,2016.0,1,0,1
PHL,FIN,2013.0,1,0,1
CHE,ARG,2001.0,1,0,1
CHN,YEM,2013.0,1,0,1
JPN,BIH,2020.0,1,0,1
MYS,MEX,2017.0,1,0,1
AFG,JOR,2014.0,1,0,1
PAK,DZA,2020.0,1,0,1
CYP,ISR,2020.0,1,0,1
CHN,BWA,2016.0,1,0,1
NLD,GMB,2008.0,1,0,1
TUN,DNK,2019.0,1,0,1
HKG,PSE,2019.0,1,0,1
MEX,TUR,2019.0,1,0,1
ESP,AGO,2012.0,1,0,1
,DJI,2013.0,2,0,2
CMR,TCD,2019.0,1,0,1
EGY,HRV,2003.0,3,0,3
RUS,MNG,2013.0,1,0,1
KAZ,NOR,2016.0,1,0,1
JAM,VGB,2002.0,1,0,1
GEO,CZE,2000.0,1,0,1
PAN,CZE,2009.0,1,0,1
CHN,ROU,2006.0,1,0,1
BWA,GBR,2000.0,1,0,1
ITA,IRN,1997.0,1,0,1
PLW,NZL,2006.0,1,0,1
PRT,UKR,2001.0,1,0,1
MLT,CHE,1998.0,1,0,1
AZE,BEL,1998.0,1,0,1
PER,SWE,2005.0,1,0,1
ARG,PHL,2014.0,1,0,1
MEX,FIN,1999.0,1,0,1
MOZ,ESP,2012.0,1,0,1
,GRD,2001.0,1,0,1
CHN,CZE,1997.0,1,0,1
BLR,POL,2017.0,2,0,2
SVN,ISR,2022.0,1,0,1
PAK,HKG,2007.0,1,0,1
FRA,FJI,2000.0,1,0,1
MDA,UKR,2000.0,2,0,2
MNE,AUT,2008.0,1,0,1
BGR,AUS,2001.0,1,0,1
NAM,NLD,2017.0,1,0,1
NZL,PAK,2006.0,1,0,1
TUR,SYR,2011.0,1,0,1
TWN,SRB,2006.0,1,0,1
ZWE,AUT,2006.0,1,0,1
TZA,IDN,2020.0,1,0,1
SAU,EGY,2023.0,1,0,1
PAK,KHM,2012.0,1,0,1
MAC,AUS,2011.0,1,0,1
SWE,MWI,2004.0,1,0,1
NZL,KHM,2013.0,1,0,1
MEX,TWN,1997.0,1,0,1
UKR,MDA,2003.0,1,0,1
CHN,PER,2015.0,1,0,1
AUS,GRC,1999.0,1,0,1
FRA,NZL,1998.0,1,0,1
ARE,SOM,2009.0,1,0,1
UKR,TWN,2009.0,1,0,1
,ATG,2019.0,1,0,1
BEN,TGO,2019.0,1,0,1
NLD,VNM,1999.0,1,0,1
SRB,ROU,2007.0,1,0,1
IRL,BIH,2021.0,1,0,1
BWA,MLI,2018.0,1,0,1
LBN,EGY,2001.0,1,0,1
PER,GTM,2019.0,1,0,1
BIH,OMN,2021.0,1,0,1
SYR,RUS,2019.0,1,0,1
SRB,ARE,2007.0,1,0,1
SEN,NCL,2002.0,1,0,1
SLV,ARG,2022.0,1,0,1
DNK,KHM,2021.0,1,0,1
MEX,BGD,2010.0,1,0,1
IRN,TWN,2010.0,1,0,1
ECU,GBR,1999.0,1,0,1
CAN,FRA,2016.0,252,360,-108
USA,CAN,2019.0,1691,1798,-107
IRN,USA,2014.0,433,101,332
USA,CAN,2010.0,1308,1466,-158
CHN,CHE,2004.0,14,16,-2
ITA,DEU,2003.0,135,134,1
COG,COD,2014.0,9,12,-3
CUB,CHL,2016.0,10,1,9
USA,ESP,2009.0,338,360,-22
CHL,ITA,2019.0,15,14,1
NZL,AUS,2010.0,155,92,63
AUS,NZL,2016.0,108,144,-36
NOR,GBR,2004.0,24,33,-9
DNK,ESP,2012.0,16,21,-5
DEU,FRA,2008.0,314,296,18
NLD,USA,2013.0,358,280,78
DEU,NLD,2017.0,287,319,-32
POL,BEL,2007.0,5,5,0
GBR,ESP,2010.0,272,226,46
ESP,FRA,2007.0,136,152,-16
DEU,NLD,2010.0,193,211,-18
MYS,GBR,2010.0,55,110,-55
AUT,DEU,2020.0,285,360,-75
JPN,DEU,2014.0,121,102,19
IND,OMN,2011.0,13,6,7
BEL,BRA,2010.0,8,14,-6
ESP,CHL,2016.0,129,60,69
CAN,JPN,2011.0,74,90,-16
HKG,CHN,2022.0,513,424,89
FRA,GRC,2013.0,14,56,-42
CAN,GBR,2004.0,207,293,-86
ESP,NOR,2004.0,7,4,3
MEX,ESP,2010.0,108,93,15
NLD,AUT,2015.0,27,29,-2
COL,USA,2011.0,66,60,6
MEX,DEU,2020.0,53,24,29
USA,SWE,2014.0,204,207,-3
ESP,NLD,2022.0,46,29,17
GBR,PAK,2011.0,55,42,13
GBR,ESP,2019.0,355,406,-51
DEU,IND,2013.0,111,133,-22
FRA,DEU,2015.0,381,324,57
AUS,IDN,2009.0,22,6,16
FRA,ITA,2008.0,143,221,-78
ITA,BRA,2014.0,43,32,11
GBR,ESP,2017.0,298,463,-165
BRA,CAN,2008.0,40,25,15
EGY,FRA,2014.0,10,15,-5
JPN,CHN,2016.0,482,272,210
HUN,AUT,2011.0,13,11,2
DEU,BRA,2005.0,32,41,-9
IND,TWN,2009.0,59,26,33
NZL,AUS,2017.0,144,110,34
PRT,ITA,2015.0,33,25,8
MYS,KWT,2015.0,1,2,-1
USA,RUS,2021.0,85,123,-38
POL,USA,2009.0,103,90,13
IND,SWE,2008.0,12,8,4
MEX,ESP,2019.0,127,132,-5
SWE,PAK,2021.0,8,4,4
DEU,ZAF,2018.0,26,32,-6
ISR,BRA,2015.0,2,4,-2
BEL,GBR,2012.0,83,82,1
JOR,IRQ,2016.0,4,2,2
ITA,ESP,2015.0,138,161,-23
JPN,AUT,2022.0,2,4,-2
RUS,DEU,2015.0,95,72,23
SDN,GBR,2016.0,2,6,-4
AUT,JPN,2006.0,7,8,-1
NLD,FRA,2014.0,122,101,21
NGA,CAN,2015.0,8,4,4
ZAF,CHN,2020.0,23,10,13
USA,EGY,2020.0,122,105,17
IRN,CAN,2012.0,195,42,153
NLD,SWE,2009.0,29,28,1
FRA,DZA,2012.0,89,44,45
AUS,TWN,2007.0,11,4,7
NGA,ZAF,2007.0,17,5,12
NPL,CHN,2021.0,6,20,-14
CHN,NLD,2011.0,58,34,24
IRN,JPN,2008.0,9,18,-9
CHN,AUS,2014.0,234,173,61
IND,SGP,2018.0,113,71,42
ZAF,NAM,2018.0,6,8,-2
MEX,ESP,2017.0,102,160,-58
AUS,DEU,2020.0,134,133,1
NOR,CAN,2018.0,13,21,-8
BRA,CHL,2014.0,19,16,3
PAK,IND,2021.0,29,29,0
ISR,GBR,2014.0,54,41,13
GBR,JPN,2012.0,122,86,36
SAU,GBR,2006.0,13,19,-6
MYS,GBR,2017.0,76,104,-28
MEX,BRA,2019.0,28,35,-7
CHN,GBR,2018.0,379,508,-129
USA,SAU,2016.0,147,98,49
GBR,IRL,2016.0,198,268,-70
GHA,FIN,2014.0,1,1,0
CHN,FRA,2021.0,104,175,-71
ETH,KEN,2009.0,2,1,1
ZAF,OMN,2014.0,2,1,1
GBR,IND,1999.0,17,28,-11
AUT,FIN,2019.0,11,11,0
AUS,BGD,2008.0,4,18,-14
COL,IND,2013.0,2,1,1
BEL,UGA,2016.0,5,4,1
MAR,ESP,2016.0,6,13,-7
ITA,MEX,2011.0,9,10,-1
CZE,IND,2021.0,10,29,-19
NOR,CHN,2015.0,15,22,-7
ROU,POL,2021.0,1,3,-2
CHE,AUS,2021.0,41,54,-13
DEU,IDN,2018.0,27,9,18
ITA,PRT,2016.0,28,30,-2
PYF,FRA,2015.0,7,20,-13
CHE,CHN,2019.0,60,63,-3
GLP,FRA,2017.0,14,6,8
ZAF,NLD,2016.0,18,22,-4
NLD,SAU,2019.0,13,10,3
CAN,CMR,2015.0,4,2,2
NLD,ZAF,2015.0,22,15,7
BRA,RUS,2015.0,7,9,-2
SGP,SAU,2020.0,10,2,8
GBR,IRQ,2016.0,41,18,23
KOR,USA,1997.0,47,75,-28
FRA,MTQ,2012.0,28,6,22
ETH,DEU,2020.0,18,12,6
HKG,RUS,2015.0,2,1,1
NLD,ISR,2019.0,12,24,-12
TWN,ESP,2022.0,5,2,3
DEU,IRN,2011.0,24,44,-20
CAN,KOR,2006.0,35,37,-2
SWE,DEU,2008.0,79,103,-24
DEU,SAU,2018.0,35,12,23
CHL,DEU,2016.0,33,39,-6
ARG,AUS,2019.0,7,2,5
FIN,GBR,2021.0,44,67,-23
NLD,IRL,1999.0,5,3,2
SRB,MNE,2017.0,8,7,1
IRN,CHE,2021.0,33,9,24
ESP,PAN,2020.0,5,3,2
BEL,SVN,2017.0,3,2,1
GRC,CYP,2021.0,34,23,11
JPN,PHL,2020.0,23,14,9
FRA,CAF,2017.0,4,1,3
IRN,PAK,2018.0,4,2,2
AUT,SWE,2017.0,29,15,14
AUS,FRA,2021.0,57,40,17
KOR,GBR,2011.0,26,46,-20
COD,COG,2020.0,16,100,-84
NGA,KOR,2021.0,5,2,3
NLD,TZA,2020.0,5,2,3
JOR,FRA,2018.0,1,2,-1
HUN,SRB,2017.0,3,7,-4
ROU,ESP,2021.0,3,3,0
BRA,CZE,2022.0,9,2,7
NZL,FRA,2018.0,21,16,5
SVN,CHE,2021.0,4,1,3
BGR,USA,2018.0,6,12,-6
COL,MEX,2015.0,22,37,-15
ARG,CHE,2012.0,5,3,2
ITA,CHE,2001.0,59,67,-8
JPN,NOR,2020.0,7,5,2
USA,ARE,2021.0,67,71,-4
FRA,BIH,2019.0,2,1,1
POL,RUS,2003.0,15,7,8
MEX,AUT,2016.0,5,5,0
TUR,LBY,2018.0,1,1,0
LKA,USA,2019.0,25,29,-4
PRT,GBR,2020.0,87,88,-1
TUR,DNK,2018.0,12,4,8
BEL,BRA,2019.0,18,24,-6
KOR,USA,1998.0,61,131,-70
USA,IDN,2004.0,22,6,16
URY,CAN,2020.0,3,1,2
POL,DNK,2016.0,8,3,5
FRA,PRT,2006.0,27,15,12
PAK,THA,2019.0,5,6,-1
CHE,SWE,2001.0,19,5,14
PAK,BGD,2018.0,12,3,9
CAN,TUN,2016.0,15,3,12
RUS,FRA,2022.0,21,14,7
GBR,SAU,2011.0,73,9,64
CMR,ZAF,2018.0,6,8,-2
PAK,MYS,2010.0,13,5,8
NZL,AUS,2019.0,147,144,3
IND,ITA,2008.0,32,12,20
ITA,FRA,2014.0,311,205,106
NOR,IND,2019.0,12,18,-6
BGD,CHN,2020.0,21,28,-7
ESP,PRT,2018.0,111,88,23
JPN,IRL,2020.0,8,7,1
KEN,USA,2015.0,60,42,18
MYS,SAU,2020.0,50,23,27
DEU,CHN,1999.0,33,43,-10
DNK,JPN,2015.0,7,4,3
AUS,QAT,2012.0,6,4,2
FRA,MEX,2008.0,55,35,20
IRL,NLD,2012.0,10,9,1
USA,CZE,2007.0,37,38,-1
ESP,CHE,2009.0,44,34,10
KEN,PAK,2015.0,4,5,-1
GBR,PRT,2006.0,44,32,12
SWE,MAR,2021.0,1,2,-1
NOR,IND,2017.0,9,11,-2
CHE,IRL,2009.0,17,6,11
CAN,IND,2001.0,19,36,-17
IDN,JPN,2011.0,23,76,-53
BGD,USA,2009.0,17,17,0
NZL,SGP,2018.0,11,17,-6
AUS,AUT,2003.0,8,19,-11
SGP,TWN,2016.0,13,18,-5
CHE,COL,2010.0,1,4,-3
USA,CRI,2007.0,14,7,7
JPN,SWE,2013.0,22,17,5
SGP,FRA,2014.0,17,35,-18
IRN,TUR,2014.0,26,4,22
BGD,ITA,2011.0,8,2,6
JPN,CHL,2014.0,7,4,3
CAN,BRA,2013.0,36,83,-47
KOR,BGD,2014.0,32,16,16
MEX,BRA,2010.0,9,13,-4
BRA,IND,2002.0,3,5,-2
HKG,MYS,2010.0,5,3,2
DEU,MKD,2011.0,2,1,1
KOR,AUS,2007.0,11,7,4
GBR,UGA,2012.0,15,4,11
SWE,KOR,2015.0,9,10,-1
FIN,CHN,2008.0,3,14,-11
CZE,CAN,2017.0,4,12,-8
HRV,BIH,2014.0,10,11,-1
FRA,DNK,2002.0,22,25,-3
FRA,LUX,2014.0,34,22,12
MEX,NLD,2020.0,11,7,4
RUS,ITA,2015.0,12,29,-17
MYS,USA,2013.0,37,38,-1
DEU,BRA,2002.0,41,35,6
DNK,NOR,2003.0,23,18,5
LVA,USA,2006.0,1,2,-1
TUR,USA,1999.0,45,37,8
AUT,IRL,2011.0,2,4,-2
SRB,USA,2001.0,23,10,13
ISR,FRA,1997.0,3,2,1
BLR,HUN,2001.0,1,1,0
NZL,CHN,2008.0,4,5,-1
CAN,ISR,2003.0,25,46,-21
EGY,SAU,2007.0,77,54,23
GBR,ARG,2017.0,15,12,3
PAK,MYS,2017.0,37,114,-77
SAU,KWT,2018.0,6,5,1
AUS,FIN,2014.0,11,15,-4
DEU,ARE,2014.0,6,2,4
MAR,TUR,2019.0,1,2,-1
BGD,NZL,2019.0,3,2,1
KOR,POL,2020.0,4,1,3
NOR,IRN,2014.0,3,18,-15
GBR,ARG,2019.0,10,15,-5
MOZ,PRT,2022.0,2,2,0
GRC,SGP,2019.0,2,2,0
AUT,ESP,2015.0,11,41,-30
EGY,CHN,2006.0,1,3,-2
ESP,PAK,2019.0,8,4,4
THA,AUS,2001.0,5,5,0
ARM,DEU,2020.0,5,3,2
SWZ,USA,2021.0,5,2,3
BEL,IDN,2021.0,5,4,1
ITA,ISR,2020.0,16,14,2
BOL,USA,2021.0,5,2,3
SGP,MYS,2016.0,12,18,-6
UKR,USA,2021.0,12,11,1
KOR,JPN,2022.0,30,48,-18
KOR,ISR,2019.0,7,5,2
ESP,BEL,2003.0,19,26,-7
LUX,DEU,2000.0,1,1,0
COL,NLD,2021.0,14,10,4
CAN,RUS,2017.0,15,17,-2
NLD,BEL,2008.0,99,105,-6
FIN,JPN,2016.0,13,11,2
FRA,SWE,1999.0,21,17,4
FRA,DNK,2005.0,22,12,10
SWE,THA,2014.0,7,2,5
USA,GHA,2012.0,22,12,10
GBR,SVK,2015.0,6,5,1
ESP,GRC,2009.0,8,10,-2
NLD,GRC,2012.0,13,23,-10
COG,BEL,2020.0,7,7,0
POL,AUS,2006.0,4,5,-1
FIN,SGP,2009.0,2,4,-2
NLD,LTU,2009.0,4,1,3
ESP,URY,2012.0,12,4,8
RUS,JPN,2007.0,20,18,2
BEL,ETH,2009.0,2,3,-1
NOR,ITA,2014.0,11,18,-7
RUS,KAZ,2012.0,15,7,8
UKR,FRA,2009.0,7,12,-5
UKR,ISR,2004.0,3,1,2
GLP,FRA,2010.0,17,13,4
ROU,JPN,2003.0,8,7,1
RUS,UKR,2005.0,29,34,-5
ITA,NOR,2007.0,11,7,4
SWE,CHE,2007.0,28,30,-2
GBR,POL,2002.0,29,33,-4
SWE,ITA,2002.0,28,26,2
NGA,JPN,2016.0,4,2,2
ARG,FRA,2006.0,19,16,3
EST,USA,2012.0,5,3,2
EGY,USA,2007.0,46,85,-39
AUS,SGP,2001.0,23,14,9
ARE,FRA,2020.0,7,20,-13
ITA,KEN,2022.0,2,2,0
LVA,GBR,2001.0,5,1,4
ESP,ARG,1997.0,11,10,1
FRA,ZAF,2006.0,9,9,0
BGD,KOR,2008.0,7,5,2
ESP,BRA,1999.0,12,7,5
NCL,FRA,2022.0,8,6,2
RUS,UKR,2002.0,45,46,-1
MEX,CUB,2010.0,11,9,2
THA,NLD,2002.0,1,4,-3
RUS,BGR,1999.0,3,4,-1
POL,ITA,2006.0,13,7,6
SWE,ITA,2005.0,26,22,4
FRA,AUT,2009.0,24,24,0
BLR,USA,2005.0,6,3,3
CAN,IRL,2002.0,13,8,5
UKR,POL,2014.0,15,13,2
HUN,FIN,2002.0,2,5,-3
FRA,CHE,2000.0,61,45,16
CHE,ZAF,2010.0,11,4,7
DNK,SWE,2013.0,65,57,8
KEN,DEU,2002.0,3,2,1
FRA,MOZ,2016.0,2,1,1
VEN,GBR,2000.0,3,3,0
GBR,CZE,1999.0,10,17,-7
MDA,DEU,2017.0,4,1,3
RUS,CZE,2011.0,10,3,7
OMN,ARE,2012.0,1,1,0
RUS,SWE,1998.0,19,8,11
AUS,SWE,2016.0,48,43,5
ESP,CAN,2000.0,7,6,1
CAN,ARG,2020.0,6,20,-14
HKG,DEU,2004.0,5,4,1
MEX,SWE,2002.0,4,4,0
HUN,POL,2013.0,7,4,3
POL,CHE,2008.0,15,8,7
BGD,AUS,2013.0,48,11,37
JPN,POL,1999.0,9,5,4
LKA,USA,2010.0,10,6,4
BRA,IND,2005.0,3,2,1
NZL,TUR,2005.0,1,1,0
BGR,RUS,2015.0,4,4,0
DEU,CZE,1998.0,5,5,0
CHE,AUT,2006.0,33,32,1
BEL,HUN,2002.0,6,3,3
CAN,NOR,2004.0,11,4,7
DEU,PRT,2004.0,10,16,-6
SRB,ITA,2007.0,2,5,-3
FRA,CAF,2019.0,6,2,4
ARE,AUS,2009.0,6,12,-6
SWE,ISL,2015.0,20,13,7
CZE,CAN,2019.0,6,9,-3
FRA,ARM,2011.0,4,1,3
FRA,KOR,2009.0,21,26,-5
JPN,RUS,2016.0,17,8,9
DEU,CYP,2002.0,1,1,0
USA,HND,2004.0,2,1,1
ZAF,AUS,2006.0,20,14,6
BEL,BGR,2020.0,4,1,3
FIN,CAN,1999.0,4,3,1
POL,PRT,2013.0,3,5,-2
GBR,BRA,2008.0,37,42,-5
CHL,AUS,2013.0,23,6,17
DEU,CUB,2014.0,2,2,0
CHN,ISR,2004.0,4,11,-7
AUT,FRA,2009.0,24,24,0
COL,PRT,2011.0,2,1,1
ESP,HND,2010.0,1,1,0
ESP,HND,2017.0,2,1,1
SWE,BOL,2010.0,2,2,0
SGP,PHL,2007.0,1,2,-1
JPN,AUS,2022.0,17,42,-25
VEN,MEX,2007.0,4,7,-3
JPN,LVA,2018.0,2,1,1
FRA,VEN,2006.0,2,3,-1
SVN,POL,2011.0,4,3,1
CAN,IRL,2005.0,12,21,-9
CZE,CAN,2010.0,5,9,-4
KWT,CZE,2005.0,1,2,-1
ESP,DZA,2007.0,2,1,1
AUT,ARE,2009.0,1,1,0
ITA,GRC,2018.0,26,28,-2
KHM,AUS,2020.0,1,3,-2
AUS,IRN,2014.0,17,136,-119
USA,MLI,2022.0,2,1,1
KAZ,RUS,2015.0,15,18,-3
MEX,HUN,2016.0,1,4,-3
OMN,GBR,2021.0,4,12,-8
CHE,COL,2019.0,9,8,1
JAM,USA,2020.0,7,4,3
FIN,NLD,2022.0,11,9,2
CAN,HKG,2016.0,25,39,-14
ARE,CHN,2017.0,3,1,2
DEU,CYP,2005.0,3,1,2
BRA,KOR,2011.0,3,1,2
JPN,PRT,2012.0,7,2,5
BEL,ROU,2012.0,2,13,-11
HUN,SVK,2017.0,9,3,6
PAK,DEU,2014.0,18,30,-12
ZAF,POL,2020.0,2,4,-2
THA,SGP,2011.0,9,3,6
BEL,SVN,2010.0,3,3,0
ISR,ZAF,2013.0,3,1,2
BGD,NZL,2017.0,3,1,2
IDN,MYS,2009.0,3,17,-14
ROU,SWE,2011.0,4,2,2
SAU,FIN,2018.0,4,1,3
RUS,CHE,2014.0,21,19,2
ESP,LTU,2016.0,1,1,0
HKG,MYS,2019.0,9,9,0
USA,NPL,2016.0,16,26,-10
NPL,ITA,2015.0,3,2,1
SAU,NGA,2014.0,5,2,3
SWE,HUN,2014.0,5,10,-5
BRA,DNK,2020.0,19,8,11
CZE,CHE,2022.0,7,3,4
SRB,MNE,2019.0,3,19,-16
CHL,ITA,2017.0,10,13,-3
IND,CHL,2014.0,7,2,5
GMB,USA,2006.0,3,1,2
ETH,MYS,2014.0,2,2,0
AUS,HKG,2018.0,36,52,-16
USA,PRY,2015.0,3,1,2
BEL,BRA,2017.0,9,25,-16
SWE,IND,2021.0,20,46,-26
GBR,NPL,2018.0,9,8,1
SAU,NLD,2007.0,1,1,0
DEU,BGR,2015.0,8,8,0
ARM,USA,2022.0,3,3,0
NLD,TUR,2021.0,12,23,-11
PAK,NLD,2017.0,4,17,-13
EGY,GBR,2016.0,15,43,-28
SGP,CHN,2000.0,8,47,-39
GRC,CZE,2020.0,6,3,3
EGY,BGD,2020.0,3,3,0
HRV,ITA,2017.0,4,12,-8
MLT,GBR,2014.0,9,10,-1
MYS,BHR,2014.0,3,1,2
JPN,BEL,2021.0,11,8,3
MEX,TUR,2018.0,3,1,2
SAU,BRA,2020.0,1,1,0
ARE,ESP,2020.0,4,6,-2
EGY,IRQ,2022.0,7,1,6
SGP,ARE,2022.0,1,4,-3
IRN,FRA,2022.0,20,6,14
THA,MMR,2018.0,5,2,3
NLD,PAK,2022.0,2,2,0
MEX,VEN,2004.0,6,3,3
CUB,ECU,2017.0,24,2,22
HUN,SVK,2019.0,6,10,-4
NPL,IND,2003.0,9,9,0
FIN,USA,2005.0,60,63,-3
ARM,FRA,2001.0,5,1,4
ESP,ARG,1998.0,13,12,1
BEL,ESP,1997.0,5,2,3
JPN,SAU,2014.0,18,3,15
CHE,LVA,2004.0,1,1,0
HUN,GBR,2001.0,11,18,-7
JPN,VNM,1999.0,1,2,-1
HKG,KOR,2013.0,7,9,-2
LTU,BEL,2009.0,1,1,0
GBR,PER,2016.0,8,4,4
BGD,IND,2009.0,9,9,0
AUT,DNK,2014.0,15,8,7
FIN,DNK,2014.0,13,8,5
PRT,FIN,2011.0,2,4,-2
DEU,SVK,2007.0,9,15,-6
AUT,BEL,2013.0,10,12,-2
ITA,CHL,2021.0,6,14,-8
BEL,PRT,2021.0,12,16,-4
FRA,PER,2015.0,8,2,6
SRB,DEU,2011.0,10,8,2
KOR,FRA,2007.0,9,17,-8
TZA,AUS,2012.0,1,1,0
IND,ISR,2002.0,13,9,4
FRA,POL,2022.0,8,14,-6
JPN,KEN,2020.0,5,5,0
ARE,MYS,2018.0,4,25,-21
TWN,IDN,2013.0,8,5,3
UZB,CHN,2022.0,2,4,-2
NLD,UGA,2013.0,1,1,0
SVN,USA,2004.0,10,13,-3
AUT,SRB,2013.0,1,5,-4
CHE,CMR,2018.0,1,1,0
AUT,FIN,2017.0,8,8,0
GHA,CHN,2012.0,4,1,3
USA,SVN,2015.0,9,8,1
ESP,KEN,2018.0,4,2,2
AUS,WSM,2018.0,1,1,0
HKG,SWE,2022.0,4,1,3
DEU,IRQ,2015.0,6,2,4
MEX,BRA,2017.0,20,29,-9
PAK,THA,2017.0,3,8,-5
MWI,KEN,2014.0,1,3,-2
NLD,MEX,2014.0,4,8,-4
TZA,NOR,2013.0,5,3,2
ECU,CAN,2022.0,2,2,0
ITA,VNM,2021.0,1,2,-1
GBR,BGD,2000.0,4,5,-1
RUS,AUT,2022.0,9,6,3
KOR,RUS,2011.0,13,15,-2
MEX,CUB,2019.0,7,27,-20
MEX,ETH,2019.0,2,1,1
BEL,SVN,2019.0,1,5,-4
HRV,ITA,2010.0,4,1,3
AUT,TUR,2006.0,5,3,2
GBR,MWI,2002.0,11,6,5
CAN,EGY,2003.0,11,4,7
AUT,ITA,2001.0,11,17,-6
CHE,PNG,2006.0,3,1,2
RUS,DNK,2011.0,5,1,4
URY,CHL,2009.0,3,1,2
ARM,RUS,2004.0,2,6,-4
CAN,RUS,2019.0,10,20,-10
GBR,ARG,2010.0,11,4,7
PAK,GBR,2004.0,12,18,-6
PRT,CHN,2009.0,4,8,-4
CUB,ESP,1999.0,12,4,8
ESP,CZE,1998.0,1,1,0
BEL,COL,2002.0,1,1,0
CUB,BRA,2006.0,5,5,0
NOR,JPN,2015.0,9,6,3
ISR,HUN,2015.0,3,2,1
KOR,IND,2003.0,9,26,-17
USA,TZA,2006.0,4,3,1
GLP,FRA,2019.0,9,11,-2
CHL,PRT,2008.0,1,2,-1
ISR,FRA,1998.0,6,6,0
IRQ,GBR,2007.0,2,3,-1
FRA,SAU,2003.0,3,1,2
NZL,NLD,2008.0,10,8,2
SEN,FRA,2007.0,24,25,-1
CHE,IRN,2013.0,2,25,-23
CAN,MYS,2012.0,7,15,-8
FRA,CYP,2012.0,2,2,0
POL,AUT,2015.0,7,18,-11
KEN,DEU,2005.0,4,4,0
PRT,ROU,2019.0,2,1,1
ITA,CZE,2006.0,7,7,0
BLR,POL,2018.0,7,1,6
CMR,GBR,2011.0,2,3,-1
TUR,SAU,2012.0,7,5,2
CAN,RUS,2010.0,15,19,-4
SVN,CZE,2015.0,2,1,1
CZE,SWE,2012.0,7,5,2
BHR,PAK,2020.0,1,4,-3
IRL,JPN,2013.0,12,3,9
IRN,SWE,2004.0,1,2,-1
ROU,ECU,2021.0,1,1,0
BEL,CZE,2007.0,3,1,2
KOR,EGY,2021.0,9,4,5
GRC,HUN,2004.0,4,2,2
CHE,COL,2017.0,8,2,6
MEX,CUB,2017.0,5,18,-13
UGA,CAN,2019.0,4,2,2
SVN,HRV,2015.0,6,9,-3
ARE,CHN,2019.0,3,9,-6
ISR,POL,2002.0,3,1,2
SVK,DEU,2018.0,5,12,-7
CAN,CZE,2021.0,5,4,1
CAN,KEN,2017.0,7,5,2
BIH,ITA,2020.0,3,1,2
AUS,SAU,2007.0,6,3,3
CHE,SLE,2021.0,1,1,0
CHE,BGR,2015.0,7,5,2
RUS,MEX,2019.0,2,3,-1
USA,ZMB,1997.0,1,1,0
ARE,BEL,2020.0,1,3,-2
PAK,NLD,2019.0,4,7,-3
CZE,BRA,2008.0,1,1,0
AUS,COL,2008.0,1,2,-1
IRL,POL,2017.0,2,6,-4
GBR,PSE,2016.0,5,1,4
NOR,IND,2010.0,2,9,-7
EST,ZAF,2014.0,1,1,0
CUB,ECU,2019.0,15,4,11
BOL,FRA,2008.0,2,1,1
SRB,MKD,2003.0,4,2,2
KOR,NLD,2003.0,6,2,4
BEL,VNM,2000.0,1,1,0
ZWE,UGA,2016.0,1,1,0
USA,MAC,2009.0,6,2,4
USA,SLE,2021.0,6,10,-4
VNM,RUS,2019.0,5,12,-7
TWN,HUN,2015.0,2,2,0
PAK,THA,2010.0,1,3,-2
CMR,CAN,2012.0,4,1,3
SAU,SDN,2014.0,3,24,-21
LUX,NLD,2016.0,5,4,1
SVN,ITA,2012.0,4,8,-4
BEL,LUX,2013.0,12,7,5
CAN,KEN,2019.0,7,9,-2
DOM,ARG,2021.0,1,2,-1
BEL,BGD,2015.0,5,5,0
MDG,GBR,2018.0,1,1,0
NGA,BRA,2021.0,2,3,-1
USA,MLT,2018.0,2,1,1
GBR,KWT,2001.0,3,1,2
COL,CHN,2020.0,1,1,0
CHE,ZAF,2019.0,6,16,-10
MYS,BEL,2015.0,3,2,1
IRN,TWN,2018.0,5,1,4
NLD,ARE,2022.0,3,2,1
KOR,NOR,2015.0,4,1,3
GHA,JPN,2007.0,1,1,0
NLD,RWA,2013.0,3,1,2
CHN,AUT,2018.0,21,22,-1
GBR,SLE,2016.0,2,1,1
BRA,AUT,2003.0,3,2,1
CAN,KEN,2010.0,4,5,-1
ITA,ALB,2006.0,2,1,1
CAN,CHL,2001.0,6,1,5
LSO,SWZ,2018.0,1,1,0
SAU,BHR,2011.0,3,4,-1
BLR,LTU,2005.0,1,1,0
MDA,RUS,2007.0,1,1,0
GRC,ITA,2001.0,7,18,-11
FRA,COG,2008.0,7,3,4
PRT,ROU,2017.0,1,2,-1
RUS,SWE,1997.0,6,7,-1
NLD,HUN,2012.0,4,10,-6
NLD,KEN,2002.0,1,2,-1
MEX,ARG,2003.0,13,8,5
CAN,GRC,1999.0,5,1,4
CAN,UKR,2007.0,2,9,-7
ARE,USA,2003.0,7,16,-9
RUS,BLR,2010.0,6,15,-9
BEL,DNK,2006.0,3,5,-2
GBR,MWI,2005.0,5,6,-1
HKG,NZL,2000.0,1,2,-1
ZAF,PRT,2005.0,2,5,-3
SAU,AUS,2006.0,7,2,5
SGP,HUN,2004.0,1,3,-2
USA,CMR,2013.0,3,7,-4
CZE,JPN,2000.0,1,1,0
ITA,FIN,2006.0,6,2,4
SRB,CHE,2003.0,4,1,3
FIN,AUS,2003.0,11,8,3
LBN,FRA,2000.0,3,8,-5
USA,JAM,2009.0,3,4,-1
FRA,NOR,1999.0,8,3,5
GBR,NGA,1999.0,4,1,3
GBR,HKG,1999.0,11,14,-3
CHL,ITA,2010.0,3,3,0
RUS,MDA,2011.0,2,5,-3
FRA,MLI,2004.0,5,3,2
SAU,QAT,2013.0,4,1,3
AUT,FIN,2010.0,4,6,-2
GBR,BGR,2015.0,3,7,-4
AZE,TUR,2013.0,6,5,1
USA,SVK,2022.0,2,1,1
EGY,SWE,2008.0,2,1,1
CMR,ITA,2011.0,2,2,0
DEU,LVA,2009.0,3,3,0
KOR,ISR,2010.0,1,3,-2
SWE,LBN,2019.0,1,4,-3
IND,VNM,2018.0,5,1,4
EGY,TWN,2020.0,2,2,0
TUR,GRC,2017.0,5,5,0
AZE,USA,2016.0,1,4,-3
LVA,EST,2020.0,3,3,0
FIN,ROU,2017.0,1,1,0
FJI,USA,2011.0,1,1,0
RUS,SRB,2013.0,4,1,3
NLD,BFA,2003.0,1,1,0
HUN,BEL,2007.0,4,3,1
TWN,IND,2004.0,13,36,-23
BGD,THA,2004.0,1,1,0
BIH,SRB,2011.0,6,13,-7
FIN,ITA,2011.0,5,15,-10
ESP,KOR,2012.0,2,4,-2
USA,KGZ,2020.0,3,2,1
GRC,FIN,2016.0,6,2,4
IDN,KOR,2015.0,7,14,-7
KOR,TWN,2000.0,1,2,-1
MYS,PHL,2022.0,2,1,1
AUS,NPL,2011.0,2,2,0
AUS,KOR,2001.0,7,6,1
LVA,SWE,1998.0,1,2,-1
SWE,AUT,1998.0,1,2,-1
CRI,FRA,2007.0,2,1,1
TUR,KGZ,2021.0,3,2,1
GRL,DNK,2006.0,4,1,3
USA,LAO,2016.0,2,2,0
PRT,EGY,2014.0,3,1,2
KWT,MYS,2022.0,1,2,-1
THA,SWE,2008.0,4,5,-1
IRQ,TUR,2017.0,3,15,-12
RUS,POL,1998.0,5,8,-3
FRA,LTU,2007.0,2,1,1
FRA,ETH,2007.0,2,1,1
NAM,CHN,2016.0,1,1,0
IRN,GBR,2004.0,12,54,-42
SRB,MNE,2010.0,3,6,-3
NGA,GMB,2019.0,1,1,0
DNK,SVN,2022.0,4,1,3
ESP,IRN,2007.0,1,1,0
AUS,ZWE,2013.0,1,1,0
SAU,JOR,2007.0,3,5,-2
IND,BTN,2006.0,1,1,0
TWN,RUS,2004.0,5,2,3
RUS,POL,1997.0,2,3,-1
MEX,CHL,1998.0,2,1,1
TWN,PAK,2019.0,1,3,-2
DEU,NZL,2022.0,4,10,-6
ISR,MLI,2019.0,1,1,0
HRV,NLD,2003.0,1,1,0
NLD,SAU,2017.0,7,4,3
FIN,BGR,2016.0,1,1,0
MYS,CHE,2017.0,3,2,1
SDN,MYS,2015.0,4,6,-2
URY,FRA,2021.0,3,4,-1
PAK,JPN,2021.0,4,12,-8
CUB,COL,2007.0,5,2,3
DEU,BLR,2014.0,3,2,1
LKA,USA,2017.0,13,30,-17
IRL,GRC,2005.0,4,3,1
HUN,FIN,2005.0,3,4,-1
ESP,PRI,2011.0,2,1,1
BEL,POL,2004.0,7,6,1
SRB,ESP,2001.0,1,1,0
BEL,ARG,2018.0,2,5,-3
HRV,CAN,2009.0,2,1,1
THA,LAO,2021.0,3,2,1
USA,EST,2001.0,2,3,-1
MEX,BGD,2018.0,1,1,0
PSE,EGY,2009.0,2,1,1
AUT,HUN,2022.0,7,4,3
CHN,PRT,2020.0,6,12,-6
DNK,THA,2006.0,2,3,-1
CHE,CHL,2011.0,3,4,-1
CZE,KOR,2015.0,2,3,-1
THA,USA,1998.0,4,9,-5
UKR,EST,2018.0,1,2,-1
ITA,COL,2007.0,1,3,-2
GHA,GBR,2013.0,11,15,-4
DEU,ALB,2002.0,1,1,0
IRL,POL,2010.0,3,8,-5
VEN,CHE,2014.0,2,1,1
PRT,ROU,2010.0,3,2,1
ITA,HKG,2016.0,1,1,0
KOR,CHL,2020.0,5,1,4
NOR,ISL,2021.0,5,5,0
KOR,DZA,2020.0,1,1,0
HKG,BGD,2020.0,3,5,-2
SDN,DEU,2004.0,1,2,-1
KEN,JPN,2011.0,4,6,-2
DEU,LBN,2009.0,1,3,-2
MYS,CHE,2019.0,2,5,-3
NZL,AUT,2018.0,2,1,1
LVA,DEU,2009.0,3,3,0
COL,VEN,2009.0,3,3,0
USA,ZWE,2006.0,1,6,-5
JPN,UKR,2011.0,4,1,3
GBR,SVN,2007.0,5,12,-7
ISL,GBR,2009.0,4,5,-1
RUS,MEX,2010.0,3,6,-3
VNM,RUS,2010.0,1,5,-4
BOL,ESP,2015.0,3,7,-4
CAN,NAM,2003.0,1,1,0
NOR,ZAF,2001.0,4,3,1
CHE,PHL,2017.0,2,4,-2
AUT,ISR,2013.0,2,6,-4
JAM,BRB,2013.0,1,1,0
FRA,CAF,2010.0,2,2,0
NZL,ESP,2011.0,1,3,-2
PRT,CZE,2007.0,3,1,2
NLD,ROU,2016.0,7,3,4
ARM,GRC,2008.0,1,1,0
GHA,NLD,2012.0,2,2,0
KWT,GBR,2000.0,2,2,0
AUS,ISL,2020.0,1,1,0
IND,SVK,2016.0,1,2,-1
GBR,AFG,2011.0,1,2,-1
DEU,QAT,2018.0,4,4,0
NLD,NZL,2015.0,4,17,-13
AUS,BTN,2015.0,1,2,-1
MYS,FRA,2012.0,1,4,-3
SGP,TUR,2018.0,2,5,-3
MWI,DEU,2021.0,2,2,0
ITA,MLT,2022.0,2,1,1
RUS,UZB,2007.0,1,7,-6
DNK,SGP,2005.0,2,2,0
DNK,IND,2004.0,3,3,0
KOR,ISR,2017.0,2,5,-3
PRT,ZAF,2014.0,2,1,1
THA,CHE,2009.0,4,3,1
SWE,BOL,2017.0,3,1,2
MDA,DEU,2019.0,4,1,3
NPL,TWN,2010.0,1,1,0
BEL,ESP,1998.0,2,3,-1
ESP,PAK,2017.0,3,2,1
GEO,FRA,2022.0,3,25,-22
SRB,NLD,2004.0,2,1,1
SRB,BIH,2003.0,2,2,0
GRC,MLT,2013.0,1,1,0
MAC,CHN,2006.0,1,6,-5
RUS,KGZ,2021.0,2,1,1
MEX,SWE,2005.0,2,2,0
AUT,PRT,2007.0,1,2,-1
AUS,BRA,1998.0,2,1,1
DEU,HRV,1998.0,1,4,-3
MAR,TUN,2015.0,1,1,0
ARE,NZL,2015.0,1,2,-1
CAN,BWA,2017.0,2,2,0
PAN,DEU,2018.0,1,1,0
CHE,PER,2020.0,1,2,-1
BEL,CYP,2021.0,1,1,0
KAZ,TUR,2017.0,5,10,-5
SOM,TUR,2022.0,1,5,-4
MCO,SWE,2012.0,1,1,0
AUS,EGY,2009.0,3,1,2
CAN,BWA,2010.0,1,1,0
CHL,DNK,2014.0,1,1,0
SWE,MEX,2011.0,2,4,-2
COG,BEN,2012.0,1,1,0
PRT,NZL,2021.0,3,1,2
VEN,CAN,2019.0,2,1,1
CHE,UKR,2020.0,2,12,-10
CZE,ROU,2021.0,1,1,0
MNG,RUS,2017.0,1,2,-1
ETH,BWA,2015.0,3,3,0
LAO,FRA,2021.0,2,1,1
UGA,CAN,2017.0,2,4,-2
NGA,NLD,2022.0,2,1,1
IDN,GBR,2001.0,2,5,-3
KWT,DEU,2016.0,1,1,0
ARG,PER,2022.0,2,1,1
IRL,POL,2019.0,2,4,-2
MEX,ETH,2017.0,1,3,-2
CHN,PRK,2016.0,4,3,1
IND,SYR,2017.0,1,1,0
JPN,KWT,2019.0,2,1,1
NLD,SAU,2010.0,2,1,1
SAU,NZL,2022.0,1,2,-1
ARE,IRL,2018.0,2,10,-8
ISR,DNK,2021.0,2,4,-2
CHN,UGA,2016.0,1,1,0
EST,CAN,2002.0,1,2,-1
HUN,SRB,2019.0,2,3,-1
ALB,SRB,2021.0,1,3,-2
RUS,ROU,2011.0,1,1,0
CZE,ISR,2001.0,4,3,1
DNK,TZA,1998.0,1,1,0
BGR,BEL,1998.0,1,3,-2
ITA,BGR,2007.0,4,7,-3
BLR,GBR,2000.0,2,1,1
VNM,RUS,2017.0,1,9,-8
AUS,KHM,2015.0,2,1,1
LKA,JPN,2009.0,2,7,-5
PER,GBR,2005.0,1,1,0
KEN,MWI,2020.0,1,2,-1
LVA,ITA,2010.0,1,1,0
NOR,RUS,2014.0,3,8,-5
IDN,CHE,2010.0,2,1,1
PER,CAN,2014.0,1,2,-1
CHE,MWI,2017.0,1,2,-1
HRV,IND,2016.0,1,1,0
DNK,MEX,2008.0,1,1,0
DNK,EGY,2016.0,1,2,-1
ISL,NLD,2014.0,1,1,0
ITA,JOR,2015.0,2,2,0
NAM,FIN,2020.0,1,1,0
CHE,PHL,2019.0,2,5,-3
VEN,ISR,2010.0,1,1,0
OMN,PAK,2020.0,3,10,-7
BEL,SRB,2021.0,1,3,-2
PRT,HUN,2014.0,2,2,0
JOR,GBR,2008.0,3,19,-16
IND,MYS,2001.0,2,3,-1
LTU,FRA,2006.0,1,1,0
ETH,SWE,2006.0,3,3,0
BGR,BEL,1997.0,1,1,0
ESP,PSE,2017.0,2,3,-1
IRL,CHL,2020.0,1,1,0
BGD,IRQ,2017.0,2,1,1
BIH,MKD,2017.0,1,1,0
UZB,CZE,2018.0,2,1,1
CYP,BEL,2020.0,1,2,-1
LTU,AUT,2021.0,1,1,0
POL,IRN,2012.0,1,5,-4
IND,JOR,2021.0,1,2,-1
MAR,USA,2014.0,3,3,0
EGY,CHL,2021.0,1,1,0
GIN,MLI,2011.0,1,2,-1
VEN,ARG,1999.0,1,1,0
IRQ,IND,2013.0,2,4,-2
KOR,BRA,2008.0,1,2,-1
HTI,FRA,2018.0,1,1,0
RUS,MEX,2017.0,3,4,-1
TUN,DEU,2018.0,2,5,-3
DEU,PER,2012.0,1,5,-4
IRL,FIN,2009.0,1,3,-2
BEN,NLD,2009.0,1,1,0
HUN,CZE,2008.0,1,2,-1
NLD,MOZ,2018.0,2,1,1
GHA,ITA,2015.0,1,1,0
DNK,POL,2018.0,2,7,-5
PAK,IDN,2021.0,3,5,-2
LBN,ESP,2019.0,1,3,-2
GRC,ESP,2000.0,2,2,0
IND,LKA,2012.0,2,1,1
ZAF,PRT,2002.0,1,1,0
UGA,CAN,2010.0,1,1,0
CHE,PHL,2010.0,3,4,-1
ZAF,GHA,2013.0,1,12,-11
CHL,CUB,2012.0,1,4,-3
GBR,FRO,2022.0,1,1,0
UKR,TUR,2017.0,1,1,0
ITA,NPL,2015.0,2,3,-1
ARG,AUS,2010.0,3,4,-1
DEU,PRI,2001.0,1,1,0
AFG,JPN,2021.0,2,2,0
ROU,SVK,2016.0,1,2,-1
SGP,ROU,2016.0,1,1,0
URY,CHE,2019.0,1,2,-1
EST,DNK,2014.0,2,1,1
PRT,TWN,2021.0,1,1,0
GRC,BRA,2022.0,1,1,0
FIN,MEX,2016.0,3,2,1
GMB,KEN,2018.0,1,1,0
DNK,LTU,2022.0,1,2,-1
ROU,SVN,2008.0,1,1,0
OMN,DEU,2012.0,1,3,-2
CRI,BRA,2018.0,1,1,0
NZL,TWN,2012.0,2,1,1
IND,MEX,1997.0,1,1,0
USA,MDG,2008.0,1,1,0
MNG,RUS,2019.0,1,1,0
ZAF,SWZ,2002.0,2,2,0
KHM,JPN,2012.0,1,1,0
KEN,GBR,1998.0,1,1,0
IRQ,AUS,2009.0,1,1,0
BEN,CIV,2003.0,1,2,-1
NLD,KEN,2005.0,1,1,0
THA,IND,1998.0,1,2,-1
KOR,ITA,2004.0,1,3,-2
MEX,ZWE,2020.0,1,2,-1
NGA,ZMB,2009.0,1,2,-1
RUS,ISL,2020.0,1,2,-1
SVK,IRL,2004.0,2,1,1
SWE,SRB,2007.0,1,3,-2
QAT,SAU,2008.0,1,2,-1
JOR,SYR,2017.0,1,5,-4
AZE,RUS,2012.0,1,5,-4
ETH,VNM,2021.0,1,1,0
CHN,ARE,2013.0,1,3,-2
MAC,GBR,2014.0,1,6,-5
KWT,AUS,2014.0,1,4,-3
MMR,JPN,2013.0,1,3,-2
LBY,GBR,2003.0,1,2,-1
RUS,SVN,2016.0,1,3,-2
LTU,SVN,2019.0,1,1,0
CHE,PRT,1999.0,1,4,-3
JPN,QAT,2022.0,1,2,-1
MEX,PAK,2015.0,1,2,-1
SVK,NOR,2020.0,1,1,0
TWN,GRC,2022.0,1,1,0
USA,CAN,2017.0,1356,1913,-557
ROU,USA,2003.0,38,16,22
DEU,EST,2011.0,5,3,2
CAN,TUR,2004.0,5,12,-7
USA,JPN,2016.0,765,732,33
CHN,HKG,2004.0,141,204,-63
USA,GRC,2011.0,88,108,-20
ETH,AUS,2013.0,1,3,-2
PRI,USA,2008.0,50,60,-10
GBR,IDN,2011.0,8,2,6
THA,NLD,2005.0,4,3,1
GBR,POL,2005.0,21,31,-10
BRA,FRA,2009.0,78,70,8
FRA,GBR,2001.0,247,201,46
USA,SGP,2008.0,184,157,27
ARG,CHL,2020.0,22,21,1
AUT,SWE,2019.0,33,15,18
DEU,NLD,2019.0,312,302,10
IRL,ITA,2022.0,11,13,-2
KOR,MYS,2020.0,9,12,-3
GBR,ISR,2014.0,41,54,-13
MUS,USA,2019.0,4,3,1
POL,DEU,1998.0,14,29,-15
DNK,FRA,2021.0,35,40,-5
ARG,GBR,2020.0,19,10,9
HKG,GBR,2018.0,63,59,4
AUT,SWE,2010.0,11,8,3
NOR,AUT,2016.0,9,14,-5
JPN,MYS,2006.0,15,10,5
FIN,USA,2002.0,67,99,-32
USA,MYS,2009.0,20,10,10
IND,BRA,2015.0,28,10,18
FRA,RUS,1999.0,34,30,4
SAU,EGY,2000.0,15,8,7
ESP,ITA,2000.0,28,22,6
IRQ,TUR,2019.0,4,21,-17
HKG,MYS,2017.0,5,4,1
RUS,BLR,2017.0,22,12,10
IND,ARE,2011.0,17,4,13
RUS,BLR,2019.0,10,17,-7
JOR,SYR,2019.0,1,1,0
CAN,ESP,2014.0,33,75,-42
TUN,USA,2011.0,9,4,5
CMR,DEU,2003.0,3,1,2
PSE,ISR,2008.0,11,4,7
USA,MKD,2016.0,2,5,-3
ITA,BEL,1999.0,17,20,-3
FRA,PAK,1999.0,1,2,-1
IRL,FRA,2013.0,27,33,-6
GBR,SWE,1999.0,24,32,-8
BEL,HUN,2005.0,6,5,1
CHE,ZAF,2017.0,6,20,-14
THA,USA,1997.0,4,4,0
BLR,USA,2002.0,21,5,16
IND,ISR,2005.0,12,6,6
SAU,PAK,2009.0,12,16,-4
NLD,ISR,2010.0,5,5,0
SGP,DNK,2018.0,7,3,4
NGA,UGA,2016.0,2,1,1
GBR,LKA,2018.0,18,9,9
JPN,PAK,2013.0,14,10,4
KEN,SEN,2018.0,2,1,1
POL,DEU,1997.0,23,30,-7
DEU,ARG,2001.0,7,16,-9
BGR,ISR,2019.0,1,1,0
NLD,BRA,2012.0,16,14,2
ARE,TUN,2016.0,1,2,-1
CAN,TWN,2015.0,13,14,-1
GHA,KOR,2019.0,1,4,-3
KAZ,TUR,2019.0,6,5,1
DEU,FIN,2000.0,6,12,-6
QAT,GBR,2022.0,8,10,-2
CHE,RUS,2018.0,7,22,-15
KWT,IND,2015.0,1,5,-4
PER,MEX,2021.0,8,6,2
HRV,ITA,2019.0,10,10,0
LUX,NOR,2019.0,1,1,0
POL,ROU,2012.0,3,1,2
GHA,CAN,2011.0,3,1,2
NLD,ISR,2017.0,11,11,0
NZL,ITA,2006.0,2,4,-2
DEU,SRB,2014.0,7,15,-8
SGP,NOR,2009.0,2,2,0
NOR,NLD,2003.0,5,17,-12
CHL,IND,2009.0,1,2,-1
LUX,ESP,2016.0,4,7,-3
IND,KWT,2018.0,7,3,4
HRV,AUT,2020.0,8,7,1
ARE,QAT,2013.0,5,1,4
BGD,SWE,2014.0,4,3,1
USA,GTM,2011.0,4,4,0
PER,ESP,2009.0,10,4,6
ARM,ITA,2001.0,2,1,1
ZAF,NOR,2011.0,2,1,1
FIN,ROU,2010.0,1,4,-3
VEN,CAN,2017.0,3,1,2
GBR,UKR,2001.0,4,18,-14
NPL,USA,2003.0,4,5,-1
RWA,BEL,2011.0,1,5,-4
CHE,ARG,2003.0,1,4,-3
CZE,ZAF,2015.0,4,2,2
CIV,SEN,2013.0,1,1,0
MEX,BEL,2007.0,3,2,1
TUN,EGY,2012.0,1,1,0
DNK,SVK,2011.0,1,2,-1
PNG,AUS,2021.0,1,3,-2
ECU,FRA,2020.0,4,7,-3
BRA,NZL,2008.0,2,2,0
LTU,SWE,2004.0,3,4,-1
SWE,TUR,2006.0,2,6,-4
SAU,KOR,2012.0,2,10,-8
CHN,ARG,2021.0,3,1,2
ZAF,MOZ,2013.0,1,2,-1
CIV,BEL,2001.0,3,2,1
CAN,NGA,2004.0,1,2,-1
IRL,IND,2003.0,3,5,-2
DNK,BEL,2004.0,5,3,2
CHE,MEX,2003.0,2,2,0
JPN,DZA,2008.0,2,1,1
AUS,ROU,2021.0,2,3,-1
MEX,URY,2006.0,1,2,-1
YEM,EGY,2006.0,1,4,-3
QAT,IND,2014.0,3,4,-1
FIN,COL,2017.0,1,1,0
USA,VEN,2020.0,5,20,-15
ARG,AUS,2017.0,5,4,1
RUS,VNM,2006.0,1,1,0
SLV,ESP,2015.0,1,1,0
IND,MEX,1998.0,1,1,0
DEU,ARM,2015.0,1,10,-9
JPN,MNG,2007.0,4,3,1
MAR,DEU,2003.0,2,3,-1
BRA,CHN,2000.0,1,4,-3
ISR,CZE,2016.0,1,4,-3
POL,TUR,2006.0,1,1,0
IDN,CHE,2017.0,1,2,-1
ZAF,CZE,2018.0,2,1,1
KOR,AUT,2009.0,4,2,2
MLI,SEN,2013.0,1,2,-1
PRY,URY,2021.0,1,1,0
SRB,CAN,2005.0,2,2,0
OMN,JOR,2008.0,1,1,0
EGY,NGA,2008.0,1,1,0
ITA,PAK,2009.0,1,1,0
ARE,DEU,2006.0,1,1,0
USA,,2015.0,69705,0,69705
IRN,,2023.0,32173,0,32173
OMN,,2014.0,61,0,61
FRA,,2013.0,8485,0,8485
,ARM,2003.0,98,0,98
,DEU,2007.0,20941,0,20941
FIN,,2012.0,1154,0,1154
ITA,,2018.0,11365,0,11365
TUR,CHN,2013.0,1,0,1
FJI,,2022.0,54,0,54
COD,,2024.0,247,0,247
IRL,,2016.0,1005,0,1005
BRA,,2005.0,1177,0,1177
BGR,,2024.0,3176,0,3176
,ITA,2007.0,13467,0,13467
ISR,,2016.0,1763,0,1763
,TUN,2002.0,801,0,801
TZA,,2024.0,1510,0,1510
,LBN,2003.0,193,0,193
,LVA,2004.0,115,0,115
,TUN,2005.0,1046,0,1046
,NGA,2001.0,693,0,693
,JPN,2015.0,22010,0,22010
,PRT,2006.0,2276,0,2276
IDN,,2009.0,80,0,80
ARG,,2004.0,369,0,369
,FIN,1999.0,3673,0,3673
GRC,LUX,2014.0,3,0,3
MKD,,2020.0,192,0,192
,KOR,2012.0,16904,0,16904
UKR,,2008.0,475,0,475
,CZE,2008.0,2420,0,2420
SGP,,2011.0,757,0,757
THA,,2008.0,364,0,364
,CHL,2000.0,1193,0,1193
PRY,,2024.0,179,0,179
BRA,,2002.0,247,0,247
,RUS,2018.0,11380,0,11380
,MDG,2005.0,65,0,65
PRI,,2014.0,108,0,108
LTU,,2011.0,213,0,213
ARE,,2015.0,153,0,153
,VNM,2012.0,841,0,841
,IRN,1994.0,179,0,179
,DZA,2016.0,1489,0,1489
,TZA,2003.0,123,0,123
,NLD,2011.0,6485,0,6485
,MDG,2002.0,35,0,35
GHA,,2014.0,67,0,67
VEN,,2003.0,67,0,67
,JAM,2001.0,38,0,38
,IDN,2011.0,1704,0,1704
,BGR,2000.0,627,0,627
,QAT,2011.0,148,0,148
,AUT,2014.0,2729,0,2729
,TWN,2015.0,5415,0,5415
IDN,BGR,2021.0,1,0,1
,PHL,2012.0,476,0,476
,YEM,2012.0,49,0,49
,SVK,2018.0,750,0,750
,NZL,2013.0,1516,0,1516
,OMN,2009.0,149,0,149
PSE,,2018.0,57,0,57
BHR,,2022.0,164,0,164
PRI,CHN,2004.0,3,0,3
,KEN,2007.0,367,0,367
VUT,,2020.0,4,0,4
,MLI,2005.0,47,0,47
,URY,2015.0,217,0,217
TTO,,2020.0,58,0,58
OMN,BHR,2022.0,2,0,2
KHM,NLD,2018.0,1,0,1
JOR,PSE,2022.0,3,0,3
MEX,PHL,2018.0,3,0,3
,TLS,2017.0,6,0,6
,DOM,2018.0,25,0,25
MYS,ARE,2016.0,20,0,20
KAZ,IRQ,2016.0,1,0,1
,CMR,2001.0,144,0,144
CHE,ARM,1999.0,1,0,1
,PRY,2008.0,18,0,18
IRQ,,2011.0,35,0,35
TUR,JOR,2007.0,2,0,2
MYS,CAN,2006.0,5,0,5
COL,VNM,2020.0,1,0,1
SVK,MEX,2002.0,1,0,1
TWN,UKR,2008.0,1,0,1
ZAF,MWI,2022.0,3,0,3
GEO,SWE,2019.0,2,0,2
,LVA,1996.0,87,0,87
MEX,MWI,2018.0,1,0,1
BGD,,1999.0,3,0,3
GRC,ROU,2003.0,5,0,5
KOR,PRK,2017.0,2,0,2
,GLP,2008.0,7,0,7
MWI,NAM,2019.0,1,0,1
GBR,PHL,2013.0,3,0,3
TWN,SVN,2017.0,1,0,1
KWT,CHN,2018.0,1,0,1
BRA,HKG,2018.0,1,0,1
,BLZ,2015.0,4,0,4
KEN,GBR,1997.0,1,0,1
UKR,PRT,2007.0,6,0,6
CHL,SGP,2020.0,1,0,1
FJI,SWE,2016.0,1,0,1
NZL,BTN,2020.0,1,0,1
GRD,,2024.0,52,0,52
YEM,,2016.0,51,0,51
MAC,,2013.0,17,0,17
,AND,2016.0,2,0,2
BEL,LTU,2014.0,1,0,1
KAZ,TUR,2010.0,1,0,1
ETH,,2012.0,56,0,56
,TTO,1998.0,62,0,62
RUS,VEN,2006.0,1,0,1
LSO,,2012.0,1,0,1
,IRQ,2001.0,42,0,42
RUS,MNG,2008.0,3,0,3
MNG,,2012.0,16,0,16
,MLI,2002.0,32,0,32
COD,BWA,2008.0,1,0,1
NLD,QAT,2014.0,6,0,6
PAN,ECU,2008.0,1,0,1
GBR,MAR,2001.0,2,0,2
CYP,,2007.0,11,0,11
LUX,,2006.0,8,0,8
NGA,AUS,1999.0,2,0,2
MEX,CHN,2000.0,1,0,1
TZA,ZAF,2004.0,3,0,3
URY,PRY,2015.0,1,0,1
BRA,CPV,2005.0,1,0,1
,TTO,1997.0,5,0,5
ZAF,KOR,2008.0,1,0,1
MLT,,2011.0,7,0,7
,GHA,1994.0,15,0,15
BEL,MCO,2004.0,2,0,2
,TJK,1998.0,17,0,17
,MCO,1997.0,1,0,1
ECU,ARG,2009.0,2,0,2
TJK,,2001.0,2,0,2
LKA,ZAF,2021.0,1,0,1
GRL,,2008.0,4,0,4
ESP,ECU,2006.0,2,0,2
,MNE,2008.0,43,0,43
SEN,ZAF,2002.0,1,0,1
KGZ,,2011.0,1,0,1
,BMU,2000.0,8,0,8
,TJK,1997.0,4,0,4
,GUM,2005.0,4,0,4
GRC,SGP,2017.0,2,0,2
CAN,ISL,2021.0,2,0,2
,GUM,2002.0,5,0,5
JPN,AFG,2018.0,7,0,7
ARM,IRN,2009.0,1,0,1
POL,TZA,2017.0,2,0,2
ETH,POL,2011.0,2,0,2
,DJI,2008.0,4,0,4
DEU,BEN,2013.0,1,0,1
MOZ,SWE,2015.0,2,0,2
SWZ,TTO,2005.0,1,0,1
USA,RWA,2007.0,2,0,2
MAR,ZAF,2014.0,2,0,2
BFA,ZAF,2015.0,2,0,2
,NER,2010.0,31,0,31
NZL,MWI,2015.0,1,0,1
RUS,TJK,2021.0,1,0,1
PRY,ESP,2022.0,2,0,2
SMR,NZL,2020.0,1,0,1
PAK,CYP,2016.0,2,0,2
CAN,QAT,2006.0,6,0,6
,NER,2017.0,17,0,17
IRL,BGD,1999.0,2,0,2
LKA,BEL,2020.0,1,0,1
TUN,IRN,2009.0,1,0,1
HUN,IND,2006.0,2,0,2
AUS,TON,2006.0,1,0,1
ITA,PRY,2011.0,1,0,1
ETH,BEL,2013.0,2,0,2
IRN,ISR,2015.0,1,0,1
NGA,LSO,2008.0,3,0,3
,BDI,2016.0,11,0,11
UGA,SWE,2021.0,1,0,1
GUY,,2013.0,1,0,1
CHL,PAN,2012.0,2,0,2
NOR,UGA,2016.0,2,0,2
BEL,SEN,2004.0,1,0,1
CAF,COG,2021.0,1,0,1
KHM,GBR,2020.0,6,0,6
GNQ,USA,2020.0,3,0,3
IRL,HUN,1999.0,1,0,1
MAR,GHA,2022.0,1,0,1
BGR,IRQ,2016.0,1,0,1
CMR,CHN,2022.0,1,0,1
CHE,UZB,2014.0,1,0,1
ARM,KAZ,2017.0,1,0,1
CZE,IRL,2003.0,1,0,1
MOZ,,2008.0,6,0,6
SVK,AUS,2004.0,2,0,2
ITA,URY,2016.0,3,0,3
ISR,POL,2005.0,2,0,2
UKR,NLD,2004.0,8,0,8
BRN,AUS,2014.0,1,0,1
FRA,PSE,2011.0,1,0,1
AUS,EST,2008.0,1,0,1
,TKM,1994.0,4,0,4
,AGO,2006.0,4,0,4
AUS,HND,2021.0,1,0,1
ARG,ZAF,2011.0,2,0,2
LTU,SVN,2017.0,1,0,1
NLD,MAR,2013.0,2,0,2
RWA,,2009.0,2,0,2
IRN,FIN,2014.0,13,0,13
BLZ,USA,2016.0,1,0,1
PHL,GBR,2015.0,3,0,3
COG,SLE,2021.0,1,0,1
NLD,CMR,2016.0,1,0,1
DNK,BGR,2017.0,1,0,1
URY,NLD,2021.0,2,0,2
GEO,AUS,2013.0,1,0,1
AUS,CRI,2018.0,3,0,3
TWN,PAK,2017.0,2,0,2
USA,GRL,2020.0,1,0,1
MAC,BGD,2017.0,1,0,1
NZL,CHE,2004.0,5,0,5
NPL,SLE,2018.0,1,0,1
GEO,ARE,2020.0,2,0,2
CHN,VNM,2005.0,1,0,1
NZL,SAU,2007.0,1,0,1
BFA,ESP,2018.0,1,0,1
UZB,DEU,2005.0,1,0,1
ESP,SAU,2015.0,4,0,4
HUN,AUS,2007.0,1,0,1
COG,KEN,2020.0,1,0,1
VEN,CAN,2010.0,7,0,7
YEM,PRT,2014.0,1,0,1
UKR,TUR,2019.0,3,0,3
ROU,ZAF,2021.0,1,0,1
CUB,CHE,2004.0,1,0,1
BDI,,2015.0,5,0,5
KWT,CAN,1998.0,1,0,1
MUS,USA,2010.0,1,0,1
HUN,ARE,2008.0,3,0,3
FIN,BLR,2014.0,1,0,1
FRA,HTI,2011.0,2,0,2
NIC,CRI,2013.0,1,0,1
BMU,CAN,2015.0,2,0,2
AUT,NPL,2021.0,1,0,1
ESP,PSE,2019.0,2,0,2
MAR,VEN,2005.0,1,0,1
CUB,PER,2007.0,1,0,1
KOR,PRK,2010.0,1,0,1
KHM,SVK,2009.0,1,0,1
TUR,TUN,2018.0,1,0,1
MRT,ITA,2014.0,1,0,1
GEO,RUS,2021.0,4,0,4
NZL,TUR,2002.0,1,0,1
CAN,IDN,2005.0,3,0,3
BGD,OMN,2016.0,3,0,3
PYF,,2004.0,3,0,3
SWE,CYP,2013.0,2,0,2
JPN,PLW,2009.0,1,0,1
CAN,IDN,2002.0,2,0,2
,MCO,1998.0,4,0,4
DJI,,2013.0,2,0,2
FIN,ROU,2019.0,3,0,3
SEN,USA,2000.0,1,0,1
NZL,COL,2003.0,1,0,1
CMR,TUN,2001.0,3,0,3
BEL,ARE,2000.0,1,0,1
MRT,NLD,2019.0,1,0,1
VEN,PRI,2003.0,2,0,2
PAK,NZL,2005.0,1,0,1
MEX,CRI,2006.0,4,0,4
TTO,PHL,2018.0,1,0,1
LVA,SWE,1997.0,2,0,2
IRN,NLD,2001.0,1,0,1
BOL,,2008.0,3,0,3
CZE,SAU,2004.0,1,0,1
MWI,ZAF,2005.0,3,0,3
ITA,KNA,2007.0,1,0,1
NER,IND,2011.0,2,0,2
ZAF,DNK,2007.0,3,0,3
PRT,CHE,1997.0,2,0,2
GUF,USA,2010.0,1,0,1
TUR,BOL,2007.0,1,0,1
CZE,BGD,2022.0,1,0,1
CHN,BRN,2016.0,1,0,1
CHL,KNA,2020.0,3,0,3
NOR,LUX,2007.0,1,0,1
GRC,BGD,2011.0,1,0,1
GRC,KOR,2021.0,2,0,2
PRY,FRA,2011.0,1,0,1
PER,BEL,2022.0,1,0,1
GHA,DEU,2001.0,1,0,1
MYS,DEU,2000.0,1,0,1
GIN,CHE,2014.0,1,0,1
MEX,SYR,2017.0,1,0,1
DEU,CPV,2015.0,1,0,1
TTO,KNA,2017.0,1,0,1
PRI,ECU,2021.0,1,0,1
MDA,FIN,1998.0,2,0,2
NOR,AGO,2015.0,1,0,1
YEM,CAN,2018.0,1,0,1
ZWE,NGA,1997.0,1,0,1
AUT,IDN,2000.0,1,0,1
FJI,GBR,2001.0,1,0,1
MEX,NOR,2006.0,1,0,1
BEL,THA,2021.0,2,0,2
FRA,KAZ,2021.0,3,0,3
CMR,GHA,2016.0,1,0,1
ARM,NOR,2019.0,1,0,1
TUR,LBN,2020.0,2,0,2
CRI,,2025.0,1,0,1
HRV,FIN,2018.0,2,0,2
LBN,ESP,2017.0,1,0,1
,VUT,2016.0,4,0,4
GMB,PAK,2021.0,1,0,1
FJI,TTO,2020.0,1,0,1
JPN,TUR,2022.0,1,0,1
SRB,JPN,2004.0,2,0,2
LKA,HKG,2001.0,1,0,1
LAO,PHL,2004.0,1,0,1
PAK,NLD,2010.0,4,0,4
URY,CHE,2010.0,1,0,1
MAR,MRT,2017.0,1,0,1
MKD,HRV,2021.0,1,0,1
EST,ESP,1999.0,1,0,1
USA,SOM,2019.0,2,0,2
GUF,USA,2019.0,1,0,1
ZMB,KEN,2021.0,1,0,1
MUS,ZAF,2020.0,1,0,1
ETH,OMN,2021.0,1,0,1
,ATG,2018.0,1,0,1
ITA,MWI,2021.0,1,0,1
OMN,TUR,2014.0,1,0,1
ZAF,TUR,2001.0,1,0,1
,NER,2019.0,3,0,3
SRB,CAN,2002.0,3,0,3
POL,LBY,2000.0,2,0,2
SYR,CHN,2003.0,1,0,1
MYS,UZB,2015.0,2,0,2
THA,IRL,2003.0,1,0,1
ARG,RUS,1997.0,1,0,1
LVA,TWN,2002.0,1,0,1
DZA,ZAF,2012.0,1,0,1
GBR,BEN,2008.0,2,0,2
ITA,TZA,2002.0,1,0,1
CHN,LTU,2015.0,1,0,1
ARE,VNM,2018.0,2,0,2
ZAF,HRV,2000.0,1,0,1
FRA,BIH,2010.0,1,0,1
ZAF,PRI,2009.0,1,0,1
GBR,GAB,2015.0,1,0,1
VNM,COL,2002.0,1,0,1
KHM,MDG,2003.0,1,0,1
ESP,GUM,2003.0,1,0,1
CHN,NER,2013.0,1,0,1
SYR,IRL,2014.0,1,0,1
NLD,ECU,2013.0,1,0,1
,KNA,1999.0,1,0,1
GRC,RUS,2015.0,3,0,3
FJI,FRA,2020.0,1,0,1
SAU,ITA,2006.0,1,0,1
CHN,TKM,2011.0,1,0,1
CUB,GBR,2009.0,1,0,1
IRL,LUX,2012.0,1,0,1
FRA,TCD,2012.0,1,0,1
PRI,CHL,2012.0,1,0,1
ITA,MOZ,2011.0,2,0,2
ZMB,UGA,2015.0,1,0,1
LUX,NOR,2017.0,1,0,1
BRA,MMR,2016.0,1,0,1
CHN,TCD,2017.0,1,0,1
BEL,HKG,2016.0,1,0,1
FIN,TZA,2020.0,2,0,2
ROU,UKR,2018.0,1,0,1
,TLS,2019.0,2,0,2
SDN,PRT,2009.0,1,0,1
SDN,IRL,2002.0,1,0,1
HUN,FJI,2010.0,1,0,1
NLD,PER,2006.0,3,0,3
GMB,DEU,2012.0,1,0,1
IND,KEN,2004.0,1,0,1
MOZ,AUS,2002.0,1,0,1
DZA,BEL,2003.0,1,0,1
GBR,KNA,2018.0,1,0,1
SVK,UGA,2017.0,1,0,1
EGY,NZL,2022.0,2,0,2
SAU,PER,2006.0,1,0,1
LBY,POL,2006.0,1,0,1
RUS,MOZ,2005.0,1,0,1
FRA,LVA,2003.0,1,0,1
FRA,KWT,2006.0,1,0,1
CZE,ARE,2007.0,1,0,1
BLR,AZE,1998.0,1,0,1
ZAF,TWN,2008.0,1,0,1
NZL,BGD,2009.0,2,0,2
BRA,PAK,2006.0,1,0,1
DOM,CAN,2017.0,1,0,1
CZE,COL,2012.0,1,0,1
JPN,TZA,2018.0,2,0,2
SDN,JOR,2020.0,1,0,1
DEU,MNE,2018.0,1,0,1
MAR,COG,2020.0,3,0,3
CIV,ROU,2019.0,1,0,1
MAR,MRT,2019.0,6,0,6
BLR,ISR,2021.0,1,0,1
GBR,ECU,2007.0,1,0,1
PAN,MEX,2003.0,1,0,1
IDN,PER,2008.0,1,0,1
CHN,ZAF,1997.0,1,0,1
PRT,ISL,2018.0,1,0,1
CZE,HKG,2015.0,1,0,1
IDN,EST,2018.0,1,0,1
DNK,CHL,2005.0,2,0,2
,LBR,2008.0,2,0,2
EGY,PNG,2016.0,1,0,1
AGO,PRT,2022.0,1,0,1
LBN,ESP,2010.0,1,0,1
PSE,KOR,2020.0,1,0,1
HUN,PAK,1998.0,1,0,1
LUX,DNK,2019.0,1,0,1
POL,CHL,2003.0,1,0,1
HUN,ETH,2016.0,1,0,1
NLD,MKD,2007.0,1,0,1
VEN,URY,2022.0,2,0,2
ARE,NGA,2016.0,1,0,1
ETH,SYR,2021.0,1,0,1
DOM,ECU,2021.0,1,0,1
ESP,HND,2019.0,1,0,1
JOR,JPN,2001.0,1,0,1
SEN,BOL,2003.0,1,0,1
KGZ,DEU,2004.0,1,0,1
PAN,BEL,2004.0,1,0,1
USA,MNP,2014.0,1,0,1
HUN,FJI,2019.0,1,0,1
DNK,GMB,2003.0,1,0,1
DEU,AZE,2002.0,1,0,1
SAU,NOR,2005.0,1,0,1
,SOM,1994.0,1,0,1
BLZ,THA,2016.0,1,0,1
NOR,KEN,2011.0,1,0,1
BTN,THA,2016.0,1,0,1
,TLS,2010.0,3,0,3
PER,AUT,2021.0,1,0,1
BEL,NGA,2022.0,1,0,1
GHA,ZWE,2019.0,1,0,1
AUS,MDV,2022.0,1,0,1
AUT,SAU,1999.0,1,0,1
DNK,CHL,2002.0,2,0,2
MMR,NLD,2022.0,1,0,1
ROU,KNA,2020.0,1,0,1
HKG,KAZ,2016.0,1,0,1
TJK,DEU,2000.0,1,0,1
GBR,MDG,2016.0,2,0,2
ARE,ROU,2020.0,1,0,1
CHN,SLE,2016.0,3,0,3
NZL,MAC,2002.0,1,0,1
BEL,LBN,2005.0,1,0,1
TUR,CHE,1998.0,1,0,1
FRA,ZWE,2003.0,1,0,1
NCL,,2009.0,2,0,2
ECU,PER,2013.0,1,0,1
BLR,LUX,2010.0,1,0,1
EGY,SOM,2011.0,1,0,1
ZWE,BLR,2016.0,1,0,1
TUR,GRC,2019.0,1,0,1
LTU,EST,2020.0,1,0,1
PAK,AFG,2022.0,1,0,1
BEL,IRN,1999.0,1,0,1
CMR,MAR,2010.0,1,0,1
CMR,PRT,2012.0,1,0,1
BHR,CHE,2016.0,1,0,1
ARG,GTM,2015.0,1,0,1
MUS,IND,2013.0,1,0,1
BLR,JPN,2005.0,1,0,1
CAN,MAC,2021.0,1,0,1
ROU,JOR,2010.0,1,0,1
KOR,PRT,2002.0,1,0,1
COL,ECU,1999.0,1,0,1
CHN,IND,1997.0,1,0,1
NOR,PRT,1998.0,1,0,1
IRL,ETH,2016.0,1,0,1
SAU,SWE,1999.0,1,0,1
ITA,DJI,2019.0,1,0,1
PER,GBR,2002.0,1,0,1
AUT,CUB,2002.0,1,0,1
JPN,BRN,2014.0,1,0,1
IRN,ARG,2014.0,1,0,1
MYS,BWA,2016.0,1,0,1
SVN,IDN,2017.0,1,0,1
NLD,BES,2020.0,1,0,1
LTU,NOR,2016.0,3,0,3
GUF,USA,2017.0,1,0,1
PSE,TUN,2015.0,1,0,1
MYS,POL,2020.0,1,0,1
POL,ISL,2020.0,1,0,1
KOR,NGA,2012.0,1,0,1
USA,MUS,2014.0,1,0,1
RWA,LBR,2014.0,1,0,1
CHN,SSD,2022.0,1,0,1
DZA,PER,2018.0,1,0,1
ARG,JPN,2014.0,1,0,1
OMN,KWT,2013.0,1,0,1
ITA,EST,2022.0,2,0,2
ISR,FIN,2004.0,1,0,1
HKG,UKR,2011.0,1,0,1
PAK,ITA,2008.0,2,0,2
ZAF,FIN,2000.0,1,0,1
LBY,BHR,2009.0,1,0,1
NER,GBR,2021.0,1,0,1
PRT,ECU,2013.0,1,0,1
MOZ,UGA,2014.0,1,0,1
SWZ,EGY,2021.0,1,0,1
CAN,EST,2014.0,1,0,1
POL,LBN,2014.0,1,0,1
UKR,HUN,2003.0,1,0,1
NIC,AUS,2009.0,1,0,1
IRL,IDN,2021.0,1,0,1
ECU,ITA,2007.0,2,0,2
CYP,IND,2004.0,1,0,1
ESP,SEN,2019.0,1,0,1
DNK,BGR,2019.0,1,0,1
EST,CZE,2005.0,1,0,1
PSE,CHN,2010.0,1,0,1
PAN,CHE,2022.0,1,0,1
NOR,BGD,2016.0,1,0,1
LVA,ITA,2017.0,1,0,1
JPN,KNA,2017.0,2,0,2
ESP,ARM,2017.0,1,0,1
CMR,CHE,2022.0,2,0,2
CCK,NZL,2019.0,1,0,1
BGD,NZL,2010.0,3,0,3
ROU,SRB,2020.0,1,0,1
NPL,RWA,2012.0,1,0,1
PRY,ITA,2021.0,1,0,1
JPN,OMN,2020.0,1,0,1
HND,PER,2020.0,1,0,1
SEN,NER,2012.0,1,0,1
SVN,DNK,2009.0,1,0,1
DEU,MNG,2004.0,1,0,1
FJI,CAN,2000.0,1,0,1
ZAF,GAB,2012.0,1,0,1
,ROU,2020.0,1,0,1
HUN,UZB,2019.0,1,0,1
POL,BWA,2015.0,1,0,1
TUR,KEN,2013.0,1,0,1
BEN,DEU,2003.0,2,0,2
ZWE,NZL,2013.0,1,0,1
BGR,ISR,2010.0,1,0,1
EGY,HRV,2001.0,1,0,1
NLD,JOR,2012.0,1,0,1
JAM,AUT,2010.0,1,0,1
IND,NER,2002.0,1,0,1
NOR,MEX,2012.0,1,0,1
ITA,LVA,2002.0,1,0,1
HUN,BRA,2005.0,1,0,1
UGA,GHA,2002.0,1,0,1
UGA,COL,2008.0,1,0,1
PHL,PAN,2012.0,1,0,1
BGR,BIH,2013.0,1,0,1
RWA,USA,2003.0,1,0,1
IDN,KHM,2007.0,1,0,1
SGP,NPL,2010.0,1,0,1
MEX,POL,2005.0,1,0,1
LKA,BRA,2008.0,1,0,1
CMR,MYS,2013.0,1,0,1
DNK,MWI,2016.0,1,0,1
MUS,USA,2017.0,2,0,2
CHN,CIV,2021.0,1,0,1
KOR,GTM,2015.0,1,0,1
CHE,LKA,1999.0,1,0,1
BLR,CAN,2015.0,1,0,1
CMR,BWA,2003.0,1,0,1
TUR,BRA,2006.0,1,0,1
HKG,SRB,2009.0,1,0,1
ESP,ETH,2016.0,1,0,1
GUM,DEU,2011.0,2,0,2
ROU,SAU,2021.0,1,0,1
MCO,EGY,2020.0,1,0,1
BLR,MEX,2008.0,1,0,1
SAU,IDN,2012.0,1,0,1
SDN,MWI,2002.0,1,0,1
MWI,NLD,2011.0,1,0,1
LBY,OMN,2012.0,1,0,1
SAU,SYR,2008.0,1,0,1
BGR,UKR,2009.0,1,0,1
IND,PER,2016.0,1,0,1
IRL,GUM,2019.0,1,0,1
GHA,TUN,2014.0,1,0,1
MYS,TZA,2019.0,1,0,1
USA,ISR,2018.0,303,400,-97
NLD,BEL,2007.0,84,92,-8
DEU,FRA,2007.0,314,262,52
USA,CHE,2016.0,561,494,67
USA,LBN,2020.0,53,90,-37
USA,DEU,2000.0,333,552,-219
CHN,USA,1999.0,355,134,221
ESP,GBR,2001.0,121,118,3
USA,MEX,2018.0,186,221,-35
CAN,USA,2019.0,1798,1691,107
CAN,SGP,2009.0,28,26,2
ARG,DEU,2010.0,21,11,10
FRA,SEN,2003.0,22,22,0
BRA,USA,2006.0,241,239,2
CAN,USA,2017.0,1913,1356,557
CHE,DEU,2003.0,293,414,-121
AUT,USA,2005.0,88,80,8
DEU,BGR,2004.0,12,23,-11
CAN,ZAF,2010.0,19,12,7
BRA,JPN,2009.0,12,13,-1
AUS,GBR,2003.0,322,409,-87
QAT,USA,2019.0,56,42,14
BRA,DEU,2012.0,65,66,-1
FRA,BEL,2016.0,211,192,19
DEU,DZA,2017.0,3,2,1
FRA,MEX,2007.0,43,29,14
DEU,ESP,2012.0,188,194,-6
GBR,ITA,2002.0,205,223,-18
GBR,FRA,2006.0,269,336,-67
CAN,GBR,2015.0,372,364,8
ESP,USA,2016.0,540,299,241
KOR,FRA,2008.0,11,20,-9
BIH,HRV,2012.0,9,8,1
NLD,FIN,2010.0,13,16,-3
USA,BEL,2009.0,106,125,-19
DEU,GBR,2010.0,525,496,29
ESP,FRA,2008.0,171,165,6
NZL,USA,2006.0,90,90,0
BRA,CAN,2007.0,43,31,12
AUS,CHN,2005.0,49,65,-16
USA,THA,2005.0,158,65,93
DEU,JOR,2017.0,12,10,2
GRC,NLD,2014.0,28,16,12
EGY,SAU,2008.0,79,52,27
DEU,GBR,2017.0,699,647,52
FRA,ITA,2007.0,183,218,-35
CHN,HKG,2015.0,378,498,-120
AUS,CAN,2010.0,116,168,-52
BGD,KOR,2007.0,12,4,8
CAN,CHE,2009.0,85,77,8
USA,SGP,2007.0,156,146,10
FRA,AUS,2012.0,115,65,50
CHL,COL,2019.0,26,33,-7
BEL,JPN,2014.0,21,12,9
AUS,THA,2010.0,34,13,21
ITA,NOR,2008.0,17,7,10
IDN,AUS,2011.0,9,34,-25
HUN,FRA,2010.0,12,14,-2
USA,CHL,2009.0,71,74,-3
ESP,MEX,2018.0,166,119,47
USA,FRA,1997.0,116,85,31
FRA,DEU,2004.0,219,202,17
CHE,SAU,2019.0,4,6,-2
GBR,ZAF,2014.0,90,70,20
CHE,BRA,2019.0,23,26,-3
NLD,FIN,2019.0,17,13,4
TWN,CHN,2014.0,83,61,22
USA,POL,2018.0,82,131,-49
DEU,DNK,2012.0,96,63,33
AUS,CHE,2009.0,48,45,3
NLD,CHN,2017.0,131,99,32
USA,BHR,2012.0,3,1,2
USA,IDN,2015.0,26,13,13
JPN,FRA,2013.0,71,93,-22
SWE,USA,2006.0,212,142,70
CHN,DEU,2020.0,427,429,-2
DNK,CAN,2010.0,16,23,-7
USA,PHL,2010.0,25,15,10
ESP,DEU,2020.0,248,211,37
USA,PHL,2019.0,32,36,-4
SVN,USA,2015.0,8,9,-1
EGY,USA,2008.0,45,98,-53
DEU,CAN,2011.0,165,147,18
TWN,GBR,2011.0,26,44,-18
AUT,NLD,2019.0,28,30,-2
DNK,CAN,2017.0,31,26,5
TWN,CAN,2016.0,13,13,0
CHN,GHA,2016.0,9,10,-1
ISR,DEU,2018.0,45,57,-12
USA,KOR,2022.0,273,306,-33
TUN,FRA,2013.0,74,116,-42
MYS,NGA,2015.0,34,22,12
IND,ZAF,2012.0,31,17,14
ESP,NOR,2015.0,26,9,17
IRN,KOR,2013.0,14,6,8
AUS,CAN,2017.0,145,175,-30
IND,MAR,2016.0,5,2,3
NZL,CHE,2015.0,11,3,8
THA,GBR,2001.0,13,12,1
TWN,IND,2015.0,49,53,-4
GBR,NLD,2000.0,44,52,-8
IND,ESP,2016.0,21,9,12
IRL,CAN,2014.0,42,30,12
DEU,PAK,2012.0,35,12,23
ZAF,DEU,2010.0,23,16,7
GBR,HUN,2014.0,26,41,-15
LKA,AUS,2020.0,31,24,7
USA,IRL,2012.0,113,171,-58
MEX,USA,2020.0,241,157,84
IRN,GBR,2015.0,43,31,12
VEN,COL,2017.0,33,20,13
KOR,PAK,2018.0,85,36,49
CHN,DNK,2022.0,48,45,3
UKR,RUS,2018.0,108,53,55
CHN,CHE,2015.0,37,34,3
DEU,ISR,2022.0,26,26,0
JPN,ESP,2020.0,22,12,10
AUS,USA,2022.0,294,187,107
CAN,BEL,2002.0,21,32,-11
ITA,NLD,2018.0,131,90,41
GBR,ISL,2019.0,15,6,9
IRN,CHN,2014.0,14,6,8
SAU,IND,2018.0,54,175,-121
SWE,FIN,2012.0,42,48,-6
BEL,FIN,2014.0,8,8,0
CZE,HUN,2019.0,4,9,-5
DEU,TWN,2005.0,11,6,5
PAK,KOR,2009.0,7,8,-1
GBR,IRN,2011.0,41,36,5
KOR,CHN,2009.0,77,66,11
BEL,SGP,2020.0,6,7,-1
POL,NLD,2020.0,18,8,10
OMN,CAN,2020.0,7,10,-3
ESP,CUB,2020.0,7,19,-12
QAT,USA,2017.0,47,59,-12
HUN,FRA,2017.0,13,14,-1
IND,GRC,2011.0,4,1,3
SWE,JPN,2016.0,21,31,-10
NLD,FIN,2017.0,20,20,0
JAM,GBR,2016.0,2,3,-1
NLD,CHN,2019.0,148,152,-4
CHL,COL,2017.0,22,25,-3
ARG,MEX,2014.0,14,18,-4
LBN,CAN,2020.0,20,4,16
SVN,JPN,2019.0,2,1,1
FRA,CZE,2016.0,37,16,21
MYS,CHN,2016.0,16,7,9
DNK,CAN,2019.0,30,26,4
AUS,NLD,2018.0,85,81,4
ZAF,DEU,2019.0,35,21,14
CHN,SAU,2019.0,42,43,-1
RUS,ZAF,2020.0,2,4,-2
NZL,ZAF,2020.0,5,14,-9
DNK,DEU,2022.0,37,68,-31
CHE,NOR,2020.0,20,14,6
LTU,GBR,2021.0,10,2,8
ARG,AUT,2020.0,4,1,3
BRA,GBR,2022.0,55,35,20
JPN,KOR,2021.0,75,79,-4
LBN,DEU,2020.0,8,6,2
UGA,USA,2021.0,25,19,6
TUR,DZA,2020.0,1,1,0
FIN,FRA,2017.0,21,32,-11
NZL,IND,2003.0,9,4,5
AUT,USA,2002.0,119,104,15
GBR,ITA,2005.0,159,189,-30
ESP,AUS,2020.0,39,38,1
IRL,CHN,2018.0,31,22,9
ITA,GBR,2012.0,397,230,167
PAK,SAU,2018.0,69,70,-1
GBR,EST,2019.0,12,7,5
AUS,THA,2019.0,39,20,19
ZAF,CAN,2018.0,17,18,-1
ZAF,NZL,2020.0,14,5,9
SWE,GBR,2011.0,98,129,-31
TUR,TWN,2021.0,4,2,2
RUS,UZB,2008.0,9,3,6
DEU,JOR,2010.0,10,8,2
AUS,TUR,2021.0,5,12,-7
JOR,GBR,2007.0,6,14,-8
ZAF,USA,2012.0,66,83,-17
NLD,CAN,2017.0,70,56,14
SRB,ITA,2008.0,4,2,2
AUS,CHN,2002.0,25,42,-17
KHM,FRA,2010.0,6,1,5
PRT,NLD,2011.0,16,17,-1
HKG,JPN,2010.0,7,2,5
POL,CHE,2007.0,13,13,0
AUS,TWN,2008.0,13,11,2
FIN,AUT,2013.0,6,7,-1
GBR,GHA,2013.0,15,11,4
CHN,ISR,2015.0,11,10,1
CHN,BEL,2001.0,9,3,6
KOR,SWE,2012.0,11,13,-2
GBR,SGP,1998.0,11,5,6
HKG,DEU,2015.0,7,11,-4
ITA,AUT,2022.0,22,25,-3
CHE,THA,2018.0,7,3,4
GBR,KOR,2003.0,20,26,-6
ROU,CHE,2013.0,8,3,5
KHM,FRA,2017.0,5,4,1
POL,ESP,2013.0,16,35,-19
NLD,RUS,2018.0,9,22,-13
UKR,DEU,1999.0,20,7,13
DEU,KOR,1999.0,8,6,2
CHE,ITA,2003.0,67,80,-13
MMR,CHN,2019.0,7,2,5
IND,PHL,2019.0,13,3,10
SWE,CHE,2008.0,27,14,13
FIN,FRA,2019.0,23,36,-13
EST,FIN,2020.0,12,15,-3
GRC,DEU,2022.0,23,20,3
JPN,ROU,2012.0,3,2,1
CUB,ITA,2002.0,6,4,2
CUB,ITA,2005.0,3,1,2
CHE,LIE,2019.0,5,3,2
MDA,USA,2007.0,2,1,1
ISR,ITA,2021.0,9,15,-6
ECU,DEU,2016.0,1,5,-4
USA,ETH,2005.0,3,7,-4
USA,NOR,1999.0,19,17,2
NLD,AUS,2016.0,83,66,17
GBR,RUS,2013.0,39,39,0
SEN,FRA,2008.0,22,22,0
URY,ESP,2006.0,4,3,1
KOR,ITA,2015.0,9,8,1
ESP,CHN,2022.0,36,28,8
KOR,DEU,2014.0,42,43,-1
ECU,USA,2022.0,11,9,2
NGA,DEU,2014.0,8,6,2
ITA,TWN,2013.0,4,3,1
VEN,MEX,2008.0,4,9,-5
TWN,AUS,1999.0,1,1,0
CHE,BRA,2010.0,12,17,-5
TWN,DEU,2018.0,20,11,9
RUS,CAN,2022.0,7,3,4
VNM,FRA,2018.0,8,63,-55
ETH,TWN,2020.0,4,13,-9
NOR,FIN,2016.0,9,19,-10
DEU,MOZ,2018.0,1,1,0
BRA,PAN,2019.0,2,1,1
AUS,JOR,2020.0,15,7,8
SWE,MYS,2018.0,6,1,5
SVK,USA,2022.0,1,2,-1
AUT,CHE,2011.0,49,60,-11
CHE,CAN,2006.0,59,52,7
ITA,IND,2001.0,3,4,-1
SWE,SAU,2006.0,5,1,4
CHN,SAU,2017.0,33,38,-5
FRA,HKG,2021.0,7,4,3
SGP,CHE,2014.0,18,18,0
NLD,NPL,2021.0,1,1,0
PRK,CHN,2021.0,3,4,-1
EGY,DEU,2011.0,31,52,-21
BEL,BEN,2011.0,3,2,1
COL,CHE,2012.0,3,1,2
IND,BGD,2018.0,13,9,4
PRT,ARG,2016.0,5,2,3
SWE,ISL,2004.0,7,9,-2
AUT,CHN,2021.0,16,14,2
PRT,KOR,2020.0,4,2,2
FRA,CIV,2019.0,19,7,12
LKA,CAN,2017.0,6,4,2
MEX,FRA,2003.0,20,41,-21
VEN,COL,2010.0,14,2,12
USA,ROU,2009.0,31,20,11
FIN,CHN,2007.0,6,8,-2
NLD,CAN,2010.0,48,58,-10
CAN,ZAF,2019.0,9,34,-25
RUS,DEU,2004.0,163,84,79
HUN,CZE,2007.0,3,3,0
GBR,QAT,2014.0,32,2,30
MYS,IND,2012.0,30,61,-31
CAN,TUR,2015.0,19,11,8
ECU,ITA,2008.0,1,1,0
THA,CAN,2016.0,11,26,-15
USA,CZE,2008.0,54,43,11
NGA,GHA,2009.0,4,3,1
AUT,ESP,2004.0,7,8,-1
AUS,THA,2017.0,28,17,11
TUN,CHE,2013.0,2,2,0
AUT,BRA,2012.0,4,3,1
DEU,PRT,2015.0,27,41,-14
PRI,USA,2007.0,44,59,-15
DEU,NOR,2000.0,10,2,8
USA,HND,2015.0,2,2,0
ECU,MEX,2012.0,2,2,0
EGY,CHE,2010.0,3,8,-5
NER,FRA,2006.0,5,6,-1
IRL,SWE,2013.0,16,3,13
UZB,RUS,2001.0,8,4,4
BLR,RUS,1999.0,9,3,6
DEU,SVK,2008.0,11,19,-8
DEU,UKR,2005.0,17,37,-20
ISR,USA,2000.0,80,85,-5
USA,AUT,1997.0,9,14,-5
IND,CAN,1998.0,6,5,1
DEU,UKR,2002.0,21,50,-29
GRC,FRA,2002.0,23,21,2
PRT,BRA,2002.0,16,25,-9
KAZ,RUS,2004.0,5,4,1
ITA,BGR,2008.0,5,6,-1
CHE,LIE,2010.0,3,2,1
USA,CRI,2008.0,10,9,1
CAN,BEL,2005.0,14,29,-15
HUN,SWE,2002.0,8,11,-3
NZL,DEU,2003.0,17,16,1
USA,NLD,1998.0,54,67,-13
GRC,POL,2003.0,1,1,0
ITA,POL,2014.0,17,71,-54
DEU,LUX,2022.0,10,7,3
SGP,JPN,2009.0,14,26,-12
DEU,ROU,2009.0,33,15,18
ITA,SVN,2002.0,6,2,4
AUS,ISR,2009.0,8,23,-15
BRA,AUS,2009.0,17,10,7
PHL,GBR,2004.0,3,4,-1
ARE,SAU,2019.0,9,35,-26
ISR,IND,2013.0,14,34,-20
SWE,SVK,2002.0,3,2,1
IND,CHN,2000.0,1,4,-3
GEO,ITA,2013.0,1,1,0
BRA,RUS,2004.0,8,1,7
RUS,ITA,2004.0,15,17,-2
IND,PAK,1997.0,1,2,-1
DZA,USA,2003.0,3,5,-2
NLD,ZAF,2004.0,6,14,-8
AUT,NLD,2010.0,15,18,-3
GBR,BGR,2004.0,6,8,-2
MEX,VEN,2015.0,5,5,0
CHE,ESP,1998.0,7,8,-1
ZAF,RUS,2002.0,8,2,6
AUT,AUS,2003.0,19,8,11
CHE,FIN,1999.0,5,4,1
BGR,DEU,2003.0,22,20,2
NLD,NZL,2004.0,9,3,6
IND,ITA,2007.0,24,7,17
TUR,GBR,1998.0,6,13,-7
NOR,JPN,2004.0,2,5,-3
PRT,POL,2007.0,3,3,0
IND,CAN,1997.0,8,5,3
COL,GBR,2000.0,2,2,0
CAN,JOR,2012.0,19,10,9
POL,CZE,2000.0,3,2,1
LUX,FRA,2005.0,4,14,-10
FIN,DEU,1997.0,5,4,1
SWE,BRA,2017.0,11,16,-5
SWE,BRA,2019.0,10,27,-17
HUN,NLD,1998.0,2,1,1
DNK,FIN,1997.0,5,1,4
USA,HUN,2000.0,10,36,-26
MEX,ITA,2002.0,7,11,-4
ARE,SAU,2017.0,4,39,-35
PRT,ESP,2006.0,22,33,-11
CHN,SWE,2006.0,22,36,-14
BOL,SWE,2014.0,1,4,-3
SGP,USA,1998.0,7,15,-8
CHN,FIN,1998.0,1,1,0
CAN,CHN,1999.0,22,48,-26
CAN,ZAF,2017.0,22,23,-1
MYS,JOR,2014.0,9,4,5
BRA,ITA,1997.0,3,8,-5
ITA,QAT,2019.0,7,2,5
MEX,BEL,2008.0,3,2,1
KEN,USA,2004.0,16,19,-3
GBR,ISL,2010.0,9,1,8
FIN,FRA,2010.0,17,18,-1
DEU,SVN,2012.0,12,10,2
PSE,USA,2016.0,4,7,-3
FRA,THA,2016.0,25,8,17
NOR,ESP,2012.0,10,9,1
EGY,CAN,2012.0,21,40,-19
CZE,MKD,2010.0,1,1,0
NLD,CHN,2010.0,25,40,-15
USA,KHM,2016.0,2,7,-5
ZAF,BWA,2013.0,6,5,1
BEL,POL,2015.0,9,13,-4
SWE,TWN,2018.0,3,8,-5
USA,HRV,2006.0,11,13,-2
KOR,AUS,2008.0,15,19,-4
IRL,ESP,2014.0,19,24,-5
AUT,PRT,2008.0,3,1,2
KOR,HKG,2022.0,7,6,1
SGP,PAK,2009.0,3,2,1
ZAF,BRA,2011.0,5,1,4
ESP,HRV,2014.0,7,4,3
ISR,PSE,2014.0,10,4,6
KEN,BEL,2002.0,3,4,-1
GBR,EST,2010.0,6,2,4
DNK,ISL,2010.0,6,7,-1
FRA,CIV,2010.0,27,25,2
ARE,SGP,2014.0,1,4,-3
NOR,POL,2016.0,5,10,-5
JPN,ITA,2019.0,18,19,-1
ZAF,DEU,2017.0,29,24,5
ITA,BGD,2018.0,4,4,0
BEL,MEX,2018.0,9,6,3
ROU,FRA,2019.0,17,23,-6
BTN,AUS,2014.0,2,1,1
CUB,COL,2008.0,3,1,2
GEO,DEU,2011.0,2,3,-1
PAK,VNM,2019.0,4,1,3
ESP,SGP,2016.0,11,6,5
SRB,HRV,2017.0,7,10,-3
USA,GMB,2014.0,1,3,-2
CZE,ESP,2020.0,19,25,-6
CHE,SVK,2018.0,2,5,-3
CHE,ESP,1997.0,5,12,-7
NLD,KOR,2019.0,9,4,5
KOR,BEL,2021.0,11,8,3
PAK,TUR,2020.0,10,11,-1
AUT,MNG,2020.0,3,1,2
NZL,KOR,2018.0,6,7,-1
KAZ,GBR,2015.0,4,6,-2
CHE,BRA,2017.0,14,26,-12
NLD,IRN,2018.0,22,33,-11
MMR,CHN,2017.0,1,3,-2
AUS,KWT,2014.0,4,1,3
EGY,CHE,2019.0,9,7,2
POL,CAN,2022.0,3,7,-4
TWN,KOR,2018.0,20,7,13
KEN,KOR,2019.0,1,1,0
GRC,CAN,2020.0,14,8,6
GUY,GUF,2014.0,2,1,1
ESP,AUT,2003.0,9,9,0
HKG,MAC,2006.0,8,3,5
USA,NLD,1997.0,32,44,-12
MMR,GBR,2019.0,2,1,1
CAN,UKR,2008.0,4,4,0
DZA,MAR,2022.0,5,2,3
DNK,BEL,2015.0,14,15,-1
GRC,PRT,2013.0,5,2,3
CHE,ROU,2006.0,5,3,2
SWE,DEU,2007.0,90,97,-7
ZAF,GBR,2000.0,13,9,4
GBR,KEN,2001.0,10,8,2
KHM,CAN,2019.0,2,1,1
DNK,FIN,1998.0,4,4,0
RUS,NOR,2006.0,7,7,0
ROU,AUS,2007.0,3,2,1
FIN,ZAF,2006.0,3,1,2
SAU,ZAF,2016.0,3,2,1
PRT,BEL,2016.0,22,15,7
IND,FRA,1997.0,4,5,-1
MYS,NLD,2019.0,3,11,-8
JPN,ITA,2017.0,18,33,-15
SRB,FRA,2017.0,10,3,7
SRB,LBY,2015.0,6,1,5
HKG,NOR,2018.0,2,1,1
JOR,ITA,2020.0,1,2,-1
FRA,CIV,2017.0,23,11,12
TUR,AZE,2014.0,4,2,2
AUT,THA,2003.0,5,2,3
JPN,LKA,2011.0,11,2,9
EGY,BHR,2021.0,3,2,1
GHA,ZAF,2013.0,12,1,11
FRA,MAR,2022.0,25,24,1
ROU,FRA,2010.0,33,26,7
IDN,SGP,2011.0,4,1,3
SVN,AUT,2018.0,6,5,1
LBN,ITA,2018.0,1,2,-1
CAN,LUX,2015.0,3,1,2
PSE,CAN,2019.0,1,1,0
GBR,CIV,2021.0,2,1,1
RUS,PRT,2019.0,2,4,-2
AUS,ECU,2016.0,3,3,0
ZAF,ESP,2021.0,7,4,3
HKG,IRN,2014.0,2,3,-1
RUS,SAU,2021.0,6,2,4
NOR,NZL,2019.0,6,6,0
RUS,PRT,2017.0,5,6,-1
USA,UKR,2021.0,11,12,-1
NZL,CZE,2018.0,1,1,0
HKG,JPN,2017.0,11,14,-3
GRC,CHE,2001.0,4,6,-2
GHA,FRA,2018.0,2,1,1
SEN,MLI,2018.0,3,2,1
NPL,THA,2019.0,4,5,-1
COL,FRA,2012.0,10,10,0
ITA,UGA,2014.0,2,4,-2
DEU,ISL,2022.0,2,1,1
NLD,ARG,2014.0,1,5,-4
HKG,JPN,2019.0,8,14,-6
DNK,IND,2015.0,12,22,-10
MAR,CAN,2020.0,3,10,-7
TWN,NZL,2017.0,6,2,4
LUX,FRA,2002.0,4,2,2
SAU,DZA,2012.0,8,4,4
ARE,SAU,2010.0,6,6,0
EGY,YEM,2015.0,3,1,2
CHE,ARE,2011.0,3,1,2
SGP,USA,1997.0,4,6,-2
AUS,RUS,2016.0,9,10,-1
BRA,HRV,2019.0,1,3,-2
FRA,COG,2007.0,8,6,2
NGA,ZAF,2008.0,14,8,6
SWE,LVA,2009.0,4,1,3
DZA,ESP,2014.0,3,4,-1
JPN,MNG,2008.0,7,1,6
USA,AZE,2004.0,2,1,1
SWE,BRA,2010.0,6,9,-3
PYF,FRA,2004.0,8,3,5
HUN,JPN,2000.0,2,2,0
KOR,UZB,2003.0,1,1,0
JPN,HUN,2006.0,5,4,1
SGP,DEU,2003.0,3,11,-8
MEX,ITA,2005.0,7,5,2
ITA,COL,2008.0,1,2,-1
BMU,USA,2002.0,5,2,3
JPN,ITA,2010.0,19,21,-2
CHE,VNM,2019.0,5,5,0
NLD,AUT,2004.0,11,5,6
IND,SWE,2007.0,10,10,0
GBR,BHR,2008.0,4,1,3
UZB,UKR,2009.0,2,1,1
SVN,BIH,2007.0,1,1,0
POL,UKR,2013.0,8,18,-10
POL,AUT,2004.0,3,3,0
ARM,RUS,2015.0,1,2,-1
LTU,USA,2021.0,5,4,1
TUN,MAR,2022.0,1,1,0
SAU,CZE,2020.0,1,1,0
USA,MDG,2007.0,2,2,0
USA,ARM,2005.0,3,8,-5
AUS,SAU,2008.0,10,7,3
USA,MAR,2016.0,5,8,-3
CHN,BGD,2016.0,8,17,-9
KOR,SGP,2003.0,8,4,4
OMN,MYS,2019.0,6,16,-10
EGY,JOR,2009.0,2,1,1
NLD,KOR,2017.0,6,4,2
NZL,IRN,2014.0,3,9,-6
SVN,IRL,2017.0,2,1,1
NLD,POL,2022.0,7,5,2
LTU,DEU,2020.0,7,8,-1
NAM,DEU,2016.0,1,1,0
USA,SDN,2017.0,2,3,-1
SVN,FRA,2009.0,2,5,-3
CMR,USA,2014.0,3,10,-7
FRA,REU,2009.0,8,10,-2
NZL,CHN,2007.0,5,6,-1
GBR,ISL,2017.0,9,5,4
LTU,SWE,2015.0,4,4,0
CHN,SAU,2010.0,13,1,12
EGY,RUS,2014.0,2,4,-2
CHE,VNM,2017.0,4,2,2
CZE,TUR,2017.0,3,6,-3
BEN,BFA,2020.0,2,3,-1
RWA,CHN,2021.0,6,3,3
CHN,MEX,2014.0,3,2,1
SWE,NZL,2001.0,2,4,-2
DNK,JPN,2004.0,6,11,-5
ITA,CUB,2013.0,3,4,-1
RUS,GEO,2011.0,3,4,-1
NCL,AUS,2015.0,1,3,-2
USA,SVN,2004.0,13,10,3
IRQ,FRA,2013.0,1,2,-1
FIN,BEL,2019.0,13,10,3
ESP,PER,2009.0,4,10,-6
ZAF,HKG,2018.0,2,3,-1
KWT,EGY,2011.0,11,4,7
SDN,DEU,2015.0,2,4,-2
USA,BOL,2002.0,1,2,-1
POL,BGR,2017.0,1,1,0
NOR,CHN,2004.0,4,3,1
ARE,NZL,2004.0,2,2,0
NZL,NLD,2007.0,3,4,-1
PER,USA,1998.0,3,3,0
MEX,COL,2006.0,10,9,1
DNK,GRL,2006.0,1,4,-3
MAR,GBR,2018.0,4,3,1
MYS,NLD,2017.0,9,6,3
CAN,TTO,2013.0,2,4,-2
TZA,ZAF,2015.0,3,5,-2
AUT,EGY,2018.0,5,2,3
DEU,JOR,2019.0,9,11,-2
CHE,MYS,2021.0,4,2,2
EGY,PSE,2018.0,6,4,2
IRL,THA,2020.0,2,2,0
DNK,ISL,2017.0,5,4,1
MYS,JPN,2003.0,7,10,-3
MAR,BEL,2020.0,3,4,-1
CAN,NGA,2015.0,4,8,-4
DEU,TUR,2022.0,13,28,-15
NLD,EGY,2020.0,5,4,1
MWI,CHE,2021.0,3,5,-2
ESP,IRL,2012.0,7,18,-11
GBR,EST,2017.0,9,5,4
TWN,NZL,2019.0,1,4,-3
PAK,SGP,2016.0,4,2,2
KOR,IRL,2012.0,4,3,1
UGA,AUS,2014.0,2,1,1
IRN,PHL,2021.0,2,1,1
BRA,HRV,2017.0,2,1,1
AUS,CZE,2014.0,12,5,7
HKG,RUS,2004.0,1,4,-3
HUN,CAN,2020.0,5,6,-1
CAN,DNK,2000.0,4,4,0
ARE,GBR,2001.0,4,8,-4
BMU,USA,2005.0,2,1,1
FRA,SRB,2006.0,2,3,-1
KOR,UKR,2002.0,2,3,-1
HUN,SWE,2005.0,6,2,4
FRA,MYS,2005.0,1,2,-1
EGY,KWT,2005.0,7,2,5
KGZ,KAZ,2015.0,3,1,2
SGP,THA,2002.0,3,1,2
THA,JPN,1998.0,3,2,1
JOR,AUS,2009.0,3,9,-6
CHL,BRA,2003.0,4,5,-1
DNK,GRC,2009.0,3,8,-5
SRB,SWE,2003.0,2,1,1
FJI,NZL,2002.0,1,1,0
RUS,ESP,1999.0,6,8,-2
MAR,FRA,1997.0,5,11,-6
BEN,NGA,2011.0,1,2,-1
COL,CAN,2002.0,3,6,-3
AUS,GMB,2017.0,1,1,0
AUS,COL,2007.0,2,1,1
MDG,FRA,2003.0,3,3,0
CAN,SWE,2000.0,5,7,-2
QAT,AUS,2012.0,4,6,-2
SWE,LTU,2001.0,2,10,-8
MUS,GBR,2009.0,1,1,0
TZA,IND,2019.0,2,1,1
JPN,NZL,2003.0,10,12,-2
BEL,BFA,2003.0,4,3,1
FRA,LTU,2008.0,2,3,-1
NLD,JPN,2012.0,10,19,-9
SRB,BRA,2006.0,3,1,2
NZL,MYS,2002.0,2,2,0
LTU,ESP,2017.0,3,1,2
PRT,CZE,2008.0,3,1,2
IRN,JPN,2007.0,7,12,-5
EST,SWE,2021.0,6,7,-1
POL,SVK,2021.0,5,3,2
DZA,TUN,2009.0,1,1,0
JOR,CAN,2017.0,7,12,-5
TGO,FRA,2007.0,2,4,-2
BFA,USA,2018.0,2,2,0
RUS,BRA,2014.0,12,9,3
PNG,CHE,2013.0,2,1,1
USA,TUN,2014.0,5,5,0
LBY,MYS,2014.0,1,10,-9
ARE,CAN,2011.0,4,18,-14
BEL,PAK,2020.0,2,2,0
THA,DEU,2003.0,4,5,-1
PER,FRA,2016.0,2,4,-2
GHA,DNK,2016.0,1,3,-2
AUS,FJI,2016.0,8,6,2
NLD,PRT,2022.0,7,10,-3
CZE,HUN,2017.0,3,7,-4
AUS,GMB,2019.0,1,1,0
IRL,EGY,2017.0,1,2,-1
PER,USA,1997.0,2,3,-1
LKA,GBR,2006.0,4,7,-3
HUN,RUS,2019.0,1,3,-2
NPL,BGD,2020.0,1,3,-2
KHM,FRA,2019.0,4,7,-3
NGA,ETH,2021.0,1,1,0
IND,PHL,2017.0,8,1,7
CHL,COL,2010.0,7,16,-9
HKG,NGA,2021.0,2,4,-2
TUR,GBR,1997.0,2,3,-1
CAN,FIN,2000.0,2,7,-5
DEU,TWN,2002.0,8,1,7
SGP,ESP,2000.0,1,2,-1
ARE,ITA,2017.0,3,15,-12
FIN,BEL,2017.0,7,8,-1
SYC,AUS,2021.0,1,1,0
OMN,EGY,2021.0,5,3,2
CAN,CUB,2010.0,1,4,-3
KGZ,TUR,2022.0,2,3,-1
COL,MEX,2004.0,4,3,1
ESP,IRN,2008.0,2,1,1
NLD,BGD,2021.0,5,2,3
AUT,ETH,2016.0,2,1,1
USA,ECU,2006.0,3,13,-10
SGP,POL,2014.0,3,8,-5
SVN,GBR,2006.0,4,2,2
SAU,JOR,2008.0,4,8,-4
SGP,BEL,2006.0,2,4,-2
ESP,UKR,2013.0,2,5,-3
IND,PHL,2010.0,4,3,1
EGY,IRN,2021.0,2,2,0
ESP,SVK,2000.0,1,3,-2
GBR,MAC,2017.0,2,1,1
SWE,HKG,2020.0,3,7,-4
ZAF,DNK,2008.0,1,1,0
CZE,UZB,2010.0,1,1,0
NPL,DEU,2009.0,2,1,1
SRB,HRV,2010.0,3,10,-7
SDN,CAN,2021.0,1,1,0
CHE,SAU,2017.0,4,12,-8
ISL,ISR,2018.0,1,1,0
MAR,YEM,2020.0,2,1,1
SDN,ZAF,2016.0,1,2,-1
MLT,POL,2015.0,1,1,0
ETH,MWI,2020.0,1,1,0
MYS,NOR,2020.0,3,2,1
PER,ECU,2017.0,1,5,-4
GBR,ROU,2022.0,6,8,-2
LBN,JOR,2020.0,3,1,2
SWE,ZAF,2022.0,4,8,-4
TWN,TUR,2003.0,1,2,-1
POL,BGR,2010.0,1,2,-1
CAN,PAK,2001.0,1,1,0
SLE,GBR,2015.0,1,6,-5
DNK,ISL,2019.0,3,4,-1
MEX,IRL,2007.0,2,2,0
EST,CHE,2006.0,1,1,0
TTO,USA,2009.0,6,8,-2
ROU,HUN,1998.0,3,1,2
GHA,JPN,2008.0,2,1,1
HKG,IND,2020.0,7,16,-9
CHE,VNM,2010.0,2,1,1
DNK,IRL,2016.0,10,4,6
BRA,HRV,2010.0,4,1,3
FRA,MLI,2015.0,2,5,-3
ISR,UKR,2006.0,2,1,1
USA,JOR,2000.0,1,4,-3
BGR,RUS,2004.0,3,8,-5
EGY,SWE,2007.0,1,3,-2
GBR,JAM,2006.0,2,3,-1
PER,BRA,2009.0,3,5,-2
MWI,ITA,2020.0,1,1,0
IND,IRQ,2012.0,4,2,2
BIH,GBR,2010.0,1,1,0
SWE,ETH,2016.0,1,2,-1
ISR,CHE,1999.0,4,3,1
OMN,SAU,2018.0,2,10,-8
NZL,MEX,2020.0,1,3,-2
FRA,TUN,1997.0,2,1,1
MLI,LUX,2018.0,1,1,0
USA,ARM,2002.0,3,6,-3
IRL,PAK,2016.0,2,7,-5
MYS,HKG,2013.0,1,5,-4
ETH,IRN,2022.0,3,2,1
EGY,ISR,2021.0,2,1,1
USA,GEO,2000.0,1,2,-1
ECU,ESP,2005.0,1,5,-4
URY,MEX,2016.0,3,6,-3
MAC,PRT,2021.0,2,1,1
USA,FJI,2001.0,1,1,0
HUN,AUS,2008.0,2,2,0
GBR,ZWE,2011.0,3,2,1
ARG,BEL,2006.0,1,1,0
PHL,USA,1998.0,1,1,0
GBR,SVK,2004.0,2,4,-2
PRT,ITA,2004.0,5,7,-2
DEU,UGA,2009.0,1,2,-1
BRA,ITA,1998.0,2,12,-10
ESP,CMR,2004.0,1,1,0
SYR,MAR,2020.0,4,1,3
BEL,TZA,2012.0,2,2,0
DNK,MEX,2007.0,3,1,2
BRA,QAT,2013.0,1,1,0
OMN,ZAF,2014.0,1,2,-1
MAR,FRA,1998.0,3,19,-16
SRB,FRA,2019.0,8,7,1
SRB,NLD,2015.0,1,6,-5
IRL,EGY,2019.0,4,3,1
GBR,MLT,2022.0,4,2,2
RWA,SWE,2016.0,4,3,1
AUS,BGD,2007.0,3,6,-3
SVK,FRA,2020.0,2,4,-2
SVK,ITA,2013.0,1,3,-2
AUT,TWN,2022.0,2,2,0
HUN,TUR,2009.0,4,1,3
BRA,CMR,2015.0,2,2,0
DNK,NZL,2009.0,5,10,-5
JPN,MEX,2001.0,2,1,1
KHM,USA,2006.0,2,1,1
IDN,FIN,2016.0,1,1,0
ITA,QAT,2017.0,3,4,-1
MYS,NLD,2010.0,1,3,-2
USA,SDN,2019.0,4,4,0
NZL,PHL,2020.0,2,1,1
BGR,FRA,2020.0,1,4,-3
BRA,PRY,2020.0,4,2,2
IND,PAK,1998.0,2,1,1
AUS,MAC,2016.0,1,1,0
THA,SWE,2007.0,1,9,-8
ESP,HUN,2000.0,1,2,-1
CMR,BEL,2015.0,2,5,-3
AFG,PHL,2019.0,1,1,0
URY,ITA,2006.0,1,1,0
OMN,FRA,2014.0,2,2,0
NGA,CAN,2004.0,2,1,1
LTU,DNK,2010.0,4,1,3
FIN,CZE,2014.0,2,4,-2
FIN,IRN,2013.0,4,12,-8
NPL,THA,2010.0,4,1,3
PRI,CHN,2015.0,3,1,2
GNB,DNK,2014.0,4,1,3
SVK,BEL,2016.0,2,2,0
PHL,DEU,2014.0,3,4,-1
BRA,ISR,2002.0,1,1,0
TTO,IND,2020.0,3,1,2
NGA,BEN,2009.0,1,4,-3
BHR,EGY,2016.0,2,2,0
ARG,URY,2006.0,2,3,-1
RUS,PAK,2013.0,1,2,-1
GBR,THA,1997.0,2,3,-1
NLD,SUR,2014.0,3,1,2
AUS,MYS,2001.0,3,7,-4
KAZ,FRA,2015.0,2,3,-1
TUR,NOR,2013.0,3,2,1
HKG,BEL,2015.0,1,3,-2
UKR,NLD,2015.0,5,2,3
THA,KEN,2011.0,2,1,1
CZE,NZL,2020.0,3,1,2
BTN,IND,2020.0,1,4,-3
CZE,MKD,2019.0,1,1,0
HUN,RUS,2017.0,1,2,-1
ESP,VEN,2021.0,4,6,-2
NPL,THA,2017.0,1,4,-3
USA,PAN,1999.0,1,3,-2
CAN,CRI,2003.0,1,3,-2
ISL,FRA,2020.0,2,4,-2
SAU,MAR,2012.0,2,5,-3
QAT,PAK,2020.0,3,4,-1
ISR,SRB,2008.0,1,1,0
LTU,DNK,2019.0,1,1,0
DEU,PHL,2009.0,2,3,-1
PAK,HUN,2014.0,2,1,1
NZL,RUS,2003.0,1,1,0
ZAF,AUT,2022.0,3,3,0
MYS,YEM,2022.0,4,3,1
TUR,GEO,2017.0,1,1,0
CHE,LBN,2017.0,2,1,1
LBN,SYR,2011.0,2,1,1
SVK,JPN,1998.0,2,2,0
ITA,HUN,1999.0,3,4,-1
ECU,ESP,2002.0,2,1,1
CZE,BEL,1997.0,1,1,0
BWA,DEU,2020.0,1,1,0
SWE,CHL,1999.0,2,1,1
AUT,SVK,1997.0,2,2,0
GBR,CHL,2001.0,4,1,3
ARE,POL,2021.0,2,1,1
BRA,COL,2006.0,4,6,-2
AUS,POL,1999.0,1,2,-1
USA,NCL,2016.0,1,4,-3
NOR,NZL,2017.0,1,7,-6
ITA,NZL,2001.0,1,2,-1
PRI,COL,2005.0,2,3,-1
BRA,NZL,2007.0,1,1,0
LBY,DEU,2008.0,1,2,-1
COL,SWE,2006.0,1,2,-1
CZE,DNK,2008.0,1,4,-3
SWE,KEN,2011.0,1,1,0
POL,LTU,2006.0,1,3,-2
KOR,MEX,2009.0,1,1,0
ZWE,KEN,2018.0,2,1,1
SVN,IRL,2019.0,1,1,0
CAN,CUB,2017.0,2,12,-10
ARE,ITA,2019.0,2,15,-13
BEL,TUN,2003.0,2,1,1
SYR,GBR,2006.0,1,2,-1
CAN,PRT,1999.0,2,3,-1
VEN,ITA,2014.0,1,1,0
ARG,ECU,2022.0,1,3,-2
UKR,PRT,2008.0,3,1,2
DEU,LTU,2006.0,1,11,-10
CAN,ROU,2000.0,1,5,-4
POL,IND,2011.0,3,21,-18
IRL,ISR,2009.0,2,9,-7
SGP,THA,2005.0,2,2,0
AUS,NGA,2012.0,1,6,-5
EGY,IRL,2021.0,4,2,2
LKA,CAN,2019.0,2,5,-3
IRQ,GBR,2008.0,2,2,0
PER,PRT,2016.0,1,2,-1
USA,DMA,2020.0,1,1,0
NLD,MWI,2005.0,1,1,0
NPL,JPN,2006.0,2,5,-3
EGY,AUT,2022.0,1,1,0
DEU,NPL,2014.0,3,6,-3
SRB,FRA,2010.0,2,2,0
IRN,ARE,2015.0,1,1,0
NZL,MYS,2005.0,1,1,0
BGD,FIN,2010.0,1,1,0
COG,FRA,2014.0,2,8,-6
SVK,IND,2022.0,1,1,0
FJI,NZL,2005.0,1,2,-1
UKR,LTU,2022.0,3,1,2
ISR,EGY,2017.0,1,1,0
OMN,BEL,2022.0,1,1,0
CHL,CHE,2003.0,3,3,0
OMN,MYS,2017.0,1,17,-16
NGA,GBR,1999.0,1,4,-3
CAN,BFA,2013.0,1,1,0
KOR,FIN,2003.0,1,1,0
TZA,IND,2017.0,1,3,-2
GMB,SEN,2005.0,1,1,0
GAB,USA,2016.0,3,2,1
ECU,SWE,2020.0,1,1,0
BEL,EGY,2009.0,1,4,-3
NOR,NZL,2010.0,1,4,-3
VNM,NLD,2005.0,1,2,-1
GTM,MEX,2021.0,2,3,-1
ITA,SVN,2005.0,2,2,0
NLD,KOR,2010.0,2,8,-6
IND,NOR,2003.0,1,3,-2
KWT,FRA,2018.0,1,1,0
ASM,USA,2005.0,1,1,0
PAN,CHL,2013.0,1,1,0
THA,CHN,2009.0,1,3,-2
ZAF,ITA,2018.0,5,3,2
ARG,ISR,2021.0,1,1,0
UGA,NLD,2013.0,1,1,0
TUR,BGD,2021.0,2,1,1
JPN,ARG,2018.0,2,1,1
UGA,DEU,2019.0,1,2,-1
HRV,NZL,2019.0,1,1,0
PRT,QAT,2018.0,1,1,0
THA,PRT,2015.0,1,1,0
SVN,SVK,2019.0,2,2,0
AUS,BWA,2013.0,1,2,-1
ROU,CAN,2021.0,1,3,-2
SAU,NLD,2008.0,1,3,-2
CHE,BGR,2004.0,2,5,-3
BGR,ITA,2009.0,2,5,-3
OMN,JOR,2007.0,1,3,-2
ITA,DZA,2002.0,1,1,0
UKR,BLR,2006.0,1,1,0
SAU,AUT,2015.0,1,1,0
ITA,BLR,2001.0,1,2,-1
EGY,FIN,2015.0,1,4,-3
FIN,KOR,2016.0,3,4,-1
USA,RWA,2008.0,1,2,-1
NZL,EGY,2011.0,1,1,0
SGP,ETH,2016.0,1,3,-2
OMN,MYS,2010.0,1,5,-4
PSE,CAN,2017.0,1,2,-1
COL,TWN,2020.0,1,1,0
SVN,HRV,2004.0,1,1,0
NOR,EST,2013.0,2,2,0
BEN,GHA,2014.0,2,1,1
BRN,ARE,2014.0,1,1,0
ZAF,MAR,2022.0,1,2,-1
ETH,ZWE,2014.0,1,1,0
PAK,SDN,2009.0,1,1,0
MLI,CAN,2018.0,2,3,-1
SVN,NLD,1999.0,1,1,0
GBR,GRD,2009.0,1,1,0
GBR,MOZ,2016.0,1,2,-1
RWA,KEN,2022.0,1,1,0
DEU,KGZ,2018.0,1,1,0
GBR,KHM,2013.0,1,1,0
FRA,PHL,2011.0,1,1,0
CZE,EGY,2021.0,3,1,2
FRA,ETH,2008.0,1,2,-1
VEN,COL,2019.0,39,22,17
NOR,DEU,2003.0,22,32,-10
CAN,USA,2010.0,1466,1308,158
USA,IND,2018.0,712,1317,-605
ARG,DEU,2017.0,30,28,2
DEU,USA,2012.0,1110,1117,-7
USA,THA,2002.0,95,52,43
IND,USA,2003.0,517,264,253
SAU,CAN,2011.0,19,76,-57
SAU,USA,2006.0,22,56,-34
TZA,CHE,2011.0,4,1,3
AUS,ZAF,2016.0,29,37,-8
JPN,NPL,2014.0,9,6,3
USA,PHL,2017.0,33,31,2
IRN,SWE,2015.0,18,22,-4
NLD,CAN,2019.0,60,64,-4
ROU,FRA,2017.0,20,23,-3
CHL,FRA,2020.0,37,34,3
ESP,COL,2012.0,65,38,27
PAK,FRA,2021.0,6,6,0
BEL,NLD,2021.0,137,142,-5
ITA,ESP,2004.0,88,49,39
GBR,MAC,2019.0,4,3,1
ESP,SWE,2016.0,73,39,34
USA,FRA,1998.0,133,136,-3
AUS,ESP,2022.0,26,10,16
AUS,CAN,2019.0,171,157,14
SWE,CAN,2020.0,30,37,-7
PER,ECU,2019.0,4,3,1
CAN,NOR,2015.0,22,16,6
KOR,LKA,2020.0,6,2,4
NZL,CAN,2021.0,21,19,2
IND,SAU,2001.0,5,5,0
SRB,HRV,2019.0,7,5,2
IDN,TWN,2022.0,15,21,-6
FRA,CHN,2012.0,122,121,1
ITA,RUS,2011.0,7,16,-9
CYP,GRC,2009.0,11,25,-14
GBR,BRA,2007.0,43,40,3
COG,USA,2009.0,3,6,-3
CZE,TUR,2019.0,6,6,0
NOR,DNK,2001.0,23,5,18
KOR,QAT,2018.0,5,1,4
AUT,IND,2016.0,8,11,-3
USA,BGD,1997.0,2,1,1
LTU,ESP,2019.0,3,3,0
THA,VNM,2022.0,6,5,1
NLD,ITA,2003.0,41,57,-16
FIN,DEU,1998.0,12,7,5
COL,ARG,2000.0,12,2,10
POL,BEL,2008.0,14,3,11
VEN,ESP,2000.0,5,5,0
USA,BFA,2003.0,1,1,0
GRC,JPN,2018.0,1,2,-1
RUS,JPN,2008.0,14,18,-4
IND,BRA,2004.0,7,2,5
USA,ISL,2009.0,13,10,3
USA,AUT,1998.0,22,32,-10
SWE,BGD,2009.0,4,3,1
USA,BGD,1998.0,1,1,0
NOR,GBR,2015.0,43,69,-26
CAN,TWN,2004.0,14,11,3
LTU,TUR,2017.0,1,1,0
GBR,GMB,2018.0,9,13,-4
ISR,CHN,2014.0,8,10,-2
DEU,MNG,2015.0,2,2,0
TUR,JPN,2012.0,8,5,3
HUN,FRA,2019.0,8,10,-2
AUT,NLD,2017.0,23,28,-5
RUS,SGP,2016.0,3,1,2
CHL,ESP,2001.0,13,19,-6
EGY,CHE,2017.0,6,1,5
PAK,GBR,2015.0,43,69,-26
BEL,KEN,2016.0,7,5,2
NER,BEL,2014.0,1,1,0
ESP,VNM,2021.0,2,1,1
SDN,MAR,2020.0,1,1,0
HRV,SVN,2009.0,6,3,3
IND,KEN,2015.0,3,3,0
MEX,UKR,2005.0,3,1,2
ARG,DEU,2019.0,26,18,8
ROU,DNK,2014.0,3,2,1
HUN,BEL,2008.0,4,7,-3
DNK,TWN,2006.0,1,1,0
JPN,ARE,2020.0,5,1,4
AGO,BRA,2016.0,1,1,0
ARG,DZA,2009.0,1,1,0
CZE,SVK,1999.0,7,5,2
SVN,CZE,2004.0,1,1,0
PRT,NOR,2009.0,1,1,0
FIN,BEL,2010.0,5,2,3
MAR,DZA,2013.0,5,3,2
IRN,AUS,2003.0,2,7,-5
GAB,FRA,2016.0,8,10,-2
BHR,IRL,2013.0,1,2,-1
SWE,IRL,2022.0,10,5,5
DEU,DZA,2010.0,2,3,-1
QAT,USA,2010.0,10,21,-11
KWT,IND,2004.0,4,9,-5
CHE,COG,2015.0,7,3,4
CHE,LBN,2019.0,3,4,-1
SRB,TUR,2016.0,3,1,2
RUS,ARG,2001.0,2,4,-2
USA,BOL,2005.0,3,7,-4
ARE,LBN,2011.0,4,4,0
JPN,ZMB,2000.0,1,1,0
GBR,DZA,2005.0,1,3,-2
FRA,TUN,1998.0,9,4,5
HUN,ISR,2016.0,2,1,1
SGP,GRC,2020.0,2,3,-1
GBR,BWA,2011.0,3,2,1
HUN,RUS,2010.0,2,2,0
IND,AUT,2012.0,6,3,3
MEX,PRI,2018.0,1,1,0
EST,DEU,1998.0,1,2,-1
TZA,GBR,1997.0,1,1,0
FRA,LAO,2009.0,1,2,-1
IND,HKG,2001.0,4,5,-1
CHL,BEL,2003.0,1,3,-2
ISR,AUT,2009.0,3,4,-1
MNG,KOR,2018.0,5,16,-11
CHN,SRB,2022.0,2,1,1
ISR,BRA,2004.0,2,1,1
BRA,BOL,2021.0,3,1,2
GBR,SVN,2008.0,4,9,-5
MEX,CAN,2000.0,3,6,-3
CHE,HRV,2016.0,4,4,0
POL,SAU,2019.0,2,2,0
CHE,EGY,2014.0,4,3,1
SWE,ARG,2006.0,3,2,1
SWE,NIC,2009.0,1,2,-1
CHE,TWN,2021.0,3,7,-4
CYP,TWN,2021.0,1,1,0
LUX,ITA,2016.0,1,14,-13
CUB,JPN,2001.0,1,1,0
SGP,PHL,2008.0,2,3,-1
TUR,POL,2015.0,2,5,-3
EGY,LBN,2011.0,2,1,1
YEM,IND,2022.0,1,10,-9
SEN,MRT,2002.0,1,1,0
KEN,AUS,2022.0,1,2,-1
NLD,AZE,2019.0,1,1,0
NLD,PHL,2012.0,2,2,0
MEX,UKR,2002.0,1,3,-2
CRI,FRA,2008.0,2,2,0
JOR,CAN,2010.0,2,13,-11
IND,JAM,2020.0,1,1,0
MRT,SAU,2017.0,1,1,0
NPL,DNK,2020.0,1,1,0
ARE,AUT,2011.0,1,1,0
JOR,ARE,1998.0,1,1,0
CAN,CUB,2019.0,1,6,-5
GBR,BRB,2004.0,1,1,0
ROU,PRT,2016.0,1,3,-2
BFA,CIV,2015.0,1,1,0
DNK,LVA,2003.0,1,1,0
ARE,PAK,2013.0,1,7,-6
SVN,RUS,2019.0,2,1,1
AUT,KEN,2009.0,1,1,0
HRV,ESP,2011.0,1,1,0
GRC,,2011.0,1419,0,1419
GBR,,2013.0,11497,0,11497
,JPN,2004.0,24930,0,24930
,GBR,2001.0,19575,0,19575
DEU,,2009.0,12159,0,12159
IRN,,2024.0,56155,0,56155
,ITA,2008.0,12988,0,12988
,TWN,2004.0,6680,0,6680
RUS,,2013.0,4626,0,4626
DNK,,2012.0,1025,0,1025
,JPN,1996.0,16576,0,16576
,DEU,2008.0,21993,0,21993
BGR,,2023.0,2249,0,2249
CHL,,2021.0,2697,0,2697
,AUS,2002.0,6945,0,6945
USA,,2004.0,26957,0,26957
BOL,FRA,2007.0,3,0,3
,VEN,2013.0,298,0,298
,SGP,2002.0,1537,0,1537
JPN,,2000.0,1633,0,1633
POL,,2013.0,2400,0,2400
LBN,,2021.0,538,0,538
,USA,2016.0,91289,0,91289
MEX,,2022.0,9939,0,9939
,EGY,2003.0,1348,0,1348
,CHE,1994.0,3345,0,3345
ARG,,2015.0,1386,0,1386
EST,,2018.0,313,0,313
,MEX,2000.0,3090,0,3090
,AUS,2005.0,7174,0,7174
UKR,,2007.0,512,0,512
JOR,,2018.0,213,0,213
PRT,,2017.0,1665,0,1665
,URY,2004.0,153,0,153
,SVN,2002.0,539,0,539
,SVN,2005.0,558,0,558
,EST,2002.0,230,0,230
PRT,,2019.0,2331,0,2331
,EST,2005.0,361,0,361
MYS,,2014.0,984,0,984
,TWN,1996.0,1372,0,1372
ZMB,,2022.0,145,0,145
,ARG,2018.0,1769,0,1769
GRC,RUS,2004.0,3,0,3
TZA,,2023.0,1012,0,1012
,TUR,2013.0,7839,0,7839
CHN,,1999.0,953,0,953
CYP,,2008.0,20,0,20
SVN,,2018.0,570,0,570
ISR,,2025.0,2,0,2
,CZE,2007.0,2355,0,2355
,SGP,2005.0,1290,0,1290
CHE,,2003.0,743,0,743
CRI,,2016.0,75,0,75
SWE,,1999.0,75,0,75
MDG,,2011.0,22,0,22
,MAR,2002.0,493,0,493
,LTU,1994.0,179,0,179
TUR,FIN,1999.0,1,0,1
,MKD,2006.0,124,0,124
ALB,,2020.0,61,0,61
TUN,KOR,2016.0,1,0,1
MEX,GHA,2020.0,1,0,1
KEN,,2018.0,308,0,308
ITA,KAZ,2014.0,2,0,2
,SAU,2009.0,1173,0,1173
,COL,2011.0,1920,0,1920
COD,,2023.0,234,0,234
PNG,,2016.0,23,0,23
,KEN,2008.0,440,0,440
PRY,,2023.0,166,0,166
MDA,,2022.0,113,0,113
,MAR,2005.0,473,0,473
BIH,IRL,2019.0,2,0,2
,BRN,2012.0,34,0,34
,BLR,2009.0,218,0,218
GHA,BEL,2017.0,2,0,2
,LVA,2015.0,243,0,243
ESP,ARE,2016.0,9,0,9
,BWA,2014.0,84,0,84
PSE,QAT,2020.0,4,0,4
NAM,,2019.0,25,0,25
,GMB,2013.0,29,0,29
,MOZ,2013.0,96,0,96
,KWT,2013.0,156,0,156
,PRK,2013.0,23,0,23
,BHS,2013.0,6,0,6
LVA,POL,1998.0,1,0,1
PER,CHN,2008.0,1,0,1
MCO,USA,2020.0,3,0,3
IRL,SAU,1998.0,1,0,1
CHE,LBR,2013.0,1,0,1
COG,DEU,2020.0,2,0,2
,BTN,2013.0,7,0,7
KHM,,2020.0,53,0,53
TUN,,2003.0,41,0,41
PRK,,2022.0,68,0,68
HND,,2010.0,1,0,1
PRT,AGO,2020.0,2,0,2
PRT,,2010.0,559,0,559
NAM,,2017.0,24,0,24
,SDN,2013.0,97,0,97
URY,PRT,2020.0,2,0,2
,BIH,2003.0,132,0,132
ROU,,2002.0,66,0,66
,KHM,2009.0,60,0,60
ISR,COL,2012.0,1,0,1
COG,,2014.0,30,0,30
IND,,1999.0,263,0,263
,LKA,1995.0,28,0,28
ARG,KOR,2002.0,2,0,2
DZA,NOR,2019.0,2,0,2
NAM,,2010.0,6,0,6
KAZ,EST,2015.0,2,0,2
FIN,LBN,2004.0,1,0,1
UZB,TWN,2019.0,1,0,1
SWE,KOR,2004.0,1,0,1
USA,NIC,2002.0,8,0,8
,MRT,2014.0,16,0,16
URY,,2006.0,32,0,32
JPN,JOR,1999.0,1,0,1
AUT,LIE,2018.0,2,0,2
EGY,,2005.0,233,0,233
LBY,SAU,2019.0,8,0,8
IDN,ITA,2005.0,2,0,2
DNK,HUN,1998.0,1,0,1
GRD,,2023.0,59,0,59
MWI,NGA,2020.0,2,0,2
ROU,BRA,2016.0,1,0,1
BOL,,2007.0,7,0,7
MNE,,2018.0,19,0,19
SDN,,2016.0,68,0,68
,CYP,1998.0,73,0,73
RUS,IDN,2020.0,1,0,1
THA,,2007.0,332,0,332
HTI,,2011.0,2,0,2
SYR,,2011.0,17,0,17
UKR,GBR,2000.0,12,0,12
NER,ETH,2013.0,1,0,1
,MDA,2001.0,36,0,36
CIV,ZAF,2008.0,1,0,1
ROU,,2005.0,189,0,189
,PYF,2000.0,10,0,10
GRL,,2007.0,2,0,2
,MNE,2007.0,23,0,23
,GLP,2007.0,8,0,8
BIH,IRL,2010.0,1,0,1
ARE,,2004.0,38,0,38
,CYP,1997.0,20,0,20
EGY,,2002.0,45,0,45
HUN,EGY,1999.0,2,0,2
ITA,ETH,2005.0,1,0,1
CYP,ESP,2001.0,1,0,1
PHL,NPL,2004.0,1,0,1
,URY,1996.0,42,0,42
MLI,AUS,2018.0,1,0,1
AUT,OMN,2000.0,1,0,1
,UGA,1994.0,26,0,26
JAM,,2013.0,23,0,23
,BRB,1998.0,15,0,15
TZA,DNK,2001.0,5,0,5
ESP,PRY,2015.0,3,0,3
MDA,TUR,2005.0,1,0,1
ECU,CHL,2001.0,1,0,1
ROU,BEL,1999.0,2,0,2
ESP,SVN,2014.0,4,0,4
UKR,AUS,2009.0,4,0,4
IND,FRA,1998.0,10,0,10
ITA,BFA,2004.0,2,0,2
SVK,PAK,2016.0,1,0,1
PRT,ISR,2011.0,1,0,1
GBR,MAC,2010.0,1,0,1
MYS,EST,2014.0,1,0,1
NIC,,2016.0,14,0,14
PRI,MEX,2005.0,2,0,2
NOR,LUX,2008.0,2,0,2
MCO,,2006.0,3,0,3
,FRO,2005.0,5,0,5
SWE,SRB,2008.0,4,0,4
BFA,GIN,2021.0,1,0,1
BHR,DZA,2012.0,2,0,2
LTU,ESP,2010.0,1,0,1
LUX,PYF,2020.0,1,0,1
IRN,EST,2017.0,4,0,4
ECU,THA,2016.0,1,0,1
NGA,PRT,2018.0,2,0,2
LSO,NGA,2009.0,1,0,1
KHM,NZL,2018.0,1,0,1
HND,,2019.0,10,0,10
,SYC,2011.0,6,0,6
DEU,PSE,2018.0,5,0,5
,MTQ,2014.0,10,0,10
UGA,IND,2022.0,2,0,2
GEO,,2006.0,34,0,34
MDA,CAN,2002.0,1,0,1
LUX,BRA,2006.0,5,0,5
LBN,SDN,2008.0,1,0,1
ZAF,ERI,2008.0,1,0,1
HND,,2017.0,14,0,14
ZAF,PER,2016.0,1,0,1
ARE,GRC,2013.0,3,0,3
ISR,FIN,2015.0,2,0,2
DNK,ARG,2012.0,1,0,1
SVK,IRL,2015.0,1,0,1
PAK,JOR,2011.0,2,0,2
UGA,COD,2021.0,1,0,1
,PRY,2007.0,24,0,24
UGA,DEU,2017.0,9,0,9
BWA,CHE,2013.0,1,0,1
PRT,GNB,2019.0,1,0,1
SDN,CHE,2018.0,1,0,1
BGD,EST,2021.0,1,0,1
JOR,OMN,2011.0,4,0,4
YEM,,2025.0,4,0,4
LBY,SAU,2010.0,2,0,2
BGD,FIN,2019.0,3,0,3
SVN,IRL,2010.0,1,0,1
ETH,UGA,2022.0,3,0,3
PRY,USA,2003.0,1,0,1
ITA,ETH,2002.0,2,0,2
LAO,THA,2007.0,1,0,1
KWT,JOR,2008.0,1,0,1
THA,POL,2011.0,1,0,1
FRA,PER,2004.0,2,0,2
VNM,ITA,2001.0,1,0,1
FRA,MDG,1999.0,3,0,3
,GTM,2000.0,9,0,9
SGP,HUN,2015.0,1,0,1
,BRB,1997.0,1,0,1
BEL,BGD,2004.0,3,0,3
IND,IRN,2022.0,2,0,2
CHE,MLI,2003.0,2,0,2
GEO,NLD,2021.0,1,0,1
BWA,NGA,2020.0,1,0,1
MOZ,,2007.0,4,0,4
MRT,,2013.0,4,0,4
GNQ,,2006.0,1,0,1
AUS,KEN,2013.0,7,0,7
NOR,NPL,2003.0,3,0,3
MUS,ITA,2009.0,1,0,1
CHE,COD,2020.0,1,0,1
EGY,LBY,2009.0,6,0,6
ITA,JOR,2004.0,3,0,3
GBR,GAB,2004.0,1,0,1
IND,THA,2003.0,2,0,2
DEU,URY,2011.0,1,0,1
GHA,GRC,2014.0,1,0,1
TZA,THA,2012.0,1,0,1
NPL,ITA,2004.0,1,0,1
COD,CHE,2012.0,1,0,1
,MDV,2010.0,1,0,1
BHR,OMN,2014.0,1,0,1
CUB,PRT,2001.0,1,0,1
CUB,ARG,2016.0,4,0,4
MEX,SLV,2016.0,2,0,2
LTU,DNK,2017.0,3,0,3
EGY,SYR,2012.0,2,0,2
GBR,VNM,1998.0,3,0,3
SGP,SVN,2020.0,1,0,1
CHL,SWE,2022.0,3,0,3
CHE,SAU,2010.0,2,0,2
BHR,ARE,2014.0,3,0,3
GTM,CHL,2021.0,1,0,1
CHE,PSE,2022.0,1,0,1
CHL,PRI,2011.0,1,0,1
IDN,ITA,2002.0,2,0,2
BWA,AUS,2008.0,1,0,1
JPN,BOL,2016.0,1,0,1
TZA,BEL,2007.0,2,0,2
IRN,EST,2019.0,5,0,5
RUS,HUN,2002.0,1,0,1
CAN,MOZ,2021.0,1,0,1
CZE,CRI,2003.0,1,0,1
SDN,SAU,1999.0,1,0,1
CHL,TWN,2021.0,1,0,1
SDN,SWE,2012.0,1,0,1
MAC,IRL,2012.0,1,0,1
KGZ,DEU,2015.0,1,0,1
GHA,GMB,2014.0,1,0,1
MAR,CIV,2018.0,3,0,3
TWN,IRL,2020.0,3,0,3
ZMB,ESP,2018.0,1,0,1
PAK,CMR,2019.0,2,0,2
SEN,COD,2019.0,2,0,2
SEN,BFA,2021.0,3,0,3
SVN,SVK,2010.0,7,0,7
PRT,PSE,2007.0,1,0,1
IDN,IND,2003.0,1,0,1
MUS,HKG,2001.0,1,0,1
GUY,CHE,2006.0,1,0,1
UKR,ISR,2015.0,2,0,2
VUT,FRA,2003.0,2,0,2
HRV,ISR,1999.0,1,0,1
FRA,DJI,2009.0,3,0,3
BIH,BEL,2020.0,1,0,1
CHE,CIV,2020.0,2,0,2
DEU,SYR,2003.0,4,0,4
CZE,CHN,2003.0,1,0,1
LCA,USA,2017.0,1,0,1
BRA,NGA,1998.0,1,0,1
HRV,KWT,2014.0,1,0,1
SWE,JOR,2003.0,1,0,1
UKR,MEX,1999.0,5,0,5
PAK,SWE,2001.0,2,0,2
FIN,ISR,2007.0,1,0,1
ZWE,FRA,1999.0,1,0,1
KEN,AUT,2001.0,2,0,2
ZAF,TWN,2007.0,2,0,2
RUS,PRT,2010.0,4,0,4
GUM,AUS,2012.0,1,0,1
USA,BHS,2002.0,1,0,1
PRI,SWE,2013.0,1,0,1
IND,TTO,2009.0,2,0,2
PAK,VNM,2017.0,1,0,1
ESP,PNG,2001.0,1,0,1
MEX,DZA,2006.0,1,0,1
SGP,MAC,2006.0,2,0,2
ZAF,IDN,2006.0,1,0,1
GUY,USA,2022.0,1,0,1
CHN,GRC,2009.0,1,0,1
UZB,LKA,2007.0,1,0,1
ITA,PER,2004.0,1,0,1
BRA,NOR,2008.0,1,0,1
USA,LIE,2017.0,1,0,1
MUS,,2011.0,9,0,9
,COD,2006.0,12,0,12
ROU,SVN,2007.0,1,0,1
SWE,LUX,2011.0,3,0,3
PRI,ARG,2012.0,2,0,2
VNM,NGA,2021.0,3,0,3
BEL,ABW,2018.0,1,0,1
NZL,FJI,2007.0,1,0,1
CHN,ZWE,2021.0,1,0,1
CHL,NOR,2015.0,1,0,1
BRA,IRN,2002.0,1,0,1
LKA,AUT,2016.0,1,0,1
ISR,HUN,2004.0,2,0,2
PAK,BWA,2019.0,1,0,1
NLD,MRT,2017.0,1,0,1
SGP,CHL,2019.0,1,0,1
SRB,RUS,2012.0,2,0,2
SRB,IRL,2009.0,1,0,1
CMR,POL,2011.0,1,0,1
DEU,ETH,2001.0,3,0,3
TWN,CHE,2006.0,1,0,1
BGR,CHN,2008.0,2,0,2
CZE,PRT,2005.0,3,0,3
TUR,HUN,2018.0,2,0,2
NZL,MDV,2013.0,1,0,1
AUS,BHR,2007.0,1,0,1
USA,SWZ,2011.0,1,0,1
LBY,ZAF,2007.0,1,0,1
ITA,DZA,2005.0,2,0,2
TUN,MRT,2007.0,1,0,1
CUB,CHE,2015.0,1,0,1
HUN,SDN,2018.0,1,0,1
DEU,OMN,2001.0,1,0,1
URY,SRB,2020.0,1,0,1
YEM,CHE,2019.0,2,0,2
BLR,AUT,2013.0,1,0,1
BMU,CAN,2004.0,1,0,1
CIV,CHE,2012.0,4,0,4
BGD,FIN,2017.0,3,0,3
ROU,MEX,2007.0,1,0,1
URY,COL,2015.0,1,0,1
AUS,MUS,2015.0,1,0,1
KAZ,ISR,2019.0,3,0,3
ISR,NZL,2022.0,2,0,2
,MDV,2019.0,6,0,6
BWA,ZWE,2018.0,1,0,1
TUN,PRT,2013.0,1,0,1
NOR,THA,2018.0,2,0,2
GRC,BWA,2020.0,1,0,1
ESP,GTM,2011.0,1,0,1
DZA,CHN,2009.0,1,0,1
RWA,BWA,2017.0,1,0,1
REU,,2013.0,3,0,3
LBY,NLD,2013.0,1,0,1
LAO,PHL,2015.0,2,0,2
IRL,IRN,2003.0,1,0,1
KOR,ARM,2018.0,1,0,1
,TCD,1997.0,4,0,4
CHE,LAO,2018.0,2,0,2
POL,BGR,2019.0,2,0,2
SRB,ZAF,2005.0,1,0,1
,BLZ,2004.0,1,0,1
CZE,LTU,2020.0,2,0,2
GBR,PNG,2018.0,2,0,2
EST,DEU,1997.0,1,0,1
LBY,THA,2008.0,2,0,2
NZL,SAU,2008.0,1,0,1
GBR,DZA,2002.0,3,0,3
NCL,PYF,2003.0,1,0,1
,TCD,1998.0,2,0,2
BGR,JPN,1999.0,1,0,1
BWA,BRB,2007.0,1,0,1
LUX,AUT,2004.0,1,0,1
ECU,DNK,2001.0,1,0,1
GRC,SVK,1999.0,1,0,1
HUN,KOR,2003.0,2,0,2
BRA,SVK,1997.0,1,0,1
TUR,HRV,2004.0,1,0,1
MOZ,SWE,2004.0,1,0,1
PSE,OMN,2008.0,1,0,1
ISR,ARE,2013.0,1,0,1
ESP,CPV,2012.0,1,0,1
ROU,IRL,2009.0,1,0,1
ARM,GRC,2007.0,1,0,1
USA,LIE,2010.0,1,0,1
MDG,BEL,2011.0,1,0,1
LTU,UKR,2009.0,1,0,1
IRL,NGA,2016.0,3,0,3
SGP,CHL,2017.0,2,0,2
TWN,HND,2014.0,1,0,1
COL,BOL,2021.0,1,0,1
VNM,LAO,2018.0,1,0,1
IRN,SAU,2015.0,2,0,2
LAO,,2003.0,2,0,2
LBN,AUT,2016.0,1,0,1
IND,EGY,2001.0,1,0,1
CAN,CMR,2004.0,1,0,1
AUS,GRD,2010.0,1,0,1
KWT,QAT,2013.0,1,0,1
ZWE,POL,2016.0,1,0,1
HND,CHE,2017.0,1,0,1
LSO,ZAF,2007.0,1,0,1
NZL,BOL,2010.0,1,0,1
,BRA,2020.0,15,0,15
SYC,FRA,2011.0,1,0,1
,ABW,2002.0,1,0,1
GRL,CAN,2013.0,1,0,1
POL,SAU,2017.0,1,0,1
BGD,AUT,2011.0,1,0,1
,GIB,2009.0,1,0,1
CAF,SEN,2002.0,1,0,1
PYF,,2015.0,5,0,5
UKR,ZAF,1998.0,1,0,1
PHL,NLD,2009.0,1,0,1
KOR,NOR,2004.0,1,0,1
ARM,GBR,2013.0,2,0,2
DEU,MMR,2007.0,1,0,1
IRL,,2025.0,3,0,3
KWT,ITA,2011.0,1,0,1
CHN,FIN,1997.0,1,0,1
KAZ,AZE,2018.0,1,0,1
SYR,TUR,2015.0,2,0,2
ZAF,DZA,2015.0,1,0,1
TUR,GEO,2019.0,1,0,1
BRA,KEN,2018.0,2,0,2
KEN,NZL,2021.0,1,0,1
TUR,BGR,2020.0,1,0,1
ETH,TUR,2019.0,1,0,1
CAN,COG,2006.0,1,0,1
MAR,ITA,2011.0,1,0,1
KEN,SOM,2022.0,1,0,1
SVN,JPN,2017.0,3,0,3
KIR,CHE,2018.0,1,0,1
BEL,SEN,2015.0,1,0,1
UKR,SVN,2021.0,1,0,1
SGP,IRL,1998.0,2,0,2
BEN,IND,2018.0,1,0,1
ZAF,BFA,2021.0,2,0,2
MAC,SGP,2022.0,1,0,1
SRB,SVN,2022.0,3,0,3
LUX,LAO,2013.0,1,0,1
TJK,UKR,1997.0,1,0,1
CZE,KAZ,2016.0,1,0,1
CHN,NOR,1997.0,1,0,1
LBR,,2013.0,1,0,1
LBY,IND,2002.0,1,0,1
MEX,PAN,2021.0,1,0,1
OMN,SGP,2015.0,1,0,1
ARG,SLV,2021.0,2,0,2
RUS,IRQ,2006.0,1,0,1
FRA,EGY,1998.0,2,0,2
NER,NCL,1998.0,1,0,1
ITA,ARE,2005.0,1,0,1
VNM,NLD,2002.0,2,0,2
FRA,YEM,2013.0,1,0,1
,FRO,2002.0,2,0,2
MRT,SAU,2010.0,1,0,1
SYC,DEU,2011.0,1,0,1
BRN,NZL,2009.0,1,0,1
ITA,MNE,2016.0,1,0,1
GIN,,2005.0,1,0,1
CHE,MNG,2016.0,1,0,1
SDN,FRA,2012.0,1,0,1
DZA,SRB,2017.0,1,0,1
BEL,MAR,1998.0,1,0,1
CAN,ALB,2009.0,1,0,1
GBR,COD,2001.0,1,0,1
GBR,NAM,1998.0,1,0,1
MKD,FRA,2013.0,2,0,2
GBR,VNM,1997.0,1,0,1
ITA,LBN,2001.0,1,0,1
PRT,GNB,2010.0,1,0,1
SWE,URY,2016.0,2,0,2
EGY,EST,2020.0,1,0,1
AUS,EST,2007.0,2,0,2
BGR,POL,2009.0,1,0,1
ITA,PAN,2020.0,1,0,1
JPN,DZA,2007.0,1,0,1
CZE,LBY,2008.0,2,0,2
NLD,BRN,2013.0,1,0,1
NOR,ZWE,2016.0,2,0,2
BGR,IRN,2008.0,1,0,1
DEU,RWA,2011.0,1,0,1
IND,BEN,2004.0,1,0,1
HRV,POL,2007.0,2,0,2
NLD,LBN,2009.0,1,0,1
BRA,SLV,2007.0,1,0,1
GHA,SWE,2015.0,1,0,1
BGD,CZE,2014.0,1,0,1
IND,ARG,2012.0,2,0,2
PAN,NLD,2017.0,1,0,1
PHL,CHE,2022.0,1,0,1
CHN,NOR,1998.0,1,0,1
ZWE,LSO,2014.0,1,0,1
POL,PER,2022.0,1,0,1
MNG,AUT,2021.0,1,0,1
MLI,GIN,2020.0,1,0,1
CMR,MDG,2011.0,1,0,1
MSR,,2023.0,1,0,1
FIN,TUR,2000.0,1,0,1
GBR,ECU,2008.0,1,0,1
SYR,CAN,2006.0,2,0,2
NPL,BEL,2018.0,1,0,1
KAZ,CAN,2003.0,1,0,1
PER,NIC,2005.0,1,0,1
NGA,ARG,2006.0,1,0,1
GEO,AUT,2007.0,1,0,1
BRA,TUN,2022.0,1,0,1
BDI,FRA,2011.0,1,0,1
ISR,JOR,2020.0,1,0,1
,MDV,2017.0,2,0,2
VEN,CRI,2017.0,1,0,1
UZB,NOR,2006.0,1,0,1
ZWE,AUS,2003.0,1,0,1
NZL,NOR,2006.0,2,0,2
GBR,GIB,2014.0,1,0,1
GTM,ARG,2009.0,1,0,1
IRN,LBN,2011.0,1,0,1
ISR,SVN,2011.0,2,0,2
CUB,PER,2008.0,1,0,1
NLD,MLT,2016.0,1,0,1
LBY,SAU,2017.0,1,0,1
THA,CHL,2018.0,1,0,1
NZL,ISL,2019.0,1,0,1
LBN,BGR,2019.0,1,0,1
ARE,IND,1997.0,1,0,1
KWT,OMN,2008.0,1,0,1
AUS,NCL,2005.0,2,0,2
PAK,BHR,2011.0,1,0,1
TUR,NPL,2014.0,1,0,1
ECU,URY,2018.0,3,0,3
GBR,THA,1998.0,2,0,2
VEN,AUS,2002.0,1,0,1
BGD,CYP,2015.0,1,0,1
UKR,BGR,2020.0,1,0,1
ESP,DZA,2008.0,1,0,1
CAN,LAO,2008.0,1,0,1
AUS,MCO,2006.0,1,0,1
MRT,GBR,2004.0,1,0,1
PSE,BGD,2007.0,1,0,1
,BLZ,1996.0,2,0,2
NZL,POL,2004.0,1,0,1
BEL,NER,2016.0,1,0,1
MRT,DEU,2002.0,1,0,1
CZE,BRA,2007.0,1,0,1
CHE,TCD,2013.0,1,0,1
DEU,PYF,2007.0,1,0,1
DEU,SLE,2013.0,1,0,1
GRC,TWN,2014.0,1,0,1
AUS,PLW,2013.0,1,0,1
BGR,NLD,1998.0,1,0,1
VEN,ARE,2019.0,2,0,2
KEN,GHA,2001.0,1,0,1
USA,LTU,1998.0,1,0,1
CAN,CIV,2021.0,2,0,2
POL,SAU,2010.0,1,0,1
FJI,THA,2014.0,1,0,1
NPL,ARG,2015.0,1,0,1
HUN,OMN,2003.0,1,0,1
BFA,KEN,2014.0,1,0,1
LBN,IRQ,2017.0,1,0,1
URY,DNK,2010.0,1,0,1
CUB,CZE,2009.0,1,0,1
TWN,NLD,2003.0,1,0,1
BOL,BRA,2011.0,1,0,1
BEL,ZWE,2012.0,1,0,1
KOR,KAZ,2007.0,2,0,2
HKG,FJI,2019.0,1,0,1
IDN,POL,2011.0,1,0,1
POL,NPL,2015.0,1,0,1
KAZ,ISR,2010.0,1,0,1
GBR,SGP,1997.0,1,0,1
PAK,ZAF,2003.0,1,0,1
KWT,BHR,2011.0,1,0,1
GHA,IRL,2016.0,1,0,1
NLD,AZE,2017.0,1,0,1
ESP,SDN,2020.0,1,0,1
CAF,SEN,2005.0,1,0,1
JPN,MOZ,2019.0,1,0,1
SRB,CHL,2015.0,1,0,1
CHL,AFG,2017.0,1,0,1
BGD,IRL,2022.0,1,0,1
JPN,HRV,2006.0,1,0,1
AUT,BFA,2014.0,2,0,2
MEX,LBR,2020.0,1,0,1
BFA,TUN,2022.0,1,0,1
NPL,BRA,2018.0,1,0,1
PHL,MAC,2019.0,1,0,1
NZL,PRY,2018.0,1,0,1
PRY,ARG,2006.0,1,0,1
CHN,AFG,2014.0,1,0,1
CHE,MLT,2022.0,1,0,1
HKG,POL,2013.0,1,0,1
GRD,CAN,2016.0,1,0,1
CHL,RUS,2020.0,1,0,1
CAN,GIN,2014.0,1,0,1
KEN,SDN,2003.0,1,0,1
NLD,NGA,2003.0,1,0,1
MAR,SAU,2014.0,1,0,1
AUS,MNG,2012.0,1,0,1
NLD,LKA,2002.0,1,0,1
VEN,JPN,2006.0,1,0,1
BOL,ESP,2004.0,2,0,2
MOZ,ZAF,2009.0,1,0,1
TJK,USA,2003.0,1,0,1
ZAF,ROU,2005.0,1,0,1
NAM,ITA,2016.0,1,0,1
TLS,USA,2014.0,1,0,1
CHL,CRI,2009.0,1,0,1
SAU,BGR,2008.0,1,0,1
ECU,DOM,2020.0,1,0,1
ITA,AGO,2020.0,1,0,1
BFA,DEU,2005.0,1,0,1
GBR,ARM,2001.0,1,0,1
,PLW,2003.0,1,0,1
DOM,FRA,2007.0,1,0,1
AGO,ITA,2012.0,1,0,1
ETH,LKA,2021.0,1,0,1
IND,DZA,2000.0,1,0,1
BIH,GBR,2017.0,1,0,1
MEX,GRC,2021.0,1,0,1
PER,IND,2008.0,1,0,1
MUS,FRA,2002.0,1,0,1
LBN,ARE,2008.0,1,0,1
PAK,UKR,2011.0,1,0,1
ZMB,MWI,2007.0,1,0,1
GTM,CHE,2020.0,1,0,1
JOR,CHN,2022.0,1,0,1
JPN,UZB,2021.0,1,0,1
CAN,GMB,2021.0,1,0,1
TWN,BLR,2012.0,1,0,1
LKA,IDN,2014.0,1,0,1
MAR,FIN,2019.0,1,0,1
THA,EGY,2021.0,1,0,1
BEN,BDI,2009.0,1,0,1
FJI,KAZ,2012.0,1,0,1
GAB,GBR,2012.0,1,0,1
JPN,PNG,2014.0,1,0,1
ROU,IRQ,2020.0,2,0,2
GHA,THA,2017.0,1,0,1
FRA,USA,2011.0,831,670,161
NOR,FIN,2022.0,8,6,2
USA,IND,2017.0,676,1221,-545
KOR,CAN,2011.0,38,38,0
CAN,USA,2018.0,1924,1348,576
ITA,USA,2006.0,421,347,74
USA,MEX,2010.0,156,174,-18
USA,ISR,2019.0,335,344,-9
ITA,FRA,2015.0,328,220,108
USA,POL,2019.0,93,122,-29
PRT,ITA,2014.0,31,35,-4
DEU,GBR,2018.0,622,653,-31
SWE,DNK,2005.0,42,49,-7
USA,BRA,2020.0,321,671,-350
GBR,KHM,2008.0,4,1,3
GBR,TZA,2011.0,8,5,3
CHN,JPN,1998.0,50,40,10
TZA,NOR,2007.0,5,2,3
USA,IND,2019.0,712,1345,-633
FRA,DEU,2014.0,366,345,21
FRA,ARG,2021.0,15,16,-1
ZAF,GHA,2007.0,3,1,2
NLD,USA,2007.0,294,221,73
CHN,POL,2021.0,15,3,12
ISR,DEU,2010.0,26,27,-1
USA,SWE,2015.0,229,211,18
GRC,GBR,2012.0,170,150,20
USA,KEN,2012.0,34,32,2
KEN,USA,2014.0,48,47,1
AUS,USA,2016.0,592,556,36
SWE,NOR,2011.0,62,38,24
USA,URY,2011.0,11,7,4
GBR,NOR,2019.0,87,57,30
ARG,NLD,2005.0,3,5,-2
USA,IND,2010.0,568,902,-334
USA,HKG,2011.0,110,86,24
ITA,BRA,2015.0,58,33,25
ITA,ESP,2014.0,135,180,-45
FRA,IND,1999.0,7,11,-4
AUS,JPN,2009.0,42,55,-13
USA,AUS,1998.0,102,86,16
NOR,CHN,2014.0,18,15,3
ISR,IRL,2009.0,9,2,7
IRL,CHN,2017.0,26,10,16
DEU,CHE,2020.0,629,408,221
QAT,USA,2018.0,65,48,17
GRC,JPN,2019.0,3,4,-1
IRN,FIN,2015.0,13,4,9
NLD,CZE,2011.0,6,8,-2
FRA,BEL,2022.0,82,71,11
AUS,SAU,2013.0,26,9,17
TWN,USA,2020.0,192,186,6
GBR,DEU,2020.0,660,579,81
GBR,NOR,2017.0,96,48,48
ISR,DEU,2017.0,57,54,3
USA,POL,2010.0,117,101,16
CHL,DNK,2015.0,6,1,5
BEL,FRA,2011.0,173,167,6
ROU,CHE,2008.0,5,4,1
CAN,BGD,2012.0,12,26,-14
ARG,USA,1999.0,42,47,-5
ESP,GBR,2003.0,156,150,6
ARE,EGY,2006.0,7,7,0
ESP,MEX,2017.0,160,102,58
CHE,GBR,2000.0,45,31,14
COL,AUS,2011.0,12,2,10
AUT,EGY,2010.0,3,1,2
IRN,USA,2015.0,506,87,419
GBR,FIN,2011.0,50,37,13
IDN,USA,2005.0,7,14,-7
NLD,FRA,2015.0,130,121,9
CAN,BEN,2009.0,2,3,-1
NGA,FRA,2010.0,1,2,-1
SVN,AUT,2010.0,4,2,2
GBR,GHA,2008.0,16,4,12
AUS,MYS,2003.0,6,8,-2
RUS,CHE,2015.0,20,16,4
CHN,AUS,2015.0,283,214,69
QAT,EGY,2020.0,7,12,-5
BRA,GBR,2016.0,130,83,47
ITA,AUT,2016.0,57,37,20
AUT,NLD,2018.0,32,37,-5
IND,GBR,2021.0,231,120,111
AUT,DNK,2015.0,17,9,8
ESP,MEX,2019.0,132,127,5
CHN,DNK,2016.0,53,50,3
COG,COD,2015.0,18,21,-3
KOR,PAK,2017.0,58,49,9
NLD,NZL,2014.0,7,10,-3
USA,CHE,2022.0,218,174,44
SWE,FRA,2006.0,42,29,13
RWA,MWI,2020.0,1,1,0
SGP,PHL,2013.0,3,7,-4
CHL,COL,2018.0,22,32,-10
AUS,IRN,2015.0,26,144,-118
BGD,AUS,2007.0,6,3,3
KOR,BGD,2015.0,21,26,-5
SAU,IND,2019.0,64,141,-77
GBR,NOR,2010.0,47,31,16
ITA,BGD,2010.0,1,5,-4
ESP,USA,2022.0,183,188,-5
CHE,BRA,2018.0,15,38,-23
TWN,DEU,2019.0,18,12,6
NLD,CAN,2018.0,59,59,0
CHE,LIE,2018.0,1,1,0
FRA,GRC,2007.0,27,19,8
NLD,CHN,2018.0,138,124,14
CHN,SAU,2018.0,43,32,11
TUN,FRA,2008.0,60,92,-32
KOR,PAK,2019.0,115,28,87
PAK,SAU,2017.0,84,44,40
AUS,THA,2018.0,33,14,19
SVK,CZE,2020.0,68,38,30
IND,CHL,2015.0,6,2,4
USA,LKA,2021.0,12,12,0
USA,ARG,2020.0,58,101,-43
SWE,CHN,2006.0,36,22,14
POL,GBR,2002.0,33,29,4
USA,RWA,2013.0,6,8,-2
BEL,CHE,2005.0,23,11,12
IRN,DEU,2021.0,92,24,68
ITA,NLD,2019.0,124,75,49
GBR,MEX,2011.0,55,29,26
PAK,SAU,2019.0,85,78,7
DEU,EGY,2020.0,38,39,-1
DEU,ISR,2016.0,39,42,-3
BEL,CHN,2009.0,6,20,-14
FIN,BEL,2018.0,15,10,5
MYS,USA,2007.0,20,18,2
AUS,CMR,2017.0,2,1,1
FRA,MAR,2016.0,85,37,48
KOR,QAT,2017.0,2,2,0
USA,POL,2017.0,82,144,-62
BGD,SWE,2015.0,5,2,3
MMR,KOR,2016.0,2,1,1
NPL,AUS,2020.0,17,10,7
FRA,LUX,2015.0,27,20,7
CZE,FIN,2021.0,5,7,-2
SVN,AUT,2017.0,7,3,4
ESP,SWE,2022.0,32,26,6
EGY,SAU,2013.0,190,126,64
BEL,MEX,2019.0,7,3,4
USA,UGA,2021.0,19,25,-6
CAN,NZL,2015.0,40,37,3
ITA,SWE,2020.0,57,39,18
DEU,SWE,2021.0,135,105,30
USA,ITA,1999.0,200,206,-6
IND,BGD,2017.0,9,7,2
CHL,PER,2021.0,6,8,-2
AUS,ZAF,2022.0,16,8,8
DEU,JOR,2018.0,11,9,2
CHE,DEU,2001.0,214,281,-67
FRA,CHL,2021.0,26,30,-4
SWE,THA,2015.0,9,5,4
TWN,KOR,2010.0,16,9,7
SVN,AUT,2019.0,9,6,3
CHN,BGD,2022.0,29,8,21
SWE,JPN,2022.0,8,11,-3
ITA,CHN,2020.0,69,53,16
AUT,ESP,2014.0,17,30,-13
GBR,GMB,2019.0,13,12,1
MOZ,GBR,2021.0,1,2,-1
IND,ESP,2022.0,11,6,5
IND,BGD,2010.0,6,6,0
NLD,ESP,2020.0,67,89,-22
SAU,IND,2017.0,56,145,-89
IND,PHL,2018.0,6,6,0
SRB,GBR,2005.0,10,5,5
TUR,IRN,2020.0,8,38,-30
IRL,CHN,2019.0,30,15,15
DNK,CAN,2018.0,31,26,5
GBR,DNK,1997.0,11,6,5
PAK,SAU,2010.0,27,10,17
THA,TWN,2011.0,4,2,2
CHN,GHA,2022.0,28,9,19
COL,CHL,2021.0,29,28,1
NLD,AUS,2022.0,28,37,-9
ZAF,HKG,2019.0,2,3,-1
IND,NLD,2021.0,42,31,11
AUS,CAN,2018.0,161,193,-32
USA,ISR,2010.0,279,360,-81
VNM,FRA,2019.0,22,49,-27
ITA,NLD,2010.0,79,48,31
UKR,RUS,2017.0,178,44,134
ISR,DEU,2019.0,64,50,14
SWE,ECU,2018.0,3,1,2
USA,ISR,2017.0,322,365,-43
HRV,BIH,2015.0,9,3,6
CHE,ITA,2001.0,67,59,8
THA,GBR,2003.0,15,44,-29
HKG,NOR,2019.0,4,4,0
ZAF,KEN,2012.0,12,9,3
MWI,GBR,2005.0,6,5,1
FRA,GLP,2011.0,11,13,-2
JPN,SWE,2007.0,22,22,0
IRL,DEU,2012.0,47,22,25
GBR,AUS,2000.0,99,87,12
BEL,RUS,2009.0,5,12,-7
FRA,TUR,2006.0,10,9,1
CAN,IRN,2012.0,42,195,-153
SAU,JOR,2013.0,15,36,-21
PAK,AUT,2012.0,3,22,-19
SGP,CAN,2012.0,27,27,0
PAK,DEU,2015.0,17,35,-18
GUF,FRA,2006.0,7,15,-8
USA,CZE,2013.0,47,40,7
ITA,NOR,2013.0,17,7,10
NLD,MEX,2015.0,7,13,-6
ISL,DNK,2011.0,7,4,3
ESP,DNK,2012.0,21,16,5
HUN,BEL,2013.0,3,3,0
USA,PHL,2018.0,33,34,-1
DEU,MEX,2009.0,28,36,-8
KOR,IDN,2012.0,13,2,11
CAN,LBN,2006.0,5,8,-3
GBR,BRN,2020.0,4,2,2
IND,BGD,2019.0,13,10,3
TWN,DEU,2010.0,13,8,5
UKR,RUS,2010.0,28,48,-20
VEN,COL,2018.0,62,13,49
IND,JPN,1998.0,16,9,7
NLD,RUS,2010.0,9,13,-4
EGY,USA,2013.0,72,100,-28
ISR,GBR,2015.0,45,45,0
NOR,ITA,2015.0,10,32,-22
NLD,POL,2016.0,18,18,0
CAN,MEX,2012.0,28,34,-6
FIN,DNK,2015.0,15,9,6
GBR,GRC,1999.0,42,19,23
ISR,CHN,2004.0,11,4,7
ZAF,CAN,2017.0,23,22,1
BEL,CHE,2002.0,28,16,12
GBR,TWN,2006.0,39,15,24
KOR,FRA,2013.0,18,22,-4
GBR,ZAF,2004.0,50,53,-3
LUX,KOR,2020.0,2,3,-1
ITA,BGD,2019.0,4,4,0
BEL,MEX,2017.0,7,9,-2
CAN,ESP,2015.0,40,76,-36
FRA,NLD,2000.0,32,21,11
CHE,TUR,2006.0,6,6,0
DNK,IRL,2022.0,7,2,5
DEU,IRL,1997.0,5,1,4
FRA,BOL,2009.0,3,1,2
FRA,CZE,2022.0,22,10,12
KEN,AUS,2016.0,5,5,0
CIV,FRA,2011.0,19,34,-15
DEU,IND,2007.0,63,87,-24
SWE,NLD,2012.0,44,48,-4
CZE,USA,1997.0,7,12,-5
IND,JPN,1997.0,5,4,1
NLD,PRT,2016.0,11,34,-23
CAN,POL,1999.0,3,5,-2
DEU,RUS,2006.0,72,117,-45
JPN,FRA,2008.0,81,60,21
ITA,CUB,2008.0,4,4,0
DEU,ITA,1997.0,32,31,1
SWE,UKR,1998.0,2,5,-3
VNM,KOR,2020.0,32,131,-99
AUS,FIN,2015.0,16,13,3
GBR,KEN,2003.0,12,7,5
BEL,ITA,2002.0,33,28,5
ITA,IND,2003.0,12,20,-8
GHA,JPN,2013.0,3,1,2
VNM,FRA,2017.0,12,56,-44
AUS,IND,2012.0,32,80,-48
DEU,HUN,2006.0,32,30,2
NLD,IRN,2019.0,16,43,-27
NLD,IRN,2017.0,29,28,1
KGZ,TUR,2016.0,5,4,1
DEU,SRB,2015.0,7,12,-5
UGA,GBR,2020.0,11,22,-11
POL,JPN,2021.0,4,4,0
SGP,FRA,2015.0,29,37,-8
SWE,BRA,2018.0,9,27,-18
ZAF,CAN,2019.0,34,9,25
CHN,SGP,1998.0,22,2,20
ROU,FRA,2018.0,16,23,-7
COL,ITA,2020.0,12,4,8
TWN,CHN,2004.0,28,19,9
NLD,TWN,2001.0,7,3,4
DEU,TUR,2016.0,45,61,-16
IND,IRN,2016.0,16,4,12
SRB,FRA,2018.0,10,4,6
GBR,SVK,2014.0,3,7,-4
DEU,VNM,2020.0,15,12,3
USA,SDN,2018.0,2,4,-2
MWI,USA,2012.0,16,4,12
NZL,HUN,2008.0,1,2,-1
MEX,PER,2020.0,8,3,5
TWN,KOR,2019.0,4,14,-10
FRA,ROU,2020.0,22,22,0
SWE,CZE,2021.0,14,10,4
ZAF,DEU,2018.0,32,26,6
NZL,LKA,2021.0,4,2,2
ITA,AUS,2021.0,16,28,-12
FRA,GEO,2021.0,13,23,-10
ITA,QAT,2018.0,5,2,3
KOR,AUS,2013.0,33,34,-1
GHA,GBR,2007.0,6,13,-7
SWE,ISL,2014.0,16,23,-7
IDN,TWN,2016.0,16,22,-6
JPN,SAU,2015.0,20,4,16
DEU,ITA,1998.0,33,57,-24
NLD,ITA,2001.0,49,38,11
JPN,IND,1998.0,9,16,-7
CHE,SAU,2018.0,10,4,6
FRA,BRA,1997.0,11,8,3
VEN,CHL,2009.0,5,1,4
ZAF,CAN,2010.0,12,19,-7
CZE,TUR,2018.0,2,6,-4
USA,CMR,2007.0,5,5,0
AUS,KEN,2008.0,1,5,-4
USA,CRI,2013.0,13,12,1
USA,SVN,2014.0,8,14,-6
SWE,CHE,2013.0,34,53,-19
GRC,CHE,2003.0,9,10,-1
UKR,SWE,2012.0,10,2,8
JOR,USA,2005.0,14,34,-20
BEL,LUX,2007.0,8,2,6
CAN,BRA,2007.0,31,43,-12
BEL,ITA,2005.0,42,28,14
PER,ARG,2009.0,4,2,2
NZL,KOR,2010.0,3,3,0
SVN,HRV,2014.0,6,10,-4
USA,NZL,2000.0,22,29,-7
USA,ZAF,2000.0,15,24,-9
HRV,DEU,2002.0,10,9,1
SDN,MYS,2014.0,3,5,-2
GBR,RUS,2008.0,22,39,-17
MYS,QAT,2021.0,3,4,-1
ZAF,DNK,2013.0,2,5,-3
IDN,USA,2002.0,13,10,3
ESP,AUT,2001.0,9,7,2
MWI,GBR,2002.0,6,11,-5
NOR,DEU,2001.0,9,11,-2
JOR,SAU,2009.0,17,5,12
ITA,CAN,2000.0,7,6,1
DNK,NLD,2002.0,23,21,2
ISR,IND,2008.0,9,16,-7
BRA,ESP,1998.0,2,5,-3
DNK,NLD,2005.0,3,12,-9
MEX,GBR,2000.0,8,11,-3
SVN,SVK,2018.0,8,5,3
BGR,DEU,2001.0,29,3,26
FIN,SWE,1997.0,8,7,1
NZL,DEU,2001.0,11,15,-4
MEX,FRA,2001.0,15,22,-7
UZB,RUS,2003.0,3,5,-2
POL,GBR,2005.0,31,21,10
JPN,MNG,2013.0,3,4,-1
GBR,ISR,2015.0,45,45,0
CAN,THA,2020.0,11,7,4
RUS,ARM,1999.0,1,1,0
KOR,HKG,2016.0,13,8,5
GBR,CHL,2003.0,14,1,13
CAN,ARE,2020.0,31,18,13
USA,GMB,2004.0,2,4,-2
IDN,THA,2009.0,2,2,0
CYP,USA,2000.0,2,2,0
RUS,HRV,2009.0,2,1,1
SVK,SVN,1999.0,1,1,0
KOR,DEU,2004.0,15,21,-6
BRA,ARG,2002.0,25,21,4
SDN,CHE,2010.0,1,1,0
RUS,ITA,2014.0,11,18,-7
GBR,ARE,1998.0,1,1,0
ECU,USA,2016.0,16,31,-15
ZWE,KEN,2010.0,1,1,0
IRL,FRA,2007.0,12,28,-16
JPN,ITA,2018.0,24,31,-7
FIN,SWE,1998.0,22,7,15
IRL,JPN,2007.0,1,9,-8
MYS,SGP,2006.0,9,10,-1
SAU,IND,2010.0,6,58,-52
IND,SAU,2003.0,4,3,1
GRC,NLD,2004.0,6,13,-7
JPN,BGR,2009.0,4,1,3
SWE,ESP,1997.0,2,4,-2
JPN,IND,1997.0,4,5,-1
ARG,MEX,2004.0,10,6,4
HKG,TWN,2005.0,3,4,-1
GBR,CHN,2000.0,15,41,-26
JAM,BRA,2021.0,1,1,0
SWE,HUN,2015.0,5,9,-4
BEL,MEX,2010.0,4,4,0
EST,FRA,2012.0,3,1,2
SEN,FRA,2013.0,22,25,-3
JPN,PAK,2007.0,9,6,3
SGP,DEU,2001.0,7,1,6
PRT,AUS,2006.0,2,1,1
SWE,TWN,2017.0,5,3,2
LBN,ITA,2010.0,1,1,0
FRA,HRV,2011.0,4,1,3
MEX,RUS,2011.0,5,3,2
KAZ,RUS,2014.0,13,23,-10
ESP,IRN,2013.0,4,18,-14
ARG,DEU,2018.0,29,23,6
ARE,PAK,2008.0,1,1,0
KOR,NOR,2014.0,3,1,2
EST,GBR,2011.0,2,7,-5
CUB,VEN,2009.0,3,3,0
NLD,IRN,2010.0,10,22,-12
JPN,CHL,2015.0,3,2,1
MYS,NLD,2018.0,9,5,4
IRL,EGY,2018.0,1,4,-3
SVK,USA,2016.0,11,8,3
AUS,TWN,2013.0,15,8,7
ZAF,SWE,2012.0,8,5,3
IRL,CAN,2004.0,18,6,12
CUB,FRA,2009.0,1,3,-2
FIN,FRA,2018.0,28,23,5
CHE,POL,2020.0,14,21,-7
CHE,LAO,2017.0,3,4,-1
MYS,KOR,2011.0,6,13,-7
CHE,THA,2019.0,6,4,2
HUN,FRA,2018.0,12,18,-6
MLT,GBR,2015.0,9,9,0
LKA,CAN,2018.0,2,11,-9
DEU,LUX,2016.0,23,21,2
CHN,JPN,1997.0,30,19,11
DEU,LKA,2016.0,2,2,0
SUR,NLD,2014.0,1,3,-2
TUR,FRA,2021.0,14,10,4
GBR,ECU,2013.0,3,2,1
IND,BRA,2014.0,22,6,16
IRL,DNK,2012.0,6,1,5
BRA,MEX,2021.0,22,22,0
MAR,USA,2015.0,3,3,0
GBR,MLT,2016.0,18,11,7
GBR,ZMB,2016.0,5,5,0
UKR,POL,2015.0,17,17,0
ESP,NZL,2021.0,3,6,-3
DZA,CAN,2021.0,3,1,2
ZAF,ITA,2019.0,8,5,3
ISR,ESP,2021.0,4,10,-6
NLD,RUS,2019.0,18,18,0
USA,SRB,2021.0,3,14,-11
VNM,DEU,2020.0,12,15,-3
VNM,THA,2020.0,4,24,-20
UKR,CAN,2021.0,4,1,3
PAK,QAT,2020.0,4,3,1
RWA,ZWE,2013.0,2,1,1
ITA,COL,2013.0,5,1,4
AUS,ZWE,2007.0,1,2,-1
FRA,BRA,1998.0,22,16,6
POL,BEL,2013.0,16,15,1
RUS,AZE,2005.0,3,1,2
GBR,ROU,2016.0,10,17,-7
CHL,AUS,2007.0,4,4,0
MYS,AUS,2006.0,15,9,6
MYS,JPN,2001.0,3,6,-3
FRA,VNM,2009.0,14,4,10
ARE,GBR,2003.0,5,4,1
HKG,TWN,2002.0,7,3,4
FRA,SVN,2011.0,4,7,-3
IRN,BEL,2009.0,8,10,-2
GBR,EST,2018.0,6,10,-4
RUS,CAN,2016.0,15,10,5
NLD,AUT,2014.0,28,25,3
CAN,ZAF,2018.0,18,17,1
ITA,BGR,2013.0,3,4,-1
ITA,JOR,2014.0,3,1,2
SWE,MYS,2019.0,2,7,-5
HKG,EGY,2019.0,1,1,0
EGY,PSE,2019.0,6,1,5
MYS,CHN,2022.0,28,22,6
ITA,UKR,2020.0,2,4,-2
BRA,CHL,2015.0,21,15,6
ZAF,BWA,2008.0,2,8,-6
FRA,CIV,2018.0,19,8,11
USA,CYP,2000.0,2,2,0
BWA,AUS,2013.0,2,1,1
BRA,FIN,2020.0,16,3,13
PYF,FRA,2014.0,8,11,-3
SEN,MAR,2008.0,2,1,1
SWE,DNK,2002.0,60,52,8
DNK,SWE,2007.0,38,56,-18
GBR,VEN,2006.0,5,9,-4
AUS,BEL,2021.0,25,14,11
SVK,IND,2016.0,2,1,1
VNM,FRA,2010.0,5,9,-4
ETH,USA,2011.0,9,9,0
CZE,MKD,2018.0,2,1,1
PHL,GBR,2014.0,5,9,-4
CHE,SGP,2020.0,23,22,1
BRA,CHE,2021.0,31,9,22
MAR,PRT,2021.0,2,3,-1
NGA,CAN,2014.0,5,2,3
RUS,UZB,2013.0,4,9,-5
KOR,PHL,2021.0,12,4,8
NPL,THA,2018.0,4,5,-1
ITA,SEN,2018.0,2,1,1
DZA,IRN,2016.0,2,2,0
ITA,IDN,2011.0,5,1,4
CHL,BRA,2001.0,4,5,-1
CHE,JPN,2009.0,24,27,-3
AUT,BEL,2007.0,6,5,1
GBR,ISL,2018.0,7,3,4
FIN,KOR,2022.0,5,2,3
THA,VNM,2016.0,8,1,7
USA,BLR,2020.0,1,1,0
CHE,LAO,2019.0,2,1,1
NLD,BGR,2002.0,5,5,0
VNM,USA,2021.0,28,51,-23
CYP,AUT,2022.0,1,1,0
ARE,SAU,2018.0,7,39,-32
COG,FRA,2004.0,1,2,-1
TUR,ISR,2000.0,1,1,0
MOZ,BRA,2012.0,4,4,0
IND,PRT,1999.0,2,2,0
ESP,DZA,2013.0,2,1,1
BEL,FIN,2004.0,4,3,1
FRA,SEN,2001.0,16,15,1
FRA,PER,2014.0,2,7,-5
BEL,JPN,2004.0,10,10,0
NGA,BEL,2006.0,1,1,0
THA,FRA,2001.0,4,2,2
ARE,ITA,2018.0,5,9,-4
JPN,NZL,2001.0,7,2,5
ARE,SWE,2007.0,1,3,-2
NOR,IRL,2009.0,1,3,-2
DEU,IRL,1998.0,3,2,1
AUT,AUS,2001.0,7,8,-1
AUT,EGY,2019.0,2,3,-1
AUS,CHL,2003.0,3,4,-1
USA,TTO,2011.0,6,5,1
POL,ESP,2008.0,11,5,6
DNK,ISR,2002.0,5,3,2
GBR,BHR,2013.0,4,3,1
USA,LVA,2009.0,3,1,2
ITA,NZL,2003.0,5,3,2
PHL,IND,2011.0,5,3,2
CHN,BEL,2003.0,5,7,-2
CHL,SWE,2016.0,4,1,3
KOR,PAK,2010.0,6,8,-2
BEL,CZE,2013.0,9,10,-1
SWE,TWN,2010.0,1,4,-3
IRL,CHN,2010.0,5,13,-8
CHE,SVK,2019.0,5,5,0
ISR,HUN,2014.0,2,2,0
GEO,USA,2006.0,8,7,1
MEX,BEL,2013.0,7,5,2
NOR,JPN,2014.0,3,9,-6
BIH,FRA,2019.0,1,2,-1
DEU,IRQ,2014.0,3,2,1
DZA,MAR,2016.0,4,3,1
ESP,ROU,2000.0,1,2,-1
NLD,KOR,2018.0,4,13,-9
BGR,ESP,2011.0,6,2,4
PRT,ARG,2022.0,1,2,-1
GBR,DNK,1998.0,12,10,2
NOR,IRN,2015.0,5,15,-10
DZA,SAU,2009.0,6,2,4
FRA,SGP,2002.0,7,2,5
ISR,NZL,2016.0,4,2,2
HRV,DEU,2005.0,6,4,2
BRA,ARG,2005.0,14,10,4
ARG,ECU,2016.0,4,2,2
NZL,JPN,2021.0,5,6,-1
CHL,GRC,2021.0,3,1,2
CHN,SGP,1997.0,8,1,7
VNM,PHL,2008.0,1,1,0
SVK,RUS,2020.0,3,6,-3
IND,EST,2021.0,3,2,1
CMR,USA,2004.0,4,3,1
CAN,UKR,2013.0,2,6,-4
IRL,CHE,2003.0,7,8,-1
AZE,TUR,2007.0,8,2,6
MOZ,USA,2021.0,6,3,3
IRN,TUR,2015.0,21,9,12
FRA,ETH,2013.0,3,2,1
GHA,MYS,2013.0,3,3,0
DEU,PSE,2017.0,6,1,5
TUR,AZE,2004.0,3,4,-1
POL,UKR,2008.0,8,10,-2
EGY,BEL,2005.0,2,5,-3
MYS,HKG,2008.0,3,4,-1
SAU,SGP,2013.0,1,5,-4
CAN,SYR,2017.0,1,2,-1
PHL,AUS,2012.0,6,5,1
AUT,RUS,2005.0,5,10,-5
SGP,JOR,2018.0,1,1,0
ARE,NZL,2014.0,2,3,-1
FRA,BGR,2011.0,4,6,-2
TWN,KOR,2017.0,9,8,1
AUS,KHM,2014.0,4,1,3
IDN,IRL,2020.0,1,1,0
HKG,NOR,2010.0,1,1,0
EGY,FRA,2015.0,9,19,-10
KHM,FRA,2018.0,6,11,-5
ESP,SGP,2022.0,1,1,0
KOR,ARM,2019.0,1,1,0
DNK,JPN,2014.0,6,7,-1
AUT,LTU,2021.0,1,1,0
AUS,ITA,2000.0,3,2,1
IDN,KOR,2014.0,5,12,-7
HKG,KOR,2007.0,5,2,3
SVK,ESP,2000.0,3,1,2
DEU,LIE,2020.0,1,1,0
LBN,ITA,2019.0,4,4,0
JOR,USA,2002.0,10,17,-7
IRN,CHN,2004.0,1,1,0
TWN,NLD,2001.0,3,7,-4
USA,TUN,2004.0,6,3,3
BEL,CMR,2012.0,5,1,4
BRA,PER,2009.0,5,3,2
ALB,ITA,2020.0,6,3,3
ITA,JPN,2006.0,6,25,-19
FIN,AUT,2008.0,5,5,0
MAR,GBR,2010.0,2,1,1
BEL,LTU,2015.0,2,3,-1
ISR,PSE,2004.0,2,1,1
JPN,DNK,1999.0,2,3,-1
IRL,ESP,2004.0,6,3,3
IND,HKG,2003.0,3,4,-1
DNK,ISR,2005.0,2,2,0
BEN,GBR,2005.0,1,2,-1
JPN,NPL,2004.0,3,3,0
CYP,JPN,2002.0,1,1,0
CMR,FRA,1999.0,3,2,1
IRN,AUS,2001.0,1,5,-4
AUS,MAC,2022.0,2,1,1
CAN,TTO,2008.0,2,5,-3
ARG,NLD,2002.0,7,1,6
CHE,UGA,2012.0,3,4,-1
NGA,ITA,1999.0,1,1,0
URY,USA,2021.0,7,12,-5
DNK,PHL,2009.0,1,1,0
UKR,ITA,2012.0,3,1,2
LSO,USA,2013.0,2,2,0
AUS,FJI,2022.0,2,1,1
ZAF,ISR,2012.0,1,1,0
OMN,SAU,2019.0,4,7,-3
UKR,SAU,2017.0,1,1,0
FRA,LTU,2013.0,4,4,0
NZL,KOR,2019.0,4,7,-3
GBR,SDN,2016.0,6,2,4
NZL,KOR,2017.0,3,9,-6
MAR,TUN,2014.0,4,3,1
BRA,RUS,2014.0,9,12,-3
PAK,EGY,2021.0,4,1,3
ITA,BGD,2017.0,3,3,0
TWN,MYS,2021.0,3,6,-3
LBY,EGY,2016.0,1,5,-4
POL,SWE,2000.0,8,3,5
POL,SAU,2018.0,1,1,0
ZAF,HKG,2017.0,4,2,2
ISR,CAN,1998.0,4,5,-1
SGP,IDN,2011.0,1,4,-3
CHN,BRA,2011.0,4,4,0
GBR,BFA,2021.0,3,1,2
BWA,ZWE,2019.0,2,1,1
SVN,DEU,2009.0,8,6,2
KWT,AUS,2015.0,3,4,-1
CHL,CHE,2001.0,1,2,-1
ITA,SVK,2011.0,1,4,-3
BEL,ZAF,2007.0,6,2,4
JPN,MLT,2000.0,1,1,0
FIN,PRT,2016.0,4,6,-2
BGD,DEU,2006.0,1,4,-3
NER,BEL,2004.0,1,1,0
BRA,CRI,2012.0,1,4,-3
JPN,GHA,1999.0,1,1,0
CZE,UZB,2018.0,1,2,-1
ESP,JPN,1998.0,4,1,3
POL,PRT,2007.0,3,3,0
JPN,FIN,2021.0,4,6,-2
PAK,KEN,2012.0,1,3,-2
JPN,ARG,2017.0,1,3,-2
MEX,PRI,2017.0,1,1,0
SVK,ITA,2008.0,3,2,1
IRN,CZE,2011.0,1,1,0
EGY,OMN,2009.0,1,4,-3
MCO,DEU,2018.0,2,1,1
MNG,KOR,2019.0,6,10,-4
OMN,SAU,2017.0,3,2,1
HUN,RUS,2018.0,2,1,1
LVA,LTU,2021.0,1,2,-1
UKR,FIN,2020.0,1,1,0
MMR,CHN,2018.0,4,2,2
LKA,IND,2012.0,1,2,-1
DEU,NGA,2020.0,7,3,4
VEN,MEX,2013.0,7,3,4
IRL,MEX,2007.0,2,2,0
LAO,KOR,2016.0,1,1,0
MAR,GBR,2017.0,3,2,1
CHE,THA,2017.0,5,4,1
KWT,HUN,2004.0,1,1,0
ITA,ROU,2021.0,9,4,5
UKR,LTU,2016.0,2,2,0
HKG,NOR,2017.0,1,2,-1
GBR,SRB,2006.0,6,5,1
PER,CHL,2000.0,1,1,0
ITA,ARG,1997.0,2,1,1
FIN,NGA,2009.0,1,1,0
BEL,SWE,2000.0,2,1,1
GUY,GUF,2004.0,3,2,1
DNK,CHE,2000.0,5,6,-1
GRC,AUS,2005.0,1,1,0
GBR,BGR,2014.0,3,6,-3
MYS,UZB,2014.0,1,3,-2
NOR,POL,2022.0,2,6,-4
SRB,SVN,2016.0,4,3,1
BRN,AUS,2015.0,3,1,2
JPN,MEX,2003.0,2,5,-3
RWA,KEN,2016.0,1,2,-1
PAK,TWN,2011.0,1,1,0
NOR,CZE,2020.0,5,7,-2
CZE,DNK,2013.0,4,3,1
AUT,LIE,2017.0,2,2,0
ZAF,ITA,2010.0,3,3,0
NZL,CZE,2019.0,2,2,0
KWT,USA,2021.0,4,13,-9
HUN,ESP,1999.0,1,1,0
UKR,JPN,1999.0,6,2,4
SYR,FRA,2021.0,3,1,2
AUS,URY,2012.0,2,1,1
KEN,IND,2006.0,3,3,0
CZE,HUN,2018.0,4,8,-4
CHN,SRB,2016.0,4,1,3
ISL,CHE,2004.0,1,1,0
GRC,JPN,2010.0,1,2,-1
FRA,NGA,2004.0,1,1,0
SGP,UKR,2000.0,1,1,0
DEU,SVK,2013.0,9,9,0
BRA,TUN,2016.0,1,1,0
IND,RUS,2009.0,1,3,-2
SAU,NGA,2015.0,5,6,-1
HKG,FRA,2006.0,3,3,0
ITA,TWN,2008.0,3,2,1
NOR,EST,2008.0,1,2,-1
GBR,BRB,2014.0,2,1,1
TUR,BEL,2006.0,1,2,-1
LUX,AUT,2014.0,1,3,-2
AUT,EGY,2017.0,2,3,-1
PHL,CHE,2016.0,3,2,1
ZAF,ITA,2017.0,5,7,-2
CHL,TUR,2015.0,1,1,0
CZE,HRV,2020.0,1,5,-4
SWE,TWN,2019.0,5,8,-3
RUS,PRT,2018.0,4,4,0
NOR,NZL,2018.0,3,9,-6
QAT,MAR,2021.0,1,2,-1
AUT,IND,2022.0,3,8,-5
ZAF,IND,1997.0,1,1,0
KAZ,KGZ,2020.0,2,1,1
GRC,CHN,2020.0,3,5,-2
GNB,DNK,2004.0,2,4,-2
CUB,PER,2013.0,1,1,0
FRA,SGP,2005.0,3,4,-1
PAK,TZA,2010.0,1,2,-1
SYR,IND,2013.0,1,2,-1
AUT,PRT,2013.0,4,2,2
PRT,CAN,2002.0,7,3,4
LBN,ITA,2017.0,4,1,3
ECU,ITA,2013.0,1,6,-5
NGA,FRA,2019.0,5,2,3
USA,COG,2013.0,1,3,-2
SWE,LTU,2003.0,2,2,0
BGD,FRA,2018.0,2,3,-1
UKR,PRT,2013.0,1,1,0
VNM,SWE,2007.0,1,3,-2
QAT,IND,2015.0,5,10,-5
DNK,SRB,2009.0,1,2,-1
SWE,KOR,2014.0,6,11,-5
SVN,JPN,2018.0,2,1,1
MWI,KEN,2015.0,1,1,0
ZAF,MYS,2020.0,1,2,-1
AUT,SVN,2006.0,1,1,0
DEU,DZA,2018.0,2,6,-4
CHE,THA,2010.0,1,5,-4
NLD,NGA,2001.0,2,1,1
GHA,ZAF,2008.0,1,3,-2
ISR,BRA,2014.0,1,5,-4
TWN,SGP,1999.0,1,2,-1
IDN,ESP,2020.0,2,3,-1
ARE,KWT,2020.0,4,2,2
ESP,UKR,2008.0,1,5,-4
KWT,FRA,2019.0,2,4,-2
TZA,IND,2018.0,1,3,-2
CAN,GHA,2021.0,3,7,-4
KEN,KOR,2018.0,1,1,0
IRL,HKG,2009.0,1,5,-4
RUS,SRB,2007.0,1,1,0
NLD,UGA,2007.0,2,1,1
IRL,PAK,2022.0,3,4,-1
FIN,THA,2020.0,4,1,3
SWE,SRB,2013.0,1,1,0
KAZ,GEO,2019.0,1,1,0
RUS,SGP,2022.0,2,1,1
ARG,JPN,2015.0,1,1,0
GBR,SVN,2013.0,1,8,-7
SGP,SWE,2002.0,1,2,-1
MLT,CAN,2005.0,1,1,0
NLD,IND,1998.0,1,2,-1
ITA,ARG,1998.0,2,2,0
PRT,CAN,2005.0,4,4,0
ESP,ARE,2022.0,1,4,-3
TWN,AUT,2022.0,2,2,0
VEN,RUS,2009.0,1,1,0
RUS,BRA,2004.0,1,8,-7
PHL,BRN,2020.0,1,1,0
ESP,JPN,1997.0,1,2,-1
PNG,USA,2011.0,3,3,0
PAK,TZA,2017.0,1,3,-2
IND,DNK,1999.0,1,2,-1
CYP,CAN,2012.0,1,2,-1
CHE,SVK,2017.0,4,6,-2
CHE,BGR,2014.0,2,2,0
USA,GRD,2011.0,3,6,-3
GIN,CHE,2015.0,1,1,0
JPN,IDN,1999.0,2,2,0
AUT,SRB,2007.0,1,2,-1
CHE,EGY,2004.0,1,1,0
SEN,MLI,2017.0,1,1,0
MYS,BEL,2014.0,4,2,2
AUS,BTN,2014.0,1,2,-1
NLD,URY,2014.0,1,1,0
URY,MEX,2022.0,1,1,0
KEN,PAK,2014.0,1,3,-2
ESP,UZB,2015.0,1,1,0
SAU,ARE,2000.0,2,1,1
ISR,ZAF,2007.0,3,1,2
PRT,BEL,2022.0,7,5,2
IND,FJI,2005.0,1,1,0
CHL,GBR,1998.0,1,5,-4
FIN,IDN,2016.0,1,1,0
KEN,ETH,2006.0,1,4,-3
VNM,AUS,2005.0,3,3,0
CHN,PRI,2015.0,1,3,-2
BHR,EGY,2022.0,1,1,0
GBR,MUS,2020.0,1,1,0
SEN,MLI,2019.0,1,1,0
CHL,BEL,2001.0,1,2,-1
PRI,SWE,2008.0,1,1,0
CAN,SRB,2000.0,1,2,-1
NOR,MYS,2013.0,1,2,-1
SDN,CHE,2019.0,1,1,0
LKA,SGP,2011.0,1,1,0
HUN,ISR,2022.0,1,1,0
PAK,TZA,2019.0,1,2,-1
FIN,RUS,1998.0,1,3,-2
PRK,AUS,2011.0,1,1,0
ISR,TUR,2000.0,1,1,0
CHE,HKG,2011.0,1,13,-12
NLD,ARG,2004.0,2,5,-3
MOZ,SWE,2014.0,1,1,0
PRT,EGY,2015.0,1,2,-1
MNG,KOR,2017.0,1,7,-6
DNK,BRA,1997.0,1,1,0
MYS,JOR,2004.0,1,1,0
IRN,KOR,2008.0,1,1,0
USA,NAM,2014.0,1,2,-1
ESP,SVN,2004.0,2,1,1
KWT,ARE,2011.0,1,3,-2
KWT,SAU,2009.0,1,1,0
NZL,IND,2001.0,1,3,-2
MNG,KOR,2010.0,1,1,0
KAZ,HUN,2020.0,1,2,-1
UGA,KEN,2005.0,1,2,-1
AUS,ECU,2022.0,1,1,0
POL,NOR,2000.0,1,2,-1
BEL,GAB,2012.0,1,2,-1
CHE,BIH,2015.0,1,1,0
GRC,AUS,2002.0,1,2,-1
DNK,CHN,2000.0,1,5,-4
MNE,SRB,2012.0,1,8,-7
CHL,ZAF,2020.0,1,1,0
USA,KHM,2022.0,1,1,0
ECU,DEU,2022.0,1,1,0
LUX,VNM,2021.0,1,2,-1
GAB,USA,2022.0,1,5,-4
PRK,KOR,2020.0,1,1,0
NGA,DEU,2004.0,1,6,-5
GUY,USA,2016.0,1,1,0
USA,CIV,2013.0,1,2,-1
ITA,BIH,2020.0,1,3,-2
DZA,JOR,2011.0,1,1,0
ECU,PER,2007.0,1,1,0
IDN,IND,2001.0,1,3,-2
DEU,CUB,2015.0,2,2,0
AUT,ISR,2007.0,1,4,-3
GBR,UZB,2011.0,1,1,0
GHA,DNK,2022.0,1,1,0
USA,MNP,2015.0,1,1,0
GEO,CHE,2003.0,1,1,0
RUS,JOR,2014.0,1,1,0
DEU,YEM,2017.0,1,2,-1
COL,BEL,2021.0,1,1,0
KWT,LBN,2004.0,1,1,0
SAU,SDN,2015.0,2,13,-11
EGY,RUS,2004.0,1,2,-1
DZA,USA,2001.0,1,2,-1
DEU,ETH,2003.0,1,3,-2
BLR,FRA,2000.0,1,2,-1
ETH,MYS,2015.0,1,1,0
EGY,PSE,2017.0,1,3,-2
BHR,SAU,2009.0,1,1,0
PSE,GBR,2004.0,1,1,0
MEX,PRI,2019.0,1,1,0
CHE,HRV,2022.0,1,1,0
EST,DNK,2015.0,1,1,0
TUR,CHN,2007.0,1,1,0
PRT,CPV,2021.0,1,4,-3
FIN,IND,2012.0,1,16,-15
KAZ,IND,2020.0,1,2,-1
BGD,PHL,2016.0,1,1,0
ZWE,CHE,2009.0,1,1,0
PRI,PER,2010.0,1,1,0
NOR,THA,2019.0,1,2,-1
SRB,ROU,2008.0,1,2,-1
GAB,COG,2022.0,1,1,0
BRA,HRV,2018.0,1,3,-2
ETH,UGA,2016.0,1,1,0
CIV,MLI,2021.0,1,1,0
LTU,ESP,2018.0,1,6,-5
USA,MEX,2017.0,168,237,-69
SWE,POL,2012.0,18,17,1
ESP,FRA,2013.0,238,142,96
FRA,IDN,2020.0,11,3,8
USA,KOR,2016.0,868,690,178
JOR,CAN,2018.0,8,13,-5
USA,MEX,2019.0,203,232,-29
GBR,CAN,2011.0,344,291,53
ESP,MEX,2010.0,93,108,-15
IND,USA,2001.0,329,152,177
NGA,ZAF,2013.0,38,18,20
USA,DNK,2012.0,105,94,11
AUS,NLD,2010.0,35,54,-19
AUS,GBR,2001.0,230,215,15
RUS,DEU,2014.0,99,91,8
BRA,SWE,2014.0,13,10,3
NLD,FIN,2018.0,22,12,10
POL,CAN,2016.0,17,22,-5
AUS,NLD,2017.0,62,93,-31
MYS,YEM,2016.0,16,2,14
FRA,LBN,2021.0,46,48,-2
LTU,DNK,2018.0,8,4,4
GRC,DEU,2016.0,64,45,19
ITA,NLD,2017.0,128,78,50
MYS,DNK,2021.0,1,2,-1
CHN,ESP,2012.0,13,14,-1
UKR,RUS,2019.0,88,38,50
GBR,KOR,2001.0,17,12,5
DEU,HKG,2006.0,5,7,-2
BRA,IRL,2020.0,17,6,11
ESP,CHN,2016.0,37,30,7
FRA,COL,2011.0,14,8,6
POL,AUT,2014.0,21,7,14
JPN,EGY,2012.0,70,18,52
LBN,ARE,2013.0,1,1,0
AUS,NLD,2019.0,80,78,2
AUS,RUS,2022.0,1,1,0
USA,AUS,1997.0,47,35,12
JPN,DEU,2015.0,104,97,7
IRQ,IRN,2012.0,2,5,-3
COL,MEX,2014.0,25,32,-7
DEU,VEN,2007.0,6,5,1
IRQ,GBR,2013.0,8,16,-8
HKG,JPN,2018.0,10,10,0
FRA,ESP,2000.0,51,47,4
PER,ECU,2018.0,4,3,1
GBR,CMR,2009.0,3,3,0
ETH,BEL,2007.0,2,1,1
BEL,AUT,2009.0,7,7,0
GBR,GMB,2010.0,6,6,0
HUN,DEU,1999.0,22,19,3
NOR,DNK,2003.0,18,23,-5
NLD,BEN,2011.0,1,2,-1
BEL,GRC,2005.0,10,9,1
GRC,USA,1999.0,15,41,-26
CAN,PAK,2003.0,4,3,1
MDG,FRA,2001.0,6,3,3
NLD,ZAF,2014.0,14,21,-7
IRL,SWE,2008.0,4,10,-6
GMB,GBR,2012.0,8,4,4
SVK,CHE,2004.0,4,1,3
NOR,LUX,2013.0,3,1,2
TWN,DEU,2017.0,20,20,0
RUS,JPN,2013.0,7,11,-4
ARE,JOR,2021.0,12,18,-6
PRT,ZAF,2015.0,4,1,3
BFA,USA,2017.0,4,3,1
AUS,ESP,2016.0,30,56,-26
ISR,GRC,2020.0,1,2,-1
SWE,IRL,2016.0,11,6,5
DEU,PSE,2019.0,5,3,2
CZE,RUS,2020.0,7,19,-12
NZL,POL,2014.0,2,9,-7
DEU,YEM,2019.0,1,1,0
RUS,HKG,2021.0,2,1,1
LBN,USA,2000.0,4,4,0
NLD,DEU,1999.0,47,82,-35
ITA,POL,2004.0,7,10,-3
CZE,USA,1998.0,7,8,-1
BEL,GRC,2002.0,3,8,-5
RUS,IRN,2011.0,1,1,0
FRA,THA,2022.0,3,5,-2
SGP,NLD,2011.0,6,12,-6
AUT,RUS,2002.0,12,7,5
FIN,CHE,2012.0,13,10,3
EGY,AUT,2016.0,1,3,-2
IND,THA,2001.0,1,2,-1
HRV,FRA,2005.0,3,4,-1
IRL,BHR,2021.0,2,7,-5
SRB,GBR,2002.0,6,5,1
CIV,USA,2011.0,2,2,0
NLD,NOR,2000.0,6,6,0
KOR,IRN,2021.0,4,22,-18
EGY,CHE,2018.0,7,5,2
SWE,ZAF,2016.0,8,6,2
BGD,FIN,2018.0,2,1,1
KGZ,RUS,2003.0,2,2,0
NOR,RUS,2015.0,5,7,-2
ZAF,AUT,2016.0,4,4,0
NZL,IRL,1999.0,4,2,2
SVN,ESP,2006.0,2,2,0
CAN,BGR,2004.0,2,5,-3
ETH,GBR,2012.0,5,6,-1
CHN,MEX,2004.0,2,1,1
VEN,ITA,2004.0,1,2,-1
JPN,LAO,2011.0,2,1,1
BFA,USA,2019.0,1,1,0
TWN,NGA,2008.0,1,1,0
DEU,NPL,2004.0,1,1,0
USA,MAR,2022.0,2,2,0
DEU,ISL,2016.0,2,7,-5
VEN,CHE,2015.0,1,1,0
DEU,BGR,2014.0,9,9,0
NLD,SRB,2006.0,2,3,-1
VNM,AUS,2002.0,3,2,1
HUN,CHN,1999.0,1,1,0
NPL,NLD,2016.0,2,4,-2
GIN,SEN,2021.0,2,2,0
ETH,NOR,2011.0,2,3,-1
HRV,FRA,2002.0,3,1,2
BRA,ESP,1997.0,6,2,4
BOL,ESP,2014.0,1,1,0
DZA,DEU,2004.0,2,2,0
SWE,MYS,2010.0,2,2,0
PRT,DZA,2001.0,1,1,0
OMN,MYS,2018.0,3,15,-12
AUS,CZE,2004.0,1,1,0
SGP,SWE,2005.0,4,1,3
SWE,ESP,1998.0,4,1,3
NZL,CZE,2017.0,1,2,-1
SEN,GHA,2022.0,1,1,0
AUS,MLT,2018.0,1,2,-1
JPN,THA,1998.0,2,3,-1
AUT,THA,2001.0,1,1,0
RUS,TUR,2012.0,1,3,-2
DEU,ARE,2015.0,2,3,-1
FIN,IRL,2012.0,2,3,-1
CZE,ZAF,2014.0,1,1,0
USA,PRY,2014.0,2,1,1
JPN,ARG,2010.0,1,2,-1
KOR,QAT,2019.0,2,1,1
MAC,TWN,2014.0,1,2,-1
SWE,NZL,2003.0,1,6,-5
EST,ITA,2008.0,1,1,0
EGY,IND,2011.0,1,2,-1
,GBR,2003.0,18061,0,18061
JPN,,2023.0,83034,0,83034
USA,,2014.0,63459,0,63459
ARE,,2014.0,120,0,120
,CUB,1999.0,745,0,745
GBR,,2008.0,9360,0,9360
RUS,,2008.0,3377,0,3377
JOR,,2010.0,109,0,109
ZAF,,2020.0,2300,0,2300
,DEU,2013.0,23591,0,23591
OMN,,2015.0,80,0,80
,EGY,2001.0,1320,0,1320
,BWA,2004.0,71,0,71
,JOR,1999.0,281,0,281
EST,,2019.0,342,0,342
,ITA,2013.0,14015,0,14015
PRT,,2018.0,1953,0,1953
EST,,2017.0,242,0,242
,MTQ,2004.0,13,0,13
,NPL,2000.0,75,0,75
FRA,,2007.0,5623,0,5623
,GRC,2002.0,2709,0,2709
MEX,,2016.0,2364,0,2364
,BWA,1996.0,26,0,26
POL,,2008.0,1773,0,1773
,FJI,1999.0,30,0,30
,POL,2006.0,5153,0,5153
,UKR,1999.0,2302,0,2302
,TUR,2008.0,6951,0,6951
ESP,,2006.0,3106,0,3106
MDA,,2016.0,46,0,46
PAK,,2020.0,2436,0,2436
,ECU,1997.0,13,0,13
,PAK,2012.0,3193,0,3193
SVN,,2017.0,490,0,490
,JPN,2014.0,22124,0,22124
KEN,,2010.0,91,0,91
CRI,,2022.0,276,0,276
,NZL,2007.0,1331,0,1331
,GRC,2005.0,2834,0,2834
SWZ,,2021.0,20,0,20
AUT,,2002.0,176,0,176
MYS,,2004.0,73,0,73
SDN,,2022.0,255,0,255
CYP,,2013.0,44,0,44
BGR,,2000.0,9,0,9
,UZB,2002.0,107,0,107
,SRB,2000.0,717,0,717
SVN,,2019.0,635,0,635
,ARG,2010.0,2655,0,2655
GRC,DZA,2013.0,1,0,1
,KAZ,2016.0,1184,0,1184
CIV,,2023.0,496,0,496
SVN,,2010.0,183,0,183
,UZB,2005.0,97,0,97
LTU,TUR,2018.0,1,0,1
BWA,,2021.0,108,0,108
,MTQ,1996.0,6,0,6
ECU,,2009.0,29,0,29
AUT,,2005.0,732,0,732
EST,,2010.0,95,0,95
,LUX,2011.0,122,0,122
,TWN,2014.0,5684,0,5684
KEN,,2017.0,261,0,261
,AUT,2015.0,2579,0,2579
,VEN,2008.0,487,0,487
MAR,ZAF,2015.0,1,0,1
JOR,,2017.0,181,0,181
,HRV,2012.0,927,0,927
,KEN,2013.0,473,0,473
CAF,,2020.0,18,0,18
,BEL,2016.0,3315,0,3315
NAM,,2018.0,17,0,17
,ZAF,1994.0,945,0,945
,LIE,2012.0,11,0,11
,RWA,2016.0,111,0,111
FRA,PNG,2017.0,1,0,1
PNG,,2022.0,47,0,47
,ARG,2017.0,2107,0,2107
,SUR,2012.0,2,0,2
DNK,BRA,1998.0,1,0,1
,SLV,2012.0,11,0,11
ZMB,,2016.0,30,0,30
,URY,2014.0,246,0,246
IRN,EST,2018.0,4,0,4
PHL,,2003.0,12,0,12
MNE,,2019.0,40,0,40
JPN,SVN,2021.0,2,0,2
,MWI,1998.0,47,0,47
CHE,,2001.0,129,0,129
MLI,LUX,2019.0,1,0,1
IRN,SDN,2018.0,2,0,2
GHA,FRA,2017.0,1,0,1
,ARG,2019.0,826,0,826
LVA,BEL,2009.0,1,0,1
UZB,FJI,2021.0,1,0,1
,KWT,2008.0,155,0,155
JOR,,2019.0,276,0,276
KEN,,2019.0,382,0,382
SVK,,2006.0,232,0,232
PRI,,2015.0,102,0,102
UZB,,1999.0,14,0,14
,BEN,2006.0,32,0,32
MYS,BHR,2015.0,3,0,3
GHA,,2015.0,76,0,76
,SYR,2000.0,45,0,45
IND,LBY,2009.0,6,0,6
TZA,OMN,2016.0,1,0,1
BRA,LUX,2014.0,1,0,1
SDN,SYR,2017.0,1,0,1
SAU,LBN,2006.0,2,0,2
FRA,NCL,2000.0,1,0,1
TUR,SWE,1997.0,1,0,1
,SDN,2008.0,112,0,112
DNK,ISL,2018.0,4,0,4
NIC,,2022.0,22,0,22
BGR,RUS,2014.0,6,0,6
KEN,MOZ,2018.0,2,0,2
ZWE,KEN,2019.0,2,0,2
TJK,CHN,2021.0,1,0,1
GUF,CHE,2021.0,1,0,1
MDA,ARM,2020.0,3,0,3
MAC,,2007.0,3,0,3
LKA,,2006.0,21,0,21
,BIH,2001.0,120,0,120
ISL,,2006.0,22,0,22
MRT,,2008.0,3,0,3
,MOZ,2008.0,35,0,35
FSM,,2024.0,2,0,2
,MDA,2003.0,21,0,21
REU,,2008.0,4,0,4
,ZWE,1999.0,101,0,101
JAM,,2008.0,18,0,18
,ECU,1998.0,38,0,38
TGO,BEN,2006.0,1,0,1
,NAM,2002.0,9,0,9
ATG,,2012.0,3,0,3
ETH,MEX,2011.0,1,0,1
GMB,,2009.0,11,0,11
,CRI,1998.0,62,0,62
COG,,2004.0,5,0,5
IRN,NZL,2006.0,3,0,3
NLD,BGR,2005.0,3,0,3
MYS,SDN,2000.0,1,0,1
EGY,HUN,2004.0,1,0,1
MDG,GAB,2017.0,1,0,1
USA,MOZ,2006.0,2,0,2
RUS,LUX,2021.0,1,0,1
AUS,MLI,2020.0,1,0,1
NGA,FRA,2017.0,1,0,1
GAB,,2005.0,9,0,9
AUT,PSE,2007.0,1,0,1
NER,KEN,2018.0,1,0,1
FJI,PLW,2005.0,2,0,2
TUN,IRL,1999.0,1,0,1
JPN,SVK,1999.0,5,0,5
,CRI,1997.0,44,0,44
SDN,TTO,2004.0,1,0,1
,GRL,1999.0,2,0,2
KNA,ZAF,2013.0,1,0,1
CUB,COL,2013.0,4,0,4
IND,POL,2002.0,6,0,6
ITA,SMR,2006.0,1,0,1
TUR,ARG,2006.0,1,0,1
MKD,FRA,2008.0,3,0,3
BWA,ZAF,1999.0,1,0,1
GRC,EGY,2012.0,2,0,2
TUN,,2001.0,4,0,4
FRA,BRN,2015.0,1,0,1
GUY,,2007.0,1,0,1
IND,NAM,2017.0,3,0,3
TUR,CZE,2012.0,2,0,2
FIN,UGA,2013.0,1,0,1
JAM,NGA,2019.0,2,0,2
OMN,TUR,2015.0,1,0,1
,GMB,2008.0,19,0,19
MEX,AZE,2018.0,1,0,1
POL,EGY,2016.0,2,0,2
PAK,VNM,2018.0,2,0,2
NGA,IND,1999.0,1,0,1
GIB,,2024.0,6,0,6
JAM,IRL,2015.0,1,0,1
CAN,YEM,2020.0,1,0,1
UKR,UZB,2014.0,1,0,1
GBR,PAN,2021.0,1,0,1
KOR,BGR,2012.0,3,0,3
PRT,CZE,2013.0,1,0,1
SVN,IRL,2018.0,1,0,1
ITA,PER,2014.0,1,0,1
NGA,TGO,2006.0,1,0,1
IDN,KGZ,2005.0,1,0,1
THA,DEU,2001.0,7,0,7
MMR,SGP,2002.0,1,0,1
,BTN,2008.0,6,0,6
CRI,SWE,2016.0,1,0,1
EST,PRT,2019.0,2,0,2
FIN,RUS,1997.0,2,0,2
OMN,AUT,2002.0,1,0,1
MKD,PRT,2002.0,1,0,1
BRB,AUT,2012.0,1,0,1
,NAM,2005.0,14,0,14
AUT,LIE,2019.0,3,0,3
IND,KAZ,2018.0,1,0,1
CHE,LBN,2018.0,3,0,3
TWN,GTM,2019.0,1,0,1
BDI,NLD,2011.0,1,0,1
PRT,HUN,2015.0,2,0,2
,GNB,2012.0,9,0,9
PRT,MDA,2016.0,1,0,1
QAT,,2005.0,9,0,9
JPN,BRN,2015.0,1,0,1
FRA,KEN,2021.0,3,0,3
BEL,GIN,2019.0,1,0,1
RUS,AZE,2002.0,2,0,2
BLR,AUT,2008.0,1,0,1
KAZ,GEO,2017.0,2,0,2
BEL,BFA,2001.0,1,0,1
POL,IRL,2003.0,2,0,2
IRL,GHA,2006.0,1,0,1
SRB,PRT,2000.0,1,0,1
SWE,CRI,1998.0,1,0,1
BRB,,2009.0,4,0,4
,OMN,1995.0,12,0,12
DOM,,2009.0,2,0,2
JOR,DNK,2017.0,1,0,1
SWE,GHA,2016.0,1,0,1
SVN,CUB,2020.0,1,0,1
DJI,,2007.0,2,0,2
PNG,CHE,2008.0,1,0,1
CCK,,2014.0,1,0,1
PHL,TZA,2012.0,1,0,1
ISL,ISR,2017.0,1,0,1
GBR,QAT,2004.0,4,0,4
LTU,ISR,2015.0,1,0,1
CUB,DNK,2000.0,1,0,1
ISL,ISR,2019.0,1,0,1
ITA,HND,2017.0,1,0,1
PRI,PER,2019.0,1,0,1
GUF,GUY,2019.0,1,0,1
TWN,CZE,2020.0,3,0,3
BRA,NOR,2013.0,7,0,7
GEO,AUS,2007.0,1,0,1
DEU,GHA,1999.0,2,0,2
JAM,CAN,2001.0,2,0,2
KWT,FRA,2017.0,2,0,2
CHE,TUN,2022.0,2,0,2
QAT,KOR,2021.0,1,0,1
SYR,CHE,2019.0,2,0,2
,BLZ,2014.0,2,0,2
CAN,GAB,2021.0,1,0,1
SYR,PRI,2005.0,1,0,1
,MWI,1997.0,3,0,3
ESP,DOM,2011.0,3,0,3
NZL,LBR,2017.0,1,0,1
TWN,SVK,2011.0,2,0,2
TUR,NOR,2008.0,2,0,2
KWT,NGA,2012.0,1,0,1
PRI,CHE,2014.0,3,0,3
TUR,GHA,2020.0,2,0,2
NLD,FJI,2013.0,1,0,1
TWN,NOR,2021.0,2,0,2
PER,FRA,2022.0,3,0,3
THA,CHL,2010.0,1,0,1
LTU,ISL,2009.0,1,0,1
DZA,ARE,2011.0,1,0,1
SVN,RUS,2018.0,1,0,1
MYS,MLT,2019.0,1,0,1
NOR,BLR,2008.0,2,0,2
DOM,CHL,2009.0,1,0,1
FRA,ARE,2003.0,3,0,3
SAU,OMN,2021.0,2,0,2
BRA,TTO,2009.0,1,0,1
SGP,BGD,2005.0,2,0,2
MWI,ZWE,2005.0,1,0,1
IDN,CAN,2021.0,1,0,1
QAT,,2002.0,3,0,3
ESP,TUR,2000.0,1,0,1
SYR,QAT,2012.0,1,0,1
BDI,TUR,2019.0,1,0,1
MNE,,2017.0,17,0,17
ISR,QAT,2004.0,1,0,1
CHN,LTU,2014.0,1,0,1
ARE,QAT,2007.0,3,0,3
DZA,AUS,2001.0,1,0,1
CHL,ZMB,2012.0,1,0,1
BEL,TUN,2001.0,2,0,2
ITA,YEM,2011.0,1,0,1
CZE,KWT,2001.0,1,0,1
BLR,SVN,1998.0,1,0,1
AUS,YEM,2009.0,1,0,1
PRY,AUS,2002.0,1,0,1
CHL,FIN,2005.0,2,0,2
USA,QAT,1997.0,1,0,1
BHR,USA,2001.0,2,0,2
KHM,COL,2003.0,1,0,1
CUB,AUS,2007.0,1,0,1
JPN,IRQ,2014.0,1,0,1
CHE,GEO,2017.0,1,0,1
TTO,CAN,2012.0,4,0,4
PER,IND,2013.0,1,0,1
NIC,FRA,2007.0,1,0,1
CHE,KEN,2009.0,1,0,1
BEL,RWA,2015.0,1,0,1
SYR,ETH,2018.0,1,0,1
FLK,,2023.0,7,0,7
ITA,NPL,2014.0,1,0,1
IND,MAR,2022.0,2,0,2
CYP,OMN,2011.0,1,0,1
HRV,NZL,2018.0,1,0,1
CHE,HTI,2019.0,1,0,1
MKD,QAT,2018.0,1,0,1
IRN,SVN,2018.0,2,0,2
ARG,FIN,2021.0,1,0,1
SWE,MYS,2017.0,4,0,4
GNQ,ESP,2009.0,1,0,1
AUT,CHL,2006.0,2,0,2
ROU,DNK,2004.0,3,0,3
,GUF,1994.0,3,0,3
USA,OMN,1998.0,1,0,1
MEX,PRI,2010.0,1,0,1
UZB,BLR,2021.0,1,0,1
ARG,ARE,2017.0,5,0,5
PHL,SWE,2021.0,1,0,1
ARG,NOR,2002.0,1,0,1
BRN,GBR,2001.0,1,0,1
FIN,SVN,2011.0,1,0,1
BHS,,2021.0,5,0,5
MAR,DZA,2008.0,1,0,1
TUR,AUS,2001.0,1,0,1
ARE,IRQ,2021.0,1,0,1
KOR,ARG,2008.0,1,0,1
DEU,COG,2003.0,1,0,1
PAN,CRI,2003.0,1,0,1
COL,JPN,2005.0,1,0,1
ZAF,MOZ,2007.0,3,0,3
ISL,CZE,2012.0,1,0,1
ISR,SRB,2013.0,2,0,2
BMU,MCO,2010.0,1,0,1
CHE,SVN,2009.0,2,0,2
SMR,ITA,2016.0,3,0,3
PER,PRT,2022.0,1,0,1
ITA,PRI,2014.0,1,0,1
UZB,TUR,2002.0,2,0,2
LTU,LVA,2020.0,1,0,1
SWZ,TWN,2020.0,1,0,1
ISR,UGA,2018.0,1,0,1
,CAF,1999.0,4,0,4
UKR,BEL,2020.0,1,0,1
,MDV,2018.0,4,0,4
BIH,ISR,2020.0,1,0,1
CUB,DEU,2000.0,1,0,1
KOR,FJI,2016.0,1,0,1
SVK,TUR,2012.0,3,0,3
MAR,CIV,2017.0,1,0,1
UZB,KAZ,2006.0,1,0,1
MWI,,2003.0,4,0,4
NGA,BWA,2000.0,1,0,1
FSM,CAN,2006.0,1,0,1
ARG,SYR,2002.0,1,0,1
ARM,GBR,2008.0,1,0,1
GBR,PHL,2007.0,3,0,3
UGA,DEU,2018.0,4,0,4
,PRK,2008.0,4,0,4
IRL,LIE,2018.0,1,0,1
FRA,BWA,2022.0,1,0,1
TKM,CHN,2013.0,3,0,3
AUT,LIE,2010.0,2,0,2
AUT,ETH,2022.0,1,0,1
HKG,FJI,2018.0,1,0,1
ESP,GMB,2013.0,1,0,1
CAN,AFG,2010.0,1,0,1
NGA,EST,2019.0,1,0,1
NPL,NZL,2013.0,1,0,1
ZAF,HKG,2010.0,1,0,1
LTU,GRC,2013.0,1,0,1
PRY,ECU,2022.0,1,0,1
TUR,JOR,2013.0,1,0,1
,ASM,2001.0,1,0,1
MWI,MYS,2013.0,1,0,1
KEN,ZMB,2020.0,1,0,1
AUT,ZAF,1998.0,2,0,2
CRI,DEU,2000.0,2,0,2
NZL,EST,2002.0,2,0,2
DEU,BEN,2007.0,1,0,1
GBR,YEM,2006.0,2,0,2
AUS,CYP,1997.0,1,0,1
TUR,PSE,2011.0,2,0,2
SYR,USA,1999.0,2,0,2
GTM,IRQ,2018.0,1,0,1
CHE,BOL,2011.0,1,0,1
TUR,NGA,2006.0,1,0,1
GBR,ARE,1997.0,1,0,1
PAK,SWE,2003.0,2,0,2
MNE,,2010.0,2,0,2
MEX,NIC,2003.0,1,0,1
PRI,ZAF,2010.0,1,0,1
NLD,SGP,2000.0,3,0,3
UGA,KEN,2002.0,1,0,1
THA,ZMB,2015.0,1,0,1
EGY,UGA,2015.0,1,0,1
KNA,USA,2003.0,1,0,1
RWA,IND,2013.0,1,0,1
AZE,SAU,2002.0,1,0,1
SRB,NOR,2014.0,3,0,3
VNM,ESP,2012.0,1,0,1
BHR,CAN,2020.0,1,0,1
BHR,AUT,2020.0,1,0,1
SEN,NLD,2011.0,1,0,1
HUN,MYS,2012.0,1,0,1
IRQ,OMN,2015.0,1,0,1
LAO,VNM,2013.0,1,0,1
ECU,IRL,2016.0,2,0,2
POL,URY,2017.0,1,0,1
ISL,NOR,2000.0,2,0,2
NZL,RUS,2001.0,2,0,2
NLD,IND,1997.0,1,0,1
HUN,AUS,2013.0,2,0,2
LAO,KHM,2007.0,1,0,1
TUR,MYS,2011.0,1,0,1
FIN,SVK,2009.0,2,0,2
SYR,DEU,2011.0,2,0,2
UZB,BEL,2006.0,2,0,2
FIN,MDA,2010.0,1,0,1
PRT,MAC,2011.0,1,0,1
PAN,JPN,2020.0,1,0,1
HRV,KOR,2016.0,1,0,1
,MLT,1994.0,11,0,11
,BHS,2008.0,1,0,1
SVN,CZE,2014.0,5,0,5
ITA,BLR,2003.0,2,0,2
OMN,ZWE,2001.0,1,0,1
JPN,CZE,1999.0,2,0,2
ZAF,IND,1998.0,1,0,1
BMU,AUS,2012.0,1,0,1
KOR,QAT,2010.0,1,0,1
,MRT,2004.0,2,0,2
ESP,SAU,2014.0,5,0,5
MEX,NPL,2018.0,1,0,1
THA,HUN,2009.0,2,0,2
,SMR,2006.0,1,0,1
KOR,SVK,2016.0,2,0,2
NLD,QAT,2015.0,6,0,6
AUS,TZA,2021.0,2,0,2
DEU,KWT,1998.0,1,0,1
GMB,ESP,2022.0,1,0,1
CUB,URY,2012.0,1,0,1
BRB,FRA,2021.0,1,0,1
LVA,ISR,2015.0,1,0,1
ESP,THA,2002.0,1,0,1
HND,,2018.0,3,0,3
,MRT,1996.0,1,0,1
CUB,PRT,2003.0,1,0,1
NAM,DEU,2022.0,1,0,1
PRI,ZAF,2017.0,2,0,2
YEM,CHE,2018.0,1,0,1
KWT,UKR,2019.0,1,0,1
LBR,CHE,2015.0,1,0,1
LTU,IRL,2018.0,2,0,2
GUM,,2012.0,2,0,2
SRB,TUR,2022.0,1,0,1
FRA,NPL,2022.0,1,0,1
ISR,BRB,2005.0,1,0,1
NGA,PRT,2019.0,1,0,1
SLE,IRL,2016.0,1,0,1
KHM,NZL,2010.0,1,0,1
DNK,BEN,2005.0,1,0,1
ARM,SWE,2020.0,2,0,2
MYS,ETH,2012.0,1,0,1
UGA,ETH,2009.0,1,0,1
MYS,LAO,2010.0,1,0,1
MLT,ESP,2013.0,1,0,1
ZAF,SAU,2002.0,2,0,2
ECU,URY,2017.0,2,0,2
ARG,CHN,1998.0,1,0,1
IRQ,KOR,2010.0,1,0,1
NPL,MUS,2017.0,1,0,1
CYP,FRA,2007.0,1,0,1
GRC,MEX,2016.0,3,0,3
PER,AUS,2013.0,1,0,1
SVN,MNE,2011.0,1,0,1
BWA,TUR,2017.0,1,0,1
MAR,CIV,2019.0,4,0,4
BFA,MLI,2005.0,3,0,3
USA,BFA,2001.0,1,0,1
LKA,PHL,2007.0,1,0,1
ECU,COL,2000.0,1,0,1
BWA,SWZ,2001.0,1,0,1
PER,CAN,2015.0,2,0,2
VEN,CRI,2018.0,1,0,1
IND,FJI,2002.0,1,0,1
PAN,IRL,2022.0,1,0,1
DEU,SEN,2008.0,1,0,1
GHA,GMB,2004.0,1,0,1
JAM,NGA,2010.0,1,0,1
SYR,TZA,2008.0,1,0,1
SGP,SRB,2020.0,1,0,1
IND,NOR,2001.0,1,0,1
SRB,SWE,2001.0,1,0,1
CAN,CMR,2014.0,2,0,2
EST,KAZ,2005.0,2,0,2
NGA,TTO,2003.0,1,0,1
GRC,BRN,2017.0,1,0,1
ZAF,LUX,2015.0,1,0,1
ITA,MDG,2004.0,1,0,1
LTU,CAN,2002.0,1,0,1
PRI,PER,2017.0,1,0,1
NAM,MWI,2007.0,1,0,1
GBR,MSR,2012.0,1,0,1
SGP,CHL,2018.0,1,0,1
UKR,SAU,2010.0,1,0,1
VEN,NLD,2007.0,1,0,1
ISL,CHL,2013.0,1,0,1
AUS,AZE,2019.0,1,0,1
ALB,MKD,2022.0,1,0,1
DEU,MOZ,2019.0,1,0,1
,TCA,2014.0,2,0,2
VEN,SGP,2017.0,1,0,1
ARG,BOL,2022.0,1,0,1
CZE,CHN,2001.0,1,0,1
PRT,ARM,2020.0,2,0,2
KAZ,EGY,2016.0,1,0,1
TUN,YEM,2019.0,1,0,1
TWN,IRN,2006.0,1,0,1
MMR,SVK,2021.0,1,0,1
UKR,BRA,1997.0,1,0,1
FIN,QAT,2009.0,1,0,1
CHE,PSE,2016.0,1,0,1
IRL,JOR,1999.0,1,0,1
VNM,LAO,2017.0,1,0,1
HRV,NPL,2019.0,1,0,1
TUN,PRT,2008.0,1,0,1
GUF,CMR,2004.0,1,0,1
TWN,TTO,2008.0,1,0,1
CHL,FLK,2007.0,1,0,1
VEN,SWE,2009.0,2,0,2
CAN,EST,2015.0,1,0,1
TUN,CHE,2008.0,4,0,4
NPL,PHL,2011.0,1,0,1
IRQ,ISR,2010.0,1,0,1
TUR,IDN,2016.0,1,0,1
MDG,ZAF,2013.0,1,0,1
TUN,KOR,2022.0,1,0,1
RWA,CAN,2013.0,1,0,1
DNK,BLR,2019.0,1,0,1
NOR,THA,2017.0,2,0,2
CUB,JPN,2003.0,1,0,1
EGY,ETH,2007.0,2,0,2
LBN,DNK,2009.0,1,0,1
CAN,UZB,2011.0,1,0,1
GAB,,2002.0,1,0,1
ZAF,NCL,2015.0,1,0,1
FIN,SAU,2009.0,1,0,1
TWN,TUR,2001.0,1,0,1
ARM,TWN,1997.0,1,0,1
JPN,KHM,2005.0,1,0,1
EST,GRC,2005.0,1,0,1
IDN,CZE,2006.0,1,0,1
BRA,SAU,2011.0,1,0,1
PRT,BGR,2008.0,1,0,1
TUR,UKR,2007.0,1,0,1
USA,GAB,2006.0,1,0,1
COD,BEL,2009.0,1,0,1
DEU,OMN,2003.0,1,0,1
MYS,ITA,2006.0,1,0,1
ZWE,CAN,2001.0,1,0,1
DNK,CMR,2005.0,1,0,1
LTU,AUS,2003.0,1,0,1
MEX,MYS,2006.0,1,0,1
MKD,SWE,2014.0,1,0,1
BDI,,2014.0,1,0,1
NPL,MUS,2019.0,1,0,1
LVA,DNK,2021.0,1,0,1
HKG,ITA,2012.0,1,0,1
CUB,ARG,2022.0,1,0,1
CMR,NAM,2021.0,1,0,1
ZWE,KEN,2017.0,1,0,1
DEU,KGZ,2019.0,2,0,2
PSE,USA,2022.0,2,0,2
CAN,GIB,2022.0,1,0,1
FJI,KOR,2013.0,1,0,1
JPN,SDN,2021.0,1,0,1
ETH,UZB,2019.0,1,0,1
PRI,SVN,2015.0,1,0,1
SWE,CMR,2012.0,1,0,1
FIN,KEN,2018.0,1,0,1
SRB,LVA,2020.0,1,0,1
CUB,AUT,2006.0,1,0,1
AUS,TUN,2010.0,1,0,1
HRV,OMN,2020.0,1,0,1
USA,TCA,2013.0,1,0,1
THA,FIN,2006.0,1,0,1
TZA,,2000.0,1,0,1
ASM,,2011.0,1,0,1
NCL,KHM,2006.0,2,0,2
FIN,CRI,2005.0,1,0,1
USA,FLK,2012.0,1,0,1
KOR,GRC,2003.0,1,0,1
TUR,HUN,2010.0,2,0,2
IRN,BRA,2006.0,1,0,1
LKA,POL,2011.0,1,0,1
KAZ,IRL,2007.0,1,0,1
LTU,ROU,2007.0,1,0,1
ITA,HND,2010.0,1,0,1
OMN,AUS,1998.0,1,0,1
BRA,BGR,2017.0,1,0,1
IRN,ARG,2015.0,1,0,1
LBY,SAU,2018.0,1,0,1
MAR,FIN,2018.0,1,0,1
CZE,GRC,2008.0,1,0,1
MLI,NER,2019.0,1,0,1
BWA,LBN,2004.0,1,0,1
BGR,NOR,2007.0,1,0,1
BHR,IRL,2008.0,1,0,1
CHE,HTI,2017.0,1,0,1
MYS,KWT,2014.0,1,0,1
KOR,KHM,2014.0,1,0,1
IDN,RUS,2015.0,1,0,1
HUN,OMN,2001.0,1,0,1
BRA,HND,2005.0,1,0,1
QAT,ARE,2009.0,1,0,1
,CAN,2020.0,4,0,4
URY,BEL,1998.0,1,0,1
MYS,ARG,2012.0,1,0,1
PRT,QAT,2019.0,1,0,1
MYS,ARM,2007.0,1,0,1
TWN,SDN,2020.0,1,0,1
LBN,DZA,2011.0,1,0,1
BGR,BRA,2011.0,1,0,1
NLD,CHL,2002.0,1,0,1
DNK,PER,2011.0,1,0,1
SDN,PAK,2013.0,1,0,1
MAR,NER,2021.0,1,0,1
ECU,POL,2019.0,1,0,1
ESP,THA,2005.0,1,0,1
UGA,ISL,2013.0,1,0,1
BGD,BHR,2021.0,1,0,1
TON,NZL,2014.0,1,0,1
BRN,QAT,2020.0,1,0,1
MAC,MKD,2020.0,1,0,1
CMR,USA,2005.0,5,5,0
AUS,DEU,2013.0,113,161,-48
USA,GBR,2015.0,1525,1543,-18
USA,DEU,2010.0,982,1108,-126
IDN,USA,2004.0,6,22,-16
KOR,USA,2012.0,644,944,-300
ISR,USA,2017.0,365,322,43
USA,ARG,2007.0,89,97,-8
CAN,OMN,2006.0,6,1,5
TUR,DEU,2006.0,23,19,4
IRL,CAN,2005.0,21,12,9
USA,TUR,2015.0,285,236,49
GBR,USA,2011.0,1477,1288,189
NGA,USA,2008.0,26,17,9
AUT,USA,2014.0,119,123,-4
MYS,USA,2020.0,48,18,30
NOR,TZA,2009.0,9,2,7
USA,THA,2014.0,219,93,126
ZAF,GBR,2010.0,68,87,-19
CHL,DEU,2021.0,35,14,21
DNK,CHE,2018.0,35,41,-6
USA,BRA,2007.0,276,255,21
GBR,CHN,2018.0,508,379,129
ESP,CRI,2010.0,2,2,0
AUS,FRA,2016.0,92,100,-8
FRA,ESP,2018.0,198,270,-72
ARG,GBR,2013.0,17,12,5
TUR,CHE,2012.0,9,4,5
DEU,UKR,2014.0,13,38,-25
HUN,USA,2008.0,57,64,-7
USA,SAU,2021.0,206,92,114
JOR,USA,2004.0,10,24,-14
MEX,IND,2009.0,7,4,3
CAN,SRB,2018.0,3,4,-1
SVK,CZE,2007.0,27,17,10
USA,JPN,2021.0,507,440,67
GRC,FRA,2014.0,35,23,12
PRT,CAN,2004.0,5,4,1
ESP,PAN,2013.0,5,2,3
GBR,ZAF,2005.0,57,50,7
DNK,GBR,2008.0,55,66,-11
ARG,CAN,2015.0,13,16,-3
AUS,ETH,2019.0,10,22,-12
ISR,USA,2010.0,360,279,81
CHN,THA,2009.0,3,1,2
IRL,USA,2008.0,101,114,-13
SWE,BEL,2008.0,10,8,2
BEL,DEU,2015.0,89,105,-16
FRA,GRC,2020.0,26,39,-13
CHN,PAK,2009.0,19,10,9
CHN,CAN,2008.0,151,134,17
USA,RUS,2016.0,148,151,-3
CHN,USA,2001.0,642,250,392
GBR,NLD,2017.0,247,328,-81
PRT,BRA,2014.0,107,83,24
USA,DEU,2019.0,1032,1140,-108
IRN,ITA,2009.0,11,6,5
NLD,ESP,2007.0,57,32,25
ISR,USA,2019.0,344,335,9
GBR,MYS,2011.0,109,45,64
CAN,ARE,2007.0,11,6,5
ZAF,NGA,2011.0,13,31,-18
ISR,FRA,2012.0,21,17,4
BRA,ISR,2014.0,5,1,4
IND,CHN,2019.0,252,55,197
CHE,AUS,2016.0,59,54,5
AUT,DEU,2013.0,323,287,36
DNK,AUS,2011.0,18,25,-7
ARE,KWT,2007.0,2,1,1
ESP,RUS,2011.0,5,14,-9
TUR,CYP,2015.0,35,20,15
SWE,IND,2016.0,35,58,-23
USA,ETH,2014.0,19,18,1
JOR,IRQ,2021.0,4,1,3
BGD,AUS,2020.0,62,58,4
HKG,AUS,2007.0,32,26,6
GBR,GRC,2003.0,129,64,65
GBR,IRL,2021.0,209,181,28
NLD,USA,2020.0,343,355,-12
GBR,NLD,2019.0,328,316,12
IRN,IRQ,2012.0,5,2,3
GBR,NZL,2011.0,128,99,29
MEX,GBR,2018.0,66,53,13
PRT,CHE,2012.0,11,8,3
THA,USA,2012.0,101,205,-104
ESP,ZAF,2015.0,9,6,3
ROU,GBR,2015.0,21,13,8
CHE,GBR,2018.0,228,275,-47
VEN,ESP,2010.0,30,26,4
ESP,CRI,2019.0,8,8,0
PRT,DNK,2015.0,18,3,15
CHL,AUS,2020.0,19,9,10
USA,ZAF,2018.0,80,107,-27
TWN,HKG,2011.0,6,9,-3
OMN,PAK,2013.0,1,9,-8
BGD,GBR,2022.0,15,6,9
FIN,GBR,2016.0,53,50,3
ESP,CHL,2021.0,60,76,-16
POL,CZE,2019.0,19,11,8
THA,IND,2012.0,6,5,1
VEN,ESP,2019.0,20,9,11
CAN,FRA,2021.0,189,235,-46
DEU,TWN,2014.0,18,25,-7
USA,HUN,2017.0,49,52,-3
FRA,BEN,2015.0,9,11,-2
BEL,USA,2022.0,69,52,17
AUT,BEL,2020.0,14,15,-1
IND,NPL,2015.0,33,19,14
KEN,CHN,2018.0,11,8,3
IND,CHN,2017.0,171,39,132
SWE,DNK,2004.0,49,39,10
TZA,NOR,2020.0,1,6,-5
SWZ,USA,2016.0,1,1,0
ITA,CAN,2018.0,77,52,25
ETH,DEU,2013.0,4,7,-3
ZAF,GBR,2017.0,103,64,39
KAZ,USA,2019.0,23,18,5
JPN,CHN,2021.0,380,256,124
DNK,SWE,2020.0,90,77,13
SVN,CHE,2016.0,12,1,11
AUS,NZL,2021.0,96,97,-1
CHE,POL,2007.0,13,13,0
UKR,USA,2016.0,29,12,17
PRT,DEU,2015.0,41,27,14
FRA,MYS,2014.0,11,6,5
SWE,PAK,2016.0,17,3,14
ZMB,ZAF,2019.0,5,9,-4
CHE,BGD,2014.0,2,2,0
BEL,GBR,1998.0,12,10,2
FIN,ESP,2022.0,2,13,-11
EGY,GBR,2021.0,47,39,8
BEL,LUX,2020.0,18,6,12
KOR,VNM,2006.0,5,2,3
DNK,CHN,2018.0,45,56,-11
NZL,MYS,2014.0,20,6,14
DZA,GBR,2017.0,1,6,-5
USA,NZL,2018.0,125,123,2
UZB,KOR,2012.0,1,1,0
ESP,GBR,1999.0,52,62,-10
MEX,CAN,2019.0,46,25,21
ZMB,USA,2015.0,20,10,10
PAK,CHN,2011.0,25,35,-10
USA,EGY,2013.0,100,72,28
USA,MNG,2014.0,4,2,2
UKR,GBR,2019.0,10,7,3
CAN,DNK,2017.0,26,31,-5
GBR,IRQ,2021.0,51,14,37
AUS,SWE,2021.0,37,30,7
POL,SWE,2018.0,20,10,10
THA,IDN,2022.0,6,11,-5
GBR,CHE,2022.0,130,115,15
POL,FRA,2008.0,29,22,7
URY,CAN,2013.0,1,2,-1
DNK,USA,2011.0,85,124,-39
COL,GBR,2019.0,13,21,-8
GBR,NLD,2010.0,187,185,2
GHA,GBR,2020.0,16,18,-2
PAK,USA,2008.0,30,36,-6
DEU,NOR,2017.0,68,40,28
NLD,DEU,2003.0,146,170,-24
HKG,KOR,2020.0,21,17,4
AUS,ETH,2017.0,5,11,-6
ETH,AUS,2020.0,15,12,3
QAT,ZAF,2019.0,1,1,0
GBR,PER,2021.0,3,7,-4
COL,ARG,2019.0,20,14,6
GBR,PHL,2020.0,10,5,5
USA,ARE,2016.0,82,43,39
FRA,NCL,2018.0,24,17,7
PRT,RUS,2011.0,2,5,-3
KAZ,KOR,2019.0,9,2,7
GBR,AUT,2022.0,49,44,5
ECU,PER,2020.0,5,2,3
JOR,QAT,2021.0,8,1,7
MEX,HUN,2021.0,3,1,2
CAN,TUN,2021.0,3,9,-6
USA,PAK,2009.0,48,37,11
MAR,ESP,2021.0,8,7,1
CAN,USA,2000.0,397,267,130
SAU,ARE,2018.0,39,7,32
RUS,KAZ,1997.0,2,2,0
CAN,ARG,2013.0,10,16,-6
YEM,CHN,2020.0,3,2,1
CHN,FRA,2016.0,142,195,-53
USA,KAZ,2022.0,4,11,-7
AUS,ARE,2003.0,3,2,1
FRA,NLD,2018.0,109,116,-7
IND,KOR,2022.0,143,61,82
BEL,JPN,2002.0,9,9,0
AUS,ITA,2018.0,41,50,-9
IRL,NLD,1997.0,3,1,2
VEN,ESP,2017.0,22,8,14
USA,CUB,2007.0,3,7,-4
IRL,BRA,2015.0,4,7,-3
USA,JOR,2010.0,41,20,21
FRA,URY,2012.0,8,1,7
MYS,ARE,2021.0,13,4,9
ESP,ARG,2012.0,68,54,14
TWN,USA,2007.0,213,316,-103
SWE,AUT,2012.0,10,19,-9
BEL,ESP,2012.0,22,42,-20
TUR,NLD,2009.0,16,6,10
CHN,UKR,2019.0,5,13,-8
MYS,SAU,2013.0,46,13,33
GRC,CYP,2016.0,30,20,10
SGP,HKG,2009.0,24,32,-8
SGP,RUS,2011.0,1,5,-4
PRT,GBR,2013.0,74,56,18
FIN,TUR,2010.0,7,2,5
DZA,GBR,2019.0,4,6,-2
IRQ,USA,2009.0,3,3,0
KEN,GBR,2012.0,13,21,-8
UGA,BEL,2009.0,2,2,0
BEL,SWE,2018.0,34,25,9
BRA,BEL,2015.0,19,25,-6
ZAF,POL,2013.0,6,1,5
TWN,AUS,2001.0,6,5,1
KOR,DEU,2002.0,22,13,9
GBR,JPN,1998.0,24,27,-3
KOR,DEU,2005.0,20,22,-2
GBR,JPN,1997.0,22,14,8
CAN,CHN,2001.0,32,82,-50
JPN,DNK,2003.0,13,6,7
AUS,DNK,2011.0,25,18,7
ESP,MAR,2015.0,17,5,12
HKG,ZAF,2022.0,1,1,0
CHN,ARE,2020.0,15,8,7
GBR,MUS,2007.0,3,1,2
DEU,IND,2020.0,113,182,-69
RUS,BRA,2002.0,13,12,1
KOR,EGY,2016.0,4,3,1
DEU,NOR,2019.0,69,42,27
FRA,ROU,2007.0,36,24,12
FIN,POL,2022.0,3,2,1
DZA,DEU,2002.0,2,2,0
CAN,SWE,2010.0,31,28,3
FRA,ISR,2001.0,17,14,3
SGP,MYS,2021.0,17,12,5
GRC,USA,2003.0,59,130,-71
HUN,SWE,2014.0,10,5,5
CHE,BRA,2000.0,2,2,0
GRD,USA,2019.0,20,13,7
IRL,AUS,2011.0,36,24,12
NZL,GBR,2001.0,54,66,-12
IRN,IND,2008.0,3,5,-2
USA,CYP,2018.0,10,6,4
ZAF,SLE,2013.0,1,1,0
CHE,IRN,2020.0,11,35,-24
CHL,MEX,2008.0,5,9,-4
COL,ARG,2017.0,12,20,-8
RUS,GBR,2022.0,28,19,9
ARG,ITA,2015.0,16,14,2
ZAF,NLD,2021.0,13,15,-2
DEU,GRC,2009.0,39,51,-12
ETH,BEL,2020.0,1,8,-7
KOR,LUX,2020.0,3,2,1
CAN,FIN,2017.0,14,18,-4
ROU,FRA,2000.0,8,11,-3
KEN,ZAF,2022.0,6,5,1
USA,HUN,2010.0,36,75,-39
ESP,ROU,2018.0,4,9,-5
RUS,SWE,2012.0,24,13,11
IRL,GBR,1998.0,15,23,-8
ITA,ISR,2013.0,15,6,9
VNM,SWE,2020.0,4,5,-1
DEU,BGD,2022.0,2,3,-1
COL,ESP,2011.0,38,50,-12
JOR,DEU,2022.0,5,2,3
NLD,CAN,2000.0,14,9,5
TWN,CHN,2002.0,33,26,7
EGY,MYS,2018.0,9,10,-1
JPN,BGD,2011.0,63,37,26
ZWE,GBR,2010.0,6,3,3
PHL,TWN,2009.0,1,1,0
POL,DEU,2012.0,69,115,-46
JPN,IRL,2013.0,3,12,-9
HUN,NOR,2019.0,6,2,4
TUR,CHN,2020.0,13,9,4
JPN,IDN,2003.0,25,7,18
USA,NPL,2021.0,16,37,-21
ZAF,COG,2018.0,1,1,0
LUX,ESP,2021.0,1,6,-5
CAN,DNK,2010.0,23,16,7
AUS,OMN,2012.0,3,1,2
ISR,PSE,2005.0,13,3,10
EGY,RUS,2005.0,1,2,-1
AUS,LKA,2008.0,5,6,-1
CAN,ITA,2006.0,34,40,-6
PRT,CUB,2013.0,1,2,-1
USA,BIH,2012.0,6,2,4
ITA,ZAF,2015.0,11,3,8
USA,NGA,2008.0,17,26,-9
HRV,AUT,2013.0,7,1,6
ISL,NOR,2018.0,4,5,-1
BEL,ITA,2004.0,23,26,-3
BGR,BEL,2012.0,8,4,4
SDN,SAU,2001.0,2,1,1
CHN,ZAF,2012.0,3,4,-1
ZAF,FRA,2006.0,9,9,0
RUS,ESP,2001.0,14,11,3
GBR,HUN,2002.0,22,21,1
ESP,HRV,2002.0,2,7,-5
FRA,MDG,2001.0,3,6,-3
IRL,GBR,1997.0,11,17,-6
BEL,CHE,2004.0,29,8,21
HRV,DEU,2004.0,9,7,2
POL,GBR,2004.0,22,17,5
SVK,CHE,2002.0,7,3,4
ISL,CHE,2002.0,1,1,0
GBR,JOR,2009.0,11,6,5
ARG,NLD,2004.0,5,2,3
NZL,PAK,2011.0,2,2,0
CAN,POL,2003.0,12,12,0
USA,GUM,2019.0,9,4,5
LUX,SGP,2017.0,1,4,-3
BEL,GRC,2004.0,10,6,4
AUS,CAN,2000.0,29,27,2
UKR,JPN,2003.0,7,4,3
UKR,DEU,2001.0,25,15,10
SVK,SVN,2003.0,2,1,1
CZE,RUS,2007.0,8,7,1
SYR,USA,2003.0,1,5,-4
CAN,FIN,2010.0,15,11,4
LUX,FRA,2014.0,22,34,-12
ISR,CHE,2001.0,4,5,-1
NLD,ARG,2005.0,5,3,2
JPN,RUS,2021.0,8,3,5
NZL,IRL,2003.0,2,3,-1
AUS,CZE,2005.0,4,2,2
CZE,FRA,2006.0,13,10,3
FRA,SVK,1997.0,3,1,2
MEX,CHL,2012.0,8,12,-4
ITA,POL,2002.0,16,15,1
USA,HUN,2019.0,47,56,-9
CMR,FRA,2003.0,4,17,-13
USA,NOR,2001.0,43,45,-2
BEL,FIN,2002.0,2,3,-1
ISR,BEL,2010.0,2,6,-4
BEL,ISR,2011.0,5,3,2
AZE,RUS,1998.0,3,2,1
AUS,POL,2001.0,5,3,2
AUS,HUN,2008.0,2,2,0
ZAF,JPN,2003.0,4,1,3
DNK,NLD,2004.0,17,9,8
ISR,AUS,2022.0,6,5,1
POL,DNK,2021.0,3,5,-2
GBR,HUN,2005.0,17,16,1
BLR,RUS,2001.0,8,10,-2
BRA,URY,2009.0,4,4,0
PRI,ESP,2009.0,5,2,3
COL,DEU,2006.0,6,4,2
BHR,OMN,2005.0,1,1,0
BRA,ARG,2004.0,10,18,-8
HKG,SGP,2011.0,37,17,20
CHE,SGP,2007.0,9,4,5
SGP,ESP,2017.0,8,6,2
HKG,TWN,2004.0,3,4,-1
TWN,CHN,2005.0,30,16,14
CUB,ITA,2014.0,2,1,1
ECU,FRA,2013.0,2,4,-2
HRV,CHE,2015.0,6,1,5
PHL,JPN,2008.0,11,19,-8
FIN,GHA,2019.0,2,3,-1
AUS,BRA,2012.0,9,31,-22
TWN,SGP,2003.0,2,3,-1
DEU,SGP,2009.0,25,16,9
AUT,NLD,2000.0,5,3,2
USA,BOL,2014.0,5,3,2
JPN,IRN,2008.0,18,9,9
BFA,NGA,2018.0,1,2,-1
SGP,CHE,2005.0,7,5,2
IND,ETH,2006.0,4,3,1
RWA,ZAF,2010.0,2,1,1
RUS,POL,2012.0,17,9,8
MEX,UKR,2014.0,2,2,0
CAN,ROU,2010.0,5,4,1
ITA,CHN,2007.0,13,12,1
USA,NIC,2014.0,2,1,1
ZAF,GHA,2020.0,24,12,12
MWI,GBR,2004.0,2,8,-6
ISR,DNK,2016.0,3,2,1
BEL,PRT,2016.0,15,22,-7
GBR,TTO,2012.0,7,5,2
COL,CAN,2014.0,5,10,-5
USA,UZB,2015.0,2,1,1
GBR,BRN,2007.0,2,1,1
OMN,GBR,2016.0,6,11,-5
CAN,HKG,2021.0,17,21,-4
CZE,IND,2016.0,15,15,0
USA,VEN,2013.0,9,34,-25
SGP,THA,2014.0,8,3,5
JPN,ISR,2022.0,2,1,1
MEX,ITA,2014.0,10,11,-1
ROU,POL,2016.0,2,2,0
ZWE,GBR,2019.0,5,10,-5
CHN,IND,2012.0,15,21,-6
PRT,SWE,2008.0,4,4,0
NZL,DNK,2017.0,5,6,-1
KOR,MNG,2011.0,3,2,1
CHN,UKR,2017.0,5,20,-15
NER,GBR,2016.0,1,3,-2
MYS,IRN,2009.0,6,34,-28
IRN,DNK,2012.0,14,6,8
ARE,SWE,2020.0,6,5,1
ROU,ESP,2016.0,3,5,-2
PRT,IRL,2011.0,3,1,2
MEX,NLD,2013.0,5,8,-3
IND,CZE,2015.0,19,8,11
NOR,CZE,2007.0,1,1,0
IND,NZL,2015.0,9,7,2
TUR,PAK,2022.0,12,9,3
NZL,DNK,2010.0,5,2,3
RUS,FIN,2022.0,14,3,11
IND,GHA,2019.0,5,2,3
CAN,KAZ,2018.0,5,3,2
CIV,SEN,2020.0,3,2,1
HKG,GHA,2021.0,3,3,0
POL,CZE,2017.0,21,14,7
MKD,BGR,2015.0,1,2,-1
THA,ITA,2018.0,4,4,0
UZB,RUS,1999.0,4,3,1
COD,COG,2013.0,6,16,-10
PER,CHL,2018.0,10,12,-2
CHE,NGA,2018.0,4,6,-2
SYR,SAU,2018.0,2,1,1
MYS,BGD,2022.0,18,12,6
BEL,ZAF,2020.0,14,12,2
NGA,JPN,2021.0,3,4,-1
SGP,ESP,2019.0,8,4,4
NGA,CMR,2022.0,4,1,3
POL,PRT,2020.0,5,4,1
GRC,FIN,2021.0,2,2,0
CAN,DNK,2019.0,26,30,-4
CZE,SVK,2001.0,17,9,8
SRB,GBR,2004.0,8,3,5
FRA,DZA,1998.0,5,4,1
NGA,GBR,2001.0,8,7,1
ALB,ITA,2007.0,1,2,-1
DEU,KOR,2001.0,12,11,1
BEL,ROU,1998.0,4,1,3
ITA,SVN,2014.0,6,10,-4
DNK,CZE,2008.0,4,1,3
NIC,USA,2010.0,1,3,-2
MYS,SDN,2018.0,13,2,11
LBN,CHE,2015.0,5,3,2
MEX,CHE,2019.0,8,5,3
PER,COL,2008.0,3,1,2
CHE,IND,2009.0,9,21,-12
VEN,DEU,2017.0,12,2,10
IRL,SRB,2017.0,2,1,1
AUS,PRT,2018.0,3,7,-4
USA,TUN,2005.0,5,1,4
BIH,DEU,2008.0,2,3,-1
MNG,JPN,2019.0,10,18,-8
ISR,ZAF,2020.0,3,5,-2
ITA,VEN,2011.0,1,1,0
BRA,NLD,2011.0,14,13,1
HKG,CAN,2008.0,15,24,-9
ZAF,CHN,2013.0,7,7,0
ISR,CHN,2002.0,6,8,-2
NGA,UGA,2021.0,4,1,3
NPL,CHN,2016.0,9,4,5
NZL,DNK,2019.0,3,4,-1
SWE,IRN,2022.0,4,17,-13
LUX,NLD,2021.0,5,5,0
MEX,CHE,2017.0,8,5,3
OMN,KWT,2020.0,3,1,2
GBR,COL,2006.0,7,5,2
POL,NOR,2018.0,13,6,7
SWE,OMN,2017.0,1,2,-1
CZE,PRT,2014.0,3,3,0
NPL,GBR,2018.0,8,9,-1
USA,GEO,2017.0,19,15,4
HUN,IRL,2001.0,1,1,0
FRA,MTQ,1998.0,16,4,12
IRN,KAZ,2022.0,3,1,2
VNM,AUS,2004.0,3,2,1
FIN,JPN,2021.0,6,4,2
BEL,IRL,2009.0,4,4,0
ISR,CHN,2005.0,5,2,3
PAN,COL,2022.0,1,1,0
BLR,DEU,2008.0,8,3,5
DZA,GBR,2010.0,2,2,0
NOR,DNK,1999.0,15,5,10
GEO,RUS,2016.0,3,5,-2
USA,BLR,2007.0,8,6,2
FIN,NOR,2006.0,11,4,7
IRL,CAN,2002.0,8,13,-5
ITA,SAU,2012.0,13,3,10
RUS,BRA,2005.0,4,11,-7
BEL,NOR,2001.0,2,3,-1
SWE,ZWE,2002.0,1,1,0
FIN,FRA,2000.0,2,6,-4
CHN,BEL,1999.0,3,1,2
FRA,MCO,2015.0,10,2,8
RUS,KAZ,1998.0,5,4,1
CAN,PRT,2001.0,1,5,-4
FRA,IND,2003.0,11,20,-9
COL,ARG,2010.0,8,7,1
PRI,MEX,2014.0,1,1,0
LVA,SWE,2012.0,3,3,0
JPN,SVK,2003.0,4,3,1
GRC,AUS,2004.0,1,2,-1
TUR,AZE,2005.0,2,5,-3
AUS,THA,2000.0,4,1,3
SGP,SAU,2013.0,5,1,4
JAM,USA,2013.0,2,6,-4
IDN,KEN,2011.0,1,2,-1
FRA,TWN,2009.0,6,8,-2
ITA,CHL,2016.0,18,11,7
ARG,CUB,2009.0,3,1,2
USA,GEO,2019.0,17,16,1
USA,ARM,2014.0,7,6,1
NLD,GHA,2012.0,2,2,0
ESP,SVK,2019.0,3,2,1
GRC,ARE,2018.0,8,1,7
AUS,GHA,2012.0,1,2,-1
HUN,FRA,2000.0,10,8,2
CHN,IRL,2009.0,8,8,0
PRI,COL,2014.0,4,1,3
EGY,QAT,2015.0,11,8,3
ISR,ROU,2017.0,3,1,2
AUT,PAK,2018.0,6,3,3
BRA,DNK,2013.0,5,5,0
CRI,AUS,2014.0,1,1,0
TZA,SWE,2015.0,2,1,1
KAZ,USA,2017.0,12,18,-6
ROU,SAU,2016.0,3,1,2
NGA,MYS,2010.0,10,3,7
AUT,IRN,2018.0,10,13,-3
URY,GBR,2019.0,3,2,1
ISR,CZE,2021.0,4,5,-1
ZAF,MOZ,2020.0,3,2,1
ZWE,GBR,2017.0,4,9,-5
CRI,DEU,2018.0,3,7,-4
ITA,HKG,2021.0,6,2,4
CAN,ROU,2019.0,7,5,2
EGY,HUN,2002.0,1,1,0
KGZ,CHN,2020.0,2,2,0
MYS,OMN,2008.0,2,1,1
TZA,CAN,2017.0,1,1,0
BHR,TUR,2020.0,1,1,0
IDN,DEU,2018.0,9,27,-18
NGA,FIN,2009.0,1,1,0
BOL,USA,2016.0,6,4,2
IND,FJI,2004.0,3,1,2
UGA,ZAF,2008.0,2,1,1
USA,GEO,2010.0,7,12,-5
PRT,FRA,2006.0,15,27,-12
USA,CMR,2020.0,6,9,-3
JPN,ITA,2000.0,6,12,-6
NLD,BGR,2004.0,1,4,-3
TUR,KGZ,2016.0,4,5,-1
IRN,ZAF,2012.0,4,1,3
TUR,MEX,2018.0,1,3,-2
DZA,DEU,2005.0,2,2,0
COG,BEL,2013.0,6,4,2
CHE,FIN,2001.0,4,6,-2
QAT,ITA,2020.0,4,5,-1
AUT,KOR,2022.0,3,4,-1
CHN,HUN,2006.0,3,2,1
CAN,THA,2007.0,11,8,3
SDN,GBR,2021.0,3,1,2
GRD,USA,2017.0,11,9,2
JAM,DEU,2019.0,3,2,1
ZAF,COL,2007.0,1,3,-2
SWE,UGA,2010.0,2,1,1
ESP,ALB,2017.0,1,1,0
CZE,AUS,2015.0,3,8,-5
CHN,COG,2017.0,3,2,1
BRA,IRN,2014.0,1,10,-9
MEX,CHE,2010.0,3,3,0
ITA,SRB,2015.0,3,7,-4
PHL,RUS,2014.0,1,1,0
QAT,NLD,2022.0,2,2,0
CHN,MEX,2002.0,2,1,1
ISL,RUS,2020.0,2,1,1
EGY,KWT,2014.0,12,9,3
JPN,ZMB,2017.0,2,1,1
KHM,AUS,2013.0,1,1,0
DEU,TUN,2006.0,1,1,0
VEN,FRA,2008.0,3,2,1
FIN,NZL,2018.0,3,3,0
ARM,DEU,2013.0,2,1,1
ITA,TUR,2006.0,6,2,4
GRC,NLD,2005.0,10,8,2
MKD,SRB,2008.0,5,11,-6
RUS,AZE,2004.0,5,4,1
SAU,MYS,2009.0,3,6,-3
RUS,SVN,2021.0,2,3,-1
CAN,MAR,2008.0,2,3,-1
HRV,SRB,2003.0,4,4,0
FRA,KHM,2018.0,11,6,5
JPN,CZE,2003.0,10,7,3
BEL,GBR,1997.0,5,10,-5
TTO,GBR,2001.0,3,4,-1
GRC,NLD,2002.0,6,4,2
NLD,BRA,1998.0,1,1,0
ZAF,DEU,2000.0,2,5,-3
FRA,SGP,2004.0,2,6,-4
POL,CZE,2010.0,6,4,2
TUR,UKR,2020.0,2,4,-2
BGR,NOR,2020.0,1,1,0
ZAF,COD,2021.0,2,1,1
BGR,JPN,2001.0,2,5,-3
NOR,KOR,2014.0,1,3,-2
COL,IND,2020.0,1,2,-1
ITA,BLR,1999.0,1,1,0
CHE,EGY,2005.0,2,3,-1
SVK,RUS,2007.0,3,4,-1
JPN,GHA,2003.0,2,1,1
IRL,ESP,2005.0,3,10,-7
ZAF,CHE,2011.0,8,7,1
ITA,IND,1999.0,5,7,-2
CHE,EGY,2002.0,2,2,0
AUT,HRV,2009.0,3,3,0
AUS,HRV,2017.0,3,1,2
DEU,VNM,2007.0,5,2,3
BRA,PRI,2018.0,1,1,0
DEU,NPL,2005.0,1,2,-1
JPN,NOR,2013.0,5,5,0
BEL,THA,2016.0,3,3,0
ESP,TWN,2018.0,5,5,0
ISR,BEL,2017.0,2,5,-3
NLD,SGP,2018.0,15,15,0
CHE,UKR,2013.0,2,4,-2
VEN,DEU,2010.0,5,1,4
PAK,JPN,2016.0,6,10,-4
PER,VEN,2014.0,1,1,0
BLR,FRA,2018.0,1,1,0
ESP,CRI,2017.0,7,3,4
CHN,EGY,2012.0,5,2,3
VUT,CHE,2019.0,1,1,0
PSE,FRA,2020.0,1,1,0
USA,GUM,2017.0,3,4,-1
COL,NLD,2016.0,4,5,-1
FIN,EST,2001.0,6,2,4
DEU,HRV,2012.0,7,7,0
ARG,DEU,2000.0,5,10,-5
USA,VNM,2006.0,5,3,2
ROU,BEL,2001.0,3,2,1
LUX,BEL,2003.0,2,6,-4
UKR,FIN,2007.0,1,1,0
EGY,TUR,2022.0,6,2,4
ARG,MEX,2005.0,13,6,7
SRB,PRT,2018.0,2,1,1
DNK,CAN,2000.0,4,4,0
CAN,ROU,2017.0,4,4,0
AUS,HRV,2019.0,3,3,0
URY,FRA,2016.0,2,2,0
CHN,PRT,2013.0,11,4,7
GBR,ISL,2000.0,2,2,0
PRT,GRC,2016.0,2,2,0
GBR,SYR,2008.0,5,2,3
COL,GBR,2010.0,4,11,-7
SWE,SVK,2014.0,1,3,-2
LUX,USA,2009.0,3,3,0
AUS,MYS,1999.0,1,2,-1
CYP,USA,2018.0,6,10,-4
SVK,POL,2011.0,5,3,2
KOR,MYS,2013.0,8,5,3
LTU,FIN,2007.0,2,1,1
NLD,MLI,2010.0,1,1,0
DEU,NGA,2007.0,3,4,-1
BRA,MYS,2016.0,1,1,0
ZWE,NLD,2006.0,1,1,0
AUT,SRB,2020.0,1,7,-6
TZA,CAN,2010.0,2,1,1
TUN,OMN,2017.0,2,1,1
NOR,AUS,2008.0,2,15,-13
CZE,ROU,2016.0,2,1,1
MNG,JPN,2010.0,2,8,-6
COL,ITA,2007.0,3,1,2
GRD,USA,2010.0,4,5,-1
TWN,FRA,2018.0,5,10,-5
ARE,SAU,2000.0,1,2,-1
KOR,CHL,2013.0,5,1,4
MEX,AUT,2021.0,4,1,3
NIC,USA,2017.0,4,1,3
IND,HKG,1999.0,3,1,2
POL,GRC,2009.0,5,1,4
CAN,HND,2019.0,1,1,0
NZL,BRN,2017.0,1,1,0
MYS,POL,2013.0,2,2,0
RUS,SRB,2020.0,1,2,-1
DEU,GHA,2003.0,3,3,0
USA,SLE,2016.0,3,4,-1
ARG,CRI,2021.0,1,2,-1
ESP,ETH,2021.0,1,2,-1
EGY,BEL,2004.0,1,1,0
SRB,SVK,2015.0,1,1,0
ITA,UKR,2007.0,1,4,-3
SWE,BRA,2000.0,2,3,-1
NLD,FIN,2000.0,3,1,2
SWE,CHL,2001.0,3,1,2
LKA,SWE,2005.0,1,1,0
MNG,CZE,2006.0,1,1,0
FRA,ISL,2014.0,3,3,0
SEN,BEL,2013.0,1,1,0
CHL,IRL,2015.0,2,1,1
PRT,AUT,2012.0,3,6,-3
JPN,NGA,2018.0,8,2,6
CHE,SLE,2016.0,1,1,0
URY,GBR,2017.0,2,3,-1
SWE,NGA,2018.0,2,4,-2
CHN,CYP,2020.0,1,1,0
NOR,VNM,2015.0,3,1,2
EST,AUS,2015.0,2,1,1
MMR,JPN,2020.0,3,9,-6
DNK,OMN,2018.0,1,1,0
NLD,ARG,2002.0,1,7,-6
NOR,UGA,2021.0,2,2,0
COG,FRA,2005.0,1,11,-10
FRA,IDN,2007.0,4,2,2
FRA,DZA,1997.0,2,2,0
MRT,FRA,2007.0,2,1,1
ITA,ETH,2014.0,2,6,-4
RUS,ISR,2009.0,5,8,-3
DZA,ESP,2005.0,1,1,0
BFA,BEL,2008.0,2,1,1
IRL,NLD,1998.0,2,3,-1
PAK,BRA,2009.0,4,1,3
SGP,ESP,2010.0,1,4,-3
BEL,SRB,2016.0,3,4,-1
BEL,CYP,2016.0,2,1,1
IRN,ROU,2014.0,2,1,1
CHN,BLR,2014.0,2,1,1
SVK,CHE,2005.0,4,2,2
TWN,MEX,2011.0,2,1,1
SWE,ZWE,2005.0,2,2,0
NOR,NGA,2019.0,1,3,-2
IRN,CAN,1997.0,1,3,-2
SGP,VNM,2008.0,1,3,-2
CMR,USA,2002.0,3,8,-5
EGY,NOR,2008.0,2,1,1
MAR,GAB,2015.0,3,1,2
SGP,CHE,2002.0,1,1,0
TZA,KEN,2011.0,3,1,2
ECU,ESP,2014.0,4,37,-33
AZE,USA,2021.0,2,1,1
ROU,DNK,2005.0,1,2,-1
ESP,LTU,2021.0,2,2,0
FIN,TZA,2013.0,2,1,1
KAZ,USA,2010.0,2,3,-1
POL,BGR,2000.0,1,1,0
ETH,ZAF,2009.0,2,3,-1
NOR,ARE,2018.0,2,2,0
KHM,GBR,2013.0,1,1,0
LAO,KHM,2020.0,1,3,-2
GRC,BGR,2022.0,1,1,0
CAN,BLR,2009.0,1,2,-1
VNM,NLD,2014.0,2,3,-1
NOR,NGA,2010.0,1,1,0
IRQ,IND,2020.0,2,9,-7
NOR,ISL,2016.0,5,3,2
SWE,BWA,2008.0,1,2,-1
RUS,PRT,2000.0,2,1,1
CAN,ISL,2016.0,3,1,2
JPN,NPL,2002.0,3,1,2
AUS,KWT,2002.0,3,1,2
BIH,ITA,2013.0,1,2,-1
NZL,ISR,2017.0,3,4,-1
QAT,EGY,2007.0,2,8,-6
PRT,THA,2015.0,1,1,0
TZA,DEU,2015.0,6,6,0
IRL,TUR,2022.0,1,4,-3
SGP,BRN,2011.0,1,1,0
LVA,EST,2013.0,3,1,2
MLI,DEU,2014.0,1,1,0
AUT,NZL,2003.0,1,3,-2
BGD,SAU,2011.0,1,1,0
HKG,BGD,2013.0,2,1,1
HRV,BEL,2011.0,1,1,0
IRL,SGP,2018.0,2,2,0
LUX,SGP,2019.0,2,2,0
PER,BOL,2019.0,1,2,-1
DNK,ESP,1997.0,1,4,-3
VNM,IRN,2020.0,1,18,-17
USA,GUM,2010.0,1,4,-3
DNK,ESP,1998.0,3,2,1
FRA,NGA,2005.0,1,2,-1
ARE,TUN,2021.0,5,7,-2
ETH,IND,2003.0,2,3,-1
GBR,FJI,2009.0,1,1,0
CHN,UGA,2021.0,1,2,-1
ZAF,RUS,2014.0,1,4,-3
NOR,LKA,2012.0,1,3,-2
COL,JPN,2004.0,1,1,0
FIN,TUR,2017.0,2,2,0
CUB,BEL,2018.0,2,1,1
USA,ZMB,2012.0,3,10,-7
GBR,MDG,2021.0,1,2,-1
RWA,ZAF,2017.0,1,6,-5
VEN,ITA,2002.0,1,2,-1
SGP,EGY,2020.0,2,1,1
NLD,GRC,1998.0,1,1,0
NGA,DEU,2002.0,5,5,0
UGA,GBR,2007.0,4,5,-1
FIN,HUN,2006.0,1,1,0
CAN,ZAF,2000.0,1,5,-4
BMU,USA,2014.0,3,1,2
AUT,NOR,2003.0,2,1,1
CRI,GTM,2019.0,1,1,0
CYP,FRA,2020.0,1,4,-3
CHN,MWI,2018.0,3,1,2
NGA,BRA,2016.0,2,3,-1
GBR,SLE,2021.0,2,1,1
POL,BLR,2006.0,1,3,-2
NGA,SAU,2003.0,2,3,-1
NLD,CHN,2000.0,1,10,-9
FIN,ISL,2010.0,1,1,0
PER,ITA,2019.0,2,1,1
CAN,CYP,2008.0,3,1,2
CMR,IND,2019.0,1,2,-1
IRL,AUT,2006.0,4,4,0
ESP,SVK,2010.0,2,2,0
GBR,HRV,2003.0,1,4,-3
GBR,CHL,1999.0,1,2,-1
THA,GBR,1999.0,3,5,-2
ROU,RUS,2008.0,1,3,-2
ITA,ISL,2011.0,1,1,0
BGD,EGY,2001.0,1,1,0
JOR,YEM,2019.0,2,1,1
ECU,KOR,2019.0,1,2,-1
DEU,GAB,2003.0,1,2,-1
HND,ARG,2019.0,2,1,1
MKD,ITA,2017.0,1,1,0
ISR,PSE,2002.0,1,2,-1
ISR,TUR,2018.0,4,2,2
ITA,URY,2021.0,1,1,0
BEL,HKG,2021.0,1,2,-1
LAO,FRA,2016.0,2,2,0
MEX,CZE,2008.0,3,2,1
SVN,MEX,2012.0,1,1,0
IRQ,SWE,2018.0,1,3,-2
VNM,NOR,2022.0,2,1,1
USA,LBY,2011.0,1,1,0
USA,GMB,2002.0,1,3,-2
ZAF,SVK,2011.0,1,2,-1
ROU,NLD,2008.0,3,5,-2
FIN,HKG,2013.0,1,1,0
VNM,JPN,2008.0,2,15,-13
BWA,USA,2006.0,3,7,-4
SWE,UGA,2017.0,2,2,0
SWE,UGA,2019.0,2,4,-2
SGP,ITA,2012.0,1,6,-5
CHE,SRB,2003.0,1,4,-3
SVN,NLD,2001.0,1,1,0
FRA,BGD,2018.0,3,2,1
ARG,VEN,1997.0,1,1,0
ROU,FIN,2006.0,1,1,0
ISR,CHL,2020.0,2,1,1
EST,NLD,2016.0,1,1,0
IRL,NZL,2022.0,1,6,-5
HRV,IND,2021.0,1,1,0
VEN,ITA,2005.0,1,1,0
ECU,IND,2020.0,1,1,0
SRB,FRA,2000.0,1,3,-2
TUR,SRB,2003.0,1,1,0
AUS,CZE,2002.0,2,1,1
GUY,FRA,2009.0,1,1,0
PER,ITA,2017.0,1,2,-1
ISR,ETH,2015.0,1,1,0
ARE,JPN,2017.0,1,4,-3
RUS,KGZ,2016.0,3,4,-1
BHR,CAN,2007.0,1,1,0
ARE,JPN,2019.0,2,7,-5
URY,GBR,2010.0,1,1,0
USA,GLP,2016.0,1,2,-1
JPN,ZMB,2019.0,1,4,-3
BRA,VEN,2015.0,1,6,-5
GBR,PSE,2021.0,4,3,1
GRC,CHL,2021.0,1,3,-2
ROU,IND,2022.0,1,1,0
CHL,NLD,2003.0,1,1,0
PRT,ECU,2020.0,1,1,0
SWE,SGP,2022.0,3,5,-2
DEU,VEN,2020.0,1,6,-5
MKD,HRV,2016.0,1,2,-1
LTU,RUS,2016.0,2,1,1
KWT,IRQ,2020.0,1,1,0
YEM,MAR,2018.0,1,3,-2
ESP,SVK,2017.0,1,1,0
CHN,MEX,2005.0,1,1,0
CAN,PRI,2008.0,1,1,0
DEU,JAM,2019.0,2,3,-1
QAT,TUR,2022.0,1,2,-1
FRA,KAZ,2016.0,1,1,0
NOR,CHL,2013.0,1,2,-1
TUR,ISR,2018.0,2,4,-2
AFG,IRN,2014.0,1,1,0
KEN,MWI,2013.0,1,2,-1
FRA,CRI,2006.0,1,2,-1
SGP,POL,2002.0,1,1,0
AUT,LUX,2022.0,1,1,0
ISR,ROU,2019.0,2,1,1
GBR,GIB,2002.0,1,1,0
BFA,DEU,2014.0,1,3,-2
ROU,DZA,2020.0,1,1,0
FSM,USA,2003.0,1,1,0
BEL,PER,2018.0,1,4,-3
THA,BEL,2003.0,1,2,-1
UKR,AUT,2022.0,1,4,-3
LIE,CHE,2006.0,1,1,0
KHM,THA,2011.0,1,1,0
SEN,CMR,1999.0,1,1,0
NLD,HUN,1998.0,1,2,-1
FRO,DNK,2018.0,1,2,-1
USA,DEU,2017.0,1059,1193,-134
GRC,BEL,2018.0,23,8,15
GBR,AUS,2018.0,549,537,12
DEU,CHE,2007.0,470,308,162
GBR,DEU,2007.0,315,467,-152
NOR,SWE,2008.0,29,58,-29
GBR,ITA,2014.0,254,460,-206
LBN,USA,2018.0,75,42,33
IND,CHN,2010.0,15,5,10
ITA,DNK,2008.0,17,15,2
FRA,BFA,2009.0,9,4,5
AUS,CHN,2014.0,173,234,-61
IRN,CHE,2016.0,20,6,14
DNK,FRA,2016.0,48,34,14
PRT,NZL,2016.0,2,1,1
AUS,NCL,2014.0,2,2,0
USA,JOR,2017.0,63,35,28
TWN,IDN,2020.0,27,34,-7
USA,ITA,2003.0,470,431,39
CAN,SWE,2019.0,43,39,4
CAN,BRA,2020.0,68,174,-106
PNG,AUS,2016.0,9,6,3
ESP,HUN,2019.0,8,2,6
NLD,NOR,2018.0,34,20,14
CAN,BEL,2014.0,35,42,-7
USA,JOR,2019.0,60,40,20
ECU,COL,2018.0,5,8,-3
ITA,PRT,2021.0,32,30,2
BEL,CAN,2009.0,29,24,5
BGD,CHN,2013.0,9,4,5
ZAF,GBR,2019.0,89,83,6
HUN,JPN,2010.0,5,3,2
ARG,CHL,2013.0,17,5,12
MEX,CAN,2017.0,43,32,11
UKR,GBR,2010.0,16,10,6
DEU,NOR,2010.0,51,34,17
CHE,ISR,2011.0,14,11,3
FRA,JPN,2009.0,82,93,-11
DEU,THA,2009.0,13,8,5
ZAF,LSO,2018.0,6,2,4
DEU,CZE,2012.0,36,32,4
MEX,CAN,2010.0,40,15,25
DEU,GBR,2000.0,161,112,49
PAK,IND,2016.0,26,27,-1
COL,GBR,2017.0,16,16,0
DEU,POL,2011.0,173,78,95
USA,PRT,2006.0,46,34,12
HUN,DEU,2003.0,50,26,24
CAN,SWE,2017.0,40,26,14
SAU,QAT,2020.0,15,8,7
BGD,MYS,2015.0,37,22,15
JPN,PHL,2013.0,22,11,11
NLD,TUR,2016.0,26,23,3
JPN,SWE,2020.0,35,17,18
CAN,NLD,2020.0,61,56,5
HUN,ESP,2003.0,3,4,-1
IND,MEX,2012.0,8,2,6
CAN,FIN,2019.0,13,19,-6
ARG,USA,2003.0,139,96,43
ESP,CZE,2012.0,8,10,-2
BEL,FIN,2005.0,3,4,-1
POL,VNM,2006.0,1,1,0
ZAF,TZA,2009.0,1,1,0
ITA,SWE,2007.0,21,26,-5
FIN,CZE,2002.0,2,2,0
JPN,NPL,2005.0,6,3,3
CHL,ESP,1999.0,11,12,-1
USA,TUN,2002.0,6,5,1
ARG,COL,2008.0,9,5,4
UKR,BEL,2007.0,4,2,2
VNM,DEU,2007.0,2,5,-3
BEL,IDN,2016.0,5,2,3
FRA,UKR,2011.0,12,12,0
CHN,SLE,2021.0,3,2,1
KOR,THA,2015.0,9,7,2
NGA,MYS,2019.0,35,104,-69
SGP,TWN,2021.0,18,8,10
CHN,PRK,2021.0,4,3,1
BEL,JPN,2005.0,7,9,-2
BGR,PRT,2006.0,2,1,1
USA,PAN,2001.0,2,2,0
HUN,ITA,2022.0,4,3,1
DEU,BEN,2020.0,4,3,1
JPN,BEL,2016.0,13,11,2
BEL,BGR,2013.0,4,3,1
MEX,DEU,2013.0,30,33,-3
HUN,POL,2020.0,2,5,-3
NGA,DEU,2005.0,6,3,3
ITA,POL,2005.0,9,8,1
BRA,MLT,2017.0,1,1,0
NOR,PRT,2012.0,3,2,1
SWE,PRT,2018.0,4,19,-15
HKG,DNK,2012.0,3,1,2
ARE,ROU,2013.0,1,1,0
EST,UKR,2018.0,2,1,1
ARE,QAT,2020.0,6,7,-1
SRB,VNM,2020.0,2,2,0
UKR,GBR,2017.0,12,6,6
CAN,CZE,2016.0,8,12,-4
USA,BHS,2014.0,4,1,3
PER,MEX,2016.0,5,7,-2
VEN,AUS,2014.0,4,1,3
EST,VNM,2019.0,2,1,1
FIN,ISL,2019.0,3,1,2
ESP,HUN,2017.0,4,3,1
HKG,THA,2020.0,4,6,-2
RUS,ARM,2003.0,4,4,0
MAC,HKG,2015.0,7,17,-10
ISR,BEL,2019.0,5,8,-3
JPN,PAK,2020.0,7,5,2
NGA,MYS,2017.0,27,97,-70
ITA,HUN,2001.0,3,1,2
IRL,CZE,2006.0,1,1,0
EGY,NLD,2008.0,1,4,-3
IRL,PRT,2012.0,5,5,0
HUN,JPN,2019.0,9,2,7
ARG,MEX,2002.0,5,7,-2
MLI,FRA,2015.0,5,2,3
ALB,SRB,2016.0,4,5,-1
CHL,ISR,2021.0,4,2,2
CAN,SVN,2018.0,1,1,0
NGA,ITA,2003.0,3,4,-1
IRL,ROU,2003.0,1,1,0
CIV,CAN,2014.0,1,2,-1
ARE,GBR,1999.0,2,4,-2
AUT,UKR,2015.0,2,2,0
FRA,NGA,2002.0,3,1,2
ESP,HUN,2010.0,3,7,-4
BEL,SVK,2016.0,2,2,0
BHR,TUN,2022.0,1,1,0
AUT,ISR,2020.0,3,10,-7
MEX,DNK,2018.0,3,2,1
IRL,JPN,2020.0,7,8,-1
UZB,ITA,2007.0,1,2,-1
KWT,SVK,2003.0,2,1,1
BRA,FIN,2007.0,2,1,1
CZE,SWE,1998.0,2,2,0
ARE,FRA,2013.0,4,5,-1
FIN,LTU,2009.0,1,1,0
MYS,BRN,2011.0,3,2,1
PHL,DEU,2002.0,3,1,2
EGY,DNK,2019.0,1,6,-5
HUN,JPN,2017.0,3,4,-1
USA,PHL,2000.0,4,7,-3
KWT,CAN,2012.0,6,6,0
AUT,COL,2015.0,1,2,-1
MEX,PER,2007.0,1,2,-1
RUS,HUN,2014.0,3,1,2
FIN,TUR,2019.0,4,19,-15
DNK,NPL,2017.0,2,1,1
NLD,TZA,2013.0,1,1,0
CAN,VEN,2001.0,1,5,-4
JPN,SYR,2007.0,1,1,0
CHL,BOL,2018.0,1,2,-1
VNM,IND,2019.0,2,5,-3
IDN,SAU,2022.0,1,1,0
AUT,RUS,2004.0,2,5,-3
CZE,SWE,1997.0,1,1,0
ZAF,ARE,2008.0,1,1,0
SRB,AUT,2011.0,1,2,-1
PAK,CYP,2021.0,1,3,-2
AZE,TUR,2020.0,2,6,-4
AUS,ETH,2010.0,1,1,0
,GRC,2004.0,2870,0,2870
ITA,,2024.0,116649,0,116649
NLD,,2009.0,2585,0,2585
JPN,,2019.0,25571,0,25571
JPN,,2010.0,18791,0,18791
FRA,,2020.0,17541,0,17541
KOR,,2011.0,6465,0,6465
EGY,,2014.0,905,0,905
,KOR,1998.0,9549,0,9549
CAN,,2011.0,6127,0,6127
SRB,,2008.0,136,0,136
,FRA,1995.0,12735,0,12735
CIV,,2010.0,44,0,44
JPN,,2017.0,22684,0,22684
,GBR,1999.0,31232,0,31232
CHN,,2001.0,1718,0,1718
,CHN,2011.0,137369,0,137369
,GRC,1996.0,769,0,769
JOR,,2023.0,2224,0,2224
EST,,2023.0,1388,0,1388
,AUS,2014.0,9727,0,9727
PSE,,2024.0,648,0,648
HKG,,2012.0,797,0,797
,CUB,2003.0,586,0,586
,NOR,2007.0,1745,0,1745
,CAN,2007.0,11362,0,11362
TUR,,2011.0,2007,0,2007
,IND,2008.0,23386,0,23386
,IRL,1995.0,346,0,346
SVN,,2023.0,2703,0,2703
,UZB,2004.0,85,0,85
,PHL,1998.0,216,0,216
,ESP,2008.0,13435,0,13435
IRL,,2021.0,2095,0,2095
,SWE,2009.0,3650,0,3650
,UKR,2003.0,1101,0,1101
ROU,,2014.0,1070,0,1070
ISR,,2021.0,3526,0,3526
,ZWE,2003.0,54,0,54
CIV,,2017.0,151,0,151
PRT,,2000.0,29,0,29
TZA,,2018.0,155,0,155
SLV,,2015.0,12,0,12
DZA,,2009.0,71,0,71
,KOR,1997.0,2503,0,2503
,GEO,2015.0,155,0,155
IND,,2001.0,331,0,331
KEN,,2023.0,1865,0,1865
COL,,2008.0,142,0,142
GRD,,2018.0,13,0,13
,ROU,2013.0,1964,0,1964
,MEX,2010.0,5587,0,5587
,IRN,2016.0,11160,0,11160
MDA,BEL,2010.0,1,0,1
BGR,,2018.0,415,0,415
CIV,,2019.0,172,0,172
,JOR,2003.0,217,0,217
,EST,2014.0,366,0,366
,GTM,2010.0,31,0,31
,MAR,2014.0,1444,0,1444
MAC,,2020.0,126,0,126
,ETH,2007.0,213,0,213
COD,,2018.0,11,0,11
,HTI,2011.0,25,0,25
PRY,,2018.0,22,0,22
,BWA,2002.0,44,0,44
MNE,,2023.0,222,0,222
AUT,,2004.0,588,0,588
ITA,LUX,2022.0,6,0,6
BGD,NPL,2012.0,2,0,2
,MEX,2017.0,4678,0,4678
,TJK,2012.0,16,0,16
,MEX,2019.0,2111,0,2111
,PNG,2009.0,27,0,27
,TTO,2012.0,51,0,51
,PHL,1997.0,33,0,33
MYS,,2005.0,87,0,87
,BHR,2013.0,55,0,55
,GHA,2016.0,561,0,561
NPL,,2009.0,58,0,58
NZL,,2006.0,420,0,420
IRQ,JOR,2006.0,2,0,2
CUB,USA,2015.0,9,0,9
YEM,,2021.0,56,0,56
PNG,CAN,2016.0,1,0,1
ALB,PRT,2019.0,1,0,1
,LAO,2013.0,31,0,31
,NPL,2018.0,668,0,668
LBY,,2022.0,93,0,93
BIH,,2011.0,41,0,41
GRC,MLT,2020.0,2,0,2
,PAN,2015.0,50,0,50
LUX,MLI,2020.0,1,0,1
GEO,AUS,2020.0,1,0,1
,SRB,2018.0,768,0,768
,BWA,2005.0,53,0,53
NLD,ROU,2021.0,2,0,2
GRC,NZL,2018.0,1,0,1
IND,SVK,2021.0,2,0,2
BEL,UGA,2021.0,6,0,6
CHL,,2025.0,14,0,14
UGA,BFA,2002.0,1,0,1
,SYR,2018.0,144,0,144
RWA,EGY,2021.0,2,0,2
ZAF,,2007.0,402,0,402
,SVN,2014.0,610,0,610
,SGP,2014.0,2293,0,2293
USA,BRN,2010.0,1,0,1
MSR,,2018.0,1,0,1
,SOM,2016.0,5,0,5
,NCL,2006.0,9,0,9
MKD,,2013.0,48,0,48
PAK,,2007.0,217,0,217
,MUS,2006.0,22,0,22
NLD,ABW,2022.0,1,0,1
NZL,NGA,2012.0,1,0,1
,PSE,2006.0,40,0,40
ROU,CHL,2019.0,1,0,1
BLR,,2006.0,135,0,135
,BFA,2007.0,82,0,82
UZB,TUR,2004.0,1,0,1
,UZB,1996.0,96,0,96
IND,DNK,2003.0,4,0,4
,GIN,2007.0,12,0,12
JPN,PER,2022.0,1,0,1
ECU,KOR,2017.0,1,0,1
ITA,ARE,2014.0,2,0,2
,GAB,2013.0,43,0,43
SLE,KEN,2021.0,1,0,1
IRN,CYP,2018.0,1,0,1
NOR,ECU,2018.0,3,0,3
BEL,SAU,2012.0,3,0,3
MYS,MAR,2021.0,1,0,1
POL,HUN,2008.0,2,0,2
,GTM,2017.0,41,0,41
MTQ,,2022.0,23,0,23
CUB,CHL,2021.0,7,0,7
,KGZ,2009.0,22,0,22
,PYF,2017.0,7,0,7
,FRO,2014.0,8,0,8
SEN,COG,2015.0,1,0,1
TTO,,2013.0,30,0,30
TUR,PRT,2012.0,2,0,2
,MDA,1999.0,61,0,61
,GTM,2019.0,22,0,22
ESP,AND,2022.0,3,0,3
,DZA,1994.0,90,0,90
SWE,,2001.0,104,0,104
IRN,CHN,2005.0,1,0,1
DJI,,2020.0,6,0,6
,VNM,1998.0,102,0,102
BRN,,2009.0,3,0,3
JPN,KEN,2013.0,9,0,9
,CAF,2003.0,9,0,9
NLD,LKA,2014.0,3,0,3
IND,PRT,2003.0,6,0,6
JPN,ZMB,2010.0,5,0,5
VEN,DEU,2019.0,7,0,7
UZB,,2003.0,51,0,51
ESP,SVN,2005.0,1,0,1
ITA,NZL,1999.0,1,0,1
VEN,TWN,2011.0,1,0,1
MUS,ZAF,2013.0,2,0,2
UGA,,2006.0,16,0,16
ARE,SYR,2003.0,1,0,1
NGA,LTU,2003.0,1,0,1
PRY,URY,2016.0,1,0,1
RUS,THA,2006.0,3,0,3
,VNM,1997.0,28,0,28
,YEM,1998.0,15,0,15
,FJI,2003.0,22,0,22
ARG,POL,2012.0,2,0,2
ZAF,ECU,2002.0,1,0,1
PHL,PRT,2009.0,1,0,1
SWE,ARE,2003.0,5,0,5
EGY,AUS,2003.0,1,0,1
THA,ISL,2010.0,1,0,1
,NAM,1996.0,6,0,6
GBR,QAT,2002.0,1,0,1
ITA,MKD,2009.0,1,0,1
MKD,DEU,2009.0,1,0,1
FRA,SVK,1998.0,2,0,2
CAF,CHN,2015.0,1,0,1
GAB,,2004.0,2,0,2
COG,FRA,2002.0,1,0,1
PAN,ISR,2016.0,2,0,2
KHM,SWE,2013.0,1,0,1
PNG,GRD,2019.0,1,0,1
CMR,MLI,2016.0,1,0,1
SVK,QAT,2015.0,2,0,2
,TGO,2008.0,29,0,29
MKD,IRL,2017.0,1,0,1
MWI,DEU,2016.0,1,0,1
ROU,SRB,2013.0,2,0,2
ITA,VNM,2016.0,6,0,6
JOR,DZA,2014.0,1,0,1
CHE,MNE,2018.0,1,0,1
GMB,SEN,2014.0,1,0,1
GUY,KOR,2019.0,3,0,3
ESP,PHL,2018.0,1,0,1
ESP,ALB,2019.0,1,0,1
GBR,QAT,2005.0,1,0,1
,GUY,2007.0,2,0,2
BFA,ITA,2018.0,1,0,1
CUB,GNQ,2020.0,1,0,1
MWI,,1999.0,3,0,3
BFA,,2008.0,14,0,14
GUY,GUF,2005.0,2,0,2
IND,GHA,2010.0,3,0,3
TTO,RUS,2009.0,1,0,1
NLD,CHL,2004.0,1,0,1
CAN,MWI,2008.0,1,0,1
GBR,NIC,2022.0,2,0,2
GUY,,2020.0,10,0,10
CHN,CAF,2020.0,1,0,1
,PYF,2010.0,12,0,12
,YEM,1997.0,5,0,5
MYS,,2002.0,15,0,15
GAB,CAF,2011.0,1,0,1
,GRL,2003.0,5,0,5
NLD,CMR,2021.0,1,0,1
BEL,KGZ,2004.0,1,0,1
IRL,SRB,2010.0,3,0,3
ARE,IDN,2020.0,1,0,1
TUN,OMN,2019.0,3,0,3
SAU,UGA,2020.0,1,0,1
MAC,SAU,2019.0,1,0,1
PRT,MAR,2018.0,2,0,2
ALB,KWT,2018.0,1,0,1
USA,TGO,2018.0,1,0,1
,NAM,2004.0,13,0,13
HKG,COL,2009.0,1,0,1
PER,BOL,2017.0,1,0,1
CHL,ZAF,2007.0,3,0,3
CYP,BEL,2013.0,2,0,2
MLI,SEN,2020.0,3,0,3
VNM,MEX,2021.0,2,0,2
VNM,SRB,2021.0,4,0,4
ARE,BRA,2015.0,1,0,1
KEN,UGA,2001.0,2,0,2
EGY,HUN,2005.0,1,0,1
LBY,ARE,2002.0,2,0,2
QAT,,2004.0,11,0,11
JOR,SDN,2004.0,1,0,1
FLK,,2017.0,2,0,2
GBR,SYC,2004.0,2,0,2
DEU,GMB,2006.0,1,0,1
UKR,HKG,2019.0,2,0,2
DZA,ESP,2002.0,1,0,1
IRL,KEN,2005.0,1,0,1
JAM,MEX,2005.0,1,0,1
AUS,ISL,2013.0,2,0,2
LTU,CAN,2004.0,1,0,1
USA,KNA,2001.0,1,0,1
GMB,NGA,2009.0,1,0,1
TGO,,2008.0,3,0,3
NOR,NGA,2017.0,2,0,2
IND,KAZ,2000.0,3,0,3
GIN,,2014.0,3,0,3
CHE,VUT,2015.0,1,0,1
MLI,,2011.0,18,0,18
ISR,ISL,2013.0,1,0,1
,MTQ,2005.0,2,0,2
NZL,IRN,2005.0,1,0,1
RUS,CMR,2005.0,1,0,1
GRC,CZE,2013.0,5,0,5
HUN,NOR,2017.0,5,0,5
PAK,ARE,2009.0,1,0,1
TUR,IRN,2007.0,4,0,4
GHA,SRB,2016.0,1,0,1
POL,JOR,2014.0,2,0,2
IRL,KWT,2009.0,1,0,1
OMN,PHL,2018.0,1,0,1
LBR,PAK,2015.0,2,0,2
DOM,MEX,2009.0,3,0,3
BWA,CAN,2009.0,2,0,2
BMU,,2021.0,4,0,4
FJI,LKA,2016.0,1,0,1
ESP,KOR,1998.0,1,0,1
KGZ,GBR,2012.0,1,0,1
NLD,ECU,2020.0,6,0,6
AGO,SWE,2018.0,1,0,1
ISR,HRV,2009.0,1,0,1
SWE,IDN,2007.0,2,0,2
VUT,CHE,2017.0,1,0,1
JOR,HKG,2006.0,1,0,1
USA,BRN,2017.0,1,0,1
BGR,FIN,2012.0,1,0,1
JPN,GUM,2005.0,1,0,1
LBN,LBY,2015.0,1,0,1
NGA,PER,2014.0,1,0,1
LUX,PRT,2008.0,2,0,2
PAN,,2015.0,23,0,23
SVN,ETH,2013.0,1,0,1
CHN,MUS,2014.0,1,0,1
CMR,NOR,2013.0,1,0,1
,FSM,2010.0,3,0,3
PHL,COL,2018.0,1,0,1
TZA,MWI,2017.0,2,0,2
BIH,NOR,2018.0,1,0,1
,VGB,2016.0,1,0,1
TZA,CAN,2019.0,1,0,1
LUX,JPN,2013.0,1,0,1
EST,MDA,2018.0,2,0,2
BRA,SDN,2019.0,2,0,2
,MTQ,2002.0,8,0,8
PRT,MEX,2001.0,2,0,2
DEU,MWI,2022.0,1,0,1
ZMB,ZAF,2010.0,1,0,1
,BDI,1994.0,2,0,2
BLR,BRA,2001.0,2,0,2
POL,CHN,2006.0,2,0,2
QAT,KWT,2006.0,2,0,2
IRN,JOR,2019.0,1,0,1
IRL,LVA,2007.0,1,0,1
HUN,VNM,2003.0,1,0,1
FRA,LBY,2018.0,3,0,3
SGP,HRV,2001.0,1,0,1
CMR,BRA,2014.0,1,0,1
SVN,BEL,2006.0,2,0,2
ISR,NOR,2006.0,2,0,2
GUY,GUF,2002.0,1,0,1
AZE,JPN,2019.0,1,0,1
HKG,HUN,2009.0,1,0,1
NZL,KAZ,2018.0,1,0,1
PNG,GBR,2006.0,1,0,1
FIN,TWN,2006.0,1,0,1
SWE,NZL,1999.0,2,0,2
GBR,AZE,1998.0,1,0,1
MMR,,2008.0,5,0,5
MYS,PSE,2009.0,1,0,1
MOZ,TTO,2017.0,1,0,1
BRA,IRL,2007.0,3,0,3
SRB,CZE,2011.0,2,0,2
JOR,YEM,2017.0,2,0,2
KOR,AZE,2014.0,1,0,1
SDN,LBY,2015.0,2,0,2
AZE,EGY,2014.0,1,0,1
POL,MKD,2014.0,1,0,1
EGY,TWN,2013.0,2,0,2
JPN,OMN,2013.0,3,0,3
,ABW,2014.0,1,0,1
EGY,BGD,2013.0,2,0,2
JOR,PRT,2021.0,1,0,1
NPL,AUS,2007.0,3,0,3
IND,PHL,2000.0,1,0,1
CHN,IRQ,2003.0,1,0,1
EST,VNM,2017.0,1,0,1
IND,GHA,2017.0,2,0,2
TUR,TCD,2008.0,1,0,1
SVN,ISR,2021.0,1,0,1
VEN,NLD,2020.0,1,0,1
HUN,NOR,2010.0,2,0,2
IND,POL,2004.0,1,0,1
IRL,CHE,1999.0,1,0,1
ITA,DZA,2014.0,5,0,5
CZE,NOR,2006.0,1,0,1
GRC,ZWE,2015.0,2,0,2
LUX,BGR,2003.0,1,0,1
SWE,LTU,1999.0,1,0,1
UKR,MEX,2001.0,5,0,5
MNE,AUT,2020.0,1,0,1
CHL,SGP,2013.0,1,0,1
MLI,NZL,2015.0,1,0,1
OMN,CZE,2016.0,1,0,1
BRN,BFA,2020.0,1,0,1
SVK,SLV,2007.0,1,0,1
NLD,PAN,2010.0,1,0,1
IND,JOR,2016.0,2,0,2
PRI,ARE,2013.0,1,0,1
QAT,SVK,2019.0,1,0,1
TZA,HND,2016.0,1,0,1
IRQ,CAN,2012.0,1,0,1
MWI,THA,2016.0,1,0,1
HUN,NZL,2007.0,2,0,2
GRC,MAR,2001.0,1,0,1
PHL,NZL,2008.0,1,0,1
YEM,TUR,2014.0,1,0,1
COL,KHM,2013.0,1,0,1
CHE,LSO,2017.0,1,0,1
ZMB,FRA,2020.0,1,0,1
IRL,IDN,2016.0,3,0,3
ZWE,TWN,2022.0,1,0,1
ETH,GHA,2022.0,1,0,1
BTN,GBR,2001.0,1,0,1
IRL,TUN,2016.0,1,0,1
COL,PAN,2009.0,1,0,1
SGP,TTO,2006.0,1,0,1
BTN,FRA,2018.0,1,0,1
ZAF,SAU,2004.0,1,0,1
DEU,LBY,2012.0,4,0,4
BRA,MLT,2019.0,2,0,2
CHN,SVK,2019.0,1,0,1
SVK,NOR,2013.0,1,0,1
MEX,NZL,2015.0,2,0,2
ASM,USA,2014.0,1,0,1
IDN,COL,2017.0,1,0,1
ISR,MKD,2012.0,1,0,1
DNK,ISL,2000.0,2,0,2
PSE,ARE,2005.0,1,0,1
COL,UGA,2006.0,2,0,2
SGP,BRA,2008.0,1,0,1
LBY,PSE,2020.0,1,0,1
DZA,CHL,2009.0,1,0,1
IRN,LTU,2014.0,1,0,1
IRQ,YEM,2017.0,1,0,1
NOR,MWI,2018.0,2,0,2
SDN,TUR,2022.0,2,0,2
MLI,NGA,2019.0,1,0,1
VEN,PAN,2018.0,2,0,2
RUS,LTU,2011.0,2,0,2
CRI,NIC,2003.0,1,0,1
DNK,EGY,2021.0,2,0,2
MKD,ITA,2019.0,2,0,2
FRA,ARE,1999.0,1,0,1
GHA,UGA,2008.0,1,0,1
NLD,SVN,2022.0,2,0,2
CUB,HND,2009.0,1,0,1
USA,MNE,2010.0,1,0,1
SRB,ALB,2012.0,4,0,4
MWI,JPN,2021.0,1,0,1
CAF,,2007.0,2,0,2
CAF,BFA,2012.0,1,0,1
TTO,AUT,2019.0,1,0,1
RUS,KHM,2015.0,1,0,1
HRV,NOR,2011.0,1,0,1
MKD,ITA,2010.0,1,0,1
USA,GHA,1997.0,1,0,1
ITA,ECU,2006.0,1,0,1
DEU,LIE,2007.0,4,0,4
JPN,MUS,2008.0,1,0,1
NOR,SGP,1997.0,1,0,1
KWT,HUN,2002.0,1,0,1
IRL,CHL,2013.0,2,0,2
GBR,DZA,2014.0,5,0,5
SVK,FIN,2005.0,1,0,1
BTN,AUS,2005.0,1,0,1
PSE,DEU,2001.0,1,0,1
IRN,CHN,2002.0,1,0,1
JPN,ETH,2009.0,1,0,1
FRA,JOR,2016.0,3,0,3
RUS,CYP,2009.0,1,0,1
KAZ,IRL,2020.0,2,0,2
ABW,,2021.0,1,0,1
SWZ,CHE,2014.0,1,0,1
KWT,ESP,2022.0,1,0,1
KOR,SRB,2019.0,2,0,2
GBR,EST,2000.0,2,0,2
EGY,RUS,2002.0,2,0,2
CHN,ROU,2011.0,1,0,1
GEO,IND,2013.0,1,0,1
SWE,GRL,2022.0,1,0,1
BRA,IDN,2009.0,2,0,2
FIN,MYS,2003.0,1,0,1
BTN,NLD,2018.0,1,0,1
UZB,ISR,2017.0,1,0,1
NLD,BRA,1997.0,1,0,1
SVN,SVK,2000.0,1,0,1
MWI,BFA,2001.0,1,0,1
FRA,CIV,2000.0,3,0,3
ITA,TUN,2001.0,1,0,1
LKA,CAN,2000.0,1,0,1
,FLK,2008.0,4,0,4
SVN,KOR,2001.0,1,0,1
CAN,TZA,2012.0,1,0,1
BLR,CHE,2013.0,1,0,1
GRC,JOR,2017.0,1,0,1
YEM,MNE,2013.0,1,0,1
TUR,KAZ,2004.0,1,0,1
SOM,CHN,2022.0,1,0,1
ZWE,KOR,2020.0,1,0,1
UGA,ITA,2022.0,1,0,1
GUF,,2008.0,3,0,3
COD,NGA,2021.0,1,0,1
LUX,DZA,2012.0,1,0,1
BHR,OMN,2002.0,1,0,1
BIH,AUT,2018.0,1,0,1
FIN,GHA,2017.0,1,0,1
IRN,JOR,2017.0,1,0,1
RUS,BGD,2001.0,1,0,1
GRC,CHN,2007.0,1,0,1
IND,SAU,1999.0,1,0,1
GBR,LBR,2018.0,2,0,2
CHN,TGO,2014.0,1,0,1
SGP,SVK,2021.0,1,0,1
MNG,BEL,2021.0,1,0,1
IRQ,NLD,2016.0,2,0,2
TGO,CHE,2017.0,1,0,1
IRL,IRQ,2021.0,1,0,1
GHA,PRT,2019.0,2,0,2
,PYF,2019.0,3,0,3
CMR,IDN,2012.0,1,0,1
FJI,THA,2005.0,1,0,1
IRL,MLT,2009.0,1,0,1
MLI,ZAF,2013.0,1,0,1
AFG,NLD,2021.0,1,0,1
JOR,GRC,2016.0,1,0,1
CMR,ESP,2016.0,1,0,1
BEL,BOL,2015.0,1,0,1
,MRT,2005.0,2,0,2
CHE,ETH,2015.0,3,0,3
POL,IRL,1999.0,2,0,2
,MCO,2012.0,4,0,4
MEX,KEN,2006.0,1,0,1
NPL,SAU,2018.0,2,0,2
ITA,UGA,2002.0,1,0,1
OMN,DEU,1997.0,1,0,1
AUT,OMN,2017.0,1,0,1
CAN,MYS,1997.0,1,0,1
DEU,JOR,2000.0,2,0,2
FIN,BEL,2000.0,1,0,1
SWE,ECU,2000.0,1,0,1
USA,PSE,2009.0,1,0,1
GMB,TZA,2009.0,1,0,1
NGA,THA,2008.0,2,0,2
GBR,GEO,2006.0,2,0,2
ARG,HRV,2005.0,1,0,1
NLD,PRI,2010.0,1,0,1
GEO,PRT,2008.0,2,0,2
MUS,IND,2020.0,1,0,1
SGP,ZAF,2006.0,3,0,3
CZE,TWN,2012.0,2,0,2
FJI,NZL,2014.0,2,0,2
CHN,HRV,2011.0,1,0,1
BDI,SEN,2018.0,1,0,1
TWN,FIN,2009.0,1,0,1
BFA,CHE,2008.0,1,0,1
SSD,BGD,2013.0,1,0,1
KHM,PHL,2022.0,1,0,1
CPV,PER,2022.0,1,0,1
LBY,BEL,2000.0,1,0,1
TWN,SRB,2011.0,1,0,1
CHN,COG,2010.0,2,0,2
USA,NER,2018.0,1,0,1
UGA,AUS,2002.0,1,0,1
GBR,BOL,2009.0,1,0,1
HUN,SVN,2008.0,1,0,1
DNK,MLT,2013.0,1,0,1
BGR,DNK,2008.0,1,0,1
NZL,LAO,2014.0,1,0,1
POL,KOR,2022.0,1,0,1
AUS,PRY,2019.0,1,0,1
NLD,RWA,2020.0,3,0,3
FIN,THA,2007.0,2,0,2
SRB,MDA,2014.0,1,0,1
URY,ISR,2016.0,1,0,1
TUR,MKD,2001.0,2,0,2
USA,FJI,1999.0,1,0,1
LBY,FIN,2017.0,1,0,1
PER,ITA,2010.0,1,0,1
DEU,MDG,2004.0,1,0,1
THA,TZA,2011.0,1,0,1
NLD,PSE,2015.0,1,0,1
GBR,UGA,1997.0,1,0,1
ARG,PRY,2008.0,1,0,1
PAK,UZB,2013.0,1,0,1
GBR,GIB,2005.0,1,0,1
QAT,ZAF,2017.0,2,0,2
HUN,IRN,2014.0,1,0,1
ESP,GRL,2020.0,1,0,1
ISR,CYP,2015.0,1,0,1
MEX,SAU,2012.0,1,0,1
CAN,MKD,2015.0,1,0,1
AUT,JOR,2018.0,1,0,1
YEM,JOR,2021.0,1,0,1
CHE,DZA,2015.0,2,0,2
BEL,PRY,2017.0,2,0,2
JOR,SGP,2017.0,1,0,1
BHR,KWT,2004.0,1,0,1
TUN,OMN,2010.0,1,0,1
ARE,ETH,2015.0,1,0,1
CAN,GRD,2021.0,1,0,1
NGA,BGD,2021.0,1,0,1
MWI,CAN,2022.0,1,0,1
RUS,EGY,2003.0,1,0,1
AUT,IRQ,2010.0,1,0,1
DEU,NPL,2002.0,1,0,1
ESP,LVA,2015.0,2,0,2
COG,KEN,2013.0,1,0,1
,MHL,2007.0,1,0,1
SAU,CHL,2017.0,1,0,1
OMN,SWE,2018.0,1,0,1
BLR,KEN,2009.0,1,0,1
HKG,KAZ,2021.0,1,0,1
ROU,ZAF,2016.0,1,0,1
ROU,HKG,2006.0,1,0,1
GRC,JOR,2019.0,1,0,1
IND,AZE,2018.0,1,0,1
TUR,SGP,2004.0,1,0,1
LKA,GHA,2014.0,1,0,1
,MRT,2002.0,1,0,1
FRA,PAN,2001.0,1,0,1
SAU,TUR,2006.0,1,0,1
AUS,KWT,2005.0,2,0,2
NGA,IND,2003.0,1,0,1
ITA,UGA,2005.0,1,0,1
HUN,KAZ,2014.0,1,0,1
CUB,QAT,2006.0,1,0,1
SVK,HRV,2016.0,1,0,1
COD,USA,2009.0,1,0,1
TWN,NPL,2015.0,1,0,1
CAN,MAC,2016.0,1,0,1
SVK,CHL,2003.0,1,0,1
AFG,SYR,2017.0,1,0,1
FIN,SYC,2002.0,1,0,1
SYR,PRI,2004.0,2,0,2
LKA,SWE,2002.0,1,0,1
CHE,ECU,2009.0,1,0,1
LTU,AUT,2016.0,1,0,1
USA,SDN,2000.0,1,0,1
GNB,,2008.0,2,0,2
PRI,ECU,2016.0,1,0,1
BOL,SWE,2005.0,1,0,1
YEM,ITA,2022.0,1,0,1
AUT,ALB,2008.0,1,0,1
FLK,,2019.0,1,0,1
KNA,JPN,2021.0,1,0,1
CAF,SEN,2014.0,1,0,1
BRA,ROU,2005.0,1,0,1
RWA,ESP,2018.0,1,0,1
IND,COG,2020.0,2,0,2
,TKM,2016.0,1,0,1
BEL,DZA,2022.0,1,0,1
SVK,KOR,2011.0,1,0,1
,ERI,1995.0,1,0,1
CAN,UGA,2009.0,1,0,1
DNK,VNM,2006.0,1,0,1
NLD,GUF,2014.0,1,0,1
JPN,SEN,2016.0,1,0,1
IRN,UZB,2019.0,1,0,1
HRV,LTU,2020.0,1,0,1
BIH,BHR,2017.0,1,0,1
ISR,BGR,2012.0,1,0,1
MEX,GTM,2006.0,1,0,1
DEU,BDI,2004.0,1,0,1
IND,EGY,1999.0,1,0,1
TUN,PAK,2010.0,1,0,1
NLD,SYR,2002.0,1,0,1
VNM,THA,2007.0,1,0,1
COG,,2005.0,2,0,2
NGA,AUT,2002.0,1,0,1
SRB,MLT,2001.0,1,0,1
NZL,SLB,2009.0,1,0,1
CAN,PAK,1999.0,1,0,1
BFA,KEN,2002.0,1,0,1
HUN,RUS,2000.0,1,0,1
MYS,JOR,2002.0,1,0,1
CZE,ARM,2003.0,1,0,1
ZWE,NOR,2017.0,1,0,1
COL,KEN,2006.0,1,0,1
BLR,ISR,2016.0,1,0,1
,WSM,2008.0,1,0,1
NLD,SLE,2022.0,1,0,1
GRC,KOR,2016.0,1,0,1
NZL,KEN,2006.0,1,0,1
GNQ,CHE,2019.0,1,0,1
HKG,ETH,2020.0,1,0,1
IRQ,QAT,2021.0,2,0,2
DNK,ARE,2015.0,1,0,1
DOM,GBR,2015.0,1,0,1
NLD,PRI,2019.0,1,0,1
SAU,EST,2018.0,1,0,1
ESP,KOR,1997.0,1,0,1
PRT,HKG,2011.0,1,0,1
RWA,SWZ,2013.0,1,0,1
CHN,MYS,2001.0,1,0,1
GUM,GLP,2008.0,1,0,1
BDI,USA,2007.0,1,0,1
IDN,SDN,2012.0,1,0,1
FLK,,2010.0,1,0,1
JPN,MEX,1999.0,2,0,2
GNB,SWE,2008.0,1,0,1
MMR,LKA,2012.0,1,0,1
ISR,ROU,2010.0,1,0,1
HUN,EGY,2001.0,2,0,2
CHE,LIE,2000.0,1,0,1
MYS,MDA,2011.0,1,0,1
SWE,SDN,2011.0,1,0,1
JPN,BTN,2018.0,1,0,1
KHM,SLE,2017.0,1,0,1
KOR,PAK,2023.0,1,0,1
JPN,CYP,2016.0,1,0,1
LIE,RUS,2013.0,1,0,1
URY,FIN,2021.0,1,0,1
LVA,BLR,2013.0,1,0,1
SDN,BRA,2016.0,1,0,1
TZA,MWI,2019.0,1,0,1
IRQ,CYP,2021.0,1,0,1
LBR,CHN,2019.0,1,0,1
AUS,PRY,2017.0,1,0,1
COL,GTM,2022.0,1,0,1
DEU,AUS,2012.0,147,136,11
USA,VEN,2008.0,20,31,-11
JPN,PHL,2008.0,19,11,8
BEL,ITA,2014.0,57,108,-51
FRA,CAN,2012.0,320,243,77
GBR,AUS,2017.0,562,518,44
FRA,ESP,2019.0,238,244,-6
CAN,ROU,2018.0,2,5,-3
ARG,ESP,2012.0,54,68,-14
CHN,DEU,2007.0,126,128,-2
GBR,AUT,2016.0,74,69,5
PRT,USA,2009.0,41,50,-9
JPN,KEN,2008.0,1,7,-6
ITA,ISR,2008.0,8,7,1
GBR,AUS,2010.0,535,381,154
USA,ZAF,2010.0,65,73,-8
USA,NZL,2019.0,125,114,11
AUT,DEU,2008.0,179,228,-49
FRA,NLD,2010.0,100,82,18
GBR,CHN,2017.0,426,345,81
ARG,FRA,2011.0,26,18,8
RUS,CZE,2006.0,11,13,-2
BEL,GRC,2014.0,7,18,-11
CHN,NLD,2006.0,20,28,-8
CHE,AUT,2011.0,60,49,11
JPN,TUN,2010.0,2,3,-1
CHE,FRA,2009.0,190,244,-54
DEU,FRA,2020.0,329,377,-48
USA,CYP,2010.0,23,2,21
USA,ITA,2001.0,304,355,-51
USA,JOR,2018.0,47,39,8
FRA,ITA,2020.0,250,301,-51
RUS,DNK,2006.0,7,5,2
USA,DEU,2018.0,1064,1132,-68
DEU,BRA,2015.0,81,84,-3
FRA,ESP,2010.0,235,158,77
GBR,CHE,2016.0,281,247,34
USA,NZL,2010.0,131,96,35
GBR,CHN,2010.0,194,175,19
CAN,SRB,2019.0,3,5,-2
COL,USA,2006.0,28,40,-12
USA,GRC,2006.0,105,73,32
POL,GBR,2014.0,135,45,90
GBR,POL,2015.0,39,91,-52
DZA,FRA,2009.0,46,59,-13
CHN,USA,2003.0,832,585,247
IRL,USA,2013.0,128,111,17
DEU,NOR,2018.0,80,38,42
GBR,TUR,2009.0,30,22,8
ESP,DEU,2007.0,86,120,-34
USA,ZAF,2017.0,86,106,-20
GBR,SAU,2006.0,19,13,6
CHN,CAN,2013.0,223,216,7
CHE,GBR,2010.0,172,199,-27
AUS,DEU,2008.0,91,133,-42
ITA,CAN,2019.0,92,40,52
ROU,NLD,2013.0,5,5,0
MEX,GBR,2017.0,39,62,-23
USA,LBN,2007.0,25,34,-9
CHE,DEU,1999.0,126,155,-29
USA,NZL,2017.0,102,130,-28
CHE,GBR,2019.0,260,298,-38
IRL,SGP,2017.0,8,2,6
SAU,ARE,2019.0,35,9,26
ZAF,CHN,2008.0,7,2,5
CHE,NLD,2009.0,54,54,0
ZAF,GBR,2018.0,93,70,23
IDN,JPN,2006.0,8,39,-31
DEU,BGR,2005.0,12,24,-12
FRA,ESP,2017.0,216,290,-74
CAN,JPN,2006.0,60,91,-31
USA,CHN,1998.0,101,159,-58
DNK,CHN,2010.0,17,29,-12
SWE,ITA,2015.0,31,78,-47
ISL,NOR,2019.0,2,4,-2
SGP,SWE,2014.0,9,8,1
BGR,JPN,2003.0,5,3,2
DNK,CHN,2017.0,49,59,-10
SGP,GBR,2006.0,50,55,-5
CHN,KOR,2012.0,60,143,-83
HKG,CHN,2021.0,746,643,103
POL,FRA,2013.0,36,87,-51
GBR,PRT,2011.0,78,46,32
BRA,CAN,2020.0,174,68,106
UKR,USA,2022.0,9,4,5
ISR,DEU,2000.0,11,24,-13
IRN,SGP,2015.0,13,4,9
NZL,ISR,2018.0,4,3,1
ESP,AUS,2007.0,14,10,4
IND,KOR,2016.0,193,118,75
USA,CYP,2017.0,9,13,-4
NGA,MYS,2018.0,32,86,-54
NLD,BEL,2020.0,154,171,-17
GBR,CHN,2019.0,511,422,89
POL,AUT,2002.0,5,7,-2
POL,SWE,2019.0,27,19,8
ISR,USA,2018.0,400,303,97
FIN,USA,2015.0,71,65,6
FIN,NLD,2021.0,21,13,8
USA,ISR,2000.0,85,80,5
ITA,CAN,2017.0,66,46,20
FRA,NLD,2017.0,103,94,9
GBR,AUS,2019.0,584,565,19
IND,ITA,2020.0,52,25,27
NZL,CHN,2020.0,47,44,3
NLD,DEU,2001.0,101,137,-36
USA,THA,2004.0,147,51,96
ESP,ECU,2011.0,7,3,4
AUS,FRA,2022.0,29,33,-4
IND,ISR,2015.0,72,24,48
BEL,USA,2016.0,202,123,79
MEX,GBR,2019.0,59,44,15
AUS,CHN,2004.0,46,54,-8
KOR,JPN,2021.0,79,75,4
DNK,CHN,2019.0,57,66,-9
MEX,CAN,2018.0,37,31,6
IND,SWE,2020.0,68,35,33
MEX,CZE,2013.0,3,3,0
NZL,CHL,2012.0,3,3,0
VNM,JPN,2013.0,10,31,-21
CMR,CHE,2021.0,1,2,-1
CHN,VNM,2015.0,10,6,4
AUS,ETH,2018.0,4,15,-11
NLD,SGP,2019.0,19,19,0
PRI,USA,2020.0,90,63,27
CAN,BEL,2004.0,13,22,-9
VEN,DEU,2018.0,6,2,4
USA,SGP,2020.0,187,166,21
AUS,ITA,2019.0,30,44,-14
ESP,TWN,2019.0,6,4,2
MWI,ZAF,2015.0,3,5,-2
RUS,FRA,2021.0,42,22,20
DNK,CHE,2019.0,39,40,-1
IND,POL,2014.0,9,36,-27
USA,NOR,2003.0,67,65,2
NGA,USA,2013.0,27,40,-13
BRA,NZL,2020.0,9,3,6
SAU,ARE,2010.0,6,6,0
ESP,NLD,2021.0,69,50,19
USA,EGY,2008.0,98,45,53
RUS,DEU,2002.0,207,106,101
NLD,NOR,2019.0,34,15,19
JOR,DEU,2016.0,11,14,-3
CMR,CHN,2021.0,4,5,-1
JPN,COL,2012.0,4,2,2
USA,GUM,2018.0,5,5,0
COL,GBR,2018.0,16,11,5
FRA,DNK,2015.0,35,35,0
GRC,DNK,2012.0,9,1,8
AUS,BGD,2020.0,58,62,-4
ESP,TUR,2017.0,9,6,3
KAZ,USA,2018.0,11,11,0
EGY,MYS,2019.0,5,10,-5
ZAF,MWI,2021.0,10,3,7
TUR,ISR,2019.0,3,2,1
USA,ARE,2022.0,31,36,-5
CHE,GBR,2017.0,217,276,-59
SWE,PRT,2019.0,15,21,-6
GRD,USA,2018.0,10,8,2
USA,RUS,2022.0,42,58,-16
GBR,ITA,2004.0,142,196,-54
USA,ZAF,2019.0,70,119,-49
PHL,JPN,2013.0,11,22,-11
MEX,POL,2015.0,1,4,-3
KOR,KAZ,2020.0,8,4,4
ITA,VNM,2022.0,2,2,0
USA,MEX,2000.0,36,61,-25
IND,USA,1999.0,151,72,79
USA,CHN,1997.0,146,64,82
SAU,AUS,2011.0,6,18,-12
AUT,PAK,2017.0,9,1,8
JPN,ESP,2007.0,14,8,6
FRA,DEU,2005.0,229,221,8
CAN,DNK,2018.0,26,31,-5
GBR,MWI,2015.0,10,14,-4
KAZ,MYS,2013.0,1,1,0
IRL,ITA,2021.0,20,34,-14
PRT,GBR,2008.0,40,44,-4
CAN,SRB,2017.0,3,6,-3
FRA,DEU,2002.0,260,256,4
DEU,AUT,1998.0,51,55,-4
RUS,USA,2012.0,140,118,22
ZAF,AUS,2011.0,34,21,13
GBR,SYR,2013.0,9,1,8
RUS,ITA,2005.0,19,24,-5
BIH,CHE,2012.0,1,3,-2
HKG,SWE,2021.0,6,3,3
BRA,CUB,2009.0,4,8,-4
MWI,GBR,2014.0,17,6,11
USA,NGA,2013.0,40,27,13
CAN,MAR,2013.0,7,2,5
GRC,BEL,2010.0,12,12,0
IDN,SAU,2016.0,3,2,1
IRN,JPN,2020.0,14,15,-1
KOR,TUR,2014.0,7,3,4
CHL,MEX,2013.0,11,19,-8
ZAF,LSO,2010.0,2,5,-3
NLD,CHE,2012.0,87,42,45
BLR,USA,2015.0,3,2,1
CHN,ITA,2009.0,17,13,4
ITA,CAN,2010.0,53,42,11
GBR,BEL,2012.0,82,83,-1
CHN,RUS,2009.0,15,10,5
AUS,GBR,1999.0,102,139,-37
CUB,MEX,2009.0,11,10,1
MYS,OMN,2013.0,6,1,5
GRC,ARE,2019.0,5,1,4
POL,NOR,2010.0,8,6,2
AUS,ITA,2010.0,24,30,-6
TWN,FRA,2010.0,5,10,-5
TWN,FRA,2017.0,11,15,-4
ARG,BRA,2012.0,19,12,7
CAN,CHN,2003.0,54,87,-33
PYF,FRA,2002.0,7,5,2
DEU,AUT,1997.0,27,27,0
ISR,AUS,2016.0,16,12,4
DNK,JPN,2005.0,11,3,8
CHE,NOR,2007.0,13,4,9
GBR,PAK,2006.0,23,16,7
FRA,KHM,2019.0,7,4,3
SVN,SRB,2016.0,3,4,-1
FIN,GBR,2022.0,29,29,0
TUR,MEX,2017.0,4,2,2
JOR,USA,2014.0,29,47,-18
JPN,AUT,2021.0,8,11,-3
DNK,GBR,2013.0,58,66,-8
ZAF,COG,2019.0,4,1,3
USA,POL,2000.0,28,56,-28
CAN,DEU,1998.0,19,25,-6
THA,ITA,2017.0,4,5,-1
USA,PAN,2003.0,5,9,-4
DEU,BGR,2002.0,27,12,15
CZE,IND,2022.0,4,17,-13
KEN,DEU,2015.0,11,9,2
SWE,TUR,2011.0,3,6,-3
TUR,IND,2009.0,4,4,0
THA,MYS,2012.0,5,3,2
NPL,GBR,2017.0,10,4,6
AUS,POL,2003.0,6,2,4
EGY,MYS,2017.0,6,7,-1
MNG,JPN,2018.0,7,14,-7
HKG,TWN,2014.0,10,13,-3
FRA,POL,2021.0,30,19,11
DNK,NLD,2014.0,17,36,-19
NIC,USA,2018.0,3,1,2
USA,KAZ,2016.0,21,11,10
MMR,MYS,2014.0,1,2,-1
POL,CHE,2020.0,21,14,7
BEL,PER,2010.0,3,1,2
AUT,IRN,2017.0,6,11,-5
CAN,TWN,2002.0,8,8,0
BGD,KOR,2020.0,17,44,-27
IRL,SGP,2019.0,5,11,-6
ESP,PHL,2019.0,2,2,0
HUN,NOR,2018.0,5,2,3
JOR,SGP,2018.0,1,1,0
USA,CYP,2019.0,14,9,5
CZE,SVK,2003.0,28,31,-3
ESP,MEX,2000.0,17,44,-27
GRC,USA,2001.0,47,61,-14
NZL,FJI,2020.0,1,6,-5
HUN,CZE,2020.0,8,6,2
PER,CHL,2019.0,4,9,-5
HUN,USA,2013.0,70,59,11
CAN,SWE,2018.0,50,37,13
SGP,ESP,2018.0,3,6,-3
DEU,NZL,2021.0,19,26,-7
CAN,ARG,2008.0,10,8,2
FRA,VEN,2011.0,8,8,0
DEU,BEL,2012.0,95,71,24
JPN,IRN,2013.0,12,8,4
PAK,AUS,2012.0,16,7,9
SAU,ARE,2017.0,39,4,35
ETH,CHN,2020.0,16,11,5
RUS,UKR,2015.0,27,219,-192
HUN,CAN,2007.0,5,7,-2
ZAF,ZMB,2020.0,15,7,8
SWE,IRN,2016.0,20,27,-7
ECU,BEL,2013.0,5,2,3
FRA,NCL,2019.0,17,23,-6
BRA,ISR,2004.0,1,2,-1
SWE,ISL,2002.0,16,4,12
ZAF,SWZ,2015.0,4,1,3
UGA,KEN,2014.0,7,8,-1
FRA,ZAF,2011.0,24,14,10
DEU,IRN,2006.0,10,12,-2
FIN,UKR,2003.0,1,1,0
DNK,IDN,2014.0,2,1,1
MEX,GBR,2010.0,35,41,-6
AUS,LKA,2013.0,11,6,5
NLD,SGP,2010.0,6,4,2
TTO,GBR,2003.0,3,5,-2
FRA,MEX,2020.0,29,44,-15
VEN,ESP,2018.0,22,9,13
IND,ERI,2012.0,2,1,1
IND,CHE,2009.0,21,9,12
CHE,NGA,2017.0,5,13,-8
PSE,ISR,2020.0,8,18,-10
UGA,ZAF,2013.0,2,4,-2
PRT,BRA,2004.0,19,25,-6
NLD,EGY,2007.0,3,2,1
ITA,ESP,2005.0,85,56,29
USA,SVN,2002.0,11,8,3
AUT,ESP,2002.0,15,10,5
CMR,FRA,2001.0,9,7,2
UKR,DEU,2003.0,38,16,22
JPN,TUR,2021.0,4,3,1
FRA,IND,2001.0,13,26,-13
CHE,ITA,1999.0,31,55,-24
AUT,USA,2004.0,83,85,-2
BEL,SWE,2017.0,25,17,8
USA,SVN,2005.0,12,8,4
HUN,ITA,2016.0,10,8,2
ITA,SVN,2004.0,4,1,3
CHL,BRA,1999.0,2,4,-2
FRA,SEN,1999.0,8,17,-9
BRA,ARG,2014.0,27,21,6
NLD,SVN,2016.0,2,3,-1
CAN,DEU,1997.0,22,13,9
NGA,GBR,2003.0,12,19,-7
GBR,GRC,2001.0,51,29,22
FIN,EST,2003.0,12,5,7
ITA,NLD,2000.0,14,19,-5
KEN,USA,2002.0,25,18,7
FRA,ISR,2003.0,22,35,-13
KWT,IND,2002.0,11,1,10
AUT,NOR,2001.0,2,1,1
KEN,USA,2005.0,18,17,1
SWE,SVK,2004.0,2,3,-1
NLD,NZL,2002.0,5,8,-3
SGP,QAT,2014.0,4,1,3
ZAF,ITA,2000.0,2,1,1
ZMB,JPN,2006.0,3,2,1
NZL,ZAF,2007.0,2,1,1
NOR,SWE,2013.0,44,58,-14
NLD,NZL,2005.0,7,4,3
KOR,RUS,2006.0,10,12,-2
NOR,CHN,2002.0,2,9,-7
JPN,NOR,2008.0,5,1,4
ESP,IND,1997.0,2,2,0
GBR,BGR,2002.0,6,6,0
EGY,MYS,2010.0,5,1,4
GBR,NOR,2000.0,12,7,5
RUS,ESP,2003.0,8,7,1
ITA,FIN,2011.0,15,5,10
CHE,BGR,2005.0,2,2,0
BWA,ZAF,2001.0,4,1,3
GMB,USA,2011.0,3,2,1
NOR,DEU,1999.0,6,14,-8
GRC,POL,1999.0,1,1,0
SWE,PRT,2017.0,1,18,-17
DNK,JPN,2002.0,7,8,-1
PAK,IND,2022.0,21,22,-1
FIN,CHN,2020.0,44,44,0
IDN,USA,2014.0,20,20,0
GEO,FRA,2021.0,23,13,10
MAR,BEL,2007.0,1,4,-3
NGA,BWA,2010.0,3,3,0
FIN,ESP,2016.0,18,19,-1
RUS,ROU,2006.0,3,1,2
UKR,MEX,2003.0,5,2,3
IRL,GRC,2015.0,6,1,5
POL,ITA,2011.0,16,31,-15
MAR,CAN,2007.0,4,4,0
KOR,GBR,2006.0,15,30,-15
MEX,ITA,2004.0,2,4,-2
ITA,MEX,2006.0,3,9,-6
FRA,NCL,2017.0,22,14,8
NCL,FRA,2021.0,8,11,-3
DNK,CHE,2010.0,21,22,-1
HKG,CAN,2013.0,15,25,-10
MYS,PHL,2021.0,3,1,2
CAN,IRL,2015.0,33,42,-9
AUS,ITA,2017.0,25,58,-33
DNK,THA,2011.0,1,4,-3
RUS,FIN,2016.0,21,25,-4
QAT,FRA,2014.0,4,19,-15
ISL,NOR,2010.0,4,11,-7
IRL,NZL,2016.0,10,4,6
PRT,SWE,2013.0,10,6,4
BEL,COG,2009.0,3,3,0
KEN,CHN,2017.0,5,13,-8
SWE,LKA,2016.0,3,1,2
SAU,NOR,2015.0,3,2,1
ETH,DEU,2008.0,3,3,0
OMN,LKA,2015.0,2,1,1
USA,PRI,2012.0,40,71,-31
VNM,AUS,2014.0,8,19,-11
CAN,TWN,2005.0,10,9,1
BGR,GBR,2012.0,6,6,0
PHL,CHN,2012.0,5,3,2
UZB,DEU,2015.0,3,3,0
NLD,NOR,2010.0,26,5,21
NLD,TUR,2022.0,6,11,-5
AUT,CAN,1998.0,3,3,0
FRO,DNK,2010.0,1,5,-4
NOR,BRA,2012.0,7,5,2
NOR,AUS,2013.0,9,22,-13
BEL,KOR,2003.0,3,1,2
ITA,IRN,2012.0,8,30,-22
JPN,NLD,2009.0,14,14,0
HRV,DEU,2014.0,12,13,-1
CRI,DEU,2010.0,4,2,2
ISL,IRN,2013.0,1,2,-1
ROU,RUS,2013.0,1,1,0
VNM,COL,2015.0,1,1,0
AUT,PAK,2010.0,7,8,-1
CZE,CHE,2021.0,12,9,3
IRN,POL,2015.0,2,4,-2
IRN,IND,2013.0,8,25,-17
BGD,DNK,2013.0,2,2,0
KEN,CHN,2019.0,6,14,-8
SVN,HRV,2002.0,6,5,1
VEN,FRA,2013.0,4,7,-3
BRA,IND,2015.0,10,28,-18
PRT,GRC,2022.0,1,1,0
HUN,JPN,2018.0,1,6,-5
POL,NOR,2019.0,11,5,6
IDN,DEU,2019.0,14,16,-2
CRI,DEU,2019.0,2,6,-4
KOR,EGY,2022.0,3,2,1
CHE,AUS,2022.0,22,31,-9
JPN,NGA,2019.0,7,7,0
CHE,NGA,2019.0,4,8,-4
NLD,SGP,2017.0,22,14,8
GRC,CYP,2022.0,28,20,8
JPN,UKR,2006.0,3,5,-2
CAN,DZA,2016.0,8,4,4
PAK,ITA,2020.0,18,17,1
AUT,TUR,2011.0,8,1,7
GRC,FRA,2004.0,15,25,-10
CHE,FIN,2003.0,11,7,4
AUT,ESP,2005.0,11,6,5
HUN,AUT,2006.0,11,9,2
KOR,UKR,2004.0,3,3,0
PER,GBR,2015.0,5,4,1
FIN,ITA,2006.0,2,6,-4
ESP,ROU,2017.0,10,1,9
CAN,POL,2001.0,10,13,-3
BRA,RUS,2002.0,12,13,-1
ARE,NZL,2002.0,1,1,0
DEU,UKR,2004.0,26,43,-17
NLD,AUT,2005.0,5,6,-1
ROU,SWE,2006.0,3,5,-2
FRA,PRT,2011.0,39,28,11
PRT,CAN,2014.0,14,10,4
AUS,PRT,2010.0,5,2,3
ITA,KOR,2013.0,12,9,3
FRA,NZL,2012.0,15,13,2
ZAF,CAN,2000.0,5,1,4
NPL,GBR,2010.0,4,4,0
PRY,ESP,2021.0,2,1,1
THA,ITA,2010.0,3,1,2
AUS,PRT,2017.0,2,17,-15
CYP,USA,2019.0,9,14,-5
TUR,ITA,2009.0,3,5,-2
KEN,NOR,2020.0,1,1,0
NLD,KEN,2015.0,7,5,2
POL,SWE,2010.0,17,5,12
SWE,PAK,2022.0,3,5,-2
COD,COG,2008.0,6,4,2
PER,CHE,2016.0,3,1,2
AUT,JPN,2011.0,12,6,6
ISL,NOR,2017.0,5,4,1
EST,FIN,2007.0,8,3,5
CHE,CHL,2006.0,1,2,-1
CHN,SDN,2014.0,7,3,4
NZL,NLD,2020.0,10,10,0
POL,CZE,2018.0,23,7,16
ISR,TUR,2010.0,1,1,0
DEU,KOR,2003.0,18,21,-3
PAK,CAN,2009.0,12,9,3
TGO,FRA,2020.0,3,3,0
AUS,COL,2020.0,6,7,-1
BIH,AUT,2019.0,1,2,-1
POL,NOR,2017.0,8,4,4
NLD,LKA,2004.0,1,1,0
PRT,MEX,2003.0,3,1,2
CRI,USA,2009.0,15,6,9
CHE,SRB,2001.0,3,3,0
FIN,NZL,2010.0,4,2,2
POL,HUN,2013.0,4,7,-3
GRC,ARE,2017.0,6,2,4
BMU,CAN,2002.0,1,1,0
AUT,AUS,1999.0,3,11,-8
MYS,EGY,2012.0,3,5,-2
IND,BRA,2002.0,5,3,2
GRL,DNK,2011.0,3,2,1
BGR,FRA,2007.0,5,6,-1
TUR,ESP,2003.0,2,1,1
BGR,IRL,2010.0,1,1,0
CUB,BRA,2011.0,7,4,3
KAZ,RUS,2005.0,7,13,-6
ESP,AUT,1999.0,3,3,0
CZE,NLD,2009.0,3,3,0
SVK,FRA,2007.0,5,7,-2
BEL,AUS,2009.0,13,8,5
THA,IDN,2016.0,10,1,9
ESP,PRI,2006.0,6,1,5
EST,UKR,2019.0,2,4,-2
ITA,DNK,2013.0,45,20,25
AUT,HUN,2021.0,7,12,-5
KEN,BEL,2004.0,3,1,2
BEL,HUN,2015.0,2,8,-6
IRN,EGY,2012.0,5,2,3
KOR,TZA,2013.0,3,1,2
BLR,DEU,2013.0,5,3,2
TUN,CAN,2012.0,7,5,2
CAN,MAC,2022.0,2,1,1
ECU,COL,2017.0,5,5,0
KOR,SAU,2013.0,19,6,13
AUT,PAK,2019.0,5,3,2
JOR,GBR,2020.0,13,40,-27
SAU,DNK,2019.0,3,1,2
USA,BLZ,2015.0,1,1,0
TGO,CHE,2018.0,2,1,1
UKR,AUT,2016.0,6,2,4
EGY,BEL,2014.0,2,5,-3
COL,JPN,2014.0,3,2,1
ITA,LUX,2016.0,14,1,13
LUX,FIN,2016.0,2,3,-1
OMN,SWE,2017.0,2,1,1
LKA,AUS,2007.0,6,1,5
GRC,CAN,2007.0,7,9,-2
CZE,ITA,1997.0,3,2,1
BOL,FRA,2020.0,2,1,1
BEL,DNK,2011.0,6,5,1
DEU,UZB,2017.0,5,1,4
IND,BRA,2005.0,2,3,-1
VNM,IND,2018.0,1,5,-4
CUB,CHN,2014.0,2,1,1
MEX,DNK,2017.0,4,4,0
NPL,CHN,2022.0,3,7,-4
ISR,TUR,2017.0,2,1,1
IRN,CHE,2022.0,13,1,12
ECU,GTM,2021.0,1,2,-1
SAU,GBR,2011.0,9,73,-64
PRT,MAR,2010.0,2,1,1
PHL,GBR,2005.0,4,4,0
PRT,ITA,2005.0,5,6,-1
SGP,PRT,2015.0,2,1,1
MYS,SAU,2008.0,5,2,3
CHL,BOL,2017.0,5,1,4
ROU,BEL,2003.0,3,2,1
FRA,AFG,2020.0,2,1,1
PER,JPN,2019.0,2,3,-1
DZA,USA,1999.0,2,1,1
SVN,CHE,2022.0,3,1,2
BGD,GBR,2016.0,13,18,-5
AUS,SYR,2016.0,1,1,0
VEN,URY,2021.0,2,1,1
BEL,COL,2015.0,2,1,1
SWE,KOR,2002.0,5,3,2
SVN,CZE,2002.0,1,1,0
FRA,MDG,2003.0,3,3,0
CUB,DEU,2017.0,2,1,1
LBN,BEL,2013.0,3,2,1
PER,CZE,2021.0,1,1,0
ESP,TWN,2017.0,4,3,1
CHN,YEM,2020.0,2,3,-1
MEX,SWE,2015.0,5,4,1
AUT,IRN,2010.0,3,9,-6
ETH,ERI,2016.0,1,1,0
IRQ,SWE,2019.0,1,7,-6
ISR,TUR,2019.0,2,3,-1
LBY,ZAF,2020.0,1,1,0
MOZ,PRT,2021.0,2,1,1
UKR,JPN,2001.0,5,9,-4
USA,TZA,2011.0,2,11,-9
PAK,JPN,2022.0,3,4,-1
NOR,CHN,2005.0,4,3,1
NLD,ZAF,2005.0,16,5,11
IRN,RUS,2013.0,2,3,-1
HUN,BRA,2015.0,1,2,-1
SRB,HUN,2017.0,7,3,4
ZAF,LSO,2019.0,8,3,5
ESP,HUN,2018.0,5,5,0
GRC,SWE,2009.0,10,2,8
ARG,NLD,2014.0,5,1,4
NPL,GBR,2019.0,8,10,-2
BRA,RUS,2005.0,11,4,7
MEX,DNK,2010.0,3,1,2
BGR,RUS,2005.0,3,1,2
BEL,TUR,2012.0,7,3,4
HUN,SWE,2004.0,3,5,-2
AUS,NLD,2000.0,5,5,0
VNM,NLD,2004.0,4,4,0
TUR,KGZ,2022.0,3,2,1
CAN,LBY,2019.0,2,1,1
KEN,MWI,2008.0,1,1,0
DEU,GEO,2012.0,3,4,-1
SGP,DEU,1999.0,1,7,-6
JPN,ZAF,2016.0,2,2,0
ZAF,COG,2017.0,2,1,1
USA,ETH,2004.0,6,2,4
CAN,VEN,2003.0,3,3,0
HKG,IND,2007.0,4,1,3
FRA,HUN,1998.0,3,4,-1
CZE,ITA,1998.0,5,4,1
ESP,CMR,2005.0,1,1,0
NLD,RUS,2000.0,2,13,-11
POL,MYS,2013.0,2,2,0
IRL,SGP,2010.0,9,1,8
DEU,TWN,2004.0,7,11,-4
FRA,MYS,2004.0,1,1,0
CAN,QAT,2011.0,3,1,2
MDA,FRA,2012.0,3,2,1
ECU,ESP,2004.0,2,1,1
NZL,MEX,2007.0,1,3,-2
KEN,TZA,2009.0,2,2,0
CHN,UZB,2014.0,1,1,0
MLT,USA,2009.0,1,1,0
TUN,OMN,2018.0,3,1,2
TWN,SGP,2001.0,2,2,0
NLD,PAK,2021.0,2,1,1
DNK,ISR,2014.0,3,2,1
DNK,EST,2016.0,2,5,-3
IND,GHA,2018.0,7,2,5
FRA,LBY,2017.0,2,1,1
LVA,USA,2011.0,3,3,0
ZWE,GBR,2018.0,6,5,1
FRO,DNK,2019.0,1,1,0
DZA,JPN,2016.0,1,1,0
BGD,BEL,2016.0,3,1,2
UZB,CHN,2021.0,5,7,-2
BEL,PER,2019.0,2,1,1
ERI,IND,2012.0,1,2,-1
ISR,BEL,2018.0,3,6,-3
RUS,AZE,2014.0,4,9,-5
IND,PRI,2007.0,1,5,-4
NGA,CMR,2016.0,2,3,-1
JOR,PSE,2021.0,2,1,1
QAT,SAU,2020.0,8,15,-7
ARE,JPN,2018.0,1,7,-6
FRA,KHM,2017.0,4,5,-1
AUS,HRV,2018.0,1,1,0
CMR,GBR,2006.0,2,1,1
USA,SLE,2022.0,1,2,-1
ESP,ROU,2010.0,9,6,3
IND,BGD,2000.0,2,1,1
ECU,PRT,2016.0,1,1,0
TWN,AUS,2003.0,9,7,2
NLD,BGR,2014.0,2,2,0
IND,OMN,2006.0,5,1,4
LBN,CAN,2007.0,7,4,3
EGY,JPN,1998.0,3,2,1
SAU,NZL,2021.0,2,2,0
ZAF,KOR,2020.0,6,4,2
JPN,NGA,2017.0,6,4,2
FIN,NZL,2019.0,6,2,4
GRC,BRA,2021.0,2,2,0
CHL,BOL,2019.0,2,3,-1
MAC,CAN,2022.0,1,2,-1
NLD,AUT,2002.0,14,12,2
DEU,EST,2006.0,3,3,0
MLI,BFA,2015.0,1,1,0
LTU,AUT,2022.0,3,1,2
PER,CHL,2017.0,6,11,-5
PAK,NZL,2015.0,3,6,-3
SVN,NLD,2003.0,2,2,0
EGY,SWE,2020.0,1,2,-1
KAZ,RUS,2002.0,7,7,0
AUT,IRL,2006.0,4,4,0
BEL,TUN,1999.0,1,2,-1
NZL,DEU,1999.0,3,6,-3
KOR,MYS,2008.0,1,3,-2
JPN,ARE,2007.0,3,1,2
THA,NLD,2015.0,5,14,-9
SWE,ISR,2012.0,3,4,-1
PRT,POL,2020.0,4,5,-1
BEL,LBN,2015.0,3,3,0
TUR,ISR,2010.0,1,1,0
TUR,SGP,2014.0,2,5,-3
ROU,ESP,2022.0,1,3,-2
KOR,PRT,2015.0,2,1,1
POL,LUX,2013.0,2,1,1
RUS,TWN,2012.0,2,1,1
BGR,DEU,1999.0,3,5,-2
QAT,TUR,2016.0,1,4,-3
CZE,IRN,2013.0,3,4,-1
CUB,BEL,2019.0,3,1,2
EGY,IRQ,2021.0,4,4,0
JPN,BEL,2022.0,2,8,-6
MEX,CHE,2018.0,7,8,-1
IND,PRT,2001.0,3,1,2
SDN,OMN,2020.0,2,1,1
PSE,LBN,2021.0,1,1,0
CHE,BEL,1998.0,4,2,2
CUB,BEL,2017.0,4,1,3
CRI,NLD,2020.0,4,4,0
MEX,DNK,2019.0,3,2,1
FRO,DNK,2017.0,1,1,0
DNK,MEX,2020.0,4,7,-3
RUS,CHL,2011.0,2,1,1
ESP,CRI,2018.0,6,3,3
SRB,CAN,2015.0,1,2,-1
GRC,NZL,2017.0,1,1,0
CAN,PRT,2003.0,6,3,3
DNK,SGP,2015.0,4,7,-3
HRV,AUT,2008.0,3,2,1
CHE,SWZ,2016.0,3,1,2
NGA,BRA,2022.0,3,6,-3
BMU,CAN,2005.0,1,1,0
ITA,MLT,2021.0,3,4,-1
ETH,SWE,2011.0,1,4,-3
NOR,ISL,2022.0,1,2,-1
SVK,ESP,2019.0,2,3,-1
ISR,ROU,2018.0,2,2,0
MKD,SRB,2013.0,2,2,0
COG,GAB,2019.0,2,1,1
ESP,ROU,2019.0,2,5,-3
ITA,CHL,2022.0,2,1,1
CHL,FIN,2014.0,1,3,-2
BHR,JOR,2021.0,1,1,0
THA,BRA,2021.0,1,1,0
PRI,CUB,2001.0,2,1,1
AUS,EST,2020.0,2,2,0
SWE,HKG,2007.0,1,4,-3
NOR,MWI,2017.0,2,1,1
CAN,URY,2014.0,1,2,-1
FRA,HUN,1997.0,3,1,2
SWE,KOR,2005.0,3,3,0
DNK,SVK,2006.0,1,1,0
KWT,IND,2005.0,4,6,-2
PRT,SAU,2014.0,6,2,4
TUR,FIN,2003.0,2,1,1
NOR,JPN,2002.0,2,6,-4
GBR,BRB,2005.0,1,3,-2
CHE,BEL,1997.0,2,5,-3
COL,MEX,2002.0,2,4,-2
SWE,MAR,2022.0,1,1,0
CAN,CRI,1999.0,2,1,1
HKG,RUS,2002.0,2,2,0
SGP,UKR,2017.0,1,1,0
FRA,PER,2002.0,2,1,1
AUS,SVN,2015.0,1,2,-1
HRV,FRA,2014.0,5,6,-1
COL,MEX,2005.0,4,7,-3
FIN,TUR,2018.0,1,3,-2
RUS,NGA,2014.0,2,1,1
KWT,JPN,2019.0,1,2,-1
BRA,BEN,2017.0,1,1,0
ZMB,GBR,2011.0,2,1,1
SGP,ARE,2021.0,4,1,3
TWN,FRA,2019.0,6,14,-8
PER,MEX,2022.0,2,4,-2
PAK,AFG,2021.0,1,1,0
PRT,ITA,2002.0,4,5,-1
IND,DNK,2001.0,2,3,-1
SVK,ESP,2010.0,2,2,0
NZL,DNK,2018.0,4,4,0
PRY,MEX,2012.0,1,2,-1
PER,BOL,2018.0,2,1,1
ARE,NLD,2012.0,1,3,-2
EGY,KWT,2004.0,9,3,6
JPN,IRL,2008.0,7,6,1
BEL,SGP,2007.0,3,1,2
ZAF,PRT,2015.0,1,4,-3
MLT,GRC,2014.0,1,1,0
IRL,CHL,2008.0,1,2,-1
FJI,NZL,2004.0,1,3,-2
CUB,BEL,2010.0,3,1,2
DZA,GRC,2009.0,1,1,0
PER,JPN,2017.0,1,1,0
POL,NLD,2007.0,11,7,4
IDN,DEU,2010.0,1,17,-16
HKG,ISR,2020.0,2,2,0
HKG,TUR,2017.0,1,3,-2
GBR,BGR,2005.0,3,7,-4
PRT,PER,2019.0,1,2,-1
ISR,BRA,2002.0,1,1,0
AUT,LUX,2016.0,2,3,-1
ESP,PHL,2017.0,2,2,0
BRA,AGO,2021.0,2,2,0
BGD,SGP,2019.0,1,4,-3
ITA,EST,2021.0,1,4,-3
PYF,FRA,2005.0,2,5,-3
TWN,KOR,2000.0,2,1,1
FJI,USA,2006.0,2,2,0
BGD,CHN,2008.0,1,2,-1
DNK,NPL,2018.0,2,1,1
AUT,KOR,2016.0,3,1,2
BMU,USA,2004.0,1,2,-1
MYS,CAN,2011.0,6,5,1
MAC,SAU,2018.0,2,1,1
DNK,CZE,2013.0,3,4,-1
ARE,JAM,2018.0,1,1,0
SDN,NLD,2002.0,1,2,-1
PLW,USA,2004.0,1,3,-2
DEU,BGD,2016.0,4,7,-3
NLD,CRI,2018.0,1,1,0
POL,TUR,2011.0,1,7,-6
NOR,TUR,2012.0,2,2,0
SGP,BRA,2013.0,1,2,-1
CHN,UKR,2018.0,3,16,-13
DZA,ROU,2020.0,1,1,0
USA,SVK,2021.0,1,4,-3
ITA,KEN,2021.0,1,1,0
GEO,AUT,2020.0,1,1,0
BRA,SDN,2018.0,1,1,0
CAN,CZE,2022.0,3,3,0
NOR,NGA,2018.0,2,1,1
ROU,ISR,2016.0,1,2,-1
DEU,ALB,2015.0,2,1,1
COL,NLD,2022.0,2,2,0
KOR,NPL,2011.0,1,3,-2
ECU,CAN,2021.0,4,2,2
EGY,NLD,2013.0,2,1,1
LKA,DEU,2012.0,1,1,0
GBR,HRV,2001.0,1,1,0
JAM,USA,2008.0,3,5,-2
GHA,CAN,2006.0,1,2,-1
JPN,CZE,2001.0,1,8,-7
RUS,EGY,2001.0,1,1,0
CAN,CYP,2013.0,1,2,-1
NLD,CHL,2014.0,7,6,1
DNK,CHL,2015.0,1,6,-5
NGA,NER,2012.0,1,1,0
SAU,MEX,2020.0,1,5,-4
BLR,FRA,2019.0,1,1,0
BEL,PRT,2022.0,5,7,-2
NOR,VEN,2017.0,1,1,0
BEL,SRB,2022.0,1,2,-1
IRN,ARM,2012.0,1,5,-4
GRC,BGR,2016.0,1,1,0
CIV,CAN,2004.0,2,1,1
KHM,GBR,2008.0,1,4,-3
EGY,JPN,1997.0,1,1,0
ZMB,MWI,2020.0,2,3,-1
SRB,HUN,2019.0,3,2,1
RUS,VNM,2011.0,4,1,3
IND,PAN,2020.0,2,1,1
POL,ARG,2011.0,1,5,-4
PRT,FIN,2006.0,2,1,1
AFG,USA,2014.0,1,4,-3
BWA,ZWE,2000.0,1,1,0
DEU,AZE,2015.0,1,1,0
MEX,NLD,2008.0,1,11,-10
JPN,ISR,2016.0,4,4,0
AUT,ARG,2009.0,2,1,1
MDA,USA,2020.0,1,1,0
FRA,LBY,2019.0,1,1,0
AUT,MYS,2014.0,2,1,1
SLV,USA,2021.0,1,2,-1
CZE,BGD,2021.0,2,1,1
EST,NLD,2022.0,1,1,0
BEL,IDN,2022.0,3,1,2
FRA,EST,2015.0,2,1,1
DNK,LTU,2021.0,2,5,-3
LTU,FRA,2011.0,2,2,0
LAO,FRA,2022.0,1,3,-2
MYS,SWE,2021.0,2,1,1
BRA,MYS,2022.0,1,2,-1
CHL,PRT,2020.0,5,2,3
NGA,CYP,2020.0,2,3,-1
TUR,ISR,2017.0,1,2,-1
CHE,BGR,2002.0,2,3,-1
BGR,HUN,2017.0,1,1,0
GBR,BEN,2020.0,1,1,0
PAN,COL,2016.0,2,2,0
PAK,SAU,2000.0,1,1,0
TZA,USA,1998.0,1,5,-4
SAU,TUN,2009.0,2,14,-12
NLD,TZA,2008.0,1,1,0
ROU,SRB,2008.0,2,1,1
PSE,JOR,2013.0,1,1,0
HKG,ARE,2020.0,1,2,-1
SAU,SYR,2020.0,1,2,-1
MEX,ISR,2015.0,2,1,1
DEU,CYP,2015.0,1,2,-1
HRV,POL,2020.0,2,1,1
CHL,AUT,2003.0,1,1,0
POL,HRV,2012.0,1,8,-7
ALB,TUR,2012.0,1,1,0
FRA,KHM,2010.0,1,6,-5
AUT,CAN,1997.0,2,2,0
EGY,NZL,2021.0,1,1,0
NGA,CAN,2002.0,1,2,-1
ZAF,JPN,2001.0,1,2,-1
ZAF,RUS,2004.0,1,5,-4
CYP,USA,2010.0,2,23,-21
NLD,MWI,2004.0,1,1,0
KAZ,KOR,2018.0,1,8,-7
SEN,SWE,2015.0,1,1,0
OMN,CAN,2007.0,1,3,-2
TUR,NZL,2021.0,1,1,0
FIN,GHA,2018.0,1,1,0
ARE,NZL,2005.0,1,3,-2
QAT,OMN,2013.0,1,2,-1
GHA,ITA,2002.0,1,1,0
OMN,JOR,2020.0,1,2,-1
LSO,ZAF,2020.0,1,3,-2
JPN,ZMB,2018.0,1,3,-2
DEU,ARM,2005.0,3,6,-3
KOR,BRA,2020.0,2,3,-1
HUN,EGY,2003.0,2,2,0
ZAF,NZL,2007.0,1,2,-1
HUN,ESP,2001.0,1,1,0
MYS,JPN,1999.0,1,1,0
CZE,ESP,2007.0,1,3,-2
CMR,DNK,2010.0,1,1,0
ARE,SDN,1997.0,1,1,0
PRT,PHL,2021.0,1,1,0
EGY,DNK,2018.0,1,1,0
BFA,BEL,2013.0,1,3,-2
CHN,MWI,2019.0,1,1,0
NOR,JPN,2005.0,1,2,-1
KEN,MLI,2010.0,1,1,0
MKD,GRC,2006.0,1,1,0
ISR,DNK,2022.0,1,2,-1
QAT,SGP,2014.0,1,4,-3
BEL,PER,2017.0,2,1,1
URY,GBR,2018.0,1,1,0
LAO,THA,2020.0,1,4,-3
COG,CHE,2009.0,1,1,0
USA,MDA,1998.0,1,1,0
NLD,ZWE,2012.0,1,1,0
CZE,CHN,1999.0,1,1,0
SOM,TUR,2021.0,1,2,-1
NGA,SAU,2001.0,1,1,0
NOR,ARE,2019.0,1,4,-3
JPN,TUN,2019.0,1,1,0
OMN,IRQ,2020.0,1,2,-1
ESP,IND,1998.0,1,2,-1
CHL,IRN,2017.0,1,1,0
NLD,ARE,2021.0,1,3,-2
THA,ZAF,2017.0,1,1,0
ITA,ESP,2002.0,61,64,-3
RUS,DEU,2005.0,125,84,41
KEN,JPN,2006.0,5,4,1
GRC,BEL,2017.0,26,7,19
MEX,USA,2007.0,143,161,-18
SWE,DNK,2014.0,71,89,-18
BLR,RUS,2003.0,17,8,9
SWE,CAN,2007.0,50,16,34
JPN,MYS,2011.0,62,15,47
LBN,USA,2017.0,72,48,24
SWE,DEU,2020.0,144,189,-45
GBR,NLD,2018.0,311,280,31
PAK,USA,2013.0,69,59,10
MYS,BGD,2016.0,30,31,-1
IND,CHN,2018.0,239,51,188
BRA,CZE,2021.0,12,3,9
BEL,SWE,2019.0,28,20,8
USA,HUN,2018.0,40,62,-22
IRN,FRA,2021.0,26,11,15
COL,ARG,2018.0,18,25,-7
GBR,BRA,2020.0,84,132,-48
CHN,TZA,2020.0,17,8,9
ARG,USA,2001.0,113,53,60
NZL,GBR,2003.0,78,112,-34
POL,SWE,2017.0,21,12,9
QAT,GBR,2021.0,18,20,-2
LBN,USA,2019.0,73,36,37
UKR,RUS,2000.0,23,15,8
YEM,EGY,2011.0,4,1,3
MKD,NLD,2011.0,1,1,0
UKR,GBR,2018.0,11,7,4
LBN,USA,2010.0,52,36,16
USA,IND,2000.0,69,156,-87
FIN,NZL,2017.0,3,4,-1
JPN,DNK,2001.0,11,7,4
RUS,GBR,2016.0,48,43,5
CRI,DEU,2017.0,4,3,1
CYP,USA,2017.0,13,9,4
CHN,CZE,2012.0,3,3,0
SWE,IND,2022.0,18,28,-10
ECU,COL,2019.0,7,7,0
THA,SWE,2020.0,9,3,6
JPN,AUS,2021.0,34,41,-7
CHE,NZL,2012.0,8,8,0
USA,GEO,2018.0,13,17,-4
FIN,POL,2016.0,4,9,-5
NLD,DNK,2012.0,21,16,5
BEL,CHE,2014.0,38,38,0
CHL,FRA,2007.0,25,27,-2
MEX,DEU,2008.0,23,28,-5
FRA,NER,2016.0,3,4,-1
DNK,CHE,2017.0,31,25,6
BRA,SWE,2002.0,5,5,0
ARG,GBR,2008.0,20,13,7
RUS,ITA,2002.0,43,25,18
JPN,IDN,2001.0,10,13,-3
SWE,ISL,2005.0,9,6,3
CAN,SAU,1998.0,2,1,1
NOR,CHE,2012.0,14,13,1
TUN,USA,2006.0,4,5,-1
MEX,FRA,1999.0,15,14,1
NLD,ITA,1999.0,26,28,-2
ISR,CHE,2003.0,19,5,14
SRB,GBR,2014.0,3,6,-3
USA,MDG,2020.0,4,8,-4
CAN,FIN,2018.0,15,24,-9
BEL,NOR,2003.0,3,2,1
BRA,POL,2011.0,15,2,13
CHN,PRT,2008.0,4,7,-3
MAC,CHN,2011.0,5,19,-14
THA,HKG,2009.0,2,1,1
ARG,CHL,2008.0,12,13,-1
FRA,SGP,2014.0,35,17,18
IND,IRL,2009.0,16,4,12
NLD,ZAF,2002.0,9,13,-4
ESP,CUB,2007.0,15,16,-1
AUT,IRN,2019.0,5,20,-15
MKD,SVN,2011.0,1,1,0
DNK,FRA,2022.0,13,20,-7
CZE,BRA,2020.0,2,15,-13
QAT,NLD,2016.0,3,3,0
AUS,PRT,2019.0,4,9,-5
ETH,GHA,2016.0,1,2,-1
KEN,ZAF,2016.0,12,21,-9
MYS,SDN,2017.0,12,4,8
CUB,DEU,2019.0,9,1,8
FLK,GBR,2013.0,1,2,-1
SWE,SGP,2016.0,15,9,6
CAN,SRB,2010.0,3,3,0
ISL,NZL,2014.0,1,1,0
GBR,SVK,2002.0,7,3,4
SWE,BEL,2013.0,14,22,-8
GRC,RUS,2002.0,6,5,1
SWE,PRT,2010.0,5,4,1
ARG,COL,2013.0,7,13,-6
CAN,LBY,2017.0,3,1,2
HUN,FIN,2015.0,4,1,3
CHL,ARG,2009.0,8,7,1
CUB,ITA,2004.0,1,3,-2
BEL,CHL,2009.0,6,2,4
BIH,NOR,2019.0,1,1,0
USA,ZWE,2011.0,1,4,-3
PHL,GBR,2002.0,3,4,-1
BGR,RUS,2002.0,6,2,4
GBR,OMN,2009.0,7,2,5
ARG,SWE,2013.0,4,3,1
PRT,IRN,2012.0,2,11,-9
IND,FJI,2014.0,4,1,3
BIH,SRB,2006.0,5,7,-2
ZMB,ZAF,2018.0,7,11,-4
CHN,EST,2020.0,4,3,1
IDN,DEU,2017.0,9,23,-14
ARG,PER,2021.0,4,6,-2
SWE,NGA,2017.0,3,1,2
POL,AUS,2011.0,5,16,-11
ITA,CZE,2011.0,4,6,-2
MEX,KOR,2021.0,3,2,1
AUS,JOR,2007.0,6,1,5
TUR,PAK,2016.0,8,8,0
JPN,SVK,2001.0,1,3,-2
RUS,MDA,2006.0,2,2,0
BRA,SWE,2005.0,3,6,-3
GBR,KOR,1999.0,8,3,5
FRA,NCL,2010.0,7,23,-16
CAN,KAZ,2017.0,4,1,3
ARE,DEU,2011.0,1,6,-5
MYS,SDN,2019.0,5,1,4
YEM,MAR,2017.0,1,1,0
RUS,MNG,2020.0,1,2,-1
SRB,DEU,2006.0,9,13,-4
PRT,BLR,2008.0,1,3,-2
LTU,DEU,2007.0,9,9,0
RUS,AUT,2021.0,9,7,2
URY,AUS,2016.0,3,1,2
GBR,SVK,2005.0,2,9,-7
SDN,MYS,2005.0,1,2,-1
JPN,NZL,1999.0,3,1,2
IRQ,SWE,2017.0,2,3,-1
JPN,PER,2016.0,2,1,1
BRA,BGR,2000.0,1,2,-1
ISR,NLD,2012.0,7,10,-3
BEL,MEX,2000.0,4,1,3
DNK,KOR,2012.0,3,3,0
RUS,ARM,2001.0,2,3,-1
GBR,PRI,2001.0,2,1,1
COL,CAN,2004.0,2,1,1
GTM,GBR,2021.0,1,1,0
ARG,EST,2016.0,1,1,0
POL,AUT,2005.0,4,3,1
ESP,ISL,2014.0,1,1,0
ZAF,LSO,2017.0,2,1,1
DEU,SDN,2003.0,1,2,-1
BRA,DNK,2008.0,3,1,2
POL,KOR,2016.0,5,1,4
BLR,UKR,2012.0,1,1,0
HRV,SRB,2001.0,1,5,-4
NGA,IND,2001.0,3,3,0
MYS,SDN,2010.0,1,4,-3
COL,DNK,2009.0,2,1,1
ZAF,SAU,2014.0,2,6,-4
NZL,TUR,2015.0,4,2,2
HRV,GRC,2016.0,1,2,-1
SRB,QAT,2016.0,1,1,0
ZAF,NOR,2006.0,3,1,2
LTU,JPN,2013.0,1,1,0
FIN,ISR,2020.0,3,4,-1
ESP,TUR,2010.0,6,4,2
ESP,TUR,2019.0,10,5,5
SYR,ITA,2020.0,1,2,-1
KOR,POL,2008.0,1,2,-1
LBY,USA,2013.0,2,6,-4
FRA,COG,2020.0,1,1,0
IND,JOR,2022.0,1,2,-1
ZMB,KEN,2022.0,1,1,0
SVK,ESP,2017.0,1,1,0
HUN,SYR,2012.0,1,1,0
ARM,USA,2021.0,3,2,1
PAK,IDN,2022.0,1,1,0
KWT,MYS,2021.0,1,3,-2
TZA,BEL,2020.0,1,3,-2
AUT,SGP,2016.0,2,3,-1
CZE,KOR,2002.0,1,1,0
CAN,SVN,2010.0,1,1,0
SEN,ZAF,2015.0,1,2,-1
EGY,NGA,2020.0,1,5,-4
BGR,HUN,2019.0,1,1,0
SWE,NGA,2019.0,1,4,-3
IRL,TUR,2016.0,1,3,-2
GRC,RUS,2005.0,1,2,-1
UKR,LVA,2019.0,1,2,-1
GBR,SEN,2016.0,1,2,-1
AUS,ROU,2022.0,1,1,0
,AUS,2004.0,7185,0,7185
BRA,,2015.0,8989,0,8989
JPN,,2018.0,23991,0,23991
,SVN,2004.0,526,0,526
,JPN,2002.0,27377,0,27377
ARM,,2012.0,67,0,67
,SGP,2004.0,1362,0,1362
,TWN,2005.0,6612,0,6612
,MAR,2004.0,480,0,480
,EST,2004.0,297,0,297
CHN,,2003.0,5418,0,5418
TZA,,2010.0,53,0,53
USA,,2005.0,28851,0,28851
IND,,2003.0,1471,0,1471
,TWN,2002.0,5572,0,5572
,CUB,2001.0,573,0,573
MOZ,,2020.0,54,0,54
,BRA,2007.0,17132,0,17132
PER,CHL,2010.0,4,0,4
,ISR,2009.0,2272,0,2272
,JPN,2005.0,24472,0,24472
,MAR,1996.0,266,0,266
USA,,2002.0,7575,0,7575
UKR,,2020.0,2251,0,2251
,UZB,2014.0,101,0,101
PRT,,2023.0,11486,0,11486
THA,,2020.0,2329,0,2329
,PRT,2011.0,3203,0,3203
,AUS,1996.0,3212,0,3212
,ESP,2013.0,13778,0,13778
,EGY,1999.0,1750,0,1750
,HND,2009.0,13,0,13
HND,,2023.0,85,0,85
CHE,,1999.0,75,0,75
,IND,2013.0,32355,0,32355
,ARG,2000.0,2732,0,2732
,MYS,1995.0,211,0,211
,NLD,2006.0,5419,0,5419
TTO,,2008.0,14,0,14
,UKR,2001.0,1210,0,1210
,SVN,1996.0,291,0,291
,HKG,2009.0,1639,0,1639
,THA,2012.0,2417,0,2417
AUT,,2014.0,1524,0,1524
COL,,2013.0,428,0,428
GRC,IND,2009.0,3,0,3
,DNK,2016.0,2789,0,2789
SWE,,2003.0,788,0,788
,NPL,2017.0,481,0,481
TZA,,2017.0,134,0,134
,BGD,2009.0,733,0,733
SRB,,2013.0,352,0,352
,URY,2005.0,158,0,158
KWT,,2009.0,100,0,100
ZWE,,2009.0,25,0,25
,MEX,2018.0,4178,0,4178
,TUN,2015.0,1363,0,1363
,SRB,2010.0,1756,0,1756
,ARE,1994.0,72,0,72
,ISL,2009.0,145,0,145
EST,IRL,2009.0,1,0,1
,BIH,1999.0,97,0,97
,ROU,2008.0,2611,0,2611
MMR,,2013.0,9,0,9
BGR,,2019.0,481,0,481
LUX,,2011.0,28,0,28
,PRI,1994.0,80,0,80
LBY,,2016.0,45,0,45
,IDN,2006.0,481,0,481
,JOR,2001.0,206,0,206
,BHR,2008.0,31,0,31
,NPL,2010.0,257,0,257
BGR,,2017.0,412,0,412
,HUN,2007.0,1393,0,1393
,GRC,2014.0,2204,0,2204
,MDG,2015.0,89,0,89
SGP,,2006.0,463,0,463
,SYR,2010.0,102,0,102
,SGP,1996.0,389,0,389
MYS,PRT,2014.0,1,0,1
,ZMB,2009.0,61,0,61
QAT,,2014.0,43,0,43
TZA,,2019.0,189,0,189
MYS,CZE,2015.0,5,0,5
,MNG,2012.0,64,0,64
,SRB,2019.0,488,0,488
,URY,2002.0,149,0,149
EGY,,2004.0,190,0,190
,LBY,2012.0,53,0,53
,AZE,2012.0,107,0,107
COD,,2019.0,13,0,13
PRY,,2019.0,36,0,36
BEL,DZA,2016.0,5,0,5
CHL,KAZ,2018.0,1,0,1
,TGO,2013.0,38,0,38
,SRB,2017.0,867,0,867
CIV,,2018.0,127,0,127
,NAM,2014.0,41,0,41
BOL,,2020.0,59,0,59
NAM,,2023.0,155,0,155
,GUM,2015.0,4,0,4
,MLI,2015.0,49,0,49
,MMR,2016.0,67,0,67
TUN,MRT,2020.0,2,0,2
SWE,UGA,2018.0,2,0,2
,MAC,2016.0,218,0,218
ROU,,2004.0,186,0,186
,PER,1994.0,33,0,33
,SYR,2017.0,119,0,119
AUS,NAM,2021.0,2,0,2
,GTM,2018.0,46,0,46
EST,CZE,2015.0,4,0,4
BGR,,2010.0,227,0,227
BHR,,2021.0,105,0,105
,COG,2007.0,56,0,56
,AFG,2009.0,18,0,18
SYR,AUT,2010.0,1,0,1
,EST,1996.0,105,0,105
,QAT,2006.0,89,0,89
SRB,PRT,2010.0,2,0,2
AUS,LAO,2015.0,2,0,2
RUS,IRL,2012.0,5,0,5
MEX,TWN,2012.0,1,0,1
MTQ,,2016.0,8,0,8
TWN,UKR,2020.0,1,0,1
TWN,MWI,2020.0,2,0,2
ARE,,2005.0,42,0,42
CRI,ECU,2016.0,2,0,2
AUS,ISL,2008.0,1,0,1
,AGO,2011.0,11,0,11
JOR,,2000.0,4,0,4
FJI,,2021.0,39,0,39
ETH,IRL,2021.0,1,0,1
POL,SRB,2011.0,1,0,1
CAN,IDN,2015.0,3,0,3
ZAF,LTU,2018.0,1,0,1
,NPL,2019.0,365,0,365
CAN,KAZ,2019.0,1,0,1
LKA,BRA,2020.0,1,0,1
HKG,KEN,2022.0,1,0,1
KHM,BTN,2020.0,1,0,1
,ZWE,2001.0,67,0,67
LTU,,2006.0,73,0,73
BLR,MEX,2020.0,1,0,1
UZB,,2001.0,21,0,21
PRY,,2010.0,5,0,5
,BOL,1998.0,26,0,26
BFA,,2013.0,30,0,30
COD,,2010.0,3,0,3
DZA,GBR,2018.0,3,0,3
BEN,,2009.0,12,0,12
JPN,ZWE,2013.0,1,0,1
,CIV,1995.0,50,0,50
FRA,PSE,2006.0,1,0,1
DNK,MLI,2016.0,2,0,2
MKD,,2008.0,14,0,14
TGO,,2013.0,9,0,9
BHR,KWT,2014.0,2,0,2
FRA,SDN,2003.0,3,0,3
HKG,GRC,2002.0,1,0,1
JPN,GHA,2001.0,4,0,4
BWA,POL,2005.0,1,0,1
AUS,NCL,2004.0,2,0,2
SYR,USA,2001.0,6,0,6
KEN,,2000.0,2,0,2
SGP,KWT,2004.0,1,0,1
UKR,ARG,2005.0,1,0,1
MEX,QAT,2015.0,1,0,1
GBR,IDN,2006.0,5,0,5
SGP,SAU,2008.0,3,0,3
BFA,ITA,2017.0,1,0,1
BEL,CIV,2013.0,3,0,3
,FJI,2001.0,14,0,14
JPN,ARG,2000.0,2,0,2
HKG,RUS,2005.0,5,0,5
GRC,ARE,2010.0,4,0,4
OMN,GHA,2016.0,1,0,1
ITA,ALB,2011.0,6,0,6
ITA,PER,2005.0,1,0,1
IND,ARE,2006.0,3,0,3
ISR,KOR,2011.0,2,0,2
BLR,FRA,2010.0,2,0,2
BLR,CAN,2002.0,6,0,6
UKR,AZE,2014.0,2,0,2
CYP,CHE,2002.0,1,0,1
TWN,BEL,1999.0,1,0,1
KWT,PAK,2010.0,1,0,1
ALB,GBR,2009.0,1,0,1
GHA,BFA,2011.0,1,0,1
MAR,TUN,2005.0,1,0,1
DEU,MOZ,2000.0,1,0,1
GIN,,2004.0,3,0,3
IDN,KOR,2005.0,2,0,2
,BOL,1997.0,15,0,15
VEN,CZE,2018.0,2,0,2
MEX,IRL,2020.0,3,0,3
USA,MLI,2021.0,2,0,2
KHM,PAK,2014.0,2,0,2
,SYR,2019.0,116,0,116
EST,VNM,2018.0,1,0,1
VNM,EST,2020.0,1,0,1
,BLZ,2005.0,4,0,4
BLR,FRA,2017.0,2,0,2
,LAO,2008.0,23,0,23
NLD,MLI,2018.0,2,0,2
HUN,IND,2011.0,1,0,1
ALB,CZE,2021.0,1,0,1
PRY,,2017.0,25,0,25
ZWE,IND,2012.0,2,0,2
SYC,COL,2017.0,1,0,1
GRL,,2020.0,9,0,9
IND,HUN,2015.0,4,0,4
SEN,CHE,2013.0,3,0,3
BRA,KOR,2006.0,2,0,2
ESP,ALB,2018.0,3,0,3
AZE,FRA,2017.0,1,0,1
ESP,SVK,2018.0,3,0,3
ETH,PER,2018.0,1,0,1
TGO,GHA,2017.0,1,0,1
SYR,SAU,2017.0,2,0,2
IRN,ISR,2005.0,1,0,1
TUR,KAZ,2014.0,3,0,3
IRQ,,2006.0,6,0,6
CHE,OMN,2007.0,1,0,1
,GAB,2008.0,19,0,19
,CPV,2009.0,2,0,2
COD,,2017.0,4,0,4
HUN,ARE,2020.0,1,0,1
CHN,BGR,2012.0,1,0,1
NOR,ARE,2010.0,1,0,1
PNG,BGD,2021.0,1,0,1
SDN,CHN,2012.0,1,0,1
CAN,USA,2023.0,1,0,1
UGA,NAM,2014.0,1,0,1
IRQ,BGR,2014.0,1,0,1
JPN,ECU,2002.0,1,0,1
ARG,SRB,2004.0,1,0,1
,CAF,2001.0,11,0,11
SVN,,2000.0,7,0,7
RUS,JOR,2005.0,2,0,2
GAB,,2014.0,13,0,13
USA,PRY,2005.0,1,0,1
ZMB,COG,2005.0,1,0,1
FIN,EGY,2012.0,3,0,3
RUS,ETH,2014.0,1,0,1
ITA,EGY,1998.0,2,0,2
OMN,SAU,2000.0,1,0,1
CHE,SVK,2000.0,2,0,2
USA,NAM,2002.0,2,0,2
TWN,PRT,2010.0,1,0,1
ZWE,CUB,2008.0,1,0,1
SDN,MYS,2002.0,3,0,3
KEN,UGA,2003.0,1,0,1
,BLZ,2002.0,1,0,1
COD,NLD,2011.0,1,0,1
GRD,,2010.0,4,0,4
FRA,HTI,2006.0,1,0,1
GBR,GAB,2005.0,1,0,1
HKG,CYP,2011.0,1,0,1
TWN,GRC,2021.0,2,0,2
MLT,BEL,2011.0,1,0,1
PER,ITA,2018.0,5,0,5
AUT,BGD,2015.0,1,0,1
MHL,,2016.0,1,0,1
GRD,,2017.0,10,0,10
PRT,YEM,2013.0,1,0,1
JPN,TUN,2017.0,3,0,3
MEX,PAK,2005.0,3,0,3
MKD,ITA,2018.0,2,0,2
JPN,MDG,2019.0,2,0,2
ISR,GHA,2020.0,1,0,1
ZWE,DEU,2021.0,3,0,3
CRI,GTM,2018.0,1,0,1
CUB,IND,2021.0,1,0,1
ITA,LVA,2015.0,1,0,1
BRN,PAK,2015.0,1,0,1
TKM,USA,2009.0,1,0,1
SWE,QAT,2007.0,1,0,1
ITA,JOR,2005.0,3,0,3
ECU,SWE,2007.0,1,0,1
SGP,BGD,2014.0,1,0,1
MWI,ITA,2007.0,1,0,1
FRA,KWT,2011.0,1,0,1
PRT,URY,2013.0,2,0,2
NPL,NGA,2005.0,1,0,1
,GRL,2001.0,5,0,5
CHL,LVA,2021.0,1,0,1
PRT,MAR,2017.0,2,0,2
PRT,PER,2017.0,1,0,1
RWA,ZMB,2021.0,1,0,1
ESP,AND,2016.0,4,0,4
KEN,CIV,2019.0,1,0,1
FLK,,2018.0,2,0,2
SWZ,USA,2022.0,2,0,2
SAU,EST,2019.0,2,0,2
JPN,DZA,2020.0,1,0,1
ZMB,MYS,2015.0,1,0,1
BIH,LUX,2022.0,1,0,1
THA,OMN,2019.0,1,0,1
ZAF,ARE,2013.0,2,0,2
ROU,SVN,2020.0,1,0,1
,FLK,2013.0,2,0,2
NGA,ITA,2001.0,1,0,1
CHE,GUY,2008.0,1,0,1
JPN,OMN,2008.0,1,0,1
KWT,TZA,2016.0,2,0,2
NLD,URY,2002.0,1,0,1
GRD,,2019.0,15,0,15
PHL,BEL,2003.0,1,0,1
MOZ,SWE,2005.0,1,0,1
BGR,SWE,2007.0,3,0,3
CAN,HUN,1997.0,2,0,2
SVK,CHL,2001.0,1,0,1
ISR,AZE,2015.0,2,0,2
MAR,MEX,2009.0,4,0,4
MCO,MDG,2013.0,2,0,2
VEN,PAN,2019.0,2,0,2
CAN,SEN,2013.0,2,0,2
FRA,LBY,2010.0,1,0,1
NOR,MWI,2010.0,1,0,1
IRL,TCA,2015.0,1,0,1
ESP,THA,2014.0,2,0,2
IND,NER,2015.0,2,0,2
BEL,TTO,2022.0,1,0,1
BEL,NPL,2010.0,1,0,1
UGA,ITA,2016.0,2,0,2
GHA,UGA,2013.0,2,0,2
FRA,BGD,2017.0,2,0,2
MKD,EGY,2020.0,1,0,1
LAO,USA,2021.0,1,0,1
SRB,DNK,2015.0,1,0,1
MOZ,IND,2012.0,1,0,1
TWN,ESP,2021.0,3,0,3
BEL,THA,2022.0,1,0,1
BRN,GBR,1999.0,1,0,1
KGZ,ALB,2021.0,1,0,1
TUR,SDN,2021.0,3,0,3
TZA,BGD,2010.0,1,0,1
JPN,KAZ,2003.0,2,0,2
FIN,MDA,2000.0,2,0,2
GRC,AUS,2014.0,8,0,8
CAN,PRI,2013.0,1,0,1
ITA,TZA,2015.0,2,0,2
ISR,HUN,2002.0,3,0,3
KAZ,NOR,2021.0,1,0,1
KNA,,2011.0,1,0,1
CHE,PYF,2015.0,1,0,1
HKG,TUR,2010.0,1,0,1
PRT,TWN,2022.0,1,0,1
TUN,,1999.0,3,0,3
GBR,BRB,2002.0,1,0,1
KWT,BGD,2012.0,1,0,1
TWN,ROU,2010.0,1,0,1
BEL,CUB,2003.0,3,0,3
NLD,IRN,2000.0,1,0,1
KHM,,2007.0,3,0,3
SVK,SWE,2009.0,4,0,4
YEM,SAU,2012.0,2,0,2
DEU,IRQ,2002.0,1,0,1
NGA,BWA,2017.0,1,0,1
SYR,SAU,2010.0,3,0,3
GBR,DZA,2004.0,3,0,3
NOR,CHL,2008.0,2,0,2
CMR,SWE,2009.0,2,0,2
TUR,VNM,2019.0,4,0,4
TUR,VNM,2017.0,2,0,2
,SWZ,2007.0,9,0,9
ROU,POL,2022.0,1,0,1
CAN,HND,2018.0,1,0,1
BFA,IDN,2019.0,1,0,1
BEL,NPL,2019.0,3,0,3
CYP,QAT,2016.0,1,0,1
JAM,CAN,1999.0,2,0,2
,WSM,2013.0,12,0,12
ITA,GTM,2020.0,2,0,2
SWE,MEX,2006.0,3,0,3
PRY,CHE,2011.0,1,0,1
MNE,,2000.0,1,0,1
SYR,AUT,2017.0,3,0,3
GMB,AUS,2014.0,1,0,1
GHA,CMR,2021.0,3,0,3
NZL,FIN,1998.0,1,0,1
MAC,FRA,2014.0,1,0,1
AUT,JOR,2017.0,1,0,1
THA,SGP,2006.0,1,0,1
MYS,URY,2016.0,1,0,1
HRV,ISR,2003.0,1,0,1
PAN,AUS,2012.0,2,0,2
MCO,USA,2007.0,3,0,3
VNM,IDN,2014.0,1,0,1
MTQ,CAN,2016.0,1,0,1
HRV,IRN,2015.0,2,0,2
OMN,FIN,2019.0,1,0,1
AZE,FRA,2010.0,1,0,1
ROU,NGA,2014.0,1,0,1
BEN,ITA,2013.0,1,0,1
GIN,GNB,2017.0,4,0,4
ROU,CHN,2015.0,3,0,3
,PYF,2018.0,3,0,3
IND,NOR,1999.0,1,0,1
USA,BRN,2018.0,1,0,1
GRC,NZL,2019.0,1,0,1
ARM,CHL,2021.0,1,0,1
PRI,PRT,2015.0,1,0,1
ARM,COL,2015.0,1,0,1
GRC,ALB,2016.0,1,0,1
ZAF,POL,2008.0,1,0,1
ASM,USA,2004.0,1,0,1
GNB,,2013.0,1,0,1
LKA,NLD,2012.0,1,0,1
CHE,MAR,2011.0,1,0,1
TUR,BRA,2011.0,1,0,1
ITA,ETH,2004.0,1,0,1
UKR,CZE,2009.0,3,0,3
GUF,,2013.0,3,0,3
BGR,NZL,2008.0,2,0,2
MOZ,SWE,2002.0,1,0,1
BGR,MYS,2019.0,1,0,1
TZA,NGA,2006.0,1,0,1
,FRO,1996.0,1,0,1
CHL,NLD,2001.0,3,0,3
PHL,DNK,2003.0,3,0,3
MEX,NOR,2011.0,3,0,3
BLR,SVK,2001.0,1,0,1
BLR,CHE,2008.0,1,0,1
MYS,SLB,2019.0,1,0,1
RUS,ECU,2017.0,1,0,1
BFA,TGO,2015.0,1,0,1
NZL,MAC,2015.0,1,0,1
SEN,BEL,2008.0,2,0,2
SVN,PRT,2021.0,2,0,2
HUN,SVN,2013.0,1,0,1
QAT,SRB,2020.0,2,0,2
BIH,POL,2018.0,1,0,1
TUN,CHL,2012.0,1,0,1
NOR,MWI,2019.0,3,0,3
ZWE,TZA,2012.0,1,0,1
GRC,JOR,2018.0,1,0,1
ROU,MCO,2017.0,1,0,1
RWA,TZA,2022.0,1,0,1
MLT,,2006.0,3,0,3
USA,GRL,2008.0,1,0,1
NGA,CAN,2005.0,3,0,3
NGA,COL,2007.0,1,0,1
NPL,BGD,2007.0,2,0,2
DEU,BOL,2012.0,2,0,2
CAN,MWI,2013.0,1,0,1
QAT,NOR,2020.0,2,0,2
ERI,SAU,2004.0,1,0,1
TUR,ROU,2012.0,2,0,2
IDN,PER,2020.0,1,0,1
SRB,HUN,2010.0,1,0,1
EST,,2000.0,3,0,3
MCO,ESP,2016.0,1,0,1
FRA,BGD,2010.0,1,0,1
ARM,DEU,2008.0,3,0,3
SWE,GRL,2016.0,1,0,1
KWT,FIN,2008.0,2,0,2
GHA,BWA,2010.0,1,0,1
FRA,KAZ,2022.0,2,0,2
RUS,EST,2009.0,1,0,1
BHR,IRN,2016.0,1,0,1
KGZ,,2006.0,1,0,1
MAR,TUN,2002.0,1,0,1
MDA,ESP,2007.0,2,0,2
ITA,JOR,2002.0,1,0,1
,FRO,2004.0,4,0,4
FIN,CRI,2014.0,1,0,1
TTO,NLD,2008.0,1,0,1
LTU,CAN,2014.0,1,0,1
PAK,BEL,2012.0,2,0,2
ZMB,TUN,2012.0,1,0,1
JPN,MLT,2017.0,1,0,1
CYP,MLT,2020.0,1,0,1
ZMB,THA,2019.0,1,0,1
CYP,IRL,2020.0,4,0,4
SWE,ARE,2001.0,1,0,1
JPN,MMR,2009.0,3,0,3
EGY,BGD,2008.0,2,0,2
GAB,NLD,2020.0,1,0,1
NCL,MEX,2006.0,1,0,1
EGY,TWN,2008.0,1,0,1
GTM,BRA,2016.0,1,0,1
BRA,SLV,2020.0,1,0,1
LTU,KAZ,2013.0,1,0,1
NCL,GBR,2004.0,1,0,1
SAU,IND,2000.0,1,0,1
MLI,COG,2020.0,1,0,1
HND,SWE,2016.0,1,0,1
LKA,NOR,2006.0,1,0,1
BRB,ITA,2008.0,1,0,1
THA,LAO,2022.0,3,0,3
LVA,SRB,2021.0,1,0,1
USA,KWT,1998.0,2,0,2
SYR,LBN,2015.0,2,0,2
POL,KHM,2014.0,1,0,1
CZE,IDN,2020.0,3,0,3
BEL,ALB,2016.0,1,0,1
CAN,SAU,1997.0,2,0,2
PAK,OMN,2009.0,2,0,2
JPN,JOR,2003.0,1,0,1
DNK,MYS,2003.0,1,0,1
DNK,GHA,2003.0,1,0,1
BLR,CHN,2001.0,1,0,1
SDN,SAU,2003.0,2,0,2
AUS,ARE,2001.0,3,0,3
THA,FRA,1999.0,1,0,1
ARG,AUT,2007.0,2,0,2
KOR,ROU,2003.0,1,0,1
RUS,ZAF,2007.0,3,0,3
CZE,ZAF,2005.0,1,0,1
PNG,IRL,2009.0,1,0,1
NPL,SAU,2010.0,1,0,1
ARG,LUX,2020.0,1,0,1
SVN,TUR,2009.0,1,0,1
CYP,BEL,2008.0,1,0,1
BGD,PRT,2013.0,1,0,1
BDI,KEN,2015.0,1,0,1
TWN,ARG,2018.0,1,0,1
FRA,BGD,2019.0,4,0,4
KEN,MLI,2017.0,2,0,2
KEN,DNK,2022.0,1,0,1
ZWE,THA,2019.0,1,0,1
ZMB,IDN,2014.0,1,0,1
NOR,KEN,2006.0,1,0,1
TWN,PRT,2019.0,1,0,1
NOR,CUB,2004.0,1,0,1
UGA,JPN,2008.0,1,0,1
ISR,BRA,2005.0,2,0,2
NZL,MWI,2002.0,1,0,1
ISR,GEO,2011.0,1,0,1
CHN,COG,2018.0,1,0,1
PNG,MYS,2003.0,1,0,1
KEN,PAK,2005.0,1,0,1
MCO,AUS,2003.0,1,0,1
RUS,ISL,2008.0,1,0,1
TZA,MWI,2018.0,1,0,1
ABW,NLD,2007.0,1,0,1
HKG,MAR,2003.0,1,0,1
BHR,ITA,2010.0,1,0,1
ZAF,CRI,2001.0,1,0,1
KWT,JPN,2017.0,1,0,1
NPL,PRT,2009.0,1,0,1
SYR,SAU,2019.0,1,0,1
ESP,QAT,2011.0,1,0,1
MEX,CRI,2011.0,2,0,2
MEX,PRI,2000.0,1,0,1
ESP,PHL,2010.0,1,0,1
ALB,AUT,2009.0,1,0,1
TCD,FRA,2010.0,1,0,1
AUS,BHR,2020.0,2,0,2
ARE,KAZ,2015.0,1,0,1
SWE,BRA,2023.0,2,0,2
KWT,PAK,2017.0,2,0,2
FRA,TGO,2016.0,2,0,2
GUF,KHM,2002.0,2,0,2
TUR,BRN,2021.0,1,0,1
,MSR,2018.0,1,0,1
SWE,BWA,2013.0,1,0,1
LUX,SGP,2018.0,2,0,2
MKD,GBR,2010.0,1,0,1
ESP,PLW,2015.0,1,0,1
FIN,HKG,2008.0,1,0,1
ARG,EGY,2021.0,1,0,1
COL,IRN,2016.0,2,0,2
MMR,USA,2014.0,1,0,1
VUT,CHE,2018.0,1,0,1
BLR,CAN,2005.0,2,0,2
IND,ZMB,2014.0,1,0,1
SVN,IRN,2021.0,1,0,1
BEL,BIH,2013.0,1,0,1
DNK,LKA,2021.0,1,0,1
VEN,CPV,2018.0,1,0,1
COL,CHN,2008.0,2,0,2
ITA,DZA,2004.0,1,0,1
DEU,PSE,2000.0,1,0,1
SRB,NOR,2002.0,1,0,1
ARE,,2002.0,3,0,3
LBY,POL,2011.0,1,0,1
CAN,TCD,2020.0,1,0,1
LAO,NOR,2018.0,1,0,1
ECU,KOR,2018.0,1,0,1
SVN,CZE,2005.0,2,0,2
COG,JPN,2020.0,1,0,1
TCD,FRA,2017.0,1,0,1
COL,THA,2022.0,1,0,1
NGA,VNM,2016.0,1,0,1
PAK,KWT,1997.0,1,0,1
BIH,AUT,2017.0,1,0,1
LBY,IND,2004.0,1,0,1
ZWE,COL,2002.0,1,0,1
HRV,CYP,2018.0,1,0,1
VNM,DNK,2003.0,1,0,1
AUS,SVK,2002.0,1,0,1
HKG,QAT,2015.0,1,0,1
BGR,IRL,2017.0,1,0,1
DNK,CRI,2014.0,1,0,1
OMN,DNK,2011.0,1,0,1
SWE,MNG,2022.0,1,0,1
PSE,QAT,2007.0,2,0,2
CHE,GRD,2015.0,1,0,1
MLI,GIN,2007.0,1,0,1
SVK,MEX,2015.0,1,0,1
BLR,CZE,2015.0,1,0,1
BGD,BRA,2006.0,1,0,1
PNG,AUS,2022.0,1,0,1
GRC,ISR,2009.0,1,0,1
CIV,AUT,2019.0,1,0,1
CMR,LSO,2007.0,1,0,1
POL,GUY,2017.0,1,0,1
GHA,SLE,2020.0,1,0,1
NPL,ZAF,2008.0,1,0,1
CHE,GEO,2000.0,1,0,1
URY,JPN,2006.0,1,0,1
JOR,TWN,2012.0,1,0,1
CAN,SVN,2017.0,1,0,1
YEM,THA,2008.0,1,0,1
SAU,BHR,2006.0,1,0,1
SEN,CAF,2016.0,1,0,1
THA,DEU,1999.0,1,0,1
BRA,LVA,2016.0,1,0,1
MMR,PHL,2015.0,1,0,1
MYS,ZAF,2006.0,1,0,1
FRA,JOR,2022.0,1,0,1
EGY,CHL,2022.0,1,0,1
BGD,AFG,2017.0,1,0,1
SGP,PAN,2016.0,1,0,1
EGY,POL,2019.0,1,0,1
EST,KAZ,2014.0,1,0,1
ROU,VNM,2016.0,2,0,2
TTO,SWE,2013.0,1,0,1
DNK,OMN,2019.0,1,0,1
GMB,FRA,2007.0,1,0,1
IND,LSO,2007.0,1,0,1
PRT,PER,2010.0,1,0,1
IRQ,IRL,2020.0,1,0,1
JOR,POL,2013.0,1,0,1
IDN,IND,1999.0,2,0,2
UGA,SWE,2022.0,1,0,1
BEN,GBR,2014.0,1,0,1
KNA,AUS,2008.0,1,0,1
AUT,EGY,2000.0,1,0,1
GBR,GMB,2000.0,2,0,2
IND,JAM,2007.0,1,0,1
RUS,LBN,2004.0,1,0,1
AUT,QAT,2016.0,1,0,1
EGY,ARM,2009.0,1,0,1
BWA,DEU,2007.0,1,0,1
NGA,ESP,2016.0,1,0,1
NOR,BWA,2015.0,1,0,1
IRN,KAZ,2016.0,1,0,1
GRC,KOR,2022.0,1,0,1
CIV,TCD,2019.0,1,0,1
,TCA,2005.0,1,0,1
SWE,ZMB,2017.0,1,0,1
ARE,SDN,1998.0,1,0,1
BRA,PRI,2017.0,1,0,1
NGA,DNK,2022.0,1,0,1
BWA,,2025.0,1,0,1
AUT,NZL,2001.0,1,0,1
UGA,FRA,2004.0,1,0,1
TUN,THA,2004.0,1,0,1
USA,KWT,1997.0,2,0,2
BWA,CMR,2004.0,1,0,1
CHN,ZMB,2013.0,1,0,1
RUS,KGZ,2022.0,1,0,1
BEL,BGD,2002.0,1,0,1
SOM,ITA,2022.0,1,0,1
NZL,IRL,2001.0,1,0,1
GBR,SYC,2014.0,1,0,1
USA,BHS,2004.0,1,0,1
JAM,DEU,2018.0,1,0,1
COL,JAM,2011.0,1,0,1
UGA,COL,2020.0,1,0,1
NIC,JPN,2020.0,1,0,1
CHL,THA,2019.0,1,0,1
,NRU,2009.0,1,0,1
CZE,BIH,2011.0,1,0,1
NGA,VEN,2010.0,1,0,1
SDN,USA,2009.0,1,0,1
CMR,IND,2018.0,1,0,1
BEL,DEU,2014.0,81,94,-13
CAN,AUS,2009.0,159,125,34
CAN,GBR,2002.0,220,230,-10
BRA,USA,2011.0,304,340,-36
USA,AUS,2012.0,587,475,112
JPN,USA,2009.0,1008,942,66
CAN,EGY,1999.0,4,3,1
KEN,DEU,2004.0,4,6,-2
ESP,DEU,2008.0,110,139,-29
DNK,PRT,2019.0,7,10,-3
DEU,CHN,2003.0,70,126,-56
NZL,USA,2011.0,99,123,-24
CHE,CAN,2011.0,75,78,-3
CHN,HKG,2005.0,169,196,-27
FRA,CHE,2018.0,343,237,106
BRA,COL,2011.0,19,18,1
USA,THA,2015.0,218,96,122
CAN,GBR,2005.0,212,300,-88
EGY,SAU,2020.0,251,172,79
DEU,CHE,2013.0,593,420,173
MEX,USA,2008.0,123,144,-21
USA,GBR,2014.0,1602,1575,27
DEU,EGY,2013.0,55,31,24
IND,JPN,2012.0,67,70,-3
GBR,IND,2003.0,73,71,2
TWN,USA,2013.0,265,298,-33
RUS,HKG,2016.0,2,4,-2
USA,TUR,2014.0,273,180,93
SGP,IND,2018.0,71,113,-42
USA,TWN,2001.0,172,106,66
HKG,USA,2009.0,114,127,-13
USA,ARG,2013.0,95,87,8
DEU,CAN,2006.0,142,89,53
CHN,SWE,2011.0,67,42,25
USA,BRA,2013.0,299,363,-64
AUT,DEU,2007.0,175,288,-113
CHL,USA,2009.0,74,71,3
COD,COG,2007.0,6,5,1
FRA,CHL,2016.0,47,32,15
GBR,ITA,2015.0,296,527,-231
GBR,DEU,2013.0,551,543,8
ISR,CAN,2012.0,59,48,11
AUT,USA,2015.0,121,132,-11
BRA,ESP,2012.0,49,61,-12
AUS,DEU,2007.0,81,127,-46
SAU,USA,2011.0,22,114,-92
ZMB,USA,2014.0,12,15,-3
SGP,CHN,2018.0,374,262,112
CHL,FRA,2008.0,25,13,12
LUX,FRA,2015.0,20,27,-7
GBR,FRA,2011.0,411,356,55
JPN,GBR,2009.0,114,108,6
NLD,SVK,2009.0,4,4,0
DEU,TWN,2015.0,13,19,-6
HUN,ROU,2010.0,15,4,11
SWE,GBR,2006.0,109,64,45
JPN,TWN,2009.0,56,16,40
BEL,NLD,2022.0,83,70,13
GRC,CAN,2008.0,10,8,2
DEU,ITA,2012.0,154,256,-102
CUB,USA,2014.0,8,8,0
ITA,SWE,2013.0,57,20,37
NPL,JPN,2011.0,3,8,-5
TUR,USA,2003.0,115,204,-89
GBR,ETH,2019.0,7,4,3
NGA,CHN,2010.0,3,8,-5
DNK,DEU,2021.0,90,96,-6
PRT,BRA,2015.0,118,84,34
MYS,IDN,2019.0,77,19,58
EGY,QAT,2014.0,10,7,3
MAR,BEL,2008.0,2,3,-1
NLD,THA,2012.0,9,3,6
NLD,IDN,2012.0,12,4,8
NLD,GBR,2017.0,328,247,81
MYS,VNM,2020.0,16,6,10
SWE,CHE,2020.0,44,58,-14
AUS,USA,2021.0,417,387,30
IND,FIN,2012.0,16,1,15
ZWE,ZAF,2017.0,23,23,0
IND,SVN,2019.0,5,2,3
ITA,AUT,2021.0,48,36,12
DEU,BRA,2004.0,38,36,2
NLD,GBR,2019.0,316,328,-12
IND,GBR,2016.0,165,158,7
POL,SVK,2022.0,2,1,1
CHN,SGP,2012.0,205,183,22
DEU,ISR,2021.0,52,58,-6
CHN,DNK,2021.0,59,65,-6
DEU,JPN,2010.0,93,105,-12
SAU,EGY,2018.0,183,175,8
DEU,JPN,2017.0,120,102,18
USA,UGA,2016.0,26,34,-8
FRA,MAR,2021.0,49,39,10
SGP,AUS,2009.0,53,52,1
FRA,LBN,2016.0,92,34,58
CZE,DNK,2020.0,3,7,-4
OMN,EGY,2022.0,3,3,0
DEU,JPN,2019.0,134,110,24
MYS,IDN,2010.0,13,2,11
BEL,VNM,2018.0,13,2,11
ZWE,ZAF,2019.0,25,35,-10
AUS,BEL,2016.0,25,43,-18
NLD,COL,2018.0,5,11,-6
DEU,MYS,2018.0,9,13,-4
DEU,SWE,2016.0,180,126,54
NGA,CHN,2019.0,34,23,11
CHN,MAC,2018.0,67,84,-17
IRN,DEU,2016.0,97,31,66
DEU,UKR,2015.0,9,30,-21
BRA,MEX,2016.0,21,20,1
MYS,DEU,2018.0,13,9,4
ECU,ESP,2015.0,8,42,-34
AUT,VNM,2017.0,3,3,0
MKD,USA,2016.0,5,2,3
ZAF,ETH,2019.0,15,7,8
ESP,ITA,2018.0,178,204,-26
DNK,ITA,2010.0,11,28,-17
TUR,FRA,2016.0,16,19,-3
FRA,ROU,2013.0,31,34,-3
BRA,GBR,2021.0,103,53,50
GBR,ECU,2020.0,5,2,3
ECU,USA,2021.0,23,16,7
UKR,CAN,2016.0,6,2,4
BWA,GBR,2017.0,2,5,-3
GRC,DEU,2021.0,43,39,4
NGA,ZAF,2020.0,66,93,-27
SGP,FIN,2019.0,5,1,4
MYS,IDN,2017.0,96,13,83
ZAF,ETH,2017.0,11,7,4
TUR,SWE,2012.0,13,6,7
KOR,FRA,2020.0,32,34,-2
AUS,SAU,2020.0,65,36,29
IRL,MYS,2012.0,8,3,5
ITA,CHN,2013.0,36,21,15
USA,COL,2010.0,54,60,-6
LBN,FRA,2018.0,37,112,-75
NOR,ETH,2018.0,9,5,4
DNK,ITA,2019.0,25,53,-28
ESP,CAN,2018.0,69,64,5
TWN,CZE,2013.0,2,1,1
MEX,DEU,2007.0,19,25,-6
USA,COL,2019.0,81,122,-41
USA,COL,2017.0,99,93,6
KOR,AUS,2020.0,48,28,20
BRA,NOR,2020.0,18,5,13
DZA,IRL,2020.0,2,1,1
GBR,MLT,2021.0,7,5,2
LBN,CHE,2014.0,3,2,1
POL,KAZ,2020.0,2,2,0
ZAF,MAR,2021.0,5,1,4
LBN,CAN,2008.0,8,4,4
CZE,VNM,2020.0,7,4,3
IDN,TWN,2021.0,32,32,0
COL,CHL,2016.0,18,21,-3
USA,PER,2009.0,33,30,3
KEN,BEL,2015.0,22,4,18
GHA,MYS,2020.0,1,4,-3
THA,VNM,2021.0,21,4,17
NGA,CHN,2017.0,17,8,9
ETH,UGA,2021.0,1,2,-1
SEN,FRA,2020.0,23,28,-5
CHN,JPN,2012.0,280,453,-173
ITA,SGP,2018.0,14,2,12
MEX,ITA,2015.0,15,12,3
AUS,ESP,2021.0,37,28,9
ITA,DEU,1999.0,62,63,-1
AUS,IRL,2019.0,47,45,2
ESP,FIN,2009.0,9,9,0
LTU,FIN,2013.0,2,3,-1
ESP,MAR,2014.0,21,8,13
FRA,ARG,2016.0,30,34,-4
RUS,BEL,2010.0,9,2,7
CHL,GBR,2012.0,19,24,-5
SVK,CZE,2013.0,64,39,25
SAU,JOR,2020.0,20,26,-6
ITA,BEL,2003.0,51,26,25
PRT,DEU,2014.0,60,23,37
PER,GBR,2004.0,2,1,1
CHE,NOR,2008.0,8,7,1
CZE,USA,2012.0,40,40,0
GBR,ARE,2012.0,22,11,11
GBR,NGA,2003.0,19,12,7
GRC,ESP,2018.0,17,14,3
FIN,SWE,2012.0,48,42,6
NLD,HRV,2018.0,4,5,-1
KEN,NLD,2012.0,4,6,-2
BRA,FIN,2013.0,3,4,-1
GRC,FRA,2015.0,45,31,14
LKA,GBR,2011.0,4,10,-6
NZL,MYS,2015.0,25,25,0
URY,USA,2016.0,12,9,3
UGA,GBR,2013.0,11,1,10
HKG,AUS,2013.0,56,27,29
FIN,USA,2004.0,72,70,2
USA,EGY,2007.0,85,46,39
DEU,SVK,2020.0,8,7,1
JPN,SVN,2016.0,1,2,-1
AUS,IRL,2010.0,31,43,-12
VNM,KOR,2013.0,16,40,-24
IRQ,MYS,2018.0,9,164,-155
IRL,DEU,1998.0,2,3,-1
USA,BGR,2001.0,5,23,-18
FRA,BEN,2014.0,19,6,13
RUS,KOR,2010.0,9,13,-4
SWE,NLD,1998.0,6,6,0
USA,IDN,2002.0,10,13,-3
IRL,ARE,2018.0,10,2,8
NLD,GBR,2010.0,185,187,-2
USA,BHS,2015.0,3,2,1
BRA,BEL,2014.0,20,14,6
ARE,JOR,2016.0,5,8,-3
IND,CZE,2014.0,19,6,13
IND,ISR,2004.0,11,10,1
USA,DNK,1997.0,21,24,-3
CMR,CAF,2017.0,1,1,0
MYS,NZL,2012.0,9,13,-4
EGY,USA,2020.0,105,122,-17
JPN,IND,2012.0,70,67,3
VNM,USA,2016.0,20,29,-9
USA,MMR,2019.0,4,6,-2
BRA,PRT,2001.0,16,9,7
TUR,IRN,2013.0,7,18,-11
POL,CAN,2021.0,10,7,3
BRA,CHN,2018.0,13,4,9
ETH,NLD,2017.0,7,6,1
PAK,GBR,2002.0,10,13,-3
DEU,LUX,2021.0,26,15,11
IRL,BHR,2016.0,4,2,2
MWI,USA,1997.0,1,3,-2
URY,ARG,2003.0,1,2,-1
SWE,GHA,2021.0,2,3,-1
ISR,ITA,2022.0,6,4,2
EGY,ARE,2017.0,12,9,3
DEU,PRT,2002.0,16,6,10
CZE,GBR,2001.0,19,18,1
SGP,BEL,2011.0,8,6,2
CHN,GBR,2000.0,41,15,26
LBY,EGY,2021.0,1,4,-3
KEN,RWA,2018.0,7,3,4
DEU,CHL,2009.0,26,26,0
CMR,KEN,2012.0,3,1,2
RUS,AUS,2010.0,9,1,8
SWE,GRC,2019.0,14,33,-19
GUM,USA,2010.0,4,1,3
ZWE,ZAF,2010.0,18,4,14
NOR,FRA,2010.0,14,28,-14
GBR,IRN,2006.0,55,11,44
AUT,CHE,2006.0,32,33,-1
ARG,GBR,2007.0,6,12,-6
JPN,KEN,2007.0,7,1,6
DEU,ZAF,2000.0,5,2,3
SWE,TUN,2010.0,1,1,0
FRA,SWE,2003.0,45,40,5
SWE,KEN,2006.0,1,1,0
POL,RUS,1999.0,7,11,-4
MEX,NLD,2007.0,2,5,-3
USA,IDN,2005.0,14,7,7
NOR,GBR,2002.0,38,46,-8
USA,LBN,2008.0,28,50,-22
ESP,ZAF,2014.0,7,2,5
GBR,MWI,2004.0,8,2,6
ESP,CUB,2008.0,19,28,-9
DEU,LTU,2011.0,4,8,-4
ZAF,BEL,2022.0,2,3,-1
ZAF,CHN,2007.0,3,6,-3
NER,FRA,2011.0,5,2,3
FRA,GEO,2016.0,18,13,5
IRN,GBR,2002.0,8,35,-27
CAN,NOR,2002.0,9,9,0
FIN,AUS,1999.0,2,2,0
MAR,CAN,2008.0,3,2,1
CZE,AUS,2014.0,5,12,-7
GBR,SWE,2003.0,91,87,4
USA,KEN,1998.0,2,4,-2
RUS,AUS,2019.0,11,8,3
NLD,ESP,2013.0,54,83,-29
LTU,SWE,2002.0,5,2,3
GBR,POL,2004.0,17,22,-5
GBR,HKG,2003.0,35,24,11
NLD,EGY,2008.0,4,1,3
CHE,RUS,2000.0,6,6,0
CAN,ARE,2013.0,33,10,23
RUS,NLD,2009.0,13,7,6
CHE,SGP,2013.0,19,13,6
TWN,RUS,2002.0,6,5,1
USA,RWA,2020.0,12,10,2
CAN,AUT,2009.0,13,22,-9
TWN,RUS,2005.0,2,1,1
PRT,ESP,2011.0,53,70,-17
FRA,RUS,2003.0,41,48,-7
RUS,CHN,2009.0,10,15,-5
HUN,CAN,2008.0,4,9,-5
CHN,AUT,2000.0,8,1,7
USA,IRN,1998.0,3,3,0
DEU,PRT,2005.0,15,14,1
USA,BLR,2013.0,4,2,2
MOZ,USA,2016.0,4,4,0
BRA,IND,2004.0,2,7,-5
CHE,ROU,2011.0,2,3,-1
MDA,RUS,2020.0,3,4,-1
NLD,IRL,2003.0,9,8,1
LTU,SWE,2005.0,3,4,-1
ARM,RUS,2002.0,3,3,0
FIN,CAN,2003.0,15,12,3
LTU,GBR,2022.0,4,2,2
SWE,POL,1997.0,1,3,-2
SWE,ITA,2004.0,12,18,-6
THA,NZL,2018.0,3,6,-3
GRC,GBR,1998.0,14,16,-2
ITA,ARG,2012.0,17,9,8
AUS,AUT,1999.0,11,3,8
USA,DNK,1998.0,34,27,7
ISL,USA,2010.0,7,16,-9
MCO,FRA,2001.0,1,7,-6
PRT,NLD,2006.0,9,9,0
SWE,POL,1998.0,3,2,1
GUM,USA,2019.0,4,9,-5
PHL,VNM,2008.0,1,1,0
ISL,USA,2017.0,6,15,-9
EGY,ESP,2001.0,2,1,1
TWN,GBR,2006.0,15,39,-24
ROU,USA,1999.0,8,3,5
MEX,VEN,2002.0,2,5,-3
GRC,GBR,1997.0,3,5,-2
JPN,BRA,2001.0,6,8,-2
SVK,DEU,2000.0,14,7,7
GBR,SDN,2021.0,1,3,-2
MOZ,GBR,2016.0,2,1,1
SVN,USA,2002.0,8,11,-3
CHN,CHE,2005.0,14,12,2
BOL,CHL,2014.0,3,1,2
TWN,JPN,2001.0,4,12,-8
HKG,GBR,2000.0,12,7,5
ESP,PRT,2000.0,7,10,-3
KOR,ITA,2005.0,6,1,5
TWN,IND,2002.0,11,26,-15
KWT,GBR,2018.0,4,12,-8
HUN,CHE,2010.0,9,13,-4
DEU,VNM,2013.0,12,9,3
MEX,PER,2013.0,1,3,-2
CZE,PRT,2015.0,2,8,-6
ITA,ZAF,2014.0,11,3,8
DNK,POL,2000.0,3,1,2
USA,QAT,2012.0,30,20,10
CHE,GRC,2001.0,6,4,2
MEX,AUS,2012.0,14,11,3
DEU,IRL,2012.0,22,47,-25
USA,MMR,2017.0,3,1,2
IRN,AUT,2012.0,4,4,0
ITA,NOR,2020.0,27,16,11
ROU,DEU,2009.0,15,33,-18
GBR,ETH,2010.0,6,1,5
NZL,CHE,2005.0,8,5,3
USA,CUB,2013.0,5,8,-3
ESP,BRA,2003.0,28,24,4
BRA,IRN,2015.0,2,10,-8
GBR,ETH,2017.0,8,2,6
MEX,COL,2011.0,18,19,-1
DEU,BIH,2018.0,4,7,-3
HKG,NLD,2009.0,4,1,3
JPN,PHL,2007.0,5,9,-4
ISR,JPN,2017.0,10,4,6
HKG,FIN,2006.0,2,2,0
PAN,USA,2009.0,7,12,-5
CHE,TWN,2022.0,3,4,-1
COL,ITA,2013.0,1,5,-4
ARG,CAN,2014.0,14,13,1
ZAF,FIN,2018.0,4,3,1
ITA,SVN,2015.0,8,3,5
BLR,USA,2004.0,11,10,1
ESP,BGR,2018.0,3,1,2
ESP,DZA,2020.0,11,3,8
TWN,MYS,2016.0,9,5,4
EGY,ARE,2019.0,15,4,11
HUN,ROU,2017.0,6,14,-8
GHA,NGA,2017.0,3,6,-3
ESP,BOL,2017.0,5,1,4
ESP,AUS,2008.0,11,11,0
CUB,ITA,2015.0,5,1,4
POL,JPN,2016.0,12,18,-6
HUN,CHE,2017.0,16,6,10
BGD,MYS,2014.0,25,25,0
UGA,ISL,2020.0,1,1,0
IRN,SWE,2005.0,1,1,0
COL,CAN,2015.0,14,17,-3
GBR,BGD,2018.0,23,22,1
LUX,DEU,2018.0,24,35,-11
ESP,IRN,2020.0,16,33,-17
GBR,BHR,2020.0,5,4,1
AUS,TWN,2020.0,14,22,-8
IND,NZL,2014.0,10,10,0
SWE,GRC,2017.0,6,38,-32
SEN,USA,2018.0,9,3,6
AUT,PRT,2020.0,7,11,-4
JPN,MNG,2020.0,8,5,3
ARE,DNK,2019.0,6,3,3
BRA,SGP,2017.0,4,3,1
GTM,USA,2018.0,3,13,-10
USA,CZE,2020.0,44,43,1
FRA,KEN,2016.0,7,4,3
PRI,CHN,2005.0,2,1,1
ISL,USA,2019.0,9,16,-7
HKG,NGA,2022.0,1,3,-2
KOR,IRN,2016.0,8,17,-9
NZL,CHE,2002.0,3,6,-3
BGD,IRL,2021.0,1,2,-1
RUS,LUX,2016.0,1,1,0
MEX,ZAF,2010.0,1,1,0
RWA,CAN,2020.0,1,2,-1
SVN,USA,2005.0,8,12,-4
HRV,AUT,2007.0,3,3,0
EGY,DEU,2006.0,14,34,-20
CHE,POL,2013.0,16,29,-13
CAN,ARG,2007.0,10,12,-2
JPN,HKG,2001.0,6,9,-3
KEN,PHL,2020.0,1,1,0
ISR,ESP,2016.0,9,11,-2
DNK,ITA,2017.0,24,42,-18
TWN,IND,2005.0,9,34,-25
UKR,NLD,2005.0,3,1,2
CAN,GHA,2016.0,5,3,2
ITA,ROU,2016.0,12,7,5
LTU,USA,2022.0,4,6,-2
RUS,KOR,2017.0,6,9,-3
VNM,THA,2013.0,2,5,-3
AUT,CHN,2022.0,15,6,9
MLT,DEU,2018.0,1,3,-2
BEL,POL,2002.0,8,8,0
ETH,NLD,2019.0,7,13,-6
EGY,ARE,2010.0,13,9,4
KGZ,TUR,2021.0,2,3,-1
DZA,CAN,2016.0,4,8,-4
DEU,ECU,2019.0,7,8,-1
MYS,DNK,2016.0,6,4,2
PHL,SGP,2010.0,1,5,-4
EGY,CZE,2012.0,2,3,-1
HKG,MAC,2011.0,10,3,7
AUT,POL,2016.0,2,13,-11
CHN,CHE,2002.0,12,10,2
ROU,GBR,2014.0,20,11,9
CZE,JPN,2018.0,9,11,-2
TWN,CHE,2011.0,3,6,-3
ISL,SWE,2012.0,11,9,2
USA,COG,2020.0,8,6,2
GHA,JPN,2020.0,2,8,-6
BRA,CHE,2016.0,23,15,8
ROU,ITA,2009.0,8,18,-10
CHN,POL,2016.0,3,12,-9
SRB,ITA,2020.0,6,2,4
CHL,VEN,2016.0,2,15,-13
IDN,ITA,2015.0,1,1,0
BGD,JPN,2009.0,35,51,-16
CHE,ARM,2003.0,1,1,0
DNK,IND,2002.0,2,4,-2
SYR,FRA,2016.0,3,8,-5
ESP,JPN,2012.0,12,8,4
FRA,MCO,2014.0,12,6,6
USA,HTI,2018.0,4,5,-1
SWE,ESP,2012.0,22,37,-15
RUS,GEO,2006.0,4,6,-2
FRA,PRI,2016.0,2,1,1
USA,ETH,2015.0,22,21,1
CAN,GRC,2003.0,13,3,10
SWE,GRC,2010.0,5,8,-3
USA,FSM,2017.0,1,1,0
EGY,YEM,2002.0,3,1,2
GBR,ZWE,2006.0,2,10,-8
PAK,FRA,2022.0,5,7,-2
NLD,KEN,2004.0,4,6,-2
POL,EGY,2021.0,3,4,-1
FIN,CHE,1998.0,2,3,-1
ESP,BEL,1999.0,6,11,-5
ARE,CAN,2006.0,5,9,-4
CAN,MEX,1997.0,2,3,-1
RUS,KOR,2019.0,6,10,-4
ZAF,ESP,2022.0,4,1,3
JPN,VNM,2003.0,10,5,5
OMN,USA,2010.0,2,6,-4
CHN,ISR,2002.0,8,6,2
BRA,VEN,2014.0,1,9,-8
FRA,HKG,2022.0,3,3,0
PRT,JPN,2003.0,3,6,-3
AUS,PNG,2003.0,6,3,3
HRV,RUS,2003.0,1,1,0
OMN,USA,2019.0,8,4,4
NOR,CZE,2013.0,7,3,4
ESP,NOR,2005.0,5,6,-1
RUS,SVK,2010.0,4,2,2
GUM,USA,2017.0,4,3,1
GBR,BWA,2006.0,5,3,2
RUS,ZAF,2008.0,1,2,-1
PAK,GBR,2005.0,12,18,-6
MEX,ISR,2004.0,1,1,0
SDN,DEU,2005.0,3,1,2
CHN,ISR,2005.0,2,5,-3
GEO,DEU,2006.0,6,1,5
ISR,JPN,2019.0,6,5,1
SGP,THA,2015.0,5,5,0
BRA,PRY,2008.0,1,3,-2
DEU,LIE,2013.0,2,1,1
BRB,JAM,2015.0,1,3,-2
BGR,FRA,2008.0,4,9,-5
SWE,ARG,2011.0,3,1,2
DNK,IND,2005.0,5,5,0
RUS,BEL,2017.0,3,5,-2
ARG,ITA,2014.0,13,13,0
ZAF,RWA,2011.0,2,1,1
NOR,KOR,2015.0,1,4,-3
CHE,KOR,2018.0,7,11,-4
SVN,GBR,2011.0,4,3,1
KOR,THA,2014.0,5,4,1
LVA,ESP,2011.0,2,1,1
CAN,NOR,2005.0,3,11,-8
USA,BOL,2015.0,6,2,4
NPL,AUS,2013.0,8,1,7
MNG,USA,2012.0,2,1,1
IRL,SVK,2006.0,1,1,0
TWN,VNM,2012.0,6,1,5
PRI,COL,2015.0,5,2,3
SWE,CZE,2016.0,7,7,0
VNM,DEU,2013.0,9,12,-3
SVK,USA,2021.0,4,1,3
BRA,ZAF,2018.0,8,4,4
FRA,MLI,2005.0,5,1,4
PRI,DEU,2003.0,1,1,0
HUN,FIN,2004.0,4,2,2
JOR,OMN,2006.0,1,1,0
USA,DZA,2001.0,2,1,1
CAN,LKA,2019.0,5,2,3
KWT,USA,2016.0,7,25,-18
ETH,IRN,2021.0,2,4,-2
QAT,KOR,2016.0,1,5,-4
BGR,CHE,2018.0,1,3,-2
CRI,FRA,2020.0,4,4,0
PYF,USA,2009.0,1,2,-1
IND,KEN,2005.0,4,1,3
BEL,POL,2005.0,9,5,4
DNK,RUS,2009.0,2,2,0
ISR,JPN,2010.0,4,1,3
SAU,CAN,2006.0,17,27,-10
CUB,ESP,2003.0,24,12,12
BEL,CZE,2020.0,10,5,5
USA,HRV,2011.0,10,26,-16
USA,MWI,2009.0,12,7,5
RUS,BEL,2019.0,11,9,2
CHE,TZA,2018.0,4,10,-6
DEU,ECU,2017.0,5,4,1
DNK,BEL,2002.0,7,6,1
SYR,CAN,2011.0,1,2,-1
KAZ,CHN,2019.0,5,3,2
JOR,ITA,2008.0,1,1,0
FRA,MLI,2002.0,1,3,-2
ISR,GRC,2013.0,2,2,0
SVK,GBR,2019.0,6,3,3
PER,VEN,2015.0,1,1,0
SWE,HKG,2008.0,1,1,0
CHN,TWN,2001.0,29,19,10
KOR,ZAF,2018.0,3,1,2
TUR,CYP,2014.0,26,16,10
EGY,KWT,2015.0,9,13,-4
CHE,UKR,2007.0,1,1,0
RUS,SAU,2022.0,1,1,0
PSE,BEL,2015.0,2,3,-1
SAU,POL,2013.0,4,4,0
KOR,PHL,2016.0,11,8,3
IRQ,GBR,2020.0,8,106,-98
BRA,SGP,2019.0,1,1,0
ITA,ETH,2015.0,4,1,3
LBN,ARE,2020.0,6,1,5
BWA,AUS,2020.0,2,1,1
NZL,CAN,2022.0,7,9,-2
RWA,KEN,2021.0,2,3,-1
HKG,IND,2008.0,2,5,-3
JPN,HUN,2011.0,4,3,1
MYS,QAT,2016.0,9,1,8
USA,SEN,2012.0,3,2,1
USA,SRB,2016.0,10,14,-4
CHL,PER,2016.0,10,2,8
LTU,POL,2018.0,1,1,0
NPL,NLD,2021.0,1,1,0
LTU,DEU,2008.0,8,8,0
ARM,RUS,2005.0,2,2,0
KWT,JOR,2020.0,2,2,0
COG,BEL,2007.0,1,2,-1
ESP,SRB,2001.0,1,1,0
CUB,COL,2020.0,3,2,1
LKA,AUS,2008.0,6,5,1
IND,PRI,2008.0,3,4,-1
DNK,BEL,2005.0,3,4,-1
JPN,EGY,1998.0,2,3,-1
RUS,BGR,2003.0,8,5,3
SWE,ZAF,2021.0,4,8,-4
CHE,COG,2005.0,1,1,0
NZL,SGP,2000.0,6,5,1
CHE,LVA,2002.0,2,1,1
JPN,POL,2003.0,10,3,7
MEX,ARG,1999.0,2,3,-1
VEN,ARG,2003.0,1,1,0
DNK,NOR,1999.0,5,15,-10
CAN,IRL,2004.0,6,18,-12
ZAF,RUS,2015.0,1,2,-1
USA,ECU,2011.0,8,10,-2
RUS,NOR,2011.0,5,5,0
JPN,LKA,2006.0,5,1,4
DEU,NGA,2013.0,2,1,1
IND,NPL,2014.0,11,20,-9
SRB,SVN,2021.0,4,1,3
COL,SWE,2011.0,2,2,0
DNK,PRT,2017.0,10,11,-1
BRA,ISR,2015.0,4,2,2
RWA,NLD,2014.0,2,2,0
SGP,PHL,2020.0,1,2,-1
ETH,DEU,2007.0,8,4,4
DEU,ISL,2021.0,2,2,0
AUT,ZAF,2012.0,2,1,1
HUN,PRT,2014.0,2,2,0
AUT,VNM,2019.0,5,1,4
KOR,TWN,2018.0,7,20,-13
RUS,CAN,2021.0,10,13,-3
BEN,FRA,2017.0,8,12,-4
CMR,BRA,2015.0,2,2,0
PRT,CZE,2020.0,6,6,0
EST,FIN,2008.0,8,10,-2
ITA,ISR,2007.0,7,4,3
BEL,HUN,2004.0,5,5,0
ESP,NOR,2002.0,5,6,-1
POL,NLD,2008.0,16,13,3
KOR,IND,1999.0,3,7,-4
CAN,MEX,1998.0,3,3,0
KGZ,JPN,2016.0,1,1,0
JPN,EGY,1997.0,1,1,0
PAK,IRL,2018.0,6,9,-3
CZE,EGY,2022.0,1,1,0
IDN,AUS,2006.0,3,13,-10
UKR,ITA,1998.0,4,1,3
SVK,FRA,2008.0,4,5,-1
JPN,FIN,2016.0,11,13,-2
ITA,SRB,2014.0,5,5,0
CHL,ZAF,2013.0,1,1,0
DEU,SAU,2000.0,2,3,-1
TZA,DEU,2014.0,3,6,-3
SRB,JPN,2005.0,1,1,0
THA,NLD,2004.0,3,8,-5
CHE,ARG,1999.0,1,1,0
IRL,BRA,2014.0,5,6,-1
THA,KHM,2011.0,1,1,0
ITA,IRL,2001.0,5,5,0
TTO,BRB,2016.0,1,1,0
NZL,PRT,2011.0,2,3,-1
MEX,JPN,2011.0,3,2,1
NZL,NOR,2011.0,3,2,1
SGP,FIN,2017.0,1,7,-6
PAK,CHE,2019.0,4,5,-1
ESP,NZL,2016.0,4,3,1
ITA,COL,2020.0,4,12,-8
ZAF,COL,2013.0,1,1,0
FRA,FJI,2019.0,1,1,0
COL,BEL,2016.0,5,6,-1
CZE,THA,2019.0,2,1,1
AUS,IND,1998.0,3,3,0
NLD,MWI,2015.0,1,1,0
VNM,ROU,2020.0,1,1,0
LSO,USA,2020.0,2,1,1
FRA,ETH,2020.0,3,2,1
ISR,SWE,2001.0,2,2,0
FIN,RUS,2012.0,8,20,-12
GBR,DZA,2015.0,3,1,2
CHN,NAM,2019.0,1,1,0
GBR,LKA,2000.0,1,1,0
MAR,ITA,2006.0,1,3,-2
LBN,DEU,2008.0,2,1,1
ISR,CYP,2014.0,1,1,0
MEX,CHN,2018.0,5,1,4
GMB,GBR,1997.0,1,1,0
ZAF,MYS,2013.0,1,2,-1
BWA,GBR,2019.0,2,6,-4
BGR,TUR,2017.0,3,1,2
COD,IND,2022.0,3,1,2
FRA,GAB,1998.0,3,1,2
UKR,ISR,2005.0,1,2,-1
HUN,AUS,2020.0,2,8,-6
DNK,ROU,2018.0,1,2,-1
JOR,LBN,2020.0,1,3,-2
GBR,JAM,2011.0,3,1,2
BLR,POL,2000.0,1,1,0
CHL,SWE,2021.0,5,1,4
ARE,NOR,2018.0,2,2,0
GBR,SVN,2020.0,8,7,1
EGY,YEM,2005.0,1,1,0
NOR,CAN,2000.0,2,1,1
PRI,GBR,2011.0,2,1,1
URY,CAN,2007.0,1,1,0
IRL,DEU,1997.0,1,5,-4
BGD,THA,2005.0,2,1,1
USA,HND,2005.0,1,2,-1
SAU,OMN,2016.0,3,8,-5
USA,ARM,2015.0,3,6,-3
SRB,JPN,2002.0,1,2,-1
CAN,ISR,1999.0,10,7,3
YEM,USA,2006.0,1,1,0
SWE,UKR,2012.0,2,10,-8
SWE,NLD,1997.0,1,2,-1
USA,IRN,1997.0,2,1,1
CHN,PRT,2007.0,6,1,5
MEX,SWE,2004.0,3,4,-1
BFA,DEU,2015.0,1,4,-3
USA,MNG,2015.0,4,4,0
TGO,BFA,2014.0,3,1,2
ETH,JPN,2011.0,1,1,0
TUR,TWN,2022.0,1,1,0
TUR,JOR,2020.0,4,1,3
ISR,FIN,2002.0,3,1,2
ISR,HKG,2016.0,2,2,0
ZMB,TZA,2010.0,1,1,0
ARG,PRT,2017.0,1,3,-2
UKR,BLR,2011.0,2,2,0
BEL,SGP,2008.0,1,3,-2
ITA,BGR,2020.0,2,2,0
CAN,IRN,1997.0,3,1,2
POL,LTU,2011.0,1,1,0
EGY,IRN,2022.0,3,1,2
ALB,ITA,2013.0,3,3,0
ITA,UKR,2013.0,3,5,-2
UGA,USA,2022.0,6,5,1
NZL,LKA,2016.0,6,3,3
IDN,PRT,2020.0,1,1,0
CAN,LKA,2017.0,4,6,-2
FIN,THA,2013.0,2,2,0
FJI,NZL,2015.0,2,2,0
RUS,GRC,2012.0,1,1,0
BRA,IRL,2013.0,7,3,4
DNK,BRA,2012.0,1,7,-6
IRQ,CHN,2018.0,2,20,-18
SAU,SGP,2020.0,2,10,-8
ISL,CAN,2014.0,1,3,-2
GHA,NGA,2019.0,1,6,-5
ESP,BOL,2019.0,1,2,-1
RUS,TUR,1998.0,1,1,0
CAN,VNM,2018.0,5,5,0
NZL,ZAF,2008.0,3,7,-4
SAU,KEN,2012.0,1,1,0
BFA,FRA,1999.0,2,2,0
ESP,DNK,1997.0,4,1,3
MAC,SGP,2021.0,1,5,-4
UGA,IND,2021.0,1,1,0
PER,SWE,2014.0,1,1,0
ZMB,ZWE,2009.0,1,1,0
ARE,CHE,2018.0,1,3,-2
BEN,NGA,2006.0,1,1,0
TUR,BGD,2022.0,1,4,-3
CHE,ETH,2014.0,3,2,1
BEL,IRN,2003.0,1,1,0
GBR,COG,2009.0,1,1,0
JPN,NOR,2007.0,3,2,1
NOR,NLD,1999.0,4,6,-2
GBR,LBY,2001.0,1,1,0
UKR,SWE,1998.0,5,2,3
IRL,RUS,2009.0,1,3,-2
KOR,KEN,2018.0,1,1,0
BWA,GBR,2010.0,2,2,0
AUS,JOR,2008.0,2,1,1
ISR,UKR,2011.0,1,2,-1
JAM,USA,2007.0,1,3,-2
BMU,USA,2015.0,3,1,2
FRA,ECU,2009.0,2,1,1
UGA,CHE,2018.0,2,2,0
HRV,MKD,2018.0,1,1,0
EGY,BHR,2022.0,1,1,0
PHL,CZE,2022.0,1,1,0
GRC,CZE,2007.0,1,3,-2
CAN,NGA,2002.0,2,1,1
SGP,HUN,2005.0,1,1,0
FIN,CHE,1997.0,2,1,1
RUS,HUN,2015.0,1,1,0
UZB,ITA,2013.0,2,1,1
ARE,PRT,2016.0,1,1,0
IND,KWT,2000.0,1,3,-2
CAN,MLT,2006.0,1,1,0
FIN,ZAF,2011.0,1,1,0
POL,FIN,2001.0,4,1,3
AUT,BGR,2012.0,1,3,-2
KOR,ESP,2012.0,4,2,2
NAM,IND,2014.0,1,2,-1
FRA,ISL,2015.0,1,3,-2
THA,LKA,2012.0,1,2,-1
ETH,NLD,2010.0,3,3,0
BEL,ARE,2018.0,1,4,-3
ITA,BIH,2013.0,2,1,1
PHL,CHE,2021.0,1,4,-3
UGA,FRA,2015.0,1,1,0
AUT,COL,2014.0,2,1,1
ZMB,NLD,2019.0,1,2,-1
CAN,UKR,2020.0,3,3,0
MLI,GBR,2009.0,1,1,0
IRN,HUN,2011.0,1,1,0
BGR,SRB,2018.0,1,1,0
ARE,IRN,2013.0,1,1,0
NLD,MKD,2020.0,2,2,0
CHN,ESP,1998.0,2,3,-1
SDN,DEU,2002.0,2,1,1
DNK,SGP,2004.0,1,1,0
NAM,GBR,2009.0,1,1,0
ECU,FRA,2007.0,2,1,1
FRA,SRB,2011.0,2,1,1
AUS,VEN,2006.0,1,2,-1
MHL,USA,2010.0,1,1,0
ARG,FIN,2016.0,1,2,-1
ROU,CAN,2022.0,1,1,0
GBR,URY,2016.0,1,1,0
OMN,AUS,2012.0,1,3,-2
NLD,ZMB,2016.0,1,1,0
RUS,SVK,2017.0,1,3,-2
DNK,GRL,2011.0,2,3,-1
PRK,CHN,2022.0,2,1,1
TUR,RUS,2001.0,2,2,0
KWT,EGY,2006.0,2,5,-3
ESP,DNK,1998.0,2,3,-1
UZB,DEU,2004.0,2,1,1
SGP,TUN,2012.0,1,1,0
BRA,AUT,1999.0,1,1,0
SWE,BFA,2012.0,1,1,0
HKG,BGD,2007.0,1,1,0
TWN,DNK,2003.0,1,1,0
HRV,HUN,2015.0,1,2,-1
ARE,USA,1999.0,1,2,-1
AZE,IRN,2019.0,1,3,-2
GEO,TUR,2017.0,1,1,0
MAC,PRT,2022.0,1,1,0
BGD,BRN,2016.0,4,3,1
PAK,CHE,2010.0,1,4,-3
CHN,TUN,2021.0,1,6,-5
USA,FSM,2019.0,1,1,0
EGY,IRL,2022.0,2,1,1
KOR,BEL,2022.0,4,3,1
GBR,CIV,2022.0,1,1,0
BGD,ARE,2009.0,1,1,0
KWT,OMN,2020.0,1,3,-2
TWN,NOR,2016.0,2,2,0
DEU,PAN,2018.0,1,1,0
ZMB,TZA,2019.0,1,2,-1
SAU,BGD,2011.0,1,1,0
AUS,IND,1997.0,2,3,-1
USA,UZB,2014.0,1,1,0
NOR,GRC,2009.0,1,4,-3
BGD,THA,2002.0,1,1,0
KOR,ITA,2002.0,1,3,-2
SGP,CAN,1998.0,1,3,-2
NPL,CAN,2012.0,1,1,0
ARG,BEL,2011.0,1,1,0
BOL,NLD,2008.0,1,1,0
KAZ,GBR,2005.0,1,2,-1
ARG,ISR,2022.0,1,4,-3
NLD,BGD,2022.0,1,1,0
ECU,GBR,2001.0,1,1,0
EGY,TWN,2007.0,1,1,0
BEN,USA,2018.0,1,4,-3
QAT,EGY,2013.0,1,5,-4
BEL,SEN,2002.0,1,1,0
CHN,BLR,2015.0,1,2,-1
GHA,SWE,2005.0,1,1,0
ZAF,ETH,2010.0,2,1,1
BGD,PHL,2021.0,1,1,0
ESP,VEN,2022.0,1,1,0
FRA,MLT,2017.0,1,1,0
JPN,ARE,2008.0,1,1,0
SLE,ITA,2017.0,1,1,0
SWE,LUX,2006.0,1,2,-1
SDN,PAK,2020.0,1,2,-1
BIH,USA,2018.0,1,7,-6
MLT,ESP,2020.0,1,1,0
TTO,IND,2008.0,1,1,0
MLI,USA,2022.0,1,2,-1
RWA,CHN,2022.0,1,4,-3
NOR,USA,2009.0,61,75,-14
JPN,CAN,2009.0,79,80,-1
AUS,CHN,2015.0,214,283,-69
IND,AUS,2009.0,73,33,40
PRT,GBR,2007.0,33,38,-5
FRA,DNK,2004.0,21,13,8
SWE,USA,2011.0,180,203,-23
IND,DEU,2018.0,186,137,49
CAN,TUR,2005.0,6,7,-1
CHN,HKG,2002.0,144,137,7
NLD,IND,2012.0,26,24,2
IND,NLD,2016.0,49,29,20
SAU,NLD,2020.0,8,7,1
JPN,THA,2012.0,91,42,49
ESP,FRA,2020.0,195,221,-26
USA,KOR,2021.0,576,551,25
HRV,CHE,2014.0,9,4,5
ITA,AUS,2016.0,54,38,16
JPN,KOR,2022.0,48,30,18
DEU,TUR,2021.0,17,61,-44
USA,UKR,2022.0,4,9,-5
CHN,DEU,2008.0,137,134,3
FRA,BRA,2012.0,99,69,30
AUS,IRL,2017.0,40,41,-1
RUS,JPN,2020.0,16,16,0
ESP,CHN,2021.0,43,39,4
BEN,FRA,2019.0,6,6,0
DEU,FIN,2018.0,56,69,-13
SWE,EST,2009.0,9,2,7
GBR,DNK,2012.0,72,54,18
USA,CRI,2020.0,20,19,1
PER,DEU,2012.0,5,1,4
SWE,AUS,2014.0,33,43,-10
JPN,IRL,2007.0,9,1,8
FRA,NOR,2003.0,11,5,6
NOR,FRA,2017.0,19,32,-13
GBR,CZE,2003.0,33,19,14
IRN,GBR,2005.0,10,46,-36
ITA,ARE,2015.0,10,2,8
VEN,GBR,2018.0,4,1,3
NLD,POL,2021.0,9,10,-1
HUN,SWE,2015.0,9,5,4
MLI,FRA,2014.0,2,5,-3
FRA,IDN,2013.0,12,6,6
HUN,BEL,2020.0,4,4,0
RUS,UZB,2020.0,11,6,5
HKG,DEU,2002.0,9,6,3
YEM,IND,2021.0,3,7,-4
AUT,UKR,2014.0,2,5,-3
GBR,ROU,2021.0,11,13,-2
FRA,MYS,2015.0,5,2,3
CHE,DNK,1997.0,1,3,-2
GEO,POL,2003.0,1,1,0
CAN,LUX,2002.0,1,1,0
RUS,UKR,2004.0,35,29,6
AUS,NOR,2001.0,4,3,1
USA,VEN,2007.0,24,30,-6
JPN,ESP,2008.0,16,8,8
CHE,CZE,2003.0,2,4,-2
UKR,ISR,2002.0,7,3,4
ARG,CHL,2007.0,11,9,2
AUT,CZE,2009.0,7,3,4
OMN,CAN,2008.0,3,8,-5
CHN,LKA,2011.0,3,1,2
CZE,FIN,2016.0,2,8,-6
HKG,NZL,2018.0,8,4,4
NOR,SAU,2018.0,3,2,1
NZL,JPN,2016.0,8,1,7
AUS,TUR,2022.0,5,4,1
ISR,SRB,2020.0,3,1,2
HUN,ROU,2019.0,12,11,1
HKG,DEU,2005.0,5,3,2
SWE,CAN,2008.0,33,27,6
KEN,AUS,2021.0,3,1,2
KOR,HKG,2021.0,7,14,-7
TTO,JAM,2011.0,3,1,2
ZAF,IND,2012.0,17,31,-14
USA,LKA,2016.0,18,8,10
ZAF,IRL,2018.0,6,4,2
NOR,FRA,2019.0,24,57,-33
EST,SWE,2022.0,3,2,1
NZL,THA,2009.0,3,2,1
KOR,DNK,2009.0,3,3,0
ARG,URY,2011.0,1,2,-1
HRV,SWE,2010.0,2,3,-1
AUS,PAK,2009.0,5,3,2
FRA,EST,2004.0,2,1,1
ZAF,NZL,2008.0,7,3,4
CAN,THA,2013.0,18,6,12
AZE,IRN,2010.0,2,2,0
SVK,GBR,2017.0,4,4,0
ISR,RUS,2001.0,1,17,-16
NLD,PRT,2021.0,14,19,-5
BRB,GBR,2006.0,1,1,0
IRL,NOR,2012.0,2,1,1
POL,BEL,2020.0,4,10,-6
SVK,GBR,2010.0,6,10,-4
BEN,FRA,2010.0,5,12,-7
NOR,MYS,2020.0,2,3,-1
MYS,IRL,2012.0,3,8,-5
QAT,CHE,2018.0,1,2,-1
FIN,PRT,2021.0,3,5,-2
GBR,MUS,2013.0,1,1,0
NLD,TZA,2007.0,1,2,-1
BGR,CZE,2016.0,3,2,1
SEN,MRT,2015.0,1,1,0
PAN,BRA,2006.0,2,1,1
MEX,VEN,2005.0,1,5,-4
DNK,PRT,2010.0,4,4,0
ESP,PRY,2002.0,1,1,0
ITA,GRC,2000.0,8,3,5
AUT,BIH,2009.0,2,1,1
RUS,AUS,2017.0,7,9,-2
PRT,DNK,2014.0,9,5,4
URY,ESP,2011.0,8,3,5
OMN,USA,2017.0,3,7,-4
NZL,SAU,2020.0,2,8,-6
UKR,NLD,2002.0,4,1,3
SWZ,ZAF,2018.0,4,7,-3
ITA,RUS,2006.0,12,23,-11
HUN,IRN,2015.0,1,1,0
COL,NOR,2008.0,1,1,0
MWI,ZAF,2004.0,1,1,0
HUN,CHE,2019.0,9,7,2
ITA,DZA,2015.0,4,1,3
NPL,NZL,2020.0,2,1,1
CRI,TWN,2012.0,1,1,0
AUS,NCL,2015.0,3,1,2
SWE,TUN,2017.0,2,4,-2
KOR,POL,2007.0,1,1,0
IND,IRN,2021.0,3,4,-1
EGY,LBN,2006.0,1,2,-1
MAC,HKG,2014.0,5,18,-13
KGZ,DEU,2002.0,1,1,0
IDN,CAN,2016.0,2,7,-5
PHL,SGP,2017.0,4,3,1
SWE,VNM,2016.0,2,1,1
FRA,LTU,2020.0,3,3,0
CRI,CAN,2018.0,2,2,0
CZE,RUS,2013.0,6,7,-1
CAN,IDN,2004.0,1,1,0
USA,CIV,2020.0,3,6,-3
KAZ,UZB,2018.0,3,1,2
DZA,MAR,2021.0,4,1,3
USA,PNG,2014.0,1,2,-1
PHL,AFG,2019.0,1,1,0
ARM,DEU,2007.0,2,2,0
NLD,UKR,2001.0,2,2,0
BHR,GBR,2018.0,1,4,-3
KHM,KOR,2012.0,1,1,0
THA,PHL,2018.0,1,4,-3
CZE,SGP,2016.0,1,1,0
BGR,AUS,1999.0,1,1,0
DEU,ECU,2010.0,1,1,0
SGP,MAC,2011.0,1,1,0
NLD,FJI,2020.0,1,1,0
DNK,AUT,2001.0,1,1,0
,RUS,2000.0,9447,0,9447
,TUN,2004.0,1017,0,1017
TWN,,2009.0,2726,0,2726
HRV,,2012.0,446,0,446
,BEL,1994.0,2616,0,2616
,BRA,2008.0,17398,0,17398
URY,,2011.0,59,0,59
BEL,,2012.0,1647,0,1647
IRN,,2010.0,797,0,797
,FIN,2003.0,1990,0,1990
PRT,,2024.0,21183,0,21183
IRN,,2019.0,6898,0,6898
,SVK,2000.0,728,0,728
ITA,,2000.0,451,0,451
,MLI,2004.0,59,0,59
ZAF,,2013.0,749,0,749
PAK,,2013.0,779,0,779
CUB,,2009.0,305,0,305
MEX,,2021.0,6457,0,6457
EGY,,2015.0,1082,0,1082
,FRA,2009.0,14787,0,14787
ROU,,2015.0,1287,0,1287
IRN,,2017.0,4544,0,4544
,HRV,1997.0,495,0,495
ARG,,2005.0,438,0,438
,TUN,1996.0,231,0,231
,NOR,2013.0,1956,0,1956
,MDG,2004.0,41,0,41
CMR,,2012.0,51,0,51
,HUN,2008.0,1400,0,1400
,SWE,1995.0,2979,0,2979
SRB,NLD,2002.0,4,0,4
LBN,,2022.0,816,0,816
,HRV,1998.0,1272,0,1272
CHL,,2022.0,4266,0,4266
,COL,2006.0,1415,0,1415
,AUS,2015.0,9391,0,9391
,ROU,2007.0,2950,0,2950
ARG,,2002.0,132,0,132
KHM,,2008.0,5,0,5
,GEO,2014.0,166,0,166
CZE,,2009.0,840,0,840
,CAN,2013.0,12626,0,12626
MYS,CMR,2016.0,1,0,1
CYP,,2020.0,192,0,192
,BFA,2013.0,122,0,122
CHN,LVA,2007.0,2,0,2
GRC,,2006.0,609,0,609
,PAK,1998.0,732,0,732
UKR,BEL,2013.0,7,0,7
,LBN,1999.0,255,0,255
NAM,,2024.0,240,0,240
,LVA,2002.0,78,0,78
,IRL,2009.0,1696,0,1696
MDA,,2021.0,83,0,83
,ZAF,2016.0,2697,0,2697
,SVN,2015.0,509,0,509
,ETH,2013.0,630,0,630
BWA,,2016.0,47,0,47
MYS,YEM,2021.0,16,0,16
,SEN,2010.0,127,0,127
ZMB,,2021.0,91,0,91
,MWI,2012.0,105,0,105
,MKD,2011.0,194,0,194
,MLI,1996.0,9,0,9
,EST,2015.0,306,0,306
SWZ,,2016.0,4,0,4
,ECU,2012.0,224,0,224
,SGP,2015.0,2294,0,2294
PHL,RUS,2015.0,2,0,2
,COD,2011.0,14,0,14
LVA,LTU,2016.0,5,0,5
AUS,,2001.0,143,0,143
,CRI,2012.0,129,0,129
,CHL,2018.0,1779,0,1779
BRA,,2004.0,869,0,869
,GIN,2013.0,17,0,17
,MAR,2015.0,1527,0,1527
,BGR,2018.0,402,0,402
SYR,ESP,2018.0,2,0,2
PRK,,2021.0,20,0,20
,PAN,2014.0,50,0,50
IDN,TLS,2018.0,2,0,2
FRA,SYR,2012.0,11,0,11
FIN,VNM,2018.0,2,0,2
,MLT,2016.0,69,0,69
NOR,LUX,2020.0,2,0,2
ERI,USA,2018.0,2,0,2
,SEN,2019.0,47,0,47
,FRO,2015.0,12,0,12
KHM,VNM,2020.0,1,0,1
,SLE,2017.0,24,0,24
BGR,CHN,2020.0,2,0,2
MUS,,2006.0,4,0,4
,ARM,1999.0,173,0,173
HND,,2024.0,82,0,82
GEO,,2011.0,66,0,66
,GUF,2016.0,18,0,18
,SEN,2017.0,112,0,112
SEN,,2001.0,2,0,2
,MDG,1996.0,17,0,17
,LVA,2005.0,154,0,154
AZE,,2012.0,89,0,89
,BHR,2007.0,23,0,23
GBR,PAN,2016.0,3,0,3
PAN,,2014.0,18,0,18
,PAK,1997.0,130,0,130
,TZA,1999.0,137,0,137
IND,PNG,2013.0,1,0,1
ASM,USA,2015.0,1,0,1
,KGZ,1995.0,12,0,12
MOZ,NER,2020.0,1,0,1
GBR,BRN,2013.0,8,0,8
FRA,FJI,2017.0,2,0,2
USA,KEN,1997.0,2,0,2
ITA,CYP,1999.0,2,0,2
SEN,TGO,2022.0,1,0,1
GBR,ZMB,2021.0,2,0,2
AUS,TZA,2016.0,5,0,5
LVA,,2009.0,37,0,37
ALB,,2008.0,6,0,6
,ALB,2001.0,8,0,8
FIN,TZA,2007.0,1,0,1
TTO,,2007.0,22,0,22
,SLB,2001.0,2,0,2
IDN,PHL,2010.0,3,0,3
,KAZ,1994.0,117,0,117
CHE,ALB,2008.0,1,0,1
FRA,PAK,2003.0,2,0,2
,LSO,2001.0,5,0,5
SDN,IND,2010.0,1,0,1
BEL,ECU,2003.0,2,0,2
GBR,GIN,2001.0,2,0,2
VNM,,2001.0,5,0,5
SWE,SAU,2011.0,3,0,3
IND,SGP,2000.0,15,0,15
NZL,FRA,2000.0,2,0,2
GUM,CHN,2015.0,1,0,1
MDG,,2006.0,3,0,3
ARG,PRT,2019.0,4,0,4
,LIE,1998.0,6,0,6
VEN,,1999.0,7,0,7
CUB,CHE,2002.0,1,0,1
SVK,RUS,2013.0,5,0,5
JPN,GRC,2001.0,1,0,1
BEN,DEU,1999.0,3,0,3
GBR,MLI,2002.0,1,0,1
URY,COL,2002.0,1,0,1
ARE,HKG,2006.0,2,0,2
USA,NIC,2015.0,4,0,4
ARG,MYS,2009.0,1,0,1
SRB,POL,2018.0,2,0,2
PSE,SAU,2018.0,2,0,2
,SLV,1998.0,5,0,5
CHN,MAR,2012.0,1,0,1
ISL,FRA,2008.0,1,0,1
,COG,2008.0,58,0,58
COD,DEU,2006.0,1,0,1
BGD,,2003.0,32,0,32
TUR,ZAF,2012.0,4,0,4
ZWE,PAK,2010.0,1,0,1
ZAF,DNK,2020.0,4,0,4
ZAF,ISR,1998.0,1,0,1
ZAF,PRT,2004.0,2,0,2
,LAO,2007.0,22,0,22
LKA,EGY,2011.0,1,0,1
PRT,OMN,2014.0,1,0,1
PAK,EGY,2016.0,2,0,2
LBY,IND,2015.0,3,0,3
NLD,NPL,2022.0,2,0,2
,SLE,2019.0,26,0,26
SGP,OMN,2016.0,1,0,1
GNQ,GIN,2012.0,2,0,2
CHE,NPL,2021.0,1,0,1
KWT,HKG,2018.0,1,0,1
,SWZ,2008.0,12,0,12
FIN,IDN,2021.0,1,0,1
MYS,ZMB,2019.0,1,0,1
HRV,SWE,2019.0,5,0,5
COM,,2011.0,1,0,1
ZAF,POL,2007.0,1,0,1
SRB,CAN,2004.0,1,0,1
MLI,DEU,2015.0,3,0,3
,GUM,1996.0,5,0,5
,GAB,2007.0,27,0,27
BHS,,2016.0,2,0,2
FIN,OMN,2010.0,1,0,1
MYS,NGA,2002.0,1,0,1
BEL,MNE,2018.0,1,0,1
BGR,USA,2000.0,9,0,9
HUN,NZL,2013.0,2,0,2
AFG,GBR,2016.0,2,0,2
PER,AUS,2020.0,2,0,2
MCO,,2011.0,5,0,5
CHN,SVN,2010.0,1,0,1
SWE,TUN,2019.0,2,0,2
,GUY,2013.0,4,0,4
ITA,BWA,2017.0,1,0,1
EGY,NPL,2009.0,3,0,3
ESP,NIC,2017.0,1,0,1
UKR,PRT,2020.0,1,0,1
SVN,MKD,2018.0,2,0,2
IRL,HUN,2003.0,1,0,1
AUT,VNM,2010.0,3,0,3
SYR,,2006.0,11,0,11
PAN,CAN,2004.0,1,0,1
,NIC,2017.0,10,0,10
GIN,,2015.0,6,0,6
CHE,MYS,2022.0,1,0,1
BLR,IRL,2004.0,1,0,1
KAZ,,2001.0,9,0,9
NGA,ETH,2022.0,1,0,1
BEL,CMR,1998.0,1,0,1
LIE,,2009.0,4,0,4
PLW,USA,2015.0,1,0,1
USA,PLW,2017.0,1,0,1
GMB,GBR,1998.0,1,0,1
SRB,CHL,2005.0,4,0,4
GNQ,,2011.0,1,0,1
,PNG,1995.0,16,0,16
USA,OMN,2012.0,5,0,5
,NIC,2010.0,14,0,14
SLB,,2012.0,1,0,1
GTM,AGO,2015.0,1,0,1
MYS,COG,2004.0,2,0,2
IND,KEN,2002.0,3,0,3
GRC,PSE,2009.0,1,0,1
AUT,CMR,2003.0,3,0,3
MKD,,2007.0,13,0,13
CMR,BEL,2005.0,1,0,1
MDG,USA,1998.0,1,0,1
NLD,VNM,2001.0,1,0,1
PRI,MEX,2015.0,1,0,1
,STP,2004.0,1,0,1
PRT,CPV,2016.0,4,0,4
PAK,NGA,2009.0,1,0,1
CHN,TGO,2015.0,2,0,2
RUS,LVA,2008.0,2,0,2
CHE,MOZ,2014.0,2,0,2
SLV,ITA,2007.0,1,0,1
PHL,SAU,2020.0,1,0,1
,SLE,2010.0,8,0,8
IDN,ESP,2013.0,2,0,2
JOR,DZA,2015.0,1,0,1
CIV,MLI,2016.0,1,0,1
,GNQ,2012.0,6,0,6
DZA,LUX,2021.0,1,0,1
JPN,PAN,2007.0,1,0,1
VEN,MEX,2020.0,10,0,10
EST,LTU,2007.0,1,0,1
PHL,AFG,2017.0,1,0,1
CAN,LKA,2010.0,3,0,3
DNK,GNB,2003.0,9,0,9
CAN,BGD,1998.0,1,0,1
ARE,DNK,2010.0,1,0,1
LIE,FRA,2001.0,1,0,1
KOR,UKR,2015.0,2,0,2
MYS,SAU,2007.0,1,0,1
KEN,SLE,2016.0,1,0,1
CAF,,2013.0,3,0,3
TZA,CHE,2006.0,1,0,1
PHL,SWE,2016.0,2,0,2
SVN,CHN,2003.0,1,0,1
KEN,COG,2007.0,2,0,2
SLV,,2014.0,5,0,5
MDA,TWN,2006.0,1,0,1
SRB,BEL,2009.0,1,0,1
ESP,MKD,2017.0,1,0,1
ECU,AUT,2015.0,1,0,1
NZL,QAT,2021.0,2,0,2
MTQ,SWE,2013.0,1,0,1
SEN,BEL,2007.0,2,0,2
VEN,PER,2009.0,1,0,1
CHL,TWN,2022.0,1,0,1
KGZ,AUT,2016.0,1,0,1
CHE,PRI,2016.0,1,0,1
EST,CHE,2011.0,2,0,2
JPN,HRV,2011.0,1,0,1
MMR,NOR,2016.0,1,0,1
PAK,RUS,2019.0,2,0,2
,ERI,2009.0,5,0,5
IND,MLI,2003.0,2,0,2
LUX,HUN,2019.0,1,0,1
SVK,QAT,2014.0,2,0,2
SWZ,DEU,2019.0,1,0,1
TUR,HKG,2009.0,3,0,3
PYF,,2005.0,3,0,3
FRA,BDI,2001.0,1,0,1
,LIE,1997.0,2,0,2
CAN,NAM,1999.0,1,0,1
PAK,RUS,2017.0,3,0,3
CHE,CIV,2008.0,1,0,1
,RWA,1994.0,5,0,5
DEU,URY,2006.0,2,0,2
,LCA,2013.0,1,0,1
BLR,JPN,2004.0,1,0,1
BEL,OMN,2007.0,1,0,1
MTQ,IRL,2014.0,1,0,1
ITA,LTU,2001.0,2,0,2
SGP,LBN,2008.0,1,0,1
MMR,AUS,2011.0,1,0,1
USA,DOM,2003.0,1,0,1
FIN,IRL,1998.0,1,0,1
GUY,ZAF,2004.0,1,0,1
PHL,IRN,2005.0,1,0,1
THA,MAR,2016.0,1,0,1
GMB,BEL,2011.0,1,0,1
BWA,BRN,2008.0,1,0,1
SLE,CAN,2017.0,1,0,1
IND,IDN,2011.0,1,0,1
KEN,GIN,2014.0,1,0,1
CUB,VNM,2014.0,2,0,2
NCL,CAN,2020.0,1,0,1
GHA,BDI,2018.0,1,0,1
CIV,DEU,2019.0,2,0,2
CUB,NLD,2019.0,3,0,3
KAZ,GBR,2002.0,3,0,3
BGR,NZL,2007.0,1,0,1
BEL,BOL,2014.0,1,0,1
PAK,CHE,2017.0,1,0,1
MRT,FRA,2013.0,1,0,1
ZAF,AUT,2021.0,7,0,7
CRI,AUS,2015.0,2,0,2
NGA,IDN,2012.0,1,0,1
ESP,CYP,2011.0,2,0,2
GEO,CZE,2019.0,1,0,1
ITA,MDA,2007.0,1,0,1
CAN,IRN,1998.0,1,0,1
SVK,NOR,2007.0,2,0,2
GMB,FRA,2008.0,1,0,1
ESP,EST,2001.0,1,0,1
DEU,TZA,2001.0,1,0,1
ARM,TWN,2012.0,2,0,2
NOR,GHA,2009.0,2,0,2
GEO,ISR,2001.0,1,0,1
SGP,CAN,1997.0,2,0,2
QAT,IRN,2007.0,1,0,1
MYS,NGA,2005.0,1,0,1
MEX,ECU,2009.0,2,0,2
ESP,GIB,2012.0,1,0,1
GIB,,2018.0,3,0,3
USA,MLT,2000.0,2,0,2
SRB,BRA,2011.0,1,0,1
AUS,PYF,2012.0,1,0,1
ITA,BWA,2010.0,2,0,2
SRB,CHL,2002.0,1,0,1
DZA,YEM,2019.0,1,0,1
CMR,CAF,2019.0,2,0,2
CAN,CIV,2022.0,1,0,1
FIN,HRV,2015.0,1,0,1
ZAF,IRN,2003.0,2,0,2
NLD,KAZ,2006.0,1,0,1
BGR,SWE,2008.0,2,0,2
CHN,NAM,2017.0,5,0,5
IDN,MEX,2011.0,1,0,1
HRV,SWE,2017.0,1,0,1
BEL,DJI,2014.0,1,0,1
RUS,SVK,2019.0,3,0,3
UGA,EGY,2010.0,1,0,1
BGR,TUR,2010.0,3,0,3
NPL,USA,1999.0,3,0,3
ROU,JPN,1999.0,3,0,3
CMR,TZA,2010.0,1,0,1
,SUR,1998.0,5,0,5
PHL,MEX,2012.0,1,0,1
NZL,ARG,2017.0,1,0,1
EGY,GRC,2009.0,1,0,1
ITA,THA,2012.0,2,0,2
BHR,CAN,2013.0,2,0,2
BGD,KAZ,2012.0,1,0,1
FRA,MWI,2018.0,1,0,1
UKR,FIN,2013.0,1,0,1
ARM,MYS,2018.0,1,0,1
USA,GUF,2018.0,1,0,1
CRI,SAU,2017.0,1,0,1
BGD,NGA,2020.0,2,0,2
BGD,ESP,2018.0,1,0,1
AFG,MMR,2021.0,1,0,1
BLR,FIN,2001.0,1,0,1
IND,SVN,2010.0,2,0,2
CHE,ARE,2006.0,1,0,1
FIN,IND,1997.0,2,0,2
USA,BLZ,2004.0,1,0,1
BEL,BEN,2006.0,2,0,2
UKR,BGR,2008.0,1,0,1
,DOM,2000.0,2,0,2
MEX,HND,2017.0,1,0,1
SWE,RWA,2002.0,1,0,1
FRO,USA,2003.0,1,0,1
AUT,PNG,2003.0,1,0,1
EST,CAN,2004.0,2,0,2
CHE,LUX,1999.0,1,0,1
CIV,DNK,2001.0,1,0,1
CHE,IRQ,2006.0,1,0,1
FIN,PSE,2013.0,1,0,1
ESP,GEO,2002.0,1,0,1
AUS,GRC,2001.0,2,0,2
CRI,MTQ,2006.0,1,0,1
YEM,BHR,2003.0,1,0,1
VEN,PRI,1999.0,1,0,1
LSO,ESP,2002.0,1,0,1
FRA,JAM,2006.0,1,0,1
MDA,KGZ,2016.0,1,0,1
ZAF,GUF,2014.0,1,0,1
USA,VCT,2020.0,1,0,1
LUX,KOR,2013.0,1,0,1
USA,AFG,2022.0,1,0,1
NLD,KWT,2019.0,1,0,1
BLR,NOR,2021.0,1,0,1
HKG,PHL,2022.0,1,0,1
CUB,NLD,2010.0,1,0,1
GRC,HUN,2002.0,1,0,1
UKR,NZL,2008.0,1,0,1
ARE,DNK,2017.0,2,0,2
MEX,POL,2004.0,2,0,2
RUS,IRQ,2011.0,1,0,1
AUT,IDN,2018.0,4,0,4
MYS,SVN,2010.0,1,0,1
MAR,NER,2016.0,2,0,2
CZE,ARE,2020.0,2,0,2
DNK,FRO,2001.0,2,0,2
KWT,NZL,2014.0,1,0,1
CAN,LAO,2020.0,1,0,1
PRT,HRV,2003.0,1,0,1
DEU,ALB,2004.0,1,0,1
CYP,ARE,2006.0,1,0,1
AUT,ZWE,2013.0,1,0,1
BLR,CHE,2007.0,2,0,2
BIH,PRT,2016.0,1,0,1
HRV,NLD,1999.0,1,0,1
ECU,CHN,2014.0,1,0,1
PAK,NOR,2011.0,2,0,2
NOR,SDN,2012.0,1,0,1
CHN,KEN,2012.0,2,0,2
NLD,EST,2009.0,1,0,1
EST,ISL,2015.0,1,0,1
SDN,NOR,2011.0,1,0,1
LVA,DNK,2016.0,1,0,1
MWI,CHE,2022.0,1,0,1
MNE,ZAF,2019.0,1,0,1
CHN,LBY,2019.0,1,0,1
NZL,KGZ,2020.0,1,0,1
,DEU,2020.0,3,0,3
,ITA,2020.0,2,0,2
FRA,OMN,2012.0,2,0,2
SEN,THA,1998.0,1,0,1
ETH,NGA,2018.0,1,0,1
CHN,MUS,2015.0,1,0,1
BEL,TWN,2003.0,2,0,2
PRY,CHL,2013.0,1,0,1
TUR,LBY,2000.0,1,0,1
,GRD,1999.0,2,0,2
COL,MYS,2012.0,1,0,1
GAB,DEU,2011.0,1,0,1
KEN,MWI,2007.0,1,0,1
PLW,,2022.0,2,0,2
PRT,EST,2021.0,1,0,1
MEX,HND,2019.0,2,0,2
,GUM,2004.0,2,0,2
PRI,VEN,2001.0,2,0,2
DNK,CHL,2004.0,1,0,1
ITA,CIV,2015.0,1,0,1
TUR,IDN,2021.0,1,0,1
DNK,ARE,2014.0,2,0,2
CAN,BHS,2016.0,1,0,1
KOR,LKA,2008.0,1,0,1
NGA,AIA,2014.0,1,0,1
URY,ITA,2011.0,1,0,1
SGP,KOR,2001.0,1,0,1
MKD,BGR,2014.0,1,0,1
CHN,JOR,1999.0,1,0,1
GMB,DNK,2002.0,1,0,1
FRA,SAU,1999.0,1,0,1
MEX,BRA,2023.0,1,0,1
KEN,ZMB,2013.0,1,0,1
EST,AUS,2014.0,2,0,2
CPV,FIN,2015.0,1,0,1
GRL,USA,2022.0,1,0,1
NZL,MEX,2008.0,1,0,1
ALB,HUN,2011.0,1,0,1
CUB,PER,2020.0,1,0,1
CMR,TZA,2017.0,1,0,1
ARE,BRA,2014.0,1,0,1
PAK,IRQ,2014.0,2,0,2
SRB,KWT,2022.0,1,0,1
TZA,MLI,2017.0,1,0,1
SGP,SAU,2007.0,2,0,2
PAK,JOR,2006.0,1,0,1
GEO,CHN,2017.0,1,0,1
DEU,IDN,2000.0,2,0,2
ZAF,KEN,1997.0,1,0,1
TWN,COL,2011.0,1,0,1
PRI,CZE,2011.0,1,0,1
JPN,SYR,2013.0,1,0,1
MNG,TUR,2019.0,1,0,1
TUR,POL,2002.0,3,0,3
NLD,MAC,2008.0,1,0,1
ISR,UZB,2018.0,1,0,1
LBY,,2025.0,1,0,1
PRI,PAK,2015.0,1,0,1
NOR,VNM,2014.0,3,0,3
PAN,FIN,2011.0,1,0,1
ITA,BEN,2003.0,1,0,1
ESP,MCO,2007.0,1,0,1
ARG,SRB,2015.0,1,0,1
USA,PLW,2019.0,1,0,1
CHE,DZA,2014.0,1,0,1
OMN,SGP,2005.0,1,0,1
IRN,ARE,2005.0,1,0,1
NPL,BGD,2008.0,1,0,1
SRB,SVK,2014.0,1,0,1
UZB,IND,2010.0,1,0,1
NGA,POL,2019.0,1,0,1
KOR,NLD,1999.0,1,0,1
VEN,CUB,2022.0,1,0,1
FRA,LBR,2019.0,1,0,1
SEN,ZAF,2004.0,1,0,1
UKR,HUN,1999.0,1,0,1
GMB,IRL,2008.0,1,0,1
CZE,BHR,2016.0,1,0,1
GHA,ETH,2011.0,1,0,1
DEU,KWT,2012.0,1,0,1
SGP,GRC,2008.0,2,0,2
ESP,NIC,2010.0,2,0,2
TJK,IRN,2013.0,1,0,1
KEN,NAM,1999.0,1,0,1
JPN,SDN,2016.0,2,0,2
BWA,NAM,2013.0,1,0,1
CHE,LKA,2003.0,1,0,1
SWE,VEN,2010.0,1,0,1
CHL,PRI,2006.0,1,0,1
CHE,PRT,2003.0,2,0,2
FIN,LBY,2009.0,2,0,2
MDA,CZE,2017.0,2,0,2
SEN,SGP,2008.0,1,0,1
AUS,LAO,2004.0,1,0,1
MYS,NOR,2008.0,1,0,1
BEL,EST,2012.0,1,0,1
FSM,,2018.0,2,0,2
IND,LUX,2012.0,1,0,1
HKG,BWA,2007.0,1,0,1
NGA,COL,2008.0,1,0,1
AUS,NER,2012.0,1,0,1
MCO,USA,2008.0,1,0,1
IRN,UKR,2009.0,1,0,1
BGD,PER,2018.0,1,0,1
ITA,HRV,2009.0,1,0,1
AUT,ZMB,2006.0,1,0,1
HRV,FIN,2000.0,1,0,1
BFA,TGO,2004.0,1,0,1
MAR,CHN,2015.0,1,0,1
ARG,TWN,2009.0,1,0,1
CHL,ETH,2018.0,1,0,1
UKR,VNM,2014.0,1,0,1
CHN,ZWE,2022.0,1,0,1
,SSD,2015.0,1,0,1
,NIC,2019.0,6,0,6
TLS,AUS,2020.0,1,0,1
LBN,LBY,2014.0,1,0,1
DZA,TUR,2019.0,1,0,1
PAN,THA,2013.0,1,0,1
BRA,MNE,2008.0,1,0,1
AFG,ARE,2015.0,1,0,1
MAC,THA,2019.0,1,0,1
UKR,KWT,2005.0,1,0,1
ECU,HKG,2020.0,1,0,1
KOR,COL,2016.0,1,0,1
GUF,IRN,2004.0,1,0,1
TKM,CHN,2020.0,1,0,1
GHA,IRQ,2017.0,1,0,1
POL,MKD,2015.0,1,0,1
BEL,COL,2004.0,1,0,1
CYP,TUR,2001.0,1,0,1
UKR,BRA,2012.0,1,0,1
BEL,GEO,2001.0,1,0,1
BLR,GBR,2018.0,2,0,2
ISR,POL,2004.0,1,0,1
SRB,BIH,1999.0,1,0,1
VEN,AUS,2015.0,1,0,1
CUB,URY,1997.0,1,0,1
NOR,SVN,1999.0,1,0,1
KHM,AUS,2007.0,1,0,1
HTI,,2006.0,1,0,1
PAK,UZB,2007.0,1,0,1
CAN,LVA,2003.0,1,0,1
ROU,HRV,2009.0,1,0,1
AUS,SRB,2011.0,1,0,1
IDN,SGP,2006.0,1,0,1
GIN,SLE,2006.0,1,0,1
CHE,CYP,2018.0,1,0,1
TON,NCL,2013.0,1,0,1
YEM,QAT,2006.0,1,0,1
TCA,ARE,2019.0,1,0,1
BRA,EST,2015.0,1,0,1
BWA,BGD,2018.0,1,0,1
GHA,ECU,2014.0,1,0,1
REU,BEL,2011.0,1,0,1
ISR,BLR,2011.0,1,0,1
PRT,KAZ,2021.0,1,0,1
HUN,JOR,2005.0,1,0,1
USA,HND,2002.0,1,0,1
GRC,MCO,1999.0,1,0,1
SAU,GHA,2011.0,1,0,1
JOR,TUR,2003.0,1,0,1
CZE,NZL,2008.0,1,0,1
ZAF,CHL,2011.0,1,0,1
SWE,AFG,2010.0,1,0,1
TON,KHM,2007.0,1,0,1
IRN,FJI,2020.0,1,0,1
PNG,ETH,2012.0,1,0,1
LVA,BRA,2018.0,1,0,1
PHL,PER,2018.0,1,0,1
IND,GRD,2009.0,1,0,1
KAZ,SWE,2016.0,1,0,1
DEU,MNE,2000.0,1,0,1
CMR,CIV,1999.0,1,0,1
BEL,GHA,2012.0,1,0,1
USA,LSO,2006.0,1,0,1
PHL,FRA,2012.0,1,0,1
ZAF,SWZ,2004.0,1,0,1
COL,SGP,2018.0,1,0,1
BRB,DEU,2018.0,1,0,1
SWE,NCL,2018.0,1,0,1
PER,PAN,2020.0,1,0,1
COD,NOR,1998.0,1,0,1
FIN,CHL,1997.0,1,0,1
PHL,EGY,2016.0,1,0,1
PHL,MMR,2018.0,1,0,1
SAU,VNM,2016.0,1,0,1
MLT,TUN,2021.0,1,0,1
USA,FRA,2012.0,689,789,-100
BRA,ZAF,2010.0,5,4,1
CHE,USA,2009.0,388,399,-11
CAN,NZL,2005.0,18,31,-13
GBR,DEU,2008.0,328,579,-251
USA,MAR,2021.0,7,4,3
MYS,DEU,2010.0,5,5,0
TWN,USA,2008.0,230,296,-66
FRA,USA,2006.0,641,602,39
FIN,USA,2014.0,66,62,4
CHN,IRN,2012.0,5,6,-1
BEL,DEU,2004.0,59,42,17
IRL,USA,2007.0,90,97,-7
SWE,ITA,2014.0,23,72,-49
FRA,CHE,2010.0,254,176,78
TZA,GBR,2012.0,10,8,2
CHN,CAN,2007.0,122,133,-11
SWE,CHN,2011.0,42,67,-25
IRL,KOR,2010.0,6,6,0
DEU,EGY,2008.0,35,15,20
IDN,NLD,2009.0,1,13,-12
DEU,CHE,2008.0,563,333,230
ITA,USA,2011.0,545,341,204
CHN,AUS,2005.0,65,49,16
TUR,GBR,2012.0,28,49,-21
CHN,NPL,2009.0,2,1,1
USA,BRA,2008.0,234,335,-101
SWE,FRA,2011.0,42,43,-1
SGP,USA,2012.0,185,268,-83
USA,BGR,2003.0,8,22,-14
SGP,IND,2017.0,67,95,-28
CHN,DEU,2013.0,253,216,37
SGP,CHN,2019.0,423,247,176
CHN,NOR,2012.0,26,9,17
KOR,TUR,2015.0,5,2,3
UGA,GBR,2008.0,4,10,-6
IRN,USA,2005.0,30,30,0
RUS,UKR,2014.0,39,116,-77
SWE,JPN,2021.0,9,19,-10
KEN,DEU,2014.0,9,9,0
ZAF,BFA,2016.0,2,1,1
GBR,TWN,2011.0,44,26,18
CYP,GBR,2009.0,3,25,-22
UGA,KEN,2015.0,3,4,-1
SGP,CHN,2017.0,331,250,81
FRA,CHE,2017.0,371,205,166
USA,GBR,2004.0,964,1327,-363
THA,JPN,2012.0,42,91,-49
BEL,ITA,2015.0,66,81,-15
DNK,GBR,2007.0,49,38,11
IND,BEL,2009.0,14,4,10
CZE,ESP,2013.0,5,18,-13
IND,DEU,2010.0,122,66,56
USA,NLD,2012.0,307,310,-3
TUN,FRA,2020.0,116,82,34
DEU,JPN,2018.0,134,113,21
SWE,NOR,2006.0,46,29,17
BRA,ARG,2015.0,23,32,-9
FRA,CHE,2019.0,349,231,118
USA,CAN,2000.0,267,397,-130
CHE,ESP,2012.0,48,61,-13
JPN,ESP,2013.0,11,13,-2
FRA,SGP,2015.0,37,29,8
IND,NGA,2001.0,3,3,0
ITA,SWE,2008.0,34,23,11
USA,CHE,2021.0,413,375,38
IND,DEU,2017.0,184,111,73
BRA,CHE,2022.0,13,5,8
ESP,VEN,2016.0,21,21,0
USA,HTI,2019.0,4,7,-3
NOR,POL,2021.0,7,4,3
IND,GBR,2022.0,137,96,41
USA,COL,2018.0,81,118,-37
USA,SWE,2002.0,190,265,-75
DEU,MYS,2017.0,3,17,-14
ESP,USA,2021.0,320,285,35
POL,GBR,2015.0,91,39,52
PAK,DEU,2002.0,5,4,1
CHN,BGD,2021.0,35,23,12
NLD,GBR,2018.0,280,311,-31
IND,FRA,2012.0,73,61,12
PAK,FRA,2016.0,6,17,-11
DEU,NLD,2000.0,72,43,29
BGD,ESP,2019.0,2,5,-3
ROU,CHE,2020.0,11,4,7
VNM,AUS,2015.0,17,24,-7
ZWE,ZAF,2018.0,31,32,-1
SGP,IND,2019.0,71,91,-20
MYS,AUS,2011.0,52,73,-21
IRN,DEU,2022.0,44,12,32
CHN,SDN,2015.0,5,4,1
CHL,PER,2022.0,4,5,-1
CHN,MAC,2019.0,64,140,-76
UGA,USA,2016.0,34,26,8
ETH,NLD,2018.0,5,17,-12
USA,LBN,2013.0,33,58,-25
BEL,FRA,2006.0,140,132,8
GBR,VNM,2012.0,12,8,4
ESP,DEU,2013.0,203,153,50
USA,TUR,2004.0,185,144,41
GBR,TZA,2006.0,8,7,1
LUX,DEU,2017.0,23,31,-8
FIN,PAK,2015.0,1,1,0
MEX,USA,2013.0,196,153,43
IND,CAN,2012.0,121,64,57
FIN,IRN,2020.0,7,45,-38
TWN,CAN,2021.0,9,6,3
FRA,LBN,2022.0,22,38,-16
FRA,CZE,2021.0,29,11,18
ISR,IND,2020.0,57,139,-82
EST,SWE,2016.0,8,6,2
MWI,GBR,2015.0,14,10,4
AUS,VNM,2012.0,8,9,-1
AUT,IND,2021.0,8,10,-2
AUS,FJI,2021.0,7,6,1
USA,HKG,2006.0,74,109,-35
DEU,BRA,2014.0,60,80,-20
NLD,FRA,2002.0,67,82,-15
FIN,AUT,2020.0,18,6,12
CHE,NOR,2013.0,19,5,14
LBN,FRA,2017.0,44,95,-51
LUX,ITA,2021.0,5,8,-3
MLT,GBR,2002.0,2,3,-1
CHE,KOR,2019.0,13,11,2
JPN,DEU,2002.0,105,107,-2
IND,ISR,2014.0,68,19,49
CAN,ESP,2002.0,17,15,2
COL,CHL,2022.0,15,14,1
BRA,CHN,2017.0,9,7,2
JPN,DEU,2005.0,102,98,4
ESP,CAN,2019.0,76,44,32
PAK,IRL,2017.0,3,4,-1
AUT,IDN,2019.0,3,1,2
THA,NZL,2019.0,4,5,-1
HKG,TWN,2015.0,8,6,2
DEU,SWE,2022.0,61,61,0
TUR,NOR,2020.0,15,1,14
DEU,FIN,2019.0,54,55,-1
SGP,FIN,2018.0,6,4,2
EGY,ARE,2018.0,21,6,15
CHN,MAC,2017.0,55,44,11
SVK,ITA,2020.0,3,1,2
FRA,BEL,2021.0,159,142,17
IRQ,MYS,2019.0,21,141,-120
NLD,AUS,2021.0,52,75,-23
BRA,PRT,2003.0,20,23,-3
PAK,IRL,2019.0,9,6,3
ARE,NOR,2019.0,4,1,3
GBR,BGD,2019.0,21,14,7
JPN,FRA,2020.0,65,87,-22
MEX,CHN,2017.0,5,2,3
HUN,USA,2007.0,55,61,-6
ITA,GBR,1998.0,48,32,16
IND,NPL,2004.0,11,10,1
CHN,AUS,2002.0,42,25,17
SWE,DNK,2015.0,86,76,10
USA,ARG,2008.0,89,101,-12
FRA,GEO,2022.0,25,3,22
ITA,GBR,1997.0,22,22,0
KOR,PHL,2022.0,5,2,3
MYS,HKG,2020.0,5,4,1
BEL,NLD,2016.0,153,156,-3
CHN,GHA,2021.0,54,15,39
IRN,USA,2002.0,13,17,-4
TUN,PRT,2020.0,6,4,2
ITA,FRA,2002.0,146,199,-53
VEN,USA,2009.0,25,22,3
POL,FRA,2007.0,36,19,17
AUS,SVN,2014.0,1,1,0
IRL,HUN,2001.0,1,1,0
JPN,VNM,2001.0,3,1,2
USA,TWN,2003.0,262,174,88
DNK,NLD,2015.0,24,34,-10
DEU,RUS,2011.0,76,108,-32
GBR,POL,2014.0,45,135,-90
ITA,SGP,2017.0,10,6,4
VNM,KOR,2008.0,1,8,-7
USA,AUT,2012.0,105,117,-12
GBR,SGP,2012.0,102,69,33
MYS,CHN,2021.0,32,23,9
ITA,CMR,2011.0,2,2,0
CAN,ARE,2008.0,23,1,22
GBR,IND,2001.0,41,51,-10
KOR,CAN,2006.0,37,35,2
AUS,JOR,2013.0,7,6,1
BEL,CHE,2015.0,42,37,5
MYS,IDN,2018.0,89,15,74
CZE,JPN,2017.0,9,6,3
BEL,IND,1999.0,4,7,-3
ITA,CHE,1999.0,55,31,24
NLD,FRA,2005.0,74,83,-9
KEN,CAN,2012.0,2,4,-2
JPN,KOR,2016.0,114,95,19
CHN,TWN,2003.0,31,31,0
MYS,DEU,2017.0,17,3,14
ISR,GBR,2005.0,34,26,8
SGP,SWE,2015.0,8,5,3
PRT,BEL,2021.0,16,12,4
CIV,MDG,2016.0,1,1,0
SGP,IND,2010.0,30,51,-21
SWE,AUS,2004.0,34,23,11
HRV,DEU,2015.0,23,7,16
GBR,SWE,2001.0,48,53,-5
NOR,SAU,2017.0,1,1,0
RUS,CHE,2002.0,32,12,20
USA,IRL,1998.0,15,10,5
ISR,GBR,2002.0,26,23,3
CHE,POL,2008.0,8,15,-7
JPN,BRA,2003.0,18,4,14
DEU,ESP,1997.0,8,18,-10
ITA,JPN,2011.0,26,13,13
GBR,CZE,2001.0,18,19,-1
JOR,ARE,2012.0,19,1,18
UKR,POL,2002.0,22,13,9
AUS,BEL,2022.0,16,6,10
ESP,SWE,2021.0,59,43,16
LKA,CHE,2020.0,3,1,2
NLD,COL,2019.0,14,8,6
DNK,ITA,2018.0,24,50,-26
USA,SRB,2022.0,2,9,-7
KEN,ETH,2011.0,5,1,4
ESP,BGR,2017.0,5,1,4
CHN,MAC,2010.0,24,15,9
HRV,FRA,2015.0,7,7,0
CZE,BEL,2012.0,8,4,4
AUS,IRL,2018.0,34,30,4
ARE,IND,2012.0,4,23,-19
GRC,ESP,2010.0,16,9,7
GRC,ESP,2019.0,15,14,1
CHE,TZA,2019.0,5,12,-7
GBR,EGY,2003.0,16,17,-1
IND,MAR,2021.0,3,2,1
NGA,CHN,2018.0,19,9,10
ZAF,FIN,2019.0,4,1,3
CHE,SGP,2008.0,10,4,6
KAZ,TJK,2019.0,1,1,0
NOR,SWE,2007.0,26,64,-38
DEU,VNM,2008.0,3,3,0
AUS,ZAF,2021.0,16,36,-20
CZE,GRC,2020.0,3,6,-3
ZAF,ETH,2018.0,11,6,5
ITA,BRA,2002.0,23,16,7
ARG,JPN,2002.0,2,1,1
KOR,PRT,2014.0,3,6,-3
GBR,ARG,2000.0,4,5,-1
AUS,RUS,2021.0,5,11,-6
IND,ESP,2021.0,23,13,10
BRA,ZAF,2019.0,12,5,7
KOR,IRN,2022.0,3,14,-11
NZL,LKA,2022.0,3,3,0
VNM,USA,2022.0,26,13,13
KWT,GBR,2010.0,3,9,-6
KOR,TWN,2017.0,8,9,-1
KAZ,UZB,2019.0,5,1,4
PAK,CHE,2018.0,6,7,-1
DEU,USA,1998.0,347,296,51
VNM,GBR,2009.0,7,2,5
DEU,KEN,2009.0,5,4,1
ISL,USA,2018.0,10,16,-6
BGD,DEU,2011.0,8,4,4
MEX,ESP,2000.0,44,17,27
IND,POL,2015.0,10,14,-4
BEL,VNM,2019.0,13,8,5
HUN,FIN,2014.0,6,3,3
GHA,ZAF,2020.0,12,24,-12
JPN,EST,2015.0,2,2,0
BEL,HUN,2014.0,7,7,0
DEU,ARG,1999.0,5,8,-3
NZL,JPN,2022.0,2,4,-2
ESP,AUS,2013.0,47,13,34
LBN,CAN,2013.0,6,11,-5
CHN,BRA,2006.0,2,1,1
DEU,CHN,2001.0,62,88,-26
PER,PRT,2021.0,1,2,-1
IND,NZL,2004.0,8,1,7
ESP,CUB,2013.0,11,25,-14
ROU,PAK,2013.0,1,1,0
SWE,HUN,2002.0,11,8,3
BHR,GBR,2010.0,1,1,0
OMN,EGY,2016.0,4,4,0
HUN,CHE,2018.0,13,10,3
CIV,FRA,2006.0,19,16,3
ESP,BRA,2001.0,12,16,-4
LTU,ITA,2011.0,2,3,-1
CAN,KWT,2009.0,8,5,3
BWA,MWI,2006.0,1,1,0
EST,GBR,2006.0,4,1,3
ESP,CAN,2017.0,52,42,10
ARG,ITA,2004.0,20,9,11
USA,DZA,2003.0,5,3,2
PAK,USA,2007.0,37,35,2
FRA,TUN,2012.0,96,82,14
MEX,PER,2008.0,3,2,1
ISR,POL,2014.0,3,9,-6
ARG,COL,2007.0,5,3,2
GRC,CAN,2013.0,13,5,8
IRL,GRC,2014.0,3,5,-2
AUS,FIN,2005.0,10,7,3
USA,URY,2006.0,9,7,2
HND,USA,2012.0,2,1,1
NLD,BGD,2016.0,3,3,0
GBR,MEX,2006.0,41,20,21
HRV,BIH,2005.0,11,5,6
MYS,OMN,2007.0,1,2,-1
HUN,GBR,1999.0,9,6,3
NOR,ITA,2002.0,11,9,2
BEN,FRA,2018.0,9,11,-2
GBR,FIN,2006.0,29,21,8
AUS,GRC,2003.0,3,2,1
FRA,AUS,1998.0,6,9,-3
NLD,ESP,2008.0,52,48,4
CAN,ESP,2005.0,19,21,-2
ZAF,SAU,2015.0,6,3,3
NZL,AUS,2000.0,36,30,6
ITA,BEL,2001.0,18,27,-9
AUT,SWE,2000.0,2,1,1
MEX,RUS,2006.0,8,2,6
JPN,HKG,2003.0,10,9,1
CHE,HKG,2006.0,3,2,1
GUM,USA,2018.0,5,5,0
FRA,SWE,2001.0,29,41,-12
CHE,ZWE,2013.0,3,2,1
NLD,CHL,2015.0,12,8,4
ARE,EGY,2011.0,7,10,-3
DEU,FIN,2017.0,42,55,-13
USA,NGA,2007.0,15,17,-2
POL,UKR,2020.0,30,31,-1
HRV,BIH,2002.0,3,3,0
AUS,IRN,2002.0,8,2,6
BLR,USA,2014.0,8,2,6
CHN,UZB,2015.0,1,1,0
ARG,CAN,2004.0,12,15,-3
CAN,THA,2008.0,13,12,1
DEU,NGA,2008.0,8,6,2
HUN,ROU,2018.0,11,9,2
JPN,POL,2001.0,11,13,-2
FRA,IRL,2009.0,24,35,-11
DEU,ESP,1998.0,30,40,-10
RUS,MEX,2000.0,7,3,4
AUS,NOR,2003.0,4,7,-3
FRA,FIN,2009.0,13,9,4
SWE,FIN,1997.0,7,8,-1
TUR,FRA,2022.0,4,4,0
SWE,FIN,1998.0,7,22,-15
GBR,RUS,2020.0,40,48,-8
GTM,USA,2010.0,6,2,4
FRA,MCO,2004.0,13,2,11
USA,UKR,2016.0,12,29,-17
ISL,DNK,2006.0,5,2,3
HKG,FRA,2011.0,6,1,5
VNM,JPN,2007.0,5,10,-5
FIN,DNK,2005.0,9,8,1
MEX,CHN,2019.0,8,5,3
CHL,FRA,2013.0,24,29,-5
PRT,AUS,2011.0,3,5,-2
ZAF,USA,1998.0,15,10,5
PRT,DEU,2004.0,16,10,6
JPN,IRN,2007.0,12,7,5
DEU,MYS,2010.0,5,5,0
AUS,SGP,1999.0,17,7,10
CZE,ISR,1999.0,2,1,1
PER,USA,2012.0,23,25,-2
FRA,GUF,2009.0,8,15,-7
UKR,TUR,2000.0,5,1,4
BGD,SWE,2002.0,1,1,0
FRA,DNK,2014.0,27,30,-3
FRA,EGY,2012.0,15,5,10
AUS,PNG,2001.0,2,2,0
TWN,JPN,2003.0,17,34,-17
GBR,MOZ,2021.0,2,1,1
NZL,ZAF,2013.0,3,6,-3
DEU,DNK,1997.0,13,10,3
NLD,MEX,2005.0,3,4,-1
CHN,VNM,2014.0,10,7,3
USA,BGD,2012.0,19,35,-16
JPN,FIN,2022.0,6,3,3
BEL,VNM,2017.0,15,5,10
CAN,IRL,2014.0,30,42,-12
GBR,ISR,2005.0,26,34,-8
CUB,ESP,2001.0,20,12,8
BEL,SGP,2013.0,3,3,0
GBR,THA,2012.0,75,34,41
GBR,CYP,2009.0,25,3,22
PAK,DEU,2005.0,4,1,3
ITA,ZAF,2004.0,5,3,2
POL,JPN,2022.0,6,6,0
CHE,KOR,2017.0,10,20,-10
NOR,ITA,2005.0,3,14,-11
KEN,FRA,2012.0,4,3,1
HRV,GBR,2012.0,7,3,4
ZAF,BWA,2020.0,9,10,-1
FRA,TUR,2011.0,15,13,2
IND,NLD,2022.0,17,14,3
TUR,BEL,2011.0,11,2,9
LBN,FRA,2010.0,21,33,-12
IRQ,MYS,2010.0,10,2,8
PRT,ZAF,2005.0,5,2,3
LBN,FRA,2019.0,45,77,-32
BIH,DEU,2007.0,2,4,-2
NOR,ETH,2019.0,10,5,5
GRC,ESP,2017.0,14,26,-12
IRN,NZL,2011.0,2,1,1
NOR,ETH,2017.0,5,6,-1
THA,NZL,2017.0,3,7,-4
AUS,KEN,2020.0,7,8,-1
RUS,AUS,2018.0,13,9,4
COL,BRA,2009.0,10,8,2
ITA,KOR,2007.0,3,3,0
BRA,PRY,2013.0,6,1,5
CHE,TZA,2017.0,3,5,-2
LKA,AUS,2013.0,6,11,-5
LTU,USA,2016.0,4,7,-3
USA,UGA,2022.0,5,6,-1
PAK,NZL,2014.0,6,9,-3
PRT,CAN,2015.0,13,5,8
NOR,FIN,2021.0,15,22,-7
MWI,ZAF,2014.0,9,3,6
ISR,ESP,2022.0,2,8,-6
PER,GBR,2014.0,4,5,-1
ZAF,IRL,2017.0,6,2,4
QAT,FRA,2015.0,5,29,-24
BRA,ZAF,2017.0,5,3,2
CHN,FIN,2012.0,20,11,9
DNK,IDN,2015.0,1,1,0
FRA,ARG,2022.0,12,9,3
AUS,IRN,2005.0,11,7,4
THA,CAN,2021.0,7,9,-2
FRA,THA,2021.0,18,9,9
ZAF,NZL,2013.0,6,3,3
BRA,CHN,2019.0,21,1,20
USA,HTI,2017.0,11,5,6
ARE,PAK,2020.0,10,21,-11
KOR,BEL,2016.0,5,9,-4
ESP,UKR,2020.0,3,4,-1
GTM,USA,2019.0,15,9,6
GHA,NGA,2018.0,3,4,-1
POL,ESP,2020.0,22,14,8
GBR,GHA,2020.0,18,16,2
PRT,SAU,2015.0,6,1,5
JOR,MYS,2012.0,5,13,-8
IRQ,CHN,2019.0,2,16,-14
CAN,VNM,2019.0,4,4,0
RUS,KOR,2018.0,10,9,1
GRC,IRL,2009.0,6,2,4
CAN,IND,1999.0,15,20,-5
GBR,NGA,2001.0,7,8,-1
ROU,GBR,2004.0,10,5,5
HUN,CAN,2013.0,10,3,7
DEU,SVN,1998.0,1,1,0
FIN,KOR,2021.0,3,13,-10
MKD,SRB,2007.0,5,9,-4
GBR,BGD,2010.0,13,6,7
PER,CAN,2002.0,1,1,0
PHL,JPN,2007.0,9,5,4
CHE,GHA,2020.0,4,4,0
ESP,POL,2009.0,11,17,-6
PRT,ZAF,2002.0,1,1,0
IDN,USA,2015.0,13,26,-13
AUS,BWA,2020.0,1,2,-1
MAR,FRA,2012.0,42,92,-50
CHN,NGA,2012.0,5,4,1
DEU,ECU,2018.0,14,5,9
SWE,GRC,2018.0,6,22,-16
ARE,DNK,2018.0,2,3,-1
TUR,KOR,2012.0,2,1,1
HUN,ISR,2021.0,3,3,0
ISR,RUS,2003.0,13,17,-4
ISR,SGP,2011.0,4,2,2
FIN,DNK,2002.0,6,11,-5
GBR,ISR,2002.0,23,26,-3
CHE,PRT,2001.0,2,8,-6
USA,IRL,1997.0,10,7,3
NOR,AUS,2007.0,11,10,1
FRA,LUX,2005.0,14,4,10
POL,SVK,2016.0,4,5,-1
GUF,FRA,2011.0,11,21,-10
BFA,BEL,2007.0,1,2,-1
OMN,CAN,2013.0,6,16,-10
BOL,ARG,2020.0,1,1,0
LUX,DEU,2010.0,9,23,-14
TUN,CHE,2020.0,1,1,0
NLD,CZE,2006.0,3,2,1
CHN,QAT,2020.0,2,2,0
FRA,HKG,2016.0,6,10,-4
TUR,SGP,2015.0,5,2,3
ECU,DEU,2021.0,5,6,-1
SAU,SDN,2005.0,3,3,0
LTU,GBR,2016.0,10,7,3
EGY,BHR,2016.0,2,2,0
SGP,KOR,2003.0,4,8,-4
AUT,SVK,2012.0,8,6,2
ESP,NZL,2022.0,2,2,0
PER,FRA,2021.0,3,3,0
CZE,BGR,2011.0,1,1,0
ISR,JPN,2018.0,6,2,4
PSE,USA,2021.0,4,3,1
USA,MUS,2005.0,1,1,0
HRV,ITA,2000.0,1,4,-3
BGD,CHE,2003.0,1,3,-2
NGA,USA,2007.0,17,15,2
FRA,SVN,2006.0,3,1,2
FIN,CAN,2001.0,8,10,-2
BLR,DEU,2007.0,11,2,9
NLD,IRL,2001.0,4,4,0
MAR,USA,2005.0,7,3,4
MYS,GBR,2000.0,5,11,-6
USA,GRD,2006.0,4,1,3
DEU,ARE,2002.0,5,1,4
HUN,NZL,2008.0,2,1,1
OMN,IND,2012.0,8,7,1
SAU,SDN,2002.0,3,2,1
IND,PAK,2012.0,18,31,-13
GRC,AUS,2015.0,9,2,7
VEN,FRA,2007.0,6,7,-1
EGY,FRA,2005.0,5,6,-1
CHN,PRI,2005.0,1,2,-1
NOR,ESP,1998.0,1,1,0
NOR,RUS,2005.0,6,8,-2
AUT,SVN,2011.0,2,5,-3
HRV,CHE,2004.0,6,1,5
USA,BMU,2010.0,2,2,0
AUT,MEX,2005.0,2,1,1
DNK,PRT,2018.0,4,11,-7
ESP,MAR,2004.0,3,8,-5
NLD,KEN,2014.0,4,4,0
ITA,DNK,2007.0,13,9,4
TUR,RUS,2003.0,5,6,-1
GEO,USA,2011.0,11,13,-2
MYS,SGP,2011.0,13,21,-8
BRA,ITA,2012.0,18,44,-26
ETH,USA,2006.0,5,6,-1
GBR,MWI,2014.0,6,17,-11
SRB,POL,2010.0,1,1,0
NOR,ETH,2010.0,2,2,0
BEL,PAK,2013.0,4,1,3
DNK,AUT,2003.0,4,2,2
HUN,NLD,2012.0,10,4,6
LTU,LVA,2008.0,3,1,2
DEU,HKG,2011.0,7,8,-1
NLD,COL,2010.0,1,3,-2
PER,COL,2007.0,1,2,-1
MEX,CUB,2000.0,3,9,-6
COL,NOR,2013.0,2,1,1
NLD,COL,2017.0,8,8,0
ETH,NGA,2017.0,2,3,-1
CHN,POL,2022.0,9,8,1
HKG,IRL,2010.0,3,1,2
ZAF,ARE,2007.0,1,1,0
RUS,PAK,2020.0,2,1,1
DNK,SGP,2014.0,4,7,-3
SGP,IRL,2012.0,3,6,-3
BEN,USA,2019.0,2,1,1
BWA,GBR,2018.0,1,8,-7
BGR,CHE,2010.0,4,6,-2
ROU,HUN,2012.0,3,7,-4
GRC,TUR,2012.0,3,2,1
THA,NZL,2010.0,5,3,2
SVK,GBR,2018.0,7,6,1
HKG,NZL,2017.0,9,7,2
SLV,MEX,2019.0,1,1,0
NPL,PAK,2020.0,2,2,0
SWE,CZE,2022.0,4,6,-2
MEX,CHN,2010.0,1,2,-1
KWT,USA,2022.0,5,6,-1
GBR,YEM,2011.0,2,1,1
USA,LUX,2012.0,3,5,-2
AGO,BRA,2021.0,2,2,0
CYP,ITA,2012.0,2,1,1
PAK,SGP,2021.0,5,4,1
BRA,MEX,2022.0,6,3,3
JPN,LUX,2016.0,1,2,-1
CAN,MAR,2007.0,4,4,0
USA,MOZ,2011.0,2,2,0
IRN,SGP,2014.0,9,5,4
BEL,VNM,2010.0,4,1,3
PRK,CHN,2016.0,3,4,-1
DEU,LIE,2008.0,3,2,1
HKG,NZL,2010.0,2,2,0
DEU,CUB,2002.0,1,4,-3
AUT,DNK,2005.0,4,2,2
ITA,SRB,2004.0,4,3,1
CHN,TJK,2020.0,1,1,0
ITA,SGP,2019.0,6,9,-3
DEU,DNK,1998.0,10,9,1
AUT,DNK,2002.0,4,6,-2
MEX,NZL,2004.0,2,1,1
HTI,USA,2003.0,1,1,0
AUS,KOR,1999.0,6,4,2
RUS,IRN,2006.0,5,2,3
SGP,QAT,2015.0,6,1,5
IRQ,CHN,2010.0,1,5,-4
AUT,CHN,2016.0,8,21,-13
IND,PRI,2013.0,2,1,1
FRA,COL,2006.0,7,4,3
RUS,BEL,2018.0,13,8,5
USA,AFG,2016.0,1,2,-1
SAU,ZAF,2021.0,1,2,-1
LAO,JPN,2016.0,1,2,-1
IRL,KOR,2019.0,1,5,-4
FRA,NOR,2001.0,9,12,-3
CAN,RUS,2000.0,4,22,-18
THA,PHL,2019.0,4,3,1
ETH,NGA,2019.0,4,1,3
KWT,GBR,2019.0,7,16,-9
KOR,ZAF,2010.0,2,1,1
BGR,CHE,2019.0,2,1,1
SVN,CAN,2012.0,1,1,0
GBR,BGD,2017.0,17,21,-4
NLD,LUX,2012.0,5,3,2
CAN,LBN,2011.0,3,10,-7
LKA,USA,2000.0,5,1,4
NOR,CYP,2016.0,1,1,0
IDN,GBR,1999.0,1,1,0
POL,FIN,2003.0,2,3,-1
RUS,BLR,2000.0,7,6,1
BRA,CHL,2002.0,3,3,0
KOR,BGD,2005.0,2,7,-5
AUT,ITA,1999.0,8,4,4
PRT,SWE,2007.0,6,5,1
TUN,QAT,2011.0,1,1,0
THA,AUS,1999.0,2,2,0
ROU,CAN,2016.0,4,4,0
ESP,SRB,2003.0,8,3,5
AUT,RUS,2015.0,5,8,-3
SGP,NLD,2006.0,5,2,3
ITA,SGP,2010.0,3,3,0
ARE,OMN,2009.0,2,1,1
COG,COD,2002.0,1,3,-2
USA,TTO,2006.0,3,4,-1
IRN,IND,2007.0,2,9,-7
URY,BRA,2009.0,4,4,0
IND,BRN,2009.0,2,1,1
USA,CUB,2008.0,5,4,1
NLD,JPN,1997.0,4,2,2
CHE,CHN,2000.0,2,7,-5
DNK,ROU,2019.0,3,3,0
EGY,IND,2006.0,2,1,1
TUR,AUT,2003.0,4,1,3
EST,FIN,2013.0,5,7,-2
HKG,IND,2013.0,7,7,0
CHE,ZAF,2000.0,3,1,2
NLD,KWT,2018.0,1,1,0
BLR,NZL,2018.0,1,1,0
CAN,COL,2009.0,3,7,-4
MEX,PRT,2012.0,2,3,-1
ISR,ITA,2016.0,14,18,-4
CHE,TWN,2016.0,5,4,1
URY,MEX,2021.0,1,4,-3
MYS,NOR,2013.0,2,1,1
NGA,BEL,2011.0,2,1,1
CAN,VNM,2017.0,6,3,3
FRA,CHL,2022.0,12,15,-3
BTN,IND,2013.0,1,1,0
BRA,SGP,2018.0,3,2,1
IDN,CAN,2022.0,1,1,0
BEL,COL,2014.0,3,1,2
CHN,SVN,2018.0,1,2,-1
DEU,MYS,2019.0,5,11,-6
PSE,SAU,2019.0,1,4,-3
ESP,ARE,2021.0,6,2,4
NLD,MEX,2002.0,5,6,-1
FRA,LUX,2002.0,2,4,-2
HKG,PHL,2016.0,4,3,1
CHL,KOR,2012.0,1,1,0
TUN,ESP,2011.0,3,4,-1
ZAF,IRL,2010.0,4,4,0
CZE,RUS,2008.0,9,7,2
CHE,KOR,2010.0,11,4,7
CHL,MEX,2007.0,4,10,-6
SGP,FRA,2005.0,4,3,1
UKR,BEL,2008.0,2,1,1
AFG,USA,2015.0,4,2,2
KEN,NGA,2001.0,1,1,0
KEN,LKA,2016.0,1,1,0
IND,ZAF,1997.0,1,1,0
CHE,CZE,2001.0,3,5,-2
SEN,USA,2010.0,4,5,-1
EGY,QAT,2004.0,5,1,4
ZMB,NGA,2009.0,2,1,1
DEU,BLR,2005.0,3,10,-7
SVN,MKD,2010.0,1,1,0
AUS,MAC,2021.0,2,1,1
FIN,LUX,2011.0,1,1,0
VNM,DEU,2008.0,3,3,0
CHE,HRV,2021.0,2,3,-1
FRA,MDA,2011.0,1,3,-2
ARM,FRA,1999.0,1,1,0
LBN,DEU,2013.0,5,2,3
EGY,BEL,2015.0,4,10,-6
ARE,PRT,2022.0,2,1,1
NLD,BGR,2015.0,3,1,2
KWT,GBR,2017.0,5,6,-1
EST,ITA,2020.0,2,6,-4
GTM,MEX,2016.0,4,3,1
MEX,HND,2018.0,2,2,0
ARG,NLD,2015.0,4,2,2
KEN,RWA,2017.0,1,2,-1
GAB,FRA,2021.0,2,1,1
ROU,PRT,2021.0,1,1,0
TWN,IRN,2011.0,1,2,-1
BRA,DEU,1998.0,6,9,-3
CAN,GHA,2022.0,1,5,-4
MEX,MAR,2021.0,1,1,0
IND,FJI,2015.0,2,1,1
ZAF,BEL,2016.0,5,11,-6
MYS,DNK,2022.0,1,1,0
IRL,PAK,2021.0,2,10,-8
MEX,BRA,2000.0,3,2,1
SEN,USA,2017.0,3,6,-3
USA,KHM,2021.0,3,1,2
BHR,GBR,2017.0,3,9,-6
CAN,TTO,2020.0,3,2,1
GBR,LTU,2009.0,2,7,-5
MYS,IND,1998.0,1,2,-1
CIV,USA,2006.0,1,2,-1
JPN,SAU,2002.0,1,1,0
DNK,FRO,2003.0,2,2,0
THA,NLD,2014.0,6,12,-6
ITA,SVK,2006.0,2,3,-1
SWE,EGY,2011.0,1,5,-4
ERI,USA,2019.0,2,1,1
SWE,TUN,2018.0,1,4,-3
ITA,TWN,2020.0,1,3,-2
PRT,ARG,2021.0,1,1,0
IND,MYS,1999.0,7,1,6
BWA,IND,2007.0,1,1,0
ARM,KOR,2019.0,1,1,0
CZE,AUT,2009.0,3,7,-4
MNE,SVN,2017.0,1,2,-1
PAK,HKG,2020.0,6,9,-3
KEN,RWA,2019.0,6,5,1
ZAF,PRT,2014.0,1,2,-1
ITA,CUB,2020.0,1,5,-4
ETH,NGA,2010.0,2,2,0
AUT,ROU,2009.0,1,2,-1
PAK,IRL,2010.0,1,2,-1
DEU,AZE,2014.0,2,1,1
CHL,VEN,2022.0,1,6,-5
MEX,SWE,2014.0,6,4,2
ARE,CHE,2019.0,2,1,1
DEU,SEN,2020.0,1,1,0
SWE,TZA,2009.0,3,3,0
BIH,USA,2010.0,1,1,0
AUS,FIN,2002.0,10,3,7
DEU,PAN,2010.0,1,2,-1
FRA,AUS,1997.0,5,1,4
DEU,BLR,2002.0,8,15,-7
NGA,CHE,2003.0,2,1,1
ITA,IRL,2003.0,4,5,-1
BRN,AUS,2002.0,2,1,1
BRA,VEN,2004.0,2,2,0
URY,USA,2022.0,4,4,0
KWT,QAT,2020.0,1,1,0
DEU,CRI,1998.0,1,1,0
GBR,UKR,1999.0,3,9,-6
USA,BLR,2008.0,4,3,1
JPN,ARE,2013.0,2,1,1
PAK,TUR,2013.0,3,4,-1
EGY,IRL,2016.0,1,1,0
LAO,CHE,2016.0,2,2,0
EGY,NLD,2007.0,2,3,-1
MAR,BEL,2013.0,2,4,-2
TTO,IND,2013.0,1,3,-2
QAT,SGP,2015.0,1,6,-5
VNM,FIN,2019.0,2,2,0
BRA,FJI,2017.0,1,1,0
ISR,SWE,2003.0,2,1,1
SEN,BFA,2016.0,6,1,5
SAU,NGA,2002.0,1,2,-1
CYP,TUR,2003.0,1,1,0
HUN,DNK,2006.0,2,4,-2
IRL,ARE,2019.0,4,1,3
IND,HUN,2014.0,3,1,2
AUT,CYP,2022.0,1,1,0
ARG,PRI,2010.0,1,2,-1
BRA,DEU,1997.0,10,5,5
GRC,PRT,2020.0,1,3,-2
FRA,IDN,2008.0,4,2,2
POL,ARE,2021.0,1,2,-1
ITA,MAR,2006.0,3,1,2
USA,BRB,2001.0,1,1,0
CAN,EST,2002.0,2,1,1
KAZ,VNM,2021.0,1,1,0
MAR,QAT,2018.0,2,1,1
CUB,RUS,2017.0,2,1,1
ISL,FRA,2013.0,1,5,-4
KOR,ZAF,2017.0,3,1,2
USA,FSM,2018.0,1,1,0
OMN,USA,2018.0,1,3,-2
KAZ,BLR,2014.0,2,1,1
LTU,CAN,2015.0,2,2,0
MYS,QAT,2022.0,2,1,1
MEX,MYS,2011.0,1,1,0
DNK,CHL,2014.0,1,1,0
CHE,MYS,2016.0,2,1,1
LBN,GBR,2011.0,4,6,-2
ARE,GRC,2020.0,3,5,-2
UGA,EGY,2018.0,1,1,0
GBR,VEN,2011.0,3,1,2
MAR,ZAF,2005.0,1,1,0
IRN,RUS,2007.0,1,7,-6
UZB,DEU,2014.0,3,3,0
MLI,USA,2016.0,1,10,-9
TWN,IRL,2013.0,3,1,2
DEU,ARE,2005.0,1,1,0
SRB,CAN,2014.0,1,2,-1
DNK,ROU,2017.0,2,4,-2
GAB,USA,2021.0,1,2,-1
RWA,SWE,2021.0,1,1,0
BRA,CHN,2010.0,1,3,-2
FIN,GRC,2012.0,1,5,-4
CHN,KAZ,2015.0,2,1,1
BGR,DNK,2007.0,2,1,1
BHR,GBR,2019.0,1,3,-2
USA,EST,1999.0,2,1,1
JOR,EGY,2012.0,1,1,0
ARE,IRN,2008.0,1,1,0
SWE,HUN,2005.0,2,6,-4
USA,BLZ,2014.0,1,2,-1
AZE,DEU,2011.0,1,1,0
NOR,CZE,2008.0,2,3,-1
UGA,ZAF,2007.0,3,1,2
MYS,IND,1997.0,1,1,0
DNK,HUN,2012.0,2,4,-2
USA,PNG,2004.0,1,2,-1
IRL,ZAF,2012.0,2,1,1
LUX,RUS,2016.0,1,1,0
NLD,MAC,2013.0,1,1,0
CRI,CAN,2017.0,1,6,-5
BHR,EGY,2021.0,2,3,-1
IRL,KOR,2017.0,1,6,-5
SWE,HKG,2013.0,2,5,-3
UGA,KOR,2020.0,1,2,-1
DEU,BIH,2019.0,1,2,-1
BRA,IND,2014.0,6,22,-16
AUT,MYS,2015.0,1,1,0
CZE,EGY,2016.0,4,1,3
VNM,NZL,2020.0,2,1,1
AUT,IDN,2010.0,3,2,1
ECU,SWE,2013.0,1,1,0
SYR,DEU,2006.0,1,2,-1
AUT,LTU,2022.0,1,3,-2
NPL,AUS,2008.0,1,1,0
NLD,EGY,2013.0,1,2,-1
AUS,LKA,2007.0,1,6,-5
DZA,ITA,2009.0,1,3,-2
COL,JPN,2015.0,2,2,0
MYS,PRT,2015.0,1,1,0
FRA,MLT,2018.0,1,1,0
PHL,SGP,2018.0,2,4,-2
VNM,THA,2008.0,2,2,0
IDN,SWE,2014.0,1,1,0
FRA,HRV,2006.0,2,1,1
ZMB,NLD,2018.0,1,2,-1
COL,ITA,2008.0,2,1,1
AUS,ECU,2021.0,3,3,0
QAT,CHE,2017.0,1,5,-4
FIN,VNM,2019.0,2,2,0
CHL,GRC,2022.0,1,1,0
EGY,IRN,2016.0,2,3,-1
SGP,PRT,2014.0,1,2,-1
SEN,GHA,2021.0,1,1,0
SDN,ZAF,2021.0,1,1,0
PRT,KOR,2013.0,1,3,-2
THA,BGD,2012.0,1,3,-2
ARE,BRN,2018.0,1,1,0
PSE,SAU,2017.0,2,3,-1
PRI,DEU,2001.0,1,1,0
FJI,JPN,2021.0,1,1,0
GEO,UKR,2020.0,1,1,0
SAU,NGA,2005.0,2,1,1
NLD,UKR,2003.0,1,3,-2
ALB,ITA,2008.0,1,1,0
NLD,HRV,2019.0,2,6,-4
ZAF,FIN,2017.0,1,3,-2
BHR,CAN,2008.0,1,1,0
BGR,AUT,2009.0,1,1,0
BGR,ISR,2000.0,1,2,-1
ITA,LTU,2003.0,1,3,-2
MLT,DEU,2019.0,1,1,0
URY,ARG,2001.0,1,3,-2
IND,EST,2022.0,2,3,-1
ARG,ISR,2016.0,1,1,0
PRT,JPN,2001.0,1,2,-1
CRI,VEN,2012.0,1,1,0
RUS,PHL,2022.0,1,1,0
SWZ,ZAF,2010.0,2,2,0
MLT,DEU,2017.0,1,1,0
SVK,FRA,2013.0,1,4,-3
SGP,FRA,2002.0,2,7,-5
SRB,DNK,2014.0,2,2,0
MAR,CAN,2013.0,2,7,-5
ISR,GRC,2008.0,1,3,-2
HKG,IRL,2019.0,2,2,0
TWN,MYS,2022.0,3,6,-3
UZB,ITA,2008.0,1,1,0
ITA,UZB,2009.0,1,1,0
NGA,SWE,2009.0,2,1,1
BEL,LBN,2014.0,1,5,-4
MLT,GBR,2005.0,1,3,-2
KOR,KEN,2019.0,1,1,0
DNK,ISR,2015.0,1,1,0
DMA,USA,2020.0,1,1,0
KOR,ISR,2000.0,1,1,0
SGP,BGD,2015.0,2,1,1
BIH,USA,2017.0,1,2,-1
BLR,FIN,2003.0,1,3,-2
SAU,FRA,2006.0,1,2,-1
SAU,OMN,2022.0,1,1,0
COL,AUS,2006.0,1,2,-1
ITA,LVA,2014.0,1,1,0
NZL,ARG,2018.0,1,2,-1
CMR,NGA,2006.0,2,2,0
PER,CAN,2005.0,1,2,-1
SVN,MKD,2019.0,1,3,-2
POL,BRA,2003.0,1,2,-1
CZE,AUS,2004.0,1,1,0
POL,LBY,2010.0,1,1,0
FRA,BGR,2006.0,1,5,-4
HKG,IRL,2017.0,1,3,-2
MOZ,USA,2022.0,1,3,-2
BGR,TUR,2018.0,1,1,0
ITA,ROU,2022.0,1,4,-3
NOR,IRN,2002.0,1,1,0
RUS,ZAF,2013.0,1,1,0
IRQ,FRA,2020.0,1,9,-8
NAM,ZAF,2009.0,1,1,0
SWE,QAT,2013.0,1,1,0
BGR,SWE,2013.0,1,2,-1
DZA,TUR,2018.0,1,1,0
ETH,AUT,2016.0,1,2,-1
IRQ,PAK,2012.0,1,1,0
VEN,ARG,2001.0,1,5,-4
DEU,BIH,2010.0,1,3,-2
TUR,LTU,2020.0,1,1,0
ESP,BGR,2010.0,1,2,-1
ITA,FRA,2005.0,194,137,57
DEU,FIN,2010.0,34,38,-4
SGP,CHN,2010.0,141,177,-36
HKG,CAN,2007.0,20,23,-3
ROU,NLD,2007.0,3,4,-1
ITA,BRA,2005.0,23,17,6
GBR,HKG,2001.0,29,21,8
GBR,CAN,2006.0,284,236,48
SAU,EGY,2019.0,206,207,-1
CAN,NZL,2002.0,23,27,-4
UKR,POL,2005.0,15,8,7
SAU,EGY,2010.0,58,183,-125
DNK,IRL,2021.0,7,12,-5
DEU,USA,1997.0,195,196,-1
ESP,ITA,2017.0,140,167,-27
HKG,AUS,2008.0,34,21,13
IRQ,MYS,2017.0,12,109,-97
GTM,USA,2017.0,9,3,6
LTU,DEU,2013.0,5,10,-5
JOR,USA,2015.0,23,52,-29
SAU,EGY,2017.0,154,147,7
SWE,CAN,2013.0,32,43,-11
TUR,USA,2001.0,94,111,-17
IRN,KOR,2020.0,25,6,19
BEL,GRC,2015.0,11,18,-7
POL,NLD,2013.0,16,31,-15
FRA,GBR,1999.0,97,97,0
CZE,GBR,2003.0,19,33,-14
CHL,CAN,2009.0,11,8,3
CHE,TUR,2011.0,11,17,-6
ESP,ITA,2010.0,89,190,-101
DNK,FIN,2012.0,8,13,-5
FRA,IRN,2012.0,15,20,-5
FRA,RUS,2001.0,33,53,-20
PHL,USA,2012.0,20,41,-21
KAZ,UZB,2017.0,1,2,-1
ITA,AUS,2022.0,12,14,-2
USA,SWE,2005.0,155,188,-33
ZAF,USA,1997.0,5,4,1
DEU,HUN,2011.0,22,42,-20
EST,DEU,2012.0,3,4,-1
FRA,ROU,2008.0,43,23,20
RUS,CHE,2005.0,19,11,8
EST,CZE,2014.0,1,4,-3
ESP,CAN,2010.0,40,47,-7
DEU,SRB,2005.0,11,10,1
ITA,CHN,2008.0,14,11,3
GBR,ESP,2000.0,56,57,-1
MAR,USA,2002.0,11,4,7
BRA,BEL,2004.0,7,8,-1
FRA,GLP,2006.0,10,17,-7
REU,FRA,2012.0,17,15,2
SRB,USA,1999.0,10,1,9
FRA,PYF,2012.0,11,5,6
CZE,JPN,2010.0,4,6,-2
MLI,FRA,2004.0,3,5,-2
ESP,EGY,2009.0,11,3,8
BRN,AUS,2005.0,3,1,2
KWT,AUS,2002.0,1,3,-2
NOR,RUS,2002.0,7,12,-5
ZAF,IRL,2019.0,3,1,2
TUR,ARE,2012.0,2,1,1
EGY,ESP,2003.0,2,1,1
CAN,GRC,2001.0,8,4,4
KOR,ZAF,2019.0,3,7,-4
NOR,SAU,2019.0,3,5,-2
VEN,GBR,2017.0,1,2,-1
IRL,SAU,2012.0,3,3,0
NLD,NPL,2016.0,4,2,2
CHN,PHL,2012.0,3,5,-2
FRA,CHN,1998.0,11,7,4
NOR,EST,2020.0,2,3,-1
UGA,CHE,2019.0,3,1,2
CAN,LKA,2018.0,11,2,9
CRI,CAN,2019.0,8,2,6
SVK,CZE,2008.0,34,8,26
BGR,FRA,2013.0,4,7,-3
KOR,TWN,2019.0,14,4,10
GBR,ETH,2018.0,6,10,-4
FRA,BEN,2004.0,4,3,1
NLD,HRV,2010.0,1,2,-1
NLD,JPN,1998.0,6,3,3
ARE,JOR,2022.0,8,9,-1
VEN,GBR,2010.0,5,1,4
BEL,KEN,2021.0,2,2,0
GRC,ITA,1999.0,8,5,3
ESP,COL,1998.0,3,1,2
AUT,UKR,2004.0,4,4,0
PAK,EGY,2022.0,1,7,-6
PHL,THA,2009.0,1,3,-2
IRL,SWE,2020.0,7,12,-5
USA,BWA,2012.0,8,11,-3
AZE,IRN,2018.0,3,4,-1
RUS,AZE,2015.0,3,2,1
CHE,SWE,1999.0,6,10,-4
THA,PHL,2017.0,1,4,-3
SWZ,ZAF,2019.0,4,9,-5
COL,AUT,2021.0,2,2,0
CZE,JPN,2019.0,7,8,-1
MYS,DEU,2019.0,11,5,6
CUB,USA,2004.0,6,4,2
GBR,LBY,2003.0,2,1,1
USA,LTU,2012.0,5,3,2
NLD,ISR,2000.0,1,4,-3
CHE,GRC,2003.0,10,9,1
THA,PHL,2010.0,2,3,-1
SVK,SLV,2008.0,2,1,1
FRA,CHN,1997.0,3,2,1
BEL,BRA,2000.0,1,2,-1
DEU,SRB,2002.0,2,16,-14
KOR,TWN,2010.0,9,16,-7
DEU,BIH,2017.0,2,7,-5
IRN,TUR,2005.0,2,1,1
RUS,SVK,2018.0,3,2,1
FRA,EST,2014.0,4,3,1
CRI,ESP,2003.0,2,2,0
CAN,IDN,2014.0,2,2,0
ESP,SGP,2021.0,4,2,2
BEN,JPN,2009.0,1,1,0
NLD,HRV,2017.0,1,4,-3
NOR,BEL,2009.0,4,3,1
SEN,USA,2019.0,4,2,2
IRN,POL,2014.0,2,2,0
LTU,POL,2017.0,1,1,0
PAK,CZE,2020.0,2,2,0
ZAF,PNG,2008.0,1,1,0
JPN,CHL,2005.0,2,3,-1
CAN,URY,2015.0,1,1,0
LVA,LTU,2022.0,2,1,1
TJK,DEU,2019.0,2,1,1
THA,FIN,2011.0,1,2,-1
TUR,KAZ,2015.0,2,4,-2
BEL,ARE,2019.0,4,1,3
ZAF,ESP,2016.0,3,9,-6
UGA,CHE,2017.0,3,2,1
BEL,UKR,2003.0,2,4,-2
ZMB,USA,2004.0,2,4,-2
TZA,SWE,2004.0,2,1,1
BHR,IND,2020.0,1,5,-4
NOR,ESP,1997.0,1,2,-1
SWZ,ZAF,2017.0,2,5,-3
SRB,GBR,2015.0,3,9,-6
MEX,CZE,2007.0,2,3,-1
BGD,MYS,2004.0,1,2,-1
NLD,SRB,2011.0,1,1,0
ARE,PSE,2006.0,1,2,-1
IRQ,CHN,2017.0,2,7,-5
QAT,BEL,2014.0,1,2,-1
KWT,ARE,2006.0,1,2,-1
IND,TUR,2012.0,4,2,2
BRA,IRL,2008.0,4,3,1
DEU,CUB,2005.0,2,4,-2
CHN,ZWE,2016.0,2,1,1
VEN,CAN,2000.0,1,3,-2
ISL,ITA,2012.0,1,1,0
KHM,CHN,2011.0,1,1,0
IRL,ARE,2017.0,2,1,1
SGP,ETH,2021.0,2,1,1
CZE,LBN,2021.0,1,1,0
SVN,ESP,2011.0,1,2,-1
CAN,CIV,2016.0,1,2,-1
PRT,BGD,2019.0,1,1,0
BFA,TGO,2014.0,1,3,-2
AUS,PER,2009.0,1,1,0
RUS,,2020.0,13598,0,13598
,ESP,2007.0,13224,0,13224
GBR,,2020.0,23269,0,23269
ITA,,2023.0,54657,0,54657
KEN,,2024.0,2711,0,2711
SVN,,2024.0,4128,0,4128
,NOR,2008.0,1892,0,1892
BRA,,2014.0,8004,0,8004
EST,,2024.0,2124,0,2124
,USA,1994.0,90428,0,90428
ESP,,2011.0,5698,0,5698
IRN,,2018.0,5651,0,5651
,CAN,2008.0,11441,0,11441
POL,,2020.0,5742,0,5742
,FIN,2001.0,2200,0,2200
,AUT,2002.0,1971,0,1971
,AUT,2005.0,2104,0,2104
KHM,,2013.0,17,0,17
HUN,,2012.0,671,0,671
JOR,,2024.0,4034,0,4034
SAU,,2012.0,297,0,297
ZAF,,2008.0,475,0,475
PER,,2012.0,110,0,110
,BGR,2010.0,540,0,540
EST,SVK,2018.0,1,0,1
JAM,,2020.0,53,0,53
,IND,2007.0,19869,0,19869
,ISR,1995.0,1577,0,1577
,CIV,2009.0,146,0,146
MNE,,2024.0,219,0,219
,CHE,2016.0,4440,0,4440
,BRA,2013.0,20211,0,20211
AUS,,2003.0,1016,0,1016
,POL,2011.0,6916,0,6916
SVK,,2011.0,338,0,338
,GEO,2004.0,166,0,166
SDN,,2021.0,130,0,130
,HKG,1995.0,791,0,791
,GEO,1996.0,76,0,76
LTU,FIN,2008.0,4,0,4
,CHL,2010.0,1933,0,1933
CHL,,2016.0,1065,0,1065
MAR,,2009.0,183,0,183
BEL,MAR,2012.0,7,0,7
PSE,,2023.0,390,0,390
PAK,,2008.0,253,0,253
,NGA,1999.0,853,0,853
LKA,,2011.0,55,0,55
,MYS,2009.0,4516,0,4516
COL,,2007.0,95,0,95
GRC,NOR,2012.0,5,0,5
ARG,PRT,2018.0,2,0,2
AUT,,2015.0,1649,0,1649
,ALB,2003.0,16,0,16
DNK,TUR,2003.0,1,0,1
RUS,NZL,2009.0,1,0,1
,MLI,2014.0,69,0,69
,GRC,2015.0,2118,0,2118
QAT,,2015.0,62,0,62
,HUN,2013.0,1479,0,1479
,BFA,2008.0,99,0,99
ZAF,OMN,2002.0,2,0,2
,BGR,2017.0,476,0,476
RUS,ETH,2015.0,4,0,4
,TUN,2014.0,1493,0,1493
,ETH,2008.0,226,0,226
LBN,,2016.0,124,0,124
,UZB,2015.0,96,0,96
BWA,,2022.0,133,0,133
,CHL,2017.0,2073,0,2073
PER,KOR,2012.0,1,0,1
AUT,VNM,2018.0,3,0,3
PNG,,2021.0,57,0,57
,MDG,2014.0,76,0,76
,BGR,2019.0,180,0,180
,CYP,2012.0,139,0,139
CMR,AUS,2015.0,1,0,1
SWE,VNM,2022.0,2,0,2
OMN,,2005.0,26,0,26
,SWZ,2013.0,8,0,8
SWZ,,2022.0,30,0,30
,CHL,2019.0,855,0,855
,JAM,1999.0,83,0,83
RUS,NGA,2015.0,1,0,1
,LTU,2016.0,475,0,475
,NAM,2015.0,33,0,33
FSM,,2019.0,6,0,6
,UGA,2016.0,349,0,349
CRI,,2021.0,196,0,196
,CMR,1999.0,141,0,141
,SLE,2018.0,30,0,30
,NIC,2018.0,14,0,14
,SEN,2018.0,72,0,72
COL,BEL,2022.0,5,0,5
,PAN,2004.0,31,0,31
,BEN,2011.0,108,0,108
IND,CZE,2004.0,1,0,1
,IRQ,1999.0,61,0,61
TUR,IRN,2008.0,3,0,3
LIE,SWE,2014.0,1,0,1
BTN,,2011.0,2,0,2
PRT,DNK,2004.0,3,0,3
,LUX,2006.0,58,0,58
PYF,GBR,2010.0,1,0,1
VNM,PHL,2020.0,1,0,1
POL,PRI,2020.0,1,0,1
PRI,,2002.0,10,0,10
DNK,ARG,1998.0,1,0,1
,PAN,1996.0,6,0,6
USA,GAB,2011.0,2,0,2
,ISL,1995.0,69,0,69
AZE,KAZ,2012.0,1,0,1
GEO,NLD,2016.0,1,0,1
LBR,,2020.0,19,0,19
,TGO,2007.0,38,0,38
RUS,LUX,2022.0,2,0,2
SRB,,2007.0,110,0,110
,COG,2013.0,99,0,99
AUT,IDN,2017.0,4,0,4
USA,MMR,2018.0,3,0,3
,GIN,2008.0,7,0,7
CHE,ETH,2004.0,1,0,1
UKR,CAN,2022.0,1,0,1
,BGD,1995.0,100,0,100
MEX,FIN,2003.0,2,0,2
POL,MNG,2017.0,1,0,1
,NER,2000.0,10,0,10
ISL,,2011.0,38,0,38
PRI,,2005.0,27,0,27
TUR,PSE,2006.0,1,0,1
,ZMB,1995.0,15,0,15
BFA,,2007.0,8,0,8
SEN,,2003.0,13,0,13
REU,,2020.0,7,0,7
BGD,SWE,2005.0,2,0,2
JPN,GRC,2003.0,6,0,6
IND,ROU,2004.0,1,0,1
BFA,CMR,2021.0,1,0,1
,GUY,2008.0,7,0,7
NZL,ARE,2012.0,4,0,4
CAF,,2008.0,3,0,3
GUF,,2007.0,5,0,5
BRA,CHL,2005.0,10,0,10
ROU,ISL,2001.0,1,0,1
HUN,YEM,2010.0,1,0,1
FIN,OMN,2018.0,1,0,1
BEL,LTU,2005.0,4,0,4
FIN,ROU,2000.0,1,0,1
SEN,NCL,2004.0,2,0,2
OMN,,2002.0,2,0,2
KEN,COL,2011.0,1,0,1
GUF,GAB,2008.0,1,0,1
CZE,CAN,2000.0,8,0,8
ISL,DEU,1999.0,1,0,1
EGY,NOR,2007.0,2,0,2
MOZ,GBR,2022.0,1,0,1
VNM,,2003.0,14,0,14
BEL,TWN,2001.0,2,0,2
USA,AIA,2013.0,1,0,1
,BRN,1998.0,13,0,13
KAZ,,2003.0,20,0,20
PRT,AGO,2013.0,2,0,2
JPN,ROU,1997.0,3,0,3
,TCD,2012.0,11,0,11
SVK,PAK,2021.0,1,0,1
FSM,,2017.0,2,0,2
CAN,VNM,2010.0,7,0,7
GBR,SYR,2007.0,6,0,6
CHN,TUR,2009.0,2,0,2
NZL,MAC,2014.0,2,0,2
IRN,PRT,2011.0,4,0,4
MYS,BRA,2013.0,1,0,1
SWE,THA,2005.0,5,0,5
ISR,COL,1998.0,1,0,1
IDN,TLS,2019.0,1,0,1
PRT,COL,2012.0,3,0,3
MRT,,2020.0,17,0,17
MYS,ZMB,2018.0,2,0,2
IDN,BRN,2014.0,2,0,2
IRN,CZE,2006.0,1,0,1
AUT,CUB,2014.0,1,0,1
NIC,,2021.0,18,0,18
,LSO,2003.0,5,0,5
SGP,TZA,2012.0,1,0,1
AZE,AUS,1999.0,1,0,1
ZAF,COL,2008.0,1,0,1
CZE,SGP,2022.0,1,0,1
HUN,SAU,2021.0,1,0,1
GBR,KWT,1999.0,3,0,3
ALB,,2013.0,15,0,15
ARE,NOR,2017.0,3,0,3
PNG,PHL,2019.0,1,0,1
,BRB,2012.0,4,0,4
NAM,UGA,2015.0,1,0,1
CZE,FIN,2022.0,2,0,2
,GUM,2014.0,2,0,2
CHE,PAK,2003.0,3,0,3
CRI,IND,2004.0,1,0,1
ECU,BEL,2007.0,2,0,2
MOZ,KHM,2003.0,1,0,1
ESP,VNM,2016.0,2,0,2
CHE,TUN,2021.0,1,0,1
AUS,UKR,1999.0,2,0,2
MDA,DEU,2000.0,4,0,4
NER,,2012.0,4,0,4
FLK,GBR,2007.0,1,0,1
GLP,FRA,2000.0,7,0,7
PRT,MOZ,2009.0,1,0,1
POL,ALB,2006.0,1,0,1
HKG,LKA,2005.0,2,0,2
GAB,,2015.0,13,0,13
NLD,VNM,2003.0,3,0,3
FIN,SVN,2006.0,1,0,1
HUN,SGP,1999.0,1,0,1
QAT,EGY,2008.0,4,0,4
GHA,,2005.0,13,0,13
CHN,CHL,2001.0,1,0,1
BRA,FIN,2008.0,3,0,3
BEL,BOL,2004.0,2,0,2
AGO,,2009.0,2,0,2
BGD,,2001.0,2,0,2
GBR,BRN,2008.0,4,0,4
THA,TWN,2006.0,2,0,2
,EUE,2003.0,6,0,6
BEN,SEN,2011.0,1,0,1
BEL,IRN,2001.0,3,0,3
TWN,CZE,2008.0,2,0,2
DEU,PAN,2017.0,4,0,4
PRT,PAK,2014.0,1,0,1
GBR,CUB,2001.0,2,0,2
MAR,YEM,2013.0,2,0,2
KOR,IRQ,2014.0,1,0,1
DEU,MRT,2015.0,1,0,1
GBR,TUN,2011.0,2,0,2
TWN,SAU,2011.0,4,0,4
AUS,LVA,2012.0,2,0,2
MUS,NGA,2019.0,1,0,1
PAK,LVA,2018.0,1,0,1
DEU,PAK,1998.0,1,0,1
VUT,FJI,2022.0,1,0,1
JPN,CIV,2012.0,1,0,1
ITA,SMR,2011.0,2,0,2
CUB,ZWE,2005.0,1,0,1
SVK,HUN,2007.0,3,0,3
DNK,CZE,2007.0,1,0,1
KAZ,CHN,2018.0,5,0,5
DNK,SEN,2007.0,2,0,2
,REU,2016.0,4,0,4
,BMU,2010.0,5,0,5
ARE,KWT,2008.0,2,0,2
ESP,ISL,2015.0,3,0,3
CHE,TCD,2020.0,2,0,2
UKR,NZL,2013.0,1,0,1
SRB,IRN,2009.0,1,0,1
IRN,BRA,2011.0,2,0,2
PRI,PAN,2019.0,1,0,1
HKG,QAT,2014.0,1,0,1
SGP,KAZ,2012.0,1,0,1
SRB,ARE,2020.0,3,0,3
CHE,CYP,2019.0,2,0,2
TWN,NOR,2022.0,2,0,2
AUT,POL,2022.0,2,0,2
AUT,COL,2004.0,1,0,1
PRT,SVK,2019.0,1,0,1
BHS,,2022.0,8,0,8
NGA,QAT,2021.0,2,0,2
GHA,,2002.0,2,0,2
SRB,TWN,2013.0,1,0,1
LBY,USA,2007.0,1,0,1
MYS,CZE,2014.0,4,0,4
BEN,BFA,2013.0,3,0,3
NLD,BDI,2005.0,1,0,1
MYS,BHR,2005.0,1,0,1
ROU,KEN,2009.0,1,0,1
GEO,POL,2001.0,1,0,1
URY,DEU,2003.0,2,0,2
AUS,SEN,1999.0,1,0,1
ZWE,SWE,2004.0,1,0,1
COG,COD,2005.0,2,0,2
SAU,SWE,2001.0,2,0,2
GIN,FRA,1998.0,1,0,1
TZA,BWA,2013.0,1,0,1
PHL,DOM,2000.0,1,0,1
MCO,FRA,2003.0,3,0,3
NOR,HUN,1999.0,1,0,1
CHE,AGO,2002.0,1,0,1
BLR,GBR,2010.0,1,0,1
CAN,PSE,2016.0,3,0,3
IND,CHL,2002.0,2,0,2
MMR,USA,2015.0,3,0,3
DNK,PAN,2010.0,1,0,1
UGA,CHE,2010.0,1,0,1
ARG,PRI,2017.0,2,0,2
SVN,IND,2012.0,2,0,2
LBN,TUN,2009.0,1,0,1
LVA,GBR,1999.0,2,0,2
CZE,GEO,2020.0,1,0,1
IRQ,NAM,2014.0,1,0,1
QAT,KOR,2022.0,1,0,1
NOR,SRB,2015.0,1,0,1
GAB,ESP,2017.0,1,0,1
BGR,TWN,2010.0,1,0,1
PAN,CAN,2014.0,3,0,3
CAN,ZMB,2015.0,2,0,2
PER,MMR,2018.0,1,0,1
SGP,EST,2017.0,1,0,1
GIB,,2017.0,1,0,1
GEO,ITA,2020.0,2,0,2
BGD,ESP,2017.0,1,0,1
RUS,SGP,2021.0,2,0,2
CAN,CHL,1999.0,2,0,2
HUN,SVK,2000.0,2,0,2
IND,NER,2014.0,2,0,2
UKR,ZAF,2012.0,1,0,1
UKR,SVN,2016.0,2,0,2
SEN,GBR,1997.0,1,0,1
QAT,IND,2002.0,1,0,1
USA,BMU,2017.0,2,0,2
JPN,BIH,2007.0,1,0,1
RUS,YEM,2009.0,1,0,1
PAK,FIN,2012.0,2,0,2
ZWE,COG,2011.0,1,0,1
CYP,BGD,2021.0,1,0,1
CAN,GUY,2019.0,1,0,1
,BRN,1997.0,1,0,1
ISR,MYS,2013.0,1,0,1
GEO,JPN,2009.0,1,0,1
CAN,PRI,2007.0,2,0,2
ESP,LUX,2011.0,2,0,2
COL,BOL,2016.0,1,0,1
CHE,CYP,2017.0,4,0,4
ZWE,ITA,2014.0,1,0,1
EGY,UGA,2002.0,1,0,1
CAN,GUY,2010.0,1,0,1
UGA,NLD,2020.0,4,0,4
IRQ,POL,2011.0,2,0,2
ARM,CHN,2020.0,1,0,1
ESP,NIC,2018.0,2,0,2
MAR,MYS,2015.0,2,0,2
POL,MAR,2019.0,1,0,1
BRA,QAT,2020.0,2,0,2
ARG,AUS,2000.0,1,0,1
RUS,PER,2015.0,1,0,1
MEX,ZAF,2018.0,5,0,5
CYP,AUT,2021.0,1,0,1
NOR,IND,2000.0,1,0,1
ZMB,NOR,2002.0,1,0,1
ISR,CYP,2004.0,1,0,1
BRA,FJI,2010.0,1,0,1
BHS,CAN,2020.0,2,0,2
EST,ISR,2017.0,3,0,3
ISR,AZE,2014.0,1,0,1
CUB,RUS,2019.0,1,0,1
FIN,JOR,2014.0,1,0,1
BGR,CAN,2009.0,1,0,1
FIN,VNM,2017.0,3,0,3
POL,GHA,2016.0,1,0,1
KWT,LUX,2021.0,1,0,1
EGY,SDN,2021.0,2,0,2
DZA,ARE,2006.0,2,0,2
SVK,KWT,2002.0,2,0,2
SVK,CAN,2012.0,3,0,3
NLD,BEN,2006.0,1,0,1
JPN,KHM,2015.0,2,0,2
CHN,LBY,2018.0,1,0,1
CAN,BHR,2011.0,1,0,1
COL,QAT,2019.0,2,0,2
TUR,ARG,2011.0,1,0,1
UZB,KAZ,2011.0,1,0,1
GEO,TUR,2018.0,1,0,1
KOR,SWE,1998.0,2,0,2
IRN,FIN,2002.0,1,0,1
BLR,GBR,2019.0,2,0,2
VEN,BGD,1998.0,1,0,1
ARG,HUN,1999.0,1,0,1
LTU,ISR,2005.0,1,0,1
GBR,UZB,2006.0,2,0,2
GBR,LBN,1999.0,1,0,1
RUS,BGR,2001.0,4,0,4
SRB,ISR,2002.0,1,0,1
GIB,,2019.0,3,0,3
NLD,PSE,2004.0,1,0,1
CUB,CHN,2015.0,1,0,1
DEU,BWA,2009.0,1,0,1
NPL,POL,2005.0,1,0,1
BEN,KEN,2013.0,1,0,1
CHE,CIV,2013.0,1,0,1
BEL,ARE,2017.0,3,0,3
PHL,ARG,2013.0,2,0,2
,FLK,2007.0,1,0,1
TJK,JPN,2017.0,1,0,1
IRN,NOR,2003.0,1,0,1
PRT,HRV,2001.0,1,0,1
BWA,ZMB,2016.0,1,0,1
CHL,IDN,2020.0,1,0,1
DZA,POL,2004.0,1,0,1
DZA,CAN,2022.0,5,0,5
SVN,LBN,2021.0,1,0,1
GRD,IRL,2021.0,1,0,1
BGR,MEX,1998.0,1,0,1
IRQ,GTM,2019.0,1,0,1
MEX,KWT,2010.0,1,0,1
CMR,CAF,2018.0,1,0,1
BEL,MDA,2009.0,1,0,1
IRL,MAC,2014.0,1,0,1
ARE,IRQ,2022.0,1,0,1
EST,AUT,2013.0,1,0,1
CZE,KAZ,2021.0,1,0,1
ARM,GBR,2020.0,1,0,1
OMN,QAT,2012.0,3,0,3
EST,GRC,2015.0,1,0,1
GEO,CHN,2018.0,1,0,1
SWE,THA,2002.0,2,0,2
LUX,VNM,2022.0,1,0,1
PAN,,2004.0,2,0,2
VNM,CHE,2001.0,1,0,1
VEN,GBR,2019.0,3,0,3
AZE,UKR,2009.0,1,0,1
DZA,JOR,2006.0,2,0,2
ESP,MDA,2008.0,2,0,2
PRT,URY,2007.0,1,0,1
SWE,ROU,2009.0,3,0,3
COG,ZAF,2011.0,1,0,1
AFG,DEU,2011.0,1,0,1
PAK,ESP,2012.0,1,0,1
MYS,ITA,2011.0,4,0,4
TUN,KOR,2021.0,2,0,2
MYS,SYR,2021.0,1,0,1
LBN,MYS,2016.0,1,0,1
FIN,ZMB,2004.0,1,0,1
FIN,NAM,2019.0,1,0,1
MAR,PRT,2022.0,3,0,3
GTM,NLD,2020.0,1,0,1
NOR,TWN,2006.0,1,0,1
CZE,THA,2018.0,3,0,3
LVA,DNK,2022.0,2,0,2
SYR,ESP,2017.0,1,0,1
DEU,PRI,1999.0,1,0,1
BEN,GMB,2019.0,1,0,1
ARG,AUT,2013.0,3,0,3
VCT,,2020.0,1,0,1
DEU,MDG,2015.0,2,0,2
PRI,ARG,1998.0,1,0,1
ZAF,EST,2022.0,1,0,1
JAM,GBR,2021.0,2,0,2
AUT,NGA,2013.0,1,0,1
BLR,GBR,2017.0,1,0,1
PNG,USA,2006.0,2,0,2
TGO,,2007.0,2,0,2
PRT,UZB,2012.0,1,0,1
FIN,ARE,2004.0,2,0,2
CIV,BEL,1999.0,1,0,1
ESP,COL,1997.0,1,0,1
FRO,DEU,2021.0,1,0,1
SWE,VEN,2018.0,1,0,1
CIV,MLI,2022.0,1,0,1
MMR,,2007.0,3,0,3
RUS,OMN,2002.0,1,0,1
MDA,CZE,2018.0,1,0,1
LBN,IND,2016.0,1,0,1
FRA,GIN,2003.0,2,0,2
GBR,BIH,1999.0,1,0,1
ZAF,HUN,2009.0,1,0,1
QAT,MAR,2022.0,1,0,1
PAN,KOR,2012.0,1,0,1
DEU,ZWE,2007.0,1,0,1
JAM,IND,2006.0,1,0,1
ROU,BGR,2009.0,1,0,1
MYS,ISR,2016.0,1,0,1
NAM,ISR,2015.0,1,0,1
GHA,EST,2021.0,1,0,1
NIC,ARG,2020.0,1,0,1
CAN,BFA,2020.0,1,0,1
CHE,PRI,2022.0,2,0,2
ZAF,GRC,2020.0,1,0,1
ISL,POL,2011.0,2,0,2
ERI,USA,2010.0,1,0,1
GBR,MNG,2006.0,1,0,1
UZB,GBR,2003.0,1,0,1
HRV,JOR,2014.0,1,0,1
PNG,CZE,2000.0,1,0,1
CHE,DZA,2004.0,1,0,1
TUR,QAT,2009.0,1,0,1
FRA,CAF,2000.0,1,0,1
PRI,TZA,2019.0,1,0,1
TJK,CHE,2010.0,1,0,1
JPN,UZB,2016.0,1,0,1
KGZ,USA,2012.0,1,0,1
MEX,PAN,2016.0,1,0,1
PER,EGY,2021.0,1,0,1
CUB,NLD,2018.0,1,0,1
GRC,IRN,2006.0,1,0,1
BRA,HND,2015.0,1,0,1
ROU,CYP,2010.0,1,0,1
MCO,MAR,2016.0,1,0,1
POL,LBY,2019.0,2,0,2
MLT,GRC,2015.0,1,0,1
KHM,GUF,2001.0,1,0,1
NGA,MEX,2002.0,1,0,1
BEN,USA,2017.0,3,0,3
URY,NZL,2021.0,2,0,2
ROU,CYP,2019.0,1,0,1
JOR,IRL,2000.0,1,0,1
SGP,KEN,2020.0,1,0,1
KHM,NGA,2012.0,1,0,1
CAN,UZB,2006.0,1,0,1
KOR,SAU,2007.0,1,0,1
,SLB,2003.0,1,0,1
SVK,RUS,2008.0,2,0,2
MNG,THA,2020.0,1,0,1
ARG,JPN,2005.0,1,0,1
ROU,ARG,2005.0,1,0,1
TUN,BRA,2017.0,2,0,2
ESP,HKG,1998.0,3,0,3
TUN,CIV,2017.0,1,0,1
,NIU,2015.0,1,0,1
CZE,MOZ,2020.0,1,0,1
,SMR,2011.0,2,0,2
GAB,COG,2021.0,1,0,1
AUT,FIN,2000.0,3,0,3
IRN,BOL,2014.0,1,0,1
JPN,SAU,2005.0,3,0,3
CHE,TTO,2003.0,1,0,1
ZAF,LKA,2006.0,1,0,1
SYR,MAR,2013.0,1,0,1
SGP,EST,2019.0,1,0,1
MDG,FIN,2003.0,1,0,1
IND,AUT,1997.0,1,0,1
MYS,CHE,2000.0,1,0,1
COL,SGP,2019.0,3,0,3
SWE,IRQ,2009.0,1,0,1
VEN,DNK,2009.0,1,0,1
MNE,CZE,2016.0,1,0,1
TUR,JPN,1997.0,1,0,1
MAR,COD,2020.0,1,0,1
FRA,BIH,2000.0,1,0,1
BLR,ITA,2009.0,2,0,2
CAN,PRY,2003.0,1,0,1
NGA,ETH,2016.0,1,0,1
CMR,KOR,2009.0,1,0,1
LUX,HUN,2018.0,1,0,1
DJI,USA,2010.0,1,0,1
SWE,IDN,2008.0,1,0,1
CRI,DNK,2020.0,1,0,1
LVA,ZAF,2004.0,1,0,1
UKR,IRN,2012.0,1,0,1
PRI,PAN,2017.0,1,0,1
IRN,PER,2019.0,1,0,1
FRA,PRY,2017.0,1,0,1
BRA,ECU,2012.0,1,0,1
AZE,SAU,2015.0,1,0,1
HTI,GBR,2015.0,1,0,1
GBR,PRY,2020.0,1,0,1
PLW,,2016.0,2,0,2
IRQ,CHE,2022.0,1,0,1
HUN,BRA,2014.0,1,0,1
CHN,MOZ,2019.0,1,0,1
MAR,NER,2022.0,3,0,3
CUB,ARG,2021.0,1,0,1
EGY,CAN,1997.0,1,0,1
MAC,ESP,2019.0,1,0,1
BRA,FJI,2019.0,1,0,1
CYP,JPN,2015.0,1,0,1
CHE,MNG,2021.0,1,0,1
ISR,ARE,2020.0,1,0,1
RUS,HKG,2022.0,2,0,2
BLR,CZE,2014.0,1,0,1
,TUR,2020.0,2,0,2
MSR,ESP,2008.0,1,0,1
ISR,KEN,2003.0,1,0,1
HUN,PRT,2004.0,1,0,1
CRI,HND,2003.0,1,0,1
MWI,NGA,2013.0,1,0,1
DNK,BGR,2000.0,1,0,1
BEN,ITA,2007.0,1,0,1
DEU,GTM,2003.0,1,0,1
ZAF,HRV,2010.0,1,0,1
KOR,COD,2021.0,1,0,1
IND,AUT,1998.0,1,0,1
BRA,TUR,2012.0,1,0,1
LTU,POL,2019.0,1,0,1
JOR,FIN,2011.0,1,0,1
ISL,UGA,2018.0,1,0,1
QAT,LBY,2017.0,1,0,1
TWN,BFA,2019.0,1,0,1
ARG,NOR,2015.0,1,0,1
GUF,GLP,2018.0,1,0,1
KEN,SGP,2019.0,1,0,1
GIN,GBR,2019.0,1,0,1
NLD,ZMB,2022.0,1,0,1
BGD,ESP,2010.0,1,0,1
KWT,PSE,2019.0,1,0,1
GAB,MAR,2012.0,1,0,1
CHN,LUX,2012.0,1,0,1
KWT,NLD,2014.0,1,0,1
TJK,,1999.0,1,0,1
HND,MEX,2001.0,1,0,1
DEU,TZA,2003.0,1,0,1
GNB,SWE,2007.0,1,0,1
ESP,BGR,2019.0,1,0,1
NER,MEX,2017.0,1,0,1
SAU,TWN,2007.0,1,0,1
AGO,USA,2006.0,1,0,1
POL,HUN,2007.0,1,0,1
CAN,MLI,2009.0,1,0,1
COL,EGY,2009.0,1,0,1
LVA,RUS,2009.0,1,0,1
CAN,JOR,1998.0,1,0,1
NLD,BRN,2020.0,1,0,1
FRA,LBR,2018.0,1,0,1
IND,LSO,2013.0,1,0,1
ETH,LKA,2016.0,1,0,1
VEN,CUB,2016.0,1,0,1
GLP,USA,2000.0,1,0,1
CHN,PRI,2002.0,1,0,1
FRA,DEU,2013.0,321,317,4
KOR,DEU,2008.0,33,24,9
GRC,NLD,2008.0,10,11,-1
USA,JPN,2011.0,908,869,39
CAN,USA,2009.0,1420,1304,116
PRT,DNK,2020.0,7,9,-2
CHE,JPN,2018.0,28,38,-10
CHE,ESP,2003.0,25,31,-6
CHL,AUS,2015.0,26,14,12
GBR,PAK,2016.0,88,33,55
RUS,DEU,2013.0,90,75,15
NLD,USA,2015.0,378,344,34
ESP,FRA,2014.0,304,169,135
CAN,CHE,2019.0,106,88,18
BRA,AUS,2010.0,33,10,23
USA,AUT,2003.0,109,90,19
MCO,FRA,2012.0,5,8,-3
IRN,USA,2007.0,59,34,25
GBR,IRL,2011.0,154,211,-57
DEU,GBR,2009.0,505,436,69
POL,FIN,2012.0,7,15,-8
ARE,ZAF,2019.0,3,4,-1
EGY,SAU,2014.0,177,162,15
CAN,FRA,2011.0,245,300,-55
SGP,KOR,2012.0,29,14,15
JPN,SWE,2015.0,27,17,10
BEL,ZAF,2015.0,14,4,10
MEX,FRA,1997.0,5,1,4
USA,SAU,2011.0,114,22,92
USA,CHL,2010.0,84,73,11
IND,KOR,2006.0,71,16,55
KOR,CHN,2010.0,110,62,48
USA,SVN,2013.0,6,12,-6
ISR,BRA,2013.0,2,2,0
ITA,FRA,2007.0,218,183,35
FRA,TUN,2003.0,60,31,29
ESP,CHL,2011.0,58,51,7
GBR,CHE,2006.0,133,148,-15
BRA,JPN,2010.0,14,9,5
USA,GRC,2016.0,77,124,-47
AUS,JPN,2018.0,61,62,-1
SWE,CHE,2014.0,50,44,6
BRA,PRT,2012.0,60,70,-10
JPN,CHN,2011.0,376,299,77
AUS,CHE,2019.0,65,61,4
COL,MEX,2013.0,22,17,5
SAU,QAT,2015.0,16,3,13
GBR,USA,2021.0,1129,1133,-4
CHN,CAN,2002.0,104,39,65
CHN,CAN,2005.0,118,66,52
JPN,NPL,2008.0,8,3,5
BGD,GBR,2006.0,10,11,-1
EGY,FRA,2007.0,8,16,-8
NGA,ZAF,2014.0,38,21,17
USA,CHL,2019.0,117,105,12
TUR,CYP,2020.0,62,41,21
SWE,AUS,2020.0,43,58,-15
CHE,SVN,2018.0,6,7,-1
CAN,CHE,2017.0,115,83,32
NLD,FRA,2007.0,95,85,10
GBR,QAT,2008.0,8,2,6
CAN,JPN,2016.0,72,71,1
BEL,USA,2006.0,113,102,11
USA,BEL,2010.0,116,127,-11
JPN,FRA,2004.0,68,48,20
HUN,NLD,2003.0,6,7,-1
TWN,CHN,2008.0,53,39,14
DEU,IND,2015.0,117,150,-33
KOR,GBR,2016.0,65,36,29
PRT,RUS,2021.0,7,2,5
DEU,ITA,2001.0,98,108,-10
EGY,GBR,2011.0,13,67,-54
JOR,SAU,2018.0,25,39,-14
THA,JPN,2003.0,28,37,-9
SGP,GBR,2016.0,87,136,-49
BGD,AUS,2015.0,58,19,39
CHN,JPN,2001.0,183,132,51
KWT,SAU,2018.0,5,6,-1
DNK,NZL,2017.0,6,5,1
USA,BEL,2019.0,149,178,-29
AUS,CHE,2017.0,61,49,12
BRA,PER,2018.0,26,16,10
ESP,RUS,2021.0,11,5,6
FRA,VNM,2018.0,63,8,55
KOR,CHN,2017.0,179,86,93
KOR,CHN,2019.0,252,110,142
PAK,CHN,2021.0,209,344,-135
SGP,TWN,2011.0,11,15,-4
PRT,NOR,2019.0,12,2,10
DEU,IRN,2016.0,31,97,-66
AUS,CAN,2009.0,125,159,-34
GBR,SAU,2016.0,111,53,58
USA,CHL,2017.0,135,121,14
TUR,DEU,2022.0,28,13,15
IND,CAN,2003.0,41,26,15
USA,TWN,2012.0,311,273,38
AUS,SAU,2014.0,29,18,11
AUS,SWE,2011.0,35,25,10
MYS,USA,2015.0,41,40,1
ZAF,GHA,2015.0,9,8,1
PER,BRA,2017.0,13,28,-15
COL,USA,2016.0,111,87,24
IND,JPN,2001.0,69,32,37
ITA,NOR,2014.0,18,11,7
IND,OMN,2016.0,18,5,13
KOR,FRA,2014.0,26,34,-8
ROU,NLD,2002.0,11,4,7
SEN,FRA,2014.0,14,27,-13
CHN,NLD,2016.0,107,115,-8
USA,CMR,2015.0,11,9,2
IDN,JPN,2016.0,27,148,-121
HKG,THA,2015.0,2,1,1
HRV,SVN,2019.0,12,7,5
TWN,JPN,2012.0,35,33,2
GBR,MYS,2021.0,59,63,-4
AUS,NPL,2016.0,4,12,-8
USA,TUR,2020.0,224,254,-30
IND,NPL,2020.0,36,31,5
CHE,BRA,2009.0,11,12,-1
ETH,FIN,2019.0,1,2,-1
BRA,AUS,2017.0,48,24,24
BEL,DEU,2020.0,90,106,-16
TZA,ETH,2019.0,2,2,0
PRT,DEU,2020.0,42,33,9
HKG,KOR,2015.0,7,14,-7
SGP,JPN,2019.0,29,35,-6
DNK,AUS,2021.0,24,27,-3
JPN,BGD,2021.0,65,19,46
BEL,CHN,2018.0,60,57,3
VEN,FRA,2002.0,5,8,-3
CHE,EGY,2008.0,4,1,3
HUN,AUT,2016.0,28,11,17
TWN,HKG,2021.0,9,18,-9
DNK,SWE,2015.0,76,86,-10
DEU,ROU,2017.0,21,20,1
GBR,NZL,2021.0,100,70,30
TUR,CHN,2015.0,5,5,0
USA,BEL,2017.0,117,221,-104
DZA,CHN,2017.0,3,5,-2
BRA,AUS,2019.0,61,21,40
PAK,KOR,2019.0,28,115,-87
NLD,KOR,2009.0,4,6,-2
ZAF,NGA,2021.0,66,62,4
CHL,MEX,2005.0,3,6,-3
GHA,GBR,2015.0,5,18,-13
AUT,KEN,2019.0,2,1,1
DZA,TUN,2019.0,2,6,-4
DNK,GBR,2002.0,49,55,-6
IRN,BEL,2018.0,22,15,7
ARG,CAN,2020.0,20,6,14
BRA,CHL,2007.0,12,10,2
SGP,USA,2003.0,107,113,-6
DNK,USA,2021.0,100,127,-27
USA,NLD,2003.0,258,257,1
GBR,EGY,2012.0,43,17,26
BRA,BEL,2020.0,19,11,8
SGP,JPN,2017.0,41,36,5
THA,CHN,2017.0,25,23,2
USA,PRT,2022.0,16,23,-7
CAN,CHE,2010.0,91,74,17
AUS,NZL,2011.0,90,180,-90
CHN,AUS,2007.0,69,44,25
BGD,MYS,2020.0,27,63,-36
KOR,VNM,2022.0,37,31,6
USA,BGR,2012.0,17,14,3
ARG,MEX,2008.0,9,10,-1
IRL,USA,2002.0,77,71,6
LKA,SWE,2008.0,1,2,-1
NGA,GHA,2019.0,6,1,5
BGD,SAU,2021.0,10,6,4
BHR,SAU,2018.0,3,4,-1
IND,CZE,2020.0,37,12,25
FRA,LUX,2007.0,28,9,19
CHL,DEU,2011.0,22,17,5
IRQ,GBR,2014.0,12,22,-10
PAK,USA,2005.0,27,31,-4
CAN,BRA,2015.0,51,79,-28
IRL,USA,2005.0,68,90,-22
AUT,ESP,2013.0,12,30,-18
DEU,SVK,2014.0,11,12,-1
USA,ISL,2017.0,15,6,9
GBR,SVK,2013.0,6,6,0
IRN,NOR,2012.0,10,2,8
SRB,ITA,2014.0,5,5,0
NLD,ZAF,2013.0,18,11,7
MKD,SRB,2002.0,6,1,5
CHE,GRC,2012.0,15,24,-9
FIN,NOR,2022.0,6,8,-2
JPN,DEU,2007.0,95,91,4
USA,CHN,1999.0,134,355,-221
MYS,NLD,2009.0,4,4,0
KOR,AUS,2014.0,39,25,14
GBR,IRQ,2011.0,7,4,3
IND,USA,1998.0,79,46,33
USA,AUS,2001.0,249,339,-90
IND,ARE,2016.0,33,13,20
DEU,ROU,2010.0,21,18,3
ISR,GBR,2007.0,37,23,14
AUS,THA,2009.0,34,14,20
CAN,TWN,2013.0,19,13,6
JPN,IND,2001.0,32,69,-37
IRL,NOR,2001.0,3,3,0
IND,USA,1997.0,30,19,11
IRN,IRL,2012.0,4,7,-3
USA,CZE,2014.0,60,36,24
ESP,PER,2017.0,28,10,18
FRA,REU,2017.0,17,14,3
AUS,CHE,2010.0,52,55,-3
CHN,NOR,2003.0,5,4,1
CHE,DEU,1997.0,48,54,-6
JPN,THA,2001.0,18,16,2
CHN,SGP,2001.0,59,12,47
NOR,CHN,2013.0,16,18,-2
FIN,JPN,2011.0,8,10,-2
NGA,GHA,2017.0,6,3,3
NLD,CHN,2009.0,31,35,-4
DNK,GBR,2005.0,55,41,14
CAN,NZL,2007.0,30,25,5
CZE,USA,2001.0,42,23,19
COL,DEU,2022.0,11,5,6
CAN,ITA,2022.0,20,38,-18
ESP,MAR,2020.0,19,7,12
DNK,GRC,2017.0,5,12,-7
FRA,MAC,2020.0,1,1,0
CHE,ITA,1997.0,27,22,5
FRA,CIV,2009.0,14,26,-12
SGP,FRA,2007.0,10,13,-3
USA,ROU,2017.0,28,18,10
JPN,ITA,2009.0,18,8,10
BEL,LUX,2015.0,13,7,6
GBR,IDN,2016.0,21,8,13
POL,UKR,2004.0,13,10,3
IRL,BRA,2020.0,6,17,-11
SWE,BEL,2002.0,10,11,-1
NOR,SWE,2005.0,19,55,-36
PAK,IRQ,2020.0,5,6,-1
TUR,GBR,2003.0,15,44,-29
CZE,FRA,2022.0,10,22,-12
KHM,THA,2021.0,2,6,-4
AUS,GBR,1998.0,67,76,-9
SVN,FRA,2017.0,8,3,5
IDN,THA,2018.0,6,11,-5
COL,PRT,2016.0,3,4,-1
MAR,IND,2019.0,3,1,2
CHE,DEU,1998.0,82,98,-16
IRQ,KWT,2020.0,1,1,0
USA,ROU,2010.0,31,24,7
KOR,THA,2020.0,19,8,11
HUN,USA,2005.0,71,60,11
GBR,SEN,2006.0,1,1,0
NGA,UGA,2011.0,3,1,2
ERI,CHN,2022.0,2,1,1
CYP,GRC,2019.0,17,60,-43
DZA,TUN,2017.0,3,2,1
ZAF,CHE,2021.0,9,9,0
HKG,SGP,2021.0,28,41,-13
CHE,IRN,2015.0,8,34,-26
ITA,PRT,2011.0,27,11,16
CHE,ITA,1998.0,31,46,-15
ESP,PER,2019.0,21,13,8
CAN,NLD,2015.0,62,53,9
GBR,HUN,2008.0,9,29,-20
NGA,CMR,2006.0,2,2,0
JOR,IRQ,2011.0,4,2,2
USA,BWA,2003.0,8,2,6
DNK,CAN,2009.0,12,18,-6
USA,NAM,2013.0,3,3,0
SVN,HRV,2013.0,7,6,1
HRV,SVN,2010.0,4,6,-2
USA,PHL,2009.0,21,20,1
ESP,DZA,2014.0,4,3,1
ISR,RUS,2012.0,15,6,9
BRA,ITA,2003.0,16,24,-8
AUS,KEN,2004.0,4,1,3
SWE,IRN,2006.0,7,3,4
GBR,ISR,2007.0,23,37,-14
AUS,ISR,2010.0,9,13,-4
DNK,JPN,2013.0,6,7,-1
NGA,USA,2005.0,17,14,3
AUS,ISR,2019.0,13,19,-6
ITA,IRL,2012.0,21,11,10
SVN,FRA,2019.0,5,3,2
ESP,SAU,2013.0,7,1,6
PHL,NLD,2019.0,1,6,-5
SWE,LVA,2010.0,5,2,3
RUS,GBR,2006.0,45,19,26
CHN,GRC,2019.0,2,4,-2
FRA,IRN,2003.0,5,5,0
NLD,IDN,2001.0,4,2,2
FRA,BRA,2001.0,41,40,1
DEU,AUT,1999.0,82,63,19
IND,FRA,2003.0,20,11,9
GBR,THA,2003.0,44,15,29
RUS,CZE,2016.0,9,17,-8
FIN,SWE,2001.0,28,38,-10
ARM,GBR,2004.0,1,1,0
HUN,RUS,2009.0,4,2,2
HUN,USA,2002.0,78,61,17
HKG,CAN,2005.0,26,12,14
HRV,BIH,2007.0,9,11,-2
AUT,UKR,2020.0,2,2,0
KEN,USA,2013.0,41,53,-12
CYP,TUR,2012.0,8,13,-5
EGY,JPN,1999.0,3,4,-1
USA,ISL,2010.0,16,7,9
NOR,SWE,2002.0,35,45,-10
CHE,BEL,1999.0,7,15,-8
BGR,ITA,2010.0,4,3,1
MOZ,ZAF,2010.0,2,1,1
DNK,GRC,2010.0,4,3,1
USA,DZA,2012.0,1,3,-2
PRT,SWE,2002.0,3,6,-3
ZAF,DEU,2009.0,15,23,-8
IND,PAK,2003.0,8,6,2
NZL,GRC,2017.0,1,1,0
USA,NPL,2011.0,5,12,-7
ITA,MEX,2016.0,25,7,18
COG,USA,2017.0,8,4,4
IRN,RUS,2002.0,1,4,-3
GBR,AUT,2006.0,36,47,-11
CAN,DEU,1999.0,36,53,-17
ESP,JPN,2001.0,5,5,0
USA,LVA,2018.0,3,2,1
POL,HUN,2002.0,6,1,5
NGA,USA,2002.0,11,11,0
USA,NGA,2005.0,14,17,-3
SAU,JPN,2017.0,6,23,-17
RUS,FIN,2006.0,10,10,0
ITA,BRA,2007.0,22,25,-3
TZA,NGA,2016.0,2,1,1
ROU,HUN,2003.0,1,2,-1
FRA,GRC,2015.0,31,45,-14
IRL,CAN,2008.0,25,20,5
DEU,SRB,2007.0,13,14,-1
HUN,FRA,2009.0,9,12,-3
DNK,FIN,2003.0,9,14,-5
BLR,DEU,2002.0,15,8,7
ITA,POL,2008.0,14,9,5
PHL,JPN,2002.0,9,12,-3
CAN,ZAF,2009.0,14,15,-1
FIN,LTU,2000.0,1,3,-2
USA,BGD,2003.0,11,12,-1
BGR,DEU,1997.0,4,3,1
NOR,AUS,2002.0,9,4,5
VEN,MEX,2014.0,8,5,3
CHN,FIN,2003.0,8,8,0
NLD,FIN,2009.0,16,8,8
FRA,SEN,1997.0,4,5,-1
GRC,NOR,2003.0,3,1,2
USA,ROU,2019.0,13,15,-2
NOR,RUS,2007.0,6,5,1
EGY,CZE,2001.0,1,1,0
DEU,GRC,2000.0,20,9,11
BRA,ESP,2001.0,16,12,4
POL,BRA,2012.0,5,27,-22
IRL,ZAF,2003.0,4,3,1
BLZ,USA,2011.0,1,2,-1
AUT,AUS,1997.0,4,1,3
DJI,FRA,2006.0,1,1,0
ARE,SGP,2008.0,2,4,-2
ZAF,BWA,2004.0,6,5,1
CAN,HUN,1999.0,1,1,0
DEU,BGD,2006.0,4,1,3
DEU,IRL,2001.0,14,11,3
CHL,BRA,1997.0,1,1,0
JPN,CHL,2007.0,3,1,2
DNK,ISL,2009.0,3,5,-2
ESP,PRI,2016.0,2,2,0
PHL,USA,2003.0,14,23,-9
MYS,BGD,2006.0,5,4,1
ISL,CHE,2008.0,1,1,0
SAU,JOR,2014.0,19,41,-22
BGR,POL,2010.0,2,1,1
NOR,AUS,2005.0,5,12,-7
NLD,NZL,2013.0,11,3,8
AUS,KHM,2013.0,1,1,0
BRA,LUX,2013.0,2,1,1
PAK,KOR,2010.0,8,6,2
GRC,QAT,2018.0,3,2,1
IRN,FIN,2007.0,4,2,2
ETH,FIN,2010.0,1,1,0
EGY,QAT,2020.0,12,7,5
ISR,SWE,2012.0,4,3,1
AUT,IRL,2016.0,3,5,-2
FIN,FRA,2009.0,9,13,-4
AUS,ISR,2017.0,13,24,-11
MAC,HKG,2020.0,11,17,-6
PRT,CHL,2017.0,6,4,2
CYP,FRA,2015.0,2,1,1
IRL,ISR,2017.0,3,1,2
DNK,NZL,2010.0,2,5,-3
MAR,USA,2007.0,4,1,3
BRA,JPN,2017.0,12,12,0
ZAF,NLD,2011.0,15,15,0
BEL,HKG,2011.0,1,2,-1
GHA,KEN,2018.0,2,4,-2
DEU,IRQ,2013.0,2,3,-1
IND,BRA,2013.0,11,2,9
NZL,POL,2013.0,7,1,6
CAN,OMN,2022.0,2,3,-1
CHE,KEN,2018.0,4,6,-2
GBR,LBY,2012.0,11,1,10
EGY,ESP,2012.0,6,7,-1
CHE,ISR,2021.0,12,9,3
NLD,AUT,2013.0,20,21,-1
CAN,SGP,2019.0,29,27,2
PRT,THA,2020.0,3,1,2
LIE,CHE,2022.0,3,1,2
FRA,PER,2013.0,3,1,2
SGP,PHL,2014.0,3,4,-1
MYS,BRN,2021.0,6,1,5
PRT,FRA,2022.0,16,11,5
AUS,TWN,2014.0,9,22,-13
GBR,BGR,2013.0,5,5,0
CHN,ARE,2015.0,5,1,4
POL,DNK,2011.0,10,13,-3
BWA,USA,2022.0,5,6,-1
NOR,ITA,2007.0,7,11,-4
AUT,NLD,2009.0,8,8,0
DEU,MAR,2022.0,2,4,-2
CYP,GRC,2017.0,13,56,-43
EGY,LBY,2017.0,6,1,5
AUS,DNK,2021.0,27,24,3
ETH,AUS,2015.0,5,2,3
RUS,GRC,2001.0,5,3,2
PAK,KOR,2017.0,49,58,-9
THA,CHN,2019.0,20,28,-8
IRL,ESP,2008.0,9,13,-4
IND,SVK,2011.0,1,1,0
SRB,DEU,2016.0,22,9,13
ISR,AUS,2006.0,5,6,-1
BLR,DEU,2005.0,10,3,7
ESP,IND,1999.0,4,1,3
MEX,CZE,2002.0,3,1,2
SWE,ESP,2001.0,25,15,10
ROU,TUR,2006.0,2,2,0
FRA,JPN,2000.0,23,19,4
ITA,ARG,2001.0,8,8,0
KEN,FRA,2003.0,3,1,2
ISR,CAN,2001.0,12,21,-9
AUT,BEL,2015.0,9,13,-4
BGR,DEU,1998.0,4,2,2
FRA,BEN,2020.0,10,4,6
MKD,SRB,2005.0,15,4,11
MYS,VNM,2014.0,6,1,5
CAN,BLR,2000.0,1,1,0
JPN,BRA,2012.0,18,8,10
PRT,ITA,2013.0,23,27,-4
FIN,ITA,2016.0,7,18,-11
DNK,HUN,2003.0,10,3,7
PER,USA,2003.0,15,24,-9
ITA,KOR,2002.0,3,1,2
RWA,IND,2014.0,1,1,0
MEX,AUT,2011.0,1,2,-1
SDN,MYS,2013.0,3,4,-1
KOR,MEX,2017.0,2,3,-1
PER,BRA,2019.0,13,49,-36
USA,RWA,2014.0,14,7,7
IRL,AUS,2021.0,23,36,-13
IND,ETH,2022.0,13,13,0
JOR,CAN,2009.0,4,10,-6
PHL,JPN,2005.0,11,8,3
SAU,YEM,2017.0,2,7,-5
NOR,DEU,1998.0,5,4,1
ISR,IND,2004.0,10,11,-1
USA,CRI,2014.0,9,9,0
PRT,NOR,2017.0,11,2,9
TUN,DZA,2022.0,3,3,0
IDN,KOR,2013.0,3,18,-15
UGA,TZA,2022.0,1,1,0
JPN,ISR,2006.0,2,3,-1
IND,LBY,2018.0,1,4,-3
NLD,LBN,2019.0,6,5,1
JPN,PAK,2015.0,7,3,4
MYS,UGA,2017.0,2,1,1
RUS,CHE,2007.0,15,6,9
DEU,ROU,2019.0,9,22,-13
EGY,PAK,2012.0,1,2,-1
PRT,FIN,2016.0,6,4,2
ESP,AUT,1998.0,1,4,-3
NLD,MEX,2007.0,5,2,3
DEU,BLR,2007.0,2,11,-9
SAU,IRL,2019.0,4,8,-4
ZMB,USA,2020.0,9,10,-1
NZL,PAK,2021.0,4,5,-1
ITA,BFA,2013.0,2,1,1
CHL,CRI,2017.0,1,1,0
BEL,AUT,2018.0,14,19,-5
AUS,MEX,2022.0,2,4,-2
GBR,BHR,2014.0,5,1,4
ISR,PSE,2008.0,4,11,-7
ITA,DNK,2005.0,12,11,1
JAM,BRB,2015.0,3,1,2
PHL,NLD,2017.0,3,1,2
UGA,ZAF,2002.0,1,1,0
DEU,JOR,2009.0,8,6,2
AUS,FIN,2007.0,5,9,-4
KAZ,RUS,2013.0,9,17,-8
JPN,UKR,2016.0,5,3,2
GBR,GHA,2004.0,6,3,3
PNG,CHE,2004.0,1,1,0
BGR,NLD,2003.0,2,5,-3
AUS,IRN,2007.0,22,18,4
CZE,HUN,2009.0,3,5,-2
IRL,COL,2010.0,2,1,1
JOR,EGY,2003.0,3,1,2
SYR,IND,2014.0,2,1,1
NOR,DEU,1997.0,2,1,1
DEU,BGR,2013.0,9,10,-1
SGP,HKG,2000.0,4,3,1
SGP,CHE,2008.0,4,10,-6
LKA,CAN,2009.0,2,1,1
ECU,CHN,2020.0,1,1,0
MEX,IND,2000.0,2,4,-2
FRA,REU,2010.0,12,10,2
GBR,EST,2009.0,3,2,1
CHN,IRN,2003.0,1,1,0
SVN,SVK,2009.0,5,2,3
GBR,SVN,2014.0,6,13,-7
IRL,MEX,2015.0,2,1,1
VEN,FRA,2005.0,6,9,-3
AUT,DNK,2007.0,1,2,-1
BGR,ITA,2019.0,3,6,-3
FIN,NGA,2018.0,1,2,-1
SWE,THA,2007.0,9,1,8
SVK,CHE,2008.0,2,3,-1
SGP,JPN,2010.0,13,29,-16
NLD,ARG,2008.0,5,1,4
ARG,ITA,2020.0,12,18,-6
NZL,ESP,2016.0,3,4,-1
PAK,DEU,2007.0,13,6,7
SEN,COG,2020.0,1,1,0
CHN,SLE,2011.0,1,1,0
NLD,IND,2001.0,6,8,-2
MEX,BEL,2014.0,3,11,-8
CHL,COL,2009.0,7,13,-6
NGA,JPN,2011.0,3,4,-1
CZE,GBR,2012.0,28,27,1
IND,BHR,2010.0,3,1,2
FRA,UKR,2021.0,2,7,-5
ETH,BEL,2015.0,3,4,-1
MAR,TUN,2013.0,1,1,0
IND,RUS,2018.0,16,7,9
ROU,FRA,2009.0,27,37,-10
IRL,JPN,2015.0,6,1,5
DZA,DEU,2008.0,1,2,-1
FRA,SEN,1998.0,5,8,-3
CHN,PAK,2000.0,1,1,0
NLD,SVN,2006.0,2,1,1
EST,AUS,2020.0,2,2,0
ARE,ZAF,2017.0,2,1,1
SDN,PAK,2014.0,1,1,0
ZAF,SEN,2021.0,2,1,1
CRI,GBR,2017.0,2,4,-2
ARE,BHR,2010.0,2,1,1
VEN,NLD,2015.0,2,1,1
BEL,RUS,2018.0,8,13,-5
FRA,REU,2019.0,8,18,-10
COD,BEL,2018.0,3,9,-6
IND,THA,1998.0,2,1,1
USA,NGA,2002.0,11,11,0
BEL,MAR,2003.0,8,3,5
HUN,BEL,2014.0,7,7,0
IND,ROU,2020.0,4,1,3
SVK,HUN,2005.0,1,1,0
NGA,BEN,2010.0,1,1,0
ISR,IRL,2018.0,5,4,1
GBR,ECU,2014.0,3,2,1
NLD,ITA,1997.0,5,9,-4
ITA,COL,2014.0,6,10,-4
FRA,BOL,2018.0,1,2,-1
NGA,IRN,2019.0,1,1,0
CZE,AUS,2020.0,8,12,-4
CHN,HUN,2022.0,6,1,5
ARG,DNK,2018.0,4,4,0
LUX,NLD,2011.0,3,4,-1
IND,TUR,2003.0,2,1,1
CRI,ESP,2012.0,2,7,-5
GBR,ARE,2001.0,8,4,4
NLD,ECU,2015.0,4,2,2
BRA,NOR,2014.0,9,2,7
GBR,KOR,1997.0,3,1,2
CHN,GRC,2017.0,3,5,-2
LUX,AUT,2013.0,2,1,1
PRT,CHL,2019.0,4,4,0
NPL,DEU,2010.0,2,4,-2
USA,PNG,2020.0,3,1,2
NZL,BRA,2018.0,4,4,0
DNK,EGY,2011.0,2,1,1
ROU,SWE,2016.0,2,3,-1
FRA,PSE,2016.0,2,2,0
ITA,PHL,2022.0,1,2,-1
ARE,QAT,2015.0,6,2,4
GHA,MYS,2014.0,1,2,-1
ZAF,NOR,2016.0,4,5,-1
NLD,MYS,2022.0,1,2,-1
EGY,LBY,2019.0,2,6,-4
MYS,THA,2022.0,7,3,4
BGR,POL,2017.0,1,1,0
DEU,MKD,2016.0,2,4,-2
MUS,GBR,2019.0,1,3,-2
ESP,ZAF,2020.0,9,6,3
SWE,LVA,2019.0,2,1,1
FRA,TGO,2006.0,7,1,6
ARE,SAU,2009.0,6,7,-1
JPN,UGA,2002.0,1,1,0
SDN,TUR,2006.0,1,1,0
CAN,MAR,2005.0,4,7,-3
JPN,IRN,2002.0,4,5,-1
TUR,AZE,2008.0,6,6,0
FRA,PYF,2003.0,9,3,6
THA,SGP,2016.0,5,8,-3
GRC,BGR,2006.0,2,2,0
FIN,AUT,2004.0,3,3,0
TZA,NLD,2022.0,1,3,-2
EGY,LBY,2010.0,5,2,3
SVK,JPN,2003.0,3,4,-1
SVK,ITA,2004.0,4,1,3
QAT,ARE,2018.0,8,4,4
NLD,ITA,1998.0,13,17,-4
RUS,SRB,2015.0,2,6,-4
NOR,IRN,2007.0,3,1,2
PRT,NOR,2010.0,3,1,2
ZAF,IND,2001.0,7,2,5
DEU,SGP,2000.0,4,3,1
DEU,PHL,2010.0,3,4,-1
TUR,RUS,2012.0,3,1,2
PER,COL,2002.0,2,1,1
FIN,SAU,2018.0,1,4,-3
QAT,USA,2009.0,5,18,-13
DEU,TZA,2012.0,2,2,0
JPN,NZL,1998.0,1,1,0
USA,GTM,2016.0,3,11,-8
CAN,SAU,1999.0,5,6,-1
NGA,DEU,2008.0,6,8,-2
SVN,FRA,2010.0,5,4,1
CMR,USA,2008.0,7,4,3
MYS,NZL,2001.0,1,1,0
SAU,YEM,2019.0,3,8,-5
OMN,MYS,2009.0,1,3,-2
KEN,ZAF,2006.0,1,5,-4
MAR,ESP,2011.0,7,3,4
FIN,CZE,2008.0,2,1,1
CAN,BEN,2018.0,2,2,0
TTO,USA,2017.0,3,5,-2
SAU,BHR,2016.0,2,3,-1
IRQ,DEU,2012.0,1,1,0
SVK,POL,2021.0,3,5,-2
MLT,AUS,2018.0,2,1,1
SWE,LVA,2017.0,5,5,0
ETH,FIN,2017.0,2,2,0
HRV,BEL,2021.0,2,3,-1
USA,VNM,2022.0,13,26,-13
IND,BWA,2007.0,1,1,0
MKD,BGR,2020.0,2,1,1
FIN,RUS,2001.0,6,17,-11
JPN,NZL,1997.0,3,2,1
HUN,ITA,2006.0,6,6,0
ISR,CHN,2008.0,3,6,-3
ITA,CUB,2004.0,3,1,2
ARE,SWE,2015.0,2,5,-3
SRB,AUT,2021.0,3,4,-1
COG,USA,2019.0,5,4,1
CYP,GRC,2010.0,8,29,-21
ROU,NLD,2005.0,4,1,3
CZE,BEL,2003.0,3,2,1
GNB,DNK,2008.0,2,1,1
MEX,AUS,2001.0,4,2,2
VNM,JPN,2005.0,5,9,-4
CMR,GBR,2016.0,1,1,0
USA,KAZ,2006.0,2,1,1
UKR,POL,2007.0,13,6,7
POL,ISR,2017.0,6,1,5
REU,FRA,2003.0,2,2,0
RUS,BRA,2008.0,4,2,2
COG,FRA,2008.0,3,7,-4
ESP,UKR,2004.0,2,2,0
THA,CHN,2010.0,3,3,0
MLT,GBR,2007.0,1,5,-4
FRA,NER,2006.0,6,5,1
JPN,GRC,2012.0,1,1,0
DEU,ARE,2007.0,6,1,5
HRV,DNK,2021.0,1,2,-1
DEU,EST,2016.0,8,3,5
GRC,FIN,2011.0,3,2,1
USA,COG,2014.0,9,1,8
GBR,ISL,2009.0,5,4,1
NGA,KWT,2006.0,1,1,0
BEL,CZE,2014.0,9,6,3
CHE,IND,2000.0,2,3,-1
AUT,AUS,1998.0,4,7,-3
CHL,JPN,2022.0,3,2,1
ITA,EGY,1999.0,1,1,0
IRL,COL,2019.0,1,1,0
CZE,VNM,2014.0,1,1,0
NOR,QAT,2022.0,1,1,0
BEL,EGY,2017.0,2,4,-2
HUN,AUS,2014.0,1,1,0
VNM,JPN,2002.0,3,5,-2
ARE,BRA,2020.0,1,4,-3
ITA,ZAF,2020.0,3,13,-10
DEU,DZA,2009.0,1,1,0
POL,ISR,2019.0,5,2,3
CMR,JPN,2021.0,1,1,0
SGP,IRN,2012.0,4,7,-3
SGP,PAK,2017.0,4,3,1
RUS,PRT,2009.0,2,5,-3
SAU,SGP,2014.0,1,12,-11
IND,BHR,2017.0,1,1,0
IDN,CHN,2018.0,4,5,-1
PAN,COL,2006.0,2,1,1
LTU,UKR,2017.0,2,1,1
POL,PRT,2015.0,6,8,-2
MDA,RUS,2014.0,1,2,-1
NZL,DEU,1998.0,4,5,-1
FRA,MCO,2020.0,10,8,2
BEL,DZA,2006.0,2,1,1
UGA,ETH,2018.0,2,1,1
IRL,ISR,2010.0,2,6,-4
BGD,CHE,2012.0,3,2,1
GRC,TWN,2008.0,1,1,0
ZWE,NLD,2022.0,1,1,0
PRT,SWE,2005.0,5,8,-3
PRT,CZE,2014.0,3,3,0
AZE,TUR,2015.0,3,5,-2
NGA,TZA,2016.0,1,2,-1
DNK,NZL,2019.0,4,3,1
ARG,NZL,2018.0,2,1,1
DNK,CZE,2002.0,1,2,-1
KEN,PAK,2013.0,3,4,-1
ROU,CHE,2004.0,1,3,-2
SWE,KOR,2013.0,4,4,0
BGR,DNK,2002.0,4,1,3
CHL,GBR,2001.0,1,4,-3
SWE,UKR,2001.0,3,5,-2
JPN,ZAF,2006.0,1,1,0
BGD,ITA,2016.0,1,7,-6
ARG,COL,2002.0,2,8,-6
URY,AUS,2006.0,1,2,-1
MYS,ARE,2011.0,1,1,0
EGY,ITA,1999.0,1,1,0
KEN,CAN,2003.0,4,4,0
BGR,ITA,2017.0,1,4,-3
IND,TTO,2010.0,1,3,-2
URY,DEU,2012.0,2,1,1
CYP,CHE,2013.0,3,1,2
ESP,IRN,2014.0,6,10,-4
BOL,CHL,2020.0,4,2,2
HUN,HRV,2016.0,2,1,1
VNM,BRN,2020.0,1,1,0
IND,PHL,2009.0,3,5,-2
TUR,UKR,2015.0,1,1,0
DEU,UGA,2019.0,2,1,1
KEN,JPN,2016.0,4,10,-6
MAR,NLD,2018.0,2,1,1
SLB,AUS,2017.0,1,2,-1
USA,MKD,2011.0,2,2,0
KHM,FRA,2009.0,2,5,-3
TWN,NZL,2009.0,2,2,0
ZMB,JPN,2016.0,2,4,-2
USA,GMB,2008.0,1,3,-2
USA,KWT,1999.0,3,2,1
IRL,CZE,2022.0,1,1,0
IND,UZB,2021.0,2,1,1
USA,PAK,2000.0,4,6,-2
SAU,ESP,2021.0,3,7,-4
TTO,USA,2010.0,4,10,-6
ARG,TUR,2018.0,1,2,-1
FIN,BEL,2009.0,4,2,2
JOR,DEU,2006.0,3,11,-8
IRL,AUT,2022.0,1,2,-1
CAN,MAR,2002.0,2,7,-5
NLD,CMR,2011.0,1,2,-1
SRB,IRL,2017.0,1,2,-1
NOR,UGA,2011.0,1,2,-1
NGA,CAN,2013.0,5,4,1
SDN,JPN,2011.0,2,1,1
BEL,EGY,2010.0,4,4,0
IRN,CHN,2008.0,4,1,3
ESP,TUN,2012.0,1,5,-4
FRA,LAO,2017.0,2,3,-1
PER,BRA,2010.0,3,9,-6
IND,BHR,2019.0,5,1,4
FRA,DJI,2017.0,1,1,0
CMR,ITA,2016.0,3,8,-5
CHN,MEX,2008.0,1,1,0
ZAF,FRA,2022.0,6,6,0
SAU,TUN,2023.0,1,1,0
PRT,IRL,2021.0,4,3,1
ITA,SRB,2020.0,2,6,-4
POL,ESP,2004.0,4,3,1
AUT,KEN,2017.0,1,2,-1
VEN,ITA,2008.0,1,4,-3
FJI,USA,2016.0,1,2,-1
MEX,NZL,2020.0,3,1,2
HUN,POL,2015.0,2,3,-1
ROU,FIN,2022.0,1,1,0
NOR,BGD,2011.0,1,2,-1
CAN,ALB,2019.0,2,2,0
DZA,CHN,2019.0,3,13,-10
GHA,CAN,2016.0,3,5,-2
ISL,CAN,2020.0,2,2,0
IRN,NGA,2019.0,1,1,0
NGA,BEN,2019.0,1,4,-3
CZE,DNK,2014.0,4,3,1
GHA,SEN,2021.0,1,1,0
GRC,POL,1998.0,1,1,0
LBN,ARE,2014.0,1,2,-1
LTU,NOR,2011.0,2,1,1
KOR,RUS,2016.0,4,4,0
CAN,UKR,2014.0,1,5,-4
FRA,EGY,2003.0,6,2,4
AUS,HUN,2002.0,1,1,0
ESP,AUT,1997.0,2,2,0
SVK,DNK,2006.0,1,1,0
ROU,DNK,2008.0,2,4,-2
NOR,VNM,2020.0,1,3,-2
KEN,CHE,2018.0,6,4,2
TUR,AUT,2012.0,2,3,-1
CHN,NER,2015.0,1,1,0
BIH,SRB,2016.0,7,14,-7
IND,TTO,2019.0,2,2,0
SWE,SRB,2014.0,3,4,-1
DEU,ARM,2013.0,1,2,-1
MAC,SWE,2016.0,1,1,0
CHE,VNM,2009.0,2,1,1
IRN,RUS,2005.0,1,1,0
EGY,OMN,2018.0,3,4,-1
USA,COD,2021.0,1,2,-1
SLE,KEN,2011.0,1,1,0
VNM,SWE,2015.0,1,5,-4
JOR,QAT,2011.0,3,1,2
CAN,DZA,2006.0,1,4,-3
AUT,CAN,1999.0,1,6,-5
ZAF,GMB,2018.0,1,2,-1
NLD,UKR,2012.0,1,2,-1
ECU,CUB,2016.0,1,24,-23
EST,IND,2022.0,3,2,1
KOR,KWT,2018.0,1,1,0
CUB,FRA,2018.0,4,2,2
TWN,BGD,2018.0,1,1,0
USA,TUN,2008.0,1,2,-1
BRA,RUS,2013.0,2,10,-8
TWN,ISR,2005.0,1,2,-1
ITA,TUR,2022.0,3,9,-6
JAM,CAN,1998.0,1,1,0
COL,IND,2015.0,1,2,-1
DNK,CYP,2022.0,1,1,0
ISR,PRT,2016.0,2,3,-1
ARE,TUR,2022.0,1,3,-2
POL,SAU,2009.0,1,1,0
ALB,DEU,2018.0,3,1,2
AUT,HRV,2000.0,1,4,-3
UGA,DEU,2009.0,2,1,1
EGY,JOR,2017.0,1,3,-2
QAT,BRA,2013.0,1,1,0
KWT,JOR,2014.0,1,3,-2
TZA,DEU,2020.0,2,8,-6
SRB,FRA,2009.0,1,3,-2
TUR,OMN,2020.0,1,1,0
PER,ARG,2018.0,1,2,-1
DNK,TUR,2012.0,1,4,-3
TZA,USA,1999.0,1,2,-1
EST,ITA,2004.0,1,1,0
TUR,SWE,2001.0,1,2,-1
FIN,IRN,2004.0,1,1,0
ITA,KOR,2005.0,1,6,-5
PRT,URY,2005.0,1,1,0
CAN,BGR,2008.0,2,4,-2
NOR,NZL,2009.0,3,3,0
TZA,GBR,2003.0,3,6,-3
AUT,SRB,2015.0,2,5,-3
ZMB,AUS,2021.0,1,2,-1
FRA,DJI,2010.0,5,4,1
BGR,GRC,1999.0,1,3,-2
CHE,BGR,2013.0,2,3,-1
SAU,LBY,2011.0,1,2,-1
UKR,IRN,2003.0,1,1,0
PAK,IRN,2019.0,3,2,1
NPL,DEU,2017.0,1,1,0
TUR,SVN,2017.0,1,3,-2
SRB,IRQ,2018.0,3,1,2
CHE,LBN,2009.0,1,1,0
SGP,EGY,2015.0,1,1,0
IND,TTO,2017.0,3,2,1
CHL,IRL,2020.0,1,1,0
EGY,CHE,2009.0,2,2,0
FRA,DJI,2019.0,1,2,-1
KAZ,JPN,2020.0,2,2,0
GRC,AUT,2022.0,1,4,-3
BRN,NZL,2017.0,1,1,0
EGY,RUS,2008.0,1,1,0
ESP,SRB,2012.0,1,1,0
PAK,IRN,2017.0,1,2,-1
MAC,AUS,2022.0,1,2,-1
EGY,JOR,2019.0,1,5,-4
SAU,CHE,2021.0,4,2,2
BEL,BGD,2013.0,1,3,-2
MAR,SWE,2022.0,1,1,0
SAU,NLD,2014.0,1,6,-5
MYS,OMN,2005.0,1,1,0
BEL,FIN,2008.0,2,3,-1
KEN,NLD,2001.0,1,3,-2
ARE,IND,2003.0,1,1,0
MEX,KEN,2022.0,1,2,-1
ROU,IND,2006.0,1,1,0
PHL,NLD,2010.0,1,3,-2
EGY,NLD,2005.0,1,2,-1
POL,BLR,2022.0,1,2,-1
UGA,BRA,2020.0,1,1,0
FIN,PHL,2003.0,1,1,0
UGA,CHN,2019.0,1,3,-2
AUS,BTN,2013.0,1,1,0
SAU,UKR,2016.0,1,1,0
ECU,GBR,2012.0,1,1,0
MAR,SAU,2008.0,1,1,0
GAB,SEN,2005.0,1,1,0
SGP,MEX,2021.0,1,1,0
PRT,HUN,2007.0,1,2,-1
DNK,BRA,2001.0,1,2,-1
ZAF,DNK,2014.0,1,3,-2
SYR,JPN,2017.0,1,1,0
PER,COL,2005.0,1,1,0
MLI,CHE,2006.0,1,1,0
KOR,MEX,2019.0,1,8,-7
NLD,COD,2018.0,1,1,0
FRA,LAO,2019.0,1,4,-3
BIH,ESP,2019.0,1,1,0
AUT,COL,2020.0,1,6,-5
ZAF,SVK,2021.0,1,1,0
USA,FRA,2003.0,646,751,-105
GBR,SGP,2003.0,36,47,-11
USA,GBR,2020.0,1490,1694,-204
NLD,ROU,2011.0,2,3,-1
USA,SWE,2007.0,163,189,-26
JOR,AUS,2017.0,4,11,-7
SGP,MYS,2011.0,21,13,8
COG,COD,2007.0,5,6,-1
CAN,HKG,2011.0,16,28,-12
EGY,USA,2014.0,73,101,-28
TWN,IDN,2015.0,17,11,6
AUS,NOR,2012.0,17,14,3
IRL,FRA,2015.0,44,26,18
SAU,JPN,2019.0,11,15,-4
COL,ESP,2021.0,57,62,-5
GBR,COL,2022.0,9,6,3
POL,FRA,2005.0,25,21,4
NLD,LVA,2018.0,1,2,-1
DEU,MEX,2018.0,37,55,-18
RUS,UZB,2014.0,3,5,-2
NGA,PAK,2021.0,4,4,0
BRA,VEN,2020.0,5,13,-8
IND,NZL,2020.0,33,11,22
NOR,IRL,2018.0,4,6,-2
GBR,RUS,2004.0,35,49,-14
CAN,SGP,2017.0,30,40,-10
NLD,MKD,2014.0,2,1,1
JPN,RUS,2011.0,12,15,-3
SAU,JPN,2010.0,2,13,-11
MYS,BEL,2013.0,1,3,-2
FIN,DEU,2003.0,31,23,8
USA,ISL,2019.0,16,9,7
MAR,FRA,2003.0,46,52,-6
ROU,GBR,2020.0,18,15,3
POL,CHN,2022.0,8,9,-1
LBN,CHE,2020.0,1,1,0
GBR,ZAF,2008.0,58,75,-17
AUS,GBR,1997.0,39,35,4
GBR,DNK,2001.0,30,34,-4
FRA,HUN,1999.0,6,6,0
CHN,TWN,2012.0,37,94,-57
POL,BEL,2014.0,17,8,9
SWE,ISL,2013.0,8,15,-7
CAN,SGP,2010.0,22,26,-4
PHL,DEU,2008.0,5,3,2
SWE,BEL,2005.0,7,6,1
TUN,FRA,2004.0,33,61,-28
JPN,IRN,2005.0,16,8,8
CHL,MEX,2002.0,3,5,-2
FIN,ESP,2006.0,3,6,-3
PYF,FRA,2013.0,7,16,-9
PAK,USA,2002.0,24,19,5
ROU,IRL,2010.0,3,2,1
RUS,JPN,2014.0,15,16,-1
GBR,PER,2011.0,3,3,0
AUT,SVK,2003.0,5,8,-3
FIN,DNK,2007.0,7,5,2
USA,OMN,2001.0,3,1,2
SAU,IRL,2017.0,6,1,5
BRA,NLD,2021.0,40,19,21
ISR,ZAF,2015.0,3,2,1
CAN,TUN,2011.0,6,9,-3
JPN,MNG,2014.0,11,4,7
BRA,SWE,2013.0,8,3,5
DNK,AUT,2012.0,10,7,3
DEU,PHL,2019.0,5,12,-7
POL,AUT,2013.0,11,10,1
SVN,DEU,2018.0,11,4,7
ROU,IRL,2019.0,2,3,-1
CHE,PAK,2012.0,1,3,-2
ESP,PER,2010.0,5,10,-5
RUS,ITA,2013.0,18,14,4
ITA,DNK,2002.0,12,17,-5
RUS,DNK,2016.0,5,1,4
DZA,SAU,2018.0,11,4,7
NPL,DEU,2019.0,4,4,0
RUS,ISR,2000.0,7,5,2
SWE,SGP,2006.0,6,4,2
ISL,NLD,2007.0,2,3,-1
CRI,FRA,2014.0,1,2,-1
SWE,MEX,2016.0,5,6,-1
SAU,SDN,2007.0,4,3,1
AUS,CZE,2008.0,3,1,2
ITA,ARM,2010.0,1,3,-2
SWE,BGD,2019.0,1,8,-7
IRL,NZL,2006.0,3,4,-1
HRV,SVN,2017.0,5,6,-1
JPN,HKG,2012.0,6,12,-6
HTI,USA,2012.0,11,4,7
EST,BEL,2021.0,3,2,1
DNK,GRC,2019.0,6,12,-6
CHE,CHL,2016.0,5,4,1
ARG,DEU,2009.0,21,11,10
JOR,AUS,2019.0,3,6,-3
MYS,ZAF,2016.0,5,1,4
LAO,SWE,2010.0,1,1,0
HRV,GBR,2003.0,4,1,3
SWE,HUN,2007.0,10,6,4
SWE,BRA,2009.0,6,5,1
GBR,VNM,2003.0,4,5,-1
TZA,NOR,2015.0,2,7,-5
VEN,COL,2009.0,3,3,0
HKG,JPN,2009.0,3,7,-4
CHN,OMN,2019.0,2,2,0
SRB,HRV,2009.0,8,11,-3
POL,KOR,2006.0,1,1,0
BGR,RUS,2013.0,3,3,0
ITA,HKG,2011.0,2,2,0
ECU,BEL,2005.0,1,1,0
EST,DEU,2003.0,3,2,1
BRA,KOR,2016.0,2,5,-3
JOR,ARE,2003.0,3,3,0
BEL,EGY,2019.0,4,2,2
FIN,ARE,2020.0,2,1,1
ZAF,MOZ,2015.0,1,1,0
KOR,BGD,2007.0,4,12,-8
SWE,BGD,2017.0,4,8,-4
KOR,MEX,2010.0,1,2,-1
LTU,CZE,2019.0,2,1,1
ISR,AUT,2010.0,2,1,1
MEX,FRA,1998.0,5,7,-2
ISL,SWE,2001.0,2,5,-3
ISR,HUN,2013.0,4,7,-3
NER,IND,2016.0,2,1,1
CAN,BRB,2006.0,2,2,0
SGP,PAK,2019.0,2,4,-2
IND,FIN,2001.0,2,2,0
QAT,ITA,2015.0,1,7,-6
ESP,SVN,2008.0,2,3,-1
UKR,AUT,2006.0,2,1,1
NOR,JPN,2013.0,5,5,0
ISR,CZE,2011.0,1,3,-2
DEU,TUN,2022.0,3,1,2
SGP,MMR,2016.0,1,1,0
ETH,ITA,2022.0,2,4,-2
SRB,AUS,2021.0,3,1,2
MLI,FRA,2020.0,7,7,0
KEN,THA,2008.0,1,1,0
FRA,LAO,2010.0,1,1,0
SEN,CAN,2021.0,3,1,2
SRB,CZE,2021.0,2,1,1
AUS,BRN,2018.0,2,3,-1
KAZ,AUS,2015.0,1,2,-1
BOL,ESP,2013.0,3,1,2
ISR,AUT,2019.0,3,4,-1
JOR,AUS,2010.0,2,6,-4
ARG,COL,2005.0,2,2,0
URY,DNK,2009.0,1,1,0
BEL,UKR,2012.0,1,2,-1
RWA,BEL,2016.0,3,5,-2
ITA,ARM,2019.0,2,2,0
MYS,UZB,2013.0,1,2,-1
BEL,RWA,2007.0,1,1,0
PSE,GBR,2008.0,1,4,-3
CAN,CUB,2009.0,1,5,-4
BEL,ISR,2021.0,1,5,-4
POL,VNM,2022.0,1,2,-1
,TUR,2004.0,6097,0,6097
USA,,2013.0,58292,0,58292
,ESP,2002.0,11773,0,11773
DEU,,2010.0,11975,0,11975
TWN,,2024.0,32298,0,32298
NZL,,2022.0,2874,0,2874
,IND,2002.0,11366,0,11366
DEU,,2019.0,23707,0,23707
CZE,,2024.0,16407,0,16407
FRA,,2015.0,10039,0,10039
,VEN,2004.0,497,0,497
,DNK,2006.0,1956,0,1956
CAN,,2021.0,17194,0,17194
DEU,,2017.0,19044,0,19044
BIH,,2021.0,347,0,347
,RUS,1995.0,10341,0,10341
RUS,,2004.0,3004,0,3004
TUR,,2021.0,8780,0,8780
AUS,,2012.0,3799,0,3799
,IND,2005.0,14992,0,14992
ISR,,2011.0,1338,0,1338
GBR,,2004.0,6063,0,6063
,CHN,1994.0,13014,0,13014
,IDN,2016.0,6482,0,6482
,SWE,2000.0,4663,0,4663
,KWT,2004.0,163,0,163
IRL,,2011.0,616,0,616
NOR,EST,2004.0,1,0,1
POL,,2004.0,765,0,765
,ESP,2005.0,12515,0,12515
,EGY,1997.0,378,0,378
,EGY,1998.0,1694,0,1694
NLD,,2000.0,171,0,171
MYS,,2008.0,196,0,196
CUB,,2024.0,1325,0,1325
,AUT,2007.0,2384,0,2384
KOR,,2021.0,17721,0,17721
LVA,,2024.0,1489,0,1489
SGP,,2016.0,1376,0,1376
,ITA,2014.0,13791,0,13791
,GMB,2004.0,7,0,7
LTU,,2016.0,390,0,390
PRT,,2009.0,497,0,497
,TUR,1996.0,1515,0,1515
ECU,BEL,2002.0,1,0,1
ZWE,,2023.0,417,0,417
,QAT,2016.0,346,0,346
UGA,,2022.0,504,0,504
,JPN,2013.0,22301,0,22301
CYP,,2014.0,55,0,55
,SDN,2004.0,58,0,58
,SVK,1995.0,564,0,564
BEL,,2001.0,69,0,69
,ECU,2001.0,74,0,74
,CYP,2003.0,45,0,45
ARE,,2013.0,104,0,104
,SAU,2010.0,1437,0,1437
,NLD,2016.0,6492,0,6492
HKG,PAK,1999.0,1,0,1
,DEU,2014.0,23549,0,23549
BLR,,2022.0,594,0,594
,VEN,1996.0,231,0,231
VNM,,2012.0,109,0,109
,DZA,2011.0,1290,0,1290
,MOZ,2004.0,37,0,37
,ALB,2012.0,104,0,104
,TWN,2013.0,6059,0,6059
ECU,,2018.0,107,0,107
BEN,,2023.0,381,0,381
KAZ,,2012.0,46,0,46
,BLR,2010.0,201,0,201
,NZL,2015.0,1361,0,1361
DZA,FIN,2018.0,2,0,2
,SAU,2017.0,2817,0,2817
IRQ,,2016.0,98,0,98
,KEN,2014.0,489,0,489
FIN,QAT,2018.0,2,0,2
BRB,PYF,2019.0,1,0,1
,URY,2013.0,248,0,248
CUB,AUS,2015.0,2,0,2
LIE,,2024.0,52,0,52
,BDI,2011.0,10,0,10
,SAU,2019.0,2387,0,2387
NZL,NPL,2016.0,2,0,2
,VUT,2011.0,6,0,6
PER,POL,2016.0,1,0,1
MLI,,2021.0,84,0,84
TTO,USA,2019.0,7,0,7
GRC,,2025.0,8,0,8
JPN,SAU,2007.0,4,0,4
GBR,KOR,1998.0,4,0,4
MKD,POL,2019.0,3,0,3
SRB,,2005.0,81,0,81
KOR,MNG,2021.0,4,0,4
VEN,CHL,2018.0,17,0,17
COL,EST,2021.0,2,0,2
,BLR,2017.0,319,0,319
CHL,CRI,2019.0,8,0,8
KWT,,2023.0,824,0,824
,KHM,2010.0,55,0,55
SAU,,2003.0,92,0,92
,KHM,2017.0,40,0,40
,CRI,2001.0,58,0,58
THA,HUN,2018.0,1,0,1
,MAC,2006.0,54,0,54
,TGO,2005.0,26,0,26
IRL,EGY,2009.0,2,0,2
ZWE,CHE,2018.0,1,0,1
SAU,IRL,2010.0,1,0,1
YEM,,2011.0,14,0,14
BGD,FRA,2009.0,2,0,2
KWT,OMN,2014.0,1,0,1
HKG,LUX,2015.0,1,0,1
PAN,,2020.0,33,0,33
PER,AUS,2014.0,3,0,3
SVK,CAN,2003.0,6,0,6
BFA,ZAF,2013.0,1,0,1
,KWT,1996.0,63,0,63
HUN,,2003.0,256,0,256
MYS,AFG,2016.0,2,0,2
SRB,,2002.0,32,0,32
GBR,MAC,2009.0,4,0,4
COL,,2005.0,72,0,72
,BWA,2008.0,61,0,61
UKR,AUS,2019.0,3,0,3
GRD,BEL,2019.0,1,0,1
,COM,2016.0,9,0,9
TZA,KEN,2021.0,4,0,4
VEN,QAT,2018.0,1,0,1
ROU,EST,2022.0,1,0,1
,BLR,2019.0,133,0,133
TUR,SVK,2019.0,1,0,1
IND,YEM,2012.0,9,0,9
CHN,GIN,2021.0,1,0,1
REU,NCL,2009.0,1,0,1
,SDN,1996.0,18,0,18
,BIH,1998.0,54,0,54
ARG,ZAF,2016.0,4,0,4
NLD,RWA,2015.0,4,0,4
AUT,KOR,2006.0,4,0,4
GHA,,2007.0,30,0,30
,MWI,2001.0,44,0,44
COG,,2008.0,24,0,24
,TGO,2002.0,16,0,16
,MOZ,1996.0,9,0,9
PRI,,2007.0,66,0,66
GRC,TUR,2003.0,3,0,3
AUS,VNM,2003.0,6,0,6
HKG,HUN,2000.0,1,0,1
TKM,,2002.0,2,0,2
,GMB,1996.0,6,0,6
GMB,,2018.0,15,0,15
CIV,CMR,2003.0,1,0,1
NZL,GHA,2005.0,1,0,1
HKG,POL,2004.0,1,0,1
UGA,PER,2006.0,1,0,1
ARG,SWE,2005.0,4,0,4
HRV,,2001.0,15,0,15
MDA,CHE,2006.0,1,0,1
OMN,,2007.0,36,0,36
,BOL,1999.0,28,0,28
OMN,QAT,2003.0,1,0,1
UGA,ZAF,2005.0,3,0,3
MLT,,2016.0,27,0,27
NZL,NCL,2018.0,2,0,2
,MMR,2006.0,9,0,9
SAU,TUR,2022.0,2,0,2
BFA,,2005.0,9,0,9
CAN,PRI,2002.0,2,0,2
MTQ,,2006.0,5,0,5
SVK,GRC,2005.0,1,0,1
POL,MDA,2010.0,2,0,2
JAM,,2004.0,11,0,11
CHN,SAU,2009.0,4,0,4
CAN,PHL,2011.0,1,0,1
DEU,DOM,2010.0,2,0,2
ROU,MDV,2008.0,1,0,1
NPL,THA,2009.0,3,0,3
NLD,ARM,2009.0,2,0,2
PAK,IRN,2010.0,2,0,2
BMU,,2011.0,1,0,1
,PNG,2000.0,17,0,17
SLV,,2020.0,13,0,13
NGA,AUT,2008.0,2,0,2
SWE,MLT,2017.0,1,0,1
DOM,,2018.0,13,0,13
CZE,LKA,2012.0,2,0,2
LIE,CAN,2019.0,2,0,2
COL,AGO,2006.0,1,0,1
KOR,ESP,2001.0,2,0,2
MYS,LTU,2021.0,1,0,1
UGA,PAK,2016.0,1,0,1
RUS,THA,2022.0,1,0,1
BRB,,2018.0,5,0,5
,SLB,2012.0,4,0,4
TUN,CHN,2022.0,2,0,2
CHN,ROU,2021.0,1,0,1
GIN,MLI,2016.0,1,0,1
CAN,PRI,2005.0,1,0,1
SEN,,2012.0,38,0,38
DJI,,2015.0,7,0,7
USA,LUX,2003.0,3,0,3
,BRB,2003.0,4,0,4
AZE,,2001.0,11,0,11
NLD,UGA,2015.0,4,0,4
BIH,IDN,2014.0,1,0,1
,FLK,2002.0,5,0,5
,KHM,2019.0,14,0,14
SEN,MDG,1999.0,1,0,1
CUB,USA,2020.0,8,0,8
UGA,LBR,2015.0,1,0,1
LSO,USA,2014.0,2,0,2
CHL,HND,2019.0,2,0,2
BEN,CHE,2018.0,2,0,2
COL,,2002.0,14,0,14
QAT,FIN,2020.0,1,0,1
CYP,DNK,2016.0,1,0,1
ZWE,BDI,2018.0,1,0,1
NER,USA,2015.0,2,0,2
ITA,VEN,2021.0,1,0,1
,BIH,1997.0,9,0,9
BHR,ARE,2008.0,2,0,2
NZL,KEN,2022.0,2,0,2
LSO,ZWE,2012.0,1,0,1
BRA,URY,2000.0,2,0,2
FRA,GIN,2012.0,2,0,2
ISR,ARE,2004.0,1,0,1
GBR,NAM,2003.0,1,0,1
BOL,ITA,2007.0,1,0,1
USA,WSM,2004.0,1,0,1
NOR,TZA,2000.0,3,0,3
PER,,2003.0,8,0,8
SGP,CHL,2009.0,1,0,1
KOR,KHM,2013.0,2,0,2
BEL,CIV,2002.0,1,0,1
SVK,FIN,2008.0,1,0,1
MWI,JPN,2011.0,1,0,1
,TCD,2003.0,2,0,2
LAO,VNM,2014.0,4,0,4
WSM,,2012.0,1,0,1
FRA,NGA,2008.0,1,0,1
BFA,GAB,2012.0,2,0,2
KWT,IND,2013.0,5,0,5
KOR,NOR,2013.0,4,0,4
,WSM,2002.0,2,0,2
HUN,SVN,2002.0,1,0,1
NGA,GHA,2010.0,2,0,2
CHE,TCD,2004.0,2,0,2
,MRT,2008.0,7,0,7
IND,COL,2021.0,1,0,1
SYR,,2025.0,1,0,1
BRA,KWT,2016.0,2,0,2
SWE,NIC,2010.0,3,0,3
CZE,ECU,2019.0,1,0,1
,BTN,2004.0,8,0,8
MUS,IND,2015.0,1,0,1
SAU,PSE,2016.0,1,0,1
BFA,ETH,2017.0,2,0,2
,LSO,2012.0,9,0,9
SRB,SWE,1998.0,1,0,1
NZL,HUN,2004.0,1,0,1
BRA,ECU,2003.0,1,0,1
JOR,LBN,2014.0,1,0,1
BEL,KAZ,2018.0,3,0,3
GTM,PER,2017.0,1,0,1
BEL,BIH,2002.0,4,0,4
NZL,ARE,2003.0,3,0,3
,DOM,1995.0,3,0,3
BRB,USA,2003.0,1,0,1
ARE,HUN,2011.0,3,0,3
VNM,KHM,2018.0,1,0,1
MAC,,2015.0,13,0,13
BRA,NPL,2019.0,1,0,1
TZA,MYS,2014.0,1,0,1
PRI,ISR,2019.0,1,0,1
BEN,BDI,2019.0,2,0,2
HUN,ZAF,2021.0,1,0,1
MYS,JOR,2008.0,3,0,3
CUB,CZE,2019.0,2,0,2
ARG,DOM,2020.0,1,0,1
GUY,,2015.0,1,0,1
SLV,DEU,2013.0,1,0,1
LBY,,2006.0,7,0,7
IRN,MEX,2016.0,3,0,3
OMN,GRC,2019.0,1,0,1
POL,MYS,2002.0,1,0,1
MDG,FRA,1998.0,2,0,2
DEU,NPL,2008.0,2,0,2
MMR,,2005.0,2,0,2
MRT,,2004.0,4,0,4
GUY,GUF,2008.0,3,0,3
ZWE,ETH,2001.0,1,0,1
DEU,BHR,2012.0,2,0,2
UKR,BRA,2001.0,2,0,2
,KGZ,2000.0,6,0,6
SGP,VNM,2002.0,1,0,1
ESP,AND,2006.0,2,0,2
PER,CAN,2007.0,2,0,2
DEU,THA,2000.0,3,0,3
JPN,PER,2006.0,2,0,2
GBR,MDG,2011.0,3,0,3
ISR,EGY,2009.0,1,0,1
ITA,IRQ,2018.0,4,0,4
NZL,GRC,2010.0,3,0,3
TWN,ARE,2021.0,3,0,3
BDI,,2013.0,3,0,3
,MTQ,2008.0,1,0,1
LBY,CAN,2012.0,1,0,1
AUT,CIV,2017.0,1,0,1
HRV,CHE,2020.0,4,0,4
NGA,NPL,2016.0,1,0,1
,BLZ,2013.0,4,0,4
RWA,CAN,2014.0,1,0,1
KGZ,,2016.0,7,0,7
DNK,MAR,2017.0,1,0,1
LBY,HRV,2015.0,1,0,1
SGP,NGA,2010.0,1,0,1
EGY,NLD,2002.0,4,0,4
CAN,SEN,2002.0,1,0,1
,GNQ,2001.0,3,0,3
NOR,KEN,2016.0,1,0,1
PSE,ARE,2008.0,1,0,1
EST,SGP,2012.0,1,0,1
TWN,SWZ,2018.0,1,0,1
AND,,2008.0,3,0,3
LTU,JPN,2005.0,1,0,1
TGO,,2002.0,1,0,1
TUR,NLD,2000.0,3,0,3
TUR,IRL,2003.0,2,0,2
LSO,GMB,2000.0,1,0,1
ZMB,BWA,2008.0,1,0,1
BRN,IND,2016.0,1,0,1
,BHS,2004.0,5,0,5
GNQ,ESP,2018.0,1,0,1
BFA,BEL,2002.0,1,0,1
SYR,JOR,2021.0,1,0,1
PAK,SYR,2019.0,1,0,1
PRT,ECU,2015.0,2,0,2
NLD,ETH,2022.0,2,0,2
SAU,NGA,2007.0,1,0,1
ARM,BLR,2018.0,1,0,1
BEN,ITA,2002.0,1,0,1
ITA,TWN,2004.0,1,0,1
,TON,2019.0,1,0,1
IND,VEN,2017.0,1,0,1
SYR,UZB,2022.0,1,0,1
CUB,COL,2014.0,5,0,5
ROU,SVK,2011.0,1,0,1
FRA,SYR,2001.0,2,0,2
CHL,KEN,2007.0,1,0,1
PHL,GRC,2021.0,1,0,1
GBR,SYR,2002.0,1,0,1
NZL,IND,1997.0,1,0,1
,PRK,2004.0,1,0,1
NOR,URY,2018.0,1,0,1
GEO,GRC,2021.0,1,0,1
COG,PAK,2009.0,1,0,1
ARE,TTO,2018.0,1,0,1
LTU,DNK,2009.0,1,0,1
FIN,BHR,2015.0,1,0,1
POL,LUX,2005.0,1,0,1
NGA,IRN,2017.0,1,0,1
NPL,NZL,2014.0,3,0,3
CHN,HRV,2021.0,1,0,1
CHN,TKM,2016.0,2,0,2
ESP,LTU,2011.0,1,0,1
CUB,GTM,2006.0,1,0,1
ECU,PRY,2021.0,1,0,1
MYS,HKG,2004.0,1,0,1
,FLK,2005.0,3,0,3
QAT,PRT,2021.0,1,0,1
CHL,BEL,1998.0,1,0,1
FRA,TWN,2000.0,2,0,2
USA,PSE,2000.0,1,0,1
ATG,GBR,2021.0,1,0,1
AUS,KWT,2008.0,2,0,2
DNK,BIH,2011.0,2,0,2
EST,DNK,2007.0,3,0,3
CAN,ALB,2017.0,1,0,1
UZB,SWE,2002.0,1,0,1
KOR,LUX,2015.0,2,0,2
GHA,USA,1999.0,1,0,1
SGP,BRA,2005.0,1,0,1
BFA,BEL,2005.0,1,0,1
BEL,LKA,2002.0,1,0,1
GHA,ITA,2013.0,1,0,1
PER,ECU,2009.0,1,0,1
NLD,LUX,2003.0,2,0,2
NLD,TGO,2002.0,1,0,1
ARE,PAK,2004.0,3,0,3
UKR,PRT,2014.0,3,0,3
FRA,OMN,2001.0,2,0,2
SWE,MWI,2007.0,1,0,1
CUB,CHL,2011.0,4,0,4
GBR,KHM,2004.0,1,0,1
KWT,ROU,2006.0,1,0,1
KWT,TUR,2003.0,1,0,1
TWN,NPL,2020.0,1,0,1
BHR,IND,2004.0,2,0,2
CPV,,2018.0,1,0,1
KEN,MRT,2012.0,1,0,1
CHN,PHL,2003.0,2,0,2
TKM,,2005.0,3,0,3
ITA,JOR,2013.0,2,0,2
DEU,UGA,2010.0,1,0,1
DNK,FRO,2012.0,2,0,2
NGA,,1999.0,5,0,5
TJK,RUS,2000.0,2,0,2
LUX,ISR,2007.0,1,0,1
PYF,GUF,2007.0,1,0,1
JPN,BRN,2007.0,1,0,1
CHE,LIE,2009.0,1,0,1
SUR,,2016.0,2,0,2
TUN,UKR,2017.0,1,0,1
UGA,AUS,2008.0,1,0,1
GBR,SLE,2011.0,1,0,1
CHE,URY,2022.0,1,0,1
LVA,BEL,2018.0,1,0,1
GEO,ESP,2003.0,1,0,1
ETH,GHA,2006.0,1,0,1
KOR,SGP,1998.0,1,0,1
GNB,,2005.0,1,0,1
POL,HUN,2005.0,1,0,1
CUB,PER,2014.0,1,0,1
CMR,,2001.0,1,0,1
DEU,SEN,2004.0,2,0,2
TUR,SVN,2019.0,1,0,1
AUT,ISR,2015.0,3,0,3
JPN,ECU,2013.0,2,0,2
KOR,CZE,2003.0,3,0,3
GHA,GMB,2008.0,2,0,2
CHN,UGA,2011.0,1,0,1
SRB,VNM,2015.0,1,0,1
AUT,PSE,2015.0,2,0,2
MLI,BEL,2017.0,1,0,1
MKD,SWE,2013.0,1,0,1
TUR,SVK,2017.0,1,0,1
SWE,CRI,2001.0,3,0,3
BFA,AUT,2022.0,2,0,2
DNK,SVK,2016.0,1,0,1
NZL,PER,2018.0,1,0,1
COD,JPN,2019.0,1,0,1
SVN,BRA,2017.0,1,0,1
HUN,TUR,2019.0,1,0,1
USA,LBY,2021.0,3,0,3
IRQ,OMN,2007.0,1,0,1
ZAF,SDN,2005.0,1,0,1
SYR,BEL,2018.0,2,0,2
TGO,GBR,2018.0,1,0,1
BEL,GMB,2021.0,2,0,2
MEX,GTM,2022.0,4,0,4
TUR,JOR,2014.0,2,0,2
GUY,NGA,2022.0,1,0,1
PNG,ESP,2021.0,1,0,1
TWN,MEX,2021.0,1,0,1
ARE,ITA,2009.0,1,0,1
USA,PRY,2013.0,2,0,2
IRL,IRQ,2011.0,1,0,1
GBR,BRB,2013.0,3,0,3
LAO,KHM,2015.0,1,0,1
SVN,FIN,2017.0,2,0,2
UKR,DZA,2016.0,1,0,1
ISR,NPL,2021.0,1,0,1
CZE,NOR,2022.0,3,0,3
POL,MDA,2019.0,1,0,1
PRT,COL,2003.0,2,0,2
TWN,UZB,2022.0,2,0,2
USA,UZB,2020.0,3,0,3
MUS,GBR,2017.0,4,0,4
LUX,USA,2000.0,1,0,1
IRN,ITA,2000.0,1,0,1
,VCT,2018.0,1,0,1
SEN,NGA,2017.0,2,0,2
FIN,ECU,2019.0,1,0,1
RUS,LTU,2021.0,1,0,1
BEN,BEL,2022.0,1,0,1
BEL,PHL,2022.0,1,0,1
CAN,TGO,2008.0,1,0,1
NPL,,2000.0,1,0,1
DZA,,2000.0,1,0,1
MYS,LBY,1998.0,1,0,1
NAM,MWI,2015.0,1,0,1
MAR,MLI,2008.0,1,0,1
LTU,IRL,2009.0,1,0,1
JAM,CAN,1997.0,1,0,1
BLR,CAN,2013.0,1,0,1
BEL,IRL,2000.0,1,0,1
CHL,CHE,1997.0,1,0,1
OMN,NGA,2003.0,1,0,1
MEX,HRV,2003.0,1,0,1
BOL,PRT,2018.0,1,0,1
CRI,DNK,2004.0,1,0,1
SVN,FIN,2019.0,2,0,2
KEN,BWA,2012.0,1,0,1
ITA,PRY,2016.0,1,0,1
CHN,IRL,2000.0,1,0,1
BGD,BRA,2016.0,1,0,1
QAT,CYP,2017.0,1,0,1
GRC,HKG,2019.0,2,0,2
MAR,CZE,2018.0,1,0,1
CMR,SEN,2017.0,2,0,2
AZE,GEO,2022.0,1,0,1
UZB,FRA,1997.0,1,0,1
SGP,VNM,2005.0,1,0,1
MTQ,CAN,2006.0,1,0,1
USA,ERI,2014.0,1,0,1
NAM,JPN,2018.0,1,0,1
PHL,TUR,2014.0,1,0,1
,PLW,1998.0,1,0,1
VEN,CHE,2007.0,1,0,1
MOZ,FRA,2009.0,1,0,1
SDN,ITA,2017.0,1,0,1
BGD,COL,2015.0,1,0,1
IRN,PRI,2011.0,1,0,1
ITA,LTU,2012.0,1,0,1
TUR,PRI,2004.0,1,0,1
THA,BGD,2003.0,1,0,1
SWE,ECU,2009.0,1,0,1
KHM,ITA,2007.0,1,0,1
NER,EGY,2018.0,1,0,1
THA,IDN,2006.0,1,0,1
JPN,JAM,2015.0,2,0,2
IRN,SVN,2009.0,1,0,1
THA,DEU,1997.0,1,0,1
CIV,TGO,2013.0,1,0,1
GTM,ARG,2019.0,1,0,1
MKD,CAN,2017.0,1,0,1
IRL,PHL,2016.0,1,0,1
LIE,ESP,2018.0,1,0,1
CHE,MOZ,2020.0,1,0,1
EGY,TUN,2018.0,1,0,1
NIC,COL,2010.0,1,0,1
SYR,JPN,2019.0,3,0,3
MUS,ITA,2010.0,1,0,1
PNG,GIN,2022.0,1,0,1
TZA,ETH,2017.0,1,0,1
AUT,THA,1998.0,1,0,1
CCK,,2013.0,2,0,2
HND,,2009.0,2,0,2
GEO,ISR,2012.0,1,0,1
SVN,BRA,2010.0,1,0,1
CHN,THA,2000.0,1,0,1
MYS,KWT,2013.0,2,0,2
SVK,HUN,2002.0,1,0,1
SGP,DEU,1997.0,1,0,1
NGA,MTQ,2006.0,1,0,1
USA,BTN,2017.0,2,0,2
,TON,2017.0,1,0,1
,TON,2010.0,2,0,2
JPN,MWI,2003.0,1,0,1
BRN,GBR,1998.0,1,0,1
GBR,JOR,2000.0,1,0,1
HKG,CHE,1999.0,2,0,2
AUS,GMB,2009.0,1,0,1
LKA,PAK,2020.0,1,0,1
COD,UGA,2020.0,1,0,1
IND,ZWE,2022.0,1,0,1
LBN,BHR,2022.0,1,0,1
IND,CHL,2007.0,1,0,1
ARG,DZA,2010.0,1,0,1
CUB,CAN,1999.0,1,0,1
GBR,COM,2012.0,1,0,1
IND,GUY,2012.0,1,0,1
FIN,PNG,2019.0,1,0,1
GTM,ARG,2017.0,1,0,1
MWI,BEL,2013.0,1,0,1
NGA,GUY,2013.0,1,0,1
GMB,MLI,2022.0,1,0,1
ROU,RUS,2005.0,1,0,1
ROU,GEO,2015.0,1,0,1
SRB,ARG,2006.0,1,0,1
UKR,THA,2009.0,1,0,1
JPN,IRQ,2013.0,1,0,1
USA,BTN,2019.0,2,0,2
GMB,BFA,2017.0,1,0,1
FRA,AND,2021.0,1,0,1
ZAF,KHM,2018.0,1,0,1
BGD,DNK,2005.0,1,0,1
LKA,TWN,2021.0,1,0,1
FRA,UGA,2006.0,1,0,1
SWE,DZA,2010.0,1,0,1
HND,CHL,2003.0,1,0,1
SAU,PNG,2020.0,1,0,1
PRT,OMN,2020.0,1,0,1
BRA,GUF,2014.0,1,0,1
BRN,AUS,2007.0,1,0,1
BIH,CYP,2019.0,1,0,1
NAM,,2009.0,4,0,4
BEL,MRT,2007.0,1,0,1
BLZ,,2012.0,3,0,3
SVK,GRC,2002.0,1,0,1
ITA,KAZ,2008.0,1,0,1
NOR,LBY,2012.0,1,0,1
ISR,SAU,2016.0,1,0,1
ZAF,LVA,2010.0,1,0,1
SEN,CHE,2005.0,1,0,1
BLR,AUT,2004.0,1,0,1
RWA,ZWE,2014.0,1,0,1
MYS,UGA,2019.0,2,0,2
BDI,COD,2015.0,1,0,1
,CCK,2016.0,1,0,1
MLI,BEL,2019.0,2,0,2
SWE,LKA,2006.0,1,0,1
NZL,UGA,2020.0,1,0,1
UZB,GBR,2012.0,2,0,2
SYR,AUS,2015.0,1,0,1
BGD,SWE,2007.0,1,0,1
SSD,NOR,2018.0,1,0,1
EST,JPN,2018.0,1,0,1
ITA,PER,2013.0,2,0,2
EGY,GHA,2022.0,1,0,1
GRC,BGD,2016.0,1,0,1
GMB,NLD,2011.0,1,0,1
TTO,DEU,2014.0,1,0,1
,VIR,2007.0,1,0,1
HRV,MNE,2014.0,1,0,1
KWT,NZL,2020.0,1,0,1
KWT,NOR,2008.0,1,0,1
LTU,CZE,2010.0,1,0,1
BIH,DEU,2005.0,1,0,1
USA,PYF,2015.0,1,0,1
UZB,UKR,2010.0,1,0,1
TGO,,2005.0,1,0,1
DEU,NER,2011.0,1,0,1
MYS,JPN,1998.0,1,0,1
GUF,,2005.0,1,0,1
CZE,ITA,1999.0,1,0,1
MLT,RUS,2008.0,1,0,1
BFA,CHE,2005.0,1,0,1
LTU,NZL,2008.0,1,0,1
PER,CHN,2014.0,1,0,1
DEU,BEN,2015.0,1,0,1
MLI,BEL,2010.0,1,0,1
IRL,ETH,2011.0,1,0,1
CAN,GRD,2011.0,1,0,1
EST,KOR,2022.0,1,0,1
UKR,JOR,2020.0,1,0,1
LVA,FRA,2012.0,1,0,1
DEU,BRN,2019.0,1,0,1
KOR,ARG,2004.0,1,0,1
KHM,ETH,2010.0,1,0,1
AUS,MOZ,2008.0,1,0,1
RUS,ROU,2016.0,1,0,1
HRV,GRC,2006.0,1,0,1
CRI,GBR,2010.0,1,0,1
MHL,AUS,2007.0,1,0,1
GBR,PSE,2011.0,1,0,1
URY,BOL,2018.0,1,0,1
NLD,OMN,2021.0,1,0,1
TUR,SYR,2022.0,1,0,1
MYS,BHR,2007.0,1,0,1
ZWE,ZMB,2015.0,1,0,1
MAR,DZA,2004.0,1,0,1
UGA,ISL,2014.0,1,0,1
NER,,2003.0,1,0,1
BRN,ARE,2008.0,1,0,1
GBR,MKD,2017.0,1,0,1
SDN,KWT,2005.0,1,0,1
NCL,FJI,2006.0,1,0,1
AFG,CAN,2009.0,1,0,1
SAU,ISR,2019.0,1,0,1
POL,AFG,2019.0,1,0,1
TWN,PER,2020.0,1,0,1
NCL,CAN,2014.0,1,0,1
USA,PRK,2016.0,1,0,1
SVK,UKR,2001.0,1,0,1
EGY,NOR,2005.0,1,0,1
SDN,ITA,2010.0,1,0,1
AUS,LTU,2006.0,1,0,1
ZWE,RWA,2012.0,1,0,1
ITA,SEN,2009.0,1,0,1
NAM,ZWE,2016.0,1,0,1
POL,COL,2016.0,1,0,1
,MDV,2009.0,1,0,1
ESP,BIH,2022.0,1,0,1
IRL,OMN,2022.0,1,0,1
MDV,ARE,2018.0,1,0,1
GMB,NOR,2021.0,1,0,1
KEN,SWZ,2017.0,1,0,1
PHL,FRA,2001.0,1,0,1
GHA,ZMB,2022.0,1,0,1
COL,UGA,2022.0,1,0,1
MKD,CAN,2019.0,1,0,1
ZWE,SWE,2020.0,1,0,1
EGY,LKA,2022.0,1,0,1
BEL,CZE,2004.0,3,7,-4
CHE,CZE,2012.0,5,13,-8
DEU,CHN,2012.0,199,242,-43
FRA,SWE,2012.0,65,53,12
BEL,RUS,2010.0,2,9,-7
USA,IND,2009.0,498,860,-362
USA,MEX,2009.0,156,157,-1
USA,CHL,2018.0,116,108,8
USA,ISR,2009.0,285,364,-79
CMR,USA,2013.0,7,3,4
ESP,BRA,2012.0,61,49,12
GBR,SWE,2012.0,146,108,38
HKG,CHN,2011.0,371,297,74
GBR,BRA,2015.0,79,93,-14
DEU,CYP,2020.0,6,1,5
ITA,POL,2013.0,40,12,28
PRT,GBR,2005.0,34,40,-6
GBR,IND,2012.0,132,138,-6
TUR,USA,2012.0,191,243,-52
NOR,GBR,2007.0,28,44,-16
IRL,CHN,2009.0,8,8,0
FIN,CAN,2012.0,15,23,-8
CHN,HKG,2007.0,216,208,8
AUS,JPN,2010.0,54,57,-3
TUN,FRA,2014.0,76,126,-50
DEU,NZL,2011.0,28,27,1
FRA,DEU,2008.0,296,314,-18
USA,SGP,2015.0,230,208,22
CAN,CHE,2018.0,86,87,-1
AUT,DEU,2005.0,168,242,-74
USA,NLD,2001.0,183,198,-15
POL,ESP,2014.0,53,14,39
USA,FRA,2001.0,456,553,-97
GBR,NOR,2009.0,46,25,21
JPN,AUS,2011.0,69,45,24
JPN,MNG,2004.0,2,2,0
ESP,NLD,2011.0,54,69,-15
ISR,DEU,2009.0,42,21,21
GRC,QAT,2019.0,3,4,-1
ZAF,AUS,2021.0,36,16,20
ISR,IRL,2010.0,6,2,4
USA,PRT,2016.0,55,79,-24
BEL,CHN,2017.0,64,61,3
FIN,USA,2020.0,81,71,10
CAN,GBR,2007.0,286,300,-14
NLD,BEL,2015.0,180,132,48
FRA,MEX,2015.0,49,26,23
COL,NLD,2006.0,3,3,0
AUS,DEU,2005.0,78,102,-24
RUS,DEU,2008.0,105,74,31
CHE,JPN,2010.0,25,33,-8
DEU,PRT,2007.0,26,15,11
JPN,VNM,2012.0,28,15,13
FIN,CHN,2015.0,19,18,1
IRL,GBR,1999.0,48,53,-5
GBR,DNK,2003.0,59,40,19
GBR,QAT,2013.0,24,1,23
MEX,VEN,2007.0,7,4,3
CHE,AUS,2006.0,39,37,2
CHN,FRA,2006.0,43,32,11
AUT,DEU,2002.0,155,195,-40
DEU,BRA,2020.0,58,141,-83
BEL,CHN,2019.0,64,70,-6
CHE,AUT,2021.0,61,43,18
CAN,OMN,2016.0,8,5,3
CUB,MEX,2000.0,9,3,6
USA,ROU,2018.0,19,15,4
UKR,USA,2006.0,34,9,25
KOR,JPN,2011.0,97,128,-31
JPN,FRA,2014.0,77,95,-18
USA,GTM,2022.0,6,4,2
BEL,GBR,1999.0,22,24,-2
SGP,JPN,2018.0,43,30,13
TUR,DEU,2016.0,61,45,16
FIN,NLD,2011.0,12,16,-4
AUS,CHE,2018.0,65,56,9
GBR,HKG,2012.0,43,26,17
BRA,CAN,2015.0,79,51,28
CMR,CHN,2011.0,1,2,-1
PNG,CHE,2014.0,2,2,0
USA,BEL,2018.0,139,196,-57
UKR,RUS,2009.0,26,27,-1
AUS,JPN,2017.0,67,49,18
ZAF,TWN,2015.0,3,1,2
DEU,ITA,2003.0,134,135,-1
AUS,KEN,2014.0,3,8,-5
SAU,JPN,2018.0,7,16,-9
SVN,FRA,2018.0,2,5,-3
GBR,GHA,2014.0,22,8,14
IND,BGD,2009.0,9,9,0
AUS,BGD,2015.0,19,58,-39
CHN,ITA,2000.0,8,8,0
FRA,ITA,2015.0,220,328,-108
EGY,OMN,2017.0,4,1,3
DEU,MEX,2019.0,35,47,-12
RUS,FRA,2011.0,73,34,39
BEN,BEL,2016.0,2,5,-3
FRA,VNM,2019.0,49,22,27
IND,ISR,2020.0,139,57,82
QAT,SAU,2015.0,3,16,-13
BGD,KOR,2015.0,26,21,5
BRA,IND,2020.0,22,11,11
PRI,USA,2015.0,80,61,19
IRN,BEL,2019.0,18,14,4
EGY,CHN,2021.0,40,42,-2
FRA,VNM,2017.0,56,12,44
ESP,MEX,2009.0,83,92,-9
TWN,CHN,2013.0,102,62,40
CHE,JPN,2017.0,42,35,7
ITA,NLD,2009.0,65,44,21
SGP,CHE,2013.0,13,19,-6
USA,ZWE,2021.0,2,3,-1
GBR,RWA,2016.0,4,1,3
IND,ETH,2016.0,49,8,41
AUS,JPN,2019.0,40,62,-22
ITA,CHL,2006.0,10,2,8
FIN,SWE,2003.0,36,48,-12
EGY,SAU,2004.0,33,18,15
BRA,PER,2017.0,28,13,15
CHN,CHE,2007.0,30,11,19
TWN,DEU,2009.0,14,12,2
ITA,TUR,2016.0,11,8,3
PAK,KOR,2018.0,36,85,-49
IRL,AUT,2016.0,5,3,2
IRL,ESP,2013.0,15,24,-9
ISR,AUT,2018.0,5,3,2
FRA,REU,2018.0,23,14,9
GBR,COL,2016.0,14,14,0
FIN,RUS,2003.0,23,18,5
ITA,TWN,2014.0,7,4,3
CAN,JPN,2022.0,35,20,15
IND,HUN,2020.0,10,7,3
CHN,SGP,2003.0,86,52,34
CHN,ISR,2007.0,5,9,-4
ISR,IND,2014.0,19,68,-49
LTU,CZE,2018.0,1,2,-1
IND,ARE,2022.0,28,21,7
SGP,GBR,2022.0,42,38,4
PAK,ITA,2015.0,8,21,-13
JPN,BEL,2006.0,15,10,5
MNG,TWN,2020.0,1,1,0
PER,BRA,2018.0,16,26,-10
ITA,FIN,2021.0,26,9,17
AUS,NLD,2009.0,34,50,-16
CHN,NLD,2022.0,76,90,-14
SRB,CAN,2020.0,4,1,3
GBR,PAK,2022.0,27,47,-20
BRA,PER,2019.0,49,13,36
POL,VNM,2016.0,4,2,2
JPN,MYS,2021.0,17,29,-12
JPN,IND,2003.0,39,58,-19
AUS,NPL,2022.0,5,8,-3
IND,CAN,2001.0,36,19,17
SAU,GBR,2021.0,47,129,-82
GRC,CYP,2006.0,9,4,5
COL,USA,2022.0,48,31,17
FRA,PRT,2021.0,23,22,1
FRA,BRA,2003.0,71,44,27
CHN,VNM,2020.0,30,8,22
ISR,CHN,2013.0,8,4,4
ZAF,SWZ,2020.0,4,5,-1
RUS,UKR,2020.0,39,45,-6
ESP,ECU,2021.0,43,36,7
PRT,POL,2015.0,8,6,2
GRC,SVN,2013.0,2,1,1
AUT,HUN,2011.0,11,13,-2
IDN,JPN,2022.0,34,34,0
JPN,POL,2012.0,40,5,35
USA,POL,2009.0,90,103,-13
PHL,FIN,2015.0,1,1,0
CHE,LTU,2012.0,2,1,1
ITA,BGR,2004.0,9,1,8
SWE,ITA,2020.0,39,57,-18
GBR,PRT,2021.0,58,66,-8
USA,EGY,2005.0,56,47,9
PRT,NOR,2018.0,9,5,4
USA,VEN,2002.0,18,34,-16
JPN,TUR,2011.0,10,10,0
ITA,BEL,2012.0,78,38,40
BGR,PRT,2016.0,1,1,0
JPN,BGR,2019.0,4,1,3
KOR,VNM,2016.0,60,20,40
DEU,KAZ,2016.0,6,3,3
TZA,GBR,2001.0,7,1,6
JOR,GBR,2015.0,11,30,-19
IRN,ESP,2012.0,8,4,4
USA,ISL,2018.0,16,10,6
DEU,IRN,2022.0,12,44,-32
JOR,SAU,2010.0,37,5,32
PER,ARG,2010.0,5,4,1
NLD,LVA,2010.0,1,1,0
BEL,DNK,2021.0,13,15,-2
GBR,JPN,1999.0,60,45,15
IND,RUS,2017.0,8,7,1
ROU,ESP,2006.0,6,2,4
NLD,RUS,2009.0,7,13,-6
SGP,USA,2001.0,63,51,12
VNM,FRA,2009.0,4,14,-10
IRN,SWE,2007.0,9,7,2
CHE,JPN,2019.0,35,32,3
CAN,NOR,2007.0,8,6,2
NZL,CHN,2015.0,19,12,7
BEL,CHN,2010.0,20,29,-9
JPN,PHL,2002.0,12,9,3
FIN,GBR,2006.0,21,29,-8
IND,JPN,2003.0,58,39,19
IRL,CAN,2013.0,43,25,18
GBR,SAU,2022.0,54,36,18
GRL,DNK,2021.0,5,3,2
ROU,CHN,2020.0,3,2,1
QAT,ARE,2017.0,8,12,-4
BEL,PRT,2006.0,2,4,-2
IND,FRA,2001.0,26,13,13
MYS,CAN,2021.0,19,7,12
NGA,AUS,2012.0,6,1,5
SGP,PAK,2018.0,5,1,4
CAN,ITA,2016.0,37,65,-28
DNK,FRA,2006.0,20,25,-5
CAN,TWN,2008.0,16,10,6
CRI,FRA,2004.0,3,2,1
ITA,IND,1998.0,4,6,-2
GBR,HUN,2013.0,25,31,-6
ARG,CHL,2002.0,9,4,5
PAN,CAN,2020.0,2,1,1
USA,LVA,2010.0,2,7,-5
NGA,GHA,2018.0,4,3,1
OMN,GBR,2006.0,6,9,-3
TWN,KOR,2009.0,11,10,1
USA,MDG,2015.0,7,4,3
KOR,DEU,2013.0,44,39,5
FRA,TUN,2001.0,32,26,6
JPN,IRL,2002.0,3,1,2
FRA,RUS,2012.0,30,51,-21
PRT,USA,2000.0,8,14,-6
IND,RUS,2019.0,18,9,9
IRN,POL,2020.0,20,1,19
CYP,GRC,2018.0,26,27,-1
USA,GRC,2022.0,30,39,-9
GBR,POL,2020.0,49,61,-12
ESP,PER,2018.0,29,16,13
ALB,DEU,2017.0,2,1,1
FRA,PAK,2012.0,23,8,15
PRT,GBR,2002.0,25,56,-31
HRV,AUT,2005.0,4,4,0
SWE,LVA,2018.0,3,3,0
KEN,CHE,2019.0,7,5,2
IDN,CHN,2017.0,2,2,0
IND,OMN,2022.0,7,4,3
NGA,IRN,2018.0,1,2,-1
IND,ITA,2015.0,47,42,5
CZE,NOR,2016.0,4,4,0
IND,SWE,2015.0,50,20,30
CAN,KOR,2021.0,22,42,-20
DEU,IRL,2003.0,16,7,9
POL,AUT,2008.0,10,5,5
GBR,CMR,2019.0,4,11,-7
USA,VNM,2016.0,29,20,9
RUS,CZE,2022.0,8,5,3
ZAF,PRT,2020.0,2,5,-3
JPN,THA,2003.0,37,28,9
POL,ITA,2021.0,21,19,2
MNG,DEU,2021.0,1,1,0
USA,BGD,2001.0,8,9,-1
RUS,BRA,2013.0,10,2,8
BEL,EGY,2018.0,8,4,4
AUT,TUR,2021.0,3,8,-5
MEX,DOM,2021.0,1,1,0
ZAF,CAN,2009.0,15,14,1
UGA,ETH,2019.0,2,2,0
IRL,ITA,2011.0,12,30,-18
CHN,FIN,2001.0,10,5,5
SEN,FRA,2004.0,23,25,-2
SAU,ITA,2021.0,15,13,2
ISL,SWE,2003.0,13,15,-2
GBR,MWI,2020.0,10,18,-8
BHR,SAU,2019.0,5,8,-3
JPN,KEN,2002.0,4,3,1
GEO,RUS,2006.0,6,4,2
SWE,TUR,2021.0,5,14,-9
USA,IDN,2007.0,17,10,7
BOL,MEX,2017.0,1,2,-1
EGY,USA,2004.0,43,61,-18
BEL,SVK,2006.0,4,6,-2
CZE,USA,2003.0,59,52,7
GBR,THA,2001.0,12,13,-1
FRA,NOR,2012.0,28,30,-2
CZE,DNK,2004.0,4,3,1
FIN,ARG,2015.0,1,1,0
NOR,ISL,2006.0,3,6,-3
RUS,JPN,2004.0,22,21,1
USA,RUS,2006.0,137,195,-58
CUB,BRA,2021.0,4,6,-2
AUT,ESP,2008.0,17,15,2
BRA,ESP,2003.0,24,28,-4
MAR,DZA,2014.0,5,3,2
THA,JPN,2001.0,16,18,-2
BEL,AUS,2000.0,3,2,1
JPN,PHL,2005.0,8,11,-3
GBR,CZE,2012.0,27,28,-1
USA,CZE,2004.0,42,39,3
UGA,NLD,2014.0,4,3,1
GBR,TUR,2000.0,33,14,19
SWE,ESP,2003.0,19,23,-4
ESP,GBR,1998.0,43,39,4
BRA,DNK,2002.0,2,1,1
KEN,USA,2008.0,22,35,-13
PHL,USA,2001.0,10,10,0
FIN,DEU,2001.0,14,17,-3
DEU,BGR,2008.0,13,18,-5
ISR,CAN,2003.0,46,25,21
RUS,ITA,2008.0,15,13,2
AUS,FRA,2006.0,34,45,-11
NOR,THA,2009.0,1,1,0
SVK,JPN,2001.0,3,1,2
GBR,NGA,2012.0,27,32,-5
USA,SVK,2011.0,7,10,-3
ESP,GBR,1997.0,20,29,-9
DNK,ESP,1999.0,3,5,-2
DEU,MEX,2010.0,25,15,10
NLD,IDN,2003.0,7,4,3
TWN,RUS,2007.0,1,3,-2
CAN,CMR,2008.0,3,3,0
CHE,FRA,2000.0,45,61,-16
KEN,NLD,2003.0,3,4,-1
TWN,IND,2007.0,16,48,-32
RUS,UZB,2004.0,5,6,-1
SVN,USA,2007.0,13,9,4
PAK,CAN,2000.0,3,1,2
NLD,IRL,2012.0,9,10,-1
ITA,ISR,2005.0,7,10,-3
CHE,ESP,2001.0,16,15,1
NLD,NZL,2008.0,8,10,-2
MOZ,CHE,2016.0,1,2,-1
USA,VEN,2005.0,27,28,-1
BRA,ITA,2001.0,13,12,1
CAN,TUR,2007.0,12,12,0
CHE,UKR,2002.0,1,5,-4
MEX,DEU,2005.0,16,23,-7
HUN,BEL,2004.0,5,5,0
AUS,MEX,2016.0,9,6,3
MDA,RUS,2004.0,3,1,2
JPN,NOR,2002.0,6,2,4
JPN,IRL,2005.0,6,3,3
ARG,CHL,2005.0,11,7,4
GBR,ZAF,2013.0,80,65,15
CZE,SWE,1999.0,3,3,0
GBR,BGR,2008.0,6,2,4
AUS,BRN,2019.0,3,1,2
ARG,MEX,2013.0,11,14,-3
JPN,MEX,1997.0,3,1,2
USA,MLI,2011.0,3,1,2
PER,USA,2001.0,15,3,12
PAK,JPN,2006.0,5,10,-5
PYF,FRA,2008.0,6,6,0
GBR,SGP,2001.0,32,24,8
PHL,GBR,2008.0,1,2,-1
JAM,USA,2005.0,3,1,2
ISR,IRL,2017.0,1,3,-2
IRL,ISR,2018.0,4,5,-1
NGA,ZAF,2004.0,8,1,7
IND,NGA,2012.0,6,6,0
KOR,NOR,2008.0,4,2,2
PAK,SAU,2009.0,16,12,4
SWE,KOR,2008.0,2,3,-1
NZL,NLD,2015.0,17,4,13
HUN,AUT,2022.0,4,7,-3
KOR,PAK,2009.0,8,7,1
NLD,THA,2003.0,3,3,0
EGY,OMN,2010.0,4,2,2
COG,FRA,2013.0,1,8,-7
ROU,NOR,2010.0,3,1,2
KOR,KWT,2019.0,1,1,0
CHE,EGY,2013.0,6,2,4
CHE,SVN,2010.0,2,4,-2
USA,SVN,2008.0,5,8,-3
FRA,SYR,2003.0,3,1,2
THA,CHN,2018.0,27,21,6
DEU,MEX,2017.0,24,31,-7
PAK,GBR,2007.0,22,28,-6
JPN,AUT,2011.0,6,12,-6
KOR,BRA,2015.0,5,2,3
ZAF,FRA,2016.0,21,23,-2
CAN,NGA,2007.0,2,3,-1
COL,MEX,2008.0,8,11,-3
CZE,FRA,2016.0,16,37,-21
ITA,UGA,2013.0,2,1,1
CYP,NLD,2015.0,1,2,-1
BRA,PER,2010.0,9,3,6
ARG,PER,2011.0,4,2,2
MEX,IRL,2015.0,1,2,-1
FIN,NOR,2016.0,19,9,10
NLD,ZAF,2008.0,20,12,8
NZL,TUR,2020.0,3,8,-5
NLD,ETH,2016.0,9,2,7
NOR,ROU,2015.0,2,1,1
MLI,BFA,2020.0,1,2,-1
COL,DEU,2016.0,25,17,8
IND,ZWE,2016.0,1,1,0
DNK,MEX,2015.0,5,3,2
ZAF,ZWE,2012.0,7,19,-12
IRN,KOR,2014.0,14,3,11
AUT,JPN,2021.0,11,8,3
PER,ARG,2019.0,6,3,3
IRN,CHN,2013.0,9,4,5
BWA,USA,2016.0,6,6,0
KNA,NZL,2013.0,1,1,0
FIN,ITA,2022.0,15,8,7
VEN,CHL,2019.0,18,3,15
BEL,THA,2006.0,3,2,1
TUR,NOR,2014.0,4,3,1
CMR,SEN,2018.0,1,2,-1
VNM,KHM,2017.0,1,1,0
ITA,ALB,2021.0,5,6,-1
MEX,POL,2020.0,2,2,0
IDN,BRN,2020.0,5,2,3
GBR,CMR,2017.0,5,3,2
IRL,HKG,2019.0,2,2,0
EGY,OMN,2019.0,2,3,-1
PER,GBR,2020.0,8,5,3
JOR,SAU,2019.0,20,37,-17
GHA,CAN,2022.0,5,1,4
IRL,HKG,2017.0,3,1,2
RUS,GHA,2020.0,3,2,1
THA,NLD,2020.0,4,13,-9
USA,TZA,2021.0,10,12,-2
UKR,CHN,2021.0,9,7,2
ISR,KOR,2021.0,7,4,3
IND,BTN,2021.0,3,2,1
RWA,BEL,2022.0,2,1,1
FRA,ZAF,2021.0,15,22,-7
SWE,CHE,2004.0,22,17,5
BEL,SRB,2006.0,5,2,3
BEL,POL,2007.0,5,5,0
DNK,FIN,2001.0,7,7,0
JPN,NOR,2005.0,2,1,1
KEN,CAN,2001.0,4,1,3
CHE,PRT,2012.0,8,11,-3
NOR,DNK,1997.0,2,1,1
NGA,TZA,2022.0,1,3,-2
IND,CHE,2000.0,3,2,1
GBR,GMB,2009.0,6,9,-3
AUS,SVN,2020.0,5,3,2
ARM,DEU,2005.0,6,3,3
NLD,AUT,2008.0,16,6,10
PAK,IRN,2018.0,2,4,-2
POL,CHE,2015.0,33,17,16
KEN,DEU,2020.0,11,11,0
USA,LVA,2017.0,2,6,-4
IRN,MEX,2022.0,3,1,2
IDN,CHN,2019.0,8,7,1
NLD,MYS,2016.0,8,7,1
GRC,SRB,2011.0,2,2,0
CHN,BEL,1998.0,2,2,0
GNB,DNK,2013.0,2,1,1
CHN,PRT,2002.0,8,2,6
CAN,QAT,2021.0,13,11,2
BEL,JPN,2013.0,12,18,-6
NOR,QAT,2016.0,3,1,2
TUR,AZE,2013.0,5,6,-1
IDN,THA,2017.0,3,8,-5
IRN,NGA,2018.0,2,1,1
GRC,QAT,2017.0,3,4,-1
FRA,EST,2020.0,4,2,2
EST,CAN,2020.0,2,1,1
AUS,ISR,2018.0,11,16,-5
DZA,TUN,2018.0,3,7,-4
SAU,BHR,2022.0,5,4,1
DZA,CHN,2018.0,1,3,-2
HRV,PRT,2019.0,3,1,2
ITA,IRQ,2017.0,3,1,2
CAN,ARG,2005.0,11,13,-2
IRN,BEL,2010.0,11,7,4
CHE,NLD,2000.0,10,14,-4
LTU,SWE,2007.0,8,6,2
DNK,VNM,2016.0,5,1,4
HKG,QAT,2020.0,2,1,1
PAK,NZL,2020.0,8,8,0
RUS,VNM,2021.0,9,6,3
CHN,GRC,2018.0,3,4,-1
FRA,DJI,2018.0,4,3,1
IRL,CZE,2016.0,1,1,0
SAU,NOR,2020.0,2,3,-1
COD,COG,2002.0,3,1,2
NOR,DNK,1998.0,4,3,1
KOR,FRA,2004.0,8,5,3
SAU,JOR,2004.0,4,2,2
DZA,FRA,2000.0,13,4,9
ECU,FRA,2005.0,3,1,2
POL,UKR,2014.0,13,15,-2
GBR,CHL,1998.0,5,1,4
ARG,VEN,1999.0,1,1,0
BRA,DNK,2005.0,1,3,-2
KWT,IND,2008.0,2,5,-3
HKG,DEU,2007.0,8,6,2
OMN,NOR,2017.0,1,2,-1
ZAF,MWI,2011.0,3,1,2
ITA,ECU,2016.0,5,2,3
ZAF,POL,2005.0,3,1,2
SWE,ISL,2008.0,11,2,9
ARG,GBR,2005.0,10,8,2
ITA,ISR,2002.0,11,21,-10
HRV,SVN,2018.0,8,13,-5
CHN,RUS,2000.0,1,5,-4
JPN,KEN,2005.0,5,4,1
QAT,ARE,2019.0,4,6,-2
SAU,IND,2009.0,6,29,-23
OMN,JOR,2015.0,2,2,0
CMR,CHE,2011.0,2,3,-1
IRL,NOR,2003.0,1,2,-1
ITA,JOR,2008.0,1,1,0
AUS,BRN,2010.0,4,2,2
BRA,CZE,2011.0,2,1,1
SGP,POL,2013.0,6,1,5
DEU,NPL,2013.0,6,2,4
SGP,ZAF,2016.0,5,1,4
CHE,KEN,2017.0,2,7,-5
NLD,KEN,2020.0,6,5,1
GHA,ZAF,2014.0,5,14,-9
CHN,MEX,2013.0,3,6,-3
UZB,RUS,1997.0,1,5,-4
FRA,COG,2015.0,5,4,1
PRT,CUB,2002.0,2,1,1
BEL,HUN,2020.0,4,4,0
AUS,KAZ,2021.0,2,1,1
NOR,IRL,2017.0,3,2,1
LTU,FRA,2021.0,3,1,2
DEU,EST,2022.0,3,3,0
FRA,VNM,2010.0,9,5,4
KOR,AUS,2004.0,5,13,-8
SVN,DEU,2019.0,9,15,-6
IND,PAK,2001.0,1,11,-10
MEX,GTM,2016.0,3,4,-1
IND,BRA,2008.0,7,5,2
ARM,USA,2011.0,6,5,1
MEX,DEU,2002.0,6,16,-10
ITA,BEN,2012.0,2,1,1
MEX,NLD,2002.0,6,5,1
ZAF,GRC,2014.0,1,2,-1
CAN,GRC,2012.0,3,7,-4
DNK,GRC,2018.0,4,8,-4
FIN,NGA,2017.0,2,1,1
PER,ARG,2017.0,1,9,-8
ETH,DEU,2005.0,3,3,0
CHE,SVN,2019.0,2,5,-3
IRL,NLD,1999.0,3,5,-2
URY,VEN,2020.0,2,2,0
UZB,RUS,1998.0,1,3,-2
ESP,JPN,2003.0,6,2,4
PSE,ISR,2015.0,9,9,0
DEU,MKD,2022.0,1,1,0
BEL,RUS,2019.0,9,11,-2
IRN,BEL,2017.0,14,7,7
JPN,GAB,2017.0,1,1,0
KEN,CHE,2017.0,7,2,5
ARG,DNK,2017.0,3,2,1
BEL,RUS,2017.0,5,3,2
NZL,BRA,2017.0,1,6,-5
ESP,PAN,2002.0,1,1,0
DNK,SGP,2020.0,5,9,-4
NZL,ESP,2022.0,2,2,0
BRN,PAK,2020.0,1,1,0
GHA,IND,2021.0,1,2,-1
KOR,NPL,2021.0,4,3,1
IRL,HKG,2010.0,1,3,-2
AUS,LAO,2020.0,1,2,-1
CUB,COL,2004.0,1,1,0
ROU,CHE,2014.0,4,5,-1
PAK,HKG,2014.0,1,1,0
RUS,AUT,2011.0,11,3,8
ESP,NOR,2007.0,3,8,-5
AUT,EGY,2009.0,3,2,1
CYP,CHE,2008.0,1,1,0
AUS,KWT,2013.0,3,2,1
TZA,NLD,2016.0,2,3,-1
BRA,NOR,2004.0,1,2,-1
HUN,AUS,2004.0,4,1,3
IND,SAU,1998.0,1,1,0
ITA,ARG,2003.0,7,21,-14
CAN,ARG,2002.0,9,16,-7
IDN,THA,2010.0,2,3,-1
MYS,NZL,2003.0,1,1,0
CZE,BEL,2001.0,4,1,3
CHE,BGR,2008.0,4,2,2
QAT,GBR,2011.0,5,6,-1
ITA,IND,1997.0,6,3,3
DNK,IND,2007.0,2,4,-2
USA,LTU,2001.0,3,5,-2
DNK,JPN,2008.0,8,10,-2
GHA,SWE,2007.0,2,1,1
AUS,TWN,2004.0,5,3,2
JPN,NLD,2000.0,4,8,-4
AUS,PNG,2012.0,5,9,-4
SWE,TWN,2009.0,1,1,0
HUN,KWT,2001.0,3,1,2
URY,FRA,2006.0,3,2,1
SWE,IND,2006.0,7,15,-8
CHL,NZL,2012.0,3,3,0
GEO,FRA,2011.0,4,1,3
USA,TUN,2013.0,2,4,-2
TTO,GHA,2008.0,1,1,0
PRT,CHL,2018.0,3,6,-3
UGA,AUS,2013.0,1,1,0
GRC,AUT,2016.0,3,3,0
DZA,KOR,2021.0,2,1,1
TTO,USA,2018.0,5,6,-1
POL,AUS,2021.0,8,6,2
PRY,ESP,2011.0,1,5,-4
BEL,LBN,2020.0,9,7,2
JPN,ARG,2009.0,2,1,1
NZL,CHE,2007.0,7,9,-2
IND,LBY,2017.0,1,2,-1
ISR,PSE,2013.0,7,12,-5
BEL,NGA,2011.0,1,2,-1
CHL,PRT,2015.0,3,3,0
FRA,PSE,2022.0,1,2,-1
CHN,TZA,2015.0,2,2,0
BEN,BRA,2017.0,1,1,0
POL,ISR,2018.0,4,2,2
ARE,DEU,2021.0,4,13,-9
BRA,PAK,2021.0,3,5,-2
ROU,FIN,2016.0,1,2,-1
MYS,PHL,2011.0,2,2,0
QAT,IRL,2022.0,2,2,0
CAN,BFA,2014.0,2,2,0
RUS,KAZ,1999.0,4,9,-5
BRA,RUS,2008.0,2,4,-2
SRB,ITA,2004.0,3,4,-1
SVN,ITA,1999.0,2,1,1
USA,KGZ,2002.0,1,1,0
HRV,PRT,2010.0,2,1,1
SVN,HRV,2008.0,2,5,-3
USA,DOM,2012.0,4,1,3
IDN,PER,2015.0,2,1,1
SVN,PRT,2011.0,2,1,1
MWI,BEL,2008.0,1,1,0
AUT,BGR,2003.0,1,5,-4
CHE,KEN,2019.0,5,7,-2
USA,LVA,2019.0,4,2,2
ZAF,PAK,2021.0,5,2,3
SAU,YEM,2018.0,5,8,-3
ARE,CHL,2018.0,1,1,0
BOL,FRA,2015.0,4,1,3
TUR,MLT,2018.0,1,1,0
CUB,FRA,2017.0,7,2,5
NOR,IRL,2019.0,4,7,-3
KGZ,USA,2001.0,1,1,0
ZAF,BWA,2014.0,4,10,-6
CAN,UKR,2004.0,1,8,-7
IRL,HUN,2012.0,3,4,-1
GBR,KHM,2014.0,2,4,-2
AUS,VNM,2001.0,2,2,0
DNK,CHL,2020.0,1,7,-6
IRN,CHE,2006.0,5,2,3
FRA,BOL,2019.0,2,1,1
TZA,NGA,2022.0,3,1,2
CRI,USA,2000.0,2,2,0
FRA,LAO,2018.0,3,3,0
MDA,ROU,2012.0,3,1,2
MLI,COG,2015.0,1,1,0
GBR,ARE,2003.0,4,5,-1
GBR,SVK,2008.0,2,5,-3
BFA,CIV,2007.0,2,3,-1
GRC,NLD,2013.0,19,9,10
JPN,BGR,2010.0,1,2,-1
VEN,CHL,2010.0,3,1,2
BRA,CUB,2000.0,3,4,-1
ARE,TUR,2016.0,4,3,1
HUN,NLD,2001.0,5,1,4
ISR,BRA,2008.0,1,2,-1
KOR,PRT,2020.0,2,4,-2
ZAF,KOR,2015.0,1,3,-2
SVK,CHE,2013.0,4,1,3
LUX,GBR,2012.0,1,11,-10
CHL,PAK,2016.0,1,1,0
SWE,UKR,2003.0,1,3,-2
TUN,NLD,2022.0,2,2,0
KWT,SAU,2019.0,2,9,-7
KEN,PAK,2008.0,1,1,0
DEU,TUN,2016.0,3,3,0
CHE,THA,2009.0,3,4,-1
CHL,JPN,2016.0,6,5,1
NZL,FJI,2015.0,2,2,0
CAN,CZE,2006.0,3,9,-6
LBY,MYS,2013.0,5,5,0
COG,BEL,2005.0,2,2,0
NLD,TUR,2006.0,2,3,-1
NGA,CAN,2008.0,4,3,1
TZA,DNK,1998.0,1,1,0
ISR,DNK,2006.0,2,2,0
FRA,EGY,2001.0,1,1,0
CHN,HUN,2016.0,2,6,-4
KOR,ESP,2003.0,1,1,0
LIE,CHE,2016.0,3,1,2
GRC,CHE,1997.0,1,2,-1
DNK,NZL,2018.0,4,4,0
GBR,UGA,1999.0,1,3,-2
NLD,PAK,2011.0,3,6,-3
HKG,SWE,2011.0,1,2,-1
NCL,AUS,2007.0,1,1,0
NGA,FRA,2009.0,1,2,-1
CAN,HRV,2016.0,2,3,-1
ESP,HRV,2013.0,3,5,-2
FIN,SVK,2019.0,2,1,1
MEX,URY,2021.0,4,1,3
IRQ,JOR,2016.0,2,4,-2
COD,BEL,2017.0,2,7,-5
KOR,ITA,2007.0,3,3,0
IRL,ZAF,2001.0,2,2,0
ETH,DEU,2002.0,1,3,-2
RUS,HRV,2017.0,1,1,0
TUR,HUN,2009.0,1,4,-3
ZAF,IRN,2012.0,1,4,-3
HKG,POL,2014.0,1,1,0
KAZ,IRN,2022.0,1,3,-2
FRA,PYF,2001.0,1,3,-2
NZL,ITA,2021.0,3,10,-7
PRT,JPN,2012.0,2,7,-5
FIN,ETH,2010.0,1,1,0
JPN,MDA,2004.0,1,1,0
VEN,MEX,2004.0,3,6,-3
BEL,MEX,2009.0,6,5,1
NOR,EST,2014.0,1,1,0
MYS,BEL,2008.0,1,2,-1
BHR,IND,2014.0,1,1,0
ZAF,CHN,2005.0,3,4,-1
CHN,PRT,2005.0,4,1,3
MEX,KOR,2011.0,1,1,0
EGY,NZL,2011.0,1,1,0
CHE,KAZ,2017.0,1,1,0
NOR,CHN,2008.0,5,8,-3
UKR,SGP,2014.0,1,1,0
JPN,BGR,2017.0,2,5,-3
AUS,NAM,2011.0,1,3,-2
CAF,FRA,2011.0,3,3,0
NZL,POL,2008.0,2,1,1
BIH,SRB,2022.0,3,2,1
MWI,ZAF,2020.0,3,8,-5
CHN,OMN,2018.0,1,3,-2
ARE,BHR,2018.0,2,4,-2
LTU,UKR,2018.0,2,1,1
OMN,KOR,2017.0,1,4,-3
ARE,PAK,2014.0,5,9,-4
SYR,BEL,2010.0,2,1,1
CMR,KEN,2003.0,1,1,0
NZL,IRN,2013.0,1,10,-9
BGD,ITA,2022.0,2,3,-1
EST,JPN,2017.0,1,1,0
IRN,SGP,2020.0,4,6,-2
SGP,PRT,2020.0,3,1,2
BOL,SWE,2013.0,2,2,0
FRA,BOL,2017.0,1,2,-1
LAO,THA,2015.0,1,2,-1
AUS,EST,2015.0,1,2,-1
JPN,MEX,1998.0,1,2,-1
KAZ,RUS,2008.0,3,11,-8
ROU,AUS,2015.0,2,2,0
SAU,TUR,2016.0,1,5,-4
ARM,RUS,2007.0,1,2,-1
DEU,PSE,2009.0,3,2,1
GRC,PRT,2014.0,3,1,2
EGY,PSE,2009.0,1,2,-1
MEX,KEN,2016.0,1,2,-1
NLD,ARG,2013.0,4,4,0
CAN,PYF,2017.0,1,1,0
BOL,USA,2006.0,1,2,-1
PSE,GBR,2013.0,3,4,-1
CUB,QAT,2016.0,1,3,-2
USA,BLZ,2020.0,1,3,-2
SAU,THA,2018.0,2,1,1
CHL,DOM,2019.0,2,1,1
TUN,DZA,2016.0,2,6,-4
MEX,PRI,2009.0,1,2,-1
ARE,GBR,1998.0,1,1,0
ITA,CUB,2014.0,1,2,-1
TWN,UKR,2015.0,1,1,0
MEX,AUS,2003.0,2,4,-2
SVN,AUT,2009.0,1,2,-1
MAC,USA,2012.0,1,10,-9
SEN,BEL,2002.0,1,1,0
OMN,AUS,2003.0,3,1,2
NLD,TZA,2002.0,1,1,0
SAU,SYR,2015.0,1,3,-2
EST,ITA,2014.0,1,5,-4
ARG,CHE,1999.0,1,1,0
MKD,HRV,2006.0,1,1,0
MAR,SAU,2013.0,1,1,0
KWT,SAU,2010.0,3,5,-2
HRV,GBR,2001.0,1,1,0
EGY,BGD,2002.0,1,1,0
DEU,SEN,2014.0,1,1,0
NER,BEL,2013.0,1,1,0
DOM,CHL,2019.0,1,2,-1
HRV,SVK,2019.0,2,1,1
PER,DEU,2003.0,1,2,-1
IND,RUS,2010.0,1,4,-3
AUT,ZAF,2003.0,1,1,0
ETH,ITA,2016.0,1,1,0
NPL,PAK,2014.0,2,1,1
AUT,IRL,2022.0,2,1,1
ARM,CHE,2020.0,1,1,0
BGR,NLD,2001.0,2,1,1
NLD,TZA,2005.0,1,1,0
CYP,NOR,2011.0,1,1,0
ECU,CAN,2011.0,1,2,-1
CHL,GBR,2003.0,1,14,-13
GRC,BRA,2011.0,1,1,0
MLT,NLD,2017.0,1,1,0
BEL,MAR,2001.0,1,1,0
BHR,SAU,2017.0,2,4,-2
BHR,MYS,2021.0,1,3,-2
SWE,LTU,1997.0,1,1,0
KOR,QAT,2009.0,1,1,0
KOR,CZE,2001.0,1,1,0
AFG,IND,2014.0,1,1,0
SVN,TUR,2000.0,1,1,0
EGY,JOR,2018.0,1,2,-1
COG,USA,2018.0,4,6,-2
CYP,DNK,2022.0,1,1,0
DNK,HUN,2001.0,1,5,-4
FIN,NGA,2019.0,1,1,0
ZWE,BEL,2011.0,1,1,0
SEN,AUS,2012.0,1,1,0
UKR,PRT,2004.0,1,1,0
UKR,CZE,2000.0,2,1,1
FRA,SVK,1999.0,3,2,1
DNK,UKR,2003.0,1,1,0
BEL,FIN,2013.0,1,5,-4
KOR,IRQ,2020.0,1,1,0
ZAF,ZMB,2015.0,3,3,0
FRA,MTQ,1999.0,2,6,-4
ZAF,DNK,2004.0,2,2,0
RUS,BGR,2012.0,1,1,0
BGR,RUS,2008.0,1,5,-4
MAR,GBR,2009.0,1,1,0
NGA,DEU,2013.0,1,2,-1
CAN,MYS,1999.0,1,1,0
MEX,ISR,2020.0,4,3,1
GBR,LAO,2012.0,2,1,1
CHN,EST,2015.0,1,1,0
ISL,CHE,2013.0,1,2,-1
BLR,USA,2020.0,1,1,0
KHM,SGP,2015.0,1,1,0
ISR,POL,2020.0,2,7,-5
OMN,IRL,2019.0,2,1,1
USA,BTN,2018.0,1,1,0
CHE,GIN,2016.0,1,1,0
FIN,SAU,2019.0,1,3,-2
USA,COG,2004.0,1,1,0
MYS,KAZ,2013.0,1,1,0
AUS,BRN,2017.0,1,3,-2
NLD,LVA,2017.0,1,1,0
BRB,USA,2001.0,1,1,0
GBR,KEN,1998.0,1,1,0
KOR,RUS,2022.0,1,3,-2
IRL,BGD,2012.0,1,2,-1
ZAF,IND,2003.0,2,5,-3
BRA,BGR,2009.0,1,1,0
SVN,GRC,2019.0,1,1,0
BWA,ZWE,2009.0,1,1,0
URY,ARG,2012.0,1,7,-6
COL,CUB,2011.0,2,1,1
SVK,ITA,2014.0,1,2,-1
TWN,BGD,2010.0,1,1,0
PAK,KGZ,2014.0,1,1,0
NOR,HRV,2019.0,1,1,0
USA,ATG,2019.0,1,3,-2
BGR,ITA,2018.0,1,5,-4
USA,GMB,2013.0,2,3,-1
LAO,FRA,2006.0,1,3,-2
ZAF,POL,2002.0,1,1,0
DZA,ESP,2013.0,1,2,-1
TWN,BGD,2019.0,1,2,-1
EST,USA,1999.0,1,2,-1
GEO,EST,2020.0,1,1,0
FRO,NOR,2017.0,1,1,0
USA,CIV,2004.0,1,3,-2
FRA,BOL,2010.0,1,1,0
SWE,MYS,2009.0,1,2,-1
NOR,IRL,2010.0,1,1,0
CZE,CHE,2011.0,13,6,7
BEL,IRN,2012.0,10,13,-3
DEU,FRA,2015.0,324,381,-57
DZA,SAU,2019.0,14,3,11
USA,EGY,2002.0,38,39,-1
PRT,ITA,2008.0,7,14,-7
FRA,POL,2011.0,105,23,82
AUS,DEU,2002.0,65,89,-24
ITA,ESP,2008.0,128,67,61
DEU,ROU,2018.0,26,10,16
ITA,ARM,2018.0,1,2,-1
PHL,DEU,2013.0,5,4,1
KOR,CHN,2018.0,210,113,97
COL,PRT,2022.0,3,1,2
USA,AUS,2003.0,394,467,-73
MAC,CHN,2021.0,147,108,39
VEN,CHL,2017.0,15,2,13
PRT,FRA,2016.0,50,38,12
CAN,IRL,2020.0,42,38,4
BRA,AUS,2018.0,72,29,43
SWE,DEU,2015.0,112,180,-68
JOR,AUS,2018.0,4,10,-6
FIN,ETH,2017.0,2,2,0
ITA,CZE,2021.0,16,18,-2
FRA,DNK,2020.0,49,40,9
ARG,FRA,2021.0,16,15,1
AUS,COL,2015.0,4,11,-7
MAR,TUN,2008.0,3,3,0
SAU,AUS,2021.0,17,41,-24
CUB,ESP,2012.0,37,13,24
ESP,FRA,2004.0,97,118,-21
KOR,GBR,2022.0,38,30,8
IRN,GBR,2007.0,22,70,-48
GBR,IDN,2022.0,18,5,13
IRN,FRA,2011.0,14,21,-7
IRN,JPN,2015.0,11,11,0
IRL,SWE,2014.0,23,10,13
UGA,JPN,2002.0,1,1,0
CAN,SGP,2018.0,35,23,12
CAN,IDN,2020.0,8,2,6
USA,AUT,2001.0,72,98,-26
BRA,JPN,2018.0,11,16,-5
MEX,SWE,2020.0,9,7,2
CHL,ESP,1997.0,4,5,-1
THA,GBR,1997.0,3,2,1
USA,RWA,2004.0,1,1,0
MYS,JOR,2013.0,15,6,9
MAR,FRA,2001.0,40,54,-14
AND,ESP,2011.0,7,1,6
CAN,ETH,2012.0,2,1,1
AUT,SVK,2001.0,5,8,-3
DNK,BRA,2003.0,3,3,0
POL,BLR,2016.0,4,4,0
NLD,IND,2003.0,10,8,2
CHL,ARG,2000.0,4,1,3
ARG,GBR,2002.0,12,12,0
USA,ARE,2006.0,26,8,18
NZL,KOR,2009.0,6,2,4
LUX,CAN,2021.0,2,3,-1
GBR,SVN,2004.0,5,2,3
SVN,BEL,2016.0,5,3,2
GBR,RUS,2014.0,40,35,5
BEL,AUT,2017.0,12,9,3
MYS,THA,2016.0,10,4,6
ITA,KEN,2011.0,2,2,0
JPN,MAC,2020.0,1,1,0
NLD,IRN,2009.0,15,20,-5
SAU,IRL,2018.0,3,6,-3
TUN,USA,2022.0,4,1,3
SWE,BGD,2018.0,4,6,-2
ZWE,CHE,2019.0,3,2,1
FIN,AUT,2014.0,12,4,8
NCL,FRA,2011.0,22,14,8
SVN,DEU,2017.0,10,8,2
POL,CHN,2016.0,12,3,9
DZA,SAU,2017.0,2,4,-2
RUS,HRV,2019.0,2,1,1
JPN,LTU,2011.0,2,1,1
THA,BGD,2001.0,3,1,2
PAK,IND,2006.0,8,9,-1
ZAF,NOR,2022.0,2,2,0
SWE,SRB,2004.0,1,5,-4
NPL,DEU,2018.0,2,4,-2
IDN,THA,2019.0,5,17,-12
JAM,USA,2002.0,4,8,-4
FIN,TWN,2016.0,2,7,-5
BRA,POL,2021.0,6,2,4
POL,BEL,2004.0,6,7,-1
BRA,SWE,2008.0,11,7,4
FRA,PER,2008.0,7,8,-1
UKR,NLD,2007.0,6,1,5
DZA,DEU,2013.0,1,1,0
DEU,SVK,2004.0,10,17,-7
ESP,SVN,2013.0,4,1,3
FIN,ETH,2019.0,2,1,1
FRA,VEN,2021.0,2,2,0
CZE,ZAF,2008.0,1,2,-1
AUS,SAU,2004.0,5,4,1
EGY,IRQ,2011.0,1,1,0
FRA,DZA,1999.0,13,6,7
PHL,NLD,2018.0,1,3,-2
JPN,NPL,2013.0,5,3,2
SRB,DEU,2022.0,3,2,1
GBR,VNM,2001.0,3,5,-2
NZL,BRA,2010.0,4,4,0
DNK,THA,2021.0,2,3,-1
DNK,PHL,2019.0,1,2,-1
CHL,ESP,1998.0,1,7,-6
MEX,BEL,2004.0,3,2,1
EGY,TUN,2010.0,1,1,0
CHE,CHL,2022.0,2,1,1
THA,SWE,2015.0,5,9,-4
YEM,EGY,2021.0,3,3,0
KWT,SAU,2017.0,2,7,-5
PER,BEL,2011.0,1,2,-1
ESP,QAT,2021.0,3,1,2
GRC,RUS,2008.0,3,1,2
MAC,AUS,2016.0,1,1,0
EST,DEU,2001.0,2,2,0
JOR,ARE,2001.0,3,2,1
FIN,HUN,2016.0,2,5,-3
BEL,COL,2020.0,2,6,-4
CZE,BRA,2015.0,3,6,-3
MOZ,ZAF,2018.0,1,1,0
SDN,MYS,2008.0,1,3,-2
USA,SEN,2003.0,1,1,0
USA,OMN,2003.0,6,6,0
DNK,BEL,2007.0,2,3,-1
KWT,SGP,1999.0,1,1,0
ROU,HUN,2001.0,4,3,1
NLD,ARE,2011.0,3,2,1
CAN,TTO,2014.0,3,1,2
FIN,SVK,2017.0,2,2,0
MEX,NLD,2005.0,4,3,1
CAN,BEN,2019.0,1,1,0
EGY,LBY,2018.0,2,3,-1
FIN,CZE,2013.0,2,2,0
SVN,GRC,2017.0,2,2,0
BEL,ECU,2012.0,1,2,-1
USA,QAT,2003.0,7,2,5
DNK,GNB,2012.0,1,4,-3
MYS,AFG,2022.0,2,2,0
KOR,EGY,2006.0,2,3,-1
RWA,SAU,2017.0,1,1,0
NOR,JPN,2008.0,1,5,-4
SAU,SWE,2012.0,3,4,-1
NPL,MYS,2012.0,1,1,0
OMN,SAU,2009.0,1,4,-3
ALB,DEU,2010.0,1,2,-1
ITA,MEX,2022.0,1,10,-9
ECU,FRA,2002.0,1,3,-2
NLD,BRA,1999.0,1,3,-2
ITA,NOR,2004.0,4,5,-1
ZMB,JPN,2022.0,1,2,-1
HRV,AUT,2002.0,1,5,-4
CHE,UKR,2005.0,1,2,-1
KWT,LBN,2013.0,1,1,0
CHN,NOR,2001.0,1,2,-1
MEX,CRI,2021.0,2,3,-1
JOR,PSE,2011.0,1,1,0
NOR,SGP,1999.0,1,1,0
BEL,TWN,2012.0,3,2,1
AUS,CZE,2013.0,1,6,-5
CRI,NLD,2015.0,1,1,0
MUS,GBR,2018.0,1,3,-2
BTN,AUS,2013.0,1,1,0
LKA,ITA,2019.0,1,1,0
DNK,BGD,2012.0,1,2,-1
SEN,MAR,2014.0,1,1,0
FRA,GHA,2012.0,1,2,-1
CHN,BEL,1997.0,1,2,-1
,ITA,2004.0,13354,0,13354
USA,,2008.0,42642,0,42642
,DEU,2004.0,19639,0,19639
GBR,,2014.0,12859,0,12859
BRA,,2020.0,20739,0,20739
,KEN,2004.0,273,0,273
,GBR,1997.0,8211,0,8211
,KOR,1999.0,10047,0,10047
MAR,,2024.0,8172,0,8172
RUS,,2014.0,4594,0,4594
,ISR,2000.0,3090,0,3090
THA,,2015.0,1015,0,1015
POL,,2014.0,2700,0,2700
,HKG,2000.0,1530,0,1530
NLD,,2023.0,23786,0,23786
,GBR,1998.0,36451,0,36451
,IRN,2006.0,7237,0,7237
DEU,,2018.0,21046,0,21046
,ITA,1996.0,7495,0,7495
,DEU,1996.0,12122,0,12122
,PRT,1994.0,904,0,904
DZA,,2023.0,5300,0,5300
,JPN,2008.0,22518,0,22518
EST,,2009.0,90,0,90
,ROU,2002.0,1007,0,1007
,TWN,2008.0,7371,0,7371
HRV,,2003.0,99,0,99
SGP,,2022.0,3445,0,3445
,CRI,2003.0,86,0,86
,FIN,2012.0,2182,0,2182
SRB,IRL,2018.0,2,0,2
,MWI,2003.0,47,0,47
LTU,,2022.0,1065,0,1065
,PHL,1999.0,221,0,221
NZL,,2016.0,983,0,983
,ROU,2005.0,1470,0,1470
,GHA,2006.0,200,0,200
,ARG,2009.0,2605,0,2605
SVN,,2009.0,188,0,188
COG,,2013.0,33,0,33
HUN,,2001.0,89,0,89
NPL,,2023.0,1452,0,1452
ARG,,2007.0,565,0,565
,TUR,2014.0,7584,0,7584
IRQ,,2022.0,3555,0,3555
,BGD,2000.0,318,0,318
UKR,,2015.0,846,0,846
BLR,,2016.0,203,0,203
BGD,,2012.0,198,0,198
MYS,,2013.0,791,0,791
ECU,,2017.0,83,0,83
ECU,,2010.0,25,0,25
MLT,,2022.0,196,0,196
,CZE,2015.0,2505,0,2505
BRN,,2023.0,164,0,164
,PER,2011.0,343,0,343
DOM,,2017.0,10,0,10
UGA,,2016.0,118,0,118
,PRI,2011.0,126,0,126
,URY,2008.0,206,0,206
,ARE,2011.0,277,0,277
,LVA,2007.0,238,0,238
,SAU,2018.0,3411,0,3411
LUX,,2021.0,219,0,219
ECU,,2019.0,206,0,206
IND,BHR,2018.0,7,0,7
,VEN,2014.0,231,0,231
BEL,,2003.0,501,0,501
,KNA,2012.0,7,0,7
,ISL,2000.0,187,0,187
,KWT,2014.0,169,0,169
,BWA,2013.0,46,0,46
KNA,,2021.0,13,0,13
,PRK,2014.0,35,0,35
,MOZ,2014.0,71,0,71
JOR,,2009.0,83,0,83
JAM,,2014.0,51,0,51
,SDN,2014.0,126,0,126
UZB,SVN,2013.0,1,0,1
,GMB,2014.0,51,0,51
KGZ,,2022.0,82,0,82
,PRY,2015.0,51,0,51
,MNE,2015.0,64,0,64
DOM,,2019.0,19,0,19
FRO,,2024.0,75,0,75
NGA,CYP,2015.0,1,0,1
KEN,,2009.0,78,0,78
,VNM,1999.0,131,0,131
,PSE,2016.0,128,0,128
,BLR,2018.0,227,0,227
,KEN,1996.0,56,0,56
,KHM,2018.0,43,0,43
MAR,IND,2018.0,1,0,1
,BTN,2014.0,36,0,36
GMB,,2019.0,19,0,19
CHN,CRI,2020.0,1,0,1
AGO,,2024.0,46,0,46
VNM,KHM,2019.0,1,0,1
ITA,KAZ,2013.0,4,0,4
,ECU,2003.0,56,0,56
NZL,KEN,2016.0,1,0,1
,BHR,2005.0,37,0,37
BHR,,2011.0,27,0,27
THA,HKG,2000.0,1,0,1
JPN,DZA,2015.0,3,0,3
,BHR,2002.0,36,0,36
AUT,SAU,2012.0,5,0,5
,CYP,2001.0,57,0,57
VEN,ARG,2012.0,3,0,3
GHA,KEN,2017.0,5,0,5
CHE,GHA,2014.0,2,0,2
DEU,MAR,2016.0,4,0,4
MOZ,BEL,2021.0,2,0,2
KOR,KWT,2017.0,1,0,1
HUN,PHL,2019.0,2,0,2
CYP,,2004.0,5,0,5
,MUS,2016.0,33,0,33
SDN,IRL,2020.0,1,0,1
FJI,,2011.0,6,0,6
ISL,THA,2018.0,2,0,2
COG,JPN,2015.0,1,0,1
,MDA,1997.0,30,0,30
,TCD,2001.0,8,0,8
ARE,,2008.0,76,0,76
POL,DZA,2007.0,1,0,1
,LAO,2002.0,12,0,12
COL,PRI,2003.0,1,0,1
,GAB,2002.0,16,0,16
,ZMB,2000.0,24,0,24
SAU,,2001.0,19,0,19
TZA,ZAF,2007.0,3,0,3
GRC,YEM,2016.0,1,0,1
TON,NZL,2008.0,1,0,1
KEN,SWE,2000.0,1,0,1
,YEM,1999.0,27,0,27
,MDA,1998.0,86,0,86
JPN,OMN,2002.0,1,0,1
FRA,IRN,2001.0,4,0,4
SAU,NLD,2004.0,1,0,1
BOL,,2015.0,32,0,32
KEN,MWI,2005.0,1,0,1
FRA,OMN,2003.0,3,0,3
BGD,MLI,2016.0,1,0,1
REU,,2014.0,6,0,6
SWE,LAO,2007.0,1,0,1
AZE,,2003.0,12,0,12
ZWE,,2000.0,1,0,1
EST,LTU,2005.0,2,0,2
KEN,NER,2013.0,1,0,1
TTO,,2005.0,11,0,11
FIN,,1999.0,28,0,28
ZAF,MKD,2010.0,1,0,1
USA,LUX,2001.0,1,0,1
PRI,RUS,1998.0,1,0,1
TUR,NZL,2011.0,1,0,1
ARM,DEU,2002.0,2,0,2
TWN,POL,2003.0,2,0,2
JOR,EGY,2001.0,1,0,1
PER,GHA,2014.0,1,0,1
MOZ,,2015.0,17,0,17
BGD,THA,2007.0,2,0,2
SEN,SWE,2020.0,1,0,1
SWE,SEN,2021.0,3,0,3
GBR,CRI,2014.0,1,0,1
EGY,FIN,2007.0,1,0,1
SRB,NLD,2007.0,1,0,1
BRB,,2017.0,9,0,9
PNG,AUS,2006.0,3,0,3
SGP,ARE,2011.0,4,0,4
GBR,GEO,2016.0,2,0,2
PRI,DEU,2012.0,1,0,1
BRA,KOR,2022.0,3,0,3
OMN,PRT,2018.0,1,0,1
UKR,AUS,2018.0,3,0,3
GMB,,2017.0,8,0,8
NZL,NPL,2022.0,1,0,1
LSO,ZAF,2015.0,3,0,3
BIH,KWT,2015.0,1,0,1
CPV,,2019.0,8,0,8
BEL,PHL,2016.0,2,0,2
OMN,IRL,2017.0,1,0,1
PRT,FIN,2022.0,3,0,3
MYS,SWE,2011.0,4,0,4
ARM,GBR,2014.0,1,0,1
CMR,PHL,2019.0,1,0,1
ARE,ISR,2021.0,1,0,1
,NCL,2016.0,17,0,17
ROU,NOR,2019.0,3,0,3
AUS,GUY,2018.0,1,0,1
NOR,KEN,2022.0,2,0,2
LBN,CYP,2018.0,1,0,1
BEL,DOM,2021.0,1,0,1
KAZ,OMN,2014.0,1,0,1
KWT,,2000.0,18,0,18
YEM,ARE,2000.0,1,0,1
TUR,LTU,2014.0,1,0,1
,LAO,2005.0,21,0,21
BRB,,2010.0,9,0,9
CPV,,2017.0,7,0,7
,LBR,2015.0,12,0,12
CZE,ROU,2006.0,2,0,2
IDN,KOR,2008.0,2,0,2
NZL,PER,2010.0,1,0,1
PER,CUB,2021.0,1,0,1
PRT,BGR,2014.0,2,0,2
SVN,HKG,2016.0,1,0,1
SLE,BEL,2011.0,1,0,1
SRB,NOR,2008.0,2,0,2
MMR,ISR,2020.0,1,0,1
MEX,QAT,2020.0,1,0,1
LKA,ITA,2017.0,1,0,1
GMB,,2010.0,7,0,7
LIE,USA,2009.0,2,0,2
BGD,RUS,2000.0,2,0,2
BGR,POL,2018.0,2,0,2
COL,CZE,2021.0,2,0,2
BGR,CHN,2004.0,2,0,2
MEX,NOR,2021.0,4,0,4
,GIB,2018.0,3,0,3
SWE,LIE,2016.0,1,0,1
MKD,,2005.0,8,0,8
DNK,PHL,2010.0,1,0,1
BHR,JOR,2011.0,1,0,1
GHA,MYS,2004.0,1,0,1
BDI,UGA,2019.0,2,0,2
DEU,MNG,2007.0,2,0,2
CHE,LKA,2012.0,1,0,1
ITA,IRQ,2019.0,2,0,2
IND,FIN,2003.0,2,0,2
,BRB,2001.0,5,0,5
IND,HKG,1997.0,2,0,2
GMB,DEU,1999.0,2,0,2
JPN,PRT,1999.0,1,0,1
MLI,PHL,2010.0,1,0,1
NZL,AZE,2019.0,1,0,1
,GNQ,2003.0,3,0,3
FIN,SVK,2010.0,1,0,1
CHN,QAT,2014.0,2,0,2
IND,TTO,2018.0,1,0,1
PRI,CHN,2007.0,1,0,1
FJI,SLB,2010.0,1,0,1
CHL,NOR,2007.0,2,0,2
ESP,UKR,2014.0,2,0,2
IDN,BRA,2014.0,2,0,2
CUB,FRA,2010.0,1,0,1
ARE,CMR,2020.0,1,0,1
CHN,YEM,2015.0,2,0,2
JPN,PNG,2013.0,1,0,1
MRT,,2014.0,2,0,2
,MTQ,2013.0,4,0,4
SYR,ARE,2016.0,1,0,1
BFA,TGO,2020.0,2,0,2
HUN,FIN,2020.0,2,0,2
TZA,SEN,2016.0,1,0,1
MYS,CZE,2020.0,6,0,6
SLV,GTM,2012.0,1,0,1
CHN,PAK,2023.0,3,0,3
BEN,,2000.0,1,0,1
SVK,ISR,2000.0,1,0,1
,GAB,2005.0,10,0,10
GAB,NLD,2015.0,3,0,3
KWT,MYS,2011.0,2,0,2
,NER,1995.0,10,0,10
SUR,,2022.0,19,0,19
CHE,SDN,2022.0,1,0,1
DNK,SRB,2010.0,1,0,1
MEX,SGP,2012.0,1,0,1
NGA,YEM,2017.0,1,0,1
NZL,LUX,2011.0,2,0,2
EST,ESP,2012.0,1,0,1
ITA,EST,2011.0,3,0,3
RUS,DNK,2022.0,4,0,4
CMR,GBR,2022.0,5,0,5
,BHS,2014.0,4,0,4
MMR,PHL,2020.0,2,0,2
GHA,RUS,2019.0,2,0,2
ZAF,TTO,2017.0,2,0,2
IND,ATG,2022.0,1,0,1
VEN,SWE,2019.0,1,0,1
EGY,YEM,2007.0,3,0,3
,TON,2018.0,1,0,1
HRV,IRL,2003.0,1,0,1
,HND,2000.0,4,0,4
PYF,,2007.0,2,0,2
LTU,RUS,2006.0,2,0,2
BGD,CHN,2005.0,2,0,2
ESP,PRY,2007.0,1,0,1
SWE,DZA,2018.0,1,0,1
PHL,FRA,2003.0,2,0,2
ESP,DZA,2004.0,4,0,4
SVK,SWE,2000.0,1,0,1
SWE,PAK,2006.0,1,0,1
KGZ,KAZ,2007.0,1,0,1
SGP,HUN,2007.0,1,0,1
POL,URY,2009.0,1,0,1
SVK,NOR,2005.0,1,0,1
PER,CRI,2010.0,1,0,1
GBR,NCL,2015.0,1,0,1
BOL,PRT,2017.0,1,0,1
MYS,SLE,2020.0,1,0,1
BEL,BGR,2005.0,1,0,1
CHN,IRN,2001.0,1,0,1
CHN,RWA,2012.0,2,0,2
SDN,AUS,2013.0,2,0,2
KWT,QAT,2014.0,2,0,2
MEX,COD,2019.0,1,0,1
,MRT,2013.0,6,0,6
NLD,PER,2021.0,2,0,2
ZWE,KEN,2009.0,3,0,3
SVK,NOR,2002.0,1,0,1
URY,CAN,2005.0,1,0,1
IRL,MYS,2003.0,1,0,1
REU,FRA,2001.0,3,0,3
ITA,ERI,2011.0,1,0,1
QAT,POL,2017.0,1,0,1
MAR,SWE,2016.0,1,0,1
BHR,PAK,2005.0,1,0,1
BFA,USA,2009.0,2,0,2
SGP,SAU,2005.0,1,0,1
EGY,THA,2012.0,2,0,2
ETH,SWE,2021.0,3,0,3
SWE,BHR,2017.0,1,0,1
BLR,CHE,2005.0,1,0,1
LVA,BEL,2010.0,1,0,1
KEN,NGA,2012.0,2,0,2
ITA,MLT,2011.0,3,0,3
IND,KEN,2007.0,2,0,2
SDN,OMN,2015.0,2,0,2
TZA,SDN,2007.0,1,0,1
NPL,UZB,2010.0,1,0,1
HUN,CZE,2015.0,6,0,6
RUS,MNG,2015.0,2,0,2
MRT,JPN,2019.0,1,0,1
RUS,ARG,1998.0,5,0,5
RUS,KGZ,2006.0,1,0,1
UGA,ETH,2017.0,2,0,2
LUX,KEN,2008.0,1,0,1
USA,ATG,2017.0,1,0,1
RWA,BGD,1999.0,1,0,1
NLD,JOR,1999.0,1,0,1
VNM,CHE,2012.0,1,0,1
LBR,,2014.0,3,0,3
TUN,PRT,2014.0,2,0,2
CHE,MAR,2021.0,2,0,2
FRA,RWA,2013.0,4,0,4
TWN,SWZ,2019.0,1,0,1
CMR,,2003.0,2,0,2
GMB,USA,2021.0,2,0,2
VNM,MAC,2021.0,1,0,1
EST,CZE,2020.0,2,0,2
NAM,JPN,2010.0,1,0,1
SDN,DEU,2007.0,2,0,2
GRL,,2015.0,2,0,2
DNK,LUX,2018.0,2,0,2
ARM,CHN,2014.0,1,0,1
PSE,ARE,2013.0,2,0,2
JOR,NLD,2002.0,1,0,1
BLR,LTU,2020.0,2,0,2
IND,PAN,2015.0,1,0,1
THA,BRA,2011.0,1,0,1
MYS,UGA,2018.0,2,0,2
USA,PRY,2008.0,1,0,1
FIN,HKG,2002.0,2,0,2
PAN,GRC,1998.0,1,0,1
AUS,ROU,2006.0,2,0,2
NZL,NCL,2010.0,1,0,1
SVN,CHE,2006.0,1,0,1
AUS,BWA,2014.0,2,0,2
CUB,CHE,2007.0,3,0,3
BLR,SAU,2015.0,1,0,1
GBR,AGO,2021.0,1,0,1
NZL,TWN,1999.0,1,0,1
ARG,NZL,2019.0,1,0,1
UGA,TZA,2016.0,2,0,2
SVN,CAN,2001.0,1,0,1
USA,BRB,2012.0,2,0,2
CUB,FRA,2019.0,2,0,2
ALB,DEU,2019.0,1,0,1
EGY,PER,2012.0,1,0,1
TUV,,2024.0,1,0,1
TUR,ARE,2001.0,1,0,1
BDI,,2008.0,1,0,1
ARG,NZL,2010.0,2,0,2
LTU,EST,2002.0,1,0,1
IRQ,GBR,2004.0,1,0,1
SWE,MAR,2006.0,1,0,1
CMR,BEL,2007.0,2,0,2
ITA,BLR,1997.0,1,0,1
IND,SRB,2000.0,1,0,1
CIV,CMR,2001.0,1,0,1
HKG,RUS,2008.0,2,0,2
IND,LBY,2010.0,3,0,3
KHM,GBR,2002.0,1,0,1
ISR,SRB,2004.0,1,0,1
BRN,OMN,2008.0,1,0,1
TUN,CHE,2014.0,2,0,2
DNK,URY,2006.0,1,0,1
IDN,FJI,2014.0,1,0,1
IRQ,PSE,2010.0,1,0,1
BGR,CYP,2008.0,1,0,1
DNK,IRQ,2013.0,1,0,1
GTM,IDN,2015.0,1,0,1
GRC,CZE,2005.0,1,0,1
BRA,MCO,2019.0,1,0,1
MKD,SVN,2021.0,1,0,1
LKA,NOR,2022.0,1,0,1
SRB,IND,2019.0,1,0,1
COL,ECU,2012.0,2,0,2
DEU,KWT,2003.0,2,0,2
,TKM,2006.0,2,0,2
LBY,RUS,2006.0,1,0,1
RWA,DEU,2007.0,2,0,2
IND,BRB,2011.0,1,0,1
SRB,ARE,2014.0,1,0,1
ECU,RUS,2018.0,1,0,1
NLD,SUR,2013.0,1,0,1
NOR,CHL,2005.0,1,0,1
SRB,KOR,2020.0,1,0,1
UGA,GHA,2020.0,1,0,1
KOR,POL,2002.0,1,0,1
GUF,GUY,2009.0,2,0,2
GBR,OMN,2000.0,1,0,1
BWA,FIN,2001.0,1,0,1
ZAF,BEN,2001.0,2,0,2
MOZ,PAK,2008.0,1,0,1
SGP,PRI,2007.0,1,0,1
DEU,OMN,1998.0,1,0,1
ARG,DNK,2010.0,1,0,1
CHE,CUB,2009.0,2,0,2
KOR,CHL,2002.0,1,0,1
SWE,GNB,2005.0,1,0,1
ITA,HND,2009.0,1,0,1
QAT,PSE,2013.0,1,0,1
,BLZ,2008.0,3,0,3
IDN,HUN,2017.0,1,0,1
AUT,CIV,2018.0,1,0,1
SRB,IND,2017.0,1,0,1
PRY,CZE,2016.0,1,0,1
HUN,AZE,2019.0,1,0,1
LBY,ISR,2019.0,1,0,1
MLI,NER,2009.0,1,0,1
BFA,AUT,2016.0,3,0,3
AZE,RUS,1999.0,1,0,1
COD,JPN,2018.0,1,0,1
EST,PRT,2009.0,1,0,1
SWE,KWT,2019.0,1,0,1
ITA,COL,2004.0,1,0,1
SDN,ARE,2012.0,2,0,2
SLV,ESP,2008.0,1,0,1
SVK,EGY,2010.0,1,0,1
JOR,NZL,2011.0,1,0,1
GBR,MCO,2007.0,1,0,1
MDA,JPN,2000.0,1,0,1
ISR,PAK,2012.0,1,0,1
COL,CHN,2005.0,1,0,1
CZE,KOR,2008.0,1,0,1
EGY,TWN,2005.0,1,0,1
ARG,GTM,2008.0,1,0,1
KEN,THA,2013.0,1,0,1
HKG,ARE,2015.0,1,0,1
MAR,TZA,2020.0,1,0,1
AUS,MYS,1998.0,2,0,2
TCA,USA,2010.0,2,0,2
IDN,HUN,2019.0,2,0,2
HKG,PRT,2021.0,1,0,1
TZA,ETH,2018.0,1,0,1
ISL,JOR,2022.0,1,0,1
NGA,MAC,2022.0,1,0,1
MMR,ITA,2022.0,1,0,1
ZWE,NAM,2005.0,1,0,1
USA,SLE,2006.0,1,0,1
LVA,POL,2001.0,2,0,2
COG,BEL,2002.0,1,0,1
USA,FJI,1998.0,1,0,1
FRA,ETH,2004.0,1,0,1
BLR,ISR,2006.0,1,0,1
CHE,KEN,2010.0,1,0,1
FIN,TZA,2005.0,1,0,1
SVK,SUR,2021.0,1,0,1
BWA,CHL,2018.0,1,0,1
ESP,URY,1999.0,2,0,2
PYF,POL,2002.0,1,0,1
ESP,MLT,2022.0,1,0,1
SRB,IND,2010.0,1,0,1
ARG,ARE,2009.0,1,0,1
LSO,USA,2004.0,1,0,1
ITA,PER,2008.0,1,0,1
ISR,IRL,2019.0,1,0,1
CHE,NAM,2013.0,1,0,1
GHA,TZA,2012.0,1,0,1
BFA,MDG,2015.0,1,0,1
ROU,IRL,2018.0,2,0,2
DOM,CHL,2010.0,1,0,1
THA,HUN,2017.0,1,0,1
SLB,MYS,2018.0,1,0,1
DEU,MMR,2015.0,1,0,1
ARG,IND,2001.0,2,0,2
KWT,FIN,2005.0,2,0,2
ARM,BLR,2017.0,1,0,1
VEN,ITA,2013.0,2,0,2
ZWE,COL,2008.0,1,0,1
ITA,MOZ,2022.0,1,0,1
LBN,NLD,2015.0,2,0,2
GHA,NOR,2015.0,1,0,1
SVK,EGY,2017.0,1,0,1
BRB,,2019.0,3,0,3
FRA,BHR,2016.0,1,0,1
IRN,GRC,2021.0,1,0,1
COG,GBR,2011.0,1,0,1
IND,LKA,1999.0,1,0,1
SLE,GBR,2007.0,1,0,1
NER,THA,2010.0,1,0,1
OMN,SGP,2007.0,1,0,1
VUT,GBR,2013.0,1,0,1
MYS,BIH,2012.0,1,0,1
ESP,KWT,2014.0,1,0,1
TWN,MWI,2015.0,1,0,1
SEN,KEN,2012.0,1,0,1
MAR,COM,2016.0,1,0,1
AUS,BHR,2015.0,1,0,1
PRT,PAK,2020.0,1,0,1
UGA,NER,2022.0,1,0,1
NCL,LAO,2019.0,1,0,1
BOL,MEX,2019.0,1,0,1
IDN,RWA,2020.0,1,0,1
FRA,KAZ,2006.0,1,0,1
BEL,CHL,2000.0,1,0,1
BWA,AUS,2004.0,1,0,1
IRL,NPL,2014.0,1,0,1
DZA,FIN,2019.0,1,0,1
DZA,OMN,2015.0,1,0,1
POL,PAN,2020.0,1,0,1
ZAF,AZE,2007.0,1,0,1
CYP,ROU,2015.0,1,0,1
TUR,AFG,2019.0,1,0,1
DMA,,2022.0,1,0,1
ZMB,NZL,2022.0,1,0,1
FIN,QAT,2010.0,1,0,1
FRO,NOR,2019.0,1,0,1
JPN,PSE,2016.0,1,0,1
GBR,BRB,2008.0,1,0,1
SVK,CAN,2001.0,1,0,1
GBR,CMR,2010.0,2,0,2
LVA,CZE,2015.0,1,0,1
KEN,CZE,2017.0,1,0,1
HKG,NOR,2009.0,1,0,1
DOM,ESP,2012.0,1,0,1
BRA,QAT,2014.0,1,0,1
RWA,SAU,2019.0,1,0,1
AZE,AFG,2017.0,1,0,1
MKD,CAN,2018.0,1,0,1
PRT,SRB,2016.0,1,0,1
PAK,SDN,2018.0,1,0,1
CHN,MLI,2016.0,1,0,1
SAU,PRI,2011.0,1,0,1
CIV,ZAF,2004.0,1,0,1
RUS,TJK,2006.0,1,0,1
GRD,GBR,2012.0,1,0,1
YEM,NOR,2013.0,1,0,1
TUR,THA,2008.0,1,0,1
POL,BGD,2021.0,1,0,1
GEO,CAN,2012.0,1,0,1
AUT,ARG,2000.0,1,0,1
AUT,ISL,2007.0,1,0,1
TUR,POL,2007.0,1,0,1
GRC,TUR,2001.0,1,0,1
KEN,ARE,2012.0,1,0,1
ZMB,MWI,2015.0,1,0,1
KAZ,FRA,2007.0,1,0,1
ZAF,GMB,2017.0,1,0,1
CPV,,2010.0,1,0,1
SAU,PSE,2022.0,2,0,2
ITA,TZA,2020.0,1,0,1
CAN,NCL,2012.0,1,0,1
KHM,CMR,2015.0,1,0,1
ETH,,1999.0,1,0,1
HKG,EGY,2009.0,1,0,1
CHE,COG,2007.0,1,0,1
DOM,,2010.0,6,0,6
GBR,BHR,2004.0,1,0,1
KWT,BGR,2009.0,1,0,1
GHA,SVN,2016.0,1,0,1
IRL,KEN,2013.0,1,0,1
AND,,2013.0,1,0,1
UZB,AUT,2012.0,1,0,1
LBY,ARE,2013.0,2,0,2
FJI,SLB,2019.0,1,0,1
NLD,COD,2019.0,1,0,1
SGP,SAU,2002.0,1,0,1
GNQ,FRA,2011.0,1,0,1
TUN,MRT,2015.0,1,0,1
MWI,BRA,2018.0,1,0,1
ARG,EGY,2011.0,1,0,1
HRV,IRN,2020.0,1,0,1
TUR,SVN,2018.0,1,0,1
BLR,CZE,2020.0,2,0,2
CHL,HND,2018.0,1,0,1
CRI,POL,2012.0,1,0,1
ISR,CRI,2022.0,1,0,1
EGY,BGD,2005.0,1,0,1
SRB,ROU,2014.0,1,0,1
BGD,GRC,1999.0,1,0,1
KEN,COG,2005.0,1,0,1
URY,NLD,2006.0,1,0,1
CHL,IDN,2014.0,1,0,1
GRC,BGD,2022.0,1,0,1
DNK,SVN,2011.0,2,0,2
JOR,NLD,2005.0,1,0,1
FJI,USA,2022.0,1,0,1
CMR,DZA,2005.0,1,0,1
GRC,ISR,2000.0,1,0,1
DOM,ARG,2006.0,1,0,1
TUR,JOR,2004.0,1,0,1
JPN,CYP,2006.0,1,0,1
LBY,IRQ,2011.0,1,0,1
COD,BWA,2015.0,1,0,1
MAR,ETH,2020.0,1,0,1
SWE,MOZ,2012.0,1,0,1
VEN,RUS,2017.0,1,0,1
KEN,MWI,2002.0,1,0,1
ESP,PRI,2022.0,1,0,1
SYR,KEN,2014.0,1,0,1
VUT,NZL,2020.0,1,0,1
CHN,KEN,2003.0,1,0,1
UGA,ETH,2010.0,1,0,1
MDG,PHL,2011.0,1,0,1
GTM,ARG,2018.0,1,0,1
CUB,VEN,2019.0,1,0,1
,DJI,2015.0,2,0,2
USA,ERI,2004.0,1,0,1
NLD,LVA,2019.0,1,0,1
SWE,KWT,2017.0,1,0,1
ETH,FIN,2018.0,1,0,1
LAO,LUX,2019.0,1,0,1
NCL,SWE,2017.0,1,0,1
UZB,CHE,2022.0,1,0,1
BEL,IDN,2006.0,1,0,1
HUN,MKD,2011.0,1,0,1
BOL,JOR,2013.0,1,0,1
ISR,ISL,2002.0,1,0,1
MYS,EST,2013.0,1,0,1
ITA,PRI,2008.0,1,0,1
TJK,PAK,2008.0,1,0,1
PER,,2001.0,1,0,1
ZWE,CHE,2010.0,1,0,1
TUN,BHR,2012.0,1,0,1
IND,JOR,2006.0,1,0,1
LKA,CHE,2014.0,1,0,1
TWN,ESP,2011.0,1,0,1
BLR,CAN,2008.0,1,0,1
LBY,POL,2021.0,1,0,1
CAN,FJI,2022.0,1,0,1
BEL,TTO,2006.0,1,0,1
EGY,DZA,2012.0,1,0,1
BRA,CIV,2011.0,1,0,1
SWE,GNB,2002.0,1,0,1
ERI,ZAF,2009.0,1,0,1
VNM,NZL,2014.0,1,0,1
DOM,BWA,2018.0,1,0,1
SGP,MMR,2022.0,1,0,1
REU,USA,2020.0,1,0,1
SGP,IRL,2001.0,1,0,1
ISR,EST,2021.0,1,0,1
COL,UGA,2016.0,1,0,1
LKA,BRA,2015.0,1,0,1
BIH,MDA,2014.0,1,0,1
FIN,PHL,2001.0,1,0,1
IRL,OMN,2016.0,1,0,1
BIH,ESP,2018.0,1,0,1
IDN,SWE,2020.0,1,0,1
SEN,IND,2021.0,1,0,1
PRT,BRA,2020.0,160,204,-44
RUS,DEU,2007.0,111,68,43
TUR,DNK,2009.0,2,1,1
MEX,USA,2002.0,174,183,-9
AUS,ESP,2011.0,13,36,-23
NZL,CHN,2004.0,5,1,4
MEX,USA,2005.0,123,132,-9
AUT,GRC,2017.0,3,7,-4
SWE,DEU,2004.0,73,81,-8
NZL,GBR,2012.0,94,160,-66
DEU,LUX,2011.0,32,4,28
PRT,IND,2017.0,19,13,6
USA,LBN,2002.0,11,21,-10
CHN,HKG,2008.0,251,245,6
CAN,GBR,2008.0,311,292,19
CAN,CHN,2012.0,223,184,39
GBR,ITA,2020.0,385,477,-92
DNK,DEU,2011.0,62,94,-32
FRA,USA,2016.0,873,674,199
ITA,GRC,2009.0,21,20,1
NLD,USA,2014.0,355,318,37
DEU,USA,1999.0,561,429,132
CHN,USA,2012.0,2024,1949,75
FRA,DEU,2007.0,262,314,-52
MYS,YEM,2011.0,6,1,5
DEU,CRI,1999.0,1,1,0
JPN,SGP,2010.0,29,13,16
GBR,CAN,2016.0,308,361,-53
GBR,MLT,2011.0,4,6,-2
BEL,FRA,2016.0,192,211,-19
ESP,ARG,2001.0,30,33,-3
GBR,DZA,2020.0,2,3,-1
IND,SGP,2009.0,51,20,31
FRA,ITA,2004.0,146,139,7
PRT,ESP,2021.0,71,85,-14
GRC,MEX,2011.0,1,1,0
AUT,GBR,2010.0,62,58,4
KOR,USA,2001.0,284,369,-85
GBR,MEX,2016.0,55,40,15
DEU,PRT,2008.0,16,11,5
POL,AUT,2007.0,8,3,5
CHN,AUS,2013.0,232,148,84
ZAF,NZL,2002.0,7,2,5
POL,SVK,2006.0,3,3,0
PRI,USA,2004.0,47,45,2
DEU,KOR,2012.0,36,38,-2
IRL,SVN,2017.0,1,2,-1
AUS,SAU,2015.0,42,28,14
JPN,DEU,2013.0,115,106,9
DEU,ISL,2011.0,7,3,4
JPN,KOR,2006.0,126,101,25
BRA,CAN,2004.0,29,24,5
GRC,LUX,2013.0,3,2,1
DEU,BEL,2003.0,44,44,0
BRA,FRA,2018.0,119,94,25
USA,FIN,2010.0,53,72,-19
IRN,SWE,2008.0,6,13,-7
USA,PRI,2003.0,37,44,-7
POL,DEU,2001.0,36,52,-16
ITA,BRA,2013.0,43,25,18
USA,SGP,2004.0,103,110,-7
USA,ECU,2021.0,16,23,-7
DEU,SRB,2013.0,11,7,4
CHN,DNK,2011.0,32,11,21
IRL,BEL,2010.0,5,8,-3
ITA,FRA,2013.0,360,209,151
DEU,ISR,2011.0,31,35,-4
GRC,DEU,2011.0,57,37,20
IRN,USA,2013.0,400,62,338
CHE,CAN,2021.0,47,74,-27
USA,LBN,2005.0,29,28,1
ISR,CHE,2012.0,16,8,8
AUS,HKG,2009.0,26,41,-15
NGA,ZAF,2015.0,59,42,17
SWE,USA,2021.0,156,174,-18
GBR,FIN,2016.0,50,53,-3
USA,ESP,2018.0,382,523,-141
NOR,RUS,2013.0,7,8,-1
EGY,USA,2015.0,84,103,-19
IND,TWN,2018.0,72,41,31
BGD,USA,2018.0,108,38,70
COL,AUS,2016.0,9,3,6
USA,THA,2020.0,173,109,64
BGD,AUS,2014.0,50,21,29
CAN,BRA,2014.0,34,74,-40
GBR,ISR,2013.0,41,34,7
GBR,PHL,2014.0,9,5,4
IRN,GBR,2008.0,20,59,-39
AUT,GBR,2017.0,89,68,21
PRT,CHN,2018.0,13,7,6
CHL,FRA,2002.0,15,21,-6
AUS,IDN,2018.0,77,26,51
NZL,HKG,2017.0,7,9,-2
ARG,ESP,2003.0,52,42,10
AUT,CHE,2022.0,37,25,12
AUS,PHL,2017.0,6,18,-12
AUS,CHN,2020.0,421,318,103
FRA,AUT,2018.0,42,31,11
RUS,IND,2019.0,9,18,-9
KOR,FRA,2015.0,21,22,-1
BEL,LUX,2014.0,25,2,23
USA,HKG,2016.0,145,139,6
CHN,GBR,2009.0,143,177,-34
TUN,MAR,2011.0,2,1,1
BGD,PAK,2017.0,8,9,-1
USA,NOR,2012.0,71,40,31
AUS,IRQ,2017.0,12,5,7
POL,USA,2018.0,131,82,49
NOR,GBR,2008.0,32,46,-14
CHN,NZL,2017.0,26,24,2
HUN,BEL,2015.0,8,2,6
ITA,NOR,2015.0,32,10,22
ESP,CHE,2018.0,113,66,47
TWN,THA,2019.0,16,4,12
GBR,BEL,2003.0,63,67,-4
NLD,FRA,2013.0,94,88,6
EGY,SAU,2015.0,161,183,-22
CAN,NLD,2014.0,58,58,0
DEU,CAN,2022.0,57,47,10
AUT,GBR,2019.0,95,95,0
ITA,AUT,2011.0,31,39,-8
RUS,IRN,2016.0,6,4,2
CRI,COL,2016.0,4,3,1
CHL,IND,2018.0,4,8,-4
DEU,BGR,2007.0,16,11,5
NLD,SWE,2018.0,63,56,7
ISL,GBR,2018.0,3,7,-4
IDN,SGP,2022.0,2,1,1
CHN,DEU,2005.0,114,84,30
RUS,SWE,2001.0,38,13,25
SAU,PAK,2018.0,70,69,1
ESP,DOM,2016.0,7,1,6
AUT,FRA,2018.0,31,42,-11
TUR,ESP,2012.0,6,6,0
ETH,USA,2016.0,30,15,15
MWI,AUS,2019.0,3,2,1
BRA,COL,2021.0,63,32,31
BEL,RWA,2013.0,3,1,2
HKG,GBR,2009.0,41,38,3
SGP,NLD,2016.0,15,19,-4
IDN,FRA,2017.0,3,10,-7
ARG,BEL,2021.0,5,3,2
SVK,AUT,2017.0,6,11,-5
BEL,ETH,2018.0,10,3,7
AUT,USA,2020.0,116,126,-10
MEX,COL,2021.0,24,33,-9
BEL,COD,2017.0,7,2,5
TWN,IDN,2014.0,11,12,-1
JPN,TWN,2000.0,9,3,6
TTO,JAM,2021.0,2,1,1
ECU,ESP,2020.0,44,54,-10
SWE,CAN,2005.0,36,22,14
ARE,AUS,2018.0,17,18,-1
ITA,ETH,2020.0,5,6,-1
GTM,ECU,2020.0,1,2,-1
CHN,SWE,2021.0,90,89,1
AUS,IRQ,2019.0,22,5,17
JPN,MNG,2015.0,8,1,7
JPN,SGP,2019.0,35,29,6
NZL,USA,2021.0,82,92,-10
UKR,FRA,2018.0,10,16,-6
FRA,CMR,2019.0,19,14,5
KOR,NOR,2007.0,1,2,-1
CAN,BEL,2020.0,35,36,-1
BEL,POL,2008.0,3,14,-11
ISL,DNK,2016.0,5,5,0
DEU,ARM,2007.0,2,2,0
SWE,SAU,2021.0,7,7,0
CAN,NOR,2008.0,11,4,7
NOR,CAN,2009.0,8,13,-5
JPN,CHE,2010.0,33,25,8
CHE,BGD,2020.0,9,2,7
NGA,GBR,2012.0,32,27,5
SWE,RUS,2019.0,14,16,-2
FJI,AUS,2017.0,7,8,-1
BRA,USA,2021.0,449,234,215
FRA,CHN,1999.0,11,7,4
USA,GRD,2016.0,6,14,-8
EST,GBR,2016.0,10,3,7
POL,CHE,2004.0,13,6,7
RUS,USA,2003.0,290,216,74
THA,USA,2001.0,46,37,9
TWN,AUS,2012.0,15,18,-3
DEU,FRA,2004.0,202,219,-17
NLD,MEX,2013.0,8,5,3
FRA,HRV,2016.0,7,6,1
NOR,USA,2000.0,13,25,-12
BRA,DEU,1999.0,8,23,-15
GRC,FRA,2020.0,39,26,13
MLT,GBR,2013.0,5,7,-2
PRT,MEX,2012.0,3,2,1
JPN,SWE,2014.0,28,33,-5
NZL,FRA,2009.0,16,12,4
NLD,BEL,2004.0,60,79,-19
PRT,CHE,2001.0,8,2,6
DNK,IRN,2012.0,6,14,-8
FIN,EST,2012.0,19,7,12
GBR,LKA,2009.0,11,4,7
FRA,MAR,2011.0,92,43,49
ISL,AUT,2012.0,1,1,0
PAK,DEU,2013.0,25,35,-10
NLD,PRT,2011.0,17,16,1
RUS,POL,2001.0,10,14,-4
CHL,AUS,2014.0,19,12,7
BRA,CHL,2013.0,10,15,-5
EGY,FRA,2013.0,9,20,-11
AUS,IRN,2013.0,26,116,-90
SGP,FRA,2013.0,20,25,-5
AUS,PHL,2019.0,11,16,-5
ESP,PRT,2009.0,50,49,1
IDN,KOR,2007.0,3,2,1
SVK,AUT,2010.0,10,7,3
ESP,ISR,2017.0,10,6,4
COL,VEN,2018.0,13,62,-49
FIN,CHN,2004.0,12,7,5
KOR,AUS,2015.0,32,20,12
JPN,USA,2000.0,358,279,79
CAN,AUS,2000.0,27,29,-2
CHN,DEU,2002.0,112,57,55
JPN,ESP,2005.0,7,10,-3
KOR,CHE,2019.0,11,13,-2
DNK,SWE,2014.0,89,71,18
NLD,HKG,2017.0,7,8,-1
NZL,HKG,2010.0,2,2,0
HKG,IND,2002.0,3,4,-1
NLD,CHE,2003.0,41,36,5
NOR,CHN,2007.0,2,8,-6
USA,PAN,2012.0,10,15,-5
MEX,BEL,2015.0,8,5,3
TWN,SWE,2019.0,8,5,3
SWE,FIN,1999.0,13,19,-6
GHA,JPN,2015.0,1,3,-2
HKG,DEU,2008.0,10,6,4
CZE,DNK,2015.0,4,3,1
DEU,IND,2014.0,107,161,-54
HRV,USA,2019.0,23,6,17
BGR,BEL,2001.0,9,2,7
USA,CZE,2015.0,57,43,14
USA,RWA,2015.0,9,13,-4
RUS,ITA,2007.0,26,19,7
CAN,LUX,2008.0,2,1,1
ESP,DEU,2002.0,98,79,19
JPN,CHE,2017.0,35,42,-7
ITA,CHE,1998.0,46,31,15
MAR,ITA,2022.0,1,4,-3
IRL,JPN,2014.0,4,2,2
FRA,GBR,1997.0,30,31,-1
HUN,BLR,2000.0,1,1,0
IND,QAT,2019.0,18,5,13
DEU,ARG,1998.0,4,3,1
PER,ESP,2018.0,16,29,-13
NZL,SWE,2019.0,8,7,1
BEL,NLD,2006.0,89,61,28
MEX,ITA,2020.0,22,12,10
RUS,CHE,2013.0,29,10,19
KAZ,RUS,2007.0,4,13,-9
BEL,CZE,2015.0,11,1,10
BRA,ISR,2020.0,5,5,0
DEU,COL,2019.0,18,22,-4
TZA,CHE,2022.0,4,2,2
THA,AUT,2017.0,9,7,2
LUX,FRA,2020.0,17,19,-2
NLD,DNK,2003.0,18,18,0
USA,BHS,2020.0,3,4,-1
ESP,CUB,2002.0,18,14,4
TWN,CHE,2021.0,7,3,4
CHE,ARE,2022.0,1,1,0
VNM,NLD,2020.0,8,8,0
HKG,MAC,2021.0,21,6,15
ESP,ISR,2010.0,4,8,-4
JPN,CHE,2019.0,32,35,-3
ITA,ARE,2020.0,6,10,-4
JPN,SGP,2017.0,36,41,-5
SRB,ITA,2015.0,7,3,4
DEU,UKR,2020.0,7,19,-12
LKA,JPN,2018.0,6,11,-5
SVK,AUT,2019.0,12,10,2
THA,AUT,2019.0,4,4,0
BRA,IRN,2020.0,2,9,-7
NZL,ZAF,2002.0,2,7,-5
POL,IND,2022.0,4,20,-16
IRQ,HUN,2021.0,7,1,6
CHN,ETH,2021.0,25,10,15
SAU,BGD,2021.0,6,10,-4
CHN,LKA,2021.0,3,3,0
CHN,NZL,2019.0,33,44,-11
MYS,USA,2014.0,41,35,6
CHN,BRA,2016.0,7,3,4
CHE,HUN,2010.0,13,9,4
ESP,VEN,2006.0,13,19,-6
UKR,POL,2013.0,18,8,10
CZE,POL,2019.0,11,19,-8
KOR,CHE,2017.0,20,10,10
SWE,CAN,2002.0,35,26,9
AUT,BEL,2014.0,10,13,-3
NLD,HKG,2010.0,4,6,-2
SVK,FRA,2005.0,6,1,5
ROU,BEL,2012.0,13,2,11
ISR,GBR,2013.0,34,41,-7
HUN,CAN,2005.0,5,3,2
PAK,BGD,2009.0,5,10,-5
ESP,DEU,2005.0,61,119,-58
AUT,ESP,2007.0,9,7,2
TTO,GBR,2012.0,5,7,-2
FRA,MYS,2020.0,3,9,-6
MAR,CAN,2005.0,7,4,3
VEN,ECU,2018.0,31,5,26
TUR,EGY,2008.0,2,1,1
ZAF,AUT,2011.0,2,2,0
FRA,MEX,2004.0,37,18,19
GBR,BRA,2004.0,56,43,13
TUN,CAN,2003.0,2,2,0
BRA,RUS,2007.0,9,1,8
SGP,IDN,2016.0,9,6,3
BGR,GBR,2003.0,9,9,0
LTU,GBR,2006.0,5,3,2
MAR,CAN,2002.0,7,2,5
HUN,IRL,2012.0,4,3,1
SWE,AUT,2001.0,10,2,8
ARE,CAN,2022.0,12,6,6
ESP,AUS,2005.0,9,10,-1
SVK,FRA,2002.0,4,6,-2
SVK,DEU,2009.0,13,11,2
USA,HRV,2021.0,10,12,-2
FRA,SVN,2016.0,3,5,-2
KEN,GBR,2001.0,8,10,-2
POL,NLD,2002.0,12,8,4
FRA,NZL,2003.0,7,4,3
DEU,ESP,1999.0,30,41,-11
KEN,USA,2007.0,21,21,0
USA,FIN,2017.0,63,90,-27
TUR,POL,2008.0,1,1,0
RUS,UZB,2015.0,4,5,-1
CHE,NOR,2005.0,11,2,9
ARG,BRA,2003.0,26,15,11
HRV,BIH,2013.0,7,4,3
CHE,FIN,2012.0,10,13,-3
ROU,MDA,2019.0,3,5,-2
SWE,CHE,2015.0,52,40,12
CAN,ARM,2006.0,1,1,0
ARM,CAN,2011.0,1,1,0
SGP,ISR,2012.0,1,7,-6
JPN,HUN,2021.0,2,3,-1
SEN,FRA,2015.0,20,27,-7
SWE,HUN,2013.0,6,9,-3
ITA,GEO,2012.0,2,1,1
GBR,TTO,2001.0,4,3,1
BGD,JPN,2000.0,7,5,2
ARE,QAT,2014.0,12,1,11
SWE,ISL,2007.0,11,4,7
GRC,MLT,2014.0,1,1,0
NLD,ZAF,2007.0,10,9,1
SAU,NGA,2013.0,6,3,3
DEU,DNK,1999.0,26,17,9
DEU,TUR,2011.0,28,39,-11
RUS,CHN,2000.0,5,1,4
ECU,VEN,2019.0,6,41,-35
LKA,GBR,2021.0,12,9,3
ITA,COL,2015.0,16,5,11
HUN,GBR,1997.0,3,4,-1
FRA,AUS,1999.0,14,12,2
USA,MYS,2018.0,27,67,-40
ESP,AUS,2002.0,13,8,5
CHL,USA,2000.0,12,16,-4
BEL,SGP,2005.0,1,4,-3
VNM,BEL,2019.0,8,13,-5
NOR,CHE,2003.0,6,9,-3
SWE,HKG,2005.0,2,1,1
DNK,MEX,2004.0,1,1,0
JPN,CAN,2000.0,23,23,0
KEN,PAK,2007.0,1,4,-3
DEU,IDN,2009.0,8,8,0
ESP,NOR,2008.0,11,4,7
KOR,CAN,2016.0,40,36,4
DEU,CHL,2000.0,6,2,4
HRV,USA,2010.0,16,23,-7
DNK,POL,2009.0,6,5,1
PRT,TUR,2018.0,6,4,2
GBR,BHR,2015.0,3,2,1
CHE,RUS,2009.0,12,16,-4
NOR,LUX,2015.0,1,1,0
NLD,NZL,2007.0,4,3,1
BLR,RUS,2012.0,11,10,1
NLD,CZE,2016.0,10,10,0
AUT,DNK,2013.0,10,6,4
GBR,ROU,2011.0,8,13,-5
CZE,SVK,2012.0,29,54,-25
DEU,LBN,2018.0,8,9,-1
MYS,KOR,2016.0,15,15,0
CHE,IRN,2014.0,10,26,-16
NOR,ITA,2013.0,7,17,-10
KOR,HKG,2011.0,5,4,1
FJI,AUS,2010.0,8,3,5
DEU,CMR,2010.0,4,3,1
TUN,GBR,2017.0,5,1,4
KHM,USA,2021.0,1,3,-2
IND,IRN,2011.0,19,7,12
BRA,NOR,2015.0,8,5,3
USA,ETH,2020.0,18,28,-10
KAZ,EGY,2011.0,1,1,0
THA,TWN,2016.0,6,20,-14
NZL,NOR,2021.0,6,3,3
HRV,USA,2017.0,10,14,-4
ITA,HUN,2012.0,7,7,0
SWE,THA,2013.0,7,6,1
KOR,ARE,2019.0,14,2,12
IND,QAT,2010.0,6,1,5
NZL,SWE,2010.0,7,6,1
IRQ,ARE,2010.0,2,1,1
ESP,IRN,2015.0,5,15,-10
NZL,PRT,2021.0,1,3,-2
COG,COD,2013.0,16,6,10
DEU,LVA,2018.0,3,4,-1
CAN,IND,1998.0,5,6,-1
BEL,KWT,2012.0,1,1,0
IDN,AUS,2022.0,7,21,-14
KOR,AUT,2018.0,6,10,-4
UKR,DEU,2012.0,24,9,15
IRL,FIN,2018.0,5,9,-4
LAO,GBR,2017.0,3,3,0
CZE,SRB,2018.0,3,4,-1
TUR,FIN,2012.0,7,2,5
VNM,SWE,2014.0,1,2,-1
HRV,ESP,2022.0,3,1,2
IRL,BEL,2019.0,19,9,10
DEU,TWN,2020.0,10,21,-11
THA,CHE,2018.0,3,7,-4
NLD,JPN,1999.0,6,12,-6
EGY,KEN,2021.0,3,2,1
ZAF,BEL,2006.0,7,4,3
BEL,ZAF,2014.0,10,6,4
MNG,CHN,2019.0,1,4,-3
SVN,GBR,2021.0,4,10,-6
GBR,GUY,2019.0,1,1,0
BHS,GBR,2020.0,1,2,-1
KEN,CMR,2019.0,4,1,3
UZB,USA,2010.0,2,1,1
IND,ITA,2004.0,12,7,5
DEU,COL,2010.0,8,2,6
JPN,GBR,2000.0,42,40,2
EST,FIN,2005.0,4,3,1
USA,IRL,1999.0,35,39,-4
ESP,GRC,2018.0,14,17,-3
ECU,USA,2011.0,10,8,2
EST,FIN,2002.0,7,5,2
USA,URY,2016.0,9,12,-3
FIN,PRT,2011.0,4,2,2
GBR,IRN,2022.0,7,28,-21
DEU,ZAF,2009.0,23,15,8
RUS,NLD,2000.0,13,2,11
SVK,NLD,2017.0,5,2,3
HKG,IND,2005.0,2,5,-3
USA,UKR,2006.0,9,34,-25
POL,SVN,2010.0,2,3,-1
ESP,CHN,2011.0,10,8,2
JPN,SAU,2013.0,20,4,16
FRA,GRC,2014.0,23,35,-12
IRN,TUR,2013.0,18,7,11
USA,MLT,2009.0,1,1,0
ESP,ISR,2019.0,8,8,0
CHN,ISR,2008.0,6,3,3
BEL,MYS,2019.0,4,5,-1
TUR,BIH,2019.0,5,4,1
LBN,QAT,2019.0,2,3,-1
AFG,IRN,2020.0,3,3,0
IDN,MYS,2018.0,15,89,-74
EGY,KWT,2020.0,10,12,-2
BGD,IND,2018.0,9,13,-4
ZAF,USA,1999.0,28,18,10
DNK,QAT,2016.0,1,1,0
HKG,USA,2000.0,36,28,8
POL,EGY,2011.0,1,7,-6
IRL,BEL,2017.0,10,9,1
NZL,SWE,2017.0,11,9,2
AUS,KOR,1997.0,1,3,-2
CAN,TUR,2008.0,14,8,6
NZL,CAN,2006.0,21,32,-11
AUT,GRC,2019.0,1,7,-6
DEU,SAU,2009.0,13,2,11
DNK,GRL,2021.0,3,5,-2
ITA,BGR,2015.0,7,2,5
PHL,IND,2016.0,10,5,5
CHN,ARE,2014.0,2,2,0
AUS,FIN,2013.0,7,11,-4
SAU,JOR,2015.0,22,26,-4
AUS,TWN,2015.0,10,14,-4
PRT,NLD,2022.0,10,7,3
SGP,NZL,2019.0,12,15,-3
IND,SWE,2004.0,9,7,2
BGD,PAK,2010.0,9,2,7
CZE,POL,2017.0,14,21,-7
KWT,ARE,2016.0,2,3,-1
TUN,BEL,2019.0,4,5,-1
DEU,CMR,2017.0,6,7,-1
RUS,IND,2017.0,7,8,-1
PNG,USA,2016.0,1,2,-1
GBR,NPL,2009.0,3,4,-1
CAN,NGA,2008.0,3,4,-1
CHE,CMR,2009.0,3,1,2
GRC,CAN,2002.0,9,13,-4
PRT,AGO,2002.0,1,1,0
COL,MEX,2007.0,5,8,-3
BLR,UKR,2003.0,3,2,1
AUT,CZE,2000.0,3,5,-2
LBY,EGY,2011.0,7,2,5
GBR,ECU,2015.0,6,4,2
CHN,KOR,2003.0,23,24,-1
CHE,SWE,1997.0,3,2,1
IND,MEX,2001.0,6,2,4
MEX,PAN,2006.0,1,1,0
HUN,GBR,1998.0,6,4,2
SGP,AUS,2000.0,7,7,0
AUS,PHL,2010.0,8,6,2
ROU,CAN,2006.0,4,5,-1
ARE,SWE,2014.0,2,2,0
AUS,POL,2012.0,11,6,5
NZL,NLD,2004.0,3,9,-6
HUN,SWE,2020.0,5,6,-1
USA,IDN,2008.0,13,6,7
GAB,DEU,2021.0,8,2,6
PHL,KOR,2010.0,3,5,-2
MAR,BEL,2002.0,5,1,4
VNM,SGP,2012.0,3,2,1
BEL,NZL,2017.0,5,2,3
USA,SVN,2007.0,9,13,-4
RUS,ESP,2012.0,7,8,-1
TWN,THA,2010.0,3,3,0
IRN,JPN,2004.0,3,10,-7
RUS,CAN,2011.0,20,13,7
NLD,AUT,2007.0,14,15,-1
CYP,FRA,2014.0,3,4,-1
ROU,ITA,2000.0,2,1,1
POL,CAN,2011.0,11,32,-21
NPL,KOR,2010.0,3,1,2
ISR,FRA,2001.0,14,17,-3
BEN,NLD,2018.0,2,3,-1
GLP,BRA,2010.0,1,1,0
GHA,GBR,2014.0,8,22,-14
TUR,PSE,2016.0,3,2,1
KAZ,GBR,2008.0,3,2,1
BWA,SWE,2008.0,2,1,1
ETH,AUS,2014.0,6,1,5
NZL,SGP,2009.0,5,3,2
KOR,ARE,2017.0,12,2,10
LVA,DEU,2018.0,4,3,1
FRA,CMR,2017.0,13,17,-4
DEU,SVN,1999.0,2,1,1
BRN,AUS,2013.0,5,4,1
NOR,IRN,2013.0,5,15,-10
IND,AUS,2000.0,8,6,2
TWN,THA,2017.0,15,6,9
NLD,KHM,2021.0,3,1,2
HUN,CAN,2002.0,10,4,6
SGP,NZL,2010.0,8,10,-2
JPN,ESP,2002.0,8,6,2
PRT,ITA,2007.0,5,8,-3
DNK,BEL,2008.0,8,6,2
LTU,USA,2006.0,6,7,-1
CAN,AUT,2000.0,4,5,-1
FRA,LUX,2013.0,20,20,0
ZAF,GHA,2014.0,14,5,9
THA,VNM,2011.0,5,3,2
PHL,KOR,2017.0,5,14,-9
GBR,BGR,2007.0,4,2,2
FIN,SGP,2018.0,4,6,-2
GTM,HND,2018.0,1,1,0
BGD,PAK,2019.0,6,10,-4
CHN,NZL,2010.0,5,5,0
PHL,KOR,2019.0,2,10,-8
RUS,ZAF,2002.0,2,8,-6
KOR,CHE,2010.0,4,11,-7
AUS,BRA,2001.0,5,4,1
HKG,KOR,2014.0,12,4,8
BEL,MYS,2010.0,1,1,0
FRA,CMR,2010.0,13,20,-7
CHE,HUN,2017.0,6,16,-10
SGP,DNK,2009.0,4,3,1
SDN,SAU,2012.0,10,3,7
HUN,KAZ,2020.0,2,1,1
IRN,FIN,2013.0,12,4,8
CAN,ECU,2019.0,2,2,0
EGY,DEU,2022.0,10,11,-1
MEX,VEN,2008.0,9,4,5
UKR,CHE,2017.0,8,1,7
ITA,OMN,2019.0,2,1,1
ARG,AUT,2002.0,1,1,0
VEN,MEX,2015.0,5,5,0
DNK,KOR,2003.0,1,2,-1
UGA,USA,2006.0,7,9,-2
AUS,IRQ,2010.0,2,2,0
AUS,ZWE,2014.0,2,1,1
VNM,BEL,2017.0,5,15,-10
CHE,EST,2019.0,4,3,1
DEU,ARE,2013.0,7,1,6
HUN,POL,2014.0,3,7,-4
USA,NIC,2020.0,1,1,0
COL,PER,2016.0,2,4,-2
LBN,CHN,2020.0,2,1,1
BFA,SEN,2018.0,2,2,0
FJI,AUS,2019.0,8,4,4
DEU,COL,2017.0,17,11,6
MMR,JPN,2014.0,2,5,-3
TCD,DEU,2017.0,1,1,0
PRT,IND,2019.0,16,15,1
SVN,AUS,2017.0,2,2,0
CHN,MYS,2012.0,5,5,0
IRQ,GBR,2015.0,12,28,-16
CHN,AUT,2009.0,7,6,1
COD,FRA,2020.0,3,1,2
MYS,ESP,2016.0,2,3,-1
BIH,HUN,2019.0,2,1,1
NLD,HKG,2019.0,9,8,1
NGA,CAN,2007.0,3,2,1
TGO,FRA,2004.0,5,5,0
FRA,LTU,2015.0,4,2,2
CHE,ZMB,2010.0,1,1,0
MAR,BEL,2005.0,1,3,-2
DEU,MDA,2018.0,3,2,1
CRI,NLD,2004.0,1,1,0
AUT,ITA,1997.0,1,2,-1
QAT,SAU,2004.0,1,1,0
SWE,EST,2000.0,2,1,1
IND,COG,2014.0,2,1,1
IRL,BGR,2010.0,1,1,0
SEN,BFA,2006.0,1,1,0
BEL,ESP,2001.0,14,23,-9
FRA,UZB,2006.0,1,1,0
CZE,DEU,2000.0,9,8,1
ARE,MAR,2021.0,1,4,-3
TUR,CAN,2000.0,1,5,-4
VEN,BRA,2017.0,6,1,5
JPN,CHL,2013.0,5,2,3
EGY,YEM,2008.0,2,1,1
GRC,RUS,2007.0,3,1,2
DEU,LTU,2021.0,3,8,-5
SWE,KOR,2007.0,3,3,0
CZE,POL,2010.0,4,6,-2
BEL,IND,1997.0,2,1,1
BEL,IND,1998.0,2,2,0
LBR,USA,2017.0,2,3,-1
DEU,CUB,2013.0,2,7,-5
SRB,NLD,2008.0,1,1,0
SWE,ZAF,2011.0,4,6,-2
SVK,USA,2011.0,10,7,3
TZA,ZAF,2008.0,3,3,0
PSE,EGY,2018.0,4,6,-2
ETH,MYS,2013.0,1,1,0
FRA,MLI,2008.0,10,2,8
RWA,GBR,2019.0,3,2,1
HUN,DNK,2016.0,9,3,6
ETH,KEN,2018.0,4,7,-3
TWN,SWE,2010.0,4,1,3
UGA,NOR,2019.0,1,2,-1
ITA,SVN,2020.0,7,10,-3
USA,TTO,2016.0,3,7,-4
SGP,MAC,2021.0,5,1,4
FRA,ISL,2020.0,4,2,2
CHE,ZWE,2005.0,2,1,1
CHE,HUN,2019.0,7,9,-2
LBN,SWE,2019.0,4,1,3
BGD,NLD,2017.0,1,2,-1
CZE,PRT,2020.0,6,6,0
HKG,ESP,2021.0,2,2,0
LTU,DEU,2002.0,2,4,-2
CMR,NGA,2016.0,3,2,1
IND,BRA,2007.0,3,8,-5
CHL,RUS,2002.0,2,2,0
AZE,TUR,2014.0,2,4,-2
ETH,NOR,2016.0,4,8,-4
UGA,NOR,2017.0,2,2,0
IDN,NOR,2017.0,2,4,-2
ETH,CAN,2021.0,5,3,2
PRT,CZE,2015.0,8,2,6
MEX,JPN,2021.0,3,2,1
RUS,IRL,2003.0,4,1,3
RUS,TWN,2003.0,4,1,3
GBR,UKR,1998.0,8,5,3
TUR,BIH,2017.0,6,3,3
AUT,ITA,1998.0,1,1,0
SVN,USA,2008.0,8,5,3
IDN,TWN,2011.0,5,8,-3
KEN,MEX,2022.0,2,1,1
NOR,BRA,2003.0,2,1,1
PER,CAN,2013.0,2,1,1
SRB,RUS,1999.0,1,4,-3
CUB,ITA,2020.0,5,1,4
BEL,TUR,2003.0,2,1,1
ZAF,RUS,2020.0,4,2,2
EGY,CAN,1999.0,3,4,-1
ECU,VEN,2017.0,4,43,-39
NZL,FJI,2004.0,3,1,2
UKR,ESP,2017.0,1,3,-2
SWE,ISR,2003.0,1,2,-1
PHL,BEL,2012.0,2,3,-1
SWE,SVN,2017.0,2,4,-2
UZB,USA,2017.0,1,3,-2
TWN,RUS,2008.0,2,6,-4
ISL,NLD,2013.0,1,1,0
VNM,BEL,2010.0,1,4,-3
SGP,PHL,2015.0,6,2,4
IDN,FRA,2019.0,3,13,-10
NZL,HKG,2019.0,2,9,-7
USA,COG,2015.0,1,5,-4
JPN,LAO,2016.0,2,1,1
BEL,NOR,2012.0,6,1,5
FJI,NZL,2020.0,6,1,5
VNM,ETH,2021.0,1,1,0
FIN,BRA,2018.0,4,11,-7
THA,KHM,2021.0,6,2,4
JPN,LKA,2022.0,3,1,2
CHL,SWE,2011.0,3,6,-3
MWI,KEN,2013.0,2,1,1
LBR,USA,2019.0,4,8,-4
AUT,ARE,2018.0,2,1,1
KWT,AUS,2013.0,2,3,-1
FRA,COG,2004.0,2,1,1
SVN,HRV,2007.0,5,2,3
CHN,CMR,2018.0,1,4,-3
DEU,PAK,1999.0,2,1,1
FRA,BLR,2004.0,2,1,1
GRC,ITA,1998.0,6,8,-2
IND,MYS,1998.0,2,1,1
PAN,AUS,2003.0,1,1,0
JOR,GBR,2004.0,2,8,-6
NOR,ARG,2011.0,1,1,0
AUT,ISR,2014.0,5,2,3
AUT,PRT,2015.0,4,6,-2
CZE,ESP,2005.0,2,3,-1
ZAF,NZL,2005.0,9,3,6
CAN,UKR,2015.0,1,4,-3
CHE,EST,2017.0,1,4,-3
NGA,COG,2018.0,1,1,0
CHE,SWE,1998.0,3,4,-1
BEL,NZL,2010.0,3,3,0
CMR,ZAF,2009.0,3,1,2
PRY,BRA,2012.0,1,2,-1
AUS,EGY,2018.0,7,12,-5
BEL,KOR,2012.0,3,7,-4
USA,IRQ,2012.0,2,8,-6
CIV,GBR,2022.0,1,1,0
PYF,FRA,2007.0,4,3,1
IND,MYS,1997.0,1,1,0
DNK,JPN,2007.0,9,9,0
LVA,SWE,2001.0,2,1,1
KEN,UGA,2012.0,1,2,-1
USA,PER,2000.0,4,2,2
KEN,CMR,2017.0,1,3,-2
BRA,HUN,2019.0,1,1,0
SYR,DEU,2016.0,1,1,0
NZL,ZAF,2005.0,3,9,-6
NPL,JPN,2021.0,1,7,-6
FIN,ARG,2004.0,2,1,1
NOR,MYS,2015.0,1,1,0
RUS,IND,2010.0,4,1,3
SAU,DZA,1999.0,1,1,0
ESP,CZE,2001.0,1,5,-4
MWI,AUS,2017.0,1,1,0
AUS,BGR,2004.0,1,1,0
BEL,MYS,2017.0,2,2,0
IRN,CZE,2016.0,4,2,2
ZWE,USA,2019.0,7,8,-1
NLD,BEN,2016.0,4,1,3
UKR,CHE,2019.0,3,1,2
LUX,CHN,2021.0,3,3,0
PAK,NOR,2021.0,1,2,-1
RUS,SRB,2014.0,2,1,1
TWN,SWE,2017.0,3,5,-2
CHE,ZMB,2017.0,3,1,2
IRN,AFG,2021.0,2,2,0
DNK,MYS,2012.0,1,2,-1
JOR,ESP,2010.0,1,1,0
MAR,USA,2013.0,3,4,-1
RWA,ZWE,2015.0,1,1,0
SVN,NLD,2012.0,2,1,1
ARM,RUS,2008.0,2,3,-1
EST,CHE,2021.0,2,2,0
FRA,ETH,2015.0,1,1,0
IRQ,ARE,2019.0,1,1,0
DEU,HRV,2001.0,4,10,-6
CAN,VEN,2012.0,2,3,-1
HKG,BEL,2008.0,1,2,-1
ARG,JPN,2013.0,1,3,-2
CYP,DEU,1998.0,1,1,0
IND,CHL,2013.0,2,1,1
MAR,CHE,2001.0,1,2,-1
KWT,IND,2007.0,1,9,-8
BEL,LTU,2013.0,2,4,-2
JPN,TZA,2009.0,4,2,2
GBR,SVK,2007.0,2,2,0
FRA,URY,2001.0,1,1,0
BGR,RUS,2007.0,2,1,1
MYS,UZB,2007.0,1,2,-1
AUT,GRC,2010.0,3,4,-1
MEX,RUS,2016.0,2,5,-3
SWE,CYP,2014.0,1,3,-2
SWE,SVN,2019.0,3,3,0
UKR,MEX,2012.0,1,1,0
TUR,HRV,2007.0,1,1,0
KOR,SLB,2020.0,1,1,0
THA,PRT,2008.0,1,2,-1
NPL,KOR,2017.0,2,7,-5
GBR,SWZ,2014.0,1,1,0
IRL,SVN,2019.0,1,1,0
CHL,AUT,2012.0,3,2,1
FRA,PHL,2022.0,1,1,0
RWA,GBR,2017.0,1,1,0
GRC,ITA,1997.0,4,2,2
AUS,SGP,1998.0,4,5,-1
MYS,IND,1999.0,1,7,-6
UKR,ESP,2019.0,1,1,0
PRY,ARG,2021.0,1,1,0
HRV,CZE,2019.0,3,1,2
NLD,RWA,2014.0,2,2,0
URY,ITA,2021.0,1,1,0
KGZ,TUR,2011.0,1,3,-2
IRN,HKG,2018.0,4,1,3
DEU,URY,2022.0,1,1,0
AUT,CHN,2006.0,2,7,-5
LBN,CAN,2002.0,2,3,-1
GBR,TZA,2016.0,4,6,-2
PRT,ZAF,2013.0,1,1,0
PHL,BGD,2021.0,1,1,0
BEL,NZL,2019.0,1,6,-5
CMR,BEN,2018.0,1,1,0
VNM,MYS,2018.0,1,10,-9
POL,LTU,2021.0,1,3,-2
COL,NOR,2005.0,1,1,0
LTU,DEU,2005.0,5,8,-3
LKA,THA,2004.0,1,1,0
CZE,ESP,2002.0,1,1,0
AUS,ARG,1998.0,1,1,0
SAU,KWT,2009.0,1,1,0
USA,PRY,2007.0,1,2,-1
HUN,AUS,2015.0,1,3,-2
LTU,SWE,2008.0,3,4,-1
HRV,CAN,2018.0,1,2,-1
LUX,BRA,2021.0,2,3,-1
PAK,JOR,2022.0,1,1,0
SVK,IND,2011.0,1,1,0
SGP,AUT,2012.0,3,7,-4
HKG,LKA,2013.0,1,1,0
ARG,RUS,2001.0,4,2,2
MAC,SGP,2011.0,1,1,0
NLD,ZWE,2003.0,1,1,0
URY,ESP,2021.0,5,7,-2
SWE,NPL,2017.0,2,3,-1
EGY,AUT,2011.0,1,4,-3
NER,FRA,2021.0,2,2,0
CAN,COG,2021.0,1,1,0
COL,SWE,2021.0,3,1,2
JOR,HUN,2021.0,2,3,-1
CHE,LVA,2008.0,1,1,0
MLI,USA,2006.0,2,3,-1
COL,RUS,2000.0,1,2,-1
URY,PRT,2005.0,1,1,0
BGR,ESP,2016.0,3,5,-2
PSE,DEU,2012.0,2,4,-2
CAN,PRT,2012.0,5,8,-3
FRA,SRB,2021.0,3,4,-1
HRV,CZE,2017.0,1,3,-2
NLD,EGY,2005.0,2,1,1
PAN,USA,2000.0,1,1,0
USA,ARM,2020.0,3,3,0
NLD,UGA,2014.0,3,4,-1
IDN,ITA,2020.0,2,2,0
DEU,ARG,1997.0,1,5,-4
SGP,NOR,2018.0,3,3,0
MDA,USA,2004.0,3,1,2
DEU,IRQ,2007.0,1,1,0
SWE,GHA,2011.0,1,1,0
FIN,IRQ,2018.0,1,1,0
CAN,CMR,2007.0,2,1,1
BEN,CMR,2017.0,2,1,1
BGD,NLD,2010.0,2,1,1
BGD,NLD,2019.0,3,5,-2
ETH,BEL,2014.0,4,2,2
NLD,VEN,2017.0,1,1,0
MLT,ESP,2015.0,1,2,-1
NZL,MYS,2020.0,3,14,-11
KWT,EGY,2022.0,2,5,-3
ZAF,SGP,2017.0,1,1,0
OMN,EGY,2006.0,1,1,0
MEX,UKR,2020.0,1,1,0
DEU,VEN,2014.0,4,1,3
DEU,LKA,2011.0,2,1,1
GBR,ZMB,2011.0,1,2,-1
CHN,SYR,2019.0,1,2,-1
CHE,NOR,2002.0,2,6,-4
IRN,ARE,2008.0,1,1,0
TZA,BWA,2005.0,1,1,0
BEL,PAK,2002.0,1,1,0
SRB,SVN,2011.0,3,5,-2
JOR,ESP,2017.0,1,1,0
GBR,ZWE,2022.0,2,1,1
NOR,TWN,2016.0,2,2,0
PRT,ARE,2016.0,1,1,0
LAO,CHE,2006.0,1,1,0
ZAF,BRA,2022.0,4,2,2
NOR,JPN,2007.0,2,3,-1
BLR,POL,2009.0,1,2,-1
RUS,IRQ,2021.0,1,2,-1
NCL,AUS,2008.0,2,1,1
AUT,MEX,2013.0,1,5,-4
TUN,GBR,2010.0,1,3,-2
FRA,TZA,2016.0,1,2,-1
BGR,JPN,2012.0,2,2,0
USA,MNG,2020.0,2,2,0
THA,SWE,2004.0,2,2,0
MEX,CHL,2001.0,2,3,-1
PSE,ISR,2004.0,1,2,-1
SEN,CIV,2017.0,1,1,0
MAR,CHN,2020.0,3,1,2
THA,NOR,2012.0,1,1,0
AUT,PHL,2008.0,2,1,1
CAN,JOR,1999.0,1,1,0
ETH,JPN,2021.0,1,2,-1
PAN,BRA,2022.0,1,1,0
BEN,CMR,2019.0,2,1,1
HUN,IRQ,2021.0,1,7,-6
DNK,HRV,2019.0,1,2,-1
ETH,BRA,2019.0,1,1,0
BGD,SWE,2013.0,2,2,0
ZAF,SGP,2019.0,1,2,-1
IRQ,IND,2014.0,2,5,-3
JOR,KWT,2012.0,1,2,-1
IDN,FRA,2010.0,1,5,-4
NZL,PNG,2019.0,1,1,0
AUT,BRA,1999.0,1,1,0
BOL,FRA,2004.0,1,3,-2
TUR,TWN,2006.0,1,2,-1
LKA,NLD,2003.0,1,1,0
KNA,GBR,2015.0,1,1,0
UKR,BGR,2002.0,1,1,0
BRA,SRB,2006.0,1,3,-2
URY,CHN,2020.0,1,1,0
QAT,HRV,2019.0,1,1,0
KOR,BLR,2003.0,1,2,-1
TUR,CHN,2014.0,1,4,-3
SEN,DEU,2019.0,1,1,0
TUR,CHE,2001.0,1,3,-2
DNK,IND,2008.0,2,7,-5
MAR,ZAF,2013.0,1,1,0
CHE,BGR,2007.0,1,1,0
TTO,AUS,2010.0,1,1,0
GBR,BWA,2022.0,2,2,0
BGR,CHN,2015.0,1,1,0
BEL,SGP,2002.0,1,1,0
BIH,CZE,2014.0,1,1,0
PRT,POL,2004.0,1,1,0
ZAF,NAM,2009.0,1,1,0
ESP,COL,1999.0,1,1,0
NLD,MWI,2020.0,1,1,0
CHN,ECU,2021.0,1,2,-1
HRV,EGY,2018.0,1,1,0
OMN,CAN,2005.0,1,4,-3
ITA,COG,2010.0,1,1,0
AUS,SRB,2021.0,1,3,-2
USA,KOR,2011.0,874,692,182
PAK,GBR,2008.0,41,28,13
FRA,CAN,2003.0,206,142,64
USA,SWE,2013.0,207,171,36
SAU,USA,2021.0,92,206,-114
ESP,FRA,2015.0,289,179,110
ESP,CUB,2005.0,13,20,-7
IRL,FRA,2014.0,38,23,15
SAU,CAN,2022.0,19,36,-17
CHN,ZAF,2001.0,8,2,6
SGP,NZL,2017.0,9,15,-6
FRA,COL,2016.0,24,20,4
FJI,IND,2017.0,3,3,0
COL,CAN,2020.0,18,17,1
USA,FIN,2019.0,86,71,15
SAU,FRA,2016.0,14,54,-40
ITA,PAK,2018.0,20,12,8
SWE,GBR,2022.0,53,55,-2
CHE,HKG,2016.0,8,9,-1
CHE,IRL,2018.0,17,11,6
ITA,TUN,2012.0,3,3,0
CHE,ROU,2021.0,3,3,0
ITA,GBR,1999.0,93,66,27
SWE,NOR,2016.0,71,36,35
CIV,FRA,2016.0,8,31,-23
KOR,BGD,2013.0,26,13,13
THA,MYS,2003.0,1,1,0
CHN,CHE,2008.0,24,22,2
TWN,IND,2008.0,15,47,-32
SGP,THA,2020.0,7,7,0
DEU,AUS,2003.0,69,78,-9
ECU,ARG,2018.0,4,7,-3
PRT,IND,2010.0,5,21,-16
VEN,BRA,2019.0,7,5,2
NZL,CHE,2008.0,4,5,-1
EGY,LBN,2022.0,1,2,-1
BRA,GBR,2011.0,52,60,-8
TUN,BEL,2017.0,5,2,3
CAN,NZL,2013.0,38,33,5
FRA,MDG,2012.0,10,6,4
POL,NLD,2005.0,10,3,7
MTQ,FRA,2000.0,8,1,7
FIN,DNK,2013.0,9,12,-3
HKG,RUS,2007.0,1,1,0
DEU,SVK,2015.0,6,10,-4
POL,BEL,2015.0,13,9,4
NLD,LTU,2018.0,2,3,-1
SWE,RUS,2010.0,15,12,3
HUN,ARE,2004.0,3,1,2
BRA,SWE,2007.0,9,8,1
ITA,CHE,1997.0,22,27,-5
USA,KNA,2012.0,3,1,2
DNK,RUS,2000.0,3,4,-1
CAN,TWN,2007.0,13,11,2
KEN,AUS,2011.0,5,2,3
THA,AUT,2010.0,4,3,1
RUS,JPN,2015.0,17,11,6
USA,MAC,2018.0,13,9,4
EGY,IND,2016.0,4,5,-1
LTU,BEL,2018.0,2,7,-5
NOR,KOR,2020.0,3,11,-8
TWN,GBR,2022.0,9,13,-4
ITA,DZA,2020.0,2,5,-3
USA,BOL,2020.0,5,4,1
TUR,ROU,2003.0,1,2,-1
BGR,USA,2009.0,12,4,8
IRN,HUN,2021.0,5,3,2
KAZ,SGP,2021.0,1,1,0
SVK,NLD,2010.0,5,2,3
IRQ,AUS,2018.0,9,9,0
CHN,IND,2001.0,5,5,0
GRC,HUN,2008.0,1,1,0
GRC,CAN,2005.0,7,9,-2
SDN,DEU,2008.0,1,2,-1
FRA,ISR,2012.0,17,21,-4
UKR,NLD,2008.0,4,2,2
DEU,GEO,2003.0,3,2,1
EST,NOR,2019.0,4,3,1
USA,CMR,2014.0,10,3,7
ISR,ITA,2006.0,8,6,2
CZE,PER,2021.0,1,1,0
NPL,KOR,2019.0,3,3,0
FRA,BGR,2016.0,5,6,-1
USA,CIV,2015.0,1,2,-1
CHN,SYR,2010.0,1,1,0
CAN,IND,1997.0,5,8,-3
KOR,BEL,2006.0,3,5,-2
PRT,EGY,2013.0,2,2,0
ARE,NZL,2007.0,1,1,0
SGP,BEL,2021.0,6,5,1
ARG,URY,2021.0,9,5,4
AUT,SRB,2014.0,2,3,-1
IND,UKR,2016.0,1,1,0
SVK,NLD,2019.0,5,4,1
SAU,SDN,2013.0,4,18,-14
ROU,DEU,2000.0,7,5,2
MAR,EGY,2011.0,1,1,0
BGR,FRA,2005.0,6,3,3
BGR,FRA,2002.0,4,5,-1
OMN,JOR,2004.0,2,1,1
AUS,BGD,2004.0,3,2,1
AUS,SGP,1997.0,3,1,2
EST,SWE,2006.0,3,6,-3
ECU,PER,2014.0,2,1,1
CHE,NZL,2003.0,5,7,-2
SWE,CHL,2012.0,3,3,0
NZL,AUT,2009.0,2,2,0
ZWE,USA,2010.0,6,3,3
ZWE,FRA,2012.0,1,1,0
BRA,SAU,2016.0,2,1,1
FJI,IND,2019.0,1,3,-2
URY,CHL,2018.0,3,3,0
PER,AUS,2015.0,2,1,1
MDA,RUS,2015.0,2,5,-3
NZL,SAU,2015.0,1,2,-1
KEN,BEL,2020.0,4,4,0
EST,ARM,2016.0,1,1,0
LBN,CAN,2005.0,2,2,0
CRI,FRA,2015.0,1,2,-1
VNM,DNK,2012.0,1,4,-3
LIE,DEU,2018.0,1,1,0
NGA,PHL,2020.0,1,1,0
IND,KWT,2009.0,8,3,5
TUR,MYS,2016.0,1,4,-3
MLI,SEN,2014.0,2,2,0
GBR,SVN,2015.0,5,10,-5
ROU,MDA,2017.0,2,5,-3
CIV,USA,2016.0,2,2,0
FRA,HKG,2006.0,3,3,0
CHL,UKR,2003.0,1,1,0
BEL,CUB,2012.0,1,2,-1
PAN,GBR,2012.0,1,1,0
BRA,HUN,2017.0,1,4,-3
ZAF,CHL,2021.0,3,2,1
CHL,DNK,2013.0,1,2,-1
SVK,IRN,2020.0,1,5,-4
IND,IDN,2021.0,2,1,1
THA,IND,2001.0,2,1,1
ESP,JOR,2012.0,1,1,0
CZE,BRA,2004.0,1,2,-1
TUN,SYR,2018.0,1,1,0
ROU,AUS,2004.0,1,1,0
OMN,CAN,2002.0,2,3,-1
ECU,ITA,2015.0,1,5,-4
GRC,KWT,2017.0,2,1,1
ISR,ARG,2017.0,1,1,0
NLD,MAR,2014.0,1,2,-1
TTO,AUS,2017.0,1,1,0
ESP,CYP,2021.0,1,1,0
KWT,CAN,2001.0,1,1,0
ESP,DZA,2015.0,2,1,1
HKG,NLD,2000.0,1,1,0
SAU,SGP,2015.0,1,8,-7
SVN,AUS,2010.0,1,1,0
PER,VEN,2020.0,1,6,-5
CHN,,2012.0,36590,0,36590
,CZE,2004.0,2103,0,2103
NLD,,2024.0,44774,0,44774
,FRA,2000.0,17932,0,17932
MEX,,2011.0,1430,0,1430
,HUN,2005.0,1408,0,1408
,JPN,2007.0,24177,0,24177
ITA,,2009.0,5792,0,5792
NOR,,2017.0,1345,0,1345
SWE,,2012.0,2003,0,2003
,BRA,2002.0,9832,0,9832
,THA,2003.0,1583,0,1583
DZA,,2024.0,6896,0,6896
NOR,,2010.0,664,0,664
,TWN,2007.0,7134,0,7134
FRA,,2014.0,8913,0,8913
EGY,,2020.0,2441,0,2441
GUY,,2014.0,5,0,5
,RUS,2009.0,8307,0,8307
USA,,2007.0,37742,0,37742
,CHE,2006.0,3711,0,3711
NOR,,2019.0,1813,0,1813
,NGA,1998.0,787,0,787
IND,,2012.0,6816,0,6816
,HUN,2002.0,1277,0,1277
,DEU,2015.0,22846,0,22846
,BRA,2005.0,15386,0,15386
GRC,,2022.0,4215,0,4215
OMN,,2013.0,73,0,73
MDA,,2011.0,28,0,28
MAR,,2023.0,4308,0,4308
,MNE,2004.0,16,0,16
,TTO,2001.0,63,0,63
GHA,,2013.0,66,0,66
,NGA,1997.0,155,0,155
ARG,,2008.0,644,0,644
,ITA,2015.0,13493,0,13493
,LKA,2019.0,266,0,266
NPL,,2024.0,1900,0,1900
GEO,,2021.0,219,0,219
,IRL,2000.0,1097,0,1097
,LTU,2006.0,719,0,719
TWN,,2000.0,83,0,83
FRA,NAM,2010.0,1,0,1
,CZE,1996.0,1182,0,1182
,UGA,2006.0,234,0,234
MUS,,2022.0,78,0,78
ROU,,2020.0,1804,0,1804
CMR,MYS,2014.0,1,0,1
,AUT,2013.0,2645,0,2645
,GLP,2004.0,15,0,15
,PRY,2004.0,16,0,16
,SVK,2009.0,946,0,946
,BEL,2011.0,3504,0,3504
,JAM,1998.0,69,0,69
IDN,,2018.0,610,0,610
,CMR,1997.0,31,0,31
BEL,MWI,2010.0,1,0,1
GRL,NOR,2011.0,1,0,1
,NZL,2014.0,1473,0,1473
,LKA,2010.0,172,0,172
,KAZ,2011.0,1173,0,1173
,LVA,2008.0,249,0,249
TZA,PRY,2015.0,1,0,1
,RWA,2011.0,98,0,98
ITA,ZMB,2017.0,1,0,1
SAU,QAT,2014.0,8,0,8
RWA,,2018.0,38,0,38
SYR,,2022.0,169,0,169
URY,,2021.0,316,0,316
BLR,,2025.0,2,0,2
MCO,,2021.0,20,0,20
,LKA,2017.0,362,0,362
THA,,2004.0,143,0,143
HTI,,2022.0,34,0,34
,LUX,2016.0,120,0,120
BRN,,2024.0,260,0,260
,KEN,2015.0,462,0,462
,DOM,2009.0,9,0,9
GIN,,2020.0,13,0,13
VNM,IRQ,2022.0,1,0,1
MDG,,2022.0,162,0,162
CHN,PRI,2013.0,2,0,2
AGO,,2023.0,45,0,45
JOR,ESP,2019.0,2,0,2
,OMN,2018.0,172,0,172
UKR,,2004.0,527,0,527
DNK,,1999.0,32,0,32
GBR,MNG,2016.0,1,0,1
,AZE,2003.0,119,0,119
,URY,2007.0,221,0,221
CAN,EST,2013.0,2,0,2
MAC,,2014.0,33,0,33
POL,MKD,2020.0,2,0,2
ARE,,2007.0,49,0,49
CHN,YEM,2004.0,1,0,1
PRI,,2013.0,107,0,107
,BRN,1999.0,12,0,12
ARG,SAU,2022.0,1,0,1
HKG,,2001.0,41,0,41
NCL,,2018.0,29,0,29
PLW,USA,2020.0,1,0,1
POL,EST,2016.0,1,0,1
GBR,MMR,2018.0,1,0,1
SWE,LUX,2022.0,3,0,3
NLD,CUW,2018.0,1,0,1
DNK,TWN,2021.0,1,0,1
CHL,,2006.0,199,0,199
NZL,SEN,2022.0,1,0,1
ETH,ARE,2022.0,1,0,1
CYP,ARE,2022.0,2,0,2
ITA,MAR,2016.0,5,0,5
,LBY,2003.0,36,0,36
EGY,IRL,2006.0,1,0,1
BEL,COD,2019.0,11,0,11
ARM,,2003.0,43,0,43
SVN,AUS,2019.0,6,0,6
,IRQ,1997.0,5,0,5
ESP,FIN,2000.0,3,0,3
LBY,BHR,2018.0,1,0,1
,MKD,1994.0,32,0,32
,CMR,1998.0,115,0,115
IRL,DZA,2017.0,1,0,1
CZE,,2000.0,64,0,64
CUB,,2000.0,53,0,53
COM,,2021.0,1,0,1
BOL,,2004.0,2,0,2
LBN,,2006.0,37,0,37
,COG,2005.0,50,0,50
YEM,SAU,2003.0,1,0,1
IRL,MCO,2019.0,1,0,1
BGR,CHL,2001.0,1,0,1
,IRQ,1998.0,44,0,44
LTU,NGA,2002.0,1,0,1
LKA,AUS,2005.0,3,0,3
BRA,MWI,2004.0,1,0,1
AUS,KOR,1998.0,3,0,3
RUS,LVA,2002.0,1,0,1
CAN,SUR,2009.0,1,0,1
CZE,ISR,1998.0,1,0,1
KGZ,GBR,2001.0,1,0,1
USA,BHR,1999.0,1,0,1
NZL,,2025.0,3,0,3
EGY,BHR,2006.0,3,0,3
MLI,GBR,2000.0,1,0,1
GRD,DEU,2005.0,1,0,1
ARG,POL,2001.0,1,0,1
ALB,NLD,2010.0,2,0,2
,JAM,1997.0,9,0,9
FRO,,2023.0,24,0,24
GBR,UKR,1997.0,5,0,5
AUS,LBN,2018.0,4,0,4
,MNG,2003.0,24,0,24
LVA,,2000.0,7,0,7
IND,ZAF,1999.0,2,0,2
ZMB,,2011.0,11,0,11
IND,KEN,2008.0,1,0,1
CYP,,2015.0,65,0,65
JPN,JOR,2012.0,3,0,3
NZL,OMN,2011.0,2,0,2
JOR,ZAF,2016.0,1,0,1
SRB,CHN,2012.0,8,0,8
,SWZ,2002.0,8,0,8
KWT,BEL,2011.0,1,0,1
KOR,ITA,2008.0,5,0,5
ARG,LBN,2016.0,1,0,1
RUS,HUN,2020.0,3,0,3
DNK,JOR,2018.0,3,0,3
SWE,NPL,2019.0,1,0,1
NAM,AUS,2019.0,2,0,2
MYS,SEN,2013.0,1,0,1
FIN,KAZ,2022.0,1,0,1
TTO,KWT,2011.0,1,0,1
ASM,USA,2020.0,2,0,2
,MNE,1996.0,2,0,2
CMR,NLD,2006.0,2,0,2
AUS,LBY,2012.0,1,0,1
POL,SVN,2019.0,2,0,2
LBN,QAT,2017.0,3,0,3
,COG,2002.0,45,0,45
JOR,OMN,2022.0,2,0,2
NLD,BDI,2013.0,1,0,1
AUT,BRN,2015.0,1,0,1
BGD,ETH,2012.0,1,0,1
IRN,PAK,2009.0,3,0,3
CAN,MLT,2022.0,1,0,1
LBY,IND,2020.0,3,0,3
BLR,EST,2021.0,1,0,1
PRI,GBR,2021.0,1,0,1
SWE,SRB,2015.0,5,0,5
ITA,SLE,2018.0,1,0,1
LKA,AUS,2002.0,2,0,2
NPL,NZL,2015.0,4,0,4
LBY,LBN,2016.0,1,0,1
CMR,AUT,2009.0,1,0,1
,MCO,2001.0,12,0,12
ITA,OMN,2017.0,2,0,2
PHL,KEN,2008.0,1,0,1
,ERI,2000.0,5,0,5
FRA,PER,2007.0,4,0,4
OMN,NLD,2012.0,2,0,2
BHR,BRN,1997.0,1,0,1
TZA,JOR,2019.0,1,0,1
CHL,GTM,2018.0,1,0,1
IDN,GBR,1997.0,1,0,1
CZE,SAU,2008.0,1,0,1
MUS,IND,2014.0,2,0,2
ALB,,2005.0,3,0,3
PSE,,2009.0,11,0,11
TGO,NLD,2014.0,2,0,2
GBR,BEN,2004.0,2,0,2
CHE,NPL,2011.0,3,0,3
TTO,AUS,2019.0,1,0,1
GRC,GHA,2018.0,1,0,1
SVK,MYS,2017.0,1,0,1
IRL,MEX,2014.0,5,0,5
NLD,MKD,2015.0,2,0,2
ITA,COG,2019.0,2,0,2
KEN,PHL,2015.0,1,0,1
GNQ,,2021.0,4,0,4
KOR,JOR,2022.0,1,0,1
HUN,EGY,2012.0,1,0,1
PAK,MAR,2018.0,1,0,1
TKM,CHN,2015.0,4,0,4
SVK,IRL,2008.0,2,0,2
SRB,NOR,2007.0,1,0,1
ZAF,TWN,2004.0,2,0,2
ZWE,TZA,2003.0,2,0,2
ISR,HUN,2007.0,3,0,3
PRT,AGO,2005.0,1,0,1
SUR,NLD,2007.0,1,0,1
CAN,ECU,2017.0,2,0,2
LAO,GBR,2019.0,3,0,3
TCD,CHE,2005.0,2,0,2
OMN,LBN,2016.0,1,0,1
,TJK,2001.0,6,0,6
KOR,ARE,2010.0,1,0,1
DEU,QAT,2009.0,1,0,1
IRN,SVK,2018.0,2,0,2
HUN,ECU,2022.0,1,0,1
ITA,JOR,2007.0,1,0,1
,GLP,1996.0,4,0,4
PYF,,2008.0,3,0,3
NZL,MEX,2005.0,2,0,2
IND,PRI,2002.0,2,0,2
MWI,NOR,2022.0,1,0,1
NLD,VEN,2010.0,1,0,1
GBR,GTM,2012.0,1,0,1
MEX,BOL,2018.0,1,0,1
GRC,DZA,2015.0,1,0,1
POL,PRT,2014.0,2,0,2
IND,LTU,2015.0,1,0,1
LBN,ARE,2015.0,4,0,4
RUS,HND,2021.0,1,0,1
ISR,FIN,2008.0,2,0,2
AUT,PSE,2014.0,1,0,1
PRY,JPN,2010.0,1,0,1
BFA,COG,2012.0,1,0,1
ZMB,CHE,2003.0,1,0,1
LTU,BLR,2012.0,2,0,2
IRN,ZAF,2001.0,1,0,1
GHA,PHL,2008.0,1,0,1
BFA,TUN,2011.0,1,0,1
TUN,MLI,2013.0,1,0,1
NPL,FJI,1999.0,1,0,1
DJI,,2014.0,3,0,3
SRB,USA,1998.0,3,0,3
ECU,SWE,2005.0,2,0,2
KWT,THA,2020.0,1,0,1
NIU,NLD,2008.0,1,0,1
HUN,ISL,2016.0,1,0,1
SLE,GBR,2008.0,1,0,1
NOR,ROU,2004.0,2,0,2
NGA,KEN,2003.0,1,0,1
IND,AUT,1999.0,3,0,3
SAU,CZE,2005.0,1,0,1
BRB,GBR,2022.0,1,0,1
LKA,DNK,2009.0,2,0,2
SVN,BIH,2004.0,1,0,1
NZL,PNG,2010.0,2,0,2
GBR,GRL,2007.0,2,0,2
AUS,VEN,2022.0,1,0,1
JPN,MAR,2012.0,3,0,3
ARG,ECU,2011.0,2,0,2
NZL,QAT,2011.0,1,0,1
KOR,LKA,2005.0,1,0,1
ARG,AUT,2005.0,2,0,2
PHL,DNK,2012.0,1,0,1
MDG,CHN,2012.0,1,0,1
JPN,KAZ,2012.0,3,0,3
BWA,THA,2014.0,1,0,1
IND,MLT,2021.0,1,0,1
MYS,VNM,2015.0,2,0,2
MAR,KWT,2018.0,1,0,1
ZAF,LKA,2016.0,1,0,1
NLD,VEN,2019.0,1,0,1
PHL,RUS,2020.0,4,0,4
ITA,SVK,2016.0,2,0,2
TUN,GBR,2019.0,2,0,2
NLD,LKA,2020.0,1,0,1
MEX,DZA,2021.0,1,0,1
NLD,QAT,2013.0,3,0,3
AUS,PAK,2000.0,1,0,1
ETH,UGA,2011.0,1,0,1
PRI,BRA,2001.0,1,0,1
SWZ,GBR,2003.0,1,0,1
CIV,SWE,2022.0,1,0,1
BEL,COD,2010.0,1,0,1
GBR,SDN,2011.0,4,0,4
IRN,QAT,2017.0,3,0,3
CHL,TWN,2006.0,1,0,1
COG,MUS,2018.0,1,0,1
POL,LBN,2013.0,1,0,1
,SWZ,2005.0,4,0,4
NLD,EST,2000.0,1,0,1
ABW,BEL,2017.0,1,0,1
OMN,DZA,2014.0,1,0,1
ITA,SAU,2001.0,2,0,2
RUS,ZAF,2005.0,1,0,1
SDN,MYS,2007.0,1,0,1
SEN,TGO,2006.0,1,0,1
ROU,MDA,2010.0,2,0,2
JPN,MRT,2012.0,1,0,1
KGZ,DEU,2008.0,1,0,1
COD,CMR,2019.0,1,0,1
IRN,TWN,2009.0,2,0,2
UZB,KOR,2001.0,2,0,2
BLR,CAN,2007.0,4,0,4
USA,LBR,2012.0,2,0,2
PRT,CYP,2016.0,1,0,1
IRL,BGR,2019.0,2,0,2
ZWE,KOR,2014.0,1,0,1
CZE,CYP,2018.0,1,0,1
KOR,HUN,2012.0,1,0,1
MDG,CAN,2020.0,1,0,1
SUR,USA,2017.0,1,0,1
LBN,JPN,2019.0,2,0,2
IND,GRC,2022.0,1,0,1
SAU,PRT,2022.0,1,0,1
KEN,LKA,2006.0,1,0,1
HKG,PHL,2006.0,1,0,1
IRL,QAT,2018.0,3,0,3
GBR,GAB,2007.0,1,0,1
SYR,AUS,2014.0,2,0,2
CUB,NZL,2011.0,1,0,1
MNE,AUT,2014.0,1,0,1
NPL,BGD,2005.0,2,0,2
BMU,USA,2020.0,1,0,1
AUS,TUR,2006.0,4,0,4
MWI,NGA,2005.0,1,0,1
BOL,ESP,2007.0,3,0,3
ARG,HUN,1997.0,1,0,1
CZE,ZAF,2007.0,1,0,1
CZE,TWN,2001.0,2,0,2
SVN,DNK,2018.0,2,0,2
CHN,TUN,2011.0,1,0,1
NIC,CRI,2014.0,1,0,1
KWT,IRQ,2014.0,1,0,1
IRN,QAT,2019.0,3,0,3
THA,MNG,2018.0,1,0,1
DEU,PRK,2011.0,1,0,1
ZWE,FJI,2020.0,1,0,1
NPL,KHM,2009.0,1,0,1
PRT,MAC,2016.0,5,0,5
JOR,DZA,2020.0,2,0,2
USA,MUS,2013.0,3,0,3
MDA,FIN,2001.0,2,0,2
ZAF,FJI,2004.0,1,0,1
VEN,PRT,2019.0,1,0,1
ZAF,SRB,2006.0,1,0,1
NLD,LBY,2004.0,1,0,1
FLK,NZL,2008.0,1,0,1
PHL,ITA,2016.0,2,0,2
DEU,PRI,1997.0,1,0,1
PER,PAN,2015.0,1,0,1
MAR,LBN,2012.0,1,0,1
COL,ARE,2019.0,2,0,2
NZL,IRQ,2016.0,1,0,1
CUB,COL,2015.0,6,0,6
CZE,EGY,2006.0,3,0,3
MDG,CHE,2015.0,1,0,1
MLI,CMR,2009.0,4,0,4
SGP,ITA,2001.0,1,0,1
GBR,MAR,1998.0,1,0,1
GUM,BEL,2007.0,1,0,1
ITA,OMN,2010.0,1,0,1
BWA,NGA,2005.0,1,0,1
TUN,ETH,2012.0,1,0,1
LBN,JOR,2002.0,1,0,1
JPN,UZB,2006.0,1,0,1
CHE,CIV,2005.0,3,0,3
ITA,MUS,2018.0,1,0,1
GEO,AUT,2004.0,1,0,1
BRA,LBN,2018.0,1,0,1
AUS,JOR,2002.0,3,0,3
KHM,,2005.0,2,0,2
EGY,NGA,2004.0,1,0,1
NPL,FRA,2002.0,1,0,1
BOL,NLD,2005.0,1,0,1
POL,NPL,2008.0,1,0,1
GUF,MDG,2003.0,1,0,1
,REU,2006.0,3,0,3
NPL,NLD,2011.0,2,0,2
,BLZ,2007.0,4,0,4
REU,DOM,2017.0,1,0,1
GBR,BRB,2007.0,1,0,1
ALB,,2002.0,1,0,1
SDN,GRC,2018.0,1,0,1
ERI,ETH,2009.0,1,0,1
ZAF,SGP,2010.0,1,0,1
OMN,CHN,2003.0,1,0,1
KOR,LKA,2002.0,1,0,1
CYP,MYS,2014.0,1,0,1
POL,GRD,2014.0,1,0,1
DEU,BEN,2014.0,2,0,2
IDN,ARE,2016.0,1,0,1
ASM,,2016.0,3,0,3
SYR,NLD,2006.0,1,0,1
COL,FRA,1999.0,3,0,3
EGY,IRN,2006.0,1,0,1
JPN,NIC,2016.0,2,0,2
AGO,USA,2016.0,2,0,2
BWA,KEN,2010.0,1,0,1
MYS,PNG,2015.0,1,0,1
VEN,AUS,2020.0,2,0,2
KOR,DNK,2000.0,1,0,1
LKA,SGP,2016.0,2,0,2
,PRY,1996.0,3,0,3
CYP,IRL,2004.0,1,0,1
ATA,CAN,2006.0,1,0,1
PHL,CHE,2011.0,1,0,1
ITA,PRI,2007.0,1,0,1
VEN,PRT,2017.0,1,0,1
BRA,BLR,2016.0,1,0,1
SWE,SVK,2020.0,1,0,1
NLD,SEN,2017.0,1,0,1
SDN,PAK,2015.0,1,0,1
TWN,EGY,2016.0,1,0,1
BRA,NZL,2004.0,1,0,1
LBN,OMN,2005.0,1,0,1
NZL,CHL,2003.0,1,0,1
JPN,YEM,2010.0,1,0,1
PHL,ISR,2019.0,1,0,1
GIN,COG,2018.0,1,0,1
BRN,BFA,2014.0,1,0,1
USA,HND,2008.0,1,0,1
NGA,OMN,2012.0,1,0,1
,TCA,2007.0,7,0,7
MDV,KEN,2021.0,1,0,1
UKR,TWN,2017.0,1,0,1
SEN,CIV,2019.0,1,0,1
BRA,EST,2020.0,3,0,3
LBY,PAK,2018.0,2,0,2
LBY,DEU,2015.0,2,0,2
NCL,IRL,2018.0,1,0,1
IRN,LTU,2020.0,1,0,1
QAT,BGD,2014.0,1,0,1
ZMB,MWI,2004.0,1,0,1
NGA,CZE,2021.0,1,0,1
HKG,AUT,2003.0,1,0,1
VNM,UKR,2003.0,3,0,3
DZA,REU,2008.0,1,0,1
ETH,RUS,1999.0,2,0,2
PAK,TUR,2002.0,2,0,2
ROU,MYS,2005.0,1,0,1
THA,AUS,1998.0,2,0,2
SRB,USA,1997.0,3,0,3
BEL,NAM,2016.0,1,0,1
MEX,TWN,2003.0,1,0,1
VEN,CHE,2013.0,1,0,1
COG,ZWE,2016.0,1,0,1
ALB,NLD,2017.0,1,0,1
GBR,GUY,2017.0,1,0,1
PRT,SGP,2012.0,1,0,1
CHN,BDI,2016.0,1,0,1
EST,NOR,2010.0,1,0,1
JPN,NCL,2009.0,1,0,1
TUR,ISL,2017.0,1,0,1
USA,MNP,2013.0,1,0,1
,MNP,2013.0,1,0,1
USA,SUR,2016.0,1,0,1
GUY,NLD,2021.0,1,0,1
MAC,MYS,2010.0,1,0,1
UKR,ESP,2010.0,2,0,2
BRA,MDG,2008.0,1,0,1
POL,KEN,2016.0,1,0,1
AGO,HRV,2017.0,1,0,1
ISL,DEU,1997.0,1,0,1
CHE,COG,2008.0,1,0,1
RUS,OMN,2013.0,1,0,1
EST,NOR,2017.0,1,0,1
BGR,NOR,2014.0,2,0,2
GHA,HKG,2016.0,3,0,3
GBR,CPV,2021.0,1,0,1
DEU,TJK,2003.0,1,0,1
PYF,USA,2000.0,1,0,1
ETH,ISR,2003.0,2,0,2
AUT,MNG,2005.0,1,0,1
ISR,COL,1999.0,1,0,1
IRN,COL,2015.0,2,0,2
CMR,MDG,2022.0,1,0,1
AZE,BLR,2016.0,1,0,1
CIV,SEN,2014.0,1,0,1
NZL,POL,2007.0,1,0,1
NAM,CAN,2018.0,1,0,1
CUB,GLP,1999.0,1,0,1
BLR,VNM,2019.0,2,0,2
COL,ROU,2019.0,1,0,1
ITA,MMR,2018.0,1,0,1
DNK,PRI,2018.0,1,0,1
,LBR,2004.0,1,0,1
HRV,MNE,2015.0,2,0,2
MUS,THA,2019.0,1,0,1
ARM,MEX,2016.0,1,0,1
UKR,KOR,1998.0,2,0,2
MAR,TWN,2008.0,1,0,1
CHN,MUS,2020.0,4,0,4
MAC,IRL,1999.0,1,0,1
IND,BWA,2013.0,1,0,1
ISR,BRA,2007.0,1,0,1
CHN,COM,2020.0,1,0,1
RWA,CHE,2022.0,1,0,1
AUS,KNA,2014.0,1,0,1
IDN,NZL,2022.0,1,0,1
ARM,ITA,1998.0,1,0,1
,AUS,2020.0,1,0,1
BGR,SWE,2002.0,2,0,2
UZB,ESP,1998.0,1,0,1
UGA,COL,2004.0,2,0,2
JOR,FRA,2009.0,1,0,1
CYP,KAZ,2016.0,1,0,1
HRV,FIN,2009.0,1,0,1
BRA,KNA,2018.0,1,0,1
HKG,REU,2014.0,1,0,1
CMR,IRL,2022.0,1,0,1
AZE,POL,2020.0,1,0,1
SRB,UZB,2019.0,1,0,1
ISL,NCL,2020.0,1,0,1
GHA,NER,2019.0,1,0,1
CHE,CRI,2012.0,1,0,1
ISR,ZWE,2018.0,1,0,1
MRT,NER,2002.0,1,0,1
IRN,SAU,2008.0,1,0,1
USA,ZMB,2001.0,1,0,1
HKG,BLR,2013.0,1,0,1
CHE,PSE,2011.0,1,0,1
CHL,TUR,2013.0,1,0,1
PRI,AUS,2012.0,1,0,1
SYR,HUN,2021.0,2,0,2
PER,NZL,2019.0,1,0,1
KOR,SWE,1999.0,2,0,2
GMB,FRA,2005.0,1,0,1
AUS,PRI,2016.0,1,0,1
DZA,AUT,2012.0,1,0,1
BLR,BRA,2012.0,1,0,1
ATA,NLD,2020.0,1,0,1
FRA,GTM,2007.0,1,0,1
BOL,VEN,2006.0,1,0,1
,MDV,1995.0,1,0,1
IRN,SYR,2011.0,1,0,1
BLR,VNM,2017.0,2,0,2
ITA,KNA,2015.0,1,0,1
DEU,MMR,2004.0,1,0,1
NLD,ECU,2014.0,1,0,1
IRQ,OMN,2013.0,1,0,1
LSO,USA,2015.0,1,0,1
CAN,MNG,2017.0,1,0,1
CHE,ZMB,2019.0,1,0,1
BWA,KAZ,2018.0,1,0,1
YEM,USA,2022.0,1,0,1
BGD,KOR,2004.0,2,0,2
EGY,PRY,2022.0,1,0,1
BEN,COD,2022.0,1,0,1
SVN,BGR,2021.0,1,0,1
KOR,ROU,2012.0,1,0,1
BLR,SWE,2022.0,1,0,1
CHN,TGO,2020.0,1,0,1
BEL,LVA,2017.0,1,0,1
MWI,MYS,2015.0,1,0,1
,MAR,2020.0,3,0,3
CHN,BLR,2020.0,2,0,2
CUB,PER,2015.0,1,0,1
KOR,IRL,1999.0,1,0,1
NLD,SEN,2010.0,1,0,1
IND,MUS,2000.0,1,0,1
UKR,DNK,2000.0,1,0,1
BEL,JOR,2002.0,1,0,1
BIH,HRV,1999.0,1,0,1
ZAF,OMN,2013.0,1,0,1
KHM,NCL,2015.0,2,0,2
BHR,TUR,2014.0,1,0,1
BLR,NOR,2011.0,1,0,1
AUS,UKR,1998.0,1,0,1
PRI,ARG,1999.0,1,0,1
SLE,NLD,2021.0,1,0,1
BEL,BDI,2011.0,1,0,1
ZMB,NOR,2013.0,1,0,1
POL,CMR,2014.0,1,0,1
MYS,KWT,2007.0,1,0,1
EGY,BIH,2014.0,1,0,1
CHE,GNQ,2016.0,1,0,1
BTN,JPN,2017.0,1,0,1
CHN,BHS,2020.0,1,0,1
SDN,PSE,2020.0,1,0,1
ISR,JOR,2002.0,2,0,2
NOR,PRT,2001.0,1,0,1
AUS,FLK,2011.0,1,0,1
SRB,BRA,2021.0,1,0,1
CIV,CHE,1999.0,1,0,1
AUT,AGO,2019.0,1,0,1
ERI,GBR,2018.0,1,0,1
AUS,JOR,2005.0,1,0,1
ETH,AUT,2006.0,1,0,1
SGP,GRC,2005.0,1,0,1
BGR,UKR,2018.0,1,0,1
ESP,KEN,2009.0,1,0,1
HKG,TZA,2010.0,1,0,1
NOR,PAK,2003.0,1,0,1
GRC,BHR,2006.0,1,0,1
TUN,MRT,2004.0,1,0,1
CMR,BEL,2008.0,1,0,1
KEN,COD,2016.0,1,0,1
DZA,JOR,2016.0,1,0,1
KGZ,AUS,2020.0,1,0,1
TUN,IND,2005.0,1,0,1
HUN,UKR,2022.0,1,0,1
,COD,1994.0,1,0,1
USA,NAM,2007.0,1,0,1
ITA,FJI,2015.0,1,0,1
ITA,COG,2017.0,1,0,1
MOZ,,2004.0,1,0,1
HKG,SYR,2002.0,1,0,1
MOZ,JOR,2022.0,1,0,1
DEU,HUN,2021.0,13,25,-12
USA,CAN,2009.0,1304,1420,-116
FRA,LUX,2008.0,21,6,15
DEU,NLD,2009.0,224,201,23
JPN,DNK,2012.0,8,3,5
IND,TWN,2010.0,51,25,26
GBR,GRC,2012.0,150,170,-20
USA,ITA,2012.0,381,506,-125
ITA,FRA,2008.0,221,143,78
IRN,USA,2008.0,107,40,67
UKR,FRA,2019.0,16,6,10
USA,SWE,2008.0,151,189,-38
COG,COD,2008.0,4,6,-2
ARG,AUS,2009.0,3,2,1
IRL,ESP,2007.0,9,13,-4
USA,ESP,2010.0,372,361,11
TUR,FRA,2006.0,9,10,-1
LKA,USA,2009.0,9,8,1
NLD,DEU,2012.0,243,207,36
USA,CHE,2011.0,510,418,92
DEU,BEL,2001.0,35,35,0
FRA,BEL,2011.0,167,173,-6
ITA,SWE,2005.0,22,26,-4
CAN,GBR,2013.0,340,327,13
NLD,AUS,2011.0,61,51,10
ESP,USA,2011.0,465,400,65
NLD,USA,2004.0,239,236,3
TWN,CAN,2011.0,16,15,1
NZL,CHN,2014.0,20,17,3
GBR,RUS,2015.0,45,42,3
NLD,FRA,2008.0,106,69,37
ARG,NLD,2020.0,4,5,-1
CHN,HKG,2013.0,340,389,-49
ISR,GBR,2008.0,36,17,19
GBR,CAN,2022.0,155,134,21
VEN,ECU,2017.0,43,4,39
LAO,THA,2014.0,1,1,0
GBR,ESP,2009.0,223,239,-16
ISL,CHE,2007.0,1,1,0
DEU,CHE,2005.0,408,259,149
PRT,AUS,2021.0,6,7,-1
SVK,CZE,2005.0,27,20,7
FRA,ITA,2014.0,205,311,-106
ARG,MEX,2007.0,8,9,-1
USA,ESP,2017.0,352,529,-177
NZL,AUS,2009.0,157,116,41
ESP,CHE,2017.0,103,65,38
DNK,IND,2013.0,14,15,-1
MWI,GBR,2020.0,18,10,8
THA,CAN,2011.0,13,7,6
SAU,SDN,2008.0,3,3,0
BEL,ESP,2003.0,26,19,7
ROU,CHE,2015.0,10,4,6
GBR,DEU,2002.0,363,387,-24
GEO,USA,2021.0,14,8,6
ARG,ESP,2001.0,33,30,3
SWE,DEU,2014.0,105,140,-35
CAN,BRA,2004.0,24,29,-5
CHN,AUS,2008.0,107,62,45
POL,GBR,2020.0,61,49,12
GBR,ZAF,2007.0,57,52,5
TWN,IND,2013.0,33,37,-4
LTU,CAN,2020.0,1,1,0
FRA,AUT,2019.0,51,32,19
IRN,MYS,2012.0,73,79,-6
IND,SWE,2014.0,40,26,14
BRA,FRA,2019.0,123,97,26
IND,QAT,2018.0,12,6,6
MYS,NGA,2013.0,17,21,-4
BEL,ITA,2020.0,84,91,-7
PRT,NLD,2016.0,34,11,23
SWE,DNK,2020.0,77,90,-13
FRA,USA,2022.0,267,257,10
DNK,NLD,2020.0,40,47,-7
USA,MAC,2019.0,3,12,-9
AUT,POL,2006.0,4,6,-2
JPN,DEU,2008.0,109,97,12
NZL,NLD,2014.0,10,7,3
NLD,SWE,2017.0,78,37,41
PRI,USA,2014.0,83,39,44
MYS,GBR,2009.0,52,92,-40
SWE,CHN,2021.0,89,90,-1
DEU,IND,2004.0,49,89,-40
BGD,KOR,2014.0,16,32,-16
IRN,JPN,2014.0,11,15,-4
BGD,USA,2019.0,105,57,48
POL,USA,2017.0,144,82,62
DEU,RUS,2021.0,53,90,-37
SAU,PAK,2019.0,78,85,-7
CHN,ISR,2013.0,4,8,-4
HKG,FIN,2016.0,3,1,2
ITA,USA,2021.0,335,291,44
IND,ITA,2014.0,46,34,12
AUS,BRA,2003.0,10,11,-1
FRA,SGP,2020.0,28,29,-1
KOR,USA,2003.0,502,578,-76
USA,ESP,2019.0,368,444,-76
POL,USA,2019.0,122,93,29
AUT,CHE,2016.0,70,66,4
USA,MYS,2019.0,43,59,-16
TWN,GBR,2016.0,33,35,-2
JPN,IDN,2012.0,83,20,63
NLD,SWE,2019.0,85,58,27
TUN,FRA,2015.0,78,116,-38
ETH,IND,2012.0,6,19,-13
ITA,PAK,2019.0,19,14,5
JOR,USA,2020.0,46,45,1
USA,HKG,2022.0,92,56,36
NLD,HKG,2018.0,7,5,2
CHE,CHN,2009.0,37,30,7
FRA,KOR,2010.0,18,26,-8
KOR,ISR,2009.0,2,1,1
SAU,CAN,2016.0,59,111,-52
SAU,PAK,2017.0,44,84,-40
KOR,DEU,2007.0,18,29,-11
FRA,AUT,2017.0,39,38,1
BRA,ARG,2020.0,38,19,19
JPN,CHE,2018.0,38,28,10
AUT,GBR,2018.0,70,81,-11
RUS,AZE,2020.0,4,5,-1
JOR,GBR,2014.0,7,32,-25
DEU,CHE,2002.0,338,253,85
POL,IND,2016.0,8,12,-4
ITA,PAK,2017.0,18,13,5
PAK,HKG,2015.0,7,2,5
GBR,TWN,2021.0,27,18,9
ITA,BRA,2008.0,35,24,11
AUS,IDN,2019.0,91,25,66
DEU,CZE,2003.0,27,26,1
BEL,BEN,2016.0,5,2,3
GBR,BRA,2014.0,74,75,-1
SWE,FRA,2021.0,45,85,-40
SVK,ITA,2015.0,7,2,5
RUS,GEO,2016.0,5,3,2
NLD,SRB,2021.0,2,4,-2
HRV,DEU,2020.0,16,7,9
IND,GBR,2006.0,111,83,28
ISR,IND,2015.0,24,72,-48
SGP,NLD,2022.0,5,2,3
MEX,BRA,2009.0,6,10,-4
RUS,SWE,2003.0,32,21,11
KOR,CAN,2022.0,25,11,14
PER,ESP,2019.0,13,21,-8
DEU,HKG,2021.0,10,17,-7
BEL,FRA,2022.0,71,82,-11
BGD,USA,2017.0,73,44,29
ITA,JPN,2021.0,18,18,0
RUS,ETH,2020.0,8,6,2
TUR,BEL,2021.0,8,8,0
CHN,NZL,2018.0,29,19,10
UGA,KEN,2020.0,13,11,2
GBR,BRN,2002.0,2,3,-1
ESP,ISR,2018.0,11,8,3
ECU,VEN,2018.0,5,31,-26
KEN,CMR,2018.0,2,1,1
COL,VEN,2019.0,22,39,-17
MYS,AUS,2021.0,45,38,7
IRQ,AUS,2019.0,5,22,-17
AUT,IND,2011.0,4,8,-4
IRN,NZL,2021.0,7,3,4
MEX,ARE,2020.0,2,1,1
IND,TWN,2019.0,75,30,45
VEN,ECU,2019.0,41,6,35
ECU,ARG,2019.0,4,3,1
MYS,KOR,2022.0,11,3,8
IDN,MYS,2019.0,19,77,-58
GRC,AUS,2020.0,6,3,3
LKA,JPN,2019.0,6,15,-9
PRT,CHN,2010.0,7,10,-3
GBR,IRN,2016.0,36,48,-12
COL,SAU,2021.0,2,2,0
VNM,AUS,2020.0,38,59,-21
MYS,SGP,2021.0,12,17,-5
IRN,SWE,2013.0,30,13,17
TWN,THA,2018.0,15,6,9
PHL,KOR,2018.0,10,8,2
BRA,CAN,2014.0,74,34,40
USA,FIN,2018.0,63,95,-32
NLD,BEL,2014.0,141,121,20
CHE,ARE,2016.0,3,1,2
IRN,KOR,2015.0,14,6,8
CHE,USA,2000.0,145,108,37
LKA,JPN,2017.0,2,13,-11
USA,MYS,2017.0,41,59,-18
ARE,AUS,2019.0,19,27,-8
CHE,IRL,2010.0,11,8,3
FRA,AUT,2010.0,19,21,-2
CAN,POL,2012.0,36,16,20
FIN,SGP,2017.0,7,1,6
BRA,FRA,2010.0,70,87,-17
IRN,DEU,2006.0,12,10,2
POL,USA,2010.0,101,117,-16
USA,MYS,2010.0,37,10,27
FRA,THA,2011.0,19,10,9
RUS,USA,2001.0,328,114,214
COL,CHL,2006.0,2,5,-3
FRA,ROU,2005.0,23,26,-3
POL,ZAF,2012.0,3,12,-9
SVK,BEL,2011.0,4,3,1
ESP,GRC,2017.0,26,14,12
CAN,NGA,2013.0,4,5,-1
GRC,USA,2012.0,142,83,59
POL,CHE,2014.0,53,12,41
USA,DNK,1999.0,50,58,-8
ITA,DEU,1997.0,31,32,-1
PER,ESP,2010.0,10,5,5
ARE,EGY,2021.0,5,19,-14
CHE,TUN,2011.0,2,2,0
JPN,FRA,2015.0,72,96,-24
THA,USA,2003.0,51,144,-93
AUS,IDN,2017.0,71,15,56
DEU,CAN,2016.0,168,152,16
TZA,CHE,2016.0,4,7,-3
DNK,MEX,2014.0,2,7,-5
FIN,CHN,2014.0,16,16,0
JPN,SWE,2004.0,27,16,11
NOR,GBR,2013.0,47,69,-22
AUS,COL,2014.0,6,3,3
ESP,ARG,2003.0,42,52,-10
USA,ARG,2002.0,84,119,-35
CAN,ARE,2002.0,8,2,6
UZB,TUR,2020.0,1,1,0
JPN,CHL,2008.0,6,1,5
ITA,DEU,1998.0,57,33,24
KEN,MEX,2016.0,2,1,1
PAK,ITA,2014.0,12,10,2
BRA,FRA,2017.0,98,126,-28
UGA,GBR,2002.0,5,3,2
SWE,NLD,1999.0,13,7,6
AUS,CZE,2007.0,2,4,-2
CAN,ESP,2008.0,32,30,2
PER,ESP,2017.0,10,28,-18
THA,AUT,2018.0,4,4,0
LBR,USA,2018.0,1,3,-2
AUS,PHL,2018.0,6,15,-9
FRA,CMR,2018.0,18,12,6
ESP,CHE,2010.0,55,46,9
AFG,MYS,2021.0,3,2,1
AUT,FRA,2019.0,32,51,-19
MAR,MYS,2020.0,1,2,-1
NZL,SWE,2018.0,13,5,8
THA,CHE,2017.0,4,5,-1
RUS,IND,2018.0,7,16,-9
OMN,TUR,2008.0,1,2,-1
DEU,GHA,2012.0,4,2,2
SWE,RUS,2018.0,12,21,-9
AUS,IRQ,2018.0,9,9,0
ETH,KEN,2019.0,7,8,-1
ESP,LUX,2021.0,6,1,5
MNG,CHN,2018.0,3,2,1
NLD,CHE,2001.0,25,28,-3
PAK,TWN,2022.0,5,1,4
SVK,CZE,2002.0,27,14,13
CAN,RUS,2009.0,13,14,-1
NPL,KOR,2018.0,8,10,-2
CZE,RUS,2005.0,7,8,-1
ESP,THA,2020.0,2,2,0
DEU,SRB,2008.0,16,5,11
ISR,CHN,2007.0,9,5,4
IRL,BEL,2018.0,13,18,-5
KOR,AUT,2019.0,3,6,-3
BGD,USA,2010.0,29,21,8
IRN,PRT,2021.0,8,1,7
TWN,RUS,2013.0,2,2,0
HRV,ESP,2016.0,3,6,-3
EGY,DEU,2016.0,28,46,-18
GBR,MEX,2022.0,15,15,0
AUT,GRC,2018.0,4,4,0
SGP,NZL,2018.0,17,11,6
CHL,NLD,2012.0,4,4,0
ITA,POL,2007.0,12,18,-6
HRV,USA,2018.0,12,12,0
DZA,CAN,2006.0,4,1,3
BRA,CHL,2008.0,12,10,2
BRA,MEX,2006.0,9,10,-1
DZA,ESP,2007.0,1,2,-1
SVN,USA,2013.0,12,6,6
TUR,AZE,2007.0,2,8,-6
FRA,ARG,2006.0,16,19,-3
AZE,GBR,2006.0,1,1,0
FRA,LBN,2006.0,31,12,19
EGY,LBN,2016.0,6,4,2
USA,MOZ,2021.0,3,6,-3
DEU,PRT,2013.0,22,33,-11
HUN,ARE,2014.0,1,1,0
FRA,ROU,2002.0,25,26,-1
IND,GRC,2016.0,1,1,0
NLD,MEX,2008.0,11,1,10
USA,UGA,2006.0,9,7,2
BEL,JPN,2007.0,9,12,-3
FRA,IND,2012.0,61,73,-12
JPN,LKA,2016.0,9,7,2
USA,SRB,2006.0,15,9,6
DEU,NGA,2005.0,3,6,-3
NLD,ESP,2002.0,39,38,1
CAN,NLD,2004.0,31,32,-1
GMB,GBR,1999.0,6,3,3
ISR,FRA,2003.0,35,22,13
USA,ARG,2005.0,73,149,-76
RUS,SRB,2004.0,6,3,3
GBR,BEL,2001.0,51,49,2
BFA,FRA,1998.0,3,3,0
DEU,VNM,2002.0,4,2,2
SGP,HUN,2013.0,2,1,1
GLP,FRA,2009.0,19,13,6
QAT,CHN,2020.0,2,2,0
ESP,BEL,1998.0,3,2,1
ISR,NLD,2001.0,6,7,-1
USA,CMR,2004.0,3,4,-1
ARG,BRA,2001.0,24,10,14
NOR,FIN,2011.0,7,17,-10
BEL,TUR,2001.0,3,2,1
KWT,CAN,2003.0,1,2,-1
AUT,SWE,2009.0,9,8,1
ARE,KWT,2002.0,2,2,0
VNM,KOR,2005.0,2,2,0
POL,RUS,1998.0,8,5,3
MEX,CUB,2009.0,10,11,-1
IND,DNK,2012.0,18,9,9
DEU,VEN,2004.0,1,3,-2
HUN,POL,2004.0,1,1,0
UGA,GBR,2005.0,12,4,8
ESP,KHM,2009.0,1,1,0
POL,UKR,2015.0,17,17,0
CAN,TTO,2015.0,3,1,2
FIN,ISR,2014.0,3,2,1
ESP,NOR,2013.0,10,4,6
ITA,ROU,2006.0,7,11,-4
LTU,SWE,2013.0,4,4,0
DEU,EGY,2002.0,22,18,4
NLD,DNK,2001.0,15,18,-3
FRA,SAU,1998.0,1,1,0
CAN,NOR,2013.0,19,7,12
AUS,AUT,1998.0,7,4,3
THA,KOR,2000.0,1,1,0
SAU,QAT,2004.0,1,1,0
SWE,NOR,2022.0,39,27,12
NOR,POL,2011.0,3,6,-3
SAU,NGA,2008.0,4,1,3
GRC,GBR,1999.0,19,42,-23
CZE,UKR,2000.0,1,2,-1
BGD,AUT,2016.0,1,2,-1
FRA,MEX,2014.0,33,34,-1
ESP,POL,2000.0,2,3,-1
BGD,SWE,2008.0,5,2,3
USA,PRI,2001.0,17,19,-2
GUF,FRA,2021.0,17,16,1
CHE,MEX,1998.0,1,1,0
NZL,HKG,2018.0,4,8,-4
CAN,TUR,2013.0,18,16,2
AUT,FRA,2017.0,38,39,-1
TZA,ZAF,2013.0,5,8,-3
KWT,EGY,2016.0,9,5,4
USA,MAC,2010.0,8,2,6
GRC,CHN,2005.0,4,2,2
SWE,KEN,2016.0,3,4,-1
GBR,ISR,2008.0,17,36,-19
ITA,CHN,2002.0,8,17,-9
BEL,BRA,2009.0,12,10,2
FJI,IND,2018.0,1,3,-2
HKG,AUS,2005.0,24,15,9
CHE,ZAF,2009.0,4,8,-4
SGP,CAN,1999.0,2,7,-5
NOR,NLD,1997.0,1,2,-1
USA,JAM,2017.0,7,4,3
AUS,ZAF,2011.0,21,34,-13
IND,MEX,2003.0,5,2,3
CMR,FRA,2012.0,11,25,-14
ROU,USA,1998.0,6,1,5
KOR,ARE,2018.0,16,6,10
PRT,CAN,2020.0,14,9,5
FIN,ROU,2009.0,2,1,1
BGD,IND,2010.0,6,6,0
IRL,SWE,2015.0,8,7,1
KOR,PHL,2006.0,2,3,-1
LBN,QAT,2018.0,4,1,3
DEU,COL,2018.0,20,22,-2
LVA,DEU,2010.0,3,3,0
DEU,LVA,2019.0,4,3,1
UKR,FRA,2010.0,9,6,3
USA,JAM,2019.0,3,4,-1
DNK,SWE,2004.0,39,49,-10
NOR,ITA,2008.0,7,17,-10
AUS,IRN,2008.0,24,22,2
NGA,IND,2012.0,6,6,0
CHE,SGP,2002.0,1,1,0
CHE,IRL,2019.0,16,16,0
PRT,IND,2018.0,17,7,10
NZL,JPN,2006.0,2,4,-2
ZAF,BRA,2016.0,5,3,2
AUS,IDN,2010.0,32,8,24
HRV,BIH,2008.0,11,4,7
JPN,FIN,2006.0,8,4,4
IRL,FIN,2017.0,4,4,0
PAK,AUS,2001.0,1,2,-1
SDN,OMN,2014.0,1,1,0
GAB,FRA,2011.0,7,2,5
PAK,DEU,2008.0,12,8,4
GBR,FIN,2022.0,29,29,0
AUS,ARE,2012.0,8,5,3
IRL,DNK,1999.0,3,1,2
BWA,ZAF,2012.0,7,6,1
MYS,IRQ,2012.0,23,6,17
BEL,ZAF,2004.0,9,3,6
USA,IDN,2013.0,24,14,10
CHE,HUN,2018.0,10,13,-3
MYS,HKG,2015.0,6,3,3
IRL,FIN,2019.0,5,3,2
FIN,BRA,2019.0,5,19,-14
BEN,NGA,2016.0,2,1,1
AUS,FJI,2011.0,8,8,0
PER,FRA,2011.0,6,3,3
JPN,SGP,2018.0,30,43,-13
JPN,PAK,2004.0,5,2,3
CHN,KOR,2001.0,19,11,8
COG,IND,2014.0,1,2,-1
HKG,FRA,2021.0,4,7,-3
KOR,AUT,2010.0,3,3,0
MAR,DZA,2015.0,5,6,-1
KOR,ITA,2013.0,9,12,-3
KEN,IND,2021.0,2,5,-3
AUS,KEN,2015.0,3,1,2
PHL,IND,2022.0,5,3,2
BGD,DEU,2021.0,4,5,-1
TUR,BIH,2018.0,3,3,0
EGY,AUS,2012.0,4,4,0
ETH,USA,2022.0,13,7,6
ARE,CAN,2016.0,12,35,-23
CHN,SDN,2020.0,16,3,13
CZE,POL,2018.0,7,23,-16
IDN,MYS,2017.0,13,96,-83
UKR,CAN,2006.0,6,4,2
LBN,GBR,2021.0,11,8,3
TUN,ESP,2021.0,9,4,5
ISL,GBR,2019.0,6,15,-9
ESP,GRC,2019.0,14,15,-1
AUT,SVN,2021.0,9,4,5
BEL,POL,2013.0,15,16,-1
NLD,LTU,2017.0,4,2,2
PAK,BHR,2016.0,1,1,0
NOR,IND,2009.0,2,12,-10
LVA,SWE,2003.0,2,4,-2
NOR,RUS,2008.0,3,10,-7
ARE,AUS,2017.0,17,19,-2
ITA,AUS,2006.0,27,15,12
SRB,CHE,1998.0,1,1,0
AUT,FRA,2010.0,21,19,2
UKR,POL,2008.0,10,8,2
UKR,FRA,2017.0,16,18,-2
FIN,BRA,2010.0,3,1,2
OMN,FRA,2007.0,2,2,0
NGA,DEU,2007.0,4,3,1
BEL,COD,2018.0,9,3,6
MLT,GBR,2008.0,2,7,-5
CZE,CAN,2009.0,10,8,2
FJI,AUS,2018.0,6,9,-3
GBR,GHA,2015.0,18,5,13
IRQ,AUS,2010.0,2,2,0
NOR,ROU,2014.0,2,1,1
NGA,SAU,2012.0,5,7,-2
BGD,PAK,2018.0,3,12,-9
IDN,AUS,2016.0,25,57,-32
POL,DEU,2003.0,59,51,8
FRA,FIN,2000.0,6,2,4
SRB,MNE,2009.0,1,3,-2
ITA,NGA,2017.0,4,2,2
CHE,EST,2018.0,4,5,-1
FIN,BRA,2017.0,4,7,-3
DEU,CUB,2008.0,3,4,-1
SGP,BGD,2020.0,4,1,3
DNK,IRL,2011.0,5,2,3
SRB,GRC,2011.0,2,2,0
IRL,SVK,2016.0,1,3,-2
DEU,MDA,2019.0,1,4,-3
CHN,BGD,2011.0,8,2,6
THA,CHE,2019.0,4,6,-2
UKR,ESP,2018.0,4,3,1
IRQ,AUS,2017.0,5,12,-7
CAN,ISR,1998.0,5,4,1
TUN,IRN,2019.0,1,1,0
TUR,EGY,2013.0,1,1,0
BGD,IND,2019.0,10,13,-3
SRB,GBR,2020.0,11,7,4
GBR,SRB,2021.0,3,5,-2
NOR,ISR,2019.0,2,3,-1
ROU,AUT,2011.0,3,3,0
LUX,BEL,2012.0,9,13,-4
NOR,SRB,2020.0,2,4,-2
CHL,IND,2019.0,4,13,-9
UKR,NOR,2021.0,1,1,0
BHR,ARE,2007.0,2,1,1
BGD,AUS,2004.0,2,3,-1
FRA,CHL,2006.0,12,14,-2
GBR,BWA,2016.0,5,3,2
AUT,DNK,2008.0,6,5,1
CHE,POL,2002.0,10,7,3
AUS,BEL,2006.0,7,8,-1
COL,VEN,2010.0,2,14,-12
DEU,VNM,2005.0,3,2,1
ITA,SAU,2003.0,2,2,0
NZL,CHE,2013.0,18,12,6
POL,SVN,2018.0,3,2,1
LBN,NLD,2014.0,2,1,1
ITA,SWE,2002.0,26,28,-2
SWE,ISR,2001.0,2,2,0
FRA,IRL,2000.0,7,1,6
CYP,GBR,2000.0,1,1,0
CAN,ARE,2005.0,7,5,2
USA,BLR,2005.0,3,6,-3
EGY,FRA,2008.0,7,10,-3
MYS,PRT,2020.0,2,1,1
DEU,HRV,2003.0,14,11,3
GBR,TTO,2003.0,5,3,2
GHA,GBR,2004.0,3,6,-3
GRC,NLD,2007.0,8,9,-1
CHE,GHA,2015.0,2,5,-3
LTU,FIN,2005.0,1,3,-2
DEU,ARE,2008.0,6,1,5
USA,JAM,2010.0,6,8,-2
TUN,CHE,2015.0,2,2,0
AUS,BGD,2014.0,21,50,-29
CHL,ITA,2009.0,6,8,-2
PSE,USA,2011.0,2,7,-5
IND,ESP,2011.0,9,7,2
BOL,ARG,2015.0,1,2,-1
BEL,GRC,2020.0,13,16,-3
RUS,SGP,2011.0,5,1,4
TWN,SGP,2012.0,12,7,5
ARE,AUS,2010.0,4,9,-5
RUS,MEX,2009.0,5,7,-2
FIN,DNK,2008.0,8,12,-4
UKR,NLD,2013.0,5,3,2
SGP,IDN,2022.0,1,2,-1
FIN,AUT,2015.0,8,3,5
ESP,BEL,1997.0,2,5,-3
MYS,ITA,2021.0,2,2,0
KWT,USA,2006.0,8,20,-12
CAN,LBN,2021.0,8,18,-10
NLD,CHL,2020.0,8,9,-1
TZA,BEL,2014.0,1,3,-2
CHN,CMR,2017.0,4,1,3
DEU,NAM,2012.0,2,1,1
ITA,NGA,2019.0,5,2,3
ZAF,SAU,2020.0,8,1,7
CHE,HKG,2022.0,7,1,6
COG,GHA,2019.0,1,1,0
IDN,NZL,2016.0,3,6,-3
TWN,SWE,2018.0,8,3,5
RWA,FRA,2019.0,1,1,0
EST,GBR,2022.0,2,11,-9
BGD,NLD,2018.0,3,3,0
NLD,CZE,2022.0,4,2,2
VNM,USA,2006.0,3,5,-2
CRI,MEX,2021.0,3,2,1
SVK,RUS,2002.0,4,3,1
GBR,HUN,2007.0,13,23,-10
FSM,PLW,2004.0,1,1,0
FRA,NZL,2001.0,7,9,-2
TUR,UKR,2004.0,1,1,0
ZWE,MEX,2016.0,2,4,-2
DEU,LVA,2010.0,3,3,0
ESP,GRC,2010.0,9,16,-7
SWE,ETH,2011.0,4,1,3
CAN,URY,2020.0,1,3,-2
HKG,BRA,2019.0,2,1,1
FIN,SGP,2019.0,1,5,-4
MWI,ZMB,2012.0,2,2,0
ESP,CZE,2003.0,5,3,2
NPL,PAK,2015.0,1,2,-1
RUS,NGA,2020.0,3,3,0
CHE,SGP,2005.0,5,7,-2
NZL,BGD,2019.0,2,3,-1
KOR,TUR,2020.0,2,7,-5
SGP,CHE,2007.0,4,9,-5
AUT,NOR,2012.0,6,2,4
USA,GAB,2021.0,2,1,1
NCL,AUS,2013.0,1,1,0
AUS,FIN,2008.0,4,16,-12
ITA,IRN,2001.0,2,1,1
IRL,PAK,2011.0,1,2,-1
THA,BEL,2012.0,3,2,1
CHN,BRA,2022.0,6,12,-6
GRC,PRT,2015.0,4,2,2
PSE,EGY,2019.0,1,6,-5
ZAF,ZMB,2014.0,5,3,2
AUT,CHL,2021.0,2,1,1
ITA,MAR,2022.0,4,1,3
ECU,ARG,2017.0,1,6,-5
TWN,ZAF,2016.0,5,2,3
LTU,BEL,2017.0,1,1,0
ETH,SGP,2016.0,3,1,2
GBR,BLR,2016.0,1,1,0
UZB,BEL,2021.0,1,1,0
MEX,RUS,2022.0,3,3,0
AUS,IND,1999.0,5,9,-4
NOR,EST,2015.0,1,3,-2
IDN,FRA,2018.0,6,17,-11
HRV,FRA,2020.0,4,5,-1
CHE,JOR,2021.0,4,1,3
TUR,NGA,2021.0,3,1,2
DEU,NGA,2002.0,5,5,0
DNK,TZA,2003.0,4,2,2
GBR,PHL,2004.0,4,3,1
ARE,LBN,2016.0,1,1,0
COG,FRA,2007.0,6,8,-2
TUR,CHE,2003.0,4,4,0
CHL,URY,2001.0,2,1,1
CZE,AUT,2000.0,5,3,2
TUR,IRN,2005.0,1,2,-1
ESP,UKR,2015.0,4,5,-1
PRT,UKR,1998.0,1,1,0
VEN,ITA,2007.0,1,2,-1
AUT,SRB,2004.0,1,1,0
FRA,URY,2003.0,1,3,-2
AUT,ARE,2017.0,3,1,2
PRT,AUT,2003.0,3,3,0
AZE,TUR,2004.0,4,3,1
NOR,TUR,2001.0,4,1,3
SWE,POL,1999.0,2,3,-1
BEL,SVN,2009.0,2,4,-2
MEX,CHL,2003.0,2,3,-1
POL,JPN,2006.0,6,7,-1
RUS,EGY,2012.0,2,1,1
MEX,MAR,2011.0,3,1,2
MWI,KEN,2008.0,1,1,0
AUS,RUS,2011.0,5,13,-8
UKR,ITA,1999.0,2,3,-1
NOR,CHE,2001.0,5,3,2
FRA,GUF,2000.0,5,1,4
TUR,NOR,2015.0,1,2,-1
PSE,EGY,2017.0,3,1,2
LKA,JPN,2010.0,4,8,-4
THA,PRT,2013.0,2,1,1
CHL,VEN,2006.0,2,3,-1
LBY,FRA,2017.0,1,2,-1
THA,CHE,2010.0,5,1,4
MAR,KWT,2019.0,1,1,0
TGO,FRA,2014.0,2,2,0
USA,URY,2022.0,4,4,0
ZAF,KOR,2014.0,1,2,-1
POL,MEX,2012.0,1,3,-2
TWN,QAT,2016.0,2,1,1
MAR,USA,2008.0,4,2,2
MLT,POL,2013.0,2,1,1
EGY,SWE,2014.0,2,4,-2
ZAF,BWA,2015.0,6,9,-3
GBR,HRV,2012.0,3,7,-4
SWE,EGY,2021.0,4,1,3
AUS,EGY,2019.0,12,10,2
VNM,KOR,2002.0,6,1,5
CAN,GHA,2006.0,2,1,1
UKR,BEL,2002.0,5,2,3
MEX,ARG,1998.0,2,2,0
USA,IRN,1999.0,5,2,3
SWE,CZE,2006.0,2,5,-3
DEU,LBN,2010.0,3,3,0
FRA,CZE,2011.0,14,20,-6
GEO,DEU,2016.0,4,1,3
GHA,NOR,2014.0,1,2,-1
BEL,LUX,2004.0,6,3,3
CHE,POL,2005.0,9,10,-1
ZMB,NOR,2008.0,1,1,0
DEU,MNG,2013.0,2,1,1
ROU,PRT,2011.0,3,3,0
HUN,SVK,2009.0,2,2,0
JOR,IND,2001.0,2,2,0
IDN,NOR,2018.0,1,1,0
CMR,BEL,2013.0,3,1,2
DEU,BLR,2008.0,3,8,-5
IRQ,FRA,2015.0,2,1,1
NGA,ITA,2012.0,3,3,0
PRT,BGR,2015.0,1,1,0
ARE,JOR,2006.0,3,6,-3
NLD,LTU,2019.0,4,2,2
BGD,IND,2017.0,7,9,-2
BFA,MLI,2020.0,2,1,1
CHL,NOR,2013.0,2,1,1
SVK,AUT,2018.0,9,6,3
EST,NOR,2018.0,2,2,0
FIN,PAK,2020.0,1,3,-2
FRA,PHL,2016.0,2,4,-2
ETH,KEN,2017.0,3,5,-2
GBR,TZA,2022.0,2,4,-2
LTU,ITA,2021.0,3,2,1
FIN,CHE,1999.0,4,5,-1
MMR,MYS,2020.0,1,4,-3
ISR,ESP,2006.0,3,2,1
BOL,ITA,2008.0,1,1,0
CMR,USA,2007.0,5,5,0
DEU,URY,2016.0,4,4,0
FIN,IRN,2015.0,4,13,-9
LVA,DEU,2017.0,3,1,2
HRV,CAN,2019.0,1,1,0
IND,BEL,2000.0,2,2,0
ISL,DNK,2022.0,3,6,-3
ESP,GTM,2016.0,6,2,4
BWA,ETH,2012.0,1,1,0
KOR,CHE,2018.0,11,7,4
GHA,SWE,2013.0,1,1,0
CHE,IRL,2017.0,5,19,-14
NPL,AUS,2005.0,3,2,1
ISR,SGP,2021.0,4,4,0
GHA,ZAF,2015.0,8,9,-1
USA,BLR,2002.0,5,21,-16
POL,PRT,2004.0,1,1,0
CAN,EST,2008.0,1,1,0
HRV,SRB,2012.0,6,4,2
SGP,FRA,2008.0,6,16,-10
DEU,LBN,2017.0,4,3,1
MEX,SLV,2011.0,1,1,0
ALB,NLD,2018.0,1,1,0
LVA,DEU,2019.0,3,4,-1
TUN,GBR,2018.0,4,6,-2
MRT,FRA,2002.0,2,1,1
TGO,BEN,2021.0,1,1,0
ITA,PAK,2010.0,3,4,-1
CHE,SRB,2012.0,4,4,0
RWA,GBR,2018.0,1,3,-2
ISR,CHL,2004.0,3,1,2
CAN,BGR,2007.0,1,3,-2
EGY,FIN,2013.0,2,1,1
FRA,IDN,2005.0,1,1,0
DNK,ISR,2020.0,3,3,0
QAT,EGY,2002.0,4,2,2
AUT,BEL,2004.0,5,6,-1
ITA,UKR,2005.0,1,3,-2
BEL,LTU,2008.0,1,1,0
IRL,POL,2009.0,2,5,-3
LKA,THA,2014.0,1,2,-1
LKA,CHE,2015.0,3,2,1
SWE,HUN,2008.0,5,10,-5
USA,PYF,2004.0,1,1,0
PAK,SGP,2011.0,1,2,-1
POL,RUS,1997.0,3,2,1
AUT,ARE,2019.0,2,1,1
CHN,IND,2003.0,3,4,-1
RUS,ARM,2012.0,1,2,-1
CHN,ZAF,2003.0,1,1,0
SWE,LUX,2016.0,3,3,0
TGO,SEN,2014.0,1,4,-3
VNM,DEU,2005.0,2,3,-1
CHL,DNK,2008.0,2,1,1
ROU,USA,1997.0,2,1,1
ARE,HKG,2016.0,1,2,-1
FIN,IND,1999.0,1,2,-1
JPN,CZE,2012.0,3,6,-3
URY,USA,2006.0,7,9,-2
GBR,QAT,2007.0,1,2,-1
FRA,SVN,2022.0,2,4,-2
VNM,LUX,2021.0,2,1,1
GBR,ZWE,2016.0,2,24,-22
CHN,KAZ,2020.0,3,4,-1
BGD,HKG,2012.0,2,2,0
ITA,SVK,2022.0,3,2,1
SAU,CHN,2012.0,2,13,-11
FRA,GAB,1999.0,2,3,-1
BRA,CHE,2006.0,6,7,-1
PSE,ISR,2014.0,4,10,-6
BEL,FIN,2007.0,5,3,2
USA,ZMB,2003.0,2,1,1
SWE,THA,2008.0,5,4,1
TWN,SAU,2021.0,3,4,-1
IRN,LUX,2022.0,2,1,1
IDN,MYS,2010.0,2,13,-11
FRA,COL,2022.0,3,4,-1
NZL,BGD,2017.0,1,3,-2
TUR,PSE,2022.0,2,1,1
FLK,NZL,2013.0,1,1,0
CAN,THA,2005.0,3,4,-1
NGA,KEN,2001.0,1,1,0
FIN,CZE,2007.0,2,4,-2
USA,NCL,2011.0,1,2,-1
LAO,PHL,2013.0,1,1,0
MYS,CHN,2011.0,2,5,-3
PHL,AUS,1999.0,1,1,0
KOR,KAZ,2014.0,3,1,2
CUB,CHN,2020.0,2,2,0
ARE,AUT,2016.0,1,2,-1
SDN,DEU,2013.0,1,2,-1
TWN,IRN,2021.0,1,9,-8
SAU,LBN,2021.0,1,4,-3
DEU,LBN,2019.0,3,10,-7
SAU,PRT,2016.0,1,7,-6
FRA,NGA,2007.0,2,1,1
VNM,BEL,2018.0,2,13,-11
BEL,ETH,2017.0,4,1,3
LIE,AUT,2016.0,2,1,1
BEN,GBR,2020.0,1,1,0
ITA,UKR,2002.0,2,2,0
EGY,RUS,2007.0,2,3,-1
HRV,CZE,2018.0,2,2,0
BEN,NLD,2017.0,4,3,1
OMN,BGD,2022.0,1,1,0
LTU,BEL,2019.0,1,1,0
DZA,ARE,2022.0,1,1,0
SAU,ZAF,2011.0,3,3,0
JPN,EST,2020.0,2,2,0
EST,FRA,1999.0,2,1,1
LBY,FRA,2019.0,1,1,0
USA,TTO,2022.0,1,2,-1
ITA,SLE,2017.0,1,1,0
CMR,BEN,2019.0,1,2,-1
THA,SWE,2014.0,2,7,-5
HKG,BEL,2013.0,1,1,0
GBR,CRI,2015.0,3,1,2
KHM,PAK,2020.0,2,1,1
MEX,VEN,2013.0,3,7,-4
PRT,ISR,2016.0,3,2,1
GRC,HUN,2013.0,3,1,2
ARE,GRC,2015.0,1,3,-2
SRB,ISR,2008.0,1,1,0
MDA,FRA,2001.0,1,1,0
ARM,IRN,2010.0,1,4,-3
BRN,SGP,2012.0,1,1,0
VNM,GBR,2000.0,1,1,0
RUS,BRA,2007.0,1,9,-8
DNK,NOR,1998.0,3,4,-1
CHE,NZL,2001.0,1,3,-2
FIN,ARG,2014.0,1,2,-1
CHL,IND,2010.0,2,3,-1
HUN,NZL,2005.0,1,1,0
BRA,MOZ,2012.0,4,4,0
SGP,QAT,2020.0,2,1,1
SYR,FRA,2006.0,1,3,-2
IDN,CAN,2006.0,1,1,0
PRT,ROU,2009.0,2,4,-2
PRT,SAU,2020.0,1,2,-1
RUS,IRN,2022.0,3,2,1
BRB,GBR,2016.0,1,1,0
ESP,ISL,2020.0,1,2,-1
USA,GRD,2022.0,2,7,-5
CHE,PHL,2009.0,2,2,0
RUS,TWN,2001.0,3,1,2
ISL,GBR,2010.0,1,9,-8
ESP,PRY,2013.0,1,1,0
NOR,IRN,2008.0,1,2,-1
LAO,GBR,2018.0,1,1,0
COL,AUS,2022.0,4,6,-2
CHN,CMR,2019.0,1,1,0
RUS,TUR,1999.0,2,1,1
EST,DNK,2008.0,1,2,-1
MEX,BOL,2017.0,2,1,1
COL,BRA,2000.0,1,3,-2
ISR,ARG,2018.0,1,1,0
SWE,PRI,2009.0,1,1,0
OMN,IRN,2013.0,1,2,-1
GBR,KHM,2015.0,1,2,-1
USA,MDG,2014.0,2,7,-5
ZAF,ISR,1999.0,1,1,0
DEU,LVA,2017.0,1,3,-2
EGY,BEL,2020.0,1,7,-6
BRN,AUS,2008.0,1,1,0
ESP,DOM,2022.0,2,1,1
SVN,BIH,2014.0,1,2,-1
ARE,USA,1998.0,1,3,-2
JOR,OMN,2016.0,2,4,-2
DNK,KOR,2001.0,1,2,-1
CMR,NGA,2022.0,1,4,-3
CRI,NLD,2014.0,2,1,1
GBR,MMR,2019.0,1,2,-1
VNM,TWN,2012.0,1,6,-5
ZWE,COG,2021.0,2,2,0
GRC,DNK,2001.0,3,3,0
THA,TWN,2022.0,3,2,1
CIV,FRA,2022.0,1,4,-3
CHN,LBN,2020.0,1,2,-1
CHN,EGY,2003.0,1,2,-1
THA,NGA,2012.0,1,1,0
IRQ,ARE,2018.0,1,1,0
UGA,NOR,2018.0,2,3,-1
RWA,AUS,2017.0,1,1,0
TUN,CAN,2001.0,1,1,0
IRL,DEU,1999.0,2,8,-6
CMR,BEN,2017.0,1,2,-1
SVK,SVN,2012.0,1,5,-4
SVN,DNK,2017.0,1,1,0
ARM,IRN,2019.0,1,1,0
JPN,DZA,2014.0,1,1,0
CZE,GRC,2015.0,1,5,-4
ISR,BGR,2003.0,1,2,-1
DNK,NOR,1997.0,1,2,-1
AUS,ECU,2011.0,1,1,0
ECU,DEU,2011.0,1,3,-2
SVK,CHE,2007.0,1,5,-4
BFA,SEN,2017.0,1,2,-1
VNM,DEU,2002.0,2,4,-2
CHE,LVA,2013.0,1,1,0
BEL,SEN,2013.0,1,1,0
IRL,QAT,2019.0,1,1,0
CHE,SEN,2021.0,1,1,0
JAM,GBR,2011.0,1,3,-2
USA,CUB,2005.0,1,5,-4
SWE,ARE,2012.0,1,2,-1
ITA,BOL,2008.0,1,1,0
TWN,EGY,2022.0,1,3,-2
ARE,SWE,2004.0,1,2,-1
USA,SWZ,2016.0,1,1,0
TZA,UGA,2022.0,1,1,0
LIE,DEU,2019.0,1,3,-2
MEX,IRN,2022.0,1,3,-2
SRB,NLD,2013.0,1,4,-3
BHR,IRL,2015.0,1,2,-1
SGP,NOR,2010.0,1,2,-1
QAT,SGP,2020.0,1,2,-1
BHS,CAN,2015.0,1,2,-1
BHR,AUS,2021.0,1,1,0
PRT,ARE,2022.0,1,2,-1
GBR,CYP,2000.0,1,1,0
CZE,SRB,2017.0,2,3,-1
AUT,ISR,2004.0,1,1,0
AFG,USA,2020.0,1,1,0
AUS,AUT,1997.0,1,4,-3
FRA,BGR,2022.0,1,1,0
BEL,MYS,2018.0,1,4,-3
MYS,EGY,2001.0,2,1,1
CHL,PER,2006.0,1,1,0
CUB,ARG,2011.0,1,1,0
FJI,DEU,2021.0,1,1,0
CHN,TZA,2014.0,1,1,0
VNM,IDN,2020.0,1,1,0
SAU,RUS,2021.0,2,6,-4
ITA,OMN,2018.0,1,2,-1
GBR,TUN,2021.0,1,2,-1
DEU,MDA,2017.0,1,4,-3
GBR,LTU,2000.0,1,2,-1
CHE,COL,2009.0,1,2,-1
VNM,THA,2002.0,1,1,0
PRT,MAC,2022.0,1,1,0
FRA,ZWE,1998.0,1,1,0
SGP,POL,2007.0,1,1,0
JOR,ISR,2017.0,1,1,0
UZB,KAZ,2021.0,1,3,-2
AUT,MYS,2020.0,1,2,-1
IRN,ARE,2013.0,1,1,0
URY,CHL,2019.0,1,2,-1
BOL,BEL,2003.0,1,1,0
SWE,SYR,2018.0,1,1,0
MAC,FRA,2020.0,1,1,0
CHL,PRT,2014.0,1,10,-9
SWE,GBR,2016.0,145,148,-3
USA,BRA,2005.0,243,248,-5
IRN,CHN,2007.0,2,3,-1
IND,PRT,2012.0,33,13,20
BEL,CHE,2020.0,49,33,16
GBR,DEU,2005.0,338,431,-93
USA,SGP,2014.0,288,203,85
MEX,ESP,2009.0,92,83,9
TWN,USA,2005.0,172,279,-107
DEU,SWE,2006.0,78,89,-11
TWN,CHN,2007.0,45,32,13
FRA,CAN,2001.0,129,110,19
ESP,CHE,2019.0,103,83,20
DEU,FRA,2014.0,345,366,-21
RUS,CHE,2008.0,18,13,5
TWN,USA,2002.0,164,236,-72
TTO,BRB,2006.0,2,2,0
IND,NLD,2006.0,18,11,7
FRA,COG,2014.0,8,2,6
SGP,SWE,2020.0,10,8,2
SWE,JPN,2011.0,22,41,-19
AUS,EGY,2017.0,7,9,-2
MDA,USA,2014.0,1,1,0
FRA,KOR,2017.0,24,26,-2
HUN,ESP,2012.0,11,3,8
COL,VEN,2017.0,20,33,-13
RUS,MNG,2014.0,3,1,2
USA,BRA,2002.0,250,257,-7
UKR,ISR,2013.0,1,1,0
TUR,KAZ,2020.0,10,6,4
HUN,DEU,2012.0,27,33,-6
BGR,AUS,1998.0,1,3,-2
DEU,AUS,2001.0,53,51,2
KOR,BRA,2014.0,6,3,3
CHN,CHE,2013.0,36,32,4
IRN,GBR,2013.0,40,35,5
HKG,AUS,2002.0,26,25,1
NLD,ESP,2005.0,29,31,-2
FRA,GRC,2004.0,25,15,10
PRT,CHN,2019.0,4,4,0
PAK,GBR,2013.0,40,80,-40
UKR,CHE,2018.0,8,1,7
POL,ESP,2015.0,25,16,9
IDN,USA,2020.0,17,31,-14
HKG,TWN,2020.0,20,14,6
FRA,IDN,2002.0,4,3,1
CAN,ECU,2018.0,3,2,1
IRL,CAN,2007.0,25,22,3
ISL,GBR,2017.0,5,9,-4
USA,LKA,2006.0,6,5,1
RUS,BLR,2009.0,9,10,-1
ESP,DNK,1999.0,5,3,2
ITA,RUS,2016.0,31,20,11
BEL,KEN,2011.0,2,3,-1
USA,TUN,2007.0,3,2,1
JPN,EGY,1999.0,4,3,1
BGR,GBR,2001.0,20,2,18
GBR,ARG,2009.0,8,9,-1
NLD,ARG,2007.0,3,1,2
NLD,LTU,2010.0,2,4,-2
RUS,POL,2003.0,7,15,-8
JPN,NPL,2007.0,10,4,6
IRL,FRA,2004.0,11,13,-2
DEU,EGY,2005.0,31,7,24
CAN,MEX,1999.0,9,3,6
NLD,SWE,2010.0,37,31,6
IDN,SGP,2016.0,6,9,-3
FRA,KOR,2019.0,44,24,20
MYS,USA,2004.0,7,20,-13
BOL,FRA,2014.0,3,3,0
KEN,GBR,2003.0,7,12,-5
CZE,RUS,2002.0,4,8,-4
NLD,ISR,2009.0,11,13,-2
DNK,QAT,2022.0,3,1,2
ITA,CHN,2005.0,10,5,5
PAK,MYS,2009.0,9,5,4
FRA,TUR,2021.0,10,14,-4
ROU,MDA,2018.0,1,2,-1
TUR,POL,2013.0,5,2,3
CZE,BRA,2014.0,3,3,0
IRN,HKG,2017.0,4,3,1
USA,CUB,2002.0,3,4,-1
JOR,ESP,2018.0,2,7,-5
GHA,HKG,2022.0,2,1,1
USA,MAC,2017.0,7,4,3
DNK,BEL,2013.0,8,10,-2
QAT,CAN,2012.0,3,7,-4
SAU,PAK,2010.0,10,27,-17
ZWE,USA,2018.0,6,6,0
HKG,DEU,2013.0,8,7,1
NAM,DEU,2011.0,1,1,0
PSE,GBR,2007.0,1,2,-1
RUS,IRL,2001.0,4,1,3
GBR,MUS,2005.0,1,3,-2
ETH,KEN,2010.0,4,3,1
FRA,MLI,2013.0,2,5,-3
IRL,FIN,2010.0,2,1,1
BGR,BEL,2003.0,4,2,2
AUS,LBN,2017.0,3,1,2
SVN,DNK,2019.0,1,5,-4
SVN,PAK,2020.0,1,1,0
BHR,IND,2015.0,1,4,-3
CAN,THA,2002.0,8,4,4
CZE,FIN,2006.0,2,1,1
AUT,NZL,2012.0,4,3,1
TUR,MYS,2022.0,3,5,-2
CYP,NLD,2014.0,1,1,0
CHE,TUR,2021.0,10,16,-6
NOR,PRT,2003.0,1,3,-2
SRB,BGR,2003.0,3,2,1
GNB,DNK,2007.0,1,2,-1
CHE,DNK,1999.0,5,3,2
SAU,FRA,2022.0,5,8,-3
ETH,TZA,2019.0,2,2,0
HUN,DNK,2022.0,2,2,0
COL,PER,2022.0,2,2,0
CHL,CAN,2000.0,2,1,1
KEN,ETH,2021.0,2,3,-1
HKG,KOR,2004.0,2,2,0
CZE,SRB,2019.0,2,2,0
TWN,CZE,2005.0,1,1,0
ARE,PAK,2015.0,6,8,-2
THA,MYS,2001.0,2,1,1
VNM,SWE,2004.0,1,3,-2
QAT,FRA,2020.0,3,8,-5
IND,MAR,2011.0,2,4,-2
UKR,JPN,2012.0,1,6,-5
LUX,ITA,2011.0,2,6,-4
BEN,CMR,2018.0,1,1,0
ARG,POL,2003.0,1,1,0
VNM,MYS,2017.0,3,6,-3
SVN,ESP,2021.0,3,6,-3
UZB,KOR,2003.0,1,1,0
SWE,BGR,2011.0,1,2,-1
CAN,COL,2000.0,3,1,2
NER,USA,2004.0,1,1,0
CAN,KEN,2009.0,1,2,-1
BGR,CAN,2000.0,1,1,0
CAN,BFA,2015.0,2,3,-1
CAN,BHR,2021.0,2,1,1
AUT,FIN,2009.0,3,4,-1
KAZ,TUR,2009.0,2,1,1
NZL,IRL,2012.0,1,5,-4
PAK,SVK,2019.0,1,2,-1
FRA,GLP,2022.0,2,4,-2
AUS,LBN,2010.0,1,1,0
BRA,THA,2021.0,1,1,0
SWE,SVN,2018.0,1,1,0
BGD,THA,2013.0,2,2,0
BEL,ETH,2010.0,2,3,-1
BRA,NZL,2014.0,1,5,-4
ITA,CUB,2015.0,1,5,-4
PHL,ITA,2022.0,2,1,1
IRL,JPN,2004.0,1,5,-4
PAK,JOR,2016.0,1,2,-1
RUS,,2015.0,5204,0,5204
,NZL,2004.0,1273,0,1273
ARG,,2013.0,1091,0,1091
,USA,2011.0,89900,0,89900
TWN,,2023.0,19366,0,19366
GBR,,2015.0,14099,0,14099
AUT,,2020.0,2849,0,2849
CRI,,2011.0,40,0,40
ESP,,2021.0,18838,0,18838
IDN,,2019.0,981,0,981
FRA,,2004.0,4519,0,4519
GRC,,2016.0,1786,0,1786
CZE,,2023.0,11135,0,11135
,POL,1994.0,4236,0,4236
,JOR,2012.0,373,0,373
NOR,,2018.0,1516,0,1516
,CAN,2002.0,10743,0,10743
KWT,,2024.0,1113,0,1113
,HRV,1999.0,1273,0,1273
,NOR,2005.0,1656,0,1656
POL,,2015.0,3624,0,3624
ZWE,,2024.0,538,0,538
,ZAF,2006.0,1634,0,1634
,CAN,2005.0,11040,0,11040
,ARG,1995.0,1575,0,1575
,FJI,2012.0,32,0,32
UKR,,2014.0,810,0,810
,AUT,2008.0,2362,0,2362
,THA,2001.0,1268,0,1268
SVK,,2021.0,1276,0,1276
,COL,2016.0,2533,0,2533
MUS,,2016.0,15,0,15
,NOR,2002.0,1535,0,1535
PRI,,2008.0,61,0,61
CUB,,2023.0,1786,0,1786
,CIV,2000.0,96,0,96
MOZ,,2014.0,15,0,15
FIN,MYS,2012.0,2,0,2
NLD,UGA,2004.0,2,0,2
ESP,PAK,2009.0,2,0,2
,NZL,1996.0,584,0,584
BEL,NER,2011.0,3,0,3
,ARM,1998.0,170,0,170
UZB,,2012.0,63,0,63
,TTO,2003.0,53,0,53
MAR,TUR,2009.0,2,0,2
LVA,,2023.0,1097,0,1097
HKG,,2003.0,215,0,215
,LBN,1997.0,32,0,32
BEN,,2024.0,546,0,546
,TUR,2015.0,6755,0,6755
,OMN,2010.0,129,0,129
,CZE,2014.0,2761,0,2761
,ZWE,2012.0,153,0,153
QAT,,2020.0,203,0,203
IDN,,2017.0,365,0,365
LKA,,2021.0,323,0,323
,UKR,2012.0,2205,0,2205
,TZA,1997.0,36,0,36
,ETH,2005.0,166,0,166
,PAK,1999.0,889,0,889
,LVA,2013.0,236,0,236
,VEN,2015.0,252,0,252
,CUB,2012.0,627,0,627
SYR,,2016.0,73,0,73
RWA,AUS,2019.0,1,0,1
ZAF,,2002.0,101,0,101
,MNE,2014.0,69,0,69
MUS,THA,2018.0,1,0,1
IRQ,,2025.0,13,0,13
MYS,,2007.0,170,0,170
NCL,,2019.0,25,0,25
,GIN,2005.0,20,0,20
GHA,,2008.0,18,0,18
PYF,,2013.0,4,0,4
GAB,,2020.0,31,0,31
,MOZ,2015.0,69,0,69
,GMB,2015.0,24,0,24
,PRK,2015.0,38,0,38
,KWT,2015.0,142,0,142
ISL,,2021.0,183,0,183
,SDN,2015.0,105,0,105
,BTN,2015.0,29,0,29
,MLT,2006.0,62,0,62
,LKA,2018.0,390,0,390
ZAF,,2005.0,325,0,325
PAK,,2005.0,149,0,149
,OMN,2017.0,167,0,167
,OMN,2019.0,106,0,106
SVK,FIN,2007.0,2,0,2
THA,,2014.0,896,0,896
,MYS,2000.0,685,0,685
IDN,,2010.0,69,0,69
NCL,,2017.0,16,0,16
BOL,BRA,2016.0,3,0,3
,MNG,2001.0,15,0,15
CHE,EGY,2007.0,1,0,1
,ETH,2002.0,102,0,102
NOR,NLD,1998.0,3,0,3
CHE,IRN,2004.0,1,0,1
SYR,ITA,2014.0,4,0,4
SLV,BRA,2014.0,1,0,1
ESP,EGY,2000.0,1,0,1
TWN,UKR,2014.0,3,0,3
RWA,,2017.0,42,0,42
VEN,NLD,2004.0,1,0,1
ARE,IRN,2002.0,1,0,1
AIA,,2018.0,2,0,2
LBN,SWE,2018.0,1,0,1
,PRY,2014.0,55,0,55
AZE,IRL,2018.0,1,0,1
PAK,NLD,2009.0,5,0,5
UZB,USA,2018.0,6,0,6
,BFA,2002.0,47,0,47
PNG,,2011.0,11,0,11
BRA,SAU,2022.0,6,0,6
SDN,,2011.0,30,0,30
AFG,JOR,2013.0,1,0,1
,TZA,1998.0,119,0,119
NLD,SAU,2009.0,2,0,2
,LBR,2014.0,10,0,10
UKR,TWN,2018.0,1,0,1
LVA,LTU,2006.0,1,0,1
,AZE,2001.0,111,0,111
RWA,,2019.0,48,0,48
COG,,2007.0,16,0,16
,ARM,1997.0,75,0,75
RWA,,2010.0,5,0,5
PAK,,2002.0,21,0,21
MDG,,2016.0,45,0,45
,LBN,1998.0,205,0,205
BGR,CZE,2006.0,2,0,2
OMN,,2008.0,38,0,38
,LBY,2001.0,24,0,24
MRT,,2015.0,3,0,3
MEX,BLR,2000.0,2,0,2
JAM,,2015.0,31,0,31
USA,MAR,2011.0,3,0,3
KWT,BHR,2016.0,1,0,1
DOM,CUB,2010.0,2,0,2
CHL,AUS,2004.0,1,0,1
UKR,SWE,1999.0,7,0,7
CMR,BEN,2010.0,3,0,3
PNG,IND,2020.0,1,0,1
SYR,EGY,2002.0,2,0,2
UKR,FIN,2005.0,2,0,2
,BFA,2005.0,75,0,75
DEU,MDA,2010.0,3,0,3
USA,SMR,2002.0,1,0,1
PRY,CHL,2002.0,3,0,3
BEN,DEU,1998.0,1,0,1
ZAF,OMN,2008.0,2,0,2
MAR,,2000.0,9,0,9
CAN,ISR,1997.0,4,0,4
ROU,JPN,1998.0,6,0,6
ZAF,GHA,2004.0,1,0,1
CAN,TZA,2003.0,2,0,2
NZL,CHL,2001.0,2,0,2
NAM,ZAF,2000.0,1,0,1
,SLV,1999.0,3,0,3
HRV,CAN,2017.0,3,0,3
PAK,SVK,2017.0,1,0,1
EST,ITA,2015.0,2,0,2
ARM,,2001.0,7,0,7
ROU,DNK,2007.0,1,0,1
SVN,DNK,2010.0,2,0,2
LVA,CZE,2014.0,1,0,1
,TJK,2003.0,11,0,11
NCL,,2010.0,7,0,7
MKD,USA,2006.0,4,0,4
,GUY,2005.0,3,0,3
DEU,RWA,2016.0,1,0,1
BEL,RWA,2008.0,2,0,2
,BWA,2007.0,54,0,54
PER,PRT,2011.0,2,0,2
YEM,QAT,2016.0,1,0,1
IRN,TUN,2021.0,1,0,1
REU,,2015.0,2,0,2
NGA,COG,2019.0,6,0,6
,GLP,2014.0,5,0,5
SEN,CIV,2018.0,1,0,1
GHA,COD,2020.0,3,0,3
NIC,,2011.0,10,0,10
OMN,BWA,2016.0,1,0,1
HTI,,2016.0,5,0,5
EGY,YEM,2013.0,5,0,5
TWN,SVK,2022.0,1,0,1
BOL,,2014.0,26,0,26
MYS,ESP,2022.0,4,0,4
GTM,,2012.0,7,0,7
SGP,,2025.0,6,0,6
LIE,,2023.0,38,0,38
THA,MDV,2013.0,1,0,1
ARM,IRN,2017.0,3,0,3
ARG,NOR,2020.0,2,0,2
TUN,MRT,2014.0,1,0,1
,DJI,2014.0,2,0,2
HUN,CRI,2006.0,1,0,1
IRN,CZE,2022.0,12,0,12
MLT,CAN,2020.0,1,0,1
,GUF,2006.0,12,0,12
BHR,CAN,2002.0,1,0,1
BWA,,2006.0,8,0,8
ISR,PSE,2007.0,8,0,8
VEN,BRA,2018.0,9,0,9
DZA,BEL,1997.0,2,0,2
DNK,MOZ,2017.0,2,0,2
BGR,MKD,2006.0,2,0,2
CHN,ESP,1999.0,2,0,2
POL,IRQ,2001.0,1,0,1
CHE,BWA,2015.0,1,0,1
USA,KEN,1999.0,2,0,2
NLD,SYC,2018.0,1,0,1
EST,TUR,2009.0,1,0,1
ASM,,2022.0,4,0,4
,SUR,1999.0,1,0,1
BLR,UKR,2001.0,3,0,3
BRN,VEN,2020.0,1,0,1
MAR,PRT,2006.0,1,0,1
UGA,FJI,2011.0,1,0,1
,MTQ,2007.0,4,0,4
COG,TZA,2011.0,1,0,1
DEU,GAB,2012.0,3,0,3
POL,NPL,2013.0,1,0,1
IRN,HKG,2019.0,3,0,3
ESP,ARE,2011.0,1,0,1
IRN,SVK,2019.0,5,0,5
USA,LSO,2016.0,1,0,1
ETH,BEL,2004.0,1,0,1
KGZ,KAZ,2013.0,1,0,1
,GRL,2012.0,7,0,7
CHL,GTM,2019.0,1,0,1
,GIN,2002.0,8,0,8
LVA,RUS,2000.0,1,0,1
KHM,CHN,2021.0,1,0,1
,BHS,2015.0,4,0,4
HUN,SAU,2011.0,1,0,1
GBR,MMR,2017.0,1,0,1
ESP,UZB,2008.0,1,0,1
TZA,MDG,2018.0,1,0,1
,CAF,2012.0,7,0,7
KOR,AUT,2017.0,7,0,7
BTN,,2021.0,14,0,14
PER,URY,2010.0,1,0,1
BFA,GBR,2018.0,2,0,2
GMB,IND,2022.0,2,0,2
FRA,AGO,2011.0,1,0,1
,NER,2009.0,19,0,19
ITA,MTQ,2012.0,1,0,1
IND,FJI,2020.0,2,0,2
KAZ,FRA,2013.0,1,0,1
HKG,USA,2023.0,1,0,1
GTM,NLD,2015.0,1,0,1
SRB,ARE,2015.0,2,0,2
HKG,SEN,2010.0,1,0,1
RWA,NAM,2020.0,1,0,1
AFG,PER,2011.0,8,0,8
COL,JPN,2020.0,4,0,4
BRA,FLK,2018.0,1,0,1
CHN,QAT,2015.0,4,0,4
GBR,PAN,2006.0,2,0,2
CHN,UZB,2020.0,4,0,4
AUT,ZWE,2002.0,1,0,1
DEU,LIE,2002.0,3,0,3
HKG,SRB,2010.0,1,0,1
,SMR,1994.0,3,0,3
GRL,,2014.0,5,0,5
AUS,BWA,2015.0,1,0,1
DZA,DEU,2007.0,4,0,4
IDN,CHE,2009.0,2,0,2
QAT,SRB,2014.0,3,0,3
CAN,EGY,1998.0,2,0,2
SWE,MAC,2000.0,1,0,1
CAN,IRN,1999.0,6,0,6
ITA,SMR,2021.0,6,0,6
CHE,MEX,1997.0,1,0,1
FIN,BLR,2008.0,2,0,2
KWT,NOR,2007.0,1,0,1
FRA,BIH,2009.0,1,0,1
LTU,LVA,2005.0,1,0,1
ROU,EGY,2016.0,1,0,1
ECU,NLD,2002.0,1,0,1
FIN,AUS,1997.0,1,0,1
HKG,ITA,1999.0,1,0,1
KOR,MWI,2012.0,1,0,1
NZL,ROU,2004.0,1,0,1
,GNB,1999.0,1,0,1
SEN,ESP,2012.0,1,0,1
HKG,ARE,2014.0,1,0,1
ESP,NZL,2006.0,1,0,1
ESP,SVN,2007.0,2,0,2
AUT,PHL,2013.0,1,0,1
ZAF,JPN,2012.0,4,0,4
MYS,HRV,2012.0,1,0,1
MYS,SYR,2011.0,1,0,1
HKG,ARG,2015.0,1,0,1
TUN,TGO,2017.0,1,0,1
JPN,KHM,2020.0,6,0,6
DNK,IDN,2020.0,1,0,1
CYP,FRA,2004.0,1,0,1
EST,POL,2021.0,4,0,4
MDG,THA,2008.0,1,0,1
SMR,,2021.0,4,0,4
IND,PSE,2021.0,3,0,3
NPL,AUS,2002.0,2,0,2
,BEN,1994.0,3,0,3
GRC,KWT,2018.0,1,0,1
BGR,FIN,2003.0,1,0,1
FIN,THA,2005.0,1,0,1
ETH,MYS,2008.0,1,0,1
CHE,MNG,2011.0,1,0,1
JPN,SAU,2008.0,4,0,4
LTU,FIN,2002.0,2,0,2
IND,GAB,2009.0,1,0,1
BRA,FIN,2005.0,2,0,2
SEN,THA,1999.0,1,0,1
GBR,BTN,2017.0,1,0,1
AZE,UZB,1997.0,1,0,1
MDA,DEU,2009.0,3,0,3
BRA,IRL,2005.0,2,0,2
IRN,BHR,2006.0,1,0,1
,MCO,2003.0,5,0,5
NZL,IRN,2007.0,2,0,2
BEL,MCO,2013.0,2,0,2
WLF,FRA,2010.0,1,0,1
KGZ,DEU,2013.0,1,0,1
GBR,GIB,2007.0,1,0,1
TUR,PHL,2019.0,1,0,1
TUN,ARE,2001.0,1,0,1
PRT,AND,2009.0,1,0,1
KWT,QAT,2015.0,1,0,1
BRA,IRL,2002.0,2,0,2
NOR,BRA,2001.0,1,0,1
ARE,QAT,2004.0,1,0,1
SAU,OMN,2006.0,3,0,3
BHR,SWE,2019.0,1,0,1
NLD,CUW,2019.0,2,0,2
MLT,SVK,2007.0,1,0,1
MMR,SGP,2020.0,2,0,2
IRN,QAT,2018.0,1,0,1
CHL,ECU,2012.0,1,0,1
FIN,MMR,2017.0,3,0,3
PHL,CAN,2021.0,2,0,2
CRI,DNK,2015.0,1,0,1
BWA,KAZ,2017.0,2,0,2
VNM,PHL,2015.0,1,0,1
COL,ARE,2018.0,1,0,1
EGY,IND,2022.0,4,0,4
,GUY,2002.0,1,0,1
YEM,PAK,2018.0,1,0,1
GTM,URY,2016.0,1,0,1
KHM,MMR,2019.0,1,0,1
CUB,GBR,2017.0,2,0,2
DNK,ZMB,2001.0,1,0,1
SVN,ROU,2012.0,1,0,1
HUN,VNM,2012.0,1,0,1
SGP,CYP,2007.0,1,0,1
IRL,ROU,2012.0,2,0,2
KHM,SGP,2014.0,1,0,1
CZE,NGA,2015.0,2,0,2
MEX,BOL,2010.0,2,0,2
YEM,USA,2016.0,2,0,2
JPN,SYR,2005.0,1,0,1
KOR,JOR,2016.0,2,0,2
GHA,PER,2008.0,1,0,1
NGA,COD,2020.0,1,0,1
SRB,EGY,2021.0,1,0,1
PRT,CPV,2006.0,1,0,1
,MRT,2007.0,4,0,4
QAT,TZA,2021.0,1,0,1
MAR,MRT,2009.0,1,0,1
KWT,ITA,2016.0,1,0,1
MDA,ISR,2017.0,1,0,1
CHE,ARG,1998.0,1,0,1
ITA,KAZ,2007.0,1,0,1
PSE,EGY,2010.0,2,0,2
ITA,NGA,2010.0,3,0,3
GBR,PRI,2012.0,2,0,2
VNM,ESP,1999.0,1,0,1
BRB,FIN,2002.0,1,0,1
HUN,CZE,2014.0,4,0,4
,MHL,2002.0,1,0,1
NPL,USA,1998.0,1,0,1
ZAF,DZA,2013.0,2,0,2
NLD,LBY,2014.0,1,0,1
PSE,FIN,2012.0,1,0,1
ARM,DNK,2001.0,1,0,1
SWE,VNM,2006.0,1,0,1
RUS,NZL,2000.0,3,0,3
PER,NLD,2003.0,1,0,1
UZB,ITA,2005.0,2,0,2
MYS,QAT,2006.0,2,0,2
PNG,PAK,2005.0,1,0,1
AUS,KWT,2007.0,2,0,2
PRI,GUY,2006.0,1,0,1
MDA,GBR,2018.0,1,0,1
ARM,RUS,2013.0,2,0,2
HKG,MYS,2009.0,1,0,1
CHE,ISL,2021.0,1,0,1
MKD,FRA,2015.0,1,0,1
SRB,LBY,2013.0,2,0,2
DEU,LIE,2005.0,2,0,2
CUB,GBR,2010.0,1,0,1
IDN,CZE,2021.0,2,0,2
CZE,HRV,2005.0,2,0,2
SWE,PER,2021.0,1,0,1
NGA,TUR,2001.0,1,0,1
ERI,MYS,2014.0,1,0,1
BGR,ISR,2009.0,1,0,1
TUN,QAT,2021.0,2,0,2
GBR,MCO,2013.0,2,0,2
NOR,ISR,2010.0,1,0,1
KEN,TUN,2013.0,2,0,2
GNQ,CAN,2011.0,1,0,1
GAB,GMB,2007.0,1,0,1
LVA,ARG,2009.0,1,0,1
SLE,GBR,2013.0,2,0,2
JOR,SYR,2009.0,2,0,2
UKR,FIN,2002.0,2,0,2
HKG,IDN,2008.0,1,0,1
JPN,SVK,2012.0,2,0,2
ARE,CHN,2009.0,1,0,1
SVK,JOR,2001.0,1,0,1
IRQ,OMN,2008.0,1,0,1
SEN,TUN,2014.0,1,0,1
ITA,TWN,2015.0,5,0,5
ITA,SLE,2019.0,1,0,1
SVK,SDN,2015.0,1,0,1
ARE,PSE,2022.0,1,0,1
GIN,COG,2017.0,1,0,1
FIN,BWA,2004.0,1,0,1
ZWE,ZMB,2004.0,1,0,1
CZE,SGP,2006.0,1,0,1
UGA,GMB,2016.0,1,0,1
ETH,CHN,2014.0,1,0,1
POL,EST,2022.0,1,0,1
AUT,ARE,2010.0,2,0,2
GRC,SVN,2007.0,1,0,1
FIN,LUX,2021.0,1,0,1
MAR,CHE,2003.0,1,0,1
FRA,CAF,2009.0,3,0,3
SEN,BOL,1998.0,2,0,2
COG,ZAF,2021.0,1,0,1
,GRD,1998.0,1,0,1
ARG,BOL,2011.0,1,0,1
PHL,DEU,2007.0,2,0,2
BGD,ZWE,2022.0,1,0,1
BRN,ARE,2007.0,1,0,1
MNG,FIN,2019.0,2,0,2
RUS,CMR,2007.0,1,0,1
GRC,NGA,2019.0,1,0,1
GBR,MMR,2010.0,1,0,1
CHE,BTN,2013.0,1,0,1
PSE,ARE,2007.0,1,0,1
PRT,TTO,2012.0,1,0,1
MEX,PER,2002.0,1,0,1
ZWE,NGA,2003.0,1,0,1
MLT,KEN,2020.0,1,0,1
CAN,KWT,2000.0,1,0,1
TWN,CZE,2002.0,2,0,2
BLR,ITA,2000.0,1,0,1
MEX,PER,2005.0,2,0,2
DEU,AGO,2003.0,1,0,1
ARG,RUS,2003.0,4,0,4
NOR,GRL,2016.0,1,0,1
CIV,MLI,2006.0,1,0,1
KOR,OMN,2013.0,2,0,2
IND,SYR,2009.0,1,0,1
BEN,PHL,2014.0,1,0,1
LBY,NLD,2015.0,1,0,1
BGR,UKR,2017.0,1,0,1
DNK,PRI,2017.0,1,0,1
SEN,DEU,2018.0,1,0,1
GBR,GUY,2018.0,1,0,1
SEN,GHA,2011.0,1,0,1
BMU,DEU,2011.0,1,0,1
PAK,CZE,2015.0,2,0,2
GLP,USA,2009.0,1,0,1
ESP,PSE,2009.0,1,0,1
KEN,THA,2007.0,2,0,2
NGA,ZMB,2019.0,2,0,2
ZAF,VNM,2018.0,1,0,1
SDN,QAT,2021.0,1,0,1
HRV,LTU,2004.0,1,0,1
CZE,SRB,2010.0,1,0,1
USA,KHM,2011.0,1,0,1
IRQ,IND,2004.0,1,0,1
USA,GMB,2007.0,2,0,2
CHN,CMR,2010.0,1,0,1
GMB,CMR,2022.0,1,0,1
CZE,IDN,2014.0,1,0,1
ARM,CHN,2015.0,1,0,1
ISL,LKA,2015.0,1,0,1
IND,ECU,2016.0,1,0,1
BLR,SWE,2016.0,1,0,1
ALB,ESP,2016.0,1,0,1
THA,MNG,2019.0,1,0,1
KEN,BRA,2019.0,1,0,1
IRN,FIN,2008.0,2,0,2
TUN,IRL,2012.0,1,0,1
,LIE,1999.0,2,0,2
COD,CHN,2022.0,1,0,1
NPL,ARE,2017.0,1,0,1
MWI,IND,2020.0,1,0,1
AUS,TZA,2006.0,1,0,1
SEN,LBR,2022.0,1,0,1
JPN,SVN,2006.0,1,0,1
LUX,ISR,2008.0,1,0,1
CIV,SEN,2004.0,1,0,1
CMR,BOL,2009.0,1,0,1
PAN,AUS,2001.0,1,0,1
THA,TUR,2013.0,1,0,1
BFA,KEN,2007.0,1,0,1
PAK,THA,2009.0,1,0,1
VNM,HUN,1998.0,1,0,1
GUY,GUF,2007.0,1,0,1
HRV,MEX,2016.0,1,0,1
POL,UZB,2019.0,1,0,1
CHE,MAC,2019.0,1,0,1
IRL,BGR,2018.0,2,0,2
AZE,SAU,2020.0,1,0,1
FRA,GEO,2006.0,1,0,1
IRN,KEN,2021.0,1,0,1
MDG,JPN,2015.0,1,0,1
SYR,TUR,2013.0,2,0,2
GIN,COG,2019.0,2,0,2
KOR,ECU,2016.0,1,0,1
,TLS,2009.0,1,0,1
TWN,MYS,2006.0,1,0,1
TZA,JPN,2016.0,2,0,2
ISR,GRC,2005.0,1,0,1
JAM,BRB,2004.0,1,0,1
NAM,AUS,2018.0,1,0,1
BIH,MNG,2009.0,1,0,1
SVK,ROU,2020.0,2,0,2
RWA,ETH,2008.0,1,0,1
PAN,JPN,2002.0,1,0,1
LBR,,2015.0,1,0,1
CYP,POL,2012.0,1,0,1
BRA,HUN,2018.0,2,0,2
KWT,ZAF,2018.0,1,0,1
SEN,MAR,2015.0,1,0,1
EGY,SVK,2000.0,1,0,1
PHL,CHN,2001.0,1,0,1
SWE,IDN,2005.0,1,0,1
ISR,FIN,2013.0,2,0,2
ZAF,COL,2005.0,1,0,1
CUW,NLD,2009.0,2,0,2
HKG,IRN,2007.0,2,0,2
MDA,JOR,2007.0,1,0,1
PNG,GHA,2008.0,1,0,1
BRA,MWI,2014.0,1,0,1
HUN,ARM,2013.0,1,0,1
NLD,KAZ,2016.0,1,0,1
PRT,KHM,2020.0,1,0,1
USA,HND,2013.0,1,0,1
KOR,BLR,2001.0,2,0,2
CHE,ARG,1997.0,1,0,1
SWE,LAO,2013.0,1,0,1
PNG,USA,2022.0,1,0,1
AFG,DEU,2021.0,1,0,1
BTN,OMN,2020.0,1,0,1
CUB,AUT,2021.0,1,0,1
NLD,TJK,2020.0,1,0,1
ISL,ARE,2016.0,1,0,1
AZE,CAN,2019.0,1,0,1
TJK,UZB,2019.0,1,0,1
LVA,CAN,2016.0,1,0,1
BRN,DEU,2020.0,2,0,2
CAN,SVK,1998.0,1,0,1
COG,JPN,2014.0,1,0,1
SYC,FRA,2016.0,1,0,1
NGA,AUT,2007.0,1,0,1
ESP,HRV,2007.0,1,0,1
JPN,SDN,2006.0,1,0,1
GBR,NCL,2014.0,1,0,1
SGP,PRI,2013.0,1,0,1
LKA,NLD,2001.0,2,0,2
REU,ROU,2002.0,1,0,1
BGR,CHL,2003.0,1,0,1
PAN,POL,2000.0,1,0,1
AZE,ESP,2002.0,1,0,1
ZAF,FJI,2014.0,1,0,1
FIN,SGP,2010.0,1,0,1
COG,KOR,2018.0,1,0,1
CHN,BDI,2022.0,1,0,1
SYC,DEU,2016.0,1,0,1
FIN,KAZ,2016.0,2,0,2
GBR,BFA,2006.0,1,0,1
CHL,ZAF,2005.0,1,0,1
ZAF,PRI,2019.0,1,0,1
QAT,EGY,2005.0,2,0,2
FIN,CHL,1999.0,1,0,1
FRA,TTO,2016.0,1,0,1
HTI,GBR,2020.0,1,0,1
BFA,COD,2020.0,1,0,1
ARE,NLD,2001.0,1,0,1
ARG,AGO,2001.0,1,0,1
NGA,BEL,2021.0,1,0,1
NLD,VEN,2018.0,1,0,1
GBR,MUS,2002.0,1,0,1
CAF,,2005.0,1,0,1
NGA,ZMB,2017.0,1,0,1
SWE,ERI,2002.0,1,0,1
ITA,BIH,2005.0,1,0,1
ROU,BRA,2011.0,1,0,1
JPN,GTM,2007.0,1,0,1
DEU,MDG,2020.0,1,0,1
AUS,PSE,2014.0,1,0,1
DNK,BGR,2009.0,1,0,1
VEN,ECU,2010.0,1,0,1
MAR,SAU,2007.0,1,0,1
IRN,SAU,2013.0,1,0,1
NGA,SWZ,2012.0,1,0,1
SWZ,ZWE,1997.0,1,0,1
IND,UKR,2022.0,1,0,1
SVN,PER,2020.0,1,0,1
IND,CHL,2008.0,1,0,1
BEL,VEN,2014.0,1,0,1
FRA,KEN,2006.0,1,0,1
JOR,FIN,2021.0,1,0,1
PNG,CHE,2015.0,1,0,1
PRT,JOR,2016.0,1,0,1
IND,SEN,2022.0,1,0,1
USA,AUS,2015.0,594,513,81
FIN,SWE,2015.0,60,49,11
IND,AUS,2011.0,68,43,25
GBR,AUS,2016.0,575,530,45
KOR,IND,2008.0,34,116,-82
JPN,USA,2011.0,869,908,-39
DEU,TWN,2012.0,14,20,-6
GBR,ITA,2012.0,230,397,-167
AUS,KOR,2013.0,34,33,1
FRA,ESP,2016.0,185,302,-117
AUT,USA,2012.0,117,105,12
SWE,ESP,2015.0,26,90,-64
BEL,USA,2019.0,178,149,29
CAN,JOR,2005.0,3,4,-1
GBR,CHE,2010.0,199,172,27
FRA,BRA,2015.0,112,93,19
AUS,GBR,2007.0,366,442,-76
ESP,DEU,1999.0,41,30,11
NOR,USA,2011.0,45,68,-23
LBN,EGY,2008.0,3,3,0
BRA,USA,2009.0,366,258,108
UKR,DEU,2020.0,19,7,12
ISR,CAN,2015.0,51,57,-6
KOR,USA,2014.0,731,971,-240
USA,THA,2012.0,205,101,104
RUS,USA,2004.0,251,180,71
CAN,AUS,2011.0,191,130,61
JPN,IND,2015.0,66,70,-4
BEL,USA,2010.0,127,116,11
JOR,DEU,2010.0,8,10,-2
PRT,UKR,2008.0,1,3,-2
USA,PER,2011.0,29,27,2
USA,ZAF,2016.0,89,103,-14
DEU,ROU,2006.0,17,22,-5
USA,PRI,2004.0,45,47,-2
GBR,FRA,2009.0,286,347,-61
SAU,ARE,2016.0,33,13,20
ZAF,USA,2005.0,55,68,-13
GBR,CHN,2016.0,395,305,90
URY,FRA,2018.0,3,4,-1
DEU,KOR,2020.0,49,71,-22
GBR,CHE,2019.0,298,260,38
CHE,ITA,2007.0,63,102,-39
NZL,USA,2009.0,119,108,11
GBR,SEN,2010.0,3,1,2
BRA,ESP,2015.0,69,130,-61
BRA,DEU,2005.0,41,32,9
CHE,SWE,2013.0,53,34,19
FRA,AUS,2002.0,58,37,21
ROU,ESP,2018.0,9,4,5
ITA,GBR,2005.0,189,159,30
CHL,USA,2011.0,92,83,9
ESP,COL,2005.0,21,10,11
CHN,USA,2020.0,2893,2985,-92
BGR,DEU,2007.0,11,16,-5
CUB,ITA,2012.0,3,1,2
IND,KOR,2010.0,150,86,64
POL,SWE,2016.0,18,14,4
SGP,AUS,2011.0,66,48,18
AUS,SGP,2013.0,68,82,-14
FRA,CHN,2005.0,39,28,11
USA,JOR,2022.0,15,18,-3
LUX,FRA,2012.0,18,34,-16
ARG,ESP,2004.0,69,28,41
HKG,USA,2011.0,86,110,-24
CAN,EGY,2008.0,19,20,-1
BFA,FRA,2008.0,8,8,0
CHN,IND,2014.0,30,57,-27
DEU,AUS,2004.0,87,62,25
NLD,SVN,2017.0,5,4,1
CHN,JPN,2015.0,267,508,-241
JPN,THA,2015.0,99,48,51
GBR,CHE,2017.0,276,217,59
IND,KOR,2017.0,240,130,110
AUS,USA,2000.0,137,107,30
HUN,GBR,2013.0,31,25,6
CAN,CHN,2020.0,366,302,64
PAK,IND,2018.0,29,26,3
AUS,CHN,2012.0,125,175,-50
KEN,ZAF,2017.0,9,17,-8
THA,USA,2014.0,93,219,-126
DEU,ITA,2015.0,173,279,-106
RUS,ESP,2020.0,14,6,8
DEU,BGD,2010.0,2,3,-1
TWN,VNM,2015.0,23,2,21
USA,KOR,2000.0,163,152,11
MNG,USA,2015.0,4,4,0
CZE,USA,2015.0,43,57,-14
CHE,GBR,2016.0,247,281,-34
ITA,CHE,2013.0,208,108,100
CHN,AUS,1998.0,11,4,7
ESP,BEL,2008.0,38,21,17
ZAF,IND,2015.0,30,68,-38
CHE,AUS,2018.0,56,65,-9
MYS,BGD,2017.0,56,18,38
USA,RUS,2018.0,145,152,-7
RUS,CHN,2011.0,10,6,4
DEU,IDN,2021.0,14,15,-1
GBR,NLD,2022.0,129,98,31
IRL,NZL,2019.0,12,9,3
FRA,MDG,2020.0,9,6,3
IND,JPN,2015.0,70,66,4
AUS,PRT,2016.0,7,11,-4
POL,DEU,2014.0,164,70,94
UKR,USA,2018.0,29,14,15
CHN,GBR,2021.0,392,506,-114
MYS,NZL,2015.0,25,25,0
PAK,JPN,2018.0,9,8,1
NLD,THA,2015.0,14,5,9
CAN,ISR,2008.0,20,49,-29
ESP,JPN,2015.0,24,10,14
USA,NOR,2020.0,99,55,44
CHL,GBR,2015.0,24,31,-7
FRA,ISR,2020.0,25,25,0
GBR,ARE,2015.0,43,10,33
BGD,GBR,2017.0,21,17,4
IND,MYS,2013.0,73,33,40
MTQ,FRA,2011.0,11,22,-11
NLD,IND,2015.0,25,35,-10
ZAF,GBR,2022.0,51,39,12
IND,SGP,2021.0,53,53,0
NLD,NOR,2016.0,41,16,25
IRN,AUS,2007.0,18,22,-4
BGD,SGP,2016.0,3,1,2
DEU,SAU,2021.0,14,13,1
ISR,AUS,2019.0,19,13,6
USA,KAZ,2017.0,18,12,6
USA,BEL,2006.0,102,113,-11
AUS,ITA,2016.0,38,54,-16
BLR,FRA,2016.0,2,1,1
KEN,CHN,2016.0,3,3,0
SWE,SGP,2017.0,9,11,-2
NPL,CHN,2018.0,12,16,-4
LBN,USA,2016.0,69,56,13
FRA,NLD,2016.0,89,109,-20
FIN,RUS,2015.0,23,20,3
ISR,USA,2022.0,116,141,-25
GRC,BEL,2016.0,22,9,13
THA,IDN,2019.0,17,5,12
USA,NZL,2016.0,87,136,-49
PRT,CHE,2014.0,25,13,12
BEL,SWE,2016.0,27,26,1
ITA,CHL,2018.0,20,10,10
USA,SGP,2003.0,113,107,6
NZL,GBR,2020.0,104,118,-14
SRB,HUN,2016.0,5,3,2
NOR,VEN,2016.0,1,1,0
DNK,CHN,2016.0,50,53,-3
NGA,BRA,2018.0,5,6,-1
USA,IRQ,2020.0,59,5,54
KEN,ZAF,2019.0,16,22,-6
TUR,PAK,2019.0,19,6,13
CAN,PRT,2020.0,9,14,-5
ITA,GBR,2002.0,223,205,18
ITA,GRC,2021.0,22,19,3
JPN,KAZ,2020.0,2,2,0
DNK,IRN,2020.0,8,36,-28
BLR,RUS,2020.0,14,9,5
ZWE,FRA,2020.0,2,1,1
KAZ,USA,2022.0,11,4,7
GBR,LKA,2021.0,9,12,-3
ZAF,NAM,2021.0,11,2,9
FRA,CHN,2002.0,24,38,-14
MEX,FRA,2007.0,29,43,-14
MYS,BGD,2019.0,54,21,33
RUS,GBR,2010.0,37,31,6
SDN,SAU,2020.0,29,14,15
FIN,GBR,2018.0,55,66,-11
GBR,DNK,2015.0,100,97,3
KOR,CHN,2006.0,45,41,4
BGD,JPN,2011.0,37,63,-26
ISR,CHE,2020.0,18,11,7
MEX,CHL,2014.0,17,8,9
IRQ,SWE,2016.0,4,4,0
AUS,CHE,2006.0,37,39,-2
USA,ZMB,2014.0,15,12,3
USA,IRL,2005.0,90,68,22
GRC,ITA,2013.0,37,16,21
SGP,ITA,2014.0,12,13,-1
THA,DEU,2007.0,12,8,4
QAT,TUR,2017.0,2,4,-2
CHL,BRA,2007.0,10,12,-2
HUN,ITA,2010.0,11,9,2
MYS,BGD,2010.0,6,11,-5
CHE,ROU,2009.0,4,4,0
CZE,DEU,2011.0,42,32,10
USA,CHL,2006.0,62,64,-2
GRC,FRA,2012.0,34,22,12
ITA,CAN,2016.0,65,37,28
NPL,JPN,2009.0,4,7,-3
IRN,ZAF,2014.0,6,3,3
SWE,IRN,2010.0,15,22,-7
TUR,CAN,2011.0,18,21,-3
MEX,ARG,2008.0,10,9,1
THA,IDN,2010.0,3,2,1
SGP,JPN,2006.0,11,12,-1
CHN,DEU,1999.0,43,33,10
SGP,DEU,2007.0,9,15,-6
CYP,USA,2016.0,12,9,3
DEU,ISR,2000.0,24,11,13
CAN,CHE,2006.0,52,59,-7
SWE,DEU,2003.0,83,83,0
DEU,FRA,2003.0,232,245,-13
NLD,USA,2001.0,198,183,15
IRN,AUT,2015.0,9,10,-1
NLD,BEL,2003.0,78,97,-19
ESP,PRT,2021.0,85,71,14
POL,NOR,2016.0,10,5,5
RUS,GBR,2017.0,37,37,0
IND,CHN,2022.0,34,68,-34
FRA,ITA,2003.0,159,155,4
USA,ECU,2009.0,12,5,7
DEU,ESP,2002.0,79,98,-19
FRA,MEX,2003.0,41,20,21
IRN,TWN,2021.0,9,1,8
TUR,UKR,2001.0,3,2,1
DEU,ARG,2013.0,21,25,-4
ISR,AUS,2010.0,13,9,4
DEU,HRV,2014.0,13,12,1
BRA,DEU,2002.0,35,41,-6
UGA,PER,2017.0,1,1,0
IND,ITA,2003.0,20,12,8
ISR,DNK,2018.0,6,2,4
CZE,SVK,2020.0,38,68,-30
IRL,JPN,2001.0,2,6,-4
DEU,NOR,2022.0,35,21,14
JPN,GBR,2011.0,90,104,-14
AUS,BRA,2014.0,16,41,-25
RUS,TJK,2018.0,4,3,1
GBR,AUT,2019.0,95,95,0
DEU,IRL,2015.0,47,39,8
PRT,BRA,2012.0,70,60,10
SWE,FIN,2005.0,21,26,-5
SGP,ISR,2020.0,7,2,5
CAN,FIN,2022.0,6,5,1
TUR,ESP,2020.0,10,14,-4
JOR,DEU,2019.0,11,9,2
DEU,IND,2001.0,34,42,-8
USA,MWI,2011.0,8,4,4
RWA,ZAF,2022.0,1,2,-1
USA,ARE,2018.0,110,52,58
SVK,USA,2000.0,12,7,5
THA,MMR,2021.0,3,2,1
NGA,MYS,2022.0,22,30,-8
THA,IDN,2017.0,8,3,5
RUS,FIN,2019.0,22,16,6
DEU,ZAF,2021.0,17,36,-19
UKR,AUT,2019.0,4,3,1
CRI,BRA,2021.0,2,3,-1
KOR,MEX,2006.0,1,1,0
KHM,USA,2009.0,4,1,3
IRN,DNK,2014.0,23,3,20
ISL,SWE,2015.0,13,20,-7
GBR,BEL,2004.0,44,59,-15
ITA,FRA,1998.0,48,56,-8
SWE,IND,2018.0,22,68,-46
PRI,USA,2003.0,44,37,7
DEU,DNK,2002.0,65,47,18
NLD,TUR,2018.0,12,31,-19
ESP,ARG,2014.0,69,59,10
JPN,CAN,2011.0,90,74,16
JPN,NGA,2016.0,2,4,-2
RUS,NLD,2011.0,15,12,3
CZE,IND,2018.0,10,15,-5
BEL,PER,2016.0,3,2,1
PER,BOL,2022.0,1,1,0
RUS,SWE,2014.0,12,15,-3
ETH,KOR,2013.0,2,1,1
FIN,AUS,2008.0,16,4,12
FIN,EST,2020.0,15,12,3
BEL,DZA,2010.0,3,1,2
FRA,COG,2003.0,2,3,-1
GBR,AUT,2010.0,58,62,-4
MAR,SEN,2008.0,1,2,-1
GBR,BRA,2003.0,43,39,4
PRT,ESP,2009.0,49,50,-1
BIH,HRV,2002.0,3,3,0
ZAF,USA,2002.0,72,69,3
SWE,FIN,2002.0,33,38,-5
DNK,SWE,2001.0,36,30,6
BRA,CAN,2003.0,28,31,-3
BIH,HRV,2005.0,5,11,-6
NLD,FRA,1998.0,15,23,-8
BEL,EGY,2006.0,2,4,-2
USA,HRV,2009.0,13,12,1
RUS,CAN,2000.0,22,4,18
FRA,GRC,2001.0,18,11,7
JPN,ROU,2005.0,5,2,3
DJI,FRA,2010.0,4,5,-1
CAN,NZL,1998.0,8,1,7
LKA,GBR,2009.0,4,11,-7
UKR,AUT,2017.0,4,1,3
USA,ROU,2006.0,18,28,-10
AUS,ISR,2006.0,6,5,1
IDN,BEL,2007.0,1,1,0
GBR,ISR,1998.0,14,9,5
CAN,NLD,2001.0,30,26,4
ITA,BRA,1998.0,12,2,10
SEN,GMB,2005.0,1,1,0
CYP,GRC,2006.0,4,9,-5
RUS,POL,2014.0,11,11,0
NCL,NZL,2015.0,2,1,1
SWE,LVA,2006.0,5,2,3
DEU,SVN,2005.0,3,8,-5
ESP,AUT,2007.0,7,9,-2
DNK,NOR,2008.0,19,19,0
ISR,GBR,1998.0,9,14,-5
USA,LBN,1999.0,16,1,15
IRN,USA,1997.0,1,2,-1
POL,CHE,2003.0,12,11,1
USA,IRL,2002.0,71,77,-6
EGY,CAN,2005.0,9,8,1
BEL,ZAF,2001.0,6,5,1
CHE,ARG,2008.0,4,1,3
CAN,BRA,2001.0,20,16,4
GHA,DEU,2013.0,4,8,-4
FIN,ESP,2010.0,13,8,5
CAN,SRB,2016.0,4,2,2
CHN,ZAF,2014.0,11,5,6
DEU,DNK,2005.0,48,42,6
USA,ISL,2006.0,23,9,14
FRA,ZWE,2008.0,1,1,0
KEN,UGA,2020.0,11,13,-2
JPN,NZL,2007.0,9,4,5
FIN,ESP,2017.0,13,17,-4
ITA,BRA,1997.0,8,3,5
KEN,SEN,2021.0,2,1,1
USA,GUM,2022.0,2,2,0
ISR,FRA,2014.0,17,24,-7
SRB,CHE,2008.0,2,2,0
BEL,PRT,2018.0,11,18,-7
POL,CZE,2022.0,9,10,-1
JPN,DEU,1997.0,13,14,-1
ESP,FIN,2011.0,16,13,3
CHE,CAN,2009.0,77,85,-8
ISR,AUT,2006.0,2,2,0
UKR,POL,1998.0,6,4,2
SRB,USA,2013.0,9,12,-3
BRA,GBR,2000.0,11,21,-10
RUS,CHE,1998.0,10,1,9
MEX,AUS,2015.0,23,4,19
KOR,SGP,2007.0,5,14,-9
BGR,ITA,2006.0,8,2,6
NLD,SGP,2016.0,19,15,4
DEU,PAK,2002.0,4,5,-1
EGY,KWT,2012.0,11,7,4
USA,EST,2013.0,6,6,0
NLD,MEX,1998.0,3,1,2
ESP,COL,2002.0,12,6,6
ISR,GBR,1997.0,8,2,6
SAU,USA,2009.0,33,82,-49
GRC,DEU,2000.0,9,20,-11
DEU,BEL,2004.0,42,59,-17
RUS,CHE,1997.0,7,3,4
BOL,USA,2018.0,2,7,-5
DEU,UKR,2012.0,9,24,-15
FRA,URY,2014.0,5,1,4
NOR,ZAF,2013.0,3,1,2
AUT,KOR,2010.0,3,3,0
AUS,PAK,2011.0,7,26,-19
GBR,KOR,2007.0,40,30,10
CHN,AUS,1997.0,3,2,1
NPL,IND,2008.0,17,18,-1
USA,KNA,2020.0,2,5,-3
CAN,BEL,2012.0,20,29,-9
CAN,SGP,2006.0,22,19,3
USA,OMN,2015.0,7,2,5
DEU,CZE,2014.0,46,47,-1
NOR,NLD,2008.0,10,21,-11
IRL,NOR,2015.0,5,1,4
MEX,COL,2009.0,2,7,-5
CAN,AUT,2011.0,22,17,5
ITA,HUN,2020.0,10,8,2
FRA,ECU,2011.0,6,4,2
EGY,KEN,2009.0,3,1,2
SRB,MKD,2008.0,11,5,6
AUS,AUT,2008.0,17,16,1
NOR,ISL,2018.0,5,4,1
UGA,NGA,2011.0,1,3,-2
USA,MLT,2021.0,3,2,1
COG,USA,2006.0,1,2,-1
NZL,NOR,2009.0,3,3,0
PAK,IRN,2006.0,1,1,0
SVK,FRA,1999.0,2,3,-1
CUB,BEL,2016.0,3,1,2
KEN,ZAF,2010.0,13,9,4
SWE,EST,2011.0,9,3,6
HUN,ITA,2019.0,10,8,2
NLD,DNK,2004.0,9,17,-8
NLD,SVK,2011.0,1,8,-7
MEX,ITA,2012.0,10,11,-1
NZL,IND,2007.0,2,4,-2
ROU,DEU,2011.0,16,22,-6
BGD,GBR,2019.0,14,21,-7
ECU,ESP,2012.0,6,3,3
THA,AUS,2013.0,18,35,-17
NZL,DEU,2007.0,22,28,-6
CMR,DEU,2008.0,3,2,1
KEN,NLD,2015.0,5,7,-2
ESP,CZE,2014.0,22,6,16
TUR,DNK,2021.0,5,3,2
TWN,AUS,2020.0,22,14,8
ITA,LUX,2019.0,10,8,2
CHE,FIN,2020.0,14,11,3
FIN,ESP,2019.0,22,28,-6
RWA,USA,2008.0,2,1,1
FRA,NCL,2016.0,21,11,10
JPN,ZAF,2019.0,3,5,-2
NOR,PRT,2014.0,2,13,-11
TUR,FIN,2020.0,9,1,8
NZL,MYS,2012.0,13,9,4
USA,KAZ,2019.0,18,23,-5
OMN,GBR,2018.0,9,15,-6
SVN,SRB,2017.0,3,2,1
NOR,CAN,2021.0,10,20,-10
HUN,PAK,2014.0,1,2,-1
NLD,IDN,2015.0,15,14,1
GRC,BGR,2010.0,2,1,1
PAN,GBR,2020.0,4,2,2
MWI,CAN,2017.0,2,1,1
AUT,ZAF,2015.0,6,3,3
GRC,BGR,2017.0,4,1,3
ZAF,CZE,2021.0,2,1,1
AUS,HKG,2021.0,25,35,-10
VNM,PAK,2019.0,1,4,-3
PRT,PER,2016.0,2,1,1
FRA,TGO,2017.0,5,2,3
HUN,EGY,2020.0,6,2,4
CAN,DNK,2022.0,9,6,3
RUS,FIN,2017.0,17,19,-2
USA,SEN,2015.0,5,4,1
CAN,SVN,2016.0,1,1,0
FRA,UGA,2017.0,1,2,-1
ROU,TUR,2019.0,2,2,0
SWE,SAU,2009.0,2,2,0
NZL,FRA,2021.0,9,11,-2
ITA,ARG,2015.0,14,16,-2
AUT,ITA,2013.0,34,41,-7
FRA,NER,2019.0,4,2,2
FRA,LAO,2006.0,3,1,2
BGR,GBR,2004.0,8,6,2
USA,CMR,2001.0,8,3,5
DEU,BLR,1998.0,3,4,-1
TUR,JPN,2002.0,8,9,-1
SWE,CAN,1999.0,11,12,-1
USA,SWE,1997.0,29,28,1
FIN,DNK,1998.0,4,4,0
POL,RUS,2008.0,8,10,-2
FIN,CHN,2003.0,8,8,0
RUS,FIN,2010.0,24,9,15
DNK,CHE,2016.0,35,30,5
ITA,SVN,2012.0,8,4,4
UGA,ITA,2017.0,4,3,1
URY,ESP,2009.0,7,7,0
SVN,CHE,2018.0,7,6,1
SWE,IRN,2019.0,15,66,-51
PHL,DNK,2020.0,1,1,0
BEL,SVK,2018.0,3,1,2
OMN,AUS,2015.0,4,6,-2
TWN,CHE,2009.0,2,4,-2
CHN,AUT,2021.0,14,16,-2
DEU,BGD,2019.0,6,6,0
IRN,USA,1998.0,3,3,0
URY,NLD,2018.0,2,1,1
COL,FRA,2002.0,6,1,5
GHA,AUS,2011.0,1,2,-1
HUN,SWE,2012.0,12,3,9
CIV,GHA,2020.0,1,1,0
IRN,IRQ,2014.0,4,1,3
GBR,KWT,2013.0,15,4,11
MKD,CZE,2019.0,1,1,0
MYS,JPN,2007.0,9,16,-7
ESP,KEN,2021.0,3,2,1
SGP,AUT,2020.0,3,1,2
TUR,IRQ,2015.0,6,4,2
CAN,SWE,2022.0,11,20,-9
COL,NLD,2018.0,11,5,6
NZL,DNK,2022.0,2,2,0
NPL,USA,2008.0,8,5,3
TUR,MAR,2021.0,3,3,0
MYS,IND,2005.0,7,18,-11
KHM,NLD,2021.0,1,3,-2
GRD,USA,2022.0,7,2,5
JPN,TUN,2016.0,8,1,7
KEN,GBR,2014.0,10,21,-11
USA,PAN,2020.0,16,15,1
FIN,TUR,2022.0,1,5,-4
DNK,POL,2021.0,5,3,2
ETH,GHA,2019.0,1,1,0
ESP,AND,2017.0,4,1,3
USA,CYP,2016.0,9,12,-3
GBR,DZA,2012.0,2,3,-1
DEU,BOL,2004.0,1,2,-1
TUR,SWE,2015.0,10,11,-1
NGA,KWT,2010.0,1,1,0
LAO,FRA,2018.0,3,3,0
ZWE,AUS,2007.0,2,1,1
NLD,POL,2000.0,3,3,0
USA,KAZ,2010.0,3,2,1
USA,SYR,2013.0,1,8,-7
DEU,CUB,1998.0,3,1,2
BEL,SRB,2018.0,2,3,-1
BRA,COL,2009.0,8,10,-2
AUS,OMN,2014.0,6,1,5
JPN,ZAF,2010.0,4,2,2
SWE,SGP,2010.0,8,4,4
PHL,CHN,2004.0,1,1,0
ROU,IND,2019.0,3,3,0
CHN,DNK,2000.0,5,1,4
ESP,AUS,1999.0,5,4,1
NPL,GBR,2016.0,7,3,4
AUT,IRN,2016.0,6,15,-9
GIN,FRA,2002.0,5,1,4
NOR,ESP,2005.0,6,5,1
SWE,BLR,2005.0,1,2,-1
ISR,AUS,2017.0,24,13,11
IRL,ARG,2011.0,3,1,2
SVN,GBR,2009.0,4,14,-10
THA,ITA,2016.0,3,6,-3
BEL,DZA,2019.0,5,2,3
SWE,SGP,2019.0,8,14,-6
AUT,AUS,2007.0,13,9,4
SWE,AUT,2014.0,16,15,1
KOR,NZL,2008.0,3,2,1
BFA,SWE,2012.0,1,1,0
NOR,ESP,2002.0,6,5,1
MAR,DEU,2008.0,1,4,-3
ARE,KOR,2011.0,1,1,0
SWE,UKR,2015.0,4,5,-1
KOR,NLD,2008.0,4,2,2
BLR,POL,2021.0,2,2,0
FJI,NZL,2012.0,3,1,2
GBR,LBN,2013.0,6,6,0
SRB,BGR,2014.0,1,2,-1
AUS,MKD,2014.0,1,1,0
COL,GBR,2022.0,6,9,-3
ESP,TWN,2016.0,5,3,2
BEL,SAU,2014.0,4,1,3
CAN,CHL,2013.0,11,16,-5
PSE,ISR,2003.0,4,4,0
IRL,MYS,2015.0,9,3,6
BEL,NOR,2020.0,13,6,7
EGY,TUR,2019.0,3,3,0
UKR,MEX,2020.0,1,1,0
GRC,ARE,2016.0,7,1,6
MEX,UKR,2012.0,1,1,0
JPN,ZMB,2022.0,2,1,1
PRY,BRA,2020.0,2,4,-2
SVK,DEU,2021.0,6,4,2
CRI,DEU,2016.0,8,7,1
CHE,CRI,2020.0,4,1,3
NZL,SGP,2021.0,6,8,-2
QAT,SDN,2017.0,1,1,0
KOR,SWE,2005.0,3,3,0
DNK,TZA,2014.0,3,1,2
VEN,ESP,2022.0,1,1,0
AUT,SGP,2017.0,4,2,2
DEU,CHL,2011.0,17,22,-5
SYR,SAU,2016.0,2,1,1
ITA,HRV,2011.0,4,2,2
DNK,EST,2017.0,4,1,3
RUS,NOR,2009.0,8,5,3
NGA,BEN,2006.0,1,1,0
IND,IDN,2009.0,2,2,0
AUS,ARG,2013.0,4,4,0
DNK,BRA,2015.0,8,12,-4
IRL,NZL,2017.0,6,6,0
JPN,BEL,2018.0,11,15,-4
SGP,BEL,2009.0,3,6,-3
HKG,KOR,2001.0,2,3,-1
PER,BRA,2006.0,2,4,-2
AUS,ETH,2022.0,4,12,-8
MEX,JPN,2009.0,6,2,4
FRA,CUB,2009.0,3,1,2
SAU,BEL,2013.0,1,2,-1
ESP,IRL,2002.0,7,3,4
GBR,UKR,2013.0,6,7,-1
BRA,ISR,2012.0,2,6,-4
AUT,CZE,2011.0,6,10,-4
USA,GEO,2022.0,4,3,1
EGY,CAN,2002.0,8,2,6
USA,ETH,2012.0,10,13,-3
FRA,AUS,2005.0,36,33,3
MYS,USA,2001.0,7,8,-1
IDN,ITA,2012.0,1,2,-1
SVN,SRB,2010.0,2,4,-2
FRA,SAU,2008.0,3,3,0
ZAF,ROU,2012.0,1,2,-1
ROU,ITA,2011.0,5,7,-2
GRC,BGR,2019.0,1,1,0
THA,ETH,2013.0,1,1,0
THA,ESP,2013.0,1,1,0
JPN,ISR,2017.0,4,10,-6
SWE,IRN,2017.0,8,33,-25
AUT,KOR,2019.0,6,3,3
CAN,ISL,2018.0,3,3,0
SDN,TUR,2019.0,3,1,2
CHN,KGZ,2021.0,2,1,1
NZL,FJI,2003.0,5,2,3
JPN,AFG,2021.0,2,2,0
MDG,GBR,2021.0,2,1,1
DEU,CRI,2005.0,2,1,1
CHE,SWZ,2017.0,1,2,-1
AUS,BGD,2003.0,3,2,1
CAN,JOR,2002.0,3,2,1
CHL,FRA,1999.0,4,9,-5
NLD,JPN,2002.0,16,24,-8
NLD,ZWE,2004.0,2,1,1
ARG,AUT,1999.0,1,1,0
ESP,CUB,1999.0,4,12,-8
DNK,GRL,2009.0,6,4,2
DEU,LUX,2000.0,1,1,0
ESP,HKG,2005.0,1,2,-1
AUT,SGP,2010.0,3,1,2
ZAF,NZL,1999.0,4,1,3
BHR,USA,2007.0,3,2,1
JPN,ZAF,2017.0,3,6,-3
KOR,UKR,2012.0,4,1,3
IND,ZAF,2002.0,5,9,-4
KOR,SWE,2002.0,3,5,-2
NZL,CHL,2004.0,1,3,-2
CHL,CHE,2007.0,2,3,-1
AUT,BRA,2005.0,5,2,3
JPN,HUN,2009.0,7,3,4
BRA,JPN,2006.0,9,12,-3
DEU,PAK,2005.0,1,4,-3
GBR,MAR,2013.0,2,1,1
DEU,BGD,2017.0,12,6,6
IRL,TUR,2017.0,1,2,-1
LKA,HKG,2013.0,1,1,0
FIN,UKR,2020.0,1,1,0
USA,SLE,2018.0,5,3,2
COL,PRI,2015.0,2,5,-3
JPN,PER,2019.0,3,2,1
NLD,GHA,2014.0,1,3,-2
JPN,BTN,2016.0,1,1,0
ALB,SRB,2018.0,3,1,2
IRL,SRB,2022.0,1,4,-3
ROU,POL,2018.0,3,2,1
IDN,SAU,2017.0,1,4,-3
PRT,MEX,2020.0,1,5,-4
IND,VNM,2021.0,1,11,-10
PRI,IND,2007.0,5,1,4
DEU,MWI,2017.0,1,3,-2
IND,AUT,2005.0,5,5,0
DNK,DEU,2000.0,14,24,-10
ARE,USA,2008.0,14,45,-31
HKG,ZAF,2019.0,3,2,1
GBR,JAM,2009.0,1,4,-3
BRA,AUT,2008.0,3,5,-2
HRV,AUS,2007.0,1,1,0
EGY,CZE,2015.0,1,4,-3
CHL,AUT,2020.0,5,2,3
HRV,SVN,2006.0,4,3,1
PER,VEN,2012.0,1,1,0
TUN,DEU,2021.0,4,3,1
CMR,ZAF,2021.0,2,3,-1
ISL,NOR,2016.0,3,5,-2
HRV,HUN,2012.0,1,1,0
AUT,BEL,2001.0,2,5,-3
IDN,GBR,2013.0,1,8,-7
MOZ,ZAF,2006.0,1,2,-1
SWE,PAK,2018.0,7,9,-2
DEU,SVN,2002.0,7,6,1
CAN,NZL,1997.0,4,2,2
GBR,ISR,1997.0,2,8,-6
JOR,GBR,2003.0,3,5,-2
COG,MAR,2016.0,1,2,-1
DEU,SRB,1998.0,4,2,2
BEN,CIV,2008.0,1,1,0
HUN,POL,2001.0,1,1,0
NER,FRA,2009.0,5,5,0
BRA,NZL,2003.0,2,2,0
PRY,USA,2007.0,2,1,1
FRA,TGO,2010.0,3,3,0
PAK,AUS,2004.0,2,2,0
BGR,POL,2006.0,4,1,3
NOR,GRC,2011.0,2,2,0
KAZ,DEU,2011.0,1,1,0
ROU,BEL,2020.0,4,7,-3
NLD,EST,2011.0,3,1,2
PER,CHE,2019.0,3,1,2
VNM,SGP,2020.0,3,14,-11
IND,THA,2007.0,2,4,-2
CAN,DZA,2017.0,3,6,-3
ESP,AND,2010.0,2,1,1
EGY,MYS,2016.0,5,8,-3
SWE,HUN,1998.0,3,3,0
IRL,NZL,2010.0,5,3,2
QAT,NLD,2017.0,8,2,6
POL,PAK,2020.0,1,3,-2
ARE,IRL,2021.0,3,3,0
TWN,FRA,2016.0,8,12,-4
ESP,TUR,2016.0,4,5,-1
CMR,GAB,2020.0,2,1,1
FRA,KAZ,2018.0,3,4,-1
BGR,JPN,2020.0,2,2,0
CRI,ECU,2019.0,4,1,3
GBR,TTO,2014.0,2,4,-2
DJI,FRA,2017.0,1,1,0
USA,BHR,2005.0,2,1,1
AUS,ESP,2000.0,3,3,0
SWE,CHL,2020.0,2,2,0
IDN,SAU,2019.0,2,4,-2
JPN,ISR,2019.0,5,6,-1
COL,FRA,2005.0,7,2,5
IND,NOR,2007.0,3,3,0
FRA,NER,2017.0,3,2,1
TWN,ETH,2014.0,1,2,-1
GBR,MLT,2000.0,3,1,2
TWN,POL,2015.0,1,4,-3
JPN,PAK,2001.0,1,1,0
ROU,ISR,2019.0,1,2,-1
UGA,FRA,2012.0,1,3,-2
IDN,DNK,2010.0,1,1,0
CYP,SWE,2014.0,3,1,2
QAT,JOR,2008.0,2,2,0
HKG,MAC,2009.0,7,2,5
ISL,AUS,2014.0,2,1,1
ESP,CRI,2022.0,5,3,2
TUN,JPN,2008.0,1,1,0
CHN,PSE,2021.0,3,2,1
GBR,GTM,2020.0,1,2,-1
VEN,AUS,2012.0,2,1,1
IRL,SGP,2016.0,7,3,4
BEL,NPL,2016.0,2,1,1
SWE,ISR,2004.0,1,1,0
NZL,ZAF,1999.0,1,4,-3
FRA,KHM,2016.0,4,5,-1
SVN,ZAF,2017.0,1,1,0
THA,OMN,2016.0,1,1,0
QAT,SAU,2003.0,2,3,-1
NOR,CHE,2004.0,6,10,-4
ROU,JPN,2008.0,3,11,-8
TTO,USA,2006.0,4,3,1
NOR,RUS,1998.0,5,1,4
ITA,DZA,2012.0,2,1,1
DNK,ARG,2005.0,1,1,0
GHA,GBR,2001.0,2,1,1
EGY,KOR,2007.0,3,3,0
FRA,NZL,2004.0,3,4,-1
ITA,TUN,2020.0,3,6,-3
FRA,SRB,2009.0,3,1,2
CAN,ESP,1997.0,2,2,0
HRV,NLD,2008.0,1,1,0
RUS,IRL,2004.0,5,1,4
CAN,NPL,2013.0,4,2,2
ITA,IRN,2004.0,4,1,3
SWE,NIC,2006.0,1,2,-1
HKG,NLD,2011.0,2,4,-2
BEL,THA,2018.0,3,2,1
JPN,ISR,2010.0,1,4,-3
SWE,PRT,2016.0,3,13,-10
CZE,PRT,2012.0,1,1,0
IRN,JPN,2003.0,4,5,-1
NZL,NLD,2003.0,4,6,-2
TZA,KOR,2015.0,1,1,0
ZMB,CHN,2020.0,3,4,-1
ESP,PER,2006.0,2,6,-4
KOR,IRL,2005.0,1,1,0
BGD,AUS,2001.0,2,1,1
SRB,SWE,2007.0,3,1,2
USA,BHR,2002.0,1,1,0
JPN,COL,2004.0,1,1,0
TTO,GBR,2020.0,4,4,0
CHE,MEX,2008.0,2,4,-2
BGD,NPL,2014.0,1,1,0
JPN,ROU,2002.0,3,3,0
SRB,RUS,2005.0,1,1,0
BWA,SWZ,2007.0,1,1,0
POL,CAN,2000.0,7,7,0
NGA,ESP,2019.0,1,1,0
IND,AUT,2002.0,1,3,-2
TUR,KGZ,2018.0,2,4,-2
TUN,CAN,2004.0,2,5,-3
THA,FRA,2007.0,7,7,0
DEU,VEN,2001.0,2,2,0
UKR,KOR,2013.0,1,2,-1
URY,CUB,2015.0,1,1,0
NZL,AUT,2021.0,2,5,-3
MYS,IRL,2015.0,3,9,-6
BGD,GBR,2010.0,6,13,-7
DEU,MWI,2010.0,2,2,0
JOR,AUS,2006.0,1,5,-4
CZE,NPL,2020.0,1,2,-1
NGA,CMR,2019.0,1,3,-2
PHL,FRA,2015.0,3,2,1
ZAF,TUR,2013.0,1,2,-1
KOR,UGA,2020.0,2,1,1
SDN,SWE,2002.0,1,1,0
CHE,BFA,2021.0,2,1,1
ZAF,UGA,2007.0,1,3,-2
LTU,AUT,2018.0,2,1,1
DEU,MWI,2019.0,1,1,0
AUS,LTU,2017.0,1,1,0
EST,UKR,2016.0,1,2,-1
ECU,PAN,2021.0,1,1,0
CMR,KEN,2015.0,1,2,-1
IRN,PAK,2021.0,3,1,2
RUS,ZAF,1999.0,3,3,0
ROU,SAU,2018.0,1,1,0
CHE,GMB,2009.0,1,1,0
PSE,ESP,2014.0,1,4,-3
NZL,RUS,2007.0,1,2,-1
FIN,ISR,2003.0,2,2,0
TUR,PRT,2014.0,2,3,-1
SRB,ALB,2014.0,5,3,2
CHE,SWZ,2019.0,1,2,-1
MLI,ISR,2019.0,1,1,0
ISR,TUR,2016.0,3,1,2
RUS,KGZ,2018.0,4,3,1
SVN,NLD,2020.0,2,2,0
JOR,AUT,2020.0,1,1,0
SAU,FIN,2021.0,1,1,0
LTU,DEU,1999.0,3,7,-4
AUS,NGA,2005.0,2,1,1
DEU,GEO,2004.0,2,3,-1
SWE,ZAF,2000.0,3,1,2
NLD,PHL,2002.0,1,2,-1
DEU,BLR,1997.0,3,6,-3
CAN,ESP,1998.0,4,4,0
RUS,TWN,2004.0,2,5,-3
COL,CHE,2005.0,2,1,1
POL,NLD,1999.0,3,3,0
CAN,DZA,2019.0,5,7,-2
CHL,BEL,2007.0,1,4,-3
IRL,IRN,2007.0,1,1,0
CHE,CMR,2021.0,2,1,1
SVK,UKR,2015.0,1,4,-3
AUS,ZMB,2020.0,2,3,-1
AUT,LUX,2017.0,1,2,-1
JPN,JOR,2020.0,1,2,-1
GIB,GBR,2019.0,1,1,0
BEN,TGO,2021.0,1,1,0
GRC,CAN,1999.0,1,5,-4
HRV,QAT,2020.0,1,1,0
FIN,LBY,2011.0,1,1,0
USA,LBR,2020.0,2,6,-4
ISL,JPN,2011.0,1,1,0
TUR,ROU,2004.0,1,2,-1
PAN,DEU,2021.0,2,3,-1
BRA,GRC,2011.0,1,1,0
ARE,ZAF,2006.0,1,2,-1
FIN,POL,2010.0,3,3,0
ZAF,RUS,2012.0,2,1,1
QAT,SDN,2019.0,1,1,0
ITA,GHA,2002.0,1,1,0
QAT,SDN,2010.0,1,1,0
IRL,IND,2008.0,2,9,-7
ESP,ROU,2016.0,5,3,2
IRQ,ITA,2020.0,2,1,1
BGD,BEL,2019.0,2,5,-3
LUX,SGP,2022.0,1,1,0
BEL,CUB,2020.0,2,2,0
BGR,BEL,2014.0,5,3,2
POL,LTU,2009.0,1,1,0
BEL,BFA,2007.0,2,1,1
IND,LUX,2015.0,1,2,-1
FRO,DNK,2016.0,1,4,-3
AZE,FRA,2016.0,1,1,0
VNM,IND,2022.0,5,3,2
PAK,BGD,2021.0,2,6,-4
NLD,PRT,2000.0,2,4,-2
PER,JPN,2016.0,1,2,-1
NOR,BRA,2004.0,2,1,1
PER,CHL,2016.0,2,10,-8
KOR,ESP,2015.0,1,7,-6
HKG,IND,1999.0,1,3,-2
MKD,CZE,2010.0,1,1,0
FIN,DNK,1997.0,1,5,-4
HUN,TUR,2006.0,1,1,0
JOR,KWT,2020.0,2,2,0
PER,DEU,2015.0,1,5,-4
CAN,DZA,2010.0,3,5,-2
MYS,LKA,2011.0,1,1,0
GAB,ZAF,2018.0,1,1,0
BRN,GBR,2007.0,1,2,-1
AUT,BGR,2015.0,1,2,-1
USA,ASM,2005.0,1,1,0
AUS,MWI,2011.0,1,1,0
MYS,IND,2002.0,2,9,-7
SWE,ARG,2009.0,2,2,0
USA,BHS,2012.0,1,1,0
ARM,FRA,2013.0,1,1,0
AUT,BRA,2002.0,2,2,0
COL,GTM,2017.0,1,2,-1
IDN,DNK,2019.0,1,2,-1
POL,NZL,2013.0,1,7,-6
USA,MNG,2012.0,1,2,-1
ROU,UKR,2021.0,1,1,0
EST,NLD,2018.0,3,4,-1
ESP,PHL,2016.0,1,3,-2
BGR,USA,2021.0,1,5,-4
LKA,MYS,2013.0,1,4,-3
NGA,ESP,2010.0,1,1,0
SRB,ESP,2013.0,2,2,0
HKG,PSE,2021.0,1,1,0
USA,NER,2016.0,1,2,-1
BEL,ARG,2021.0,3,5,-2
BGD,EGY,2020.0,3,3,0
LBY,GBR,2008.0,2,9,-7
LTU,RUS,2018.0,1,2,-1
IND,GHA,2022.0,1,1,0
AUS,WSM,2021.0,1,1,0
FRA,TGO,2019.0,1,2,-1
HUN,CAN,1999.0,1,1,0
SWZ,USA,2018.0,1,3,-2
SVK,DNK,2010.0,1,1,0
BGD,BEL,2010.0,1,1,0
SYR,GBR,2009.0,1,6,-5
HKG,ZAF,2017.0,2,4,-2
PHL,FIN,2003.0,1,1,0
BEL,DZA,2017.0,1,2,-1
LKA,NLD,2004.0,1,1,0
AZE,TUR,2001.0,2,2,0
NLD,MWI,2012.0,2,2,0
CRI,NLD,2003.0,2,1,1
SVN,FRA,2006.0,1,3,-2
OMN,JOR,2003.0,2,2,0
MKD,HRV,2018.0,1,1,0
NLD,MEX,1997.0,1,3,-2
FRA,BLR,2003.0,1,1,0
BRA,CHL,1997.0,1,1,0
DNK,NZL,2006.0,1,4,-3
FRA,DJI,2006.0,1,1,0
EST,LVA,2013.0,1,3,-2
DZA,QAT,2020.0,1,2,-1
HUN,SGP,2013.0,1,2,-1
THA,IND,2014.0,2,7,-5
JPN,PER,2017.0,1,1,0
URY,AUS,2017.0,1,1,0
DNK,GHA,2020.0,2,1,1
TUR,ISR,2016.0,1,3,-2
SGP,HRV,2020.0,1,1,0
SRB,BRA,2009.0,1,2,-1
BEL,TUR,2004.0,3,1,2
ROU,ISR,2017.0,1,3,-2
ECU,USA,2000.0,1,2,-1
USA,BIH,2014.0,1,1,0
AUS,HRV,2022.0,1,1,0
NLD,SLE,2017.0,1,1,0
DEU,QAT,2021.0,1,1,0
GRC,KOR,2018.0,1,1,0
TZA,HKG,2020.0,1,1,0
KOR,FIN,2007.0,1,2,-1
SEN,GIN,2008.0,1,1,0
PRT,SGP,2020.0,1,3,-2
NLD,NGA,2007.0,1,2,-1
FRA,BGD,2016.0,1,2,-1
AUS,SRB,2009.0,1,2,-1
VNM,NOR,2019.0,1,2,-1
CAN,ROU,2022.0,1,1,0
SAU,IRN,2020.0,1,3,-2
SAU,DNK,2016.0,1,1,0
VNM,NOR,2017.0,1,2,-1
LVA,GBR,2013.0,1,1,0
CZE,ROU,2018.0,1,4,-3
MLT,SWE,2021.0,1,2,-1
FIN,NZL,2016.0,1,3,-2
USA,QAT,2015.0,84,33,51
CHE,DEU,2007.0,308,470,-162
IND,USA,2007.0,716,406,310
FRA,GBR,2013.0,375,378,-3
SGP,THA,2012.0,11,5,6
ITA,DEU,2008.0,168,121,47
USA,DEU,2022.0,437,405,32
DEU,USA,2005.0,1092,896,196
USA,SWE,1998.0,47,45,2
DEU,USA,2002.0,1232,1079,153
IRL,PRT,2014.0,3,3,0
BEL,USA,2017.0,221,117,104
FRA,CAN,2004.0,204,132,72
AUS,FRA,2018.0,71,86,-15
FRA,SYR,2015.0,8,5,3
CHN,SGP,2015.0,243,264,-21
CAN,IND,2013.0,87,121,-34
FIN,POL,2019.0,8,7,1
MEX,CAN,2022.0,28,10,18
ITA,LUX,2017.0,13,4,9
IND,KOR,2019.0,234,153,81
PAN,USA,2011.0,11,16,-5
MEX,GBR,2016.0,40,55,-15
SWE,USA,2009.0,183,184,-1
TUR,CHE,2014.0,19,10,9
JPN,DEU,1998.0,36,23,13
MEX,USA,1999.0,38,52,-14
CHN,FRA,2018.0,155,243,-88
NLD,ITA,2007.0,57,68,-11
JOR,DEU,2017.0,10,12,-2
NGA,GBR,2020.0,53,71,-18
DEU,ESP,2005.0,119,61,58
COL,ARG,2022.0,5,6,-1
CHN,UKR,2022.0,7,10,-3
CHN,MYS,2020.0,20,65,-45
GBR,AUT,2017.0,68,89,-21
GRC,CYP,2018.0,27,26,1
NLD,CHE,2004.0,37,27,10
BEL,ESP,2014.0,31,64,-33
SWE,NGA,2016.0,3,1,2
CHN,SWE,2009.0,53,30,23
IND,FIN,2015.0,25,7,18
HUN,ITA,2017.0,10,7,3
ECU,COL,2016.0,2,7,-5
GRC,DNK,2004.0,2,3,-1
AUT,LUX,2019.0,1,1,0
SAU,KWT,2021.0,4,2,2
POL,KOR,2017.0,4,2,2
IRL,FRA,2001.0,10,6,4
EGY,JOR,2006.0,3,1,2
PNG,AUS,2018.0,7,10,-3
ITA,AUT,2000.0,5,3,2
MDG,FRA,2007.0,7,11,-4
BRA,AUS,2006.0,10,14,-4
ESP,IRL,2005.0,10,3,7
ISR,NLD,2004.0,9,4,5
ITA,FRA,1997.0,41,38,3
DNK,GRC,2006.0,5,3,2
NOR,DEU,2007.0,8,46,-38
FRA,SEN,2007.0,25,24,1
TUR,JPN,2005.0,7,4,3
DEU,BEN,2001.0,1,1,0
ITA,SAU,2014.0,13,5,8
ROU,USA,2008.0,21,24,-3
CHE,BGD,2012.0,2,3,-1
JPN,SWE,2001.0,21,31,-10
IDN,DEU,2016.0,7,30,-23
THA,SWE,2003.0,1,8,-7
SWE,SVK,2012.0,1,2,-1
COL,CAN,2012.0,17,10,7
LBY,IND,2012.0,10,3,7
NLD,SVN,2019.0,3,3,0
CZE,IRL,2008.0,4,3,1
FIN,POL,2017.0,4,9,-5
IRN,CHE,2018.0,28,11,17
PAN,MEX,2008.0,1,3,-2
QAT,NLD,2019.0,4,2,2
IRL,TUR,2019.0,3,10,-7
QAT,TUR,2019.0,4,7,-3
TUR,PAK,2017.0,5,11,-6
KOR,EGY,2018.0,10,8,2
POL,IDN,2020.0,1,3,-2
ARE,MYS,2021.0,4,13,-9
SGP,ESP,2022.0,1,1,0
IRN,NLD,2013.0,33,9,24
ARG,BRA,2004.0,18,10,8
DNK,FRA,2018.0,51,84,-33
IND,ZAF,2005.0,12,2,10
NZL,THA,2011.0,4,1,3
IND,MEX,2014.0,14,4,10
MKD,RUS,2020.0,1,1,0
USA,HUN,2022.0,16,17,-1
LVA,SWE,2014.0,3,1,2
CHE,NGA,2016.0,3,3,0
BGD,BEL,2017.0,4,6,-2
USA,ARM,2012.0,3,3,0
IND,SWE,2003.0,9,7,2
FRA,JOR,2018.0,2,1,1
FRA,MAR,2000.0,22,19,3
NLD,FRA,1997.0,12,7,5
ECU,PRT,2017.0,1,2,-1
IRL,RUS,2011.0,3,2,1
ROU,AUS,2003.0,2,3,-1
PER,CHE,2010.0,2,1,1
MLI,CHE,2019.0,1,2,-1
DJI,FRA,2019.0,2,1,1
DZA,EGY,2011.0,1,2,-1
TUR,ZAF,2015.0,1,3,-2
THA,LAO,2018.0,5,4,1
MEX,DNK,2016.0,2,4,-2
DZA,JPN,2017.0,1,1,0
POL,KOR,2019.0,1,3,-2
AUS,POL,2020.0,8,9,-1
JPN,ESP,1999.0,4,9,-5
ZAF,COG,2016.0,1,2,-1
BHR,ZAF,2004.0,1,2,-1
SGP,TUR,2021.0,6,5,1
BEL,IDN,2018.0,4,3,1
CAN,CZE,2018.0,6,5,1
FRA,REU,2006.0,12,3,9
NOR,KOR,2012.0,2,3,-1
NZL,CHN,2003.0,5,4,1
CHN,KEN,2015.0,7,1,6
PRI,BRA,2014.0,1,1,0
HKG,ESP,2009.0,1,1,0
SVN,SRB,2019.0,4,6,-2
SRB,BIH,2008.0,12,2,10
POL,KOR,2010.0,2,1,1
GBR,ROU,2000.0,1,2,-1
AUS,NCL,2012.0,2,2,0
DEU,SDN,2020.0,1,4,-3
TUR,AUS,2007.0,3,1,2
FRA,MYS,2012.0,4,1,3
HKG,DNK,2014.0,2,3,-1
DEU,LTU,2009.0,3,2,1
SYR,RUS,2021.0,1,2,-1
SWE,LKA,2010.0,1,1,0
DEU,CRI,2002.0,2,1,1
ISL,FIN,2002.0,1,1,0
ESP,AND,2019.0,3,2,1
NOR,RUS,1997.0,4,1,3
ARG,URY,2009.0,3,2,1
TTO,FRA,2013.0,1,1,0
PAK,NOR,2009.0,2,1,1
SWE,HUN,1997.0,2,1,1
DNK,MYS,2020.0,3,4,-1
HUN,ARE,2003.0,2,2,0
TWN,UKR,2003.0,1,1,0
BHR,TUN,2019.0,2,1,1
PSE,DEU,2020.0,4,6,-2
IRL,TUR,2010.0,2,1,1
ESP,SVK,2022.0,1,1,0
SDN,BRA,2018.0,1,1,0
SAU,JPN,2006.0,3,4,-1
CHN,GRC,2006.0,1,1,0
PAK,ITA,2003.0,1,2,-1
USA,BOL,2012.0,1,6,-5
NOR,GHA,2011.0,1,1,0
FRA,UGA,2019.0,1,4,-3
IND,IRN,2000.0,1,1,0
DEU,TUR,2000.0,3,5,-2
ARG,POL,2014.0,1,4,-3
KOR,UZB,2007.0,1,3,-2
ZAF,AUT,2000.0,1,2,-1
NOR,HUN,2013.0,2,4,-2
ZWE,GBR,2022.0,1,2,-1
CAN,SVK,2008.0,2,1,1
DEU,BRN,2006.0,1,1,0
DNK,RUS,2011.0,1,5,-4
GBR,NPL,2021.0,1,11,-10
DEU,UZB,2016.0,1,2,-1
PER,CHE,2017.0,1,1,0
NLD,GAB,2021.0,1,1,0
NER,ITA,2009.0,1,1,0
HRV,GRC,2019.0,1,2,-1
KWT,CAN,2014.0,1,12,-11
SRB,BEL,2011.0,1,2,-1
,FRA,2011.0,14952,0,14952
,HUN,1999.0,2094,0,2094
CHN,,2020.0,121320,0,121320
,BRA,1999.0,10526,0,10526
BEL,,2015.0,2197,0,2197
,THA,2004.0,1863,0,1863
TWN,,2011.0,3626,0,3626
ITA,,2021.0,16974,0,16974
SWE,,2020.0,4445,0,4445
,RUS,1994.0,18148,0,18148
JPN,,2022.0,43357,0,43357
EGY,,2012.0,557,0,557
IND,,2020.0,24605,0,24605
ISR,,2024.0,17933,0,17933
,AUT,1998.0,3219,0,3219
,CZE,2003.0,1792,0,1792
,CHN,1995.0,9600,0,9600
IRL,,2024.0,10247,0,10247
CUB,,2011.0,406,0,406
HKG,,2014.0,1005,0,1005
,BLR,2006.0,199,0,199
FRA,,2001.0,478,0,478
BGR,,2016.0,382,0,382
,AZE,2004.0,99,0,99
CZE,,2011.0,854,0,854
,AUS,2012.0,9730,0,9730
TZA,,2016.0,109,0,109
DEU,,2006.0,8365,0,8365
CRI,,2023.0,566,0,566
ROU,,2012.0,770,0,770
,BEL,2000.0,3501,0,3501
,ECU,2015.0,780,0,780
BGR,FRA,1999.0,4,0,4
,LBY,2004.0,36,0,36
,MNG,2004.0,28,0,28
,EGY,2007.0,2575,0,2575
,NZL,2001.0,1266,0,1266
TUV,USA,2017.0,1,0,1
,AUT,1997.0,869,0,869
,SVN,2012.0,624,0,624
NOR,MWI,2016.0,2,0,2
LBY,,2010.0,13,0,13
HRV,,2015.0,681,0,681
CHE,,2007.0,1512,0,1512
,SVK,1994.0,862,0,862
DNK,,2005.0,521,0,521
CIV,,2022.0,281,0,281
,LBN,2008.0,220,0,220
PSE,,2021.0,109,0,109
VEN,,2008.0,240,0,240
AUT,PAK,2016.0,9,0,9
,KAZ,2000.0,101,0,101
,IRL,2011.0,1662,0,1662
,MKD,2009.0,162,0,162
FRA,UGA,2010.0,2,0,2
,PRY,2003.0,25,0,25
,DNK,2010.0,2740,0,2740
LVA,,2011.0,78,0,78
YEM,,2024.0,272,0,272
,SGP,2012.0,2266,0,2266
GRC,ALB,2017.0,1,0,1
,MAC,2010.0,66,0,66
,SRB,2016.0,954,0,954
,SAU,2006.0,584,0,584
AZE,,2015.0,129,0,129
,NPL,2016.0,384,0,384
,IRN,2018.0,10354,0,10354
GRD,,2016.0,18,0,18
LBY,,2019.0,53,0,53
,NGA,2013.0,1564,0,1564
,CMR,2013.0,380,0,380
TGO,ITA,2015.0,1,0,1
,MAR,2012.0,1199,0,1199
,MMR,2010.0,15,0,15
GHA,CHE,2013.0,2,0,2
,EST,2012.0,371,0,371
HRV,TUR,2015.0,2,0,2
SDN,,2023.0,397,0,397
,IRQ,2013.0,539,0,539
PNG,,2023.0,109,0,109
UKR,,2003.0,442,0,442
,DNK,2017.0,2503,0,2503
IRN,,2025.0,125,0,125
LBY,,2017.0,61,0,61
,MCO,2014.0,10,0,10
,JAM,2013.0,33,0,33
COL,NZL,2020.0,2,0,2
,TTO,2014.0,39,0,39
BIH,NOR,2016.0,2,0,2
,DNK,2019.0,1451,0,1451
ZMB,ZAF,2022.0,1,0,1
,MAC,2017.0,209,0,209
,SYR,2016.0,100,0,100
,CRI,2015.0,167,0,167
,TJK,2014.0,30,0,30
,GHA,2018.0,651,0,651
,MAC,2019.0,188,0,188
KEN,BOL,2011.0,1,0,1
GHA,PRT,2022.0,2,0,2
NIC,,2023.0,35,0,35
,MMR,2017.0,59,0,59
BMU,,2024.0,12,0,12
TUN,OMN,2022.0,3,0,3
,MWI,2015.0,125,0,125
NOR,HKG,2015.0,1,0,1
,KHM,2006.0,31,0,31
PRT,AUT,2014.0,8,0,8
CMR,,2015.0,99,0,99
,ARM,2008.0,141,0,141
KOR,MMR,2011.0,1,0,1
TUN,,2007.0,151,0,151
ABW,,2024.0,8,0,8
,MNE,2003.0,16,0,16
,BIH,2007.0,232,0,232
,AZE,1996.0,53,0,53
,TZA,2008.0,184,0,184
,ERI,2011.0,8,0,8
TWN,JOR,2020.0,3,0,3
BEN,RWA,2022.0,1,0,1
,FRO,2012.0,6,0,6
JPN,PER,2010.0,3,0,3
FLK,,2022.0,3,0,3
URY,,2009.0,46,0,46
CAN,KAZ,2016.0,4,0,4
BRN,ITA,2019.0,1,0,1
FIN,GHA,2022.0,1,0,1
IRN,KAZ,2019.0,3,0,3
,SOM,2018.0,19,0,19
ARM,,2004.0,43,0,43
,BRN,2002.0,14,0,14
DEU,MLI,2008.0,1,0,1
TJK,,2013.0,7,0,7
THA,,2003.0,77,0,77
,THA,1996.0,264,0,264
BEN,MLI,2011.0,1,0,1
MDA,USA,2003.0,4,0,4
UZB,KOR,2014.0,1,0,1
USA,BFA,2007.0,2,0,2
,BRN,2005.0,9,0,9
FRA,HND,2019.0,1,0,1
,COG,1999.0,21,0,21
CHN,EGY,2014.0,13,0,13
GEO,,2009.0,50,0,50
VNM,BRA,2006.0,3,0,3
DOM,USA,2008.0,2,0,2
MDA,,2000.0,11,0,11
DNK,,2002.0,119,0,119
,MNG,1996.0,4,0,4
BEL,TZA,2002.0,1,0,1
NGA,EGY,2021.0,9,0,9
ITA,LUX,2010.0,4,0,4
KEN,SDN,2007.0,1,0,1
USA,MDG,2003.0,3,0,3
CZE,BRA,2003.0,2,0,2
KWT,CHN,2021.0,3,0,3
GRC,NZL,2016.0,3,0,3
BEL,LUX,2001.0,7,0,7
ZWE,HND,2008.0,1,0,1
BGR,NOR,2001.0,1,0,1
AUS,CYP,2015.0,3,0,3
,DOM,1994.0,4,0,4
UKR,TJK,2014.0,1,0,1
CHE,IRN,2001.0,2,0,2
PSE,ITA,2013.0,2,0,2
IND,ARG,2002.0,1,0,1
MEX,,2000.0,36,0,36
HUN,JPN,2022.0,3,0,3
SYR,AUS,2001.0,1,0,1
AUS,BGR,2003.0,2,0,2
MTQ,,2010.0,7,0,7
ESP,TZA,2003.0,2,0,2
MDA,ESP,1999.0,2,0,2
PRT,POL,2003.0,3,0,3
HUN,BGR,2000.0,2,0,2
DZA,HUN,2015.0,1,0,1
FRA,QAT,2007.0,2,0,2
BGR,SWE,1999.0,1,0,1
,GLP,2003.0,11,0,11
PRT,VEN,2011.0,1,0,1
BIH,CHE,2004.0,1,0,1
GBR,BIH,2013.0,2,0,2
SVK,ZAF,2005.0,1,0,1
BEN,LBR,2016.0,2,0,2
PRY,,2016.0,10,0,10
GIN,,2012.0,4,0,4
GNQ,,2009.0,1,0,1
AUT,ISR,2001.0,2,0,2
FRA,MRT,2011.0,1,0,1
SWE,OMN,2022.0,1,0,1
TCD,,2015.0,3,0,3
DNK,EST,2010.0,2,0,2
MHL,,2017.0,1,0,1
BRA,LVA,2017.0,2,0,2
RWA,TZA,2018.0,2,0,2
ALB,SWE,2016.0,1,0,1
GBR,HTI,2014.0,1,0,1
IRL,BIH,2017.0,1,0,1
PHL,NOR,2017.0,1,0,1
CMR,ESP,2018.0,2,0,2
ESP,BLR,2018.0,1,0,1
URY,ISR,2018.0,1,0,1
NGA,DNK,2018.0,1,0,1
ISR,BEL,2022.0,1,0,1
EGY,LBY,2006.0,1,0,1
BRA,CHL,1998.0,2,0,2
MKD,IRL,2022.0,1,0,1
SGP,DNK,2021.0,7,0,7
KOR,YEM,2016.0,1,0,1
NOR,KAZ,2015.0,3,0,3
PER,NIC,2012.0,1,0,1
ZMB,ZWE,2011.0,1,0,1
UKR,POL,1997.0,5,0,5
BGR,KOR,2014.0,1,0,1
ETH,BFA,2011.0,1,0,1
BOL,DEU,2011.0,1,0,1
COL,GTM,2010.0,1,0,1
THA,LKA,2015.0,2,0,2
PHL,IDN,2017.0,3,0,3
BDI,ZWE,2005.0,1,0,1
ERI,SAU,2012.0,1,0,1
AUT,DNK,1997.0,1,0,1
GIN,GNB,2016.0,1,0,1
MEX,VNM,2020.0,3,0,3
LBY,GRC,2021.0,1,0,1
VEN,PER,2011.0,2,0,2
GBR,KAZ,2013.0,3,0,3
TUR,LBY,2021.0,2,0,2
THA,ZAF,2016.0,1,0,1
TUN,SAU,2008.0,6,0,6
POL,HRV,2004.0,1,0,1
BEL,TZA,2005.0,1,0,1
ZAF,CMR,2007.0,2,0,2
NOR,TUR,2004.0,1,0,1
PHL,LAO,2008.0,1,0,1
CHE,NOR,1999.0,3,0,3
UGA,ITA,2010.0,1,0,1
IRN,NGA,2006.0,1,0,1
DEU,TTO,2002.0,1,0,1
CHL,UKR,2004.0,1,0,1
PRT,DZA,2007.0,2,0,2
,LBY,1996.0,11,0,11
SWE,JOR,2007.0,2,0,2
GBR,SEN,2017.0,1,0,1
MCO,,2009.0,8,0,8
CZE,PRY,2018.0,1,0,1
CHE,KHM,2015.0,3,0,3
MTQ,,2019.0,6,0,6
SAU,BGD,2009.0,2,0,2
EST,TUN,2013.0,1,0,1
POL,CHL,2008.0,3,0,3
NPL,CHE,2009.0,1,0,1
NZL,GRC,2006.0,1,0,1
DNK,TWN,2009.0,1,0,1
POL,CUB,2009.0,1,0,1
VNM,NLD,2012.0,6,0,6
KOR,HUN,2020.0,1,0,1
EGY,PRT,2011.0,2,0,2
ISL,DEU,2013.0,2,0,2
NZL,NGA,2014.0,2,0,2
,SWZ,1999.0,4,0,4
GTM,BRA,2010.0,1,0,1
AUS,TTO,2015.0,2,0,2
BEL,GHA,2015.0,2,0,2
EST,HUN,2013.0,1,0,1
MAC,SAU,2022.0,1,0,1
ECU,PRT,2019.0,1,0,1
ITA,THA,2015.0,3,0,3
RUS,SRB,2001.0,3,0,3
ARG,BEL,2009.0,2,0,2
,RWA,2000.0,4,0,4
,ABW,2012.0,4,0,4
SEN,DNK,2001.0,1,0,1
,LBR,2003.0,1,0,1
VNM,SWE,2001.0,2,0,2
CHN,CIV,2018.0,1,0,1
MOZ,,2003.0,2,0,2
NLD,SVN,2010.0,1,0,1
MDV,NPL,2015.0,1,0,1
ROU,IRL,2006.0,3,0,3
,COD,2009.0,6,0,6
ARG,RUS,2014.0,1,0,1
MDG,SEN,2011.0,2,0,2
ERI,,2008.0,4,0,4
CHN,SEN,2013.0,2,0,2
GTM,SLV,2013.0,1,0,1
GAB,TCD,2021.0,1,0,1
PRI,COL,2012.0,5,0,5
BMU,GBR,2013.0,1,0,1
ETH,ISR,2004.0,2,0,2
AUT,GTM,2010.0,1,0,1
EGY,TUR,2017.0,3,0,3
MYS,SDN,2016.0,9,0,9
SVK,SGP,2014.0,1,0,1
DEU,LBY,2014.0,2,0,2
IRN,THA,2011.0,1,0,1
BTN,GBR,2020.0,1,0,1
BFA,MMR,2011.0,1,0,1
ARG,EST,2019.0,2,0,2
CYP,IRN,2017.0,1,0,1
AUS,LBY,2020.0,1,0,1
NOR,GEO,2018.0,1,0,1
YEM,ITA,2019.0,1,0,1
MYS,TLS,2021.0,1,0,1
FRA,LBY,2016.0,2,0,2
JAM,CAN,2007.0,3,0,3
CHN,CYP,2001.0,1,0,1
CAN,LBY,2016.0,2,0,2
ZWE,IND,2004.0,2,0,2
BOL,,2003.0,9,0,9
GBR,ZMB,2000.0,1,0,1
CHE,IDN,2007.0,2,0,2
MAR,CAN,1999.0,2,0,2
LKA,DEU,2004.0,1,0,1
BGR,MEX,2005.0,1,0,1
ETH,CHE,2005.0,1,0,1
THA,CHN,2006.0,2,0,2
NLD,ABW,2010.0,1,0,1
BGD,KOR,2003.0,2,0,2
KEN,ESP,2007.0,1,0,1
BHS,GBR,2012.0,1,0,1
DEU,TGO,2008.0,1,0,1
ROU,ECU,2018.0,1,0,1
THA,CYP,2020.0,1,0,1
FRA,ISL,2012.0,4,0,4
,GRD,2008.0,9,0,9
CHN,MNG,2015.0,1,0,1
SWE,MAR,2018.0,2,0,2
KWT,BGD,2004.0,1,0,1
MTQ,,2017.0,7,0,7
NZL,OMN,2000.0,1,0,1
MNG,JPN,2022.0,2,0,2
BEL,KHM,2011.0,1,0,1
SRB,NZL,2002.0,1,0,1
NLD,BFA,2008.0,2,0,2
USA,PYF,2001.0,1,0,1
MEX,BGR,2013.0,1,0,1
MAR,IRN,2015.0,1,0,1
ITA,GUF,2021.0,1,0,1
NZL,KAZ,2016.0,1,0,1
EGY,BRA,2016.0,3,0,3
AUT,SGP,2019.0,3,0,3
DNK,MEX,2003.0,2,0,2
GBR,LSO,2007.0,1,0,1
KAZ,CAN,2007.0,2,0,2
CHN,MWI,2016.0,1,0,1
GBR,GNB,2016.0,2,0,2
DJI,CMR,2007.0,1,0,1
SVK,KWT,1998.0,1,0,1
COD,,2016.0,5,0,5
DNK,ARG,2002.0,2,0,2
WSM,AUS,2013.0,1,0,1
MYS,LBY,2007.0,1,0,1
NZL,PRT,2009.0,2,0,2
QAT,CUB,2020.0,1,0,1
ESP,GIB,2015.0,1,0,1
CMR,COD,2017.0,2,0,2
TWN,DZA,2021.0,1,0,1
PHL,RUS,2012.0,1,0,1
MWI,LBR,2013.0,1,0,1
GUY,CAN,2007.0,1,0,1
IRN,CYP,2016.0,1,0,1
LAO,,2007.0,3,0,3
MDA,CHE,2019.0,1,0,1
BMU,NZL,2013.0,1,0,1
ARM,CZE,2019.0,1,0,1
MRT,MLI,2017.0,1,0,1
NGA,KWT,2017.0,1,0,1
FRA,NER,2010.0,2,0,2
AUT,QAT,2010.0,1,0,1
ARG,EST,2010.0,1,0,1
ZAF,ZMB,2003.0,2,0,2
BLR,JOR,2006.0,1,0,1
MEX,ECU,2011.0,2,0,2
ARM,QAT,2011.0,1,0,1
VEN,BEL,2020.0,2,0,2
BGR,FIN,2014.0,1,0,1
KEN,SSD,2020.0,1,0,1
,GNQ,2015.0,2,0,2
NLD,SLE,2019.0,2,0,2
UKR,LVA,2016.0,1,0,1
SYR,JPN,2006.0,2,0,2
BLR,UKR,2004.0,1,0,1
ARG,CHN,2015.0,1,0,1
ITA,RWA,2018.0,1,0,1
GRC,ROU,2008.0,2,0,2
CHN,BLR,2012.0,4,0,4
ITA,ARE,2012.0,4,0,4
QAT,ISL,2017.0,1,0,1
BRA,DZA,2005.0,1,0,1
KOR,DNK,2011.0,4,0,4
DNK,KOR,2004.0,1,0,1
JPN,BWA,2013.0,1,0,1
CUB,CRI,2012.0,1,0,1
ZAF,NIC,2015.0,1,0,1
JPN,TZA,2021.0,1,0,1
SDN,TUR,2017.0,1,0,1
PHL,BGD,2009.0,1,0,1
UKR,GBR,2022.0,2,0,2
IRN,HUN,2009.0,1,0,1
HRV,IRL,2015.0,2,0,2
UKR,AUS,2006.0,2,0,2
IRN,ROU,2012.0,1,0,1
LBN,KWT,2020.0,2,0,2
ARE,BHR,2006.0,1,0,1
AUS,ZWE,2001.0,2,0,2
HUN,IRL,2020.0,1,0,1
POL,MDA,2006.0,1,0,1
EGY,SWE,2003.0,2,0,2
SAU,QAT,2001.0,3,0,3
GTM,DOM,2016.0,1,0,1
CIV,CHN,2009.0,1,0,1
IND,KWT,2021.0,3,0,3
SRB,QAT,2017.0,1,0,1
BRB,CAN,2007.0,1,0,1
CHL,AUS,2001.0,1,0,1
ASM,USA,2012.0,1,0,1
HKG,TTO,2002.0,1,0,1
VEN,NLD,2001.0,1,0,1
DEU,SYR,2007.0,1,0,1
BOL,NZL,2005.0,1,0,1
CHN,LKA,2009.0,2,0,2
GRC,IRQ,2011.0,1,0,1
COL,CRI,2008.0,3,0,3
PRY,ARG,2009.0,3,0,3
VUT,NCL,2005.0,1,0,1
MNG,AUS,2013.0,1,0,1
JAM,BHS,2015.0,1,0,1
SVN,HUN,2014.0,1,0,1
ZMB,,2000.0,3,0,3
ESP,NER,2019.0,1,0,1
ITA,VNM,2018.0,2,0,2
SWE,LKA,2017.0,1,0,1
COL,GTM,2019.0,1,0,1
NOR,LVA,2022.0,1,0,1
ROU,VNM,2019.0,1,0,1
NGA,ISR,2008.0,1,0,1
BEL,ALB,2019.0,1,0,1
RUS,ECU,2016.0,1,0,1
OMN,GEO,2021.0,1,0,1
UGA,ITA,2019.0,1,0,1
SYR,CAN,2009.0,1,0,1
MYS,CHN,2023.0,1,0,1
POL,ISR,2006.0,1,0,1
MLI,IND,2007.0,1,0,1
DEU,ARE,1997.0,1,0,1
NLD,PHL,2005.0,1,0,1
BHR,NZL,2020.0,1,0,1
BEL,SYR,2008.0,1,0,1
OMN,SWE,2016.0,2,0,2
JPN,HRV,2009.0,1,0,1
ARM,ITA,2013.0,2,0,2
NCL,VUT,2006.0,1,0,1
LAO,THA,2003.0,1,0,1
GIB,GBR,2017.0,2,0,2
MEX,BGD,2021.0,1,0,1
PSE,JPN,2014.0,1,0,1
ARG,PAN,2017.0,1,0,1
CZE,CAF,2017.0,1,0,1
FJI,LKA,2018.0,1,0,1
BHR,TUN,2017.0,1,0,1
IDN,EST,2021.0,1,0,1
IND,JOR,2018.0,1,0,1
BDI,BEL,2021.0,1,0,1
BLR,LVA,2015.0,1,0,1
BRN,MYS,2007.0,1,0,1
UGA,RWA,2013.0,1,0,1
BLR,BRA,2020.0,1,0,1
PAK,ISR,2020.0,2,0,2
CHE,LUX,2008.0,4,0,4
UGA,BWA,2015.0,1,0,1
GLP,,2013.0,4,0,4
MWI,CAN,2019.0,3,0,3
PAN,COL,2017.0,2,0,2
FIN,PRT,2000.0,1,0,1
TZA,COL,2019.0,1,0,1
UKR,HUN,2008.0,1,0,1
THA,NOR,2020.0,1,0,1
HUN,NOR,2022.0,3,0,3
MWI,THA,2018.0,1,0,1
VNM,SAU,2021.0,2,0,2
CMR,IDN,2014.0,1,0,1
CHE,NCL,2012.0,1,0,1
,MMR,2019.0,19,0,19
FJI,MYS,2020.0,1,0,1
PNG,NAM,2010.0,1,0,1
HKG,AUT,2004.0,1,0,1
LSO,ZAF,2003.0,1,0,1
AUS,COL,2003.0,1,0,1
CUB,PRI,1999.0,1,0,1
CAN,GRL,2001.0,1,0,1
OMN,CRI,2009.0,1,0,1
JPN,CRI,2008.0,1,0,1
MEX,HKG,2002.0,1,0,1
CMR,MLI,2018.0,1,0,1
BEL,TGO,2015.0,1,0,1
PAK,KOR,2006.0,2,0,2
CHL,IRN,2016.0,1,0,1
MTQ,GUF,2010.0,1,0,1
BFA,CAF,2002.0,1,0,1
CHL,BOL,2016.0,2,0,2
YEM,CAN,2021.0,1,0,1
UZB,AUS,2016.0,2,0,2
MLI,SEN,2001.0,1,0,1
PRT,PRI,2005.0,1,0,1
KWT,AUS,1998.0,1,0,1
BRA,MUS,2013.0,1,0,1
NIC,SWE,2016.0,1,0,1
BEN,AUT,2007.0,1,0,1
SGP,CZE,2013.0,2,0,2
HND,CAN,2007.0,1,0,1
SEN,TUN,2003.0,1,0,1
EGY,GRC,2011.0,1,0,1
BEL,ALB,2017.0,1,0,1
ESP,SLV,2011.0,2,0,2
GRC,ALB,2019.0,1,0,1
RUS,PSE,2004.0,1,0,1
ISR,DZA,2015.0,1,0,1
LUX,ZAF,2013.0,1,0,1
PHL,MEX,2015.0,1,0,1
BEL,MMR,2005.0,1,0,1
,ATG,1994.0,1,0,1
MEX,TUR,2021.0,1,0,1
CAN,PNG,2017.0,2,0,2
CUB,GLP,2005.0,1,0,1
KEN,CUB,2011.0,1,0,1
EGY,BGR,2017.0,1,0,1
DEU,PHL,2006.0,2,0,2
DNK,OMN,2016.0,2,0,2
ROU,CHL,2022.0,1,0,1
NCL,FJI,2019.0,1,0,1
PHL,BEL,2020.0,3,0,3
SLE,,2007.0,1,0,1
CHN,SVK,2022.0,3,0,3
JPN,SAU,1998.0,2,0,2
NLD,ALB,2011.0,1,0,1
AGO,GBR,2002.0,1,0,1
NGA,SEN,2010.0,1,0,1
KAZ,KOR,2022.0,3,0,3
BRA,MLT,2022.0,1,0,1
IND,TTO,2006.0,3,0,3
HKG,SAU,2008.0,1,0,1
CZE,CMR,2013.0,1,0,1
ISR,NZL,2000.0,1,0,1
GEO,SVK,2010.0,1,0,1
DJI,EGY,2014.0,1,0,1
LBY,QAT,2018.0,1,0,1
SGP,TUN,2015.0,1,0,1
AUT,PAN,2013.0,1,0,1
MLI,CHE,2017.0,1,0,1
CZE,ECU,2006.0,1,0,1
CZE,IDN,2003.0,1,0,1
BDI,PER,2015.0,1,0,1
NLD,ABW,2017.0,1,0,1
BGR,ZAF,2000.0,1,0,1
DZA,GBR,2022.0,2,0,2
CIV,CHE,2002.0,1,0,1
SEN,ISL,2018.0,1,0,1
UGA,SGP,2021.0,1,0,1
ESP,JOR,2020.0,3,0,3
EST,MDA,2016.0,1,0,1
MYS,EGY,2004.0,1,0,1
RUS,OMN,1998.0,1,0,1
AUT,NPL,2018.0,1,0,1
NPL,NOR,2008.0,1,0,1
EGY,SYR,2005.0,1,0,1
ARG,ROU,2007.0,1,0,1
GHA,BGD,2011.0,1,0,1
JPN,FJI,2020.0,1,0,1
PAK,DEU,1997.0,1,0,1
MEX,SAU,2014.0,1,0,1
AUS,LTU,2010.0,1,0,1
ISR,LKA,2009.0,1,0,1
ESP,MWI,2008.0,1,0,1
MDA,CHE,2017.0,1,0,1
SWE,MNG,2018.0,1,0,1
QAT,GRD,2021.0,1,0,1
ETH,CHE,2002.0,1,0,1
KEN,RUS,2006.0,1,0,1
AUT,DNK,1998.0,2,0,2
CZE,TWN,2014.0,2,0,2
CMR,CIV,2008.0,1,0,1
CMR,SEN,2006.0,1,0,1
IND,RWA,2007.0,1,0,1
NZL,UKR,2002.0,1,0,1
CYP,DEU,2013.0,1,0,1
PRT,NOR,2006.0,2,0,2
AUS,IRN,1997.0,1,0,1
IND,ERI,2004.0,1,0,1
NLD,ABW,2019.0,1,0,1
ITA,GHA,2005.0,1,0,1
BEL,SGP,1999.0,2,0,2
MAR,BGD,2012.0,1,0,1
SWE,GRL,2017.0,1,0,1
ITA,BHR,2004.0,1,0,1
IRQ,BHR,2021.0,1,0,1
NOR,ARE,2016.0,1,0,1
ZMB,ITA,2021.0,1,0,1
FJI,HKG,2013.0,1,0,1
URY,PER,2013.0,1,0,1
LUX,FIN,2017.0,1,0,1
HTI,ISR,2017.0,1,0,1
BRA,HKG,2021.0,1,0,1
ARM,BEL,2021.0,1,0,1
ECU,MEX,2005.0,1,0,1
BRN,THA,2017.0,1,0,1
CZE,ESP,1999.0,1,0,1
VEN,NZL,2016.0,1,0,1
CHE,ERI,2015.0,1,0,1
CHN,JOR,2008.0,1,0,1
ISL,AUT,2020.0,1,0,1
TCA,,2024.0,2,0,2
KWT,VNM,2020.0,1,0,1
PAK,IDN,2018.0,2,0,2
SRB,PER,2020.0,1,0,1
MYS,MEX,2021.0,1,0,1
SVK,ESP,2016.0,1,0,1
IND,TUN,2012.0,1,0,1
POL,IRQ,2004.0,1,0,1
ITA,ETH,2012.0,1,0,1
GBR,GRD,2006.0,1,0,1
ZWE,TZA,2004.0,1,0,1
PHL,LKA,2002.0,1,0,1
EST,DNK,1997.0,1,0,1
GRL,,2003.0,1,0,1
MAR,USA,1998.0,1,0,1
TWN,TUR,2007.0,2,0,2
BMU,USA,2012.0,1,0,1
JOR,DZA,2012.0,1,0,1
HRV,FIN,2021.0,1,0,1
CHL,CZE,2015.0,1,0,1
YEM,ITA,2017.0,1,0,1
CRI,AUS,2012.0,1,0,1
CYP,LIE,2018.0,1,0,1
DOM,DMA,2020.0,1,0,1
EST,FIN,1999.0,1,0,1
PRT,MAR,2016.0,1,0,1
PYF,ISR,2001.0,1,0,1
TUR,PAK,2010.0,1,0,1
UGA,PER,2019.0,1,0,1
KWT,KAZ,2018.0,1,0,1
MWI,BRN,2000.0,1,0,1
BRA,DZA,2002.0,1,0,1
SGP,MAC,2009.0,1,0,1
NLD,TWN,2007.0,1,0,1
KWT,ROU,2019.0,1,0,1
SYR,AUT,2016.0,1,0,1
SAU,IRQ,2015.0,1,0,1
NGA,VNM,2019.0,1,0,1
PHL,IDN,2019.0,1,0,1
VEN,PRI,2008.0,1,0,1
LKA,CHN,2015.0,1,0,1
COL,MMR,2018.0,1,0,1
SOM,JPN,2020.0,1,0,1
SWE,SYC,2005.0,1,0,1
DZA,JPN,2019.0,1,0,1
CHL,SWE,2000.0,1,0,1
DOM,ARG,2018.0,1,0,1
ISR,KAZ,2022.0,1,0,1
NZL,BRB,2019.0,1,0,1
DEU,NOR,2016.0,76,46,30
USA,DEU,2016.0,1149,1193,-44
FRA,SAU,2013.0,38,5,33
CHE,ESP,2015.0,50,118,-68
POL,GBR,2012.0,64,98,-34
FRA,GBR,2008.0,379,315,64
HRV,GBR,2015.0,11,7,4
GBR,HRV,2020.0,9,8,1
BEL,THA,2017.0,4,5,-1
THA,BEL,2020.0,2,3,-1
USA,RUS,2017.0,134,155,-21
CHN,KOR,2014.0,59,142,-83
USA,AUT,2015.0,132,121,11
JPN,BEL,2019.0,10,11,-1
SGP,USA,2015.0,208,230,-22
AUS,SGP,2008.0,55,49,6
ITA,CHE,2008.0,140,73,67
USA,CAN,2021.0,1024,1129,-105
GBR,GRC,2020.0,150,187,-37
USA,RUS,2010.0,135,167,-32
DEU,NLD,2021.0,258,236,22
SAU,CHN,2020.0,46,51,-5
ITA,USA,2009.0,525,327,198
GRC,ITA,2008.0,10,23,-13
CHE,AUS,2010.0,55,52,3
SWE,IND,2019.0,26,54,-28
USA,NLD,2015.0,344,378,-34
CHE,USA,2011.0,418,510,-92
ESP,GBR,2007.0,166,181,-15
AUS,FRA,2019.0,85,84,1
BRA,ITA,2015.0,33,58,-25
NLD,USA,2003.0,257,258,-1
USA,FRA,2015.0,673,848,-175
GRC,CYP,2010.0,29,8,21
FIN,GBR,2019.0,62,67,-5
DEU,AUS,2014.0,148,116,32
CHE,SWE,2008.0,14,27,-13
MEX,PRT,2015.0,2,2,0
GRC,ROU,2013.0,1,2,-1
DNK,NOR,2013.0,29,21,8
NAM,USA,2013.0,3,3,0
GBR,CYP,2011.0,33,5,28
TUN,ARE,2014.0,5,2,3
EGY,AUS,2020.0,14,10,4
IND,CAN,2015.0,115,80,35
GRC,GBR,2005.0,77,127,-50
GBR,SGP,2015.0,142,81,61
CRI,MEX,2009.0,3,1,2
NLD,DEU,2020.0,329,293,36
VNM,GBR,2011.0,8,17,-9
CHN,IRN,2015.0,8,16,-8
TUR,PAK,2018.0,13,15,-2
CAN,EGY,2013.0,30,21,9
ITA,CAN,2022.0,38,20,18
AUS,AUT,2013.0,10,16,-6
GBR,BEL,2014.0,99,112,-13
ITA,DEU,2013.0,292,151,141
CAN,LBN,2009.0,5,9,-4
DEU,CHE,1999.0,155,126,29
MAR,FRA,2015.0,34,115,-81
RUS,USA,2014.0,140,144,-4
MEX,ESP,2021.0,92,90,2
GBR,THA,2015.0,93,28,65
USA,MOZ,2009.0,5,2,3
FIN,ESP,2018.0,17,21,-4
GBR,AUT,2018.0,81,70,11
CAN,URY,2012.0,2,1,1
GBR,DEU,1999.0,109,152,-43
MMR,THA,2011.0,1,1,0
GRC,CYP,2017.0,56,13,43
GBR,NLD,2016.0,255,318,-63
DNK,SWE,2003.0,48,55,-7
FRA,CAN,2014.0,350,250,100
USA,JOR,2016.0,59,31,28
USA,IRN,2002.0,17,13,4
RUS,NZL,2011.0,1,2,-1
ISR,USA,2016.0,408,307,101
KOR,IND,2013.0,105,175,-70
GBR,CHN,2022.0,364,231,133
IND,CHN,2016.0,129,29,100
MYS,IRQ,2020.0,118,17,101
TZA,GBR,2015.0,2,13,-11
ARG,ESP,2014.0,59,69,-10
GBR,AUS,2022.0,222,202,20
REU,FRA,2015.0,8,7,1
JPN,IDN,2020.0,181,60,121
CHN,FRA,2017.0,150,201,-51
KEN,ZAF,2018.0,12,24,-12
BEL,PRT,2010.0,8,4,4
ISR,AUS,2018.0,16,11,5
MYS,BGD,2018.0,68,13,55
USA,ITA,2020.0,376,487,-111
GRC,USA,2020.0,99,77,22
CHE,AUS,2017.0,49,61,-12
CAN,CHL,2008.0,10,6,4
USA,RUS,2019.0,120,168,-48
SWE,IND,2010.0,13,25,-12
ITA,IRN,2014.0,10,38,-28
SRB,USA,2008.0,12,15,-3
IND,POL,2012.0,16,3,13
GBR,VNM,2015.0,13,18,-5
CHE,MWI,2021.0,5,3,2
USA,LTU,2015.0,6,5,1
CAN,ISR,2013.0,45,44,1
USA,ARG,1999.0,47,42,5
CHE,CHN,2021.0,74,47,27
SAU,ARE,2022.0,9,4,5
GBR,CHE,2018.0,275,228,47
IND,PAK,2015.0,35,24,11
CAN,POL,2020.0,10,6,4
RUS,POL,2004.0,6,6,0
BEL,MAR,2015.0,8,1,7
BFA,FRA,2013.0,7,11,-4
THA,JPN,2015.0,48,99,-51
FRA,ITA,2001.0,146,132,14
FIN,CHE,2005.0,5,3,2
SWE,NLD,2002.0,32,21,11
CAN,FIN,2016.0,14,14,0
ETH,IND,2020.0,27,70,-43
VEN,ESP,2016.0,21,21,0
CHE,GBR,2022.0,115,130,-15
GRC,CYP,2019.0,60,17,43
CHN,HKG,1997.0,17,14,3
HKG,ZAF,2018.0,3,2,1
DEU,BEL,2014.0,94,81,13
CHN,HKG,1998.0,21,16,5
USA,SLE,2017.0,9,5,4
SWE,PAK,2010.0,4,7,-3
FRA,EGY,2015.0,19,9,10
NZL,AUS,2021.0,97,96,1
USA,ARE,2017.0,79,54,25
FRA,NLD,2022.0,38,29,9
AUT,ITA,2008.0,16,34,-18
CHN,FRA,2019.0,158,212,-54
USA,SGP,2001.0,51,63,-12
NGA,VNM,2018.0,2,1,1
NLD,SGP,2022.0,2,5,-3
OMN,GBR,2019.0,9,20,-11
USA,GEO,2016.0,29,9,20
AUS,IND,2002.0,12,22,-10
DNK,FRA,2019.0,36,65,-29
USA,NZL,2022.0,23,39,-16
ESP,USA,2000.0,134,90,44
DEU,GHA,2020.0,17,7,10
ROU,ISR,2018.0,2,2,0
ITA,LUX,2018.0,14,2,12
FRA,IND,2020.0,70,88,-18
NGA,MYS,2016.0,33,50,-17
MEX,ARG,2013.0,14,11,3
BRA,MOZ,2020.0,7,4,3
CHE,ARG,2013.0,4,10,-6
MYS,GBR,2021.0,63,59,4
AUT,FIN,2021.0,9,5,4
IRN,CHE,2017.0,25,13,12
IRN,CHE,2019.0,43,11,32
GRD,USA,2016.0,14,6,8
LBN,USA,2022.0,69,14,55
JPN,DNK,2020.0,11,6,5
BWA,ZAF,2020.0,10,9,1
USA,KEN,2005.0,17,18,-1
DNK,CHN,2022.0,45,48,-3
RUS,FIN,2018.0,34,16,18
CAN,GBR,1997.0,32,33,-1
ARE,IND,2015.0,12,23,-11
ITA,SWE,1999.0,15,22,-7
HRV,ITA,2021.0,5,6,-1
IDN,GBR,2008.0,6,4,2
USA,ARE,2019.0,112,77,35
IND,DNK,2020.0,33,13,20
FRA,ESP,2022.0,104,79,25
BEL,USA,2018.0,196,139,57
IND,MYS,2008.0,29,17,12
MEX,GBR,2022.0,15,15,0
LUX,BEL,2020.0,6,18,-12
CAN,KEN,2021.0,2,5,-3
ZAF,GBR,2016.0,92,78,14
PAK,MYS,2021.0,37,100,-63
MWI,GBR,2012.0,11,11,0
COL,BRA,2011.0,18,19,-1
SWE,CHN,2009.0,30,53,-23
SWE,ARE,2020.0,5,6,-1
CAN,KWT,2011.0,13,1,12
ESP,BEL,2013.0,57,26,31
VEN,USA,2011.0,25,13,12
FRA,IRL,2011.0,26,24,2
SWE,DEU,2001.0,48,49,-1
IND,FRA,2015.0,79,84,-5
NOR,NLD,2013.0,15,37,-22
DEU,RUS,2009.0,64,124,-60
ESP,ARG,2004.0,28,69,-41
ARG,BRA,2014.0,21,27,-6
PER,USA,2015.0,45,31,14
FRA,GAB,2002.0,12,2,10
DNK,CHE,2022.0,21,19,2
NLD,CHE,2014.0,84,55,29
FRA,SGP,2012.0,24,21,3
GBR,TWN,2009.0,36,18,18
USA,IRN,2005.0,30,30,0
JPN,MEX,2007.0,4,2,2
BEL,IDN,2017.0,4,1,3
HKG,AUS,1999.0,7,19,-12
BEL,CHN,2006.0,10,8,2
JOR,USA,2012.0,32,42,-10
DEU,IND,2003.0,45,79,-34
MEX,BRA,2021.0,22,22,0
USA,DNK,2005.0,73,86,-13
CHN,NOR,2015.0,22,15,7
IRL,DEU,2005.0,12,30,-18
SWE,NLD,2005.0,23,25,-2
FRA,BEL,2000.0,39,33,6
DNK,ISR,2012.0,1,6,-5
MEX,CHE,2016.0,7,11,-4
CHL,ECU,2020.0,16,9,7
UKR,USA,2019.0,16,17,-1
CHL,ITA,2021.0,14,6,8
SGP,BGD,2012.0,5,2,3
AUS,IND,2005.0,13,40,-27
CHE,JPN,2006.0,27,28,-1
ISR,FRA,2004.0,15,23,-8
BRA,CAN,2001.0,16,20,-4
CAN,IRN,2002.0,30,21,9
THA,USA,2004.0,51,147,-96
DEU,BGD,2018.0,7,6,1
JPN,EGY,2002.0,20,7,13
UKR,SWE,2005.0,6,3,3
AUS,JPN,2006.0,35,50,-15
FIN,GBR,2010.0,38,47,-9
SGP,SWE,2012.0,8,15,-7
HND,USA,2015.0,2,2,0
PAK,IND,2019.0,32,50,-18
UKR,USA,2017.0,27,15,12
NPL,CHN,2019.0,9,15,-6
HUN,ITA,2018.0,9,11,-2
FRA,TUN,2015.0,116,78,38
THA,NGA,2020.0,5,1,4
GRC,DNK,2014.0,15,4,11
NLD,DNK,2014.0,36,17,19
FRA,JOR,2019.0,2,1,1
USA,SLE,2019.0,3,5,-2
USA,KAZ,2018.0,11,11,0
ARE,CHN,2021.0,3,14,-11
COL,NLD,2010.0,3,1,2
COL,NLD,2017.0,8,8,0
FIN,GRC,2015.0,4,3,1
UKR,JPN,2020.0,1,1,0
CHN,BEL,2007.0,12,17,-5
AUT,MYS,2012.0,4,1,3
NGA,ITA,2020.0,6,1,5
AUS,ITA,2022.0,14,12,2
LKA,USA,2021.0,12,12,0
PNG,AUS,2019.0,10,8,2
VNM,TWN,2020.0,15,36,-21
NOR,DNK,2007.0,17,23,-6
TWN,USA,1999.0,56,111,-55
BEL,IDN,2019.0,8,1,7
PER,CHL,2022.0,5,4,1
KEN,GBR,2004.0,10,20,-10
TUN,SAU,2013.0,38,5,33
AUT,KOR,2018.0,10,6,4
HRV,SRB,2020.0,7,7,0
AUT,SWE,2021.0,17,14,3
NLD,NOR,2022.0,10,11,-1
AUS,ARE,2020.0,25,13,12
GBR,BRA,2001.0,40,43,-3
BEL,PRT,2019.0,7,16,-9
RUS,KGZ,2019.0,3,3,0
FRA,VNM,2006.0,12,1,11
EGY,TUR,2018.0,1,3,-2
CZE,IND,2017.0,5,16,-11
NGA,IND,2020.0,3,8,-5
ESP,DNK,2005.0,10,9,1
ZWE,GBR,2016.0,24,2,22
CAN,COL,2011.0,6,5,1
UKR,USA,2010.0,23,17,6
SWE,DNK,2012.0,74,66,8
GBR,KEN,2007.0,15,12,3
ESP,HUN,2016.0,4,2,2
BGR,BEL,2004.0,6,6,0
USA,PRI,2014.0,39,83,-44
AUS,MYS,2007.0,23,19,4
CAN,IRN,2005.0,39,38,1
NPL,IND,2013.0,16,14,2
SGP,ESP,2016.0,6,11,-5
OMN,GBR,2017.0,13,14,-1
BEL,ARM,2017.0,1,1,0
PHL,USA,2015.0,24,40,-16
GUF,FRA,2009.0,15,8,7
FRA,GRC,2003.0,30,19,11
RUS,SWE,2004.0,40,16,24
POL,RUS,2013.0,11,3,8
BEL,ESP,2004.0,19,14,5
DOM,USA,2013.0,4,4,0
AUS,CHL,2007.0,4,4,0
CAN,MEX,2002.0,20,14,6
FRA,CZE,2000.0,8,4,4
BEL,HRV,2011.0,1,1,0
SVK,CZE,1999.0,5,7,-2
IRL,DEU,2002.0,13,16,-3
JPN,SWE,2003.0,22,30,-8
RUS,TUR,2002.0,7,3,4
CAN,BRA,2003.0,31,28,3
LBN,EGY,2013.0,3,3,0
POL,IRL,2007.0,2,2,0
BEL,POL,1998.0,2,1,1
SWE,NZL,2007.0,5,4,1
UKR,IND,2020.0,1,1,0
SGP,CAN,2002.0,18,17,1
BRB,USA,2015.0,2,2,0
USA,EST,2008.0,7,2,5
USA,CHE,2000.0,108,145,-37
ZAF,KEN,2005.0,4,6,-2
AUT,SVN,2009.0,2,1,1
GRC,CHE,2007.0,12,4,8
FRA,TUR,2009.0,12,7,5
HUN,GBR,2008.0,29,9,20
BEL,RUS,2006.0,6,7,-1
SWE,AUT,2004.0,5,4,1
FIN,CHE,2002.0,10,3,7
RUS,MNG,2001.0,1,1,0
FRA,NCL,2022.0,6,8,-2
USA,KEN,2002.0,18,25,-7
VNM,SWE,2003.0,1,2,-1
ITA,CHL,2017.0,13,10,3
ESP,CZE,2004.0,3,1,2
PAK,GBR,1997.0,3,3,0
TUR,CHE,2004.0,5,2,3
LVA,CHE,2002.0,1,2,-1
RUS,IRL,2014.0,3,3,0
IDN,USA,2012.0,10,18,-8
SAU,QAT,2003.0,3,2,1
POL,CHE,2001.0,8,12,-4
VNM,AUS,2012.0,9,8,1
DEU,PRT,1998.0,5,1,4
FRA,PYF,2015.0,20,7,13
CAN,CZE,2010.0,9,5,4
CAN,CZE,2017.0,12,4,8
HKG,DEU,1998.0,4,1,3
NOR,GBR,1998.0,8,7,1
SVN,DEU,2006.0,3,9,-6
IND,LBY,2006.0,1,1,0
CAN,MEX,2005.0,16,14,2
NOR,ISL,2010.0,11,4,7
GMB,GBR,2002.0,10,8,2
GBR,CHL,2007.0,9,19,-10
FRA,FIN,2011.0,18,17,1
NLD,TUR,2010.0,9,23,-14
NZL,NLD,2001.0,4,5,-1
UZB,RUS,2007.0,7,1,6
USA,ZAF,2022.0,26,44,-18
IRL,JPN,2003.0,1,5,-4
NLD,ISR,2021.0,8,6,2
URY,BRA,2011.0,3,6,-3
CHE,DNK,2002.0,9,17,-8
COL,GBR,2016.0,14,14,0
RWA,USA,2013.0,8,6,2
ZAF,SAU,2012.0,10,3,7
POL,NZL,2008.0,1,2,-1
CHN,NGA,2015.0,11,11,0
NLD,SRB,2009.0,1,3,-2
BEL,ITA,2012.0,38,78,-40
SGP,CAN,2005.0,23,13,10
CZE,AUT,2011.0,10,6,4
KEN,IND,2009.0,2,1,1
IRL,IND,2013.0,8,10,-2
AZE,TUR,2003.0,8,2,6
SWE,ROU,2011.0,2,4,-2
IRL,NZL,2018.0,14,8,6
MWI,USA,2005.0,3,3,0
NLD,TUR,2017.0,20,21,-1
BEL,CHE,2012.0,39,37,2
IRL,ZAF,2015.0,1,5,-4
SWE,ISR,2014.0,6,6,0
HUN,CHN,2020.0,6,12,-6
ISL,ITA,2015.0,3,4,-1
AUT,LUX,2018.0,3,2,1
PRT,GRC,2019.0,3,2,1
ARE,EGY,2009.0,10,6,4
SWE,SGP,2018.0,5,13,-8
DNK,NLD,2012.0,16,21,-5
ARG,AUS,2021.0,6,4,2
FIN,DEU,2015.0,46,52,-6
THA,IDN,2018.0,11,6,5
BGD,HKG,2020.0,5,3,2
GBR,LTU,2011.0,4,1,3
CHE,LUX,2013.0,5,3,2
NOR,ISL,2019.0,4,2,2
SRB,BIH,2013.0,11,5,6
POL,ZAF,2020.0,4,2,2
JPN,BEL,2010.0,6,11,-5
NOR,CHE,2014.0,7,14,-7
ITA,JPN,2009.0,8,18,-10
IND,GHA,2016.0,4,3,1
MYS,SDN,2022.0,3,1,2
SVK,SVN,2020.0,4,5,-1
JPN,GHA,2020.0,8,2,6
JOR,MYS,2015.0,5,17,-12
AUT,NOR,2020.0,12,7,5
SVK,JPN,2015.0,2,1,1
BRA,ARG,2012.0,12,19,-7
KAZ,USA,2016.0,11,21,-10
BEL,BRA,2021.0,10,31,-21
JPN,BEL,2017.0,10,17,-7
CHN,UKR,2016.0,4,8,-4
FRA,JOR,2017.0,4,3,1
AUS,VNM,2015.0,24,17,7
SWE,IRN,2018.0,14,35,-21
COL,NLD,2019.0,8,14,-6
ISL,NOR,2022.0,2,1,1
PRT,NZL,2019.0,3,4,-1
USA,CYP,2022.0,5,4,1
HKG,MYS,2021.0,2,2,0
TWN,SGP,2020.0,11,9,2
SWZ,USA,2019.0,5,2,3
MAC,CAN,2017.0,1,1,0
ISR,DNK,2019.0,5,2,3
HUN,ESP,2020.0,5,2,3
CZE,IND,2019.0,7,24,-17
CAN,RUS,2021.0,13,10,3
NGA,SAU,2020.0,4,5,-1
ESP,ROU,2022.0,3,1,2
RUS,BLR,2021.0,8,8,0
NLD,SAU,2021.0,9,4,5
PAK,THA,2021.0,6,8,-2
NZL,ARE,2015.0,2,1,1
CHN,IND,2004.0,3,8,-5
NLD,BEL,2001.0,51,67,-16
CAN,NLD,2003.0,22,49,-27
NLD,AUS,2000.0,5,5,0
DEU,CZE,2004.0,19,31,-12
TGO,FRA,2001.0,1,4,-3
ESP,DNK,2002.0,11,12,-1
USA,HUN,2016.0,48,49,-1
BGR,NLD,2015.0,1,3,-2
THA,KOR,2011.0,5,3,2
BEL,SVN,2021.0,3,1,2
BGD,GBR,2018.0,22,23,-1
PAK,IDN,2019.0,1,1,0
CAN,DNK,2016.0,25,31,-6
CHE,NGA,2022.0,4,4,0
FIN,AUS,2013.0,11,7,4
DEU,MEX,2006.0,17,14,3
USA,ZMB,2004.0,4,2,2
JOR,GBR,2001.0,1,5,-4
LBN,GBR,2009.0,5,5,0
NPL,GBR,2022.0,3,4,-1
GRC,NOR,2015.0,13,2,11
UKR,SWE,2002.0,10,2,8
OMN,IND,2015.0,13,21,-8
ZAF,LSO,2022.0,1,1,0
FRA,LVA,2013.0,1,1,0
OMN,QAT,2015.0,2,2,0
DEU,HKG,2009.0,5,13,-8
THA,MYS,2014.0,6,6,0
POL,CZE,2016.0,17,13,4
IND,SYR,2021.0,3,1,2
CAN,DZA,2018.0,3,11,-8
KOR,EGY,2019.0,8,6,2
CHE,ZAF,2021.0,9,9,0
FRA,KAZ,2019.0,6,2,4
NGA,BRA,2019.0,10,10,0
BRA,NGA,2015.0,5,9,-4
KOR,ISR,2021.0,4,7,-3
KOR,EGY,2017.0,7,2,5
PAK,ESP,2015.0,2,1,1
BEL,PRT,2017.0,12,17,-5
ITA,IND,2007.0,7,24,-17
QAT,CAN,2020.0,5,15,-10
CYP,USA,2022.0,4,5,-1
IRL,ROU,2020.0,3,5,-2
JPN,CZE,2020.0,10,4,6
NPL,CHN,2017.0,6,9,-3
IRN,ARM,2014.0,2,4,-2
ESP,TWN,2022.0,2,5,-3
IDN,DEU,2022.0,6,9,-3
NOR,FIN,2000.0,3,1,2
IND,SWE,2001.0,7,3,4
MEX,CHL,2004.0,4,4,0
SWE,POL,2005.0,6,13,-7
PHL,AUS,2002.0,5,1,4
CHN,CHE,1998.0,1,3,-2
NLD,CHL,2012.0,4,4,0
JOR,SAU,2006.0,6,3,3
TZA,NOR,2003.0,3,3,0
LTU,SWE,1997.0,1,1,0
MYS,SGP,2009.0,10,17,-7
NAM,ZAF,2011.0,3,6,-3
BGD,AUS,2003.0,2,3,-1
KOR,ITA,1998.0,1,1,0
FRA,MLI,1998.0,1,1,0
ROU,ESP,2010.0,6,9,-3
NOR,TUR,2014.0,3,4,-1
KEN,CAN,2015.0,10,7,3
DEU,GAB,2020.0,3,6,-3
GBR,LBN,2008.0,3,6,-3
GEO,RUS,2010.0,5,2,3
RUS,ARG,2007.0,1,1,0
NPL,NOR,2013.0,1,1,0
ARE,GBR,2007.0,9,20,-11
ROU,TUR,2018.0,3,2,1
PRT,AUS,2009.0,2,2,0
BEL,AUT,2006.0,8,3,5
BRA,AUT,2013.0,5,3,2
IND,HKG,2007.0,1,4,-3
BEL,SVK,2010.0,3,4,-1
CUB,JPN,2007.0,1,1,0
PRT,COL,2015.0,1,1,0
CHE,NZL,2014.0,7,11,-4
SRB,MKD,2013.0,2,2,0
PRT,ROU,2021.0,1,1,0
LBN,SAU,2014.0,6,2,4
OMN,GBR,2010.0,3,2,1
IND,TUR,2015.0,7,2,5
KOR,NLD,2013.0,7,10,-3
UGA,SWE,2010.0,1,2,-1
NZL,CHL,2014.0,1,4,-3
ESP,MOZ,2015.0,4,2,2
GRC,BEL,2022.0,5,4,1
EGY,DNK,2016.0,2,1,1
SDN,CHN,2014.0,3,7,-4
GAB,MAR,2015.0,1,3,-2
PAK,JPN,2010.0,4,9,-5
NPL,USA,2013.0,21,5,16
BRN,THA,2018.0,1,1,0
VNM,RUS,2021.0,6,9,-3
PNG,AUS,2017.0,12,8,4
NOR,ISL,2017.0,4,5,-1
NGA,TUR,2014.0,2,4,-2
POL,MEX,2020.0,2,2,0
FIN,POL,2018.0,6,9,-3
MEX,DNK,2022.0,6,1,5
KEN,CHN,2022.0,1,7,-6
MYS,USA,2003.0,11,19,-8
BOL,USA,2010.0,3,4,-1
DZA,BEL,2013.0,3,2,1
MYS,CHE,2021.0,2,4,-2
CHN,FIN,2015.0,18,19,-1
ISR,MEX,2011.0,2,1,1
TUR,IRL,2015.0,3,2,1
BEL,SWE,2022.0,10,6,4
GBR,UKR,2008.0,5,13,-8
BLR,IRN,2009.0,3,1,2
SWE,PRT,2022.0,5,6,-1
CAN,ROU,2016.0,4,4,0
ESP,NOR,1997.0,2,1,1
POL,NOR,2022.0,6,2,4
PAK,JPN,2019.0,3,8,-5
TUR,BEL,2009.0,7,4,3
MNE,SRB,2005.0,1,1,0
RWA,ZAF,2016.0,5,1,4
RUS,AZE,2012.0,5,1,4
USA,GUM,2016.0,6,3,3
AUS,HRV,2016.0,2,3,-1
NLD,ZWE,2014.0,5,1,4
BEN,CIV,2013.0,2,1,1
UGA,SWE,2017.0,2,2,0
UGA,PER,2018.0,1,1,0
PAK,NPL,2015.0,2,1,1
CHE,PHL,2021.0,4,1,3
QAT,SVK,2016.0,1,1,0
SWZ,USA,2017.0,1,4,-3
GRC,ARE,2022.0,3,2,1
PRT,IRN,2014.0,5,11,-6
IDN,SAU,2018.0,2,4,-2
RUS,TJK,2019.0,7,2,5
ESP,TTO,2016.0,1,3,-2
AUS,FJI,2000.0,2,1,1
TUR,KOR,2015.0,2,5,-3
CAN,CZE,2019.0,9,6,3
ITA,CYP,2013.0,1,1,0
ROU,ESP,2019.0,5,2,3
MAR,TUR,2021.0,3,3,0
HKG,TWN,2012.0,9,6,3
MNG,JPN,2016.0,4,10,-6
ROU,USA,2013.0,8,12,-4
SVN,CHE,2010.0,4,2,2
SRB,GBR,2012.0,2,12,-10
ETH,GBR,2005.0,3,1,2
MWI,DEU,2019.0,1,1,0
DNK,BEL,1997.0,1,1,0
LAO,FRA,2019.0,4,1,3
CHE,SRB,2020.0,5,8,-3
UGA,GBR,1999.0,3,1,2
ESP,SWE,2000.0,9,5,4
CHL,AUS,2003.0,4,3,1
SWE,IRQ,2011.0,4,1,3
AUT,RUS,2012.0,3,12,-9
ITA,BLR,2007.0,1,3,-2
BEL,LUX,2003.0,6,2,4
ITA,UKR,1999.0,3,2,1
CAN,BGD,2002.0,3,4,-1
KWT,GRC,2020.0,2,1,1
SWE,POL,2002.0,7,11,-4
HUN,POL,2003.0,1,5,-4
CAN,BGD,2005.0,4,8,-4
AUS,BGD,2001.0,1,2,-1
HRV,DEU,2012.0,7,7,0
FRA,NER,2018.0,7,3,4
NGA,KOR,2010.0,1,1,0
QAT,TUR,2018.0,2,6,-4
BGR,GBR,2014.0,6,3,3
EST,GRC,2012.0,1,1,0
BEL,THA,2019.0,2,2,0
BEL,SRB,2019.0,3,2,1
CHN,ZAF,2004.0,2,1,1
ITA,CHL,2019.0,14,15,-1
URY,FRA,2010.0,2,2,0
PAK,IDN,2017.0,1,2,-1
MWI,DEU,2017.0,3,1,2
FRA,UGA,2018.0,3,2,1
ESP,EGY,2011.0,3,4,-1
ZAF,JPN,2020.0,2,4,-2
PNG,AUS,2010.0,3,3,0
ETH,BEL,2003.0,2,1,1
TUR,KGZ,2017.0,2,2,0
CHN,ISL,2020.0,1,2,-1
ZWE,CHE,2006.0,2,1,1
LAO,FRA,2017.0,3,2,1
PER,CHE,2018.0,1,3,-2
KHM,LAO,2020.0,3,1,2
HRV,NLD,2013.0,4,2,2
ESP,PAK,2021.0,2,5,-3
TWN,PAK,2021.0,7,7,0
SRB,MNE,2021.0,6,16,-10
KGZ,RUS,2007.0,2,1,1
BEL,ZAF,2003.0,5,6,-1
ETH,GBR,2002.0,2,1,1
ESP,SGP,2000.0,2,1,1
FIN,CHN,2001.0,5,10,-5
FIN,EGY,2014.0,1,3,-2
BRA,PER,2006.0,4,2,2
PAK,BEL,2014.0,1,1,0
CAN,JAM,2011.0,4,1,3
GBR,VEN,2009.0,3,5,-2
KOR,ITA,1997.0,1,1,0
FIN,IND,2002.0,1,2,-1
GRC,EGY,2005.0,1,1,0
CHE,UGA,2005.0,2,1,1
DEU,VEN,2003.0,2,2,0
AUS,BRA,2004.0,6,15,-9
DEU,PRI,2008.0,2,1,1
CZE,CAN,2021.0,4,5,-1
ROU,POL,2017.0,3,1,2
PNG,IND,2012.0,2,1,1
CHE,TUR,2009.0,7,8,-1
IND,RUS,2006.0,3,1,2
LTU,RUS,2017.0,1,4,-3
SVN,USA,1997.0,1,1,0
ESP,GNQ,2014.0,1,2,-1
DEU,GEO,2014.0,4,1,3
HUN,NOR,2016.0,6,2,4
MWI,DEU,2010.0,2,2,0
EGY,MYS,2022.0,5,1,4
PAK,JPN,2017.0,3,8,-5
GBR,ARG,2021.0,10,9,1
SWE,LKA,2018.0,3,2,1
JOR,DEU,2018.0,9,11,-2
BGD,NZL,2021.0,2,3,-1
USA,LVA,2006.0,2,1,1
TWN,CAN,2000.0,2,5,-3
AUS,RUS,2000.0,2,3,-1
HKG,SAU,2013.0,1,1,0
FRA,IRQ,2013.0,2,1,1
CHN,ISR,1998.0,1,1,0
AUT,ISR,2003.0,2,3,-1
OMN,JOR,2001.0,2,3,-1
PRT,CAN,2012.0,8,5,3
NOR,SRB,2012.0,1,1,0
AUT,ROU,2011.0,3,3,0
JPN,PAK,2003.0,3,2,1
HKG,KOR,2003.0,3,1,2
KOR,CZE,2015.0,3,2,1
ESP,NOR,1998.0,1,1,0
ISR,ROU,2016.0,2,1,1
SWE,TZA,2011.0,3,2,1
MAR,CHE,2004.0,3,1,2
BEL,THA,2010.0,3,1,2
NER,GBR,2017.0,1,2,-1
KOR,EGY,2010.0,6,1,5
SRB,CHE,2013.0,5,4,1
ZWE,IDN,2002.0,1,2,-1
UKR,ITA,2002.0,2,2,0
LTU,CAN,2012.0,1,2,-1
BEL,DZA,2018.0,8,3,5
IRN,BEL,2006.0,2,1,1
THA,ITA,2022.0,2,3,-1
CHE,SWZ,2018.0,2,1,1
GHA,GBR,2003.0,1,6,-5
QAT,MYS,2011.0,2,1,1
MEX,CUB,2021.0,4,6,-2
UKR,ITA,2005.0,3,1,2
SVK,HRV,2019.0,1,2,-1
ITA,NZL,2007.0,4,2,2
TUN,OMN,2016.0,2,2,0
EGY,OMN,2006.0,1,1,0
GBR,TTO,2004.0,4,2,2
CHN,EGY,2004.0,1,1,0
KHM,CHE,2013.0,1,1,0
UKR,TUR,2021.0,1,1,0
AUS,BRN,2006.0,3,2,1
DNK,PHL,2006.0,1,1,0
KOR,NZL,2013.0,3,3,0
AUS,ZAF,2000.0,1,4,-3
PRT,BEL,2000.0,2,1,1
JPN,COL,2014.0,2,3,-1
BRA,CRI,2005.0,1,1,0
NGA,BRA,2010.0,1,1,0
MWI,ZMB,2020.0,3,2,1
LKA,ZAF,2017.0,1,1,0
JOR,SWE,2015.0,1,2,-1
BGD,BEL,2018.0,5,5,0
PER,MEX,2010.0,1,2,-1
LKA,NZL,2013.0,5,1,4
HKG,FRA,2009.0,5,6,-1
COL,ZAF,2013.0,1,1,0
ROU,GRC,2013.0,2,1,1
COL,JPN,2012.0,2,4,-2
CHL,TUN,2020.0,1,1,0
NGA,NER,2014.0,1,1,0
COL,GTM,2018.0,3,1,2
NGA,BRA,2017.0,2,6,-4
IRL,SGP,2022.0,1,3,-2
GBR,KAZ,2008.0,2,3,-1
USA,IDN,1997.0,1,6,-5
CMR,DEU,2013.0,5,1,4
USA,FJI,2007.0,4,1,3
CHN,PHL,2015.0,3,1,2
SWE,ETH,2000.0,1,1,0
TUR,SGP,2012.0,2,3,-1
UGA,KEN,2012.0,2,1,1
EST,NLD,2019.0,1,3,-2
THA,LAO,2019.0,5,4,1
JPN,KHM,2012.0,1,1,0
NOR,GBR,1997.0,2,2,0
DZA,PRT,2001.0,1,1,0
ZAF,ISR,2002.0,1,2,-1
SAU,HKG,2011.0,1,3,-2
LTU,RUS,2019.0,4,2,2
DEU,MCO,2013.0,2,2,0
DEU,HRV,2004.0,7,9,-2
SWE,HRV,2014.0,2,4,-2
NOR,PAK,2014.0,3,2,1
RUS,TUR,2005.0,5,4,1
ALB,DEU,2006.0,1,2,-1
USA,CUB,1999.0,1,2,-1
GBR,KWT,2008.0,2,6,-4
TUR,KGZ,2019.0,1,1,0
FIN,ARG,2001.0,1,1,0
BLR,UKR,2014.0,1,1,0
CHN,ESP,2002.0,1,1,0
BGD,TUR,2011.0,1,1,0
ARM,RUS,1998.0,1,1,0
ITA,CHL,2010.0,3,3,0
CZE,IND,2010.0,1,3,-2
CAN,MAC,2017.0,1,1,0
RUS,TWN,2014.0,2,5,-3
CZE,CHL,2020.0,3,1,2
URY,FRA,2019.0,2,4,-2
CHE,COL,2021.0,1,4,-3
FRA,KAZ,2017.0,3,3,0
ZAF,KEN,2002.0,2,1,1
GIB,GBR,2018.0,1,1,0
RUS,EGY,2020.0,8,7,1
GHA,KOR,2021.0,2,5,-3
UKR,KOR,2008.0,2,1,1
NOR,ZMB,2008.0,1,1,0
JOR,JPN,2008.0,1,1,0
PAN,AUS,2014.0,1,1,0
MEX,TWN,2014.0,1,1,0
PAK,FIN,2015.0,1,1,0
DEU,ETH,2007.0,4,8,-4
PSE,CHN,2021.0,2,3,-1
IRL,BLR,2007.0,1,1,0
ALB,SRB,2017.0,2,1,1
PAK,SWE,2007.0,3,1,2
ISR,ZAF,2003.0,3,1,2
PRT,CHE,2004.0,2,6,-4
ISR,DNK,2017.0,3,2,1
BRN,SGP,2020.0,1,2,-1
ROU,ESP,2017.0,1,10,-9
CUB,BEL,2022.0,1,1,0
EST,NLD,2017.0,2,3,-1
CHE,HRV,2000.0,1,2,-1
MKD,CZE,2018.0,1,2,-1
LAO,FRA,2010.0,1,1,0
HUN,CZE,2001.0,1,1,0
CYP,POL,2020.0,2,1,1
DJI,FRA,2018.0,3,4,-1
UGA,CAN,2021.0,1,2,-1
USA,LUX,2015.0,2,2,0
NGA,NZL,2020.0,2,3,-1
AFG,JPN,2019.0,2,5,-3
RUS,KGZ,2010.0,1,3,-2
CRI,NLD,2001.0,1,2,-1
KEN,CHE,2006.0,2,1,1
DEU,LIE,1999.0,2,2,0
UKR,BEL,1999.0,2,1,1
DZA,ITA,2011.0,1,2,-1
SVK,RUS,1999.0,1,2,-1
ZAF,ISR,2005.0,1,1,0
LVA,RUS,2011.0,1,1,0
DNK,ETH,2002.0,1,2,-1
USA,YEM,2008.0,1,1,0
DEU,BOL,2014.0,2,3,-1
BEL,GRC,2012.0,7,14,-7
KEN,ITA,2011.0,2,2,0
CZE,BRA,2001.0,1,1,0
IND,EGY,2007.0,2,2,0
NLD,ISL,2014.0,1,1,0
CHL,URY,2014.0,1,6,-5
PRT,UKR,2013.0,1,1,0
CAN,BRB,2018.0,1,1,0
SDN,TUR,2018.0,1,1,0
SVK,ESP,2022.0,1,1,0
FRA,ROU,1999.0,6,10,-4
CRI,ECU,2018.0,1,1,0
LBN,ESP,2021.0,2,1,1
DNK,BEL,1998.0,1,1,0
GBR,CMR,2006.0,1,2,-1
CAN,ARE,1999.0,4,2,2
ARE,NLD,2014.0,2,4,-2
CHE,KEN,2006.0,1,2,-1
AFG,USA,2012.0,1,6,-5
IRL,DNK,2002.0,1,2,-1
ISR,DNK,2010.0,2,2,0
IDN,CZE,2009.0,1,1,0
CAN,SVK,2013.0,3,2,1
KWT,PAK,2022.0,1,3,-2
GEO,RUS,2019.0,1,4,-3
AUT,IRN,2022.0,2,11,-9
BOL,USA,2019.0,1,3,-2
LKA,ZAF,2019.0,1,2,-1
CYP,ITA,2015.0,3,3,0
PHL,CHN,2014.0,2,3,-1
AUT,SGP,2018.0,3,5,-2
GLP,FRA,2021.0,2,4,-2
FRA,GAB,2005.0,1,3,-2
ITA,SAU,2004.0,1,2,-1
USA,CMR,2003.0,5,1,4
TZA,MWI,2016.0,1,1,0
UGA,SWE,2019.0,4,2,2
VNM,CHL,2016.0,1,1,0
URY,GBR,2016.0,1,1,0
DNK,KOR,2014.0,1,11,-10
BEL,PAN,2021.0,2,1,1
BWA,ETH,2020.0,1,1,0
ARM,RUS,1997.0,1,2,-1
SGP,ITA,2004.0,1,2,-1
GRC,IRL,2011.0,2,3,-1
BRA,EGY,2020.0,4,1,3
COG,GAB,2022.0,1,1,0
KWT,NGA,2002.0,1,2,-1
ITA,LBN,2007.0,2,2,0
EGY,BRA,2022.0,2,1,1
NOR,ARE,2022.0,2,1,1
UGA,COG,2016.0,1,2,-1
ESP,BLR,2010.0,2,2,0
IRL,DNK,2005.0,1,1,0
FRA,KHM,2022.0,3,1,2
IRN,GBR,1997.0,1,2,-1
ESP,AND,2018.0,1,2,-1
SWE,COL,2008.0,1,1,0
FIN,PHL,2015.0,1,1,0
VEN,CHL,2006.0,3,2,1
GEO,RUS,2017.0,2,1,1
SWZ,GBR,2014.0,1,1,0
SRB,ESP,2008.0,2,1,1
ECU,PRT,2018.0,2,1,1
CZE,UKR,2011.0,1,1,0
TUN,JPN,2013.0,1,4,-3
FIN,TUR,2016.0,3,4,-1
ESP,HND,2021.0,1,1,0
ECU,COL,2022.0,1,1,0
LBY,GBR,2013.0,1,7,-6
PSE,IRN,2019.0,1,1,0
IND,JOR,2017.0,1,3,-2
URY,FRA,2017.0,1,6,-5
IRL,HKG,2006.0,1,1,0
CZE,IRL,2013.0,1,3,-2
GBR,ARM,2007.0,1,1,0
DEU,OMN,2007.0,1,1,0
NZL,DNK,2016.0,1,4,-3
AUS,OMN,2004.0,1,1,0
SVN,USA,1998.0,1,2,-1
NOR,ZAF,2008.0,1,2,-1
IRN,BLR,2009.0,1,3,-2
NIC,ESP,2016.0,1,1,0
CAN,SVN,2022.0,1,1,0
GBR,PRI,2020.0,1,1,0
PHL,LAO,2013.0,1,1,0
MDA,FRA,2014.0,1,1,0
PAK,NLD,2021.0,1,2,-1
IRQ,LBY,2003.0,1,1,0
LKA,ZAF,2010.0,1,1,0
IRL,POL,2021.0,1,2,-1
CYP,DEU,2008.0,1,1,0
NZL,FJI,2001.0,1,2,-1
ZAF,MOZ,2003.0,1,1,0
ROU,NOR,2006.0,1,1,0
DOM,BRA,2018.0,1,1,0
KEN,ETH,2009.0,1,2,-1
JPN,COD,2020.0,1,1,0
AFG,JPN,2017.0,1,3,-2
CHN,IDN,2007.0,1,1,0
BRN,DEU,2012.0,1,1,0
PHL,THA,2011.0,1,4,-3
FIN,MWI,2011.0,1,1,0
IRQ,NLD,2019.0,1,1,0
KOR,USA,2004.0,507,580,-73
TUR,GBR,2015.0,37,50,-13
CHL,ESP,2007.0,14,32,-18
AUS,FRA,2010.0,79,90,-11
SWE,FRA,2009.0,40,56,-16
MYS,AUS,2009.0,36,36,0
USA,BRA,1999.0,95,84,11
AUS,FRA,2017.0,77,89,-12
DNK,FRA,2010.0,21,22,-1
NLD,TUR,2019.0,19,29,-10
CHN,FRA,2010.0,97,78,19
DEU,FRA,2001.0,200,196,4
JOR,EGY,2015.0,2,2,0
IRN,MYS,2020.0,18,56,-38
FRA,NZL,2014.0,11,6,5
CHE,AUS,2019.0,61,65,-4
EST,DEU,2015.0,8,2,6
IND,KOR,2018.0,198,130,68
GBR,ESP,2021.0,289,235,54
SWE,PAK,2019.0,12,5,7
ITA,VNM,2017.0,9,1,8
RUS,GBR,2018.0,40,44,-4
IND,PRT,2020.0,8,20,-12
DNK,FRA,2017.0,32,65,-33
JPN,EGY,2005.0,34,15,19
FRA,IRN,2015.0,37,22,15
FIN,GBR,2017.0,64,55,9
GBR,SEN,2018.0,2,2,0
MEX,CAN,2016.0,35,30,5
ARG,USA,2020.0,101,58,43
BEL,TUR,2014.0,13,4,9
RUS,MEX,2021.0,1,8,-7
RUS,MYS,2014.0,2,2,0
DEU,KEN,2011.0,13,5,8
ITA,CHN,1999.0,10,4,6
GRC,GBR,2002.0,47,102,-55
AUS,KOR,2008.0,19,15,4
DEU,ARG,2008.0,40,15,25
CAN,SWE,2016.0,39,36,3
PRT,SAU,2012.0,2,1,1
UKR,AUT,2018.0,4,2,2
USA,DNK,2002.0,95,117,-22
PAK,AUS,2014.0,30,17,13
CAN,GBR,1998.0,50,42,8
SWE,JPN,2000.0,17,7,10
IRQ,TUR,2021.0,9,10,-1
SWE,PAK,2017.0,12,5,7
CHN,IRQ,2020.0,10,4,6
USA,BGD,2015.0,24,81,-57
ZMB,CHE,2014.0,1,1,0
THA,GBR,2007.0,25,34,-9
ARE,USA,2013.0,18,68,-50
RUS,ARM,2020.0,9,3,6
DNK,FIN,2015.0,9,15,-6
FRA,GUF,2011.0,21,11,10
DEU,HUN,2009.0,23,37,-14
NZL,BRA,2006.0,1,3,-2
GEO,USA,2009.0,5,9,-4
IRN,GBR,1998.0,1,3,-2
TUN,CAN,2014.0,15,10,5
PRI,USA,2001.0,19,17,2
FRA,MEX,2001.0,22,15,7
CHE,DNK,2005.0,10,9,1
IRL,FRA,2003.0,13,14,-1
IND,SAU,2007.0,9,4,5
GAB,FRA,2000.0,6,2,4
AUS,UKR,2008.0,2,1,1
CHL,CAN,2011.0,16,14,2
ZAF,SWE,2005.0,3,3,0
ISR,BEL,2016.0,2,4,-2
USA,BWA,2015.0,10,10,0
PER,MEX,2019.0,4,4,0
JPN,ZMB,2016.0,4,2,2
THA,LAO,2017.0,6,4,2
POL,SWE,2022.0,10,8,2
GBR,SRB,2009.0,6,8,-2
SRB,QAT,2018.0,3,3,0
DZA,GBR,2016.0,1,5,-4
SVN,CHE,2019.0,5,2,3
THA,AUS,2008.0,16,29,-13
CAN,PAK,2007.0,9,4,5
GMB,GBR,2005.0,8,6,2
CHN,CZE,2014.0,5,1,4
PRT,NZL,2017.0,2,2,0
IND,BEL,2011.0,17,14,3
BEL,IDN,2010.0,4,1,3
IDN,NLD,2011.0,7,8,-1
NZL,ISR,2016.0,2,4,-2
NOR,IND,2021.0,7,20,-13
ESP,CRI,2016.0,4,6,-2
CAN,ISL,2017.0,3,1,2
NZL,IRL,2020.0,10,11,-1
VEN,DEU,2016.0,4,3,1
CMR,FRA,2020.0,9,18,-9
AUS,ARG,2008.0,4,5,-1
ZAF,SWE,2002.0,5,5,0
CAN,TZA,2004.0,2,1,1
AUT,SRB,2003.0,1,1,0
GBR,PHL,2003.0,2,2,0
TUR,GRC,2021.0,2,1,1
NLD,LUX,2015.0,5,5,0
ROU,HUN,2015.0,6,8,-2
SWE,EGY,2009.0,1,2,-1
UKR,GBR,2016.0,9,8,1
JPN,ISR,2018.0,2,6,-4
NOR,BRA,2014.0,2,9,-7
AUT,SVK,2015.0,4,10,-6
IND,ITA,2001.0,4,3,1
CHN,ARG,2019.0,2,1,1
UKR,NOR,2009.0,1,2,-1
IND,ESP,2000.0,2,2,0
HUN,SVK,2021.0,4,4,0
CYP,GBR,2011.0,5,33,-28
CZE,BEL,2015.0,1,11,-10
DNK,NPL,2016.0,1,1,0
RUS,KGZ,2017.0,2,2,0
KAZ,TUR,2021.0,4,2,2
ISR,SGP,2009.0,2,3,-1
CHE,ISL,2009.0,1,1,0
BGD,KOR,2001.0,2,1,1
FRA,URY,2004.0,2,1,1
CHL,POL,2011.0,2,1,1
CHE,POL,1999.0,8,13,-5
NOR,CZE,1999.0,2,1,1
NOR,BEL,2011.0,2,3,-1
DNK,EST,2018.0,1,4,-3
IND,MEX,2004.0,8,1,7
JPN,EST,2012.0,1,1,0
SYR,USA,2020.0,1,1,0
NOR,POL,2000.0,2,1,1
DEU,EGY,1999.0,8,6,2
UKR,MDA,2008.0,2,2,0
THA,CAN,2000.0,3,2,1
ISR,NLD,2014.0,8,9,-1
ARG,NLD,2012.0,4,4,0
ITA,VNM,2019.0,5,5,0
ITA,CMR,2009.0,1,1,0
CHE,MEX,2013.0,4,6,-2
CHL,KOR,2015.0,1,1,0
FIN,IND,2005.0,1,3,-2
SWE,LTU,2007.0,6,8,-2
JPN,ZAF,2018.0,7,4,3
CHL,NLD,2020.0,9,8,1
ZMB,ZAF,2016.0,4,3,1
HUN,JPN,2016.0,4,6,-2
POL,KOR,2018.0,5,5,0
DEU,NAM,2020.0,2,4,-2
CZE,RUS,1999.0,2,3,-1
FRA,JOR,2010.0,3,1,2
IRL,SAU,2015.0,2,1,1
AUS,ROU,2017.0,1,1,0
IRL,CHE,2007.0,6,11,-5
GHA,CIV,2008.0,1,1,0
RWA,TZA,2017.0,2,1,1
MYS,EGY,2014.0,2,8,-6
FRA,COG,2001.0,1,3,-2
CAN,ISL,2019.0,3,1,2
POL,CHL,2013.0,1,2,-1
MEX,PRY,2019.0,2,1,1
TUR,KAZ,2012.0,1,1,0
AUS,ETH,2016.0,1,11,-10
PHL,MYS,2007.0,1,1,0
AUT,IND,2000.0,1,2,-1
KOR,TUR,2012.0,1,2,-1
KEN,FRA,2015.0,2,3,-1
LBY,FIN,2016.0,2,1,1
NOR,GEO,2017.0,1,1,0
USA,SYR,2008.0,2,4,-2
EGY,BEL,2012.0,1,6,-5
VNM,ITA,2007.0,1,1,0
NZL,COL,2013.0,1,1,0
SGP,IRL,2015.0,1,9,-8
ZMB,KEN,2017.0,1,2,-1
AUT,,2012.0,1191,0,1191
,USA,2000.0,104159,0,104159
MEX,,2023.0,19464,0,19464
JPN,,2016.0,22204,0,22204
,GBR,2007.0,18778,0,18778
,CAN,1999.0,16206,0,16206
,CZE,2001.0,1881,0,1881
ESP,,2009.0,4957,0,4957
,NOR,1999.0,2728,0,2728
LKA,,2009.0,44,0,44
,PRT,1995.0,718,0,718
FRA,,2003.0,3142,0,3142
SAU,,2015.0,574,0,574
,NZL,2003.0,1291,0,1291
ISL,,2009.0,42,0,42
,PAK,2002.0,832,0,832
SGP,CZE,2008.0,1,0,1
,TJK,2004.0,12,0,12
,HRV,2005.0,1003,0,1003
,HRV,2002.0,946,0,946
,IRQ,2008.0,303,0,303
ARM,,2014.0,77,0,77
ZAF,,1999.0,28,0,28
HUN,,2015.0,968,0,968
MDA,,2023.0,182,0,182
,GRC,2012.0,2308,0,2308
,MYS,2011.0,5280,0,5280
VEN,,2013.0,405,0,405
,TTO,2004.0,48,0,48
,IRN,2010.0,12311,0,12311
UKR,,2001.0,140,0,140
UZB,,2020.0,90,0,90
ZMB,,2023.0,292,0,292
SVK,,2009.0,297,0,297
,PAK,2005.0,1529,0,1529
BGR,,2022.0,1274,0,1274
,LVA,1997.0,87,0,87
MAR,,2011.0,218,0,218
IND,MOZ,2017.0,1,0,1
,GLP,2001.0,4,0,4
,THA,2014.0,2671,0,2671
COD,,2022.0,99,0,99
,NGA,2008.0,1734,0,1734
,GHA,2019.0,396,0,396
HKG,,2004.0,359,0,359
,ETH,1999.0,134,0,134
CUB,VEN,2006.0,5,0,5
,IRN,2017.0,11021,0,11021
,MCO,2004.0,8,0,8
,POL,2009.0,5269,0,5269
,GHA,2010.0,338,0,338
,CYP,2015.0,220,0,220
LBY,,2018.0,64,0,64
PAN,COL,2018.0,1,0,1
,MEX,2016.0,5115,0,5115
,AZE,2014.0,174,0,174
POL,HRV,2014.0,24,0,24
TZA,,2022.0,432,0,432
PER,,2015.0,126,0,126
,BEN,2009.0,87,0,87
MYS,GHA,2015.0,1,0,1
BGR,IDN,2019.0,1,0,1
,CMR,2008.0,242,0,242
,UZB,2012.0,96,0,96
GRD,,2022.0,34,0,34
ETH,OMN,2019.0,1,0,1
FIN,PSE,1999.0,2,0,2
,IRN,2019.0,6282,0,6282
CIV,,2016.0,104,0,104
,TZA,2013.0,232,0,232
FRA,ZWE,2013.0,1,0,1
LUX,MAC,2014.0,1,0,1
,NAM,2012.0,30,0,30
,MAC,2018.0,209,0,209
AUT,NZL,2020.0,4,0,4
FJI,,2024.0,192,0,192
,LBN,2013.0,391,0,391
,MMR,2018.0,72,0,72
PSE,IRN,2017.0,1,0,1
,ARM,2013.0,118,0,118
,DNK,2018.0,2291,0,2291
,MNG,2014.0,68,0,68
,LBY,2014.0,29,0,29
GAB,COD,2019.0,1,0,1
,BRB,2015.0,6,0,6
PRY,,2022.0,81,0,81
ETH,BRN,2015.0,1,0,1
,GHA,2017.0,632,0,632
BHR,,2024.0,380,0,380
,CIV,2011.0,95,0,95
ALB,SRB,2019.0,8,0,8
PRK,,2023.0,129,0,129
LVA,FIN,2007.0,2,0,2
GTM,,2020.0,42,0,42
TUR,SRB,2020.0,3,0,3
QAT,,2012.0,37,0,37
HRV,THA,2017.0,1,0,1
HKG,DEU,1997.0,5,0,5
ARG,IRL,2020.0,5,0,5
CAN,SRB,2022.0,2,0,2
RUS,TJK,2017.0,3,0,3
HRV,EST,2017.0,1,0,1
,PYF,2016.0,12,0,12
TZA,ZWE,2015.0,1,0,1
NPL,MDV,2020.0,1,0,1
NGA,CMR,2018.0,2,0,2
HRV,FRA,2012.0,7,0,7
FRA,ALB,2011.0,1,0,1
,SLV,2002.0,14,0,14
NLD,COD,2006.0,2,0,2
OMN,KEN,2017.0,1,0,1
BOL,USA,2017.0,4,0,4
PHL,,2007.0,52,0,52
LKA,IND,2005.0,1,0,1
,JAM,2008.0,34,0,34
PHL,IDN,2018.0,2,0,2
GMB,GHA,2010.0,2,0,2
PHL,CAN,2009.0,5,0,5
,BFA,1999.0,80,0,80
,LVA,1998.0,160,0,160
BRA,ECU,2015.0,7,0,7
THA,,2001.0,14,0,14
FIN,ETH,2006.0,1,0,1
NLD,BGR,2012.0,2,0,2
GRC,AUS,2012.0,7,0,7
CAN,TUR,1998.0,4,0,4
,GNB,2002.0,4,0,4
CAN,NGA,1998.0,2,0,2
TUR,KGZ,2010.0,2,0,2
,NER,1994.0,14,0,14
IRN,KAZ,2018.0,2,0,2
HUN,SGP,2008.0,3,0,3
BIH,VNM,2018.0,1,0,1
SYR,AUS,2003.0,1,0,1
,MNE,2001.0,15,0,15
SMR,,2009.0,2,0,2
HUN,MEX,2002.0,1,0,1
UKR,ISR,1998.0,4,0,4
PAK,,1999.0,3,0,3
MNE,SRB,2002.0,1,0,1
BEL,POL,1997.0,3,0,3
SEN,GUF,1999.0,2,0,2
ITA,GLP,2006.0,1,0,1
BOL,FRA,2001.0,3,0,3
FJI,DEU,2009.0,2,0,2
ESP,LUX,2009.0,3,0,3
TUR,QAT,2011.0,2,0,2
IRN,DNK,2004.0,2,0,2
LUX,SWE,2008.0,1,0,1
,GUY,1999.0,3,0,3
IRN,NZL,2009.0,2,0,2
AUS,MAC,2000.0,1,0,1
,MDA,2007.0,58,0,58
IRL,CYP,2007.0,1,0,1
ROU,NGA,2012.0,1,0,1
SWZ,BWA,2005.0,1,0,1
AUS,PRT,2022.0,5,0,5
CUB,DEU,2022.0,1,0,1
ISL,ROU,2017.0,1,0,1
FLK,,2016.0,2,0,2
IRQ,SWE,2022.0,2,0,2
BRA,MYS,2019.0,1,0,1
,GTM,2016.0,33,0,33
GRC,KOR,2017.0,4,0,4
MDA,USA,2001.0,2,0,2
CAN,SWZ,2019.0,1,0,1
MEX,PRY,2017.0,4,0,4
KOR,PRK,2021.0,1,0,1
PER,ITA,2016.0,1,0,1
,SOM,2017.0,7,0,7
MWI,,2007.0,14,0,14
,SUR,2002.0,7,0,7
PSE,BHR,2013.0,1,0,1
SVN,ESP,2009.0,3,0,3
VEN,CAN,2021.0,1,0,1
CHE,SGP,1999.0,1,0,1
,TTO,1996.0,11,0,11
HKG,ISR,2001.0,3,0,3
MWI,USA,2002.0,4,0,4
LTU,SWE,1998.0,3,0,3
USA,MNE,2016.0,2,0,2
BRA,NZL,2001.0,1,0,1
TUR,ARE,2015.0,4,0,4
SGP,KAZ,2015.0,2,0,2
ERI,,2013.0,7,0,7
URY,ECU,2008.0,2,0,2
SEN,GIN,2013.0,1,0,1
JOR,SGP,2016.0,1,0,1
BEL,CYP,2010.0,2,0,2
HKG,KEN,2019.0,3,0,3
AFG,CHE,2015.0,1,0,1
GMB,GNB,2010.0,1,0,1
SYR,KAZ,2017.0,1,0,1
BRN,ITA,2018.0,1,0,1
DEU,MRT,2012.0,1,0,1
BRA,ETH,2007.0,1,0,1
NER,,2015.0,7,0,7
CMR,MAR,2021.0,1,0,1
ZAF,TGO,2020.0,1,0,1
PSE,FIN,2020.0,1,0,1
BEL,CYP,2019.0,2,0,2
CAN,BHR,2009.0,2,0,2
,TCD,2015.0,7,0,7
GAB,,2012.0,5,0,5
JPN,BGR,2006.0,5,0,5
HRV,GRC,2018.0,4,0,4
UKR,FIN,1999.0,2,0,2
ECU,,2006.0,9,0,9
JPN,PRI,2005.0,4,0,4
TWN,RUS,1997.0,1,0,1
QAT,DNK,2011.0,1,0,1
PNG,,2000.0,6,0,6
SDN,KEN,2015.0,2,0,2
CYP,SYR,2003.0,1,0,1
JPN,SEN,2017.0,2,0,2
ZAF,GHA,2003.0,1,0,1
,LIE,2002.0,5,0,5
SWE,MAR,2017.0,2,0,2
CHN,SVK,2016.0,1,0,1
GRC,TUR,2015.0,1,0,1
AUS,ROU,2010.0,2,0,2
,GNB,2005.0,3,0,3
LVA,CHE,2005.0,1,0,1
NZL,SVN,2010.0,1,0,1
,GIN,1999.0,16,0,16
ITA,NCL,2020.0,1,0,1
LUX,QAT,2015.0,1,0,1
SVN,CHE,2017.0,7,0,7
PRT,VNM,2020.0,1,0,1
PER,AUT,2017.0,1,0,1
FIN,ROU,2021.0,2,0,2
THA,BGD,2015.0,3,0,3
ARG,PAN,2018.0,1,0,1
CHN,EST,2001.0,2,0,2
NGA,GMB,2021.0,3,0,3
AUT,NPL,2010.0,1,0,1
THA,NPL,2011.0,2,0,2
NLD,GHA,2004.0,2,0,2
LTU,ITA,2009.0,3,0,3
IRN,GRD,2008.0,1,0,1
GMB,GHA,2019.0,2,0,2
NOR,UKR,2005.0,1,0,1
CUB,PRT,2007.0,4,0,4
SWE,UGA,2016.0,4,0,4
MUS,SWE,2009.0,1,0,1
RUS,QAT,2021.0,1,0,1
MTQ,,2018.0,6,0,6
BRB,,2006.0,6,0,6
,GRD,2013.0,14,0,14
CMR,IND,2016.0,1,0,1
EST,FRA,2002.0,2,0,2
,SOM,2019.0,20,0,20
EGY,POL,2022.0,3,0,3
SWE,LBY,2009.0,1,0,1
MWI,ZWE,2012.0,1,0,1
PNG,RUS,2006.0,1,0,1
GMB,,2006.0,5,0,5
,PRY,2001.0,8,0,8
,TJK,1996.0,6,0,6
PRT,GRC,2010.0,2,0,2
LSO,ZAF,2001.0,1,0,1
CRI,AUT,2012.0,2,0,2
UKR,NLD,1998.0,2,0,2
TZA,BEL,2001.0,1,0,1
BHR,TUN,2018.0,2,0,2
DOM,,2006.0,2,0,2
NZL,EST,2012.0,1,0,1
MYS,NCL,2007.0,1,0,1
PER,ARG,2006.0,2,0,2
TWN,LTU,2001.0,1,0,1
ISR,FIN,1998.0,1,0,1
FRA,VUT,2007.0,1,0,1
,SLV,2005.0,2,0,2
CZE,ISR,2008.0,4,0,4
TGO,BEN,2009.0,2,0,2
MNE,RUS,2018.0,1,0,1
PRT,MOZ,2011.0,1,0,1
MKD,HRV,2010.0,3,0,3
LTU,AUT,2010.0,1,0,1
AUT,PAK,2022.0,2,0,2
LTU,AUT,2017.0,1,0,1
KGZ,USA,2015.0,1,0,1
POL,ARM,2014.0,1,0,1
CHN,JOR,2013.0,2,0,2
NGA,BWA,2022.0,1,0,1
TJK,LTU,2014.0,1,0,1
BWA,FIN,2015.0,1,0,1
CZE,TWN,2004.0,1,0,1
CZE,ROU,2017.0,2,0,2
DNK,KWT,2020.0,1,0,1
NLD,ABW,2018.0,1,0,1
MRT,NLD,2021.0,1,0,1
MAR,MRT,2021.0,1,0,1
MYS,ROU,2021.0,1,0,1
ARG,SVN,1999.0,1,0,1
BWA,MNG,2019.0,1,0,1
NPL,QAT,2008.0,1,0,1
GRC,CHN,1999.0,1,0,1
NCL,CHN,2020.0,1,0,1
ETH,OMN,2010.0,1,0,1
ZAF,PER,2000.0,1,0,1
CAN,MLI,2011.0,1,0,1
JOR,BHR,2005.0,3,0,3
PER,FRA,2000.0,1,0,1
DOM,ARG,2010.0,1,0,1
CHL,PRT,2001.0,1,0,1
CHN,LUX,2015.0,1,0,1
ZMB,ETH,2011.0,1,0,1
USA,BIH,2004.0,3,0,3
IND,MOZ,2010.0,1,0,1
ETH,SYR,2019.0,2,0,2
LUX,SGP,2016.0,1,0,1
UKR,ZAF,2015.0,1,0,1
AUS,MMR,2007.0,1,0,1
BEN,SEN,2009.0,2,0,2
CAN,ISL,2010.0,1,0,1
PRT,AUT,2004.0,2,0,2
VNM,KHM,2006.0,1,0,1
DZA,BRA,2011.0,1,0,1
CMR,AGO,2005.0,1,0,1
GLP,,2008.0,5,0,5
IRN,PRT,2009.0,1,0,1
JOR,IND,2014.0,1,0,1
,SUR,2005.0,2,0,2
BEN,CAN,2007.0,1,0,1
,LBR,2001.0,1,0,1
NGA,KOR,2019.0,2,0,2
LUX,POL,2020.0,2,0,2
AUS,ROU,2019.0,1,0,1
ISR,GRC,1999.0,1,0,1
MAC,CAN,2019.0,2,0,2
ITA,MWI,2019.0,1,0,1
NIC,GTM,2021.0,1,0,1
CRI,CHL,2002.0,1,0,1
THA,SWE,2001.0,2,0,2
KOR,GEO,2014.0,1,0,1
SVK,CHN,2018.0,2,0,2
ISR,TUR,2022.0,2,0,2
DZA,KWT,2018.0,2,0,2
PAK,NER,2021.0,1,0,1
CHN,TUR,2011.0,1,0,1
USA,BRN,2016.0,2,0,2
FRO,DNK,2022.0,2,0,2
SVK,ROU,2012.0,1,0,1
CAN,SWZ,2010.0,1,0,1
BEL,GAB,2005.0,1,0,1
OMN,BRN,2015.0,1,0,1
NER,LUX,2010.0,1,0,1
BEL,CYP,2017.0,2,0,2
PAK,BRN,2013.0,3,0,3
FRA,CAF,2021.0,1,0,1
,CUW,2001.0,1,0,1
TZA,PER,2012.0,1,0,1
FRA,ARE,2007.0,2,0,2
PHL,ESP,2014.0,1,0,1
HUN,GRC,2015.0,3,0,3
OMN,ITA,1998.0,1,0,1
CHN,ESP,2005.0,3,0,3
HKG,MEX,2015.0,1,0,1
FIN,IRL,2002.0,3,0,3
UGA,NAM,2012.0,3,0,3
CRI,GTM,2016.0,2,0,2
CMR,COD,2018.0,2,0,2
PAN,PRI,2012.0,1,0,1
IND,BRN,2011.0,2,0,2
TJK,,2008.0,5,0,5
ARG,NOR,2012.0,2,0,2
MOZ,,2001.0,1,0,1
YEM,SAU,2014.0,3,0,3
CUB,UGA,2006.0,1,0,1
,MCO,1996.0,1,0,1
DNK,TZA,2004.0,4,0,4
AUS,EST,2001.0,1,0,1
GRC,HRV,2002.0,2,0,2
MEX,VEN,1998.0,1,0,1
CHN,CIV,2010.0,1,0,1
BGD,VEN,1999.0,1,0,1
CZE,BGR,2009.0,2,0,2
NZL,NCL,2006.0,1,0,1
ISR,IRL,2006.0,1,0,1
GNB,CHE,2003.0,1,0,1
GLP,RUS,2002.0,1,0,1
IDN,VNM,2005.0,1,0,1
AUT,EST,2011.0,2,0,2
JAM,GRD,2006.0,1,0,1
PAN,MEX,2013.0,1,0,1
GHA,KEN,2006.0,2,0,2
BRA,MYS,2010.0,1,0,1
DEU,TJK,2014.0,1,0,1
MDA,CHE,2018.0,1,0,1
TUN,IRL,2020.0,1,0,1
CHN,MNE,2018.0,1,0,1
MEX,PRY,2010.0,1,0,1
SGP,QAT,2012.0,1,0,1
BEL,KEN,2000.0,2,0,2
DEU,NGA,1999.0,2,0,2
MUS,IND,2003.0,1,0,1
TUR,CZE,2002.0,1,0,1
ROU,MCO,2022.0,1,0,1
IDN,TUR,2014.0,1,0,1
CRI,DEU,2022.0,2,0,2
TUR,PRT,2004.0,1,0,1
DNK,IRL,2000.0,1,0,1
BRA,UZB,2009.0,1,0,1
BTN,,2009.0,1,0,1
CRI,,2000.0,4,0,4
BHR,BWA,1998.0,1,0,1
FIN,ISR,2001.0,2,0,2
AUT,NPL,2017.0,1,0,1
BEL,QAT,2007.0,1,0,1
VEN,PAN,2022.0,1,0,1
MDA,DEU,2021.0,1,0,1
,LIE,2005.0,2,0,2
JPN,PER,2018.0,1,0,1
PRT,LTU,2020.0,1,0,1
ZMB,KEN,2019.0,2,0,2
NLD,MLI,2016.0,1,0,1
TUN,MEX,2011.0,1,0,1
NPL,ISR,2014.0,1,0,1
NGA,NOR,2011.0,1,0,1
MHL,,2018.0,1,0,1
,KIR,2014.0,2,0,2
GUM,,2005.0,4,0,4
FRA,BIH,2021.0,1,0,1
HUN,VNM,2020.0,3,0,3
BEL,CMR,2002.0,1,0,1
FRA,BOL,2006.0,3,0,3
PER,KHM,2014.0,1,0,1
TTO,IRL,2015.0,1,0,1
NZL,ECU,2015.0,1,0,1
LSO,GBR,2011.0,1,0,1
,TKM,2010.0,1,0,1
AZE,KAZ,2015.0,1,0,1
CYP,KOR,2012.0,1,0,1
CRI,CHE,1997.0,1,0,1
FRO,,2011.0,2,0,2
ISR,MLI,2021.0,1,0,1
ROU,SAU,2017.0,2,0,2
SWE,CMR,2005.0,1,0,1
VEN,SVN,2018.0,1,0,1
NGA,SLE,2013.0,1,0,1
CIV,CMR,2015.0,3,0,3
SOM,ETH,2022.0,1,0,1
ZAF,COG,2022.0,1,0,1
TZA,COL,2018.0,1,0,1
CHN,MMR,2015.0,1,0,1
CHN,COG,2016.0,1,0,1
URY,CHE,2021.0,2,0,2
,SOM,2010.0,1,0,1
RUS,ECU,2022.0,1,0,1
ZAF,CIV,2013.0,1,0,1
PHL,HRV,2019.0,1,0,1
ROU,POL,2019.0,3,0,3
CAN,NOR,1998.0,2,0,2
ISR,TWN,2011.0,1,0,1
,NIU,2012.0,1,0,1
ISL,RUS,2003.0,2,0,2
DEU,UZB,2022.0,1,0,1
MKD,VNM,2017.0,1,0,1
UZB,KAZ,2009.0,2,0,2
HKG,THA,2003.0,2,0,2
CHE,UGA,2002.0,1,0,1
MAC,,2003.0,1,0,1
DEU,JAM,2016.0,1,0,1
UKR,IRN,2015.0,2,0,2
ZWE,NGA,2004.0,2,0,2
ARG,RUS,2004.0,1,0,1
DEU,MNG,1997.0,1,0,1
ECU,CHL,2007.0,1,0,1
GHA,CHE,2008.0,1,0,1
AGO,,2011.0,2,0,2
GBR,TUN,2009.0,1,0,1
ZAF,TUR,2008.0,2,0,2
ETH,SYR,2017.0,1,0,1
CAF,BFA,2004.0,1,0,1
AFG,BGD,2020.0,2,0,2
IRL,IDN,2017.0,1,0,1
UGA,ITA,2018.0,1,0,1
GTM,CRI,2020.0,1,0,1
ISR,URY,2020.0,1,0,1
IDN,CHE,2021.0,1,0,1
NOR,GEO,2019.0,1,0,1
DEU,MWI,2018.0,3,0,3
DNK,COL,2013.0,1,0,1
LKA,MYS,2008.0,1,0,1
GBR,MDA,2005.0,1,0,1
,VGB,2019.0,2,0,2
,UKR,2020.0,6,0,6
BFA,MLI,2012.0,1,0,1
ISR,NAM,2002.0,1,0,1
LAO,AUS,2014.0,1,0,1
ARM,GRC,2001.0,1,0,1
TWN,OMN,2010.0,1,0,1
CHL,DOM,2006.0,1,0,1
LKA,NPL,2010.0,1,0,1
CUB,AUS,2003.0,1,0,1
MLI,CHE,2018.0,1,0,1
SWE,KWT,2006.0,1,0,1
SVN,NOR,2013.0,1,0,1
SWE,URY,2000.0,1,0,1
ESP,PRY,1998.0,1,0,1
TCD,NOR,2017.0,1,0,1
CAN,ZMB,2012.0,1,0,1
MKD,GBR,2022.0,1,0,1
IND,ERI,2014.0,1,0,1
CHN,ARG,2017.0,1,0,1
MKD,AUS,1997.0,1,0,1
PER,TWN,2013.0,1,0,1
NLD,TTO,2020.0,1,0,1
USA,GUY,2014.0,1,0,1
SAU,EST,2022.0,1,0,1
AUT,PSE,2003.0,1,0,1
EST,NLD,2010.0,1,0,1
KAZ,MEX,2011.0,1,0,1
PSE,MYS,2007.0,1,0,1
LUX,NZL,2020.0,1,0,1
ROU,PNG,2013.0,1,0,1
URY,SWE,2011.0,2,0,2
ESP,SEN,2021.0,1,0,1
,TKM,2019.0,3,0,3
QAT,EGY,1999.0,1,0,1
FIN,IRL,2005.0,3,0,3
BEL,URY,2009.0,1,0,1
TZA,ISR,2006.0,1,0,1
MYS,CUB,2006.0,1,0,1
GRC,LBY,2009.0,2,0,2
NZL,CHE,1997.0,1,0,1
TZA,PHL,2011.0,1,0,1
MEX,BFA,2013.0,1,0,1
BLR,ISR,2019.0,1,0,1
NLD,PRI,2016.0,1,0,1
ARM,NOR,2021.0,1,0,1
NZL,NGA,2004.0,1,0,1
LTU,AUT,2019.0,3,0,3
ISL,ESP,2009.0,1,0,1
THA,ETH,2008.0,1,0,1
IND,JOR,2019.0,2,0,2
FJI,IRL,2021.0,1,0,1
NIC,MOZ,2016.0,1,0,1
TLS,,2014.0,1,0,1
URY,ISR,2017.0,1,0,1
NLD,CYP,2002.0,1,0,1
BGR,KWT,2007.0,1,0,1
BGR,BIH,2003.0,1,0,1
CUB,AUT,2009.0,1,0,1
ETH,ERI,2018.0,1,0,1
VEN,KAZ,2007.0,1,0,1
TWN,ARM,2009.0,1,0,1
PAN,FRA,2002.0,1,0,1
FIN,LUX,2009.0,1,0,1
PER,NLD,2004.0,1,0,1
SVK,BEL,2000.0,1,0,1
ZAF,HUN,2011.0,1,0,1
BGD,MEX,2005.0,1,0,1
ALB,ITA,1999.0,1,0,1
SVK,EGY,2006.0,1,0,1
RUS,SRB,2003.0,1,0,1
JPN,CUB,2017.0,1,0,1
SEN,ESP,2020.0,1,0,1
NGA,DZA,2012.0,1,0,1
ZAF,GMB,2006.0,1,0,1
AFG,,2007.0,3,0,3
CHN,NPL,2011.0,1,0,1
HUN,TWN,2014.0,1,0,1
KHM,PRT,2022.0,1,0,1
PRY,MEX,2014.0,1,0,1
GBR,SYC,2012.0,1,0,1
FRA,SYC,2022.0,1,0,1
ESP,PSE,2021.0,2,0,2
URY,NLD,2017.0,1,0,1
SVK,CAN,2015.0,1,0,1
VEN,MAR,2015.0,1,0,1
TUR,MWI,2020.0,1,0,1
JOR,BHR,2002.0,1,0,1
PAN,ITA,2016.0,1,0,1
CAN,MAC,2010.0,1,0,1
,DMA,2018.0,1,0,1
ROU,GIB,2020.0,1,0,1
,JOR,2020.0,2,0,2
LTU,SVN,2021.0,1,0,1
ROU,POL,2010.0,1,0,1
UKR,TJK,2004.0,1,0,1
NZL,HRV,2012.0,1,0,1
THA,FIN,2009.0,1,0,1
NOR,PRT,2004.0,1,0,1
NOR,TUN,2011.0,1,0,1
ROU,MNE,2004.0,1,0,1
UGA,RWA,2008.0,1,0,1
AUS,URY,2002.0,1,0,1
EGY,TUN,2006.0,1,0,1
BEN,ZAF,2002.0,1,0,1
LTU,RUS,2010.0,1,0,1
KAZ,GRC,2021.0,1,0,1
RUS,SGP,2000.0,1,0,1
,MHL,1999.0,1,0,1
IRL,LBY,2007.0,1,0,1
ETH,OMN,2017.0,1,0,1
MDG,DEU,2008.0,1,0,1
SWE,MAR,2010.0,1,0,1
MWI,THA,2017.0,1,0,1
ZMB,BRA,2018.0,1,0,1
MYS,PRT,2012.0,1,0,1
TUN,SWE,2020.0,1,0,1
OMN,KWT,2003.0,1,0,1
TUR,UKR,2003.0,2,0,2
IND,LVA,2014.0,1,0,1
SDN,SLE,2022.0,1,0,1
ALB,SRB,2010.0,1,0,1
MKD,HRV,2017.0,1,0,1
HKG,AUT,2014.0,2,0,2
ERI,NOR,2011.0,1,0,1
LVA,GBR,2008.0,1,0,1
PRY,ISL,2009.0,1,0,1
SVK,NZL,2009.0,1,0,1
ZWE,GRC,1998.0,1,0,1
PHL,PRY,2007.0,1,0,1
IND,FJI,2012.0,1,0,1
CZE,LUX,2013.0,1,0,1
CHN,MWI,2022.0,1,0,1
NOR,BEN,2019.0,1,0,1
CUB,FRA,2006.0,1,0,1
FIN,SAU,2006.0,1,0,1
URY,RUS,2020.0,1,0,1
IND,DZA,2016.0,1,0,1
,FSM,2016.0,2,0,2
VNM,DEU,1999.0,1,0,1
BLR,MEX,2001.0,1,0,1
ZWE,ZMB,2003.0,1,0,1
LBN,POL,2017.0,1,0,1
BHR,FRA,2012.0,1,0,1
LKA,NPL,2019.0,1,0,1
BHR,THA,2014.0,1,0,1
IRN,CHL,2013.0,1,0,1
TUR,CZE,2005.0,1,0,1
YEM,CHN,2003.0,1,0,1
TUR,ROU,2014.0,1,0,1
PRY,URY,2019.0,1,0,1
JOR,FIN,2009.0,1,0,1
COL,MAC,2016.0,1,0,1
CMR,ESP,2019.0,1,0,1
CMR,ISR,2020.0,1,0,1
NLD,BWA,2017.0,1,0,1
FRA,CHE,2016.0,397,212,185
IND,USA,2013.0,922,759,163
USA,AUS,2014.0,635,487,148
DEU,AUT,2005.0,242,168,74
UKR,MDA,2007.0,2,3,-1
JPN,IND,2014.0,94,77,17
SGP,KOR,2020.0,34,26,8
AUS,ARG,2007.0,5,8,-3
THA,USA,2015.0,96,218,-122
USA,NLD,2004.0,236,239,-3
ESP,ARG,2015.0,82,41,41
USA,TUR,2012.0,243,191,52
CHE,DEU,2013.0,420,593,-173
FRA,GBR,2007.0,338,311,27
CMR,JPN,2009.0,2,1,1
GBR,USA,2009.0,1280,1256,24
DEU,FIN,2016.0,53,60,-7
ZAF,TZA,2011.0,5,3,2
IND,GBR,2018.0,238,157,81
USA,CHN,2005.0,657,928,-271
MEX,CHL,2015.0,18,8,10
NLD,ITA,2013.0,61,98,-37
SGP,DEU,2013.0,14,46,-32
ZAF,NGA,2009.0,8,20,-12
DEU,SWE,2018.0,167,145,22
CHL,GBR,2014.0,28,42,-14
BGD,BRN,2018.0,2,3,-1
KOR,USA,2015.0,701,906,-205
HKG,SGP,2009.0,32,24,8
CAN,USA,2021.0,1129,1024,105
IRN,AUS,2013.0,116,26,90
TUR,NLD,2011.0,21,15,6
POL,DEU,2015.0,124,67,57
CHN,TWN,2020.0,95,192,-97
DNK,GBR,1999.0,19,18,1
JPN,GRC,2020.0,1,2,-1
IDN,GBR,2007.0,2,4,-2
CAN,DEU,2005.0,86,136,-50
FRA,URY,2015.0,2,5,-3
CHE,ITA,2013.0,108,208,-100
SWE,ESP,2014.0,35,62,-27
GBR,MYS,2009.0,92,52,40
BRA,ZAF,2016.0,3,5,-2
BRA,BEL,2012.0,18,16,2
PHL,USA,2004.0,16,13,3
CHE,ESP,2004.0,32,19,13
ESP,VEN,2010.0,26,30,-4
KEN,ESP,2013.0,1,1,0
JPN,THA,2014.0,81,44,37
SAU,EGY,2016.0,188,176,12
BRA,ITA,2004.0,17,13,4
USA,FRA,2004.0,545,606,-61
NLD,GHA,2015.0,2,2,0
JPN,KOR,2010.0,113,96,17
GBR,DNK,2014.0,97,80,17
USA,JPN,2000.0,279,358,-79
SGP,USA,2004.0,110,103,7
HUN,USA,1999.0,43,27,16
ZAF,DEU,2021.0,36,17,19
ARE,IND,2004.0,1,4,-3
ESP,JPN,2014.0,27,11,16
FRA,LBN,2018.0,112,37,75
CHE,GRC,2020.0,21,22,-1
SGP,CHN,2016.0,309,234,75
ESP,ZAF,2012.0,8,2,6
NLD,CHN,2021.0,141,121,20
USA,UGA,2018.0,26,36,-10
ISR,CAN,2014.0,45,51,-6
GRC,ITA,2007.0,26,17,9
CZE,GBR,2020.0,43,36,7
MYS,IRN,2011.0,57,45,12
DNK,USA,2009.0,82,113,-31
KWT,CAN,2015.0,8,15,-7
JPN,KOR,2019.0,92,94,-2
USA,PAK,2011.0,49,46,3
IRN,DEU,2018.0,88,37,51
BRA,CHE,2018.0,38,15,23
MYS,JPN,2013.0,20,71,-51
TWN,JPN,2020.0,42,50,-8
BRA,ESP,2014.0,54,100,-46
BEL,CAN,2011.0,40,27,13
IRN,DNK,2015.0,20,3,17
AUT,IDN,2016.0,7,1,6
DEU,IRL,2014.0,29,46,-17
USA,QAT,2014.0,65,19,46
QAT,USA,2021.0,40,34,6
USA,CHN,2002.0,428,787,-359
KEN,NZL,2019.0,3,4,-1
AUS,CAN,2021.0,111,126,-15
AUT,CHN,2019.0,27,17,10
ESP,ITA,2016.0,169,188,-19
USA,BFA,2013.0,2,6,-4
IND,SVN,2022.0,1,1,0
IND,MYS,2007.0,27,10,17
IDN,BEL,2013.0,2,1,1
LBN,FRA,2016.0,34,92,-58
CHN,IRL,2011.0,15,9,6
AUS,SGP,2007.0,41,62,-21
JPN,CHN,2000.0,62,109,-47
NLD,IND,2014.0,26,24,2
IRQ,MYS,2016.0,17,92,-75
IND,MEX,2015.0,11,4,7
DEU,ITA,2014.0,162,283,-121
NLD,GBR,2022.0,98,129,-31
URY,USA,2018.0,16,7,9
BGR,MKD,2018.0,2,5,-3
DEU,ARG,2007.0,13,24,-11
CHE,PAK,2020.0,9,5,4
NLD,UKR,2020.0,1,7,-6
IND,CZE,2012.0,5,1,4
ITA,SGP,2016.0,10,8,2
CHL,COL,2021.0,28,29,-1
SWE,AUT,2015.0,21,21,0
PER,ECU,2021.0,7,5,2
ARG,DEU,2021.0,37,9,28
TWN,POL,2014.0,4,6,-2
FRA,TUN,2004.0,61,33,28
DEU,AUT,2002.0,195,155,40
KEN,GBR,2015.0,21,21,0
ITA,CHE,2007.0,102,63,39
BRA,CHN,2016.0,3,7,-4
GBR,ARE,2014.0,25,12,13
HKG,NZL,2016.0,8,4,4
RUS,SWE,2015.0,22,12,10
ESP,VEN,2019.0,9,20,-11
CHN,POL,2018.0,13,10,3
DEU,JPN,2022.0,35,43,-8
HKG,PHL,2019.0,3,4,-1
NOR,ETH,2016.0,8,4,4
DNK,AUT,2020.0,18,9,9
UKR,CAN,2018.0,3,4,-1
EGY,ESP,2020.0,4,11,-7
KWT,USA,2018.0,7,32,-25
LBN,IND,2019.0,4,1,3
UGA,USA,2019.0,25,34,-9
BRA,PRT,2020.0,204,160,44
ISL,SWE,2014.0,23,16,7
BEL,VNM,2016.0,8,4,4
ZWE,ZAF,2022.0,18,10,8
IND,JPN,2014.0,77,94,-17
LTU,GBR,2019.0,7,8,-1
CHE,BRA,2021.0,9,31,-22
AUS,KOR,2007.0,7,11,-4
USA,MMR,2022.0,1,2,-1
ESP,MAR,2012.0,8,10,-2
GBR,EGY,2020.0,61,53,8
COL,CHL,2018.0,32,22,10
CHN,ZAF,2015.0,8,2,6
CHL,BEL,2013.0,10,5,5
PRT,AUT,2015.0,6,4,2
FRA,KEN,2018.0,4,2,2
CHL,PER,2018.0,12,10,2
GBR,LBY,2020.0,17,5,12
ITA,IRL,2020.0,37,21,16
CYP,TUR,2020.0,41,62,-21
FIN,FRA,2021.0,20,21,-1
AUT,NLD,2021.0,27,21,6
MCO,FRA,2020.0,8,10,-2
SGP,HKG,2011.0,17,37,-20
CHN,PAK,2011.0,35,25,10
DEU,CZE,2015.0,48,38,10
FRA,DEU,1998.0,77,67,10
ISR,ESP,2018.0,8,11,-3
EGY,ARE,2022.0,16,4,12
LTU,DNK,2021.0,5,2,3
CHE,MYS,2019.0,5,2,3
KOR,BEL,2019.0,5,8,-3
JPN,KOR,2017.0,125,101,24
GBR,KOR,2013.0,47,36,11
MYS,NLD,2021.0,5,4,1
SWE,CZE,2018.0,10,7,3
NZL,DEU,2013.0,30,28,2
TUR,IRL,2004.0,1,1,0
AUT,GBR,2006.0,47,36,11
CHE,SWE,2007.0,30,28,2
FIN,LTU,2011.0,3,1,2
PAK,FRA,2010.0,10,9,1
LUX,DEU,2016.0,21,23,-2
KOR,IRN,2018.0,5,18,-13
IND,NPL,2012.0,17,17,0
ESP,GBR,2008.0,180,197,-17
ITA,IND,2008.0,12,32,-20
NLD,THA,2014.0,12,6,6
IRL,AUS,2009.0,38,26,12
ARE,JOR,2018.0,10,22,-12
FRA,TWN,2011.0,16,8,8
NZL,CAN,2010.0,36,32,4
ITA,ROU,2018.0,18,13,5
NOR,VNM,2012.0,1,1,0
TUR,SWE,2014.0,7,4,3
KOR,AUS,2001.0,6,7,-1
JPN,CHE,2006.0,28,27,1
DEU,GRC,2011.0,37,57,-20
AUS,OMN,2015.0,6,4,2
TZA,SWE,2012.0,3,6,-3
IND,THA,2013.0,9,2,7
ZAF,IND,2014.0,14,72,-58
ARG,CHN,2014.0,1,1,0
GBR,SGP,2004.0,45,35,10
CHN,CAN,1999.0,48,22,26
BEL,ESP,2015.0,44,77,-33
CAN,DEU,2002.0,121,124,-3
IND,NLD,2018.0,29,43,-14
PER,DEU,2014.0,4,3,1
AUT,CHN,2017.0,14,16,-2
BRA,BOL,2017.0,3,1,2
AUS,BRA,2015.0,31,44,-13
BGD,FRA,2021.0,2,1,1
NOR,DNK,2008.0,19,19,0
IND,FRA,2004.0,35,21,14
EGY,JPN,2005.0,15,34,-19
PAK,FRA,2019.0,12,14,-2
MDG,FRA,2013.0,12,7,5
USA,CZE,2001.0,23,42,-19
ITA,CUB,2003.0,6,1,5
KOR,CHE,2006.0,7,8,-1
EGY,SAU,2001.0,26,18,8
ESP,FRA,2001.0,103,88,15
RUS,ITA,1998.0,16,5,11
ITA,AUS,2018.0,50,41,9
NLD,VNM,2020.0,8,8,0
POL,BRA,2020.0,4,12,-8
IRN,NOR,2020.0,26,1,25
LTU,USA,2019.0,7,5,2
USA,UKR,2017.0,15,27,-12
FRA,CHL,2018.0,34,36,-2
ITA,EGY,2002.0,3,1,2
AUS,TWN,2001.0,5,6,-1
MOZ,USA,2018.0,4,2,2
DZA,CAN,2018.0,11,3,8
CAN,ZAF,2021.0,11,23,-12
TWN,BEL,2013.0,2,3,-1
SEN,USA,2016.0,5,4,1
JOR,CAN,2021.0,9,8,1
VNM,USA,2018.0,18,37,-19
DNK,JPN,1998.0,3,3,0
LTU,ESP,2021.0,2,2,0
IRL,SWE,2003.0,3,2,1
NZL,CAN,2019.0,38,36,2
ROU,FRA,2021.0,9,17,-8
DEU,TZA,2020.0,8,2,6
BGD,MYS,2012.0,24,12,12
FIN,RUS,2014.0,15,22,-7
GAB,CMR,2019.0,2,2,0
NGA,CHE,2020.0,8,17,-9
ISR,ITA,2010.0,6,9,-3
SGP,IND,2016.0,63,86,-23
TUR,AUT,2020.0,4,4,0
DNK,CAN,2021.0,15,25,-10
FRA,GIN,2020.0,4,4,0
MYS,IDN,2022.0,25,12,13
EGY,QAT,2012.0,5,6,-1
AUS,IRL,2022.0,22,12,10
CAN,TWN,1997.0,1,2,-1
IND,NOR,2013.0,10,7,3
TUN,FRA,2003.0,31,60,-29
AUS,NZL,2000.0,30,36,-6
AUS,VNM,2004.0,2,3,-1
USA,ZMB,2015.0,10,20,-10
NLD,BGD,2019.0,5,3,2
AUS,NOR,2020.0,27,16,11
GUM,USA,2022.0,2,2,0
UGA,USA,2017.0,25,26,-1
BEL,DEU,2012.0,71,95,-24
SVK,NLD,2006.0,3,1,2
USA,UKR,2010.0,17,23,-6
ARG,CAN,2012.0,17,11,6
EST,SWE,2010.0,6,11,-5
SAU,MYS,2011.0,3,23,-20
THA,JPN,2004.0,26,49,-23
ZWE,USA,2006.0,6,1,5
IRQ,USA,2011.0,4,2,2
GBR,THA,2004.0,50,15,35
BGD,CAN,2005.0,8,4,4
GRC,POL,2013.0,8,3,5
FRA,UKR,2009.0,12,7,5
ESP,CHL,2000.0,10,7,3
LBN,IRN,2020.0,1,1,0
NZL,ARE,2004.0,2,2,0
AUT,SVK,2004.0,7,9,-2
NLD,IDN,2014.0,24,8,16
DEU,THA,2011.0,25,12,13
HUN,GBR,2007.0,23,13,10
MAR,ESP,2000.0,1,2,-1
AUT,ITA,2007.0,24,26,-2
DNK,AUS,2009.0,14,20,-6
NOR,DEU,2013.0,29,66,-37
GRC,CHE,2008.0,9,5,4
ITA,ESP,1998.0,25,18,7
ITA,NOR,2001.0,3,9,-6
FRA,BEN,2012.0,7,8,-1
FRA,IRN,2004.0,10,1,9
EGY,USA,2001.0,45,30,15
RUS,DEU,1997.0,36,36,0
USA,AUT,2004.0,85,83,2
USA,MCO,2018.0,2,1,1
CHE,BEL,2002.0,16,28,-12
FRA,DEU,1997.0,44,55,-11
AUT,CAN,2005.0,16,14,2
GEO,GBR,2019.0,1,2,-1
GHA,USA,2002.0,7,7,0
POL,SVK,2017.0,6,5,1
BGR,DEU,2013.0,10,9,1
POL,ESP,2003.0,7,6,1
BRA,MEX,2018.0,26,18,8
AUT,ESP,1998.0,4,1,3
CAN,HUN,2005.0,3,5,-2
ISR,FRA,2015.0,17,34,-17
BLR,DEU,1999.0,6,1,5
HKG,CAN,1999.0,9,6,3
BRA,RUS,1998.0,8,3,5
SWE,RUS,2006.0,18,20,-2
HRV,USA,2006.0,13,11,2
IRL,USA,1999.0,39,35,4
SEN,FRA,2001.0,15,16,-1
GBR,EST,2021.0,7,13,-6
RUS,ISR,2011.0,10,5,5
AUT,CAN,2002.0,10,9,1
USA,OMN,2014.0,16,5,11
ROU,HUN,2004.0,5,1,4
CZE,ITA,2002.0,11,4,7
SVK,AUT,2006.0,8,8,0
AUS,THA,2021.0,9,14,-5
BEN,FRA,2022.0,6,2,4
PAK,USA,1999.0,4,5,-1
TZA,GBR,2004.0,4,5,-1
CZE,BEL,2004.0,7,3,4
CHN,FIN,2004.0,7,12,-5
RUS,ITA,1997.0,5,11,-6
FIN,JPN,2000.0,4,1,3
BRA,NLD,2009.0,19,12,7
DEU,SVK,2001.0,10,18,-8
GRC,ZAF,2002.0,3,2,1
IND,SAU,2008.0,21,8,13
IRL,ZAF,2004.0,3,3,0
VNM,CHN,2013.0,1,6,-5
ITA,DNK,1999.0,7,5,2
NZL,SWE,2006.0,4,5,-1
CAN,HKG,2000.0,5,7,-2
ISR,BRA,1997.0,2,1,1
CAN,PAK,2008.0,7,13,-6
BRA,VEN,2012.0,4,3,1
ESP,VEN,2017.0,8,22,-14
AUS,MYS,2008.0,21,28,-7
THA,GBR,2008.0,16,50,-34
CUB,USA,2012.0,5,2,3
ROU,CZE,2013.0,1,1,0
ZAF,SEN,2009.0,1,2,-1
CHL,CHN,2011.0,3,1,2
ZAF,ESP,2010.0,4,5,-1
GBR,KEN,2008.0,10,12,-2
AUS,BEL,2018.0,27,26,1
FRA,QAT,2013.0,12,3,9
ESP,AUT,2013.0,30,12,18
FRA,SEN,2013.0,25,22,3
JPN,BGD,2009.0,51,35,16
ITA,SAU,2015.0,21,1,20
KOR,SGP,2013.0,26,19,7
MYS,LBY,2013.0,5,5,0
USA,UZB,2012.0,3,1,2
SWE,AUS,2012.0,25,40,-15
TUR,CYP,2012.0,13,8,5
AUS,TUR,2019.0,5,17,-12
AUT,AUS,2013.0,16,10,6
MLI,CIV,2011.0,3,1,2
GTM,ESP,2009.0,1,1,0
MEX,FRA,2013.0,29,43,-14
PHL,TWN,2011.0,4,1,3
NGA,ETH,2010.0,2,2,0
ARG,ITA,2012.0,9,17,-8
FRA,HKG,2019.0,9,12,-3
DEU,KWT,2014.0,4,1,3
GBR,UKR,2007.0,8,12,-4
CHE,TZA,2016.0,7,4,3
COL,ESP,2009.0,46,31,15
ZMB,USA,2012.0,10,3,7
FRA,MCO,2012.0,8,5,3
MEX,FIN,2020.0,2,1,1
CHE,LIE,2021.0,3,2,1
LTU,GBR,2017.0,7,9,-2
TUR,TWN,2019.0,3,3,0
CZE,JPN,2016.0,10,12,-2
GBR,GHA,2003.0,6,1,5
COL,BEL,2018.0,5,7,-2
MYS,DEU,2016.0,13,10,3
MEX,AUS,2014.0,9,6,3
AUS,SWE,2000.0,4,7,-3
IRN,ZAF,2015.0,6,3,3
DEU,MYS,2016.0,10,13,-3
IRN,IRL,2020.0,16,2,14
ARG,ISR,2017.0,1,1,0
KOR,BEL,2017.0,13,9,4
ARE,IRQ,2018.0,1,1,0
RUS,POL,2015.0,9,14,-5
EGY,IRL,2017.0,2,1,1
THA,LKA,2014.0,2,1,1
NLD,COL,2016.0,5,4,1
LUX,USA,2011.0,5,5,0
USA,LKA,2018.0,25,14,11
ITA,QAT,2021.0,5,3,2
CRI,ESP,2020.0,9,2,7
LVA,DNK,2018.0,1,1,0
ITA,ZAF,2012.0,13,6,7
RUS,HKG,2018.0,5,1,4
ITA,KOR,1999.0,2,1,1
PAK,CHE,2022.0,4,1,3
SRB,HRV,2021.0,3,2,1
NLD,HRV,2016.0,5,3,2
GTM,USA,2016.0,11,3,8
KOR,PHL,2018.0,8,10,-2
BEL,IND,2007.0,8,9,-1
HUN,BEL,2001.0,11,6,5
SRB,AUS,2009.0,2,1,1
ITA,ESP,1997.0,13,8,5
ZAF,BFA,2019.0,2,2,0
IND,CAN,2004.0,53,18,35
USA,KWT,2005.0,6,4,2
IND,TUR,2004.0,4,1,3
ARE,POL,2017.0,1,1,0
ESP,BGR,2016.0,5,3,2
CHN,IND,2015.0,23,88,-65
USA,SEN,2014.0,5,3,2
ISR,SWE,2020.0,7,6,1
ZAF,BEL,2019.0,9,6,3
CAN,CHL,2007.0,8,7,1
USA,PSE,2011.0,7,2,5
BRN,MYS,2013.0,2,7,-5
GRC,ESP,2016.0,15,14,1
JPN,FIN,2018.0,9,11,-2
AUT,THA,2013.0,3,2,1
VEN,PRT,2006.0,2,1,1
SGP,IRN,2020.0,6,4,2
USA,BGD,2004.0,5,9,-4
MNG,USA,2014.0,2,4,-2
ISR,IND,2003.0,5,19,-14
CHE,ISR,2009.0,9,11,-2
TUR,CHE,2015.0,13,11,2
TWN,MYS,2018.0,7,13,-6
BEL,MAR,2004.0,7,2,5
CAN,GHA,2018.0,5,2,3
ISR,ITA,2017.0,19,19,0
BEL,SAU,2015.0,5,3,2
PRT,CHE,2015.0,15,9,6
KOR,FIN,2013.0,10,1,9
UGA,CHE,2016.0,2,1,1
HUN,PRT,2012.0,1,3,-2
AUS,DNK,2009.0,20,14,6
FRA,SYR,2014.0,8,2,6
GBR,BGD,2016.0,18,13,5
AUS,GRC,2020.0,3,6,-3
ISR,JPN,2022.0,1,2,-1
ISL,USA,2022.0,4,6,-2
NLD,KOR,2021.0,7,14,-7
AUS,TZA,2018.0,5,1,4
RUS,SAU,2019.0,5,1,4
IRL,MYS,2014.0,9,2,7
SWE,BEL,1999.0,7,6,1
HRV,GBR,2004.0,1,3,-2
MAC,HKG,2012.0,4,20,-16
MEX,BEL,2001.0,4,3,1
AUT,POL,2018.0,10,8,2
ZAF,CHE,2009.0,8,4,4
IND,BRA,1997.0,1,3,-2
POL,BGR,2021.0,1,2,-1
TWN,VNM,2014.0,13,3,10
CAN,SAU,2005.0,20,11,9
ARG,COL,1999.0,5,4,1
HUN,NLD,2004.0,8,5,3
POL,UKR,2003.0,11,22,-11
GBR,KWT,2007.0,6,3,3
EST,DEU,2004.0,2,2,0
HUN,GRC,2004.0,2,4,-2
AUT,UKR,2012.0,1,2,-1
ESP,IND,2005.0,3,7,-4
THA,AUS,2007.0,16,18,-2
DEU,COL,2006.0,4,6,-2
CZE,POL,2006.0,6,2,4
BRA,PAN,2021.0,3,2,1
CHE,HUN,2006.0,9,3,6
CZE,SVN,2002.0,1,1,0
KEN,RWA,2016.0,2,1,1
USA,LTU,2004.0,6,4,2
POL,FIN,2020.0,6,8,-2
DEU,HRV,2015.0,7,23,-16
CHL,BRA,2013.0,15,10,5
ESP,IND,2002.0,4,5,-1
PRT,IND,2006.0,2,11,-9
FRA,CMR,2006.0,6,7,-1
DNK,HUN,2004.0,1,1,0
PHL,KOR,2006.0,3,2,1
FRA,HUN,2002.0,11,14,-3
SVK,ITA,2003.0,4,4,0
JPN,SRB,2005.0,1,1,0
KWT,GBR,2016.0,5,20,-15
SWE,CHE,2001.0,5,19,-14
DNK,TZA,2015.0,2,1,1
ITA,SRB,2012.0,6,1,5
USA,DZA,2020.0,5,3,2
SRB,SWE,2013.0,1,1,0
JOR,MYS,2004.0,1,1,0
GEO,GBR,2010.0,1,2,-1
DNK,PRT,2022.0,2,2,0
EGY,IRN,2019.0,1,1,0
FRA,HKG,2017.0,14,4,10
FRA,BFA,2011.0,9,16,-7
USA,EST,2007.0,4,5,-1
BRA,URY,2011.0,6,3,3
USA,UKR,2019.0,17,16,1
SEN,MDG,2002.0,5,1,4
POL,SVK,2010.0,3,2,1
FRA,HKG,2010.0,5,9,-4
MYS,NZL,2014.0,6,20,-14
SAU,OMN,2018.0,10,2,8
PAK,ZAF,2013.0,3,2,1
USA,SDN,2021.0,3,2,1
CHE,IDN,2013.0,1,3,-2
CHN,PHL,2004.0,1,1,0
HKG,JPN,2021.0,14,11,3
MEX,CHN,2016.0,4,4,0
BLR,GBR,2016.0,1,1,0
TUR,IRQ,2014.0,3,1,2
ITA,THA,2014.0,1,5,-4
JPN,ITA,2021.0,18,18,0
TUR,AUS,2013.0,3,4,-1
ITA,BGR,2001.0,1,4,-3
AUS,GHA,2015.0,4,4,0
ARE,SAU,2021.0,7,18,-11
ITA,ARG,2014.0,13,13,0
THA,AUT,2006.0,3,3,0
EGY,KOR,2013.0,3,5,-2
CHN,EGY,2015.0,11,8,3
MYS,DZA,2020.0,4,2,2
CAN,VNM,2016.0,4,2,2
IND,NZL,2012.0,8,4,4
IRN,ETH,2020.0,7,2,5
POL,SVK,2019.0,3,5,-2
KHM,FRA,2021.0,2,6,-4
IRQ,DEU,2020.0,5,6,-1
NOR,FRA,2022.0,9,19,-10
PRT,DNK,2012.0,8,4,4
NPL,THA,2021.0,4,7,-3
SWE,GRC,2022.0,6,5,1
FRA,ARG,2018.0,26,31,-5
GBR,ECU,2001.0,1,1,0
CHL,DEU,2000.0,2,6,-4
KGZ,RUS,2008.0,1,1,0
SRB,ITA,2001.0,2,4,-2
ESP,UKR,2003.0,2,2,0
UGA,USA,2010.0,9,15,-6
CHE,BEL,2005.0,11,23,-12
HUN,FRA,2021.0,9,4,5
SEN,BEN,2012.0,4,1,3
CAN,CIV,2017.0,1,3,-2
LVA,FRA,2020.0,1,1,0
NZL,LKA,2018.0,3,5,-2
FRA,CIV,2021.0,8,7,1
DNK,ARE,2012.0,2,1,1
GBR,CHL,2008.0,12,17,-5
IRN,AUT,2014.0,12,7,5
SWE,VNM,2018.0,2,1,1
PAK,CHN,2009.0,10,19,-9
EGY,CHE,2021.0,5,5,0
HTI,USA,2020.0,2,7,-5
SWE,BRA,2021.0,9,24,-15
ROU,CAN,2017.0,4,4,0
TUR,PRT,2015.0,4,2,2
CHE,IND,2011.0,17,28,-11
CHE,KOR,2016.0,17,9,8
CHN,KEN,2014.0,4,3,1
CHL,CHE,2013.0,4,2,2
SVN,ARG,2017.0,1,1,0
MEX,IND,2011.0,3,2,1
POL,IRL,2008.0,8,1,7
IND,LUX,2014.0,2,1,1
POL,TWN,2020.0,1,1,0
HRV,AUS,2013.0,1,3,-2
SWZ,ZAF,2016.0,4,2,2
RWA,CHN,2017.0,2,2,0
UZB,KOR,2015.0,2,1,1
DNK,ITA,2022.0,15,21,-6
KOR,BEL,2010.0,2,2,0
IRL,ARE,2016.0,6,1,5
USA,AFG,2019.0,1,2,-1
OMN,AUS,2014.0,1,6,-5
BIH,USA,2016.0,1,1,0
GTM,MEX,2019.0,3,3,0
ITA,LTU,2020.0,4,3,1
LAO,CHE,2017.0,4,3,1
RWA,CHN,2019.0,2,8,-6
CZE,EGY,2019.0,2,1,1
ESP,COG,2018.0,2,1,1
LUX,SRB,2020.0,1,1,0
PHL,NGA,2020.0,1,1,0
DEU,JOR,2021.0,8,4,4
EGY,SGP,2020.0,1,2,-1
CMR,NLD,2019.0,1,1,0
MWI,CHE,2017.0,2,1,1
SWE,UKR,2014.0,2,10,-8
USA,BWA,2004.0,4,3,1
GBR,LUX,2002.0,1,2,-1
JPN,MNG,2001.0,2,4,-2
CHN,IRN,2004.0,1,1,0
JOR,ARE,2004.0,2,5,-3
SWE,SVN,2006.0,1,1,0
POL,FRA,1999.0,11,12,-1
HUN,KWT,2004.0,1,1,0
ESP,RUS,2009.0,8,15,-7
IRL,SVN,2006.0,1,1,0
BGR,KOR,2015.0,1,3,-2
USA,KWT,2002.0,6,10,-4
ARG,CUB,2011.0,1,1,0
SWE,COL,2007.0,1,3,-2
AUT,CHN,2010.0,4,11,-7
IRN,IND,1999.0,3,1,2
GBR,VNM,2004.0,3,3,0
CAN,HUN,2002.0,4,10,-6
GHA,USA,2005.0,4,8,-4
ZAF,ESP,2019.0,7,6,1
IRL,BRA,2012.0,5,4,1
FRA,EGY,2004.0,2,3,-1
AUS,TUR,2010.0,4,8,-4
NOR,NPL,2013.0,1,1,0
SVN,RUS,2021.0,3,2,1
SVK,POL,2009.0,5,2,3
QAT,DEU,2011.0,1,3,-2
CHN,NZL,2006.0,4,5,-1
EGY,IRN,2010.0,1,2,-1
KEN,NLD,2014.0,4,4,0
DEU,SYR,2013.0,7,6,1
THA,PAK,2011.0,3,1,2
PAK,IRQ,2012.0,1,1,0
PAK,DNK,2015.0,3,1,2
DNK,ZAF,2011.0,4,4,0
MYS,DNK,2018.0,4,5,-1
HUN,CHE,2022.0,3,2,1
GBR,URY,2018.0,1,1,0
EGY,BHR,2019.0,2,3,-1
CZE,TUR,2021.0,2,5,-3
SRB,ALB,2015.0,1,6,-5
EGY,PAK,2020.0,6,7,-1
RUS,UZB,2001.0,4,8,-4
EGY,JPN,2002.0,7,20,-13
MMR,CHN,2021.0,4,5,-1
AUT,GHA,2017.0,1,1,0
PAK,CMR,2021.0,2,2,0
BEL,NZL,2006.0,4,1,3
JPN,SGP,2006.0,12,11,1
ARE,GBR,2008.0,7,21,-14
RUS,IND,2006.0,1,3,-2
ZAF,ESP,2017.0,7,11,-4
KOR,ZAF,2016.0,3,4,-1
PRT,BGR,2003.0,2,3,-1
PRK,CHN,2017.0,1,5,-4
USA,SRB,2018.0,7,24,-17
UZB,RUS,2008.0,3,9,-6
CHE,SAU,2021.0,2,4,-2
IRL,CHE,2008.0,4,11,-7
BGR,RUS,1998.0,1,2,-1
ROU,CHE,2003.0,4,3,1
KAZ,RUS,1998.0,4,5,-1
FJI,AUS,2006.0,2,3,-1
MDG,JPN,2003.0,1,1,0
NZL,HKG,2006.0,1,2,-1
LUX,CHE,2011.0,5,7,-2
IND,HKG,2008.0,5,2,3
BRA,ECU,2004.0,1,1,0
AUT,LTU,2018.0,1,2,-1
JPN,BRA,2020.0,3,19,-16
CHN,NOR,2004.0,3,4,-1
MMR,GBR,2021.0,2,1,1
NZL,IND,2013.0,5,12,-7
FRA,GEO,2018.0,8,45,-37
HKG,PHL,2010.0,2,2,0
SRB,FRA,2021.0,4,3,1
ARE,CHE,2016.0,1,3,-2
SGP,FIN,2022.0,3,2,1
ITA,EGY,2005.0,2,1,1
NGA,ETH,2019.0,1,4,-3
CHN,THA,2011.0,5,1,4
OMN,EGY,2019.0,3,2,1
KAZ,ARE,2013.0,1,2,-1
SRB,USA,2007.0,12,10,2
AUS,TUR,2017.0,8,19,-11
ESP,EST,2020.0,4,4,0
MLI,USA,2010.0,3,3,0
HUN,ROU,2022.0,1,7,-6
BGD,ESP,2016.0,2,3,-1
GBR,LBN,2007.0,4,3,1
IRL,BHR,2018.0,4,5,-1
DNK,ISL,2021.0,4,5,-1
ISL,DEU,2007.0,1,2,-1
BGD,CAN,2002.0,4,3,1
JPN,SRB,2002.0,2,1,1
DEU,BGR,1997.0,3,4,-1
REU,FRA,2004.0,1,4,-3
TZA,USA,2005.0,5,2,3
PRT,IRL,2009.0,4,1,3
OMN,EGY,2010.0,2,4,-2
CAN,CUB,2021.0,2,5,-3
HKG,DNK,2015.0,1,2,-1
QAT,KOR,2018.0,1,5,-4
HRV,CHE,2012.0,6,4,2
CAN,PSE,2019.0,1,1,0
CMR,IDN,2015.0,3,1,2
CAN,TWN,1998.0,1,3,-2
OMN,USA,2022.0,4,2,2
MYS,IRL,2014.0,2,9,-7
IND,PHL,2021.0,6,3,3
DEU,ETH,2008.0,3,3,0
ESP,ISR,2006.0,2,3,-1
VEN,MEX,2001.0,2,2,0
CAN,UKR,2001.0,2,3,-1
CHE,GHA,2003.0,2,1,1
CAN,ECU,2006.0,1,3,-2
FIN,IRN,2003.0,1,1,0
SAU,NLD,2001.0,1,1,0
NOR,ZAF,2007.0,1,2,-1
UKR,TWN,2006.0,2,1,1
VNM,JPN,1999.0,2,1,1
CZE,MEX,2011.0,2,3,-1
AUT,ESP,1997.0,2,2,0
MAC,PRT,2019.0,3,2,1
USA,AFG,2017.0,3,6,-3
MEX,PAN,2010.0,1,1,0
TUN,BEL,2006.0,1,2,-1
GHA,DEU,2007.0,2,4,-2
USA,MDA,2005.0,1,1,0
HRV,MKD,2016.0,2,1,1
ROU,CAN,2010.0,4,5,-1
IRL,BEL,2006.0,2,2,0
EGY,IRL,2019.0,3,4,-1
JPN,CMR,2005.0,1,1,0
PHL,HKG,2005.0,1,1,0
CZE,FIN,2018.0,3,5,-2
HKG,NGA,2019.0,4,7,-3
AUT,CYP,2018.0,1,1,0
NGA,IRQ,2013.0,1,1,0
CAN,CRI,2013.0,2,1,1
GHA,NGA,2022.0,3,3,0
FRA,OMN,2014.0,2,2,0
GBR,TTO,2015.0,5,2,3
EGY,ITA,2002.0,1,3,-2
HND,USA,2004.0,1,2,-1
GBR,MAC,2021.0,3,4,-1
NOR,JPN,1998.0,3,2,1
SGP,ITA,2015.0,4,14,-10
ZAF,UGA,2013.0,4,2,2
GBR,PAN,2018.0,1,2,-1
BEL,BFA,2013.0,3,1,2
ZAF,ETH,2022.0,3,2,1
ESP,NZL,2018.0,4,7,-3
PRI,IND,2013.0,1,2,-1
LVA,GBR,2007.0,1,3,-2
CAN,ARM,2017.0,1,1,0
PHL,PAK,2012.0,1,1,0
TWN,MEX,2009.0,2,1,1
RUS,COL,2000.0,2,1,1
CZE,EGY,2010.0,3,1,2
KOR,THA,2012.0,3,3,0
KAZ,CZE,2020.0,3,1,2
VNM,CAN,2002.0,1,4,-3
IRL,URY,2012.0,1,1,0
THA,BGD,2004.0,1,1,0
NOR,TZA,2011.0,4,5,-1
FRA,PYF,2004.0,3,8,-5
ZAF,FIN,2016.0,2,5,-3
ITA,NZL,2008.0,5,3,2
MOZ,ESP,2005.0,1,1,0
DNK,BRA,2014.0,5,10,-5
GUY,CAN,2013.0,2,1,1
MLI,NLD,2010.0,1,1,0
BGR,BEL,2015.0,4,4,0
PAK,RUS,2022.0,2,1,1
NLD,NPL,2017.0,1,1,0
NOR,AUS,1999.0,2,3,-1
BHR,IND,2003.0,2,1,1
CAN,TZA,2015.0,1,1,0
ARG,PRT,2022.0,2,1,1
ROU,CAN,2019.0,5,7,-2
USA,SVN,1998.0,2,1,1
CZE,AUS,2012.0,2,3,-1
NGA,ETH,2017.0,3,2,1
NLD,NAM,2019.0,1,1,0
FRA,HUN,2005.0,4,7,-3
THA,NZL,2016.0,1,3,-2
LVA,SWE,2015.0,2,4,-2
COL,PAN,2011.0,4,3,1
BEL,GEO,2020.0,4,2,2
RUS,PRT,2021.0,2,7,-5
KEN,SAU,2011.0,1,1,0
NOR,NZL,2021.0,3,6,-3
LKA,CAN,2021.0,1,1,0
LTU,POL,2016.0,1,3,-2
IRL,IRN,2013.0,1,8,-7
CRI,CAN,2016.0,1,3,-2
PRT,CPV,2018.0,1,1,0
DNK,HKG,2007.0,1,1,0
MAC,PRT,2017.0,1,4,-3
QAT,MAR,2018.0,1,2,-1
HUN,AUS,2001.0,3,2,1
OMN,IND,2004.0,2,4,-2
NZL,PAK,2009.0,1,2,-1
SYR,FRA,2018.0,3,9,-6
CHE,MYS,2017.0,2,3,-1
USA,BIH,2015.0,1,1,0
MLI,USA,2017.0,2,4,-2
MYS,PAK,2008.0,2,6,-4
DZA,USA,2013.0,1,1,0
IDN,IND,2013.0,2,2,0
JPN,UZB,2019.0,1,1,0
SVK,HUN,1999.0,1,1,0
POL,AUT,1998.0,1,2,-1
USA,BEN,2011.0,1,1,0
ZWE,ETH,2014.0,1,1,0
RUS,BEL,2022.0,4,5,-1
CHE,EST,2006.0,1,1,0
DNK,JPN,1997.0,1,1,0
ECU,GBR,2020.0,2,5,-3
ARE,FIN,2020.0,1,2,-1
CZE,HUN,2021.0,1,4,-3
KEN,CAN,2004.0,2,3,-1
VNM,BEL,2006.0,3,3,0
CZE,DNK,2001.0,1,2,-1
DEU,ARM,1997.0,1,3,-2
IDN,FRA,2006.0,2,6,-4
BGD,CHE,2020.0,2,9,-7
MAR,JPN,2005.0,1,1,0
EGY,ISR,2017.0,1,1,0
ESP,SRB,2020.0,2,4,-2
NOR,IDN,2020.0,1,2,-1
THA,GHA,2013.0,1,1,0
ITA,PRT,2000.0,1,3,-2
PHL,JPN,1999.0,1,2,-1
SEN,BFA,2017.0,2,1,1
SAU,BEL,2007.0,1,1,0
BHR,USA,2013.0,1,3,-2
TUR,BGD,2019.0,1,2,-1
PRK,CHN,2019.0,3,11,-8
GBR,SVK,1997.0,2,3,-1
AUT,MAR,2009.0,1,1,0
USA,SVN,1997.0,1,1,0
NOR,PRT,2015.0,2,10,-8
JPN,ETH,2011.0,1,1,0
MEX,PAN,2017.0,1,1,0
IRL,PRT,2015.0,2,9,-7
TWN,ETH,2015.0,1,2,-1
FRA,AZE,2016.0,1,1,0
GBR,ETH,2022.0,1,3,-2
ARE,POL,2019.0,1,1,0
CAN,BLR,2011.0,1,2,-1
HKG,PHL,2017.0,1,2,-1
TZA,DEU,2012.0,2,2,0
NLD,BGD,2017.0,2,1,1
PRT,ITA,1998.0,1,2,-1
JPN,SVN,2018.0,1,2,-1
COL,PRI,2014.0,1,4,-3
KAZ,CHN,2022.0,2,4,-2
UKR,ESP,2006.0,1,1,0
DEU,BGR,1998.0,2,4,-2
BRA,NGA,2004.0,1,1,0
POL,HUN,1999.0,2,1,1
IRQ,BGD,2017.0,1,2,-1
NLD,ZMB,2018.0,2,1,1
POL,GRC,2011.0,1,4,-3
PRI,ESP,2011.0,1,2,-1
MWI,AUS,2006.0,1,1,0
TZA,KEN,2009.0,2,2,0
SGP,LKA,2011.0,1,1,0
BGR,GRC,2002.0,2,3,-1
KEN,NZL,2010.0,1,1,0
MLT,ITA,2013.0,1,3,-2
MKD,DEU,2011.0,1,2,-1
IRN,DZA,2013.0,1,1,0
TUN,BRA,2016.0,1,1,0
ZWE,AUS,2013.0,1,1,0
MAR,NER,2018.0,1,1,0
PAK,KWT,2002.0,1,2,-1
ISR,EGY,2021.0,1,2,-1
CIV,CRI,2018.0,3,2,1
LBN,AUS,2020.0,2,4,-2
FIN,BEL,2021.0,1,10,-9
RUS,AUS,2022.0,1,1,0
ETH,AUT,2017.0,1,1,0
USA,AFG,2010.0,1,3,-2
MAR,FIN,2021.0,1,1,0
NOR,EST,2003.0,2,1,1
BGR,CZE,2018.0,1,2,-1
CZE,CHN,2013.0,2,2,0
DEU,ARM,1998.0,1,2,-1
ZAF,BEL,2017.0,1,8,-7
CAN,PSE,2017.0,2,1,1
MEX,PRT,2004.0,1,3,-2
EGY,BHR,2010.0,1,1,0
KAZ,SAU,2014.0,1,2,-1
SGP,MYS,2000.0,1,1,0
MNP,USA,2015.0,1,1,0
HRV,SWE,2022.0,1,1,0
POL,SGP,2002.0,1,1,0
LBN,CHE,2012.0,1,2,-1
RUS,KOR,2022.0,3,1,2
KEN,BWA,2020.0,1,2,-1
VNM,CAN,2005.0,1,1,0
EGY,ITA,2005.0,1,2,-1
BEL,CZE,2001.0,1,4,-3
POL,DNK,2000.0,1,3,-2
NLD,BGD,2010.0,1,2,-1
THA,PHL,2016.0,1,3,-2
GHA,BEL,2021.0,2,2,0
MKD,USA,2018.0,1,1,0
DEU,BIH,2016.0,1,1,0
GBR,BGR,1998.0,1,1,0
IND,EST,2018.0,1,1,0
USA,GBR,2012.0,1296,1490,-194
AUS,GBR,2013.0,401,678,-277
CHN,SGP,2014.0,195,247,-52
BEL,NLD,2010.0,113,125,-12
RUS,DEU,1998.0,49,33,16
EST,SWE,2017.0,4,3,1
GBR,NZL,2009.0,118,92,26
DNK,FIN,2004.0,8,5,3
CHN,MAC,2016.0,69,33,36
CHN,JPN,2014.0,259,476,-217
TZA,KOR,2014.0,1,4,-3
JPN,FRA,2003.0,65,52,13
PAK,FRA,2017.0,7,23,-16
IND,DEU,2016.0,189,132,57
NLD,CAN,2021.0,28,47,-19
FRA,BRA,2014.0,109,90,19
DEU,GBR,2021.0,431,513,-82
CHE,TWN,2019.0,8,11,-3
PHL,FRA,2014.0,4,1,3
CAN,IND,2007.0,31,86,-55
VEN,COL,2021.0,14,9,5
CAN,FRA,2000.0,39,65,-26
USA,TWN,2020.0,186,192,-6
CZE,USA,2014.0,36,60,-24
CZE,ITA,2005.0,7,5,2
FRA,JPN,2011.0,86,90,-4
DEU,POL,2009.0,60,70,-10
THA,DEU,2013.0,15,30,-15
IND,FIN,2014.0,15,3,12
RUS,JPN,2001.0,34,25,9
NOR,SWE,1999.0,14,17,-3
FIN,DEU,2004.0,18,22,-4
CHN,SAU,2021.0,43,30,13
ESP,CAN,2016.0,60,36,24
NZL,CAN,2017.0,41,32,9
ESP,CZE,2015.0,33,4,29
IRN,NLD,2007.0,9,9,0
MAR,FRA,2004.0,48,42,6
PRT,DEU,2012.0,30,36,-6
USA,FIN,2006.0,62,66,-4
OMN,MYS,2021.0,3,15,-12
USA,COL,2022.0,31,48,-17
TUR,FRA,2018.0,25,13,12
BGR,NLD,2004.0,4,1,3
GBR,RUS,2003.0,47,58,-11
IRL,EGY,2021.0,2,4,-2
TUR,GBR,2004.0,20,23,-3
CHL,ESP,2008.0,38,29,9
CAN,SAU,2002.0,19,13,6
NZL,BEL,2002.0,2,1,1
JPN,HKG,2020.0,11,18,-7
POL,BEL,2001.0,7,5,2
ROU,GBR,2012.0,16,9,7
BGR,GRC,2005.0,3,1,2
DEU,SGP,2011.0,30,17,13
FIN,SWE,2014.0,56,41,15
GBR,MAR,2007.0,1,4,-3
USA,SAU,2000.0,12,9,3
USA,BGR,2020.0,11,4,7
BLR,PRT,2009.0,1,1,0
SGP,NZL,2006.0,6,4,2
SWE,LTU,2008.0,4,3,1
IND,PAK,2004.0,11,2,9
PHL,SGP,2022.0,2,2,0
NAM,IND,2012.0,1,1,0
EST,SWE,2019.0,8,5,3
BGR,CHE,2016.0,4,2,2
THA,FRA,2013.0,11,18,-7
DEU,ECU,2022.0,1,1,0
LBY,CAN,2020.0,2,3,-1
DEU,DZA,2021.0,2,4,-2
ESP,TUN,2020.0,7,8,-1
SWE,NZL,2008.0,8,5,3
ISR,RUS,2020.0,10,23,-13
TWN,HKG,2009.0,14,8,6
GBR,JOR,2011.0,15,7,8
USA,CRI,2001.0,2,5,-3
PAK,IRL,2016.0,7,2,5
POL,AUT,1997.0,2,2,0
EGY,CZE,2014.0,2,3,-1
NGA,CHN,2022.0,8,12,-4
ZAF,IRL,2016.0,3,3,0
NLD,NPL,2019.0,5,3,2
PSE,JPN,2015.0,2,1,1
KAZ,RUS,1997.0,2,2,0
UKR,BRA,2014.0,1,1,0
NOR,SAU,2016.0,2,2,0
AUS,PHL,2006.0,3,1,2
JPN,RUS,2000.0,16,23,-7
SRB,AUT,2009.0,3,4,-1
VEN,BRA,2006.0,4,3,1
USA,HTI,2016.0,5,6,-1
LTU,USA,2010.0,3,8,-5
PRT,RUS,2009.0,5,2,3
KOR,ESP,2014.0,6,5,1
LTU,USA,2017.0,4,2,2
BGD,PAK,2006.0,5,3,2
BEL,TUN,2013.0,3,6,-3
JAM,CAN,2013.0,2,3,-1
BEL,ISR,2009.0,3,3,0
TUR,TWN,2017.0,1,1,0
SVK,GBR,2022.0,2,1,1
NZL,JPN,2018.0,13,6,7
FIN,AUT,2003.0,6,2,4
USA,SYR,2007.0,1,2,-1
UKR,KOR,2007.0,4,1,3
KEN,ZWE,2015.0,1,1,0
GIN,SEN,2018.0,1,1,0
GBR,SVN,2001.0,2,3,-1
AUS,CHL,2008.0,3,2,1
NGA,ZAF,2001.0,4,1,3
LTU,GBR,2010.0,7,3,4
FRA,UZB,2019.0,1,2,-1
CHL,MEX,1999.0,1,1,0
NLD,FIN,2021.0,13,21,-8
ZAF,CMR,2013.0,3,6,-3
BHR,GBR,2016.0,3,3,0
SVK,UKR,2014.0,1,4,-3
PAK,EGY,2018.0,2,1,1
BWA,GBR,2022.0,2,2,0
ARE,ITA,2021.0,3,6,-3
EGY,BHR,2017.0,2,3,-1
ETH,ZAF,2011.0,6,5,1
AUT,HRV,2011.0,4,4,0
GRC,EST,2016.0,2,1,1
USA,BMU,2016.0,1,1,0
MEX,GRC,2019.0,1,1,0
DNK,TUR,2020.0,2,12,-10
BRA,SWE,1998.0,1,2,-1
SVK,CAN,2004.0,1,2,-1
FRA,GUY,2006.0,1,1,0
VNM,CZE,2020.0,4,7,-3
GRC,TUR,2004.0,1,3,-2
MLI,FRA,2012.0,3,2,1
LAO,CHE,2019.0,1,2,-1
GBR,SHN,2017.0,1,1,0
KEN,USA,1998.0,4,2,2
OMN,EGY,2017.0,1,4,-3
MLI,USA,2019.0,3,2,1
CAN,TTO,2003.0,1,1,0
ITA,MYS,2020.0,4,3,1
IRQ,CHN,2016.0,2,18,-16
IDN,CAN,2018.0,1,5,-4
VEN,FRA,1999.0,1,4,-3
GBR,BGR,1997.0,1,1,0
GBR,PER,2000.0,1,1,0
URY,DEU,2020.0,1,4,-3
AUS,SLB,2020.0,1,1,0
ARE,PAK,2003.0,1,1,0
,ESP,1999.0,15971,0,15971
,JPN,1998.0,55106,0,55106
AUS,,2020.0,9808,0,9808
,ITA,2001.0,14081,0,14081
KOR,,2009.0,4794,0,4794
CAN,,2009.0,5469,0,5469
,TWN,1998.0,6631,0,6631
,CHN,2009.0,100599,0,100599
TUR,,2009.0,1687,0,1687
,JPN,1997.0,10794,0,10794
,SWE,2011.0,3854,0,3854
NLD,,2011.0,2840,0,2840
BEL,,2014.0,1958,0,1958
,TUR,2003.0,6292,0,6292
PRT,,2021.0,3647,0,3647
MEX,,2024.0,27162,0,27162
CHE,,2013.0,2573,0,2573
,DEU,2001.0,18766,0,18766
DZA,,2011.0,128,0,128
,IND,1999.0,13349,0,13349
GBR,,2003.0,4124,0,4124
RUS,,2003.0,2345,0,2345
,GBR,2008.0,18773,0,18773
HKG,,2015.0,986,0,986
POL,,2003.0,590,0,590
,DZA,2000.0,375,0,375
CHL,,2010.0,551,0,551
AZE,,2014.0,142,0,142
ZMB,,2024.0,515,0,515
IRN,,2022.0,17114,0,17114
NGA,,2002.0,13,0,13
,TWN,1997.0,1178,0,1178
CHL,,2017.0,1143,0,1143
,BRB,2004.0,6,0,6
,JAM,2007.0,38,0,38
CHL,,2019.0,1633,0,1633
WSM,AUS,2007.0,3,0,3
,LTU,2010.0,598,0,598
HRV,,2014.0,579,0,579
HND,,2021.0,35,0,35
,BOL,2002.0,36,0,36
BHR,,2023.0,308,0,308
,CHE,2010.0,4283,0,4283
,TUV,2005.0,1,0,1
LBN,,2010.0,75,0,75
NPL,,2011.0,58,0,58
,VEN,2003.0,504,0,504
GEO,NLD,2017.0,2,0,2
VNM,,2020.0,730,0,730
UKR,SVN,2010.0,2,0,2
TUN,,2013.0,526,0,526
HUN,,2004.0,334,0,334
LBN,,2019.0,255,0,255
COL,LAO,2016.0,1,0,1
,CYP,2004.0,76,0,76
AUT,GRC,2006.0,3,0,3
,MDA,2008.0,46,0,46
,BGR,2016.0,538,0,538
LBN,,2017.0,192,0,192
KAZ,,2020.0,889,0,889
,NGA,2007.0,1518,0,1518
,UGA,2010.0,266,0,266
NAM,,2021.0,35,0,35
,IRQ,2007.0,232,0,232
,CHE,2017.0,4352,0,4352
EGY,ZAF,2013.0,3,0,3
,EGY,2013.0,3354,0,3354
,GEO,2012.0,168,0,168
NGA,,2005.0,65,0,65
CAN,PAN,2013.0,1,0,1
,PNG,2011.0,29,0,29
BWA,,2018.0,48,0,48
CHN,MNG,2014.0,1,0,1
,ZAF,2018.0,2238,0,2238
ZAF,EST,2018.0,1,0,1
DEU,SEN,2003.0,1,0,1
PRK,,2024.0,199,0,199
,CRI,2014.0,153,0,153
,CHE,2019.0,2306,0,2306
,PAN,2012.0,51,0,51
,BIH,2013.0,192,0,192
,CHL,2016.0,2277,0,2277
CZE,THA,2022.0,2,0,2
BHS,,2018.0,7,0,7
MDA,,2024.0,138,0,138
SEN,BFA,2019.0,4,0,4
,MWI,2014.0,116,0,116
FJI,,2023.0,138,0,138
,LTU,2017.0,514,0,514
,TJK,2015.0,19,0,19
IND,YEM,2020.0,12,0,12
,TTO,2015.0,68,0,68
SEN,,2020.0,182,0,182
IRL,ISL,2021.0,1,0,1
NOR,,2006.0,388,0,388
,LTU,2019.0,236,0,236
MCO,MAR,2019.0,2,0,2
,UGA,2017.0,349,0,349
,CMR,2007.0,218,0,218
HUN,PAK,2015.0,1,0,1
,MLT,2018.0,75,0,75
BEN,CAN,2008.0,2,0,2
RUS,SAU,2017.0,6,0,6
TJK,DEU,2016.0,2,0,2
,ECU,2014.0,518,0,518
GTM,MEX,2017.0,1,0,1
,KEN,2001.0,255,0,255
,LKA,2006.0,168,0,168
CMR,,2014.0,95,0,95
PAK,BRA,2011.0,4,0,4
NLD,DZA,2013.0,1,0,1
,URY,1998.0,178,0,178
JPN,,2025.0,29,0,29
MDV,NPL,2014.0,1,0,1
ITA,PRI,1998.0,1,0,1
BGR,PAK,2011.0,1,0,1
,KWT,2003.0,149,0,149
,KGZ,2011.0,26,0,26
LAO,,2013.0,13,0,13
PER,,2004.0,18,0,18
VNM,ITA,2008.0,1,0,1
,PLW,2013.0,4,0,4
PHL,,2008.0,52,0,52
CHN,ZWE,2019.0,2,0,2
,MCO,2015.0,6,0,6
SWZ,,2018.0,4,0,4
,URY,1997.0,67,0,67
TUN,GBR,2006.0,2,0,2
,TCD,2004.0,5,0,5
,GUF,2018.0,13,0,13
HKG,CHE,2002.0,1,0,1
LTU,CHE,2011.0,1,0,1
,MOZ,2003.0,17,0,17
PAK,ROU,2015.0,1,0,1
,CYP,1996.0,15,0,15
BIH,,2009.0,34,0,34
SAU,,2004.0,149,0,149
MLI,,2009.0,12,0,12
,UGA,2019.0,270,0,270
FIN,GRC,2004.0,3,0,3
AUS,MAR,2013.0,2,0,2
SRB,,1999.0,12,0,12
BEL,NIC,2007.0,2,0,2
,TGO,1999.0,11,0,11
TWN,ARE,2009.0,1,0,1
USA,NGA,1999.0,2,0,2
ISR,CZE,2000.0,2,0,2
BEL,ARE,2016.0,4,0,4
ISR,BRA,1998.0,1,0,1
,MKD,1995.0,23,0,23
CUB,CAN,2005.0,3,0,3
TZA,USA,2002.0,13,0,13
LAO,CHE,2010.0,2,0,2
ZAF,BEL,2010.0,4,0,4
JAM,,2003.0,6,0,6
CHE,VNM,2021.0,5,0,5
PER,AUS,2001.0,1,0,1
ITA,ISL,2009.0,2,0,2
MYS,BRN,2009.0,2,0,2
TTO,AUS,2006.0,1,0,1
SEN,COG,2012.0,2,0,2
PAK,GEO,2011.0,2,0,2
PER,SAU,2002.0,1,0,1
FIN,ARE,2012.0,1,0,1
CAN,CYP,1999.0,2,0,2
ROU,RUS,1999.0,4,0,4
SGP,BGR,2018.0,1,0,1
SLV,,2012.0,4,0,4
,GMB,2003.0,27,0,27
THA,DNK,2005.0,2,0,2
,BOL,2005.0,56,0,56
LKA,IRL,2014.0,1,0,1
CHN,IDN,2008.0,2,0,2
GMB,CHE,2000.0,2,0,2
UKR,JOR,2012.0,1,0,1
QAT,CHE,2016.0,2,0,2
KOR,COL,2018.0,1,0,1
GBR,SHN,2019.0,1,0,1
UGA,BEL,2011.0,3,0,3
IRL,SAU,2004.0,2,0,2
GBR,BIH,2007.0,1,0,1
IRL,,2000.0,28,0,28
MEX,NZL,2012.0,3,0,3
IRQ,CAN,2015.0,1,0,1
GTM,CHL,2017.0,2,0,2
CHL,SVN,2017.0,1,0,1
BGR,TWN,2016.0,1,0,1
TCD,,2014.0,1,0,1
ZAF,BFA,2017.0,3,0,3
ISR,SYR,2015.0,1,0,1
JPN,LUX,2019.0,2,0,2
MNG,HKG,2022.0,1,0,1
EGY,TTO,2009.0,1,0,1
,SDN,2003.0,51,0,51
ISR,,2000.0,55,0,55
NZL,POL,1998.0,1,0,1
BOL,CHL,2012.0,2,0,2
UGA,BWA,2014.0,2,0,2
PAN,,2012.0,9,0,9
PAK,SWE,2008.0,3,0,3
MYS,PSE,2011.0,2,0,2
PHL,CZE,2019.0,2,0,2
UGA,COD,2019.0,1,0,1
,BDI,2000.0,2,0,2
LVA,JPN,2020.0,1,0,1
BRN,,2011.0,5,0,5
FRA,MLT,2022.0,1,0,1
POL,SAU,2021.0,1,0,1
ZAF,MDG,2020.0,1,0,1
AUT,GHA,2019.0,1,0,1
,HTI,2009.0,15,0,15
VUT,AUS,2002.0,1,0,1
TUR,JOR,2001.0,1,0,1
BRA,BOL,2010.0,3,0,3
NOR,FRO,2009.0,1,0,1
HKG,CHN,2023.0,5,0,5
GRC,PRT,2003.0,1,0,1
DNK,EGY,2000.0,4,0,4
ESP,DZA,2001.0,1,0,1
MNP,,2023.0,1,0,1
GBR,FJI,2011.0,3,0,3
LTU,LUX,2008.0,1,0,1
CUB,CAN,2002.0,3,0,3
IRQ,QAT,2000.0,2,0,2
MWI,,2008.0,18,0,18
MAR,JPN,2002.0,1,0,1
TWN,PHL,2005.0,2,0,2
DEU,CIV,2011.0,1,0,1
SLE,,2013.0,4,0,4
AUS,BWA,2003.0,1,0,1
PAN,PNG,2008.0,1,0,1
MYS,TWN,2008.0,5,0,5
BWA,ZMB,2017.0,1,0,1
VEN,GBR,2016.0,2,0,2
SGP,OMN,2018.0,3,0,3
VEN,CUB,2010.0,3,0,3
AFG,,2008.0,2,0,2
ESP,VNM,2019.0,3,0,3
SAU,VNM,2018.0,1,0,1
,REU,2010.0,7,0,7
MLI,IND,2013.0,2,0,2
FIN,OMN,2022.0,1,0,1
MDV,AUS,2011.0,1,0,1
,BHS,2003.0,3,0,3
NGA,SDN,2019.0,1,0,1
DNK,FRO,2020.0,6,0,6
GMB,UGA,2009.0,1,0,1
NGA,POL,2022.0,2,0,2
BLR,CAN,1998.0,1,0,1
ZAF,BFA,2010.0,1,0,1
UZB,ESP,2007.0,1,0,1
MEX,NIC,2008.0,1,0,1
SGP,LUX,2011.0,1,0,1
RUS,LUX,2018.0,1,0,1
BRA,CYP,2021.0,2,0,2
SYR,ESP,2016.0,1,0,1
LKA,OMN,2013.0,1,0,1
FJI,CZE,2008.0,1,0,1
BRA,TUR,2004.0,2,0,2
,FLK,1999.0,5,0,5
NGA,JPN,2000.0,1,0,1
ISR,ARG,2006.0,4,0,4
CIV,BFA,2005.0,2,0,2
JOR,AFG,2017.0,1,0,1
FSM,,2016.0,5,0,5
PRI,VEN,2020.0,2,0,2
KOR,MAC,2019.0,1,0,1
SGP,TWN,2000.0,1,0,1
ESP,LSO,2017.0,1,0,1
BRA,BOL,2019.0,3,0,3
BLR,FIN,2020.0,1,0,1
IRN,ZWE,2020.0,1,0,1
,BRB,1996.0,2,0,2
PAK,KWT,2005.0,1,0,1
NLD,PSE,2012.0,1,0,1
CMR,HKG,2019.0,1,0,1
SRB,ESP,2007.0,2,0,2
TJK,,2007.0,4,0,4
ARG,ISR,2019.0,1,0,1
JPN,IRN,1999.0,2,0,2
TTO,FRA,2007.0,1,0,1
BOL,GBR,2011.0,2,0,2
TUR,BIH,2006.0,1,0,1
IRL,DZA,2006.0,2,0,2
TUR,RUS,2020.0,3,0,3
LBN,IRQ,2021.0,1,0,1
NZL,BGR,1998.0,1,0,1
ROU,CUB,2006.0,2,0,2
,COD,1995.0,2,0,2
NGA,BFA,2002.0,2,0,2
SVN,ISR,2000.0,1,0,1
MCO,BEL,2009.0,1,0,1
CHE,BGR,1998.0,1,0,1
SEN,ITA,2011.0,1,0,1
COL,MEX,1998.0,2,0,2
MEX,AUT,2000.0,1,0,1
JPN,UGA,1999.0,1,0,1
PRT,LUX,2007.0,2,0,2
UZB,IRN,2008.0,1,0,1
OMN,QAT,2004.0,2,0,2
PYF,CHE,2009.0,1,0,1
,BTN,2003.0,4,0,4
HUN,LVA,2017.0,1,0,1
SEN,BFA,2010.0,1,0,1
GIN,JPN,2010.0,1,0,1
IRN,HRV,2014.0,2,0,2
MYS,QAT,2018.0,5,0,5
TWN,SLB,2019.0,1,0,1
SEN,TGO,2017.0,1,0,1
LAO,JPN,2017.0,2,0,2
GBR,BHR,2001.0,2,0,2
CHE,ZMB,2006.0,1,0,1
CAN,KNA,2013.0,1,0,1
ARG,DOM,2012.0,1,0,1
PER,SWE,2012.0,3,0,3
EGY,GBR,2000.0,4,0,4
ITA,VEN,2009.0,2,0,2
GUY,FRA,2011.0,1,0,1
FRA,ARE,2008.0,2,0,2
ESP,GIB,2014.0,2,0,2
THA,MEX,2001.0,1,0,1
SLE,USA,2011.0,4,0,4
BEN,USA,2016.0,3,0,3
KHM,BEL,2012.0,1,0,1
ZAF,BWA,2003.0,3,0,3
HRV,IND,2000.0,1,0,1
NLD,NPL,2010.0,1,0,1
URY,AUT,2009.0,1,0,1
HKG,CHE,2005.0,3,0,3
IRN,QAT,2006.0,1,0,1
AFG,PAK,2007.0,1,0,1
COL,,1999.0,2,0,2
UKR,SGP,2003.0,2,0,2
GHA,COG,2009.0,1,0,1
AFG,ITA,2012.0,1,0,1
VEN,CUB,2017.0,3,0,3
BRN,IDN,2015.0,1,0,1
KOR,ZWE,2019.0,1,0,1
ZAF,NLD,2000.0,3,0,3
IND,BGR,2013.0,2,0,2
WSM,,2020.0,4,0,4
UZB,TJK,2017.0,1,0,1
MUS,QAT,2017.0,1,0,1
PRT,ETH,2017.0,1,0,1
,BMU,2016.0,3,0,3
ZAF,SRB,2019.0,1,0,1
KEN,BEN,2006.0,1,0,1
IDN,NOR,2006.0,1,0,1
BEL,MUS,2005.0,1,0,1
PRT,THA,2012.0,1,0,1
UKR,CHE,2006.0,2,0,2
TWN,NZL,2021.0,2,0,2
SGP,CHL,2021.0,1,0,1
CUB,PRT,2008.0,2,0,2
MDG,KHM,2014.0,1,0,1
NOR,UGA,2000.0,1,0,1
SRB,ARE,2003.0,1,0,1
CYP,HKG,2013.0,1,0,1
BFA,GIN,2019.0,1,0,1
PRT,SWE,1999.0,3,0,3
AUS,UKR,2007.0,1,0,1
JPN,SDN,2018.0,1,0,1
SEN,NCL,2012.0,2,0,2
AUT,CRI,2016.0,1,0,1
LKA,CZE,2014.0,1,0,1
TUR,NOR,2003.0,1,0,1
CIV,BEN,2022.0,2,0,2
SWE,ISL,1998.0,1,0,1
NER,ETH,2003.0,1,0,1
BRN,CAN,2018.0,1,0,1
SYR,YEM,2014.0,1,0,1
BGR,SRB,2016.0,1,0,1
TUR,KOR,2004.0,1,0,1
NZL,ARG,2022.0,1,0,1
,WSM,1999.0,2,0,2
SVN,ARG,2010.0,1,0,1
ITA,JOR,1998.0,1,0,1
SWE,KOR,1997.0,2,0,2
BEL,GUM,2006.0,1,0,1
BRA,ALB,2014.0,1,0,1
ARG,FIN,2018.0,2,0,2
TUN,CHE,2003.0,1,0,1
UZB,USA,2006.0,2,0,2
MDG,IND,2006.0,1,0,1
IDN,CMR,2002.0,1,0,1
AUS,MMR,2008.0,1,0,1
ARM,NLD,2003.0,1,0,1
LUX,SAU,2021.0,1,0,1
SRB,SVK,2012.0,2,0,2
CHL,TWN,2019.0,1,0,1
ZAF,DNK,2001.0,1,0,1
CUB,CHL,2000.0,2,0,2
BFA,BEN,2009.0,1,0,1
ZWE,BWA,2005.0,2,0,2
IDN,ZAF,2008.0,1,0,1
NLD,TWN,2013.0,3,0,3
BRA,MUS,2007.0,1,0,1
USA,PNG,2012.0,1,0,1
GRC,BHR,2017.0,1,0,1
AUS,SAU,2001.0,1,0,1
,ASM,2013.0,1,0,1
GBR,COM,2020.0,1,0,1
KOR,MAC,2017.0,1,0,1
IND,KAZ,2021.0,2,0,2
RUS,MAR,2013.0,1,0,1
DNK,SEN,1999.0,1,0,1
PRT,SVK,2016.0,1,0,1
BRB,CAN,2013.0,1,0,1
NLD,NZL,1998.0,1,0,1
PHL,HKG,2002.0,1,0,1
MNE,DEU,2003.0,1,0,1
HRV,IRL,2014.0,2,0,2
PLW,,2017.0,3,0,3
ERI,USA,2016.0,1,0,1
CRI,ITA,2020.0,4,0,4
BWA,NZL,2006.0,1,0,1
,VUT,2000.0,3,0,3
KWT,SWE,2018.0,1,0,1
BEL,QAT,2008.0,1,0,1
MWI,CHE,2010.0,1,0,1
EGY,ISR,2010.0,1,0,1
CHL,CZE,2014.0,2,0,2
BEN,CMR,2006.0,1,0,1
BRA,IDN,2011.0,1,0,1
PRI,OMN,2015.0,1,0,1
THA,TZA,2009.0,1,0,1
SDN,CAN,2019.0,1,0,1
KWT,PSE,2016.0,1,0,1
MLT,JPN,2012.0,1,0,1
GBR,LSO,2013.0,2,0,2
NPL,CAN,2014.0,1,0,1
URY,BEL,2014.0,1,0,1
OMN,TUN,2002.0,1,0,1
LBY,MAR,2019.0,2,0,2
BEN,GMB,2016.0,1,0,1
IDN,BDI,2020.0,1,0,1
UGA,EGY,2022.0,1,0,1
MAC,VNM,2011.0,1,0,1
GHA,MWI,2017.0,1,0,1
SRB,SGP,2015.0,2,0,2
CHE,BHR,2020.0,1,0,1
BGD,FIN,2021.0,1,0,1
KOR,CZE,2004.0,2,0,2
IRN,EST,2021.0,7,0,7
ROU,NLD,1999.0,1,0,1
IDN,BGD,2012.0,1,0,1
BGD,KWT,2002.0,1,0,1
AUT,PRT,2001.0,2,0,2
PSE,CAN,2021.0,3,0,3
LVA,LTU,2018.0,2,0,2
DNK,LBR,2017.0,1,0,1
SAU,COL,2013.0,1,0,1
CMR,SLE,2015.0,1,0,1
DNK,UGA,2018.0,2,0,2
USA,ERI,2001.0,1,0,1
NAM,LSO,2015.0,1,0,1
NZL,BGR,1997.0,1,0,1
JOR,EGY,2004.0,4,0,4
SEN,MDG,2005.0,1,0,1
PAN,NLD,2021.0,1,0,1
SVN,HUN,2015.0,1,0,1
HKG,CHL,2020.0,3,0,3
PHL,GRC,2009.0,1,0,1
ARG,SWE,1999.0,1,0,1
SWE,CRI,2014.0,1,0,1
AUT,GHA,2010.0,1,0,1
ISL,VNM,2011.0,1,0,1
PRT,MYS,2009.0,2,0,2
GEO,ITA,2003.0,1,0,1
PHL,BRA,2014.0,1,0,1
ARE,CYP,2008.0,1,0,1
NZL,POL,1997.0,1,0,1
GNQ,GIN,2014.0,1,0,1
PHL,SAU,2001.0,1,0,1
GBR,LUX,2005.0,3,0,3
TWN,ITA,2002.0,2,0,2
THA,EGY,2010.0,1,0,1
BFA,NER,2013.0,1,0,1
CHL,LBN,2007.0,1,0,1
ARG,RUS,2015.0,2,0,2
ARG,ROU,2013.0,1,0,1
MEX,PAN,2019.0,2,0,2
COL,SGP,2016.0,1,0,1
SEN,DEU,2006.0,1,0,1
NGA,SOM,2008.0,1,0,1
CHE,ETH,2012.0,2,0,2
MEX,THA,2011.0,1,0,1
NLD,AUT,1997.0,1,0,1
BEN,COG,2011.0,1,0,1
SGP,KAZ,2004.0,1,0,1
CRI,ARG,2011.0,1,0,1
ALB,BGR,2019.0,1,0,1
ZMB,DNK,2019.0,1,0,1
CAN,SYC,2019.0,1,0,1
PRI,CHE,1997.0,1,0,1
USA,LUX,2004.0,3,0,3
BGD,NLD,2006.0,1,0,1
JPN,LUX,2010.0,1,0,1
AUS,KEN,2003.0,1,0,1
DNK,SDN,2002.0,1,0,1
PSE,RUS,2014.0,1,0,1
AUT,COL,2012.0,1,0,1
MOZ,ETH,2012.0,1,0,1
ISR,MDA,2006.0,1,0,1
POL,SGP,2005.0,2,0,2
MNG,TUR,2022.0,1,0,1
KOR,MNG,2009.0,3,0,3
GIN,JPN,2017.0,1,0,1
AUS,MKD,2015.0,1,0,1
ISR,CYP,2012.0,1,0,1
NZL,ETH,2014.0,1,0,1
PER,COL,1999.0,1,0,1
FIN,VNM,2016.0,1,0,1
BRA,NER,2015.0,1,0,1
CHE,KHM,2014.0,1,0,1
IND,MAC,2020.0,1,0,1
NZL,NGA,2015.0,1,0,1
HKG,IRL,2016.0,2,0,2
MNG,AUT,2019.0,1,0,1
THA,EGY,2019.0,1,0,1
IND,EGY,2008.0,2,0,2
BEL,GHA,2014.0,1,0,1
MNE,SVN,2016.0,1,0,1
SGP,BHR,2011.0,1,0,1
LBR,ETH,2020.0,1,0,1
TKM,,1999.0,1,0,1
KEN,LKA,2017.0,1,0,1
TWN,TUR,2013.0,1,0,1
BLZ,,2020.0,1,0,1
TUR,BHR,2008.0,1,0,1
MNE,BIH,2017.0,2,0,2
BEN,ECU,2019.0,1,0,1
MKD,AUT,2011.0,1,0,1
CZE,KOR,1998.0,1,0,1
CHE,TCD,2003.0,4,0,4
KEN,SDN,2013.0,2,0,2
BRA,ZWE,2013.0,1,0,1
BEL,GMB,2009.0,1,0,1
ZAF,SRB,2010.0,1,0,1
NLD,ZAF,1998.0,2,0,2
AUT,GEO,2014.0,1,0,1
AZE,GBR,2018.0,1,0,1
SYR,KOR,2014.0,2,0,2
NOR,RWA,2019.0,1,0,1
CHE,MLI,2013.0,1,0,1
ZAF,HRV,2016.0,1,0,1
ARG,SLV,2019.0,1,0,1
MEX,SAU,2015.0,1,0,1
HRV,ARE,2020.0,1,0,1
ARG,IND,2004.0,1,0,1
MAR,AUT,2007.0,1,0,1
CMR,GUF,2002.0,1,0,1
LUX,RWA,2009.0,1,0,1
SRB,BGR,2015.0,1,0,1
SVK,EST,2014.0,1,0,1
CUB,SWE,2020.0,1,0,1
,REU,2017.0,1,0,1
AZE,IND,2014.0,1,0,1
NPL,GRC,2020.0,1,0,1
MMR,BEL,2019.0,1,0,1
KWT,OMN,2001.0,2,0,2
GRC,PHL,2001.0,2,0,2
NCL,HKG,2005.0,1,0,1
CHE,VEN,2002.0,1,0,1
NZL,FIN,2005.0,1,0,1
CMR,NLD,2017.0,1,0,1
KHM,CAN,2021.0,1,0,1
LTU,AUS,2008.0,1,0,1
GLP,,2007.0,1,0,1
COG,CHN,2004.0,1,0,1
NER,,2004.0,1,0,1
MYS,KWT,1997.0,1,0,1
KWT,IND,1997.0,1,0,1
MNE,CZE,2017.0,1,0,1
SVN,SWE,2002.0,1,0,1
TWN,BFA,2016.0,1,0,1
LKA,ISR,2008.0,1,0,1
AUT,BGR,2014.0,1,0,1
SWE,JOR,2013.0,1,0,1
JPN,LUX,2017.0,1,0,1
MOZ,GBR,2018.0,1,0,1
SEN,SAU,2014.0,1,0,1
CAN,BHS,2018.0,1,0,1
NZL,BOL,2021.0,1,0,1
JOR,AFG,2019.0,1,0,1
TWN,NOR,2018.0,2,0,2
CAN,MNE,2021.0,1,0,1
RWA,NLD,2012.0,2,0,2
PER,PHL,2001.0,1,0,1
PHL,MEX,2014.0,1,0,1
DEU,PAN,2016.0,1,0,1
HRV,DNK,2009.0,1,0,1
MAR,DZA,2003.0,1,0,1
AFG,GBR,2018.0,1,0,1
SAU,SVN,2022.0,1,0,1
MAR,CHE,2015.0,1,0,1
DZA,NOR,2021.0,2,0,2
BLZ,GBR,2011.0,1,0,1
EGY,IRL,2010.0,1,0,1
BGD,PER,2016.0,1,0,1
GEO,NLD,2019.0,1,0,1
GBR,CIV,2019.0,1,0,1
DEU,COG,2008.0,1,0,1
CUB,RUS,2016.0,1,0,1
ARM,AUS,2016.0,1,0,1
ITA,URY,2000.0,1,0,1
PHL,MNG,2002.0,1,0,1
CRI,FRA,2001.0,1,0,1
CZE,GEO,2003.0,1,0,1
POL,LBY,2016.0,1,0,1
CIV,CMR,2004.0,1,0,1
RUS,SVK,2022.0,1,0,1
NOR,AZE,2017.0,1,0,1
VEN,BOL,2007.0,1,0,1
GBR,ERI,2004.0,1,0,1
GEO,PAK,2014.0,1,0,1
SGP,CZE,2007.0,1,0,1
HUN,SVN,1999.0,1,0,1
SGP,IRL,2004.0,1,0,1
ITA,PSE,2008.0,1,0,1
MLI,BEN,2002.0,1,0,1
LKA,KWT,2017.0,1,0,1
TWN,MAC,2013.0,1,0,1
SGP,PNG,2019.0,1,0,1
FJI,NOR,2007.0,1,0,1
MYS,CMR,2018.0,1,0,1
ARG,SLV,2010.0,1,0,1
CHN,ROU,2009.0,1,0,1
GRC,FIN,2000.0,1,0,1
PAK,MEX,1999.0,1,0,1
MDA,SWE,2021.0,1,0,1
CZE,UZB,2021.0,1,0,1
HUN,CHL,2002.0,1,0,1
SVN,ARG,2019.0,1,0,1
MDV,MYS,2014.0,1,0,1
HUN,COL,2014.0,1,0,1
ISR,BGD,2022.0,1,0,1
CAN,FRO,2008.0,1,0,1
FRA,UZB,2010.0,1,0,1
PSE,ITA,2007.0,1,0,1
EGY,NLD,1999.0,1,0,1
LTU,JPN,1999.0,1,0,1
ARM,GBR,2003.0,1,0,1
KHM,TON,2015.0,1,0,1
ESP,IRN,2001.0,1,0,1
TUR,PRI,2003.0,1,0,1
GBR,SVK,1998.0,1,0,1
MLI,NLD,2019.0,1,0,1
ZAF,PSE,2007.0,1,0,1
NLD,ZAF,1997.0,1,0,1
ESP,MYS,2005.0,1,0,1
PHL,PRT,2011.0,1,0,1
BGD,NGA,2001.0,1,0,1
KEN,NZL,2017.0,1,0,1
GNQ,BEL,2019.0,1,0,1
PAK,LTU,2020.0,1,0,1
GAB,CMR,2010.0,1,0,1
SLB,FJI,2021.0,1,0,1
RUS,PRI,1999.0,1,0,1
SRB,UKR,2011.0,1,0,1
PRT,TUN,2015.0,1,0,1
SYR,NLD,2010.0,1,0,1
MWI,CHE,2019.0,1,0,1
GHA,THA,2021.0,1,0,1
IRL,TWN,2008.0,1,0,1
BEN,BRN,2017.0,1,0,1
ISR,JAM,2016.0,1,0,1
CAN,UGA,2011.0,1,0,1
SYR,NOR,2018.0,1,0,1
PAK,PRT,2015.0,1,0,1
GEO,GBR,2017.0,1,0,1
GBR,NOR,2021.0,95,32,63
BRA,CHE,2010.0,17,12,5
USA,FRA,2014.0,691,892,-201
DEU,SWE,2017.0,155,125,30
IRL,CHE,2013.0,10,9,1
AUS,NLD,2021.0,75,52,23
JOR,ARE,2014.0,11,4,7
NLD,GRC,2005.0,8,10,-2
BGR,DEU,2008.0,18,13,5
IRN,SGP,2012.0,7,4,3
IND,USA,2008.0,807,426,381
JPN,IND,2004.0,48,72,-24
GBR,IND,2020.0,195,317,-122
FRA,ARG,2017.0,35,31,4
FRA,TUN,2014.0,126,76,50
GBR,BEL,2015.0,98,117,-19
SRB,MKD,2007.0,9,5,4
ITA,DEU,2007.0,158,128,30
CHE,ESP,2014.0,39,112,-73
IND,GBR,2010.0,119,114,5
RUS,USA,2015.0,141,143,-2
MEX,FRA,2008.0,35,55,-20
BRA,CHN,2022.0,12,6,6
MEX,ARG,2007.0,9,8,1
FRA,LBN,2017.0,95,44,51
ITA,ROU,2019.0,12,13,-1
ESP,GBR,2013.0,360,246,114
CHE,ITA,2008.0,73,140,-67
CHE,DEU,2008.0,333,563,-230
GHA,IND,2009.0,2,1,1
BRA,ITA,2014.0,32,43,-11
DNK,NOR,2007.0,23,17,6
NLD,GBR,2016.0,318,255,63
GBR,SGP,2014.0,123,73,50
TUR,USA,2020.0,254,224,30
BEL,COL,2012.0,2,2,0
USA,CZE,2003.0,52,59,-7
BFA,FRA,2007.0,6,14,-8
AUS,CHL,2013.0,6,23,-17
USA,AUT,2014.0,123,119,4
USA,PRI,2015.0,61,80,-19
IRN,CAN,2005.0,38,39,-1
GBR,THA,2014.0,74,30,44
BEL,NLD,2018.0,170,164,6
GBR,SWE,2020.0,186,135,51
GBR,NGA,2020.0,71,53,18
DEU,SVK,2003.0,14,22,-8
SAU,IND,2021.0,48,72,-24
POL,USA,2006.0,129,95,34
IND,JPN,2004.0,72,48,24
NZL,CAN,2018.0,20,20,0
FRA,EGY,2014.0,15,10,5
KOR,IND,2007.0,25,101,-76
CHE,FRA,2011.0,216,263,-47
IRN,DEU,2010.0,41,22,19
MOZ,IND,2015.0,1,1,0
IRL,GBR,2005.0,122,140,-18
EGY,USA,2003.0,35,80,-45
IND,CAN,2014.0,110,66,44
SWE,ITA,2012.0,18,50,-32
DEU,AUS,2015.0,156,142,14
DEU,CHN,2020.0,429,427,2
ARE,JOR,2019.0,11,28,-17
CHN,ITA,2011.0,25,19,6
ISR,JPN,2016.0,4,4,0
MAC,USA,2020.0,5,13,-8
NZL,JPN,2010.0,10,13,-3
IND,GBR,2017.0,191,174,17
DEU,SWE,2019.0,162,141,21
IND,NLD,2019.0,58,29,29
TUR,IRL,2014.0,2,5,-3
SGP,USA,2014.0,203,288,-85
MYS,IDN,2016.0,70,11,59
USA,ISR,2021.0,265,267,-2
AUS,VNM,2014.0,19,8,11
ITA,BEL,2020.0,91,84,7
ESP,CAN,2022.0,26,23,3
MAR,FRA,2014.0,61,89,-28
CHN,KOR,2015.0,68,171,-103
USA,COL,2016.0,87,111,-24
IND,CHE,2011.0,28,17,11
IRL,CHN,2021.0,20,12,8
YEM,MYS,2013.0,2,4,-2
USA,SRB,2010.0,15,8,7
TWN,CHN,1998.0,15,3,12
THA,JPN,2014.0,44,81,-37
FIN,DEU,2014.0,38,56,-18
FRA,CHE,2022.0,124,88,36
SGP,IND,2022.0,42,23,19
SEN,FRA,2003.0,22,22,0
HKG,CHN,2000.0,34,94,-60
JPN,NLD,2011.0,14,14,0
USA,MEX,2021.0,96,174,-78
PAK,CAN,2011.0,22,9,13
ZAF,ZWE,2020.0,29,38,-9
ESP,GNQ,2015.0,1,1,0
DEU,JPN,2016.0,124,131,-7
HUN,NLD,2014.0,9,8,1
CHL,GBR,2004.0,7,10,-3
JPN,KOR,2018.0,107,107,0
CZE,FIN,2019.0,3,6,-3
FRA,SWE,2020.0,91,57,34
ESP,BRA,2020.0,78,104,-26
USA,POL,2021.0,59,85,-26
RUS,BEL,2016.0,11,12,-1
BEL,IRN,2020.0,4,33,-29
ESP,MEX,2021.0,90,92,-2
SWE,LTU,2013.0,4,4,0
FRA,NZL,2015.0,10,17,-7
LBN,FRA,2022.0,38,22,16
DEU,ITA,2004.0,132,127,5
AUS,MYS,2013.0,96,91,5
IRN,DEU,2019.0,133,35,98
SWE,CZE,2019.0,10,9,1
IRN,DEU,2017.0,83,31,52
CHL,PER,2017.0,11,6,5
SAU,EGY,2022.0,108,149,-41
FRA,NOR,2020.0,47,27,20
QAT,KOR,2019.0,1,2,-1
KOR,PAK,2021.0,63,43,20
BRA,SGP,2016.0,3,1,2
ITA,AUS,2017.0,58,25,33
ITA,AUS,2019.0,44,30,14
ISR,DEU,2021.0,58,52,6
AUT,DEU,1999.0,63,82,-19
TUN,ARE,2015.0,9,1,8
CHN,POL,2019.0,14,9,5
UGA,USA,2018.0,36,26,10
AUS,IRL,2016.0,28,46,-18
IND,NLD,2010.0,34,14,20
CHN,NOR,2014.0,15,18,-3
OMN,USA,2016.0,6,11,-5
DEU,BEL,2015.0,105,89,16
BHR,USA,2008.0,3,1,2
IRN,ESP,2020.0,33,16,17
ITA,NLD,2021.0,80,67,13
NLD,THA,2004.0,8,3,5
KOR,PHL,2017.0,14,5,9
LUX,GBR,2020.0,8,9,-1
SAU,OMN,2019.0,7,4,3
IRL,GBR,2002.0,92,158,-66
KOR,PHL,2019.0,10,2,8
VNM,USA,2019.0,23,54,-31
CHL,EGY,2021.0,1,1,0
BRA,MEX,2019.0,35,28,7
FRA,CHL,2019.0,33,32,1
LUX,DEU,2022.0,7,10,-3
RUS,AUS,2016.0,10,9,1
USA,LKA,2019.0,29,25,4
TUR,FRA,2019.0,17,18,-1
PAK,SAU,2021.0,50,44,6
IND,DEU,2022.0,73,55,18
GBR,OMN,2011.0,7,4,3
TWN,DEU,2021.0,19,14,5
GBR,ARE,2004.0,11,3,8
PHL,SGP,2016.0,7,4,3
ESP,ITA,2022.0,76,103,-27
AZE,IRN,2016.0,4,1,3
TWN,NOR,2019.0,2,1,1
IND,NLD,2017.0,23,37,-14
PER,USA,2014.0,34,36,-2
MEX,CHN,2022.0,6,4,2
ESP,NZL,2017.0,3,3,0
NLD,IRN,2021.0,16,31,-15
CHN,SGP,2004.0,68,76,-8
IRQ,MYS,2022.0,12,39,-27
USA,ESP,2006.0,292,281,11
UKR,RUS,2021.0,28,27,1
CZE,USA,2004.0,39,42,-3
ZAF,IRL,2022.0,5,3,2
DEU,SWE,2010.0,102,106,-4
GBR,JPN,2005.0,106,96,10
COL,CHL,2019.0,33,26,7
VNM,USA,2017.0,24,30,-6
ZAF,CAN,2021.0,23,11,12
SYR,FRA,2017.0,7,4,3
FRA,ARG,2019.0,31,37,-6
NOR,BRA,2015.0,5,8,-3
AUT,POL,2017.0,6,11,-5
DEU,FIN,2022.0,25,25,0
DEU,BRA,2012.0,66,65,1
SWE,CHE,2003.0,21,18,3
ISR,NLD,2015.0,5,11,-6
BEL,COG,2011.0,3,3,0
FRA,SVK,2002.0,6,4,2
KWT,USA,2010.0,7,11,-4
ITA,AUS,2010.0,30,24,6
SVK,GBR,2016.0,4,4,0
MYS,JPN,2008.0,9,36,-27
BRA,PAK,2009.0,1,4,-3
CMR,TZA,2016.0,1,1,0
FRA,RUS,2020.0,49,47,2
ARG,ESP,2015.0,41,82,-41
MEX,ZAF,2016.0,3,1,2
POL,ITA,2009.0,11,16,-5
FRA,IRN,2014.0,26,20,6
GRC,SWE,2011.0,16,4,12
TWN,MYS,2010.0,4,3,1
PRT,USA,2011.0,56,56,0
GBR,RUS,2001.0,20,70,-50
AUS,BEL,2010.0,16,14,2
PAK,FRA,2018.0,11,15,-4
BEL,AUS,2011.0,24,22,2
KOR,SGP,2008.0,15,12,3
ITA,ROU,2010.0,17,6,11
KOR,JPN,2000.0,34,39,-5
LTU,FRA,2009.0,3,4,-1
ZAF,IRN,2020.0,2,5,-3
SGP,DEU,2008.0,13,34,-21
FIN,USA,2012.0,63,69,-6
CRI,USA,2011.0,8,7,1
GBR,CHL,2013.0,25,23,2
AUS,BEL,2019.0,26,48,-22
PAK,OMN,2011.0,4,1,3
FRA,LBN,2019.0,77,45,32
SAU,GBR,2009.0,16,36,-20
COL,BEL,2010.0,2,1,1
CAN,IRL,2012.0,34,32,2
CZE,SWE,2002.0,3,5,-2
DNK,FIN,2014.0,8,13,-5
BEL,GBR,2002.0,62,59,3
RUS,JPN,2003.0,38,38,0
IND,EGY,2013.0,3,2,1
OMN,IND,2014.0,13,18,-5
ITA,IRN,2015.0,10,37,-27
NOR,CHE,2015.0,6,26,-20
SWE,TWN,2021.0,6,4,2
URY,USA,2017.0,16,14,2
COL,CHL,2017.0,25,22,3
CHN,BEL,2013.0,30,35,-5
NLD,RUS,2021.0,8,15,-7
ZAF,HKG,2021.0,4,1,3
ESP,NLD,2000.0,16,10,6
NLD,BRA,2002.0,6,11,-5
USA,BGD,2014.0,23,54,-31
HKG,AUT,2015.0,3,1,2
GRC,DNK,2015.0,8,2,6
CHL,BRA,2008.0,10,12,-2
FRA,DNK,2012.0,21,40,-19
POL,IRL,2013.0,5,11,-6
FRA,BRA,2004.0,55,31,24
ARE,GBR,2013.0,13,32,-19
GRL,DNK,2009.0,4,6,-2
VNM,NGA,2018.0,1,2,-1
HUN,TWN,2015.0,2,2,0
DEU,OMN,2013.0,3,2,1
USA,MYS,2006.0,18,13,5
ITA,FIN,2009.0,12,11,1
GBR,SVN,2003.0,2,2,0
JPN,AUS,2000.0,5,14,-9
BRA,MEX,2017.0,29,20,9
IND,EST,2019.0,5,2,3
SWE,VNM,2019.0,8,1,7
LTU,USA,2018.0,10,5,5
FRA,ZAF,2009.0,22,8,14
ISL,SWE,2004.0,9,7,2
POL,JPN,2017.0,12,7,5
AUS,BEL,2017.0,28,24,4
CHE,THA,2021.0,4,5,-1
JPN,FIN,2019.0,13,8,5
ARG,GBR,1999.0,4,10,-6
LTU,GBR,2018.0,12,7,5
BRA,CHE,2019.0,26,23,3
CAN,EGY,2007.0,16,10,6
CHN,POL,2017.0,9,8,1
VNM,FRA,2021.0,13,27,-14
COL,ECU,2020.0,10,8,2
USA,UGA,2019.0,34,25,9
CHE,PRT,2020.0,8,28,-20
NGA,AUS,2020.0,9,5,4
KOR,AUS,2003.0,9,16,-7
GBR,KOR,2008.0,32,24,8
GBR,VNM,2014.0,19,23,-4
BHR,GBR,2022.0,2,1,1
TWN,MYS,2019.0,8,11,-3
POL,JPN,2010.0,7,12,-5
TUR,KOR,2014.0,3,7,-4
THA,GBR,2013.0,39,67,-28
MYS,QAT,2019.0,10,3,7
IND,NOR,2008.0,8,5,3
ITA,ROU,2017.0,13,12,1
USA,SRB,2019.0,14,14,0
CUB,ESP,2020.0,19,7,12
IDN,SWE,2012.0,1,2,-1
HKG,PHL,2018.0,2,3,-1
IND,ERI,2015.0,3,1,2
THA,FRA,2008.0,10,13,-3
KEN,AUT,2013.0,1,2,-1
JOR,MYS,2014.0,4,9,-5
IRL,NLD,2002.0,7,7,0
CAN,PAK,2013.0,18,20,-2
PAK,AUS,2015.0,24,20,4
JPN,THA,2004.0,49,26,23
ROU,USA,2007.0,16,32,-16
BEL,GBR,2005.0,54,62,-8
HRV,GBR,2014.0,8,4,4
USA,LKA,2010.0,6,10,-4
KEN,NLD,2004.0,6,4,2
ZWE,ZAF,2016.0,16,14,2
YEM,SAU,2015.0,12,2,10
FRA,GEO,2017.0,6,40,-34
GRC,IND,2011.0,1,4,-3
AUS,EGY,2006.0,2,3,-1
GBR,POL,2012.0,98,64,34
CAN,GRC,2020.0,8,14,-6
JPN,FIN,2010.0,15,8,7
ESP,FRA,2003.0,123,122,1
FRA,DZA,2005.0,21,27,-6
POL,UKR,2001.0,10,17,-7
AUT,FRA,2006.0,11,26,-15
URY,USA,2010.0,8,13,-5
ROU,GRC,2007.0,2,3,-1
USA,GHA,2005.0,8,4,4
USA,LUX,2014.0,6,3,3
ITA,ISR,1999.0,7,4,3
FRA,POL,2000.0,13,12,1
BRA,ESP,2004.0,18,20,-2
NLD,ITA,2008.0,45,68,-23
MDA,RUS,2003.0,2,2,0
ESP,BEL,2007.0,17,20,-3
DEU,IRL,2004.0,19,10,9
USA,EGY,1999.0,14,9,5
RUS,UZB,2003.0,5,3,2
PAK,NZL,2012.0,6,3,3
RUS,UKR,2012.0,28,30,-2
SAU,AUS,2009.0,6,5,1
ARG,PRT,2016.0,2,5,-3
TUN,FRA,2001.0,26,32,-6
BEL,TUN,2008.0,4,1,3
ARG,CHE,2002.0,1,2,-1
IRN,CAN,2002.0,21,30,-9
RUS,KAZ,2002.0,7,7,0
SVN,AUT,2021.0,4,9,-5
USA,UGA,2017.0,26,25,1
FRA,PYF,2014.0,11,8,3
UZB,RUS,2013.0,9,4,5
GBR,DNK,2004.0,49,47,2
ETH,KEN,2006.0,4,1,3
RUS,KAZ,2005.0,13,7,6
PRT,GBR,1999.0,7,21,-14
USA,VEN,1999.0,9,8,1
ITA,POL,1998.0,8,3,5
IRL,ITA,2000.0,2,1,1
FRA,AUT,2006.0,26,11,15
ARE,IND,2014.0,8,32,-24
USA,SVK,2000.0,7,12,-5
IRL,NLD,2005.0,10,10,0
JPN,FRA,2001.0,58,54,4
FRA,VEN,2009.0,6,5,1
FRA,LBN,2010.0,33,21,12
POL,AUS,2009.0,13,8,5
CAN,MYS,2002.0,1,2,-1
GRC,MKD,2014.0,2,1,1
BEL,ROU,2002.0,3,6,-3
ZAF,AUS,2009.0,31,9,22
USA,DOM,2020.0,5,2,3
CHL,ARG,2011.0,16,15,1
LBN,SAU,2015.0,4,5,-1
USA,JAM,2006.0,6,5,1
TWN,CHN,1997.0,8,2,6
ITA,HND,2021.0,1,1,0
NLD,GRC,2002.0,4,6,-2
CHE,AUT,2009.0,39,54,-15
URY,CHL,2006.0,3,1,2
USA,UKR,2018.0,14,29,-15
NOR,NLD,2007.0,13,11,2
NLD,IND,2004.0,5,14,-9
CAN,UKR,2003.0,3,7,-4
CAN,KOR,2009.0,32,43,-11
OMN,AUS,2004.0,1,1,0
TWN,VNM,2004.0,1,1,0
NLD,DNK,2015.0,34,24,10
ITA,NZL,2013.0,11,3,8
DEU,NZL,2000.0,6,9,-3
JPN,SDN,2017.0,3,2,1
ESP,NZL,2019.0,8,4,4
MAC,CHN,2009.0,5,11,-6
GBR,KEN,2013.0,16,19,-3
BEL,LBN,2012.0,4,1,3
LKA,JPN,2006.0,1,5,-4
ISR,IND,2001.0,9,10,-1
SAU,OMN,2017.0,2,3,-1
GBR,ETH,2016.0,13,4,9
EGY,IRL,2018.0,4,1,3
IRL,GRC,2012.0,3,1,2
CHL,URY,2015.0,5,5,0
DNK,ESP,2005.0,9,10,-1
EGY,ARE,2016.0,9,10,-1
ROU,CHE,2001.0,2,1,1
NPL,IND,2007.0,15,11,4
DZA,FRA,2011.0,31,95,-64
ARE,IRQ,2010.0,1,2,-1
MYS,DEU,2022.0,2,3,-1
FIN,AUS,2007.0,9,5,4
BEL,TUR,2015.0,4,10,-6
MDG,FRA,2008.0,6,11,-5
EGY,KOR,2008.0,2,2,0
CHE,NZL,2015.0,3,11,-8
NLD,NGA,2008.0,2,1,1
EST,CAN,2012.0,2,1,1
ROU,JPN,2007.0,6,5,1
MEX,PRT,2014.0,3,3,0
ESP,URY,2002.0,8,4,4
MDA,ROU,2020.0,7,1,6
ZMB,GBR,2009.0,3,1,2
GBR,MWI,2012.0,11,11,0
FIN,CAN,2020.0,19,11,8
FIN,SGP,2006.0,5,2,3
ARE,JOR,2017.0,9,12,-3
TUN,CAN,2015.0,10,4,6
UKR,CAN,2010.0,6,3,3
FRA,CHL,2017.0,52,24,28
SVK,CAN,2014.0,5,2,3
ARG,BRA,2015.0,32,23,9
ZAF,ETH,2016.0,7,3,4
COL,CUB,2000.0,2,1,1
KOR,IRN,2019.0,8,19,-11
MYS,PAK,2013.0,18,30,-12
USA,GHA,2002.0,7,7,0
DEU,ALB,2012.0,1,1,0
DEU,ETH,2013.0,7,4,3
BGR,CZE,2017.0,1,2,-1
FRA,ARE,2013.0,5,4,1
SRB,DNK,2012.0,2,2,0
DZA,CAN,2019.0,7,5,2
COG,CMR,2013.0,1,1,0
BEN,FRA,2016.0,8,9,-1
CHE,KOR,2022.0,11,6,5
ISR,ITA,2018.0,13,22,-9
DEU,ECU,2016.0,5,1,4
EST,SWE,2018.0,7,7,0
UKR,CAN,2017.0,5,2,3
FRA,SEN,2008.0,22,22,0
NGA,CHN,2016.0,6,8,-2
CHL,PER,2019.0,9,4,5
MNG,AUT,2018.0,1,1,0
SDN,CHE,2021.0,5,1,4
TWN,KOR,2021.0,14,10,4
CHN,FIN,2014.0,16,16,0
BRA,IND,2012.0,7,6,1
FRA,HKG,2018.0,10,8,2
PAK,IRL,2022.0,4,3,1
CZE,JPN,2022.0,2,4,-2
ITA,BGD,2021.0,5,2,3
NZL,KOR,2021.0,4,3,1
CUB,MEX,2011.0,14,9,5
NLD,COL,2022.0,2,2,0
CHN,RUS,2011.0,6,10,-4
KOR,PHL,2010.0,5,3,2
LBN,ARE,2003.0,1,1,0
AUT,PRT,2003.0,3,3,0
RUS,FRA,2000.0,33,19,14
IND,FRA,2014.0,83,70,13
CHN,BGR,2015.0,1,1,0
NLD,SWE,2006.0,21,25,-4
SAU,ITA,2009.0,1,4,-3
ETH,SWE,2009.0,4,3,1
BRA,MEX,2010.0,13,9,4
AUS,TWN,2003.0,7,9,-2
KOR,DEU,1998.0,5,3,2
UKR,FRA,2006.0,7,5,2
ISL,USA,2016.0,10,13,-3
MEX,POL,2012.0,3,1,2
USA,UGA,2010.0,15,9,6
COL,CHL,2010.0,16,7,9
AUT,CHN,2018.0,22,21,1
CHE,CZE,2020.0,15,22,-7
IND,EST,2017.0,3,3,0
MOZ,USA,2017.0,4,3,1
SDN,IRL,2012.0,1,1,0
COL,BEL,2017.0,5,6,-1
MWI,ZAF,2012.0,4,5,-1
NOR,DEU,2008.0,17,52,-35
NLD,HUN,2005.0,7,4,3
FIN,RUS,2004.0,11,16,-5
MEX,ISR,2012.0,2,1,1
FIN,EGY,2015.0,4,1,3
IRL,BHR,2019.0,1,6,-5
NLD,LTU,2006.0,5,1,4
USA,CRI,2003.0,14,6,8
ESP,KOR,2002.0,2,3,-1
URY,USA,2019.0,11,12,-1
CHN,PHL,2014.0,3,2,1
IND,THA,2008.0,3,4,-1
CHE,NLD,2011.0,43,63,-20
THA,DEU,2008.0,17,23,-6
URY,ARG,2020.0,4,11,-7
ESP,UKR,2001.0,1,2,-1
SWE,ISR,2015.0,3,3,0
TUR,FRA,2017.0,16,25,-9
CHE,TZA,2022.0,2,4,-2
BGR,MKD,2019.0,1,2,-1
CAN,VNM,2022.0,3,3,0
ESP,BOL,2016.0,2,4,-2
GBR,CZE,2020.0,36,43,-7
KAZ,AUT,2019.0,1,1,0
KWT,GBR,2022.0,4,2,2
NOR,DNK,2013.0,21,29,-8
SAU,PAK,2006.0,11,4,7
ESP,JPN,2004.0,9,4,5
HUN,CHE,2016.0,10,12,-2
CHN,POL,2010.0,8,1,7
MKD,USA,2019.0,2,1,1
ZAF,ITA,2021.0,6,6,0
GBR,GMB,2021.0,9,9,0
ISR,ESP,2010.0,8,4,4
AUS,PNG,2020.0,3,4,-1
SEN,BEL,1999.0,1,1,0
CYP,ESP,2013.0,2,4,-2
USA,MMR,2016.0,1,2,-1
THA,PHL,2022.0,1,1,0
ARG,FRA,2009.0,16,16,0
USA,OMN,2004.0,5,7,-2
AUS,AUT,2007.0,9,13,-4
CHL,CUB,2002.0,3,1,2
DEU,PER,2002.0,1,2,-1
AUT,HUN,2000.0,3,5,-2
ESP,NIC,2016.0,1,1,0
KEN,CAN,2014.0,8,8,0
MLI,USA,2018.0,3,2,1
GHA,NLD,2002.0,3,2,1
TUR,FRA,2010.0,10,13,-3
DNK,ESP,2002.0,12,11,1
NLD,BRA,2005.0,19,12,7
FRA,MTQ,2005.0,11,11,0
PAN,CAN,2012.0,1,1,0
IRL,IND,2007.0,3,11,-8
COL,VEN,2006.0,6,2,4
NLD,IDN,2004.0,7,2,5
AUT,JPN,2009.0,7,8,-1
HUN,BEL,2003.0,7,4,3
CUB,BRA,2009.0,8,4,4
FRA,ETH,2003.0,2,2,0
FRA,MTQ,2002.0,7,9,-2
JOR,TWN,2015.0,1,1,0
IDN,MYS,2006.0,4,3,1
MYS,FRA,2005.0,2,1,1
JPN,NZL,2008.0,12,8,4
NGA,ZAF,2003.0,7,9,-2
USA,BWA,2014.0,12,5,7
FRA,GEO,2019.0,11,48,-37
AUT,THA,2008.0,4,1,3
BEL,CZE,2003.0,2,3,-1
USA,TZA,2009.0,9,7,2
POL,RUS,2007.0,6,3,3
KOR,IRN,2017.0,7,20,-13
TUR,AUS,2008.0,5,5,0
BEL,MAR,2014.0,1,3,-2
CZE,FIN,2010.0,7,5,2
DZA,CAN,2010.0,5,3,2
MYS,CAN,2009.0,6,8,-2
QAT,KOR,2017.0,2,2,0
IDN,CAN,2019.0,3,5,-2
MAR,DEU,2007.0,2,6,-4
CMR,DEU,2007.0,5,1,4
ESP,NZL,2010.0,2,2,0
BEL,DNK,2009.0,4,6,-2
NZL,CHL,2015.0,6,4,2
NZL,ARE,2014.0,3,2,1
OMN,EGY,2018.0,4,3,1
MEX,NGA,2011.0,2,1,1
PAK,RUS,2016.0,3,1,2
GBR,HUN,1998.0,4,6,-2
PAK,NPL,2014.0,1,2,-1
AUS,SVN,2012.0,1,2,-1
GHA,NGA,2016.0,3,4,-1
ROU,HUN,2014.0,10,8,2
VEN,ARG,2020.0,11,2,9
IRL,ZAF,2014.0,8,2,6
ARG,CHE,2005.0,4,2,2
RWA,CHN,2018.0,2,3,-1
CHE,ARM,2020.0,1,1,0
SWE,VNM,2017.0,2,2,0
SVN,CHN,2020.0,1,1,0
MAR,NER,2017.0,1,1,0
HUN,ROU,2016.0,5,7,-2
NLD,KEN,2012.0,6,4,2
NGA,PRT,2021.0,1,1,0
IND,ISR,2012.0,17,15,2
CAN,QAT,2009.0,9,1,8
THA,BRN,2018.0,1,1,0
JPN,FIN,2017.0,13,16,-3
LKA,DEU,2015.0,3,1,2
NZL,JPN,2017.0,6,2,4
BRA,CUB,2011.0,4,7,-3
MOZ,USA,2010.0,2,2,0
BEL,ETH,2006.0,1,1,0
ITA,POL,1997.0,2,1,1
VNM,USA,2010.0,9,14,-5
SWE,CZE,2017.0,6,14,-8
THA,NZL,2022.0,2,3,-1
PHL,CHN,2015.0,1,3,-2
SWE,MOZ,2020.0,2,1,1
AUT,POL,2010.0,10,10,0
GRC,JPN,2021.0,1,1,0
GBR,URY,2019.0,2,3,-1
CHN,IRN,2014.0,6,14,-8
COL,ZAF,2007.0,3,1,2
IND,PAK,2014.0,24,23,1
GBR,ZAF,1997.0,5,3,2
GBR,UGA,2002.0,3,5,-2
HUN,AUS,2003.0,2,2,0
PAK,SWE,2013.0,4,9,-5
TWN,MYS,2017.0,2,11,-9
GRC,NOR,2014.0,6,3,3
DNK,ITA,2016.0,19,43,-24
PRT,CPV,2019.0,2,2,0
KOR,CYP,2018.0,1,1,0
ESP,VEN,2018.0,9,22,-13
ARE,PRT,2017.0,1,3,-2
ETH,NLD,2016.0,2,9,-7
SDN,USA,2011.0,1,1,0
MYS,GHA,2014.0,2,1,1
GIN,SEN,2019.0,2,1,1
SEN,BFA,2018.0,2,2,0
CZE,SGP,2019.0,1,3,-2
CIV,DEU,2016.0,1,2,-1
SWE,VNM,2010.0,4,2,2
JPN,UZB,2018.0,1,2,-1
FRA,COD,2020.0,1,3,-2
DEU,PSE,2021.0,4,1,3
IND,NGA,2020.0,8,3,5
GEO,NLD,2018.0,1,2,-1
PSE,HKG,2021.0,1,1,0
CAN,LKA,2016.0,1,1,0
GBR,BGD,2022.0,6,15,-9
SWZ,ZAF,2022.0,3,3,0
NZL,TUR,2012.0,2,3,-1
CHN,CUB,2020.0,2,2,0
ISR,ESP,2017.0,6,10,-4
SWE,UKR,2004.0,2,5,-3
AUS,IDN,2006.0,13,3,10
ZAF,BWA,2001.0,1,4,-3
IRN,OMN,2013.0,2,1,1
EST,USA,2002.0,4,5,-1
CZE,NLD,2011.0,8,6,2
ESP,GRC,2006.0,8,5,3
TUR,NOR,2001.0,1,4,-3
CAN,PER,2014.0,2,1,1
POL,SVK,2018.0,5,11,-6
FIN,GRC,2014.0,2,4,-2
RUS,AUT,2000.0,7,2,5
ITA,CUB,2001.0,1,7,-6
ITA,NOR,2003.0,9,7,2
RUS,BRA,1998.0,3,8,-5
DEU,MDA,2006.0,2,3,-1
MAR,MEX,2011.0,1,3,-2
ITA,CZE,2009.0,5,7,-2
IND,IRL,2011.0,8,9,-1
GBR,HUN,1997.0,4,3,1
ISR,ESP,2019.0,8,8,0
IDN,ZWE,2002.0,2,1,1
TZA,GBR,2014.0,5,13,-8
PRI,IND,2008.0,4,3,1
NLD,HUN,2002.0,6,8,-2
JPN,PRT,2002.0,2,9,-7
KOR,NLD,2007.0,6,6,0
JPN,COL,2015.0,2,2,0
JPN,AUT,2000.0,2,4,-2
IND,HUN,2012.0,2,4,-2
CHN,KEN,2004.0,2,1,1
MEX,URY,2009.0,2,1,1
CYP,ITA,2014.0,2,3,-1
GTM,MEX,2018.0,4,3,1
IRL,FIN,2006.0,2,2,0
ISR,CHN,1998.0,1,1,0
SWE,MYS,2021.0,1,2,-1
PHL,AUT,2014.0,1,1,0
CHN,CZE,2015.0,4,4,0
NOR,THA,2021.0,1,1,0
GHA,JPN,2003.0,1,2,-1
NGA,KEN,2015.0,2,3,-1
DNK,SGP,2012.0,5,6,-1
IRL,BHR,2017.0,2,3,-1
GBR,CUB,2020.0,1,1,0
ARE,CHE,2022.0,1,1,0
CAN,IDN,2012.0,6,2,4
KEN,NGA,2020.0,4,3,1
PAK,TZA,2021.0,3,2,1
ESP,URY,2005.0,1,6,-5
SRB,ITA,2003.0,2,2,0
BEL,ECU,2020.0,4,6,-2
ITA,SGP,2022.0,1,5,-4
CHL,NZL,2020.0,6,1,5
SDN,CHN,2015.0,4,5,-1
CHE,LTU,2020.0,2,1,1
MYS,QAT,2017.0,3,3,0
CZE,EGY,2018.0,2,1,1
GBR,URY,2017.0,3,2,1
SYR,FRA,2010.0,1,9,-8
IRL,TWN,2013.0,1,3,-2
UZB,DEU,2012.0,3,1,2
LVA,DEU,2006.0,3,2,1
KOR,PRT,2012.0,3,2,1
ISL,GBR,2006.0,7,6,1
THA,NLD,2012.0,3,9,-6
DZA,USA,2008.0,2,4,-2
PRT,JPN,2020.0,2,5,-3
ARG,CHL,1999.0,3,1,2
CZE,CHE,2000.0,2,4,-2
CHE,MEX,2007.0,4,4,0
BRA,BOL,2018.0,1,1,0
ITA,LBN,2013.0,2,2,0
CMR,NLD,2018.0,2,1,1
AUS,TUR,2018.0,12,16,-4
GRC,ROU,2007.0,3,2,1
DEU,MYS,2022.0,3,2,1
DZA,CAN,2017.0,6,3,3
DNK,GNB,2020.0,3,1,2
GUM,USA,2016.0,3,6,-3
IND,BGD,2021.0,13,13,0
MAR,CMR,2016.0,2,3,-1
IRN,EGY,2015.0,2,1,1
RUS,SVK,2016.0,3,1,2
JOR,CYP,2020.0,2,1,1
NZL,ITA,2009.0,3,6,-3
LBN,ITA,2021.0,3,1,2
BEL,MEX,2021.0,4,6,-2
KOR,NPL,2009.0,2,2,0
KEN,SWE,2011.0,1,1,0
SYC,AUS,2018.0,1,1,0
LAO,JPN,2018.0,1,4,-3
NLD,BGD,2018.0,3,3,0
RUS,BGR,2020.0,5,2,3
PAK,EGY,2017.0,1,5,-4
DNK,CHL,2012.0,1,1,0
NLD,HRV,2022.0,4,1,3
NOR,TUR,2015.0,2,1,1
RUS,VEN,2009.0,1,1,0
BEL,EST,2004.0,1,1,0
YEM,DEU,2011.0,1,2,-1
THA,LKA,2004.0,1,1,0
IND,HKG,2013.0,7,7,0
BGR,TUR,2016.0,1,1,0
BIH,CHE,2015.0,1,1,0
PAK,CHE,2016.0,2,2,0
NZL,ARG,2016.0,1,1,0
PHL,SWE,2017.0,2,1,1
CZE,SGP,2017.0,2,1,1
MAR,GBR,2021.0,3,2,1
CIV,MLI,2017.0,2,2,0
SWE,TUR,2009.0,3,8,-5
CHL,VEN,2019.0,3,18,-15
IRN,POL,2012.0,5,1,4
ARE,USA,2007.0,9,23,-14
BEL,TWN,2020.0,3,3,0
HKG,EGY,2021.0,2,2,0
VNM,CHE,2020.0,1,7,-6
ETH,AUT,2018.0,3,4,-1
SAU,TUN,2011.0,4,23,-19
CAN,GHA,2019.0,7,9,-2
BRA,AUT,2007.0,2,3,-1
DEU,MLI,2007.0,1,1,0
LIE,DEU,2006.0,3,2,1
ISR,POL,2012.0,4,3,1
PSE,EGY,2006.0,2,6,-4
BEL,ROU,2005.0,3,8,-5
UKR,CZE,2011.0,1,1,0
DNK,BRA,2004.0,2,3,-1
BLR,UKR,2015.0,3,2,1
FIN,NLD,2000.0,1,3,-2
UKR,BRA,2004.0,1,2,-1
DNK,PRT,2016.0,4,13,-9
USA,FJI,2013.0,3,2,1
BRA,NGA,2014.0,3,3,0
MAC,PRT,2018.0,1,1,0
HND,USA,2014.0,3,2,1
JPN,TJK,2015.0,1,1,0
BGR,MKD,2017.0,4,1,3
CHE,LUX,2007.0,1,1,0
THA,BGD,2014.0,3,3,0
GRC,ESP,2022.0,1,6,-5
THA,CHL,2021.0,1,1,0
VEN,MEX,2003.0,2,4,-2
ARG,MEX,1998.0,2,2,0
SVN,IND,2014.0,1,1,0
SDN,ARE,2020.0,3,2,1
SRB,CHE,2007.0,3,2,1
ISR,HKG,2017.0,3,1,2
CAN,MYS,2005.0,1,5,-4
ISR,HKG,2010.0,1,1,0
JPN,PHL,1999.0,2,1,1
BEL,JPN,1998.0,4,2,2
GEO,TUR,2016.0,1,1,0
GBR,PAN,2010.0,2,1,1
GBR,LSO,2008.0,1,1,0
MEX,BEL,2003.0,1,6,-5
HRV,AUS,2008.0,1,1,0
ISR,KOR,2009.0,1,2,-1
BEL,BFA,2008.0,1,2,-1
USA,MCO,2019.0,1,1,0
IDN,AUT,2011.0,2,2,0
MAR,PRT,2010.0,1,2,-1
CHL,CUB,2005.0,1,2,-1
DNK,THA,2009.0,1,1,0
BRA,ZAF,2022.0,2,4,-2
MWI,CHE,2018.0,3,2,1
THA,MYS,2015.0,3,4,-1
IRQ,CHN,2022.0,2,3,-1
SVN,ITA,2005.0,2,2,0
NGA,TUR,2015.0,2,2,0
CHL,VEN,2017.0,2,15,-13
DOM,ESP,2020.0,2,3,-1
ZAF,UGA,2008.0,1,2,-1
GBR,BHR,2003.0,2,2,0
OMN,NGA,2014.0,1,1,0
CUB,PRT,2013.0,2,1,1
BGR,NLD,2014.0,2,2,0
AFG,GBR,2017.0,2,2,0
MEX,EGY,2015.0,2,1,1
KOR,FIN,2008.0,1,2,-1
KOR,TWN,2022.0,2,10,-8
COG,FRA,1998.0,1,3,-2
BFA,USA,2021.0,1,1,0
KOR,ESP,2004.0,2,2,0
KGZ,RUS,2013.0,1,1,0
IRN,AUT,2004.0,3,1,2
BEL,CHL,2011.0,7,3,4
KOR,UZB,2008.0,1,2,-1
TUR,NZL,2000.0,1,1,0
CAN,PAN,2008.0,1,2,-1
BWA,GBR,2016.0,3,5,-2
BFA,SEN,2006.0,1,1,0
PER,GBR,2012.0,4,1,3
AUT,ARG,2011.0,1,1,0
DNK,UGA,2017.0,1,1,0
NGA,NER,2015.0,2,1,1
KEN,IDN,2011.0,2,1,1
BRA,TUR,2014.0,1,2,-1
KEN,GHA,2013.0,2,1,1
JPN,MEX,2013.0,4,5,-1
QAT,SWE,2014.0,1,1,0
VNM,AUT,2009.0,1,2,-1
GHA,FRA,2021.0,2,1,1
CAN,GHA,2017.0,3,8,-5
CAN,ETH,2020.0,1,3,-2
KEN,RWA,2022.0,1,1,0
KEN,TZA,2011.0,1,3,-2
HRV,AUT,1999.0,3,4,-1
NOR,CYP,2018.0,1,2,-1
SVN,ITA,2002.0,2,6,-4
NLD,TWN,2008.0,2,1,1
AUT,ZAF,2004.0,1,2,-1
MYS,DNK,2010.0,1,1,0
PRT,IRN,2015.0,1,17,-16
SWE,CZE,2010.0,3,3,0
PRY,ESP,2000.0,1,1,0
ZAF,ESP,2018.0,2,12,-10
VNM,ITA,2013.0,1,2,-1
CHE,QAT,2020.0,1,1,0
CHN,DZA,2011.0,2,1,1
KHM,MDG,2007.0,1,1,0
LVA,DNK,2017.0,1,1,0
AZE,RUS,2005.0,1,3,-2
MOZ,USA,2019.0,1,2,-1
IRQ,SAU,2020.0,1,6,-5
GMB,USA,2009.0,1,2,-1
BRA,NOR,2003.0,1,2,-1
ARM,BRA,2016.0,1,1,0
CRI,CAN,2022.0,1,2,-1
DEU,LVA,2006.0,2,3,-1
NZL,IND,2008.0,2,9,-7
AUT,CYP,2010.0,1,1,0
SAU,SWE,2020.0,6,9,-3
CHL,VNM,2016.0,1,1,0
NPL,MYS,2020.0,2,1,1
NCL,USA,2013.0,1,2,-1
CHL,CHE,2008.0,1,2,-1
IRL,CAN,1998.0,2,4,-2
GBR,UGA,2005.0,4,12,-8
IRL,KOR,2022.0,2,2,0
FRA,KEN,2017.0,3,1,2
TWN,NLD,2008.0,1,2,-1
YEM,GBR,2004.0,1,2,-1
GRC,NLD,1998.0,1,1,0
NLD,ZMB,2019.0,2,1,1
CHL,BEL,2008.0,2,4,-2
ARE,NOR,2022.0,1,2,-1
MEX,AUS,2004.0,1,2,-1
LVA,USA,2009.0,1,3,-2
ARE,IRQ,2019.0,1,1,0
COL,DNK,2011.0,1,1,0
ARM,NLD,2001.0,1,1,0
TUR,SAU,2005.0,1,3,-2
GBR,FLK,2013.0,2,1,1
LBN,EGY,2007.0,1,2,-1
ZMB,NLD,2016.0,1,1,0
JPN,MNG,2003.0,2,1,1
IND,FIN,2004.0,1,1,0
THA,CHE,2006.0,1,2,-1
NZL,LKA,2019.0,4,4,0
NOR,SAU,2022.0,1,2,-1
BTN,USA,2018.0,1,1,0
ARE,PRT,2019.0,1,4,-3
JOR,TUR,2020.0,1,4,-3
COL,BEL,2019.0,2,7,-5
EGY,PSE,2021.0,2,10,-8
ERI,IND,2015.0,1,3,-2
NZL,BGD,2006.0,1,1,0
ARG,ISR,2018.0,1,1,0
CAN,BHS,2017.0,1,1,0
HKG,NOR,2021.0,1,1,0
SAU,VNM,2019.0,1,1,0
RUS,HKG,2017.0,1,2,-1
KEN,BRA,2006.0,1,1,0
DOM,USA,2007.0,1,1,0
ZAF,DNK,2003.0,1,1,0
GBR,GHA,2001.0,1,2,-1
PHL,MYS,2013.0,1,1,0
EGY,BHR,2018.0,2,1,1
JPN,PRY,2011.0,1,1,0
FRA,SVK,2005.0,1,6,-5
ESP,ECU,2009.0,1,3,-2
ETH,ISR,2015.0,1,1,0
YEM,EGY,2009.0,1,5,-4
MEX,CRI,2009.0,1,3,-2
ZAF,PAK,2009.0,1,1,0
ZAF,FIN,2022.0,1,1,0
NGA,FRA,2021.0,1,1,0
BRB,FRA,2019.0,1,1,0
CHE,LKA,2020.0,1,3,-2
ARG,VEN,2002.0,1,2,-1
NOR,SGP,2005.0,1,2,-1
CHL,VEN,2010.0,1,3,-2
ISR,HKG,2019.0,1,3,-2
ETH,RWA,2020.0,1,1,0
KOR,COL,2019.0,1,1,0
FRA,CAN,2015.0,350,212,138
USA,NLD,2014.0,318,355,-37
IRN,AUS,2008.0,22,24,-2
AUT,TUR,2009.0,3,3,0
GBR,PRT,2009.0,54,53,1
ZAF,SWZ,2012.0,2,9,-7
USA,AUS,2004.0,386,424,-38
JPN,MYS,2009.0,46,11,35
USA,IND,2021.0,528,921,-393
AUS,GBR,2008.0,404,498,-94
SGP,CHN,2022.0,260,163,97
GBR,URY,2010.0,1,1,0
CHE,IRL,2006.0,10,5,5
NLD,CHE,2015.0,85,66,19
GBR,TUR,2011.0,33,37,-4
GBR,HKG,2020.0,73,68,5
ISR,CAN,2004.0,53,27,26
CAN,ISR,2007.0,27,44,-17
JPN,POL,2020.0,9,6,3
IND,SAU,2013.0,100,19,81
PHL,USA,2014.0,27,21,6
CHN,JPN,2004.0,176,331,-155
FRA,PAK,2020.0,14,9,5
GBR,JPN,2002.0,125,111,14
IND,GBR,2019.0,274,171,103
CHE,TWN,2018.0,11,11,0
USA,LKA,2017.0,30,13,17
ITA,IND,2013.0,38,45,-7
GRC,CHE,2013.0,32,11,21
KOR,BEL,2018.0,14,8,6
PRT,CHN,2006.0,7,1,6
JPN,VNM,2020.0,92,18,74
KWT,USA,2017.0,10,30,-20
ZAF,BEL,2018.0,16,9,7
IND,SVN,2016.0,2,1,1
ARE,AUS,2006.0,5,5,0
USA,SRB,2017.0,10,22,-12
GBR,PAN,2019.0,5,2,3
NZL,JPN,2019.0,9,9,0
ROU,CAN,2018.0,5,2,3
BGD,IND,2006.0,4,8,-4
NLD,IRL,2020.0,20,19,1
EST,ESP,2020.0,4,4,0
KAZ,SWE,2017.0,3,1,2
FRA,CHL,2010.0,24,20,4
MEX,SWE,2012.0,9,3,6
LBY,GBR,2007.0,3,6,-3
AUS,DEU,1999.0,22,36,-14
CHN,MAC,2022.0,67,88,-21
NZL,DEU,2008.0,21,29,-8
ESP,CHE,2006.0,27,31,-4
BRA,FRA,2006.0,52,66,-14
IND,TWN,2006.0,43,13,30
GTM,USA,2022.0,4,6,-2
KWT,USA,2019.0,14,26,-12
CZE,BEL,2014.0,6,9,-3
GRC,POL,2008.0,1,1,0
CZE,FIN,2017.0,3,4,-1
TUR,ITA,2011.0,9,5,4
ITA,ARG,2004.0,9,20,-11
TUR,GBR,2014.0,38,48,-10
PER,ESP,2006.0,6,2,4
BGR,GBR,2015.0,7,3,4
FRA,ARG,2010.0,18,28,-10
POL,ESP,2001.0,8,6,2
SRB,BIH,2007.0,14,13,1
EGY,SAU,2003.0,35,29,6
AUT,AUS,2008.0,16,17,-1
KEN,DEU,2012.0,8,9,-1
CHE,UKR,1999.0,1,3,-2
SWE,ESP,2004.0,22,15,7
BGD,USA,2006.0,7,8,-1
GBR,ZAF,1998.0,7,4,3
CHN,VNM,2012.0,4,2,2
JPN,PRT,2005.0,1,1,0
ITA,BGR,2003.0,7,5,2
FRA,PRT,2009.0,32,28,4
TUN,ITA,2011.0,4,1,3
HUN,FIN,2012.0,4,6,-2
BRA,CHE,2017.0,26,14,12
PAK,ESP,2014.0,4,4,0
NOR,FRA,2016.0,9,40,-31
TUR,IND,2011.0,2,3,-1
FRA,DZA,2002.0,26,24,2
PRT,COL,2014.0,3,2,1
CHN,NGA,2014.0,10,7,3
TZA,DNK,2013.0,3,3,0
POL,JPN,2019.0,8,9,-1
CHN,NAM,2016.0,1,1,0
SWE,GRC,2016.0,7,22,-15
ZWE,AUS,2008.0,1,1,0
FRA,KOR,2006.0,19,9,10
REU,FRA,2014.0,17,5,12
DEU,SYR,2008.0,2,1,1
RUS,KOR,2016.0,4,4,0
PAK,EGY,2010.0,3,1,2
ESP,AUT,2008.0,15,17,-2
MEX,DEU,1999.0,4,11,-7
DNK,KOR,2015.0,3,11,-8
AUT,POL,2019.0,8,11,-3
KAZ,AZE,2021.0,1,1,0
USA,LTU,2014.0,6,4,2
BLR,USA,2012.0,5,1,4
LKA,SWE,1998.0,1,1,0
SYR,FRA,2019.0,4,6,-2
RUS,SAU,2018.0,3,3,0
LVA,LTU,2017.0,2,3,-1
DEU,PRY,2020.0,2,1,1
BRA,ECU,2014.0,3,2,1
BOL,PER,2020.0,1,2,-1
SWE,NZL,2013.0,5,16,-11
POL,BEL,2003.0,9,8,1
USA,SEN,2004.0,1,1,0
USA,CIV,2003.0,1,1,0
BRA,CZE,2000.0,1,1,0
CHN,CHL,2020.0,6,6,0
ROU,CZE,2008.0,3,1,2
DZA,TUR,2016.0,2,1,1
TJK,CHN,2019.0,3,1,2
PHL,DEU,1998.0,1,2,-1
RUS,IRL,2015.0,3,3,0
SAU,JOR,2003.0,3,2,1
SEN,GIN,2007.0,2,1,1
TUR,TWN,2018.0,7,1,6
AUT,SVK,2014.0,8,9,-1
ARE,BRN,2016.0,1,1,0
TUR,SWE,2004.0,1,4,-3
USA,ZWE,2009.0,2,7,-5
MOZ,GBR,2019.0,1,2,-1
PSE,MYS,2013.0,1,5,-4
BEL,BGR,1999.0,2,1,1
FRA,LTU,2003.0,3,2,1
HKG,SWE,2000.0,1,1,0
FRA,ZWE,2007.0,1,1,0
DEU,GEO,2015.0,2,5,-3
NLD,LUX,2014.0,4,2,2
NZL,LKA,2017.0,4,1,3
IRL,ARE,2022.0,2,1,1
MYS,DNK,2019.0,1,2,-1
SGP,IRL,2014.0,8,5,3
CIV,MLI,2010.0,2,2,0
NZL,WSM,2021.0,1,2,-1
AUS,TZA,2019.0,1,2,-1
SWE,SRB,2003.0,1,2,-1
PHL,FRA,2004.0,1,2,-1
CZE,SWE,2005.0,1,10,-9
DNK,UKR,2004.0,1,2,-1
JPN,SVN,2019.0,1,2,-1
OMN,ARE,2002.0,1,5,-4
DEU,BOL,2015.0,1,2,-1
ALB,TUR,2015.0,1,3,-2
KOR,FRA,2003.0,1,6,-5
CPV,PRT,2020.0,1,1,0
QAT,JOR,2007.0,1,2,-1
GBR,PAN,2017.0,1,1,0
FRA,KEN,2019.0,1,3,-2
USA,GUY,2015.0,1,1,0
CAN,GMB,2018.0,1,1,0
THA,SAU,2020.0,1,1,0
PRY,MEX,2015.0,1,1,0
HKG,NGA,2018.0,1,3,-2
BRA,,2012.0,5821,0,5821
,DEU,2003.0,20096,0,20096
,TUR,2001.0,6034,0,6034
,ITA,2003.0,13027,0,13027
,CRI,2004.0,82,0,82
,KOR,2005.0,11360,0,11360
ISR,,2023.0,10410,0,10410
SVN,,2021.0,865,0,865
IRN,,2016.0,3932,0,3932
,KOR,2002.0,9375,0,9375
IRL,,2023.0,6128,0,6128
GBR,,2001.0,705,0,705
CHE,,2008.0,1796,0,1796
,ROU,1999.0,1157,0,1157
HUN,,2014.0,854,0,854
,GBR,2013.0,20563,0,20563
,PRT,2009.0,2969,0,2969
,GRD,2007.0,14,0,14
,ARG,1994.0,1597,0,1597
,LAO,1999.0,8,0,8
LAO,,2008.0,6,0,6
TUN,,2008.0,230,0,230
CRI,,2024.0,642,0,642
BEL,,2004.0,754,0,754
,POL,1995.0,2997,0,2997
,OMN,2006.0,99,0,99
SAU,,2014.0,435,0,435
,YEM,2002.0,22,0,22
PHL,,2013.0,118,0,118
,PHL,2002.0,176,0,176
LBN,,2018.0,212,0,212
EST,,2021.0,483,0,483
,MWI,2004.0,48,0,48
RUS,,2001.0,774,0,774
,VNM,2002.0,187,0,187
KEN,,2021.0,599,0,599
NPL,AUT,2013.0,1,0,1
KWT,,2011.0,150,0,150
,ECU,2004.0,77,0,77
,LBN,2007.0,222,0,222
BWA,,2017.0,51,0,51
SVK,SWE,2011.0,3,0,3
,TUN,2012.0,1356,0,1356
,KWT,2001.0,132,0,132
PER,,2014.0,149,0,149
,BIH,2008.0,220,0,220
JOR,,2021.0,493,0,493
,THA,2015.0,2596,0,2596
,KEN,2003.0,258,0,258
ARM,CHE,2012.0,3,0,3
LUX,,2009.0,25,0,25
,ISR,2011.0,2344,0,2344
,HKG,2011.0,1733,0,1733
,ZAF,2010.0,2123,0,2123
,BGD,2011.0,863,0,863
KOR,CZE,2014.0,4,0,4
,VEN,2001.0,532,0,532
VEN,,2007.0,209,0,209
,AZE,2015.0,184,0,184
CHL,,2018.0,1385,0,1385
,ZAF,2017.0,2457,0,2457
UKR,CHN,2009.0,1,0,1
BGD,,2020.0,588,0,588
,MLT,2010.0,86,0,86
,ZMB,2011.0,71,0,71
,ISL,2011.0,119,0,119
SDN,,2024.0,432,0,432
,CHE,2018.0,3797,0,3797
,MNG,2015.0,99,0,99
PNG,,2024.0,106,0,106
IND,TUR,2014.0,4,0,4
YEM,,2023.0,143,0,143
ARM,,2015.0,104,0,104
,LTU,2018.0,491,0,491
MYS,DNK,2017.0,6,0,6
,STP,2012.0,1,0,1
SWZ,,2019.0,8,0,8
,MTQ,1998.0,12,0,12
,PHL,2005.0,222,0,222
,VNM,2005.0,236,0,236
,MDG,2012.0,61,0,61
,CYP,2014.0,186,0,186
,MLT,2017.0,79,0,79
MNE,,2021.0,76,0,76
,TCD,2014.0,10,0,10
,MDA,2013.0,37,0,37
,TZA,2007.0,135,0,135
,LBY,2015.0,30,0,30
NLD,NPL,2018.0,2,0,2
CRI,NOR,2012.0,1,0,1
NIC,,2024.0,47,0,47
AZE,KAZ,2014.0,5,0,5
NPL,BEL,2021.0,1,0,1
,SEN,2016.0,92,0,92
RUS,HKG,2019.0,5,0,5
,SLE,2016.0,23,0,23
,PER,2000.0,151,0,151
,UGA,2018.0,370,0,370
,PRI,2000.0,126,0,126
,ZAF,2019.0,1214,0,1214
,GUF,2019.0,8,0,8
,EGY,2008.0,2799,0,2799
FIN,,2005.0,648,0,648
,MLI,2012.0,43,0,43
FIN,,2002.0,165,0,165
,BHR,1999.0,43,0,43
,YEM,2005.0,24,0,24
SAU,OMN,2010.0,4,0,4
ZWE,,2011.0,26,0,26
POL,,2001.0,120,0,120
,ARM,2007.0,144,0,144
CHE,ARG,2007.0,2,0,2
CMR,,2004.0,9,0,9
POL,GHA,2018.0,1,0,1
KOR,ZWE,2018.0,3,0,3
FRA,SYR,2004.0,2,0,2
KAZ,POL,2015.0,1,0,1
TTO,GRD,2018.0,1,0,1
IDN,,2006.0,32,0,32
AUS,KAZ,2009.0,1,0,1
IRL,SAU,2014.0,5,0,5
FSM,,2022.0,7,0,7
SWZ,CAN,2002.0,1,0,1
CMR,CAN,2005.0,1,0,1
CHN,RWA,2020.0,5,0,5
NOR,ETH,2022.0,2,0,2
BHS,,2019.0,8,0,8
,ARE,2000.0,102,0,102
,GMB,2001.0,23,0,23
USA,QAT,2004.0,7,0,7
MNG,,2005.0,5,0,5
,BWA,1997.0,28,0,28
,MOZ,2001.0,16,0,16
MWI,,2013.0,34,0,34
NER,,2014.0,8,0,8
BWA,,2019.0,64,0,64
MWI,SWE,2008.0,1,0,1
,SDN,2001.0,44,0,44
ITA,ALB,2009.0,4,0,4
TZA,SWZ,2015.0,1,0,1
BWA,,2010.0,22,0,22
,GAB,1999.0,18,0,18
MNG,,2002.0,2,0,2
ITA,BWA,2016.0,2,0,2
SEN,MAR,2001.0,2,0,2
,CRI,1996.0,34,0,34
ETH,,2005.0,23,0,23
BEN,,2011.0,17,0,17
,MTQ,1997.0,9,0,9
UKR,CHL,2000.0,1,0,1
BLR,CZE,2012.0,2,0,2
NGA,DEU,1998.0,3,0,3
UKR,PRT,2003.0,1,0,1
HUN,EST,2008.0,1,0,1
FRA,KWT,2009.0,1,0,1
TUR,SAU,2002.0,4,0,4
POL,TUR,2009.0,2,0,2
LSO,ITA,2006.0,1,0,1
BFA,KEN,1998.0,1,0,1
BMU,,2023.0,10,0,10
TZA,ESP,2004.0,1,0,1
GIB,,2022.0,2,0,2
COL,ZWE,2009.0,1,0,1
AZE,,2004.0,15,0,15
ROU,DNK,1998.0,1,0,1
SGP,NOR,2006.0,4,0,4
IRL,BHR,2010.0,1,0,1
CZE,SGP,2010.0,2,0,2
NIC,DNK,1999.0,1,0,1
BEL,FIN,1997.0,2,0,2
MOZ,DNK,2014.0,1,0,1
RUS,BRA,1997.0,7,0,7
NZL,TWN,2002.0,4,0,4
GBR,AZE,2005.0,1,0,1
TUN,EGY,2002.0,1,0,1
KEN,HKG,2015.0,1,0,1
GMB,DEU,2002.0,3,0,3
POL,ROU,2005.0,2,0,2
CUB,PER,2003.0,2,0,2
BFA,CAN,2009.0,2,0,2
DEU,AZE,2012.0,1,0,1
ESP,KOR,2005.0,2,0,2
ZAF,MEX,2009.0,1,0,1
TUR,BHR,2013.0,1,0,1
RUS,PHL,2019.0,3,0,3
LTU,AUS,2013.0,1,0,1
JPN,SVN,2010.0,3,0,3
VNM,PER,2020.0,3,0,3
JPN,SDN,2010.0,3,0,3
FIN,OMN,2016.0,1,0,1
CAN,CIV,2018.0,3,0,3
FRA,MUS,2020.0,1,0,1
,HND,2011.0,16,0,16
IDN,PHL,2016.0,1,0,1
AZE,GBR,2017.0,1,0,1
,NIC,2016.0,16,0,16
,MLT,2019.0,46,0,46
CMR,BRB,2014.0,1,0,1
,BEN,1995.0,13,0,13
GBR,ECU,2003.0,3,0,3
KEN,PHL,2003.0,2,0,2
FIN,BEN,2010.0,1,0,1
UGA,FIN,2009.0,1,0,1
ZWE,IND,2015.0,1,0,1
IRL,JAM,2013.0,1,0,1
IRL,MYS,2004.0,3,0,3
ROU,KWT,2021.0,1,0,1
HRV,,2004.0,118,0,118
FJI,CHN,2009.0,1,0,1
CIV,ZAF,2003.0,1,0,1
,BWA,1998.0,67,0,67
CAN,PSE,2018.0,3,0,3
ECU,AUS,2008.0,1,0,1
IRL,CAN,1997.0,3,0,3
SWZ,,2017.0,7,0,7
CHN,MNG,2004.0,1,0,1
VNM,LAO,2021.0,1,0,1
NOR,PAK,2015.0,6,0,6
BGR,CZE,2010.0,2,0,2
CMR,CIV,2007.0,1,0,1
,BHS,2001.0,3,0,3
ARG,CZE,2005.0,1,0,1
OMN,BGR,2014.0,1,0,1
LBN,HUN,2002.0,1,0,1
BWA,SWZ,2008.0,1,0,1
CYP,,2003.0,7,0,7
CHL,SRB,2004.0,2,0,2
BGR,,2025.0,5,0,5
,GNQ,2004.0,2,0,2
SGP,SAU,1999.0,1,0,1
ARG,VEN,2005.0,4,0,4
NCL,,2006.0,3,0,3
ESP,IRN,2003.0,2,0,2
OMN,QAT,2014.0,2,0,2
FIN,PER,2003.0,1,0,1
MEX,NIC,2013.0,1,0,1
IND,RWA,2008.0,1,0,1
PAK,FIN,2014.0,2,0,2
PNG,SLB,2005.0,1,0,1
FRA,TCD,2005.0,1,0,1
PYF,NCL,2005.0,2,0,2
MYS,FRA,2002.0,3,0,3
,AFG,2011.0,6,0,6
SAU,VNM,2017.0,1,0,1
MNE,BIH,2018.0,1,0,1
JAM,USA,1999.0,1,0,1
BHR,ZAF,2015.0,1,0,1
BLR,GBR,2022.0,1,0,1
TUN,SAU,2007.0,5,0,5
MYS,CZE,2012.0,1,0,1
JOR,IND,2015.0,1,0,1
USA,MCO,2017.0,1,0,1
BHS,,2017.0,4,0,4
UZB,JPN,2000.0,1,0,1
,GUF,2017.0,11,0,11
,BTN,2001.0,2,0,2
RUS,VNM,2009.0,1,0,1
NOR,BWA,2012.0,2,0,2
LVA,POL,2014.0,1,0,1
ZAF,EST,2010.0,1,0,1
MYS,MLT,2021.0,1,0,1
HRV,BRA,2007.0,2,0,2
HKG,SRB,2006.0,2,0,2
PER,CUB,2009.0,1,0,1
USA,MAC,2006.0,5,0,5
HUN,BRA,2012.0,1,0,1
,AGO,2009.0,11,0,11
GRC,TUR,2014.0,8,0,8
,GUF,2010.0,14,0,14
HKG,TUN,2018.0,1,0,1
POL,HRV,2015.0,5,0,5
EGY,ALB,2019.0,1,0,1
PRT,CPV,2017.0,1,0,1
HND,MEX,2020.0,1,0,1
,BRB,2014.0,9,0,9
MEX,PRI,2021.0,1,0,1
ESP,COG,2019.0,1,0,1
EGY,ZAF,2008.0,1,0,1
MAR,NER,2019.0,1,0,1
SWE,JOR,2008.0,1,0,1
NGA,ISR,2007.0,1,0,1
,MWI,1996.0,11,0,11
BRA,ARE,2011.0,1,0,1
NAM,CAN,2006.0,1,0,1
MAR,DZA,2001.0,1,0,1
DEU,KWT,2004.0,3,0,3
TWN,POL,2004.0,2,0,2
GBR,CIV,2018.0,2,0,2
GRC,OMN,2012.0,2,0,2
,MRT,1998.0,2,0,2
BGR,NZL,1999.0,1,0,1
NPL,CAN,2004.0,2,0,2
PHL,SYR,2012.0,1,0,1
GRC,PRT,2001.0,1,0,1
ISR,UZB,2022.0,1,0,1
ETH,,2002.0,5,0,5
AUT,MCO,2012.0,1,0,1
POL,CHL,2007.0,1,0,1
GRC,SRB,2000.0,1,0,1
SGP,FIN,2016.0,3,0,3
AUT,PER,2002.0,1,0,1
PRI,AFG,2006.0,1,0,1
SVN,DZA,2015.0,1,0,1
LKA,UZB,2010.0,1,0,1
MYS,NZL,2004.0,1,0,1
CMR,KEN,2004.0,1,0,1
AUT,CYP,2019.0,1,0,1
AUS,LAO,2012.0,2,0,2
PAN,SLV,2014.0,1,0,1
HRV,RUS,2020.0,3,0,3
NLD,KWT,2016.0,2,0,2
LTU,TJK,2018.0,1,0,1
BRN,MYS,2008.0,2,0,2
IRQ,BHS,2018.0,1,0,1
FRA,SOM,2018.0,1,0,1
OMN,FRA,1998.0,1,0,1
AUS,CYP,2004.0,1,0,1
NPL,MEX,2008.0,1,0,1
KWT,MYS,2000.0,1,0,1
SVK,CHE,1997.0,1,0,1
ARG,MEX,1997.0,2,0,2
ECU,CHL,2013.0,3,0,3
AFG,,2013.0,5,0,5
KOR,NZL,2007.0,2,0,2
CMR,FIN,2008.0,1,0,1
PNG,NCL,2014.0,1,0,1
CAN,SLE,2014.0,1,0,1
CIV,MLI,2019.0,2,0,2
LVA,DNK,2019.0,3,0,3
FRA,OMN,2004.0,2,0,2
ARM,USA,2000.0,4,0,4
KWT,FRA,2021.0,2,0,2
BTN,ESP,2021.0,1,0,1
IND,EST,2010.0,2,0,2
AUT,EGY,2021.0,1,0,1
,MRT,1997.0,2,0,2
IRL,ESP,1997.0,1,0,1
CMR,CHE,2000.0,1,0,1
JAM,TTO,2002.0,2,0,2
PHL,DEU,1997.0,1,0,1
,ECU,1996.0,9,0,9
DEU,CYP,2012.0,3,0,3
BRA,POL,2009.0,2,0,2
NOR,MEX,2005.0,1,0,1
HKG,SAU,2007.0,1,0,1
FRA,PRI,2019.0,1,0,1
COG,NLD,2008.0,1,0,1
VEN,PRI,2007.0,2,0,2
FRA,VUT,2013.0,1,0,1
RUS,TWN,2015.0,2,0,2
NZL,ECU,2014.0,1,0,1
JOR,EGY,2014.0,2,0,2
NLD,NAM,2018.0,1,0,1
GUF,CZE,2017.0,1,0,1
,GUM,2012.0,4,0,4
IRL,BWA,2014.0,1,0,1
BLR,IRL,2012.0,1,0,1
USA,MCO,2010.0,2,0,2
ITA,CYP,2007.0,1,0,1
BEL,PRI,2017.0,1,0,1
IND,BGR,2008.0,1,0,1
BEL,VNM,2022.0,7,0,7
UKR,CAN,2019.0,7,0,7
PHL,SWE,2010.0,1,0,1
MLI,MRT,2020.0,1,0,1
CAN,GAB,2019.0,1,0,1
ARE,DZA,2007.0,1,0,1
AUT,GRL,2013.0,1,0,1
GRC,NLD,1997.0,1,0,1
OMN,ARE,2005.0,3,0,3
ARG,FIN,2010.0,2,0,2
IRL,LUX,2005.0,1,0,1
SGP,EST,2022.0,1,0,1
RUS,CUB,2020.0,1,0,1
PAN,AUS,2015.0,1,0,1
FIN,JOR,2012.0,1,0,1
PAK,COL,2008.0,1,0,1
TCD,,2004.0,1,0,1
TJK,CHN,2017.0,1,0,1
ABW,,2023.0,4,0,4
BMU,SWE,2014.0,1,0,1
SYR,CYP,2011.0,1,0,1
MYS,AUT,2013.0,1,0,1
,PLW,2008.0,5,0,5
BEL,ABW,2021.0,1,0,1
MEX,SGP,2020.0,2,0,2
SGP,OMN,2017.0,2,0,2
FIN,BRA,2006.0,1,0,1
ITA,THA,2004.0,3,0,3
BEL,UZB,2008.0,1,0,1
TZA,ITA,2003.0,1,0,1
GAB,MLI,2006.0,1,0,1
MYS,FIN,2002.0,1,0,1
MYS,SAU,1999.0,1,0,1
FRA,KGZ,2014.0,1,0,1
IRQ,AUS,2006.0,1,0,1
CZE,EST,2011.0,1,0,1
ITA,MCO,2012.0,2,0,2
ITA,MLI,2002.0,2,0,2
GLP,SWE,2004.0,2,0,2
IRN,CHN,1998.0,1,0,1
LKA,CHN,2004.0,1,0,1
YEM,BRA,2005.0,1,0,1
SWE,CUB,2009.0,2,0,2
PRY,VEN,2005.0,1,0,1
MLT,IRL,2011.0,1,0,1
AUS,TLS,2015.0,3,0,3
BRB,USA,2014.0,2,0,2
NAM,SWE,2013.0,1,0,1
BHR,,2000.0,1,0,1
SLE,,2008.0,2,0,2
KOR,POL,1999.0,2,0,2
MAR,PRT,2019.0,1,0,1
MYS,LBY,2008.0,2,0,2
DEU,LAO,2005.0,1,0,1
FRA,GNB,2002.0,1,0,1
UZB,PRT,2010.0,1,0,1
BRB,CAN,2008.0,2,0,2
POL,MOZ,2010.0,1,0,1
USA,AFG,2018.0,4,0,4
ITA,NGA,2006.0,1,0,1
IRN,PSE,2020.0,1,0,1
LTU,TWN,2008.0,1,0,1
ETH,NAM,2014.0,1,0,1
AZE,CAN,2006.0,1,0,1
IRQ,FRA,2001.0,1,0,1
KAZ,AUT,2010.0,1,0,1
NGA,CHL,2015.0,1,0,1
ECU,URY,2021.0,5,0,5
ARE,DNK,2016.0,1,0,1
RUS,LUX,2019.0,1,0,1
CAF,GUF,2004.0,1,0,1
CHN,PRT,1999.0,4,0,4
JPN,NOR,1999.0,1,0,1
ESP,LBN,2011.0,1,0,1
IRN,DZA,2008.0,1,0,1
OMN,ISR,2016.0,1,0,1
HKG,QAT,2012.0,3,0,3
POL,MAR,2022.0,1,0,1
LVA,NLD,2013.0,1,0,1
ETH,LKA,2018.0,1,0,1
FIN,HKG,1999.0,1,0,1
BFA,IND,2019.0,1,0,1
JPN,GUF,2012.0,1,0,1
IDN,IND,2008.0,1,0,1
KGZ,AUT,2017.0,1,0,1
HKG,NZL,2022.0,2,0,2
USA,BLZ,2012.0,1,0,1
EGY,HUN,1997.0,1,0,1
TWN,ESP,2000.0,1,0,1
TZA,KOR,2004.0,1,0,1
BEL,JPN,1997.0,1,0,1
CHN,MEX,1997.0,1,0,1
HKG,PRT,2009.0,1,0,1
IRN,KOR,2001.0,1,0,1
NOR,MKD,2015.0,1,0,1
MYS,HUN,2013.0,1,0,1
COL,DOM,2015.0,1,0,1
RWA,,2006.0,1,0,1
MAR,IRN,2004.0,1,0,1
GAB,KEN,2019.0,1,0,1
CZE,IRL,2007.0,3,0,3
OMN,LKA,2012.0,1,0,1
BLR,JPN,2012.0,1,0,1
PRI,PRT,2012.0,2,0,2
FIN,BEN,2017.0,1,0,1
HKG,CZE,2014.0,1,0,1
IRQ,BIH,2020.0,1,0,1
IRN,CHN,1997.0,2,0,2
NLD,ISL,2015.0,1,0,1
POL,IRQ,2015.0,1,0,1
BEL,MAC,2020.0,2,0,2
,REU,2018.0,2,0,2
ARG,ARE,2021.0,1,0,1
KWT,RUS,2007.0,1,0,1
POL,MOZ,2017.0,1,0,1
BLR,BOL,2011.0,1,0,1
CHL,GRC,2019.0,1,0,1
FRA,KEN,2010.0,3,0,3
HUN,GRC,2014.0,1,0,1
,CPV,2011.0,5,0,5
TZA,,2025.0,1,0,1
TCA,,2023.0,4,0,4
ISR,PSE,1997.0,1,0,1
JAM,TTO,2005.0,1,0,1
POL,SRB,2009.0,1,0,1
FRA,SAU,2007.0,5,0,5
ETH,LAO,2011.0,1,0,1
TWN,NOR,2010.0,1,0,1
AUT,BGD,2012.0,1,0,1
UKR,HUN,2007.0,1,0,1
ESP,VNM,2018.0,1,0,1
SVK,ISR,2011.0,1,0,1
JPN,NAM,2019.0,2,0,2
OMN,ESP,2022.0,1,0,1
TLS,,2015.0,2,0,2
ZAF,CIV,2007.0,1,0,1
PRT,UZB,2014.0,1,0,1
KWT,SGP,2002.0,1,0,1
COG,FRA,1997.0,1,0,1
ZAF,GRC,2001.0,1,0,1
TZA,AUS,2005.0,1,0,1
MDG,JPN,2001.0,2,0,2
FRA,QAT,2008.0,2,0,2
ISR,CHN,1997.0,1,0,1
BGD,ESP,2022.0,2,0,2
COL,CZE,2009.0,1,0,1
MKD,MNE,2001.0,1,0,1
DEU,COG,2013.0,1,0,1
ECU,FRA,1999.0,2,0,2
POL,BIH,2014.0,1,0,1
GRC,LBN,2015.0,1,0,1
AUT,SAU,2020.0,2,0,2
BGR,SRB,2022.0,1,0,1
TUR,ZAF,2004.0,1,0,1
GTM,GNQ,2019.0,1,0,1
GHA,OMN,2007.0,1,0,1
CUB,GBR,2006.0,1,0,1
GBR,KGZ,2011.0,2,0,2
GHA,NAM,2012.0,1,0,1
CHE,IDN,2008.0,1,0,1
MEX,QAT,2012.0,1,0,1
JPN,NAM,2017.0,1,0,1
SWE,FRO,2011.0,2,0,2
BRA,BGR,2021.0,1,0,1
GRC,BRN,2021.0,1,0,1
KOR,BLR,2015.0,1,0,1
KWT,HUN,1997.0,1,0,1
TTO,BRB,2017.0,1,0,1
GHA,BRA,2019.0,1,0,1
AFG,GBR,2019.0,1,0,1
ARG,CZE,2002.0,1,0,1
CHN,IDN,2013.0,1,0,1
SEN,MLI,2021.0,1,0,1
IND,TZA,2005.0,1,0,1
BEN,PRT,2015.0,1,0,1
SWZ,,2010.0,4,0,4
SVN,TWN,2011.0,1,0,1
SAU,VEN,2014.0,1,0,1
ITA,PAK,2006.0,1,0,1
ITA,TWN,2001.0,1,0,1
SDN,MCO,2016.0,1,0,1
HRV,CAN,2006.0,1,0,1
KWT,PHL,2010.0,1,0,1
ESP,COG,2017.0,1,0,1
IRL,LBY,2013.0,2,0,2
PRT,HRV,2020.0,1,0,1
BLR,AUT,2001.0,1,0,1
PRI,UKR,2008.0,1,0,1
GIN,SEN,2017.0,1,0,1
SDN,KEN,2014.0,1,0,1
CUB,JPN,2013.0,1,0,1
KAZ,DZA,2014.0,1,0,1
LKA,ISR,2013.0,1,0,1
ZAF,SRB,2018.0,1,0,1
SWE,CRI,2004.0,1,0,1
ECU,CHE,2011.0,1,0,1
ERI,,2007.0,1,0,1
CMR,SWZ,2009.0,1,0,1
UGA,CHE,2022.0,1,0,1
GBR,LAO,2020.0,1,0,1
CUB,RUS,2022.0,1,0,1
PHL,CZE,2018.0,1,0,1
BFA,IND,2017.0,1,0,1
CHE,LAO,2021.0,1,0,1
KWT,POL,2022.0,1,0,1
SVN,BMU,2011.0,1,0,1
PLW,,2018.0,1,0,1
GBR,AGO,2009.0,1,0,1
GIN,SEN,2010.0,1,0,1
GHA,BFA,2009.0,1,0,1
MYS,KHM,2020.0,3,0,3
ETH,FRA,2002.0,1,0,1
NGA,NAM,2012.0,1,0,1
MAC,AUT,2017.0,1,0,1
OMN,POL,2005.0,1,0,1
CZE,LVA,2017.0,1,0,1
IDN,KHM,2003.0,1,0,1
PRI,DEU,2020.0,1,0,1
PHL,EGY,2019.0,2,0,2
KEN,ARE,2020.0,1,0,1
MDA,FRA,2015.0,1,0,1
THA,PER,2019.0,1,0,1
COG,CHE,2011.0,1,0,1
TTO,DEU,2003.0,1,0,1
AUS,LIE,2012.0,1,0,1
UKR,SGP,2001.0,1,0,1
MLT,MKD,2003.0,1,0,1
CZE,DNK,2003.0,1,0,1
JPN,VEN,1999.0,1,0,1
NOR,GTM,2019.0,1,0,1
THA,PER,2010.0,1,0,1
GEO,CAN,2020.0,1,0,1
TKM,DEU,2017.0,1,0,1
SYC,,2005.0,1,0,1
RUS,LUX,2017.0,1,0,1
SRB,KWT,2018.0,1,0,1
MMR,NOR,2019.0,1,0,1
MLI,NOR,2002.0,1,0,1
IRQ,GBR,2003.0,1,0,1
DEU,PER,2005.0,1,0,1
CHE,CUB,2021.0,1,0,1
HTI,CHE,2018.0,1,0,1
BRA,SRB,2018.0,1,0,1
MLI,NOR,2005.0,1,0,1
CZE,ETH,2008.0,1,0,1
MDG,CMR,2017.0,1,0,1
VEN,PRY,2020.0,1,0,1
SWZ,GBR,2015.0,1,0,1
PRI,RUS,2013.0,1,0,1
AGO,ESP,2016.0,1,0,1
CIV,CRI,2017.0,1,0,1
KEN,NZL,2018.0,1,0,1
BGR,CHE,2022.0,1,0,1
JPN,MMR,2011.0,1,0,1
CIV,GUF,2011.0,1,0,1
GTM,FRA,2012.0,1,0,1
CZE,SRB,2006.0,1,0,1
IND,PRK,2018.0,1,0,1
PRI,ZAF,2021.0,1,0,1
IDN,BRN,2012.0,1,0,1
AUS,USA,2009.0,386,488,-102
ESP,DNK,2013.0,21,14,7
TUR,USA,2004.0,144,185,-41
ISR,USA,2006.0,376,211,165
DEU,USA,2008.0,1113,915,198
ESP,PRT,2011.0,70,53,17
COL,FRA,2008.0,4,12,-8
GRC,AUT,2010.0,4,3,1
ITA,DEU,2005.0,135,121,14
USA,DEU,2006.0,902,1170,-268
USA,GBR,2001.0,827,1055,-228
CAN,JPN,2018.0,79,75,4
BRA,GBR,2009.0,48,48,0
USA,DNK,2013.0,143,117,26
GRC,DEU,2009.0,51,39,12
CZE,USA,2020.0,43,44,-1
CAN,IRN,2013.0,49,240,-191
CHN,DNK,2009.0,11,9,2
CHN,USA,2015.0,2491,2442,49
HKG,USA,2021.0,122,123,-1
USA,IRL,2008.0,114,101,13
GBR,NLD,2006.0,127,201,-74
CYP,GRC,2022.0,20,28,-8
SGP,GBR,2018.0,109,130,-21
AUS,IND,2013.0,53,88,-35
ITA,AUT,2009.0,41,20,21
TUN,JPN,2005.0,2,1,1
AUS,CHE,2022.0,31,22,9
USA,KOR,2009.0,787,646,141
USA,GRC,2018.0,78,103,-25
DEU,KOR,2015.0,43,50,-7
FRA,SWE,2004.0,34,33,1
ZAF,FRA,2010.0,13,19,-6
BRA,PRT,2014.0,83,107,-24
JPN,USA,2021.0,440,507,-67
FRA,AUS,2008.0,72,45,27
FIN,ITA,2018.0,18,26,-8
ESP,FRA,2012.0,191,177,14
JPN,THA,2020.0,125,67,58
IRL,GBR,2007.0,126,156,-30
DEU,BRA,2003.0,39,44,-5
GBR,HKG,2004.0,26,30,-4
SWE,CHE,2012.0,39,44,-5
MYS,IND,2008.0,17,29,-12
NZL,GBR,2015.0,109,98,11
USA,NOR,2015.0,100,47,53
EGY,SAU,2012.0,190,105,85
CZE,FRA,2017.0,21,29,-8
DEU,CHE,1998.0,98,82,16
GBR,DEU,1998.0,109,108,1
MEX,AUS,2020.0,6,11,-5
IRL,NLD,2007.0,10,14,-4
RUS,JPN,2012.0,14,15,-1
DNK,TUR,2014.0,6,2,4
SVK,CZE,1998.0,4,4,0
MYS,YEM,2009.0,4,3,1
DEU,ITA,2020.0,239,292,-53
FRA,DZA,2007.0,48,20,28
USA,PRT,2010.0,75,42,33
ITA,TUR,2019.0,15,17,-2
FRA,CHN,2008.0,58,58,0
CAN,MYS,2007.0,7,4,3
SVK,USA,2009.0,10,18,-8
USA,AUS,2020.0,515,567,-52
BEL,RUS,2016.0,12,11,1
GBR,EGY,2014.0,61,21,40
IND,JPN,2020.0,95,64,31
USA,GTM,2018.0,13,3,10
COL,DEU,2019.0,22,18,4
FIN,SWE,2020.0,71,57,14
CHN,TWN,2014.0,61,83,-22
USA,CHL,2022.0,29,46,-17
GBR,LBY,2014.0,14,4,10
IRN,AZE,2013.0,6,2,4
CHN,GBR,2011.0,176,261,-85
SGP,AUS,2021.0,54,68,-14
DEU,MEX,2016.0,22,46,-24
CHN,JPN,2020.0,326,447,-121
KOR,IDN,2013.0,18,3,15
KOR,VNM,2019.0,129,21,108
CHE,DNK,2013.0,23,30,-7
RUS,CHN,2021.0,24,19,5
IND,RUS,2016.0,15,3,12
VEN,CHL,2016.0,15,2,13
CHE,CHL,2018.0,8,10,-2
GBR,SWE,2004.0,67,76,-9
GBR,SAU,2018.0,163,46,117
SWE,EST,2021.0,7,6,1
FRA,BRA,2020.0,94,131,-37
HKG,NLD,2021.0,5,7,-2
CHL,GBR,2020.0,43,37,6
CHE,GRC,2014.0,11,35,-24
ITA,ARG,2020.0,18,12,6
SDN,SAU,2015.0,13,2,11
JPN,IND,2020.0,64,95,-31
COL,USA,2018.0,118,81,37
ALB,DEU,2016.0,2,2,0
SGP,JPN,2022.0,16,12,4
IND,ETH,2017.0,60,15,45
GBR,DNK,2020.0,106,98,8
CAN,CHE,2022.0,45,36,9
IND,ARE,2018.0,58,19,39
GBR,POL,2003.0,33,22,11
JPN,GBR,2021.0,60,92,-32
FIN,NOR,2019.0,25,17,8
USA,KEN,2013.0,53,41,12
DEU,CHN,2004.0,92,101,-9
ITA,DEU,2002.0,133,131,2
SVN,POL,2018.0,2,3,-1
BEN,BEL,2019.0,4,1,3
TUR,DEU,2019.0,92,37,55
PRT,FRA,2017.0,47,28,19
BLR,RUS,2015.0,14,4,10
BRA,PER,2016.0,22,13,9
KOR,IND,2002.0,8,26,-18
NLD,IDN,2020.0,47,20,27
CZE,FRA,2019.0,30,18,12
PAK,KOR,2022.0,25,25,0
NGA,GBR,2015.0,34,39,-5
MYS,IRL,2020.0,6,4,2
PRT,SGP,2015.0,1,2,-1
TUR,CAN,2021.0,33,11,22
ARE,TUR,2019.0,4,6,-2
IND,AUS,2021.0,94,61,33
GBR,IDN,2018.0,29,14,15
BRA,MAR,2021.0,2,1,1
IND,ETH,2019.0,63,16,47
PRT,FRA,2019.0,37,32,5
UGA,TZA,2019.0,3,4,-1
TWN,AUS,2015.0,14,10,4
DEU,KAZ,2019.0,4,6,-2
AUS,QAT,2007.0,1,1,0
CHL,USA,2021.0,92,64,28
NZL,KEN,2019.0,4,3,1
KOR,CHN,2022.0,115,92,23
SRB,DEU,2018.0,14,3,11
ZAF,FRA,2019.0,18,18,0
KOR,DNK,2021.0,7,5,2
FRA,ISR,2015.0,34,17,17
FRA,PSE,2018.0,7,2,5
MWI,USA,2013.0,7,16,-9
USA,PRT,2019.0,48,55,-7
ESP,PER,2022.0,7,8,-1
NOR,GHA,2021.0,4,2,2
TWN,VNM,2020.0,36,15,21
ISR,PRT,2018.0,1,1,0
ETH,ITA,2019.0,5,5,0
MYS,NZL,2020.0,14,3,11
JPN,CAN,2021.0,49,47,2
TTO,GBR,2015.0,2,5,-3
FRA,MAR,2009.0,61,33,28
DEU,NOR,2006.0,45,9,36
DNK,NOR,2002.0,21,21,0
USA,VNM,2019.0,54,23,31
NOR,HKG,2020.0,3,2,1
FRA,REU,2022.0,10,3,7
ZAF,GBR,2006.0,59,43,16
COL,GBR,2006.0,5,7,-2
HKG,AUS,1998.0,6,5,1
CHL,JPN,2010.0,1,5,-4
IRN,CAN,2007.0,57,52,5
ECU,CUB,2018.0,6,20,-14
USA,PER,2021.0,19,34,-15
CAN,AUT,2021.0,17,15,2
ITA,GBR,2008.0,239,175,64
DEU,ESP,2008.0,139,110,29
DEU,ZAF,2011.0,22,18,4
CHN,NLD,2018.0,124,138,-14
UKR,GBR,2006.0,13,12,1
ZAF,IND,2020.0,35,35,0
GBR,ARE,2020.0,58,31,27
UKR,DEU,2015.0,30,9,21
PER,BRA,2022.0,6,16,-10
DEU,IRL,2020.0,32,33,-1
USA,BEL,2022.0,52,69,-17
IND,ZAF,2008.0,15,3,12
EGY,OMN,2016.0,4,4,0
BRA,DEU,2008.0,46,43,3
CAN,AUS,2021.0,126,111,15
ISL,SWE,2020.0,14,15,-1
EGY,USA,2012.0,51,96,-45
GBR,LKA,2011.0,10,4,6
KOR,GBR,2018.0,56,60,-4
SWE,NLD,2013.0,39,48,-9
FRA,GAB,2013.0,8,2,6
PAK,KEN,2013.0,4,3,1
AUS,ESP,2009.0,13,17,-4
TUR,DEU,2010.0,43,41,2
USA,IRN,2013.0,62,400,-338
JPN,ROU,2008.0,11,3,8
CAN,ITA,2019.0,40,92,-52
QAT,ARE,2016.0,7,9,-2
SVK,DEU,2011.0,15,9,6
CZE,FRA,2010.0,17,21,-4
ITA,NOR,2012.0,13,7,6
ITA,IRL,2014.0,21,21,0
BEL,GBR,2007.0,74,53,21
IND,ETH,2010.0,8,6,2
LTU,NLD,2014.0,2,1,1
DEU,IRN,2018.0,37,88,-51
GRC,GBR,2013.0,168,118,50
BWA,USA,2017.0,9,6,3
NLD,MYS,2017.0,6,9,-3
USA,PRT,2017.0,46,73,-27
AUS,SAU,2012.0,13,3,10
JPN,BRA,2014.0,20,7,13
DNK,POL,2011.0,13,10,3
MEX,ARG,2005.0,6,13,-7
ESP,IRN,2012.0,4,8,-4
BRA,AUS,2022.0,28,12,16
CAN,SGP,2022.0,12,7,5
RUS,KAZ,2007.0,13,4,9
MYS,THA,2019.0,9,3,6
USA,IRQ,2015.0,11,8,3
CZE,GBR,2014.0,34,34,0
CHN,HKG,1999.0,47,38,9
NLD,IND,2020.0,37,54,-17
NGA,TZA,2018.0,4,1,3
FIN,NOR,2017.0,17,13,4
SWE,CHL,2015.0,3,3,0
FRA,RUS,2004.0,23,43,-20
GBR,DEU,1997.0,52,58,-6
GBR,NGA,2004.0,13,8,5
FIN,AUS,2005.0,7,10,-3
FIN,RUS,2020.0,12,29,-17
NLD,MYS,2019.0,11,3,8
ITA,SWE,1997.0,4,7,-3
GBR,CZE,2004.0,18,15,3
ITA,BEL,2004.0,26,23,3
MEX,CAN,2006.0,24,14,10
IND,OMN,2018.0,36,16,20
ROU,GBR,2001.0,10,2,8
ESP,BEL,2005.0,20,17,3
COL,DEU,2017.0,11,17,-6
BEL,AUT,2016.0,22,6,16
CZE,DEU,2021.0,43,35,8
DNK,GNB,2004.0,4,2,2
NOR,USA,2021.0,53,74,-21
CHL,JPN,2017.0,3,5,-2
THA,CHN,2022.0,14,23,-9
NLD,ETH,2017.0,6,7,-1
PAN,USA,2021.0,7,11,-4
FRA,VNM,2016.0,54,10,44
CHN,KEN,2020.0,12,7,5
CRI,GBR,2022.0,3,1,2
ZAF,FRA,2017.0,18,22,-4
LKA,CHN,2020.0,3,7,-4
GBR,COL,2019.0,21,13,8
CAN,ITA,2010.0,42,53,-11
DZA,CHN,2022.0,1,4,-3
NPL,CAN,2020.0,4,1,3
PAK,NGA,2021.0,4,4,0
AUS,PAK,2021.0,15,29,-14
ITA,HRV,2021.0,6,5,1
FRA,NOR,2004.0,19,10,9
CAN,SDN,2021.0,1,1,0
GBR,MWI,2003.0,5,5,0
SWE,USA,2000.0,67,59,8
DEU,CHL,2021.0,14,35,-21
BHR,SAU,2016.0,3,2,1
USA,BRA,1998.0,54,42,12
IRN,BEL,2016.0,25,12,13
ROU,BEL,2015.0,9,6,3
FRA,ROU,1998.0,6,4,2
USA,QAT,2020.0,51,60,-9
CHE,JPN,2016.0,36,34,2
FRA,SVK,2007.0,7,5,2
ITA,GRC,2011.0,15,31,-16
GMB,GBR,2013.0,7,6,1
CHE,ERI,2020.0,1,1,0
CHE,ARG,2005.0,2,4,-2
CZE,SVK,2015.0,52,70,-18
ZAF,KEN,2013.0,15,13,2
ETH,FRA,2007.0,1,2,-1
JPN,VNM,2004.0,6,4,2
EGY,CAN,2008.0,20,19,1
ALB,USA,2013.0,1,1,0
DNK,ESP,2007.0,12,15,-3
DEU,TUR,2009.0,27,32,-5
USA,TUR,2001.0,111,94,17
RUS,UKR,2003.0,42,41,1
CAN,EGY,2005.0,8,9,-1
ROU,USA,2005.0,20,14,6
POL,CHN,2017.0,8,9,-1
FIN,CHE,2013.0,13,18,-5
IRL,IND,2002.0,1,2,-1
CZE,IRL,2005.0,2,1,1
CAN,GRC,2004.0,11,3,8
MNE,SRB,2013.0,2,4,-2
SVN,ITA,2007.0,3,6,-3
SRB,BIH,2005.0,5,4,1
BRA,USA,2000.0,73,60,13
BRA,AUT,2005.0,2,5,-3
THA,NLD,2003.0,3,3,0
FIN,CAN,2004.0,17,7,10
USA,IDN,1999.0,7,1,6
CHE,MEX,2005.0,5,1,4
CHE,CAN,2000.0,19,20,-1
ESP,BEL,2002.0,28,18,10
NLD,HUN,2007.0,7,6,1
JPN,EGY,2013.0,59,14,45
BEL,DEU,2001.0,35,35,0
CHE,POL,1997.0,4,3,1
PRT,DEU,2001.0,5,5,0
USA,ROU,2022.0,5,5,0
USA,CZE,2012.0,40,40,0
JPN,HKG,2014.0,13,10,3
AUS,JPN,2016.0,63,42,21
DNK,DEU,2009.0,45,90,-45
DEU,CHE,1997.0,54,48,6
ROU,USA,2002.0,29,14,15
UKR,FIN,1998.0,1,2,-1
SAU,USA,2000.0,9,12,-3
BLR,USA,2003.0,17,5,12
FRA,DNK,2003.0,30,22,8
IND,NGA,2004.0,1,1,0
POL,RUS,2005.0,14,6,8
AUS,AUT,2002.0,15,18,-3
DNK,NOR,2005.0,24,12,12
NLD,ESP,1998.0,10,8,2
DNK,COL,2005.0,1,1,0
KWT,OMN,2012.0,2,1,1
CAN,SWE,2006.0,11,34,-23
NZL,USA,2000.0,29,22,7
FRA,MCO,2001.0,7,1,6
NLD,IRL,2004.0,7,9,-2
HRV,CHE,2001.0,4,3,1
NLD,GRC,2007.0,9,8,1
MEX,SWE,2003.0,2,2,0
KOR,NLD,2002.0,5,4,1
CYP,TUR,2014.0,16,26,-10
DEU,LUX,2009.0,18,8,10
POL,TWN,2014.0,6,4,2
SEN,FRA,2012.0,18,28,-10
GBR,MLT,2009.0,5,5,0
HKG,GBR,2011.0,29,54,-25
KWT,SAU,2016.0,2,4,-2
POL,BLR,2019.0,4,4,0
NLD,BRA,2007.0,13,10,3
KHM,VNM,2012.0,2,2,0
MCO,FRA,2014.0,6,12,-6
NLD,ESP,1997.0,5,5,0
MEX,ARG,2002.0,7,5,2
URY,ARG,2004.0,2,2,0
BGR,AUS,2002.0,4,2,2
ESP,IRL,2008.0,13,9,4
NOR,GBR,1999.0,11,7,4
BEL,PHL,2010.0,3,2,1
ISR,NZL,2009.0,2,1,1
NOR,NLD,2002.0,8,15,-7
ESP,COL,2008.0,27,20,7
NZL,DNK,2006.0,4,1,3
CHN,SWE,2000.0,6,8,-2
ARE,USA,2005.0,9,31,-22
IND,SGP,2011.0,44,30,14
MYS,MEX,2011.0,1,1,0
ARG,CAN,2001.0,6,9,-3
VEN,ESP,2006.0,19,13,6
MEX,BEL,2012.0,5,5,0
ZAF,SWE,2013.0,6,9,-3
ITA,MEX,2018.0,16,17,-1
PRT,MEX,2015.0,2,2,0
GBR,NPL,2011.0,4,7,-3
LBN,AUS,2014.0,3,2,1
AUT,CZE,2021.0,8,10,-2
CAN,JOR,2008.0,9,4,5
GRC,AUT,2017.0,7,3,4
NLD,MYS,2010.0,3,1,2
DEU,IDN,2011.0,11,8,3
IND,CHN,2006.0,11,8,3
BEL,CUB,2015.0,1,2,-1
GUY,USA,2009.0,1,1,0
NZL,TWN,2007.0,2,2,0
KOR,SWE,2008.0,3,2,1
POL,FIN,2014.0,12,4,8
AUS,AUT,2005.0,10,10,0
NLD,VNM,2014.0,3,2,1
SGP,KOR,2014.0,19,26,-7
DEU,TUN,2017.0,3,6,-3
FRA,MDG,2015.0,11,10,1
GBR,COL,2010.0,11,4,7
ZAF,NAM,2011.0,6,3,3
SVN,BEL,2019.0,5,1,4
AUS,TWN,2012.0,18,15,3
GBR,CMR,2016.0,1,1,0
CHN,AUT,2011.0,7,5,2
FRA,SRB,2000.0,3,1,2
ITA,PHL,2017.0,3,1,2
PER,AUS,2012.0,2,1,1
USA,VNM,2010.0,14,9,5
DNK,AUT,2014.0,8,15,-7
USA,COG,2012.0,2,5,-3
IRN,NOR,2014.0,18,3,15
SAU,KWT,2011.0,6,4,2
BEL,CHN,2016.0,45,47,-2
KEN,CHE,2016.0,6,3,3
SAU,JPN,2022.0,2,1,1
USA,ISL,2022.0,6,4,2
AUS,HKG,2011.0,18,31,-13
BHS,JAM,2019.0,1,1,0
ESP,JPN,2020.0,12,22,-10
MDG,USA,2013.0,4,4,0
ITA,LTU,2014.0,6,3,3
MTQ,FRA,2021.0,10,15,-5
PRT,FRA,2010.0,36,35,1
PHL,AUS,2013.0,12,3,9
UGA,NGA,2021.0,1,4,-3
TWN,JPN,2014.0,40,36,4
ITA,ECU,2017.0,7,3,4
USA,VNM,2017.0,30,24,6
BEL,UKR,2014.0,4,2,2
TUN,DZA,2017.0,2,3,-1
RWA,BEL,2018.0,2,4,-2
NOR,ESP,2008.0,4,11,-7
BRA,KOR,2018.0,4,2,2
MYS,THA,2017.0,12,2,10
IRL,DNK,2013.0,7,3,4
NPL,USA,2002.0,2,4,-2
FIN,IND,2013.0,8,20,-12
CUB,USA,2001.0,6,1,5
DZA,RUS,2021.0,1,3,-2
ITA,TUR,2017.0,9,14,-5
CZE,NOR,2010.0,3,3,0
RUS,NLD,2021.0,15,8,7
IRL,AUT,2019.0,4,3,1
IRL,NOR,2020.0,3,3,0
BWA,USA,2019.0,14,18,-4
CHN,HUN,2019.0,6,3,3
BRN,IND,2018.0,2,5,-3
GHA,AUS,2021.0,12,9,3
BEL,EGY,2022.0,1,2,-1
IRQ,JOR,2019.0,4,3,1
DEU,KAZ,2017.0,5,4,1
SAU,JOR,2012.0,7,34,-27
IND,CMR,2021.0,1,2,-1
DEU,PAK,2008.0,8,12,-4
USA,GHA,2007.0,5,4,1
ESP,DZA,2012.0,6,1,5
LKA,IND,2013.0,2,1,1
SWE,ARG,2000.0,1,3,-2
ESP,BRA,2004.0,20,18,2
SVK,CZE,1997.0,4,3,1
IRL,DEU,2013.0,47,25,22
CAN,TUR,1999.0,1,2,-1
USA,BRA,1997.0,29,16,13
PRT,ESP,2000.0,10,7,3
BGD,JPN,2021.0,19,65,-46
ITA,HUN,2015.0,6,9,-3
FRA,SYR,2020.0,4,3,1
KOR,ESP,2020.0,11,2,9
IDN,JPN,2018.0,40,150,-110
CAN,OMN,2019.0,9,7,2
NGA,CHE,2014.0,2,1,1
POL,VNM,2019.0,3,2,1
SWE,FIN,2008.0,28,28,0
CAN,ISR,2002.0,16,36,-20
EGY,AUT,2009.0,2,3,-1
RUS,CAN,2009.0,14,13,1
CHL,JPN,2019.0,8,4,4
CHE,MEX,2002.0,5,3,2
KEN,AUS,2009.0,2,1,1
DNK,MYS,2015.0,5,1,4
ROU,DEU,2021.0,12,13,-1
IND,ISR,2003.0,19,5,14
DNK,NZL,2022.0,2,2,0
CMR,ITA,2018.0,1,2,-1
AUS,BRN,2016.0,3,2,1
USA,SEN,2020.0,8,4,4
SAU,DEU,2013.0,3,20,-17
DEU,ISR,2009.0,21,42,-21
LBY,GBR,2005.0,1,2,-1
SAU,IRQ,2020.0,6,1,5
FIN,AUS,2002.0,3,10,-7
EGY,JOR,2022.0,3,4,-1
TTO,USA,2022.0,2,1,1
USA,LVA,2016.0,3,4,-1
KOR,RUS,2018.0,9,10,-1
ITA,THA,2020.0,2,3,-1
ROU,JPN,2002.0,3,3,0
CHE,RUS,2011.0,9,35,-26
KEN,DEU,2003.0,6,3,3
DZA,BEL,2002.0,2,2,0
CAN,ISR,2005.0,20,54,-34
BEL,ROU,2007.0,6,6,0
JPN,PRT,2007.0,2,2,0
FRA,LAO,2022.0,3,1,2
FRA,MTQ,2007.0,15,14,1
GIN,FRA,2008.0,6,2,4
FRA,GIN,2014.0,3,1,2
SRB,CHE,2002.0,3,2,1
USA,BGR,2014.0,11,11,0
DEU,PRT,1999.0,6,5,1
FIN,NOR,2010.0,13,5,8
IRL,AUT,2010.0,10,4,6
ECU,USA,2009.0,5,12,-7
CHE,CZE,2004.0,7,5,2
CAN,BGD,2013.0,15,16,-1
BEL,CMR,2013.0,1,3,-2
SVN,NLD,2015.0,4,1,3
ARM,CHE,2003.0,1,1,0
CMR,DEU,2005.0,1,1,0
PAK,BGD,2011.0,8,5,3
NLD,KEN,2003.0,4,3,1
NOR,CAN,2011.0,7,10,-3
IND,IRN,2009.0,12,10,2
IRL,RUS,2021.0,2,7,-5
RWA,USA,2005.0,1,1,0
SRB,MKD,2005.0,4,15,-11
NLD,PRT,2009.0,14,12,2
GBR,UGA,2007.0,5,4,1
NOR,SGP,2007.0,1,5,-4
ISR,SWE,2014.0,6,6,0
MEX,TUR,2011.0,2,1,1
HUN,AUT,2018.0,17,7,10
ITA,COL,2012.0,6,3,3
AUS,NOR,2014.0,14,6,8
UGA,TZA,2017.0,2,1,1
ESP,FIN,2021.0,14,17,-3
POL,CZE,2006.0,2,6,-4
CZE,NOR,2019.0,1,4,-3
SWE,ZAF,2009.0,4,3,1
ROU,SWE,2018.0,4,3,1
MEX,KEN,2019.0,6,3,3
MYS,ETH,2013.0,1,1,0
FIN,EST,2015.0,15,14,1
TUN,MAR,2009.0,2,1,1
BEL,NOR,2015.0,7,4,3
DEU,SVN,2008.0,5,2,3
NPL,IND,2005.0,8,21,-13
PRY,BRA,2015.0,2,2,0
DEU,TUN,2019.0,3,10,-7
JPN,JOR,2015.0,3,1,2
NZL,ESP,2018.0,7,4,3
ESP,TUN,2014.0,4,5,-1
COD,BEL,2016.0,1,1,0
VEN,MEX,2012.0,7,3,4
DNK,BRA,2020.0,8,19,-11
IRQ,DEU,2014.0,2,3,-1
DEU,ROU,2022.0,8,3,5
SVN,USA,1999.0,2,1,1
CZE,NOR,2017.0,2,3,-1
SAU,TUR,2019.0,9,8,1
ZMB,JPN,2018.0,3,1,2
LUX,IND,2014.0,1,2,-1
CAN,PRT,2015.0,5,13,-8
ITA,CHN,1998.0,8,5,3
MEX,ISR,2003.0,1,1,0
PHL,MEX,2020.0,3,2,1
BRA,NOR,2012.0,5,7,-2
MYS,LKA,2021.0,6,1,5
IND,NPL,2001.0,6,2,4
NPL,IND,2002.0,9,7,2
CYP,CAN,2013.0,2,1,1
AUS,PNG,2004.0,6,1,5
MAR,DEU,2002.0,2,1,1
AUS,MEX,2019.0,5,15,-10
THA,MMR,2011.0,1,1,0
ZAF,DNK,2012.0,5,1,4
TZA,NGA,2018.0,1,4,-3
HTI,USA,2014.0,6,10,-4
EGY,ESP,2014.0,5,5,0
CAN,ROU,2006.0,5,4,1
UKR,ITA,2013.0,5,3,2
RUS,CZE,2018.0,9,10,-1
ESP,HUN,2006.0,2,3,-1
UKR,SWE,2013.0,4,2,2
KOR,IRL,2008.0,4,1,3
PAN,FRA,2013.0,1,1,0
KOR,VNM,2010.0,12,8,4
ITA,CHN,1997.0,5,5,0
BEL,COL,2003.0,2,1,1
SVN,GBR,2000.0,1,2,-1
PHL,DNK,2015.0,1,2,-1
ROU,EST,2019.0,1,1,0
BOL,MEX,2016.0,1,2,-1
SGP,ZAF,2019.0,2,1,1
IRL,AUT,2017.0,3,3,0
BWA,USA,2010.0,8,7,1
ZAF,NOR,2018.0,3,1,2
GLP,MTQ,2014.0,4,1,3
CHE,PAK,2014.0,4,2,2
ECU,GBR,2014.0,2,3,-1
AUT,ZAF,2020.0,3,5,-2
KWT,JOR,2012.0,2,1,1
IND,ZWE,2019.0,1,1,0
IND,ATG,2018.0,2,1,1
THA,IRN,2020.0,2,3,-1
SVN,FRA,2022.0,4,2,2
NGA,GHA,2022.0,3,3,0
CHE,KEN,2016.0,3,6,-3
EST,IND,2017.0,3,3,0
ROU,GRC,2002.0,2,1,1
EST,USA,2007.0,5,4,1
HUN,NOR,2006.0,2,2,0
ITA,TUR,2010.0,8,9,-1
MDA,RUS,2012.0,4,2,2
EGY,PAK,2014.0,3,1,2
SAU,YEM,2022.0,5,10,-5
ETH,GBR,2013.0,10,4,6
SWE,ITA,2003.0,19,27,-8
MEX,CHE,2006.0,3,4,-1
ARG,ITA,2001.0,8,8,0
LKA,GBR,2000.0,1,1,0
CHE,PRT,2004.0,6,2,4
HUN,FIN,2003.0,5,2,3
SRB,IRL,2022.0,4,1,3
USA,GEO,2006.0,7,8,-1
FRA,ROU,1997.0,4,5,-1
PAK,AUT,2013.0,5,30,-25
MYS,VNM,2012.0,4,2,2
CAN,IRL,2003.0,11,12,-1
CAN,FIN,2006.0,6,15,-9
USA,HRV,2000.0,5,6,-1
NLD,JPN,2008.0,13,18,-5
USA,BHR,2008.0,1,3,-2
DNK,IND,1999.0,2,1,1
UKR,ISR,1999.0,3,1,2
COL,CHE,2008.0,3,2,1
KEN,UGA,2015.0,4,3,1
ROU,FIN,2010.0,4,1,3
ZWE,GBR,2006.0,10,2,8
USA,DZA,2014.0,6,2,4
HUN,IRL,2015.0,3,5,-2
NOR,NLD,2005.0,6,12,-6
PER,ITA,2006.0,1,1,0
IRL,CZE,2010.0,2,5,-3
MEX,NZL,2001.0,1,1,0
SRB,CHE,2005.0,1,1,0
IND,AUT,2008.0,5,4,1
NPL,NOR,2005.0,1,1,0
CAN,OMN,2010.0,8,2,6
BEL,KOR,2015.0,7,7,0
DNK,GRC,2022.0,3,5,-2
DEU,MKD,2018.0,2,2,0
LBY,CAN,2014.0,1,2,-1
LUX,SRB,2014.0,1,1,0
ITA,MYS,2014.0,3,2,1
CRI,ESP,2014.0,3,6,-3
UGA,COG,2006.0,1,1,0
TUR,CZE,2013.0,2,1,1
DNK,SAU,2021.0,4,2,2
PER,ARG,2016.0,1,5,-4
HRV,SVN,2022.0,3,1,2
TUN,DZA,2019.0,6,2,4
EST,IND,2019.0,2,5,-3
TZA,NLD,2019.0,4,2,2
VNM,POL,2021.0,3,3,0
NPL,USA,2005.0,3,5,-2
RUS,BGR,2004.0,8,3,5
RUS,UZB,2012.0,3,2,1
TWN,USA,1997.0,17,41,-24
USA,CUB,1998.0,1,2,-1
GBR,GEO,2019.0,2,1,1
GRC,AUT,2019.0,7,1,6
AUT,IRL,2018.0,2,5,-3
USA,MWI,2021.0,8,15,-7
UGA,ETH,2016.0,1,1,0
SRB,CAN,2003.0,2,2,0
DNK,SRB,2016.0,1,1,0
CHL,SWE,2009.0,1,2,-1
BEL,HUN,2003.0,4,7,-3
PRT,CZE,2012.0,1,1,0
GBR,RWA,2017.0,1,1,0
THA,VNM,2009.0,6,1,5
JPN,UKR,2018.0,2,5,-3
ARM,RUS,1999.0,1,1,0
THA,NOR,2015.0,3,2,1
GBR,ECU,2012.0,1,1,0
AUT,PRT,2012.0,6,3,3
VNM,DNK,2015.0,1,3,-2
LVA,FRA,2014.0,2,2,0
ECU,BRA,2007.0,1,3,-2
BGR,USA,2011.0,5,11,-6
GBR,RWA,2019.0,2,3,-1
BRA,CRI,2013.0,2,1,1
NOR,PER,2014.0,1,1,0
IRL,ARG,2021.0,1,3,-2
SRB,IRQ,2016.0,1,1,0
ROU,ITA,2021.0,4,9,-5
TTO,CAN,2013.0,4,2,2
BEN,BEL,2017.0,3,4,-1
CHN,MLI,2019.0,2,2,0
OMN,AUS,2020.0,2,3,-1
PER,DEU,2020.0,5,7,-2
CAN,HRV,2019.0,1,1,0
GBR,SDN,2009.0,2,1,1
IND,KWT,2011.0,4,3,1
FRA,PAN,2015.0,2,1,1
QAT,KWT,2017.0,1,2,-1
SGP,ZAF,2017.0,1,1,0
BRA,GRC,2021.0,2,2,0
IND,ZWE,2017.0,1,1,0
IND,LBN,2019.0,1,4,-3
CAN,OMN,2017.0,14,3,11
DNK,IRN,2015.0,3,20,-17
USA,BRN,2006.0,2,1,1
ITA,SRB,2001.0,4,2,2
POL,BLR,2010.0,5,2,3
BLR,POL,2011.0,3,2,1
AUS,POL,2015.0,4,18,-14
PRI,GBR,2000.0,1,1,0
USA,UZB,2001.0,1,2,-1
ZWE,NLD,2010.0,3,1,2
JPN,GRC,2014.0,2,1,1
POL,CHN,2019.0,9,14,-5
CAN,NOR,1999.0,4,1,3
NZL,SGP,2011.0,8,10,-2
DEU,PHL,2022.0,3,3,0
CAN,SVK,2002.0,1,2,-1
USA,OMN,2020.0,6,7,-1
TUR,RUS,2014.0,3,3,0
AUT,BGR,2020.0,2,2,0
TUR,AUT,2014.0,3,11,-8
CAN,UKR,2012.0,1,6,-5
GBR,BHR,2012.0,5,2,3
IRN,IRL,2014.0,7,2,5
BGD,ITA,2018.0,4,4,0
DEU,MAR,2017.0,4,2,2
JOR,FRA,2011.0,1,1,0
IRL,OMN,2019.0,1,2,-1
MEX,KEN,2017.0,3,1,2
UKR,NLD,1999.0,2,2,0
NLD,LVA,2016.0,1,1,0
USA,RWA,2012.0,3,2,1
ESP,LVA,2001.0,1,1,0
PHL,CHE,2009.0,2,2,0
AUS,ISR,2022.0,5,6,-1
MEX,COL,2000.0,2,3,-1
CHE,POL,1998.0,5,8,-3
CHE,UGA,2013.0,2,2,0
CUB,ESP,2004.0,7,13,-6
COL,ITA,1997.0,2,2,0
ITA,UKR,1998.0,1,4,-3
GBR,CUB,2004.0,1,3,-2
CAN,ARE,1998.0,2,1,1
SVN,BEL,2010.0,3,3,0
SGP,AUT,2015.0,7,2,5
ESP,PRI,2018.0,2,4,-2
CHN,ISR,1999.0,5,2,3
DEU,EGY,1998.0,2,1,1
TWN,POL,2020.0,1,1,0
LSO,CHE,2021.0,2,1,1
BRA,COL,2000.0,3,1,2
IND,NZL,2001.0,3,1,2
OMN,NLD,2015.0,1,2,-1
DEU,ISL,2009.0,2,5,-3
BEL,POL,1999.0,3,2,1
CHE,SVN,2016.0,1,12,-11
ISR,IRL,2016.0,3,1,2
NER,FRA,2000.0,1,1,0
IRL,MYS,2020.0,4,6,-2
BRA,BEL,2001.0,5,8,-3
ARG,CHN,2020.0,2,1,1
TUR,FIN,2015.0,5,3,2
ISR,AUT,2022.0,5,1,4
SRB,SVN,2009.0,4,1,3
ESP,CRI,2006.0,1,1,0
BGD,CHE,2014.0,2,2,0
ARE,TUR,2017.0,3,11,-8
QAT,GRC,2018.0,2,3,-1
IND,YEM,2014.0,2,1,1
IRQ,JOR,2010.0,2,4,-2
FIN,DZA,2021.0,1,1,0
KOR,NZL,2002.0,2,1,1
POL,ISR,2022.0,1,1,0
BIH,SRB,2018.0,3,15,-12
NZL,NPL,2018.0,2,1,1
KEN,NLD,2020.0,5,6,-1
PHL,CHL,2019.0,1,2,-1
ARE,KOR,2021.0,4,10,-6
MOZ,BRA,2013.0,2,3,-1
USA,PNG,2001.0,1,3,-2
HKG,AUS,1997.0,1,8,-7
CHE,CMR,2011.0,3,2,1
TWN,JOR,2015.0,1,1,0
DEU,CRI,2008.0,1,4,-3
VEN,PER,2021.0,2,1,1
GRD,USA,2006.0,1,4,-3
DZA,TUN,2022.0,3,3,0
SRB,BIH,2002.0,1,1,0
IND,LBY,2016.0,2,3,-1
ITA,PHL,2019.0,2,1,1
DEU,QAT,2011.0,3,1,2
LTU,CZE,2022.0,2,2,0
CAN,EGY,2002.0,2,8,-6
AUS,NGA,2008.0,1,1,0
BEL,TWN,2004.0,1,1,0
CMR,CAN,2007.0,1,2,-1
COL,DEU,2010.0,2,8,-6
GHA,NZL,2021.0,1,1,0
QAT,KWT,2019.0,1,2,-1
PAK,GBR,1999.0,3,1,2
IRN,TWN,2011.0,2,1,1
NIC,USA,2006.0,2,1,1
CHN,MAR,2020.0,1,3,-2
FRA,CRI,2017.0,4,1,3
FRA,ARM,2018.0,1,1,0
JOR,AUS,2022.0,1,2,-1
PAK,IRN,2022.0,2,1,1
PSE,DEU,2015.0,4,6,-2
JPN,BGR,2016.0,4,2,2
HUN,AUS,2012.0,3,1,2
GRC,ROU,2002.0,1,2,-1
BRA,AUT,2002.0,2,2,0
ARG,NZL,2016.0,1,1,0
CHE,ARG,2002.0,2,1,1
SRB,NLD,1999.0,1,1,0
RUS,ESP,2015.0,2,7,-5
MEX,VEN,1999.0,1,2,-1
NZL,CHE,1999.0,2,1,1
BRN,DNK,2014.0,1,1,0
FRA,PAK,2004.0,1,1,0
MEX,KEN,2010.0,1,1,0
ISR,NOR,2019.0,3,2,1
COL,KEN,2010.0,1,1,0
PRI,ARG,2008.0,2,1,1
ESP,SRB,2014.0,2,3,-1
VEN,DEU,2006.0,2,1,1
BIH,HRV,2008.0,4,11,-7
COL,KEN,2017.0,2,1,1
GBR,SVN,2012.0,2,5,-3
LIE,CHE,2010.0,2,3,-1
SVN,BEL,2017.0,2,3,-1
BGD,ARE,2021.0,1,1,0
ALB,FRA,2014.0,1,1,0
BEL,SEN,1999.0,1,1,0
IRN,MEX,2018.0,1,2,-1
ISR,BEL,2006.0,2,2,0
TUN,OMN,2006.0,2,1,1
SRB,RUS,2008.0,2,2,0
IRL,ISR,2022.0,1,2,-1
BIH,TUR,2013.0,1,1,0
USA,ECU,2000.0,2,1,1
BEN,DEU,2002.0,1,3,-2
LTU,UKR,2022.0,1,3,-2
KAZ,USA,2006.0,1,2,-1
DEU,GTM,2014.0,1,2,-1
ETH,ITA,2010.0,1,2,-1
SWE,CRI,2020.0,1,2,-1
ARG,URY,2000.0,1,1,0
ESP,KOR,2007.0,2,2,0
FRA,HTI,2018.0,1,1,0
JPN,HUN,2000.0,2,2,0
KOR,THA,2001.0,2,4,-2
IDN,CHN,2016.0,3,1,2
RUS,TUR,2013.0,3,2,1
JPN,ZMB,2006.0,2,3,-1
GHA,CAN,2018.0,2,5,-3
DNK,CYP,2019.0,1,1,0
CHL,CZE,2020.0,1,3,-2
PRT,DNK,2001.0,1,3,-2
NLD,CYP,2013.0,1,1,0
QAT,JOR,2005.0,1,2,-1
OMN,DEU,2007.0,1,1,0
BWA,AUS,2012.0,1,1,0
HKG,BEL,1999.0,1,1,0
NGA,LBR,2018.0,1,1,0
GHA,KEN,2016.0,1,3,-2
ROU,JPN,2005.0,2,5,-3
NOR,MYS,2012.0,1,1,0
CMR,GAB,2015.0,2,1,1
QAT,JOR,2002.0,1,2,-1
SAU,MAR,2008.0,1,1,0
EGY,KAZ,2011.0,1,1,0
ECU,ITA,2012.0,1,1,0
VNM,SGP,2015.0,2,5,-3
PHL,FRA,2020.0,1,4,-3
EGY,TUN,2016.0,1,1,0
COL,ARG,2006.0,2,4,-2
SRB,DNK,2003.0,1,1,0
ESP,BIH,2019.0,1,1,0
GBR,GEO,2010.0,2,1,1
IRN,GBR,1999.0,1,8,-7
URY,ESP,2000.0,1,2,-1
ZWE,CHE,2016.0,3,5,-2
ITA,BGR,2012.0,2,2,0
CUB,COL,2012.0,5,1,4
SLE,CHE,2021.0,1,1,0
FIN,UKR,2015.0,1,5,-4
FRA,OMN,2020.0,1,1,0
CHL,AUT,2015.0,1,3,-2
HKG,DEU,1999.0,1,7,-6
LKA,NOR,2018.0,1,2,-1
ZAF,ISR,2013.0,1,3,-2
SVK,AUS,1999.0,1,1,0
PRI,CHN,1999.0,1,2,-1
DZA,MYS,2018.0,1,1,0
KWT,KOR,2018.0,1,1,0
NOR,IDN,2014.0,1,1,0
TUR,MLT,2022.0,1,1,0
VNM,CZE,2014.0,1,1,0
NLD,SDN,2019.0,1,1,0
URY,DEU,2014.0,1,1,0
MEX,FIN,2014.0,2,1,1
SRB,ITA,2012.0,1,6,-5
AUS,NPL,2018.0,4,9,-5
IDN,THA,2016.0,1,10,-9
GBR,ZMB,2009.0,1,3,-2
DEU,MAR,2019.0,1,5,-4
TGO,MAR,2017.0,1,4,-3
DEU,PER,2007.0,1,3,-2
ISR,POL,2003.0,1,2,-1
RUS,MDA,2018.0,1,2,-1
NZL,BRA,2016.0,1,4,-3
DZA,FIN,2016.0,1,1,0
CHE,URY,2019.0,2,1,1
SRB,MKD,2002.0,1,6,-5
MNG,USA,2020.0,2,2,0
COG,MLI,2015.0,1,1,0
RUS,GRC,2020.0,1,2,-1
USA,GUM,2006.0,1,3,-2
PER,GBR,2003.0,2,1,1
LVA,CHE,2013.0,1,1,0
NPL,NLD,2009.0,1,1,0
PER,DOM,2020.0,1,1,0
DEU,TUN,2010.0,2,1,1
NZL,KEN,2010.0,1,1,0
PRI,CAN,2017.0,1,1,0
IRN,PAK,2011.0,1,2,-1
SAU,IRL,2022.0,2,3,-1
CHL,SRB,2020.0,1,1,0
BGD,MYS,2001.0,1,2,-1
IRL,ECU,2018.0,1,1,0
NOR,EGY,2008.0,1,2,-1
ROU,FIN,2017.0,1,1,0
BEL,ARG,2011.0,1,1,0
NZL,FRA,2011.0,15,18,-3
GBR,ROU,2009.0,17,13,4
USA,TWN,2014.0,285,268,17
AUS,MEX,2017.0,13,8,5
TUR,ESP,2015.0,9,8,1
BRA,ESP,2020.0,104,78,26
ZAF,USA,2008.0,70,58,12
FIN,USA,2003.0,72,88,-16
NGA,ZAF,2012.0,36,23,13
JOR,SAU,2016.0,32,34,-2
CHE,FIN,2015.0,13,19,-6
GBR,JPN,2007.0,90,112,-22
USA,LBR,2015.0,5,1,4
TUN,USA,2018.0,4,3,1
GBR,IND,2004.0,50,98,-48
DZA,SAU,2016.0,6,3,3
CZE,DNK,2012.0,3,1,2
POL,RUS,2002.0,14,14,0
SVN,DEU,2016.0,12,5,7
CAN,CHN,2015.0,262,261,1
NLD,THA,2020.0,13,4,9
CHN,SGP,2020.0,302,387,-85
POL,BRA,2014.0,34,5,29
CAN,ITA,2017.0,46,66,-20
KOR,VNM,2017.0,69,22,47
IRN,AUT,2020.0,28,3,25
JPN,TWN,2021.0,46,34,12
CAN,GBR,1999.0,100,92,8
KAZ,DEU,2021.0,5,5,0
VNM,ARE,2020.0,1,1,0
MEX,ECU,2021.0,3,4,-1
BEL,PHL,2019.0,3,3,0
USA,HUN,2006.0,60,57,3
SWE,ESP,2020.0,65,66,-1
TUR,DEU,2017.0,58,41,17
USA,JOR,2006.0,34,11,23
DEU,SVK,2012.0,12,12,0
KOR,AUS,2012.0,32,13,19
ISR,CHE,2015.0,17,17,0
GBR,PAK,2018.0,80,50,30
CHN,ESP,2013.0,24,15,9
ARE,MYS,2011.0,1,1,0
USA,PAN,2015.0,10,13,-3
GBR,FRA,2000.0,88,94,-6
NLD,ETH,2019.0,13,7,6
SAU,BHR,2018.0,4,3,1
BFA,AUT,2019.0,2,1,1
TUR,SWE,2020.0,25,7,18
CAN,DNK,2006.0,13,19,-6
FRA,ECU,2021.0,5,2,3
ETH,ITA,2017.0,6,2,4
ITA,TUN,2015.0,9,3,6
MEX,SGP,2004.0,1,1,0
SWE,IRL,2009.0,14,8,6
KOR,NLD,2005.0,2,6,-4
FIN,HUN,2017.0,1,2,-1
BFA,FRA,2002.0,6,11,-5
SWE,POL,2013.0,12,13,-1
NZL,TUR,2003.0,1,1,0
FIN,SAU,2016.0,2,1,1
USA,ARG,1998.0,13,23,-10
TWN,USA,1998.0,20,66,-46
PRT,FIN,2018.0,6,2,4
ARE,USA,2002.0,12,20,-8
USA,ARG,1997.0,10,7,3
USA,CRI,2012.0,12,11,1
SWE,SRB,2012.0,1,3,-2
NOR,IRL,2016.0,3,6,-3
SGP,PHL,2012.0,1,3,-2
AUT,BRA,2008.0,5,3,2
DEU,EST,2018.0,8,9,-1
TZA,NLD,2010.0,3,3,0
BEL,PHL,2017.0,2,3,-1
CAN,MEX,2013.0,24,29,-5
SWE,AUS,2001.0,18,14,4
POL,PAK,2015.0,1,1,0
RUS,DNK,2018.0,7,5,2
BEL,GHA,2020.0,1,3,-2
DNK,RUS,2021.0,4,9,-5
ITA,ZAF,2001.0,3,2,1
IRQ,JOR,2017.0,3,6,-3
CHL,NZL,2004.0,3,1,2
NZL,AUT,2011.0,2,3,-1
SAU,TUR,2017.0,7,12,-5
GBR,COL,2017.0,16,16,0
DEU,SAU,2011.0,18,3,15
JPN,POL,2004.0,7,5,2
POL,CAN,2009.0,11,11,0
ESP,CHN,2009.0,4,10,-6
DEU,EGY,1997.0,5,1,4
BRA,IND,2003.0,5,2,3
COL,PRT,2018.0,4,2,2
TUR,DNK,2011.0,2,2,0
SGP,CAN,2013.0,19,22,-3
THA,SGP,2018.0,4,6,-2
NPL,DEU,2022.0,1,1,0
EST,CAN,2003.0,1,2,-1
NOR,KEN,2018.0,3,1,2
TUR,JPN,2008.0,1,8,-7
FIN,IRL,2013.0,2,4,-2
POL,CHN,2010.0,1,8,-7
NLD,ETH,2010.0,3,3,0
DEU,TZA,2014.0,6,3,3
SWE,MEX,2018.0,4,14,-10
FRA,SDN,2015.0,2,1,1
KOR,LAO,2020.0,1,1,0
CHN,CHE,1999.0,3,2,1
RUS,ROU,2018.0,1,3,-2
CHN,GRC,2022.0,3,1,2
AUS,MEX,2010.0,7,8,-1
NLD,POL,2009.0,14,13,1
KOR,IND,2005.0,10,67,-57
AUT,GEO,2020.0,1,1,0
ITA,SWE,1998.0,7,10,-3
LBN,EGY,2005.0,1,1,0
CZE,RUS,1997.0,1,1,0
CUB,FRA,2016.0,6,3,3
SRB,BEL,2021.0,3,1,2
KAZ,SAU,2020.0,2,3,-1
ZAF,PRT,2003.0,4,1,3
HUN,JPN,2006.0,4,5,-1
CHN,MYS,2015.0,6,18,-12
KOR,HKG,2009.0,1,5,-4
SGP,IRN,2014.0,5,9,-4
LIE,CHE,2019.0,3,5,-2
SGP,ISR,2015.0,5,4,1
DNK,VNM,2017.0,1,3,-2
SAU,TUR,2010.0,2,3,-1
MCO,AUS,2015.0,1,1,0
FIN,TWN,2019.0,1,1,0
DEU,SDN,2015.0,4,2,2
IRL,GRC,2003.0,3,1,2
DOM,USA,2005.0,1,4,-3
IRL,CZE,2017.0,1,4,-3
POL,ROU,2007.0,1,4,-3
NOR,HRV,2016.0,1,1,0
DEU,MAR,2010.0,1,1,0
PAN,IND,2017.0,1,1,0
BFA,FRA,2005.0,5,6,-1
POL,BEL,2012.0,6,21,-15
BEL,KAZ,2016.0,1,1,0
EGY,CZE,2020.0,2,2,0
AUT,BGD,2003.0,1,1,0
FIN,HUN,2010.0,1,2,-1
IRL,CZE,2019.0,4,3,1
EGY,QAT,2001.0,2,1,1
BEN,BEL,2010.0,1,3,-2
FRA,BEN,2001.0,3,1,2
CHN,HUN,2017.0,3,3,0
SGP,TUR,2011.0,1,2,-1
SAU,NLD,2012.0,1,4,-3
USA,CIV,2012.0,2,1,1
KEN,JPN,2018.0,2,5,-3
RWA,BDI,2019.0,1,1,0
ESP,URY,2007.0,1,8,-7
NGA,BRN,2020.0,1,1,0
SWE,BGD,2022.0,1,4,-3
MEX,GTM,2019.0,3,3,0
TZA,AUS,2007.0,1,1,0
MYS,FRA,2007.0,2,5,-3
HKG,ESP,2000.0,1,1,0
FIN,SVK,2016.0,1,1,0
SVK,UKR,2020.0,1,3,-2
CRI,CHL,2013.0,1,2,-1
MAR,NLD,2016.0,1,2,-1
FIN,PRT,2009.0,1,2,-1
BRN,USA,2014.0,1,2,-1
KOR,ITA,1999.0,1,2,-1
MAC,AUS,2010.0,1,1,0
BEL,SYR,2005.0,1,1,0
TUR,,2024.0,49974,0,49974
KOR,,2024.0,78097,0,78097
ESP,,2023.0,57082,0,57082
CAN,,2024.0,76779,0,76779
ITA,,2011.0,6680,0,6680
DEU,,2022.0,40200,0,40200
NZL,,2010.0,608,0,608
,ARM,2002.0,130,0,130
BIH,,2024.0,968,0,968
CHN,,2015.0,57493,0,57493
,FIN,2004.0,2044,0,2044
BLR,,2017.0,218,0,218
BEL,,2020.0,3777,0,3777
CZE,,2021.0,3644,0,3644
,ITA,2012.0,14711,0,14711
,FRA,1994.0,16929,0,16929
SVK,,2023.0,4256,0,4256
,CAN,1998.0,17626,0,17626
BRA,,2003.0,555,0,555
MLI,,2024.0,244,0,244
,DEU,2012.0,23764,0,23764
,CAN,1997.0,3457,0,3457
IND,,2015.0,12295,0,12295
,MEX,2006.0,3786,0,3786
,BEL,2009.0,3337,0,3337
NZL,,2017.0,1098,0,1098
AUS,,2014.0,4450,0,4450
,RUS,2011.0,10600,0,10600
SGP,,2018.0,1688,0,1688
TWN,,2021.0,7591,0,7591
JPN,,2006.0,15010,0,15010
,KOR,2007.0,12681,0,12681
ISL,,2023.0,674,0,674
VNM,,2014.0,178,0,178
SWE,,2015.0,2487,0,2487
,IRL,1994.0,600,0,600
MEX,,2009.0,997,0,997
,NOR,1998.0,3051,0,3051
,TUN,2003.0,931,0,931
BLR,,2010.0,170,0,170
UGA,,2010.0,30,0,30
DNK,,2008.0,855,0,855
HRV,,2020.0,1157,0,1157
,FIN,1996.0,1274,0,1274
NZL,,2019.0,1450,0,1450
LKA,,2023.0,1174,0,1174
CUB,,2021.0,737,0,737
,KEN,2012.0,520,0,520
AZE,,2020.0,226,0,226
CMR,,2020.0,257,0,257
,PHL,2007.0,265,0,265
MDA,,2009.0,13,0,13
,NLD,2018.0,5276,0,5276
LTU,,2018.0,461,0,461
UGA,,2017.0,106,0,106
,LBN,2005.0,224,0,224
PSE,,2011.0,18,0,18
,DZA,1995.0,81,0,81
,GTM,2006.0,16,0,16
,NOR,1997.0,573,0,573
SYR,ARE,2017.0,1,0,1
,BFA,1997.0,31,0,31
,PAK,2013.0,3032,0,3032
,HRV,2013.0,849,0,849
,SVK,2011.0,1116,0,1116
,PSE,2010.0,68,0,68
,VNM,2007.0,388,0,388
UGA,,2019.0,222,0,222
LVA,,2021.0,282,0,282
,IDN,2018.0,6231,0,6231
BLR,,2019.0,267,0,267
CMR,GBR,2018.0,4,0,4
ECU,,2016.0,54,0,54
,TZA,2002.0,137,0,137
EGY,LKA,2017.0,1,0,1
GNQ,ESP,2016.0,1,0,1
SUR,,2018.0,11,0,11
,LBN,2002.0,184,0,184
,MUS,2017.0,34,0,34
FIN,,2007.0,897,0,897
USA,KNA,2015.0,3,0,3
IRQ,,2018.0,136,0,136
,ALB,2014.0,62,0,62
ZWE,ETH,2020.0,1,0,1
,ETH,1998.0,130,0,130
MYS,ZAF,2018.0,2,0,2
,QAT,2018.0,554,0,554
ETH,IDN,2018.0,2,0,2
,PSE,2017.0,132,0,132
FRA,MRT,2021.0,1,0,1
,PSE,2019.0,97,0,97
,MUS,2010.0,35,0,35
SEN,,2014.0,59,0,59
BTN,,2023.0,64,0,64
,LVA,1999.0,188,0,188
TWN,BLZ,2017.0,1,0,1
,ARM,2005.0,125,0,125
,PYF,2006.0,9,0,9
MLT,,2018.0,48,0,48
LIE,,2021.0,13,0,13
ESP,EST,2014.0,3,0,3
JOR,KWT,2015.0,3,0,3
FJI,ESP,2021.0,1,0,1
DNK,GHA,2015.0,1,0,1
,DOM,2011.0,19,0,19
,GNB,2013.0,1,0,1
,MLI,2003.0,36,0,36
CHE,MDG,2014.0,1,0,1
ROU,TUN,2018.0,1,0,1
SWE,CMR,2013.0,3,0,3
DNK,VNM,2019.0,9,0,9
,MKD,2000.0,60,0,60
PYF,NCL,2007.0,1,0,1
LBY,GBR,2002.0,3,0,3
,GEO,2001.0,92,0,92
BGR,LBN,2021.0,2,0,2
,TZA,2005.0,175,0,175
CYP,,2012.0,43,0,43
,PAN,2001.0,19,0,19
ARG,,1999.0,32,0,32
ZAF,IRN,2004.0,4,0,4
CAN,THA,1998.0,1,0,1
MNG,,2007.0,6,0,6
NPL,AUS,1998.0,1,0,1
,MDG,2003.0,43,0,43
CMR,KEN,2020.0,3,0,3
ETH,,2007.0,26,0,26
,GUY,1998.0,5,0,5
VEN,,2005.0,177,0,177
,ERI,1994.0,1,0,1
VEN,,2002.0,41,0,41
COG,BFA,2007.0,1,0,1
,BFA,1998.0,52,0,52
USA,DOM,2004.0,1,0,1
KEN,BFA,2013.0,1,0,1
AUT,TZA,2010.0,1,0,1
IRL,KNA,2013.0,1,0,1
LSO,,2007.0,1,0,1
BGD,,2004.0,34,0,34
KAZ,,2014.0,38,0,38
GUM,,2013.0,1,0,1
KGZ,,2018.0,8,0,8
CIV,,2006.0,13,0,13
NLD,JOR,2007.0,1,0,1
,KAZ,2009.0,147,0,147
DOM,,2016.0,14,0,14
MAR,SWE,2019.0,3,0,3
AUS,HRV,2006.0,3,0,3
BEN,GAB,2002.0,1,0,1
THA,RUS,2005.0,1,0,1
,GIN,1998.0,8,0,8
DEU,VNM,1998.0,1,0,1
NOR,MEX,2007.0,1,0,1
SRB,JPN,1999.0,2,0,2
TUR,EGY,1999.0,1,0,1
BLR,DNK,2005.0,3,0,3
DNK,GRL,2000.0,1,0,1
USA,BLZ,2003.0,1,0,1
JPN,FJI,2015.0,3,0,3
KWT,NLD,2003.0,1,0,1
RUS,NOR,2000.0,6,0,6
,GRD,2005.0,9,0,9
GHA,LBR,2018.0,1,0,1
CHN,UKR,2006.0,1,0,1
CHE,LUX,2002.0,2,0,2
ISL,LUX,2014.0,2,0,2
FRA,IDN,1998.0,1,0,1
,NCL,2010.0,22,0,22
UKR,MEX,2015.0,2,0,2
SAU,RWA,2011.0,1,0,1
MUS,DNK,2021.0,1,0,1
NZL,SAU,2012.0,2,0,2
,BRN,2008.0,21,0,21
USA,MLT,2011.0,2,0,2
BLZ,,2014.0,2,0,2
HRV,NLD,2002.0,2,0,2
ESP,JOR,2015.0,3,0,3
IND,TTO,2022.0,1,0,1
IRL,SDN,2017.0,2,0,2
SRB,IND,2016.0,2,0,2
VNM,KHM,2016.0,1,0,1
MDA,ROU,2004.0,2,0,2
AUT,TUN,2004.0,1,0,1
BLR,BRA,2015.0,1,0,1
NLD,SDN,2017.0,3,0,3
,LSO,2014.0,13,0,13
VEN,DOM,2020.0,2,0,2
MAC,AUS,2019.0,4,0,4
VNM,GMB,2021.0,1,0,1
,LIE,2013.0,10,0,10
BIH,PAK,2009.0,1,0,1
PRI,ROU,2007.0,1,0,1
GEO,,2000.0,6,0,6
KWT,SGP,2007.0,1,0,1
,YEM,2007.0,30,0,30
HKG,ITA,2013.0,1,0,1
ATA,DEU,2001.0,1,0,1
IDN,VNM,2013.0,1,0,1
,RWA,2009.0,67,0,67
GRC,QAT,2016.0,8,0,8
,GUM,2003.0,4,0,4
JPN,KAZ,2015.0,1,0,1
TWN,HRV,2010.0,2,0,2
MWI,UGA,2020.0,2,0,2
,COD,2000.0,6,0,6
,SLV,2013.0,14,0,14
ESP,SLV,2021.0,1,0,1
NOR,KWT,2019.0,1,0,1
VEN,SAU,2019.0,1,0,1
PRI,AUS,2015.0,1,0,1
GIN,MLI,2018.0,3,0,3
BEL,LBY,2010.0,1,0,1
,MUS,2019.0,17,0,17
MNG,NLD,2020.0,1,0,1
,NCL,2017.0,6,0,6
EGY,LBY,2022.0,3,0,3
NZL,THA,2021.0,7,0,7
IND,BHR,2022.0,4,0,4
FRA,ETH,2012.0,2,0,2
BGR,OMN,2008.0,1,0,1
HRV,NLD,2005.0,2,0,2
CHE,LKA,2004.0,1,0,1
SYC,,2007.0,3,0,3
MAC,AUS,2017.0,2,0,2
HUN,PRT,2001.0,1,0,1
ITA,GEO,2015.0,1,0,1
THA,RUS,2002.0,1,0,1
RUS,FLK,1999.0,1,0,1
ZWE,SWE,2001.0,1,0,1
GHA,CHN,2007.0,1,0,1
DZA,POL,2001.0,1,0,1
IRN,ESP,2004.0,1,0,1
POL,DZA,1999.0,1,0,1
GRC,COL,2021.0,1,0,1
FIN,QAT,2016.0,4,0,4
PRK,,2009.0,1,0,1
NGA,EGY,2011.0,1,0,1
,ETH,1997.0,15,0,15
COL,RUS,2021.0,3,0,3
POL,TUN,2014.0,4,0,4
BGR,PRT,2010.0,4,0,4
COL,ZAF,2002.0,1,0,1
GHA,JPN,2012.0,1,0,1
ARG,VEN,2007.0,3,0,3
MEX,ISL,2019.0,3,0,3
MKD,BEL,2019.0,3,0,3
SYC,GBR,2007.0,1,0,1
BFA,AUT,2017.0,1,0,1
MKD,GRC,2018.0,1,0,1
NAM,GBR,2021.0,1,0,1
MOZ,CHE,2017.0,4,0,4
ITA,ECU,2019.0,6,0,6
BOL,DEU,2021.0,1,0,1
PAK,POL,2021.0,7,0,7
SGP,PAK,2022.0,4,0,4
GMB,,2016.0,6,0,6
NCL,DEU,2015.0,1,0,1
CHE,GIN,2019.0,1,0,1
SVK,IND,2009.0,1,0,1
NIC,ESP,2006.0,2,0,2
PHL,CHL,2010.0,3,0,3
CHE,LUX,2005.0,2,0,2
MDG,TUR,2008.0,1,0,1
SGP,DNK,2011.0,3,0,3
FRA,BHR,2017.0,1,0,1
SLB,,2020.0,13,0,13
,SHN,2013.0,1,0,1
TUR,ZAF,2020.0,3,0,3
BRB,,2016.0,3,0,3
DEU,LIE,1998.0,1,0,1
PNG,GBR,2017.0,3,0,3
RWA,CAN,2012.0,1,0,1
SYR,ARE,2019.0,2,0,2
FRA,CRI,2019.0,4,0,4
OMN,CYP,2021.0,1,0,1
USA,BRB,2004.0,3,0,3
AUS,JAM,2016.0,2,0,2
ARE,FIN,2014.0,2,0,2
IND,CYP,2021.0,3,0,3
HKG,HRV,2017.0,1,0,1
UKR,HUN,2005.0,3,0,3
FRA,IDN,1997.0,1,0,1
ARE,UKR,2014.0,1,0,1
PRT,JPN,2004.0,1,0,1
PRY,COL,2008.0,2,0,2
IRN,SYR,2009.0,1,0,1
MUS,NOR,2005.0,1,0,1
LUX,TUR,2008.0,1,0,1
CZE,ARE,2012.0,2,0,2
NOR,NGA,2006.0,1,0,1
NZL,NCL,2016.0,1,0,1
NCL,NZL,2020.0,1,0,1
EGY,FIN,1999.0,1,0,1
SWE,SAU,2000.0,2,0,2
POL,CHL,2005.0,1,0,1
,GUY,1997.0,1,0,1
BWA,TLS,2014.0,1,0,1
AUS,COG,2006.0,2,0,2
CAN,SVK,2005.0,1,0,1
MAR,DEU,2005.0,1,0,1
TUN,SAU,2005.0,1,0,1
MEX,GTM,2010.0,2,0,2
CMR,GMB,2008.0,1,0,1
SMR,,2023.0,7,0,7
KOR,BRN,2015.0,1,0,1
DEU,KAZ,2010.0,3,0,3
NOR,,2025.0,2,0,2
BGD,IRL,2009.0,2,0,2
TUN,CHN,2019.0,11,0,11
COD,JPN,2022.0,1,0,1
BGD,EGY,2015.0,2,0,2
TUN,AUT,2008.0,1,0,1
CZE,NPL,2015.0,1,0,1
TCD,,2020.0,13,0,13
UZB,LTU,1998.0,1,0,1
IRL,BGD,2004.0,1,0,1
TWN,CHE,2000.0,1,0,1
KHM,NLD,2011.0,1,0,1
FIN,TWN,2017.0,2,0,2
MDG,ZAF,2012.0,2,0,2
NGA,BEN,2022.0,2,0,2
,SLB,2014.0,8,0,8
DNK,CHL,2003.0,1,0,1
HKG,SAU,2005.0,2,0,2
UZB,DEU,2003.0,2,0,2
IRN,UZB,2006.0,1,0,1
BLR,DNK,2002.0,1,0,1
CRI,BRA,2011.0,2,0,2
NZL,QAT,2009.0,1,0,1
AUT,TWN,2009.0,2,0,2
TUN,DEU,2011.0,2,0,2
BEL,ECU,2004.0,2,0,2
NOR,LUX,2012.0,2,0,2
CAN,MKD,2001.0,1,0,1
BGR,ARE,2017.0,1,0,1
IRN,THA,2021.0,2,0,2
KGZ,CHE,2018.0,2,0,2
BEL,GAB,2013.0,1,0,1
PER,COD,2018.0,1,0,1
CIV,ITA,2009.0,2,0,2
IRL,BRA,2001.0,1,0,1
,GRD,2002.0,3,0,3
DNK,CYP,2017.0,1,0,1
AUT,LVA,2015.0,1,0,1
FIN,IDN,2009.0,1,0,1
BGR,PRT,2017.0,1,0,1
SWE,BHR,2016.0,1,0,1
THA,LKA,2020.0,5,0,5
RUS,BGD,2015.0,1,0,1
SAU,THA,2022.0,1,0,1
GRC,BGD,2018.0,1,0,1
AUS,CYP,2020.0,3,0,3
FIN,ETH,2016.0,2,0,2
MDV,ARE,2016.0,1,0,1
CYP,IRQ,2020.0,2,0,2
CYP,ETH,2022.0,1,0,1
PRT,NOR,2022.0,1,0,1
KWT,SRB,2019.0,1,0,1
PNG,NZL,2015.0,1,0,1
POL,VNM,2010.0,2,0,2
HUN,BEL,2012.0,9,0,9
COD,CAN,2021.0,1,0,1
,SUR,2013.0,14,0,14
USA,TJK,2013.0,1,0,1
IND,HUN,2003.0,1,0,1
VNM,THA,1998.0,1,0,1
FRA,CUB,2000.0,3,0,3
PHL,NGA,2014.0,1,0,1
DEU,BRB,2021.0,2,0,2
,FSM,2006.0,2,0,2
LTU,GRC,2012.0,2,0,2
BEN,ESP,2013.0,1,0,1
CHN,MLI,2017.0,1,0,1
KGZ,TUR,2009.0,1,0,1
BEL,KWT,2015.0,1,0,1
IRN,KWT,2013.0,1,0,1
NLD,LBN,2022.0,1,0,1
HRV,TUR,2020.0,1,0,1
ESP,CYP,2000.0,1,0,1
MDA,HUN,1997.0,1,0,1
ETH,TGO,2022.0,1,0,1
CHE,BFA,2011.0,1,0,1
,MHL,1998.0,4,0,4
CAN,NGA,1999.0,2,0,2
GRC,LTU,2001.0,1,0,1
DEU,MNG,1999.0,1,0,1
KAZ,GBR,1999.0,1,0,1
POL,CHL,2002.0,2,0,2
BGR,ARE,2019.0,1,0,1
AUS,GIB,2016.0,1,0,1
TUN,CUB,2001.0,2,0,2
NLD,BOL,2009.0,1,0,1
ROU,GRC,2005.0,2,0,2
POL,PAN,2003.0,1,0,1
SVN,GRC,2016.0,1,0,1
PRT,CHL,2022.0,2,0,2
SYC,CHE,2016.0,1,0,1
SWE,LIE,2019.0,1,0,1
CAN,BEN,2016.0,3,0,3
MAR,NOR,2012.0,1,0,1
ISR,NOR,2017.0,1,0,1
SDN,SVK,2017.0,1,0,1
MYS,MAC,2017.0,1,0,1
BRA,JPN,2022.0,2,0,2
BGR,AUS,2005.0,2,0,2
NZL,OMN,2009.0,2,0,2
ISR,CYP,2001.0,1,0,1
NGA,NAM,2003.0,1,0,1
ZMB,,2009.0,8,0,8
VEN,ARG,2004.0,2,0,2
VNM,TTO,2014.0,1,0,1
VEN,FIN,2015.0,1,0,1
BWA,SWE,1999.0,1,0,1
SWZ,ZWE,2005.0,1,0,1
LVA,ESP,2000.0,1,0,1
HRV,IRL,2020.0,2,0,2
CZE,AUS,2001.0,1,0,1
ARE,MLT,2018.0,1,0,1
ARG,NGA,2016.0,1,0,1
RUS,TKM,1997.0,1,0,1
NAM,BWA,2007.0,1,0,1
LVA,AUS,2013.0,1,0,1
THA,KAZ,2018.0,1,0,1
GRC,DZA,2012.0,1,0,1
LIE,CHE,2017.0,1,0,1
FRO,GBR,2013.0,1,0,1
DNK,BOL,2010.0,1,0,1
CHL,ZMB,2013.0,1,0,1
UZB,CHE,2018.0,1,0,1
EGY,GHA,2017.0,1,0,1
WSM,,2014.0,2,0,2
UKR,DNK,2021.0,1,0,1
COL,UGA,2019.0,1,0,1
IRN,GEO,2021.0,1,0,1
GIN,PNG,2021.0,1,0,1
COL,ECU,2004.0,1,0,1
GHA,MYS,2012.0,2,0,2
PAK,MOZ,2005.0,1,0,1
JOR,PAK,2005.0,2,0,2
CHL,PAK,2019.0,1,0,1
RWA,CIV,2020.0,1,0,1
BEL,ISL,2018.0,1,0,1
BRA,MCO,2016.0,1,0,1
NOR,IRQ,2014.0,1,0,1
IRL,LBN,2009.0,1,0,1
LAO,VNM,2012.0,2,0,2
GRC,CHN,1997.0,1,0,1
ISL,AUT,2015.0,1,0,1
LBN,KWT,2015.0,2,0,2
COL,TZA,2016.0,1,0,1
BEN,DNK,2018.0,1,0,1
GAB,AUT,2016.0,1,0,1
ERI,CHN,2017.0,1,0,1
URY,,2000.0,3,0,3
GBR,MUS,1998.0,1,0,1
FRA,SAU,2005.0,1,0,1
VNM,BLR,2022.0,1,0,1
SVN,NOR,2002.0,1,0,1
USA,ATG,2016.0,1,0,1
VEN,SWE,2016.0,2,0,2
GAB,OMN,2013.0,1,0,1
NGA,RWA,2021.0,1,0,1
DEU,TGO,2005.0,1,0,1
GMB,KEN,2011.0,1,0,1
MYS,PNG,2012.0,2,0,2
PER,IND,2012.0,1,0,1
DNK,NPL,2006.0,1,0,1
LAO,IDN,2017.0,1,0,1
TUN,SRB,2018.0,1,0,1
NLD,PRI,2006.0,1,0,1
PAK,ALB,2018.0,1,0,1
DZA,QAT,2015.0,2,0,2
NLD,BFA,2002.0,1,0,1
PNG,VUT,2021.0,1,0,1
TUR,SVN,2022.0,1,0,1
HKG,KWT,2007.0,1,0,1
CMR,ZAF,2011.0,2,0,2
BGD,THA,1999.0,2,0,2
PAN,IND,2019.0,1,0,1
ROU,ETH,2015.0,1,0,1
NGA,AUS,2004.0,3,0,3
MNG,JPN,2006.0,2,0,2
ETH,CHE,2008.0,1,0,1
EGY,SYR,2008.0,1,0,1
TZA,CAN,2006.0,1,0,1
SVN,KOR,2015.0,1,0,1
PAN,ITA,2006.0,1,0,1
VUT,MDG,2017.0,1,0,1
CUB,QAT,2017.0,1,0,1
SVN,SLV,2017.0,1,0,1
MWI,NLD,2018.0,2,0,2
MKD,BEL,2017.0,1,0,1
,NCL,2019.0,3,0,3
RWA,NGA,2016.0,1,0,1
THA,MAC,2020.0,1,0,1
ESP,ZAF,2001.0,2,0,2
GMB,DEU,2007.0,1,0,1
HRV,ISR,2015.0,1,0,1
ZWE,SWZ,2013.0,1,0,1
GBR,GRD,2022.0,1,0,1
AUT,BIH,2021.0,1,0,1
TUN,DZA,2010.0,1,0,1
BEN,TWN,2017.0,1,0,1
JPN,MAR,2015.0,2,0,2
PHL,BGD,2000.0,1,0,1
POL,EGY,2009.0,2,0,2
GRC,JOR,2006.0,1,0,1
PAK,UGA,2014.0,1,0,1
NOR,BFA,2020.0,1,0,1
NLD,EST,2021.0,1,0,1
TUR,JOR,2012.0,1,0,1
VEN,BEL,2015.0,1,0,1
MKD,CHE,2012.0,1,0,1
UGA,TZA,2010.0,2,0,2
,COM,2018.0,1,0,1
IRN,UKR,2021.0,1,0,1
AUT,KEN,2022.0,1,0,1
KHM,CHE,2005.0,1,0,1
URY,GBR,2006.0,1,0,1
RWA,SAU,2016.0,1,0,1
TUR,OMN,2001.0,1,0,1
PER,SWE,2001.0,1,0,1
GRC,HRV,2013.0,1,0,1
RUS,LKA,2022.0,1,0,1
IND,ARG,2008.0,1,0,1
BEL,IRN,2004.0,1,0,1
ISR,GRC,1998.0,1,0,1
SVK,LBY,2011.0,1,0,1
CRI,SWE,2009.0,1,0,1
SRB,KOR,2003.0,1,0,1
SEN,GUF,1998.0,1,0,1
DNK,SVK,2018.0,1,0,1
ARE,KWT,1998.0,1,0,1
VEN,JPN,2000.0,2,0,2
TUN,CHN,2017.0,1,0,1
ETH,FJI,2020.0,1,0,1
PNG,FJI,2022.0,1,0,1
DNK,SGP,2003.0,1,0,1
JPN,TZA,2011.0,1,0,1
FLK,,2006.0,1,0,1
BEL,MMR,2008.0,1,0,1
CZE,IRL,2002.0,1,0,1
KOR,MEX,2022.0,1,0,1
PRT,UKR,2005.0,1,0,1
IRL,KAZ,2013.0,1,0,1
KAZ,FRA,1999.0,1,0,1
LBY,GRC,2011.0,1,0,1
VIR,USA,2006.0,1,0,1
BOL,CRI,2017.0,1,0,1
CAN,LAO,2012.0,1,0,1
IRL,NAM,2015.0,1,0,1
AFG,HKG,2015.0,1,0,1
ARM,ESP,2018.0,2,0,2
COL,LUX,2021.0,1,0,1
ERI,,2005.0,2,0,2
BEL,TZA,2008.0,2,0,2
POL,VNM,2017.0,1,0,1
DEU,KWT,2020.0,1,0,1
CUB,ETH,2016.0,1,0,1
GBR,RWA,2010.0,1,0,1
SGP,ZWE,2006.0,1,0,1
CAN,GEO,2014.0,1,0,1
ISR,ETH,2001.0,1,0,1
USA,ALB,2008.0,1,0,1
MOZ,ZAF,2022.0,1,0,1
RWA,BDI,2017.0,1,0,1
HRV,BRA,2002.0,1,0,1
IDN,TWN,2009.0,1,0,1
TWN,UZB,2017.0,1,0,1
FJI,USA,2018.0,1,0,1
ARG,TWN,2021.0,1,0,1
NLD,PHL,2008.0,2,0,2
,ECU,2020.0,1,0,1
UKR,GEO,2007.0,2,0,2
TUN,KWT,2019.0,1,0,1
VGB,TTO,2009.0,1,0,1
MNG,CHE,2008.0,1,0,1
FRA,LVA,2002.0,1,0,1
NLD,FLK,2006.0,1,0,1
SAU,NOR,2003.0,1,0,1
LBY,CZE,2006.0,1,0,1
QAT,EGY,1997.0,2,0,2
ESP,NOR,1999.0,1,0,1
SAU,SWE,2004.0,1,0,1
DNK,BEL,1999.0,1,0,1
SYR,EGY,1997.0,1,0,1
BWA,NAM,1998.0,1,0,1
TUR,SYR,2019.0,1,0,1
ARM,BEL,2011.0,1,0,1
ROU,CHN,2003.0,1,0,1
LKA,MMR,2008.0,1,0,1
TZA,QAT,2019.0,1,0,1
ZAF,LVA,2022.0,1,0,1
PRI,CHL,2007.0,1,0,1
NOR,NAM,2019.0,1,0,1
NGA,PNG,2003.0,1,0,1
GRC,LVA,2005.0,1,0,1
OMN,ARE,2007.0,1,0,1
PRY,CZE,2017.0,1,0,1
MLT,BRA,2018.0,1,0,1
GHA,MLI,2015.0,1,0,1
PNG,KHM,2016.0,1,0,1
VEN,NOR,2007.0,1,0,1
TUN,DNK,2011.0,2,0,2
SWE,ARM,2012.0,1,0,1
YEM,GBR,2020.0,1,0,1
ZWE,NLD,2019.0,1,0,1
PRT,SRB,2017.0,1,0,1
,KNA,1996.0,1,0,1
MYS,AUS,2023.0,1,0,1
ETH,COG,2007.0,1,0,1
NGA,MYS,2006.0,1,0,1
BFA,AUT,2010.0,1,0,1
ETH,FIN,2022.0,1,0,1
NLD,SDN,2010.0,1,0,1
DNK,ARG,2008.0,1,0,1
KOR,KWT,2016.0,1,0,1
NCL,SWE,2016.0,1,0,1
VNM,HKG,2018.0,1,0,1
TZA,SLE,2019.0,1,0,1
DEU,GUM,2009.0,1,0,1
AUS,LBY,2015.0,1,0,1
DNK,FRO,2014.0,1,0,1
LBN,CYP,2022.0,1,0,1
ITA,PHL,2010.0,1,0,1
LAO,IDN,2019.0,1,0,1
FRA,DJI,2022.0,1,0,1
KOR,MMR,2021.0,1,0,1
ETH,LTU,2020.0,1,0,1
DEU,CHN,2014.0,240,326,-86
USA,CHN,2007.0,829,1196,-367
USA,CAN,2011.0,1317,1517,-200
RUS,CZE,2017.0,18,7,11
JPN,IDN,2015.0,142,28,114
ISR,RUS,2004.0,12,10,2
NLD,DEU,2015.0,288,271,17
SWE,POL,2008.0,17,19,-2
ROU,SWE,2017.0,12,3,9
GBR,PAK,2019.0,64,72,-8
GRC,GBR,2008.0,106,180,-74
GHA,ZAF,2012.0,4,3,1
COL,FRA,2013.0,15,12,3
GBR,PAK,2017.0,70,62,8
FRA,BEL,2009.0,179,136,43
GBR,CHN,2006.0,112,114,-2
CHN,ESP,2008.0,9,5,4
GBR,PAK,2010.0,38,29,9
DEU,AUT,2007.0,288,175,113
USA,GRC,2017.0,58,120,-62
ESP,COL,2013.0,86,42,44
ZAF,USA,2013.0,95,87,8
GBR,ESP,2011.0,270,252,18
GBR,SAU,2010.0,62,24,38
CHN,NLD,2010.0,40,25,15
CAN,MEX,2008.0,22,22,0
BRA,JPN,2016.0,9,20,-11
USA,IRL,2013.0,111,128,-17
NLD,ISR,2011.0,5,11,-6
THA,AUS,2005.0,5,24,-19
BRA,AUS,2016.0,42,39,3
GRC,NOR,2020.0,9,3,6
KOR,GBR,2010.0,32,47,-15
IND,NZL,2003.0,4,9,-5
DEU,ESP,2013.0,153,203,-50
GBR,GHA,2012.0,20,5,15
ISR,IND,2012.0,15,17,-2
ITA,GBR,2013.0,386,227,159
USA,GRC,2019.0,74,106,-32
FRA,NLD,2006.0,87,77,10
ESP,BRA,2014.0,100,54,46
GBR,IND,2014.0,147,121,26
ESP,USA,2009.0,360,338,22
ITA,FRA,1999.0,87,66,21
BRA,DEU,2013.0,86,76,10
USA,TWN,2004.0,255,179,76
DEU,NLD,2011.0,220,230,-10
CHE,GBR,2006.0,148,133,15
USA,TUR,2003.0,204,115,89
USA,FRA,2020.0,587,709,-122
KOR,VNM,2018.0,100,27,73
FRA,RUS,2014.0,47,60,-13
CHE,COL,2011.0,3,5,-2
USA,IRN,2008.0,40,107,-67
FIN,ITA,2017.0,11,22,-11
ESP,SWE,2009.0,30,24,6
DEU,EST,2010.0,4,6,-2
TZA,GBR,2020.0,9,2,7
MEX,ESP,2011.0,96,102,-6
SWE,FIN,2013.0,42,45,-3
JPN,FRA,2012.0,68,61,7
GRC,USA,2015.0,128,77,51
FRA,NOR,2014.0,31,18,13
SWE,ETH,2009.0,3,4,-1
USA,KEN,2008.0,35,22,13
MEX,USA,1998.0,21,26,-5
FRA,GBR,2002.0,320,296,24
JPN,BRA,2004.0,6,10,-4
AUS,NOR,2004.0,6,6,0
GBR,THA,2020.0,92,38,54
ZAF,ZWE,2014.0,15,26,-11
IRN,MYS,2015.0,37,122,-85
USA,BGD,2020.0,65,103,-38
TUR,DEU,2018.0,84,37,47
NGA,IND,2015.0,3,4,-1
ITA,BEL,2014.0,108,57,51
KGZ,USA,2020.0,2,3,-1
EGY,OMN,2022.0,3,3,0
FRA,PAK,2014.0,43,6,37
COL,USA,2019.0,122,81,41
FRA,IND,2015.0,84,79,5
IND,ARE,2017.0,70,14,56
TUR,USA,2014.0,180,273,-93
BEL,DEU,2003.0,44,44,0
MYS,IRQ,2015.0,46,7,39
BEL,BRA,2011.0,9,10,-1
COL,USA,2017.0,93,99,-6
ITA,USA,2000.0,193,144,49
JPN,GHA,2015.0,3,1,2
SRB,DEU,2017.0,22,9,13
GBR,HRV,2015.0,7,11,-4
SAU,HKG,2021.0,5,3,2
BEL,CHN,2022.0,44,32,12
CHE,USA,2021.0,375,413,-38
EGY,CAN,2013.0,21,30,-9
DEU,IRN,2010.0,22,41,-19
ITA,CAN,2006.0,40,34,6
ARE,IND,2020.0,31,69,-38
MYS,THA,2018.0,19,3,16
CAN,CHE,2016.0,100,81,19
USA,NLD,2020.0,355,343,12
DNK,GNB,2014.0,1,4,-3
FIN,DEU,2020.0,45,51,-6
KOR,CHN,2016.0,168,93,75
PAK,KOR,2016.0,28,60,-32
AUS,LUX,2021.0,5,2,3
IND,BEL,2021.0,29,9,20
IND,OMN,2019.0,24,9,15
GBR,SGP,2020.0,104,101,3
GBR,IDN,2019.0,32,28,4
PHL,USA,2020.0,24,19,5
MWI,NLD,2019.0,2,2,0
CHL,NLD,2015.0,8,12,-4
CAN,ITA,2018.0,52,77,-25
TUR,GBR,2020.0,80,67,13
FRA,SWE,2014.0,82,52,30
BGR,ITA,2016.0,5,6,-1
ARG,USA,2015.0,92,108,-16
NLD,FRA,1999.0,17,28,-11
CHN,FIN,2020.0,44,44,0
FRA,AUS,2013.0,117,71,46
NZL,AUS,2011.0,180,90,90
USA,ALB,2013.0,1,1,0
NLD,IRL,2014.0,11,11,0
USA,GBR,2003.0,1165,1458,-293
SAU,CHN,2015.0,14,20,-6
USA,AUT,2020.0,126,116,10
CZE,NOR,2018.0,8,4,4
IND,PRT,2015.0,19,14,5
ESP,PER,2016.0,19,17,2
IND,CAN,2020.0,165,84,81
USA,CHL,2016.0,135,107,28
FRA,CHN,2013.0,143,114,29
GBR,SWE,2014.0,164,124,40
USA,ROU,2016.0,14,21,-7
USA,BEL,2016.0,123,202,-79
TWN,CAN,2009.0,12,16,-4
FRA,TUN,2020.0,82,116,-34
JPN,VNM,2014.0,38,16,22
SWE,MEX,2019.0,7,5,2
AUS,ISR,2016.0,12,16,-4
BRA,ITA,2020.0,53,52,1
BEL,IND,2005.0,7,6,1
ISR,PRT,2017.0,2,1,1
CHN,NLD,2019.0,152,148,4
SWE,ARE,2015.0,5,2,3
CZE,AUT,2021.0,10,8,2
CHN,DEU,1998.0,27,28,-1
ITA,CHE,2005.0,74,77,-3
SVN,BEL,2018.0,4,4,0
THA,NPL,2021.0,7,4,3
GBR,SAU,2019.0,178,55,123
CHN,NOR,2020.0,30,32,-2
FRA,CRI,2018.0,4,1,3
SAU,BHR,2017.0,4,2,2
NLD,ETH,2018.0,17,5,12
BIH,SRB,2017.0,12,11,1
USA,LTU,2020.0,9,8,1
ZWE,NLD,2018.0,3,2,1
CAN,IRN,2008.0,47,76,-29
IND,FRA,2020.0,88,70,18
USA,VNM,2018.0,37,18,19
ZAF,NOR,2019.0,3,4,-1
ETH,ITA,2018.0,2,2,0
USA,NZL,2006.0,90,90,0
FRA,PYF,2020.0,11,21,-10
CHE,ESP,2020.0,77,111,-34
GBR,CYP,2021.0,24,13,11
FIN,NOR,2018.0,44,13,31
BWA,ETH,2015.0,3,3,0
IND,PAK,2020.0,45,30,15
CHE,SVN,2022.0,1,3,-2
DEU,PAK,2013.0,35,25,10
IND,RUS,2022.0,10,5,5
IDN,THA,2022.0,11,6,5
ISR,PRT,2019.0,3,3,0
KEN,FRA,2020.0,3,3,0
THA,JPN,2020.0,67,125,-58
BEL,AUT,2022.0,4,8,-4
BRA,PER,2022.0,16,6,10
EST,JPN,2022.0,2,1,1
GBR,VNM,2020.0,22,12,10
CAN,JPN,2019.0,72,70,2
CHL,CAN,2021.0,21,15,6
BRA,ECU,2020.0,18,7,11
LBN,DNK,2022.0,1,1,0
CAN,SGP,2016.0,27,27,0
PER,USA,2020.0,54,34,20
DZA,SAU,2022.0,6,2,4
ROU,GBR,2003.0,11,6,5
HUN,GBR,2005.0,16,17,-1
ECU,CUB,2019.0,4,15,-11
IND,ETH,2018.0,58,20,38
GBR,GRC,2015.0,125,250,-125
GBR,SAU,2017.0,153,41,112
CHN,NLD,2017.0,99,131,-32
ITA,CHE,2002.0,96,79,17
IDN,JPN,2017.0,57,158,-101
SRB,DEU,2019.0,21,4,17
JPN,EGY,2008.0,37,13,24
MWI,USA,2008.0,5,1,4
CHE,CHL,2017.0,11,8,3
COL,USA,2010.0,60,54,6
DNK,FIN,2020.0,17,12,5
CHE,SWE,2002.0,19,24,-5
CAN,GRC,2014.0,8,17,-9
CAN,SAU,2007.0,42,19,23
ESP,IRL,2013.0,24,15,9
ITA,MEX,2019.0,21,11,10
CAN,IRL,2001.0,11,7,4
NZL,ESP,2017.0,3,3,0
ESP,DEU,1998.0,40,30,10
MEX,GBR,2006.0,20,41,-21
NGA,SAU,2015.0,6,5,1
PRT,NOR,2016.0,9,6,3
KOR,GBR,2017.0,52,58,-6
FRA,EGY,2020.0,13,12,1
ITA,JPN,2000.0,12,6,6
FRA,THA,2009.0,10,8,2
FIN,MYS,2015.0,1,1,0
RUS,ROU,2010.0,1,1,0
TUN,FRA,2012.0,82,96,-14
CYP,USA,2006.0,5,18,-13
CHE,CHN,2011.0,24,31,-7
AUS,ARE,2015.0,15,4,11
CHN,AUS,1999.0,31,11,20
GBR,RUS,2012.0,28,39,-11
IND,ISR,2001.0,10,9,1
ESP,TWN,2006.0,3,1,2
IRL,SWE,2012.0,7,6,1
CHN,TWN,2004.0,19,28,-9
CHL,ECU,2015.0,8,2,6
CHE,BEL,2007.0,28,17,11
TUR,IRL,2020.0,5,6,-1
GBR,POL,2001.0,13,25,-12
AUS,SGP,2002.0,34,27,7
THA,AUS,2002.0,5,11,-6
SLB,AUS,2016.0,2,2,0
USA,ZAF,2006.0,56,46,10
THA,BGD,2020.0,6,2,4
RUS,CHE,1999.0,9,4,5
GBR,COL,2018.0,11,16,-5
FRA,FIN,2021.0,21,20,1
CAN,BGD,2008.0,8,8,0
THA,SGP,2017.0,5,4,1
USA,SWE,1999.0,88,66,22
FIN,NZL,2006.0,2,1,1
DEU,IRN,2019.0,35,133,-98
KHM,ESP,2009.0,1,1,0
ETH,IND,2015.0,10,26,-16
USA,CYP,2006.0,18,5,13
FIN,ITA,2010.0,5,15,-10
AUT,ITA,2005.0,16,20,-4
POL,NLD,1998.0,1,3,-2
NLD,MYS,2018.0,5,9,-4
IND,OMN,2010.0,20,3,17
BRN,USA,2004.0,2,1,1
CYP,GRC,2016.0,20,30,-10
AUS,ZAF,2009.0,9,31,-22
AUS,JPN,2022.0,42,17,25
BWA,ZAF,2015.0,9,6,3
CZE,BEL,2020.0,5,10,-5
USA,PRT,2018.0,48,68,-20
IND,AUT,2013.0,11,5,6
GHA,CAN,2017.0,8,3,5
RUS,DNK,2019.0,4,4,0
CHE,GIN,2018.0,3,1,2
KOR,CZE,2020.0,4,4,0
IND,ZAF,2013.0,52,22,30
ARG,ITA,2003.0,21,7,14
COL,BRA,2021.0,32,63,-31
AUS,VNM,2020.0,59,38,21
TUN,DZA,2018.0,7,3,4
FIN,ITA,2019.0,15,37,-22
EST,DEU,2020.0,6,8,-2
DEU,TUN,2018.0,5,2,3
CHN,NGA,2020.0,21,27,-6
EGY,AUS,2015.0,12,6,6
MAC,AUS,2018.0,2,1,1
FIN,CHE,2008.0,12,8,4
USA,LUX,2020.0,10,7,3
QAT,MYS,2021.0,4,3,1
FRA,VNM,2022.0,15,8,7
USA,ISL,2016.0,13,10,3
GRC,IRL,2021.0,5,1,4
PAK,NLD,2011.0,6,3,3
AUS,KOR,2005.0,20,11,9
IRQ,PAK,2020.0,6,5,1
MAR,FRA,2020.0,45,67,-22
JOR,EGY,2020.0,5,2,3
CHE,SWE,2005.0,20,17,3
CHN,NPL,2021.0,20,6,14
USA,CHE,2009.0,399,388,11
GBR,MWI,2001.0,8,2,6
SRB,MNE,2011.0,6,3,3
USA,BGR,2004.0,14,12,2
COL,DEU,2018.0,22,20,2
CAN,IND,2005.0,26,66,-40
CHE,CZE,2014.0,13,16,-3
DEU,ROU,2016.0,13,22,-9
OMN,IND,2020.0,14,18,-4
AUS,SGP,2005.0,34,42,-8
IDN,JPN,2019.0,59,158,-99
MWI,NLD,2017.0,2,5,-3
RUS,CZE,2019.0,19,4,15
GHA,USA,2007.0,4,5,-1
TZA,USA,2007.0,6,7,-1
FRA,CZE,2009.0,17,15,2
NLD,JPN,2013.0,18,18,0
GLP,FRA,2011.0,13,11,2
IND,OMN,2017.0,25,11,14
UKR,SWE,2008.0,2,3,-1
FRA,HTI,2010.0,1,1,0
JAM,GBR,2009.0,4,1,3
KOR,SWE,2013.0,4,4,0
KEN,JPN,2019.0,7,8,-1
CZE,CAN,2011.0,11,7,4
TUR,CYP,2003.0,1,1,0
LBN,USA,2006.0,29,18,11
JOR,BHR,2008.0,1,1,0
FRA,HUN,2007.0,13,11,2
GBR,MAR,2005.0,2,2,0
ARG,CAN,2003.0,20,12,8
SWE,CAN,1998.0,5,5,0
FIN,USA,2001.0,63,61,2
LVA,GBR,2005.0,2,1,1
TTO,USA,2016.0,7,3,4
LVA,GBR,2002.0,2,2,0
CHE,GRC,2004.0,8,8,0
DNK,CHE,2006.0,23,13,10
RUS,MDA,2010.0,2,2,0
GBR,ISR,1999.0,19,8,11
FIN,CAN,2014.0,19,18,1
BIH,HRV,2013.0,4,7,-3
JPN,DEU,1999.0,47,63,-16
KOR,RUS,2019.0,10,6,4
BEL,UKR,2004.0,5,3,2
UKR,POL,1999.0,9,4,5
GRC,ITA,2002.0,13,14,-1
EGY,QAT,2003.0,4,3,1
CZE,AUS,2003.0,2,4,-2
AUT,CAN,2007.0,14,11,3
SRB,HUN,2006.0,1,1,0
USA,MAR,2009.0,6,1,5
CZE,GBR,2004.0,15,18,-3
ZMB,USA,2003.0,1,2,-1
GRC,ITA,2005.0,11,11,0
GBR,ARG,2011.0,14,12,2
SGP,JPN,2016.0,26,49,-23
HRV,CHE,2003.0,6,2,4
UKR,KOR,2002.0,3,2,1
RUS,DNK,2010.0,7,6,1
CZE,ISR,2005.0,3,1,2
EGY,JPN,2007.0,18,32,-14
AUT,ITA,2002.0,11,15,-4
DEU,HUN,2000.0,13,18,-5
GBR,LTU,2021.0,2,10,-8
ESP,ROU,2006.0,2,6,-4
SAU,BHR,2019.0,8,5,3
SGP,GBR,2010.0,32,85,-53
BGR,FRA,1998.0,2,1,1
USA,DZA,2004.0,2,1,1
USA,KWT,2007.0,7,6,1
DEU,RUS,2000.0,58,106,-48
ITA,MEX,2010.0,5,10,-5
IND,ESP,2009.0,20,8,12
AUS,PRT,2006.0,1,2,-1
POL,ESP,2012.0,19,31,-12
CAN,SRB,2006.0,2,4,-2
CHN,HUN,2018.0,7,5,2
SDN,FRA,2013.0,2,1,1
BEL,ECU,2014.0,2,1,1
GUF,FRA,2000.0,1,5,-4
UKR,JPN,2015.0,8,2,6
MYS,GBR,2011.0,45,109,-64
HTI,USA,2004.0,5,3,2
CMR,FRA,2015.0,10,18,-8
ARE,EGY,2000.0,2,2,0
IDN,DEU,2006.0,4,4,0
BFA,CMR,2009.0,1,1,0
BLR,USA,2001.0,10,5,5
MAC,USA,2014.0,5,16,-11
PAK,SGP,2009.0,2,3,-1
BRA,VEN,2003.0,9,1,8
AUS,KOR,2002.0,8,12,-4
USA,EST,2002.0,5,4,1
PRT,DEU,2003.0,14,22,-8
GBR,TWN,2000.0,10,2,8
SGP,CAN,2008.0,32,19,13
GBR,NGA,2014.0,41,27,14
FRA,GAB,2008.0,6,3,3
IRL,POL,2011.0,4,2,2
ARE,TUR,2018.0,2,4,-2
MYS,IND,2013.0,33,73,-40
FRA,NCL,2006.0,10,8,2
AUT,IND,2009.0,6,10,-4
ISL,DEU,2002.0,2,1,1
NZL,IRL,2015.0,11,5,6
NOR,IND,2011.0,4,9,-5
COL,PRT,2010.0,1,1,0
KOR,RUS,2017.0,9,6,3
AUT,FIN,2011.0,6,10,-4
CAN,RUS,2011.0,13,20,-7
ESP,AUS,1998.0,3,2,1
IDN,JPN,2010.0,22,78,-56
IRL,DEU,2008.0,21,41,-20
GBR,CZE,2014.0,34,34,0
ESP,CUB,1998.0,3,2,1
BGD,CAN,2007.0,5,1,4
CHE,SRB,2015.0,7,9,-2
BRA,CHL,1999.0,4,2,2
ROU,PRT,2009.0,4,2,2
KOR,MEX,2016.0,3,1,2
AUS,FJI,2009.0,2,7,-5
BRA,KOR,2017.0,3,3,0
USA,LBN,1997.0,2,2,0
UGA,CHN,2016.0,1,1,0
CMR,ITA,2010.0,2,1,1
GIN,MLI,2017.0,1,1,0
THA,CHN,2016.0,21,8,13
HUN,AUT,2017.0,23,9,14
ROU,SWE,2019.0,3,5,-2
KEN,CHE,2022.0,5,2,3
AUS,MEX,2018.0,7,13,-6
ITA,MEX,2017.0,17,14,3
MEX,CUB,2011.0,9,14,-5
CYP,ITA,2020.0,4,7,-3
DEU,GAB,2015.0,3,2,1
JOR,ARE,2020.0,24,10,14
RUS,BLR,2011.0,11,12,-1
MCO,FRA,2004.0,2,13,-11
CHE,JPN,2022.0,12,13,-1
VNM,CHE,2014.0,3,4,-1
POL,MEX,2015.0,4,1,3
CHN,MLI,2018.0,6,1,5
PER,BRA,2016.0,13,22,-9
NZL,ECU,2020.0,1,1,0
SAU,PSE,2017.0,3,2,1
HUN,AUT,2019.0,18,9,9
CHE,SDN,2019.0,1,1,0
KEN,JPN,2017.0,3,8,-5
GRC,TUR,2020.0,3,6,-3
IND,DNK,2015.0,22,12,10
NAM,ZAF,2021.0,2,11,-9
PAK,FIN,2020.0,3,1,2
ISR,GBR,1999.0,8,19,-11
HRV,GBR,2020.0,8,9,-1
DEU,MAR,2018.0,5,4,1
VNM,GBR,2021.0,11,10,1
USA,GTM,2019.0,9,15,-6
NZL,ESP,2010.0,2,2,0
IND,ARE,2010.0,15,1,14
ARG,ZAF,2010.0,3,2,1
HUN,AUT,2010.0,12,5,7
BEL,SVN,2011.0,4,2,2
FRA,DNK,2001.0,14,15,-1
CUB,USA,2003.0,3,5,-2
CHE,NOR,1998.0,2,3,-1
FIN,DNK,1999.0,2,5,-3
NLD,SGP,2006.0,2,5,-3
ARG,AUS,2011.0,5,1,4
TWN,PAK,2011.0,1,1,0
CIV,BFA,2007.0,3,2,1
THA,SGP,2010.0,3,3,0
USA,DOM,2014.0,4,1,3
GRC,HKG,2016.0,1,1,0
SAU,YEM,2016.0,2,7,-5
NGA,AUS,2014.0,5,1,4
AUS,RUS,2009.0,4,10,-6
FRA,ARM,2010.0,2,1,1
POL,SGP,2007.0,1,1,0
AUS,NPL,2017.0,8,8,0
IRL,ISR,2016.0,1,3,-2
AUT,IRL,2019.0,3,4,-1
DNK,NZL,2016.0,4,1,3
QAT,GRC,2019.0,4,3,1
CMR,GBR,2019.0,11,4,7
CUB,ESP,2014.0,26,14,12
PAK,MYS,2011.0,17,7,10
POL,ZAF,2015.0,10,2,8
PER,FRA,2009.0,5,1,4
FRA,CAF,2011.0,3,3,0
ITA,ECU,2018.0,7,6,1
IND,TUR,2020.0,7,4,3
GAB,FRA,2009.0,1,10,-9
DEU,UGA,2016.0,8,3,5
ROU,HUN,2020.0,11,12,-1
RWA,BEL,2019.0,2,1,1
FJI,USA,2019.0,1,2,-1
QAT,ARE,2022.0,6,3,3
GHA,CAN,2019.0,9,7,2
QAT,IRL,2019.0,1,1,0
GBR,KWT,2002.0,7,3,4
CHE,PRT,2014.0,13,25,-12
FJI,USA,2010.0,1,6,-5
FRA,IRN,2020.0,14,28,-14
CRI,ESP,2004.0,2,5,-3
DZA,CHN,2016.0,1,1,0
MYS,AUS,2000.0,3,1,2
MYS,GHA,2020.0,4,1,3
IND,IRQ,2013.0,4,2,2
LUX,GBR,2014.0,5,5,0
LTU,CZE,2016.0,2,1,1
VEN,USA,2021.0,8,5,3
NOR,POL,2009.0,2,3,-1
DEU,ARG,2002.0,19,17,2
GHA,DEU,2002.0,1,2,-1
BLR,ESP,2010.0,2,2,0
ZAF,LSO,2006.0,2,1,1
TUR,NOR,2012.0,2,2,0
BEL,MAR,2020.0,4,3,1
NOR,FIN,2009.0,4,9,-5
GIN,FRA,2013.0,2,1,1
GRD,GBR,2014.0,2,1,1
AUS,ITA,2006.0,15,27,-12
SWE,ITA,2001.0,24,15,9
GEO,ITA,2012.0,1,2,-1
CAN,ESP,1999.0,5,8,-3
GMB,GBR,2008.0,2,8,-6
ESP,CUB,1997.0,3,1,2
ESP,MAR,2003.0,4,8,-4
USA,GTM,2010.0,2,6,-4
DEU,HKG,2000.0,2,3,-1
TWN,ITA,2007.0,1,1,0
BRA,PRT,2004.0,25,19,6
GBR,UKR,2002.0,8,13,-5
CHE,CHL,2010.0,6,8,-2
BEL,HUN,2001.0,6,11,-5
SWE,AUS,2003.0,24,24,0
CHN,DEU,1997.0,15,18,-3
BRA,IND,2001.0,6,5,1
BRA,BEL,2003.0,7,8,-1
TUR,KWT,2021.0,1,1,0
BIH,SRB,2010.0,2,3,-1
POL,FIN,2004.0,2,2,0
DEU,KEN,2021.0,5,6,-1
NGA,BWA,2006.0,1,2,-1
NLD,KEN,2001.0,3,1,2
BEL,RUS,2022.0,5,4,1
AUS,KEN,2012.0,5,2,3
DEU,GHA,2015.0,5,4,1
ZAF,IRN,2014.0,3,6,-3
IND,MYS,2002.0,9,2,7
TUR,QAT,2021.0,4,2,2
DEU,IRN,2017.0,31,83,-52
SAU,ARE,2006.0,5,1,4
ISR,SWE,2004.0,1,1,0
HRV,SVN,2016.0,8,10,-2
ZAF,ISR,2008.0,1,2,-1
SRB,DEU,2010.0,6,6,0
ZAF,FRA,2018.0,13,28,-15
ESP,DNK,2008.0,16,14,2
BGD,VNM,2020.0,1,2,-1
CZE,FRA,2018.0,13,36,-23
IDN,CHE,2011.0,2,1,1
RUS,MEX,2011.0,3,5,-2
BWA,USA,2018.0,12,9,3
BGD,HKG,2015.0,1,2,-1
BEL,EGY,2016.0,7,3,4
LVA,RUS,2021.0,4,3,1
TUR,KOR,2020.0,7,2,5
ITA,TUR,2018.0,8,19,-11
IRL,DNK,2008.0,2,4,-2
PAK,NPL,2020.0,2,2,0
NGA,GHA,2016.0,4,3,1
JPN,UKR,2019.0,3,1,2
RUS,THA,2018.0,2,1,1
SAU,PSE,2019.0,4,1,3
AUT,NOR,2015.0,10,4,6
EGY,DZA,2014.0,1,2,-1
COL,URY,2009.0,1,1,0
FRA,GUF,2021.0,16,17,-1
HUN,ISR,2009.0,3,1,2
COL,ECU,2014.0,1,1,0
PHL,THA,2021.0,5,4,1
MEX,BRA,2011.0,3,5,-2
POL,NOR,2006.0,3,2,1
ROU,BRA,2009.0,1,1,0
SAU,DEU,2008.0,1,2,-1
SWE,FRA,2000.0,11,23,-12
GBR,VEN,2000.0,3,3,0
NLD,VNM,2004.0,4,4,0
CZE,ITA,2007.0,8,8,0
UGA,TZA,2018.0,4,2,2
BRN,SGP,2015.0,4,6,-2
NGA,ITA,2015.0,4,3,1
SAU,DZA,2013.0,2,6,-4
ZAF,TUR,2005.0,2,1,1
IND,NGA,2014.0,6,6,0
PER,ARG,2022.0,1,2,-1
CYP,DEU,2005.0,1,3,-2
DNK,CHN,2006.0,6,14,-8
PAK,KWT,2007.0,2,2,0
CHN,PRI,1999.0,2,1,1
MAR,IND,2016.0,2,5,-3
HUN,SVK,2011.0,4,1,3
AUS,PNG,2014.0,5,5,0
SAU,UKR,2017.0,1,1,0
MEX,SGP,2014.0,1,2,-1
ZAF,BWA,2012.0,6,7,-1
BEL,HRV,2021.0,3,2,1
JOR,AUS,2016.0,4,8,-4
NOR,KEN,2017.0,2,1,1
CYP,GBR,2021.0,13,24,-11
TUN,NLD,2017.0,1,1,0
USA,GTM,2017.0,3,9,-6
ESP,MOZ,2020.0,2,1,1
NLD,LUX,2020.0,10,8,2
ISR,TWN,2021.0,2,1,1
PAK,IRN,2016.0,3,2,1
LUX,BEL,2015.0,7,13,-6
NZL,BRA,2022.0,3,2,1
BRA,NGA,2020.0,5,10,-5
BEN,BEL,2018.0,1,1,0
URY,BRA,2021.0,4,8,-4
DNK,AUT,2004.0,4,7,-3
TTO,CAN,2008.0,5,2,3
BGD,ITA,2017.0,3,3,0
KOR,IRL,2013.0,2,2,0
IRL,ROU,2015.0,1,1,0
ESP,SRB,2004.0,2,6,-4
ZMB,JPN,2019.0,4,1,3
AUT,ETH,2009.0,3,1,2
IDN,GBR,2002.0,7,4,3
HRV,ITA,2011.0,2,4,-2
IND,TTO,2016.0,5,2,3
KEN,DEU,2001.0,2,1,1
FIN,AUT,2012.0,4,9,-5
FRA,TUR,2000.0,6,4,2
GBR,KWT,2005.0,6,5,1
ZAF,NZL,1998.0,1,1,0
REU,FRA,2020.0,9,7,2
KOR,RUS,2010.0,13,9,4
SRB,RUS,2013.0,1,4,-3
DEU,ARG,2005.0,13,22,-9
GBR,UKR,2005.0,4,15,-11
KEN,JPN,2010.0,3,3,0
MDA,DEU,2011.0,2,1,1
HUN,SGP,2005.0,1,1,0
LBN,CAN,1997.0,1,1,0
LIE,CHE,2018.0,1,1,0
CHL,ITA,2011.0,6,5,1
NZL,ZAF,1998.0,1,1,0
SRB,CAN,2001.0,1,2,-1
ESP,IND,2007.0,3,16,-13
BRA,KOR,2010.0,1,1,0
ZAF,KEN,2008.0,3,3,0
BEN,NER,2012.0,1,1,0
COG,USA,2016.0,3,3,0
DEU,ARE,1999.0,1,1,0
SYR,USA,2015.0,3,2,1
PRT,FIN,2010.0,1,4,-3
ETH,GBR,2008.0,4,3,1
NOR,ESP,2013.0,4,10,-6
FIN,IRN,2012.0,2,3,-1
MYS,ZAF,2010.0,1,2,-1
ROU,SWE,2010.0,1,3,-2
CUB,DEU,2006.0,4,2,2
SAU,TUR,2018.0,6,19,-13
CAN,COL,2021.0,7,22,-15
ESP,HKG,2013.0,2,1,1
CAN,PER,2020.0,2,4,-2
COL,CHE,2013.0,6,2,4
USA,LVA,2022.0,1,3,-2
DNK,BOL,2018.0,1,1,0
SVN,FRA,2016.0,5,3,2
FRA,HTI,2017.0,2,1,1
AUS,FIN,1999.0,2,2,0
RUS,MDA,2019.0,2,6,-4
NGA,IRN,2016.0,2,1,1
BRA,KOR,2019.0,3,2,1
IRN,NLD,2002.0,5,2,3
BRN,IND,2019.0,2,2,0
CHN,MMR,2020.0,5,2,3
COD,BEL,2022.0,3,3,0
DEU,EST,2019.0,5,6,-1
ITA,ZAF,2003.0,4,3,1
SWE,PRT,2006.0,5,7,-2
QAT,KWT,2018.0,2,3,-1
ROU,CHE,2012.0,5,5,0
CAN,JOR,2013.0,6,4,2
AUS,NPL,2019.0,7,11,-4
ARE,CHN,2011.0,2,1,1
CMR,GBR,2017.0,3,5,-2
BGD,ITA,2019.0,4,4,0
FRA,PSE,2019.0,5,6,-1
IRN,USA,1999.0,2,5,-3
CAN,HUN,2007.0,7,5,2
SRB,ESP,2002.0,2,4,-2
EGY,MYS,2006.0,1,2,-1
CHL,NZL,2014.0,4,1,3
CHL,FRA,1998.0,3,2,1
USA,KHM,2009.0,1,4,-3
JPN,CMR,2007.0,2,1,1
PRT,CHL,2016.0,5,2,3
PRI,DEU,2014.0,1,1,0
SVN,POL,2010.0,3,2,1
NZL,NPL,2019.0,2,1,1
GBR,KHM,2012.0,2,1,1
ROU,AUT,2009.0,2,1,1
CHN,CUB,2014.0,1,2,-1
SWE,CHN,2000.0,8,6,2
LKA,AUS,1998.0,1,1,0
DEU,PHL,2016.0,6,5,1
ZAF,JPN,2015.0,1,6,-5
FIN,KOR,2009.0,1,4,-3
JPN,CZE,2015.0,8,6,2
PHL,NLD,2016.0,2,2,0
VNM,TWN,2015.0,2,23,-21
PRT,FIN,2019.0,6,6,0
KWT,KOR,2019.0,1,1,0
PRT,FIN,2017.0,4,2,2
NGA,TZA,2019.0,1,3,-2
DEU,UZB,2006.0,1,3,-2
EGY,ITA,2007.0,4,5,-1
HKG,CHE,2007.0,3,1,2
CZE,GRC,2012.0,1,3,-2
BRA,MOZ,2015.0,10,2,8
MLT,BRA,2017.0,1,1,0
RUS,CUB,2014.0,1,1,0
IRL,ZAF,2020.0,3,7,-4
GBR,KAZ,2005.0,2,1,1
PRT,ROU,2011.0,3,3,0
CAN,HRV,2018.0,2,1,1
HKG,MYS,2011.0,3,2,1
KOR,THA,2003.0,2,3,-1
FRA,KHM,2006.0,1,3,-2
NOR,RUS,1999.0,1,3,-2
IRL,GRC,2001.0,1,1,0
HUN,HRV,2019.0,1,1,0
SWE,MEX,2010.0,3,1,2
USA,BHR,2013.0,3,1,2
BEL,IRN,2014.0,10,16,-6
TZA,NLD,2018.0,2,3,-1
SWE,CAN,1997.0,1,3,-2
DEU,EST,2017.0,4,9,-5
PAK,THA,2011.0,1,3,-2
EGY,LKA,2018.0,1,1,0
IRN,NGA,2016.0,1,2,-1
KAZ,TUR,2011.0,1,2,-1
CHL,DOM,2022.0,1,1,0
ESP,PRI,2017.0,2,2,0
EGY,LBY,2016.0,5,1,4
AFG,CHE,2020.0,4,1,3
NIC,SWE,2006.0,2,1,1
LKA,USA,2011.0,8,12,-4
FRA,BEN,2003.0,3,6,-3
ECU,CUB,2017.0,2,24,-22
NZL,ESP,2019.0,4,8,-4
CHN,PHL,2020.0,5,5,0
CIV,NER,2019.0,1,1,0
DEU,KAZ,2018.0,2,3,-1
USA,MDA,2007.0,1,2,-1
LUX,ITA,2009.0,1,4,-3
RWA,BEL,2010.0,2,1,1
MEX,PRT,2020.0,5,1,4
THA,ITA,2006.0,1,2,-1
ESP,UKR,2012.0,2,3,-1
VNM,RUS,2011.0,1,4,-3
SGP,FRA,1999.0,1,1,0
GRC,PRT,2012.0,4,1,3
ARM,FRA,2002.0,1,1,0
FRO,DNK,2006.0,1,1,0
JPN,NGA,2006.0,3,2,1
CHE,DZA,2003.0,1,1,0
ZAF,NOR,2017.0,4,2,2
AUS,GRC,2004.0,2,1,1
USA,UZB,2003.0,2,2,0
MYS,SGP,2000.0,1,1,0
ITA,EGY,2007.0,5,4,1
ITA,PHL,2018.0,2,2,0
JPN,DNK,2015.0,4,7,-3
VNM,ZAF,2021.0,5,1,4
TUR,ARE,2020.0,5,1,4
QAT,GRC,2017.0,4,3,1
PRT,BEL,2009.0,3,6,-3
HRV,SRB,2015.0,5,9,-4
NPL,SWE,2013.0,1,1,0
PRT,SRB,2018.0,1,2,-1
BGR,HUN,2006.0,2,1,1
GHA,CHE,2002.0,2,2,0
UZB,DEU,2001.0,1,2,-1
FRA,LAO,2016.0,2,2,0
HKG,ITA,2008.0,2,2,0
PER,GBR,2001.0,1,4,-3
IND,BHR,2016.0,2,1,1
FRA,ARM,2019.0,3,2,1
MYS,CHN,2009.0,2,3,-1
BHR,IRL,2012.0,2,2,0
CHE,TUR,2000.0,2,2,0
JPN,ESP,1997.0,2,1,1
USA,PNG,2003.0,1,1,0
AUS,MAC,2009.0,1,2,-1
TZA,NGA,2019.0,3,1,2
CHN,GRC,2016.0,1,4,-3
GEO,USA,2000.0,2,1,1
ISL,NOR,2006.0,6,3,3
BGD,DEU,2000.0,2,3,-1
JPN,HKG,2004.0,5,7,-2
LBN,AUS,2004.0,1,1,0
GHA,DNK,2009.0,2,1,1
PHL,AUS,2008.0,3,6,-3
AFG,ZAF,2013.0,1,1,0
IND,MLI,2014.0,1,1,0
CMR,ITA,2017.0,1,3,-2
THA,DNK,2007.0,1,1,0
SAU,JPN,2016.0,4,16,-12
ZAF,LBY,2020.0,1,1,0
ISR,IRL,2022.0,2,1,1
RUS,EGY,2015.0,3,3,0
ITA,MOZ,2010.0,1,1,0
BLR,CHN,2015.0,2,1,1
CAN,CHL,2005.0,4,7,-3
COG,CHN,2020.0,1,1,0
VEN,CHL,2022.0,6,1,5
CUB,ARG,2009.0,1,3,-2
UGA,NLD,2012.0,3,2,1
AUT,IRL,2017.0,3,3,0
ISR,PRT,2010.0,2,1,1
POL,ISR,2016.0,4,1,3
AUT,EST,2021.0,1,1,0
RUS,ROU,2017.0,4,1,3
VEN,CAN,2011.0,1,2,-1
SGP,PAK,2016.0,2,4,-2
ESP,PRI,2019.0,2,1,1
RUS,TUR,2008.0,3,2,1
GBR,AFG,2017.0,2,2,0
JOR,CHE,2021.0,1,4,-3
CHE,KEN,2022.0,2,5,-3
GBR,RWA,2018.0,3,1,2
ITA,TWN,2012.0,2,5,-3
CRI,DEU,2006.0,1,2,-1
CAN,NPL,2002.0,1,1,0
DEU,SRB,1999.0,1,4,-3
BEL,BOL,2003.0,1,1,0
USA,SYR,2005.0,2,1,1
ITA,SRB,2003.0,2,2,0
NOR,ZAF,2002.0,1,4,-3
THA,CZE,2008.0,1,1,0
MYS,HKG,2012.0,1,10,-9
ZAF,SWE,2008.0,3,4,-1
SWE,MEX,2017.0,3,3,0
BHS,USA,2021.0,2,1,1
GRC,MKD,2020.0,1,1,0
GRC,AUT,2018.0,4,4,0
AFG,CHN,2020.0,1,2,-1
BHR,SAU,2022.0,4,5,-1
DOM,CHL,2022.0,1,1,0
LTU,DEU,1998.0,1,2,-1
CZE,ESP,1998.0,1,1,0
CZE,UKR,2021.0,3,4,-1
NPL,GBR,2006.0,4,2,2
AUS,UGA,2013.0,1,1,0
NPL,DEU,2016.0,3,3,0
CHE,TUN,2009.0,3,2,1
ZMB,JPN,2017.0,1,2,-1
OMN,KOR,2022.0,1,3,-2
BLR,FRA,2006.0,1,3,-2
NLD,EGY,1997.0,2,1,1
JPN,UKR,2017.0,2,2,0
DNK,SVK,2010.0,1,1,0
URY,MEX,2009.0,1,2,-1
MMR,THA,2021.0,2,3,-1
LTU,UKR,2016.0,2,2,0
MOZ,ZAF,2016.0,2,1,1
PRT,JPN,2014.0,1,1,0
THA,BEL,2015.0,3,2,1
CHN,TKM,2017.0,2,1,1
POL,BLR,2018.0,1,7,-6
IRQ,JOR,2018.0,1,5,-4
HND,USA,2020.0,2,1,1
IRL,CZE,2018.0,2,4,-2
PER,CHL,2006.0,1,1,0
ESP,ARE,2009.0,2,1,1
AUT,IRL,2010.0,4,10,-6
CHN,KWT,2019.0,1,1,0
RUS,NZL,2021.0,1,1,0
CAN,KWT,2021.0,1,3,-2
BGD,ITA,2010.0,5,1,4
SGP,IRL,2020.0,3,3,0
MWI,NLD,2010.0,1,2,-1
HUN,VNM,2015.0,1,2,-1
IRL,AUT,2018.0,5,2,3
SWE,MOZ,2014.0,1,1,0
EST,IND,2018.0,1,1,0
MEX,KEN,2018.0,2,1,1
SWE,LVA,2016.0,1,1,0
ARE,OMN,2021.0,1,3,-2
AUS,BWA,2012.0,1,1,0
AZE,HUN,2020.0,1,1,0
HUN,SRB,2011.0,2,1,1
CYP,CAN,2008.0,1,3,-2
USA,SYR,2002.0,5,1,4
MLT,GBR,1999.0,1,1,0
BRB,IND,2009.0,1,1,0
EGY,FRA,1999.0,1,3,-2
SWE,NGA,2006.0,1,3,-2
PAK,KEN,2008.0,1,1,0
HUN,HRV,2017.0,2,4,-2
MDG,USA,2008.0,1,1,0
NGA,CHE,2004.0,1,1,0
CAN,CHL,2002.0,1,4,-3
TUR,GRC,2011.0,1,2,-1
KOR,ETH,2013.0,1,2,-1
EST,ITA,2012.0,1,4,-3
HUN,ESP,2015.0,1,7,-6
CYP,DNK,2019.0,1,1,0
CHN,CHL,2014.0,2,4,-2
NOR,UKR,2008.0,1,3,-2
CHN,TUR,2021.0,1,10,-9
NOR,EST,2012.0,1,2,-1
LKA,KOR,2021.0,1,5,-4
SAU,MAR,2013.0,1,1,0
KEN,ITA,2021.0,1,1,0
COL,PRT,2017.0,1,3,-2
RWA,NGA,2022.0,1,1,0
EGY,SVK,2021.0,1,1,0
KWT,SAU,2022.0,1,1,0
MAR,DZA,2012.0,1,1,0
PRT,MOZ,2021.0,1,2,-1
USA,LBN,1998.0,2,2,0
NGA,BEN,2016.0,1,2,-1
LVA,CHE,2008.0,1,1,0
CHE,SDN,2010.0,1,1,0
BGD,MYS,2003.0,1,2,-1
NZL,IDN,2008.0,1,2,-1
SRB,ROU,2012.0,1,1,0
MEX,SWE,2001.0,1,2,-1
AUT,DNK,1999.0,2,2,0
MAR,ARE,2008.0,1,2,-1
EGY,JOR,2016.0,1,3,-2
NCL,VUT,2016.0,1,3,-2
ITA,CUB,2012.0,1,3,-2
IRL,HUN,2014.0,1,1,0
CYP,DEU,2002.0,1,1,0
PAK,DEU,1999.0,1,2,-1
JPN,SVK,2015.0,1,2,-1
BGD,TUR,2021.0,1,2,-1
AUT,IRN,2006.0,1,1,0
MYS,HRV,2015.0,1,5,-4
FIN,SVK,2022.0,1,1,0
SVK,BEL,2009.0,2,2,0
FRA,GBR,2005.0,306,249,57
DEU,USA,2013.0,1170,1118,52
USA,ITA,2015.0,325,490,-165
CAN,DEU,2007.0,92,192,-100
CAN,IND,2002.0,23,48,-25
GBR,AUS,2006.0,420,354,66
DEU,MEX,2022.0,10,14,-4
CAN,JPN,2017.0,68,57,11
USA,DNK,2008.0,74,74,0
IND,ARE,2019.0,59,23,36
GBR,HKG,2014.0,65,43,22
SGP,USA,2020.0,166,187,-21
KOR,GBR,2019.0,80,42,38
JPN,POL,2014.0,9,52,-43
IRN,ESP,2014.0,10,6,4
SGP,GBR,2017.0,93,141,-48
ESP,EGY,2021.0,11,10,1
AUT,SVK,2020.0,7,7,0
GBR,LBN,2005.0,5,1,4
THA,KOR,2021.0,6,12,-6
SDN,KEN,2020.0,1,1,0
SVN,DEU,2022.0,8,5,3
IRL,SAU,2020.0,17,4,13
IDN,NLD,2021.0,19,21,-2
CHE,DNK,2008.0,25,14,11
AUS,CHE,2016.0,54,59,-5
PRT,FRA,2018.0,38,41,-3
AUT,SWE,2011.0,18,14,4
TWN,SGP,2015.0,21,13,8
DEU,DNK,2013.0,95,78,17
SWE,BGD,2016.0,8,4,4
SAU,SWE,2014.0,3,5,-2
CAN,JPN,2010.0,72,85,-13
NLD,AUS,2009.0,50,34,16
QAT,CAN,2015.0,8,22,-14
DEU,BRA,2001.0,33,30,3
IND,NPL,2003.0,9,9,0
HUN,DEU,2015.0,42,26,16
COL,PRT,2019.0,6,2,4
CAN,OMN,2018.0,8,8,0
BEL,SWE,2006.0,9,9,0
FRA,ESP,2006.0,130,132,-2
RUS,CZE,2010.0,10,3,7
THA,CAN,2009.0,15,12,3
CHE,LTU,2014.0,4,1,3
MLI,FRA,2003.0,2,3,-1
RUS,UKR,2001.0,34,43,-9
HUN,FIN,2001.0,6,1,5
CAN,KEN,2011.0,7,5,2
NLD,NOR,2006.0,15,7,8
SWE,JPN,2009.0,27,24,3
DNK,TUR,2004.0,2,1,1
ITA,BRA,1999.0,12,11,1
SRB,USA,2002.0,18,18,0
ESP,DEU,1997.0,18,8,10
SRB,USA,2005.0,8,14,-6
AUS,IND,2008.0,17,66,-49
FRA,REU,2016.0,8,6,2
CHE,CHL,2019.0,6,7,-1
BGR,GRC,2007.0,2,3,-1
RUS,ARM,2015.0,2,1,1
CHN,IRN,2020.0,13,80,-67
TUN,USA,2017.0,9,7,2
ESP,POL,2021.0,18,10,8
TUR,JPN,2013.0,5,12,-7
HUN,GBR,2002.0,21,22,-1
CAN,NZL,1999.0,5,5,0
PAK,AUT,2008.0,6,5,1
CHL,KOR,2020.0,1,5,-4
JOR,MYS,2020.0,7,29,-22
SWE,HUN,1999.0,1,3,-2
PRT,ARG,2009.0,1,1,0
MEX,GTM,2018.0,3,4,-1
AUS,ARG,2002.0,5,6,-1
GBR,EGY,2004.0,20,6,14
NZL,NPL,2017.0,3,1,2
FIN,IRL,2008.0,3,3,0
TWN,JPN,2004.0,10,17,-7
ESP,TUR,2006.0,2,1,1
IRN,NLD,2005.0,5,2,3
POL,CHN,2018.0,10,13,-3
DNK,GRC,2016.0,2,9,-7
IRN,KOR,2012.0,5,2,3
IND,MYS,2005.0,18,7,11
BEL,PHL,2018.0,3,2,1
GBR,PRI,2015.0,1,3,-2
BIH,SRB,2019.0,8,7,1
IRN,AZE,2008.0,2,2,0
GIN,MLI,2019.0,1,2,-1
ECU,MEX,2013.0,2,1,1
BEL,ZWE,2013.0,1,1,0
DNK,HUN,2020.0,5,6,-1
DEU,SVN,2013.0,4,7,-3
TWN,DNK,2014.0,2,1,1
RUS,DNK,2017.0,7,6,1
GBR,IDN,2017.0,24,10,14
KEN,CAN,2020.0,4,6,-2
GBR,IDN,2010.0,9,3,6
MAC,HKG,2003.0,1,2,-1
FIN,HUN,2018.0,4,3,1
MEX,USA,1997.0,9,16,-7
AUT,UKR,2003.0,2,7,-5
CHE,ZAF,2011.0,7,8,-1
CAN,POL,2015.0,7,32,-25
FIN,IND,2008.0,6,5,1
TUN,USA,2019.0,2,6,-4
POL,SWE,2006.0,8,8,0
SVK,FRA,1997.0,1,3,-2
GBR,CRI,2012.0,1,1,0
DZA,TUN,2016.0,6,2,4
GBR,LBY,2004.0,3,1,2
SWE,BGR,2009.0,1,1,0
BGD,MEX,2008.0,2,1,1
BEL,IND,2002.0,3,7,-4
TWN,FRA,2006.0,5,6,-1
MNG,RUS,2011.0,1,2,-1
IDN,GBR,2005.0,2,3,-1
SWE,IRQ,2021.0,1,4,-3
QAT,ESP,2020.0,2,2,0
AUT,BRA,2013.0,3,5,-2
MEX,NZL,2003.0,2,3,-1
TUN,NLD,2019.0,1,1,0
RUS,ROU,2019.0,4,1,3
IRL,SGP,2006.0,1,2,-1
HUN,NLD,2020.0,8,5,3
JPN,ESP,1998.0,1,4,-3
SGP,KOR,2004.0,4,2,2
HRV,RUS,2014.0,1,2,-1
TUR,SRB,2015.0,5,1,4
SWE,TZA,2021.0,1,3,-2
DEU,BLR,1999.0,1,6,-5
URY,ARG,2014.0,5,4,1
MAR,CZE,2022.0,1,1,0
TUR,CZE,2008.0,1,2,-1
USA,NER,2006.0,2,1,1
NOR,BEL,2021.0,5,12,-7
DEU,MKD,2017.0,1,4,-3
BEL,PAN,2011.0,2,1,1
IRL,ECU,2019.0,1,1,0
DZA,CHE,2009.0,1,1,0
BEL,KEN,2009.0,1,1,0
SVN,CAN,2020.0,3,2,1
MYS,ZAF,2019.0,2,3,-1
GHA,KEN,2022.0,2,2,0
RWA,BEL,2017.0,2,1,1
RUS,LVA,1997.0,3,1,2
ISR,AUT,2016.0,2,7,-5
JOR,SAU,2022.0,5,9,-4
BEL,KAZ,2022.0,1,3,-2
IDN,CHN,2022.0,2,5,-3
CHE,HRV,2009.0,3,4,-1
GBR,LAO,2014.0,1,1,0
NPL,MYS,2014.0,1,1,0
HUN,PRT,2003.0,3,2,1
BRA,TUR,2020.0,2,4,-2
ZMB,DEU,2021.0,1,1,0
ISR,ARE,2012.0,1,1,0
ITA,ARM,2016.0,1,2,-1
FIN,GRC,2020.0,1,1,0
TZA,PAK,2020.0,1,3,-2
HUN,,2020.0,1694,0,1694
RUS,,2012.0,4054,0,4054
DEU,,2016.0,17485,0,17485
DNK,,2013.0,1183,0,1183
SGP,,2010.0,754,0,754
GBR,,2012.0,11030,0,11030
,AUT,1999.0,3291,0,3291
LUX,,2024.0,1066,0,1066
,USA,2009.0,88490,0,88490
,CMR,2002.0,128,0,128
,BRA,1998.0,9180,0,9180
,BRA,1997.0,2793,0,2793
LTU,,2010.0,179,0,179
CRI,,2009.0,30,0,30
SAU,,2020.0,1569,0,1569
POL,,2012.0,2216,0,2216
,JOR,2015.0,548,0,548
LTU,,2019.0,490,0,490
BRB,,2022.0,16,0,16
,PAN,2003.0,21,0,21
,SAU,2016.0,2635,0,2635
URY,,2023.0,1131,0,1131
,SRB,2006.0,1118,0,1118
,NLD,2010.0,6521,0,6521
ECU,,2022.0,1054,0,1054
,NGA,2005.0,1372,0,1372
,POL,2000.0,5567,0,5567
,TUN,2001.0,720,0,720
BLR,,2018.0,224,0,224
AUS,,2004.0,1502,0,1502
,HRV,2008.0,1109,0,1109
,GEO,2003.0,195,0,195
,MYS,1994.0,237,0,237
ESP,,2000.0,293,0,293
,NGA,2002.0,836,0,836
NZL,,2018.0,1223,0,1223
,TUR,2012.0,7872,0,7872
SGP,,2017.0,1530,0,1530
LTU,,2017.0,447,0,447
,IRQ,2005.0,101,0,101
,HUN,1998.0,2192,0,2192
BGD,,2014.0,284,0,284
,MLI,2001.0,26,0,26
,NLD,2019.0,3134,0,3134
,HUN,1997.0,1089,0,1089
,PAK,2008.0,2451,0,2451
MDV,SWE,2008.0,1,0,1
SGP,,2019.0,1868,0,1868
SVK,,2000.0,34,0,34
,PRI,1995.0,73,0,73
GTM,,2015.0,15,0,15
PER,,2020.0,405,0,405
,NPL,2006.0,186,0,186
MAR,,2021.0,1404,0,1404
NOR,OMN,2007.0,1,0,1
BEL,MLI,2005.0,1,0,1
,UKR,2015.0,2969,0,2969
KGZ,,2019.0,28,0,28
,IDN,2010.0,1301,0,1301
,BLR,2016.0,307,0,307
,CMR,2005.0,198,0,198
,FIN,2014.0,1962,0,1962
PHL,PNG,2013.0,2,0,2
,QAT,2010.0,135,0,135
,NLD,2017.0,5861,0,5861
GEO,,2023.0,587,0,587
IRQ,,2017.0,84,0,84
,IDN,2017.0,7852,0,7852
DOM,,2022.0,46,0,46
,QAT,2017.0,421,0,421
UGA,,2018.0,153,0,153
UZB,,2015.0,72,0,72
,KWT,2012.0,119,0,119
NGA,,2007.0,120,0,120
,VEN,2012.0,296,0,296
,IDN,2019.0,2848,0,2848
NZL,MDV,2012.0,1,0,1
,MOZ,2012.0,61,0,61
,BTN,2012.0,14,0,14
ALB,DNK,2019.0,1,0,1
IRQ,,2019.0,158,0,158
ISR,NOR,2018.0,2,0,2
IND,LBN,2018.0,2,0,2
SVN,EST,2017.0,2,0,2
BRN,CHN,2020.0,1,0,1
,ZWE,2015.0,131,0,131
,CUB,2015.0,454,0,454
IDN,,2025.0,46,0,46
IRN,BEL,2022.0,23,0,23
NER,,2020.0,25,0,25
MCO,,2023.0,40,0,40
,KHM,2016.0,73,0,73
,CAF,2015.0,5,0,5
CAN,BWA,2011.0,2,0,2
,BRN,2013.0,40,0,40
,PSE,2018.0,164,0,164
,MUS,2018.0,28,0,28
,QAT,2019.0,356,0,356
,SDN,2012.0,108,0,108
,GMB,2012.0,21,0,21
,SYR,2006.0,50,0,50
,JAM,2005.0,43,0,43
MUS,USA,2011.0,3,0,3
BGD,ZMB,2021.0,1,0,1
,IRQ,2002.0,33,0,33
MLT,,2019.0,47,0,47
KNA,,2024.0,31,0,31
CPV,,2022.0,21,0,21
,PRK,2012.0,11,0,11
BGR,,2006.0,169,0,169
,FJI,2015.0,26,0,26
VNM,HKG,2019.0,1,0,1
AUT,MCO,2001.0,1,0,1
DNK,VNM,2018.0,5,0,5
FRO,,2021.0,11,0,11
NZL,ARE,2020.0,9,0,9
NOR,HRV,2022.0,1,0,1
COM,,2023.0,7,0,7
BRA,,2001.0,86,0,86
IRQ,,2010.0,26,0,26
,ARE,1995.0,31,0,31
UKR,AUS,2016.0,3,0,3
TZA,,2006.0,23,0,23
MNG,AUS,2002.0,3,0,3
MEX,BLR,2021.0,1,0,1
SDN,,2009.0,27,0,27
THA,ISR,2013.0,1,0,1
,GUM,2001.0,5,0,5
SVK,ESP,2006.0,3,0,3
SUR,,2010.0,8,0,8
NOR,NAM,2018.0,1,0,1
FRA,DJI,2016.0,5,0,5
,MDG,2001.0,41,0,41
KAZ,,2004.0,35,0,35
,ALB,2004.0,21,0,21
PNG,,2009.0,14,0,14
,CIV,1994.0,12,0,12
IND,PSE,2000.0,1,0,1
,COG,1997.0,11,0,11
KGZ,,2010.0,8,0,8
AUT,SVN,2000.0,1,0,1
GBR,GEO,2018.0,2,0,2
,SWZ,1998.0,3,0,3
HKG,UKR,2010.0,1,0,1
CMR,TUN,2002.0,1,0,1
,COG,1998.0,21,0,21
OMN,BRA,2013.0,2,0,2
CHL,BOL,2006.0,1,0,1
BFA,MAR,2020.0,1,0,1
TJK,,2005.0,4,0,4
CRI,GBR,2016.0,1,0,1
VNM,,2004.0,24,0,24
BLR,JPN,2001.0,2,0,2
FIN,JOR,2001.0,1,0,1
JAM,,2012.0,23,0,23
MLT,,2017.0,28,0,28
NIC,,2009.0,11,0,11
SEN,,2004.0,10,0,10
AGO,,2021.0,22,0,22
NLD,MLT,2009.0,1,0,1
MLT,,2010.0,10,0,10
ZAF,PRT,2001.0,2,0,2
MKD,FRA,2012.0,2,0,2
USA,SLV,2007.0,1,0,1
,BOL,2007.0,41,0,41
FRA,AGO,2009.0,2,0,2
THA,NGA,2015.0,1,0,1
SVN,SLV,2018.0,1,0,1
NOR,KEN,2019.0,2,0,2
SVK,TWN,2016.0,1,0,1
KEN,NGA,2014.0,2,0,2
ESP,PSE,2011.0,2,0,2
,GNB,2008.0,4,0,4
NLD,SAU,2011.0,4,0,4
MYS,KHM,2014.0,1,0,1
,GRL,2015.0,3,0,3
ITA,PRY,2017.0,1,0,1
,NER,2011.0,15,0,15
,SLV,2008.0,17,0,17
MAR,NLD,2022.0,1,0,1
POL,LVA,2007.0,1,0,1
COL,TUR,2021.0,1,0,1
TUR,SYR,2018.0,1,0,1
HUN,GRC,2020.0,1,0,1
ITA,LIE,2021.0,4,0,4
,NCL,2018.0,15,0,15
USA,ATG,2022.0,1,0,1
,BEN,2000.0,44,0,44
,PER,1995.0,47,0,47
SVK,SVN,2015.0,5,0,5
UKR,NOR,2000.0,1,0,1
TUR,MNG,2018.0,1,0,1
GHA,RWA,2020.0,1,0,1
CZE,ARG,2008.0,1,0,1
CUB,PAK,2014.0,1,0,1
ZMB,NZL,2017.0,2,0,2
,JAM,2002.0,61,0,61
GMB,,2022.0,31,0,31
LVA,ITA,2011.0,2,0,2
MOZ,CHE,2018.0,1,0,1
UZB,CHE,2017.0,1,0,1
POL,COL,2017.0,1,0,1
NOR,HUN,2002.0,5,0,5
CUB,URY,2008.0,1,0,1
RUS,ZAF,1998.0,1,0,1
NGA,TZA,2017.0,3,0,3
,SWZ,1997.0,2,0,2
GUM,,2008.0,2,0,2
DEU,BHR,2004.0,1,0,1
UKR,KOR,2005.0,1,0,1
UKR,ITA,2008.0,1,0,1
BGR,SWE,1998.0,1,0,1
ESP,EST,2004.0,1,0,1
CZE,ESP,1997.0,1,0,1
GBR,LUX,2007.0,3,0,3
SAU,BHR,2010.0,5,0,5
EGY,ESP,2004.0,2,0,2
PHL,CAN,2000.0,2,0,2
GHA,CAN,2010.0,2,0,2
AUS,SEN,2002.0,1,0,1
GHA,TZA,2014.0,1,0,1
FRA,HTI,2019.0,3,0,3
IRL,NGA,2009.0,1,0,1
BEL,PER,2006.0,2,0,2
MLT,NLD,2022.0,1,0,1
GAB,USA,2009.0,3,0,3
RWA,GHA,2018.0,1,0,1
AUT,CMR,2014.0,1,0,1
ARE,BHR,2016.0,1,0,1
COG,RWA,2016.0,1,0,1
HKG,JOR,2009.0,1,0,1
USA,EST,2005.0,9,0,9
CHN,ISL,2015.0,1,0,1
IRN,BWA,2021.0,1,0,1
SAU,TZA,2019.0,1,0,1
,LSO,1996.0,1,0,1
FRA,ARM,2017.0,1,0,1
,KNA,2014.0,7,0,7
GBR,LVA,2021.0,2,0,2
SAU,PSE,2010.0,1,0,1
PYF,CHL,2004.0,1,0,1
LBN,CHE,2003.0,1,0,1
PAN,,2003.0,1,0,1
UKR,MDA,2005.0,4,0,4
TCD,FRA,2006.0,1,0,1
,COM,2010.0,1,0,1
JPN,ROU,2013.0,6,0,6
SRB,MYS,2015.0,1,0,1
GHA,LBR,2017.0,2,0,2
FRA,TJK,2013.0,1,0,1
KGZ,,2017.0,16,0,16
,ALB,1996.0,7,0,7
ISR,TUR,2006.0,2,0,2
PHL,CHL,2018.0,1,0,1
ISL,LTU,2008.0,1,0,1
ROU,MLT,2017.0,1,0,1
VNM,SYR,2018.0,1,0,1
IRL,PHL,2017.0,1,0,1
TGO,MAR,2018.0,1,0,1
SYR,JPN,2016.0,1,0,1
MMR,GHA,2019.0,1,0,1
UGA,MWI,2021.0,1,0,1
ROU,TUN,2019.0,1,0,1
SWE,ROU,2021.0,4,0,4
CHL,PHL,2008.0,2,0,2
,SLB,2004.0,2,0,2
EGY,HRV,2002.0,6,0,6
OMN,BGR,2020.0,1,0,1
TJK,SVK,2011.0,1,0,1
CZE,NGA,2012.0,1,0,1
SYC,NLD,2001.0,1,0,1
ISR,LUX,2005.0,1,0,1
NGA,TZA,2010.0,1,0,1
GAB,IND,2008.0,1,0,1
BWA,TZA,2021.0,1,0,1
ESP,SGP,2009.0,3,0,3
MEX,POL,2001.0,1,0,1
AUS,IRN,1999.0,3,0,3
SUR,,2017.0,5,0,5
MEX,BGR,2002.0,2,0,2
ISR,POL,2001.0,3,0,3
ETH,POL,2010.0,1,0,1
LKA,IND,2008.0,3,0,3
MLT,JPN,2003.0,2,0,2
,LSO,2004.0,6,0,6
CAN,GEO,2004.0,1,0,1
CYP,SAU,2021.0,2,0,2
CAN,JAM,2021.0,3,0,3
ESP,MLT,2019.0,3,0,3
TUN,GRC,2013.0,1,0,1
CAF,CHE,2021.0,1,0,1
NCL,MEX,2010.0,1,0,1
MEX,ISR,2001.0,4,0,4
NER,IND,2019.0,2,0,2
NCL,FSM,2015.0,1,0,1
BHR,IND,2012.0,1,0,1
CYP,UKR,2019.0,1,0,1
SVN,ROU,2015.0,1,0,1
PRT,HRV,2014.0,2,0,2
CHL,CRI,2016.0,4,0,4
CAN,LVA,2014.0,1,0,1
,BHS,2012.0,6,0,6
TUN,CHN,2018.0,5,0,5
FJI,USA,2017.0,2,0,2
PRY,CAN,2014.0,1,0,1
BOL,FIN,2020.0,1,0,1
NER,IND,2010.0,2,0,2
DEU,MKD,2010.0,2,0,2
SWE,TTO,2016.0,1,0,1
KWT,QAT,2012.0,4,0,4
CHN,COL,2007.0,1,0,1
HUN,CAN,1998.0,2,0,2
CUB,BEL,2006.0,2,0,2
UKR,IRL,2013.0,2,0,2
DNK,ARG,2013.0,1,0,1
GHA,RUS,2022.0,1,0,1
CHN,LUX,2020.0,1,0,1
POL,ETH,2007.0,1,0,1
PRT,LUX,2005.0,2,0,2
CRI,ISR,2009.0,1,0,1
CHE,QAT,2014.0,2,0,2
CHE,PAK,2004.0,6,0,6
GBR,TUN,2000.0,1,0,1
FRA,NPL,2009.0,1,0,1
IND,YEM,2004.0,1,0,1
THA,ETH,2005.0,2,0,2
BFA,SLE,2013.0,1,0,1
MYS,KEN,2007.0,1,0,1
LUX,NOR,2011.0,1,0,1
BOL,COL,2018.0,1,0,1
BHR,EGY,2009.0,3,0,3
USA,ASM,2013.0,1,0,1
TZA,IRL,2021.0,1,0,1
FRA,BIH,2011.0,2,0,2
SAU,GRC,2002.0,1,0,1
IDN,LBR,2017.0,1,0,1
DNK,LUX,2016.0,2,0,2
BEL,TZA,2013.0,2,0,2
NOR,CMR,2016.0,1,0,1
IRN,ECU,2022.0,1,0,1
SUR,,2019.0,10,0,10
POL,VNM,2018.0,3,0,3
GRC,QAT,2022.0,1,0,1
HKG,CHL,2004.0,1,0,1
COD,,2006.0,2,0,2
GIN,MLI,2010.0,1,0,1
MDG,COG,2017.0,1,0,1
THA,KAZ,2017.0,1,0,1
LVA,AUT,2001.0,4,0,4
TTO,IND,1998.0,1,0,1
ESP,AUS,1997.0,1,0,1
MYS,SDN,2006.0,1,0,1
ZAF,OMN,1999.0,1,0,1
BIH,SVN,2009.0,1,0,1
ITA,MOZ,2017.0,2,0,2
,LIE,2008.0,4,0,4
CHN,OMN,2016.0,1,0,1
CAN,PYF,2022.0,1,0,1
,SUR,2008.0,5,0,5
OMN,NGA,2020.0,1,0,1
ESP,CPV,2013.0,1,0,1
PER,MYS,2018.0,1,0,1
NGA,NOR,2021.0,2,0,2
SGP,COL,2021.0,2,0,2
BEL,ISL,2019.0,1,0,1
DNK,BRN,2013.0,1,0,1
TUR,KHM,2007.0,1,0,1
GBR,NAM,2020.0,1,0,1
ARG,DNK,2022.0,2,0,2
NOR,QAT,2018.0,2,0,2
GLP,MDG,2012.0,1,0,1
BFA,NGA,2006.0,3,0,3
KOR,HRV,2017.0,1,0,1
GRC,HRV,2008.0,1,0,1
SEN,KEN,2014.0,1,0,1
HKG,TUR,2006.0,1,0,1
LKA,BRN,2009.0,1,0,1
KEN,COL,2000.0,1,0,1
ETH,CHE,2013.0,1,0,1
GHA,DEU,2005.0,1,0,1
BFA,ZMB,2006.0,1,0,1
OMN,QAT,2020.0,2,0,2
TUR,SVN,2016.0,2,0,2
KEN,BWA,2004.0,1,0,1
RUS,ZAF,1997.0,2,0,2
DNK,FRO,2004.0,1,0,1
SAU,NGA,1999.0,2,0,2
CIV,BEL,2005.0,1,0,1
SRB,DNK,2001.0,3,0,3
GAB,GBR,2013.0,1,0,1
ETH,RWA,2014.0,1,0,1
ARM,ITA,2005.0,1,0,1
NOR,COG,2017.0,1,0,1
GIB,ESP,2016.0,1,0,1
KOR,ARG,2012.0,2,0,2
MKD,POL,2016.0,1,0,1
MAC,GIB,2022.0,1,0,1
LIE,NLD,2020.0,1,0,1
SOM,SWE,2017.0,1,0,1
ITA,MOZ,2019.0,1,0,1
,COM,2017.0,1,0,1
SDN,ARE,2014.0,1,0,1
EST,AUS,2003.0,1,0,1
IND,GEO,2019.0,1,0,1
ESP,KWT,2012.0,1,0,1
FRA,GHA,2014.0,2,0,2
IRL,OMN,2018.0,1,0,1
COM,REU,2018.0,1,0,1
NZL,PER,2022.0,1,0,1
GHA,,1999.0,2,0,2
CUB,CAN,2007.0,3,0,3
IND,SYR,2011.0,2,0,2
RWA,SAU,2022.0,2,0,2
MDG,NCL,2012.0,1,0,1
GLP,USA,2011.0,1,0,1
CZE,SVN,2007.0,1,0,1
DZA,MYS,2010.0,1,0,1
GRC,EGY,2008.0,1,0,1
CZE,ISR,2002.0,1,0,1
HKG,FRA,2000.0,2,0,2
POL,LAO,2014.0,1,0,1
THA,FIN,2000.0,1,0,1
LUX,GRC,2007.0,1,0,1
PAK,LBR,2009.0,1,0,1
NOR,KEN,2010.0,1,0,1
SRB,IRL,2016.0,1,0,1
UKR,ROU,2008.0,1,0,1
THA,GAB,2009.0,1,0,1
KOR,HRV,2019.0,2,0,2
ZWE,SWZ,2008.0,1,0,1
ROU,FIN,2018.0,2,0,2
JPN,UKR,2010.0,4,0,4
CUB,YEM,2014.0,1,0,1
NGA,LBR,2017.0,3,0,3
GNQ,,2023.0,5,0,5
IRL,EST,2004.0,1,0,1
IND,CZE,2003.0,3,0,3
CHN,QAT,2012.0,1,0,1
BOL,DNK,2007.0,2,0,2
CIV,AUT,2006.0,1,0,1
YEM,ESP,2007.0,2,0,2
POL,NZL,2002.0,2,0,2
NOR,TUN,2021.0,1,0,1
RUS,MKD,2009.0,1,0,1
UKR,DZA,2019.0,1,0,1
QAT,SWE,2020.0,2,0,2
ETH,HUN,2021.0,2,0,2
IRN,MEX,2019.0,1,0,1
COL,TZA,2022.0,1,0,1
ITA,IRQ,2022.0,1,0,1
,SMR,2000.0,1,0,1
MYS,AFG,2017.0,1,0,1
ERI,PNG,2009.0,1,0,1
HRV,SVK,2022.0,1,0,1
NZL,JOR,2021.0,2,0,2
CUB,FIN,2022.0,1,0,1
ESP,OMN,2013.0,1,0,1
NGA,GMB,2011.0,1,0,1
ESP,TUN,2004.0,1,0,1
AUT,MEX,1999.0,1,0,1
NZL,TUR,2001.0,1,0,1
AUT,COL,2003.0,1,0,1
TWN,PHL,2007.0,1,0,1
BFA,GAB,2004.0,1,0,1
PAK,SDN,2016.0,1,0,1
USA,TJK,2008.0,2,0,2
NLD,LBN,2016.0,1,0,1
FIN,ROU,2011.0,2,0,2
CHL,JPN,2018.0,3,0,3
MYS,UGA,2016.0,1,0,1
NOR,EGY,2013.0,1,0,1
JPN,MWI,2020.0,3,0,3
ETH,CIV,2016.0,1,0,1
UKR,IRN,2020.0,1,0,1
TZA,ZWE,2020.0,1,0,1
MNE,ITA,2017.0,1,0,1
ZWE,CHE,2022.0,2,0,2
BFA,ETH,2016.0,1,0,1
IRQ,CZE,2021.0,1,0,1
BRA,SVK,2020.0,3,0,3
NOR,MAR,2018.0,1,0,1
KEN,BFA,2008.0,1,0,1
USA,YEM,2002.0,1,0,1
SVK,KWT,1999.0,1,0,1
URY,DEU,2004.0,1,0,1
TUR,WSM,2017.0,1,0,1
PNG,CZE,2011.0,1,0,1
BRA,KWT,2017.0,1,0,1
VNM,PER,2014.0,1,0,1
KGZ,CHE,2019.0,1,0,1
REU,,2012.0,3,0,3
CYP,AUS,2012.0,1,0,1
ARG,ZAF,2019.0,1,0,1
NZL,KNA,2021.0,1,0,1
COG,PER,2020.0,1,0,1
PRY,,2006.0,1,0,1
COG,NER,2014.0,1,0,1
PRT,VNM,2015.0,1,0,1
BLR,FIN,2004.0,1,0,1
LVA,ISR,1999.0,1,0,1
POL,NZL,2005.0,1,0,1
,TLS,2011.0,7,0,7
GUM,AUS,2013.0,2,0,2
CHL,POL,2021.0,3,0,3
DEU,PRI,2002.0,1,0,1
ZAF,URY,2008.0,1,0,1
IND,MDV,2021.0,1,0,1
SVN,FIN,2016.0,1,0,1
MMR,ITA,2017.0,1,0,1
PAN,POL,2021.0,1,0,1
TWN,SWZ,2022.0,1,0,1
ESP,BGD,2021.0,1,0,1
CPV,PRT,2014.0,1,0,1
SYC,USA,2019.0,1,0,1
GBR,MDA,2008.0,1,0,1
FIN,TWN,2018.0,2,0,2
SYR,AUT,2006.0,1,0,1
MLI,MRT,2014.0,1,0,1
ARM,CHN,2012.0,1,0,1
ARM,ITA,2002.0,1,0,1
IRL,BGD,2014.0,1,0,1
NOR,KWT,2018.0,1,0,1
ISL,,2000.0,2,0,2
TZA,PHL,2021.0,1,0,1
BEL,SGP,1998.0,1,0,1
GRC,BGD,2017.0,1,0,1
BEL,CRI,2014.0,1,0,1
NLD,CYP,2008.0,1,0,1
UZB,AUS,2006.0,1,0,1
GRC,BGD,2010.0,1,0,1
,TON,2016.0,2,0,2
MAR,MRT,2011.0,1,0,1
FJI,GBR,2002.0,2,0,2
MAR,AUT,2005.0,1,0,1
BRN,IND,2010.0,1,0,1
ESP,PYF,2017.0,1,0,1
UGA,PAK,2017.0,1,0,1
ARE,ARM,2007.0,1,0,1
DNK,HKG,2005.0,1,0,1
NZL,NAM,2011.0,1,0,1
MDA,ROU,2014.0,1,0,1
SSD,CHN,2020.0,1,0,1
SRB,CYP,2020.0,1,0,1
PAK,EST,2021.0,2,0,2
IND,LBY,2022.0,1,0,1
FRA,GIN,2004.0,1,0,1
PRY,FRA,2019.0,1,0,1
THA,ARE,2021.0,1,0,1
SWE,BOL,2011.0,1,0,1
KAZ,CYP,2019.0,1,0,1
ESP,HND,2011.0,1,0,1
KAZ,MDA,2018.0,1,0,1
TUN,PRT,2012.0,1,0,1
GRC,BGD,2019.0,1,0,1
BLR,ESP,2017.0,1,0,1
FIN,MDG,2018.0,1,0,1
LUX,POL,2015.0,1,0,1
BIH,BGR,2002.0,1,0,1
OMN,HUN,2007.0,1,0,1
SVN,ESP,2000.0,1,0,1
CMR,COG,2007.0,1,0,1
PRI,ARG,2013.0,1,0,1
RUS,SGP,2009.0,1,0,1
AGO,CPV,2020.0,1,0,1
PHL,MAR,2020.0,1,0,1
PSE,CHE,2013.0,1,0,1
PRT,LTU,2015.0,1,0,1
KAZ,NZL,2017.0,1,0,1
POL,PSE,2019.0,1,0,1
HKG,HRV,2018.0,1,0,1
CYP,POL,2015.0,1,0,1
DEU,NAM,2015.0,1,0,1
BRA,PRI,2006.0,1,0,1
FRO,GBR,2008.0,1,0,1
DNK,ETH,2008.0,1,0,1
BHS,LSO,2006.0,1,0,1
GLP,,2005.0,1,0,1
NLD,MEX,1999.0,2,0,2
FIN,KWT,2002.0,2,0,2
ZAF,GMB,2022.0,1,0,1
CHE,NOR,1997.0,2,0,2
ITA,LVA,2001.0,1,0,1
NZL,FIN,2007.0,2,0,2
AUS,LVA,2020.0,1,0,1
MYS,CHE,2011.0,1,0,1
KAZ,NZL,2019.0,1,0,1
FRA,PSE,2017.0,1,0,1
PAK,ALB,2019.0,1,0,1
MKD,GRC,2017.0,1,0,1
MDV,,2013.0,1,0,1
MRT,,2012.0,1,0,1
MCO,ITA,2002.0,1,0,1
SEN,GMB,2013.0,1,0,1
TUR,AFG,2022.0,1,0,1
LUX,MAR,2007.0,1,0,1
MNG,CHE,2013.0,1,0,1
SWE,MLT,2016.0,1,0,1
ALB,DNK,2017.0,1,0,1
SLV,,2003.0,1,0,1
MAR,USA,1999.0,1,0,1
THA,ZAF,2006.0,1,0,1
BLR,CZE,2001.0,1,0,1
MAR,SYR,1999.0,1,0,1
ARE,SDN,2007.0,1,0,1
DEU,BRN,2016.0,1,0,1
ESP,PHL,2006.0,1,0,1
SEN,GBR,2013.0,1,0,1
PNG,SGP,2021.0,1,0,1
KOR,BGR,2008.0,1,0,1
BRB,GRD,2016.0,1,0,1
DNK,SVK,2019.0,1,0,1
BIH,NLD,2019.0,1,0,1
CRI,NIC,2015.0,1,0,1
URY,CHE,2011.0,1,0,1
BWA,FIN,2020.0,1,0,1
SVK,JPN,2020.0,1,0,1
KOR,TTO,2018.0,1,0,1
DNK,VEN,2006.0,1,0,1
FRA,BHR,2018.0,1,0,1
LUX,ISR,1999.0,1,0,1
MEX,SYR,2011.0,1,0,1
BRA,QAT,2012.0,1,0,1
SWE,URY,2009.0,1,0,1
ISR,ALB,2008.0,1,0,1
CHN,RWA,2014.0,1,0,1
HKG,CZE,2020.0,1,0,1
DNK,NAM,2018.0,1,0,1
LKA,ITA,2022.0,1,0,1
USA,NCL,2009.0,1,0,1
DZA,NLD,2003.0,1,0,1
TUN,KWT,2018.0,1,0,1
ESP,KAZ,2002.0,1,0,1
UKR,NZL,1998.0,2,0,2
LTU,DEU,1997.0,1,0,1
YEM,CUB,2008.0,2,0,2
BGD,AFG,2006.0,1,0,1
QAT,POL,2022.0,1,0,1
ZAF,TTO,2022.0,1,0,1
EGY,SYR,2013.0,1,0,1
FRA,MUS,2014.0,1,0,1
JOR,BIH,2004.0,1,0,1
IRN,BGD,2015.0,1,0,1
QAT,IRL,2017.0,1,0,1
SGP,ZAF,2018.0,1,0,1
PAK,HKG,2012.0,1,0,1
GBR,MOZ,2009.0,1,0,1
BRB,USA,2020.0,1,0,1
CHE,URY,2018.0,1,0,1
MAR,POL,2018.0,1,0,1
CHL,PRY,2015.0,1,0,1
COL,EGY,2021.0,1,0,1
GTM,PER,2016.0,1,0,1
SSD,SAU,2013.0,1,0,1
TUN,GUF,2021.0,1,0,1
USA,CHN,2008.0,937,1385,-448
CAN,USA,2011.0,1517,1317,200
DEU,GBR,2011.0,468,531,-63
USA,JPN,2009.0,942,1008,-66
SWE,GBR,2019.0,147,184,-37
POL,USA,2016.0,117,76,41
ESP,CHE,2016.0,127,64,63
CHN,USA,2014.0,2391,2263,128
USA,ITA,2004.0,368,387,-19
GBR,GRC,2004.0,99,61,38
CHN,IND,2020.0,87,220,-133
IRL,GBR,2013.0,239,178,61
DEU,AUT,2008.0,228,179,49
ESP,GBR,2005.0,157,141,16
CHL,DEU,2009.0,26,26,0
BEL,GRC,2003.0,10,3,7
NLD,CHN,2011.0,34,58,-24
GBR,CAN,2018.0,353,375,-22
JPN,BRA,2015.0,13,10,3
GBR,ZWE,2019.0,10,5,5
EST,GBR,2018.0,10,6,4
NLD,GBR,2006.0,201,127,74
NGA,GBR,2014.0,27,41,-14
FIN,FRA,2011.0,17,18,-1
CYP,FRA,2012.0,2,2,0
DEU,SDN,2014.0,3,1,2
AUS,SWE,2009.0,28,39,-11
SDN,SAU,2014.0,24,3,21
USA,ESP,2016.0,299,540,-241
GRC,USA,2004.0,81,97,-16
ROU,FRA,2011.0,34,32,2
RUS,POL,2020.0,18,8,10
BEL,ESP,2020.0,59,71,-12
BEL,NOR,2014.0,7,4,3
USA,NOR,2014.0,77,69,8
BEL,FRA,2018.0,205,205,0
FRA,PHL,2019.0,4,2,2
USA,SAU,2009.0,82,33,49
SWE,BRA,2011.0,8,13,-5
DEU,CAN,2010.0,142,138,4
NLD,USA,2012.0,310,307,3
MYS,USA,2012.0,26,26,0
JPN,CHN,2009.0,376,247,129
JPN,SGP,2022.0,12,16,-4
DEU,IND,2012.0,110,111,-1
SWE,GBR,2010.0,110,112,-2
ZAF,BRA,2017.0,3,5,-2
ARG,USA,2004.0,160,59,101
SWE,POL,2007.0,9,9,0
KEN,UGA,2014.0,8,7,1
NOR,UGA,2009.0,3,2,1
CAN,FRA,2009.0,180,266,-86
SGP,HKG,2021.0,41,28,13
NLD,BRA,2013.0,15,16,-1
ZWE,MEX,2017.0,2,4,-2
ESP,GBR,2002.0,131,145,-14
DNK,SWE,2012.0,66,74,-8
IRN,CAN,2013.0,240,49,191
ESP,CZE,2020.0,25,19,6
CAN,IRN,2007.0,52,57,-5
AUS,CAN,2011.0,130,191,-61
CYP,TUR,2015.0,20,35,-15
JPN,LAO,2018.0,4,1,3
DEU,ETH,2005.0,3,3,0
BLR,RUS,2014.0,21,9,12
ZAF,ETH,2006.0,4,1,3
IRL,EST,2015.0,1,1,0
FRA,DZA,2013.0,77,31,46
DEU,SGP,2021.0,21,22,-1
TZA,UGA,2018.0,2,4,-2
USA,MYS,2016.0,33,41,-8
EGY,LBN,2019.0,10,1,9
ESP,ARG,2020.0,60,86,-26
CHN,PAK,2021.0,344,209,135
FRA,AUT,2016.0,33,35,-2
BRA,PRT,2015.0,84,118,-34
NZL,GBR,2014.0,115,107,8
GBR,IRN,2010.0,42,29,13
BGD,IND,2016.0,15,10,5
FRA,ISR,2014.0,24,17,7
ISL,GBR,2016.0,5,6,-1
CHN,TWN,2015.0,67,135,-68
CHE,IRL,2016.0,11,15,-4
ISR,CHE,2014.0,18,15,3
IRN,DNK,2020.0,36,8,28
DEU,GRC,2021.0,39,43,-4
SAU,CAN,2017.0,67,115,-48
TWN,GBR,2019.0,26,33,-7
DEU,JPN,2006.0,85,102,-17
BGD,AUS,2012.0,28,8,20
CZE,SRB,2016.0,1,2,-1
ARG,DEU,2011.0,24,18,6
BEL,GBR,2013.0,79,97,-18
CAN,CHN,2014.0,205,267,-62
SGP,NLD,2018.0,15,15,0
ITA,IRL,2015.0,32,18,14
GBR,JPN,2013.0,112,109,3
IRL,NLD,2013.0,16,16,0
AUT,CHE,2017.0,76,73,3
ESP,GRC,2016.0,14,15,-1
GBR,FIN,2018.0,66,55,11
THA,USA,2020.0,109,173,-64
AUT,CHE,2019.0,75,59,16
TWN,GBR,2017.0,39,21,18
USA,PHL,2011.0,26,30,-4
JPN,CHE,2022.0,13,12,1
ESP,ISR,2022.0,8,2,6
DNK,NLD,2003.0,18,18,0
AUT,USA,2001.0,98,72,26
ITA,PAK,2016.0,23,9,14
POL,TWN,2015.0,4,1,3
USA,SWZ,2017.0,4,1,3
DEU,CAN,2019.0,167,155,12
GBR,IRN,2017.0,37,68,-31
ETH,ZAF,2021.0,5,7,-2
AUT,GBR,2022.0,44,49,-5
USA,HKG,2018.0,142,150,-8
ECU,GBR,2015.0,4,6,-2
BRA,FRA,2016.0,118,113,5
POL,DEU,2020.0,50,60,-10
FRA,COL,2018.0,36,14,22
DEU,CZE,2020.0,60,41,19
PRT,CHE,2020.0,28,8,20
CHE,BEL,2008.0,25,24,1
SWE,AUT,2020.0,27,34,-7
DEU,RWA,2019.0,2,3,-1
JPN,IDN,2004.0,27,10,17
CZE,SVK,2014.0,33,71,-38
CHE,REU,2019.0,1,1,0
IND,TWN,2016.0,63,42,21
COL,VEN,2016.0,7,35,-28
COL,AUS,2018.0,10,7,3
DNK,AUT,2015.0,9,17,-8
USA,IRN,2007.0,34,59,-25
BGD,USA,2016.0,55,31,24
GBR,NZL,2000.0,25,25,0
ETH,ESP,2020.0,2,2,0
CHN,EGY,2020.0,39,37,2
RUS,KAZ,2013.0,17,9,8
EGY,JPN,2008.0,13,37,-24
MYS,KOR,2018.0,19,13,6
AUS,GRC,2015.0,2,9,-7
HRV,ESP,2019.0,4,4,0
GBR,MEX,2018.0,53,66,-13
AUS,BRA,2020.0,26,56,-30
BRA,URY,2021.0,8,4,4
SAU,CAN,2019.0,86,144,-58
USA,FIN,2022.0,22,26,-4
BEL,CAN,2021.0,33,42,-9
ITA,NGA,2016.0,2,1,1
RUS,ISR,2021.0,16,3,13
GBR,ITA,2001.0,161,144,17
BGD,NPL,2020.0,3,1,2
TUR,CHE,2020.0,18,14,4
RUS,GEO,2019.0,4,1,3
PAK,TWN,2018.0,6,4,2
IRQ,USA,2021.0,11,31,-20
ARM,DEU,1997.0,3,1,2
TZA,CHE,2019.0,12,5,7
HRV,DEU,2003.0,11,14,-3
PAK,ARE,2021.0,14,4,10
ITA,IND,2002.0,10,7,3
CHN,THA,2021.0,21,24,-3
GRC,GBR,2007.0,92,133,-41
SGP,FIN,2006.0,2,5,-3
AUS,IRQ,2022.0,8,2,6
GBR,IRL,2009.0,188,145,43
GBR,LUX,2008.0,4,2,2
SWE,GBR,2017.0,124,177,-53
ZAF,TZA,2021.0,8,4,4
IDN,FRA,2022.0,4,1,3
JPN,SWE,2012.0,22,17,5
UKR,SWE,2007.0,2,9,-7
SGP,MYS,2009.0,17,10,7
ARG,CHE,2013.0,10,4,6
CHN,ESP,2007.0,9,4,5
DEU,KOR,2014.0,43,42,1
CAN,BRA,2012.0,49,67,-18
NLD,KOR,2011.0,10,5,5
TWN,CHN,1999.0,6,11,-5
PER,ESP,2016.0,17,19,-2
AUT,HRV,2021.0,3,5,-2
AUT,CHE,2010.0,57,39,18
NLD,GRC,2013.0,9,19,-10
MYS,IRN,2021.0,31,16,15
DNK,ESP,2013.0,14,21,-7
JPN,RUS,2009.0,15,16,-1
FRA,MTQ,2013.0,19,26,-7
ISR,FRA,2020.0,25,25,0
USA,COL,2006.0,40,28,12
FIN,JPN,2009.0,7,7,0
GBR,BWA,2010.0,2,2,0
AUT,DEU,1998.0,55,51,4
VEN,COL,2011.0,11,7,4
AUT,SRB,2012.0,4,1,3
FRA,GRC,2012.0,22,34,-12
IRN,NOR,2015.0,15,5,10
FRA,IND,2004.0,21,35,-14
IRL,JPN,2012.0,5,3,2
ISR,RUS,2015.0,8,13,-5
DEU,THA,2021.0,13,13,0
GBR,JOR,2021.0,23,14,9
PRT,AUT,2020.0,11,7,4
UZB,GBR,2015.0,2,3,-1
BEL,ITA,2003.0,26,51,-25
ESP,CHL,2009.0,44,26,18
TUR,AUT,2015.0,3,3,0
ETH,USA,2018.0,22,27,-5
SAU,KOR,2013.0,6,19,-13
GBR,BWA,2017.0,5,2,3
NOR,DNK,2002.0,21,21,0
TWN,ETH,2020.0,13,4,9
HUN,POL,2012.0,7,2,5
RUS,IND,2022.0,5,10,-5
AUT,FRA,2016.0,35,33,2
AUS,OMN,2020.0,3,2,1
FJI,AUS,2022.0,1,2,-1
SRB,GBR,2003.0,5,2,3
TUR,NLD,2021.0,23,12,11
CHE,IND,2021.0,26,23,3
ZAF,NLD,2009.0,16,13,3
UKR,SVK,2021.0,6,2,4
SGP,CAN,2007.0,9,22,-13
KEN,GBR,2020.0,31,31,0
USA,GRD,2018.0,8,10,-2
BEN,NGA,2019.0,4,1,3
THA,GBR,2005.0,15,63,-48
ITA,ISR,1997.0,3,1,2
MEX,RUS,2018.0,4,2,2
USA,MAC,2016.0,8,8,0
TZA,CHE,2017.0,5,3,2
NZL,BGD,2016.0,2,1,1
IDN,AUS,2017.0,15,71,-56
IRN,IRQ,2020.0,20,7,13
BEL,COD,2022.0,3,3,0
CZE,POL,2022.0,10,9,1
CZE,SWE,2013.0,7,5,2
JPN,MEX,2002.0,7,2,5
GEO,DEU,2017.0,4,3,1
COD,CHN,2018.0,1,1,0
SLE,USA,2021.0,10,6,4
PRT,NLD,2010.0,18,24,-6
PAK,BRA,2021.0,5,3,2
BEL,CHE,2003.0,16,19,-3
CIV,FRA,2018.0,8,19,-11
SAU,MYS,2021.0,18,42,-24
BRA,ARG,2003.0,15,26,-11
RUS,PRT,2011.0,5,2,3
THA,IND,2020.0,5,22,-17
KOR,ECU,2019.0,2,1,1
IND,MEX,2020.0,11,8,3
BRB,GBR,2019.0,1,3,-2
TWN,GBR,2010.0,23,40,-17
IRN,QAT,2022.0,3,1,2
KEN,ZWE,2020.0,1,1,0
ZAF,BRA,2010.0,4,5,-1
TUR,PRT,2020.0,6,1,5
TUR,ALB,2019.0,2,1,1
GBR,IRQ,2009.0,3,2,1
CZE,GBR,2015.0,36,40,-4
NLD,SWE,2016.0,63,44,19
GBR,FJI,2021.0,1,1,0
ARE,GBR,2005.0,8,10,-2
NLD,DEU,2004.0,137,140,-3
CAN,MEX,2007.0,24,25,-1
IDN,USA,2003.0,12,11,1
GBR,IRN,2019.0,34,75,-41
GBR,ZWE,2017.0,9,4,5
GHA,USA,2008.0,8,11,-3
VEN,ECU,2016.0,24,1,23
CAN,NLD,2012.0,57,55,2
HUN,SWE,2001.0,12,3,9
ESP,KOR,2013.0,5,5,0
EGY,GBR,2009.0,18,44,-26
FRA,CIV,2011.0,34,19,15
USA,KEN,2007.0,21,21,0
JPN,MEX,2005.0,3,2,1
DNK,CAN,2011.0,20,20,0
RUS,AUS,2006.0,10,2,8
GBR,ETH,2006.0,2,1,1
KEN,PER,2020.0,4,1,3
ZAF,KEN,2007.0,7,10,-3
AUT,DEU,1997.0,27,27,0
GBR,EST,2011.0,7,2,5
AUS,THA,2011.0,22,19,3
AUS,NZL,2009.0,116,157,-41
JPN,EGY,2007.0,32,18,14
USA,GHA,2013.0,15,10,5
GBR,CHL,2002.0,8,7,1
SWE,DNK,2003.0,55,48,7
CHE,IRN,2012.0,6,22,-16
AUS,DEU,1998.0,17,24,-7
UKR,JPN,2004.0,9,1,8
USA,URY,2018.0,7,16,-9
BRA,NLD,2000.0,3,4,-1
RUS,AZE,2003.0,6,3,3
GRC,FRA,2001.0,11,18,-7
NLD,UGA,2012.0,2,3,-1
JPN,DNK,2004.0,11,6,5
CAN,HKG,2009.0,23,28,-5
DNK,AUS,2000.0,5,3,2
EGY,LBN,2010.0,3,2,1
GBR,KEN,2002.0,14,14,0
GRC,CHE,2005.0,6,15,-9
HRV,USA,2022.0,7,5,2
DNK,ITA,2006.0,7,22,-15
USA,NPL,2009.0,3,10,-7
NOR,BGR,2002.0,1,1,0
DEU,UKR,2001.0,15,25,-10
ITA,SAU,2020.0,9,8,1
POL,GBR,2003.0,22,33,-11
JPN,PHL,1998.0,1,1,0
OMN,ARE,2013.0,5,1,4
AUS,ZWE,2012.0,3,1,2
AUS,MYS,2005.0,13,11,2
DEU,HRV,2020.0,7,16,-9
NZL,IRL,2004.0,5,4,1
IRL,CHE,2002.0,5,5,0
BEL,JPN,1999.0,5,8,-3
RUS,ARM,2004.0,6,2,4
ZAF,DEU,2011.0,18,22,-4
NOR,FRA,2006.0,8,20,-12
KWT,NGA,2007.0,1,1,0
ITA,IND,2005.0,12,12,0
CHE,BRA,2011.0,7,11,-4
EGY,BEL,2003.0,1,1,0
JOR,KWT,2014.0,3,1,2
GBR,ZAF,1999.0,13,13,0
AUT,CAN,2008.0,14,9,5
HUN,ROU,2006.0,7,2,5
KOR,DEU,1999.0,6,8,-2
PAK,CHE,2006.0,3,2,1
GBR,CHL,2005.0,21,8,13
RUS,BRA,1999.0,8,5,3
NGA,OMN,2014.0,1,1,0
CAN,POL,2004.0,11,20,-9
EGY,KWT,2001.0,4,8,-4
GBR,HUN,1999.0,6,9,-3
ESP,URY,2013.0,13,6,7
PRT,BRA,2001.0,9,16,-7
AUS,DEU,1997.0,6,15,-9
CHN,BEL,2002.0,13,14,-1
PAK,CHN,2000.0,1,1,0
HKG,DNK,2020.0,5,1,4
AUT,RUS,2003.0,2,7,-5
THA,GBR,2002.0,13,31,-18
AUS,MYS,2002.0,6,10,-4
USA,JAM,2016.0,4,6,-2
TTO,GBR,2014.0,4,2,2
AUS,CHN,2001.0,19,37,-18
BEL,ZAF,2012.0,6,7,-1
IDN,AUS,2019.0,25,91,-66
JOR,QAT,2009.0,2,4,-2
IRL,DEU,2007.0,19,35,-16
PRT,GBR,1998.0,4,13,-9
POL,ZAF,2004.0,1,1,0
NZL,VNM,2020.0,1,2,-1
CHE,ISR,2000.0,5,1,4
YEM,USA,2010.0,1,2,-1
DEU,JOR,2011.0,9,6,3
AUT,NLD,2011.0,14,18,-4
ITA,PRT,2009.0,18,4,14
POL,DNK,2009.0,5,6,-1
ALB,ESP,2017.0,1,1,0
AUS,POL,2014.0,5,23,-18
CAN,MYS,2013.0,10,17,-7
BEL,BEN,2010.0,3,1,2
BGD,CAN,2008.0,8,8,0
MWI,GBR,2003.0,5,5,0
CHE,GRC,2015.0,14,44,-30
SGP,ISR,2014.0,5,6,-1
JPN,LKA,2017.0,13,2,11
OMN,MYS,2011.0,2,4,-2
DNK,IRN,2014.0,3,23,-20
CHE,ARE,2019.0,1,2,-1
RUS,IRN,2018.0,5,5,0
KOR,IDN,2007.0,2,3,-1
NLD,BEN,2018.0,3,2,1
RUS,SWE,2020.0,18,15,3
SVN,ITA,2013.0,6,5,1
UKR,DEU,2014.0,38,13,25
PAK,DNK,2020.0,8,6,2
NZL,NGA,2020.0,3,2,1
SGP,IRN,2015.0,4,13,-9
KWT,EGY,2017.0,14,7,7
JAM,USA,1997.0,1,1,0
ISR,ARG,2022.0,4,1,3
POL,PAK,2014.0,4,2,2
CHL,AUS,2012.0,10,6,4
PHL,IND,2018.0,6,6,0
VNM,SGP,2014.0,6,5,1
FIN,BRA,2016.0,8,3,5
NLD,HKG,2022.0,4,1,3
CHN,BRA,2018.0,4,13,-9
CRI,ESP,2015.0,5,9,-4
HKG,SGP,2000.0,3,4,-1
GBR,BWA,2019.0,6,2,4
MEX,SAU,2020.0,5,1,4
IDN,MYS,2016.0,11,70,-59
IRL,CAN,1999.0,3,4,-1
SGP,IDN,2018.0,6,5,1
IRL,PRT,2020.0,6,12,-6
IRN,ZAF,2020.0,5,2,3
IND,PHL,2011.0,3,5,-2
THA,PAK,2021.0,8,6,2
SAU,FRA,2018.0,9,45,-36
ZAF,BRA,2019.0,5,12,-7
GBR,PER,2009.0,1,3,-2
PRT,NLD,2017.0,28,20,8
IDN,AUS,2010.0,8,32,-24
USA,THA,2001.0,37,46,-9
ESP,RUS,2000.0,5,11,-6
RUS,KOR,2006.0,12,10,2
HUN,DNK,2018.0,5,2,3
PRT,CAN,2003.0,3,6,-3
EGY,DEU,2010.0,26,33,-7
KWT,EGY,2019.0,12,18,-6
HUN,FRA,2011.0,19,11,8
MEX,DEU,1997.0,5,1,4
ISL,USA,2006.0,9,23,-14
IND,SAU,2002.0,10,5,5
ETH,FRA,2013.0,2,3,-1
UKR,FRA,2016.0,13,6,7
AZE,RUS,2013.0,5,3,2
IRN,IRL,2015.0,9,3,6
ITA,SVK,2018.0,5,3,2
TUR,SAU,2013.0,7,1,6
TUN,IRN,2016.0,2,2,0
POL,IND,2017.0,10,15,-5
USA,PAN,2014.0,12,15,-3
HKG,JPN,2011.0,9,5,4
USA,EGY,1998.0,7,10,-3
PAK,KEN,2007.0,4,1,3
NLD,ROU,2009.0,4,4,0
PHL,TWN,2021.0,6,8,-2
FIN,EST,2014.0,14,7,7
BEL,LUX,2012.0,13,9,4
AUS,IRL,2006.0,22,31,-9
PRT,GBR,1997.0,4,7,-3
JPN,LKA,2010.0,8,4,4
ECU,BRA,2013.0,2,4,-2
PAK,JOR,2019.0,3,1,2
LBY,SAU,2011.0,2,1,1
GHA,GBR,2012.0,5,20,-15
IRL,FRA,2012.0,37,26,11
ROU,BEL,2014.0,6,6,0
GBR,LBY,2015.0,16,3,13
SGP,NZL,2022.0,9,7,2
SAU,MAC,2018.0,1,2,-1
DEU,URY,2019.0,2,4,-2
ZWE,USA,2022.0,3,3,0
TWN,ZAF,2017.0,2,4,-2
CHL,COL,2011.0,12,13,-1
CAN,ZAF,2011.0,16,13,3
IND,HKG,2002.0,4,3,1
MEX,IND,2021.0,6,7,-1
FRA,CMR,2022.0,4,4,0
KOR,GHA,2021.0,5,2,3
CHN,IRL,2021.0,12,20,-8
USA,PSE,2021.0,3,4,-1
UZB,RUS,2002.0,2,10,-8
MYS,IDN,2006.0,3,4,-1
NGA,JPN,2009.0,3,1,2
DEU,TZA,2015.0,6,6,0
PHL,SGP,2006.0,3,5,-2
ARE,GBR,2002.0,3,9,-6
GHA,BEN,2014.0,1,2,-1
RUS,GEO,2017.0,1,2,-1
COG,BFA,2013.0,1,1,0
GBR,HRV,2004.0,3,1,2
OMN,USA,2006.0,1,3,-2
ARE,QAT,2012.0,1,1,0
GBR,MYS,2000.0,11,5,6
CAN,ARG,1998.0,1,4,-3
NLD,FIN,2011.0,16,12,4
IND,DNK,2004.0,3,3,0
TWN,AUS,2014.0,22,9,13
CAN,HUN,2008.0,9,4,5
GEO,DEU,2019.0,5,4,1
LVA,DEU,2016.0,10,5,5
FRA,GLP,2018.0,6,22,-16
DEU,LVA,2016.0,5,10,-5
MEX,NLD,1997.0,3,1,2
ZWE,ZAF,2006.0,12,2,10
AZE,TUR,2012.0,2,9,-7
ETH,BEL,2012.0,1,4,-3
IND,SAU,2005.0,10,3,7
FRA,GAB,2007.0,4,5,-1
SWE,CHL,2014.0,3,2,1
GBR,UGA,2013.0,1,11,-10
EGY,ARE,2006.0,7,7,0
CZE,MEX,2021.0,1,9,-8
DEU,DZA,2011.0,4,1,3
MAR,ESP,2009.0,5,6,-1
PRT,SGP,2014.0,2,1,1
FIN,BEL,2011.0,5,3,2
FRA,MDG,2014.0,6,3,3
FRA,PHL,2010.0,4,2,2
CHE,HKG,2018.0,5,6,-1
CAN,LKA,2006.0,1,6,-5
HUN,CHE,2006.0,3,9,-6
DEU,PER,2013.0,2,2,0
LUX,IND,2015.0,2,1,1
HKG,FIN,2010.0,3,1,2
NLD,GHA,2020.0,7,6,1
DEU,LBN,2016.0,7,3,4
SRB,ALB,2020.0,2,5,-3
CHN,ZAF,2020.0,10,23,-13
KOR,CHE,2022.0,6,11,-5
BEL,KOR,2014.0,6,8,-2
PRT,ISR,2017.0,1,2,-1
FRA,GIN,2015.0,2,7,-5
POL,PRT,2012.0,4,4,0
CHN,CMR,2016.0,3,1,2
HND,ESP,2017.0,1,2,-1
SVN,NLD,2014.0,3,1,2
GBR,TTO,2020.0,4,4,0
AUS,IND,2007.0,17,47,-30
PRT,IND,2022.0,6,4,2
MEX,LUX,2020.0,1,1,0
ARE,LBN,2017.0,4,4,0
JPN,LKA,2019.0,15,6,9
THA,TWN,2018.0,6,15,-9
SGP,ITA,2020.0,8,7,1
BEL,BEN,2017.0,4,3,1
EGY,SGP,2015.0,1,1,0
KOR,ARE,2022.0,7,2,5
GBR,TZA,2018.0,7,3,4
ARE,AUT,2017.0,1,3,-2
ETH,GBR,2007.0,2,2,0
CHE,EST,2022.0,2,1,1
USA,KNA,2014.0,2,1,1
ARG,MEX,1999.0,3,2,1
SWE,KEN,2019.0,6,3,3
LUX,NLD,2009.0,1,3,-2
ROU,MDA,2022.0,1,1,0
PHL,PRT,2021.0,1,1,0
ITA,NZL,2005.0,2,1,1
ESP,DNK,2007.0,15,12,3
BEN,NGA,2010.0,1,1,0
TZA,USA,2008.0,4,4,0
USA,BEN,2021.0,1,3,-2
ARE,HKG,2017.0,3,2,1
PRT,TUR,2016.0,4,2,2
JPN,NOR,1998.0,2,3,-1
CAN,PAK,2002.0,2,8,-6
VNM,IRL,2021.0,1,1,0
BFA,SEN,2016.0,1,6,-5
JPN,ETH,2021.0,2,1,1
NOR,LKA,2020.0,2,1,1
MLI,CIV,2021.0,1,1,0
NPL,KOR,2022.0,2,2,0
CAN,MLT,2019.0,2,1,1
CHL,CHN,2021.0,6,4,2
AUS,SLB,2015.0,3,1,2
LUX,CHE,2021.0,2,6,-4
LKA,SGP,2018.0,1,4,-3
SVK,AUT,2022.0,3,2,1
USA,KWT,2008.0,8,6,2
ZAF,ARG,2010.0,2,3,-1
MEX,IRN,2018.0,2,1,1
FRA,HUN,2008.0,9,13,-4
NZL,BEL,2008.0,2,1,1
NOR,SGP,2013.0,3,4,-1
SDN,GBR,2009.0,1,2,-1
ARE,SAU,2011.0,11,6,5
FJI,NZL,2001.0,2,1,1
QAT,DEU,2021.0,1,1,0
USA,VEN,1997.0,4,3,1
JPN,CZE,2004.0,5,4,1
SWE,SVK,2001.0,2,2,0
CUB,PRT,2002.0,1,2,-1
COD,USA,2021.0,2,1,1
KWT,BHR,2019.0,1,2,-1
ZWE,RWA,2015.0,1,1,0
DEU,GAB,2004.0,1,3,-2
IND,POL,2003.0,1,4,-3
JOR,OMN,2010.0,2,1,1
ISR,JPN,2006.0,3,2,1
CHE,SRB,2004.0,1,3,-2
IND,HKG,2005.0,5,2,3
TWN,SGP,2004.0,5,5,0
NOR,DNK,2005.0,12,24,-12
CHL,PAN,2013.0,1,1,0
NOR,UKR,2007.0,1,1,0
ZWE,MEX,2019.0,3,1,2
VEN,BRA,2022.0,3,1,2
IND,GRC,2010.0,1,1,0
THA,DNK,2008.0,3,1,2
IRL,BEL,2022.0,7,7,0
TUR,FIN,2014.0,1,1,0
KOR,NGA,2013.0,1,1,0
ITA,NZL,2002.0,2,2,0
USA,CMR,2012.0,2,7,-5
NLD,CZE,2018.0,5,9,-4
RWA,CHE,2017.0,2,1,1
LIE,AUT,2017.0,2,2,0
HRV,ESP,2017.0,2,2,0
ESP,TUN,2015.0,4,1,3
ZAF,GHA,2012.0,3,4,-1
FRA,SVN,2018.0,5,2,3
OMN,KWT,2012.0,1,2,-1
JPN,JOR,2014.0,3,2,1
USA,TTO,2018.0,6,5,1
HRV,CHL,2014.0,1,1,0
PRT,MEX,2014.0,3,3,0
NOR,IDN,2015.0,4,2,2
JOR,CAN,2011.0,9,11,-2
USA,IRQ,2014.0,2,6,-4
OMN,DEU,2013.0,2,3,-1
LBY,SRB,2015.0,1,6,-5
NOR,PRT,2020.0,1,5,-4
CAN,UGA,2021.0,2,1,1
LTU,CHE,2021.0,5,1,4
TWN,EGY,2018.0,2,2,0
ETH,NOR,2018.0,5,9,-4
TZA,JPN,2019.0,1,9,-8
ITA,HUN,2014.0,5,6,-1
IRQ,DEU,2015.0,2,6,-4
BEN,NLD,2016.0,1,4,-3
SVK,SVN,2004.0,5,4,1
BRA,SAU,2018.0,1,1,0
EGY,IND,2018.0,3,6,-3
FRA,SGP,2003.0,1,3,-2
FSM,USA,2004.0,1,1,0
BGR,BEL,2020.0,1,4,-3
SWE,NZL,2002.0,3,4,-1
BEL,UGA,2009.0,2,2,0
PSE,DEU,2014.0,4,4,0
SVN,SVK,2011.0,6,1,5
CMR,FRA,2004.0,14,9,5
GMB,GBR,2007.0,6,4,2
FRA,URY,2020.0,6,2,4
IRQ,AUS,2016.0,6,3,3
USA,VEN,1998.0,4,7,-3
POL,IRN,2013.0,4,3,1
HKG,KOR,2012.0,5,4,1
USA,DZA,2015.0,3,2,1
YEM,JOR,2009.0,1,1,0
GBR,KEN,2005.0,9,6,3
DEU,COL,2022.0,5,11,-6
MEX,DEU,1998.0,3,4,-1
RUS,BEL,2006.0,7,6,1
HRV,FRA,2003.0,2,1,1
NOR,NZL,2011.0,2,3,-1
CYP,ARE,2019.0,2,3,-1
DNK,ISL,2011.0,4,7,-3
PHL,AUS,2007.0,2,8,-6
AUT,BEL,2012.0,8,5,3
SWZ,BWA,2007.0,1,1,0
GUM,USA,2006.0,3,1,2
GBR,MAC,2011.0,3,1,2
HUN,IRL,2014.0,1,1,0
DEU,ECU,2006.0,1,1,0
NLD,UKR,2015.0,2,5,-3
IRQ,IND,2012.0,2,4,-2
IND,FJI,2003.0,1,1,0
TWN,ZAF,2010.0,2,1,1
DNK,EGY,2009.0,3,1,2
USA,LSO,2019.0,1,1,0
CAN,BGD,2007.0,1,5,-4
FRA,SVK,2013.0,4,1,3
IND,EGY,2005.0,2,4,-2
NZL,MYS,2001.0,1,1,0
TZA,CHN,2021.0,4,9,-5
SGP,LKA,2021.0,2,1,1
ARM,IRN,2016.0,4,1,3
OMN,BGD,2018.0,1,2,-1
IDN,SGP,2017.0,1,7,-6
SWE,RUS,2022.0,8,8,0
IDN,SGP,2019.0,3,8,-5
BRA,DOM,2021.0,1,2,-1
DEU,ETH,2002.0,3,1,2
TWN,PHL,2008.0,1,2,-1
CAN,MLT,2017.0,1,2,-1
JAM,TTO,2013.0,3,2,1
ZAF,SWE,2007.0,4,3,1
DNK,ISR,2003.0,1,4,-3
SGP,NOR,2016.0,1,1,0
IRL,CHE,2005.0,3,6,-3
CUB,ITA,2001.0,7,1,6
UZB,RUS,2005.0,3,4,-1
JPN,BGD,2000.0,5,7,-2
KEN,BEL,2001.0,2,1,1
TWN,SWE,2022.0,2,1,1
ARG,VEN,2013.0,2,3,-1
IDN,NZL,2017.0,1,7,-6
BEN,FRA,2006.0,4,9,-5
NLD,BGR,2003.0,5,2,3
KWT,ARE,2018.0,5,2,3
ISR,CHN,1999.0,2,5,-3
SYR,DEU,2018.0,4,2,2
CHE,PAK,2015.0,2,3,-1
IRN,CZE,2018.0,5,3,2
ESP,GTM,2017.0,1,1,0
LKA,JPN,2016.0,7,9,-2
ITA,ISR,1998.0,3,1,2
FRA,TWN,2021.0,4,4,0
IRQ,CAN,2020.0,5,5,0
ITA,POL,1999.0,4,5,-1
MWI,CHN,2021.0,2,5,-3
IRL,KWT,2021.0,3,1,2
UKR,ITA,2007.0,4,1,3
BRA,SGP,2006.0,1,1,0
ETH,KEN,2016.0,3,4,-1
MMR,JPN,2012.0,4,2,2
USA,SWZ,2019.0,2,5,-3
AUT,GRC,2022.0,4,1,3
AUS,GHA,2020.0,6,19,-13
NGA,ITA,2004.0,1,2,-1
IND,LKA,2013.0,1,2,-1
USA,SLV,2008.0,1,1,0
USA,EGY,1997.0,3,5,-2
RUS,GEO,2010.0,2,5,-3
TWN,ITA,2008.0,2,3,-1
GRC,AUS,2003.0,2,3,-1
GBR,ZWE,2010.0,3,6,-3
ITA,BLR,2002.0,1,4,-3
AUS,DNK,2000.0,3,5,-2
MEX,HND,2006.0,1,2,-1
AUT,ISR,2012.0,3,7,-4
DNK,PRT,2006.0,2,1,1
CZE,HUN,2011.0,3,3,0
OMN,TUN,2008.0,3,1,2
PHL,KOR,2022.0,2,5,-3
ZAF,ISR,2007.0,1,3,-2
AUT,ARE,2016.0,2,1,1
PRT,MAC,2018.0,1,1,0
CHE,HUN,2022.0,2,3,-1
USA,SDN,2011.0,1,1,0
AUS,LBN,2016.0,1,5,-4
ESP,GTM,2019.0,3,1,2
KHM,JPN,2013.0,1,1,0
DEU,BHR,2015.0,1,2,-1
GTM,COL,2017.0,2,1,1
PRY,BRA,2014.0,2,2,0
WSM,NZL,2021.0,2,1,1
ARE,LBN,2010.0,1,4,-3
DNK,ZAF,2021.0,2,1,1
ARG,GBR,1998.0,4,4,0
RUS,TUR,2007.0,2,1,1
CRI,ARG,2021.0,2,1,1
TWN,HKG,2000.0,1,1,0
KEN,MEX,2019.0,3,6,-3
ARE,AUT,2019.0,1,2,-1
CHL,AUT,2014.0,2,6,-4
DNK,MYS,2014.0,1,6,-5
DEU,URY,2010.0,2,1,1
ZMB,CHN,2014.0,1,1,0
AUS,CHL,2005.0,1,1,0
SWE,LTU,2002.0,2,5,-3
BEL,GAB,2007.0,1,1,0
HRV,ESP,2010.0,2,2,0
HRV,HUN,2001.0,1,1,0
TZA,JPN,2010.0,1,4,-3
MEX,ITA,2001.0,2,5,-3
SWE,GRC,2006.0,3,2,1
ARE,LBN,2019.0,2,3,-1
BWA,GBR,2006.0,3,5,-2
ESP,EST,2015.0,3,1,2
CHE,FIN,2014.0,11,11,0
MYS,FRA,2013.0,1,10,-9
REU,CHE,2019.0,1,1,0
CHN,ARE,2012.0,1,1,0
HKG,CHE,2008.0,1,5,-4
MLI,SEN,2012.0,2,1,1
BRB,GBR,2017.0,2,1,1
VNM,SWE,2012.0,1,1,0
PRT,TUN,2020.0,4,6,-2
MAR,ITA,2019.0,5,2,3
RUS,EGY,2004.0,2,1,1
SWE,KEN,2017.0,2,8,-6
BRA,DNK,1997.0,1,1,0
USA,BIH,2020.0,1,5,-4
PHL,ITA,2018.0,2,2,0
CHE,BOL,2018.0,1,1,0
CAN,ARG,1997.0,1,1,0
HKG,CHL,2015.0,1,1,0
SRB,FRA,2011.0,1,2,-1
GHA,HKG,2018.0,5,1,4
KOR,RWA,2021.0,2,1,1
ETH,IND,2004.0,2,3,-1
SGP,BGD,2003.0,2,1,1
MYS,ESP,2018.0,1,5,-4
DEU,RWA,2017.0,2,1,1
ITA,SVN,2001.0,3,1,2
KEN,MEX,2010.0,1,1,0
MCO,FRA,2015.0,2,10,-8
DOM,MEX,2021.0,1,1,0
BGD,NLD,2022.0,1,1,0
JOR,IRQ,2009.0,1,3,-2
DEU,TWN,2001.0,5,10,-5
IRL,SVK,2017.0,2,1,1
SAU,PRT,2019.0,1,1,0
BGR,ESP,2018.0,1,3,-2
MLI,CHN,2019.0,2,2,0
LBN,AUS,2015.0,1,5,-4
BGD,PAK,2022.0,3,7,-4
PRT,ISR,2019.0,3,3,0
TWN,THA,2022.0,2,3,-1
TZA,DNK,2002.0,2,4,-2
MEX,NLD,1998.0,1,3,-2
AUS,CHL,2002.0,2,3,-1
TUR,AZE,1999.0,1,1,0
ZAF,JPN,2004.0,1,2,-1
NGA,SAU,2004.0,1,6,-5
LKA,CAN,2011.0,2,3,-1
ARM,DEU,1998.0,2,1,1
UKR,MEX,2014.0,2,2,0
TUR,RUS,2015.0,2,3,-1
HRV,CAN,2016.0,3,2,1
DNK,FRO,2015.0,1,2,-1
SGP,AUT,2014.0,2,2,0
HKG,THA,2012.0,2,1,1
NLD,LTU,2016.0,2,4,-2
LSO,ZWE,2015.0,1,1,0
TUR,PSE,2018.0,3,1,2
BRN,IDN,2020.0,2,5,-3
CAN,RWA,2019.0,1,3,-2
JOR,AUT,2014.0,1,2,-1
DNK,TZA,2020.0,1,2,-1
GBR,PHL,2012.0,2,3,-1
GMB,CHE,2009.0,1,1,0
AUS,EGY,2016.0,2,9,-7
PAK,KWT,2008.0,1,1,0
CUB,GBR,2016.0,2,1,1
LUX,BEL,2004.0,3,6,-3
ETH,AUS,2012.0,6,1,5
BEL,BEN,2019.0,1,4,-3
JAM,USA,1998.0,1,1,0
VNM,ITA,2002.0,1,4,-3
KAZ,CZE,2015.0,1,1,0
CAN,CUB,2011.0,1,3,-2
CRI,COL,2018.0,1,3,-2
IRL,MLT,2021.0,1,1,0
BGD,OMN,2009.0,1,1,0
BGR,GRC,2008.0,1,1,0
SVN,AUS,2022.0,1,1,0
KEN,MEX,2017.0,1,3,-2
HUN,PAK,2020.0,1,2,-1
RUS,CYP,2021.0,1,1,0
ECU,VEN,2022.0,2,4,-2
SWE,ARE,2004.0,2,1,1
PAK,SWE,2005.0,1,1,0
THA,CHE,2016.0,1,7,-6
IDN,SGP,2010.0,1,4,-3
IRL,SVK,2019.0,1,1,0
BGR,JPN,2014.0,2,4,-2
NGA,IND,2004.0,1,1,0
NLD,KAZ,2017.0,1,2,-1
NZL,EGY,2019.0,1,2,-1
MWI,NOR,2017.0,1,2,-1
BOL,BRA,2017.0,1,3,-2
ARG,NLD,2003.0,1,6,-5
UKR,ROU,2007.0,1,1,0
KOR,AUT,2016.0,1,3,-2
ESP,IRQ,2018.0,1,2,-1
HUN,UKR,2017.0,1,3,-2
IND,QAT,2022.0,3,3,0
YEM,USA,2019.0,1,4,-3
LUX,FRA,2001.0,1,1,0
POL,IRL,2002.0,1,1,0
BHR,TUR,2012.0,1,2,-1
NLD,CHL,2003.0,1,1,0
KEN,BWA,2015.0,1,1,0
USA,GMB,1999.0,1,1,0
UZB,USA,2022.0,1,1,0
PRT,RUS,2000.0,1,2,-1
SDN,KOR,2021.0,1,1,0
TUR,MYS,2018.0,1,8,-7
SYR,USA,2004.0,1,5,-4
ISR,CZE,2009.0,1,1,0
VNM,ITA,2005.0,1,1,0
ITA,TUN,2014.0,2,3,-1
MEX,BOL,2016.0,2,1,1
VNM,TWN,2004.0,1,1,0
PAN,BRA,2019.0,1,2,-1
PRT,ISR,2010.0,1,2,-1
POL,IND,2010.0,1,4,-3
ZAF,VNM,2022.0,1,2,-1
ZAF,CHE,2000.0,1,3,-2
ISL,AUS,2020.0,1,1,0
THA,AUT,2022.0,1,2,-1
IND,TZA,2013.0,1,2,-1
BGD,FIN,2011.0,1,1,0
SVN,HUN,2020.0,1,1,0
SAU,IRN,2014.0,1,1,0
UGA,GMB,2017.0,1,1,0
ATG,IND,2018.0,1,2,-1
SWE,SVN,2022.0,1,1,0
CYP,JOR,2020.0,1,2,-1
HUN,DEU,2004.0,44,34,10
USA,TWN,2015.0,305,277,28
DEU,CAN,2017.0,180,178,2
TZA,NOR,2012.0,3,2,1
CAN,DEU,2008.0,121,175,-54
JPN,ITA,2011.0,13,26,-13
AUS,IDN,2016.0,57,25,32
GBR,USA,2000.0,431,353,78
ESP,IND,2008.0,9,16,-7
CHL,IND,2016.0,4,5,-1
USA,ZMB,2020.0,10,9,1
USA,DNK,2007.0,82,84,-2
ARE,CAN,2010.0,11,17,-6
IRL,FIN,2016.0,8,4,4
EGY,DEU,2017.0,37,52,-15
FRA,KOR,2016.0,24,27,-3
ESP,SRB,2015.0,3,2,1
PER,NLD,2020.0,3,1,2
EGY,LBN,2017.0,4,5,-1
ARE,CAN,2017.0,21,30,-9
CAN,PRT,2014.0,10,14,-4
ISR,ZAF,2012.0,1,1,0
ARE,CAN,2019.0,30,26,4
SAU,PAK,2016.0,33,91,-58
TWN,JPN,2015.0,40,38,2
TUR,ESP,2014.0,8,6,2
PRT,NLD,2019.0,25,24,1
FRA,BFA,2021.0,8,4,4
CHN,NZL,2022.0,15,32,-17
EGY,DEU,2019.0,34,40,-6
NLD,ECU,2012.0,1,2,-1
FIN,CHE,2007.0,10,5,5
PRT,CHN,2016.0,13,3,10
CHE,DNK,2007.0,20,9,11
CUB,CAN,2008.0,5,2,3
MEX,CHL,2020.0,20,6,14
DNK,TUR,2015.0,2,5,-3
MNG,CHN,2022.0,2,1,1
BWA,ZAF,2004.0,5,6,-1
SWE,NLD,2007.0,30,22,8
CHL,ESP,2005.0,18,28,-10
AUS,NOR,2015.0,14,11,3
CHL,CUB,2013.0,1,6,-5
DNK,USA,2000.0,36,21,15
JOR,USA,2003.0,8,18,-10
SGP,KOR,2015.0,31,22,9
FRA,BGR,2018.0,7,3,4
FRA,HRV,2018.0,6,5,1
DEU,POL,2000.0,27,21,6
BEL,BGR,1997.0,1,1,0
CHL,ESP,2002.0,19,21,-2
CAN,TUN,2009.0,4,4,0
SAU,CAN,2010.0,31,70,-39
BEL,BGR,1998.0,3,1,2
FRA,PHL,2017.0,3,4,-1
EST,USA,2013.0,6,6,0
KHM,FRA,2011.0,2,3,-1
JPN,HKG,2015.0,4,11,-7
MYS,NLD,2011.0,4,11,-7
MYS,RUS,2021.0,3,4,-1
KWT,CAN,2020.0,4,11,-7
ARE,AUS,2016.0,7,21,-14
SVK,GBR,2006.0,3,7,-4
ITA,RUS,2010.0,11,19,-8
IRL,AUS,2000.0,5,3,2
BDI,FRA,2019.0,1,2,-1
GRC,CHE,2002.0,7,13,-6
FRA,UKR,2000.0,3,9,-6
CHN,BEL,2005.0,17,15,2
SWE,NZL,2005.0,9,3,6
ESP,DOM,2018.0,3,3,0
HUN,RUS,2011.0,2,3,-1
MWI,USA,2007.0,1,4,-3
RUS,ESP,2014.0,10,5,5
NLD,HUN,2013.0,9,10,-1
IRL,DNK,2007.0,3,5,-2
ARE,ITA,2011.0,1,2,-1
BEL,NZL,2022.0,3,1,2
HKG,TWN,2003.0,7,4,3
VEN,ITA,1999.0,2,1,1
HKG,FIN,2019.0,5,2,3
CHE,VNM,2011.0,2,1,1
CAN,ECU,2022.0,2,2,0
EGY,CHE,2011.0,2,2,0
BEL,ROU,2013.0,6,7,-1
CHN,MYS,2014.0,3,6,-3
POL,GRC,2021.0,1,2,-1
USA,BGR,2015.0,6,14,-8
HTI,USA,2015.0,5,9,-4
SGP,TWN,2009.0,4,10,-6
USA,ARM,2001.0,1,3,-2
MDG,USA,2007.0,2,2,0
BEL,IRL,2021.0,9,10,-1
KWT,EGY,2010.0,5,6,-1
TZA,AUS,2013.0,1,2,-1
JPN,PAK,2012.0,10,4,6
AUS,PHL,2022.0,2,5,-3
TUR,CHN,2012.0,3,2,1
COL,ESP,2000.0,3,5,-2
IND,CUB,2018.0,1,1,0
TWN,NZL,2011.0,1,4,-3
POL,FIN,2015.0,4,7,-3
CAN,PAK,2005.0,3,9,-6
DEU,URY,2017.0,5,5,0
MYS,PAK,2005.0,2,1,1
TWN,IDN,2012.0,5,2,3
POL,IND,2019.0,4,23,-19
CZE,ITA,2008.0,3,9,-6
DEU,VEN,2012.0,2,2,0
ISR,SWE,2015.0,3,3,0
URY,DEU,2015.0,2,1,1
BEL,ZMB,2011.0,1,1,0
URY,CHL,2016.0,2,3,-1
ARE,SWE,2012.0,2,1,1
IRL,LUX,2013.0,2,1,1
USA,ETH,2001.0,1,2,-1
SRB,BGR,2020.0,1,1,0
CAN,TZA,2020.0,2,1,1
IRN,LBN,2019.0,1,1,0
ITA,MYS,2015.0,1,6,-5
MEX,FIN,2015.0,1,1,0
NZL,SWE,2022.0,5,1,4
ECU,ARG,2016.0,2,4,-2
POL,BGR,2011.0,1,5,-4
DEU,MDA,2016.0,1,1,0
FIN,IRL,2007.0,1,4,-3
LTU,NLD,2015.0,2,1,1
HND,ESP,2010.0,1,1,0
CMR,USA,1999.0,1,1,0
CYP,JPN,2003.0,1,1,0
LBY,CAN,2015.0,1,2,-1
LVA,SWE,2020.0,1,2,-1
NGA,ARE,2020.0,2,2,0
CHN,,2014.0,48583,0,48583
,CHN,2000.0,30000,0,30000
,UKR,2004.0,1067,0,1067
FRA,,2012.0,7561,0,7561
,UZB,2003.0,107,0,107
NOR,,2022.0,4264,0,4264
AUS,,2015.0,5206,0,5206
NLD,,2021.0,8600,0,8600
IND,,2014.0,10769,0,10769
,GBR,2005.0,18768,0,18768
,GBR,2002.0,18894,0,18894
,JOR,2004.0,276,0,276
GRC,,2010.0,1260,0,1260
,SVN,2001.0,560,0,560
,CUB,2004.0,771,0,771
ISR,,2009.0,1227,0,1227
,ROU,1998.0,1165,0,1165
CAN,,2000.0,248,0,248
,AUS,2001.0,6962,0,6962
SWE,,2014.0,2276,0,2276
,GRC,2003.0,2754,0,2754
GRC,,2019.0,2083,0,2083
,UKR,1996.0,1324,0,1324
,EST,2001.0,270,0,270
,SGP,2001.0,1234,0,1234
,BEL,1995.0,1772,0,1772
,FJI,2004.0,23,0,23
,ZWE,2004.0,93,0,93
DZA,,2021.0,1872,0,1872
HKG,,2020.0,1634,0,1634
,CUB,1996.0,390,0,390
SEN,,2015.0,75,0,75
KOR,,2000.0,172,0,172
IRL,,2009.0,512,0,512
,MAR,2001.0,535,0,535
,COL,2010.0,1754,0,1754
FIN,,2013.0,1283,0,1283
,HRV,2007.0,1173,0,1173
URY,,2024.0,1440,0,1440
,NZL,2012.0,1470,0,1470
GRC,,2017.0,1778,0,1778
MDG,,2019.0,64,0,64
,SWE,1994.0,3320,0,3320
LUX,,2023.0,668,0,668
MUS,,2017.0,14,0,14
JPN,PRT,2013.0,6,0,6
MNG,,2013.0,16,0,16
GEO,,2024.0,651,0,651
CHN,SAU,2011.0,23,0,23
,PAK,2007.0,2188,0,2188
KAZ,,2015.0,61,0,61
,VNM,2013.0,908,0,908
MDG,,2010.0,22,0,22
UKR,IND,2004.0,1,0,1
TZA,CHE,2010.0,4,0,4
,KOR,2013.0,16621,0,16621
SVN,SWE,2008.0,1,0,1
NGA,,2008.0,203,0,203
TUR,,2000.0,45,0,45
,KAZ,1995.0,74,0,74
,PHL,2013.0,555,0,555
AUT,,2003.0,387,0,387
PRT,,2011.0,574,0,574
,ROU,1997.0,458,0,458
,COL,2019.0,1085,0,1085
MUS,,2019.0,25,0,25
NPL,,2021.0,341,0,341
,DZA,2009.0,1028,0,1028
POL,PRY,2015.0,1,0,1
,COL,2017.0,2311,0,2311
USA,SUR,2018.0,2,0,2
IDN,,2016.0,214,0,214
PRI,AUS,2014.0,1,0,1
BRN,,2021.0,53,0,53
SYR,,2017.0,92,0,92
NOR,TZA,2021.0,4,0,4
,LUX,2018.0,139,0,139
,ZWE,1996.0,30,0,30
HTI,,2017.0,13,0,13
SYR,,2019.0,53,0,53
MCO,,2024.0,88,0,88
,SEN,2006.0,94,0,94
BEN,COD,2019.0,1,0,1
,BHR,1998.0,34,0,34
IRN,HKG,2016.0,5,0,5
BOL,BEL,2020.0,1,0,1
,OMN,2016.0,132,0,132
,ALB,2015.0,42,0,42
,SLE,2006.0,6,0,6
IRN,,2006.0,172,0,172
SWE,HND,2013.0,2,0,2
MAC,,2012.0,17,0,17
IRL,EGY,2011.0,2,0,2
NLD,VNM,2015.0,7,0,7
,BHR,1997.0,6,0,6
NLD,SXM,2018.0,1,0,1
HRV,SWE,2006.0,1,0,1
ETH,,2013.0,77,0,77
MDG,,2017.0,32,0,32
,FJI,1996.0,8,0,8
UZB,,2004.0,48,0,48
CHE,UKR,1997.0,1,0,1
VNM,,2015.0,218,0,218
,MDV,2011.0,2,0,2
,NAM,2003.0,14,0,14
QAT,IDN,2016.0,1,0,1
HUN,ESP,2004.0,3,0,3
,MDA,2002.0,45,0,45
,GAB,1997.0,11,0,11
CAN,UZB,2018.0,1,0,1
,YEM,2013.0,32,0,32
DEU,,2025.0,45,0,45
,SLB,2015.0,6,0,6
POL,BRA,2015.0,13,0,13
SAU,QAT,2012.0,4,0,4
JOR,OMN,2019.0,4,0,4
IND,GRC,2019.0,4,0,4
AUS,QAT,2013.0,7,0,7
,BWA,1999.0,54,0,54
SYR,,2010.0,17,0,17
ZAF,ARG,2017.0,4,0,4
EGY,,2001.0,25,0,25
TZA,FIN,2010.0,1,0,1
RWA,,2016.0,24,0,24
,PNG,1994.0,18,0,18
NGA,CHE,2015.0,5,0,5
MUS,,2010.0,7,0,7
PHL,DNK,2014.0,1,0,1
,MDA,2005.0,31,0,31
LBN,QAT,2022.0,4,0,4
ROU,,2001.0,40,0,40
TUR,MKD,2014.0,1,0,1
IRN,AZE,2007.0,2,0,2
PHL,,2005.0,46,0,46
BFA,DNK,2004.0,1,0,1
,FRO,2001.0,6,0,6
,JOR,1996.0,80,0,80
MYS,,1999.0,9,0,9
,MTQ,1999.0,12,0,12
LBY,DZA,2007.0,1,0,1
,GAB,1998.0,31,0,31
BRA,BLR,2018.0,1,0,1
CHN,GUM,2012.0,1,0,1
,GRL,2004.0,4,0,4
GTM,ESP,2000.0,1,0,1
BRA,LKA,2018.0,1,0,1
AUT,NOR,2004.0,6,0,6
MWI,,2002.0,2,0,2
KOR,UKR,2001.0,3,0,3
HUN,EGY,2014.0,2,0,2
QAT,,2003.0,2,0,2
NER,MLI,2007.0,1,0,1
BHR,ARE,1999.0,1,0,1
JPN,KAZ,2014.0,3,0,3
MCO,BEL,2000.0,1,0,1
MWI,,2005.0,4,0,4
BEL,QAT,2005.0,1,0,1
CHL,PRY,2004.0,1,0,1
CUB,CHL,2009.0,3,0,3
KNA,,2023.0,16,0,16
,RWA,1995.0,2,0,2
YEM,,2009.0,8,0,8
GHA,NGA,2006.0,3,0,3
CHN,NER,2012.0,2,0,2
FRA,MKD,2007.0,1,0,1
CHE,ARE,2017.0,1,0,1
,LIE,2007.0,7,0,7
GRC,CHL,2009.0,1,0,1
KEN,MYS,2010.0,1,0,1
GAB,,2003.0,4,0,4
NAM,,2011.0,4,0,4
PRT,ECU,2012.0,1,0,1
LTU,BEL,2016.0,3,0,3
SVN,JPN,2011.0,1,0,1
CHL,GTM,2016.0,2,0,2
,AND,2009.0,2,0,2
,BOL,2008.0,45,0,45
IND,ECU,2017.0,2,0,2
ZAF,MOZ,2012.0,4,0,4
GHA,CHN,2013.0,3,0,3
THA,POL,2019.0,3,0,3
BEL,SAU,2020.0,6,0,6
SGP,LUX,2021.0,1,0,1
PAK,UGA,2015.0,2,0,2
ISL,LUX,2015.0,4,0,4
SGP,CHL,2011.0,2,0,2
JOR,KOR,2019.0,1,0,1
GNQ,,2024.0,11,0,11
,CAF,2004.0,10,0,10
CHE,EGY,1999.0,2,0,2
JPN,EST,2003.0,1,0,1
ESP,HRV,1999.0,1,0,1
PHL,KHM,2009.0,1,0,1
ARE,FIN,2015.0,1,0,1
GTM,URY,2017.0,1,0,1
GUM,POL,2013.0,1,0,1
PHL,MYS,2002.0,3,0,3
NCL,,2016.0,11,0,11
CMR,CAN,2013.0,3,0,3
IRN,CHN,1999.0,1,0,1
SYC,,2013.0,3,0,3
GUY,,2012.0,2,0,2
KOR,BRN,2014.0,2,0,2
,LSO,2015.0,8,0,8
GTM,ITA,2019.0,2,0,2
CHE,BGD,2001.0,1,0,1
RUS,MNE,2000.0,1,0,1
LUX,ARE,2020.0,1,0,1
UGA,DEU,2011.0,3,0,3
GHA,IRN,2021.0,2,0,2
PAK,BHR,2017.0,1,0,1
NOR,BGD,2009.0,1,0,1
COL,PAN,2021.0,1,0,1
SVK,POL,2000.0,6,0,6
HUN,CHN,2004.0,1,0,1
NGA,IRL,2008.0,2,0,2
BLR,PHL,2015.0,1,0,1
PRI,SYR,2009.0,1,0,1
SWE,ZWE,1999.0,1,0,1
KEN,IRL,2003.0,1,0,1
,MRT,1999.0,10,0,10
MLI,,2000.0,1,0,1
ITA,LBN,2002.0,1,0,1
HTI,,2019.0,17,0,17
,KGZ,1994.0,5,0,5
NGA,CIV,2005.0,1,0,1
ALB,GRC,2006.0,1,0,1
ZAF,LKA,2018.0,5,0,5
LTU,BLR,2014.0,1,0,1
TTO,ZAF,2016.0,1,0,1
NGA,UGA,2009.0,4,0,4
LSO,NOR,2009.0,1,0,1
BWA,MWI,2018.0,1,0,1
PAK,UKR,2010.0,1,0,1
,NIC,2006.0,14,0,14
JAM,BWA,2018.0,1,0,1
OMN,POL,2013.0,1,0,1
JOR,OMN,2017.0,2,0,2
PAN,BRA,2010.0,1,0,1
MYS,ARE,2009.0,3,0,3
,SUR,2007.0,1,0,1
IND,LAO,2015.0,1,0,1
BEL,MYS,2022.0,1,0,1
RWA,CHE,2010.0,1,0,1
BDI,FRA,2017.0,1,0,1
POL,IDN,2014.0,2,0,2
CUB,PRT,2005.0,1,0,1
MYS,PSE,2021.0,3,0,3
DEU,CMR,2022.0,2,0,2
BRA,IDN,2021.0,1,0,1
BTN,BGD,2018.0,1,0,1
HRV,CZE,2022.0,1,0,1
NCL,MLT,2020.0,1,0,1
RWA,GBR,2022.0,1,0,1
SVK,NLD,2022.0,2,0,2
BEL,GUF,2002.0,1,0,1
,HTI,2000.0,2,0,2
ITA,GIN,2005.0,1,0,1
,SLV,2007.0,6,0,6
GRC,GHA,2016.0,1,0,1
TUR,FJI,2010.0,1,0,1
CUB,SWE,2015.0,2,0,2
IRN,LUX,2018.0,3,0,3
MNP,USA,2020.0,2,0,2
PAK,AUT,2007.0,5,0,5
NZL,FIN,2008.0,3,0,3
MAC,KAZ,2016.0,1,0,1
MAR,CHE,2020.0,1,0,1
LBN,SWE,2022.0,1,0,1
NLD,TUN,2015.0,1,0,1
PHL,,2002.0,6,0,6
MKD,DEU,2021.0,2,0,2
USA,LBR,2014.0,3,0,3
NGA,JAM,2020.0,1,0,1
BIH,SWE,2021.0,2,0,2
SYR,IRN,2021.0,1,0,1
ZWE,BWA,2008.0,3,0,3
ZAF,EGY,2007.0,1,0,1
,SYC,2017.0,3,0,3
JPN,SRB,2008.0,2,0,2
CMR,POL,2019.0,1,0,1
ZAF,SGP,2022.0,1,0,1
GHA,POL,2015.0,1,0,1
HRV,NOR,2000.0,1,0,1
KEN,GHA,2005.0,1,0,1
GBR,MNE,2014.0,1,0,1
CAN,LTU,2010.0,1,0,1
DEU,GHA,2004.0,3,0,3
ITA,HKG,2009.0,2,0,2
GBR,AZE,2013.0,1,0,1
NLD,CYP,2007.0,3,0,3
HRV,DNK,2000.0,1,0,1
CZE,TUR,2011.0,2,0,2
YEM,ISR,2017.0,1,0,1
IND,EGY,2002.0,3,0,3
WSM,,2015.0,1,0,1
DEU,OMN,2005.0,2,0,2
LSO,,2013.0,4,0,4
TUN,POL,2010.0,1,0,1
CAN,MCO,2013.0,1,0,1
,GNB,2007.0,2,0,2
FJI,POL,2010.0,1,0,1
SYR,MYS,2013.0,1,0,1
GEO,DEU,2010.0,5,0,5
BEL,ETH,2016.0,5,0,5
KHM,MMR,2016.0,1,0,1
ETH,ARE,2019.0,1,0,1
CAN,RWA,2017.0,1,0,1
KOR,JOR,2017.0,1,0,1
BLR,SWE,2019.0,1,0,1
NLD,TZA,1998.0,1,0,1
MDA,DNK,2020.0,1,0,1
GBR,GNQ,2017.0,1,0,1
COD,MWI,2021.0,1,0,1
NLD,ARG,1999.0,1,0,1
FRA,NGA,1999.0,1,0,1
KWT,BHR,2010.0,1,0,1
ETH,NLD,2006.0,3,0,3
POL,EST,2018.0,1,0,1
FIN,BGR,2009.0,1,0,1
BMU,USA,2001.0,2,0,2
YEM,IRQ,2009.0,2,0,2
GBR,SWZ,2012.0,3,0,3
PYF,NCL,2013.0,1,0,1
COM,,2024.0,8,0,8
BEN,NGA,2017.0,4,0,4
BLZ,,2015.0,2,0,2
NLD,IRQ,2018.0,4,0,4
COL,JPN,2003.0,1,0,1
NLD,GTM,2004.0,1,0,1
DEU,LBR,2016.0,1,0,1
USA,LIE,2011.0,2,0,2
KGZ,RUS,2002.0,1,0,1
USA,LSO,2010.0,1,0,1
SVK,CHE,1999.0,2,0,2
CUB,TZA,2018.0,1,0,1
FJI,CHE,2007.0,2,0,2
IRL,MEX,2012.0,1,0,1
,LAO,1998.0,6,0,6
CIV,GBR,2017.0,1,0,1
GNB,DNK,1999.0,1,0,1
BLR,SWE,2017.0,3,0,3
PRI,RUS,2002.0,2,0,2
DNK,QAT,2018.0,1,0,1
ITA,SDN,2014.0,1,0,1
CYP,SWE,2020.0,1,0,1
BFA,GBR,2022.0,1,0,1
CUB,URY,2007.0,1,0,1
ISL,ARE,2019.0,1,0,1
LTU,IRL,2011.0,1,0,1
HND,,2011.0,5,0,5
GBR,PSE,2009.0,2,0,2
ECU,PER,2012.0,2,0,2
AIA,,2022.0,1,0,1
POL,SGP,2008.0,3,0,3
NGA,COG,2016.0,1,0,1
DEU,CIV,2021.0,1,0,1
PRT,ARE,2018.0,5,0,5
KWT,BHR,2017.0,1,0,1
EGY,AUS,2004.0,1,0,1
CHE,VEN,2008.0,1,0,1
AUS,LBY,2014.0,2,0,2
DEU,MDG,2003.0,1,0,1
PER,VNM,2019.0,1,0,1
NIC,CRI,2012.0,1,0,1
CHL,ISL,2020.0,2,0,2
CHN,LBY,2006.0,1,0,1
IND,GRC,2017.0,2,0,2
ISR,MKD,2020.0,1,0,1
CAN,LTU,2019.0,2,0,2
JOR,ISR,2016.0,1,0,1
SLB,NLD,2021.0,1,0,1
IDN,NZL,2010.0,1,0,1
VUT,AUS,2008.0,1,0,1
KOR,BGR,2007.0,1,0,1
ARE,CYP,2002.0,1,0,1
KAZ,NLD,2021.0,2,0,2
IND,PRT,2004.0,7,0,7
TWN,ZAF,2019.0,4,0,4
ESP,BOL,2006.0,4,0,4
ITA,IDN,2018.0,1,0,1
MAR,LBN,2014.0,1,0,1
TWN,QAT,2017.0,1,0,1
FIN,KEN,2011.0,2,0,2
RWA,AUS,2016.0,1,0,1
EGY,ITA,2008.0,2,0,2
POL,IRL,2005.0,6,0,6
HRV,IDN,2003.0,1,0,1
HUN,ECU,2019.0,1,0,1
ARG,GBR,1997.0,2,0,2
FRA,ARE,2005.0,2,0,2
JPN,SVK,2004.0,2,0,2
DZA,DEU,1999.0,1,0,1
TUR,KAZ,2003.0,1,0,1
PSE,ARE,1999.0,1,0,1
BRA,CYP,2011.0,1,0,1
LTU,CAN,2003.0,1,0,1
NLD,JOR,2013.0,2,0,2
MDG,MLI,2004.0,2,0,2
MAR,JPN,2008.0,1,0,1
JPN,PHL,1997.0,1,0,1
DEU,OMN,2002.0,2,0,2
IRL,LBY,2002.0,1,0,1
QAT,HRV,2022.0,1,0,1
CHN,MEX,1999.0,4,0,4
CHN,PRT,1997.0,1,0,1
CHN,UGA,2009.0,1,0,1
IRL,QAT,2016.0,1,0,1
BGD,ETH,2014.0,1,0,1
CZE,COL,2013.0,1,0,1
AUS,ARE,2004.0,5,0,5
MAR,AUS,2011.0,1,0,1
LKA,IND,2007.0,2,0,2
IRN,LBN,2017.0,1,0,1
VNM,BGD,2021.0,3,0,3
PRY,GBR,1999.0,1,0,1
IND,AGO,2013.0,1,0,1
CIV,BFA,2008.0,2,0,2
GRC,EGY,2007.0,1,0,1
COL,ISR,2008.0,1,0,1
GBR,UZB,2018.0,2,0,2
CHN,IDN,2002.0,1,0,1
AUS,AFG,2019.0,1,0,1
COL,VNM,1998.0,1,0,1
SVK,CYP,2021.0,1,0,1
AZE,FIN,2015.0,1,0,1
CHE,LIE,2011.0,2,0,2
TWN,MEX,2000.0,1,0,1
GMB,COG,2015.0,1,0,1
ALB,CHE,2017.0,1,0,1
ZAF,CHN,1998.0,1,0,1
FRA,BRB,2013.0,1,0,1
RUS,AGO,2009.0,1,0,1
CMR,BEN,2016.0,1,0,1
ARM,PRT,2012.0,1,0,1
HRV,QAT,2014.0,1,0,1
PAN,BRA,2017.0,1,0,1
CAN,GEO,2015.0,2,0,2
TZA,JPN,2017.0,3,0,3
FRA,CYP,2013.0,2,0,2
PAN,GBR,2014.0,1,0,1
PAN,NLD,2011.0,1,0,1
ROU,EGY,2019.0,1,0,1
GUF,MTQ,2016.0,2,0,2
BLR,SVK,2004.0,1,0,1
MEX,ZAF,2006.0,2,0,2
POL,SAU,2011.0,1,0,1
SWE,TUN,2006.0,1,0,1
TTO,CAN,2007.0,1,0,1
AUS,ZMB,2014.0,1,0,1
MAR,TGO,2021.0,1,0,1
ISL,LVA,2014.0,1,0,1
GHA,GAB,2018.0,1,0,1
MDA,UKR,2006.0,1,0,1
ALB,COL,2015.0,1,0,1
CAN,LTU,2017.0,1,0,1
BTN,GBR,2014.0,1,0,1
GBR,BTN,2016.0,1,0,1
SAU,IDN,2013.0,1,0,1
PRI,NZL,2020.0,1,0,1
KOR,EST,2021.0,2,0,2
PSE,IRQ,2020.0,1,0,1
SGP,ROU,2009.0,1,0,1
IDN,ZAF,2002.0,1,0,1
LIE,FRA,2015.0,1,0,1
EST,MAC,2015.0,1,0,1
TUR,ALB,2010.0,3,0,3
CZE,PRT,2001.0,1,0,1
KEN,EGY,2019.0,2,0,2
RWA,UGA,2021.0,2,0,2
SWE,LUX,2017.0,1,0,1
CHN,SVN,2006.0,1,0,1
BRA,HUN,2022.0,3,0,3
TUR,ISL,2022.0,1,0,1
MEX,NIC,2002.0,2,0,2
HUN,ECU,2017.0,1,0,1
PRI,CUB,2004.0,1,0,1
AUT,VNM,2006.0,1,0,1
GEO,CHE,2005.0,1,0,1
JPN,MAR,2014.0,1,0,1
CIV,BEN,2006.0,2,0,2
PER,DNK,2008.0,1,0,1
KWT,HUN,1999.0,1,0,1
QAT,CAN,2004.0,1,0,1
ARG,CHL,1997.0,2,0,2
GRL,POL,2010.0,1,0,1
IRN,EST,2011.0,1,0,1
MOZ,FRA,2011.0,1,0,1
IND,PER,2009.0,1,0,1
BOL,GTM,2013.0,1,0,1
TUR,CZE,2007.0,1,0,1
CHE,SAU,2011.0,1,0,1
PYF,NZL,2012.0,1,0,1
DEU,LBY,2020.0,2,0,2
BEL,GEO,2015.0,1,0,1
AUS,UZB,2017.0,1,0,1
,VUT,2009.0,1,0,1
GRC,NGA,2016.0,1,0,1
MAC,NLD,2015.0,1,0,1
KAZ,HKG,2018.0,1,0,1
VEN,AUS,2001.0,1,0,1
ITA,MDV,2017.0,1,0,1
AUS,MKD,2020.0,1,0,1
BRA,PAN,2011.0,1,0,1
BMU,AUS,2007.0,1,0,1
JOR,BHR,2007.0,1,0,1
HRV,ISR,2014.0,1,0,1
RWA,RUS,2022.0,1,0,1
GMB,NLD,2009.0,1,0,1
GBR,SLE,2009.0,2,0,2
IND,YEM,2015.0,3,0,3
COG,GHA,2016.0,1,0,1
NLD,KAZ,2019.0,2,0,2
PSE,EGY,2016.0,2,0,2
JPN,GHA,2004.0,2,0,2
SRB,ZAF,2001.0,1,0,1
ISR,ERI,2002.0,1,0,1
SWZ,RWA,2016.0,1,0,1
ZWE,BFA,2013.0,1,0,1
THA,SEN,2014.0,1,0,1
CHL,PRI,2017.0,1,0,1
FIN,MNG,2018.0,1,0,1
LUX,IRL,2009.0,1,0,1
CMR,AUS,2003.0,1,0,1
SVN,UKR,1997.0,2,0,2
SWE,BTN,2008.0,1,0,1
CUB,AUS,2012.0,1,0,1
GBR,MSR,2007.0,1,0,1
TUR,ALB,2017.0,1,0,1
MNG,FRA,2019.0,1,0,1
KOR,TUN,2018.0,1,0,1
MDA,FIN,2020.0,1,0,1
SVN,MNE,2018.0,1,0,1
MEX,THA,2021.0,1,0,1
CHN,CAF,2012.0,1,0,1
SDN,BHR,2011.0,1,0,1
ESP,ISL,2003.0,1,0,1
,SYC,2019.0,1,0,1
BWA,CAN,2021.0,1,0,1
CYP,ARE,2017.0,1,0,1
UKR,KAZ,2008.0,1,0,1
LBY,BGR,2013.0,1,0,1
CMR,GUF,2008.0,1,0,1
FRA,ARE,2002.0,2,0,2
IND,UKR,2018.0,1,0,1
ITA,LBN,2005.0,1,0,1
KWT,DEU,2009.0,1,0,1
AUT,PSE,2012.0,1,0,1
BMU,,2009.0,1,0,1
BEL,LVA,2022.0,1,0,1
TTO,KOR,2013.0,1,0,1
BGD,TWN,2009.0,2,0,2
UKR,ESP,2022.0,1,0,1
GLP,FIN,2013.0,1,0,1
SEN,CMR,2002.0,2,0,2
ISL,GRC,2019.0,1,0,1
BRA,ISR,2001.0,3,0,3
SYR,TUN,2009.0,1,0,1
JPN,MOZ,2011.0,1,0,1
PHL,ISR,2022.0,1,0,1
MYS,FJI,2012.0,1,0,1
TZA,AUT,2009.0,1,0,1
LVA,CAN,2010.0,1,0,1
CHN,BDI,2018.0,1,0,1
BWA,GHA,2016.0,1,0,1
TWN,SVK,2018.0,1,0,1
EGY,SVN,2014.0,1,0,1
THA,MNG,2016.0,1,0,1
USA,LSO,2017.0,1,0,1
GBR,ARM,2002.0,1,0,1
NGA,SWZ,2004.0,1,0,1
OMN,DZA,2012.0,2,0,2
LVA,CHE,2007.0,1,0,1
MCO,AUS,2014.0,2,0,2
FRA,TCD,2013.0,1,0,1
MWI,JPN,2009.0,1,0,1
BGR,NOR,2012.0,1,0,1
SDN,AUT,2015.0,1,0,1
FIN,CRI,2003.0,1,0,1
DJI,,2012.0,3,0,3
AUT,DZA,2015.0,1,0,1
TZA,NAM,2012.0,1,0,1
IND,AFG,2013.0,1,0,1
GTM,,2004.0,1,0,1
THA,BEL,2004.0,1,0,1
PNG,USA,2018.0,1,0,1
PSE,NOR,2003.0,1,0,1
FRA,JAM,2010.0,1,0,1
ETH,IRQ,2019.0,2,0,2
TON,,2012.0,1,0,1
AUS,KWT,1999.0,1,0,1
SRB,AUT,2000.0,1,0,1
CIV,SWE,2010.0,1,0,1
GUF,GLP,2006.0,1,0,1
TUR,EST,2021.0,1,0,1
LTU,DNK,2011.0,1,0,1
,BDI,2009.0,4,0,4
MAR,PAK,2015.0,1,0,1
PER,VNM,2010.0,1,0,1
COD,CMR,2022.0,1,0,1
CMR,MYS,2012.0,1,0,1
GRC,THA,2015.0,1,0,1
NLD,BHR,2019.0,1,0,1
COD,DEU,2019.0,1,0,1
LTU,NOR,2009.0,2,0,2
NPL,ETH,2002.0,1,0,1
,GRL,1996.0,1,0,1
HRV,URY,2020.0,1,0,1
DNK,GHA,2014.0,1,0,1
FRA,PAN,2014.0,1,0,1
KEN,GMB,2017.0,1,0,1
KOR,HUN,2014.0,2,0,2
GRC,IRN,2018.0,1,0,1
SAU,LBY,2009.0,1,0,1
MEX,AUT,2009.0,1,0,1
MDA,NOR,2018.0,1,0,1
COL,NZL,2014.0,1,0,1
ETH,IRQ,2017.0,1,0,1
PAK,BHR,2010.0,1,0,1
PRT,JOR,2017.0,1,0,1
BGD,CHE,2015.0,1,0,1
BOL,GBR,2021.0,1,0,1
SYC,FRA,2019.0,1,0,1
AUT,LVA,2014.0,1,0,1
ROU,LUX,2015.0,1,0,1
JPN,PRI,2007.0,1,0,1
IND,UGA,2008.0,1,0,1
KWT,AUT,2019.0,1,0,1
BFA,UGA,2019.0,1,0,1
FRA,VUT,2005.0,1,0,1
MOZ,ESP,2008.0,1,0,1
IRN,KWT,2007.0,1,0,1
GRC,NLD,1999.0,1,0,1
GRC,VEN,2014.0,1,0,1
ITA,PSE,2005.0,1,0,1
PAK,SWE,2002.0,1,0,1
JPN,KEN,1997.0,1,0,1
ISR,CHL,2012.0,1,0,1
USA,MDA,2008.0,1,0,1
GEO,BEL,2007.0,2,0,2
DEU,FJI,2015.0,1,0,1
USA,MKD,2009.0,1,0,1
SYC,GBR,2013.0,1,0,1
MRT,DEU,2001.0,1,0,1
ETH,MEX,2018.0,1,0,1
ARG,CZE,2013.0,1,0,1
IRL,ESP,1999.0,1,0,1
JPN,DOM,2018.0,1,0,1
MYS,ARM,2012.0,1,0,1
ISR,BGD,2006.0,1,0,1
EST,NOR,2022.0,1,0,1
LVA,FIN,2002.0,1,0,1
TUR,SRB,2004.0,1,0,1
BRA,CRI,2007.0,1,0,1
ITA,NAM,2017.0,1,0,1
TUR,GEO,2011.0,1,0,1
JOR,UKR,2018.0,1,0,1
ZWE,ZMB,2012.0,1,0,1
NER,CHE,2009.0,1,0,1
TCD,ITA,2009.0,1,0,1
BEN,CAN,2002.0,1,0,1
NLD,SUR,1999.0,1,0,1
ZAF,POL,1998.0,1,0,1
TWN,AZE,2002.0,1,0,1
SRB,NGA,2007.0,1,0,1
LKA,PHL,2012.0,1,0,1
ARG,KOR,2001.0,1,0,1
SLV,ARG,2009.0,1,0,1
ZWE,KOR,2012.0,1,0,1
BFA,SDN,2003.0,1,0,1
MLI,NOR,2013.0,1,0,1
FJI,VUT,2021.0,1,0,1
ERI,SWE,2001.0,1,0,1
DEU,MAC,2021.0,1,0,1
IND,TUN,2001.0,1,0,1
GBR,PRI,2004.0,1,0,1
AFG,NLD,2009.0,1,0,1
IRL,SVK,2010.0,1,0,1
ISR,KEN,2015.0,1,0,1
AUS,MMR,2002.0,1,0,1
BRN,USA,2015.0,1,0,1
YEM,KWT,2010.0,1,0,1
NER,KEN,2011.0,1,0,1
ESP,AZE,2019.0,1,0,1
MAC,MYS,2022.0,1,0,1
IRQ,UZB,2021.0,1,0,1
COL,ARE,2022.0,1,0,1
TUR,BHR,2002.0,1,0,1
CAN,BGR,1999.0,1,0,1
PAK,ROU,2020.0,1,0,1
HND,SLV,2012.0,1,0,1
ESP,ITA,2006.0,93,87,6
FRA,USA,2010.0,736,649,87
USA,CHN,2013.0,2063,2107,-44
USA,IND,2011.0,618,872,-254
FRA,SVN,2010.0,4,5,-1
CHE,DEU,2005.0,259,408,-149
DEU,USA,2007.0,1131,907,224
FRA,CHE,2006.0,235,157,78
GBR,MEX,2010.0,41,35,6
SWE,DEU,2012.0,73,134,-61
IRN,CAN,2008.0,76,47,29
KHM,SGP,2012.0,1,1,0
SGP,IND,2006.0,15,27,-12
CHE,ITA,2005.0,77,74,3
IND,USA,2005.0,601,304,297
IND,DEU,2006.0,103,58,45
USA,MEX,2011.0,153,187,-34
ESP,NLD,2009.0,55,60,-5
IND,USA,2002.0,489,245,244
GBR,GRC,2014.0,123,226,-103
GBR,CAN,2010.0,332,348,-16
USA,IRL,2007.0,97,90,7
UKR,DEU,2004.0,43,26,17
CAN,SAU,2013.0,85,35,50
GBR,FIN,2010.0,47,38,9
BRA,DEU,2007.0,64,45,19
ZAF,USA,2007.0,56,47,9
USA,HKG,2010.0,127,138,-11
ESP,BRA,2015.0,130,69,61
ESP,KOR,2008.0,2,1,1
BEL,FRA,2010.0,155,174,-19
ESP,MEX,2011.0,102,96,6
TUR,USA,2015.0,236,285,-49
USA,GHA,2008.0,11,8,3
BRA,CHN,2006.0,1,2,-1
USA,ISR,2011.0,302,317,-15
GRC,USA,2014.0,140,70,70
IRL,GBR,2008.0,155,170,-15
NLD,CHE,2020.0,109,81,28
FRA,AUS,2007.0,58,45,13
AUS,NLD,2011.0,51,61,-10
NLD,BEL,2012.0,121,113,8
FRA,DEU,1999.0,102,111,-9
SWE,DNK,2001.0,30,36,-6
JPN,IDN,2014.0,142,23,119
DEU,AUT,2013.0,287,323,-36
USA,SGP,2012.0,268,185,83
IRL,BEL,2016.0,10,8,2
SGP,IDN,2019.0,8,3,5
HKG,CHN,2009.0,243,263,-20
YEM,SAU,2020.0,25,7,18
USA,ITA,2014.0,329,604,-275
FRA,USA,2019.0,839,611,228
JPN,VNM,2015.0,49,16,33
CHE,DEU,2002.0,253,338,-85
RUS,USA,2020.0,167,111,56
SWE,GBR,2018.0,164,194,-30
GRC,JPN,2011.0,1,5,-4
USA,ESP,2022.0,188,183,5
GBR,FIN,2019.0,67,62,5
BGD,PAK,2016.0,8,5,3
USA,SVK,2009.0,18,10,8
TUR,IND,2021.0,7,2,5
PRI,USA,2012.0,71,40,31
USA,PRI,2020.0,63,90,-27
UKR,CHE,2016.0,7,2,5
DEU,ESP,2007.0,120,86,34
ETH,USA,2019.0,31,26,5
ISR,NLD,2020.0,11,11,0
FRA,ITA,2012.0,171,323,-152
KOR,JPN,2009.0,105,135,-30
GBR,HKG,2015.0,61,42,19
CHN,KOR,2020.0,100,231,-131
MYS,IRQ,2014.0,36,9,27
DEU,AUS,2020.0,133,134,-1
USA,HKG,2017.0,153,124,29
USA,PAN,2004.0,3,8,-5
USA,MYS,2022.0,12,24,-12
CHE,FRA,2021.0,173,229,-56
KOR,CAN,2017.0,64,30,34
DZA,FRA,2021.0,35,32,3
UKR,RUS,2011.0,32,33,-1
SGP,CHN,2006.0,103,73,30
IDN,AUS,2018.0,26,77,-51
RUS,EGY,2014.0,4,2,2
PRT,JPN,2015.0,3,2,1
GBR,FIN,2017.0,55,64,-9
USA,HKG,2019.0,139,161,-22
FRA,PAK,2015.0,28,7,21
ARG,BRA,2020.0,19,38,-19
CAN,ECU,2016.0,3,3,0
DEU,CHN,2015.0,276,312,-36
RUS,ARM,2014.0,4,4,0
KOR,CAN,2019.0,45,46,-1
IND,ITA,2012.0,56,30,26
DEU,CAN,2018.0,169,143,26
FIN,CHN,2012.0,11,20,-9
FRA,CAN,2020.0,258,249,9
DEU,BEL,2020.0,106,90,16
ITA,BEL,2015.0,81,66,15
ETH,USA,2017.0,18,15,3
IRN,VNM,2020.0,18,1,17
ITA,FIN,2000.0,3,2,1
GBR,CZE,2015.0,40,36,4
GRC,DNK,2020.0,9,8,1
GBR,CAN,2017.0,339,376,-37
TWN,GBR,2018.0,24,28,-4
VNM,MYS,2022.0,4,2,2
GBR,TZA,2019.0,4,8,-4
ARG,USA,2014.0,86,71,15
ESP,ISR,2016.0,11,9,2
ZAF,IRN,2015.0,3,6,-3
BWA,ZAF,2014.0,10,4,6
SYR,USA,2014.0,7,3,4
PRT,USA,2021.0,29,33,-4
THA,AUT,2016.0,2,5,-3
ARG,ESP,2020.0,86,60,26
BEL,AUS,2021.0,14,25,-11
JPN,SGP,2016.0,49,26,23
SAU,CAN,2018.0,65,116,-51
NZL,CHN,2012.0,12,14,-2
PRT,NLD,2018.0,26,20,6
FIN,CAN,2015.0,16,11,5
GRC,SWE,2021.0,25,12,13
SWE,NOR,2010.0,64,35,29
GBR,KOR,2002.0,31,13,18
ITA,EGY,2013.0,10,5,5
KHM,JPN,2008.0,3,1,2
FIN,BRA,2022.0,4,6,-2
GBR,TUR,2021.0,43,56,-13
SGP,NLD,2019.0,19,19,0
SWE,NOR,2019.0,71,63,8
ITA,SVK,2017.0,6,2,4
FRA,IND,2014.0,70,83,-13
GBR,MEX,2019.0,44,59,-15
IND,TWN,2022.0,34,15,19
SAU,GBR,2000.0,3,6,-3
SWE,RUS,2016.0,20,9,11
ETH,NOR,2017.0,6,5,1
COL,AUS,2019.0,13,7,6
ISL,DNK,2017.0,4,5,-1
SAU,EGY,2006.0,38,47,-9
CAN,CHN,2004.0,76,100,-24
CIV,FRA,2019.0,7,19,-12
GBR,IND,2015.0,147,165,-18
GBR,MEX,2017.0,62,39,23
SWE,ISR,2020.0,6,7,-1
NLD,SWE,2022.0,23,23,0
BTN,JPN,2016.0,1,1,0
BRA,HUN,2016.0,2,2,0
RUS,TWN,2020.0,3,5,-2
SGP,NLD,2017.0,14,22,-8
BGD,USA,2022.0,81,23,58
TUR,MYS,2019.0,2,10,-8
HRV,ESP,2018.0,5,6,-1
AUT,CHE,2018.0,64,77,-13
COL,AUS,2017.0,10,8,2
LKA,JPN,2022.0,1,3,-2
SAU,PAK,2022.0,26,29,-3
AUS,EGY,2022.0,3,4,-1
POL,USA,2022.0,47,34,13
TUR,PSE,2019.0,4,2,2
ITA,SVK,2019.0,4,2,2
FRA,SWE,2015.0,82,45,37
PAK,SAU,2011.0,31,16,15
GBR,ITA,2003.0,220,189,31
COL,PER,2019.0,12,5,7
CUB,MEX,2021.0,6,4,2
TUR,ROU,2020.0,1,4,-3
ARE,AUS,2022.0,8,15,-7
USA,THA,2003.0,144,51,93
NZL,GBR,2004.0,74,105,-31
IRN,FRA,2009.0,6,19,-13
JPN,CHE,2016.0,34,36,-2
ETH,KEN,2022.0,1,2,-1
KOR,TWN,2006.0,5,4,1
BRA,CAN,2012.0,67,49,18
VEN,GBR,2006.0,9,5,4
NLD,IRL,2015.0,13,15,-2
GBR,NOR,2011.0,68,35,33
AUS,ARE,2014.0,20,8,12
SGP,IDN,2017.0,7,1,6
USA,URY,2017.0,14,16,-2
JPN,LKA,2018.0,11,6,5
LBN,QAT,2016.0,6,4,2
FRA,RUS,2015.0,48,49,-1
TWN,THA,2016.0,20,6,14
CHE,THA,2011.0,3,3,0
PRT,ARE,2019.0,4,1,3
OMN,SAU,2011.0,6,3,3
RUS,FRA,2009.0,42,29,13
CZE,POL,2016.0,13,17,-4
FRA,DZA,2008.0,41,27,14
ETH,IND,2014.0,6,26,-20
NPL,KOR,2016.0,3,6,-3
IRL,CHN,2011.0,9,15,-6
CHL,NZL,2015.0,4,6,-2
DEU,NZL,2009.0,40,36,4
MYS,KOR,2019.0,7,8,-1
KOR,CHE,2016.0,9,17,-8
CHE,HKG,2010.0,7,1,6
POL,IND,2018.0,9,13,-4
CHE,AUT,2000.0,6,11,-5
PRT,CHN,2022.0,7,6,1
IND,IRL,2021.0,28,14,14
MDA,ROU,2015.0,1,5,-4
ZAF,ZWE,2015.0,13,19,-6
BEL,GBR,2008.0,67,71,-4
NLD,DNK,2020.0,47,40,7
CHN,NZL,2016.0,27,23,4
JPN,ROU,2007.0,5,6,-1
COG,CHE,2021.0,6,2,4
HRV,SRB,2014.0,11,4,7
NLD,ITA,2005.0,43,40,3
BEL,ITA,2001.0,27,18,9
GBR,IRN,2018.0,36,64,-28
MDG,FRA,2002.0,7,9,-2
ZAF,KOR,2012.0,3,5,-2
ITA,IRN,2020.0,15,81,-66
IRN,MYS,2014.0,59,110,-51
CHL,BEL,2005.0,1,3,-2
EST,NOR,2016.0,1,1,0
DEU,FIN,2006.0,22,27,-5
CHL,BEL,2002.0,3,1,2
DEU,COL,2016.0,17,25,-8
NCL,FRA,2009.0,9,13,-4
DEU,UKR,2003.0,16,38,-22
HKG,SWE,2009.0,5,3,2
RUS,AUT,2009.0,16,6,10
DEU,KOR,2004.0,21,15,6
FRA,COL,2017.0,24,16,8
KWT,EGY,2018.0,8,4,4
ISL,GBR,2022.0,2,3,-1
CZE,NLD,2021.0,8,7,1
IRN,ESP,2015.0,15,5,10
CAN,POL,2014.0,18,50,-32
CHE,CZE,2015.0,14,13,1
IND,CHE,2021.0,23,26,-3
SVK,AUT,2016.0,12,5,7
FRA,HRV,2017.0,9,7,2
NGA,AUS,2015.0,4,2,2
PRT,ISR,2018.0,1,1,0
SAU,CHN,2014.0,12,22,-10
IND,DNK,2014.0,13,15,-2
DNK,NLD,2001.0,18,15,3
FRA,NOR,2015.0,26,17,9
BLR,DEU,1997.0,6,3,3
NLD,CZE,2019.0,15,6,9
HUN,USA,1998.0,21,18,3
GBR,BRA,2012.0,73,52,21
ISR,DEU,2011.0,35,31,4
FRA,GLP,2019.0,11,9,2
FRA,MEX,2012.0,37,22,15
DEU,PAK,2007.0,6,13,-7
ZAF,SGP,2016.0,1,5,-4
MEX,ITA,2003.0,14,11,3
PAK,CAN,2021.0,23,12,11
NLD,BRA,2008.0,11,12,-1
GBR,OMN,2021.0,12,4,8
IND,NGA,2015.0,4,3,1
NLD,CZE,2017.0,8,4,4
DNK,JPN,1999.0,3,2,1
CHN,CZE,2020.0,16,12,4
FRA,VEN,2000.0,1,2,-1
AUT,GBR,2016.0,69,74,-5
IND,ERI,2020.0,1,2,-1
CHN,RUS,2021.0,19,24,-5
AUT,FRA,2022.0,11,17,-6
UZB,JPN,2009.0,2,1,1
FRA,SEN,2005.0,20,22,-2
POL,ZAF,2014.0,14,1,13
SGP,IDN,2010.0,4,1,3
IND,PRT,2014.0,15,15,0
PRT,IND,2016.0,11,10,1
HUN,ESP,2014.0,7,4,3
FRA,COL,2010.0,18,4,14
CIV,FRA,2017.0,11,23,-12
FRA,CMR,2016.0,16,12,4
IDN,NZL,2018.0,4,6,-2
EGY,LBN,2018.0,12,2,10
THA,DEU,2005.0,3,12,-9
USA,HTI,2006.0,10,2,8
SWE,ARE,2014.0,2,2,0
JAM,NGA,2011.0,1,1,0
CHE,ITA,2002.0,79,96,-17
FRA,ISR,2004.0,23,15,8
AUT,USA,2003.0,90,109,-19
GBR,KOR,2005.0,34,20,14
ROU,BEL,2004.0,6,5,1
CUB,ESP,2015.0,29,13,16
MEX,FRA,2005.0,31,55,-24
TUR,AUS,2002.0,5,1,4
CHE,BEL,2013.0,38,55,-17
USA,BHR,2007.0,2,3,-1
BIH,HRV,2007.0,11,9,2
HRV,MKD,2006.0,1,1,0
HUN,USA,1997.0,11,21,-10
NGA,GBR,2004.0,8,13,-5
CHE,SVK,2011.0,4,1,3
RUS,ITA,1999.0,32,8,24
USA,TTO,2010.0,10,4,6
AUT,AUS,2002.0,18,15,3
CZE,KWT,2005.0,2,1,1
IRL,USA,1998.0,10,15,-5
HRV,DEU,2001.0,10,4,6
SGP,DEU,2002.0,9,9,0
USA,URY,2010.0,13,8,5
VNM,AUS,2001.0,2,2,0
IDN,USA,2001.0,7,13,-6
DNK,ROU,2006.0,1,2,-1
GBR,GMB,2011.0,8,10,-2
BEL,CHE,2001.0,11,13,-2
KWT,ARE,2019.0,3,3,0
NZL,DEU,2005.0,13,30,-17
CHE,HUN,2016.0,12,10,2
JPN,TUR,2009.0,8,7,1
ITA,DZA,2003.0,8,1,7
MEX,FRA,2002.0,25,29,-4
TTO,GBR,2004.0,2,4,-2
HRV,AUS,2005.0,1,1,0
CAN,BEL,2003.0,19,25,-6
ESP,AUT,2002.0,10,15,-5
CHL,NLD,2014.0,6,7,-1
AUT,NOR,2014.0,13,5,8
OMN,JOR,2012.0,3,1,2
FRA,GLP,2017.0,6,14,-8
BLR,DEU,1998.0,4,3,1
ITA,SVK,2010.0,7,1,6
CIV,USA,2019.0,2,4,-2
NLD,ITA,2002.0,57,52,5
TUR,SRB,2014.0,3,1,2
BGR,DEU,2002.0,12,27,-15
ISL,DNK,2010.0,7,6,1
ARG,FRA,2000.0,4,4,0
BRA,RUS,1999.0,5,8,-3
SWE,CHL,2004.0,2,2,0
THA,FRA,2005.0,1,8,-7
ZAF,AFG,2013.0,1,1,0
POL,GBR,2001.0,25,13,12
FRA,PRT,2000.0,8,8,0
CZE,SVK,2004.0,23,19,4
FRA,ZAF,2000.0,5,3,2
SWE,FIN,2007.0,44,28,16
USA,GRD,2019.0,13,20,-7
TWN,ZAF,2018.0,2,1,1
POL,ITA,2000.0,3,11,-8
MEX,RUS,2010.0,6,3,3
PRT,POL,2012.0,4,4,0
SAU,AUS,2000.0,2,2,0
NGA,SAU,2014.0,2,5,-3
PRT,BRA,2003.0,23,20,3
BRA,ARG,2001.0,10,24,-14
NOR,DEU,2002.0,14,20,-6
CZE,SWE,2008.0,7,5,2
ZAF,LKA,2019.0,2,1,1
POL,CHE,2012.0,11,34,-23
GBR,TZA,2010.0,10,7,3
GRC,FRA,2003.0,19,30,-11
MYS,FRA,2008.0,5,3,2
CHE,BGD,2003.0,3,1,2
CHN,CAN,1998.0,25,6,19
ZAF,AUS,2000.0,4,1,3
PAK,USA,1997.0,2,3,-1
CHN,CAN,1997.0,7,4,3
DNK,GBR,1998.0,10,12,-2
ITA,HUN,2004.0,4,4,0
JPN,MMR,2021.0,8,3,5
ISR,KOR,2000.0,1,1,0
JPN,NZL,2005.0,4,6,-2
CIV,FRA,2010.0,25,27,-2
AUS,POL,2004.0,5,1,4
IRL,ITA,2009.0,8,20,-12
KOR,ARE,2016.0,7,2,5
SRB,SWE,2002.0,3,2,1
CHE,PRT,2015.0,9,15,-6
SVN,AUS,2016.0,3,1,2
RUS,KAZ,2008.0,11,3,8
ZWE,USA,2016.0,5,8,-3
IRN,JPN,2012.0,11,12,-1
SWE,SVN,2016.0,1,6,-5
HRV,USA,2016.0,12,26,-14
ESP,IND,2013.0,19,20,-1
ZAF,MWI,2009.0,1,1,0
SGP,NLD,2010.0,4,6,-2
FRA,SVK,2008.0,5,4,1
LUX,GBR,2015.0,6,10,-4
NOR,ESP,2007.0,8,3,5
HRV,CZE,2016.0,2,1,1
NZL,NLD,2012.0,5,14,-9
COL,ECU,2015.0,4,1,3
NGA,NLD,2009.0,1,1,0
CHE,EST,2016.0,4,1,3
BEL,MEX,2011.0,6,7,-1
ESP,URY,2008.0,6,11,-5
IRN,AUS,2005.0,7,11,-4
GEO,DEU,2018.0,1,4,-3
MYS,HRV,2014.0,1,1,0
MOZ,ESP,2013.0,1,3,-2
TWN,AUS,2004.0,3,5,-2
GBR,NGA,2015.0,39,34,5
USA,KWT,2013.0,10,6,4
ETH,NOR,2010.0,2,2,0
GBR,UGA,2008.0,10,4,6
GBR,TZA,2017.0,7,7,0
EST,GBR,2017.0,5,9,-4
COL,PER,2017.0,4,4,0
AUS,PHL,2016.0,15,7,8
TUN,GBR,2016.0,3,2,1
ROU,MDA,2016.0,7,3,4
NLD,HKG,2016.0,6,9,-3
GBR,ZWE,2018.0,5,6,-1
IDN,MYS,2022.0,12,25,-13
EGY,JPN,2013.0,14,59,-45
BOL,BRA,2018.0,1,1,0
TZA,CHE,2018.0,10,4,6
FRA,AUT,2022.0,17,11,6
GRC,ESP,2006.0,5,8,-3
PHL,KOR,2016.0,8,11,-3
VNM,CHE,2015.0,6,1,5
MAR,MEX,2021.0,1,1,0
ESP,GTM,2018.0,1,3,-2
THA,DNK,2013.0,2,2,0
MYS,KOR,2017.0,26,7,19
ERI,IND,2020.0,2,1,1
PRT,ARE,2017.0,3,1,2
IND,QAT,2016.0,7,4,3
BGD,CAN,2013.0,16,15,1
TUN,ITA,2021.0,5,6,-1
PRT,MAC,2017.0,4,1,3
ESP,CAN,2006.0,24,27,-3
LAO,AUS,2020.0,2,1,1
FRA,HRV,2019.0,7,6,1
CHE,HKG,2019.0,7,14,-7
CAN,GRC,2015.0,8,19,-11
JOR,KOR,2018.0,1,1,0
ETH,NOR,2019.0,5,10,-5
PHL,CHN,2020.0,5,5,0
CAN,KOR,2000.0,5,8,-3
NGA,HKG,2021.0,4,2,2
GHA,HKG,2019.0,1,3,-2
BGD,IND,2022.0,11,8,3
BRA,CUB,2021.0,6,4,2
GHA,USA,2013.0,10,15,-5
DEU,DNK,2007.0,66,50,16
NOR,DEU,2005.0,12,35,-23
BGR,ESP,2010.0,2,1,1
FIN,EST,2004.0,4,8,-4
MYS,IND,2007.0,10,27,-17
SGP,AUT,2004.0,1,1,0
USA,ETH,2003.0,2,6,-4
AUT,HUN,2009.0,13,15,-2
DNK,KOR,2020.0,4,9,-5
EGY,SWE,2012.0,4,7,-3
BGR,RUS,1999.0,4,3,1
PSE,EGY,2022.0,4,2,2
ARE,NLD,2020.0,5,5,0
CZE,ITA,2013.0,10,12,-2
HRV,POL,2012.0,8,1,7
GBR,BWA,2018.0,8,1,7
IND,BGD,2011.0,7,8,-1
CAN,MYS,2008.0,5,2,3
JPN,AUT,2009.0,8,7,1
KEN,SWE,2021.0,2,2,0
BEL,COG,2021.0,6,1,5
CMR,FRA,2014.0,12,20,-8
NOR,CHE,2020.0,14,20,-6
JPN,CZE,2014.0,8,6,2
LUX,FRA,2003.0,2,4,-2
NLD,ZWE,2020.0,2,1,1
SYR,DEU,2019.0,4,4,0
CHE,ARE,2018.0,3,1,2
TUR,ITA,2021.0,9,7,2
CHN,BRA,2017.0,7,9,-2
USA,GRD,2017.0,9,11,-2
CHE,NZL,2020.0,16,6,10
HUN,SWE,2003.0,7,13,-6
MYS,EGY,2020.0,14,2,12
KOR,QAT,2011.0,2,1,1
NGA,TUR,2020.0,2,7,-5
UKR,CZE,2021.0,4,3,1
DEU,GEO,2020.0,5,5,0
GRC,IND,2021.0,2,1,1
EGY,AUS,2014.0,3,6,-3
THA,SWE,2012.0,5,4,1
VNM,FRA,2011.0,7,14,-7
PRT,IRN,2020.0,5,16,-11
CHE,LKA,2015.0,2,3,-1
IRL,NLD,2008.0,5,11,-6
IRN,AUS,2002.0,2,8,-6
ESP,IRL,2007.0,13,9,4
BGR,DEU,2005.0,24,12,12
JOR,USA,2001.0,11,10,1
MNG,KOR,2011.0,2,3,-1
DEU,PSE,2011.0,6,2,4
FRA,HRV,2010.0,6,1,5
BGR,JPN,2004.0,4,3,1
FRA,BLR,2012.0,3,2,1
JPN,DNK,2014.0,7,6,1
NOR,SWE,1997.0,3,4,-1
DEU,BGR,1999.0,5,3,2
NLD,RUS,2011.0,12,15,-3
TWN,TUR,2002.0,1,2,-1
ARG,VEN,2008.0,3,1,2
BHR,GBR,2006.0,1,1,0
ZAF,CAN,2011.0,13,16,-3
HUN,UKR,2018.0,2,1,1
AUT,BRA,2007.0,3,2,1
IRL,HUN,2015.0,5,3,2
KOR,SGP,2002.0,5,3,2
AUT,JPN,2000.0,4,2,2
SRB,GBR,2001.0,2,1,1
CHL,CHE,2005.0,3,1,2
CHN,MAC,2006.0,6,1,5
BEL,CUB,2004.0,2,1,1
SWE,PHL,2007.0,2,1,1
CHE,SRB,2014.0,3,3,0
ETH,FRA,2008.0,2,1,1
CZE,JPN,2006.0,5,5,0
NOR,SGP,2008.0,2,6,-4
LBN,FRA,2006.0,12,31,-19
BEL,TUN,2002.0,3,1,2
TUR,AUS,2005.0,3,2,1
DEU,URY,2018.0,1,3,-2
AUT,CAN,2013.0,12,15,-3
TZA,USA,2013.0,11,15,-4
EGY,NGA,2012.0,1,1,0
TWN,ITA,2013.0,3,4,-1
SVN,AUT,2011.0,5,2,3
FIN,ISR,2012.0,1,1,0
ESP,AUT,2005.0,6,11,-5
UZB,USA,2016.0,3,2,1
NZL,KOR,2011.0,4,3,1
CHE,IRL,2022.0,6,5,1
CHE,KOR,2006.0,8,7,1
JOR,GBR,2012.0,8,24,-16
EGY,ITA,2013.0,5,10,-5
POL,IRQ,2020.0,1,1,0
ESP,GRC,2022.0,6,1,5
CHN,RWA,2015.0,2,4,-2
PHL,JPN,1998.0,1,1,0
CHN,IRQ,2014.0,3,3,0
ETH,ARE,2018.0,1,1,0
USA,URY,2019.0,12,11,1
AUT,THA,2005.0,2,3,-1
FRA,SVN,2019.0,3,5,-2
BIH,CHE,2020.0,3,2,1
MYS,ESP,2017.0,3,1,2
BEL,BEN,2018.0,1,1,0
GBR,BGD,2006.0,11,10,1
THA,TWN,2017.0,6,15,-9
COL,DOM,2020.0,1,1,0
ZAF,BRA,2018.0,4,8,-4
BEL,ETH,2022.0,2,1,1
MAC,USA,2015.0,1,14,-13
PSE,ISR,2012.0,4,18,-14
CHL,CHE,2002.0,2,1,1
NGA,KEN,2020.0,3,4,-1
BGR,GBR,2020.0,6,8,-2
FRA,GLP,2010.0,13,17,-4
FRA,SEN,2002.0,17,23,-6
NOR,SWE,1998.0,7,19,-12
AUT,RUS,2001.0,4,10,-6
NLD,GRC,2008.0,11,10,1
MYS,SWE,2009.0,2,1,1
ROU,ARE,2017.0,3,1,2
USA,BFA,2002.0,3,2,1
KOR,SGP,2005.0,3,10,-7
VEN,ARG,2015.0,2,3,-1
BRA,CZE,2009.0,1,1,0
GBR,LUX,2013.0,9,5,4
NLD,LTU,2022.0,1,1,0
MEX,RUS,2019.0,3,2,1
AUT,AUS,2005.0,10,10,0
IND,ZAF,2007.0,11,9,2
AUS,CMR,2011.0,1,1,0
CZE,CHE,2009.0,9,9,0
HKG,TWN,2001.0,7,5,2
JPN,POL,2015.0,4,20,-16
CHL,PRT,2012.0,4,1,3
THA,TWN,2019.0,4,16,-12
BGD,NLD,2016.0,3,3,0
EST,ESP,2015.0,1,3,-2
ETH,USA,2010.0,3,12,-9
AUS,BGD,2012.0,8,28,-20
KOR,AUT,2022.0,4,3,1
LBN,NLD,2012.0,1,1,0
THA,HKG,2021.0,3,8,-5
HKG,ARE,2012.0,1,1,0
CHE,HKG,2017.0,4,4,0
USA,TTO,2017.0,5,3,2
IRN,SVK,2022.0,4,1,3
ITA,PAK,2022.0,2,16,-14
THA,CHE,2022.0,3,4,-1
SGP,DEU,2005.0,8,14,-6
CZE,CHN,2002.0,1,1,0
BRN,GBR,2002.0,3,2,1
COL,VEN,2022.0,3,9,-6
SWE,KEN,2018.0,5,3,2
NOR,TUR,2020.0,1,15,-14
AUS,IDN,2022.0,21,7,14
VEN,ECU,2022.0,4,2,2
PAK,BHR,2018.0,1,1,0
ISL,DNK,2019.0,4,3,1
BGR,CHE,2006.0,3,2,1
JOR,OMN,2018.0,7,3,4
EST,USA,2008.0,2,7,-5
NZL,DEU,2002.0,6,17,-11
BHR,USA,2005.0,1,2,-1
BIH,USA,2006.0,4,7,-3
KAZ,RUS,1999.0,9,4,5
FRA,MDG,2004.0,5,2,3
COL,AUS,2010.0,3,3,0
GRC,POL,2005.0,2,4,-2
RUS,AZE,2001.0,4,4,0
KEN,BEL,2003.0,3,5,-2
ITA,DNK,1998.0,10,6,4
OMN,ARE,2008.0,3,2,1
POL,AUT,1999.0,2,2,0
ARE,AUT,2018.0,1,2,-1
PRT,CAN,2001.0,5,1,4
IRL,USA,1997.0,7,10,-3
BEL,ECU,2015.0,5,1,4
CHE,QAT,2015.0,1,1,0
EGY,IND,2017.0,3,2,1
NZL,HKG,2016.0,4,8,-4
DNK,GBR,1997.0,6,11,-5
AUT,NZL,2014.0,8,5,3
ETH,MEX,2019.0,1,2,-1
THA,TWN,2010.0,3,3,0
NLD,LKA,2003.0,1,1,0
ZAF,LKA,2010.0,1,1,0
SRB,RUS,2007.0,1,1,0
PRT,MEX,2004.0,3,1,2
SAU,IND,2011.0,8,89,-81
ETH,MEX,2017.0,3,1,2
TUR,BIH,2016.0,5,2,3
NLD,IRN,2011.0,14,27,-13
AUS,COL,2012.0,2,4,-2
CHN,BRA,2019.0,1,21,-20
CAN,ETH,2015.0,1,2,-1
COL,CHE,2007.0,2,1,1
DNK,GNB,2015.0,3,1,2
BEL,NZL,2016.0,4,6,-2
PAK,BEL,2020.0,2,2,0
ARE,HKG,2018.0,1,2,-1
NLD,BEN,2017.0,3,4,-1
FRA,BGR,2019.0,1,1,0
ITA,MAR,2019.0,2,5,-3
IND,BRB,2009.0,1,1,0
NOR,PAK,2020.0,4,6,-2
IRL,KOR,2006.0,1,2,-1
USA,BMU,2006.0,2,1,1
PNG,USA,2017.0,2,3,-1
IND,BRA,1999.0,6,2,4
NOR,NPL,2005.0,1,1,0
MYS,JPN,2005.0,6,7,-1
DEU,GHA,2014.0,3,5,-2
ZWE,MEX,2018.0,1,1,0
BGD,GRC,2008.0,2,1,1
CHL,IND,2022.0,4,5,-1
GBR,BGR,1999.0,3,3,0
ITA,DNK,1997.0,5,7,-2
MYS,KOR,2010.0,2,9,-7
AUT,ESP,1999.0,3,3,0
PHL,GBR,1999.0,1,1,0
COG,GBR,2009.0,1,1,0
TUR,SAU,2008.0,2,2,0
TUN,ARE,2020.0,4,2,2
CMR,CAN,2008.0,3,3,0
ETH,SWE,2000.0,1,1,0
EGY,PSE,2011.0,4,5,-1
NZL,BEL,2013.0,3,4,-1
IND,THA,2002.0,2,2,0
EST,GBR,2019.0,7,12,-5
CAN,SYR,2011.0,2,1,1
JPN,ARG,2011.0,2,1,1
PAK,TZA,2011.0,1,2,-1
RUS,ESP,2004.0,7,8,-1
LUX,DEU,2006.0,2,11,-9
NLD,HUN,2008.0,8,10,-2
DNK,MEX,2012.0,3,3,0
GBR,MMR,2022.0,2,1,1
NLD,CZE,2010.0,5,5,0
VNM,TWN,2014.0,3,13,-10
USA,ARM,2003.0,2,7,-5
IND,GRC,2018.0,2,1,1
USA,SWZ,2018.0,3,1,2
KEN,CMR,2016.0,1,2,-1
BEL,NOR,2004.0,1,1,0
ARM,USA,2009.0,4,3,1
BEL,CHL,2021.0,3,4,-1
COL,FRA,2007.0,3,8,-5
AND,ESP,2009.0,1,4,-3
BEL,COD,2016.0,1,1,0
GTM,COL,2018.0,1,3,-2
PRI,FRA,2016.0,1,2,-1
JPN,PRT,2008.0,2,1,1
AUS,PAN,2009.0,1,1,0
SWE,ISL,1999.0,3,2,1
SGP,SWE,2001.0,2,1,1
VNM,BEL,2016.0,4,8,-4
NOR,BRA,2020.0,5,18,-13
COL,PER,2010.0,1,4,-3
SAU,SYR,2012.0,2,3,-1
KOR,PAK,2011.0,9,14,-5
ITA,BGD,2011.0,2,8,-6
HKG,FIN,2018.0,3,2,1
TUN,CHL,2020.0,1,1,0
BEL,KOR,2004.0,1,2,-1
NZL,TWN,2008.0,3,1,2
MEX,KOR,2009.0,1,1,0
RUS,IRN,2017.0,6,5,1
TZA,UGA,2019.0,4,3,1
FRA,GUY,2016.0,1,2,-1
RUS,IND,2016.0,3,15,-12
CHE,FIN,2004.0,6,9,-3
PHL,ESP,2020.0,1,4,-3
KOR,JOR,2018.0,1,1,0
MYS,PHL,2009.0,2,1,1
CYP,NGA,2020.0,3,2,1
PER,ESP,2022.0,8,7,1
OMN,BGD,2019.0,2,1,1
ZAF,ZMB,2012.0,2,4,-2
KOR,SWE,2007.0,3,3,0
PAK,ZAF,2002.0,2,1,1
NLD,BGR,2001.0,1,2,-1
BEL,GRC,2001.0,5,9,-4
NLD,AUT,1999.0,5,5,0
FRA,MTQ,2008.0,8,14,-6
NLD,ARE,2009.0,2,1,1
DEU,SYR,2005.0,3,2,1
CHL,BRA,2002.0,3,3,0
MYS,JPN,2002.0,3,13,-10
GBR,HRV,2014.0,4,8,-4
ARG,COL,1998.0,6,1,5
MEX,UKR,2003.0,2,5,-3
BRB,CAN,2005.0,1,1,0
SVN,HRV,1999.0,3,1,2
MEX,RUS,2017.0,4,3,1
CHL,MEX,1998.0,1,2,-1
ITA,KOR,1997.0,1,1,0
LAO,GBR,2016.0,1,2,-1
VEN,AUS,2003.0,1,2,-1
NZL,MYS,2003.0,1,1,0
MWI,GBR,2001.0,2,8,-6
LUX,BEL,2014.0,2,25,-23
KEN,NGA,2015.0,3,2,1
SAU,SWE,2015.0,4,3,1
FIN,MYS,2014.0,3,3,0
BLR,CHN,2014.0,1,2,-1
CHL,URY,2020.0,3,6,-3
QAT,HUN,2019.0,2,1,1
IDN,SGP,2018.0,5,6,-1
KOR,TUN,2017.0,2,1,1
RUS,BGR,2015.0,4,4,0
CMR,NGA,2019.0,3,1,2
FSM,USA,2014.0,1,1,0
LBN,SAU,2020.0,5,3,2
BGR,ESP,2017.0,1,5,-4
NZL,IND,2002.0,2,3,-1
EGY,NLD,1997.0,1,2,-1
LTU,POL,2006.0,3,1,2
SYR,DEU,2017.0,4,2,2
USA,ZWE,2000.0,1,1,0
AUT,GRC,2016.0,3,3,0
SRB,SWE,2005.0,2,3,-1
SVN,SWE,2013.0,4,2,2
USA,GRD,2010.0,5,4,1
KWT,GBR,2006.0,5,8,-3
LUX,GRC,2013.0,2,3,-1
NLD,NZL,1999.0,2,2,0
NOR,AUS,1998.0,1,2,-1
BHR,USA,2002.0,1,1,0
MDG,FRA,2005.0,3,4,-1
ISR,SVN,2018.0,1,1,0
CHN,MYS,2004.0,1,1,0
HKG,RUS,1999.0,1,1,0
DEU,CMR,2016.0,1,3,-2
ISR,ARG,2016.0,1,1,0
CIV,USA,2017.0,3,2,1
SVN,MNE,2017.0,2,1,1
AUS,LKA,1998.0,1,1,0
TUN,CAN,2020.0,9,8,1
USA,MAC,2022.0,2,2,0
KEN,GMB,2018.0,1,1,0
IRQ,AUS,2022.0,2,8,-6
POL,HRV,2020.0,1,2,-1
GRD,GBR,2015.0,1,1,0
PHL,IND,2010.0,3,4,-1
IDN,PER,2012.0,1,1,0
ITA,LKA,2013.0,1,2,-1
AUS,IRQ,2016.0,3,6,-3
PHL,ITA,2019.0,1,2,-1
SDN,USA,2021.0,2,3,-1
SDN,CHN,2020.0,3,16,-13
CAN,JOR,2007.0,6,6,0
PAK,KWT,2013.0,2,1,1
ROU,AUS,2012.0,2,1,1
BEL,MYS,2016.0,2,1,1
PAK,TWN,2019.0,3,1,2
TUN,BEL,2016.0,1,5,-4
BGD,AUT,2018.0,1,2,-1
NGA,ZMB,2022.0,1,3,-2
NZL,FJI,2012.0,1,3,-2
MLT,IRL,2021.0,1,1,0
CPV,PRT,2015.0,2,2,0
MLT,USA,2021.0,2,3,-1
ITA,IDN,2017.0,1,2,-1
KOR,UZB,2005.0,1,3,-2
CUB,BRA,2000.0,4,3,1
UKR,TWN,2016.0,1,2,-1
ZWE,BWA,2013.0,1,1,0
ZAF,UGA,2002.0,1,1,0
ITA,CZE,2000.0,2,3,-1
EST,GBR,2010.0,2,6,-4
BEL,TWN,2015.0,1,6,-5
RWA,GBR,2016.0,1,4,-3
CHN,BRA,2010.0,3,1,2
HUN,CHN,2014.0,1,3,-2
NGA,IND,2014.0,6,6,0
OMN,TUN,2013.0,1,1,0
HND,ESP,2018.0,2,2,0
ITA,KOR,1998.0,1,1,0
USA,MDA,2013.0,1,2,-1
NLD,IRQ,2019.0,1,1,0
MYS,ESP,2019.0,2,2,0
ROU,ARE,2019.0,1,1,0
ZWE,BEL,2009.0,2,1,1
SDN,SAU,2004.0,2,3,-1
QAT,AUS,2007.0,1,1,0
BEL,TUN,2005.0,1,4,-3
BRA,MOZ,2014.0,3,3,0
ITA,IDN,2019.0,2,1,1
PRT,ITA,1999.0,1,8,-7
CMR,COG,2013.0,1,1,0
SEN,GBR,2007.0,1,1,0
ARE,PSE,2017.0,1,1,0
IRN,ISL,2013.0,2,1,1
HKG,CHE,2013.0,3,3,0
LAO,THA,2012.0,2,2,0
TZA,BEL,2012.0,2,2,0
CMR,CHE,2009.0,1,3,-2
GBR,DZA,2003.0,1,2,-1
ARG,CHE,2008.0,1,4,-3
ZMB,MWI,2012.0,2,2,0
ECU,VEN,2016.0,1,24,-23
KEN,MEX,2018.0,1,2,-1
NOR,TWN,2019.0,1,2,-1
HKG,NZL,2006.0,2,1,1
BLR,UKR,2020.0,1,1,0
TUR,PSE,2017.0,4,1,3
FIN,EGY,2020.0,3,4,-1
PHL,IND,2019.0,3,13,-10
IDN,AUT,2021.0,1,4,-3
IRL,QAT,2022.0,2,2,0
AUT,ARG,2021.0,1,1,0
IRN,EGY,2020.0,1,1,0
BEL,VNM,2006.0,3,3,0
GBR,CUB,2015.0,1,2,-1
ZAF,FIN,2006.0,1,3,-2
CHE,MLI,2005.0,1,1,0
BOL,FRA,2012.0,4,3,1
SVN,CHN,2015.0,2,2,0
SVK,SRB,2015.0,1,1,0
KOR,UKR,2003.0,1,4,-3
CAN,VEN,2004.0,2,4,-2
LBR,USA,2016.0,1,2,-1
USA,DOM,2015.0,3,2,1
PRT,MAC,2019.0,2,3,-1
DEU,YEM,2011.0,2,1,1
ALB,NOR,2014.0,1,1,0
IDN,FRA,2016.0,3,14,-11
PHL,ITA,2017.0,1,3,-2
SVN,NLD,2004.0,1,2,-1
DEU,GAB,2014.0,1,2,-1
TGO,SEN,2012.0,1,1,0
NZL,CHL,2020.0,1,6,-5
ZMB,CHE,2020.0,1,1,0
AUS,SVK,1999.0,1,1,0
GEO,FRA,2009.0,1,1,0
NZL,IND,2005.0,2,2,0
AUT,SAU,2015.0,1,1,0
MLI,CHN,2018.0,1,6,-5
ECU,ESP,2003.0,1,1,0
DEU,SDN,2004.0,2,1,1
POL,HKG,2016.0,1,2,-1
PRI,AUS,2004.0,1,2,-1
NLD,COL,2006.0,3,3,0
TZA,UGA,2017.0,1,2,-1
IRN,CZE,2010.0,2,1,1
GBR,LAO,2015.0,1,2,-1
COL,CAN,2003.0,2,2,0
CRI,COL,2017.0,1,1,0
USA,BRB,2015.0,2,2,0
ZAF,TWN,2012.0,1,1,0
TZA,CMR,2016.0,1,1,0
FRA,SGP,2001.0,1,2,-1
PHL,IND,2017.0,1,8,-7
BTN,BGD,2019.0,1,2,-1
IDN,NOR,2016.0,1,2,-1
SWE,HRV,2020.0,1,3,-2
ITA,SVN,2003.0,1,3,-2
SWE,BEL,1998.0,2,2,0
USA,SVN,1999.0,1,2,-1
FJI,NZL,2003.0,2,5,-3
HKG,CAN,1997.0,1,3,-2
BRB,GBR,2018.0,1,2,-1
BOL,ESP,1999.0,1,1,0
KEN,EGY,2018.0,1,1,0
FJI,IND,2016.0,1,5,-4
TUR,MYS,2017.0,1,11,-10
DEU,CRI,2007.0,1,1,0
POL,ROU,2008.0,2,2,0
ITA,IDN,2010.0,1,1,0
BHR,JOR,2009.0,1,1,0
LBN,KWT,2004.0,1,1,0
BLR,CAN,1999.0,1,1,0
GBR,UZB,2010.0,1,1,0
JPN,MYS,2000.0,1,2,-1
EGY,KWT,2003.0,2,6,-4
FIN,SGP,2022.0,2,3,-1
ZAF,RUS,2003.0,1,7,-6
MNG,CHN,2016.0,1,1,0
POL,SGP,2013.0,1,6,-5
ESP,LBN,2021.0,1,2,-1
UKR,IRL,2007.0,1,1,0
ZAF,LKA,2017.0,1,1,0
NZL,FIN,2013.0,1,2,-1
USA,LSO,2018.0,1,2,-1
HKG,IRL,2006.0,1,1,0
PAK,JOR,2018.0,1,1,0
COG,ZWE,2019.0,1,2,-1
DOM,ESP,2015.0,1,1,0
VNM,CAN,2013.0,1,3,-2
CUB,ITA,2003.0,1,6,-5
SVN,DNK,2022.0,1,4,-3
CHN,USA,2004.0,805,597,208
FRA,USA,2017.0,917,668,249
GBR,BEL,2020.0,161,112,49
JPN,AUS,2009.0,55,42,13
DEU,FRA,2012.0,290,322,-32
AUS,GBR,2005.0,320,406,-86
GBR,CAN,2019.0,435,369,66
SWE,NOR,2017.0,79,48,31
RUS,DEU,1999.0,98,53,45
BEL,FRA,2019.0,184,195,-11
GBR,SWE,2015.0,176,112,64
EGY,CAN,2007.0,10,16,-6
ESP,COL,2007.0,30,23,7
JPN,NZL,2002.0,9,10,-1
NZL,SWE,2016.0,11,4,7
FIN,NLD,2009.0,8,16,-8
PAK,USA,1998.0,3,5,-2
BEL,IRN,2015.0,9,14,-5
AUS,PNG,2015.0,4,7,-3
FRA,KOR,2022.0,12,7,5
BEL,FRA,2017.0,208,190,18
HUN,DNK,2019.0,8,3,5
SVK,SVN,2014.0,3,5,-2
ESP,CHE,2022.0,48,36,12
CHL,ARG,2021.0,12,17,-5
AUS,GBR,2002.0,360,344,16
CHN,DZA,2021.0,4,1,3
FRA,POL,2009.0,29,25,4
CHE,NLD,2021.0,60,89,-29
KAZ,POL,2020.0,2,2,0
CHN,ITA,2021.0,49,48,1
AUS,CHN,2003.0,46,47,-1
FRA,CHN,2007.0,37,43,-6
HUN,DEU,2014.0,47,25,22
KOR,CAN,2010.0,49,42,7
CAN,DEU,2013.0,185,162,23
CRI,COL,2019.0,3,1,2
EGY,IND,2010.0,4,1,3
ARE,CAN,2018.0,27,27,0
ITA,ESP,1999.0,28,39,-11
JPN,NLD,2021.0,12,15,-3
SAU,FRA,2017.0,14,28,-14
TWN,SGP,2014.0,16,12,4
THA,MYS,2020.0,4,11,-7
SAU,TUN,2021.0,39,91,-52
PAK,AUS,2020.0,46,22,24
ITA,RUS,2018.0,18,22,-4
ITA,NLD,2011.0,91,55,36
TWN,DEU,2011.0,14,19,-5
IND,POL,2001.0,2,1,1
NLD,JPN,2007.0,16,16,0
IND,UKR,2019.0,4,1,3
POL,FRA,1997.0,10,13,-3
BLR,RUS,2004.0,13,7,6
CAN,HUN,2013.0,3,10,-7
DEU,TWN,2003.0,7,5,2
TWN,KOR,2011.0,13,9,4
PAK,OMN,2021.0,6,4,2
BEL,ROU,2008.0,10,3,7
GBR,PRT,2000.0,15,9,6
NZL,IRL,2014.0,10,9,1
SAU,FRA,2019.0,10,25,-15
FRA,COL,2019.0,16,18,-2
AUT,EGY,2011.0,4,1,3
CRI,USA,2021.0,15,11,4
POL,FRA,1998.0,6,11,-5
DEU,SVN,2007.0,6,2,4
DNK,ESP,2008.0,14,16,-2
IND,SWE,2012.0,40,10,30
IRL,FIN,2022.0,4,1,3
NPL,LKA,2013.0,1,2,-1
BGD,KOR,2012.0,10,18,-8
GBR,SVK,1999.0,2,3,-1
BMU,USA,2003.0,3,1,2
FJI,AUS,2016.0,6,8,-2
HKG,CAN,1998.0,2,10,-8
FRA,BGR,2010.0,5,7,-2
BRA,NZL,2012.0,4,4,0
FRA,BGR,2017.0,8,3,5
NGA,IRL,2013.0,1,2,-1
NOR,THA,2011.0,1,1,0
CHN,CHL,2015.0,1,7,-6
SGP,THA,2003.0,1,3,-2
ZAF,ITA,2011.0,1,7,-6
HUN,DNK,2017.0,4,1,3
HUN,DNK,2010.0,5,1,4
THA,FRA,2002.0,4,8,-4
CAN,PRT,2004.0,4,5,-1
SWE,BEL,1997.0,2,6,-4
TUR,JPN,2007.0,6,8,-2
RUS,IRL,2020.0,10,2,8
NGA,ITA,2014.0,4,2,2
HRV,FRA,2001.0,1,5,-4
KWT,ARE,2010.0,2,1,1
VEN,BRA,2016.0,5,3,2
ISR,CHE,2004.0,10,4,6
AUS,HUN,1998.0,1,1,0
RUS,IRN,2019.0,3,18,-15
SGP,NZL,2016.0,5,14,-9
PAK,ITA,2012.0,1,7,-6
SAU,DZA,2007.0,2,6,-4
COL,MEX,1999.0,1,4,-3
ITA,SGP,2006.0,1,2,-1
CRI,COL,2010.0,2,1,1
SWE,LUX,2018.0,3,1,2
PRT,CYP,2017.0,1,1,0
GHA,HKG,2017.0,1,1,0
QAT,CAN,2014.0,2,15,-13
RUS,HUN,2003.0,1,1,0
JAM,CAN,2005.0,1,1,0
FRA,SVN,2017.0,3,8,-5
LKA,THA,2012.0,2,1,1
KWT,IND,1999.0,2,2,0
IRQ,NGA,2022.0,1,3,-2
ECU,ARG,2022.0,3,1,2
FRA,COG,2012.0,3,4,-1
SEN,MLI,2011.0,1,3,-2
TUR,ESP,2004.0,1,3,-2
CHL,ECU,2014.0,1,2,-1
ARG,PER,2009.0,2,4,-2
BRA,SWE,1999.0,2,2,0
TWN,TUR,2005.0,1,4,-3
TUN,POL,2018.0,1,2,-1
ITA,NGA,2022.0,1,1,0
CHE,CUB,2011.0,1,2,-1
CZE,PAK,2021.0,2,3,-1
CAN,LTU,2018.0,1,2,-1
ITA,EST,2009.0,1,1,0
SEN,CIV,2016.0,1,1,0
,AUS,2003.0,6673,0,6673
,USA,1995.0,53784,0,53784
BIH,,2023.0,973,0,973
,TWN,1999.0,6800,0,6800
TUR,,2023.0,27770,0,27770
ESP,,2024.0,92971,0,92971
,ESP,1998.0,15942,0,15942
,BIH,2002.0,172,0,172
KOR,,2023.0,47546,0,47546
SVK,,2024.0,5326,0,5326
,JPN,1999.0,46875,0,46875
NOR,,2016.0,1245,0,1245
CAN,,2023.0,45812,0,45812
,ISR,1994.0,2394,0,2394
,SVN,2003.0,567,0,567
,EGY,2005.0,1591,0,1591
,IND,1997.0,3466,0,3466
IDN,,2022.0,7327,0,7327
USA,,1999.0,2771,0,2771
CHN,,2004.0,6490,0,6490
AUT,,2001.0,69,0,69
,PRT,2000.0,1795,0,1795
,IND,1998.0,12823,0,12823
FIN,,2008.0,1025,0,1025
,ESP,1997.0,6894,0,6894
SVN,,2011.0,234,0,234
THA,,2012.0,652,0,652
PRT,CYP,2019.0,1,0,1
MLI,,2023.0,221,0,221
JOR,,2011.0,112,0,112
,GRC,2001.0,2739,0,2739
GRC,,2018.0,1934,0,1934
,SGP,2003.0,1394,0,1394
,ISL,1994.0,49,0,49
,EST,2003.0,225,0,225
,EGY,2002.0,1274,0,1274
SVK,NLD,2016.0,5,0,5
DNK,,2007.0,735,0,735
LKA,,2024.0,1775,0,1775
,KOR,2008.0,13773,0,13773
,MAR,2003.0,493,0,493
CHE,,2005.0,1151,0,1151
ISL,,2024.0,1064,0,1064
IND,,2004.0,2190,0,2190
SWE,,2004.0,984,0,984
NGA,,2013.0,781,0,781
UKR,,2012.0,640,0,640
,BIH,2005.0,157,0,157
MDA,NLD,2010.0,1,0,1
KEN,,2011.0,92,0,92
ARM,,2020.0,129,0,129
,BGD,1994.0,120,0,120
DEU,MYS,2006.0,3,0,3
,CHL,2006.0,1732,0,1732
BOL,,2012.0,12,0,12
,HKG,1994.0,854,0,854
LVA,CAN,2018.0,1,0,1
,ARE,2009.0,219,0,219
ROU,,2003.0,141,0,141
ARE,,1999.0,4,0,4
CHE,,2002.0,346,0,346
JPN,DZA,2012.0,3,0,3
GRC,GEO,2019.0,1,0,1
,PRI,2009.0,163,0,163
CRI,CAN,2006.0,2,0,2
,ARG,2011.0,2637,0,2637
,CZE,2012.0,2894,0,2894
ZWE,,2021.0,138,0,138
BGD,,2015.0,324,0,324
,PHL,2008.0,284,0,284
,UKR,2014.0,2598,0,2598
BTN,,2024.0,90,0,90
,CAF,2014.0,8,0,8
SYR,,2018.0,94,0,94
GTM,,2014.0,18,0,18
,VNM,2008.0,424,0,424
,PER,2009.0,336,0,336
,FIN,2015.0,1929,0,1929
SEN,USA,2006.0,2,0,2
TZA,AUS,2008.0,1,0,1
RWA,,2022.0,149,0,149
,LUX,2010.0,102,0,102
,PRY,2012.0,19,0,19
,JOR,2014.0,492,0,492
,COL,2018.0,2119,0,2119
NPL,BEL,2011.0,2,0,2
,MNE,2012.0,83,0,83
BEN,,2021.0,127,0,127
,FJI,2014.0,48,0,48
,BOL,2013.0,41,0,41
,ZWE,2014.0,111,0,111
,LKA,2016.0,359,0,359
,LUX,2017.0,136,0,136
ESP,DOM,2019.0,6,0,6
BRA,ARE,2021.0,2,0,2
CYP,ARE,2018.0,3,0,3
BRN,GBR,2005.0,1,0,1
IRN,QAT,2016.0,1,0,1
,BGR,2006.0,492,0,492
POL,MEX,2014.0,10,0,10
SMR,,2024.0,13,0,13
IRN,CZE,2019.0,20,0,20
KWT,,2021.0,308,0,308
,CUB,2014.0,424,0,424
ZAF,ARG,2018.0,2,0,2
,NAM,2001.0,17,0,17
TWN,SWE,2016.0,5,0,5
,YEM,2008.0,39,0,39
,URY,1999.0,226,0,226
BRA,KEN,2011.0,1,0,1
AUS,BGR,2012.0,2,0,2
UZB,,2014.0,52,0,52
IRN,CZE,2017.0,4,0,4
MUS,,2018.0,29,0,29
MDG,,2018.0,48,0,48
TUN,,2005.0,75,0,75
IRQ,ARE,2016.0,2,0,2
UGA,FRA,2003.0,2,0,2
NZL,PAN,2014.0,2,0,2
KHM,CAF,2010.0,1,0,1
EGY,,2003.0,113,0,113
,DJI,2012.0,6,0,6
ETH,,2008.0,36,0,36
NER,BFA,2021.0,1,0,1
PAK,MAR,2022.0,2,0,2
CMR,SWE,2021.0,1,0,1
,LUX,2019.0,96,0,96
SDN,CHE,2011.0,1,0,1
SVK,MLT,2020.0,1,0,1
KEN,NOR,2012.0,3,0,3
BRN,SGP,2014.0,1,0,1
,TGO,1997.0,19,0,19
,TGO,1998.0,9,0,9
,UZB,2001.0,91,0,91
EST,,2011.0,95,0,95
MNE,,2011.0,7,0,7
MNG,,2008.0,10,0,10
MOZ,,2012.0,6,0,6
IDN,MKD,2018.0,1,0,1
PHL,PER,2006.0,1,0,1
CAN,PAN,2005.0,1,0,1
ZWE,AUS,2002.0,3,0,3
QAT,HUN,2017.0,1,0,1
KOR,ROU,2004.0,2,0,2
CHE,IDN,2005.0,1,0,1
GRL,,2012.0,4,0,4
AUT,TUR,2000.0,1,0,1
CIV,BFA,2013.0,2,0,2
LUX,CAN,2000.0,1,0,1
GTM,CRI,2014.0,1,0,1
CAN,URY,2001.0,1,0,1
BHS,AUS,2000.0,1,0,1
NPL,BRA,2011.0,1,0,1
,HND,1994.0,2,0,2
AZE,RUS,2008.0,5,0,5
COL,POL,2002.0,1,0,1
IDN,CMR,2013.0,3,0,3
TUN,EGY,2008.0,2,0,2
ZAF,KNA,2014.0,1,0,1
DEU,NAM,2014.0,3,0,3
LAO,USA,2009.0,1,0,1
GRC,ZAF,2013.0,2,0,2
OMN,DEU,2008.0,1,0,1
EST,PRT,2011.0,2,0,2
,ZMB,1994.0,16,0,16
LUX,TUR,2007.0,1,0,1
PAK,ZAF,2005.0,1,0,1
USA,MDG,2012.0,10,0,10
MOZ,DEU,2002.0,1,0,1
IDN,GHA,2019.0,1,0,1
GRC,IRN,2017.0,2,0,2
LUX,SVK,2011.0,2,0,2
GHA,SDN,2012.0,1,0,1
MDA,FRA,2020.0,1,0,1
DNK,QAT,2017.0,1,0,1
SDN,ARE,2015.0,1,0,1
RUS,IRN,2010.0,7,0,7
ESP,AZE,2018.0,1,0,1
RUS,EST,2021.0,4,0,4
IRL,MCO,2016.0,1,0,1
LBR,COG,2019.0,2,0,2
NOR,ISR,2022.0,1,0,1
LBN,SWE,2016.0,1,0,1
,LBR,2012.0,10,0,10
NCL,,2022.0,40,0,40
HUN,ECU,2018.0,1,0,1
,KNA,2015.0,10,0,10
TUR,COL,2020.0,1,0,1
TUN,BHR,2015.0,2,0,2
JPN,LAO,2019.0,7,0,7
JOR,UKR,2019.0,1,0,1
MWI,IND,2001.0,2,0,2
BGR,DNK,1998.0,1,0,1
USA,KNA,2004.0,1,0,1
CHE,BGR,1999.0,2,0,2
SGP,ARE,2009.0,1,0,1
PRI,THA,2018.0,1,0,1
TUN,IRN,2022.0,1,0,1
AUS,TUN,2011.0,1,0,1
BFA,USA,2011.0,2,0,2
MAC,PHL,2021.0,1,0,1
,GLP,2012.0,15,0,15
TUR,ALB,2018.0,2,0,2
MAR,CIV,2011.0,1,0,1
SAU,PRT,2018.0,3,0,3
HKG,AUT,2020.0,3,0,3
FIN,CIV,2022.0,1,0,1
QAT,SRB,2012.0,1,0,1
TUN,,2002.0,10,0,10
BEL,VEN,2012.0,1,0,1
DZA,SWE,2022.0,1,0,1
MLT,EST,2021.0,1,0,1
IDN,MMR,2021.0,1,0,1
,WSM,1998.0,1,0,1
HTI,,2018.0,20,0,20
BRA,PHL,2015.0,1,0,1
LBY,IRQ,2009.0,1,0,1
SWZ,ZAF,2006.0,1,0,1
KWT,BGR,2011.0,1,0,1
NOR,OMN,2013.0,1,0,1
AGO,PRT,2009.0,1,0,1
,PLW,2002.0,3,0,3
PRI,JPN,2006.0,1,0,1
,BRN,2007.0,9,0,9
VNM,JPN,1998.0,1,0,1
GMB,AUS,2001.0,1,0,1
ATA,USA,2001.0,3,0,3
SGP,NOR,2022.0,3,0,3
OMN,NLD,2004.0,3,0,3
HUN,IND,2000.0,3,0,3
GBR,AZE,2008.0,1,0,1
THA,NOR,2004.0,1,0,1
ITA,KEN,2009.0,3,0,3
LBY,HUN,1999.0,1,0,1
PLW,USA,2003.0,5,0,5
BLR,GBR,2006.0,3,0,3
FJI,,2009.0,13,0,13
TON,FJI,2014.0,1,0,1
IRN,HKG,2022.0,7,0,7
JPN,GHA,2014.0,5,0,5
POL,HUN,1997.0,5,0,5
FRA,AFG,2012.0,1,0,1
SWZ,CAN,2008.0,1,0,1
BIH,CHN,2018.0,1,0,1
IRQ,IRL,2012.0,1,0,1
GBR,NCL,2012.0,2,0,2
MLI,IND,2005.0,1,0,1
MAC,GUM,2016.0,1,0,1
,GRL,2014.0,7,0,7
NLD,KAZ,2018.0,2,0,2
IRL,PER,2020.0,1,0,1
SVK,SAU,2021.0,1,0,1
FRA,MYS,2003.0,4,0,4
BHR,,2009.0,15,0,15
,AGO,2000.0,3,0,3
PNG,IND,2001.0,1,0,1
ASM,,2010.0,1,0,1
USA,NGA,1997.0,2,0,2
VEN,BEL,2004.0,1,0,1
FJI,SGP,2017.0,1,0,1
PSE,FIN,2014.0,1,0,1
UKR,JPN,2014.0,5,0,5
TZA,ISL,2021.0,1,0,1
BGR,BRA,2019.0,2,0,2
SVK,KHM,2008.0,1,0,1
VNM,SGP,2004.0,1,0,1
ARG,NOR,2001.0,1,0,1
MLI,IND,2002.0,1,0,1
CYP,OMN,2010.0,1,0,1
CRI,NLD,2012.0,1,0,1
ECU,CHE,2021.0,3,0,3
SVN,MNE,2010.0,1,0,1
NZL,KWT,2019.0,1,0,1
TUN,COG,2007.0,1,0,1
NLD,GTM,2014.0,2,0,2
QAT,,2001.0,1,0,1
PER,UGA,2021.0,1,0,1
PRT,VNM,2014.0,1,0,1
CHL,AGO,2020.0,1,0,1
CMR,NGA,2010.0,2,0,2
CUB,CAN,2013.0,4,0,4
PYF,NCL,2008.0,1,0,1
LAO,,2005.0,1,0,1
ISR,BIH,2015.0,1,0,1
UKR,TKM,2014.0,1,0,1
DEU,ARM,1999.0,2,0,2
IDN,GHA,2010.0,1,0,1
ARM,AUS,2006.0,2,0,2
BDI,NLD,2010.0,1,0,1
POL,MKD,2003.0,1,0,1
PRI,ARG,2007.0,1,0,1
SRB,ZAF,2003.0,2,0,2
ERI,NAM,2013.0,1,0,1
GEO,AUT,2012.0,1,0,1
AUS,QAT,2008.0,2,0,2
FRA,ISL,2003.0,2,0,2
UZB,FRA,2005.0,2,0,2
PYF,MEX,2002.0,2,0,2
GBR,ALB,2005.0,1,0,1
CHN,LBN,2001.0,1,0,1
KHM,NOR,1998.0,1,0,1
PAN,GBR,2004.0,1,0,1
YEM,JPN,2013.0,1,0,1
IND,UGA,2013.0,1,0,1
NGA,USA,1998.0,2,0,2
NLD,ZAF,1999.0,4,0,4
GTM,USA,2006.0,5,0,5
LTU,TWN,2002.0,2,0,2
ABW,BEL,2016.0,1,0,1
LSO,ZAF,2012.0,2,0,2
ZAF,IRL,2006.0,1,0,1
PYF,AUS,2008.0,1,0,1
ARG,LUX,2012.0,1,0,1
GHA,HKG,2010.0,1,0,1
IRL,ROU,2014.0,1,0,1
TUR,BRA,2000.0,1,0,1
FIN,CMR,2021.0,2,0,2
NPL,MEX,2002.0,1,0,1
NGA,FRA,2011.0,1,0,1
ASM,,2017.0,2,0,2
SVK,THA,2015.0,1,0,1
GHA,ARE,2017.0,1,0,1
POL,EST,2010.0,1,0,1
UKR,FRA,2022.0,1,0,1
,SYC,2018.0,5,0,5
USA,NIC,2003.0,5,0,5
CHL,PAN,2008.0,1,0,1
AUS,PSE,2012.0,1,0,1
MTQ,GLP,2005.0,1,0,1
OMN,GUM,2010.0,1,0,1
GRC,KWT,2016.0,1,0,1
LBN,FIN,2014.0,1,0,1
MLT,CHE,2020.0,2,0,2
ESP,GAB,2016.0,1,0,1
FRA,PRY,2006.0,1,0,1
,FRO,2003.0,3,0,3
NCL,GBR,2003.0,1,0,1
KEN,UGA,2004.0,1,0,1
BFA,ZAF,1999.0,1,0,1
COD,FRA,2003.0,1,0,1
TZA,COD,2021.0,2,0,2
COG,ZWE,2017.0,2,0,2
BFA,NER,2002.0,1,0,1
JPN,LAO,2010.0,1,0,1
JPN,YEM,2016.0,1,0,1
THA,PHL,2006.0,1,0,1
RUS,GEO,2018.0,3,0,3
IND,AUT,2007.0,8,0,8
SAU,CYP,2005.0,1,0,1
DNK,ISR,2001.0,5,0,5
IRL,JOR,2014.0,1,0,1
SYR,PAK,2020.0,1,0,1
THA,BTN,2021.0,4,0,4
JOR,IND,2020.0,4,0,4
SWE,TUR,2000.0,2,0,2
PNG,MYS,2004.0,1,0,1
BHR,THA,2020.0,1,0,1
BIH,DEU,1997.0,1,0,1
HUN,KOR,2002.0,1,0,1
CUB,DOM,2021.0,2,0,2
,ASM,2005.0,1,0,1
AUS,BIH,2012.0,1,0,1
SAU,ITA,2000.0,1,0,1
CYP,HKG,2002.0,1,0,1
NZL,RUS,2005.0,3,0,3
CIV,USA,2010.0,3,0,3
DEU,PRY,2015.0,1,0,1
ECU,AUS,2005.0,1,0,1
ARG,ARE,2011.0,1,0,1
DEU,BIH,2006.0,2,0,2
POL,HUN,1998.0,3,0,3
TUR,PSE,2010.0,1,0,1
HRV,CAN,2022.0,1,0,1
,BMU,2006.0,2,0,2
CUB,YEM,2015.0,1,0,1
MYS,TUR,2021.0,10,0,10
,PLW,2005.0,2,0,2
TUN,SWE,2014.0,1,0,1
NLD,CUB,2011.0,1,0,1
OMN,CHN,2020.0,1,0,1
JOR,TUR,2015.0,3,0,3
IRN,LUX,2017.0,2,0,2
BTN,BGD,2017.0,1,0,1
OMN,LBN,2017.0,1,0,1
IRN,LUX,2019.0,3,0,3
ARG,NLD,2001.0,3,0,3
BRA,ISR,2003.0,2,0,2
KEN,GNQ,2018.0,1,0,1
JPN,TJK,2020.0,1,0,1
TUR,HUN,2011.0,3,0,3
BEL,MWI,2016.0,1,0,1
CMR,NGA,2017.0,1,0,1
IND,IRQ,2007.0,4,0,4
RUS,MNG,2012.0,1,0,1
UZB,KGZ,2016.0,1,0,1
DJI,MAR,2021.0,1,0,1
CHE,BOL,2010.0,1,0,1
USA,TZA,2000.0,1,0,1
HUN,IRL,2004.0,3,0,3
SVK,ZAF,2007.0,1,0,1
ESP,ECU,2000.0,1,0,1
BLR,BRA,2004.0,1,0,1
BEL,NGA,2009.0,1,0,1
KHM,BTN,2012.0,1,0,1
ITA,SDN,2004.0,1,0,1
FRA,MMR,2012.0,2,0,2
DNK,IDN,2001.0,1,0,1
UGA,IDN,2008.0,1,0,1
ECU,PHL,2014.0,1,0,1
FRA,MUS,2015.0,1,0,1
CAN,UZB,2019.0,1,0,1
DEU,NIC,2004.0,1,0,1
BGD,HKG,2014.0,3,0,3
IRQ,EGY,2013.0,2,0,2
HUN,BIH,2002.0,1,0,1
ECU,CAN,2009.0,1,0,1
LVA,USA,2000.0,2,0,2
NZL,WSM,2011.0,1,0,1
PAK,PHL,2013.0,1,0,1
LAO,NLD,2007.0,1,0,1
SAU,CYP,2002.0,1,0,1
NAM,AUS,2016.0,2,0,2
USA,IRQ,2004.0,1,0,1
AUT,BLR,1998.0,1,0,1
HUN,CHL,2013.0,2,0,2
KHM,NZL,2011.0,1,0,1
BHR,DEU,2013.0,2,0,2
,ASM,2002.0,3,0,3
LVA,UKR,2005.0,1,0,1
TUR,MYS,2010.0,1,0,1
HKG,ISR,2012.0,1,0,1
PRY,USA,2002.0,1,0,1
NZL,BWA,2004.0,1,0,1
ERI,USA,2006.0,2,0,2
FRA,BRB,2008.0,1,0,1
SVN,BIH,2012.0,1,0,1
CAN,CRI,2005.0,1,0,1
TWN,NLD,2002.0,1,0,1
PAK,IRL,2006.0,2,0,2
TUN,TZA,2016.0,1,0,1
GMB,BEN,2020.0,1,0,1
DEU,MOZ,2011.0,1,0,1
POL,NAM,2021.0,1,0,1
LKA,SGP,2017.0,1,0,1
YEM,USA,2018.0,1,0,1
SLV,BRA,2012.0,1,0,1
ESP,IRQ,2017.0,1,0,1
HND,CRI,2021.0,2,0,2
NGA,OMN,2004.0,1,0,1
PAN,BRA,2018.0,4,0,4
LBY,BRN,2018.0,1,0,1
KOR,MOZ,2002.0,1,0,1
GRC,SRB,2009.0,1,0,1
NOR,ROU,2012.0,1,0,1
LSO,,2008.0,1,0,1
JPN,KGZ,2013.0,2,0,2
ESP,IRQ,2019.0,2,0,2
TWN,EGY,2010.0,1,0,1
DEU,KNA,2016.0,1,0,1
PHL,IRL,2015.0,2,0,2
ISR,COL,2007.0,1,0,1
UKR,MEX,2004.0,2,0,2
TLS,,2020.0,8,0,8
IDN,POL,2018.0,1,0,1
AIA,,2016.0,1,0,1
POL,AUS,2000.0,1,0,1
JPN,FJI,2004.0,1,0,1
KOR,IRL,2007.0,1,0,1
GIB,,2006.0,1,0,1
UKR,CHN,2000.0,1,0,1
POL,SVN,2016.0,1,0,1
,THA,2020.0,4,0,4
PSE,JOR,1997.0,1,0,1
LTU,FRA,2000.0,3,0,3
TUR,NZL,2009.0,2,0,2
ESP,BGR,2006.0,3,0,3
PAK,AFG,2009.0,1,0,1
SDN,MYS,1999.0,1,0,1
MLI,BRA,2010.0,1,0,1
BLR,VNM,2016.0,1,0,1
ARE,PSE,2010.0,1,0,1
DEU,TTO,2007.0,1,0,1
DEU,ZMB,2014.0,1,0,1
CUB,ZAF,2005.0,1,0,1
BWA,KEN,2016.0,1,0,1
HKG,NOR,2011.0,2,0,2
DNK,QAT,2019.0,1,0,1
BEN,MTQ,2012.0,1,0,1
NLD,BEN,2019.0,2,0,2
MEX,CZE,1998.0,1,0,1
CHE,BOL,2019.0,1,0,1
CHN,BLR,2003.0,1,0,1
NLD,JOR,2008.0,1,0,1
VNM,VEN,2010.0,1,0,1
ROU,KAZ,2016.0,1,0,1
GBR,MNG,2019.0,1,0,1
UGA,NZL,2014.0,1,0,1
UZB,SWE,1997.0,1,0,1
MEX,EGY,2020.0,4,0,4
MAR,ITA,2018.0,2,0,2
NLD,IRQ,2017.0,1,0,1
BRB,DEU,2006.0,1,0,1
PRI,NOR,2002.0,1,0,1
ISL,AUT,2004.0,1,0,1
NLD,CUW,2022.0,1,0,1
GRC,IRN,2010.0,1,0,1
CAN,MNG,2016.0,1,0,1
CHN,BDI,2010.0,1,0,1
AUT,MDA,2013.0,1,0,1
CMR,PAK,2017.0,1,0,1
BTN,CHE,2020.0,1,0,1
NGA,TWN,2021.0,2,0,2
CYP,IRL,2012.0,2,0,2
SLV,GTM,2015.0,1,0,1
RWA,AUS,2022.0,1,0,1
BGD,ZAF,2002.0,1,0,1
IDN,ITA,2003.0,1,0,1
LBN,DZA,2019.0,1,0,1
DEU,LVA,2022.0,2,0,2
CAN,NCL,2015.0,1,0,1
MCO,QAT,2014.0,1,0,1
FRA,PHL,2018.0,4,0,4
BDI,NLD,2019.0,1,0,1
ETH,NGA,2006.0,1,0,1
AUT,MAC,2008.0,1,0,1
NAM,TZA,2015.0,1,0,1
KWT,BHR,2018.0,1,0,1
USA,TCD,2022.0,1,0,1
REU,ITA,2018.0,1,0,1
GBR,PNG,2011.0,1,0,1
USA,SYC,2011.0,1,0,1
IRL,BGD,2015.0,1,0,1
ZWE,IND,2020.0,2,0,2
IRL,IRN,2002.0,1,0,1
PER,DNK,2013.0,1,0,1
KOR,ETH,2007.0,1,0,1
TWN,BEL,2005.0,1,0,1
PAN,AUS,2020.0,1,0,1
UZB,LKA,2012.0,1,0,1
PAK,UKR,2018.0,1,0,1
BEL,CRI,2015.0,1,0,1
ZAF,GAB,2008.0,1,0,1
BRA,LBN,2022.0,1,0,1
GRC,BRA,2009.0,1,0,1
GHA,CHN,2008.0,1,0,1
JOR,ETH,2014.0,1,0,1
NOR,TWN,2017.0,1,0,1
CAN,MAR,1997.0,1,0,1
AUT,LIE,2011.0,2,0,2
UGA,GMB,2018.0,1,0,1
CAN,CYP,1998.0,1,0,1
CMR,CHN,2009.0,1,0,1
MDA,GBR,2016.0,1,0,1
RWA,COG,2002.0,1,0,1
GBR,GTM,2004.0,1,0,1
LKA,SYR,2017.0,1,0,1
ISR,PAK,2015.0,1,0,1
ATG,IND,2010.0,1,0,1
NLD,LBY,2012.0,1,0,1
ETH,EGY,2014.0,2,0,2
FRA,CYP,2008.0,1,0,1
ALB,CHE,2018.0,1,0,1
ZAF,THA,2021.0,1,0,1
GHA,NOR,2012.0,1,0,1
HRV,QAT,2004.0,1,0,1
ITA,SYR,2019.0,1,0,1
SAU,KGZ,2019.0,1,0,1
CHE,MAC,2022.0,1,0,1
POL,LVA,2013.0,1,0,1
TGO,ETH,2018.0,1,0,1
AUT,KAZ,2020.0,1,0,1
HUN,TWN,2020.0,1,0,1
CHL,PRI,2018.0,1,0,1
LBY,LBN,2019.0,1,0,1
ROU,NZL,2020.0,1,0,1
IDN,ARE,2017.0,1,0,1
DNK,PER,2017.0,1,0,1
CZE,SVN,2013.0,1,0,1
ECU,BRA,2008.0,1,0,1
CHE,FJI,2015.0,1,0,1
KWT,TUN,2021.0,1,0,1
IRN,ARM,2020.0,1,0,1
EST,MEX,2013.0,1,0,1
USA,BFA,2005.0,1,0,1
ECU,,2025.0,1,0,1
YEM,EGY,2000.0,1,0,1
HUN,KOR,2005.0,1,0,1
AZE,BEL,2020.0,1,0,1
BGD,ESP,2006.0,1,0,1
IRN,IND,1998.0,1,0,1
ETH,NZL,2018.0,1,0,1
LTU,BEL,2022.0,1,0,1
VUT,NCL,2007.0,1,0,1
NOR,ETH,2006.0,1,0,1
PSE,DEU,2004.0,1,0,1
GBR,LSO,2005.0,1,0,1
NLD,NGA,2005.0,1,0,1
CZE,PRT,2003.0,1,0,1
MYS,LBY,2005.0,1,0,1
ARM,KOR,2006.0,1,0,1
UZB,TUR,2001.0,1,0,1
SVK,ROU,2001.0,1,0,1
RUS,VEN,2000.0,1,0,1
SEN,POL,2019.0,1,0,1
TUN,FIN,2009.0,1,0,1
BEL,CIV,1998.0,1,0,1
SOM,,2013.0,1,0,1
MAR,HUN,2009.0,1,0,1
QAT,JPN,2007.0,1,0,1
IDN,TUR,2020.0,1,0,1
ZMB,BEL,2015.0,1,0,1
HUN,BGD,2015.0,1,0,1
MEX,IRN,2017.0,1,0,1
BIH,EGY,2013.0,1,0,1
AUT,ARE,2022.0,1,0,1
FJI,SGP,2010.0,1,0,1
ARE,THA,2013.0,1,0,1
FLK,AUS,2015.0,1,0,1
BGR,SAU,2002.0,1,0,1
EGY,KOR,2005.0,1,0,1
JAM,BWA,2010.0,1,0,1
NPL,MYS,2015.0,1,0,1
FIN,MDA,2011.0,2,0,2
BEL,DNK,2000.0,2,0,2
FIN,KAZ,2018.0,1,0,1
ITA,PRI,1999.0,1,0,1
FIN,NAM,2006.0,1,0,1
UKR,SAU,2011.0,1,0,1
BWA,NLD,2006.0,1,0,1
BGR,SRB,2006.0,1,0,1
KEN,IDN,2021.0,1,0,1
ITA,COG,2016.0,1,0,1
FJI,MHL,2018.0,1,0,1
BRA,LKA,2010.0,1,0,1
URY,CZE,2011.0,1,0,1
AUS,BHR,2012.0,1,0,1
ITA,BHR,2020.0,1,0,1
HND,MEX,2015.0,1,0,1
JPN,NIC,2019.0,1,0,1
COD,CHN,2019.0,1,0,1
DNK,BGD,2015.0,1,0,1
CAN,MLT,2018.0,1,0,1
LSO,UGA,2015.0,1,0,1
UGA,THA,2018.0,1,0,1
HUN,GBR,2006.0,22,17,5
SVK,CHE,2018.0,5,2,3
THA,KOR,2020.0,8,19,-11
DEU,ARM,2019.0,2,2,0
DNK,AUS,2003.0,12,11,1
SGP,RUS,2003.0,3,1,2
USA,UKR,1997.0,7,10,-3
CHE,HUN,2007.0,5,10,-5
PRT,ITA,2019.0,29,32,-3
BEL,ISR,2003.0,3,4,-1
PER,CHL,2002.0,2,1,1
BGR,RUS,2017.0,2,3,-1
PER,ARG,2008.0,1,1,0
ESP,UKR,2009.0,2,2,0
LKA,CAN,2004.0,1,2,-1
DZA,ESP,2018.0,3,6,-3
DEU,ARM,2010.0,1,4,-3
MYS,GHA,2021.0,3,1,2
NPL,GBR,2005.0,2,1,1
AUT,ROU,2020.0,3,3,0
BWA,ZWE,2014.0,1,1,0
PAK,NPL,2021.0,1,1,0
CYP,USA,2005.0,3,20,-17
SVN,CZE,2019.0,2,1,1
BLR,KAZ,2016.0,1,1,0
NLD,SGP,2002.0,2,1,1
ESP,DNK,2016.0,43,17,26
CAN,ISR,2006.0,12,56,-44
ARG,DEU,2014.0,20,23,-3
USA,ISR,2004.0,190,346,-156
MTQ,FRA,2020.0,19,10,9
GBR,ITA,2000.0,64,70,-6
SAU,DEU,2016.0,9,29,-20
FIN,SWE,2021.0,53,46,7
ECU,USA,2012.0,13,20,-7
DEU,QAT,2015.0,8,3,5
PER,ESP,2007.0,7,8,-1
USA,ZWE,2003.0,7,5,2
ZAF,AUS,2003.0,34,13,21
VEN,ITA,2017.0,1,1,0
HRV,IRL,2021.0,2,1,1
GIN,GNQ,2019.0,1,8,-7
PRT,CZE,2009.0,2,2,0
JPN,BGD,2001.0,14,11,3
PAN,DEU,2015.0,3,1,2
QAT,PSE,2019.0,1,1,0
BEN,NLD,2007.0,1,1,0
KWT,HRV,2019.0,2,1,1
ITA,AUS,1997.0,4,1,3
OMN,ZAF,2010.0,1,1,0
SAU,ETH,2019.0,1,1,0
THA,LKA,2021.0,1,1,0
CHE,KEN,2013.0,1,3,-2
MYS,KAZ,2019.0,1,1,0
AUS,BTN,2018.0,1,2,-1
TWN,VNM,2021.0,29,15,14
USA,GEO,2005.0,13,7,6
USA,SWE,2017.0,214,220,-6
MEX,ESP,2014.0,84,155,-71
USA,POL,2015.0,85,138,-53
CHE,THA,2015.0,3,3,0
AUT,FRA,2008.0,22,24,-2
GBR,UGA,2022.0,8,7,1
KWT,AUS,2019.0,3,8,-5
QAT,SAU,2009.0,1,3,-2
KWT,AUS,2017.0,1,4,-3
TWN,THA,2013.0,3,3,0
COL,USA,1999.0,8,10,-2
EST,USA,2022.0,3,4,-1
HRV,ITA,2014.0,2,3,-1
TWN,ITA,2016.0,3,7,-4
BEL,SEN,2018.0,2,1,1
NPL,JPN,2003.0,2,3,-1
ZAF,LBN,2007.0,1,1,0
BGD,GBR,1997.0,1,1,0
PAK,BEL,2021.0,3,5,-2
SGP,GBR,1999.0,6,16,-10
CUB,DOM,2020.0,2,1,1
MEX,ESP,2004.0,54,70,-16
BRA,PRT,2011.0,69,75,-6
DEU,PRT,2019.0,30,47,-17
CHN,HKG,2010.0,291,316,-25
CHE,LVA,2017.0,1,3,-2
USA,COL,2002.0,30,31,-1
GBR,KEN,2006.0,6,11,-5
MEX,CHL,2021.0,19,4,15
HRV,BIH,2018.0,3,10,-7
EST,USA,2016.0,6,2,4
BEL,POL,2017.0,11,11,0
USA,GHA,2016.0,25,12,13
IRQ,AUS,2013.0,4,3,1
CHE,HUN,2008.0,7,13,-6
GHA,USA,2022.0,17,13,4
COL,VEN,2013.0,2,12,-10
DEU,IDN,2014.0,12,12,0
KWT,AUS,2018.0,3,4,-1
FRA,GRC,2009.0,20,24,-4
KEN,IND,2003.0,4,3,1
BEL,LUX,2009.0,6,3,3
SWE,ARG,2001.0,3,5,-2
CHE,AUS,1997.0,1,2,-1
MYS,IDN,2005.0,2,5,-3
BDI,BEL,2014.0,1,1,0
USA,TWN,2011.0,288,255,33
KEN,GBR,2021.0,14,26,-12
ITA,TUR,1999.0,3,1,2
ITA,DEU,2016.0,296,176,120
COL,GBR,2013.0,17,9,8
GRC,USA,2021.0,76,48,28
MEX,ESP,2020.0,137,142,-5
FIN,DEU,2011.0,42,29,13
AUS,KOR,2022.0,25,17,8
NAM,ZAF,2015.0,6,7,-1
AUS,DEU,2019.0,132,165,-33
HUN,CHE,2007.0,10,5,5
USA,COL,2007.0,45,48,-3
NGA,SAU,2021.0,8,5,3
NPL,USA,2016.0,26,16,10
FRA,TWN,2004.0,7,5,2
LUX,DNK,2020.0,1,1,0
USA,VEN,2017.0,11,28,-17
BRA,DNK,2019.0,15,12,3
EST,LTU,2019.0,2,1,1
IND,RUS,2002.0,2,9,-7
PAK,MEX,2018.0,1,1,0
IRL,CHL,2019.0,2,1,1
SWE,GRC,2007.0,7,5,2
SWE,GBR,1997.0,5,13,-8
IRL,CHL,2017.0,2,1,1
ZAF,ETH,2007.0,3,1,2
NLD,ROU,2003.0,1,4,-3
MUS,CHE,2018.0,1,1,0
NZL,ARG,2007.0,1,2,-1
PRT,CUB,2010.0,2,1,1
USA,JPN,2003.0,1097,1297,-200
PHL,JPN,2018.0,21,13,8
MYS,GBR,2020.0,85,103,-18
CHN,SWE,2012.0,52,55,-3
SGP,JPN,2002.0,11,14,-3
NGA,USA,2017.0,50,31,19
CAN,ISR,2022.0,20,23,-3
DEU,GRC,2014.0,48,73,-25
BGD,PRT,2019.0,1,1,0
BEL,FRA,1997.0,23,27,-4
MYS,DEU,2007.0,5,3,2
USA,EST,2016.0,2,6,-4
MAR,DEU,2022.0,4,2,2
USA,HRV,2012.0,13,19,-6
TWN,VNM,2011.0,5,1,4
NOR,CHL,2018.0,1,4,-3
LVA,EST,2018.0,3,3,0
ITA,KOR,2010.0,5,8,-3
BRA,CHN,2007.0,1,4,-3
HUN,IRL,2021.0,3,1,2
KAZ,MYS,2019.0,1,1,0
AUS,CHE,2002.0,31,29,2
TWN,USA,2019.0,234,209,25
FRA,AUT,2005.0,20,21,-1
SWE,GRC,2013.0,6,22,-16
JPN,USA,2004.0,1149,905,244
PRI,USA,2000.0,17,11,6
MYS,IDN,2013.0,49,15,34
ARG,ESP,2011.0,78,74,4
TWN,CAN,2001.0,4,7,-3
CHL,BRA,2022.0,11,10,1
NLD,KEN,2009.0,3,1,2
PHL,SGP,2013.0,7,3,4
MAC,CHN,2012.0,4,20,-16
IND,IRN,2003.0,7,2,5
HRV,JPN,2003.0,1,1,0
ISR,JPN,2013.0,3,7,-4
SWE,ISR,2011.0,2,6,-4
USA,BLR,2019.0,1,4,-3
IDN,MYS,2005.0,5,2,3
ESP,HUN,2007.0,2,4,-2
KOR,NPL,2012.0,2,5,-3
LAO,AUS,2011.0,1,1,0
IRL,CHN,2020.0,20,23,-3
BLR,GBR,2008.0,4,1,3
AUS,IDN,2002.0,8,5,3
NLD,SGP,2007.0,3,6,-3
MTQ,FRA,2014.0,26,12,14
DNK,AUS,2012.0,26,22,4
NOR,DNK,2022.0,20,15,5
TWN,USA,2018.0,265,216,49
FIN,FRA,2020.0,16,26,-10
GRC,CAN,2017.0,16,10,6
CHE,POL,2018.0,20,22,-2
DNK,AUT,2021.0,12,11,1
DEU,CHE,2018.0,635,462,173
SWE,HKG,2019.0,3,2,1
CHE,NOR,2019.0,23,15,8
SWE,SGP,1999.0,3,2,1
FRA,CZE,2003.0,16,16,0
RUS,BEL,2008.0,10,10,0
DNK,CHN,2007.0,9,5,4
GRC,DEU,2001.0,15,21,-6
SVK,FRA,2017.0,3,3,0
LBN,CAN,2010.0,4,6,-2
ECU,AUS,2016.0,3,3,0
TWN,IRL,2019.0,1,1,0
UKR,BEL,2018.0,2,2,0
POL,IRL,2022.0,1,4,-3
QAT,NZL,2014.0,1,3,-2
PSE,QAT,2019.0,1,1,0
NZL,HKG,2002.0,5,2,3
IND,THA,2016.0,9,7,2
UZB,RUS,2022.0,2,1,1
ITA,SEN,2020.0,1,1,0
IRL,ESP,2016.0,17,38,-21
GBR,PRT,2020.0,88,87,1
CAN,IRL,2021.0,42,29,13
CUB,BRA,2020.0,11,1,10
CAN,IRN,2017.0,73,262,-189
KEN,JPN,2008.0,7,1,6
CHL,USA,2003.0,54,63,-9
NOR,CHN,2022.0,16,15,1
ALB,USA,2017.0,1,1,0
ESP,DNK,2010.0,21,13,8
CZE,ARG,2019.0,2,3,-1
NLD,CYP,2017.0,3,3,0
LVA,USA,2020.0,2,2,0
JPN,IRL,2006.0,5,4,1
KOR,RUS,2008.0,7,13,-6
ECU,DEU,2014.0,1,6,-5
COL,BRA,2001.0,2,5,-3
TTO,CAN,2010.0,1,1,0
PRT,PAK,2021.0,2,1,1
AUT,FRA,1999.0,11,2,9
BEN,NGA,2007.0,3,3,0
MEX,CRI,2020.0,3,3,0
CAN,ZAF,2012.0,17,11,6
USA,CHE,2004.0,377,296,81
USA,IRL,2019.0,113,145,-32
GRC,GBR,2018.0,204,166,38
CHL,DEU,2015.0,29,41,-12
FRA,BEL,2004.0,125,106,19
QAT,AUS,2019.0,15,9,6
UKR,ESP,1999.0,2,1,1
ARG,CAN,2021.0,10,7,3
GBR,BGD,1997.0,1,1,0
UKR,ITA,2018.0,4,3,1
USA,NGA,2006.0,15,14,1
DEU,PAK,2010.0,17,11,6
LKA,IND,2018.0,6,7,-1
SAU,CHE,2020.0,2,8,-6
ITA,HRV,2001.0,3,1,2
ESP,POL,2003.0,6,7,-1
JPN,ISR,2005.0,4,3,1
LKA,CAN,2012.0,2,2,0
MKD,SRB,2006.0,10,3,7
EGY,QAT,2021.0,6,10,-4
PRT,BEL,2004.0,5,3,2
HUN,BLR,2001.0,1,1,0
SAU,EGY,1998.0,5,4,1
ARE,OMN,2003.0,1,1,0
HUN,DNK,2007.0,2,1,1
AUS,MNG,2017.0,1,1,0
FRA,GTM,2016.0,1,1,0
NGA,PAK,2020.0,1,2,-1
MYS,KWT,2016.0,2,1,1
FIN,JPN,2015.0,8,12,-4
USA,CMR,2011.0,2,8,-6
BEL,BDI,2014.0,1,1,0
DEU,CHE,2006.0,507,252,255
NZL,AUS,2012.0,151,86,65
DNK,BEL,2016.0,21,14,7
DNK,ESP,2019.0,27,41,-14
GBR,NLD,1997.0,11,14,-3
JPN,SVK,2009.0,1,1,0
GUF,FRA,2020.0,13,22,-9
NLD,HUN,2019.0,12,9,3
NLD,GRC,2017.0,16,25,-9
MEX,BRA,2012.0,7,6,1
KEN,COL,2020.0,1,1,0
POL,DNK,2004.0,4,4,0
TUR,DEU,2007.0,31,18,13
ARG,CHE,2010.0,7,3,4
BRA,URY,2003.0,4,5,-1
GAB,USA,2015.0,2,2,0
ARG,VEN,2010.0,1,3,-2
FRA,CRI,2007.0,1,2,-1
PAK,THA,2012.0,2,7,-5
CHL,NLD,2009.0,2,1,1
OMN,JPN,2018.0,1,1,0
MYS,FRA,2010.0,3,7,-4
IRL,GHA,2020.0,1,1,0
CHL,PER,2002.0,1,2,-1
KWT,SAU,1999.0,1,3,-2
MYS,THA,2007.0,1,1,0
CHE,BEL,2019.0,37,70,-33
AUS,SRB,2020.0,1,1,0
NLD,GRC,2018.0,21,20,1
PRT,BRA,2021.0,91,127,-36
USA,GRC,2007.0,117,85,32
GHA,USA,2019.0,37,38,-1
IRN,FIN,2016.0,12,12,0
EST,USA,2018.0,5,4,1
BRA,SRB,2002.0,2,1,1
DEU,ZAF,2012.0,32,22,10
CHE,TWN,2005.0,2,2,0
MEX,GBR,1997.0,1,1,0
IDN,SGP,2008.0,2,1,1
MAR,CAN,2006.0,2,6,-4
ESP,DZA,2011.0,1,1,0
BRA,CUB,2003.0,5,4,1
BEN,NGA,2008.0,2,3,-1
JPN,CMR,2010.0,1,1,0
JOR,CHN,2015.0,1,2,-1
GHA,JPN,2011.0,1,3,-2
LUX,ESP,2014.0,4,5,-1
KAZ,ITA,2018.0,2,2,0
FRA,ITA,2021.0,264,242,22
TUN,SAU,2018.0,86,32,54
MYS,SAU,2022.0,14,9,5
NGA,USA,2016.0,53,37,16
USA,HRV,2004.0,22,14,8
NOR,ISL,2008.0,2,3,-1
CAN,CHL,2010.0,11,7,4
BRA,CUB,2012.0,2,7,-5
AUS,AUT,2018.0,18,14,4
IND,ERI,2009.0,5,1,4
DEU,IDN,2003.0,5,1,4
ZAF,TUR,2010.0,1,1,0
CAN,BWA,2001.0,1,1,0
AUT,GBR,1997.0,3,3,0
BFA,TGO,2011.0,1,1,0
AUT,GBR,1998.0,5,7,-2
SWE,ISR,2009.0,1,2,-1
CAN,ISR,2018.0,53,51,2
LKA,HKG,2019.0,1,3,-2
SRB,MKD,2018.0,2,5,-3
GBR,LKA,2003.0,11,4,7
BGD,GBR,2013.0,13,11,2
KOR,RUS,2002.0,13,24,-11
USA,SYR,2019.0,3,7,-4
ETH,SWE,2015.0,1,3,-2
ITA,DEU,2010.0,221,131,90
ESP,ARG,2009.0,74,67,7
ITA,DEU,2019.0,307,214,93
AUS,AUT,2017.0,22,32,-10
COL,PAN,2012.0,2,3,-1
MEX,NLD,2016.0,13,9,4
FRA,IRQ,2019.0,14,1,13
LBY,GBR,2019.0,3,16,-13
ZAF,GHA,2021.0,20,8,12
FRA,GRC,2021.0,24,22,2
USA,EST,2018.0,4,5,-1
CHE,IND,2012.0,18,38,-20
ITA,KOR,2022.0,5,3,2
OMN,GBR,2013.0,5,12,-7
DNK,POL,2001.0,4,3,1
GBR,TTO,2009.0,4,2,2
NLD,MYS,2005.0,2,2,0
FIN,ZAF,2014.0,4,1,3
POL,BLR,2005.0,2,4,-2
NGA,PAK,2015.0,2,1,1
FRA,SRB,2014.0,2,3,-1
SGP,ZAF,2005.0,1,1,0
AUS,IDN,1997.0,1,1,0
SVN,NOR,2019.0,2,1,1
CAN,SVK,2017.0,1,1,0
FRA,GBR,2018.0,502,410,92
KHM,USA,2014.0,4,3,1
SGP,RUS,2015.0,4,2,2
SWE,DNK,2011.0,77,58,19
CHE,DEU,2017.0,422,632,-210
IRN,AUS,2017.0,167,41,126
FRA,ROU,2022.0,9,8,1
CHE,BRA,2003.0,10,10,0
FRA,CIV,2003.0,28,16,12
AUS,CAN,2003.0,99,83,16
HUN,ITA,2007.0,6,4,2
ARE,IND,2009.0,3,15,-12
GBR,CHN,1999.0,22,45,-23
SVK,JPN,2009.0,1,1,0
FRA,ARE,2018.0,13,10,3
KOR,PHL,2008.0,1,1,0
ZAF,CHE,2004.0,2,2,0
LKA,OMN,2017.0,1,1,0
PHL,IND,2002.0,1,3,-2
PRT,RUS,2004.0,6,6,0
ESP,MOZ,2009.0,4,2,2
UKR,CAN,2008.0,4,4,0
AUS,ISR,1998.0,1,1,0
URY,MEX,2020.0,5,2,3
ARE,HRV,2017.0,1,2,-1
EGY,ZAF,2017.0,2,1,1
PHL,IND,2005.0,2,7,-5
ECU,AUS,2019.0,1,4,-3
SAU,ARE,1999.0,2,3,-1
HRV,BIH,2006.0,5,10,-5
PAK,DEU,2006.0,7,6,1
USA,TTO,2005.0,6,6,0
GRC,FRA,2011.0,44,34,10
HKG,USA,2012.0,129,135,-6
ITA,IND,2019.0,28,55,-27
IDN,IND,2018.0,4,4,0
SAU,USA,2015.0,81,144,-63
ITA,LBN,2017.0,1,4,-3
FRA,SEN,2018.0,37,27,10
SRB,JPN,2006.0,1,1,0
GBR,GMB,2003.0,11,6,5
OMN,EGY,2008.0,1,3,-2
TZA,KEN,2014.0,4,4,0
GHA,MYS,2021.0,1,3,-2
MTQ,FRA,2012.0,6,28,-22
UZB,RUS,2010.0,3,2,1
KWT,EGY,2005.0,2,7,-5
GEO,RUS,2007.0,2,6,-4
PAK,QAT,2016.0,6,3,3
PRT,CZE,2021.0,4,2,2
CHE,TWN,2008.0,2,6,-4
CHE,KHM,2009.0,1,1,0
GBR,BFA,2013.0,1,1,0
SVK,POL,2014.0,3,4,-1
LVA,FIN,2019.0,1,1,0
MKD,HRV,2007.0,1,1,0
THA,GBR,2019.0,43,77,-34
PRI,IND,2018.0,2,1,1
ISR,ESP,2013.0,6,7,-1
BEN,NGA,2002.0,1,2,-1
BEL,AUT,1997.0,1,1,0
BRA,NOR,2021.0,16,5,11
PRT,RUS,2014.0,1,5,-4
FIN,ITA,2015.0,14,13,1
ITA,ESP,2011.0,183,88,95
FRA,IND,2010.0,40,86,-46
AUS,DEU,2021.0,114,91,23
JOR,KWT,2018.0,5,3,2
CHL,AUS,2016.0,18,20,-2
CHE,AUT,2002.0,16,33,-17
ZAF,AUS,2002.0,29,20,9
ISL,GBR,2012.0,4,10,-6
POL,AUS,2002.0,6,4,2
NGA,IND,2010.0,2,3,-1
NLD,TUR,2020.0,15,34,-19
GBR,PHL,2016.0,6,2,4
ISL,DNK,2014.0,3,5,-2
PER,ESP,2012.0,7,12,-5
BEL,BGR,2021.0,4,3,1
SWE,PRT,2001.0,2,3,-1
DZA,PRT,2022.0,1,2,-1
ZAF,HKG,1999.0,2,1,1
BRA,POL,2002.0,1,1,0
ARG,USA,2019.0,101,66,35
PHL,IND,2014.0,2,6,-4
ISR,CHE,2017.0,18,17,1
ARG,USA,2018.0,85,74,11
JPN,ITA,1999.0,14,9,5
CHL,DEU,2008.0,21,23,-2
LBN,BEL,2021.0,7,2,5
SGP,MYS,2008.0,14,11,3
JOR,DEU,2020.0,9,8,1
HKG,SGP,2002.0,21,8,13
UGA,NOR,2012.0,4,5,-1
BWA,MWI,2004.0,1,2,-1
IND,CHE,1998.0,1,2,-1
NZL,ISR,2001.0,1,1,0
SWE,ARE,2018.0,3,3,0
TUN,DZA,2015.0,2,5,-3
MOZ,ESP,2009.0,2,4,-2
SWE,ETH,2007.0,2,2,0
FRA,GUY,2012.0,1,1,0
BHR,NZL,2019.0,1,1,0
KAZ,USA,2001.0,1,1,0
SOM,USA,2014.0,1,1,0
AUT,GRC,2012.0,4,5,-1
PHL,DEU,2011.0,3,5,-2
HUN,SVN,2021.0,1,1,0
CHE,URY,2015.0,1,1,0
USA,CHE,2008.0,394,387,7
USA,TWN,2018.0,216,265,-49
CHE,PRT,2019.0,14,17,-3
NGA,ZAF,2016.0,70,54,16
FRA,CHE,2001.0,145,123,22
ESP,DNK,2009.0,14,10,4
POL,ESP,2022.0,13,9,4
DNK,GNB,2010.0,3,4,-1
TUR,DEU,2004.0,16,16,0
HKG,USA,1998.0,18,30,-12
USA,LKA,2020.0,24,17,7
POL,BEL,2016.0,8,12,-4
ZAF,NLD,2007.0,9,10,-1
HKG,USA,1997.0,7,16,-9
URY,MEX,2008.0,1,1,0
PER,FRA,2008.0,8,7,1
VEN,GBR,2001.0,4,5,-1
DZA,MAR,2013.0,3,5,-2
BEL,ECU,2010.0,1,1,0
COG,COD,2011.0,5,11,-6
USA,TWN,2010.0,337,244,93
GRC,DEU,2008.0,28,37,-9
EST,FIN,2021.0,5,12,-7
AUS,IRL,2001.0,21,10,11
SAU,USA,2002.0,28,33,-5
ZAF,USA,2009.0,70,52,18
TUR,DEU,2014.0,39,39,0
USA,PRT,2014.0,56,64,-8
AUS,CHN,2006.0,66,61,5
RUS,AUS,2001.0,12,2,10
UGA,TZA,2014.0,1,1,0
ESP,SGP,2013.0,12,7,5
PRT,BEL,2013.0,6,2,4
IND,SGP,1999.0,10,1,9
IRQ,FRA,2016.0,1,1,0
PRI,VEN,2010.0,2,1,1
USA,MLI,2007.0,1,2,-1
GIN,FRA,2009.0,4,2,2
COG,ZMB,2017.0,1,1,0
MYS,KHM,2018.0,1,3,-2
VNM,USA,2014.0,21,26,-5
CHE,CAN,2007.0,74,44,30
ITA,FIN,2008.0,9,6,3
CHE,AUT,2008.0,24,46,-22
IND,FRA,2017.0,123,71,52
HRV,GBR,2019.0,17,5,12
MEX,NLD,2011.0,13,9,4
COL,CHL,2014.0,21,19,2
JPN,PHL,2011.0,18,7,11
MAC,CHN,2008.0,6,8,-2
PER,DEU,2018.0,3,7,-4
CUB,MEX,1999.0,3,4,-1
GBR,OMN,1999.0,2,1,1
SAU,OMN,2014.0,4,5,-1
NLD,THA,2018.0,12,7,5
OMN,NGA,2019.0,1,1,0
IRN,POL,2022.0,16,3,13
NZL,ARE,2019.0,5,1,4
GRC,KOR,2015.0,4,3,1
BEL,BGR,2011.0,3,3,0
ITA,JOR,2021.0,2,1,1
POL,SVK,2004.0,2,2,0
JPN,MAC,2022.0,1,1,0
RUS,KAZ,2000.0,3,5,-2
MLI,FRA,2016.0,2,7,-5
POL,COL,2020.0,2,1,1
IND,NZL,2016.0,13,10,3
UZB,JPN,2002.0,1,1,0
NZL,UGA,2016.0,1,1,0
IRL,USA,2011.0,135,115,20
PRT,FRA,2020.0,36,40,-4
VNM,JPN,2011.0,9,35,-26
ESP,JPN,2010.0,20,17,3
ITA,ROU,2004.0,5,8,-3
UZB,RUS,2009.0,3,4,-1
ESP,MEX,1998.0,15,8,7
PHL,JPN,2011.0,7,18,-11
ISR,CAN,2010.0,54,30,24
SGP,JPN,2001.0,7,13,-6
ESP,JPN,2017.0,20,12,8
ITA,ARG,2010.0,13,9,4
ZAF,CHE,2008.0,7,5,2
RUS,AUS,2012.0,9,3,6
KEN,NLD,2019.0,6,8,-2
PRT,DEU,2022.0,15,11,4
DNK,EGY,2002.0,4,5,-1
GRC,FIN,2002.0,2,1,1
SWE,UKR,2017.0,2,5,-3
FRA,UKR,2008.0,4,12,-8
SAU,ETH,2021.0,2,1,1
EGY,JPN,2000.0,4,3,1
ISR,ZAF,2006.0,1,2,-1
ARG,PRT,2012.0,2,1,1
TWN,VNM,2019.0,49,18,31
KOR,PRT,2016.0,4,2,2
SAU,USA,2013.0,60,137,-77
MEX,CHL,2018.0,12,14,-2
PRT,CAN,2022.0,4,10,-6
CZE,IND,2014.0,6,19,-13
CHE,POL,2011.0,25,18,7
IND,MYS,2009.0,42,26,16
USA,LKA,2015.0,21,8,13
VNM,DEU,2011.0,3,10,-7
PRT,BEL,2002.0,4,3,1
GAB,USA,2002.0,2,2,0
USA,MOZ,2008.0,1,2,-1
GBR,TTO,2018.0,2,2,0
ISL,GBR,2001.0,3,2,1
DNK,POL,1998.0,5,1,4
TWN,NOR,2015.0,1,1,0
AUT,URY,2013.0,1,1,0
LKA,NLD,2010.0,2,3,-1
PER,ESP,2001.0,2,2,0
ZAF,RUS,2016.0,3,2,1
CHL,FIN,2022.0,1,1,0
PRT,ARG,2002.0,2,3,-1
MEX,UKR,2016.0,1,1,0
BEL,ARM,2014.0,1,1,0
AUS,PRT,2012.0,3,6,-3
JPN,LAO,2020.0,2,2,0
BEL,ESP,2010.0,43,35,8
NOR,CHE,2018.0,17,19,-2
POL,USA,2003.0,142,95,47
POL,BEL,2006.0,8,4,4
BEL,ESP,2019.0,53,85,-32
MEX,CHL,2017.0,24,18,6
DEU,TUR,2005.0,17,20,-3
CHN,CZE,2018.0,19,8,11
DOM,USA,2009.0,1,1,0
CHN,DNK,2005.0,7,7,0
HUN,JPN,2012.0,4,2,2
FRA,ETH,2006.0,1,2,-1
ETH,KEN,2003.0,1,2,-1
BGD,IND,2003.0,9,7,2
AUT,GRC,2001.0,1,3,-2
FIN,ESP,2014.0,4,23,-19
OMN,GBR,2004.0,2,5,-3
ESP,CZE,2010.0,7,9,-2
SVK,FRA,2011.0,5,4,1
CHE,BRA,2007.0,5,7,-2
FJI,AUS,2004.0,4,6,-2
CHN,FRA,2001.0,25,15,10
CAN,NZL,2009.0,43,25,18
BRA,PER,2015.0,20,7,13
GRC,GBR,2011.0,137,144,-7
ECU,PER,2018.0,3,4,-1
SRB,USA,2021.0,14,3,11
GBR,BRA,2010.0,54,40,14
THA,JPN,2006.0,20,56,-36
BGR,ESP,2012.0,3,1,2
IRN,HKG,2014.0,3,2,1
CHN,CMR,2014.0,1,1,0
GHA,BEL,2007.0,2,1,1
CHE,CAN,1998.0,14,12,2
CHN,AUT,2013.0,11,16,-5
PSE,ISR,2019.0,10,16,-6
ISL,GBR,2014.0,3,6,-3
CHE,KEN,2015.0,1,3,-2
UKR,FIN,2000.0,1,1,0
PAK,THA,2008.0,1,1,0
LSO,ZAF,2019.0,3,8,-5
KOR,ITA,2009.0,5,4,1
NZL,AUS,2013.0,173,96,77
USA,POL,2007.0,82,105,-23
CHE,SRB,2016.0,3,3,0
USA,CHL,2015.0,112,109,3
BGD,JPN,2002.0,13,17,-4
AUT,SRB,2017.0,3,1,2
ITA,CYP,2021.0,1,2,-1
JPN,DNK,2016.0,8,7,1
AUS,IRQ,2014.0,2,2,0
GBR,VEN,1998.0,3,1,2
ITA,CHL,2003.0,3,3,0
USA,CMR,2019.0,4,7,-3
TZA,CHE,2012.0,4,1,3
HRV,TUR,2006.0,2,1,1
BEL,BEN,2012.0,3,2,1
SGP,EGY,2017.0,1,1,0
IRQ,IND,2019.0,1,14,-13
AUS,IDN,2004.0,10,5,5
USA,IDN,2009.0,27,11,16
JPN,SWE,2010.0,31,24,7
EGY,LBY,2015.0,2,3,-1
TWN,SWE,2014.0,1,2,-1
USA,TWN,2016.0,259,263,-4
BRA,PRT,2016.0,85,140,-55
POL,UKR,2017.0,15,30,-15
USA,RWA,2018.0,12,13,-1
ZAF,BWA,2019.0,15,5,10
SVN,CZE,2009.0,1,1,0
NGA,IRQ,2021.0,1,1,0
BRA,NOR,2018.0,13,6,7
KOR,KEN,2020.0,4,2,2
POL,BEL,2018.0,11,8,3
CHE,KOR,2020.0,15,18,-3
PAK,IRL,2020.0,12,9,3
KOR,RUS,2012.0,11,8,3
GBR,LBY,2016.0,5,5,0
IRL,CHN,2008.0,4,2,2
PRY,USA,2021.0,2,4,-2
GBR,EST,2013.0,5,9,-4
CHN,POL,2001.0,3,1,2
JPN,MNE,2004.0,1,1,0
CHE,KWT,2016.0,1,1,0
ARM,GBR,2017.0,1,1,0
AFG,IND,2019.0,1,3,-2
NPL,DEU,2004.0,1,1,0
SRB,AUS,1998.0,1,1,0
CHN,CMR,2015.0,1,3,-2
USA,COL,2020.0,89,125,-36
PAK,SAU,2013.0,70,12,58
CHL,ESP,2021.0,76,60,16
BGD,PAK,2015.0,13,5,8
GBR,KEN,2021.0,26,14,12
POL,BEL,2019.0,19,8,11
PHL,KOR,2015.0,5,9,-4
DNK,CAN,2008.0,16,24,-8
CHE,AUT,1998.0,7,5,2
FRA,PRT,1998.0,6,6,0
SVN,FRA,2014.0,4,5,-1
BRA,NOR,2017.0,4,6,-2
KOR,PAK,2013.0,14,20,-6
TUR,NLD,2005.0,8,6,2
IND,QAT,2015.0,10,5,5
SGP,KOR,2022.0,12,12,0
MEX,BRA,2007.0,7,8,-1
HKG,HUN,2002.0,1,1,0
ZAF,FRA,2012.0,13,26,-13
CAN,ZAF,2008.0,14,22,-8
POL,BEL,2010.0,11,8,3
ISR,SRB,2017.0,1,1,0
NPL,VNM,2019.0,1,1,0
UGA,TZA,2012.0,1,3,-2
PAK,SWE,2021.0,4,8,-4
CAN,LKA,2020.0,5,1,4
FJI,KOR,2010.0,2,1,1
ARG,FRA,1997.0,1,1,0
BWA,GBR,2020.0,2,2,0
ITA,ARM,2014.0,1,1,0
ARM,POL,2018.0,1,1,0
JPN,USA,2013.0,819,818,1
FIN,SWE,2016.0,73,43,30
SVK,CZE,2009.0,25,15,10
NZL,JOR,2008.0,1,1,0
ITA,AUS,2012.0,36,25,11
GRC,DEU,1998.0,7,8,-1
PAN,CAN,2010.0,3,3,0
EST,AUS,2018.0,3,2,1
RUS,AUS,2004.0,8,7,1
FRA,EST,2010.0,2,3,-1
HUN,NLD,2022.0,7,2,5
KEN,ITA,2008.0,3,2,1
NOR,ITA,2000.0,2,2,0
GRC,AUT,2003.0,4,3,1
CHE,KEN,2020.0,9,6,3
AUS,SVN,2010.0,1,1,0
CAN,BEN,2020.0,2,2,0
NGA,FIN,2007.0,1,1,0
DEU,BRA,2019.0,71,123,-52
DEU,BRA,2010.0,55,58,-3
CAN,RUS,2005.0,10,25,-15
PHL,THA,2008.0,1,2,-1
FRA,TUN,2016.0,120,64,56
BGR,USA,2002.0,26,8,18
ESP,USA,1998.0,76,84,-8
GBR,TUR,2007.0,23,14,9
JPN,CAN,2008.0,76,67,9
BEL,DEU,2019.0,107,105,2
IND,NPL,2017.0,34,12,22
AUS,RUS,1998.0,3,8,-5
EST,AUS,2019.0,2,2,0
RUS,NLD,2008.0,12,12,0
CZE,ESP,2009.0,9,5,4
CZE,FRA,2001.0,12,7,5
SGP,IND,2004.0,8,31,-23
ISR,CYP,2019.0,1,1,0
MLI,FRA,2017.0,2,7,-5
PRT,THA,2017.0,2,1,1
KAZ,SAU,2022.0,1,1,0
CHE,ETH,2010.0,2,1,1
SDN,SAU,2006.0,3,4,-1
SAU,KWT,2002.0,3,2,1
RUS,NGA,2017.0,3,3,0
ESP,BRA,2006.0,25,22,3
HRV,DEU,2010.0,11,14,-3
GRC,AUS,2019.0,10,5,5
EGY,DEU,2003.0,13,31,-18
FRA,GLP,2001.0,3,12,-9
AUT,CHE,2003.0,33,20,13
ARG,BRA,2022.0,9,10,-1
PRT,CUB,2009.0,1,1,0
BEL,VNM,2015.0,16,3,13
UGA,KEN,2010.0,2,5,-3
SWE,EST,2007.0,5,5,0
ITA,FIN,1999.0,5,2,3
KOR,POL,2009.0,3,1,2
URY,GBR,2004.0,2,1,1
HUN,JPN,2004.0,3,4,-1
CMR,NER,2009.0,1,1,0
DEU,LVA,2020.0,1,2,-1
NZL,EST,2019.0,1,1,0
ESP,ISL,2019.0,1,2,-1
DEU,PSE,2005.0,1,2,-1
FRA,BGD,2014.0,1,1,0
IRN,IRQ,2016.0,7,2,5
ESP,MEX,2002.0,59,40,19
ARG,BRA,2016.0,40,24,16
NZL,SWE,2020.0,8,7,1
NPL,KOR,2020.0,4,13,-9
TWN,THA,2020.0,16,9,7
GHA,USA,2021.0,20,18,2
AUS,ITA,2004.0,17,18,-1
CAN,ZAF,2002.0,12,17,-5
GRC,IND,2013.0,2,1,1
FRA,ISL,2019.0,3,3,0
MEX,RUS,2003.0,8,12,-4
CHN,THA,2008.0,3,4,-1
GBR,ZWE,2001.0,4,3,1
IDN,DEU,2004.0,2,2,0
AUS,NCL,2010.0,1,2,-1
BEL,SAU,2022.0,1,3,-2
PAK,DNK,2022.0,2,2,0
MEX,USA,2012.0,152,175,-23
BRA,ESP,2008.0,45,33,12
BRA,DEU,2020.0,141,58,83
CHE,ISR,2019.0,22,18,4
FRA,GUF,2016.0,27,17,10
ITA,CZE,2018.0,29,20,9
MEX,ECU,2022.0,1,8,-7
MTQ,FRA,2022.0,3,7,-4
LTU,USA,2009.0,5,5,0
CAN,TWN,2003.0,14,6,8
KEN,LKA,2009.0,1,1,0
BRA,SWE,2003.0,9,9,0
NLD,ZAF,2003.0,9,9,0
DEU,BWA,2016.0,1,1,0
IND,BHR,2021.0,4,2,2
ITA,POL,2001.0,9,14,-5
THA,KOR,2016.0,8,15,-7
ESP,FIN,2022.0,13,2,11
ISL,FIN,2020.0,1,2,-1
ROU,BGR,2016.0,1,2,-1
GRC,FRA,1999.0,3,13,-10
AUT,THA,2004.0,2,2,0
NLD,OMN,2010.0,3,1,2
TZA,CAN,2011.0,1,2,-1
CHN,KEN,2008.0,2,2,0
IND,SAU,2014.0,123,25,98
USA,LBY,2019.0,2,1,1
MTQ,FRA,2016.0,22,14,8
IND,GBR,2009.0,126,97,29
ARG,USA,2005.0,149,73,76
PRT,RUS,2018.0,4,4,0
DEU,SVK,1997.0,5,1,4
BRA,NLD,2018.0,38,19,19
BEL,DNK,2017.0,15,13,2
THA,DEU,2014.0,21,20,1
ALB,ITA,2012.0,4,2,2
JPN,GHA,2002.0,1,2,-1
SAU,DEU,2020.0,18,29,-11
JPN,CZE,2002.0,9,3,6
IND,NOR,2014.0,6,10,-4
MEX,URY,2010.0,3,1,2
BGR,ROU,2016.0,2,1,1
SVK,ESP,2011.0,1,2,-1
CZE,RUS,2012.0,1,5,-4
FRA,ECU,2016.0,13,3,10
KEN,ZWE,2007.0,3,1,2
MYS,SGP,2018.0,17,15,2
THA,IRL,2014.0,1,1,0
CHL,ESP,2015.0,42,147,-105
CAN,PAK,2015.0,18,19,-1
LBR,USA,2021.0,3,1,2
PAK,USA,2012.0,74,53,21
FIN,DEU,2007.0,28,35,-7
USA,SGP,1997.0,6,4,2
BEL,COD,2021.0,12,6,6
USA,BWA,2007.0,4,8,-4
DEU,THA,2022.0,5,2,3
AUT,SGP,2009.0,4,2,2
TTO,JAM,2010.0,3,3,0
REU,FRA,2007.0,10,11,-1
KAZ,SGP,2017.0,2,2,0
AUT,CHL,2018.0,3,2,1
SWE,PER,2018.0,1,2,-1
CHN,EGY,2008.0,3,2,1
DNK,BEL,2001.0,3,5,-2
BLR,UKR,2013.0,1,1,0
ISR,UKR,2017.0,1,6,-5
QAT,HRV,2021.0,1,1,0
EST,CHE,2019.0,3,4,-1
THA,FIN,2018.0,1,1,0
PRT,DNK,1999.0,1,2,-1
ALB,TUR,2013.0,1,2,-1
SWE,LKA,2009.0,1,1,0
BEL,SEN,2001.0,1,1,0
LBY,IRL,2011.0,1,2,-1
MAC,JPN,2022.0,1,1,0
BRA,USA,2018.0,587,369,218
TUR,BEL,2010.0,7,6,1
SWE,USA,2018.0,257,245,12
JPN,CHL,2001.0,1,1,0
DNK,FRA,2009.0,23,26,-3
DEU,HKG,2019.0,15,27,-12
THA,FIN,2017.0,2,1,1
SVN,ESP,2017.0,7,3,4
SWE,ESP,2007.0,29,14,15
TUN,CAN,2008.0,5,6,-1
CAN,TUR,2003.0,3,7,-4
COD,USA,2016.0,1,2,-1
MYS,PSE,2016.0,8,2,6
MEX,AUS,2007.0,5,3,2
TUR,NGA,2019.0,6,2,4
AUS,PNG,2002.0,3,5,-2
PER,MEX,2009.0,2,3,-1
GBR,GMB,2006.0,5,7,-2
IRN,PRT,2017.0,9,6,3
HRV,AUT,2012.0,8,1,7
DNK,TWN,2018.0,1,2,-1
KEN,IND,2019.0,3,2,1
IND,TZA,2020.0,3,3,0
VEN,GBR,2011.0,1,3,-2
ITA,NGA,2021.0,4,4,0
KOR,GBR,2000.0,3,11,-8
KOR,MYS,2012.0,7,8,-1
ARE,USA,2004.0,5,15,-10
ISR,SGP,2010.0,3,2,1
AUT,CHL,2010.0,1,2,-1
ARE,RUS,2020.0,1,3,-2
USA,RUS,2009.0,112,166,-54
JOR,RUS,2010.0,1,2,-1
FRA,DZA,2004.0,27,17,10
ARG,USA,2013.0,87,95,-8
AUT,SWE,2016.0,24,20,4
IND,CHN,2021.0,109,114,-5
NOR,NLD,2020.0,15,23,-8
LUX,ESP,2019.0,8,11,-3
NOR,AUT,2019.0,13,14,-1
KAZ,KOR,2021.0,4,4,0
ESP,CHL,2010.0,55,44,11
ITA,GRC,2022.0,12,11,1
EGY,YEM,2012.0,5,6,-1
SAU,DZA,2015.0,1,1,0
JOR,QAT,2019.0,10,4,6
TUR,POL,2012.0,9,2,7
NLD,ROU,2017.0,3,5,-2
DNK,NZL,2011.0,5,4,1
DNK,COL,2020.0,2,3,-1
USA,QAT,2005.0,6,2,4
ITA,BGR,1999.0,2,5,-3
CHN,IRQ,2013.0,4,1,3
LUX,ESP,2010.0,1,3,-2
PRT,ISR,2009.0,1,2,-1
EGY,LBY,2011.0,2,7,-5
CHN,KEN,2005.0,1,2,-1
CHN,SGP,2002.0,82,35,47
NOR,AUT,2010.0,7,6,1
ZAF,ZWE,2007.0,2,19,-17
USA,SLV,2014.0,1,2,-1
PHL,KAZ,2017.0,1,3,-2
PSE,DEU,2013.0,4,4,0
HUN,USA,2003.0,62,67,-5
BEL,IND,2020.0,19,40,-21
RUS,BLR,2022.0,8,4,4
QAT,GBR,2017.0,16,37,-21
PRT,GBR,2001.0,23,27,-4
AUT,SWE,2022.0,5,6,-1
IRN,FRA,2010.0,13,27,-14
DEU,ARG,2020.0,18,29,-11
ESP,POL,2006.0,9,4,5
EST,DEU,2002.0,3,3,0
IRN,IND,2003.0,2,7,-5
HRV,BIH,2012.0,8,9,-1
PAK,AUT,2015.0,3,19,-16
IRL,SWE,1999.0,1,2,-1
THA,KOR,2006.0,3,2,1
CHE,PAK,2007.0,3,1,2
USA,LTU,2002.0,2,5,-3
NZL,IDN,2015.0,2,3,-1
ARG,AUS,2022.0,1,2,-1
GHA,CMR,2019.0,1,3,-2
CZE,SVN,2004.0,1,1,0
KAZ,NOR,2019.0,1,1,0
POL,PAK,2013.0,2,1,1
SWE,BOL,2022.0,1,2,-1
ZAF,CZE,2016.0,1,4,-3
PAK,MYS,2022.0,29,52,-23
CZE,CHE,2010.0,7,7,0
ARG,COL,2003.0,3,3,0
MYS,PAK,2020.0,149,50,99
GBR,SWE,2013.0,158,91,67
SWE,IRL,2017.0,13,10,3
IND,IRN,2019.0,9,2,7
CHN,BEL,2020.0,63,83,-20
FRA,RUS,2013.0,38,39,-1
BEL,KEN,2018.0,6,5,1
POL,NLD,2001.0,6,5,1
CAN,NLD,1999.0,10,8,2
ARG,POL,2002.0,1,1,0
SWE,IRL,2010.0,17,12,5
AUS,BRA,2005.0,11,11,0
CHN,HUN,2009.0,1,2,-1
FIN,LTU,2006.0,2,1,1
DEU,DZA,2022.0,1,3,-2
DZA,DEU,2012.0,2,1,1
YEM,MYS,2020.0,4,18,-14
SWE,IRL,2019.0,15,18,-3
SVN,AUS,2011.0,1,2,-1
FRA,MTQ,2015.0,19,21,-2
SWE,IRL,2018.0,12,10,2
ESP,CHN,2018.0,52,30,22
TWN,CAN,2019.0,16,10,6
BRN,GBR,2020.0,2,4,-2
ITA,IRL,2013.0,25,26,-1
SWE,ETH,2019.0,4,1,3
BEL,KOR,2007.0,2,3,-1
TUR,CZE,2014.0,3,2,1
DEU,LKA,2018.0,2,1,1
SAU,DEU,2014.0,5,23,-18
CZE,TUR,2016.0,4,2,2
CHE,KOR,2021.0,14,15,-1
MYS,KWT,2012.0,1,2,-1
TWN,DEU,2022.0,8,15,-7
IND,AUT,2004.0,4,1,3
NLD,CAN,2016.0,65,59,6
BRA,SWE,2012.0,9,11,-2
ISR,CHE,2007.0,7,5,2
IRL,FRA,2005.0,18,27,-9
FIN,THA,2004.0,2,1,1
ESP,AUS,2014.0,67,20,47
CAN,NLD,2005.0,24,35,-11
PAK,NGA,2019.0,1,4,-3
TUR,CAN,2017.0,26,16,10
MTQ,FRA,2019.0,30,16,14
JPN,PAK,2005.0,5,3,2
MCO,GBR,2017.0,1,1,0
IRL,FRA,2002.0,8,18,-10
DNK,PRT,2009.0,2,2,0
ARG,MEX,2020.0,13,16,-3
CHN,MEX,2020.0,8,4,4
AUT,ISR,2002.0,1,2,-1
CAN,BGD,2003.0,1,6,-5
AUT,BEL,2005.0,6,4,2
FRA,MRT,2017.0,3,1,2
LTU,DEU,2014.0,3,4,-1
ARE,KWT,2004.0,1,3,-2
ESP,BOL,2009.0,1,1,0
GBR,PRT,2016.0,73,122,-49
ZAF,SDN,2015.0,3,1,2
DEU,FIN,2009.0,24,42,-18
BRA,SWE,2020.0,35,5,30
KOR,DNK,2018.0,8,2,6
GHA,AUS,2018.0,19,11,8
CZE,CHN,2012.0,3,3,0
IND,DEU,2009.0,126,72,54
RUS,CZE,2021.0,17,4,13
ESP,DEU,2004.0,77,72,5
DEU,BEL,1999.0,31,16,15
USA,SGP,2002.0,84,119,-35
CAN,KWT,2010.0,7,5,2
PRT,RUS,2016.0,7,4,3
NGA,BRA,2011.0,1,1,0
JPN,BEL,2011.0,15,15,0
COG,BEL,2015.0,3,5,-2
DEU,SVN,2003.0,7,4,3
ALB,SRB,2011.0,3,1,2
GMB,GBR,2001.0,4,6,-2
USA,BHS,2007.0,1,1,0
MEX,ZWE,2015.0,1,1,0
AUS,SVN,2008.0,1,2,-1
IDN,IND,2012.0,1,2,-1
ARE,KWT,2014.0,1,2,-1
EGY,SWE,2002.0,1,1,0
FRA,GAB,2001.0,1,1,0
CAN,GBR,2020.0,366,400,-34
PAK,CAN,2018.0,29,24,5
BRA,USA,2022.0,253,139,114
AUS,MUS,2020.0,3,1,2
DEU,THA,2010.0,17,16,1
POL,NLD,2015.0,25,14,11
MEX,SWE,2007.0,3,1,2
NER,DEU,2004.0,1,1,0
AUS,JOR,2015.0,9,2,7
SWE,LUX,2021.0,4,1,3
MLT,USA,2018.0,1,2,-1
ITA,BGR,2005.0,4,5,-1
DNK,BEL,2020.0,16,17,-1
AUT,ECU,2018.0,1,2,-1
UKR,GBR,2009.0,10,8,2
GEO,DEU,2021.0,3,2,1
KOR,NZL,2012.0,2,3,-1
IND,HRV,2020.0,2,3,-1
CMR,FRA,1998.0,1,1,0
ITA,RUS,2021.0,17,16,1
TUR,POL,2020.0,6,3,3
ZAF,TZA,2017.0,8,3,5
POL,IND,2021.0,13,24,-11
FRA,GBR,2012.0,336,382,-46
ESP,NZL,2011.0,3,1,2
USA,SWE,2020.0,230,181,49
CHN,ITA,2010.0,20,16,4
AUT,MEX,2020.0,4,8,-4
LBY,IND,2013.0,2,5,-3
AUS,KEN,2005.0,1,2,-1
JPN,NLD,2017.0,22,22,0
COL,CAN,2013.0,13,9,4
TUN,ITA,2019.0,2,1,1
CHL,ARG,2017.0,16,13,3
TWN,FRA,2009.0,8,6,2
HKG,ESP,2016.0,5,1,4
BEL,COG,2017.0,7,5,2
PAK,OMN,2017.0,8,2,6
ROU,GBR,2007.0,10,10,0
PRT,EGY,2020.0,1,1,0
ESP,URY,2001.0,1,5,-4
TZA,USA,2003.0,2,12,-10
KHM,AUS,2014.0,1,4,-3
ARG,SWE,2004.0,3,3,0
USA,UZB,2007.0,1,3,-2
DEU,SEN,2002.0,1,1,0
NZL,GBR,1997.0,5,9,-4
ISR,UKR,2016.0,1,3,-2
KOR,POL,2014.0,2,8,-6
NOR,GBR,2014.0,40,71,-31
FRA,GBR,2003.0,304,324,-20
DEU,SAU,2010.0,27,1,26
GBR,LKA,2019.0,14,14,0
DEU,SAU,2017.0,36,13,23
TUR,DNK,2019.0,4,6,-2
NLD,USA,2008.0,242,265,-23
PRT,DNK,2002.0,3,6,-3
IND,KWT,2019.0,5,5,0
FRA,BEN,2005.0,7,6,1
ARG,AUS,2018.0,7,2,5
NOR,CAN,2017.0,9,24,-15
HUN,SVK,2018.0,10,5,5
ZAF,MOZ,2008.0,1,1,0
FJI,IND,2009.0,1,2,-1
COL,CUB,2016.0,1,6,-5
CHE,IRN,2008.0,1,4,-3
SVK,IRL,2014.0,1,1,0
HRV,BRA,2001.0,1,1,0
SEN,CHE,2020.0,3,3,0
IRL,GBR,2012.0,208,157,51
CAN,NLD,2013.0,47,63,-16
CHE,CHN,2017.0,56,60,-4
MYS,GBR,2019.0,92,105,-13
PAK,MYS,2019.0,46,126,-80
BRA,SWE,2015.0,23,6,17
CHE,CHN,2010.0,24,33,-9
DEU,HRV,1997.0,4,4,0
CAN,NZL,2014.0,31,36,-5
BFA,FRA,2003.0,7,12,-5
IND,DEU,2000.0,27,17,10
DEU,CZE,1997.0,6,5,1
BEL,ZAF,2013.0,9,6,3
HUN,SVK,2010.0,5,1,4
BEL,IND,2001.0,5,3,2
JOR,QAT,2016.0,6,1,5
MEX,ISR,2002.0,1,5,-4
IND,SYR,2019.0,1,2,-1
IND,TZA,2012.0,1,1,0
MNG,RUS,2010.0,1,1,0
SGP,GBR,2011.0,43,85,-42
GBR,LBN,2001.0,3,2,1
DEU,GBR,2019.0,664,710,-46
PRT,BRA,2005.0,31,29,2
FRA,ISR,1999.0,13,8,5
ZAF,BEL,2021.0,10,6,4
GBR,NOR,2018.0,109,49,60
GRC,FRA,2005.0,13,23,-10
HRV,AUS,2003.0,1,2,-1
NZL,GBR,1999.0,27,27,0
CHE,TUN,2016.0,1,3,-2
EGY,KWT,2002.0,4,2,2
DEU,DZA,2019.0,5,4,1
BRA,SWE,2004.0,2,9,-7
SWE,SVK,2005.0,1,3,-2
VEN,AUS,2005.0,1,2,-1
IRL,CHE,2001.0,1,5,-4
THA,FRA,2003.0,2,5,-3
TZA,FIN,2011.0,1,2,-1
GMB,BEL,2006.0,1,1,0
JOR,CAN,2019.0,9,17,-8
VEN,CRI,2010.0,1,1,0
COL,CAN,2005.0,2,2,0
CAN,TWN,2014.0,9,13,-4
USA,IRN,2012.0,47,321,-274
DNK,DEU,2016.0,89,138,-49
SAU,FRA,2011.0,1,27,-26
HKG,AUS,2020.0,34,51,-17
SRB,HRV,2018.0,6,8,-2
CHE,DNK,2012.0,15,15,0
CAN,NLD,2007.0,35,34,1
AUT,POL,2021.0,6,9,-3
TZA,DNK,2003.0,2,4,-2
CHE,IRN,2007.0,5,7,-2
GBR,HUN,2004.0,17,18,-1
CHL,ESP,2003.0,14,25,-11
NLD,RUS,2017.0,18,18,0
FRA,GAB,2012.0,5,2,3
SAU,DEU,2012.0,9,17,-8
HUN,DNK,2011.0,5,2,3
LBN,GBR,2006.0,2,7,-5
THA,CAN,2022.0,5,4,1
SWE,VNM,2021.0,4,4,0
TWN,CAN,2022.0,1,8,-7
FRA,TZA,2011.0,1,1,0
CAN,BHR,2006.0,1,2,-1
BFA,USA,2010.0,1,1,0
BEL,BGD,2014.0,1,2,-1
CRI,FRA,2013.0,1,1,0
FIN,BGD,2012.0,1,2,-1
DEU,PSE,2010.0,5,4,1
GBR,GMB,2017.0,4,5,-1
GBR,ZAF,2002.0,55,53,2
SRB,HUN,2018.0,6,1,5
SWE,AUS,2015.0,39,55,-16
VNM,KOR,2007.0,5,9,-4
DEU,EGY,2007.0,30,16,14
IRL,FRA,2020.0,34,28,6
ZMB,ZAF,2017.0,6,6,0
CUB,DEU,2018.0,4,1,3
HRV,THA,2016.0,1,1,0
IRL,ESP,2002.0,3,7,-4
KOR,POL,2013.0,12,2,10
PHL,DEU,2005.0,2,2,0
NLD,CRI,2019.0,1,2,-1
UGA,COG,2017.0,1,1,0
NOR,AUT,2021.0,2,16,-14
JPN,TUN,2018.0,3,2,1
AUS,MEX,2006.0,2,5,-3
HRV,HUN,2014.0,1,1,0
KWT,PAK,2018.0,1,1,0
THA,LAO,2016.0,5,2,3
ZMB,KEN,2016.0,2,1,1
ESP,TUR,2018.0,4,12,-8
GRC,BEL,2019.0,25,20,5
FRA,NLD,2019.0,147,94,53
CHN,FRA,2022.0,63,119,-56
LBN,SAU,2012.0,3,2,1
NLD,NOR,2017.0,37,5,32
ITA,HUN,2003.0,7,12,-5
EGY,CHN,2011.0,6,1,5
THA,ITA,2019.0,4,4,0
NZL,ITA,2011.0,4,5,-1
BEL,BGR,2008.0,1,3,-2
VNM,FRA,2000.0,1,2,-1
AUT,RUS,2014.0,3,12,-9
TUN,ITA,2009.0,1,1,0
HUN,DEU,2001.0,23,24,-1
CAN,KOR,2011.0,38,38,0
CUB,DEU,2010.0,3,2,1
RUS,HUN,2004.0,1,1,0
BIH,DEU,2013.0,1,4,-3
CAF,CMR,2017.0,1,1,0
BEL,SWE,2010.0,8,16,-8
CAN,BEL,2015.0,30,42,-12
TUR,CAN,2009.0,13,10,3
CZE,DEU,2009.0,24,29,-5
MTQ,FRA,2009.0,16,14,2
NOR,GBR,2005.0,23,42,-19
KOR,MAC,2022.0,1,1,0
SWE,IRL,2021.0,4,11,-7
AUS,HKG,2000.0,17,5,12
AZE,IRN,2017.0,2,1,1
BEL,BGR,2007.0,1,1,0
CZE,ESP,2008.0,6,2,4
GBR,EGY,2001.0,11,6,5
CHE,DNK,1998.0,4,3,1
SWE,SRB,2020.0,2,6,-4
CAN,TUR,2002.0,4,9,-5
VNM,CHE,2003.0,1,1,0
UGA,COD,2022.0,1,1,0
PHL,AUS,1997.0,1,1,0
CHE,ZWE,2008.0,1,1,0
PHL,SGP,2019.0,2,11,-9
ESP,ITA,2019.0,186,212,-26
FIN,DEU,2012.0,50,36,14
IND,DEU,2019.0,179,143,36
AUS,TUR,2016.0,8,3,5
HRV,SWE,2018.0,9,1,8
NZL,CAN,2016.0,31,38,-7
THA,KOR,2009.0,2,3,-1
USA,LKA,2022.0,11,9,2
NOR,FRA,2018.0,24,46,-22
HKG,NZL,2019.0,9,2,7
LUX,DEU,2019.0,15,32,-17
SWE,BEL,2007.0,10,5,5
MAR,DZA,2020.0,3,7,-4
RUS,SAU,2016.0,3,1,2
IRL,BHR,2022.0,5,4,1
ESP,BOL,2018.0,2,2,0
DEU,SVN,1997.0,1,1,0
BFA,MLI,2015.0,1,1,0
KOR,MAC,2016.0,1,1,0
KEN,IND,2011.0,1,1,0
USA,UZB,2004.0,2,4,-2
GBR,SRB,2011.0,6,4,2
BEL,JPN,2008.0,11,15,-4
NLD,CAN,2009.0,38,34,4
ITA,ESP,2013.0,152,148,4
BRA,JPN,2019.0,12,12,0
DEU,POL,2021.0,52,41,11
SAU,THA,2017.0,2,1,1
FRA,LTU,2014.0,3,3,0
POL,FRA,2002.0,27,37,-10
FRA,BFA,2000.0,4,8,-4
HKG,CAN,2002.0,24,23,1
TUN,USA,2016.0,4,2,2
SEN,BEN,2020.0,2,1,1
ARG,CHN,2001.0,1,1,0
USA,LTU,2003.0,7,3,4
CHE,ETH,2020.0,4,4,0
DEU,PHL,2017.0,6,5,1
ISR,AUT,2017.0,6,3,3
IDN,BGD,2020.0,2,3,-1
BEL,CAN,2000.0,5,4,1
JPN,BGR,2018.0,1,1,0
MEX,PRT,2003.0,1,3,-2
TZA,SWE,2020.0,2,2,0
ITA,MYS,2012.0,3,3,0
SWE,BGD,2010.0,3,1,2
FIN,SVK,2018.0,1,1,0
CAN,ESP,2007.0,21,32,-11
ITA,BGR,2014.0,3,2,1
NOR,AUT,2011.0,5,4,1
NZL,SAU,2014.0,4,2,2
CHN,JPN,2003.0,240,276,-36
BEL,AUT,2019.0,11,20,-9
JOR,SAU,2017.0,27,29,-2
USA,CRI,2004.0,10,5,5
TUR,GBR,2001.0,16,40,-24
BEL,AUT,2010.0,5,9,-4
GRC,JPN,2009.0,3,4,-1
BEL,BGR,2002.0,1,4,-3
EGY,SWE,2015.0,3,3,0
UKR,ISR,2007.0,2,1,1
ROU,DNK,2013.0,4,2,2
DZA,SAU,2010.0,5,2,3
SVN,DEU,2010.0,4,3,1
ARE,BEL,2005.0,1,1,0
KOR,POL,2005.0,1,1,0
HUN,IND,2021.0,4,3,1
SVN,BIH,2015.0,2,2,0
AUS,USA,2011.0,460,512,-52
NLD,POL,2011.0,22,15,7
ITA,ESP,2007.0,110,66,44
GBR,FRA,2021.0,323,293,30
SWE,RUS,2017.0,10,19,-9
CAN,ESP,2013.0,40,61,-21
DEU,CZE,2001.0,17,22,-5
IDN,NOR,2019.0,2,4,-2
FRA,GBR,1998.0,54,44,10
DEU,CMR,2019.0,5,1,4
RUS,NOR,2021.0,12,4,8
SWE,IRL,2011.0,7,11,-4
FRA,KOR,2018.0,46,23,23
ZWE,USA,2017.0,6,15,-9
ITA,HRV,2000.0,4,1,3
IND,QAT,2017.0,12,3,9
HKG,THA,2014.0,4,2,2
USA,JAM,2018.0,5,4,1
FRA,GLP,2016.0,6,22,-16
AUS,NCL,2020.0,2,2,0
CHL,FRA,2005.0,12,19,-7
GRC,KWT,2019.0,1,1,0
JPN,PAK,2014.0,13,7,6
ZAF,MOZ,2014.0,2,1,1
GRC,DNK,2003.0,2,2,0
ZAF,DNK,2015.0,1,2,-1
ARE,NLD,2003.0,1,1,0
ISR,NLD,2003.0,7,4,3
SAU,NLD,2015.0,2,4,-2
TUR,BIH,2010.0,1,1,0
KEN,BEN,2010.0,1,2,-1
ITA,RUS,2022.0,4,16,-12
ARE,MEX,2021.0,1,2,-1
JOR,ISR,2018.0,2,1,1
DZA,MAR,2011.0,1,1,0
CAN,RWA,2022.0,2,3,-1
DEU,BLR,2013.0,3,5,-2
USA,CRI,2015.0,15,7,8
BWA,NGA,2002.0,2,1,1
UGA,FRA,2020.0,1,3,-2
THA,FIN,2021.0,2,1,1
IRN,BRA,2021.0,8,2,6
ESP,SWE,2011.0,53,31,22
IND,TWN,2017.0,56,30,26
BEL,ETH,2019.0,8,3,5
PRT,CHN,2017.0,13,6,7
CAN,NZL,2008.0,26,25,1
TUR,SGP,2020.0,3,5,-2
AUT,ETH,2011.0,2,1,1
PRT,BEL,2011.0,4,10,-6
IRL,PRT,2003.0,3,3,0
SVN,AUS,2018.0,1,4,-3
DEU,BEN,2004.0,2,1,1
SWE,AUT,2003.0,6,7,-1
KOR,BGD,2008.0,5,7,-2
AUS,OMN,2003.0,1,3,-2
SGP,NOR,2019.0,3,1,2
ARG,USA,2012.0,93,81,12
BEL,NZL,2018.0,9,3,6
IND,POL,2020.0,26,7,19
AUT,RUS,2020.0,5,13,-8
ESP,SGP,2011.0,6,3,3
VEN,USA,2000.0,11,6,5
UKR,AUT,2010.0,5,4,1
RUS,GBR,2019.0,62,40,22
JPN,TWN,2011.0,49,36,13
HKG,GBR,2021.0,54,48,6
CHN,KOR,2004.0,21,35,-14
ZAF,LSO,2016.0,3,1,2
GBR,PHL,2001.0,3,2,1
CHE,RUS,2021.0,6,27,-21
BEL,IND,2013.0,19,16,3
CUB,DEU,2016.0,6,1,5
PER,MEX,2018.0,5,7,-2
IND,BHR,2006.0,5,1,4
AUS,GHA,2014.0,2,6,-4
GBR,ALB,2007.0,1,1,0
PAN,COL,2019.0,1,3,-2
NLD,JPN,2005.0,15,12,3
DNK,EST,2019.0,3,2,1
HUN,DEU,2020.0,45,29,16
PER,MEX,2017.0,5,6,-1
NLD,ESP,1999.0,15,19,-4
PAK,IND,2017.0,33,43,-10
BEL,IND,2008.0,8,6,2
SWE,IND,2017.0,22,42,-20
TWN,FRA,2022.0,8,3,5
USA,ARE,2010.0,47,15,32
POL,DEU,2004.0,53,40,13
CAN,IND,2008.0,39,85,-46
IRN,CHE,2010.0,14,1,13
IRN,NLD,2008.0,14,10,4
ESP,POL,2011.0,18,19,-1
IRN,EGY,2014.0,2,2,0
JOR,ARE,2015.0,10,2,8
PAK,IND,2010.0,16,18,-2
BEL,SRB,2017.0,2,3,-1
HUN,NLD,2015.0,8,7,1
COL,ARG,2016.0,11,16,-5
KWT,SAU,2006.0,2,1,1
NLD,SVN,2018.0,4,8,-4
LUX,DNK,2021.0,1,2,-1
KAZ,KOR,2016.0,3,1,2
FRA,TGO,2018.0,3,2,1
FRA,IDN,1999.0,2,2,0
KOR,TWN,2016.0,16,15,1
THA,IND,2015.0,8,9,-1
CAN,CIV,2019.0,3,2,1
BEL,NLD,2017.0,148,158,-10
IRN,IRQ,2015.0,5,1,4
CHE,TWN,2010.0,2,7,-5
BEL,NLD,2019.0,166,178,-12
USA,PHL,2021.0,11,23,-12
ISR,ITA,2019.0,20,18,2
CHN,BEL,2008.0,19,13,6
GBR,IRL,2000.0,39,35,4
POL,JPN,2018.0,8,10,-2
GBR,ISL,2021.0,3,6,-3
PER,USA,2004.0,21,17,4
BEL,IRL,2011.0,6,5,1
JPN,NZL,2013.0,14,9,5
IRN,ITA,2011.0,10,6,4
CHE,TWN,2017.0,4,9,-5
KEN,FRA,2004.0,2,1,1
JPN,MEX,2008.0,3,2,1
FJI,IND,2006.0,1,1,0
HKG,NGA,2017.0,1,3,-2
KOR,FRA,2001.0,3,2,1
MYS,TWN,2013.0,5,7,-2
KEN,FRA,2014.0,2,1,1
DNK,BGD,2020.0,3,2,1
FIN,SWE,2004.0,30,29,1
CHL,ESP,2013.0,43,100,-57
NPL,USA,2007.0,9,3,6
MYS,EGY,2015.0,9,7,2
IRL,SWE,2001.0,7,1,6
EST,DEU,2014.0,1,6,-5
FIN,AUT,2001.0,4,3,1
KOR,GRC,2013.0,1,1,0
PRK,CHN,2018.0,2,7,-5
FRA,EST,2012.0,1,3,-2
SVK,UKR,2004.0,2,1,1
TUR,IRQ,2020.0,20,5,15
BEL,CZE,2012.0,4,8,-4
DEU,DNK,2008.0,63,46,17
MYS,THA,2010.0,5,4,1
IND,FIN,2020.0,23,10,13
CZE,SWE,2007.0,3,2,1
TUN,EGY,2007.0,1,3,-2
IRQ,GBR,2012.0,8,7,1
KOR,FRA,2012.0,19,15,4
CHL,CUB,2007.0,1,3,-2
ESP,MAR,2001.0,4,1,3
JPN,MNG,2012.0,3,4,-1
TUR,SAU,2007.0,2,1,1
IRL,IND,2005.0,1,4,-3
ISR,CAN,2020.0,68,51,17
USA,GRC,2010.0,100,110,-10
ITA,IRL,2004.0,10,3,7
SGP,GBR,2019.0,106,99,7
SAU,IRL,2016.0,5,3,2
CHN,IRQ,2015.0,10,1,9
VEN,ARG,2014.0,3,1,2
PRT,COL,2020.0,4,4,0
POL,UKR,2012.0,10,13,-3
NOR,HUN,2005.0,1,1,0
FRA,IRL,2021.0,23,32,-9
TUN,USA,2010.0,5,4,1
GRC,BEL,2006.0,14,8,6
ZAF,NOR,2010.0,6,1,5
SWE,NLD,2008.0,31,31,0
DEU,CRI,2013.0,4,5,-1
MEX,DNK,2006.0,2,1,1
JPN,GRC,2004.0,3,1,2
HUN,TUR,2016.0,2,2,0
THA,SGP,2019.0,4,3,1
CHE,UGA,2008.0,3,1,2
USA,BWA,2020.0,7,9,-2
AUS,PER,2021.0,1,5,-4
AUT,NZL,2015.0,4,7,-3
ARE,PAK,2012.0,3,7,-4
DEU,ZMB,2015.0,2,1,1
ZAF,GRC,2012.0,1,1,0
NOR,BLR,2012.0,1,1,0
KOR,USA,2020.0,766,704,62
CAN,SAU,2008.0,42,20,22
FRA,USA,2018.0,870,633,237
GBR,ISL,2011.0,6,7,-1
KOR,CAN,2018.0,55,32,23
ITA,RUS,2017.0,30,14,16
GBR,EGY,2015.0,55,23,32
LUX,USA,2021.0,5,9,-4
IRN,ITA,2021.0,59,15,44
FRA,JPN,2021.0,88,63,25
SWE,NOR,2018.0,61,65,-4
USA,PAK,2021.0,60,93,-33
ARE,PSE,2018.0,1,1,0
NLD,CAN,2011.0,49,59,-10
QAT,USA,2011.0,14,29,-15
SRB,HRV,2011.0,8,10,-2
CAN,BEL,2001.0,24,18,6
JPN,GRC,2015.0,3,3,0
SWE,LTU,2005.0,4,3,1
EGY,ESP,2015.0,2,13,-11
ITA,RUS,2019.0,20,13,7
NOR,AUT,2009.0,3,10,-7
FIN,IND,2007.0,3,2,1
HRV,SRB,2004.0,4,4,0
ALB,FRA,2015.0,2,1,1
COL,PER,2018.0,2,3,-1
TUN,EGY,2013.0,1,1,0
CIV,USA,2018.0,1,4,-3
NZL,TWN,2013.0,2,3,-1
USA,POL,2011.0,261,81,180
NLD,DEU,2014.0,305,223,82
ITA,GBR,2007.0,236,162,74
USA,FIN,2016.0,66,86,-20
BRA,FRA,2022.0,50,31,19
FRA,NZL,2020.0,17,25,-8
EGY,DEU,2018.0,29,56,-27
BEL,TUR,2020.0,7,24,-17
USA,NOR,2004.0,53,37,16
THA,DEU,2002.0,3,7,-4
GBR,JPN,2008.0,102,124,-22
FRA,HUN,2013.0,11,13,-2
UKR,ESP,2016.0,4,3,1
KWT,ARE,2017.0,5,3,2
URY,ARG,2015.0,4,7,-3
CAN,TWN,1999.0,4,1,3
SYR,DEU,2010.0,2,1,1
SAU,NZL,2009.0,1,2,-1
ESP,DOM,2017.0,8,1,7
ISL,FIN,2007.0,1,1,0
