migrationfrom,migrationto,year,n_migrations,n_migrations_back,netmigrations
USA,DEU,2014.0,1270,1372,-102
USA,SAU,2012.0,131,58,73
USA,CHN,2006.0,859,1109,-250
USA,CAN,2020.0,1851,2045,-194
JPN,USA,2003.0,1634,1356,278
GBR,CHE,2008.0,178,183,-5
USA,JPN,2004.0,1137,1415,-278
FRA,NLD,2012.0,120,127,-7
PRT,GBR,2016.0,131,86,45
ISR,USA,2013.0,410,346,64
GBR,AUS,1999.0,288,275,13
BRA,MEX,2020.0,31,26,5
ITA,CAN,2014.0,72,49,23
CAN,CHN,2011.0,254,236,18
ESP,USA,2012.0,544,447,97
MYS,AUS,2005.0,16,19,-3
DEU,BEL,2006.0,74,47,27
ESP,ARG,2009.0,87,83,4
GBR,CHN,2015.0,452,341,111
USA,JPN,2008.0,1115,1201,-86
AUT,CAN,2010.0,22,17,5
USA,HKG,2013.0,150,146,4
USA,IRL,2009.0,129,137,-8
AUS,CAN,2008.0,119,149,-30
JPN,DEU,2009.0,143,107,36
GBR,AUT,2020.0,128,95,33
TWN,CHN,2006.0,48,62,-14
MYS,SWE,2012.0,4,6,-2
BEL,GBR,2011.0,88,93,-5
NLD,IRL,2017.0,15,17,-2
IND,USA,2000.0,510,277,233
SVK,DEU,2003.0,28,13,15
DEU,GBR,2008.0,708,405,303
FRA,USA,2003.0,861,778,83
DEU,ESP,2011.0,176,161,15
SGP,NZL,2020.0,18,17,1
AUS,HKG,2008.0,22,44,-22
CZE,NLD,2013.0,11,11,0
NLD,CZE,2015.0,13,9,4
BEL,POL,2023.0,8,3,5
SGP,CHN,2014.0,282,209,73
AUS,GBR,2010.0,447,618,-171
GBR,AUS,2020.0,665,583,82
SWE,ESP,2006.0,23,21,2
JPN,AUT,2003.0,18,7,11
GBR,USA,2002.0,1877,1561,316
SGP,USA,2021.0,238,184,54
GBR,ESP,2015.0,299,541,-242
CAN,GBR,2009.0,322,382,-60
GBR,USA,2012.0,1839,1598,241
CAN,USA,2015.0,2039,1612,427
CHN,HKG,2010.0,382,745,-363
HUN,CAN,2011.0,5,9,-4
USA,GRC,2020.0,105,137,-32
FRA,TUR,2008.0,17,9,8
USA,DEU,2001.0,1335,1452,-117
USA,CHN,2010.0,1753,2221,-468
CHN,USA,2016.0,3391,3218,173
USA,POL,2013.0,102,92,10
ESP,VEN,2008.0,24,27,-3
GBR,NZL,2004.0,128,80,48
USA,NLD,2021.0,489,397,92
USA,FRA,2011.0,766,940,-174
USA,KOR,2002.0,568,591,-23
SGP,CHN,2008.0,131,143,-12
USA,FRA,2021.0,669,791,-122
USA,ISR,2013.0,346,410,-64
DEU,JPN,2003.0,99,134,-35
VEN,CAN,2001.0,14,3,11
DEU,CAN,2007.0,216,119,97
CAN,USA,2004.0,1437,1390,47
KEN,USA,2017.0,52,102,-50
KEN,USA,2022.0,43,68,-25
NLD,CHN,2013.0,77,71,6
GBR,CHE,2001.0,138,139,-1
FIN,DEU,2022.0,51,59,-8
CHN,GBR,1998.0,59,67,-8
FRA,CAN,2009.0,298,225,73
GRC,GBR,2009.0,136,152,-16
CHN,SWE,2005.0,40,30,10
FRA,DEU,2010.0,368,322,46
SWE,NOR,2005.0,61,23,38
NOR,SWE,2006.0,31,56,-25
DEU,AUT,2006.0,263,171,92
ISR,NLD,2009.0,16,14,2
FRA,AUS,2018.0,89,84,5
DEU,NLD,2008.0,228,202,26
CHE,NLD,2014.0,63,92,-29
CHE,USA,2007.0,326,386,-60
BGR,RUS,2010.0,3,4,-1
USA,CHE,2007.0,386,326,60
AUT,RUS,2009.0,8,18,-10
FRA,ESP,2013.0,166,275,-109
TUR,CYP,2019.0,119,122,-3
GBR,AUS,2007.0,494,401,93
CHN,USA,2017.0,3596,3484,112
USA,CAN,2007.0,1552,1449,103
NLD,GBR,2008.0,187,153,34
URY,ESP,2012.0,11,13,-2
USA,GBR,2017.0,1879,2069,-190
FRA,ARM,2014.0,3,1,2
USA,PAK,2008.0,45,30,15
BRA,USA,2012.0,387,405,-18
DEU,CHN,2006.0,152,113,39
MEX,PRY,2012.0,2,1,1
USA,ESP,2013.0,432,548,-116
BEL,JPN,2022.0,15,6,9
CAN,JPN,2002.0,109,124,-15
USA,JPN,2015.0,961,983,-22
GBR,USA,2005.0,1528,1371,157
ITA,CUB,2011.0,1,5,-4
IRN,CAN,2011.0,214,60,154
KOR,BGD,2018.0,41,17,24
USA,DEU,2004.0,1125,1229,-104
USA,DEU,2015.0,1246,1341,-95
JPN,DEU,2019.0,135,151,-16
MEX,ESP,2004.0,58,80,-22
MEX,ESP,2008.0,86,96,-10
FRA,TUN,2017.0,153,93,60
FRA,CAN,2021.0,347,315,32
ROU,FRA,2008.0,27,43,-16
FRA,ROU,2010.0,36,34,2
ESP,PRT,2013.0,120,71,49
NLD,USA,2006.0,250,246,4
USA,JPN,2014.0,957,997,-40
FIN,USA,2009.0,72,83,-11
AUS,GBR,2006.0,403,474,-71
BRA,AUS,2001.0,13,14,-1
CMR,FRA,2021.0,15,26,-11
DNK,IRL,2013.0,5,9,-4
CHN,TWN,2018.0,177,339,-162
SWE,USA,2012.0,239,233,6
AUS,CHN,2011.0,133,221,-88
POL,CHN,2015.0,3,6,-3
ESP,HUN,2015.0,6,5,1
GBR,SGP,2010.0,95,47,48
GBR,NZL,2008.0,136,115,21
USA,CHE,2020.0,621,541,80
TUR,ITA,2004.0,1,6,-5
EGY,FRA,2016.0,11,21,-10
DEU,NLD,2014.0,251,362,-111
TWN,USA,2011.0,289,367,-78
CAN,SAU,2016.0,119,69,50
DEU,AUT,2010.0,332,279,53
USA,CHN,2023.0,2356,1692,664
NLD,USA,2010.0,332,359,-27
DEU,SWE,2014.0,157,132,25
ESP,ITA,2013.0,162,183,-21
ISR,GBR,2018.0,69,51,18
IND,KOR,2012.0,189,110,79
AUS,USA,2012.0,611,718,-107
CIV,FRA,1998.0,16,14,2
USA,NLD,2019.0,421,486,-65
POL,FRA,2018.0,53,53,0
DEU,HUN,2003.0,42,59,-17
ITA,USA,2004.0,476,442,34
IND,SGP,2008.0,43,25,18
TWN,SGP,2011.0,17,14,3
USA,ECU,2012.0,22,18,4
POL,GRC,2007.0,5,1,4
GRC,POL,2010.0,4,4,0
GBR,IRL,2005.0,208,169,39
CHL,GBR,2006.0,12,10,2
NZL,CHN,2016.0,26,32,-6
JPN,BGD,2008.0,40,44,-4
JPN,BGD,2014.0,78,54,24
GBR,CYP,2012.0,37,14,23
DEU,JPN,2013.0,135,145,-10
POL,GBR,2010.0,61,53,8
AUS,CAN,2015.0,175,209,-34
USA,FRA,2019.0,750,960,-210
GBR,CAN,2003.0,350,253,97
CHN,FRA,2003.0,53,48,5
GRC,FIN,2013.0,6,2,4
NZL,AUS,2003.0,116,102,14
AUS,NZL,2007.0,89,154,-65
JPN,THA,2009.0,93,33,60
FIN,PRT,2020.0,5,5,0
ITA,BEL,2011.0,87,37,50
DEU,GBR,2004.0,433,385,48
TWN,IND,2011.0,44,51,-7
USA,NZL,2013.0,121,131,-10
AUS,CHL,2019.0,19,29,-10
ESP,CZE,2018.0,33,18,15
TUR,USA,2011.0,226,303,-77
DEU,DNK,2018.0,165,129,36
USA,IND,2005.0,397,676,-279
IND,USA,2010.0,1007,676,331
SWE,FRA,2008.0,52,51,1
DEU,AUS,2011.0,173,150,23
USA,RUS,2008.0,185,207,-22
CIV,FRA,2007.0,19,33,-14
GBR,ROU,1997.0,6,6,0
USA,THA,2011.0,222,110,112
ESP,FRA,2016.0,354,226,128
GBR,ESP,2008.0,230,213,17
CHE,FRA,2003.0,207,286,-79
FRA,DEU,2006.0,268,270,-2
USA,CAN,1998.0,878,1288,-410
DEU,RUS,2003.0,153,239,-86
BEL,USA,2003.0,183,131,52
GBR,IRL,2012.0,203,277,-74
USA,CHN,2000.0,372,680,-308
USA,JPN,2001.0,1219,1594,-375
USA,BRA,2021.0,440,755,-315
BRA,CAN,2009.0,64,48,16
IRL,FRA,2006.0,19,32,-13
CAN,OMN,2003.0,4,2,2
ZAF,FRA,2005.0,11,13,-2
NAM,ZWE,2015.0,1,2,-1
USA,GBR,2022.0,1384,1658,-274
CAN,PRT,2009.0,6,5,1
ISR,USA,2003.0,435,283,152
ITA,USA,2015.0,622,408,214
BRA,ITA,2023.0,49,24,25
CAN,NLD,2010.0,69,63,6
RUS,UKR,2011.0,51,38,13
USA,NLD,2009.0,306,299,7
JPN,VNM,2011.0,47,9,38
AUT,FRA,2003.0,23,27,-4
FRA,USA,2013.0,942,802,140
TUR,ITA,2008.0,8,2,6
USA,GBR,2016.0,1887,1984,-97
USA,TTO,2020.0,12,10,2
CHE,SWE,2011.0,56,63,-7
NLD,BEL,2010.0,132,119,13
DEU,POL,2012.0,77,87,-10
FRA,CHN,2006.0,46,67,-21
GBR,RUS,2018.0,64,48,16
GBR,PRT,2003.0,53,27,26
IRL,AUS,2013.0,55,28,27
MYS,GBR,2003.0,18,61,-43
ESP,MAR,2018.0,20,8,12
MAR,ESP,2020.0,10,17,-7
CAN,DNK,2014.0,28,19,9
NLD,GBR,2015.0,369,250,119
BRA,USA,2002.0,307,367,-60
ITA,GBR,2011.0,394,255,139
USA,KEN,2009.0,32,32,0
USA,KEN,2011.0,34,37,-3
JPN,GBR,2007.0,124,112,12
GBR,FRA,1997.0,209,193,16
GBR,IRL,2002.0,251,181,70
CAN,FRA,2013.0,262,390,-128
CHN,USA,2018.0,3772,3825,-53
CHE,DEU,2006.0,298,564,-266
GBR,ITA,2000.0,191,249,-58
GBR,NZL,2015.0,118,126,-8
USA,THA,2009.0,188,103,85
FIN,GBR,2012.0,47,59,-12
FRA,ARE,2009.0,8,1,7
DEU,FRA,2009.0,345,346,-1
SGP,FRA,2016.0,24,34,-10
GRC,LUX,2022.0,6,3,3
SWE,NOR,2012.0,75,63,12
SWE,CHE,2006.0,50,23,27
FIN,USA,2021.0,91,80,11
SWE,DEU,2016.0,144,201,-57
NZL,USA,2003.0,128,148,-20
USA,ITA,2006.0,423,465,-42
GBR,PAK,2007.0,37,21,16
AUS,LKA,2010.0,5,16,-11
BRA,USA,2005.0,309,319,-10
USA,BRA,2011.0,458,378,80
DEU,NLD,2015.0,291,323,-32
DEU,GBR,2014.0,729,702,27
JPN,NLD,2001.0,27,27,0
PRT,BRA,2010.0,90,102,-12
TWN,USA,2009.0,271,375,-104
GBR,RUS,2017.0,46,55,-9
CHE,CHN,2004.0,17,11,6
ZAF,GBR,2004.0,64,59,5
CZE,USA,2010.0,37,37,0
FIN,AUT,2011.0,16,6,10
CAN,USA,2001.0,1831,1349,482
BEL,TZA,2016.0,1,5,-4
POL,CHE,2010.0,22,9,13
IND,GBR,1999.0,73,63,10
KOR,IND,2016.0,145,205,-60
HKG,CHN,2012.0,717,726,-9
SAU,CAN,2007.0,21,45,-24
LBN,USA,1997.0,7,16,-9
GBR,BRA,2006.0,75,44,31
AUT,GBR,2014.0,89,76,13
GBR,BRA,2010.0,77,54,23
CHL,USA,2004.0,62,62,0
GBR,LKA,2012.0,9,17,-8
FIN,ESP,2013.0,15,18,-3
TUN,CHE,2016.0,3,1,2
POL,UKR,2006.0,16,21,-5
PER,USA,2011.0,34,39,-5
CAN,DEU,2017.0,194,183,11
IND,PAK,2010.0,16,19,-3
IRL,USA,2010.0,135,146,-11
BRA,USA,1997.0,139,187,-48
BGR,NLD,2011.0,2,1,1
USA,DNK,2010.0,111,110,1
AUT,USA,2006.0,109,86,23
CHE,GBR,2003.0,135,174,-39
USA,RUS,2004.0,319,321,-2
FRA,CIV,2014.0,20,32,-12
CAN,FRA,2003.0,177,230,-53
USA,RUS,2015.0,215,182,33
ITA,CHE,2011.0,176,115,61
CHE,BRA,2012.0,16,19,-3
VNM,RUS,2020.0,11,28,-17
CHE,MEX,2000.0,5,4,1
SAU,ZAF,2012.0,20,25,-5
GBR,USA,1997.0,938,938,0
USA,MEX,2002.0,262,235,27
USA,IND,2012.0,829,997,-168
BEL,CHN,2012.0,36,38,-2
SWE,CAN,2006.0,36,21,15
GBR,DEU,2016.0,699,832,-133
GBR,CAN,2013.0,391,359,32
GBR,NZL,2001.0,115,98,17
GBR,CHE,2004.0,164,115,49
GBR,CHE,2015.0,274,272,2
POL,ESP,2009.0,19,8,11
FRA,CIV,2008.0,33,17,16
CHN,BEL,2011.0,36,31,5
DEU,CHN,2010.0,175,222,-47
CHE,DEU,2010.0,470,631,-161
FRA,ITA,2016.0,259,396,-137
IND,MEX,2011.0,3,3,0
POL,UKR,2023.0,27,45,-18
USA,BRA,2019.0,445,718,-273
PHL,USA,2022.0,39,38,1
ITA,GBR,2009.0,345,220,125
AUS,CAN,2014.0,154,201,-47
CAN,GBR,2019.0,422,526,-104
DEU,ARG,2006.0,19,35,-16
SGP,USA,2009.0,166,222,-56
BEL,MAR,2011.0,10,1,9
DEU,GBR,2001.0,473,473,0
GBR,TUR,2004.0,44,29,15
JPN,CHN,2007.0,418,252,166
USA,SWE,2022.0,219,192,27
CAN,KOR,2015.0,39,49,-10
SGP,CHN,2015.0,298,272,26
DEU,GBR,2015.0,736,687,49
GBR,DEU,2022.0,705,495,210
SWE,AUT,2021.0,23,25,-2
GBR,TZA,2020.0,9,7,2
USA,EGY,2018.0,166,128,38
CHN,GBR,2020.0,588,754,-166
GBR,ZMB,2002.0,3,5,-2
SGP,USA,2011.0,171,268,-97
IND,MYS,2016.0,80,46,34
CAN,CHN,2019.0,459,439,20
VEN,ESP,2020.0,21,16,5
GBR,ESP,2004.0,186,161,25
NOR,SWE,2010.0,53,64,-11
HUN,HRV,2015.0,3,1,2
AUT,POL,2012.0,12,11,1
GBR,FRA,2005.0,299,372,-73
ITA,NLD,2007.0,76,69,7
ITA,USA,2014.0,673,482,191
RUS,SWE,2023.0,15,8,7
CAN,CHE,2007.0,52,71,-19
AUT,DEU,2022.0,283,330,-47
JPN,NZL,2011.0,5,8,-3
CHL,USA,2014.0,114,152,-38
JPN,ARG,2003.0,2,2,0
JPN,GRC,2011.0,4,2,2
CHE,GBR,2013.0,230,284,-54
NOR,PRT,2016.0,9,10,-1
MYS,AUS,2012.0,64,84,-20
AUT,GBR,2008.0,69,45,24
JPN,SGP,2003.0,22,10,12
CZE,JPN,2007.0,8,6,2
NZL,SGP,2008.0,15,8,7
SAU,BHR,2015.0,8,4,4
GBR,ITA,2010.0,240,368,-128
PAN,USA,2001.0,12,4,8
CHL,USA,2008.0,98,103,-5
ZAF,IRL,2015.0,2,1,1
RUS,AUT,2012.0,17,6,11
AUT,RUS,2019.0,7,16,-9
RUS,SRB,2022.0,5,3,2
AUS,CHN,2009.0,105,149,-44
DNK,USA,2013.0,135,160,-25
SGP,OMN,2015.0,1,1,0
GBR,ETH,2013.0,10,12,-2
IND,TWN,2002.0,34,11,23
GBR,FIN,2013.0,52,40,12
UKR,DEU,2019.0,38,16,22
GBR,GRC,2009.0,152,136,16
GRC,HUN,2011.0,2,2,0
SAU,USA,1999.0,27,33,-6
SWE,AUS,2018.0,57,59,-2
THA,USA,2009.0,103,188,-85
DNK,GBR,2016.0,106,116,-10
JPN,NOR,2017.0,8,5,3
GBR,DNK,2011.0,87,56,31
ZAF,AUS,2004.0,27,22,5
USA,DEU,2008.0,1048,1248,-200
AUS,DEU,2009.0,121,154,-33
JPN,CAN,2004.0,100,82,18
CAN,JPN,2005.0,85,101,-16
NZL,USA,2013.0,131,121,10
ESP,MEX,2007.0,100,87,13
ESP,IRL,2022.0,33,34,-1
KAZ,USA,2002.0,2,1,1
PRT,CHN,2013.0,8,12,-4
CHE,NLD,2008.0,50,55,-5
USA,MEX,2005.0,215,193,22
TUR,USA,2009.0,222,248,-26
JPN,RUS,2007.0,25,23,2
DEU,IRN,2014.0,36,82,-46
BRA,FRA,2013.0,85,116,-31
ESP,CHL,2007.0,51,37,14
SWE,BEL,2018.0,29,33,-4
CAN,DEU,2018.0,178,185,-7
POL,USA,2013.0,92,102,-10
IND,USA,2006.0,722,458,264
CHL,USA,2015.0,121,150,-29
CHL,NLD,2022.0,17,9,8
JPN,IRN,2018.0,14,11,3
ESP,ARG,2011.0,97,94,3
SAU,EGY,2014.0,220,299,-79
USA,LBN,2011.0,49,52,-3
CHN,LBN,2018.0,1,1,0
DEU,TWN,2006.0,20,8,12
TWN,DEU,2007.0,10,14,-4
FRA,PER,2006.0,3,3,0
GBR,ESP,2001.0,187,174,13
IND,GBR,2007.0,156,106,50
ITA,IND,2016.0,50,46,4
USA,PAN,2010.0,22,18,4
BRA,CAN,2011.0,67,48,19
CZE,USA,2006.0,54,53,1
GUM,USA,1999.0,7,3,4
CHL,CAN,2004.0,8,6,2
AUS,CHE,2014.0,59,66,-7
SWE,USA,2002.0,343,235,108
AUT,HUN,2013.0,13,20,-7
USA,IRN,2009.0,66,125,-59
GBR,CHN,2014.0,409,310,99
SLV,SVN,2014.0,4,9,-5
ITA,CHN,2009.0,20,22,-2
DNK,ISR,2011.0,2,6,-4
ITA,CHE,2009.0,180,114,66
IND,SGP,2004.0,35,10,25
USA,KOR,2005.0,732,628,104
JPN,CHN,1999.0,153,165,-12
JPN,IND,2022.0,77,68,9
NZL,JPN,2005.0,6,3,3
GRC,GBR,2011.0,167,165,2
ESP,DEU,2010.0,154,161,-7
ISL,USA,2003.0,18,17,1
SGP,GBR,2008.0,61,72,-11
KOR,JPN,2013.0,120,152,-32
JPN,KOR,2014.0,177,115,62
EGY,USA,2006.0,44,95,-51
USA,HUN,2007.0,81,80,1
ESP,DNK,2021.0,45,35,10
IRL,GBR,2010.0,220,261,-41
USA,NOR,2009.0,85,90,-5
GRC,GBR,2021.0,188,198,-10
JPN,TWN,2008.0,40,24,16
TWN,JPN,2009.0,27,55,-28
NZL,CAN,2020.0,42,41,1
CAN,NZL,2022.0,22,24,-2
CHE,FRA,2013.0,250,339,-89
ESP,BRA,2009.0,70,89,-19
ZAF,ESP,2013.0,4,10,-6
GBR,DNK,2009.0,81,53,28
RUS,GBR,2003.0,72,69,3
DEU,IRN,2008.0,26,20,6
THA,USA,2021.0,131,213,-82
USA,GBR,2018.0,1886,2057,-171
IND,BGD,2012.0,17,9,8
BEL,GBR,2021.0,162,162,0
KOR,GBR,1999.0,15,19,-4
CHN,GBR,1999.0,78,73,5
JPN,TUR,2004.0,13,13,0
KOR,MNG,2013.0,4,1,3
GBR,THA,2010.0,58,33,25
TUR,FIN,2023.0,7,2,5
TUR,EGY,2011.0,1,3,-2
TZA,UGA,2012.0,4,2,2
ZAF,NLD,2007.0,17,9,8
ROU,CHE,2010.0,5,8,-3
GRC,BEL,2008.0,12,11,1
CAN,PAN,2011.0,4,1,3
IND,SGP,2001.0,16,11,5
AUS,AUT,2009.0,33,36,-3
AUS,CHE,2008.0,51,50,1
GBR,NLD,2007.0,163,199,-36
FRA,POL,2014.0,42,32,10
FRA,POL,2008.0,34,38,-4
FRA,DEU,2023.0,231,193,38
ESP,CHN,2014.0,26,31,-5
ARG,ESP,2006.0,82,69,13
CAN,HKG,2008.0,26,21,5
AUS,JPN,2003.0,48,65,-17
ITA,SMR,2015.0,5,4,1
AUS,CHL,2011.0,6,15,-9
USA,ESP,2003.0,374,355,19
GBR,UKR,2010.0,61,100,-39
FRA,PRT,2013.0,44,35,9
ESP,CHE,2005.0,36,30,6
IND,IDN,2007.0,5,5,0
ITA,BEL,2009.0,64,32,32
CAN,HKG,2004.0,20,27,-7
NLD,GBR,2004.0,146,148,-2
AUT,DEU,2016.0,382,350,32
KOR,FIN,2010.0,4,3,1
JPN,TWN,2004.0,22,11,11
SWE,GBR,2007.0,124,117,7
ZAF,AUS,2014.0,46,29,17
KOR,CAN,1998.0,10,17,-7
CAN,KOR,2001.0,18,29,-11
USA,SWE,2016.0,282,251,31
NGA,USA,2023.0,87,28,59
JPN,CHN,1998.0,133,141,-8
DEU,SAU,2013.0,27,4,23
KOR,CHN,2004.0,52,36,16
SWE,ESP,2010.0,32,40,-8
USA,NOR,2021.0,130,90,40
FRA,MAR,2004.0,63,63,0
CAN,AUS,2013.0,219,147,72
SVK,DEU,2013.0,11,12,-1
KOR,IND,2018.0,147,222,-75
FRA,BRA,2009.0,104,94,10
SGP,KOR,2009.0,17,17,0
USA,ITA,2023.0,271,295,-24
LTU,USA,2020.0,8,12,-4
FRA,CHE,2005.0,261,155,106
FRA,JPN,2003.0,69,79,-10
HRV,IRL,2017.0,5,1,4
DEU,SWE,2015.0,205,125,80
COL,BRA,2015.0,48,43,5
ESP,MEX,2020.0,184,179,5
JPN,DEU,2011.0,129,131,-2
ESP,NLD,2003.0,41,39,2
NPL,USA,2006.0,10,2,8
THA,NPL,2014.0,4,4,0
KOR,CHN,2008.0,73,92,-19
CHN,KOR,2011.0,83,186,-103
AUS,CHE,2015.0,72,72,0
PRT,IND,2014.0,21,17,4
FRA,MAR,2008.0,83,49,34
SWE,CAN,2000.0,39,29,10
JPN,RUS,1998.0,35,40,-5
IND,FRA,2010.0,93,42,51
IRN,FRA,2008.0,13,23,-10
IND,JPN,2006.0,75,72,3
JPN,LTU,2003.0,3,3,0
CHN,DNK,2012.0,38,32,6
ISR,CAN,2011.0,57,59,-2
AUT,FRA,2013.0,37,48,-11
GBR,SRB,2012.0,17,5,12
AUS,USA,2002.0,640,530,110
GBR,CHN,2004.0,114,117,-3
JPN,IDN,2010.0,88,26,62
ITA,USA,2008.0,558,418,140
BRA,GBR,2007.0,48,60,-12
CAN,GBR,2011.0,338,377,-39
FRA,MAR,2001.0,94,59,35
DZA,CAN,2013.0,5,5,0
DEU,HKG,2002.0,7,14,-7
PRT,USA,1999.0,32,32,0
BEL,GRC,2019.0,23,25,-2
CAN,JOR,2010.0,13,4,9
BEL,GBR,2009.0,86,100,-14
THA,NLD,2009.0,11,13,-2
KOR,DEU,2009.0,26,38,-12
AUS,PHL,2015.0,9,10,-1
CHN,SGP,2000.0,85,27,58
USA,ARE,2013.0,84,31,53
IND,IRN,2012.0,21,10,11
USA,THA,2021.0,213,131,82
GRC,ESP,2014.0,17,18,-1
NOR,BWA,2006.0,2,1,1
TWN,CHN,2010.0,160,176,-16
IND,DEU,2003.0,96,56,40
GBR,RUS,2016.0,50,64,-14
TUR,USA,2019.0,346,315,31
USA,BEL,2020.0,184,184,0
AUT,USA,2010.0,109,106,3
DEU,IND,2016.0,143,184,-41
JPN,HUN,2003.0,19,9,10
ISR,DEU,2012.0,40,37,3
CHN,GBR,2007.0,114,162,-48
RUS,DNK,2003.0,6,7,-1
PRT,ESP,2015.0,85,117,-32
NZL,ARE,2018.0,3,5,-2
ARG,AUS,2013.0,7,2,5
RUS,CAN,1999.0,46,18,28
USA,HRV,2012.0,19,22,-3
KOR,AUS,2006.0,17,20,-3
GBR,FRA,2002.0,403,399,4
DEU,CAN,2020.0,200,207,-7
FRA,IRL,2008.0,33,20,13
TWN,EGY,2007.0,2,1,1
RUS,USA,2021.0,198,143,55
RUS,IRL,2010.0,2,4,-2
HKG,IND,2006.0,2,5,-3
MDA,FRA,2000.0,5,3,2
FRA,MDA,2013.0,4,2,2
GRC,SWE,2012.0,15,10,5
SWE,FRA,2014.0,62,86,-24
GBR,SGP,2000.0,52,26,26
BRA,PRT,2018.0,164,155,9
CHN,TWN,2016.0,127,240,-113
FRA,CAN,2011.0,337,286,51
DNK,AUS,2007.0,20,19,1
FRA,CHE,2012.0,346,210,136
JPN,AUS,2007.0,62,36,26
AUS,CAN,2004.0,142,105,37
RUS,BRA,2019.0,8,8,0
ESP,FRA,2022.0,209,221,-12
DEU,KAZ,2020.0,7,4,3
USA,VNM,2007.0,9,4,5
USA,DOM,2016.0,4,5,-1
BRA,DEU,2023.0,103,35,68
FRA,SGP,2022.0,15,26,-11
POL,IRL,2010.0,8,4,4
CAN,DEU,2016.0,169,176,-7
HUN,ITA,1999.0,6,10,-4
NLD,NOR,2007.0,16,17,-1
NOR,NLD,2011.0,14,25,-11
FRA,MLI,2010.0,11,12,-1
GBR,HUN,2006.0,27,25,2
IND,CAN,2017.0,164,76,88
USA,EGY,2016.0,134,125,9
GBR,CZE,2010.0,68,37,31
USA,UGA,2012.0,32,19,13
IRN,JPN,2023.0,5,1,4
ECU,ESP,2009.0,6,3,3
FRA,BEL,2007.0,172,165,7
GRC,BEL,2014.0,27,9,18
LUX,GRC,2021.0,2,7,-5
FIN,USA,2011.0,82,63,19
RUS,ROU,1998.0,5,1,4
USA,ROU,2003.0,20,49,-29
USA,ROU,2013.0,26,23,3
GHA,GBR,2016.0,15,25,-10
AUS,GBR,2023.0,282,273,9
CHE,NLD,2004.0,36,47,-11
BRN,USA,2006.0,1,2,-1
QAT,USA,2020.0,60,43,17
ISR,NLD,2019.0,24,14,10
IDN,ITA,2011.0,2,6,-4
UKR,DEU,2021.0,43,14,29
AUT,TUR,2007.0,6,2,4
IND,BEL,2012.0,30,14,16
BEL,IND,2016.0,29,32,-3
BEL,IND,2018.0,23,32,-9
IND,TWN,2005.0,36,9,27
JPN,SWE,2006.0,22,34,-12
DEU,IND,2018.0,146,211,-65
PAK,OMN,2014.0,11,3,8
OMN,SAU,2015.0,5,6,-1
BEL,SWE,2015.0,27,17,10
GBR,NLD,1999.0,146,143,3
RUS,VNM,2013.0,10,5,5
ITA,NGA,2015.0,4,2,2
ZAF,GBR,2014.0,79,120,-41
DEU,NGA,2011.0,8,5,3
GBR,ZAF,2016.0,87,100,-13
UGA,KEN,2023.0,8,8,0
UKR,AUT,2008.0,7,2,5
CHE,ITA,2022.0,158,223,-65
BEL,NLD,2007.0,99,86,13
BEL,ROU,2018.0,3,4,-1
FIN,LUX,2012.0,2,2,0
CHE,USA,1999.0,395,335,60
ITA,MEX,2008.0,7,9,-2
USA,SVK,2014.0,18,17,1
CHN,HKG,2006.0,308,277,31
ESP,NLD,2013.0,100,66,34
VEN,GBR,2007.0,8,11,-3
ESP,BRA,2011.0,92,79,13
HKG,SGP,2003.0,18,21,-3
DEU,AUT,2000.0,165,195,-30
AUT,DEU,2018.0,313,394,-81
ARG,DEU,2012.0,41,26,15
DZA,FRA,2007.0,30,71,-41
USA,IND,2002.0,340,634,-294
CZE,FRA,2002.0,22,11,11
DEU,BFA,2004.0,1,2,-1
MLI,BFA,2018.0,2,4,-2
USA,SGP,2017.0,256,247,9
PAK,KOR,2008.0,4,3,1
MYS,PAK,2017.0,131,48,83
ZAF,ZMB,2018.0,21,7,14
FRA,DZA,2010.0,117,48,69
IND,ARE,2012.0,19,4,15
DNK,CHE,2012.0,24,20,4
JPN,CAN,2014.0,98,74,24
IND,NZL,2006.0,6,4,2
IDN,USA,2017.0,24,57,-33
GBR,CZE,2006.0,29,49,-20
GBR,COL,2008.0,16,11,5
DEU,ROU,2008.0,39,16,23
DEU,ESP,2009.0,168,144,24
RUS,USA,2009.0,195,187,8
CAN,PER,2006.0,2,1,1
HRV,SVN,2020.0,13,13,0
ITA,USA,2001.0,596,494,102
IRN,GBR,2011.0,35,57,-22
GBR,THA,2006.0,55,22,33
BRA,POL,2015.0,2,1,1
IRN,ARM,2010.0,5,1,4
ESP,FRA,2018.0,306,256,50
USA,DNK,2006.0,107,87,20
GBR,CYP,2002.0,8,2,6
DEU,ECU,2015.0,8,4,4
FRA,SVK,2010.0,3,6,-3
FRA,DNK,2011.0,32,22,10
IRL,CZE,2020.0,7,4,3
CZE,IRL,2023.0,4,4,0
CHN,MAC,2015.0,73,25,48
PAK,SAU,2015.0,91,32,59
GBR,GRC,2021.0,198,188,10
DEU,IRL,2016.0,45,42,3
CAN,SAU,2017.0,136,65,71
NLD,GBR,2001.0,205,181,24
ITA,GBR,2019.0,591,475,116
BEL,CAN,2012.0,33,29,4
IND,DEU,2013.0,139,126,13
MNE,SRB,2022.0,59,45,14
CAN,DNK,2008.0,25,19,6
GBR,SAU,2002.0,29,8,21
USA,PAK,2001.0,22,32,-10
FRA,HKG,2008.0,10,10,0
FRA,TUR,2015.0,16,19,-3
COL,USA,2003.0,41,39,2
COL,USA,2013.0,88,112,-24
ISR,GBR,2017.0,66,68,-2
BEL,FRA,2020.0,226,285,-59
GBR,GRC,2019.0,188,250,-62
USA,ISR,2003.0,283,435,-152
IND,JPN,2000.0,84,48,36
POL,GBR,2000.0,19,45,-26
ISR,CAN,2009.0,54,39,15
DEU,AUS,2021.0,140,164,-24
ITA,JPN,2020.0,30,30,0
TUR,ARE,2019.0,5,4,1
GRC,CAN,2006.0,9,12,-3
IND,CHE,2005.0,16,13,3
USA,NLD,2011.0,347,376,-29
DEU,DNK,2016.0,142,93,49
IRN,CAN,2009.0,111,58,53
USA,NOR,2011.0,100,72,28
FRA,LBN,2007.0,28,22,6
AUT,SVN,2008.0,5,5,0
DEU,CZE,2019.0,72,71,1
CHE,USA,2020.0,541,621,-80
AUS,IND,2017.0,71,145,-74
CZE,EGY,2003.0,2,1,1
JPN,BGD,2015.0,72,47,25
NOR,SGP,2009.0,2,4,-2
POL,TWN,2021.0,3,4,-1
IND,ARE,2005.0,5,2,3
JPN,ITA,2007.0,17,19,-2
ROU,GBR,2021.0,19,20,-1
GBR,CZE,2000.0,32,33,-1
USA,MNG,2011.0,4,2,2
SWE,EGY,2013.0,6,10,-4
CHL,AUS,2019.0,29,19,10
IND,OMN,2012.0,12,13,-1
FRA,CHE,2002.0,252,195,57
TWN,CHN,2023.0,138,112,26
NOR,NLD,2009.0,10,29,-19
FRA,SGP,2017.0,34,27,7
IND,ETH,2003.0,5,3,2
DEU,ESP,2019.0,244,252,-8
BEL,FIN,2023.0,8,5,3
AUS,HKG,2004.0,27,26,1
TWN,SGP,2009.0,9,9,0
THA,NZL,2003.0,1,1,0
SGP,USA,2019.0,256,249,7
USA,DNK,2023.0,106,82,24
NOR,DEU,2022.0,55,82,-27
IND,AUS,2012.0,82,52,30
DEU,FIN,2012.0,48,48,0
ROU,FRA,2014.0,39,31,8
BEL,USA,2013.0,185,167,18
KEN,TZA,2005.0,4,5,-1
USA,NZL,2003.0,148,128,20
FRA,ITA,2022.0,281,294,-13
USA,BEL,2007.0,108,136,-28
NLD,SVK,2012.0,2,5,-3
NLD,KOR,2012.0,8,9,-1
PRT,GBR,2018.0,132,89,43
USA,LBN,2021.0,60,144,-84
MEX,CHN,2020.0,9,8,1
DEU,LVA,2012.0,3,7,-4
ITA,CAN,2008.0,44,40,4
NLD,UKR,2016.0,2,3,-1
JPN,FRA,2017.0,91,79,12
CAN,RUS,2020.0,23,18,5
CAN,NZL,2017.0,44,44,0
GUM,USA,2007.0,6,2,4
UGA,USA,2004.0,13,11,2
USA,UGA,2005.0,18,10,8
USA,RUS,2001.0,266,597,-331
AUS,DEU,2021.0,164,140,24
BEL,FRA,1999.0,124,116,8
BEL,CHE,2016.0,68,78,-10
NLD,THA,2017.0,10,11,-1
SVN,AUT,2014.0,13,5,8
AUT,SVN,2015.0,3,4,-1
USA,PER,2020.0,65,66,-1
SVN,USA,2009.0,16,16,0
CHE,ISR,2013.0,14,16,-2
KOR,VNM,2007.0,11,6,5
CHN,HKG,2000.0,209,160,49
GBR,SAU,2005.0,22,14,8
GBR,NOR,2020.0,118,69,49
PRT,ESP,2014.0,100,110,-10
DNK,POL,2013.0,9,8,1
GBR,ESP,2014.0,292,487,-195
AUS,THA,2013.0,36,28,8
CHE,ARG,2019.0,6,11,-5
CAN,SGP,1998.0,16,6,10
JAM,USA,2010.0,13,12,1
GBR,OMN,2003.0,6,7,-1
AUS,PHL,2004.0,7,8,-1
CAN,PAK,2021.0,24,39,-15
GRC,GBR,2019.0,250,188,62
GBR,KEN,2011.0,26,25,1
NLD,CAN,2007.0,41,47,-6
ITA,AUS,2005.0,18,25,-7
USA,IRN,2019.0,161,576,-415
USA,SAU,1997.0,31,17,14
TUR,USA,2021.0,309,291,18
CHE,RUS,2004.0,15,22,-7
DEU,SWE,2008.0,123,91,32
FIN,DEU,2016.0,69,67,2
JPN,KOR,2008.0,155,95,60
ZAF,GBR,2008.0,87,79,8
GBR,ZAF,2017.0,82,118,-36
POL,GBR,2006.0,36,24,12
GRC,USA,2011.0,128,116,12
CAN,LUX,2019.0,3,1,2
CHE,DEU,2023.0,300,364,-64
HKG,CHN,2002.0,262,252,10
USA,MEX,2012.0,255,215,40
SWE,BEL,2017.0,22,29,-7
CHE,ITA,2016.0,111,296,-185
COD,COG,2010.0,16,18,-2
ESP,AUT,2011.0,27,19,8
JPN,ZMB,2014.0,3,2,1
ARG,FRA,2020.0,39,25,14
ITA,BGD,2012.0,4,4,0
MEX,GBR,2003.0,33,36,-3
GBR,KOR,2011.0,57,33,24
DEU,POL,2002.0,75,87,-12
USA,LTU,2010.0,9,6,3
IRL,ISR,2014.0,8,12,-4
NOR,ITA,2023.0,5,27,-22
USA,RUS,2014.0,195,195,0
PRT,GBR,2017.0,135,86,49
ESP,DNK,2019.0,42,31,11
THA,SWE,2022.0,4,8,-4
GRC,AUS,2016.0,10,5,5
DEU,BGR,2006.0,16,37,-21
ZWE,USA,2012.0,5,6,-1
FRA,TUN,2016.0,156,101,55
NOR,AUS,2011.0,7,17,-10
CAN,MAR,2010.0,15,1,14
AUS,CHN,2021.0,674,424,250
HKG,SGP,2013.0,34,27,7
ITA,CHN,2011.0,27,30,-3
POL,CZE,2012.0,15,8,7
FRA,ITA,2018.0,315,383,-68
FRA,TUN,2018.0,119,113,6
DNK,CRI,2017.0,2,1,1
DEU,FRA,2021.0,346,391,-45
BEL,ZAF,2006.0,8,6,2
RUS,DEU,2017.0,143,118,25
AUT,SVK,2018.0,5,16,-11
GBR,DNK,2021.0,137,116,21
GBR,SGP,2006.0,63,56,7
BLR,RUS,2021.0,20,23,-3
AUS,CHE,2004.0,36,31,5
HKG,GBR,2004.0,35,27,8
AUS,IND,2022.0,72,112,-40
AUT,DEU,2017.0,367,364,3
CHN,TWN,2022.0,169,235,-66
SGP,GBR,2004.0,40,41,-1
KOR,IND,2022.0,156,308,-152
KOR,AUS,2010.0,36,22,14
URY,USA,2003.0,8,12,-4
USA,POL,2003.0,131,183,-52
PRT,FRA,2012.0,34,53,-19
RUS,KOR,2014.0,7,14,-7
SVK,NLD,2014.0,6,5,1
GBR,IRN,2002.0,59,11,48
BRA,ITA,2010.0,25,46,-21
RUS,NOR,2013.0,10,8,2
IDN,SWE,2011.0,2,2,0
RUS,BLR,2005.0,27,15,12
ITA,BEL,2019.0,145,89,56
AUT,GRC,2007.0,7,1,6
NLD,ITA,2018.0,95,155,-60
IND,KOR,2005.0,66,13,53
PRT,IND,2015.0,17,19,-2
CHN,SGP,2006.0,84,112,-28
MYS,IRN,2007.0,5,7,-2
CAN,IRN,2009.0,58,111,-53
CMR,USA,2010.0,10,5,5
FRA,IRN,2009.0,24,11,13
USA,COL,2020.0,150,181,-31
SVN,AUT,2008.0,5,5,0
USA,PRT,2005.0,47,48,-1
BRA,AUT,2000.0,3,1,2
AUS,BEL,2020.0,26,38,-12
BEL,ITA,2023.0,66,77,-11
RUS,USA,2011.0,190,186,4
IND,PRT,2010.0,20,5,15
GRC,NLD,2009.0,19,12,7
NLD,GRC,2010.0,16,18,-2
DNK,LTU,2003.0,1,1,0
BFA,FRA,2019.0,12,15,-3
CHN,NLD,2007.0,40,27,13
GRC,ESP,2008.0,21,9,12
POL,SWE,1998.0,9,14,-5
AUS,IRL,2020.0,60,41,19
DEU,FRA,2019.0,365,441,-76
BRA,DNK,2016.0,28,9,19
USA,PER,2007.0,33,33,0
PAK,GBR,2010.0,39,52,-13
USA,GRD,2008.0,5,3,2
CAN,POL,2011.0,15,18,-3
USA,CAN,1999.0,956,1397,-441
CHE,HRV,2004.0,1,6,-5
NOR,DEU,2016.0,57,82,-25
DEU,BEL,2010.0,101,108,-7
PRT,USA,2007.0,40,55,-15
RUS,BLR,2002.0,41,14,27
SRB,CAN,2000.0,6,3,3
BRA,DEU,2010.0,64,64,0
USA,GEO,2013.0,53,42,11
NLD,ABW,2012.0,1,1,0
JPN,THA,2011.0,94,70,24
COL,CAN,2022.0,35,7,28
CAN,DOM,2023.0,1,1,0
TWN,IND,2009.0,28,66,-38
USA,PSE,2014.0,11,5,6
NLD,AUT,2016.0,23,20,3
FRA,DNK,2009.0,28,23,5
CHE,SWE,2019.0,56,66,-10
FIN,NZL,2014.0,3,5,-2
PRT,ESP,2008.0,50,52,-2
FRA,BEL,2020.0,285,226,59
EGY,SAU,2023.0,260,194,66
ARE,MAR,2020.0,7,3,4
BEL,ESP,2009.0,40,28,12
GRC,CYP,2013.0,50,16,34
SAU,USA,2020.0,162,390,-228
NLD,PRT,2012.0,21,24,-3
CHE,AUS,2012.0,65,58,7
AUS,TWN,2006.0,10,6,4
KOR,DEU,2011.0,53,40,13
PRT,BEL,2003.0,3,6,-3
USA,THA,2019.0,239,136,103
KOR,UZB,2021.0,4,7,-3
BEL,ITA,2000.0,49,36,13
JPN,CAN,2008.0,88,85,3
GBR,SRB,2005.0,13,11,2
SRB,GBR,2006.0,15,7,8
ROU,GBR,2011.0,14,15,-1
IND,RUS,2001.0,3,3,0
IRN,CAN,2019.0,364,76,288
CHE,ITA,2017.0,115,306,-191
DNK,NLD,2010.0,13,26,-13
MEX,COL,2005.0,8,6,2
COL,MEX,2011.0,22,25,-3
DEU,NOR,2008.0,62,15,47
NOR,TZA,2013.0,4,7,-3
LBN,USA,2005.0,36,40,-4
USA,ZAF,2007.0,68,61,7
GBR,DNK,2019.0,139,114,25
BEL,ESP,2019.0,74,85,-11
SGP,GBR,2015.0,98,158,-60
ITA,DNK,2006.0,19,9,10
IRL,USA,2006.0,81,114,-33
IND,MYS,2017.0,79,62,17
MYS,IND,2021.0,85,63,22
CAN,ARE,2010.0,13,7,6
FRA,AUS,2016.0,107,95,12
IDN,IND,2010.0,5,10,-5
CHL,AUS,2011.0,15,6,9
MYS,GBR,2013.0,64,199,-135
SGP,JPN,2007.0,13,23,-10
DEU,CZE,2009.0,37,28,9
CUB,ESP,2010.0,45,18,27
RUS,FRA,2005.0,63,49,14
CHE,POL,2011.0,12,23,-11
USA,URY,2007.0,9,10,-1
RUS,IRN,2007.0,7,1,6
FRA,JPN,2013.0,95,75,20
CUB,CHL,2012.0,5,4,1
VEN,USA,2005.0,44,39,5
SWE,FRA,2015.0,47,87,-40
IND,LKA,2010.0,2,6,-4
SAU,JOR,2018.0,41,31,10
USA,GMB,2018.0,2,6,-4
USA,GMB,2022.0,3,1,2
CAN,DZA,2012.0,2,3,-1
RUS,NLD,2002.0,25,14,11
ISR,NZL,2007.0,3,1,2
NZL,ISR,2013.0,2,1,1
GRL,CAN,2018.0,2,1,1
FRA,DZA,2006.0,58,35,23
EGY,SAU,2000.0,24,30,-6
DEU,SWE,2001.0,90,97,-7
RUS,FRA,2002.0,74,60,14
VEN,USA,2012.0,30,24,6
IRN,SWE,2010.0,21,19,2
GBR,NLD,1998.0,136,140,-4
ZAF,ITA,2007.0,5,4,1
SRB,USA,2017.0,28,26,2
SEN,FRA,2018.0,25,54,-29
CHL,CAN,2015.0,18,27,-9
IRN,FRA,2014.0,18,34,-16
LTU,RUS,2004.0,3,3,0
CAN,ESP,2009.0,36,31,5
RUS,JPN,2000.0,49,48,1
UKR,RUS,2013.0,78,58,20
ITA,DNK,2010.0,36,12,24
ESP,USA,1997.0,241,268,-27
ARG,ITA,2009.0,13,18,-5
DEU,ISR,2015.0,62,51,11
GBR,HUN,2010.0,34,33,1
UZB,DEU,2009.0,4,3,1
BRA,ISR,2019.0,13,2,11
IND,FRA,2000.0,31,15,16
USA,PAK,2015.0,82,93,-11
NLD,KOR,2005.0,7,1,6
ESP,DEU,2023.0,140,173,-33
ISL,DEU,2011.0,5,7,-2
CHL,ESP,2016.0,92,153,-61
IRL,CAN,2009.0,23,35,-12
NZL,CAN,2007.0,29,31,-2
SRB,HRV,2002.0,6,7,-1
ESP,USA,2002.0,355,397,-42
PAK,SAU,2001.0,10,4,6
CHE,JPN,2007.0,37,29,8
SGP,KWT,2016.0,1,1,0
POL,DEU,2017.0,85,81,4
NZL,DEU,2009.0,36,41,-5
KEN,CHN,2008.0,1,2,-1
BRA,CHE,2020.0,35,29,6
CUB,MEX,2007.0,15,14,1
PSE,GBR,2011.0,1,1,0
GBR,AUS,1998.0,301,249,52
AUS,FRA,2003.0,40,57,-17
AUS,BRN,2013.0,3,5,-2
DEU,EGY,2017.0,59,48,11
TUR,SAU,2010.0,7,4,3
TWN,GBR,2002.0,25,39,-14
GBR,TWN,2005.0,39,17,22
BRA,FRA,2003.0,70,89,-19
USA,CUB,2006.0,7,5,2
SWE,DEU,2017.0,143,187,-44
PRT,ESP,2004.0,34,43,-9
NLD,VNM,2006.0,7,3,4
ZAF,GBR,2001.0,87,68,19
RUS,CAN,1998.0,33,14,19
SVN,DEU,1999.0,5,4,1
CAN,ESP,2011.0,46,56,-10
POL,DEU,2018.0,91,92,-1
BLR,RUS,2019.0,22,15,7
RUS,CHN,2020.0,55,44,11
NOR,ISL,2001.0,3,1,2
RUS,SWE,2000.0,41,24,17
CHE,USA,1998.0,360,316,44
USA,CHE,1999.0,335,395,-60
USA,SGP,2016.0,220,222,-2
BRA,BEL,2018.0,21,24,-3
GBR,ARG,2012.0,20,20,0
USA,IDN,2017.0,57,24,33
LTU,SWE,2009.0,5,6,-1
USA,FIN,2003.0,102,95,7
GBR,TWN,2002.0,39,25,14
FRA,MDG,2018.0,15,17,-2
FRA,MDG,2022.0,7,3,4
POL,ITA,2007.0,15,11,4
FRA,CMR,2002.0,17,19,-2
HUN,AUT,2015.0,15,17,-2
GBR,NLD,2020.0,390,385,5
GBR,CHN,2001.0,104,95,9
SWE,UKR,2017.0,5,8,-3
TWN,HKG,2008.0,15,10,5
TZA,NOR,2009.0,4,7,-3
GBR,ARM,2009.0,1,1,0
ESP,ARG,2019.0,85,106,-21
MEX,GBR,2013.0,36,50,-14
USA,JOR,2005.0,38,19,19
DEU,IDN,2012.0,32,4,28
ITA,GRC,2020.0,29,33,-4
ESP,CHE,2012.0,76,51,25
AUS,JPN,2013.0,63,68,-5
ZWE,ZAF,1998.0,5,3,2
ITA,RUS,2003.0,40,23,17
KEN,GBR,2016.0,29,21,8
SDN,GBR,2008.0,1,3,-2
KWT,EGY,2015.0,15,12,3
CHL,CUB,2017.0,3,10,-7
IRN,MYS,2010.0,50,35,15
ITA,KOR,2017.0,17,5,12
ZAF,AUS,2015.0,44,29,15
IND,USA,2023.0,918,518,400
GBR,URY,2004.0,2,1,1
ARG,ESP,2010.0,91,89,2
FJI,AUS,2008.0,9,4,5
SWE,ISL,2009.0,12,6,6
MYS,IND,2019.0,69,67,2
NZL,AUT,2012.0,5,3,2
USA,NGA,2018.0,62,52,10
CUB,AUS,2006.0,1,1,0
THA,NLD,2011.0,11,5,6
GBR,ISR,2017.0,68,66,2
GRC,CHE,2022.0,26,27,-1
IRL,DEU,2017.0,41,35,6
KOR,CAN,2007.0,45,43,2
CAN,KOR,2008.0,35,42,-7
ARE,FRA,2018.0,10,17,-7
FRA,ARE,2019.0,21,5,16
RUS,SWE,2006.0,25,18,7
CZE,CHE,2008.0,15,11,4
CAN,TWN,2006.0,15,8,7
PNG,GBR,1997.0,3,1,2
DNK,DEU,2013.0,97,103,-6
THA,AUT,2008.0,4,5,-1
FRA,ISR,2019.0,39,32,7
CZE,IND,2012.0,1,2,-1
IDN,FRA,1997.0,2,3,-1
USA,GEO,2003.0,26,58,-32
USA,ZAF,2020.0,103,141,-38
FRA,NLD,2005.0,84,90,-6
JAM,CAN,2009.0,3,1,2
IRN,CAN,2021.0,492,84,408
CYP,DEU,2017.0,8,3,5
USA,IRL,2011.0,129,149,-20
AUT,IND,2008.0,3,6,-3
ZAF,BHR,2004.0,2,1,1
IRL,CAN,2019.0,62,52,10
UGA,COG,2020.0,5,2,3
CHE,ARG,2009.0,3,2,1
ESP,GRC,2013.0,17,26,-9
CHE,CHL,1999.0,2,3,-1
RUS,DEU,2018.0,117,107,10
USA,SGP,2018.0,224,271,-47
FRA,AUS,2022.0,57,66,-9
DEU,AUS,2019.0,189,172,17
MEX,ITA,2021.0,28,15,13
TUR,CHE,2016.0,18,5,13
LTU,DEU,2018.0,11,4,7
PAK,FRA,2020.0,14,19,-5
JPN,THA,2019.0,143,106,37
NLD,SRB,2020.0,6,3,3
USA,IDN,2016.0,41,22,19
CAN,CHN,2021.0,521,421,100
DEU,SVK,2017.0,17,7,10
NLD,IRL,2022.0,19,28,-9
ITA,ISR,2021.0,28,17,11
KEN,DEU,2023.0,12,4,8
CHN,ARE,2022.0,20,20,0
CHN,IND,2022.0,160,74,86
TWN,SGP,2019.0,21,19,2
ZAF,ITA,2020.0,15,8,7
KOR,BGD,2017.0,38,27,11
FRA,CHN,2023.0,155,130,25
POL,NLD,2022.0,15,16,-1
GBR,ITA,2023.0,313,200,113
OMN,CAN,2021.0,5,8,-3
FRA,VNM,2020.0,80,26,54
CAN,ESP,2021.0,72,69,3
KOR,AUS,2023.0,25,20,5
JPN,VNM,2019.0,110,38,72
ARE,OMN,2020.0,2,6,-4
MWI,ZWE,2018.0,3,1,2
SVN,DEU,2020.0,15,11,4
TZA,THA,2019.0,1,1,0
BRA,IND,2018.0,17,14,3
DEU,USA,2005.0,1205,1077,128
ITA,ESP,2012.0,190,148,42
RUS,USA,2014.0,195,195,0
CHN,USA,2007.0,1330,1038,292
GBR,AUS,2017.0,652,589,63
PRT,NLD,2016.0,38,17,21
AUS,BEL,2016.0,29,49,-20
THA,JPN,2004.0,34,68,-34
BRA,PRT,2007.0,48,52,-4
ISR,USA,2006.0,415,252,163
USA,JPN,2009.0,1129,1134,-5
TUR,USA,2004.0,176,229,-53
JPN,CAN,2011.0,98,92,6
DEU,AUS,2008.0,153,111,42
CHE,USA,2016.0,573,614,-41
USA,CHE,2018.0,600,595,5
CAN,USA,2011.0,1748,1595,153
PER,USA,2008.0,33,35,-2
SGP,AUS,2017.0,95,97,-2
DEU,USA,2002.0,1515,1320,195
ISR,CAN,2008.0,52,27,25
USA,CHE,2017.0,577,624,-47
POL,USA,2010.0,113,143,-30
JPN,USA,2006.0,1284,1110,174
HKG,GBR,2009.0,46,46,0
USA,CAN,2017.0,1603,2136,-533
DEU,ITA,2012.0,165,274,-109
USA,GBR,2007.0,1504,1465,39
FRA,LBN,2017.0,101,50,51
BEL,NLD,2018.0,204,190,14
GBR,BEL,2005.0,72,61,11
DEU,AUS,2004.0,98,73,25
VEN,ECU,2019.0,50,8,42
ESP,ARG,2008.0,75,83,-8
CZE,SVK,2005.0,23,27,-4
CHE,POL,2014.0,15,17,-2
IRL,DNK,2004.0,4,4,0
USA,CHN,2013.0,2730,2577,153
NLD,FRA,2005.0,90,84,6
SWE,DNK,2005.0,56,62,-6
BEL,USA,2010.0,150,143,7
USA,TUR,2012.0,284,249,35
PRT,DNK,2008.0,6,1,5
DEU,COL,2010.0,17,7,10
GBR,JPN,2002.0,140,153,-13
MYS,USA,2007.0,26,21,5
ITA,ESP,2002.0,81,91,-10
DEU,CHE,2002.0,467,320,147
TUR,FRA,2006.0,10,13,-3
USA,AUS,2002.0,530,640,-110
GBR,SWE,2012.0,170,130,40
AUT,ITA,2007.0,23,31,-8
USA,CHL,2006.0,81,78,3
GBR,NZL,2019.0,149,132,17
FRA,DEU,2013.0,356,330,26
FRA,USA,2010.0,868,779,89
USA,FRA,2015.0,783,1004,-221
JPN,CHN,2018.0,528,345,183
ITA,USA,2009.0,601,416,185
KOR,JPN,2000.0,95,109,-14
USA,JPN,2021.0,826,695,131
RUS,USA,2004.0,321,319,2
USA,TUN,2008.0,6,3,3
AUS,IDN,2017.0,96,28,68
CHN,SGP,2003.0,92,53,39
AUS,ZAF,2009.0,12,31,-19
GRC,FRA,2013.0,63,17,46
AUS,ISR,2021.0,26,18,8
CAN,USA,2009.0,1656,1461,195
CHN,JPN,2002.0,255,279,-24
FRA,CHN,2003.0,48,53,-5
FRA,MEX,2005.0,57,31,26
GBR,GRC,2008.0,206,121,85
CAN,THA,2003.0,13,5,8
GBR,THA,2003.0,60,17,43
USA,FRA,2008.0,730,808,-78
CAN,GBR,2015.0,422,403,19
USA,CAN,2018.0,1678,2119,-441
USA,BRA,2015.0,470,534,-64
GRC,GBR,2008.0,121,206,-85
NOR,DEU,2007.0,19,53,-34
ITA,IRN,2012.0,14,33,-19
DEU,FRA,2001.0,313,297,16
CHE,JPN,2017.0,37,42,-5
CAN,AUS,2006.0,128,113,15
SGP,CHN,2011.0,158,224,-66
FRA,CAN,2008.0,293,204,89
GBR,CAN,2010.0,366,356,10
KOR,USA,2012.0,754,1080,-326
FRA,USA,2006.0,762,715,47
ESP,URY,2015.0,20,6,14
TWN,JPN,2014.0,53,46,7
DEU,GBR,2009.0,591,508,83
UKR,DEU,2008.0,26,21,5
USA,BRA,2014.0,438,487,-49
NLD,IDN,2005.0,8,5,3
NZL,USA,2010.0,103,144,-41
JPN,CHN,2016.0,567,346,221
SGP,USA,2014.0,218,295,-77
TWN,USA,2004.0,221,333,-112
UKR,KOR,2004.0,3,2,1
FRA,MAR,2011.0,102,48,54
DEU,JPN,2010.0,103,127,-24
JPN,USA,2010.0,1094,1111,-17
BEL,GBR,2008.0,78,88,-10
USA,THA,2014.0,255,115,140
USA,IRN,2004.0,34,34,0
ITA,USA,2011.0,642,489,153
SAU,EGY,2019.0,320,394,-74
BGD,KOR,2015.0,25,24,1
USA,JPN,2011.0,1043,991,52
IRN,CAN,2004.0,36,44,-8
USA,IRL,2008.0,120,105,15
GIN,PNG,2016.0,1,1,0
IND,GBR,2017.0,229,192,37
ISR,GRC,2008.0,2,2,0
AUS,FRA,2006.0,42,62,-20
UKR,SVK,2000.0,2,1,1
RUS,NOR,2006.0,16,11,5
USA,NOR,2014.0,89,75,14
GBR,AUS,2016.0,643,604,39
JPN,GBR,2016.0,123,147,-24
FRA,ESP,2010.0,261,189,72
ITA,CAN,2009.0,59,49,10
CAN,ITA,2010.0,41,68,-27
CHN,HKG,2013.0,695,594,101
COL,USA,2010.0,103,83,20
AUT,GBR,2011.0,61,70,-9
GBR,CHE,2021.0,353,284,69
VNM,NLD,2001.0,2,1,1
NLD,USA,2003.0,302,292,10
AUS,BRA,2003.0,10,12,-2
IND,USA,2003.0,599,359,240
CAN,GBR,2008.0,338,350,-12
CHN,AUS,2012.0,210,184,26
JOR,SAU,2009.0,17,5,12
MEX,RUS,2016.0,6,6,0
CHE,NOR,2013.0,21,9,12
ITA,GBR,2015.0,595,360,235
CHE,SWE,2004.0,23,31,-8
FRA,JPN,2010.0,82,103,-21
DEU,BEL,2013.0,100,104,-4
CHE,DEU,2013.0,464,660,-196
ITA,GBR,2014.0,525,333,192
USA,TWN,2012.0,340,291,49
TUR,RUS,2007.0,2,4,-2
ARG,USA,2012.0,114,111,3
FRA,USA,2000.0,840,587,253
FRA,EGY,2012.0,29,8,21
JPN,IDN,2013.0,122,32,90
USA,CAN,2016.0,1590,2093,-503
RWA,USA,2013.0,8,8,0
USA,CRI,2014.0,21,18,3
ZAF,GBR,2021.0,126,65,61
USA,HUN,2018.0,62,76,-14
PAK,AUT,2013.0,7,28,-21
ITA,GBR,2004.0,223,205,18
RUS,DEU,2007.0,145,103,42
PRT,RUS,2018.0,8,4,4
EGY,SAU,2003.0,52,45,7
DEU,KOR,2015.0,51,59,-8
USA,BRA,2008.0,353,403,-50
USA,THA,2015.0,257,129,128
CHE,IND,2016.0,24,36,-12
USA,DEU,2009.0,1148,1241,-93
FRA,POL,2019.0,72,42,30
USA,GRC,2018.0,100,134,-34
USA,ITA,2003.0,543,537,6
USA,SVN,1998.0,12,4,8
CUB,ESP,2003.0,43,21,22
USA,EGY,2007.0,112,51,61
USA,ESP,2010.0,441,442,-1
SGP,KOR,2015.0,27,25,2
DNK,SWE,2005.0,62,56,6
DEU,HUN,2006.0,45,38,7
DEU,GRC,2010.0,35,52,-17
GRC,GBR,2015.0,272,137,135
SGP,USA,2004.0,128,103,25
KOR,DEU,2004.0,23,23,0
EGY,NLD,2007.0,4,2,2
NOR,USA,2023.0,51,63,-12
USA,GBR,1998.0,1071,1167,-96
CHN,GBR,2016.0,378,476,-98
CHE,AUT,2006.0,40,46,-6
NLD,DNK,2012.0,25,24,1
RUS,USA,2008.0,207,185,22
ITA,FRA,2005.0,219,168,51
BEL,ITA,2013.0,63,91,-28
GBR,NOR,2017.0,102,62,40
CMR,FRA,2001.0,14,13,1
ISR,NLD,2001.0,10,9,1
DEU,ESP,2015.0,161,315,-154
ITA,BEL,2014.0,118,73,45
USA,QAT,2013.0,44,21,23
USA,IRL,2015.0,133,165,-32
CAN,IRN,2004.0,44,36,8
USA,CAN,2022.0,1468,1421,47
CAN,GBR,2001.0,238,290,-52
FRA,CIV,2011.0,49,22,27
FRA,CIV,2009.0,27,41,-14
USA,DNK,2013.0,160,135,25
FIN,CHE,2014.0,8,15,-7
AUS,MYS,2003.0,10,9,1
DEU,UKR,2020.0,14,32,-18
NZL,GBR,2005.0,96,127,-31
USA,FRA,2004.0,667,782,-115
DEU,GBR,2011.0,585,634,-49
CHN,JPN,2012.0,343,532,-189
NGA,GBR,2015.0,43,46,-3
IRN,NLD,2012.0,37,14,23
TWN,USA,2014.0,308,319,-11
SWE,FRA,2021.0,73,113,-40
USA,RUS,2011.0,186,190,-4
ESP,ARG,2015.0,130,85,45
IND,CAN,2007.0,102,43,59
USA,IRL,2001.0,64,57,7
CAN,BEL,2013.0,32,43,-11
USA,AUS,2012.0,718,611,107
FRA,RUS,2004.0,45,55,-10
PRI,PRT,2014.0,1,1,0
DEU,RUS,2010.0,123,141,-18
RUS,CHN,2018.0,18,26,-8
DEU,FRA,2008.0,354,345,9
NLD,DEU,2012.0,259,228,31
CHE,NLD,2019.0,91,127,-36
JPN,THA,2008.0,76,27,49
FIN,NOR,2018.0,42,17,25
NOR,FIN,2022.0,22,25,-3
ESP,GBR,2005.0,178,174,4
CHN,USA,2020.0,4047,4243,-196
CHN,DEU,2005.0,124,124,0
USA,CHN,2003.0,694,867,-173
LVA,GBR,2012.0,2,1,1
GUF,FRA,2022.0,41,20,21
USA,FRA,2014.0,831,955,-124
DEU,CHE,2012.0,669,499,170
UGA,USA,2009.0,11,18,-7
FIN,USA,2008.0,66,66,0
FIN,USA,2015.0,83,84,-1
JPN,DEU,2008.0,113,112,1
KEN,USA,2020.0,63,65,-2
GBR,ESP,2009.0,252,269,-17
JPN,FRA,2007.0,70,74,-4
USA,GBR,1999.0,1119,1354,-235
POL,GBR,2003.0,36,32,4
SGP,CHN,2009.0,138,178,-40
GRC,PRT,2012.0,4,1,3
CMR,USA,2003.0,6,6,0
GBR,NLD,2016.0,290,361,-71
GRC,CYP,2023.0,32,23,9
ESP,CZE,2020.0,35,22,13
GBR,CHN,2009.0,207,187,20
USA,TUR,2005.0,250,190,60
KOR,DEU,2008.0,30,29,1
CAN,USA,2019.0,2105,1960,145
SWE,NLD,2005.0,30,27,3
SWE,NLD,2002.0,39,29,10
RUS,ITA,2001.0,43,32,11
CAN,CHN,2004.0,98,118,-20
CHE,FRA,2006.0,198,249,-51
CAN,DNK,2009.0,16,9,7
COL,ESP,2016.0,61,120,-59
GBR,MEX,2022.0,44,50,-6
TWN,CHN,2013.0,171,143,28
ESP,GBR,2012.0,314,285,29
BEL,USA,2006.0,128,114,14
DEU,THA,2021.0,34,23,11
KOR,USA,2002.0,591,568,23
USA,BEL,2016.0,147,234,-87
JPN,THA,2014.0,93,69,24
USA,AUS,1997.0,332,288,44
DEU,DNK,2007.0,83,61,22
ESP,NLD,2010.0,65,88,-23
TWN,USA,2001.0,203,296,-93
SGP,HKG,2023.0,33,40,-7
USA,BGR,2013.0,13,9,4
IRN,USA,2020.0,544,136,408
FRA,DNK,2015.0,30,37,-7
GHA,CHN,2014.0,7,5,2
CHN,USA,1999.0,515,299,216
CHE,SWE,2008.0,24,38,-14
SWE,CHE,2013.0,46,73,-27
SWE,IND,2017.0,32,43,-11
CAN,GBR,2014.0,389,403,-14
FRA,DEU,2003.0,314,312,2
DEU,CHN,2013.0,286,310,-24
IND,IDN,2017.0,35,6,29
AUS,CHN,2015.0,293,354,-61
GBR,DEU,2007.0,390,543,-153
TUR,USA,2014.0,237,355,-118
GRC,ISR,2018.0,6,1,5
GBR,IND,2005.0,83,104,-21
KEN,USA,1999.0,18,15,3
DEU,AUT,2013.0,303,342,-39
USA,ZAF,2016.0,131,137,-6
CHN,DEU,2012.0,292,250,42
AUS,LKA,2013.0,18,7,11
SGP,SAU,2015.0,13,2,11
ISR,CAN,2014.0,50,49,1
BEL,GBR,2004.0,79,57,22
GBR,GRC,2004.0,122,79,43
GBR,UKR,2003.0,19,22,-3
SWE,CHN,2006.0,46,28,18
IRL,ISR,2011.0,28,5,23
NLD,BGR,2014.0,2,3,-1
GRC,GBR,2004.0,79,122,-43
JPN,TUR,2009.0,12,8,4
ARE,TUR,2022.0,2,5,-3
CHE,NLD,2011.0,48,77,-29
CAN,DEU,2020.0,207,200,7
GBR,DEU,1999.0,323,369,-46
BEL,GRC,2004.0,11,5,6
BEL,FRA,2022.0,179,229,-50
USA,AUT,2005.0,88,103,-15
ITA,CZE,2011.0,7,5,2
FRA,GRC,1998.0,23,19,4
USA,SGP,2007.0,163,136,27
PRT,ESP,2009.0,62,66,-4
PRT,USA,2016.0,80,72,8
AUS,THA,2006.0,35,16,19
DEU,CAN,2017.0,183,194,-11
CAN,GRC,2001.0,14,11,3
CAN,GRC,2004.0,11,1,10
CRI,ESP,2003.0,2,5,-3
BRA,COL,2017.0,77,69,8
USA,IRL,2014.0,126,137,-11
USA,NLD,2014.0,389,424,-35
USA,ISR,2000.0,305,377,-72
USA,ISR,2006.0,252,415,-163
MEX,ESP,2021.0,157,152,5
GBR,ITA,2003.0,264,227,37
FRA,GRC,1999.0,27,18,9
SWE,JPN,2016.0,27,36,-9
NLD,LUX,2020.0,10,11,-1
SWE,GBR,2016.0,175,173,2
IND,EGY,2007.0,2,3,-1
USA,HUN,2022.0,33,50,-17
RUS,GBR,2006.0,54,30,24
AUS,ESP,2010.0,28,28,0
FRA,GBR,2012.0,419,420,-1
JOR,SAU,2011.0,44,11,33
DEU,NGA,2004.0,8,5,3
DZA,FRA,2016.0,64,128,-64
MEX,IND,2009.0,8,7,1
NLD,BEL,2003.0,98,116,-18
FIN,EST,2008.0,9,11,-2
USA,BRA,2001.0,315,304,11
DEU,JPN,2006.0,93,121,-28
CAN,IRN,2008.0,50,82,-32
TWN,CHN,2003.0,83,133,-50
NGA,MYS,2021.0,55,139,-84
MYS,ARE,2022.0,22,5,17
DEU,ARG,2013.0,28,35,-7
BEL,MAR,2015.0,3,1,2
GBR,NLD,2018.0,388,313,75
CHN,AUS,2005.0,55,63,-8
CAN,USA,2021.0,1850,1653,197
NZL,GBR,2002.0,118,98,20
IND,NZL,2003.0,8,10,-2
FRA,REU,2022.0,20,27,-7
ESP,ITA,2006.0,102,104,-2
MEX,USA,2005.0,193,215,-22
ITA,DEU,2002.0,178,162,16
USA,BRA,2004.0,286,286,0
NZL,AUS,2006.0,125,95,30
CAN,BRA,1999.0,29,26,3
FRA,SEN,2012.0,52,27,25
JPN,GBR,2018.0,131,158,-27
AUS,IND,1999.0,19,24,-5
AUS,GBR,2003.0,394,486,-92
JPN,BGD,2011.0,73,48,25
CHN,SGP,2013.0,222,239,-17
MAC,HKG,2020.0,12,21,-9
HKG,MAC,2022.0,12,8,4
USA,HKG,2000.0,90,87,3
SWE,DNK,2012.0,85,72,13
CAN,QAT,2017.0,19,11,8
GBR,NOR,2016.0,72,65,7
CAN,BGD,2015.0,14,28,-14
USA,IDN,2007.0,22,23,-1
IDN,SGP,2010.0,4,4,0
CAN,DNK,2011.0,29,23,6
MYS,IND,2015.0,74,93,-19
MYS,USA,2020.0,59,38,21
SWE,DEU,2007.0,113,90,23
IRN,QAT,2019.0,3,1,2
VEN,ESP,2016.0,34,28,6
VEN,CHL,2018.0,21,1,20
GBR,ESP,2011.0,312,296,16
FRA,GBR,2005.0,372,299,73
USA,PER,2016.0,40,60,-20
COL,DEU,2000.0,5,7,-2
COL,AUS,2011.0,14,2,12
AUT,DEU,2007.0,200,291,-91
SWE,ITA,2012.0,22,57,-35
HUN,HRV,2021.0,3,2,1
JPN,KOR,2011.0,151,99,52
AUS,IRL,2018.0,42,30,12
IND,USA,2013.0,1058,905,153
CHN,KOR,2001.0,32,20,12
CHE,CAN,2006.0,76,56,20
CZE,SWE,2008.0,8,11,-3
USA,TWN,2005.0,326,200,126
JPN,NZL,2004.0,15,5,10
ARG,PER,2022.0,11,6,5
DEU,USA,1997.0,873,793,80
NZL,AUS,2010.0,165,100,65
TWN,USA,2008.0,262,310,-48
USA,ESP,2000.0,299,335,-36
UKR,POL,2003.0,22,13,9
KOR,JPN,2010.0,112,132,-20
ITA,SWE,2012.0,57,22,35
FRA,MAR,2009.0,92,44,48
KOR,USA,1997.0,216,363,-147
ZAF,CHN,2004.0,1,2,-1
CZE,CHE,2021.0,23,15,8
IRL,FIN,2010.0,5,1,4
DEU,ITA,2005.0,144,151,-7
FRA,SAU,2012.0,32,6,26
CZE,CHN,2014.0,2,7,-5
SGP,USA,2008.0,166,183,-17
RUS,ISR,2011.0,12,8,4
ITA,ISR,2004.0,5,12,-7
GBR,RUS,2020.0,57,79,-22
CAN,KOR,2011.0,44,45,-1
DEU,AUS,2014.0,158,143,15
DEU,BLR,1998.0,9,14,-5
AUS,CHL,2014.0,17,19,-2
NOR,GBR,2007.0,33,43,-10
TWN,IND,2008.0,17,52,-35
CHN,HKG,2003.0,281,312,-31
CHN,USA,1998.0,407,304,103
GBR,NLD,2017.0,285,388,-103
USA,DEU,2019.0,1264,1331,-67
OMN,JOR,2015.0,3,1,2
USA,ESP,2006.0,373,324,49
GBR,KOR,2008.0,37,25,12
POL,NLD,2007.0,16,13,3
JPN,TWN,2011.0,51,52,-1
CZE,GBR,2002.0,43,43,0
DEU,KOR,2014.0,48,55,-7
RUS,USA,2015.0,182,215,-33
CHN,FRA,2006.0,67,46,21
FRA,CAN,2014.0,366,294,72
HKG,IRL,2011.0,3,1,2
IRL,GBR,2013.0,296,234,62
AUT,JPN,2016.0,13,12,1
ITA,NGA,2011.0,2,1,1
GBR,DNK,2014.0,101,94,7
FRA,GBR,2002.0,399,403,-4
GBR,VEN,2000.0,11,7,4
ITA,FRA,2012.0,358,210,148
USA,ARG,1997.0,78,66,12
NOR,CHN,2020.0,37,37,0
ESP,GBR,1997.0,104,121,-17
OMN,MYS,2017.0,2,18,-16
KOR,USA,2005.0,628,732,-104
USA,GBR,2020.0,1837,2077,-240
ITA,CHE,2008.0,168,85,83
ESP,DEU,2003.0,109,119,-10
DEU,ESP,2008.0,157,142,15
KOR,ESP,2015.0,3,10,-7
IRL,USA,2003.0,83,99,-16
GBR,NZL,2011.0,134,117,17
DNK,EGY,2022.0,5,1,4
TUN,LBN,2016.0,2,1,1
CHN,PRT,2012.0,8,10,-2
DEU,KEN,2018.0,15,13,2
CHE,DEU,2003.0,333,482,-149
BEL,FRA,2016.0,227,245,-18
USA,THA,2004.0,179,64,115
USA,CHE,2022.0,507,426,81
SWE,NZL,2002.0,5,6,-1
GEO,DEU,2016.0,6,5,1
TWN,IND,2014.0,63,49,14
RUS,KOR,2011.0,15,20,-5
BEL,SWE,2011.0,21,10,11
BEL,SWE,2019.0,37,21,16
SWE,BEL,2020.0,35,27,8
GBR,ITA,2013.0,285,449,-164
USA,KEN,2014.0,63,55,8
TWN,USA,2015.0,304,321,-17
NGA,USA,2003.0,16,15,1
GBR,AUT,2016.0,107,86,21
USA,CZE,2008.0,57,49,8
FRA,CAN,2004.0,212,150,62
AUS,ISR,2009.0,9,28,-19
ISR,USA,2010.0,397,318,79
GBR,JPN,2005.0,124,117,7
USA,GRC,2022.0,87,98,-11
AUS,IND,2007.0,29,58,-29
DEU,BGR,2003.0,24,33,-9
URY,USA,2006.0,12,12,0
HUN,AUT,2011.0,17,16,1
USA,HKG,2010.0,128,136,-8
IRN,USA,2007.0,64,42,22
ITA,DEU,2012.0,274,165,109
ESP,DEU,2013.0,236,191,45
NGA,GBR,2014.0,35,58,-23
SWE,GBR,2017.0,147,194,-47
GBR,ESP,2019.0,434,460,-26
ESP,IND,2014.0,15,13,2
IND,LBY,2011.0,8,4,4
FRA,ITA,2007.0,195,238,-43
CHN,FRA,2010.0,109,91,18
GMB,UGA,2017.0,1,1,0
GBR,NOR,2018.0,115,63,52
IRL,NZL,2010.0,9,4,5
BIH,AUT,2009.0,1,1,0
AUT,BIH,2018.0,2,4,-2
COL,DEU,2010.0,7,17,-10
PRT,DEU,2001.0,11,17,-6
SVK,CZE,2003.0,42,34,8
CHN,KOR,2008.0,92,73,19
GBR,IND,2012.0,156,150,6
CHE,ITA,1998.0,80,97,-17
FRA,ESP,2023.0,152,127,25
CZE,AUT,2010.0,7,10,-3
RUS,UKR,2001.0,68,61,7
BEL,USA,2000.0,150,107,43
USA,NZL,2010.0,144,103,41
CYP,GBR,2017.0,17,35,-18
GEO,USA,2018.0,221,226,-5
UKR,BEL,2012.0,3,2,1
SVN,ARG,2018.0,1,1,0
TUR,USA,2008.0,213,240,-27
NZL,USA,2006.0,107,113,-6
GBR,SWE,2005.0,83,93,-10
JPN,THA,2004.0,68,34,34
THA,JPN,2014.0,69,93,-24
JPN,THA,2015.0,114,64,50
USA,SGP,1998.0,66,52,14
CHN,CAN,2005.0,127,104,23
GBR,PRT,2010.0,89,66,23
RUS,ISR,2021.0,30,12,18
ITA,ISR,2008.0,9,11,-2
DEU,SWE,2019.0,189,161,28
CAN,KOR,2009.0,37,49,-12
AUS,CAN,2009.0,149,195,-46
LVA,DEU,2006.0,3,3,0
FRA,SWE,2005.0,40,45,-5
AUT,BRA,2002.0,5,3,2
JPN,DEU,2014.0,141,131,10
DEU,CHE,1997.0,243,191,52
RUS,JPN,2003.0,48,44,4
USA,MYS,2016.0,44,50,-6
ARG,CHE,2015.0,11,9,2
JPN,USA,2023.0,401,388,13
AUS,KOR,1997.0,4,3,1
USA,RUS,2019.0,190,226,-36
GBR,JPN,2012.0,139,125,14
DEU,ISR,2021.0,78,80,-2
BRA,ARG,2005.0,14,19,-5
AUS,SGP,2020.0,87,101,-14
CHN,TWN,2007.0,55,56,-1
EGY,RUS,2007.0,3,3,0
JPN,FRA,2020.0,83,114,-31
NLD,GBR,2011.0,240,230,10
NLD,DNK,2005.0,17,8,9
ISR,GBR,1999.0,32,32,0
NZL,IRL,2008.0,8,11,-3
USA,NLD,2004.0,283,282,1
NGA,GBR,2008.0,20,29,-9
CHL,CAN,2009.0,11,5,6
DEU,ISR,2011.0,34,40,-6
USA,TWN,2002.0,302,229,73
GRC,USA,2004.0,101,124,-23
DEU,NGA,2008.0,12,11,1
AUT,USA,2003.0,110,128,-18
CHE,AUT,2010.0,54,52,2
CHE,MEX,2013.0,6,7,-1
MAR,FRA,2002.0,66,88,-22
CHL,FRA,2012.0,20,32,-12
IND,NLD,2010.0,39,19,20
KOR,CHN,2009.0,102,122,-20
BRA,FRA,2010.0,99,111,-12
CHE,GRC,2005.0,19,8,11
GBR,SGP,2013.0,103,69,34
KOR,IND,2020.0,182,247,-65
SWE,FRA,2011.0,49,51,-2
ISR,CHN,2007.0,13,5,8
CAN,AUS,2010.0,198,140,58
SWE,DEU,2020.0,186,220,-34
EGY,USA,2013.0,78,119,-41
DEU,NLD,2009.0,231,218,13
SGP,FRA,2007.0,11,14,-3
NZL,AUS,2023.0,84,57,27
ITA,CZE,2009.0,4,7,-3
HUN,CHE,2022.0,10,6,4
AUT,USA,2013.0,149,118,31
CZE,USA,2013.0,45,72,-27
USA,CZE,2014.0,76,54,22
DNK,CHN,2017.0,67,66,1
NLD,DEU,1997.0,110,107,3
GRC,GBR,2014.0,248,129,119
AUT,CHE,2000.0,22,23,-1
GBR,AUT,2018.0,97,102,-5
USA,KEN,2008.0,40,27,13
MEX,ESP,2009.0,124,120,4
AUT,CAN,2013.0,14,12,2
CHL,USA,2009.0,98,104,-6
SGP,MYS,2009.0,22,11,11
MYS,IND,2014.0,36,102,-66
DEU,DNK,2020.0,150,127,23
USA,CYM,2012.0,1,1,0
CZE,DEU,2016.0,72,59,13
TWN,IND,2001.0,7,27,-20
BEL,NZL,2006.0,4,2,2
ZAF,USA,2005.0,71,103,-32
GBR,BRA,2013.0,76,66,10
FRA,POL,2011.0,38,30,8
USA,URY,2016.0,12,19,-7
BRA,AUS,2009.0,18,10,8
ARM,RUS,2004.0,6,7,-1
CAN,IRN,2001.0,31,16,15
CHN,JPN,2005.0,248,391,-143
CHE,ITA,2020.0,184,296,-112
GRC,USA,2008.0,115,137,-22
USA,SYR,2008.0,3,7,-4
ITA,SWE,2005.0,25,24,1
DEU,FRA,2004.0,243,271,-28
GBR,AUT,2022.0,106,85,21
DNK,GBR,1999.0,44,61,-17
MYS,BGD,2017.0,66,25,41
DEU,COL,2000.0,7,5,2
PRI,USA,2012.0,142,98,44
GRC,IRL,2010.0,2,2,0
USA,ITA,2013.0,443,631,-188
BRA,FRA,2006.0,67,90,-23
USA,FRA,2001.0,679,901,-222
CHE,CHN,2009.0,50,30,20
CHE,CHN,2011.0,38,49,-11
AUS,NZL,2018.0,171,174,-3
FIN,NLD,2000.0,9,11,-2
POL,ITA,2018.0,16,38,-22
CAN,IRN,2014.0,61,269,-208
ZAF,USA,2002.0,101,108,-7
CAN,IRL,1998.0,14,8,6
EGY,DEU,2016.0,37,83,-46
ZAF,ZWE,2013.0,23,24,-1
GBR,MLT,2017.0,11,12,-1
GRC,BEL,2009.0,9,11,-2
AUT,HRV,2011.0,3,6,-3
ZAF,BEL,2017.0,6,12,-6
GBR,NLD,2022.0,359,240,119
SWE,AUT,2001.0,9,10,-1
AUS,CAN,2011.0,150,211,-61
ESP,JPN,2014.0,24,12,12
UGA,GBR,2007.0,10,8,2
USA,DEU,2021.0,1144,1175,-31
ITA,GBR,2008.0,293,220,73
HKG,AUS,2002.0,30,35,-5
FRA,CIV,2021.0,34,13,21
BRA,ESP,2007.0,46,53,-7
VEN,ECU,2021.0,16,19,-3
USA,CHE,2016.0,614,573,41
CAN,CHN,2008.0,165,186,-21
DEU,TUR,2010.0,51,42,9
SGP,KOR,2008.0,14,14,0
BEL,NOR,2003.0,2,1,1
GBR,ARE,2012.0,34,15,19
SWE,CHN,2010.0,56,79,-23
PSE,ISR,2013.0,21,12,9
BEL,POL,2013.0,15,10,5
BRA,RUS,2015.0,5,8,-3
SGP,IND,2016.0,78,95,-17
ARG,ITA,2015.0,20,17,3
GBR,CHN,2019.0,679,513,166
CAN,TUR,2013.0,19,22,-3
AUS,IRL,2017.0,39,44,-5
POL,BEL,2013.0,10,15,-5
NLD,FRA,2012.0,127,120,7
DEU,CAN,2018.0,185,178,7
CYP,GRC,2023.0,23,32,-9
THA,SGP,2011.0,7,4,3
MNP,USA,2012.0,3,1,2
NZL,CAN,2017.0,44,44,0
CAN,NZL,2020.0,41,42,-1
CHL,AUS,2014.0,19,17,2
AUS,CHL,2015.0,20,25,-5
ESP,ECU,2010.0,4,3,1
CAN,LBN,2011.0,4,7,-3
GRC,LUX,2020.0,5,2,3
GHA,AUS,2023.0,9,6,3
IRN,ARE,2015.0,3,3,0
BEL,FRA,2017.0,244,235,9
TWN,JPN,2015.0,60,48,12
NLD,CHE,2002.0,40,49,-9
BEL,AUS,2016.0,49,29,20
AUS,BEL,2018.0,31,30,1
BEL,KOR,2012.0,8,7,1
BGR,BEL,2005.0,3,5,-2
JPN,KOR,2009.0,149,122,27
ITA,CHE,2014.0,273,119,154
CHE,CAN,2010.0,82,105,-23
DEU,NOR,2009.0,63,15,48
BRA,CAN,2008.0,49,36,13
FRA,DZA,2013.0,120,63,57
GBR,CHE,2009.0,205,189,16
CAN,FIN,2006.0,8,12,-4
THA,TWN,2011.0,3,5,-2
HUN,USA,2005.0,84,81,3
AUS,SWE,2010.0,38,41,-3
DEU,GRC,2006.0,31,31,0
USA,NOR,2008.0,81,58,23
CAN,SVN,2010.0,1,1,0
ISR,USA,2000.0,377,305,72
NLD,CHE,2012.0,95,59,36
IND,DEU,2010.0,131,92,39
IND,PAK,2013.0,27,22,5
FRA,DNK,2008.0,24,25,-1
IND,ZAF,2013.0,48,19,29
CYP,TUR,2012.0,26,42,-16
ITA,USA,2021.0,510,454,56
BGD,BEL,2011.0,4,2,2
USA,COL,2016.0,150,136,14
IND,SGP,2019.0,114,82,32
IND,SGP,2009.0,56,22,34
NGA,USA,2013.0,36,40,-4
IND,GBR,2016.0,187,194,-7
CAN,SAU,2007.0,45,21,24
URY,SWE,2017.0,2,1,1
RUS,AUS,2018.0,18,17,1
NZL,SWE,2010.0,6,8,-2
BEL,IND,2007.0,10,10,0
USA,CMR,2003.0,6,6,0
CAN,CHN,2001.0,50,90,-40
ESP,MEX,2017.0,207,140,67
AUT,DEU,1999.0,144,156,-12
USA,NPL,2010.0,6,15,-9
BRA,ESP,1998.0,27,29,-2
GBR,IND,1997.0,62,58,4
DEU,PAK,2013.0,41,30,11
SWE,GEO,2004.0,2,1,1
ZMB,USA,1999.0,3,1,2
USA,ZAF,2018.0,116,138,-22
USA,NLD,2008.0,298,301,-3
GBR,KEN,2001.0,17,23,-6
SGP,CAN,2004.0,18,11,7
DZA,ARG,2009.0,3,2,1
NZL,IND,2008.0,2,9,-7
FRA,AUS,2007.0,67,53,14
HKG,NLD,2011.0,3,2,1
ARG,JPN,2005.0,1,3,-2
CHE,GBR,2006.0,143,156,-13
CAN,MEX,2014.0,32,40,-8
NLD,USA,2013.0,395,341,54
CAN,CZE,2010.0,14,6,8
ISL,SWE,2007.0,7,14,-7
GBR,CHE,2019.0,333,295,38
CAN,POL,2014.0,16,19,-3
MYS,GBR,2010.0,58,112,-54
CHN,ZAF,2013.0,6,6,0
ZAF,CHN,2015.0,6,8,-2
BRA,GBR,2018.0,170,139,31
DEU,RUS,2006.0,99,161,-62
ESP,COL,2002.0,19,11,8
CHN,MAC,2021.0,309,297,12
MAC,CHN,2022.0,291,368,-77
JPN,USA,2000.0,1419,1150,269
AUT,AUS,2012.0,57,27,30
PRT,GBR,1999.0,36,37,-1
CHN,GBR,2017.0,404,529,-125
PRT,BRA,2013.0,95,97,-2
USA,GRC,2016.0,101,134,-33
IND,CAN,2020.0,201,88,113
CHN,MAC,2011.0,31,30,1
FRA,DZA,2003.0,52,37,15
KEN,ETH,2011.0,5,2,3
USA,AUS,2005.0,478,490,-12
USA,CZE,2015.0,69,55,14
USA,NZL,2023.0,72,56,16
SWE,BEL,2007.0,9,6,3
AUT,DEU,1998.0,116,138,-22
BEL,FRA,2018.0,246,251,-5
DNK,DEU,2006.0,50,79,-29
ITA,CHE,2001.0,97,95,2
SRB,USA,2007.0,37,6,31
FRA,CAN,2015.0,380,262,118
CHN,PAK,2017.0,160,282,-122
USA,ZAF,2022.0,84,119,-35
TUR,CYP,2014.0,49,52,-3
PRT,CHN,2006.0,8,2,6
CAN,ISR,2014.0,49,50,-1
POL,FRA,2007.0,52,33,19
GBR,FIN,2010.0,54,46,8
ESP,FIN,2023.0,18,17,1
ESP,IND,2001.0,6,9,-3
GBR,DNK,2008.0,81,69,12
TUR,GBR,2013.0,46,66,-20
USA,TUR,2002.0,245,158,87
GBR,POL,2003.0,32,36,-4
DEU,ESP,2004.0,90,89,1
FRA,IND,2002.0,18,41,-23
ESP,ARG,2004.0,59,92,-33
JOR,SAU,2019.0,32,37,-5
PRT,GBR,1998.0,21,43,-22
KWT,CAN,2015.0,10,20,-10
CHN,DEU,1997.0,61,45,16
AUS,CHN,2004.0,58,63,-5
NOR,USA,2006.0,55,69,-14
CHE,POL,2001.0,15,12,3
FIN,IRN,2013.0,3,15,-12
ETH,ZAF,2021.0,10,18,-8
DEU,ZAF,2017.0,27,31,-4
CAN,CHN,2015.0,333,344,-11
TWN,CHL,2021.0,5,1,4
FRA,NOR,2002.0,27,17,10
GBR,SGP,2003.0,38,66,-28
FRA,THA,2011.0,27,13,14
JPN,CAN,2021.0,90,65,25
DNK,CAN,2016.0,31,26,5
FRA,IRL,2009.0,27,32,-5
DEU,ITA,1997.0,91,106,-15
NLD,NOR,2016.0,49,25,24
DEU,CUB,2020.0,6,8,-2
DEU,ISL,2019.0,6,3,3
DEU,FRA,2014.0,376,429,-53
OMN,IND,2014.0,14,21,-7
DEU,BEL,2003.0,69,78,-9
GBR,DEU,1998.0,337,314,23
NZL,DEU,2001.0,18,25,-7
IRL,DEU,2007.0,24,44,-20
USA,HKG,2006.0,81,108,-27
HKG,SGP,2023.0,40,33,7
CAN,AUT,2010.0,17,22,-5
HKG,TWN,2002.0,10,5,5
HUN,GBR,2005.0,23,20,3
IND,FRA,2003.0,32,17,15
FIN,USA,2004.0,85,94,-9
USA,ISR,2010.0,318,397,-79
DEU,CZE,2014.0,59,48,11
USA,TWN,1997.0,238,119,119
FRA,ITA,1999.0,152,189,-37
NZL,THA,2009.0,3,2,1
DEU,SWE,2009.0,121,95,26
GRC,USA,2015.0,145,101,44
ESP,BRA,2014.0,135,75,60
ISR,GBR,2007.0,42,20,22
BEL,ESP,2004.0,25,16,9
GBR,COL,2019.0,25,24,1
EGY,JPN,2007.0,20,37,-17
LAO,AUS,2007.0,1,1,0
SWE,UKR,2007.0,8,2,6
ESP,GRC,2006.0,13,7,6
GBR,BEL,2012.0,98,106,-8
JPN,PHL,2008.0,20,17,3
PRT,BEL,2006.0,6,4,2
SEN,FRA,2007.0,30,36,-6
ITA,ROU,2010.0,8,5,3
ESP,GBR,2002.0,192,170,22
FIN,CHN,2012.0,16,24,-8
SVK,NLD,2009.0,4,4,0
DEU,NZL,2010.0,25,28,-3
DEU,BGR,2013.0,16,10,6
ESP,PRT,2006.0,40,32,8
CHN,PRT,2005.0,4,4,0
BEL,NOR,2013.0,9,3,6
NZL,CHE,2005.0,9,5,4
AUT,SRB,2015.0,3,6,-3
ETH,GBR,2014.0,9,4,5
CHL,ARG,2011.0,17,29,-12
USA,IRL,2004.0,97,86,11
ZMB,USA,2007.0,4,7,-3
JPN,VNM,2004.0,10,4,6
VNM,JPN,2005.0,3,11,-8
CAN,THA,2013.0,22,7,15
CAN,SGP,2022.0,23,34,-11
TUR,IRN,2013.0,13,21,-8
LUX,GBR,2008.0,3,6,-3
FRA,BRA,2015.0,143,122,21
ZAF,USA,2012.0,93,117,-24
HUN,CZE,2015.0,8,2,6
CHE,GRC,2012.0,22,29,-7
AUT,CHE,2010.0,52,54,-2
SGP,GBR,2011.0,60,80,-20
TUR,AUS,2014.0,14,5,9
CHN,NOR,2002.0,10,2,8
AUS,HKG,2021.0,35,46,-11
GBR,HUN,2003.0,24,33,-9
ESP,FRA,2007.0,152,180,-28
GBR,ZAF,2020.0,84,125,-41
FRA,ESP,2006.0,153,150,3
SWE,GBR,2018.0,180,200,-20
FRA,HRV,2016.0,10,7,3
PRT,GBR,2007.0,40,50,-10
MEX,VEN,2008.0,10,6,4
ITA,FIN,2011.0,19,8,11
USA,ARG,2012.0,111,114,-3
CHN,PAK,2016.0,150,203,-53
JAM,USA,2003.0,12,9,3
KOR,SAU,2013.0,26,5,21
SAU,ETH,2020.0,2,3,-1
USA,SWE,2007.0,177,235,-58
PHL,AUS,2001.0,3,10,-7
SRB,DNK,2008.0,3,1,2
PAK,CAN,2016.0,25,24,1
PHL,USA,2020.0,42,44,-2
NLD,ESP,2012.0,75,65,10
IND,JPN,2013.0,92,90,2
JPN,IND,2020.0,81,137,-56
THA,USA,2008.0,106,226,-120
UKR,DEU,2001.0,49,18,31
SGP,PHL,2020.0,15,9,6
ETH,BEL,2004.0,1,1,0
CAN,HKG,2009.0,25,28,-3
CAN,SGP,2017.0,34,30,4
SVK,USA,2010.0,11,16,-5
NLD,UGA,2014.0,2,2,0
CHE,RUS,2011.0,10,31,-21
ITA,USA,2019.0,602,465,137
AUT,IDN,2010.0,3,1,2
CAN,MYS,2014.0,20,24,-4
ISR,GBR,2020.0,64,55,9
TUN,FRA,2012.0,87,127,-40
TUN,QAT,2022.0,4,3,1
CHN,GBR,2018.0,477,621,-144
FRA,MAR,2019.0,104,55,49
AUT,HRV,2009.0,5,3,2
DZA,FRA,2018.0,63,142,-79
DZA,FRA,2022.0,42,56,-14
DNK,USA,2006.0,87,107,-20
FRA,BEL,2018.0,251,246,5
BEL,DEU,2002.0,80,78,2
ARG,USA,2005.0,163,101,62
EGY,CAN,2004.0,15,10,5
DEU,COL,2006.0,6,4,2
IRL,GBR,2003.0,179,207,-28
CHL,AUT,2012.0,4,1,3
FRA,BRA,2004.0,70,51,19
ZMB,JPN,2009.0,1,2,-1
GBR,HKG,2005.0,24,34,-10
ARE,USA,2013.0,31,84,-53
BRA,CAN,2004.0,38,43,-5
KOR,GBR,2017.0,63,67,-4
HUN,FIN,2012.0,4,5,-1
ESP,ARG,2014.0,104,90,14
FIN,CHE,2008.0,12,8,4
EGY,SAU,2013.0,291,173,118
FRA,BEL,2017.0,235,244,-9
ISR,AUT,2021.0,13,7,6
MEX,CAN,2010.0,44,26,18
TUR,SVN,2017.0,1,4,-3
USA,CHL,2000.0,45,52,-7
GBR,POL,2013.0,56,58,-2
ESP,FIN,2006.0,5,6,-1
DEU,IRL,2007.0,44,24,20
TUR,USA,2015.0,265,316,-51
AUS,ITA,2021.0,47,30,17
PAK,SAU,2021.0,81,95,-14
ESP,NLD,2006.0,39,51,-12
SAU,EGY,2021.0,302,393,-91
BRA,GBR,2016.0,140,103,37
CHN,PAK,2022.0,508,278,230
KOR,CHN,2011.0,186,83,103
SGP,CHN,2021.0,547,350,197
CZE,POL,2011.0,14,6,8
USA,MNG,2015.0,4,4,0
GRC,DEU,2018.0,96,48,48
ITA,ESP,2005.0,101,84,17
SVK,AUT,2006.0,7,7,0
IND,CAN,1998.0,42,27,15
LUX,USA,2010.0,5,6,-1
GRC,HUN,2004.0,4,2,2
IRN,CAN,2008.0,82,50,32
IRN,CAN,2014.0,269,61,208
DEU,NOR,2019.0,94,48,46
CIV,FRA,2016.0,19,65,-46
ETH,AUS,2012.0,6,2,4
CHE,FRA,2023.0,175,182,-7
DEU,CZE,2004.0,31,34,-3
GBR,DEU,2020.0,818,710,108
GBR,AUS,2018.0,650,626,24
LTU,USA,2016.0,4,7,-3
AUS,ISR,2019.0,18,26,-8
CHE,FIN,2014.0,15,8,7
CHN,AUS,2002.0,47,32,15
BRB,TTO,2009.0,3,1,2
SAU,ARE,2018.0,50,11,39
JPN,THA,2001.0,43,37,6
NOR,RUS,2014.0,3,16,-13
KGZ,TUR,2016.0,5,4,1
SVK,ITA,2001.0,4,4,0
DNK,SWE,2012.0,72,85,-13
UKR,BLR,2009.0,5,3,2
ITA,NLD,2017.0,154,98,56
SWE,LTU,2001.0,5,10,-5
SVK,CZE,2013.0,84,59,25
GBR,DNK,2001.0,63,70,-7
FRA,MAR,2021.0,90,71,19
SWE,AUS,2020.0,63,73,-10
USA,GRC,2017.0,98,135,-37
DNK,NLD,2013.0,15,34,-19
CMR,USA,2013.0,7,3,4
FRA,SWE,1997.0,29,38,-9
CAN,PRT,2015.0,9,16,-7
ITA,MDG,2001.0,2,2,0
FRA,BRA,2001.0,80,55,25
GBR,SVN,2005.0,11,7,4
ESP,COL,2012.0,92,62,30
BRA,CHL,2008.0,19,12,7
DNK,NOR,2002.0,34,24,10
BRA,AUT,2013.0,6,4,2
NLD,HUN,2007.0,10,3,7
DNK,GBR,2007.0,63,54,9
TWN,IND,2015.0,58,56,2
LTU,DNK,2006.0,6,4,2
DNK,LTU,2010.0,1,3,-2
CZE,SVK,1997.0,10,26,-16
NLD,CHN,2010.0,32,57,-25
PAK,DEU,2005.0,9,3,6
AUS,CHN,2014.0,254,293,-39
IND,FIN,2005.0,3,3,0
IRN,GBR,2001.0,18,46,-28
BLR,RUS,2008.0,22,14,8
THA,GBR,2004.0,22,63,-41
SWE,CAN,2013.0,37,45,-8
IRQ,YEM,2006.0,1,2,-1
FIN,USA,2014.0,78,87,-9
JPN,AUS,2017.0,57,72,-15
GRC,DEU,2016.0,76,53,23
AUT,AUS,2005.0,18,24,-6
IND,ITA,2012.0,47,33,14
JPN,SWE,2003.0,29,37,-8
PER,ESP,2016.0,22,26,-4
SVK,SRB,2008.0,1,2,-1
LBY,GBR,2003.0,2,3,-1
NLD,BRA,2007.0,19,12,7
ARG,CHE,2014.0,5,6,-1
CHE,ARG,2015.0,9,11,-2
ARG,ESP,2013.0,81,81,0
NZL,NLD,2001.0,12,16,-4
CHN,DEU,2002.0,143,80,63
GBR,BWA,2000.0,5,1,4
KOR,CAN,2016.0,43,37,6
ESP,DNK,2014.0,34,14,20
HUN,SWE,2007.0,8,10,-2
IND,SWE,2012.0,48,18,30
CHL,CAN,2021.0,29,24,5
VEN,ESP,2018.0,30,19,11
FIN,POL,2019.0,7,9,-2
PRT,ESP,2011.0,63,101,-38
HUN,USA,2012.0,69,66,3
ITA,MEX,2011.0,14,16,-2
TUN,FRA,2002.0,44,72,-28
BEL,GRC,2008.0,11,12,-1
DEU,ITA,2002.0,162,178,-16
TZA,NOR,2015.0,6,8,-2
SGP,ISR,2005.0,1,1,0
GBR,BGR,2013.0,8,11,-3
TUR,DEU,2010.0,42,51,-9
CAN,AUS,2023.0,88,91,-3
DNK,DEU,2010.0,70,112,-42
CHE,FRA,2010.0,228,289,-61
JPN,ESP,2005.0,8,13,-5
AUT,CHE,2006.0,46,40,6
SGP,AUS,2022.0,53,70,-17
DEU,LBY,2008.0,2,1,1
DEU,SWE,2011.0,154,115,39
GRC,NLD,2015.0,27,8,19
DNK,ESP,2002.0,13,15,-2
AUS,CHL,2004.0,1,2,-1
SWE,ISL,2001.0,9,13,-4
CAN,TWN,2013.0,18,17,1
IRN,GBR,2008.0,28,70,-42
FRA,SGP,2007.0,14,11,3
HKG,CAN,1999.0,23,19,4
USA,PAK,2009.0,51,50,1
ITA,CHE,2015.0,275,126,149
GEO,USA,2022.0,133,181,-48
ITA,NLD,2018.0,155,95,60
SGP,CHN,2019.0,469,306,163
AUT,HUN,2010.0,10,16,-6
FRA,KOR,2016.0,28,30,-2
JPN,MYS,2018.0,83,49,34
SWE,CHE,2003.0,32,36,-4
ISR,USA,2023.0,216,194,22
DEU,JPN,2000.0,127,128,-1
TUR,NLD,2009.0,18,11,7
TUR,NLD,2011.0,28,19,9
BRA,CUB,2019.0,8,12,-4
USA,PER,2018.0,60,54,6
ITA,GBR,2001.0,282,267,15
BRA,SWE,2003.0,9,8,1
LTU,JPN,2005.0,1,2,-1
NLD,FRA,2002.0,91,110,-19
ISR,CAN,2004.0,62,36,26
DEU,GBR,2019.0,763,841,-78
TTO,USA,2021.0,16,5,11
BRA,NLD,2006.0,13,21,-8
SAU,EGY,2009.0,70,165,-95
NZL,GBR,2012.0,86,167,-81
USA,PRI,2002.0,65,103,-38
AUT,PRT,2003.0,4,2,2
LTU,GBR,2006.0,5,3,2
DEU,LTU,2010.0,9,2,7
JPN,AUS,2016.0,56,76,-20
USA,BEN,2016.0,4,2,2
USA,PER,2017.0,43,53,-10
NOR,BEL,2022.0,10,10,0
USA,DZA,2014.0,9,3,6
CHN,BEL,2004.0,7,14,-7
SWE,NLD,2012.0,47,54,-7
GRC,USA,2001.0,93,104,-11
EGY,ARE,2022.0,34,12,22
AUS,JPN,2010.0,58,82,-24
GBR,SWE,1997.0,51,46,5
SVN,AUT,2019.0,13,6,7
SWE,AUS,2007.0,32,30,2
MEX,USA,2002.0,235,262,-27
KAZ,RUS,2005.0,13,20,-7
AUS,NOR,2005.0,16,7,9
GHA,ZAF,2004.0,1,3,-2
LBN,CAN,2015.0,12,16,-4
AUS,NZL,2022.0,99,148,-49
ITA,ARG,2012.0,23,9,14
FRA,IND,2012.0,65,80,-15
ITA,SVK,2009.0,5,4,1
CHN,CAN,2012.0,231,278,-47
CAN,DEU,1998.0,75,92,-17
GRC,USA,2014.0,150,92,58
DEU,BRA,2012.0,84,77,7
DEU,LBN,2016.0,8,4,4
BGR,DEU,2004.0,20,19,1
CYP,GBR,2016.0,20,43,-23
USA,HND,2008.0,1,4,-3
AUS,CAN,2021.0,199,191,8
NLD,CZE,2011.0,9,8,1
JPN,IND,2007.0,72,68,4
GBR,OMN,2010.0,4,6,-2
ESP,CHL,2022.0,93,117,-24
RUS,CZE,2018.0,15,12,3
MYS,DEU,2010.0,8,3,5
IRN,DEU,2010.0,46,29,17
KWT,IND,2020.0,3,5,-2
ETH,SWE,2010.0,5,6,-1
NOR,AUS,2014.0,12,13,-1
HRV,DEU,2012.0,8,11,-3
FRA,CAN,2001.0,211,162,49
BEN,ITA,2005.0,1,1,0
NLD,MLI,2016.0,2,1,1
KEN,GBR,2020.0,40,37,3
GBR,AUS,2022.0,448,454,-6
GIN,FRA,2007.0,1,7,-6
PNG,GIN,2010.0,2,1,1
NLD,ROU,2010.0,6,6,0
PRT,USA,2022.0,66,51,15
DEU,EGY,2007.0,39,22,17
CAN,CMR,2014.0,2,2,0
ZMB,JPN,2011.0,2,3,-1
BGD,CAN,2007.0,7,5,2
USA,RUS,2021.0,143,198,-55
JPN,BRA,2003.0,25,7,18
SAU,USA,2018.0,150,278,-128
JPN,ESP,2012.0,13,16,-3
USA,BEL,2018.0,190,245,-55
GBR,KEN,2004.0,14,12,2
CAN,GEO,2004.0,1,1,0
GBR,SWE,2002.0,115,120,-5
MEX,ITA,2015.0,16,17,-1
FRA,ZAF,2009.0,25,11,14
GBR,ISR,1998.0,28,27,1
USA,POL,2000.0,112,121,-9
USA,ROU,2006.0,26,29,-3
CZE,AUS,1997.0,1,2,-1
CHN,TWN,1999.0,51,62,-11
DNK,CHL,2015.0,2,4,-2
CHN,CAN,1997.0,31,30,1
CHN,ISR,2002.0,14,6,8
NZL,SGP,2009.0,6,3,3
CHE,GRC,2002.0,17,9,8
DEU,IND,1998.0,36,60,-24
SGP,USA,2015.0,234,285,-51
BRA,DEU,2013.0,97,83,14
MAR,FRA,2012.0,59,124,-65
MEX,FRA,2013.0,36,47,-11
ZAF,IND,2013.0,19,48,-29
FRA,JPN,2006.0,70,66,4
FIN,USA,2001.0,103,94,9
AUS,NLD,2018.0,95,95,0
ITA,POL,2012.0,13,12,1
GUF,FRA,2017.0,38,37,1
FRA,POL,2009.0,39,32,7
AUS,FRA,2023.0,40,34,6
NOR,TZA,2010.0,10,3,7
CAN,MEX,2015.0,40,39,1
SGP,IND,2017.0,68,111,-43
FIN,SWE,2013.0,51,50,1
GRL,DNK,2011.0,3,4,-1
DEU,CHL,2006.0,25,12,13
JPN,LKA,2017.0,19,3,16
GBR,MEX,2018.0,62,68,-6
FRA,UKR,2009.0,13,11,2
CZE,DEU,2022.0,61,56,5
FRA,NOR,2005.0,17,12,5
AUT,AUS,2002.0,29,38,-9
EGY,ARE,2017.0,12,12,0
DNK,NOR,2012.0,33,14,19
AUS,ARE,2003.0,3,3,0
CUB,USA,2005.0,6,6,0
USA,ZWE,2000.0,8,11,-3
CHE,BEL,2013.0,31,66,-35
CHN,FIN,2014.0,20,20,0
IND,TZA,2015.0,4,6,-2
MYS,IRN,2017.0,185,18,167
IND,CHN,2009.0,19,13,6
OMN,SGP,2012.0,2,1,1
SVK,SVN,2004.0,20,9,11
AUS,FJI,2006.0,4,3,1
GRC,NLD,2008.0,15,11,4
BRA,CHL,2015.0,32,25,7
BEL,ESP,2008.0,27,45,-18
PER,ECU,2019.0,12,2,10
SYR,JOR,2011.0,1,1,0
CHL,USA,2011.0,121,108,13
GBR,GHA,2003.0,10,4,6
TUN,ARE,2015.0,14,1,13
RUS,GBR,2010.0,41,46,-5
GBR,PNG,2000.0,3,1,2
PNG,AUS,2009.0,8,7,1
GBR,TTO,2003.0,8,4,4
GRC,DEU,2017.0,97,51,46
AUT,THA,2013.0,7,4,3
IRN,USA,1999.0,10,18,-8
IRL,ISR,2019.0,2,6,-4
CAN,HUN,2008.0,10,4,6
EGY,ZAF,2007.0,2,1,1
MEX,ESP,2019.0,163,187,-24
FRA,ZAF,2011.0,29,11,18
USA,SGP,1999.0,76,51,25
AUS,KOR,2005.0,20,15,5
JPN,VNM,2014.0,37,18,19
CAN,CHE,2016.0,112,99,13
SWE,IND,2022.0,43,61,-18
CHE,SWE,2015.0,57,58,-1
USA,KEN,2004.0,30,25,5
CHL,CHE,2007.0,5,6,-1
BRA,CAN,2015.0,98,66,32
BRA,GBR,2022.0,136,101,35
GBR,COL,2021.0,19,16,3
IND,SAU,2012.0,104,26,78
GBR,IRL,2020.0,512,426,86
USA,ESP,2014.0,371,594,-223
USA,CHN,2009.0,1339,1919,-580
USA,JPN,2013.0,978,998,-20
DEU,AUS,2010.0,157,124,33
PRT,BRA,2009.0,70,88,-18
USA,ISR,2008.0,288,387,-99
BEL,CAN,2020.0,47,51,-4
VEN,ESP,2012.0,46,24,22
CAN,USA,2013.0,1810,1610,200
AUS,USA,2007.0,509,566,-57
ISR,USA,2008.0,387,288,99
USA,IND,2007.0,494,764,-270
CAN,GBR,2000.0,239,227,12
USA,BRA,2006.0,311,299,12
AUS,GBR,2009.0,440,627,-187
JPN,USA,2014.0,997,957,40
USA,FRA,2010.0,779,868,-89
BEL,AUT,2007.0,6,9,-3
GBR,CAN,2008.0,350,338,12
JPN,CHN,2012.0,532,343,189
FRA,CHN,2011.0,128,143,-15
CHN,FRA,2014.0,154,181,-27
ESP,ARG,2006.0,69,82,-13
USA,ARG,2017.0,122,127,-5
CHE,GBR,2008.0,183,178,5
ESP,DEU,2009.0,144,168,-24
AUS,IRL,2012.0,32,54,-22
EGY,GBR,2020.0,66,73,-7
POL,CHE,2009.0,22,12,10
ISR,USA,2004.0,405,238,167
JPN,USA,2001.0,1594,1219,375
IND,USA,2011.0,955,757,198
CHL,DEU,2007.0,21,20,1
GBR,CHN,2003.0,113,115,-2
BEL,USA,2004.0,122,102,20
USA,BEL,2005.0,125,117,8
BEL,POL,2021.0,13,6,7
NLD,GBR,2013.0,257,254,3
NLD,SWE,2015.0,79,28,51
RUS,USA,2010.0,210,171,39
ESP,NOR,2016.0,32,8,24
AUS,THA,2001.0,23,10,13
USA,HKG,2015.0,157,134,23
CHE,DEU,2019.0,506,670,-164
CHE,FRA,2014.0,252,377,-125
CHN,AUS,2017.0,458,388,70
HKG,CHN,2020.0,1405,1006,399
CHE,CAN,2004.0,54,49,5
CAN,CHE,2005.0,47,62,-15
MEX,USA,2017.0,310,270,40
CHE,GBR,2014.0,288,270,18
USA,POL,2008.0,114,167,-53
SGP,CHN,2013.0,239,222,17
HKG,AUS,2018.0,48,42,6
PRT,FRA,2020.0,46,53,-7
AUS,CHN,2006.0,73,63,10
POL,USA,2014.0,111,105,6
NZL,GBR,2017.0,123,126,-3
ESP,ISR,2020.0,21,10,11
USA,ESP,2004.0,301,359,-58
DEU,FRA,2010.0,322,368,-46
CAN,CHN,2000.0,43,74,-31
USA,TUR,2016.0,322,304,18
ESP,ITA,2004.0,61,106,-45
FRA,DEU,2009.0,346,345,1
USA,CHN,2011.0,2135,2344,-209
GBR,GRC,2010.0,172,138,34
SGP,USA,2010.0,172,253,-81
USA,ECU,2007.0,14,14,0
ISR,AUS,2015.0,18,10,8
USA,FRA,2023.0,318,396,-78
GBR,USA,2020.0,2077,1837,240
GBR,AUS,2005.0,443,375,68
GBR,AUS,2012.0,734,430,304
BRA,CAN,2000.0,37,25,12
JPN,USA,2008.0,1201,1115,86
ESP,DEU,2011.0,161,176,-15
JPN,CHN,2005.0,391,248,143
TWN,DEU,2002.0,3,10,-7
CHN,HKG,2021.0,1409,1440,-31
USA,CAN,2012.0,1540,1735,-195
DEU,GBR,2013.0,669,713,-44
NLD,DNK,2018.0,50,31,19
FRA,GBR,2016.0,573,404,169
ESP,CRI,2003.0,5,2,3
BRA,AUS,2003.0,12,10,2
JPN,CHE,2020.0,44,41,3
ITA,USA,2013.0,631,443,188
DEU,AUT,2009.0,268,240,28
JPN,ITA,2005.0,23,20,3
USA,CZE,2006.0,53,54,-1
THA,SGP,2013.0,14,3,11
USA,DEU,2013.0,1301,1362,-61
GBR,USA,2007.0,1465,1504,-39
IRL,CAN,2010.0,31,36,-5
USA,BRA,2010.0,391,390,1
GBR,IND,2018.0,211,244,-33
RUS,KAZ,2010.0,16,10,6
JAM,USA,2021.0,10,15,-5
ESP,USA,2007.0,320,356,-36
USA,ESP,2008.0,387,402,-15
SVK,CAN,2000.0,3,2,1
JPN,USA,2015.0,983,961,22
GBR,TTO,2019.0,10,7,3
LBN,USA,2007.0,40,28,12
CAN,FRA,2008.0,204,293,-89
IRL,CAN,2006.0,22,22,0
USA,CHN,2019.0,3924,4018,-94
PNG,AUS,2013.0,9,3,6
ISR,GRC,2010.0,6,3,3
GBR,GRC,2000.0,117,64,53
DEU,ZAF,1997.0,10,4,6
ESP,NLD,2008.0,55,53,2
CHN,DEU,2022.0,511,604,-93
AUS,MYS,2011.0,63,53,10
POL,USA,2008.0,167,114,53
USA,CHL,2008.0,103,98,5
GRC,USA,2010.0,143,125,18
CHE,DEU,2011.0,420,722,-302
RUS,AUT,2007.0,8,7,1
HUN,FRA,2007.0,15,12,3
BEL,KEN,2008.0,3,3,0
AUS,FIN,2009.0,10,9,1
DEU,USA,2017.0,1359,1239,120
CHN,HKG,2011.0,601,733,-132
HKG,CHN,2007.0,282,302,-20
VNM,KOR,2021.0,57,132,-75
NZL,AUS,2008.0,171,109,62
USA,CZE,2010.0,37,37,0
CZE,USA,2021.0,72,62,10
CHE,FRA,2001.0,210,249,-39
SGP,USA,2006.0,136,160,-24
PRI,USA,2022.0,131,209,-78
CHN,GBR,2002.0,105,85,20
NLD,BEL,2009.0,136,118,18
IND,NLD,2015.0,24,32,-8
DEU,RUS,2008.0,126,141,-15
RUS,PRT,2015.0,3,7,-4
DEU,SGP,2005.0,20,6,14
USA,ISR,2015.0,387,418,-31
DEU,AUS,2023.0,61,89,-28
EGY,SAU,2011.0,269,104,165
DEU,FRA,2006.0,270,268,2
AUS,CHN,2023.0,439,263,176
IND,DEU,2014.0,172,115,57
USA,AUS,2016.0,690,689,1
CAN,JPN,1999.0,96,112,-16
FRA,BEL,2012.0,202,200,2
USA,CHE,2012.0,550,478,72
DEU,CHE,2016.0,680,495,185
SVN,USA,2000.0,14,12,2
THA,GBR,2000.0,11,15,-4
TUR,USA,2023.0,192,105,87
IRL,GBR,2011.0,282,224,58
THA,USA,2006.0,90,191,-101
USA,THA,2010.0,201,130,71
MEX,ESP,2003.0,70,84,-14
KOR,CAN,2012.0,36,31,5
CAN,KOR,2013.0,44,45,-1
AUT,NLD,1998.0,15,11,4
DEU,GBR,2003.0,461,485,-24
GBR,ITA,2021.0,520,484,36
USA,CHE,2005.0,389,374,15
USA,DNK,2009.0,135,93,42
DEU,JOR,2007.0,8,7,1
ESP,CAN,2007.0,35,28,7
USA,ESP,2015.0,421,634,-213
ESP,USA,2020.0,515,485,30
FRA,BEL,2005.0,163,130,33
JPN,MYS,2005.0,10,8,2
CAN,AUS,2014.0,201,154,47
AUT,AUS,2017.0,63,53,10
AUS,NZL,2012.0,99,179,-80
USA,ARG,2018.0,109,106,3
CAN,AUS,2001.0,114,116,-2
ESP,DZA,2018.0,13,6,7
DZA,ESP,2019.0,6,14,-8
FRA,CMR,1999.0,14,7,7
CAN,USA,2003.0,1648,1562,86
GBR,CHE,2013.0,284,230,54
NLD,ISR,1998.0,5,8,-3
USA,FRA,2000.0,587,840,-253
AUT,USA,2009.0,119,112,7
EGY,SAU,2019.0,394,320,74
NZL,CAN,2012.0,35,43,-8
CAN,CHN,2010.0,209,240,-31
LTU,FRA,2004.0,1,1,0
GBR,DZA,2017.0,6,2,4
BRA,USA,2007.0,338,349,-11
CUB,ESP,2011.0,26,24,2
MEX,JPN,2007.0,2,5,-3
JPN,MEX,2011.0,3,2,1
GBR,IRL,2007.0,209,159,50
RUS,CAN,2012.0,26,19,7
DNK,SWE,2016.0,91,101,-10
KEN,ZAF,2004.0,4,9,-5
RUS,VNM,2008.0,6,1,5
TWN,USA,2010.0,294,376,-82
GBR,ESP,2013.0,300,410,-110
FRA,SEN,2017.0,33,34,-1
FRA,SEN,2022.0,23,19,4
NOR,DNK,2018.0,40,68,-28
GBR,CAN,2014.0,403,389,14
CAN,FRA,2015.0,262,380,-118
TUN,SAU,2022.0,101,56,45
GBR,CAN,2001.0,290,238,52
USA,IND,2020.0,937,1606,-669
BRA,ITA,2021.0,88,57,31
PRI,USA,2018.0,206,172,34
IND,FRA,2009.0,79,40,39
CHN,JPN,2016.0,346,567,-221
TUR,AUT,2019.0,11,7,4
FRA,TUR,2013.0,14,18,-4
GBR,IRN,1998.0,26,9,17
USA,POL,2015.0,131,103,28
BEL,NLD,2005.0,83,90,-7
USA,CHN,2021.0,4508,3369,1139
IND,GBR,1997.0,58,62,-4
GBR,MYS,2007.0,94,27,67
CHN,GBR,2005.0,117,116,1
CHN,GBR,2012.0,246,362,-116
GBR,CHN,2013.0,397,244,153
CHN,HKG,2009.0,355,454,-99
FRA,CAN,2006.0,268,164,104
CHE,USA,2012.0,478,550,-72
NZL,USA,2004.0,128,123,5
DEU,ESP,2023.0,173,140,33
GBR,FRA,1999.0,276,324,-48
FRA,JPN,2004.0,80,76,4
CHN,SGP,2011.0,224,158,66
FRA,UKR,2013.0,15,21,-6
GBR,AUS,1997.0,222,230,-8
CZE,ESP,2021.0,21,30,-9
GBR,UKR,2011.0,117,21,96
CZE,AUT,2004.0,14,5,9
TUR,USA,2000.0,158,180,-22
CAN,HKG,2003.0,29,26,3
GBR,FIN,2014.0,56,62,-6
QAT,DEU,2012.0,2,1,1
ZAF,TUN,2017.0,58,1,57
USA,CAN,2002.0,1530,1712,-182
FRA,CHE,1998.0,172,127,45
SWE,NOR,2007.0,67,29,38
NOR,SWE,2009.0,36,77,-41
ESP,COL,2017.0,159,91,68
SWE,ZAF,2004.0,8,3,5
JPN,AUS,2002.0,73,61,12
DEU,NLD,2003.0,204,180,24
IND,DEU,2004.0,99,61,38
USA,CAN,2005.0,1426,1430,-4
AUS,USA,1998.0,407,389,18
NLD,ESP,2016.0,76,115,-39
BEN,CIV,2018.0,13,1,12
THA,GBR,2023.0,32,36,-4
DEU,CAN,2005.0,148,108,40
RUS,GBR,2008.0,46,33,13
USA,KOR,1999.0,500,339,161
IRL,USA,2009.0,137,129,8
IRL,FRA,2011.0,28,27,1
NLD,USA,2011.0,376,347,29
AUT,USA,2011.0,139,157,-18
JPN,CHN,2002.0,279,255,24
POL,ESP,2006.0,6,10,-4
CZE,USA,2009.0,36,38,-2
CZE,USA,2011.0,56,51,5
IDN,IND,2011.0,8,14,-6
USA,MYS,2002.0,19,23,-4
USA,FRA,2006.0,715,762,-47
NLD,GBR,2003.0,189,184,5
GBR,USA,1998.0,1167,1071,96
BRA,CHN,2002.0,8,5,3
BEL,ISR,2008.0,2,4,-2
DEU,AUT,2011.0,342,289,53
FIN,CZE,2016.0,8,3,5
GBR,FIN,2004.0,43,28,15
FRA,BEL,2002.0,174,168,6
ITA,USA,2003.0,537,543,-6
ITA,FRA,2017.0,398,284,114
ESP,PRT,2014.0,110,100,10
USA,RUS,2013.0,197,178,19
SAU,CAN,2012.0,29,98,-69
AUS,AUT,2010.0,31,36,-5
NLD,USA,2019.0,486,421,65
FRA,NCL,2008.0,22,11,11
ITA,SWE,2016.0,87,35,52
MYS,JPN,2009.0,13,49,-36
SGP,CHE,2022.0,24,18,6
CAN,GBR,2010.0,356,366,-10
USA,GRC,2002.0,141,100,41
USA,PRT,2007.0,55,40,15
SRB,GRC,2004.0,6,1,5
BGR,AUT,2008.0,2,3,-1
DNK,LBN,2022.0,1,2,-1
CHN,FRA,2001.0,32,34,-2
GBR,USA,1999.0,1354,1119,235
FRA,CAN,2000.0,211,178,33
USA,ESP,2001.0,304,404,-100
GBR,NLD,2002.0,204,188,16
CHE,GBR,2015.0,272,274,-2
USA,DNK,2011.0,135,112,23
CHE,DNK,2017.0,30,32,-2
BRA,USA,1999.0,227,262,-35
ESP,BRA,2010.0,76,82,-6
NZL,JPN,1999.0,8,11,-3
RUS,CAN,2002.0,38,19,19
CAN,PAN,2010.0,3,2,1
SAU,IND,2020.0,64,170,-106
USA,ISR,2014.0,355,401,-46
UKR,POL,2021.0,42,30,12
DEU,TWN,2011.0,23,21,2
JPN,AUS,2012.0,72,63,9
CHE,DNK,2018.0,42,36,6
ITA,BEL,2023.0,77,66,11
CAN,TUR,2011.0,25,20,5
ARG,DEU,2007.0,24,19,5
FRA,USA,2004.0,782,667,115
USA,ZAF,2005.0,103,71,32
TWN,CHN,2009.0,112,140,-28
USA,KAZ,2020.0,21,19,2
GBR,NZL,2003.0,136,90,46
BEL,GBR,2006.0,77,63,14
ESP,GBR,2016.0,567,304,263
FIN,CHE,2006.0,11,6,5
ARG,MEX,2016.0,23,28,-5
MEX,ARG,2018.0,31,21,10
GBR,BEL,2022.0,133,126,7
BEL,GBR,2023.0,64,85,-21
SGP,AUS,2005.0,48,42,6
GBR,IDN,1999.0,8,3,5
GBR,JPN,2022.0,117,111,6
UKR,RUS,2014.0,167,39,128
IND,AUS,2020.0,182,87,95
IRL,MYS,2022.0,3,7,-4
FRA,CZE,2012.0,10,22,-12
CHE,FRA,2004.0,195,243,-48
CHE,RUS,2013.0,10,29,-19
MEX,GBR,2014.0,35,49,-14
BGD,MYS,2019.0,31,64,-33
CHN,CAN,2018.0,368,427,-59
ESP,VEN,2003.0,24,15,9
CHN,AUS,2018.0,493,506,-13
TUR,BEL,2014.0,8,14,-6
GRC,MKD,2016.0,4,1,3
TWN,VNM,2017.0,39,9,30
BRA,GBR,2002.0,56,77,-21
ESP,PRT,2008.0,52,50,2
DEU,CHE,2017.0,719,447,272
ITA,DEU,2017.0,368,218,150
TUR,BGR,2017.0,3,1,2
JPN,ESP,2018.0,16,19,-3
GBR,BRA,2009.0,63,51,12
FRA,USA,2014.0,955,831,124
AUS,ESP,2014.0,28,75,-47
ROU,FRA,2013.0,37,28,9
TUR,ITA,2013.0,13,21,-8
AUS,MYS,2009.0,36,40,-4
GBR,THA,2009.0,62,21,41
FRA,ESP,2008.0,186,189,-3
DEU,USA,2016.0,1373,1309,64
GBR,ESP,2003.0,189,181,8
CHE,CZE,2018.0,18,22,-4
CHE,CZE,2022.0,11,22,-11
EGY,USA,2009.0,63,122,-59
ESP,ITA,2008.0,90,169,-79
IND,ESP,2012.0,23,9,14
NLD,PRT,2007.0,19,8,11
GBR,ITA,2011.0,255,394,-139
ROU,FRA,2003.0,40,18,22
DEU,CHN,2009.0,164,205,-41
CHE,DEU,2009.0,453,645,-192
CHN,CZE,2017.0,8,6,2
CHN,DNK,1999.0,10,4,6
ITA,CAN,2013.0,58,46,12
ZAF,IND,2011.0,9,33,-24
GBR,ITA,2009.0,220,345,-125
ITA,FRA,2018.0,383,315,68
USA,TTO,2005.0,3,6,-3
NLD,RUS,2020.0,12,29,-17
NER,NGA,2017.0,14,12,2
ITA,DEU,2016.0,337,211,126
DNK,CAN,2012.0,28,14,14
GBR,MEX,2002.0,47,28,19
MEX,GBR,2004.0,26,34,-8
FRA,DNK,2010.0,29,23,6
SWE,ZAF,2008.0,6,3,3
SGP,CHN,2003.0,53,92,-39
SWE,NOR,1999.0,55,29,26
NZL,EGY,2007.0,1,1,0
SVN,USA,2010.0,14,10,4
GBR,GRC,2006.0,171,90,81
KOR,JPN,2004.0,109,136,-27
FRA,IRN,2006.0,23,12,11
ZAF,CAN,2007.0,23,9,14
NZL,SWE,2014.0,14,3,11
NLD,ISR,1999.0,4,8,-4
NOR,SWE,2019.0,70,94,-24
KOR,JPN,2015.0,105,121,-16
USA,THA,2023.0,70,92,-22
CAN,CMR,2010.0,4,3,1
USA,SYR,2006.0,11,3,8
GBR,NOR,2002.0,46,46,0
USA,AUS,2017.0,653,731,-78
BRA,GBR,2005.0,48,61,-13
SWE,GBR,2012.0,130,170,-40
JPN,AUT,2004.0,10,10,0
JPN,AUT,2015.0,19,10,9
CHE,KEN,2020.0,12,6,6
FRA,ESP,2015.0,218,324,-106
FRA,CHE,2007.0,283,207,76
GBR,OMN,2015.0,18,6,12
CAN,ZAF,2005.0,12,19,-7
LUX,DEU,2015.0,19,33,-14
BRA,DEU,2011.0,79,79,0
ESP,KOR,2018.0,11,15,-4
KOR,ESP,2023.0,8,15,-7
PHL,HKG,2019.0,5,4,1
AUS,THA,2014.0,41,32,9
CHE,CAN,2008.0,94,83,11
USA,NZL,2015.0,117,124,-7
AUS,ARE,2021.0,21,19,2
CAN,DNK,2013.0,25,20,5
GBR,COL,2013.0,16,16,0
IND,NLD,2008.0,16,10,6
BEL,DNK,2020.0,23,18,5
GBR,HUN,2011.0,29,48,-19
DEU,AUT,2021.0,402,337,65
FRA,CAN,2010.0,301,287,14
USA,ARE,2015.0,91,51,40
COL,RUS,2004.0,1,2,-1
USA,CHL,2014.0,152,114,38
USA,GEO,2008.0,49,33,16
SWE,ROU,2003.0,4,3,1
CHN,BEL,2006.0,14,12,2
USA,TWN,2017.0,222,317,-95
GBR,BRA,2011.0,84,66,18
KOR,JPN,2001.0,103,147,-44
ARG,CAN,2009.0,17,14,3
IRL,AUS,2004.0,15,21,-6
THA,GBR,2006.0,22,55,-33
GBR,THA,2011.0,76,34,42
GRC,FRA,2011.0,53,30,23
GRC,USA,2023.0,63,43,20
CHE,AUS,2020.0,96,69,27
BGR,DEU,2000.0,27,18,9
GRC,USA,2006.0,93,121,-28
IND,ZAF,2009.0,16,8,8
FIN,SWE,2011.0,53,42,11
NOR,MYS,2017.0,2,1,1
POL,GBR,2009.0,57,36,21
CHE,DEU,2021.0,515,694,-179
GRC,FRA,2009.0,33,24,9
JPN,EGY,2018.0,79,40,39
CHE,GBR,2004.0,115,164,-49
EGY,SAU,2009.0,165,70,95
ESP,GBR,2017.0,538,372,166
AUS,BRA,2011.0,20,41,-21
DEU,CHL,2015.0,46,30,16
SVN,GBR,2020.0,7,13,-6
JPN,NZL,2006.0,7,2,5
NZL,JPN,2007.0,8,10,-2
TWN,USA,2006.0,244,355,-111
SVN,NLD,2010.0,3,2,1
FRA,JPN,2008.0,65,88,-23
CAN,GBR,2006.0,238,320,-82
IND,JPN,2009.0,85,71,14
JPN,GBR,2002.0,153,140,13
NLD,TWN,2011.0,2,8,-6
GBR,PRT,2004.0,64,37,27
IND,ITA,2022.0,45,31,14
USA,GEO,2015.0,113,63,50
SWE,GBR,2002.0,120,115,5
TUR,CYP,2023.0,76,108,-32
ESP,HKG,2018.0,2,1,1
POL,RUS,2010.0,11,7,4
USA,NLD,2006.0,246,250,-4
ISR,USA,2015.0,418,387,31
TUR,USA,2006.0,201,246,-45
IND,AUS,2007.0,58,29,29
DEU,IRN,2013.0,31,87,-56
FIN,USA,2006.0,74,82,-8
IND,JPN,2011.0,100,82,18
GRC,DEU,2012.0,69,57,12
JPN,RUS,2002.0,59,46,13
ITA,NLD,2002.0,69,67,2
DEU,ESP,2010.0,161,154,7
FIN,DNK,2006.0,11,12,-1
CHL,IND,2004.0,4,2,2
USA,NLD,2000.0,252,298,-46
MYS,GBR,2008.0,29,104,-75
SWE,USA,2007.0,235,177,58
FIN,BEL,2004.0,2,4,-2
DEU,PRT,2017.0,30,66,-36
PRI,USA,2016.0,205,216,-11
USA,PRI,2018.0,172,206,-34
BEL,DEU,2016.0,122,101,21
SWE,CHE,2009.0,38,43,-5
JPN,SWE,2011.0,44,25,19
AUS,AUT,2006.0,22,26,-4
USA,ITA,2019.0,465,602,-137
RUS,PRT,2008.0,9,2,7
MWI,BWA,2004.0,1,1,0
FIN,GBR,2007.0,43,30,13
THA,USA,2010.0,130,201,-71
USA,PHL,1999.0,24,17,7
FRA,DEU,2021.0,391,346,45
GLP,FRA,2012.0,36,32,4
FRA,USA,2001.0,901,679,222
NLD,ESP,2018.0,88,90,-2
GBR,AUT,2012.0,78,72,6
USA,LBN,2010.0,49,70,-21
FRA,ESP,2004.0,134,117,17
NGA,GBR,2006.0,16,19,-3
GBR,NGA,2009.0,26,24,2
IND,DEU,2008.0,112,80,32
LKA,MYS,2016.0,4,4,0
CAN,BEL,2011.0,36,46,-10
IND,SAU,2016.0,181,64,117
CHE,FIN,2010.0,10,13,-3
SWE,DNK,2022.0,86,99,-13
EST,DEU,2009.0,6,3,3
GBR,ISL,2002.0,16,7,9
ISL,GBR,2003.0,11,12,-1
ESP,SWE,2012.0,46,30,16
BGR,CZE,2015.0,3,1,2
HKG,CHN,1999.0,151,120,31
USA,GRC,2005.0,109,97,12
GBR,NOR,2012.0,74,39,35
NLD,NOR,2012.0,18,14,4
USA,CHL,2015.0,150,121,29
DEU,JPN,2004.0,107,125,-18
ESP,AUT,2010.0,15,17,-2
CAN,NOR,2009.0,14,8,6
CHE,BEL,2009.0,30,39,-9
CIV,FRA,2002.0,18,20,-2
FRA,CIV,2003.0,35,25,10
CHE,NLD,2003.0,43,51,-8
NOR,CAN,2014.0,16,19,-3
NLD,DEU,2018.0,379,333,46
FRA,BRA,2006.0,90,67,23
NOR,USA,2004.0,48,67,-19
NOR,FIN,2005.0,5,7,-2
USA,AUT,2018.0,152,148,4
GBR,TWN,1999.0,24,13,11
SWE,CHN,2004.0,29,23,6
IND,FRA,2011.0,99,51,48
BEL,NLD,2012.0,126,125,1
RUS,UKR,2006.0,33,53,-20
FRA,IND,2017.0,68,120,-52
LBN,FRA,2007.0,22,28,-6
CHL,USA,2013.0,126,126,0
USA,ARE,2004.0,19,6,13
DEU,CAN,2002.0,166,143,23
DNK,DEU,2015.0,75,150,-75
DEU,TWN,2009.0,15,21,-6
GBR,IRN,2007.0,87,27,60
SRB,GBR,2011.0,8,12,-4
FRA,ESP,2014.0,217,319,-102
IND,TWN,1999.0,22,2,20
ITA,ESP,2016.0,230,216,14
CHN,SGP,2009.0,178,138,40
CAN,HKG,2013.0,27,18,9
ISR,ROU,2013.0,1,1,0
PYF,FRA,2016.0,20,14,6
OMN,THA,2016.0,1,2,-1
GRC,CYP,2015.0,46,15,31
NOR,ZAF,2016.0,8,4,4
SGP,KOR,2006.0,7,9,-2
GRC,ITA,2011.0,30,15,15
GBR,AUT,2005.0,42,47,-5
HKG,IND,2009.0,9,1,8
USA,PRT,1998.0,29,23,6
NGA,USA,2019.0,67,53,14
KOR,USA,2016.0,764,1005,-241
KOR,USA,2017.0,848,853,-5
GBR,DNK,2006.0,49,70,-21
USA,BGD,2019.0,61,113,-52
MYS,IND,2010.0,29,72,-43
AUS,CHE,2013.0,57,59,-2
FRA,PRT,2008.0,36,26,10
ARG,USA,2017.0,127,122,5
CAN,OMN,2008.0,9,3,6
DEU,ITA,2017.0,218,368,-150
AUT,MAR,2014.0,2,1,1
USA,TUR,2018.0,318,358,-40
FRA,BRA,2010.0,111,99,12
GBR,ITA,2019.0,475,591,-116
AUT,USA,2021.0,128,123,5
NOR,ESP,2011.0,8,12,-4
HUN,JPN,2002.0,11,9,2
DEU,ISR,2013.0,46,40,6
ARE,USA,2019.0,83,108,-25
ARG,CAN,2011.0,15,10,5
ZAF,USA,2022.0,119,84,35
ZWE,ZAF,2012.0,25,9,16
MLT,GBR,2016.0,15,19,-4
ZAF,TZA,2013.0,7,6,1
HRV,AUT,2010.0,3,3,0
PRT,FRA,1999.0,22,29,-7
SGP,ITA,2017.0,9,16,-7
AUS,JPN,2004.0,36,57,-21
BRA,CAN,2023.0,127,51,76
CHE,CAN,2014.0,95,103,-8
CAN,AUS,2008.0,149,119,30
BEL,USA,2014.0,219,156,63
ESP,DEU,2021.0,252,268,-16
ITA,BEL,2006.0,32,39,-7
NPL,USA,2009.0,11,8,3
DEU,HUN,2001.0,48,37,11
IRN,CAN,2010.0,171,62,109
IRL,FRA,2009.0,32,27,5
DEU,NLD,2013.0,255,263,-8
EGY,DEU,2002.0,27,22,5
NOR,USA,2008.0,58,81,-23
RUS,MEX,2005.0,8,4,4
USA,THA,2006.0,191,90,101
GBR,TWN,2007.0,40,24,16
TUN,FRA,2017.0,93,153,-60
TWN,CHN,2019.0,400,185,215
CUB,MEX,2012.0,20,14,6
GBR,AUS,2002.0,457,430,27
FRA,DEU,2011.0,371,376,-5
TUR,USA,2010.0,205,259,-54
USA,VEN,2009.0,34,34,0
PRT,ARG,2014.0,3,4,-1
USA,NZL,2001.0,116,152,-36
DNK,USA,2008.0,102,94,8
IRL,AUS,2015.0,48,28,20
CZE,ESP,2009.0,9,5,4
USA,AUT,2016.0,171,133,38
PRI,USA,2017.0,214,163,51
DEU,TUR,2015.0,50,55,-5
AUT,AUS,2018.0,35,52,-17
ITA,ESP,2022.0,248,204,44
USA,MNP,2011.0,1,1,0
ITA,POL,2017.0,19,24,-5
MEX,AUS,2011.0,13,8,5
ISL,USA,2015.0,16,22,-6
JPN,BEL,2008.0,14,15,-1
SVK,HUN,2009.0,3,3,0
CHN,FRA,2015.0,159,189,-30
FRA,CHN,2019.0,281,204,77
SWE,JPN,2005.0,31,29,2
MDG,FRA,2016.0,12,16,-4
GBR,KOR,2006.0,43,20,23
CHE,NLD,2013.0,76,81,-5
TUN,SAU,2018.0,123,39,84
NLD,BEL,2021.0,234,183,51
BRA,FRA,2004.0,51,70,-19
DEU,SWE,2013.0,173,114,59
JPN,NZL,2010.0,17,13,4
ITA,NOR,2010.0,25,7,18
URY,SWE,2012.0,4,1,3
FRA,SWE,2022.0,96,68,28
JPN,VNM,2010.0,28,15,13
FRA,IRN,2010.0,32,16,16
DEU,THA,2013.0,39,14,25
DEU,AUT,2019.0,407,354,53
SWE,ESP,2011.0,38,47,-9
DEU,ARG,2019.0,30,39,-9
FRA,DZA,2009.0,85,60,25
NPL,USA,2011.0,14,8,6
TWN,SGP,2006.0,4,5,-1
SGP,TWN,2008.0,7,7,0
MEX,CHE,2015.0,10,7,3
GBR,ARE,2016.0,47,29,18
ESP,GBR,2018.0,498,427,71
BFA,FRA,2006.0,14,9,5
BEL,CHN,1998.0,10,11,-1
CHN,BEL,2000.0,15,10,5
RUS,USA,2000.0,516,182,334
COL,USA,2004.0,32,51,-19
NZL,USA,2014.0,117,115,2
NLD,CHE,2017.0,126,86,40
EGY,CAN,2010.0,22,26,-4
CUB,JPN,2011.0,1,1,0
USA,HKG,2014.0,151,134,17
AUT,FRA,2015.0,35,50,-15
USA,PRI,2017.0,163,214,-51
ESP,NLD,2001.0,40,42,-2
DEU,JPN,2015.0,127,113,14
FRA,PRT,2015.0,33,60,-27
ARG,USA,2018.0,106,109,-3
CHE,FRA,2015.0,280,387,-107
ESP,MEX,2012.0,146,102,44
DEU,VNM,2011.0,12,4,8
USA,GEO,2014.0,87,66,21
GBR,SWE,2016.0,173,175,-2
CAN,TWN,2009.0,17,18,-1
POL,CAN,2015.0,28,11,17
DEU,NOR,2003.0,42,30,12
CAN,TZA,2017.0,2,3,-1
CHN,TUR,2014.0,8,1,7
BEL,GBR,2010.0,88,92,-4
AUS,GBR,2021.0,563,659,-96
HUN,CAN,2010.0,5,7,-2
HKG,ZAF,2013.0,2,1,1
SLE,GBR,2023.0,3,6,-3
DEU,SGP,2012.0,33,29,4
CAN,AUS,2015.0,209,175,34
DEU,USA,2018.0,1268,1289,-21
CZE,IRL,2011.0,4,4,0
AUS,NLD,2012.0,52,68,-16
CAN,SGP,1997.0,11,4,7
GBR,CZE,2009.0,48,42,6
URY,FRA,2005.0,3,5,-2
GBR,QAT,2018.0,53,29,24
CAN,FRA,2014.0,294,366,-72
ZAF,USA,2018.0,138,116,22
ITA,AUT,2005.0,21,31,-10
DEU,CAN,2012.0,171,181,-10
BRA,CAN,2010.0,74,54,20
GBR,IDN,2007.0,12,2,10
USA,FIN,2014.0,87,78,9
FRA,FIN,2012.0,25,23,2
DEU,BGR,2009.0,29,20,9
DNK,BRA,2010.0,4,6,-2
CAN,AUT,2015.0,30,16,14
FIN,FRA,2014.0,22,24,-2
KOR,AUS,2009.0,18,13,5
CHE,SGP,2018.0,23,20,3
BEL,ESP,2006.0,30,12,18
USA,MYS,2005.0,21,15,6
USA,MLI,2004.0,6,1,5
SGP,ESP,2014.0,4,6,-2
SVK,DEU,2008.0,20,11,9
FRA,DNK,2000.0,21,18,3
USA,ITA,2011.0,489,642,-153
USA,TWN,2022.0,203,219,-16
SWE,TUR,1998.0,2,2,0
POL,USA,2004.0,153,146,7
SWE,CMR,2016.0,2,1,1
AUS,GBR,2019.0,611,634,-23
GBR,UKR,2009.0,27,77,-50
IND,ARE,2020.0,91,31,60
GBR,TWN,1998.0,19,12,7
TWN,GBR,1999.0,13,24,-11
AUS,SRB,2007.0,2,2,0
IND,AUT,2021.0,10,10,0
GBR,POL,2019.0,82,84,-2
NLD,FRA,2022.0,104,102,2
AUS,NOR,2018.0,19,14,5
ETH,FRA,2009.0,2,1,1
GRC,AUT,2020.0,8,9,-1
DEU,BRA,2018.0,99,136,-37
CHN,ISR,2018.0,34,31,3
BGD,JPN,2012.0,41,75,-34
BRA,GBR,2012.0,72,89,-17
ISR,IND,2011.0,14,18,-4
HUN,AUT,2013.0,20,13,7
AUS,DEU,2006.0,91,124,-33
AUS,OMN,2017.0,5,3,2
NLD,CHE,2016.0,99,83,16
JPN,KOR,2003.0,164,96,68
USA,CHE,2002.0,445,445,0
GBR,IND,2016.0,194,187,7
JPN,KOR,2013.0,152,120,32
HUN,BEL,2006.0,9,11,-2
CAN,SGP,2012.0,31,30,1
BRA,MEX,2005.0,12,5,7
GBR,KOR,2000.0,26,22,4
CHE,AUT,2015.0,61,93,-32
LTU,GBR,2008.0,7,3,4
NZL,AUS,2015.0,190,120,70
JPN,BRA,2021.0,9,8,1
CHE,USA,2002.0,445,445,0
NLD,SWE,2008.0,31,28,3
AUS,BGD,2018.0,44,75,-31
CHE,TUR,2013.0,15,13,2
DNK,AUS,2005.0,9,11,-2
DEU,FIN,1998.0,19,25,-6
ITA,BRA,2016.0,78,45,33
USA,NOR,2006.0,69,55,14
TUR,ISR,2008.0,2,2,0
BEL,AUS,2012.0,32,12,20
CAN,CHN,2023.0,310,225,85
BEL,FIN,2021.0,16,4,12
MYS,AUS,2007.0,18,23,-5
USA,NOR,2010.0,101,76,25
NOR,ITA,2019.0,17,33,-16
USA,TUR,2017.0,316,356,-40
USA,ISL,1998.0,9,4,5
CHE,KOR,2013.0,16,15,1
GBR,IND,2017.0,192,229,-37
CYP,TUR,2022.0,114,130,-16
SVK,GBR,2004.0,8,11,-3
ARM,DEU,2009.0,6,2,4
USA,LKA,2015.0,25,12,13
POL,GBR,2019.0,84,82,2
SWE,JPN,2002.0,29,46,-17
SGP,NLD,2020.0,23,16,7
GBR,NGA,2011.0,40,26,14
ESP,DEU,2019.0,252,244,8
GBR,PRT,2014.0,74,109,-35
AUS,NZL,2002.0,78,113,-35
MYS,NZL,2022.0,9,9,0
COL,USA,2015.0,136,109,27
PRT,ESP,2003.0,14,43,-29
SWE,CAN,2011.0,29,38,-9
GBR,CAN,2015.0,403,422,-19
UKR,NLD,2010.0,5,2,3
USA,GUM,2008.0,5,6,-1
CAN,NLD,2011.0,70,49,21
NLD,HKG,2013.0,5,3,2
KOR,USA,2018.0,857,885,-28
GBR,JOR,2020.0,49,26,23
UKR,RUS,2008.0,34,72,-38
IND,KOR,2007.0,108,32,76
NZL,IRL,2006.0,6,5,1
SGP,CAN,2010.0,28,22,6
ZAF,NLD,2002.0,14,13,1
THA,NLD,2010.0,6,5,1
CAN,IRN,2000.0,28,19,9
BRA,FRA,2014.0,118,139,-21
USA,URY,2005.0,12,10,2
USA,GUM,2001.0,2,7,-5
USA,HUN,2012.0,66,69,-3
AUS,NZL,1997.0,54,65,-11
AUS,TUR,2015.0,15,8,7
MEX,ECU,2007.0,2,2,0
FRA,CAN,2023.0,148,134,14
PRT,CHN,2008.0,7,4,3
TWN,DEU,2012.0,22,22,0
VEN,MEX,2006.0,4,6,-2
IDN,SGP,2015.0,3,12,-9
MEX,FRA,2021.0,60,48,12
PRT,NLD,2012.0,24,21,3
SAU,CHN,2017.0,43,39,4
MEX,USA,2016.0,286,268,18
CAF,FRA,1999.0,5,1,4
IND,TWN,1998.0,18,1,17
BEL,KOR,2016.0,7,9,-2
DNK,SRB,2007.0,2,2,0
FRA,NOR,2017.0,43,25,18
ZAF,GBR,2013.0,88,115,-27
BGR,DEU,2006.0,37,16,21
USA,POL,2014.0,105,111,-6
SGP,CAN,2023.0,18,17,1
CAN,RUS,2002.0,19,38,-19
TUR,GRC,2005.0,2,6,-4
DEU,ITA,2018.0,257,351,-94
COG,COD,2018.0,146,60,86
SVK,AUT,2001.0,9,5,4
JPN,SGP,2014.0,28,32,-4
FRA,BFA,2008.0,14,12,2
USA,UGA,2020.0,42,32,10
AND,ESP,2005.0,3,1,2
GBR,MEX,2005.0,44,11,33
GUM,USA,2005.0,4,4,0
DEU,CHE,2022.0,602,455,147
USA,ARE,2014.0,95,30,65
FRA,DZA,2021.0,116,68,48
JPN,PHL,2010.0,26,15,11
BEL,FRA,2012.0,200,202,-2
POL,USA,2015.0,103,131,-28
GRC,NLD,2023.0,9,20,-11
DEU,ECU,2013.0,8,3,5
IND,GBR,2012.0,150,156,-6
JPN,ZMB,2003.0,2,3,-1
COG,COD,2017.0,84,36,48
NZL,USA,2015.0,124,117,7
AUT,CHE,2014.0,63,55,8
USA,POL,2004.0,146,153,-7
CHN,KOR,2000.0,19,11,8
KOR,CHN,2003.0,28,35,-7
DEU,GRC,2015.0,52,83,-31
FRA,IND,2018.0,79,93,-14
DEU,FRA,2023.0,193,231,-38
TUR,NLD,2013.0,34,13,21
AUT,CHE,2001.0,29,31,-2
ZAF,KEN,2011.0,9,13,-4
ROU,DEU,2004.0,28,19,9
NLD,CHE,2018.0,113,100,13
CYP,TUR,2016.0,44,105,-61
POL,GBR,2011.0,63,40,23
AUS,JPN,2008.0,46,63,-17
ROU,ITA,2008.0,16,18,-2
ITA,AUS,2020.0,51,58,-7
GBR,OMN,2014.0,17,9,8
USA,ARG,2016.0,120,94,26
ITA,NLD,2005.0,56,50,6
GBR,SAU,2020.0,237,85,152
LBN,LBY,2011.0,3,2,1
FIN,USA,2010.0,89,65,24
PAK,CHN,2020.0,389,421,-32
RUS,SWE,2011.0,15,11,4
USA,IRN,2010.0,58,179,-121
SWE,CAN,2009.0,43,31,12
MEX,DEU,2010.0,17,28,-11
KOR,CHN,2013.0,187,91,96
FRA,ZAF,2013.0,32,18,14
UKR,POL,2009.0,23,12,11
GBR,NLD,2005.0,158,177,-19
BEL,USA,2015.0,177,158,19
BEL,COD,2020.0,13,6,7
FRA,CZE,2005.0,18,21,-3
CAN,IRN,2010.0,62,171,-109
USA,IND,1998.0,193,347,-154
GBR,BHR,2010.0,2,3,-1
MEX,DEU,2000.0,11,15,-4
MEX,FRA,2009.0,35,40,-5
FRA,MEX,2016.0,61,54,7
TWN,CHN,2021.0,247,268,-21
TWN,USA,2000.0,152,300,-148
MEX,CHN,2005.0,3,1,2
RUS,BLR,2020.0,18,14,4
BLR,RUS,2023.0,14,7,7
FRA,LBN,2005.0,25,13,12
BRA,CAN,2006.0,34,49,-15
SWE,IRN,2007.0,12,7,5
BRA,JPN,1999.0,10,18,-8
SWE,DNK,2017.0,102,103,-1
DEU,BEL,2021.0,123,127,-4
TUR,GBR,2019.0,93,70,23
NOR,FRA,2014.0,29,33,-4
BRA,DEU,2009.0,53,67,-14
AUT,GBR,2003.0,38,27,11
SRB,MNE,2007.0,14,3,11
IRN,CAN,2006.0,64,50,14
NGA,COG,2020.0,5,3,2
GBR,MEX,2012.0,47,46,1
USA,SAU,2007.0,59,18,41
DEU,TUR,2004.0,21,18,3
DEU,ITA,2016.0,211,337,-126
GBR,MYS,2020.0,147,78,69
BRA,CHL,2000.0,4,10,-6
DNK,USA,2001.0,125,136,-11
USA,BRA,2000.0,244,278,-34
GBR,CZE,2019.0,63,53,10
DNK,DEU,2008.0,50,76,-26
CHN,CAN,2016.0,404,354,50
ESP,GRC,2014.0,18,17,1
CAN,GBR,2023.0,204,216,-12
TUN,ESP,2008.0,2,7,-5
BLR,RUS,2000.0,23,20,3
TUR,JPN,2017.0,7,7,0
GRC,CYP,2014.0,44,14,30
HKG,USA,2007.0,102,109,-7
SGP,HKG,2014.0,22,31,-9
HUN,FRA,1999.0,28,8,20
GBR,GEO,2007.0,4,1,3
RUS,POL,2022.0,18,12,6
CMR,FRA,2006.0,18,14,4
IND,IRQ,2019.0,20,4,16
PER,VEN,2006.0,1,1,0
ETH,NOR,2007.0,6,1,5
JPN,SEN,2013.0,2,1,1
CHN,HKG,2019.0,810,1272,-462
NZL,GBR,2018.0,107,115,-8
GBR,BRA,2021.0,109,165,-56
MAC,MAR,2012.0,10,6,4
AUS,JPN,2014.0,50,66,-16
AUS,TWN,2009.0,20,11,9
JPN,DEU,2010.0,127,103,24
THA,JPN,2010.0,70,88,-18
KOR,FIN,2011.0,5,1,4
CYP,TUR,2018.0,97,134,-37
USA,NZL,2014.0,115,117,-2
NLD,DEU,2022.0,327,370,-43
SWE,EGY,2015.0,5,7,-2
AUS,USA,1999.0,474,400,74
NOR,RUS,2006.0,11,16,-5
RUS,NOR,2008.0,26,5,21
DEU,FRA,2000.0,263,248,15
BGR,GBR,2006.0,8,10,-2
NZL,AUS,2004.0,96,90,6
JPN,BEL,2001.0,16,11,5
EGY,IRN,2013.0,3,6,-3
IRN,CAN,2000.0,19,28,-9
GBR,QAT,2017.0,44,16,28
ARG,ESP,2019.0,106,85,21
CHE,CHN,2013.0,40,43,-3
DEU,BEL,2009.0,103,76,27
RUS,IND,2003.0,3,2,1
AUS,FRA,2015.0,102,114,-12
USA,SAU,2020.0,390,162,228
SWE,ZAF,2015.0,4,9,-5
BGR,GBR,2010.0,18,10,8
GBR,CHE,2003.0,174,135,39
GBR,FRA,2020.0,521,527,-6
USA,IRN,2006.0,54,54,0
ESP,JPN,2006.0,6,10,-4
ITA,RUS,2015.0,32,14,18
GRC,SRB,2005.0,6,6,0
CUB,DEU,2014.0,6,1,5
USA,TZA,2004.0,8,7,1
TZA,USA,2021.0,23,21,2
FRA,LBN,2012.0,66,23,43
USA,PAN,2019.0,27,19,8
CAN,SWE,2012.0,39,34,5
SWE,CAN,2021.0,40,49,-9
VEN,USA,2007.0,38,43,-5
USA,SRB,1999.0,28,33,-5
SRB,PRT,2003.0,1,3,-2
IND,USA,2021.0,1602,894,708
GBR,FRA,1998.0,230,251,-21
NZL,RUS,2018.0,3,4,-1
GBR,DNK,2010.0,74,53,21
SWE,CHE,2011.0,63,56,7
ECU,NLD,2017.0,4,2,2
ECU,NLD,2022.0,6,3,3
CAN,MAC,2015.0,1,2,-1
SAU,GBR,2014.0,35,118,-83
IRN,GBR,2006.0,21,82,-61
USA,PER,2005.0,21,30,-9
PER,USA,2006.0,20,41,-21
SGP,ITA,2016.0,8,13,-5
MYS,PSE,2015.0,9,2,7
KOR,GBR,2005.0,31,33,-2
USA,CAN,1997.0,783,980,-197
CAN,FRA,2004.0,150,212,-62
CAN,VNM,2008.0,5,1,4
JPN,EGY,2017.0,75,33,42
USA,HKG,2004.0,76,101,-25
DNK,DEU,2014.0,102,99,3
GBR,JPN,2017.0,142,125,17
COL,GBR,2007.0,7,8,-1
POL,USA,2001.0,138,91,47
RUS,JPN,2009.0,16,19,-3
TUR,GBR,2011.0,50,46,4
GBR,TUR,2013.0,66,46,20
IRL,GBR,2019.0,286,484,-198
USA,GAB,2003.0,2,1,1
GAB,USA,2007.0,5,2,3
JPN,HUN,2004.0,4,7,-3
DEU,PAK,2011.0,19,23,-4
IND,CHE,2020.0,65,50,15
CAN,JPN,2007.0,74,93,-19
ESP,CHL,2005.0,28,22,6
JPN,GBR,2005.0,117,124,-7
PAK,USA,2016.0,119,80,39
GBR,SWE,2017.0,194,147,47
KOR,GBR,2012.0,29,56,-27
PER,USA,2010.0,56,31,25
ESP,ITA,2015.0,201,164,37
GBR,ARE,2017.0,82,26,56
ITA,GBR,2000.0,249,191,58
ITA,CHE,2023.0,156,109,47
IND,JPN,2021.0,104,85,19
MLI,SEN,2022.0,5,1,4
USA,TUN,2010.0,20,4,16
PRI,CHN,2019.0,2,1,1
GBR,PSE,2013.0,6,3,3
FRA,MAR,2003.0,68,52,16
CHE,ESP,2016.0,74,129,-55
EGY,DEU,2012.0,35,63,-28
NOR,SVK,2012.0,2,5,-3
NZL,AUS,2001.0,96,88,8
CAN,MAR,2011.0,12,3,9
MAR,CAN,2017.0,6,15,-9
POL,BEL,2019.0,24,17,7
NZL,AUS,2014.0,183,91,92
OMN,ARE,2021.0,6,1,5
SAU,USA,2005.0,20,46,-26
GBR,POL,2009.0,36,57,-21
GBR,KOR,2010.0,45,23,22
ARG,DEU,1998.0,16,11,5
BEL,NLD,1997.0,64,56,8
BEL,NLD,2002.0,114,115,-1
FRA,POL,2013.0,41,27,14
DNK,CHE,2007.0,12,23,-11
FRA,SWE,2018.0,84,66,18
CHE,AUS,2007.0,54,37,17
USA,GEO,2004.0,36,36,0
MEX,GBR,2015.0,47,47,0
DEU,JPN,2001.0,132,144,-12
ITA,AUS,1999.0,25,7,18
FRA,CHE,1999.0,197,138,59
DEU,HRV,2019.0,16,26,-10
IND,PRT,2009.0,14,5,9
FRA,MEX,2018.0,52,41,11
SGP,GBR,2013.0,69,103,-34
SGP,HKG,2001.0,19,22,-3
MYS,GBR,2004.0,25,35,-10
GRC,GBR,2000.0,64,117,-53
GRC,KWT,2020.0,2,1,1
FRA,NLD,2007.0,86,105,-19
GBR,PRT,2001.0,53,48,5
GRC,DEU,2002.0,30,47,-17
CMR,SEN,2014.0,2,2,0
IND,USA,2019.0,1576,888,688
USA,KAZ,2007.0,4,1,3
DEU,NZL,2008.0,35,19,16
CAN,AUS,2004.0,105,142,-37
NOR,JPN,2011.0,3,7,-4
NOR,TZA,2008.0,9,2,7
KOR,CHE,2008.0,13,5,8
UKR,FRA,2007.0,9,4,5
UKR,DEU,2010.0,35,17,18
CAN,FIN,2014.0,19,22,-3
FRA,AUT,2007.0,26,19,7
ESP,CAN,1998.0,19,27,-8
USA,CUB,2021.0,7,5,2
CUB,USA,2022.0,7,4,3
HUN,USA,2016.0,64,77,-13
AUS,ZAF,2013.0,30,51,-21
ISR,CAN,2000.0,36,21,15
KOR,VNM,2012.0,37,7,30
AUS,BWA,2011.0,5,1,4
ARG,ESP,2009.0,83,87,-4
AUS,CUB,2007.0,1,1,0
ISR,CHE,2009.0,11,14,-3
USA,SVK,2013.0,11,16,-5
FRA,THA,2003.0,5,4,1
DEU,MEX,2014.0,27,34,-7
PRT,ESP,2013.0,71,120,-49
BEL,ITA,2009.0,32,64,-32
KOR,JPN,2014.0,115,177,-62
LKA,CHE,2000.0,2,1,1
AUS,THA,2008.0,37,18,19
ESP,JPN,2010.0,32,24,8
NGA,UGA,2020.0,6,5,1
ZAF,USA,2016.0,137,131,6
IRN,CAN,2023.0,238,54,184
IRL,USA,2019.0,145,136,9
AUT,SWE,2004.0,8,8,0
DNK,DEU,2001.0,82,57,25
KOR,AUS,2019.0,64,28,36
GRC,SAU,2014.0,5,1,4
FIN,EST,2023.0,6,11,-5
ITA,DEU,2018.0,351,257,94
USA,FIN,2004.0,94,85,9
SRB,HUN,2013.0,2,4,-2
GMB,USA,2001.0,1,1,0
SYR,GBR,2015.0,7,2,5
KOR,USA,2019.0,812,874,-62
IRL,GBR,2022.0,378,392,-14
NLD,NOR,2013.0,34,24,10
GBR,ESP,2012.0,285,314,-29
CHE,NLD,2002.0,49,40,9
FRA,GBR,2009.0,401,340,61
TWN,CHN,2018.0,339,177,162
USA,KOR,2008.0,914,695,219
AUT,DEU,2006.0,171,263,-92
JPN,USA,2007.0,1210,1211,-1
USA,CHE,2003.0,416,427,-11
USA,KOR,2014.0,1077,810,267
AUT,TUR,2003.0,3,4,-1
CHE,USA,2013.0,528,561,-33
NZL,USA,2007.0,89,127,-38
RUS,CAN,2003.0,22,26,-4
CHN,CAN,2009.0,193,159,34
USA,GBR,2010.0,1657,1767,-110
JPN,ESP,2011.0,12,20,-8
DEU,USA,2009.0,1241,1148,93
CHL,SWE,2012.0,4,5,-1
NZL,AUS,2007.0,154,89,65
AUS,NZL,2013.0,104,202,-98
CHE,FRA,2007.0,207,283,-76
USA,JPN,2005.0,1177,1346,-169
BWA,NOR,2011.0,1,1,0
USA,TWN,2009.0,375,271,104
CHN,JPN,2011.0,390,481,-91
NZL,IRN,2006.0,4,1,3
IRN,KOR,2011.0,12,6,6
ITA,USA,2012.0,632,453,179
ISR,USA,1999.0,305,284,21
USA,ISR,2007.0,268,389,-121
USA,DEU,2005.0,1077,1205,-128
NGA,DEU,2006.0,8,8,0
DNK,NOR,2011.0,34,33,1
USA,IND,2014.0,929,1027,-98
POL,BEL,2017.0,15,12,3
POL,BEL,2022.0,19,13,6
IND,GBR,2003.0,95,94,1
COL,DEU,2007.0,9,6,3
USA,CHN,2016.0,3218,3391,-173
TUN,SAU,2009.0,13,3,10
DNK,ESP,2009.0,10,17,-7
DEU,AUT,2018.0,394,313,81
KOR,USA,2009.0,760,870,-110
KOR,USA,2011.0,800,983,-183
ESP,GBR,2011.0,296,312,-16
USA,CAN,2013.0,1610,1810,-200
GBR,USA,2004.0,1603,1297,306
GBR,USA,2014.0,1897,1767,130
FRA,CHE,2015.0,387,280,107
GBR,SWE,2019.0,194,166,28
AUS,GBR,2017.0,589,652,-63
CZE,JPN,2003.0,8,10,-2
AUS,HKG,2012.0,40,44,-4
GBR,NZL,2012.0,167,86,81
USA,CAN,2003.0,1562,1648,-86
CAN,USA,2005.0,1430,1426,4
CAN,USA,2012.0,1735,1540,195
GBR,USA,2008.0,1523,1540,-17
JPN,USA,2020.0,879,825,54
POL,FRA,2006.0,37,31,6
USA,IDN,2000.0,11,23,-12
GBR,ZMB,2015.0,13,2,11
USA,GBR,2023.0,848,1016,-168
ESP,USA,2004.0,359,301,58
MEX,CUB,2014.0,9,20,-11
ESP,DEU,2016.0,292,184,108
DEU,USA,2019.0,1331,1264,67
USA,EGY,2006.0,95,44,51
SWE,CHN,2007.0,50,30,20
AUS,USA,2004.0,474,486,-12
USA,IND,2015.0,910,1069,-159
BRA,USA,2004.0,286,286,0
BRA,USA,2014.0,487,438,49
DEU,IND,2006.0,71,106,-35
DNK,NLD,2017.0,29,59,-30
GBR,FRA,2014.0,434,482,-48
USA,AUT,2011.0,157,139,18
ESP,IRN,2022.0,18,37,-19
DEU,NLD,2002.0,216,155,61
NLD,DEU,2011.0,262,257,5
DEU,CHE,2009.0,645,453,192
NLD,DEU,2019.0,347,353,-6
AUS,BGD,2009.0,2,18,-16
CHN,USA,2010.0,2221,1753,468
USA,CHN,2018.0,3825,3772,53
RUS,DEU,2006.0,161,99,62
DEU,THA,2012.0,26,22,4
USA,SGP,2010.0,253,172,81
RUS,FRA,2004.0,55,45,10
FRA,TUN,2010.0,116,98,18
GBR,USA,2015.0,1889,1808,81
ARM,FRA,2016.0,3,1,2
NLD,GBR,2002.0,188,204,-16
FRA,GBR,2019.0,522,510,12
ROU,FRA,2012.0,38,42,-4
DEU,EGY,2010.0,51,35,16
IND,GBR,2013.0,151,170,-19
USA,VIR,2022.0,12,9,3
FRA,IRL,2005.0,26,17,9
CHN,USA,2006.0,1109,859,250
PAK,RUS,2008.0,1,1,0
NOR,DEU,2010.0,43,57,-14
MEX,USA,2019.0,295,378,-83
IRN,USA,2010.0,179,58,121
IRN,USA,2006.0,54,54,0
EGY,SAU,2017.0,284,249,35
CHN,HKG,2017.0,809,822,-13
GBR,ITA,2017.0,343,650,-307
DEU,JPN,2020.0,128,140,-12
BRA,SRB,2004.0,7,4,3
USA,MEX,2015.0,298,268,30
AUS,PNG,2018.0,12,4,8
TUR,AZE,2023.0,5,4,1
PRI,USA,2009.0,155,100,55
PRI,USA,2011.0,141,120,21
AUS,GBR,2018.0,626,650,-24
DEU,IRL,2006.0,38,14,24
HKG,CHN,2008.0,367,310,57
DEU,SGP,2013.0,50,23,27
EGY,DEU,2003.0,14,30,-16
USA,SAU,2014.0,166,91,75
DEU,AUT,2016.0,350,382,-32
GBR,CHE,2005.0,144,146,-2
GRC,DEU,2013.0,99,50,49
FRA,IND,2011.0,51,99,-48
USA,ESP,1998.0,252,284,-32
USA,DNK,2017.0,148,165,-17
AUS,CAN,2002.0,130,114,16
FIN,AUS,2010.0,12,5,7
AUS,USA,2015.0,655,692,-37
TWN,CHN,2017.0,295,139,156
RUS,MEX,2003.0,14,12,2
IND,KOR,2008.0,131,45,86
DEU,JPN,1999.0,121,114,7
DEU,USA,2011.0,1316,1254,62
USA,DEU,2012.0,1284,1265,19
ESP,USA,2015.0,634,421,213
AUT,ESP,2011.0,19,27,-8
FRA,CHE,2004.0,243,195,48
USA,PRI,2021.0,223,178,45
GBR,CYP,2008.0,18,6,12
GBR,CHN,2005.0,116,117,-1
FRA,ESP,2007.0,180,152,28
FRA,CHL,2007.0,30,26,4
FRA,MEX,2009.0,40,35,5
DNK,CHN,2013.0,27,42,-15
EGY,FRA,2010.0,11,15,-4
DZA,FRA,2003.0,37,52,-15
ITA,DEU,2009.0,211,131,80
AUT,PAK,2014.0,17,6,11
DEU,NLD,2012.0,228,259,-31
ITA,ESP,2009.0,185,113,72
RUS,DEU,2010.0,141,123,18
FRA,USA,2007.0,787,703,84
USA,ISR,2020.0,417,458,-41
DNK,NOR,2021.0,66,51,15
JPN,FRA,2023.0,38,49,-11
IRL,ROU,2016.0,2,2,0
ROU,IRL,2020.0,7,5,2
GBR,NZL,2002.0,98,118,-20
ESP,CUB,2006.0,19,20,-1
ECU,GBR,2016.0,10,8,2
ITA,USA,2005.0,476,400,76
VEN,USA,2004.0,46,38,8
GBR,IRL,2008.0,227,187,40
CHL,GBR,2016.0,48,48,0
ESP,USA,2008.0,402,387,15
USA,AUS,2009.0,622,488,134
FRA,BEL,2003.0,175,168,7
LBN,FRA,2004.0,11,31,-20
DNK,USA,2007.0,95,93,2
CHN,CAN,2011.0,236,254,-18
CHE,ESP,2009.0,43,48,-5
ESP,GBR,2009.0,269,252,17
USA,SGP,2006.0,160,136,24
BEL,FRA,2003.0,168,175,-7
CHN,DEU,2011.0,243,248,-5
FRA,ITA,2006.0,180,219,-39
ITA,FRA,2009.0,266,178,88
FRA,LBN,2013.0,62,27,35
GBR,AUS,2003.0,486,394,92
GBR,USA,2001.0,1787,1453,334
ARG,USA,2011.0,114,129,-15
CAN,BRA,2006.0,49,34,15
EST,DEU,2017.0,13,4,9
HUN,NLD,2010.0,12,9,3
JPN,TWN,2002.0,31,23,8
BRA,CHE,2003.0,11,8,3
FRA,SWE,2009.0,53,53,0
BEL,ITA,2016.0,68,105,-37
FRA,USA,1998.0,676,583,93
DEU,SRB,2022.0,9,6,3
FRA,TUR,2012.0,24,9,15
CHN,USA,2000.0,680,372,308
CIV,FRA,2013.0,25,42,-17
PRI,USA,2019.0,224,166,58
FRA,GBR,2011.0,422,465,-43
USA,IND,2004.0,338,656,-318
GBR,CHE,2002.0,144,161,-17
DEU,GBR,2005.0,477,411,66
DEU,GBR,2002.0,504,464,40
JPN,CHN,2013.0,567,359,208
FRA,SAU,2011.0,27,1,26
PAN,USA,2012.0,18,18,0
CAN,BRA,2010.0,54,74,-20
GBR,PAK,2003.0,38,17,21
TWN,CAN,2013.0,17,18,-1
NLD,USA,2017.0,426,411,15
TWN,GBR,2014.0,33,41,-8
BEL,JPN,2010.0,14,11,3
KOR,ISR,2012.0,2,4,-2
NLD,AUS,2008.0,55,48,7
AUS,NPL,2008.0,2,1,1
CHE,GBR,2007.0,194,161,33
USA,HRV,2004.0,23,15,8
GBR,DEU,2010.0,624,595,29
IND,USA,2022.0,1386,757,629
USA,IND,2008.0,548,865,-317
AUT,CHE,2007.0,53,44,9
COL,USA,2007.0,64,85,-21
GBR,THA,2017.0,85,48,37
GBR,SWE,2011.0,158,115,43
DEU,POL,2015.0,86,74,12
RUS,GBR,2007.0,67,29,38
DEU,ROU,2012.0,22,39,-17
USA,UGA,2008.0,23,16,7
ITA,FIN,2005.0,13,13,0
USA,CHE,2013.0,561,528,33
AUT,ITA,2010.0,41,41,0
BEL,BRA,2013.0,20,20,0
ZAF,GBR,2002.0,69,69,0
IND,KOR,2004.0,49,14,35
AUS,IND,2010.0,41,90,-49
ITA,USA,2002.0,614,587,27
SGP,CHN,2012.0,222,241,-19
JPN,KOR,2005.0,168,85,83
ARG,JPN,2009.0,2,2,0
ESP,USA,2014.0,594,371,223
ITA,FRA,2011.0,340,191,149
CHN,SWE,2008.0,69,46,23
GMB,GBR,2009.0,10,4,6
IND,SWE,2021.0,73,37,36
USA,GBR,2006.0,1497,1446,51
IND,USA,2017.0,1399,870,529
DEU,RUS,2020.0,95,171,-76
AUS,USA,2014.0,627,732,-105
FRA,DEU,2016.0,434,393,41
GRC,NOR,2018.0,23,3,20
FRA,DZA,2016.0,128,64,64
USA,POL,2007.0,131,142,-11
USA,PRT,2008.0,71,44,27
GBR,MYS,2008.0,104,29,75
BRA,ESP,2006.0,25,29,-4
LBN,USA,2008.0,53,36,17
BEL,FRA,2013.0,207,232,-25
CIV,NLD,2019.0,1,1,0
HKG,SGP,2020.0,42,45,-3
CAN,DEU,2010.0,169,164,5
TUR,DEU,2007.0,36,20,16
GBR,AUS,2013.0,736,465,271
HKG,USA,2004.0,101,76,25
DEU,AUT,2022.0,330,283,47
AUT,DEU,2023.0,175,219,-44
DEU,GBR,2012.0,613,638,-25
GBR,HKG,2019.0,53,73,-20
GBR,JPN,2009.0,137,131,6
CAN,CHE,2013.0,98,75,23
DEU,CHL,2007.0,20,21,-1
FRA,AUS,2006.0,62,42,20
AUS,SGP,2006.0,41,54,-13
AUT,ESP,2009.0,29,14,15
PRT,ITA,2023.0,22,27,-5
FRA,SWE,2011.0,51,49,2
GBR,FRA,2008.0,380,410,-30
USA,ITA,2018.0,489,664,-175
JPN,NLD,2005.0,19,13,6
JPN,FIN,2007.0,5,5,0
ISR,USA,2007.0,389,268,121
DEU,CAN,2013.0,172,203,-31
IND,USA,2016.0,1162,821,341
CHN,SWE,2004.0,23,29,-6
ESP,FRA,2010.0,189,261,-72
USA,DEU,2002.0,1320,1515,-195
CAN,FRA,2007.0,220,267,-47
CZE,FRA,2008.0,16,21,-5
FRA,ITA,2010.0,179,287,-108
AUS,FRA,2007.0,53,67,-14
GBR,DEU,2006.0,332,553,-221
GBR,BRA,2017.0,100,143,-43
HKG,CHN,2004.0,347,272,75
CHN,HKG,2022.0,1325,1400,-75
CHN,JPN,2009.0,298,456,-158
IDN,BRN,2018.0,1,3,-2
CHE,USA,2003.0,427,416,11
SGP,CHE,2019.0,31,22,9
CHE,SGP,2021.0,16,33,-17
DEU,CHE,2021.0,694,515,179
NZL,CAN,2013.0,39,47,-8
USA,PAN,2016.0,26,14,12
ESP,ITA,2020.0,205,224,-19
ITA,ESP,2021.0,279,252,27
USA,MEX,2008.0,222,177,45
IRL,USA,2016.0,195,111,84
CHE,VNM,2003.0,1,2,-1
PRT,FRA,2004.0,17,41,-24
SWE,NOR,2004.0,55,33,22
JPN,SWE,2018.0,32,16,16
AUS,IRL,2003.0,23,14,9
GBR,IRN,2001.0,46,18,28
AUT,CHE,1999.0,27,17,10
ISR,FRA,2009.0,23,20,3
ESP,AUS,2016.0,61,41,20
DNK,DEU,1999.0,45,56,-11
GBR,JOR,2008.0,19,2,17
FRA,DZA,2018.0,142,63,79
BRA,USA,2001.0,304,315,-11
IDN,AUS,2001.0,7,11,-4
JPN,BGR,2003.0,7,6,1
MYS,NGA,2019.0,120,55,65
AUS,GBR,2022.0,454,448,6
NLD,RUS,2015.0,19,14,5
IND,DEU,2007.0,110,66,44
GBR,BEL,2009.0,100,86,14
CHE,ITA,2000.0,77,94,-17
KEN,ZAF,2007.0,15,8,7
HKG,USA,2015.0,134,157,-23
KOR,CAN,2013.0,45,44,1
SAU,PAK,2015.0,32,91,-59
NGA,KEN,2017.0,5,4,1
DEU,ITA,2011.0,158,274,-116
MAR,USA,2021.0,19,18,1
EGY,USA,2017.0,124,129,-5
IDN,JPN,2008.0,17,63,-46
JPN,CAN,2002.0,124,109,15
IRL,MYS,2011.0,6,1,5
DEU,ITA,2009.0,131,211,-80
HRV,SWE,2014.0,4,1,3
QAT,CAN,2019.0,10,28,-18
USA,POL,2020.0,113,134,-21
ESP,MEX,2003.0,84,70,14
JPN,KOR,1997.0,71,35,36
BEL,TUR,2018.0,12,8,4
JPN,USA,1998.0,1105,1035,70
GBR,NZL,2005.0,127,96,31
JPN,CHN,2003.0,331,289,42
DNK,JPN,2009.0,9,14,-5
GBR,ARE,2009.0,20,4,16
ARE,GBR,2010.0,12,26,-14
GBR,ARE,2011.0,32,7,25
CHE,DEU,2016.0,495,680,-185
CHE,DEU,2018.0,504,681,-177
DEU,ITA,2019.0,261,372,-111
GBR,IND,2011.0,155,149,6
GBR,IRL,2001.0,247,133,114
AUT,ESP,2019.0,40,36,4
DEU,SWE,2005.0,97,92,5
GBR,IND,2009.0,110,159,-49
EGY,USA,2016.0,125,134,-9
USA,EGY,2023.0,68,85,-17
JPN,KOR,2012.0,154,111,43
GBR,CHE,2012.0,304,204,100
USA,PRI,2009.0,100,155,-55
BRA,JPN,2004.0,11,11,0
FRA,BEL,2013.0,232,207,25
JPN,CZE,2009.0,10,8,2
AUT,USA,2016.0,133,171,-38
ITA,MAR,2004.0,3,4,-1
USA,ECU,2015.0,38,10,28
ESP,DEU,2017.0,294,211,83
SWE,NLD,2009.0,36,35,1
EST,IND,2020.0,1,7,-6
JPN,EGY,2009.0,48,29,19
SWE,USA,2001.0,338,252,86
CHN,AUS,2011.0,221,133,88
USA,AUT,2021.0,123,128,-5
HKG,USA,2014.0,134,151,-17
NLD,USA,2016.0,460,402,58
DNK,BEL,2017.0,16,18,-2
GBR,CAN,2007.0,319,302,17
DEU,CHN,2016.0,361,393,-32
AUT,GBR,2005.0,47,42,5
USA,DNK,2018.0,176,154,22
AUS,SWE,2020.0,73,63,10
JPN,USA,1999.0,1230,1114,116
DEU,NOR,2002.0,24,21,3
BEL,MEX,2003.0,5,4,1
GBR,SAU,2008.0,42,23,19
AUS,GBR,2016.0,604,643,-39
USA,GBR,2000.0,1292,1535,-243
ITA,SAU,2023.0,9,5,4
MEX,ESP,2012.0,102,146,-44
ESP,MEX,2013.0,172,117,55
AUT,DEU,2000.0,195,165,30
GBR,AUT,2013.0,88,78,10
GBR,BRA,2018.0,139,170,-31
GBR,HKG,2009.0,46,46,0
BRA,DEU,2022.0,144,64,80
CHE,NLD,2005.0,32,54,-22
DEU,NZL,2007.0,27,25,2
NZL,SGP,1997.0,3,4,-1
USA,EGY,2010.0,125,59,66
SGP,AUS,2003.0,43,34,9
CAN,NGA,2009.0,2,1,1
CHN,MAC,2012.0,52,21,31
AUS,ZAF,2005.0,18,26,-8
CHE,AUT,2020.0,77,100,-23
CHE,DEU,2022.0,455,602,-147
ECU,USA,2003.0,11,9,2
USA,PRT,2015.0,69,102,-33
POL,DEU,2010.0,76,71,5
ESP,NLD,1999.0,44,41,3
NLD,CHE,2011.0,77,48,29
NLD,GBR,2005.0,177,158,19
HKG,USA,2008.0,133,113,20
GEO,DEU,2013.0,4,2,2
DEU,GEO,2018.0,3,3,0
FRA,DZA,2017.0,134,52,82
JPN,KOR,2002.0,160,103,57
FRA,USA,2020.0,848,740,108
ARE,USA,2017.0,60,82,-22
SWE,DNK,2011.0,79,63,16
IND,SWE,2019.0,75,41,34
BEL,CHN,2008.0,17,16,1
PER,MEX,2008.0,4,6,-2
SWE,DNK,2009.0,96,50,46
CAN,ARG,2011.0,10,15,-5
CHN,TWN,2010.0,176,160,16
SGP,CHN,2005.0,104,92,12
HKG,CHN,2015.0,782,620,162
IND,KOR,2015.0,232,130,102
KOR,IND,2023.0,112,234,-122
USA,SWE,2010.0,231,224,7
FRA,NOR,2009.0,27,17,10
DEU,CHE,2019.0,670,506,164
TWN,ETH,2017.0,3,4,-1
FRA,GRC,2010.0,28,29,-1
CRI,USA,2003.0,8,18,-10
HKG,GBR,2005.0,34,24,10
DEU,ARM,2016.0,3,4,-1
EGY,JPN,2006.0,14,31,-17
NLD,USA,2018.0,484,423,61
CAN,COL,2008.0,12,12,0
COL,CAN,2010.0,17,8,9
USA,CYP,2013.0,23,15,8
GBR,HUN,2016.0,27,43,-16
DNK,ISL,2007.0,10,6,4
GBR,BRA,2016.0,103,140,-37
EGY,SAU,2018.0,320,309,11
SGP,IND,2003.0,14,31,-17
CHN,ISR,2011.0,13,8,5
USA,CHL,2007.0,86,58,28
GBR,SVN,2021.0,14,15,-1
IRN,FIN,2022.0,47,7,40
PRT,ARG,1999.0,2,1,1
BEL,USA,2007.0,136,108,28
BRA,FIN,2009.0,2,2,0
SWE,USA,2014.0,233,238,-5
AUS,HKG,1997.0,25,7,18
CHN,GBR,2013.0,244,397,-153
CHN,SGP,2022.0,341,505,-164
MEX,BRA,1999.0,7,4,3
CAN,BRA,2000.0,25,37,-12
BEN,TGO,2007.0,2,2,0
GBR,NLD,2013.0,254,257,-3
VIR,USA,2008.0,4,6,-2
NLD,ITA,2006.0,59,59,0
AUS,CAN,2005.0,132,110,22
USA,PER,2013.0,40,23,17
DNK,ARE,2018.0,4,3,1
ESP,FRA,2024.0,7,1,6
DEU,CHE,2011.0,722,420,302
SWE,GBR,2003.0,110,109,1
FRA,JPN,2007.0,74,70,4
USA,TUR,2011.0,303,226,77
IRL,GBR,2016.0,319,252,67
ESP,ITA,1998.0,39,65,-26
CYP,TUR,2021.0,140,172,-32
ITA,DEU,2011.0,274,158,116
BGD,AUS,2010.0,13,6,7
RUS,POL,2011.0,13,7,6
GBR,BEL,2019.0,173,149,24
JPN,GBR,2003.0,153,142,11
SWE,DEU,2010.0,128,110,18
FRA,NLD,2004.0,81,89,-8
USA,FIN,2007.0,65,69,-4
NOR,FRA,1999.0,12,16,-4
MEX,GBR,2007.0,36,35,1
KOR,IND,2006.0,25,79,-54
KOR,IND,2010.0,99,148,-49
PRT,BRA,2022.0,143,194,-51
HUN,ESP,2010.0,10,4,6
PHL,GBR,2022.0,14,7,7
ESP,RUS,2013.0,9,11,-2
AUT,CHE,1998.0,39,13,26
HKG,GBR,2012.0,19,53,-34
DEU,SWE,2012.0,163,96,67
AUT,CHL,2013.0,4,2,2
ISR,DEU,2014.0,46,51,-5
PRT,FRA,2008.0,26,36,-10
CHE,ESP,2021.0,73,126,-53
DEU,PRT,2019.0,35,52,-17
POL,PRT,2023.0,2,8,-6
NLD,ITA,2010.0,67,105,-38
AUS,MYS,2016.0,105,126,-21
SWE,RUS,2008.0,20,17,3
CHE,AUS,2015.0,72,72,0
USA,ROU,2007.0,35,24,11
UKR,USA,2004.0,43,17,26
GBR,CHN,2012.0,362,246,116
USA,AUS,2011.0,692,645,47
UKR,GBR,2008.0,64,6,58
IND,AUS,2008.0,74,24,50
USA,JPN,2002.0,1329,1677,-348
DEU,JOR,2014.0,16,4,12
JPN,KAZ,2021.0,4,3,1
SWE,DNK,2019.0,109,115,-6
DEU,OMN,2006.0,1,1,0
SWE,BEL,2010.0,25,17,8
FRA,SAU,2021.0,36,21,15
JPN,SGP,2007.0,23,13,10
AUT,PAK,2015.0,19,7,12
DEU,TWN,2017.0,15,26,-11
DNK,SWE,2021.0,112,89,23
NOR,USA,2020.0,69,133,-64
USA,QAT,2017.0,50,48,2
NLD,FRA,2011.0,92,97,-5
NLD,IND,2018.0,40,29,11
USA,BEL,2013.0,167,185,-18
GBR,CHN,2002.0,85,105,-20
ISR,GBR,2010.0,38,37,1
KEN,AUS,2005.0,3,1,2
GBR,SGP,2017.0,162,114,48
DNK,SWE,2011.0,63,79,-16
IRL,DEU,2010.0,41,61,-20
ISL,USA,1999.0,15,8,7
USA,ISL,2004.0,18,14,4
LBN,USA,2004.0,35,35,0
FRA,CHE,2008.0,276,238,38
NOR,GBR,2000.0,37,34,3
NLD,GRC,2017.0,19,32,-13
GBR,QAT,2019.0,52,30,22
IRL,NGA,2015.0,1,3,-2
AUS,ESP,1999.0,7,5,2
AUT,USA,2017.0,148,132,16
CUB,ITA,2010.0,5,7,-2
BRA,USA,2015.0,534,470,64
DEU,IDN,2015.0,29,12,17
SWE,GBR,2013.0,112,181,-69
ESP,CHE,2001.0,24,29,-5
FRA,IND,2021.0,85,105,-20
ITA,TWN,2009.0,3,1,2
TWN,ITA,2010.0,2,2,0
NLD,BEL,2017.0,172,176,-4
USA,ESP,2007.0,356,320,36
CHN,SWE,2014.0,90,87,3
IND,AUS,2014.0,111,62,49
USA,ALB,2010.0,9,4,5
MEX,ARG,2009.0,11,10,1
NLD,CHN,2007.0,27,40,-13
AUT,ESP,2021.0,29,30,-1
USA,FIN,1998.0,79,69,10
MYS,SGP,2008.0,8,11,-3
CHN,HKG,2018.0,793,1018,-225
ZAF,USA,2011.0,87,122,-35
BGR,CZE,2020.0,2,3,-1
ROU,NLD,2006.0,4,3,1
FRA,AUT,2008.0,27,25,2
SRB,DEU,2014.0,21,8,13
GBR,ESP,2002.0,170,192,-22
LBN,FRA,2008.0,25,32,-7
CAN,EGY,2019.0,59,51,8
POL,NLD,2006.0,11,10,1
SWE,JPN,2013.0,20,25,-5
ESP,DEU,2022.0,213,229,-16
ARG,BRA,2011.0,27,31,-4
HKG,CAN,2010.0,23,19,4
JPN,CAN,2005.0,101,85,16
CAN,JPN,2008.0,85,88,-3
FRA,USA,1999.0,790,527,263
POL,FRA,2000.0,27,48,-21
GRC,CHE,2010.0,24,11,13
CHE,GRC,2011.0,12,19,-7
MAR,FRA,2009.0,44,92,-48
USA,ARG,2011.0,129,114,15
JPN,FRA,2006.0,66,70,-4
TWN,CHE,2013.0,1,4,-3
CHL,ESP,2006.0,36,42,-6
CAN,USA,1997.0,980,783,197
KOR,CAN,2003.0,30,30,0
SGP,CHN,2002.0,48,92,-44
IND,ARE,2014.0,40,8,32
ARE,IND,2019.0,25,70,-45
GBR,CHE,1997.0,100,98,2
PRT,FRA,2001.0,35,25,10
ARE,SAU,2003.0,7,7,0
GBR,CAN,1999.0,205,223,-18
HKG,SGP,2007.0,20,16,4
DNK,GBR,2010.0,53,74,-21
BGD,MYS,2016.0,39,37,2
COL,DEU,1999.0,4,2,2
FRA,MAR,2002.0,88,66,22
ITA,DEU,2019.0,372,261,111
MAR,AUT,2009.0,1,1,0
DEU,PER,2017.0,2,4,-2
USA,PSE,2012.0,13,3,10
IND,CHE,2004.0,20,8,12
CAN,ARG,2009.0,14,17,-3
AUS,NZL,2003.0,102,116,-14
PAK,NZL,2011.0,4,4,0
GBR,TWN,2008.0,46,14,32
USA,AUS,2021.0,583,674,-91
CHE,AUS,2014.0,66,59,7
DEU,PRT,2021.0,49,52,-3
SAU,EGY,2012.0,152,267,-115
GBR,ISR,2006.0,21,28,-7
BRA,FRA,2007.0,76,78,-2
IND,FRA,2018.0,93,79,14
AUT,AUS,2011.0,43,37,6
VNM,USA,1999.0,3,2,1
GBR,AUT,2003.0,27,38,-11
CHN,USA,2023.0,1692,2356,-664
HRV,USA,2013.0,20,18,2
SAU,USA,2003.0,32,74,-42
CAN,FRA,2020.0,339,372,-33
FRA,GUF,2015.0,26,34,-8
USA,TWN,2019.0,251,294,-43
FRA,ROU,2018.0,25,23,2
KOR,CHN,2012.0,208,80,128
AUT,ITA,2000.0,20,15,5
IND,CAN,2010.0,115,74,41
GBR,NOR,2003.0,50,34,16
NLD,AUS,2014.0,101,60,41
JPN,LKA,2013.0,14,4,10
SWE,GRC,2015.0,9,20,-11
JPN,FRA,2010.0,103,82,21
ZAF,MWI,2007.0,2,2,0
AUS,CHE,2012.0,58,65,-7
FRA,LUX,2016.0,25,14,11
KOR,SGP,2017.0,32,21,11
PRT,BRA,2017.0,199,150,49
TUR,IRN,2016.0,16,26,-10
JOR,SAU,2012.0,42,8,34
LKA,NLD,2010.0,1,1,0
CAN,AUS,2020.0,191,210,-19
SWE,AUS,2010.0,41,38,3
GBR,FRA,2015.0,450,518,-68
POL,GBR,2022.0,54,64,-10
VEN,USA,2008.0,36,25,11
ESP,ITA,2007.0,86,134,-48
IND,IRN,2015.0,31,12,19
POL,CHE,2017.0,31,24,7
USA,TUR,2021.0,291,309,-18
GRC,CYP,2020.0,61,31,30
GBR,TUR,1997.0,35,23,12
JPN,TUR,2005.0,6,7,-1
FIN,TUR,2005.0,3,5,-2
IND,CAN,2006.0,57,43,14
ITA,ESP,2019.0,257,219,38
PHL,CAN,2008.0,3,2,1
ARG,ESP,2018.0,77,113,-36
USA,NZL,1998.0,78,94,-16
NLD,GBR,2012.0,239,198,41
FRA,MAR,2012.0,124,59,65
AUS,FIN,2018.0,27,28,-1
USA,DEU,1997.0,793,873,-80
ROU,USA,2000.0,40,10,30
USA,PHL,2014.0,39,25,14
GBR,GHA,2018.0,20,23,-3
ESP,BEL,2010.0,30,51,-21
RWA,USA,2018.0,15,11,4
GBR,IRL,2015.0,239,277,-38
EGY,SAU,2016.0,287,267,20
NLD,DEU,2009.0,218,231,-13
BGR,BEL,2009.0,10,4,6
FRA,TUN,2006.0,89,54,35
AUT,NLD,2014.0,23,28,-5
GBR,ITA,2016.0,332,628,-296
FRA,ESP,1999.0,145,110,35
PER,DEU,2009.0,1,1,0
DEU,IND,2010.0,92,131,-39
MEX,ESP,2002.0,72,82,-10
SVK,CZE,2018.0,109,89,20
FRA,POL,2012.0,36,23,13
GBR,IND,2019.0,223,318,-95
CAN,SWE,2013.0,45,37,8
PAK,CAN,2013.0,20,16,4
SAU,IND,2004.0,7,13,-6
SGP,FRA,2010.0,16,20,-4
FRA,CHE,2014.0,377,252,125
UKR,RUS,1999.0,87,71,16
DEU,CAN,2003.0,161,122,39
IRL,USA,2017.0,151,154,-3
FRA,CMR,2004.0,11,12,-1
NGA,USA,2017.0,61,48,13
KEN,UGA,2022.0,13,14,-1
CHE,IND,2013.0,36,48,-12
ITA,BGD,2004.0,1,1,0
SWE,URY,2020.0,2,1,1
FRA,NLD,2014.0,111,135,-24
CZE,IND,2001.0,1,1,0
DEU,USA,2021.0,1175,1144,31
BHR,CAN,2006.0,2,2,0
USA,ITA,2016.0,419,677,-258
ESP,VEN,2005.0,22,19,3
JPN,HKG,2000.0,8,5,3
GBR,HKG,2021.0,75,79,-4
DEU,ARG,2016.0,25,21,4
BFA,USA,2013.0,8,4,4
USA,MEX,2014.0,267,267,0
CHE,GBR,2020.0,327,381,-54
ESP,GRC,2020.0,15,18,-3
PAK,DEU,2019.0,26,63,-37
BRA,ITA,2022.0,68,45,23
PRT,NGA,2019.0,4,1,3
HUN,GBR,2011.0,48,29,19
CHE,ITA,2006.0,75,115,-40
BEL,CHN,2001.0,11,14,-3
POL,NOR,2013.0,9,4,5
ISR,DEU,2004.0,38,22,16
RUS,SWE,2018.0,30,15,15
BLR,USA,2006.0,9,4,5
SGP,OMN,2012.0,1,2,-1
NLD,CAN,2013.0,67,63,4
KEN,GBR,2010.0,27,18,9
FIN,GBR,2014.0,62,56,6
CAN,JPN,2015.0,76,83,-7
BRA,DEU,2017.0,110,114,-4
CHE,HKG,2008.0,6,4,2
TWN,VNM,2009.0,3,1,2
ARG,USA,2009.0,119,122,-3
ESP,CHN,2012.0,16,20,-4
USA,ARG,2019.0,101,133,-32
NLD,AUT,2010.0,22,23,-1
USA,TWN,2021.0,229,257,-28
JPN,CAN,2012.0,93,90,3
USA,EST,2009.0,8,4,4
CHE,PSE,2020.0,1,1,0
GEO,USA,2013.0,42,53,-11
DNK,DEU,2007.0,61,83,-22
SVN,HRV,2021.0,14,10,4
HRV,CHE,2022.0,5,5,0
LKA,BRA,2009.0,1,1,0
ESP,FRA,2006.0,150,153,-3
PRT,BRA,2016.0,176,120,56
ARM,IRN,2012.0,3,2,1
USA,SWE,2023.0,136,113,23
CAN,OMN,1999.0,4,1,3
ECU,BEL,2016.0,6,4,2
CAN,KOR,2005.0,25,40,-15
NZL,CHN,2010.0,8,7,1
USA,JPN,1997.0,978,900,78
CHE,NOR,2017.0,23,19,4
PAK,JPN,2014.0,8,11,-3
JPN,SAU,2016.0,23,8,15
BRA,GBR,2013.0,66,76,-10
BRA,PRT,2010.0,102,90,12
DNK,USA,1999.0,136,100,36
MAC,CHN,2013.0,22,46,-24
ESP,HUN,2012.0,5,11,-6
ZAF,CAN,2008.0,23,13,10
USA,BEL,2003.0,131,183,-52
IND,HKG,2019.0,13,16,-3
SWE,USA,2004.0,259,202,57
DEU,LTU,2007.0,12,9,3
FRA,URY,2017.0,5,2,3
HKG,MAC,2013.0,17,3,14
USA,LUX,2009.0,6,2,4
CHE,KOR,2012.0,11,8,3
AUT,DNK,2017.0,12,13,-1
ISR,USA,2020.0,458,417,41
USA,GRC,2003.0,149,86,63
SRB,USA,2006.0,40,41,-1
CYP,NLD,2017.0,4,3,1
NGA,NER,2011.0,5,31,-26
ARG,USA,2019.0,133,101,32
SWE,DEU,2006.0,91,96,-5
CHN,NLD,2003.0,29,9,20
QAT,GRC,2020.0,2,6,-4
GBR,ISR,2000.0,34,26,8
CHE,CAN,1999.0,44,57,-13
IND,SWE,2009.0,29,9,20
DEU,JOR,2008.0,14,7,7
MNG,RUS,2020.0,2,2,0
POL,GBR,2017.0,104,70,34
NGA,ZAF,2023.0,53,70,-17
FRA,CHN,2018.0,281,190,91
ROU,USA,2006.0,29,26,3
ISR,FRA,2011.0,21,19,2
GBR,MYS,2004.0,35,25,10
USA,SVN,2006.0,11,14,-3
NLD,IDN,2011.0,13,12,1
IDN,NLD,2012.0,10,16,-6
SWE,MYS,2014.0,5,2,3
OMN,PAK,2018.0,5,6,-1
YEM,USA,2003.0,2,2,0
FRA,POL,2005.0,37,37,0
SWE,USA,2008.0,214,175,39
GBR,TUR,2002.0,72,24,48
DNK,CAN,2013.0,20,25,-5
MEX,SWE,2011.0,5,1,4
AUT,BEL,2018.0,30,14,16
NZL,ISR,1999.0,3,2,1
ISR,NZL,2003.0,2,2,0
CHE,CZE,2021.0,15,23,-8
NZL,GBR,2019.0,132,149,-17
THA,SGP,2012.0,4,10,-6
BLZ,USA,2012.0,3,3,0
CHL,USA,1997.0,27,39,-12
USA,CHL,1998.0,36,30,6
USA,PRI,2019.0,166,224,-58
FRA,NLD,2008.0,84,119,-35
MEX,USA,2009.0,245,239,6
CHN,DEU,2021.0,506,620,-114
BRA,ITA,2017.0,60,65,-5
JOR,GBR,2021.0,30,45,-15
CHE,SGP,2009.0,9,7,2
CHE,SGP,2011.0,15,14,1
SGP,TWN,2007.0,7,5,2
HRV,USA,2003.0,13,31,-18
NZL,USA,1998.0,94,78,16
SWE,ETH,2007.0,2,1,1
UKR,USA,2008.0,28,21,7
DNK,FRA,2015.0,37,30,7
JAM,BRB,2016.0,5,1,4
SVK,CZE,2017.0,72,93,-21
CZE,SVK,2019.0,66,99,-33
ZAF,SWE,2018.0,22,13,9
ARG,GBR,2010.0,7,13,-6
TWN,CHN,2016.0,240,127,113
MYS,USA,2006.0,11,21,-10
ESP,CAN,2014.0,89,40,49
UGA,CHE,2012.0,4,2,2
ESP,COL,2021.0,139,126,13
USA,ITA,2017.0,451,693,-242
GBR,NGA,2016.0,72,41,31
BEL,NOR,2022.0,10,10,0
FRA,SYR,2010.0,12,2,10
USA,GEO,2020.0,232,289,-57
BRA,COL,2003.0,7,8,-1
MEX,CHE,1998.0,3,1,2
IRL,NZL,2007.0,7,7,0
USA,SVN,2010.0,10,14,-4
IRN,TUR,2016.0,26,16,10
HKG,CHN,2001.0,254,216,38
URY,USA,2007.0,10,9,1
GUM,USA,2003.0,7,7,0
SAU,GBR,1999.0,11,12,-1
SWE,PRT,2008.0,10,4,6
CHE,NLD,2012.0,59,95,-36
NLD,FRA,2019.0,104,153,-49
POL,DNK,2008.0,10,8,2
USA,HUN,2013.0,68,79,-11
NZL,AUS,1999.0,101,77,24
FRA,ESP,2020.0,282,242,40
NOR,GBR,2006.0,34,53,-19
HKG,AUS,2011.0,33,24,9
ZMB,USA,2010.0,7,8,-1
USA,ZMB,2011.0,12,11,1
THA,AUS,2010.0,26,41,-15
ZAF,USA,2009.0,96,92,4
USA,URY,2013.0,6,12,-6
IND,NGA,2010.0,7,5,2
NZL,GBR,2009.0,104,125,-21
DEU,ECU,2012.0,2,5,-3
AUS,MYS,2017.0,112,141,-29
USA,SAU,2008.0,53,40,13
AUT,SWE,1999.0,9,7,2
USA,JAM,2007.0,2,4,-2
ARG,ESP,2017.0,83,125,-42
IND,TWN,2001.0,27,7,20
IND,BRA,2011.0,6,4,2
OMN,ARE,2018.0,10,5,5
TZA,GBR,2018.0,6,6,0
GBR,GHA,2017.0,38,16,22
GBR,COL,2012.0,14,17,-3
HKG,CAN,2006.0,17,19,-2
IRL,ESP,2010.0,20,9,11
KOR,FRA,2009.0,27,20,7
AUS,BEL,2003.0,15,18,-3
VEN,CUB,2007.0,1,3,-2
AUS,DNK,2015.0,32,28,4
ITA,DNK,2017.0,44,22,22
PRT,BEL,2007.0,4,2,2
FIN,CHN,2019.0,40,52,-12
ITA,BRA,2009.0,32,39,-7
JPN,EGY,2011.0,61,14,47
ESP,USA,2001.0,404,304,100
DEU,DNK,2010.0,112,70,42
DEU,DNK,2023.0,78,49,29
MYS,CAN,2008.0,1,7,-6
IND,JPN,2016.0,124,68,56
UKR,USA,2014.0,28,36,-8
BEL,IRL,2007.0,4,4,0
KOR,BGD,2010.0,17,16,1
GBR,JOR,2014.0,38,8,30
HKG,CHN,2014.0,722,616,106
IND,BRA,2019.0,18,17,1
AUS,OMN,2011.0,5,1,4
BGD,USA,2008.0,28,17,11
POL,USA,2007.0,142,131,11
CHN,GBR,2003.0,115,113,2
FRA,GLP,2004.0,17,26,-9
CZE,DEU,2003.0,32,31,1
ARE,USA,2018.0,58,123,-65
USA,ARE,2020.0,103,76,27
UKR,RUS,2007.0,38,45,-7
USA,CHN,2022.0,4218,2281,1937
CHE,FRA,1999.0,138,197,-59
RUS,GBR,2020.0,79,57,22
IND,FRA,2017.0,120,68,52
AUS,JPN,2020.0,70,67,3
AUT,USA,2022.0,118,129,-11
ITA,ARG,2011.0,20,12,8
NLD,TUR,2014.0,19,24,-5
CZE,HUN,2014.0,5,5,0
ARG,BRA,2009.0,26,33,-7
AUT,ITA,2006.0,22,22,0
ITA,AUS,2008.0,27,17,10
CAN,CHL,2011.0,13,20,-7
IRL,CHE,2009.0,7,14,-7
IND,USA,2018.0,1570,877,693
DEU,BRA,2009.0,67,53,14
AUS,THA,2007.0,28,20,8
CHE,BEL,2017.0,41,72,-31
KGZ,RUS,2009.0,3,3,0
GBR,ROU,2004.0,10,13,-3
FRA,ZAF,2002.0,15,21,-6
GBR,CAN,2020.0,494,456,38
KOR,EGY,2007.0,3,3,0
CAN,BEL,2018.0,44,46,-2
NOR,DNK,2011.0,33,34,-1
IRL,SGP,2014.0,5,7,-2
ISR,ITA,2003.0,18,13,5
IND,FIN,2011.0,15,2,13
ESP,CAN,2008.0,45,35,10
USA,RUS,2012.0,172,155,17
TUN,BEL,2013.0,5,6,-1
RUS,DEU,2023.0,118,36,82
AUS,DNK,2008.0,23,22,1
BRA,ESP,2023.0,78,35,43
UKR,FRA,2015.0,14,8,6
FRA,AUS,2010.0,111,81,30
DEU,CHN,2018.0,460,467,-7
LTU,ITA,2008.0,2,7,-5
SWE,AUS,2006.0,37,31,6
SWE,FRA,2005.0,45,40,5
GBR,IRL,2014.0,214,312,-98
SGP,HKG,2007.0,16,20,-4
UKR,POL,2018.0,34,24,10
USA,GRC,2013.0,109,136,-27
USA,PHL,2008.0,34,30,4
POL,DEU,2006.0,66,65,1
CAN,DEU,2023.0,88,89,-1
CZE,FRA,2015.0,18,28,-10
ITA,BRA,2011.0,47,34,13
USA,HUN,2003.0,83,81,2
IND,PRT,2016.0,14,11,3
BEL,CZE,2009.0,5,5,0
MDG,ITA,2002.0,3,1,2
MDA,ROU,2022.0,3,2,1
HUN,DEU,2019.0,47,34,13
BRA,PRT,2006.0,51,43,8
BEL,AUS,2013.0,23,18,5
USA,GAB,2012.0,2,1,1
GAB,USA,2015.0,5,3,2
DEU,SVN,2011.0,7,10,-3
USA,ROU,2020.0,30,25,5
CHN,TWN,2000.0,86,57,29
FRA,DEU,2018.0,420,383,37
NGA,ZAF,2010.0,31,13,18
NLD,LUX,2010.0,6,1,5
GRD,USA,2015.0,13,10,3
NZL,GBR,2011.0,117,134,-17
ETH,USA,2013.0,26,14,12
GMB,NGA,2007.0,2,1,1
GMB,GBR,2021.0,14,13,1
IND,DEU,1998.0,60,36,24
ROU,DEU,1999.0,19,14,5
NLD,BEL,2022.0,147,189,-42
SWE,FRA,2012.0,62,67,-5
DEU,NOR,2005.0,39,12,27
JPN,IRN,2010.0,24,23,1
GBR,IRN,2004.0,81,16,65
AUT,USA,2018.0,148,152,-4
CAN,SRB,2004.0,6,8,-2
SWE,ITA,2009.0,25,31,-6
DEU,BRA,2011.0,79,79,0
DEU,POL,2014.0,80,91,-11
USA,TUR,2009.0,248,222,26
USA,MEX,2004.0,222,177,45
JPN,MNG,2010.0,8,6,2
ROU,USA,2010.0,33,45,-12
DEU,CHL,1998.0,15,5,10
SVN,AUT,2012.0,8,6,2
ESP,PRT,2007.0,43,49,-6
IDN,GBR,2021.0,40,57,-17
JAM,GBR,2008.0,5,4,1
PRT,BRA,2018.0,155,164,-9
CAN,ARE,2017.0,33,24,9
USA,AUT,2009.0,112,119,-7
USA,PRT,2014.0,77,79,-2
BEL,RUS,2008.0,12,9,3
MYS,GBR,2007.0,27,94,-67
SWE,NLD,2019.0,79,88,-9
NLD,SWE,2020.0,82,80,2
DEU,HRV,2016.0,21,22,-1
USA,HRV,2015.0,18,20,-2
BWA,GBR,2005.0,2,6,-4
DEU,IDN,2008.0,15,6,9
ZAF,ESP,2007.0,4,1,3
CAN,JPN,2014.0,74,98,-24
CHE,AUS,2008.0,50,51,-1
CAN,EGY,2011.0,27,18,9
IDN,MYS,2013.0,19,57,-38
SAU,EGY,2002.0,37,37,0
CAN,ZAF,2013.0,17,19,-2
AUS,USA,2001.0,598,467,131
FIN,ROU,2015.0,3,4,-1
RUS,BLR,2008.0,14,22,-8
KOR,USA,2021.0,850,797,53
CAN,RUS,2003.0,26,22,4
DEU,PRT,2009.0,26,26,0
GBR,ZAF,2010.0,90,93,-3
GBR,POL,2016.0,58,83,-25
BEL,TUR,2016.0,12,6,6
CHN,JPN,2021.0,454,577,-123
TWN,VNM,2019.0,53,24,29
BEL,CHE,2010.0,40,32,8
CAN,DEU,2006.0,88,155,-67
SRB,GRC,2007.0,8,4,4
IRL,SWE,2009.0,12,15,-3
DEU,BEL,2016.0,101,122,-21
ESP,PRT,1999.0,20,25,-5
ESP,DEU,2018.0,275,231,44
ISR,SGP,2007.0,2,1,1
GBR,SGP,2016.0,156,106,50
PRT,IND,2012.0,13,37,-24
FRA,GBR,2021.0,508,480,28
GBR,CZE,2022.0,54,44,10
KOR,GBR,2003.0,25,27,-2
GTM,ESP,2001.0,1,1,0
JPN,CHE,2004.0,30,21,9
GBR,DEU,2023.0,422,334,88
CHE,JPN,2013.0,31,43,-12
CYP,NLD,2018.0,4,1,3
MNE,SRB,2023.0,16,32,-16
GBR,DEU,2000.0,359,437,-78
CZE,SVK,2021.0,74,72,2
IND,TWN,2008.0,52,17,35
SWE,RUS,2014.0,18,15,3
FRA,TUR,1997.0,7,2,5
GBR,MEX,2003.0,36,33,3
RUS,NLD,2008.0,18,12,6
KEN,BWA,2021.0,2,4,-2
CHN,SGP,2018.0,307,430,-123
CHL,USA,2012.0,103,128,-25
IND,KOR,2001.0,24,4,20
CAN,CHE,2003.0,60,58,2
ESP,CUB,2010.0,18,45,-27
GBR,ESP,2005.0,174,178,-4
CAN,HRV,2008.0,2,1,1
NLD,GRC,2018.0,26,24,2
PAK,DEU,2009.0,17,15,2
JOR,EGY,2016.0,4,1,3
BLR,ITA,2014.0,2,1,1
ESP,GBR,2019.0,460,434,26
ESP,CAN,2001.0,28,23,5
SVK,USA,2007.0,18,18,0
NLD,TUR,2015.0,29,16,13
SAU,SDN,2006.0,5,4,1
LBN,FRA,2001.0,19,25,-6
BRA,JPN,2015.0,11,12,-1
JPN,BRA,2018.0,18,14,4
CHL,CUB,2006.0,4,5,-1
ITA,USA,1997.0,365,407,-42
DNK,GBR,2000.0,54,60,-6
ZAF,USA,2019.0,159,112,47
NLD,ECU,2021.0,9,2,7
GMB,USA,2020.0,3,2,1
ZWE,GBR,2003.0,7,10,-3
SWE,TWN,2012.0,1,4,-3
TWN,SWE,2013.0,1,2,-1
ESP,PRI,2014.0,7,3,4
BEL,TWN,2023.0,3,2,1
AUS,NOR,2021.0,25,13,12
NOR,DNK,2019.0,42,61,-19
TUR,GBR,2018.0,94,92,2
MEX,GBR,2020.0,62,55,7
IND,ETH,2020.0,98,34,64
IRL,GBR,2018.0,320,390,-70
ZAF,KEN,2018.0,38,18,20
LTU,DEU,2006.0,8,2,6
DEU,IND,2000.0,48,65,-17
SGP,AUS,2013.0,79,75,4
CHN,PRT,2011.0,13,9,4
ITA,COL,2016.0,12,5,7
ISL,NLD,2006.0,2,4,-2
VNM,GBR,2013.0,26,18,8
JPN,SWE,2016.0,36,27,9
DNK,ZAF,2013.0,7,3,4
PAN,NIC,2013.0,1,1,0
ISR,BEL,2008.0,4,2,2
BEL,CAN,2014.0,41,42,-1
IRN,FRA,2005.0,5,20,-15
AUS,CAN,2012.0,172,197,-25
FRA,SVN,2014.0,5,4,1
AUT,AUS,2019.0,34,49,-15
IRL,AUS,2007.0,32,25,7
KAZ,RUS,2011.0,8,23,-15
PRT,FRA,2015.0,60,33,27
ZAF,PRI,2007.0,1,1,0
BOL,ITA,2017.0,3,1,2
IRN,FRA,2012.0,21,25,-4
CAN,DEU,2000.0,77,113,-36
ESP,NLD,2007.0,32,67,-35
AUS,KOR,2019.0,28,64,-36
CHN,DEU,2019.0,464,489,-25
BRA,ARG,2009.0,33,26,7
CHL,USA,2005.0,68,73,-5
USA,QAT,2016.0,75,36,39
TWN,PHL,2010.0,2,3,-1
DEU,ISL,2012.0,6,1,5
FRA,ROU,2017.0,25,21,4
CZE,RUS,2019.0,14,23,-9
HKG,TWN,2019.0,24,11,13
JPN,CHE,2008.0,50,30,20
BRA,ESP,2000.0,31,38,-7
JPN,NOR,2010.0,6,5,1
JPN,IND,2010.0,98,83,15
GRC,ESP,2012.0,21,9,12
NLD,ESP,2021.0,92,113,-21
SAU,PAK,2004.0,10,6,4
GRC,AUT,2015.0,10,4,6
AUT,BEL,2022.0,21,17,4
CZE,CAN,2013.0,11,10,1
SWE,NOR,2008.0,71,39,32
HRV,ESP,2013.0,5,4,1
ESP,HRV,2017.0,4,3,1
BRA,AUT,2018.0,8,13,-5
AUT,BRA,2019.0,6,16,-10
MYS,CAN,2015.0,22,23,-1
USA,ESP,1999.0,264,295,-31
ARE,EGY,2014.0,12,19,-7
SGP,IDN,2015.0,12,3,9
JPN,IDN,2016.0,189,44,145
USA,SAU,2004.0,56,27,29
OMN,ARE,2016.0,4,3,1
HRV,GBR,2011.0,11,2,9
FRA,NZL,2016.0,17,16,1
TUR,CAN,2012.0,19,20,-1
MAR,CAN,2009.0,9,12,-3
IND,TWN,2015.0,56,58,-2
FIN,GBR,2008.0,46,38,8
AUS,KOR,2011.0,27,22,5
NZL,USA,1999.0,82,107,-25
SRB,HRV,2014.0,15,17,-2
GBR,PAK,2013.0,95,53,42
ESP,CHE,2008.0,61,50,11
MEX,IRN,2008.0,1,5,-4
JPN,POL,2017.0,12,8,4
ITA,MEX,2012.0,12,14,-2
USA,SVK,2002.0,16,30,-14
IND,SRB,2003.0,5,1,4
SRB,IND,2004.0,8,4,4
CHN,DNK,2001.0,12,9,3
AZE,TUR,2006.0,4,7,-3
BRA,FRA,1999.0,54,72,-18
AUS,CAN,1997.0,63,69,-6
SAU,EGY,1997.0,28,23,5
FIN,FRA,1998.0,12,9,3
NZL,CHN,2006.0,7,6,1
DEU,ROU,1997.0,8,17,-9
USA,TUR,2019.0,315,346,-31
GBR,CAN,1998.0,197,186,11
MEX,FRA,2018.0,41,52,-11
FRA,MEX,2019.0,54,57,-3
NOR,CHN,2006.0,6,8,-2
GBR,SGP,2022.0,88,110,-22
LUX,DEU,2020.0,37,37,0
CHN,MNG,2009.0,2,1,1
ITA,NLD,2013.0,111,70,41
FRA,GUF,2008.0,16,13,3
EGY,GBR,2008.0,24,37,-13
NLD,ESP,2009.0,70,67,3
CHE,GBR,1999.0,121,108,13
SRB,USA,2000.0,36,21,15
PRT,GBR,2010.0,66,89,-23
NOR,JPN,2018.0,8,9,-1
JPN,RUS,2003.0,44,48,-4
SWE,FIN,2011.0,42,53,-11
FRA,CHN,2022.0,275,165,110
MYS,SGP,2004.0,6,11,-5
IND,TWN,2014.0,49,63,-14
GBR,NGA,2022.0,66,80,-14
NLD,IDN,2009.0,15,5,10
FRA,KOR,2013.0,20,19,1
GRC,ITA,2017.0,28,35,-7
GRC,FRA,2016.0,40,42,-2
USA,RUS,2002.0,311,543,-232
NLD,DEU,2021.0,364,434,-70
SRB,KWT,2007.0,2,1,1
COL,VEN,2015.0,5,26,-21
CUB,CHL,2015.0,13,2,11
HUN,USA,2021.0,53,48,5
FRA,HUN,2011.0,15,24,-9
SVN,GBR,2008.0,9,8,1
GBR,SVN,2009.0,13,8,5
CAN,PER,2018.0,5,4,1
FRA,REU,2013.0,28,31,-3
TUN,SAU,2011.0,29,7,22
NZL,AUT,2015.0,7,6,1
KOR,SAU,2022.0,23,14,9
RUS,BLR,2001.0,26,25,1
CRI,USA,2013.0,18,18,0
GBR,LBN,2010.0,6,6,0
GBR,TTO,2017.0,9,4,5
OMN,USA,2007.0,8,9,-1
GRC,CAN,2016.0,15,3,12
ZAF,IRL,2005.0,6,1,5
USA,NZL,2007.0,127,89,38
CHN,CHL,2018.0,6,10,-4
IND,AUS,2015.0,128,68,60
USA,ARM,2006.0,7,7,0
ZAF,DEU,2013.0,19,33,-14
BEL,EGY,2014.0,5,5,0
CZE,FRA,2014.0,18,22,-4
USA,SRB,2004.0,40,33,7
EGY,JPN,2000.0,12,11,1
IND,HKG,2011.0,7,3,4
KOR,MYS,2011.0,14,5,9
ITA,SWE,2009.0,31,25,6
KOR,SWE,2018.0,20,14,6
ESP,PRI,2008.0,3,1,2
USA,FIN,2020.0,100,104,-4
USA,SGP,2023.0,114,110,4
MYS,IRQ,2019.0,191,25,166
TUR,TWN,2020.0,7,3,4
GBR,MYS,2015.0,163,70,93
MYS,PAK,2023.0,90,51,39
GBR,RUS,2010.0,46,41,5
SWE,DEU,2023.0,81,111,-30
IND,YEM,2021.0,19,6,13
GBR,EGY,2019.0,62,58,4
CMR,KEN,2019.0,2,6,-4
TUN,FRA,2021.0,120,92,28
POL,USA,2020.0,134,113,21
TUR,DEU,2020.0,115,62,53
HRV,DEU,2021.0,20,11,9
FRA,DEU,2022.0,332,298,34
CHN,NOR,2019.0,37,31,6
BRA,DEU,2016.0,107,118,-11
FRA,SEN,2019.0,49,22,27
GBR,SAU,2014.0,118,35,83
AUS,THA,2020.0,48,27,21
CYP,TUR,2019.0,122,119,3
NLD,CHN,2020.0,204,192,12
SWE,ESP,2022.0,63,75,-12
CHE,FRA,2020.0,255,434,-179
GBR,EGY,2021.0,54,91,-37
MYS,JPN,2018.0,49,83,-34
FIN,DEU,2023.0,32,38,-6
IDN,IND,2018.0,16,23,-7
ESP,PER,2020.0,37,22,15
IRN,ITA,2020.0,98,26,72
USA,LTU,2018.0,10,17,-7
TUN,FRA,2019.0,123,117,6
POL,MYS,2019.0,1,3,-2
ARG,USA,2021.0,151,77,74
ARG,MEX,2019.0,27,24,3
JPN,USA,2011.0,991,1043,-52
CHN,USA,2005.0,958,808,150
USA,CHN,2014.0,2938,2879,59
IRN,USA,2012.0,326,66,260
CHE,DEU,2008.0,351,638,-287
KOR,USA,2007.0,671,846,-175
DNK,DEU,2011.0,85,110,-25
KEN,CAN,2014.0,6,6,0
IND,USA,2014.0,1027,929,98
USA,ESP,2009.0,414,419,-5
POL,GBR,2015.0,68,47,21
USA,TWN,2007.0,353,237,116
CHN,JPN,2007.0,252,418,-166
ESP,ITA,2019.0,219,257,-38
ITA,ESP,2020.0,224,205,19
BEL,DEU,2007.0,54,95,-41
RUS,SWE,2004.0,39,14,25
IND,USA,2004.0,656,338,318
DEU,FRA,2003.0,312,314,-2
IRL,GBR,2014.0,312,214,98
NZL,AUS,2011.0,197,116,81
DEU,JPN,2011.0,131,129,2
NOR,BWA,2008.0,1,1,0
SWE,MYS,2016.0,10,9,1
SWE,MYS,2022.0,4,6,-2
AUT,BEL,2008.0,5,8,-3
FRA,DEU,2004.0,271,243,28
USA,KOR,2017.0,853,848,5
USA,GBR,2005.0,1371,1528,-157
CAN,NOR,2004.0,11,7,4
USA,ITA,2014.0,482,673,-191
USA,CHN,2008.0,1159,1562,-403
CHN,HKG,2001.0,216,254,-38
USA,POL,2019.0,135,120,15
NIC,USA,2009.0,5,4,1
CAN,GBR,2013.0,359,391,-32
NLD,CZE,2006.0,5,2,3
POL,CAN,2009.0,14,16,-2
FRA,GBR,2020.0,527,521,6
CHN,SGP,2008.0,143,131,12
USA,CHN,2004.0,720,909,-189
DEU,AUT,2004.0,234,158,76
GBR,CHN,2010.0,226,208,18
FRA,TUN,2005.0,92,41,51
FRA,CHE,2017.0,421,260,161
CHE,GBR,2009.0,189,205,-16
CAN,AUS,2009.0,195,149,46
CAN,NLD,2015.0,60,75,-15
NLD,FRA,2007.0,105,86,19
AUT,ITA,2005.0,31,21,10
USA,ISR,2011.0,360,363,-3
GBR,IND,2007.0,106,156,-50
DEU,FRA,2013.0,330,356,-26
FRA,DEU,2014.0,429,376,53
USA,CHN,2015.0,3179,3092,87
USA,HRV,2016.0,29,14,15
USA,BRA,2003.0,357,286,71
USA,GBR,2012.0,1598,1839,-241
CAN,DEU,2005.0,108,148,-40
DEU,TWN,2004.0,6,10,-4
DEU,GBR,2000.0,437,359,78
GBR,FIN,2011.0,50,38,12
GBR,USA,2017.0,2069,1879,190
USA,FRA,2003.0,778,861,-83
FRA,USA,2021.0,791,669,122
JPN,IDN,2015.0,157,42,115
AUS,FRA,2021.0,100,71,29
CHN,USA,2002.0,914,548,366
AUS,USA,2018.0,742,670,72
GBR,USA,2018.0,2057,1886,171
USA,TUR,1999.0,117,136,-19
ESP,ITA,2011.0,115,203,-88
NLD,USA,2015.0,428,403,25
COG,BEL,2020.0,7,7,0
AUS,GBR,2008.0,451,610,-159
FRA,AUS,2002.0,75,37,38
BRA,BEL,2012.0,19,19,0
TUN,FRA,2007.0,70,100,-30
FRA,USA,2009.0,814,771,43
ITA,FRA,2007.0,238,195,43
IRL,CAN,2013.0,43,31,12
CHE,FRA,2009.0,221,285,-64
DEU,CHE,1999.0,325,286,39
USA,IND,2018.0,877,1570,-693
IND,USA,2008.0,865,548,317
USA,VIR,2015.0,2,2,0
VIR,USA,2016.0,4,3,1
CHN,HKG,2004.0,272,347,-75
KOR,UKR,2005.0,4,2,2
POL,USA,2011.0,99,142,-43
KOR,USA,1999.0,339,500,-161
USA,IRN,2003.0,34,32,2
GBR,IRL,2016.0,252,319,-67
HKG,CHN,2016.0,840,814,26
CHN,DEU,1999.0,76,84,-8
JPN,USA,2019.0,875,922,-47
USA,GBR,2002.0,1561,1877,-316
USA,IND,2017.0,870,1399,-529
USA,THA,2003.0,188,83,105
KOR,THA,2013.0,7,8,-1
LBN,FRA,2017.0,50,101,-51
ESP,FRA,2012.0,220,194,26
CAN,AUS,2011.0,211,150,61
USA,POL,2011.0,142,99,43
ITA,BEL,2003.0,53,32,21
USA,DEU,2010.0,1194,1289,-95
CHN,JPN,1998.0,141,133,8
AUT,GBR,2006.0,55,36,19
IND,FRA,2008.0,86,27,59
ESP,CHN,2010.0,17,14,3
GBR,GRC,2013.0,143,187,-44
ZAF,CMR,2007.0,3,1,2
SGP,HKG,2021.0,54,34,20
IRL,AUS,2009.0,35,27,8
SGP,CAN,2003.0,24,15,9
IRN,SAU,2014.0,1,1,0
ESP,DEU,2015.0,315,161,154
CHN,DEU,2007.0,155,138,17
IND,ITA,2007.0,29,9,20
DEU,SVK,2012.0,12,16,-4
FRA,ITA,2002.0,234,194,40
DEU,USA,2020.0,1256,1264,-8
ESP,AUT,2013.0,31,15,16
USA,PRI,2007.0,101,98,3
GBR,FRA,2022.0,493,321,172
DEU,ESP,2003.0,119,109,10
RUS,TUR,2008.0,5,3,2
KOR,SGP,2008.0,14,14,0
AUS,CHN,2013.0,199,278,-79
GBR,ITA,2001.0,267,282,-15
FRA,EGY,2007.0,15,6,9
FRA,EGY,2020.0,26,14,12
USA,PRI,2020.0,209,170,39
CAN,GHA,2017.0,4,14,-10
FRA,BRA,2013.0,116,85,31
BRA,FIN,2020.0,27,2,25
DEU,RUS,2011.0,109,131,-22
FRA,USA,2011.0,940,766,174
SAU,EGY,2006.0,63,72,-9
EGY,JPN,2005.0,21,39,-18
AUS,USA,2017.0,731,653,78
IRN,CAN,2003.0,37,50,-13
USA,FIN,2019.0,103,103,0
ESP,USA,2016.0,641,366,275
CHE,DEU,2015.0,508,663,-155
CHN,SGP,2014.0,209,282,-73
USA,ESP,2021.0,444,483,-39
GBR,BRA,2004.0,82,52,30
FRA,DEU,2015.0,414,382,32
BRA,USA,2016.0,601,532,69
CHN,NZL,2009.0,11,6,5
USA,CHL,2011.0,108,121,-13
GBR,DEU,2005.0,411,477,-66
DNK,USA,2011.0,112,135,-23
MYS,AUS,2017.0,141,112,29
DEU,IRL,2012.0,28,50,-22
GBR,ESP,2010.0,318,266,52
FRA,CHN,2008.0,79,67,12
FIN,GBR,2017.0,72,54,18
NZL,AUS,2009.0,168,100,68
USA,EST,2007.0,5,5,0
AUT,DEU,2002.0,196,229,-33
ITA,USA,2006.0,465,423,42
ESP,USA,2017.0,627,463,164
ESP,USA,2022.0,413,396,17
ISR,USA,2011.0,363,360,3
GBR,IDN,2016.0,29,15,14
USA,NZL,2011.0,133,114,19
FRA,DEU,2008.0,345,354,-9
ESP,DEU,2014.0,290,158,132
USA,FRA,2013.0,802,942,-140
DEU,AUT,2008.0,256,203,53
DEU,BEL,2008.0,89,62,27
CHN,AUT,2000.0,6,4,2
AUT,CHN,2006.0,6,6,0
CAN,TWN,2008.0,18,15,3
FRA,BRA,2003.0,89,70,19
PRI,USA,2007.0,98,101,-3
ROU,GBR,2003.0,11,9,2
THA,USA,2003.0,83,188,-105
DEU,GBR,2006.0,553,332,221
IRL,GBR,2008.0,187,227,-40
BRA,LBY,2012.0,1,1,0
PAN,USA,2023.0,22,9,13
FRA,SWE,2020.0,110,69,41
JPN,BEL,2009.0,18,14,4
GBR,ESP,2006.0,199,171,28
DEU,CHL,2009.0,27,38,-11
DNK,NOR,2020.0,72,36,36
NLD,USA,2001.0,331,299,32
GBR,FRA,2016.0,404,573,-169
IRL,USA,2004.0,86,97,-11
FRA,GBR,2007.0,399,367,32
GBR,DEU,2012.0,638,613,25
BEL,CAN,2017.0,65,39,26
SVN,ESP,2010.0,5,1,4
DEU,GBR,2010.0,595,624,-29
GBR,CHN,2006.0,151,122,29
RUS,USA,2013.0,178,197,-19
ISR,SGP,2011.0,5,2,3
AUT,DEU,2012.0,286,327,-41
IRL,TUR,2011.0,6,4,2
TUR,FRA,2011.0,18,25,-7
CAN,KOR,2006.0,39,36,3
DEU,BEL,2015.0,130,108,22
BEL,DEU,2020.0,132,135,-3
USA,THA,2013.0,234,124,110
USA,KOR,2016.0,1005,764,241
RUS,IRL,2004.0,6,1,5
IRL,USA,2008.0,105,120,-15
GBR,IND,1998.0,58,63,-5
MYS,IDN,2011.0,21,16,5
DEU,CHN,2008.0,152,162,-10
CAN,DEU,2012.0,181,171,10
IND,DNK,2020.0,26,17,9
DEU,SWE,2010.0,110,128,-18
CHE,KOR,2010.0,14,4,10
JPN,USA,2009.0,1134,1129,5
FRA,GBR,1998.0,251,230,21
GBR,NZL,2006.0,149,95,54
JPN,KEN,2012.0,10,6,4
USA,IND,2016.0,821,1162,-341
ITA,POL,2007.0,11,15,-4
ARG,USA,2007.0,146,116,30
JPN,ARG,2011.0,2,2,0
SWE,CHN,2011.0,66,86,-20
SWE,AUT,2013.0,13,18,-5
AUT,GBR,2010.0,70,60,10
IND,USA,2015.0,1069,910,159
ROU,FRA,2000.0,29,21,8
FRA,ROU,2001.0,22,24,-2
ROU,ESP,2017.0,11,9,2
HKG,CHN,2018.0,1018,793,225
ITA,RUS,2009.0,21,22,-1
USA,ARE,2009.0,42,10,32
AUS,GBR,2004.0,368,445,-77
GBR,SWE,2007.0,117,124,-7
ESP,NLD,2011.0,65,77,-12
MEX,GBR,2021.0,55,53,2
ZAF,SWE,2001.0,10,2,8
DEU,ISR,2010.0,29,33,-4
SGP,TWN,2011.0,14,17,-3
NER,NGA,2020.0,7,1,6
HRV,CHE,2004.0,6,1,5
CHE,HRV,2006.0,5,4,1
JPN,TWN,2010.0,51,28,23
DEU,USA,2007.0,1284,1019,265
CHN,HKG,2014.0,616,722,-106
FRA,MEX,1998.0,35,26,9
DEU,TUR,2011.0,34,48,-14
USA,ARE,2019.0,108,83,25
USA,EGY,2012.0,131,70,61
ZAF,GBR,2010.0,93,90,3
USA,AUS,2007.0,566,509,57
GBR,IRL,2018.0,390,320,70
AUS,GBR,2015.0,518,670,-152
DEU,HUN,2009.0,25,47,-22
USA,SWE,2012.0,233,239,-6
VEN,FRA,2003.0,6,10,-4
IND,ISR,2002.0,16,15,1
USA,TWN,1998.0,286,121,165
DEU,AUS,2013.0,179,122,57
IND,USA,2001.0,559,305,254
DNK,GBR,2002.0,59,74,-15
ISR,BEL,2017.0,4,9,-5
BEL,ISR,2019.0,7,4,3
CHE,FRA,2019.0,264,395,-131
GBR,DEU,1997.0,257,247,10
ITA,FRA,2020.0,361,297,64
SWE,CHN,2019.0,134,116,18
GBR,BRA,2001.0,84,51,33
DEU,CHN,2014.0,269,346,-77
HKG,CHN,2017.0,822,809,13
CAN,GBR,2003.0,253,350,-97
USA,GEO,2021.0,212,223,-11
FIN,JPN,2006.0,8,8,0
KOR,ITA,2008.0,5,1,4
CHE,ITA,2005.0,95,88,7
HRV,GBR,2007.0,4,5,-1
USA,IRL,2013.0,130,154,-24
BRA,DEU,2008.0,63,57,6
ESP,GBR,2007.0,191,223,-32
TUR,KOR,2012.0,2,1,1
USA,ROU,2009.0,33,28,5
BRA,URY,2021.0,21,3,18
GBR,ITA,2004.0,205,223,-18
IDN,AUS,2017.0,28,96,-68
BEL,USA,2009.0,154,118,36
CAN,IRN,2003.0,50,37,13
MYS,JPN,2014.0,33,110,-77
USA,PRT,2017.0,64,93,-29
RUS,VNM,2021.0,28,12,16
GRC,USA,2003.0,86,149,-63
LBN,IRQ,2023.0,3,1,2
USA,ISR,2009.0,329,407,-78
FRA,SWE,2007.0,54,58,-4
SWE,ESP,2008.0,42,37,5
ISR,CAN,2003.0,56,31,25
IND,TTO,2010.0,3,3,0
GBR,THA,2004.0,63,22,41
USA,JPN,2010.0,1111,1094,17
DNK,CHE,2016.0,41,41,0
DNK,CHE,2018.0,36,42,-6
DNK,USA,2009.0,93,135,-42
MEX,BRA,2019.0,36,34,2
SRB,CAN,2004.0,8,6,2
GBR,CHE,2010.0,245,197,48
GBR,SWE,1998.0,66,68,-2
SWE,USA,2017.0,278,271,7
USA,GEO,2019.0,265,200,65
ZAF,KEN,2004.0,9,4,5
DEU,NOR,2006.0,46,14,32
DEU,JPN,2019.0,151,135,16
EGY,UKR,1998.0,1,1,0
CHN,TWN,2002.0,118,128,-10
DEU,USA,1998.0,1134,976,158
ISR,CHE,2008.0,14,4,10
DEU,NLD,2010.0,237,231,6
ITA,ROU,2021.0,10,14,-4
DEU,CHN,2004.0,129,112,17
ITA,DEU,1999.0,134,130,4
GBR,BGR,2004.0,11,17,-6
FRA,CHE,2016.0,424,263,161
RUS,USA,2003.0,432,337,95
TWN,USA,2003.0,216,321,-105
DEU,AUT,2014.0,362,323,39
PAK,SAU,2000.0,10,7,3
PRT,BRA,2014.0,125,111,14
JPN,IND,2012.0,81,76,5
CAN,ISR,2013.0,44,45,-1
GBR,LBY,2007.0,7,4,3
USA,AUS,1998.0,389,407,-18
GBR,ITA,2015.0,360,595,-235
GBR,BRA,2015.0,97,108,-11
MEX,ESP,2006.0,72,79,-7
CMR,DEU,2008.0,6,5,1
DNK,FRO,2012.0,3,1,2
GBR,ITA,2014.0,333,525,-192
BGD,CAN,2012.0,26,12,14
AUS,IRN,2007.0,33,25,8
USA,GHA,2004.0,14,6,8
USA,SGP,2005.0,125,102,23
ESP,VEN,2006.0,20,25,-5
CHE,CAN,2011.0,81,96,-15
IRL,GBR,2004.0,159,195,-36
IRL,AUS,2019.0,45,45,0
DEU,CHN,2015.0,335,340,-5
FRA,JPN,2011.0,89,84,5
TWN,CHN,2015.0,214,138,76
SWE,RUS,2022.0,14,24,-10
MEX,ESP,2010.0,133,105,28
CHE,CAN,2009.0,95,99,-4
USA,NZL,2009.0,127,125,2
IND,BGD,2018.0,14,17,-3
BRA,ESP,2005.0,28,29,-1
KOR,SWE,2001.0,3,6,-3
USA,CHL,2009.0,104,98,6
CHL,USA,2010.0,89,110,-21
ESP,USA,2018.0,577,466,111
ESP,COL,2007.0,36,22,14
ITA,TUR,2019.0,18,24,-6
GBR,ARE,2020.0,71,36,35
JOR,USA,2004.0,13,29,-16
USA,SAU,2022.0,272,129,143
CAN,ITA,2011.0,39,59,-20
ESP,FRA,2005.0,142,120,22
CHE,RUS,2006.0,14,28,-14
SGP,SWE,2008.0,4,7,-3
FRA,NLD,2016.0,98,124,-26
CAN,FRA,2009.0,225,298,-73
UKR,RUS,2021.0,90,73,17
USA,CHN,2001.0,457,784,-327
ESP,CAN,2018.0,91,69,22
ITA,CHE,2013.0,230,131,99
CHL,COL,2009.0,10,8,2
GBR,ROU,2017.0,16,24,-8
IND,RUS,2000.0,1,7,-6
KOR,USA,1998.0,283,471,-188
IND,SGP,2010.0,54,32,22
AUS,DEU,2013.0,122,179,-57
BLR,DEU,2001.0,18,16,2
USA,NLD,2013.0,341,395,-54
NLD,USA,2014.0,424,389,35
JPN,HUN,2009.0,7,3,4
IDN,USA,2002.0,24,14,10
USA,SWE,1997.0,149,174,-25
IND,CAN,2002.0,53,30,23
BEL,DNK,2016.0,15,22,-7
CHN,SGP,2001.0,80,27,53
DNK,USA,2021.0,133,176,-43
NOR,SWE,2001.0,43,58,-15
USA,SVN,2012.0,22,15,7
GBR,CHE,2000.0,93,128,-35
GBR,POL,2004.0,25,24,1
CHE,TUR,2006.0,9,6,3
SGP,TWN,2019.0,19,21,-2
USA,JPN,2000.0,1150,1419,-269
ZAF,SAU,2012.0,25,20,5
SAU,GBR,2019.0,72,224,-152
ITA,BEL,2013.0,91,63,28
USA,GEO,2011.0,39,45,-6
GBR,CZE,2004.0,30,22,8
MEX,USA,2007.0,223,241,-18
SYR,USA,2007.0,3,3,0
JPN,IDN,2008.0,63,17,46
KEN,CHE,2019.0,6,4,2
IND,DEU,2011.0,148,128,20
VEN,ECU,2023.0,6,4,2
USA,ESP,2019.0,481,517,-36
IND,CAN,2005.0,57,30,27
NZL,GBR,2007.0,106,149,-43
USA,JPN,2023.0,388,401,-13
AUS,MYS,2015.0,119,107,12
DEU,POL,2017.0,81,85,-4
GBR,LUX,2015.0,12,7,5
HKG,CHN,2022.0,1400,1325,75
ITA,USA,2010.0,583,429,154
IND,ARE,2017.0,81,18,63
RUS,SVK,2016.0,4,1,3
POL,JPN,2009.0,11,16,-5
UKR,RUS,2011.0,38,51,-13
DEU,DNK,2012.0,118,71,47
KEN,DEU,2014.0,10,10,0
COL,USA,2009.0,73,81,-8
ISR,USA,2009.0,407,329,78
AUS,CAN,2006.0,113,128,-15
DEU,GEO,2014.0,5,5,0
AUS,MYS,2008.0,29,29,0
COL,GBR,2016.0,14,19,-5
FRA,NLD,2017.0,114,104,10
CHN,CHE,2015.0,60,38,22
USA,FIN,2021.0,80,91,-11
FIN,KOR,2022.0,7,8,-1
RUS,COL,2006.0,3,1,2
CAN,NLD,2014.0,72,74,-2
KOR,CHN,2010.0,136,107,29
DNK,SWE,2007.0,57,70,-13
DEU,GRC,2011.0,44,59,-15
TWN,CHN,2004.0,55,85,-30
EGY,SAU,2008.0,95,72,23
PAK,SAU,2010.0,25,13,12
MEX,USA,2020.0,398,317,81
GRC,GBR,2013.0,187,143,44
JPN,AUT,2009.0,7,11,-4
PER,USA,2013.0,23,40,-17
IRN,DEU,2011.0,48,27,21
IRN,SWE,2008.0,8,11,-3
FRA,TUN,1997.0,29,20,9
DEU,ARG,2001.0,14,24,-10
IND,NOR,2013.0,8,5,3
AUT,HUN,2021.0,13,54,-41
BRA,FRA,2011.0,109,99,10
IND,TWN,2016.0,81,36,45
ARM,DEU,2015.0,8,1,7
AUT,BGR,2020.0,1,3,-2
CAN,FRA,2021.0,315,347,-32
BGR,CAN,2019.0,1,3,-2
DEU,COL,2009.0,10,8,2
USA,FIN,2009.0,83,72,11
JPN,KOR,2010.0,132,112,20
DEU,PRT,2007.0,23,21,2
SGP,GBR,2006.0,56,63,-7
GBR,SGP,2008.0,72,61,11
GBR,JPN,1998.0,128,115,13
FIN,CAN,2002.0,26,18,8
SRB,CAN,2008.0,1,5,-4
SGP,CHN,2006.0,112,84,28
CHE,DEU,2004.0,299,467,-168
SGP,IDN,2018.0,7,5,2
BEL,UKR,2015.0,2,1,1
ITA,GBR,2013.0,449,285,164
DEU,ITA,2007.0,144,187,-43
USA,PRT,2016.0,72,80,-8
CZE,USA,2001.0,52,36,16
ZAF,AUS,2006.0,27,12,15
USA,DNK,2008.0,94,102,-8
DNK,BEL,2015.0,14,19,-5
USA,ITA,2015.0,408,622,-214
IND,ETH,2011.0,24,6,18
CHE,POL,2013.0,11,25,-14
AUS,DEU,2003.0,100,84,16
NLD,ITA,2005.0,50,56,-6
CHE,HKG,2018.0,7,11,-4
RUS,ISR,2000.0,25,9,16
GBR,PHL,2008.0,3,1,2
ARG,SWE,2007.0,3,3,0
FRA,ESP,2011.0,218,214,4
CHN,CAN,2007.0,147,160,-13
DEU,POL,2022.0,86,81,5
CHE,DEU,2014.0,540,717,-177
GHA,GBR,2005.0,4,7,-3
POL,CHE,2015.0,24,16,8
CHE,FRA,2011.0,244,291,-47
LAO,USA,2011.0,1,1,0
USA,NOR,2003.0,89,76,13
USA,ITA,2008.0,418,558,-140
GBR,SAU,2017.0,166,62,104
FIN,DNK,2003.0,11,14,-3
DNK,NLD,2004.0,18,15,3
GBR,ISR,1997.0,25,27,-2
ESP,NLD,2009.0,67,70,-3
GBR,ZAF,2005.0,78,55,23
KEN,BEL,2003.0,6,3,3
NLD,CHN,2021.0,216,195,21
USA,SAU,2016.0,158,127,31
ISR,DEU,2018.0,61,61,0
JPN,TWN,2000.0,23,13,10
AUS,ZAF,2010.0,16,36,-20
TWN,CHN,2001.0,112,76,36
USA,AUS,2020.0,623,725,-102
DEU,SDN,2003.0,3,1,2
AUT,CHE,2009.0,60,43,17
DNK,DEU,2009.0,60,103,-43
DEU,USA,1999.0,1310,993,317
USA,FIN,2011.0,63,82,-19
CHE,BEL,2008.0,24,25,-1
MEX,CHE,2009.0,4,9,-5
ITA,DNK,2004.0,10,13,-3
AUS,CAN,2010.0,140,198,-58
GBR,BEL,1999.0,56,73,-17
BEL,USA,2011.0,134,148,-14
AUS,USA,2016.0,689,690,-1
IND,KOR,2018.0,222,147,75
SGP,GBR,2010.0,47,95,-48
ISR,CHN,2005.0,9,3,6
IND,JPN,2014.0,91,124,-33
NLD,BRA,2012.0,23,21,2
FRA,HKG,2010.0,7,7,0
JPN,ARE,2008.0,5,2,3
CHN,DNK,2016.0,66,54,12
CHN,DNK,2018.0,67,65,2
DEU,SAU,2009.0,14,2,12
ESP,IND,2003.0,10,4,6
USA,DNK,2004.0,99,103,-4
CAN,ARG,2007.0,16,9,7
NZL,USA,2019.0,131,145,-14
PYF,FRA,2007.0,9,7,2
CAN,AUT,2019.0,23,23,0
DEU,NZL,2009.0,41,36,5
USA,TWN,1999.0,259,165,94
GBR,EGY,2020.0,73,66,7
MEX,FRA,2008.0,42,67,-25
ITA,IRL,2008.0,29,14,15
USA,SAU,2017.0,223,150,73
PRT,GBR,2012.0,70,67,3
USA,BRA,2013.0,401,473,-72
BRA,ITA,2014.0,43,56,-13
CAN,KOR,2010.0,60,52,8
FRA,PYF,2020.0,16,16,0
USA,RUS,2006.0,218,252,-34
USA,ARG,2007.0,116,146,-30
CHE,GRC,2007.0,5,15,-10
GRC,CHE,2012.0,29,22,7
ZAF,NZL,2001.0,12,8,4
CHN,TWN,1997.0,44,46,-2
USA,MLI,2019.0,16,1,15
CHE,TWN,2018.0,11,8,3
TUR,AZE,2005.0,4,5,-1
CAN,CHN,2013.0,304,259,45
CHN,USA,1997.0,276,328,-52
CHL,USA,2006.0,78,81,-3
CHL,GBR,2008.0,16,10,6
USA,NZL,2021.0,125,121,4
ARG,NLD,2013.0,6,9,-3
IRL,FRA,2014.0,39,27,12
AUS,ARE,2015.0,15,5,10
ESP,CUB,2002.0,28,22,6
ITA,DNK,2008.0,21,17,4
BEL,USA,2019.0,217,174,43
AUS,SGP,2005.0,42,48,-6
GBR,IND,1999.0,63,73,-10
NZL,AUS,2019.0,160,150,10
ITA,DNK,2015.0,56,17,39
SDN,SAU,2013.0,26,5,21
NLD,DEU,2007.0,176,222,-46
NGA,CAN,2005.0,5,3,2
BWA,CAN,2010.0,1,1,0
FRA,IRL,2006.0,32,19,13
ARG,CAN,2008.0,11,9,2
RUS,CHE,2001.0,22,13,9
ITA,DEU,2007.0,187,144,43
CAN,THA,2008.0,19,12,7
GBR,DNK,2003.0,75,64,11
HUN,NOR,2011.0,2,1,1
ITA,SGP,2016.0,13,8,5
ZAF,KEN,2008.0,8,3,5
AUT,ITA,2002.0,23,23,0
DEU,SWE,2000.0,87,59,28
JPN,ESP,2007.0,21,10,11
GBR,UGA,2020.0,24,13,11
FRA,HUN,1998.0,13,18,-5
NZL,USA,2011.0,114,133,-19
MYS,FJI,2012.0,1,1,0
PHL,USA,2012.0,23,42,-19
USA,MEX,2017.0,270,310,-40
CUB,PRT,2001.0,2,1,1
SGP,USA,2003.0,137,118,19
TUR,DEU,2009.0,34,41,-7
UKR,SWE,2012.0,9,3,6
GRC,SWE,2017.0,37,9,28
FRA,AUS,2012.0,116,88,28
ESP,GRC,2011.0,12,14,-2
ISR,PSE,2014.0,21,7,14
TWN,CHN,2014.0,150,147,3
RUS,BRA,2013.0,11,8,3
AUS,TWN,2008.0,12,11,1
IND,CHE,2016.0,36,24,12
SVK,USA,2009.0,11,23,-12
CHN,MAC,2023.0,282,343,-61
GBR,MYS,2022.0,75,84,-9
CHL,ESP,2005.0,22,28,-6
BEL,POL,2015.0,14,14,0
DEU,AUT,2015.0,366,304,62
USA,MNP,2008.0,2,1,1
EGY,USA,2015.0,121,136,-15
BGD,GBR,2010.0,8,15,-7
CZE,GBR,2007.0,61,39,22
ARG,ESP,2014.0,90,104,-14
DEU,PAK,2015.0,37,17,20
JPN,FRA,2002.0,67,82,-15
NLD,DEU,2020.0,388,365,23
CHN,SWE,2018.0,114,123,-9
CHN,FIN,2013.0,25,20,5
FRA,MAR,2006.0,78,35,43
USA,ISL,2018.0,22,11,11
NLD,ESP,2007.0,67,32,35
MEX,FRA,2004.0,29,45,-16
TUR,USA,2003.0,172,247,-75
BEL,USA,2021.0,186,176,10
BRA,DEU,2014.0,108,85,23
USA,QAT,2015.0,84,30,54
ITA,COL,2014.0,11,9,2
DEU,MAR,2018.0,6,4,2
NLD,TWN,2014.0,4,5,-1
BEL,ITA,2014.0,73,118,-45
DEU,HRV,2004.0,7,14,-7
GBR,THA,2008.0,64,22,42
IND,BEL,2017.0,37,19,18
FRA,POL,2010.0,32,47,-15
USA,OMN,2003.0,8,8,0
FRA,TUN,2012.0,127,87,40
CAN,FRA,2011.0,286,337,-51
ESP,DEU,2008.0,142,157,-15
GBR,SYR,1998.0,2,1,1
TWN,FRA,2016.0,11,12,-1
NOR,FRA,2009.0,17,27,-10
CHE,GBR,2019.0,295,333,-38
JPN,DEU,2013.0,145,135,10
AUS,VNM,2005.0,12,2,10
FRA,CMR,2018.0,28,14,14
FRA,CHN,2014.0,181,154,27
COL,KEN,2019.0,2,1,1
ESP,ITA,2009.0,113,185,-72
CHN,AUS,1999.0,38,27,11
USA,HKG,2011.0,117,96,21
NOR,ARG,2022.0,1,3,-2
LUX,FIN,2011.0,1,1,0
UGA,USA,2000.0,7,3,4
ITA,IND,2012.0,33,47,-14
POL,AUS,2009.0,8,6,2
DEU,IND,2012.0,112,133,-21
SVK,USA,2011.0,14,9,5
BRA,PRT,2005.0,42,47,-5
SWE,NOR,2017.0,82,70,12
BRA,ESP,2012.0,78,103,-25
JPN,USA,2021.0,695,826,-131
USA,PHL,2022.0,38,39,-1
KOR,IND,2012.0,110,189,-79
RUS,NOR,2009.0,17,13,4
ARG,DEU,2018.0,39,31,8
USA,BFA,2012.0,3,4,-1
FRA,ESP,2009.0,189,170,19
THA,USA,2013.0,124,234,-110
USA,MEX,2018.0,352,277,75
MEX,CHE,2019.0,6,5,1
USA,DEU,2000.0,1095,1375,-280
GRC,FRA,2015.0,49,35,14
CHN,MAC,2000.0,1,2,-1
ESP,CHN,2006.0,4,6,-2
GBR,FRA,2018.0,494,597,-103
FRA,USA,2019.0,960,750,210
DEU,ISR,2006.0,32,29,3
CHE,SWE,2013.0,73,46,27
AUT,POL,2016.0,4,11,-7
GBR,CAN,2019.0,526,422,104
JPN,CAN,2010.0,95,93,2
IND,JPN,2008.0,84,68,16
USA,ISR,2021.0,384,433,-49
DEU,MEX,2009.0,27,37,-10
JPN,SWE,2004.0,25,21,4
MEX,CAN,2011.0,35,29,6
PRT,FRA,2016.0,57,41,16
GBR,CMR,2010.0,3,3,0
NOR,SWE,2015.0,59,75,-16
CHE,PSE,2011.0,1,1,0
DEU,HRV,2008.0,16,7,9
NLD,GBR,2006.0,212,139,73
SWE,USA,2022.0,192,219,-27
DEU,DNK,2005.0,50,43,7
HUN,USA,2007.0,80,81,-1
NLD,HKG,2006.0,3,5,-2
USA,TWN,2020.0,237,269,-32
ARE,CAN,2023.0,19,17,2
BRA,URY,2011.0,7,5,2
DEU,CHE,2020.0,745,545,200
IRL,GBR,2015.0,277,239,38
FRA,CAN,2013.0,390,262,128
ESP,FRA,2002.0,147,156,-9
GRC,CYP,2021.0,54,43,11
CHN,MAC,2006.0,14,7,7
SAU,PAK,2017.0,65,96,-31
CHE,LTU,2007.0,2,1,1
FIN,AUT,2013.0,8,9,-1
FRA,URY,2014.0,4,2,2
DNK,AUT,2012.0,11,7,4
USA,ISR,2019.0,413,385,28
AUT,DEU,1997.0,103,93,10
PAK,CHN,2016.0,203,150,53
ZAF,USA,2020.0,141,103,38
SWE,DNK,2007.0,70,57,13
FIN,USA,2013.0,98,73,25
GBR,BRA,2014.0,94,100,-6
NZL,DEU,2013.0,25,24,1
CAN,JPN,2016.0,86,84,2
POL,NLD,2012.0,15,21,-6
SAU,BHR,2006.0,1,1,0
AUS,SWE,2009.0,31,41,-10
AUS,IND,2002.0,20,31,-11
FRA,DEU,2001.0,297,313,-16
TUR,DEU,2021.0,129,42,87
IND,SWE,2020.0,82,46,36
NOR,IND,2019.0,14,19,-5
ETH,FRA,2004.0,2,2,0
CAN,AUS,2019.0,192,206,-14
USA,DNK,2014.0,150,141,9
MYS,SWE,2016.0,9,10,-1
GBR,BRA,2008.0,57,56,1
HKG,AUS,2007.0,34,27,7
JPN,KOR,2006.0,153,115,38
CAN,JPN,2022.0,73,65,8
NLD,SWE,2009.0,35,36,-1
ITA,USA,2023.0,295,271,24
SGP,MYS,2000.0,7,7,0
FIN,FRA,2009.0,13,11,2
DEU,IND,2002.0,66,98,-32
USA,ITA,2001.0,494,596,-102
JAM,USA,2008.0,12,8,4
CHE,GBR,2011.0,208,249,-41
USA,SGP,2002.0,109,133,-24
AUT,CAN,2008.0,14,8,6
LBY,CAN,2008.0,2,2,0
CAN,FIN,2021.0,28,17,11
RUS,FRA,2016.0,47,41,6
ITA,FRA,1998.0,160,151,9
ESP,BEL,2002.0,37,22,15
NZL,FRA,2011.0,17,17,0
JPN,AUT,2021.0,15,15,0
UKR,SWE,2005.0,7,3,4
RUS,BRA,2003.0,9,9,0
FRA,DNK,2013.0,42,31,11
AUT,SWE,2009.0,12,15,-3
ARG,ESP,2008.0,83,75,8
IRL,MEX,2014.0,4,1,3
IND,ZAF,2014.0,66,20,46
ARG,GBR,2012.0,20,20,0
TUR,IND,2019.0,8,11,-3
TZA,KEN,2010.0,5,6,-1
JPN,FRA,1997.0,34,44,-10
SWE,AUS,2012.0,30,40,-10
DEU,FIN,2017.0,60,73,-13
JOR,USA,2008.0,22,61,-39
GBR,GRC,2003.0,154,76,78
BEL,NOR,2015.0,4,6,-2
TTO,USA,2006.0,7,5,2
FRA,CHL,2009.0,22,34,-12
DEU,ETH,2007.0,7,7,0
FRA,JPN,2009.0,97,97,0
SGP,CHE,2007.0,4,9,-5
GBR,SWE,2020.0,219,154,65
RUS,IND,2010.0,5,1,4
MEX,COL,2016.0,54,29,25
CHE,BEL,2015.0,42,51,-9
CHE,DEU,2001.0,373,418,-45
SGP,USA,2013.0,207,285,-78
ITA,IRL,2015.0,32,25,7
USA,ITA,2004.0,442,476,-34
CAN,JOR,2008.0,9,5,4
GBR,SGP,2015.0,158,98,60
CHE,IRN,2007.0,8,6,2
SWE,PRT,2022.0,16,15,1
IRN,CAN,2013.0,249,61,188
GBR,SAU,2016.0,124,65,59
GRC,GBR,2003.0,76,154,-78
AUT,CAN,2004.0,23,9,14
CAN,USA,2023.0,1060,814,246
URY,USA,2009.0,19,15,4
PRT,BEL,2009.0,6,5,1
ARE,USA,2008.0,14,54,-40
USA,ARG,2020.0,92,135,-43
FRA,MEX,2020.0,30,50,-20
ROU,CHE,2008.0,4,5,-1
CHE,ROU,2010.0,8,5,3
DEU,THA,2006.0,15,7,8
GBR,JPN,2020.0,150,131,19
USA,KEN,2013.0,60,45,15
USA,PHL,2016.0,46,34,12
NLD,USA,2004.0,282,283,-1
SWE,THA,2014.0,5,5,0
CAN,BRA,2012.0,69,77,-8
CUB,ESP,2008.0,28,28,0
ESP,CUB,2012.0,27,49,-22
CUB,ESP,2014.0,31,29,2
CAN,IRL,2012.0,33,34,-1
GRC,TUR,2007.0,3,3,0
AUS,JPN,2009.0,57,63,-6
CHN,TUR,2021.0,11,16,-5
CAN,BGD,2013.0,15,21,-6
RUS,DEU,2005.0,153,133,20
USA,UKR,2016.0,15,28,-13
USA,AUT,2020.0,157,131,26
CHL,CAN,2010.0,14,13,1
BEL,SWE,2010.0,17,25,-8
NLD,AUT,2012.0,30,19,11
GBR,IRL,2017.0,294,260,34
GBR,IRL,2022.0,392,378,14
DEU,BGR,2004.0,19,20,-1
IRN,AUS,2015.0,149,36,113
MYS,DEU,2021.0,18,8,10
BEL,DNK,2018.0,16,9,7
ITA,HRV,2011.0,6,2,4
USA,ARE,2011.0,62,23,39
ARE,USA,2015.0,51,91,-40
IND,FRA,2004.0,40,26,14
IRL,AUT,2018.0,3,3,0
CHN,CAN,1999.0,68,44,24
FRA,HUN,2007.0,12,15,-3
CHN,FRA,2009.0,110,70,40
IND,TUR,2012.0,6,4,2
DNK,DEU,2021.0,125,143,-18
USA,POL,2021.0,99,130,-31
BRA,DEU,2004.0,41,43,-2
KEN,NLD,2002.0,4,3,1
SLV,USA,2017.0,2,1,1
SAU,PAK,2022.0,90,64,26
SGP,ISR,2007.0,1,2,-1
EGY,SAU,2015.0,277,235,42
ESP,GBR,2020.0,389,500,-111
RUS,UKR,2003.0,57,60,-3
MNG,USA,2007.0,2,2,0
ZAF,FRA,2016.0,23,20,3
POL,UKR,2008.0,13,15,-2
DEU,RUS,2021.0,96,156,-60
KOR,JPN,2011.0,99,151,-52
AUS,FRA,2011.0,90,100,-10
NLD,GBR,2023.0,161,210,-49
RUS,BLR,2016.0,18,26,-8
FRA,CHE,2022.0,333,227,106
FRA,LTU,2014.0,5,4,1
USA,KEN,2003.0,38,20,18
IND,AUS,2018.0,131,74,57
NGA,CAN,2012.0,7,6,1
MEX,FRA,2014.0,39,40,-1
ISR,GBR,2005.0,43,37,6
GBR,FRA,2017.0,445,538,-93
IRL,DEU,2012.0,50,28,22
AUS,HKG,2006.0,29,36,-7
ROU,USA,2005.0,27,20,7
ITA,USA,2000.0,513,453,60
BEL,GBR,2013.0,91,139,-48
FRA,DZA,2015.0,143,51,92
SVK,DEU,2009.0,21,15,6
CAN,FIN,2011.0,15,9,6
CHN,FRA,2011.0,143,128,15
CHN,HKG,2015.0,620,782,-162
JPN,BRA,2001.0,23,17,6
RUS,GBR,2021.0,68,63,5
ZAF,TZA,2010.0,5,4,1
BLR,UKR,2008.0,8,1,7
AUT,USA,2001.0,146,118,28
SWE,USA,2016.0,251,282,-31
NLD,ESP,2020.0,82,111,-29
AUS,ESP,2021.0,54,48,6
CAN,FIN,2009.0,13,19,-6
SWE,NOR,2022.0,75,60,15
USA,NZL,2019.0,145,131,14
SWE,CHN,2009.0,53,53,0
CHE,FRA,2021.0,262,374,-112
NPL,IND,2008.0,24,21,3
DEU,SVN,2007.0,10,4,6
IND,ISR,2005.0,15,10,5
FRA,CHN,2015.0,189,159,30
RUS,FRA,2022.0,82,25,57
GBR,QAT,2020.0,51,17,34
NLD,ETH,2011.0,4,4,0
GBR,DNK,2013.0,85,72,13
YEM,IRQ,2006.0,2,1,1
CHN,ITA,2017.0,59,50,9
ITA,PRT,2018.0,39,42,-3
MNG,JPN,2009.0,4,4,0
NER,BFA,2016.0,1,1,0
CHE,CAN,2019.0,100,118,-18
NER,NGA,2007.0,5,6,-1
MAR,MAC,2010.0,7,2,5
CAN,SAU,2012.0,98,29,69
USA,PRI,1999.0,50,46,4
DEU,JPN,2009.0,107,143,-36
USA,QAT,2014.0,75,21,54
AUS,ZAF,2000.0,17,22,-5
EST,GBR,2018.0,9,14,-5
CAN,NLD,2004.0,29,35,-6
NLD,BEL,2004.0,74,90,-16
IND,TWN,2018.0,77,51,26
CZE,CHE,2006.0,11,4,7
CHE,CZE,2007.0,8,7,1
FRA,ARG,2011.0,24,29,-5
EGY,USA,2014.0,91,109,-18
GRC,CAN,2001.0,11,14,-3
CAN,DEU,2002.0,143,166,-23
CAN,SAU,2002.0,24,18,6
RUS,ARM,2005.0,4,6,-2
ROU,BEL,2014.0,12,7,5
AUS,USA,2022.0,614,486,128
AUT,USA,2008.0,116,104,12
BRA,AUT,2008.0,4,5,-1
AUT,CHE,2011.0,55,47,8
CHE,BRA,2022.0,18,39,-21
CAN,AUS,2021.0,191,199,-8
ROU,SRB,2005.0,2,1,1
DNK,GBR,2012.0,65,79,-14
GBR,DEU,2002.0,464,504,-40
TUR,GBR,2008.0,19,41,-22
GBR,PRT,2021.0,100,108,-8
CHE,TWN,2017.0,6,8,-2
FIN,ESP,2011.0,12,18,-6
SGP,CAN,2013.0,26,25,1
SWE,DEU,2005.0,92,97,-5
SGP,FRA,2005.0,4,7,-3
ZMB,USA,2012.0,9,8,1
USA,ZMB,2007.0,7,4,3
RUS,CYP,2011.0,1,1,0
BRA,ARE,2022.0,6,6,0
RUS,SGP,2010.0,3,1,2
JPN,DEU,2003.0,134,99,35
USA,SVK,2006.0,10,24,-14
USA,SVK,2010.0,16,11,5
DNK,ROU,2019.0,4,3,1
DEU,POL,2018.0,92,91,1
DEU,POL,2016.0,73,89,-16
JPN,LTU,2021.0,2,1,1
AUS,ISR,2010.0,13,18,-5
PRI,ECU,2016.0,2,1,1
CHE,GEO,2017.0,2,1,1
AUT,BRA,2020.0,5,28,-23
LTU,DEU,2012.0,7,5,2
PRI,USA,2020.0,170,209,-39
GBR,POL,2008.0,32,73,-41
NZL,NOR,2011.0,2,3,-1
EGY,QAT,2014.0,17,11,6
FRA,DZA,2008.0,69,52,17
BEL,THA,2006.0,3,2,1
DEU,NGA,2013.0,7,5,2
ITA,SGP,2017.0,16,9,7
AZE,USA,2010.0,3,1,2
GBR,SAU,2018.0,190,62,128
CHE,ITA,1997.0,59,78,-19
NZL,CHN,1997.0,2,2,0
USA,SRB,2016.0,13,16,-3
ZAF,DNK,2007.0,3,2,1
SAU,EGY,2023.0,194,260,-66
BRA,VEN,2007.0,3,11,-8
ZAF,GBR,2006.0,77,50,27
EGY,USA,2008.0,52,114,-62
ARG,ITA,2013.0,15,10,5
NOR,USA,2021.0,90,130,-40
MAC,HKG,2005.0,2,5,-3
DEU,IRL,2005.0,27,11,16
ITA,ARG,2007.0,18,20,-2
NLD,GRC,2014.0,18,38,-20
ESP,POL,2000.0,4,8,-4
SGP,DEU,2007.0,9,18,-9
ROU,USA,1997.0,12,13,-1
MDA,USA,2008.0,1,2,-1
DEU,BEL,2014.0,105,92,13
DEU,ARG,2014.0,37,23,14
CHE,ISR,2011.0,11,16,-5
KEN,CHN,2006.0,2,3,-1
GBR,CYP,2017.0,35,17,18
HND,USA,2007.0,3,2,1
SVN,USA,2003.0,10,16,-6
DEU,ISL,2010.0,9,1,8
ZAF,IRL,2006.0,1,3,-2
CHL,COL,2019.0,26,43,-17
FRA,ROU,2015.0,46,35,11
JPN,IDN,2014.0,178,34,144
BEL,RUS,2018.0,9,11,-2
FRA,GRC,2002.0,32,31,1
MEX,CAN,2009.0,22,26,-4
SEN,MLI,2019.0,6,4,2
GBR,BEL,2020.0,195,150,45
USA,CRI,2013.0,18,18,0
GBR,KEN,2013.0,27,18,9
CZE,POL,2010.0,5,8,-3
SAU,TUR,2011.0,2,4,-2
KOR,AUS,2014.0,40,25,15
ISR,PSE,2008.0,9,11,-2
SVK,NOR,2005.0,1,1,0
CMR,USA,2008.0,5,6,-1
HRV,AUS,2007.0,1,1,0
DNK,NOR,2007.0,20,23,-3
GBR,HRV,2014.0,8,10,-2
CAN,TUR,2014.0,27,18,9
NZL,CHL,2004.0,1,3,-2
HRV,SRB,2013.0,17,12,5
DEU,ESP,2013.0,191,236,-45
ESP,PRT,2021.0,152,118,34
NLD,AUT,2002.0,15,19,-4
IRL,FIN,2019.0,9,4,5
POL,GBR,2008.0,73,32,41
GBR,LUX,2008.0,6,3,3
KEN,GBR,2005.0,7,12,-5
CHN,CAN,1998.0,55,24,31
IRL,PRT,2013.0,7,4,3
DEU,CHE,1998.0,275,251,24
ROU,USA,2002.0,44,21,23
CHN,TWN,2005.0,49,56,-7
FRA,DZA,2001.0,51,27,24
VNM,JPN,1999.0,4,6,-2
RUS,BLR,2017.0,33,20,13
CHN,RUS,2021.0,40,43,-3
AUT,RUS,2003.0,7,10,-3
SWE,ITA,2007.0,28,22,6
GBR,SGP,2014.0,133,80,53
FRA,ITA,2005.0,168,219,-51
CAN,DEU,1997.0,69,66,3
SAU,MYS,2016.0,28,76,-48
GBR,MYS,2017.0,134,94,40
IND,SGP,2006.0,31,16,15
CHN,KOR,2003.0,35,28,7
KOR,CHN,2006.0,51,53,-2
KOR,JPN,2009.0,122,149,-27
MDG,FRA,2020.0,10,12,-2
IRL,USA,2015.0,165,133,32
FRA,IRN,2013.0,20,18,2
EGY,SAU,2001.0,49,29,20
FRA,MAR,2010.0,94,51,43
FRA,CYP,2020.0,4,2,2
TUR,BEL,2009.0,9,5,4
FIN,CAN,2012.0,23,20,3
ARE,CHN,2011.0,3,1,2
TUN,SAU,2020.0,165,64,101
KEN,GBR,2012.0,14,29,-15
EGY,KWT,2020.0,13,19,-6
GRC,PRT,2007.0,2,5,-3
TUR,PAK,2011.0,7,4,3
ESP,TUN,2008.0,7,2,5
FIN,GBR,2018.0,56,79,-23
AUS,TLS,2014.0,2,1,1
IND,ZAF,2008.0,19,7,12
NLD,BEL,2015.0,190,152,38
TZA,GBR,2008.0,4,8,-4
ESP,ARG,2013.0,81,81,0
CHL,GBR,2004.0,11,13,-2
HKG,SGP,2021.0,34,54,-20
FRA,ESP,2019.0,261,291,-30
NGA,USA,2015.0,48,54,-6
CUB,CHL,2016.0,7,5,2
CAN,BEL,2008.0,16,35,-19
GBR,FIN,2021.0,87,63,24
GMB,GBR,1998.0,2,8,-6
IRN,SWE,2014.0,39,17,22
USA,TUR,2020.0,309,336,-27
CAN,HKG,2000.0,27,20,7
SOM,TUR,2023.0,5,3,2
IRL,ZAF,2013.0,8,4,4
AUS,ECU,2016.0,6,2,4
CHL,CHN,2017.0,5,5,0
EGY,USA,2001.0,78,61,17
KOR,EGY,2011.0,7,8,-1
GBR,EGY,2007.0,32,19,13
ESP,PRT,2011.0,101,63,38
HUN,CAN,2003.0,9,3,6
BLR,GBR,2009.0,1,1,0
DEU,CYP,2015.0,5,6,-1
UKR,POL,2004.0,13,10,3
SWE,POL,2008.0,15,25,-10
GBR,BHR,2003.0,4,3,1
NOR,IND,2021.0,12,31,-19
UZB,RUS,2007.0,13,4,9
ITA,IRN,2020.0,26,98,-72
CHN,DEU,2020.0,550,561,-11
CHN,CMR,2021.0,9,4,5
CHL,IND,2011.0,4,2,2
AUT,KEN,2021.0,2,1,1
PAK,MYS,2022.0,80,134,-54
FRA,ESP,2021.0,238,275,-37
MYS,GBR,2021.0,95,111,-16
ZAF,GBR,2023.0,71,49,22
KOR,CHE,2019.0,17,13,4
CHE,KOR,2023.0,7,14,-7
MAC,GBR,2020.0,1,7,-6
CHL,FRA,2020.0,43,32,11
USA,SRB,2017.0,26,28,-2
ZAF,NGA,2021.0,126,91,35
CAN,USA,2024.0,10,5,5
SVK,DEU,2019.0,10,7,3
JPN,FIN,2019.0,14,8,6
CHE,GBR,2021.0,284,353,-69
IND,IRL,2017.0,27,12,15
GBR,IRN,2017.0,48,67,-19
KAZ,CHN,2018.0,4,1,3
MYS,KOR,2018.0,20,16,4
IRL,NZL,2021.0,12,12,0
USA,SAU,2018.0,278,150,128
MOZ,NLD,2004.0,1,1,0
GBR,FRA,2012.0,420,419,1
MYS,JPN,2006.0,15,21,-6
HKG,USA,2012.0,135,149,-14
CAN,USA,2014.0,1940,1559,381
USA,KOR,2012.0,1080,754,326
CAN,USA,2008.0,1617,1529,88
KOR,IRN,2015.0,8,13,-5
GBR,GRC,2011.0,165,167,-2
FRA,POL,2004.0,24,36,-12
FRA,PRT,2003.0,41,17,24
CHN,SGP,2010.0,208,181,27
JPN,USA,2013.0,998,978,20
USA,BRA,2009.0,356,450,-94
ARG,BEL,2020.0,5,3,2
DEU,NOR,2014.0,66,33,33
USA,FRA,2009.0,771,814,-43
GBR,DEU,2017.0,766,824,-58
NZL,AUS,2013.0,202,104,98
RUS,CHE,2023.0,428,14,414
GBR,ITA,2006.0,220,230,-10
DEU,FRA,2011.0,376,371,5
IND,JPN,2010.0,83,98,-15
GRC,DEU,2007.0,59,40,19
CHE,BRA,2005.0,16,11,5
USA,ITA,2010.0,429,583,-154
FRA,LTU,2010.0,5,7,-2
FRA,DNK,2021.0,46,45,1
ESP,FRA,2017.0,315,266,49
CAN,AUS,2003.0,127,112,15
THA,NPL,2008.0,2,2,0
CAN,CHN,2009.0,159,193,-34
SWE,CHN,2013.0,77,82,-5
FIN,NOR,2020.0,36,30,6
USA,GRC,2007.0,148,95,53
EGY,SAU,2010.0,227,78,149
DNK,DEU,2003.0,62,75,-13
GRC,USA,2009.0,118,133,-15
DNK,CAN,2020.0,38,31,7
FRA,GUF,2005.0,7,10,-3
UGA,USA,2014.0,29,23,6
SWE,JPN,2007.0,31,40,-9
KEN,GBR,2018.0,26,33,-7
KOR,CHE,2003.0,11,9,2
GBR,CHE,2014.0,270,288,-18
SGP,RUS,2003.0,3,1,2
CHE,SWZ,2013.0,8,12,-4
FIN,CHE,2021.0,16,18,-2
TTO,USA,2004.0,8,6,2
CAN,IND,2019.0,91,178,-87
SWE,EST,2007.0,6,8,-2
RUS,UKR,2009.0,33,57,-24
GRC,BEL,2001.0,12,6,6
FRA,BRA,2011.0,99,109,-10
GRC,ITA,2010.0,22,28,-6
USA,KOR,1997.0,363,216,147
HKG,CHN,2005.0,265,372,-107
BGR,RUS,2023.0,6,2,4
GEO,USA,2020.0,289,232,57
ARE,SAU,2020.0,12,42,-30
CHN,SWE,2002.0,31,17,14
CAN,IND,2011.0,72,135,-63
USA,SWE,2017.0,271,278,-7
POL,USA,2003.0,183,131,52
ESP,VEN,2015.0,37,39,-2
VNM,TWN,2018.0,15,51,-36
HUN,JPN,2007.0,9,9,0
SWE,FRA,2004.0,42,44,-2
MEX,CAN,2013.0,35,32,3
TWN,JPN,2019.0,77,35,42
FIN,NLD,2013.0,19,17,2
VEN,ECU,2015.0,24,2,22
AUS,SGP,2016.0,90,82,8
CHN,HKG,2023.0,1018,1045,-27
ESP,USA,2005.0,292,353,-61
TUR,CYP,2021.0,172,140,32
FRA,TWN,2002.0,3,7,-4
FRA,PER,2010.0,6,5,1
JPN,GBR,1999.0,122,131,-9
DEU,ESP,2021.0,268,252,16
ITA,EST,2005.0,1,1,0
CAN,NZL,2016.0,34,37,-3
FRA,DEU,2000.0,248,263,-15
UKR,RUS,2003.0,60,57,3
CHN,SWE,2012.0,71,69,2
USA,COL,2007.0,85,64,21
RUS,CAN,2007.0,37,20,17
CHE,HUN,2013.0,14,19,-5
HKG,CAN,2016.0,38,25,13
IDN,IND,2006.0,4,4,0
NGA,GBR,2011.0,26,40,-14
DEU,LBN,2020.0,5,9,-4
TUN,IRL,2009.0,1,1,0
SAU,EGY,2015.0,235,277,-42
GBR,NOR,2007.0,43,33,10
DEU,THA,2008.0,27,20,7
FRA,TWN,2012.0,17,16,1
DEU,CZE,2021.0,57,72,-15
LBN,CAN,2009.0,9,6,3
USA,ITA,2000.0,453,513,-60
MYS,JPN,2010.0,16,47,-31
CAN,JPN,2012.0,90,93,-3
CHE,CAN,2003.0,58,60,-2
PHL,CHE,2020.0,4,3,1
CHN,CHE,2010.0,36,29,7
DEU,AUS,2009.0,154,121,33
KEN,ZWE,2006.0,4,2,2
HUN,FRA,2002.0,18,11,7
BRA,ESP,2016.0,110,145,-35
CHN,KOR,2009.0,122,102,20
MEX,RUS,2007.0,6,4,2
TWN,HKG,2004.0,4,2,2
CHE,IND,2020.0,50,65,-15
IRN,IND,2017.0,9,20,-11
NLD,CZE,2008.0,4,7,-3
MLI,FRA,2009.0,10,8,2
USA,GUM,2013.0,7,5,2
AUS,USA,2005.0,490,478,12
DEU,CHN,2023.0,408,344,64
USA,SWE,2018.0,317,297,20
JOR,ITA,2009.0,1,1,0
RUS,AZE,2017.0,8,6,2
AUT,POL,2005.0,3,5,-2
BRA,ESP,2017.0,123,130,-7
GBR,ZAF,2018.0,94,122,-28
USA,NGA,2016.0,50,58,-8
ESP,PRT,2003.0,43,14,29
FIN,IRL,2022.0,8,8,0
MEX,DEU,2011.0,31,20,11
ITA,CZE,2001.0,8,6,2
TWN,USA,2019.0,294,251,43
JOR,USA,2010.0,25,44,-19
NGA,CAN,2017.0,8,5,3
LUX,CHE,2005.0,1,3,-2
IRL,HRV,2019.0,2,1,1
JOR,ARE,2021.0,32,21,11
CAN,ISR,2011.0,59,57,2
USA,COL,1998.0,42,28,14
CHE,PRT,2009.0,10,7,3
LTU,CHE,2005.0,1,1,0
ITA,NOR,2021.0,27,23,4
ITA,CHE,2019.0,297,184,113
BRA,ESP,2018.0,120,129,-9
IRN,USA,2022.0,463,110,353
NLD,BEL,2023.0,120,125,-5
BRA,NOR,2021.0,22,6,16
DNK,USA,2003.0,131,110,21
MYS,OMN,2010.0,5,1,4
JPN,CHN,2020.0,599,440,159
ESP,DNK,2011.0,14,14,0
FIN,ARE,2017.0,2,1,1
BEL,TUR,2006.0,6,2,4
NLD,GBR,2014.0,318,264,54
ARE,PAK,2018.0,15,13,2
BEL,SEN,2011.0,5,1,4
DEU,IRL,2018.0,46,51,-5
ITA,PRT,2012.0,34,16,18
BEL,BRA,2007.0,20,8,12
AUS,CAN,2001.0,116,114,2
GBR,BMU,2014.0,1,2,-1
DEU,RUS,2013.0,113,110,3
IND,SGP,2014.0,82,64,18
AUS,NLD,2007.0,35,41,-6
USA,ZAF,1999.0,75,77,-2
NGA,GBR,2019.0,74,114,-40
DEU,GRC,2013.0,50,99,-49
SGP,AUS,1999.0,18,35,-17
TUR,BEL,2013.0,12,6,6
USA,PRT,2012.0,83,59,24
ESP,BEL,2018.0,87,57,30
FRA,AUT,2005.0,21,23,-2
BEL,FRA,2007.0,165,172,-7
SWE,USA,2005.0,222,201,21
PER,USA,2009.0,38,39,-1
ITA,SGP,2012.0,9,2,7
HKG,GBR,2015.0,55,62,-7
ITA,GRC,2007.0,22,27,-5
SVK,ITA,2011.0,5,3,2
ITA,IRL,2010.0,23,12,11
PHL,JPN,2011.0,13,25,-12
CHN,USA,2022.0,2281,4218,-1937
AUS,FRA,2013.0,85,125,-40
PNG,AUS,2004.0,4,5,-1
ITA,AUS,2012.0,39,20,19
AUS,ITA,2014.0,28,48,-20
PRI,BRA,2019.0,2,4,-2
CHE,CHN,2001.0,15,13,2
DNK,CHE,1997.0,4,2,2
GEO,DEU,2007.0,6,6,0
JPN,IDN,2006.0,39,10,29
FRA,MAR,2014.0,108,59,49
USA,HRV,2002.0,16,31,-15
SVN,USA,2019.0,8,13,-5
ZAF,IND,2010.0,11,32,-21
ARG,ESP,2023.0,61,27,34
AUS,CZE,2019.0,16,10,6
NLD,USA,2000.0,298,252,46
CAN,SWE,2020.0,54,42,12
FIN,GBR,2002.0,54,51,3
IND,GBR,2020.0,361,229,132
CHN,PAK,2020.0,421,389,32
IRL,ESP,2022.0,34,33,1
NOR,CHN,2022.0,31,32,-1
BGD,KOR,2019.0,18,36,-18
IDN,USA,2016.0,22,41,-19
AUS,CAN,2019.0,206,192,14
GBR,NGA,2013.0,38,33,5
USA,DEU,2011.0,1254,1316,-62
DEU,USA,2012.0,1265,1284,-19
DEU,CHE,2005.0,456,298,158
CAN,PAK,2015.0,20,23,-3
GBR,ESP,2021.0,419,401,18
POL,USA,2006.0,172,126,46
DEU,FRA,2015.0,382,414,-32
HRV,BIH,2014.0,7,12,-5
MEX,USA,2012.0,215,255,-40
DEU,NLD,2011.0,257,262,-5
AUS,DEU,2008.0,111,153,-42
FRA,TUN,2007.0,100,70,30
USA,IRN,2008.0,41,105,-64
CAN,FRA,2010.0,287,301,-14
DEU,ESP,2014.0,158,290,-132
JPN,DEU,2001.0,144,132,12
USA,PRI,2012.0,98,142,-44
CHE,USA,2018.0,595,600,-5
CHE,USA,2022.0,426,507,-81
TUR,CYP,2015.0,59,56,3
JPN,CAN,2009.0,99,93,6
GBR,CHE,2011.0,249,208,41
NLD,DEU,2005.0,167,172,-5
NLD,GBR,2021.0,299,422,-123
CHE,USA,2017.0,624,577,47
CAN,DEU,2007.0,119,216,-97
HUN,DEU,2005.0,43,49,-6
USA,NZL,2006.0,113,107,6
IRL,ARE,2017.0,3,1,2
DEU,NZL,2006.0,28,15,13
CAN,OMN,2010.0,12,2,10
JPN,CHN,2017.0,546,379,167
CAN,CHN,2014.0,290,316,-26
ITA,TUR,2010.0,15,13,2
AUS,PNG,2003.0,6,4,2
USA,THA,2008.0,226,106,120
COL,USA,2006.0,40,67,-27
AUT,SWE,2010.0,15,10,5
MAR,FRA,2005.0,41,62,-21
ZAF,GBR,2009.0,75,85,-10
CAN,IND,2008.0,47,92,-45
AUS,GBR,2013.0,465,736,-271
ESP,AUT,2008.0,22,18,4
ITA,CHE,2004.0,100,78,22
CHE,GBR,2010.0,197,245,-48
GBR,CAN,2006.0,320,238,82
PSE,DEU,2004.0,2,1,1
CAN,PRT,2001.0,8,8,0
USA,RUS,2009.0,187,195,-8
DNK,AUS,2017.0,34,34,0
DEU,GBR,2021.0,652,795,-143
USA,POL,2006.0,126,172,-46
NLD,FIN,2018.0,26,15,11
USA,NLD,2015.0,403,428,-25
SGP,GBR,2019.0,111,128,-17
BRA,GBR,2017.0,143,100,43
UKR,DEU,2014.0,44,14,30
GBR,NZL,2009.0,125,104,21
DEU,LUX,2010.0,32,15,17
PRT,USA,2018.0,96,66,30
BEL,ZAF,2013.0,13,12,1
ZAF,NOR,2010.0,6,2,4
ARE,QAT,2013.0,6,2,4
FRA,BEN,2005.0,14,6,8
CAN,GBR,2004.0,215,332,-117
MNG,KOR,2021.0,2,15,-13
CMR,FRA,2008.0,17,16,1
PRT,DEU,2004.0,17,13,4
GBR,AUT,2017.0,80,95,-15
NGA,DEU,2007.0,10,3,7
JPN,DEU,2015.0,113,127,-14
HKG,KOR,2004.0,5,2,3
DEU,CHN,2003.0,84,133,-49
HKG,IND,2013.0,11,7,4
CHE,RUS,2021.0,13,38,-25
FRA,PYF,2005.0,7,5,2
ESP,BRA,2015.0,168,106,62
GRC,ESP,2009.0,10,4,6
CHN,TWN,2020.0,254,332,-78
CHE,NZL,2005.0,5,9,-4
DNK,NLD,2003.0,21,25,-4
USA,JPN,2019.0,922,875,47
AUS,RUS,2011.0,9,15,-6
DEU,ESP,2001.0,106,95,11
CHN,BEL,2008.0,16,17,-1
GBR,GRC,2015.0,137,272,-135
GBR,KEN,2015.0,29,18,11
AUS,FRA,2010.0,81,111,-30
JPN,ARG,2010.0,2,1,1
MEX,DEU,2008.0,30,24,6
CZE,ITA,2003.0,5,5,0
ESP,ITA,2010.0,109,217,-108
MMR,THA,2019.0,14,9,5
CAN,IND,2014.0,91,131,-40
DEU,ROU,2009.0,30,24,6
JOR,USA,2013.0,34,60,-26
NLD,POL,2010.0,19,29,-10
CHN,CAN,2002.0,122,58,64
USA,POL,2010.0,143,113,30
CHN,EST,2020.0,4,4,0
IRL,HUN,2015.0,4,1,3
COL,CHL,2022.0,29,31,-2
CHL,COL,2023.0,15,15,0
NLD,JPN,2005.0,13,19,-6
UKR,ISR,2003.0,3,5,-2
USA,LTU,2003.0,12,5,7
DEU,PRT,2005.0,18,16,2
GBR,VEN,2006.0,7,12,-5
DEU,ETH,2005.0,5,2,3
BFA,CHN,2013.0,1,1,0
ITA,JPN,2017.0,36,24,12
CAN,NLD,2003.0,25,58,-33
AUS,IDN,2016.0,73,28,45
SAU,EGY,2011.0,104,269,-165
AUS,CHN,2001.0,32,53,-21
FRA,SWE,2002.0,58,62,-4
USA,ARE,2010.0,50,16,34
UKR,RUS,2000.0,91,66,25
CAN,ZAF,2017.0,29,31,-2
AUS,KOR,2012.0,18,31,-13
GBR,CHN,2011.0,306,214,92
AUS,IND,2020.0,87,182,-95
POL,DEU,2007.0,90,77,13
AUS,DEU,2014.0,143,158,-15
GBR,PRT,2006.0,49,32,17
USA,SWE,2020.0,303,244,59
KOR,VNM,2017.0,79,25,54
USA,DNK,2003.0,110,131,-21
BEL,GBR,2014.0,129,113,16
HRV,CHE,2003.0,7,3,4
USA,CRI,2015.0,18,16,2
GBR,JAM,2006.0,2,2,0
ZAF,IRL,2011.0,2,4,-2
IRL,FRA,2013.0,29,35,-6
BRA,ESP,2020.0,135,95,40
DEU,AUT,2003.0,216,180,36
NLD,BEL,2013.0,163,125,38
FRA,DNK,2004.0,21,16,5
ITA,SVN,2012.0,6,11,-5
BEL,NLD,2016.0,168,187,-19
TUR,GRC,2022.0,7,2,5
ISR,CHE,2003.0,21,8,13
ESP,CHL,2018.0,143,111,32
ESP,FRA,2020.0,242,282,-40
ESP,GRC,2010.0,8,19,-11
AUS,CHN,2008.0,83,122,-39
JPN,NLD,2009.0,13,22,-9
TUR,AZE,1998.0,2,6,-4
FRA,USA,2023.0,396,318,78
PHL,JPN,2008.0,17,20,-3
ESP,PRT,2010.0,56,74,-18
DEU,NLD,2019.0,353,347,6
NLD,DEU,2002.0,155,216,-61
USA,LBN,2004.0,35,35,0
IRN,CAN,2015.0,272,75,197
USA,KOR,2020.0,840,905,-65
GRC,GBR,2010.0,138,172,-34
JPN,USA,2004.0,1415,1137,278
FRA,GLP,2007.0,41,24,17
FRA,USA,2008.0,808,730,78
ARG,USA,2016.0,94,120,-26
USA,KOR,2007.0,846,671,175
IRL,AUS,2008.0,29,30,-1
USA,ISR,2001.0,333,389,-56
CAN,POL,2010.0,14,17,-3
SWE,NLD,2016.0,52,60,-8
IND,GBR,2005.0,104,83,21
JPN,DEU,2006.0,121,93,28
DEU,ITA,2022.0,270,313,-43
FRA,USA,2015.0,1004,783,221
IND,TZA,2010.0,3,1,2
IRN,ESP,2021.0,53,17,36
USA,NLD,2010.0,359,332,27
FRA,DZA,2011.0,138,48,90
ESP,URY,2010.0,13,5,8
IND,USA,2009.0,917,618,299
DEU,CHN,2011.0,248,243,5
UKR,KOR,2006.0,3,1,2
CHN,KOR,2010.0,107,136,-29
IRL,GBR,2021.0,477,458,19
ITA,CHE,2010.0,193,120,73
IRL,GBR,2009.0,166,249,-83
USA,DEU,2003.0,1310,1373,-63
USA,ARE,2008.0,54,14,40
USA,GRC,2012.0,104,180,-76
NLD,VNM,2009.0,5,2,3
HUN,USA,2018.0,76,62,14
NLD,DEU,2017.0,346,322,24
ISR,USA,2014.0,401,355,46
USA,AUS,2018.0,670,742,-72
CAN,ISR,2010.0,37,60,-23
SAU,BGD,2015.0,6,10,-4
USA,ISR,2004.0,238,405,-167
RUS,USA,2006.0,252,218,34
FIN,GBR,2020.0,67,83,-16
FRA,SWE,2016.0,87,58,29
USA,IND,1999.0,233,400,-167
HKG,GBR,2003.0,39,34,5
TUN,OMN,2012.0,1,1,0
FRA,ZAF,2003.0,24,15,9
GRC,GBR,2006.0,90,171,-81
FRA,GBR,2017.0,538,445,93
USA,PRI,2016.0,216,205,11
CHN,CAN,2017.0,360,404,-44
TUR,FRA,2015.0,19,16,3
USA,COL,2012.0,124,118,6
IRL,USA,2011.0,149,129,20
ITA,GBR,2010.0,368,240,128
JPN,VNM,2006.0,14,3,11
USA,IRL,2010.0,146,135,11
CAN,SWE,1997.0,20,16,4
USA,TUR,2022.0,185,238,-53
ISR,BEL,2007.0,2,3,-1
ITA,GBR,2006.0,230,220,10
BRA,CHL,2006.0,15,7,8
GBR,JPN,2016.0,147,123,24
DNK,USA,2004.0,103,99,4
JPN,CHN,1997.0,76,104,-28
FRA,CHE,2020.0,434,255,179
AUS,GBR,2011.0,504,619,-115
NCL,FRA,2007.0,13,17,-4
FRA,HKG,2003.0,7,7,0
SWE,EGY,2008.0,2,2,0
ITA,CHE,2006.0,115,75,40
CHN,BEL,2010.0,28,22,6
FRA,ISR,2010.0,18,25,-7
GBR,NLD,2012.0,198,239,-41
DEU,ARG,2009.0,19,28,-9
SWE,USA,2020.0,244,303,-59
USA,RUS,2003.0,337,432,-95
GBR,CAN,2004.0,332,215,117
NLD,AUS,2007.0,41,35,6
FRA,DEU,2019.0,441,365,76
DEU,KOR,2006.0,19,22,-3
ESP,VEN,2013.0,42,39,3
DEU,AUS,2006.0,124,91,33
ESP,ITA,2014.0,211,160,51
CHL,USA,2003.0,68,79,-11
DEU,CHE,2018.0,681,504,177
USA,KOR,1998.0,471,283,188
HRV,USA,2002.0,31,16,15
NLD,BEL,2011.0,141,128,13
FRA,ROU,2009.0,42,33,9
RUS,AUT,2020.0,18,12,6
ZAF,AUS,2003.0,40,20,20
NGA,NER,2016.0,9,19,-10
EGY,SAU,2021.0,393,302,91
AUT,SGP,2013.0,7,5,2
USA,BEL,2012.0,158,180,-22
EGY,USA,2011.0,61,127,-66
SDN,SAU,2010.0,13,4,9
CAN,ITA,2008.0,40,44,-4
IND,IRN,2007.0,10,4,6
NZL,CAN,2002.0,40,23,17
CUB,ESP,2009.0,33,27,6
RUS,ISR,2003.0,23,15,8
ESP,NLD,2015.0,84,62,22
CHE,FRA,2008.0,238,276,-38
ESP,GRC,2004.0,4,6,-2
CHE,USA,2005.0,374,389,-15
NGA,MEX,2019.0,2,1,1
BRA,CUB,2013.0,9,14,-5
CUB,BRA,2014.0,15,5,10
SGP,IND,2005.0,19,30,-11
BRA,ARG,2016.0,31,50,-19
LKA,BRN,2013.0,6,1,5
CAN,KOR,2003.0,30,30,0
GBR,FRA,2007.0,367,399,-32
USA,LBN,2023.0,39,109,-70
ISR,FRA,2017.0,28,42,-14
ESP,DNK,2010.0,23,17,6
USA,NZL,2008.0,122,95,27
UKR,DEU,2006.0,32,25,7
DEU,GRC,2014.0,53,87,-34
SWE,IRL,2008.0,14,8,6
BWA,ZAF,2011.0,12,8,4
DEU,IDN,2007.0,13,2,11
AUS,DEU,2000.0,71,83,-12
LBN,CAN,2006.0,8,7,1
SDN,DEU,2006.0,3,7,-4
USA,TWN,2018.0,260,313,-53
BRA,FRA,2008.0,108,86,22
GBR,SGP,2009.0,84,54,30
CAN,MEX,2010.0,26,44,-18
CHN,JPN,2018.0,345,528,-183
BRA,NLD,2001.0,18,13,5
CAN,ESP,2010.0,58,47,11
JPN,ITA,2002.0,33,24,9
GBR,SAU,2007.0,37,16,21
DEU,RUS,2004.0,123,198,-75
IND,SGP,2013.0,53,62,-9
SGP,NZL,2012.0,7,10,-3
BEL,USA,2008.0,133,133,0
CAN,CHN,2006.0,132,144,-12
BEL,FRA,1997.0,80,85,-5
BRA,USA,2020.0,790,452,338
MEX,RUS,2002.0,17,19,-2
RUS,MEX,2012.0,4,2,2
DEU,ESP,2006.0,110,94,16
GBR,THA,2021.0,109,59,50
NOR,ITA,2009.0,9,14,-5
DEU,ZAF,2012.0,41,30,11
USA,QAT,2009.0,15,4,11
TWN,IND,2010.0,29,62,-33
CHE,SWE,2010.0,60,55,5
NOR,DNK,2022.0,40,48,-8
FRA,SVN,1999.0,3,1,2
KOR,KHM,2017.0,3,1,2
USA,ITA,2021.0,454,510,-56
IRN,POL,2022.0,45,5,40
GBR,QAT,2016.0,47,17,30
USA,ZAF,2002.0,108,101,7
COL,ESP,2005.0,15,29,-14
BEL,ZAF,2009.0,7,4,3
CHN,AUS,2022.0,380,587,-207
GBR,GRC,2023.0,100,83,17
LTU,SWE,2006.0,3,5,-2
SGP,JPN,2002.0,9,21,-12
ISR,USA,2001.0,389,333,56
USA,TWN,2016.0,279,282,-3
FIN,SWE,2009.0,29,44,-15
NLD,SWE,2014.0,71,50,21
AUT,HUN,2015.0,17,15,2
FRA,DZA,2019.0,140,47,93
CAN,CHE,2012.0,88,78,10
FRA,NOR,2016.0,37,16,21
USA,BEL,2002.0,119,195,-76
MDG,FRA,2018.0,17,15,2
NGA,GBR,2010.0,38,33,5
GRC,DEU,2005.0,22,27,-5
BGR,DEU,2010.0,23,17,6
USA,MEX,2007.0,241,223,18
ITA,SWE,2018.0,86,52,34
IND,CHE,2007.0,20,10,10
COL,USA,2008.0,67,74,-7
SWE,FIN,2016.0,52,78,-26
NGA,JPN,2014.0,5,9,-4
MAR,FRA,2016.0,48,98,-50
IND,SGP,2003.0,31,14,17
GBR,ETH,2008.0,8,5,3
HUN,GBR,2016.0,43,27,16
FIN,CHN,2017.0,32,26,6
LUX,CAN,2020.0,2,4,-2
NLD,FRA,2016.0,124,98,26
USA,BGD,2009.0,26,20,6
AUS,CHN,2010.0,110,174,-64
CZE,RUS,2016.0,20,13,7
CHN,AUS,2016.0,395,349,46
ISR,IRL,2012.0,6,11,-5
AUS,MYS,2019.0,98,135,-37
TUN,FRA,2018.0,113,119,-6
RUS,FRA,1999.0,68,57,11
IRL,FRA,2019.0,32,48,-16
IRL,TUR,2015.0,3,3,0
GRC,SGP,2015.0,6,2,4
BEL,SWE,2003.0,20,11,9
SGP,JPN,2005.0,11,22,-11
SWE,LKA,2012.0,4,1,3
HUN,DEU,2017.0,49,40,9
GBR,AUT,2002.0,55,47,8
CAN,IRN,2006.0,50,64,-14
PRT,BRA,2011.0,96,113,-17
EGY,ARE,2012.0,14,15,-1
USA,GEO,2001.0,48,51,-3
AUS,NLD,2005.0,29,35,-6
HKG,CHN,1998.0,83,128,-45
JPN,SAU,2019.0,22,8,14
FRA,TWN,2007.0,8,6,2
USA,AUT,2017.0,132,148,-16
USA,COL,2002.0,42,52,-10
GBR,NZL,2013.0,147,122,25
ITA,IRN,2018.0,26,57,-31
HUN,USA,2022.0,50,33,17
ITA,DNK,2011.0,38,12,26
AUS,ROU,2004.0,1,1,0
ESP,PRT,2015.0,117,85,32
ESP,ARG,2010.0,89,91,-2
ARG,ESP,2011.0,94,97,-3
CHE,AUT,2014.0,55,63,-8
AUT,CHE,2015.0,93,61,32
TUN,SAU,2017.0,107,36,71
NLD,CYP,2019.0,5,3,2
NZL,NLD,2023.0,9,5,4
RUS,NOR,2015.0,7,6,1
HUN,AUT,2003.0,12,12,0
RUS,KAZ,2006.0,7,8,-1
FRA,GBR,2018.0,597,494,103
USA,ZAF,2012.0,117,93,24
ITA,ARG,2016.0,29,15,14
NLD,USA,2021.0,397,489,-92
FRA,PRT,2014.0,30,46,-16
BRA,ITA,2009.0,39,32,7
USA,CMR,2011.0,8,13,-5
JPN,IDN,2011.0,96,31,65
ISR,CAN,2010.0,60,37,23
JPN,IDN,2009.0,81,15,66
CAN,MEX,2006.0,15,25,-10
COL,USA,2014.0,113,96,17
USA,LUX,2018.0,11,16,-5
SVK,BEL,2012.0,2,5,-3
JPN,IDN,2021.0,235,118,117
MWI,GBR,2011.0,18,27,-9
ITA,DEU,2022.0,313,270,43
CAN,ESP,2000.0,21,20,1
CUB,USA,2018.0,15,10,5
USA,PER,2012.0,40,25,15
IRN,AUS,2019.0,221,53,168
SVK,CZE,2011.0,66,34,32
AUS,KWT,2019.0,9,4,5
GBR,SWE,2022.0,163,141,22
ISR,NLD,2006.0,9,5,4
CHE,BEL,2011.0,34,49,-15
ESP,NLD,2014.0,115,73,42
RUS,GBR,2004.0,66,53,13
GBR,HKG,2011.0,43,30,13
BRA,USA,2008.0,403,353,50
HKG,GBR,2002.0,39,40,-1
JPN,MYS,2013.0,78,27,51
USA,CHN,2017.0,3484,3596,-112
USA,JPN,2012.0,995,1016,-21
DEU,NLD,2005.0,172,167,5
USA,KOR,2004.0,681,600,81
AUS,ITA,2012.0,20,39,-19
CHN,DEU,2009.0,205,164,41
AUS,USA,2008.0,470,634,-164
USA,KOR,2015.0,1030,834,196
NLD,AUT,2000.0,13,25,-12
USA,ESP,2020.0,485,515,-30
USA,TWN,2011.0,367,289,78
CAN,AUS,2007.0,155,150,5
IND,SAU,2011.0,87,10,77
BGR,FIN,2011.0,2,1,1
KEN,USA,2010.0,25,37,-12
USA,NZL,1999.0,107,82,25
FIN,CAN,2010.0,15,17,-2
USA,SWE,2006.0,180,237,-57
GBR,FRA,2004.0,317,337,-20
PAN,CAN,2016.0,3,2,1
FRA,CIV,2012.0,47,19,28
CAN,JPN,2004.0,82,100,-18
CAN,MAR,2018.0,13,6,7
AUS,IND,2023.0,57,82,-25
MAC,HKG,2023.0,13,10,3
CZE,USA,2018.0,54,69,-15
ITA,ESP,2011.0,203,115,88
DEU,BLR,2006.0,8,10,-2
GBR,IRL,2004.0,195,159,36
SWE,NZL,2009.0,8,7,1
USA,HKG,2007.0,109,102,7
GBR,NLD,2003.0,184,189,-5
KOR,GBR,2013.0,48,53,-5
USA,COL,2003.0,39,41,-2
HUN,GBR,2009.0,31,27,4
BEL,DEU,2009.0,76,103,-27
HUN,GBR,2019.0,39,37,2
GBR,FRA,2001.0,337,457,-120
NOR,USA,2007.0,55,73,-18
IRN,AUT,2010.0,10,8,2
MEX,USA,2011.0,241,247,-6
NLD,BRA,2006.0,21,13,8
GBR,SWE,2009.0,135,136,-1
SAU,IND,2015.0,37,177,-140
USA,GBR,2024.0,5,7,-2
CAN,USA,2002.0,1712,1530,182
RUS,CHN,2013.0,8,3,5
TWN,DEU,2003.0,8,6,2
IND,CHE,2014.0,42,39,3
DEU,HUN,2020.0,33,48,-15
AUT,DEU,2010.0,279,332,-53
PRI,USA,2021.0,178,223,-45
CHE,JPN,2003.0,35,27,8
FRA,TWN,2004.0,8,5,3
CHN,IND,2010.0,9,17,-8
BEL,ROU,2010.0,16,6,10
CAN,SAU,2010.0,65,31,34
BEL,SRB,2002.0,7,1,6
BLR,CAN,2009.0,2,1,1
HUN,NLD,2023.0,8,5,3
CAN,ARE,2022.0,22,28,-6
JPN,HRV,2013.0,1,2,-1
JPN,PAK,2011.0,14,14,0
CHE,FRA,1998.0,127,172,-45
BEL,USA,1999.0,141,97,44
IND,MYS,2010.0,72,29,43
CHE,DEU,2017.0,447,719,-272
BEL,UKR,2018.0,3,3,0
USA,JOR,2008.0,61,22,39
PAK,AUS,2019.0,59,22,37
DEU,GBR,1997.0,247,257,-10
GBR,LUX,2018.0,13,5,8
USA,AUS,2019.0,746,717,29
USA,ITA,2022.0,391,414,-23
GBR,TWN,2014.0,41,33,8
CHE,ITA,2010.0,120,193,-73
JPN,IND,2006.0,72,75,-3
RUS,DEU,2000.0,226,99,127
UKR,BLR,1997.0,8,3,5
AUS,NLD,2013.0,53,93,-40
KEN,USA,2006.0,24,29,-5
MDG,USA,2009.0,5,7,-2
GBR,SGP,2018.0,136,115,21
HUN,USA,2011.0,74,68,6
SWE,IRL,2007.0,7,3,4
ZAF,DNK,2011.0,3,5,-2
DEU,TUR,2007.0,20,36,-16
NLD,CYP,2017.0,3,4,-1
USA,COL,2013.0,112,88,24
USA,EST,2011.0,8,6,2
GBR,SAU,2015.0,124,36,88
BEL,NLD,2003.0,116,98,18
MEX,ESP,2005.0,62,77,-15
IRL,USA,2018.0,158,174,-16
ESP,NLD,2020.0,111,82,29
DEU,HRV,2017.0,14,16,-2
FRA,NLD,2001.0,112,82,30
AUT,GBR,1997.0,16,17,-1
LBN,USA,2015.0,63,63,0
GBR,MWI,2018.0,16,22,-6
FRA,AUT,2015.0,50,35,15
AUT,NZL,2019.0,6,7,-1
ISR,RUS,2006.0,14,8,6
TWN,CAN,2003.0,9,18,-9
FRA,MEX,2021.0,48,60,-12
CAN,IRL,2023.0,26,24,2
BEL,DEU,2019.0,140,124,16
MYS,VNM,2023.0,6,1,5
VNM,JPN,2021.0,33,114,-81
JPN,MEX,2016.0,10,7,3
VNM,JPN,2019.0,38,110,-72
CHN,USA,2012.0,2442,2515,-73
FRA,ITA,2012.0,210,358,-148
USA,ROU,2019.0,29,21,8
HUN,DEU,2007.0,40,31,9
GBR,USA,2016.0,1984,1887,97
GBR,NZL,2010.0,141,118,23
NOR,ISL,2010.0,8,4,4
USA,JPN,2006.0,1110,1284,-174
GBR,CAN,2011.0,377,338,39
BMU,USA,2003.0,5,2,3
BRA,USA,2022.0,610,363,247
AUS,GBR,2014.0,527,701,-174
FRA,PRT,2009.0,38,32,6
TUR,USA,2013.0,287,281,6
NOR,USA,2019.0,91,139,-48
ISR,AUS,2019.0,26,18,8
CHN,HKG,2008.0,310,367,-57
AUS,GBR,2001.0,404,372,32
AUT,USA,2004.0,100,93,7
GBR,CAN,2009.0,382,322,60
AUT,DEU,2005.0,167,252,-85
CYP,TUR,2020.0,112,125,-13
CAN,USA,2010.0,1754,1636,118
COG,FRA,2005.0,3,9,-6
JPN,SWE,2008.0,29,29,0
SGP,THA,2020.0,6,8,-2
FRA,ROU,2008.0,43,27,16
TTO,GBR,2008.0,3,10,-7
GBR,JPN,2007.0,112,124,-12
DEU,AUS,2003.0,84,100,-16
RUS,DEU,2012.0,145,99,46
CAN,USA,2006.0,1427,1533,-106
CAN,USA,2000.0,1578,1102,476
ITA,GBR,2003.0,227,264,-37
ITA,CAN,2010.0,68,41,27
NLD,USA,2008.0,301,298,3
USA,PRY,2003.0,1,1,0
KOR,SGP,2014.0,23,21,2
JPN,BRA,2008.0,12,17,-5
GBR,FIN,2019.0,81,73,8
PRT,FIN,2019.0,5,7,-2
USA,SWE,2005.0,201,222,-21
HKG,SGP,2009.0,36,26,10
SWE,FRA,2010.0,47,59,-12
NLD,GBR,2010.0,212,249,-37
USA,ESP,2011.0,480,509,-29
DNK,FRA,2018.0,47,78,-31
UKR,RUS,2019.0,110,57,53
DEU,DNK,2002.0,80,57,23
DEU,EST,2006.0,3,3,0
CHN,SGP,2004.0,63,69,-6
EST,FIN,2012.0,12,17,-5
USA,EST,1998.0,5,1,4
ISR,USA,2021.0,433,384,49
GBR,GMB,2010.0,9,5,4
CHN,SGP,2015.0,272,298,-26
TUR,NLD,2010.0,29,12,17
NLD,BEL,2008.0,105,111,-6
SWE,ESP,2004.0,24,21,3
GBR,THA,2014.0,88,36,52
IND,CAN,2012.0,134,82,52
USA,CZE,2013.0,72,45,27
NZL,USA,2009.0,125,127,-2
AUS,FRA,2009.0,83,90,-7
FRA,CAN,2003.0,230,177,53
BEL,ITA,2004.0,27,20,7
DEU,BRA,2007.0,57,75,-18
USA,DEU,2006.0,1083,1329,-246
CHE,ITA,2012.0,108,234,-126
DEU,CHE,2007.0,508,357,151
HUN,USA,2020.0,52,53,-1
AUT,DNK,2014.0,12,6,6
ESP,AUS,2014.0,75,28,47
FRA,GEO,2016.0,16,10,6
ITA,LUX,2022.0,13,6,7
SGP,CHN,2010.0,181,208,-27
BRA,USA,2018.0,678,521,157
USA,PHL,2017.0,48,34,14
IND,DEU,2009.0,138,90,48
UKR,AUS,2009.0,4,2,2
POL,USA,2019.0,120,135,-15
MKD,GRC,2018.0,5,1,4
TUR,CHE,2005.0,6,8,-2
SWE,CZE,2009.0,10,9,1
DEU,DZA,2019.0,7,4,3
GBR,CHE,2023.0,176,153,23
EGY,SAU,2014.0,299,220,79
GBR,USA,2022.0,1658,1384,274
SWE,CHE,2008.0,38,24,14
AUS,CHN,2003.0,51,60,-9
ESP,ROU,2009.0,6,6,0
MEX,SWE,2007.0,3,2,1
USA,NLD,2003.0,292,302,-10
CAN,IRL,1997.0,9,8,1
USA,TUR,2007.0,262,199,63
ECU,VEN,2022.0,5,17,-12
IRL,SRB,2023.0,1,1,0
SRB,USA,2002.0,46,26,20
POL,USA,2009.0,148,124,24
USA,KOR,2018.0,885,857,28
CAN,NZL,2005.0,19,34,-15
CHE,ITA,2002.0,86,118,-32
HUN,SRB,2011.0,2,2,0
BEL,DEU,1998.0,46,52,-6
CHE,AUT,2009.0,43,60,-17
AUS,KOR,1999.0,11,7,4
THA,GBR,2003.0,17,60,-43
ZAF,IND,2008.0,7,19,-12
AUT,HUN,2019.0,16,33,-17
ESP,CHE,2022.0,124,76,48
BLR,USA,2012.0,4,1,3
PAK,GBR,2008.0,41,32,9
GBR,THA,2015.0,95,32,63
FRA,PRT,2011.0,42,38,4
PRT,FRA,2018.0,37,63,-26
MUS,AUS,2010.0,2,1,1
BEL,BGR,1998.0,3,7,-4
BRA,NZL,2001.0,4,1,3
GBR,NGA,2008.0,29,20,9
COL,USA,2011.0,94,94,0
GBR,ITA,2008.0,220,293,-73
DNK,SWE,1998.0,34,45,-11
KEN,USA,2005.0,27,21,6
DEU,NLD,2006.0,189,190,-1
GBR,TTO,2015.0,6,4,2
LTU,DNK,2011.0,2,1,1
IND,AUT,2014.0,15,4,11
NLD,ITA,2012.0,71,113,-42
CHN,CHE,2008.0,42,26,16
DEU,SWE,2006.0,96,91,5
TUR,DEU,2011.0,48,34,14
PRT,BRA,2004.0,36,41,-5
CAN,JPN,2017.0,79,72,7
HUN,GBR,1998.0,18,25,-7
NLD,BEL,2014.0,172,148,24
GHA,AUS,2019.0,18,6,12
FIN,CAN,2005.0,13,14,-1
CZE,USA,2014.0,54,76,-22
NOR,USA,2009.0,90,85,5
USA,LBN,2003.0,41,27,14
FRA,DZA,2004.0,53,23,30
GBR,TUR,2006.0,45,25,20
USA,GBR,1997.0,938,938,0
USA,KOR,2022.0,728,731,-3
ZAF,AUS,2010.0,36,16,20
ESP,SGP,2011.0,9,6,3
RUS,POL,1998.0,14,13,1
SWE,FIN,2007.0,40,38,2
ARG,BRA,2007.0,26,25,1
USA,HKG,2009.0,133,120,13
BEL,CHE,1997.0,17,16,1
BRA,FRA,2009.0,94,104,-10
DEU,FIN,2018.0,53,76,-23
NGA,GBR,2013.0,33,38,-5
FRA,ROU,2004.0,34,29,5
NZL,CHE,2007.0,7,10,-3
NLD,SVN,2010.0,2,3,-1
USA,SGP,2012.0,276,199,77
SRB,USA,2005.0,15,46,-31
PHL,USA,2005.0,23,20,3
EGY,IND,2019.0,3,5,-2
POL,DEU,2012.0,87,77,10
ARG,USA,1999.0,137,83,54
USA,LTU,2001.0,9,13,-4
AUT,USA,2015.0,161,149,12
ESP,CHE,2018.0,120,85,35
IRN,MYS,2014.0,70,119,-49
BLR,RUS,2003.0,19,8,11
NOR,ARE,2022.0,3,1,2
ZAF,GBR,2000.0,72,43,29
JOR,USA,2001.0,17,22,-5
CZE,USA,2008.0,49,57,-8
CHN,ISR,1998.0,9,3,6
ISR,CHN,2002.0,6,14,-8
RUS,BLR,2022.0,16,22,-6
UKR,POL,2015.0,27,15,12
ISR,AUS,2011.0,18,12,6
SVK,CHE,2003.0,10,1,9
IRN,FRA,2006.0,12,23,-11
TWN,GBR,2016.0,35,36,-1
NLD,CHE,2007.0,52,44,8
GUY,USA,2022.0,1,1,0
ITA,SWE,2007.0,22,28,-6
ZAF,NGA,2011.0,22,33,-11
BRA,USA,2017.0,635,473,162
CZE,ESP,2008.0,4,4,0
CHN,TUR,2019.0,7,18,-11
PRT,GBR,2002.0,24,68,-44
BEL,NZL,2011.0,4,1,3
CAN,JPN,2018.0,90,96,-6
HKG,USA,2018.0,165,133,32
USA,VEN,2008.0,25,36,-11
USA,CHL,2021.0,126,150,-24
KOR,USA,2020.0,905,840,65
POL,GBR,2014.0,67,64,3
SWE,USA,2018.0,297,317,-20
PRT,ESP,2010.0,74,56,18
BEL,NOR,2014.0,8,4,4
RUS,AUT,2016.0,16,9,7
JPN,POL,2004.0,10,9,1
IRL,ESP,2012.0,23,9,14
NLD,GRC,2008.0,11,15,-4
CAN,IRN,2013.0,61,249,-188
GBR,HUN,2015.0,32,48,-16
KAZ,RUS,2007.0,15,10,5
NIC,USA,2011.0,12,3,9
HKG,SGP,2011.0,35,17,18
SWE,ETH,2009.0,8,5,3
GBR,PRT,2011.0,87,52,35
DEU,NOR,2010.0,57,43,14
CHE,NOR,2004.0,12,9,3
GBR,ZAF,2002.0,69,69,0
NZL,GBR,1999.0,69,104,-35
CAN,EGY,1999.0,15,12,3
GBR,POL,2014.0,64,67,-3
JPN,CAN,2006.0,117,74,43
DEU,ITA,2020.0,295,344,-49
SAU,TUN,2022.0,56,101,-45
HKG,USA,2022.0,138,157,-19
NZL,GBR,2020.0,120,142,-22
RUS,DNK,2011.0,5,2,3
FRA,MCO,2014.0,13,4,9
MDG,USA,2007.0,4,4,0
NGA,UGA,2016.0,2,1,1
ITA,DNK,2014.0,35,20,15
CZE,IND,2017.0,7,20,-13
TUR,GBR,2004.0,29,44,-15
PRI,ESP,2010.0,7,3,4
KAZ,GBR,2020.0,7,8,-1
MYS,GBR,2019.0,87,129,-42
IRN,DEU,2021.0,166,53,113
USA,JOR,2017.0,64,47,17
CHN,CAN,2020.0,430,537,-107
,USA,2003.0,76476,0,76476
MYS,,2025.0,27981,0,27981
JPN,,2008.0,17719,0,17719
CAN,,2007.0,4533,0,4533
CHN,,2025.0,1163994,0,1163994
,RUS,2002.0,5740,0,5740
,BLR,1998.0,304,0,304
BLR,,2014.0,187,0,187
SAU,,2016.0,736,0,736
AUS,,2025.0,81796,0,81796
,PRI,2001.0,133,0,133
VEN,,2023.0,590,0,590
NLD,,2013.0,3346,0,3346
,GBR,1994.0,70947,0,70947
,CHE,1996.0,3692,0,3692
GBR,,2022.0,28920,0,28920
,POL,2003.0,4348,0,4348
POL,,2010.0,1930,0,1930
,THA,2000.0,1043,0,1043
EGY,,2025.0,29452,0,29452
CHN,,2021.0,132948,0,132948
ESP,,2020.0,12479,0,12479
TUR,,2012.0,2274,0,2274
SRB,,2018.0,744,0,744
AUS,,2021.0,10262,0,10262
AUT,,2024.0,8733,0,8733
,AUS,2006.0,7357,0,7357
,ISR,1997.0,2237,0,2237
GRC,,2014.0,1546,0,1546
CHE,,2025.0,38732,0,38732
AUS,,2011.0,3595,0,3595
CHN,,2019.0,96417,0,96417
GBR,,2017.0,15274,0,15274
CHE,,2009.0,2186,0,2186
,TUN,1995.0,598,0,598
ITA,,2014.0,7488,0,7488
GRC,,2015.0,1644,0,1644
,PRT,2003.0,1662,0,1662
,AUT,2000.0,1778,0,1778
DNK,,2025.0,23803,0,23803
CHE,,2021.0,5546,0,5546
,HKG,2012.0,1734,0,1734
,CAN,1995.0,15254,0,15254
BRA,,2023.0,43322,0,43322
,BEL,2002.0,2698,0,2698
HRV,,2010.0,365,0,365
,ARG,2004.0,2037,0,2037
ARG,,2023.0,6284,0,6284
DEU,,2008.0,11687,0,11687
,MYS,2003.0,902,0,902
,HKG,2005.0,1412,0,1412
JPN,,2015.0,21128,0,21128
,DEU,1994.0,64966,0,64966
DEU,,2015.0,16068,0,16068
CHN,,2009.0,25772,0,25772
,CHN,2004.0,71835,0,71835
,ISR,2002.0,2297,0,2297
DEU,,2014.0,14741,0,14741
FIN,,2022.0,2956,0,2956
CHE,,2019.0,4434,0,4434
,ITA,2000.0,10824,0,10824
NOR,,2013.0,986,0,986
CHN,,2011.0,34812,0,34812
,CHN,2001.0,33855,0,33855
,ARG,2001.0,1678,0,1678
POL,,2024.0,22455,0,22455
FRA,,2016.0,10856,0,10856
NGA,,2018.0,865,0,865
BRA,,2024.0,64314,0,64314
,CHL,2003.0,1019,0,1019
,IND,1995.0,11927,0,11927
,RUS,1997.0,9223,0,9223
GBR,,2016.0,14097,0,14097
FIN,,2018.0,1866,0,1866
,CZE,1994.0,5251,0,5251
,HKG,2002.0,1460,0,1460
ESP,,2007.0,3925,0,3925
,CHE,2001.0,2803,0,2803
AUS,,2019.0,7850,0,7850
,CHN,2014.0,167628,0,167628
HRV,,2023.0,2393,0,2393
DNK,,2019.0,2434,0,2434
,CIV,2004.0,102,0,102
,CYP,2018.0,296,0,296
,MEX,2001.0,2503,0,2503
,TWN,1995.0,4569,0,4569
VEN,,2010.0,367,0,367
,CHN,2008.0,91615,0,91615
HUN,,2006.0,534,0,534
,FRA,1998.0,12803,0,12803
,MKD,2002.0,92,0,92
,LKA,1998.0,89,0,89
,ZAF,2002.0,1359,0,1359
SVK,,2008.0,307,0,307
,CHN,2015.0,181484,0,181484
JPN,,2014.0,19486,0,19486
,DNK,1999.0,1576,0,1576
HUN,,2024.0,5749,0,5749
,ARG,1996.0,2345,0,2345
,FRA,2007.0,14337,0,14337
FRA,,2018.0,12753,0,12753
ITA,,2015.0,8071,0,8071
,CHN,1996.0,17109,0,17109
,FRA,1999.0,12808,0,12808
,NLD,2002.0,4783,0,4783
,PAK,1995.0,702,0,702
GBR,,2018.0,16685,0,16685
,BEL,1997.0,2544,0,2544
PAK,,2024.0,12530,0,12530
FIN,,2017.0,1657,0,1657
KOR,,2012.0,6342,0,6342
ITA,,2008.0,5374,0,5374
TWN,,2008.0,2487,0,2487
,DZA,2005.0,732,0,732
SAU,,2017.0,870,0,870
,TUR,1994.0,7553,0,7553
,POL,2013.0,6373,0,6373
,ISL,1999.0,93,0,93
,NLD,2005.0,5133,0,5133
PAK,,2023.0,6785,0,6785
AUS,,2009.0,3223,0,3223
,LTU,2001.0,505,0,505
LTU,,2020.0,487,0,487
,CHE,2004.0,3496,0,3496
,RUS,2005.0,6700,0,6700
,AUS,2000.0,5548,0,5548
TWN,,2014.0,5290,0,5290
AUT,,2000.0,457,0,457
JPN,,2004.0,16103,0,16103
,MEX,1996.0,2654,0,2654
DNK,,2021.0,2942,0,2942
JPN,,2001.0,12983,0,12983
,BGR,2003.0,483,0,483
SRB,,2017.0,691,0,691
,DEU,2009.0,22915,0,22915
BRA,,2010.0,4199,0,4199
,ESP,2018.0,15935,0,15935
SWE,,2016.0,2702,0,2702
FRA,,2017.0,11755,0,11755
NZL,,2012.0,688,0,688
,SGP,2000.0,1077,0,1077
BRA,,2006.0,1795,0,1795
HRV,,2006.0,220,0,220
,SAU,2002.0,443,0,443
IRL,,2007.0,408,0,408
HUN,,2010.0,730,0,730
TWN,,2015.0,6121,0,6121
FRA,,2022.0,21288,0,21288
CHE,,2011.0,2209,0,2209
THA,,2024.0,10483,0,10483
THA,,2023.0,5306,0,5306
,GBR,2011.0,21662,0,21662
EGY,,2009.0,398,0,398
,KOR,2016.0,16640,0,16640
,IRL,2003.0,1154,0,1154
FIN,,2016.0,1523,0,1523
SWE,,2022.0,5503,0,5503
,LVA,2006.0,249,0,249
,ZAF,2005.0,1460,0,1460
SRB,ROU,2017.0,3,0,3
SGP,,2015.0,1236,0,1236
,SWE,2002.0,3337,0,3337
,KOR,2018.0,17830,0,17830
KAZ,,2025.0,6302,0,6302
NGA,,2017.0,751,0,751
,UKR,2016.0,3990,0,3990
HRV,,2024.0,4316,0,4316
CAN,,2020.0,12803,0,12803
GEO,,2015.0,81,0,81
,BRA,2016.0,23369,0,23369
,LTU,2004.0,616,0,616
COG,,2025.0,316,0,316
AUT,,2010.0,1210,0,1210
ARG,,2024.0,10245,0,10245
ZAF,,2022.0,3159,0,3159
CMR,,2025.0,2933,0,2933
,IDN,2002.0,236,0,236
,KAZ,1996.0,122,0,122
,ITA,2006.0,12985,0,12985
,GBR,2009.0,20223,0,20223
DNK,,2009.0,940,0,940
POL,,2023.0,12898,0,12898
CZE,,2008.0,776,0,776
PRT,,2012.0,710,0,710
COL,,2022.0,3303,0,3303
,GHA,2002.0,113,0,113
,GHA,1997.0,68,0,68
BGD,,2025.0,8661,0,8661
TTO,,2023.0,144,0,144
,IRN,1999.0,934,0,934
GRC,,2008.0,1056,0,1056
,IRN,2007.0,8694,0,8694
,NLD,1997.0,4686,0,4686
,SVK,1997.0,684,0,684
ZAF,,2017.0,1311,0,1311
BWA,,2013.0,47,0,47
CRI,,2004.0,26,0,26
,FIN,2019.0,1820,0,1820
SGP,,2014.0,1130,0,1130
KHM,,2016.0,45,0,45
CHL,,2012.0,647,0,647
,RUS,2012.0,13100,0,13100
MEX,,2013.0,2222,0,2222
PAK,,2006.0,211,0,211
,VNM,2000.0,132,0,132
AUT,,2023.0,5299,0,5299
KOR,,2005.0,2638,0,2638
,NOR,2000.0,1253,0,1253
,DEU,2011.0,24147,0,24147
,HUN,1995.0,2326,0,2326
SWE,,2018.0,3188,0,3188
TWN,,2001.0,1191,0,1191
,SWE,1997.0,3730,0,3730
,SWE,2005.0,3355,0,3355
,HKG,1997.0,1063,0,1063
DEU,,2001.0,7950,0,7950
SVK,,2014.0,478,0,478
,CZE,2019.0,2291,0,2291
,USA,2013.0,95559,0,95559
CYP,,2025.0,2082,0,2082
UZB,,2011.0,59,0,59
,MWI,2000.0,43,0,43
EGY,,2019.0,1566,0,1566
CYP,,2019.0,155,0,155
SWE,,2017.0,2904,0,2904
,RWA,2004.0,22,0,22
SAU,,2018.0,973,0,973
MAR,,2008.0,176,0,176
GEO,,2014.0,67,0,67
,EGY,1994.0,2735,0,2735
,BEL,2005.0,3051,0,3051
VEN,,2024.0,663,0,663
,IRN,1998.0,835,0,835
BLR,,2008.0,178,0,178
,DNK,1998.0,1700,0,1700
,SRB,2002.0,605,0,605
SGP,,2008.0,661,0,661
EST,,2013.0,159,0,159
NGA,,2022.0,2710,0,2710
,NGA,2000.0,602,0,602
,CUB,1995.0,783,0,783
HRV,,2000.0,104,0,104
ECU,,2012.0,23,0,23
,FIN,1994.0,7407,0,7407
BGD,,2021.0,661,0,661
,UKR,2017.0,6110,0,6110
NZL,,2002.0,391,0,391
THA,,2010.0,552,0,552
MYS,,2011.0,460,0,460
POL,,2000.0,526,0,526
SRB,,2022.0,1606,0,1606
,ITA,2010.0,14276,0,14276
,IDN,2005.0,427,0,427
,FRA,2020.0,6352,0,6352
,GBR,2019.0,20977,0,20977
ITA,,2001.0,3600,0,3600
,ZAF,1997.0,1235,0,1235
UZB,,2009.0,53,0,53
,SEN,2003.0,98,0,98
DEU,,2004.0,9704,0,9704
,MEX,2004.0,3129,0,3129
GLP,,2023.0,11,0,11
,KEN,2000.0,191,0,191
SVN,,2007.0,134,0,134
,GUF,1997.0,3,0,3
POL,,2006.0,1361,0,1361
,NLD,2012.0,6689,0,6689
,MEX,2014.0,5399,0,5399
OMN,,2023.0,459,0,459
LTU,IRL,2008.0,2,0,2
,SVK,2002.0,623,0,623
SVK,,2015.0,540,0,540
COL,,2018.0,1095,0,1095
,COL,2004.0,828,0,828
DNK,,2011.0,962,0,962
HUN,,2023.0,3237,0,3237
,ROU,1994.0,2099,0,2099
LUX,SWE,2019.0,2,0,2
SAU,,2022.0,2720,0,2720
,NOR,2006.0,1621,0,1621
KOR,,2002.0,2016,0,2016
,NZL,2000.0,963,0,963
,THA,2006.0,1963,0,1963
,SRB,1997.0,596,0,596
,JPN,2016.0,22712,0,22712
,FIN,2009.0,2128,0,2128
NZL,,2005.0,397,0,397
IRL,LBY,2009.0,1,0,1
KGZ,BEL,2003.0,1,0,1
,MNE,2010.0,52,0,52
ARG,CHN,2021.0,3,0,3
GBR,,2026.0,1513,0,1513
,EGY,2019.0,4818,0,4818
,PRT,2013.0,3384,0,3384
,BLR,1999.0,361,0,361
ZAF,,2018.0,1425,0,1425
BRB,,2015.0,7,0,7
,PHL,2000.0,186,0,186
MEX,,2003.0,501,0,501
POL,SAU,2007.0,2,0,2
MYS,,2009.0,256,0,256
,FJI,2018.0,56,0,56
SVK,,2001.0,163,0,163
SWE,,2026.0,360,0,360
CZE,,2014.0,1280,0,1280
MYS,,2019.0,2945,0,2945
NGA,,2016.0,818,0,818
MYS,,2021.0,4541,0,4541
CMR,,2011.0,62,0,62
BGR,,2012.0,323,0,323
,BEL,2012.0,3761,0,3761
TUR,,2005.0,731,0,731
NPL,,2013.0,59,0,59
NLD,,2003.0,2032,0,2032
JOR,,2008.0,70,0,70
,YEM,1995.0,18,0,18
VNM,,2022.0,1861,0,1861
,JOR,2006.0,442,0,442
ARG,,2010.0,813,0,813
JPN,EST,2009.0,1,0,1
ESP,,1999.0,1199,0,1199
ISL,,2003.0,26,0,26
,COL,2001.0,387,0,387
,ARE,1996.0,94,0,94
,DZA,2002.0,434,0,434
,MEX,2008.0,3801,0,3801
,DZA,2012.0,1476,0,1476
,BGD,1998.0,249,0,249
,DEU,2019.0,22415,0,22415
,CIV,2001.0,59,0,59
,ROU,2009.0,2572,0,2572
,SGP,2006.0,1543,0,1543
,GRC,2016.0,2395,0,2395
,SAU,2012.0,1949,0,1949
,NZL,2006.0,1238,0,1238
,SWE,2012.0,3898,0,3898
ISR,,2013.0,1483,0,1483
,BGD,1999.0,229,0,229
,HRV,2000.0,850,0,850
ISR,,2003.0,917,0,917
,AUS,2010.0,8983,0,8983
,COL,1996.0,283,0,283
,NOR,2010.0,1832,0,1832
ITA,,2004.0,4160,0,4160
KEN,,2007.0,77,0,77
EGY,,2011.0,515,0,515
,SVN,1995.0,684,0,684
,KWT,2000.0,130,0,130
ZAF,,2016.0,1172,0,1172
LTU,,2007.0,86,0,86
,CHE,2014.0,4849,0,4849
,JOR,2000.0,163,0,163
BFA,,2021.0,125,0,125
BFA,,2019.0,75,0,75
,KWT,2006.0,163,0,163
MAR,,2001.0,94,0,94
BLR,,2015.0,202,0,202
ETH,UGA,2005.0,1,0,1
ARM,,2023.0,297,0,297
,ARM,1994.0,355,0,355
ARM,,2024.0,544,0,544
UGA,,2020.0,184,0,184
EGY,,2021.0,2788,0,2788
,IDN,1997.0,226,0,226
IRN,,2013.0,1946,0,1946
CIV,,2012.0,57,0,57
,ZAF,2012.0,2760,0,2760
CZE,,2004.0,519,0,519
IDN,,2013.0,140,0,140
FRA,,2026.0,1598,0,1598
,LVA,2000.0,71,0,71
,EST,1994.0,567,0,567
,CHE,2008.0,3900,0,3900
MAC,,2025.0,1553,0,1553
,HRV,2006.0,1054,0,1054
,CHE,2015.0,4955,0,4955
,HRV,2010.0,1226,0,1226
CZE,,2015.0,1512,0,1512
,PNG,1997.0,30,0,30
ARG,,2000.0,279,0,279
CYP,,2021.0,246,0,246
,TUR,2011.0,7967,0,7967
,DNK,2007.0,2152,0,2152
IRL,,2020.0,1519,0,1519
BDI,,2000.0,2,0,2
TWN,,2004.0,1486,0,1486
GRC,,2004.0,562,0,562
DZA,,2020.0,1088,0,1088
BGD,,2019.0,394,0,394
,MAR,2000.0,522,0,522
,ALB,2000.0,30,0,30
TUR,,2002.0,437,0,437
LBY,,2013.0,37,0,37
DZA,,2007.0,52,0,52
UGA,GMB,2014.0,1,0,1
TZA,,2015.0,81,0,81
COL,,2017.0,800,0,800
,GEO,2006.0,169,0,169
EST,,2003.0,38,0,38
IDN,SGP,2003.0,1,0,1
BHR,,2008.0,22,0,22
,LTU,1996.0,257,0,257
,VNM,2010.0,716,0,716
VNM,,2018.0,411,0,411
NOR,LTU,2008.0,2,0,2
PAN,CAN,2006.0,1,0,1
,CZE,2009.0,2737,0,2737
PHL,LAO,2009.0,1,0,1
PAK,,2010.0,441,0,441
,PER,1998.0,128,0,128
PRI,,2016.0,87,0,87
NLD,BWA,2002.0,1,0,1
,UGA,1999.0,74,0,74
CUB,,2014.0,659,0,659
AUT,,2006.0,935,0,935
,SDN,2000.0,36,0,36
BGD,,2009.0,141,0,141
KAZ,,2011.0,43,0,43
,BRA,2018.0,23718,0,23718
QAT,,2023.0,645,0,645
MAR,,2015.0,390,0,390
MAR,,2014.0,374,0,374
USA,TLS,2012.0,1,0,1
,SAU,1997.0,476,0,476
,TUR,2009.0,7356,0,7356
PAK,BHR,2001.0,1,0,1
EGY,YEM,2006.0,3,0,3
CZE,,2001.0,394,0,394
MNP,,2007.0,1,0,1
,MAR,2006.0,540,0,540
,URY,1994.0,293,0,293
GAB,AGO,2014.0,1,0,1
THA,,2000.0,99,0,99
,CZE,2011.0,2641,0,2641
PYF,,2024.0,51,0,51
KWT,,2012.0,103,0,103
ARE,LBN,2007.0,1,0,1
,SYR,2003.0,43,0,43
SRB,,2016.0,656,0,656
FIN,TUR,2004.0,3,0,3
TUR,FIN,2006.0,5,0,5
IRN,,2003.0,77,0,77
,DZA,1997.0,248,0,248
MMR,,2025.0,339,0,339
MMR,,2009.0,6,0,6
OMN,,2024.0,760,0,760
CUB,,2015.0,624,0,624
,ISR,2005.0,2328,0,2328
,PER,1999.0,120,0,120
,CMR,2017.0,564,0,564
,MDA,1995.0,93,0,93
,MLT,2002.0,32,0,32
BGD,,2011.0,155,0,155
BLR,PRT,2015.0,3,0,3
,SVK,2012.0,1237,0,1237
COG,,2009.0,36,0,36
GBR,PSE,2004.0,2,0,2
AFG,,2019.0,18,0,18
FRA,MDA,2003.0,2,0,2
MWI,,2022.0,150,0,150
QAT,,2024.0,1317,0,1317
THA,,2006.0,275,0,275
,PSE,2003.0,25,0,25
,SVK,2005.0,734,0,734
GRC,,2001.0,365,0,365
,FIN,2011.0,2141,0,2141
ZMB,,2015.0,25,0,25
KEN,SOM,2020.0,1,0,1
JAM,,2024.0,179,0,179
,LUX,1996.0,39,0,39
MWI,LUX,2002.0,1,0,1
MDG,,2007.0,18,0,18
JOR,,2015.0,170,0,170
GBR,JOR,1997.0,2,0,2
MOZ,BRA,2010.0,1,0,1
MLI,,2020.0,76,0,76
,JPN,2017.0,22008,0,22008
,ISR,2012.0,2553,0,2553
ARG,NOR,2021.0,3,0,3
,BHR,1994.0,86,0,86
BHR,,2014.0,22,0,22
BFA,GAB,2009.0,1,0,1
SVK,GEO,2013.0,1,0,1
,OMN,2001.0,72,0,72
BFA,,2025.0,1035,0,1035
,JAM,1995.0,71,0,71
KHM,,2022.0,116,0,116
URY,,2013.0,95,0,95
GEO,,2008.0,80,0,80
GIN,,2025.0,167,0,167
,KHM,2003.0,41,0,41
ISL,,2013.0,55,0,55
,NGA,2006.0,1551,0,1551
,COL,2015.0,2821,0,2821
,LUX,2001.0,29,0,29
SDN,,2013.0,90,0,90
,ARG,2008.0,2675,0,2675
NLD,CYP,2023.0,3,0,3
,PRY,1994.0,29,0,29
MAR,SWE,2012.0,2,0,2
,QAT,1999.0,40,0,40
HUN,,2000.0,296,0,296
BOL,,2024.0,230,0,230
,MAR,2010.0,863,0,863
PRI,,2022.0,196,0,196
,ESP,2017.0,15100,0,15100
JAM,,2023.0,139,0,139
,PRI,2004.0,138,0,138
,EGY,2009.0,3270,0,3270
ETH,,2009.0,43,0,43
,ARE,2004.0,130,0,130
ETH,,2025.0,8200,0,8200
ETH,,2019.0,244,0,244
BOL,,2010.0,17,0,17
SVK,,2004.0,225,0,225
,SGP,2010.0,2165,0,2165
,AZE,1994.0,238,0,238
SVN,,2020.0,556,0,556
,AUT,2010.0,2555,0,2555
,SRB,2005.0,993,0,993
,ARG,2014.0,2817,0,2817
ZAF,,2026.0,170,0,170
TZA,,2014.0,75,0,75
CHL,,2002.0,189,0,189
,GRC,2017.0,2379,0,2379
BWA,SWE,2009.0,1,0,1
,CAF,1994.0,16,0,16
,JPN,2018.0,22416,0,22416
,MYS,2013.0,6073,0,6073
ISL,AUT,2011.0,1,0,1
,ESP,2016.0,14707,0,14707
CAN,,1999.0,1817,0,1817
BHR,,2015.0,37,0,37
KAZ,,2021.0,888,0,888
UZB,,2025.0,1460,0,1460
MOZ,ZAF,2003.0,2,0,2
JOR,,2014.0,161,0,161
,UGA,1998.0,82,0,82
ESP,AND,2001.0,2,0,2
ISR,NOR,2008.0,3,0,3
KEN,,2020.0,453,0,453
DEU,ARM,2023.0,3,0,3
GLP,MEX,2007.0,1,0,1
,BIH,2011.0,238,0,238
,AUT,2006.0,2332,0,2332
TGO,,2024.0,220,0,220
,ARM,2011.0,140,0,140
PRI,,2017.0,106,0,106
,KAZ,2015.0,1575,0,1575
MDA,,2007.0,23,0,23
CHE,TUN,2007.0,4,0,4
QAT,,2010.0,39,0,39
,KEN,2006.0,381,0,381
COG,NPL,2019.0,1,0,1
,ARE,2015.0,548,0,548
,LUX,2004.0,58,0,58
HKG,BRA,2005.0,2,0,2
TTO,,2024.0,198,0,198
,VEN,1995.0,716,0,716
ERI,,2009.0,11,0,11
CMR,,2019.0,236,0,236
VNM,,2016.0,243,0,243
CUB,,2008.0,322,0,322
BFA,ITA,2008.0,2,0,2
,ABW,2010.0,2,0,2
,EGY,2011.0,3305,0,3305
OMN,,2010.0,47,0,47
,EGY,2021.0,22,0,22
,NPL,2001.0,175,0,175
DNK,LKA,2013.0,1,0,1
,ARE,2008.0,186,0,186
,QAT,2007.0,69,0,69
,CIV,1996.0,96,0,96
,NER,2004.0,17,0,17
FIN,KOR,2012.0,3,0,3
LVA,,2012.0,50,0,50
ARM,,2000.0,48,0,48
,PRI,1996.0,130,0,130
IRN,EGY,2010.0,1,0,1
,MNE,2000.0,6,0,6
PAN,,2023.0,179,0,179
,GEO,2000.0,85,0,85
ZMB,,2008.0,11,0,11
SAU,,2026.0,657,0,657
TJK,,2023.0,70,0,70
BEL,UGA,2007.0,4,0,4
GEO,CHE,2019.0,3,0,3
NER,ZWE,2015.0,1,0,1
,PHL,2010.0,430,0,430
TWN,MWI,2006.0,1,0,1
,KAZ,2004.0,107,0,107
,ISL,2007.0,132,0,132
,NIC,2003.0,22,0,22
CYP,,2011.0,44,0,44
,AGO,2003.0,8,0,8
AFG,GBR,2007.0,3,0,3
,NZL,2010.0,1477,0,1477
LTU,IRL,2001.0,1,0,1
SAU,PSE,2001.0,1,0,1
ALB,,2024.0,311,0,311
,KAZ,2001.0,129,0,129
MWI,,2016.0,39,0,39
,FSM,2004.0,1,0,1
CHL,,2005.0,245,0,245
SRB,IND,1997.0,2,0,2
MEX,GRC,2020.0,2,0,2
,CRI,1994.0,183,0,183
LAO,,2016.0,16,0,16
VEN,,2000.0,98,0,98
BRA,,2000.0,719,0,719
GBR,VCT,2007.0,2,0,2
NLD,CUW,2020.0,17,0,17
HTI,,2012.0,10,0,10
SRB,WSM,2008.0,1,0,1
CIV,,2005.0,23,0,23
BOL,,2000.0,12,0,12
CUB,PER,2018.0,2,0,2
,LVA,2010.0,307,0,307
TUN,NLD,2013.0,1,0,1
NOR,,2003.0,454,0,454
ESP,TUN,2006.0,3,0,3
KAZ,,2009.0,54,0,54
MMR,,2011.0,4,0,4
SGP,,2001.0,322,0,322
BGD,NGA,2009.0,1,0,1
ZAF,BHR,2008.0,1,0,1
,COL,2014.0,2822,0,2822
,MEX,2015.0,5572,0,5572
,ARG,2015.0,2623,0,2623
,IDN,2012.0,2334,0,2334
,PRI,2015.0,137,0,137
,KAZ,2014.0,2022,0,2022
,IRL,2013.0,1756,0,1756
COG,,2021.0,96,0,96
,LTU,2015.0,508,0,508
PHL,ZAF,2017.0,1,0,1
,ECU,2011.0,168,0,168
,KOR,2017.0,17785,0,17785
SLE,,2025.0,244,0,244
,BRA,2017.0,23798,0,23798
,MMR,2015.0,111,0,111
,IRN,2020.0,7371,0,7371
CMR,,2021.0,333,0,333
ZWE,MWI,2021.0,2,0,2
,CIV,2015.0,151,0,151
,IRQ,2016.0,3718,0,3718
DEU,,2025.0,157857,0,157857
,AUT,2003.0,1977,0,1977
DEU,,2009.0,12539,0,12539
,USA,2000.0,72444,0,72444
,CAN,2002.0,9669,0,9669
,PHL,2003.0,215,0,215
ESP,,2022.0,19351,0,19351
,USA,2010.0,91504,0,91504
CHN,,2014.0,48283,0,48283
,DEU,2001.0,16241,0,16241
USA,,2012.0,54284,0,54284
,ESP,1998.0,9707,0,9707
,AUS,2003.0,6209,0,6209
AUS,,2014.0,4468,0,4468
,UKR,1998.0,1404,0,1404
ITA,,2025.0,140150,0,140150
NLD,,2024.0,21327,0,21327
CHN,,2008.0,21516,0,21516
GBR,,1999.0,3730,0,3730
,DEU,1996.0,22135,0,22135
,BEL,1995.0,3957,0,3957
TWN,,2019.0,6218,0,6218
,TWN,2005.0,6556,0,6556
ESP,,2018.0,10699,0,10699
JPN,,2025.0,154907,0,154907
,TWN,2002.0,5110,0,5110
CAN,,2022.0,17529,0,17529
AUT,,2013.0,1420,0,1420
JPN,,2011.0,19641,0,19641
,GBR,1996.0,22521,0,22521
GBR,,2007.0,9264,0,9264
ITA,,2009.0,5899,0,5899
,ITA,2003.0,11881,0,11881
ITA,,2021.0,14451,0,14451
ISR,,2010.0,1394,0,1394
,JPN,1999.0,23765,0,23765
JPN,,2009.0,18250,0,18250
,EGY,2014.0,4245,0,4245
,THA,2003.0,1472,0,1472
CAN,,2018.0,10565,0,10565
,GBR,2001.0,16392,0,16392
,TUN,2002.0,712,0,712
,NOR,2003.0,1543,0,1543
AUS,,2008.0,2997,0,2997
JPN,,2021.0,27725,0,27725
CRI,VEN,2008.0,2,0,2
MEX,,2010.0,1187,0,1187
GRC,,2025.0,20538,0,20538
,CAN,1997.0,8922,0,8922
MEX,,2023.0,10497,0,10497
BEL,,2012.0,1706,0,1706
FRA,,2007.0,6159,0,6159
,HRV,2003.0,818,0,818
TWN,,2009.0,2833,0,2833
MYS,,2008.0,202,0,202
DEU,,2011.0,12510,0,12510
,AUS,2013.0,10312,0,10312
SGP,,2025.0,14442,0,14442
,USA,2006.0,78824,0,78824
,IND,2002.0,10286,0,10286
,ESP,1999.0,9452,0,9452
NLD,,2023.0,12631,0,12631
,GBR,2004.0,18156,0,18156
DEU,,2021.0,26308,0,26308
,CHN,1994.0,27998,0,27998
,POL,2000.0,4019,0,4019
GBR,,2020.0,20798,0,20798
DEU,,2019.0,22443,0,22443
,CHL,2000.0,886,0,886
,BRA,1999.0,6730,0,6730
,CHN,2009.0,101328,0,101328
,TUR,2001.0,5028,0,5028
TWN,,2025.0,38336,0,38336
,NZL,2003.0,1178,0,1178
,JPN,1998.0,25858,0,25858
CAN,,2016.0,9132,0,9132
,DEU,2004.0,19122,0,19122
GRC,,2021.0,2606,0,2606
IRN,,2024.0,30991,0,30991
ISL,,2023.0,352,0,352
CAN,,2017.0,10179,0,10179
MAR,,2021.0,1095,0,1095
GRC,,2009.0,1166,0,1166
IND,,2012.0,6882,0,6882
,BRA,1998.0,6246,0,6246
,VEN,2002.0,483,0,483
,KOR,1998.0,6225,0,6225
,IND,1997.0,8306,0,8306
CZE,,2025.0,20996,0,20996
,CZE,2001.0,1638,0,1638
NOR,,2024.0,7844,0,7844
,ROU,2001.0,841,0,841
,RUS,1995.0,16595,0,16595
IND,,2005.0,3231,0,3231
SWE,,2007.0,1738,0,1738
GRC,,2011.0,1498,0,1498
,ISR,1995.0,4032,0,4032
NOR,,2006.0,474,0,474
USA,,2002.0,34540,0,34540
,IND,2005.0,14390,0,14390
IRN,,2023.0,17973,0,17973
LTU,,2018.0,435,0,435
,FIN,1996.0,2342,0,2342
MLT,,2024.0,313,0,313
,KWT,2003.0,147,0,147
ARM,,2013.0,92,0,92
,LBN,2002.0,166,0,166
SVK,,2025.0,7324,0,7324
SVK,,2009.0,327,0,327
,KOR,1999.0,6587,0,6587
,JOR,2003.0,222,0,222
DNK,,2015.0,1411,0,1411
,TWN,1997.0,3603,0,3603
DZA,,2022.0,1976,0,1976
,TUN,2005.0,1050,0,1050
SGP,,2019.0,1781,0,1781
TWN,,2011.0,3720,0,3720
,CHN,2011.0,139161,0,139161
,KOR,2007.0,12769,0,12769
CHN,,2015.0,56504,0,56504
,SGP,2003.0,1398,0,1398
,FRA,2016.0,14067,0,14067
,PAK,2002.0,758,0,758
,EGY,2001.0,1014,0,1014
,CHE,2009.0,4210,0,4210
GRC,,2019.0,1903,0,1903
CZE,,2009.0,897,0,897
,HUN,2002.0,1186,0,1186
ESP,,2017.0,9355,0,9355
JPN,,2019.0,23507,0,23507
FRA,,2020.0,15654,0,15654
,TUN,2012.0,1348,0,1348
,FRA,2018.0,13341,0,13341
RUS,,2012.0,4067,0,4067
,SRB,1995.0,1100,0,1100
,ESP,2007.0,13110,0,13110
NLD,,2010.0,2756,0,2756
ESP,,2016.0,8322,0,8322
,TUR,2004.0,5872,0,5872
ARG,,2013.0,1100,0,1100
,NLD,1995.0,8473,0,8473
TUN,,2012.0,484,0,484
,JPN,2007.0,24017,0,24017
TZA,,2019.0,196,0,196
ISR,,2023.0,5387,0,5387
BRA,,2013.0,6721,0,6721
TWN,,2021.0,6594,0,6594
,CAN,2005.0,10756,0,10756
IRN,,2010.0,825,0,825
BGD,,2014.0,292,0,292
SAU,,2007.0,230,0,230
HKG,,2012.0,788,0,788
,IRL,2006.0,1514,0,1514
MYS,,2014.0,984,0,984
,MEX,2011.0,5443,0,5443
CZE,,2011.0,910,0,910
CHN,,2004.0,7555,0,7555
,GBR,2008.0,19177,0,19177
SGP,,2009.0,774,0,774
ZAF,,2020.0,2006,0,2006
TZA,,2025.0,2460,0,2460
ITA,,2011.0,6731,0,6731
,BGR,2000.0,441,0,441
,NGA,2003.0,906,0,906
GEO,,2009.0,73,0,73
,GEO,2003.0,215,0,215
COG,,2008.0,24,0,24
CMR,,2008.0,50,0,50
NOR,,2010.0,706,0,706
DZA,,2016.0,340,0,340
ITA,,2019.0,11756,0,11756
,GRC,2007.0,2928,0,2928
,GRC,1999.0,1891,0,1891
,COG,2002.0,51,0,51
CMR,COG,2007.0,4,0,4
URY,,2024.0,1003,0,1003
,ARM,2004.0,128,0,128
,DEU,2015.0,24259,0,24259
FIN,,2020.0,2100,0,2100
MEX,,2024.0,17957,0,17957
,VIR,1996.0,5,0,5
PRY,,2024.0,202,0,202
AUS,,2015.0,5228,0,5228
,HKG,1995.0,1553,0,1553
,MEX,1994.0,5412,0,5412
,CZE,2004.0,2041,0,2041
MAR,,2025.0,11355,0,11355
,CRI,1996.0,88,0,88
CRI,,2011.0,54,0,54
MDA,,2018.0,50,0,50
,ARG,1994.0,5407,0,5407
ESP,,2026.0,2031,0,2031
,TWN,2012.0,6758,0,6758
SGP,,2011.0,826,0,826
,GRC,1998.0,1875,0,1875
IRL,,2017.0,1088,0,1088
,TUR,2008.0,7016,0,7016
CHN,,2001.0,5561,0,5561
AUS,GIN,2015.0,1,0,1
CHE,,2014.0,2803,0,2803
ISR,,2024.0,9345,0,9345
THA,,2013.0,872,0,872
,BWA,1997.0,52,0,52
,LBN,2012.0,414,0,414
BRA,,2003.0,1202,0,1202
,MAR,2003.0,464,0,464
,TUR,1996.0,3374,0,3374
,KHM,2000.0,20,0,20
,PAK,2012.0,3339,0,3339
USA,,2005.0,35835,0,35835
,EGY,2008.0,2738,0,2738
KEN,,2017.0,291,0,291
BEL,,2005.0,1176,0,1176
,CHE,1994.0,12291,0,12291
FIN,,2007.0,991,0,991
VNM,,2007.0,61,0,61
DNK,,2008.0,944,0,944
AUS,,2001.0,1640,0,1640
RUS,,2002.0,2959,0,2959
CHE,,2001.0,1214,0,1214
RUS,,2005.0,3719,0,3719
,UKR,1999.0,1494,0,1494
IND,,2002.0,2491,0,2491
LTU,,2022.0,737,0,737
LTU,,2016.0,358,0,358
IRL,,2016.0,1030,0,1030
,IRQ,1999.0,57,0,57
BLR,,2025.0,1649,0,1649
,POL,2010.0,6016,0,6016
CUB,,2011.0,474,0,474
CRI,,2025.0,1009,0,1009
BLR,,2009.0,179,0,179
CAN,,2026.0,1012,0,1012
ETH,,2014.0,98,0,98
IRQ,,2009.0,17,0,17
UZB,,2008.0,39,0,39
,MWI,2003.0,51,0,51
,FIN,2001.0,1790,0,1790
CHE,,2008.0,1975,0,1975
NGA,,2020.0,1222,0,1222
GHA,,2012.0,52,0,52
,KEN,2003.0,256,0,256
,MEX,2009.0,4367,0,4367
CHE,,2015.0,3105,0,3105
,PAK,2005.0,1562,0,1562
,DEU,2008.0,22283,0,22283
NLD,,2006.0,2035,0,2035
NOR,,2023.0,4550,0,4550
IDN,,2024.0,14780,0,14780
CUB,,2009.0,351,0,351
SRB,,2020.0,1104,0,1104
,LVA,2003.0,104,0,104
,ZAF,1995.0,1959,0,1959
,CHE,2011.0,4749,0,4749
HRV,,2013.0,589,0,589
SVK,,2021.0,1065,0,1065
JOR,,2025.0,5828,0,5828
THA,,2003.0,193,0,193
SVN,,2016.0,463,0,463
PHL,,2012.0,99,0,99
ZAF,,2007.0,474,0,474
DZA,,2017.0,445,0,445
,SVN,2002.0,484,0,484
,YEM,2002.0,22,0,22
TZA,,2009.0,56,0,56
,TUR,2015.0,7289,0,7289
LKA,,2023.0,738,0,738
IRL,,2022.0,2265,0,2265
PAK,,2013.0,824,0,824
,IRL,2000.0,856,0,856
,CAN,2012.0,12852,0,12852
ISL,,2010.0,51,0,51
UGA,,2017.0,98,0,98
,JAM,2002.0,62,0,62
IDN,,2023.0,7679,0,7679
,BRA,2007.0,17211,0,17211
SAU,IRL,2011.0,1,0,1
CYP,,2015.0,76,0,76
,IND,2012.0,33396,0,33396
,PRT,2000.0,1254,0,1254
,SWE,1995.0,6322,0,6322
HUN,,2013.0,760,0,760
FIN,SAU,2011.0,2,0,2
,KAZ,1994.0,259,0,259
,COL,1994.0,462,0,462
,MYS,2006.0,2209,0,2209
NPL,,2010.0,53,0,53
COL,,2020.0,1689,0,1689
TUR,IRN,2003.0,1,0,1
,EST,2008.0,330,0,330
FRA,,1999.0,2757,0,2757
,POL,2006.0,5001,0,5001
,MYS,2000.0,544,0,544
,HUN,1997.0,1316,0,1316
EST,,2024.0,1241,0,1241
,DEU,2014.0,24650,0,24650
,CZE,1996.0,1775,0,1775
,ROU,2008.0,2610,0,2610
MAR,,2009.0,209,0,209
GMB,GHA,2011.0,2,0,2
ISR,,2000.0,555,0,555
,SVK,1995.0,998,0,998
,TUN,1997.0,426,0,426
SGP,,2021.0,2135,0,2135
SWE,,2020.0,3853,0,3853
,TTO,1999.0,53,0,53
CZE,,2021.0,3045,0,3045
,UKR,2007.0,1278,0,1278
,VEN,2005.0,609,0,609
GEO,,2025.0,1171,0,1171
,FIN,2004.0,1973,0,1973
GHA,CHN,2008.0,1,0,1
,TZA,2001.0,92,0,92
DEU,SAU,2006.0,5,0,5
NOR,,2000.0,300,0,300
URY,,2023.0,612,0,612
,GBR,2014.0,23530,0,23530
COL,,2007.0,105,0,105
CZE,,2019.0,2262,0,2262
BHR,,2025.0,636,0,636
,EST,2001.0,209,0,209
,ARE,2019.0,902,0,902
BHR,,2011.0,33,0,33
JOR,,2011.0,107,0,107
POL,,2013.0,2293,0,2293
,HUN,2005.0,1392,0,1392
ASM,,2025.0,12,0,12
,VNM,2003.0,183,0,183
POL,,2003.0,966,0,966
IRQ,,2025.0,11269,0,11269
,URY,2004.0,159,0,159
,SAU,1995.0,743,0,743
SAU,,1999.0,120,0,120
UKR,,2012.0,621,0,621
,UZB,2001.0,105,0,105
EGY,IRN,2009.0,5,0,5
IRL,,2018.0,1269,0,1269
ROU,,2012.0,781,0,781
TUR,NPL,2014.0,2,0,2
,BLR,2016.0,352,0,352
BLR,,2021.0,408,0,408
,DNK,2017.0,2889,0,2889
,IDN,1995.0,285,0,285
ARG,,2003.0,478,0,478
,CUB,2002.0,584,0,584
,CMR,1998.0,72,0,72
MEX,,2000.0,291,0,291
NLD,,2000.0,1587,0,1587
,LTU,2011.0,516,0,516
,VEN,1997.0,502,0,502
,PAK,1997.0,515,0,515
IDN,SGP,2000.0,1,0,1
ZMB,,2025.0,857,0,857
,BGR,2006.0,520,0,520
AUT,KEN,2000.0,1,0,1
,ROU,1996.0,925,0,925
KEN,,2018.0,300,0,300
MEX,,2006.0,677,0,677
EGY,,2008.0,322,0,322
BHR,,2021.0,90,0,90
,PAN,1998.0,12,0,12
ISR,,2006.0,991,0,991
DNK,,2014.0,1216,0,1216
COG,,2015.0,56,0,56
,LTU,1994.0,495,0,495
,CHE,2019.0,4491,0,4491
RWA,LUX,2008.0,1,0,1
KOR,NGA,2012.0,1,0,1
,ZMB,1995.0,50,0,50
,URY,2001.0,154,0,154
,THA,2013.0,2599,0,2599
,FIN,2015.0,2032,0,2032
,MYS,2010.0,4852,0,4852
BRB,,2025.0,88,0,88
,MDA,2002.0,52,0,52
MDA,,2017.0,38,0,38
VEN,,2013.0,431,0,431
BLR,,2011.0,196,0,196
KEN,KNA,2020.0,1,0,1
,CHN,2019.0,274619,0,274619
NGA,,2007.0,155,0,155
PAK,MEX,2012.0,1,0,1
,NOR,2013.0,2053,0,2053
,SLV,1998.0,7,0,7
,EST,1996.0,206,0,206
,ARG,2011.0,2736,0,2736
EST,ITA,2004.0,1,0,1
HKG,,2002.0,402,0,402
,ROU,2004.0,1092,0,1092
,FIN,2008.0,2057,0,2057
,TZA,1996.0,105,0,105
CRI,,2009.0,32,0,32
MKD,,2012.0,36,0,36
AZE,IND,2020.0,1,0,1
LKA,,2024.0,1404,0,1404
BGD,,2015.0,360,0,360
,URY,1996.0,124,0,124
ETH,,2015.0,101,0,101
BRA,MAC,2004.0,2,0,2
,ZWE,1998.0,84,0,84
,GBR,2015.0,22046,0,22046
IND,CHL,2005.0,1,0,1
LKA,,2010.0,59,0,59
,PRI,2009.0,165,0,165
HUN,EGY,1998.0,6,0,6
HKG,,2005.0,473,0,473
BWA,UGA,2017.0,1,0,1
AUS,,2004.0,2267,0,2267
ARE,,2002.0,23,0,23
,MNE,2003.0,19,0,19
SDN,,2023.0,300,0,300
,PRI,2011.0,136,0,136
,EGY,1996.0,1178,0,1178
NPL,DNK,2007.0,1,0,1
NPL,,2024.0,1762,0,1762
,LBN,1997.0,137,0,137
,ARG,2009.0,2624,0,2624
ISR,IRN,2013.0,2,0,2
PAK,,2003.0,175,0,175
,MNP,2001.0,1,0,1
EGY,,2015.0,1052,0,1052
EGY,ETH,2007.0,3,0,3
AGO,,2018.0,16,0,16
JOR,,2021.0,376,0,376
UZB,,2004.0,72,0,72
EST,,2023.0,695,0,695
,CUB,1997.0,730,0,730
AUT,,2003.0,733,0,733
KEN,,2016.0,244,0,244
,PYF,2000.0,11,0,11
,AUT,2013.0,2786,0,2786
,ARM,2001.0,112,0,112
NLD,PHL,2015.0,5,0,5
,EST,2004.0,284,0,284
ZAF,NOR,2006.0,4,0,4
,SLB,2003.0,2,0,2
,MLI,2002.0,37,0,37
MLI,,2022.0,98,0,98
MLI,,2016.0,29,0,29
LTU,,2026.0,126,0,126
DNK,,2004.0,733,0,733
EST,,2010.0,94,0,94
,AZE,2001.0,106,0,106
BLR,,2019.0,247,0,247
,DZA,1995.0,270,0,270
SWE,SDN,2006.0,2,0,2
CAN,BWA,2006.0,3,0,3
BEL,SUR,2017.0,3,0,3
CHE,,2004.0,1555,0,1555
,BGR,2010.0,605,0,605
TZA,,2021.0,266,0,266
,BWA,2002.0,43,0,43
,ITA,2013.0,14536,0,14536
,CRI,2001.0,62,0,62
,BOL,2003.0,46,0,46
,IRN,2018.0,13262,0,13262
SVK,,2011.0,371,0,371
,SVN,2005.0,601,0,601
MYS,,2015.0,1277,0,1277
EST,,2000.0,23,0,23
,SDN,2003.0,50,0,50
SDN,,2010.0,37,0,37
AZE,,2012.0,88,0,88
,LBN,2005.0,218,0,218
TTO,,2013.0,38,0,38
TUR,KOR,2007.0,2,0,2
UGA,,2022.0,363,0,363
,ECU,2001.0,75,0,75
CHN,TUR,2006.0,1,0,1
BEL,TWN,2007.0,3,0,3
GBR,ARM,2004.0,2,0,2
,LIE,1997.0,3,0,3
GEO,,2019.0,226,0,226
JAM,,2013.0,27,0,27
,NCL,1995.0,19,0,19
KEN,COL,2018.0,4,0,4
BFA,,2008.0,17,0,17
CUB,,2025.0,1993,0,1993
IRL,,2026.0,186,0,186
,BHR,2001.0,43,0,43
NGA,ROU,2020.0,1,0,1
ARG,VEN,2005.0,3,0,3
,PHL,2013.0,664,0,664
BWA,,2024.0,320,0,320
,FIN,2014.0,2068,0,2068
,IRN,2016.0,12493,0,12493
VNM,,2020.0,694,0,694
PER,,2012.0,93,0,93
FRA,SYR,1998.0,3,0,3
,SVN,2012.0,699,0,699
LUX,,2022.0,182,0,182
EGY,,2014.0,886,0,886
PYF,,2013.0,4,0,4
CUB,,2021.0,670,0,670
,BRA,2020.0,9696,0,9696
CYP,,2008.0,24,0,24
,PRT,2006.0,2208,0,2208
,NPL,2009.0,257,0,257
,CZE,2008.0,2460,0,2460
GRC,QAT,2016.0,9,0,9
,KOR,2020.0,11265,0,11265
UKR,EST,2011.0,1,0,1
DZA,,2018.0,717,0,717
,CRI,2004.0,76,0,76
CYP,,2014.0,64,0,64
ZAF,,1999.0,185,0,185
,YEM,1997.0,14,0,14
COM,,2024.0,9,0,9
LTU,,2017.0,428,0,428
ISL,,2024.0,595,0,595
SAU,IRN,2003.0,1,0,1
MDG,,2016.0,61,0,61
,MOZ,1999.0,27,0,27
,KAZ,2011.0,1263,0,1263
BEL,,2002.0,1011,0,1011
,MDG,2003.0,44,0,44
,EGY,2004.0,1436,0,1436
UGA,,2018.0,143,0,143
MAR,,2011.0,223,0,223
PRT,LTU,2015.0,1,0,1
URY,,2000.0,25,0,25
,HUN,2012.0,1732,0,1732
CMR,,2014.0,104,0,104
UKR,,2002.0,545,0,545
,ETH,2002.0,85,0,85
SVN,,2022.0,882,0,882
SVK,,2019.0,839,0,839
,ARE,1994.0,246,0,246
,GUY,2003.0,5,0,5
,TZA,2004.0,179,0,179
IRQ,,2011.0,29,0,29
GRC,CRI,2007.0,2,0,2
SYR,,2017.0,80,0,80
ETH,GBR,2001.0,4,0,4
OMN,,2013.0,70,0,70
,IRQ,1998.0,46,0,46
IRQ,,2021.0,1020,0,1020
JOR,,2009.0,89,0,89
ARE,,2012.0,111,0,111
BHR,,2019.0,49,0,49
KAZ,,2015.0,61,0,61
,MOZ,1998.0,23,0,23
COD,,2022.0,134,0,134
LBY,,2010.0,25,0,25
TCD,BFA,2005.0,1,0,1
GUY,,2012.0,5,0,5
,BHR,2004.0,49,0,49
BHR,,2009.0,19,0,19
DZA,,2026.0,162,0,162
,TGO,2003.0,11,0,11
MDG,,2022.0,132,0,132
ITA,TUN,1999.0,1,0,1
NPL,,2023.0,864,0,864
MWI,,2020.0,97,0,97
PRI,,2007.0,65,0,65
,SVN,1997.0,440,0,440
PRT,QAT,2023.0,1,0,1
,TUR,2014.0,8080,0,8080
MNE,,2023.0,105,0,105
ROU,,2002.0,210,0,210
SWE,,1999.0,547,0,547
,OMN,1994.0,144,0,144
SRB,,2007.0,167,0,167
ABW,,2018.0,4,0,4
LKA,DNK,2009.0,1,0,1
,LBY,1998.0,24,0,24
GBR,AZE,1998.0,1,0,1
,PRT,2010.0,3137,0,3137
BEL,ZMB,2010.0,1,0,1
,NPL,1994.0,61,0,61
,DNK,2016.0,2992,0,2992
,MTQ,1999.0,3,0,3
SRB,ROU,2007.0,4,0,4
IDN,,2010.0,95,0,95
SYR,,2016.0,70,0,70
MAR,,2019.0,805,0,805
CYP,RUS,2012.0,2,0,2
SAU,,2020.0,1332,0,1332
MMR,,2008.0,8,0,8
KAZ,,2008.0,41,0,41
ITA,JOR,1999.0,3,0,3
LKA,GHA,2012.0,3,0,3
PRT,AUT,2014.0,14,0,14
IND,NER,2014.0,4,0,4
MDA,,2016.0,39,0,39
UZB,,2015.0,73,0,73
NIC,,2025.0,62,0,62
SAU,UGA,2002.0,1,0,1
MWI,TWN,2008.0,1,0,1
KAZ,,2014.0,45,0,45
,UZB,1996.0,168,0,168
USA,HND,2004.0,5,0,5
KOR,DZA,2002.0,1,0,1
SVN,,2018.0,549,0,549
NIC,,2021.0,19,0,19
,VNM,2013.0,1023,0,1023
NIC,,2019.0,27,0,27
,PSE,2000.0,31,0,31
EGY,MYS,2009.0,5,0,5
,ESP,2020.0,8387,0,8387
FIN,,1999.0,265,0,265
GEO,CAN,2002.0,2,0,2
BOL,,2003.0,13,0,13
GTM,,1999.0,6,0,6
EGY,,2004.0,273,0,273
KEN,,2022.0,747,0,747
OMN,NGA,2005.0,2,0,2
,SGP,2013.0,2425,0,2425
PYF,GAB,2003.0,1,0,1
BEL,MYS,2000.0,1,0,1
SVN,,2017.0,487,0,487
WSM,,2015.0,1,0,1
CZE,IDN,2007.0,1,0,1
IDN,CZE,2010.0,2,0,2
,COG,1997.0,28,0,28
NIC,CUB,2000.0,1,0,1
,CIV,1994.0,127,0,127
,URY,2008.0,218,0,218
SRB,KEN,2011.0,1,0,1
VEN,BEL,2004.0,3,0,3
BEL,COL,2007.0,5,0,5
,CHL,2006.0,1683,0,1683
,FRA,2017.0,13201,0,13201
ESP,TTO,2021.0,3,0,3
BLR,GRC,2012.0,1,0,1
,ECU,2004.0,76,0,76
TUN,SUR,2013.0,1,0,1
YEM,,2010.0,11,0,11
KEN,NPL,2013.0,1,0,1
,TJK,1998.0,18,0,18
ZAF,PRT,2008.0,1,0,1
BEN,,2024.0,398,0,398
,NGA,2013.0,1650,0,1650
,ROU,2015.0,1831,0,1831
,EGY,2015.0,3633,0,3633
,TZA,2014.0,306,0,306
FRA,,2024.0,49786,0,49786
,TWN,1994.0,9308,0,9308
TWN,,2012.0,4076,0,4076
GBR,,2024.0,72025,0,72025
,USA,2007.0,83070,0,83070
USA,,2025.0,679262,0,679262
,USA,1999.0,69791,0,69791
ESP,,2013.0,6313,0,6313
,CHN,2002.0,49846,0,49846
CZE,,2012.0,1078,0,1078
,ESP,2000.0,9841,0,9841
IND,,2025.0,197020,0,197020
BEL,,2009.0,1515,0,1515
UKR,,2025.0,16268,0,16268
USA,,2011.0,52586,0,52586
USA,,2009.0,48398,0,48398
TUR,,2008.0,1458,0,1458
USA,,2019.0,90476,0,90476
,FRA,2003.0,12767,0,12767
,BRA,2000.0,7541,0,7541
,RUS,2004.0,6165,0,6165
RUS,,2025.0,85274,0,85274
USA,,2021.0,110305,0,110305
,ISR,2001.0,2141,0,2141
JPN,,2012.0,18460,0,18460
BRA,,2017.0,11212,0,11212
,CHN,1997.0,17065,0,17065
EST,,2020.0,339,0,339
,ITA,2017.0,15355,0,15355
ISR,,2007.0,1041,0,1041
GBR,,2010.0,10888,0,10888
,JPN,2000.0,23460,0,23460
,RUS,1996.0,12262,0,12262
TUN,,2025.0,8013,0,8013
,HKG,2001.0,1334,0,1334
DEU,,2012.0,12588,0,12588
,USA,1998.0,74507,0,74507
FRA,,2010.0,7661,0,7661
HUN,,2016.0,1001,0,1001
,RUS,2001.0,6247,0,6247
VEN,,2022.0,570,0,570
,CHN,2005.0,72452,0,72452
,PRT,1998.0,1246,0,1246
,GBR,1995.0,31133,0,31133
CAN,,2013.0,7062,0,7062
,DNK,2003.0,1653,0,1653
BRA,,2016.0,9725,0,9725
HKG,,2019.0,1262,0,1262
,NLD,2001.0,4343,0,4343
,MEX,1997.0,2399,0,2399
,IND,1994.0,23263,0,23263
THA,,2022.0,3184,0,3184
ROU,,2021.0,2046,0,2046
,CAN,1994.0,35661,0,35661
,TUN,2009.0,1212,0,1212
,ARG,2002.0,1856,0,1856
KOR,,2014.0,7885,0,7885
HKG,,2011.0,951,0,951
GBR,,2023.0,42556,0,42556
RUS,,2009.0,3710,0,3710
FIN,,2024.0,7516,0,7516
,BRA,2010.0,20773,0,20773
,CHL,2007.0,1708,0,1708
,IRN,2003.0,3514,0,3514
IND,,2019.0,18775,0,18775
,PRT,1999.0,1230,0,1230
HKG,,2025.0,14731,0,14731
,CAN,2011.0,12763,0,12763
BRA,,2018.0,12529,0,12529
BRA,,2022.0,29494,0,29494
RUS,,2019.0,9854,0,9854
BEL,,2025.0,27187,0,27187
,KOR,2000.0,7073,0,7073
RUS,,2011.0,3998,0,3998
NGA,,2010.0,328,0,328
,BEL,2001.0,2504,0,2504
IND,,2009.0,4843,0,4843
BEL,,2019.0,3121,0,3121
ZAF,,2010.0,700,0,700
,ESP,2010.0,14839,0,14839
,CHE,2002.0,3308,0,3308
,SVK,1996.0,794,0,794
ROU,,2025.0,15723,0,15723
,JPN,2006.0,23342,0,23342
FRA,,2023.0,30452,0,30452
THA,,2017.0,1194,0,1194
,ROU,1995.0,1387,0,1387
IND,,2021.0,26162,0,26162
BEL,,2021.0,3857,0,3857
,BEL,1996.0,3070,0,3070
,TUR,1995.0,4284,0,4284
,POL,1999.0,3724,0,3724
IND,,2011.0,5662,0,5662
UKR,,2019.0,1458,0,1458
UKR,,2021.0,2670,0,2670
FIN,,2023.0,4200,0,4200
,ARM,1995.0,229,0,229
ARM,,2026.0,11,0,11
,ZAF,2004.0,1486,0,1486
,SWE,2001.0,3190,0,3190
AUT,,2022.0,3708,0,3708
POL,,2017.0,3699,0,3699
RUS,,2021.0,16266,0,16266
,DZA,2015.0,1656,0,1656
SGP,,2012.0,889,0,889
POL,,2018.0,4220,0,4220
KOR,,2008.0,4041,0,4041
KOR,,2015.0,9088,0,9088
TUN,,2011.0,380,0,380
,CHE,2005.0,3388,0,3388
,NPL,2002.0,144,0,144
,DEU,1995.0,30640,0,30640
SRB,,2024.0,4540,0,4540
THA,,2016.0,1087,0,1087
HUN,,2022.0,2152,0,2152
NGA,,2024.0,7389,0,7389
,RUS,2015.0,17265,0,17265
ZAF,,2024.0,8399,0,8399
GRC,,2012.0,1480,0,1480
HKG,,2009.0,806,0,806
,ISR,2004.0,2402,0,2402
TUR,,2014.0,2939,0,2939
FRA,,2006.0,5945,0,5945
,CHL,1999.0,708,0,708
NLD,,2007.0,2280,0,2280
NOR,,2007.0,537,0,537
,IRL,1999.0,859,0,859
NLD,,2020.0,6245,0,6245
,NLD,2004.0,5044,0,5044
TUR,,2015.0,3217,0,3217
IRN,,2007.0,232,0,232
,KOR,2006.0,11913,0,11913
,BRA,2006.0,15982,0,15982
,JPN,2010.0,23834,0,23834
,BGD,2003.0,332,0,332
,ISR,1996.0,2638,0,2638
POL,,2022.0,7809,0,7809
,ESP,2006.0,12319,0,12319
SWE,,2010.0,2079,0,2079
ITA,,2012.0,6650,0,6650
,BEL,2008.0,3170,0,3170
UKR,,2009.0,552,0,552
LAO,,2010.0,13,0,13
,CHN,2012.0,151117,0,151117
,PER,2003.0,216,0,216
SWE,,2024.0,13550,0,13550
JPN,,2005.0,15901,0,15901
,ZAF,1996.0,1561,0,1561
,LTU,2005.0,517,0,517
THA,,2018.0,1411,0,1411
TUN,,2019.0,1070,0,1070
BEL,,2011.0,1736,0,1736
,MEX,2002.0,2680,0,2680
ARG,,2018.0,1870,0,1870
MEX,,2007.0,793,0,793
,NLD,1996.0,6115,0,6115
ARG,ZAF,2015.0,1,0,1
,SVN,1994.0,1207,0,1207
,HKG,1996.0,1288,0,1288
HKG,,2021.0,1552,0,1552
,TWN,2011.0,7239,0,7239
,CAN,2009.0,11940,0,11940
SVK,,2012.0,404,0,404
,DZA,2001.0,382,0,382
AZE,,2021.0,307,0,307
,KAZ,2002.0,86,0,86
,ISR,2008.0,2373,0,2373
ARM,,2017.0,94,0,94
ARG,,2022.0,4085,0,4085
,SRB,2008.0,1604,0,1604
,CHE,1997.0,3055,0,3055
ISR,,2020.0,2447,0,2447
,SRB,2001.0,532,0,532
GBR,,2000.0,5940,0,5940
HUN,,2026.0,154,0,154
AUT,,2017.0,1959,0,1959
,BGR,1998.0,537,0,537
,MDA,2009.0,68,0,68
DEU,,2005.0,9583,0,9583
GBR,,2006.0,8726,0,8726
JPN,,2002.0,14977,0,14977
COL,,2024.0,7660,0,7660
,IRL,1998.0,834,0,834
,HKG,2004.0,1386,0,1386
VEN,,2016.0,526,0,526
AZE,,2025.0,1116,0,1116
THA,KOR,2007.0,3,0,3
BWA,,2007.0,13,0,13
,CRI,1995.0,124,0,124
,PRI,2002.0,110,0,110
SWE,,2023.0,7758,0,7758
ARG,,2016.0,1405,0,1405
VNM,,2023.0,3086,0,3086
,USA,2020.0,52707,0,52707
ZAF,,2000.0,277,0,277
POL,,2026.0,789,0,789
ARE,,2011.0,98,0,98
PAK,,2017.0,1219,0,1219
,LKA,2003.0,136,0,136
,GRC,2010.0,2357,0,2357
,PYF,1999.0,6,0,6
SAU,,2024.0,8222,0,8222
CAF,CMR,2012.0,2,0,2
,IND,2009.0,27693,0,27693
USA,DOM,2006.0,5,0,5
,SWE,1996.0,4328,0,4328
NZL,,2015.0,879,0,879
IRQ,,2005.0,17,0,17
,NLD,2008.0,6011,0,6011
,MUS,2003.0,17,0,17
,BEL,2014.0,3649,0,3649
,FIN,1995.0,3264,0,3264
,HUN,2011.0,1637,0,1637
,GRC,2006.0,2705,0,2705
HRV,,2018.0,681,0,681
,PAK,2009.0,3097,0,3097
AUT,,2016.0,1781,0,1781
ARE,,2025.0,6035,0,6035
CHL,,2015.0,806,0,806
KOR,,2004.0,2474,0,2474
FIN,,2006.0,888,0,888
,ARG,1997.0,1955,0,1955
HUN,,2018.0,1237,0,1237
FRA,,2000.0,4429,0,4429
,CZE,1995.0,2477,0,2477
,BLR,2003.0,242,0,242
DEU,,2002.0,8832,0,8832
,DZA,1996.0,233,0,233
GHA,,2011.0,37,0,37
NZL,KEN,2015.0,2,0,2
FIN,,2010.0,1140,0,1140
PAK,,2022.0,4159,0,4159
,POL,1998.0,3718,0,3718
,ISR,2015.0,2744,0,2744
KOR,,2001.0,1649,0,1649
MNG,,2021.0,91,0,91
,GRC,2000.0,2021,0,2021
,KOR,2010.0,15139,0,15139
PRY,,2007.0,4,0,4
,ZAF,2001.0,1195,0,1195
ZAF,,2023.0,4717,0,4717
,SVK,2001.0,595,0,595
,LTU,2002.0,492,0,492
,NLD,2015.0,6474,0,6474
POL,,2016.0,3161,0,3161
NZL,,2008.0,551,0,551
BGR,,2015.0,383,0,383
QAT,,2017.0,102,0,102
IRN,,2020.0,7353,0,7353
,ISL,2003.0,99,0,99
,UGA,2003.0,118,0,118
,NOR,2017.0,2112,0,2112
,HUN,1994.0,4431,0,4431
,SRB,1996.0,778,0,778
SAU,,2023.0,4256,0,4256
,RUS,2008.0,7318,0,7318
SEN,,2011.0,31,0,31
,PAN,2006.0,34,0,34
NZL,,2014.0,879,0,879
SEN,,2025.0,939,0,939
,MYS,1999.0,427,0,427
NGA,,2023.0,4392,0,4392
SVN,,2013.0,312,0,312
,CMR,2000.0,108,0,108
,MAR,2016.0,1569,0,1569
SWE,,2000.0,884,0,884
,FRA,2013.0,15145,0,15145
ISR,,1999.0,367,0,367
SRB,,2023.0,2411,0,2411
,MEX,2012.0,5434,0,5434
,MEX,2005.0,3256,0,3256
,PRI,1997.0,117,0,117
BGR,,2008.0,230,0,230
,IND,2011.0,29948,0,29948
MEX,,2020.0,4172,0,4172
BRA,,2026.0,2588,0,2588
CZE,,2005.0,534,0,534
ARG,,2026.0,239,0,239
ARG,,2017.0,1691,0,1691
SWE,PHL,2009.0,1,0,1
,EST,1995.0,279,0,279
MNE,,2020.0,45,0,45
AUT,,2018.0,2188,0,2188
GHA,,2025.0,5195,0,5195
TWN,,2002.0,1305,0,1305
OMN,,2022.0,263,0,263
CHL,,2014.0,832,0,832
,BEL,2004.0,2871,0,2871
TTO,,2017.0,33,0,33
,MYS,1998.0,531,0,531
TUN,,2009.0,302,0,302
TUN,,2021.0,1396,0,1396
,IRN,2013.0,12203,0,12203
VEN,,2018.0,491,0,491
IRL,,2013.0,831,0,831
,UKR,2000.0,1260,0,1260
,RUS,2014.0,18631,0,18631
,LBN,1994.0,277,0,277
CAN,,2003.0,3610,0,3610
,SWE,2004.0,3419,0,3419
,COL,2002.0,540,0,540
TUR,BHR,2022.0,3,0,3
,POL,2007.0,5063,0,5063
ECU,,2008.0,14,0,14
KOR,IDN,2009.0,5,0,5
,DZA,2004.0,714,0,714
NOR,,2020.0,1898,0,1898
TUR,,2004.0,609,0,609
SWE,,2006.0,1611,0,1611
,SRB,2004.0,836,0,836
,CMR,2006.0,184,0,184
COL,,2023.0,4872,0,4872
PRT,,2014.0,935,0,935
,TZA,1995.0,145,0,145
CHL,,2008.0,402,0,402
,MDA,1994.0,188,0,188
,SAU,1996.0,581,0,581
SAU,,2000.0,179,0,179
VNM,,2024.0,5472,0,5472
,IRL,2007.0,1640,0,1640
TWN,,2005.0,1562,0,1562
KWT,,2014.0,132,0,132
GEO,FRA,2015.0,7,0,7
,EGY,1995.0,1529,0,1529
CIV,,2014.0,85,0,85
CIV,,2015.0,83,0,83
,ITA,2018.0,17944,0,17944
AUT,,2026.0,288,0,288
,ITA,2016.0,14274,0,14274
,SWE,2008.0,3354,0,3354
PAK,,2018.0,1427,0,1427
PHL,,2025.0,3782,0,3782
,BGR,1999.0,489,0,489
VEN,DOM,2019.0,2,0,2
TWN,ISR,2006.0,3,0,3
,VEN,1994.0,1033,0,1033
HUN,,2017.0,1111,0,1111
USA,PLW,2002.0,5,0,5
PRT,,2015.0,1230,0,1230
,IDN,1996.0,243,0,243
BGR,,2001.0,215,0,215
SGP,,2005.0,445,0,445
,QAT,2003.0,61,0,61
TTO,,2022.0,104,0,104
FIN,,2000.0,426,0,426
PHL,,2009.0,71,0,71
,SWE,2014.0,3759,0,3759
ROU,,2009.0,299,0,299
MOZ,,2009.0,15,0,15
IND,SDN,2009.0,3,0,3
RWA,DEU,2021.0,3,0,3
URY,,2007.0,40,0,40
COL,,2006.0,105,0,105
IDN,,2020.0,1166,0,1166
PER,,2025.0,5314,0,5314
,GMB,2000.0,12,0,12
BLR,ITA,2004.0,2,0,2
,DNK,2013.0,3143,0,3143
,TUN,1994.0,783,0,783
CUB,,2005.0,198,0,198
,KAZ,1997.0,118,0,118
,PAK,2011.0,3358,0,3358
ARE,,2021.0,458,0,458
MWI,,2006.0,11,0,11
,NPL,2005.0,174,0,174
NPL,,2020.0,221,0,221
ISL,,2007.0,53,0,53
COL,,2010.0,248,0,248
ITA,,2002.0,3741,0,3741
BIH,,2008.0,41,0,41
PRT,,2004.0,283,0,283
PRT,,2008.0,445,0,445
QAT,,2018.0,160,0,160
HRV,,2016.0,629,0,629
MEX,ZAF,2013.0,3,0,3
,NLD,2014.0,6554,0,6554
LTU,,2013.0,290,0,290
,ARG,2005.0,2140,0,2140
JAM,,2018.0,56,0,56
CAN,KWT,2007.0,8,0,8
PHL,,2019.0,348,0,348
HRV,UKR,2018.0,1,0,1
PAK,,2016.0,1216,0,1216
TJK,,2018.0,21,0,21
CHL,,2001.0,151,0,151
DZA,,2013.0,192,0,192
DEU,LVA,2008.0,4,0,4
MAC,AUT,2007.0,1,0,1
KEN,,2013.0,168,0,168
TJK,,2022.0,66,0,66
PHL,MEX,2010.0,1,0,1
UKR,,2011.0,659,0,659
,MLT,1996.0,35,0,35
ROU,,2011.0,639,0,639
,IDN,2001.0,196,0,196
HRV,,2017.0,682,0,682
,BEN,2003.0,34,0,34
BLR,DNK,2011.0,1,0,1
,BEL,2015.0,3533,0,3533
NGA,CMR,2003.0,3,0,3
LBN,,2015.0,128,0,128
,HKG,2008.0,1514,0,1514
PRI,,2024.0,440,0,440
,PSE,1999.0,20,0,20
ARE,,2009.0,71,0,71
ARE,,2019.0,271,0,271
SVK,,2005.0,259,0,259
LKA,,2007.0,35,0,35
,IND,2019.0,33122,0,33122
CUB,,2012.0,467,0,467
ALB,,2022.0,101,0,101
PYF,,2017.0,11,0,11
ETH,EGY,2006.0,1,0,1
CHN,LAO,2008.0,1,0,1
ESP,,2003.0,2983,0,2983
ZAF,,2006.0,456,0,456
KGZ,,2008.0,5,0,5
,MLI,2009.0,63,0,63
,CIV,2002.0,111,0,111
QAT,,2022.0,345,0,345
SAU,,2006.0,194,0,194
,ARE,1997.0,64,0,64
,MMR,2002.0,24,0,24
ARM,,2022.0,189,0,189
HRV,,2022.0,1357,0,1357
ARM,,2016.0,98,0,98
MAR,,2012.0,260,0,260
BEL,SUR,2013.0,1,0,1
ZWE,,2008.0,29,0,29
MKD,,2025.0,730,0,730
BWA,,2020.0,75,0,75
ALB,DEU,2015.0,2,0,2
SEN,,2021.0,186,0,186
FJI,SAU,2016.0,1,0,1
ITA,,2005.0,4092,0,4092
ZWE,,2015.0,37,0,37
DEU,AFG,2015.0,2,0,2
,SAU,2001.0,394,0,394
LBN,,2008.0,74,0,74
EST,,2007.0,50,0,50
ROU,,2019.0,1393,0,1393
,SVK,2008.0,900,0,900
,GTM,2003.0,20,0,20
MNP,USA,2009.0,2,0,2
,CHL,1998.0,749,0,749
,AUS,2017.0,10660,0,10660
ECU,,2015.0,45,0,45
,PNG,1996.0,44,0,44
BOL,,2016.0,34,0,34
,NZL,2016.0,1581,0,1581
SYR,ARE,2008.0,2,0,2
LIE,DEU,2001.0,5,0,5
JAM,,2022.0,62,0,62
MOZ,,2025.0,482,0,482
NZL,,2001.0,338,0,338
GAB,,2011.0,17,0,17
PHL,,2011.0,112,0,112
FLK,CHL,2008.0,1,0,1
VNM,,2010.0,111,0,111
,ZWE,2000.0,71,0,71
PER,,2011.0,92,0,92
FRA,LKA,2007.0,1,0,1
JOR,DZA,2019.0,2,0,2
,LUX,2002.0,41,0,41
PAK,,2026.0,1400,0,1400
,HRV,2016.0,1044,0,1044
,LBY,2006.0,41,0,41
,DZA,2008.0,941,0,941
GAB,,2025.0,258,0,258
,SVK,2004.0,624,0,624
,PAK,1994.0,905,0,905
SAU,,2010.0,237,0,237
ZWE,,2001.0,25,0,25
,COM,2003.0,1,0,1
PRI,,2023.0,312,0,312
SRB,,2010.0,253,0,253
,ARG,2012.0,2812,0,2812
ISL,,2020.0,136,0,136
,ETH,1994.0,191,0,191
QAT,,2016.0,77,0,77
,URY,1995.0,210,0,210
,NGA,2018.0,3357,0,3357
JPN,COG,2012.0,1,0,1
,PRT,2020.0,2027,0,2027
CZE,,2002.0,430,0,430
ETH,CAN,2008.0,3,0,3
NLD,,1999.0,1024,0,1024
GUM,,2023.0,13,0,13
,MYS,2007.0,3231,0,3231
,LTU,1997.0,276,0,276
,SAU,2008.0,909,0,909
BEL,ETH,2008.0,2,0,2
BLR,,2012.0,183,0,183
,PRT,2007.0,2435,0,2435
AND,,2023.0,10,0,10
RUS,SYR,2006.0,1,0,1
THA,,2026.0,517,0,517
CHL,AUT,2009.0,5,0,5
,COD,2003.0,8,0,8
NLD,KHM,2007.0,1,0,1
,NPL,1997.0,72,0,72
,CIV,2005.0,145,0,145
UGA,,2013.0,87,0,87
,KGZ,2002.0,23,0,23
OMN,ITA,2022.0,2,0,2
SEN,NER,2009.0,1,0,1
LBY,LBN,2014.0,8,0,8
CRI,NOR,2009.0,1,0,1
MNG,,2019.0,57,0,57
,TWN,2009.0,7602,0,7602
,PRI,2005.0,142,0,142
,KEN,2018.0,740,0,740
MWI,DNK,2003.0,1,0,1
MKD,,2021.0,239,0,239
,AUS,2016.0,10510,0,10510
CAN,MLT,2012.0,1,0,1
,ERI,2001.0,11,0,11
TUR,KGZ,2014.0,4,0,4
,IDN,2004.0,383,0,383
LSO,,2009.0,3,0,3
PRT,,2001.0,211,0,211
,ZAF,2008.0,1862,0,1862
,SYR,1998.0,47,0,47
PER,,2021.0,558,0,558
,COL,2012.0,2080,0,2080
BMU,NOR,2016.0,1,0,1
,TUN,2011.0,1245,0,1245
PRI,,2010.0,95,0,95
,CUB,2019.0,492,0,492
,MKD,2004.0,109,0,109
ABW,BEL,2015.0,1,0,1
BIH,,2015.0,77,0,77
,UKR,2010.0,1658,0,1658
AUT,PSE,2010.0,2,0,2
USA,GUY,2021.0,2,0,2
CHL,CHE,2006.0,4,0,4
,PSE,1998.0,14,0,14
LKA,,2020.0,243,0,243
JOR,YEM,2003.0,1,0,1
CIV,,2001.0,16,0,16
RUS,MNE,2008.0,1,0,1
PRI,CAN,2003.0,2,0,2
TUR,,2001.0,435,0,435
AUS,BLR,2018.0,1,0,1
,BGR,2007.0,625,0,625
HUN,AUS,2010.0,3,0,3
BEL,TZA,2010.0,8,0,8
ESP,GTM,1998.0,1,0,1
,SWE,2015.0,3636,0,3636
SWE,SGP,2004.0,6,0,6
,ZMB,2004.0,43,0,43
ZMB,THA,2013.0,1,0,1
GBR,MMR,2003.0,2,0,2
,SAU,2004.0,413,0,413
,GHA,2004.0,118,0,118
LTU,JPN,2009.0,3,0,3
,GHA,2001.0,83,0,83
GHA,LKA,2011.0,3,0,3
NLD,PRI,2013.0,1,0,1
,POL,2020.0,2961,0,2961
BEN,,2020.0,82,0,82
DZA,GBR,2003.0,2,0,2
DZA,SVN,2016.0,1,0,1
BGR,,2014.0,303,0,303
JOR,,2012.0,142,0,142
MDA,,2013.0,35,0,35
,MAC,2002.0,21,0,21
MEX,NZL,2006.0,2,0,2
CHN,KEN,2010.0,5,0,5
PAK,NLD,2001.0,2,0,2
,DZA,2014.0,1818,0,1818
,CAN,2019.0,12155,0,12155
,CYP,2006.0,105,0,105
NER,,2022.0,78,0,78
CRI,,2012.0,65,0,65
FRA,AFG,2006.0,1,0,1
MLT,,2007.0,8,0,8
MLT,,2020.0,56,0,56
MLI,NLD,2015.0,2,0,2
FRA,PNG,2008.0,1,0,1
GUF,GIN,2014.0,4,0,4
TZA,,2012.0,72,0,72
,SEN,1999.0,72,0,72
,CUB,1994.0,1059,0,1059
LBY,,2007.0,17,0,17
ARM,,2018.0,104,0,104
MWI,,2024.0,457,0,457
,NAM,1994.0,23,0,23
LSO,GBR,1999.0,1,0,1
,IDN,2015.0,5816,0,5816
,ERI,2004.0,23,0,23
SGP,,2002.0,346,0,346
FRA,NER,2004.0,9,0,9
MNG,,2025.0,569,0,569
GUY,GUF,2011.0,2,0,2
GUF,,2025.0,99,0,99
,CHE,2012.0,4727,0,4727
NER,,2018.0,29,0,29
KHM,GBR,2019.0,6,0,6
,SAU,2015.0,2542,0,2542
BOL,,2018.0,40,0,40
SRB,ARG,2007.0,2,0,2
LVA,,2015.0,129,0,129
,VEN,2009.0,476,0,476
,OMN,2002.0,71,0,71
,COG,2011.0,148,0,148
,HND,2003.0,11,0,11
KOR,ARM,2015.0,1,0,1
,TTO,2000.0,33,0,33
SWE,BLR,2006.0,2,0,2
,MLT,2004.0,30,0,30
JAM,,2016.0,47,0,47
GBR,SYR,2011.0,8,0,8
,ZAF,2014.0,2929,0,2929
,ZAF,2015.0,2865,0,2865
,IDN,2014.0,4322,0,4322
,AUT,2016.0,2777,0,2777
,SVK,2015.0,1060,0,1060
,COL,2005.0,959,0,959
,NGA,2016.0,2576,0,2576
,ISR,2014.0,2687,0,2687
,PAK,2019.0,5745,0,5745
,MAR,2017.0,1883,0,1883
,KWT,2017.0,224,0,224
,NGA,2017.0,2986,0,2986
,TUN,2019.0,1008,0,1008
,SVN,2011.0,796,0,796
,HKG,2015.0,2093,0,2093
,SVK,2014.0,1166,0,1166
,GHA,2014.0,643,0,643
,PNG,2015.0,41,0,41
,SAU,2014.0,2311,0,2311
,HKG,2014.0,1907,0,1907
,SRB,2014.0,1300,0,1300
,MLT,2015.0,106,0,106
,SRB,2015.0,1153,0,1153
MWI,,2023.0,229,0,229
,LVA,2016.0,279,0,279
,VNM,2016.0,2079,0,2079
,TWN,2019.0,6401,0,6401
,THA,2018.0,3524,0,3524
,AUS,2018.0,10491,0,10491
,NOR,2016.0,2102,0,2102
,ISL,2013.0,140,0,140
,ZMB,2015.0,142,0,142
,VNM,2017.0,3067,0,3067
,QAT,2013.0,336,0,336
GUM,,2024.0,23,0,23
,UKR,2006.0,1203,0,1203
,SGP,2018.0,2617,0,2617
AUT,,2014.0,1548,0,1548
,DEU,2003.0,19124,0,19124
KOR,,2022.0,18249,0,18249
,TUR,2003.0,5924,0,5924
,PRT,1994.0,2989,0,2989
,GBR,2003.0,17268,0,17268
IRN,,2025.0,68886,0,68886
DEU,,2024.0,68988,0,68988
,USA,1994.0,315458,0,315458
USA,,2020.0,98606,0,98606
TUR,,2022.0,8708,0,8708
,CZE,2003.0,1716,0,1716
,KOR,2002.0,8722,0,8722
GRC,,2024.0,8204,0,8204
SGP,,2010.0,832,0,832
,CHN,2010.0,116019,0,116019
,JPN,2002.0,23957,0,23957
JPN,,2010.0,18466,0,18466
,CHN,2006.0,79732,0,79732
JPN,,2024.0,68613,0,68613
,VEN,1998.0,554,0,554
,USA,2009.0,89545,0,89545
,JPN,1997.0,28160,0,28160
JPN,,2023.0,44693,0,44693
,EGY,2003.0,1158,0,1158
DEU,,2023.0,43098,0,43098
USA,,2007.0,41479,0,41479
BRA,,2015.0,8691,0,8691
AUT,,2008.0,1047,0,1047
ITA,,2010.0,6161,0,6161
ISR,,2025.0,22105,0,22105
,BRA,2002.0,8738,0,8738
,GRC,1997.0,1829,0,1829
ITA,,2024.0,46419,0,46419
,CHE,2000.0,3007,0,3007
,HUN,1998.0,1336,0,1336
CHN,,2003.0,7393,0,7393
RUS,,2007.0,3534,0,3534
,FIN,2003.0,1855,0,1855
NOR,,2025.0,19871,0,19871
BRA,,2008.0,2770,0,2770
HKG,,2007.0,679,0,679
,HUN,1999.0,1194,0,1194
HUN,,2015.0,973,0,973
,CRI,2003.0,90,0,90
,MEX,2000.0,2349,0,2349
IND,,2020.0,20804,0,20804
,GRC,2002.0,2372,0,2372
GBR,,2012.0,11266,0,11266
POL,,2015.0,2818,0,2818
,NZL,2001.0,1008,0,1008
,CAN,2007.0,11598,0,11598
,IRL,1994.0,2298,0,2298
PER,,2020.0,372,0,372
IND,,2007.0,3820,0,3820
NLD,,2025.0,54308,0,54308
MEX,,2025.0,34630,0,34630
DEU,,2010.0,12126,0,12126
ISR,,2011.0,1391,0,1391
PSE,,2022.0,169,0,169
LKA,,2025.0,2299,0,2299
IRN,,2011.0,963,0,963
KOR,,2016.0,9752,0,9752
,CHN,2000.0,26788,0,26788
CZE,,2024.0,9311,0,9311
,CAN,1999.0,8025,0,8025
AUS,,2013.0,4223,0,4223
,ITA,1996.0,13399,0,13399
ITA,,2023.0,28062,0,28062
MEX,,2011.0,1468,0,1468
GRC,,2010.0,1321,0,1321
IRQ,,2010.0,23,0,23
ISR,,2009.0,1308,0,1308
,ESP,1997.0,9892,0,9892
,NOR,1996.0,1694,0,1694
ISR,,2019.0,2117,0,2117
MEX,,2021.0,5300,0,5300
CHL,,2016.0,1018,0,1018
FRA,,2012.0,7720,0,7720
,BRA,1997.0,6072,0,6072
,POL,2009.0,5372,0,5372
BEL,,2007.0,1223,0,1223
,ITA,2001.0,11061,0,11061
,PHL,2001.0,199,0,199
HUN,,2008.0,622,0,622
,ITA,2004.0,12396,0,12396
,IND,1998.0,7831,0,7831
,ESP,2002.0,10145,0,10145
,PAK,2007.0,2255,0,2255
NLD,,2009.0,2694,0,2694
,NOR,2001.0,1236,0,1236
,JPN,2005.0,23098,0,23098
TWN,,2024.0,18386,0,18386
,CHL,2009.0,1831,0,1831
,CAN,1998.0,8412,0,8412
,TWN,1999.0,3850,0,3850
TWN,,2023.0,10702,0,10702
,ARM,2003.0,115,0,115
CHL,,2022.0,2990,0,2990
PAK,,2015.0,1039,0,1039
,UKR,2005.0,1097,0,1097
POL,,2008.0,1781,0,1781
,IND,1999.0,8197,0,8197
TUR,,2016.0,3569,0,3569
TUR,,2018.0,5868,0,5868
,KOR,2005.0,11190,0,11190
CHN,,2013.0,41082,0,41082
,COL,2000.0,396,0,396
,USA,2011.0,92452,0,92452
RUS,,2020.0,11940,0,11940
,DZA,2017.0,1567,0,1567
CZE,,2010.0,935,0,935
TWN,,2010.0,3227,0,3227
KOR,,2017.0,11432,0,11432
NLD,,2021.0,7163,0,7163
URY,,2021.0,266,0,266
,TWN,2007.0,7226,0,7226
,AUS,2004.0,6866,0,6866
PRT,,2018.0,1797,0,1797
TUR,KOR,2005.0,1,0,1
ISR,,2021.0,2853,0,2853
,TWN,1998.0,3570,0,3570
,SAU,2016.0,2997,0,2997
RUS,,1999.0,1471,0,1471
JPN,,2006.0,16184,0,16184
TWN,,2000.0,1038,0,1038
FRA,,2005.0,5753,0,5753
,SGP,2008.0,1833,0,1833
,AUT,2001.0,1867,0,1867
NOR,,2011.0,776,0,776
,ROU,2013.0,2168,0,2168
NOR,,2019.0,1691,0,1691
NLD,,2011.0,2929,0,2929
UKR,,2007.0,534,0,534
ITA,,2006.0,4470,0,4470
,IRN,1995.0,650,0,650
NZL,,2018.0,1178,0,1178
SWE,,2012.0,2086,0,2086
,LBN,1998.0,149,0,149
,FRA,1995.0,26124,0,26124
,ARG,2000.0,1899,0,1899
ARG,,2008.0,712,0,712
,KOR,1997.0,5793,0,5793
,AUS,2001.0,5558,0,5558
BRA,,2014.0,7824,0,7824
IDN,,2021.0,2491,0,2491
,TZA,2003.0,121,0,121
,HRV,2001.0,873,0,873
,AUS,1996.0,7290,0,7290
VEN,,2008.0,256,0,256
ZMB,,2023.0,170,0,170
,ESP,2005.0,11657,0,11657
,DEU,2013.0,24489,0,24489
,NLD,2016.0,6997,0,6997
,UKR,2002.0,1033,0,1033
NLD,,2019.0,5631,0,5631
MEX,,2009.0,1056,0,1056
CUB,,2024.0,1893,0,1893
CHL,,2017.0,1108,0,1108
CZE,,2023.0,5334,0,5334
THA,,2014.0,896,0,896
CHE,,2013.0,2645,0,2645
HKG,,2020.0,1488,0,1488
TUN,,2020.0,1205,0,1205
,PRT,2009.0,2964,0,2964
IDN,,2025.0,34599,0,34599
,THA,1996.0,918,0,918
,SGP,2004.0,1426,0,1426
CRI,,2006.0,46,0,46
,JOR,1996.0,192,0,192
DEU,,2006.0,9471,0,9471
NZL,,2022.0,2144,0,2144
,BGR,2011.0,613,0,613
,LTU,2000.0,541,0,541
SGP,,2024.0,6417,0,6417
,CAF,2003.0,11,0,11
CAF,,2012.0,5,0,5
,NOR,2008.0,1892,0,1892
,NOR,2004.0,1631,0,1631
,TUN,2007.0,1166,0,1166
,AZE,2003.0,122,0,122
IRN,,2021.0,9409,0,9409
,ITA,2008.0,12993,0,12993
,THA,2001.0,1110,0,1110
HUN,,2014.0,843,0,843
TUR,,2026.0,878,0,878
KOR,,2018.0,12265,0,12265
FIN,,2002.0,630,0,630
BGR,,2016.0,436,0,436
THA,,2008.0,405,0,405
,ROU,2003.0,976,0,976
,EST,2003.0,218,0,218
GBR,,2002.0,8362,0,8362
,BRA,2012.0,21014,0,21014
NZL,,2017.0,1083,0,1083
BEL,,1999.0,452,0,452
JPN,,2000.0,11211,0,11211
GRC,,2023.0,4685,0,4685
,ESP,2012.0,14590,0,14590
MEX,,2019.0,3476,0,3476
IRN,,2009.0,554,0,554
JOR,,2010.0,115,0,115
URY,,2025.0,1927,0,1927
CZE,,2006.0,605,0,605
LKA,,2009.0,51,0,51
PYF,,2008.0,3,0,3
,TUN,1998.0,472,0,472
AUS,,2003.0,2226,0,2226
,SAU,2017.0,3342,0,3342
IND,,1999.0,1287,0,1287
,JOR,2001.0,158,0,158
THA,,2015.0,991,0,991
,AUT,1996.0,1977,0,1977
,HRV,1996.0,885,0,885
JOR,,2006.0,50,0,50
JOR,,2024.0,2195,0,2195
FIN,,2012.0,1167,0,1167
,CUB,1998.0,715,0,715
TUR,,2017.0,4472,0,4472
USA,,1999.0,17733,0,17733
ARG,,2015.0,1347,0,1347
LVA,,2022.0,313,0,313
,UZB,2003.0,98,0,98
NPL,,2025.0,2972,0,2972
,SWE,2017.0,3326,0,3326
,ARG,2006.0,2288,0,2288
,BGR,1994.0,2153,0,2153
,NZL,1996.0,1411,0,1411
,VEN,1999.0,468,0,468
PRT,,2022.0,3726,0,3726
,POL,1994.0,11436,0,11436
GRC,,2000.0,316,0,316
GBR,,2005.0,8365,0,8365
ZAF,,2002.0,402,0,402
,MNG,1998.0,29,0,29
,DNK,1995.0,3198,0,3198
KWT,,2018.0,149,0,149
,ECU,2003.0,71,0,71
BGR,,2018.0,435,0,435
,RUS,2016.0,17854,0,17854
,BRA,2005.0,14795,0,14795
SVN,KOR,2013.0,1,0,1
NOR,,2021.0,2380,0,2380
,SGP,2001.0,1119,0,1119
,POL,2019.0,5800,0,5800
PRT,,2016.0,1372,0,1372
SGP,,2023.0,3773,0,3773
,PRI,2000.0,104,0,104
,CMR,2002.0,103,0,103
,KEN,2001.0,231,0,231
IRQ,,2023.0,3081,0,3081
,KAZ,2006.0,107,0,107
NGA,,2012.0,589,0,589
PER,,2007.0,41,0,41
PRT,,2017.0,1574,0,1574
LBY,ARE,2013.0,2,0,2
ITA,,2000.0,3361,0,3361
ISL,,2011.0,48,0,48
,ZWE,1997.0,110,0,110
,UKR,1997.0,1757,0,1757
BEL,,2020.0,3473,0,3473
,JPN,2012.0,23745,0,23745
ROU,,2007.0,296,0,296
SWE,,2002.0,1303,0,1303
MAR,,2024.0,4324,0,4324
URY,,2019.0,174,0,174
,IND,2007.0,19956,0,19956
UKR,,2020.0,1873,0,1873
PNG,SLB,2008.0,1,0,1
SLB,,2012.0,4,0,4
,THA,2004.0,1734,0,1734
EST,,2025.0,2711,0,2711
,SVK,2017.0,1040,0,1040
SVK,,2023.0,2013,0,2013
SGP,,2006.0,493,0,493
,GEO,2001.0,91,0,91
GEO,ZAF,2006.0,1,0,1
FRA,,2002.0,5740,0,5740
,SVN,1998.0,525,0,525
BRA,,2004.0,1328,0,1328
PAK,,2008.0,280,0,280
MAR,,2023.0,2205,0,2205
CHE,TCD,2003.0,5,0,5
TCD,CHE,2005.0,1,0,1
LBY,,2011.0,34,0,34
CZE,,2000.0,292,0,292
POL,,2014.0,2536,0,2536
AUT,,2015.0,1646,0,1646
CHN,ARG,2022.0,2,0,2
,NGA,2001.0,641,0,641
,PAK,1998.0,538,0,538
IRN,,2019.0,6138,0,6138
GHA,GMB,2008.0,1,0,1
RUS,SGP,2000.0,1,0,1
CIV,,2022.0,273,0,273
SVK,,2024.0,3375,0,3375
,URY,2003.0,145,0,145
TUN,ZAF,2015.0,17,0,17
BLR,,2010.0,177,0,177
,CRI,2013.0,132,0,132
,ECU,2013.0,369,0,369
TTO,,2014.0,47,0,47
,NGA,1996.0,511,0,511
,SGP,1996.0,856,0,856
ARG,,2014.0,1191,0,1191
,THA,2008.0,2344,0,2344
NOR,,2009.0,729,0,729
,GEO,2004.0,165,0,165
,BGD,1995.0,318,0,318
BLR,,2023.0,774,0,774
ZAF,,2005.0,423,0,423
DEU,,2000.0,6870,0,6870
,RUS,2017.0,19558,0,19558
GRC,,2006.0,736,0,736
,BLR,1995.0,620,0,620
,URY,2013.0,265,0,265
GEO,,2023.0,494,0,494
,ITA,2015.0,14390,0,14390
DNK,,2013.0,1183,0,1183
BRA,,2001.0,842,0,842
EST,,2009.0,111,0,111
BGR,NLD,2013.0,3,0,3
,PRI,2006.0,177,0,177
PRI,,2012.0,94,0,94
NCL,,2011.0,4,0,4
,GMB,1997.0,15,0,15
IDN,,2009.0,80,0,80
YEM,,2009.0,8,0,8
,POL,2011.0,6485,0,6485
AUT,,2004.0,821,0,821
,AUS,2008.0,8353,0,8353
,AUT,2004.0,2070,0,2070
BWA,,2019.0,70,0,70
ECU,,2022.0,823,0,823
,GRC,2005.0,2754,0,2754
,THA,2015.0,2896,0,2896
DEU,ARE,2002.0,6,0,6
,MYS,2009.0,4613,0,4613
,CIV,2000.0,78,0,78
,BEL,2018.0,3664,0,3664
SWE,,2005.0,1534,0,1534
RWA,,2025.0,729,0,729
,BIH,2003.0,130,0,130
BIH,,2022.0,343,0,343
TWN,,2006.0,1786,0,1786
BGR,,2022.0,951,0,951
,NZL,2008.0,1532,0,1532
ZAF,,2012.0,682,0,682
TZA,,2024.0,961,0,961
,SVN,1999.0,523,0,523
SGP,MAC,2017.0,3,0,3
,CMR,2005.0,200,0,200
TUN,,2007.0,174,0,174
NGA,EGY,2016.0,1,0,1
AUS,JAM,2017.0,2,0,2
,DZA,2016.0,1714,0,1714
BGR,,2017.0,472,0,472
,CHL,1994.0,1964,0,1964
PLW,,2009.0,4,0,4
,MEX,2006.0,3666,0,3666
,BFA,2003.0,56,0,56
,UKR,2012.0,2355,0,2355
KWT,,2022.0,352,0,352
QAT,,2008.0,35,0,35
,MYS,1994.0,904,0,904
,AUS,2015.0,9923,0,9923
,IRL,2009.0,1723,0,1723
ARM,,2008.0,60,0,60
,PAK,1999.0,605,0,605
PAK,,2004.0,189,0,189
JOR,,2023.0,1127,0,1127
FIN,,2005.0,762,0,762
MYS,,2013.0,811,0,811
JPN,SAU,2008.0,5,0,5
SAU,,2012.0,317,0,317
,LTU,2010.0,561,0,561
,MAR,2001.0,421,0,421
LBY,,2021.0,60,0,60
,MEX,2010.0,5558,0,5558
,KOR,2012.0,16957,0,16957
,ITA,2014.0,14458,0,14458
,MAR,1996.0,564,0,564
KOR,,2026.0,1946,0,1946
LVA,,2018.0,186,0,186
,IRL,2019.0,2003,0,2003
EST,,2011.0,100,0,100
CMR,,2013.0,105,0,105
HRV,,2008.0,277,0,277
,CYP,2002.0,71,0,71
LBN,TUN,2019.0,1,0,1
VEN,,2015.0,476,0,476
VEN,,2014.0,516,0,516
,PRT,2011.0,3239,0,3239
,MWI,2001.0,33,0,33
ISL,,2021.0,157,0,157
,FIN,2013.0,2216,0,2216
,PHL,1996.0,198,0,198
THA,,2001.0,121,0,121
HUN,,2004.0,485,0,485
GEO,,2024.0,739,0,739
MAR,,2010.0,214,0,214
,TKM,1994.0,6,0,6
TKM,,2012.0,3,0,3
LBY,,2025.0,348,0,348
LBY,,2009.0,19,0,19
BLR,,2024.0,1259,0,1259
CAN,AFG,2016.0,1,0,1
ISL,,2009.0,46,0,46
GEO,CHN,2006.0,1,0,1
,IND,2020.0,26621,0,26621
,BHR,2003.0,44,0,44
BRN,,2017.0,36,0,36
HRV,,2015.0,673,0,673
,CUB,1999.0,612,0,612
OMN,NOR,2011.0,1,0,1
,VIR,2003.0,2,0,2
EGY,,2013.0,752,0,752
,MDG,2004.0,32,0,32
,MAC,2006.0,50,0,50
ARG,SVN,2020.0,2,0,2
,USA,2019.0,86989,0,86989
,TUN,1999.0,542,0,542
DNK,,2003.0,631,0,631
,NZL,2004.0,1225,0,1225
HRV,BEL,2009.0,2,0,2
PAK,,2014.0,961,0,961
,TJK,2002.0,16,0,16
,CMR,1997.0,67,0,67
PAN,,2015.0,23,0,23
MLT,,2021.0,86,0,86
,AUT,2015.0,2803,0,2803
,GBR,2013.0,21934,0,21934
PHL,,2007.0,71,0,71
,COL,2006.0,1476,0,1476
SMR,,2021.0,5,0,5
ISL,,2019.0,122,0,122
SAU,PSE,2023.0,3,0,3
,KEN,1996.0,226,0,226
COL,,2012.0,368,0,368
BEN,,2025.0,813,0,813
JAM,,2014.0,52,0,52
DNK,BLR,2019.0,1,0,1
,MAR,2004.0,449,0,449
MNE,,2009.0,2,0,2
MLT,,2025.0,698,0,698
,BGR,2009.0,508,0,508
SYR,MAR,2013.0,1,0,1
,AUT,2008.0,2433,0,2433
,RUS,2018.0,15446,0,15446
,ISL,1995.0,169,0,169
ISL,,2025.0,1247,0,1247
BGR,TUR,2000.0,1,0,1
ROU,NLD,2005.0,7,0,7
HTI,,2018.0,30,0,30
CHE,,2003.0,1498,0,1498
,IRQ,2002.0,39,0,39
,MDA,1999.0,46,0,46
NPL,,2021.0,310,0,310
,NZL,2015.0,1485,0,1485
,KWT,2001.0,107,0,107
BOL,,2015.0,36,0,36
,CHE,2010.0,4485,0,4485
EGY,ETH,2005.0,1,0,1
SVK,,2010.0,373,0,373
HUN,,2001.0,354,0,354
,HKG,2018.0,2415,0,2415
EST,,2019.0,324,0,324
KWT,,2017.0,135,0,135
CUB,,2010.0,395,0,395
,GIN,2003.0,11,0,11
GIN,,2013.0,6,0,6
PSE,,2016.0,54,0,54
SUR,BEL,2016.0,2,0,2
,NGA,2004.0,1322,0,1322
MRT,,2008.0,3,0,3
BHR,,2024.0,285,0,285
PRT,BLR,2014.0,2,0,2
,VNM,1996.0,120,0,120
ITA,SEN,2017.0,3,0,3
GUF,CIV,2018.0,1,0,1
UZB,,2013.0,103,0,103
VNM,,2012.0,121,0,121
DOM,,2018.0,15,0,15
LBN,,2017.0,181,0,181
,MLI,1999.0,26,0,26
,MNP,2003.0,6,0,6
,JAM,1998.0,44,0,44
LUX,RWA,2009.0,1,0,1
,BRN,2003.0,9,0,9
BRN,,2022.0,46,0,46
LVA,,2017.0,169,0,169
CAF,CHE,2017.0,1,0,1
ITA,NGA,2010.0,2,0,2
FRA,GIN,2002.0,3,0,3
BLR,,2006.0,172,0,172
IND,CZE,2003.0,3,0,3
,VNM,2001.0,163,0,163
ZWE,,2017.0,51,0,51
HRV,,2014.0,605,0,605
ARM,,2015.0,109,0,109
GEO,SVK,2010.0,1,0,1
OMN,,2014.0,68,0,68
VNM,TWN,2005.0,1,0,1
CHL,FLK,2007.0,1,0,1
ZWE,,2022.0,167,0,167
COL,,2002.0,47,0,47
,JOR,2004.0,279,0,279
,ZWE,2002.0,50,0,50
,SDN,2004.0,62,0,62
LBN,,2018.0,180,0,180
,LUX,2010.0,108,0,108
,AUS,2014.0,10234,0,10234
SAU,,2005.0,236,0,236
BHR,,2010.0,31,0,31
PRY,,2011.0,5,0,5
BGR,,2026.0,35,0,35
CHL,,2018.0,1321,0,1321
,GLP,2007.0,25,0,25
NZL,,2026.0,176,0,176
,TTO,2005.0,52,0,52
,HRV,2004.0,905,0,905
,NLD,2017.0,6579,0,6579
HRV,,2004.0,185,0,185
FJI,,2022.0,55,0,55
,MDG,2001.0,46,0,46
GBR,LIE,2009.0,1,0,1
,MDG,1996.0,40,0,40
,BEL,2016.0,3614,0,3614
ETH,TWN,2008.0,1,0,1
ARG,,2004.0,518,0,518
ZAF,ZMB,2005.0,2,0,2
,BTN,2003.0,9,0,9
BTN,,2023.0,63,0,63
PRT,,2026.0,410,0,410
TTO,,2008.0,20,0,20
,KWT,1996.0,191,0,191
,GUM,2002.0,4,0,4
,PRY,2003.0,20,0,20
,MYS,2011.0,5447,0,5447
GEO,,2010.0,63,0,63
IDN,,2019.0,779,0,779
,JAM,1999.0,64,0,64
SAU,,2002.0,167,0,167
GHA,,2020.0,213,0,213
,IDN,2016.0,7506,0,7506
BFA,,2013.0,31,0,31
ZMB,,2010.0,12,0,12
BGD,,2013.0,206,0,206
,HRV,2008.0,1163,0,1163
ECU,,2016.0,47,0,47
MNE,,2025.0,282,0,282
NPL,CAN,2003.0,1,0,1
,ETH,1998.0,76,0,76
NZL,,2016.0,987,0,987
FIN,IRL,2005.0,4,0,4
,GEO,1996.0,151,0,151
,TTO,2002.0,39,0,39
,MWI,1996.0,24,0,24
BWA,,2011.0,39,0,39
,GAB,2002.0,27,0,27
GAB,,2007.0,10,0,10
ESP,CIV,2004.0,1,0,1
IDN,,2011.0,99,0,99
LKA,,2021.0,303,0,303
,VNM,2004.0,283,0,283
,KEN,2004.0,265,0,265
ROU,,2020.0,1521,0,1521
MKD,,2020.0,184,0,184
LKA,PAK,2008.0,1,0,1
KWT,,2016.0,134,0,134
,EGY,2013.0,3474,0,3474
,LBY,1997.0,19,0,19
JPN,JOR,2015.0,2,0,2
,LVA,2004.0,110,0,110
ZMB,,2024.0,405,0,405
,CUB,2007.0,842,0,842
PAN,,2014.0,20,0,20
,JOR,2015.0,605,0,605
,SRB,2017.0,1130,0,1130
,CHE,2006.0,3677,0,3677
,BOL,2004.0,37,0,37
POL,,2001.0,649,0,649
THA,,2004.0,252,0,252
,SGP,2015.0,2437,0,2437
BEN,,2021.0,124,0,124
,CAN,2020.0,7471,0,7471
MMR,,2013.0,16,0,16
NAM,IND,2004.0,1,0,1
BWA,,2025.0,623,0,623
,SWE,2018.0,3315,0,3315
NPL,,2019.0,178,0,178
,ARE,2000.0,73,0,73
,CIV,2006.0,176,0,176
NLD,CHL,2002.0,4,0,4
BRA,PAK,2009.0,2,0,2
IRQ,,2024.0,5736,0,5736
NIC,PAN,2011.0,1,0,1
HND,,2018.0,4,0,4
,MWI,2004.0,64,0,64
CYP,,2013.0,56,0,56
NIC,,2023.0,51,0,51
,NOR,2014.0,2051,0,2051
,ISR,2016.0,2787,0,2787
KAZ,,2013.0,39,0,39
CHN,KEN,2002.0,2,0,2
PSE,,2018.0,61,0,61
SEN,,2007.0,26,0,26
SVK,DNK,2010.0,2,0,2
OMN,ROU,2011.0,17,0,17
,PHL,2004.0,198,0,198
,OMN,2006.0,113,0,113
SGP,,2000.0,226,0,226
ROU,,1999.0,114,0,114
VEN,,2001.0,110,0,110
UKR,,1999.0,326,0,326
CRI,,2010.0,54,0,54
REU,,2014.0,6,0,6
,KWT,2004.0,161,0,161
LIE,,2016.0,11,0,11
,PYF,1994.0,36,0,36
GAB,NER,2012.0,1,0,1
HTI,,2016.0,12,0,12
KGZ,,2017.0,18,0,18
LVA,ISR,1997.0,1,0,1
GMB,AUS,1997.0,1,0,1
BWA,,2021.0,103,0,103
FJI,AUS,2000.0,3,0,3
CRI,,2024.0,599,0,599
PER,CRI,2010.0,1,0,1
CIV,,2017.0,137,0,137
BGD,KOR,2003.0,3,0,3
,LVA,2008.0,250,0,250
MCO,,2025.0,98,0,98
TUR,SOM,2020.0,9,0,9
ARM,KOR,2011.0,1,0,1
,CHL,2011.0,2051,0,2051
PRI,,2002.0,32,0,32
UGA,CHE,2006.0,1,0,1
MYS,KHM,2007.0,1,0,1
EGY,,2003.0,269,0,269
,SVK,2018.0,985,0,985
,MAR,2015.0,1604,0,1604
,VNM,2015.0,1463,0,1463
,MYS,2019.0,4711,0,4711
,NGA,2015.0,2124,0,2124
,PAK,2020.0,3796,0,3796
,NOR,2015.0,2111,0,2111
,AFG,2019.0,73,0,73
AFG,EGY,2022.0,1,0,1
,TUR,2013.0,8253,0,8253
PRY,,2025.0,381,0,381
,PHL,2015.0,665,0,665
,PHL,2014.0,678,0,678
,MCO,2015.0,7,0,7
,IDN,2018.0,9259,0,9259
YEM,,2025.0,385,0,385
,THA,2014.0,2829,0,2829
,ARE,2010.0,249,0,249
,NGA,2014.0,1932,0,1932
AUT,PAK,2022.0,8,0,8
,AUT,2014.0,2885,0,2885
ARE,,2020.0,371,0,371
,NZL,2014.0,1544,0,1544
,CMR,2012.0,362,0,362
CMR,SLE,2015.0,2,0,2
,MDG,2014.0,78,0,78
,JOR,2014.0,523,0,523
,BEL,2017.0,3407,0,3407
,COL,2010.0,1899,0,1899
,ALB,2014.0,80,0,80
,MWI,2015.0,184,0,184
,MAR,2014.0,1525,0,1525
,ZAF,2016.0,2981,0,2981
,IDN,2017.0,10305,0,10305
TZA,,2023.0,556,0,556
,HRV,2015.0,1043,0,1043
,SGP,2014.0,2476,0,2476
,JOR,2008.0,532,0,532
,KEN,2015.0,579,0,579
POL,IRQ,2015.0,1,0,1
,MNE,2015.0,73,0,73
,HRV,2014.0,1016,0,1016
,FRA,1997.0,14060,0,14060
DEU,,2013.0,13855,0,13855
USA,,2022.0,133371,0,133371
USA,,2018.0,84395,0,84395
,USA,1996.0,91360,0,91360
USA,,2017.0,80613,0,80613
,IRN,2005.0,5993,0,5993
PHL,,2018.0,278,0,278
KOR,,2007.0,3341,0,3341
TWN,,2013.0,4799,0,4799
BRA,,2021.0,22303,0,22303
BRA,,2025.0,115039,0,115039
BEL,,2016.0,2488,0,2488
,GBR,2000.0,16663,0,16663
,CHN,2003.0,67581,0,67581
,ESP,1995.0,15842,0,15842
ESP,,2012.0,5765,0,5765
,TUR,2000.0,4323,0,4323
,FRA,2002.0,12672,0,12672
,ITA,1994.0,53292,0,53292
HUN,,2009.0,666,0,666
,AUS,1994.0,21077,0,21077
,USA,2004.0,77764,0,77764
THA,,2025.0,23289,0,23289
,CHE,2003.0,3389,0,3389
CHE,,2023.0,9756,0,9756
TUN,,2022.0,1573,0,1573
,USA,2001.0,69759,0,69759
ITA,,2013.0,7014,0,7014
CHN,,2024.0,425041,0,425041
JPN,,2013.0,18955,0,18955
CAN,,2012.0,6518,0,6518
BRA,,2011.0,5056,0,5056
NOR,,2014.0,1090,0,1090
USA,,2016.0,73202,0,73202
CHE,,2010.0,2305,0,2305
MEX,,2008.0,920,0,920
BRA,,2009.0,3441,0,3441
IND,,2017.0,15887,0,15887
MEX,,2014.0,2140,0,2140
HRV,,2025.0,8678,0,8678
,COL,2003.0,615,0,615
,PER,2002.0,174,0,174
PYF,,2019.0,14,0,14
AUS,,2023.0,18142,0,18142
BRA,,2019.0,14734,0,14734
NOR,,2008.0,636,0,636
ARG,,2025.0,18780,0,18780
CHN,,2010.0,30143,0,30143
,MEX,2003.0,2912,0,2912
,NLD,1999.0,4297,0,4297
,DEU,2000.0,16713,0,16713
PRT,,2020.0,2290,0,2290
EGY,,2023.0,6759,0,6759
POL,,2025.0,49059,0,49059
,GBR,2010.0,21025,0,21025
RUS,,2017.0,6475,0,6475
,BEL,1998.0,2393,0,2393
DNK,,2010.0,1004,0,1004
,AUT,1994.0,6810,0,6810
GLP,,2009.0,10,0,10
,SWE,2007.0,3449,0,3449
IND,,2018.0,17725,0,17725
,NLD,1998.0,4647,0,4647
NLD,,2014.0,3395,0,3395
NZL,,2020.0,1454,0,1454
CHE,,2024.0,15874,0,15874
AUS,,2024.0,30587,0,30587
,FIN,2000.0,1812,0,1812
,MYS,2001.0,686,0,686
,FRA,2005.0,13381,0,13381
,BRA,1995.0,7949,0,7949
CYP,,2023.0,451,0,451
BEL,,2018.0,3048,0,3048
,MEX,2013.0,5338,0,5338
MYS,,2024.0,13594,0,13594
,MAR,2009.0,861,0,861
ISR,,2008.0,1242,0,1242
,KOR,1995.0,6884,0,6884
,JPN,1995.0,46080,0,46080
,ITA,2019.0,15788,0,15788
IND,,2016.0,14021,0,14021
,GBR,2006.0,18314,0,18314
HUN,,2025.0,13079,0,13079
IND,,2022.0,32097,0,32097
RUS,,2016.0,5494,0,5494
RUS,,2018.0,8191,0,8191
RUS,,2022.0,20218,0,20218
,SWE,1998.0,3376,0,3376
,POL,2001.0,3981,0,3981
VCT,GBR,2012.0,1,0,1
,IRL,2001.0,890,0,890
PAK,,2025.0,27126,0,27126
HUN,,2021.0,1601,0,1601
KOR,,2020.0,13938,0,13938
ARM,,2025.0,1071,0,1071
,LTU,2003.0,595,0,595
NLD,,2008.0,2427,0,2427
NZL,,2007.0,510,0,510
TUR,,2020.0,5702,0,5702
HKG,,2017.0,1084,0,1084
CHN,,2023.0,233272,0,233272
,THA,2011.0,2463,0,2463
,MKD,2007.0,161,0,161
MKD,,2017.0,105,0,105
POL,,2011.0,2130,0,2130
,CZE,2000.0,1512,0,1512
AUT,,2025.0,21041,0,21041
TUR,,2007.0,1174,0,1174
,ITA,2011.0,15499,0,15499
,CZE,2006.0,2127,0,2127
IRN,,2015.0,3221,0,3221
MEX,,2015.0,1881,0,1881
,RUS,1998.0,8093,0,8093
,RUS,1999.0,7605,0,7605
,HKG,2007.0,1489,0,1489
NPL,,2008.0,57,0,57
,DNK,2002.0,1671,0,1671
ITA,,2003.0,4053,0,4053
,USA,2008.0,85692,0,85692
,DEU,2010.0,24019,0,24019
,ROU,2000.0,750,0,750
CHN,,2006.0,10740,0,10740
RUS,,2026.0,811,0,811
,BGR,2004.0,480,0,480
DEU,,2003.0,9715,0,9715
KAZ,,2024.0,3600,0,3600
SGP,,2013.0,989,0,989
AUS,,2010.0,3476,0,3476
,ARG,2003.0,1699,0,1699
JPN,,2003.0,15462,0,15462
,TUR,2006.0,6038,0,6038
ARG,,2011.0,911,0,911
,IRN,2002.0,2356,0,2356
,GRC,1995.0,2867,0,2867
,SWE,1999.0,3269,0,3269
,RUS,2007.0,7192,0,7192
BEL,,2017.0,2761,0,2761
,FRA,2012.0,15736,0,15736
PER,,2017.0,232,0,232
,SAU,2020.0,3281,0,3281
NLD,,2015.0,3798,0,3798
BEL,,2022.0,4714,0,4714
THA,,2021.0,2404,0,2404
IND,ATA,2010.0,1,0,1
DNK,,2023.0,5240,0,5240
,SGP,1994.0,2116,0,2116
AUT,,2011.0,1245,0,1245
AUT,,2021.0,3089,0,3089
,KAZ,2003.0,117,0,117
POL,,2021.0,6182,0,6182
COG,,2023.0,123,0,123
,SAU,2007.0,729,0,729
,USA,2014.0,95056,0,95056
TUN,,2018.0,962,0,962
,BEL,1999.0,2487,0,2487
ISR,,2015.0,1573,0,1573
DNK,,2024.0,8895,0,8895
,SRB,2007.0,1433,0,1433
,IRL,1996.0,1110,0,1110
,DEU,2006.0,19762,0,19762
ARG,,2019.0,2073,0,2073
,UKR,1995.0,3078,0,3078
,MMR,2003.0,21,0,21
MMR,,2024.0,198,0,198
VIR,,2025.0,14,0,14
,CHE,2013.0,4683,0,4683
ARG,,2021.0,3119,0,3119
UKR,,2017.0,1185,0,1185
UKR,,2018.0,1274,0,1274
,PRT,2001.0,1464,0,1464
GHA,,2017.0,126,0,126
BGD,,2024.0,3764,0,3764
,NLD,2007.0,5949,0,5949
USA,,2026.0,5828,0,5828
,SAU,1998.0,425,0,425
AUT,,2019.0,2294,0,2294
UKR,,2016.0,1060,0,1060
BOL,,2025.0,271,0,271
,ZAF,1998.0,1197,0,1197
,PER,1997.0,154,0,154
AUS,,2006.0,2492,0,2492
,VNM,2009.0,620,0,620
,HKG,1999.0,1181,0,1181
LVA,,2007.0,29,0,29
,ITA,2009.0,13585,0,13585
PAK,,2019.0,1590,0,1590
TUN,,2017.0,737,0,737
NLD,,2004.0,2173,0,2173
ESP,,2005.0,3212,0,3212
,PRT,1996.0,1447,0,1447
CHN,,2000.0,4798,0,4798
,CHN,2013.0,158834,0,158834
MEX,,2004.0,550,0,550
POL,,2019.0,4594,0,4594
,HKG,1998.0,1135,0,1135
HKG,,2016.0,1052,0,1052
COG,,2024.0,233,0,233
,PRT,2008.0,2656,0,2656
HUN,,2019.0,1308,0,1308
IRL,,2002.0,280,0,280
,CRI,2000.0,81,0,81
CHE,,2006.0,1528,0,1528
THA,,2019.0,1723,0,1723
,PRI,2003.0,127,0,127
,LVA,1994.0,366,0,366
,IND,2016.0,33509,0,33509
IND,,2026.0,4141,0,4141
POL,,2009.0,1928,0,1928
AUT,,2009.0,1179,0,1179
,POL,1996.0,4420,0,4420
EGY,,2024.0,13412,0,13412
CHE,,2000.0,1071,0,1071
GHA,,2018.0,161,0,161
GHA,,2016.0,92,0,92
,BGR,2001.0,455,0,455
,DNK,2012.0,3155,0,3155
,AUS,2009.0,8539,0,8539
CHE,SAU,2015.0,6,0,6
,NOR,1994.0,5302,0,5302
CIV,,2020.0,145,0,145
TWN,,2003.0,1429,0,1429
,ISR,1998.0,2260,0,2260
,NGA,2009.0,1815,0,1815
EST,,2014.0,154,0,154
HKG,,2022.0,1830,0,1830
THA,,2011.0,646,0,646
TJK,,2021.0,30,0,30
,HRV,1994.0,2188,0,2188
HRV,,2021.0,1167,0,1167
ESP,,2002.0,2683,0,2683
,BLR,2002.0,246,0,246
,CHL,1996.0,864,0,864
,POL,2004.0,4666,0,4666
KOR,SVN,2010.0,1,0,1
,NPL,2003.0,188,0,188
HUN,,2011.0,754,0,754
,URY,2000.0,128,0,128
,AUT,2009.0,2680,0,2680
YEM,,2008.0,17,0,17
,LKA,2002.0,115,0,115
,EGY,2000.0,968,0,968
,ROU,2006.0,2601,0,2601
UZB,,2024.0,810,0,810
,FIN,2006.0,1971,0,1971
IDN,,2008.0,81,0,81
CHN,UGA,2013.0,1,0,1
,KWT,1994.0,489,0,489
,CIV,2003.0,109,0,109
AUS,,2000.0,1385,0,1385
PRT,,2007.0,389,0,389
,BGR,1996.0,838,0,838
HRV,,2019.0,905,0,905
,ISR,1999.0,2154,0,2154
PAK,,2009.0,339,0,339
FIN,LBY,2012.0,2,0,2
IRN,,2008.0,351,0,351
IRL,,2012.0,705,0,705
OMN,,2025.0,1790,0,1790
BEL,ISL,2008.0,1,0,1
ZWE,NAM,2009.0,1,0,1
CHL,,2007.0,321,0,321
,USA,2015.0,97349,0,97349
UKR,,2026.0,102,0,102
ISR,,2004.0,958,0,958
IRN,LUX,2015.0,2,0,2
MDA,,2012.0,39,0,39
,NZL,1994.0,4044,0,4044
,BGD,2002.0,301,0,301
KOR,,1999.0,643,0,643
,IRN,1997.0,617,0,617
,POL,2014.0,6419,0,6419
CHL,,2020.0,1683,0,1683
UKR,,2022.0,4250,0,4250
BEL,,2026.0,359,0,359
,ZAF,1999.0,1158,0,1158
IRN,,2014.0,2710,0,2710
CZE,,2013.0,1198,0,1198
KGZ,DEU,2009.0,1,0,1
,KGZ,2003.0,21,0,21
SVK,,2013.0,434,0,434
,CMR,1995.0,134,0,134
,AUT,2011.0,2669,0,2669
ROU,,2017.0,1330,0,1330
,SVK,1998.0,638,0,638
,QAT,2002.0,50,0,50
URY,,2015.0,86,0,86
HRV,,2009.0,334,0,334
,ARE,2003.0,118,0,118
CMR,,2024.0,1467,0,1467
,AUS,2011.0,9849,0,9849
GRC,,2013.0,1560,0,1560
VEN,,2021.0,523,0,523
,NER,2003.0,20,0,20
PHL,,2022.0,775,0,775
VEN,,2019.0,534,0,534
BGD,,2010.0,140,0,140
VEN,,2025.0,756,0,756
ISR,,2014.0,1462,0,1462
,IDN,1998.0,283,0,283
MYS,,2023.0,7538,0,7538
,IRL,2004.0,1252,0,1252
MAR,,2003.0,138,0,138
BLR,,2003.0,161,0,161
,CHL,2001.0,846,0,846
MEX,,2001.0,421,0,421
LKA,,2008.0,37,0,37
,SYR,2001.0,33,0,33
ROU,,2018.0,1561,0,1561
,BHR,2000.0,20,0,20
SVN,,2012.0,253,0,253
DNK,,2006.0,798,0,798
QAT,,2025.0,3223,0,3223
,MYS,1996.0,493,0,493
,IDN,1999.0,236,0,236
MAR,,2013.0,309,0,309
,VNM,1994.0,173,0,173
PAN,,2025.0,404,0,404
JOR,,2013.0,155,0,155
DEU,PSE,2002.0,2,0,2
URY,,2014.0,73,0,73
,DNK,2005.0,1769,0,1769
PAK,,2011.0,547,0,547
ARE,,2022.0,657,0,657
,POL,2008.0,5073,0,5073
,CZE,2010.0,2707,0,2707
,GEO,2009.0,171,0,171
CMR,,2023.0,831,0,831
ISL,,2008.0,43,0,43
,MYS,2015.0,5577,0,5577
,RWA,2003.0,9,0,9
DZA,,2012.0,144,0,144
REU,,2025.0,22,0,22
,SVK,1999.0,576,0,576
,IDN,2020.0,4638,0,4638
CAN,GUY,2008.0,2,0,2
BGD,,2023.0,1949,0,1949
LBY,,2015.0,56,0,56
CAN,,2005.0,3735,0,3735
,DZA,1999.0,275,0,275
,BGD,2005.0,478,0,478
PER,,2022.0,808,0,808
,MYS,2008.0,3648,0,3648
VEN,,2009.0,317,0,317
HRV,HUN,2018.0,3,0,3
MNG,,2018.0,46,0,46
BGR,TUR,2013.0,2,0,2
ISR,TWN,2007.0,3,0,3
ITA,BRN,2005.0,1,0,1
NOR,,2015.0,1112,0,1112
TTO,,2025.0,337,0,337
ARG,,2009.0,696,0,696
,MAR,1994.0,932,0,932
,IRL,2008.0,1761,0,1761
,MAC,2003.0,23,0,23
UGA,RWA,2011.0,1,0,1
,OMN,2003.0,82,0,82
LUX,RWA,2014.0,2,0,2
CAN,,2002.0,3482,0,3482
THA,,2009.0,486,0,486
,DNK,1997.0,1699,0,1699
ISR,,2001.0,663,0,663
GEO,,2013.0,70,0,70
,DZA,1998.0,281,0,281
,BLR,1997.0,353,0,353
CMR,,2010.0,51,0,51
EGY,,2010.0,410,0,410
PER,,2018.0,237,0,237
EST,,2001.0,50,0,50
,SRB,1999.0,515,0,515
VEN,,2011.0,480,0,480
MYS,CHN,2005.0,4,0,4
,THA,1994.0,1411,0,1411
,COG,2018.0,91,0,91
,ECU,2000.0,58,0,58
,NOR,2009.0,1907,0,1907
GMB,NGA,2004.0,2,0,2
PNG,,2007.0,13,0,13
HKG,ISR,2011.0,2,0,2
,MWI,2019.0,161,0,161
CYP,,2024.0,872,0,872
,ISL,2002.0,84,0,84
,NGA,1994.0,1112,0,1112
,ZAF,2007.0,1767,0,1767
EST,,2015.0,176,0,176
NOR,,2004.0,428,0,428
,LBY,1995.0,34,0,34
LBY,,2008.0,17,0,17
,GUM,1995.0,9,0,9
,PRT,2004.0,1853,0,1853
ALB,,2025.0,575,0,575
PAK,,2021.0,2806,0,2806
ETH,,2023.0,1444,0,1444
,NGA,2011.0,1667,0,1667
GRC,,2003.0,505,0,505
HKG,,2018.0,1187,0,1187
ARG,PRT,2001.0,4,0,4
HRV,,2011.0,415,0,415
OMN,,2011.0,47,0,47
TGO,,2021.0,63,0,63
PRI,ESP,2013.0,5,0,5
QAT,,2021.0,235,0,235
,SWE,2020.0,1797,0,1797
SGP,KHM,2010.0,1,0,1
,IND,2017.0,37764,0,37764
,DZA,2007.0,1090,0,1090
,SGP,2019.0,2265,0,2265
KWT,,2007.0,75,0,75
IRN,,2004.0,98,0,98
TUN,,2026.0,155,0,155
,PAN,1995.0,27,0,27
SVN,,2005.0,138,0,138
,RUS,2020.0,6782,0,6782
CUB,,2013.0,669,0,669
IDN,,2014.0,159,0,159
,NOR,2019.0,1940,0,1940
DNK,BLR,2014.0,2,0,2
BLR,DNK,2017.0,1,0,1
,MLT,2007.0,58,0,58
ROU,,2016.0,1219,0,1219
LBN,,2007.0,47,0,47
BLR,,2013.0,148,0,148
,LTU,2013.0,569,0,569
BGR,,2007.0,237,0,237
,TUR,2010.0,7379,0,7379
SGP,,2003.0,446,0,446
OMN,NGA,2016.0,2,0,2
,HTI,2003.0,11,0,11
,BEL,2007.0,3318,0,3318
TUN,,2016.0,635,0,635
,NZL,2009.0,1501,0,1501
,PYF,2004.0,6,0,6
KGZ,THA,2020.0,1,0,1
,SGP,2009.0,2109,0,2109
CYM,,2018.0,1,0,1
ROU,,2022.0,2414,0,2414
TTO,,2019.0,72,0,72
SLB,AUS,2012.0,1,0,1
SEN,,2016.0,67,0,67
CIV,,2007.0,29,0,29
NLD,,2001.0,1727,0,1727
MYS,,2000.0,77,0,77
MNG,,2016.0,39,0,39
MMR,,2023.0,266,0,266
BGR,,2020.0,607,0,607
,MAR,2011.0,1041,0,1041
SUR,BEL,2020.0,1,0,1
DEU,ALB,2009.0,3,0,3
BLR,PRT,2013.0,2,0,2
BOL,,2011.0,34,0,34
DNK,,2000.0,439,0,439
,HUN,2016.0,1707,0,1707
EGY,TWN,2006.0,1,0,1
EGY,,2006.0,282,0,282
CUB,AUT,2020.0,1,0,1
,IND,2018.0,36373,0,36373
ETH,,2024.0,3481,0,3481
MYS,,2010.0,299,0,299
,SRB,1998.0,499,0,499
MNP,USA,2016.0,7,0,7
,THA,2019.0,3483,0,3483
,PRT,2015.0,3142,0,3142
,LUX,2003.0,40,0,40
SOM,,2024.0,52,0,52
JAM,,2009.0,21,0,21
,ROU,2010.0,2272,0,2272
LUX,MWI,2001.0,1,0,1
ARM,,2021.0,156,0,156
QAT,,2019.0,157,0,157
NZL,,1999.0,167,0,167
,POL,2015.0,5797,0,5797
,EGY,2010.0,3505,0,3505
,MOZ,1995.0,25,0,25
,CHL,2004.0,1355,0,1355
,LVA,2009.0,301,0,301
ROU,NGA,2019.0,1,0,1
CRI,URY,2003.0,1,0,1
ARM,,2009.0,64,0,64
,KHM,2001.0,24,0,24
,BWA,2018.0,105,0,105
,CAN,2018.0,13815,0,13815
BWA,,2008.0,21,0,21
ARM,,2019.0,125,0,125
LTU,,2005.0,66,0,66
ZWE,,2020.0,98,0,98
LTU,,2012.0,235,0,235
,CHL,2008.0,1735,0,1735
BFA,,2023.0,265,0,265
,NOR,2011.0,1870,0,1870
,MYS,2004.0,1336,0,1336
,CAN,2016.0,13198,0,13198
USA,DJI,2009.0,1,0,1
MNG,,2022.0,155,0,155
,SAU,1999.0,338,0,338
KAZ,,2010.0,55,0,55
USA,BLZ,2009.0,1,0,1
BIH,,2020.0,176,0,176
RUS,CIV,2003.0,1,0,1
BOL,,2021.0,67,0,67
ETH,,2010.0,49,0,49
BRB,JAM,2011.0,2,0,2
,EGY,2006.0,1772,0,1772
,KEN,2009.0,490,0,490
GHA,,2022.0,538,0,538
MEX,CHN,2012.0,6,0,6
SYR,,2012.0,33,0,33
SGP,KAZ,2018.0,2,0,2
CHN,BFA,2015.0,1,0,1
BDI,,2025.0,75,0,75
BGD,BWA,2007.0,1,0,1
MYS,SRB,2021.0,4,0,4
PRY,,2008.0,5,0,5
GUY,,2022.0,16,0,16
IDN,SWE,2006.0,3,0,3
MKD,,2016.0,71,0,71
,MYS,2014.0,6110,0,6110
CRI,GRC,2009.0,1,0,1
ESP,SYR,2014.0,1,0,1
JOR,,2003.0,28,0,28
,AZE,2000.0,103,0,103
CIV,TCD,2002.0,1,0,1
KGZ,,2020.0,35,0,35
DEU,MNE,2005.0,3,0,3
,TUN,2016.0,1413,0,1413
CUB,,2003.0,289,0,289
GTM,GBR,2005.0,1,0,1
ARE,,2026.0,172,0,172
THA,OMN,2012.0,1,0,1
OMN,,2019.0,155,0,155
USA,MDG,2011.0,7,0,7
KGZ,,2007.0,7,0,7
BHR,IND,2009.0,4,0,4
ARE,,2017.0,193,0,193
NER,,2025.0,202,0,202
PAN,,2021.0,62,0,62
,AZE,2006.0,215,0,215
SLE,,2024.0,131,0,131
,TWN,2017.0,6086,0,6086
FIN,HRV,2019.0,4,0,4
,ISL,1997.0,85,0,85
,UGA,2002.0,120,0,120
ITA,BFA,2010.0,3,0,3
,COG,2017.0,97,0,97
UZB,,2006.0,60,0,60
,IRN,2012.0,12413,0,12413
,SVK,2007.0,730,0,730
ARE,,2016.0,198,0,198
HKG,,2026.0,398,0,398
,PSE,2004.0,41,0,41
,GHA,1998.0,73,0,73
SWE,BOL,2012.0,5,0,5
BFA,,2024.0,480,0,480
GHA,DNK,1999.0,2,0,2
ESP,ZAF,2006.0,6,0,6
LTU,,2002.0,40,0,40
NOR,,2001.0,343,0,343
,PHL,1994.0,325,0,325
MTQ,,2004.0,2,0,2
BOL,,2019.0,44,0,44
ISR,SGP,2004.0,1,0,1
,SYR,2004.0,32,0,32
IDN,,2015.0,209,0,209
SDN,,2008.0,16,0,16
NOR,TWN,2014.0,1,0,1
,ZMB,1999.0,27,0,27
RUS,CYP,2014.0,1,0,1
ARM,,2011.0,61,0,61
BLR,GBR,2014.0,2,0,2
JPN,LTU,2008.0,3,0,3
LKA,,2015.0,91,0,91
DEU,CIV,2013.0,2,0,2
,ARM,2000.0,119,0,119
PHL,,2016.0,162,0,162
PAK,BRA,2008.0,1,0,1
TUR,,1999.0,190,0,190
,SEN,2004.0,85,0,85
,NIC,1996.0,13,0,13
NIC,USA,2001.0,1,0,1
,GHA,1999.0,81,0,81
MAC,,2023.0,158,0,158
LBN,,2020.0,320,0,320
ISL,,2015.0,85,0,85
,ISL,2005.0,113,0,113
ROU,,2026.0,112,0,112
URY,,2008.0,46,0,46
,FIN,2010.0,2152,0,2152
,NIC,2001.0,10,0,10
,BEN,2002.0,41,0,41
TTO,,2009.0,29,0,29
,UGA,1997.0,81,0,81
NCL,,2014.0,11,0,11
CMR,,2006.0,28,0,28
GIN,GUF,2013.0,6,0,6
SEN,,2017.0,85,0,85
,SEN,1996.0,113,0,113
,ARG,2013.0,2800,0,2800
,KEN,1994.0,550,0,550
KEN,KWT,2014.0,1,0,1
ZWE,,1999.0,23,0,23
,BOL,1994.0,55,0,55
DZA,LBN,2018.0,3,0,3
,LSO,1995.0,7,0,7
CZE,,2003.0,480,0,480
,IDN,2007.0,645,0,645
ERI,,2024.0,33,0,33
GIN,AUS,2011.0,1,0,1
LVA,,2020.0,207,0,207
KAZ,,2023.0,1827,0,1827
PHL,,2026.0,43,0,43
,ZWE,1995.0,149,0,149
,SDN,1994.0,85,0,85
TLS,,2023.0,13,0,13
,URY,2010.0,245,0,245
,AGO,2004.0,8,0,8
SRB,LTU,2013.0,1,0,1
LBY,,2001.0,7,0,7
USA,BRN,2020.0,3,0,3
COL,BEL,2008.0,3,0,3
TTO,,2021.0,97,0,97
,MDG,1994.0,87,0,87
HND,CHL,2006.0,2,0,2
,EST,2000.0,157,0,157
BWA,,2015.0,35,0,35
JAM,,2021.0,73,0,73
,KWT,2009.0,148,0,148
BWA,,2014.0,34,0,34
TTO,,2011.0,40,0,40
,BGD,1997.0,234,0,234
TJK,UZB,2002.0,1,0,1
JPN,GBR,2020.0,131,150,-19
NLD,CAN,2020.0,73,73,0
JPN,VNM,2021.0,114,33,81
SWE,DEU,2022.0,141,187,-46
USA,KEN,2019.0,85,59,26
ITA,CHE,2021.0,275,210,65
GUM,USA,2020.0,6,8,-2
JPN,FRA,2018.0,80,88,-8
NZL,CHN,2018.0,30,34,-4
NZL,ZAF,2019.0,10,22,-12
SAU,AUS,2002.0,4,4,0
BRA,CAN,2021.0,216,111,105
ITA,NLD,2020.0,145,118,27
CAN,IRN,2019.0,76,364,-288
TUR,CHN,2019.0,18,7,11
CHN,SGP,2023.0,248,358,-110
FIN,CAN,2022.0,12,20,-8
IND,MYS,2018.0,65,64,1
AUT,ITA,2017.0,48,103,-55
IRN,USA,2016.0,561,118,443
BEL,NLD,2020.0,209,194,15
ITA,KOR,2022.0,10,14,-4
GBR,MEX,2020.0,55,62,-7
USA,CHN,2024.0,49,41,8
NOR,SWE,2023.0,42,47,-5
NLD,HUN,2017.0,14,12,2
ETH,SDN,2019.0,2,1,1
CHN,BEL,2019.0,83,63,20
NOR,GBR,2022.0,52,111,-59
COL,ESP,2020.0,124,125,-1
KOR,VNM,2020.0,144,39,105
GBR,PAK,2020.0,114,77,37
ECU,ESP,2021.0,77,82,-5
DEU,SGP,2020.0,36,38,-2
GBR,MYS,2012.0,162,59,103
PER,USA,2021.0,52,47,5
CAN,SAU,2022.0,91,63,28
BRA,CAN,2019.0,165,78,87
UKR,HUN,2022.0,2,3,-1
BRA,COL,2020.0,97,53,44
CHN,HKG,2024.0,37,90,-53
EGY,JPN,2018.0,40,79,-39
MYS,SAU,2016.0,76,28,48
MYS,KOR,2012.0,12,7,5
DEU,IRL,2017.0,35,41,-6
EGY,HUN,2021.0,6,6,0
ESP,IRL,2018.0,48,37,11
IRN,GBR,2021.0,115,28,87
MEX,ESP,2001.0,70,68,2
PRT,DZA,2019.0,5,4,1
GBR,POL,2023.0,48,42,6
THA,GBR,2021.0,59,109,-50
IND,ISR,2018.0,117,51,66
IND,ISR,2022.0,113,70,43
IRL,DEU,2018.0,51,46,5
FRA,PAK,2016.0,16,8,8
IRN,CHN,2023.0,30,16,14
HKG,USA,2002.0,125,99,26
PER,USA,2019.0,75,64,11
LBN,GBR,2020.0,16,5,11
GBR,LBN,2022.0,9,20,-11
USA,PAK,2014.0,67,87,-20
MYS,PAK,2022.0,134,80,54
CHN,NLD,2020.0,192,204,-12
PER,BEL,2015.0,2,4,-2
GBR,TUR,2015.0,58,51,7
SEN,USA,2001.0,5,2,3
JPN,IND,2018.0,99,114,-15
HUN,CHE,2020.0,14,11,3
JPN,AUS,1998.0,42,52,-10
CHE,JPN,1999.0,17,23,-6
DEU,BEL,2023.0,76,65,11
AUS,DEU,2019.0,172,189,-17
ZAF,ARE,2022.0,7,4,3
AUS,AUT,2019.0,49,34,15
BGD,JPN,2020.0,74,113,-39
ESP,CZE,2022.0,25,23,2
CZE,ESP,2023.0,15,14,1
FRA,GRC,2022.0,24,31,-7
ESP,SWE,2020.0,91,68,23
CAN,GRC,2021.0,7,15,-8
EGY,CAN,2019.0,51,59,-8
FRA,CAN,2019.0,402,295,107
KEN,USA,2018.0,69,74,-5
IRN,GBR,2019.0,85,50,35
FRA,QAT,2018.0,9,4,5
BEL,CHE,2022.0,68,57,11
NLD,ITA,2022.0,103,134,-31
ZAF,ZMB,2022.0,13,4,9
PRT,ITA,2018.0,42,39,3
ITA,GBR,2021.0,484,520,-36
NOR,DEU,2018.0,52,89,-37
DEU,IND,2017.0,138,208,-70
DNK,GBR,2022.0,106,137,-31
IRN,ESP,2023.0,29,7,22
CHL,GBR,2023.0,29,30,-1
BOL,CHL,2021.0,3,7,-4
RUS,LVA,2022.0,6,4,2
KOR,CAN,2020.0,71,32,39
THA,DEU,2018.0,18,36,-18
ITA,CHN,2019.0,72,50,22
CAN,ZAF,2020.0,18,43,-25
SVK,CHE,2021.0,3,1,2
JPN,IDN,2023.0,78,60,18
BRA,GBR,2020.0,174,123,51
CHN,FIN,2019.0,52,40,12
AUS,CHN,2019.0,555,538,17
ITA,JPN,1998.0,30,24,6
AUS,NZL,2020.0,172,202,-30
AUS,LAO,2022.0,1,1,0
GBR,CHL,2018.0,51,63,-12
JPN,THA,2021.0,133,62,71
FRA,BRA,2021.0,125,169,-44
GBR,SGP,2023.0,64,56,8
GHA,GBR,2018.0,23,20,3
ITA,LBN,2019.0,8,6,2
USA,IRL,2021.0,153,149,4
CHE,NLD,2015.0,77,111,-34
HUN,EGY,2022.0,6,6,0
FIN,SWE,2023.0,43,34,9
USA,ALB,2018.0,8,3,5
MYS,BGD,2020.0,81,42,39
ARG,PRI,2020.0,3,5,-2
CHE,ITA,2018.0,149,304,-155
IND,CAN,2018.0,156,106,50
EGY,ESP,2022.0,9,11,-2
EGY,CAN,2021.0,66,60,6
TUR,SWE,2022.0,20,13,7
NPL,ITA,2021.0,2,2,0
IND,ESP,2020.0,31,26,5
FRA,ROU,2023.0,15,15,0
IND,JPN,2023.0,70,50,20
IND,NGA,2017.0,10,11,-1
CAN,BRA,2017.0,83,140,-57
CAN,SAU,2018.0,127,75,52
GBR,BRA,2023.0,61,82,-21
TWN,BRA,2017.0,4,2,2
CAN,GBR,2021.0,403,418,-15
USA,CZE,2019.0,66,53,13
DNK,CHN,2020.0,95,124,-29
BEL,CHN,1997.0,11,9,2
USA,NOR,2019.0,139,91,48
SAU,EGY,2008.0,72,95,-23
AUS,BRA,2023.0,13,27,-14
PRT,ITA,2022.0,43,36,7
KOR,NZL,2018.0,7,6,1
BRA,PRT,2016.0,120,176,-56
CHL,BRA,2019.0,24,46,-22
CZE,FRA,2005.0,21,18,3
AZE,TUR,2022.0,5,10,-5
HKG,MAC,2007.0,15,4,11
ITA,IND,2017.0,47,53,-6
FIN,ESP,2003.0,7,10,-3
CZE,DEU,2007.0,42,33,9
JOR,USA,2023.0,47,24,23
ARM,RUS,2021.0,5,5,0
PRY,BRA,2019.0,3,6,-3
NGA,ZAF,2018.0,91,76,15
JPN,FRA,2022.0,57,75,-18
GRC,USA,2019.0,142,106,36
CAN,ITA,2003.0,38,39,-1
GHA,NOR,2023.0,2,3,-1
TUR,GBR,2023.0,67,32,35
GBR,VNM,2019.0,60,14,46
IRN,CHE,2020.0,48,13,35
TWN,USA,2021.0,257,229,28
TUR,KOR,2017.0,6,3,3
NLD,NGA,2018.0,6,4,2
USA,BHR,2019.0,5,5,0
CAN,MEX,2019.0,42,49,-7
KOR,CHN,2015.0,190,106,84
AUS,KEN,2018.0,6,3,3
THA,IND,2019.0,14,16,-2
AUT,USA,2023.0,67,65,2
ITA,NLD,1998.0,57,48,9
ESP,MOZ,2019.0,5,6,-1
ROU,USA,2018.0,23,28,-5
CHN,FIN,2009.0,10,13,-3
JOR,SAU,2015.0,36,26,10
ISR,SWE,2021.0,14,7,7
IRL,JPN,2021.0,3,10,-7
DNK,NLD,2023.0,21,28,-7
FRA,BRA,2019.0,136,166,-30
MEX,VEN,2019.0,3,11,-8
GLP,FRA,2020.0,27,33,-6
KOR,BEL,2012.0,7,8,-1
IND,CAN,2022.0,175,113,62
GBR,KOR,2019.0,59,87,-28
CHE,AUT,2003.0,25,38,-13
IND,CZE,2021.0,51,15,36
THA,JPN,2019.0,106,143,-37
SAU,DEU,2021.0,25,33,-8
NGA,TUR,2017.0,4,4,0
ESP,MAR,2016.0,13,6,7
FRA,IRN,2021.0,20,52,-32
USA,SGP,2022.0,190,165,25
DEU,DNK,2022.0,135,105,30
BGD,AUS,2022.0,71,70,1
USA,ARM,2017.0,6,7,-1
CAN,HUN,2019.0,9,9,0
IRN,BRA,2015.0,12,2,10
PRT,DEU,2021.0,52,49,3
POL,ITA,2020.0,17,37,-20
BGD,CAN,2022.0,43,15,28
ZAF,ZWE,2023.0,26,21,5
CHN,KOR,2021.0,193,321,-128
IRL,USA,2023.0,89,76,13
GBR,CZE,2023.0,24,22,2
ITA,CAN,2015.0,88,53,35
ETH,GBR,2021.0,10,14,-4
JOR,MYS,2023.0,8,24,-16
JPN,PHL,2021.0,28,24,4
RUS,ITA,2021.0,26,24,2
GBR,KOR,2021.0,74,85,-11
CZE,GRC,2022.0,9,2,7
FRA,CHE,1997.0,121,109,12
USA,NGA,2022.0,40,139,-99
LTU,DEU,2022.0,5,7,-2
LKA,CHN,2021.0,4,10,-6
TWN,IND,2021.0,61,96,-35
COG,BEN,2021.0,2,1,1
IRN,AUS,2023.0,80,25,55
USA,KEN,2021.0,56,71,-15
TUN,CZE,2021.0,7,2,5
MYS,SAU,2018.0,87,31,56
TWN,JPN,2021.0,70,61,9
IRL,DEU,2022.0,48,39,9
GBR,ZAF,2022.0,87,140,-53
KOR,DEU,2021.0,70,65,5
THA,IND,2021.0,20,23,-3
ESP,MOZ,2021.0,3,3,0
OMN,MYS,2020.0,4,25,-21
RUS,DEU,2022.0,152,57,95
USA,CZE,2021.0,62,72,-10
NGA,ZAF,2022.0,88,108,-20
CZE,USA,2023.0,48,38,10
ZAF,CIV,2022.0,3,2,1
AUS,VNM,2016.0,37,36,1
DEU,IND,2022.0,132,220,-88
CHE,SWE,2021.0,72,65,7
IND,ZAF,2023.0,22,39,-17
CAN,BRA,2018.0,90,144,-54
USA,IRQ,2023.0,24,7,17
CHL,URY,2021.0,7,3,4
PRK,KOR,2021.0,5,11,-6
ETH,CHN,2021.0,20,47,-27
BGR,DEU,2021.0,10,8,2
NOR,RUS,2021.0,4,17,-13
VNM,ITA,2021.0,3,9,-6
TUR,CHE,2018.0,26,15,11
USA,IRN,2021.0,157,509,-352
BEL,ESP,2021.0,70,99,-29
ITA,BEL,2021.0,116,106,10
IRL,BEL,2020.0,16,10,6
RUS,ISR,2004.0,15,11,4
ISR,RUS,2018.0,10,15,-5
GBR,GIB,2021.0,2,2,0
CAN,IRL,2022.0,47,42,5
LVA,SWE,2022.0,2,2,0
TUR,EGY,2019.0,3,4,-1
FRA,IRN,2011.0,23,23,0
AUS,NZL,1999.0,77,101,-24
PRT,DEU,2011.0,25,31,-6
PRT,BRA,2023.0,91,110,-19
FRA,IDN,2022.0,7,7,0
ZAF,UGA,2018.0,17,15,2
MEX,ESP,2015.0,139,189,-50
JPN,GHA,2022.0,5,6,-1
DEU,EGY,2022.0,36,46,-10
IND,THA,2022.0,27,21,6
CAN,PER,2023.0,3,4,-1
CAN,DEU,2022.0,139,154,-15
IDN,CHN,2020.0,12,12,0
ITA,CHN,2021.0,81,81,0
AUT,GBR,2015.0,84,85,-1
QAT,PAK,2023.0,9,10,-1
MYS,IRL,2022.0,7,3,4
PRT,CAN,2019.0,17,11,6
AFG,IRN,2021.0,5,4,1
CIV,CAN,2009.0,1,1,0
DEU,UKR,2016.0,16,47,-31
ARE,GBR,2016.0,29,47,-18
HUN,IRN,2021.0,4,8,-4
RUS,UKR,2021.0,73,90,-17
SWE,BEL,2022.0,19,21,-2
CAN,CYP,2018.0,6,1,5
CAN,IRN,2021.0,84,492,-408
ECU,BRA,2022.0,8,14,-6
COL,ESP,2007.0,22,36,-14
CHE,NLD,2001.0,38,62,-24
SGP,IND,2020.0,98,106,-8
CAN,BGD,2021.0,32,41,-9
MYS,USA,2022.0,62,35,27
MAC,CHN,2020.0,261,236,25
MYS,VNM,2022.0,8,10,-2
UKR,ISR,2023.0,6,1,5
PAK,LTU,2023.0,2,3,-1
SWE,GBR,1999.0,86,73,13
KOR,BGD,2022.0,40,32,8
DEU,SWE,2004.0,101,88,13
BRA,BEL,2022.0,32,13,19
SGP,AUS,2020.0,101,87,14
PAK,BRA,2013.0,10,5,5
AUT,NLD,2012.0,19,30,-11
BGD,HKG,2023.0,7,3,4
CHN,ITA,2002.0,21,11,10
FRA,KAZ,2014.0,1,1,0
CAN,MEX,2011.0,29,35,-6
USA,HUN,1999.0,65,93,-28
USA,TZA,2003.0,13,6,7
DEU,ARG,2000.0,22,18,4
AUT,GBR,2001.0,42,33,9
CUB,ESP,2000.0,32,22,10
ITA,MEX,2004.0,3,7,-4
FRA,LBN,1998.0,26,11,15
GBR,JOR,2002.0,4,2,2
AUS,GBR,2000.0,320,347,-27
JOR,ARE,2011.0,13,3,10
AUT,USA,2000.0,124,91,33
GBR,BRA,2000.0,81,41,40
AUT,SVN,2001.0,7,4,3
NLD,BEL,2006.0,77,101,-24
RUS,JPN,2010.0,20,24,-4
DEU,POL,1997.0,45,55,-10
GBR,IRL,1997.0,84,86,-2
IRL,USA,2000.0,54,69,-15
IND,FRA,2006.0,47,31,16
FRA,HRV,1999.0,3,5,-2
USA,PAK,2004.0,34,33,1
ISR,JPN,1998.0,3,5,-2
JPN,NLD,2004.0,13,25,-12
FRA,NLD,2002.0,110,91,19
SVN,CHE,1997.0,2,1,1
ITA,CAN,2001.0,44,45,-1
CHL,DEU,2002.0,14,15,-1
CAN,KOR,2014.0,38,48,-10
AUS,USA,1997.0,288,332,-44
ESP,SWE,1998.0,14,12,2
IND,CZE,2009.0,5,2,3
USA,CZE,2011.0,51,56,-5
ITA,CZE,2015.0,23,9,14
USA,QAT,2006.0,9,3,6
ITA,QAT,2015.0,8,2,6
RUS,SWE,2010.0,13,19,-6
DEU,NLD,2004.0,164,155,9
FRA,POL,2001.0,56,32,24
ISR,DEU,2002.0,47,48,-1
DEU,ISR,2004.0,22,38,-16
BEL,POL,2006.0,11,6,5
JPN,RUS,1999.0,28,49,-21
CAN,LKA,1999.0,1,1,0
LKA,CAN,2002.0,1,2,-1
VNM,GBR,1999.0,2,2,0
SWE,TUR,2002.0,4,1,3
RUS,DEU,2016.0,118,126,-8
MDG,SEN,2001.0,4,2,2
CZE,DEU,1999.0,24,32,-8
RUS,MDA,1997.0,2,3,-1
RUS,FIN,2013.0,18,15,3
BEL,TUR,2000.0,5,5,0
CAN,JPN,1997.0,83,81,2
NLD,SWE,2003.0,39,39,0
JPN,CHE,2002.0,36,32,4
GBR,SAU,2012.0,97,16,81
GBR,NZL,2014.0,127,118,9
GBR,ROU,2005.0,13,9,4
USA,PRT,2002.0,54,41,13
AFG,USA,2011.0,8,10,-2
USA,PHL,2002.0,29,27,2
DEU,AUT,2023.0,219,175,44
DEU,HRV,2010.0,17,16,1
HRV,USA,1999.0,17,16,1
NLD,BEL,2000.0,92,82,10
USA,BEL,1999.0,97,141,-44
DEU,SRB,2006.0,28,40,-12
ROU,FRA,2001.0,24,22,2
ARE,EGY,2012.0,15,14,1
GEO,USA,2007.0,27,35,-8
OMN,ARE,2000.0,6,1,5
DEU,CHN,2000.0,77,112,-35
DEU,CHL,2003.0,15,16,-1
ESP,ISR,2005.0,1,6,-5
ISR,ESP,2007.0,4,5,-1
NOR,USA,2003.0,76,89,-13
ESP,BGR,2005.0,4,3,1
DNK,IND,2000.0,6,8,-2
AUT,CZE,2005.0,10,7,3
FRA,FIN,1999.0,13,10,3
NOR,SWE,2000.0,36,42,-6
ITA,NLD,1999.0,62,57,5
ESP,CHL,1999.0,23,26,-3
USA,CHL,2003.0,79,68,11
USA,GRC,1998.0,115,57,58
SWE,CHE,2000.0,30,24,6
NLD,AUS,2002.0,31,34,-3
CHE,BEL,2006.0,18,21,-3
FRA,UKR,2001.0,8,12,-4
UKR,USA,2002.0,50,38,12
ROU,ESP,2002.0,4,2,2
BGR,USA,2015.0,18,13,5
TUR,CZE,2017.0,6,3,3
BEL,NLD,1998.0,63,60,3
IND,BGD,2002.0,15,12,3
FRA,BEL,1998.0,110,86,24
GRC,DEU,1998.0,19,29,-10
JPN,TWN,2001.0,25,8,17
NLD,AUS,1997.0,15,13,2
ESP,POL,2001.0,6,5,1
DEU,LUX,2013.0,42,13,29
CZE,DEU,1998.0,22,16,6
FIN,RUS,2017.0,30,27,3
FIN,RUS,2022.0,13,53,-40
IRL,GBR,2006.0,171,208,-37
CAN,TUR,2010.0,18,17,1
BRA,AUS,2014.0,52,19,33
RUS,UKR,2019.0,57,110,-53
NLD,GHA,2000.0,1,1,0
CHE,ISR,2003.0,8,21,-13
USA,HUN,1998.0,69,79,-10
BEL,NLD,1999.0,75,66,9
NZL,JPN,1997.0,7,10,-3
FRA,VEN,1999.0,13,10,3
ESP,CHE,1997.0,26,21,5
URY,USA,2013.0,12,6,6
SWE,AUS,2016.0,46,55,-9
FRA,RUS,2009.0,47,57,-10
FIN,GBR,1997.0,28,20,8
UKR,GBR,2005.0,17,4,13
GBR,UKR,2006.0,16,24,-8
SAU,USA,1998.0,26,30,-4
LTU,NOR,2001.0,4,1,3
USA,SRB,1997.0,27,18,9
USA,ZAF,1998.0,38,67,-29
IRN,AUS,2010.0,62,32,30
RUS,KOR,2001.0,12,8,4
ZWE,ZAF,2007.0,19,3,16
DEU,FIN,2002.0,34,36,-2
BEL,ITA,2006.0,39,32,7
USA,NCL,2015.0,1,2,-1
NLD,CAN,1998.0,34,31,3
SRB,FRA,2007.0,17,4,13
MYS,USA,2016.0,50,44,6
ESP,JPN,2009.0,16,23,-7
VEN,ESP,1999.0,11,9,2
ESP,VEN,2004.0,21,27,-6
DEU,JOR,1997.0,4,2,2
JOR,DEU,1998.0,2,5,-3
ARE,BHR,2007.0,2,2,0
UKR,JPN,2000.0,11,3,8
JPN,UKR,2007.0,1,2,-1
ZAF,BWA,2019.0,16,9,7
AUS,CHE,2001.0,37,32,5
SWE,USA,1997.0,174,149,25
MEX,ITA,2009.0,9,11,-2
ESP,DEU,2006.0,94,110,-16
FRA,IRL,2004.0,13,15,-2
HUN,AUT,2008.0,17,8,9
USA,SRB,2002.0,26,46,-20
ESP,CHE,2002.0,29,30,-1
TUR,ESP,2000.0,1,1,0
BEL,DNK,1997.0,5,5,0
UKR,USA,1997.0,41,13,28
ZAF,FRA,2012.0,18,24,-6
RUS,IRL,2006.0,6,4,2
SWE,GBR,1998.0,68,66,2
DEU,DNK,2017.0,125,99,26
SGP,GBR,2014.0,80,133,-53
FRA,UKR,2008.0,7,11,-4
AUS,NPL,2002.0,4,2,2
TUR,AZE,2017.0,12,6,6
AZE,TUR,2018.0,6,14,-8
EST,SWE,1998.0,8,4,4
BGR,USA,2001.0,46,12,34
MAR,DEU,2000.0,2,5,-3
NOR,LTU,2014.0,2,2,0
SWE,NOR,1997.0,25,20,5
GEO,USA,1998.0,26,10,16
CAN,ISR,2021.0,55,65,-10
PAK,CHN,2005.0,3,2,1
FRA,ITA,2017.0,284,398,-114
DEU,ISR,2001.0,44,46,-2
NLD,VNM,2000.0,4,2,2
ZWE,USA,2002.0,11,7,4
CAN,NOR,2010.0,21,11,10
FRA,SVK,2000.0,3,8,-5
USA,GRC,1999.0,82,80,2
CAN,TWN,2000.0,16,6,10
SWE,POL,2006.0,8,10,-2
RUS,KAZ,2021.0,57,33,24
AUS,NLD,2020.0,80,85,-5
CAN,CHE,1999.0,57,44,13
DNK,CAN,1999.0,15,20,-5
CAN,DNK,2004.0,10,18,-8
USA,LBN,2019.0,63,103,-40
FRA,BEL,1999.0,116,124,-8
AUT,CZE,1997.0,9,6,3
GBR,MEX,1999.0,40,22,18
FIN,RUS,2016.0,33,31,2
RUS,FIN,2003.0,27,26,1
FRA,REU,2007.0,29,23,6
BRA,CHL,2009.0,15,18,-3
FRA,TUR,2004.0,4,13,-9
DEU,POL,2005.0,55,74,-19
PRT,FRA,2002.0,27,49,-22
HUN,CAN,2009.0,7,6,1
CAN,HUN,2011.0,9,5,4
BRA,DEU,2000.0,26,49,-23
ZAF,CAN,2002.0,23,12,11
MMR,USA,2000.0,2,1,1
SWE,CHE,2023.0,43,33,10
SVK,SVN,2011.0,5,36,-31
FRA,GUF,2012.0,27,23,4
MWI,GBR,2023.0,19,9,10
RUS,MEX,1998.0,12,7,5
USA,SRB,2005.0,46,15,31
MCO,FRA,2006.0,7,9,-2
RUS,AUT,2005.0,13,7,6
ITA,SAU,2016.0,18,10,8
USA,MAR,2004.0,3,3,0
IND,CHE,1997.0,8,8,0
CHE,IND,1998.0,8,7,1
BEL,IRN,2011.0,18,12,6
ARE,ITA,2008.0,1,1,0
ITA,ARE,2010.0,1,2,-1
USA,TUN,2011.0,8,11,-3
IDN,USA,2022.0,43,39,4
RUS,USA,2019.0,226,190,36
HKG,PHL,1997.0,1,1,0
PHL,USA,2018.0,48,44,4
LBN,FRA,2002.0,15,20,-5
CHE,AUS,2002.0,30,37,-7
ISR,ITA,2007.0,5,8,-3
NOR,GBR,2016.0,65,72,-7
AUS,POL,2009.0,6,8,-2
USA,HRV,1997.0,12,11,1
NLD,FIN,1999.0,12,12,0
PNG,USA,2004.0,2,1,1
BLR,DEU,2000.0,14,9,5
GRC,DEU,1999.0,22,31,-9
DNK,BEL,2000.0,8,5,3
USA,MEX,1997.0,115,93,22
JPN,ITA,1998.0,24,30,-6
FIN,FRA,2013.0,21,24,-3
AUS,IRL,2007.0,25,32,-7
NOR,ESP,2000.0,7,4,3
EGY,ARE,2007.0,8,10,-2
VEN,GBR,1998.0,5,11,-6
BGD,IND,2015.0,8,14,-6
GRC,DEU,2020.0,83,54,29
GBR,NOR,1998.0,23,21,2
DEU,GRC,2003.0,40,27,13
BGR,TUR,2001.0,2,1,1
USA,LVA,2012.0,8,3,5
FRA,ESP,2003.0,152,135,17
JPN,KOR,2004.0,136,109,27
USA,IND,1997.0,190,232,-42
NLD,IRL,2018.0,15,26,-11
GBR,TWN,2012.0,42,24,18
PRT,BRA,2000.0,41,29,12
DEU,SAU,2003.0,3,2,1
JPN,GBR,1998.0,115,128,-13
POL,ITA,1999.0,20,14,6
ITA,SRB,2009.0,5,8,-3
BEL,SGP,2018.0,10,5,5
TUR,TWN,2003.0,4,1,3
SGP,GBR,2001.0,33,50,-17
ZAF,CAN,2012.0,16,19,-3
RUS,GBR,2013.0,45,50,-5
POL,CHE,2006.0,9,9,0
AUS,QAT,2017.0,10,10,0
USA,GHA,2023.0,21,35,-14
NZL,SGP,2001.0,6,5,1
SGP,NZL,2007.0,6,6,0
AUT,BEL,2000.0,6,3,3
AUT,CHE,2003.0,38,25,13
UKR,POL,2000.0,22,16,6
DNK,NZL,2001.0,5,3,2
NLD,CZE,2014.0,14,8,6
AUT,RUS,2011.0,9,12,-3
GBR,AUT,1998.0,20,18,2
ROU,AUT,2020.0,4,3,1
RUS,NLD,1997.0,17,14,3
FRA,CAF,1998.0,3,1,2
RUS,JPN,2006.0,26,34,-8
RUS,KOR,2015.0,8,9,-1
MEX,CUB,2012.0,14,20,-6
DNK,ITA,1998.0,7,22,-15
DEU,CAN,1998.0,92,75,17
ITA,CAN,2004.0,39,26,13
IRL,GBR,2000.0,144,171,-27
RUS,ISR,2008.0,13,9,4
NLD,CAN,1999.0,24,33,-9
FRA,GUF,2002.0,14,7,7
GUF,FRA,2007.0,6,15,-9
BRA,CUB,2001.0,5,5,0
MYS,USA,2018.0,79,37,42
HKG,FRA,2007.0,8,8,0
TUR,IND,2013.0,4,6,-2
BRA,DNK,2018.0,27,9,18
DEU,ZAF,2007.0,25,16,9
HKG,CAN,2018.0,18,35,-17
COD,BEL,2008.0,1,1,0
USA,COL,1999.0,41,24,17
GBR,POL,2006.0,24,36,-12
CZE,USA,2000.0,48,44,4
AUT,JPN,2020.0,13,11,2
DEU,NLD,2001.0,185,175,10
USA,MYS,2007.0,21,26,-5
FIN,SWE,2000.0,50,38,12
SGP,CAN,2009.0,28,32,-4
EGY,SWE,2018.0,11,6,5
KOR,RUS,2001.0,8,12,-4
FIN,DNK,2011.0,15,13,2
DEU,EST,2001.0,5,2,3
SWE,NOR,2002.0,61,39,22
ESP,FIN,2003.0,10,7,3
FIN,GBR,2005.0,35,35,0
GBR,ETH,2003.0,7,7,0
CHE,PHL,2013.0,6,3,3
SAU,ARE,1998.0,3,3,0
HRV,USA,1998.0,16,14,2
USA,HRV,2005.0,18,17,1
COL,BRA,2014.0,56,28,28
PAN,USA,2004.0,10,11,-1
PAN,USA,2014.0,16,25,-9
TUN,USA,2002.0,7,3,4
GBR,BGR,2010.0,10,18,-8
BEL,MEX,1998.0,4,1,3
SWE,JPN,1999.0,31,30,1
PAK,BGD,1998.0,2,1,1
BGD,PAK,2004.0,2,4,-2
BGD,PAK,2015.0,13,10,3
NOR,ISL,2004.0,5,2,3
FIN,JPN,2004.0,11,8,3
POL,UKR,2000.0,16,22,-6
GBR,RUS,2022.0,39,86,-47
ESP,HUN,2008.0,3,4,-1
ISR,CHN,2016.0,12,16,-4
SWE,IND,1999.0,6,11,-5
KOR,PAK,2005.0,2,2,0
ZAF,AUS,2008.0,36,24,12
MEX,CAN,2003.0,25,16,9
IRL,AUS,2003.0,14,23,-9
UKR,TUR,1997.0,2,2,0
ARG,AUS,2003.0,9,3,6
BRA,CHL,2021.0,50,19,31
NGA,KWT,1999.0,4,3,1
RUS,CHN,1998.0,6,5,1
SRB,GBR,2000.0,14,8,6
FRA,AUT,1997.0,6,13,-7
ESP,RUS,2007.0,14,11,3
FRA,FIN,2020.0,31,17,14
NGA,ITA,2016.0,2,2,0
SWE,PRT,2002.0,11,5,6
SWE,PRT,2005.0,10,7,3
PRT,SWE,2021.0,20,8,12
BEL,FRA,1998.0,86,110,-24
ARG,DEU,2005.0,23,11,12
ECU,FRA,2009.0,6,3,3
BWA,ZAF,2006.0,7,2,5
CMR,USA,2000.0,6,4,2
LBN,USA,2002.0,34,20,14
CAN,NLD,2000.0,40,34,6
CAN,TUR,2000.0,7,14,-7
JPN,HUN,2013.0,6,7,-1
NZL,SGP,2014.0,12,8,4
DEU,NOR,2001.0,28,22,6
JPN,KOR,2015.0,121,105,16
NLD,IND,2006.0,12,16,-4
ARG,ESP,2000.0,77,58,19
RUS,MDA,2005.0,8,1,7
MDA,RUS,2006.0,2,3,-1
VEN,DEU,2002.0,8,3,5
DNK,RUS,2012.0,4,6,-2
ISR,ITA,1999.0,9,10,-1
NLD,SAU,2012.0,2,1,1
LBN,CAN,2019.0,13,15,-2
EGY,DEU,2020.0,52,67,-15
RWA,USA,2023.0,8,10,-2
BGD,AUS,2018.0,75,44,31
HKG,GBR,2001.0,37,39,-2
ETH,SWE,2013.0,2,4,-2
MYS,ARE,2020.0,35,6,29
IRL,GBR,2023.0,225,208,17
NLD,PRT,2005.0,12,6,6
SGP,BGD,2018.0,6,2,4
PAK,TUR,2016.0,11,11,0
CHL,CHE,2016.0,5,7,-2
THA,IRN,2019.0,2,2,0
ZMB,USA,2016.0,26,14,12
EGY,CHN,2020.0,61,48,13
BRA,BEL,2017.0,36,21,15
BGD,CAN,2017.0,31,20,11
GBR,THA,2023.0,36,32,4
CHN,FRA,2013.0,127,162,-35
MEX,ESP,2014.0,124,202,-78
IND,ISR,2017.0,110,45,65
PHL,AUS,2019.0,21,14,7
MYS,USA,2017.0,68,37,31
NPL,AUS,2017.0,16,9,7
NPL,AUS,2022.0,28,8,20
AZE,TUR,2017.0,6,12,-6
HUN,UKR,2015.0,1,3,-2
NLD,BRA,2016.0,37,44,-7
CZE,SWE,2021.0,19,20,-1
EGY,FRA,2017.0,16,19,-3
POL,AUT,2018.0,7,11,-4
DNK,GBR,2018.0,115,127,-12
KOR,ETH,2019.0,15,4,11
TWN,CAN,2020.0,21,13,8
CHN,CHE,2023.0,79,70,9
CHN,ESP,2017.0,35,57,-22
FRA,KOR,1998.0,8,6,2
JPN,CHE,2012.0,49,35,14
EGY,JPN,2016.0,45,67,-22
BRA,ZAF,2020.0,10,6,4
FRA,REU,2020.0,31,17,14
NOR,AUS,2021.0,13,25,-12
ZAF,KEN,2023.0,18,14,4
CAN,MEX,2021.0,36,69,-33
MYS,LBY,2018.0,16,2,14
HUN,IRL,2017.0,6,2,4
HUN,CAN,2021.0,11,5,6
GMB,MLI,2020.0,1,1,0
JPN,LKA,2020.0,26,3,23
JAM,TTO,2022.0,3,1,2
COL,KHM,2018.0,2,1,1
BEL,BRA,2020.0,19,30,-11
AUS,ARE,2023.0,20,12,8
ISR,CHN,2022.0,45,34,11
DEU,BGD,2015.0,12,8,4
ROU,AUS,2016.0,4,2,2
CAN,IRL,2017.0,36,44,-8
SGP,KOR,2021.0,32,24,8
CAN,HKG,2014.0,26,24,2
CAN,PRT,2019.0,11,17,-6
SAU,GRC,2021.0,3,3,0
ISL,DNK,2013.0,9,6,3
AUT,FIN,2020.0,7,15,-8
UKR,CZE,2013.0,13,2,11
GRC,AUS,2018.0,14,10,4
THA,AUS,2016.0,23,41,-18
SWE,KOR,2018.0,14,20,-6
FRA,TUN,2022.0,59,87,-28
DEU,GHA,2018.0,16,9,7
THA,USA,2019.0,136,239,-103
ARE,GBR,2017.0,26,82,-56
BEL,COG,2015.0,10,9,1
SLE,USA,2020.0,4,10,-6
IRQ,MYS,2015.0,25,54,-29
NLD,BRA,2017.0,32,42,-10
SGP,HKG,2013.0,27,34,-7
TWN,ISR,2022.0,6,1,5
FRA,LBN,2020.0,93,86,7
ECU,CHL,2018.0,11,20,-9
USA,OMN,2019.0,7,8,-1
FIN,DNK,2019.0,19,14,5
CHL,BRA,2021.0,19,50,-31
FRA,DNK,2019.0,72,37,35
HRV,BIH,2019.0,21,10,11
COL,CHL,2020.0,45,22,23
SRB,USA,2018.0,34,9,25
PAK,KOR,2015.0,48,31,17
COL,CAN,2017.0,24,23,1
USA,IRN,2011.0,73,239,-166
FIN,AUS,2017.0,17,18,-1
MEX,CHE,2003.0,4,2,2
UKR,USA,2005.0,46,29,17
KOR,OMN,2018.0,5,1,4
MLT,ESP,2018.0,1,1,0
CZE,EGY,2013.0,4,3,1
FRA,POL,2015.0,30,28,2
PRT,NLD,2020.0,33,30,3
NLD,PAK,2020.0,13,8,5
IRL,DNK,2021.0,16,6,10
USA,CIV,2016.0,8,2,6
KOR,CHE,2013.0,15,16,-1
CHE,KOR,2014.0,8,14,-6
SWE,DEU,2018.0,169,188,-19
ESP,AUT,2019.0,36,40,-4
FIN,PAK,2018.0,7,2,5
CAN,IND,2021.0,107,178,-71
FIN,DEU,2017.0,73,60,13
IRL,SAU,2019.0,10,3,7
AUS,JOR,2017.0,14,7,7
TZA,ZAF,2017.0,7,14,-7
JPN,FIN,2013.0,17,13,4
CHN,AUT,2015.0,23,17,6
UGA,USA,2015.0,27,31,-4
KOR,POL,2019.0,6,2,4
HRV,FRA,2023.0,2,2,0
BRA,PRT,2022.0,194,143,51
PRT,ITA,2016.0,30,31,-1
FIN,EST,2019.0,14,19,-5
EST,FIN,2022.0,12,18,-6
FRA,COG,2017.0,6,4,2
CHL,CHE,2018.0,11,11,0
SEN,FRA,2016.0,48,37,11
IND,MEX,2021.0,14,9,5
EGY,RUS,2022.0,4,22,-18
POL,NOR,2020.0,16,14,2
TUR,GBR,2010.0,48,46,2
GBR,TUR,2014.0,54,46,8
JPN,IND,2017.0,72,105,-33
PAN,USA,2015.0,20,13,7
NZL,TWN,2018.0,3,3,0
PER,GBR,2019.0,9,4,5
ISL,SWE,2018.0,20,13,7
SDN,SAU,2021.0,43,22,21
IRQ,RUS,2019.0,3,11,-8
CHN,KEN,2022.0,17,8,9
AUS,SGP,2018.0,129,89,40
CHE,GTM,2018.0,2,1,1
NOR,FIN,2020.0,30,36,-6
JPN,NOR,2018.0,9,8,1
CHE,CHN,2008.0,26,42,-16
USA,EGY,2022.0,110,140,-30
SGP,NOR,2007.0,4,1,3
VEN,DEU,2005.0,5,4,1
DEU,VEN,2006.0,4,2,2
SWE,BOL,2020.0,7,6,1
JPN,GHA,2017.0,8,7,1
CHN,FIN,2021.0,50,58,-8
CHL,ESP,2017.0,97,161,-64
NZL,CHN,2017.0,28,33,-5
POL,SGP,2016.0,2,4,-2
ESP,BRA,2019.0,119,115,4
FRA,GIN,2017.0,8,8,0
GIN,FRA,2018.0,2,5,-3
MYS,CHN,2020.0,78,37,41
CHN,MYS,2023.0,73,76,-3
FRA,HKG,2015.0,9,8,1
DNK,SVK,2015.0,1,1,0
MEX,PRT,2017.0,4,7,-3
NLD,BRA,2018.0,38,43,-5
AUS,RUS,2015.0,16,13,3
CHN,FIN,2011.0,18,14,4
CHN,KOR,2019.0,146,308,-162
BRA,PRT,2017.0,150,199,-49
RUS,ARM,2017.0,7,7,0
IND,ISR,2016.0,118,27,91
IND,ROU,2019.0,2,2,0
ESP,JPN,2019.0,21,22,-1
AUS,DEU,2011.0,150,173,-23
SGP,IRL,2016.0,3,8,-5
ESP,LUX,2020.0,10,4,6
ESP,BEL,2016.0,84,49,35
TWN,IND,2019.0,46,81,-35
POL,DEU,2016.0,89,73,16
PAK,VNM,2020.0,11,2,9
TWN,AUS,2017.0,25,8,17
MOZ,USA,2020.0,8,13,-5
NLD,BRA,2022.0,24,56,-32
GBR,ISR,2018.0,51,69,-18
TUR,ZAF,2017.0,8,1,7
NZL,IRN,2017.0,11,14,-3
BRA,DNK,2022.0,31,4,27
DNK,BEL,2006.0,6,3,3
FRA,ROU,2000.0,21,29,-8
GBR,EST,2015.0,6,12,-6
FRA,IRN,2019.0,22,46,-24
TUR,SWE,2016.0,14,10,4
RUS,SRB,2017.0,4,4,0
GRC,DNK,2017.0,14,4,10
TUR,SWE,2017.0,27,9,18
SVN,BEL,2013.0,2,2,0
GBR,PRT,2013.0,66,85,-19
FIN,MYS,2016.0,4,2,2
SWE,CAN,2023.0,15,28,-13
THA,MYS,2019.0,8,9,-1
RUS,LVA,2017.0,5,3,2
RUS,BLR,1997.0,18,16,2
THA,GBR,2011.0,34,76,-42
PRT,CHL,2020.0,5,3,2
POL,NOR,2007.0,6,4,2
DNK,BRA,2021.0,8,32,-24
ISR,GBR,2022.0,55,40,15
RUS,SGP,2004.0,3,2,1
IND,AUT,2023.0,11,4,7
THA,JPN,2021.0,62,133,-71
IND,HUN,2022.0,9,6,3
CHE,JPN,2020.0,41,44,-3
SDN,KOR,2020.0,2,3,-1
USA,IDN,2022.0,39,43,-4
THA,IDN,2020.0,34,18,16
AUS,SGP,2022.0,70,53,17
IND,NGA,2022.0,14,15,-1
SVN,USA,2021.0,8,10,-2
HUN,BEL,2021.0,6,6,0
JOR,DEU,2020.0,11,14,-3
BRA,NOR,2019.0,8,3,5
IND,LUX,2019.0,5,2,3
PHL,GBR,2023.0,5,4,1
SVN,CZE,2011.0,3,1,2
FRA,BOL,2020.0,1,2,-1
VNM,NLD,2021.0,8,13,-5
CAN,BRA,2022.0,75,176,-101
AUT,THA,2023.0,5,1,4
PRT,USA,2020.0,62,79,-17
SAU,QAT,2017.0,17,6,11
AUS,VNM,2022.0,69,34,35
CZE,DEU,2020.0,56,74,-18
IRN,DEU,2013.0,87,31,56
DEU,IRN,2015.0,38,98,-60
USA,VNM,2020.0,63,40,23
IRN,DNK,2022.0,42,17,25
IDN,SWE,2019.0,5,1,4
YEM,MYS,2016.0,2,17,-15
ZAF,ETH,2020.0,17,9,8
ITA,CHL,2020.0,19,16,3
EGY,NLD,2022.0,9,8,1
NLD,MEX,2019.0,8,22,-14
MEX,DEU,2009.0,37,27,10
RUS,GIN,2019.0,1,1,0
FRA,MYS,2021.0,6,7,-1
FRA,KOR,2020.0,14,37,-23
IND,GBR,1998.0,63,58,5
HUN,AUT,2014.0,27,14,13
USA,HKG,2003.0,75,110,-35
HUN,PAK,2021.0,3,5,-2
DEU,NGA,2019.0,11,12,-1
THA,MYS,2021.0,5,21,-16
LBN,DEU,2021.0,11,3,8
GBR,MLT,2020.0,27,9,18
CHN,MEX,2022.0,7,13,-6
ROU,BEL,2023.0,3,3,0
MYS,TUR,2015.0,11,1,10
DNK,FRA,2002.0,23,28,-5
PRT,DEU,2019.0,52,35,17
IRL,IND,2021.0,19,38,-19
GRC,NLD,2019.0,33,28,5
ECU,ESP,2019.0,60,76,-16
NOR,AUT,2020.0,12,17,-5
ZMB,AUS,2020.0,3,2,1
MYS,KAZ,2021.0,4,1,3
USA,MLI,2003.0,2,4,-2
BGD,AUS,2017.0,77,37,40
RUS,EST,2020.0,6,1,5
FIN,CAN,2018.0,25,22,3
COL,MEX,2019.0,56,68,-12
BGR,GBR,2021.0,5,3,2
DEU,GAB,2017.0,7,3,4
USA,RWA,2019.0,20,13,7
DEU,GHA,2022.0,18,11,7
THA,JPN,2011.0,70,94,-24
BFA,USA,2020.0,3,4,-1
KOR,HKG,2020.0,18,23,-5
IRN,IRL,2021.0,24,5,19
GBR,CHL,2022.0,35,50,-15
ECU,CAN,2020.0,11,3,8
ESP,DEU,2024.0,1,2,-1
CHL,ESP,2018.0,111,143,-32
IRL,IND,2011.0,10,12,-2
PAK,CHE,2004.0,1,4,-3
IND,AUS,1997.0,13,14,-1
USA,BGD,2000.0,6,22,-16
FIN,DEU,2018.0,76,53,23
LBN,SDN,2019.0,2,1,1
JPN,NOR,2022.0,12,10,2
CHE,FIN,2021.0,18,16,2
KOR,RUS,2014.0,14,7,7
SWE,ISL,2021.0,20,25,-5
SAU,CAN,2020.0,76,178,-102
ECU,CHL,2017.0,9,8,1
IND,POL,2023.0,40,17,23
USA,DNK,2000.0,117,115,2
PAK,CAN,2020.0,33,26,7
IRN,BEL,2020.0,39,6,33
HRV,SRB,2019.0,18,17,1
ITA,DNK,2023.0,27,22,5
SWE,LUX,2020.0,3,3,0
ZAF,DEU,2020.0,54,41,13
BEL,TUR,2023.0,6,9,-3
CAN,CMR,2019.0,6,4,2
CAN,SVK,2018.0,2,2,0
IDN,MYS,2020.0,38,123,-85
POL,GBR,2023.0,42,48,-6
DEU,PAK,2023.0,13,15,-2
ESP,GRC,2003.0,4,4,0
ITA,FIN,2001.0,12,14,-2
AGO,PRT,2014.0,3,4,-1
GBR,ZWE,2020.0,8,10,-2
ESP,DOM,2020.0,5,5,0
THA,NLD,2021.0,8,11,-3
TUR,SRB,2019.0,13,1,12
KOR,CHN,2014.0,202,82,120
PSE,ITA,2021.0,3,3,0
ESP,ARG,2021.0,120,103,17
CZE,BEL,2021.0,4,15,-11
NZL,CHN,2022.0,77,33,44
IRL,CAN,2021.0,42,52,-10
EGY,USA,2023.0,85,68,17
ESP,PER,2013.0,17,10,7
MYS,BRN,2013.0,5,3,2
GHA,USA,2021.0,53,35,18
NZL,DEU,2011.0,34,39,-5
ITA,CZE,2004.0,9,5,4
USA,PAN,2023.0,9,22,-13
PSE,JOR,2022.0,2,5,-3
USA,KNA,2021.0,4,9,-5
USA,LBR,2022.0,56,11,45
GRC,DNK,2022.0,12,7,5
HKG,CAN,2022.0,35,21,14
SVN,ITA,2022.0,12,12,0
ITA,JOR,2022.0,5,4,1
USA,LTU,2023.0,8,6,2
AUS,QAT,2018.0,6,7,-1
IRN,DNK,2018.0,21,15,6
USA,KGZ,2021.0,2,2,0
VNM,TWN,2022.0,31,71,-40
DZA,ESP,2023.0,1,4,-3
USA,CRI,2019.0,34,25,9
COL,DOM,2022.0,1,1,0
PAK,DNK,2023.0,9,4,5
TLS,AUS,2022.0,1,2,-1
AUS,TLS,2023.0,4,6,-2
ESP,URY,2021.0,16,13,3
IND,TZA,2021.0,3,1,2
JPN,NPL,2023.0,4,5,-1
IND,CHN,2014.0,61,26,35
CHN,IND,2016.0,28,135,-107
ETH,TWN,2023.0,6,7,-1
YEM,SAU,2023.0,14,6,8
FIN,AUT,2021.0,17,12,5
CHN,CHL,2023.0,3,1,2
NOR,ESP,2023.0,10,16,-6
ARE,USA,2023.0,49,48,1
BEL,GBR,2019.0,149,173,-24
NLD,CHL,2022.0,9,17,-8
KOR,IND,2017.0,147,258,-111
FRA,LUX,2023.0,22,15,7
CUB,ITA,2022.0,6,2,4
USA,ETH,2023.0,15,27,-12
GHA,GBR,2022.0,27,20,7
USA,QAT,2023.0,23,45,-22
TUR,CHE,2022.0,23,10,13
SGP,FRA,2022.0,26,15,11
CAN,PRT,2021.0,6,12,-6
PRT,DNK,2021.0,15,6,9
ITA,BEN,2021.0,1,1,0
ITA,ALB,2015.0,9,4,5
AUS,SWE,2003.0,25,38,-13
USA,BEL,1998.0,78,112,-34
NOR,ESP,2006.0,7,7,0
CUB,MEX,2020.0,34,9,25
ESP,CUB,2022.0,10,20,-10
AUT,IRN,2005.0,4,2,2
GBR,PAK,1998.0,21,11,10
POL,BEL,2000.0,8,8,0
HUN,ARG,2002.0,1,1,0
FIN,NOR,1998.0,8,4,4
ISR,AUS,2013.0,15,12,3
NLD,MOZ,2002.0,2,3,-1
ARG,FRA,2007.0,13,19,-6
NLD,IND,2000.0,4,12,-8
BGD,IND,2001.0,5,14,-9
UKR,GRC,1999.0,3,1,2
RUS,SVK,1997.0,8,1,7
DEU,CZE,2011.0,36,39,-3
AUT,CHE,2013.0,81,56,25
CAN,KWT,2003.0,3,1,2
ZAF,CHE,1999.0,2,2,0
USA,SVN,2017.0,18,14,4
ITA,DZA,2000.0,2,1,1
GLP,FRA,1998.0,16,11,5
GBR,LKA,1997.0,4,1,3
FRA,SRB,2005.0,4,3,1
SVK,AUT,2003.0,11,9,2
FIN,CAN,2017.0,29,17,12
JPN,IDN,2000.0,23,24,-1
IDN,JPN,2002.0,12,36,-24
VEN,COL,2014.0,24,6,18
FRA,MCO,2006.0,9,7,2
ITA,BGR,2016.0,7,1,6
BEL,ESP,2011.0,36,46,-10
CHN,NLD,1998.0,8,11,-3
AUS,MYS,2006.0,13,15,-2
SRB,RUS,2000.0,9,2,7
FRA,CMR,1997.0,11,8,3
JPN,ITA,2020.0,30,30,0
ESP,CAN,2012.0,65,49,16
UKR,BLR,2008.0,1,8,-7
BEL,LUX,2009.0,12,5,7
ISL,GBR,2001.0,5,11,-6
ESP,HRV,2000.0,6,2,4
FRA,KOR,2007.0,20,14,6
GBR,PAK,1999.0,13,21,-8
NGA,USA,2000.0,16,23,-7
CHL,GBR,2010.0,27,18,9
UZB,CAN,2002.0,1,1,0
FIN,SWE,2010.0,53,38,15
ARG,DEU,1997.0,15,9,6
IND,CHE,2012.0,37,23,14
BEL,UKR,2010.0,2,3,-1
KOR,CAN,1999.0,18,13,5
BEL,RUS,2002.0,14,13,1
SVN,CHE,2002.0,6,2,4
GBR,NOR,1999.0,29,20,9
AUS,NZL,1998.0,57,84,-27
AUS,HKG,2001.0,45,14,31
HRV,BIH,2009.0,10,5,5
GBR,NGA,2000.0,22,12,10
HUN,SVK,2005.0,4,3,1
SVK,HUN,2006.0,3,2,1
DEU,BGR,2000.0,18,27,-9
FIN,JPN,2001.0,10,8,2
FRA,NCL,2003.0,14,7,7
ARE,EGY,2005.0,7,10,-3
FRA,SRB,2002.0,10,6,4
ESP,CAN,2002.0,15,28,-13
USA,MWI,2003.0,12,1,11
FRA,NLD,1997.0,49,64,-15
SWE,POL,2000.0,11,8,3
CZE,ITA,2000.0,5,7,-2
USA,SEN,2010.0,6,6,0
SVN,SVK,2001.0,5,3,2
ISR,JPN,1999.0,6,11,-5
JPN,ISR,2001.0,9,11,-2
DOM,JPN,2003.0,1,1,0
CAN,CHE,1998.0,49,32,17
NZL,NLD,2009.0,8,18,-10
FRA,MTQ,2000.0,9,22,-13
AUT,SWE,2003.0,7,7,0
CMR,FRA,2009.0,16,14,2
FRA,NCL,2013.0,34,20,14
TUR,SVK,2014.0,2,1,1
BEL,CHE,2017.0,72,41,31
SGP,ESP,2013.0,7,16,-9
SRB,GBR,2010.0,5,7,-2
ITA,GRC,1999.0,9,12,-3
ARE,DEU,2008.0,2,9,-7
DEU,ARE,2017.0,11,6,5
FRA,GRC,2018.0,44,46,-2
DEU,ROU,2001.0,13,32,-19
SGP,MYS,2004.0,11,6,5
URY,ARG,2006.0,4,4,0
ZAF,DEU,1999.0,15,21,-6
POL,CZE,1997.0,5,6,-1
POL,IND,2020.0,10,40,-30
JPN,MEX,2000.0,6,1,5
SGP,MYS,2014.0,28,14,14
GBR,MYS,1997.0,20,19,1
NLD,AUS,2005.0,35,29,6
HKG,CHN,1997.0,63,80,-17
BEL,AUT,2002.0,9,9,0
BEL,AUT,2005.0,4,3,1
TWN,ROU,2005.0,1,1,0
KWT,QAT,2016.0,4,1,3
CHE,SVK,2002.0,3,6,-3
ARG,CHL,2006.0,15,15,0
DNK,CHE,2002.0,20,7,13
PRT,USA,1998.0,23,29,-6
GBR,GMB,2008.0,11,4,7
BEL,CAN,2002.0,34,28,6
FRA,GLP,2002.0,18,13,5
GLP,FRA,2007.0,24,41,-17
USA,UZB,2006.0,1,6,-5
MEX,DEU,2019.0,51,41,10
CHE,ZAF,2002.0,6,8,-2
CAN,SGP,1999.0,17,10,7
ZAF,BEL,2007.0,3,7,-4
UKR,FRA,2002.0,16,18,-2
POL,RUS,2019.0,8,13,-5
USA,MYS,1999.0,12,12,0
SWE,FRA,2001.0,52,49,3
LSO,ZAF,2000.0,2,1,1
CHE,BGR,2000.0,3,1,2
ISR,UKR,2003.0,5,3,2
SEN,USA,2015.0,12,6,6
USA,VEN,2006.0,46,36,10
NOR,DEU,2017.0,51,78,-27
POL,BEL,2006.0,6,11,-5
BRA,COL,2007.0,17,7,10
ITA,MEX,2014.0,19,10,9
ARE,KWT,2021.0,6,3,3
CZE,JPN,1998.0,6,3,3
MTQ,FRA,1997.0,6,7,-1
ITA,SAU,2022.0,18,5,13
THA,IND,2009.0,4,3,1
CAN,NLD,2006.0,29,46,-17
DNK,CAN,2007.0,16,9,7
CZE,FIN,2012.0,6,5,1
BEL,ARG,1999.0,2,6,-4
BGD,KOR,2011.0,15,18,-3
SAU,BHR,2008.0,3,3,0
AUS,NLD,1999.0,30,9,21
AUS,IDN,1999.0,11,10,1
IDN,AUS,2002.0,9,14,-5
GBR,MYS,2002.0,55,16,39
RWA,USA,2010.0,7,5,2
USA,RWA,2011.0,5,9,-4
DEU,ZAF,1999.0,21,15,6
MYS,AUS,2002.0,15,11,4
IND,KOR,2002.0,31,7,24
KWT,CAN,2021.0,11,15,-4
ZMB,USA,2018.0,19,12,7
SWE,GRC,1997.0,11,4,7
CZE,FRA,1997.0,9,19,-10
FRA,CZE,1998.0,20,13,7
BRA,DEU,2006.0,59,55,4
BLR,POL,2013.0,9,8,1
JPN,CHE,2005.0,32,24,8
RUS,ITA,2019.0,29,20,9
IND,AUS,2005.0,47,15,32
CZE,HUN,2005.0,1,2,-1
HUN,CHN,2017.0,5,1,4
SVK,NLD,2001.0,3,7,-4
AUT,NLD,2002.0,19,15,4
ESP,PAN,2023.0,3,4,-1
AUS,RUS,2008.0,6,8,-2
TWN,GBR,1997.0,7,19,-12
ZWE,GBR,1998.0,6,8,-2
CHL,COL,2003.0,2,3,-1
FRA,CZE,2007.0,16,21,-5
HKG,NZL,1999.0,10,4,6
ISR,NLD,2021.0,17,12,5
CMR,FRA,2019.0,22,24,-2
AUS,DNK,2005.0,11,9,2
IRN,SWE,2000.0,4,2,2
AUS,ZAF,2001.0,13,31,-18
ZAF,NOR,2003.0,2,1,1
SVK,CZE,2006.0,40,31,9
RUS,AUT,1997.0,9,3,6
DNK,FRA,1997.0,22,15,7
IND,BEL,2005.0,9,6,3
UKR,FRA,2005.0,16,10,6
DEU,CRI,2000.0,3,2,1
JPN,BLR,2012.0,1,1,0
CHE,JPN,1998.0,25,15,10
DEU,HRV,2000.0,16,15,1
POL,FRA,2016.0,37,36,1
ITA,THA,2016.0,7,5,2
USA,SVK,2008.0,14,21,-7
RUS,DNK,2013.0,8,3,5
DNK,FRA,2005.0,18,22,-4
NOR,FIN,1998.0,4,8,-4
SAU,CAN,1999.0,16,17,-1
LBN,LBY,2010.0,1,2,-1
LBY,LBN,2012.0,3,4,-1
BEL,ITA,2010.0,42,59,-17
CAN,BEL,2010.0,48,41,7
SVK,CZE,2000.0,20,16,4
UKR,DEU,2011.0,30,29,1
DEU,UKR,2017.0,15,43,-28
USA,UKR,2002.0,38,50,-12
IRL,HKG,1997.0,1,2,-1
CAN,ROU,1997.0,1,5,-4
SVK,UKR,2000.0,1,2,-1
BGR,FRA,2016.0,5,6,-1
ITA,SMR,2014.0,1,2,-1
SRB,DEU,2002.0,21,14,7
ESP,KAZ,2021.0,3,1,2
SWE,JPN,1998.0,27,33,-6
RUS,BLR,2012.0,19,18,1
BLR,BEL,2002.0,6,5,1
BEL,BLR,2003.0,5,10,-5
BRA,JPN,2002.0,9,19,-10
BGR,CHE,2002.0,5,1,4
SWE,CAN,2010.0,42,44,-2
ISR,PSE,2006.0,10,5,5
BLR,BEL,2012.0,1,8,-7
USA,SVK,2001.0,12,26,-14
SWE,TZA,2001.0,9,1,8
CAN,TWN,2010.0,22,12,10
USA,UKR,2005.0,29,46,-17
ROU,USA,2016.0,26,19,7
MWI,USA,2019.0,18,19,-1
CAN,DNK,2001.0,16,22,-6
BRA,ITA,2006.0,34,25,9
JPN,BRA,2000.0,18,22,-4
SRB,MNE,2005.0,8,3,5
JOR,IRQ,1999.0,1,1,0
DEU,OMN,2016.0,7,2,5
TUR,NLD,2001.0,4,6,-2
TUR,AUT,2006.0,4,7,-3
IND,ESP,1998.0,9,1,8
VEN,ECU,2014.0,15,3,12
CAN,FIN,2013.0,14,15,-1
KEN,UGA,2000.0,1,3,-2
BRA,UKR,2004.0,2,2,0
EGY,JOR,2003.0,2,2,0
EGY,USA,2010.0,59,125,-66
ESP,CAN,1997.0,15,15,0
TUR,GBR,2000.0,34,67,-33
NLD,NOR,1999.0,11,7,4
KOR,CHL,2011.0,2,1,1
ZAF,CHN,2011.0,7,7,0
JPN,KOR,2001.0,147,103,44
KHM,USA,2002.0,2,1,1
CRI,USA,1999.0,12,7,5
FRA,CZE,1999.0,22,12,10
DEU,ARM,2000.0,4,6,-2
ARM,DEU,2010.0,6,1,5
SWE,RUS,2002.0,31,47,-16
PAK,SAU,2008.0,17,12,5
GBR,GMB,2004.0,11,7,4
COL,ITA,2016.0,5,12,-7
MKD,NLD,2020.0,1,2,-1
FRA,RUS,2011.0,58,81,-23
DEU,HUN,2013.0,37,46,-9
IND,SGP,2015.0,86,56,30
NPL,IND,2010.0,32,24,8
SRB,CHE,2011.0,7,4,3
FRA,IRL,2015.0,28,43,-15
AUS,CHL,2021.0,15,39,-24
NAM,ZAF,2014.0,6,7,-1
DNK,GBR,2017.0,114,127,-13
DNK,FRA,2012.0,38,26,12
SRB,USA,2016.0,16,13,3
BRA,NZL,2010.0,5,3,2
BEL,LUX,2019.0,24,8,16
ESP,IND,2011.0,10,13,-3
DEU,MEX,2013.0,35,39,-4
ITA,AUT,2020.0,66,58,8
ITA,COL,2023.0,7,10,-3
RUS,ARM,2018.0,3,8,-5
ZAF,BWA,2011.0,8,12,-4
CAN,BRA,2016.0,74,124,-50
IRL,PRT,2019.0,6,11,-5
PRT,IRL,2020.0,14,8,6
ARE,GBR,2022.0,37,75,-38
NOR,FRA,2013.0,20,31,-11
AUS,ZAF,2014.0,29,46,-17
USA,IRQ,2010.0,6,3,3
SAU,IDN,2017.0,2,1,1
IRL,ITA,2012.0,9,25,-16
MYS,IDN,2013.0,57,19,38
GRL,DNK,2015.0,5,5,0
FIN,CHE,2009.0,20,3,17
ESP,BEL,2022.0,60,60,0
JPN,FRA,2016.0,83,106,-23
USA,CHL,2013.0,126,126,0
IRL,CHN,2015.0,25,20,5
ARE,SDN,2017.0,2,2,0
LBN,USA,2012.0,48,63,-15
ZAF,GBR,2015.0,97,109,-12
CAN,ESP,2019.0,59,80,-21
UKR,GBR,2012.0,23,56,-33
LUX,USA,2013.0,6,11,-5
GBR,IRN,2012.0,51,33,18
THA,USA,2011.0,110,222,-112
CHE,CHN,2015.0,38,60,-22
ITA,KEN,2008.0,1,5,-4
IDN,NLD,2008.0,7,15,-8
NOR,NLD,2021.0,32,43,-11
PRT,BRA,2006.0,43,51,-8
TWN,JPN,2011.0,52,51,1
DEU,KEN,2020.0,24,15,9
KEN,FIN,2022.0,1,1,0
ARG,GBR,2016.0,16,28,-12
SVK,BEL,2020.0,5,3,2
CHN,TWN,2017.0,139,295,-156
TWN,ITA,2022.0,5,3,2
ESP,ARE,2015.0,10,2,8
BEL,JPN,2018.0,19,18,1
NZL,MYS,2017.0,31,17,14
FRA,GRC,2016.0,42,40,2
ZAF,IRL,2008.0,6,1,5
TWN,ESP,2012.0,4,1,3
COL,MEX,2021.0,69,56,13
DEU,SVK,2018.0,9,7,2
ARM,RUS,2011.0,12,5,7
BGD,AUS,2016.0,59,24,35
POL,FIN,2011.0,6,5,1
SWE,GRC,2012.0,10,15,-5
CHN,MAC,2014.0,55,30,25
USA,PHL,2012.0,42,23,19
AUT,ITA,2018.0,54,90,-36
BEL,THA,2015.0,4,4,0
NLD,TZA,2011.0,3,2,1
ZAF,RWA,2012.0,2,1,1
GBR,BGD,2014.0,17,12,5
DNK,PRT,2012.0,5,10,-5
NLD,HKG,2014.0,9,4,5
DEU,EST,2014.0,9,4,5
TUR,CHE,2017.0,17,11,6
ITA,THA,2018.0,6,4,2
USA,EGY,2017.0,129,124,5
NGA,CAN,2018.0,17,11,6
ESP,JPN,2011.0,20,12,8
SRB,BGR,2017.0,1,2,-1
GBR,BRN,2019.0,6,4,2
ESP,BRA,2021.0,113,122,-9
AUS,SGP,2017.0,97,95,2
CAN,MYS,2021.0,8,24,-16
BOL,USA,2003.0,8,1,7
CHN,BEL,2021.0,99,78,21
NOR,GBR,2018.0,63,115,-52
SGP,AUS,2007.0,67,41,26
IRN,IRL,2019.0,15,5,10
AUS,IDN,2020.0,98,59,39
DNK,AUS,2020.0,42,50,-8
MYS,SAU,2017.0,103,30,73
CHN,LUX,2019.0,2,4,-2
ARG,DOM,2021.0,2,1,1
NLD,USA,2023.0,217,229,-12
FRA,IDN,2018.0,19,10,9
MYS,SAU,2022.0,40,35,5
IRN,USA,2018.0,586,179,407
POL,SWE,1999.0,15,6,9
JPN,DEU,2021.0,113,113,0
CAN,CHE,2020.0,125,127,-2
FIN,AUS,2018.0,28,27,1
UKR,POL,2023.0,45,27,18
NGA,GBR,2021.0,104,85,19
IRN,USA,2017.0,604,124,480
GBR,KEN,2021.0,31,22,9
PHL,JPN,2019.0,35,41,-6
TWN,KOR,2020.0,7,15,-8
PRY,USA,2021.0,5,8,-3
NGA,ZAF,2016.0,89,53,36
THA,GBR,2019.0,62,93,-31
USA,HUN,2020.0,53,52,1
FRA,SGP,2018.0,44,26,18
BEL,BOL,2018.0,5,2,3
NLD,AUT,2018.0,37,40,-3
AUS,GHA,2018.0,14,20,-6
HKG,GBR,2014.0,46,74,-28
FRA,CZE,2020.0,37,28,9
ZAF,ZMB,2016.0,6,5,1
NZL,IRN,2022.0,5,6,-1
PRT,GBR,2022.0,66,130,-64
IND,IDN,2020.0,47,14,33
CHL,ESP,2022.0,117,93,24
SWE,VNM,2020.0,9,5,4
CHN,ESP,2022.0,58,71,-13
MWI,USA,2021.0,24,11,13
EGY,ITA,2023.0,8,10,-2
DEU,KOR,2009.0,38,26,12
JOR,BHR,2021.0,3,2,1
LBN,CAN,2021.0,24,13,11
SWE,GBR,2020.0,154,219,-65
ESP,MAR,2017.0,19,7,12
DEU,GEO,2023.0,2,2,0
CHE,POL,2021.0,19,31,-12
CHE,DEU,2000.0,325,356,-31
AUS,IND,2018.0,74,131,-57
IRL,NLD,2022.0,28,19,9
ITA,SAU,2018.0,10,11,-1
AUS,AUT,2011.0,37,43,-6
LBN,FRA,1997.0,14,10,4
ESP,BGR,2002.0,2,4,-2
ESP,SGP,2013.0,16,7,9
BGR,ITA,2001.0,8,4,4
CHL,BEL,2019.0,12,11,1
KWT,FIN,2010.0,1,2,-1
FIN,GHA,2020.0,4,1,3
USA,CHE,1998.0,316,360,-44
NGA,GBR,2009.0,24,26,-2
VEN,USA,1997.0,30,30,0
GBR,FIN,2003.0,51,42,9
SAU,KWT,2002.0,3,1,2
DNK,HKG,2019.0,3,3,0
SRB,JPN,2006.0,6,1,5
RUS,AUT,2002.0,13,10,3
JPN,CAN,2001.0,128,87,41
DEU,CAN,1999.0,82,82,0
UKR,CAN,2013.0,5,3,2
PHL,DEU,2000.0,1,2,-1
ITA,MEX,2001.0,8,5,3
DEU,BEL,2000.0,76,50,26
BEL,AUT,2012.0,12,5,7
JPN,CHE,1997.0,16,25,-9
ITA,IRL,2000.0,8,7,1
ISR,DEU,1997.0,24,32,-8
CAN,ZAF,1998.0,7,13,-6
EST,SWE,1999.0,4,8,-4
BEL,COG,2008.0,5,1,4
SWE,TWN,2001.0,2,1,1
ISR,ITA,1998.0,6,9,-3
ITA,AUS,1997.0,7,8,-1
SWE,RUS,1997.0,10,25,-15
CHE,AUS,1997.0,18,10,8
PAK,EGY,2013.0,4,1,3
ITA,AUS,2002.0,23,24,-1
KEN,CHE,2013.0,5,4,1
RUS,FRA,1997.0,79,58,21
NZL,SGP,2004.0,4,10,-6
NZL,DNK,2004.0,6,4,2
BEL,DNK,2002.0,12,11,1
EGY,USA,2000.0,47,64,-17
NLD,RUS,1997.0,14,17,-3
CHL,BRA,2011.0,12,19,-7
HUN,FRA,1997.0,9,11,-2
ESP,FIN,2013.0,18,15,3
GBR,GHA,2000.0,11,9,2
FIN,SWE,2006.0,37,43,-6
KEN,CAN,2010.0,8,4,4
ITA,URY,2004.0,1,1,0
MEX,RUS,1998.0,7,12,-5
DEU,NOR,2004.0,33,19,14
PRT,SWE,2019.0,24,17,7
HKG,MYS,2003.0,3,1,2
ROU,TWN,2000.0,1,2,-1
IND,NLD,2003.0,19,9,10
TUN,DZA,2020.0,8,8,0
TUR,AZE,2016.0,8,4,4
SAU,DEU,2019.0,27,41,-14
ROU,SWE,2013.0,5,1,4
ARE,THA,2021.0,1,4,-3
USA,IRL,2019.0,136,145,-9
NZL,DEU,2019.0,30,33,-3
EGY,KOR,2023.0,11,7,4
ITA,TUN,2017.0,6,8,-2
BRA,SWE,2023.0,19,13,6
KOR,GBR,2020.0,68,75,-7
NGA,MYS,2015.0,31,41,-10
AUS,MYS,2023.0,22,46,-24
LTU,SWE,2021.0,9,6,3
ITA,KOR,2016.0,8,11,-3
MYS,PAK,2016.0,75,48,27
ITA,BLR,2016.0,3,1,2
QAT,JPN,2019.0,1,2,-1
NLD,NOR,2020.0,35,23,12
IND,CAN,2016.0,135,110,25
ISR,GBR,2016.0,73,44,29
KOR,DEU,2019.0,93,55,38
GRC,CHE,2016.0,37,14,23
DEU,EGY,2016.0,83,37,46
ZAF,NLD,2020.0,28,32,-4
USA,RWA,2021.0,16,20,-4
SAU,PAK,2012.0,19,57,-38
IRN,FRA,2015.0,18,22,-4
NLD,ITA,2017.0,98,154,-56
GBR,ISR,2022.0,40,55,-15
COL,CHE,2017.0,6,5,1
ITA,THA,2017.0,1,5,-4
IRN,GBR,2009.0,36,68,-32
PER,COL,2021.0,9,5,4
CZE,PRT,2023.0,5,1,4
NLD,IND,2023.0,14,29,-15
NGA,CAN,2022.0,37,7,30
FIN,USA,2019.0,103,103,0
ESP,BEL,2017.0,81,53,28
RUS,CAN,2020.0,18,23,-5
CZE,AUT,2003.0,9,7,2
GHA,USA,2019.0,36,40,-4
CAN,LKA,2020.0,3,5,-2
POL,FRA,2022.0,37,37,0
LKA,USA,2020.0,27,38,-11
ESP,CHL,2020.0,157,124,33
BGD,USA,2002.0,17,18,-1
GBR,PSE,2008.0,4,1,3
SRB,BIH,2011.0,14,13,1
USA,BLR,2019.0,3,6,-3
ISL,DEU,2021.0,5,6,-1
IND,TWN,2012.0,44,35,9
ISR,DEU,2005.0,41,27,14
COL,CHE,2022.0,7,4,3
CAN,IND,2009.0,50,92,-42
BEL,GRC,2021.0,18,28,-10
RUS,KAZ,2011.0,23,8,15
HKG,KOR,2021.0,19,10,9
SGP,JPN,2020.0,23,33,-10
ROU,DNK,2021.0,1,1,0
ROU,SVK,2020.0,2,1,1
NLD,AUT,2022.0,43,33,10
RUS,BEL,2005.0,12,9,3
DNK,NZL,2004.0,4,6,-2
POL,ITA,1998.0,7,17,-10
DEU,NZL,2003.0,20,16,4
NAM,ZAF,2015.0,9,10,-1
PRT,FRA,1997.0,15,14,1
RUS,MEX,1999.0,16,5,11
SRB,RUS,2006.0,16,5,11
PAK,CAN,1998.0,1,3,-2
SWE,VNM,2007.0,4,1,3
AUT,FIN,1999.0,5,3,2
SAU,ARE,1999.0,8,2,6
DEU,FIN,1997.0,15,17,-2
CAN,ZAF,1999.0,12,11,1
AUS,ITA,2001.0,20,24,-4
NLD,RUS,2002.0,14,25,-11
NZL,CAN,1999.0,14,18,-4
GBR,TUR,2001.0,59,25,34
FRA,MTQ,2006.0,12,17,-5
URY,CHL,2002.0,7,2,5
SRB,AUS,1997.0,1,1,0
EST,GBR,1997.0,1,2,-1
UKR,POL,2010.0,18,11,7
SVK,CZE,2023.0,41,39,2
SAU,EGY,2001.0,29,49,-20
ITA,CHL,2007.0,8,8,0
KWT,CAN,2019.0,10,17,-7
ITA,RUS,2013.0,16,18,-2
ITA,MAR,2005.0,6,2,4
THA,ITA,2002.0,3,2,1
ESP,DEU,2000.0,85,76,9
AUS,GBR,2024.0,4,3,1
RUS,BEL,2002.0,13,14,-1
ZAF,CAN,2005.0,19,12,7
BLR,JPN,2011.0,1,2,-1
SWE,POL,2010.0,13,22,-9
THA,BEL,2023.0,1,2,-1
SGP,PHL,2018.0,7,2,5
CAN,SWE,1998.0,24,27,-3
ESP,DNK,2009.0,17,10,7
NLD,ISR,2002.0,9,6,3
BEL,NZL,2003.0,6,2,4
RUS,JPN,2023.0,12,7,5
HUN,JPN,1998.0,11,11,0
GAB,DEU,2004.0,3,1,2
AUS,SWE,2013.0,46,46,0
ARG,URY,2008.0,7,4,3
SWE,RUS,2005.0,20,21,-1
IRQ,GBR,2010.0,4,1,3
POL,RUS,2021.0,12,26,-14
JPN,FIN,2003.0,14,20,-6
CHE,AUT,2013.0,56,81,-25
AUS,IND,2016.0,78,125,-47
MYS,CHN,2007.0,7,4,3
GBR,CHL,2017.0,63,52,11
POL,ROU,2018.0,1,6,-5
ETH,CHN,2019.0,13,17,-4
USA,CRI,2011.0,15,13,2
MOZ,ZAF,2013.0,4,3,1
SVK,HRV,2013.0,1,1,0
EGY,JPN,2017.0,33,75,-42
TWN,CHE,2020.0,8,3,5
FIN,POL,2015.0,7,4,3
ITA,LUX,2012.0,13,1,12
CUB,ECU,2018.0,23,9,14
MYS,PAK,2020.0,161,63,98
BRA,EST,2020.0,5,1,4
CYP,GBR,2018.0,22,46,-24
IND,NLD,2023.0,29,14,15
ITA,AUT,2022.0,68,61,7
FRA,CIV,2019.0,33,17,16
ESP,ITA,2000.0,65,62,3
TUR,CHE,2020.0,28,13,15
GBR,NOR,2022.0,111,52,59
PRT,ESP,2019.0,133,143,-10
ITA,FIN,2019.0,37,20,17
IND,GBR,2018.0,244,211,33
BEL,UGA,2018.0,9,2,7
MYS,VNM,2020.0,18,5,13
IND,CHN,2021.0,163,161,2
USA,EGY,2020.0,184,135,49
BGD,KOR,2014.0,18,27,-9
NLD,POL,2023.0,13,11,2
NLD,TZA,2014.0,7,1,6
CHE,CAN,2023.0,70,52,18
CHN,IRL,2018.0,30,35,-5
THA,TZA,2018.0,1,2,-1
DNK,ITA,2022.0,36,41,-5
IND,CHN,2019.0,250,69,181
USA,PAK,2019.0,114,134,-20
NLD,CAN,2022.0,58,54,4
RUS,DEU,2020.0,171,95,76
GBR,CHN,2021.0,809,613,196
SGP,AUS,2018.0,89,129,-40
NOR,IDN,2020.0,2,2,0
FRA,VNM,2022.0,47,27,20
ITA,HUN,2020.0,12,8,4
GBR,CAN,2023.0,216,204,12
CHN,NLD,2018.0,141,161,-20
ISR,AUS,2010.0,18,13,5
URY,AUS,2019.0,2,1,1
IDN,THA,2021.0,27,40,-13
THA,IDN,2022.0,25,29,-4
NLD,IRN,2016.0,14,38,-24
GBR,PRT,2023.0,52,33,19
USA,BOL,2008.0,6,2,4
CHE,SAU,2023.0,5,1,4
MEX,CAN,2023.0,20,21,-1
MOZ,BEL,2018.0,1,1,0
TUR,CZE,2020.0,11,7,4
DNK,GBR,2020.0,117,143,-26
MAC,CHN,2018.0,144,89,55
AUT,DEU,2020.0,340,442,-102
BGD,JPN,2017.0,68,91,-23
JPN,BGD,2019.0,108,52,56
POL,SWE,2016.0,24,21,3
AUS,SWE,2023.0,39,22,17
USA,AUT,2012.0,136,129,7
MYS,GBR,2023.0,65,35,30
BRA,PRT,2020.0,243,176,67
ARE,GBR,2020.0,36,71,-35
FRA,IRL,2019.0,48,32,16
CHN,NLD,2017.0,122,142,-20
PRT,ESP,2021.0,118,152,-34
NLD,GBR,2019.0,359,433,-74
CHN,PAK,2018.0,243,315,-72
CAN,SAU,2020.0,178,76,102
ARG,FRA,2018.0,38,43,-5
BRA,FRA,2023.0,92,43,49
CZE,UKR,2022.0,5,16,-11
NGA,MYS,2019.0,55,120,-65
DEU,IRL,2020.0,34,52,-18
USA,BOL,2015.0,10,2,8
EGY,DEU,2018.0,45,64,-19
COL,ARG,2018.0,21,31,-10
AUS,IRQ,2022.0,26,5,21
CAN,FRA,2023.0,134,148,-14
USA,MYS,2018.0,37,79,-42
KOR,VNM,2016.0,70,23,47
CAN,NLD,2013.0,63,67,-4
USA,PAK,2021.0,113,151,-38
SWE,GBR,2022.0,141,163,-22
CHE,CHN,2019.0,76,87,-11
SLV,SVK,2010.0,8,13,-5
NZL,USA,2000.0,122,100,22
CAN,IRL,2020.0,51,33,18
AUT,SWE,2023.0,16,13,3
JPN,GBR,2017.0,125,142,-17
BGD,TWN,2019.0,1,1,0
ITA,ALB,2019.0,12,1,11
HUN,EGY,2020.0,9,9,0
NPL,CHN,2018.0,15,15,0
JPN,CHN,2022.0,594,364,230
ITA,ARG,2002.0,15,21,-6
IRN,CZE,2016.0,6,3,3
POL,GRC,2022.0,3,5,-2
GBR,FJI,2009.0,2,2,0
GBR,TZA,2018.0,6,6,0
CHN,IRL,2022.0,36,29,7
SAU,GBR,2023.0,67,113,-46
KOR,IND,2007.0,32,108,-76
PRT,BEL,2000.0,3,7,-4
DEU,NOR,2021.0,102,68,34
KOR,IRN,2019.0,11,22,-11
PHL,AUS,2015.0,10,9,1
AUS,CHE,2021.0,81,64,17
BEL,CHE,2020.0,77,49,28
FRA,AUS,2020.0,109,86,23
KOR,CHN,2021.0,321,193,128
CHN,NPL,2021.0,31,12,19
NPL,CHN,2022.0,13,27,-14
GBR,TUR,2019.0,70,93,-23
KOR,TWN,2022.0,7,22,-15
FIN,ITA,2022.0,25,19,6
SAU,USA,2017.0,150,223,-73
DEU,IND,1999.0,42,60,-18
CAN,KOR,2019.0,45,54,-9
BRA,PAN,2021.0,11,3,8
CAN,DEU,1999.0,82,82,0
TWN,ISR,2020.0,1,1,0
DEU,SWE,2021.0,216,177,39
AUS,VNM,2020.0,77,56,21
CAN,RUS,2018.0,18,25,-7
BEL,AUS,2022.0,17,30,-13
SAU,CAN,2017.0,65,136,-71
TWN,CHE,2018.0,8,11,-3
TUR,DEU,2023.0,81,29,52
CAN,ESP,2015.0,44,78,-34
SEN,FRA,2020.0,29,40,-11
SAU,ARE,2022.0,42,14,28
NZL,SGP,2019.0,20,13,7
ITA,NLD,2016.0,139,77,62
IND,ESP,2017.0,22,31,-9
RUS,IND,2019.0,11,18,-7
AUS,ESP,2023.0,33,11,22
HUN,SWE,2020.0,8,5,3
ZAF,FIN,2021.0,8,2,6
NGA,CAN,2020.0,26,6,20
ITA,ROU,2000.0,10,13,-3
GBR,KWT,2012.0,13,6,7
HKG,AUT,2020.0,2,2,0
USA,ISR,2023.0,194,216,-22
JPN,GHA,2020.0,8,3,5
AUS,PER,2022.0,3,1,2
FRA,UKR,2019.0,5,20,-15
BEL,USA,2023.0,101,83,18
ECU,USA,2022.0,27,24,3
AUS,CHE,2019.0,79,74,5
USA,HUN,2016.0,77,64,13
ROU,FRA,2021.0,25,22,3
BRA,BEL,2020.0,30,19,11
DEU,URY,2023.0,1,4,-3
COL,ESP,2018.0,72,135,-63
COL,AUS,2019.0,11,9,2
IND,PHL,2018.0,7,7,0
ESP,MEX,2016.0,204,178,26
IDN,MYS,2022.0,56,63,-7
IRN,ITA,2023.0,65,24,41
ESP,CHL,2017.0,161,97,64
RUS,TWN,2002.0,10,5,5
TWN,RUS,2003.0,3,6,-3
KOR,JPN,2006.0,115,153,-38
KEN,USA,2007.0,32,37,-5
FRA,BEL,2022.0,229,179,50
CHN,GBR,2022.0,547,830,-283
DEU,THA,2019.0,29,22,7
DEU,ARE,2020.0,15,8,7
AUS,COL,2002.0,7,3,4
AUS,LUX,2018.0,1,3,-2
CHE,MAR,2021.0,3,2,1
DEU,NLD,2021.0,434,364,70
CHE,NLD,2021.0,108,128,-20
POL,UKR,2013.0,16,15,1
DEU,KAZ,2016.0,6,3,3
DEU,SGP,2017.0,41,39,2
PAN,ESP,2018.0,2,4,-2
THA,AUT,2019.0,5,6,-1
CHN,SAU,2023.0,48,32,16
FRA,TUN,2020.0,119,129,-10
PRT,USA,2017.0,93,64,29
ESP,SWE,2016.0,88,46,42
NGA,ZAF,2020.0,98,129,-31
CZE,JPN,2022.0,9,7,2
CMR,CHE,2021.0,3,2,1
IRN,DEU,2023.0,82,35,47
ITA,FIN,2021.0,31,16,15
ESP,PRT,2023.0,67,91,-24
ZAF,NGA,2023.0,70,53,17
SWE,TZA,2019.0,7,3,4
ITA,SAU,2020.0,9,12,-3
NOR,ISR,2018.0,1,1,0
EGY,IRQ,2018.0,7,1,6
CAN,SEN,2015.0,3,11,-8
ESP,EGY,2021.0,23,12,11
HRV,MNE,2020.0,3,1,2
GBR,TUR,2021.0,80,113,-33
HUN,USA,2002.0,96,88,8
ESP,IRL,2020.0,51,32,19
PAK,CAN,2018.0,30,23,7
IND,GBR,2022.0,325,225,100
KOR,CHN,2019.0,308,146,162
BRA,COL,2018.0,76,70,6
FRA,ZAF,2021.0,17,35,-18
DNK,CHN,2018.0,65,67,-2
ZWE,ZAF,2016.0,25,24,1
NZL,USA,2024.0,1,1,0
MYS,LBY,2020.0,20,5,15
ZWE,ZAF,2022.0,53,35,18
RUS,KAZ,2015.0,43,30,13
MYS,IRN,2022.0,26,16,10
DEU,CZE,2008.0,36,35,1
SGP,IND,2022.0,71,57,14
CHN,BEL,2015.0,45,43,2
BGR,MKD,2018.0,4,5,-1
BRA,ITA,2013.0,27,54,-27
JPN,BGD,2021.0,107,54,53
ISR,NZL,2017.0,3,3,0
CUB,BEL,2022.0,4,1,3
AUT,SVK,1998.0,9,3,6
SGP,VNM,2020.0,20,5,15
IND,ETH,2023.0,27,54,-27
NZL,THA,2019.0,5,3,2
JPN,GBR,2022.0,111,117,-6
BGD,JPN,2018.0,89,78,11
NZL,AUS,2000.0,117,86,31
UKR,KAZ,2020.0,3,4,-1
SGP,AUS,2016.0,82,90,-8
KWT,EGY,2021.0,16,13,3
IDN,CAN,2019.0,4,4,0
KOR,GBR,2018.0,71,68,3
USA,COL,2022.0,92,145,-53
DEU,ECU,2021.0,9,10,-1
NGA,HKG,2022.0,4,1,3
AUT,FIN,2018.0,13,12,1
EST,SWE,2022.0,11,6,5
LTU,USA,2018.0,17,10,7
GHA,KEN,2018.0,2,6,-4
DEU,ZAF,2022.0,34,32,2
ETH,JPN,2022.0,3,3,0
AUS,ITA,2019.0,54,50,4
EGY,CHN,2016.0,13,20,-7
POL,USA,2023.0,73,53,20
ITA,AUT,2017.0,103,48,55
FIN,ESP,2023.0,17,18,-1
RUS,CHN,2016.0,17,16,1
AUT,SVN,2021.0,13,7,6
CHL,ESP,2020.0,124,157,-33
USA,ESP,2023.0,230,276,-46
GBR,KOR,2015.0,53,55,-2
GRC,ESP,2019.0,18,18,0
AUT,GBR,2019.0,107,117,-10
DNK,AUS,2018.0,30,41,-11
ITA,ALB,2021.0,14,5,9
FRA,CZE,2022.0,31,28,3
MYS,BGD,2022.0,47,27,20
CZE,SRB,2022.0,3,7,-4
CRI,USA,2018.0,31,33,-2
ESP,MAR,2007.0,8,5,3
PRT,GBR,2020.0,113,113,0
ESP,SWE,2018.0,99,45,54
CMR,NGA,2023.0,2,1,1
KOR,TWN,2018.0,12,20,-8
DNK,DEU,2023.0,49,78,-29
USA,JAM,2023.0,12,5,7
KOR,VNM,2022.0,97,63,34
ESP,CHN,2019.0,62,51,11
SVN,IND,2020.0,1,4,-3
PAK,POL,2022.0,12,3,9
ZAF,IRL,2021.0,9,6,3
IND,MYS,2020.0,67,80,-13
BEL,SWE,2021.0,31,27,4
ESP,MEX,2022.0,101,108,-7
KOR,RUS,2021.0,14,9,5
COL,ITA,2020.0,16,9,7
USA,HKG,2023.0,132,107,25
USA,GEO,2023.0,101,135,-34
BEL,SGP,2020.0,5,10,-5
ESP,SWE,2022.0,75,63,12
NPL,THA,2019.0,4,7,-3
THA,NPL,2021.0,10,5,5
SRB,GBR,2013.0,10,5,5
IRL,CHN,2021.0,28,27,1
FIN,CAN,2020.0,25,13,12
GBR,GMB,2021.0,13,14,-1
IRN,CZE,2022.0,22,6,16
GBR,ISL,2018.0,8,6,2
HKG,GBR,2021.0,79,75,4
USA,SLE,2021.0,7,4,3
TZA,NGA,2021.0,2,2,0
IND,IDN,2022.0,24,9,15
BEL,NLD,2022.0,189,147,42
ZAF,BEL,2022.0,14,10,4
EGY,CHN,2018.0,39,20,19
AUS,TWN,2003.0,9,7,2
BEL,LUX,2015.0,15,9,6
BRA,POL,2021.0,7,5,2
RUS,ARM,2020.0,9,5,4
SVK,ESP,2021.0,2,2,0
FRA,ARM,2021.0,2,1,1
CIV,ZAF,2020.0,2,6,-4
RUS,CAN,2022.0,25,7,18
IND,DEU,2023.0,138,83,55
DEU,CAN,2022.0,154,139,15
COL,USA,2023.0,109,36,73
ZAF,AUS,2021.0,49,19,30
THA,CAN,2022.0,14,8,6
ITA,CHL,2022.0,8,18,-10
THA,AUS,2020.0,27,48,-21
TUN,ESP,2023.0,5,5,0
CHE,GBR,2000.0,128,93,35
KHM,CHN,2023.0,2,1,1
MDA,DEU,2000.0,7,1,6
NLD,DNK,1997.0,18,13,5
KOR,RUS,2011.0,20,15,5
ITA,MEX,2021.0,15,28,-13
PRT,IND,2021.0,11,9,2
PAK,KOR,2021.0,63,103,-40
QAT,USA,2022.0,69,35,34
TUR,BEL,2023.0,9,6,3
DEU,TUR,2023.0,29,81,-52
TUN,MAR,2021.0,1,4,-3
BHR,EGY,2022.0,5,6,-1
KOR,VNM,2018.0,117,31,86
CZE,DEU,2018.0,71,72,-1
CHN,NZL,2023.0,34,44,-10
LUX,ITA,2021.0,6,19,-13
LTU,USA,2022.0,11,8,3
RUS,ISR,2009.0,7,8,-1
DEU,IRN,2021.0,53,166,-113
EGY,TUR,2018.0,3,3,0
ESP,MAR,2020.0,17,10,7
ISR,DNK,2018.0,7,4,3
ISR,IND,2003.0,6,22,-16
SDN,KOR,2022.0,1,3,-2
JPN,SGP,2023.0,24,14,10
EGY,IND,2023.0,11,8,3
GEO,USA,2016.0,66,171,-105
IND,AFG,2020.0,2,3,-1
NPL,DEU,2019.0,6,7,-1
GRC,DEU,2022.0,60,52,8
CHN,RUS,2023.0,27,60,-33
GBR,DNK,2004.0,65,60,5
DEU,MEX,2023.0,12,30,-18
CUB,ECU,2022.0,7,2,5
IRN,CHE,2022.0,28,15,13
CHN,UGA,2021.0,2,2,0
IND,SGP,2021.0,85,88,-3
NPL,THA,2021.0,5,10,-5
SAU,USA,2022.0,129,272,-143
HRV,USA,2022.0,10,11,-1
DNK,USA,2023.0,82,106,-24
CMR,GBR,2022.0,12,7,5
NLD,IRN,2017.0,30,30,0
FRA,ITA,2020.0,297,361,-64
CUB,MEX,2018.0,38,13,25
MEX,ESP,2011.0,133,128,5
BRB,GBR,2016.0,5,4,1
ARE,SAU,2022.0,14,42,-28
IRN,HKG,2021.0,10,1,9
TUR,IDN,2022.0,2,3,-1
GBR,RWA,2023.0,1,1,0
JPN,KOR,2021.0,101,107,-6
UKR,CHN,2021.0,15,16,-1
FJI,AUS,2019.0,11,12,-1
AUT,CHN,2019.0,27,16,11
DNK,SWE,1997.0,35,31,4
FRA,RUS,2008.0,36,48,-12
SWE,DEU,1999.0,77,71,6
GUF,FRA,2018.0,33,61,-28
FRA,GBR,1997.0,193,209,-16
IND,ISR,1999.0,24,4,20
ITA,DEU,1997.0,106,91,15
ARG,CHL,2003.0,19,6,13
JPN,FRA,1999.0,54,78,-24
SAU,BHR,2009.0,1,2,-1
IND,SAU,2002.0,11,6,5
SWE,ITA,2002.0,35,25,10
GHA,GBR,1998.0,5,5,0
CZE,USA,2003.0,74,54,20
NLD,SWE,2000.0,29,36,-7
RUS,AUS,2017.0,12,9,3
BRA,AUS,2019.0,64,38,26
USA,BGR,2003.0,21,24,-3
CHE,AUT,2000.0,23,22,1
DEU,DNK,1999.0,56,45,11
FRA,CHL,2006.0,16,19,-3
DEU,CHL,2000.0,21,3,18
HUN,SRB,2006.0,10,6,4
USA,ARG,2005.0,101,163,-62
DEU,DNK,1998.0,38,35,3
ITA,FRA,1997.0,151,144,7
CAN,POL,2001.0,14,19,-5
CZE,POL,2021.0,20,37,-17
RUS,POL,2002.0,18,15,3
FRA,HUN,2002.0,11,18,-7
USA,FIN,2000.0,84,112,-28
FRA,CHL,2000.0,10,7,3
RUS,ESP,1997.0,9,10,-1
TUN,FRA,2005.0,41,92,-51
BEL,PRT,2016.0,19,21,-2
RUS,BRA,2001.0,5,22,-17
RUS,FIN,2010.0,34,10,24
EGY,KOR,2013.0,11,4,7
CHE,SGP,2012.0,17,14,3
DEU,CRI,2003.0,7,2,5
USA,EGY,1998.0,54,54,0
PRI,USA,1997.0,32,42,-10
USA,BEL,2017.0,161,253,-92
SWE,ITA,2005.0,24,25,-1
RUS,UKR,2015.0,45,244,-199
PRI,USA,2002.0,103,65,38
RUS,UKR,2004.0,48,36,12
DEU,BRA,2002.0,47,48,-1
USA,AUT,1997.0,91,83,8
MKD,SRB,1997.0,3,5,-2
ESP,CRI,2019.0,9,9,0
SWE,FIN,2005.0,30,31,-1
GBR,VNM,2001.0,8,12,-4
AUT,AUS,1997.0,26,23,3
USA,ARE,2006.0,30,7,23
NOR,CHE,2001.0,8,3,5
CHE,NOR,2003.0,14,12,2
FIN,SWE,2003.0,40,51,-11
USA,AFG,2010.0,7,6,1
FIN,AUS,1998.0,4,1,3
RUS,NOR,2010.0,13,18,-5
RUS,UKR,2014.0,39,167,-128
CAN,FRA,2000.0,178,211,-33
ITA,SWE,2002.0,25,35,-10
CHE,FRA,2000.0,167,216,-49
IND,JPN,2003.0,76,61,15
RUS,GBR,2000.0,81,41,40
QAT,USA,2018.0,63,57,6
CHL,BEL,2015.0,11,7,4
ARG,USA,1997.0,66,78,-12
QAT,JOR,2005.0,1,2,-1
CHL,ESP,1999.0,26,23,3
NGA,GBR,2004.0,17,23,-6
EGY,ARE,2016.0,14,12,2
ITA,EGY,2008.0,3,2,1
RUS,SWE,2013.0,15,13,2
USA,LBN,2014.0,55,99,-44
FIN,KWT,2003.0,1,3,-2
NLD,AUT,2007.0,15,14,1
USA,KEN,2001.0,23,27,-4
SVN,NLD,2008.0,4,2,2
NLD,SVN,2011.0,6,2,4
CHL,FRA,2005.0,16,22,-6
NGA,GBR,2001.0,19,19,0
GBR,NGA,2003.0,30,10,20
DNK,ZAF,2018.0,2,4,-2
GBR,RUS,1999.0,42,74,-32
CAN,ISR,2004.0,36,62,-26
SGP,PRT,2015.0,3,1,2
RUS,DEU,1999.0,169,117,52
CAN,NOR,2003.0,6,9,-3
GBR,RUS,1998.0,46,49,-3
BGR,RUS,2003.0,10,7,3
GBR,CAN,2000.0,227,239,-12
GBR,HUN,2013.0,33,44,-11
USA,NZL,2000.0,100,122,-22
SWE,CAN,2003.0,41,34,7
AUS,HRV,2017.0,1,2,-1
EST,CHE,2022.0,4,5,-1
SRB,BRA,2000.0,3,1,2
NLD,JPN,1997.0,28,18,10
ARG,FRA,2016.0,46,42,4
JPN,EGY,2002.0,30,11,19
CHL,FRA,1997.0,6,5,1
CHL,FRA,2002.0,12,17,-5
GBR,GRC,2001.0,116,58,58
CHE,SWE,2001.0,40,22,18
BEL,CHE,2007.0,22,24,-2
DEU,CZE,2001.0,28,26,2
DNK,FIN,2003.0,14,11,3
FIN,POL,2011.0,5,6,-1
POL,FIN,2014.0,5,8,-3
HKG,AUS,2005.0,33,15,18
NLD,ITA,1998.0,48,57,-9
BGD,GBR,2019.0,14,35,-21
SWE,HUN,2007.0,10,8,2
ITA,BRA,1997.0,27,12,15
CHN,UKR,2023.0,12,11,1
CHE,ITA,1999.0,77,83,-6
NLD,ITA,2007.0,69,76,-7
GBR,JPN,1997.0,106,92,14
DEU,GRC,2023.0,35,44,-9
GLP,FRA,2017.0,37,29,8
GLP,FRA,2022.0,27,26,1
FRA,LTU,2013.0,5,4,1
JPN,SRB,2004.0,5,1,4
HUN,USA,1997.0,63,68,-5
SWZ,GBR,1999.0,1,1,0
USA,SWE,1999.0,191,219,-28
EGY,USA,2003.0,48,95,-47
AUT,RUS,2001.0,10,13,-3
FIN,ISL,2010.0,1,1,0
ZAF,GBR,2011.0,74,108,-34
PYF,FRA,2002.0,6,9,-3
FIN,DNK,2004.0,10,8,2
FIN,CAN,1999.0,12,12,0
BEL,BGR,2002.0,6,9,-3
ITA,BGR,2007.0,6,3,3
RUS,ESP,2002.0,11,15,-4
PAK,SAU,2009.0,19,10,9
FRA,RUS,2015.0,65,61,4
BEL,GRC,2015.0,9,21,-12
BHR,ARE,2008.0,3,1,2
DEU,SVK,1998.0,11,8,3
BLR,RUS,2004.0,21,14,7
DEU,CZE,2015.0,48,49,-1
FRA,ESP,2000.0,153,116,37
ESP,FRA,1998.0,136,90,46
DEU,AUS,2015.0,178,176,2
NZL,ZAF,2008.0,4,8,-4
ZAF,DEU,2017.0,31,27,4
CHN,TWN,1998.0,68,53,15
ZWE,NGA,1997.0,4,3,1
TUR,USA,2001.0,164,212,-48
SGP,POL,2013.0,3,3,0
AUS,SWE,2000.0,21,25,-4
GBR,IND,2002.0,84,109,-25
AUT,ESP,2002.0,21,13,8
DEU,GRC,2000.0,32,21,11
ARG,USA,2002.0,160,126,34
USA,KEN,2015.0,50,53,-3
BRA,BEL,2007.0,8,20,-12
CAN,BRA,1998.0,30,15,15
JPN,DEU,2004.0,125,107,18
MEX,CAN,2000.0,19,22,-3
NLD,NZL,1997.0,10,3,7
FRA,SEN,2002.0,37,28,9
ITA,BGR,1998.0,6,3,3
THA,AUS,1999.0,5,14,-9
SAU,NGA,2002.0,1,1,0
AZE,TUR,2007.0,8,4,4
DEU,QAT,2016.0,5,2,3
CHE,JPN,2016.0,42,37,5
CHE,NLD,2009.0,65,65,0
ISR,CAN,2015.0,60,63,-3
DEU,SVN,2002.0,9,5,4
USA,CIV,1999.0,3,2,1
TUR,JPN,2002.0,13,7,6
DNK,USA,2000.0,115,117,-2
CAN,GRC,2008.0,9,11,-2
DEU,HUN,2000.0,37,50,-13
CZE,BEL,2001.0,7,5,2
CAN,TWN,2003.0,18,9,9
SRB,USA,1998.0,28,23,5
AUS,NZL,2016.0,126,163,-37
JPN,IND,1999.0,38,80,-42
IND,SWE,2002.0,14,6,8
HUN,AUT,2021.0,54,13,41
BOL,FRA,2014.0,8,2,6
ITA,HUN,2007.0,7,7,0
GBR,ZAF,1998.0,41,46,-5
NPL,IND,2003.0,13,16,-3
CAN,ESP,2001.0,23,28,-5
ITA,NOR,2014.0,18,11,7
CHN,FRA,2000.0,29,34,-5
HUN,CZE,2001.0,2,3,-1
USA,PRI,2005.0,77,70,7
AUS,ITA,2009.0,15,30,-15
AUS,AUT,2014.0,60,84,-24
DNK,CHN,2016.0,54,66,-12
DEU,VEN,2003.0,4,5,-1
USA,EGY,1999.0,53,42,11
DNK,DEU,2000.0,51,69,-18
CHL,BRA,2008.0,12,19,-7
CHN,BEL,2001.0,14,11,3
FRA,ITA,1998.0,151,160,-9
MEX,ARG,2005.0,10,8,2
BLR,RUS,2001.0,25,26,-1
ITA,BRA,2002.0,30,20,10
ITA,RUS,2010.0,15,25,-10
ITA,IND,1999.0,7,18,-11
AUS,DEU,2015.0,176,178,-2
VEN,FRA,2008.0,6,5,1
CAN,CHE,2018.0,96,103,-7
SWE,POL,2003.0,13,18,-5
ITA,RUS,2006.0,17,25,-8
ETH,USA,2016.0,29,30,-1
BGR,DEU,2014.0,18,10,8
BRA,CAN,2014.0,80,55,25
ZAF,CHE,2016.0,23,14,9
ITA,IRN,2005.0,4,2,2
IRN,ITA,2006.0,5,4,1
BGR,FRA,1999.0,14,6,8
ZAF,DEU,2016.0,32,36,-4
USA,TUR,1997.0,59,55,4
JPN,SGP,2010.0,33,22,11
USA,ARE,2000.0,28,6,22
CAN,MEX,2001.0,24,20,4
BEL,GBR,2015.0,127,118,9
NOR,USA,2000.0,76,71,5
USA,NOR,2001.0,70,76,-6
RUS,FIN,2023.0,21,13,8
CHE,ISR,2000.0,11,3,8
SAU,TUR,2006.0,3,3,0
BEL,IRN,2008.0,8,2,6
ESP,FRA,1999.0,110,145,-35
IRL,DEU,1999.0,5,12,-7
ARG,ESP,2003.0,81,57,24
DNK,MYS,2002.0,2,1,1
USA,PAN,2003.0,13,17,-4
DEU,RUS,2000.0,99,226,-127
CAN,FRA,2006.0,164,268,-104
MEX,BRA,2023.0,10,18,-8
RUS,FIN,2000.0,20,12,8
AUT,ITA,1998.0,14,14,0
POL,NLD,1998.0,10,6,4
NOR,GBR,1998.0,21,23,-2
CAN,ISR,2001.0,41,30,11
FRA,MDG,1998.0,5,4,1
GBR,SVN,2002.0,5,5,0
ARG,BRA,2012.0,32,24,8
SWE,CZE,2000.0,3,1,2
MYS,JPN,2003.0,11,15,-4
JPN,NGA,2011.0,8,9,-1
JPN,KEN,1999.0,7,3,4
SGP,DEU,2002.0,10,14,-4
USA,AUT,2002.0,135,147,-12
SWE,DNK,2002.0,81,77,4
MKD,SRB,2005.0,66,30,36
CHL,MEX,2014.0,14,18,-4
BGR,CAN,2006.0,4,2,2
POL,USA,2000.0,121,112,9
CUB,BRA,2000.0,6,6,0
POL,SVK,2006.0,4,3,1
GBR,MEX,2016.0,63,53,10
RUS,GBR,2023.0,53,21,32
NOR,SWE,2013.0,54,66,-12
NOR,POL,2023.0,4,6,-2
CAN,CHE,2017.0,127,106,21
SRB,ESP,2005.0,3,3,0
NOR,GBR,1999.0,20,29,-9
FIN,CAN,2007.0,12,9,3
HUN,FIN,2005.0,5,3,2
LBN,CAN,2001.0,5,2,3
AUS,TZA,2009.0,2,2,0
SRB,MKD,1999.0,11,7,4
NZL,SWE,2000.0,8,6,2
SEN,FRA,1998.0,18,16,2
NLD,ESP,1997.0,31,26,5
SAU,GBR,2006.0,17,21,-4
CAN,AUS,2000.0,107,98,9
USA,NGA,1998.0,19,23,-4
HUN,AUT,2019.0,33,16,17
FRA,LBN,2016.0,86,43,43
SRB,ITA,2008.0,10,7,3
FIN,CAN,1998.0,20,13,7
CHE,ESP,2012.0,51,76,-25
RUS,ISR,2019.0,23,15,8
FRA,ARE,2014.0,15,3,12
POL,DEU,1999.0,59,58,1
CAN,ITA,2000.0,39,37,2
ITA,SRB,2004.0,8,10,-2
JPN,BEL,2006.0,16,16,0
JPN,BEL,2000.0,8,16,-8
ISR,RUS,1998.0,16,31,-15
GRC,ITA,2003.0,11,23,-12
DEU,KOR,2008.0,29,30,-1
HRV,SRB,2014.0,17,15,2
CHE,NZL,2002.0,6,6,0
ZAF,GBR,2019.0,113,95,18
ECU,FRA,2004.0,4,1,3
IND,CAN,1999.0,39,22,17
BEL,BRA,2016.0,26,22,4
CZE,GBR,1997.0,32,29,3
NLD,CZE,2019.0,14,9,5
AUS,SGP,1998.0,30,13,17
ITA,SWE,1997.0,19,21,-2
ARE,NLD,2014.0,2,5,-3
USA,LBN,2008.0,36,53,-17
VNM,JPN,2012.0,13,44,-31
USA,KWT,2002.0,12,14,-2
DNK,BEL,2003.0,6,5,1
THA,USA,2015.0,129,257,-128
DEU,HRV,2003.0,15,14,1
MEX,USA,1997.0,93,115,-22
FRA,TUN,1999.0,56,35,21
BRA,CAN,2001.0,45,29,16
CAN,BEL,2003.0,20,34,-14
USA,MYS,2017.0,37,68,-31
IRN,GBR,2015.0,48,40,8
BRN,GBR,2002.0,4,3,1
FIN,BEL,2010.0,8,4,4
CHN,KOR,2004.0,36,52,-16
CHE,PRT,2004.0,8,3,5
PRT,CHE,2005.0,6,9,-3
RUS,KAZ,2004.0,5,8,-3
GBR,NZL,2021.0,138,121,17
DEU,UKR,1999.0,15,38,-23
FRA,ROU,2003.0,18,40,-22
FRA,JPN,2000.0,82,77,5
ESP,MEX,2018.0,215,161,54
MEX,RUS,2017.0,6,6,0
GBR,BRA,2003.0,59,59,0
RUS,SRB,1999.0,8,8,0
ITA,CHN,2001.0,11,12,-1
DEU,EGY,1998.0,17,10,7
DEU,BLR,2020.0,4,8,-4
ARG,GBR,2007.0,8,15,-7
FRA,MEX,2002.0,49,33,16
MEX,FRA,2003.0,28,51,-23
UGA,DNK,2002.0,2,1,1
CAN,POL,2015.0,11,28,-17
COL,FRA,2003.0,6,4,2
ETH,GBR,2004.0,3,10,-7
POL,FRA,1999.0,37,36,1
PHL,SGP,2017.0,8,6,2
ESP,RUS,2016.0,19,9,10
ZAF,NGA,2000.0,5,1,4
ITA,POL,2002.0,15,17,-2
HKG,KOR,2001.0,5,2,3
SWE,FIN,2012.0,50,53,-3
BGR,GBR,2008.0,8,5,3
ARG,CAN,2003.0,23,13,10
IRL,BEL,2016.0,11,7,4
SWE,AUS,1998.0,15,27,-12
ROU,GRC,2001.0,2,2,0
BRA,FRA,2000.0,45,83,-38
ESP,HUN,2019.0,9,4,5
THA,USA,2004.0,64,179,-115
CAN,CUB,2010.0,3,4,-1
BEL,DEU,1997.0,39,46,-7
SVK,RUS,1998.0,5,5,0
GBR,KOR,2004.0,40,21,19
GBR,KOR,2014.0,47,43,4
AUS,ARG,2002.0,6,6,0
CAN,KWT,2006.0,12,5,7
CHL,ZAF,2015.0,2,4,-2
GBR,ISR,1999.0,32,32,0
SWE,DEU,1998.0,44,84,-40
AUS,HKG,2009.0,25,49,-24
FRA,FIN,2016.0,36,29,7
PRT,SWE,2004.0,8,5,3
AUS,AUT,2015.0,66,37,29
TUR,ISR,2010.0,4,1,3
ECU,FRA,2001.0,10,2,8
CAN,POL,2004.0,12,19,-7
PRI,ESP,2019.0,7,3,4
USA,BLR,2004.0,9,10,-1
PAK,GBR,2003.0,17,38,-21
PRT,ITA,1999.0,4,9,-5
MDG,FRA,2005.0,6,7,-1
SWE,FIN,2002.0,44,45,-1
CAN,SWE,2017.0,53,35,18
NLD,CHE,1997.0,22,21,1
BGR,FRA,1998.0,13,13,0
BGR,DEU,2001.0,53,12,41
CHL,BRA,2001.0,9,13,-4
BRA,CHL,2004.0,13,5,8
CHE,ROU,2009.0,5,3,2
ROU,DEU,2010.0,22,25,-3
POL,ZAF,1999.0,2,2,0
ITA,FRA,2002.0,194,234,-40
HKG,GBR,2019.0,73,53,20
USA,COL,2017.0,146,134,12
VNM,RUS,2018.0,7,27,-20
FRA,FIN,2017.0,34,28,6
RUS,EST,2016.0,1,5,-4
GBR,HKG,2002.0,40,39,1
TUR,CAN,2011.0,20,25,-5
GBR,PAK,2017.0,89,70,19
SGP,JPN,2022.0,41,22,19
EGY,CAN,2014.0,34,51,-17
LBY,CAN,2013.0,3,1,2
ESP,CHL,2016.0,153,92,61
NOR,GHA,2023.0,3,2,1
CMR,MAR,2021.0,3,2,1
KOR,MAR,2023.0,1,2,-1
IND,ISR,2020.0,141,71,70
FRA,FIN,2018.0,26,27,-1
SDN,KEN,2020.0,2,1,1
MYS,BGD,2018.0,78,24,54
AUS,PHL,2021.0,16,12,4
JPN,CAN,2019.0,85,88,-3
BWA,USA,2019.0,16,12,4
VNM,SGP,2013.0,3,1,2
HKG,SWE,2019.0,5,3,2
BRA,MEX,2018.0,39,29,10
NPL,AUS,2020.0,22,7,15
JPN,FIN,2000.0,10,5,5
MYS,IRN,2016.0,176,32,144
TUR,CAN,2019.0,49,19,30
SWE,ROU,2019.0,6,2,4
RUS,CHE,2013.0,29,10,19
TUR,SAU,2013.0,6,4,2
CUB,MEX,2016.0,41,4,37
FRA,LBN,2018.0,137,52,85
BRA,COL,2016.0,54,49,5
FRA,MDG,2020.0,12,10,2
IDN,NLD,2021.0,39,58,-19
NLD,FIN,2017.0,25,21,4
BRA,ZAF,2022.0,4,7,-3
IRQ,SWE,2016.0,5,3,2
ITA,GRC,2016.0,23,38,-15
NOR,DEU,2020.0,47,76,-29
AUS,FIN,2013.0,11,14,-3
NLD,NOR,2017.0,44,11,33
MYS,TWN,2012.0,2,3,-1
FRA,MYS,2014.0,10,6,4
HKG,SWE,2021.0,6,2,4
CHE,JPN,2018.0,36,51,-15
ITA,IND,2020.0,48,55,-7
ROU,NOR,2010.0,2,3,-1
USA,ZAF,2017.0,113,143,-30
EGY,ARE,2018.0,26,11,15
SMR,ITA,2019.0,5,7,-2
AUT,CHE,2023.0,45,40,5
AUT,FRA,2000.0,20,19,1
GBR,TUR,2009.0,38,28,10
AUS,MYS,2013.0,103,103,0
SRB,BIH,2015.0,26,10,16
ZAF,NLD,2017.0,31,37,-6
BRA,MEX,2017.0,42,30,12
BEL,NLD,2017.0,176,172,4
FRA,THA,2009.0,9,16,-7
BRA,CZE,2019.0,13,3,10
PER,ESP,2022.0,20,16,4
CHE,CHN,2021.0,99,93,6
MAC,CAN,2022.0,1,1,0
MYS,LKA,2017.0,8,2,6
DEU,IND,2020.0,154,223,-69
IRN,AUS,2013.0,120,33,87
AUS,NLD,2022.0,87,58,29
USA,COL,2018.0,154,160,-6
DEU,SGP,2018.0,37,41,-4
NOR,ISL,2009.0,1,1,0
USA,GAB,2021.0,7,4,3
CAN,SWE,2018.0,47,44,3
LKA,GBR,2019.0,18,24,-6
BRB,GBR,2017.0,3,2,1
IRN,BEL,2016.0,23,13,10
ZWE,ZAF,2017.0,40,37,3
AUT,LUX,2016.0,2,4,-2
CAN,CHE,2022.0,94,75,19
NOR,GBR,2020.0,69,118,-49
THA,CAN,2016.0,17,27,-10
HRV,CZE,2016.0,7,1,6
SVK,SVN,2008.0,23,30,-7
AUS,NZL,2017.0,139,156,-17
PRT,NLD,2018.0,37,27,10
DEU,TWN,2013.0,17,21,-4
RUS,ITA,2014.0,16,21,-5
SWE,SAU,2021.0,12,8,4
ARE,CAN,2021.0,33,32,1
EGY,CHN,2017.0,28,12,16
BEL,CHL,2019.0,11,12,-1
CHE,ISR,2023.0,16,9,7
ZAF,CHE,2022.0,14,6,8
FIN,ITA,2017.0,16,25,-9
GLP,FRA,2016.0,43,27,16
POL,VNM,2016.0,7,6,1
ETH,USA,2022.0,28,28,0
OMN,GBR,2022.0,14,11,3
KOR,JPN,2023.0,46,57,-11
NLD,CHN,2023.0,128,131,-3
SWE,CHN,2023.0,95,72,23
BGD,AUS,2020.0,85,70,15
JPN,NLD,2019.0,31,42,-11
LKA,SGP,2017.0,1,2,-1
PAK,ARE,2023.0,25,10,15
KWT,AUS,2015.0,2,7,-5
NOR,GRC,2019.0,6,9,-3
CHN,IND,2020.0,105,258,-153
IRN,MYS,2013.0,100,109,-9
MYS,IRN,2018.0,133,32,101
ESP,AUT,2014.0,38,15,23
DEU,PSE,2018.0,7,2,5
CHE,KOR,2011.0,5,9,-4
SAU,HKG,2023.0,3,3,0
MAC,CHN,2016.0,59,86,-27
SEN,TGO,2022.0,2,1,1
GBR,BRN,2015.0,10,2,8
CRI,USA,2016.0,21,33,-12
RUS,CAN,2017.0,25,21,4
YEM,USA,2018.0,1,2,-1
YEM,USA,2022.0,2,4,-2
HKG,CAN,2020.0,30,23,7
TWN,KOR,2018.0,20,12,8
FJI,AUS,2021.0,13,4,9
CHN,ESP,2020.0,55,70,-15
BRA,CHE,2018.0,44,24,20
VEN,BRA,2016.0,6,6,0
NLD,CAN,2018.0,69,75,-6
KOR,HKG,2018.0,17,16,1
GEO,USA,2017.0,140,210,-70
GBR,DNK,2015.0,111,94,17
USA,RWA,2014.0,20,8,12
CAN,MAR,2013.0,10,3,7
DNK,GRL,2019.0,13,4,9
USA,HTI,2011.0,5,6,-1
HRV,SVN,2016.0,12,18,-6
SWE,JPN,2022.0,30,26,4
DEU,IRN,2019.0,46,149,-103
DNK,THA,2017.0,4,3,1
TWN,NZL,2019.0,2,2,0
MYS,SAU,2020.0,68,33,35
TUN,DZA,2017.0,4,3,1
POL,AUT,2020.0,20,7,13
KOR,GHA,2022.0,4,1,3
ZAF,NLD,2016.0,26,33,-7
JPN,MYS,2016.0,71,40,31
TWN,DEU,2017.0,26,15,11
FRA,HKG,2019.0,8,11,-3
THA,USA,2014.0,115,255,-140
AUS,KEN,2020.0,8,7,1
IRN,DNK,2020.0,45,12,33
LAO,THA,2013.0,2,3,-1
JPN,KOR,2019.0,113,112,1
GBR,PAK,2018.0,100,77,23
SGP,NZL,2018.0,17,15,2
TUR,CAN,2021.0,48,23,25
COL,BRA,2019.0,59,107,-48
IRN,KOR,2012.0,7,1,6
ROU,CAN,2009.0,2,7,-5
VEN,MEX,2001.0,9,4,5
POL,SVK,2023.0,4,1,3
AUS,IRN,2005.0,23,14,9
IRN,CHE,2018.0,25,17,8
GAB,DEU,2019.0,4,4,0
GBR,DZA,2012.0,4,2,2
BRA,CHE,2022.0,39,18,21
COL,CHL,2016.0,22,20,2
DZA,PAK,2016.0,1,3,-2
THA,IDN,2016.0,10,4,6
HRV,SVN,2018.0,11,14,-3
DEU,EST,2021.0,11,16,-5
SWE,JPN,2017.0,31,26,5
IRL,NLD,2020.0,20,30,-10
ZAF,BEL,2016.0,11,18,-7
ZWE,NAM,2013.0,1,1,0
NLD,BRA,2020.0,38,74,-36
IRQ,AUS,2016.0,7,5,2
AUS,IRQ,2017.0,15,5,10
GBR,PAK,2022.0,79,92,-13
RUS,CZE,2016.0,13,20,-7
ESP,VEN,2011.0,26,48,-22
FRA,BEL,2016.0,245,227,18
TWN,AUS,2020.0,28,16,12
CAN,KOR,2021.0,36,56,-20
KOR,CAN,2018.0,61,42,19
ZAF,NOR,2023.0,2,2,0
SAU,SDN,2020.0,23,35,-12
IRN,PRT,2019.0,16,4,12
USA,BEL,2022.0,142,147,-5
DNK,AUS,2016.0,48,35,13
POL,CHL,2020.0,5,2,3
CHL,POL,2022.0,2,3,-1
JPN,MYS,2017.0,68,56,12
AUS,THA,2010.0,41,26,15
HKG,AUS,2012.0,44,40,4
MYS,CHN,2022.0,75,62,13
FRA,JPN,2023.0,49,38,11
CHL,USA,2021.0,150,126,24
UKR,SVK,2023.0,13,6,7
BRA,DNK,2020.0,26,15,11
ROU,DEU,2000.0,27,15,12
HUN,AUS,2020.0,5,9,-4
CHN,FRA,2023.0,130,155,-25
PAK,THA,2021.0,13,19,-6
THA,PAK,2022.0,7,7,0
ITA,JPN,2016.0,23,26,-3
GBR,CHL,2020.0,53,56,-3
RUS,UKR,2008.0,72,34,38
SEN,FRA,1999.0,24,25,-1
USA,KNA,2015.0,3,6,-3
DEU,COL,2023.0,12,12,0
ETH,ZAF,2019.0,9,19,-10
TUR,ZAF,2020.0,4,1,3
USA,LAO,2019.0,4,5,-1
MYS,ARE,2018.0,32,3,29
PHL,SGP,2016.0,10,4,6
USA,URY,2022.0,10,10,0
CHL,CHE,2020.0,7,10,-3
ECU,USA,2016.0,17,39,-22
ARG,GBR,2020.0,31,18,13
HUN,CHN,2020.0,8,10,-2
UKR,BLR,2019.0,3,2,1
JPN,EGY,2005.0,39,21,18
NLD,SWE,2023.0,45,45,0
TZA,BEL,2020.0,3,3,0
COL,BRA,2021.0,60,106,-46
IRN,AUT,2020.0,40,7,33
MYS,CHN,2016.0,18,9,9
BGD,CAN,2020.0,44,28,16
DEU,CAN,2016.0,176,169,7
ARG,DNK,2021.0,8,1,7
THA,TWN,2019.0,8,21,-13
JPN,HUN,2023.0,2,5,-3
SDN,ZAF,2019.0,4,5,-1
COL,CHE,2020.0,13,3,10
NZL,CHN,2020.0,51,54,-3
CAN,ARG,2005.0,12,13,-1
USA,IRN,2014.0,113,467,-354
GBR,MEX,2017.0,75,47,28
HUN,ITA,2017.0,20,7,13
FRA,THA,2019.0,21,14,7
FRA,BRA,2014.0,139,118,21
SGP,FIN,2022.0,8,3,5
VEN,ESP,2022.0,14,10,4
SGP,JPN,2016.0,37,54,-17
GBR,BGD,2019.0,35,14,21
MYS,JOR,2013.0,18,8,10
MNG,FRA,2021.0,1,1,0
IRQ,MYS,2021.0,48,149,-101
CAN,SGP,2018.0,39,24,15
ITA,CAN,2021.0,55,50,5
EGY,ESP,2020.0,9,19,-10
CHL,ESP,2007.0,37,51,-14
SWE,BRA,2000.0,3,4,-1
NZL,ESP,2022.0,8,3,5
USA,PAK,2011.0,53,51,2
KGZ,CHE,2018.0,2,2,0
NGA,DEU,2020.0,10,8,2
USA,GRD,2009.0,1,8,-7
ESP,ITA,2023.0,141,159,-18
MOZ,BEL,2022.0,1,4,-3
MYS,QAT,2023.0,6,4,2
IND,HUN,2020.0,10,8,2
SWE,FRA,2019.0,73,92,-19
GBR,BGD,2021.0,38,32,6
IRL,IND,2015.0,18,19,-1
ZAF,DEU,2022.0,32,34,-2
USA,NOR,2015.0,118,74,44
IRN,FRA,2019.0,46,22,24
USA,FIN,2010.0,65,89,-24
TZA,NLD,2019.0,9,3,6
FRA,HUN,2012.0,17,14,3
JPN,ZMB,2021.0,5,5,0
ESP,POL,2019.0,27,25,2
GBR,ISR,2020.0,55,64,-9
GAB,DEU,2021.0,7,1,6
BGR,USA,2019.0,10,10,0
IRL,USA,2013.0,154,130,24
SAU,GBR,2000.0,16,22,-6
FIN,CHE,2015.0,24,10,14
HRV,USA,2018.0,11,14,-3
DEU,GHA,2020.0,24,15,9
HKG,IRL,2019.0,3,2,1
HKG,IRL,2021.0,7,1,6
CHN,NPL,2019.0,17,8,9
BGD,BEL,2019.0,4,6,-2
AUS,BEL,2017.0,37,25,12
KWT,KOR,2019.0,1,1,0
COL,ESP,2017.0,91,159,-68
ITA,NLD,2022.0,134,103,31
UKR,EST,2019.0,3,2,1
MYS,NLD,2017.0,14,9,5
IRL,CAN,2015.0,43,32,11
NER,NGA,2012.0,14,4,10
USA,ARM,2020.0,10,5,5
AUS,IND,1998.0,13,22,-9
BEL,VNM,2017.0,21,7,14
COL,CHL,2017.0,30,28,2
IRN,BEL,2022.0,48,5,43
USA,IRN,2015.0,101,503,-402
GBR,PAK,2016.0,99,42,57
PSE,GBR,2001.0,1,1,0
BIH,SRB,2010.0,7,4,3
JPN,ITA,2018.0,28,33,-5
NZL,PAK,2022.0,5,3,2
GRC,PRT,2002.0,2,1,1
CHN,POL,2023.0,22,12,10
MCO,FRA,2003.0,5,5,0
KOR,AUS,2013.0,41,32,9
EGY,YEM,2013.0,5,3,2
NOR,JPN,2003.0,6,8,-2
TUR,NLD,2021.0,37,26,11
PAK,CAN,2022.0,41,18,23
SOM,KEN,2019.0,1,1,0
ISR,NZL,2022.0,6,1,5
ESP,NLD,2023.0,48,59,-11
EGY,MAR,2020.0,3,5,-2
PAK,OMN,2019.0,12,2,10
BRA,NLD,2023.0,38,16,22
MEX,GBR,2023.0,27,27,0
SVN,DEU,2022.0,16,11,5
KWT,USA,2022.0,15,22,-7
GRC,CHE,1998.0,4,4,0
SYR,DEU,2019.0,4,4,0
FRA,NCL,2023.0,16,13,3
KOR,AUT,2022.0,6,5,1
MYS,IND,2001.0,7,10,-3
IRN,PRT,2021.0,16,1,15
BGD,GBR,2021.0,32,38,-6
POL,FIN,2015.0,4,7,-3
AUS,ZAF,2021.0,19,49,-30
TUR,ITA,2021.0,24,20,4
USA,CHL,2023.0,59,59,0
IDN,THA,2019.0,11,26,-15
AUS,HKG,2019.0,39,54,-15
ITA,AUT,2018.0,90,54,36
ITA,BEL,2001.0,51,45,6
RUS,HUN,2020.0,4,2,2
AUS,RUS,2019.0,10,15,-5
COL,AUT,2023.0,2,1,1
PRT,NLD,2022.0,27,17,10
LKA,GBR,2009.0,5,9,-4
JOR,QAT,2022.0,16,5,11
FRA,THA,2021.0,30,17,13
EGY,DEU,2022.0,46,36,10
MYS,IND,2004.0,12,12,0
SWE,EST,2022.0,6,11,-5
ZAF,ETH,2022.0,12,6,6
LBN,ITA,2021.0,5,4,1
ARE,SAU,2018.0,11,50,-39
EGY,HKG,2020.0,1,1,0
CHN,GHA,2023.0,37,12,25
NLD,ESP,2005.0,31,30,1
FRA,LBN,2022.0,46,106,-60
USA,NZL,2024.0,1,1,0
NLD,HKG,2021.0,9,10,-1
PAK,IRL,2022.0,19,10,9
HKG,MYS,2010.0,5,3,2
SDN,GBR,2021.0,5,4,1
ZWE,GBR,2022.0,8,9,-1
FIN,FRA,2023.0,14,12,2
CIV,FRA,2022.0,12,14,-2
JPN,MYS,2022.0,32,16,16
USA,ARE,2023.0,48,49,-1
DEU,ROU,2021.0,18,22,-4
MMR,CHN,2021.0,9,9,0
ARE,DEU,2021.0,9,15,-6
BLR,POL,2023.0,3,1,2
IND,PHL,2022.0,6,6,0
FRA,FIN,2022.0,33,25,8
NOR,IND,2023.0,16,20,-4
ESP,DOM,2022.0,5,2,3
KOR,GBR,2016.0,62,42,20
TUR,TUN,2022.0,1,2,-1
IRQ,MYS,2019.0,25,191,-166
TUR,FRA,2010.0,17,15,2
RWA,CHN,2018.0,4,3,1
MYS,OMN,2013.0,7,2,5
PAK,SGP,2021.0,10,7,3
KOR,EGY,2010.0,9,4,5
CHE,POL,2004.0,9,17,-8
ESP,AND,2021.0,8,3,5
ZAF,SAU,2020.0,21,9,12
AZE,IRN,2022.0,1,4,-3
NOR,FRA,2023.0,19,38,-19
TUN,DZA,2022.0,10,7,3
ISR,NLD,2014.0,9,9,0
AUT,FRA,2023.0,23,23,0
LKA,USA,2022.0,29,19,10
PHL,ITA,2018.0,3,3,0
THA,CHN,2023.0,38,57,-19
MYS,CHN,2018.0,52,15,37
ZAF,LSO,2021.0,13,7,6
SVK,DEU,2023.0,5,1,4
BEL,BRA,2022.0,13,32,-19
AUS,DEU,2004.0,73,98,-25
GBR,KWT,1997.0,8,1,7
MDG,FRA,1997.0,4,4,0
GBR,OMN,2000.0,7,3,4
JPN,CZE,1997.0,7,8,-1
KOR,IRN,2011.0,6,12,-6
GBR,GRC,2014.0,129,248,-119
SAU,NGA,2012.0,6,7,-1
SRB,CHE,2001.0,2,3,-1
RUS,DNK,2000.0,14,9,5
JAM,CAN,2015.0,5,2,3
OMN,JOR,2001.0,1,4,-3
AUT,FIN,2016.0,13,12,1
ETH,GHA,2006.0,2,2,0
THA,DNK,2002.0,1,3,-2
FIN,RUS,1998.0,15,24,-9
DEU,SVK,1999.0,7,10,-3
SVK,DEU,2010.0,14,14,0
DEU,MEX,2000.0,15,11,4
UKR,KOR,2001.0,3,2,1
ITA,POL,1997.0,10,10,0
ARG,HUN,2002.0,1,1,0
DNK,NOR,1997.0,15,10,5
BRA,RUS,2014.0,5,13,-8
GBR,FIN,2006.0,30,28,2
DEU,AUS,2001.0,92,84,8
DEU,PRT,2012.0,39,30,9
FRA,AUS,1999.0,47,45,2
NLD,ESP,2002.0,52,47,5
NOR,CHE,2014.0,6,17,-11
KAZ,HKG,2023.0,1,2,-1
USA,MAR,2019.0,16,18,-2
NLD,NZL,2002.0,10,17,-7
HRV,AUT,2001.0,7,2,5
RUS,SRB,1998.0,3,15,-12
CHL,BRA,2014.0,21,29,-8
CAN,NZL,1998.0,24,14,10
FRA,TUN,1998.0,42,26,16
DEU,IND,2007.0,66,110,-44
SGP,USA,2001.0,114,101,13
SWE,ITA,1997.0,21,19,2
IRL,AUS,2000.0,7,8,-1
CHE,GRC,1997.0,7,2,5
CZE,SVK,2012.0,52,63,-11
EGY,JPN,1998.0,7,12,-5
IRL,ZAF,2004.0,6,3,3
ITA,DEU,2005.0,151,144,7
GBR,RUS,2007.0,29,67,-38
RUS,BRA,2008.0,4,1,3
CHL,PER,2006.0,4,1,3
DNK,USA,2010.0,110,111,-1
POL,ESP,2008.0,13,5,8
USA,ASM,2014.0,2,4,-2
FRA,MYS,2015.0,12,3,9
AUS,MWI,2017.0,1,1,0
FRA,SEN,2005.0,29,27,2
ZAF,BRA,2022.0,7,4,3
AUT,SVK,2007.0,11,9,2
ISR,RUS,2007.0,3,4,-1
GBR,PRT,2000.0,61,23,38
AUT,UKR,1997.0,3,5,-2
RUS,UZB,1998.0,7,9,-2
DEU,KOR,2004.0,23,23,0
ITA,ESP,1997.0,45,50,-5
NZL,TUR,2012.0,2,3,-1
RUS,CAN,2018.0,25,18,7
NGA,DEU,1999.0,6,6,0
DEU,WSM,2000.0,1,1,0
BIH,HRV,2008.0,8,15,-7
ISR,FRA,2005.0,26,22,4
DZA,FRA,2017.0,52,134,-82
DEU,PAN,2017.0,2,2,0
ESP,BEL,2007.0,20,18,2
AZE,RUS,1997.0,7,9,-2
AUT,CAN,2003.0,17,19,-2
JPN,DNK,2001.0,8,9,-1
ITA,RUS,2000.0,28,48,-20
JPN,DNK,2015.0,5,9,-4
CHE,ISR,2010.0,7,17,-10
FRA,RUS,2001.0,68,82,-14
TWN,SWE,2016.0,7,1,6
IND,FRA,2013.0,71,73,-2
SEN,USA,2011.0,3,6,-3
ROU,GBR,2014.0,26,15,11
POL,RUS,2014.0,10,13,-3
AUT,SWE,2006.0,12,8,4
AUS,NLD,2017.0,79,109,-30
USA,TZA,2000.0,5,4,1
DNK,SWE,2002.0,77,81,-4
BRA,POL,2011.0,1,4,-3
BLR,DEU,2003.0,19,6,13
ROU,USA,1999.0,26,20,6
ESP,RUS,2018.0,14,9,5
ESP,ARG,2001.0,62,75,-13
NLD,ZAF,2004.0,13,15,-2
USA,SWE,1998.0,150,219,-69
CAN,PAK,2008.0,11,11,0
SRB,MKD,2007.0,20,25,-5
KOR,BGD,2007.0,7,12,-5
SWE,DNK,1997.0,31,35,-4
ARG,URY,2009.0,3,10,-7
CAN,ARG,2002.0,10,21,-11
ARG,VEN,1997.0,2,2,0
USA,PRI,1997.0,42,32,10
SWE,POL,2013.0,13,20,-7
CHE,ARG,2014.0,6,5,1
USA,NPL,2006.0,2,10,-8
IRL,AUS,2006.0,31,16,15
AUT,BEL,2003.0,8,4,4
JPN,FRA,1998.0,37,72,-35
ARE,USA,2003.0,9,18,-9
THA,USA,2001.0,70,101,-31
UKR,SWE,1998.0,10,4,6
HUN,SAU,2019.0,1,2,-1
NOR,DNK,2005.0,18,27,-9
GBR,BEL,2002.0,72,83,-11
GBR,BGR,2003.0,11,12,-1
ESP,VEN,2019.0,20,26,-6
USA,CZE,2001.0,36,52,-16
ISR,GBR,1998.0,27,28,-1
NZL,DEU,2004.0,12,30,-18
ISR,CAN,2001.0,30,41,-11
CHL,URY,2001.0,3,1,2
SAU,ARE,2016.0,40,13,27
ARE,ITA,2019.0,5,18,-13
NLD,SGP,2018.0,19,13,6
DEU,MEX,2010.0,28,17,11
USA,UZB,2003.0,2,3,-1
AUS,DEU,2001.0,84,92,-8
UKR,RUS,2010.0,45,55,-10
NGA,ZAF,1999.0,6,2,4
HKG,MYS,2006.0,4,1,3
UKR,RUS,2006.0,53,33,20
TTO,FRA,2003.0,3,2,1
ITA,CAN,2011.0,59,39,20
GBR,EGY,2002.0,19,13,6
NZL,ESP,2018.0,9,6,3
BEL,JPN,1998.0,5,6,-1
QAT,JOR,2002.0,2,2,0
ARE,SWE,2012.0,2,1,1
GBR,EGY,2012.0,61,26,35
FRA,REU,2018.0,31,22,9
GRC,NLD,2001.0,12,17,-5
NLD,GRC,2003.0,11,14,-3
SWE,NLD,1997.0,10,15,-5
SWE,BRA,2006.0,7,8,-1
PAK,SAU,2019.0,92,100,-8
BRA,PRT,1998.0,18,38,-20
SWE,BEL,1999.0,12,6,6
RUS,POL,2005.0,11,13,-2
POL,RUS,2008.0,17,6,11
CHE,CZE,1997.0,9,3,6
SVK,FRA,2002.0,6,7,-1
HUN,BEL,2004.0,6,4,2
FRA,ARG,2006.0,23,18,5
GBR,BEL,1997.0,39,37,2
FRA,MDA,2000.0,3,5,-2
IDN,USA,1999.0,16,16,0
AUT,HUN,2000.0,9,12,-3
NLD,JPN,2002.0,22,27,-5
JPN,AUS,2022.0,40,75,-35
VNM,USA,2000.0,10,4,6
ROU,FRA,2019.0,19,26,-7
IND,ITA,1997.0,10,10,0
BEL,DEU,2005.0,63,59,4
ESP,PER,2010.0,6,10,-4
ESP,PRT,2000.0,22,16,6
ESP,JPN,2004.0,12,4,8
CAN,SAU,1998.0,16,14,2
IND,BRA,2002.0,2,7,-5
USA,POL,2023.0,53,73,-20
USA,VEN,2003.0,62,44,18
TUN,PRT,2008.0,2,1,1
SVN,USA,2001.0,15,6,9
EST,FIN,2007.0,8,3,5
FIN,EST,2014.0,12,7,5
POL,BLR,2016.0,4,4,0
RUS,ITA,2015.0,14,32,-18
NLD,IRN,2022.0,16,51,-35
PER,BRA,2011.0,12,5,7
CAN,ISR,2015.0,63,60,3
DEU,QAT,2018.0,4,6,-2
ARE,AUS,2009.0,6,11,-5
USA,CHL,2010.0,110,89,21
SWE,ZAF,2000.0,7,2,5
JPN,FIN,2006.0,8,8,0
FRA,AUS,1998.0,29,34,-5
HUN,NLD,1998.0,8,13,-5
CAN,TUN,2016.0,19,3,16
FRA,MTQ,2013.0,19,33,-14
USA,OMN,2004.0,6,6,0
OMN,USA,2006.0,2,6,-4
ESP,CZE,2007.0,5,5,0
NOR,ZAF,2005.0,2,1,1
NOR,NLD,2015.0,15,41,-26
CAN,FIN,2010.0,17,15,2
ESP,NLD,2000.0,36,24,12
JPN,AUT,2010.0,13,14,-1
FRA,SWE,2012.0,67,62,5
POL,RUS,2004.0,13,5,8
CHL,IND,2010.0,2,5,-3
BEL,LUX,2001.0,10,2,8
USA,ROU,2000.0,10,40,-30
CHE,CAN,2000.0,50,40,10
AUT,ESP,2005.0,8,8,0
NLD,SWE,2006.0,27,27,0
EST,LVA,2014.0,4,2,2
BEL,THA,2019.0,4,2,2
GBR,THA,2013.0,77,45,32
EGY,CAN,2008.0,22,25,-3
DNK,GBR,1998.0,47,47,0
FRA,COL,2006.0,10,4,6
COL,CAN,2007.0,14,15,-1
NZL,NOR,2006.0,2,1,1
TUR,GBR,2003.0,22,58,-36
RUS,ITA,2004.0,26,16,10
GBR,ZAF,1999.0,55,51,4
CHE,ESP,2002.0,30,29,1
IRN,SWE,2003.0,4,3,1
JPN,BGD,2009.0,54,52,2
USA,ARG,2002.0,126,160,-34
DNK,ISL,2010.0,9,6,3
SVK,ITA,2008.0,3,4,-1
MEX,DEU,2014.0,34,27,7
DNK,JPN,2002.0,7,10,-3
CZE,AUT,2000.0,8,5,3
UKR,DEU,2004.0,46,26,20
POL,DEU,1998.0,54,51,3
USA,MYS,2022.0,35,62,-27
POL,GBR,2013.0,58,56,2
BGR,JPN,2003.0,6,7,-1
POL,RUS,2001.0,13,18,-5
FRA,BGR,2018.0,7,9,-2
ITA,SMR,2011.0,2,3,-1
ESP,KOR,2012.0,2,2,0
MAR,ESP,2018.0,8,20,-12
CHE,ESP,1997.0,21,26,-5
JPN,RUS,2022.0,9,8,1
ROU,USA,1998.0,30,6,24
DEU,SRB,2003.0,19,16,3
SVK,USA,2006.0,24,10,14
BEL,BLR,2010.0,3,2,1
CAN,JOR,2003.0,4,7,-3
CZE,GBR,2012.0,43,31,12
GBR,CZE,2013.0,42,36,6
PAN,AUS,2001.0,1,1,0
REU,FRA,1997.0,7,4,3
ITA,BRA,2005.0,26,24,2
GBR,EGY,1997.0,9,3,6
RUS,CZE,2022.0,20,13,7
FRA,IND,1997.0,21,22,-1
USA,IRN,2001.0,22,23,-1
NOR,POL,2006.0,1,4,-3
SVK,DEU,2000.0,25,14,11
ITA,ARG,1997.0,12,6,6
NOR,CAN,2010.0,11,21,-10
KWT,GBR,2000.0,7,5,2
BRA,UKR,2009.0,1,1,0
POL,ESP,2004.0,5,4,1
ESP,POL,2009.0,8,19,-11
FRA,KHM,2022.0,4,1,3
ARG,URY,2011.0,2,1,1
URY,ARG,2013.0,7,5,2
ISR,SWE,2004.0,1,2,-1
MEX,ITA,2008.0,9,7,2
CHL,RUS,2015.0,1,1,0
AUT,BEL,2013.0,16,16,0
ISR,PRT,2010.0,2,2,0
RUS,POL,1997.0,18,15,3
RUS,POL,2012.0,13,6,7
SGP,GBR,2009.0,54,84,-30
JPN,NZL,2001.0,14,5,9
ARE,SWE,1997.0,1,1,0
CHN,UZB,2021.0,10,3,7
NLD,GBR,1997.0,108,92,16
CAN,EGY,2009.0,21,16,5
IRL,AUS,1999.0,10,10,0
COL,USA,2020.0,181,150,31
AUS,URY,2022.0,3,2,1
IND,JPN,2018.0,114,99,15
ISR,CHE,2018.0,34,21,13
GBR,JPN,2021.0,139,103,36
DEU,VNM,2018.0,34,11,23
CHN,JPN,2019.0,357,577,-220
DEU,BOL,2016.0,3,1,2
ESP,FRA,2023.0,127,152,-25
USA,IRQ,2022.0,59,13,46
IRL,GBR,2017.0,260,294,-34
FRA,ESP,1998.0,90,136,-46
BRA,AUT,2022.0,17,2,15
USA,TZA,2020.0,32,29,3
TZA,USA,2022.0,15,25,-10
ZAF,USA,2021.0,181,97,84
GBR,IND,2021.0,252,360,-108
JOR,USA,2017.0,47,64,-17
MOZ,BRA,2018.0,5,4,1
COG,BEL,2021.0,10,9,1
CHN,PSE,2020.0,1,1,0
NZL,USA,2020.0,113,155,-42
TUR,IRQ,2018.0,16,10,6
JPN,BRA,2022.0,13,9,4
AUS,IRN,2019.0,53,221,-168
CHN,VNM,2017.0,36,13,23
AUT,ITA,2023.0,41,45,-4
DEU,CHN,2022.0,604,511,93
UKR,CZE,2020.0,21,3,18
UZB,KOR,2017.0,3,2,1
NOR,USA,1999.0,65,68,-3
BRA,DEU,2018.0,136,99,37
ITA,SWE,2021.0,70,60,10
DEU,BRA,2021.0,75,160,-85
DEU,ITA,2021.0,308,354,-46
BEL,DEU,2021.0,127,123,4
ITA,FRA,2019.0,401,332,69
JPN,POL,2018.0,16,8,8
PAK,CHN,2015.0,141,81,60
VNM,KOR,2017.0,25,79,-54
USA,ISR,1998.0,279,293,-14
ISR,IND,2017.0,45,110,-65
PAK,GBR,2018.0,77,100,-23
ESP,ECU,2020.0,82,66,16
CHL,ESP,2010.0,64,69,-5
USA,GEO,2007.0,35,27,8
IND,FIN,2021.0,36,13,23
CHN,CHE,2016.0,77,51,26
SVK,HUN,2017.0,5,15,-10
ETH,FRA,2018.0,2,4,-2
IRN,AUT,2023.0,20,7,13
HKG,AUS,2021.0,46,35,11
NGA,USA,2022.0,139,40,99
SWE,CAN,2017.0,35,53,-18
NLD,CHE,2021.0,128,108,20
HUN,EGY,2023.0,8,1,7
ITA,DEU,2021.0,354,308,46
DEU,SVN,2021.0,11,12,-1
CHN,AUS,2019.0,538,555,-17
JPN,IDN,2018.0,188,62,126
CZE,GBR,2019.0,53,63,-10
AUS,TWN,2022.0,18,10,8
POL,GBR,2018.0,78,96,-18
CHN,SWE,2015.0,110,89,21
TZA,CHE,2020.0,6,6,0
AUS,MMR,2019.0,5,1,4
GBR,CYP,2014.0,38,21,17
CAN,NOR,2018.0,26,17,9
CHN,ISR,2021.0,42,46,-4
CAN,CRI,2021.0,4,2,2
NLD,ISL,2021.0,3,3,0
TUN,ESP,2020.0,11,13,-2
ESP,TUN,2022.0,12,7,5
AUS,PHL,2012.0,10,11,-1
USA,HKG,2020.0,159,182,-23
FRA,AUS,2023.0,34,40,-6
GBR,ITA,2022.0,465,409,56
KOR,EGY,2020.0,18,10,8
JOR,MYS,2016.0,6,26,-20
IDN,JPN,2015.0,42,157,-115
CHN,ESP,2023.0,52,55,-3
ISL,FIN,2023.0,2,1,1
TWN,GBR,2008.0,14,46,-32
SWE,CAN,2018.0,44,47,-3
POL,AUS,2020.0,12,10,2
IRN,AUS,2016.0,146,43,103
TWN,GBR,2015.0,31,28,3
FRA,LUX,2018.0,30,24,6
AUS,JPN,1999.0,62,36,26
GBR,NGA,2018.0,95,55,40
NOR,SWE,2022.0,60,75,-15
VNM,AUS,2021.0,43,67,-24
BEL,CUB,2018.0,5,1,4
CRI,AUT,2018.0,2,1,1
ZAF,KOR,2019.0,9,10,-1
NGA,NZL,2019.0,3,2,1
FRA,SEN,2021.0,31,30,1
ZAF,IND,2018.0,42,46,-4
USA,IDN,2023.0,15,15,0
GBR,IRQ,2020.0,180,18,162
PAK,USA,2019.0,134,114,20
GBR,JPN,2019.0,160,118,42
GBR,IDN,2014.0,25,11,14
UKR,RUS,2020.0,95,84,11
ZAF,GHA,2021.0,46,17,29
ROU,ITA,1999.0,7,9,-2
TWN,IDN,2021.0,72,71,1
IRN,AUS,2022.0,125,30,95
KAZ,HUN,2019.0,2,1,1
DEU,PAK,2018.0,32,28,4
FRA,HKG,2002.0,8,4,4
CHN,FRA,2020.0,212,256,-44
LTU,GBR,2020.0,9,9,0
ITA,POL,2019.0,45,20,25
NZL,GBR,2021.0,121,138,-17
MYS,NGA,2021.0,139,55,84
TUN,SAU,2019.0,184,41,143
IND,PAK,2018.0,37,26,11
PER,AUS,2018.0,2,2,0
TUN,SAU,2021.0,122,75,47
FRA,NGA,2023.0,1,8,-7
ESP,COL,2019.0,146,100,46
ARG,ESP,2022.0,125,65,60
ITA,DNK,2018.0,53,31,22
SGP,SWE,2018.0,16,10,6
PRT,AUS,2015.0,11,3,8
CHN,CAN,2019.0,439,459,-20
CHN,ITA,2015.0,22,53,-31
FRA,NOR,2021.0,47,37,10
IND,DNK,2021.0,29,13,16
DNK,IND,2022.0,14,25,-11
USA,GHA,2018.0,33,32,1
GBR,CZE,2018.0,55,41,14
GBR,SWE,2021.0,234,147,87
FIN,CAN,2000.0,17,12,5
ETH,AUS,2021.0,25,7,18
GBR,LBN,2006.0,6,2,4
CAN,NLD,2018.0,75,69,6
VNM,KOR,2018.0,31,117,-86
FIN,CAN,2023.0,11,10,1
NLD,NZL,2019.0,19,11,8
BRA,FRA,2020.0,167,127,40
CHN,GHA,2020.0,39,29,10
GBR,BEL,2021.0,162,162,0
ITA,COL,2018.0,14,9,5
DNK,NOR,2019.0,61,42,19
CZE,IRN,2019.0,6,18,-12
NZL,AUS,2020.0,202,172,30
GHA,AUS,2020.0,25,14,11
NGA,USA,2018.0,52,62,-10
CHE,ITA,2023.0,109,156,-47
ESP,GBR,2021.0,401,419,-18
HUN,GBR,2021.0,45,30,15
PAK,USA,2021.0,151,113,38
MAR,FRA,2019.0,55,104,-49
ZAF,SWE,2022.0,17,10,7
CHE,BEL,2022.0,57,68,-11
AUS,BRA,2018.0,34,73,-39
CHE,BRA,2015.0,20,17,3
FRA,SWE,2021.0,113,73,40
ITA,RUS,1999.0,26,52,-26
NLD,PRT,2001.0,17,13,4
RWA,USA,2022.0,19,11,8
MEX,COL,2014.0,36,26,10
FRA,LUX,2022.0,24,14,10
CHN,SAU,2020.0,67,53,14
JPN,RUS,2013.0,14,17,-3
JPN,IDN,2022.0,151,86,65
TWN,CHN,2022.0,235,169,66
CHN,SGP,2017.0,297,376,-79
IRN,PAK,2020.0,7,3,4
JPN,KHM,2017.0,8,1,7
KHM,JPN,2019.0,1,5,-4
POL,USA,1998.0,88,107,-19
USA,POL,1999.0,108,112,-4
IND,FRA,2022.0,114,61,53
PAK,GBR,2022.0,92,79,13
PAK,HKG,2019.0,9,11,-2
IND,FJI,2016.0,7,1,6
JPN,SWE,2022.0,26,30,-4
GBR,LAO,2017.0,4,3,1
MAC,HKG,2006.0,5,10,-5
ITA,SWE,2019.0,93,47,46
BEN,TGO,2020.0,3,1,2
ZAF,NGA,2020.0,129,98,31
FRA,JPN,2020.0,114,83,31
FIN,BEL,2020.0,7,9,-2
DNK,DEU,2020.0,127,150,-23
TUR,IRL,2022.0,10,4,6
PHL,HKG,2018.0,3,5,-2
UKR,CHE,2020.0,13,2,11
DEU,BEL,2017.0,131,132,-1
ESP,MYS,2021.0,7,4,3
COL,NLD,2015.0,10,4,6
SWE,ITA,2019.0,47,93,-46
BOL,BEL,2010.0,2,2,0
AUT,FRA,1998.0,17,5,12
AUS,PAK,2015.0,26,28,-2
IRN,NLD,2019.0,47,25,22
FRA,ITA,2023.0,170,180,-10
TUR,JPN,2019.0,11,13,-2
CHN,CZE,2019.0,33,8,25
ESP,BEL,2006.0,12,30,-18
JOR,USA,2018.0,47,54,-7
KEN,GBR,2023.0,18,17,1
MYS,DEU,2020.0,15,6,9
RUS,CHE,2017.0,15,23,-8
BRA,ITA,2018.0,88,69,19
KOR,NLD,2019.0,10,9,1
MAR,FRA,2021.0,71,90,-19
ESP,DZA,2019.0,14,6,8
PHL,NZL,2017.0,4,3,1
CHN,RUS,2020.0,44,55,-11
JPN,IRL,2019.0,9,4,5
CHN,TWN,2023.0,112,138,-26
TUR,FRA,2020.0,31,15,16
USA,PNG,2018.0,2,2,0
ZMB,ZAF,2013.0,5,1,4
IND,CAN,2023.0,131,61,70
EGY,USA,2018.0,128,166,-38
MYS,KWT,2019.0,5,4,1
AUS,DNK,2014.0,30,30,0
ZAF,ESP,2020.0,11,5,6
ROU,BEL,2022.0,10,6,4
EGY,FIN,2017.0,6,2,4
MAR,ESP,2013.0,5,12,-7
MYS,TWN,2021.0,12,11,1
BRA,ARG,2019.0,50,36,14
JOR,MYS,2018.0,8,34,-26
GRC,CHE,2023.0,16,16,0
MKD,SRB,2021.0,10,7,3
PRT,ESP,2012.0,68,111,-43
IRQ,USA,2020.0,26,78,-52
IND,HKG,2021.0,22,8,14
LKA,IND,2021.0,8,5,3
DEU,CHN,2017.0,404,387,17
CHN,VNM,2018.0,30,5,25
KOR,IDN,2021.0,36,36,0
IND,MYS,2023.0,39,43,-4
POL,CAN,2020.0,11,13,-2
DEU,BEL,2018.0,125,137,-12
JPN,IDN,2017.0,199,76,123
COG,COD,2021.0,139,69,70
VNM,DEU,2021.0,19,35,-16
BOL,PER,2021.0,2,1,1
POL,UKR,2022.0,32,57,-25
MEX,USA,2021.0,387,276,111
JOR,USA,2022.0,54,39,15
CAN,ITA,2020.0,58,81,-23
ESP,HRV,2022.0,6,6,0
ZAF,HKG,2020.0,2,2,0
PSE,IRN,2020.0,1,1,0
NGA,IND,2022.0,15,14,1
TWN,IDN,2019.0,44,27,17
BHR,KWT,2022.0,3,1,2
PHL,USA,2023.0,20,14,6
AUS,MYS,2018.0,107,139,-32
MYS,EGY,2021.0,14,13,1
FRA,MAR,1997.0,63,29,34
VNM,DNK,2019.0,3,7,-4
CHL,ECU,2021.0,20,13,7
ITA,COL,2022.0,9,17,-8
NOR,DEU,2023.0,40,51,-11
CAN,KWT,1998.0,8,2,6
CHL,GBR,2018.0,63,51,12
USA,ARG,2021.0,77,151,-74
DNK,SWE,2019.0,115,109,6
PAK,TUR,2023.0,17,11,6
TWN,MWI,2022.0,1,1,0
MYS,OMN,2022.0,15,5,10
BGD,JPN,2003.0,24,26,-2
LUX,NOR,2020.0,2,3,-1
IRN,IRQ,2021.0,37,20,17
IRN,TUR,2022.0,60,21,39
NPL,IND,2022.0,24,35,-11
ESP,TUN,2018.0,13,10,3
NZL,CHN,2023.0,44,34,10
GBR,QAT,2021.0,37,32,5
AUS,MYS,2022.0,43,56,-13
NZL,HKG,2012.0,2,5,-3
IND,NPL,2021.0,47,23,24
MYS,IRQ,2021.0,149,48,101
IRN,USA,2023.0,351,81,270
ESP,IRN,2018.0,22,30,-8
UGA,KEN,2022.0,14,13,1
DNK,ESP,2021.0,35,45,-10
ITA,BRA,2021.0,57,88,-31
COL,AUT,2020.0,4,1,3
BRA,ARG,2021.0,37,33,4
USA,MWI,2020.0,20,22,-2
GBR,HUN,2022.0,21,31,-10
AUS,SAU,2022.0,59,27,32
FRA,IRQ,2018.0,20,2,18
CHN,MYS,2022.0,62,75,-13
BRA,AUS,2012.0,41,15,26
RUS,VNM,2020.0,28,11,17
AUT,CAN,2022.0,26,17,9
BEL,RWA,2021.0,10,2,8
DNK,GNB,2022.0,3,2,1
PAK,CHN,2014.0,103,67,36
MYS,SAU,2023.0,40,21,19
IRN,NLD,2021.0,72,23,49
JPN,EGY,2021.0,70,40,30
GBR,FIN,2020.0,83,67,16
UGA,ZAF,2021.0,13,8,5
NGA,USA,2016.0,58,50,8
CHL,GBR,2017.0,52,63,-11
IND,POL,2022.0,48,12,36
IDN,IND,2022.0,9,24,-15
MAR,ESP,2003.0,13,8,5
GBR,ISR,2023.0,37,47,-10
SWE,ITA,2011.0,32,57,-25
PAK,MYS,2015.0,49,68,-19
PAK,ARE,2020.0,29,12,17
AUS,BRA,2017.0,39,61,-22
IRN,SWE,2022.0,45,19,26
CHN,EGY,2021.0,86,44,42
FRA,COL,2020.0,25,21,4
USA,LTU,2022.0,8,11,-3
SWE,CAN,2022.0,45,33,12
SWE,DNK,2021.0,89,112,-23
PHL,IDN,2020.0,4,7,-3
FRA,DZA,2022.0,56,42,14
MEX,FRA,2022.0,50,25,25
PAK,QAT,2022.0,19,5,14
NZL,SAU,2022.0,6,2,4
SGP,DEU,2021.0,43,31,12
PAN,DOM,2021.0,1,1,0
SRB,SAU,2020.0,5,1,4
DNK,PRT,2015.0,6,20,-14
ARG,CAN,2022.0,23,7,16
BRA,PER,2020.0,81,19,62
MEX,PER,2021.0,21,14,7
USA,PHL,2015.0,43,27,16
KEN,DEU,2022.0,14,16,-2
PAK,SWE,2023.0,8,2,6
LBN,ARE,2023.0,18,4,14
IRN,AUS,2018.0,163,43,120
DNK,CHE,2014.0,31,33,-2
AUT,CHE,2020.0,100,77,23
IRN,NLD,2011.0,28,17,11
AUT,AUS,2009.0,36,33,3
SWE,MMR,2021.0,1,1,0
CHN,ISR,2019.0,24,32,-8
ISR,CHN,2023.0,24,21,3
USA,BGD,2022.0,83,187,-104
AUT,AUS,2021.0,22,28,-6
USA,BGD,2017.0,48,88,-40
ITA,PER,2009.0,3,1,2
FRA,VNM,2003.0,6,2,4
CAN,BEL,2017.0,39,65,-26
SEN,FRA,2000.0,39,12,27
COL,IND,2021.0,2,3,-1
CHN,SGP,2016.0,263,336,-73
USA,NZL,2020.0,155,113,42
MEX,AUS,2022.0,11,5,6
IND,ISR,2023.0,79,63,16
JPN,SGP,1999.0,8,3,5
SGP,JPN,2003.0,10,22,-12
JPN,KAZ,2019.0,8,2,6
DEU,FIN,2014.0,59,46,13
GBR,NZL,1997.0,51,48,3
USA,RUS,1997.0,187,271,-84
DEU,RUS,1999.0,117,169,-52
COL,CUB,1998.0,2,5,-3
USA,IND,2001.0,305,559,-254
DEU,RUS,1998.0,140,145,-5
FRA,LBN,2003.0,30,15,15
USA,RUS,2005.0,243,279,-36
IND,SWE,2011.0,36,22,14
DNK,USA,1998.0,120,89,31
BGR,USA,2002.0,31,8,23
JPN,AUS,2003.0,65,48,17
FRA,TUR,2002.0,7,8,-1
GBR,CZE,2017.0,38,44,-6
MEX,ARG,2021.0,18,21,-3
NLD,SVK,2008.0,4,6,-2
DEU,SVK,2023.0,1,5,-4
USA,EGY,2000.0,64,47,17
GBR,MAR,2016.0,3,2,1
HUN,FRA,2001.0,18,18,0
DEU,RUS,2007.0,103,145,-42
ITA,AUS,2004.0,23,17,6
ZAF,CAN,2001.0,26,9,17
DEU,FIN,2004.0,27,22,5
SWE,RUS,2004.0,14,39,-25
JPN,BGD,2005.0,51,30,21
DNK,SWE,2009.0,50,96,-46
CZE,ITA,2018.0,18,27,-9
BRA,GBR,2003.0,59,59,0
SWE,DEU,2000.0,59,87,-28
DEU,TUR,1998.0,10,9,1
USA,SWE,2000.0,236,259,-23
AUT,SVN,1997.0,3,3,0
FRA,ARG,2007.0,19,13,6
IND,SGP,1997.0,7,3,4
ISR,USA,1998.0,293,279,14
USA,ISR,1999.0,284,305,-21
JPN,NPL,2017.0,15,3,12
GBR,NOR,2013.0,77,45,32
ESP,POL,2002.0,8,10,-2
AUS,FRA,1999.0,45,47,-2
GBR,OMN,1998.0,5,1,4
IND,DEU,1999.0,60,42,18
UKR,USA,2001.0,69,32,37
GBR,ARG,2014.0,17,21,-4
BRA,AUS,2002.0,16,13,3
GBR,ZWE,2003.0,10,7,3
TUR,ESP,2017.0,10,12,-2
COL,USA,1999.0,24,41,-17
NZL,BRA,2012.0,5,1,4
USA,ARG,2009.0,122,119,3
GBR,PER,2001.0,3,3,0
ISR,AUS,2007.0,10,7,3
CAN,SVK,2000.0,2,3,-1
SVK,CZE,2016.0,75,86,-11
FRA,ITA,2000.0,210,192,18
MYS,FRA,2019.0,10,8,2
CAN,FRA,1999.0,144,194,-50
USA,HRV,2001.0,23,27,-4
CAN,FRA,1998.0,128,184,-56
CAN,CZE,1998.0,10,3,7
DEU,SWE,1997.0,63,41,22
EGY,ARE,2013.0,12,15,-3
AUS,SWE,1998.0,27,15,12
ZAF,SAU,2010.0,30,6,24
JPN,ZAF,1997.0,2,2,0
AUS,DNK,2004.0,13,15,-2
ESP,BGR,2001.0,5,8,-3
BGR,ESP,2004.0,2,1,1
IND,AUS,2001.0,38,22,16
BEL,USA,1998.0,112,78,34
ISR,PSE,2016.0,40,6,34
UKR,POL,2016.0,36,15,21
ITA,CAN,2005.0,38,22,16
THA,ITA,2008.0,3,2,1
AUS,FRA,1998.0,34,29,5
CHL,USA,2002.0,47,72,-25
IRL,NLD,2000.0,8,7,1
ISR,DEU,2001.0,46,44,2
DEU,ISR,2002.0,48,47,1
NLD,AUS,2004.0,26,22,4
KEN,USA,2000.0,26,16,10
USA,JOR,2001.0,22,17,5
GBR,ESP,1997.0,121,104,17
ITA,CAN,2002.0,40,40,0
BGR,USA,2012.0,15,12,3
USA,BGR,2016.0,9,17,-8
CAN,OMN,2007.0,5,2,3
JPN,HUN,2007.0,9,9,0
NZL,KOR,2013.0,6,5,1
CHL,FRA,2009.0,34,22,12
FRA,JPN,1999.0,78,54,24
CZE,GBR,2009.0,42,48,-6
CAN,CZE,2007.0,5,9,-4
ESP,UKR,2000.0,3,5,-2
RUS,BLR,2004.0,14,21,-7
DEU,NLD,1997.0,107,110,-3
SAU,KWT,2004.0,2,3,-1
TJK,RUS,2005.0,1,1,0
HUN,SWE,2006.0,8,3,5
FIN,GBR,2001.0,45,41,4
GRC,SWE,2014.0,29,5,24
GBR,JPN,2011.0,127,113,14
PRT,IND,2002.0,2,2,0
PAN,POL,1998.0,5,2,3
CHE,ZAF,2004.0,4,6,-2
CHE,CZE,2009.0,20,14,6
ITA,RUS,2020.0,22,23,-1
USA,MEX,2001.0,238,215,23
POL,DEU,2000.0,64,67,-3
AUS,ESP,2020.0,47,51,-4
CZE,DEU,2013.0,42,35,7
FRA,BGR,2003.0,16,6,10
USA,MYS,2013.0,39,50,-11
CZE,POL,1997.0,6,5,1
MYS,SGP,2015.0,19,22,-3
KOR,JPN,1999.0,61,105,-44
SVK,DEU,1999.0,10,7,3
DEU,ISR,2005.0,27,41,-14
GRC,CZE,2010.0,3,1,2
ITA,MEX,2005.0,7,9,-2
CUB,DEU,1999.0,5,3,2
HKG,FRA,2003.0,7,7,0
POL,GBR,2016.0,83,58,25
SRB,BEL,2001.0,8,1,7
FRA,HKG,2005.0,4,5,-1
CZE,SVK,2011.0,34,66,-32
CZE,CHL,2011.0,4,1,3
BEL,CAN,2015.0,56,40,16
CAN,NLD,2016.0,72,76,-4
NLD,BEL,2018.0,190,204,-14
USA,ZAF,2003.0,74,129,-55
JPN,FRA,2000.0,77,82,-5
FRA,SEN,2011.0,37,32,5
MEX,CZE,2022.0,8,4,4
SAU,NGA,2009.0,2,1,1
TUR,AZE,2006.0,7,4,3
AZE,TUR,2010.0,9,10,-1
NLD,RUS,2004.0,13,22,-9
NOR,LTU,2002.0,6,1,5
JPN,CHE,2015.0,41,38,3
JPN,ITA,2003.0,21,28,-7
CAN,AUS,1998.0,100,76,24
GBR,PRT,2007.0,50,40,10
DEU,SWE,2002.0,82,101,-19
GRC,CAN,2018.0,12,2,10
CHN,NZL,2020.0,54,51,3
SGP,GBR,2012.0,77,118,-41
USA,SRB,2001.0,29,41,-12
JPN,SAU,2017.0,22,10,12
ZAF,GBR,1997.0,39,32,7
CAN,JPN,2001.0,87,128,-41
TUR,DEU,1999.0,5,16,-11
LBN,USA,2014.0,99,55,44
NLD,CAN,2003.0,58,25,33
SWE,OMN,1998.0,1,1,0
PNG,USA,2012.0,1,2,-1
USA,PNG,2017.0,2,2,0
JPN,CAN,1997.0,81,83,-2
SVK,DEU,1998.0,8,11,-3
ESP,FRA,2000.0,116,153,-37
FIN,SWE,2018.0,87,54,33
SWE,FIN,2019.0,58,85,-27
RUS,ISR,2005.0,12,19,-7
BGR,USA,1997.0,20,9,11
CHE,ZAF,2001.0,9,6,3
CHE,BEL,2016.0,78,68,10
CUB,ESP,2016.0,27,18,9
ITA,ROU,2007.0,15,18,-3
FRA,AUT,2004.0,14,18,-4
FRA,VEN,2003.0,10,6,4
USA,MMR,2014.0,2,1,1
NLD,CHE,2009.0,65,65,0
GBR,MWI,2016.0,21,20,1
RUS,NOR,1999.0,8,4,4
DEU,PRT,2011.0,31,25,6
RUS,FRA,2008.0,48,36,12
HKG,ZAF,1997.0,2,1,1
EST,GBR,2001.0,5,3,2
CHE,ZAF,2015.0,15,20,-5
ESP,CHL,2003.0,30,13,17
BEL,HUN,2011.0,6,8,-2
CZE,POL,2012.0,8,15,-7
NOR,SWE,2016.0,46,87,-41
KEN,GBR,2006.0,13,18,-5
HKG,USA,2001.0,121,101,20
ISR,GBR,2006.0,28,21,7
GBR,ISR,2010.0,37,38,-1
BEL,CHL,2005.0,4,3,1
BEL,BGR,2011.0,12,3,9
IND,CAN,2000.0,54,18,36
LUX,USA,1998.0,1,1,0
CHE,GBR,1998.0,116,112,4
GBR,RUS,2000.0,41,81,-40
ARG,COL,2011.0,6,9,-3
RUS,GBR,1998.0,49,46,3
KWT,IND,2010.0,2,5,-3
USA,POL,1998.0,107,88,19
POL,USA,1999.0,112,108,4
CAN,SWE,2003.0,34,41,-7
PAN,USA,2002.0,14,15,-1
CHE,ESP,2019.0,92,120,-28
CHL,FRA,2011.0,28,27,1
FRA,IRL,2012.0,34,47,-13
DEU,POL,2001.0,94,76,18
FRA,DEU,2017.0,421,379,42
GRC,CHE,2006.0,13,6,7
PRT,ESP,2005.0,24,33,-9
LUX,USA,2020.0,10,11,-1
USA,LUX,2021.0,20,12,8
SVN,GBR,2001.0,5,5,0
CHE,TZA,2020.0,6,6,0
IRL,NLD,2023.0,19,9,10
HUN,USA,2009.0,77,67,10
BEL,DNK,2001.0,8,7,1
NLD,ROU,2020.0,3,5,-2
KOR,RUS,2012.0,7,10,-3
VEN,USA,2001.0,47,60,-13
FIN,NLD,2007.0,20,11,9
NLD,FIN,2013.0,17,19,-2
USA,HKG,1998.0,91,70,21
SVK,POL,2007.0,9,3,6
SWE,NOR,2014.0,85,58,27
IND,BGD,2008.0,15,14,1
GRC,BEL,2005.0,9,11,-2
GTM,MEX,2002.0,1,2,-1
SAU,USA,2013.0,69,152,-83
USA,ROU,1999.0,20,26,-6
DEU,NZL,1999.0,13,14,-1
NGA,DEU,2000.0,6,6,0
GBR,ZAF,2006.0,50,77,-27
KOR,UKR,2000.0,2,3,-1
BEL,ISR,1998.0,3,4,-1
ROU,USA,2023.0,26,9,17
DEU,HUN,1999.0,26,34,-8
USA,PER,2003.0,31,16,15
NLD,ITA,2000.0,54,76,-22
USA,SVK,1997.0,18,15,3
HUN,DEU,2011.0,49,30,19
DNK,SGP,2017.0,9,8,1
KOR,PAK,2015.0,31,48,-17
ARE,FRA,2010.0,2,5,-3
CHE,AUT,2007.0,44,53,-9
UKR,RUS,1998.0,66,74,-8
NGA,SWE,2003.0,1,1,0
ITA,CZE,1997.0,8,3,5
BEL,AUT,2001.0,7,5,2
DEU,JOR,2001.0,5,5,0
KOR,JPN,2007.0,99,163,-64
BEL,CAN,2001.0,28,39,-11
ZAF,GBR,2012.0,85,124,-39
UKR,POL,2017.0,36,18,18
POL,UKR,2018.0,24,34,-10
CZE,NLD,2020.0,10,5,5
AUT,ROU,2014.0,6,6,0
SWE,SGP,2014.0,11,6,5
CZE,USA,2016.0,58,55,3
ESP,NOR,2021.0,21,23,-2
SGP,GBR,2005.0,40,54,-14
REU,FRA,2011.0,39,27,12
CUB,BRA,2007.0,8,5,3
CHE,HRV,2012.0,4,7,-3
CAN,AUS,1999.0,107,87,20
CAN,ITA,1999.0,31,34,-3
ISR,FRA,2021.0,30,40,-10
FRA,AUS,2000.0,40,30,10
GBR,EGY,2009.0,33,26,7
BEL,FIN,2017.0,10,14,-4
JPN,GBR,2013.0,137,137,0
IND,TWN,2004.0,32,16,16
FRA,CMR,2001.0,13,14,-1
POL,AUS,1998.0,4,4,0
GBR,HUN,2017.0,41,51,-10
IRN,SWE,2018.0,49,16,33
USA,SRB,2014.0,20,27,-7
HKG,CAN,2000.0,20,27,-7
CZE,FRA,2001.0,21,17,4
DEU,UKR,2010.0,17,35,-18
COD,COG,2018.0,60,146,-86
DEU,JPN,2007.0,109,119,-10
USA,FIN,1999.0,72,104,-32
TUR,AUT,2016.0,13,6,7
RUS,DNK,1998.0,12,6,6
NOR,CAN,2020.0,13,29,-16
BLR,DEU,2017.0,7,5,2
DEU,AUT,2017.0,364,367,-3
ITA,GRC,2013.0,21,44,-23
TZA,UGA,2001.0,2,1,1
DNK,ITA,2013.0,22,43,-21
SWE,BRA,1999.0,9,1,8
GBR,ETH,1998.0,1,3,-2
BRA,PRT,2000.0,29,41,-12
CHE,RUS,1997.0,14,14,0
UKR,ESP,1998.0,4,1,3
GBR,RUS,2006.0,30,54,-24
USA,SAU,2001.0,52,41,11
DEU,GRC,1999.0,31,22,9
DEU,JPN,1998.0,115,104,11
NLD,DNK,2011.0,18,18,0
DNK,NLD,2016.0,28,37,-9
AUS,ZAF,2002.0,27,34,-7
CUB,CAN,2009.0,8,2,6
CMR,CHE,2002.0,2,2,0
CHE,CMR,2004.0,3,2,1
POL,NLD,2000.0,10,10,0
SWE,FRA,1997.0,38,29,9
USA,HKG,1999.0,85,86,-1
OMN,BGD,2015.0,2,2,0
CHE,AUS,2004.0,31,36,-5
SVK,HUN,2018.0,12,10,2
GBR,PRT,2020.0,113,113,0
CHN,RUS,1999.0,11,7,4
FRA,MCO,2016.0,13,8,5
FRA,TUN,2000.0,66,31,35
TUN,USA,2008.0,3,6,-3
GBR,SRB,2004.0,14,16,-2
ISR,GBR,2000.0,26,34,-8
IND,OMN,2004.0,4,3,1
SVK,USA,1999.0,15,15,0
CYP,FRA,2010.0,2,1,1
FRA,CYP,2011.0,2,1,1
FRA,MAR,2005.0,62,41,21
AUS,ITA,2002.0,24,23,1
MEX,ISR,2000.0,3,3,0
USA,PHL,2001.0,13,25,-12
TTO,BRB,2014.0,2,1,1
LKA,SGP,2013.0,1,1,0
SWE,MEX,2002.0,7,5,2
JPN,IND,2000.0,48,84,-36
SAU,IND,2014.0,33,129,-96
RUS,IRL,2017.0,5,2,3
NLD,AUS,2015.0,96,68,28
SGP,CHE,2011.0,14,15,-1
IRL,BEL,2003.0,5,5,0
USA,QAT,2018.0,57,63,-6
GRC,FRA,2018.0,46,44,2
ITA,MLT,2020.0,3,5,-2
ITA,KOR,2006.0,4,1,3
RUS,AUS,2003.0,14,7,7
DNK,JPN,2019.0,17,16,1
PAK,IND,2014.0,19,27,-8
CHN,ZAF,2022.0,11,10,1
CHN,BRA,2014.0,6,4,2
RWA,USA,2016.0,16,19,-3
AUS,BGD,2021.0,80,100,-20
BRA,ECU,2021.0,15,5,10
ARG,ISR,2013.0,2,2,0
ITA,DNK,2022.0,41,36,5
USA,SAU,2015.0,171,95,76
CHN,EGY,2019.0,40,49,-9
PHL,DEU,2016.0,7,2,5
HTI,USA,2016.0,8,9,-1
BRA,NLD,2020.0,74,38,36
MYS,JOR,2016.0,26,6,20
MYS,IRN,2013.0,109,100,9
SGP,DEU,2019.0,48,31,17
MAR,KOR,2021.0,1,1,0
IND,FRA,2016.0,93,87,6
POL,BEL,2018.0,16,15,1
JPN,SGP,2020.0,33,23,10
CHN,CHE,2022.0,101,94,7
CHN,CHE,2017.0,82,75,7
ISR,IND,2018.0,51,117,-66
THA,SAU,2021.0,1,1,0
SAU,CHN,2019.0,51,61,-10
BEL,ISR,2020.0,7,6,1
USA,BWA,2018.0,14,8,6
DEU,PAK,2017.0,48,35,13
AUS,OMN,2019.0,10,4,6
ARG,URY,2012.0,8,4,4
URY,ARG,2016.0,12,9,3
BHR,USA,2017.0,3,1,2
BEL,FIN,2018.0,9,12,-3
AUS,SAU,2017.0,77,27,50
DEU,TUR,2020.0,62,115,-53
MEX,FRA,2017.0,45,64,-19
AUS,SAU,2018.0,69,32,37
DEU,ETH,2019.0,13,3,10
GBR,ITA,2018.0,404,623,-219
AUT,FRA,2020.0,34,53,-19
KOR,FIN,2017.0,7,4,3
JPN,CHE,2014.0,35,33,2
IND,YEM,2019.0,12,3,9
AUS,TUR,2020.0,10,21,-11
TUR,PRT,2018.0,6,5,1
AUT,BEL,2017.0,13,12,1
REU,FRA,2021.0,22,30,-8
NLD,IDN,2021.0,58,39,19
MAR,COG,2016.0,2,1,1
NLD,DNK,2021.0,57,48,9
EGY,QAT,2022.0,6,10,-4
BEL,ITA,2022.0,83,89,-6
FRA,ETH,2019.0,6,1,5
ETH,FRA,2022.0,1,7,-6
KOR,IDN,2019.0,50,18,32
CAN,OMN,2020.0,13,8,5
CZE,USA,2022.0,58,44,14
SWE,NLD,2021.0,84,67,17
SWE,NOR,2015.0,75,59,16
PRT,ARE,2015.0,5,2,3
NZL,SWE,2020.0,14,7,7
KHM,THA,2020.0,7,3,4
LUX,NLD,2020.0,11,10,1
MEX,CAN,2020.0,72,45,27
IRN,DEU,2020.0,167,56,111
CYP,ESP,2016.0,1,2,-1
MAR,CAN,2019.0,10,6,4
DEU,ARG,2018.0,31,39,-8
IND,LKA,2017.0,8,5,3
GBR,BRB,2016.0,4,5,-1
SGP,NLD,2014.0,5,25,-20
CHN,PAK,2013.0,42,60,-18
TUR,IRQ,2016.0,12,8,4
IRL,ITA,2015.0,25,32,-7
GRC,SAU,2020.0,9,1,8
LUX,AUT,2018.0,3,3,0
CAN,THA,2016.0,27,17,10
BEL,USA,2020.0,184,184,0
IND,ZAF,2017.0,63,37,26
CAN,NOR,2017.0,23,7,16
GBR,TTO,2016.0,3,6,-3
HKG,AUS,2009.0,49,25,24
SVN,SVK,2012.0,21,14,7
FRA,MLI,2018.0,8,6,2
CHN,ITA,2014.0,43,38,5
IND,DEU,2020.0,223,154,69
HKG,DEU,2017.0,15,13,2
BGD,DEU,2013.0,6,8,-2
IND,POL,2017.0,13,4,9
ARM,COL,2017.0,2,3,-1
PAK,JPN,2015.0,4,6,-2
GBR,ARE,2021.0,87,37,50
BEL,ITA,2018.0,73,136,-63
SWE,FIN,2021.0,76,77,-1
CZE,BGR,2020.0,3,2,1
GBR,CZE,2016.0,45,54,-9
ARG,COL,2019.0,17,16,1
ECU,ITA,2018.0,5,7,-2
GBR,THA,2022.0,61,30,31
GRC,ROU,2023.0,1,4,-3
FRA,ROU,2016.0,36,37,-1
NOR,SWE,2018.0,66,81,-15
YEM,SAU,2022.0,17,11,6
DEU,MEX,2020.0,36,58,-22
THA,AUS,2023.0,14,16,-2
GBR,THA,2018.0,110,54,56
ETH,SWE,2020.0,7,3,4
ZAF,ZWE,2017.0,37,40,-3
AUS,COL,2019.0,9,11,-2
ARE,QAT,2017.0,13,9,4
IND,AUS,2004.0,31,10,21
IND,SAU,2019.0,161,88,73
SGP,DNK,2020.0,9,9,0
CAN,NLD,2017.0,61,91,-30
FIN,SWE,2017.0,87,57,30
SWE,ESP,2016.0,46,88,-42
NLD,BEL,2016.0,187,168,19
EGY,CZE,2010.0,2,3,-1
DEU,GRC,2020.0,54,83,-29
IRN,MYS,2018.0,32,133,-101
MDV,GBR,2016.0,3,1,2
SAU,CAN,2013.0,42,92,-50
KOR,FRA,2011.0,22,28,-6
CHN,AUT,2012.0,17,17,0
ESP,TUN,2016.0,17,7,10
RUS,CZE,2013.0,8,6,2
SGP,ITA,2019.0,11,10,1
MYS,ZAF,2020.0,3,3,0
USA,YEM,2021.0,1,2,-1
SLB,AUS,2013.0,2,3,-1
HKG,PAK,2022.0,7,7,0
DNK,AUS,2013.0,24,29,-5
FRA,SWE,2019.0,92,73,19
IND,BGD,2014.0,9,15,-6
IND,IRQ,2017.0,14,2,12
CZE,ESP,2017.0,16,18,-2
NCL,FRA,2015.0,24,27,-3
COG,COD,2019.0,187,53,134
KOR,AUS,2018.0,68,31,37
TZA,USA,2016.0,16,25,-9
DNK,FRA,2014.0,37,40,-3
ESP,CHL,2013.0,132,63,69
EGY,USA,2022.0,140,110,30
ITA,DNK,2016.0,50,23,27
AUS,LKA,2018.0,22,37,-15
CAN,TUR,2016.0,25,26,-1
RUS,ESP,2019.0,15,10,5
BGD,JPN,2013.0,42,60,-18
DNK,USA,2020.0,148,176,-28
POL,BEL,2016.0,7,16,-9
NLD,CHE,2019.0,127,91,36
IND,JPN,2017.0,105,72,33
ZWE,BWA,2023.0,4,1,3
GBR,THA,2016.0,86,40,46
GBR,ZAF,2023.0,49,71,-22
USA,ZAF,2013.0,125,142,-17
TUN,FRA,2011.0,90,137,-47
IRN,CHE,2013.0,27,6,21
ZAF,ISR,2022.0,5,2,3
DEU,BEL,2022.0,119,104,15
AUS,BGD,2019.0,67,94,-27
BRA,DNK,2023.0,29,7,22
GBR,POL,2018.0,96,78,18
DNK,KOR,2018.0,3,8,-5
NOR,DNK,2021.0,51,66,-15
JPN,BRA,2016.0,21,12,9
SWE,IND,2013.0,23,59,-36
SRB,CHN,2019.0,4,3,1
AUS,IRN,2011.0,39,61,-22
IRN,AUS,2017.0,175,48,127
IRL,ESP,2023.0,23,21,2
ITA,CAN,2012.0,62,46,16
PAK,BRN,2019.0,2,2,0
LBY,GBR,2016.0,5,8,-3
AUS,MNG,2019.0,3,2,1
GRC,FRA,2022.0,31,24,7
FRA,GRC,2023.0,14,13,1
PRT,BEL,2020.0,28,13,15
AUS,BRA,2016.0,53,59,-6
KGZ,DEU,2017.0,1,2,-1
FRA,ECU,2020.0,11,6,5
DNK,FIN,2017.0,15,26,-11
GBR,POL,2017.0,70,104,-34
USA,JOR,2014.0,49,34,15
SAU,PAK,2008.0,12,17,-5
HKG,PAK,2017.0,2,11,-9
FRA,CHN,2017.0,221,191,30
SGP,HKG,2020.0,45,42,3
HKG,TWN,2021.0,22,12,10
SAU,AUS,2008.0,8,10,-2
AUS,SAU,2016.0,62,16,46
CHE,GRC,2019.0,17,45,-28
NGA,KEN,2022.0,5,8,-3
USA,PAK,2012.0,68,84,-16
PER,FRA,2013.0,7,1,6
BEL,KOR,2019.0,6,6,0
JPN,HKG,2023.0,11,3,8
SWE,USA,2015.0,238,268,-30
BRA,PAK,2020.0,11,5,6
CHE,EGY,2022.0,6,2,4
PER,CAN,2022.0,5,1,4
KWT,IND,2006.0,4,2,2
USA,HRV,2014.0,17,19,-2
JPN,ESP,2021.0,20,15,5
GBR,NGA,2017.0,92,45,47
RUS,SWE,2016.0,15,22,-7
TUR,GBR,2016.0,45,66,-21
HRV,AUS,2019.0,5,4,1
TUN,SWE,2019.0,1,1,0
COD,UGA,2021.0,3,3,0
RUS,EST,2013.0,7,1,6
CHN,NOR,2011.0,20,13,7
PYF,FRA,2021.0,23,22,1
GBR,TWN,2015.0,28,31,-3
MEX,BRA,2020.0,26,31,-5
IND,POL,2018.0,13,7,6
HKG,PAK,2018.0,10,10,0
IRL,AUS,2020.0,41,60,-19
IND,ZAF,2018.0,46,42,4
VEN,USA,2015.0,30,10,20
CAN,BEL,2022.0,34,36,-2
CAN,ARE,2018.0,26,29,-3
CHE,DNK,2019.0,47,49,-2
SGP,RUS,2020.0,4,7,-3
GBR,UKR,2018.0,38,14,24
SWE,ISR,2022.0,3,4,-1
SWE,COL,2022.0,2,5,-3
CHL,NZL,2019.0,6,4,2
KOR,SDN,2022.0,3,1,2
CHL,FRA,2019.0,31,40,-9
CHE,SAU,2020.0,7,2,5
AUT,THA,2022.0,6,9,-3
NOR,FRA,2020.0,32,47,-15
GBR,OMN,2020.0,29,11,18
THA,ITA,2014.0,5,7,-2
BRA,AGO,2020.0,1,1,0
CAN,ARG,2021.0,10,22,-12
SWE,POL,2016.0,21,24,-3
CZE,EGY,2020.0,2,2,0
CHE,GRC,2021.0,19,42,-23
SYR,USA,2019.0,7,7,0
IDN,IND,2016.0,14,25,-11
GBR,IRN,2008.0,70,28,42
NLD,IDN,2019.0,53,20,33
TUR,BEL,2020.0,22,13,9
KOR,NLD,2021.0,14,16,-2
DEU,NZL,2020.0,33,34,-1
ITA,IRL,2022.0,33,26,7
ITA,ARG,2019.0,14,18,-4
KEN,USA,2023.0,28,32,-4
GBR,MYS,2014.0,157,76,81
MNG,JPN,2020.0,9,22,-13
SAU,DZA,2022.0,8,5,3
RUS,CHE,2022.0,49,13,36
IRL,ISL,2020.0,1,1,0
EGY,QAT,2017.0,17,5,12
MMR,USA,2018.0,3,3,0
THA,ESP,2021.0,2,4,-2
ZAF,MWI,2020.0,18,9,9
DEU,IND,2023.0,83,138,-55
AUS,JPN,2007.0,36,62,-26
ESP,IDN,2021.0,3,4,-1
GBR,BRA,2022.0,101,136,-35
FRA,MCO,2022.0,11,7,4
ETH,BWA,2021.0,2,1,1
FRA,URY,2022.0,4,2,2
ARE,QAT,2018.0,7,11,-4
CHL,ECU,2019.0,16,12,4
GHA,CAN,2020.0,8,13,-5
ESP,FIN,2020.0,28,18,10
BEL,MYS,2020.0,5,3,2
AUT,CZE,2004.0,5,14,-9
CAN,NZL,2010.0,33,34,-1
FRA,CHL,1999.0,15,4,11
CAN,ARE,2016.0,41,15,26
TUR,GBR,2017.0,74,70,4
FRA,SAU,2019.0,27,10,17
FRA,IND,2019.0,69,85,-16
CHE,EGY,2017.0,4,7,-3
JPN,NPL,2022.0,16,6,10
BGD,AUS,2023.0,55,47,8
ITA,IRL,2017.0,39,23,16
MEX,CAN,1998.0,13,24,-11
USA,BGD,2016.0,37,83,-46
NLD,ITA,2023.0,66,91,-25
HKG,AUS,2019.0,54,39,15
IRN,JPN,2016.0,13,13,0
MEX,NLD,2019.0,22,8,14
DEU,CHL,2020.0,38,52,-14
SWE,CAN,2016.0,43,34,9
BEL,MLI,2017.0,1,1,0
EST,GBR,2008.0,5,8,-3
ARE,IND,2021.0,42,77,-35
TZA,GBR,2022.0,11,7,4
GHA,DEU,2021.0,21,17,4
CHN,USA,2024.0,41,49,-8
CAN,SRB,2001.0,3,6,-3
IND,NZL,2018.0,15,13,2
FRA,CMR,2015.0,24,19,5
HND,USA,2021.0,4,4,0
USA,VNM,2013.0,43,9,34
GBR,GHA,2022.0,20,27,-7
ESP,SVN,2019.0,4,4,0
GBR,SRB,2015.0,15,6,9
NOR,BRA,2011.0,3,3,0
AUS,VUT,2015.0,2,2,0
IND,THA,2023.0,31,13,18
DEU,EGY,2006.0,36,21,15
KOR,BEL,2015.0,8,11,-3
BEL,LBN,2021.0,5,8,-3
UGA,AUT,2020.0,1,1,0
AUT,CAN,2017.0,20,33,-13
HKG,IRL,1997.0,2,1,1
MYS,AUS,2014.0,86,114,-28
KWT,GBR,1998.0,6,8,-2
HKG,CAN,2023.0,11,18,-7
GBR,NPL,2020.0,18,5,13
COL,ECU,2016.0,13,2,11
IND,SGP,2005.0,30,19,11
BTN,THA,2020.0,3,4,-1
ROU,ITA,2020.0,14,13,1
NPL,DNK,2023.0,1,1,0
SGP,NOR,2013.0,3,2,1
COL,FRA,2016.0,24,38,-14
DNK,NLD,2022.0,44,41,3
THA,FRA,2023.0,6,3,3
BRA,ECU,2019.0,25,8,17
IRQ,ESP,2021.0,3,3,0
NER,NGA,2019.0,11,7,4
GRC,ESP,2002.0,4,3,1
IND,ZAF,2022.0,37,26,11
RUS,EGY,2021.0,21,11,10
ZAF,ZWE,2018.0,41,49,-8
KOR,RUS,2005.0,10,23,-13
DEU,LTU,2020.0,12,6,6
NLD,THA,2023.0,4,2,2
USA,QAT,2022.0,35,69,-34
HKG,SGP,1998.0,13,10,3
TUR,ESP,2022.0,20,14,6
DEU,LVA,2001.0,8,5,3
FRA,EST,2021.0,5,3,2
IND,EGY,2023.0,8,11,-3
DEU,SAU,2020.0,34,24,10
AUS,PRT,2003.0,2,2,0
BWA,ETH,2022.0,2,2,0
CHN,SWE,2001.0,28,29,-1
ISR,ARE,2022.0,1,1,0
BEL,CHN,2004.0,14,7,7
CHN,CHE,2018.0,70,64,6
TUR,JPN,2021.0,6,8,-2
POL,DEU,2023.0,43,48,-5
PRT,CHE,2019.0,23,15,8
MEX,CHL,2021.0,33,22,11
GBR,POL,2022.0,64,54,10
GBR,LUX,2022.0,9,10,-1
BEL,CHE,2023.0,39,38,1
COL,ECU,2022.0,10,8,2
VNM,CAN,2023.0,5,1,4
ECU,MEX,2022.0,12,11,1
KOR,FRA,2021.0,27,19,8
SWE,HKG,2023.0,7,7,0
AUS,IRN,2021.0,41,177,-136
VNM,TWN,2023.0,18,40,-22
CAN,FIN,2020.0,13,25,-12
MYS,USA,2023.0,40,6,34
RUS,CHE,2018.0,31,16,15
GBR,DZA,2021.0,6,4,2
MEX,SWE,2021.0,13,1,12
IRQ,IRN,2021.0,20,37,-17
ESP,THA,2022.0,3,2,1
PER,DEU,2021.0,6,6,0
IRL,FRA,2022.0,29,39,-10
BIH,TUR,2018.0,3,3,0
LKA,NZL,2021.0,8,6,2
KEN,CAN,2018.0,9,4,5
FRA,TUN,2023.0,37,70,-33
IDN,KOR,2021.0,36,36,0
GHA,KAZ,2022.0,1,4,-3
IRL,DEU,2023.0,27,28,-1
TZA,SWE,2021.0,4,7,-3
LKA,AUS,2021.0,43,32,11
ITA,POL,2021.0,29,32,-3
ZAF,ZWE,2022.0,35,53,-18
NLD,GRC,2022.0,15,20,-5
FRA,MLI,2022.0,9,1,8
DNK,AUT,2023.0,8,9,-1
KGZ,RUS,2021.0,7,6,1
ESP,DZA,2021.0,18,8,10
GBR,ECU,2016.0,8,10,-2
ARE,USA,2022.0,74,87,-13
USA,NGA,2023.0,28,87,-59
GBR,CHL,2023.0,30,29,1
ISR,POL,2021.0,5,6,-1
TUR,JOR,2021.0,3,5,-2
SWE,THA,2022.0,8,4,4
ETH,IND,2021.0,40,65,-25
FIN,CHN,2021.0,58,50,8
PRT,GBR,2023.0,33,52,-19
TWN,ETH,2022.0,11,2,9
TWN,BEL,2021.0,8,4,4
CHN,NGA,2021.0,34,28,6
TUN,TUR,2021.0,2,3,-1
NGA,ITA,2023.0,5,2,3
CHE,NOR,2016.0,30,10,20
IND,AUT,2018.0,21,6,15
IND,ITA,2019.0,62,40,22
NOR,HUN,2022.0,3,5,-2
VNM,SWE,2023.0,4,1,3
NLD,BRA,2023.0,16,38,-22
AUT,NOR,2021.0,25,8,17
PAK,DEU,2021.0,36,38,-2
DEU,PAK,2022.0,30,25,5
HUN,CHN,2023.0,7,5,2
CYP,DEU,2023.0,3,3,0
PHL,ESP,2018.0,4,1,3
RWA,DEU,2019.0,2,2,0
JPN,IND,2023.0,50,70,-20
ARE,FRA,2023.0,10,16,-6
ITA,ARE,2022.0,13,7,6
BEL,IND,2023.0,9,25,-16
ESP,BEL,2023.0,35,38,-3
HKG,CHE,2023.0,3,5,-2
FIN,DEU,2000.0,27,31,-4
DEU,FIN,2001.0,32,34,-2
AUS,SWE,2007.0,30,32,-2
BRA,CZE,2002.0,1,2,-1
DEU,GRC,1998.0,29,19,10
UKR,CAN,1999.0,6,2,4
RUS,CZE,2003.0,19,5,14
DEU,FIN,2008.0,39,42,-3
DNK,RUS,2001.0,6,4,2
IND,NLD,1999.0,17,11,6
ITA,FIN,2012.0,17,14,3
MKD,ITA,2020.0,1,3,-2
RUS,KOR,2005.0,23,10,13
BEL,NLD,2013.0,125,163,-38
FIN,GBR,2004.0,28,43,-15
GBR,FIN,2007.0,30,43,-13
FIN,ITA,2013.0,19,21,-2
GBR,CHN,1997.0,57,41,16
FRA,MCO,2017.0,12,16,-4
FRA,AUT,2001.0,27,20,7
CHL,AUT,2019.0,3,7,-4
RUS,KOR,2002.0,25,15,10
JPN,CHE,2001.0,30,27,3
FIN,BEL,1998.0,7,1,6
GRC,BEL,2002.0,7,8,-1
RUS,NOR,1998.0,5,8,-3
POL,DNK,2001.0,6,6,0
NAM,KEN,2015.0,1,1,0
FIN,POL,2002.0,5,1,4
BRA,BEL,2000.0,10,15,-5
GBR,TUR,2005.0,37,26,11
GBR,ISL,2003.0,12,11,1
AUT,ROU,2004.0,3,1,2
GRC,RUS,2017.0,2,1,1
ROU,SWE,1998.0,4,1,3
EGY,TUR,2013.0,1,2,-1
USA,LKA,2007.0,8,12,-4
GBR,PRT,1998.0,43,21,22
DEU,MEX,1998.0,10,10,0
DEU,UKR,2006.0,25,32,-7
UKR,BEL,2009.0,3,2,1
UKR,BEL,2019.0,3,1,2
DEU,LUX,2007.0,22,3,19
JPN,TWN,2005.0,40,19,21
CHE,SVN,2001.0,3,1,2
DEU,POL,2008.0,54,94,-40
SRB,KOR,2017.0,1,1,0
GEO,USA,2003.0,58,26,32
DEU,POL,2004.0,45,70,-25
ESP,ITA,1999.0,67,56,11
DEU,ISR,1997.0,32,24,8
RUS,TWN,2009.0,7,2,5
NZL,AUS,1998.0,84,57,27
MAR,FRA,2011.0,48,102,-54
IND,ISR,2000.0,23,7,16
NLD,SWE,1999.0,16,24,-8
DNK,JPN,2011.0,11,6,5
CAN,IRL,2000.0,8,13,-5
ITA,CZE,2002.0,6,10,-4
RUS,BEL,2001.0,20,12,8
PAK,SAU,2012.0,57,19,38
JPN,POL,2016.0,22,11,11
SVK,USA,1998.0,15,13,2
MTQ,FRA,2001.0,15,7,8
MDA,USA,2018.0,9,8,1
ROU,FRA,2005.0,30,39,-9
BFA,BEL,2011.0,4,4,0
CZE,ESP,2016.0,13,25,-12
BRA,FRA,1998.0,42,70,-28
CAN,ITA,1998.0,28,29,-1
POL,CAN,2007.0,15,17,-2
POL,SVK,2020.0,8,10,-2
CHE,AUT,1999.0,17,27,-10
JPN,ESP,2019.0,22,21,1
MKD,SRB,2009.0,47,25,22
SRB,GBR,2018.0,16,12,4
CHE,CZE,2019.0,21,23,-2
CAN,AUT,2007.0,10,17,-7
GRC,FRA,2017.0,37,28,9
FRA,ARG,1998.0,10,12,-2
DNK,CHE,2004.0,12,15,-3
DEU,ZAF,2003.0,25,21,4
ARG,URY,2002.0,5,3,2
BGR,ESP,2008.0,6,2,4
CHN,RUS,1998.0,5,6,-1
USA,PAK,2005.0,26,28,-2
SWE,RUS,2015.0,17,29,-12
CZE,FRA,2004.0,18,22,-4
AUS,SGP,2000.0,34,18,16
USA,UKR,2001.0,32,69,-37
BEL,CAN,2008.0,35,16,19
NLD,IND,2016.0,31,44,-13
DNK,FRA,2004.0,16,21,-5
PRT,ITA,2000.0,6,10,-4
ITA,PRT,2001.0,16,12,4
CAN,CHL,2021.0,24,29,-5
RUS,GRC,2000.0,6,2,4
BGR,RUS,2018.0,5,5,0
BGR,RUS,2022.0,4,3,1
RUS,GBR,1999.0,74,42,32
NOR,USA,1998.0,55,65,-10
DNK,FIN,2016.0,14,28,-14
DEU,IRL,2000.0,12,11,1
ESP,PRT,1998.0,24,9,15
IRL,ISR,2012.0,11,6,5
MYS,USA,2000.0,17,19,-2
FRA,GUF,2014.0,12,38,-26
DEU,ROU,2002.0,17,33,-16
SEN,MLI,1999.0,2,1,1
DNK,DEU,1998.0,35,38,-3
JPN,BGD,1997.0,9,10,-1
SRB,HRV,2001.0,5,4,1
GBR,ZAF,2000.0,43,72,-29
PAK,SAU,2002.0,12,3,9
SEN,USA,2012.0,5,4,1
BGR,CAN,1999.0,2,2,0
AUT,GBR,2012.0,72,78,-6
USA,SGP,2000.0,77,73,4
NZL,CAN,2003.0,27,30,-3
FIN,SWE,2022.0,59,67,-8
FRA,HUN,2019.0,14,13,1
FIN,DEU,2006.0,29,25,4
ARG,FRA,2003.0,27,15,12
NLD,ISR,2008.0,3,16,-13
FIN,DEU,2010.0,54,37,17
PRT,GBR,2000.0,23,61,-38
CHE,IRN,2011.0,13,18,-5
PRT,RUS,2003.0,5,10,-5
HUN,AUT,2002.0,11,11,0
JAM,USA,2017.0,12,11,1
KOR,CHE,2007.0,6,4,2
USA,ECU,2008.0,13,8,5
USA,CUB,2017.0,7,18,-11
ESP,AUS,2017.0,58,30,28
NLD,BRA,2000.0,13,10,3
BEL,SWE,2002.0,17,14,3
DEU,VNM,2016.0,22,7,15
ITA,IND,2010.0,20,46,-26
IND,ISR,2006.0,18,6,12
CUB,USA,2009.0,12,5,7
CAN,KWT,2020.0,20,5,15
PRT,ESP,2002.0,30,39,-9
SGP,MYS,2012.0,14,23,-9
RUS,BLR,2014.0,15,24,-9
MTQ,FRA,2008.0,13,15,-2
MTQ,FRA,2015.0,28,26,2
CHN,HUN,2020.0,10,8,2
HUN,ROU,2020.0,17,15,2
HUN,USA,2019.0,58,68,-10
VNM,FRA,1999.0,8,5,3
FIN,HUN,2003.0,3,9,-6
SWE,IRN,2001.0,6,1,5
FRA,GRC,2000.0,33,13,20
BGD,USA,2015.0,78,38,40
NPL,GBR,2013.0,5,14,-9
DEU,FIN,2015.0,56,56,0
GUF,FRA,2003.0,10,15,-5
FRA,GUF,2004.0,13,6,7
OMN,GBR,2003.0,7,6,1
SWE,EGY,2007.0,2,2,0
ITA,THA,2006.0,3,1,2
DNK,CHE,2001.0,20,14,6
UKR,JPN,2017.0,3,1,2
FRA,MTQ,2022.0,14,12,2
CHE,ISR,2007.0,6,11,-5
CAN,SAU,2000.0,22,10,12
FIN,CAN,2006.0,12,8,4
LTU,DNK,2007.0,3,3,0
SVK,AUT,1999.0,11,2,9
BEL,IND,2006.0,8,11,-3
FRA,UKR,1997.0,10,9,1
SWE,NIC,2007.0,3,2,1
CHN,AUT,2002.0,5,6,-1
RUS,BEL,2008.0,9,12,-3
GBR,BLR,2003.0,4,1,3
SWE,CHE,2016.0,52,68,-16
ESP,NLD,1998.0,37,26,11
ESP,SWE,2013.0,62,39,23
ESP,ROU,1999.0,2,1,1
ROU,ESP,2001.0,4,4,0
THA,BEL,2017.0,7,3,4
NOR,ARE,2015.0,2,1,1
KWT,IND,2000.0,2,11,-9
SWE,RUS,2001.0,26,55,-29
DNK,RUS,2015.0,3,9,-6
AUT,HUN,1998.0,3,3,0
UKR,TUR,2014.0,3,2,1
HUN,ESP,2006.0,4,2,2
SWE,IRN,2004.0,4,4,0
BGD,USA,2004.0,11,12,-1
ESP,COG,2020.0,1,1,0
AUS,SWE,1999.0,27,18,9
ISR,BEL,2004.0,1,9,-8
ROU,FRA,2002.0,36,22,14
JPN,BGR,2013.0,5,3,2
FRA,CHL,1998.0,11,14,-3
SRB,ARE,2010.0,1,1,0
CHN,AUS,2009.0,149,105,44
UKR,SVK,1999.0,2,1,1
AUS,ARE,2018.0,24,16,8
ITA,CAN,1997.0,19,22,-3
IRL,KNA,2016.0,1,1,0
ESP,KOR,2019.0,10,16,-6
ESP,MAR,2000.0,4,3,1
PRT,USA,2013.0,84,74,10
SWE,CZE,1998.0,4,5,-1
FRA,NCL,2020.0,37,51,-14
BEL,CHE,2000.0,27,14,13
FRA,BFA,1999.0,10,7,3
SWE,CUB,1998.0,2,2,0
JPN,NLD,2002.0,27,22,5
TUN,FRA,2009.0,100,127,-27
BEL,QAT,2016.0,5,2,3
AUS,NLD,2003.0,43,32,11
MDG,FRA,2011.0,10,13,-3
DEU,MEX,1999.0,16,6,10
RUS,NLD,2004.0,22,13,9
FRA,POL,1997.0,43,32,11
CAN,TUR,2018.0,27,40,-13
USA,MWI,2007.0,6,3,3
NOR,POL,1999.0,1,2,-1
ISR,MEX,2002.0,5,2,3
LBN,FRA,2014.0,31,79,-48
SAU,EGY,2005.0,37,47,-10
ZWE,ZAF,2003.0,11,1,10
ITA,NLD,2003.0,70,62,8
FRA,NOR,2019.0,58,29,29
CAN,NOR,2016.0,27,14,13
CHE,SVK,2004.0,4,4,0
USA,GTM,2002.0,6,5,1
GAB,GBR,2000.0,3,2,1
CAN,DNK,1997.0,13,11,2
IRN,MEX,2008.0,5,1,4
URY,ARG,2022.0,8,13,-5
RUS,ISR,2002.0,20,8,12
NLD,POL,2007.0,13,16,-3
FIN,NLD,1999.0,12,12,0
GBR,BEL,2011.0,93,88,5
IRL,NZL,1999.0,2,3,-1
GBR,SVK,2006.0,13,3,10
BEL,AUT,2014.0,19,11,8
PRT,JPN,2018.0,9,4,5
FIN,JPN,2002.0,12,21,-9
FRA,IRL,1997.0,10,5,5
BRA,JPN,2001.0,17,23,-6
CHE,CHN,2012.0,43,38,5
KEN,ZWE,2017.0,1,1,0
USA,ZWE,2020.0,12,4,8
BRA,ESP,2010.0,82,76,6
SVK,NLD,2012.0,5,2,3
NLD,SVK,2014.0,5,6,-1
MEX,CHL,2011.0,19,12,7
MYS,KOR,2014.0,10,25,-15
ARG,FRA,2013.0,41,27,14
ROU,ESP,2015.0,11,8,3
TWN,DEU,2013.0,21,17,4
UKR,GBR,2014.0,30,26,4
DEU,NOR,2012.0,66,34,32
THA,IRL,2018.0,1,2,-1
FIN,SWE,2016.0,78,52,26
POL,CHE,2018.0,20,26,-6
IRL,SWE,2019.0,16,14,2
IRQ,IRN,2009.0,2,1,1
VNM,AUS,2011.0,4,11,-7
SWE,IRN,2014.0,17,39,-22
DNK,GBR,2023.0,66,86,-20
IRN,CHN,2018.0,49,11,38
VNM,DEU,2011.0,4,12,-8
GRC,POL,2016.0,4,1,3
MYS,AUS,2008.0,29,29,0
ARE,USA,2016.0,46,90,-44
IND,ESP,2013.0,23,16,7
USA,CMR,2017.0,7,11,-4
VNM,CHN,2021.0,14,30,-16
CHN,THA,2015.0,15,17,-2
GBR,MWI,2022.0,19,17,2
TWN,FRA,2014.0,16,12,4
FRA,TWN,2015.0,10,11,-1
THA,VNM,2014.0,6,6,0
EGY,DEU,2013.0,35,62,-27
ESP,ISR,2015.0,17,8,9
ESP,COL,2009.0,57,42,15
FRA,KHM,2013.0,7,2,5
GBR,IRN,2015.0,40,48,-8
SAU,CHE,2020.0,2,7,-5
ESP,GRC,1999.0,2,3,-1
AUT,CAN,2016.0,21,32,-11
SAU,ITA,2012.0,2,12,-10
ESP,COL,2011.0,64,71,-7
KEN,AUS,2012.0,3,2,1
CHN,IRL,2013.0,11,17,-6
CRI,ARG,2014.0,3,1,2
COL,BRA,2012.0,37,28,9
SWE,CHE,2022.0,55,71,-16
ITA,RUS,1998.0,29,27,2
PRT,FRA,2014.0,46,30,16
BGD,MYS,2017.0,25,66,-41
HUN,DEU,2009.0,47,25,22
NZL,SGP,2012.0,10,7,3
KOR,BRA,2023.0,5,1,4
NOR,DNK,2009.0,27,35,-8
THA,CHN,2020.0,36,47,-11
ITA,AUS,2014.0,48,28,20
FRA,PAK,2006.0,4,2,2
IRL,BEL,2013.0,8,5,3
PAK,IRN,2007.0,1,1,0
MEX,CAN,2007.0,25,31,-6
NLD,DNK,2019.0,48,47,1
AUS,IDN,2013.0,62,17,45
MEX,ARG,2019.0,24,27,-3
CAN,HRV,2015.0,1,1,0
NGA,MYS,2012.0,28,14,14
ITA,SWE,2011.0,57,32,25
ZAF,IND,2016.0,27,70,-43
DEU,IRQ,2021.0,10,6,4
SWE,ITA,2021.0,60,70,-10
NLD,JPN,2021.0,25,26,-1
KOR,TWN,2003.0,8,3,5
GUF,FRA,2013.0,30,31,-1
VEN,COL,2005.0,2,3,-1
SAU,ZAF,2015.0,17,12,5
HUN,ITA,2003.0,15,5,10
KEN,DEU,2016.0,14,20,-6
CAN,FIN,2007.0,9,12,-3
USA,MLT,2012.0,3,3,0
USA,ISL,2015.0,22,16,6
GBR,IDN,2015.0,30,7,23
ESP,NCL,2015.0,1,1,0
IND,NPL,2011.0,23,38,-15
DEU,GBR,2023.0,334,422,-88
GBR,IRQ,2021.0,153,34,119
HKG,AUS,2020.0,42,52,-10
IND,BRA,2020.0,12,21,-9
CHN,ITA,2018.0,39,64,-25
DEU,SWE,2023.0,111,81,30
ITA,PRT,2022.0,36,43,-7
SEN,GIN,2020.0,2,1,1
NZL,USA,2021.0,121,125,-4
USA,HKG,2021.0,164,158,6
MYS,NGA,2020.0,133,60,73
ETH,IRN,2018.0,3,2,1
FIN,CHN,2020.0,54,52,2
USA,GUM,2021.0,20,15,5
GBR,IRN,2018.0,42,60,-18
SAU,IND,2018.0,70,188,-118
IND,SAU,2020.0,170,64,106
VNM,PAK,2019.0,3,3,0
DNK,SWE,2020.0,120,106,14
USA,JAM,2021.0,15,10,5
MEX,COL,2018.0,59,60,-1
LKA,KOR,2022.0,5,8,-3
MEX,JPN,2022.0,11,5,6
TUN,ESP,2019.0,7,4,3
CHN,FRA,2019.0,204,281,-77
BEL,CHN,2022.0,100,75,25
PAK,SAU,2023.0,72,60,12
ESP,FRA,1997.0,76,93,-17
AUS,DNK,2018.0,41,30,11
AUS,JPN,2021.0,60,58,2
IND,KOR,2022.0,308,156,152
MYS,SGP,2016.0,20,14,6
CHL,DEU,2022.0,41,37,4
BRA,NLD,2019.0,45,31,14
FIN,GBR,2016.0,70,58,12
KOR,JPN,2019.0,112,113,-1
KEN,RWA,2019.0,10,5,5
ESP,CHE,2016.0,129,74,55
AUS,BGD,2020.0,70,85,-15
FRA,CHE,2018.0,378,283,95
CUB,CHL,2022.0,6,5,1
ISR,DEU,2022.0,61,68,-7
ESP,PRT,2019.0,143,133,10
BRA,KOR,2019.0,3,5,-2
IDN,TWN,2022.0,46,68,-22
GBR,TWN,2022.0,36,22,14
CHE,ESP,2020.0,97,132,-35
BRA,FRA,2019.0,166,136,30
CMR,ZAF,2021.0,4,11,-7
ZAF,CAN,2022.0,41,15,26
ISR,SRB,2002.0,1,2,-1
AUS,PAK,2018.0,23,45,-22
AUS,PAK,2022.0,37,40,-3
SGP,CHN,2023.0,358,248,110
THA,VNM,2016.0,10,7,3
MYS,AUS,2018.0,139,107,32
USA,UGA,2017.0,42,26,16
DNK,DEU,2019.0,126,123,3
QAT,GBR,2017.0,16,44,-28
USA,CHL,2019.0,155,133,22
ESP,NLD,2021.0,113,92,21
CAN,CHL,2020.0,28,20,8
COL,BRA,2023.0,29,28,1
EGY,AUS,2020.0,20,11,9
BEL,CAN,2022.0,36,34,2
IDN,JPN,2018.0,62,188,-126
BRA,JPN,2017.0,11,17,-6
FRA,CHL,2021.0,44,45,-1
KAZ,FRA,2020.0,5,4,1
ESP,CHN,2023.0,55,52,3
RUS,EGY,2020.0,18,9,9
ARG,ITA,2003.0,19,9,10
CZE,IRN,2020.0,2,23,-21
USA,ECU,2022.0,24,27,-3
PAK,CHN,2018.0,315,243,72
BEL,LBN,2020.0,9,4,5
THA,HKG,2019.0,6,5,1
MYS,CAN,2016.0,27,9,18
DEU,LTU,2021.0,4,11,-7
GRD,USA,2018.0,11,13,-2
IRN,MYS,2008.0,15,4,11
USA,DEU,2023.0,587,648,-61
IND,AUT,2015.0,19,12,7
AUT,NOR,2020.0,17,12,5
USA,ECU,2018.0,40,32,8
IND,NPL,2020.0,43,34,9
SGP,HKG,2019.0,41,38,3
SWE,FRA,2023.0,36,54,-18
HKG,CAN,2012.0,23,15,8
ESP,ITA,2021.0,252,279,-27
ITA,CAN,2023.0,36,40,-4
DEU,GRC,2019.0,52,78,-26
ARG,USA,2020.0,135,92,43
FRA,DZA,2014.0,155,54,101
IRN,ITA,2019.0,70,28,42
GHA,DEU,2020.0,15,24,-9
USA,LKA,2021.0,22,25,-3
VNM,FRA,2019.0,20,63,-43
GBR,PRT,2019.0,97,132,-35
PRT,NOR,2019.0,16,2,14
BGD,USA,2016.0,83,37,46
USA,HKG,2019.0,164,175,-11
DOM,ARG,2023.0,1,1,0
RUS,AUT,2022.0,13,14,-1
GHA,CAN,2019.0,8,9,-1
BHR,SAU,2019.0,7,10,-3
MYS,IDN,2019.0,97,27,70
BHR,GBR,2022.0,8,4,4
USA,NPL,2019.0,25,53,-28
CYP,IRN,2021.0,2,4,-2
ESP,AUS,2015.0,78,40,38
USA,SWZ,2019.0,6,5,1
NLD,SWE,2019.0,88,79,9
IDN,DEU,2018.0,17,36,-19
DEU,NLD,2023.0,221,199,22
HKG,ISR,2008.0,1,1,0
FRA,NLD,2022.0,102,104,-2
ZAF,GHA,2020.0,26,18,8
CAN,KAZ,2021.0,4,2,2
KOR,JPN,2021.0,107,101,6
UKR,FRA,2017.0,17,15,2
UKR,FRA,2022.0,14,3,11
CHN,FRA,2021.0,165,277,-112
CHE,AUS,2018.0,73,77,-4
NOR,CHE,2013.0,9,21,-12
ZAF,RUS,2014.0,4,5,-1
ISR,USA,2019.0,385,413,-28
POL,CZE,2018.0,30,14,16
HKG,USA,2016.0,153,155,-2
GBR,SRB,2018.0,12,16,-4
LUX,AUS,2020.0,4,5,-1
HUN,GBR,2020.0,42,33,9
SRB,MNE,2017.0,17,13,4
ITA,HRV,2021.0,10,6,4
CHE,CHN,2023.0,70,79,-9
ESP,ECU,2019.0,76,60,16
NLD,SWE,2021.0,67,84,-17
USA,RUS,2023.0,47,110,-63
ROU,ESP,2018.0,9,7,2
ESP,ROU,2019.0,6,6,0
ROU,DEU,2019.0,18,16,2
SAU,MYS,2022.0,35,40,-5
SRB,DEU,2016.0,19,11,8
CHN,DNK,2022.0,117,101,16
BRA,FRA,2021.0,169,125,44
GBR,LKA,2016.0,22,5,17
MAR,FRA,2020.0,56,83,-27
CAN,KWT,2009.0,11,7,4
GBR,BWA,2019.0,8,4,4
ESP,EGY,2023.0,8,8,0
CHE,AUS,2017.0,59,72,-13
CHN,AUS,2020.0,460,619,-159
NGA,NLD,2021.0,6,4,2
ZAF,NGA,2019.0,90,121,-31
ETH,NGA,2022.0,4,6,-2
CHL,GBR,2015.0,42,39,3
DNK,USA,2019.0,161,163,-2
SWE,NLD,2020.0,80,82,-2
SWE,CHE,2015.0,58,57,1
USA,PRT,2018.0,66,96,-30
AUS,PAK,2016.0,27,42,-15
PAK,AUS,2020.0,63,35,28
BEL,CHN,2018.0,70,60,10
IND,ARE,2022.0,54,35,19
ESP,HND,2018.0,3,1,2
IDN,JPN,2017.0,76,199,-123
IND,KOR,2017.0,258,147,111
LTU,GBR,2021.0,16,8,8
IRL,PAK,2021.0,6,18,-12
ITA,IDN,2011.0,6,2,4
CHN,LKA,2017.0,7,2,5
PAK,CHN,2022.0,278,508,-230
KOR,ARE,2022.0,14,5,9
LBN,USA,2022.0,144,40,104
VEN,USA,2016.0,33,8,25
LBN,FRA,2018.0,52,137,-85
IND,ETH,2019.0,79,22,57
CAN,FRA,2019.0,295,402,-107
GBR,SAU,2022.0,213,96,117
DEU,BRA,2020.0,99,177,-78
ITA,TUR,2021.0,20,24,-4
CZE,USA,2015.0,55,69,-14
SAU,IND,2022.0,87,85,2
ITA,CAN,2000.0,37,39,-2
DEU,SAU,2021.0,33,25,8
PAK,CHN,2017.0,282,160,122
ETH,NOR,2017.0,8,7,1
IND,BEL,2016.0,32,29,3
ESP,GBR,1999.0,130,159,-29
GEO,FRA,2018.0,32,6,26
AUS,ETH,2017.0,4,13,-9
COL,USA,2021.0,174,130,44
ECU,DEU,2017.0,5,7,-2
DEU,PAK,2014.0,34,28,6
DEU,JOR,2022.0,7,12,-5
FRA,NOR,2020.0,47,32,15
CHN,BRA,2022.0,10,19,-9
BEN,NGA,2021.0,4,7,-3
CHN,NGA,2020.0,25,41,-16
FIN,NLD,2021.0,28,25,3
CHE,AUS,2022.0,44,66,-22
COL,USA,2019.0,164,152,12
CHN,GHA,2019.0,16,25,-9
NLD,PRT,2018.0,27,37,-10
JPN,ETH,2019.0,5,2,3
DNK,CHE,2022.0,36,38,-2
ITA,AUS,2022.0,30,38,-8
MYS,IRQ,2020.0,151,37,114
NZL,PHL,2020.0,2,2,0
SAU,PAK,2018.0,87,86,1
USA,LKA,2019.0,29,32,-3
IRN,GBR,2003.0,22,68,-46
RWA,ZAF,2018.0,3,14,-11
ESP,FIN,2021.0,16,22,-6
IRN,POL,2020.0,16,2,14
CZE,FRA,2022.0,28,31,-3
ETH,AUS,2020.0,32,13,19
VEN,USA,2022.0,11,7,4
FRA,GLP,2018.0,24,49,-25
IRL,HKG,2022.0,1,3,-2
IND,NLD,2019.0,52,26,26
BRA,PER,2019.0,51,13,38
CHN,GHA,2021.0,81,13,68
CHE,ISR,2021.0,16,18,-2
DNK,NLD,2015.0,27,41,-14
FRA,ARG,2021.0,29,30,-1
IRN,NZL,2018.0,26,4,22
GBR,GHA,2014.0,33,12,21
NGA,UGA,2018.0,6,2,4
DEU,HRV,2015.0,7,25,-18
CHE,SGP,2020.0,30,26,4
DEU,PAK,2008.0,8,14,-6
USA,YEM,2020.0,1,1,0
LBN,FRA,2022.0,106,46,60
FIN,VNM,2021.0,4,1,3
USA,AUS,1999.0,400,474,-74
COL,GBR,2018.0,24,15,9
IRN,PRT,2023.0,10,2,8
SAU,GBR,2021.0,92,273,-181
CHN,BGD,2016.0,6,20,-14
ESP,GBR,1998.0,161,106,55
ZAF,COD,2023.0,6,1,5
EGY,MYS,2023.0,4,6,-2
AZE,RUS,2020.0,4,10,-6
MAR,CAN,2020.0,5,14,-9
CHN,CZE,2020.0,25,14,11
JOR,CAN,2021.0,19,14,5
PAK,USA,2020.0,153,83,70
PAK,IND,2017.0,26,41,-15
IRN,IRQ,2020.0,32,23,9
IDN,JPN,2022.0,86,151,-65
IND,NZL,2004.0,5,1,4
GBR,SRB,2017.0,7,14,-7
CHL,ECU,2020.0,22,12,10
DEU,GRC,2021.0,67,72,-5
IRQ,USA,2021.0,25,72,-47
USA,IND,2022.0,757,1386,-629
USA,KAZ,2022.0,13,16,-3
IDN,DEU,2022.0,15,29,-14
IND,BEL,2022.0,32,17,15
GBR,BGD,2000.0,10,11,-1
JPN,BGD,2006.0,36,35,1
HKG,TWN,2020.0,21,20,1
RUS,FIN,2021.0,43,20,23
POL,USA,2021.0,130,99,31
UZB,RUS,2020.0,5,22,-17
USA,SWE,2002.0,235,343,-108
IND,IRL,2022.0,65,13,52
BTN,THA,2021.0,2,7,-5
ETH,UGA,2022.0,6,3,3
UGA,ETH,2023.0,4,3,1
GBR,TWN,2016.0,36,35,1
AUT,CHE,2019.0,75,66,9
SVN,GBR,2022.0,5,12,-7
IND,ARE,2018.0,66,27,39
AUS,THA,2021.0,43,24,19
IND,NLD,2021.0,57,40,17
ESP,CAN,2022.0,58,58,0
TWN,THA,2022.0,16,6,10
PAK,IND,2022.0,44,32,12
IRN,ITA,2021.0,104,22,82
ITA,POL,2020.0,37,17,20
BGD,USA,2022.0,187,83,104
BRA,AUS,2023.0,27,13,14
CHN,ITA,2022.0,85,81,4
BGD,USA,2018.0,108,56,52
VNM,MYS,2021.0,12,10,2
CYP,USA,2021.0,12,11,1
MYS,YEM,2021.0,32,6,26
LTU,DNK,2021.0,6,3,3
IND,TWN,2022.0,87,48,39
CHN,ISR,2020.0,45,24,21
DEU,MEX,2021.0,41,62,-21
USA,NPL,2021.0,31,47,-16
MYS,IND,2013.0,41,88,-47
IND,KOR,2016.0,205,145,60
JPN,SGP,2021.0,36,34,2
UKR,CAN,2021.0,7,5,2
CHN,THA,2022.0,42,50,-8
MEX,ETH,2019.0,1,2,-1
COL,GBR,2022.0,29,32,-3
ITA,PAK,2021.0,12,37,-25
IDN,THA,2023.0,24,21,3
VNM,USA,2021.0,53,68,-15
IND,ETH,2021.0,65,40,25
SVK,CZE,2015.0,79,63,16
IND,AUS,2022.0,112,72,40
THA,VNM,2018.0,20,7,13
BEL,COD,2022.0,16,5,11
COD,BEL,2023.0,4,6,-2
TZA,JPN,2021.0,2,5,-3
ZAF,MWI,2021.0,14,11,3
ITA,BRA,2020.0,65,72,-7
GBR,TUR,2023.0,32,67,-35
PAK,THA,2023.0,8,7,1
IRN,AFG,2022.0,5,3,2
CAN,CIV,2010.0,2,1,1
ARG,DEU,2022.0,35,23,12
SAU,AUS,2022.0,27,59,-32
THA,NPL,2023.0,6,4,2
USA,KHM,2021.0,9,5,4
DEU,ETH,2020.0,17,17,0
NLD,AUS,2018.0,95,95,0
IND,AUS,2016.0,125,78,47
SAU,CHE,2021.0,6,5,1
GBR,IDN,2022.0,58,36,22
CHE,BEL,2004.0,15,28,-13
VNM,JPN,2020.0,32,127,-95
ARE,IND,2020.0,31,91,-60
AUT,PAK,2018.0,12,7,5
BGD,USA,2017.0,88,48,40
GBR,MYS,2018.0,170,108,62
PRT,BRA,2015.0,164,143,21
NZL,AUS,2021.0,151,154,-3
CHE,NLD,2023.0,69,67,2
USA,RUS,2000.0,182,516,-334
IND,IRN,2022.0,8,13,-5
KOR,PRK,2021.0,11,5,6
SGP,BEL,2009.0,4,6,-2
CAN,BEL,2015.0,40,56,-16
CHN,NZL,2021.0,50,45,5
DNK,SWE,1999.0,49,50,-1
FRA,MTQ,2014.0,18,25,-7
MTQ,FRA,2016.0,33,15,18
SWE,DNK,1998.0,45,34,11
FRA,RUS,2003.0,63,68,-5
ZAF,USA,1998.0,67,38,29
CZE,CHE,2000.0,6,10,-4
NZL,GBR,1998.0,62,72,-10
CHE,LUX,2012.0,4,4,0
SRB,USA,1997.0,18,27,-9
GBR,CHE,2006.0,156,143,13
USA,AUT,1999.0,100,122,-22
SWE,NLD,1998.0,19,25,-6
SWE,ESP,2001.0,35,17,18
NLD,ITA,2002.0,67,69,-2
SEN,BEL,2014.0,2,1,1
BEL,ITA,2001.0,45,51,-6
CHE,UKR,2001.0,2,5,-3
RUS,GBR,2011.0,45,33,12
GBR,RUS,2002.0,58,85,-27
DEU,RUS,2009.0,111,153,-42
JPN,CAN,2000.0,125,110,15
AUS,CAN,2000.0,98,107,-9
POL,DEU,1997.0,55,45,10
DEU,SVK,2005.0,12,20,-8
FRA,GBR,1999.0,324,276,48
TUN,FRA,1999.0,35,56,-21
AUS,SWE,2021.0,65,49,16
POL,RUS,2003.0,19,19,0
CHN,SWE,2017.0,114,131,-17
BGR,RUS,2004.0,8,6,2
USA,OMN,2013.0,9,3,6
RUS,DEU,2002.0,279,172,107
RUS,POL,1999.0,16,11,5
EGY,JPN,2002.0,11,30,-19
GBR,ESP,2000.0,129,158,-29
RUS,SWE,2015.0,29,17,12
EGY,QAT,2004.0,5,1,4
ESP,DEU,2001.0,95,106,-11
GBR,TUR,2000.0,67,34,33
FRA,AUS,1997.0,32,25,7
POL,FRA,2002.0,36,42,-6
AUS,BRA,2001.0,14,13,1
DEU,CZE,2003.0,31,32,-1
CHE,GRC,1999.0,10,1,9
SEN,MDG,2002.0,6,2,4
FIN,RUS,2012.0,19,24,-5
TUR,CAN,2010.0,17,18,-1
ZAF,ISR,2001.0,3,2,1
ISR,FRA,1999.0,23,27,-4
NLD,GRC,2001.0,17,12,5
IND,SGP,2000.0,24,2,22
USA,GAB,2023.0,2,3,-1
BLR,DEU,2015.0,4,2,2
CHE,NLD,2010.0,53,62,-9
JPN,NLD,2000.0,33,25,8
SWE,FIN,1999.0,36,43,-7
USA,ARG,1998.0,71,91,-20
DEU,UKR,2002.0,24,52,-28
JPN,IND,2002.0,76,88,-12
FIN,SWE,2008.0,34,26,8
NER,FRA,2019.0,5,2,3
ITA,DNK,2001.0,15,16,-1
SWE,ITA,1999.0,28,23,5
GRC,BEL,2000.0,7,10,-3
ARE,EGY,2017.0,12,12,0
EGY,GBR,2018.0,54,57,-3
SWE,AUS,1997.0,21,12,9
ZAF,SVK,2011.0,1,1,0
UKR,PRT,2008.0,3,2,1
BGR,USA,2000.0,36,10,26
DEU,NLD,2000.0,175,166,9
COL,DNK,2011.0,3,1,2
DEU,IDN,2018.0,36,17,19
KEN,USA,2002.0,43,25,18
GBR,HKG,1999.0,33,26,7
IRL,USA,2001.0,57,64,-7
CZE,KOR,2002.0,2,1,1
ISR,GBR,1997.0,27,25,2
BGR,USA,2010.0,10,15,-5
USA,BGR,2014.0,9,15,-6
CZE,TUR,2018.0,2,8,-6
SWE,FRA,2006.0,46,35,11
JPN,NPL,2001.0,4,4,0
NGA,USA,2004.0,18,19,-1
NLD,BRA,2002.0,11,22,-11
ISR,AUT,2000.0,7,2,5
CHE,SWE,2003.0,36,32,4
CHE,BEL,2014.0,55,45,10
USA,SVN,1997.0,10,2,8
ITA,FRA,1999.0,189,152,37
KAZ,RUS,1999.0,5,9,-4
RUS,UKR,2013.0,58,78,-20
GBR,CZE,2008.0,53,49,4
RUS,FIN,2019.0,26,16,10
CAN,TUR,2004.0,10,14,-4
TUR,CAN,2006.0,11,13,-2
GBR,GHA,2001.0,6,5,1
GHA,GBR,2002.0,5,7,-2
DEU,ITA,1999.0,130,134,-4
SWE,ZAF,2021.0,6,22,-16
EGY,USA,2004.0,46,75,-29
AUS,RUS,2000.0,5,9,-4
CAN,NLD,2001.0,40,36,4
ARG,VEN,2020.0,4,12,-8
NLD,JPN,1999.0,28,24,4
IND,HKG,1999.0,3,3,0
HKG,IND,2004.0,5,2,3
IND,PRT,2001.0,6,1,5
ARG,USA,1998.0,91,71,20
EGY,KWT,1998.0,3,8,-5
KWT,EGY,2000.0,10,4,6
CHE,HKG,2022.0,9,9,0
DNK,GBR,1997.0,30,42,-12
AUS,JOR,2002.0,4,1,3
ISL,FIN,2002.0,2,2,0
DNK,PER,2000.0,1,1,0
FIN,USA,2003.0,95,102,-7
BGR,FRA,2005.0,12,7,5
FIN,SWE,2001.0,49,50,-1
ARE,GBR,2005.0,9,14,-5
FRA,POL,2000.0,48,27,21
SVK,CZE,2001.0,23,23,0
CAN,UKR,2014.0,3,5,-2
ZAF,KEN,2001.0,3,3,0
DEU,BRA,1999.0,41,17,24
ESP,AUS,2001.0,24,5,19
NGA,ZWE,1999.0,2,3,-1
FIN,DEU,2002.0,36,34,2
BRA,DEU,2001.0,44,54,-10
BEL,DEU,1999.0,42,61,-19
ITA,GEO,2002.0,1,4,-3
IRL,NLD,2005.0,12,8,4
AUS,SGP,2002.0,41,31,10
DEU,HRV,2001.0,10,17,-7
ARG,BRA,1998.0,21,8,13
NLD,CHE,1999.0,36,42,-6
IRL,AUS,2011.0,43,35,8
LTU,DEU,1997.0,3,7,-4
AUS,ITA,2000.0,20,20,0
RUS,TWN,2007.0,2,3,-1
FIN,CAN,1997.0,10,10,0
DEU,BEL,2001.0,74,62,12
NLD,DNK,2007.0,16,14,2
FRA,ITA,1997.0,144,151,-7
FRA,TUN,2002.0,72,44,28
RUS,AZE,2005.0,5,5,0
JPN,SAU,2015.0,20,5,15
DEU,TUR,2009.0,41,34,7
ZAF,IND,2015.0,25,68,-43
PAK,GBR,2004.0,19,24,-5
ITA,DEU,2020.0,344,295,49
SVK,CZE,2004.0,35,23,12
IND,NPL,1999.0,13,3,10
ESP,BEL,1997.0,12,19,-7
AUT,SVK,1997.0,7,8,-1
DEU,AUT,2001.0,186,198,-12
FIN,RUS,2002.0,25,25,0
USA,POL,2009.0,124,148,-24
SWE,CAN,2014.0,40,49,-9
GBR,NZL,2000.0,85,94,-9
IND,JPN,2001.0,108,64,44
PAN,USA,2000.0,10,7,3
DEU,DNK,1997.0,43,25,18
BEL,CHE,2005.0,25,13,12
BEL,CHE,2012.0,35,36,-1
ITA,DEU,1998.0,150,92,58
DEU,SVK,1997.0,9,15,-6
DEU,CZE,2013.0,35,42,-7
DEU,LIE,2002.0,5,3,2
DEU,ISR,2000.0,41,36,5
AUS,SWE,2011.0,36,32,4
GBR,JPN,1999.0,131,122,9
ZAF,BWA,2003.0,6,2,4
SWE,FRA,2000.0,30,61,-31
MAR,FRA,1999.0,49,67,-18
FRA,GUF,2017.0,37,38,-1
FRA,GUF,2022.0,20,41,-21
SGP,FRA,2002.0,4,7,-3
PER,USA,2003.0,16,31,-15
GBR,MWI,2008.0,9,14,-5
MWI,GBR,2015.0,15,21,-6
NOR,CHN,1997.0,4,3,1
HUN,FIN,1998.0,3,1,2
SWE,AUS,2005.0,40,20,20
THA,JPN,2013.0,63,107,-44
SGP,AUT,2008.0,1,6,-5
DEU,NGA,2003.0,9,5,4
ITA,CAN,2006.0,40,39,1
MEX,FRA,2015.0,35,60,-25
RUS,BGR,1997.0,6,7,-1
CHE,HUN,2009.0,7,17,-10
FRA,GAB,2002.0,8,5,3
ISR,GBR,2012.0,38,43,-5
DEU,NOR,2000.0,28,18,10
NLD,ISR,2018.0,15,14,1
FIN,CHE,2003.0,6,16,-10
GBR,PER,2018.0,9,8,1
ROU,SWE,2019.0,2,6,-4
FRA,QAT,2012.0,13,1,12
ESP,ARG,2003.0,57,81,-24
FRA,CIV,2000.0,20,16,4
POL,FRA,1997.0,32,43,-11
CAN,ARE,2001.0,11,4,7
MEX,BRA,2009.0,20,14,6
BHR,JOR,2009.0,2,1,1
NLD,FRA,1998.0,49,78,-29
JPN,THA,2003.0,55,40,15
PAN,USA,2010.0,18,22,-4
CAN,ISR,2003.0,31,56,-25
USA,IDN,2012.0,26,12,14
CAN,GRC,2003.0,11,8,3
NLD,ZMB,2018.0,2,1,1
GBR,HKG,2007.0,35,57,-22
ITA,NOR,2013.0,16,8,8
NOR,ITA,2015.0,12,34,-22
HKG,TWN,2007.0,4,6,-2
SGP,MYS,2010.0,18,19,-1
USA,AUT,1998.0,83,119,-36
TWN,CHN,2008.0,95,84,11
TZA,CHE,2019.0,10,3,7
BLR,USA,2002.0,27,6,21
USA,BLR,2003.0,15,20,-5
SVN,USA,2013.0,13,7,6
JPN,THA,2013.0,107,63,44
ZAF,USA,1999.0,77,75,2
RUS,SWE,2001.0,55,26,29
MEX,USA,1998.0,130,143,-13
USA,PRI,1998.0,66,41,25
NZL,POL,1997.0,2,1,1
DEU,CHN,2001.0,83,120,-37
CHL,FRA,1998.0,14,11,3
USA,CZE,2003.0,54,74,-20
CAN,PHL,2021.0,6,5,1
FRA,IRL,2000.0,14,12,2
IRL,FRA,2001.0,14,12,2
BRA,ISR,2003.0,3,1,2
NLD,CHN,2019.0,171,205,-34
SRB,ESP,2007.0,7,2,5
DEU,CRI,2004.0,3,1,2
USA,SYR,2003.0,8,2,6
MAR,ITA,2018.0,3,1,2
NOR,DEU,2002.0,21,24,-3
CRI,RUS,1998.0,11,1,10
BGR,BEL,1999.0,7,2,5
FRA,SEN,1999.0,25,24,1
UKR,KOR,2003.0,4,1,3
HUN,NLD,2002.0,11,6,5
CAN,TUR,2001.0,12,15,-3
USA,ROU,2021.0,30,27,3
BRA,NLD,2009.0,21,15,6
BEL,ROU,2005.0,8,6,2
SGP,DNK,2019.0,15,5,10
NLD,BEL,2001.0,102,92,10
ZAF,CIV,2002.0,5,2,3
EST,RUS,2000.0,4,3,1
DEU,EGY,2002.0,22,27,-5
IND,UZB,2022.0,3,4,-1
ISR,FRA,1998.0,16,29,-13
FRA,MTQ,2004.0,22,4,18
RUS,GRC,2002.0,6,6,0
SRB,HRV,2016.0,18,28,-10
POL,UKR,2014.0,11,17,-6
CAN,DNK,2006.0,21,25,-4
UKR,DEU,2003.0,46,27,19
GBR,SWE,1999.0,73,86,-13
NGA,USA,2001.0,19,9,10
USA,NGA,2002.0,18,13,5
TUR,RUS,2005.0,7,4,3
SDN,SAU,2003.0,2,1,1
SWE,ITA,1998.0,27,31,-4
GBR,ARE,2007.0,28,8,20
RUS,NLD,2017.0,16,18,-2
NLD,RUS,2018.0,11,21,-10
JPN,VNM,2013.0,45,10,35
CAN,CRI,1999.0,2,1,1
USA,AUT,2007.0,88,95,-7
DEU,TUR,2019.0,56,102,-46
CHL,USA,2000.0,52,45,7
BEL,GBR,2003.0,75,74,1
PRI,USA,1998.0,41,66,-25
BEL,HUN,1999.0,1,7,-6
EGY,SAU,2004.0,41,31,10
AUT,UKR,1998.0,7,2,5
NLD,CHL,2012.0,6,4,2
THA,FRA,2012.0,15,22,-7
USA,DNK,2001.0,136,125,11
ISR,CAN,2013.0,45,44,1
GBR,BEL,1998.0,42,55,-13
NLD,ESP,1998.0,26,37,-11
HKG,DEU,2004.0,6,3,3
UGA,GBR,2005.0,14,6,8
AUT,FRA,2011.0,35,27,8
ITA,ESP,1999.0,56,67,-11
GRC,ARE,2017.0,13,3,10
ARE,PSE,2010.0,1,1,0
DEU,UKR,1997.0,13,12,1
ROU,CHE,2004.0,4,4,0
KOR,LUX,2015.0,3,1,2
COG,COD,2007.0,7,6,1
ZAF,UGA,2002.0,3,1,2
UGA,ZAF,2007.0,3,4,-1
JPN,AUT,2019.0,14,17,-3
CZE,USA,2004.0,40,55,-15
SRB,RUS,2001.0,2,4,-2
ISR,PSE,2004.0,8,8,0
ITA,ESP,2007.0,134,86,48
SWE,EGY,2019.0,7,5,2
KEN,IRL,1999.0,1,1,0
POL,DEU,2005.0,74,55,19
ESP,FIN,2009.0,9,11,-2
GBR,CYP,2018.0,46,22,24
PRT,BRA,2001.0,48,28,20
ARE,EGY,2022.0,12,34,-22
BEL,ZAF,2001.0,10,11,-1
FIN,DEU,1997.0,17,15,2
CHE,HRV,2010.0,6,2,4
USA,TUN,2003.0,6,2,4
NLD,VNM,2015.0,11,2,9
USA,VEN,2001.0,60,47,13
GRC,ITA,2001.0,16,19,-3
RUS,CRI,1997.0,5,1,4
CRI,RUS,1999.0,5,1,4
USA,CRI,2003.0,18,8,10
ECU,MEX,2014.0,2,9,-7
MEX,ECU,2018.0,17,10,7
AUT,NLD,2018.0,40,37,3
DEU,ITA,1998.0,92,150,-58
ITA,CHE,2003.0,104,87,17
JPN,KOR,2000.0,109,95,14
ARG,GBR,1997.0,13,7,6
NOR,DEU,2012.0,34,66,-32
JPN,CAN,2023.0,34,55,-21
POL,GBR,2004.0,24,25,-1
USA,EGY,2005.0,74,56,18
AUS,KOR,1998.0,10,3,7
SWE,DEU,2002.0,101,82,19
URY,BRA,2011.0,5,7,-2
CHN,RUS,2011.0,6,8,-2
NLD,DEU,1998.0,124,120,4
CAN,NZL,2012.0,43,35,8
FIN,DEU,2012.0,48,48,0
USA,LKA,2009.0,9,15,-6
URY,MEX,2016.0,2,4,-2
MEX,SWE,1999.0,3,2,1
BGD,IND,2000.0,13,7,6
IND,BGD,2017.0,9,25,-16
KAZ,RUS,1998.0,15,13,2
USA,MEX,2022.0,252,372,-120
ARE,CAN,2000.0,7,3,4
GRC,FRA,2004.0,18,32,-14
FRA,UKR,2010.0,14,22,-8
CHE,NLD,2000.0,39,28,11
USA,PHL,2018.0,44,48,-4
KOR,ITA,2001.0,3,4,-1
USA,TUR,1998.0,97,90,7
SWE,FIN,1998.0,25,48,-23
RUS,JPN,2004.0,30,29,1
IRL,JPN,2003.0,2,7,-5
SWE,SRB,2004.0,7,3,4
CAN,IND,2003.0,26,53,-27
EGY,MYS,2010.0,7,1,6
CHN,KOR,2013.0,91,187,-96
PRT,AUS,2018.0,11,6,5
IND,BEL,2018.0,32,23,9
ARE,MYS,2017.0,7,23,-16
SAU,TUN,2016.0,32,89,-57
USA,KAZ,2018.0,13,16,-3
BRA,MYS,2016.0,3,2,1
NLD,FRA,2020.0,118,129,-11
ROU,ITA,2009.0,10,27,-17
ITA,ROU,2011.0,11,12,-1
LBY,LBN,2016.0,1,1,0
SGP,NLD,2016.0,17,22,-5
TWN,IDN,2020.0,45,58,-13
IDN,KOR,2020.0,33,53,-20
CAN,HKG,2006.0,19,17,2
MEX,ESP,2023.0,76,57,19
BEL,CAN,2016.0,43,38,5
DZA,TUN,2018.0,5,7,-2
USA,ECU,2016.0,39,17,22
USA,PAK,2010.0,53,69,-16
BRA,HKG,2021.0,5,1,4
UKR,HUN,2012.0,2,3,-1
LBN,FRA,2016.0,43,86,-43
FRA,NCL,2019.0,31,39,-8
SWE,BRA,2019.0,16,31,-15
ISR,DEU,2017.0,75,58,17
UKR,USA,2016.0,28,15,13
KAZ,AZE,2017.0,1,1,0
IND,PRT,2015.0,19,17,2
NGA,MYS,2023.0,44,42,2
NLD,AUS,2016.0,87,85,2
JPN,EGY,2020.0,68,62,6
PAK,MYS,2018.0,59,152,-93
CZE,FRA,2016.0,21,38,-17
DEU,JPN,2021.0,113,113,0
ARG,CHL,2015.0,28,29,-1
COL,DEU,2021.0,33,23,10
PAK,AUT,2014.0,6,17,-11
DEU,SAU,2019.0,41,27,14
NOR,JPN,2015.0,5,8,-3
RUS,GBR,2009.0,48,34,14
IND,OMN,2016.0,22,7,15
DEU,FIN,2016.0,67,69,-2
GRC,SWE,2022.0,19,19,0
IDN,TWN,2016.0,18,24,-6
MYS,TWN,2020.0,16,3,13
FRA,CHL,2019.0,40,31,9
SAU,PAK,2016.0,46,94,-48
BFA,CAN,2016.0,2,4,-2
PAK,MYS,2017.0,48,131,-83
DEU,LUX,2021.0,44,26,18
KOR,EGY,2019.0,8,13,-5
POL,SVK,2021.0,10,9,1
DEU,HUN,2021.0,30,35,-5
PRT,ESP,2023.0,91,67,24
EGY,ITA,2015.0,7,8,-1
AUS,SAU,2014.0,31,20,11
ESP,PER,2019.0,28,20,8
AUT,PRT,2015.0,5,6,-1
USA,SVK,2023.0,2,5,-3
AUS,SRB,2022.0,2,6,-4
MEX,CAN,2019.0,49,42,7
FRA,NLD,2018.0,120,121,-1
ITA,UKR,2020.0,3,6,-3
GBR,JOR,2016.0,25,18,7
NGA,CHN,2017.0,16,8,8
DEU,NZL,2019.0,33,30,3
IRL,SGP,2016.0,8,3,5
JPN,KOR,2023.0,57,46,11
TWN,VNM,2020.0,48,26,22
ISR,GBR,2002.0,33,37,-4
POL,PRT,1997.0,2,2,0
ITA,ECU,2016.0,9,1,8
FRA,GLP,2017.0,29,37,-8
ITA,PRT,2017.0,35,23,12
ETH,NOR,2018.0,6,9,-3
MEX,JPN,2018.0,8,9,-1
UKR,SVK,2021.0,13,2,11
CUB,USA,2020.0,14,7,7
TTO,GBR,2015.0,4,6,-2
HUN,FRA,2016.0,12,17,-5
MYS,YEM,2019.0,26,6,20
SYR,GBR,2019.0,6,2,4
BRA,DEU,2015.0,97,98,-1
MEX,CAN,2021.0,69,36,33
FRA,CIV,2010.0,26,42,-16
KOR,PAK,2018.0,87,50,37
NAM,GBR,2016.0,5,2,3
CHE,AUT,2019.0,66,75,-9
CAN,AUT,2021.0,25,24,1
BEL,ETH,2018.0,14,5,9
GBR,IRN,2016.0,41,51,-10
NLD,ISR,2022.0,9,14,-5
CZE,CHE,2023.0,17,6,11
NLD,PRT,2022.0,17,27,-10
ZAF,KOR,2020.0,7,6,1
AUS,ISR,2023.0,10,14,-4
GBR,IRN,2022.0,28,88,-60
ESP,CAN,2016.0,76,42,34
CUB,ESP,2015.0,28,16,12
USA,BGD,2015.0,38,78,-40
SVN,SVK,2010.0,27,13,14
IND,ISR,1997.0,12,1,11
ETH,NGA,2017.0,3,4,-1
SWE,DEU,2012.0,96,163,-67
ESP,ECU,2021.0,82,77,5
BEL,ETH,2017.0,8,2,6
ROU,HUN,2015.0,21,10,11
BEL,CAN,2018.0,46,44,2
IND,IRL,2018.0,34,9,25
BEN,NGA,2019.0,12,4,8
RWA,USA,2015.0,19,7,12
GBR,IRQ,2009.0,5,4,1
USA,GTM,2023.0,9,2,7
ESP,ROU,2021.0,9,8,1
HTI,USA,2014.0,4,20,-16
NLD,IDN,2020.0,62,33,29
GBR,LBY,2020.0,24,6,18
IND,JOR,2021.0,3,2,1
IDN,JPN,2016.0,44,189,-145
NGA,CHN,2016.0,7,14,-7
IRN,NLD,2020.0,62,26,36
GBR,TWN,2018.0,37,30,7
ESP,IRN,2015.0,7,16,-9
SRB,MNE,2018.0,8,16,-8
USA,UGA,2016.0,51,34,17
CAN,KEN,2017.0,12,10,2
CHN,CHE,2014.0,56,53,3
CZE,POL,2000.0,3,6,-3
CHE,DNK,2020.0,40,43,-3
FRA,PSE,2022.0,2,1,1
URY,ESP,2018.0,9,24,-15
CHE,PRT,2013.0,18,11,7
CAN,OMN,2009.0,9,2,7
CHL,DEU,2017.0,38,35,3
KOR,CHN,2023.0,185,154,31
PAK,MYS,2016.0,48,75,-27
GBR,JOR,2018.0,43,17,26
JPN,SAU,2014.0,19,3,16
BEL,ZAF,2015.0,12,14,-2
DEU,IRQ,2020.0,19,6,13
FRA,ARG,2019.0,39,50,-11
NZL,LKA,2021.0,6,8,-2
SWE,UGA,2022.0,3,2,1
UGA,SWE,2023.0,1,1,0
MYS,AUS,2016.0,126,105,21
ZAF,CAN,2016.0,25,27,-2
TWN,HKG,2023.0,10,6,4
JPN,CHE,2022.0,35,27,8
SWE,ESP,2015.0,35,88,-53
CZE,ESP,2014.0,12,31,-19
IND,FRA,2001.0,29,19,10
IDN,GBR,2020.0,38,54,-16
RUS,IRQ,2019.0,11,3,8
NLD,CHE,2020.0,150,95,55
USA,PAK,2006.0,38,40,-2
PAK,USA,2007.0,38,33,5
CHN,SAU,2019.0,61,51,10
ITA,VNM,2017.0,11,2,9
IRN,NZL,2016.0,20,1,19
DNK,LUX,2018.0,2,1,1
DNK,BEL,2008.0,3,4,-1
NZL,PRT,2019.0,3,3,0
EST,GBR,2017.0,10,11,-1
CAN,COG,2016.0,1,1,0
AUT,FRA,2019.0,38,62,-24
CMR,FRA,2013.0,10,25,-15
ESP,ISR,2016.0,12,8,4
CHN,PRK,2018.0,19,2,17
AUS,HKG,2023.0,38,28,10
NOR,CHN,2012.0,15,32,-17
MYS,THA,2017.0,16,5,11
HND,USA,2020.0,4,4,0
JPN,LUX,2019.0,2,1,1
NCL,FRA,2018.0,25,24,1
FRA,NCL,2021.0,32,29,3
NCL,FRA,2022.0,15,27,-12
AUS,KOR,2020.0,29,67,-38
YEM,JOR,2022.0,2,2,0
THA,ITA,2018.0,4,6,-2
IRL,DEU,2005.0,11,27,-16
KOR,ARE,2017.0,13,4,9
FRA,ZAF,2000.0,16,11,5
PRT,FRA,2022.0,43,37,6
SDN,CHN,2020.0,7,27,-20
USA,JOR,2018.0,54,47,7
ETH,ZAF,2023.0,5,10,-5
ARE,CHN,2021.0,10,17,-7
PAK,OMN,2023.0,12,7,5
CAN,ITA,2019.0,64,93,-29
MEX,AUT,2019.0,7,4,3
GBR,NGA,2015.0,46,43,3
SRB,SVN,2019.0,4,8,-4
UKR,CZE,2019.0,11,5,6
SWE,TWN,2023.0,3,6,-3
GBR,ARG,2022.0,8,18,-10
MYS,JOR,2014.0,11,4,7
NOR,BRA,2020.0,8,24,-16
FRA,ECU,2021.0,7,8,-1
IDN,AUS,2016.0,28,73,-45
AUT,SWE,2021.0,25,23,2
LBN,USA,2017.0,80,74,6
ISL,IND,2020.0,1,1,0
CAN,ITA,2021.0,50,55,-5
MYS,KWT,2020.0,5,3,2
CHN,EGY,2020.0,48,61,-13
ETH,KEN,2018.0,9,12,-3
RUS,FRA,2018.0,56,65,-9
UKR,USA,2018.0,29,17,12
UKR,USA,2022.0,23,14,9
SAU,SWE,2020.0,8,5,3
ZAF,RWA,2018.0,14,3,11
DEU,ISR,2023.0,36,36,0
SDN,MYS,2015.0,4,9,-5
SAU,AUS,2017.0,27,77,-50
IND,FJI,2015.0,2,2,0
IND,CHN,2023.0,45,105,-60
MYS,AUS,2022.0,56,43,13
THA,SGP,2023.0,8,4,4
PER,MEX,2022.0,7,9,-2
DEU,MEX,2011.0,20,31,-11
IND,QAT,2019.0,18,7,11
JPN,KAZ,2020.0,3,2,1
RUS,HKG,2022.0,8,2,6
IDN,SGP,2019.0,4,10,-6
SGP,IDN,2022.0,8,4,4
EGY,BGD,2012.0,1,1,0
HUN,AUT,2010.0,16,10,6
CHE,IRN,2020.0,13,48,-35
CHN,DNK,2017.0,66,67,-1
HRV,BEL,2021.0,4,3,1
MKD,DEU,2017.0,5,3,2
IRN,FRA,2023.0,26,16,10
MYS,ITA,2021.0,5,3,2
HKG,MYS,2011.0,4,3,1
IRQ,USA,2019.0,28,68,-40
USA,JOR,2016.0,73,41,32
NPL,JPN,2023.0,5,4,1
FRA,DNK,2003.0,29,27,2
ESP,NOR,2020.0,31,26,5
USA,PAN,2014.0,25,16,9
CHN,SWE,2022.0,108,167,-59
GBR,GEO,2017.0,1,1,0
ITA,AUS,2017.0,68,37,31
CHE,RUS,2023.0,14,428,-414
FRA,BFA,2021.0,17,18,-1
USA,NGA,2012.0,41,36,5
USA,SVN,2002.0,15,9,6
SWE,IRQ,2023.0,4,2,2
IRN,FIN,2014.0,14,4,10
FIN,JPN,2023.0,6,5,1
FRA,SEN,2020.0,40,29,11
JOR,GBR,2020.0,26,49,-23
ARG,COL,2020.0,24,19,5
SWE,DNK,1999.0,50,49,1
RUS,ESP,2020.0,21,8,13
SGP,NLD,2022.0,18,13,5
IRL,HKG,2017.0,4,2,2
IRL,ISR,2010.0,10,19,-9
EGY,CHE,2010.0,6,6,0
ARG,CHL,2008.0,13,13,0
CAN,DNK,2000.0,17,13,4
IND,SWE,1999.0,11,6,5
DEU,SWE,2024.0,3,1,2
PRT,FRA,2017.0,60,35,25
FRA,PRT,2019.0,41,45,-4
NOR,DNK,2020.0,36,72,-36
URY,ESP,2022.0,5,8,-3
AUS,FRA,2019.0,103,100,3
UGA,CHN,2019.0,4,4,0
MNG,JPN,2019.0,10,24,-14
IND,FRA,2014.0,83,80,3
EGY,QAT,2015.0,13,9,4
ESP,MAC,2023.0,2,2,0
HKG,MYS,2019.0,10,8,2
FRA,MCO,2015.0,16,3,13
HRV,CAN,2009.0,3,1,2
ITA,SGP,2018.0,15,6,9
DEU,MEX,2019.0,41,51,-10
DEU,SVN,2020.0,11,15,-4
SAU,MYS,2017.0,30,103,-73
HUN,SVK,2022.0,12,8,4
KOR,PAK,2022.0,92,49,43
PAK,KOR,2023.0,54,50,4
DNK,NLD,2001.0,34,22,12
DEU,SYR,2020.0,3,4,-1
FRA,COL,2021.0,25,28,-3
TUR,BEL,2021.0,15,13,2
BFA,CAN,2018.0,4,2,2
SVK,CAN,2013.0,5,2,3
KOR,CHE,2021.0,19,23,-4
DNK,NZL,2023.0,6,6,0
CHE,ZAF,2017.0,12,24,-12
BEL,IRL,2019.0,15,19,-4
POL,DEU,2002.0,87,75,12
ZAF,AUS,2023.0,21,15,6
ZAF,DNK,1999.0,1,1,0
USA,SRB,2022.0,18,17,1
NLD,CHN,2011.0,52,78,-26
USA,ISL,2016.0,12,10,2
EGY,GBR,2017.0,50,61,-11
LKA,AUS,2020.0,34,31,3
USA,NOR,2013.0,90,83,7
NOR,SWE,2014.0,58,85,-27
KOR,IDN,2020.0,53,33,20
UKR,CZE,2021.0,11,7,4
LVA,GBR,2007.0,1,3,-2
KWT,SAU,2022.0,3,1,2
SDN,SSD,2021.0,20,3,17
IRL,FRA,2015.0,43,28,15
JPN,SGP,2011.0,46,19,27
KAZ,CHN,2022.0,4,8,-4
COD,USA,2021.0,4,8,-4
NLD,EGY,2003.0,4,2,2
TWN,GBR,2022.0,22,36,-14
ROU,ALB,2021.0,2,1,1
CHN,NZL,2019.0,36,48,-12
RUS,CHE,2014.0,25,12,13
DEU,NOR,2023.0,51,40,11
PAK,NGA,2022.0,7,1,6
HUN,IND,2021.0,5,7,-2
MEX,COL,2022.0,38,47,-9
RWA,KEN,2021.0,5,6,-1
MWI,DEU,2022.0,2,4,-2
CHN,POL,2021.0,24,10,14
CYP,GRC,2021.0,43,54,-11
UGA,NOR,2022.0,3,5,-2
GBR,NZL,2023.0,61,49,12
USA,UGA,2022.0,32,27,5
NOR,FRA,2021.0,37,47,-10
NLD,TUR,2022.0,14,34,-20
THA,BTN,2021.0,7,2,5
IDN,AUS,2018.0,38,104,-66
GBR,IND,2020.0,229,361,-132
KGZ,RUS,2020.0,4,5,-1
MYS,USA,2012.0,32,43,-11
KOR,PHL,2023.0,15,7,8
VNM,IND,2021.0,19,8,11
CHN,SAU,2021.0,56,56,0
AUT,CYP,2022.0,2,2,0
CHL,USA,2023.0,59,59,0
CHL,DEU,2016.0,38,40,-2
ISL,DNK,2011.0,7,5,2
USA,TZA,2021.0,21,23,-2
NLD,KOR,2022.0,13,13,0
DEU,BGR,2001.0,12,53,-41
USA,ARE,2021.0,103,70,33
MYS,GBR,2009.0,46,103,-57
GBR,CZE,2014.0,47,31,16
CHE,TUR,2023.0,4,16,-12
BGD,GBR,2023.0,21,11,10
NLD,AUS,2022.0,58,87,-29
KHM,USA,2022.0,6,6,0
CHE,AUT,2021.0,94,81,13
VEN,CAN,2006.0,9,1,8
ARE,EGY,2018.0,11,26,-15
BEL,SWE,2023.0,16,19,-3
GBR,OMN,2021.0,27,8,19
NGA,AUS,2014.0,5,1,4
NOR,RUS,2003.0,5,8,-3
CZE,BRA,2001.0,3,3,0
NGA,NER,1998.0,3,1,2
FIN,DEU,2005.0,19,30,-11
IDN,GBR,1999.0,3,8,-5
USA,JAM,2011.0,15,6,9
ITA,KOR,2012.0,9,7,2
FRA,UKR,2000.0,7,14,-7
OMN,ARE,2001.0,2,1,1
DEU,BEL,2004.0,55,68,-13
ARG,ESP,2004.0,92,59,33
KOR,RUS,2006.0,18,14,4
HRV,BIH,2013.0,12,5,7
KOR,UKR,2002.0,4,4,0
MEX,USA,1999.0,150,182,-32
AUS,SAU,2015.0,43,31,12
DNK,ISL,2011.0,5,7,-2
USA,SVN,2005.0,17,11,6
LKA,GBR,2000.0,7,10,-3
PRT,DEU,2013.0,43,32,11
ITA,ROU,2009.0,27,10,17
FRA,NOR,2007.0,26,16,10
GBR,ISR,2012.0,43,38,5
MEX,NLD,2007.0,2,14,-12
GBR,HRV,2015.0,9,15,-6
MAR,USA,2020.0,12,19,-7
NZL,NLD,2003.0,7,15,-8
BEL,GRC,2003.0,8,4,4
RUS,SRB,2005.0,8,8,0
CHN,UKR,2021.0,16,15,1
UKR,TUR,2016.0,2,2,0
ITA,HUN,1997.0,3,4,-1
ITA,HUN,2012.0,10,9,1
DEU,RUS,2019.0,108,156,-48
USA,GMB,2002.0,4,5,-1
THA,SGP,2000.0,1,2,-1
VEN,USA,2018.0,27,13,14
FIN,JPN,2010.0,14,15,-1
CAN,BRA,2002.0,37,43,-6
DNK,PRT,2017.0,15,14,1
JPN,POL,2008.0,14,17,-3
ITA,HUN,2002.0,13,13,0
JPN,NLD,2006.0,12,27,-15
ESP,POL,2010.0,15,20,-5
SWE,CAN,2004.0,30,27,3
FRA,MYS,2013.0,8,1,7
AUS,RUS,2006.0,7,12,-5
FRA,TWN,2018.0,16,8,8
CAN,KOR,2000.0,27,11,16
JPN,DNK,2003.0,14,5,9
DNK,JPN,2007.0,11,8,3
ESP,DZA,1999.0,1,1,0
TWN,RUS,2004.0,8,3,5
ISR,IND,2004.0,7,13,-6
NZL,DNK,2006.0,4,4,0
DNK,JPN,1999.0,9,6,3
SRB,MKD,2005.0,30,66,-36
AUS,THA,2011.0,31,17,14
CZE,ITA,2001.0,6,8,-2
POL,JPN,2019.0,11,12,-1
SRB,ESP,1999.0,5,1,4
BEL,LBN,2007.0,1,1,0
USA,SEN,2014.0,11,3,8
ITA,SWE,1999.0,23,28,-5
IND,JPN,2004.0,77,69,8
JPN,SWE,2014.0,28,34,-6
ZAF,IND,2001.0,7,5,2
SEN,USA,2000.0,5,1,4
BRN,GBR,1999.0,2,1,1
FRA,NCL,2009.0,12,20,-8
RUS,NOR,2011.0,14,10,4
ARG,AUS,2009.0,5,1,4
ARG,BRA,2020.0,36,45,-9
ARG,MEX,1999.0,7,2,5
THA,GBR,2013.0,45,77,-32
COL,BRA,2006.0,8,4,4
CAN,AUT,2009.0,16,19,-3
DEU,LIE,2005.0,3,3,0
ESP,AUS,2004.0,9,6,3
CIV,CHE,2001.0,2,2,0
ITA,AUS,2018.0,69,45,24
TUR,SAU,2014.0,8,5,3
GBR,SVK,1997.0,10,9,1
CAN,NZL,1997.0,25,13,12
VEN,ARG,1999.0,2,2,0
NPL,IND,2004.0,13,20,-7
MEX,DEU,2003.0,20,20,0
KOR,CZE,2001.0,1,1,0
BEL,CHE,2002.0,33,22,11
CHL,ESP,2002.0,35,31,4
NPL,USA,2004.0,7,6,1
SAU,SWE,1999.0,4,2,2
GBR,SGP,2004.0,41,40,1
ESP,UKR,2002.0,4,3,1
AUT,BEL,2001.0,5,7,-2
ROU,TWN,2001.0,1,2,-1
IRN,GBR,2013.0,50,44,6
ARE,USA,2001.0,7,16,-9
FRA,MTQ,2008.0,15,13,2
SRB,MKD,1997.0,5,3,2
AUT,HRV,2000.0,4,4,0
CHL,AUS,2013.0,23,7,16
EGY,CAN,2013.0,27,35,-8
GRC,ROU,2012.0,3,3,0
ROU,GRC,2013.0,2,2,0
GMB,GBR,2020.0,13,14,-1
ARG,COL,1999.0,4,2,2
HUN,USA,1999.0,93,65,28
FRA,NCL,2011.0,15,37,-22
SWE,CHE,2001.0,22,40,-18
MLI,SEN,1998.0,2,1,1
SEN,FRA,2005.0,27,29,-2
BLR,POL,2009.0,2,3,-1
HRV,SRB,2003.0,3,4,-1
BEL,JPN,2002.0,8,15,-7
DEU,LUX,2011.0,39,14,25
ARE,JOR,2021.0,21,32,-11
TUR,RUS,1997.0,1,5,-4
UKR,ISR,2001.0,10,1,9
SEN,USA,2010.0,6,6,0
NOR,DNK,1998.0,14,13,1
VEN,USA,2017.0,33,17,16
NZL,IND,2003.0,10,8,2
GBR,ZAF,1997.0,32,39,-7
CZE,GBR,2020.0,53,50,3
PRT,GBR,1997.0,15,24,-9
POL,RUS,2013.0,17,6,11
DEU,OMN,2005.0,2,1,1
OMN,EGY,2018.0,7,2,5
MEX,ITA,2013.0,9,15,-6
AUS,HUN,2003.0,4,2,2
HUN,FRA,2018.0,13,20,-7
GRC,CHE,1997.0,2,7,-5
GRC,CHE,2002.0,9,17,-8
NOR,CHE,2003.0,12,14,-2
IRL,FIN,2009.0,4,5,-1
HRV,FRA,2015.0,6,6,0
AUT,BEL,2004.0,6,6,0
ISR,RUS,2002.0,8,20,-12
PNG,USA,2006.0,2,1,1
GBR,NGA,2001.0,19,19,0
SEN,FRA,2002.0,28,37,-9
AUS,CHE,2010.0,49,66,-17
GBR,RUS,2012.0,48,45,3
TUR,ROU,2005.0,3,1,2
AUS,MYS,2001.0,8,13,-5
AUS,MYS,2004.0,16,8,8
CUB,USA,2007.0,9,5,4
USA,CUB,2008.0,14,6,8
FRA,SWE,1998.0,39,29,10
FRA,SEN,1998.0,16,18,-2
UZB,KAZ,2017.0,4,1,3
BLR,RUS,2013.0,25,24,1
BGR,DEU,2003.0,33,24,9
CHE,BGR,2001.0,4,4,0
ITA,RUS,2011.0,10,23,-13
ITA,IRL,2014.0,23,20,3
NLD,BEN,2006.0,2,2,0
AUT,MAR,2009.0,1,1,0
NLD,AUT,1997.0,8,6,2
NGA,USA,2014.0,51,39,12
USA,BGD,2014.0,23,63,-40
ARG,CAN,2004.0,18,16,2
CHN,ESP,1997.0,8,1,7
ITA,BRA,1998.0,19,10,9
EGY,SWE,2012.0,4,7,-3
UKR,RUS,2009.0,57,33,24
GBR,ROU,2016.0,19,18,1
DEU,HUN,2019.0,34,47,-13
GRC,ARE,2018.0,10,2,8
ARE,GRC,2020.0,5,5,0
USA,MOZ,2018.0,9,7,2
ESP,AUT,2003.0,12,12,0
AUS,ESP,2011.0,21,32,-11
MEX,FRA,2001.0,22,37,-15
GRL,DNK,2006.0,6,5,1
SAU,TUR,2019.0,11,8,3
CHN,CHE,2001.0,13,15,-2
CHE,CHN,2006.0,22,16,6
NOR,ZAF,2007.0,2,1,1
HKG,IND,2008.0,3,4,-1
RUS,GRC,1997.0,1,2,-1
QAT,GBR,2018.0,29,53,-24
FRA,CHN,2001.0,34,32,2
AUT,HUN,2011.0,16,17,-1
HUN,DNK,2016.0,16,2,14
MEX,IND,2006.0,3,6,-3
TZA,ESP,2002.0,1,1,0
BEL,ITA,2015.0,77,97,-20
NOR,GBR,1997.0,15,23,-8
AUS,ARG,2007.0,17,10,7
RUS,UZB,2002.0,18,6,12
HKG,IND,2014.0,7,8,-1
RUS,AZE,2012.0,9,1,8
JPN,PHL,2003.0,21,11,10
CAN,BRA,2005.0,29,41,-12
NLD,ITA,1997.0,38,30,8
CZE,SVK,2007.0,22,39,-17
ESP,IRL,2002.0,9,6,3
ISL,DNK,2009.0,3,3,0
ARG,ESP,2001.0,75,62,13
NLD,DNK,1998.0,18,10,8
USA,KWT,2007.0,7,8,-1
CZE,SVK,1999.0,14,13,1
IRN,USA,2002.0,19,32,-13
BEL,ITA,2008.0,41,50,-9
USA,BGD,2008.0,17,28,-11
GBR,POL,2015.0,47,68,-21
GBR,HRV,2001.0,4,1,3
NOR,ITA,2008.0,7,12,-5
BGR,FRA,1997.0,11,4,7
SRB,MKD,2002.0,25,14,11
ARG,CHL,2001.0,7,8,-1
KOR,ESP,2013.0,3,4,-1
DEU,TWN,2014.0,23,28,-5
SWE,AUS,2002.0,30,37,-7
GBR,KWT,1998.0,8,6,2
JPN,SWE,2001.0,43,45,-2
POL,CHN,2006.0,2,1,1
SWE,CAN,2015.0,43,45,-2
GIB,GBR,2017.0,4,1,3
USA,MWI,2021.0,11,24,-13
DEU,GAB,2005.0,5,1,4
GAB,DEU,2010.0,5,2,3
RUS,TUR,2015.0,4,4,0
SVK,DEU,2011.0,13,13,0
HRV,BIH,2003.0,18,1,17
AUS,JPN,2011.0,62,81,-19
BEL,RUS,2022.0,10,14,-4
ZAF,USA,2007.0,61,68,-7
DEU,SVK,2002.0,18,26,-8
NLD,LUX,1997.0,1,1,0
GTM,USA,2000.0,10,5,5
GBR,HUN,2001.0,33,16,17
SWE,UKR,2005.0,3,7,-4
CHE,LVA,2014.0,1,3,-2
GBR,IRQ,2011.0,8,4,4
POL,NLD,1997.0,7,7,0
CHN,ZAF,2015.0,8,6,2
UKR,SWE,2002.0,9,2,7
JPN,IND,1997.0,21,44,-23
GBR,CZE,2015.0,53,38,15
IND,SWE,1998.0,9,5,4
USA,EGY,1997.0,46,37,9
AUS,CHE,2000.0,32,32,0
LIE,AUT,2019.0,2,4,-2
NLD,DNK,1999.0,21,10,11
CAN,SAU,1997.0,16,11,5
DNK,ESP,2020.0,40,48,-8
FRA,ARE,2013.0,5,4,1
PAK,ARE,2021.0,29,10,19
GBR,ZAF,2012.0,124,85,39
ZWE,KEN,2022.0,4,1,3
CHL,ESP,2012.0,47,84,-37
NOR,USA,2011.0,72,100,-28
TWN,ESP,2018.0,8,6,2
CAN,NOR,2014.0,19,16,3
JOR,SAU,2010.0,34,7,27
JOR,USA,2014.0,34,49,-15
MYS,SAU,2012.0,35,6,29
FIN,IND,2020.0,17,26,-9
NLD,ETH,2021.0,12,6,6
DNK,POL,2019.0,10,10,0
IND,AUS,2017.0,145,71,74
POL,AUS,2019.0,8,5,3
GBR,ROU,2018.0,22,23,-1
YEM,EGY,2016.0,4,5,-1
POL,CHE,2014.0,17,15,2
,MAC,2015.0,238,0,238
KAZ,,2019.0,538,0,538
,LUX,2015.0,133,0,133
FIN,,2026.0,208,0,208
COL,,2026.0,160,0,160
,SEN,2013.0,185,0,185
,PRI,2014.0,131,0,131
PRI,COL,2017.0,3,0,3
,LTU,2014.0,597,0,597
LUX,,2020.0,119,0,119
NOR,PER,2023.0,2,0,2
GBR,LBR,2013.0,2,0,2
,BOL,2000.0,28,0,28
,COL,2008.0,1572,0,1572
,RWA,2015.0,83,0,83
BGR,,2002.0,253,0,253
,NGA,2010.0,1666,0,1666
,BGD,2007.0,628,0,628
,BGR,2013.0,544,0,544
,NPL,2014.0,411,0,411
,DNK,2020.0,1612,0,1612
,UKR,2018.0,4999,0,4999
,SYR,2013.0,130,0,130
,CYP,2016.0,295,0,295
,ARE,2014.0,460,0,460
CRI,ZAF,2018.0,1,0,1
ETH,,2021.0,483,0,483
,SRB,2012.0,1305,0,1305
,IRQ,2018.0,3678,0,3678
,HTI,2014.0,34,0,34
DNK,GEO,1997.0,1,0,1
,GRC,2018.0,2649,0,2649
,CHL,2013.0,2293,0,2293
,NPL,2015.0,445,0,445
FJI,,2012.0,14,0,14
NPL,AUT,2016.0,2,0,2
CHN,CRI,2018.0,1,0,1
KAZ,AUT,2020.0,2,0,2
,NER,2015.0,40,0,40
MAC,,2021.0,94,0,94
BFA,,2009.0,17,0,17
,BGD,2020.0,1407,0,1407
,HTI,2015.0,41,0,41
PAN,,2024.0,259,0,259
TCD,,2025.0,58,0,58
NGA,,2026.0,134,0,134
ZMB,MWI,2019.0,6,0,6
ETH,,2011.0,57,0,57
BEL,BOL,2017.0,3,0,3
,BRN,2019.0,57,0,57
,OMN,2014.0,223,0,223
MDA,,2020.0,66,0,66
COD,,2020.0,47,0,47
,OMN,2015.0,180,0,180
,TTO,2016.0,60,0,60
,FJI,2017.0,49,0,49
,PER,2020.0,1159,0,1159
,KGZ,2015.0,69,0,69
,ZWE,2017.0,187,0,187
,MTQ,2018.0,8,0,8
,ZWE,2016.0,172,0,172
,ZWE,2018.0,182,0,182
,KGZ,2014.0,72,0,72
,SAU,2005.0,467,0,467
,NPL,2004.0,187,0,187
ZWE,UGA,2020.0,1,0,1
,IRQ,2017.0,4478,0,4478
,MDV,2015.0,5,0,5
MDV,,2022.0,9,0,9
NCL,GBR,2017.0,1,0,1
CHE,BGD,2021.0,5,0,5
,TUR,2019.0,8234,0,8234
,LUX,2014.0,138,0,138
,UGA,2007.0,224,0,224
BWA,CHN,2019.0,1,0,1
MAC,PHL,2020.0,3,0,3
GTM,,2022.0,73,0,73
,JOR,2010.0,464,0,464
RWA,NZL,2020.0,2,0,2
,ROU,2011.0,2370,0,2370
SRB,,2026.0,113,0,113
,ROU,2019.0,2055,0,2055
,RWA,2014.0,99,0,99
,CMR,2018.0,591,0,591
,AZE,2019.0,210,0,210
,GMB,2018.0,44,0,44
,ECU,2019.0,855,0,855
,MOZ,2018.0,96,0,96
,TCD,2018.0,9,0,9
,PAN,2018.0,88,0,88
,QAT,2020.0,351,0,351
MOZ,FIN,2023.0,2,0,2
ALB,,2023.0,208,0,208
,TTO,2018.0,60,0,60
,UZB,2019.0,284,0,284
,EST,2019.0,280,0,280
COD,FRA,2011.0,1,0,1
,GRD,2018.0,31,0,31
THA,ARE,2004.0,1,0,1
,URY,2019.0,193,0,193
TGO,,2023.0,90,0,90
,TZA,2019.0,354,0,354
VNM,,2026.0,220,0,220
,BLZ,2018.0,15,0,15
SAU,SYR,2021.0,5,0,5
,CYP,2017.0,259,0,259
,KAZ,2008.0,124,0,124
,BLR,2007.0,234,0,234
,THA,2010.0,2548,0,2548
CMR,BWA,2022.0,1,0,1
,TJK,2018.0,53,0,53
ETH,NAM,2021.0,1,0,1
MYS,BRA,2022.0,2,0,2
CHE,MDG,2022.0,1,0,1
MDG,CHE,2023.0,1,0,1
,SUR,2018.0,13,0,13
BOL,,2023.0,123,0,123
,LSO,2017.0,27,0,27
,LSO,2018.0,18,0,18
PRY,CAN,2021.0,1,0,1
,DEU,2021.0,58,0,58
,VNM,2006.0,379,0,379
,GAB,2018.0,31,0,31
VNM,,2017.0,296,0,296
PRT,EGY,2016.0,1,0,1
,UZB,1994.0,422,0,422
,LBN,1995.0,160,0,160
GAB,NER,2016.0,1,0,1
SRB,SWE,2000.0,9,0,9
VEN,,2006.0,191,0,191
UKR,CHE,2003.0,5,0,5
,BFA,1994.0,90,0,90
ARG,,2006.0,650,0,650
COL,,2016.0,715,0,715
TWN,CZE,2009.0,2,0,2
,OMN,1996.0,73,0,73
MAR,,2004.0,153,0,153
VNM,RUS,1998.0,2,0,2
TZA,IND,2004.0,2,0,2
,GEO,2010.0,167,0,167
ZWE,NOR,2002.0,2,0,2
OMN,,2000.0,13,0,13
KWT,PAK,2004.0,1,0,1
PAK,KWT,2006.0,1,0,1
BGR,CAN,2003.0,10,0,10
,BTN,1994.0,1,0,1
BGR,,2005.0,194,0,194
,TZA,1994.0,185,0,185
KEN,COM,2005.0,1,0,1
,NPL,1996.0,70,0,70
,ISL,1998.0,100,0,100
BLR,,2001.0,109,0,109
,MMR,1996.0,13,0,13
CHL,PHL,2017.0,4,0,4
PRT,,2005.0,321,0,321
AFG,SRB,2005.0,1,0,1
SOM,ZWE,2013.0,1,0,1
EST,CHE,2007.0,1,0,1
BLR,,2004.0,183,0,183
,MKD,1997.0,55,0,55
AZE,ISR,2013.0,1,0,1
CHN,QAT,2011.0,3,0,3
BLR,ARM,2015.0,1,0,1
DEU,GTM,2021.0,4,0,4
ROU,CHE,2000.0,5,0,5
IRL,,1999.0,123,0,123
GRC,KOR,2008.0,2,0,2
QAT,,2006.0,19,0,19
LBN,ESP,1999.0,1,0,1
ESP,LBN,2001.0,5,0,5
RUS,VNM,2003.0,2,0,2
NLD,SVN,2004.0,3,0,3
DEU,ECU,2001.0,1,0,1
KEN,,1999.0,27,0,27
CAF,FRA,1997.0,2,0,2
GBR,BRN,2009.0,4,0,4
SGP,,2004.0,452,0,452
MDG,,1999.0,3,0,3
PSE,ARE,2006.0,2,0,2
HKG,POL,2006.0,2,0,2
,ARE,2001.0,128,0,128
RUS,SGP,2001.0,8,0,8
,MLT,2012.0,92,0,92
BIH,,2012.0,73,0,73
ISR,IRL,1998.0,2,0,2
TGO,,2010.0,7,0,7
TUR,SVN,1998.0,1,0,1
KWT,,2002.0,62,0,62
ARE,CHL,2013.0,1,0,1
CHL,BWA,2019.0,1,0,1
GBR,CMR,2004.0,6,0,6
KWT,,2005.0,57,0,57
,GTM,1998.0,10,0,10
ECU,BOL,1998.0,1,0,1
PRT,HRV,2018.0,1,0,1
,MAC,2014.0,169,0,169
MAC,,2019.0,84,0,84
NZL,LUX,2014.0,2,0,2
MYS,BRA,2018.0,2,0,2
,GHA,2012.0,452,0,452
,PSE,2013.0,73,0,73
,KHM,2013.0,76,0,76
KHM,,2018.0,70,0,70
UGA,CHE,2001.0,3,0,3
,AGO,2013.0,16,0,16
,NIC,2013.0,20,0,20
,GUY,2010.0,10,0,10
RUS,IRQ,2013.0,1,0,1
,ALB,2010.0,126,0,126
CHE,PYF,2019.0,1,0,1
PYF,,2023.0,41,0,41
NER,,2023.0,64,0,64
AFG,,2021.0,36,0,36
NER,,2024.0,145,0,145
COG,,2019.0,84,0,84
ZWE,,2002.0,43,0,43
URY,SAU,2003.0,1,0,1
,SLE,2012.0,40,0,40
,CRI,2011.0,127,0,127
WSM,,2021.0,14,0,14
DEU,GTM,2019.0,3,0,3
,REU,2012.0,7,0,7
SYR,,2020.0,99,0,99
BEL,ECU,2017.0,8,0,8
,BFA,2011.0,132,0,132
BRB,IRL,2017.0,1,0,1
,NCL,2012.0,24,0,24
IRQ,,2004.0,11,0,11
BRN,CAN,2020.0,2,0,2
GTM,BRA,2012.0,1,0,1
MMR,,2019.0,45,0,45
LBY,HUN,2016.0,1,0,1
BGR,TUR,2008.0,3,0,3
GIN,,2019.0,16,0,16
DZA,ALB,2018.0,1,0,1
,BOL,2010.0,47,0,47
SAU,OMN,1999.0,6,0,6
BRA,OMN,2002.0,1,0,1
JPN,ZWE,2019.0,1,0,1
,EST,2009.0,373,0,373
,AFG,2013.0,11,0,11
CIV,MWI,1998.0,1,0,1
SGP,SAU,2011.0,13,0,13
UZB,,2019.0,83,0,83
UZB,,2021.0,110,0,110
ISR,CHE,2006.0,12,0,12
,CMR,2016.0,523,0,523
NZL,BGR,2021.0,1,0,1
,DOM,2013.0,30,0,30
,NPL,2008.0,240,0,240
,TJK,2016.0,36,0,36
,LSO,2016.0,12,0,12
MAC,IRL,2000.0,1,0,1
TLS,,2025.0,45,0,45
,GAB,2017.0,45,0,45
CHE,MMR,2022.0,2,0,2
,LBY,2016.0,51,0,51
,GAB,2016.0,47,0,47
,MOZ,2016.0,100,0,100
SLE,,2021.0,44,0,44
GRC,CZE,2017.0,10,0,10
SOM,,2025.0,174,0,174
,LAO,2016.0,56,0,56
,FJI,2016.0,40,0,40
,SUR,2016.0,6,0,6
,GRD,2016.0,19,0,19
JPN,SVK,2023.0,1,0,1
PRT,,2002.0,209,0,209
MMR,,2021.0,65,0,65
CHE,KGZ,2023.0,2,0,2
LAO,,2022.0,61,0,61
,MKD,2012.0,215,0,215
ERI,,2021.0,8,0,8
ERI,,2025.0,42,0,42
GIN,,2021.0,18,0,18
ZAF,SLE,2019.0,1,0,1
SLE,NOR,2021.0,1,0,1
ESP,PSE,2020.0,3,0,3
,GMB,2016.0,26,0,26
POL,CHN,2008.0,3,0,3
MLT,CAN,2023.0,4,0,4
,TGO,2010.0,41,0,41
CHN,NPL,2014.0,5,0,5
VUT,AUS,2016.0,2,0,2
NOR,IRQ,2016.0,1,0,1
ITA,FJI,2022.0,1,0,1
CUB,,2004.0,321,0,321
LBN,SDN,2021.0,1,0,1
BIH,SGP,2014.0,1,0,1
SGP,BIH,2015.0,1,0,1
MNE,,2013.0,8,0,8
,BDI,2013.0,10,0,10
BDI,,2024.0,52,0,52
DNK,AZE,2023.0,1,0,1
BMU,USA,2019.0,2,0,2
GBR,SOM,2016.0,1,0,1
LBN,,2012.0,104,0,104
REU,,2023.0,13,0,13
,PAN,2016.0,72,0,72
,LKA,2020.0,333,0,333
,CRI,2019.0,184,0,184
PRT,AUS,2002.0,2,0,2
,BRB,2018.0,11,0,11
AFG,,2025.0,202,0,202
HKG,ISR,2000.0,2,0,2
,PRK,2019.0,112,0,112
SDN,AFG,2021.0,1,0,1
NAM,UGA,2021.0,2,0,2
FRA,ISL,2022.0,6,0,6
,ISL,2020.0,72,0,72
,BIH,2019.0,224,0,224
,BFA,2019.0,142,0,142
,KEN,2010.0,467,0,467
POL,ROU,2022.0,2,0,2
,LBY,2017.0,46,0,46
WSM,,2025.0,42,0,42
VCT,,2025.0,5,0,5
IND,BHS,2019.0,2,0,2
,UZB,2011.0,149,0,149
SYC,,2024.0,37,0,37
QAT,BHR,2018.0,1,0,1
,GTM,1999.0,7,0,7
MOZ,NLD,2001.0,1,0,1
LKA,SGP,1998.0,1,0,1
,MAC,2001.0,16,0,16
ISL,ISR,2014.0,3,0,3
MYS,SDN,2003.0,1,0,1
BHR,GBR,1997.0,1,0,1
GMB,ITA,2010.0,1,0,1
BOL,,2006.0,13,0,13
CZE,KEN,1997.0,1,0,1
KEN,CZE,1998.0,1,0,1
BRA,ISL,2009.0,1,0,1
LBN,,2005.0,36,0,36
,MRT,1995.0,5,0,5
BLR,EST,2013.0,1,0,1
JAM,,2006.0,15,0,15
,ECU,1994.0,72,0,72
TGO,BEN,1997.0,1,0,1
NLD,AND,1999.0,2,0,2
JOR,,2004.0,52,0,52
SVK,AZE,2009.0,3,0,3
,LKA,1999.0,85,0,85
SVN,,1999.0,34,0,34
HKG,IRL,2001.0,1,0,1
BLR,NZL,1999.0,1,0,1
FRA,TTO,1997.0,1,0,1
,MLI,1995.0,37,0,37
DJI,,2023.0,7,0,7
AND,,2022.0,3,0,3
EGY,VEN,2002.0,1,0,1
,COG,1995.0,21,0,21
NPL,,2003.0,17,0,17
LUX,RWA,2003.0,2,0,2
USA,VNM,1998.0,4,0,4
FRA,BDI,2009.0,1,0,1
BHR,SDN,2013.0,3,0,3
PAK,,2000.0,94,0,94
CRI,,2015.0,54,0,54
ZAF,MDG,2006.0,1,0,1
SRB,HKG,1998.0,2,0,2
LVA,,2002.0,46,0,46
TWN,MYS,2002.0,1,0,1
KAZ,USA,1997.0,1,0,1
JOR,,2001.0,33,0,33
CRI,,2008.0,41,0,41
SWE,IRN,2002.0,7,0,7
CZE,PRT,2000.0,1,0,1
,BIH,1994.0,40,0,40
ARE,SRB,2013.0,2,0,2
MNE,DEU,2011.0,1,0,1
AUS,WSM,2012.0,2,0,2
,BIH,2009.0,238,0,238
,MDG,2000.0,28,0,28
CUB,SWE,2018.0,2,0,2
,NAM,1995.0,21,0,21
JPN,KHM,2000.0,4,0,4
OMN,,2006.0,22,0,22
GMB,IRL,2009.0,1,0,1
,LTU,2008.0,560,0,560
,PRI,2008.0,184,0,184
,URY,2009.0,246,0,246
,BMU,2002.0,4,0,4
,PHL,2006.0,276,0,276
MWI,,2026.0,1,0,1
,CIV,2008.0,129,0,129
,LUX,2008.0,102,0,102
,GHA,2005.0,140,0,140
COL,NGA,2015.0,2,0,2
AND,,2018.0,4,0,4
,MUS,2007.0,34,0,34
,KGZ,2008.0,22,0,22
,TZA,2009.0,214,0,214
PRI,,2018.0,123,0,123
,NER,2008.0,33,0,33
,VUT,2008.0,9,0,9
,ECU,2009.0,84,0,84
,MNE,2006.0,40,0,40
LKA,AFG,2016.0,1,0,1
BEN,,2013.0,17,0,17
MWI,,2017.0,39,0,39
IDN,ZAF,2016.0,1,0,1
THA,COD,2009.0,1,0,1
,ZMB,2005.0,51,0,51
,PER,2007.0,340,0,340
,TZA,2011.0,211,0,211
,LKA,2007.0,202,0,202
GAB,GBR,2018.0,1,0,1
ITA,COL,2019.0,15,6,9
FRA,GBR,2022.0,321,493,-172
GBR,DNK,2023.0,86,66,20
DEU,RUS,2014.0,127,123,4
GBR,EGY,2022.0,73,77,-4
ESP,GBR,2022.0,312,447,-135
BRA,PER,2004.0,9,3,6
NLD,CHN,2004.0,24,18,6
KOR,PAK,2020.0,104,52,52
IND,NPL,2018.0,33,22,11
CHN,CAN,2022.0,325,506,-181
PAK,AUT,2019.0,2,5,-3
AUS,USA,2020.0,725,623,102
CHN,KOR,2023.0,154,185,-31
FIN,SWE,2019.0,85,58,27
BEL,AUT,2020.0,21,20,1
ARE,USA,2021.0,70,103,-33
BEL,CHN,2020.0,101,83,18
DNK,SWE,2022.0,99,86,13
DEU,CHN,2021.0,620,506,114
USA,BGR,2021.0,13,5,8
AUT,USA,2019.0,136,125,11
IND,POL,2021.0,41,22,19
GBR,JPN,2018.0,158,131,27
GBR,IND,2022.0,225,325,-100
VNM,JPN,2022.0,34,79,-45
PAK,USA,2018.0,125,103,22
NGA,AUS,2021.0,10,8,2
COG,COD,2016.0,79,21,58
CHN,DEU,2018.0,467,460,7
LKA,DEU,2019.0,6,3,3
IND,SAU,2017.0,156,67,89
USA,GUM,2004.0,6,7,-1
IND,DNK,2017.0,28,10,18
DNK,SWE,2018.0,116,97,19
BEL,ITA,2021.0,106,116,-10
IRN,ETH,2019.0,2,3,-1
ETH,IRN,2020.0,4,10,-6
JPN,FIN,2015.0,15,11,4
JOR,TUR,2018.0,4,1,3
AUS,CHL,2023.0,7,5,2
MYS,NGA,2017.0,104,37,67
TWN,TUR,2023.0,5,1,4
MEX,USA,2022.0,372,252,120
MYS,CAN,2020.0,32,13,19
TWN,USA,2023.0,154,105,49
KOR,USA,2022.0,731,728,3
BOL,DEU,2015.0,3,1,2
RUS,CHE,2019.0,29,22,7
AUS,SAU,2021.0,93,26,67
FRA,MEX,2017.0,64,45,19
CHN,CHE,2021.0,93,99,-6
IND,ZAF,2021.0,31,45,-14
CHN,SWE,2020.0,123,124,-1
IND,ETH,2014.0,31,5,26
LBN,USA,2020.0,107,78,29
IRL,FRA,2021.0,43,40,3
KOR,ITA,2019.0,11,9,2
CHN,IRQ,2018.0,30,2,28
IDN,TWN,2020.0,58,45,13
CHN,DEU,2017.0,387,404,-17
TWN,IDN,2022.0,68,46,22
USA,IRQ,2019.0,68,28,40
AUS,SAU,2011.0,20,4,16
SWE,NOR,2020.0,82,73,9
IDN,KOR,2018.0,11,38,-27
CHN,JPN,2022.0,364,594,-230
USA,NOR,2000.0,71,76,-5
CHN,IRQ,2017.0,13,4,9
CHN,NOR,2022.0,32,31,1
PAK,AUS,2017.0,34,23,11
USA,CHE,1997.0,291,284,7
NOR,SWE,2021.0,84,90,-6
FRA,EGY,2017.0,19,16,3
ITA,TWN,2022.0,3,5,-2
SGP,QAT,2022.0,3,2,1
BGD,SWE,2009.0,3,2,1
HUN,SVK,2020.0,9,9,0
ROU,HUN,2021.0,18,13,5
HKG,USA,2020.0,182,159,23
DEU,BRA,2017.0,114,110,4
VNM,JPN,2016.0,26,72,-46
AUS,LBN,2020.0,5,5,0
EGY,FIN,2019.0,3,3,0
GBR,ARE,2022.0,75,37,38
ESP,MEX,1997.0,35,33,2
CAN,ARG,2018.0,22,13,9
MYS,IDN,2015.0,80,14,66
ISR,IND,2021.0,72,152,-80
IRN,AUS,2021.0,177,41,136
GBR,SGP,2019.0,128,111,17
NLD,DEU,2016.0,334,281,53
USA,BIH,2018.0,10,2,8
CZE,CHL,2017.0,5,2,3
PAK,GBR,2019.0,80,90,-10
IRN,SWE,2021.0,69,19,50
TUN,FRA,2022.0,87,59,28
VNM,AUS,2016.0,36,37,-1
IND,SWE,2016.0,66,40,26
IRN,ITA,2015.0,39,15,24
AUS,FRA,2004.0,30,38,-8
NLD,IDN,2018.0,47,29,18
GBR,TWN,2020.0,41,34,7
RUS,USA,2023.0,110,47,63
JPN,CHE,1998.0,15,25,-10
ITA,DNK,2019.0,62,38,24
CHN,DEU,2016.0,393,361,32
BRA,DEU,2019.0,150,91,59
BGD,USA,2020.0,153,72,81
SWE,ITA,2017.0,46,93,-47
IND,FRA,2019.0,85,69,16
JOR,USA,2019.0,41,68,-27
POL,BEL,2021.0,6,13,-7
FRA,SEN,2018.0,54,25,29
DEU,SWZ,2019.0,1,1,0
THA,JPN,2023.0,44,38,6
GBR,GHA,2019.0,31,21,10
ITA,ESP,2018.0,244,197,47
USA,DNK,2019.0,163,161,2
DEU,IDN,2020.0,35,12,23
FRA,NOR,2018.0,46,34,12
DNK,RUS,2020.0,9,7,2
USA,AUT,2022.0,129,118,11
IND,SAU,2022.0,85,87,-2
ISR,SWE,2010.0,4,3,1
USA,IRQ,2021.0,72,25,47
ESP,AUS,2019.0,55,38,17
PRT,CHE,2022.0,19,12,7
JOR,MYS,2019.0,12,28,-16
TUN,SAU,2016.0,89,32,57
ESP,USA,1998.0,284,252,32
ITA,CHL,1997.0,2,2,0
MYS,NGA,2018.0,100,48,52
IRN,KOR,2022.0,42,8,34
CHE,NOR,2011.0,8,13,-5
CHN,ITA,2020.0,66,87,-21
JPN,SWE,2019.0,31,26,5
CHL,GBR,2019.0,59,55,4
CAN,EGY,2018.0,64,38,26
IND,NOR,2023.0,20,16,4
KOR,FRA,2022.0,19,35,-16
KOR,SWE,2021.0,23,9,14
SWE,JPN,2012.0,25,34,-9
ESP,CHE,2020.0,132,97,35
MEX,USA,2018.0,277,352,-75
IDN,FRA,2020.0,9,17,-8
IND,KOR,2020.0,247,182,65
ITA,GBR,2023.0,200,313,-113
IDN,JPN,2020.0,102,261,-159
IRL,USA,2021.0,149,153,-4
USA,KWT,2022.0,22,15,7
FRA,MTQ,2019.0,30,26,4
ZAF,KEN,2019.0,29,26,3
ITA,ISR,2023.0,12,12,0
VNM,ARE,2021.0,3,1,2
GBR,BRA,2019.0,125,144,-19
CHE,GBR,2001.0,139,138,1
USA,NLD,2023.0,229,217,12
JPN,ITA,1997.0,28,16,12
GHA,SWE,2021.0,1,2,-1
ECU,NLD,2018.0,2,4,-2
JPN,EGY,2016.0,67,45,22
TTO,GBR,2021.0,7,6,1
DEU,HKG,2020.0,15,23,-8
HKG,GHA,2020.0,3,3,0
SYR,USA,2017.0,4,1,3
IRN,IRQ,2018.0,22,13,9
IRQ,GBR,2019.0,29,175,-146
PAK,USA,2022.0,185,81,104
JPN,TWN,2013.0,33,30,3
JPN,THA,2023.0,38,44,-6
USA,QAT,2019.0,57,55,2
AUS,TWN,2019.0,16,21,-5
AUT,ESP,2018.0,26,42,-16
CHN,DNK,2020.0,124,95,29
PRT,NLD,2005.0,6,12,-6
ZWE,CAN,2019.0,3,1,2
PHL,NZL,2019.0,6,2,4
CHN,CHE,2019.0,87,76,11
HUN,USA,2017.0,76,54,22
CHE,NZL,2016.0,12,16,-4
PAK,HKG,2022.0,7,7,0
ZAF,GBR,2003.0,75,74,1
CAN,NGA,2018.0,11,17,-6
SRB,ITA,2006.0,16,10,6
EGY,USA,2019.0,132,170,-38
LTU,DNK,2015.0,2,2,0
ESP,ARG,2023.0,27,61,-34
PAK,AUS,2016.0,42,27,15
CHN,JPN,2017.0,379,546,-167
ESP,DZA,2022.0,7,5,2
URY,JPN,1998.0,1,1,0
NGA,MYS,2013.0,23,21,2
SRB,FRA,2012.0,8,5,3
MYS,IRQ,2022.0,99,41,58
GRC,SWE,2020.0,34,15,19
BEL,DEU,2017.0,132,131,1
KEN,GHA,2021.0,11,2,9
KAZ,RUS,2018.0,49,45,4
NGA,CHN,2020.0,41,25,16
DEU,FIN,2020.0,61,60,1
ITA,BRA,2022.0,45,68,-23
EGY,USA,2021.0,143,173,-30
SWE,DNK,2018.0,97,116,-19
IRN,SWE,2019.0,75,21,54
RUS,NLD,2020.0,29,12,17
ZAF,RWA,2020.0,5,5,0
NZL,PHL,2018.0,4,4,0
ITA,FRA,2022.0,294,281,13
GBR,NGA,2019.0,114,74,40
CHN,ISR,2016.0,16,12,4
EGY,YEM,2021.0,9,4,5
MEX,NLD,2018.0,17,13,4
BRN,GBR,2016.0,3,9,-6
ITA,BRA,2017.0,65,60,5
ESP,NOR,2018.0,28,12,16
BIH,DEU,2019.0,2,1,1
ISR,NLD,2023.0,11,10,1
NLD,IND,2021.0,40,57,-17
GRC,TUR,2018.0,7,9,-2
USA,ZMB,2022.0,11,12,-1
BGD,MYS,2021.0,23,61,-38
DEU,TWN,2021.0,24,31,-7
CZE,GBR,2018.0,41,55,-14
GBR,EGY,2018.0,57,54,3
HUN,GBR,2022.0,31,21,10
MYS,JOR,2021.0,44,9,35
JPN,ESP,2017.0,15,25,-10
SWE,MYS,2020.0,5,9,-4
TWN,IDN,2018.0,48,19,29
MYS,TWN,2016.0,7,9,-2
NLD,SAU,2020.0,15,8,7
CHL,CHN,2020.0,10,5,5
ISR,CHE,2021.0,18,16,2
CAN,ARE,2019.0,35,28,7
CAN,THA,2021.0,20,13,7
VNM,DEU,2018.0,11,34,-23
DEU,VNM,2019.0,31,9,22
IDN,AUS,2020.0,59,98,-39
ESP,BGR,2007.0,4,3,1
COD,COG,2019.0,53,187,-134
JPN,PAK,2022.0,10,6,4
SWE,CHE,2019.0,66,56,10
AUS,MYS,2021.0,59,65,-6
FIN,IRN,2021.0,6,50,-44
DNK,NOR,2022.0,48,40,8
VNM,DNK,2022.0,3,1,2
USA,NOR,2023.0,63,51,12
CHN,BEL,2023.0,59,66,-7
ESP,IRN,2021.0,17,53,-36
GBR,HKG,2022.0,73,86,-13
KOR,SGP,2019.0,34,29,5
USA,VEN,2021.0,10,18,-8
BGD,CHN,2022.0,33,68,-35
NLD,CHN,2015.0,120,106,14
DNK,FIN,2021.0,15,22,-7
ITA,IRN,2022.0,19,105,-86
MLT,GBR,2022.0,17,9,8
AFG,USA,2023.0,5,2,3
ETH,KOR,2022.0,5,8,-3
GBR,NGA,2021.0,85,104,-19
NOR,IRN,2023.0,8,10,-2
DZA,ESP,2021.0,8,18,-10
CHN,SDN,2023.0,6,1,5
BGR,DEU,2023.0,3,4,-1
PAK,MYS,2020.0,63,161,-98
PRT,BRA,2019.0,141,196,-55
LVA,UKR,2022.0,1,5,-4
MYS,EGY,2022.0,8,7,1
MYS,KOR,2020.0,15,15,0
BHR,IND,2021.0,8,9,-1
UGA,ZAF,2022.0,9,12,-3
IRN,IRL,2023.0,11,7,4
DEU,PAK,2021.0,38,36,2
DEU,AUS,2000.0,83,71,12
SGP,DEU,2022.0,34,24,10
PAK,GBR,2021.0,112,96,16
BEL,RWA,2022.0,5,1,4
THA,USA,2023.0,92,70,22
RUS,DNK,2008.0,3,7,-4
CHN,IRN,2022.0,31,46,-15
CZE,SWE,2023.0,9,7,2
IND,PAK,2021.0,49,46,3
MAR,FRA,2022.0,82,65,17
CZE,GBR,2022.0,44,54,-10
GBR,QAT,2022.0,30,20,10
ESP,TUN,2021.0,7,5,2
CHE,CAN,2015.0,92,101,-9
TWN,IND,2023.0,37,60,-23
ECU,VEN,2020.0,17,30,-13
USA,PRI,2022.0,209,131,78
GIB,GBR,2020.0,2,2,0
ETH,BEL,2023.0,14,10,4
JPN,PHL,2023.0,15,12,3
AUS,THA,2004.0,26,10,16
NZL,CHE,2018.0,20,12,8
NLD,ESP,2022.0,73,86,-13
ITA,IRL,2021.0,42,37,5
ESP,BRA,2023.0,35,78,-43
DEU,SRB,2021.0,14,24,-10
USA,EST,2022.0,13,6,7
CHN,EGY,2022.0,100,37,63
COL,FRA,2021.0,28,25,3
VNM,AUS,2022.0,34,69,-35
JPN,DEU,2023.0,59,62,-3
SWE,ITA,2022.0,58,74,-16
COG,CHN,2021.0,1,2,-1
CHN,IDN,2023.0,8,3,5
BRA,NOR,2023.0,12,4,8
KOR,SGP,2021.0,24,32,-8
TUR,IRQ,2021.0,37,13,24
GHA,ZAF,2023.0,17,20,-3
DEU,CRI,2021.0,8,5,3
ETH,IND,2022.0,50,35,15
CZE,SVK,2018.0,89,109,-20
NLD,CHE,2022.0,107,97,10
USA,SLV,2022.0,6,3,3
GBR,HKG,2018.0,69,73,-4
HKG,AUS,2022.0,34,44,-10
COG,COD,2022.0,91,52,39
CAN,VNM,2014.0,5,2,3
NLD,IDN,2022.0,52,33,19
IRQ,GBR,2021.0,34,153,-119
ESP,AUS,2021.0,48,54,-6
HUN,POL,2021.0,6,3,3
MEX,DEU,2023.0,30,12,18
TUR,UKR,2021.0,1,2,-1
ITA,EGY,2023.0,10,8,2
CUB,ESP,2021.0,16,15,1
NLD,IRN,2012.0,14,37,-23
CHN,ZAF,2019.0,9,22,-13
LUX,AUT,2021.0,3,3,0
ROU,DEU,2015.0,33,35,-2
AUS,BGD,2022.0,70,71,-1
SRB,ITA,2023.0,6,3,3
BEL,DEU,2022.0,104,119,-15
CHN,MYS,2021.0,48,55,-7
BEN,DEU,2019.0,2,6,-4
QAT,CAN,2022.0,13,8,5
ZAF,GHA,2022.0,38,12,26
JPN,EGY,2022.0,63,34,29
SWE,GBR,2005.0,93,83,10
IND,NPL,2022.0,35,24,11
PAK,LTU,2021.0,3,1,2
GBR,CZE,2021.0,67,30,37
SWE,NLD,2022.0,55,64,-9
USA,MEX,1999.0,182,150,32
ISR,CHE,2019.0,24,28,-4
SGP,SWE,2021.0,16,5,11
ITA,BRA,2018.0,69,88,-19
JPN,DEU,2000.0,128,127,1
BGD,KOR,2023.0,25,22,3
AUS,ISL,2021.0,1,1,0
EGY,PRT,2014.0,3,2,1
TUR,IRL,2021.0,9,4,5
USA,GRC,1997.0,86,69,17
GRC,FRA,2021.0,37,40,-3
DEU,NZL,2001.0,25,18,7
JPN,SGP,2008.0,25,16,9
ESP,ITA,2001.0,96,94,2
BRA,CHE,1997.0,6,9,-3
CHE,BRA,1998.0,8,5,3
BEL,FRA,2002.0,168,174,-6
ITA,ESP,2017.0,223,177,46
DEU,RUS,2001.0,141,233,-92
SRB,HRV,2007.0,10,7,3
USA,SRB,2020.0,25,25,0
SWE,USA,1999.0,219,191,28
NER,FRA,2014.0,8,4,4
DEU,BOL,2011.0,1,4,-3
USA,NZL,2004.0,123,128,-5
USA,VEN,2011.0,25,37,-12
SWE,ITA,2018.0,52,86,-34
CAN,CHE,2002.0,52,51,1
RUS,GBR,2001.0,102,39,63
CAN,FIN,2008.0,12,26,-14
SWE,USA,1998.0,219,150,69
GBR,DNK,2000.0,60,54,6
BEL,USA,2001.0,158,115,43
AUT,CHL,2002.0,1,2,-1
SVK,DEU,2004.0,18,16,2
CHE,SVN,1998.0,2,2,0
CAN,ITA,2004.0,26,39,-13
GRC,ESP,2003.0,4,4,0
AUS,ITA,2003.0,15,23,-8
BLR,POL,2001.0,7,4,3
AUS,HRV,2012.0,1,2,-1
USA,SAU,1998.0,30,26,4
BRA,RUS,2000.0,5,12,-7
SGP,CHE,2016.0,17,26,-9
BEL,MEX,2002.0,5,5,0
SWE,RUS,2020.0,19,21,-2
PRT,USA,1997.0,16,20,-4
DEU,ESP,2000.0,76,85,-9
AUT,CHE,2008.0,50,37,13
DEU,POL,1999.0,58,59,-1
POL,ESP,2000.0,8,4,4
USA,CZE,2000.0,44,48,-4
BEL,FRA,2005.0,130,163,-33
VEN,ESP,2002.0,17,15,2
USA,FIN,2008.0,66,66,0
DEU,CZE,2000.0,33,30,3
SGP,CHE,2018.0,20,23,-3
NZL,CAN,2005.0,34,19,15
FRA,JPN,2001.0,78,81,-3
ESP,ARG,2000.0,58,77,-19
ISR,ZAF,2000.0,3,4,-1
ISR,AUS,2004.0,11,7,4
GRC,NLD,2000.0,9,8,1
GAB,USA,2020.0,11,3,8
GBR,ROU,1999.0,12,8,4
CZE,SVK,2017.0,93,72,21
CZE,SVK,2022.0,47,66,-19
URY,BRA,2014.0,8,11,-3
BRA,URY,2015.0,9,11,-2
CAN,ESP,2006.0,26,30,-4
UKR,DEU,2000.0,44,9,35
FRA,BRA,2000.0,83,45,38
NLD,CAN,2002.0,38,49,-11
ESP,AUT,2000.0,13,6,7
CZE,CAN,1997.0,2,11,-9
USA,IRL,2006.0,114,81,33
BEL,CHL,2013.0,7,8,-1
CAN,SWE,2002.0,35,49,-14
MEX,CAN,2001.0,20,24,-4
JOR,QAT,2002.0,2,2,0
SVN,NLD,2006.0,3,2,1
RUS,FRA,1998.0,49,58,-9
DEU,CAN,1997.0,66,69,-3
TUR,GBR,2009.0,28,38,-10
ESP,ISR,1999.0,6,6,0
ISR,ESP,2002.0,8,3,5
DEU,BEL,2011.0,89,98,-9
NOR,ITA,2021.0,23,27,-4
NLD,FIN,2002.0,12,16,-4
SWE,AUT,2000.0,12,7,5
DNK,COL,2018.0,3,4,-1
FRA,PRT,2001.0,25,35,-10
SWE,FRA,2003.0,56,49,7
USA,KEN,2000.0,16,26,-10
DZA,FRA,2005.0,39,40,-1
PRT,USA,2002.0,41,54,-13
CAN,JPN,1998.0,97,88,9
THA,USA,2000.0,34,82,-48
HUN,GBR,2017.0,51,41,10
RUS,CAN,1997.0,28,20,8
NZL,USA,2001.0,152,116,36
UKR,FRA,1998.0,10,6,4
NGA,USA,2009.0,26,31,-5
USA,FIN,2001.0,94,103,-9
DEU,MEX,2008.0,24,30,-6
LVA,RUS,1997.0,6,5,1
FRA,CHL,2001.0,14,13,1
ARE,IND,2018.0,27,66,-39
SWE,ISL,2000.0,14,4,10
NAM,ZAF,2013.0,7,8,-1
CZE,FRA,1998.0,13,20,-7
RUS,BEL,1998.0,13,5,8
TUR,CAN,2003.0,10,6,4
ISR,SGP,2014.0,5,5,0
BEL,BRA,1997.0,13,7,6
CAN,ITA,2001.0,45,44,1
NLD,NOR,2005.0,19,7,12
ZAF,SWE,2019.0,17,11,6
FIN,GBR,1998.0,23,22,1
BEL,AUS,2002.0,17,8,9
SAU,TUR,2008.0,2,2,0
DNK,CAN,2002.0,13,27,-14
CAN,DNK,2003.0,19,29,-10
USA,URY,2012.0,13,12,1
SVK,AUT,2008.0,14,13,1
FRA,GLP,2020.0,33,27,6
HKG,DNK,2018.0,7,3,4
FIN,FRA,2004.0,13,12,1
FRA,FIN,2005.0,11,12,-1
CAN,FRA,2001.0,162,211,-49
CZE,USA,2019.0,53,66,-13
FRA,VEN,2005.0,9,8,1
ZAF,CHE,2005.0,7,9,-2
NLD,GRC,2011.0,11,19,-8
AUS,DNK,1999.0,17,7,10
KOR,RUS,2003.0,14,25,-11
VEN,GBR,1997.0,2,3,-1
FRA,POL,2003.0,35,36,-1
ITA,BEL,2010.0,59,42,17
USA,MEX,1998.0,143,130,13
VNM,FRA,2015.0,19,41,-22
POL,CZE,1998.0,10,1,9
SGP,MYS,2013.0,20,18,2
BEL,CAN,1999.0,19,10,9
HUN,POL,2019.0,6,1,5
DEU,PHL,1999.0,3,1,2
BRA,DEU,2021.0,160,75,85
NLD,RUS,1998.0,13,11,2
FRA,NLD,1999.0,79,41,38
SAU,IND,1998.0,15,3,12
IRL,BEL,1997.0,4,2,2
SVN,HRV,2018.0,14,11,3
IND,OMN,2020.0,41,10,31
BRA,FRA,2001.0,55,80,-25
GBR,HKG,2017.0,63,67,-4
PAK,SAU,2003.0,6,8,-2
ESP,TUR,2001.0,1,1,0
SRB,BIH,2006.0,12,7,5
UKR,JPN,2009.0,6,3,3
MYS,GBR,2015.0,70,163,-93
EGY,GBR,1999.0,14,13,1
NZL,SWE,2015.0,10,10,0
GBR,SGP,2011.0,80,60,20
FRA,TWN,1999.0,7,2,5
ITA,JPN,2012.0,23,17,6
COL,MEX,2023.0,21,23,-2
TZA,USA,2009.0,12,9,3
USA,CHL,2001.0,67,56,11
ESP,CHL,1997.0,12,8,4
SVN,DEU,1997.0,6,6,0
USA,POL,2001.0,91,138,-47
JPN,TUR,2003.0,14,14,0
CAN,RUS,2012.0,19,26,-7
UKR,USA,2007.0,28,25,3
GRC,USA,2000.0,79,107,-28
TWN,CAN,1997.0,2,7,-5
PER,USA,2023.0,38,22,16
PLW,USA,2006.0,2,2,0
DEU,LUX,2004.0,9,2,7
HUN,ITA,2005.0,9,5,4
CZE,CAN,2002.0,15,3,12
CAN,CZE,2004.0,7,6,1
ESP,CHE,1998.0,22,29,-7
ESP,CAN,1999.0,24,11,13
USA,HUN,2002.0,88,96,-8
IND,PHL,2002.0,5,3,2
LBN,CHN,2021.0,2,2,0
SYR,MAR,2010.0,3,1,2
RUS,FIN,2014.0,29,18,11
RUS,JPN,2011.0,18,20,-2
ARG,CHL,2009.0,11,11,0
PAN,USA,2013.0,19,18,1
FRA,REU,1997.0,4,7,-3
SWE,JPN,1997.0,22,19,3
AUT,POL,1999.0,7,4,3
ZAF,AUS,2013.0,51,30,21
JPN,FIN,2008.0,13,8,5
TWN,JPN,2000.0,13,23,-10
CAN,POL,2000.0,14,16,-2
DEU,ISR,2003.0,32,33,-1
AUS,BRA,2021.0,37,84,-47
AUS,SWE,2008.0,29,46,-17
SWE,EST,2002.0,18,7,11
SVN,SVK,2013.0,16,8,8
NLD,ESP,2017.0,72,92,-20
ZWE,GBR,1997.0,4,5,-1
ESP,POL,2013.0,19,12,7
ITA,SWE,2017.0,93,46,47
NLD,PRT,1998.0,17,5,12
POL,CZE,2007.0,6,4,2
DEU,CZE,2010.0,29,30,-1
JPN,SGP,2015.0,49,36,13
GBR,GAB,2000.0,2,3,-1
CHL,BEL,2006.0,5,2,3
MAR,CHN,2018.0,21,5,16
AUS,ISR,2003.0,9,13,-4
CAN,POL,2006.0,10,22,-12
CAN,RUS,1997.0,20,28,-8
ROU,ITA,2004.0,9,6,3
IND,KWT,2007.0,10,3,7
ITA,BEL,2000.0,36,49,-13
USA,PAN,2011.0,23,20,3
NOR,USA,2014.0,75,89,-14
IND,KWT,1999.0,6,4,2
GRC,CAN,2009.0,12,11,1
UKR,USA,1998.0,28,29,-1
FRA,ECU,2015.0,7,6,1
USA,IRL,2000.0,69,54,15
ITA,AUT,2002.0,23,23,0
USA,PHL,2020.0,44,42,2
MEX,BOL,2003.0,1,2,-1
GBR,MEX,1997.0,21,15,6
EGY,PAK,2006.0,2,1,1
CIV,FRA,1997.0,10,3,7
SVN,GBR,2007.0,13,8,5
CHE,AUS,1998.0,28,20,8
USA,HUN,2005.0,81,84,-3
KEN,JPN,2007.0,2,8,-6
USA,UKR,1999.0,22,55,-33
BEL,EGY,1999.0,2,1,1
SAU,EGY,2003.0,45,52,-7
MEX,CHL,2016.0,21,19,2
ITA,JPN,2002.0,24,33,-9
ESP,PRT,2004.0,43,34,9
BRB,GBR,1997.0,2,2,0
GBR,IRL,1999.0,145,148,-3
DEU,GRC,2004.0,31,28,3
FRA,MLI,2009.0,8,10,-2
FIN,BEL,2015.0,8,4,4
MEX,CUB,1999.0,10,14,-4
CUB,MEX,2005.0,11,10,1
ZAF,ETH,2002.0,1,3,-2
AUS,SWE,2004.0,30,40,-10
GBR,VEN,2001.0,10,9,1
MEX,RUS,1997.0,4,10,-6
BEL,GRC,2006.0,9,14,-5
LVA,USA,2004.0,1,4,-3
LVA,USA,2008.0,2,1,1
CHE,FIN,2000.0,10,11,-1
JPN,GBR,1997.0,92,106,-14
USA,CHL,2004.0,62,62,0
GBR,NOR,2005.0,52,34,18
FRA,NCL,2001.0,9,6,3
TUN,FRA,2016.0,101,156,-55
USA,QAT,2011.0,42,11,31
GBR,IRN,1999.0,30,8,22
NOR,AUS,2000.0,6,6,0
SRB,ITA,2010.0,1,6,-5
JPN,RUS,2005.0,35,28,7
TWN,TUR,2006.0,3,1,2
ESP,RUS,2012.0,9,5,4
RUS,EST,2002.0,2,2,0
ARG,FRA,2005.0,21,15,6
USA,GHA,2019.0,40,36,4
POL,BLR,1997.0,5,4,1
MTQ,FRA,1999.0,17,9,8
DEU,JOR,1998.0,5,2,3
CHN,RUS,2014.0,9,10,-1
FIN,CHE,2000.0,11,10,1
UKR,POL,2019.0,39,32,7
DNK,CAN,1997.0,11,13,-2
DZA,FRA,2002.0,37,34,3
BRA,USA,1998.0,190,214,-24
SGP,AUS,2002.0,31,41,-10
ROU,AUT,2012.0,5,3,2
DNK,RUS,1998.0,6,12,-6
MYS,IRN,2002.0,3,1,2
ZAF,DEU,2002.0,29,22,7
NOR,USA,2001.0,76,70,6
NOR,USA,2015.0,74,118,-44
AUS,FRA,2001.0,49,37,12
FRA,REU,2012.0,20,25,-5
GBR,MLT,2012.0,10,5,5
DEU,HRV,2009.0,11,10,1
HRV,CHE,2011.0,5,1,4
FIN,GBR,1999.0,27,26,1
ISR,FRA,2018.0,28,34,-6
PER,FRA,1997.0,2,1,1
KOR,CAN,2005.0,40,25,15
FRA,BEL,1997.0,85,80,5
SWE,POL,2009.0,12,14,-2
CMR,FRA,2000.0,11,8,3
FRA,SAU,2016.0,56,15,41
JPN,CAN,2003.0,133,97,36
PSE,ISR,2011.0,20,19,1
BRB,CAN,2011.0,1,3,-2
GBR,SWE,2018.0,200,180,20
AUS,COL,2018.0,7,12,-5
UZB,USA,2002.0,7,1,6
JPN,AUT,2008.0,12,10,2
USA,ISL,1999.0,8,15,-7
CYP,ITA,2000.0,2,1,1
ETH,GBR,2000.0,10,1,9
UKR,ESP,2001.0,5,3,2
ZAF,BEL,2002.0,7,11,-4
IRQ,IRN,2016.0,4,7,-3
URY,ITA,2005.0,1,1,0
PAK,BGD,2012.0,11,9,2
ISL,NOR,2002.0,9,3,6
RUS,BEL,1999.0,10,7,3
GBR,CZE,2011.0,45,36,9
PRT,RUS,2002.0,5,8,-3
PRT,NOR,2015.0,11,1,10
NLD,POL,2001.0,14,12,2
CZE,HUN,1999.0,5,2,3
GEO,DEU,2002.0,3,2,1
DEU,GEO,2011.0,7,6,1
CHN,SWE,1999.0,22,14,8
GBR,ARG,1999.0,17,12,5
FIN,USA,2000.0,112,84,28
UKR,USA,1999.0,55,22,33
AUS,IRL,1997.0,6,3,3
UKR,BLR,2003.0,2,3,-1
CHL,BRA,2023.0,14,28,-14
USA,HUN,1997.0,68,63,5
BRA,IRN,2018.0,4,5,-1
AUS,RUS,2003.0,7,14,-7
RUS,ESP,2018.0,9,14,-5
BRA,URY,2008.0,4,5,-1
MEX,CRI,1998.0,2,1,1
POL,CAN,2004.0,19,12,7
SWE,PRT,2020.0,20,22,-2
ITA,PAK,2008.0,1,2,-1
FRA,ECU,2008.0,5,1,4
TTO,USA,2003.0,7,11,-4
FRA,CMR,2007.0,22,12,10
USA,LBN,2000.0,35,18,17
FRA,URY,2009.0,7,1,6
POL,CAN,2001.0,19,14,5
ESP,PRI,2020.0,6,1,5
PHL,AUS,2000.0,6,6,0
GRC,RUS,2011.0,2,2,0
ITA,PRT,1998.0,5,4,1
ZWE,ZAF,2005.0,17,4,13
FRA,VEN,1997.0,6,4,2
DEU,GRC,2001.0,41,27,14
MDG,NER,1999.0,1,2,-1
KWT,USA,1997.0,2,10,-8
ITA,JPN,1997.0,16,28,-12
ZAF,ISR,2019.0,4,2,2
BEL,RUS,1999.0,7,10,-3
PRT,USA,2005.0,48,47,1
HKG,DEU,2019.0,35,16,19
IND,ZAF,2019.0,48,46,2
LBN,BEL,2017.0,5,10,-5
IRN,SVK,2020.0,7,1,6
MYS,IRQ,2017.0,140,20,120
MYS,IRQ,2016.0,104,21,83
CHN,EGY,2018.0,20,39,-19
FRA,SRB,2020.0,11,5,6
BRN,VNM,2020.0,1,1,0
FRA,MAR,2013.0,122,42,80
BRA,NZL,2021.0,20,1,19
KAZ,USA,2020.0,19,21,-2
AUS,NOR,2022.0,21,12,9
USA,ARG,2022.0,64,130,-66
RWA,USA,2021.0,20,16,4
USA,RWA,2023.0,10,8,2
GAB,MAR,2017.0,1,1,0
LBY,USA,2016.0,3,3,0
SGP,THA,2017.0,5,6,-1
CAN,ECU,2020.0,3,11,-8
KOR,IDN,2016.0,15,15,0
SWE,SRB,2019.0,3,6,-3
NLD,GRC,2021.0,27,26,1
AUS,CAN,2013.0,147,219,-72
KEN,SDN,2022.0,1,1,0
IRL,BHR,2020.0,3,1,2
IND,ITA,2018.0,46,39,7
URY,ESP,1999.0,8,4,4
VNM,CHN,2017.0,13,36,-23
ITA,HKG,2020.0,3,4,-1
TWN,VNM,2018.0,51,15,36
IRN,DEU,2014.0,82,36,46
DEU,COG,2021.0,1,2,-1
IRL,CHE,2016.0,17,17,0
POL,SVK,2015.0,8,5,3
GRC,ITA,2019.0,39,37,2
ETH,DEU,2017.0,11,8,3
PRT,IRN,2017.0,9,11,-2
SGP,CHE,2017.0,23,24,-1
ARG,CHL,2019.0,36,25,11
PAK,DEU,2022.0,25,30,-5
PAK,QAT,2021.0,10,7,3
LBY,FRA,2014.0,2,3,-1
IRN,FIN,2021.0,50,6,44
RWA,ZAF,2020.0,5,5,0
IND,AUT,2019.0,18,8,10
UGA,ZAF,2018.0,15,17,-2
FRA,REU,2005.0,13,4,9
FJI,GBR,2023.0,2,1,1
AUT,NZL,2022.0,2,6,-4
THA,BGD,2017.0,5,2,3
NGA,NER,2017.0,12,14,-2
CHL,AUT,2016.0,1,2,-1
VNM,USA,2015.0,24,31,-7
IRN,CHN,2019.0,70,18,52
KHM,COL,2016.0,1,1,0
CHN,NLD,2012.0,92,56,36
HKG,AUS,2016.0,36,45,-9
AUS,FRA,2014.0,100,106,-6
CAN,MEX,2023.0,21,20,1
GBR,ECU,2021.0,8,4,4
MEX,FRA,2019.0,57,54,3
BRA,ISR,2000.0,2,2,0
USA,LKA,2014.0,20,6,14
GBR,BEL,2017.0,130,161,-31
NLD,SGP,2012.0,15,11,4
NLD,DNK,2017.0,59,29,30
MYS,GBR,2014.0,76,157,-81
NZL,ZAF,2010.0,9,10,-1
IND,BEL,2020.0,45,23,22
ZAF,IND,2019.0,46,48,-2
HRV,GBR,2018.0,16,14,2
USA,ETH,2019.0,33,31,2
IND,BRA,2018.0,14,17,-3
AUT,CZE,2007.0,8,10,-2
JPN,PAK,2018.0,11,7,4
DEU,LUX,2014.0,43,23,20
HUN,VNM,2021.0,4,1,3
ARG,NLD,2023.0,4,2,2
ISR,CAN,2023.0,36,38,-2
CRI,CAN,2020.0,4,6,-2
SDN,MYS,2021.0,5,12,-7
FRA,DNK,2023.0,34,15,19
POL,BRA,2017.0,3,6,-3
KOR,SAU,2021.0,27,15,12
LBN,FRA,2020.0,86,93,-7
SRB,SWE,2009.0,2,2,0
SRB,GBR,2021.0,12,10,2
CAF,FRA,1998.0,1,3,-2
CHE,SWE,2006.0,23,50,-27
CHE,ESP,2022.0,76,124,-48
JPN,NLD,2013.0,28,22,6
NLD,JPN,2018.0,29,33,-4
IND,GBR,2002.0,109,84,25
IND,ESP,1997.0,3,5,-2
ESP,COL,2018.0,135,72,63
CHE,DNK,2022.0,38,36,2
NLD,CHN,2014.0,80,113,-33
CHN,NLD,2002.0,29,26,3
COL,DEU,2014.0,16,15,1
GBR,HKG,2016.0,53,67,-14
IND,ITA,2017.0,53,47,6
AUS,ARE,2019.0,32,21,11
CAN,PAK,2006.0,12,9,3
AUT,HKG,2018.0,3,1,2
MEX,ARG,2016.0,28,23,5
CHE,NGA,2020.0,25,3,22
ETH,IND,2017.0,18,69,-51
ISL,FRA,2019.0,8,6,2
DEU,IRQ,2016.0,7,5,2
PAK,DEU,2016.0,32,37,-5
DEU,PAK,2019.0,63,26,37
EGY,AUS,2017.0,7,8,-1
EGY,AUS,2022.0,15,11,4
MDG,FRA,2017.0,7,20,-13
CHN,FRA,2008.0,67,79,-12
CHE,KEN,2007.0,2,1,1
AUT,GBR,2013.0,78,88,-10
DEU,CYP,2021.0,9,6,3
PAK,BRN,2017.0,2,1,1
USA,TUN,2023.0,7,4,3
ARG,COL,2016.0,19,15,4
MYS,JOR,2019.0,28,12,16
TWN,JPN,2023.0,33,38,-5
CHE,DNK,2016.0,41,41,0
FRA,SAU,2018.0,60,16,44
GBR,THA,2019.0,93,62,31
PHL,ESP,2019.0,4,2,2
COL,BRA,2013.0,43,24,19
SVN,HRV,2016.0,18,12,6
CHN,SAU,2014.0,21,20,1
GHA,DEU,2017.0,11,9,2
FIN,IND,2022.0,8,24,-16
MYS,DNK,2013.0,5,3,2
SGP,USA,2023.0,110,114,-4
FRA,IRL,2003.0,18,8,10
IND,SWE,2022.0,61,43,18
TWN,VNM,2016.0,27,3,24
VEN,MEX,2010.0,15,6,9
BOL,SWE,2021.0,4,3,1
MEX,SWE,2018.0,10,1,9
VNM,FRA,2014.0,19,45,-26
PRT,CHE,2017.0,22,15,7
IRN,AUS,2009.0,38,36,2
USA,BRB,2019.0,8,3,5
CHL,DEU,2020.0,52,38,14
PSE,FRA,2023.0,1,1,0
IDN,KOR,2022.0,31,25,6
GBR,BGR,2021.0,3,5,-2
IND,DEU,2015.0,162,140,22
JOR,GBR,2016.0,18,25,-7
FRA,LBN,1997.0,10,14,-4
LBN,FRA,1998.0,11,26,-15
LKA,NZL,2016.0,4,6,-2
CAN,MEX,2000.0,22,19,3
BWA,CAN,2013.0,3,1,2
AUT,AUS,2022.0,12,31,-19
AUS,AUT,2023.0,15,14,1
ZAF,NGA,2015.0,46,67,-21
IND,ZAF,2011.0,33,9,24
QAT,JOR,2022.0,5,16,-11
SVK,CZE,2021.0,72,74,-2
CHN,SAU,2015.0,27,11,16
SAU,CHN,2018.0,44,47,-3
MYS,FRA,2017.0,11,7,4
SGP,KOR,2010.0,14,18,-4
DEU,TWN,2019.0,13,27,-14
DEU,PRT,2018.0,44,60,-16
ISR,DEU,2020.0,69,80,-11
BRA,ARG,2017.0,48,40,8
ISR,FIN,2023.0,6,1,5
PRT,NZL,2020.0,5,2,3
KAZ,FRA,2016.0,1,1,0
GBR,UGA,2017.0,19,12,7
FRA,BEN,2017.0,12,16,-4
MEX,CAN,2015.0,39,40,-1
IDN,GBR,2016.0,15,29,-14
FIN,CHN,2018.0,39,43,-4
NZL,VNM,2022.0,5,2,3
MYS,THA,2020.0,16,10,6
COL,NLD,2020.0,13,14,-1
POL,CHE,2021.0,31,19,12
SAU,KOR,2018.0,14,18,-4
BRA,ECU,2017.0,6,5,1
SGP,SWE,2019.0,13,11,2
GBR,UKR,2021.0,12,7,5
DNK,ESP,2018.0,34,27,7
KAZ,CAN,2019.0,2,3,-1
GBR,UKR,2019.0,31,11,20
BRA,AUT,2021.0,19,6,13
NLD,BEL,2019.0,194,205,-11
SRB,NOR,2019.0,3,1,2
BEL,NOR,2021.0,15,9,6
CAN,DZA,2020.0,6,6,0
DNK,ESP,2017.0,35,52,-17
ARG,CAN,2019.0,19,11,8
KEN,DEU,2021.0,15,15,0
IND,SWE,2017.0,43,32,11
TUN,USA,2020.0,10,10,0
ETH,GBR,2023.0,7,5,2
JPN,VNM,2023.0,41,22,19
USA,DNK,2021.0,176,133,43
ESP,AUT,2023.0,18,17,1
PRT,HUN,2019.0,6,2,4
NLD,AUS,2020.0,85,80,5
ITA,IRL,2019.0,56,24,32
SWE,AUT,2023.0,13,16,-3
FRA,ETH,2022.0,7,1,6
CZE,SVN,2010.0,1,2,-1
ITA,COL,2021.0,18,17,1
IDN,IND,2019.0,30,38,-8
BRA,JPN,2020.0,23,7,16
EGY,KWT,2017.0,10,16,-6
NLD,VNM,2019.0,12,4,8
QAT,PAK,2019.0,3,10,-7
TUR,FIN,2019.0,17,5,12
GHA,KOR,2020.0,3,4,-1
ITA,ARG,2018.0,16,19,-3
GBR,CYP,2020.0,54,24,30
JPN,BGD,2013.0,60,42,18
DNK,SWE,2017.0,103,102,1
ITA,SWE,2022.0,74,58,16
MKD,BGR,2018.0,5,4,1
USA,UKR,2020.0,22,28,-6
BRA,ECU,2018.0,16,7,9
POL,UKR,2009.0,12,23,-11
ITA,SVN,2022.0,12,12,0
AUS,DEU,2023.0,89,61,28
BEL,ETH,2020.0,10,4,6
IND,ITA,2016.0,46,50,-4
BEL,LUX,2023.0,16,7,9
DNK,NLD,2021.0,48,57,-9
UGA,KEN,2019.0,11,16,-5
BRA,COL,2012.0,28,37,-9
CHN,PRT,2017.0,7,13,-6
CZE,POL,2013.0,6,6,0
DNK,BEL,2019.0,20,21,-1
DEU,NGA,2023.0,10,10,0
MWI,USA,2023.0,11,23,-12
CAN,MAR,2021.0,7,6,1
MYS,TWN,2017.0,15,5,10
SWE,FIN,2022.0,67,59,8
CAN,IRQ,2019.0,6,2,4
AUS,OMN,2022.0,1,2,-1
KOR,GBR,2002.0,23,41,-18
NOR,ESP,2021.0,23,21,2
ESP,NOR,2022.0,29,13,16
LUX,FRA,2018.0,24,30,-6
KEN,UGA,2019.0,16,11,5
BEL,ITA,2019.0,89,145,-56
SGP,DEU,2016.0,43,42,1
ARE,IND,2016.0,18,44,-26
RUS,JPN,2019.0,15,11,4
IND,BGD,2020.0,26,24,2
CAN,IRN,2023.0,54,238,-184
SVN,SLV,2015.0,9,2,7
IND,NLD,2014.0,33,27,6
SGP,GBR,2003.0,66,38,28
TWN,VNM,2022.0,71,31,40
THA,IND,2023.0,13,31,-18
GBR,BGR,2019.0,8,9,-1
IDN,GBR,2018.0,24,34,-10
CAN,NOR,2019.0,24,22,2
DEU,CYP,2019.0,7,2,5
ARG,CHL,2021.0,36,14,22
AUS,IRN,2018.0,43,163,-120
SRB,FRA,2002.0,6,10,-4
HKG,TWN,2022.0,25,8,17
RUS,FIN,2004.0,21,16,5
IRL,HKG,2020.0,2,2,0
BEL,ZAF,2021.0,8,15,-7
DNK,NLD,2019.0,47,48,-1
NZL,JPN,2020.0,15,10,5
IRN,FIN,2019.0,29,4,25
PAK,CHN,2007.0,8,7,1
SRB,DEU,1998.0,25,5,20
ECU,MEX,2011.0,5,3,2
BRA,NOR,2010.0,5,1,4
BGD,KOR,2010.0,16,17,-1
MEX,ESP,2013.0,117,172,-55
VNM,BEL,2020.0,7,27,-20
PRT,DEU,2023.0,32,24,8
VCT,USA,2021.0,2,3,-1
VNM,ITA,2023.0,1,3,-2
KEN,CAN,2019.0,10,8,2
CHN,KOR,2024.0,3,6,-3
ARM,USA,2020.0,5,10,-5
NZL,DNK,2013.0,11,3,8
ISR,IND,2019.0,59,149,-90
IND,MAC,2019.0,2,1,1
GRD,USA,2020.0,10,15,-5
IND,HKG,2017.0,17,10,7
KOR,DEU,2010.0,41,35,6
SWE,ISL,2006.0,11,17,-6
JPN,KGZ,2021.0,1,1,0
GHA,NOR,2021.0,3,5,-2
GHA,NLD,2019.0,4,5,-1
IND,CHL,2022.0,17,4,13
CHN,VNM,2021.0,30,14,16
SVK,HUN,2021.0,13,10,3
FRA,TWN,2020.0,10,12,-2
RUS,SWE,2021.0,24,16,8
NGA,AUS,2019.0,11,5,6
KOR,IDN,2022.0,25,31,-6
AUS,BGD,2016.0,24,59,-35
RUS,SWE,2019.0,18,23,-5
MAR,TUN,2018.0,2,6,-4
JPN,IRL,2022.0,12,4,8
DNK,TUR,2019.0,9,10,-1
RUS,KOR,2003.0,25,14,11
NLD,ECU,2022.0,3,6,-3
COL,GBR,2020.0,23,22,1
RUS,ITA,2000.0,48,28,20
AUT,ZAF,2017.0,10,3,7
IND,POL,2019.0,38,8,30
JPN,DNK,2023.0,7,2,5
IRN,MYS,2021.0,25,61,-36
CZE,CHN,2023.0,14,9,5
NPL,IND,2019.0,23,40,-17
USA,LTU,2021.0,6,12,-6
PAK,NZL,2018.0,9,10,-1
POL,GBR,2021.0,60,94,-34
UKR,DEU,2023.0,34,8,26
CAN,NGA,2022.0,7,37,-30
FRA,TCD,2021.0,4,1,3
UKR,ITA,2022.0,3,5,-2
GRC,PRT,2022.0,3,1,2
PER,CHL,2015.0,6,3,3
SGP,USA,2000.0,73,77,-4
FIN,CHN,2022.0,57,50,7
CHN,FIN,2023.0,40,37,3
KOR,MYS,2022.0,5,15,-10
BRA,PAK,2015.0,13,11,2
KAZ,GBR,2022.0,9,3,6
KOR,ARE,2020.0,21,6,15
PAK,AUS,2022.0,40,37,3
ROU,GBR,2023.0,9,16,-7
GBR,FLK,2022.0,1,7,-6
IND,LKA,2021.0,5,8,-3
DEU,ETH,2017.0,8,11,-3
USA,THA,2000.0,82,34,48
IRL,SWE,2022.0,15,14,1
GBR,HUN,2021.0,30,45,-15
HKG,PAK,2021.0,8,12,-4
ITA,NLD,2012.0,113,71,42
IRN,CHN,2021.0,65,43,22
RUS,EGY,2022.0,22,4,18
TUR,LUX,2021.0,2,1,1
IND,PAK,2009.0,13,9,4
ITA,DZA,2021.0,6,4,2
UKR,ISR,2019.0,4,2,2
ESP,COL,2022.0,77,110,-33
AUS,NGA,2022.0,8,9,-1
MYS,JPN,2021.0,52,43,9
ECU,GBR,2019.0,5,8,-3
IND,YEM,2022.0,16,2,14
MEX,CHL,2022.0,15,12,3
SRB,RUS,2019.0,3,9,-6
FRA,NLD,2020.0,129,118,11
MOZ,BRA,2021.0,4,14,-10
PAK,AUT,2021.0,4,12,-8
IRL,TUR,2008.0,4,3,1
IND,TWN,2020.0,93,56,37
DNK,NLD,2009.0,14,18,-4
SWE,CAN,2019.0,46,46,0
NLD,NZL,2022.0,13,9,4
FRA,ROU,2019.0,26,19,7
NOR,TZA,2015.0,8,6,2
NGA,SAU,2022.0,10,10,0
IRL,IND,2023.0,12,36,-24
DEU,IRQ,2018.0,17,1,16
PAK,DEU,2018.0,28,32,-4
CHE,NOR,2021.0,33,18,15
BEL,CZE,2022.0,11,14,-3
AUS,CHN,2024.0,17,9,8
DEU,BRA,2022.0,64,144,-80
FRA,ISR,2023.0,23,19,4
ZAF,NZL,2019.0,22,10,12
FRA,BRA,2023.0,43,92,-49
LKA,CAN,2020.0,5,3,2
RUS,VNM,2015.0,15,2,13
SWE,ESP,2021.0,60,84,-24
AUS,POL,2023.0,7,5,2
IND,HKG,2018.0,23,13,10
CUB,BRA,2015.0,20,2,18
OMN,EGY,1998.0,4,3,1
DNK,CHN,2005.0,8,9,-1
CHE,RUS,2003.0,9,26,-17
POL,ITA,2002.0,17,15,2
CAN,CHN,2024.0,9,11,-2
NLD,CHN,2001.0,20,19,1
DEU,HUN,2008.0,49,41,8
GRC,UKR,1998.0,1,1,0
COL,USA,2001.0,37,33,4
DEU,GMB,2001.0,1,1,0
SVK,DEU,2001.0,24,20,4
JPN,MYS,2012.0,69,35,34
AUT,SWE,2014.0,22,18,4
FRA,GLP,1999.0,19,17,2
CRI,USA,2005.0,8,13,-5
GBR,HRV,2021.0,10,14,-4
AUS,ESP,2004.0,6,9,-3
GBR,AUT,1997.0,17,16,1
CHE,JPN,2002.0,32,36,-4
BRA,CHL,2010.0,19,9,10
HKG,KOR,2023.0,13,9,4
FRA,ECU,2014.0,5,3,2
DEU,RUS,2015.0,117,137,-20
CHE,GRC,2022.0,27,26,1
USA,VEN,2019.0,10,39,-29
FIN,THA,2023.0,3,1,2
BGR,USA,2003.0,24,21,3
GBR,BEL,2016.0,117,141,-24
AUS,SWE,2001.0,29,26,3
FRA,RUS,2006.0,36,54,-18
MYS,TUR,2013.0,3,1,2
RUS,AUS,2005.0,12,8,4
USA,PHL,1998.0,14,14,0
AUT,DNK,2011.0,6,8,-2
USA,FSM,2004.0,2,1,1
ITA,RUS,2001.0,32,43,-11
JOR,USA,2009.0,14,48,-34
RUS,FIN,2015.0,31,27,4
CHE,VNM,2005.0,2,1,1
RUS,UKR,2000.0,66,91,-25
USA,VNM,1997.0,3,2,1
BIH,HRV,2010.0,7,6,1
SGP,NLD,2007.0,8,5,3
FIN,FRA,2001.0,17,18,-1
FRA,FIN,2002.0,27,16,11
EGY,ARE,2005.0,10,7,3
GBR,BGR,2009.0,9,7,2
AUT,FRA,2001.0,20,27,-7
CHN,AUT,2003.0,8,6,2
IRL,ITA,1998.0,3,3,0
FRA,SRB,1999.0,4,2,2
MWI,USA,2000.0,8,2,6
CHN,IRQ,2016.0,21,3,18
ESP,NLD,2004.0,49,43,6
ZAF,MEX,2002.0,1,3,-2
NOR,DNK,2017.0,33,66,-33
SVK,SVN,2000.0,2,5,-3
SVK,USA,2014.0,17,18,-1
SVK,USA,2001.0,26,12,14
SWE,RUS,1999.0,27,38,-11
CHE,CAN,2001.0,76,53,23
USA,MDA,2016.0,5,1,4
DNK,AUS,2002.0,23,23,0
USA,ETH,2009.0,9,12,-3
BEL,MAR,2000.0,9,2,7
USA,PER,2002.0,28,14,14
ZAF,NLD,2005.0,7,19,-12
SVK,AUT,2004.0,13,5,8
BOL,USA,2001.0,2,4,-2
ISR,DEU,1998.0,38,33,5
ARE,DEU,2013.0,1,10,-9
SWE,BRA,2015.0,10,23,-13
CAN,AUT,2004.0,9,23,-14
ZAF,NGA,2001.0,3,6,-3
GRC,FRA,2019.0,40,29,11
RUS,CHN,1997.0,4,2,2
SVK,USA,2004.0,27,7,20
HKG,SGP,2001.0,22,19,3
DEU,PAK,2009.0,15,17,-2
SGP,AUS,1997.0,7,12,-5
USA,PAK,2013.0,65,82,-17
NZL,NLD,2000.0,12,11,1
JPN,NLD,2003.0,25,13,12
CZE,DEU,1997.0,20,15,5
BEL,KEN,2001.0,2,3,-1
GRC,SWE,2007.0,5,7,-2
BEL,AUT,1999.0,5,2,3
AUT,BEL,2009.0,9,5,4
FIN,NLD,2001.0,11,13,-2
MTQ,FRA,2007.0,15,19,-4
IND,OMN,1999.0,2,3,-1
OMN,IND,2000.0,2,4,-2
UKR,CHE,2004.0,4,2,2
FIN,ITA,2002.0,12,8,4
VEN,USA,1998.0,34,33,1
FRA,BGR,1997.0,4,11,-7
CZE,FRA,1999.0,12,22,-10
GBR,BGD,2003.0,13,9,4
SAU,ITA,2003.0,2,2,0
UZB,USA,2005.0,1,4,-3
FRA,UKR,2003.0,9,23,-14
SWE,ZAF,2014.0,12,8,4
BRA,GBR,1997.0,32,53,-21
GBR,ARG,1998.0,10,13,-3
FRA,COL,2001.0,10,3,7
DNK,DEU,2004.0,50,55,-5
HRV,SRB,2010.0,11,6,5
FRA,GUF,2020.0,37,24,13
EGY,JOR,2004.0,2,4,-2
USA,JOR,2007.0,61,22,39
SWE,EST,2012.0,6,3,3
SAU,OMN,2012.0,4,2,2
MEX,ITA,2023.0,23,23,0
USA,SEN,2011.0,6,3,3
SAU,TUR,2014.0,5,8,-3
GBR,NOR,1997.0,23,15,8
ARG,CHE,2000.0,7,1,6
HKG,DEU,2009.0,12,4,8
VNM,GBR,2002.0,6,14,-8
EGY,OMN,2003.0,2,3,-1
REU,FRA,2016.0,39,25,14
ITA,CAN,2003.0,39,38,1
THA,MYS,2010.0,6,3,3
FRA,RUS,2023.0,23,61,-38
ARG,BEL,2002.0,4,2,2
SAU,PAK,2007.0,12,12,0
AUT,NLD,2020.0,48,22,26
SWE,RUS,1998.0,21,40,-19
MEX,GBR,2001.0,30,36,-6
JPN,THA,2006.0,64,31,33
ARG,FRA,2012.0,23,37,-14
FRA,ARG,2015.0,26,48,-22
TUR,ITA,2003.0,11,4,7
ITA,TUR,2004.0,6,1,5
CHE,AUT,2001.0,31,29,2
MYS,AUS,1999.0,4,12,-8
AUS,PNG,2011.0,9,4,5
DZA,FRA,1997.0,16,24,-8
ARG,AUS,2015.0,6,11,-5
USA,ZMB,2017.0,23,15,8
BRA,MOZ,2016.0,4,4,0
ESP,FIN,2001.0,3,9,-6
VEN,USA,1999.0,35,52,-17
GRC,SWE,1998.0,2,8,-6
ESP,BGR,1999.0,4,7,-3
KEN,BEL,2000.0,3,2,1
CHE,SVN,2020.0,2,4,-2
ROU,HUN,2019.0,14,21,-7
CYP,GRC,2014.0,14,44,-30
IND,TWN,2007.0,43,16,27
NLD,SVK,1998.0,4,3,1
GBR,NPL,2001.0,4,5,-1
USA,ROU,2015.0,23,23,0
GBR,OMN,2008.0,14,4,10
ZWE,GBR,2002.0,9,7,2
FRA,MDA,2001.0,1,1,0
ESP,AUS,2011.0,32,21,11
DNK,GRL,2003.0,5,1,4
TUR,CYP,2010.0,19,26,-7
PSE,GBR,2023.0,4,1,3
POL,RUS,2000.0,18,21,-3
DNK,LTU,2001.0,1,3,-2
USA,FIN,2015.0,84,83,1
AUT,KOR,2015.0,7,3,4
NZL,NLD,2006.0,15,11,4
BOL,FRA,2010.0,4,7,-3
CHL,DEU,1998.0,5,15,-10
BEL,RUS,2007.0,14,13,1
BLR,GBR,2001.0,5,4,1
BRA,PER,2008.0,13,4,9
THA,BEL,2021.0,2,2,0
CAN,SGP,2005.0,15,23,-8
DNK,ISL,2001.0,7,5,2
AUS,NZL,2005.0,102,109,-7
CAN,EGY,2017.0,52,44,8
CHL,ARG,2003.0,6,19,-13
DEU,SWE,2003.0,95,97,-2
DEU,HUN,2004.0,35,56,-21
IRQ,USA,2014.0,8,7,1
IND,IRL,2007.0,13,2,11
NLD,RUS,2007.0,12,10,2
SAU,GBR,2001.0,16,21,-5
JPN,DNK,2000.0,9,8,1
NOR,FIN,2002.0,12,11,1
TWN,FRA,2020.0,12,10,2
CHN,MAC,2019.0,97,340,-243
AUS,IDN,2018.0,104,38,66
IDN,USA,2020.0,26,61,-35
BRA,COL,2022.0,77,60,17
USA,SGP,2020.0,238,200,38
FIN,JPN,2021.0,10,11,-1
CYP,ARE,2022.0,4,1,3
BRA,CZE,2021.0,20,3,17
AUS,IDN,2022.0,61,50,11
CHN,NLD,2022.0,188,202,-14
CHN,NLD,2016.0,127,121,6
NPL,CHN,2017.0,10,8,2
ISR,AUS,2023.0,14,10,4
PRT,DEU,2015.0,47,26,21
JPN,TWN,2021.0,61,70,-9
KAZ,UZB,2018.0,7,4,3
NZL,USA,2023.0,56,72,-16
FRA,SGP,2020.0,32,24,8
SGP,GBR,2021.0,126,126,0
ESP,CRI,2021.0,8,4,4
TZA,ZAF,2020.0,8,13,-5
SAU,CAN,2022.0,63,91,-28
NLD,IRL,2020.0,30,20,10
COL,ESP,2022.0,110,77,33
RUS,MEX,2018.0,7,3,4
NLD,ITA,1999.0,57,62,-5
FRA,KOR,2018.0,25,28,-3
JPN,ETH,2023.0,5,6,-1
RUS,CHN,2017.0,26,14,12
TUR,KWT,2023.0,6,1,5
IRQ,AUS,2018.0,13,10,3
LBY,MYS,2020.0,5,20,-15
AUT,GBR,2021.0,85,124,-39
EGY,LBY,2022.0,4,4,0
POL,ITA,2017.0,24,19,5
ESP,SWE,2017.0,95,43,52
USA,NLD,2001.0,299,331,-32
CHE,TUR,2021.0,15,25,-10
CAN,ITA,2006.0,39,40,-1
CHN,CHE,2003.0,15,13,2
ARG,URY,2021.0,21,9,12
IRN,BRA,2021.0,15,2,13
DEU,LUX,2006.0,19,2,17
GBR,MLT,2016.0,19,15,4
SWE,SRB,2003.0,3,2,1
POL,CHE,2003.0,15,9,6
FRA,IND,2005.0,21,42,-21
USA,LBN,2001.0,24,14,10
PAK,USA,2002.0,33,25,8
GBR,SVK,1999.0,14,11,3
HRV,GBR,2012.0,6,5,1
ESP,CHN,2021.0,74,63,11
SDN,SAU,2001.0,3,4,-1
ROU,GBR,2001.0,18,12,6
RUS,JPN,2013.0,17,14,3
CAN,SWE,2016.0,34,43,-9
CHE,PAK,1999.0,1,1,0
ESP,ROU,2006.0,2,3,-1
NLD,FRA,1997.0,64,49,15
GBR,CZE,2003.0,64,35,29
BRA,BEL,1999.0,9,10,-1
UKR,RUS,2023.0,60,14,46
RUS,ITA,2008.0,17,19,-2
HKG,ITA,1997.0,1,1,0
DNK,GRL,2011.0,4,3,1
AUS,JPN,2000.0,47,38,9
SVK,CAN,2004.0,1,6,-5
BEL,NZL,2023.0,1,5,-4
USA,FIN,2006.0,82,74,8
BEL,POL,2003.0,12,12,0
JPN,PRT,2005.0,1,4,-3
CZE,RUS,1997.0,13,5,8
FRA,UKR,2011.0,15,15,0
DEU,TUR,2000.0,13,14,-1
PHL,USA,1999.0,17,24,-7
ARG,MEX,2002.0,8,8,0
NOR,DNK,2002.0,24,34,-10
JPN,IRN,1999.0,10,2,8
HUN,DEU,1997.0,24,32,-8
FRA,CHL,2010.0,31,23,8
BRA,PRT,1999.0,31,21,10
MEX,VEN,2001.0,4,9,-5
COG,COD,2012.0,17,15,2
COD,COG,2013.0,27,22,5
GBR,UGA,2012.0,17,10,7
SWE,FIN,1997.0,26,30,-4
NLD,SWE,2010.0,44,38,6
USA,GEO,2000.0,46,26,20
USA,PAN,2013.0,18,19,-1
PAK,BGD,2018.0,15,10,5
FRA,KOR,2022.0,35,19,16
HKG,SGP,2000.0,14,12,2
TUN,FRA,1997.0,20,29,-9
FRA,ECU,2010.0,3,3,0
BOL,FRA,2015.0,4,5,-1
ISR,RUS,2020.0,8,29,-21
KEN,CAN,2013.0,7,5,2
JPN,PHL,2004.0,19,10,9
SGP,PAK,2018.0,7,1,6
CAN,MLI,2021.0,2,2,0
FIN,DEU,2020.0,60,61,-1
RUS,CHN,2022.0,53,37,16
GUM,USA,2018.0,11,15,-4
QAT,USA,2016.0,36,75,-39
SWE,KOR,2020.0,12,26,-14
PAK,USA,2012.0,84,68,16
FRA,HRV,2018.0,10,4,6
FRA,CZE,2018.0,29,23,6
QAT,USA,2017.0,48,50,-2
NLD,ITA,2020.0,118,145,-27
DEU,LUX,2023.0,22,12,10
BRA,IND,2020.0,21,12,9
DEU,BGD,2011.0,5,9,-4
EST,FIN,2020.0,10,22,-12
CAN,ITA,2023.0,40,36,4
ARG,FRA,2022.0,24,24,0
USA,VNM,2017.0,36,28,8
BRA,IRL,2020.0,22,4,18
ESP,BEL,2020.0,92,71,21
DNK,CHN,2022.0,101,117,-16
HKG,NLD,2021.0,10,9,1
JPN,NLD,2021.0,26,25,1
UKR,EST,2021.0,2,1,1
MEX,VEN,2004.0,6,7,-1
TUR,FRA,2023.0,11,11,0
OMN,CAN,2014.0,5,3,2
KAZ,DEU,2016.0,3,6,-3
NLD,ZAF,2015.0,35,19,16
USA,KHM,2023.0,6,1,5
FRA,VNM,2016.0,60,20,40
JPN,ITA,2017.0,24,36,-12
CYP,DEU,2020.0,4,8,-4
POL,ISR,2019.0,7,3,4
POL,FRA,1998.0,30,36,-6
FRA,HRV,2022.0,2,4,-2
FRA,IDN,2020.0,17,9,8
OMN,USA,2023.0,8,3,5
FRA,IRL,2021.0,40,43,-3
GBR,BEN,1997.0,1,1,0
FIN,CHE,2004.0,9,8,1
IND,HKG,1997.0,2,2,0
TUN,DEU,2021.0,5,5,0
DEU,TUN,2022.0,2,8,-6
PHL,KOR,2023.0,7,15,-8
CAN,HKG,2019.0,21,29,-8
MMR,THA,2021.0,12,8,4
TUR,NLD,2019.0,36,22,14
ITA,CAN,2019.0,93,64,29
POL,JPN,2023.0,5,6,-1
SWE,AUS,1999.0,18,27,-9
DNK,NZL,2011.0,7,7,0
RUS,DEU,1998.0,145,140,5
IND,DEU,2000.0,65,48,17
NOR,RUS,2008.0,5,26,-21
SWE,LUX,2018.0,2,1,1
ROU,ITA,2006.0,14,11,3
AUT,CHL,2018.0,2,4,-2
CHE,BEL,2003.0,19,22,-3
POL,ESP,2014.0,12,24,-12
NGA,SAU,2002.0,1,1,0
USA,THA,2001.0,101,70,31
SEN,USA,2009.0,5,7,-2
DNK,JPN,1997.0,10,8,2
POL,NLD,1999.0,14,14,0
PRT,DNK,2001.0,4,2,2
GNB,DNK,2007.0,2,3,-1
GBR,ZAF,2007.0,68,57,11
NZL,DEU,2008.0,19,35,-16
SVK,CHE,2004.0,4,4,0
MLI,FRA,2008.0,11,4,7
ZWE,AUS,2003.0,1,1,0
FIN,DEU,1998.0,25,19,6
NLD,CAN,2017.0,91,61,30
ESP,BRA,2008.0,41,65,-24
TUR,ROU,2007.0,5,2,3
NLD,HUN,1999.0,8,4,4
RUS,CHE,2003.0,26,9,17
COL,MEX,2014.0,26,36,-10
OMN,CAN,2004.0,4,2,2
ARE,AUS,2021.0,19,21,-2
IRL,DEU,1998.0,11,16,-5
HUN,GBR,2002.0,30,25,5
SVK,GBR,2000.0,10,7,3
SVK,CZE,2022.0,66,47,19
ZAF,GHA,2019.0,15,17,-2
FRA,VNM,2013.0,24,12,12
CHN,HKG,2016.0,814,840,-26
SAU,GBR,2020.0,85,237,-152
EGY,AUS,2021.0,15,15,0
CHL,NOR,2018.0,8,1,7
BRA,URY,2020.0,34,7,27
IND,PAK,2016.0,44,19,25
PAK,AUS,2021.0,59,26,33
JPN,EGY,2019.0,86,32,54
NOR,CHN,2023.0,27,17,10
KOR,JPN,2020.0,97,127,-30
CHN,AUS,2021.0,424,674,-250
BRA,FIN,2021.0,23,3,20
VNM,USA,2020.0,40,63,-23
FRA,JPN,1998.0,72,37,35
BEL,POL,2018.0,15,16,-1
NLD,USA,2022.0,318,474,-156
ITA,JPN,2003.0,28,21,7
IRL,ITA,2008.0,14,29,-15
POL,FRA,2023.0,29,22,7
PAK,IND,2015.0,32,21,11
SAU,CHN,2021.0,56,56,0
CHN,CAN,2021.0,421,521,-100
SWE,CHN,2020.0,124,123,1
USA,AUT,2019.0,125,136,-11
IRQ,AUS,2013.0,3,4,-1
ESP,EST,2022.0,7,5,2
JOR,MYS,2017.0,10,22,-12
LUX,FRA,2021.0,25,24,1
MOZ,ESP,2021.0,3,3,0
FRA,CZE,2003.0,18,25,-7
FRA,EGY,2021.0,23,12,11
MAR,TUN,2019.0,4,5,-1
PHL,NZL,2022.0,3,1,2
AUT,SWE,2020.0,39,29,10
RUS,POL,2019.0,13,8,5
ITA,FRA,2021.0,360,359,1
IRN,KOR,2019.0,22,11,11
IND,LKA,2022.0,5,2,3
IND,LKA,2018.0,7,8,-1
BRA,SWE,2022.0,42,15,27
NPL,USA,2018.0,46,26,20
BRA,PRT,2023.0,110,91,19
ISR,GBR,2023.0,47,37,10
TWN,POL,2022.0,1,3,-2
ZAF,SWE,2016.0,13,8,5
ETH,IND,2019.0,22,79,-57
CHE,CAN,2020.0,127,125,2
NLD,FRA,2021.0,105,142,-37
PAK,AUT,2017.0,5,8,-3
BEL,ITA,2017.0,82,114,-32
RUS,FRA,2001.0,82,68,14
FRA,CHE,2001.0,249,210,39
TUR,FRA,1999.0,2,7,-5
RUS,FIN,1999.0,21,10,11
AUT,NLD,2008.0,10,17,-7
CZE,AUT,1998.0,2,13,-11
FRA,COL,2007.0,12,6,6
NLD,SWE,2007.0,28,41,-13
DNK,GRC,2001.0,5,4,1
NAM,ZAF,2002.0,6,3,3
UKR,ESP,1999.0,3,1,2
NLD,FIN,2003.0,9,15,-6
DNK,CAN,2003.0,29,19,10
ARG,URY,1997.0,2,1,1
CHE,AUT,1998.0,13,39,-26
JPN,HUN,1998.0,11,11,0
IND,COL,2005.0,2,1,1
GBR,CHL,2010.0,18,27,-9
ITA,BGR,2000.0,6,5,1
ZAF,AUS,1997.0,14,6,8
CAN,FIN,1999.0,12,12,0
PAN,USA,1997.0,5,6,-1
RUS,ISR,1997.0,15,9,6
SWE,NZL,2021.0,8,12,-4
GBR,PRT,1999.0,37,36,1
USA,UKR,2008.0,21,28,-7
RUS,LVA,2023.0,6,1,5
NOR,GBR,2023.0,52,64,-12
FIN,NLD,1998.0,11,9,2
AUS,JPN,1998.0,52,42,10
RUS,CHN,2003.0,3,3,0
POL,CHE,2016.0,21,19,2
GBR,ARE,2019.0,81,27,54
FRA,NOR,2011.0,31,17,14
QAT,USA,2013.0,21,44,-23
GBR,FIN,1998.0,22,23,-1
USA,NGA,2006.0,21,23,-2
FRA,POL,2002.0,42,36,6
SWE,CHN,1998.0,15,24,-9
URY,BRA,2007.0,5,4,1
PAK,GBR,2017.0,70,89,-19
GRC,CAN,2017.0,14,7,7
CZE,PRT,2016.0,7,2,5
BRA,SWE,2018.0,34,10,24
ITA,PRT,2015.0,26,36,-10
QAT,PAK,2018.0,5,6,-1
IRL,USA,2022.0,126,107,19
FRA,HUN,2021.0,12,16,-4
TWN,MYS,2015.0,8,2,6
IND,ISR,2010.0,25,13,12
DNK,BEL,2016.0,22,15,7
MYS,IDN,2020.0,123,38,85
TUR,GBR,2022.0,87,77,10
MYS,GBR,2020.0,78,147,-69
LBY,GBR,2017.0,3,6,-3
FRA,CHN,2016.0,228,169,59
IND,KOR,2014.0,189,131,58
CHN,IND,2023.0,105,45,60
MYS,SDN,2020.0,14,2,12
RUS,GRC,2023.0,3,2,1
KOR,FRA,2019.0,28,27,1
DEU,SYR,2019.0,4,4,0
BRA,SWE,2016.0,23,19,4
ITA,IRN,2019.0,28,70,-42
FIN,IND,2021.0,13,36,-23
TLS,AUS,2023.0,6,4,2
SGP,PHL,2023.0,4,1,3
SWE,CZE,2020.0,11,27,-16
CUB,ESP,2018.0,23,15,8
MEX,BRA,1998.0,4,4,0
THA,KOR,2020.0,12,19,-7
CUB,DEU,2020.0,8,6,2
IND,JPN,2022.0,68,77,-9
CHE,CAN,2007.0,71,52,19
CHL,COL,2020.0,22,45,-23
MCO,FRA,2016.0,8,13,-5
QAT,CAN,2021.0,18,21,-3
ITA,AUS,2015.0,61,30,31
MDG,USA,2021.0,7,7,0
PHL,CHN,2022.0,7,12,-5
IRN,POL,2021.0,32,2,30
IRN,KOR,2009.0,3,3,0
NZL,DNK,2005.0,5,5,0
CAN,ITA,2007.0,32,48,-16
JPN,UKR,2003.0,5,5,0
FRA,GLP,2008.0,28,29,-1
MEX,RUS,2003.0,12,14,-2
AUT,FRA,1999.0,15,14,1
FRA,CIV,2002.0,20,18,2
IDN,USA,2006.0,16,26,-10
CHE,CAN,1998.0,32,49,-17
ETH,NOR,2008.0,2,7,-5
ISR,AUT,1997.0,3,1,2
GBR,FIN,1999.0,26,27,-1
BEL,PRT,2003.0,6,3,3
PAK,DEU,2011.0,23,19,4
CHL,ARG,2005.0,7,16,-9
IRL,FIN,2007.0,4,2,2
BRA,PER,2007.0,4,2,2
JPN,ISR,1997.0,3,7,-4
ZAF,AUS,2002.0,34,27,7
FIN,NOR,2003.0,8,5,3
ARE,GBR,2023.0,29,37,-8
KWT,EGY,1997.0,2,4,-2
NLD,ARG,2000.0,5,4,1
JPN,HUN,1999.0,4,4,0
SWE,IRL,1998.0,1,4,-3
DEU,SGP,2003.0,14,5,9
RUS,NOR,2020.0,12,13,-1
JPN,MYS,2003.0,15,11,4
DNK,FRA,2008.0,25,24,1
EGY,CHN,2013.0,3,9,-6
ZWE,USA,2015.0,20,9,11
GLP,FRA,2013.0,24,46,-22
AUS,GRC,2010.0,6,4,2
USA,GHA,2016.0,38,18,20
ZAF,CAN,2018.0,27,21,6
IRN,DEU,2019.0,149,46,103
CHN,JPN,2020.0,440,599,-159
MEX,ECU,2022.0,11,12,-1
DEU,CHL,2019.0,42,44,-2
COG,COD,2020.0,185,43,142
SWE,CHN,2021.0,148,133,15
SRB,DEU,2018.0,15,5,10
CHN,IRQ,2020.0,18,5,13
IND,DEU,2019.0,216,156,60
CHL,DEU,2018.0,63,48,15
BGD,CHN,2020.0,33,34,-1
BEL,EGY,2018.0,11,4,7
TUN,FRA,2020.0,129,119,10
SGP,IRL,2012.0,6,7,-1
IND,ZAF,2015.0,68,25,43
UKR,GBR,2018.0,14,38,-24
GBR,IRQ,2019.0,175,29,146
GBR,CHN,2023.0,565,398,167
HRV,ITA,2019.0,16,11,5
RUS,NOR,2019.0,8,12,-4
CAN,HKG,2023.0,18,11,7
JPN,NGA,2023.0,1,5,-4
CAN,FIN,2019.0,21,17,4
BRA,NLD,2021.0,75,38,37
AUT,SWE,2019.0,35,18,17
FRA,AUT,2018.0,52,43,9
SGP,GBR,2023.0,56,64,-8
RUS,JPN,2015.0,20,16,4
TWN,GBR,2017.0,44,21,23
GEO,FRA,2017.0,28,1,27
JPN,AFG,2019.0,6,3,3
HKG,GBR,2023.0,52,49,3
IRN,KOR,2020.0,29,12,17
ARE,AUS,2023.0,12,20,-8
TUR,DEU,2019.0,102,56,46
UGA,ZAF,2020.0,4,10,-6
HKG,USA,2017.0,133,168,-35
GRC,SWE,2018.0,25,10,15
FRA,JPN,2019.0,122,83,39
ESP,COL,2020.0,125,124,1
CHN,BGD,2022.0,68,33,35
PRT,CHE,2020.0,33,12,21
CUB,DEU,2021.0,4,3,1
DEU,IDN,2022.0,29,15,14
AUS,ZAF,2023.0,15,21,-6
AUS,BRA,2015.0,36,54,-18
SWE,IRL,2021.0,12,16,-4
GRC,FIN,2019.0,3,4,-1
MYS,IRL,2012.0,3,7,-4
DNK,GRC,2017.0,4,14,-10
MEX,SWE,2020.0,13,6,7
GRD,USA,2022.0,16,8,8
IRQ,HUN,2022.0,15,10,5
NGA,CHN,2022.0,23,37,-14
DNK,GBR,2005.0,74,49,25
HKG,SAU,2014.0,5,1,4
BRA,PER,2021.0,82,26,56
CZE,HUN,2022.0,7,6,1
SAU,KOR,2020.0,11,39,-28
BRA,ECU,2020.0,18,6,12
HKG,FIN,2021.0,2,1,1
SRB,MNE,2022.0,45,59,-14
KGZ,USA,2004.0,2,2,0
SWE,ETH,2021.0,5,5,0
FRA,JPN,2021.0,111,93,18
USA,IRL,2003.0,99,83,16
CHL,ARG,2006.0,15,15,0
RUS,DEU,1997.0,123,122,1
GBR,MYS,2016.0,141,102,39
GBR,RUS,1997.0,57,60,-3
HUN,DEU,1999.0,34,26,8
ESP,VEN,2010.0,44,52,-8
ISR,CHE,2004.0,12,2,10
FRA,IND,1998.0,8,16,-8
JPN,EGY,1999.0,13,8,5
FIN,SWE,2004.0,37,40,-3
CZE,GBR,1998.0,34,51,-17
GBR,CZE,2001.0,33,51,-18
DNK,FIN,2004.0,8,10,-2
ECU,FRA,2003.0,10,1,9
DEU,KOR,2013.0,53,47,6
FJI,USA,2018.0,3,3,0
FRA,SGP,2012.0,32,23,9
ITA,BGR,2002.0,8,6,2
EGY,GBR,2022.0,77,73,4
NLD,POL,2019.0,19,16,3
ESP,BRA,2003.0,43,34,9
SWE,CAN,2001.0,44,34,10
EGY,OMN,2023.0,12,9,3
IRN,JPN,2001.0,4,4,0
LUX,DEU,2011.0,14,39,-25
NOR,GBR,2002.0,46,46,0
DEU,BRA,1998.0,32,25,7
TUR,FRA,2019.0,26,27,-1
CHE,ESP,1998.0,29,22,7
CAN,NZL,2002.0,23,40,-17
FRA,GLP,2016.0,27,43,-16
JPN,TWN,2006.0,33,17,16
USA,EGY,2002.0,63,43,20
ITA,CZE,2010.0,9,14,-5
IDN,DEU,2016.0,7,34,-27
DNK,FRA,2017.0,36,70,-34
MYS,SGP,2022.0,34,21,13
GBR,HUN,2004.0,27,28,-1
UKR,AUT,2000.0,6,2,4
FRA,SAU,1999.0,1,1,0
IRL,FRA,2004.0,15,13,2
SVK,CZE,2008.0,52,24,28
CAN,BEL,2014.0,42,41,1
HUN,ROU,2019.0,21,14,7
BRA,PRT,1997.0,19,14,5
IRL,GBR,2001.0,133,247,-114
NPL,MYS,2012.0,1,1,0
QAT,MAR,2018.0,1,1,0
HUN,USA,1998.0,79,69,10
IND,MYS,2012.0,69,45,24
NOR,SWE,2008.0,39,71,-32
REU,FRA,1998.0,5,1,4
NLD,IND,2015.0,32,24,8
CAN,HUN,2013.0,5,15,-10
EST,FRA,2002.0,2,3,-1
FRA,RUS,2013.0,51,56,-5
FRA,ISR,2003.0,19,37,-18
USA,RUS,2010.0,171,210,-39
KWT,ARE,2006.0,2,3,-1
LBN,USA,2016.0,83,63,20
GBR,RUS,2005.0,37,40,-3
MAR,TUN,1999.0,5,1,4
DNK,FIN,2008.0,10,7,3
SWE,HUN,2002.0,5,6,-1
LVA,USA,2011.0,5,4,1
NLD,ESP,1999.0,41,44,-3
HUN,DEU,1998.0,34,23,11
GBR,EGY,1999.0,13,14,-1
RUS,JPN,2001.0,51,41,10
ESP,BRA,2013.0,115,69,46
SAU,SDN,2002.0,2,2,0
HRV,DEU,2007.0,11,17,-6
NLD,SWE,2011.0,45,42,3
ITA,SRB,2003.0,11,6,5
CUB,ITA,1997.0,3,2,1
FRA,GUF,2018.0,61,33,28
ROU,FRA,2006.0,30,41,-11
RUS,ESP,1999.0,14,9,5
FIN,SWE,2015.0,70,54,16
GRL,NOR,2010.0,3,1,2
DEU,IND,1997.0,34,46,-12
USA,SVK,2000.0,17,15,2
CHN,TWN,2012.0,100,176,-76
USA,CMR,2014.0,12,2,10
SAU,IND,2016.0,64,181,-117
CZE,GBR,1999.0,37,35,2
DNK,NOR,1998.0,13,14,-1
NLD,DEU,1999.0,121,162,-41
IND,FIN,2020.0,26,17,9
MYS,FRA,2020.0,9,7,2
ESP,CHE,2017.0,112,63,49
NLD,AUS,2017.0,109,79,30
NLD,POL,2021.0,20,21,-1
FIN,FRA,2021.0,27,30,-3
BGD,MYS,2015.0,41,36,5
AUT,KOR,2019.0,8,8,0
PRT,AUS,2022.0,5,12,-7
PRT,BEL,2019.0,22,10,12
RUS,SWE,2008.0,17,20,-3
MEX,GTM,2018.0,2,6,-4
SWE,ITA,2020.0,53,67,-14
USA,LUX,2020.0,11,10,1
IND,LKA,2015.0,6,9,-3
AUS,LKA,2014.0,17,20,-3
BEL,AUT,2018.0,14,30,-16
CAN,LBN,2006.0,7,8,-1
AUS,THA,2019.0,54,22,32
JPN,TWN,2023.0,38,33,5
ARM,COL,2015.0,4,2,2
GRC,ESP,2023.0,15,14,1
SWE,DNK,2020.0,106,120,-14
DEU,LUX,2019.0,45,17,28
RUS,GBR,2019.0,64,66,-2
ISR,AUS,2021.0,18,26,-8
DEU,VNM,2015.0,22,8,14
IRN,NZL,2017.0,14,11,3
TWN,USA,2013.0,274,331,-57
NOR,NLD,2003.0,8,22,-14
TWN,ESP,2022.0,4,4,0
FRA,AUT,2017.0,45,40,5
RUS,ITA,2013.0,18,16,2
USA,MWI,2019.0,19,18,1
UKR,POL,2014.0,17,11,6
AUS,CHE,2023.0,51,41,10
BEL,ETH,2016.0,14,2,12
GBR,LKA,2018.0,22,17,5
FRA,LUX,2014.0,38,26,12
RUS,FRA,2017.0,59,63,-4
CAN,OMN,2019.0,11,7,4
AUS,PAK,2017.0,23,34,-11
GBR,PRT,2009.0,64,53,11
IDN,SGP,2021.0,8,12,-4
KAZ,USA,2017.0,17,27,-10
COL,CUB,2019.0,4,7,-3
ITA,ROU,2019.0,20,9,11
IND,SGP,2023.0,37,30,7
JPN,DNK,2013.0,8,5,3
KEN,SEN,2021.0,3,1,2
IRL,ITA,2017.0,23,39,-16
DZA,CAN,2021.0,12,14,-2
KOR,AUS,2015.0,37,25,12
KOR,SAU,2015.0,22,7,15
KAZ,TUR,2022.0,7,11,-4
ZAF,ZWE,2014.0,21,28,-7
IND,RUS,2023.0,14,12,2
JPN,CHE,2017.0,42,37,5
USA,VCT,2020.0,2,2,0
PER,BRA,2023.0,16,22,-6
AUT,UGA,2021.0,1,1,0
MDA,DEU,2019.0,3,3,0
ESP,DNK,2003.0,10,12,-2
FRA,MCO,2001.0,10,4,6
ESP,BGR,2018.0,2,2,0
NGA,JPN,2021.0,7,9,-2
BRA,JPN,2018.0,14,18,-4
VNM,FRA,2021.0,36,68,-32
ITA,HRV,2019.0,11,16,-5
ESP,NLD,2019.0,97,69,28
AUT,NLD,2022.0,33,43,-10
HKG,ITA,2020.0,4,3,1
IND,MYS,2002.0,22,5,17
CZE,ITA,2008.0,5,11,-6
JOR,FRA,2023.0,2,1,1
NOR,TZA,2021.0,14,1,13
TUR,PAK,2021.0,22,26,-4
FIN,FRA,2019.0,25,38,-13
BRA,HUN,2022.0,7,3,4
IDN,TLS,2022.0,2,1,1
CHN,JPN,1999.0,165,153,12
GBR,TUR,2010.0,46,48,-2
SAU,TUN,2017.0,36,107,-71
TUR,GBR,2001.0,25,59,-34
SWE,BEL,2005.0,11,9,2
SVK,CZE,2014.0,86,73,13
KOR,DEU,2013.0,47,53,-6
DEU,ARG,2008.0,35,21,14
CHN,POL,2019.0,14,13,1
FRA,MEX,1999.0,36,21,15
SVK,CAN,2003.0,8,1,7
POL,BEL,2004.0,13,8,5
FRA,SVK,2004.0,4,4,0
FRA,MTQ,2015.0,26,28,-2
MKD,SRB,1999.0,7,11,-4
MEX,ESP,2000.0,76,66,10
SAU,HUN,2022.0,1,1,0
GBR,GMB,2023.0,11,6,5
JPN,POL,2001.0,16,18,-2
PHL,USA,2002.0,27,29,-2
CHE,AUS,2016.0,66,65,1
HUN,BEL,2013.0,7,7,0
POL,GBR,2001.0,42,31,11
SRB,GBR,2014.0,5,11,-6
USA,VEN,2015.0,10,30,-20
KWT,EGY,2006.0,2,4,-2
HUN,DEU,2020.0,48,33,15
ISR,PSE,2001.0,19,2,17
CYP,GRC,2009.0,12,28,-16
FRA,UKR,2006.0,11,8,3
NOR,FRA,2019.0,29,58,-29
MKD,SRB,1998.0,12,5,7
JPN,ISR,2010.0,5,3,2
BRA,CAN,2003.0,36,48,-12
FRA,NOR,1998.0,12,8,4
IRL,SWE,1999.0,3,2,1
NOR,ITA,2001.0,14,4,10
MNE,SRB,2002.0,5,3,2
AUT,AUS,1999.0,31,64,-33
ESP,POL,2006.0,10,6,4
ARG,URY,2006.0,4,4,0
GBR,GMB,2006.0,4,5,-1
FRA,COL,2019.0,19,21,-2
EST,GBR,2016.0,10,6,4
DEU,TWN,2015.0,19,21,-2
DEU,QAT,2020.0,11,4,7
MYS,PAK,2018.0,152,59,93
IRN,FIN,2023.0,20,10,10
USA,JOR,2012.0,45,34,11
VEN,MEX,2019.0,11,3,8
ITA,IRL,2023.0,19,20,-1
ROU,DEU,2013.0,35,35,0
TUR,BRA,2014.0,4,2,2
NLD,ETH,2013.0,8,7,1
MYS,YEM,2013.0,9,2,7
FRA,IRL,2014.0,27,39,-12
EGY,GBR,2012.0,26,61,-35
ESP,RUS,2020.0,8,21,-13
AUS,TWN,2023.0,8,13,-5
DEU,ROU,2014.0,24,42,-18
GBR,KEN,2019.0,37,28,9
SWE,IND,2020.0,46,82,-36
ITA,HUN,2017.0,7,20,-13
GBR,LBN,2016.0,11,7,4
LBN,CAN,2011.0,7,4,3
MEX,DEU,2021.0,62,41,21
FRA,RUS,2019.0,54,60,-6
LUX,IRL,2013.0,1,3,-2
FRA,AUS,2017.0,103,91,12
ITA,ZAF,2016.0,13,8,5
CHN,BFA,2013.0,1,1,0
UKR,CHE,2013.0,4,1,3
TUR,GBR,2006.0,25,45,-20
JPN,MYS,2020.0,43,39,4
PRY,BRA,2011.0,2,3,-1
SAU,SDN,2018.0,16,25,-9
CAN,KWT,2013.0,12,4,8
GBR,ROU,2012.0,14,27,-13
NLD,IRL,2016.0,14,20,-6
UGA,USA,2008.0,16,23,-7
IND,NLD,2013.0,28,19,9
LTU,SWE,2019.0,4,8,-4
EGY,ESP,2017.0,14,16,-2
SWE,CHN,2003.0,31,31,0
SAU,BEL,2018.0,3,5,-2
SGP,KOR,2019.0,29,34,-5
GHA,ZAF,2009.0,2,3,-1
RUS,SGP,2015.0,3,6,-3
RUS,KOR,2008.0,13,7,6
GBR,JOR,2012.0,23,11,12
MYS,IRN,2020.0,75,26,49
NLD,SWE,2013.0,54,40,14
NLD,AUS,2012.0,68,52,16
ZAF,NGA,2013.0,31,46,-15
NGA,ZAF,2017.0,101,68,33
DEU,NOR,2015.0,59,48,11
NOR,CZE,2021.0,9,10,-1
FRA,MAR,2015.0,115,54,61
NOR,USA,2013.0,83,90,-7
FRA,KEN,2012.0,9,6,3
GBR,VNM,2021.0,27,20,7
SWE,AUT,2011.0,12,17,-5
CHN,SAU,2013.0,25,12,13
ISL,NLD,2016.0,3,3,0
NOR,ESP,2010.0,11,11,0
THA,TWN,2014.0,4,12,-8
PAK,CHN,2012.0,46,50,-4
NZL,QAT,2014.0,3,1,2
LUX,ESP,2015.0,4,9,-5
IND,CHN,2015.0,85,29,56
UKR,SWE,2017.0,8,5,3
DEU,VNM,2000.0,4,2,2
UKR,AUT,2014.0,6,5,1
SVN,FRA,2012.0,6,7,-1
USA,TUN,2009.0,2,8,-6
OMN,IND,2011.0,7,14,-7
KWT,GBR,2013.0,5,14,-9
HUN,ITA,2020.0,8,12,-4
NPL,AUS,2016.0,13,7,6
PAK,MYS,2012.0,31,10,21
MYS,UGA,2014.0,1,1,0
FRA,COL,2013.0,15,16,-1
DEU,NGA,2021.0,13,13,0
JPN,HKG,2018.0,10,11,-1
ZAF,SAU,2016.0,9,11,-2
CHN,IND,2017.0,45,173,-128
BGD,CAN,2018.0,33,18,15
URY,COL,2022.0,2,2,0
FJI,AUS,2014.0,7,13,-6
CHN,IND,2018.0,56,232,-176
TUR,ITA,2014.0,14,18,-4
POL,DNK,2012.0,8,7,1
ROU,FRA,2015.0,35,46,-11
TUN,OMN,2020.0,5,2,3
NPL,JPN,2015.0,3,9,-6
DEU,KOR,2021.0,65,70,-5
VEN,DEU,2012.0,4,2,2
EGY,FRA,2018.0,14,28,-14
CAN,YEM,2021.0,1,2,-1
POL,DEU,2022.0,81,86,-5
SGP,FRA,2017.0,27,34,-7
SWE,BEL,2016.0,30,21,9
JPN,AUS,2020.0,67,70,-3
JPN,RUS,2020.0,19,15,4
COD,BEL,2014.0,3,6,-3
COG,NLD,2017.0,1,1,0
ZMB,USA,2017.0,15,23,-8
AUS,LKA,2006.0,4,5,-1
NZL,MYS,2016.0,24,16,8
BEL,UKR,2023.0,2,4,-2
FRA,NGA,2017.0,1,2,-1
MAR,MAC,2015.0,14,7,7
SGP,CAN,2019.0,37,38,-1
GRC,NLD,2021.0,26,27,-1
TWN,SAU,2015.0,16,2,14
IRL,NLD,2016.0,20,14,6
DEU,BGR,2023.0,4,3,1
NGA,DEU,2017.0,12,13,-1
CHE,MNG,2015.0,2,1,1
PAK,SAU,2014.0,59,36,23
PAK,KOR,2014.0,29,19,10
CZE,DNK,2018.0,3,3,0
PER,NLD,2010.0,2,1,1
GBR,CHN,2008.0,152,137,15
NLD,AUT,2017.0,44,24,20
NIC,CRI,2018.0,2,3,-1
HKG,CHE,2017.0,6,5,1
CHE,POL,2019.0,19,26,-7
PSE,GBR,2019.0,3,8,-5
TWN,NGA,2016.0,1,1,0
KOR,JPN,2003.0,96,164,-68
EST,FIN,2016.0,21,12,9
MMR,THA,2014.0,1,3,-2
TUR,NLD,2014.0,24,19,5
SGP,ARE,2013.0,7,2,5
ARE,SGP,2017.0,3,6,-3
CAN,ISR,2019.0,61,60,1
CHN,ESP,2018.0,43,68,-25
RUS,SRB,2018.0,12,8,4
BRA,IRL,2022.0,30,7,23
JPN,NLD,2014.0,13,25,-12
CHE,THA,2020.0,7,5,2
FIN,ITA,2007.0,13,9,4
KWT,CAN,2009.0,7,11,-4
KOR,ESP,2011.0,5,2,3
SAU,NOR,2017.0,3,1,2
QAT,EGY,2019.0,11,15,-4
GRC,AUS,2017.0,8,9,-1
BEL,COL,2018.0,7,5,2
GBR,ISR,2016.0,44,73,-29
ESP,UKR,2016.0,4,4,0
MYS,LBY,2016.0,9,3,6
AUT,ITA,2022.0,61,68,-7
POL,FRA,2017.0,46,43,3
DEU,ARE,2022.0,8,8,0
ESP,PRY,2019.0,9,1,8
BRA,PAK,2013.0,5,10,-5
JPN,TWN,2015.0,48,60,-12
ARE,GBR,2018.0,30,69,-39
GRC,CZE,2018.0,9,2,7
DEU,ISR,2014.0,51,46,5
MYS,THA,2012.0,4,2,2
MDA,ROU,2023.0,4,1,3
LTU,FIN,2017.0,1,3,-2
CHL,ARG,2015.0,29,28,1
SGP,ZAF,2020.0,11,11,0
CAN,POL,2021.0,13,14,-1
JPN,IND,2016.0,68,124,-56
VNM,KOR,2010.0,13,18,-5
COL,CAN,2018.0,19,14,5
AUS,VNM,2017.0,29,26,3
IND,PAK,2023.0,35,27,8
SWE,KOR,2016.0,9,13,-4
TZA,KEN,2015.0,6,9,-3
TUN,USA,2005.0,6,7,-1
IND,ESP,2007.0,10,4,6
KEN,GBR,2017.0,35,29,6
SRB,BIH,2019.0,15,12,3
MYS,DEU,2013.0,9,14,-5
TUR,POL,2021.0,10,2,8
NGA,COL,2010.0,2,1,1
THA,AUT,2014.0,6,8,-2
BEL,SWE,2014.0,14,22,-8
IRL,DNK,2019.0,6,6,0
THA,AUS,2018.0,15,43,-28
KOR,RUS,2015.0,9,8,1
TUR,NGA,2014.0,4,3,1
SAU,ARE,2020.0,42,12,30
TUR,NLD,2015.0,16,29,-13
MEX,POL,2019.0,5,2,3
NOR,AUS,2019.0,18,20,-2
ESP,CYP,2015.0,3,1,2
BRA,BEL,2016.0,22,26,-4
TZA,BEL,2016.0,5,1,4
CHL,NLD,2016.0,10,6,4
IND,TUR,2017.0,12,8,4
GMB,ITA,2023.0,1,1,0
CHN,ESP,2016.0,34,37,-3
HKG,THA,2021.0,8,6,2
DEU,ISL,2015.0,6,8,-2
NLD,ZAF,2019.0,27,33,-6
NOR,CHE,2019.0,18,35,-17
IND,THA,2018.0,19,10,9
BRA,AUT,2023.0,12,5,7
AUS,IRQ,2020.0,56,8,48
COL,ECU,2023.0,5,2,3
IRL,ESP,2018.0,37,48,-11
NPL,GBR,2020.0,5,18,-13
DZA,FRA,2020.0,69,123,-54
KOR,AUT,2020.0,10,5,5
OMN,CAN,2019.0,7,11,-4
JPN,IRN,2017.0,22,20,2
EST,SWE,2020.0,3,7,-4
DEU,ROU,2015.0,35,33,2
ALB,ITA,2022.0,9,4,5
IND,FRA,2023.0,59,36,23
RWA,NLD,2019.0,1,2,-1
JOR,YEM,2020.0,3,1,2
HUN,BRA,2017.0,4,3,1
ISR,CHN,2018.0,31,34,-3
IND,MYS,2022.0,30,61,-31
MYS,AUT,2023.0,1,1,0
EST,CZE,2018.0,3,7,-4
GRC,ZAF,2017.0,4,1,3
ISL,NOR,2020.0,7,6,1
JOR,SAU,2014.0,40,22,18
SAU,JOR,2017.0,38,32,6
ISR,GHA,2022.0,1,1,0
ITA,BGR,2017.0,4,1,3
KWT,IND,2017.0,3,7,-4
ARG,GBR,2022.0,18,8,10
CHN,MEX,2017.0,8,7,1
AUT,EGY,2020.0,8,4,4
TUR,ARE,2021.0,12,6,6
UGA,GBR,2017.0,12,19,-7
VEN,ITA,2021.0,2,2,0
POL,PRT,2017.0,6,7,-1
NPL,AUS,2018.0,14,8,6
QAT,BEL,2021.0,3,1,2
SEN,FRA,2017.0,34,33,1
IRN,TUR,2023.0,48,10,38
CHN,DZA,2020.0,16,5,11
MAC,HKG,2018.0,8,13,-5
NLD,SGP,2020.0,16,23,-7
DNK,GRC,2002.0,2,4,-2
POL,IRN,2019.0,2,12,-10
ALB,ITA,2018.0,3,8,-5
ROU,GBR,2019.0,29,29,0
SAU,NZL,2020.0,9,1,8
AUS,FIN,2023.0,14,10,4
BEL,TWN,2016.0,4,3,1
ISR,IND,2023.0,63,79,-16
FIN,AUT,2019.0,13,12,1
PAK,GBR,2023.0,62,40,22
BEL,PER,2020.0,3,3,0
NLD,CHL,2017.0,14,11,3
FRA,ZAF,2014.0,29,17,12
MYS,LKA,2020.0,6,4,2
BLR,NOR,2015.0,1,1,0
NOR,SGP,2019.0,2,3,-1
GBR,GHA,2023.0,21,18,3
DEU,SVK,2022.0,11,11,0
PAK,TUR,2022.0,17,32,-15
DEU,IDN,2005.0,7,5,2
EGY,OMN,2004.0,5,3,2
MYS,SGP,2002.0,6,1,5
VNM,THA,2017.0,11,10,1
GEO,JPN,2005.0,1,1,0
ISR,CAN,2019.0,60,61,-1
CAN,COL,2005.0,3,1,2
PAK,TUR,2017.0,20,14,6
NOR,NPL,2021.0,6,4,2
GBR,BHR,2021.0,7,6,1
SWE,KOR,2022.0,10,12,-2
NOR,RUS,2019.0,12,8,4
RUS,IRN,2020.0,4,12,-8
IRN,CHN,2024.0,2,1,1
FRA,MDG,2017.0,20,7,13
LAO,AUS,2018.0,2,1,1
ZAF,ZMB,2017.0,6,6,0
CHE,BEL,2023.0,38,39,-1
NOR,GBR,2017.0,62,102,-40
BRA,AUS,2015.0,54,36,18
FRA,GAB,2017.0,7,7,0
HUN,CZE,2019.0,10,7,3
NLD,LUX,2017.0,7,4,3
ZAF,UGA,2016.0,15,7,8
GTM,CRI,2021.0,2,1,1
ESP,MAR,2022.0,14,16,-2
VNM,THA,2022.0,13,18,-5
GBR,ISL,1999.0,3,4,-1
SVN,CHN,2019.0,2,2,0
LBN,CHE,2021.0,10,2,8
TWN,ITA,2017.0,4,8,-4
POL,MKD,2016.0,1,1,0
ARG,ITA,2019.0,18,14,4
PHL,AUS,2021.0,12,16,-4
AUS,AUT,2021.0,28,22,6
KOR,SWE,2023.0,14,4,10
POL,NLD,2017.0,19,22,-3
FRA,ISR,2011.0,19,21,-2
CMR,FRA,2011.0,14,29,-15
FRA,GAB,2022.0,8,4,4
NGA,BEN,2012.0,5,4,1
GBR,MWI,2000.0,8,4,4
UKR,FRA,1997.0,9,10,-1
NOR,CHE,2009.0,8,18,-10
FRA,VEN,1998.0,14,6,8
RUS,HKG,2005.0,1,5,-4
MEX,CUB,2002.0,18,22,-4
USA,ISL,1997.0,10,4,6
ITA,AUT,1998.0,14,14,0
ESP,ITA,2003.0,91,89,2
ESP,VEN,2001.0,19,13,6
FRA,KEN,1997.0,1,2,-1
MEX,AUS,2006.0,6,2,4
PAK,CZE,2017.0,2,1,1
JPN,NGA,2001.0,5,4,1
NOR,ISL,2014.0,7,10,-3
AUT,SVK,2017.0,12,4,8
IND,IRN,2005.0,9,1,8
VNM,FRA,2003.0,2,6,-4
FRA,THA,2004.0,9,2,7
BGR,ITA,2015.0,4,4,0
CHE,SWE,2009.0,43,38,5
GBR,TTO,2006.0,8,2,6
VEN,COL,2015.0,26,5,21
BRN,USA,2000.0,2,1,1
NOR,POL,2003.0,7,4,3
PAK,MYS,2005.0,2,2,0
ARE,USA,2010.0,16,50,-34
ESP,AUS,2010.0,28,28,0
FRA,AUT,2012.0,35,34,1
AUT,GBR,2004.0,36,33,3
SGP,MYS,2001.0,4,3,1
PRT,ESP,2001.0,31,32,-1
CAN,RUS,1998.0,14,33,-19
ARG,DEU,2002.0,22,20,2
ARG,CUB,2015.0,3,8,-5
DNK,NLD,2000.0,19,25,-6
IDN,USA,2018.0,24,44,-20
HRV,AUT,2009.0,3,5,-2
USA,JOR,2002.0,22,15,7
RUS,AUS,1998.0,9,5,4
NGA,GHA,2013.0,5,2,3
SAU,GRC,2019.0,3,8,-5
BRA,AUT,2006.0,4,3,1
AUS,BTN,2018.0,7,2,5
ARG,FRA,1998.0,12,10,2
CZE,UKR,1998.0,3,1,2
SRB,GBR,2023.0,4,7,-3
RUS,CZE,1998.0,6,10,-4
ARE,OMN,2007.0,1,2,-1
HUN,AUT,2004.0,8,7,1
SRB,DEU,1997.0,8,18,-10
MEX,FRA,2000.0,31,35,-4
CHE,ZAF,1997.0,8,3,5
USA,VEN,2000.0,25,45,-20
USA,KAZ,2012.0,12,5,7
BGR,JPN,2000.0,7,5,2
CHN,RUS,2003.0,3,3,0
BRA,MEX,1998.0,4,4,0
AUT,PAK,2012.0,21,4,17
AUT,DNK,2006.0,4,5,-1
SVK,POL,2003.0,2,5,-3
DEU,VEN,2010.0,4,4,0
BGR,JPN,2010.0,2,2,0
SYR,DEU,2004.0,3,3,0
UGA,ETH,2015.0,2,2,0
JOR,SAU,2008.0,10,4,6
SAU,JOR,2016.0,39,42,-3
DEU,LTU,2003.0,6,8,-2
CIV,FRA,1999.0,9,18,-9
ITA,CZE,2014.0,17,6,11
JOR,ARE,2019.0,35,11,24
CZE,JPN,1999.0,2,3,-1
CHE,RUS,2001.0,13,22,-9
BEL,ROU,2016.0,2,12,-10
GBR,MYS,2005.0,54,23,31
FRA,FIN,1998.0,9,12,-3
COL,AUS,2004.0,3,2,1
BOL,USA,2013.0,1,5,-4
USA,BOL,2019.0,8,1,7
BEL,IND,2017.0,19,37,-18
GRC,FRA,2006.0,19,13,6
EST,SWE,2007.0,8,6,2
HRV,FRA,2006.0,3,3,0
FRA,HRV,2007.0,2,5,-3
BEL,UKR,2000.0,2,2,0
AUS,ZWE,2017.0,2,3,-1
ETH,KEN,1997.0,4,1,3
GBR,AUT,1999.0,30,29,1
CZE,CAN,1999.0,5,6,-1
TUR,IRL,2010.0,2,2,0
CUB,MEX,1998.0,16,7,9
GBR,LKA,2005.0,15,8,7
SRB,BRA,2003.0,1,3,-2
GBR,IRN,1997.0,14,8,6
DNK,ITA,2007.0,12,10,2
AUS,NLD,1998.0,17,26,-9
UZB,KOR,2010.0,3,1,2
RUS,MDA,2002.0,3,3,0
PRT,IRL,2007.0,4,1,3
NZL,ZAF,2011.0,7,11,-4
NOR,EST,2000.0,2,2,0
GIN,GNQ,2018.0,5,8,-3
KEN,USA,2016.0,61,70,-9
BRA,GBR,1998.0,47,71,-24
CAN,SWE,1999.0,31,34,-3
CAN,CZE,2003.0,7,6,1
GRC,FRA,2000.0,13,33,-20
ESP,MEX,1999.0,57,38,19
AUS,BRA,2006.0,11,7,4
GBR,ZWE,1999.0,11,7,4
HUN,FRA,2005.0,8,9,-1
JPN,MYS,2007.0,22,13,9
KWT,NGA,2006.0,2,1,1
IND,KEN,2011.0,2,1,1
AUS,DNK,2012.0,31,29,2
NZL,JPN,2012.0,12,9,3
PAK,GBR,2006.0,22,34,-12
GBR,IRN,2005.0,69,15,54
CAN,SRB,1997.0,3,4,-1
DZA,ITA,2003.0,3,6,-3
FRA,GLP,1997.0,10,12,-2
BEN,FRA,2008.0,9,9,0
CAN,SEN,2019.0,2,4,-2
FRA,GLP,2012.0,32,36,-4
CHL,USA,2001.0,56,67,-11
JPN,ZMB,2008.0,2,1,1
CAN,BEL,2000.0,13,31,-18
JPN,NPL,2000.0,3,2,1
PRT,NLD,1999.0,13,10,3
IRN,SAU,2023.0,2,2,0
USA,LKA,2003.0,9,10,-1
EST,USA,2000.0,5,3,2
EST,USA,2006.0,2,6,-4
ARG,CAN,2000.0,11,6,5
SWE,THA,2006.0,4,6,-2
IND,NOR,2009.0,11,1,10
BEN,BEL,1998.0,2,2,0
GBR,MEX,1998.0,24,22,2
ITA,IND,2018.0,39,46,-7
RUS,BEL,2012.0,13,11,2
UGA,GBR,2018.0,13,23,-10
SRB,SVK,2009.0,1,2,-1
DEU,CHL,2013.0,29,30,-1
BGR,SRB,2004.0,8,1,7
DNK,TUR,2000.0,1,1,0
BRA,GBR,1999.0,39,68,-29
HUN,SRB,2003.0,6,1,5
IND,ARE,2002.0,2,1,1
DNK,FIN,2010.0,7,10,-3
POL,NOR,1999.0,2,1,1
NLD,GRC,2006.0,11,5,6
GBR,NGA,2010.0,33,38,-5
GBR,NGA,2023.0,29,72,-43
GBR,MLT,1999.0,6,5,1
USA,VEN,2010.0,28,37,-9
JPN,AUS,1999.0,36,62,-26
GBR,POL,2010.0,53,61,-8
ZAF,NAM,2002.0,3,6,-3
NAM,USA,2019.0,5,5,0
UKR,ESP,2003.0,5,4,1
KOR,CHN,2001.0,20,32,-12
USA,JAM,2003.0,9,12,-3
CZE,UKR,1999.0,3,2,1
ISR,BLR,2007.0,1,1,0
USA,SAU,2002.0,50,36,14
SWE,SGP,2002.0,1,4,-3
AUT,CZE,2002.0,11,17,-6
ESP,EST,2000.0,1,3,-2
SVN,USA,2011.0,19,21,-2
USA,MAR,2001.0,5,7,-2
JOR,SAU,2001.0,5,1,4
DEU,ISR,2008.0,29,32,-3
FIN,HKG,2010.0,1,2,-1
FRA,TGO,2004.0,6,3,3
SLV,SVN,2001.0,4,6,-2
USA,BMU,1999.0,4,1,3
IRN,JPN,2006.0,5,13,-8
DEU,EGY,2018.0,64,45,19
GBR,SAU,1997.0,11,6,5
ZAF,DEU,2007.0,16,25,-9
EGY,ITA,2000.0,3,4,-1
ITA,EGY,2011.0,8,2,6
SAU,USA,2007.0,18,59,-41
SRB,CHE,2009.0,3,2,1
CHE,SRB,2011.0,4,7,-3
BEL,CHE,2018.0,64,50,14
BEL,GRC,2009.0,11,9,2
DNK,AUS,1999.0,7,17,-10
LBN,FRA,2005.0,13,25,-12
CZE,CAN,2007.0,9,5,4
CZE,SRB,1998.0,4,6,-2
USA,SVK,2015.0,19,10,9
BWA,USA,2014.0,5,12,-7
USA,LBN,2009.0,47,50,-3
LBN,SAU,2022.0,9,3,6
FRA,DZA,2000.0,35,22,13
AUT,ROU,2005.0,1,1,0
SVN,AUT,2001.0,4,7,-3
NLD,FIN,1998.0,9,11,-2
JPN,AUT,2013.0,13,9,4
DNK,PRT,2005.0,2,2,0
GBR,GHA,2010.0,22,11,11
ESP,VEN,2014.0,33,34,-1
CUB,ESP,2006.0,20,19,1
RUS,BRA,2011.0,5,4,1
IND,OMN,1997.0,1,3,-2
OMN,IND,2021.0,24,32,-8
ARG,PRT,2003.0,4,1,3
ARE,EGY,1997.0,5,2,3
BRA,CZE,2001.0,3,3,0
SWE,GRC,2002.0,3,9,-6
KWT,USA,2020.0,10,34,-24
CYP,USA,2003.0,8,9,-1
AUS,HKG,2015.0,27,49,-22
SWE,SVK,2011.0,3,1,2
BGR,ITA,2004.0,6,7,-1
LTU,USA,1998.0,9,3,6
DEU,KEN,1998.0,3,2,1
ARG,DNK,2001.0,3,1,2
GRC,SRB,1999.0,2,3,-1
DNK,CAN,1998.0,16,18,-2
FRA,AUT,2002.0,16,17,-1
CAN,AUT,2003.0,19,17,2
SAU,TUN,2012.0,5,30,-25
URY,MEX,2002.0,1,1,0
JOR,BHR,2019.0,8,2,6
DEU,UKR,2018.0,20,40,-20
SGP,FIN,2020.0,3,1,2
NLD,UGA,2019.0,5,1,4
VNM,TWN,2017.0,9,39,-30
SEN,FRA,2022.0,19,23,-4
NZL,NLD,2011.0,13,14,-1
SAU,JOR,2022.0,26,17,9
USA,MYS,2020.0,38,59,-21
TUR,IRN,2023.0,10,48,-38
PAK,SWE,2018.0,11,14,-3
MAR,DEU,2023.0,6,3,3
DZA,GBR,2020.0,3,6,-3
USA,HTI,2015.0,13,5,8
LUX,TUR,2022.0,1,1,0
URY,ARG,2023.0,3,4,-1
CHN,AUT,2008.0,9,6,3
NLD,UGA,2021.0,7,4,3
PAK,CZE,2016.0,3,3,0
CZE,HRV,2018.0,5,5,0
ARG,NLD,2019.0,7,5,2
CHE,FIN,2019.0,15,14,1
ITA,KAZ,2022.0,4,5,-1
RUS,ZAF,2021.0,3,3,0
CHN,ETH,2020.0,14,16,-2
CHN,SRB,2020.0,2,2,0
JPN,COL,2017.0,2,1,1
ITA,HUN,2022.0,8,14,-6
QAT,AUS,2019.0,11,9,2
ZMB,USA,2022.0,12,11,1
VNM,IRL,2020.0,2,3,-1
CHE,MLT,2020.0,1,2,-1
CHE,KEN,2012.0,5,2,3
IND,NGA,2018.0,26,11,15
ECU,CHL,2016.0,3,8,-5
NOR,NPL,2019.0,4,3,1
SGP,DNK,2013.0,5,7,-2
IND,NOR,2021.0,31,12,19
TZA,ITA,2018.0,2,5,-3
SVK,HUN,2023.0,7,4,3
TUR,CZE,2018.0,8,2,6
MLI,CAN,2015.0,4,3,1
ROU,BGR,2020.0,3,4,-1
IRQ,EGY,2018.0,1,7,-6
OMN,IND,2019.0,16,40,-24
GHA,CHN,2019.0,25,16,9
LUX,GBR,2021.0,14,15,-1
COL,CAN,2016.0,21,8,13
TUR,DNK,2015.0,4,3,1
NPL,KOR,2020.0,6,14,-8
ESP,IND,2019.0,25,22,3
THA,CHE,2020.0,5,7,-2
CZE,NOR,2020.0,7,5,2
AUT,TUR,2020.0,4,11,-7
PAK,TUR,2018.0,22,11,11
HUN,PRT,2022.0,3,1,2
CHE,IRL,2020.0,15,17,-2
CHL,AUS,2021.0,39,15,24
MLI,USA,2015.0,6,6,0
ITA,ISR,2019.0,26,21,5
CAN,QAT,2020.0,17,14,3
PAN,ITA,2020.0,1,2,-1
BEL,BGD,2023.0,2,1,1
MYS,HKG,2018.0,6,4,2
RUS,MEX,2020.0,7,7,0
RUS,HUN,2022.0,2,3,-1
IRL,CHN,2014.0,16,18,-2
DEU,COL,2013.0,14,23,-9
PRY,BRA,2021.0,3,5,-2
ARE,PAK,2022.0,11,19,-8
ZWE,BEL,2020.0,1,1,0
TUN,BEL,2020.0,9,6,3
CHN,KAZ,2021.0,15,6,9
BRA,EST,2022.0,3,2,1
IRL,DEU,2016.0,42,45,-3
IND,LTU,2019.0,1,1,0
HKG,SAU,2023.0,3,3,0
USA,BGD,2023.0,63,122,-59
BHR,GBR,2012.0,4,5,-1
VNM,SWE,2016.0,1,3,-2
AUT,PRT,2023.0,5,7,-2
THA,DEU,2016.0,13,32,-19
SUR,NLD,2021.0,4,5,-1
ARE,TUR,2020.0,2,7,-5
BEL,CHL,2015.0,7,11,-4
IDN,NLD,2015.0,19,21,-2
TWN,CZE,2021.0,5,2,3
DNK,IND,2023.0,13,13,0
CHL,ARG,2014.0,21,24,-3
GIN,MLI,2013.0,1,2,-1
CAN,NLD,2023.0,43,35,8
BEL,NOR,2010.0,6,7,-1
ITA,BGR,2018.0,7,2,5
NLD,KOR,2002.0,2,3,-1
MCO,FRA,2000.0,6,6,0
MTQ,FRA,2002.0,8,13,-5
CHL,MEX,2021.0,22,33,-11
DNK,CZE,2022.0,4,5,-1
IRQ,RUS,2021.0,6,14,-8
GHA,CHN,2021.0,13,81,-68
ETH,NGA,2005.0,2,2,0
ITA,FIN,2015.0,18,23,-5
AFG,IND,2017.0,1,3,-2
DNK,NPL,2015.0,1,1,0
NZL,IND,2011.0,12,5,7
AUS,ITA,2004.0,17,23,-6
NGA,ITA,2022.0,6,7,-1
VEN,BRA,2020.0,14,6,8
IRN,ZAF,2019.0,12,1,11
UKR,TWN,2001.0,4,1,3
EGY,PAK,2021.0,10,6,4
USA,LAO,2014.0,2,6,-4
FRA,PAK,2017.0,25,10,15
SAU,AUS,2012.0,6,13,-7
DEU,NZL,2013.0,24,25,-1
POL,SVK,2013.0,7,6,1
TWN,SWE,2020.0,8,2,6
TWN,CAN,1999.0,6,9,-3
CHL,MEX,2019.0,16,27,-11
USA,NGA,2017.0,48,61,-13
HKG,CAN,2017.0,22,22,0
FRA,MYS,2009.0,5,3,2
NGA,CYP,2021.0,2,7,-5
IND,NOR,2019.0,19,14,5
TUR,GRC,2020.0,9,6,3
SRB,BIH,2021.0,23,16,7
IND,LUX,2021.0,9,1,8
NGA,AUS,2023.0,8,5,3
MYS,JOR,2023.0,24,8,16
IRN,RUS,2019.0,17,4,13
ESP,IND,2021.0,24,33,-9
MYS,OMN,2023.0,11,2,9
NOR,PRT,2022.0,3,6,-3
FRA,PAK,2018.0,16,11,5
OMN,GBR,2020.0,11,29,-18
NZL,PAK,2020.0,11,8,3
COD,FRA,2021.0,2,8,-6
IRN,AUT,2017.0,13,7,6
USA,ISL,2005.0,18,3,15
IND,AUS,2002.0,31,20,11
AUS,POL,2021.0,10,13,-3
CIV,ZAF,2016.0,11,3,8
KOR,ETH,2021.0,11,10,1
UKR,GBR,1997.0,15,31,-16
USA,ARE,2003.0,18,9,9
ARE,MYS,2012.0,1,6,-5
EGY,CAN,2009.0,16,21,-5
ISR,AUS,2003.0,13,9,4
AUS,ISR,2004.0,7,11,-4
USA,PHL,2005.0,20,23,-3
KEN,CAN,2000.0,3,3,0
EGY,CAN,2011.0,18,27,-9
BRA,COL,1999.0,5,2,3
BGR,DEU,2019.0,6,9,-3
USA,BGR,2010.0,15,10,5
CAN,NOR,2000.0,10,20,-10
MKD,USA,2001.0,2,1,1
NCL,FRA,1997.0,5,5,0
AUT,POL,2002.0,6,7,-1
COL,SWE,1997.0,2,1,1
FRA,ZAF,2008.0,22,16,6
BGR,USA,2004.0,13,18,-5
CHN,BRA,2012.0,4,5,-1
SEN,GUF,2000.0,2,1,1
NOR,FIN,2007.0,8,5,3
PER,NIC,2018.0,1,1,0
ISL,GBR,2008.0,7,9,-2
BRA,ISR,2021.0,7,5,2
PAK,GBR,2000.0,23,23,0
NCL,FRA,2005.0,13,27,-14
JPN,TWN,2014.0,46,53,-7
NLD,MEX,2011.0,14,13,1
FRA,HTI,2012.0,1,1,0
CAN,LBN,2014.0,13,10,3
IND,ZAF,2010.0,32,11,21
DNK,SVK,2008.0,1,2,-1
ITA,DNK,2000.0,11,18,-7
AUS,IRL,1998.0,8,13,-5
UKR,JPN,2010.0,6,4,2
VNM,USA,2003.0,5,15,-10
USA,ECU,2002.0,7,6,1
BLR,DEU,2006.0,10,8,2
CAN,MEX,2009.0,26,22,4
SVN,GBR,2005.0,7,11,-4
NGA,CMR,1999.0,4,1,3
CAF,FRA,2012.0,8,3,5
SWE,ESP,2000.0,19,17,2
GBR,SRB,2002.0,15,12,3
NLD,GRC,2023.0,20,9,11
CAN,DNK,2015.0,26,21,5
SVK,USA,2003.0,31,18,13
BEL,CHN,2002.0,14,17,-3
HKG,JPN,2004.0,8,6,2
FRA,CUB,2014.0,2,6,-4
NOR,RUS,2009.0,13,17,-4
DEU,EST,2015.0,5,8,-3
POL,CAN,2003.0,17,17,0
FRA,KOR,1999.0,6,4,2
CUB,ITA,2018.0,3,2,1
LUX,BEL,2021.0,15,18,-3
NCL,FRA,2002.0,12,9,3
CUB,MEX,1999.0,14,10,4
IND,AUT,2006.0,9,4,5
FRA,ZAF,2004.0,12,5,7
SVN,SVK,2008.0,30,23,7
RUS,TJK,1998.0,1,5,-4
HRV,USA,2020.0,14,14,0
SAU,EGY,2004.0,31,41,-10
ISR,ETH,2000.0,2,1,1
HUN,ITA,1998.0,7,5,2
ZAF,FRA,2002.0,21,15,6
VEN,ESP,2007.0,32,24,8
USA,OMN,2011.0,9,7,2
FIN,KWT,2010.0,2,1,1
SAU,GBR,2003.0,17,26,-9
COL,ESP,1999.0,4,8,-4
FRA,CMR,2012.0,23,17,6
FRA,TUR,2001.0,11,7,4
TUR,FRA,2003.0,5,11,-6
PHL,ESP,2000.0,10,5,5
NGA,USA,2006.0,23,21,2
NOR,AUT,2007.0,1,7,-6
AUS,POL,2019.0,5,8,-3
EGY,ARE,1999.0,10,6,4
CAN,LBN,2004.0,7,3,4
PAN,COL,2012.0,4,2,2
ZAF,NZL,2006.0,3,2,1
RUS,CZE,1999.0,17,6,11
CYP,USA,2013.0,15,23,-8
BEL,RUS,1997.0,7,6,1
OMN,EGY,2005.0,4,4,0
BEL,IRL,2003.0,5,5,0
BEL,RUS,2012.0,11,13,-2
GBR,SRB,1997.0,4,7,-3
USA,PNG,2006.0,1,2,-1
KOR,GBR,2007.0,28,40,-12
FRA,BGR,1998.0,13,13,0
NLD,NOR,1998.0,11,10,1
JPN,SWE,2000.0,25,31,-6
FRA,GRC,2017.0,28,37,-9
OMN,NZL,2001.0,1,2,-1
EGY,OMN,2001.0,3,2,1
HKG,JPN,2001.0,12,9,3
ISR,BEL,2002.0,4,4,0
CHE,AUS,2005.0,32,32,0
JPN,DNK,2011.0,6,11,-5
NLD,FIN,2007.0,11,20,-9
VEN,USA,2002.0,65,38,27
DEU,SRB,2000.0,10,25,-15
SVK,DNK,2015.0,1,1,0
USA,PAN,2000.0,7,10,-3
ISR,IND,2006.0,6,18,-12
POL,CHN,2001.0,1,1,0
SVN,SWE,2022.0,3,5,-2
GRC,POL,2000.0,1,1,0
DEU,JOR,2002.0,8,6,2
TTO,USA,2008.0,9,12,-3
USA,JOR,1997.0,10,9,1
YEM,EGY,2012.0,10,7,3
BHR,CAN,2022.0,2,2,0
UKR,KOR,2009.0,2,4,-2
AUS,PAK,2005.0,6,4,2
USA,CMR,2000.0,4,6,-2
CHN,ZAF,2023.0,7,6,1
JOR,OMN,1997.0,1,2,-1
ROU,HUN,2006.0,4,7,-3
EGY,DEU,1999.0,20,15,5
GBR,NGA,2006.0,19,16,3
EGY,DEU,2007.0,22,39,-17
PHL,NPL,2011.0,1,1,0
FRA,UKR,2004.0,12,8,4
KWT,SAU,2012.0,4,4,0
CAN,SRB,2005.0,2,4,-2
SRB,CAN,2006.0,4,4,0
JPN,BGR,2007.0,10,2,8
FIN,NLD,2003.0,15,9,6
HRV,CHE,2000.0,8,2,6
CHE,HRV,2001.0,5,1,4
PAK,JPN,2005.0,5,7,-2
ARE,FRA,2016.0,7,17,-10
SGP,IND,2007.0,24,37,-13
ECU,ARG,2020.0,9,5,4
NLD,SUR,2022.0,5,4,1
LBY,GBR,2010.0,3,8,-5
GBR,VEN,2003.0,12,9,3
USA,PER,1998.0,7,15,-8
POL,ESP,2011.0,26,11,15
IND,BGD,2005.0,10,9,1
BRA,DNK,2017.0,25,15,10
DNK,BRA,2019.0,14,19,-5
IND,EGY,2016.0,8,9,-1
IND,PAK,2006.0,6,10,-4
SGP,KOR,2011.0,18,24,-6
FRA,MCO,2010.0,6,4,2
POL,BEL,2010.0,14,8,6
FRA,NZL,2006.0,13,7,6
TZA,GBR,2010.0,5,13,-8
JPN,KEN,2017.0,12,10,2
DEU,KOR,2019.0,55,93,-38
ITA,ZAF,2018.0,7,10,-3
SWE,ESP,2023.0,51,47,4
JPN,MNG,2018.0,13,9,4
JPN,NLD,2015.0,18,11,7
MYS,IND,2011.0,32,56,-24
CMR,DEU,2010.0,4,8,-4
KEN,MEX,2013.0,1,1,0
NPL,USA,2010.0,15,6,9
MWI,ZMB,2016.0,4,1,3
HKG,JPN,2015.0,8,5,3
ROU,DNK,2011.0,3,3,0
CHN,EST,2016.0,3,4,-1
ARG,GBR,2018.0,18,25,-7
ROU,GRC,2011.0,3,6,-3
ITA,ARM,2012.0,2,1,1
CAN,HKG,2015.0,22,29,-7
COL,GBR,2012.0,17,14,3
GRC,CHN,2017.0,7,4,3
NLD,EST,2015.0,3,4,-1
AUT,EGY,2007.0,7,2,5
NOR,SRB,2009.0,7,2,5
PRT,DEU,2009.0,26,26,0
GBR,SVK,2017.0,7,6,1
KOR,BGD,2016.0,21,38,-17
TWN,NGA,2018.0,1,1,0
BEN,FRA,2014.0,7,15,-8
SAU,IRQ,2017.0,4,1,3
EGY,ESP,2018.0,15,20,-5
POL,ZAF,2018.0,3,3,0
ZAF,POL,2021.0,6,3,3
HKG,KOR,2011.0,7,6,1
IRN,AFG,2012.0,1,1,0
NGA,NLD,2013.0,2,3,-1
FRA,THA,2014.0,15,20,-5
ZAF,AUT,2013.0,4,4,0
PAK,IND,2012.0,23,21,2
BEL,VNM,2020.0,27,7,20
TUR,CAN,2014.0,18,27,-9
SGP,TWN,2013.0,15,11,4
ISR,CHE,2010.0,17,7,10
HUN,GRC,2011.0,2,2,0
KEN,GHA,2023.0,5,1,4
CAN,ROU,2012.0,6,7,-1
AUS,POL,2011.0,8,5,3
IRN,TUR,2010.0,8,3,5
IRL,NOR,2023.0,9,2,7
FRA,SGP,2016.0,34,24,10
IND,CHE,2002.0,21,9,12
DEU,ARG,2010.0,13,26,-13
TUR,SRB,2011.0,6,1,5
THA,FRA,2016.0,13,33,-20
SWZ,CHE,2010.0,10,9,1
COD,COG,2023.0,44,33,11
CAN,LBY,2013.0,1,3,-2
BEL,MEX,2020.0,8,3,5
SGP,NOR,2020.0,5,1,4
CAN,IRN,2011.0,60,214,-154
BEL,ECU,2016.0,4,6,-2
MEX,BRA,2013.0,20,19,1
BEL,GRC,2011.0,11,11,0
THA,LAO,2012.0,3,3,0
NOR,ETH,2012.0,6,5,1
GRC,CHN,2016.0,9,3,6
COL,DEU,2013.0,23,14,9
NLD,TUR,2012.0,22,17,5
SSD,SDN,2017.0,4,1,3
CAN,GRC,2011.0,7,10,-3
POL,FIN,2019.0,9,7,2
MEX,CRI,2012.0,9,1,8
CAN,THA,2010.0,25,16,9
ISR,SWE,2011.0,6,1,5
SVK,SRB,2019.0,2,1,1
ITA,LTU,2011.0,6,2,4
NOR,RUS,2011.0,10,14,-4
THA,FRA,2022.0,15,20,-5
ARG,CHL,2010.0,23,8,15
BFA,FRA,2021.0,18,17,1
CAN,PAK,2011.0,11,22,-11
BGD,KOR,2021.0,24,44,-20
GBR,COL,2014.0,19,12,7
DNK,BGD,2016.0,3,2,1
GBR,NPL,2013.0,14,5,9
VEN,FRA,2019.0,3,4,-1
GBR,EST,2014.0,11,5,6
DNK,IDN,2022.0,7,2,5
MEX,COL,2012.0,24,20,4
MKD,SVN,2015.0,1,1,0
CAN,MYS,2011.0,7,5,2
CZE,POL,2015.0,16,13,3
MEX,DNK,2015.0,5,5,0
YEM,IRQ,2008.0,1,1,0
ITA,TUR,2013.0,21,13,8
USA,TUN,2019.0,13,7,6
IRN,AUT,2016.0,14,10,4
BGR,SRB,2014.0,2,2,0
KEN,NOR,2017.0,1,3,-2
AGO,BRA,2012.0,1,2,-1
USA,GRD,2014.0,9,3,6
SRB,NLD,2017.0,7,2,5
SWE,IRN,2012.0,23,31,-8
BEL,JPN,2016.0,15,16,-1
EGY,AUT,2003.0,3,2,1
ESP,CUB,2018.0,15,23,-8
RUS,NLD,2012.0,15,9,6
ESP,CZE,2017.0,18,16,2
LUX,BEL,2019.0,8,24,-16
USA,MWI,2013.0,10,18,-8
FRA,LAO,2013.0,6,3,3
ETH,GBR,2019.0,6,7,-1
FRA,IDN,2017.0,16,8,8
HUN,CHE,1999.0,5,9,-4
ITA,SRB,2019.0,7,5,2
IND,NGA,2016.0,9,13,-4
COL,CHN,2019.0,3,4,-1
ESP,URY,2019.0,12,11,1
MEX,FRA,2010.0,44,52,-8
BRA,NLD,2013.0,23,14,9
PRT,AUS,2012.0,6,4,2
AUT,SWE,2013.0,18,13,5
NZL,NLD,2021.0,18,15,3
USA,LBR,2017.0,15,8,7
RUS,KAZ,2019.0,57,30,27
MEX,NZL,2017.0,8,4,4
MWI,KEN,2023.0,4,3,1
EGY,ARE,2020.0,35,22,13
GHA,GBR,2017.0,16,38,-22
HRV,AUT,2021.0,12,3,9
IND,HUN,2018.0,7,4,3
CMR,BEL,2022.0,4,7,-3
POL,AUT,2016.0,11,4,7
ZAF,CHN,2019.0,22,9,13
JPN,TUR,2014.0,16,5,11
CHL,FIN,2018.0,5,3,2
ZAF,CHE,2007.0,10,5,5
USA,BGR,2023.0,5,2,3
JPN,IRN,2022.0,9,11,-2
JPN,MNG,2022.0,13,6,7
SAU,KAZ,2018.0,3,2,1
BGD,SWE,2023.0,3,4,-1
FRA,GIN,2018.0,5,2,3
PER,COL,2019.0,6,10,-4
SVN,ITA,2017.0,7,12,-5
CHN,KEN,2017.0,15,5,10
ITA,ROU,2013.0,14,13,1
CYP,ISR,2019.0,1,1,0
AUT,ITA,2016.0,44,65,-21
HKG,JPN,2014.0,9,13,-4
ALB,ITA,2016.0,2,9,-7
MAR,GBR,2020.0,4,2,2
KWT,EGY,2001.0,11,6,5
KOR,NZL,2022.0,2,6,-4
DEU,FIN,2005.0,30,19,11
DNK,AUT,2016.0,11,11,0
ESP,ZAF,2019.0,10,7,3
AUS,GHA,2022.0,11,11,0
RUS,UZB,2022.0,8,5,3
MNE,SRB,2018.0,16,8,8
IRQ,AUS,2020.0,8,56,-48
SWE,MAR,2020.0,2,2,0
SDN,SAU,2019.0,37,13,24
IRQ,DEU,2016.0,5,7,-2
UGA,DEU,2014.0,3,2,1
SAU,KAZ,2022.0,2,4,-2
IND,ZAF,2006.0,11,3,8
ITA,AUT,2007.0,31,23,8
CZE,POL,2014.0,12,15,-3
IDN,VNM,2021.0,1,7,-6
LTU,CZE,2020.0,1,2,-1
CZE,LTU,2021.0,1,3,-2
BEL,ARE,2020.0,7,2,5
TZA,BEL,2022.0,1,6,-5
JPN,ARE,2023.0,6,2,4
SGP,ARG,2018.0,1,2,-1
CYP,DEU,2016.0,4,3,1
DNK,EGY,2007.0,2,1,1
CHN,SDN,2021.0,25,9,16
ISR,RUS,2017.0,12,18,-6
TZA,ESP,2017.0,2,2,0
CHN,MEX,2016.0,4,4,0
CZE,KOR,2018.0,1,10,-9
ESP,JPN,2021.0,15,20,-5
CAN,OMN,2013.0,16,6,10
BGD,IND,2014.0,15,9,6
SGP,SWE,2023.0,4,8,-4
TTO,NZL,2010.0,1,1,0
BGD,DNK,2011.0,2,2,0
ARE,AUS,2014.0,12,14,-2
SWE,LTU,2021.0,6,9,-3
TUR,IRL,2023.0,8,2,6
CHN,AUT,2014.0,16,15,1
AUT,JPN,1998.0,10,5,5
TUN,ARE,2021.0,10,4,6
RUS,AZE,2022.0,5,2,3
ZAF,BEL,2020.0,17,14,3
CZE,SWE,2019.0,12,14,-2
USA,NER,2001.0,2,2,0
GRC,CHN,2018.0,5,3,2
CHN,RWA,2021.0,5,6,-1
CHE,EGY,2023.0,1,4,-3
JPN,HRV,2020.0,2,1,1
THA,PAK,2020.0,12,7,5
KOR,MMR,2020.0,2,2,0
AFG,USA,2019.0,14,18,-4
IDN,ITA,2021.0,1,3,-2
IRN,RUS,2021.0,9,9,0
RUS,ITA,2011.0,23,10,13
IRL,PRT,2021.0,5,6,-1
SWE,PER,2013.0,1,1,0
HUN,SWE,2022.0,9,11,-2
FIN,DNK,2021.0,22,15,7
DNK,ISR,2021.0,6,7,-1
PAK,NOR,2020.0,6,1,5
NPL,CAN,2019.0,9,2,7
IRN,CZE,2020.0,23,2,21
SWE,ISR,2023.0,5,5,0
TWN,DEU,2020.0,32,14,18
USA,CRI,2009.0,14,19,-5
CRI,MEX,1998.0,1,2,-1
ITA,NZL,2019.0,4,6,-2
ESP,UKR,2018.0,2,3,-1
VNM,NLD,2019.0,4,12,-8
CZE,LUX,2022.0,2,2,0
PRT,ITA,2017.0,23,35,-12
PAK,PRT,2023.0,4,2,2
USA,PRY,2019.0,5,2,3
TWN,SGP,2021.0,12,22,-10
CHN,ISL,2021.0,1,4,-3
ISR,ESP,2020.0,10,21,-11
PRT,MEX,2023.0,2,1,1
DNK,FRO,2016.0,5,1,4
VNM,KOR,2023.0,35,72,-37
GRC,IRL,2013.0,8,4,4
FRA,GIN,2016.0,3,3,0
AUS,CZE,2021.0,7,6,1
UKR,KAZ,2022.0,4,3,1
HKG,DEU,2023.0,14,6,8
AUS,FIN,2006.0,14,10,4
BIH,HRV,2019.0,10,21,-11
AUS,ESP,2013.0,26,56,-30
ESP,ECU,2013.0,27,5,22
TUN,EGY,2022.0,1,1,0
NGA,SWE,2020.0,1,2,-1
SGP,SAU,2021.0,8,1,7
URY,DEU,2019.0,3,3,0
BWA,ZAF,2010.0,7,4,3
ITA,NOR,2019.0,33,17,16
PRT,EGY,2017.0,3,2,1
CHN,QAT,2021.0,3,4,-1
QAT,CHN,2023.0,2,5,-3
EST,ITA,2019.0,4,9,-5
SAU,BEL,2022.0,6,2,4
ZAF,SWZ,2021.0,13,8,5
SVK,UKR,2023.0,6,13,-7
CAN,ETH,2021.0,8,5,3
EGY,IRN,2015.0,1,1,0
COL,ITA,2022.0,17,9,8
DEU,LIE,2022.0,2,2,0
TUR,SGP,2016.0,11,7,4
CPV,PRT,2021.0,5,4,1
ARG,ITA,2021.0,30,14,16
RUS,IRL,2023.0,4,3,1
FRA,QAT,2022.0,6,1,5
KOR,ESP,2019.0,16,10,6
IRN,AUT,2022.0,24,8,16
VNM,GBR,2020.0,17,30,-13
CHE,PRT,2021.0,13,20,-7
UGA,GBR,2022.0,20,14,6
ARG,NZL,2020.0,3,1,2
BMU,CAN,2022.0,14,1,13
CMR,CAN,2018.0,5,2,3
FRA,DZA,2023.0,20,18,2
CHN,SVN,2015.0,3,1,2
MAR,BEL,2022.0,8,8,0
HKG,IDN,2018.0,1,1,0
CAN,GRC,2019.0,17,11,6
SWE,AUS,2022.0,29,48,-19
ZAF,CHN,2021.0,22,7,15
MYS,DNK,2008.0,1,3,-2
EGY,TWN,2021.0,4,2,2
NLD,NGA,2022.0,5,2,3
BGD,DEU,2020.0,14,17,-3
ARE,FRA,2022.0,8,20,-12
GBR,SWZ,2022.0,3,1,2
LBN,EGY,2022.0,10,5,5
CHL,BEL,2021.0,11,8,3
MEX,FRA,2023.0,13,18,-5
SDN,IRL,2021.0,2,1,1
SGP,CAN,2021.0,31,22,9
KEN,COG,2022.0,2,1,1
COG,KEN,2023.0,1,2,-1
CAN,UKR,2000.0,4,6,-2
POL,SRB,2020.0,2,1,1
USA,AZE,2021.0,6,4,2
VNM,HUN,2021.0,1,4,-3
ISR,CAN,2021.0,65,55,10
CZE,PRY,2012.0,2,1,1
NZL,BRA,2001.0,1,4,-3
UKR,PRT,2000.0,5,1,4
RUS,NOR,2003.0,8,5,3
FRA,LBN,1999.0,23,15,8
ARG,NLD,2009.0,8,3,5
SRB,AUT,2003.0,4,5,-1
SRB,FRA,1999.0,2,4,-2
SRB,SWE,2006.0,7,6,1
GBR,POL,2000.0,45,19,26
NOR,BEL,2007.0,3,5,-2
USA,CRI,2021.0,23,28,-5
JPN,POL,2006.0,7,13,-6
CIV,GBR,1998.0,1,1,0
CZE,ESP,2000.0,9,1,8
CHE,CMR,2002.0,2,2,0
CAN,RUS,1999.0,18,46,-28
SWE,ISL,2011.0,9,10,-1
USA,PRT,1997.0,20,16,4
CHE,LIE,2008.0,2,1,1
MDA,UKR,2007.0,6,2,4
CUB,BRA,2013.0,14,9,5
BRA,CUB,2014.0,5,15,-10
NZL,THA,2001.0,2,3,-1
FIN,ITA,1998.0,7,10,-3
PRT,RUS,1998.0,2,3,-1
NLD,NPL,2001.0,1,1,0
AUS,SAU,2010.0,9,4,5
PHL,CHE,2007.0,2,1,1
SWE,ARG,2007.0,3,3,0
USA,SAU,2005.0,46,20,26
PHL,CHN,2023.0,9,8,1
BEL,BRA,1999.0,10,9,1
CRI,USA,2020.0,24,34,-10
AUS,BEL,1999.0,7,7,0
SWE,LVA,1997.0,3,3,0
PRT,DNK,2011.0,2,3,-1
CAN,IRL,2016.0,41,41,0
UZB,USA,1999.0,5,3,2
ISR,NLD,2011.0,11,7,4
CHL,BRA,2009.0,18,15,3
FRA,MCO,2000.0,6,6,0
AUS,THA,2003.0,21,13,8
BEL,ZAF,2023.0,8,10,-2
USA,NPL,2013.0,7,25,-18
RUS,ISR,2001.0,22,3,19
HRV,FRA,2000.0,2,5,-3
YEM,EGY,2002.0,2,3,-1
USA,CIV,2017.0,6,5,1
CHL,SWE,2015.0,5,2,3
RUS,NLD,2005.0,17,14,3
BGD,GBR,2004.0,11,10,1
GBR,BGD,2004.0,10,11,-1
FRA,CHL,2013.0,41,20,21
NLD,RUS,2012.0,9,15,-6
VEN,CHL,1999.0,1,2,-1
FIN,CAN,2016.0,16,13,3
AUS,DNK,2002.0,23,23,0
EGY,FRA,2022.0,8,18,-10
SWE,IND,2007.0,8,11,-3
ISR,CHE,2000.0,3,11,-8
CAN,BEL,2006.0,26,36,-10
ESP,CAN,2005.0,20,20,0
SGP,VNM,2018.0,9,4,5
FRA,ECU,2013.0,3,2,1
BRA,CHE,1998.0,5,8,-3
VEN,FRA,2011.0,7,11,-4
USA,HTI,2004.0,3,5,-2
BEL,RUS,2005.0,9,12,-3
USA,DOM,2022.0,7,4,3
SWE,IND,1998.0,5,9,-4
NOR,IRL,2007.0,2,4,-2
JOR,CHN,2020.0,2,3,-1
AUS,RUS,2014.0,10,7,3
UKR,DEU,2009.0,28,29,-1
BGD,JPN,1998.0,10,15,-5
CHL,GBR,2000.0,6,6,0
GBR,SDN,2007.0,4,4,0
DNK,BRA,2009.0,2,8,-6
CHL,NOR,2010.0,2,2,0
AUS,ZAF,2004.0,22,27,-5
NOR,ISL,2008.0,5,4,1
VEN,ESP,1998.0,8,9,-1
AUS,GRC,2017.0,9,8,1
CHL,DEU,1997.0,7,5,2
FRA,MDG,2016.0,16,12,4
CHN,VNM,2010.0,4,1,3
ESP,CUB,2016.0,18,27,-9
CAN,IRL,2018.0,39,48,-9
CYP,GRC,2013.0,16,50,-34
TWN,FRA,2002.0,7,3,4
CAN,TUN,2020.0,8,11,-3
RUS,CHE,2000.0,19,9,10
ISL,SWE,2022.0,5,16,-11
CHE,NOR,2000.0,4,6,-2
UKR,GBR,2002.0,22,12,10
ESP,DOM,1999.0,4,1,3
BEL,SVN,2014.0,3,2,1
ISR,HUN,2000.0,1,2,-1
IND,MEX,2019.0,13,10,3
BEL,SVK,1998.0,1,1,0
GEO,USA,1999.0,26,29,-3
ITA,FIN,2008.0,10,8,2
CHE,KOR,2004.0,8,6,2
USA,BGD,2006.0,9,12,-3
CAN,SGP,2007.0,21,17,4
USA,UKR,2012.0,22,22,0
AUT,CAN,2006.0,18,10,8
DEU,MDA,2005.0,1,2,-1
GBR,TUR,2008.0,41,19,22
FIN,MYS,2018.0,1,2,-1
CHN,ITA,2012.0,30,31,-1
DEU,VNM,2006.0,4,7,-3
MYS,BGD,2007.0,5,5,0
COG,USA,2013.0,5,3,2
CAN,HUN,2009.0,6,7,-1
GBR,COD,2022.0,4,2,2
COD,GBR,2023.0,3,4,-1
BWA,GBR,2004.0,2,5,-3
ZAF,KEN,2006.0,5,4,1
CHN,CHL,2010.0,8,1,7
DNK,ISR,2009.0,3,5,-2
MEX,IND,2001.0,5,6,-1
KOR,RUS,2004.0,19,12,7
ITA,COL,2010.0,3,9,-6
PHL,USA,2016.0,34,46,-12
BGD,FRA,2015.0,2,1,1
SWE,SAU,2014.0,7,5,2
RUS,CHE,2006.0,28,14,14
MDA,ITA,2014.0,2,1,1
FIN,CHE,2019.0,14,15,-1
MYS,ESP,2013.0,5,2,3
IRL,KOR,2014.0,3,5,-2
IDN,TWN,2012.0,2,4,-2
ESP,IND,2009.0,11,17,-6
DEU,GHA,2016.0,15,10,5
DEU,KOR,2011.0,40,53,-13
USA,PHL,1997.0,7,12,-5
USA,URY,1999.0,5,4,1
FIN,POL,2008.0,3,7,-4
BEL,POL,2000.0,8,8,0
BGD,BEL,2015.0,7,3,4
PRT,SAU,2016.0,5,1,4
NZL,JPN,2002.0,14,10,4
ESP,AND,2014.0,2,2,0
FRA,HKG,2014.0,11,4,7
GBR,HUN,2023.0,9,16,-7
TZA,USA,2023.0,13,7,6
KWT,IND,2016.0,3,3,0
CHN,NZL,2013.0,15,21,-6
IRL,DNK,2011.0,4,11,-7
ZAF,UGA,2017.0,12,8,4
JPN,DNK,2019.0,16,17,-1
NGA,MYS,2014.0,30,28,2
GRC,DNK,2018.0,10,4,6
NOR,IDN,2017.0,2,2,0
JPN,SGP,2013.0,42,23,19
GBR,PHL,2023.0,4,5,-1
GMB,USA,2013.0,3,1,2
POL,RUS,2009.0,8,7,1
ECU,BRA,2016.0,5,10,-5
ECU,AUS,2022.0,6,3,3
CHL,SGP,2021.0,1,2,-1
NZL,TWN,2016.0,4,3,1
AUT,CHN,2014.0,15,16,-1
LBR,USA,2020.0,9,11,-2
IND,CZE,2019.0,25,10,15
HKG,NLD,2015.0,4,3,1
KOR,SGP,2010.0,18,14,4
DZA,ARG,2015.0,3,3,0
SRB,CZE,1998.0,6,4,2
ZMB,GBR,2014.0,2,6,-4
GBR,GMB,2001.0,11,11,0
GRC,NLD,2011.0,19,11,8
CHN,ZMB,2018.0,6,2,4
BEL,CHL,2014.0,10,7,3
IRL,VNM,2017.0,2,1,1
PAK,AUT,2023.0,7,1,6
FRA,ZAF,2015.0,32,27,5
CHE,CAN,2013.0,75,98,-23
LKA,GBR,2015.0,11,29,-18
POL,KAZ,2019.0,1,1,0
PAK,IND,2005.0,12,8,4
MKD,USA,2015.0,3,5,-2
SDN,MYS,2010.0,6,1,5
TWN,GBR,2005.0,17,39,-22
TWN,PHL,2017.0,10,3,7
ARE,CAN,2014.0,14,30,-16
ITA,JPN,1999.0,31,25,6
GBR,MWI,2006.0,9,4,5
AUS,IRL,1999.0,10,10,0
GBR,THA,2000.0,15,11,4
CHE,SRB,2021.0,3,12,-9
ARE,OMN,1999.0,5,4,1
DEU,GHA,2017.0,9,11,-2
FRA,TGO,2015.0,6,1,5
TUR,RUS,2017.0,7,1,6
CHN,ZAF,2006.0,4,5,-1
ESP,PNG,2016.0,1,1,0
CAN,NZL,2018.0,25,29,-4
ZAF,CHE,2020.0,22,14,8
FIN,EST,2021.0,14,15,-1
FRA,HRV,2020.0,4,4,0
GBR,KOR,2009.0,33,30,3
CHE,EGY,2010.0,6,6,0
PRT,COL,2022.0,5,4,1
HUN,NLD,2016.0,12,10,2
COL,JPN,2021.0,2,3,-1
TZA,ZAF,2018.0,4,16,-12
CHE,CHL,2020.0,10,7,3
HKG,IDN,2022.0,6,2,4
KOR,SAU,2010.0,13,1,12
IND,COL,2015.0,2,2,0
PRT,AUT,2021.0,10,6,4
AUS,ZAF,2015.0,29,44,-15
IDN,JPN,2012.0,24,108,-84
DEU,VNM,2023.0,12,6,6
CAN,ITA,2013.0,46,58,-12
CHN,TZA,2019.0,8,2,6
,KEN,2013.0,560,0,560
,EST,2015.0,327,0,327
UGA,COG,2018.0,3,0,3
,CZE,2015.0,2692,0,2692
,URY,2015.0,259,0,259
,LKA,2016.0,435,0,435
,CZE,2014.0,2969,0,2969
,ECU,2014.0,549,0,549
MNG,BEL,2017.0,1,0,1
,IRN,2017.0,13646,0,13646
,CRI,2015.0,218,0,218
,EST,2014.0,380,0,380
,NPL,2011.0,292,0,292
,TZA,2015.0,311,0,311
,ECU,2015.0,861,0,861
,BIH,2014.0,233,0,233
CRI,,2021.0,176,0,176
,BIH,2015.0,262,0,262
,BHR,2015.0,106,0,106
MNE,,2024.0,195,0,195
,UZB,2015.0,111,0,111
,COL,2009.0,1609,0,1609
VEN,ISR,2018.0,1,0,1
ZMB,,2021.0,92,0,92
,IRL,2010.0,1718,0,1718
,LUX,2009.0,106,0,106
BTN,,2021.0,16,0,16
,MEX,2019.0,4530,0,4530
,COL,2019.0,2682,0,2682
,LKA,2018.0,535,0,535
,NZL,2013.0,1602,0,1602
,COL,2011.0,2009,0,2009
SWZ,,2023.0,40,0,40
,QAT,2016.0,400,0,400
,MNE,2013.0,69,0,69
USA,PRK,2018.0,1,0,1
,BFA,2015.0,124,0,124
,UZB,2014.0,118,0,118
,BHR,2014.0,84,0,84
CRI,,2019.0,108,0,108
JOR,,2019.0,247,0,247
,SLV,2007.0,12,0,12
NOR,FRO,2018.0,4,0,4
,DOM,2010.0,24,0,24
BEN,,2023.0,261,0,261
,CIV,2019.0,139,0,139
,MAR,2013.0,1311,0,1311
,PRY,2015.0,61,0,61
,UGA,2016.0,450,0,450
,PER,2016.0,846,0,846
MEX,IRQ,2018.0,4,0,4
ZAF,COD,2019.0,7,0,7
IRN,KAZ,2019.0,3,0,3
ZMB,,2019.0,90,0,90
,AZE,2014.0,195,0,195
,BFA,2001.0,41,0,41
,PER,2017.0,1162,0,1162
DOM,ARG,2019.0,1,0,1
,CRI,2014.0,193,0,193
GBR,BHR,2014.0,8,0,8
,ROU,2014.0,1894,0,1894
PRI,,2020.0,138,0,138
,BFA,2014.0,131,0,131
,HRV,2013.0,960,0,960
,GIN,2014.0,37,0,37
YEM,,2024.0,190,0,190
GTM,,2020.0,56,0,56
SDN,,2024.0,445,0,445
HKG,ESP,2022.0,2,0,2
PHL,HRV,2019.0,1,0,1
,BRN,2015.0,48,0,48
,ARG,2019.0,1927,0,1927
,OMN,2019.0,253,0,253
,ARM,2015.0,127,0,127
NGA,,1999.0,40,0,40
,OMN,2009.0,165,0,165
,QAT,2017.0,464,0,464
,IRQ,2020.0,1742,0,1742
,URY,2014.0,277,0,277
DMA,,2021.0,7,0,7
,JPN,2020.0,12268,0,12268
,BWA,2012.0,95,0,95
,PRY,2014.0,66,0,66
,CYP,2020.0,166,0,166
,RWA,2019.0,168,0,168
,UGA,2018.0,574,0,574
,BGD,2018.0,2196,0,2196
LVA,DNK,2019.0,3,0,3
,BGD,2017.0,1567,0,1567
,DNK,2018.0,2939,0,2939
PAN,BRA,2023.0,3,0,3
,LVA,2013.0,272,0,272
,KWT,2013.0,172,0,172
,SDN,2013.0,98,0,98
MLT,,2023.0,178,0,178
RWA,,2024.0,366,0,366
RWA,,2023.0,169,0,169
,BGD,2016.0,1125,0,1125
PRY,,2023.0,114,0,114
TUN,GUF,2019.0,1,0,1
RUS,BHR,2018.0,1,0,1
,ISL,2018.0,133,0,133
,PRK,2015.0,43,0,43
ECU,GTM,2016.0,1,0,1
,BLR,2018.0,359,0,359
,QAT,2018.0,688,0,688
,CHL,2010.0,1954,0,1954
CYP,PSE,2022.0,2,0,2
,ETH,2012.0,670,0,670
,LTU,2019.0,509,0,509
,COD,2017.0,90,0,90
,PER,2018.0,1424,0,1424
,COD,2018.0,140,0,140
,BEN,2018.0,160,0,160
BTN,,2025.0,191,0,191
,LKA,2017.0,466,0,466
TWN,OMN,2022.0,1,0,1
MAR,GHA,2022.0,1,0,1
SVK,BGR,2021.0,1,0,1
BEL,PSE,2023.0,1,0,1
BGD,BRN,2023.0,3,0,3
,GRC,2020.0,1646,0,1646
,KAZ,2019.0,1044,0,1044
,AZE,2015.0,214,0,214
,UKR,2020.0,1755,0,1755
AFG,,2015.0,6,0,6
,GTM,2018.0,73,0,73
,BEN,2017.0,184,0,184
TWN,PAN,2022.0,1,0,1
LBY,,2024.0,235,0,235
,UGA,2017.0,443,0,443
,IRQ,2007.0,259,0,259
NZL,THA,2021.0,9,0,9
,CHN,2021.0,6334,0,6334
,COG,2005.0,73,0,73
ROU,ALB,2023.0,2,0,2
YEM,,2023.0,94,0,94
MYS,TUR,2021.0,10,0,10
ROU,OMN,2022.0,1,0,1
,GEO,2013.0,191,0,191
BHS,,2024.0,18,0,18
,SOM,2018.0,30,0,30
DZA,UGA,2021.0,1,0,1
JPN,GAB,2021.0,2,0,2
SUR,,2025.0,55,0,55
SRB,HKG,2022.0,1,0,1
,MUS,2017.0,46,0,46
LTU,BEL,2023.0,1,0,1
SAU,SRB,2021.0,1,0,1
,OMN,2011.0,188,0,188
,ARE,2009.0,233,0,233
KEN,,2026.0,46,0,46
BRA,AGO,2023.0,3,0,3
CHE,SDN,2022.0,1,0,1
,BLR,2017.0,520,0,520
MLI,,2017.0,24,0,24
,NPL,2019.0,883,0,883
UKR,,2005.0,612,0,612
KGZ,GBR,2007.0,2,0,2
,ISL,2016.0,142,0,142
CHL,CUB,1999.0,2,0,2
GUF,,2002.0,1,0,1
UZB,,2014.0,50,0,50
LBN,KWT,2005.0,2,0,2
COL,,1999.0,26,0,26
HRV,,2003.0,183,0,183
NER,CHE,2019.0,1,0,1
CMR,,2004.0,12,0,12
,GHA,1995.0,116,0,116
GHA,,2005.0,23,0,23
LKA,BRA,2005.0,4,0,4
VNM,,1999.0,17,0,17
,BHR,1996.0,36,0,36
,PRI,1994.0,280,0,280
SEN,,2012.0,41,0,41
MDA,USA,2003.0,4,0,4
SRB,,1999.0,60,0,60
VEN,,2003.0,123,0,123
SVK,CAN,2001.0,5,0,5
THA,TUR,2013.0,2,0,2
MYS,,2001.0,104,0,104
,JAM,1997.0,46,0,46
EGY,,2001.0,162,0,162
PRT,TUN,2002.0,2,0,2
KOR,CZE,2003.0,2,0,2
BGD,,2008.0,95,0,95
MMR,,2004.0,3,0,3
UZB,ESP,1998.0,2,0,2
ALB,FRA,2002.0,1,0,1
,TJK,1999.0,6,0,6
BRB,,2021.0,28,0,28
PER,DNK,2008.0,1,0,1
LUX,DNK,2006.0,2,0,2
PHL,MYS,2014.0,2,0,2
KAZ,,2004.0,53,0,53
HUN,,2003.0,447,0,447
UKR,ZAF,2001.0,1,0,1
BEL,COL,1999.0,1,0,1
BTN,,2011.0,7,0,7
ARM,NLD,2002.0,1,0,1
VEN,CAN,2019.0,2,0,2
AUS,BTN,1998.0,4,0,4
,AZE,1996.0,84,0,84
FSM,PLW,1999.0,1,0,1
PLW,,2024.0,8,0,8
COM,,2010.0,1,0,1
DNK,,2001.0,513,0,513
BWA,,2006.0,16,0,16
FRO,GBR,1997.0,1,0,1
,CYM,1994.0,3,0,3
BRB,,2019.0,13,0,13
SVN,,2026.0,88,0,88
,ETH,1997.0,86,0,86
ETH,MWI,2001.0,1,0,1
GAB,GBR,1998.0,2,0,2
HUN,NZL,2001.0,1,0,1
AUT,COG,2001.0,1,0,1
,JAM,2005.0,54,0,54
PHL,,2002.0,41,0,41
CUB,PRI,1999.0,1,0,1
CHL,CZE,2012.0,4,0,4
,ECU,1996.0,39,0,39
ECU,CHL,2007.0,2,0,2
CHE,VUT,2020.0,1,0,1
NER,ISR,2014.0,1,0,1
JPN,GTM,2001.0,1,0,1
TUR,BGR,2002.0,2,0,2
MUS,GMB,2017.0,1,0,1
GMB,BRA,2018.0,1,0,1
,FJI,1998.0,15,0,15
TWN,TUR,2004.0,2,0,2
,BIH,2001.0,89,0,89
MTQ,,2010.0,11,0,11
IRN,MYS,2003.0,2,0,2
GAB,VNM,2001.0,1,0,1
PHL,DNK,2003.0,2,0,2
MLT,UGA,2003.0,1,0,1
ARE,,2005.0,56,0,56
MMR,,2014.0,10,0,10
TWN,MEX,2000.0,4,0,4
DNK,TZA,2004.0,5,0,5
CAF,KHM,2000.0,1,0,1
NLD,ISL,1997.0,1,0,1
JPN,PRI,2005.0,4,0,4
VEN,ARG,2002.0,3,0,3
BLR,DNK,2005.0,3,0,3
FIN,BLR,2008.0,1,0,1
,KHM,2010.0,73,0,73
,VEN,2012.0,308,0,308
,JOR,2013.0,417,0,417
,CUB,2012.0,715,0,715
,MDA,2012.0,88,0,88
,LBY,2007.0,74,0,74
,AZE,2008.0,231,0,231
NCL,,2024.0,93,0,93
,GNQ,2013.0,3,0,3
BHR,CAN,2020.0,2,0,2
BLR,BRA,2013.0,2,0,2
MLI,GMB,2021.0,1,0,1
CAN,CYP,1999.0,1,0,1
,BOL,2013.0,51,0,51
SYR,BEL,2018.0,3,0,3
IRQ,,2019.0,128,0,128
,JAM,2012.0,58,0,58
MHL,,2018.0,3,0,3
,ALB,2013.0,88,0,88
,YEM,2012.0,58,0,58
,BIH,2008.0,229,0,229
,ISL,2017.0,155,0,155
NZL,PER,2018.0,1,0,1
LUX,,2018.0,130,0,130
JOR,PSE,2009.0,2,0,2
,BEN,2016.0,148,0,148
IRN,CHL,2020.0,5,0,5
CHE,NPL,2019.0,1,0,1
SRB,SGP,2015.0,1,0,1
,CRI,2008.0,108,0,108
GRD,,2017.0,14,0,14
SYR,,2018.0,103,0,103
SWE,IRQ,2019.0,9,0,9
MLI,,2018.0,35,0,35
,CIV,2011.0,120,0,120
LAO,,2020.0,59,0,59
,MDG,2013.0,76,0,76
CUB,,2019.0,685,0,685
,FJI,2007.0,22,0,22
,KAZ,2009.0,170,0,170
BWA,,2023.0,180,0,180
BEN,PRT,2013.0,1,0,1
,BTN,2015.0,52,0,52
,LAO,2007.0,24,0,24
ALB,DZA,2021.0,1,0,1
,LUX,2011.0,127,0,127
,MWI,2013.0,121,0,121
TUN,CHN,2019.0,14,0,14
,COG,2012.0,182,0,182
,ARM,2014.0,161,0,161
NGA,PRT,2016.0,2,0,2
LUX,,2016.0,92,0,92
HND,COL,2022.0,3,0,3
EST,POL,2021.0,4,0,4
POL,EST,2022.0,2,0,2
HND,CRI,2021.0,2,0,2
GHA,KEN,2017.0,7,0,7
ETH,IDN,2023.0,1,0,1
,COD,2016.0,69,0,69
TUR,NER,2020.0,1,0,1
GEO,,2021.0,241,0,241
TUN,YEM,2019.0,1,0,1
,UZB,2004.0,83,0,83
LBY,,2023.0,149,0,149
,BRN,2014.0,56,0,56
,SOM,2016.0,3,0,3
,MUS,2016.0,39,0,39
MUS,THA,2019.0,1,0,1
,GRL,2002.0,4,0,4
MCO,,2024.0,53,0,53
IRN,,2006.0,188,0,188
,ARE,2011.0,297,0,297
ZAF,BDI,2021.0,1,0,1
,CYP,1998.0,49,0,49
MRT,USA,2019.0,2,0,2
,HND,2016.0,39,0,39
IRN,NGA,2022.0,5,0,5
,TZA,2008.0,203,0,203
AUT,UGA,2023.0,2,0,2
,GTM,2016.0,43,0,43
SEN,,2002.0,23,0,23
,HND,2017.0,34,0,34
IND,GTM,2021.0,1,0,1
BIH,POL,2019.0,1,0,1
AGO,USA,2023.0,1,0,1
VEN,HUN,2021.0,2,0,2
NCL,,2023.0,42,0,42
IND,UKR,2022.0,2,0,2
,VUT,2019.0,16,0,16
NLD,EGY,2008.0,7,0,7
CMR,NAM,2022.0,1,0,1
,LUX,2019.0,178,0,178
COD,,2016.0,6,0,6
,HND,2018.0,39,0,39
,MMR,2019.0,68,0,68
,KGZ,2019.0,65,0,65
,MUS,2018.0,51,0,51
PAK,SVN,2023.0,1,0,1
ISR,IDN,2020.0,1,0,1
SWE,BGR,2022.0,2,0,2
,MAC,2019.0,307,0,307
,UZB,2008.0,109,0,109
BGD,RWA,2016.0,1,0,1
,CMR,2020.0,367,0,367
BEL,GMB,2021.0,1,0,1
GMB,ESP,2022.0,1,0,1
NGA,TTO,1999.0,1,0,1
NGA,ZAF,1998.0,5,0,5
GMB,DEU,2002.0,4,0,4
,BHS,2005.0,7,0,7
,SEN,2000.0,78,0,78
,SEN,2006.0,98,0,98
LUX,SWE,2015.0,3,0,3
NLD,UGA,2001.0,1,0,1
NOR,ROU,2001.0,1,0,1
,FSM,1994.0,2,0,2
FSM,,2022.0,5,0,5
,BIH,2004.0,145,0,145
,ARM,1996.0,159,0,159
BLR,THA,1998.0,1,0,1
THA,BLR,2001.0,1,0,1
POL,BRA,2012.0,5,0,5
ESP,GAB,2000.0,1,0,1
NLD,PHL,2001.0,2,0,2
USA,DZA,2008.0,3,0,3
BGD,,2004.0,50,0,50
MYS,,2004.0,102,0,102
BGR,CZE,2010.0,1,0,1
CZE,KOR,1999.0,1,0,1
GNB,DNK,1998.0,2,0,2
OMN,,2003.0,14,0,14
UZB,,2001.0,49,0,49
BRA,ISR,2001.0,2,0,2
NCL,AUS,2008.0,4,0,4
MCO,,2000.0,4,0,4
URY,,2006.0,42,0,42
ROU,,2005.0,223,0,223
PAK,ITA,1997.0,1,0,1
SEN,,2005.0,31,0,31
HKG,THA,2001.0,1,0,1
ARM,,2003.0,61,0,61
SVN,CZE,2015.0,6,0,6
OMN,DEU,2004.0,1,0,1
CHE,REU,2010.0,1,0,1
NOR,SGP,2001.0,1,0,1
IDN,,2000.0,30,0,30
BRB,,2011.0,16,0,16
,SYR,2000.0,30,0,30
,MLI,2012.0,49,0,49
,RWA,1994.0,12,0,12
SDN,,2006.0,24,0,24
PHL,,2005.0,61,0,61
,BIH,1996.0,37,0,37
MTQ,,2024.0,20,0,20
MAR,AUT,2005.0,1,0,1
AUT,MAR,2006.0,1,0,1
GUY,GUF,2012.0,1,0,1
IND,YEM,2005.0,3,0,3
YEM,IRQ,2011.0,1,0,1
,LUX,1994.0,57,0,57
MDG,ZAF,2005.0,1,0,1
GBR,BHR,2001.0,1,0,1
NIC,,2011.0,14,0,14
ESP,TZA,2003.0,2,0,2
,MKD,1995.0,83,0,83
ITA,MLI,1999.0,2,0,2
JPN,LVA,2010.0,1,0,1
RUS,OMN,1999.0,1,0,1
ARM,SWE,2005.0,1,0,1
GBR,GIB,2014.0,2,0,2
PAN,GBR,1997.0,1,0,1
PHL,CHE,2017.0,1,0,1
MEX,URY,2006.0,2,0,2
SYR,ITA,1999.0,1,0,1
,GHA,2015.0,663,0,663
CHL,FIN,2023.0,4,0,4
,RWA,2012.0,116,0,116
,THA,2016.0,3361,0,3361
BEL,MOZ,2020.0,4,0,4
,MYS,2020.0,3169,0,3169
,AUT,2018.0,2894,0,2894
,MKD,2014.0,173,0,173
,CMR,2010.0,404,0,404
,NOR,2018.0,2056,0,2056
,PHL,2016.0,809,0,809
,BGD,2013.0,1016,0,1016
,KAZ,2012.0,1571,0,1571
,HUN,2009.0,1550,0,1550
PHL,,2021.0,532,0,532
,MKD,2015.0,129,0,129
,NCL,2015.0,19,0,19
KWT,ARE,2012.0,6,0,6
,SGP,2016.0,2466,0,2466
,PHL,2018.0,1051,0,1051
,AUT,2017.0,2708,0,2708
MAR,GIN,2019.0,1,0,1
COG,CAN,2017.0,3,0,3
KHM,,2024.0,248,0,248
GTM,,2024.0,179,0,179
,VEN,2011.0,345,0,345
MAR,TZA,2019.0,1,0,1
PRY,,2020.0,26,0,26
SWZ,,2020.0,16,0,16
IND,COG,2018.0,1,0,1
,HUN,2019.0,1619,0,1619
IRL,KWT,2020.0,2,0,2
LBR,,2023.0,38,0,38
MYS,POL,2018.0,2,0,2
,PER,2013.0,565,0,565
,ZMB,2014.0,141,0,141
GHA,,2021.0,350,0,350
,GEO,2016.0,227,0,227
,ERI,2015.0,17,0,17
,JOR,2016.0,741,0,741
,IDN,2008.0,864,0,864
GBR,HRV,2022.0,7,0,7
,CYP,2010.0,151,0,151
,NPL,2012.0,303,0,303
BFA,ZAF,2018.0,1,0,1
BFA,ZAF,2022.0,2,0,2
GRC,,2005.0,647,0,647
SVK,,2002.0,230,0,230
SRB,LVA,2011.0,1,0,1
,NZL,2018.0,1588,0,1588
ZAF,BEN,2018.0,4,0,4
,CUB,2011.0,732,0,732
UGA,IRL,2018.0,3,0,3
,LBN,2009.0,296,0,296
,ETH,2011.0,552,0,552
,IND,2021.0,407,0,407
,THA,2017.0,3467,0,3467
,IRL,2020.0,980,0,980
,HRV,2017.0,1021,0,1021
,VNM,2018.0,3484,0,3484
,MAR,2018.0,2101,0,2101
,TJK,2010.0,25,0,25
,SGP,2017.0,2432,0,2432
,PAN,2010.0,55,0,55
LSO,,2025.0,81,0,81
GIN,CHE,2017.0,2,0,2
HUN,MYS,2023.0,1,0,1
PAN,,2022.0,83,0,83
,MLT,2014.0,109,0,109
,NZL,2017.0,1571,0,1571
,LVA,2018.0,329,0,329
,HRV,2018.0,1030,0,1030
GBR,MAC,2003.0,1,0,1
BGR,,2004.0,200,0,200
CHN,VNM,2016.0,21,0,21
,SDN,2017.0,197,0,197
PER,,2019.0,249,0,249
,GHA,2008.0,305,0,305
,LUX,2012.0,157,0,157
MEX,BLZ,2019.0,1,0,1
MEX,GTM,2015.0,4,0,4
MOZ,,2021.0,90,0,90
,HND,2013.0,24,0,24
,ARE,2012.0,360,0,360
TUR,IRL,2018.0,10,0,10
,KEN,2016.0,664,0,664
,BWA,2019.0,89,0,89
MEX,,1999.0,202,0,202
,MNE,2018.0,63,0,63
,JOR,2018.0,1117,0,1117
,BOL,2018.0,68,0,68
,JOR,2017.0,945,0,945
,ETH,2019.0,2296,0,2296
,VEN,2019.0,146,0,146
,MDG,2018.0,103,0,103
,GEO,2017.0,233,0,233
,KWT,2018.0,240,0,240
,MWI,2018.0,172,0,172
USA,DJI,2022.0,2,0,2
MDV,,2023.0,12,0,12
,PHL,2017.0,1001,0,1001
,ALB,2018.0,107,0,107
,CHL,2020.0,1173,0,1173
,SDN,2018.0,181,0,181
,SDN,2016.0,150,0,150
,BOL,2017.0,62,0,62
,MDG,2017.0,85,0,85
,MDA,2019.0,64,0,64
,GEO,2018.0,186,0,186
,LVA,2017.0,351,0,351
,LIE,2019.0,10,0,10
HRV,,2026.0,121,0,121
FRA,COD,2009.0,1,0,1
,GUY,2018.0,23,0,23
GTM,,2023.0,114,0,114
,IRQ,2010.0,467,0,467
,KEN,2017.0,682,0,682
MEX,EST,2021.0,1,0,1
ESP,KWT,2019.0,1,0,1
UZB,EGY,2021.0,2,0,2
,TGO,2018.0,55,0,55
,LBN,2019.0,573,0,573
,ABW,2018.0,1,0,1
,SVN,2019.0,545,0,545
,BGR,2020.0,309,0,309
,ALB,2017.0,88,0,88
EGY,NGA,2022.0,8,0,8
,BMU,2004.0,29,0,29
,JAM,2019.0,48,0,48
VUT,,2024.0,40,0,40
KHM,,2023.0,135,0,135
,MLI,2019.0,69,0,69
DNK,LUX,2015.0,1,0,1
,UGA,2013.0,361,0,361
,BRB,2010.0,13,0,13
UKR,NGA,2022.0,1,0,1
ZAF,KOR,2021.0,5,0,5
,TGO,2017.0,59,0,59
,MKD,2008.0,144,0,144
RUS,KGZ,2001.0,5,0,5
,GUF,1996.0,9,0,9
,BIH,1995.0,22,0,22
BIH,,2001.0,9,0,9
,CYP,2000.0,54,0,54
AUS,BGR,2000.0,4,0,4
,CUB,2009.0,826,0,826
JOR,,2005.0,50,0,50
SDN,,2007.0,25,0,25
SRB,,2006.0,137,0,137
AZE,,2019.0,166,0,166
AZE,,2011.0,71,0,71
IRL,,2003.0,350,0,350
IRL,BHR,2004.0,2,0,2
,JAM,1994.0,155,0,155
SRB,,2000.0,107,0,107
,MMR,1997.0,16,0,16
VEN,,2017.0,548,0,548
,UZB,1995.0,267,0,267
NZL,,2004.0,394,0,394
CUB,,2002.0,252,0,252
CAN,SRB,2015.0,2,0,2
CHL,,2004.0,222,0,222
,MKD,1996.0,41,0,41
NLD,LKA,2021.0,3,0,3
TTO,BRB,2004.0,2,0,2
ZAF,THA,2007.0,3,0,3
,PYF,1998.0,13,0,13
MUS,,2014.0,11,0,11
KEN,ZAF,1999.0,5,0,5
UKR,IRN,2000.0,1,0,1
NOR,LTU,2005.0,2,0,2
ETH,NGA,2001.0,2,0,2
NGA,ETH,2002.0,1,0,1
BLR,,2005.0,187,0,187
UZB,AZE,2015.0,1,0,1
AZE,UZB,2016.0,2,0,2
PHL,CHL,2020.0,1,0,1
SAU,MYS,2001.0,1,0,1
JAM,DEU,2001.0,1,0,1
,BWA,1994.0,66,0,66
,FRO,1994.0,4,0,4
,LIE,1994.0,9,0,9
IND,GRD,2008.0,1,0,1
,BHR,1995.0,52,0,52
,MLI,1994.0,69,0,69
DEU,MLI,2000.0,1,0,1
IRL,SRB,2005.0,3,0,3
GRC,,2002.0,423,0,423
,AZE,1995.0,123,0,123
MKD,,2009.0,21,0,21
,COL,1997.0,260,0,260
KWT,,2015.0,158,0,158
MCO,,2007.0,7,0,7
ZWE,NGA,2009.0,1,0,1
JOR,MAR,2015.0,1,0,1
,LUX,1997.0,31,0,31
BRA,MUS,2019.0,1,0,1
,BLR,2013.0,241,0,241
EST,JPN,2013.0,1,0,1
ISL,,1999.0,10,0,10
USA,EUE,2018.0,1,0,1
CHE,KGZ,2022.0,1,0,1
JAM,,2017.0,46,0,46
SVN,,2003.0,93,0,93
BGD,PAK,1997.0,3,0,3
KEN,,2003.0,48,0,48
,ERI,1996.0,5,0,5
LSO,ITA,1997.0,1,0,1
SVN,ARM,2018.0,1,0,1
,BFA,1995.0,72,0,72
GEO,,2002.0,34,0,34
,CAF,1995.0,13,0,13
FRA,KHM,2003.0,4,0,4
KHM,PHL,2008.0,1,0,1
FRA,PRI,2004.0,1,0,1
AZE,DEU,2007.0,2,0,2
,ECU,1995.0,98,0,98
KWT,,2001.0,48,0,48
MDG,NER,2001.0,1,0,1
NER,MDG,2002.0,1,0,1
TWN,ROU,2014.0,1,0,1
CHN,LVA,2019.0,1,0,1
,ZMB,2001.0,39,0,39
,LKA,2013.0,308,0,308
KOR,UGA,2022.0,2,0,2
ROU,MAR,2021.0,2,0,2
,ARE,2005.0,133,0,133
OMN,,2017.0,147,0,147
,KGZ,2012.0,25,0,25
,CIV,1997.0,92,0,92
KHM,ITA,2016.0,1,0,1
JOR,IND,2019.0,1,0,1
,LUX,2005.0,62,0,62
CPV,ESP,2016.0,3,0,3
,BEN,2013.0,122,0,122
JPN,DZA,2017.0,3,0,3
USA,MHL,2014.0,1,0,1
,SVN,2009.0,788,0,788
TGO,,2022.0,76,0,76
PER,NZL,2014.0,1,0,1
GHA,,2019.0,151,0,151
SEN,,2019.0,146,0,146
ESP,THA,2016.0,5,0,5
,LTU,2012.0,598,0,598
URY,,2020.0,222,0,222
,MDA,2011.0,66,0,66
IND,ARE,2001.0,3,0,3
,GTM,2013.0,67,0,67
,MDV,2012.0,3,0,3
MLI,NGA,2012.0,1,0,1
,CIV,2012.0,138,0,138
TGO,,2018.0,38,0,38
,FJI,2006.0,19,0,19
,YEM,2009.0,52,0,52
,LBN,2011.0,322,0,322
BOL,,2017.0,53,0,53
BDI,,2022.0,30,0,30
LBN,,2014.0,110,0,110
TUN,ZAF,2016.0,38,0,38
,COD,2013.0,23,0,23
CAF,,2023.0,29,0,29
FRA,IRQ,2017.0,7,0,7
,MUS,2013.0,37,0,37
CAN,HTI,2016.0,1,0,1
REU,,2022.0,14,0,14
,KGZ,1997.0,13,0,13
,MDG,2016.0,95,0,95
,KWT,2016.0,215,0,215
,MWI,2017.0,161,0,161
GAB,,2021.0,52,0,52
NGA,RUS,2021.0,5,0,5
BEL,SGP,2010.0,6,0,6
,MWI,2016.0,155,0,155
ITA,MOZ,2020.0,1,0,1
UZB,NLD,2019.0,1,0,1
GNQ,ESP,1998.0,1,0,1
PAN,,2017.0,35,0,35
,ZWE,2010.0,137,0,137
MLI,BEL,2013.0,1,0,1
SLV,,2018.0,16,0,16
NZL,IRQ,2020.0,1,0,1
MAR,BDI,2022.0,1,0,1
BOL,,2022.0,90,0,90
VUT,AUS,2006.0,2,0,2
AUS,TLS,2018.0,1,0,1
,BOL,2016.0,61,0,61
,ALB,2016.0,65,0,65
UKR,BGR,2019.0,4,0,4
BEN,NGA,1998.0,3,0,3
AUT,MNE,2016.0,1,0,1
,MNE,2017.0,60,0,60
LSO,,2021.0,13,0,13
,NAM,2019.0,43,0,43
SSD,,2024.0,47,0,47
TUR,RWA,2022.0,2,0,2
AUS,KHM,2023.0,1,0,1
VUT,,2023.0,13,0,13
LCA,,2025.0,2,0,2
UGA,ISR,2022.0,2,0,2
PAN,,2026.0,4,0,4
NOR,UKR,2021.0,3,0,3
KEN,TCD,2021.0,1,0,1
,SSD,2018.0,8,0,8
,MNG,2019.0,128,0,128
GIN,BEN,2021.0,1,0,1
,ZMB,1996.0,31,0,31
VEN,ARG,2021.0,3,0,3
,SEN,2020.0,64,0,64
GNB,,2024.0,20,0,20
,NIC,2020.0,6,0,6
DMA,CAN,2019.0,2,0,2
SRB,NOR,2018.0,5,0,5
CRI,,2005.0,29,0,29
BHS,,2020.0,8,0,8
HUN,ARG,2001.0,3,0,3
,GLP,1994.0,50,0,50
,MRT,1994.0,5,0,5
,MRT,2009.0,24,0,24
MWI,,2000.0,2,0,2
ROU,AUT,2003.0,5,0,5
MEX,PAK,2006.0,1,0,1
PNG,GHA,2000.0,1,0,1
NCL,,2007.0,8,0,8
,SEN,1998.0,88,0,88
NGA,,2000.0,56,0,56
BGD,NLD,1997.0,1,0,1
MTQ,,2007.0,6,0,6
BIH,,2014.0,96,0,96
PER,,2009.0,62,0,62
DZA,MUS,2011.0,1,0,1
GBR,CIV,1997.0,3,0,3
BEN,TGO,1998.0,1,0,1
PAK,OMN,2005.0,2,0,2
QAT,,2026.0,73,0,73
MAR,IRL,2001.0,1,0,1
NPL,,2007.0,34,0,34
AND,NLD,2001.0,1,0,1
LUX,JPN,2022.0,1,0,1
PRI,FRA,2005.0,3,0,3
FRA,PRI,2008.0,3,0,3
,GHA,1996.0,102,0,102
TUR,RUS,2006.0,4,0,4
SEN,,2009.0,49,0,49
,GNB,1995.0,8,0,8
SRB,BRA,1998.0,1,0,1
FIN,KAZ,2003.0,1,0,1
UZB,NOR,2007.0,1,0,1
ITA,PAK,1999.0,1,0,1
NOR,,1999.0,196,0,196
KWT,,2004.0,60,0,60
ITA,VNM,2001.0,1,0,1
UKR,HUN,2000.0,3,0,3
SYR,GHA,2012.0,1,0,1
OMN,,2018.0,147,0,147
DEU,YEM,2003.0,1,0,1
NLD,SDN,2003.0,4,0,4
,KHM,2007.0,48,0,48
PNG,,2015.0,27,0,27
SDN,SWE,2021.0,4,0,4
HKG,NOR,1998.0,1,0,1
GUF,,2021.0,7,0,7
OMN,,2016.0,89,0,89
DNK,SAU,1997.0,1,0,1
KOR,LKA,2009.0,2,0,2
FRA,MDA,1999.0,2,0,2
,LCA,1994.0,3,0,3
ZWE,,2014.0,30,0,30
DEU,URY,1999.0,4,0,4
KOR,UKR,2023.0,2,0,2
BLR,,2002.0,128,0,128
CMR,BOL,2008.0,1,0,1
IND,BHR,2002.0,3,0,3
UZB,BEL,1998.0,1,0,1
BHR,,2012.0,25,0,25
TUR,OMN,2000.0,2,0,2
,SMR,1998.0,3,0,3
SMR,ITA,2002.0,1,0,1
KWT,ARE,2005.0,1,0,1
ISR,SRB,2006.0,3,0,3
LVA,,2014.0,110,0,110
ITA,JOR,2010.0,1,0,1
,BRN,1995.0,15,0,15
BRA,POL,1997.0,1,0,1
ARM,BEL,2002.0,1,0,1
MWI,MYS,2011.0,1,0,1
CAN,BHS,2013.0,1,0,1
COL,GTM,2013.0,1,0,1
LIE,,2014.0,9,0,9
NGA,JAM,2017.0,2,0,2
,OMN,2005.0,110,0,110
,NAM,2009.0,25,0,25
,MTQ,2010.0,6,0,6
,PNG,2008.0,38,0,38
LAO,,2024.0,165,0,165
UKR,GRC,2013.0,1,0,1
MOZ,,2019.0,56,0,56
NGA,COL,2016.0,2,0,2
TUN,SDN,2012.0,1,0,1
GNB,,2023.0,7,0,7
,JAM,2009.0,58,0,58
HND,,2014.0,9,0,9
SDN,,2020.0,86,0,86
VNM,,2006.0,49,0,49
ESP,HKG,2011.0,2,0,2
ESP,SYC,2017.0,2,0,2
RUS,KHM,2016.0,1,0,1
,GUF,2008.0,10,0,10
RUS,COL,2012.0,2,0,2
,ZMB,2008.0,56,0,56
,MNE,2014.0,74,0,74
,VNM,2014.0,1303,0,1303
,SAU,2018.0,4374,0,4374
BEL,CIV,2020.0,2,0,2
,GEO,2015.0,205,0,205
,ZAF,2018.0,3032,0,3032
,SRB,2016.0,1060,0,1060
,SRB,2018.0,1013,0,1013
,MNG,2007.0,50,0,50
,CZE,2013.0,3055,0,3055
,PSE,2019.0,235,0,235
,SWE,2016.0,3529,0,3529
,HKG,2016.0,2166,0,2166
,IRL,2011.0,1693,0,1693
,ZAF,2017.0,2943,0,2943
,LVA,2015.0,274,0,274
,SDN,2008.0,139,0,139
,ISR,2017.0,2563,0,2563
,PRT,2019.0,3541,0,3541
,HKG,2017.0,2245,0,2245
,HUN,2020.0,980,0,980
,ISR,2018.0,2831,0,2831
,SWZ,2015.0,30,0,30
,ARG,2010.0,2722,0,2722
LBN,,2026.0,40,0,40
LKA,,2019.0,183,0,183
,ALB,2015.0,52,0,52
MNE,,2019.0,39,0,39
GHA,HKG,2018.0,5,0,5
,DZA,2018.0,1488,0,1488
ETH,CMR,2018.0,1,0,1
,NGA,2008.0,1818,0,1818
,KEN,2014.0,560,0,560
,MDG,2015.0,98,0,98
NCL,,2025.0,153,0,153
,KWT,2015.0,168,0,168
PHL,,2020.0,388,0,388
,CYP,2012.0,169,0,169
,NLD,2018.0,6697,0,6697
LBN,,2022.0,615,0,615
,SDN,2015.0,153,0,153
CRI,,2023.0,399,0,399
ITA,LKA,2020.0,4,0,4
,SYR,2009.0,91,0,91
SMR,,2025.0,19,0,19
PAN,CZE,2017.0,1,0,1
POL,,2004.0,1050,0,1050
BIH,SVN,2018.0,4,0,4
BHR,,2023.0,188,0,188
CUB,RUS,2022.0,2,0,2
,KEN,2008.0,481,0,481
MWI,IRL,2018.0,2,0,2
ITA,CAN,2024.0,1,0,1
,LVA,2014.0,262,0,262
SDN,,2025.0,689,0,689
,SVK,2016.0,1010,0,1010
SGP,EST,2023.0,1,0,1
,MWI,2014.0,146,0,146
,GHA,2016.0,723,0,723
,GHA,2017.0,830,0,830
SDN,,2021.0,137,0,137
,GRC,2012.0,2406,0,2406
,SEN,2011.0,167,0,167
,NPL,2006.0,208,0,208
PRY,,2019.0,30,0,30
,GIN,2013.0,30,0,30
HND,,2022.0,31,0,31
,EST,2013.0,332,0,332
CUB,,2023.0,1445,0,1445
CHL,NZL,2020.0,6,0,6
,GEO,2014.0,215,0,215
,LBN,2007.0,230,0,230
EST,,2021.0,392,0,392
LTU,DNK,2019.0,1,0,1
CHL,,2026.0,253,0,253
MAR,AGO,2021.0,1,0,1
,PHL,2008.0,304,0,304
MEX,ZMB,2021.0,1,0,1
SDN,,2019.0,90,0,90
,BOL,2015.0,60,0,60
,CHL,2019.0,2028,0,2028
PER,JPN,2022.0,3,0,3
YEM,,2021.0,57,0,57
,MLT,2017.0,84,0,84
,FJI,2012.0,40,0,40
,SWZ,2008.0,21,0,21
HTI,,2022.0,38,0,38
,ZMB,2017.0,133,0,133
SEN,,2020.0,156,0,156
,MLT,2018.0,103,0,103
,TWN,2020.0,3975,0,3975
,MAR,2008.0,815,0,815
,SDN,1996.0,55,0,55
,GHA,2018.0,935,0,935
,MKD,2018.0,109,0,109
,ZMB,2018.0,141,0,141
KOR,ZWE,2023.0,1,0,1
,VNM,2008.0,473,0,473
,USA,2021.0,370,0,370
MEX,VNM,2020.0,2,0,2
MLT,EST,2021.0,1,0,1
,VEN,2007.0,657,0,657
UKR,LTU,2023.0,4,0,4
AFG,TUR,2022.0,1,0,1
NIC,,2024.0,54,0,54
,SLE,2018.0,65,0,65
GUY,ZWE,2021.0,1,0,1
,OMN,2010.0,146,0,146
,NCL,2018.0,22,0,22
GIB,,2023.0,9,0,9
,GIB,2018.0,1,0,1
,IRQ,2012.0,471,0,471
TZA,,2000.0,10,0,10
KGZ,,2022.0,84,0,84
,LBN,2020.0,366,0,366
SUR,,2023.0,33,0,33
,MMR,2010.0,31,0,31
,ETH,2020.0,1743,0,1743
,GLP,2020.0,1,0,1
NGA,BGR,2023.0,1,0,1
BIH,,2016.0,88,0,88
,SEN,1994.0,286,0,286
HKG,,1999.0,133,0,133
LBN,KWT,1998.0,1,0,1
HRV,,2001.0,122,0,122
COL,,2005.0,86,0,86
DZA,TUR,2011.0,1,0,1
BLR,,2000.0,78,0,78
DEU,ISL,2000.0,3,0,3
KGZ,,2018.0,14,0,14
SVN,AUT,2000.0,1,0,1
MYS,,2003.0,117,0,117
AUT,,2001.0,600,0,600
VEN,,2004.0,165,0,165
IRQ,,2006.0,8,0,8
,SMR,1994.0,5,0,5
ITA,SMR,2000.0,2,0,2
SVK,TUR,2015.0,4,0,4
MDG,CAF,2014.0,1,0,1
KWT,FIN,2004.0,1,0,1
PRT,UKR,2003.0,1,0,1
VNM,,2002.0,32,0,32
ARG,,2001.0,333,0,333
USA,GUY,2007.0,4,0,4
GRC,SVN,2004.0,1,0,1
BRA,ROU,1998.0,3,0,3
KWT,NGA,2015.0,2,0,2
UZB,,2003.0,68,0,68
FRA,ALB,2000.0,1,0,1
TJK,,2008.0,3,0,3
ITA,MYS,1999.0,1,0,1
GRC,ZAF,2002.0,3,0,3
NOR,CZE,2003.0,2,0,2
SVK,,2006.0,262,0,262
JPN,GRC,2003.0,6,0,6
GEO,BEL,1999.0,1,0,1
ITA,GEO,2005.0,3,0,3
KEN,SRB,2000.0,1,0,1
PAK,,2001.0,105,0,105
SVK,,2000.0,157,0,157
SRB,,2012.0,277,0,277
AZE,TUR,2002.0,5,0,5
,KAZ,2000.0,111,0,111
LTU,NOR,2010.0,3,0,3
EGY,IDN,2012.0,1,0,1
SRB,,2002.0,133,0,133
UKR,NOR,2000.0,2,0,2
,PAN,1997.0,22,0,22
ZAF,THA,2021.0,2,0,2
URY,,2009.0,52,0,52
ARM,,2014.0,84,0,84
MMR,USA,2008.0,1,0,1
,BRB,2005.0,10,0,10
USA,SOM,2010.0,1,0,1
MWI,,2005.0,13,0,13
MLI,DEU,1997.0,1,0,1
ITA,PNG,2002.0,1,0,1
PNG,,2022.0,40,0,40
FIN,MYS,1997.0,1,0,1
PHL,NZL,2004.0,1,0,1
TUN,,1999.0,26,0,26
OMN,QAT,2004.0,2,0,2
MYS,DNK,2000.0,1,0,1
,GTM,1995.0,30,0,30
,PER,1995.0,128,0,128
CUB,,2006.0,223,0,223
,GAB,1997.0,17,0,17
FRA,GUY,2011.0,1,0,1
TUN,ZAF,2014.0,14,0,14
OMN,BRN,1999.0,1,0,1
CYP,,2003.0,13,0,13
IND,PRT,2004.0,7,0,7
,OMN,2000.0,70,0,70
BFA,COG,2003.0,1,0,1
,PSE,1994.0,18,0,18
PSE,ARE,2015.0,2,0,2
ARE,,2007.0,64,0,64
BRN,,2016.0,30,0,30
ISL,AUS,2002.0,1,0,1
TZA,,2010.0,59,0,59
AUS,EST,2007.0,2,0,2
VNM,,2005.0,45,0,45
NGA,,2002.0,88,0,88
CHL,DNK,1999.0,2,0,2
NER,MDG,2000.0,1,0,1
OMN,,2001.0,9,0,9
COL,SAU,2016.0,2,0,2
ECU,,2018.0,115,0,115
,TZA,2013.0,268,0,268
,ETH,2007.0,216,0,216
,BIH,2013.0,229,0,229
MLT,,2019.0,52,0,52
,BHR,2013.0,63,0,63
,UZB,2013.0,103,0,103
,GMB,2012.0,22,0,22
GNQ,,2018.0,5,0,5
BEL,PYF,2019.0,1,0,1
MUS,,2017.0,17,0,17
,BFA,2013.0,125,0,125
BEN,,2019.0,50,0,50
ISL,LUX,2014.0,5,0,5
DZA,JPN,2019.0,2,0,2
GIB,ESP,2018.0,4,0,4
,TTO,2012.0,64,0,64
DJI,,2008.0,2,0,2
,AZE,2013.0,188,0,188
,ARM,2013.0,126,0,126
,KAZ,2010.0,351,0,351
,TGO,1996.0,45,0,45
ISR,TWN,2016.0,3,0,3
COL,ARM,2013.0,3,0,3
,MOZ,2012.0,81,0,81
,IRQ,1997.0,35,0,35
SVN,AFG,2018.0,1,0,1
RWA,,2019.0,40,0,40
,ZWE,2012.0,195,0,195
,GRD,2012.0,28,0,28
,SYR,2011.0,134,0,134
GTM,DEU,2017.0,2,0,2
,NPL,2000.0,63,0,63
ETH,GUY,2019.0,1,0,1
,BRN,2013.0,50,0,50
CIV,,2018.0,135,0,135
,LAO,2012.0,38,0,38
RWA,IND,2012.0,1,0,1
NCL,,2019.0,23,0,23
PRT,PHL,2016.0,1,0,1
,CYP,1997.0,44,0,44
,GRL,1998.0,6,0,6
LBY,ITA,2018.0,2,0,2
BRA,GTM,2014.0,1,0,1
,PAN,2012.0,67,0,67
ESP,IRQ,2017.0,1,0,1
IRQ,BIH,2020.0,1,0,1
RWA,,2021.0,60,0,60
SVK,SDN,2015.0,2,0,2
BIH,,2018.0,113,0,113
BRB,,2024.0,68,0,68
BTN,,2024.0,108,0,108
,BWA,1998.0,56,0,56
KAZ,ITA,2007.0,1,0,1
,CAF,2013.0,9,0,9
BHS,,2025.0,28,0,28
FJI,,2018.0,23,0,23
,HUN,2007.0,1420,0,1420
MUS,,2022.0,51,0,51
,SVN,2007.0,734,0,734
PRK,,2022.0,52,0,52
BOL,NLD,2020.0,2,0,2
LBN,AUT,2019.0,3,0,3
,PNG,2016.0,28,0,28
,MKD,2016.0,153,0,153
,KHM,2019.0,67,0,67
,TLS,2016.0,14,0,14
KNA,,2022.0,14,0,14
SYR,QAT,2020.0,3,0,3
,ZMB,2016.0,150,0,150
OMN,,2004.0,27,0,27
,SLE,2016.0,28,0,28
,TGO,2015.0,45,0,45
,CIV,2010.0,167,0,167
PRY,,2021.0,62,0,62
MAR,,2006.0,170,0,170
BGD,RUS,2018.0,1,0,1
SVK,JPN,2020.0,3,0,3
,ERI,2016.0,16,0,16
GMB,,2022.0,28,0,28
,MLT,2016.0,76,0,76
NAM,,2022.0,66,0,66
,NPL,2010.0,302,0,302
GRC,PSE,2016.0,3,0,3
,LKA,1995.0,126,0,126
SDN,LBN,2020.0,1,0,1
CHN,UGA,2023.0,2,0,2
,SDN,2014.0,145,0,145
POL,IRQ,2014.0,1,0,1
,MOZ,1997.0,13,0,13
MOZ,PRT,2000.0,3,0,3
,MNE,2004.0,11,0,11
,BMU,2016.0,6,0,6
,NCL,2016.0,17,0,17
,SEN,2009.0,157,0,157
,AGO,2011.0,16,0,16
DNK,GNB,2004.0,3,0,3
LUX,HTI,2019.0,1,0,1
HTI,LUX,2020.0,1,0,1
UKR,CAN,2019.0,9,0,9
IRL,IRN,1998.0,2,0,2
GRD,IRL,2021.0,1,0,1
AUS,NAM,2021.0,1,0,1
,ERI,2018.0,21,0,21
NLD,SXM,2021.0,1,0,1
CMR,CZE,2022.0,3,0,3
DOM,,2022.0,45,0,45
,TUN,2020.0,675,0,675
,BGR,2019.0,476,0,476
MUS,USA,2018.0,2,0,2
ECU,,2026.0,19,0,19
ARM,,2004.0,66,0,66
LBY,UKR,2021.0,1,0,1
VNM,HKG,2023.0,1,0,1
,DMA,2018.0,2,0,2
TUR,NLD,2024.0,2,0,2
CHE,MAC,2023.0,1,0,1
,DMA,2016.0,9,0,9
,TLS,2018.0,9,0,9
NGA,,2005.0,100,0,100
MRT,MLI,2021.0,2,0,2
KAZ,,2003.0,37,0,37
TUR,NGA,2010.0,2,0,2
HKG,KAZ,2019.0,1,0,1
,LBN,1999.0,160,0,160
MCO,,2019.0,18,0,18
CIV,,2016.0,96,0,96
ARG,IND,2004.0,1,0,1
LKA,,2011.0,66,0,66
PNG,GHA,2002.0,1,0,1
FSM,USA,2001.0,1,0,1
KOR,SRB,2018.0,2,0,2
,VCT,1995.0,1,0,1
JAM,,2004.0,20,0,20
CZE,TUN,2011.0,2,0,2
LKA,NLD,2005.0,1,0,1
ETH,,2013.0,80,0,80
,BOL,1996.0,32,0,32
BGD,,2003.0,60,0,60
,PAN,2002.0,28,0,28
,LUX,2000.0,26,0,26
ITA,DZA,2004.0,2,0,2
JPN,LUX,2021.0,1,0,1
,LVA,1996.0,136,0,136
RUS,TUR,2004.0,6,0,6
SEN,ZAF,2004.0,1,0,1
SWE,CRI,2001.0,2,0,2
ITA,SAU,2002.0,3,0,3
OMN,ARE,2014.0,7,0,7
ITA,MLI,2005.0,1,0,1
MLI,DJI,2013.0,1,0,1
SRB,,2005.0,127,0,127
TWN,PNG,2002.0,1,0,1
AZE,,2020.0,202,0,202
FRA,BDI,2003.0,1,0,1
SWE,SDN,2019.0,1,0,1
,SEN,2019.0,121,0,121
MOZ,,2020.0,64,0,64
BOL,,2004.0,9,0,9
MAR,AUT,2007.0,1,0,1
AUT,MAR,2019.0,1,0,1
ARG,SWE,1999.0,9,0,9
USA,CIV,1997.0,2,0,2
,SYR,1994.0,66,0,66
LCA,PER,1997.0,1,0,1
PER,CRI,2000.0,1,0,1
MTQ,,2025.0,24,0,24
CUB,,2000.0,118,0,118
TZA,,2006.0,25,0,25
URY,VEN,1999.0,2,0,2
IND,CHL,2007.0,1,0,1
OMN,,2008.0,38,0,38
NLD,LKA,1999.0,1,0,1
SDN,NOR,2011.0,2,0,2
,BEN,1995.0,52,0,52
IRL,OMN,2000.0,2,0,2
GBR,REU,2008.0,1,0,1
AUT,BRA,1998.0,1,0,1
GUF,CMR,2004.0,1,0,1
TUR,CZE,1997.0,1,0,1
,MDA,1998.0,57,0,57
BEN,TWN,2017.0,1,0,1
SVK,KWT,2004.0,1,0,1
LIE,,2017.0,9,0,9
BFA,CHE,2014.0,3,0,3
ARM,SWE,2007.0,1,0,1
IRN,ARE,2003.0,1,0,1
CRI,,2000.0,21,0,21
ARG,KEN,2003.0,1,0,1
KGZ,FRA,2001.0,1,0,1
KHM,JPN,1999.0,3,0,3
,MWI,2008.0,96,0,96
ZWE,KEN,2016.0,2,0,2
,GEO,2008.0,131,0,131
QAT,,2015.0,68,0,68
,IRQ,2005.0,109,0,109
FIN,NZL,2024.0,1,0,1
,BLZ,2005.0,2,0,2
,NIC,2009.0,39,0,39
,LTU,2006.0,732,0,732
HUN,DEU,2022.0,41,28,13
MYS,IRQ,2018.0,182,19,163
KEN,AUT,2017.0,3,1,2
RUS,CHE,2021.0,38,13,25
RUS,GBR,2015.0,43,67,-24
ARG,USA,2022.0,130,64,66
VNM,JPN,2017.0,28,89,-61
HKG,DNK,2017.0,2,5,-3
CIV,BEL,2019.0,3,1,2
BRA,PER,2014.0,14,14,0
DEU,CHN,2019.0,489,464,25
USA,MEX,2020.0,317,398,-81
DEU,BRA,2016.0,118,107,11
CHN,THA,2020.0,47,36,11
USA,NPL,2014.0,15,20,-5
MAR,FRA,2018.0,61,101,-40
CHN,SGP,2021.0,350,547,-197
DEU,BEL,2019.0,124,140,-16
BEL,ESP,2023.0,38,35,3
NPL,USA,2019.0,53,25,28
ESP,DNK,2023.0,30,33,-3
BEL,DEU,2018.0,137,125,12
DNK,USA,2014.0,141,150,-9
SVK,CZE,2019.0,99,66,33
ROU,IRQ,2019.0,11,1,10
AUS,KOR,2022.0,50,40,10
KOR,JPN,2008.0,95,155,-60
IDN,GBR,2022.0,36,58,-22
FIN,USA,2023.0,64,43,21
SAU,NLD,2022.0,10,11,-1
MYS,JPN,2019.0,66,49,17
CHN,FRA,2004.0,32,49,-17
JPN,IDN,2019.0,195,84,111
JOR,CAN,2015.0,9,14,-5
PRT,TUN,2018.0,4,4,0
IRN,GBR,2023.0,76,26,50
NGA,GBR,2023.0,72,29,43
VNM,SGP,2021.0,3,10,-7
MYS,EGY,2018.0,7,9,-2
SWE,CHN,2015.0,89,110,-21
AUS,SAU,2019.0,68,41,27
CHE,COG,2021.0,5,9,-4
DEU,PRT,2022.0,44,47,-3
ZAF,ZWE,2021.0,53,58,-5
KGZ,RUS,2017.0,4,5,-1
RUS,KGZ,2020.0,5,4,1
USA,IRN,2023.0,81,351,-270
CHN,BGD,2020.0,34,33,1
ARG,ESP,2021.0,103,120,-17
TUR,GBR,2021.0,113,80,33
RUS,IRL,2019.0,6,2,4
FRA,EGY,2016.0,21,11,10
CAN,TUN,2005.0,2,4,-2
ITA,ECU,2020.0,9,1,8
SAU,MYS,2020.0,33,68,-35
NLD,DNK,2022.0,41,44,-3
ESP,COL,2016.0,120,61,59
CHE,IND,2012.0,23,37,-14
FIN,BEL,2014.0,10,9,1
ESP,CAN,2020.0,74,66,8
LVA,EST,2021.0,5,3,2
NGA,USA,2021.0,109,62,47
CHN,NOR,2018.0,37,31,6
IND,SAU,2018.0,188,70,118
PHL,SAU,2022.0,2,2,0
GBR,SGP,2021.0,126,126,0
SYR,USA,2022.0,1,3,-2
ITA,MAR,2020.0,4,6,-2
CAN,NLD,2021.0,87,46,41
IND,NZL,2021.0,20,9,11
IRN,KOR,2018.0,21,9,12
CAN,ESP,2023.0,38,37,1
USA,BRA,2023.0,191,492,-301
POL,UKR,2021.0,30,42,-12
MYS,IND,2023.0,43,39,4
CHL,ECU,2022.0,13,9,4
PER,MEX,2020.0,11,11,0
SDN,NLD,2022.0,2,1,1
LKA,AUS,2022.0,35,32,3
IND,CHE,1998.0,7,8,-1
NPL,IND,2011.0,38,23,15
RUS,FRA,2020.0,54,72,-18
GBR,PRT,2008.0,63,52,11
RUS,FRA,2007.0,59,41,18
SGP,JPN,2012.0,15,34,-19
CAN,CHE,1997.0,46,53,-7
BOL,DEU,2014.0,2,1,1
SVN,AUT,2003.0,7,2,5
GBR,COL,2003.0,14,5,9
DEU,POL,1998.0,51,54,-3
SWE,CHN,2014.0,87,90,-3
CHE,BRA,2007.0,8,8,0
PRT,BEL,2004.0,3,3,0
USA,BGR,2009.0,9,9,0
NLD,FIN,1997.0,10,3,7
USA,HKG,2008.0,113,133,-20
PRT,BRA,2021.0,170,238,-68
HKG,USA,1999.0,86,85,1
FIN,ESP,2014.0,8,29,-21
CZE,RUS,2022.0,13,20,-7
CZE,DEU,2002.0,44,33,11
DNK,ITA,2002.0,20,22,-2
DEU,SGP,2002.0,14,10,4
CHE,USA,1997.0,284,291,-7
UKR,AUS,2008.0,3,2,1
GBR,TZA,1997.0,9,4,5
USA,BGR,2011.0,14,16,-2
CAN,BEN,2002.0,1,3,-2
BHR,GBR,1998.0,3,2,1
USA,BEL,1997.0,86,90,-4
ITA,NLD,1997.0,30,38,-8
DNK,AUS,1997.0,5,8,-3
LBN,USA,1998.0,7,21,-14
HUN,JPN,1997.0,6,5,1
DEU,JOR,1999.0,5,1,4
POL,HUN,2017.0,2,1,1
SAU,USA,1997.0,17,31,-14
PRT,JPN,2011.0,3,3,0
DEU,MAR,1999.0,1,1,0
ARG,DEU,1999.0,25,11,14
CZE,CAN,2005.0,8,2,6
GBR,POL,2021.0,94,60,34
THA,JPN,2000.0,27,30,-3
SWE,EST,1997.0,11,1,10
FRA,GUF,2007.0,15,6,9
GBR,PAK,2005.0,20,15,5
ROU,JPN,2000.0,6,6,0
NLD,PRT,2020.0,30,33,-3
AUS,CHE,2003.0,31,43,-12
HRV,USA,2012.0,22,19,3
CUB,MEX,1997.0,6,7,-1
BRA,CUB,2003.0,8,6,2
DEU,MEX,2004.0,20,13,7
USA,LVA,1998.0,3,4,-1
AUT,CAN,2009.0,19,16,3
GBR,SAU,1998.0,14,4,10
IRN,GBR,2000.0,9,40,-31
DEU,TUR,2014.0,56,45,11
CAN,IND,2006.0,43,57,-14
USA,UKR,2007.0,25,28,-3
ISR,DEU,1999.0,29,36,-7
RUS,NLD,1998.0,11,13,-2
ARE,QAT,2011.0,7,3,4
RUS,UKR,2010.0,55,45,10
SWE,IRN,2020.0,18,63,-45
COD,COG,2011.0,27,7,20
AUS,BRN,2001.0,6,1,5
EST,SWE,2002.0,7,18,-11
CYP,TUR,2017.0,65,122,-57
JPN,FIN,2001.0,8,10,-2
SWE,DNK,2016.0,101,91,10
USA,UKR,1998.0,29,28,1
ITA,MYS,2022.0,4,4,0
JPN,RUS,2012.0,21,24,-3
IND,BGD,2007.0,12,10,2
ESP,PRT,2001.0,32,31,1
CAN,KEN,2007.0,5,2,3
NZL,DEU,2010.0,28,25,3
IND,DEU,2001.0,80,45,35
DEU,GRC,2008.0,37,33,4
FIN,FRA,2008.0,19,14,5
RUS,KAZ,2023.0,33,18,15
IRN,NZL,2020.0,31,6,25
BEL,LBN,2018.0,9,5,4
CHE,EGY,2011.0,3,2,1
CRI,CHL,2016.0,1,4,-3
EGY,AUS,2018.0,14,4,10
GBR,LBY,2022.0,9,5,4
AUT,ESP,2017.0,26,39,-13
IRN,TUR,2021.0,67,24,43
CHL,ECU,2018.0,20,11,9
SWE,FIN,2018.0,54,87,-33
DOM,MEX,2015.0,4,1,3
CAN,BFA,2017.0,4,3,1
HUN,DEU,2016.0,70,45,25
VNM,AUS,2017.0,26,29,-3
ZAF,NZL,2021.0,15,5,10
ISR,FRA,2022.0,23,30,-7
CZE,UKR,2012.0,2,3,-1
DEU,SRB,2009.0,11,15,-4
CHE,ISR,2015.0,16,19,-3
ETH,DEU,2018.0,6,15,-9
DNK,FRA,2020.0,51,52,-1
LKA,AUS,2018.0,37,22,15
FRA,SWE,2017.0,93,46,47
USA,ZMB,2018.0,12,19,-7
SWE,THA,2021.0,14,3,11
ITA,CHN,2023.0,62,65,-3
ITA,DNK,2021.0,52,38,14
KOR,IDN,2017.0,32,13,19
CAN,BEL,2019.0,38,49,-11
IND,JPN,2019.0,100,108,-8
AUT,AUS,2016.0,55,56,-1
ISR,PSE,2021.0,15,19,-4
ARG,COL,2017.0,24,20,4
ZWE,KOR,2017.0,2,3,-1
THA,DNK,2016.0,2,3,-1
LUX,FRA,2016.0,14,25,-11
CAN,ITA,2014.0,49,72,-23
ARG,MEX,2017.0,31,29,2
VEN,CUB,2015.0,2,3,-1
HKG,IND,2019.0,16,13,3
CHE,ESP,2018.0,85,120,-35
IRN,DEU,2015.0,98,38,60
IND,HKG,2016.0,24,12,12
FRA,HUN,2017.0,17,17,0
FRA,LUX,2019.0,42,20,22
AUS,JPN,2001.0,54,57,-3
HRV,GBR,2017.0,25,8,17
BEL,DNK,2007.0,4,5,-1
ARG,BRA,2016.0,50,31,19
CZE,SVK,2016.0,86,75,11
USA,MOZ,2020.0,13,8,5
SVK,SLV,2010.0,13,8,5
VNM,NZL,2018.0,6,5,1
CHL,KOR,2019.0,4,5,-1
PAK,HKG,2016.0,5,4,1
DNK,CHE,2020.0,43,40,3
IRN,JPN,2019.0,21,13,8
BRA,NLD,2014.0,31,30,1
SAU,NGA,2022.0,10,10,0
NLD,ISR,2020.0,10,17,-7
NPL,USA,2021.0,47,31,16
IND,KOR,1998.0,14,2,12
ESP,EST,2019.0,4,4,0
MYS,SGP,2020.0,30,24,6
AUT,ESP,2022.0,27,41,-14
NZL,NGA,2019.0,2,3,-1
MYS,NGA,2022.0,105,42,63
PAK,ITA,2017.0,12,19,-7
BEL,POL,2019.0,17,24,-7
SWE,FIN,2017.0,57,87,-30
HKG,USA,1998.0,70,91,-21
HUN,FRA,1998.0,18,13,5
UGA,KEN,2021.0,12,11,1
ISR,PSE,2019.0,30,6,24
CHE,EGY,2009.0,4,2,2
USA,BGR,2019.0,10,10,0
FRA,VEN,2002.0,9,7,2
ECU,COL,2020.0,4,12,-8
DEU,COL,2014.0,15,16,-1
CHE,NOR,2019.0,35,18,17
URY,ARG,2019.0,11,12,-1
CHE,ISR,2004.0,2,12,-10
PRT,AGO,2019.0,2,5,-3
MDA,RUS,2021.0,1,1,0
IND,FIN,2018.0,23,9,14
PAK,USA,2017.0,126,91,35
FJI,USA,2020.0,5,7,-2
ZAF,POL,2023.0,4,3,1
PRT,IRN,2022.0,5,24,-19
ROU,BEL,2021.0,9,13,-4
GBR,MAR,2021.0,10,6,4
BGR,RUS,2021.0,7,7,0
IND,HKG,2022.0,11,12,-1
IRN,TUR,2019.0,35,17,18
POL,RUS,2023.0,4,10,-6
FRA,NOR,2022.0,38,23,15
ESP,IND,2023.0,10,19,-9
ZAF,CMR,2022.0,6,8,-2
CRI,NLD,2022.0,3,2,1
DEU,FIN,1999.0,28,17,11
FRA,CZE,1997.0,19,9,10
UKR,GBR,2007.0,21,14,7
ITA,ROU,2004.0,6,9,-3
DNK,ZAF,2005.0,2,3,-1
SWE,AUT,2006.0,8,12,-4
KOR,AUS,2011.0,22,27,-5
FRA,COL,2004.0,10,3,7
NLD,MEX,2006.0,4,4,0
ESP,CHL,2002.0,31,35,-4
NOR,RUS,2000.0,3,17,-14
SGP,IND,2012.0,45,70,-25
CHE,AUS,1999.0,27,15,12
FRA,ARG,2001.0,27,16,11
CAN,COL,2007.0,15,14,1
BGR,GBR,2000.0,15,13,2
FIN,NLD,2014.0,19,18,1
JPN,DNK,2010.0,9,9,0
MEX,ZAF,2005.0,2,1,1
ITA,LUX,2020.0,19,5,14
SAU,USA,2002.0,36,50,-14
ARE,AUS,2003.0,3,3,0
RUS,NLD,1999.0,18,8,10
MEX,JPN,1998.0,4,8,-4
USA,NPL,2001.0,3,10,-7
GBR,GMB,2013.0,5,13,-8
ROU,DEU,2001.0,32,13,19
USA,SEN,2009.0,7,5,2
DNK,AUS,2012.0,29,31,-2
SAU,TUR,2004.0,1,1,0
BLR,RUS,2006.0,15,11,4
DEU,FIN,2007.0,33,29,4
FRA,ARG,2004.0,13,17,-4
CAN,ARE,2009.0,21,9,12
TWN,CHN,2011.0,201,140,61
AUS,ARG,2016.0,13,9,4
FRA,ECU,2001.0,2,10,-8
DEU,NZL,2014.0,40,30,10
CZE,FRA,2007.0,21,16,5
ITA,GRC,2005.0,11,10,1
GRC,CYP,2008.0,24,9,15
DNK,HUN,2011.0,2,4,-2
ITA,CZE,2003.0,5,5,0
CAN,IND,2010.0,74,115,-41
DEU,MEX,2015.0,32,41,-9
BGD,GBR,2003.0,9,13,-4
SAU,ARE,2013.0,9,11,-2
CHL,CHE,2010.0,17,9,8
IRL,CHE,2019.0,20,18,2
PRT,FIN,2020.0,5,5,0
ITA,TWN,2019.0,4,7,-3
TWN,KOR,2013.0,15,9,6
IND,SGP,2012.0,70,45,25
TUR,IRL,2017.0,4,3,1
DEU,DNK,2000.0,69,51,18
RUS,CHE,2016.0,21,13,8
MAC,SGP,2013.0,3,1,2
SWE,SGP,2015.0,11,9,2
FIN,NOR,2013.0,12,9,3
GBR,TUR,2012.0,54,31,23
SWE,FIN,2009.0,44,29,15
GBR,UGA,2011.0,12,7,5
CZE,BRA,2018.0,2,14,-12
MYS,AUS,2015.0,107,119,-12
KOR,NOR,2011.0,4,4,0
NOR,KOR,2017.0,4,4,0
CHN,EGY,2011.0,2,7,-5
NLD,PRT,2015.0,26,29,-3
CHE,DNK,2021.0,47,53,-6
ITA,PRT,2014.0,39,37,2
NER,NGA,2011.0,31,5,26
SWE,CHE,2017.0,71,59,12
NLD,ESP,2011.0,77,65,12
ISR,PSE,2017.0,14,15,-1
AUT,CAN,2018.0,22,25,-3
ITA,NPL,2017.0,3,1,2
FRA,NLD,2015.0,112,136,-24
PRT,CHE,2021.0,20,13,7
DEU,RWA,2020.0,2,2,0
PAK,MYS,2014.0,66,47,19
IDN,ESP,2023.0,1,2,-1
IND,IRN,2008.0,10,4,6
ZAF,ZWE,2016.0,24,25,-1
NGA,CAN,2023.0,19,6,13
SVK,AUT,2007.0,9,11,-2
PHL,KOR,2020.0,14,13,1
ARG,CHL,2018.0,36,26,10
PAK,KOR,2012.0,15,9,6
THA,LAO,2015.0,5,10,-5
CAN,NGA,2021.0,10,17,-7
GBR,EGY,2011.0,77,22,55
BEL,RWA,2019.0,5,2,3
IRL,LUX,2016.0,2,1,1
COD,COG,2017.0,36,84,-48
PRI,ARG,2019.0,2,3,-1
COD,COG,2022.0,52,91,-39
TUR,IRQ,2017.0,17,5,12
CHN,BRA,2015.0,10,8,2
DEU,ZAF,2013.0,33,19,14
ROU,AUT,2013.0,2,2,0
LUX,FRA,2019.0,20,42,-22
RUS,FRA,2015.0,61,65,-4
EGY,ESP,2023.0,8,8,0
SYR,EGY,2016.0,2,1,1
SAU,TUN,2015.0,11,75,-64
BEL,ZAF,2018.0,13,17,-4
ITA,SVN,2019.0,13,12,1
HKG,DEU,2018.0,16,19,-3
GBR,SVN,2019.0,11,20,-9
IRN,NOR,2021.0,36,4,32
CAN,SGP,2013.0,25,26,-1
ESP,PRT,2020.0,137,129,8
FRA,NZL,2017.0,17,9,8
USA,JOR,2015.0,66,31,35
GBR,HUN,2018.0,41,53,-12
TUR,NLD,2005.0,8,8,0
LAO,THA,2018.0,4,6,-2
QAT,JOR,2019.0,5,10,-5
CAN,TUR,2017.0,23,34,-11
AUS,KOR,2021.0,37,55,-18
KOR,AUS,2022.0,40,50,-10
BEL,CHN,2014.0,51,43,8
SLV,SVN,2012.0,7,1,6
CAN,ARG,2019.0,11,19,-8
NZL,SAU,2017.0,4,7,-3
CUB,CHL,2008.0,5,4,1
DEU,IRN,2012.0,35,65,-30
DZA,FRA,2013.0,63,120,-57
DEU,HKG,2015.0,17,8,9
COL,GBR,2008.0,11,16,-5
GMB,GBR,2019.0,9,11,-2
KOR,SGP,2018.0,36,31,5
BEL,DEU,2011.0,98,89,9
ZAF,GHA,2011.0,8,5,3
CHN,NOR,2021.0,31,45,-14
PAK,USA,2011.0,51,53,-2
AUT,CZE,2015.0,16,17,-1
KOR,CHN,2002.0,25,32,-7
IRL,MEX,2016.0,2,3,-1
ARE,MYS,2008.0,3,1,2
CHE,ESP,2011.0,49,74,-25
CHE,TUN,2013.0,3,2,1
BGD,CAN,2006.0,6,2,4
ITA,BRA,2019.0,63,67,-4
HKG,IND,2018.0,13,23,-10
RWA,ZAF,2015.0,12,1,11
TUN,TUR,2019.0,4,1,3
PRT,AGO,2017.0,4,4,0
IRN,MYS,2016.0,32,176,-144
KOR,PAK,2014.0,19,29,-10
CZE,GBR,2011.0,36,45,-9
FRA,KEN,2015.0,4,5,-1
DZA,TUN,2015.0,3,1,2
MYS,JPN,2016.0,40,71,-31
PAK,GBR,2016.0,42,99,-57
GBR,ECU,2018.0,9,7,2
ITA,ARE,2016.0,16,1,15
UGA,AUS,2017.0,7,3,4
DEU,ETH,2011.0,9,7,2
TUR,IRN,2017.0,17,41,-24
SWE,IRN,2008.0,11,8,3
DNK,HUN,2016.0,2,16,-14
JPN,TWN,2012.0,38,45,-7
EGY,ITA,2022.0,7,8,-1
ITA,ARE,2018.0,15,7,8
GRC,ITA,2018.0,35,23,12
BRB,JAM,2018.0,6,3,3
AUT,BRA,2011.0,5,5,0
IND,ARE,2015.0,37,14,23
TUR,ISR,2020.0,2,3,-1
MEX,NLD,2009.0,7,4,3
IND,OMN,2015.0,22,13,9
KOR,LKA,2021.0,9,3,6
AUT,BEL,2016.0,8,19,-11
CHN,CHL,2016.0,7,2,5
USA,IRQ,2018.0,43,20,23
ETH,IND,2011.0,6,24,-18
CUB,USA,2019.0,20,7,13
JPN,BEL,2007.0,14,11,3
IRN,SWE,2017.0,31,13,18
AUT,KOR,2020.0,5,10,-5
ITA,IRL,2018.0,55,22,33
COL,GBR,2014.0,12,19,-7
IND,IRQ,2018.0,14,1,13
NPL,NZL,2021.0,6,2,4
SGP,THA,2021.0,9,9,0
IND,SAU,2021.0,120,95,25
FRA,MEX,2011.0,59,32,27
CZE,COL,2019.0,2,1,1
USA,ETH,2022.0,28,28,0
NOR,GBR,2010.0,43,65,-22
BEL,ZAF,2016.0,18,11,7
SVN,CHE,2015.0,7,1,6
MEX,COL,2015.0,46,32,14
FIN,EGY,2018.0,9,4,5
CAN,GHA,2015.0,8,7,1
USA,ZMB,2019.0,25,7,18
GBR,KAZ,2019.0,10,6,4
FIN,IRN,2017.0,7,20,-13
GHA,NLD,2016.0,7,6,1
IRN,DNK,2023.0,40,3,37
ARG,CHL,2016.0,24,16,8
KOR,PHL,2012.0,11,3,8
CYP,TUR,2011.0,21,22,-1
MEX,FIN,2017.0,2,3,-1
ISR,DEU,2015.0,51,62,-11
ZAF,IND,2022.0,26,37,-11
MLT,ITA,2022.0,4,4,0
ARG,ESP,2016.0,78,105,-27
CAN,NOR,2022.0,25,21,4
SGP,ESP,2020.0,7,7,0
LUX,KOR,2017.0,1,2,-1
KOR,LUX,2018.0,2,3,-1
MEX,CHE,2020.0,15,7,8
VNM,KOR,2022.0,63,97,-34
GHA,MYS,2011.0,1,1,0
MYS,CAN,2014.0,24,20,4
GBR,ROU,2015.0,24,26,-2
REU,FRA,2019.0,35,19,16
ITA,SGP,2014.0,14,8,6
USA,CHL,2020.0,144,138,6
GRC,IRL,2020.0,10,2,8
CHN,NLD,2013.0,71,77,-6
KOR,AUS,2017.0,65,31,34
CHN,DNK,2014.0,45,39,6
BGD,IND,2012.0,9,17,-8
SWE,CHE,2018.0,61,69,-8
ETH,CHE,2019.0,3,6,-3
MYS,THA,2014.0,11,9,2
JPN,AUT,2020.0,11,13,-2
LBN,FRA,2015.0,43,65,-22
MKD,DEU,2014.0,3,1,2
SVN,HRV,2019.0,9,14,-5
CZE,GBR,2021.0,30,67,-37
VEN,CAN,2012.0,5,3,2
ISR,FRA,2019.0,32,39,-7
CHE,SGP,2019.0,22,31,-9
IND,NZL,2017.0,19,7,12
IRN,IND,2006.0,7,16,-9
CHN,POL,2020.0,15,11,4
USA,KAZ,2014.0,21,5,16
CAN,NZL,2006.0,29,30,-1
ESP,AUS,2018.0,50,49,1
DEU,NAM,2016.0,1,2,-1
NAM,DEU,2020.0,4,2,2
CHL,DEU,2014.0,21,46,-25
GBR,LTU,2015.0,11,5,6
IDN,AUS,2015.0,25,94,-69
BEL,FIN,2022.0,15,11,4
USA,LBR,2023.0,63,22,41
NLD,GHA,2017.0,12,3,9
SWE,NZL,2019.0,10,9,1
ITA,POL,2011.0,23,15,8
BHR,USA,2018.0,2,3,-1
FIN,RUS,2023.0,13,21,-8
CHL,NZL,2011.0,6,3,3
NZL,CHL,2017.0,6,5,1
NLD,BGD,2015.0,4,4,0
BRA,IND,2023.0,10,3,7
AUT,SAU,2023.0,3,2,1
BEL,CHN,2015.0,43,45,-2
ROU,HUN,2016.0,14,8,6
DNK,RUS,2004.0,6,10,-4
MDA,ROU,2017.0,1,8,-7
ZAF,NAM,2015.0,10,9,1
CHN,NGA,2019.0,20,37,-17
GBR,IRN,2014.0,44,48,-4
MCO,FRA,2017.0,16,12,4
ZAF,MOZ,2019.0,5,4,1
SAU,MYS,2014.0,22,58,-36
ZAF,KEN,2022.0,31,19,12
DNK,ESP,2019.0,31,42,-11
MYS,JOR,2018.0,34,8,26
FRA,MLI,2017.0,7,10,-3
DEU,TWN,2018.0,18,27,-9
FIN,CZE,2019.0,7,6,1
ESP,TUN,2017.0,17,8,9
MEX,FRA,2016.0,54,61,-7
DNK,IND,2017.0,10,28,-18
SWE,LBN,2020.0,1,2,-1
USA,BGR,2017.0,22,9,13
BEL,TUR,2017.0,21,13,8
USA,UGA,2015.0,31,27,4
ZWE,DEU,2020.0,2,1,1
SWE,ESP,2018.0,45,99,-54
KOR,SAU,2017.0,26,14,12
MAR,USA,2019.0,18,16,2
GBR,CYP,2015.0,36,25,11
NOR,SWE,2017.0,70,82,-12
IRN,ESP,2016.0,23,10,13
AUS,EGY,2014.0,6,6,0
UKR,ITA,2011.0,3,3,0
DEU,IRL,2023.0,28,27,1
FRA,TWN,2008.0,11,7,4
FIN,GBR,2015.0,68,62,6
UKR,CAN,2020.0,6,4,2
CHN,ZAF,2018.0,7,13,-6
MNE,HRV,2019.0,3,1,2
USA,SVK,2005.0,17,30,-13
CHL,ESP,2023.0,87,56,31
USA,IRQ,2017.0,36,13,23
ESP,HKG,2019.0,2,5,-3
GRC,SWE,2008.0,6,8,-2
AFG,JPN,2020.0,3,5,-2
ISR,CHE,2017.0,20,16,4
BEL,SWE,2012.0,18,16,2
EGY,CHE,2012.0,6,2,4
FRA,SGP,2023.0,10,14,-4
BEL,DNK,2015.0,19,14,5
KOR,JPN,1998.0,72,82,-10
FRA,SVK,2016.0,3,3,0
UKR,POL,2022.0,57,32,25
ZAF,CAN,2015.0,20,25,-5
VNM,KOR,2016.0,23,70,-47
DEU,HRV,2018.0,16,18,-2
BGD,HKG,2017.0,2,2,0
BEL,TZA,2023.0,2,1,1
LVA,EST,2016.0,7,2,5
KEN,CAN,2017.0,10,12,-2
NLD,ESP,2019.0,69,97,-28
AUT,NLD,2015.0,31,32,-1
ZAF,IND,2017.0,37,63,-26
THA,HKG,2020.0,9,6,3
GRC,IDN,2011.0,1,1,0
RWA,ZAF,2014.0,2,3,-1
CHE,NOR,2018.0,26,19,7
IND,IRN,2014.0,27,9,18
FRA,ZAF,2012.0,24,18,6
IDN,JPN,2014.0,34,178,-144
UKR,FRA,2014.0,23,12,11
IDN,GBR,2019.0,29,48,-19
MKD,DNK,2018.0,1,1,0
GBR,JOR,2015.0,29,6,23
FRA,BFA,1998.0,7,5,2
MEX,NLD,2021.0,18,10,8
IRN,NOR,2019.0,10,5,5
DZA,BEL,2021.0,3,4,-1
BOL,NLD,2021.0,1,1,0
QAT,SWE,2021.0,2,1,1
JPN,CZE,2021.0,7,6,1
NLD,SAU,2014.0,6,3,3
FRA,NZL,2018.0,17,23,-6
JPN,HUN,2020.0,2,7,-5
AUS,LKA,2022.0,32,35,-3
ETH,AUS,2019.0,27,11,16
ITA,ARE,2017.0,14,4,10
IRN,JPN,2018.0,11,14,-3
KEN,ZAF,2020.0,18,29,-11
IND,IRN,2004.0,13,1,12
ARG,TUR,2014.0,1,1,0
TUR,ARG,2020.0,1,5,-4
DEU,ISR,2012.0,37,40,-3
ESP,NOR,2019.0,31,23,8
NOR,ESP,2022.0,13,29,-16
AUS,KAZ,2015.0,3,2,1
COG,CAN,2018.0,1,2,-1
ARG,BRA,2019.0,36,50,-14
IND,NLD,2020.0,59,38,21
RUS,SWE,2017.0,23,22,1
KAZ,BEL,2023.0,4,2,2
AUS,PNG,2017.0,9,14,-5
ITA,PAK,2020.0,16,20,-4
LKA,USA,2003.0,10,9,1
LKA,AUS,2019.0,50,25,25
NLD,IND,2017.0,27,32,-5
BLR,DEU,2018.0,4,2,2
KEN,CAN,2022.0,8,9,-1
IND,ZAF,2016.0,70,27,43
MAR,CHN,2021.0,6,6,0
USA,EST,2019.0,16,14,2
USA,ETH,2017.0,27,21,6
ISR,IND,2022.0,70,113,-43
ETH,ITA,2020.0,7,7,0
DEU,IDN,2014.0,22,12,10
RUS,FIN,2007.0,13,5,8
DEU,TZA,2019.0,13,9,4
CAN,KOR,2012.0,31,36,-5
USA,GHA,2017.0,45,27,18
ISR,CHE,2022.0,28,13,15
BGD,THA,2023.0,5,5,0
CAN,TUR,2022.0,24,43,-19
EGY,KWT,2021.0,13,16,-3
CMR,USA,2017.0,11,7,4
IND,DNK,2011.0,14,11,3
IRL,NOR,2016.0,8,3,5
IRL,NZL,2020.0,9,9,0
KEN,GBR,2000.0,6,15,-9
FRA,CHL,2020.0,32,43,-11
JPN,NPL,2018.0,14,5,9
NGA,SAU,2019.0,8,5,3
BEL,KEN,2020.0,10,2,8
CAN,CRI,2019.0,6,4,2
YEM,SAU,2018.0,12,5,7
UGA,JPN,2023.0,1,1,0
NGA,IND,2017.0,11,10,1
DEU,TZA,2021.0,11,3,8
FIN,ESP,2020.0,18,28,-10
DEU,VNM,2017.0,21,12,9
AUS,VNM,2023.0,30,31,-1
USA,ETH,2018.0,40,33,7
LBN,CZE,2021.0,2,1,1
GBR,LAO,2018.0,6,3,3
AUT,VNM,2020.0,4,1,3
ETH,RWA,2022.0,2,1,1
ESP,IRN,2017.0,8,31,-23
PER,MEX,2014.0,3,7,-4
BRA,IRL,2023.0,11,6,5
GHA,JPN,2019.0,6,5,1
CHN,YEM,2023.0,4,2,2
MLT,ITA,2017.0,3,13,-10
CHN,IRQ,2019.0,18,6,12
IRQ,CHN,2020.0,5,18,-13
CZE,HRV,2023.0,5,4,1
CZE,ESP,2022.0,23,25,-2
CRI,CHE,2019.0,4,1,3
CRI,CHE,2021.0,2,2,0
MYS,JPN,2017.0,56,68,-12
MEX,SWE,2019.0,6,7,-1
GBR,ARG,2008.0,10,17,-7
JPN,IRN,2000.0,4,1,3
GBR,BGD,2012.0,19,15,4
MYS,NOR,2019.0,6,1,5
BGD,CHN,2019.0,37,33,4
KEN,CAN,2016.0,6,13,-7
QAT,ESP,2017.0,3,7,-4
DEU,COL,2020.0,13,43,-30
ESP,CZE,2023.0,14,15,-1
PAK,PRT,2018.0,4,1,3
PSE,ISR,2018.0,21,20,1
IND,BEL,2014.0,33,18,15
ARE,EGY,2001.0,9,10,-1
SWE,KEN,2014.0,5,1,4
SWE,GRC,2014.0,5,29,-24
FRA,NCL,1999.0,12,10,2
MEX,COL,2008.0,18,11,7
DNK,POL,1999.0,8,4,4
FRA,PRT,2007.0,29,14,15
DEU,MEX,2007.0,29,22,7
ISL,USA,1998.0,4,9,-5
BEL,CAN,2004.0,25,13,12
COG,COD,2009.0,24,14,10
SWE,ARG,2003.0,3,9,-6
FRA,UKR,2002.0,18,16,2
CZE,AUS,2021.0,6,7,-1
DEU,LVA,2004.0,4,2,2
DEU,MYS,2005.0,4,1,3
AUS,THA,1999.0,14,5,9
NLD,AUT,2006.0,19,10,9
TUR,BEL,1998.0,6,3,3
AUT,GBR,2002.0,47,55,-8
EGY,GBR,2001.0,9,21,-12
THA,VNM,2001.0,2,1,1
NOR,DEU,2000.0,18,28,-10
RUS,IND,1997.0,2,4,-2
GRC,SWE,2004.0,4,3,1
FRA,GLP,2014.0,29,48,-19
HRV,BEL,2007.0,1,1,0
CAN,IRL,2006.0,22,22,0
KGZ,RUS,2011.0,1,5,-4
ESP,BEL,2000.0,23,20,3
MNE,SRB,2010.0,3,9,-6
ITA,FIN,2002.0,8,12,-4
DEU,UKR,2000.0,9,44,-35
SWE,BRA,2007.0,10,8,2
BEL,BLR,1998.0,2,3,-1
GRC,BEL,1997.0,5,4,1
FIN,BEL,1999.0,3,2,1
GBR,ROU,2001.0,12,18,-6
CAN,SGP,2003.0,15,24,-9
FRA,PRT,1999.0,29,22,7
TTO,USA,2002.0,9,4,5
ISR,UKR,1998.0,3,4,-1
CUB,ARG,2013.0,4,4,0
NOR,GRC,2002.0,4,1,3
SVK,AUT,1998.0,3,9,-6
AUT,SVK,2000.0,10,10,0
SWE,FRA,2002.0,62,58,4
ROU,CAN,1997.0,5,1,4
PYF,FRA,2009.0,9,11,-2
AZE,TUR,2000.0,5,5,0
ROU,CZE,2009.0,1,2,-1
ARE,JOR,2020.0,17,31,-14
NLD,PRT,2004.0,15,9,6
BTN,AUS,2019.0,8,6,2
BRA,ROU,2009.0,1,1,0
AUT,NLD,2001.0,16,19,-3
BEL,AUT,2004.0,6,6,0
BGR,ESP,2001.0,8,5,3
BGR,POL,2002.0,2,2,0
POL,BGR,2003.0,2,3,-1
FIN,ITA,2003.0,8,8,0
FIN,GRC,2019.0,4,3,1
DEU,LTU,1999.0,9,3,6
LTU,DEU,2000.0,12,7,5
NLD,RUS,2014.0,8,18,-10
ITA,RUS,2007.0,19,32,-13
DEU,SAU,1999.0,3,1,2
SAU,SDN,2010.0,4,13,-9
RUS,AUT,2014.0,12,7,5
USA,JOR,2004.0,29,13,16
EGY,JOR,1999.0,3,1,2
DEU,DNK,2006.0,79,50,29
ITA,AUT,2003.0,23,29,-6
LKA,GBR,2002.0,11,8,3
GBR,LKA,2004.0,11,6,5
SEN,FRA,2006.0,30,45,-15
THA,BEL,2022.0,2,2,0
AUT,CZE,2008.0,9,8,1
NLD,VNM,2018.0,11,6,5
AUS,ISR,2005.0,5,18,-13
FIN,AUS,2006.0,10,14,-4
CZE,USA,2017.0,77,51,26
KWT,EGY,2012.0,9,17,-8
GBR,UKR,2017.0,23,28,-5
DNK,NOR,2009.0,35,27,8
SGP,PHL,2010.0,6,4,2
DEU,IDN,2004.0,4,5,-1
FRA,EGY,2011.0,18,11,7
VEN,DEU,2004.0,5,2,3
CAN,FIN,1998.0,13,20,-7
GRC,AUS,2023.0,2,6,-4
CHE,NLD,1997.0,21,22,-1
JPN,ARG,1998.0,4,1,3
ITA,GRC,2003.0,23,11,12
CIV,USA,2013.0,3,1,2
GBR,UGA,2009.0,8,11,-3
ISR,RUS,2023.0,6,16,-10
CAN,NZL,2000.0,32,11,21
SRB,SWE,2018.0,9,1,8
JPN,TUR,1997.0,8,6,2
JPN,TUR,2002.0,7,13,-6
CAN,QAT,2013.0,13,4,9
CZE,ITA,2017.0,17,15,2
ETH,ISR,2000.0,1,2,-1
BEL,CHE,2006.0,21,18,3
CHN,FRA,1998.0,19,28,-9
GBR,MYS,2001.0,30,20,10
KWT,OMN,2006.0,1,1,0
DEU,GRC,2007.0,40,59,-19
FIN,FRA,1999.0,10,13,-3
SWE,NLD,2011.0,42,45,-3
AUS,ESP,2007.0,14,20,-6
HUN,ROU,1998.0,3,4,-1
EST,SWE,2003.0,5,10,-5
SVK,SWE,1998.0,1,1,0
GBR,HRV,2017.0,8,25,-17
GBR,VEN,1999.0,7,8,-1
FRA,HUN,2009.0,17,13,4
JAM,USA,2018.0,13,12,1
POL,BLR,2003.0,6,4,2
USA,PRT,2004.0,39,34,5
AZE,RUS,2019.0,6,6,0
CHE,SVN,2004.0,1,1,0
SWE,EST,2003.0,10,5,5
POL,CAN,1999.0,12,17,-5
ISR,ESP,2003.0,3,2,1
DEU,IRL,2010.0,61,41,20
AUS,RUS,2005.0,8,12,-4
JPN,FIN,1999.0,9,4,5
JPN,NGA,2002.0,8,1,7
RUS,AUT,2015.0,9,8,1
UKR,SWE,2000.0,5,3,2
SVK,GBR,1999.0,11,14,-3
NLD,THA,2006.0,7,2,5
IND,KWT,2004.0,11,5,6
IND,BGD,2001.0,14,5,9
DNK,GBR,2006.0,70,49,21
NLD,HUN,2000.0,3,16,-13
DNK,MEX,2000.0,3,2,1
ITA,HRV,1998.0,3,3,0
NLD,HKG,2012.0,4,5,-1
BRA,NLD,1998.0,7,9,-2
BIH,SRB,1998.0,3,4,-1
NLD,SWE,1998.0,25,19,6
GBR,CMR,2005.0,6,5,1
GBR,CYP,2004.0,13,2,11
FJI,USA,2001.0,2,1,1
UKR,GBR,2004.0,13,16,-3
MAR,ITA,2004.0,4,3,1
PHL,USA,2010.0,19,51,-32
RUS,NLD,2001.0,35,17,18
NLD,DNK,2009.0,18,14,4
ZAF,GBR,2005.0,55,78,-23
FRA,PRT,2020.0,53,46,7
ESP,FIN,1999.0,6,3,3
BEL,UKR,2016.0,2,2,0
BEL,RUS,2014.0,10,13,-3
SGP,BRN,2015.0,6,3,3
BRN,TWN,2021.0,1,1,0
HUN,AUT,2005.0,13,10,3
PRT,ESP,1997.0,22,12,10
SGP,GBR,2002.0,44,52,-8
USA,CYP,2003.0,9,8,1
USA,PAK,2002.0,25,33,-8
PER,MEX,2001.0,4,1,3
CZE,NLD,1998.0,3,4,-1
SRB,HUN,2005.0,2,7,-5
EGY,GBR,2004.0,8,24,-16
FRA,UKR,2005.0,10,16,-6
BEL,JPN,2000.0,16,8,8
RUS,FIN,1998.0,24,15,9
TUR,SAU,2018.0,19,10,9
GRC,FIN,1999.0,4,1,3
NOR,PRT,2010.0,2,3,-1
TWN,GBR,2001.0,16,33,-17
GBR,TWN,2004.0,32,15,17
IND,ETH,2007.0,7,4,3
AUS,DNK,2001.0,25,32,-7
SWE,ZAF,1999.0,1,1,0
KEN,SWE,2013.0,4,2,2
TWN,AUS,2010.0,12,21,-9
SVN,SLV,1999.0,2,3,-1
UGA,GBR,2000.0,4,3,1
USA,ISL,2001.0,23,12,11
UKR,BRA,2009.0,1,1,0
ESP,CUB,2000.0,22,32,-10
GRC,CHE,2000.0,9,5,4
ZWE,USA,2001.0,17,8,9
UKR,TUR,2001.0,6,5,1
DEU,THA,2002.0,11,4,7
RUS,UZB,2000.0,7,23,-16
GHA,GBR,2006.0,6,11,-5
AUS,CHE,2005.0,32,32,0
IRN,MYS,2022.0,16,26,-10
REU,FRA,2009.0,23,24,-1
FRA,PRT,1998.0,19,14,5
ESP,CZE,2010.0,7,9,-2
BWA,USA,2005.0,8,5,3
USA,GHA,2022.0,39,48,-9
SAU,LBN,2015.0,8,1,7
HUN,SWE,2000.0,7,6,1
AUT,SVN,2002.0,4,3,1
JPN,AUT,2007.0,8,13,-5
CHE,DNK,2009.0,28,16,12
DNK,FRA,2001.0,20,19,1
DEU,DZA,2007.0,4,7,-3
GHA,GBR,2000.0,9,11,-2
VEN,ARG,2009.0,6,6,0
VEN,ESP,2013.0,39,42,-3
CMR,USA,2022.0,9,8,1
BRA,JPN,2014.0,9,20,-11
CIV,TZA,2017.0,1,2,-1
ESP,SWE,2003.0,26,23,3
NOR,ITA,2018.0,20,43,-23
MEX,ECU,2014.0,9,2,7
ECU,MEX,2016.0,5,6,-1
NZL,AUT,2001.0,1,1,0
SGP,DEU,2011.0,15,32,-17
URY,USA,1999.0,4,5,-1
CAN,HKG,2002.0,32,28,4
DEU,BGR,2016.0,16,9,7
GBR,SVK,2000.0,7,10,-3
BGR,FRA,2010.0,11,4,7
RUS,SRB,2000.0,2,9,-7
DNK,PRT,2014.0,3,9,-6
USA,NGA,2000.0,23,16,7
LVA,SWE,2000.0,4,3,1
RUS,JPN,2022.0,8,9,-1
USA,SRB,2008.0,29,27,2
CAN,SRB,2014.0,4,1,3
NZL,ITA,2015.0,4,11,-7
ESP,ISR,2008.0,4,12,-8
ARE,QAT,2016.0,10,8,2
COL,ECU,2017.0,10,6,4
CHN,CZE,2021.0,17,12,5
MEX,FIN,2022.0,6,2,4
CZE,VNM,2022.0,7,3,4
ARE,CHN,2020.0,14,20,-6
EGY,GBR,2015.0,32,67,-35
TWN,VNM,2021.0,53,32,21
CHE,NOR,2022.0,23,20,3
GBR,UKR,2016.0,20,20,0
IRN,TUR,2017.0,41,17,24
KEN,ZWE,2022.0,1,4,-3
IRL,IRN,2011.0,9,14,-5
TUR,IRN,2022.0,21,60,-39
UGA,KEN,2018.0,12,9,3
UGA,ZAF,2019.0,6,14,-8
SDN,CHN,2019.0,7,12,-5
CMR,DEU,2018.0,8,3,5
MAC,GBR,2021.0,4,3,1
MEX,PRY,2015.0,1,1,0
NGA,AUS,2017.0,8,3,5
SWE,COL,2017.0,5,1,4
BGD,SWE,2016.0,5,5,0
HKG,GBR,1997.0,11,36,-25
BRA,TUR,2019.0,2,1,1
TWN,AUS,2023.0,13,8,5
PAK,EGY,2020.0,11,6,5
KAZ,RUS,2021.0,33,57,-24
AUS,ARE,2016.0,26,9,17
URY,USA,2020.0,15,19,-4
MLT,GBR,2021.0,11,13,-2
URY,GBR,2005.0,3,1,2
PER,ITA,2020.0,4,8,-4
CZE,PRT,2022.0,4,4,0
IRN,JPN,2017.0,20,22,-2
RUS,HUN,2023.0,2,1,1
CHE,QAT,2021.0,2,2,0
BRA,ARG,2011.0,31,27,4
VNM,AUS,2019.0,37,72,-35
HRV,ITA,2020.0,8,14,-6
CAN,SAU,2023.0,36,33,3
JPN,BGD,2002.0,22,17,5
ISL,SWE,2023.0,13,5,8
ARG,CHL,2017.0,25,19,6
BGD,MYS,2022.0,27,47,-20
COL,ECU,2018.0,11,6,5
IND,ITA,2021.0,72,40,32
PHL,NZL,2018.0,4,4,0
DNK,SGP,2016.0,7,12,-5
GBR,ARG,2004.0,15,16,-1
SGP,ITA,2021.0,6,13,-7
IRN,ETH,2022.0,6,2,4
PAK,BEL,2022.0,3,5,-2
BRA,VEN,2019.0,6,7,-1
PSE,MYS,2017.0,2,7,-5
DEU,PAK,2016.0,37,32,5
USA,KWT,2021.0,29,17,12
CZE,LUX,2023.0,1,1,0
ALB,USA,2018.0,3,8,-5
CYP,GRC,2020.0,31,61,-30
CHL,PAN,2022.0,2,1,1
AUS,SGP,2023.0,39,49,-10
IND,NGA,2023.0,7,8,-1
SGP,QAT,2021.0,3,3,0
CZE,RUS,2021.0,7,23,-16
IND,KWT,2015.0,9,3,6
MYS,OMN,2018.0,17,6,11
SAU,AUS,2015.0,31,43,-12
KOR,MYS,2021.0,12,15,-3
KOR,BGD,2023.0,22,25,-3
TUR,AUT,2018.0,21,6,15
BGD,MYS,2018.0,24,78,-54
NOR,JPN,2016.0,7,9,-2
USA,MLI,2020.0,6,5,1
USA,BGD,2018.0,56,108,-52
SAU,FRA,2001.0,1,2,-1
TZA,USA,2018.0,23,19,4
BWA,ETH,2018.0,4,3,1
CAN,DZA,2015.0,13,5,8
IRN,CHN,2017.0,25,4,21
USA,KWT,2019.0,37,20,17
TUN,ITA,2020.0,9,9,0
GBR,KWT,2019.0,17,10,7
KOR,NPL,2020.0,14,6,8
BRA,PRY,2017.0,7,3,4
BRA,PRY,2022.0,8,5,3
MMR,JPN,2018.0,5,14,-9
AUT,MEX,2018.0,4,5,-1
MEX,AUT,2020.0,11,5,6
BRA,VEN,2021.0,7,11,-4
VNM,CHN,2019.0,17,31,-14
KOR,CZE,2018.0,10,1,9
CZE,KOR,2023.0,2,2,0
DNK,TUR,2022.0,4,11,-7
HRV,CHE,2017.0,9,3,6
ARE,CAN,2012.0,10,19,-9
KOR,FIN,2022.0,8,7,1
NLD,KEN,2022.0,10,6,4
COL,CHL,2013.0,14,17,-3
BGD,PAK,2012.0,9,11,-2
DEU,DZA,2020.0,6,5,1
ITA,IRN,2021.0,22,104,-82
BGD,CAN,2023.0,24,14,10
IDN,AUS,2008.0,13,19,-6
BHR,GBR,2015.0,4,6,-2
ARG,AUT,2011.0,2,1,1
SWE,CHL,2019.0,3,8,-5
DEU,NZL,1998.0,11,9,2
GIN,FRA,2010.0,5,1,4
HUN,AUT,2012.0,16,12,4
BGD,SWE,2022.0,6,4,2
BGD,USA,2001.0,16,11,5
PAK,HKG,2021.0,12,8,4
SEN,USA,2002.0,3,3,0
GBR,FLK,2021.0,4,3,1
DNK,IRL,2007.0,6,5,1
KOR,CHE,2020.0,25,17,8
ISL,DNK,2020.0,6,5,1
LTU,FIN,2023.0,2,2,0
ZAF,JPN,2021.0,4,4,0
JPN,BGD,2012.0,75,41,34
BGD,BEL,2002.0,2,2,0
SAU,BGD,2020.0,7,4,3
BGD,CAN,2010.0,13,6,7
BGD,GBR,2012.0,15,19,-4
GBR,BGD,2005.0,15,9,6
SWE,KWT,2005.0,1,1,0
BGD,SWE,2018.0,6,6,0
IND,IRL,2015.0,19,18,1
RUS,AUT,2008.0,9,3,6
CHE,IRN,2021.0,19,42,-23
PRT,ROU,2020.0,7,2,5
SWE,IND,2003.0,7,14,-7
CHN,DNK,2004.0,9,8,1
BEL,CHL,2012.0,5,6,-1
MYS,KOR,2015.0,14,13,1
BEL,IND,2010.0,8,28,-20
FLK,GBR,2006.0,2,2,0
USA,JAM,2020.0,10,23,-13
CHN,VNM,2022.0,23,10,13
IND,BHR,1997.0,3,1,2
PHL,SAU,2021.0,2,3,-1
NZL,CHE,2021.0,10,14,-4
SGP,IND,2013.0,62,53,9
CHN,IRN,2021.0,43,65,-22
GBR,NPL,2007.0,3,5,-2
SRB,USA,2010.0,16,22,-6
SWE,TZA,1997.0,1,1,0
GRC,NOR,2016.0,11,3,8
ITA,LUX,2014.0,13,3,10
JPN,ROU,2000.0,6,6,0
KOR,BEL,2014.0,8,13,-5
ETH,THA,2013.0,3,1,2
GRC,BGD,2008.0,1,1,0
BFA,MAR,2016.0,1,1,0
ETH,GHA,2020.0,2,1,1
EST,FIN,2000.0,8,5,3
VNM,FRA,2020.0,26,80,-54
ZAF,FRA,2015.0,27,32,-5
COL,PER,2015.0,4,3,1
BEL,ROU,2023.0,3,3,0
BIH,SRB,2020.0,16,22,-6
PSE,NOR,2021.0,1,1,0
NZL,ARE,2023.0,7,1,6
DZA,ESP,2022.0,5,7,-2
ARG,CHL,2022.0,39,14,25
RUS,GEO,2020.0,6,5,1
KWT,GBR,2020.0,8,26,-18
CHL,GBR,2022.0,50,35,15
URY,VEN,2019.0,1,4,-3
BGD,IND,2002.0,12,15,-3
ZAF,CHL,2012.0,2,2,0
GBR,BGR,2022.0,2,3,-1
ROU,HUN,2022.0,25,15,10
NOR,MYS,2019.0,1,6,-5
ESP,VEN,2002.0,15,17,-2
ESP,VEN,2012.0,24,46,-22
MCO,FRA,2018.0,7,16,-9
IND,BGD,2004.0,7,7,0
PAK,NZL,2019.0,8,8,0
CAN,HKG,2005.0,16,30,-14
KEN,JPN,2001.0,6,4,2
CAN,TZA,2011.0,2,1,1
AUS,IND,2000.0,24,24,0
USA,KAZ,2004.0,4,1,3
NPL,USA,2022.0,49,28,21
ECU,ARG,2013.0,5,6,-1
ECU,GBR,2018.0,7,9,-2
ARE,JOR,2007.0,5,6,-1
USA,CHL,1999.0,57,38,19
AUT,CZE,2001.0,6,10,-4
FRA,SRB,2004.0,9,4,5
CHE,KOR,2002.0,4,4,0
MYS,FRA,2021.0,7,6,1
IDN,USA,2000.0,23,11,12
ARG,GBR,2000.0,16,10,6
TZA,NLD,2012.0,1,7,-6
IND,RUS,2002.0,4,3,1
IND,CHE,2008.0,31,12,19
PYF,FRA,2019.0,21,17,4
BRA,DNK,2006.0,2,5,-3
GBR,JAM,2007.0,2,5,-3
NOR,ISL,2005.0,5,1,4
JPN,AUT,1998.0,5,10,-5
KWT,USA,2013.0,7,12,-5
MEX,CAN,1999.0,18,11,7
BEL,BRA,2003.0,6,7,-1
GBR,EST,1997.0,2,1,1
RUS,NOR,2007.0,25,5,20
MTQ,FRA,2014.0,25,18,7
NLD,ECU,2019.0,8,3,5
ECU,NLD,2021.0,2,9,-7
USA,SEN,2017.0,16,6,10
DEU,HUN,1998.0,23,34,-11
GBR,LUX,2016.0,13,11,2
DNK,NZL,2002.0,6,3,3
CAN,THA,2022.0,8,14,-6
UZB,USA,2003.0,3,2,1
UZB,TUR,2006.0,1,1,0
CHE,AUS,2001.0,32,37,-5
NLD,RUS,2001.0,17,35,-18
IND,MYS,2006.0,25,19,6
ARE,HUN,1999.0,1,1,0
DEU,TUR,1999.0,16,5,11
ARM,DEU,2018.0,3,5,-2
KOR,SRB,2015.0,1,3,-2
ZAF,CHE,2003.0,6,6,0
MLI,GIN,2017.0,4,1,3
RUS,HUN,2000.0,4,2,2
TWN,GBR,2004.0,15,32,-17
SAU,IND,2001.0,7,10,-3
ITA,SAU,2000.0,2,1,1
BEL,KOR,2009.0,4,1,3
AUT,IND,2005.0,6,5,1
EGY,KWT,2009.0,11,12,-1
NOR,CAN,1998.0,10,9,1
CHL,ESP,2000.0,21,17,4
CRI,CAN,2014.0,1,2,-1
AUT,NOR,2009.0,11,3,8
NLD,CHL,2010.0,5,4,1
LTU,POL,2007.0,2,1,1
SGP,CHE,2021.0,33,16,17
AUT,HUN,2007.0,16,8,8
SVN,SVK,2002.0,4,9,-5
BEL,AUS,2003.0,18,15,3
COL,USA,1998.0,28,42,-14
KOR,PAK,2001.0,1,1,0
IND,ARE,2004.0,8,1,7
TUR,KAZ,2023.0,5,4,1
PHL,USA,2006.0,16,12,4
NAM,GBR,2015.0,2,1,1
GBR,ARG,2001.0,11,17,-6
SAU,CAN,2003.0,15,19,-4
KEN,NLD,2006.0,3,4,-1
AUT,IND,2012.0,3,6,-3
VIR,USA,2004.0,1,3,-2
ZAF,FRA,2008.0,16,22,-6
GBR,SAU,2004.0,34,12,22
SWE,MEX,2005.0,4,1,3
USA,ECU,2014.0,24,14,10
NLD,TWN,2022.0,7,6,1
USA,JAM,1998.0,4,8,-4
NLD,SGP,2003.0,4,3,1
JPN,FIN,1998.0,5,10,-5
FIN,POL,1997.0,3,4,-1
FIN,POL,2012.0,9,8,1
BEL,ZAF,2017.0,12,6,6
GBR,SAU,2001.0,21,16,5
DEU,LTU,1998.0,2,6,-4
JPN,SAU,2018.0,16,7,9
JPN,AUS,2013.0,68,63,5
NLD,NZL,2009.0,18,8,10
PAK,SAU,1997.0,2,2,0
DNK,GRC,2008.0,5,5,0
CHL,CAN,2005.0,8,5,3
OMN,ARE,2017.0,13,1,12
ESP,CRI,2012.0,10,3,7
UKR,ITA,2021.0,7,7,0
BEL,HKG,1998.0,4,3,1
FRA,PYF,2019.0,17,21,-4
DEU,ARE,2006.0,2,2,0
SWE,HUN,2010.0,7,14,-7
ISR,ITA,2013.0,7,15,-8
MEX,COL,2004.0,11,8,3
ITA,ROU,1999.0,9,7,2
COL,AUS,2005.0,4,2,2
GRC,DEU,2003.0,27,40,-13
ISL,NOR,2003.0,7,2,5
CAN,CHL,2019.0,26,21,5
GBR,MEX,2013.0,50,36,14
HUN,CHE,2003.0,10,7,3
BEL,SWE,2005.0,9,11,-2
POL,NLD,2010.0,29,19,10
SGP,NLD,2015.0,17,29,-12
USA,URY,2003.0,12,8,4
CHN,DNK,2008.0,21,19,2
ESP,FIN,2007.0,5,12,-7
TTO,IND,2019.0,4,4,0
ARG,CAN,2016.0,25,16,9
POL,AUS,2007.0,8,1,7
UKR,GBR,2015.0,26,30,-4
USA,ECU,2004.0,4,8,-4
LBN,USA,2001.0,14,24,-10
FRA,IRL,2002.0,21,16,5
BEL,RUS,2004.0,9,10,-1
HUN,ITA,2013.0,10,12,-2
KOR,RUS,2002.0,15,25,-10
SRB,MNE,2001.0,4,2,2
ROU,ZAF,2008.0,1,2,-1
USA,GEO,1999.0,29,26,3
THA,CAN,2013.0,7,22,-15
KAZ,RUS,2009.0,11,20,-9
ROU,FRA,1997.0,14,28,-14
USA,UKR,2014.0,36,28,8
USA,MDA,2009.0,4,4,0
IND,BGD,2015.0,14,8,6
SRB,MKD,2006.0,18,43,-25
DEU,QAT,2013.0,8,1,7
NLD,JPN,2009.0,22,13,9
USA,KWT,2009.0,19,8,11
PNG,USA,1997.0,1,4,-3
USA,BGR,2018.0,16,8,8
SRB,GBR,2016.0,12,9,3
JPN,AFG,2020.0,5,3,2
TZA,FRA,2011.0,1,1,0
FRA,TZA,2012.0,1,1,0
EGY,ARE,2003.0,8,13,-5
CZE,SVK,2009.0,27,45,-18
ZAF,NOR,1999.0,2,2,0
AUT,UKR,2011.0,2,2,0
UKR,FRA,2001.0,12,8,4
SAU,TUN,2014.0,10,50,-40
COL,BRA,1997.0,1,4,-3
CUB,MEX,2003.0,17,5,12
CHE,TUR,2012.0,7,11,-4
CHN,FRA,1999.0,23,31,-8
TTO,IND,2009.0,3,2,1
SVK,HRV,1999.0,1,1,0
LKA,CAN,2004.0,2,2,0
CHL,VEN,2020.0,2,24,-22
SEN,GIN,2021.0,5,3,2
ARG,AUS,1999.0,2,3,-1
JOR,OMN,2001.0,4,1,3
QAT,JOR,2009.0,4,3,1
ITA,AUT,2013.0,47,46,1
PAK,IRL,2013.0,4,4,0
MWI,NLD,2015.0,2,3,-1
HRV,GBR,2019.0,22,4,18
MYS,GBR,1998.0,9,28,-19
CAN,CYP,2006.0,2,1,1
UZB,RUS,2011.0,10,8,2
JPN,BRA,2017.0,17,11,6
URY,ESP,2014.0,4,25,-21
CHE,IRN,2019.0,11,52,-41
PAK,USA,2009.0,50,51,-1
NOR,JPN,2022.0,10,12,-2
ESP,MAR,2023.0,7,6,1
CIV,ZAF,2010.0,8,1,7
KOR,SAU,2016.0,27,9,18
CAN,COL,2014.0,16,12,4
ROU,CHE,2016.0,10,8,2
ITA,IRN,2011.0,10,13,-3
FRA,FIN,2013.0,24,21,3
CAN,CRI,2009.0,5,1,4
SGP,ETH,2015.0,1,1,0
FIN,JPN,2012.0,7,12,-5
GBR,TZA,2013.0,14,4,10
ETH,ZAF,2005.0,3,4,-1
SRB,ESP,2011.0,7,2,5
UGA,GBR,2010.0,8,17,-9
GBR,UGA,2021.0,27,16,11
BEL,BGR,2009.0,4,10,-6
SAU,JOR,2023.0,24,13,11
DEU,ETH,2021.0,15,5,10
SWE,ISR,2017.0,5,5,0
BEL,CZE,2011.0,7,9,-2
CZE,SRB,2013.0,1,2,-1
EST,NLD,2008.0,1,1,0
IND,ITA,2011.0,43,37,6
RUS,SGP,2012.0,1,3,-2
BEL,THA,2012.0,3,7,-4
IND,KWT,2014.0,7,2,5
KEN,MEX,2020.0,1,2,-1
TUR,NLD,2012.0,17,22,-5
FRA,BEN,2011.0,22,9,13
EGY,AUS,2011.0,4,4,0
IRQ,CAN,2018.0,4,1,3
SGP,ARE,2020.0,9,3,6
TWN,NLD,2021.0,7,5,2
BRA,KOR,2020.0,3,1,2
MEX,FIN,2018.0,3,1,2
ESP,SVN,2021.0,7,8,-1
NOR,ITA,2017.0,15,30,-15
MAC,BRA,2013.0,1,1,0
COL,FRA,2022.0,22,16,6
DEU,JOR,2015.0,12,9,3
PAK,NLD,2015.0,8,18,-10
VNM,BEL,2014.0,4,12,-8
ESP,TUR,2020.0,16,17,-1
CAN,JOR,2017.0,13,8,5
DEU,TWN,2022.0,21,24,-3
LAO,FRA,2015.0,3,4,-1
JPN,IRL,2021.0,10,3,7
USA,MYS,2003.0,22,11,11
KEN,IND,2020.0,4,4,0
KOR,SWE,2016.0,13,9,4
AUS,LKA,2016.0,30,17,13
ITA,MNG,2021.0,2,2,0
MYS,PHL,2008.0,3,1,2
NLD,JPN,2011.0,15,24,-9
JPN,NLD,2012.0,24,15,9
PNG,AUS,2012.0,4,13,-9
BGR,PRT,2008.0,2,1,1
IND,CHN,2012.0,16,16,0
RUS,TWN,2019.0,2,2,0
IND,IRL,2008.0,11,4,7
MYS,QAT,2020.0,12,2,10
BGR,POL,2012.0,2,1,1
AUT,POL,2014.0,5,4,1
SGP,NZL,2013.0,4,11,-7
KOR,SWE,2022.0,12,10,2
GRC,AUT,2008.0,4,4,0
ITA,PER,2021.0,2,2,0
DEU,CYP,2016.0,3,4,-1
TUR,IND,2020.0,6,8,-2
ESP,KOR,2011.0,2,5,-3
USA,NGA,2010.0,29,30,-1
BRA,COL,2013.0,24,43,-19
USA,NIC,2009.0,4,5,-1
IRL,SVK,2012.0,2,2,0
CHN,TWN,2006.0,62,48,14
ESP,NOR,2011.0,12,8,4
EST,FIN,2006.0,3,8,-5
MAC,USA,2023.0,5,7,-2
DEU,TJK,2022.0,1,1,0
PRT,MEX,2016.0,8,1,7
LUX,KOR,2018.0,3,2,1
USA,IRQ,2016.0,20,16,4
NGA,AUS,2018.0,10,5,5
FRA,UKR,2012.0,10,17,-7
KEN,GHA,2016.0,4,2,2
TUN,USA,2015.0,6,7,-1
PRT,GBR,2006.0,32,49,-17
MEX,JPN,2015.0,6,10,-4
IRN,ITA,2007.0,7,4,3
MEX,IND,2012.0,3,6,-3
NZL,AUT,2014.0,6,6,0
MYS,NOR,2011.0,3,1,2
IND,BEL,2015.0,23,20,3
VEN,GBR,2013.0,3,3,0
DEU,COL,2007.0,6,9,-3
HUN,JPN,2013.0,7,6,1
KOR,VNM,2013.0,43,22,21
PRI,COL,2010.0,2,2,0
QAT,PAK,2016.0,5,5,0
AZE,GBR,2012.0,3,1,2
CHL,CAN,2012.0,17,23,-6
MWI,IRL,2015.0,1,2,-1
ESP,THA,2018.0,7,1,6
CAN,BEL,2016.0,38,43,-5
CZE,HUN,2004.0,3,1,2
CAN,EGY,2021.0,60,66,-6
DEU,GEO,2016.0,5,6,-1
HRV,GBR,2021.0,14,10,4
KEN,DEU,2017.0,13,16,-3
FRA,NER,2015.0,5,3,2
YEM,MYS,2023.0,11,9,2
GBR,VEN,1998.0,11,5,6
ITA,COL,2017.0,12,7,5
BRA,NZL,2016.0,4,2,2
SGP,EGY,2018.0,1,3,-2
RWA,CAN,2019.0,4,1,3
NZL,TUR,2021.0,3,2,1
ROU,BEL,2016.0,12,2,10
MDA,RUS,2016.0,11,4,7
CAN,CZE,2020.0,12,12,0
MAR,ARE,2021.0,4,1,3
GBR,GHA,2016.0,25,15,10
SLE,CHN,2017.0,1,1,0
NZL,LKA,2020.0,5,7,-2
GIN,DEU,2016.0,1,1,0
IRL,SWE,2021.0,16,12,4
CHN,DNK,2015.0,63,45,18
CHN,ZAF,2016.0,9,12,-3
PRT,CUB,2022.0,1,1,0
DMA,USA,2017.0,5,2,3
KOR,MNG,2020.0,9,2,7
CHE,BEL,2018.0,50,64,-14
SWE,COL,2016.0,3,1,2
ZAF,KEN,2017.0,24,11,13
GBR,MWI,2017.0,25,19,6
MKD,GRC,2014.0,1,4,-3
TUR,SGP,2023.0,2,2,0
PRT,POL,2017.0,7,6,1
TUR,FIN,2022.0,15,2,13
TUR,KOR,2023.0,5,4,1
CRI,COL,2015.0,6,1,5
ESP,IRL,2023.0,21,23,-2
CHE,ISR,1998.0,7,4,3
NLD,IRN,2013.0,14,31,-17
ZMB,IND,2017.0,1,1,0
ZAF,KEN,2016.0,23,14,9
DEU,TWN,2016.0,25,24,1
BEN,DEU,2017.0,3,4,-1
FRA,MTQ,2016.0,15,33,-18
IRN,TUR,2018.0,28,21,7
GBR,RUS,2023.0,21,53,-32
AUS,BRA,2022.0,26,53,-27
NCL,FRA,2014.0,26,26,0
PHL,ESP,2017.0,6,5,1
BRA,MOZ,2021.0,14,4,10
SWE,BOL,2013.0,2,3,-1
ARE,EGY,2004.0,7,8,-1
BEL,TUN,2019.0,5,5,0
SRB,ZAF,2021.0,1,1,0
IRN,CHN,2022.0,46,31,15
CHN,KEN,2023.0,6,6,0
SVK,GBR,2007.0,5,9,-4
CAN,RUS,2013.0,19,17,2
RUS,PRT,2020.0,7,1,6
ISR,IND,2016.0,27,118,-91
FRA,GUY,2020.0,1,1,0
DNK,GHA,2017.0,4,1,3
KEN,DEU,2018.0,13,15,-2
MYS,JOR,2017.0,22,10,12
CHN,ITA,2004.0,12,12,0
DNK,KOR,2022.0,8,12,-4
PAK,OMN,2012.0,8,2,6
SGP,IDN,2014.0,6,2,4
TWN,RUS,2018.0,5,4,1
AUT,TUR,2013.0,7,8,-1
SEN,CHE,2016.0,1,1,0
BEL,BFA,2021.0,5,7,-2
ISR,PSE,2022.0,14,5,9
COL,FRA,2018.0,22,39,-17
KEN,UGA,2016.0,11,4,7
ITA,HRV,2020.0,14,8,6
MNG,USA,2019.0,4,7,-3
KOR,SWE,2017.0,11,7,4
KOR,NGA,2021.0,4,3,1
UGA,GBR,2023.0,9,14,-5
LTU,POL,2020.0,5,1,4
ISR,AUS,2020.0,14,21,-7
FIN,BRA,2014.0,8,2,6
ITA,BIH,2017.0,1,1,0
USA,UGA,2014.0,23,29,-6
CZE,ITA,2022.0,13,40,-27
SAU,NLD,2021.0,6,16,-10
MDA,ROU,2018.0,5,2,3
CHN,MYS,2018.0,15,52,-37
KOR,SGP,2016.0,39,31,8
NGA,IND,2018.0,11,26,-15
RUS,JPN,2017.0,15,8,7
AUT,HUN,2020.0,17,34,-17
LBN,BEL,2021.0,8,5,3
SDN,CHN,2021.0,9,25,-16
CRI,CIV,2019.0,6,1,5
RUS,DNK,2020.0,7,9,-2
GHA,NZL,2020.0,2,1,1
BGD,ITA,2004.0,1,1,0
COL,ESP,2003.0,19,19,0
POL,MEX,2000.0,5,1,4
TUR,UKR,2016.0,2,2,0
HRV,HUN,2019.0,2,2,0
PER,DEU,2019.0,10,7,3
PAK,ITA,2019.0,14,28,-14
BEL,AUT,2015.0,14,10,4
FRA,GLP,2015.0,27,46,-19
MEX,CRI,2001.0,1,3,-2
AUT,FRA,2007.0,19,26,-7
FIN,FRA,2007.0,16,10,6
ARG,CUB,2002.0,2,4,-2
SGP,IDN,2008.0,2,5,-3
PHL,CHN,2018.0,6,3,3
DEU,UKR,2023.0,8,34,-26
RWA,GBR,2020.0,7,2,5
CHN,IRN,2019.0,18,70,-52
MEX,BEL,2021.0,11,6,5
IRQ,CAN,2022.0,3,3,0
THA,DNK,2021.0,7,6,1
USA,KAZ,2015.0,25,9,16
CHN,NZL,2007.0,8,8,0
GBR,UGA,2019.0,21,12,9
NLD,IRL,2023.0,9,19,-10
SDN,SWE,2011.0,1,1,0
ZAF,RUS,2017.0,115,4,111
AUS,IND,2006.0,28,47,-19
BEL,LBN,2019.0,6,7,-1
PRK,CHN,2020.0,10,14,-4
POL,BRA,2019.0,8,6,2
IDN,KOR,2019.0,18,50,-32
DEU,LUX,2020.0,37,37,0
MLT,GBR,2019.0,13,24,-11
MYS,BRN,2020.0,12,2,10
COG,ETH,2019.0,1,1,0
HKG,IND,2022.0,12,11,1
USA,BGR,2022.0,6,7,-1
FRA,BEN,2019.0,12,10,2
SAU,JPN,2020.0,8,13,-5
DZA,CAN,2020.0,6,6,0
IRN,EGY,2016.0,2,3,-1
BGD,CHN,2021.0,39,55,-16
BEL,CIV,2019.0,1,3,-2
FIN,SRB,2001.0,3,3,0
JPN,KHM,2022.0,11,1,10
TWN,SWE,2003.0,2,1,1
CZE,CHE,2012.0,17,10,7
SAU,NGA,2021.0,9,12,-3
ROU,SWE,1999.0,4,1,3
AUT,BRA,2021.0,6,19,-13
NLD,AUT,2023.0,17,21,-4
CHE,BGR,2022.0,4,2,2
NPL,AUS,2023.0,7,6,1
GBR,SVK,2023.0,5,9,-4
NLD,ARG,2023.0,2,4,-2
UGA,AUS,2022.0,1,2,-1
IND,NZL,2022.0,14,14,0
GBR,KWT,2021.0,18,6,12
POL,CHE,2022.0,23,12,11
GHA,JPN,2021.0,6,2,4
PHL,ESP,2022.0,3,1,2
CHL,NLD,2023.0,9,10,-1
SWE,GHA,2012.0,4,2,2
CHN,CHL,2022.0,6,6,0
SRB,USA,2023.0,9,8,1
GHA,NOR,2018.0,3,4,-1
BEL,POL,2022.0,13,19,-6
JPN,NOR,2023.0,6,4,2
AUS,GHA,2023.0,6,9,-3
MWI,GBR,2022.0,17,19,-2
USA,MDG,2022.0,5,6,-1
UZB,RUS,2019.0,5,15,-10
FRA,SRB,2001.0,9,7,2
GRC,SRB,2003.0,7,1,6
HUN,SVK,2015.0,8,6,2
USA,ISL,2008.0,12,13,-1
CZE,BGR,1999.0,1,2,-1
ZAF,SAU,2006.0,6,3,3
SAU,ZAF,2008.0,7,2,5
SGP,GRC,2022.0,1,2,-1
COL,ITA,2010.0,9,3,6
PRT,CHN,2020.0,12,12,0
CHN,PRT,2021.0,12,17,-5
MLI,USA,2002.0,3,5,-2
UKR,GBR,2001.0,17,7,10
MEX,SWE,2009.0,3,3,0
JPN,ARE,2018.0,7,4,3
HKG,JPN,1997.0,6,2,4
SWE,JPN,2003.0,37,29,8
MKD,DEU,2008.0,2,3,-1
VEN,DEU,2001.0,6,2,4
DEU,VEN,2016.0,2,6,-4
DEU,VEN,2018.0,3,10,-7
FRA,ZAF,2005.0,13,11,2
PYF,FRA,2011.0,7,20,-13
SGP,FRA,2006.0,8,14,-6
ESP,IRL,2010.0,9,20,-11
SAU,GBR,2007.0,16,37,-21
TUR,BEL,1999.0,3,3,0
CHE,IRL,2003.0,8,6,2
SWE,AUS,2000.0,25,21,4
POL,BLR,2013.0,8,9,-1
TUR,FRA,1998.0,7,7,0
BRA,KOR,1999.0,1,1,0
NZL,MYS,2023.0,2,4,-2
GBR,COL,2002.0,19,11,8
GBR,PHL,2016.0,3,3,0
ZAF,AUT,1998.0,2,2,0
FRA,CIV,2005.0,19,16,3
AUS,VNM,2006.0,7,1,6
CAN,LBN,2002.0,4,6,-2
KEN,BWA,2009.0,1,1,0
CHE,HRV,2002.0,2,9,-7
DNK,NLD,2018.0,31,50,-19
BEN,FRA,2012.0,16,12,4
BRA,NLD,2007.0,12,19,-7
RUS,SVK,2001.0,9,3,6
COL,ARG,2003.0,1,2,-1
OMN,EGY,2004.0,3,5,-2
MCO,FRA,2022.0,7,11,-4
RUS,LVA,2000.0,3,1,2
BGD,SGP,2012.0,2,4,-2
ISR,CHE,2016.0,15,15,0
ARG,DEU,2008.0,21,35,-14
KAZ,USA,2014.0,5,21,-16
DEU,BLR,2000.0,9,14,-5
ISR,RUS,2000.0,9,25,-16
ZWE,AUS,2018.0,2,3,-1
NOR,TUR,2000.0,3,1,2
SWE,CHL,2011.0,7,4,3
GNB,DNK,2006.0,11,2,9
NLD,TUR,2001.0,6,4,2
CAN,AUT,1998.0,9,12,-3
SRB,GRC,1998.0,2,1,1
UKR,NOR,2002.0,2,1,1
ESP,POL,1997.0,8,1,7
FIN,NLD,2020.0,25,24,1
KEN,POL,2008.0,1,2,-1
KWT,SAU,2004.0,3,2,1
AUS,FIN,2017.0,18,17,1
JPN,NLD,1997.0,18,28,-10
USA,MLI,1999.0,1,2,-1
FRA,REU,2003.0,6,4,2
FRA,EGY,2019.0,16,18,-2
USA,VNM,2003.0,15,5,10
USA,VEN,2017.0,17,33,-16
SAU,FRA,2015.0,14,38,-24
CHE,ISR,1999.0,2,8,-6
IND,NLD,1998.0,9,8,1
SVK,NLD,2005.0,7,1,6
BGD,PAK,2002.0,3,1,2
ZAF,DEU,2003.0,21,25,-4
DEU,SVK,2010.0,14,14,0
TTO,GBR,2016.0,6,3,3
AUT,CHN,1997.0,3,6,-3
CHE,CHL,2003.0,7,11,-4
SWE,POL,2018.0,24,25,-1
NLD,PRT,2014.0,21,24,-3
BEL,RUS,2001.0,12,20,-8
FIN,IRL,2000.0,4,1,3
COL,BRA,2002.0,3,10,-7
EST,FRA,2010.0,3,4,-1
FRA,EST,2011.0,4,1,3
MEX,GBR,1998.0,22,24,-2
SEN,FRA,2010.0,36,39,-3
HUN,FRA,2004.0,11,12,-1
UKR,USA,2015.0,25,17,8
SGP,MYS,2005.0,7,8,-1
ITA,IND,2000.0,11,11,0
NZL,ITA,2004.0,1,1,0
ISR,UKR,2007.0,2,3,-1
USA,ECU,2001.0,7,7,0
BRB,GBR,2013.0,3,2,1
DNK,CHN,2003.0,6,6,0
ZAF,AUS,2005.0,26,18,8
USA,GAB,2005.0,2,3,-1
SWE,BEL,2006.0,13,11,2
DEU,NER,2004.0,1,1,0
SGP,JPN,2013.0,23,42,-19
CHN,KHM,2011.0,1,1,0
PAK,IND,2004.0,6,7,-1
COL,GBR,2004.0,7,11,-4
FRA,TWN,2001.0,9,3,6
AUT,UKR,2009.0,1,7,-6
EGY,OMN,2002.0,3,3,0
GBR,BGD,1997.0,6,4,2
DEU,BGD,2005.0,3,1,2
DOM,ESP,2000.0,1,1,0
IRL,FRA,2016.0,29,34,-5
SRB,FRA,2003.0,5,8,-3
USA,ROU,1998.0,6,30,-24
IND,THA,2006.0,5,3,2
ESP,MDA,2006.0,2,1,1
MAC,USA,2006.0,1,6,-5
URY,GBR,1997.0,1,3,-2
GBR,BIH,2021.0,3,1,2
ITA,TUR,1998.0,5,3,2
BEL,JPN,2023.0,6,9,-3
MEX,GBR,1999.0,22,40,-18
AUS,HKG,2002.0,35,30,5
ARE,EGY,2008.0,8,11,-3
BRA,IND,2000.0,5,4,1
ROU,ITA,1998.0,8,7,1
GBR,ROU,2014.0,15,26,-11
IRN,FIN,2018.0,15,3,12
CHL,ARG,2012.0,19,22,-3
PRT,GRC,2015.0,5,4,1
SAU,KOR,2021.0,15,27,-12
USA,PAK,1997.0,10,14,-4
AUS,HKG,2005.0,15,33,-18
HUN,FRA,2008.0,15,13,2
CAN,TWN,2018.0,10,15,-5
AUS,ISR,2012.0,14,16,-2
SRB,JPN,2017.0,3,2,1
SAU,PAK,2014.0,36,59,-23
IRN,USA,2000.0,19,14,5
HKG,SWE,2005.0,3,2,1
FRA,MDG,2010.0,15,10,5
MAC,DEU,2019.0,1,3,-2
GRC,AUT,2014.0,10,7,3
KGZ,DEU,2016.0,1,3,-2
CRI,DEU,2020.0,8,7,1
JPN,CZE,2011.0,13,7,6
CZE,JPN,2013.0,6,12,-6
HUN,FRA,2014.0,17,16,1
BIH,DEU,2017.0,6,3,3
SWE,POL,2017.0,16,25,-9
CHN,THA,2014.0,13,13,0
ITA,IND,2023.0,33,53,-20
USA,ARE,1998.0,8,8,0
PRT,JPN,2022.0,6,3,3
SWE,ISR,2016.0,7,10,-3
NGA,CMR,2013.0,3,1,2
BEL,BEN,2020.0,6,1,5
KEN,JPN,2015.0,6,9,-3
NGA,CHN,2015.0,16,7,9
KOR,NZL,2010.0,4,4,0
USA,PAN,2022.0,20,29,-9
THA,ITA,2015.0,4,5,-1
AUS,LKA,2017.0,18,26,-8
SDN,MYS,2017.0,3,12,-9
DEU,HKG,2001.0,8,5,3
MEX,CHL,2009.0,4,6,-2
IRQ,GBR,2016.0,12,55,-43
JPN,FIN,2020.0,19,11,8
IRN,KOR,2021.0,33,6,27
SYR,USA,2021.0,3,4,-1
NOR,HUN,2018.0,2,5,-3
HUN,NOR,2020.0,10,1,9
AUS,BEL,2013.0,18,23,-5
JOR,GBR,2011.0,10,17,-7
BRA,CHN,2018.0,16,4,12
DEU,UKR,1998.0,16,32,-16
DEU,IRL,1998.0,16,11,5
DNK,NOR,2005.0,27,18,9
POL,JPN,2006.0,13,7,6
GMB,GBR,2005.0,8,6,2
ITA,CZE,2019.0,32,16,16
BEL,DEU,2012.0,87,105,-18
COL,AUS,2009.0,3,2,1
SGP,IND,2018.0,78,124,-46
POL,NLD,2020.0,22,14,8
USA,SYR,2015.0,6,3,3
SGP,CAN,2014.0,35,23,12
CHE,AUT,2023.0,40,45,-5
JPN,TWN,2019.0,35,77,-42
MEX,ITA,2014.0,10,19,-9
POL,GRC,2018.0,1,3,-2
HRV,FRA,2013.0,8,3,5
ROU,GBR,2015.0,26,24,2
CHE,POL,2015.0,16,24,-8
USA,FIN,2023.0,43,64,-21
AUT,TUR,2017.0,6,8,-2
AUS,CHE,2011.0,63,64,-1
AUT,IRL,2019.0,6,5,1
PRT,IRL,2017.0,5,7,-2
SWE,FRA,2009.0,53,53,0
ZAF,TZA,2011.0,4,4,0
COL,BRA,2011.0,29,31,-2
IRN,TUR,2013.0,21,13,8
CAN,NOR,2013.0,17,13,4
AUS,MEX,2018.0,11,15,-4
PER,USA,2015.0,38,47,-9
GRC,AUS,2007.0,5,9,-4
NZL,NOR,2023.0,5,1,4
DEU,GRC,2024.0,2,2,0
TWN,HKG,2019.0,11,24,-13
PAN,USA,2009.0,12,17,-5
UGA,DEU,2021.0,5,5,0
SAU,USA,2016.0,127,158,-31
ROU,POL,2016.0,3,2,1
ZAF,ETH,2016.0,9,10,-1
SRB,VNM,2020.0,3,2,1
COL,CUB,2000.0,4,3,1
ITA,AUT,2016.0,65,44,21
BRA,NOR,2015.0,12,6,6
MYS,NGA,2012.0,14,28,-14
CAN,NGA,2012.0,6,7,-1
KOR,CAN,2017.0,67,38,29
FRA,ISR,2014.0,26,24,2
CAN,ESP,2014.0,40,89,-49
MYS,BGD,2016.0,37,39,-2
GBR,ZWE,2018.0,12,6,6
DEU,SVK,2007.0,13,15,-2
ESP,PER,2023.0,13,14,-1
USA,NGA,2020.0,51,70,-19
AUS,PHL,2011.0,9,9,0
PRT,SWE,2008.0,4,10,-6
MEX,GBR,2000.0,22,38,-16
ITA,LBN,2014.0,6,1,5
VNM,KOR,2013.0,22,43,-21
JPN,TUR,2019.0,13,11,2
DNK,PAK,2012.0,3,1,2
JPN,VNM,2015.0,52,25,27
VNM,GBR,2018.0,20,108,-88
PAK,NZL,2012.0,3,3,0
ISR,IRL,2022.0,4,1,3
IND,SGP,2011.0,54,36,18
IRN,IRL,2015.0,12,6,6
JAM,TTO,2020.0,4,2,2
DEU,KEN,2017.0,16,13,3
FIN,NLD,2023.0,16,12,4
IRN,AZE,2014.0,2,1,1
AZE,IRN,2016.0,5,2,3
SVK,FRA,2012.0,2,2,0
CHL,MEX,2015.0,14,21,-7
CHE,JPN,2022.0,27,35,-8
FIN,ITA,2018.0,21,36,-15
SMR,ITA,2021.0,5,11,-6
NLD,BEN,2011.0,1,1,0
MEX,AUS,2013.0,13,10,3
AUS,MEX,2016.0,9,8,1
IDN,GBR,2012.0,2,11,-9
TUR,JPN,2012.0,13,7,6
JPN,TWN,2009.0,55,27,28
DEU,RUS,2023.0,36,118,-82
SGP,HKG,2000.0,12,14,-2
OMN,GBR,2016.0,9,14,-5
LKA,AUS,2012.0,18,14,4
ZWE,ZMB,2015.0,4,2,2
DEU,ZAF,2016.0,36,32,4
GBR,TTO,2013.0,5,3,2
FIN,AUT,2014.0,14,4,10
SWE,ESP,2013.0,39,62,-23
NLD,IND,2013.0,19,28,-9
GBR,TUR,2011.0,46,50,-4
BEL,AUS,2017.0,25,37,-12
AUS,PRT,2022.0,12,5,7
GRC,ESP,2021.0,18,17,1
ITA,EGY,2015.0,8,7,1
CHE,SWE,2014.0,62,68,-6
JPN,MNG,2020.0,22,9,13
MYS,ARE,2017.0,23,7,16
CRI,MEX,2016.0,4,4,0
SRB,HUN,2021.0,7,2,5
HUN,SRB,2023.0,3,1,2
USA,MAC,2018.0,11,11,0
SWE,IND,2016.0,40,66,-26
GUF,FRA,2016.0,25,23,2
BRA,MEX,2016.0,26,26,0
BRN,MYS,2012.0,3,6,-3
MEX,CHL,2012.0,20,10,10
TUR,DNK,2019.0,10,9,1
ITA,JPN,2018.0,33,28,5
PRT,SWE,2015.0,15,12,3
PAK,VNM,2022.0,1,6,-5
SGP,DNK,2023.0,7,7,0
EST,BEL,2016.0,3,4,-1
CHN,NGA,2012.0,6,6,0
SGP,PAK,2022.0,5,3,2
CMR,FRA,2015.0,19,24,-5
IRN,TWN,2019.0,7,2,5
CUB,MEX,2022.0,28,3,25
DEU,ROU,2011.0,31,23,8
FRA,BGD,2019.0,5,1,4
AUS,HKG,2011.0,24,33,-9
SWE,IND,2018.0,25,79,-54
CHE,CZE,2012.0,10,17,-7
ZAF,BWA,2008.0,4,9,-5
IRN,IRQ,2012.0,8,2,6
CHL,ITA,2017.0,18,16,2
CHL,USA,2019.0,133,155,-22
KOR,SGP,2013.0,24,23,1
SVN,HRV,2012.0,10,14,-4
SWE,ISR,2013.0,5,5,0
SWZ,USA,2017.0,3,4,-1
HUN,GBR,2012.0,33,22,11
FRA,SYR,2020.0,4,2,2
ROU,GBR,2008.0,18,12,6
IRL,GRC,2012.0,5,1,4
JOR,QAT,2018.0,5,8,-3
AUS,IRN,2012.0,36,101,-65
SAU,JOR,2020.0,32,34,-2
JPN,LKA,2016.0,11,5,6
DNK,CAN,2018.0,28,36,-8
USA,SVN,2020.0,13,14,-1
COL,BRA,2009.0,17,10,7
BRA,NZL,2013.0,6,1,5
FRA,CHN,2013.0,162,127,35
SWE,PAK,2018.0,14,11,3
ITA,KOR,2007.0,5,5,0
CAN,ARE,2013.0,30,8,22
LBY,SAU,2017.0,2,1,1
FRA,VNM,2017.0,68,18,50
OMN,IND,2015.0,13,22,-9
USA,LBY,2017.0,3,3,0
BRA,PRY,2013.0,5,1,4
CAN,CHL,2012.0,23,17,6
NGA,SAU,2012.0,7,6,1
SWE,THA,2013.0,6,5,1
PAK,IRL,2017.0,7,8,-1
NOR,ROU,2015.0,1,1,0
HUN,ROU,2010.0,18,5,13
SVN,SVK,2011.0,36,5,31
ITA,GRC,2018.0,23,35,-12
DNK,ITA,2018.0,31,53,-22
ZAF,ZMB,2020.0,14,10,4
ZAF,MOZ,2012.0,5,1,4
ITA,BRA,2012.0,59,25,34
ESP,URY,2014.0,25,4,21
GMB,GBR,2012.0,5,4,1
UGA,GBR,2020.0,13,24,-11
BEN,CAN,2012.0,1,1,0
MLI,CAN,2019.0,1,1,0
BGD,MYS,2013.0,38,22,16
ARE,AUS,2019.0,21,32,-11
CHL,AUS,2015.0,25,20,5
CHL,BRA,2015.0,25,32,-7
THA,GBR,2014.0,36,88,-52
AUS,PRT,2018.0,6,11,-5
USA,VNM,2022.0,43,41,2
CAN,LKA,2018.0,11,6,5
ESP,LUX,2016.0,8,6,2
BEL,TUR,2013.0,6,12,-6
UKR,FIN,2014.0,1,2,-1
BFA,USA,2018.0,6,4,2
JPN,MMR,2017.0,10,6,4
CHE,IRL,2016.0,17,17,0
GBR,TZA,2022.0,7,11,-4
OMN,SAU,2011.0,7,5,2
COL,ARG,2016.0,15,19,-4
SGP,KOR,2014.0,21,23,-2
URY,USA,2023.0,7,7,0
JPN,HKG,2020.0,13,20,-7
UKR,ITA,2012.0,2,3,-1
GRC,NLD,2014.0,38,18,20
KEN,GBR,1998.0,10,10,0
USA,KGZ,2015.0,1,1,0
NLD,SGP,2016.0,22,17,5
VNM,CHE,2014.0,1,5,-4
IDN,BEL,2015.0,4,4,0
BEL,IDN,2022.0,8,4,4
JPN,BEL,2010.0,11,14,-3
IRN,GBR,2014.0,48,44,4
SVN,USA,2015.0,14,12,2
OMN,GBR,2018.0,10,19,-9
TUN,BEL,2017.0,8,5,3
AUT,ITA,2020.0,58,66,-8
CHE,CHL,2017.0,12,8,4
HKG,GBR,2011.0,30,43,-13
CAN,ZAF,2016.0,27,25,2
RUS,CAN,2016.0,22,22,0
BEL,BRA,2017.0,21,36,-15
ARE,CAN,2019.0,28,35,-7
USA,PER,2022.0,30,48,-18
KOR,NLD,2012.0,9,8,1
PAK,KOR,2019.0,44,122,-78
BRA,ZAF,2017.0,4,2,2
FRA,ARE,2015.0,19,4,15
SVN,SRB,2017.0,6,3,3
TWN,PHL,2020.0,12,15,-3
DEU,JPN,2023.0,62,59,3
MAC,MAR,2016.0,10,11,-1
FIN,DNK,2014.0,18,9,9
RUS,KAZ,2014.0,32,21,11
ITA,MLT,2023.0,4,1,3
AUS,NLD,2016.0,85,87,-2
NZL,PAK,2017.0,14,9,5
BGR,GBR,2001.0,29,11,18
NOR,AUT,2022.0,17,5,12
THA,AUT,2011.0,7,4,3
UKR,SVK,2024.0,2,1,1
ESP,DNK,2004.0,12,11,1
PAN,CRI,2020.0,2,2,0
JPN,RUS,2016.0,21,8,13
RWA,NLD,2015.0,1,2,-1
NOR,CHE,2015.0,13,26,-13
JPN,ITA,2016.0,26,23,3
COL,CHL,2018.0,35,37,-2
IRL,AUS,2010.0,48,31,17
IRN,BRA,2019.0,16,3,13
SWE,EST,2016.0,4,14,-10
ECU,ESP,2015.0,9,60,-51
POL,CHN,2021.0,10,24,-14
EST,SWE,2018.0,9,9,0
FRA,CZE,2016.0,38,21,17
CZE,POL,2019.0,20,23,-3
ZAF,NLD,2018.0,28,34,-6
IDN,PHL,2016.0,1,1,0
CAN,AUS,2024.0,2,4,-2
LBR,USA,2022.0,11,56,-45
KOR,GBR,2022.0,78,66,12
MYS,IRQ,2012.0,27,10,17
HUN,ITA,2016.0,10,12,-2
SAU,NZL,2022.0,2,6,-4
MWI,USA,2014.0,20,16,4
USA,CUB,2013.0,7,11,-4
QAT,EGY,2015.0,9,13,-4
ETH,USA,2018.0,33,40,-7
FRA,POL,2021.0,51,34,17
IRQ,SWE,2022.0,1,4,-3
PER,ESP,2018.0,19,33,-14
BRA,ARG,2012.0,24,32,-8
FRA,IRL,2011.0,27,28,-1
IRL,DEU,2020.0,52,34,18
BRA,VEN,2012.0,5,8,-3
USA,OMN,2014.0,12,11,1
POL,FRA,2020.0,31,45,-14
ROU,CHE,2013.0,9,7,2
CHN,KEN,2020.0,13,9,4
KEN,AUS,2019.0,5,8,-3
PRT,DEU,2014.0,47,28,19
SEN,BEN,2015.0,2,1,1
IRN,CHN,2013.0,13,2,11
IDN,USA,2007.0,23,22,1
KEN,CHN,2019.0,8,19,-11
BRN,BGD,2013.0,2,3,-1
BFA,FRA,2015.0,26,14,12
KOR,SWE,2013.0,6,8,-2
BGD,THA,1999.0,2,1,1
THA,BGD,2005.0,2,4,-2
IRL,CHN,2019.0,36,18,18
DEU,ECU,2019.0,10,11,-1
ESP,ARE,2021.0,11,4,7
CAN,HKG,2021.0,22,41,-19
IRN,CHE,2017.0,24,15,9
SWE,BOL,2016.0,2,2,0
HUN,SAU,2021.0,3,1,2
IRN,ZAF,2015.0,8,5,3
CHE,IND,2017.0,43,32,11
ESP,IND,2015.0,20,19,1
THA,CHE,2022.0,8,9,-1
THA,JPN,2015.0,64,114,-50
NGA,LBR,2018.0,5,2,3
KOR,CAN,2022.0,57,33,24
GBR,KHM,2015.0,4,2,2
FRA,IRN,2015.0,22,18,4
CHN,IRL,2016.0,20,38,-18
ZAF,AUS,2019.0,58,30,28
ITA,SMR,2019.0,7,5,2
NZL,KOR,2018.0,6,7,-1
SAU,CAN,2016.0,69,119,-50
SWE,GHA,2019.0,2,1,1
DNK,IRN,2020.0,12,45,-33
USA,GUM,2023.0,5,15,-10
SVN,SWE,2020.0,5,4,1
BGD,ESP,2023.0,3,1,2
IDN,CHN,2018.0,9,5,4
ZAF,AUS,2011.0,39,29,10
DNK,ITA,2017.0,22,44,-22
PRT,BEL,2023.0,16,6,10
YEM,FIN,2022.0,1,1,0
EST,LVA,2015.0,9,1,8
NLD,PAK,2016.0,17,4,13
BEL,IRN,2014.0,17,15,2
IND,IDN,2018.0,23,16,7
GRC,BGR,2010.0,3,4,-1
HKG,THA,2015.0,2,1,1
MEX,VEN,2014.0,10,17,-7
CAN,PAK,2014.0,18,23,-5
ISL,DEU,2014.0,4,3,1
AUT,EGY,2017.0,5,5,0
FRA,BRA,2008.0,86,108,-22
BRA,AUS,2021.0,84,37,47
NOR,BEL,2018.0,9,9,0
EGY,DEU,2017.0,48,59,-11
BEL,DZA,2018.0,11,3,8
BEL,DZA,2022.0,2,2,0
JAM,USA,2013.0,12,9,3
NLD,FIN,2022.0,26,24,2
KOR,HKG,2016.0,11,10,1
DEU,EGY,2020.0,67,52,15
JPN,IRN,2020.0,16,16,0
UGA,USA,2019.0,25,39,-14
IND,EST,2022.0,11,6,5
ITA,KEN,2019.0,2,5,-3
POL,SWE,2017.0,25,16,9
POL,SWE,2022.0,19,22,-3
ZAF,DEU,2018.0,43,40,3
TWN,SWE,2018.0,7,4,3
LBN,AUS,2014.0,4,4,0
ZWE,ZAF,2018.0,49,41,8
PER,ESP,2017.0,12,30,-18
MAR,TUR,2021.0,3,6,-3
CAN,SWE,2022.0,33,45,-12
LBN,ARE,2020.0,11,3,8
CAN,OMN,2006.0,6,2,4
PRT,ITA,2020.0,39,45,-6
CAN,DNK,2019.0,27,32,-5
USA,GIN,2017.0,3,1,2
ISR,POL,2002.0,1,3,-2
KWT,GBR,2023.0,4,8,-4
MEX,PRT,2020.0,7,3,4
KOR,ISR,2021.0,5,10,-5
USA,VNM,2016.0,40,32,8
GBR,IRQ,2023.0,19,19,0
SLV,MEX,2019.0,1,2,-1
SWE,CHL,2012.0,5,4,1
HKG,ESP,2016.0,6,2,4
THA,KHM,2018.0,5,3,2
CHN,KOR,2014.0,82,202,-120
CAN,EGY,2012.0,44,25,19
NLD,SGP,2017.0,23,13,10
LKA,LAO,2018.0,1,1,0
ESP,LUX,2017.0,7,3,4
IRQ,CHN,2023.0,3,7,-4
ECU,USA,2017.0,21,34,-13
SAU,DZA,2013.0,5,6,-1
THA,IDN,2018.0,20,9,11
RUS,THA,2021.0,2,3,-1
GRC,BEL,2021.0,28,18,10
SWE,PAK,2016.0,20,5,15
NGA,ITA,2020.0,8,4,4
CAN,BHR,2016.0,3,1,2
GBR,BLR,2017.0,1,1,0
NLD,NOR,2022.0,31,22,9
NLD,HUN,2020.0,6,9,-3
JPN,NGA,2019.0,14,10,4
ROU,GRC,2015.0,2,4,-2
IDN,MYS,2017.0,15,107,-92
DEU,ISR,2019.0,51,79,-28
FRA,CZE,2017.0,35,26,9
EGY,JPN,2020.0,62,68,-6
TUN,DEU,2019.0,10,5,5
KOR,DEU,2014.0,55,48,7
USA,GEO,2010.0,31,43,-12
SEN,CAN,2016.0,2,9,-7
POL,MEX,2020.0,2,3,-1
USA,IDN,2020.0,61,26,35
GBR,VNM,2014.0,30,19,11
RUS,AZE,2020.0,10,4,6
MOZ,SWE,2020.0,1,2,-1
TWN,KOR,2022.0,22,7,15
SVN,SRB,2016.0,6,4,2
AUT,CHN,2021.0,22,18,4
CHE,KOR,2019.0,13,17,-4
ETH,USA,2017.0,21,27,-6
ECU,USA,2018.0,32,40,-8
LKA,USA,2018.0,17,28,-11
UKR,CHN,2019.0,19,8,11
ISR,NLD,2008.0,16,3,13
NZL,IRL,2015.0,11,7,4
GAB,FRA,2016.0,7,11,-4
CRI,GTM,2018.0,1,1,0
POL,CAN,2023.0,5,8,-3
ECU,CHL,2020.0,12,22,-10
TZA,RWA,2020.0,8,1,7
CHN,SVN,2021.0,2,6,-4
HRV,CZE,2022.0,4,2,2
NZL,CAN,2018.0,29,25,4
LVA,LTU,2018.0,3,3,0
CHE,IRL,2017.0,8,18,-10
MAR,GBR,2022.0,5,3,2
CAN,BGD,2004.0,1,5,-4
BGD,GBR,2009.0,21,6,15
CHE,THA,2022.0,9,8,1
CHN,TUR,2023.0,5,11,-6
UKR,SWE,2020.0,11,3,8
FRA,CUB,2019.0,1,4,-3
FRA,KOR,2017.0,26,27,-1
CHN,ARE,2020.0,20,14,6
USA,KWT,2005.0,10,4,6
SWE,CHN,2000.0,18,19,-1
NZL,ZAF,2001.0,8,12,-4
LTU,DEU,1999.0,3,9,-6
FRA,DNK,2001.0,19,20,-1
USA,MDG,2013.0,6,5,1
NOR,AUS,2004.0,10,7,3
SRB,GBR,2003.0,13,16,-3
TWN,IND,2004.0,16,32,-16
MAR,FRA,1997.0,29,63,-34
SWE,AUT,2004.0,8,8,0
SRB,BIH,2008.0,18,1,17
HUN,RUS,2000.0,2,4,-2
KEN,FRA,1998.0,2,1,1
FRA,HKG,2021.0,8,7,1
HKG,FRA,2022.0,11,6,5
AUS,ISL,2003.0,1,1,0
BEL,BLR,2000.0,3,1,2
ARG,ITA,2004.0,26,12,14
ITA,ARG,2005.0,15,16,-1
CHN,NOR,1997.0,3,4,-1
TUR,BEL,2000.0,5,5,0
MEX,NLD,2002.0,3,4,-1
BRA,DEU,2003.0,48,42,6
IRN,JPN,2003.0,7,6,1
ARG,NOR,2015.0,3,1,2
NPL,BGD,2013.0,1,1,0
MYS,IND,2008.0,21,36,-15
SVN,SVK,2021.0,13,4,9
NOR,SWE,2003.0,56,57,-1
MAC,AUS,2019.0,5,1,4
CHE,BGR,2003.0,2,5,-3
IND,DNK,2002.0,5,3,2
TUR,AZE,1999.0,2,3,-1
NLD,DNK,2002.0,29,32,-3
POL,JPN,2000.0,21,17,4
NLD,CRI,2000.0,2,1,1
DEU,IRN,2009.0,29,35,-6
CZE,SVK,2002.0,19,41,-22
CHE,MYS,2021.0,5,3,2
USA,ROU,2010.0,45,33,12
COL,RUS,2000.0,1,2,-1
BLR,RUS,2014.0,24,15,9
TUN,ITA,2010.0,4,3,1
BEL,CHL,2011.0,9,5,4
CZE,BGR,2000.0,1,2,-1
FRA,ARG,2000.0,17,17,0
AUS,SWE,2006.0,31,37,-6
SWE,THA,2003.0,9,2,7
KEN,CHE,2006.0,1,1,0
LTU,DEU,1998.0,6,2,4
NOR,SGP,2004.0,2,1,1
SAU,BEL,1998.0,3,1,2
JPN,SGP,2006.0,16,12,4
ITA,SAU,2007.0,3,2,1
NLD,ROU,2023.0,2,3,-1
BRA,CHL,2001.0,13,9,4
ISR,SVK,1999.0,1,1,0
FRA,PRT,2006.0,31,20,11
FIN,EST,2004.0,6,5,1
USA,CZE,2004.0,55,40,15
ITA,HUN,1999.0,10,6,4
ARG,GBR,1998.0,13,10,3
ROU,ITA,2000.0,13,10,3
DEU,THA,2009.0,20,13,7
TTO,JAM,2010.0,8,10,-2
ISR,AUS,2006.0,9,5,4
BGR,MKD,2017.0,2,3,-1
FRA,BFA,2000.0,11,14,-3
GEO,ITA,2002.0,4,1,3
HUN,SWE,1999.0,14,6,8
BEL,IRL,2000.0,5,3,2
CAN,BRA,2007.0,38,51,-13
BRA,RUS,2001.0,22,5,17
NOR,FIN,2016.0,13,20,-7
ISR,RUS,1999.0,8,21,-13
ITA,FIN,2009.0,15,11,4
UKR,SWE,1999.0,9,3,6
DNK,ESP,2005.0,8,9,-1
SVK,FRA,1997.0,2,6,-4
DEU,SYR,2005.0,3,2,1
USA,GHA,2013.0,21,10,11
NOR,CAN,2000.0,20,10,10
CAN,EGY,2005.0,13,10,3
MAR,USA,1997.0,4,2,2
IND,THA,1998.0,3,1,2
HRV,BIH,2015.0,11,6,5
NZL,NLD,2008.0,19,9,10
GMB,GBR,2002.0,10,13,-3
IRL,ESP,1999.0,2,4,-2
CZE,RUS,2002.0,8,10,-2
RUS,GEO,2000.0,4,3,1
ARE,JOR,2000.0,2,4,-2
MYS,BRN,2023.0,6,2,4
RUS,LVA,1998.0,3,2,1
JPN,NLD,2011.0,24,15,9
UKR,BEL,2002.0,4,3,1
FRA,NCL,2006.0,24,16,8
BEL,SWE,2009.0,9,15,-6
BEL,HUN,2005.0,8,9,-1
ZAF,BWA,2014.0,6,9,-3
UGA,MOZ,2004.0,1,1,0
FRA,MEX,2012.0,54,31,23
ISR,NZL,2016.0,5,2,3
HRV,AUS,2012.0,2,1,1
PER,USA,2004.0,31,29,2
GBR,OMN,2006.0,9,6,3
TUR,AUT,2013.0,8,7,1
TZA,SWE,2002.0,3,2,1
PRT,MAR,2010.0,2,1,1
KOR,UZB,2008.0,1,3,-2
CHE,BLR,2000.0,2,1,1
QAT,BEL,2015.0,1,1,0
AUS,VEN,2019.0,2,2,0
NOR,FIN,2017.0,13,24,-11
CAN,QAT,2016.0,30,13,17
ESP,COL,1997.0,7,3,4
AUS,GRC,1999.0,3,2,1
BRA,NLD,2000.0,10,13,-3
AUS,BRA,2013.0,24,30,-6
AUT,NOR,2012.0,6,7,-1
GBR,EST,2011.0,9,3,6
THA,NLD,2004.0,3,11,-8
CMR,FRA,2004.0,12,11,1
ISR,JPN,2017.0,10,5,5
CAN,ESP,2004.0,22,26,-4
BEL,JPN,1999.0,14,11,3
USA,CIV,2007.0,6,4,2
SVK,USA,2000.0,15,17,-2
AZE,IRN,2018.0,4,3,1
DEU,BRA,1997.0,30,14,16
NLD,AUT,1998.0,11,15,-4
AUT,GBR,2009.0,57,44,13
ZAF,CIV,1999.0,3,2,1
FRA,MTQ,2003.0,12,9,3
NLD,MEX,2001.0,5,2,3
KEN,UGA,2013.0,5,12,-7
EGY,ESP,2007.0,3,6,-3
USA,SVK,2011.0,9,14,-5
ARG,BRA,2002.0,24,30,-6
CYP,USA,2006.0,10,24,-14
POL,BEL,2003.0,12,12,0
BOL,CHE,2015.0,1,1,0
GBR,KOR,2001.0,18,22,-4
USA,EST,2005.0,9,1,8
MEX,CHE,2000.0,4,5,-1
PER,USA,2001.0,32,17,15
NLD,ZAF,2001.0,8,12,-4
ITA,BEL,2004.0,20,27,-7
FIN,ESP,2000.0,5,7,-2
POL,CAN,2006.0,22,10,12
CHE,HUN,2006.0,10,4,6
CAN,CZE,2000.0,3,10,-7
AUS,JPN,2006.0,42,53,-11
CAN,HUN,2001.0,10,8,2
SAU,ARE,2017.0,36,6,30
MEX,PER,2002.0,2,1,1
ISR,FIN,2014.0,2,4,-2
MYS,DNK,2009.0,2,1,1
AUS,VNM,1999.0,1,4,-3
VNM,AUS,2002.0,3,9,-6
VNM,AUS,2012.0,14,11,3
GRC,QAT,2018.0,5,2,3
SWE,IRL,2006.0,11,1,10
NOR,IND,2006.0,3,2,1
USA,VEN,2013.0,12,37,-25
ESP,JPN,2008.0,7,14,-7
GRC,NOR,2003.0,2,1,1
JPN,POL,2003.0,17,9,8
FIN,DNK,2008.0,7,10,-3
DNK,FIN,2013.0,14,8,6
FIN,GRC,2005.0,2,1,1
USA,CUB,2003.0,10,5,5
FRA,VEN,2022.0,2,4,-2
CUB,SWE,1998.0,2,2,0
NOR,CZE,2008.0,4,4,0
SWE,AUT,2014.0,18,22,-4
SRB,GRC,2000.0,3,1,2
RUS,DNK,2006.0,8,9,-1
FRA,EST,2002.0,3,2,1
EGY,OMN,2011.0,3,7,-4
SGP,SWE,2013.0,15,9,6
BEL,LUX,2008.0,11,2,9
ESP,ZAF,2015.0,13,4,9
ZAF,ARE,2020.0,9,1,8
GBR,SVK,1998.0,6,10,-4
MAR,USA,2002.0,11,7,4
SRB,MKD,1998.0,5,12,-7
ZAF,USA,1997.0,33,37,-4
GHA,USA,2004.0,6,14,-8
POL,RUS,2015.0,12,15,-3
TGO,FRA,2002.0,7,3,4
SRB,ESP,2002.0,3,4,-1
JPN,IRN,2007.0,19,8,11
CHE,FIN,2004.0,8,9,-1
BEL,CZE,2005.0,4,4,0
GBR,UGA,2002.0,11,6,5
USA,SYR,2001.0,2,11,-9
IND,DEU,2006.0,106,71,35
FIN,FRA,2000.0,13,15,-2
CHE,SRB,2004.0,3,4,-1
CHE,SRB,2008.0,3,3,0
DEU,ETH,2002.0,3,4,-1
DEU,UKR,2007.0,32,34,-2
ROU,BEL,2003.0,7,5,2
HUN,PRT,1999.0,6,1,5
TUR,DEU,2006.0,28,25,3
SGP,FIN,2018.0,7,5,2
USA,BWA,2013.0,6,5,1
AUS,FRA,2000.0,30,40,-10
ROU,AUT,2016.0,3,4,-1
USA,MDA,2002.0,2,3,-1
JPN,PHL,2014.0,29,21,8
AUT,JPN,2017.0,10,15,-5
JPN,SVK,2003.0,6,4,2
LBN,CHE,2015.0,2,2,0
BRA,ISR,2004.0,3,3,0
SAU,DEU,2001.0,3,3,0
GBR,HKG,1997.0,36,11,25
IRL,ZAF,2014.0,11,2,9
ESP,CUB,1999.0,26,30,-4
LTU,SWE,2001.0,10,5,5
CAN,AUT,2006.0,10,18,-8
THA,MYS,2001.0,2,1,1
FRA,BGR,2017.0,7,5,2
CAN,IRN,2015.0,75,272,-197
TUR,DEU,2000.0,14,13,1
DEU,AZE,2015.0,1,1,0
HKG,CAN,2007.0,26,25,1
BGR,DEU,2015.0,15,10,5
SVK,SWE,2010.0,7,3,4
USA,QAT,2003.0,8,2,6
SRB,NLD,1998.0,1,2,-1
FRA,SEN,1997.0,18,17,1
UKR,HUN,2007.0,1,1,0
GBR,LBN,1998.0,2,1,1
VNM,RUS,2022.0,12,8,4
PNG,USA,2019.0,1,2,-1
AUS,SGP,2007.0,41,67,-26
CIV,FRA,2018.0,10,42,-32
ESP,LBN,2021.0,4,5,-1
NGA,CMR,2016.0,2,1,1
JPN,FIN,2023.0,5,6,-1
IND,RUS,2019.0,18,11,7
ITA,ZAF,2020.0,8,15,-7
PAK,AUS,2012.0,15,9,6
ESP,EGY,2019.0,18,12,6
GHA,BFA,2019.0,1,4,-3
ECU,CUB,2018.0,9,23,-14
TUN,BEL,2018.0,3,6,-3
CHE,IRL,2022.0,15,17,-2
BEL,IND,2020.0,23,45,-22
KEN,AUS,2021.0,3,4,-1
TUN,CHN,2021.0,4,2,2
AUT,CHN,2009.0,8,10,-2
ZMB,USA,2020.0,10,17,-7
ITA,NOR,2015.0,34,12,22
CHL,COL,2010.0,9,18,-9
CHN,ERI,2022.0,1,1,0
NLD,PAK,2022.0,9,1,8
DEU,HUN,2023.0,19,23,-4
MYS,CHN,2017.0,55,11,44
BEL,ISL,2023.0,1,1,0
ITA,CZE,2021.0,32,29,3
GRC,KOR,2021.0,2,1,1
CZE,CAN,2018.0,8,13,-5
HUN,PHL,2019.0,1,1,0
BLZ,USA,2021.0,2,4,-2
MYS,IRL,2020.0,9,6,3
HKG,NOR,2023.0,3,2,1
USA,SLE,2019.0,10,7,3
LBR,USA,2018.0,10,9,1
ARG,GBR,1999.0,12,17,-5
IDN,CHN,2017.0,3,2,1
VEN,BRA,2018.0,14,1,13
USA,ALB,2020.0,3,3,0
KOR,BGD,2020.0,48,26,22
PER,BRA,2021.0,26,82,-56
COL,PRT,2016.0,4,4,0
EGY,CAN,2015.0,37,45,-8
JPN,ITA,2022.0,24,26,-2
JPN,IDN,2003.0,36,11,25
LAO,GBR,2021.0,1,2,-1
IND,ESP,2016.0,21,15,6
GHA,GBR,2020.0,19,30,-11
MYS,IDN,2023.0,44,40,4
ECU,ARG,2018.0,3,10,-7
BGD,DEU,2022.0,16,4,12
OMN,TUR,2008.0,1,2,-1
CYP,GBR,2022.0,14,41,-27
AUT,ESP,1997.0,11,3,8
CZE,SWE,2004.0,9,1,8
CMR,MAR,2019.0,1,2,-1
SWE,LUX,2022.0,5,1,4
FIN,RUS,2020.0,17,40,-23
THA,KOR,2023.0,4,9,-5
POL,DEU,2020.0,81,79,2
MEX,DEU,2015.0,41,32,9
SWE,JPN,2018.0,16,32,-16
BEL,ARE,2018.0,5,4,1
SRB,FRA,2018.0,12,6,6
ZAF,FIN,2019.0,5,1,4
MEX,RUS,2018.0,3,7,-4
MEX,RUS,2022.0,10,5,5
CHE,HRV,2019.0,2,3,-1
KOR,NOR,2012.0,2,1,1
JOR,SAU,2021.0,33,41,-8
CHE,SGP,2002.0,3,2,1
CHE,KOR,2021.0,23,19,4
TUR,DNK,2021.0,10,6,4
CHE,ARE,2023.0,2,2,0
GRC,CHN,2020.0,8,4,4
BRA,PAN,2019.0,3,4,-1
JOR,DEU,2022.0,12,7,5
FRO,DNK,2021.0,4,6,-2
DEU,ZAF,2018.0,40,43,-3
USA,MLI,2010.0,4,3,1
VNM,GBR,2016.0,27,36,-9
AUT,RUS,2004.0,5,8,-3
JPN,NGA,2021.0,9,7,2
USA,SEN,2003.0,3,1,2
POL,IND,2022.0,12,48,-36
ARE,JOR,2023.0,12,39,-27
KAZ,BEL,2020.0,1,1,0
TUR,ISR,2006.0,4,4,0
ITA,IND,2007.0,9,29,-20
SAU,DEU,2015.0,6,25,-19
FJI,AUS,2011.0,7,11,-4
THA,MMR,2019.0,9,14,-5
MMR,CHN,2019.0,16,5,11
ZAF,BFA,2016.0,5,1,4
CAN,BGD,2014.0,13,27,-14
LKA,GBR,2011.0,7,7,0
ROU,FRA,2011.0,39,35,4
IND,RUS,2021.0,16,14,2
IND,CYP,2022.0,4,1,3
IRQ,PAK,2020.0,4,2,2
ZAF,CHE,2018.0,18,14,4
AUT,SVK,1999.0,2,11,-9
SVK,SVN,2015.0,13,8,5
COL,USA,2000.0,46,33,13
KWT,IND,1999.0,4,6,-2
BRA,CHE,2017.0,38,20,18
CHL,PRT,1997.0,2,1,1
CAN,FIN,2000.0,12,17,-5
CAN,SGP,2016.0,28,36,-8
POL,CHE,2013.0,25,11,14
GRC,NLD,2004.0,6,17,-11
USA,BGD,2003.0,9,19,-10
KEN,ZWE,2003.0,3,2,1
HUN,IRQ,2022.0,10,15,-5
TUR,BIH,2017.0,5,1,4
NZL,HKG,2009.0,1,3,-2
NLD,IRN,2018.0,29,50,-21
PAK,SWE,2020.0,13,7,6
GBR,PAN,2006.0,3,1,2
BMU,GBR,2020.0,5,3,2
TUR,SYR,2022.0,1,2,-1
CHN,IND,2007.0,13,11,2
BEL,UGA,2016.0,6,2,4
BEL,ROU,2020.0,9,11,-2
HKG,FRA,2017.0,7,12,-5
RUS,IRQ,2023.0,6,2,4
FRA,ECU,2023.0,1,2,-1
USA,GTM,2021.0,11,16,-5
EGY,MYS,2021.0,13,14,-1
MOZ,ZAF,2023.0,2,2,0
ITA,CHL,2016.0,23,13,10
BEL,MEX,2022.0,5,7,-2
DEU,LBN,2017.0,3,5,-2
MOZ,GBR,2019.0,2,2,0
SRB,CZE,2017.0,2,2,0
HUN,CHE,2017.0,16,13,3
USA,BGD,2013.0,35,39,-4
PAK,FRA,2017.0,10,25,-15
GBR,GMB,2019.0,11,9,2
GBR,ZWE,2016.0,4,29,-25
ZWE,BEL,2018.0,1,1,0
BEL,COG,2019.0,5,6,-1
ZAF,NGA,2006.0,9,10,-1
BGD,IND,2021.0,24,39,-15
USA,MAR,2021.0,18,19,-1
PHL,ITA,2022.0,4,1,3
EGY,IND,2010.0,5,3,2
NLD,CHE,2005.0,54,32,22
CAN,ZAF,2022.0,15,41,-26
CHE,DNK,2002.0,7,20,-13
RUS,BRA,2004.0,7,7,0
SGP,ISR,2002.0,1,3,-2
KOR,CHE,2006.0,9,9,0
BRA,AUS,2011.0,41,20,21
PRI,BRA,2008.0,1,1,0
BGR,ITA,2009.0,4,4,0
EGY,CAN,2001.0,6,13,-7
CHE,ITA,2007.0,84,107,-23
POL,SVN,2011.0,3,2,1
IND,ITA,2005.0,16,11,5
USA,KWT,2012.0,17,6,11
USA,BWA,2003.0,8,6,2
ARE,SRB,2010.0,1,1,0
IND,PAK,2003.0,2,7,-5
CHE,TUN,2018.0,4,5,-1
DNK,CHL,2014.0,4,1,3
PRI,USA,2005.0,70,77,-7
HKG,CHE,2007.0,3,3,0
JPN,SAU,2013.0,17,3,14
NPL,KOR,2018.0,12,12,0
COL,CAN,2020.0,23,30,-7
CAN,ESP,2008.0,35,45,-10
ESP,AUS,2013.0,56,26,30
USA,ETH,2003.0,3,4,-1
CHN,FIN,2015.0,25,23,2
URY,USA,2000.0,7,9,-2
FIN,NZL,2009.0,4,4,0
FIN,TZA,2013.0,3,1,2
FRA,ISR,2004.0,29,21,8
IND,MEX,2014.0,15,6,9
LVA,DEU,2000.0,11,2,9
FIN,NOR,2017.0,24,13,11
IND,AUT,2003.0,5,3,2
SVN,BEL,2010.0,3,2,1
CHL,BEL,2008.0,5,6,-1
CHL,BEL,2014.0,7,10,-3
ROU,PRT,2010.0,3,3,0
CRI,USA,2017.0,21,27,-6
AUT,SWE,2000.0,7,12,-5
NOR,DNK,2012.0,14,33,-19
NZL,SGP,2011.0,7,10,-3
NZL,MYS,2007.0,2,5,-3
LUX,ITA,2019.0,8,10,-2
CAN,SAU,1999.0,17,16,1
CHL,GBR,2003.0,6,21,-15
USA,SVK,2009.0,23,11,12
IND,ISR,2007.0,21,13,8
DNK,BRA,2001.0,2,4,-2
ISR,KOR,2018.0,9,5,4
KOR,ISR,2019.0,6,4,2
ISR,UKR,2000.0,2,7,-5
USA,PRK,2017.0,1,6,-5
HUN,GBR,1997.0,20,14,6
BOL,MEX,2000.0,1,1,0
AUS,ESP,2006.0,11,14,-3
ITA,CHN,2004.0,12,12,0
ARE,CAN,2009.0,9,21,-12
TUR,KAZ,2020.0,12,5,7
IND,MYS,2007.0,32,15,17
PRT,FIN,2000.0,2,4,-2
FRA,NCL,2000.0,10,6,4
IND,DNK,2005.0,8,6,2
POL,AUS,2023.0,5,7,-2
PAK,AUS,2005.0,4,6,-2
ZAF,DNK,2012.0,3,1,2
USA,VIR,2003.0,3,2,1
NOR,ITA,2003.0,11,10,1
NLD,AUT,1999.0,5,14,-9
BRA,MOZ,2012.0,3,3,0
MOZ,BRA,2013.0,1,8,-7
DEU,KOR,2001.0,12,16,-4
CHN,ESP,1998.0,6,4,2
IRL,CAN,2004.0,22,10,12
DEU,CUB,1998.0,3,3,0
AUT,JPN,2022.0,13,10,3
POL,FIN,2008.0,7,3,4
ISR,EST,2021.0,1,1,0
CAN,CHL,2005.0,5,8,-3
CAN,ISR,2008.0,27,52,-25
BEL,ROU,1999.0,2,4,-2
GBR,LBN,2007.0,5,4,1
PAK,USA,1997.0,14,10,4
SGP,MYS,2021.0,22,15,7
CHE,RUS,2009.0,17,17,0
HRV,SRB,2001.0,4,5,-1
GBR,HKG,2012.0,53,19,34
SWE,BRA,2010.0,10,11,-1
IRN,CAN,2001.0,16,31,-15
ESP,CRI,2009.0,7,7,0
BGR,GBR,2004.0,17,11,6
JPN,SGP,2000.0,21,7,14
VNM,AUT,2010.0,2,3,-1
CHE,MLI,2015.0,1,3,-2
DNK,ITA,2016.0,23,50,-27
RUS,BGR,1998.0,6,7,-1
CHN,PRT,2002.0,8,4,4
COL,MEX,2015.0,32,46,-14
USA,IDN,1999.0,16,16,0
NOR,FIN,2018.0,17,42,-25
GBR,FIN,2000.0,15,30,-15
DEU,TUR,2006.0,25,28,-3
DEU,LIE,1999.0,1,2,-1
AUS,NOR,2012.0,18,15,3
SVN,DEU,2016.0,17,6,11
ESP,BEL,1998.0,15,17,-2
DNK,JPN,2005.0,11,5,6
HUN,ITA,2018.0,8,14,-6
DEU,ISR,2009.0,30,41,-11
GBR,ISL,2022.0,9,5,4
CHL,CAN,2011.0,20,13,7
MEX,BRA,2000.0,9,8,1
ISR,FRA,2002.0,30,38,-8
FRA,MCO,2003.0,5,5,0
FRA,ECU,2006.0,4,5,-1
FRA,MCO,2013.0,13,13,0
DNK,IRL,2000.0,3,1,2
FIN,NLD,2006.0,15,13,2
VNM,GBR,2017.0,23,61,-38
SGP,BEL,2000.0,2,1,1
UKR,NLD,2004.0,8,3,5
HRV,SRB,2008.0,15,9,6
URY,BRA,2000.0,5,3,2
TWN,VNM,2002.0,1,1,0
VNM,KOR,2003.0,1,8,-7
DNK,CAN,2017.0,33,29,4
BMU,USA,2014.0,5,2,3
CHE,TUR,2009.0,10,10,0
IND,ISR,1998.0,10,5,5
NOR,NLD,2008.0,15,23,-8
NOR,IRL,2017.0,4,5,-1
AUS,IRN,2002.0,23,6,17
IRN,AUS,2003.0,5,20,-15
NOR,NZL,2018.0,5,10,-5
SLV,SVN,2021.0,7,1,6
ESP,VEN,2009.0,27,52,-25
TWN,SGP,2004.0,5,7,-2
GBR,ISL,2016.0,8,5,3
SWE,BGD,2016.0,5,5,0
NGA,ITA,1999.0,2,3,-1
LKA,AUS,2002.0,2,4,-2
BRA,ARG,2002.0,30,24,6
EGY,AUT,2006.0,1,6,-5
AUS,SGP,1999.0,35,18,17
KWT,USA,2016.0,6,24,-18
IRQ,JOR,2016.0,3,4,-1
JOR,DEU,2018.0,10,10,0
ESP,SRB,1997.0,4,1,3
EGY,IRN,2011.0,1,3,-2
FRA,RUS,2014.0,53,74,-21
NPL,USA,2013.0,25,7,18
UKR,KOR,2008.0,4,5,-1
CHN,CZE,2002.0,7,1,6
ARG,NLD,2001.0,5,5,0
BGD,AUS,1998.0,2,1,1
CIV,CRI,2018.0,4,2,2
NLD,BRA,1998.0,9,7,2
THA,JPN,2008.0,27,76,-49
AUS,OMN,2005.0,2,2,0
CZE,RUS,2005.0,11,11,0
BGR,USA,2021.0,5,13,-8
FRA,QAT,2020.0,8,7,1
USA,VNM,2018.0,53,32,21
KOR,ESP,2014.0,6,4,2
MYS,NLD,2018.0,10,8,2
CAN,RUS,2016.0,22,22,0
IRL,IND,2008.0,4,11,-7
CYP,ESP,2013.0,2,3,-1
ESP,CYP,2019.0,4,1,3
TWN,CAN,2018.0,15,10,5
KOR,TWN,2016.0,16,13,3
TWN,KOR,2017.0,13,12,1
NIC,ESP,2016.0,1,1,0
ZAF,ITA,2016.0,8,13,-5
ZAF,ITA,2017.0,9,9,0
BEL,SGP,1999.0,1,1,0
IRN,CZE,2018.0,10,4,6
SVN,SLV,2010.0,11,2,9
BEL,LUX,2014.0,23,5,18
TWN,CAN,2016.0,13,18,-5
ITA,NOR,2008.0,12,7,5
AUT,ESP,2012.0,31,21,10
AUS,IRL,2022.0,43,39,4
BGD,JPN,2016.0,63,65,-2
CAN,AUT,2023.0,16,14,2
FRA,JOR,2010.0,6,2,4
USA,LKA,2023.0,14,12,2
THA,CHN,2010.0,10,8,2
SAU,ITA,2019.0,12,15,-3
IDN,CHN,2016.0,3,3,0
SGP,CAN,2008.0,34,21,13
BEL,IRN,2015.0,16,17,-1
DEU,TUN,2018.0,6,2,4
CAN,RUS,2017.0,21,25,-4
DEU,ETH,2012.0,5,7,-2
AFG,IRN,2014.0,1,1,0
FRA,DNK,2014.0,40,37,3
AUS,IRL,2016.0,32,41,-9
LAO,VNM,2015.0,1,3,-2
GRD,CAN,2021.0,3,1,2
JPN,PER,2017.0,2,1,1
BRA,URY,2010.0,5,6,-1
ZAF,SWZ,2015.0,5,1,4
ARG,URY,2019.0,12,11,1
FRA,TUR,2011.0,25,18,7
IRL,CAN,2008.0,32,26,6
USA,IRQ,2013.0,8,9,-1
TWN,SGP,2015.0,20,15,5
GHA,KEN,2022.0,5,3,2
ROU,CAN,2011.0,6,6,0
POL,AUS,2010.0,11,2,9
AUS,ITA,2011.0,31,49,-18
TUR,IND,2010.0,9,3,6
NOR,IRL,2022.0,5,3,2
IRL,CAN,2014.0,47,27,20
QAT,FRA,2020.0,7,8,-1
USA,TUN,2014.0,11,10,1
ESP,KOR,2002.0,4,3,1
IRN,ESP,2013.0,17,5,12
KEN,NLD,1998.0,3,1,2
ROU,ITA,2010.0,5,8,-3
AUS,CHE,2009.0,52,48,4
ISR,ITA,2017.0,20,20,0
CAN,CMR,2015.0,4,2,2
ISR,NOR,2011.0,2,3,-1
BEL,AUS,2018.0,30,31,-1
MYS,NLD,2016.0,9,13,-4
BEL,SVN,2019.0,2,4,-2
SVN,USA,2014.0,21,15,6
NLD,CUW,2022.0,6,3,3
MEX,BEL,2012.0,4,2,2
DEU,MCO,2015.0,1,1,0
KOR,FIN,2013.0,10,2,8
CUB,ESP,2013.0,26,23,3
CHN,GRC,2018.0,3,5,-2
ESP,AUT,2015.0,47,18,29
ZAF,CHN,2014.0,6,13,-7
CHL,VEN,2010.0,5,9,-4
UGA,BEL,2010.0,1,2,-1
AUS,SAU,2013.0,29,11,18
USA,CYP,2017.0,8,14,-6
ESP,ZAF,2014.0,6,5,1
SVK,FIN,2012.0,2,4,-2
AFG,GBR,2017.0,6,6,0
SVN,USA,2004.0,13,14,-1
IRL,CHN,2009.0,11,12,-1
CAN,HKG,2011.0,21,30,-9
ITA,ISR,2014.0,25,18,7
ISR,ITA,2016.0,18,21,-3
IND,IRQ,2013.0,3,1,2
RUS,IND,2021.0,14,16,-2
UGA,USA,2021.0,40,31,9
USA,MAC,2017.0,14,7,7
BEL,TZA,2020.0,3,3,0
CAN,MYS,2008.0,7,1,6
MWI,USA,2015.0,16,21,-5
GBR,CMR,2019.0,4,10,-6
GBR,KEN,2014.0,33,16,17
SGP,JPN,2017.0,50,36,14
GBR,EGY,2005.0,21,6,15
TUR,ITA,2011.0,11,7,4
ISR,FRA,2012.0,27,17,10
POL,SGP,2020.0,2,4,-2
MWI,GBR,2013.0,23,12,11
LBN,GBR,2022.0,20,9,11
DEU,MYS,2011.0,10,7,3
PER,GBR,2014.0,6,2,4
BWA,GBR,2011.0,6,2,4
PAK,QAT,2013.0,3,1,2
SWE,ISL,2014.0,15,25,-10
ESP,COL,2005.0,29,15,14
ESP,VEN,2021.0,6,18,-12
ESP,CHN,2011.0,15,15,0
CHN,NOR,2012.0,32,15,17
HRV,SVK,2016.0,2,1,1
ISL,ISR,2019.0,2,1,1
PAK,TUR,2020.0,20,29,-9
AUS,ZWE,2020.0,1,1,0
HUN,CZE,2014.0,5,5,0
VEN,ESP,2017.0,29,25,4
MYS,DEU,2023.0,4,3,1
CAN,PRT,2008.0,10,6,4
NOR,RUS,2004.0,7,8,-1
CHE,HUN,2000.0,5,13,-8
CHE,CZE,2002.0,6,13,-7
ITA,NZL,2015.0,11,4,7
GEO,DEU,2017.0,7,6,1
BRA,CHN,2017.0,18,7,11
DEU,CHL,2010.0,22,27,-5
IRL,ARE,2018.0,10,3,7
ARE,IRL,2019.0,1,3,-2
IDN,NLD,2019.0,20,53,-33
FRA,CRI,2021.0,5,3,2
CHN,SLE,2016.0,3,1,2
MEX,CAN,2006.0,25,15,10
ZAF,RUS,2013.0,2,2,0
SWE,UKR,2020.0,3,11,-8
CZE,CHE,2009.0,14,20,-6
ITA,URY,2019.0,1,1,0
ISR,IRL,2016.0,10,2,8
IRN,HUN,2021.0,8,4,4
RUS,ROU,2017.0,3,1,2
GBR,MLT,2022.0,9,17,-8
ESP,VNM,2018.0,3,1,2
RUS,KAZ,2008.0,12,14,-2
SWE,NPL,2017.0,1,3,-2
BGD,PAK,2009.0,7,9,-2
DEU,KEN,2022.0,16,14,2
CHE,COL,2016.0,4,3,1
BRA,POL,2019.0,6,8,-2
QAT,EGY,2014.0,11,17,-6
PAK,CAN,2017.0,28,22,6
PHL,THA,2021.0,9,6,3
DNK,THA,2016.0,3,2,1
MUS,CHN,2016.0,1,1,0
DZA,MAR,2017.0,1,1,0
CAN,TUN,2018.0,9,7,2
IRN,BEL,2017.0,16,9,7
BGD,HKG,2013.0,4,2,2
URY,FRA,2016.0,4,8,-4
BGD,JPN,2022.0,62,89,-27
SVN,DEU,2018.0,12,5,7
ESP,NZL,2018.0,6,9,-3
MEX,DNK,2019.0,6,1,5
THA,DEU,1999.0,3,2,1
FRA,PER,2013.0,1,7,-6
ZAF,TZA,2021.0,17,12,5
BEL,MEX,2017.0,7,10,-3
QAT,IND,2015.0,5,13,-8
LBN,GBR,2017.0,14,9,5
THA,DEU,2020.0,21,33,-12
MEX,GBR,2010.0,31,43,-12
PAK,IDN,2022.0,6,4,2
THA,PAK,2016.0,6,4,2
EGY,CHE,2009.0,2,4,-2
GUM,USA,2017.0,12,9,3
GRC,ISR,2017.0,1,1,0
TUN,QAT,2017.0,5,1,4
IDN,NZL,2017.0,8,7,1
CHN,VNM,2013.0,6,5,1
ISR,ESP,2022.0,10,11,-1
NZL,CAN,2022.0,24,22,2
SLE,CHE,2021.0,1,2,-1
CIV,GBR,2017.0,2,1,1
GBR,CIV,2019.0,4,2,2
IND,IDN,2016.0,25,14,11
IRN,FIN,2013.0,15,3,12
AUT,EGY,2016.0,5,5,0
AUT,EGY,2018.0,7,1,6
DJI,FRA,2017.0,2,3,-1
CAN,POL,2008.0,14,18,-4
ALB,GBR,2022.0,1,1,0
FIN,NZL,2021.0,1,7,-6
ITA,CHN,2014.0,38,43,-5
MEX,CHN,2017.0,7,8,-1
ITA,DNK,2003.0,13,11,2
CAN,BHS,2018.0,1,1,0
FIN,PAK,2020.0,5,3,2
ESP,LUX,2018.0,6,6,0
MYS,TUR,2019.0,10,6,4
KEN,ETH,2021.0,5,10,-5
TWN,DEU,2018.0,27,18,9
ZAF,CIV,2020.0,6,2,4
POL,LTU,2018.0,3,1,2
JOR,PSE,2019.0,5,1,4
BEL,PRT,2022.0,17,19,-2
DZA,MAR,2022.0,3,5,-2
DEU,BGD,2019.0,8,9,-1
LBN,GBR,2016.0,7,11,-4
TWN,FIN,2023.0,3,2,1
KOR,TWN,2017.0,12,13,-1
PRT,CPV,2021.0,4,5,-1
RUS,UZB,2020.0,22,5,17
FIN,ITA,2016.0,14,24,-10
AUS,BEL,2022.0,30,17,13
VNM,POL,2016.0,6,7,-1
ROU,ITA,2023.0,9,4,5
DEU,SGP,2022.0,24,34,-10
SAU,OMN,2022.0,5,4,1
SGP,MYS,2019.0,14,28,-14
URY,ISR,2019.0,3,1,2
ESP,POL,2021.0,31,14,17
JPN,AUT,2023.0,17,11,6
JPN,KEN,2020.0,3,13,-10
PRT,IRL,2018.0,7,3,4
KEN,ITA,2023.0,1,1,0
NLD,NGA,2020.0,4,5,-1
PRT,NLD,2017.0,32,22,10
MNG,DEU,2018.0,5,1,4
PHL,USA,2007.0,19,23,-4
NLD,AUT,2020.0,22,48,-26
ROU,JPN,2004.0,12,6,6
GLP,FRA,2018.0,49,24,25
AUS,ZAF,2011.0,29,39,-10
VNM,EGY,2019.0,1,1,0
EGY,CHN,2022.0,37,100,-63
TTO,USA,2009.0,11,15,-4
JPN,HRV,2017.0,1,1,0
IRL,SWE,2002.0,2,5,-3
PER,ECU,2021.0,12,9,3
CHE,ROU,2019.0,8,10,-2
USA,GRD,2019.0,18,17,1
BEL,UGA,2022.0,5,11,-6
PRT,SGP,2020.0,3,3,0
QAT,DEU,2022.0,6,4,2
HKG,JPN,2019.0,11,13,-2
BGD,PAK,2011.0,8,8,0
KOR,DEU,2001.0,16,12,4
MAR,SEN,2020.0,2,1,1
TUR,KOR,2020.0,7,5,2
MEX,DNK,2021.0,3,5,-2
JPN,HKG,2007.0,10,15,-5
TUR,ITA,2019.0,24,18,6
NPL,CHN,2016.0,13,8,5
NGA,NLD,2010.0,5,2,3
FRA,KWT,2023.0,4,1,3
ARG,BEL,2022.0,9,2,7
CHN,SVK,2021.0,2,2,0
SGP,ZAF,2022.0,9,12,-3
JPN,NOR,2020.0,11,7,4
FRO,DNK,2019.0,3,4,-1
DNK,FRO,2020.0,11,3,8
DEU,NGA,2001.0,6,10,-4
ESP,ECU,2023.0,42,24,18
DNK,POL,2023.0,3,2,1
CMR,CHN,2022.0,4,4,0
CHN,CMR,2023.0,8,2,6
DEU,KAZ,2022.0,2,2,0
AUS,SWE,2024.0,1,1,0
JOR,HUN,2023.0,1,4,-3
HUN,ITA,2022.0,14,8,6
RUS,TUR,2013.0,3,3,0
NOR,IND,2024.0,1,1,0
ITA,IDN,2023.0,2,1,1
TZA,ZMB,2021.0,3,1,2
ROU,DEU,2023.0,13,11,2
NZL,HKG,2021.0,2,3,-1
ESP,LUX,2022.0,8,8,0
IND,ESP,2022.0,22,22,0
USA,HTI,2021.0,18,12,6
USA,MWI,2023.0,23,11,12
NLD,CZE,2021.0,16,14,2
KWT,EGY,2011.0,15,6,9
CHL,SWE,2019.0,8,3,5
CHL,ARG,2021.0,14,36,-22
LTU,AUT,2022.0,4,2,2
HKG,KAZ,2023.0,2,1,1
DNK,SVK,2021.0,1,1,0
POL,NOR,2018.0,14,9,5
COG,FRA,2020.0,3,2,1
CYP,USA,2023.0,5,5,0
IRL,AUS,2023.0,24,29,-5
IRL,ESP,2020.0,32,51,-19
LUX,DEU,2023.0,12,22,-10
IND,SAU,1997.0,8,3,5
IRQ,ROU,2022.0,3,3,0
PAK,FRA,2018.0,11,16,-5
USA,GUM,2010.0,4,6,-2
KOR,BRA,1999.0,1,1,0
UGA,GBR,1999.0,6,4,2
BRA,VEN,2002.0,1,5,-4
AUT,SRB,2001.0,2,1,1
GMB,GBR,1997.0,7,3,4
ISL,USA,2000.0,8,15,-7
BGR,CZE,2000.0,2,1,1
GRC,ZAF,1999.0,1,3,-2
VNM,DEU,2002.0,4,4,0
VNM,USA,2010.0,11,22,-11
TWN,ZAF,2010.0,2,1,1
SWE,MEX,2011.0,1,5,-4
USA,PSE,2011.0,10,7,3
QAT,NLD,2017.0,9,2,7
IRL,JPN,2001.0,4,5,-1
BEL,ESP,2001.0,24,24,0
IND,NLD,2000.0,12,4,8
SWE,IDN,2012.0,2,2,0
USA,CYP,2016.0,14,11,3
CHL,AUS,2008.0,3,4,-1
SWE,ISL,2004.0,12,9,3
ESP,CUB,1998.0,22,17,5
USA,TUN,2001.0,6,4,2
CUB,USA,2002.0,8,10,-2
GRC,CAN,2003.0,8,11,-3
NOR,DEU,1999.0,15,27,-12
ARG,CHE,2004.0,5,1,4
BRA,ITA,2003.0,20,29,-9
CAN,CHL,2002.0,8,4,4
UZB,RUS,2002.0,6,18,-12
BRA,CUB,2021.0,12,7,5
AUS,AUT,2001.0,32,29,3
SRB,SVN,2006.0,5,3,2
FIN,DEU,1999.0,17,28,-11
AUS,KWT,2013.0,3,2,1
CHN,AUT,2009.0,10,8,2
NLD,EGY,2004.0,5,4,1
BRA,ESP,1999.0,18,43,-25
ESP,BRA,2001.0,39,34,5
RUS,ZAF,2004.0,6,2,4
BEL,ISR,2000.0,4,3,1
CHN,BLR,2012.0,5,1,4
LVA,SWE,1998.0,4,2,2
IRL,JPN,2004.0,3,7,-4
ITA,RUS,2023.0,7,35,-28
NZL,KOR,2017.0,4,9,-5
KOR,RUS,2019.0,15,8,7
ITA,PAK,2010.0,3,2,1
BGD,IND,2009.0,11,12,-1
PAN,GBR,2002.0,3,2,1
THA,FRA,2007.0,7,14,-7
USA,NPL,2000.0,6,7,-1
NOR,NPL,2004.0,1,1,0
ARG,BRA,1997.0,15,9,6
POL,CAN,2000.0,16,14,2
KAZ,DEU,2018.0,4,4,0
CAN,IRL,1999.0,8,9,-1
FRA,ZAF,2019.0,25,23,2
HKG,SGP,2006.0,20,15,5
RUS,PRT,2006.0,11,9,2
MYS,GBR,2000.0,13,49,-36
ARE,GBR,1998.0,4,5,-1
IND,TTO,2009.0,2,3,-1
FIN,CHE,2001.0,13,10,3
SVK,POL,2010.0,8,4,4
ARG,CUB,2009.0,4,2,2
SWE,NZL,1997.0,4,3,1
THA,DEU,1998.0,3,1,2
IRL,BGD,2012.0,1,2,-1
DNK,AUT,2007.0,2,1,1
LUX,FRA,2005.0,3,14,-11
ECU,FRA,2014.0,3,5,-2
EGY,QAT,2003.0,5,2,3
FRA,HUN,2005.0,9,8,1
VEN,FRA,2004.0,6,8,-2
FIN,RUS,1999.0,10,21,-11
GNB,SWE,2008.0,2,1,1
SGP,CHE,2005.0,4,6,-2
CHN,CHE,2013.0,43,40,3
BRB,GBR,2018.0,2,3,-1
DNK,ISR,2001.0,5,2,3
HUN,NOR,2000.0,3,1,2
NOR,HUN,2003.0,2,2,0
SWE,VEN,2019.0,2,1,1
RUS,BGR,1999.0,8,4,4
CRI,USA,2022.0,21,15,6
RUS,SWE,2003.0,36,25,11
BRN,DEU,2015.0,1,2,-1
BGR,AUS,2001.0,5,1,4
NZL,ZAF,2004.0,11,10,1
RUS,NOR,2000.0,17,3,14
AUS,BGD,2012.0,9,32,-23
HUN,ROU,2000.0,2,4,-2
PRT,POL,2003.0,3,1,2
PHL,AUS,2004.0,8,7,1
NOR,CHE,2004.0,9,12,-3
CHE,CZE,2005.0,7,13,-6
SWE,IRL,2023.0,9,10,-1
GBR,ETH,2023.0,5,7,-2
PHL,GBR,2003.0,2,6,-4
ROU,USA,2007.0,24,35,-11
TTO,AUS,2018.0,1,3,-2
NOR,ISL,2021.0,8,5,3
NOR,IRN,2008.0,3,2,1
CYP,DEU,2018.0,7,6,1
HRV,BIH,2011.0,14,7,7
IRL,FRA,2010.0,38,32,6
NZL,IRN,2018.0,4,26,-22
NGA,DEU,2016.0,10,9,1
TUR,KAZ,2017.0,9,3,6
CHE,KOR,2015.0,11,12,-1
NLD,ITA,2016.0,77,139,-62
IRN,ITA,2013.0,32,16,16
CAN,MLI,2015.0,3,4,-1
ESP,IRL,2017.0,46,25,21
SWE,CHE,2010.0,55,60,-5
IRN,ISR,2010.0,4,1,3
POL,SWE,2020.0,24,20,4
RUS,BRA,2021.0,9,3,6
SWE,AUS,2017.0,36,69,-33
NZL,DNK,2008.0,4,8,-4
FRA,ARG,2013.0,27,41,-14
PRT,POL,2023.0,8,2,6
NLD,ISR,2012.0,12,10,2
AFG,GBR,2020.0,3,4,-1
FIN,RUS,2018.0,22,37,-15
DNK,EGY,2020.0,9,1,8
COL,CHE,2018.0,7,7,0
POL,ESP,2021.0,14,31,-17
ITA,JPN,2007.0,19,17,2
MAC,AUS,2015.0,3,2,1
DNK,IRN,2022.0,17,42,-25
ITA,SRB,2011.0,7,2,5
PAK,OMN,2015.0,11,6,5
SGP,CHN,2004.0,69,63,6
CHN,IRL,2020.0,29,27,2
SAU,GBR,2013.0,28,120,-92
CAN,BGD,2019.0,31,23,8
SAU,SDN,2022.0,16,23,-7
PAK,SAU,2004.0,6,10,-4
VNM,TWN,2016.0,3,27,-24
FRA,ISR,2021.0,40,30,10
GRC,CHE,2018.0,36,15,21
DZA,NLD,2006.0,1,1,0
CHN,IDN,2019.0,13,10,3
GMB,CAN,2022.0,1,1,0
DEU,PAK,2010.0,16,15,1
ESP,POL,2014.0,24,12,12
GBR,MKD,2015.0,4,1,3
USA,DZA,2019.0,9,2,7
PAK,QAT,2023.0,10,9,1
IRL,NLD,2018.0,26,15,11
DZA,ROU,2021.0,1,1,0
RUS,UZB,2017.0,10,8,2
CHN,SDN,2019.0,12,7,5
CHN,MAR,2022.0,8,4,4
ZWE,ZAF,2020.0,46,44,2
ARG,CHL,2023.0,12,14,-2
KEN,GBR,2022.0,30,35,-5
EST,RUS,2014.0,4,6,-2
TUR,CAN,2001.0,15,12,3
MKD,DEU,1997.0,1,1,0
SVK,SVN,2019.0,23,28,-5
UKR,ISR,2000.0,7,2,5
ROU,NLD,2022.0,2,3,-1
ESP,URY,2009.0,9,7,2
ITA,NOR,2009.0,14,9,5
AUT,RUS,2021.0,10,26,-16
JAM,USA,2006.0,8,13,-5
USA,UKR,1997.0,13,41,-28
ISL,NOR,1998.0,3,2,1
FRA,CIV,2001.0,20,22,-2
BGD,GBR,2015.0,19,9,10
FRA,GEO,2005.0,1,1,0
JPN,SAU,2010.0,13,2,11
ARG,CAN,2006.0,15,7,8
OMN,DEU,2009.0,3,5,-2
NOR,JPN,2010.0,5,6,-1
COL,ESP,1998.0,1,10,-9
IND,POL,2000.0,3,3,0
EST,GBR,2012.0,8,8,0
BEL,UKR,2006.0,2,2,0
FIN,SRB,2005.0,1,4,-3
SLV,SVK,2013.0,8,2,6
GBR,BGR,2000.0,13,15,-2
DEU,VNM,2010.0,18,2,16
POL,SWE,2007.0,12,11,1
ECU,FRA,2011.0,4,7,-3
BGR,RUS,2000.0,12,3,9
CZE,CHE,2014.0,19,16,3
NOR,SRB,2011.0,5,2,3
PHL,JPN,2009.0,17,20,-3
ZAF,IND,2023.0,39,22,17
ESP,PAK,2020.0,9,4,5
KWT,QAT,2022.0,3,1,2
ESP,PRY,2021.0,8,2,6
EST,LTU,2018.0,5,1,4
POL,NLD,2018.0,13,19,-6
ITA,EGY,2021.0,23,19,4
ARG,CAN,2010.0,16,8,8
MMR,MYS,2011.0,1,1,0
GTM,GBR,2020.0,4,2,2
HUN,ISR,2012.0,4,2,2
IND,PRT,2006.0,8,3,5
IDN,PHL,2020.0,7,4,3
CHE,CHN,2014.0,53,56,-3
KEN,NLD,2016.0,7,7,0
GUF,FRA,2020.0,24,37,-13
ROU,DEU,2003.0,28,11,17
IND,HUN,2017.0,10,1,9
SGP,FRA,2018.0,26,44,-18
TUN,PRT,2021.0,4,2,2
SAU,IND,2012.0,26,104,-78
USA,BGD,2010.0,23,27,-4
BRA,IRL,2016.0,8,7,1
BGD,GBR,2001.0,8,11,-3
GBR,ARG,2002.0,12,13,-1
DNK,CHE,2005.0,13,7,6
BRA,NLD,2003.0,12,11,1
USA,ARM,2016.0,9,14,-5
RUS,UZB,2018.0,9,8,1
AUS,MYS,2000.0,9,4,5
PHL,IND,2015.0,4,11,-7
GBR,HUN,2000.0,19,26,-7
POL,CHE,2000.0,6,15,-9
RUS,CZE,2007.0,9,5,4
JPN,UKR,1998.0,6,3,3
UKR,USA,2012.0,22,22,0
JPN,NZL,2009.0,12,11,1
ITA,VEN,2005.0,2,2,0
ZAF,SWE,2023.0,7,7,0
JPN,LKA,1999.0,4,3,1
LKA,JPN,2002.0,5,5,0
AUT,IRL,2004.0,3,1,2
JPN,SWE,2010.0,43,24,19
CAN,ZAF,2007.0,9,23,-14
OMN,USA,2003.0,8,8,0
MTQ,FRA,2005.0,15,15,0
RUS,COL,2004.0,2,1,1
CHE,SVN,2002.0,2,6,-4
BEL,ISR,2003.0,4,5,-1
PER,CHL,2013.0,3,7,-4
AUS,TWN,2010.0,21,12,9
PHL,SGP,2020.0,9,15,-6
CHN,ROU,2015.0,2,1,1
CHN,BEL,2009.0,27,13,14
FIN,ZAF,2015.0,5,5,0
JPN,BGD,2001.0,22,16,6
KEN,FRA,2018.0,4,7,-3
KOR,NZL,2017.0,9,4,5
BRA,NOR,2011.0,3,3,0
BRA,PRI,2015.0,5,5,0
IRQ,PAK,2017.0,1,1,0
BLR,RUS,2011.0,12,22,-10
TZA,NOR,2011.0,2,4,-2
IRL,ESP,2017.0,25,46,-21
JPN,PHL,2019.0,41,35,6
CAN,KEN,1997.0,3,4,-1
USA,SYC,2014.0,2,1,1
CMR,CAN,2016.0,1,3,-2
FRA,SYR,2018.0,9,1,8
PAN,BRA,2013.0,1,2,-1
BGR,DEU,2011.0,11,13,-2
GBR,CHL,2016.0,48,48,0
CZE,HUN,1997.0,3,2,1
ZAF,AUS,2001.0,31,13,18
KEN,CAN,2023.0,7,7,0
RUS,MDA,2012.0,2,5,-3
ROU,RUS,2018.0,1,3,-2
IND,PRT,2023.0,6,5,1
TUR,KAZ,2016.0,17,2,15
CHL,NLD,2017.0,11,14,-3
GEO,RUS,2002.0,5,7,-2
BEL,LUX,2021.0,18,15,3
EGY,SAU,2024.0,4,9,-5
KOR,UKR,2016.0,2,1,1
BRA,POL,2014.0,3,3,0
TWN,AUS,2018.0,21,14,7
GBR,SDN,2020.0,5,6,-1
USA,SYR,2019.0,7,7,0
DZA,CHN,2020.0,5,16,-11
ISR,CHL,2023.0,1,2,-1
IRN,DNK,2016.0,28,3,25
CHN,ARE,2018.0,12,5,7
TUN,CAN,2017.0,12,8,4
MAC,USA,2018.0,11,11,0
TUR,PSE,2020.0,4,3,1
RUS,CHE,2010.0,25,17,8
SRB,CHE,2019.0,5,6,-1
SWE,THA,2023.0,5,3,2
BEL,UGA,2020.0,5,3,2
ARG,POL,2021.0,4,1,3
TUR,AZE,2022.0,10,5,5
USA,DZA,2021.0,5,5,0
SWE,JPN,2020.0,23,40,-17
UKR,FIN,2019.0,6,1,5
RUS,SYR,2022.0,2,4,-2
ARG,CHE,2021.0,15,8,7
AUS,SYC,2021.0,2,1,1
USA,PRY,2011.0,5,2,3
TWN,CHN,2000.0,57,86,-29
BGD,MYS,2000.0,5,3,2
NLD,ROU,2003.0,2,6,-4
DNK,BEL,2023.0,10,12,-2
FRA,RUS,2021.0,44,69,-25
FRA,CHL,2003.0,11,14,-3
MEX,IND,2004.0,2,8,-6
FRA,TWN,2005.0,4,3,1
ESP,IRL,2016.0,37,23,14
KHM,FRA,2020.0,7,11,-4
USA,ASM,2009.0,6,1,5
BGD,MYS,2023.0,28,31,-3
BRA,CHL,2011.0,19,12,7
DEU,MYS,2014.0,14,7,7
FRA,BGD,2014.0,1,1,0
BLR,ITA,2002.0,5,1,4
DNK,GNB,2010.0,4,4,0
FRA,CHN,2010.0,91,109,-18
ITA,MEX,2015.0,17,16,1
CHE,IND,1999.0,8,9,-1
EGY,BHR,2013.0,4,2,2
HUN,JPN,2020.0,7,2,5
FIN,IRL,2018.0,11,6,5
ZAF,SAU,2017.0,11,14,-3
AUS,JOR,2018.0,12,7,5
TUR,SGP,2017.0,7,5,2
CHN,IDN,2021.0,12,9,3
PAN,USA,2008.0,16,20,-4
ZWE,CHE,2008.0,2,2,0
,CHL,2015.0,2353,0,2353
,BGR,2015.0,552,0,552
,CAN,2017.0,13524,0,13524
,VNM,2019.0,2823,0,2823
,NLD,2020.0,3532,0,3532
,IRL,2015.0,1758,0,1758
GBR,PRY,2021.0,2,0,2
,PAK,2017.0,6024,0,6024
,KAZ,2013.0,1339,0,1339
,SEN,2015.0,157,0,157
,IRL,2014.0,1828,0,1828
,TWN,2016.0,5679,0,5679
,PRT,2014.0,3323,0,3323
ALB,,2019.0,48,0,48
,ARE,2013.0,416,0,416
,BGR,2014.0,548,0,548
,AUS,2019.0,9443,0,9443
BRA,HUN,2020.0,6,0,6
SEN,,2022.0,221,0,221
,SYR,2015.0,111,0,111
,ZAF,2020.0,1375,0,1375
NLD,BIH,2019.0,2,0,2
GIN,,2024.0,87,0,87
,CHL,2014.0,2371,0,2371
,SGP,2011.0,2290,0,2290
,NZL,2011.0,1512,0,1512
COL,FSM,2020.0,1,0,1
IND,ETH,2001.0,3,0,3
JAM,,2025.0,277,0,277
UKR,EGY,2020.0,1,0,1
,BDI,2014.0,15,0,15
BDI,,2019.0,12,0,12
,NGA,2019.0,2733,0,2733
,CUB,2016.0,427,0,427
,COL,2013.0,2329,0,2329
,LIE,2018.0,17,0,17
,COG,2016.0,126,0,126
,SYR,2014.0,124,0,124
,TUN,2017.0,1240,0,1240
,LBN,2016.0,629,0,629
,LBN,2017.0,702,0,702
,NPL,2013.0,381,0,381
,ETH,2016.0,1304,0,1304
GRD,IND,2018.0,2,0,2
,AUT,2019.0,2678,0,2678
,PAK,2016.0,4925,0,4925
,HUN,2017.0,1769,0,1769
ARE,,2018.0,238,0,238
,AFG,2014.0,32,0,32
AFG,,2024.0,118,0,118
,THA,2009.0,2341,0,2341
,KHM,2015.0,74,0,74
MAC,,2024.0,441,0,441
ECU,,2020.0,320,0,320
,HRV,2009.0,1313,0,1313
DZA,,2005.0,26,0,26
,SMR,2015.0,8,0,8
,ISR,2007.0,2330,0,2330
,BGD,2012.0,979,0,979
IRQ,MEX,2020.0,1,0,1
,DOM,2015.0,30,0,30
,ETH,2017.0,1532,0,1532
,SVK,2020.0,524,0,524
DNK,GHA,2019.0,5,0,5
UZB,,2023.0,437,0,437
,SVN,2016.0,586,0,586
IRL,LTU,2019.0,2,0,2
TUR,NOR,2018.0,10,0,10
BIH,,2007.0,20,0,20
SEN,AUS,2018.0,1,0,1
UKR,TJK,2017.0,1,0,1
TJK,,2019.0,25,0,25
LBN,BLR,2020.0,1,0,1
,TUN,2018.0,1165,0,1165
,PAK,2018.0,6814,0,6814
,BWA,2017.0,97,0,97
,UGA,2012.0,337,0,337
,HUN,2018.0,1742,0,1742
SLV,,2025.0,68,0,68
,LVA,2019.0,349,0,349
,ISR,2020.0,1515,0,1515
,PSE,2015.0,124,0,124
PSE,,2020.0,79,0,79
MEX,DMA,2018.0,2,0,2
,SVN,2018.0,642,0,642
TJK,,2025.0,128,0,128
NZL,VNM,2017.0,4,0,4
LKA,,2014.0,100,0,100
GEO,CAN,2017.0,1,0,1
TGO,,2025.0,295,0,295
ZAF,TWN,2023.0,3,0,3
,DZA,2020.0,805,0,805
,HRV,2011.0,1094,0,1094
,PHL,2019.0,943,0,943
BHR,,2013.0,30,0,30
BLZ,,2023.0,12,0,12
JPN,URY,2002.0,1,0,1
CHE,JOR,2020.0,5,0,5
HND,,2020.0,21,0,21
,BWA,2016.0,98,0,98
NPL,,2014.0,89,0,89
,SEN,2014.0,184,0,184
KWT,,2020.0,163,0,163
,PER,2012.0,398,0,398
BRA,SAU,2015.0,1,0,1
TUR,AUS,2023.0,11,0,11
,DOM,2014.0,33,0,33
ARM,POL,2018.0,1,0,1
OMN,,2021.0,170,0,170
,MAR,2019.0,2054,0,2054
,LBN,2018.0,727,0,727
,NAM,2018.0,91,0,91
,ETH,2018.0,2064,0,2064
,TWN,2018.0,6548,0,6548
,MNG,2018.0,101,0,101
,NZL,2019.0,1434,0,1434
,AFG,2015.0,33,0,33
,MDG,2019.0,89,0,89
,YEM,2018.0,71,0,71
COD,ZAF,2022.0,4,0,4
AZE,,2022.0,360,0,360
,MDA,2018.0,108,0,108
,BEL,2020.0,1929,0,1929
,CUB,2018.0,605,0,605
TCD,,2023.0,43,0,43
,MLI,2018.0,50,0,50
MEX,VNM,2022.0,1,0,1
,SRB,2020.0,614,0,614
DJI,,2025.0,21,0,21
,MNG,2017.0,107,0,107
,GHA,2020.0,690,0,690
,KEN,2019.0,676,0,676
IRN,ISL,2021.0,1,0,1
PRT,CUB,2021.0,1,0,1
MLI,FRA,2023.0,5,0,5
,JOR,2019.0,1051,0,1051
,VNM,2011.0,827,0,827
,SVN,2017.0,601,0,601
,CUB,2017.0,553,0,553
,KWT,2019.0,219,0,219
,HRV,2019.0,999,0,999
,HKG,2020.0,1877,0,1877
BLZ,,2024.0,36,0,36
,GEO,2019.0,139,0,139
NPL,ZAF,2021.0,1,0,1
,KNA,2018.0,17,0,17
,JAM,2018.0,38,0,38
,BHS,2018.0,4,0,4
MYS,MUS,2023.0,1,0,1
,JOR,2011.0,420,0,420
LSO,,2022.0,21,0,21
,VEN,2018.0,177,0,177
TZA,,2013.0,79,0,79
,MDA,2016.0,74,0,74
ECU,HKG,2022.0,1,0,1
SOM,,2023.0,18,0,18
,MLI,2016.0,48,0,48
,TZA,2010.0,225,0,225
IRL,,2005.0,353,0,353
,VEN,2017.0,163,0,163
,KEN,2011.0,502,0,502
SEN,,2018.0,119,0,119
GBR,KGZ,2008.0,1,0,1
BEL,PHL,2005.0,1,0,1
TCD,,2000.0,1,0,1
GUF,BRA,1998.0,1,0,1
,QAT,1997.0,20,0,20
,JOR,1994.0,368,0,368
KOR,MEX,2002.0,1,0,1
SWE,SAU,2003.0,2,0,2
IRQ,,2003.0,12,0,12
,GEO,1994.0,274,0,274
,UZB,2000.0,89,0,89
SVN,,2002.0,92,0,92
,BIH,2000.0,66,0,66
SMR,ITA,2003.0,4,0,4
TUR,SVK,2013.0,1,0,1
LBY,,2014.0,35,0,35
CAF,GAB,2017.0,1,0,1
PYF,,2025.0,86,0,86
FIN,KWT,2009.0,1,0,1
FIN,KWT,2011.0,2,0,2
NLD,TZA,2006.0,5,0,5
PRT,,1999.0,78,0,78
VEN,ARG,2018.0,7,0,7
ARG,PRI,2005.0,1,0,1
LKA,CHE,2023.0,1,0,1
MYS,ITA,2008.0,2,0,2
NOR,ZWE,2004.0,2,0,2
LTU,IRN,2003.0,2,0,2
DNK,LUX,1998.0,1,0,1
,MUS,1997.0,24,0,24
BGR,,1999.0,116,0,116
IND,VNM,2003.0,1,0,1
SVK,,2003.0,293,0,293
ARM,JPN,2013.0,2,0,2
JPN,ARM,2014.0,2,0,2
GRC,QAT,2012.0,2,0,2
LTU,NOR,2003.0,3,0,3
BHR,HUN,2000.0,1,0,1
ISR,SVN,2003.0,3,0,3
,BFA,2000.0,56,0,56
DEU,JAM,2003.0,1,0,1
LBR,USA,1997.0,1,0,1
EGY,,2000.0,146,0,146
USA,AFG,2004.0,2,0,2
CZE,FIN,1999.0,3,0,3
IRL,SRB,2003.0,1,0,1
,TGO,1994.0,38,0,38
UKR,AUS,2001.0,1,0,1
KWT,AUT,2014.0,1,0,1
IRN,,2001.0,39,0,39
SYR,JOR,2013.0,8,0,8
RUS,CHL,2001.0,5,0,5
LUX,,2002.0,6,0,6
URY,CHL,1998.0,2,0,2
MYS,,2006.0,176,0,176
SVK,SRB,2000.0,4,0,4
MMR,,2000.0,4,0,4
FJI,,2020.0,27,0,27
CHE,NPL,2013.0,1,0,1
,MTQ,1995.0,31,0,31
,BLR,2012.0,251,0,251
AZE,,2017.0,100,0,100
SDN,SAU,2000.0,4,0,4
,MLT,1998.0,18,0,18
,CYP,1995.0,62,0,62
COG,,2006.0,15,0,15
CAN,BRB,2005.0,3,0,3
KEN,NPL,2021.0,2,0,2
NER,,2021.0,37,0,37
KHM,FRA,2002.0,2,0,2
MEX,ROU,2005.0,2,0,2
MEX,ROU,1997.0,2,0,2
BWA,CHL,2020.0,1,0,1
ZAF,POL,2000.0,1,0,1
,RWA,2013.0,67,0,67
,HTI,2013.0,41,0,41
,PRI,2013.0,136,0,136
,LKA,2012.0,310,0,310
,LVA,2011.0,377,0,377
PHL,IRL,2019.0,2,0,2
MAR,ROU,2017.0,1,0,1
ROU,MAR,2018.0,1,0,1
,PHL,2011.0,508,0,508
,MAC,2013.0,168,0,168
,SEN,2008.0,101,0,101
,OMN,2013.0,200,0,200
,BGR,2008.0,497,0,497
TZA,NOR,2023.0,5,0,5
NLD,RWA,2016.0,5,0,5
KOR,GTM,2021.0,1,0,1
NAM,,2020.0,29,0,29
,CPV,2013.0,16,0,16
PYF,,2021.0,23,0,23
KHM,NZL,2020.0,4,0,4
,LUX,2013.0,146,0,146
VAT,USA,2020.0,1,0,1
KEN,,2012.0,137,0,137
,ISL,2012.0,129,0,129
,KGZ,2013.0,33,0,33
,GTM,2012.0,48,0,48
,JOR,2009.0,485,0,485
TGO,CIV,2014.0,4,0,4
KAZ,CHN,2007.0,1,0,1
PAN,,2019.0,42,0,42
EGY,MEX,2010.0,1,0,1
AUT,KEN,2015.0,3,0,3
ROU,CZE,2022.0,5,0,5
,BEN,1997.0,29,0,29
QAT,IRL,2013.0,2,0,2
,CRI,2010.0,115,0,115
CRI,SWE,2015.0,3,0,3
SWE,CRI,2019.0,2,0,2
MOZ,,2017.0,33,0,33
AZE,,2018.0,132,0,132
,CIV,2013.0,112,0,112
,BEN,2012.0,92,0,92
AFG,SVN,2019.0,1,0,1
CHE,LTU,2022.0,2,0,2
,MUS,2012.0,37,0,37
ERI,,2010.0,4,0,4
DEU,NAM,2019.0,5,0,5
GUF,,2017.0,10,0,10
KEN,,2005.0,42,0,42
,FSM,2013.0,5,0,5
MKD,,2018.0,116,0,116
,SLB,2009.0,19,0,19
,QAT,2012.0,251,0,251
,GEO,2011.0,146,0,146
,NER,2013.0,40,0,40
,SEN,2001.0,115,0,115
,MMR,2013.0,76,0,76
ALB,,2021.0,90,0,90
,SDN,2009.0,148,0,148
SDN,SVK,2012.0,1,0,1
PRT,MAC,2013.0,2,0,2
AUT,GAB,2017.0,1,0,1
MNG,AUS,2016.0,3,0,3
AFG,,2023.0,62,0,62
PER,,2026.0,59,0,59
GHA,,2026.0,36,0,36
,MNE,2011.0,62,0,62
MKD,,2022.0,217,0,217
SYR,QAT,2017.0,3,0,3
,JAM,2016.0,49,0,49
TLS,,2024.0,19,0,19
,FRO,2016.0,5,0,5
,KNA,2016.0,4,0,4
,VEN,2016.0,177,0,177
LBN,KAZ,2021.0,1,0,1
PRT,CZE,2010.0,2,0,2
TGO,,2019.0,41,0,41
ITA,COD,2021.0,2,0,2
COD,ITA,2022.0,4,0,4
,MNG,2016.0,105,0,105
USA,VCT,2018.0,1,0,1
VEN,PER,2020.0,7,0,7
LAO,NGA,2019.0,3,0,3
,ZMB,2007.0,66,0,66
SVK,IRQ,2015.0,1,0,1
GRD,PSE,2021.0,1,0,1
FJI,NOR,2022.0,1,0,1
IRN,OMN,2019.0,4,0,4
URY,,2004.0,38,0,38
ESP,JOR,2016.0,2,0,2
,GLP,2016.0,3,0,3
ARG,IRL,2019.0,2,0,2
,BFA,2010.0,133,0,133
PNG,UGA,2019.0,1,0,1
GIN,,2023.0,105,0,105
,MRT,2016.0,19,0,19
MRT,,2021.0,19,0,19
,NAM,2016.0,62,0,62
HKG,MWI,2021.0,3,0,3
SDN,,2004.0,9,0,9
,LIE,2016.0,9,0,9
IND,CHL,2017.0,4,0,4
AZE,DNK,2020.0,1,0,1
MEX,FIN,2021.0,5,0,5
HUN,KWT,2017.0,1,0,1
GRC,EST,2020.0,2,0,2
POL,DZA,2019.0,5,0,5
CRI,,2013.0,56,0,56
,AGO,2015.0,24,0,24
GHA,TGO,2020.0,3,0,3
TZA,TUR,2021.0,1,0,1
CHN,COL,2022.0,1,0,1
,LCA,2018.0,2,0,2
,SDN,2019.0,186,0,186
CUB,COL,2016.0,7,0,7
NLD,GMB,2022.0,1,0,1
,SGP,2021.0,39,0,39
ERI,,2023.0,17,0,17
KOR,UZB,2023.0,4,0,4
BLR,AUT,2022.0,1,0,1
DNK,MYS,2022.0,2,0,2
GLP,,2025.0,41,0,41
,ABW,2019.0,3,0,3
DNK,UZB,2023.0,1,0,1
HUN,CYP,2022.0,1,0,1
SDN,AUS,2019.0,2,0,2
,WSM,2018.0,24,0,24
WSM,,2024.0,27,0,27
DMA,VCT,2022.0,1,0,1
DEU,SEN,2022.0,3,0,3
,ZMB,2020.0,90,0,90
MEX,DEU,2024.0,1,0,1
NOR,ETH,1999.0,2,0,2
KEN,ARE,2016.0,1,0,1
MOZ,NLD,2003.0,1,0,1
SGP,LKA,2001.0,1,0,1
,LKA,1997.0,107,0,107
ESP,MLT,2012.0,1,0,1
MRT,,2025.0,102,0,102
QAT,,2009.0,25,0,25
,MLI,2017.0,54,0,54
,SMR,1996.0,2,0,2
GBR,ISL,1997.0,4,0,4
BFA,,2006.0,7,0,7
COL,CHN,2006.0,2,0,2
POL,VNM,1997.0,1,0,1
VNM,CHE,2010.0,1,0,1
,MWI,1994.0,66,0,66
USA,DZA,2010.0,9,0,9
IRQ,,2013.0,61,0,61
AZE,,2016.0,93,0,93
,BLR,2005.0,231,0,231
MDA,,2005.0,14,0,14
TGO,,2011.0,8,0,8
SAU,OMN,2005.0,2,0,2
CHL,,1999.0,78,0,78
ETH,USA,1997.0,6,0,6
SAU,ARE,2005.0,6,0,6
JPN,KWT,2003.0,4,0,4
KNA,,2020.0,8,0,8
ZAF,SEN,2005.0,3,0,3
IRL,HKG,1999.0,1,0,1
BGD,KWT,2000.0,2,0,2
UKR,MEX,2000.0,15,0,15
SWE,PAK,1997.0,1,0,1
SLV,PAK,2010.0,1,0,1
VEN,EGY,2001.0,1,0,1
COG,,2000.0,6,0,6
MDA,,2002.0,19,0,19
ECU,RUS,2012.0,1,0,1
BFA,GBR,2005.0,1,0,1
BLR,PRT,2003.0,2,0,2
ECU,,2007.0,18,0,18
HUN,CZE,2006.0,3,0,3
TUN,QAT,2005.0,1,0,1
EST,,2008.0,53,0,53
MOZ,,2022.0,114,0,114
LKA,SGP,2002.0,1,0,1
PRI,GBR,2015.0,2,0,2
ISL,,2014.0,70,0,70
PER,,2016.0,160,0,160
LKA,,2001.0,26,0,26
URY,,2001.0,16,0,16
LVA,EST,2011.0,2,0,2
MLI,,2002.0,3,0,3
DZA,BHR,2010.0,2,0,2
JAM,,2011.0,36,0,36
GBR,TWN,2001.0,33,16,17
CAN,THA,2017.0,17,14,3
DEU,KEN,2013.0,10,7,3
AUT,CHN,2005.0,10,7,3
ESP,CAN,2015.0,78,44,34
EGY,KOR,2018.0,7,8,-1
AUS,ZAF,2012.0,24,44,-20
SVN,GBR,2015.0,15,8,7
ESP,LUX,2013.0,7,1,6
BRA,MOZ,2011.0,1,3,-2
NLD,FRA,2009.0,93,91,2
USA,ISL,2014.0,10,11,-1
AUS,NOR,2019.0,20,18,2
ARG,CAN,2017.0,16,13,3
EST,USA,2022.0,6,13,-7
USA,ARE,2007.0,27,10,17
JOR,USA,2016.0,41,73,-32
DEU,BRA,2019.0,91,150,-59
CAN,TWN,2017.0,13,16,-3
UKR,ISR,2017.0,7,2,5
FRA,ARG,2020.0,25,39,-14
IRL,BRA,2017.0,10,14,-4
EGY,QAT,2018.0,17,8,9
SAU,YEM,2020.0,12,22,-10
USA,NPL,2020.0,28,49,-21
NLD,GRC,2016.0,15,33,-18
FIN,AUS,2023.0,10,14,-4
HUN,DEU,2021.0,35,30,5
POL,MEX,2023.0,5,3,2
SWZ,USA,2013.0,5,1,4
KAZ,TUR,2015.0,4,4,0
BEN,CIV,2021.0,5,4,1
CAN,THA,2018.0,17,11,6
AUS,FRA,2020.0,86,109,-23
IDN,DEU,2014.0,12,22,-10
ETH,IND,2009.0,6,3,3
IND,QAT,2020.0,22,9,13
DEU,CMR,2013.0,4,4,0
CHN,IRQ,2021.0,20,6,14
GBR,MAR,2017.0,4,2,2
EST,USA,2018.0,8,3,5
GHA,GBR,2023.0,18,21,-3
USA,CYM,2019.0,3,3,0
JPN,PAK,2019.0,13,8,5
GAB,DEU,2012.0,5,1,4
NZL,SGP,2005.0,5,7,-2
BLR,ITA,2001.0,3,2,1
ESP,CZE,2000.0,1,9,-8
SWE,NOR,2001.0,58,43,15
ARM,CAN,2001.0,1,2,-1
AUS,SGP,2010.0,53,71,-18
HUN,AUS,2006.0,3,3,0
AUS,CHE,2002.0,37,30,7
SWE,POL,2022.0,22,19,3
ARG,AUS,1998.0,3,3,0
ARM,USA,2001.0,8,4,4
ETH,NOR,2014.0,5,4,1
ETH,DEU,2009.0,7,5,2
URY,BRA,1998.0,2,3,-1
RUS,AUS,2013.0,10,3,7
USA,KAZ,2008.0,3,4,-1
CZE,AUT,2007.0,10,8,2
SVN,SVK,2005.0,10,15,-5
MDA,TUR,2011.0,1,1,0
SWE,HUN,2000.0,6,7,-1
FIN,RUS,2000.0,12,20,-8
FIN,AUS,2000.0,9,9,0
FRA,NCL,2007.0,17,13,4
COL,DEU,2020.0,43,13,30
ESP,CUB,2023.0,8,11,-3
USA,MUS,2019.0,3,6,-3
MYS,JOR,2022.0,29,6,23
USA,SEN,2018.0,14,13,1
CHN,FRA,2007.0,58,55,3
RUS,FIN,2020.0,40,17,23
NPL,USA,2017.0,33,24,9
FRA,IND,2009.0,40,79,-39
BGD,USA,2014.0,63,23,40
IND,PAK,2022.0,32,44,-12
GBR,LBY,2021.0,13,7,6
ISR,BEL,2001.0,6,5,1
CAN,BFA,2011.0,3,2,1
IND,RUS,1997.0,4,2,2
IRL,BRA,2018.0,5,12,-7
GBR,SRB,2001.0,9,8,1
IRL,ESP,2006.0,7,2,5
RUS,FRA,2014.0,74,53,21
ITA,IND,2006.0,7,12,-5
TUR,ISR,1999.0,5,2,3
NLD,POL,1999.0,14,14,0
FRA,SGP,2010.0,20,16,4
CHN,HUN,1999.0,2,3,-1
KOR,CHN,2005.0,59,41,18
IRL,ITA,2001.0,7,8,-1
GBR,IRQ,2007.0,2,5,-3
USA,PHL,2004.0,16,19,-3
IND,CHL,2019.0,12,4,8
AUS,ITA,1997.0,8,7,1
IND,SGP,2002.0,18,4,14
NLD,KEN,2017.0,8,4,4
DNK,AUS,2003.0,16,10,6
DNK,IRL,2020.0,9,6,3
PHL,DEU,2022.0,7,3,4
CZE,CHE,2005.0,13,7,6
AUT,SWE,2007.0,5,10,-5
CHL,PER,2020.0,14,4,10
PER,CHE,2001.0,1,1,0
ITA,ISL,2002.0,1,1,0
POL,IRL,2018.0,5,3,2
IND,SAU,2009.0,34,10,24
IRN,IRQ,2019.0,28,9,19
MEX,IRN,2015.0,1,1,0
CHN,IRN,2011.0,4,3,1
GRC,CHN,2006.0,1,2,-1
DEU,EGY,2023.0,31,31,0
BRA,NZL,2017.0,6,1,5
COG,COD,2011.0,7,27,-20
SWE,AUS,2023.0,22,39,-17
SWE,IRL,2020.0,11,9,2
COL,CAN,2023.0,14,6,8
EGY,JPN,2010.0,26,53,-27
UGA,AUS,2018.0,3,4,-1
MEX,PER,2019.0,12,4,8
RUS,MDA,2015.0,6,4,2
ESP,ROU,2020.0,8,7,1
CHE,CRI,2019.0,1,4,-3
KOR,ITA,2016.0,11,8,3
CZE,PRT,2017.0,2,3,-1
GRC,JPN,2014.0,4,4,0
OMN,PAK,2016.0,7,6,1
BRA,TTO,2012.0,2,1,1
UKR,SVK,2020.0,10,6,4
FRA,LAO,2020.0,5,3,2
JOR,MYS,2022.0,6,29,-23
DZA,PRT,2022.0,5,5,0
MAR,DEU,2022.0,4,6,-2
VNM,SGP,2022.0,4,6,-2
NLD,ARG,2010.0,6,3,3
VEN,ESP,2003.0,15,24,-9
PNG,AUS,2005.0,5,1,4
SWE,TWN,2002.0,3,1,2
RUS,ISR,2012.0,7,11,-4
JPN,NOR,2006.0,6,2,4
CHE,RUS,2012.0,12,21,-9
SDN,GBR,2005.0,2,1,1
AUS,GRC,2023.0,6,2,4
DEU,HKG,2004.0,3,6,-3
IRL,CHL,2017.0,3,2,1
DEU,HKG,2008.0,9,10,-1
NGA,GHA,2020.0,9,9,0
BIH,DEU,2018.0,4,4,0
IRL,NLD,2010.0,11,13,-2
CHE,DNK,2011.0,33,27,6
MYS,NLD,2013.0,8,6,2
ETH,AUT,2011.0,3,4,-1
AUS,VNM,2012.0,11,14,-3
BEL,BEN,2019.0,3,4,-1
AUT,BEL,2015.0,10,14,-4
IRL,USA,2014.0,137,126,11
CHN,IND,2012.0,16,16,0
FRA,CMR,2016.0,25,17,8
DEU,EGY,2012.0,63,35,28
KOR,PAK,2016.0,47,30,17
CHE,SAU,2021.0,5,6,-1
GRC,ESP,2000.0,5,1,4
RUS,POL,2007.0,7,10,-3
LUX,USA,2011.0,4,8,-4
TUN,GBR,2016.0,4,1,3
PAN,USA,2006.0,14,10,4
HRV,NLD,2002.0,3,1,2
KOR,IDN,2007.0,2,2,0
MYS,YEM,2011.0,5,2,3
CUB,COL,1998.0,5,2,3
BRA,CAN,2013.0,104,52,52
COL,CAN,2012.0,25,7,18
ESP,CZE,2012.0,11,10,1
USA,KWT,2020.0,34,10,24
CHE,NOR,2014.0,17,6,11
GRC,CAN,2015.0,19,4,15
SRB,NLD,2012.0,6,3,3
CZE,FRA,2017.0,26,35,-9
CHE,BRA,2016.0,15,24,-9
FRA,ISR,2013.0,33,28,5
ZAF,JPN,2020.0,5,5,0
GBR,UKR,2015.0,30,26,4
JPN,FRA,2012.0,75,64,11
NER,FRA,2011.0,6,4,2
JPN,SGP,2019.0,42,38,4
NLD,JPN,2020.0,23,33,-10
SAU,IND,2017.0,67,156,-89
AUS,AUT,2003.0,33,27,6
SWE,BEL,2012.0,16,18,-2
MYS,DEU,2019.0,19,7,12
NLD,MOZ,2016.0,1,1,0
KAZ,EGY,2011.0,1,1,0
SVN,AUS,2009.0,2,1,1
ISL,SWE,2012.0,17,14,3
DEU,VNM,2014.0,17,6,11
USA,ROU,2011.0,32,38,-6
AUS,DNK,2016.0,35,48,-13
NOR,ETH,2017.0,7,8,-1
AUS,MYS,2014.0,114,86,28
GBR,ARG,2018.0,25,18,7
GRC,NOR,2014.0,9,2,7
GBR,UKR,2008.0,6,64,-58
NGA,UGA,2022.0,11,8,3
USA,MWI,2011.0,9,15,-6
MWI,USA,2013.0,18,10,8
FRA,PER,2014.0,4,5,-1
NOR,AUS,2013.0,6,23,-17
GBR,KOR,2003.0,27,25,2
FRA,IDN,2012.0,10,3,7
GRC,FRA,2014.0,45,35,10
IRL,GRC,2020.0,2,10,-8
ITA,CHN,2013.0,40,26,14
GBR,TWN,2017.0,21,44,-23
IND,OMN,2018.0,43,19,24
DZA,TUN,2022.0,7,10,-3
QAT,KOR,2011.0,2,3,-1
POL,ESP,2003.0,8,3,5
POL,ZAF,2012.0,4,2,2
VNM,FRA,2011.0,13,27,-14
AUS,FJI,2011.0,11,7,4
CUB,SWE,2012.0,1,1,0
NOR,GBR,2012.0,39,74,-35
FIN,MEX,2011.0,1,1,0
RUS,CHE,2015.0,23,11,12
ESP,GRC,2019.0,18,18,0
JPN,BEL,2011.0,17,15,2
NZL,LKA,2011.0,1,3,-2
ARG,AUS,2021.0,12,6,6
CHN,VNM,2014.0,11,7,4
HUN,IND,2011.0,2,2,0
GBR,CYP,2022.0,41,14,27
IRL,MYS,2020.0,6,9,-3
TZA,USA,2014.0,15,18,-3
AUS,NGA,2020.0,8,9,-1
USA,CMR,2008.0,6,5,1
ITA,IND,1997.0,10,10,0
NOR,POL,2019.0,7,17,-10
COL,CUB,2011.0,2,2,0
GBR,BRN,2013.0,9,1,8
JPN,CHE,2018.0,51,36,15
USA,ISL,2022.0,10,10,0
CAN,THA,2015.0,20,12,8
NZL,TUR,2020.0,4,8,-4
EGY,GBR,2016.0,30,55,-25
SVN,CHE,2016.0,11,3,8
USA,DOM,2012.0,7,3,4
BEL,AUT,2017.0,12,13,-1
CHE,AUT,2011.0,47,55,-8
DNK,FRA,2016.0,49,36,13
KOR,SGP,2015.0,25,27,-2
KOR,EGY,2021.0,15,10,5
ZAF,LKA,2019.0,1,1,0
PRT,ITA,2012.0,16,34,-18
IRQ,IRN,2020.0,23,32,-9
USA,PAK,2023.0,59,127,-68
UKR,DEU,2013.0,24,19,5
NLD,PRT,2017.0,22,32,-10
CHL,COL,2011.0,17,18,-1
ARG,CAN,2014.0,12,20,-8
GBR,PER,2017.0,9,7,2
THA,LAO,2017.0,7,7,0
GBR,NGA,2004.0,23,17,6
UGA,USA,2010.0,17,20,-3
NLD,IND,2014.0,27,33,-6
EGY,JPN,2012.0,21,81,-60
DEU,JOR,2016.0,20,14,6
JPN,HUN,2019.0,4,8,-4
MEX,GBR,2011.0,30,57,-27
USA,RWA,2013.0,8,8,0
MYS,PAK,2012.0,10,31,-21
ITA,KOR,2002.0,4,1,3
DNK,FRA,2022.0,38,39,-1
MYS,LBY,2012.0,8,1,7
KOR,CHE,2011.0,9,5,4
NOR,CAN,2019.0,22,24,-2
GRC,DNK,2012.0,13,1,12
BGR,DEU,2013.0,10,16,-6
OMN,USA,2009.0,7,6,1
BEL,CYP,2021.0,2,2,0
MYS,GBR,2011.0,42,120,-78
CAN,JOR,2015.0,14,9,5
IRN,DNK,2012.0,17,6,11
CHN,NOR,2020.0,37,37,0
PAK,GBR,2014.0,41,79,-38
IRN,SWE,2015.0,27,22,5
FRA,SAU,2020.0,44,12,32
IND,PAK,2015.0,21,32,-11
ETH,CAN,2016.0,4,3,1
NPL,USA,2014.0,20,15,5
CHN,AUT,2010.0,18,12,6
AUS,ESP,2019.0,38,55,-17
NLD,UGA,2013.0,2,2,0
BRA,PRT,2012.0,59,119,-60
ARE,SWE,2020.0,5,7,-2
EGY,LBN,2019.0,8,2,6
NGA,FRA,2011.0,3,2,1
SVK,USA,2021.0,10,5,5
RUS,POL,2020.0,16,14,2
SGP,FRA,2012.0,23,32,-9
ECU,GBR,2014.0,3,5,-2
AUS,UGA,2020.0,1,6,-5
FRA,GRC,2012.0,27,37,-10
NPL,IND,2015.0,27,43,-16
PSE,ISR,2015.0,20,14,6
IRL,JPN,2013.0,16,2,14
DNK,EST,2016.0,3,4,-1
NZL,DNK,2010.0,6,2,4
JPN,ESP,2020.0,23,17,6
ITA,DZA,2014.0,3,1,2
SRB,DEU,2017.0,21,9,12
PRT,ARE,2017.0,3,3,0
CHL,CHN,2018.0,10,6,4
SGP,NLD,2018.0,13,19,-6
CAN,GHA,2016.0,8,2,6
HKG,GHA,2016.0,1,3,-2
SGP,LUX,2021.0,2,1,1
BEL,JPN,2012.0,22,13,9
IND,FRA,2015.0,82,84,-2
IND,QAT,2021.0,12,8,4
HUN,AUT,2023.0,13,16,-3
DEU,JOR,2017.0,18,10,8
IND,TWN,2017.0,69,30,39
AUS,JPN,2019.0,58,69,-11
BEL,CHN,2016.0,60,58,2
IRN,MYS,2015.0,45,129,-84
DEU,HKG,2022.0,17,15,2
BRA,ITA,2015.0,41,68,-27
ITA,EST,2018.0,6,5,1
ITA,BGD,2016.0,10,1,9
AZE,KAZ,2014.0,2,1,1
POL,BEL,2015.0,14,14,0
JOR,CAN,2019.0,7,17,-10
FRA,IND,2020.0,73,101,-28
NLD,ETH,2019.0,12,10,2
ESP,CAN,2017.0,63,60,3
IND,OMN,2017.0,33,13,20
SWE,NOR,2018.0,81,66,15
CUB,ESP,2001.0,35,24,11
EGY,FIN,2014.0,5,1,4
NZL,NOR,2019.0,6,4,2
GBR,BGR,2015.0,12,9,3
SWE,SAU,2023.0,4,5,-1
AUT,FRA,2021.0,32,52,-20
FRA,AUT,2022.0,39,42,-3
MYS,BRN,2021.0,10,4,6
ZAF,KEN,2014.0,21,11,10
KEN,ZAF,2019.0,26,29,-3
COD,COG,2014.0,26,24,2
TUR,KWT,2019.0,9,1,8
USA,GUM,2019.0,12,11,1
ITA,MLT,2019.0,5,6,-1
MYS,AUT,2015.0,2,1,1
NLD,IRL,2012.0,8,12,-4
IRL,NZL,2019.0,9,7,2
SLE,ETH,2020.0,1,1,0
ECU,DEU,2022.0,11,8,3
GBR,LKA,2017.0,17,15,2
USA,UKR,2022.0,14,23,-9
NZL,SWE,2019.0,9,10,-1
NLD,PER,2018.0,3,3,0
ESP,AUS,2008.0,15,16,-1
AUS,ESP,2009.0,18,35,-17
NLD,LUX,2012.0,8,4,4
RUS,AUT,2017.0,14,12,2
ROU,MDA,2021.0,7,4,3
HUN,SWE,2012.0,14,5,9
CAN,CHN,2003.0,75,103,-28
MEX,AUS,2015.0,21,9,12
CHL,DNK,2020.0,8,4,4
POL,DNK,2017.0,13,11,2
IRN,CHN,2015.0,14,10,4
ECU,VEN,2017.0,4,45,-41
NOR,CAN,2021.0,14,34,-20
FJI,CHN,2019.0,1,2,-1
KOR,MNG,2021.0,15,2,13
SGP,CHE,2020.0,26,30,-4
SVN,ESP,2023.0,3,4,-1
MLT,DEU,2018.0,2,4,-2
ROU,GBR,2013.0,20,16,4
BGR,CZE,2011.0,1,2,-1
SAU,AUS,2018.0,32,69,-37
SRB,RUS,2015.0,11,6,5
CHN,ESP,2012.0,20,16,4
PHL,IDN,2009.0,1,1,0
DEU,CHL,2021.0,31,49,-18
TWN,MYS,2016.0,9,7,2
MYS,KOR,2017.0,28,13,15
THA,LAO,2016.0,10,3,7
AUS,DNK,2022.0,36,26,10
CUB,MYS,2018.0,1,1,0
FRA,ECU,2019.0,8,7,1
SRB,IND,2016.0,1,1,0
KAZ,TUR,2016.0,2,17,-15
NGA,CHN,2018.0,17,9,8
ISL,USA,2011.0,10,12,-2
KEN,IND,2021.0,3,8,-5
OMN,USA,2011.0,7,9,-2
IND,IRN,2016.0,26,12,14
CHN,VNM,2015.0,23,4,19
CAN,PHL,2019.0,3,10,-7
VNM,SGP,2014.0,8,5,3
AUS,IND,2012.0,52,82,-30
VNM,AUS,2020.0,56,77,-21
BIH,SRB,2011.0,13,14,-1
GBR,MWI,2014.0,16,14,2
TUR,JPN,1998.0,3,3,0
DEU,BGR,2015.0,10,15,-5
ARM,USA,2017.0,7,6,1
ARM,USA,2022.0,11,8,3
KAZ,USA,2016.0,12,29,-17
IRN,TUR,2014.0,30,7,23
TUR,BEL,2019.0,22,5,17
SWE,NOR,2016.0,87,46,41
USA,KAZ,2016.0,29,12,17
AUS,EGY,2017.0,8,7,1
BEL,CHN,2017.0,64,63,1
USA,IRQ,2014.0,7,8,-1
FIN,BRA,2016.0,11,6,5
IND,JPN,2015.0,92,98,-6
KOR,PAK,2017.0,62,50,12
BGD,MYS,2014.0,41,34,7
BHR,USA,2014.0,3,1,2
AUT,THA,2015.0,10,2,8
ISR,IND,2014.0,21,68,-47
SWE,GRC,2018.0,10,25,-15
UKR,USA,2017.0,25,21,4
DEU,IDN,2016.0,34,7,27
CAN,KEN,2016.0,13,6,7
BGR,GRC,2007.0,3,3,0
ZAF,RWA,2016.0,3,5,-2
SGP,ISR,2020.0,10,4,6
NLD,GHA,2014.0,5,2,3
MEX,GBR,2019.0,72,61,11
TTO,DEU,2014.0,1,1,0
BEL,RUS,2017.0,9,5,4
ROU,DEU,2021.0,22,18,4
CRI,CHE,2020.0,1,6,-5
CHN,THA,2017.0,28,35,-7
ZAF,SGP,2022.0,12,9,3
NOR,TZA,2019.0,4,7,-3
CHN,SWE,2016.0,113,97,16
FRA,PRT,2021.0,51,49,2
NLD,CHE,1998.0,41,31,10
MNP,USA,2020.0,3,2,1
LBN,QAT,2021.0,5,2,3
TUR,MAR,2022.0,1,3,-2
IRN,ITA,2011.0,13,10,3
USA,ECU,2017.0,34,21,13
IRN,ESP,2015.0,16,7,9
TUR,NZL,2018.0,5,1,4
KAZ,RUS,2020.0,49,56,-7
ECU,COL,2017.0,6,10,-4
SGP,DEU,2020.0,38,36,2
SWE,TUR,2022.0,13,20,-7
GBR,JOR,2022.0,41,20,21
FIN,ETH,2019.0,2,1,1
AUT,CHN,2000.0,4,6,-2
USA,IRN,2013.0,78,411,-333
URY,USA,2019.0,11,14,-3
CHN,SAU,2011.0,25,3,22
SAU,CHN,2020.0,53,67,-14
JPN,MEX,2014.0,8,8,0
IND,OMN,2022.0,29,15,14
PAK,DEU,2020.0,42,34,8
ESP,SVN,2020.0,5,7,-2
KEN,AUS,2010.0,7,2,5
COL,RUS,2019.0,1,2,-1
THA,MYS,2013.0,7,5,2
LTU,FRA,2021.0,3,5,-2
MYS,OMN,2008.0,2,1,1
KHM,GBR,2020.0,6,4,2
CZE,TUR,2017.0,3,6,-3
CUB,CHL,2018.0,19,1,18
NZL,FRA,2021.0,12,17,-5
IRL,ITA,2018.0,22,55,-33
SVK,GBR,2021.0,5,6,-1
NOR,GHA,2019.0,5,2,3
NZL,ITA,2017.0,2,10,-8
ITA,CUB,2013.0,4,3,1
RUS,CHE,2004.0,22,15,7
SYR,DEU,2023.0,4,2,2
ZAF,CAN,2017.0,31,29,2
IDN,NLD,2023.0,15,22,-7
DNK,IND,2015.0,7,16,-9
EST,GBR,2022.0,11,14,-3
NOR,ARG,2017.0,4,1,3
DEU,FIN,2022.0,59,51,8
NLD,IRQ,2021.0,2,2,0
IDN,USA,2012.0,12,26,-14
FIN,CZE,2020.0,9,3,6
ITA,HKG,2018.0,6,4,2
AUS,NOR,2020.0,23,19,4
PHL,TWN,2018.0,7,5,2
DEU,JOR,2018.0,10,10,0
ITA,LUX,2018.0,17,2,15
ESP,TUR,2021.0,14,22,-8
AUS,IRN,2020.0,48,201,-153
NLD,KAZ,2021.0,1,1,0
MEX,URY,2019.0,4,4,0
HKG,DEU,2014.0,10,11,-1
SGP,ITA,2020.0,10,5,5
SVK,DEU,2021.0,13,10,3
THA,AUT,2023.0,1,5,-4
RUS,BEL,2017.0,5,9,-4
BEL,NGA,2017.0,2,2,0
JOR,AUS,2018.0,7,12,-5
CAN,CZE,2021.0,10,4,6
NLD,DNK,2020.0,59,39,20
ISL,GBR,2000.0,9,5,4
VNM,JPN,1998.0,2,2,0
CAN,IRL,2005.0,16,22,-6
USA,KWT,1999.0,16,4,12
FRA,SYR,2002.0,5,1,4
RWA,TZA,2021.0,1,1,0
CZE,NLD,2019.0,9,14,-5
ITA,TWN,2020.0,4,3,1
FRA,AGO,2018.0,2,2,0
CHE,CRI,2020.0,6,1,5
SWE,MEX,2023.0,8,4,4
TZA,CHE,2021.0,8,10,-2
NZL,CZE,2022.0,4,2,2
ETH,NLD,2019.0,10,12,-2
TUN,GBR,2017.0,4,1,3
RUS,NLD,2018.0,21,11,10
ISR,FRA,2020.0,30,38,-8
ITA,NOR,2003.0,10,11,-1
ESP,MAR,2012.0,12,9,3
SWE,NLD,1999.0,24,16,8
EGY,JPN,1997.0,4,7,-3
BRA,ITA,2001.0,18,25,-7
USA,BGR,2004.0,18,13,5
CHL,ESP,1997.0,8,12,-4
HUN,NLD,1997.0,6,7,-1
GBR,ISR,2005.0,37,43,-6
AUS,NOR,2007.0,11,11,0
CAN,BRA,1997.0,23,15,8
BEL,IND,2012.0,14,30,-16
DEU,ROU,2006.0,27,31,-4
SRB,CAN,2001.0,6,3,3
KOR,ESP,2003.0,2,2,0
GBR,POL,2001.0,31,42,-11
DEU,PRT,1998.0,13,12,1
CZE,PAK,2016.0,3,3,0
UKR,BLR,2010.0,6,2,4
GBR,OMN,2009.0,9,6,3
IND,BRA,1998.0,5,2,3
USA,ARG,1999.0,83,137,-54
BEL,TUR,2001.0,5,2,3
CHE,DNK,2007.0,23,12,11
AUS,ARE,2008.0,15,3,12
DNK,NLD,2008.0,21,21,0
GBR,CHL,2005.0,16,9,7
NLD,RUS,2017.0,18,16,2
FRA,TUR,2006.0,13,10,3
SWE,NLD,2007.0,41,28,13
DEU,ARG,2004.0,13,19,-6
ROU,FRA,2023.0,15,15,0
ISR,POL,2007.0,1,1,0
FRA,PYF,2007.0,7,9,-2
GRC,NLD,2013.0,24,8,16
AUS,LKA,2008.0,9,5,4
GRC,FRA,2008.0,25,24,1
JPN,BGD,2010.0,54,49,5
GRC,FRA,2001.0,19,26,-7
ITA,CZE,2000.0,7,5,2
AUT,BRA,2007.0,2,2,0
SWE,DEU,1997.0,41,63,-22
QAT,GBR,2016.0,17,47,-30
ITA,TUN,2012.0,4,2,2
GRC,NLD,2003.0,14,11,3
KEN,FRA,2002.0,2,1,1
BRA,VEN,1998.0,3,1,2
JPN,ZAF,2000.0,4,2,2
TJK,RUS,2000.0,2,1,1
ITA,FIN,2000.0,10,7,3
GBR,SRB,2022.0,11,9,2
FRA,CIV,2006.0,18,19,-1
SAU,EGY,2000.0,30,24,6
RUS,KAZ,2003.0,4,8,-4
GIN,FRA,1997.0,4,1,3
CZE,ISR,1998.0,1,1,0
ESP,KOR,1999.0,3,1,2
USA,COG,2003.0,3,1,2
FIN,NLD,2019.0,20,21,-1
USA,LBN,2013.0,59,71,-12
CAN,ARG,1998.0,11,4,7
BEL,THA,2023.0,2,1,1
ESP,CZE,2005.0,4,4,0
MKD,BGR,2020.0,1,1,0
CAN,KWT,2011.0,13,1,12
AUT,DNK,2008.0,9,3,6
SEN,CHE,2014.0,2,1,1
ROU,FRA,2010.0,34,36,-2
JPN,IDN,2004.0,29,4,25
CZE,SWE,2003.0,5,3,2
POL,AUT,1997.0,3,8,-5
CHL,ARG,2000.0,4,3,1
BEL,LUX,2003.0,11,2,9
UGA,GBR,2002.0,6,11,-5
MCO,FRA,2008.0,3,13,-10
GBR,CHN,2000.0,75,95,-20
ETH,DEU,2007.0,7,7,0
USA,GEO,2009.0,46,46,0
SYR,USA,1999.0,3,1,2
HUN,SWE,2005.0,10,2,8
SWE,THA,2008.0,7,4,3
ESP,BEL,2005.0,27,28,-1
ESP,UKR,1997.0,2,3,-1
FRA,GRC,1997.0,16,15,1
UGA,SWE,2010.0,4,1,3
NLD,KEN,2004.0,6,6,0
KEN,ETH,2010.0,4,3,1
POL,PRT,2002.0,7,1,6
PRT,ESP,2000.0,16,22,-6
ZAF,ZWE,2004.0,4,11,-7
JOR,EGY,2004.0,4,2,2
AUS,FLK,2010.0,2,1,1
FRA,BEN,2007.0,9,2,7
ITA,ESP,1998.0,65,39,26
BEL,IND,2005.0,6,9,-3
PRT,SWE,2003.0,7,6,1
FRA,BLR,2012.0,2,2,0
USA,QAT,2008.0,23,3,20
JPN,BRA,2015.0,12,11,1
AUT,GBR,2023.0,40,69,-29
NLD,FRA,1999.0,41,79,-38
PRT,ESP,2006.0,32,40,-8
SGP,IDN,2016.0,11,6,5
ESP,COL,1999.0,8,4,4
FRA,ARM,2000.0,2,2,0
GBR,CHL,2002.0,13,9,4
NLD,UKR,2002.0,1,6,-5
MDA,FRA,2001.0,1,1,0
DNK,HUN,2014.0,1,4,-3
BEL,POL,2001.0,8,16,-8
MYS,JPN,2004.0,9,17,-8
CAN,MAR,2004.0,7,8,-1
IRN,USA,1997.0,9,5,4
DNK,IRL,2011.0,11,4,7
PHL,USA,1997.0,12,7,5
JPN,NZL,2003.0,11,12,-1
HKG,AUS,1999.0,19,30,-11
AUS,HKG,2000.0,39,24,15
JPN,FRA,2005.0,74,78,-4
AUT,GBR,2000.0,34,28,6
DEU,GRC,2009.0,45,54,-9
FRA,MEX,2007.0,50,35,15
BRA,ARG,2007.0,25,26,-1
BGR,FRA,2002.0,10,10,0
GRC,ITA,2015.0,45,30,15
RUS,CHE,2008.0,26,18,8
BLZ,BRA,2011.0,2,2,0
SVK,SVN,2003.0,13,6,7
CHN,THA,2016.0,12,25,-13
UKR,BEL,2020.0,3,3,0
PHL,BRN,2020.0,1,1,0
BRA,CUB,2006.0,4,8,-4
FRA,SWE,1999.0,46,35,11
DNK,AUT,2002.0,7,6,1
BGR,ITA,2006.0,10,6,4
ESP,SRB,1998.0,6,3,3
NPL,USA,2001.0,10,3,7
QAT,GRC,2019.0,5,2,3
ZAF,JPN,1998.0,1,4,-3
TWN,IND,2013.0,34,41,-7
CAN,BGR,1997.0,7,3,4
HUN,SRB,2009.0,1,1,0
CAN,IND,2013.0,96,130,-34
DEU,LUX,2009.0,18,11,7
PRT,BGR,1999.0,2,1,1
HKG,CAN,1997.0,10,25,-15
DEU,EGY,1997.0,9,7,2
DEU,GEO,2004.0,3,4,-1
DNK,ESP,2007.0,18,17,1
VEN,CAN,2000.0,3,2,1
CAN,ITA,2009.0,49,59,-10
JPN,NPL,2004.0,3,3,0
SRB,ISR,2003.0,1,1,0
CHN,IND,2002.0,3,6,-3
AUT,CHE,2021.0,81,94,-13
OMN,DEU,2003.0,1,1,0
RUS,UZB,2005.0,6,10,-4
TUN,FRA,1998.0,26,42,-16
PRT,NOR,2009.0,2,1,1
REU,FRA,2020.0,17,31,-14
AUS,SGP,2012.0,62,74,-12
ARG,BRA,1999.0,24,16,8
USA,GHA,2008.0,12,8,4
AUS,TWN,2001.0,7,8,-1
TWN,AUS,2002.0,6,15,-9
PHL,PNG,2015.0,1,1,0
CHE,DNK,1999.0,11,9,2
NAM,AUS,2011.0,3,1,2
CHE,ESP,1999.0,22,23,-1
UKR,BEL,1998.0,1,2,-1
BMU,GBR,2002.0,1,3,-2
BWA,ZAF,2014.0,9,6,3
GBR,ARE,1998.0,5,4,1
IRL,DEU,1997.0,6,4,2
SVK,JPN,1998.0,4,2,2
RUS,AZE,1997.0,9,7,2
UKR,ITA,1998.0,2,3,-1
NLD,CZE,2000.0,8,2,6
CAN,CHL,1999.0,5,3,2
FIN,SGP,2011.0,6,1,5
USA,BWA,2015.0,17,18,-1
PRT,GBR,2005.0,34,45,-11
AUT,SVK,2002.0,9,10,-1
SWE,HUN,1997.0,5,8,-3
MDA,USA,2001.0,4,2,2
MWI,GBR,2008.0,14,9,5
IND,ITA,1998.0,13,13,0
FRA,EGY,1999.0,5,3,2
KOR,ISR,2006.0,3,1,2
AUS,NPL,2017.0,9,16,-7
AUS,HKG,2010.0,39,46,-7
SAU,NGA,2020.0,4,7,-3
ESP,NOR,1999.0,7,8,-1
AUS,POL,2013.0,8,12,-4
VEN,PRT,2009.0,2,2,0
ARE,GBR,1997.0,6,7,-1
SGP,DEU,1999.0,5,16,-11
NLD,UKR,1997.0,7,2,5
JPN,SVK,2001.0,6,8,-2
JPN,EGY,2007.0,37,20,17
FRA,GRC,2005.0,31,13,18
BRA,ITA,2004.0,24,23,1
ZAF,RUS,2008.0,4,2,2
TUR,CHE,2002.0,6,4,2
BEL,POL,2004.0,8,13,-5
FRA,KEN,2022.0,3,5,-2
IRQ,USA,2009.0,5,3,2
CAN,JOR,2001.0,5,3,2
NGA,DEU,1997.0,3,2,1
ITA,NZL,2013.0,14,4,10
AUT,DNK,2001.0,3,4,-1
SVK,SWE,2009.0,3,1,2
USA,COD,2019.0,8,5,3
MEX,CUB,2017.0,12,27,-15
BEL,ZMB,2019.0,1,1,0
AUS,SWE,2019.0,62,48,14
FRA,CRI,2023.0,2,4,-2
COL,BEL,2019.0,4,8,-4
ZAF,MYS,2020.0,3,3,0
BRA,MOZ,2020.0,12,5,7
SWE,PRT,2016.0,6,12,-6
HUN,DNK,2018.0,8,6,2
EGY,JOR,2019.0,5,6,-1
GBR,UKR,2004.0,16,13,3
CHN,HUN,2019.0,8,6,2
BEL,GAB,2020.0,2,1,1
BEL,AUT,2022.0,17,21,-4
USA,ARM,2002.0,5,9,-4
GRC,SAU,2019.0,8,3,5
SWE,RUS,2016.0,22,15,7
BEL,TUN,2020.0,6,9,-3
VNM,AUT,2019.0,2,6,-4
ESP,CUB,2005.0,21,28,-7
ITA,BGD,2022.0,5,7,-2
THA,HKG,2021.0,6,8,-2
KWT,TUR,2020.0,3,8,-5
GEO,FRA,2016.0,10,16,-6
KOR,BEL,2022.0,23,7,16
IRN,PAK,2019.0,4,2,2
JPN,PAK,2020.0,11,3,8
KOR,NLD,2020.0,18,6,12
SVK,GBR,2019.0,5,6,-1
ETH,IND,2020.0,34,98,-64
IRN,ROU,2014.0,2,2,0
SAU,SDN,2012.0,4,15,-11
BGD,IND,2023.0,21,17,4
PRT,MOZ,2019.0,4,4,0
PRT,MOZ,2021.0,2,4,-2
PAK,IND,2018.0,26,37,-11
GRC,CYP,2019.0,60,26,34
LUX,FRA,2020.0,19,30,-11
MEX,BRA,2021.0,27,36,-9
TUR,CAN,2023.0,31,11,20
DEU,PRT,2020.0,41,52,-11
AUS,EGY,2022.0,11,15,-4
USA,UKR,2018.0,17,29,-12
SWE,NZL,2020.0,7,14,-7
TUR,JPN,2020.0,9,11,-2
UGA,USA,2023.0,32,15,17
PAK,NZL,2020.0,8,11,-3
GRC,SGP,2019.0,1,2,-1
NZL,NOR,2021.0,6,1,5
ECU,COL,2022.0,8,10,-2
GRC,SWE,2016.0,27,6,21
AUS,EGY,2016.0,3,12,-9
ITA,SGP,2022.0,9,7,2
ZAF,HKG,2019.0,3,4,-1
POL,IRL,2014.0,5,3,2
SEN,DEU,2018.0,2,2,0
IND,ARE,2016.0,44,18,26
ISL,USA,2021.0,15,18,-3
USA,AFG,2019.0,18,14,4
SGP,ARE,2021.0,9,1,8
LUX,IRL,2021.0,2,4,-2
IRQ,GBR,2015.0,17,35,-18
PYF,FRA,2020.0,16,16,0
IND,TTO,2023.0,2,1,1
SVN,HRV,2020.0,13,13,0
HKG,EGY,2022.0,3,3,0
GEO,NLD,2018.0,2,1,1
UKR,CHE,2021.0,9,3,6
PRT,IND,2010.0,5,20,-15
ALB,SRB,2017.0,9,3,6
BWA,ZAF,2015.0,12,15,-3
FRA,SRB,2016.0,8,8,0
PHL,IDN,2021.0,7,5,2
POL,CAN,2021.0,14,13,1
MTQ,FRA,2018.0,40,24,16
CAN,EGY,2020.0,50,47,3
FRA,SAU,1998.0,4,1,3
NLD,TUR,2018.0,16,30,-14
HUN,ROU,2021.0,13,18,-5
MYS,SDN,2021.0,12,5,7
IND,CHE,2022.0,47,41,6
ZAF,FRA,2017.0,18,25,-7
ITA,AUS,2016.0,63,48,15
VNM,BEL,2022.0,6,9,-3
SGP,MYS,2023.0,12,19,-7
GRC,BRA,2021.0,4,2,2
ESP,POL,2023.0,15,23,-8
MAR,IND,2021.0,3,4,-1
BGD,IRL,2023.0,4,1,3
DEU,GHA,2012.0,6,3,3
JPN,BGD,2023.0,44,41,3
HUN,ECU,2021.0,1,2,-1
PAK,ARE,2019.0,21,15,6
SWE,RUS,2018.0,15,30,-15
LKA,CAN,2022.0,7,4,3
CAN,KOR,2023.0,29,44,-15
GRC,CYP,2011.0,34,9,25
DNK,JPN,2020.0,9,12,-3
IRL,AUT,2022.0,6,6,0
MEX,KOR,2017.0,3,4,-1
KAZ,USA,2018.0,16,13,3
CZE,POL,2023.0,16,7,9
TUR,PAK,2019.0,24,13,11
CHL,NLD,2012.0,4,6,-2
KOR,SWE,2015.0,13,10,3
USA,JOR,2022.0,39,54,-15
PAN,BRA,2021.0,3,11,-8
SAU,ZAF,2022.0,5,5,0
CZE,SWE,2013.0,8,9,-1
ETH,CAN,2018.0,5,4,1
ROU,BEL,2015.0,12,7,5
POL,BEL,2014.0,11,11,0
ARG,DEU,2016.0,21,25,-4
KEN,RWA,2021.0,6,5,1
MLI,GIN,2014.0,2,1,1
LTU,DEU,2005.0,5,9,-4
DEU,CYP,2014.0,2,1,1
IND,SAU,1999.0,7,4,3
AUT,CZE,2016.0,13,14,-1
AUS,BGD,1999.0,1,4,-3
BTN,AUS,2020.0,7,2,5
CHE,TZA,2021.0,10,8,2
IRQ,MYS,2023.0,19,52,-33
VNM,USA,2019.0,24,56,-32
BGD,PAK,2010.0,9,2,7
JAM,USA,2014.0,9,10,-1
NLD,NZL,2020.0,13,21,-8
BFA,ZAF,2015.0,4,2,2
HKG,SGP,2019.0,38,41,-3
DEU,HKG,2017.0,13,15,-2
BGD,SAU,2017.0,3,5,-2
SAU,BGD,2021.0,14,13,1
BRN,BGD,2014.0,3,5,-2
AUS,IND,1997.0,14,13,1
NLD,SAU,2016.0,11,2,9
GBR,BWA,2021.0,8,4,4
KOR,ZAF,2018.0,5,5,0
USA,UGA,2018.0,41,37,4
BGD,KOR,2013.0,13,30,-17
KOR,FIN,2014.0,5,3,2
DEU,TZA,2007.0,3,2,1
JPN,CZE,2020.0,10,5,5
SVK,POL,2021.0,9,10,-1
NGA,FRA,2021.0,4,4,0
QAT,JOR,2020.0,6,16,-10
SEN,BFA,2021.0,6,1,5
PHL,BGD,2018.0,3,1,2
ETH,IRL,2019.0,1,1,0
FRA,KEN,2018.0,7,4,3
BEL,RUS,2016.0,10,13,-3
HUN,AUT,2000.0,12,9,3
GBR,NPL,2019.0,11,6,5
SWE,PRT,2018.0,8,23,-15
KEN,USA,1997.0,12,18,-6
CRI,COL,2016.0,2,3,-1
GRC,BEL,2023.0,13,9,4
IND,VCT,2015.0,1,1,0
HUN,IND,2019.0,4,10,-6
MYS,QAT,2019.0,10,5,5
ESP,GRC,2021.0,17,18,-1
FRA,SGP,2005.0,7,4,3
RUS,ESP,1998.0,8,16,-8
DEU,BLR,1997.0,10,8,2
COL,VEN,2017.0,20,47,-27
HUN,KAZ,2020.0,2,1,1
KEN,TZA,2022.0,4,6,-2
UZB,IND,2023.0,2,1,1
MYS,JOR,2015.0,18,8,10
GBR,SVN,2020.0,13,7,6
IRL,SWE,1998.0,4,1,3
POL,DNK,2018.0,8,6,2
NGA,COG,2022.0,4,1,3
TUN,ITA,2021.0,17,14,3
TUN,USA,2022.0,9,5,4
JPN,IRL,2020.0,13,7,6
NOR,FRA,2011.0,17,31,-14
JOR,PSE,2023.0,4,3,1
AUS,VNM,2002.0,9,3,6
JPN,PAK,2007.0,12,11,1
GBR,BGD,2023.0,11,21,-10
NOR,JPN,2001.0,5,3,2
JPN,OMN,2014.0,2,1,1
DNK,EST,2022.0,1,2,-1
BRA,PRI,2000.0,4,2,2
ARG,ECU,2011.0,3,1,2
GBR,ECU,2015.0,5,3,2
RUS,TWN,2020.0,4,5,-1
VEN,PRI,2005.0,2,1,1
ESP,NOR,1998.0,4,2,2
DEU,BLR,2002.0,12,23,-11
SWE,POL,2001.0,20,17,3
CHE,NLD,2006.0,47,56,-9
HKG,AUS,1998.0,24,27,-3
AUS,FJI,2009.0,2,8,-6
NLD,IRL,1997.0,11,6,5
NZL,FIN,2007.0,3,1,2
FIN,NZL,2010.0,3,4,-1
RUS,IND,2000.0,7,1,6
CAN,MYS,2013.0,13,23,-10
BLR,DEU,2004.0,8,8,0
USA,SRB,2018.0,9,34,-25
ZAF,FIN,2023.0,3,1,2
KWT,SVK,2003.0,2,1,1
FRA,MDG,2005.0,7,6,1
AUT,SVK,2012.0,6,8,-2
NPL,AUS,2005.0,1,1,0
MEX,PER,2020.0,11,11,0
AUS,ARG,1998.0,3,3,0
CHN,LKA,2016.0,5,3,2
USA,HTI,2006.0,12,1,11
NLD,BRA,2005.0,25,13,12
MYS,USA,2002.0,23,19,4
ZAF,AUS,2000.0,22,17,5
DEU,UKR,2005.0,17,40,-23
BRA,ESP,2002.0,36,37,-1
CAN,BEL,2001.0,39,28,11
AUT,CAN,2014.0,23,29,-6
USA,BGD,2004.0,12,11,1
NOR,BRA,2007.0,1,1,0
IND,THA,2002.0,3,7,-4
CHL,BRA,2003.0,4,7,-3
FIN,ESP,2009.0,11,9,2
AUT,DNK,2004.0,7,4,3
RUS,FIN,2009.0,21,8,13
MEX,JPN,2016.0,7,10,-3
ARG,CUB,2006.0,4,2,2
CMR,FRA,2003.0,6,21,-15
SVK,ESP,2000.0,6,1,5
KOR,BEL,2016.0,9,7,2
KOR,BEL,2018.0,11,8,3
SRB,GBR,2001.0,8,9,-1
PRT,ROU,2011.0,2,4,-2
MEX,ARG,2007.0,12,7,5
SWE,CHE,2004.0,31,23,8
BEL,SGP,2012.0,5,1,4
SVN,ITA,1997.0,2,4,-2
CAN,DNK,2010.0,22,19,3
ROU,AUS,1997.0,1,2,-1
CHN,BEL,2003.0,14,12,2
FIN,HRV,2001.0,1,1,0
MEX,CHL,1998.0,2,3,-1
JPN,HKG,2012.0,9,14,-5
FIN,PHL,2001.0,1,1,0
AUS,PNG,2004.0,5,4,1
CUB,FRA,2019.0,4,1,3
CHE,MEX,2004.0,3,3,0
GBR,HKG,1998.0,45,30,15
PRI,USA,1999.0,46,50,-4
RUS,CHL,2011.0,3,3,0
AUS,BRB,2013.0,1,1,0
AUT,SAU,2002.0,2,1,1
POL,CHE,2008.0,14,12,2
HUN,EGY,2002.0,4,2,2
ARE,USA,2014.0,30,95,-65
DNK,NLD,2014.0,23,37,-14
JPN,FIN,2009.0,13,11,2
SAU,JOR,2002.0,2,1,1
ARG,COL,2007.0,4,3,1
IRL,BRA,2014.0,6,6,0
POL,BEL,2001.0,16,8,8
CHE,CZE,1999.0,7,7,0
JPN,CZE,2007.0,6,8,-2
VEN,ITA,2003.0,1,3,-2
KWT,IND,1997.0,2,4,-2
SWE,POL,2004.0,7,21,-14
USA,GHA,2015.0,39,22,17
AUT,ITA,1997.0,8,7,1
POL,COL,2022.0,3,2,1
OMN,ARE,2015.0,3,1,2
EGY,FRA,2012.0,8,29,-21
ARG,ESP,2015.0,85,130,-45
SVK,AUT,2019.0,11,10,1
POL,AUS,2021.0,13,10,3
PRT,CHE,1999.0,5,4,1
CHE,PRT,2003.0,5,5,0
BRA,CHL,2003.0,7,4,3
BRA,CUB,2010.0,11,7,4
PNG,AUS,2000.0,9,8,1
CAN,CZE,2009.0,10,12,-2
FIN,CHN,1998.0,3,3,0
NOR,DNK,2007.0,23,20,3
SAU,EGY,2010.0,78,227,-149
USA,VEN,2004.0,38,46,-8
ESP,CZE,1997.0,2,2,0
GBR,HUN,2014.0,30,46,-16
POL,UKR,2001.0,13,17,-4
AUS,POL,2003.0,7,2,5
USA,CUB,2001.0,6,11,-5
SRB,HUN,2000.0,2,2,0
IDN,USA,2005.0,16,16,0
KWT,IND,2002.0,10,4,6
HUN,SWE,2002.0,6,5,1
CHN,AUS,2007.0,89,59,30
NOR,ITA,2004.0,7,6,1
EST,FRA,1997.0,3,2,1
AUT,AUS,2007.0,33,30,3
CHN,CHL,2014.0,7,5,2
AUS,CHE,2006.0,37,45,-8
CAN,ESP,2003.0,24,20,4
RUS,GRC,2005.0,2,2,0
DEU,SRB,2001.0,8,22,-14
ITA,CHN,2003.0,17,11,6
NLD,UKR,2005.0,1,6,-5
BGR,JPN,2001.0,8,11,-3
MNE,SRB,2005.0,3,8,-5
DEU,IND,2005.0,66,94,-28
BEL,THA,2000.0,2,3,-1
BRA,ITA,2008.0,30,47,-17
USA,IDN,2002.0,14,24,-10
DEU,SRB,2015.0,15,14,1
GBR,GHA,2015.0,33,10,23
CHL,PER,2009.0,1,2,-1
NLD,GBR,2024.0,5,2,3
ARE,DEU,2000.0,1,1,0
SRB,VEN,2002.0,3,1,2
RUS,AZE,2002.0,5,1,4
AUS,LKA,2004.0,5,3,2
HUN,ROU,2009.0,12,5,7
MAR,USA,1998.0,2,4,-2
EGY,FRA,1997.0,3,2,1
FRA,EGY,1998.0,7,2,5
USA,NGA,1997.0,12,13,-1
AFG,JPN,2021.0,6,2,4
NGA,GHA,2021.0,8,11,-3
ARG,JPN,1999.0,5,3,2
PRT,ITA,2002.0,8,7,1
BRA,BEL,2002.0,6,15,-9
PAK,USA,1999.0,17,21,-4
CAN,CUB,2009.0,2,8,-6
IRL,POL,2017.0,6,6,0
MEX,UKR,1999.0,2,4,-2
NOR,AUS,2003.0,6,10,-4
CAN,ARE,2004.0,10,5,5
CHE,BGR,2004.0,3,4,-1
ITA,SWE,2020.0,67,53,14
OMN,AUS,2003.0,2,1,1
ITA,NZL,2003.0,4,4,0
OMN,JOR,2003.0,2,2,0
IND,CAN,1997.0,24,24,0
TUR,IRL,2008.0,3,4,-1
COL,FRA,2001.0,3,10,-7
BHR,SAU,2009.0,2,1,1
UKR,CHE,2009.0,2,3,-1
POL,DNK,2022.0,9,1,8
ROU,HUN,2014.0,13,5,8
THA,BEL,2015.0,4,4,0
SRB,SVN,2011.0,5,11,-6
RUS,BEL,2016.0,13,10,3
AUS,BRA,2008.0,5,25,-20
AUT,CAN,2015.0,16,30,-14
HKG,NLD,2010.0,6,3,3
CAN,IRQ,2015.0,1,1,0
ESP,IND,2013.0,16,23,-7
IDN,FRA,2018.0,10,19,-9
AUT,IRN,2017.0,7,13,-6
KOR,ARE,2018.0,14,4,10
USA,ISL,2017.0,15,6,9
PRT,BEL,2021.0,24,23,1
CAN,MEX,2003.0,16,25,-9
JPN,FIN,2011.0,13,14,-1
HUN,ROU,2011.0,6,9,-3
GBR,CHL,2012.0,26,21,5
FRA,SVN,2022.0,3,9,-6
SWE,PRT,2017.0,5,22,-17
ITA,ARM,2016.0,2,2,0
ETH,DEU,2020.0,17,17,0
JOR,SAU,2023.0,13,24,-11
RWA,KEN,2019.0,5,10,-5
FIN,BRA,2017.0,7,8,-1
AUT,NLD,2016.0,20,23,-3
JPN,TUR,2010.0,11,6,5
SEN,FRA,2012.0,27,52,-25
FRA,KEN,2016.0,9,9,0
THA,CHN,2019.0,33,34,-1
PHL,KOR,2009.0,2,3,-1
TWN,ESP,2016.0,3,5,-2
SGP,POL,2015.0,4,1,3
JPN,PRT,2020.0,5,3,2
ITA,ISR,2013.0,15,7,8
AUT,IRN,2018.0,13,16,-3
CAN,THA,2014.0,18,10,8
USA,BRB,2014.0,4,4,0
SWZ,ZAF,2018.0,6,5,1
POL,FRA,2012.0,23,36,-13
KEN,UGA,2015.0,5,9,-4
COD,COG,2015.0,31,40,-9
FRA,CHL,2011.0,27,28,-1
IND,IRL,2016.0,24,13,11
SGP,KOR,2013.0,23,24,-1
NGA,USA,2008.0,26,16,10
URY,USA,2011.0,9,16,-7
CYP,USA,2009.0,5,24,-19
AUS,DNK,2017.0,34,34,0
IRL,POL,2018.0,3,5,-2
CHE,HKG,2016.0,7,9,-2
GBR,HKG,2020.0,86,82,4
CAN,GHA,2018.0,6,3,3
TUR,BEL,2011.0,10,7,3
KOR,MNG,2011.0,2,2,0
KEN,CHN,2023.0,6,6,0
USA,KWT,1998.0,6,12,-6
SAU,RUS,2016.0,2,5,-3
BRA,NLD,2011.0,18,11,7
BEL,IRL,2009.0,4,7,-3
IDN,SGP,2011.0,5,4,1
ROU,ITA,2019.0,9,20,-11
JPN,LTU,2011.0,1,2,-1
AUT,POL,2017.0,9,7,2
ITA,POL,1999.0,14,20,-6
ECU,COL,2018.0,6,11,-5
IDN,SGP,2009.0,1,1,0
MEX,NLD,2020.0,14,8,6
CZE,BGR,2011.0,2,1,1
CHE,RUS,2010.0,17,25,-8
CAN,GRC,2013.0,5,15,-10
GRC,CAN,2014.0,18,9,9
HUN,PRT,2012.0,2,3,-1
CHN,AUS,1998.0,32,22,10
TWN,GBR,2018.0,30,37,-7
GBR,VNM,2013.0,18,26,-8
EGY,CZE,2012.0,2,3,-1
BOL,DEU,2011.0,4,1,3
SYR,RUS,2021.0,5,3,2
ARG,URY,2023.0,4,3,1
IND,CZE,2013.0,15,3,12
NLD,TWN,2015.0,4,6,-2
GHA,GBR,2012.0,8,19,-11
NGA,ZAF,2012.0,38,28,10
SYR,FRA,2006.0,6,6,0
AUS,AUT,2013.0,26,58,-32
ZAF,CHN,2013.0,6,6,0
OMN,QAT,2015.0,2,2,0
BEL,AUT,2016.0,19,8,11
AUT,POL,2018.0,11,7,4
BRA,ISR,2013.0,1,2,-1
THA,SWE,2012.0,4,7,-3
TUR,CYP,2013.0,50,23,27
LTU,SWE,2013.0,5,5,0
CZE,ITA,2014.0,6,17,-11
VNM,KOR,2014.0,18,52,-34
NOR,ITA,2014.0,11,18,-7
ZAF,BGR,2019.0,1,1,0
USA,PAN,2008.0,20,16,4
PHL,AUS,2013.0,8,11,-3
VEN,COL,2010.0,17,2,15
MKD,SRB,2007.0,25,20,5
CYP,GRC,2019.0,26,60,-34
NZL,CZE,2018.0,2,1,1
BGR,ESP,2018.0,2,2,0
AFG,JPN,2019.0,3,6,-3
SRB,SVN,2021.0,8,3,5
MAR,PRT,2017.0,2,2,0
IND,CHN,2006.0,20,5,15
DEU,HUN,2011.0,30,49,-19
SWE,KEN,2016.0,6,3,3
TUR,QAT,2019.0,5,4,1
GIN,CHE,2015.0,1,1,0
SGP,DNK,2021.0,6,2,4
CAN,COL,2018.0,14,19,-5
SAU,MYS,2018.0,31,87,-56
SAU,DZA,2014.0,2,3,-1
SAU,RUS,2018.0,2,3,-1
IRN,ZAF,2013.0,8,1,7
ZAF,IRN,2020.0,4,11,-7
TWN,RUS,2015.0,2,1,1
RUS,KAZ,2013.0,30,9,21
ARE,DEU,2023.0,3,8,-5
MDA,RUS,2014.0,4,4,0
ZAF,SWE,2014.0,8,12,-4
RUS,HKG,2018.0,5,1,4
HUN,AUT,2006.0,12,8,4
SGP,SWE,2014.0,6,11,-5
DEU,TUR,2021.0,42,129,-87
PRT,CPV,2023.0,2,1,1
EGY,QAT,2008.0,1,1,0
NOR,HKG,2020.0,4,2,2
ARM,USA,2018.0,9,9,0
ESP,ISL,2020.0,3,1,2
KAZ,TUR,2018.0,11,5,6
MNG,JPN,2021.0,3,20,-17
IND,HKG,2020.0,17,12,5
IRN,JPN,2014.0,10,13,-3
EST,NOR,2021.0,3,6,-3
CHE,TUR,2010.0,27,12,15
CRI,COL,2018.0,4,1,3
NGA,BWA,2021.0,3,2,1
FJI,AUS,2023.0,3,6,-3
NZL,AUT,2017.0,5,4,1
SVN,RUS,2016.0,3,2,1
PHL,CAN,2018.0,5,5,0
BRN,JPN,2020.0,3,1,2
BEL,HRV,2017.0,4,4,0
ETH,NLD,2021.0,6,12,-6
BRA,POL,2023.0,9,8,1
AUT,TWN,2023.0,2,2,0
ESP,JPN,2013.0,14,19,-5
BEL,ESP,2013.0,38,67,-29
USA,TZA,2019.0,20,24,-4
GBR,SEN,2019.0,2,1,1
SRB,MNE,2016.0,15,8,7
IRL,AUT,2017.0,4,2,2
USA,HRV,2022.0,11,10,1
ZAF,SDN,2020.0,6,5,1
SWE,TZA,2023.0,5,7,-2
PRT,CHN,2009.0,9,9,0
DNK,ROU,2011.0,3,3,0
FRA,DJI,2016.0,4,1,3
IRN,NOR,2020.0,32,4,28
IRL,AUS,2021.0,35,40,-5
CZE,FRA,2018.0,23,29,-6
PRT,IRN,2020.0,8,18,-10
GHA,AUS,2021.0,17,16,1
MYS,CAN,2018.0,34,12,22
POL,ESP,2013.0,12,19,-7
ISR,ZAF,2013.0,3,1,2
SRB,GRC,2019.0,3,4,-1
SAU,GBR,2011.0,16,86,-70
PER,KEN,2020.0,5,1,4
NGA,SAU,2020.0,7,4,3
MWI,NOR,2019.0,1,3,-2
CZE,RUS,2020.0,7,21,-14
PAK,IRN,2021.0,1,2,-1
QAT,CAN,2020.0,14,17,-3
IND,SVK,2022.0,5,2,3
ESP,TUR,2019.0,14,11,3
MYS,NOR,2020.0,4,2,2
VNM,MYS,2019.0,3,9,-6
MAR,FIN,2022.0,5,2,3
KEN,IND,2019.0,1,3,-2
PAK,HKG,2020.0,11,10,1
CZE,NLD,2009.0,3,4,-1
NLD,CZE,2010.0,7,5,2
CZE,NLD,2011.0,8,9,-1
SGP,IRN,2020.0,5,7,-2
ESP,BGD,2021.0,3,1,2
LKA,MYS,2020.0,4,6,-2
CZE,RUS,1999.0,6,17,-11
NOR,CAN,2011.0,9,15,-6
ESP,FIN,2019.0,26,17,9
EGY,BHR,2021.0,7,5,2
JPN,ROU,2005.0,8,5,3
AUT,CZE,2017.0,19,15,4
RUS,SWE,2014.0,15,18,-3
BOL,COL,2018.0,3,2,1
FRA,AUT,2016.0,39,35,4
NPL,SWE,2020.0,4,1,3
NLD,CHN,2009.0,38,49,-11
IRQ,CHN,2019.0,6,18,-12
PRT,CHN,2019.0,11,6,5
AUT,CZE,2022.0,23,24,-1
CMR,ZAF,2019.0,8,6,2
ZAF,CMR,2020.0,17,6,11
ZAF,FRA,2022.0,21,15,6
CHN,RUS,2019.0,29,49,-20
NLD,SAU,2022.0,11,10,1
ESP,PRI,2016.0,8,7,1
ITA,PHL,2023.0,1,1,0
ZAF,IRL,2023.0,6,1,5
MAR,ITA,2022.0,5,5,0
DEU,IRN,2023.0,35,82,-47
HKG,NOR,2021.0,2,2,0
IND,ITA,2020.0,55,48,7
NLD,HKG,2010.0,3,6,-3
JPN,IND,2005.0,54,63,-9
CHL,MEX,2013.0,13,29,-16
UGA,NOR,2018.0,6,6,0
PRK,CHN,2019.0,8,15,-7
CHN,PRK,2022.0,12,10,2
SWE,TUR,2017.0,9,27,-18
IND,BGD,2022.0,20,20,0
NLD,NGA,2012.0,1,3,-2
DZA,ITA,2021.0,4,6,-2
SVK,EGY,2022.0,2,1,1
AUT,CHN,2023.0,24,6,18
LKA,IND,2020.0,7,10,-3
POL,CZE,2022.0,23,28,-5
LIE,AUT,2021.0,3,1,2
DEU,COL,2021.0,23,33,-10
NLD,ECU,2020.0,6,2,4
CAN,KWT,2021.0,15,11,4
NLD,SAU,2018.0,15,4,11
SGP,TUR,2017.0,5,7,-2
DNK,RUS,2022.0,6,13,-7
MEX,PRY,2022.0,1,2,-1
ECU,PAN,2021.0,1,1,0
KOR,FRA,2020.0,37,14,23
SWE,ROU,2000.0,3,2,1
SGP,BRN,2018.0,1,2,-1
MEX,GTM,2022.0,7,2,5
GBR,ROU,2022.0,18,19,-1
DNK,PRT,2022.0,4,7,-3
CHN,NOR,2007.0,9,5,4
PRT,CHN,2021.0,17,12,5
FRA,GLP,2022.0,26,27,-1
IND,CHE,2018.0,60,30,30
MAR,PRT,2022.0,3,2,1
CHN,BEL,2013.0,33,41,-8
IND,PRT,2014.0,17,21,-4
AUS,NPL,2022.0,8,28,-20
VNM,AUT,2021.0,3,7,-4
ISL,USA,2019.0,13,11,2
SEN,USA,2023.0,6,3,3
NZL,AUT,2022.0,6,2,4
ESP,ISR,2017.0,13,9,4
SGP,MYS,2006.0,12,9,3
BEL,DNK,2022.0,19,19,0
ETH,TUR,2019.0,1,1,0
SWE,CZE,2021.0,20,19,1
UGA,IND,2023.0,1,4,-3
HKG,DEU,2008.0,10,9,1
ZAF,NAM,2022.0,11,8,3
IDN,GBR,1998.0,5,5,0
KEN,CHE,2021.0,6,11,-5
ROU,BEL,2008.0,3,17,-14
PAK,JPN,2018.0,7,11,-4
CHL,ARG,2023.0,14,12,2
SGP,CHN,2024.0,13,14,-1
PAK,BRA,2011.0,3,1,2
CAN,VNM,2021.0,3,7,-4
CAN,CZE,2011.0,8,14,-6
SVK,HUN,2014.0,6,9,-3
BEL,NOR,2008.0,4,1,3
VNM,DEU,1998.0,1,1,0
UGA,KEN,2015.0,9,5,4
KEN,NGA,2020.0,8,4,4
HUN,FRA,2022.0,8,4,4
JPN,IRL,1999.0,2,4,-2
FRA,CRI,2000.0,1,1,0
BEL,ESP,2003.0,27,21,6
DEU,MKD,2006.0,1,4,-3
BRA,RUS,2003.0,9,9,0
ISL,SWE,2005.0,7,8,-1
ROU,CHE,2015.0,15,6,9
SVN,SVK,2006.0,11,16,-5
VEN,DEU,2017.0,10,1,9
BGD,PHL,2021.0,1,2,-1
MWI,DEU,2017.0,5,4,1
SWE,KOR,1997.0,4,2,2
JPN,HUN,2011.0,6,8,-2
JAM,USA,2004.0,15,5,10
COL,DEU,2009.0,8,10,-2
JPN,KEN,1997.0,1,1,0
SWE,ISR,2001.0,7,6,1
KOR,NLD,2007.0,6,6,0
ARG,GBR,2002.0,13,12,1
DEU,PHL,2016.0,2,7,-5
AUS,PHL,2000.0,6,6,0
KWT,CAN,2013.0,4,12,-8
GBR,PHL,2014.0,9,8,1
IRL,CHN,2010.0,10,18,-8
IRL,CHE,2020.0,17,15,2
ZAF,RUS,2001.0,3,6,-3
CZE,IRL,2008.0,7,1,6
SVK,RUS,2002.0,4,3,1
USA,SGP,1997.0,43,36,7
FRA,MCO,2004.0,16,7,9
ROU,NLD,2002.0,10,1,9
OMN,ARE,2008.0,2,3,-1
SGP,RUS,2019.0,4,1,3
USA,AFG,2009.0,12,1,11
AUS,ZWE,2012.0,3,1,2
ZWE,AUS,2015.0,1,1,0
KOR,IRL,1998.0,1,1,0
ITA,BRA,2007.0,24,37,-13
BEL,THA,2010.0,3,2,1
BGD,NLD,2023.0,1,1,0
GBR,EGY,1998.0,10,7,3
POL,KEN,2009.0,1,2,-1
POL,SVK,2009.0,6,6,0
KOR,RUS,2010.0,15,9,6
DEU,THA,2000.0,5,3,2
AUS,KEN,2002.0,1,1,0
HUN,GBR,2007.0,30,22,8
ECU,AUS,2002.0,1,3,-2
ISR,CHE,2001.0,12,7,5
BGD,IND,2010.0,10,10,0
POL,IRL,2004.0,3,1,2
SVK,RUS,2012.0,1,1,0
USA,PAK,2000.0,15,29,-14
KOR,IND,2005.0,13,66,-53
DEU,SAU,2011.0,22,1,21
COL,VEN,2018.0,7,40,-33
VEN,ARG,2020.0,12,4,8
ECU,ITA,2004.0,1,1,0
ARE,GBR,2012.0,15,34,-19
THA,VNM,2022.0,18,13,5
MTQ,FRA,2022.0,12,14,-2
NLD,RUS,2016.0,19,27,-8
FIN,CRI,2004.0,1,1,0
HUN,FRA,2017.0,17,17,0
MMR,JPN,2015.0,2,5,-3
USA,TZA,2009.0,9,12,-3
SWE,UKR,1997.0,4,6,-2
BEL,GRC,2013.0,8,33,-25
COL,CAN,2002.0,7,5,2
CHE,CZE,2020.0,29,26,3
PNG,AUS,2010.0,6,6,0
FIN,CHE,2013.0,18,17,1
NLD,TWN,2001.0,2,2,0
BEL,POL,2008.0,4,13,-9
JPN,BGD,2000.0,13,26,-13
QAT,DNK,2021.0,1,2,-1
FRA,IND,1999.0,16,24,-8
ITA,SVN,1998.0,5,4,1
GBR,THA,2001.0,35,25,10
CHN,TUR,2009.0,5,5,0
ECU,VEN,2018.0,10,38,-28
MKD,NLD,2016.0,2,1,1
HUN,DEU,2012.0,44,44,0
RUS,IRN,2018.0,5,6,-1
FRA,COL,2023.0,12,11,1
BEL,MAR,2008.0,8,3,5
CUB,COL,2012.0,4,4,0
GBR,MWI,2013.0,12,23,-11
PRT,CAN,2014.0,15,11,4
CAN,TUN,2017.0,8,12,-4
DEU,SAU,2010.0,28,3,25
NOR,BRA,2012.0,4,6,-2
BEL,BGR,2012.0,7,8,-1
FRA,PYF,2012.0,22,11,11
GBR,VNM,2015.0,26,25,1
KOR,DEU,2015.0,59,51,8
FRA,VNM,2018.0,71,21,50
ARG,PRI,2017.0,5,3,2
CAN,OMN,2023.0,2,3,-1
BRA,CHN,2016.0,8,10,-2
CAN,BRA,2020.0,99,205,-106
GBR,LBY,2012.0,12,2,10
PRY,BRA,2008.0,2,3,-1
ZWE,UGA,2016.0,2,1,1
TWN,IDN,2012.0,4,2,2
ITA,GRC,2022.0,25,22,3
CHE,IND,2022.0,41,47,-6
BEL,IDN,2018.0,7,2,5
ITA,CHN,2015.0,53,22,31
SAU,DEU,2014.0,4,20,-16
HUN,HRV,2019.0,2,2,0
IRN,CHE,2016.0,22,5,17
IND,THA,2020.0,21,11,10
GBR,MLT,2018.0,19,20,-1
KOR,ITA,2013.0,7,11,-4
SAU,QAT,2020.0,17,7,10
DEU,MLT,2019.0,2,1,1
DEU,NOR,2011.0,57,37,20
JPN,AUS,2018.0,54,66,-12
ESP,DNK,2015.0,45,14,31
CHE,THA,2016.0,9,2,7
FRA,TUR,2019.0,27,26,1
BEL,ESP,2014.0,34,66,-32
CAN,ZAF,2018.0,21,27,-6
ZAF,BEL,2018.0,17,13,4
MEX,IND,2019.0,10,13,-3
KOR,THA,2015.0,13,8,5
CHE,MLT,2017.0,1,1,0
AUS,PRT,2016.0,8,16,-8
BHR,EGY,2017.0,4,4,0
LVA,RUS,2018.0,2,2,0
SVN,ESP,2021.0,8,7,1
ITA,KHM,2022.0,1,1,0
SWE,MOZ,2020.0,2,1,1
CAN,IND,2015.0,93,131,-38
PHL,JPN,2014.0,21,29,-8
GAB,FRA,2018.0,5,13,-8
NLD,MYS,2017.0,9,14,-5
FRA,BLR,1999.0,5,2,3
LKA,MYS,2012.0,1,2,-1
CAN,IND,2004.0,28,73,-45
AUT,FRA,2010.0,20,28,-8
KEN,GBR,1999.0,10,16,-6
CHN,JPN,1997.0,104,76,28
DNK,ZAF,2016.0,5,4,1
MAR,DEU,2003.0,3,3,0
ESP,IRL,1999.0,4,2,2
BEL,ESP,2015.0,58,81,-23
IND,NGA,1998.0,2,1,1
ROU,JPN,2001.0,12,8,4
FRA,GIN,2007.0,7,1,6
SVN,SVK,2009.0,22,24,-2
USA,GEO,2006.0,31,27,4
HUN,BEL,2001.0,10,9,1
SGP,MYS,2011.0,25,14,11
FRA,NCL,2010.0,11,25,-14
CHE,FIN,2008.0,8,12,-4
IRL,TUR,2006.0,1,2,-1
MEX,DEU,2004.0,13,20,-7
SWE,IRL,2010.0,10,14,-4
CHE,CIV,2001.0,2,2,0
GBR,ISR,2007.0,20,42,-22
SVN,CZE,2004.0,2,1,1
NOR,NLD,2001.0,12,10,2
NGA,DEU,1998.0,6,4,2
ZAF,SWE,2003.0,5,8,-3
SGP,IRN,2012.0,4,8,-4
ITA,ISR,2001.0,21,11,10
FRA,MEX,1997.0,18,16,2
BEL,THA,2021.0,2,2,0
HKG,RUS,2014.0,2,2,0
LBN,ITA,2019.0,6,8,-2
HRV,CZE,2018.0,5,5,0
AUS,IRQ,2018.0,10,13,-3
GBR,MMR,2018.0,1,1,0
KWT,IRN,2022.0,2,1,1
ISL,SWE,2020.0,19,17,2
BGD,BEL,2021.0,5,5,0
IND,MAR,2022.0,5,3,2
JPN,MMR,2022.0,8,6,2
MLI,USA,2009.0,6,3,3
NGA,JPN,2023.0,5,1,4
HUN,RUS,2010.0,5,1,4
FIN,NOR,2016.0,20,13,7
NLD,PAK,2018.0,15,3,12
ITA,ISR,2015.0,16,15,1
MEX,DEU,2001.0,14,18,-4
BHR,IND,2003.0,1,2,-1
HRV,DEU,1997.0,11,8,3
CHE,COL,2018.0,7,7,0
FIN,CHN,2002.0,11,6,5
FIN,DEU,2007.0,29,33,-4
DNK,AUS,2022.0,26,36,-10
GRC,CHE,2007.0,15,5,10
VEN,FRA,2001.0,5,9,-4
ITA,BEL,2015.0,97,77,20
SWZ,CHE,2013.0,12,8,4
JPN,RUS,2017.0,8,15,-7
ARE,OMN,2016.0,3,4,-1
NOR,AUT,2016.0,13,15,-2
BLR,USA,1998.0,14,4,10
PNG,USA,2011.0,3,1,2
CHL,CRI,2011.0,4,2,2
NLD,NOR,2018.0,48,34,14
FRA,ISR,2001.0,28,23,5
CHL,PER,2023.0,9,5,4
BEL,BGR,1997.0,6,3,3
MAR,BEL,1998.0,3,5,-2
HUN,BEL,2008.0,6,8,-2
SRB,USA,1999.0,33,28,5
CAN,MEX,2004.0,23,15,8
CZE,CHN,2001.0,3,2,1
GBR,LBN,2020.0,5,16,-11
SVN,ITA,2020.0,11,15,-4
HKG,NZL,2016.0,12,5,7
ISR,SWE,2014.0,7,8,-1
THA,MYS,2015.0,4,9,-5
IND,TUR,2007.0,5,1,4
BGD,DEU,2017.0,5,12,-7
GRC,CHE,2020.0,33,30,3
TUN,SAU,2012.0,30,5,25
FRA,GRC,2020.0,33,50,-17
USA,CYP,2018.0,18,8,10
GBR,BGD,2009.0,6,21,-15
POL,ESP,2015.0,21,17,4
MAC,MAR,2017.0,12,2,10
IRN,SWE,2013.0,36,20,16
ITA,LBN,2015.0,5,3,2
ARG,THA,2017.0,2,3,-1
NZL,THA,2011.0,4,1,3
ESP,DOM,2017.0,9,3,6
DOM,ESP,2020.0,5,5,0
JPN,IND,1998.0,29,58,-29
CIV,FRA,2017.0,19,57,-38
CZE,CAN,2022.0,14,6,8
MEX,CHN,2018.0,6,1,5
GBR,PSE,2019.0,8,3,5
EGY,LBY,2017.0,5,1,4
SLE,USA,2018.0,6,9,-3
ISL,GBR,2019.0,12,13,-1
YEM,MYS,2020.0,8,17,-9
DNK,AUT,2020.0,20,11,9
SDN,SAU,2015.0,17,9,8
ISR,SRB,2020.0,2,1,1
USA,CYP,2022.0,11,8,3
USA,CRI,2004.0,16,8,8
HUN,JPN,2017.0,10,4,6
PAK,GBR,2013.0,53,95,-42
ARG,ECU,2023.0,7,3,4
GHA,NGA,2022.0,3,13,-10
THA,SWE,2020.0,9,3,6
SWE,SDN,2010.0,1,1,0
MAC,PRT,2019.0,1,1,0
FIN,QAT,2021.0,1,1,0
PAK,OMN,2021.0,14,7,7
CZE,AUT,2023.0,16,10,6
IDN,CHN,2022.0,5,20,-15
DNK,IRL,2010.0,1,10,-9
HUN,DEU,2002.0,48,38,10
ROU,JPN,2008.0,3,14,-11
COL,DEU,2006.0,4,6,-2
ITA,CMR,2009.0,3,1,2
ESP,AND,2009.0,3,1,2
JPN,IRL,2002.0,5,1,4
DEU,KAZ,2017.0,8,6,2
NLD,UKR,1998.0,2,2,0
USA,KWT,1997.0,10,2,8
AUS,HUN,2001.0,3,3,0
TUR,JPN,2005.0,7,6,1
BEL,IND,1998.0,3,5,-2
DEU,LKA,2006.0,4,1,3
UKR,BRA,1997.0,2,1,1
TZA,USA,2013.0,18,19,-1
KHM,FRA,2017.0,5,8,-3
ZAF,NZL,2003.0,10,3,7
CZE,CHE,2011.0,16,16,0
,OMN,2008.0,129,0,129
FIN,CIV,2020.0,1,0,1
,AZE,2009.0,217,0,217
,MMR,2008.0,28,0,28
,RWA,2008.0,30,0,30
MYS,MUS,2019.0,1,0,1
,UZB,2009.0,125,0,125
,BFA,2009.0,108,0,108
MYS,SOM,2019.0,3,0,3
BRN,FRA,2021.0,1,0,1
,SDN,2010.0,119,0,119
KHM,,2017.0,38,0,38
JPN,GIN,2019.0,2,0,2
IRQ,,2014.0,85,0,85
,URY,2011.0,246,0,246
,EST,2011.0,376,0,376
IND,MAR,2020.0,4,0,4
PAN,BEL,2022.0,2,0,2
,MAC,2008.0,70,0,70
LTU,ESP,2013.0,2,0,2
VUT,,2018.0,2,0,2
IND,NCL,2018.0,1,0,1
SLB,,2016.0,5,0,5
VEN,AUS,2016.0,2,0,2
,GTM,2007.0,42,0,42
ZWE,,2012.0,26,0,26
RWA,,2013.0,15,0,15
,PLW,2011.0,4,0,4
,PRK,2011.0,3,0,3
DEU,PYF,2021.0,1,0,1
ARG,ISR,2020.0,7,0,7
PAK,CMR,2014.0,1,0,1
GRL,,2016.0,5,0,5
,BHR,2011.0,71,0,71
TLS,AUS,2016.0,2,0,2
,AZE,2011.0,159,0,159
SEN,GBR,2023.0,2,0,2
,GNB,2011.0,11,0,11
,PRY,2011.0,37,0,37
CHN,NER,2021.0,3,0,3
,CAF,2009.0,8,0,8
,CAF,2011.0,12,0,12
IRL,ALB,2014.0,1,0,1
KOR,LUX,2023.0,2,0,2
THA,MMR,2015.0,5,0,5
MRT,,2023.0,45,0,45
,BTN,2011.0,26,0,26
FLK,IND,2016.0,1,0,1
VUT,,2017.0,6,0,6
MNG,FRA,2014.0,1,0,1
THA,IRQ,2022.0,1,0,1
,SWZ,2010.0,11,0,11
BGD,KHM,2016.0,1,0,1
CHE,MDA,2021.0,1,0,1
CAN,ZWE,2018.0,1,0,1
DNK,ARE,2023.0,2,0,2
MKD,HUN,2022.0,1,0,1
NZL,TZA,2014.0,1,0,1
GTM,,2017.0,33,0,33
MDG,,2020.0,59,0,59
NER,ZAF,2014.0,1,0,1
NOR,BGR,2016.0,1,0,1
,MDG,2006.0,69,0,69
,GIN,2011.0,13,0,13
,MWI,2010.0,115,0,115
MWI,,2018.0,58,0,58
TUR,BFA,2019.0,1,0,1
,CRI,2009.0,120,0,120
MEX,POL,2021.0,5,0,5
TJK,,2024.0,91,0,91
CHL,KEN,2006.0,1,0,1
,CIV,2014.0,114,0,114
,BHR,2019.0,116,0,116
POL,ETH,2018.0,1,0,1
,GIN,2019.0,21,0,21
ARG,THA,2020.0,18,0,18
SLB,,2022.0,20,0,20
GUY,BRB,2002.0,1,0,1
,MDV,2014.0,5,0,5
,ARM,2009.0,158,0,158
MYS,MEX,2020.0,2,0,2
BLR,CHL,2003.0,1,0,1
CHL,NOR,2006.0,3,0,3
NOR,BLR,2009.0,1,0,1
,UGA,2020.0,314,0,314
,ETH,1995.0,118,0,118
,SMR,2013.0,5,0,5
COL,VNM,2018.0,3,0,3
EGY,HKG,2018.0,1,0,1
,NER,2014.0,49,0,49
GRD,,2020.0,23,0,23
,CPV,2014.0,6,0,6
COG,DEU,2019.0,1,0,1
CAN,CYM,2014.0,1,0,1
BGD,BTN,2021.0,1,0,1
BLZ,,2025.0,28,0,28
,MMR,2014.0,74,0,74
VCT,,2019.0,2,0,2
ESP,QAT,2014.0,11,0,11
,TGO,2006.0,41,0,41
CHL,IND,2003.0,1,0,1
CMR,,2009.0,51,0,51
VCT,,2021.0,5,0,5
GBR,MKD,2001.0,1,0,1
MKD,GBR,2003.0,1,0,1
AUT,BRN,2022.0,2,0,2
BEL,HRV,2012.0,1,0,1
NOR,ARG,2012.0,3,0,3
FJI,NGA,2001.0,1,0,1
MYS,THA,1997.0,1,0,1
MAR,NLD,1999.0,2,0,2
GRC,JOR,2003.0,2,0,2
GEO,ZAF,2008.0,1,0,1
CAF,CAN,2006.0,1,0,1
IRL,MEX,2000.0,1,0,1
URY,,2003.0,21,0,21
RUS,TJK,1999.0,1,0,1
HKG,UKR,1998.0,1,0,1
TUR,DNK,2001.0,3,0,3
USA,GUF,1998.0,1,0,1
LBR,,2016.0,5,0,5
,GIN,1994.0,10,0,10
JOR,KWT,2000.0,1,0,1
ZAF,RUS,2023.0,3,0,3
GBR,AFG,2003.0,1,0,1
JOR,AUS,1997.0,1,0,1
TZA,,2008.0,45,0,45
CAN,JOR,2000.0,5,0,5
NOR,ARE,2005.0,1,0,1
NGA,ESP,2001.0,1,0,1
ZAF,VEN,2017.0,1,0,1
ROU,TWN,2006.0,2,0,2
CMR,CHE,2008.0,2,0,2
,BOL,2006.0,62,0,62
GEO,,2004.0,39,0,39
LVA,RUS,1999.0,8,0,8
JPN,UZB,1999.0,1,0,1
SWE,PAN,2021.0,1,0,1
MAR,PRT,2002.0,1,0,1
LBN,,2002.0,39,0,39
VEN,AUS,2017.0,2,0,2
,BWA,1995.0,48,0,48
BWA,,2003.0,13,0,13
SVK,TUR,2006.0,1,0,1
SRB,TUR,2001.0,1,0,1
ETH,JPN,2007.0,1,0,1
THA,SGP,2001.0,3,0,3
ROU,TUR,2001.0,3,0,3
,GLP,1995.0,24,0,24
LTU,,1999.0,18,0,18
CHN,BRN,2015.0,1,0,1
LUX,,2007.0,27,0,27
PHL,ESP,2006.0,5,0,5
SEN,ZAF,2000.0,1,0,1
NLD,SGP,1998.0,6,0,6
BLR,ZAF,2003.0,1,0,1
ZAF,BLR,2012.0,1,0,1
ISR,ROU,2001.0,2,0,2
GEO,,2001.0,34,0,34
ECU,,2005.0,15,0,15
ZAF,JAM,2011.0,3,0,3
NLD,BGD,2005.0,2,0,2
MAR,NER,2004.0,1,0,1
NOR,PSE,2000.0,2,0,2
PNG,CHE,2016.0,1,0,1
MDA,USA,2000.0,2,0,2
COL,FIN,2002.0,1,0,1
CZE,IND,1997.0,1,0,1
GRC,SAU,2013.0,3,0,3
AUS,JAM,2002.0,1,0,1
FRO,DEU,2020.0,1,0,1
MLI,CIV,2005.0,2,0,2
SRB,CZE,1999.0,4,0,4
MWI,TZA,2014.0,1,0,1
CHE,SVK,1997.0,4,0,4
THA,IDN,1998.0,1,0,1
IDN,BRA,2000.0,1,0,1
DNK,GMB,2000.0,1,0,1
CAN,MLT,2008.0,1,0,1
NGA,IND,2000.0,2,0,2
IRL,KWT,2013.0,1,0,1
HKG,TUR,2008.0,2,0,2
GMB,,2002.0,5,0,5
BGD,SAU,1997.0,1,0,1
DNK,THA,1998.0,1,0,1
GUF,CAN,2021.0,1,0,1
TWN,SDN,2019.0,1,0,1
,SLV,2016.0,17,0,17
SLV,,2024.0,65,0,65
CUB,CHE,2018.0,2,0,2
BFA,TCD,2019.0,1,0,1
BDI,,2023.0,30,0,30
IRL,VNM,2018.0,3,0,3
VIR,,2024.0,7,0,7
GHA,UGA,2023.0,2,0,2
NGA,THA,2018.0,2,0,2
NOR,MKD,2019.0,1,0,1
CRI,BEL,2006.0,1,0,1
POL,SAU,2020.0,5,0,5
EGY,HKG,2016.0,1,0,1
THA,MYS,2011.0,7,0,7
IRN,KWT,2023.0,1,0,1
TUR,SVN,2020.0,4,0,4
KAZ,VUT,2019.0,1,0,1
PAN,,2010.0,18,0,18
BRN,,2012.0,6,0,6
,CYM,2015.0,4,0,4
,ZMB,2012.0,107,0,107
MAC,IRL,2023.0,1,0,1
,KWT,2010.0,159,0,159
GNB,,2018.0,8,0,8
,SUR,2017.0,15,0,15
MEX,LUX,2021.0,2,0,2
SAU,BGD,2003.0,2,0,2
,PYF,2013.0,21,0,21
ISR,TUR,2007.0,4,0,4
BHS,,2003.0,1,0,1
AUT,TUR,1998.0,3,0,3
KWT,SWE,2020.0,1,0,1
,BRN,2011.0,47,0,47
MDA,,1999.0,15,0,15
ESP,PAK,1999.0,1,0,1
LAO,,2017.0,27,0,27
LBR,,2018.0,14,0,14
CUB,,2001.0,163,0,163
PRT,BFA,2020.0,1,0,1
ARM,MYS,2008.0,3,0,3
VEN,NLD,2021.0,2,0,2
REU,,2010.0,9,0,9
,SLV,2018.0,17,0,17
NIC,,2015.0,16,0,16
,TJK,2017.0,45,0,45
,MMR,2004.0,13,0,13
MRT,,2024.0,42,0,42
CHE,TCD,2021.0,1,0,1
CHN,ISL,2019.0,1,0,1
JAM,,2000.0,11,0,11
CAN,ETH,2009.0,2,0,2
OMN,LKA,2023.0,1,0,1
AUS,BTN,2016.0,2,0,2
ZAF,CIV,2017.0,8,0,8
SVN,ISR,1999.0,1,0,1
DMA,,2015.0,4,0,4
SVN,POL,2014.0,3,0,3
JAM,PRI,2000.0,1,0,1
TUN,CHE,2017.0,5,0,5
IND,BHR,2001.0,3,0,3
SVK,DNK,2004.0,2,0,2
,MLT,1997.0,14,0,14
BEL,CHL,2004.0,2,0,2
SWE,KWT,2001.0,1,0,1
CUB,ARG,2007.0,4,0,4
BRA,PER,2003.0,3,0,3
ARM,USA,1997.0,2,0,2
MYS,SLB,2005.0,2,0,2
NZL,HKG,2001.0,5,0,5
,GNQ,2010.0,3,0,3
HKG,SYR,2000.0,1,0,1
SYR,HKG,2001.0,2,0,2
PAK,ARE,2003.0,2,0,2
BRB,AUS,2010.0,2,0,2
NOR,KOR,2000.0,2,0,2
LKA,DNK,2008.0,2,0,2
ZWE,CHE,2001.0,2,0,2
ZWE,ITA,2006.0,1,0,1
ZWE,ZMB,2021.0,3,0,3
BEL,SYR,2011.0,3,0,3
EST,ISR,2013.0,1,0,1
KAZ,KOR,2005.0,1,0,1
HUN,HKG,1998.0,1,0,1
LAO,MYS,1998.0,1,0,1
GBR,GEO,2012.0,3,0,3
CRI,,2014.0,59,0,59
CHE,ECU,2013.0,1,0,1
CHE,MLI,2009.0,1,0,1
MLI,CHE,1998.0,1,0,1
JOR,MYS,2000.0,2,0,2
ECU,CAN,2007.0,2,0,2
CAN,ECU,2012.0,2,0,2
IRL,KOR,2004.0,1,0,1
DEU,PHL,1997.0,1,0,1
BEL,VNM,1999.0,2,0,2
PRT,HUN,2000.0,1,0,1
CAN,MNG,2015.0,1,0,1
,MUS,1998.0,25,0,25
GEO,TUR,2007.0,3,0,3
SLE,ZAF,2002.0,1,0,1
SLE,ZAF,2005.0,1,0,1
BEL,SVN,2004.0,2,0,2
MDA,USA,2010.0,3,0,3
ROU,UKR,2020.0,2,0,2
JAM,GRD,2002.0,1,0,1
BHR,,2004.0,11,0,11
QAT,YEM,2003.0,1,0,1
,NER,1996.0,16,0,16
SRB,HKG,1999.0,2,0,2
BGR,SAU,2011.0,1,0,1
AUS,LBN,2002.0,3,0,3
JAM,,2010.0,39,0,39
GIN,BFA,2022.0,1,0,1
HRV,DNK,2003.0,1,0,1
USA,SOM,2014.0,1,0,1
ROU,LTU,2009.0,1,0,1
MNG,LKA,2015.0,1,0,1
,HND,2007.0,12,0,12
NAM,FRA,2021.0,1,0,1
VGB,,2011.0,2,0,2
ARG,SGP,2010.0,2,0,2
HUN,BIH,2011.0,3,0,3
MNG,IND,2023.0,1,0,1
MEX,FIN,2010.0,1,0,1
LKA,,2013.0,75,0,75
GAB,NLD,2019.0,4,0,4
MOZ,NGA,2014.0,2,0,2
,HTI,2008.0,15,0,15
SWE,NIC,2013.0,5,0,5
FIN,SRB,2012.0,2,0,2
PAK,FIN,2010.0,1,0,1
MUS,AUS,2008.0,1,0,1
IRQ,,2015.0,89,0,89
JOR,PAK,2016.0,2,0,2
BIH,QAT,2020.0,1,0,1
ECU,MAR,2021.0,1,0,1
,COD,2007.0,14,0,14
DOM,,2012.0,6,0,6
PRT,SRB,2014.0,1,0,1
AFG,ARG,2006.0,4,0,4
YEM,CHN,2011.0,1,0,1
CAF,,2017.0,10,0,10
SRB,BGR,2016.0,2,0,2
ITA,IDN,2013.0,3,0,3
ISR,ISL,2021.0,1,0,1
ESP,MNG,2019.0,1,0,1
GLP,,2024.0,24,0,24
FJI,SLB,2014.0,5,0,5
REU,,2024.0,28,0,28
MWI,ITA,2017.0,2,0,2
,MWI,2006.0,76,0,76
GMB,KEN,2020.0,2,0,2
,GUM,2017.0,6,0,6
CZE,BLR,2019.0,1,0,1
JPN,BRN,2021.0,3,0,3
BLZ,,2021.0,6,0,6
MYS,ITA,2013.0,4,0,4
PHL,UGA,2021.0,1,0,1
NZL,IDN,2019.0,11,0,11
LTU,LUX,2019.0,1,0,1
GNB,,2022.0,15,0,15
KHM,VNM,2019.0,1,0,1
FRA,TTO,2002.0,1,0,1
BHS,CAN,2021.0,1,0,1
BRA,REU,2020.0,1,0,1
UKR,GEO,2016.0,6,0,6
NLD,USA,2024.0,3,0,3
BTN,DEU,2021.0,1,0,1
HRV,SGP,2022.0,2,0,2
MMR,CHN,2014.0,2,0,2
CHN,MMR,2017.0,6,0,6
ITA,BGD,2005.0,1,0,1
FRA,RWA,2017.0,1,0,1
MCO,EGY,2022.0,1,0,1
,GMB,2017.0,48,0,48
EGY,UZB,2020.0,1,0,1
MYS,LAO,2020.0,1,0,1
,LBR,2016.0,46,0,46
,TTO,2017.0,69,0,69
,BRB,2017.0,12,0,12
NAM,VNM,2022.0,1,0,1
FRA,DEU,2024.0,2,0,2
,LBR,2018.0,18,0,18
MYS,HUN,2021.0,3,0,3
TJK,,2006.0,4,0,4
,LBY,2018.0,97,0,97
LBR,,2022.0,15,0,15
,PRY,2019.0,79,0,79
,BTN,2019.0,45,0,45
FJI,ATG,2021.0,1,0,1
IDN,BLR,2021.0,1,0,1
ISL,SGP,2022.0,1,0,1
BLR,DEU,2023.0,2,0,2
SEN,MDG,2022.0,2,0,2
GMB,,2005.0,6,0,6
CMR,CHE,2001.0,1,0,1
VEN,DEU,1997.0,2,0,2
IDN,,2003.0,45,0,45
,GNB,2009.0,5,0,5
ROU,ZAF,1997.0,1,0,1
POL,BLR,1998.0,4,0,4
BEL,THA,2014.0,4,0,4
LIE,,2002.0,6,0,6
FJI,,2002.0,5,0,5
PRY,USA,2009.0,6,0,6
NAM,,2005.0,6,0,6
MEX,NGA,1999.0,1,0,1
ZWE,AUS,2006.0,1,0,1
NER,ZAF,2008.0,1,0,1
MEX,KOR,1997.0,2,0,2
LTU,POL,2013.0,1,0,1
POL,IRL,2000.0,3,0,3
UKR,PSE,2007.0,1,0,1
KEN,POL,2012.0,1,0,1
SLV,,2006.0,3,0,3
DEU,MKD,2001.0,3,0,3
KWT,PAK,2001.0,1,0,1
LKA,,2003.0,27,0,27
POL,KOR,1997.0,2,0,2
TTO,MSR,2000.0,2,0,2
MSR,,2004.0,3,0,3
ITA,ECU,2005.0,1,0,1
KOR,PAK,2002.0,1,0,1
AUS,MWI,1999.0,1,0,1
DJI,ESP,2011.0,1,0,1
SAU,KWT,2005.0,6,0,6
BEL,UZB,2022.0,3,0,3
CUB,GBR,1998.0,2,0,2
,BRN,1994.0,32,0,32
TCD,,2009.0,2,0,2
IRL,QAT,2015.0,1,0,1
CUB,URY,2018.0,1,0,1
CUB,URY,2022.0,1,0,1
NIC,,2004.0,3,0,3
MYS,MDV,2018.0,1,0,1
FRA,PRI,2002.0,2,0,2
KOR,PER,2018.0,2,0,2
DZA,AUT,2023.0,1,0,1
AUS,LUX,2007.0,1,0,1
,MKD,2005.0,119,0,119
,MDG,2010.0,65,0,65
FRO,USA,2019.0,1,0,1
GBR,SHN,2014.0,4,0,4
CHE,LVA,2023.0,3,0,3
,SDN,2006.0,98,0,98
BGD,BEL,2008.0,1,0,1
KEN,MYS,2015.0,2,0,2
CRI,,2001.0,27,0,27
AND,,2017.0,3,0,3
KOR,KAZ,2009.0,1,0,1
CYP,FRA,2016.0,5,0,5
BOL,URY,2016.0,1,0,1
JOR,RUS,2013.0,2,0,2
CHN,CIV,2015.0,2,0,2
KWT,MYS,2008.0,1,0,1
VEN,NLD,2011.0,5,0,5
SVK,ROU,2019.0,4,0,4
LBY,LBR,2013.0,1,0,1
JPN,ISR,2015.0,5,0,5
GTM,,2018.0,28,0,28
LUX,PER,2010.0,1,0,1
IRN,LVA,2022.0,1,0,1
EGY,SGP,2011.0,2,0,2
CHN,DNK,1997.0,4,0,4
DNK,HUN,2024.0,1,0,1
MLI,DNK,2012.0,1,0,1
,PNG,2005.0,23,0,23
GUM,AUS,2021.0,2,0,2
KWT,ITA,2014.0,1,0,1
CRI,PRI,2018.0,2,0,2
BDI,COG,2015.0,1,0,1
ITA,MNE,2014.0,1,0,1
DJI,,2024.0,21,0,21
PNG,ESP,2020.0,2,0,2
TUR,HRV,2016.0,5,0,5
NGA,LTU,2021.0,2,0,2
SSD,,2018.0,3,0,3
AUT,KOR,2003.0,1,0,1
SLB,,2018.0,6,0,6
GAB,CHE,2016.0,2,0,2
ALB,,2010.0,6,0,6
NIC,,2014.0,17,0,17
TCD,,2019.0,14,0,14
ZAF,CIV,2018.0,2,0,2
ALB,,2018.0,74,0,74
NLD,JOR,2016.0,3,0,3
,SYR,2007.0,45,0,45
NGA,GRD,2012.0,1,0,1
MDV,,2024.0,25,0,25
REU,,2016.0,5,0,5
COD,,2013.0,4,0,4
PRT,PER,2020.0,3,0,3
USA,MHL,2015.0,7,0,7
SLV,,2022.0,21,0,21
MNE,IRN,2011.0,1,0,1
ESP,ETH,2015.0,3,0,3
GRC,EGY,2010.0,4,0,4
FRA,BRN,2016.0,1,0,1
,PNG,2004.0,19,0,19
,NCL,2008.0,22,0,22
LUX,,2013.0,54,0,54
GNQ,,2014.0,2,0,2
YEM,NLD,2011.0,1,0,1
,MLT,2008.0,59,0,59
LBY,,2020.0,61,0,61
CZE,ALB,2023.0,1,0,1
IND,KHM,2010.0,1,0,1
TTO,,2016.0,44,0,44
GLP,,2017.0,18,0,18
,ETH,2009.0,325,0,325
GMB,,2014.0,12,0,12
ALB,,2016.0,89,0,89
GBR,TUN,2014.0,2,0,2
BFA,MYS,2014.0,1,0,1
NPL,MEX,2021.0,1,0,1
GTM,NOR,2018.0,1,0,1
ECU,,2014.0,32,0,32
,GRL,2011.0,12,0,12
FIN,TZA,2016.0,2,0,2
GRL,,2024.0,20,0,20
GHA,HKG,2014.0,1,0,1
BOL,ARG,2016.0,1,0,1
IND,IRQ,2016.0,19,0,19
PAK,CHL,2016.0,1,0,1
,KAZ,2005.0,112,0,112
,MNG,2011.0,53,0,53
,YEM,2011.0,45,0,45
COM,COL,2014.0,5,0,5
PAN,,2016.0,25,0,25
RUS,HRV,2015.0,4,0,4
TGO,,2016.0,29,0,29
LKA,DEU,2017.0,2,0,2
,NAM,2011.0,50,0,50
NLD,BGD,2014.0,4,0,4
DNK,GTM,2007.0,1,0,1
,LIE,2011.0,5,0,5
NOR,TZA,2020.0,8,0,8
,MRT,2011.0,11,0,11
MRT,,2016.0,8,0,8
TJK,,2016.0,14,0,14
,FLK,2011.0,3,0,3
FLK,GBR,2023.0,3,0,3
,LBR,2010.0,14,0,14
IDN,DNK,2012.0,1,0,1
,GUF,2014.0,18,0,18
GUF,,2019.0,13,0,13
SVN,CHE,2014.0,8,0,8
KOR,CZE,2022.0,5,0,5
,GLP,2011.0,18,0,18
GLP,,2016.0,15,0,15
,MNG,2009.0,37,0,37
HUN,SGP,2016.0,5,0,5
,TUV,2011.0,1,0,1
HUN,SGP,2018.0,2,0,2
,BWA,2011.0,71,0,71
POL,THA,2014.0,1,0,1
FJI,USA,2014.0,3,0,3
BTN,AUS,2011.0,3,0,3
ZWE,TZA,2017.0,1,0,1
NER,,2016.0,36,0,36
TWN,POL,2018.0,1,0,1
FRA,TJK,2016.0,1,0,1
BRB,JAM,2017.0,3,0,3
PYF,,2018.0,9,0,9
MAR,PAK,2021.0,1,0,1
LAO,,2023.0,97,0,97
KWT,,2008.0,88,0,88
MYS,ETH,2021.0,5,0,5
,SLE,2014.0,63,0,63
,SEN,2007.0,86,0,86
LBR,,2024.0,75,0,75
,ARE,2002.0,102,0,102
,PNG,2014.0,39,0,39
MDV,CAN,2018.0,1,0,1
SRB,BLR,2004.0,1,0,1
,ERI,2014.0,3,0,3
,NCL,2014.0,23,0,23
,MNE,2016.0,48,0,48
LCA,,2019.0,5,0,5
MKD,,2019.0,129,0,129
CUB,AUS,2018.0,3,0,3
SLV,,2016.0,12,0,12
GAB,,2019.0,21,0,21
IND,VUT,2015.0,1,0,1
DEU,COG,2017.0,2,0,2
DEU,COG,2022.0,2,0,2
UKR,IRQ,2019.0,1,0,1
AUS,LAO,2023.0,1,0,1
IRL,BGD,2011.0,1,0,1
BOL,COL,2015.0,2,0,2
HKG,VNM,2020.0,4,0,4
USA,GRD,2005.0,2,0,2
MAR,,2005.0,184,0,184
SWE,MAC,2015.0,1,0,1
TGO,RWA,2007.0,1,0,1
PRI,,2000.0,24,0,24
LBN,,2001.0,23,0,23
GBR,MKD,2005.0,3,0,3
,GUM,2000.0,6,0,6
,COG,1994.0,31,0,31
NLD,MAR,2000.0,2,0,2
IRN,,1999.0,24,0,24
TON,USA,2021.0,2,0,2
KGZ,,2001.0,7,0,7
NGA,BWA,1999.0,2,0,2
ISR,MKD,2009.0,1,0,1
UKR,HKG,1999.0,2,0,2
LVA,,2001.0,28,0,28
ZAF,ARE,2000.0,1,0,1
FJI,,2004.0,1,0,1
ZWE,MDG,2018.0,1,0,1
LSO,KEN,2009.0,1,0,1
ITA,NGA,1997.0,2,0,2
SAU,CUB,2003.0,1,0,1
,HTI,2012.0,36,0,36
IDN,,2007.0,63,0,63
LCA,USA,1998.0,1,0,1
MAR,,2002.0,116,0,116
TUN,AUT,2006.0,3,0,3
MAR,ITA,2001.0,6,0,6
ZMB,ITA,2002.0,1,0,1
TUR,ALB,2015.0,2,0,2
GEO,FRA,2001.0,2,0,2
ZAF,UGA,2023.0,10,0,10
NGA,,2006.0,114,0,114
,MOZ,2006.0,29,0,29
NGA,UGA,2001.0,1,0,1
BHR,NZL,2022.0,2,0,2
CAN,MDG,2010.0,1,0,1
FLK,,2013.0,3,0,3
JPN,MAR,2010.0,5,0,5
CAN,SVN,1998.0,5,0,5
SWE,MEX,1997.0,4,0,4
FRA,EST,2009.0,1,0,1
GMB,,2001.0,6,0,6
LVA,,2004.0,35,0,35
CHE,GTM,2010.0,1,0,1
LKA,,1999.0,9,0,9
TGO,,2017.0,38,0,38
GBR,NFK,2010.0,1,0,1
MCO,JPN,2000.0,1,0,1
CHE,EST,2003.0,1,0,1
NOR,POL,1998.0,1,0,1
COL,,2000.0,26,0,26
FRA,UGA,2002.0,3,0,3
TWN,NGA,2000.0,1,0,1
NGA,TWN,2003.0,1,0,1
DEU,ISL,2005.0,1,0,1
NCL,,2020.0,18,0,18
SEN,NLD,2001.0,1,0,1
DEU,FRO,2019.0,2,0,2
GHA,ZWE,2004.0,1,0,1
IDN,,1999.0,23,0,23
,OMN,1997.0,49,0,49
VNM,ISL,2012.0,3,0,3
UKR,HUN,2006.0,1,0,1
MKD,,2011.0,51,0,51
PAK,UZB,2006.0,1,0,1
HKG,TUR,2005.0,1,0,1
NPL,MMR,2021.0,1,0,1
TUN,QAT,2013.0,3,0,3
UKR,DZA,2004.0,1,0,1
UGA,DEU,2002.0,6,0,6
UZB,BGR,2011.0,1,0,1
DNK,LBN,2019.0,1,0,1
,GUF,2015.0,21,0,21
QAT,ISR,2023.0,2,0,2
,SWZ,2016.0,31,0,31
ARM,DNK,2019.0,3,0,3
MKD,JOR,2018.0,1,0,1
ESP,JOR,2021.0,7,0,7
GUY,,2025.0,48,0,48
,SLE,2015.0,55,0,55
ARG,HKG,2022.0,2,0,2
ETH,ZMB,2020.0,1,0,1
MLI,KEN,2018.0,1,0,1
RWA,FRA,2015.0,1,0,1
EGY,ZAF,2023.0,2,0,2
JPN,ARE,2016.0,5,0,5
CYP,SWE,2021.0,4,0,4
TUR,OMN,2006.0,2,0,2
TKM,CHN,2019.0,2,0,2
BEN,MLI,2020.0,3,0,3
MRT,,2022.0,24,0,24
MKD,BIH,2012.0,2,0,2
CAF,,2024.0,40,0,40
SLB,,2023.0,25,0,25
RWA,,2020.0,58,0,58
ITA,PAN,2018.0,2,0,2
ABW,USA,2020.0,1,0,1
SHN,CHN,2018.0,4,0,4
MTQ,ESP,2017.0,1,0,1
BRA,CMR,2023.0,2,0,2
KEN,SSD,2021.0,3,0,3
PRI,BEL,2022.0,1,0,1
,GIN,1995.0,10,0,10
FRA,GIN,2000.0,2,0,2
KGZ,,2014.0,6,0,6
,GRL,1994.0,8,0,8
TTO,ITA,2019.0,1,0,1
DNK,KAZ,2019.0,1,0,1
,SLB,2017.0,6,0,6
BRA,ROU,2021.0,2,0,2
TLS,MYS,2023.0,1,0,1
PAK,LKA,2013.0,1,0,1
IND,HUN,2000.0,3,0,3
USA,MDA,2011.0,3,0,3
IDN,BGD,2022.0,1,0,1
AUS,KNA,2016.0,1,0,1
URY,CHL,2008.0,2,0,2
FJI,FRA,2010.0,2,0,2
SDN,PSE,2021.0,1,0,1
SWZ,ZAF,2014.0,3,0,3
,PRI,2012.0,163,0,163
,GAB,2006.0,20,0,20
,MLI,2011.0,40,0,40
,GMB,2006.0,23,0,23
GMB,,2015.0,8,0,8
BGD,ISR,2021.0,1,0,1
AZE,,2009.0,43,0,43
,REU,2004.0,17,0,17
,BMU,2014.0,4,0,4
BFA,KWT,2018.0,1,0,1
CZE,NPL,2011.0,1,0,1
GEO,,2012.0,53,0,53
NOR,PSE,2022.0,4,0,4
CUB,POL,2023.0,1,0,1
,IRQ,2000.0,45,0,45
MLI,,2013.0,23,0,23
TTO,KOR,2017.0,1,0,1
USA,BLZ,2017.0,5,0,5
FJI,WSM,2013.0,1,0,1
BGR,DNK,2021.0,3,0,3
,TJK,2000.0,15,0,15
AUS,QAT,2010.0,7,0,7
USA,HTI,1997.0,4,0,4
CHE,MTQ,2000.0,2,0,2
SVK,PRI,2001.0,1,0,1
NIC,PER,2021.0,1,0,1
NCL,ESP,2009.0,1,0,1
KWT,HRV,2018.0,1,0,1
PRI,,2006.0,34,0,34
CHL,CHN,2008.0,4,0,4
THA,NZL,1999.0,2,0,2
SWE,KWT,1997.0,3,0,3
USA,LBR,2006.0,2,0,2
HUN,RUS,1999.0,1,0,1
NPL,,1999.0,4,0,4
BMU,GBR,2000.0,1,0,1
ESP,BLR,1999.0,2,0,2
BOL,MEX,1998.0,2,0,2
NAM,DEU,1999.0,1,0,1
SWE,EGY,1998.0,2,0,2
OMN,,2026.0,32,0,32
ZMB,ZWE,2020.0,3,0,3
POL,KOR,2008.0,2,0,2
ISR,EST,2012.0,1,0,1
TUR,PSE,2013.0,4,0,4
POL,TUR,1998.0,1,0,1
CHE,HKG,2001.0,2,0,2
PAK,LBY,2008.0,1,0,1
,YEM,1994.0,23,0,23
YEM,ARE,1997.0,2,0,2
ROU,MDA,1998.0,3,0,3
ITA,PRY,1997.0,2,0,2
ZAF,ROU,2019.0,3,0,3
,AGO,2007.0,14,0,14
ISR,MEX,1997.0,2,0,2
TUR,GEO,2003.0,1,0,1
BEL,PSE,2007.0,1,0,1
,LBY,2000.0,20,0,20
CYM,JAM,2007.0,1,0,1
GRD,TTO,2007.0,1,0,1
ZAF,KWT,1997.0,1,0,1
HKG,SRB,2004.0,2,0,2
COL,HND,2003.0,1,0,1
ZAF,ARE,2006.0,2,0,2
FRA,NER,2008.0,3,0,3
NPL,EGY,2009.0,1,0,1
GBR,PRI,2009.0,2,0,2
MNE,NPL,2016.0,1,0,1
LKA,MNG,2017.0,1,0,1
PYF,,2022.0,21,0,21
IRN,MEX,2014.0,2,0,2
,AFG,2007.0,15,0,15
NGA,MEX,2016.0,3,0,3
MMR,LKA,2022.0,1,0,1
,BDI,2007.0,6,0,6
CHN,URY,2022.0,2,0,2
MAR,AUS,2014.0,2,0,2
NGA,TWN,2013.0,2,0,2
CHN,PRK,2014.0,3,0,3
IRQ,,2012.0,43,0,43
,SLE,2008.0,20,0,20
,LAO,2006.0,30,0,30
OMN,FLK,2004.0,1,0,1
FLK,TCA,2006.0,1,0,1
,GRD,2010.0,21,0,21
BRB,,2012.0,6,0,6
,OMN,2012.0,194,0,194
,NIC,2007.0,24,0,24
DOM,,2015.0,14,0,14
UZB,CHN,2014.0,2,0,2
ZAF,SDN,2021.0,5,0,5
,TLS,2008.0,3,0,3
BDI,,2016.0,8,0,8
AUT,EGY,2013.0,6,0,6
,DOM,2007.0,12,0,12
MYS,ETH,2019.0,6,0,6
,MAC,2012.0,130,0,130
KAZ,SYR,2019.0,1,0,1
YEM,,2020.0,48,0,48
KOR,LUX,2016.0,2,0,2
ECU,JPN,2000.0,1,0,1
NOR,ARE,2014.0,3,0,3
GUF,BRA,2014.0,1,0,1
SYR,,2013.0,60,0,60
,SYC,2007.0,4,0,4
ARG,ALB,2016.0,9,0,9
OMN,DZA,2017.0,2,0,2
PAN,,2018.0,35,0,35
PRI,COL,2023.0,4,0,4
NER,,2017.0,17,0,17
NPL,SLE,2020.0,2,0,2
FSM,USA,2022.0,3,0,3
PRY,AUS,2021.0,1,0,1
IND,MAC,2016.0,5,0,5
DNK,GHA,2016.0,4,0,4
LTU,TWN,2019.0,1,0,1
CUB,PRT,2018.0,1,0,1
,DMA,2014.0,8,0,8
LTU,AUS,2018.0,1,0,1
GRC,RUS,2016.0,4,0,4
MYS,GHA,2021.0,8,0,8
CMR,GAB,2017.0,2,0,2
TZA,MYS,2016.0,4,0,4
TCD,CMR,2016.0,2,0,2
ARG,SGP,2017.0,1,0,1
USA,GRL,2018.0,4,0,4
TUR,LUX,2017.0,2,0,2
MYS,PRT,2021.0,5,0,5
DEU,MUS,2019.0,1,0,1
CUW,,2023.0,6,0,6
MWI,LBR,2019.0,1,0,1
TCA,,2020.0,1,0,1
NPL,YEM,2022.0,1,0,1
EST,NOR,2020.0,4,0,4
DEU,BTN,2019.0,1,0,1
BFA,JPN,2021.0,1,0,1
IRN,ROU,2022.0,6,0,6
IND,KAZ,2013.0,1,0,1
BGR,IND,2023.0,1,0,1
GUM,CAN,2019.0,1,0,1
ARG,ROU,2019.0,1,0,1
,MCO,2016.0,13,0,13
,SLB,2016.0,14,0,14
CUB,MYS,2015.0,2,0,2
,GNQ,2016.0,8,0,8
,TKM,2020.0,2,0,2
TTO,GUY,2020.0,3,0,3
SWE,OMN,2020.0,3,0,3
VNM,NAM,2021.0,1,0,1
,TLS,2014.0,5,0,5
CHN,MWI,2020.0,3,0,3
NGA,BLR,2017.0,1,0,1
ETH,COD,2020.0,1,0,1
BRN,SGP,2022.0,1,0,1
TUN,RUS,2016.0,1,0,1
,REU,2015.0,13,0,13
BRA,QAT,2023.0,7,0,7
ITA,ZAF,2024.0,1,0,1
ATG,PRI,2022.0,1,0,1
,SWZ,2018.0,26,0,26
IRL,LVA,2010.0,2,0,2
CYM,,2025.0,21,0,21
BIH,NOR,2004.0,3,0,3
LIE,CHE,1997.0,1,0,1
ZAF,MLI,2007.0,1,0,1
NZL,LKA,1998.0,1,0,1
VEN,DEU,2015.0,7,0,7
ITA,SGP,2004.0,1,0,1
,PAN,2000.0,24,0,24
CYP,SAU,2013.0,1,0,1
GHA,,2009.0,30,0,30
GBR,FJI,1997.0,1,0,1
LUX,,2003.0,14,0,14
IRL,POL,2001.0,2,0,2
JAM,IRL,2010.0,1,0,1
BHR,TUR,2023.0,2,0,2
GBR,ATG,2003.0,1,0,1
ATG,USA,2006.0,1,0,1
POL,EGY,2008.0,3,0,3
BRA,BRN,2014.0,1,0,1
DOM,BRA,1998.0,1,0,1
NAM,MYS,2017.0,1,0,1
JOR,,2002.0,38,0,38
,CYM,1997.0,2,0,2
KWT,HKG,2002.0,1,0,1
NZL,BRN,2013.0,3,0,3
HTI,,2008.0,4,0,4
BGR,BRA,2004.0,1,0,1
ECU,TUR,2002.0,1,0,1
SWE,BHR,2003.0,1,0,1
PRI,RUS,2017.0,1,0,1
BLR,ITA,2008.0,3,0,3
ECU,,2001.0,7,0,7
USA,LKA,1998.0,9,0,9
GAB,USA,2008.0,2,0,2
,NER,1997.0,6,0,6
ETH,MEX,2013.0,1,0,1
,STP,1994.0,1,0,1
THA,RUS,2016.0,2,0,2
MWI,AUS,2001.0,2,0,2
HUN,ISR,2001.0,4,0,4
TWN,PRT,2007.0,1,0,1
BRA,GRC,2001.0,1,0,1
LVA,,2008.0,34,0,34
TTO,NLD,2010.0,1,0,1
SAU,LBN,2001.0,2,0,2
SGP,SRB,2006.0,1,0,1
,FJI,2000.0,23,0,23
,SUR,2010.0,10,0,10
COD,USA,2007.0,1,0,1
SWE,HKG,2006.0,2,0,2
LBR,USA,2003.0,1,0,1
BRN,IND,2007.0,2,0,2
MKD,MAC,2018.0,8,0,8
,ASM,2010.0,2,0,2
IRQ,HUN,2014.0,1,0,1
PRT,ARE,2014.0,4,0,4
SGP,KGZ,2021.0,1,0,1
ARG,FIN,2020.0,5,0,5
,LBY,2010.0,46,0,46
ESP,MAC,2012.0,1,0,1
IRL,LUX,2017.0,1,0,1
BFA,SEN,2005.0,2,0,2
ALB,,2017.0,75,0,75
USA,GLP,2014.0,2,0,2
GLP,GRD,2015.0,1,0,1
ZMB,FRA,2022.0,1,0,1
FRA,THA,2010.0,22,8,14
BEL,POL,2014.0,11,11,0
COL,FRA,2015.0,20,18,2
KHM,NZL,2016.0,1,1,0
FRA,ECU,2011.0,7,4,3
USA,UKR,2017.0,21,25,-4
FIN,NLD,2009.0,15,17,-2
GBR,LTU,2018.0,8,13,-5
CHE,TWN,2022.0,12,6,6
GBR,MWI,2015.0,21,15,6
DEU,BEN,2008.0,3,1,2
MEX,DEU,2013.0,39,35,4
ISR,PRT,2019.0,6,3,3
SAU,LBN,2016.0,6,7,-1
EST,DEU,2015.0,8,5,3
USA,ZWE,2019.0,12,9,3
THA,CHN,2011.0,12,5,7
RUS,NLD,2016.0,27,19,8
VNM,PAK,2021.0,13,1,12
ESP,TUR,2011.0,9,13,-4
PRT,AUS,2016.0,16,8,8
MLI,FRA,2013.0,7,3,4
CAN,MEX,2013.0,32,35,-3
DEU,MNG,2015.0,3,1,2
SVN,SLV,2011.0,8,11,-3
THA,NLD,2013.0,8,10,-2
DNK,CHE,2017.0,32,30,2
ARG,DEU,2017.0,36,28,8
CZE,SVK,2020.0,62,101,-39
HRV,CHE,2014.0,9,4,5
SAU,TUN,2018.0,39,123,-84
EGY,ESP,2012.0,8,8,0
CHE,TZA,2019.0,3,10,-7
POL,KOR,2016.0,5,1,4
TUR,GBR,2014.0,46,54,-8
AUS,ITA,2023.0,27,15,12
GRC,ESP,2010.0,19,8,11
ZAF,ESP,2011.0,3,4,-1
MYS,IDN,2021.0,98,60,38
MAR,COG,2015.0,2,1,1
MYS,SGP,2018.0,24,16,8
SAU,CHE,2019.0,7,7,0
SWE,ETH,2019.0,4,3,1
JOR,MYS,2015.0,8,18,-10
GHA,CAN,2021.0,10,8,2
AUT,SGP,2023.0,2,3,-1
NZL,FRA,2019.0,17,22,-5
CHE,CAN,2021.0,97,126,-29
ZAF,MAR,2023.0,2,3,-1
JPN,PHL,2013.0,27,18,9
GBR,ETH,2021.0,14,10,4
GBR,ARG,2016.0,28,16,12
AUT,MNG,2020.0,3,2,1
PRI,ESP,2006.0,2,5,-3
CHL,GBR,2014.0,30,46,-16
SAU,NLD,2007.0,2,3,-1
COL,FRA,2014.0,21,24,-3
THA,AFG,2014.0,1,1,0
MLT,USA,2018.0,4,3,1
IRL,KOR,2010.0,6,6,0
CHE,ARE,2021.0,6,4,2
CAN,KWT,2019.0,17,10,7
NLD,TUR,2016.0,29,27,2
JPN,MEX,2015.0,10,6,4
SWE,GRC,2022.0,19,19,0
DNK,HUN,2015.0,2,2,0
ZAF,KEN,2015.0,14,19,-5
USA,KAZ,2017.0,27,17,10
SWE,SVN,2021.0,6,5,1
MWI,GBR,2014.0,14,16,-2
CHN,ISR,2007.0,5,13,-8
AUT,AUS,2020.0,33,55,-22
DNK,LTU,2021.0,3,6,-3
NPL,BGD,2014.0,3,2,1
AUS,FJI,2019.0,12,11,1
ISR,DEU,2016.0,49,51,-2
SAU,YEM,2019.0,6,6,0
ITA,PAK,2019.0,28,14,14
ITA,RUS,2019.0,20,29,-9
OMN,PAK,2014.0,3,11,-8
CZE,PER,2021.0,1,1,0
MEX,SLV,2017.0,2,3,-1
GBR,IDN,2017.0,35,17,18
ITA,NGA,2023.0,2,5,-3
MWI,NLD,2017.0,3,3,0
LUX,DEU,2021.0,26,44,-18
PER,MEX,2017.0,5,10,-5
PRT,ISR,2017.0,3,3,0
UKR,GBR,2017.0,28,23,5
ITA,RUS,2021.0,24,26,-2
UKR,JPN,2015.0,5,4,1
POL,CHN,2023.0,12,22,-10
MYS,SGP,2017.0,24,25,-1
NGA,BEN,2018.0,10,7,3
FIN,ESP,2021.0,22,16,6
DEU,CRI,2015.0,8,5,3
DEU,NZL,2011.0,39,34,5
POL,BRA,2007.0,2,2,0
ISR,RUS,1997.0,9,15,-6
DEU,HRV,2014.0,15,18,-3
JPN,ESP,1998.0,5,11,-6
USA,BGR,2015.0,13,18,-5
GEO,CAN,1999.0,1,2,-1
CAN,NLD,2008.0,43,52,-9
FRA,IND,2007.0,34,44,-10
CHL,BEL,2013.0,8,7,1
ESP,IRL,2005.0,9,4,5
SGP,MMR,2021.0,2,3,-1
NZL,DEU,2003.0,16,20,-4
NLD,ROU,2021.0,6,4,2
SVN,AUT,2006.0,2,3,-1
FIN,GBR,2022.0,63,80,-17
BEL,HUN,1998.0,6,3,3
FRA,ROU,2014.0,31,39,-8
ARG,CHL,2004.0,5,8,-3
NGA,DEU,2002.0,6,8,-2
ROU,AUS,2002.0,2,1,1
EGY,CAN,2003.0,5,13,-8
SWE,SRB,2014.0,3,6,-3
USA,VIR,2008.0,6,4,2
DEU,BGR,2008.0,23,24,-1
MOZ,ITA,2010.0,1,1,0
BGR,BEL,1998.0,7,3,4
RUS,LVA,1997.0,5,6,-1
SVN,CAN,1999.0,3,1,2
NOR,SWE,2004.0,33,55,-22
EGY,KWT,1999.0,7,10,-3
GUY,GUF,2007.0,3,1,2
CAN,NOR,2001.0,5,14,-9
RUS,ITA,2003.0,23,40,-17
MAR,FRA,1998.0,26,72,-46
CZE,SVN,2003.0,2,2,0
UGA,GBR,1997.0,6,3,3
HUN,GBR,1999.0,19,19,0
SRB,HUN,2006.0,6,10,-4
POL,FRA,2005.0,37,37,0
TUR,CAN,2000.0,14,7,7
CAN,VEN,2001.0,3,14,-11
NLD,ARG,2002.0,3,9,-6
FIN,LUX,2016.0,2,2,0
ZAF,NOR,2011.0,5,4,1
FRA,MAR,2023.0,38,34,4
USA,BWA,2001.0,1,5,-4
DNK,TUR,2004.0,3,2,1
CZE,BRA,2004.0,1,1,0
FRA,POL,2006.0,31,37,-6
ITA,BGR,2005.0,6,2,4
CHL,PER,2021.0,14,11,3
IDN,AUS,2022.0,50,61,-11
DEU,UZB,2021.0,10,1,9
COL,GBR,2017.0,15,22,-7
HRV,DNK,2019.0,3,3,0
THA,NGA,2020.0,6,1,5
ITA,LUX,2017.0,16,7,9
SWE,IRN,2022.0,19,45,-26
JPN,NPL,2014.0,12,8,4
CAN,IDN,2015.0,8,2,6
MEX,COL,2017.0,46,36,10
PHL,IDN,2019.0,4,4,0
FRA,SRB,2022.0,5,4,1
CHN,BGD,2017.0,26,29,-3
KOR,BGD,2012.0,14,19,-5
JAM,USA,2001.0,7,13,-6
AUS,ETH,2016.0,3,14,-11
CHL,GRC,2022.0,1,1,0
MKD,AUT,2011.0,1,1,0
TZA,DNK,2002.0,4,4,0
BRA,SWE,2014.0,15,15,0
CZE,IND,2022.0,22,31,-9
NOR,NGA,2018.0,3,1,2
SVK,AUT,2009.0,10,3,7
GBR,KEN,2003.0,15,9,6
VNM,KOR,2015.0,16,52,-36
HKG,CAN,2005.0,30,16,14
EST,ITA,2003.0,2,1,1
POL,CHE,2001.0,12,15,-3
GBR,SVK,2002.0,16,12,4
RUS,KOR,2006.0,14,18,-4
PAK,SAU,2006.0,7,11,-4
ITA,FIN,2010.0,21,9,12
PAK,DEU,2007.0,16,7,9
TWN,JPN,2003.0,22,41,-19
ARE,DEU,2006.0,2,2,0
NOR,ESP,2015.0,8,28,-20
KHM,AUS,2003.0,1,2,-1
PHL,JPN,2003.0,11,21,-10
CHE,SGP,2007.0,9,4,5
RUS,JPN,2008.0,21,22,-1
ARG,GBR,2005.0,10,9,1
HUN,CHN,2002.0,1,1,0
ESP,COL,1998.0,10,1,9
CHE,CHN,2010.0,29,36,-7
CAN,AUT,2011.0,25,21,4
ARG,VEN,1999.0,2,2,0
IND,THA,1997.0,2,2,0
SRB,SWE,2004.0,3,7,-4
ITA,NGA,2000.0,5,1,4
KEN,USA,2012.0,45,51,-6
TWN,RUS,2001.0,5,6,-1
PAK,GBR,2015.0,58,90,-32
DEU,EGY,2005.0,32,7,25
NCL,USA,2013.0,1,1,0
FIN,AUT,2003.0,5,4,1
ARE,ZAF,2009.0,1,2,-1
CZE,ZAF,2015.0,3,1,2
ARE,JOR,2011.0,3,13,-10
KEN,JPN,2018.0,6,6,0
AUS,QAT,2012.0,5,3,2
ISR,NLD,2013.0,10,9,1
JPN,IRN,2005.0,19,12,7
SWE,SGP,2016.0,17,9,8
JOR,SYR,2017.0,1,3,-2
ROU,DNK,2013.0,4,3,1
CAN,NOR,2015.0,18,22,-4
FIN,SWE,2014.0,52,43,9
CAN,TWN,2014.0,10,13,-3
HKG,GBR,2010.0,40,37,3
AUT,PAK,2016.0,14,5,9
CAN,COL,2017.0,23,24,-1
CRI,GBR,2016.0,2,1,1
LVA,CHE,2015.0,5,1,4
BGD,AUS,2012.0,32,9,23
PHL,JPN,2013.0,18,27,-9
JPN,SWE,2015.0,25,18,7
IRN,AUS,2008.0,27,36,-9
SWE,ESP,2014.0,42,62,-20
PRT,HUN,2015.0,1,1,0
CZE,IND,2016.0,15,15,0
IRN,SGP,2012.0,8,4,4
NOR,ETH,2018.0,9,6,3
CAN,BOL,2018.0,1,1,0
CHN,COL,2020.0,3,1,2
GBR,GEO,2018.0,3,2,1
LBY,AUS,2020.0,1,1,0
CHE,ZAF,2018.0,14,18,-4
CUB,BRA,2019.0,12,8,4
SRB,SWE,2014.0,6,3,3
OMN,PAK,2015.0,6,11,-5
RUS,VNM,2019.0,19,5,14
ARG,MEX,2020.0,22,28,-6
THA,FIN,2018.0,2,4,-2
BEN,TGO,2019.0,3,1,2
PER,MEX,2018.0,3,10,-7
FRA,ZAF,2023.0,12,11,1
MLT,GBR,2020.0,9,27,-18
UGA,BEL,2021.0,4,6,-2
RUS,ISR,2023.0,16,6,10
TUR,NOR,2020.0,22,8,14
DEU,COL,2019.0,25,23,2
IRL,DNK,2003.0,2,4,-2
GBR,TUN,2022.0,2,1,1
NLD,HKG,2023.0,3,5,-2
NZL,DNK,2023.0,6,6,0
GBR,OMN,2019.0,18,10,8
HKG,GHA,2022.0,5,1,4
SAU,AUS,2016.0,16,62,-46
GBR,UKR,2014.0,26,30,-4
CMR,ITA,2018.0,3,5,-2
PHL,GBR,2015.0,7,3,4
AUT,AUS,1998.0,37,23,14
ESP,ETH,2018.0,5,4,1
KOR,ITA,2015.0,12,13,-1
NLD,MEX,2003.0,5,3,2
AUS,ITA,2006.0,19,27,-8
NLD,NZL,1998.0,7,9,-2
NPL,USA,2015.0,18,18,0
CHL,PER,2011.0,5,4,1
DEU,MNG,2001.0,4,1,3
BEL,DNK,2017.0,18,16,2
CRI,CAN,2018.0,1,4,-3
BRA,ESP,1997.0,15,25,-10
IRL,NOR,2008.0,4,2,2
GBR,BRB,2014.0,2,1,1
IND,MEX,2013.0,5,5,0
FIN,ISR,2003.0,2,2,0
AUT,CAN,2001.0,21,14,7
AUS,IND,2005.0,15,47,-32
BEL,BRA,2005.0,6,11,-5
PAK,JPN,2007.0,11,12,-1
IDN,JPN,1998.0,8,16,-8
POL,BGR,2002.0,2,2,0
RUS,POL,2018.0,16,15,1
FJI,AUS,2003.0,6,6,0
NLD,JPN,2016.0,25,21,4
CHE,LIE,2013.0,3,1,2
BLR,ITA,1998.0,3,2,1
BLR,RUS,2010.0,25,22,3
HRV,USA,1997.0,11,12,-1
RUS,AUS,2002.0,18,8,10
SVK,USA,2008.0,21,14,7
USA,JOR,1998.0,20,9,11
PRT,AUT,2010.0,5,6,-1
NOR,FRA,2004.0,13,21,-8
DEU,SAU,2008.0,4,2,2
DNK,NOR,2017.0,66,33,33
EGY,GBR,1998.0,7,10,-3
SVK,CZE,2009.0,45,27,18
JPN,CAN,2013.0,91,94,-3
NZL,LKA,2015.0,3,3,0
IRL,ISR,2013.0,5,5,0
IRL,JPN,2000.0,4,5,-1
NOR,RUS,2023.0,5,9,-4
POL,ITA,1997.0,10,10,0
RUS,BEL,2020.0,17,7,10
CAN,NOR,2011.0,15,9,6
GBR,GAB,2006.0,1,1,0
HUN,DNK,1998.0,2,2,0
GBR,BEL,2018.0,113,176,-63
DEU,HUN,2014.0,39,58,-19
CAN,ISR,2000.0,21,36,-15
ROU,ITA,2015.0,17,25,-8
URY,ARG,2009.0,10,3,7
NZL,IRL,2000.0,2,2,0
CHE,IRL,2005.0,7,4,3
NAM,KEN,1999.0,1,1,0
FRA,AUT,1999.0,14,15,-1
USA,SYR,2000.0,5,2,3
ISR,ITA,2002.0,26,11,15
JPN,PRT,2017.0,3,2,1
POL,RUS,2006.0,8,14,-6
EGY,JOR,2015.0,2,2,0
JOR,EGY,2019.0,6,5,1
BLR,SWE,2002.0,2,1,1
ESP,RUS,2005.0,9,14,-5
AUT,LIE,2015.0,2,1,1
UKR,FRA,1999.0,9,3,6
NZL,GBR,2022.0,88,97,-9
ZAF,NOR,2001.0,4,4,0
JPN,POL,2009.0,16,11,5
CAN,EGY,2016.0,46,33,13
USA,ZWE,2014.0,13,6,7
HTI,USA,2019.0,13,9,4
IND,CHN,2013.0,35,27,8
MYS,TWN,2018.0,15,11,4
ROU,MDA,2015.0,6,1,5
IRN,GBR,2010.0,33,53,-20
JOR,USA,2021.0,70,50,20
DEU,LUX,2015.0,33,19,14
NLD,POL,2015.0,10,18,-8
COL,ESP,2012.0,62,92,-30
IND,FIN,2016.0,17,10,7
NZL,SGP,2013.0,11,4,7
TUR,MYS,2014.0,2,2,0
RUS,GBR,2014.0,52,53,-1
ITA,PAK,2015.0,21,10,11
BRA,FIN,2018.0,13,6,7
BEL,POL,2009.0,9,6,3
ETH,NLD,2014.0,13,6,7
NZL,FIN,2018.0,2,4,-2
MEX,BRA,2004.0,9,8,1
BRA,MEX,2012.0,14,15,-1
ARG,BRA,2017.0,40,48,-8
CMR,USA,2019.0,9,6,3
BRA,FRA,2015.0,122,143,-21
FRA,RUS,2010.0,30,55,-25
MEX,IND,2013.0,5,5,0
FRA,SEN,2016.0,37,48,-11
PAK,GBR,2011.0,48,62,-14
AUS,TZA,2013.0,2,2,0
GBR,KOR,2023.0,40,48,-8
CHE,TZA,2015.0,9,3,6
FRA,JPN,2015.0,113,84,29
MKD,MAC,2019.0,7,2,5
NLD,FRA,2017.0,104,114,-10
CAN,NOR,2021.0,34,14,20
CHE,NOR,2009.0,18,8,10
JPN,AUS,1997.0,33,39,-6
USA,TZA,2014.0,18,15,3
DNK,ISL,2008.0,2,3,-1
BEL,ESP,2010.0,51,30,21
ITA,POL,2018.0,38,16,22
COL,CUB,2014.0,5,6,-1
AUT,THA,2009.0,7,2,5
MDA,ROU,2021.0,4,7,-3
IND,BRA,2017.0,28,11,17
NOR,FIN,2012.0,9,14,-5
CHE,SWE,2023.0,33,43,-10
SGP,TWN,2004.0,7,5,2
ITA,AUT,2012.0,35,35,0
KOR,IDN,2018.0,38,11,27
NLD,ECU,2017.0,2,4,-2
NGA,USA,2011.0,44,25,19
CRI,USA,2012.0,24,29,-5
SAU,JPN,2015.0,5,20,-15
GBR,PAK,2012.0,98,47,51
MAC,GBR,2017.0,1,3,-2
USA,ETH,2021.0,32,23,9
JPN,GRC,2010.0,5,4,1
IRN,KOR,2017.0,23,12,11
KEN,IND,2008.0,1,1,0
VNM,AUS,2018.0,27,43,-16
IRL,KOR,2013.0,3,2,1
THA,NLD,2006.0,2,7,-5
MYS,NGA,2016.0,48,50,-2
MEX,BRA,2015.0,24,22,2
IRN,MYS,2011.0,57,59,-2
KEN,DEU,2019.0,14,23,-9
MEX,ARG,2017.0,29,31,-2
CAN,EGY,2022.0,42,44,-2
NGA,IND,2011.0,11,4,7
NZL,CHE,2022.0,8,9,-1
IRN,NLD,2016.0,38,14,24
IRL,IRN,2018.0,7,14,-7
SYR,EGY,2011.0,1,3,-2
JOR,IND,2017.0,4,3,1
LUX,DEU,2014.0,23,43,-20
ESP,JOR,2017.0,2,1,1
VNM,GBR,2012.0,13,22,-9
BEN,NLD,2012.0,2,3,-1
LKA,USA,2012.0,17,12,5
KOR,ZAF,2020.0,6,7,-1
FRA,MTQ,2011.0,24,10,14
USA,MWI,2014.0,16,20,-4
SVK,ITA,2023.0,2,2,0
ZAF,ZWE,2011.0,10,17,-7
RUS,IRL,2021.0,9,4,5
CHN,GHA,2014.0,5,7,-2
PRT,AUS,2020.0,10,8,2
MAR,FRA,2017.0,50,99,-49
RUS,DNK,2015.0,9,3,6
CYP,USA,2014.0,12,18,-6
NPL,ITA,2010.0,1,1,0
AUS,LKA,2011.0,10,12,-2
FRA,EGY,2018.0,28,14,14
KEN,DEU,2011.0,9,16,-7
ESP,IDN,2022.0,2,3,-1
ITA,TUR,2014.0,18,14,4
THA,PAK,2012.0,10,1,9
USA,TZA,2015.0,25,17,8
ITA,ARE,2019.0,18,5,13
AZE,IRN,2012.0,3,2,1
USA,ZWE,2015.0,9,20,-11
HKG,GBR,2013.0,47,65,-18
CHL,AUT,2017.0,3,2,1
UKR,ITA,2016.0,8,2,6
LTU,CAN,2023.0,4,1,3
DEU,JPN,2014.0,131,141,-10
AUS,FRA,2008.0,60,90,-30
TUR,DEU,2008.0,31,31,0
KOR,MYS,2017.0,13,28,-15
CHL,VEN,2014.0,8,4,4
GBR,BGD,2013.0,12,12,0
SVN,AUT,2013.0,9,3,6
MEX,CUB,2020.0,9,34,-25
CZE,FRA,2020.0,28,37,-9
CAN,NLD,2019.0,86,75,11
POL,UKR,2019.0,32,39,-7
MEX,COL,2020.0,78,47,31
NGA,NER,2018.0,9,12,-3
FRA,MLI,2011.0,7,5,2
SGP,AUS,2012.0,74,62,12
LTU,BEL,2014.0,1,1,0
ESP,SGP,2015.0,9,5,4
GRC,IRL,2014.0,7,4,3
JOR,GBR,2017.0,12,27,-15
BLR,JPN,2010.0,1,1,0
ESP,EGY,2013.0,6,2,4
GRC,PRT,2016.0,5,2,3
SRB,MNE,2020.0,13,47,-34
GRC,TUR,2016.0,7,4,3
GBR,GEO,2020.0,2,2,0
MYS,YEM,2014.0,7,5,2
CAN,ARG,2016.0,16,25,-9
DEU,MKD,2013.0,1,2,-1
USA,KWT,2016.0,24,6,18
SAU,GBR,2015.0,36,124,-88
MMR,SGP,2021.0,3,2,1
NLD,FRA,2018.0,121,120,1
SAU,NGA,2018.0,6,9,-3
ROU,HUN,2011.0,9,6,3
CHN,ISR,2017.0,25,26,-1
CYP,GRC,2015.0,15,46,-31
USA,CUB,2011.0,8,12,-4
CMR,DEU,2021.0,5,3,2
FRA,CMR,2020.0,33,12,21
FRA,KOR,2012.0,16,19,-3
CHE,HKG,2020.0,8,7,1
KEN,ZWE,2011.0,1,1,0
NZL,CHE,2016.0,16,12,4
PRT,DNK,2023.0,2,4,-2
LKA,GBR,2013.0,10,17,-7
FRA,CIV,2013.0,42,25,17
JPN,BEL,2015.0,19,13,6
ISR,IRN,2011.0,2,1,1
SWE,ESP,2019.0,48,92,-44
CUB,PRT,2011.0,3,1,2
BRA,ECU,2022.0,14,8,6
UKR,CHE,2014.0,6,2,4
NCL,FRA,2020.0,51,37,14
COG,USA,2015.0,6,4,2
COL,BRA,2003.0,8,7,1
KEN,UGA,2011.0,4,5,-1
DEU,CHL,2014.0,46,21,25
CHN,NOR,2016.0,37,26,11
JPN,THA,2010.0,88,70,18
CHN,MAC,2013.0,46,22,24
ESP,HRV,2019.0,6,6,0
IRQ,IRN,2017.0,5,14,-9
ITA,AUS,2007.0,21,20,1
ESP,IRN,2011.0,10,6,4
ARE,IND,2017.0,18,81,-63
ESP,CHL,2012.0,84,47,37
QAT,CAN,2016.0,13,30,-17
ROU,ITA,2014.0,18,10,8
SVN,DNK,2015.0,5,1,4
AUS,SWE,2015.0,65,44,21
FRA,IND,2022.0,61,114,-53
IND,ETH,2015.0,35,11,24
USA,VNM,2012.0,21,18,3
KOR,NLD,2018.0,15,8,7
GBR,DZA,2016.0,7,2,5
IRN,AUS,2011.0,61,39,22
AUS,IRN,2016.0,43,146,-103
ZAF,USA,2017.0,143,113,30
GRC,BEL,2013.0,33,8,25
IRN,NOR,2018.0,14,5,9
UKR,BRA,2018.0,3,2,1
JPN,NPL,2019.0,14,6,8
HKG,DEU,2021.0,28,22,6
AZE,RUS,2017.0,6,8,-2
FRA,AUT,2020.0,53,34,19
HRV,AUS,2018.0,1,3,-2
HUN,NOR,2015.0,2,1,1
TUR,IRN,2019.0,17,35,-18
ESP,BRA,2006.0,29,25,4
ISR,FRA,2016.0,30,35,-5
NLD,IDN,2017.0,48,16,32
LAO,USA,2015.0,3,5,-2
THA,KOR,2015.0,8,13,-5
KAZ,GBR,2017.0,6,7,-1
FRA,BFA,2014.0,20,16,4
LUX,KOR,2019.0,3,1,2
NZL,IRL,2023.0,5,3,2
BRA,CHE,2002.0,8,10,-2
GBR,LKA,2020.0,28,18,10
CHL,GBR,2021.0,65,60,5
DEU,PER,2021.0,6,6,0
NGA,IND,2019.0,19,11,8
POL,CAN,2014.0,19,16,3
PRT,PHL,2020.0,1,1,0
DNK,ITA,2005.0,11,16,-5
GBR,LUX,2019.0,23,6,17
IRL,NZL,2004.0,5,7,-2
FRA,COL,2014.0,24,21,3
MDA,ROU,2019.0,5,4,1
SRB,HRV,2020.0,17,14,3
ARG,CHE,2023.0,8,5,3
CAN,TUR,2019.0,19,49,-30
IRL,BRA,2021.0,12,28,-16
UKR,GBR,2020.0,13,18,-5
NOR,DNK,2016.0,28,45,-17
LUX,BEL,2010.0,6,16,-10
SWE,NZL,2016.0,9,12,-3
CAN,KWT,2015.0,20,10,10
NOR,TZA,2014.0,11,1,10
NZL,FIN,2022.0,6,1,5
KOR,ISR,2013.0,7,2,5
NGA,MLI,2015.0,1,1,0
CHN,EGY,2016.0,20,13,7
NGA,IND,2009.0,4,5,-1
CAN,CZE,2015.0,11,8,3
ROU,DEU,2014.0,42,24,18
FRA,ROU,2011.0,35,39,-4
FRA,JPN,2014.0,97,81,16
NLD,GRC,2019.0,28,33,-5
ARG,DEU,2020.0,39,28,11
DEU,ARG,2021.0,22,54,-32
MNG,AUT,2020.0,2,3,-1
BRA,ITA,2019.0,67,63,4
ESP,PER,2015.0,22,11,11
FIN,CHN,2016.0,38,22,16
GBR,UGA,2018.0,23,13,10
IRN,NLD,2018.0,50,29,21
IRQ,THA,2019.0,2,1,1
CZE,VNM,2019.0,10,1,9
ESP,SVN,2017.0,3,8,-5
KAZ,RUS,2016.0,44,39,5
NLD,IND,2019.0,26,52,-26
CHN,NZL,2014.0,26,28,-2
KAZ,RUS,2017.0,56,58,-2
SAU,USA,2012.0,58,131,-73
FRA,MCO,2019.0,22,5,17
SWE,IND,2012.0,18,48,-30
CHN,CZE,2018.0,14,13,1
IND,PAK,2019.0,53,37,16
NZL,VNM,2016.0,3,2,1
NLD,JPN,2017.0,22,31,-9
CZE,CAN,2012.0,6,10,-4
ITA,JPN,2005.0,20,23,-3
USA,CZE,2023.0,38,48,-10
TUR,BEL,2015.0,12,8,4
PAK,AUS,2018.0,45,23,22
DNK,VNM,2020.0,7,2,5
USA,BGD,2021.0,66,169,-103
ZAF,CAN,2020.0,43,18,25
BIH,SRB,2015.0,10,26,-16
VNM,PHL,2018.0,1,2,-1
AUT,THA,2021.0,7,1,6
CAN,JPN,2020.0,100,69,31
GRC,CAN,2021.0,15,7,8
BOL,GBR,2020.0,1,1,0
USA,LTU,2019.0,6,6,0
CHN,LKA,2020.0,11,3,8
GBR,VNM,2023.0,13,11,2
ESP,ECU,2015.0,60,9,51
NPL,SWE,2022.0,2,3,-1
LKA,AUS,2017.0,26,18,8
USA,QAT,2021.0,38,58,-20
NOR,SWE,2011.0,50,76,-26
FRA,IND,2016.0,87,93,-6
MEX,ARG,2022.0,10,10,0
SWE,IDN,2018.0,4,3,1
IRN,CHE,2012.0,23,9,14
CHE,IRN,2022.0,15,28,-13
GBR,PAK,2002.0,27,11,16
IRQ,USA,2015.0,11,13,-2
LTU,FRA,2015.0,5,3,2
DEU,DZA,2004.0,5,4,1
DEU,SAU,2015.0,25,6,19
GBR,KWT,2018.0,24,7,17
HKG,BGD,2022.0,6,5,1
ESP,ROU,2014.0,6,8,-2
CAN,CHL,2016.0,23,23,0
DEU,UZB,2014.0,5,1,4
URY,ARG,2021.0,9,21,-12
GMB,GBR,2016.0,8,8,0
TTO,JAM,2015.0,9,7,2
GBR,TUR,2003.0,58,22,36
MEX,ECU,2020.0,15,10,5
GBR,ARG,2020.0,18,31,-13
GBR,IRQ,2015.0,35,17,18
HKG,SGP,2015.0,36,29,7
SAU,DZA,2019.0,8,15,-7
BGD,NPL,2017.0,1,1,0
TUR,IRN,2021.0,24,67,-43
AUS,BRA,2019.0,38,64,-26
VNM,DEU,2022.0,15,13,2
CZE,NPL,2018.0,1,1,0
PRT,JPN,2021.0,4,1,3
ZAF,GHA,2018.0,17,19,-2
TUR,JPN,2018.0,11,12,-1
NGA,PAK,2020.0,3,2,1
PRT,BEL,2015.0,25,7,18
TUR,FRA,2008.0,9,17,-8
DNK,JPN,2017.0,6,12,-6
EST,DEU,2021.0,16,11,5
NLD,NZL,2016.0,17,23,-6
CZE,IRN,2017.0,1,4,-3
QAT,PAK,2021.0,7,10,-3
DEU,MAR,2020.0,8,5,3
PAK,BEL,2019.0,4,5,-1
DNK,USA,2015.0,135,173,-38
IRN,NLD,2022.0,51,16,35
USA,MNP,2019.0,3,1,2
MYS,FRA,2022.0,10,6,4
GBR,LBY,2017.0,6,3,3
DEU,ARG,2011.0,30,30,0
MAR,CAN,2022.0,14,13,1
TUR,ESP,2021.0,22,14,8
ITA,SYR,2020.0,3,1,2
THA,CHN,2001.0,3,1,2
PAK,FIN,2021.0,4,3,1
SAU,PAK,2020.0,71,95,-24
CAN,COG,2020.0,2,1,1
BFA,ZAF,2019.0,1,2,-1
CHN,NZL,2015.0,17,25,-8
KOR,MYS,2018.0,16,20,-4
SDN,TUR,2020.0,4,2,2
ZAF,KEN,2009.0,9,4,5
SRB,ESP,2018.0,5,3,2
CAN,ISR,2023.0,38,36,2
PAK,HKG,2017.0,11,2,9
EGY,ITA,2019.0,12,29,-17
TZA,UGA,2020.0,8,3,5
MWI,GBR,2009.0,15,16,-1
CAN,KEN,2020.0,7,7,0
GRC,POL,2021.0,4,2,2
ZAF,IND,2021.0,45,31,14
TZA,SWE,2017.0,7,7,0
ITA,CUB,2010.0,7,5,2
CHE,SGP,2017.0,24,23,1
POL,TUR,2015.0,2,2,0
AUS,KOR,2018.0,31,68,-37
ITA,LVA,2022.0,4,8,-4
IND,DNK,2018.0,21,15,6
MEX,PER,2018.0,10,3,7
SGP,ARE,2008.0,4,2,2
FRA,HUN,2018.0,20,13,7
IRN,ESP,2019.0,38,13,25
COG,KEN,2019.0,3,1,2
AUS,LKA,2021.0,32,43,-11
UZB,RUS,2018.0,8,9,-1
IRN,ZAF,2023.0,5,2,3
HKG,TWN,2017.0,11,16,-5
AZE,RUS,2018.0,5,6,-1
ZAF,SDN,2018.0,5,2,3
NGA,IRL,2018.0,1,2,-1
JOR,GBR,2018.0,17,43,-26
MAR,ITA,2020.0,6,4,2
JPN,ARE,2021.0,4,3,1
IRL,SWE,2018.0,9,10,-1
ZWE,TZA,2021.0,3,1,2
USA,ECU,2020.0,39,34,5
IND,BRA,2022.0,9,12,-3
DEU,SVN,2017.0,8,10,-2
VNM,DEU,2017.0,12,21,-9
USA,KWT,2018.0,29,9,20
GBR,BRB,2019.0,2,2,0
ETH,TWN,2019.0,5,7,-2
NPL,NOR,2019.0,3,4,-1
GRC,ARE,2020.0,5,5,0
ESP,NOR,2017.0,28,18,10
DEU,COL,2015.0,24,6,18
KOR,MYS,2016.0,13,19,-6
GHA,USA,2023.0,35,21,14
PRT,ECU,2022.0,2,1,1
KHM,GBR,2016.0,3,3,0
CAN,KWT,2014.0,16,2,14
MEX,PER,2017.0,10,5,5
CZE,GBR,2017.0,44,38,6
FRA,CHN,2009.0,70,110,-40
CAN,TWN,2019.0,13,18,-5
VNM,JPN,2018.0,32,110,-78
COD,COG,2021.0,69,139,-70
SGP,IDN,2020.0,11,10,1
NLD,GHA,2019.0,5,4,1
SVK,ESP,2013.0,2,2,0
ARG,CZE,2017.0,1,2,-1
ISR,ITA,2012.0,12,16,-4
NLD,SWE,2001.0,41,35,6
EST,NOR,2015.0,4,2,2
GBR,MYS,1999.0,47,21,26
FIN,JPN,2003.0,20,14,6
SVK,POL,2001.0,2,6,-4
LBN,GBR,2005.0,3,6,-3
NOR,NZL,2005.0,2,1,1
USA,CUB,2019.0,7,20,-13
USA,SAU,1999.0,33,27,6
POL,DNK,1998.0,4,2,2
AUT,CHE,2004.0,26,32,-6
DEU,UZB,2008.0,1,3,-2
ISL,USA,2001.0,12,23,-11
TWN,RUS,2009.0,2,7,-5
ARG,FRA,2002.0,25,19,6
NLD,CAN,2012.0,60,73,-13
DEU,HKG,2007.0,8,13,-5
DNK,NOR,2016.0,45,28,17
BEL,GBR,2000.0,71,82,-11
CHE,SVK,2007.0,7,3,4
MYS,DEU,2008.0,3,5,-2
HUN,CAN,2000.0,8,10,-2
AUS,MEX,2005.0,3,1,2
BLR,BEL,2007.0,3,2,1
SWE,CZE,2015.0,12,7,5
DNK,SRB,1999.0,4,3,1
VNM,USA,2008.0,4,17,-13
ISL,NOR,2012.0,10,1,9
USA,HRV,1998.0,14,16,-2
USA,VCT,2017.0,2,1,1
GRC,DEU,1997.0,21,28,-7
ROU,GBR,2000.0,19,6,13
URY,USA,2001.0,11,6,5
IRL,CAN,2000.0,13,8,5
NOR,NLD,2000.0,13,20,-7
NLD,NOR,2002.0,21,18,3
GEO,USA,2002.0,50,41,9
GBR,SRB,1998.0,4,14,-10
ITA,CHE,2000.0,94,77,17
CAN,GRC,2000.0,11,3,8
TUR,FRA,2004.0,13,4,9
GBR,CYP,2007.0,17,5,12
ITA,DNK,2009.0,29,18,11
ZAF,DNK,2017.0,5,2,3
JPN,ZAF,2003.0,2,6,-4
CAN,ROU,1998.0,2,5,-3
DEU,MAR,2007.0,6,5,1
GRC,SAU,2015.0,5,1,4
CZE,SWE,2006.0,6,3,3
SWE,CZE,2008.0,11,8,3
CHL,DEU,1999.0,15,7,8
AUT,NLD,2007.0,14,15,-1
ESP,TWN,2014.0,4,3,1
URY,USA,2015.0,11,18,-7
GRC,FIN,2014.0,3,1,2
FRA,CMR,1998.0,7,14,-7
IND,BGR,2016.0,1,2,-1
NLD,CAN,2005.0,45,39,6
COG,ZWE,2007.0,2,1,1
NZL,ITA,2007.0,5,4,1
ESP,CHE,2007.0,23,43,-20
RUS,AUT,1998.0,7,9,-2
BEL,CAN,1998.0,16,17,-1
AUS,ESP,2008.0,16,15,1
GLP,FRA,2005.0,12,20,-8
BEL,VNM,2002.0,2,1,1
SVN,CHE,1998.0,2,2,0
RUS,BRA,2000.0,12,5,7
DNK,FRA,2007.0,15,35,-20
CHN,ITA,1999.0,10,12,-2
FIN,NOR,2012.0,14,9,5
GEO,USA,2005.0,22,40,-18
USA,YEM,2022.0,4,2,2
BRA,PAN,2013.0,2,1,1
SWE,CZE,2001.0,8,3,5
ITA,EGY,2000.0,4,3,1
IRL,RUS,2020.0,3,10,-7
FRA,NLD,1998.0,78,49,29
ESP,HUN,2003.0,6,2,4
JPN,RUS,1997.0,28,36,-8
TUR,ISR,2001.0,4,4,0
ITA,MAR,1999.0,4,1,3
AUT,HRV,2003.0,6,2,4
NOR,NPL,2010.0,5,1,4
IDN,FRA,1999.0,4,8,-4
RUS,MEX,2002.0,19,17,2
SRB,AUT,2004.0,5,2,3
AUT,SRB,2006.0,5,2,3
GEO,CHE,2006.0,2,2,0
DNK,FRA,1998.0,16,22,-6
CAN,TUN,2002.0,6,1,5
SWE,FRA,2013.0,43,83,-40
BOL,CHL,2010.0,2,1,1
ZAF,KOR,2018.0,5,5,0
USA,JOR,1999.0,19,8,11
POL,ITA,2012.0,12,13,-1
USA,MYS,2012.0,43,32,11
RUS,POL,2017.0,15,17,-2
BEL,ZWE,2011.0,2,1,1
EGY,JOR,2001.0,2,2,0
JPN,GRC,2006.0,7,2,5
SRB,CAN,2011.0,4,2,2
USA,BWA,2021.0,10,9,1
PRT,FRA,2007.0,14,29,-15
BHR,SAU,2004.0,1,2,-1
CHN,SWE,1998.0,24,15,9
ETH,ZAF,2003.0,4,4,0
SGP,NOR,2005.0,1,1,0
BLR,FRA,2007.0,4,2,2
IRL,PRT,2006.0,3,1,2
NOR,FRA,2001.0,13,16,-3
QAT,CAN,2018.0,10,16,-6
GHA,CAN,2004.0,3,1,2
ISR,CAN,2006.0,48,15,33
USA,KWT,2017.0,30,14,16
ITA,RUS,2008.0,19,17,2
CHE,JPN,2005.0,24,32,-8
ETH,CHE,2018.0,8,1,7
USA,KEN,2006.0,29,24,5
UKR,NLD,2000.0,2,1,1
NGA,JPN,2001.0,4,5,-1
RUS,BLR,1999.0,14,23,-9
ITA,ISR,2000.0,10,12,-2
TUR,DEU,2001.0,12,14,-2
RUS,CHN,2012.0,11,7,4
CHN,RUS,2015.0,22,10,12
USA,PER,1997.0,7,9,-2
BEL,BEN,2004.0,3,2,1
SVK,GBR,2014.0,10,4,6
OMN,IRN,2017.0,1,2,-1
ITA,GRC,2012.0,29,25,4
AUT,LIE,2004.0,1,1,0
POL,CAN,2008.0,18,14,4
NLD,ISR,2007.0,6,9,-3
ROU,ITA,2001.0,13,5,8
SVK,SVN,2006.0,16,11,5
CHE,BRA,1999.0,5,3,2
ESP,BRA,2000.0,38,31,7
USA,ROU,2014.0,29,27,2
THA,CHN,2014.0,13,13,0
MNP,USA,2018.0,2,4,-2
ISR,AUS,2001.0,14,8,6
NOR,IND,2014.0,10,8,2
POL,AUS,2008.0,8,6,2
BEL,UKR,2021.0,2,3,-1
SVK,SRB,2006.0,2,2,0
JPN,NZL,2000.0,6,13,-7
USA,HKG,2001.0,101,121,-20
USA,SWZ,2014.0,3,2,1
ESP,SWE,2002.0,27,24,3
RUS,CZE,2002.0,10,8,2
PRT,AUT,2006.0,3,1,2
AUS,NLD,2002.0,34,31,3
CZE,NOR,2005.0,2,1,1
GEO,DEU,2005.0,3,8,-5
BEL,CAN,2007.0,25,20,5
MNG,USA,2016.0,2,5,-3
NPL,NOR,2011.0,7,2,5
GRC,SRB,2002.0,2,4,-2
GHA,DNK,1998.0,3,2,1
DEU,HUN,2015.0,30,45,-15
VUT,NCL,2016.0,1,1,0
DNK,CHE,1998.0,10,6,4
FRA,COL,2008.0,11,5,6
BFA,FRA,2010.0,17,7,10
BEL,IRL,2001.0,1,4,-3
IND,BGD,1998.0,3,12,-9
ITA,ROU,2001.0,5,13,-8
DNK,SRB,1998.0,3,4,-1
USA,LBN,2006.0,26,32,-6
POL,SWE,2005.0,15,14,1
FRA,FIN,1997.0,10,5,5
USA,JAM,2001.0,13,7,6
GBR,GHA,2011.0,26,6,20
CHL,ITA,2002.0,6,3,3
DEU,FRO,2022.0,1,1,0
IND,ROU,2023.0,5,5,0
ZWE,USA,2007.0,14,4,10
DEU,LTU,2004.0,9,4,5
HKG,AUS,2017.0,33,51,-18
RUS,ITA,2006.0,25,17,8
JPN,BEL,2004.0,12,12,0
GUF,FRA,2012.0,23,27,-4
CHE,JPN,2012.0,35,49,-14
TUR,DNK,2003.0,2,2,0
CAN,PRT,2006.0,6,4,2
POL,AUS,2015.0,7,10,-3
SAU,GBR,2008.0,23,42,-19
AUT,SWE,2008.0,6,11,-5
CHE,CIV,2000.0,1,2,-1
DEU,SGP,1997.0,5,2,3
ESP,SWE,2005.0,22,26,-4
MLT,DEU,2020.0,2,3,-1
RWA,USA,2011.0,9,5,4
CAN,AUT,2014.0,29,23,6
RUS,ZAF,2006.0,4,1,3
UZB,PRT,2007.0,1,1,0
CHE,TUR,2003.0,3,5,-2
CAN,KWT,2001.0,5,1,4
CHE,SRB,2006.0,5,5,0
ARE,EGY,2007.0,10,8,2
DEU,CHL,2001.0,21,12,9
QAT,EGY,2000.0,2,4,-2
SWE,GRC,1998.0,8,2,6
KEN,IRL,2022.0,2,1,1
POL,CHE,2019.0,26,19,7
PAK,ITA,2022.0,53,11,42
CHN,UZB,2022.0,12,5,7
MYS,ZAF,2014.0,5,2,3
CAN,ARE,2021.0,32,33,-1
ETH,KEN,2020.0,5,10,-5
IRN,IRL,2010.0,7,3,4
UKR,TUR,2020.0,3,4,-1
FRA,DJI,1998.0,1,1,0
DNK,ESP,2022.0,39,41,-2
USA,PAN,2021.0,30,15,15
ARG,BRA,2018.0,31,50,-19
ARG,AUT,2016.0,3,1,2
HTI,USA,2021.0,12,18,-6
IRL,PAK,2015.0,8,7,1
AUT,IRN,2020.0,7,40,-33
KOR,AUS,2021.0,55,37,18
VNM,KOR,2019.0,42,136,-94
KEN,GHA,2019.0,3,2,1
LBR,GHA,2018.0,1,1,0
HKG,TWN,2018.0,18,12,6
NLD,ZWE,2019.0,3,2,1
SVK,IRN,2023.0,2,4,-2
MUS,USA,2020.0,2,4,-2
BOL,ECU,2019.0,1,2,-1
BRA,NLD,2015.0,52,25,27
TUR,DEU,2015.0,55,50,5
CZE,ITA,2019.0,16,32,-16
FRA,HUN,2016.0,17,12,5
LKA,THA,2019.0,1,3,-2
ITA,NOR,2023.0,27,5,22
RUS,ESP,2022.0,25,7,18
AUT,DNK,2019.0,11,5,6
REU,FRA,2022.0,27,20,7
HKG,IRN,2021.0,1,10,-9
NOR,FIN,1997.0,5,4,1
SWE,NZL,2018.0,7,16,-9
MDG,CHE,2019.0,2,2,0
CHE,ZAF,2020.0,14,22,-8
POL,IRN,2023.0,5,24,-19
MMR,JPN,2019.0,5,21,-16
IND,NPL,2016.0,23,20,3
ZAF,NAM,2020.0,16,10,6
GBR,ARE,2018.0,69,30,39
ITA,SGP,2020.0,5,10,-5
CAN,IDN,2021.0,7,3,4
HKG,ARE,2023.0,6,1,5
USA,MDA,2017.0,9,3,6
CHE,IRN,2018.0,17,25,-8
CZE,RUS,2018.0,12,15,-3
BGD,JPN,1997.0,10,9,1
MDG,USA,2018.0,4,5,-1
USA,MDG,2019.0,8,5,3
AUS,TWN,2021.0,20,20,0
IND,SWE,2018.0,79,25,54
IND,FRA,2021.0,105,85,20
CUB,CAN,2022.0,5,2,3
BRA,RUS,2023.0,3,6,-3
CHN,IRN,2018.0,11,49,-38
DEU,ETH,2018.0,15,6,9
ECU,GBR,2021.0,4,8,-4
PRT,CHE,2018.0,19,18,1
NGA,SAU,2018.0,9,6,3
CZE,NZL,2019.0,3,4,-1
IRN,EGY,2021.0,4,2,2
UKR,USA,2020.0,28,22,6
BEL,FIN,2019.0,10,11,-1
GBR,ECU,2019.0,8,5,3
JPN,ESP,2022.0,26,17,9
CZE,HUN,2020.0,7,6,1
IRL,CHE,2022.0,17,15,2
KEN,NZL,1999.0,1,1,0
GBR,KAZ,2018.0,14,4,10
RWA,BEL,2020.0,4,5,-1
KAZ,FRA,2022.0,1,3,-2
MYS,FIN,2018.0,2,1,1
THA,FIN,2020.0,1,3,-2
ITA,UKR,2017.0,3,3,0
LKA,DEU,2021.0,4,4,0
HKG,ITA,2018.0,4,6,-2
DZA,DEU,2018.0,4,5,-1
USA,JOR,2020.0,69,58,11
JPN,BWA,2019.0,1,1,0
CHN,CZE,2022.0,14,22,-8
AUT,DNK,2021.0,23,17,6
PYF,FRA,2018.0,19,36,-17
CAN,ARE,2011.0,20,7,13
KOR,CZE,2019.0,3,3,0
IDN,KOR,2017.0,13,32,-19
IND,BRA,2016.0,37,12,25
VEN,ARG,2017.0,3,1,2
KEN,ZWE,2019.0,2,2,0
MEX,CAN,2004.0,15,23,-8
BGD,DEU,2012.0,8,9,-1
NLD,IDN,2016.0,38,20,18
MAR,DEU,2021.0,11,3,8
TZA,CHN,2020.0,6,19,-13
CUB,ESP,2019.0,29,15,14
CHL,FRA,2022.0,27,23,4
MEX,COL,2007.0,10,10,0
USA,MLI,2008.0,4,2,2
GBR,HUN,2019.0,37,39,-2
TUN,USA,2007.0,7,3,4
GBR,KWT,2017.0,10,10,0
ETH,USA,2005.0,7,8,-1
PYF,FRA,2017.0,24,13,11
ITA,PRT,2020.0,45,39,6
CAN,BGD,2023.0,14,24,-10
IRL,DNK,2010.0,10,1,9
TWN,IND,2000.0,7,17,-10
GEO,USA,2012.0,42,50,-8
BRA,ECU,2016.0,10,5,5
MDA,USA,2009.0,4,4,0
AUT,RUS,2010.0,9,11,-2
USA,GTM,2013.0,15,9,6
NZL,USA,2008.0,95,122,-27
IND,BEL,2007.0,10,10,0
ZAF,IRN,2022.0,5,5,0
KOR,BEL,2007.0,3,3,0
ZAF,ITA,2012.0,4,11,-7
LBY,SAU,2012.0,2,1,1
THA,LKA,2018.0,4,3,1
NZL,NOR,2014.0,8,3,5
CHE,SVK,1998.0,1,5,-4
GBR,KEN,2023.0,17,18,-1
MNG,CHN,2015.0,22,3,19
LKA,MYS,2018.0,3,3,0
AUS,JPN,2015.0,52,69,-17
IRN,SWE,2011.0,32,14,18
USA,COL,1997.0,19,14,5
HKG,BGD,2017.0,2,2,0
MCO,ITA,2017.0,2,3,-1
THA,ITA,2020.0,5,6,-1
IRN,NOR,2016.0,8,6,2
ITA,ISR,2006.0,7,5,2
IRL,ZAF,2010.0,3,3,0
MLT,GBR,2017.0,12,11,1
BIH,DEU,2021.0,4,3,1
PRT,AGO,2021.0,6,3,3
SWE,COL,2021.0,5,7,-2
RUS,CAN,2005.0,28,19,9
ARE,IND,2022.0,35,54,-19
HUN,IDN,2020.0,2,2,0
SAU,IRN,2021.0,2,2,0
BEL,ZWE,2021.0,1,2,-1
IND,KWT,1998.0,9,2,7
BRA,NLD,2004.0,10,7,3
GMB,GBR,2018.0,14,6,8
POL,SWE,2012.0,19,18,1
KEN,IND,2001.0,2,2,0
BGD,SWE,2021.0,6,9,-3
EST,DNK,2023.0,3,1,2
TWN,RUS,2021.0,7,2,5
NZL,CAN,1997.0,13,25,-12
POL,SWE,1997.0,6,7,-1
SAU,TUR,2015.0,7,8,-1
CZE,DEU,2005.0,33,26,7
CAN,KEN,1999.0,6,1,5
CAN,HUN,2000.0,10,8,2
BGR,ITA,2003.0,11,8,3
FRA,PYF,2022.0,13,12,1
CHE,ISR,2008.0,4,14,-10
BRA,CHE,2005.0,11,16,-5
BGR,USA,2013.0,9,13,-4
MKD,USA,2013.0,2,2,0
SGP,CAN,2000.0,13,16,-3
IRL,BGR,2007.0,1,1,0
FIN,EST,2000.0,5,8,-3
KOR,CHE,2004.0,6,8,-2
NZL,NOR,2008.0,3,2,1
USA,ETH,2011.0,16,8,8
ESP,NZL,2012.0,13,5,8
AUT,CZE,1998.0,13,2,11
EST,GBR,1998.0,2,2,0
SWE,PRT,1998.0,5,3,2
FRA,NCL,2004.0,18,10,8
CAN,LBN,2013.0,12,7,5
DEU,MDA,1999.0,2,1,1
IDN,AUS,2007.0,11,25,-14
USA,BWA,2019.0,12,16,-4
SAU,PAK,1999.0,8,2,6
NZL,SWE,2004.0,2,7,-5
CHN,CHL,2009.0,3,1,2
CHL,GBR,2009.0,17,19,-2
BEL,DNK,1998.0,4,3,1
SRB,CHN,2016.0,2,3,-1
UKR,TUR,1999.0,8,3,5
TZA,SWE,2016.0,3,6,-3
KWT,SWE,2005.0,1,1,0
SGP,THA,2018.0,10,5,5
JPN,MEX,2019.0,5,4,1
SWE,ESP,2009.0,33,41,-8
SWE,BRA,2001.0,3,11,-8
SGP,RUS,2004.0,2,3,-1
IND,PHL,2005.0,6,2,4
BEL,KOR,2017.0,15,10,5
KOR,BEL,2020.0,12,3,9
BEL,KOR,2022.0,7,23,-16
USA,HRV,1999.0,16,17,-1
UKR,GBR,1998.0,18,17,1
CHE,CHL,1997.0,2,3,-1
DEU,NZL,2004.0,30,12,18
CAN,CRI,2016.0,3,1,2
AUS,THA,2015.0,47,21,26
SGP,NZL,2002.0,6,3,3
SGP,NZL,2005.0,7,5,2
PRT,BEL,2001.0,4,5,-1
BEL,PRT,2012.0,8,8,0
AUS,TUR,2008.0,6,5,1
NZL,JPN,1998.0,10,6,4
SGP,HKG,2004.0,20,22,-2
PRT,ARG,2004.0,2,4,-2
DEU,TUR,2001.0,14,12,2
PRT,DEU,2010.0,28,36,-8
GBR,NAM,2018.0,4,1,3
BMU,USA,2000.0,1,1,0
JOR,KWT,2021.0,7,9,-2
SDN,SAU,2023.0,12,13,-1
POL,SVK,2001.0,6,2,4
GRC,RUS,2021.0,4,2,2
BEL,GRC,2000.0,10,7,3
GEO,USA,1997.0,16,14,2
FRA,SAU,2022.0,28,19,9
PRI,PRT,2000.0,3,1,2
PER,DNK,2000.0,1,1,0
CHE,IND,2005.0,13,16,-3
JPN,BLR,1999.0,2,5,-3
IDN,DEU,1998.0,2,4,-2
EGY,AUT,2001.0,3,2,1
COL,ARG,2005.0,4,3,1
USA,URY,2002.0,5,9,-4
CHL,CAN,2003.0,6,8,-2
PSE,TUR,2014.0,3,1,2
USA,ZAF,1997.0,37,33,4
SWE,AUT,2010.0,10,15,-5
CZE,JPN,2005.0,6,11,-5
OMN,USA,2004.0,6,6,0
LBN,GBR,2012.0,5,10,-5
SWE,ISL,2010.0,21,9,12
BEL,ARG,2012.0,2,6,-4
CHE,BEL,2021.0,60,72,-12
IRL,MYS,2018.0,7,4,3
ITA,UKR,2016.0,2,8,-6
USA,PAK,2003.0,32,32,0
GEO,GBR,2013.0,3,1,2
NZL,NLD,2010.0,10,23,-13
SAU,PAK,1998.0,2,5,-3
GRC,BEL,2003.0,4,8,-4
HRV,ESP,2002.0,7,4,3
ITA,ARE,2021.0,13,5,8
NLD,ZAF,2010.0,24,23,1
CRI,ESP,2011.0,4,6,-2
AUT,NLD,1999.0,14,5,9
IRL,CHE,2017.0,18,8,10
BLR,UKR,2009.0,3,5,-2
AUT,NOR,2017.0,9,11,-2
USA,SVK,2003.0,18,31,-13
ARG,AUS,2004.0,3,1,2
POL,JPN,2008.0,17,14,3
EGY,DEU,1997.0,7,9,-2
CHL,BRA,2000.0,10,4,6
NLD,ZAF,2000.0,7,11,-4
ESP,SWE,1997.0,20,9,11
IND,IDN,2002.0,10,1,9
JPN,NPL,2009.0,10,5,5
JPN,TWN,2003.0,41,22,19
ITA,MEX,2003.0,10,8,2
ITA,NZL,2023.0,3,3,0
ITA,ROU,2008.0,18,16,2
FIN,ROU,2007.0,3,1,2
MLI,USA,2013.0,5,4,1
USA,MLI,2014.0,4,11,-7
PRI,GBR,2001.0,2,4,-2
PAK,ESP,2017.0,3,5,-2
SWE,ISR,2021.0,7,14,-7
PRT,DEU,2006.0,16,26,-10
ITA,SRB,2006.0,10,16,-6
FRA,ARG,2014.0,33,32,1
CHN,KOR,2006.0,53,51,2
GBR,VEN,2014.0,5,3,2
MCO,FRA,2009.0,18,4,14
ISR,BEL,1998.0,4,3,1
BEL,ISR,2001.0,5,6,-1
FIN,ITA,2012.0,14,17,-3
BRA,CHN,1997.0,1,5,-4
CHN,BRA,1998.0,8,2,6
POL,SWE,2002.0,10,12,-2
PAN,USA,2003.0,17,13,4
AUT,SWE,2015.0,26,23,3
CHE,IND,2002.0,9,21,-12
ZWE,GBR,2005.0,7,1,6
USA,OMN,2006.0,6,2,4
ESP,IND,2000.0,7,7,0
USA,GTM,2003.0,10,4,6
ZAF,DEU,2012.0,30,41,-11
MYS,SGP,1998.0,4,6,-2
URY,USA,2008.0,10,14,-4
CAN,FIN,2001.0,17,14,3
USA,NPL,2015.0,18,18,0
USA,GRD,2013.0,5,6,-1
BEL,RUS,1998.0,5,13,-8
AUS,SWE,2014.0,57,50,7
KWT,GBR,2015.0,13,16,-3
ISL,GBR,2013.0,8,9,-1
USA,ROU,2001.0,21,48,-27
DEU,LBN,2012.0,1,2,-1
BEL,ITA,2011.0,37,87,-50
KWT,USA,2005.0,4,10,-6
ZWE,ZAF,2002.0,10,3,7
BHR,SAU,2008.0,3,3,0
GBR,PHL,2009.0,5,3,2
CAN,SGP,2002.0,22,31,-9
NLD,FIN,2005.0,12,10,2
SVN,GBR,1998.0,4,6,-2
AUT,FIN,2005.0,4,3,1
LVA,USA,2001.0,3,3,0
JPN,THA,2000.0,30,27,3
VEN,COL,2013.0,15,9,6
FIN,ESP,2015.0,13,25,-12
POL,TWN,2010.0,3,4,-1
USA,ROU,2008.0,29,20,9
BEL,AUS,1997.0,4,6,-2
LBN,LBY,2021.0,1,6,-5
TWN,SGP,2010.0,14,14,0
DEU,ESP,2024.0,2,1,1
CHL,DNK,2018.0,3,1,2
NGA,KOR,2013.0,1,1,0
HKG,JPN,2013.0,10,11,-1
ITA,IRN,2016.0,26,38,-12
AUT,TUR,2012.0,5,4,1
IND,IRL,2020.0,32,16,16
ARG,CHE,2006.0,4,3,1
IRN,CHN,2009.0,6,2,4
COL,MEX,2010.0,21,17,4
LUX,FRA,2022.0,14,24,-10
ITA,EGY,2010.0,9,6,3
CHE,MEX,2009.0,9,4,5
BEL,UKR,2011.0,1,7,-6
TUN,ITA,2015.0,6,10,-4
MDG,CHE,2011.0,1,1,0
CHE,SGP,2016.0,26,17,9
TZA,GBR,2011.0,7,15,-8
PRT,CHN,2014.0,10,9,1
IRL,NZL,2014.0,11,11,0
LTU,SWE,2010.0,4,4,0
DEU,ETH,2016.0,16,5,11
CUB,USA,2016.0,13,6,7
GBR,FIN,2015.0,62,68,-6
MWI,ZAF,2017.0,5,10,-5
CHL,CAN,2013.0,16,13,3
MEX,CAN,2014.0,40,32,8
LSO,ZAF,2011.0,5,2,3
IRL,AUS,2014.0,56,32,24
USA,PHL,2007.0,23,19,4
ITA,CHN,2006.0,13,12,1
BGD,USA,2007.0,16,21,-5
IND,CHL,2016.0,7,3,4
AUT,UKR,2016.0,3,6,-3
DEU,NZL,2015.0,28,38,-10
ARE,BEL,2018.0,4,5,-1
POL,CZE,2020.0,27,20,7
SWE,KEN,2007.0,1,1,0
SLE,CHN,2011.0,1,1,0
IRL,PAK,2014.0,5,1,4
MEX,GBR,2008.0,32,46,-14
DEU,SVN,2016.0,6,17,-11
MYS,IRN,2012.0,98,83,15
KOR,FRA,2017.0,27,26,1
EGY,PAK,2010.0,3,3,0
NGA,CHE,2018.0,9,1,8
CAN,URY,2011.0,1,2,-1
MKD,SRB,2016.0,7,5,2
TUR,ESP,2011.0,13,9,4
USA,TTO,2012.0,8,5,3
TWN,GBR,2007.0,24,40,-16
EGY,KWT,2016.0,6,13,-7
FIN,CZE,2018.0,6,3,3
IRL,AUT,2007.0,3,2,1
SWE,BFA,2017.0,2,1,1
EGY,KOR,2019.0,13,8,5
MEX,CAN,2008.0,27,19,8
CAN,OMN,2015.0,10,6,4
HUN,FIN,2016.0,5,7,-2
CHE,LVA,2019.0,5,6,-1
IND,CHL,2018.0,12,2,10
DZA,CAN,2015.0,5,13,-8
DNK,IND,2019.0,13,21,-8
TLS,GBR,2020.0,1,1,0
CHN,PAK,2012.0,50,46,4
NLD,CHN,2008.0,26,33,-7
DEU,POL,2020.0,79,81,-2
GBR,EGY,2017.0,61,50,11
GHA,CAN,2014.0,6,5,1
AUT,ARE,2013.0,3,1,2
KEN,MEX,2015.0,1,1,0
GRC,GBR,2023.0,83,100,-17
CHE,GRC,2016.0,14,37,-23
POL,IRL,2011.0,4,3,1
AUT,POL,2020.0,7,20,-13
DEU,LTU,2014.0,4,4,0
EST,COL,2020.0,1,1,0
GBR,MAR,2019.0,4,2,2
MEX,BEL,2017.0,10,7,3
CAN,TZA,2016.0,3,1,2
COL,BEL,2015.0,1,7,-6
HKG,SGP,2014.0,31,22,9
LKA,HKG,2009.0,2,1,1
USA,CYM,2016.0,1,2,-1
FIN,SVK,2015.0,2,1,1
GMB,TWN,2011.0,1,1,0
DNK,CHN,2012.0,32,38,-6
KOR,SWE,2019.0,12,12,0
PRT,HUN,2011.0,1,2,-1
BRA,IRN,2016.0,3,6,-3
ARE,MEX,2020.0,1,2,-1
IRN,ITA,2014.0,41,17,24
EST,USA,2021.0,6,11,-5
ARG,COL,2018.0,31,21,10
CAN,TTO,2017.0,6,1,5
UKR,FRA,2020.0,9,4,5
PHL,CHN,2019.0,7,6,1
USA,MWI,2008.0,9,7,2
CHE,SWZ,2015.0,13,7,6
POL,UKR,2011.0,15,15,0
NOR,ROU,2010.0,3,2,1
DEU,ROU,2013.0,35,35,0
DEU,MNG,2019.0,3,2,1
AUT,NZL,2017.0,4,5,-1
SGP,ARE,2014.0,5,1,4
GHA,AUS,2014.0,6,2,4
RUS,ESP,2017.0,9,11,-2
SWE,URY,2008.0,2,2,0
HUN,KOR,2018.0,2,3,-1
VNM,KOR,2009.0,9,12,-3
PAK,GBR,2009.0,36,36,0
CHL,PER,2015.0,3,6,-3
DNK,FRA,1999.0,13,26,-13
KOR,IRL,2017.0,7,1,6
BGR,GRC,2022.0,2,3,-1
DEU,GEO,2019.0,4,5,-1
CHE,ISR,2014.0,18,23,-5
MYS,YEM,2015.0,10,3,7
ZAF,DNK,2016.0,4,5,-1
ZWE,AUS,2019.0,1,2,-1
MYS,OMN,2019.0,19,5,14
KOR,NOR,2018.0,12,1,11
DEU,BGR,2019.0,9,6,3
ZAF,GHA,2017.0,18,16,2
EGY,IND,2014.0,4,7,-3
NGA,CHE,2022.0,7,4,3
IRQ,CAN,2021.0,4,5,-1
CHE,LTU,2017.0,3,1,2
MEX,VEN,2000.0,5,11,-6
AUT,BEL,2019.0,18,14,4
USA,SEN,2019.0,8,8,0
JPN,SWE,2021.0,29,19,10
NLD,DNK,2016.0,37,28,9
SGP,SWE,2009.0,7,11,-4
AUS,FIN,2021.0,26,13,13
CRI,NLD,2018.0,3,1,2
KAZ,GBR,2018.0,4,14,-10
CMR,DEU,2019.0,2,7,-5
MYS,NZL,2018.0,26,17,9
IRL,CAN,2023.0,24,26,-2
AUT,HUN,2008.0,8,17,-9
BEL,TUN,2022.0,1,5,-4
CUB,CAN,2018.0,15,1,14
TWN,IND,2006.0,17,43,-26
CHE,JPN,1997.0,25,16,9
AUS,LBY,2018.0,4,1,3
GEO,IND,2021.0,3,1,2
IRN,PRT,2013.0,14,2,12
BGD,CHN,2016.0,20,6,14
ARG,NLD,2010.0,3,6,-3
COL,SWE,2020.0,5,2,3
PRI,ARG,2017.0,3,5,-2
LVA,CHE,2019.0,6,5,1
FRA,NZL,2019.0,22,17,5
KOR,FRA,2018.0,28,25,3
TUR,SAU,2021.0,14,7,7
HKG,BGD,2016.0,4,3,1
GBR,GHA,2021.0,31,32,-1
NLD,KEN,2019.0,13,6,7
URY,CHL,2020.0,2,4,-2
NOR,CHL,2017.0,4,2,2
CZE,EGY,2014.0,5,3,2
AUS,BEL,2012.0,12,32,-20
AUT,RUS,2000.0,12,5,7
ARE,EGY,2020.0,22,35,-13
MEX,BEL,2016.0,7,9,-2
KEN,ZAF,2015.0,19,14,5
CHN,MYS,2019.0,15,56,-41
JOR,IND,2016.0,2,3,-1
ESP,SRB,2017.0,5,2,3
DEU,BEN,2019.0,6,2,4
NOR,POL,2015.0,10,8,2
DNK,ESP,2016.0,21,44,-23
CHL,ECU,2017.0,8,9,-1
PAK,OMN,2013.0,9,5,4
USA,VIR,2021.0,13,2,11
CAN,COL,2020.0,30,23,7
MKD,SRB,2017.0,9,9,0
NER,NGA,2016.0,19,9,10
SWE,POL,2019.0,19,36,-17
KAZ,NLD,2013.0,1,4,-3
FIN,IND,2016.0,10,17,-7
TUN,RUS,2019.0,2,1,1
AUS,HKG,2013.0,34,58,-24
HKG,NZL,2012.0,5,2,3
DNK,JPN,2018.0,12,12,0
CAN,NGA,2016.0,4,10,-6
ESP,JOR,2018.0,6,2,4
FRA,EST,2018.0,4,5,-1
MYS,NZL,2016.0,16,24,-8
MAC,GBR,2018.0,3,1,2
AUT,ESP,2016.0,29,35,-6
ARG,AUS,2014.0,13,6,7
IRL,SWE,2017.0,11,14,-3
RUS,ISR,2013.0,7,11,-4
CRI,NLD,2016.0,1,1,0
CHL,ECU,2016.0,8,3,5
NZL,COL,2018.0,3,4,-1
CHN,CHL,2019.0,6,7,-1
ZAF,KOR,2017.0,4,7,-3
KOR,DNK,2020.0,15,4,11
JPN,SWE,2009.0,30,27,3
KOR,DEU,2023.0,34,27,7
RUS,TWN,2016.0,4,1,3
SAU,KOR,2016.0,9,27,-18
AUS,ESP,2015.0,40,78,-38
PAK,FIN,2019.0,11,5,6
PSE,ISR,2021.0,19,15,4
NLD,GHA,2021.0,5,5,0
SYR,USA,2018.0,1,2,-1
KEN,ZAF,2014.0,11,21,-10
ZAF,TUN,2018.0,20,2,18
ETH,DEU,2016.0,5,16,-11
HRV,DEU,2016.0,22,21,1
FIN,NLD,2008.0,17,20,-3
VNM,FRA,2001.0,4,2,2
PER,AUS,2021.0,6,1,5
COL,POL,2022.0,2,3,-1
POL,ESP,2023.0,23,15,8
SDN,OMN,2016.0,3,1,2
MWI,GBR,2019.0,22,25,-3
JPN,BRA,2019.0,12,15,-3
MYS,ETH,2022.0,1,1,0
BGD,CHN,2017.0,29,26,3
GHA,DEU,2018.0,9,16,-7
IRN,KOR,2016.0,23,9,14
BGR,ESP,1998.0,3,3,0
PRT,CAN,2023.0,8,1,7
HKG,BEL,2023.0,2,2,0
ETH,KOR,2018.0,4,7,-3
THA,VNM,2020.0,32,8,24
PRT,GHA,2021.0,2,1,1
ZAF,RUS,2019.0,6,4,2
FRA,KOR,2002.0,7,7,0
AUS,FJI,2008.0,4,9,-5
HRV,CHE,2021.0,8,4,4
CYP,NOR,2020.0,1,2,-1
AUS,ZAF,2003.0,20,40,-20
CZE,ITA,2021.0,29,32,-3
NZL,EGY,2020.0,2,2,0
RUS,ITA,2010.0,25,15,10
NGA,EGY,2020.0,3,2,1
GBR,UGA,2016.0,14,68,-54
JPN,HUN,2015.0,6,8,-2
BLR,DEU,2021.0,8,2,6
ARE,ESP,2019.0,1,11,-10
ECU,PER,2021.0,9,12,-3
CAN,IRQ,2021.0,5,4,1
POL,IRL,2021.0,6,7,-1
CHN,BRA,2020.0,13,22,-9
CMR,USA,2021.0,19,13,6
IRQ,IND,2023.0,6,1,5
DNK,IND,2009.0,4,17,-13
NLD,UGA,2023.0,3,1,2
MAR,USA,2022.0,14,12,2
MYS,OMN,2021.0,28,5,23
SAU,SWE,2022.0,12,14,-2
BLR,DEU,2019.0,8,2,6
AUS,BWA,2019.0,4,3,1
TUR,JPN,2022.0,3,2,1
ESP,KOR,2022.0,6,7,-1
KOR,CHE,2014.0,14,8,6
KEN,SLE,2020.0,1,2,-1
CAN,TUR,2021.0,23,48,-25
ARE,DZA,2023.0,1,4,-3
KOR,SAU,2011.0,20,3,17
ARG,AUT,2022.0,5,1,4
GBR,MWI,2021.0,20,21,-1
TUR,IRQ,2019.0,24,8,16
ZAF,VNM,2020.0,5,1,4
IDN,BRA,2019.0,1,1,0
ITA,POL,2022.0,33,24,9
MOZ,ESP,2022.0,1,5,-4
ETH,KOR,2017.0,2,5,-3
TWN,GBR,2020.0,34,41,-7
MEX,PER,2016.0,7,12,-5
IND,DNK,2022.0,25,14,11
MEX,SWE,2022.0,9,8,1
NOR,EST,2019.0,4,4,0
HND,BRA,2022.0,1,1,0
CZE,MAR,2022.0,2,2,0
RUS,NOR,2014.0,16,3,13
LBN,CAN,2023.0,16,2,14
CAN,CHL,2022.0,16,35,-19
BEL,GRC,2023.0,9,13,-4
FRA,MLI,2021.0,11,5,6
DNK,ARE,2021.0,4,1,3
KEN,JPN,2020.0,13,3,10
RUS,ITA,2023.0,35,7,28
CHL,DNK,2022.0,4,2,2
MDA,RUS,2019.0,3,4,-1
AUS,IRN,2022.0,30,125,-95
ZAF,KOR,2022.0,5,1,4
MYS,RUS,2020.0,4,1,3
NZL,FIN,2017.0,6,3,3
TUR,ETH,2022.0,4,2,2
GBR,KWT,2022.0,20,11,9
JPN,SAU,2021.0,8,7,1
BRA,HND,2021.0,3,1,2
CAN,UKR,2021.0,5,7,-2
USA,SEN,2021.0,7,6,1
FRA,OMN,2021.0,1,2,-1
SRB,GRC,2001.0,3,3,0
DNK,FIN,2011.0,13,15,-2
NGA,KEN,2021.0,5,4,1
CMR,CHE,2003.0,2,1,1
TUN,USA,1998.0,2,3,-1
USA,CYP,2002.0,11,8,3
USA,PRT,1999.0,32,32,0
EGY,CAN,2006.0,12,7,5
SMR,ITA,2013.0,2,5,-3
MAR,ESP,2012.0,9,12,-3
TGO,BEN,2007.0,2,2,0
FRA,BGR,2002.0,10,10,0
COL,FRA,2019.0,21,19,2
FRA,CZE,2002.0,11,22,-11
POL,NOR,2005.0,3,2,1
AUT,TUR,2005.0,2,3,-1
ESP,GRC,2001.0,3,6,-3
MYS,IDN,2001.0,3,1,2
SWE,GBR,1997.0,46,51,-5
USA,KEN,2010.0,37,25,12
SGP,HKG,2015.0,29,36,-7
ETH,CHE,2022.0,2,1,1
SWE,NLD,2018.0,77,80,-3
TUR,QAT,2015.0,3,3,0
ITA,MEX,2013.0,15,9,6
VNM,PHL,2016.0,2,2,0
JOR,SAU,2013.0,39,17,22
IRL,PRT,2023.0,3,2,1
POL,GEO,2008.0,2,1,1
HUN,GBR,2018.0,53,41,12
DNK,NLD,2011.0,18,18,0
SAU,AUS,2020.0,45,87,-42
DEU,TUR,2008.0,31,31,0
GBR,PRT,2015.0,72,130,-58
ARG,MEX,2018.0,21,31,-10
ITA,ROU,2015.0,25,17,8
KOR,TWN,2012.0,10,18,-8
HKG,MAC,2012.0,21,3,18
ZAF,MOZ,2017.0,9,2,7
MEX,BRA,2014.0,31,16,15
CZE,DEU,2012.0,43,36,7
CZE,IND,2020.0,7,36,-29
THA,CAN,2012.0,13,21,-8
CAN,IND,2023.0,61,131,-70
BGD,MYS,2011.0,25,11,14
TUR,CAN,2013.0,22,19,3
DNK,THA,2012.0,4,2,2
ETH,NLD,2008.0,1,5,-4
USA,YEM,2018.0,2,1,1
GBR,EGY,2016.0,55,30,25
JOR,USA,2011.0,26,50,-24
DNK,NOR,2018.0,68,40,28
AUS,DNK,2007.0,19,20,-1
JOR,DEU,2012.0,8,13,-5
MYS,IDN,2014.0,77,10,67
HRV,DEU,2017.0,16,14,2
ROU,CAN,2013.0,5,7,-2
DZA,FRA,2012.0,55,133,-78
BRA,CHL,2023.0,28,14,14
SWE,POL,2021.0,17,28,-11
FRA,CHL,2014.0,46,32,14
CHL,FRA,2016.0,38,50,-12
AUS,KOR,2016.0,32,58,-26
NLD,TUR,2020.0,27,47,-20
PHL,DEU,2021.0,14,6,8
ECU,USA,2012.0,18,22,-4
USA,JAM,2015.0,15,9,6
SRB,AUT,2015.0,6,3,3
DNK,POL,2015.0,6,9,-3
GHA,JPN,2018.0,6,4,2
JPN,SAU,2011.0,15,1,14
ITA,TWN,2017.0,8,4,4
RUS,JPN,2021.0,14,16,-2
DEU,KOR,2023.0,27,34,-7
CZE,GBR,2016.0,54,45,9
GBR,KWT,2016.0,22,8,14
SAU,CHN,2022.0,44,59,-15
SGP,TWN,2014.0,16,19,-3
AUS,LKA,2019.0,25,50,-25
SWE,SGP,2020.0,8,14,-6
IND,PRT,2011.0,25,10,15
GBR,FLK,2016.0,2,2,0
PER,ESP,2012.0,7,11,-4
GBR,IRN,2020.0,43,112,-69
EST,DEU,2019.0,8,9,-1
SRB,SVN,2015.0,8,2,6
SAU,AUT,2022.0,7,1,6
CHL,KOR,2021.0,6,4,2
SWE,CHN,2008.0,46,69,-23
CHN,NOR,2017.0,16,32,-16
LSO,ZAF,2021.0,7,13,-6
SAU,ITA,2013.0,4,17,-13
JPN,PAK,2016.0,11,12,-1
EST,USA,2019.0,14,16,-2
GBR,UGA,2022.0,14,20,-6
BFA,FRA,2000.0,14,11,3
BGR,RUS,2019.0,9,17,-8
JPN,POL,2021.0,11,13,-2
CHE,PRT,2023.0,10,12,-2
GRC,ITA,2021.0,31,35,-4
ZAF,JPN,2018.0,5,2,3
PAK,DEU,2017.0,35,48,-13
DNK,BEL,2021.0,25,19,6
CHN,CZE,2016.0,10,9,1
ITA,POL,2016.0,13,15,-2
CAN,CHL,2017.0,24,20,4
KAZ,ITA,2017.0,3,4,-1
CUB,COL,2017.0,11,3,8
GBR,ROU,2020.0,16,27,-11
CZE,PAK,2020.0,3,2,1
CHN,NGA,2022.0,37,23,14
KAZ,SAU,2021.0,4,3,1
ARE,GRC,2022.0,2,6,-4
ISR,TUR,2005.0,5,4,1
CHE,BRA,2020.0,29,35,-6
CAN,ARG,2017.0,13,16,-3
NPL,IND,2021.0,23,47,-24
BEN,NGA,2014.0,7,6,1
NZL,SWE,2008.0,1,11,-10
UKR,RUS,2004.0,36,48,-12
FRA,LBN,2002.0,20,15,5
BEL,BLR,2008.0,6,1,5
OMN,USA,2014.0,11,12,-1
BLR,BEL,1998.0,3,2,1
BRA,SWE,2009.0,6,7,-1
GBR,JOR,1998.0,7,4,3
DEU,CZE,2006.0,34,27,7
RUS,MDA,2007.0,4,2,2
BGD,JPN,2002.0,17,22,-5
ITA,CHL,2002.0,3,6,-3
ITA,NOR,2006.0,7,5,2
KWT,USA,2002.0,14,12,2
ESP,AUS,2009.0,35,18,17
GLP,FRA,1997.0,12,10,2
CHE,CZE,2016.0,16,19,-3
RUS,SWE,2009.0,15,15,0
DEU,ZAF,2002.0,22,29,-7
AUS,BEL,2005.0,8,8,0
ZAF,NZL,2009.0,11,2,9
SVN,CHE,2020.0,4,2,2
NLD,AUS,1998.0,26,17,9
JPN,CZE,2018.0,13,8,5
USA,IRN,2000.0,14,19,-5
AUS,HKG,2003.0,35,28,7
AUS,IDN,2005.0,15,5,10
RUS,KOR,2013.0,9,8,1
ITA,DZA,2011.0,5,1,4
BEL,LUX,2000.0,5,8,-3
NOR,CAN,2004.0,7,11,-4
IND,CHE,1999.0,9,8,1
DZA,ITA,2001.0,4,1,3
FRA,PRT,2004.0,41,17,24
TUR,DEU,2004.0,18,21,-3
POL,JPN,2001.0,18,16,2
GBR,JAM,2001.0,6,1,5
FIN,ESP,2004.0,4,3,1
NPL,NOR,2009.0,4,1,3
BWA,USA,2003.0,6,8,-2
GHA,USA,2006.0,11,9,2
MYS,TWN,2022.0,13,10,3
CYP,USA,2015.0,9,11,-2
ITA,AUT,1997.0,7,8,-1
AUT,SWE,2001.0,10,9,1
GBR,FIN,2008.0,38,46,-8
SRB,DNK,2000.0,2,6,-4
NLD,CZE,2003.0,1,5,-4
JPN,SGP,2004.0,14,10,4
POL,ITA,2005.0,9,11,-2
OMN,GBR,2005.0,7,11,-4
NZL,FRA,2014.0,8,14,-6
CHE,ESP,2017.0,63,112,-49
BEL,HUN,2017.0,10,10,0
IRN,CAN,2024.0,6,1,5
SWZ,ZAF,2020.0,12,8,4
ITA,CZE,2013.0,11,7,4
ZAF,FRA,2020.0,15,23,-8
NPL,FRA,2022.0,4,1,3
FRA,EGY,2022.0,18,8,10
MEX,GTM,2020.0,8,3,5
BRA,ARG,2022.0,26,26,0
USA,CYP,2005.0,23,5,18
USA,LUX,2022.0,7,8,-1
MYS,AUS,2020.0,95,91,4
ETH,AUS,2022.0,22,10,12
ESP,SVN,2022.0,3,3,0
BGD,CHN,2018.0,31,14,17
PRT,ARG,2008.0,1,1,0
GBR,NPL,2015.0,6,4,2
VNM,NGA,2020.0,2,3,-1
AUS,NOR,2017.0,26,14,12
KAZ,JPN,2010.0,1,1,0
FRA,BEN,2016.0,10,8,2
TWN,MNG,2019.0,5,1,4
PHL,JPN,2010.0,15,26,-11
NPL,IND,2009.0,31,30,1
UGA,BEL,2015.0,1,2,-1
CHN,ISR,2022.0,34,45,-11
IND,BGD,1999.0,13,7,6
SRB,FRA,2005.0,3,4,-1
USA,MAC,2012.0,10,1,9
NLD,TZA,2010.0,3,2,1
PHL,JPN,2000.0,13,10,3
MTQ,FRA,1998.0,12,7,5
FRA,MTQ,2009.0,12,23,-11
SAU,CHN,2016.0,30,32,-2
MYS,GBR,2001.0,20,30,-10
NZL,DEU,2023.0,19,7,12
ISR,HUN,2009.0,3,5,-2
SWE,GRC,2007.0,7,5,2
BRA,CHE,2012.0,19,16,3
IND,DNK,2016.0,21,17,4
TTO,USA,2013.0,13,3,10
UKR,ITA,2018.0,3,3,0
NOR,AUT,2012.0,7,6,1
BEL,BRA,2002.0,15,6,9
FRA,CHL,2008.0,21,25,-4
IRL,BEL,2002.0,4,5,-1
AUS,IRL,2002.0,10,17,-7
CHE,POL,2023.0,9,10,-1
USA,ECU,1999.0,6,7,-1
SRB,DEU,1999.0,22,5,17
FRA,CHL,2004.0,16,11,5
ESP,URY,2000.0,7,5,2
USA,EST,2016.0,6,5,1
NOR,AUS,2010.0,15,11,4
HRV,SVK,2002.0,6,2,4
ESP,FIN,2014.0,29,8,21
TWN,POL,2009.0,2,1,1
CAN,AUT,2001.0,14,21,-7
PRT,USA,2012.0,59,83,-24
CHE,CHL,2012.0,12,9,3
HKG,DEU,2011.0,9,6,3
FRA,PYF,2018.0,36,19,17
AFG,USA,2010.0,6,7,-1
IRN,EGY,2011.0,3,1,2
UGA,MWI,2013.0,1,1,0
IRL,SWE,2016.0,8,11,-3
IRN,SWE,2009.0,10,14,-4
AUT,CAN,2021.0,24,25,-1
CAN,ETH,2023.0,4,3,1
IRN,TUR,2011.0,11,5,6
IRN,BEL,2012.0,17,11,6
LAO,THA,2019.0,8,14,-6
UKR,AUT,2013.0,4,3,1
JOR,CAN,2014.0,8,13,-5
ISR,TUR,2012.0,7,2,5
HKG,SGP,2008.0,24,15,9
AUT,NOR,2016.0,15,13,2
HKG,PAK,2019.0,11,9,2
TTO,CAN,2011.0,2,1,1
FRA,LUX,2011.0,23,15,8
COL,ECU,2019.0,5,13,-8
FJI,AUS,2013.0,9,5,4
USA,KEN,2023.0,32,28,4
TZA,DEU,2019.0,9,13,-4
SWZ,CHE,2021.0,10,3,7
ARG,URY,2013.0,5,7,-2
KAZ,ITA,2018.0,3,2,1
USA,LUX,2016.0,13,9,4
SEN,USA,2013.0,5,3,2
IND,FIN,2017.0,17,14,3
MEX,CHL,2018.0,15,15,0
CAN,QAT,2012.0,9,2,7
IND,NZL,2019.0,14,9,5
ARE,QAT,2019.0,6,7,-1
BRA,PER,2015.0,26,8,18
AUS,NPL,2020.0,7,22,-15
GHA,AUS,2015.0,5,7,-2
EGY,ARE,2002.0,13,10,3
CHE,IRL,2012.0,5,15,-10
JPN,CZE,2017.0,9,13,-4
AUS,PNG,2021.0,14,9,5
VEN,USA,2020.0,23,6,17
BRA,ARG,2018.0,50,31,19
CPV,PRT,2023.0,1,2,-1
NLD,VNM,2021.0,13,8,5
ETH,ESP,2022.0,3,1,2
PRT,MAR,2014.0,1,1,0
IND,QAT,2015.0,13,5,8
IRN,IRQ,2022.0,21,11,10
MEX,CZE,2021.0,11,3,8
YEM,SAU,2021.0,15,5,10
TWN,IDN,2017.0,30,21,9
IRL,ITA,2020.0,29,51,-22
PAK,IRQ,2021.0,5,4,1
CAN,ISL,2020.0,2,3,-1
TWN,THA,2020.0,18,15,3
IRL,HRV,2023.0,1,1,0
HRV,DEU,2022.0,16,13,3
PER,POL,2020.0,1,3,-2
DNK,PAK,2016.0,2,3,-1
GHA,JPN,2022.0,6,5,1
BHR,PAK,2021.0,2,2,0
RUS,CHE,2009.0,17,17,0
CHE,POL,2000.0,15,6,9
DEU,MNE,2012.0,1,0,1
,FJI,1995.0,17,0,17
BGD,,2006.0,75,0,75
DEU,COG,2011.0,2,0,2
GBR,CYP,1998.0,10,0,10
BEN,USA,2001.0,2,0,2
,PHL,2009.0,372,0,372
URY,MEX,1999.0,5,0,5
ITA,SYR,1998.0,1,0,1
,KHM,1996.0,9,0,9
MYS,MWI,2017.0,1,0,1
CAN,BWA,2015.0,4,0,4
COL,GRC,2015.0,2,0,2
CAN,TJK,2013.0,1,0,1
BMU,,2012.0,2,0,2
,ARM,2006.0,112,0,112
,PSE,2008.0,48,0,48
,AFG,2008.0,15,0,15
,VUT,2003.0,5,0,5
SDN,,2015.0,83,0,83
AUT,PHL,2021.0,1,0,1
DNK,SAU,2013.0,1,0,1
,EST,2006.0,335,0,335
TTO,GLP,2008.0,1,0,1
HRV,DNK,2015.0,5,0,5
NZL,KHM,2017.0,1,0,1
SDN,,2014.0,79,0,79
NZL,BTN,2010.0,1,0,1
,BEN,2005.0,67,0,67
HUN,SGP,2009.0,3,0,3
SGP,HUN,2010.0,2,0,2
UGA,GMB,2003.0,1,0,1
YEM,,2014.0,20,0,20
,SYR,2008.0,82,0,82
PRI,DEU,2010.0,3,0,3
,GHA,2007.0,254,0,254
CHE,DZA,2018.0,2,0,2
,ALB,2009.0,107,0,107
,EST,2010.0,391,0,391
PAK,DNK,2011.0,1,0,1
,GUF,2007.0,10,0,10
SWE,LBY,2008.0,2,0,2
NCL,DNK,2018.0,1,0,1
,SMR,2008.0,5,0,5
KEN,ZMB,2010.0,1,0,1
SDN,YEM,2014.0,1,0,1
TUR,USA,2024.0,2,0,2
,BIH,2010.0,215,0,215
ZMB,,2013.0,22,0,22
,KHM,2008.0,55,0,55
RWA,,2014.0,9,0,9
SWE,ALB,2022.0,1,0,1
DEU,LAO,2009.0,1,0,1
,DOM,2008.0,20,0,20
GUY,,2017.0,4,0,4
,TZA,2006.0,153,0,153
,UGA,2005.0,167,0,167
GNQ,GIN,2021.0,5,0,5
GMB,FRA,2011.0,1,0,1
TCD,,2024.0,55,0,55
PHL,,2017.0,257,0,257
USA,FRO,2020.0,2,0,2
NZL,ISR,2014.0,4,0,4
GMB,,2020.0,12,0,12
LUX,,2012.0,41,0,41
SYC,,2025.0,44,0,44
,NCL,2007.0,20,0,20
YEM,,2015.0,36,0,36
,AZE,2010.0,125,0,125
,GTM,2005.0,19,0,19
SVN,LVA,2018.0,1,0,1
,KWT,2011.0,160,0,160
PRT,TLS,2014.0,1,0,1
ETH,RWA,2021.0,3,0,3
,BOL,2011.0,46,0,46
,GUY,2011.0,12,0,12
,MWI,2011.0,108,0,108
CYP,POL,2021.0,1,0,1
,BHR,2006.0,45,0,45
,YEM,2016.0,50,0,50
,PER,2005.0,259,0,259
,TGO,2011.0,59,0,59
,MDG,2011.0,86,0,86
MUS,IND,2017.0,2,0,2
,UZB,2010.0,94,0,94
DEU,LKA,2014.0,1,0,1
SWE,ALB,2017.0,1,0,1
ROU,DZA,2016.0,1,0,1
GLP,,2019.0,11,0,11
ROU,DZA,2017.0,1,0,1
ISL,LUX,2019.0,1,0,1
BLR,GRC,2022.0,1,0,1
,SDN,2011.0,120,0,120
,NIC,2014.0,20,0,20
COD,ITA,2017.0,1,0,1
ECU,ISR,2015.0,1,0,1
ISR,ECU,2017.0,2,0,2
BRN,,2020.0,26,0,26
,ECU,2010.0,137,0,137
IDN,,2004.0,39,0,39
JOR,ARE,2010.0,10,0,10
MNE,CHE,2009.0,1,0,1
,ALB,2011.0,165,0,165
CYP,IRN,2014.0,1,0,1
SDN,ETH,2022.0,2,0,2
UKR,FIN,2006.0,3,0,3
NZL,FJI,2006.0,4,0,4
,BIH,2006.0,205,0,205
,BRN,2010.0,38,0,38
,ALB,1994.0,32,0,32
VEN,DOM,2018.0,2,0,2
KEN,PRT,2015.0,1,0,1
MRT,,2019.0,12,0,12
BEL,MDA,2014.0,3,0,3
LSO,BWA,2003.0,2,0,2
NZL,SAU,2011.0,1,0,1
,SWZ,2011.0,9,0,9
JAM,,2019.0,60,0,60
NPL,SWE,2016.0,2,0,2
RUS,IRQ,2015.0,2,0,2
HRV,CHL,2009.0,1,0,1
SYC,GBR,2016.0,2,0,2
,MNE,2009.0,40,0,40
,ARM,2010.0,157,0,157
UKR,IRQ,2017.0,2,0,2
LUX,NZL,2017.0,2,0,2
BGD,NPL,2016.0,5,0,5
MAR,AUS,2020.0,1,0,1
,PSE,2014.0,87,0,87
SLE,TWN,2020.0,1,0,1
,TGO,2009.0,37,0,37
,NIC,2015.0,25,0,25
UKR,IRQ,2018.0,1,0,1
,KHM,2014.0,72,0,72
,BHR,2010.0,46,0,46
GAB,,2018.0,25,0,25
BLR,SRB,2003.0,1,0,1
KOR,IRQ,2018.0,2,0,2
IRN,LTU,2022.0,3,0,3
KEN,CHL,2018.0,1,0,1
,PYF,2014.0,14,0,14
ESP,VNM,2005.0,4,0,4
SEN,GIN,2018.0,3,0,3
HUN,LBN,2019.0,1,0,1
JPN,UGA,2021.0,2,0,2
REU,,2021.0,11,0,11
CZE,MLT,2022.0,1,0,1
NCL,PYF,2018.0,2,0,2
MYS,ETH,2018.0,3,0,3
CYM,,2017.0,3,0,3
,BOL,2009.0,51,0,51
ARG,AUT,2018.0,5,0,5
TUN,IRL,2023.0,1,0,1
BGR,CZE,2001.0,1,0,1
,TTO,1995.0,63,0,63
KOR,AZE,2010.0,1,0,1
KEN,TUR,2009.0,3,0,3
ISL,,2004.0,36,0,36
CYP,,2006.0,14,0,14
SWE,ARG,2002.0,10,0,10
NZL,ISL,1999.0,1,0,1
SVK,BEL,1997.0,4,0,4
TWN,MEX,2008.0,1,0,1
CAN,GEO,2000.0,1,0,1
SEN,CAF,2005.0,1,0,1
MWI,NLD,1999.0,1,0,1
ROU,BRA,2008.0,1,0,1
ETH,LAO,2001.0,1,0,1
,NCL,1999.0,7,0,7
,TJK,1995.0,21,0,21
NGA,LBR,2012.0,2,0,2
KWT,JPN,1999.0,3,0,3
MAR,SAU,2000.0,1,0,1
GUF,,2022.0,26,0,26
LKA,,2004.0,21,0,21
JAM,NGA,2008.0,1,0,1
NGA,JAM,2009.0,2,0,2
AZE,DEU,2004.0,1,0,1
ZAF,LKA,2014.0,2,0,2
BEL,CMR,2006.0,2,0,2
FRA,CYP,2018.0,4,0,4
IRL,EST,2016.0,1,0,1
SYR,NGA,2000.0,2,0,2
NZL,BHR,2023.0,1,0,1
BEN,,2015.0,52,0,52
UKR,THA,2015.0,2,0,2
EST,NOR,2001.0,2,0,2
JPN,SAU,2009.0,7,0,7
MLI,,2012.0,19,0,19
RWA,LKA,2003.0,1,0,1
KAZ,,2000.0,25,0,25
LTU,HRV,2002.0,1,0,1
LVA,,1999.0,14,0,14
GRC,URY,2018.0,1,0,1
JPN,ETH,2008.0,3,0,3
,MNE,1994.0,3,0,3
ETH,,2000.0,13,0,13
NPL,,2015.0,110,0,110
CRI,,2003.0,11,0,11
NCL,,2015.0,17,0,17
COG,ZAF,2004.0,1,0,1
BRB,,2003.0,3,0,3
BGR,PRT,1998.0,3,0,3
BEL,NPL,2015.0,1,0,1
KWT,CYP,2018.0,1,0,1
RUS,ZAF,2000.0,3,0,3
SWE,IDN,2016.0,6,0,6
NGA,MYS,2003.0,1,0,1
PRT,ROU,2008.0,3,0,3
BRA,UKR,2003.0,5,0,5
IDN,,2001.0,44,0,44
ETH,,2006.0,35,0,35
BFA,,2010.0,26,0,26
GUF,MDG,2018.0,1,0,1
CRI,PAN,2011.0,4,0,4
GMB,NLD,2007.0,2,0,2
SYR,,2002.0,11,0,11
DZA,TWN,2022.0,1,0,1
FRA,TZA,2003.0,1,0,1
USA,MHL,1998.0,1,0,1
MHL,USA,2001.0,2,0,2
MEX,URY,2001.0,5,0,5
TUR,LBY,2020.0,6,0,6
,PRY,2010.0,31,0,31
TWN,MWI,2021.0,2,0,2
BLR,AZE,2018.0,1,0,1
SRB,CHN,2018.0,2,0,2
ARG,ECU,2015.0,7,0,7
COL,JPN,2006.0,3,0,3
BIH,NOR,2020.0,2,0,2
MUS,,2020.0,20,0,20
,YEM,2017.0,57,0,57
SLE,,2023.0,78,0,78
CZE,SEN,2017.0,1,0,1
,VUT,2013.0,6,0,6
,PYF,2015.0,12,0,12
USA,FRA,2024.0,3,0,3
BEL,MNG,2021.0,1,0,1
,GUY,2019.0,12,0,12
MEX,EST,2018.0,2,0,2
NGA,MWI,2023.0,1,0,1
,FLK,2016.0,3,0,3
,BDI,2015.0,7,0,7
BRA,TUR,2022.0,1,0,1
EST,IRL,2002.0,1,0,1
BGR,LBN,2020.0,3,0,3
,NAM,2017.0,58,0,58
CHE,TZA,2004.0,2,0,2
,MDA,2017.0,100,0,100
VIR,,2009.0,1,0,1
SWE,KWT,2003.0,1,0,1
CUB,CAN,2016.0,6,0,6
BGD,,2000.0,43,0,43
FRA,FJI,2013.0,2,0,2
ITA,MDG,2006.0,1,0,1
MDG,ITA,2013.0,1,0,1
GUF,,2026.0,5,0,5
NGA,ETH,2003.0,2,0,2
,QAT,2005.0,53,0,53
FIN,SAU,2013.0,3,0,3
MRT,,2009.0,5,0,5
ETH,LBR,2016.0,8,0,8
LTU,AUS,2019.0,2,0,2
,MRT,2017.0,21,0,21
,THA,2021.0,17,0,17
LIE,,2007.0,4,0,4
ARM,MYS,2003.0,1,0,1
IRN,PSE,2022.0,3,0,3
,GLP,2017.0,1,0,1
ESP,ARE,2013.0,5,0,5
NIC,,2013.0,13,0,13
KEN,,2002.0,33,0,33
SEN,GIN,2022.0,3,0,3
CRI,GTM,2012.0,2,0,2
SDN,ARE,2018.0,3,0,3
ERI,HUN,2021.0,1,0,1
,JAM,2017.0,46,0,46
DZA,MRT,2021.0,1,0,1
,SOM,2012.0,4,0,4
,CRI,2006.0,98,0,98
OMN,LKA,2021.0,1,0,1
DNK,PAN,2003.0,1,0,1
,GAB,1995.0,29,0,29
SWE,VNM,1997.0,6,0,6
ISR,SGP,2001.0,1,0,1
EST,,2004.0,36,0,36
DNK,BGR,2020.0,1,0,1
BRA,PRI,2003.0,1,0,1
GBR,DMA,2013.0,1,0,1
ARG,PER,2012.0,6,0,6
DEU,QAT,2002.0,1,0,1
HRV,KWT,2016.0,1,0,1
MLT,,2004.0,8,0,8
,IRQ,1995.0,56,0,56
COL,GTM,2012.0,1,0,1
NIC,ESP,2002.0,1,0,1
GBR,SDN,1997.0,1,0,1
PRK,,2020.0,14,0,14
,AFG,2001.0,8,0,8
NPL,,2001.0,14,0,14
IRL,BGD,2016.0,3,0,3
DNK,OMN,2001.0,1,0,1
KWT,NOR,2017.0,2,0,2
GIN,SEN,2007.0,3,0,3
SYR,DZA,2018.0,1,0,1
BRA,NZL,2009.0,4,0,4
PNG,,1999.0,7,0,7
RUS,CYP,2008.0,1,0,1
,ECU,2006.0,78,0,78
MLT,,2008.0,6,0,6
SYR,EGY,2019.0,1,0,1
VEN,CHE,2000.0,1,0,1
,GTM,2002.0,18,0,18
PRY,MEX,2016.0,3,0,3
ETH,SGP,1999.0,1,0,1
BRA,THA,2003.0,1,0,1
ISR,BHS,2020.0,1,0,1
BGR,KOR,2006.0,1,0,1
ECU,BEL,2009.0,3,0,3
BEL,MOZ,2008.0,1,0,1
KAZ,,2006.0,35,0,35
SDN,MYS,2009.0,1,0,1
IRN,RUS,2024.0,3,0,3
TZA,NOR,2000.0,2,0,2
DNK,HRV,2002.0,1,0,1
UGA,,2012.0,55,0,55
KOR,NGA,2017.0,2,0,2
MMR,SGP,2011.0,1,0,1
,MWI,2009.0,118,0,118
LBN,JOR,2011.0,1,0,1
,NIC,2008.0,22,0,22
,NIC,2004.0,18,0,18
,BFA,2006.0,77,0,77
,CCK,2007.0,2,0,2
,VGB,2002.0,1,0,1
CHL,PAN,2019.0,1,0,1
BGD,HUN,2014.0,1,0,1
TUR,IRQ,2011.0,2,0,2
BGD,FIN,2013.0,2,0,2
DZA,YEM,2007.0,2,0,2
YEM,DZA,2010.0,2,0,2
,URY,2006.0,198,0,198
TUN,TUR,2016.0,12,0,12
BIH,SVK,2013.0,2,0,2
THA,LAO,2020.0,9,0,9
IRL,BWA,2019.0,2,0,2
USA,MAC,2005.0,1,0,1
IRL,OMN,2003.0,1,0,1
TCA,OMN,2007.0,1,0,1
ARE,UZB,2023.0,1,0,1
CAN,TTO,2018.0,7,0,7
UZB,,2000.0,28,0,28
MYS,GAB,2014.0,1,0,1
KNA,NZL,2016.0,1,0,1
GRC,SRB,2012.0,4,0,4
,HND,2012.0,21,0,21
MOZ,,2018.0,34,0,34
BLR,CAN,2016.0,3,0,3
,TLS,2007.0,3,0,3
ARE,MWI,2018.0,1,0,1
AFG,POL,2017.0,1,0,1
,MUS,2005.0,21,0,21
ECU,GBR,2011.0,1,0,1
,BDI,2008.0,9,0,9
GMB,GNB,2003.0,1,0,1
GNB,GMB,2008.0,1,0,1
HTI,,2020.0,22,0,22
,LKA,2005.0,141,0,141
COD,,2012.0,7,0,7
OMN,ROU,2014.0,3,0,3
SLV,PRY,2021.0,1,0,1
GBR,CRI,2017.0,3,0,3
SVN,NOR,2021.0,1,0,1
BEL,KEN,2014.0,4,0,4
NGA,OMN,2011.0,1,0,1
THA,ARG,2016.0,7,0,7
ESP,BGR,2020.0,2,0,2
CHE,GIN,2012.0,1,0,1
LKA,SGP,2012.0,1,0,1
DEU,TGO,2023.0,1,0,1
,PRK,2006.0,6,0,6
GUY,CAN,2016.0,1,0,1
SLE,NPL,2021.0,1,0,1
LIE,,2020.0,11,0,11
LBR,ZAF,2017.0,2,0,2
SYR,USA,2016.0,3,0,3
ARG,DZA,2020.0,6,0,6
POL,GTM,2018.0,1,0,1
PNG,,2020.0,32,0,32
MWI,IRQ,2017.0,1,0,1
HRV,ESP,2005.0,2,0,2
,MLT,2020.0,57,0,57
CHN,BEN,2019.0,1,0,1
BTN,SSD,2020.0,1,0,1
,BRN,2000.0,7,0,7
BHR,EGY,1997.0,2,0,2
HKG,VNM,2015.0,1,0,1
GUY,GBR,2022.0,4,0,4
DJI,,2021.0,4,0,4
KEN,PER,2022.0,2,0,2
MAR,GAB,2021.0,3,0,3
IRN,ARM,2021.0,2,0,2
MNG,,2026.0,7,0,7
BRA,SDN,2020.0,1,0,1
MAR,PRT,2007.0,1,0,1
COL,ABW,2019.0,1,0,1
CUB,ARG,2005.0,3,0,3
GAB,,2022.0,43,0,43
CHN,MDG,2022.0,1,0,1
SLV,,2021.0,16,0,16
LBN,IRL,2021.0,2,0,2
KOR,SDN,2019.0,1,0,1
CYP,UKR,2020.0,1,0,1
GHA,PRT,2020.0,2,0,2
,FRO,2018.0,7,0,7
CZE,EGY,2001.0,3,0,3
CYP,GHA,2022.0,2,0,2
BGD,NPL,2022.0,4,0,4
,MRT,2018.0,14,0,14
MYS,MWI,2022.0,1,0,1
DZA,DEU,2022.0,5,0,5
WSM,,2023.0,15,0,15
GMB,CHN,2020.0,1,0,1
,AUS,2021.0,72,0,72
ZAF,PRT,2023.0,2,0,2
EGY,UGA,2023.0,1,0,1
,MKD,2020.0,74,0,74
NOR,BIH,2006.0,1,0,1
BIH,NOR,2007.0,1,0,1
PRY,,2015.0,12,0,12
GRC,SGP,2014.0,3,0,3
CYP,ISR,2010.0,1,0,1
IDN,SWE,2000.0,1,0,1
MYS,QAT,2008.0,1,0,1
TZA,NOR,2019.0,7,4,3
ISR,RUS,2022.0,12,20,-8
PRT,SGP,2017.0,3,2,1
BLR,USA,2016.0,3,6,-3
RUS,ISR,2015.0,16,10,6
BEL,ROU,2022.0,6,10,-4
RUS,HUN,2016.0,1,3,-2
NPL,CAN,2021.0,2,1,1
GIN,USA,2017.0,1,3,-2
BRA,IRL,2017.0,14,10,4
COL,NOR,2023.0,2,1,1
DNK,AUT,2022.0,11,16,-5
SWE,TUR,2012.0,10,12,-2
ITA,HUN,2016.0,12,10,2
CAN,GRC,2009.0,11,12,-1
BGD,GBR,2008.0,13,8,5
BEL,JPN,2017.0,23,20,3
PRT,CZE,2019.0,5,2,3
AUS,VNM,2018.0,43,27,16
ZAF,NZL,2023.0,2,2,0
CAN,KNA,2019.0,2,1,1
KNA,CAN,2021.0,1,1,0
JOR,EGY,2023.0,6,5,1
ZAF,UGA,2022.0,12,9,3
POL,ARE,2020.0,4,3,1
BGD,PAK,2008.0,11,1,10
ESP,CRI,2014.0,11,11,0
NPL,DEU,2014.0,5,1,4
CHN,PHL,2022.0,12,7,5
IND,TUR,2016.0,14,5,9
HRV,AUT,2019.0,9,6,3
AUT,HUN,2003.0,12,12,0
HKG,LKA,2019.0,3,2,1
ETH,OMN,2020.0,1,1,0
OMN,AUS,2021.0,2,5,-3
LBN,DEU,2019.0,12,7,5
NLD,KAZ,2013.0,4,1,3
KAZ,KGZ,2019.0,4,5,-1
HRV,ESP,2020.0,5,5,0
SRB,CHE,2021.0,12,3,9
EGY,TUR,2020.0,8,6,2
CYP,CHE,2022.0,2,4,-2
CZE,BRA,2023.0,3,10,-7
CHE,SRB,2019.0,6,5,1
DNK,MEX,2022.0,4,7,-3
NZL,IRL,2021.0,12,12,0
UGA,CAN,2020.0,5,3,2
IND,KWT,2002.0,4,10,-6
KWT,GBR,2003.0,8,3,5
CHN,EST,2022.0,5,1,4
SGP,VNM,2022.0,6,4,2
EST,AUS,2022.0,2,5,-3
IRQ,GBR,2023.0,19,19,0
NZL,PRT,2003.0,2,2,0
TUR,ESP,2023.0,7,13,-6
FRA,MNG,2021.0,1,1,0
NPL,IND,2006.0,20,17,3
BGD,JPN,1999.0,8,19,-11
USA,PER,1999.0,15,13,2
MWI,USA,2009.0,6,15,-9
CHN,PAK,2007.0,7,8,-1
HKG,PAK,2023.0,3,12,-9
CHN,NPL,2015.0,5,1,4
IRQ,ITA,2021.0,4,2,2
JPN,CHL,2009.0,3,1,2
BEL,PAK,2021.0,10,6,4
ROU,ITA,2003.0,6,13,-7
DNK,FRO,2022.0,5,7,-2
NLD,ARG,2017.0,4,4,0
BRA,ISR,2011.0,3,4,-1
GRC,FRA,2010.0,29,28,1
PSE,ISR,2006.0,5,10,-5
SWE,PSE,2010.0,1,1,0
CAN,LBN,2008.0,5,10,-5
LBN,ARE,2017.0,5,3,2
TUR,IRL,2006.0,2,1,1
SWE,TZA,2014.0,4,6,-2
ZAF,COG,2012.0,1,1,0
THA,GBR,2009.0,21,62,-41
JPN,BGR,1999.0,3,9,-6
MAC,SGP,2007.0,2,1,1
TUR,CHN,2009.0,5,5,0
IRN,ARE,2019.0,3,1,2
CHN,ITA,2005.0,6,15,-9
QAT,KOR,2013.0,3,6,-3
TUR,KOR,2016.0,8,2,6
KOR,SGP,2000.0,5,1,4
CHN,BRA,2002.0,5,8,-3
IRL,ISR,2015.0,7,2,5
BRA,CMR,2017.0,1,2,-1
MWI,NOR,2013.0,1,1,0
JOR,DEU,2007.0,7,8,-1
ITA,FIN,2014.0,22,12,10
COG,FRA,2016.0,13,7,6
FRA,COG,2018.0,6,2,4
GBR,IDN,2012.0,11,2,9
EGY,CHN,2007.0,3,2,1
USA,CZE,2009.0,38,36,2
JPN,TUR,2008.0,11,2,9
USA,JAM,2013.0,9,12,-3
CZE,NLD,2003.0,5,1,4
PRT,SVK,2013.0,1,1,0
FRA,AGO,2005.0,3,1,2
CZE,JPN,2020.0,5,10,-5
CAN,ISR,2009.0,39,54,-15
ITA,NOR,2011.0,12,9,3
BEL,AUS,2007.0,18,11,7
NOR,GRC,2008.0,1,6,-5
MYS,IND,2009.0,33,50,-17
POL,PRT,2016.0,7,5,2
CAN,PAK,2009.0,11,14,-3
AUS,HKG,2014.0,31,48,-17
BEL,LUX,2011.0,15,8,7
ETH,GBR,2011.0,8,6,2
COL,CHL,1998.0,2,2,0
AUS,BGR,2018.0,1,2,-1
NZL,FRA,2013.0,21,11,10
ISR,PSE,2010.0,19,17,2
CZE,SVN,2009.0,2,3,-1
SAU,TWN,2017.0,4,4,0
ISR,JPN,2020.0,10,5,5
IRN,IRL,2011.0,14,9,5
CRI,USA,2007.0,9,17,-8
PAK,AUT,2010.0,11,7,4
IRN,IRL,2009.0,4,7,-3
USA,GRD,2015.0,10,13,-3
NLD,MWI,2017.0,3,3,0
SWE,HUN,2016.0,5,12,-7
CZE,FRA,2012.0,22,10,12
GRC,ARE,2012.0,5,1,4
ZAF,ZWE,2010.0,6,29,-23
ETH,ZWE,2022.0,1,1,0
NLD,ZWE,2006.0,1,2,-1
AUS,ARE,2010.0,12,7,5
EGY,PAK,2011.0,2,1,1
QAT,CYP,2020.0,2,1,1
NOR,GRC,2015.0,3,13,-10
USA,HND,2009.0,3,2,1
POL,DNK,2005.0,3,6,-3
GBR,MEX,2007.0,35,36,-1
CHE,MEX,2010.0,4,5,-1
BWA,USA,2015.0,18,17,1
SAU,ARE,2007.0,9,3,6
IND,AUT,2010.0,11,7,4
FRA,MLI,2006.0,11,2,9
MLI,SWE,2011.0,2,1,1
AUS,TWN,2000.0,7,3,4
PSE,ISR,2010.0,17,19,-2
CIV,MLI,2012.0,4,4,0
JOR,IRQ,2007.0,2,4,-2
GBR,ZWE,2007.0,2,5,-3
ITA,ISR,2011.0,13,7,6
HKG,ISR,2010.0,1,1,0
SVK,SVN,2009.0,24,22,2
UKR,POL,2006.0,21,16,5
HRV,BEL,2013.0,3,2,1
AUT,IDN,2013.0,3,1,2
THA,JPN,2009.0,33,93,-60
MYS,SGP,2005.0,8,7,1
SGP,MYS,2015.0,22,19,3
LBN,FRA,2012.0,23,66,-43
LBN,ARE,2022.0,20,3,17
JPN,TZA,2007.0,5,1,4
KOR,ARM,2012.0,1,1,0
CRI,DEU,2003.0,2,7,-5
HRV,SVN,2007.0,1,5,-4
ZAF,CHL,2015.0,4,2,2
SYR,FRA,2004.0,1,3,-2
AUS,BRA,2010.0,14,30,-16
SGP,CAN,2011.0,24,23,1
SVK,USA,2013.0,16,11,5
IDN,DEU,2005.0,5,7,-2
MCO,FRA,2010.0,4,6,-2
DEU,ZAF,2020.0,41,54,-13
ETH,ZAF,2008.0,5,4,1
FRA,MTQ,2023.0,8,16,-8
DZA,FRA,1998.0,21,26,-5
CUB,VEN,2007.0,3,1,2
BFA,FRA,2009.0,3,15,-12
FRA,ZWE,2022.0,3,2,1
JOR,USA,2000.0,23,9,14
AUS,ZAF,2008.0,24,36,-12
ARG,GBR,2017.0,22,20,2
CHE,ETH,2017.0,2,5,-3
BRA,JPN,2005.0,6,9,-3
EGY,HUN,2019.0,5,1,4
EST,CZE,2016.0,2,1,1
ARG,PER,2007.0,4,1,3
CAN,SEN,2021.0,2,3,-1
ZMB,BEL,2006.0,1,2,-1
NPL,THA,2014.0,4,4,0
MAR,ITA,2002.0,3,3,0
ITA,BEN,2009.0,1,1,0
BRA,RUS,2011.0,4,5,-1
PRT,CHN,2003.0,4,6,-2
SRB,DEU,2005.0,21,29,-8
DEU,SRB,2010.0,8,5,3
ROU,GBR,2009.0,10,11,-1
GTM,USA,2014.0,9,7,2
QAT,MYS,2014.0,1,3,-2
USA,GHA,2010.0,13,7,6
MLI,USA,2014.0,11,4,7
PHL,SGP,2007.0,2,1,1
JPN,KEN,2018.0,6,6,0
SGP,BRA,2017.0,3,6,-3
BEN,BEL,2007.0,2,2,0
KOR,THA,2011.0,4,5,-1
DEU,CMR,2007.0,2,4,-2
NLD,TZA,2009.0,7,2,5
RUS,ARM,2022.0,6,4,2
RUS,AZE,2016.0,18,4,14
VEN,CHL,2007.0,5,2,3
KOR,SGP,2006.0,9,7,2
DNK,AUT,2017.0,13,12,1
LUX,DEU,2013.0,13,42,-29
SVK,AUT,2013.0,11,11,0
IRL,HUN,2021.0,5,1,4
BRA,CRI,2009.0,2,1,1
ITA,ZAF,2022.0,6,12,-6
CHN,PHL,2017.0,3,8,-5
JOR,QAT,2020.0,16,6,10
NZL,HRV,2019.0,1,1,0
PRT,ZAF,2019.0,2,3,-1
JPN,LBY,2020.0,1,1,0
BEL,SWE,2004.0,10,14,-4
IND,EST,2020.0,7,1,6
SVN,NLD,2019.0,1,3,-2
ESP,AUT,2021.0,30,29,1
GBR,COL,2004.0,11,7,4
JPN,HKG,2022.0,14,12,2
THA,SWE,2017.0,7,16,-9
DEU,ARG,2023.0,8,27,-19
KAZ,AUS,2017.0,2,1,1
HUN,SWE,2018.0,15,3,12
TUR,SGP,2018.0,6,1,5
GBR,COL,2015.0,21,9,12
SAU,TWN,2018.0,2,9,-7
MAC,USA,2016.0,7,11,-4
LBN,SAU,2017.0,5,3,2
SWE,LTU,2019.0,8,4,4
ITA,MAR,2002.0,3,3,0
BEL,NOR,2023.0,5,7,-2
EGY,JPN,2022.0,34,63,-29
GBR,KHM,2021.0,7,8,-1
CHE,ROU,2015.0,6,15,-9
CAN,PAK,2019.0,28,23,5
CYP,DEU,2022.0,8,8,0
TUR,ZAF,2018.0,5,6,-1
DNK,BGD,2022.0,3,1,2
ARE,SGP,2022.0,5,7,-2
AUT,SRB,2021.0,8,8,0
BEL,SWE,2008.0,12,9,3
KOR,SGP,2023.0,22,13,9
ETH,USA,2020.0,24,35,-11
KOR,THA,2021.0,18,7,11
DEU,IRL,2022.0,39,48,-9
PAK,THA,2014.0,4,13,-9
YEM,MYS,2017.0,7,16,-9
ARE,PAK,2016.0,5,15,-10
ZAF,SWZ,2019.0,12,5,7
LUX,SWE,2021.0,3,6,-3
SGP,PAK,2020.0,3,5,-2
ITA,SAU,2017.0,25,6,19
IRL,ZAF,2021.0,6,9,-3
ZMB,TZA,2020.0,1,2,-1
TWN,NZL,2015.0,5,1,4
AUS,KHM,2017.0,4,1,3
KEN,ETH,2014.0,3,4,-1
NOR,IRN,2019.0,5,10,-5
SAU,CYP,2021.0,1,1,0
NOR,CHN,2018.0,31,37,-6
SVN,SVK,2004.0,9,20,-11
CZE,FIN,2002.0,4,4,0
DEU,EST,2008.0,7,4,3
EGY,GBR,2005.0,6,21,-15
GBR,TZA,1999.0,5,11,-6
UGA,DEU,2001.0,1,4,-3
ISR,PSE,2023.0,8,7,1
GLP,FRA,1999.0,17,19,-2
SWE,ETH,2003.0,15,2,13
HRV,SRB,2009.0,18,8,10
GBR,ISL,2007.0,7,4,3
ZAF,DEU,1998.0,11,13,-2
GBR,TZA,1998.0,5,5,0
ZAF,BEL,1999.0,6,4,2
BEL,ZAF,2000.0,1,4,-3
BGR,ISR,1999.0,2,1,1
TUN,DEU,2001.0,1,2,-1
FRA,URY,2000.0,5,3,2
NLD,SVK,2002.0,4,7,-3
DEU,ZAF,1998.0,13,11,2
ZAF,ZWE,2000.0,2,6,-4
NLD,HRV,2020.0,2,7,-5
AUT,THA,2000.0,4,3,1
SVK,RUS,2018.0,3,3,0
THA,DEU,2017.0,19,29,-10
ETH,AUT,2003.0,2,1,1
SWE,VEN,2004.0,1,2,-1
IRL,ITA,2005.0,9,11,-2
EGY,GBR,2002.0,13,19,-6
DZA,FRA,1999.0,11,28,-17
BEL,LTU,2011.0,2,2,0
NLD,TUR,1997.0,1,1,0
DEU,ISL,2014.0,3,4,-1
NOR,AUT,1999.0,2,1,1
NGA,BEN,2002.0,6,2,4
IRN,CHE,1998.0,1,2,-1
ARM,DEU,2000.0,6,4,2
CHE,THA,2007.0,7,1,6
MWI,UGA,2018.0,1,1,0
BGR,USA,2008.0,15,11,4
GRC,SWE,2002.0,9,3,6
USA,TTO,1999.0,7,5,2
MEX,ITA,2011.0,16,14,2
TUR,AUS,2019.0,21,10,11
CHL,ITA,2007.0,8,8,0
ITA,ISR,2009.0,12,15,-3
GRC,SWE,1997.0,4,11,-7
EGY,RUS,2016.0,3,2,1
NLD,OMN,2007.0,1,1,0
AUS,FJI,2003.0,6,6,0
CHL,CAN,2008.0,12,10,2
JPN,NGA,2004.0,5,3,2
PSE,DEU,2009.0,3,6,-3
HRV,ITA,2003.0,5,3,2
FIN,CHE,2011.0,24,9,15
IND,PAK,2000.0,4,1,3
USA,ETH,2000.0,4,8,-4
DEU,JOR,2005.0,8,10,-2
ARE,CAN,2004.0,5,10,-5
DEU,DZA,2003.0,3,2,1
ISL,SWE,2017.0,14,15,-1
SWE,ISL,2019.0,23,14,9
URY,ESP,1997.0,2,5,-3
BRA,NOR,2009.0,1,3,-2
SVN,CHN,2011.0,2,3,-1
USA,GHA,2006.0,9,11,-2
IRN,DEU,2003.0,6,10,-4
NLD,HUN,2022.0,10,14,-4
PRT,ROU,2003.0,1,1,0
USA,BRB,2010.0,3,1,2
QAT,SAU,2018.0,3,13,-10
SWE,EST,1998.0,4,8,-4
ESP,SWE,1999.0,23,15,8
FRA,PER,2000.0,3,2,1
IDN,THA,2004.0,1,1,0
ESP,PHL,2001.0,13,5,8
TUR,CYP,2011.0,22,21,1
CIV,CHE,2000.0,2,1,1
POL,CZE,2002.0,3,2,1
FIN,AUT,2009.0,6,2,4
USA,CYP,1998.0,8,2,6
PHL,NLD,2012.0,2,2,0
MDA,DEU,2013.0,4,2,2
TUR,AZE,2018.0,14,6,8
KOR,TWN,2007.0,3,6,-3
IND,IRN,1997.0,5,1,4
DEU,TUR,2003.0,18,27,-9
MWI,GBR,2006.0,4,9,-5
GTM,USA,2001.0,2,2,0
USA,GTM,2004.0,8,2,6
SWE,BGR,1998.0,2,2,0
ITA,SVK,2008.0,4,3,1
FIN,HUN,1998.0,1,3,-2
KWT,AUS,2019.0,4,9,-5
BRA,MEX,2007.0,13,8,5
ITA,ROU,2003.0,13,6,7
PNG,IDN,2011.0,1,1,0
SWE,ISR,2000.0,6,2,4
DNK,SGP,2023.0,7,7,0
OMN,ARE,2006.0,4,3,1
BEL,CHL,2008.0,6,5,1
CAN,EST,2010.0,3,2,1
CUB,DEU,2003.0,3,2,1
CHL,ARG,2004.0,8,5,3
AZE,USA,2015.0,1,2,-1
ROU,USA,2017.0,21,36,-15
SWE,THA,2000.0,3,2,1
MEX,COL,1997.0,6,1,5
MDA,UKR,1999.0,1,3,-2
RUS,KOR,2004.0,12,19,-7
ISL,DNK,2003.0,8,3,5
SRB,ALB,2021.0,12,8,4
AUS,BRA,2000.0,8,8,0
NZL,BEL,2009.0,2,1,1
VNM,GBR,1998.0,1,2,-1
SWE,LTU,2009.0,6,5,1
ITA,EGY,2019.0,29,12,17
CHE,BEL,2010.0,32,40,-8
CHE,NOR,2006.0,10,5,5
RUS,ZAF,2009.0,4,3,1
SWE,ARE,2018.0,8,4,4
POL,BLR,2020.0,5,3,2
DEU,EST,2004.0,3,3,0
AUS,ISR,2015.0,10,18,-8
SGP,ZAF,2007.0,3,2,1
THA,CAN,1999.0,2,7,-5
SWE,TZA,2008.0,5,4,1
MEX,CZE,2000.0,2,1,1
SWE,UGA,2012.0,7,5,2
USA,GUM,2003.0,7,7,0
SWE,MEX,2014.0,7,7,0
USA,MAR,2014.0,11,3,8
ZAF,NZL,2000.0,6,2,4
JPN,BRA,2010.0,9,15,-6
LSO,ZAF,2010.0,5,2,3
BGD,DEU,1999.0,2,3,-1
FRA,BFA,2013.0,18,6,12
CIV,BFA,2000.0,6,1,5
SWE,ROU,2004.0,2,2,0
GBR,HRV,2000.0,4,2,2
NLD,PRT,2002.0,14,9,5
GBR,AUT,2007.0,32,52,-20
BGR,JPN,2006.0,8,7,1
TUR,ESP,2006.0,3,2,1
CHL,CHE,2022.0,6,5,1
NLD,KEN,2006.0,4,3,1
GRC,JPN,2002.0,4,1,3
SAU,IND,2005.0,6,8,-2
ESP,BOL,2015.0,6,2,4
FIN,ARG,2017.0,1,1,0
ARE,JOR,2003.0,2,3,-1
MYS,SWE,2005.0,1,1,0
USA,ARM,2018.0,9,9,0
JPN,ZAF,2015.0,5,3,2
RUS,CHN,1999.0,7,11,-4
ARG,DNK,2004.0,2,1,1
GRC,QAT,2020.0,6,2,4
LVA,RUS,1998.0,2,3,-1
AUS,ISR,2008.0,12,8,4
CAN,AUT,2013.0,12,14,-2
MEX,GTM,2012.0,4,2,2
CHE,RUS,2014.0,12,25,-13
NLD,RUS,2005.0,14,17,-3
HKG,IND,2010.0,8,3,5
FRA,LUX,2006.0,24,4,20
NZL,ZAF,2009.0,2,11,-9
PRT,SWE,2009.0,2,12,-10
DEU,ARM,2006.0,6,2,4
GHA,USA,2011.0,12,19,-7
CAN,UKR,2006.0,3,4,-1
ESP,SWE,2007.0,19,40,-21
SVK,ITA,2021.0,7,6,1
FIN,DNK,2009.0,9,4,5
GBR,MWI,2010.0,18,8,10
HRV,USA,2007.0,16,17,-1
SWZ,ZAF,2012.0,11,2,9
NLD,UGA,2011.0,4,1,3
USA,KGZ,2011.0,4,1,3
ARG,URY,2015.0,9,6,3
SVK,SRB,2009.0,2,1,1
PRT,COL,2016.0,4,4,0
NLD,IND,2010.0,19,39,-20
COL,ARM,2019.0,1,2,-1
KEN,GHA,2010.0,1,2,-1
IDN,VNM,2019.0,3,2,1
ROU,AUS,2022.0,1,1,0
GBR,KEN,2009.0,25,20,5
IRN,CHN,2010.0,5,3,2
SRB,BIH,2009.0,8,7,1
BWA,ZAF,2023.0,10,7,3
ROU,NOR,2013.0,1,1,0
IRN,ARE,2011.0,3,1,2
TZA,USA,2010.0,14,12,2
SGP,TUR,2012.0,4,3,1
VEN,BRA,2007.0,11,3,8
ITA,IND,2022.0,31,45,-14
ISL,DEU,2009.0,4,2,2
FIN,POL,2014.0,8,5,3
NOR,IRN,2011.0,4,6,-2
UKR,ISR,2006.0,2,1,1
BEL,CMR,2009.0,3,4,-1
DEU,THA,2015.0,28,16,12
BEL,IRN,2019.0,14,21,-7
IND,ROU,2011.0,1,1,0
ARG,ECU,2013.0,6,5,1
PAK,SWE,2016.0,5,20,-15
USA,SRB,2012.0,31,9,22
IRN,CHE,2007.0,6,8,-2
ARE,TUN,2013.0,1,4,-3
URY,SWE,2007.0,2,1,1
PRT,DNK,2019.0,11,11,0
IRL,NLD,2017.0,17,15,2
SRB,HUN,2015.0,3,5,-2
SEN,CMR,2017.0,2,2,0
KEN,BEL,2011.0,1,2,-1
CAN,GHA,2012.0,4,4,0
ISR,CHN,2017.0,26,25,1
CIV,USA,2007.0,4,6,-2
USA,BWA,2010.0,9,10,-1
HKG,IRL,2015.0,2,2,0
CAN,BEN,2020.0,3,3,0
FRA,BGR,2020.0,11,2,9
FRA,FIN,2007.0,10,16,-6
DEU,MYS,2008.0,5,3,2
JPN,KEN,2016.0,9,5,4
CIV,BEL,2006.0,1,3,-2
ZAF,SAU,2018.0,16,7,9
MKD,DEU,2012.0,2,1,1
UKR,LTU,2014.0,4,1,3
FIN,EST,2011.0,14,8,6
USA,HND,2011.0,5,2,3
LKA,GBR,2008.0,4,13,-9
GRD,USA,2012.0,3,4,-1
SWE,SVN,2013.0,1,4,-3
QAT,FRA,2018.0,4,9,-5
POL,UKR,2010.0,11,18,-7
AUT,SGP,2015.0,3,7,-4
CHE,IRL,2007.0,12,5,7
ROU,GRC,2009.0,2,7,-5
GRC,CHE,2017.0,39,11,28
THA,AUS,2017.0,24,34,-10
BEL,ETH,2012.0,4,3,1
BGR,RUS,2006.0,1,3,-2
RUS,BGR,2018.0,5,5,0
BRA,AUT,2010.0,7,4,3
MWI,FRA,2016.0,1,1,0
CAN,ARE,2023.0,17,19,-2
CZE,CHE,2015.0,21,18,3
VEN,CAN,2008.0,6,2,4
ISL,GBR,2015.0,2,11,-9
GBR,ISL,2020.0,9,7,2
ITA,ECU,2012.0,3,1,2
ASM,USA,2021.0,2,2,0
YEM,IRQ,2004.0,1,1,0
LKA,GBR,2004.0,6,11,-5
MWI,USA,2011.0,15,9,6
FRA,ARE,2011.0,9,3,6
IND,IRL,2005.0,5,2,3
VNM,THA,2018.0,7,20,-13
USA,MAR,2008.0,4,4,0
PSE,DEU,2011.0,4,6,-2
CHL,IRL,2019.0,2,1,1
TUR,QAT,2013.0,2,1,1
NOR,NPL,2011.0,2,7,-5
JPN,BGD,2004.0,19,23,-4
ITA,CZE,2008.0,11,5,6
IRN,PRT,2014.0,12,7,5
CZE,ITA,2010.0,14,9,5
CHL,AUS,2009.0,5,5,0
CZE,ARG,2016.0,1,3,-2
HUN,ROU,2013.0,10,10,0
GBR,LUX,2010.0,8,4,4
RUS,ISR,2014.0,12,5,7
CZE,KOR,2017.0,5,2,3
PER,GBR,2011.0,5,3,2
RUS,KAZ,2009.0,20,11,9
PRT,AUT,2009.0,5,3,2
NLD,QAT,2018.0,5,2,3
GBR,PSE,2015.0,5,3,2
DZA,USA,2009.0,7,7,0
KHM,KOR,2010.0,1,2,-1
CHE,NOR,2010.0,12,16,-4
PER,VEN,2021.0,1,5,-4
ISL,SWE,2016.0,15,20,-5
COL,VEN,2012.0,9,13,-4
PRT,SWE,2011.0,10,6,4
TUR,ISR,2013.0,1,5,-4
DEU,PAK,2006.0,4,11,-7
SYR,JOR,2015.0,6,1,5
BEL,AUS,2020.0,38,26,12
PRT,NLD,1998.0,5,17,-12
FRA,TUR,2014.0,16,19,-3
CYP,GBR,2007.0,5,17,-12
SWE,LKA,2007.0,2,1,1
ISL,ITA,2016.0,1,3,-2
BFA,FRA,2011.0,15,14,1
GHA,NPL,2020.0,1,1,0
ESP,EGY,2014.0,8,7,1
ROU,TUR,2014.0,3,2,1
SVN,ITA,2018.0,11,12,-1
BGD,CAN,2016.0,26,21,5
CHN,CHE,2006.0,16,22,-6
NLD,ZAF,2009.0,17,23,-6
DNK,AUT,2018.0,11,10,1
KEN,FRA,2017.0,7,2,5
CYP,FRA,2017.0,3,4,-1
DEU,CMR,2020.0,9,6,3
NLD,ZAF,2011.0,17,17,0
TWN,MAC,2016.0,2,2,0
NGA,IND,2010.0,5,7,-2
CZE,CHN,2019.0,8,33,-25
ROU,NLD,2018.0,7,7,0
CHL,COL,2013.0,17,14,3
USA,LKA,2013.0,12,16,-4
LTU,DEU,2017.0,10,7,3
POL,HRV,2016.0,1,1,0
SVK,RUS,2022.0,4,10,-6
GBR,ISL,1998.0,2,1,1
POL,ZAF,2016.0,5,1,4
JPN,CAN,2015.0,83,76,7
GBR,IRQ,2013.0,18,9,9
COL,CZE,2014.0,1,1,0
SEN,MRT,2017.0,2,1,1
POL,NLD,2016.0,19,20,-1
CHE,NOR,2023.0,13,12,1
COL,AUS,2015.0,10,6,4
THA,FRA,2017.0,20,26,-6
SVK,AUS,2016.0,2,1,1
MEX,ITA,2019.0,19,21,-2
USA,FJI,2019.0,2,3,-1
JPN,SRB,2019.0,4,1,3
ESP,CZE,2016.0,25,13,12
FRA,KAZ,2015.0,5,2,3
IRQ,USA,2013.0,9,8,1
KOR,PRT,2009.0,3,1,2
EST,RUS,2015.0,2,5,-3
USA,TZA,2013.0,19,18,1
FRA,VNM,1999.0,5,8,-3
JPN,SWE,2023.0,6,16,-10
TUR,BRA,2015.0,5,1,4
SGP,BRA,2018.0,1,2,-1
GRC,AUS,2022.0,2,3,-1
FRA,AFG,2018.0,5,2,3
SVN,SWE,2018.0,6,5,1
FRA,NZL,2023.0,10,10,0
SWE,UKR,2016.0,6,9,-3
NGA,RWA,2020.0,3,3,0
BIH,SRB,2013.0,12,13,-1
JPN,POL,2023.0,6,5,1
BGD,PAK,2014.0,9,10,-1
NZL,FJI,2021.0,3,4,-1
THA,CAN,2020.0,11,19,-8
SAU,QAT,2018.0,13,3,10
CAN,TWN,2023.0,8,3,5
AUT,CAN,2023.0,14,16,-2
CZE,CHN,2021.0,12,17,-5
IRL,ARE,2020.0,3,3,0
SVN,ESP,2015.0,4,6,-2
PRT,FRA,2005.0,22,27,-5
HUN,IND,2013.0,2,1,1
GBR,TTO,2023.0,3,4,-1
JPN,IRN,2016.0,13,13,0
NOR,CHN,2016.0,26,37,-11
BGD,THA,2017.0,2,5,-3
CHL,NLD,2018.0,14,9,5
BGD,USA,2012.0,37,35,2
SAU,SDN,2017.0,6,24,-18
AUT,IND,2015.0,12,19,-7
TUR,ITA,2015.0,10,31,-21
DEU,ARE,2018.0,17,6,11
MWI,NGA,2017.0,1,3,-2
FRA,ARE,2021.0,30,6,24
ITA,TUN,2022.0,12,7,5
DEU,BGD,2014.0,11,8,3
CHE,RUS,2015.0,11,23,-12
CIV,CAN,2021.0,2,3,-1
AUS,VUT,2012.0,2,1,1
NZL,TWN,2017.0,3,5,-2
ECU,USA,2020.0,34,39,-5
EGY,HKG,2022.0,3,3,0
NPL,JPN,2014.0,8,12,-4
ISR,CHE,2023.0,9,16,-7
GBR,MDA,2016.0,1,1,0
ZAF,FIN,2015.0,5,5,0
SRB,NLD,2016.0,5,3,2
SGP,VNM,2017.0,8,3,5
DZA,USA,2019.0,2,9,-7
BFA,TGO,2019.0,3,2,1
CMR,CIV,2019.0,2,1,1
ESP,AND,2015.0,2,3,-1
KAZ,DEU,2020.0,4,7,-3
USA,GTM,2015.0,13,7,6
KOR,SAU,2023.0,20,11,9
ITA,PAK,2013.0,9,4,5
MLI,CHE,2020.0,1,1,0
NZL,MYS,2018.0,17,26,-9
NLD,CHL,2016.0,6,10,-4
DEU,CHN,2024.0,15,7,8
BRA,CHN,2020.0,22,13,9
NZL,MYS,2022.0,9,9,0
AND,ESP,2020.0,4,2,2
SHN,GBR,2019.0,2,1,1
DMA,DOM,2016.0,6,1,5
NZL,CAN,1998.0,14,24,-10
ETH,ZAF,2015.0,9,6,3
ITA,TUN,2016.0,7,3,4
BOL,ESP,2019.0,3,4,-1
BRA,CHL,2019.0,46,24,22
CIV,USA,2020.0,5,9,-4
HUN,SWE,2017.0,8,9,-1
GBR,AZE,2017.0,2,1,1
SAU,LBN,2012.0,3,6,-3
TWN,GBR,2012.0,24,42,-18
IND,ETH,2013.0,14,7,7
SVK,KEN,2019.0,2,4,-2
EST,DNK,2021.0,4,5,-1
NGA,LBR,2020.0,1,3,-2
FRA,BFA,2003.0,16,8,8
GHA,ZAF,2021.0,17,46,-29
TUR,KOR,2022.0,10,4,6
ESP,SAU,2022.0,11,7,4
IND,THA,2017.0,20,6,14
JPN,HKG,2017.0,17,15,2
COL,ITA,2018.0,9,14,-5
LTU,CHN,2018.0,5,1,4
GHA,NGA,2020.0,9,9,0
TWN,RUS,2010.0,8,1,7
GBR,MAC,2020.0,7,1,6
QAT,NLD,2020.0,3,5,-2
JPN,COL,2018.0,4,2,2
NGA,ESP,2015.0,1,1,0
ITA,ARE,2023.0,8,9,-1
FRA,PAK,2022.0,13,11,2
ROU,HUN,2023.0,11,4,7
SWE,HKG,2017.0,6,4,2
VEN,CHL,2020.0,24,2,22
GBR,HRV,2010.0,9,4,5
IRN,HKG,2014.0,4,1,3
KGZ,CHN,2021.0,1,2,-1
BEL,PRT,2007.0,2,4,-2
IND,TUR,2022.0,13,11,2
JPN,NZL,2021.0,6,11,-5
MEX,ISR,2022.0,3,1,2
NPL,USA,2023.0,33,10,23
HRV,ISR,2023.0,1,1,0
NOR,CHN,2017.0,32,16,16
UKR,DNK,2003.0,4,2,2
AUS,GRC,2016.0,5,10,-5
BRA,CZE,2015.0,4,6,-2
BGR,GBR,2011.0,16,16,0
BRA,CRI,2019.0,6,4,2
GBR,VNM,2011.0,20,14,6
AUS,SAU,2023.0,34,12,22
USA,LBR,2016.0,7,3,4
USA,COG,2021.0,4,4,0
USA,PRY,2021.0,8,5,3
BGD,NOR,2023.0,2,3,-1
BEL,IND,2022.0,17,32,-15
USA,HND,2021.0,4,4,0
CHN,RWA,2019.0,7,1,6
QAT,EGY,2021.0,10,9,1
COL,NLD,2012.0,6,4,2
HUN,JOR,2022.0,12,1,11
NZL,SGP,2015.0,15,20,-5
JPN,MEX,2023.0,2,4,-2
NGA,DEU,2022.0,14,12,2
RUS,ARM,2016.0,5,3,2
TUR,PRT,2023.0,2,2,0
AUS,ZWE,2018.0,3,2,1
DOM,ESP,2018.0,4,1,3
MYS,HKG,2022.0,7,4,3
TUR,ZAF,2022.0,2,1,1
TWN,AUS,2022.0,10,18,-8
HRV,BIH,2021.0,4,15,-11
EST,FRA,2018.0,5,4,1
CHN,SGP,2024.0,14,13,1
PSE,GBR,2021.0,11,9,2
QAT,AUS,2021.0,7,4,3
ZAF,BWA,2021.0,13,12,1
BEL,IRN,2021.0,11,44,-33
AUT,CZE,2012.0,8,11,-3
IRN,IND,2022.0,13,8,5
IRQ,IND,2021.0,9,13,-4
GIN,FRA,2017.0,8,8,0
IRN,ARE,2021.0,3,2,1
CZE,CAN,2020.0,12,12,0
GEO,CHE,2021.0,1,1,0
HUN,EGY,2017.0,2,3,-1
PAK,SWE,2017.0,7,14,-7
NOR,IND,2013.0,5,8,-3
GRC,PSE,2012.0,2,1,1
KEN,ETH,2015.0,2,4,-2
AUS,PRT,2020.0,8,10,-2
CZE,ITA,2023.0,13,14,-1
ESP,CHN,2015.0,29,33,-4
MYS,AFG,2020.0,8,1,7
ARM,IRN,2014.0,4,1,3
CAN,HKG,2001.0,19,25,-6
BEL,HKG,2013.0,1,2,-1
DEU,TWN,2010.0,12,16,-4
EGY,MYS,2015.0,6,7,-1
NZL,IND,2019.0,9,14,-5
ARE,NZL,2009.0,2,5,-3
IRQ,CAN,2023.0,2,5,-3
ESP,NZL,2020.0,8,5,3
TUR,CHN,2021.0,16,11,5
CHN,ZAF,2010.0,9,3,6
NLD,COL,2020.0,14,13,1
TUR,DZA,2019.0,1,1,0
KOR,GHA,2020.0,4,3,1
MEX,BOL,2008.0,4,2,2
BGR,GBR,2019.0,9,8,1
SLE,GBR,2021.0,6,5,1
CAN,MAR,2006.0,6,4,2
TZA,ZAF,2022.0,5,11,-6
ROU,NLD,2017.0,6,3,3
USA,FSM,2013.0,1,2,-1
CMR,ZAF,2013.0,8,4,4
PRT,LUX,2022.0,7,1,6
TWN,AUS,2016.0,21,16,5
ITA,TUN,2018.0,10,13,-3
FIN,ITA,2020.0,22,34,-12
AUS,SRB,2005.0,1,1,0
AUT,CAN,2000.0,6,10,-4
KAZ,PHL,2017.0,3,1,2
IRL,NZL,2013.0,6,3,3
GBR,COL,2001.0,14,6,8
EGY,CZE,2017.0,5,1,4
USA,BFA,2018.0,4,6,-2
CHE,GHA,2022.0,4,3,1
NOR,BLR,2019.0,1,3,-2
DNK,CZE,2018.0,3,3,0
KEN,NLD,2018.0,11,4,7
TZA,ZAF,2016.0,6,9,-3
ITA,PHL,2015.0,2,1,1
CAN,COL,2002.0,5,7,-2
COM,USA,2016.0,1,1,0
ZMB,ZAF,2020.0,10,14,-4
VNM,CAN,2018.0,2,5,-3
CRI,MEX,2007.0,3,1,2
IND,IRQ,2023.0,1,6,-5
ISR,IDN,2016.0,1,1,0
CMR,TCD,2020.0,3,2,1
JPN,BRA,2023.0,3,9,-6
TUR,CZE,2022.0,8,3,5
TWN,ETH,2023.0,7,6,1
BHR,KWT,2023.0,2,2,0
DEU,SGP,2007.0,18,9,9
ARE,LUX,2022.0,2,1,1
SRB,ALB,2019.0,12,6,6
MYS,NLD,2020.0,7,11,-4
HRV,SRB,2021.0,14,10,4
ARE,NLD,2019.0,5,8,-3
CYP,FRA,2022.0,7,3,4
RWA,IND,2018.0,2,3,-1
ZWE,IND,2017.0,1,1,0
USA,HND,2019.0,8,4,4
NLD,FIN,2020.0,24,25,-1
PRT,POL,2010.0,6,8,-2
NPL,CHN,2020.0,17,26,-9
CHL,ITA,2020.0,16,19,-3
BEL,DNK,2012.0,4,13,-9
ZAF,SYC,2021.0,4,1,3
MMR,JPN,2023.0,1,7,-6
BLR,FRA,2002.0,8,3,5
POL,CHE,2023.0,10,9,1
CZE,HRV,2022.0,2,4,-2
CHN,KEN,2018.0,12,13,-1
ECU,DEU,2012.0,5,2,3
NOR,PRT,2018.0,6,9,-3
CRI,FRA,2022.0,2,1,1
CHE,BGD,2019.0,2,3,-1
NZL,DEU,2021.0,33,25,8
JOR,PAK,2022.0,1,1,0
NOR,IDN,2016.0,3,2,1
PRT,BLR,2000.0,1,1,0
VEN,FRA,2021.0,3,1,2
ARG,CAN,2023.0,11,5,6
EGY,IRL,2020.0,5,2,3
NLD,SWZ,2021.0,3,1,2
ECU,BRA,2018.0,7,16,-9
MDG,CIV,2016.0,1,1,0
CAN,NOR,2023.0,14,12,2
POL,TUR,2013.0,1,2,-1
BEL,ECU,2018.0,6,8,-2
AUT,CHN,2001.0,6,3,3
SVK,SVN,2021.0,4,13,-9
IDN,AUT,2012.0,1,3,-2
BEL,KHM,2015.0,1,1,0
ECU,FRA,2021.0,8,7,1
FIN,KOR,2005.0,6,1,5
BRA,IND,2022.0,12,9,3
NLD,MYS,2020.0,11,7,4
CHN,MAC,2004.0,8,1,7
USA,CMR,2023.0,5,7,-2
SAU,QAT,2022.0,13,7,6
ZAF,SAU,2022.0,5,5,0
NGA,IND,2023.0,8,7,1
GNQ,USA,2021.0,1,1,0
HKG,CHE,2022.0,9,9,0
UGA,RWA,2023.0,6,3,3
KOR,PHL,2015.0,9,5,4
SRB,GRC,2013.0,3,6,-3
IRQ,DEU,2022.0,6,5,1
ITA,NZL,2021.0,12,3,9
BRA,CRI,2021.0,6,2,4
LTU,PAK,2023.0,3,2,1
ARG,NOR,2019.0,2,1,1
SAU,TWN,2022.0,1,4,-3
JPN,KEN,2022.0,10,3,7
ROU,FRA,2004.0,29,34,-5
CHE,EST,1999.0,2,1,1
DNK,HUN,2006.0,3,2,1
CAN,MAR,2000.0,4,4,0
DNK,IRL,2003.0,4,2,2
BLR,UKR,2006.0,3,2,1
ZAF,KEN,2010.0,9,15,-6
DNK,TZA,2009.0,2,1,1
AUS,ISR,2001.0,8,14,-6
LTU,USA,2007.0,9,11,-2
GBR,TTO,2010.0,2,5,-3
NGA,CAN,2016.0,10,4,6
ESP,PRY,2009.0,5,1,4
ESP,PHL,2004.0,5,4,1
KEN,UGA,2010.0,5,3,2
DEU,JOR,2012.0,13,8,5
JAM,TTO,2017.0,13,2,11
LKA,GBR,2001.0,10,4,6
LTU,POL,2003.0,7,6,1
ESP,QAT,2015.0,6,1,5
NPL,GBR,1998.0,2,1,1
MUS,USA,2005.0,1,1,0
BGR,ESP,2002.0,4,2,2
AUS,CRI,2013.0,2,1,1
SWE,LVA,2002.0,3,3,0
CHE,FIN,2009.0,3,20,-17
DEU,IRN,2004.0,13,8,5
NOR,ITA,2006.0,5,7,-2
PHL,THA,2015.0,3,3,0
MEX,CHE,2013.0,7,6,1
CHN,MAR,2018.0,5,21,-16
ESP,ARE,2004.0,1,1,0
DNK,IND,2006.0,3,6,-3
BGR,DEU,2009.0,20,29,-9
GRC,ESP,2015.0,21,17,4
BEL,TZA,2022.0,6,1,5
SWE,KEN,2005.0,2,2,0
USA,ISL,2002.0,27,12,15
VEN,MEX,2021.0,6,3,3
USA,ZWE,2013.0,8,13,-5
PAK,KOR,2001.0,1,1,0
SVN,GRC,2013.0,2,1,1
TUR,NLD,2008.0,20,5,15
ARM,USA,2005.0,8,6,2
USA,ARM,2022.0,8,11,-3
GAB,USA,2005.0,3,2,1
KEN,DEU,2000.0,10,1,9
BEN,DEU,2006.0,1,1,0
SRB,DEU,2012.0,11,13,-2
TUR,AUT,2010.0,3,2,1
USA,MKD,2005.0,5,3,2
DNK,EST,2012.0,2,1,1
UKR,CAN,2003.0,7,4,3
AUS,PHL,2014.0,9,14,-5
DEU,LVA,2005.0,4,6,-2
NOR,TUR,2016.0,4,6,-2
SWE,BRA,2003.0,8,9,-1
ZWE,GBR,2007.0,5,2,3
UGA,CHE,2008.0,1,2,-1
LKA,JPN,2005.0,4,4,0
CHN,KEN,2016.0,7,4,3
LTU,LVA,2023.0,3,2,1
GBR,GHA,2006.0,11,6,5
GHA,CAN,2003.0,3,5,-2
DEU,IDN,2002.0,6,1,5
UKR,AUT,2015.0,5,2,3
MOZ,AUS,2009.0,2,1,1
PRY,CHL,2016.0,2,2,0
ITA,SVK,2001.0,4,4,0
BIH,HRV,2021.0,15,4,11
SAU,ITA,2004.0,2,2,0
IND,PHL,2007.0,7,5,2
ESP,EGY,2008.0,8,2,6
OMN,TUN,2016.0,3,4,-1
UGA,AUS,2023.0,3,1,2
RUS,TUR,2023.0,9,1,8
SWE,ZAF,2003.0,8,5,3
HUN,POL,2006.0,3,2,1
FRA,GLP,2005.0,20,12,8
FRA,CIV,2004.0,25,15,10
AUT,UGA,2013.0,1,3,-2
SVK,ITA,2009.0,4,5,-1
BEL,SVN,2008.0,1,3,-2
TTO,USA,2014.0,6,6,0
USA,ETH,2010.0,12,10,2
MLI,USA,2001.0,5,6,-1
SEN,CHE,2023.0,2,1,1
ZWE,NLD,2003.0,1,1,0
CZE,SVN,2019.0,4,4,0
CHN,POL,2003.0,1,1,0
DEU,UGA,2003.0,4,1,3
LTU,ITA,2005.0,3,4,-1
ZWE,ZAF,1999.0,3,1,2
IRL,ISR,2008.0,2,8,-6
DEU,BEN,2000.0,1,2,-1
YEM,GBR,2011.0,1,2,-1
DEU,BGR,2010.0,17,23,-6
RUS,HKG,2002.0,4,4,0
BLR,CHE,2000.0,1,2,-1
GBR,ARG,2005.0,9,10,-1
IRL,CZE,2007.0,1,5,-4
DNK,ISL,2013.0,6,9,-3
MLT,CAN,2006.0,1,1,0
CHL,ARG,2001.0,8,7,1
NLD,SRB,1998.0,2,1,1
USA,MDG,2000.0,1,1,0
USA,BGR,2000.0,10,36,-26
CAN,MWI,2011.0,1,1,0
SVN,SVK,2014.0,13,10,3
NOR,GRC,2014.0,2,9,-7
FRA,CMR,2005.0,19,9,10
BGR,FRA,2017.0,5,7,-2
BGR,NLD,2009.0,3,1,2
CAN,LBN,2015.0,16,12,4
USA,AFG,2013.0,2,8,-6
CHE,RUS,2008.0,18,26,-8
FRA,THA,2008.0,14,11,3
ISL,USA,2013.0,14,9,5
HUN,BGR,2003.0,2,1,1
FRA,SRB,2012.0,5,8,-3
GRC,CYP,2003.0,6,4,2
USA,HTI,2008.0,1,3,-2
CHN,MAR,2017.0,2,6,-4
TWN,FRA,2012.0,16,17,-1
FIN,JPN,2014.0,11,6,5
FIN,CHL,2021.0,2,4,-2
ITA,PRT,2005.0,8,3,5
ARG,FRA,1999.0,7,17,-10
DNK,SVN,2008.0,3,1,2
DNK,FIN,2023.0,14,9,5
CHL,PER,2013.0,7,3,4
BRA,AUS,2008.0,25,5,20
SYR,FRA,2008.0,5,4,1
SWE,THA,2010.0,5,7,-2
KOR,UZB,2009.0,2,2,0
USA,BGR,2006.0,13,14,-1
AUS,SVN,2021.0,3,3,0
KEN,DEU,2010.0,5,9,-4
MEX,CUB,2005.0,10,11,-1
EGY,HUN,2011.0,2,1,1
CHL,URY,2011.0,2,1,1
DNK,IND,2010.0,6,11,-5
JPN,NLD,2008.0,24,15,9
ITA,HRV,2013.0,4,5,-1
CZE,ESP,2010.0,9,7,2
ESP,PRY,2011.0,5,1,4
NAM,USA,2021.0,8,6,2
DEU,ARE,2016.0,11,5,6
CAN,PRI,2022.0,1,1,0
CHL,CAN,2001.0,10,9,1
FIN,IRN,2010.0,4,5,-1
ESP,AUS,2006.0,14,11,3
CHE,PER,2010.0,1,3,-2
ZAF,COL,2011.0,2,2,0
SGP,AUS,1998.0,13,30,-17
SGP,SWE,2010.0,2,9,-7
SWE,SGP,2012.0,12,12,0
FIN,SAU,2015.0,4,1,3
AUT,SRB,2019.0,4,9,-5
VEN,COL,2008.0,7,5,2
IRQ,GBR,2006.0,1,1,0
IND,IRL,2012.0,18,12,6
DZA,SAU,2020.0,9,8,1
AUS,ISR,2014.0,15,21,-6
NGA,SLE,2011.0,2,1,1
UKR,LTU,2015.0,2,1,1
EGY,ITA,2006.0,3,3,0
BEL,ISR,2013.0,5,1,4
URY,ARG,2010.0,4,2,2
NPL,DNK,2017.0,3,3,0
BEL,TWN,2017.0,4,1,3
COL,FRA,2000.0,5,7,-2
AUT,SGP,2008.0,6,1,5
AUS,CZE,2011.0,2,3,-1
LKA,USA,2007.0,12,8,4
KEN,AUS,2014.0,10,5,5
NLD,UGA,2009.0,2,1,1
NPL,JPN,2008.0,5,8,-3
KOR,ZAF,2012.0,8,4,4
ZAF,NLD,1998.0,4,6,-2
NGA,USA,2010.0,30,29,1
IRN,BEL,2007.0,3,2,1
AUS,ECU,2005.0,1,2,-1
SRB,NOR,2006.0,4,1,3
ARG,ISR,2007.0,2,1,1
JPN,PHL,2009.0,20,17,3
CHN,CHE,2000.0,13,3,10
JPN,ROU,2022.0,1,1,0
AUT,DNK,2010.0,11,3,8
TWN,THA,2002.0,1,1,0
ARE,USA,2006.0,7,30,-23
ECU,USA,2007.0,14,14,0
BGR,CHE,2005.0,4,3,1
IDN,MYS,2007.0,6,8,-2
SWE,MYS,2012.0,6,4,2
CMR,GBR,2020.0,4,6,-2
BRA,PRI,2014.0,2,4,-2
THA,SGP,2014.0,4,7,-3
IRN,NZL,2012.0,8,1,7
UKR,FRA,2012.0,17,10,7
QAT,IND,2021.0,8,12,-4
NGA,CHN,2012.0,6,6,0
ISR,IND,2010.0,13,25,-12
ITA,NPL,2010.0,1,1,0
KHM,DEU,2013.0,1,1,0
QAT,SGP,2018.0,4,2,2
BMU,USA,2011.0,4,4,0
AUS,PNG,2010.0,6,6,0
YEM,MYS,2018.0,5,20,-15
BEL,SVK,2020.0,3,5,-2
GHA,SWE,2010.0,2,1,1
BGD,CHE,2019.0,3,2,1
DZA,ITA,2013.0,5,4,1
AUS,SLB,2016.0,3,1,2
UKR,NLD,2011.0,4,1,3
HRV,CHE,2010.0,2,6,-4
ZAF,CIV,2016.0,3,11,-8
HRV,CAN,2013.0,2,3,-1
LBN,SAU,2018.0,1,3,-2
IRL,SGP,2012.0,7,6,1
IRL,IND,2019.0,14,41,-27
URY,ITA,2020.0,2,1,1
ROU,HUN,2010.0,5,18,-13
MYS,BRA,2016.0,2,3,-1
HKG,LKA,2011.0,3,3,0
UGA,AUT,2013.0,3,1,2
RWA,UGA,2014.0,1,2,-1
ROU,CAN,2014.0,5,3,2
NOR,ITA,2010.0,7,25,-18
SWE,BRA,2013.0,5,9,-4
HUN,FRA,2012.0,14,17,-3
FIN,AUS,2016.0,20,9,11
IRQ,IND,2019.0,4,20,-16
SAU,OMN,2020.0,4,6,-2
USA,CUB,2010.0,15,7,8
CAN,SWE,2007.0,17,42,-25
NIC,USA,2013.0,3,6,-3
MDG,SEN,2014.0,1,2,-1
SMR,ITA,2015.0,4,5,-1
DNK,BGD,2018.0,1,2,-1
TUN,BHR,2019.0,1,2,-1
IND,GRC,2012.0,2,2,0
JAM,IND,2014.0,1,1,0
QAT,USA,2007.0,2,12,-10
ESP,ISR,2012.0,4,2,2
SDN,SAU,2011.0,5,12,-7
TUN,JPN,2011.0,1,1,0
DEU,CUB,2017.0,3,2,1
CAN,URY,2023.0,1,2,-1
FIN,KWT,2000.0,1,1,0
NOR,VNM,2011.0,4,1,3
SRB,CAN,2010.0,3,3,0
DNK,SAU,2015.0,3,2,1
HKG,BEL,2011.0,2,1,1
COL,AUT,2013.0,2,1,1
ARE,NLD,2011.0,3,2,1
BEL,BEN,2013.0,1,3,-2
EGY,DZA,2011.0,2,2,0
CHE,PAK,2018.0,4,5,-1
AUS,QAT,2016.0,16,3,13
NOR,ZMB,2018.0,2,1,1
PRY,ESP,2008.0,2,2,0
KOR,IRN,2014.0,4,12,-8
AUS,MEX,2007.0,4,5,-1
FRA,NGA,2018.0,4,2,2
MYS,JOR,2010.0,11,2,9
NCL,FRA,2012.0,15,29,-14
VEN,MEX,2011.0,9,3,6
TZA,THA,2011.0,1,1,0
MEX,IND,2014.0,6,15,-9
BEL,SGP,2016.0,7,6,1
PRT,BEL,2013.0,7,7,0
ESP,BGR,2012.0,2,3,-1
USA,HTI,2014.0,20,4,16
DEU,SRB,2023.0,7,12,-5
SVK,AUS,2022.0,1,1,0
ITA,CMR,2015.0,6,4,2
FIN,TUR,2015.0,3,5,-2
KWT,ARE,2015.0,4,1,3
IRL,CAN,2011.0,28,37,-9
TUR,GBR,2024.0,2,3,-1
LAO,FRA,2012.0,3,1,2
HKG,IDN,2017.0,1,1,0
CHE,COL,2020.0,3,13,-10
NOR,ISL,2015.0,5,4,1
LVA,DEU,2013.0,5,3,2
SGP,JPN,1998.0,2,6,-4
PAK,JPN,2002.0,9,4,5
DEU,LTU,2013.0,10,5,5
TTO,GBR,2010.0,5,2,3
PER,GBR,2021.0,13,6,7
CAN,KOR,2004.0,23,29,-6
CAN,BGD,2011.0,4,19,-15
NLD,HUN,2018.0,9,17,-8
GBR,LBN,2018.0,14,7,7
EGY,CZE,2022.0,1,1,0
KOR,BRA,2016.0,5,2,3
TWN,KOR,1999.0,4,3,1
TWN,DEU,1998.0,5,4,1
MWI,ZMB,2017.0,3,1,2
FRA,KHM,2020.0,11,7,4
HKG,TUR,2004.0,1,1,0
KOR,ESP,2021.0,11,7,4
ESP,SAU,2018.0,8,4,4
HKG,AUT,2022.0,3,4,-1
ZAF,SSD,2019.0,1,1,0
IRN,AUT,2018.0,16,13,3
NPL,THA,2015.0,4,8,-4
CHN,THA,2012.0,8,6,2
AUT,IND,2004.0,3,4,-1
HRV,NLD,2016.0,1,6,-5
HUN,CHN,2016.0,4,2,2
USA,RWA,2009.0,7,4,3
KWT,EGY,2014.0,17,21,-4
SVK,IND,2020.0,3,7,-4
GRC,BEL,2015.0,21,9,12
AUT,ISR,2021.0,7,13,-6
FIN,NZL,2015.0,6,1,5
GHA,CHN,2011.0,2,1,1
SVN,SWE,2017.0,4,2,2
PHL,USA,2017.0,34,48,-14
ROU,USA,2022.0,15,20,-5
KEN,ZAF,2013.0,15,19,-4
RUS,IND,2014.0,2,3,-1
MYS,THA,2002.0,4,2,2
HKG,MAC,2020.0,21,12,9
IND,NER,2019.0,1,2,-1
BRA,URY,2013.0,8,6,2
GRC,ITA,2023.0,15,16,-1
DNK,KOR,2023.0,3,8,-5
UKR,IND,2019.0,2,3,-1
SDN,DEU,2019.0,1,5,-4
RUS,PAK,2019.0,2,2,0
FRA,AFG,2017.0,4,2,2
BGR,IND,2016.0,2,1,1
TUR,ISR,2003.0,4,6,-2
BGD,SAU,2012.0,8,2,6
ZWE,GBR,2020.0,10,8,2
JPN,MMR,2020.0,12,6,6
PRT,PAK,2021.0,2,3,-1
ITA,JOR,2018.0,9,4,5
MEX,SAU,2017.0,3,2,1
LBY,MYS,2016.0,3,9,-6
MEX,IND,2015.0,7,12,-5
KGZ,TUR,2020.0,4,4,0
CHE,NGA,2012.0,2,1,1
ITA,HUN,2018.0,14,8,6
KAZ,AUS,2016.0,2,3,-1
HUN,IRL,2018.0,5,2,3
IRL,HUN,2019.0,2,3,-1
IND,USA,2024.0,8,10,-2
ECU,ITA,2023.0,1,3,-2
IRL,ZAF,2019.0,2,6,-4
POL,GRC,2020.0,1,3,-2
CHN,BRN,2014.0,1,1,0
BRN,AUS,2017.0,2,2,0
THA,NLD,2019.0,5,12,-7
SWE,HRV,2021.0,3,4,-1
UKR,SWE,2016.0,9,6,3
BRA,NGA,2018.0,6,5,1
IRN,IND,2016.0,12,26,-14
KAZ,IND,2021.0,1,2,-1
CAN,THA,2023.0,7,8,-1
IRQ,MYS,2014.0,16,44,-28
ARE,DEU,2015.0,4,7,-3
TUN,JPN,2019.0,2,1,1
SAU,SDN,2016.0,13,26,-13
FRA,CHN,2024.0,7,5,2
GRC,CZE,2016.0,3,1,2
DNK,CHL,2021.0,5,2,3
IDN,BRN,2023.0,4,2,2
MYS,JPN,2023.0,9,14,-5
ITA,ETH,2019.0,5,8,-3
LBY,IND,2021.0,2,1,1
EGY,POL,2014.0,1,4,-3
POL,KAZ,2021.0,4,1,3
CAN,BGD,2009.0,8,10,-2
ECU,CUB,2020.0,8,18,-10
POL,MEX,2022.0,1,9,-8
KWT,OMN,2022.0,1,1,0
GHA,ZAF,2019.0,17,15,2
ARE,HUN,2003.0,1,2,-1
RUS,PAK,2021.0,2,3,-1
VNM,CAN,2017.0,4,5,-1
GRC,MLT,2021.0,3,2,1
TUR,AUS,2021.0,20,10,10
ZAF,MUS,2021.0,4,1,3
EGY,IRQ,2020.0,12,7,5
URY,CAN,2016.0,4,4,0
RUS,AUS,2020.0,14,12,2
IRN,OMN,2023.0,8,3,5
ECU,PRT,2020.0,1,1,0
AUS,LUX,2020.0,5,4,1
NZL,NLD,2019.0,11,19,-8
GBR,BHR,2019.0,7,4,3
UGA,NOR,2012.0,3,6,-3
NLD,GHA,2023.0,4,2,2
SWE,RWA,2021.0,7,4,3
THA,CHN,2013.0,9,8,1
BEL,SGP,2022.0,2,6,-4
CYP,NGA,2021.0,7,2,5
MDG,DEU,2019.0,1,4,-3
ESP,POL,2008.0,5,13,-8
AUS,ARE,2006.0,6,4,2
IND,BRN,2020.0,2,1,1
IRN,SGP,2022.0,6,7,-1
USA,URY,2020.0,19,15,4
ESP,IRN,2023.0,7,29,-22
YEM,MAR,2020.0,2,3,-1
SVN,SRB,2020.0,4,9,-5
GHA,TZA,2022.0,2,1,1
GBR,CUB,2009.0,2,3,-1
USA,BLR,2021.0,2,4,-2
GTM,COL,2016.0,1,0,1
CHE,LIE,2011.0,2,0,2
ZAF,MAC,2007.0,1,0,1
BLZ,,2014.0,1,0,1
,TTO,2007.0,68,0,68
,ARM,2008.0,154,0,154
,LTU,2009.0,625,0,625
AUS,TZA,2011.0,2,0,2
GRD,CAN,2019.0,1,0,1
KHM,,2020.0,81,0,81
,BHR,2008.0,33,0,33
,NER,2009.0,20,0,20
,ETH,2005.0,160,0,160
,ECU,2008.0,112,0,112
,GNB,2008.0,6,0,6
,BRN,2008.0,20,0,20
TWN,TUR,2014.0,2,0,2
MEX,TWN,2007.0,1,0,1
CHE,CYP,2017.0,4,0,4
QAT,,2013.0,44,0,44
LTU,ESP,2010.0,1,0,1
DEU,BEN,2013.0,1,0,1
NLD,MLI,2018.0,2,0,2
OMN,TUR,2015.0,1,0,1
MYS,MDV,2020.0,2,0,2
ITA,SOM,2019.0,2,0,2
,CMR,2007.0,228,0,228
KOR,QAT,2010.0,3,0,3
,BFA,2008.0,96,0,96
NPL,ITA,2015.0,2,0,2
,PRY,2008.0,22,0,22
LUX,,2017.0,99,0,99
MHL,,2017.0,2,0,2
,SYR,2006.0,68,0,68
DNK,MLT,2014.0,2,0,2
ECU,IND,2020.0,2,0,2
VEN,GBR,2017.0,2,0,2
VNM,PAK,2023.0,1,0,1
BOL,,2013.0,36,0,36
NLD,UGA,2015.0,6,0,6
,SYR,2010.0,115,0,115
,BTN,2014.0,43,0,43
CIV,CHN,2009.0,2,0,2
JAM,BHS,2013.0,2,0,2
,SWZ,2013.0,18,0,18
GBR,PRT,2024.0,2,0,2
MAC,RUS,2015.0,5,0,5
CMR,,2015.0,98,0,98
GIN,GNQ,2020.0,5,0,5
DEU,AZE,2008.0,2,0,2
ARG,PHL,2012.0,1,0,1
USA,NCL,2021.0,2,0,2
,MMR,2009.0,29,0,29
ITA,ALB,2011.0,5,0,5
BGR,TWN,2016.0,1,0,1
LBY,IND,2015.0,3,0,3
JPN,LUX,2023.0,1,0,1
,GIN,2008.0,11,0,11
,PAN,2007.0,42,0,42
UGA,,2016.0,123,0,123
TWN,ARE,2019.0,4,0,4
LBR,,2020.0,27,0,27
,CUB,2005.0,689,0,689
,ZWE,2007.0,64,0,64
,PSE,2010.0,70,0,70
TUN,BHR,2015.0,2,0,2
ISL,BEL,2017.0,3,0,3
,RWA,2011.0,109,0,109
GRL,,2020.0,12,0,12
PRK,KOR,2014.0,2,0,2
FLK,,2016.0,2,0,2
,MAC,2011.0,131,0,131
BEL,SAU,2012.0,4,0,4
YEM,CAN,2019.0,1,0,1
SYR,,2022.0,126,0,126
DZA,CZE,2019.0,1,0,1
,HTI,2011.0,38,0,38
GTM,DNK,2009.0,1,0,1
,MMR,2011.0,33,0,33
IND,BRN,2017.0,3,0,3
GMB,GAB,2017.0,2,0,2
GMB,SEN,2014.0,1,0,1
GBR,PRK,2001.0,1,0,1
MAC,PHL,2017.0,1,0,1
TUV,,2018.0,1,0,1
BEL,KOR,2005.0,3,0,3
UKR,UZB,2015.0,1,0,1
DOM,VEN,2022.0,2,0,2
BGD,,2001.0,47,0,47
,NER,2011.0,16,0,16
COL,NGA,2011.0,1,0,1
IRN,KAZ,2021.0,5,0,5
AGO,,2022.0,30,0,30
SMR,,2023.0,10,0,10
NOR,ISR,2022.0,3,0,3
BHR,ARE,2014.0,4,0,4
TUN,QAT,2016.0,3,0,3
CAN,GMB,2023.0,1,0,1
LTU,HUN,2022.0,1,0,1
DEU,BHR,2012.0,2,0,2
LBN,QAT,2023.0,10,0,10
,CYP,2007.0,178,0,178
IRL,SAU,2014.0,6,0,6
,CAF,2014.0,15,0,15
VEN,NLD,2015.0,2,0,2
CAF,,2020.0,16,0,16
CMR,AUT,2016.0,2,0,2
RUS,TJK,2022.0,3,0,3
CZE,CYP,2022.0,1,0,1
CUB,GBR,2022.0,2,0,2
CAN,FJI,2022.0,1,0,1
ETH,SWZ,2015.0,1,0,1
DZA,KOR,2018.0,1,0,1
CYM,DEU,2021.0,1,0,1
CMR,SEN,2023.0,1,0,1
JPN,GEO,2006.0,1,0,1
MDA,,2022.0,92,0,92
FIN,TWN,2021.0,2,0,2
BWA,LSO,2020.0,1,0,1
CPV,,2022.0,12,0,12
SGP,NOR,2022.0,7,0,7
ZMB,CAN,2019.0,2,0,2
JPN,NIC,2019.0,2,0,2
IND,DZA,2018.0,1,0,1
,SEN,2010.0,129,0,129
GRD,,2022.0,35,0,35
BEN,BFA,2020.0,1,0,1
GBR,BOL,2019.0,3,0,3
BFA,GBR,2018.0,1,0,1
CHL,GTM,2019.0,1,0,1
COL,DOM,2020.0,1,0,1
PER,UGA,2022.0,1,0,1
MKD,CAN,2018.0,2,0,2
IND,CHL,2002.0,2,0,2
HKG,RUS,2008.0,4,0,4
BGR,MEX,2005.0,1,0,1
AUS,ZMB,2013.0,1,0,1
NLD,TGO,1999.0,1,0,1
RWA,,2010.0,5,0,5
MKD,,2005.0,14,0,14
AZE,,2005.0,23,0,23
,BRN,1996.0,7,0,7
,BFA,1996.0,67,0,67
CAN,CYP,2007.0,1,0,1
KEN,THA,2008.0,3,0,3
SRB,ISR,2008.0,2,0,2
LKA,,2006.0,30,0,30
KOR,ESP,2001.0,4,0,4
TUN,,2002.0,58,0,58
DNK,ARM,2012.0,1,0,1
ETH,MYS,1998.0,1,0,1
,BFA,2004.0,83,0,83
PER,,2002.0,26,0,26
ESP,JAM,2005.0,1,0,1
JAM,NGA,2010.0,1,0,1
COD,,2017.0,10,0,10
AUS,SEN,1998.0,1,0,1
AZE,DEU,2010.0,2,0,2
VEN,ZAF,2016.0,1,0,1
RUS,CYP,2006.0,1,0,1
AUT,BGD,2012.0,1,0,1
CHN,JOR,2014.0,1,0,1
PAK,OMN,2009.0,2,0,2
SGP,KWT,1999.0,2,0,2
RUS,SGP,2009.0,3,0,3
ZMB,UGA,2002.0,2,0,2
MDG,CAN,2008.0,1,0,1
FLK,GBR,2007.0,2,0,2
IDN,SGP,2006.0,2,0,2
DEU,RWA,2000.0,1,0,1
,CMR,1999.0,89,0,89
ISL,,2006.0,40,0,40
JPN,JOR,2003.0,1,0,1
,CAF,1996.0,6,0,6
MYS,NOR,2012.0,3,0,3
MDA,TUR,1997.0,1,0,1
JPN,MCO,1997.0,1,0,1
ZWE,FRA,2007.0,3,0,3
DNK,MYS,2005.0,1,0,1
MMR,,2001.0,4,0,4
BGR,CAN,2000.0,4,0,4
SRB,BGR,2007.0,8,0,8
,GUM,1999.0,9,0,9
JAM,ZAF,2010.0,2,0,2
ROU,DEU,2024.0,2,0,2
NLD,ISL,2002.0,1,0,1
EST,ESP,1999.0,1,0,1
PER,,2005.0,37,0,37
DNK,GHA,2003.0,1,0,1
NOR,PRT,2007.0,2,0,2
PSE,QAT,2015.0,2,0,2
NLD,SEN,2000.0,1,0,1
ROU,IND,2021.0,5,0,5
,MDA,1997.0,61,0,61
ISL,VNM,2011.0,3,0,3
UKR,SVN,2023.0,2,0,2
,PRY,1996.0,13,0,13
PRY,GBR,2008.0,1,0,1
DNK,GMB,2003.0,1,0,1
USA,ZMB,1997.0,2,0,2
PRT,ARG,2006.0,2,0,2
IDN,KEN,2023.0,2,0,2
ESP,MAR,1998.0,4,0,4
TUN,MLI,1997.0,1,0,1
MYS,FRA,1997.0,3,0,3
JAM,,2003.0,17,0,17
,AFG,2000.0,2,0,2
,CYP,1999.0,33,0,33
TWN,DZA,2023.0,1,0,1
SWE,SEN,2009.0,1,0,1
,MLT,1995.0,39,0,39
MLT,,2000.0,2,0,2
MNG,,2002.0,4,0,4
SWZ,,2000.0,1,0,1
BGR,UZB,2013.0,1,0,1
,GIN,2015.0,42,0,42
CMR,NGA,2010.0,2,0,2
,AGO,2006.0,8,0,8
NGA,TTO,2020.0,1,0,1
,BTN,2004.0,16,0,16
GHA,LBR,2019.0,2,0,2
NOR,BTN,2021.0,1,0,1
SGP,ZAF,2018.0,4,0,4
OMN,KOR,2021.0,5,0,5
PRT,MOZ,2023.0,3,0,3
,TTO,1998.0,49,0,49
,PLW,2015.0,6,0,6
SEN,CHN,2018.0,4,0,4
VUT,,2020.0,4,0,4
SEN,CMR,2020.0,1,0,1
BTN,SAU,2019.0,1,0,1
FRA,RWA,2020.0,1,0,1
MDG,THA,2020.0,2,0,2
CYP,,2004.0,7,0,7
SLE,ITA,2018.0,1,0,1
,AND,2016.0,2,0,2
LTU,AUT,2018.0,2,0,2
MYS,UGA,2021.0,3,0,3
CAN,GTM,2019.0,1,0,1
,CAF,2015.0,9,0,9
FLK,,2022.0,3,0,3
VUT,PHL,2020.0,1,0,1
,PRI,2019.0,138,0,138
IRN,HUN,2019.0,7,0,7
NLD,CUW,2018.0,3,0,3
POL,VNM,2022.0,5,0,5
KWT,LVA,2021.0,1,0,1
IND,MDV,2019.0,1,0,1
,FJI,2020.0,28,0,28
,PNG,1995.0,35,0,35
GIN,FRA,1998.0,2,0,2
,KGZ,2009.0,28,0,28
,KGZ,2011.0,28,0,28
GRL,,2007.0,2,0,2
TTO,,2003.0,18,0,18
YEM,SWE,2022.0,1,0,1
TUN,,2005.0,96,0,96
,MTQ,1998.0,6,0,6
BEL,BGD,2003.0,4,0,4
,MDA,2005.0,38,0,38
BGD,THA,1998.0,2,0,2
GBR,FLK,2005.0,2,0,2
,MRT,2002.0,3,0,3
PER,CRI,2019.0,2,0,2
,CIV,2009.0,141,0,141
IND,LTU,2015.0,2,0,2
,MNG,2012.0,91,0,91
PAK,EST,2021.0,4,0,4
MYS,ARM,2007.0,1,0,1
GLP,,2003.0,1,0,1
ISR,BGD,2022.0,1,0,1
SWE,GEO,2008.0,1,0,1
IRN,,2000.0,29,0,29
GBR,BFA,2006.0,3,0,3
RUS,MMR,2017.0,1,0,1
,LBR,2020.0,17,0,17
AGO,,2016.0,12,0,12
,MLI,2005.0,56,0,56
ARM,ESP,2018.0,1,0,1
,GTM,2017.0,66,0,66
SMR,,2024.0,21,0,21
NZL,JOR,2021.0,3,0,3
COD,KEN,2021.0,2,0,2
URY,,2010.0,58,0,58
SOM,IND,2015.0,1,0,1
,GMB,1999.0,10,0,10
,KHM,2006.0,46,0,46
,PRY,2004.0,24,0,24
GMB,KOR,2003.0,1,0,1
PAN,GBR,2005.0,1,0,1
,PYF,2006.0,13,0,13
NCL,,2006.0,5,0,5
ARE,SRB,2006.0,1,0,1
SRB,ARE,2007.0,2,0,2
DEU,LKA,2000.0,2,0,2
LKA,CHN,2015.0,2,0,2
,NER,1994.0,29,0,29
SVK,DNK,2009.0,2,0,2
SRB,KOR,2013.0,1,0,1
EST,,2006.0,55,0,55
SWE,KWT,2009.0,1,0,1
BGD,CHE,2004.0,1,0,1
PRI,,1999.0,13,0,13
ETH,,2001.0,22,0,22
NOR,CHN,1999.0,2,0,2
CUB,COL,1997.0,3,0,3
BEN,,2006.0,8,0,8
ZWE,CHE,2009.0,2,0,2
DNK,BLR,2000.0,1,0,1
PRI,CHN,2003.0,3,0,3
BLR,TWN,2008.0,1,0,1
BEL,IRN,2001.0,2,0,2
,GIN,2001.0,7,0,7
BFA,,2014.0,39,0,39
TJK,,2003.0,10,0,10
IDN,,2006.0,47,0,47
HTI,ZAF,2001.0,2,0,2
SYR,MAR,2014.0,10,0,10
SLV,SVK,2000.0,1,0,1
MRT,GBR,2020.0,1,0,1
SAU,SYR,2008.0,1,0,1
,FLK,1997.0,2,0,2
KOR,IRL,2002.0,1,0,1
CHE,PER,2003.0,2,0,2
GTM,,2007.0,11,0,11
ZAF,SLE,2004.0,1,0,1
ISR,JOR,2002.0,2,0,2
GBR,MSR,1997.0,2,0,2
MKD,HUN,1998.0,1,0,1
IRL,ETH,2011.0,1,0,1
BRB,,2009.0,9,0,9
YEM,QAT,2006.0,1,0,1
GRC,KAZ,2016.0,3,0,3
NER,DEU,2005.0,2,0,2
JOR,BHR,2001.0,2,0,2
SRB,PRT,2011.0,2,0,2
SDN,KWT,2005.0,1,0,1
FRA,UZB,2000.0,1,0,1
KNA,JPN,2016.0,1,0,1
JPN,KNA,2017.0,2,0,2
TGO,,2013.0,13,0,13
JPN,BGR,2016.0,3,0,3
TCD,ITA,2017.0,1,0,1
BRA,SVK,2012.0,1,0,1
CAN,IDN,2013.0,6,0,6
JPN,SRB,2008.0,1,0,1
PAN,,2013.0,21,0,21
MDG,,2017.0,39,0,39
ETH,MMR,2020.0,1,0,1
,GUM,2007.0,4,0,4
ZWE,CHN,2020.0,3,0,3
KEN,BEN,2022.0,1,0,1
,LSO,2007.0,13,0,13
TUR,TUN,2017.0,13,0,13
KOR,AZE,2014.0,2,0,2
ZAF,JOR,2017.0,3,0,3
MDG,,2018.0,49,0,49
BGD,AUT,2006.0,1,0,1
,PRK,2008.0,5,0,5
,MOZ,2007.0,43,0,43
KGZ,GBR,1998.0,1,0,1
,BRB,2007.0,16,0,16
MAC,,2014.0,33,0,33
,GMB,2007.0,19,0,19
ISR,FIN,2015.0,2,0,2
,DOM,2006.0,14,0,14
TWN,GTM,2019.0,1,0,1
SLV,,2013.0,13,0,13
LBN,POL,2023.0,2,0,2
MLI,HTI,2015.0,1,0,1
TUR,EST,2018.0,2,0,2
DNK,MEX,1998.0,1,0,1
SVK,IND,2016.0,2,0,2
SLV,IRL,2019.0,1,0,1
SLV,GBR,2018.0,1,0,1
BRN,ITA,2018.0,1,0,1
CMR,GBR,2018.0,5,0,5
JPN,ECU,2003.0,1,0,1
EGY,BDI,2019.0,1,0,1
EGY,DZA,2008.0,5,0,5
ITA,MNE,2019.0,2,0,2
VEN,DNK,2022.0,1,0,1
MUS,NZL,2020.0,1,0,1
DNK,ZWE,2017.0,1,0,1
DNK,RWA,2019.0,1,0,1
ISL,,2000.0,14,0,14
GRC,UZB,2016.0,1,0,1
,GUY,2013.0,5,0,5
,RWA,2009.0,68,0,68
ITA,MWI,2022.0,1,0,1
ZAF,LBR,2016.0,3,0,3
UKR,BGD,2017.0,1,0,1
IRQ,MWI,2019.0,4,0,4
SWE,SEN,2021.0,1,0,1
SSD,,2020.0,5,0,5
,MCO,2013.0,7,0,7
AFG,LBR,2021.0,1,0,1
CAF,BEN,2015.0,1,0,1
MAR,NER,2021.0,6,0,6
VNM,MAC,2017.0,1,0,1
ARE,MAR,2022.0,2,0,2
,BWA,2005.0,54,0,54
CHE,SEN,2018.0,1,0,1
,TGO,2013.0,47,0,47
ARM,SAU,2020.0,1,0,1
LBY,POL,2021.0,1,0,1
KEN,CMR,2022.0,2,0,2
UZB,ISR,2023.0,1,0,1
CIV,CRI,2017.0,3,0,3
LTU,NOR,2019.0,1,0,1
GEO,,2011.0,76,0,76
NPL,ARE,2022.0,2,0,2
KOR,BRA,2007.0,1,0,1
HRV,ITA,2023.0,3,0,3
MCO,EGY,2020.0,1,0,1
BTN,IND,2012.0,2,0,2
EGY,UZB,2022.0,2,0,2
COD,AUS,2021.0,1,0,1
IRL,SVN,2023.0,1,0,1
BMU,,2022.0,7,0,7
LBY,IDN,2018.0,1,0,1
SWZ,,2024.0,73,0,73
IND,MNG,2021.0,1,0,1
RWA,DNK,2023.0,1,0,1
ITA,NAM,2023.0,1,0,1
FIN,VNM,2023.0,1,0,1
,CPV,2019.0,8,0,8
KWT,SGP,2014.0,1,0,1
ETH,CHL,2022.0,1,0,1
IND,IOT,2008.0,1,0,1
ZAF,CHL,2021.0,4,0,4
GTM,NLD,2020.0,1,0,1
DMA,,2025.0,6,0,6
MYS,PSE,2023.0,2,0,2
MMR,TWN,2023.0,2,0,2
ARG,RUS,1999.0,1,0,1
PRT,UKR,2001.0,1,0,1
NOR,BIH,2008.0,1,0,1
,GMB,1998.0,10,0,10
MLT,CHE,1998.0,1,0,1
IND,NAM,2016.0,2,0,2
FIN,KAZ,2018.0,1,0,1
BFA,,2004.0,11,0,11
KAZ,GBR,2005.0,1,0,1
NLD,NPL,2019.0,5,0,5
SWE,LIE,2000.0,1,0,1
ARG,HUN,2012.0,1,0,1
,PRY,2001.0,9,0,9
,FJI,1999.0,18,0,18
FJI,GBR,2004.0,1,0,1
HUN,EGY,1999.0,5,0,5
FIN,ISR,2001.0,2,0,2
LKA,NOR,2000.0,1,0,1
MLI,GHA,2022.0,1,0,1
BRN,BRA,2015.0,1,0,1
USA,SLV,2002.0,3,0,3
,REU,1995.0,3,0,3
NLD,CHL,1998.0,2,0,2
UKR,NLD,2014.0,4,0,4
CAN,PRI,1998.0,1,0,1
MEX,POL,2001.0,2,0,2
NZL,TUR,2002.0,2,0,2
JPN,NOR,1999.0,1,0,1
GUF,,2005.0,4,0,4
SWE,NGA,2000.0,1,0,1
RUS,CHL,2000.0,1,0,1
NOR,CHL,2012.0,1,0,1
SRB,NLD,2007.0,6,0,6
ATA,ITA,2010.0,3,0,3
CPV,,2017.0,12,0,12
AUS,TTO,2015.0,2,0,2
GTM,CHL,2017.0,3,0,3
,BWA,2007.0,57,0,57
,ZWE,2005.0,96,0,96
CAN,GRD,2018.0,3,0,3
NER,,2015.0,15,0,15
LUX,SVK,2011.0,1,0,1
PNG,,2016.0,27,0,27
SDN,EGY,2008.0,1,0,1
VNM,SRB,2021.0,4,0,4
DEU,LIE,2012.0,5,0,5
BLR,FRA,2017.0,4,0,4
,BOL,2008.0,57,0,57
CAN,SVN,2009.0,3,0,3
,KWT,2008.0,166,0,166
LBN,,2016.0,124,0,124
,TGO,2008.0,32,0,32
,ARE,2006.0,181,0,181
LBY,,2019.0,53,0,53
AFG,LKA,2018.0,1,0,1
,ALB,2008.0,104,0,104
BRB,GHA,2008.0,1,0,1
ZWE,,2018.0,65,0,65
ALB,,2014.0,32,0,32
ZWE,,2016.0,74,0,74
COG,,2013.0,32,0,32
BRA,AGO,2019.0,3,0,3
,MNE,2008.0,49,0,49
FIN,OMN,2016.0,2,0,2
LAO,,2012.0,13,0,13
PRT,MOZ,2011.0,3,0,3
LUX,PYF,2020.0,1,0,1
,GUY,2008.0,10,0,10
,MAC,2010.0,70,0,70
SVN,CHL,2014.0,1,0,1
LTU,AUS,2014.0,2,0,2
BRN,,2018.0,27,0,27
BOL,BRA,2018.0,2,0,2
TJK,,2014.0,7,0,7
,GNQ,2001.0,3,0,3
PHL,ESP,2014.0,4,0,4
,ALB,2004.0,30,0,30
SVK,EGY,2018.0,1,0,1
ALB,,2015.0,50,0,50
SWZ,,2021.0,24,0,24
,PSE,2011.0,77,0,77
BIH,,2017.0,119,0,119
ECU,,2017.0,82,0,82
MAC,,2013.0,17,0,17
ZAF,ISR,2014.0,5,0,5
UGA,ZWE,2018.0,1,0,1
,SLB,2008.0,9,0,9
MUS,IND,2020.0,1,0,1
OMN,QAT,2008.0,2,0,2
,DOM,2011.0,29,0,29
BEL,SAU,2020.0,5,0,5
GUY,USA,2017.0,1,0,1
,PRI,2010.0,175,0,175
PSE,,2017.0,46,0,46
GNB,PRT,2014.0,1,0,1
TUR,TKM,2016.0,2,0,2
,BDI,2011.0,14,0,14
BDI,NLD,2019.0,1,0,1
HUN,THA,2014.0,1,0,1
NZL,MWI,2015.0,1,0,1
UGA,ISR,2015.0,1,0,1
UKR,AUS,2021.0,3,0,3
YEM,,2019.0,49,0,49
,KHM,2011.0,77,0,77
NGA,QAT,2017.0,1,0,1
,MDA,2020.0,27,0,27
IRL,SDN,2017.0,3,0,3
CHE,MNE,2018.0,2,0,2
BDI,ZWE,2015.0,1,0,1
GUF,,2020.0,18,0,18
MNE,,2021.0,61,0,61
GAB,GMB,2015.0,1,0,1
NER,DNK,2019.0,1,0,1
ITA,HKG,2017.0,3,0,3
FJI,,2017.0,13,0,13
VEN,EGY,2019.0,1,0,1
BEL,ISL,2021.0,3,0,3
LBR,COG,2019.0,2,0,2
NZL,TTO,2015.0,1,0,1
,LSO,1997.0,3,0,3
CYP,NOR,2018.0,2,0,2
,SYC,2011.0,6,0,6
,AFG,2011.0,19,0,19
UKR,DNK,2019.0,1,0,1
UGA,SVN,2022.0,1,0,1
BRN,,2026.0,19,0,19
GBR,HTI,2014.0,1,0,1
HTI,,2017.0,16,0,16
GAB,,2020.0,30,0,30
,BOL,2014.0,47,0,47
,KWT,2014.0,180,0,180
,TGO,2014.0,64,0,64
YEM,JOR,2018.0,2,0,2
SYR,CHE,2019.0,1,0,1
MYS,SLB,2018.0,1,0,1
BRB,,2006.0,10,0,10
GBR,MDV,2014.0,1,0,1
COG,TZA,2021.0,2,0,2
MYS,CZE,2020.0,3,0,3
TUR,LBY,2017.0,1,0,1
SWZ,,2025.0,105,0,105
,SLV,2002.0,18,0,18
MEX,PRY,2018.0,1,0,1
GTM,BRA,2018.0,2,0,2
,SSD,2014.0,5,0,5
SSD,FRA,2017.0,1,0,1
OMN,PHL,2019.0,3,0,3
,SYR,2019.0,228,0,228
GBR,MAR,2015.0,3,0,3
GBR,CRI,1998.0,1,0,1
,MUS,1995.0,17,0,17
MLT,FRA,2014.0,1,0,1
LVA,SAU,2015.0,1,0,1
ISL,CAN,2001.0,1,0,1
,LVA,2001.0,79,0,79
MYS,NOR,1998.0,1,0,1
SWE,CRI,2014.0,1,0,1
JOR,,2000.0,36,0,36
MDA,RUS,2008.0,1,0,1
GHA,,1999.0,7,0,7
,UGA,1995.0,81,0,81
BWA,JAM,2002.0,1,0,1
PAK,AUT,2001.0,1,0,1
ITA,SAU,2005.0,1,0,1
SAU,ITA,2006.0,2,0,2
JPN,KWT,2000.0,4,0,4
FRA,PAK,1997.0,1,0,1
BGR,IND,2012.0,1,0,1
AZE,,2007.0,50,0,50
NGA,ARG,2009.0,1,0,1
BRA,EGY,2001.0,1,0,1
,GLP,1998.0,10,0,10
ARE,NOR,2017.0,3,0,3
MKD,BGR,2007.0,2,0,2
BFA,,2003.0,7,0,7
ARE,,1999.0,20,0,20
TTO,NLD,1997.0,1,0,1
IND,LAO,2013.0,2,0,2
BRA,VEN,1999.0,3,0,3
EGY,AUS,1998.0,1,0,1
OMN,,2015.0,71,0,71
URY,,2011.0,73,0,73
KEN,NGA,1998.0,1,0,1
,ETH,1999.0,85,0,85
HKG,ISR,2001.0,1,0,1
KWT,JPN,2016.0,1,0,1
URY,GRC,2019.0,1,0,1
UKR,NZL,2001.0,1,0,1
COG,BEL,1999.0,1,0,1
PAK,TUR,2002.0,2,0,2
IRN,OMN,2014.0,2,0,2
ETH,,2003.0,18,0,18
JAM,,2008.0,20,0,20
IND,YEM,2007.0,4,0,4
CAN,BLZ,2010.0,1,0,1
ECU,CHL,2002.0,1,0,1
GBR,NAM,1998.0,1,0,1
USA,MNP,2014.0,1,0,1
BRN,PHL,2018.0,1,0,1
NZL,NGA,2001.0,1,0,1
CHE,PRI,2011.0,2,0,2
,BRB,1997.0,7,0,7
GMB,,2018.0,19,0,19
DEU,KWT,2015.0,1,0,1
PRI,FRA,2000.0,2,0,2
USA,MNG,2013.0,6,0,6
BRN,THA,2011.0,1,0,1
DEU,OMN,2002.0,3,0,3
,VUT,2000.0,2,0,2
FIN,HRV,2015.0,2,0,2
COG,FRA,1997.0,2,0,2
JAM,NZL,2005.0,1,0,1
NOR,TUR,2005.0,2,0,2
BLR,CHN,2001.0,1,0,1
TJK,,2001.0,3,0,3
AZE,,1999.0,19,0,19
YEM,SAU,2008.0,3,0,3
QAT,,2014.0,44,0,44
SEN,,1999.0,9,0,9
BTN,NPL,2017.0,1,0,1
LBR,GHA,2020.0,2,0,2
,BLZ,2012.0,5,0,5
LTU,IND,2020.0,2,0,2
,GUY,2015.0,15,0,15
,LUX,2006.0,59,0,59
,SHN,2015.0,5,0,5
LSO,,2020.0,14,0,14
IRN,CYP,2018.0,2,0,2
PHL,HUN,2018.0,1,0,1
LUX,PSE,2022.0,1,0,1
,RWA,2010.0,59,0,59
USA,BLZ,2008.0,2,0,2
,MKD,2017.0,133,0,133
FJI,,2026.0,9,0,9
THA,VEN,2018.0,1,0,1
CRI,GBR,2022.0,4,0,4
,SLB,2015.0,10,0,10
ARG,DNK,2023.0,5,0,5
UZB,CHN,2018.0,9,0,9
IRN,HUN,2000.0,1,0,1
SUR,,2024.0,19,0,19
IDN,ETH,2020.0,1,0,1
,MLI,2007.0,77,0,77
,TTO,1997.0,35,0,35
BGD,DNK,2013.0,2,0,2
PNG,,2018.0,25,0,25
,NCL,2017.0,16,0,16
SWE,YEM,2023.0,1,0,1
MYS,TLS,2022.0,1,0,1
,GUF,2017.0,11,0,11
JAM,,2015.0,42,0,42
LVA,,2016.0,130,0,130
GRC,BGD,2017.0,1,0,1
,SLE,2017.0,35,0,35
NPL,,2009.0,55,0,55
,GUF,2018.0,17,0,17
IRQ,JPN,2021.0,1,0,1
VNM,DNK,2007.0,2,0,2
IND,AFG,2012.0,2,0,2
,CUB,2020.0,216,0,216
NAM,,2017.0,26,0,26
BFA,PRT,2018.0,1,0,1
MYS,ARM,2012.0,1,0,1
GEO,,2006.0,47,0,47
MEX,NIC,2003.0,2,0,2
THA,ETH,2012.0,1,0,1
IDN,SEN,2022.0,1,0,1
PAN,,2008.0,8,0,8
CHL,GTM,2023.0,2,0,2
GHA,UGA,2014.0,2,0,2
,GAB,2005.0,27,0,27
GBR,MOZ,2023.0,1,0,1
,PRY,2013.0,46,0,46
,MCO,2004.0,9,0,9
ITA,AFG,2023.0,3,0,3
BGR,EGY,2018.0,3,0,3
KOR,TTO,2018.0,1,0,1
SVN,IND,1997.0,1,0,1
,FJI,1997.0,17,0,17
ISR,SVN,2006.0,1,0,1
PRY,MEX,1999.0,1,0,1
PRI,JAM,1999.0,1,0,1
LIE,CHE,2006.0,1,0,1
NER,,2001.0,4,0,4
POL,ISL,2002.0,1,0,1
MDA,AUT,2002.0,1,0,1
HUN,ARE,1998.0,1,0,1
BWA,ETH,2001.0,1,0,1
,SLB,2001.0,4,0,4
MWI,NLD,2016.0,2,0,2
SDN,KEN,2002.0,1,0,1
PRT,PRI,2001.0,3,0,3
BLR,GBR,2011.0,3,0,3
CHE,ZWE,2005.0,4,0,4
PRI,,2005.0,44,0,44
,GRD,2002.0,5,0,5
KWT,FIN,2008.0,2,0,2
GIN,,2003.0,2,0,2
TWN,BLR,2012.0,2,0,2
HKG,BEL,2003.0,3,0,3
,QAT,1995.0,20,0,20
,TJK,1997.0,16,0,16
GLP,MTQ,2002.0,1,0,1
NLD,BFA,2002.0,3,0,3
BOL,,2001.0,9,0,9
,SLV,1997.0,2,0,2
ZWE,ZMB,2003.0,1,0,1
MYS,OMN,2001.0,2,0,2
DEU,GUM,2009.0,1,0,1
GUM,DEU,2011.0,2,0,2
ARG,SAU,2021.0,1,0,1
KNA,,2018.0,5,0,5
ESP,THA,2008.0,1,0,1
NLD,REU,2007.0,1,0,1
MEX,PRY,2017.0,4,0,4
ROU,ZAF,2016.0,2,0,2
TTO,,2004.0,22,0,22
PAK,MEX,1999.0,2,0,2
SAU,BGR,2008.0,1,0,1
BGD,AUS,1997.0,3,0,3
MSR,GBR,1998.0,6,0,6
,GRD,1997.0,2,0,2
NZL,FIN,1998.0,2,0,2
MNE,,2011.0,9,0,9
GBR,MUS,2013.0,1,0,1
NCL,,2009.0,6,0,6
NPL,,2011.0,59,0,59
IND,TTO,2006.0,5,0,5
KAZ,IRL,2007.0,1,0,1
,MDA,2007.0,71,0,71
TZA,QAT,2019.0,1,0,1
AUT,KOR,2011.0,12,0,12
CCK,,2013.0,2,0,2
FRA,NAM,2022.0,1,0,1
,YEM,2007.0,36,0,36
,NAM,1999.0,18,0,18
,MDG,2008.0,57,0,57
,JAM,2007.0,50,0,50
,MCO,2008.0,12,0,12
ARM,ITA,2013.0,3,0,3
,RWA,2006.0,29,0,29
RWA,COL,2011.0,1,0,1
ARG,DNK,2010.0,2,0,2
UKR,ESP,2011.0,3,0,3
FRA,BIH,2010.0,3,0,3
SVK,BIH,2015.0,1,0,1
AUT,SAU,2012.0,5,0,5
GRC,URY,2007.0,1,0,1
BOL,IDN,2011.0,1,0,1
PRK,,2017.0,2,0,2
,COG,2007.0,54,0,54
SGP,ETH,2022.0,1,0,1
PAK,IRN,2011.0,2,0,2
SVN,IRL,2010.0,1,0,1
AFG,CHE,2015.0,1,0,1
LAO,CHE,2017.0,5,0,5
FRA,DJI,2018.0,5,0,5
ARG,ZAF,2017.0,1,0,1
SVN,NOR,2014.0,4,0,4
IRN,PRT,2010.0,3,0,3
IRQ,GRC,2018.0,2,0,2
TJK,,2015.0,18,0,18
NOR,THA,2016.0,2,0,2
LUX,KOR,2014.0,2,0,2
CHN,YEM,2002.0,1,0,1
MDV,USA,2016.0,1,0,1
BRA,AGO,2011.0,1,0,1
MNE,ITA,2017.0,1,0,1
IDN,FIN,2019.0,4,0,4
TUR,BWA,2018.0,1,0,1
URY,MEX,2022.0,2,0,2
,FJI,2005.0,28,0,28
THA,TLS,2017.0,1,0,1
NLD,NAM,2022.0,1,0,1
LBN,IND,2021.0,1,0,1
DZA,TUN,2016.0,4,0,4
,BTN,2013.0,19,0,19
MAR,CIV,2019.0,4,0,4
DEU,FLK,2022.0,1,0,1
AUS,PRY,2019.0,1,0,1
GBR,CPV,2021.0,4,0,4
BGD,UKR,2019.0,1,0,1
SVN,DNK,2021.0,6,0,6
,SVN,2020.0,295,0,295
MWI,RWA,2009.0,2,0,2
KEN,GMB,2022.0,2,0,2
KWT,CZE,2013.0,1,0,1
AND,,2012.0,32,0,32
NCL,,2021.0,27,0,27
,SLV,2012.0,23,0,23
COG,ETH,2020.0,1,0,1
USA,MMR,2017.0,6,0,6
,LBR,2012.0,15,0,15
CHE,EGY,2014.0,4,0,4
NGA,ESP,2023.0,2,0,2
PAK,ZAF,2003.0,1,0,1
SSD,COG,2023.0,1,0,1
DNK,LUX,2022.0,2,0,2
,TCD,2012.0,19,0,19
,GNB,2013.0,3,0,3
,MCO,2014.0,14,0,14
MCO,,2021.0,23,0,23
TZA,ETH,2021.0,6,0,6
SLE,MWI,2022.0,1,0,1
MYS,UZB,2020.0,5,0,5
NER,,2004.0,2,0,2
GIN,COG,2019.0,3,0,3
BEL,NPL,2019.0,3,0,3
ROU,ARG,2020.0,1,0,1
LKA,TWN,2021.0,2,0,2
IRQ,VNM,2023.0,1,0,1
ARG,AUT,2020.0,8,0,8
SVN,CHE,2017.0,8,0,8
ITA,MOZ,2019.0,4,0,4
,REU,2016.0,9,0,9
,GUF,2016.0,14,0,14
PNG,CZE,2023.0,1,0,1
,MAC,2000.0,10,0,10
NER,SGP,2021.0,1,0,1
,PSE,2009.0,48,0,48
NAM,KEN,2022.0,1,0,1
GBR,ESP,2024.0,3,0,3
ROU,CAN,2023.0,2,0,2
MUS,,2018.0,32,0,32
,PNG,2018.0,37,0,37
BOL,DEU,2021.0,2,0,2
BIH,SWE,2019.0,1,0,1
MLT,MEX,2021.0,1,0,1
TWN,MEX,2021.0,2,0,2
KOR,FJI,2023.0,2,0,2
,MNG,2020.0,49,0,49
CZE,MMR,2022.0,1,0,1
ERI,CHN,2021.0,2,0,2
CAN,CYM,2023.0,2,0,2
ARE,MEX,2018.0,1,0,1
ISR,CYP,2012.0,2,0,2
IRL,MYS,1999.0,2,0,2
ISR,COL,2007.0,2,0,2
JPN,ECU,2001.0,1,0,1
ECU,CHL,2005.0,2,0,2
KHM,,2012.0,23,0,23
PAK,ARE,2009.0,2,0,2
GUF,,2007.0,7,0,7
MTQ,,2021.0,6,0,6
SRB,LUX,2006.0,2,0,2
NLD,GTM,2014.0,2,0,2
BFA,ZAF,2004.0,1,0,1
AZE,ESP,2002.0,1,0,1
THA,FRA,1997.0,1,0,1
PAN,JPN,1998.0,1,0,1
SUR,,2010.0,9,0,9
NGA,MEX,2001.0,1,0,1
,YEM,1999.0,14,0,14
SDN,,2011.0,35,0,35
CAN,NGA,1999.0,3,0,3
LTU,POL,2009.0,2,0,2
AIA,IND,2023.0,1,0,1
VNM,THA,2002.0,1,0,1
POL,MEX,2002.0,5,0,5
LKA,AUT,2000.0,1,0,1
AUT,LKA,2006.0,1,0,1
FRA,PER,2004.0,3,0,3
EGY,MYS,2000.0,1,0,1
CIV,SEN,2002.0,2,0,2
PAK,KOR,2000.0,1,0,1
,DOM,1994.0,24,0,24
DOM,,2017.0,17,0,17
BHS,NZL,2005.0,1,0,1
POL,HUN,1998.0,1,0,1
BGR,AUT,2011.0,1,0,1
NER,ETH,2012.0,2,0,2
VNM,CHN,1999.0,1,0,1
ITA,ATA,2008.0,1,0,1
LTU,JPN,1999.0,2,0,2
BRA,POL,2000.0,1,0,1
CAN,PER,2008.0,2,0,2
GRC,CAN,2022.0,9,8,1
HRV,AUS,2021.0,3,2,1
DNK,FIN,2022.0,17,24,-7
EGY,YEM,2017.0,7,1,6
ETH,KOR,2021.0,10,11,-1
BRA,PRY,2018.0,6,5,1
AUS,WSM,2014.0,4,1,3
NOR,ESP,2017.0,18,28,-10
KAZ,GBR,2021.0,11,10,1
VNM,DEU,2019.0,9,31,-22
USA,KWT,2011.0,15,5,10
IND,UGA,2019.0,1,1,0
CHE,SEN,2013.0,1,2,-1
IRN,IND,2023.0,10,7,3
SAU,NLD,2019.0,5,13,-8
DNK,POL,2020.0,5,7,-2
PAK,FIN,2017.0,8,3,5
COL,ESP,2013.0,63,103,-40
JOR,KWT,2018.0,9,5,4
DEU,BGR,2018.0,16,5,11
HRV,CHE,2018.0,11,6,5
AUT,CHN,2012.0,17,17,0
JOR,KWT,2017.0,7,2,5
KOR,LKA,2019.0,6,2,4
DNK,CHE,2015.0,30,25,5
IND,THA,2000.0,2,2,0
FRA,SGP,2006.0,14,8,6
IND,GRC,2015.0,5,2,3
TUR,IRN,2018.0,21,28,-7
CZE,NOR,2013.0,2,10,-8
MWI,GBR,2018.0,22,16,6
FRA,LUX,2017.0,42,13,29
IND,FIN,2009.0,11,4,7
KHM,USA,2015.0,8,8,0
COL,NOR,2017.0,1,3,-2
ETH,ESP,2021.0,7,2,5
PHL,HKG,2017.0,2,2,0
JPN,NPL,2016.0,10,8,2
SAU,KWT,2014.0,6,3,3
TGO,BFA,2016.0,1,1,0
TUN,IND,2018.0,2,1,1
SGP,BEL,2020.0,10,5,5
CZE,AUS,2019.0,10,16,-6
LUX,CHE,2015.0,3,3,0
ISR,PSE,2018.0,20,21,-1
BGR,GRC,2021.0,4,3,1
CAN,BRA,2023.0,51,127,-76
MEX,AUS,2016.0,8,9,-1
SDN,ARE,2019.0,3,1,2
ERI,IND,2019.0,1,1,0
VNM,TUR,2021.0,4,1,3
IND,PRT,2017.0,15,21,-6
ZWE,BEL,2013.0,1,1,0
BEL,ZWE,2018.0,1,1,0
CHE,HKG,2014.0,4,5,-1
BEL,IRL,2020.0,10,16,-6
ETH,DNK,2020.0,2,6,-4
ECU,PER,2016.0,8,3,5
ECU,PER,2022.0,6,5,1
HRV,FRA,2017.0,6,8,-2
HRV,FRA,2022.0,4,2,2
DNK,GNB,2016.0,2,3,-1
GBR,LUX,2017.0,9,6,3
NLD,ARG,2006.0,5,6,-1
DNK,BEL,2022.0,19,19,0
SWZ,CHE,2017.0,18,5,13
IDN,KOR,2011.0,4,7,-3
GRC,NOR,2017.0,9,1,8
MYS,CAN,2001.0,5,4,1
EGY,ROU,2020.0,1,1,0
DEU,CRI,2016.0,9,8,1
MNG,AUS,2019.0,2,3,-1
CMR,USA,2016.0,11,6,5
ESP,KOR,2021.0,7,11,-4
AUS,TWN,2017.0,8,25,-17
NZL,KAZ,2020.0,1,1,0
ESP,IRN,2016.0,10,23,-13
DNK,JPN,2021.0,10,9,1
LKA,NZL,2019.0,2,8,-6
HUN,POL,2022.0,5,3,2
CZE,VNM,2017.0,2,3,-1
IND,DNK,2019.0,21,13,8
NPL,IND,2017.0,17,36,-19
KEN,NGA,2019.0,4,6,-2
AUS,NOR,2011.0,17,7,10
NOR,TUR,2023.0,2,7,-5
IND,NPL,2019.0,40,23,17
KEN,GHA,2022.0,3,5,-2
RUS,NLD,2014.0,18,8,10
ZAF,NZL,2016.0,7,10,-3
QAT,NZL,2020.0,2,3,-1
CHE,SVN,2015.0,1,7,-6
BEN,USA,2020.0,6,1,5
SGP,SWE,2016.0,9,17,-8
EGY,JOR,2020.0,7,12,-5
ARM,COL,2016.0,4,4,0
MWI,GBR,2016.0,20,21,-1
SWE,ETH,2020.0,3,7,-4
DEU,ARG,2022.0,23,35,-12
DEU,ARE,2023.0,8,3,5
COD,COG,2016.0,21,79,-58
CAN,DNK,2005.0,12,10,2
BHR,SAU,2020.0,7,10,-3
IND,BEL,2001.0,7,4,3
FIN,RUS,2006.0,21,12,9
PER,MEX,2015.0,3,8,-5
ESP,GTM,2020.0,4,1,3
FRA,NCL,1998.0,6,10,-4
ARG,CZE,2021.0,5,2,3
ZAF,NLD,2013.0,16,21,-5
USA,UZB,2022.0,2,1,1
SRB,RUS,2022.0,3,5,-2
AUS,ARE,2022.0,28,13,15
EGY,NLD,2000.0,1,2,-1
RUS,SVN,2020.0,4,3,1
LKA,THA,2022.0,2,2,0
AUS,OMN,2021.0,5,2,3
POL,BRA,2021.0,5,7,-2
BHR,GBR,2008.0,2,5,-3
SWE,KOR,2006.0,3,1,2
ZAF,RUS,2018.0,4,119,-115
ETH,DEU,2021.0,5,15,-10
MLI,DEU,2023.0,1,1,0
CAN,NLD,2022.0,54,58,-4
USA,NIC,2021.0,1,2,-1
SGP,MYS,2002.0,1,6,-5
DEU,VNM,2022.0,13,15,-2
GRC,POL,2022.0,5,3,2
ARE,PAK,2023.0,10,25,-15
AUS,JOR,2023.0,9,1,8
ARG,PRT,1999.0,1,2,-1
RUS,JPN,2018.0,14,18,-4
NPL,IND,2018.0,22,33,-11
PAK,AUT,2018.0,7,12,-5
AUT,POL,2015.0,13,11,2
SRB,DEU,2001.0,22,8,14
PAK,BEL,2018.0,8,5,3
TUR,IRQ,2022.0,23,13,10
DNK,FRO,2010.0,4,2,2
KOR,IRL,2011.0,3,1,2
JPN,TUN,2008.0,1,1,0
CHE,NZL,2019.0,11,8,3
SRB,DEU,2008.0,6,20,-14
ITA,PRT,2008.0,16,6,10
SWZ,ZAF,2015.0,1,5,-4
IRL,ITA,2014.0,20,23,-3
SWE,ZAF,2007.0,6,6,0
ZWE,ZAF,2013.0,24,23,1
HUN,NLD,2000.0,16,3,13
PRT,MEX,2017.0,7,4,3
AUS,IRL,2013.0,28,55,-27
DEU,ARG,2017.0,28,36,-8
VNM,JPN,2011.0,9,47,-38
IDN,JPN,2004.0,4,29,-25
CHN,NOR,2009.0,17,10,7
CHE,EGY,2016.0,7,6,1
COG,BEL,2009.0,4,3,1
CHE,LUX,2010.0,4,4,0
LUX,AUT,2017.0,2,3,-1
LUX,FRA,2009.0,8,25,-17
COG,BEL,2011.0,7,3,4
MYS,SAU,2010.0,19,4,15
MKD,GBR,2020.0,4,3,1
ZAF,CHE,2013.0,10,11,-1
AUT,POL,2008.0,10,11,-1
JAM,USA,2016.0,14,9,5
LTU,GBR,1999.0,2,5,-3
GBR,LTU,2001.0,1,4,-3
ITA,KOR,2023.0,7,3,4
TUR,JPN,2011.0,17,14,3
AUT,PHL,2016.0,1,1,0
SAU,FRA,2008.0,2,4,-2
AUS,RUS,2002.0,8,18,-10
FIN,CHN,2011.0,14,18,-4
DEU,MWI,2002.0,2,1,1
GRC,TUR,2011.0,3,4,-1
BRA,ITA,2016.0,45,78,-33
POL,JPN,1999.0,20,17,3
AUS,BWA,2018.0,5,1,4
KEN,UGA,2017.0,10,9,1
IDN,CAN,2012.0,3,8,-5
USA,GUM,1998.0,10,3,7
KOR,NOR,2009.0,1,3,-2
SWE,ETH,1999.0,5,4,1
HUN,JPN,2003.0,9,19,-10
BRA,NGA,2006.0,1,1,0
GBR,ZMB,2014.0,6,2,4
ARG,VEN,2009.0,6,6,0
ARE,QAT,2022.0,5,8,-3
BEL,ZMB,2007.0,2,1,1
CRI,GBR,2014.0,1,2,-1
NGA,NER,2009.0,27,12,15
ESP,BGR,2004.0,1,2,-1
GBR,ROU,2008.0,12,18,-6
IND,NLD,2007.0,14,9,5
PRT,SVN,2011.0,1,1,0
SAU,MYS,2015.0,14,62,-48
ZWE,ETH,2021.0,3,3,0
MYS,IDN,2007.0,8,6,2
ITA,LUX,2015.0,11,6,5
CAN,SAU,2006.0,30,21,9
THA,DEU,2006.0,7,15,-8
DNK,POL,2007.0,6,7,-1
NGA,SAU,2011.0,4,1,3
SGP,NLD,2008.0,5,7,-2
LVA,USA,2007.0,2,1,1
TUR,ITA,2012.0,12,15,-3
THA,FRA,2010.0,8,22,-14
URY,CAN,2010.0,2,1,1
JOR,CAN,2007.0,7,7,0
IRN,DNK,2010.0,9,4,5
AUS,ARG,2011.0,7,5,2
ESP,CAN,2004.0,26,22,4
NLD,EST,2005.0,1,1,0
NGA,ZAF,2006.0,10,9,1
USA,UGA,2004.0,11,13,-2
MYS,SGP,2001.0,3,4,-1
PRT,POL,2016.0,5,7,-2
CHE,URY,2008.0,1,1,0
HUN,MEX,2011.0,2,1,1
JPN,IRL,2011.0,6,4,2
RUS,AZE,2010.0,8,11,-3
GBR,OMN,2007.0,16,7,9
CHL,PRT,2021.0,8,2,6
FRA,NGA,2010.0,4,3,1
MYS,AUS,2004.0,8,16,-8
PRT,TUR,2014.0,2,1,1
RUS,AUT,2001.0,13,10,3
EGY,GBR,2014.0,33,60,-27
GBR,BGD,2002.0,8,10,-2
BGD,PAK,2005.0,7,2,5
SVN,HRV,2009.0,6,6,0
BRA,AUS,2005.0,11,8,3
FIN,IND,2011.0,2,15,-13
CHN,NGA,2009.0,3,3,0
AUT,SVN,2012.0,6,8,-2
DEU,NAM,2018.0,3,1,2
CIV,IND,2016.0,1,3,-2
FRA,BFA,2007.0,11,6,5
CAN,KOR,2002.0,20,35,-15
TWN,AUS,2006.0,6,10,-4
CUB,GBR,2013.0,1,1,0
MWI,KEN,2016.0,1,2,-1
CHE,DZA,2009.0,2,1,1
ISL,DNK,2007.0,6,10,-4
ISR,CHN,2010.0,9,7,2
NLD,IRN,2003.0,5,2,3
TZA,ZAF,2010.0,4,5,-1
GRC,AUS,2006.0,3,2,1
NZL,ISL,2014.0,1,1,0
KHM,SGP,2017.0,2,1,1
NZL,DNK,2012.0,6,6,0
DNK,UKR,2017.0,1,4,-3
BGD,IND,2005.0,9,10,-1
KHM,THA,2007.0,1,1,0
GBR,KWT,2009.0,7,5,2
ESP,DZA,2009.0,4,1,3
USA,GTM,2012.0,12,5,7
SAU,NGA,2011.0,1,4,-3
TWN,FRA,2004.0,5,8,-3
KOR,MYS,2009.0,6,4,2
MYS,RUS,2015.0,3,1,2
LKA,IND,2009.0,4,2,2
JAM,USA,2022.0,11,8,3
KOR,IDN,2011.0,7,4,3
AUS,NGA,2009.0,3,1,2
TUR,CAN,2005.0,7,10,-3
ESP,PRI,2015.0,9,5,4
NOR,TZA,2007.0,6,5,1
SRB,MNE,2008.0,16,5,11
GBR,MDG,2013.0,1,1,0
NOR,JPN,2017.0,5,8,-3
ISR,TUR,2013.0,5,1,4
SWE,TUR,2015.0,13,9,4
COL,ITA,2023.0,10,7,3
SVK,DEU,2007.0,15,13,2
LUX,DEU,1999.0,3,2,1
SAU,IRL,2012.0,3,2,1
ROU,CAN,2012.0,7,6,1
MNG,JPN,2007.0,3,2,1
CZE,DNK,2010.0,2,2,0
USA,VEN,2016.0,8,33,-25
DEU,PAN,2013.0,3,1,2
NOR,AUT,2013.0,3,11,-8
ITA,TUR,2020.0,11,28,-17
IRL,GRC,2021.0,4,7,-3
IND,AUT,2017.0,15,11,4
FRA,SVK,2017.0,3,3,0
AUT,NZL,2021.0,7,3,4
ESP,AUS,2022.0,33,43,-10
IRN,ESP,2017.0,31,8,23
KOR,SAU,2018.0,18,14,4
NZL,SWE,2007.0,3,6,-3
OMN,CHN,2018.0,4,2,2
CAN,IDN,2018.0,8,2,6
LSO,ZAF,2018.0,4,9,-5
GHA,DEU,2019.0,16,20,-4
CHL,FRA,2021.0,45,44,1
BGD,PHL,2020.0,4,1,3
CAN,NGA,2019.0,9,15,-6
MRT,FRA,2018.0,3,1,2
NPL,IND,2016.0,20,23,-3
MYS,SGP,2014.0,14,28,-14
IRL,TUR,2020.0,3,7,-4
USA,BWA,2022.0,8,10,-2
GBR,ECU,2017.0,9,6,3
ECU,GBR,2022.0,7,12,-5
ITA,DZA,2016.0,9,4,5
IRQ,GBR,2017.0,13,88,-75
NLD,CZE,2005.0,4,4,0
CRI,ESP,2017.0,9,10,-1
IND,PAK,2017.0,41,26,15
DZA,ESP,2017.0,8,9,-1
DZA,FIN,2020.0,4,1,3
IRN,FIN,2017.0,20,7,13
ETH,TWN,2017.0,4,3,1
THA,NZL,2020.0,4,5,-1
LVA,EST,2017.0,2,3,-1
IND,NPL,2009.0,30,31,-1
GBR,LBY,2019.0,19,2,17
USA,BHS,2016.0,1,6,-5
MEX,BEL,2011.0,8,6,2
IDN,TWN,2014.0,10,11,-1
BEL,TUN,2021.0,9,2,7
DEU,IDN,2001.0,4,5,-1
IND,MMR,2018.0,4,1,3
ZAF,MOZ,2021.0,7,5,2
SWE,HUN,2023.0,6,7,-1
IRL,NOR,2018.0,6,3,3
MAC,TWN,2018.0,4,3,1
BEL,TUR,2022.0,6,27,-21
CHE,SWZ,2020.0,8,10,-2
KHM,SGP,2022.0,4,1,3
NOR,POL,2020.0,14,16,-2
CZE,DNK,2023.0,6,3,3
ISL,USA,2020.0,11,16,-5
PER,AUS,2016.0,1,2,-1
IRN,FIN,2016.0,10,11,-1
BGD,SAU,2015.0,10,6,4
FSM,USA,2018.0,1,2,-1
AUT,DNK,2022.0,16,11,5
USA,VCT,2021.0,3,2,1
SRB,RUS,2017.0,4,4,0
CHE,KEN,2015.0,6,5,1
SGP,SWE,2017.0,14,10,4
USA,LKA,2020.0,38,27,11
IRN,OMN,2022.0,10,3,7
LUX,IND,2022.0,3,4,-1
NLD,ETH,2020.0,17,9,8
UGA,KEN,2017.0,9,10,-1
KEN,UGA,2018.0,9,12,-3
HKG,DEU,2022.0,15,17,-2
GRC,BRA,2007.0,1,2,-1
BRA,GRC,2008.0,2,1,1
NOR,FRA,1998.0,8,12,-4
NLD,RUS,2008.0,12,18,-6
FRA,PYF,2011.0,20,7,13
ISL,GBR,2005.0,9,4,5
GBR,IDN,2008.0,10,8,2
HUN,SVK,2014.0,9,6,3
DEU,MRT,2016.0,1,1,0
THA,AUT,1997.0,1,1,0
NZL,DNK,2002.0,3,6,-3
BEL,KOR,2021.0,12,14,-2
CHE,ROU,2002.0,4,6,-2
SAU,ARE,2003.0,7,7,0
CHE,COL,2003.0,1,2,-1
BRA,NLD,1999.0,9,9,0
ISL,USA,2007.0,11,15,-4
PRT,NLD,2013.0,18,16,2
CIV,ZAF,2000.0,6,1,5
CIV,FRA,2003.0,25,35,-10
KAZ,USA,2008.0,4,3,1
HRV,SVN,2003.0,8,3,5
HUN,DNK,2004.0,2,3,-1
CUB,USA,2011.0,12,8,4
FRA,VEN,2013.0,12,7,5
OMN,NLD,2011.0,2,1,1
DEU,PSE,2013.0,4,4,0
FRA,GAB,2006.0,9,6,3
SVK,GBR,1998.0,10,6,4
IRL,ISR,2002.0,2,4,-2
GRC,JPN,2015.0,1,4,-3
SAU,LBN,2014.0,2,7,-5
CAN,DNK,2002.0,27,13,14
SWE,KEN,2008.0,2,4,-2
URY,ESP,2001.0,11,8,3
USA,LVA,2004.0,4,1,3
BGR,AUT,2007.0,1,2,-1
AUT,BGR,2009.0,2,3,-1
GBR,TZA,2003.0,12,6,6
GBR,COL,2005.0,13,5,8
ETH,SWE,1999.0,4,5,-1
CHE,HRV,2005.0,1,2,-1
LKA,HKG,2018.0,2,1,1
IDN,GBR,2009.0,2,14,-12
DEU,KEN,2003.0,4,6,-2
NOR,CAN,1999.0,9,16,-7
AUS,IDN,2003.0,16,9,7
THA,IDN,2003.0,3,2,1
FRA,MTQ,2018.0,24,40,-16
ROU,TUR,2002.0,4,1,3
NER,FRA,1998.0,8,3,5
POL,CZE,2008.0,4,3,1
CYP,USA,1999.0,2,6,-4
DEU,PHL,2015.0,7,2,5
DEU,MDA,2014.0,3,3,0
MDA,USA,2017.0,3,9,-6
ISL,GBR,2012.0,5,8,-3
ITA,ARM,2001.0,3,1,2
GTM,USA,2005.0,2,7,-5
ARG,DEU,2015.0,29,20,9
ZWE,BWA,2006.0,2,1,1
GEO,RUS,2001.0,9,3,6
PRT,AGO,2016.0,4,2,2
AUT,HRV,2012.0,2,9,-7
SWE,LVA,2001.0,3,3,0
BGR,FRA,2000.0,10,13,-3
RUS,BLR,2015.0,19,26,-7
BRA,HUN,2004.0,1,1,0
USA,ARM,2000.0,5,9,-4
ITA,PRT,2004.0,13,6,7
PRT,ITA,2006.0,7,6,1
CAN,AUT,1999.0,14,8,6
THA,AUS,2000.0,13,10,3
OMN,EGY,2015.0,5,6,-1
BGR,BEL,2021.0,4,2,2
IRL,NLD,2006.0,2,12,-10
EGY,FRA,2000.0,5,4,1
EGY,FRA,2006.0,7,7,0
SWE,BEL,2023.0,19,16,3
FRA,COG,2006.0,7,4,3
NLD,IRL,2000.0,7,8,-1
RUS,GEO,1999.0,12,4,8
OMN,NLD,2009.0,1,2,-1
AUS,IRN,2009.0,36,38,-2
CAN,CZE,1999.0,6,5,1
SWE,EST,2013.0,6,4,2
USA,PRT,2001.0,37,53,-16
POL,CZE,2004.0,2,5,-3
ARE,SWE,2021.0,6,8,-2
SWE,ARE,2023.0,2,7,-5
POL,ITA,2003.0,16,27,-11
USA,JAM,1999.0,8,7,1
CHN,RUS,2007.0,4,8,-4
ESP,GRC,2007.0,6,10,-4
USA,TZA,1998.0,5,7,-2
COG,FRA,2010.0,8,4,4
ZAF,NZL,2018.0,13,6,7
LTU,GBR,2007.0,9,3,6
USA,MAR,2005.0,3,7,-4
HRV,DEU,2019.0,26,16,10
USA,LSO,2015.0,3,1,2
ZAF,LSO,2012.0,1,3,-2
JPN,SWE,2017.0,26,31,-5
DEU,PHL,2004.0,1,2,-1
ZWE,GBR,2013.0,7,10,-3
CHL,CHE,2000.0,6,5,1
CAN,SVK,2010.0,1,3,-2
FRA,ARG,1999.0,17,7,10
NLD,CZE,2012.0,10,9,1
ZMB,GBR,2002.0,5,3,2
GBR,OMN,1999.0,5,6,-1
FRA,GRC,2006.0,13,19,-6
DEU,HUN,2007.0,31,40,-9
IDN,DEU,2001.0,5,4,1
GBR,VEN,2007.0,11,8,3
SWE,TZA,2005.0,7,1,6
ZAF,JPN,2019.0,3,4,-1
BEL,JPN,2006.0,16,16,0
ESP,ISR,2001.0,4,5,-1
TZA,JPN,1999.0,2,4,-2
AUT,POL,2001.0,6,9,-3
KAZ,DEU,2003.0,2,1,1
CAF,FRA,2008.0,5,5,0
PER,ECU,2012.0,2,1,1
RUS,BGR,2023.0,2,6,-4
TUR,ITA,1997.0,3,2,1
CAF,ZAF,2013.0,1,2,-1
NAM,DEU,2007.0,1,1,0
DEU,EST,2012.0,7,7,0
NLD,PAK,2013.0,7,6,1
GRC,SVN,2017.0,2,1,1
ITA,SMR,2012.0,6,1,5
THA,LKA,2009.0,1,1,0
JPN,HKG,2006.0,6,5,1
NLD,SVK,2015.0,2,1,1
MWI,DEU,2008.0,1,4,-3
SAU,PRT,2015.0,2,7,-5
EST,SWE,2013.0,4,6,-2
USA,SVK,2012.0,7,11,-4
SVK,FIN,2021.0,1,2,-1
DEU,SVN,2009.0,5,11,-6
IND,GRD,2014.0,2,1,1
NZL,FRA,2020.0,26,20,6
ARM,COL,2018.0,4,2,2
GBR,LKA,2014.0,19,8,11
NOR,MEX,2010.0,4,2,2
VNM,IDN,2021.0,7,1,6
POL,CZE,2015.0,13,16,-3
POL,GRC,2013.0,2,4,-2
FRA,BEN,2009.0,12,11,1
ZMB,ZAF,2003.0,2,2,0
PRT,JPN,2016.0,5,3,2
THA,AUS,2006.0,16,35,-19
JPN,ETH,2020.0,8,3,5
GMB,NGA,2020.0,2,6,-4
HKG,IND,2016.0,12,24,-12
HUN,FIN,2011.0,6,4,2
FRA,CRI,2005.0,2,2,0
CHN,MYS,2016.0,9,18,-9
ITA,URY,2012.0,1,1,0
USA,CUB,2018.0,10,15,-5
MEX,AUS,2018.0,15,11,4
IDN,USA,2010.0,16,32,-16
BRA,JPN,2008.0,17,12,5
SWE,PAK,2013.0,12,5,7
MDG,FRA,2009.0,9,6,3
EGY,MYS,2012.0,6,2,4
DNK,GRC,2015.0,4,9,-5
JOR,AUS,2015.0,3,10,-7
BGR,FRA,2006.0,6,6,0
MKD,SRB,2011.0,17,2,15
TUR,CAN,2002.0,14,9,5
PAK,FRA,2013.0,8,38,-30
IRL,CHN,2012.0,16,10,6
IND,AFG,2010.0,1,2,-1
KEN,PAK,2023.0,1,4,-3
TUN,KOR,2015.0,3,1,2
CAN,NPL,2022.0,5,7,-2
BEN,CAN,2019.0,3,1,2
IRL,HKG,2014.0,3,3,0
MYS,USA,2010.0,12,48,-36
PAK,QAT,2017.0,5,4,1
IRL,BGR,2014.0,1,2,-1
HRV,BEL,2020.0,4,4,0
SAU,AUS,2014.0,20,31,-11
NLD,IRL,2006.0,12,2,10
NLD,PRT,2008.0,15,19,-4
IRN,NLD,2009.0,20,13,7
ZAF,RWA,2014.0,3,2,1
NLD,NOR,2003.0,22,8,14
ESP,NOR,2009.0,15,6,9
HRV,GBR,2009.0,2,6,-4
VEN,COL,2012.0,13,9,4
JOR,EGY,2017.0,4,4,0
AUS,THA,1998.0,21,4,17
BEL,UZB,2010.0,1,1,0
TWN,MAR,2006.0,2,2,0
PRT,ITA,2010.0,10,29,-19
NLD,ISL,2019.0,7,1,6
HUN,BGR,1998.0,1,1,0
HKG,TWN,2011.0,8,8,0
POL,UKR,2016.0,15,36,-21
SGP,VNM,2010.0,5,3,2
MEX,PAN,2008.0,3,1,2
GBR,SVK,2010.0,15,8,7
ESP,EST,2016.0,6,1,5
HRV,DEU,2009.0,10,11,-1
BEL,RUS,2015.0,10,7,3
ROU,CAN,2005.0,4,2,2
HKG,BGD,2011.0,1,1,0
CHE,CZE,2011.0,16,16,0
TZA,USA,2017.0,19,27,-8
RUS,BEL,2015.0,7,10,-3
CAN,KEN,2014.0,6,6,0
PSE,ARE,2018.0,1,1,0
NLD,NPL,2012.0,2,3,-1
NLD,AUS,2001.0,28,32,-4
CZE,CHE,2002.0,13,6,7
GBR,ARG,2015.0,12,13,-1
TUR,CHE,2010.0,12,27,-15
USA,BWA,2017.0,11,13,-2
VEN,CHL,2013.0,10,3,7
ITA,TUN,2006.0,2,1,1
BEL,DNK,2014.0,16,10,6
TUR,MEX,2007.0,1,4,-3
MEX,NLD,2011.0,13,14,-1
KWT,USA,2003.0,6,13,-7
ISR,TUR,2003.0,6,4,2
BRA,VEN,2011.0,1,4,-3
ESP,EGY,2012.0,8,8,0
USA,BRB,2017.0,2,4,-2
THA,LAO,2014.0,4,1,3
CHN,BRA,2008.0,2,5,-3
ROU,DEU,1998.0,20,13,7
MWI,GBR,2017.0,19,25,-6
AUS,ARG,2019.0,5,7,-2
CZE,ISR,2021.0,5,7,-2
FIN,IRN,2022.0,7,47,-40
CAN,DNK,2012.0,14,28,-14
FRA,PYF,2021.0,22,23,-1
SDN,TUR,2014.0,1,1,0
IRQ,MYS,2012.0,10,27,-17
SRB,NOR,2016.0,4,1,3
DEU,SVN,2019.0,14,12,2
CUB,COL,2019.0,7,4,3
NZL,CHL,2016.0,9,1,8
IRN,MYS,2017.0,18,185,-167
ITA,SVN,2021.0,21,9,12
BIH,GBR,2014.0,1,1,0
POL,ITA,2013.0,16,20,-4
AUS,NPL,2015.0,7,5,2
MDA,DEU,2020.0,2,3,-1
GTM,USA,2012.0,5,12,-7
ARG,CAN,2018.0,13,22,-9
RUS,CAN,2013.0,17,19,-2
HRV,SVN,2013.0,8,9,-1
AUT,THA,2017.0,13,9,4
PAK,KWT,2018.0,2,1,1
FIN,IRN,2016.0,11,10,1
LSO,ZAF,2016.0,4,8,-4
FRA,CYP,2021.0,6,2,4
CMR,DEU,2017.0,6,6,0
LKA,USA,2013.0,16,12,4
RUS,IND,2012.0,1,3,-2
SWE,CZE,2007.0,4,6,-2
SWE,VNM,2013.0,7,2,5
KOR,KHM,2021.0,2,2,0
CHN,ESP,2000.0,4,5,-1
PER,CAN,2016.0,7,2,5
HUN,CHE,2013.0,19,14,5
DNK,IRN,2010.0,4,9,-5
CHN,UKR,2020.0,10,14,-4
CHN,MAC,2002.0,3,5,-2
BRA,PRI,2012.0,2,4,-2
CHN,ITA,2008.0,16,18,-2
GBR,PHL,2017.0,5,4,1
GBR,BGR,2018.0,12,3,9
LTU,DEU,2023.0,2,5,-3
GBR,LTU,2014.0,10,5,5
ARG,MEX,2009.0,10,11,-1
GRC,BEL,2012.0,21,11,10
ZWE,NAM,2016.0,1,1,0
SRB,MNE,2014.0,13,3,10
BRA,BEL,2023.0,22,7,15
NPL,CHN,2013.0,3,2,1
IND,IDN,2013.0,16,14,2
NLD,JPN,2019.0,42,31,11
PRT,TUR,2015.0,4,2,2
TUR,PRT,2017.0,5,1,4
ARG,BRA,2021.0,33,37,-4
SRB,JPN,2018.0,3,1,2
HUN,FRA,2015.0,18,14,4
VEN,USA,2014.0,25,14,11
USA,PAN,2017.0,20,15,5
EGY,QAT,2016.0,12,9,3
SAU,SGP,2019.0,7,4,3
CYP,TUR,2009.0,13,11,2
JPN,IRL,2009.0,9,3,6
JPN,SAU,2022.0,9,7,2
BRA,SGP,2015.0,6,4,2
IRN,OMN,2016.0,3,1,2
LUX,IRL,2020.0,2,1,1
JPN,KHM,2018.0,4,2,2
SVN,SWE,2023.0,4,4,0
TTO,ESP,2019.0,2,2,0
AUS,LBN,2015.0,10,1,9
CZE,ITA,2016.0,13,16,-3
POL,JPN,2020.0,7,15,-8
GRC,PRT,2011.0,2,1,1
AUT,KEN,2020.0,2,4,-2
ZAF,SWE,2017.0,16,10,6
NOR,ITA,2022.0,20,34,-14
EGY,YEM,2022.0,11,7,4
DNK,KEN,2017.0,4,1,3
VNM,SRB,2020.0,2,3,-1
RUS,IRL,2018.0,5,2,3
IND,HUN,2010.0,3,1,2
TTO,GBR,2022.0,5,5,0
ALB,KOR,2021.0,1,1,0
PER,KEN,2019.0,1,1,0
LTU,LVA,2022.0,7,3,4
IND,OMN,2014.0,21,14,7
IND,FIN,2019.0,23,8,15
THA,BGD,2019.0,4,5,-1
USA,SWZ,2020.0,5,2,3
EST,FIN,2023.0,11,6,5
PSE,ISR,2017.0,15,14,1
CAN,JOR,2018.0,13,10,3
LKA,KOR,2015.0,2,2,0
SAU,KOR,2019.0,14,36,-22
GRC,ITA,2016.0,38,23,15
ZAF,CMR,2019.0,6,8,-2
EGY,ITA,2018.0,12,18,-6
AUS,SLE,2019.0,1,1,0
HUN,SWE,2023.0,7,6,1
USA,UKR,2015.0,17,25,-8
CAN,TUN,2013.0,9,8,1
IRL,POL,2015.0,7,3,4
COL,SWE,2015.0,3,4,-1
GHA,NOR,2016.0,1,1,0
BEL,EST,2016.0,4,3,1
GRC,TUR,2021.0,5,3,2
HKG,DEU,2016.0,14,8,6
KOR,IRL,2009.0,5,1,4
VNM,SGP,2018.0,4,9,-5
POL,DZA,2018.0,1,2,-1
POL,AUT,2010.0,12,8,4
IRN,CHN,2016.0,27,10,17
BGD,IRL,2012.0,2,1,1
POL,SWE,2013.0,20,13,7
NZL,ISL,2001.0,2,1,1
KOR,SGP,2022.0,17,28,-11
DEU,HRV,2022.0,13,16,-3
SDN,JPN,2015.0,1,2,-1
LBN,ARE,2006.0,3,1,2
CZE,BRA,2017.0,4,2,2
ITA,VNM,2014.0,6,2,4
USA,CMR,2018.0,13,7,6
AUS,ARE,2017.0,18,24,-6
HKG,SAU,2016.0,7,2,5
KOR,ZAF,2014.0,5,3,2
CHN,PRK,2015.0,3,1,2
USA,BHS,2018.0,3,2,1
NGA,AUS,2016.0,5,2,3
MEX,ESP,1997.0,33,35,-2
PAK,FIN,2018.0,2,7,-5
EST,GBR,2014.0,5,11,-6
NGA,CHE,2021.0,7,3,4
NLD,GHA,2016.0,6,7,-1
PSE,OMN,2016.0,1,2,-1
CAN,MAR,2022.0,13,14,-1
LUX,AUS,2019.0,3,1,2
FIN,ARG,2023.0,2,2,0
DNK,SGP,2022.0,5,7,-2
FJI,NZL,2021.0,4,3,1
PAK,NZL,2009.0,4,1,3
FRA,NZL,2022.0,12,12,0
JPN,ISR,2002.0,10,7,3
FRA,THA,2002.0,14,8,6
LKA,CAN,2008.0,5,4,1
IND,CHE,2001.0,9,7,2
ESP,PER,2007.0,8,6,2
CAN,VNM,2020.0,10,3,7
BEL,BLR,2007.0,2,3,-1
CUB,BRA,1999.0,5,2,3
JOR,GBR,2019.0,16,43,-27
ARG,COL,2021.0,21,13,8
IDN,TWN,2015.0,12,14,-2
KAZ,RUS,2019.0,30,57,-27
USA,VEN,2022.0,7,11,-4
ZAF,CMR,2021.0,11,4,7
AUS,FIN,2022.0,16,8,8
LBN,BEL,2019.0,7,6,1
TWN,BEL,2019.0,8,3,5
EGY,NZL,2020.0,2,2,0
DNK,MYS,2019.0,5,1,4
BGD,NOR,2018.0,4,1,3
PSE,TUR,2020.0,3,4,-1
NLD,TWN,2018.0,6,6,0
LTU,ESP,2020.0,2,1,1
ESP,BGD,2020.0,1,3,-2
USA,VIR,2016.0,3,4,-1
PAK,CZE,2023.0,3,2,1
CHN,PRT,2019.0,6,11,-5
CHN,ESP,2024.0,4,3,1
MAR,CAN,2021.0,6,7,-1
EST,GBR,2015.0,12,6,6
CUB,BRA,2020.0,12,6,6
SAU,DZA,2018.0,8,9,-1
TCD,NLD,2018.0,1,1,0
DEU,SRB,2017.0,9,21,-12
TUN,CAN,2023.0,10,3,7
SWE,THA,2016.0,9,8,1
TWN,MEX,2020.0,1,1,0
MYS,FIN,2019.0,4,1,3
IND,PRT,2022.0,6,18,-12
ESP,ECU,1998.0,2,2,0
BGD,GBR,2002.0,10,8,2
IND,BEL,2008.0,9,6,3
KOR,DNK,2015.0,7,4,3
URY,CAN,2006.0,2,1,1
QAT,LBN,2022.0,2,14,-12
MYS,YEM,2020.0,17,8,9
BLR,UKR,2022.0,1,1,0
IRN,ESP,2022.0,37,18,19
PAN,FRA,2021.0,1,2,-1
HRV,POL,2021.0,3,2,1
COL,NZL,2023.0,1,2,-1
KAZ,CAN,2022.0,3,2,1
LKA,IRL,2022.0,1,1,0
MYS,IRL,2023.0,6,1,5
USA,SLV,2021.0,6,2,4
BFA,CIV,2021.0,2,3,-1
MYS,TWN,2019.0,14,7,7
ROU,DEU,2020.0,19,23,-4
BGD,HKG,2022.0,5,6,-1
IND,GRC,2014.0,3,1,2
COL,BEL,2020.0,10,3,7
CRI,ESP,2022.0,6,17,-11
MWI,ZAF,2021.0,11,14,-3
IRN,SWE,2016.0,29,29,0
ITA,ARG,2021.0,14,30,-16
AUS,TLS,2017.0,4,1,3
CAN,ISL,2014.0,4,1,3
ISL,CAN,2018.0,1,3,-2
BEL,BGD,2017.0,6,5,1
FIN,CHN,2009.0,13,10,3
DEU,CRI,2017.0,4,3,1
SAU,IDN,2023.0,6,2,4
SVK,FRA,2019.0,5,2,3
TUN,ZAF,2018.0,2,20,-18
FIN,BGD,2010.0,1,1,0
QAT,PAK,2017.0,4,5,-1
ITA,MYS,2021.0,3,5,-2
CAN,LBN,2012.0,13,4,9
ITA,HUN,2023.0,7,10,-3
ESP,PAN,2017.0,6,2,4
CHE,LTU,2019.0,4,5,-1
DNK,KOR,2017.0,5,11,-6
USA,PAN,2018.0,22,27,-5
ESP,SAU,2023.0,10,7,3
SWE,IRN,2015.0,22,27,-5
USA,MNP,2022.0,1,4,-3
PAK,PRT,2017.0,2,1,1
ESP,SRB,2019.0,1,6,-5
SRB,ESP,2021.0,4,3,1
SRB,AUS,2004.0,3,2,1
KEN,ESP,2019.0,3,1,2
KAZ,GBR,2019.0,6,10,-4
CHN,IND,2024.0,5,1,4
GTM,CAN,2022.0,1,1,0
SWE,ESP,2017.0,43,95,-52
CMR,GBR,2013.0,3,4,-1
ISR,CHL,2022.0,2,3,-1
TWN,THA,2008.0,1,3,-2
CHN,CZE,2009.0,3,2,1
IRN,OMN,2018.0,3,1,2
GHA,CHE,2019.0,4,2,2
ARE,LBN,2013.0,2,3,-1
USA,LVA,2015.0,10,4,6
EGY,KOR,2016.0,5,5,0
DEU,CYP,2017.0,3,8,-5
TUR,ESP,2018.0,14,11,3
CUB,CAN,2021.0,9,2,7
PHL,FRA,2023.0,5,3,2
NZL,IRN,2023.0,3,5,-2
SRB,DEU,2015.0,14,15,-1
OMN,GBR,2013.0,5,16,-11
CAN,DZA,2014.0,8,5,3
TUR,NOR,2019.0,5,3,2
SVK,NLD,2002.0,7,4,3
DEU,GEO,2017.0,6,7,-1
RUS,SAU,2020.0,5,3,2
IND,LKA,2016.0,6,2,4
CAN,NPL,2017.0,2,2,0
BRA,TUR,2021.0,2,3,-1
NGA,FRA,2020.0,11,3,8
CUB,ITA,2006.0,3,1,2
JPN,CZE,2019.0,9,8,1
MMR,JPN,2022.0,6,8,-2
CAN,LBY,2020.0,6,2,4
SWE,SRB,2017.0,2,2,0
AUT,PRT,2018.0,4,4,0
ESP,POL,2012.0,19,19,0
TWN,ITA,2023.0,4,1,3
THA,VNM,2015.0,16,6,10
IND,THA,2024.0,1,1,0
CZE,IRL,2022.0,7,4,3
TUN,USA,2014.0,10,11,-1
GBR,KAZ,2021.0,10,11,-1
KOR,MYS,2019.0,13,13,0
SEN,BFA,2020.0,6,4,2
GBR,PAN,2020.0,4,3,1
SAU,KOR,2011.0,3,20,-17
ETH,MDG,2019.0,1,1,0
GRC,CHN,2023.0,10,10,0
CAN,IRL,2010.0,36,31,5
FRA,SVN,2008.0,3,4,-1
PRT,IRL,2003.0,2,3,-1
EGY,KWT,2019.0,26,11,15
SDN,YEM,2020.0,1,1,0
TUR,CHE,2023.0,16,4,12
SWE,MKD,2019.0,1,2,-1
KOR,AUS,2016.0,58,32,26
IRQ,GBR,2018.0,22,151,-129
BGD,SAU,2014.0,4,2,2
HND,USA,2019.0,4,8,-4
GHA,FIN,2019.0,3,2,1
POL,AUT,2023.0,8,5,3
NZL,FIN,2019.0,2,5,-3
SRB,AUT,2020.0,8,6,2
EGY,RUS,2023.0,5,15,-10
PRT,AGO,2022.0,3,6,-3
BEL,KHM,2012.0,1,1,0
MDG,FRA,2021.0,9,14,-5
TWN,IDN,2011.0,7,5,2
CYM,USA,2020.0,3,1,2
CHL,KOR,2016.0,3,1,2
KHM,GBR,2021.0,8,7,1
MYS,JPN,2022.0,16,32,-16
RUS,AZE,2023.0,4,1,3
THA,BGD,2021.0,4,6,-2
GHA,TUR,2022.0,2,2,0
SVK,IRL,2021.0,3,1,2
RUS,ESP,2021.0,12,18,-6
EGY,AUS,2019.0,14,14,0
KAZ,AUS,2023.0,1,1,0
DNK,PAK,2021.0,7,5,2
FRA,MCO,2018.0,16,7,9
MEX,CUB,2001.0,15,12,3
SYR,FRA,2005.0,2,5,-3
IRL,DEU,2006.0,14,38,-24
AUT,MEX,2022.0,5,5,0
TUR,FRA,2007.0,7,21,-14
ZAF,AUS,2012.0,44,24,20
BEL,COD,2014.0,6,3,3
BGR,USA,2005.0,19,14,5
ITA,ZAF,2006.0,3,7,-4
ITA,NGA,2012.0,7,3,4
DNK,AUT,2006.0,5,4,1
CHL,ARG,1997.0,4,2,2
POL,SWE,2003.0,18,13,5
GRC,ZAF,2010.0,3,1,2
CHE,HKG,2015.0,8,7,1
ESP,CHE,2004.0,19,43,-24
RUS,TZA,2020.0,1,1,0
POL,CZE,2001.0,5,6,-1
ZAF,NAM,2014.0,7,6,1
AUT,SVK,2010.0,6,9,-3
USA,PSE,2002.0,2,5,-3
ETH,KEN,2008.0,2,2,0
PAK,JPN,2004.0,5,5,0
COD,BEL,2002.0,1,1,0
LTU,USA,2003.0,5,12,-7
USA,MOZ,2015.0,15,10,5
ARG,DZA,2014.0,3,1,2
GAB,USA,2014.0,2,5,-3
POL,IND,2003.0,3,2,1
DEU,SRB,2018.0,5,15,-10
CHN,AUT,1997.0,6,3,3
DEU,EST,2005.0,4,3,1
AUT,BRA,2009.0,6,3,3
ISR,DEU,2008.0,32,29,3
JPN,LKA,2003.0,9,5,4
NLD,TUR,2008.0,5,20,-15
FRA,SAU,2009.0,9,2,7
KEN,AUT,2019.0,2,2,0
FRA,PRI,2014.0,2,1,1
COL,CAN,2000.0,3,4,-1
THA,CHE,2013.0,5,4,1
NLD,POL,1998.0,6,10,-4
AUS,BWA,2016.0,7,3,4
GBR,LTU,2004.0,2,4,-2
UGA,NOR,2004.0,2,1,1
SGP,POL,2016.0,4,2,2
CHE,TUR,2005.0,8,6,2
CAN,EST,2017.0,1,2,-1
TZA,ZAF,2000.0,7,1,6
GBR,KWT,2011.0,10,7,3
CHE,SWZ,1999.0,1,2,-1
SVN,POL,2012.0,4,3,1
IRN,NOR,2011.0,6,4,2
PYF,NCL,2006.0,2,2,0
ARE,HUN,2020.0,2,2,0
HUN,ARE,2021.0,5,1,4
MYS,AUS,2001.0,13,8,5
DEU,ARE,2010.0,6,2,4
RUS,KGZ,2015.0,5,4,1
POL,SVK,1998.0,5,4,1
VNM,CAN,2006.0,2,1,1
CAN,VNM,2007.0,2,3,-1
RUS,MDA,2004.0,2,4,-2
FIN,GRC,2011.0,3,2,1
NLD,LBN,2015.0,1,3,-2
CHE,RUS,2005.0,12,25,-13
ISR,NOR,2002.0,4,2,2
JPN,KEN,2000.0,7,1,6
GMB,GBR,2011.0,9,5,4
GBR,SRB,2008.0,17,6,11
HKG,SAU,2018.0,6,6,0
USA,IDN,2006.0,26,16,10
POL,CHN,2002.0,1,1,0
USA,TZA,2007.0,7,5,2
GLP,FRA,2003.0,16,29,-13
SVN,HRV,2011.0,6,11,-5
CMR,NGA,1998.0,3,2,1
RUS,DNK,2007.0,10,3,7
THA,SWE,2006.0,6,4,2
SGP,DEU,2009.0,24,30,-6
KWT,TUR,2019.0,1,9,-8
MEX,CRI,2008.0,4,2,2
GBR,IDN,2001.0,5,5,0
GBR,AZE,2006.0,1,1,0
FRA,MRT,2005.0,3,1,2
ARG,GBR,2006.0,13,15,-2
NZL,FRA,2007.0,9,12,-3
JPN,ESP,2009.0,23,16,7
JPN,IRN,2006.0,13,5,8
DZA,SAU,2013.0,6,5,1
GBR,EST,2005.0,7,2,5
PRT,CHN,1999.0,2,6,-4
USA,MAR,1997.0,2,4,-2
AUT,SVK,2006.0,7,7,0
AZE,RUS,2009.0,2,5,-3
GEO,ARE,2018.0,1,1,0
IRN,BEL,2013.0,17,5,12
UKR,ISR,2018.0,5,3,2
ARE,SGP,2010.0,1,6,-5
DEU,GHA,2010.0,5,1,4
TWN,BEL,2009.0,2,1,1
BEL,TWN,2010.0,2,1,1
CHN,NGA,2011.0,4,6,-2
GBR,CHL,2006.0,10,12,-2
DEU,GHA,2006.0,4,1,3
CMR,ITA,2014.0,2,4,-2
POL,BRA,2011.0,4,1,3
DNK,BGR,2008.0,2,1,1
SVN,FRA,2008.0,4,3,1
SVK,SWE,2007.0,3,1,2
ISL,SWE,2006.0,17,11,6
MEX,CZE,2018.0,4,2,2
VEN,DEU,2008.0,4,5,-1
GRC,ITA,2022.0,22,25,-3
MYS,THA,2015.0,9,4,5
MNG,RUS,2007.0,3,1,2
RUS,MNG,2010.0,3,2,1
CZE,HUN,2008.0,2,5,-3
THA,NPL,2012.0,2,3,-1
BEL,AUT,2008.0,8,5,3
ESP,UKR,2006.0,4,3,1
DEU,PHL,2008.0,5,5,0
BGD,BEL,2012.0,5,2,3
MKD,FRA,2009.0,2,1,1
ITA,ARG,2009.0,18,13,5
OMN,EGY,2008.0,3,5,-2
IND,CHN,2005.0,14,3,11
FRA,SEN,2009.0,25,40,-15
ZAF,FRA,2014.0,17,29,-12
CHL,CAN,2002.0,4,8,-4
DEU,EGY,2000.0,16,18,-2
GBR,GMB,2005.0,6,8,-2
USA,GUM,2007.0,2,6,-4
BLR,GBR,1999.0,4,3,1
GHA,NGA,2013.0,2,5,-3
UKR,SWE,2010.0,5,2,3
JPN,MNG,2006.0,2,3,-1
TUR,KGZ,2015.0,5,2,3
USA,MAC,2013.0,10,3,7
USA,ZMB,2021.0,18,14,4
DEU,GAB,2006.0,2,2,0
AUS,HRV,2013.0,2,1,1
ARE,GBR,2006.0,7,11,-4
ETH,DEU,2011.0,7,9,-2
CHN,IND,2006.0,5,20,-15
IRN,FRA,2002.0,4,9,-5
ZAF,MYS,2011.0,3,1,2
EGY,OMN,2012.0,6,3,3
SWZ,ZAF,2008.0,2,2,0
BWA,KEN,2007.0,1,1,0
FIN,CZE,2009.0,3,1,2
ZAF,JPN,2011.0,3,2,1
SWE,KOR,2010.0,3,2,1
HTI,USA,2017.0,8,16,-8
TWN,BEL,2011.0,3,2,1
PAK,ARE,1999.0,1,1,0
USA,PSE,2005.0,4,2,2
CAN,MUS,2019.0,1,1,0
KAZ,USA,2004.0,1,4,-3
QAT,SGP,2023.0,2,2,0
DEU,ETH,2009.0,5,7,-2
CMR,CHE,2012.0,1,2,-1
ALB,TUR,2011.0,2,1,1
PRT,NLD,2003.0,9,14,-5
MNE,SRB,2006.0,11,14,-3
NLD,ROU,2007.0,7,1,6
ECU,AUS,2010.0,1,1,0
LVA,SWE,2006.0,4,7,-3
SWE,LVA,2008.0,5,2,3
CHN,PHL,2006.0,3,5,-2
ECU,USA,2013.0,13,18,-5
MYS,KOR,2008.0,4,2,2
PAK,MYS,2004.0,2,4,-2
UKR,CZE,1999.0,2,3,-1
ITA,HUN,2010.0,12,14,-2
JPN,HKG,2010.0,7,10,-3
GBR,GMB,2002.0,13,10,3
DNK,IND,2018.0,15,21,-6
LKA,GBR,2005.0,8,15,-7
FRA,GLP,2001.0,10,20,-10
DEU,BEN,2018.0,5,1,4
BGR,CHE,2015.0,6,5,1
CHE,BGR,2018.0,4,3,1
DEU,CUB,2000.0,8,4,4
CHE,ZAF,2008.0,4,7,-3
NGA,NLD,2020.0,5,4,1
CRI,NLD,2021.0,3,2,1
GHA,GBR,2010.0,11,22,-11
IRN,IRQ,2009.0,1,2,-1
IRQ,IRN,2011.0,5,2,3
ARE,ESP,2017.0,4,10,-6
PAK,ITA,2009.0,2,1,1
HUN,DNK,2015.0,2,2,0
VEN,ARG,2019.0,8,3,5
ROU,AUS,2010.0,2,2,0
MYS,IRQ,2011.0,17,4,13
USA,GMB,2010.0,2,1,1
SDN,JPN,2008.0,4,4,0
FRA,TGO,2005.0,4,1,3
PAK,CHN,2008.0,9,16,-7
EST,BRA,2020.0,1,5,-4
DEU,PHL,2014.0,5,4,1
UGA,RWA,2016.0,3,1,2
NGA,TTO,2010.0,1,1,0
HKG,DNK,2021.0,6,2,4
CAN,HRV,2014.0,4,1,3
BGR,BEL,2011.0,3,12,-9
THA,DEU,2023.0,8,10,-2
DEU,BGR,2017.0,13,13,0
ESP,ISR,2014.0,12,13,-1
SGP,IRL,2010.0,3,9,-6
CZE,ZAF,2017.0,1,2,-1
NOR,EST,2016.0,2,2,0
MYS,SWE,2015.0,8,4,4
MEX,MAR,2020.0,1,2,-1
BEL,MEX,2013.0,5,5,0
MEX,BEL,2019.0,6,6,0
RWA,USA,2017.0,18,23,-5
ZAF,CAN,2014.0,15,22,-7
BRA,FIN,2019.0,18,8,10
IND,ESP,2003.0,4,10,-6
AUS,PAK,2014.0,25,37,-12
IRN,DEU,2007.0,22,13,9
PRI,SWE,2009.0,1,1,0
MEX,BRA,2007.0,8,13,-5
KOR,HKG,2013.0,9,8,1
HUN,ISR,2015.0,2,5,-3
AUT,KOR,2007.0,1,3,-2
ETH,CAN,2015.0,3,2,1
EGY,FRA,2023.0,7,9,-2
LUX,FRA,2011.0,15,23,-8
AUT,DNK,2016.0,11,11,0
HRV,FRA,2018.0,4,10,-6
ERI,IND,2009.0,3,2,1
JPN,TUN,2015.0,6,1,5
MEX,NZL,2010.0,3,1,2
NER,FRA,2020.0,2,6,-4
MYS,NZL,2019.0,20,20,0
GRC,NOR,2022.0,4,2,2
FRA,MTQ,2017.0,17,23,-6
SWE,PRT,2014.0,9,16,-7
CUB,AUT,2014.0,1,1,0
FRA,KWT,2020.0,8,1,7
VNM,SWE,2010.0,4,5,-1
GBR,ZWE,2013.0,10,7,3
MYS,EGY,2011.0,5,5,0
SGP,FRA,2023.0,14,10,4
PAK,MYS,2008.0,8,3,5
AUT,UKR,2021.0,4,4,0
POL,NLD,2023.0,11,13,-2
BRA,CHN,2013.0,5,7,-2
UGA,USA,2012.0,19,32,-13
SAU,FIN,2014.0,3,2,1
FRA,TWN,2014.0,12,16,-4
LBY,CAN,2017.0,1,1,0
IND,POL,2016.0,13,6,7
NLD,KOR,2014.0,7,7,0
POL,JPN,2007.0,8,10,-2
NLD,ISR,2015.0,15,9,6
PHL,GBR,2018.0,5,5,0
MDV,GBR,2022.0,3,1,2
SWE,SRB,2016.0,2,6,-4
PER,BRA,2012.0,13,6,7
ISL,NOR,2013.0,6,3,3
FRA,PAK,2010.0,11,8,3
AUS,TWN,2016.0,16,21,-5
GBR,MDV,2018.0,3,2,1
FRA,BFA,2020.0,15,8,7
COL,VEN,2008.0,5,7,-2
EGY,IRQ,2013.0,2,1,1
USA,BWA,2016.0,11,7,4
HRV,CHE,2016.0,5,6,-1
IDN,HKG,2021.0,3,2,1
HND,BRA,2021.0,1,3,-2
GRC,THA,2017.0,2,1,1
FRA,DJI,2014.0,5,3,2
GBR,ETH,2020.0,10,10,0
NOR,ESP,2016.0,8,32,-24
SVN,FRA,2014.0,4,5,-1
SAU,OMN,2013.0,3,2,1
URY,ARG,2017.0,10,11,-1
HTI,USA,2018.0,16,11,5
HTI,USA,2022.0,3,3,0
SVK,DEU,2020.0,8,11,-3
RUS,BEL,2014.0,13,10,3
KOR,ITA,2018.0,11,6,5
POL,MEX,2010.0,2,2,0
FRA,PER,2018.0,14,13,1
HKG,ISR,2018.0,1,1,0
POL,DNK,2015.0,9,6,3
ECU,GBR,2017.0,6,9,-3
TUN,CAN,2010.0,5,9,-4
CUB,MEX,2013.0,14,7,7
DNK,BEL,2018.0,9,16,-7
UZB,KOR,2022.0,3,12,-9
IRQ,IRN,2019.0,9,28,-19
FRA,PER,2016.0,9,1,8
DOM,ESP,2023.0,5,2,3
MAR,ZAF,2019.0,1,2,-1
AUS,SRB,2001.0,2,3,-1
MMR,JPN,2017.0,6,10,-4
AUS,COL,2021.0,6,13,-7
SWZ,CHE,2018.0,8,7,1
EGY,KOR,2022.0,9,8,1
BOL,BEL,2023.0,1,1,0
ROU,SWE,2020.0,1,1,0
CZE,AUT,2020.0,24,18,6
IRL,FRA,2018.0,17,33,-16
HKG,SAU,2022.0,3,5,-2
JPN,KEN,2023.0,6,7,-1
ESP,PAN,2016.0,8,3,5
NOR,PRT,2023.0,6,3,3
POL,AUT,2006.0,6,6,0
NLD,QAT,2023.0,2,2,0
BWA,ETH,2016.0,1,1,0
GBR,SYC,2021.0,3,2,1
THA,PAK,2013.0,20,4,16
JPN,LAO,2020.0,4,2,2
PRT,CHE,2011.0,11,11,0
IRL,FRA,2017.0,24,37,-13
UGA,RWA,2017.0,3,5,-2
USA,LUX,2019.0,13,6,7
PHL,GBR,2016.0,3,3,0
CUB,ESP,2017.0,18,20,-2
LTU,DNK,1998.0,2,2,0
DNK,RUS,2014.0,5,5,0
RUS,JPN,2016.0,8,21,-13
NLD,TUN,2019.0,3,1,2
DZA,PRT,2017.0,3,5,-2
SEN,MLI,2020.0,4,4,0
CMR,ZAF,2020.0,6,17,-11
GBR,URY,2002.0,3,1,2
DEU,CRI,2022.0,5,7,-2
CHE,HUN,1998.0,6,7,-1
AZE,EGY,2016.0,1,2,-1
AUS,QAT,2023.0,8,1,7
GBR,FLK,2019.0,2,3,-1
ECU,NLD,2019.0,3,8,-5
COD,ZAF,2021.0,2,5,-3
ECU,BEL,2022.0,5,4,1
KOR,IRL,2021.0,5,3,2
RUS,POL,2021.0,26,12,14
LTU,BEL,2020.0,3,2,1
VNM,ESP,2021.0,2,3,-1
OMN,NLD,2021.0,2,1,1
LVA,DEU,2020.0,5,3,2
NLD,NZL,2021.0,15,18,-3
BRA,LUX,2022.0,2,2,0
GBR,SRB,2014.0,11,5,6
PER,CAN,2017.0,5,3,2
THA,SWE,2023.0,3,5,-2
JAM,TTO,2010.0,10,8,2
BWA,ZAF,2022.0,6,13,-7
GHA,NLD,2022.0,2,7,-5
OMN,ARE,2022.0,4,6,-2
USA,HRV,2008.0,16,12,4
CMR,KEN,2021.0,3,1,2
ARG,MEX,2011.0,9,11,-2
NPL,GBR,2003.0,3,3,0
MAR,CHN,2019.0,41,3,38
MEX,JPN,2014.0,8,8,0
HUN,KAZ,2019.0,1,2,-1
BEL,GHA,2021.0,1,5,-4
KOR,PRK,2020.0,8,3,5
CHN,MNG,2019.0,18,3,15
MEX,URY,2020.0,3,1,2
AUT,PRT,2022.0,15,10,5
FRA,MDG,2023.0,3,1,2
SRB,SVN,2020.0,9,4,5
HUN,IRL,2023.0,3,1,2
IDN,POL,2020.0,3,1,2
QAT,PAK,2022.0,5,19,-14
PAK,DNK,2022.0,2,5,-3
AUS,NGA,2019.0,5,11,-6
RUS,IRL,2022.0,16,1,15
MMR,USA,2022.0,7,7,0
NLD,IND,2022.0,23,50,-27
UZB,ITA,2023.0,1,1,0
BEL,NZL,2020.0,2,5,-3
IRL,CHL,2022.0,3,4,-1
BEN,ZAF,2022.0,2,1,1
ARG,IRL,2022.0,3,1,2
FRA,IRQ,2022.0,5,4,1
SVK,HUN,2016.0,8,12,-4
DNK,DZA,2022.0,1,1,0
HUN,ESP,2023.0,6,3,3
HKG,IRN,2022.0,2,8,-6
PAK,IRQ,2022.0,1,4,-3
DEU,NAM,2022.0,1,2,-1
TUR,SWE,2023.0,17,4,13
VNM,THA,2023.0,7,13,-6
ATG,USA,2023.0,1,2,-1
PAK,BRA,2020.0,5,11,-6
EGY,IRL,2013.0,2,1,1
DEU,HKG,2014.0,11,10,1
CAN,KEN,2015.0,9,13,-4
AUT,HUN,1999.0,6,7,-1
GRC,SWE,2015.0,20,9,11
JOR,GBR,2009.0,7,14,-7
BEL,NGA,2014.0,3,3,0
GRC,IRL,2007.0,5,1,4
IRN,BRA,2012.0,5,1,4
COL,PRT,2013.0,4,1,3
AUS,KWT,2017.0,5,1,4
USA,SRB,2015.0,25,19,6
TUR,CHE,2006.0,6,9,-3
BEL,VNM,2013.0,6,6,0
DNK,MYS,2011.0,3,3,0
EGY,SDN,2014.0,5,2,3
GBR,LBY,2009.0,5,1,4
EST,FIN,2010.0,3,7,-4
TUR,SWE,2010.0,3,2,1
MYS,PAK,2010.0,6,15,-9
PAK,AUS,2011.0,23,11,12
LTU,NLD,2011.0,4,1,3
ISL,GBR,2014.0,5,10,-5
USA,MAC,2020.0,11,13,-2
PAK,IRL,2020.0,10,8,2
BRA,SVN,2021.0,2,1,1
JPN,NGA,2014.0,9,5,4
DNK,GRC,1997.0,4,2,2
IRL,FIN,2013.0,9,2,7
GBR,TWN,1997.0,19,7,12
BLR,RUS,2009.0,18,21,-3
FRA,CIV,2015.0,39,26,13
LBY,MYS,2022.0,2,12,-10
KEN,FRA,2022.0,5,3,2
BGD,IND,2008.0,14,15,-1
FIN,JPN,2015.0,11,15,-4
THA,VNM,2012.0,5,2,3
PHL,GBR,2006.0,7,4,3
AUS,MYS,2010.0,46,52,-6
SWE,RUS,2012.0,12,28,-16
USA,IRQ,2006.0,3,2,1
JOR,MYS,2010.0,2,11,-9
MEX,CHN,1999.0,5,1,4
HKG,THA,2019.0,5,6,-1
AUS,PRT,2007.0,3,1,2
PHL,DEU,2010.0,6,4,2
NLD,ROU,2013.0,5,8,-3
JPN,VNM,2009.0,27,9,18
ARE,EGY,2002.0,10,13,-3
JPN,MNG,2016.0,11,5,6
SWE,AUT,2009.0,15,12,3
USA,SVN,2016.0,14,23,-9
HKG,GBR,2008.0,39,39,0
BHR,IND,2006.0,1,3,-2
MNG,DEU,2020.0,2,2,0
KNA,USA,2017.0,7,5,2
SWE,MEX,2008.0,5,1,4
MLI,FRA,2019.0,9,23,-14
GRC,FRA,2023.0,13,14,-1
MYS,HKG,2017.0,2,5,-3
CAN,PRT,2011.0,11,6,5
MLI,FRA,2021.0,5,11,-6
TWN,HKG,2014.0,13,9,4
PER,ESP,2020.0,22,37,-15
ARE,YEM,2013.0,1,1,0
CAN,HRV,2002.0,2,1,1
SRB,MKD,2018.0,11,8,3
ESP,ISR,2002.0,3,8,-5
FIN,ARE,2016.0,4,1,3
SEN,USA,2008.0,3,2,1
CHE,KEN,2002.0,4,1,3
HUN,ITA,2007.0,7,7,0
JPN,ZAF,2008.0,2,2,0
DEU,SVK,2016.0,8,11,-3
MMR,AUS,2020.0,3,3,0
FJI,AUS,2015.0,10,13,-3
KEN,ETH,2008.0,2,2,0
JOR,ITA,2021.0,3,5,-2
NLD,LUX,2018.0,5,7,-2
LBN,SAU,2016.0,7,6,1
FRA,HRV,1998.0,3,1,2
USA,TTO,1998.0,2,5,-3
IND,EGY,2017.0,2,2,0
SVK,CZE,2010.0,49,41,8
FRA,MRT,2014.0,2,1,1
KEN,COL,2020.0,2,1,1
DEU,THA,2014.0,26,24,2
CAN,KEN,2005.0,2,4,-2
MLI,FRA,2011.0,5,7,-2
MEX,AUS,2000.0,2,2,0
PRT,CUB,2010.0,3,2,1
BLR,DEU,2010.0,13,3,10
FRA,LUX,2010.0,33,14,19
KOR,PHL,2014.0,9,6,3
NLD,SGP,2007.0,5,8,-3
PRY,USA,2011.0,2,5,-3
NZL,SWE,2013.0,18,8,10
HUN,BEL,2009.0,8,3,5
SGP,PHL,2017.0,6,8,-2
NLD,THA,2018.0,12,6,6
CZE,TWN,2023.0,2,1,1
SWE,AUT,2019.0,18,35,-17
BEL,COG,2014.0,9,6,3
GRC,DNK,2016.0,11,3,8
SAU,PAK,2002.0,3,12,-9
DEU,SDN,2009.0,7,1,6
GRC,EGY,2017.0,1,2,-1
USA,CAF,2001.0,1,1,0
SGP,AUT,2010.0,2,5,-3
ETH,BEL,2011.0,3,2,1
ITA,ZAF,2017.0,9,9,0
EST,ESP,2017.0,2,4,-2
TWN,PHL,2018.0,5,7,-2
CHE,TUR,2015.0,15,14,1
FRA,SYR,2016.0,10,2,8
MNE,SRB,2017.0,13,17,-4
LKA,CAN,2012.0,2,2,0
RUS,SRB,2016.0,7,3,4
NLD,THA,2016.0,12,6,6
CAN,SGP,2020.0,26,36,-10
AUT,NLD,1997.0,6,8,-2
HKG,ZAF,2014.0,1,1,0
THA,KHM,2020.0,3,7,-4
COL,FRA,2010.0,13,20,-7
ARE,CAN,2015.0,8,28,-20
KOR,NZL,2016.0,6,7,-1
NLD,IRN,2020.0,26,62,-36
PNG,AUS,2015.0,9,4,5
THA,KOR,2013.0,8,7,1
KOR,ARG,2021.0,1,2,-1
JPN,OMN,2023.0,1,1,0
JPN,GRC,2019.0,3,2,1
COL,ARG,2020.0,19,24,-5
NLD,KEN,2023.0,10,6,4
MCO,FRA,2023.0,7,5,2
IDN,NOR,2020.0,2,2,0
MNE,SRB,2016.0,8,15,-7
CAN,TUR,2006.0,13,11,2
IND,BGD,1997.0,4,3,1
LBN,CHE,2019.0,3,3,0
IND,KHM,2018.0,2,2,0
EGY,RUS,2018.0,8,4,4
CHN,TZA,2021.0,18,5,13
GRC,KOR,2015.0,3,2,1
CHL,JPN,2020.0,6,2,4
CHN,FJI,2019.0,2,1,1
KOR,BRA,2017.0,7,1,6
AUS,SLB,2017.0,3,2,1
ESP,CUB,2017.0,20,18,2
EGY,DZA,2021.0,4,1,3
NCL,GBR,2018.0,1,1,0
CYP,ARE,2020.0,2,2,0
CHE,ARG,2021.0,8,15,-7
NZL,ESP,2020.0,5,8,-3
PAK,CZE,2018.0,2,4,-2
NGA,TUR,2022.0,3,7,-4
UKR,ROU,2022.0,3,1,2
GBR,LBN,2017.0,9,14,-5
ARE,AUS,2001.0,3,4,-1
BGR,USA,2014.0,15,9,6
CAN,ETH,2019.0,3,4,-1
LBN,GBR,2007.0,4,5,-1
MKD,USA,2004.0,3,3,0
ZMB,GBR,2004.0,1,3,-2
BGD,MYS,2010.0,17,6,11
LVA,LTU,2020.0,3,1,2
ROU,CAN,2004.0,6,2,4
SRB,NOR,2010.0,4,6,-2
ARG,ISR,1998.0,4,1,3
CAN,KEN,2002.0,3,6,-3
ROU,CAN,2001.0,13,2,11
GRC,JPN,2005.0,5,3,2
GBR,BGD,2008.0,8,13,-5
SWE,TZA,2004.0,2,3,-1
CZE,CHE,2001.0,10,8,2
CZE,SWE,2009.0,9,10,-1
THA,ITA,2005.0,1,1,0
BFA,CAN,2012.0,1,1,0
USA,QAT,2010.0,22,10,12
NOR,CHE,2011.0,13,8,5
NLD,EGY,2009.0,1,2,-1
FIN,HUN,2007.0,4,3,1
BRA,SWE,2006.0,8,7,1
CZE,FIN,2005.0,5,3,2
CHE,LUX,2022.0,8,3,5
NAM,ZAF,2008.0,1,2,-1
TZA,NGA,2015.0,3,1,2
JPN,NPL,2010.0,6,2,4
COG,BFA,2018.0,1,3,-2
SWE,IRL,2003.0,3,7,-4
ESP,SAU,2016.0,16,2,14
IRL,NZL,2003.0,5,2,3
PHL,NGA,2021.0,1,3,-2
USA,NAM,2019.0,5,5,0
CHN,LKA,2012.0,2,1,1
ESP,SAU,2017.0,7,4,3
SWE,PRI,2008.0,1,1,0
ZAF,SWZ,2009.0,2,4,-2
NZL,BEL,2019.0,7,3,4
GHA,AUS,2013.0,3,2,1
CHE,PRT,2011.0,11,11,0
POL,ESP,2019.0,25,27,-2
NPL,IND,2000.0,10,5,5
BRA,HND,2023.0,1,1,0
TUN,USA,2012.0,6,11,-5
IRL,MWI,2015.0,2,1,1
CAN,KHM,2019.0,1,2,-1
UKR,SWE,2018.0,9,6,3
CHN,MMR,2022.0,4,2,2
IND,PHL,2020.0,4,9,-5
PAK,SWE,2022.0,9,7,2
GHA,ITA,2019.0,2,3,-1
MEX,FRA,2024.0,1,1,0
USA,ASM,2019.0,4,2,2
PRK,KOR,2019.0,5,4,1
ITA,BIH,2023.0,1,1,0
BGR,ROU,2022.0,2,2,0
USA,JAM,2000.0,5,10,-5
SVN,ITA,1999.0,6,1,5
BRA,NOR,2014.0,10,2,8
OMN,CHE,2006.0,1,1,0
KOR,IND,1999.0,6,6,0
HRV,SRB,2004.0,5,7,-2
UZB,BEL,2010.0,1,1,0
USA,MCO,2011.0,2,1,1
MCO,USA,2012.0,1,1,0
FRA,NOR,1997.0,11,11,0
PRT,SWE,2001.0,4,6,-2
FRA,KHM,2018.0,11,6,5
IRL,IND,2004.0,2,6,-4
LTU,GBR,2000.0,4,4,0
ARG,CHL,2013.0,17,18,-1
USA,BFA,2020.0,4,3,1
SWE,ARE,2007.0,3,1,2
SAU,GBR,2010.0,26,75,-49
GRC,BGR,2000.0,11,1,10
BGR,GRC,2002.0,6,3,3
GBR,FJI,2021.0,2,2,0
SAU,OMN,2018.0,12,2,10
RUS,NZL,2010.0,3,1,2
RUS,MEX,2017.0,6,6,0
USA,URY,2018.0,11,14,-3
IRL,CHE,2002.0,7,6,1
NLD,LTU,2019.0,4,1,3
BGD,FRA,2011.0,3,1,2
CHN,IRL,2017.0,14,26,-12
DEU,KGZ,2021.0,4,4,0
CHE,CYP,2022.0,4,2,2
THA,OMN,2016.0,2,1,1
CRI,DEU,2010.0,4,2,2
CHN,PHL,2020.0,7,8,-1
NLD,CHN,2000.0,15,14,1
ITA,CHN,2008.0,18,16,2
DNK,GRL,2021.0,12,6,6
HKG,KOR,2014.0,13,7,6
USA,SYR,2014.0,2,5,-3
TWN,SGP,2014.0,19,16,3
MAC,CHN,2017.0,69,77,-8
BGD,KOR,2008.0,10,7,3
IRN,RUS,2015.0,7,3,4
RUS,IRN,2017.0,5,4,1
JPN,MWI,2020.0,3,1,2
KWT,CAN,2014.0,2,16,-14
LUX,IRL,2023.0,2,1,1
PRT,DNK,2015.0,20,6,14
BEL,ISR,2023.0,1,3,-2
CMR,FRA,2014.0,14,28,-14
BEL,MEX,2016.0,9,7,2
TTO,GBR,2003.0,4,8,-4
HKG,FRA,2018.0,8,10,-2
PER,VEN,2008.0,1,2,-1
ITA,DNK,2013.0,43,22,21
ZAF,ITA,2018.0,10,7,3
PRT,CZE,2015.0,6,3,3
ISR,GRC,2015.0,1,2,-1
USA,COG,2014.0,13,3,10
DEU,BGD,2021.0,12,15,-3
IND,AUT,2013.0,11,5,6
IRN,BEL,2018.0,22,16,6
CZE,CHE,2019.0,23,21,2
SWE,NIC,2010.0,2,1,1
THA,IDN,2017.0,7,3,4
GHA,USA,2014.0,17,21,-4
CUB,BEL,2016.0,8,1,7
ITA,UGA,2015.0,2,1,1
CHE,TUR,2019.0,16,29,-13
TUR,AUS,2015.0,8,15,-7
JPN,DNK,2014.0,7,5,2
ITA,NZL,2014.0,8,4,4
CAN,EGY,1997.0,7,4,3
AUS,IRN,1997.0,5,5,0
IRL,DNK,2008.0,5,7,-2
AUT,FIN,2022.0,10,2,8
PAK,SAU,2011.0,35,18,17
CHN,ETH,2018.0,9,13,-4
USA,RWA,2015.0,7,19,-12
GBR,UGA,2005.0,6,14,-8
JOR,PSE,2021.0,10,3,7
IND,THA,1999.0,1,2,-1
VEN,CHL,2017.0,14,2,12
NZL,FRA,2010.0,13,13,0
CAN,AUT,2000.0,10,6,4
USA,SLE,2011.0,3,2,1
CZE,JPN,2018.0,8,13,-5
UGA,DEU,2019.0,3,2,1
EGY,HKG,2007.0,1,1,0
ARE,OMN,2022.0,6,4,2
GBR,ISL,2017.0,9,6,3
PRT,DNK,2014.0,9,3,6
AUS,LUX,2017.0,3,1,2
TUR,PSE,2018.0,3,1,2
PAK,NOR,2016.0,5,4,1
ISR,TUR,2018.0,5,3,2
ISR,DNK,2016.0,3,3,0
VNM,ITA,2015.0,2,5,-3
SRB,SVN,2023.0,5,2,3
SRB,ITA,2015.0,7,5,2
AUT,GRC,2022.0,8,5,3
AUS,MEX,2017.0,13,8,5
ARE,FRA,2020.0,8,19,-11
BEL,ARE,2022.0,4,2,2
ROU,USA,2020.0,25,30,-5
LKA,USA,2017.0,18,30,-12
NZL,DNK,2019.0,6,5,1
JPN,TZA,2017.0,1,2,-1
ISL,USA,2023.0,14,5,9
SWE,KOR,1999.0,5,9,-4
ISR,KOR,2022.0,3,6,-3
COL,URY,2021.0,3,1,2
GEO,GBR,2021.0,1,2,-1
TUR,PSE,2017.0,8,1,7
JPN,ISR,2019.0,10,7,3
SEN,USA,2021.0,6,7,-1
VNM,SAU,2019.0,1,1,0
CYM,GBR,2023.0,1,1,0
PAK,DEU,2012.0,15,38,-23
MAR,ESP,2017.0,7,19,-12
CHE,ZWE,2007.0,1,3,-2
BFA,FRA,2014.0,16,20,-4
CHL,SWE,2021.0,6,1,5
CHL,ITA,2018.0,12,25,-13
FRA,REU,2016.0,25,39,-14
FRA,KAZ,2019.0,5,1,4
CYP,AUS,2015.0,2,2,0
CAN,MYS,2015.0,23,22,1
TWN,DEU,2016.0,24,25,-1
TWN,DEU,2022.0,24,21,3
IND,NOR,2015.0,13,5,8
AUT,PRT,2013.0,4,1,3
UGA,TZA,2016.0,3,1,2
RUS,TJK,2018.0,7,2,5
SWE,QAT,2014.0,1,1,0
CIV,USA,2017.0,5,6,-1
HKG,MAC,2016.0,15,7,8
VEN,CHL,2016.0,15,1,14
AUS,ZAF,2019.0,30,58,-28
SLE,USA,2016.0,6,5,1
ZAF,CZE,2021.0,7,1,6
POL,CHN,2019.0,13,14,-1
CHN,MAC,2009.0,21,12,9
DEU,SGP,2016.0,42,43,-1
ITA,SVK,2021.0,6,7,-1
AUS,QAT,2020.0,11,10,1
JPN,ZAF,2019.0,4,3,1
ESP,NIC,2009.0,1,1,0
BLR,POL,2000.0,3,3,0
IRQ,TWN,2019.0,1,1,0
RUS,FIN,2006.0,12,21,-9
DEU,NPL,2015.0,5,1,4
USA,NPL,2023.0,10,33,-23
ZAF,AUS,2009.0,31,12,19
CHE,SEN,2016.0,1,1,0
NZL,IND,2015.0,8,12,-4
FRA,ISR,2015.0,35,21,14
ZAF,SEN,2018.0,5,1,4
ZAF,ETH,2018.0,17,9,8
CHE,DNK,2012.0,20,24,-4
USA,LTU,2013.0,11,4,7
CHN,POL,2000.0,3,2,1
PRT,IND,2011.0,10,25,-15
EGY,CHE,2019.0,6,4,2
IND,TUR,2020.0,8,6,2
IND,SVN,2022.0,4,2,2
THA,NZL,2010.0,7,3,4
THA,PHL,2021.0,6,9,-3
MNG,KOR,2019.0,7,11,-4
USA,MAR,2009.0,5,6,-1
CHL,ITA,2022.0,18,8,10
IRL,NZL,2023.0,3,5,-2
PRT,RUS,2017.0,10,4,6
IND,EGY,2020.0,10,5,5
NLD,SGP,2022.0,13,18,-5
LBN,EGY,2020.0,8,3,5
GIN,FRA,2020.0,4,3,1
BRA,PER,2023.0,22,16,6
IND,ESP,2018.0,27,16,11
AUT,TUR,2016.0,6,13,-7
PAK,NOR,2022.0,8,7,1
CAN,DNK,2021.0,30,25,5
JPN,RUS,2018.0,18,14,4
ISR,CHN,2020.0,24,45,-21
IRL,QAT,2019.0,4,2,2
SRB,USA,2020.0,25,25,0
POL,ITA,2022.0,24,33,-9
IND,PRT,2013.0,20,12,8
CRI,MEX,2022.0,7,1,6
IND,BRN,2018.0,6,1,5
LTU,CZE,2022.0,2,5,-3
CHN,ETH,2022.0,34,16,18
AUT,HUN,2023.0,16,13,3
JPN,VEN,2013.0,1,1,0
CHL,IND,2023.0,8,8,0
GRC,CYP,2006.0,8,6,2
CHN,IDN,2015.0,2,1,1
ARG,CRI,2021.0,1,2,-1
ISR,ESP,2018.0,8,12,-4
AUS,THA,2023.0,16,14,2
GTM,USA,2021.0,16,11,5
DNK,FRO,2007.0,2,1,1
FRO,DNK,2009.0,3,3,0
FRA,GAB,2007.0,8,7,1
DZA,DEU,2012.0,1,2,-1
THA,IND,2014.0,3,7,-4
FIN,THA,2004.0,3,1,2
ISR,SWE,2008.0,6,2,4
ARE,LBN,2018.0,2,9,-7
PRT,CAN,2004.0,3,5,-2
ESP,PAN,2013.0,7,2,5
PRI,COL,2007.0,2,2,0
UKR,AUT,2009.0,7,1,6
TUN,ARE,2014.0,4,1,3
FJI,AUS,2009.0,8,2,6
SDN,DEU,2015.0,4,4,0
NLD,THA,2007.0,7,7,0
CHN,PHL,2007.0,2,2,0
ZAF,GHA,2012.0,5,5,0
CAN,QAT,2018.0,16,10,6
ISR,GRC,2014.0,3,3,0
GBR,UKR,2013.0,25,21,4
DZA,USA,2014.0,3,9,-6
SWE,EST,2018.0,9,9,0
ITA,BEL,2008.0,50,41,9
CZE,NLD,2010.0,5,7,-2
POL,AUT,2007.0,9,6,3
IRL,PRT,2014.0,4,4,0
ZAF,LSO,2011.0,2,5,-3
GRC,BEL,2011.0,11,11,0
TUR,CYP,2008.0,13,9,4
TUN,JPN,2014.0,1,4,-3
TUR,GRC,2017.0,6,5,1
LBN,CAN,2014.0,10,13,-3
ESP,ARE,2019.0,11,1,10
GBR,SEN,2010.0,2,1,1
THA,SWE,2007.0,2,12,-10
LUX,BEL,2004.0,4,14,-10
KWT,CAN,2008.0,4,6,-2
FRA,CHL,2023.0,17,11,6
KEN,ETH,2019.0,6,7,-1
UKR,IND,2004.0,1,1,0
JPN,ISR,2021.0,8,9,-1
LKA,SWE,2008.0,1,3,-2
USA,GAB,2019.0,10,2,8
IRL,NOR,2013.0,3,1,2
EGY,FRA,2007.0,6,15,-9
NGA,NER,2005.0,11,2,9
NER,NGA,2002.0,1,1,0
LAO,COL,2012.0,1,1,0
DNK,IND,2013.0,12,17,-5
ZWE,NLD,2006.0,2,1,1
CAN,LBN,2009.0,6,9,-3
FIN,TUR,2011.0,10,3,7
DEU,EST,2011.0,4,8,-4
ARG,MEX,2012.0,14,17,-3
FRA,COL,2000.0,7,5,2
MKD,SRB,2002.0,14,25,-11
IRL,NLD,2007.0,16,18,-2
FRA,IRN,2008.0,23,13,10
AUS,POL,2015.0,10,7,3
IDN,NLD,2011.0,12,13,-1
ZAF,CHN,2008.0,6,3,3
ZAF,BWA,2015.0,15,12,3
CZE,ESP,2013.0,6,21,-15
JOR,USA,2003.0,11,25,-14
SWE,NZL,2012.0,9,12,-3
HUN,SWE,1998.0,10,3,7
SGP,DEU,2012.0,29,33,-4
DEU,SRB,2013.0,10,7,3
ETH,GBR,2008.0,5,8,-3
DNK,TUR,2003.0,2,2,0
FRA,NOR,2012.0,31,36,-5
LUX,FRA,2012.0,20,33,-13
JOR,ARE,2008.0,7,3,4
BEL,SVN,2011.0,5,2,3
RUS,ROU,2016.0,3,2,1
IND,NGA,2007.0,5,4,1
BGD,PAK,2021.0,13,14,-1
OMN,CAN,2015.0,6,10,-4
MAC,USA,2020.0,13,11,2
ITA,LTU,2008.0,7,2,5
PER,BEL,2011.0,1,3,-2
VEN,ITA,2015.0,4,3,1
JOR,IRQ,2022.0,8,1,7
ESP,URY,2004.0,9,8,1
BFA,FRA,2008.0,12,14,-2
SRB,BIH,2004.0,10,4,6
IND,CHN,2011.0,22,6,16
NLD,IDN,2012.0,16,10,6
CZE,BEL,2008.0,6,1,5
NPL,THA,2009.0,4,1,3
THA,NPL,2011.0,2,1,1
FRA,BIH,2019.0,2,2,0
MYS,GBR,2006.0,16,72,-56
JPN,BRA,2013.0,18,5,13
BRA,NLD,2010.0,24,18,6
CHN,AUT,2011.0,11,9,2
SLV,SVN,2011.0,11,8,3
THA,KOR,2010.0,3,2,1
LTU,GBR,2010.0,4,3,1
BEL,CHL,2021.0,8,11,-3
AUS,NGA,2005.0,7,2,5
COL,MEX,2008.0,11,18,-7
BEN,FRA,2009.0,11,12,-1
CAN,HUN,2014.0,5,9,-4
SVK,GBR,2010.0,8,15,-7
AUS,POL,2008.0,6,8,-2
NZL,FJI,2004.0,3,1,2
THA,GBR,2008.0,22,64,-42
IRN,GBR,2004.0,16,81,-65
AUS,TUR,2010.0,4,6,-2
JPN,NPL,2003.0,6,4,2
DNK,BRA,2015.0,15,14,1
TZA,AUS,2015.0,3,1,2
NOR,NLD,2004.0,8,21,-13
BEL,SRB,2021.0,2,4,-2
SAU,CAN,2018.0,75,127,-52
EST,BEL,2018.0,2,1,1
CZE,CHN,2015.0,6,4,2
CMR,DEU,2013.0,4,4,0
BEL,ARG,2018.0,6,7,-1
JOR,ARE,2014.0,15,7,8
ITA,SRB,2015.0,5,7,-2
HUN,CAN,2015.0,16,7,9
ISR,TUR,2017.0,6,1,5
BLR,SWE,2022.0,2,1,1
HUN,PRT,2020.0,2,1,1
BGD,IND,2019.0,16,25,-9
SRB,CZE,2018.0,5,3,2
IRN,CZE,2017.0,4,1,3
NOR,CHE,2008.0,6,12,-6
BIH,USA,2022.0,2,1,1
SDN,CHN,2012.0,2,3,-1
ARG,PRI,2018.0,2,2,0
CHN,MWI,2023.0,4,1,3
BEL,VNM,2018.0,19,3,16
SRB,FRA,2022.0,4,5,-1
ARE,PRT,2017.0,3,3,0
DNK,CRI,2020.0,2,1,1
TWN,SAU,2021.0,4,4,0
SAU,JPN,2023.0,6,9,-3
CHN,AUT,2019.0,16,27,-11
ISL,NOR,2017.0,5,5,0
ESP,RUS,2017.0,11,9,2
IRN,FRA,2021.0,52,20,32
ARG,AUS,2000.0,2,3,-1
TZA,SWE,2005.0,1,7,-6
MOZ,USA,2022.0,11,4,7
CMR,ZAF,2023.0,4,7,-3
NLD,MEX,2014.0,8,8,0
TUR,NGA,2019.0,3,4,-1
POL,NOR,2016.0,12,7,5
USA,HTI,2019.0,9,13,-4
LKA,GBR,2021.0,25,20,5
EST,ITA,2014.0,3,7,-4
DEU,ROU,2019.0,16,18,-2
MYS,HKG,2020.0,5,8,-3
KOR,MMR,2016.0,1,2,-1
NIC,ESP,2018.0,1,4,-3
THA,AUT,2021.0,1,7,-6
MAR,LBN,2015.0,2,2,0
ARG,PER,2018.0,2,1,1
PSE,GBR,2015.0,3,5,-2
COL,NZL,2020.0,1,1,0
DEU,CMR,2017.0,6,6,0
PAK,USA,2005.0,28,26,2
AUS,JPN,2023.0,32,30,2
DEU,SAU,2023.0,11,9,2
IRN,DZA,2014.0,1,1,0
LUX,USA,2023.0,5,5,0
PAK,SGP,2019.0,3,2,1
ISR,ARG,2021.0,1,1,0
COD,BEL,2019.0,2,15,-13
SWE,LTU,2014.0,7,5,2
NZL,DNK,2021.0,6,4,2
MWI,USA,2001.0,8,3,5
USA,MWI,2006.0,5,4,1
GBR,EST,2009.0,8,4,4
CHE,POL,2008.0,12,14,-2
UGA,ZAF,2005.0,5,1,4
IRN,DEU,2000.0,2,2,0
CIV,BFA,2013.0,4,2,2
RUS,ARM,1999.0,6,10,-4
JPN,DNK,2008.0,15,10,5
UZB,RUS,2005.0,10,6,4
DEU,MEX,2006.0,18,19,-1
ROU,FRA,2009.0,33,42,-9
CAN,MAR,2003.0,5,6,-1
DEU,THA,2011.0,31,13,18
VAT,ITA,2019.0,3,2,1
ITA,VAT,2022.0,1,3,-2
NLD,ARE,2022.0,5,4,1
ESP,JPN,2001.0,9,10,-1
ESP,BRA,2004.0,32,26,6
JPN,AUT,2000.0,8,6,2
ITA,BLR,1998.0,2,3,-1
GRC,PRT,2005.0,2,1,1
FRA,BGR,2022.0,4,3,1
DNK,LTU,2006.0,4,6,-2
AUT,SVN,2009.0,5,4,1
DEU,ARM,2003.0,3,6,-3
SWE,MEX,2009.0,3,3,0
PHL,IND,2021.0,5,5,0
SVN,HRV,2002.0,7,9,-2
MEX,ITA,2004.0,7,3,4
SRB,FIN,2005.0,4,1,3
SVN,AUS,2000.0,1,1,0
BIH,HRV,2014.0,12,7,5
ROU,IRL,2010.0,3,3,0
GHA,GBR,2007.0,7,16,-9
FIN,JPN,2009.0,11,13,-2
JPN,FIN,2010.0,15,14,1
NGA,JPN,2006.0,3,5,-2
TWN,JPN,2008.0,24,40,-16
USA,JAM,2010.0,12,13,-1
JPN,GRC,2014.0,4,4,0
SVN,ITA,1998.0,4,5,-1
ITA,SVN,2002.0,5,1,4
PAK,KEN,2015.0,2,1,1
BEL,MAR,2004.0,6,2,4
AUT,HRV,2021.0,3,12,-9
OMN,ARE,2013.0,3,2,1
LVA,USA,2006.0,2,3,-1
BGR,USA,2009.0,9,9,0
HRV,FRA,2003.0,5,1,4
SVK,SVN,2001.0,3,5,-2
SVN,ITA,2007.0,3,7,-4
AUT,THA,2003.0,6,2,4
SWE,HUN,1999.0,6,14,-8
BLR,USA,1999.0,10,7,3
CAN,IRL,2007.0,24,23,1
IRL,NZL,2000.0,2,2,0
NZL,IRL,2004.0,7,5,2
SGP,CAN,2001.0,17,17,0
DNK,ARG,2001.0,1,3,-2
EGY,FRA,1999.0,3,5,-2
TTO,USA,2019.0,11,11,0
IDN,THA,2009.0,4,2,2
SVN,USA,2008.0,14,10,4
OMN,JOR,2004.0,2,2,0
ZAF,CHE,2017.0,24,12,12
SVK,POL,2000.0,4,5,-1
MOZ,USA,2016.0,11,9,2
USA,MLI,2006.0,6,3,3
SWE,AUT,2008.0,11,6,5
TUR,AZE,2007.0,4,8,-4
BEL,HUN,1997.0,8,3,5
FIN,ISR,2014.0,4,2,2
PSE,ITA,2015.0,1,3,-2
JPN,NZL,2008.0,13,7,6
GBR,MWI,2003.0,7,4,3
GTM,USA,2009.0,4,7,-3
BIH,HRV,2001.0,4,4,0
HRV,BIH,2004.0,19,1,18
DNK,ESP,2012.0,16,28,-12
ITA,ISL,2009.0,2,1,1
JPN,PAK,2005.0,7,5,2
FRA,ETH,2002.0,1,1,0
JPN,PHL,2001.0,14,9,5
HRV,AUT,2014.0,8,2,6
THA,GBR,2001.0,25,35,-10
POL,CAN,2010.0,17,14,3
CAN,NGA,2002.0,5,3,2
CHE,ROU,2011.0,3,4,-1
ITA,SVN,1997.0,4,2,2
JPN,CZE,2005.0,11,6,5
TUR,ITA,2009.0,8,7,1
ROU,CHE,2003.0,6,3,3
USA,TUN,2004.0,6,4,2
UKR,CAN,2000.0,6,4,2
LUX,DEU,2006.0,2,19,-17
JOR,ARE,2001.0,5,3,2
FRA,EGY,2005.0,10,7,3
ISR,SWE,2001.0,6,7,-1
NLD,NZL,2012.0,15,11,4
BEL,NZL,2010.0,3,4,-1
POL,AUT,1999.0,4,7,-3
PHL,ESP,2003.0,16,4,12
SWE,SVK,2004.0,3,4,-1
BRA,ARG,1997.0,9,15,-6
BIH,HRV,2004.0,1,19,-18
CZE,ITA,2013.0,7,11,-4
GRC,DNK,1998.0,1,3,-2
CHL,MEX,2008.0,8,9,-1
OMN,QAT,2013.0,2,1,1
DEU,ISL,2009.0,2,4,-2
CAN,ARE,2003.0,12,2,10
KWT,QAT,2020.0,2,2,0
DEU,SAU,2000.0,3,1,2
NLD,POL,2000.0,10,10,0
IND,SAU,2005.0,8,6,2
KEN,ZAF,2010.0,15,9,6
DZA,BEL,1997.0,2,1,1
FRA,BFA,2006.0,9,14,-5
HUN,AUS,1998.0,1,1,0
USA,NIC,2002.0,11,1,10
CUB,DEU,2000.0,4,8,-4
SVK,AUT,2010.0,9,6,3
NOR,DEU,1998.0,13,17,-4
NZL,NLD,2004.0,7,13,-6
GMB,NGA,2006.0,3,3,0
UZB,GBR,2001.0,2,1,1
UKR,POL,2013.0,15,16,-1
BEL,CHE,1998.0,18,16,2
HUN,ARE,2002.0,3,2,1
FRA,ISR,2008.0,19,26,-7
DEU,KWT,2003.0,3,3,0
UGA,KEN,2013.0,12,5,7
SVK,JPN,2002.0,4,1,3
ESP,CUB,2007.0,20,21,-1
TUN,NLD,2006.0,1,2,-1
ARM,RUS,2001.0,3,4,-1
BEL,ITA,2003.0,32,53,-21
ZAF,LSO,2009.0,2,7,-5
FRA,GRC,2007.0,26,21,5
HRV,ESP,2017.0,3,4,-1
AUT,FRA,2006.0,17,30,-13
BGR,POL,2019.0,2,3,-1
USA,CRI,2001.0,10,14,-4
FIN,EST,2001.0,11,7,4
FIN,ISL,2000.0,1,1,0
SVK,ESP,2009.0,3,2,1
ESP,SVK,2010.0,2,4,-2
CHL,ESP,1998.0,12,14,-2
DZA,ZAF,2012.0,1,1,0
CAF,COD,2020.0,4,1,3
GHA,DEU,2005.0,1,2,-1
NZL,IND,2004.0,1,5,-4
ZAF,ESP,2010.0,3,7,-4
ASM,USA,2014.0,4,2,2
USA,ZMB,2002.0,5,3,2
GHA,JPN,2005.0,4,1,3
AUT,ARE,2019.0,3,1,2
AUS,THA,2000.0,10,13,-3
THA,AUS,2007.0,20,28,-8
CHE,BIH,2012.0,2,1,1
BGR,RUS,2013.0,5,3,2
DEU,PRI,1999.0,1,2,-1
SGP,NZL,2022.0,9,9,0
UKR,CAN,2006.0,4,3,1
SVN,BIH,2015.0,4,2,2
THA,DEU,2007.0,17,14,3
EST,SWE,2016.0,14,4,10
SRB,FRA,2016.0,8,8,0
GRC,ITA,2013.0,44,21,23
DNK,NZL,2009.0,5,10,-5
COD,BEL,2011.0,1,1,0
JPN,MMR,2018.0,14,5,9
CAN,LUX,2014.0,1,2,-1
SVK,CHE,2008.0,3,2,1
SVN,AUT,2011.0,3,2,1
HKG,SGP,2010.0,19,14,5
CUB,ECU,2016.0,28,2,26
KOR,IND,1998.0,2,14,-12
SAU,TUR,2010.0,4,7,-3
KOR,IDN,2012.0,10,2,8
AUS,ISR,2011.0,12,18,-6
HRV,BIH,2008.0,15,8,7
CHN,IRN,2012.0,5,6,-1
CHL,GBR,2013.0,26,26,0
VNM,DEU,2012.0,10,13,-3
DEU,VNM,2013.0,16,8,8
GBR,VNM,2008.0,13,5,8
IND,HKG,2012.0,6,2,4
FRA,ROU,2013.0,28,37,-9
HRV,USA,2017.0,11,15,-4
VNM,FRA,2010.0,8,10,-2
EGY,KWT,2012.0,17,9,8
USA,SDN,2023.0,2,4,-2
IND,CZE,2014.0,21,5,16
CMR,CHE,2019.0,3,3,0
CHN,FIN,2008.0,12,11,1
QAT,SAU,2020.0,7,17,-10
CHL,ARG,2009.0,11,11,0
USA,ZWE,2010.0,6,12,-6
JPN,TUR,2011.0,14,17,-3
AUT,JPN,2018.0,9,16,-7
CHE,IRN,2012.0,9,23,-14
URY,GBR,2009.0,3,1,2
NLD,HUN,1998.0,13,8,5
TUN,OMN,2018.0,5,1,4
NGA,CAN,2007.0,4,1,3
TUR,GRC,2018.0,9,7,2
IDN,TUR,2020.0,2,2,0
CAN,BEN,2016.0,6,1,5
CAN,BEN,2022.0,1,1,0
IDN,CAN,2021.0,3,7,-4
CHE,NZL,2012.0,11,9,2
IND,NZL,2013.0,15,9,6
BRA,DNK,2007.0,1,2,-1
FRA,LUX,2013.0,26,22,4
ITA,NZL,2008.0,5,3,2
PRT,MYS,2017.0,1,3,-2
KEN,SWE,2016.0,3,6,-3
FIN,POL,2021.0,11,8,3
IRL,SWE,2012.0,6,10,-4
CUB,DEU,2006.0,3,5,-2
IRN,FRA,2011.0,23,23,0
FRA,IRN,2014.0,34,18,16
NOR,ESP,2013.0,8,11,-3
HUN,AUS,1999.0,2,1,1
TWN,HKG,2011.0,8,8,0
SWE,ZAF,2010.0,6,5,1
EGY,NZL,2006.0,1,1,0
MYS,PRT,2012.0,1,3,-2
CIV,ITA,2009.0,1,1,0
EGY,KWT,1997.0,4,2,2
USA,TUN,2015.0,7,6,1
ISR,DNK,2017.0,4,4,0
GRC,CYP,2010.0,28,7,21
BGD,DNK,2014.0,1,2,-1
IND,MEX,2015.0,12,7,5
ITA,SMR,2021.0,11,5,6
PRT,CZE,2014.0,3,3,0
PER,GBR,2015.0,7,7,0
NOR,FRA,2010.0,20,37,-17
NLD,CHN,2006.0,33,22,11
ZAF,GHA,2005.0,1,3,-2
MWI,KEN,2013.0,5,1,4
GBR,CHL,2007.0,12,19,-7
ETH,ITA,2010.0,2,1,1
CHN,AUS,1997.0,17,15,2
IRL,CHE,2012.0,15,5,10
FIN,ESP,2010.0,20,8,12
ESP,EGY,2011.0,4,4,0
UKR,SWE,2007.0,2,8,-6
ARG,FRA,2017.0,32,41,-9
FIN,LTU,2022.0,6,4,2
PHL,FIN,2015.0,1,1,0
CHE,ROU,2021.0,11,4,7
CHE,LTU,2012.0,3,2,1
ARG,BRA,2005.0,19,14,5
SGP,RUS,2010.0,1,3,-2
IDN,SWE,2008.0,2,2,0
NGA,GMB,2018.0,3,2,1
AUS,BRN,2010.0,2,1,1
LTU,LVA,2013.0,6,2,4
NZL,NLD,2014.0,19,13,6
UKR,DEU,2015.0,36,17,19
CZE,NLD,2023.0,5,4,1
JOR,QAT,2017.0,11,2,9
SGP,SAU,2014.0,12,4,8
TUR,RUS,1999.0,4,2,2
RUS,TUR,2003.0,10,7,3
COL,ARG,2017.0,20,24,-4
NPL,BEL,2018.0,3,1,2
MOZ,DNK,2015.0,2,1,1
JPN,NZL,2014.0,10,7,3
LBN,ESP,2022.0,4,1,3
MKD,GBR,2010.0,1,1,0
COG,NGA,2013.0,2,1,1
IRL,NLD,1999.0,8,5,3
DNK,KOR,2003.0,1,3,-2
KOR,HKG,2022.0,12,17,-5
CHE,SGP,2005.0,6,4,2
PAN,USA,2011.0,20,23,-3
PER,USA,2014.0,42,42,0
ITA,BIH,2013.0,3,1,2
NZL,NLD,2015.0,23,17,6
VNM,ITA,2014.0,2,6,-4
PHL,GBR,2013.0,4,3,1
GBR,SLE,2019.0,4,5,-1
CAN,RUS,2022.0,7,25,-18
ESP,BOL,2019.0,4,3,1
GBR,GHA,2013.0,23,15,8
ITA,GRC,2017.0,35,28,7
BIH,HRV,2015.0,6,11,-5
SGP,FRA,2020.0,24,32,-8
TUR,PRT,2013.0,3,3,0
SAU,DNK,2019.0,5,3,2
BRA,PER,2000.0,4,3,1
DEU,CIV,2021.0,4,2,2
EGY,MYS,2011.0,5,5,0
NZL,DEU,2014.0,30,40,-10
PAK,KOR,2011.0,13,9,4
CHE,HUN,2010.0,20,8,12
THA,NLD,2014.0,6,18,-12
FRA,UGA,2021.0,2,1,1
CZE,SWE,2015.0,7,12,-5
IND,CZE,2015.0,16,7,9
NOR,USA,2010.0,76,101,-25
FRA,KAZ,2011.0,2,1,1
PAN,USA,2019.0,19,27,-8
PAN,USA,2021.0,15,30,-15
CYP,FRA,2020.0,2,4,-2
JOR,FRA,2021.0,1,1,0
JPN,BEL,2023.0,9,6,3
SVN,DNK,2023.0,2,2,0
MLI,CHE,2022.0,4,1,3
GBR,TZA,2016.0,11,10,1
BEL,BDI,2019.0,3,1,2
POL,NOR,2022.0,16,10,6
SVN,JPN,2018.0,3,3,0
SVK,IND,2018.0,1,3,-2
SVK,BEL,2016.0,3,4,-1
BEL,SVK,2017.0,1,3,-2
NGA,SWE,2016.0,1,3,-2
DNK,MEX,2020.0,10,8,2
AUS,BHR,2020.0,2,1,1
USA,COD,2023.0,5,4,1
BEL,COG,2021.0,9,10,-1
HKG,TWN,2005.0,7,4,3
NZL,BEL,2015.0,2,3,-1
KHM,THA,2023.0,3,4,-1
NLD,MEX,2008.0,9,1,8
CHL,CUB,2020.0,4,9,-5
CHN,EGY,2012.0,5,3,2
FRA,BGR,2016.0,6,5,1
COL,DEU,2023.0,12,12,0
CHE,EST,2016.0,6,4,2
EST,CHE,2017.0,4,5,-1
CUB,VEN,2016.0,2,2,0
USA,TZA,2010.0,12,14,-2
AUT,KOR,2023.0,8,1,7
COL,PRT,2022.0,4,5,-1
NZL,KOR,2016.0,7,6,1
IRL,CHN,2011.0,15,17,-2
NAM,USA,2015.0,6,3,3
PRT,CAN,2008.0,6,10,-4
CAN,PRT,2014.0,11,15,-4
IND,LBY,2009.0,6,1,5
ETH,IND,2012.0,8,23,-15
CHN,KOR,2015.0,106,190,-84
HKG,JPN,2009.0,7,8,-1
THA,PAK,2017.0,13,4,9
TUR,BIH,2016.0,4,4,0
KWT,EGY,2019.0,11,26,-15
RWA,UGA,2019.0,4,4,0
USA,LBY,2018.0,4,2,2
ETH,GBR,2015.0,10,6,4
ROU,GRC,2014.0,1,4,-3
GBR,ZWE,2017.0,14,5,9
ZWE,GBR,2018.0,6,12,-6
GHA,RUS,2021.0,1,2,-1
DEU,MWI,2021.0,3,1,2
EGY,CZE,2020.0,2,2,0
ROU,POL,2018.0,6,1,5
SAU,ITA,2021.0,17,19,-2
CHE,THA,2018.0,6,4,2
GRC,BEL,2019.0,25,23,2
ARE,HKG,2018.0,1,2,-1
NLD,HRV,2016.0,6,1,5
NLD,CHL,2020.0,10,16,-6
MAR,GBR,2018.0,5,3,2
BRA,CHN,2022.0,19,10,9
QAT,CHE,2018.0,3,2,1
SWE,BRA,2023.0,13,19,-6
IDN,NOR,2022.0,3,3,0
NOR,BEL,2016.0,7,6,1
MLT,CHE,2020.0,2,1,1
FRA,ISL,2020.0,3,4,-1
PAK,CHE,2019.0,3,6,-3
SWE,MEX,2021.0,1,13,-12
KNA,TTO,2015.0,5,3,2
CHE,TUR,2011.0,12,13,-1
ESP,PAK,2018.0,7,8,-1
NOR,COL,2017.0,3,1,2
IRQ,USA,2023.0,7,24,-17
IRQ,DEU,2020.0,6,19,-13
RUS,KOR,2019.0,8,15,-7
KHM,MYS,2022.0,3,1,2
USA,URY,2017.0,13,16,-3
IRL,NZL,2006.0,5,6,-1
CZE,NOR,2016.0,4,6,-2
ITA,DZA,2003.0,6,3,3
TUR,CHE,1998.0,4,4,0
AUS,NCL,2004.0,2,1,1
ITA,QAT,2019.0,8,2,6
USA,SVK,2019.0,13,14,-1
TWN,CAN,2017.0,16,13,3
USA,SVK,2021.0,5,10,-5
AFG,DEU,2019.0,5,1,4
KEN,NLD,2020.0,7,10,-3
NGA,SWE,2022.0,2,1,1
JPN,SWE,2013.0,25,20,5
MOZ,PRT,2021.0,4,2,2
MOZ,PRT,2019.0,4,4,0
TUN,MAR,2019.0,5,4,1
BLR,RUS,2015.0,26,19,7
NLD,CMR,2021.0,1,1,0
AZE,KOR,2020.0,1,1,0
THA,FRA,2020.0,18,22,-4
ZAF,HUN,2022.0,2,2,0
EGY,TUN,2021.0,1,4,-3
FRA,MRT,2021.0,1,2,-1
CHN,ROU,2019.0,2,3,-1
GBR,EST,2021.0,10,12,-2
VNM,HUN,2015.0,1,1,0
MEX,GBR,2006.0,27,50,-23
RUS,DNK,2023.0,11,6,5
NGA,BRA,2018.0,5,6,-1
IRL,CZE,2022.0,4,7,-3
GTM,MEX,2019.0,2,4,-2
ROU,SWE,2010.0,4,2,2
EGY,RUS,2020.0,9,18,-9
THA,HKG,2010.0,1,1,0
QAT,IND,2014.0,5,5,0
TUR,DNK,2011.0,3,7,-4
USA,LBY,2016.0,3,3,0
SLV,ESP,2014.0,3,1,2
CHL,POL,2016.0,3,3,0
THA,PAK,2018.0,12,3,9
ESP,GNQ,2005.0,3,2,1
AUT,LUX,2022.0,7,2,5
COG,USA,2023.0,2,1,1
TUN,JPN,2008.0,1,1,0
IDN,MYS,2018.0,15,110,-95
SGP,HKG,2010.0,14,19,-5
AUT,TUR,2022.0,4,3,1
GUF,BEL,2019.0,1,1,0
KEN,SWE,2022.0,4,2,2
GBR,OMN,2023.0,4,13,-9
GBR,SLE,2021.0,5,6,-1
TZA,COG,2019.0,1,1,0
MNG,RUS,2023.0,2,2,0
VNM,FRA,2023.0,17,16,1
ITA,PAK,2023.0,6,20,-14
BGD,DEU,2018.0,11,14,-3
JPN,AFG,2023.0,3,2,1
IND,VNM,2021.0,8,19,-11
NPL,KOR,2022.0,10,11,-1
ESP,PHL,2021.0,3,2,1
DEU,MLT,2021.0,3,6,-3
BGD,PAK,2019.0,13,7,6
NOR,CAN,2023.0,12,14,-2
IRQ,EGY,2020.0,7,12,-5
GBR,CMR,2021.0,9,11,-2
POL,SWE,2018.0,25,24,1
MWI,CHE,2016.0,3,1,2
THA,KHM,2017.0,5,3,2
GBR,TZA,2017.0,13,12,1
CZE,JPN,2016.0,13,13,0
USA,LBR,2020.0,11,9,2
VUT,FJI,2018.0,1,1,0
CHN,AUT,2021.0,18,22,-4
BEL,PHL,2016.0,3,1,2
OMN,IRQ,2020.0,1,2,-1
BHR,TUN,2019.0,2,1,1
ZAF,LSO,2019.0,12,2,10
KOR,PHL,2021.0,15,11,4
VEN,COL,2019.0,38,10,28
IND,EST,2017.0,4,4,0
HKG,CHE,2020.0,7,8,-1
PRT,BEL,2010.0,4,5,-1
ROU,NLD,2020.0,5,3,2
BGD,FIN,2011.0,1,1,0
GHA,BEL,2017.0,2,2,0
CHE,PRT,2015.0,11,31,-20
MEX,CHN,2022.0,13,7,6
NPL,KOR,2017.0,2,8,-6
PAK,THA,2019.0,6,5,1
THA,ARE,2021.0,4,1,3
DEU,NZL,2023.0,7,19,-12
PAK,BGD,2016.0,10,15,-5
KOR,CHE,2023.0,14,7,7
PER,FRA,2018.0,13,14,-1
IRN,IND,2020.0,5,16,-11
GUM,USA,2016.0,8,12,-4
VNM,CAN,2020.0,3,10,-7
DEU,KEN,2016.0,20,14,6
PHL,IND,2011.0,5,4,1
ETH,JPN,2016.0,5,4,1
DEU,BIH,2016.0,2,1,1
BRA,ISR,2015.0,4,1,3
EGY,ITA,2013.0,4,12,-8
HUN,CAN,2004.0,10,5,5
KEN,CHE,2023.0,7,4,3
SVN,NLD,2015.0,4,1,3
USA,TTO,2016.0,7,11,-4
BEL,HKG,2023.0,2,2,0
MMR,AUS,2022.0,3,4,-1
PYF,FRA,2012.0,11,22,-11
PRT,CHL,2017.0,3,5,-2
ARG,CAN,2013.0,15,14,1
NPL,NLD,2016.0,4,2,2
BGR,POL,2021.0,3,1,2
DNK,NZL,2019.0,5,6,-1
CUB,BRA,2010.0,7,11,-4
FIN,GHA,2022.0,2,3,-1
UGA,TZA,2017.0,6,1,5
COL,AUS,2021.0,13,6,7
NPL,KOR,2016.0,6,7,-1
SYR,JPN,2017.0,1,1,0
FIN,AUT,2015.0,10,6,4
AUT,SAU,2020.0,3,1,2
ITA,JPN,2022.0,26,24,2
NLD,MWI,2020.0,2,1,1
ARG,NLD,2015.0,6,3,3
DNK,CZE,2020.0,6,3,3
USA,ZWE,2023.0,2,6,-4
TUR,SDN,2019.0,4,1,3
SAU,IDN,2020.0,9,1,8
ESP,UKR,2020.0,4,5,-1
SAU,BHR,2019.0,10,7,3
PSE,USA,2018.0,8,9,-1
ETH,TZA,2019.0,2,2,0
VNM,USA,2023.0,27,41,-14
IND,MAR,2018.0,2,3,-1
VNM,TWN,2020.0,26,48,-22
CHN,CYP,2020.0,2,1,1
TUR,PAK,2023.0,11,17,-6
SRB,SVK,2015.0,2,1,1
AUS,JOR,2020.0,18,9,9
ESP,TTO,2019.0,2,2,0
DEU,EST,2019.0,9,8,1
OMN,MYS,2022.0,5,15,-10
AUT,DNK,2013.0,11,8,3
POL,ECU,2019.0,1,1,0
SEN,USA,2019.0,8,8,0
MAR,ESP,2022.0,16,14,2
CYP,DNK,2021.0,1,2,-1
IND,BHR,2019.0,5,2,3
CHN,GRC,2022.0,6,4,2
ZAF,NLD,2022.0,28,13,15
NGA,KOR,2021.0,3,4,-1
NLD,MYS,2016.0,13,9,4
MAR,CAN,2005.0,10,5,5
MEX,NZL,2007.0,3,1,2
CHL,CAN,2019.0,21,26,-5
AUT,SVK,2020.0,7,10,-3
TUR,ROU,2020.0,2,3,-1
UGA,KOR,2020.0,2,3,-1
GBR,ARE,2005.0,14,9,5
IRN,TWN,2011.0,2,2,0
TWN,IRN,2017.0,2,2,0
UGA,ETH,2019.0,3,1,2
CHL,ARG,2019.0,25,36,-11
GTM,USA,2019.0,18,9,9
FRA,AZE,2021.0,2,1,1
PAK,CHE,2021.0,8,2,6
GMB,USA,2023.0,2,1,1
KOR,ESP,2004.0,2,6,-4
GRC,IND,2021.0,5,6,-1
IDN,IRQ,2020.0,1,3,-2
EGY,POL,2021.0,2,5,-3
PER,CHL,2023.0,5,9,-4
RUS,LTU,2021.0,2,3,-1
VNM,HKG,2021.0,2,1,1
KOR,EGY,2023.0,7,11,-4
BEL,THA,2011.0,4,1,3
CHE,VNM,2022.0,2,2,0
EST,RUS,2021.0,2,7,-5
RUS,EST,2022.0,11,1,10
SAU,YEM,2023.0,6,14,-8
ISR,IRL,2017.0,4,15,-11
GBR,BMU,2021.0,2,2,0
IRL,COL,2021.0,1,1,0
BLR,CHN,2013.0,4,1,3
IRN,PHL,2021.0,2,1,1
CHN,MAR,2020.0,44,3,41
KHM,FRA,2018.0,6,11,-5
KOR,HKG,2017.0,15,14,1
POL,BGR,2022.0,4,1,3
NGA,FRA,2023.0,8,1,7
RWA,KOR,2020.0,1,4,-3
COG,COD,2002.0,4,2,2
GBR,SVK,2007.0,9,5,4
BEL,CMR,2015.0,9,2,7
EST,CHE,2016.0,4,6,-2
CHE,EST,2017.0,5,4,1
USA,SYR,2004.0,5,2,3
SYR,FRA,2009.0,1,6,-5
HUN,CZE,2008.0,5,2,3
DZA,BEL,2002.0,4,5,-1
AUT,RUS,2014.0,7,12,-5
IRL,HUN,2004.0,2,3,-1
RUS,AZE,1999.0,6,3,3
ISR,PSE,2013.0,12,21,-9
POL,UKR,2003.0,13,22,-9
FRA,BEN,2002.0,7,2,5
CZE,RUS,2012.0,3,8,-5
ESP,CHN,2009.0,5,18,-13
IRN,USA,1998.0,10,18,-8
LVA,GBR,2002.0,3,4,-1
CHN,IRN,2005.0,1,3,-2
KEN,DNK,2023.0,1,1,0
IRL,EGY,2021.0,4,8,-4
BGR,BEL,2012.0,8,7,1
FRA,CUB,2009.0,2,1,1
BEL,IRL,2023.0,7,10,-3
COL,FRA,2013.0,16,15,1
NLD,IRL,2007.0,18,16,2
FIN,SGP,2023.0,2,4,-2
CZE,KAZ,2018.0,3,1,2
MAR,USA,2005.0,7,3,4
BEN,CAN,2002.0,3,1,2
USA,GUM,2006.0,3,4,-1
DZA,ARG,2011.0,2,3,-1
AZE,UKR,2016.0,1,1,0
THA,SWE,1999.0,3,3,0
RUS,GEO,2006.0,5,7,-2
FRA,TGO,2011.0,5,2,3
FRA,TUR,2009.0,8,13,-5
MWI,TZA,2011.0,1,1,0
AGO,PRT,2009.0,1,1,0
KOR,ITA,2003.0,4,2,2
KOR,UKR,2007.0,1,2,-1
JPN,NPL,2013.0,9,2,7
DNK,HUN,2013.0,4,6,-2
HUN,GRC,2004.0,2,4,-2
ZWE,GBR,2016.0,29,4,25
USA,BLR,2015.0,5,8,-3
HRV,BIH,2001.0,4,4,0
ESP,POL,2011.0,11,26,-15
ZAF,MOZ,2005.0,2,1,1
AUT,UKR,2012.0,3,1,2
IND,DNK,1997.0,3,3,0
LUX,GBR,2014.0,5,7,-2
USA,KNA,2014.0,2,2,0
TUR,NOR,2002.0,3,3,0
CHE,FIN,2001.0,10,13,-3
USA,UZB,2013.0,3,1,2
UZB,GBR,2014.0,2,2,0
CHE,SLE,2017.0,4,2,2
BEL,GRC,2014.0,9,27,-18
REU,FRA,2012.0,25,20,5
ESP,DZA,2012.0,5,2,3
USA,JAM,2006.0,13,8,5
MEX,NLD,2005.0,4,4,0
NLD,MEX,2015.0,13,16,-3
POL,HUN,2005.0,2,3,-1
KAZ,RUS,2002.0,6,9,-3
PER,DEU,2012.0,5,1,4
LBN,NLD,2012.0,1,2,-1
ARE,SAU,2016.0,13,40,-27
RUS,MNG,2007.0,1,3,-2
CAN,IND,2001.0,27,48,-21
ESP,BEL,1999.0,15,29,-14
COD,USA,2023.0,4,5,-1
USA,SLV,2005.0,2,2,0
IND,RUS,2009.0,2,2,0
JOR,EGY,2003.0,2,2,0
FRA,IRN,2001.0,9,1,8
KWT,IND,2007.0,3,10,-7
KEN,GHA,2003.0,1,1,0
DEU,NZL,2000.0,9,17,-8
USA,GNQ,2022.0,5,2,3
BEL,SGP,2007.0,2,2,0
ITA,ZAF,2007.0,4,5,-1
CAN,ARM,2009.0,3,1,2
PER,GBR,2001.0,3,3,0
BWA,GBR,2009.0,5,1,4
FIN,CHL,2014.0,4,2,2
ITA,UKR,2002.0,1,2,-1
YEM,SAU,2013.0,4,2,2
ITA,MOZ,2010.0,1,1,0
CAN,SVK,1999.0,3,1,2
TUN,OMN,2016.0,4,3,1
ISL,USA,2006.0,9,25,-16
SWE,BWA,2008.0,1,2,-1
COD,CHE,2014.0,1,1,0
FIN,NLD,2010.0,18,16,2
GBR,BHR,2008.0,5,2,3
ZAF,PRT,2001.0,4,1,3
DEU,SVN,2012.0,12,13,-1
HUN,BEL,2014.0,8,8,0
AUT,IND,2009.0,7,7,0
BRA,CHL,2014.0,29,21,8
DEU,PRT,2002.0,17,13,4
NZL,FRA,2006.0,7,13,-6
PSE,USA,2016.0,6,8,-2
ISR,CZE,2011.0,2,2,0
ESP,MAR,1999.0,5,3,2
DEU,HUN,2010.0,36,44,-8
GHA,CAN,2006.0,4,3,1
SWE,ISL,2015.0,22,15,7
EST,USA,2013.0,8,7,1
AUS,AUT,2008.0,28,29,-1
HUN,CAN,2001.0,8,10,-2
JPN,PHL,2015.0,33,21,12
SVN,DNK,2010.0,2,1,1
FIN,AUS,2007.0,11,6,5
MYS,USA,1999.0,12,12,0
EST,CHN,2014.0,2,1,1
KOR,SWE,2003.0,5,9,-4
LVA,DEU,2010.0,3,4,-1
PRT,IRL,2016.0,7,5,2
GBR,CHL,1999.0,7,4,3
URY,USA,2010.0,9,14,-5
GBR,KEN,2008.0,16,9,7
HKG,THA,2008.0,1,4,-3
SGP,TWN,2006.0,5,4,1
LBN,ITA,2009.0,1,1,0
GBR,GMB,2009.0,4,10,-6
ESP,MKD,2011.0,1,2,-1
ARE,SAU,2017.0,6,36,-30
NOR,IRL,2016.0,3,8,-5
SVK,DEU,2006.0,13,15,-2
BRA,LUX,2013.0,2,1,1
KOR,PHL,2009.0,3,2,1
FRA,HKG,2009.0,6,4,2
NLD,TZA,2008.0,4,4,0
KOR,KAZ,2014.0,1,1,0
KAZ,RUS,2012.0,17,29,-12
KGZ,TUR,2018.0,4,1,3
LVA,LTU,2016.0,4,2,2
RUS,IRL,2013.0,4,3,1
GRC,FRA,2003.0,32,31,1
BRA,SLV,2007.0,2,2,0
BEL,JPN,2007.0,11,14,-3
BGD,AUS,2007.0,8,5,3
GHA,DEU,2002.0,3,4,-1
EGY,MYS,2019.0,1,8,-7
NOR,NZL,2016.0,5,4,1
USA,NGA,2007.0,28,18,10
ITA,SRB,2001.0,7,1,6
SGP,THA,2012.0,10,4,6
CHL,BRA,2004.0,5,13,-8
UGA,USA,2011.0,26,20,6
JPN,ZAF,2009.0,3,1,2
BLR,NOR,2019.0,3,1,2
MEX,UKR,2002.0,2,2,0
BRA,PRI,2009.0,2,3,-1
GBR,DZA,2005.0,3,2,1
DEU,MNE,2016.0,1,1,0
ESP,PAN,2003.0,3,1,2
UKR,CZE,2010.0,2,1,1
IRL,ARE,2016.0,5,1,4
TWN,JPN,2001.0,8,25,-17
BLZ,USA,2019.0,4,1,3
MYS,ITA,2006.0,1,1,0
ZAF,IRL,2009.0,3,1,2
JPN,VNM,2008.0,18,8,10
RUS,KOR,2021.0,9,14,-5
ESP,SRB,2005.0,3,3,0
PHL,AUS,2008.0,5,9,-4
SGP,CAN,2015.0,26,31,-5
DNK,THA,2022.0,2,1,1
VEN,FRA,2015.0,15,4,11
JPN,OMN,2013.0,4,1,3
CHE,LBR,2015.0,2,1,1
BEL,SRB,2019.0,6,4,2
NLD,CZE,2009.0,4,3,1
USA,OMN,2015.0,10,4,6
ESP,FIN,2010.0,8,20,-12
ISR,IND,2013.0,18,37,-19
HRV,SRB,2015.0,17,14,3
CUB,COL,2002.0,2,4,-2
ESP,NOR,2002.0,7,6,1
AUT,SRB,2014.0,4,6,-2
BRA,PRI,2011.0,4,4,0
HUN,CAN,2008.0,4,10,-6
GBR,BGD,2011.0,14,10,4
PAK,SWE,2007.0,3,1,2
BGR,USA,2011.0,16,14,2
NLD,GHA,2013.0,6,4,2
MYS,NZL,2012.0,15,8,7
VEN,BRA,2017.0,5,5,0
IRN,SGP,2020.0,7,5,2
DNK,GRL,2009.0,6,5,1
BGD,PHL,2010.0,1,1,0
BRA,CHE,2016.0,24,15,9
CHN,NZL,2006.0,6,7,-1
BRA,PER,2010.0,11,6,5
NLD,PHL,2008.0,2,1,1
BRA,MEX,2022.0,22,14,8
SWE,CYP,2014.0,1,3,-2
SVK,BEL,2017.0,3,1,2
QAT,HUN,2019.0,2,2,0
MEX,BRA,2010.0,12,26,-14
CHN,ESP,2007.0,10,4,6
GBR,VNM,2004.0,2,3,-1
VNM,AUS,2005.0,2,12,-10
ZAF,SWE,2013.0,9,8,1
NLD,KEN,2013.0,10,2,8
ESP,HUN,2021.0,4,9,-5
DEU,MYS,2009.0,6,4,2
NOR,CHN,2007.0,5,9,-4
POL,SVK,2010.0,4,8,-4
IDN,KOR,2012.0,2,10,-8
ISR,ESP,2016.0,8,12,-4
LTU,CZE,2016.0,2,1,1
BGD,GBR,2011.0,10,14,-4
IND,FIN,2012.0,16,3,13
RWA,GHA,2018.0,1,1,0
BEN,NLD,2018.0,2,4,-2
ISR,PER,2015.0,1,1,0
GBR,SYR,2012.0,9,1,8
QAT,SGP,2020.0,2,2,0
AZE,USA,2021.0,4,6,-2
EGY,HUN,2015.0,3,1,2
KOR,FRA,2012.0,19,16,3
ESP,IND,2008.0,8,16,-8
RUS,SGP,2011.0,3,1,2
LBY,IND,2014.0,3,3,0
BOL,FRA,2008.0,5,3,2
COL,NOR,2013.0,2,2,0
ECU,FRA,2015.0,6,7,-1
SGP,TWN,2010.0,14,14,0
ESP,VNM,2017.0,3,1,2
AUT,NZL,2005.0,3,1,2
CHE,PRT,2014.0,15,26,-11
DOM,DMA,2015.0,5,4,1
HKG,NLD,2019.0,8,10,-2
CAN,NZL,2007.0,31,29,2
NGA,NLD,2023.0,4,1,3
NLD,COL,2018.0,5,14,-9
GRC,CAN,2013.0,15,5,10
ZAF,NGA,2010.0,13,31,-18
ARG,SWE,2012.0,4,2,2
BFA,ITA,2011.0,3,2,1
NGA,MYS,2009.0,5,3,2
MLI,GIN,2013.0,2,1,1
CYP,GRC,2006.0,6,8,-2
JPN,COL,2020.0,1,6,-5
CHN,SRB,2016.0,3,2,1
TUR,PSE,2016.0,2,3,-1
BEL,TWN,2020.0,4,4,0
KWT,MYS,2019.0,4,5,-1
CZE,HRV,2007.0,3,1,2
DEU,DZA,2010.0,2,3,-1
DNK,TWN,2010.0,3,2,1
NZL,DEU,2015.0,38,28,10
JPN,UKR,2022.0,2,1,1
GHA,CAN,2023.0,6,4,2
SWE,ARG,2017.0,3,5,-2
LUX,GBR,2015.0,7,12,-5
BLR,JPN,2014.0,1,2,-1
CHE,BGD,2014.0,1,1,0
EGY,AZE,2013.0,1,1,0
ISL,DEU,2015.0,8,6,2
PRY,DEU,2015.0,1,3,-2
GHA,USA,2008.0,8,12,-4
BGD,NZL,2017.0,5,2,3
AUS,CHL,2001.0,2,3,-1
CHN,NOR,2005.0,4,7,-3
USA,FJI,2015.0,1,1,0
KAZ,AUS,2020.0,1,6,-5
NLD,COL,2016.0,5,5,0
EGY,IRQ,2017.0,10,2,8
BEL,TWN,1999.0,1,1,0
MYS,YEM,2023.0,9,11,-2
MAR,IND,2023.0,2,6,-4
ZMB,JPN,2021.0,5,5,0
HUN,CAN,2014.0,9,5,4
ETH,BEL,2015.0,6,5,1
RUS,ESP,2012.0,5,9,-4
ECU,ESP,2014.0,9,31,-22
SRB,FRA,2017.0,11,5,6
COL,JPN,2014.0,3,3,0
JOR,ARE,2015.0,12,5,7
MDG,DEU,2014.0,4,2,2
LBN,GBR,2018.0,7,14,-7
FRA,VEN,2016.0,10,6,4
AUT,GRC,2016.0,4,3,1
AUS,IRQ,2016.0,5,7,-2
EGY,LBY,2016.0,4,3,1
CHN,ISR,2005.0,3,9,-6
TUR,EGY,2014.0,2,2,0
MLI,USA,2021.0,2,5,-3
LKA,ITA,2019.0,1,1,0
CHN,FIN,2004.0,7,11,-4
EGY,FRA,2020.0,14,26,-12
IND,UKR,2016.0,1,1,0
IDN,MYS,2016.0,11,92,-81
HKG,FRA,2016.0,12,7,5
SDN,USA,2000.0,1,3,-2
ISR,NLD,2015.0,9,15,-6
BEL,JPN,2020.0,13,19,-6
USA,ROU,2023.0,9,26,-17
FRA,TGO,2019.0,3,1,2
QAT,NLD,2022.0,6,1,5
GRC,IRL,2023.0,8,10,-2
IRQ,BHR,2019.0,1,2,-1
TZA,CMR,2019.0,1,1,0
HUN,IRL,2020.0,4,1,3
NLD,QAT,2020.0,5,3,2
NOR,SAU,2021.0,4,6,-2
VEN,CAN,2021.0,2,1,1
USA,SOM,2021.0,5,2,3
ARG,BEL,2016.0,8,6,2
ESP,SVN,2012.0,5,4,1
CUB,ITA,2020.0,5,3,2
EST,BEL,2022.0,4,4,0
ZAF,BRA,2016.0,3,2,1
MAR,CAN,2002.0,8,4,4
ITA,QAT,2021.0,8,5,3
QAT,ITA,2014.0,2,2,0
CHL,NLD,2020.0,16,10,6
ROU,DEU,2006.0,31,27,4
CAN,ARG,2012.0,8,14,-6
ESP,URY,2008.0,9,10,-1
ISR,ITA,2022.0,15,20,-5
AUS,CHL,2008.0,4,3,1
IND,NPL,2005.0,25,13,12
CAN,CRI,2012.0,3,6,-3
GBR,HRV,2013.0,8,11,-3
BOL,SWE,2013.0,3,2,1
MLI,USA,2019.0,1,16,-15
IRL,BEL,2018.0,13,15,-2
PRI,ARG,2012.0,6,1,5
ROU,SVK,2017.0,1,1,0
EGY,QAT,2013.0,6,3,3
FIN,NOR,2022.0,25,22,3
SWE,VNM,2018.0,6,1,5
TWN,AUS,1999.0,9,7,2
NOR,CZE,2015.0,8,6,2
FRA,REU,2017.0,28,28,0
CHN,BEL,2014.0,43,51,-8
HKG,DEU,2013.0,12,7,5
USA,PRY,2014.0,5,2,3
EST,SWE,2017.0,12,4,8
USA,CIV,2020.0,9,5,4
HKG,NZL,2018.0,11,4,7
HUN,JPN,2018.0,4,9,-5
IRQ,AUS,2017.0,5,15,-10
CHE,LBN,2019.0,3,3,0
EST,RUS,2019.0,8,5,3
CHN,ZWE,2021.0,5,1,4
THA,CAN,2018.0,11,17,-6
FIN,JPN,2011.0,14,13,1
NGA,ZAF,2007.0,21,4,17
IND,NOR,2014.0,8,10,-2
BRA,SWE,2013.0,9,5,4
KWT,ARE,2021.0,3,6,-3
SWE,PAK,2022.0,7,9,-2
RUS,AZE,1998.0,4,11,-7
PRT,RUS,2016.0,8,2,6
MNE,SRB,2020.0,47,13,34
TUR,CAN,2009.0,10,10,0
DEU,SDN,2014.0,3,2,1
PRT,UKR,2008.0,2,3,-1
AUS,CZE,2014.0,13,6,7
URY,FRA,2018.0,4,3,1
GRC,ZAF,2020.0,1,3,-2
NOR,AUT,2017.0,11,9,2
HUN,PRT,2007.0,1,1,0
USA,LBN,2015.0,63,63,0
SRB,CHE,2004.0,4,3,1
NLD,FIN,2016.0,14,25,-11
URY,CHE,2009.0,3,1,2
ARG,MEX,2005.0,8,10,-2
IND,NLD,2006.0,16,12,4
NZL,HKG,2011.0,2,3,-1
LUX,DEU,2010.0,15,32,-17
ISR,JPN,2016.0,7,5,2
PNG,AUS,2021.0,9,14,-5
KWT,FRA,2019.0,3,13,-10
BEL,CMR,2014.0,4,3,1
GBR,FIN,2023.0,38,41,-3
AGO,PRT,2019.0,5,2,3
CHN,MYS,2013.0,10,8,2
NPL,DEU,2021.0,6,2,4
RUS,NOR,2023.0,9,5,4
HUN,CHE,2018.0,15,12,3
DEU,IRN,2011.0,27,48,-21
ISR,BGR,2002.0,2,1,1
AUT,ETH,2000.0,2,1,1
USA,NGA,1999.0,15,16,-1
FIN,CZE,2002.0,4,4,0
TUR,SWE,1998.0,2,2,0
USA,OMN,2008.0,9,5,4
PHL,ESP,2013.0,2,1,1
ALB,ITA,2007.0,1,2,-1
FIN,HUN,2017.0,1,5,-4
GBR,QAT,2012.0,18,1,17
VEN,COL,2011.0,16,7,9
AUS,CZE,2004.0,1,1,0
DEU,GHA,2007.0,2,5,-3
BEL,PRT,2018.0,14,21,-7
MCO,FRA,2013.0,13,13,0
TTO,IND,2012.0,2,3,-1
CYP,TUR,2005.0,9,7,2
SLV,SVN,2019.0,7,8,-1
NGA,IND,2013.0,14,10,4
DEU,ARM,2013.0,2,4,-2
CAN,MEX,2008.0,19,27,-8
MYS,YEM,2010.0,5,3,2
PRT,BRA,2003.0,29,44,-15
ARE,JOR,2006.0,5,6,-1
HKG,CAN,1998.0,14,35,-21
ESP,TUR,2010.0,7,6,1
TWN,JPN,2004.0,11,22,-11
NLD,HKG,2011.0,2,3,-1
PSE,USA,2017.0,3,10,-7
JOR,DEU,2017.0,10,18,-8
THA,CHE,2018.0,4,6,-2
NZL,IRL,2014.0,11,11,0
BGD,IRL,2019.0,1,1,0
IND,PHL,2017.0,9,1,8
VNM,FRA,2000.0,5,5,0
SRB,CHE,2015.0,6,6,0
PRT,SWE,2014.0,16,9,7
LTU,FRA,2010.0,7,5,2
BRA,BOL,2017.0,3,1,2
CAN,QAT,2022.0,8,13,-5
ZAF,MWI,2006.0,5,4,1
USA,TZA,2023.0,7,13,-6
ARE,CHN,2023.0,12,13,-1
FIN,EST,2015.0,22,20,2
NOR,TUR,2020.0,8,22,-14
UKR,FIN,2015.0,8,1,7
SYR,ITA,2020.0,1,3,-2
HUN,NLD,2020.0,9,6,3
ARE,DEU,2019.0,7,13,-6
NLD,THA,2020.0,12,8,4
SGP,JPN,2018.0,43,42,1
NGA,IRQ,2013.0,1,1,0
IRL,FRA,2003.0,8,18,-10
IND,BRB,2009.0,2,2,0
BWA,GBR,2021.0,4,8,-4
THA,SGP,2021.0,9,9,0
IDN,NOR,2017.0,2,2,0
BEN,BEL,2022.0,2,4,-2
CAN,FIN,2023.0,10,11,-1
TUR,MYS,2023.0,2,11,-9
SVK,NLD,2019.0,3,3,0
PNG,AUS,2019.0,14,7,7
IDN,SAU,2022.0,2,4,-2
KOR,GHA,2018.0,2,2,0
OMN,MYS,2018.0,6,17,-11
MMR,GBR,2019.0,3,1,2
SGP,NZL,2017.0,10,14,-4
BDI,FRA,2016.0,1,1,0
BGD,BEL,2009.0,1,1,0
NAM,ZAF,2021.0,6,20,-14
NGA,ETH,2019.0,2,2,0
PHL,SGP,2022.0,5,3,2
KEN,ZAF,2023.0,14,18,-4
FIN,PRT,2016.0,4,8,-4
TZA,ZMB,2019.0,2,4,-2
IND,BTN,2021.0,5,4,1
CAN,TUR,2003.0,6,10,-4
PAN,DEU,2019.0,1,1,0
TUR,VNM,2021.0,1,4,-3
AUS,RUS,2021.0,9,16,-7
CHE,IRL,2018.0,14,13,1
AZE,TUR,2020.0,2,12,-10
SGP,ARE,2010.0,6,1,5
UKR,FIN,2004.0,3,1,2
GBR,COL,2009.0,13,3,10
BEN,FRA,2011.0,9,22,-13
FRA,MLI,2003.0,3,2,1
SVK,SVN,2014.0,10,13,-3
TZA,USA,2003.0,6,13,-7
ESP,IRL,2007.0,15,10,5
POL,ESP,2001.0,5,6,-1
IRL,IND,2014.0,17,17,0
PHL,KOR,2006.0,3,2,1
THA,MYS,2008.0,4,5,-1
DEU,BLR,1999.0,5,15,-10
LTU,DEU,2020.0,6,12,-6
BWA,ZAF,2013.0,7,7,0
ISR,CHE,2013.0,16,14,2
SGP,AUT,2013.0,5,7,-2
SAU,OMN,2017.0,5,2,3
UKR,PRT,2013.0,1,1,0
PAK,EGY,2010.0,3,3,0
MYS,IDN,2006.0,5,4,1
FRA,NZL,2013.0,11,21,-10
NZL,IDN,2014.0,6,4,2
DNK,BEL,2013.0,11,10,1
IRN,BRA,2011.0,6,1,5
SVN,HRV,2005.0,1,3,-2
ECU,MEX,2013.0,6,4,2
JPN,LKA,2018.0,12,12,0
NZL,PAK,2016.0,6,6,0
PHL,JPN,2015.0,21,33,-12
VNM,GBR,2022.0,15,11,4
BGD,DEU,2016.0,9,6,3
EST,CHE,2018.0,4,3,1
ETH,ZAF,2011.0,7,4,3
ISL,GBR,2021.0,8,7,1
ECU,ARG,2022.0,3,2,1
USA,PSE,2019.0,10,7,3
CUB,ARG,2018.0,4,1,3
IND,MEX,2004.0,8,2,6
GBR,PSE,2009.0,4,1,3
CHE,ARG,2006.0,3,4,-1
CHL,MEX,2010.0,16,15,1
SWE,NLD,2017.0,43,86,-43
POL,CHE,2011.0,23,12,11
NLD,AUS,1999.0,9,30,-21
BLR,POL,2008.0,6,4,2
FRA,PYF,2016.0,14,20,-6
ESP,NZL,2002.0,4,1,3
SAU,POL,2019.0,1,1,0
PHL,GBR,2019.0,6,9,-3
GBR,URY,2013.0,4,2,2
HRV,USA,2005.0,17,18,-1
DEU,PRT,2016.0,32,58,-26
AUS,FJI,2004.0,7,7,0
ISR,NLD,2000.0,8,6,2
JPN,CHL,2000.0,2,1,1
BIH,USA,2005.0,1,4,-3
ETH,MOZ,2019.0,1,1,0
EGY,LBN,2015.0,9,4,5
ESP,PRI,2007.0,4,3,1
SGP,BEL,2001.0,2,2,0
ISR,CHE,2011.0,16,11,5
SWE,ITA,2016.0,35,87,-52
FRA,LUX,2009.0,25,8,17
PRT,NLD,2002.0,9,14,-5
DEU,MDA,2007.0,1,1,0
POL,FIN,2023.0,4,5,-1
FRA,NER,2007.0,4,2,2
SRB,GBR,2009.0,5,10,-5
RUS,BLR,1998.0,19,26,-7
NGA,KWT,1997.0,1,1,0
FIN,LTU,2005.0,1,2,-1
SWE,IND,1997.0,5,4,1
GBR,SDN,2002.0,6,3,3
ITA,ISR,2010.0,11,12,-1
BRA,BOL,2005.0,2,1,1
JPN,UKR,2002.0,6,13,-7
ESP,RUS,2002.0,15,11,4
PRI,ARG,2016.0,2,1,1
BRA,COL,2002.0,10,3,7
RUS,CHE,2011.0,31,10,21
GBR,MLT,2002.0,4,4,0
IRL,POL,2007.0,2,2,0
POL,IRL,2009.0,10,4,6
HUN,RUS,2008.0,2,1,1
CHE,TWN,2007.0,6,3,3
JPN,BGD,2003.0,26,24,2
COL,CHL,2002.0,1,1,0
PAK,SGP,2003.0,2,1,1
DEU,LVA,1999.0,4,1,3
NOR,RUS,2010.0,18,13,5
BRA,URY,2001.0,3,2,1
SWE,BRA,2008.0,7,8,-1
RUS,HKG,1999.0,3,1,2
CZE,ITA,2011.0,5,7,-2
ITA,CHN,2010.0,20,28,-8
HUN,BEL,2010.0,6,4,2
DEU,LUX,2008.0,25,3,22
VEN,ARG,2022.0,5,2,3
NLD,RUS,1999.0,8,18,-10
BGD,HKG,2009.0,1,2,-1
HKG,BGD,2018.0,3,4,-1
USA,CRI,2010.0,14,24,-10
DEU,BRN,2012.0,1,1,0
NOR,CAN,2015.0,22,18,4
CHN,GBR,1997.0,41,57,-16
JPN,VEN,2011.0,1,1,0
ITA,FIN,2013.0,21,19,2
DNK,CHE,1999.0,9,11,-2
AUS,PHL,2003.0,9,7,2
CZE,JPN,2002.0,7,9,-2
NOR,ISL,2003.0,2,7,-5
ARG,ITA,2006.0,15,15,0
BEL,NOR,2011.0,7,3,4
SVN,BEL,2015.0,8,3,5
ISR,ITA,1997.0,6,7,-1
CZE,AUS,2018.0,5,8,-3
CAN,IND,2000.0,18,54,-36
IND,AUS,1999.0,24,19,5
CHN,RUS,2001.0,9,10,-1
SGP,ITA,2018.0,6,15,-9
CAN,SWE,2005.0,21,41,-20
GUF,FRA,2002.0,7,14,-7
SWE,SDN,2015.0,1,1,0
UZB,BEL,2014.0,1,1,0
UKR,GRC,2002.0,3,4,-1
CAN,PAK,2023.0,16,27,-11
NCL,FRA,1998.0,10,6,4
CAN,AUT,2008.0,8,14,-6
SWE,THA,2009.0,7,5,2
GRC,ITA,2009.0,25,20,5
DEU,MDA,1998.0,2,5,-3
MDA,DEU,2004.0,1,6,-5
ASM,USA,2010.0,7,2,5
GBR,PAK,1997.0,13,11,2
CZE,BGR,2014.0,1,1,0
USA,PRT,2020.0,79,62,17
HUN,CZE,2023.0,7,3,4
CAN,TWN,2021.0,9,17,-8
USA,CYP,2012.0,30,4,26
GBR,NPL,2008.0,3,7,-4
URY,BRA,2008.0,5,4,1
CAF,USA,2001.0,1,1,0
ISR,PRT,2014.0,1,3,-2
DNK,ISR,2006.0,5,1,4
IDN,NLD,2013.0,13,24,-11
DNK,CAN,2005.0,10,12,-2
FRA,VNM,2012.0,20,13,7
AUT,RUS,2006.0,11,8,3
HKG,KOR,2010.0,6,5,1
GBR,LUX,2009.0,6,3,3
BGD,KOR,2006.0,8,2,6
HKG,COL,2020.0,1,1,0
ZAF,ZWE,2009.0,4,23,-19
LUX,DEU,2008.0,3,25,-22
PAK,IND,2020.0,37,44,-7
DEU,IRQ,2017.0,7,2,5
DEU,CRI,2019.0,7,4,3
KOR,NOR,2017.0,4,4,0
AUS,ITA,2013.0,31,61,-30
SGP,TWN,2015.0,15,20,-5
CHL,COL,2014.0,16,19,-3
JPN,MAC,2016.0,1,1,0
BRA,JPN,2007.0,12,9,3
JPN,BRA,2011.0,18,6,12
ETH,AUS,2017.0,13,4,9
IND,AUT,2011.0,6,4,2
MYS,SDN,2015.0,9,4,5
PRT,DNK,2010.0,2,8,-6
ESP,CHN,2013.0,19,27,-8
ISR,IRL,2005.0,2,4,-2
ITA,COL,2011.0,10,2,8
BEL,BGD,2021.0,5,5,0
KWT,BHR,2013.0,1,1,0
ZMB,GBR,2013.0,3,12,-9
MEX,CZE,2019.0,3,1,2
SVK,AUT,2014.0,13,11,2
RUS,VNM,2014.0,11,1,10
TUR,IND,2014.0,2,3,-1
BRA,AUT,2019.0,16,6,10
JOR,TWN,2018.0,1,3,-2
FRA,BFA,2015.0,14,26,-12
IRN,POL,2016.0,4,4,0
FRA,HKG,2013.0,7,6,1
DNK,IRL,2014.0,3,6,-3
AUS,TUR,2014.0,5,14,-9
BEL,MOZ,2015.0,1,1,0
EST,LVA,2023.0,1,1,0
KEN,CHE,2014.0,1,6,-5
BEL,MYS,2015.0,3,3,0
CZE,CHE,2013.0,16,22,-6
SLV,SVK,2014.0,2,5,-3
LBY,QAT,2014.0,3,1,2
KWT,JOR,2016.0,1,7,-6
NOR,KOR,2009.0,3,1,2
DEU,BGR,2021.0,8,10,-2
GBR,SDN,2012.0,5,5,0
USA,BWA,2009.0,7,4,3
ZAF,MYS,2016.0,3,7,-4
ARE,USA,2009.0,10,42,-32
CHN,CHE,2011.0,49,38,11
MWI,ZAF,2016.0,10,8,2
IRN,NOR,2022.0,15,3,12
MEX,DEU,2006.0,19,18,1
PHL,GBR,2011.0,3,4,-1
GHA,DEU,2016.0,10,15,-5
IND,PRT,2021.0,9,11,-2
HKG,SGP,2004.0,22,20,2
GBR,MYS,1998.0,28,9,19
ETH,ESP,2017.0,4,3,1
KOR,NLD,2016.0,7,10,-3
REU,FRA,2018.0,22,31,-9
IRQ,MYS,2013.0,8,42,-34
SEN,BFA,2014.0,6,2,4
UZB,KOR,2019.0,3,4,-1
PRT,IND,2013.0,12,20,-8
VEN,DEU,2020.0,10,1,9
BHR,GBR,2020.0,8,5,3
KOR,ITA,2021.0,15,8,7
NOR,PAK,2017.0,11,2,9
ESP,ZAF,2023.0,5,8,-3
MYS,FRA,2018.0,5,8,-3
PRI,CRI,2016.0,2,1,1
COG,BEL,2017.0,10,12,-2
UKR,CZE,2015.0,6,2,4
SRB,SVN,2014.0,7,5,2
BIH,SRB,2014.0,25,17,8
AUS,DNK,2020.0,50,42,8
POL,DZA,2021.0,2,2,0
MAR,PRT,2020.0,4,4,0
BFA,CHE,2019.0,2,2,0
GBR,KAZ,2017.0,7,6,1
MEX,FRA,2011.0,32,59,-27
EGY,SSD,2016.0,1,1,0
KOR,SAU,2019.0,36,14,22
KOR,NOR,2022.0,9,4,5
GHA,JPN,2017.0,7,8,-1
DNK,FIN,2019.0,14,19,-5
IRL,CHE,2018.0,13,14,-1
ETH,KOR,2016.0,3,2,1
KOR,FRA,2016.0,30,28,2
CHL,PER,2014.0,6,2,4
ARM,COL,2019.0,2,1,1
SGP,TUR,2020.0,5,5,0
NZL,WSM,2020.0,1,1,0
ESP,DZA,2017.0,9,8,1
CAN,MYS,2000.0,1,1,0
AUT,CHN,2013.0,15,12,3
FRA,ROU,2021.0,22,25,-3
USA,BMU,2012.0,2,1,1
CAN,ARG,2022.0,7,23,-16
DZA,CAN,2008.0,4,3,1
IDN,HKG,2017.0,1,1,0
AUT,MEX,2019.0,4,7,-3
BEL,SAU,2016.0,5,2,3
QAT,GBR,2020.0,17,51,-34
USA,GRL,2021.0,2,1,1
JPN,NPL,2021.0,14,4,10
MEX,NLD,2022.0,10,7,3
TWN,JPN,2006.0,17,33,-16
JOR,ARE,2023.0,39,12,27
MRT,DEU,2016.0,1,1,0
CHL,NZL,2018.0,8,3,5
NOR,NLD,2023.0,16,20,-4
JPN,CZE,2016.0,13,13,0
JPN,ESP,2016.0,15,27,-12
DEU,PER,2019.0,7,10,-3
PSE,ESP,2017.0,2,2,0
BEL,RWA,2016.0,5,4,1
TUR,NOR,2022.0,10,1,9
PAK,DNK,2019.0,5,4,1
MCO,FRA,2021.0,10,9,1
ESP,SVN,2018.0,5,7,-2
LKA,AUS,2016.0,17,30,-13
HKG,NZL,2002.0,5,4,1
JPN,CZE,2022.0,7,9,-2
TWN,ETH,2021.0,13,4,9
UGA,ZAF,2017.0,8,12,-4
THA,NGA,2022.0,3,1,2
ISR,ARG,2013.0,2,2,0
CAN,POL,2023.0,8,5,3
NLD,BGD,2020.0,6,3,3
CHN,MYS,2011.0,7,9,-2
PAK,NZL,2022.0,3,5,-2
NCL,FRA,1999.0,10,12,-2
BRA,IRN,2022.0,9,8,1
DNK,HUN,2019.0,5,9,-4
MEX,ZAF,2002.0,3,1,2
BGD,JPN,2005.0,30,51,-21
EGY,GBR,2007.0,19,32,-13
IND,PRT,2019.0,15,13,2
CZE,NLD,2001.0,9,5,4
SAU,SVK,2021.0,1,1,0
MYS,ETH,2017.0,3,2,1
POL,IND,2012.0,3,3,0
IRL,JPN,2023.0,6,4,2
GBR,SYR,2022.0,3,6,-3
NOR,PAK,2018.0,2,1,1
ARE,FIN,2019.0,2,2,0
MYS,EGY,2016.0,6,7,-1
IRL,IRN,2022.0,2,24,-22
ARM,FRA,2021.0,1,2,-1
JAM,USA,2019.0,12,9,3
BGD,ITA,2020.0,4,3,1
KOR,SWE,2011.0,8,5,3
THA,CHN,2015.0,17,15,2
SAU,KOR,2022.0,14,23,-9
MLT,ITA,2021.0,8,5,3
HUN,GHA,2022.0,3,1,2
EGY,CAN,2023.0,20,22,-2
ITA,CYP,2018.0,2,3,-1
ROU,IRQ,2021.0,6,3,3
CZE,IRN,2022.0,6,22,-16
IND,ARE,2007.0,8,5,3
USA,MWI,2004.0,3,3,0
IRL,MEX,2019.0,1,3,-2
VNM,IRN,2021.0,10,12,-2
USA,GHA,2011.0,19,12,7
ESP,TWN,2015.0,4,3,1
CHN,FIN,2006.0,2,13,-11
CHN,FIN,2010.0,21,12,9
MWI,GBR,2021.0,21,20,1
CHN,PAK,2002.0,4,3,1
VEN,CHL,2005.0,5,4,1
CHN,THA,2007.0,11,2,9
AUS,UGA,2018.0,4,3,1
NOR,BRA,2022.0,7,13,-6
MEX,CZE,2011.0,3,4,-1
GBR,HRV,2009.0,6,2,4
ISR,DEU,2007.0,39,21,18
IND,NLD,2004.0,15,10,5
MYS,BGD,2005.0,5,5,0
SWE,IND,2005.0,7,14,-7
CZE,BEL,2006.0,2,7,-5
IRL,NZL,2008.0,11,8,3
TWN,KOR,1997.0,1,1,0
CHL,AUS,2010.0,9,7,2
DNK,RUS,2007.0,3,10,-7
THA,CHN,2004.0,3,3,0
ESP,FIN,2008.0,18,8,10
TUR,MEX,2008.0,5,1,4
CAN,KWT,2008.0,6,4,2
GRC,BRA,2014.0,2,3,-1
CHL,COL,2008.0,4,9,-5
HKG,IND,2021.0,8,22,-14
CZE,AUS,2016.0,6,7,-1
MYS,JOR,2011.0,9,4,5
ZAF,GRC,2022.0,3,3,0
NLD,KEN,2011.0,7,6,1
NLD,BOL,2008.0,2,1,1
KOR,SGP,2011.0,24,18,6
CAN,VEN,2009.0,3,1,2
BEL,TUN,2017.0,5,8,-3
TZA,CHE,2014.0,8,5,3
TUR,SOM,2022.0,10,1,9
AUS,CHN,2000.0,33,28,5
EGY,AUT,2004.0,1,4,-3
PRT,NLD,1997.0,8,4,4
GBR,POL,2011.0,40,63,-23
NZL,DEU,2006.0,15,28,-13
PAK,KOR,2013.0,32,14,18
AUS,IRN,2017.0,48,175,-127
MYS,KWT,2018.0,4,1,3
BRN,SGP,2011.0,2,2,0
ESP,SVN,2016.0,5,3,2
SRB,GRC,2008.0,3,4,-1
CHE,CHL,2002.0,6,4,2
ZWE,NLD,2008.0,3,3,0
BRA,SRB,2020.0,3,1,2
JPN,TUR,2013.0,13,6,7
USA,ROU,2004.0,15,33,-18
POL,AUS,2014.0,9,3,6
IND,LBY,2013.0,7,2,5
QAT,GBR,2007.0,2,4,-2
ZAF,NOR,2008.0,2,2,0
ESP,FIN,2015.0,25,13,12
HRV,SWE,1999.0,3,1,2
CAN,JOR,2009.0,7,5,2
AUS,COL,2017.0,10,10,0
EGY,AUT,2008.0,2,3,-1
SLV,SVK,2008.0,3,4,-1
FRA,NZL,2021.0,17,12,5
PSE,USA,2012.0,3,13,-10
USA,PSE,2013.0,7,3,4
CHE,POL,2006.0,9,9,0
PRT,CHL,1997.0,1,2,-1
CHL,PRT,2016.0,3,4,-1
CAN,GRC,2010.0,7,13,-6
BEL,HRV,2020.0,4,4,0
ZAF,ESP,2014.0,5,6,-1
ITA,TUR,2015.0,31,10,21
UGA,USA,2013.0,34,17,17
ROU,GBR,2006.0,13,7,6
TWN,THA,2007.0,4,2,2
OMN,USA,2015.0,4,10,-6
ZWE,NLD,2014.0,1,4,-3
AUT,SRB,2010.0,6,3,3
FIN,AUT,2006.0,6,6,0
IND,MEX,2023.0,8,5,3
UKR,CHE,2015.0,3,1,2
BEL,PER,2012.0,1,2,-1
NLD,FIN,2012.0,12,20,-8
JPN,BRA,2009.0,11,9,2
JPN,BGR,2012.0,4,2,2
ESP,MYS,2016.0,3,4,-1
BIH,SRB,2001.0,4,5,-1
JPN,SVK,2011.0,2,3,-1
DNK,NZL,2013.0,3,11,-8
CHE,MEX,2019.0,5,6,-1
PAK,ARE,2014.0,8,4,4
CAN,ITA,2015.0,53,88,-35
FRA,IRL,2013.0,35,29,6
PSE,DEU,2006.0,3,3,0
BGR,IRL,2015.0,1,2,-1
PHL,IND,2013.0,8,3,5
CHE,TZA,2014.0,5,8,-3
HUN,CAN,2006.0,4,11,-7
TZA,NOR,2006.0,3,4,-1
NOR,JPN,2021.0,5,6,-1
MTQ,GUF,2007.0,1,1,0
SGP,TWN,2001.0,4,3,1
NZL,SAU,2009.0,1,1,0
CZE,FIN,2020.0,3,9,-6
DNK,ITA,2012.0,21,31,-10
FRA,MLI,2019.0,23,9,14
AUS,NGA,2018.0,5,10,-5
ETH,DEU,2022.0,13,12,1
MEX,BEL,2022.0,7,5,2
BEL,EST,2021.0,2,3,-1
CRI,CHL,2017.0,2,3,-1
NLD,MMR,2021.0,1,1,0
FRA,BEN,2018.0,19,14,5
AUS,NOR,2016.0,23,16,7
USA,GHA,2021.0,35,53,-18
NLD,CAN,1997.0,24,18,6
EGY,YEM,2019.0,11,4,7
USA,ISL,2020.0,16,11,5
SWE,IDN,2022.0,2,4,-2
KOR,NLD,2022.0,13,13,0
DEU,SRB,2019.0,11,25,-14
LKA,IND,2016.0,2,6,-4
SWE,URY,2001.0,5,2,3
CHN,POL,2015.0,6,3,3
HRV,GBR,2016.0,14,10,4
KAZ,POL,2023.0,1,2,-1
QAT,CAN,2017.0,11,19,-8
IRN,MYS,2019.0,30,101,-71
CAN,CHL,2018.0,22,25,-3
BRA,NZL,2019.0,12,4,8
MMR,IND,2017.0,1,1,0
ESP,PAN,2021.0,12,1,11
KOR,CZE,2021.0,4,2,2
USA,KHM,2015.0,8,8,0
BEL,BFA,2018.0,7,1,6
GBR,BRB,2021.0,2,2,0
SVN,USA,2023.0,8,9,-1
IRN,NLD,2017.0,30,30,0
ITA,EST,2020.0,7,4,3
PAK,BRA,2015.0,11,13,-2
LBN,BEL,2018.0,5,9,-4
BIH,TUR,2019.0,2,5,-3
MAR,ARE,2017.0,3,3,0
AUT,THA,2019.0,6,5,1
CHN,CHE,2009.0,30,50,-20
LTU,ITA,2020.0,6,4,2
IDN,FRA,1998.0,5,3,2
GUM,USA,1997.0,4,2,2
MEX,BRA,2001.0,6,4,2
USA,SRB,1998.0,23,28,-5
DEU,LUX,2001.0,6,2,4
IND,BWA,2006.0,1,1,0
JPN,ISR,2003.0,7,5,2
BEN,FRA,2003.0,5,9,-4
ROU,DNK,2006.0,2,2,0
KWT,CAN,2006.0,5,12,-7
OMN,SAU,2013.0,2,3,-1
LBN,FRA,1999.0,15,23,-8
PRT,GRC,2007.0,5,2,3
ZAF,CMR,2017.0,6,5,1
CAN,SRB,1999.0,4,4,0
TZA,USA,2011.0,14,6,8
THA,CHE,2005.0,3,2,1
SVN,CHE,2007.0,3,2,1
RUS,FIN,2008.0,16,15,1
NGA,NLD,2001.0,1,2,-1
RUS,MDA,1998.0,3,2,1
UGA,KEN,2011.0,5,4,1
VEN,FRA,2006.0,4,7,-3
ZAF,FRA,2007.0,11,9,2
BEL,LBN,2017.0,10,5,5
BIH,HRV,2023.0,7,4,3
ROU,IRL,2008.0,4,1,3
AUS,SRB,1999.0,2,3,-1
CAN,PHL,2004.0,1,2,-1
NOR,POL,2014.0,4,12,-8
JAM,USA,2009.0,12,9,3
JAM,USA,2011.0,6,15,-9
USA,JAM,2014.0,10,9,1
CRI,CIV,2018.0,2,4,-2
ITA,SVK,2013.0,5,2,3
LKA,DEU,2011.0,2,2,0
OMN,AUS,2000.0,1,3,-2
LBY,EGY,2020.0,3,7,-4
COL,GBR,1999.0,6,6,0
PAK,CAN,2005.0,12,4,8
CAN,HRV,2007.0,2,3,-1
IND,MEX,2006.0,6,3,3
AUS,MEX,1997.0,1,3,-2
ECU,FRA,2006.0,5,4,1
DEU,DZA,2014.0,1,2,-1
POL,SVK,2014.0,3,6,-3
TCD,FRA,2008.0,1,1,0
SGP,BEL,2008.0,2,1,1
COL,KEN,2001.0,1,1,0
USA,UGA,1998.0,4,6,-2
GBR,PHL,2011.0,4,3,1
FRA,GUF,1998.0,9,2,7
BEL,RUS,2020.0,7,17,-10
NZL,TON,2006.0,1,1,0
RUS,AUT,1999.0,9,7,2
SLV,SVK,2004.0,3,1,2
EGY,IND,2008.0,2,3,-1
FIN,NZL,2003.0,2,1,1
SWE,SRB,2009.0,2,2,0
OMN,ARE,2009.0,1,2,-1
EST,DEU,2011.0,8,4,4
DEU,SDN,2006.0,7,3,4
ARM,USA,1998.0,8,3,5
ITA,PRT,2007.0,13,2,11
JOR,DEU,2002.0,6,8,-2
DEU,KEN,2002.0,4,6,-2
EGY,OMN,2013.0,6,4,2
SVK,SWE,2001.0,4,2,2
BGR,BEL,2018.0,3,10,-7
ZAF,DEU,2005.0,11,18,-7
ZAF,AUT,2015.0,5,8,-3
GRC,JPN,1999.0,1,2,-1
JPN,GRC,2000.0,3,7,-4
HRV,JPN,2014.0,2,2,0
ZAF,CAN,1998.0,13,7,6
BRB,TTO,2003.0,1,1,0
USA,GUM,2015.0,5,4,1
DEU,MKD,2003.0,1,2,-1
SRB,ALB,2010.0,2,4,-2
BEL,NZL,2008.0,3,4,-1
CHE,PHL,2014.0,2,3,-1
ECU,USA,2005.0,8,5,3
TTO,JAM,2004.0,1,2,-1
BHR,GBR,1999.0,1,4,-3
NOR,CHE,2000.0,6,4,2
ESP,CHE,1999.0,23,22,1
BEL,PRT,2002.0,3,8,-5
KWT,CAN,2000.0,3,3,0
URY,SWE,2002.0,1,2,-1
SAU,IND,1999.0,4,7,-3
SWE,GRC,1999.0,6,4,2
USA,ZWE,2001.0,8,17,-9
JPN,DNK,2006.0,11,5,6
IND,JOR,2001.0,1,2,-1
CAN,THA,2009.0,18,21,-3
FRA,SVK,2009.0,8,3,5
ISR,TUR,2002.0,4,3,1
CHE,SWE,2000.0,24,30,-6
MRT,FRA,2019.0,3,4,-1
KWT,DEU,2002.0,1,1,0
USA,NPL,2004.0,6,7,-1
SRB,CHE,2006.0,5,5,0
MYS,BGR,2017.0,1,1,0
BEL,ESP,2000.0,20,23,-3
TZA,USA,2019.0,24,20,4
NOR,BEL,2012.0,3,4,-1
JAM,GBR,2007.0,5,2,3
AUS,IRL,2005.0,25,29,-4
NLD,PRT,1999.0,10,13,-3
SAU,FRA,2020.0,12,44,-32
NOR,SGP,2006.0,1,3,-2
IND,KOR,1999.0,6,6,0
FRA,MCO,2011.0,13,4,9
BEL,SWE,2013.0,27,17,10
TUR,NOR,2017.0,6,1,5
BOL,USA,2004.0,6,2,4
ITA,PRT,1999.0,9,4,5
TWN,CAN,2005.0,11,10,1
AUS,BEL,1997.0,6,4,2
CAN,KEN,1998.0,6,5,1
CHE,AUT,2004.0,32,26,6
ISL,USA,2004.0,14,18,-4
ETH,UGA,2020.0,1,4,-3
VEN,GBR,2002.0,4,13,-9
BLZ,USA,2003.0,2,1,1
BWA,ZAF,2009.0,15,7,8
ZAF,BWA,2010.0,4,7,-3
CAN,MAR,2009.0,12,9,3
DEU,KAZ,2005.0,1,1,0
ROU,PRT,2001.0,3,1,2
IND,NOR,2000.0,2,1,1
ITA,IRL,2011.0,29,14,15
AUT,JPN,2002.0,8,9,-1
CHE,TUN,2002.0,3,1,2
HUN,ITA,2002.0,13,13,0
JPN,SVN,2002.0,2,1,1
NLD,KEN,2009.0,8,5,3
ZAF,ISR,2009.0,1,1,0
ESP,MOZ,2006.0,2,2,0
CHN,PRT,2022.0,16,14,2
BEL,COG,2013.0,7,7,0
FRA,NCL,2015.0,27,24,3
ISL,USA,2014.0,11,10,1
UKR,CAN,2001.0,6,4,2
USA,KNA,2010.0,2,1,1
DEU,MWI,2003.0,1,2,-1
GBR,TTO,2011.0,8,5,3
EST,CAN,2017.0,2,1,1
MEX,DNK,2013.0,4,3,1
FRA,TCD,2009.0,1,1,0
JOR,AUS,2020.0,9,18,-9
ISR,JPN,2005.0,4,5,-1
KWT,CAN,2010.0,5,9,-4
AUS,FIN,2019.0,16,14,2
BEL,DZA,1997.0,1,2,-1
CHE,CMR,2007.0,3,2,1
NGA,BWA,2004.0,3,2,1
IRQ,GRC,2020.0,1,2,-1
CHL,GBR,2011.0,14,33,-19
IRN,FIN,2011.0,6,6,0
GBR,GHA,2009.0,15,7,8
PER,ITA,2008.0,1,1,0
FIN,PRT,2012.0,3,2,1
FRA,CHL,2015.0,56,33,23
AUS,FIN,2011.0,13,15,-2
HRV,HUN,2022.0,7,3,4
CHE,CMR,2020.0,2,5,-3
CUB,BRA,2004.0,6,5,1
PRT,KWT,2011.0,1,1,0
KEN,CAN,2009.0,6,2,4
USA,IRQ,2011.0,11,8,3
PER,VEN,2010.0,2,1,1
ZAF,MWI,2014.0,3,12,-9
SWE,TUR,2020.0,14,25,-11
SGP,THA,2016.0,11,4,7
BEL,VNM,2012.0,7,6,1
BEL,GHA,2017.0,2,2,0
CRI,MEX,2012.0,1,9,-8
HRV,AUS,2022.0,1,4,-3
DEU,SRB,2011.0,10,13,-3
CHE,UKR,2009.0,3,2,1
SGP,DNK,2015.0,4,3,1
TUN,ARE,2023.0,3,2,1
IND,NZL,2009.0,8,3,5
NLD,PAK,2012.0,12,7,5
MYS,SWE,2020.0,9,5,4
DNK,SGP,2011.0,2,2,0
UKR,ESP,2008.0,6,1,5
NLD,EGY,2006.0,3,1,2
TJK,USA,2010.0,1,2,-1
USA,GHA,2009.0,6,5,1
SGP,AUT,2019.0,2,4,-2
FIN,IND,2018.0,9,23,-14
QAT,JOR,2018.0,8,5,3
GRC,ESP,2013.0,26,17,9
ZAF,KEN,2021.0,34,18,16
EGY,LBN,2014.0,6,3,3
ZAF,CHE,2012.0,13,14,-1
CHE,CZE,2017.0,14,24,-10
CHE,NZL,2022.0,9,8,1
EGY,KWT,2018.0,3,9,-6
TWN,IRN,2005.0,2,1,1
TWN,IRN,2012.0,1,2,-1
IRN,TWN,2013.0,3,1,2
CZE,ITA,2009.0,7,4,3
JPN,AUT,2014.0,13,10,3
DEU,HRV,2011.0,9,10,-1
ESP,URY,2006.0,7,9,-2
SWE,SAU,2013.0,8,1,7
MAR,USA,2016.0,16,4,12
ROU,CHE,2009.0,3,5,-2
IND,IDN,2012.0,19,14,5
ITA,DZA,2019.0,9,4,5
VEN,ITA,2010.0,4,2,2
OMN,JOR,2010.0,2,4,-2
KEN,DEU,2009.0,7,9,-2
BWA,ZAF,2021.0,12,13,-1
SWE,ISL,2023.0,5,13,-8
SYR,FRA,2013.0,1,10,-9
CHE,NZL,2018.0,12,20,-8
AUT,CAN,2011.0,21,25,-4
BEL,IRN,2010.0,8,11,-3
UGA,SWE,2013.0,1,3,-2
AFG,AUS,2018.0,1,1,0
EGY,YEM,2009.0,10,1,9
FRA,COL,2015.0,18,20,-2
GBR,HUN,2009.0,27,31,-4
MCO,FRA,2019.0,5,22,-17
AUT,NOR,2018.0,15,8,7
LBN,BEL,2016.0,3,2,1
NGA,NLD,2014.0,3,1,2
ZMB,NLD,2020.0,4,3,1
PYF,FRA,2022.0,12,13,-1
ETH,IND,2018.0,29,62,-33
HRV,SRB,2023.0,4,5,-1
ARE,CAN,2013.0,8,30,-22
NLD,NZL,2017.0,28,13,15
JPN,IRL,2016.0,6,3,3
CRI,ESP,2019.0,9,9,0
NZL,FIN,2016.0,3,1,2
DNK,RUS,1999.0,4,9,-5
ARG,CHL,2011.0,29,17,12
GHA,MYS,2017.0,2,2,0
GHA,CAN,2015.0,7,8,-1
CMR,ZAF,2015.0,5,12,-7
ESP,MCO,2011.0,1,1,0
SLV,SVK,2015.0,9,6,3
PAK,KWT,2021.0,1,1,0
DEU,MYS,2013.0,14,9,5
NIC,USA,2014.0,5,5,0
USA,COD,2014.0,1,3,-2
KOR,IRN,2013.0,9,11,-2
CHL,NZL,2017.0,5,6,-1
IND,NZL,2011.0,5,12,-7
ITA,PAK,2014.0,9,14,-5
ZAF,CHN,2023.0,6,7,-1
IND,LKA,2019.0,9,7,2
THA,KOR,2014.0,6,5,1
BEL,HUN,2018.0,9,12,-3
PSE,DEU,2010.0,3,6,-3
NOR,CHE,2010.0,16,12,4
BEL,ISR,2004.0,9,1,8
MYS,PRT,2017.0,3,1,2
BEL,LKA,2010.0,2,1,1
NZL,LKA,2014.0,5,2,3
CHE,HUN,2015.0,12,17,-5
BEL,IRL,2014.0,7,10,-3
LTU,GBR,2015.0,5,11,-6
KEN,MWI,2016.0,2,1,1
THA,MYS,2006.0,4,2,2
TZA,CHE,2015.0,3,9,-6
MEX,CHL,2017.0,21,17,4
NZL,CHE,2017.0,13,9,4
IDN,SGP,2014.0,2,6,-4
HRV,FRA,2021.0,3,3,0
DNK,IRL,2015.0,5,4,1
LUX,CHE,2020.0,11,3,8
KHM,LAO,2018.0,1,1,0
IRN,FRA,2013.0,18,20,-2
NER,NGA,2018.0,12,9,3
GBR,LUX,2021.0,15,14,1
NLD,MEX,2023.0,5,13,-8
ESP,SVK,2014.0,2,2,0
KWT,EGY,2013.0,15,14,1
IND,OMN,1998.0,7,1,6
CZE,AUT,2015.0,17,16,1
FRA,CYP,2017.0,4,3,1
URY,BRA,2015.0,11,9,2
JPN,BEL,2014.0,19,24,-5
CIV,CHE,2019.0,4,2,2
BWA,ZAF,2019.0,9,16,-7
KOR,SGP,2009.0,17,17,0
EST,AUT,2017.0,2,2,0
AUT,EST,2020.0,3,1,2
GBR,PER,2020.0,7,9,-2
BRA,CHN,2005.0,7,1,6
CHE,SGP,2022.0,18,24,-6
POL,SVN,2013.0,4,1,3
NLD,HRV,2012.0,4,6,-2
BRA,CZE,2013.0,5,5,0
GBR,TTO,2021.0,6,7,-1
CMR,BRA,2017.0,2,1,1
KEN,UGA,2021.0,11,12,-1
NZL,COL,2022.0,3,2,1
VEN,CUB,2014.0,2,1,1
ZAF,BEN,2019.0,4,2,2
FRA,CYP,2022.0,3,7,-4
AUT,HUN,2014.0,14,27,-13
BRN,SGP,2019.0,1,2,-1
FRA,NCL,2014.0,26,26,0
CHE,SAU,2014.0,7,2,5
CHL,MEX,2023.0,10,10,0
LUX,BEL,2023.0,7,16,-9
SWE,ETH,2014.0,6,2,4
ITA,SVN,2018.0,12,11,1
LTU,CHE,2020.0,3,3,0
DNK,PAK,2018.0,6,4,2
MEX,SWE,2017.0,6,7,-1
LVA,USA,2015.0,4,10,-6
AUS,ETH,2020.0,13,32,-19
SWZ,USA,2012.0,1,1,0
KWT,JOR,2018.0,5,9,-4
RUS,BRA,2023.0,6,3,3
ISR,ITA,2005.0,8,3,5
NLD,ETH,2014.0,6,13,-7
TWN,DNK,2023.0,2,1,1
CAN,GHA,2020.0,13,8,5
ESP,HKG,2016.0,2,6,-4
CZE,PRT,2021.0,4,7,-3
FIN,GRC,2018.0,4,4,0
NGA,NZL,2016.0,2,1,1
BEL,HUN,2016.0,9,11,-2
BFA,BEN,2015.0,13,1,12
MYS,DEU,2015.0,17,7,10
SDN,CHN,2018.0,5,16,-11
CZE,ARE,2022.0,2,3,-1
MLI,SEN,2016.0,2,3,-1
CAN,CMR,2006.0,1,3,-2
AUS,UGA,2017.0,3,7,-4
MYS,IND,2006.0,19,25,-6
PAK,IRL,2012.0,1,1,0
ZAF,SGP,2020.0,11,11,0
ITA,ARG,2022.0,11,26,-15
USA,BGD,2011.0,23,33,-10
BEL,KOR,2018.0,8,11,-3
VEN,DOM,2016.0,2,1,1
NGA,BEN,2020.0,4,5,-1
FRA,ETH,2018.0,4,2,2
DEU,JOR,2020.0,14,11,3
PRT,MAR,2015.0,1,2,-1
USA,LUX,2017.0,11,11,0
AUT,CHN,2003.0,6,8,-2
ZAF,DNK,2022.0,5,2,3
TUR,SAU,2019.0,8,11,-3
PRT,MYS,2012.0,3,1,2
IRL,ITA,2007.0,8,12,-4
USA,UGA,1999.0,9,3,6
MAR,SAU,2023.0,2,1,1
ISR,IRN,2019.0,3,1,2
FRA,URY,2011.0,5,6,-1
IRL,UKR,2002.0,1,1,0
NLD,SWE,2004.0,27,24,3
IRL,MYS,2017.0,5,7,-2
CUB,CAN,2017.0,13,3,10
CHE,ISR,2001.0,7,12,-5
NGA,SAU,2016.0,2,1,1
AUT,CZE,2020.0,18,24,-6
KOR,POL,2023.0,7,3,4
BRA,FIN,2016.0,6,11,-5
ZAF,EGY,2021.0,3,2,1
IND,FIN,2022.0,24,8,16
PHL,TWN,2020.0,15,12,3
CZE,RUS,2017.0,15,19,-4
SWE,NZL,2022.0,4,14,-10
VNM,CHN,2018.0,5,30,-25
GRC,NOR,2021.0,7,4,3
RWA,USA,2019.0,13,20,-7
AUS,ARG,2018.0,5,7,-2
CHN,TZA,2023.0,10,8,2
AUS,JAM,2020.0,2,1,1
DNK,IND,2021.0,13,29,-16
SAU,MAR,2018.0,5,3,2
CHN,PRT,2016.0,4,14,-10
TUR,AUT,2021.0,8,8,0
TZA,GBR,2019.0,16,7,9
ITA,AUS,1998.0,5,14,-9
URY,ESP,2020.0,16,19,-3
ITA,VNM,2020.0,7,3,4
CZE,VNM,2021.0,11,6,5
COL,SAU,2020.0,2,1,1
SGP,THA,2022.0,10,1,9
HKG,PHL,2020.0,4,4,0
NLD,PER,2020.0,2,5,-3
MEX,FIN,2019.0,5,2,3
KEN,BWA,2017.0,1,1,0
PER,DEU,2022.0,6,4,2
DNK,GRC,1999.0,1,1,0
ECU,BEL,2019.0,3,9,-6
NLD,JOR,2019.0,3,1,2
TWN,IND,2024.0,1,3,-2
HUN,VNM,2019.0,2,2,0
AUT,BRA,2018.0,13,8,5
ZAF,SWE,2021.0,22,6,16
FRA,SVK,2019.0,2,5,-3
LKA,NZL,2018.0,4,4,0
GBR,IDN,2020.0,54,38,16
CAN,CRI,2018.0,4,1,3
TTO,GBR,2019.0,7,10,-3
CAN,BGD,2006.0,2,6,-4
NLD,ETH,2008.0,5,1,4
URY,USA,2014.0,9,15,-6
TUR,IRN,2009.0,2,7,-5
TZA,GBR,2009.0,9,11,-2
BEL,BLR,2004.0,4,3,1
MYS,BHR,2021.0,5,1,4
CMR,DEU,2009.0,7,3,4
CMR,DEU,2011.0,5,6,-1
BRN,MYS,2022.0,3,11,-8
MDG,FRA,2022.0,3,7,-4
PAK,ESP,2022.0,9,7,2
PAK,IRQ,2019.0,4,1,3
SAU,FIN,2020.0,3,1,2
JPN,KHM,2021.0,7,1,6
RUS,TUR,2021.0,4,7,-3
BRA,PRY,2021.0,5,3,2
RUS,UKR,2023.0,14,60,-46
BEN,CAN,2018.0,1,3,-2
KOR,UGA,2021.0,1,3,-2
LTU,LVA,2021.0,4,6,-2
JOR,MYS,2021.0,9,44,-35
IND,GHA,2015.0,3,2,1
MAC,TWN,2021.0,2,2,0
MYS,IDN,2008.0,12,1,11
MKD,SRB,2022.0,8,6,2
MWI,FIN,2016.0,3,1,2
MNE,AUT,2022.0,1,2,-1
BEL,CZE,2018.0,10,11,-1
KEN,NGA,2017.0,4,5,-1
ARG,CZE,2016.0,3,1,2
NOR,MYS,2018.0,2,7,-5
MYS,ITA,2015.0,6,1,5
ZAF,JPN,2016.0,6,3,3
ITA,ARG,2017.0,14,20,-6
MYS,DZA,2016.0,3,1,2
LKA,NZL,2017.0,2,3,-1
RUS,EGY,2017.0,2,8,-6
DNK,PAK,2022.0,5,2,3
ARG,PRT,2014.0,4,3,1
USA,FSM,2015.0,3,2,1
USA,BRA,2024.0,5,3,2
SWZ,CHE,2019.0,7,5,2
BGD,SWE,2019.0,10,2,8
CHN,VNM,2019.0,31,17,14
ARE,NOR,2020.0,3,1,2
LKA,CHN,2023.0,4,5,-1
BEL,NOR,2019.0,10,8,2
BFA,BEL,2017.0,5,1,4
THA,BGD,2018.0,3,2,1
REU,FRA,2017.0,28,28,0
JPN,PAK,2017.0,10,1,9
TWN,POL,2019.0,4,1,3
PHL,CHN,2021.0,8,6,2
ECU,ESP,2023.0,24,42,-18
SGP,BEL,2015.0,8,11,-3
CZE,CHN,2010.0,4,1,3
PRT,IRN,2016.0,8,11,-3
GHA,DNK,2020.0,1,3,-2
DNK,GHA,2021.0,5,1,4
ISR,CHL,2021.0,4,4,0
MMR,SGP,2019.0,2,1,1
SLE,LBR,2017.0,1,1,0
NLD,POL,2008.0,9,20,-11
NLD,ISL,2016.0,3,3,0
MAR,ZAF,2022.0,1,5,-4
MLI,BEN,2022.0,1,1,0
TZA,NLD,2013.0,5,2,3
ALB,USA,2019.0,1,1,0
CHN,NGA,2017.0,8,16,-8
THA,ESP,2022.0,2,3,-1
ZWE,KEN,2020.0,3,1,2
PRT,ROU,2015.0,2,2,0
SAU,IND,2007.0,5,7,-2
TWN,MWI,2019.0,1,1,0
POL,NZL,2017.0,1,1,0
FIN,CHE,2023.0,15,13,2
CMR,IND,2020.0,4,3,1
SWE,TUR,2007.0,4,4,0
ESP,TUN,2019.0,4,7,-3
LKA,IND,2017.0,5,8,-3
KAZ,SAU,2019.0,4,4,0
TUR,CHN,2023.0,11,5,6
EGY,AUS,2016.0,12,3,9
BHR,USA,2019.0,5,5,0
BFA,BEN,2014.0,4,3,1
SAU,AUT,2018.0,2,1,1
BOL,BRA,2020.0,1,5,-4
SDN,IDN,2020.0,1,1,0
JPN,KHM,2019.0,5,1,4
ZWE,USA,2020.0,4,12,-8
PRT,FIN,2015.0,5,4,1
CZE,TUR,2020.0,7,11,-4
HKG,SAU,2021.0,2,6,-4
HKG,NGA,2020.0,2,3,-1
ZAF,KNA,2021.0,2,1,1
TUR,ARE,2023.0,7,4,3
GBR,KAZ,2016.0,9,2,7
MEX,AUS,2021.0,12,8,4
CAN,MWI,2010.0,2,1,1
COL,PER,2020.0,8,4,4
PAN,GBR,2022.0,3,3,0
CRI,BRA,2015.0,7,1,6
ITA,EGY,2006.0,3,3,0
ECU,CHN,2018.0,3,2,1
LVA,LTU,2005.0,3,2,1
MYS,NLD,2012.0,4,9,-5
PAN,AUS,2010.0,2,1,1
FIN,DNK,2023.0,9,14,-5
TUN,BEL,2012.0,2,1,1
THA,LKA,2022.0,2,2,0
PAK,NGA,2020.0,2,3,-1
JPN,NPL,2011.0,8,2,6
DNK,ROU,2008.0,8,2,6
IRQ,IRN,2022.0,11,21,-10
PAK,BGD,2005.0,2,7,-5
NZL,MAR,2023.0,2,1,1
CZE,NGA,2021.0,1,1,0
LTU,SWE,2023.0,3,3,0
KOR,FIN,2009.0,3,1,2
FIN,GRC,2022.0,3,2,1
ROU,GRC,2023.0,4,1,3
CZE,IRL,2019.0,3,7,-4
BOL,ARG,2021.0,1,2,-1
AZE,RUS,2022.0,2,5,-3
CHN,NZL,2008.0,5,5,0
ARG,SWE,2022.0,5,4,1
NLD,KEN,2021.0,7,4,3
QAT,IRN,2017.0,1,3,-2
FJI,NZL,2022.0,4,4,0
BRN,GBR,2022.0,2,2,0
LTU,PAK,2021.0,1,3,-2
AUS,BWA,2021.0,2,1,1
SAU,FRA,1999.0,1,1,0
OMN,IRN,2022.0,3,10,-7
FRA,PSE,2020.0,3,1,2
NGA,CMR,1997.0,2,1,1
THA,NZL,2004.0,2,1,1
EST,CHE,2012.0,6,3,3
CYP,GRC,2004.0,5,5,0
CZE,ESP,2011.0,6,8,-2
SWE,EGY,2004.0,3,1,2
IRL,DNK,2006.0,3,6,-3
ZAF,BWA,2006.0,2,7,-5
AUS,HUN,2006.0,3,3,0
NIC,SWE,2007.0,2,3,-1
LTU,USA,2002.0,7,9,-2
USA,LTU,2011.0,8,6,2
UGA,USA,2003.0,6,19,-13
KEN,TZA,2007.0,2,1,1
KOR,GBR,1997.0,9,17,-8
DEU,CHL,2008.0,21,21,0
KWT,GBR,2008.0,7,6,1
ESP,PHL,2003.0,4,16,-12
GBR,BWA,2008.0,4,2,2
LTU,LVA,2011.0,2,2,0
MDA,DEU,2014.0,3,3,0
FRA,MCO,2009.0,4,18,-14
CHL,AUS,2006.0,6,3,3
HUN,CHE,2002.0,12,3,9
ETH,ZAF,2013.0,9,8,1
ISR,PSE,2009.0,15,8,7
NOR,UGA,2001.0,2,1,1
RUS,GEO,2014.0,3,2,1
IDN,JPN,2007.0,15,55,-40
FRA,LAO,2015.0,4,3,1
UGA,CHE,2013.0,6,3,3
SWE,LKA,1997.0,1,1,0
ARE,EGY,1998.0,3,4,-1
NLD,MEX,2010.0,9,7,2
FRA,HRV,2012.0,3,8,-5
DNK,GRL,2013.0,5,3,2
FIN,ITA,2005.0,13,13,0
SVK,BEL,2002.0,4,2,2
ZAF,NGA,2004.0,5,12,-7
MYS,NPL,2020.0,1,2,-1
DEU,THA,2003.0,6,9,-3
GLP,FRA,2002.0,13,18,-5
FRA,COD,2022.0,1,4,-3
GHA,NLD,2009.0,3,1,2
RUS,GEO,2008.0,3,4,-1
RUS,GEO,2015.0,7,2,5
MEX,ITA,2010.0,12,7,5
CRI,USA,2002.0,10,24,-14
TWN,DEU,2005.0,9,12,-3
USA,MAR,2003.0,9,4,5
NGA,BFA,2022.0,3,1,2
GUF,FRA,2005.0,10,7,3
GEO,DEU,1997.0,7,2,5
USA,CMR,2019.0,6,9,-3
CZE,AUS,2017.0,8,13,-5
FIN,NAM,2020.0,1,1,0
NZL,PRT,2015.0,2,1,1
SAU,TUR,2001.0,1,2,-1
RUS,GEO,2004.0,6,6,0
ESP,GRC,2008.0,9,21,-12
ITA,RUS,2014.0,21,16,5
NOR,AUS,2006.0,9,3,6
NLD,BGR,2006.0,3,1,2
FIN,THA,2010.0,3,1,2
POL,CZE,1999.0,3,18,-15
SVN,SVK,2003.0,6,13,-7
CHE,GRC,2018.0,15,36,-21
GBR,ZWE,2002.0,7,9,-2
AUT,EGY,2005.0,3,2,1
BRA,AGO,2014.0,5,1,4
JOR,TUR,2017.0,1,5,-4
USA,SYR,2010.0,4,2,2
ECU,CAN,2005.0,2,1,1
ISR,AUS,2008.0,8,12,-4
ARM,BEL,2003.0,1,1,0
DNK,DZA,2019.0,1,1,0
DZA,ESP,2011.0,2,3,-1
JPN,POL,2019.0,12,11,1
CZE,UKR,1997.0,2,2,0
PRT,POL,2009.0,8,8,0
SVN,SLV,2008.0,2,2,0
VEN,FRA,2000.0,5,8,-3
GBR,BLR,2002.0,2,8,-6
BFA,TGO,2010.0,1,1,0
LKA,GBR,2003.0,5,14,-9
OMN,GBR,2002.0,6,5,1
HRV,BIH,2000.0,8,6,2
USA,ZWE,2008.0,7,6,1
PHL,GBR,2009.0,3,5,-2
TZA,NGA,2003.0,1,1,0
ESP,TUR,2015.0,13,10,3
EGY,LBY,2012.0,5,3,2
IRQ,JOR,1997.0,1,1,0
GRC,MEX,2007.0,2,1,1
GBR,ARG,2007.0,15,8,7
ZAF,MWI,2015.0,5,6,-1
NLD,TUR,1998.0,2,2,0
BEL,COG,2003.0,7,1,6
SVN,FRA,2007.0,4,4,0
SAU,DZA,2011.0,2,7,-5
BEL,SYR,2010.0,2,1,1
MEX,VEN,2006.0,6,4,2
COD,FRA,2010.0,1,1,0
NGA,BEN,2007.0,4,3,1
CAN,LBN,2003.0,5,2,3
USA,OMN,2010.0,10,4,6
IRN,DEU,2004.0,8,13,-5
SAU,KWT,2020.0,11,1,10
NLD,PSE,2009.0,1,1,0
NOR,CAN,2001.0,14,5,9
ARG,PRT,2015.0,3,6,-3
AUS,ARE,2011.0,10,4,6
ISR,AUT,2013.0,7,4,3
FIN,JPN,2013.0,13,17,-4
CHN,TUR,2015.0,8,6,2
ESP,RUS,1997.0,10,9,1
DEU,BGR,2011.0,13,11,2
POL,ARG,1998.0,1,1,0
TUR,JPN,2016.0,8,14,-6
FRA,PER,2021.0,10,5,5
IND,NOR,2010.0,10,3,7
ZAF,ETH,2012.0,6,4,2
IRL,IND,2010.0,12,17,-5
ARG,ITA,2010.0,15,11,4
SEN,TGO,2012.0,1,2,-1
SRB,ESP,2017.0,2,5,-3
SGP,NZL,1997.0,4,3,1
NOR,ESP,2009.0,6,15,-9
ARE,MYS,2020.0,6,35,-29
HRV,ITA,2015.0,5,12,-7
GUM,USA,2012.0,10,6,4
NGA,UGA,2007.0,1,1,0
FIN,AUT,2010.0,5,7,-2
AUT,FIN,2012.0,10,7,3
COL,DNK,2014.0,3,1,2
TZA,NLD,2003.0,1,3,-2
GHA,USA,2000.0,4,2,2
NGA,LKA,2011.0,1,1,0
PRT,DNK,2006.0,3,3,0
CHN,PER,2021.0,3,1,2
IRL,AUS,2001.0,12,14,-2
SVK,DEU,2015.0,14,6,8
IRL,PRT,2010.0,7,3,4
SWE,BGR,2005.0,3,2,1
GBR,BWA,2001.0,5,1,4
HKG,FIN,2004.0,2,1,1
SGP,PAK,2012.0,3,6,-3
IND,KEN,2006.0,3,2,1
NZL,VNM,2018.0,5,6,-1
BRN,MYS,2018.0,6,5,1
EGY,KOR,2009.0,5,4,1
KOR,EGY,2015.0,10,3,7
HUN,IND,2004.0,1,1,0
NZL,FRA,2008.0,15,15,0
EGY,BHR,2008.0,1,1,0
CAN,MAR,2019.0,6,10,-4
KOR,NPL,2015.0,8,5,3
DEU,ZAF,2005.0,18,11,7
ITA,CHL,2012.0,5,7,-2
VNM,SGP,2011.0,2,4,-2
QAT,USA,2005.0,4,9,-5
CHN,NLD,2005.0,14,26,-12
HUN,ROU,2008.0,11,5,6
ROU,GBR,2010.0,20,6,14
BRA,URY,2014.0,11,8,3
AFG,GBR,2005.0,1,1,0
AUT,GRC,2005.0,2,2,0
IRN,DEU,2008.0,20,26,-6
USA,BLZ,2021.0,4,2,2
IND,KEN,2023.0,3,1,2
RUS,ARG,2016.0,2,1,1
HUN,CHE,2012.0,20,6,14
IND,AUT,2009.0,7,7,0
RUS,KGZ,2007.0,3,2,1
USA,HRV,2020.0,14,14,0
SVK,CHE,2010.0,5,1,4
TUR,AUT,2009.0,3,4,-1
NOR,POL,2008.0,7,7,0
SWE,THA,2011.0,3,9,-6
TTO,GRD,2020.0,2,1,1
ISR,IND,2009.0,11,25,-14
BRN,GBR,2018.0,4,12,-8
AUT,KOR,2014.0,3,5,-2
SWE,SGP,2007.0,10,4,6
ISR,BRA,2016.0,5,4,1
ITA,UZB,2013.0,1,1,0
IRL,ZAF,2006.0,3,1,2
VEN,SWE,2004.0,2,1,1
CZE,NLD,2004.0,6,3,3
ROU,DEU,2008.0,16,39,-23
PHL,NLD,1998.0,1,2,-1
BEL,MEX,2012.0,2,4,-2
CHL,COL,2015.0,24,20,4
CAN,CUB,2008.0,1,4,-3
CZE,NLD,2008.0,7,4,3
FRA,NZL,2011.0,17,17,0
SVN,USA,2006.0,14,11,3
CHN,BRA,1999.0,2,3,-1
SAU,ARE,2002.0,7,8,-1
SWE,ETH,2004.0,5,1,4
CAN,HUN,2006.0,11,4,7
NGA,JPN,2008.0,6,4,2
CAN,HUN,2010.0,7,5,2
FIN,DNK,2010.0,10,7,3
IRL,GRC,2017.0,2,13,-11
SWE,BRA,2014.0,15,15,0
CZE,MEX,2013.0,2,3,-1
GBR,VNM,2010.0,16,20,-4
CHE,THA,2005.0,2,3,-1
MYS,ARE,2012.0,6,1,5
CHE,NZL,2017.0,9,13,-4
IDN,THA,2013.0,5,2,3
RWA,UGA,2013.0,1,1,0
IRN,JPN,2009.0,12,23,-11
MAR,MLI,2011.0,1,1,0
IRN,BRA,2013.0,2,2,0
FRA,BGR,2012.0,13,3,10
CAN,IRQ,2011.0,1,1,0
IRL,SGP,2007.0,2,1,1
ZAF,SWE,2011.0,3,5,-2
MYS,BEL,2019.0,4,3,1
SRB,AUT,2014.0,6,4,2
BRA,IRN,2017.0,5,14,-9
FRA,LUX,2021.0,24,25,-1
BRA,ITA,2011.0,34,47,-13
PAK,EGY,2014.0,1,4,-3
PRT,CAN,2010.0,3,5,-2
ESP,ECU,2014.0,31,9,22
TTO,GBR,2011.0,5,8,-3
IND,ERI,2010.0,2,2,0
USA,NIC,2018.0,3,5,-2
NLD,ROU,2008.0,6,8,-2
IRL,BEL,2012.0,11,7,4
FIN,IRN,2011.0,6,6,0
IRL,IRN,2017.0,9,6,3
GBR,MWI,2011.0,27,18,9
ISR,HUN,2021.0,2,3,-1
ZWE,FRA,2016.0,1,0,1
COL,CHN,2021.0,4,0,4
ESP,PHL,2015.0,4,0,4
BWA,FJI,2014.0,1,0,1
GBR,BLZ,2018.0,1,0,1
GBR,BLZ,2022.0,2,0,2
HRV,IRL,2018.0,4,0,4
SVK,SAU,2008.0,2,0,2
SWE,PAN,2019.0,1,0,1
ECU,NOR,2022.0,1,0,1
NGA,PAK,2005.0,2,0,2
OMN,KOR,2008.0,1,0,1
BLR,CHE,2023.0,7,0,7
MLT,,2013.0,12,0,12
IRQ,TUN,2022.0,7,0,7
GIN,USA,2018.0,2,0,2
FJI,,2005.0,6,0,6
,MOZ,2017.0,100,0,100
BGD,IDN,2020.0,2,0,2
VNM,CZE,2010.0,1,0,1
,LAO,2018.0,28,0,28
URY,CAN,2022.0,4,0,4
JAM,FIN,2022.0,1,0,1
,SLV,2017.0,16,0,16
SLV,,2023.0,46,0,46
,PAN,2017.0,71,0,71
PHL,GTM,2020.0,1,0,1
UGA,AUS,2010.0,1,0,1
AUT,PYF,2008.0,1,0,1
YEM,,2013.0,20,0,20
LAO,,2018.0,28,0,28
TUN,QAT,2020.0,12,0,12
KOR,ESP,2009.0,3,0,3
DZA,DNK,2020.0,4,0,4
,MAC,2004.0,28,0,28
ALB,BRA,2003.0,1,0,1
,MLT,2005.0,42,0,42
,NER,2001.0,11,0,11
ITA,MDA,2010.0,3,0,3
FRA,MNG,2009.0,1,0,1
,ATG,2004.0,2,0,2
,REU,2005.0,12,0,12
COG,,2011.0,24,0,24
IRQ,,2008.0,18,0,18
SWE,LTU,2011.0,3,0,3
KEN,SVK,2021.0,4,0,4
MWI,DEU,2005.0,5,0,5
BFA,,2011.0,25,0,25
,SYC,2013.0,11,0,11
SWE,IRN,2005.0,2,0,2
SOM,,2019.0,9,0,9
,TGO,2000.0,18,0,18
PRT,AUS,2005.0,5,0,5
MNP,CUB,2006.0,1,0,1
NGA,BRA,2007.0,2,0,2
ZMB,TZA,2007.0,1,0,1
,MUS,1999.0,13,0,13
SVN,PRT,2012.0,3,0,3
SVK,SWE,2013.0,6,0,6
TTO,,2010.0,32,0,32
LBN,AUS,2009.0,2,0,2
SGP,MMR,2003.0,3,0,3
,OMN,2004.0,79,0,79
,MMR,2001.0,13,0,13
,ALB,2006.0,40,0,40
BLZ,,2009.0,2,0,2
ALB,,2000.0,6,0,6
,VUT,2004.0,3,0,3
BWA,HRV,2008.0,1,0,1
BRA,IRQ,2010.0,1,0,1
MEX,HUN,2013.0,1,0,1
KOR,KAZ,2011.0,1,0,1
FRA,TZA,2001.0,1,0,1
TZA,CHE,2003.0,1,0,1
ARM,KOR,2013.0,1,0,1
MAC,,2009.0,11,0,11
BGD,NOR,2006.0,1,0,1
BRB,,2008.0,17,0,17
JOR,ARE,2009.0,9,0,9
,BEN,1998.0,28,0,28
MLI,CAN,2014.0,1,0,1
RWA,ZWE,2018.0,2,0,2
BRA,SVN,2011.0,2,0,2
ARM,,2010.0,68,0,68
,KGZ,2004.0,28,0,28
ISL,NZL,2016.0,1,0,1
IRN,GEO,2020.0,3,0,3
JPN,BRN,2019.0,2,0,2
ALB,ARG,2020.0,5,0,5
USA,MLT,2004.0,1,0,1
SOM,,2021.0,12,0,12
TUN,CZE,2019.0,5,0,5
FRA,ISL,2017.0,4,0,4
SEN,ZWE,2003.0,1,0,1
SWE,MOZ,2017.0,3,0,3
USA,NER,2014.0,3,0,3
GTM,ITA,2020.0,1,0,1
ARG,PAN,2020.0,3,0,3
KAZ,ZAF,2018.0,1,0,1
JOR,IRL,2020.0,4,0,4
BGD,DNK,2019.0,2,0,2
MYS,ISR,2004.0,3,0,3
IRL,MAC,2021.0,1,0,1
VEN,GBR,2020.0,6,0,6
SDN,,2003.0,10,0,10
GBR,AGO,2015.0,1,0,1
MNG,BEL,2020.0,1,0,1
ITA,PRK,2018.0,1,0,1
KEN,DJI,2020.0,1,0,1
CIV,SEN,2017.0,3,0,3
BEL,BEN,2003.0,5,0,5
ZWE,HKG,2001.0,2,0,2
ESP,MLT,2007.0,1,0,1
BHR,AUS,2004.0,1,0,1
YEM,CAN,2001.0,2,0,2
USA,MKD,1997.0,2,0,2
JPN,KWT,2004.0,1,0,1
IRL,BRB,2012.0,1,0,1
ARM,,2006.0,66,0,66
ESP,BIH,2004.0,1,0,1
PAN,,2006.0,10,0,10
NGA,BRA,1998.0,3,0,3
ARM,UKR,2000.0,1,0,1
BWA,POL,2010.0,1,0,1
,ZMB,1997.0,24,0,24
,QAT,1998.0,27,0,27
TUN,TGO,2002.0,2,0,2
NGA,BEN,1997.0,2,0,2
LVA,,2005.0,44,0,44
IRL,LUX,2010.0,2,0,2
BIH,,2005.0,8,0,8
SVK,SWE,2003.0,3,0,3
MCO,,2013.0,9,0,9
NER,MLI,2009.0,1,0,1
MLI,NER,2012.0,1,0,1
LVA,JPN,2000.0,4,0,4
JPN,LVA,2003.0,1,0,1
PNG,,2002.0,10,0,10
ARM,COL,2000.0,1,0,1
FIN,SRB,2002.0,1,0,1
UZB,AZE,2002.0,1,0,1
COG,CHE,1998.0,1,0,1
SWE,URY,2003.0,1,0,1
SEN,RWA,2022.0,2,0,2
ZAF,SGP,2002.0,2,0,2
ALB,ESP,1997.0,1,0,1
ITA,GHA,2011.0,3,0,3
ISR,LVA,2008.0,1,0,1
GUM,,2017.0,6,0,6
NGA,COL,2000.0,2,0,2
NER,GBR,2015.0,1,0,1
COL,UGA,2003.0,1,0,1
FIN,IRN,2000.0,1,0,1
SVN,ISR,2007.0,1,0,1
ISR,SVN,2008.0,1,0,1
CYP,CAN,2017.0,5,0,5
IND,SEN,2001.0,1,0,1
ARG,POL,2009.0,1,0,1
DZA,TUN,2002.0,1,0,1
PRI,HRV,2012.0,1,0,1
BHR,,2001.0,10,0,10
JOR,LBN,2000.0,1,0,1
,MCO,2000.0,11,0,11
ECU,CUB,2007.0,2,0,2
LBN,JOR,2006.0,1,0,1
BEL,MLI,2006.0,1,0,1
GHA,ETH,2014.0,1,0,1
CYP,ITA,2009.0,1,0,1
ZWE,,2005.0,19,0,19
CAN,HRV,2005.0,1,0,1
BEL,MEX,1999.0,5,0,5
BRA,GRC,2005.0,2,0,2
TWN,LVA,2009.0,1,0,1
IDN,MNG,2013.0,1,0,1
CAN,TUN,1999.0,7,0,7
JPN,MNE,2004.0,1,0,1
DEU,RWA,2003.0,1,0,1
RUS,HRV,2012.0,1,0,1
DZA,MAR,2007.0,2,0,2
NLD,EGY,2011.0,3,0,3
KAZ,DEU,1999.0,2,0,2
SDN,CHE,2008.0,1,0,1
ISR,GEO,2002.0,1,0,1
SUR,,2014.0,5,0,5
CUB,DOM,2012.0,1,0,1
SVK,SLV,2009.0,8,0,8
ETH,NGA,2012.0,1,0,1
,SWZ,2006.0,12,0,12
,PYF,2003.0,9,0,9
PYF,,2010.0,5,0,5
CZE,LTU,2009.0,2,0,2
ZMB,ZAF,2007.0,2,0,2
IDN,ROU,2016.0,1,0,1
CMR,AUS,2009.0,1,0,1
NOR,LTU,2004.0,1,0,1
ITA,PRY,2001.0,1,0,1
,MCO,2006.0,5,0,5
VEN,PER,2012.0,1,0,1
PAK,IRL,2007.0,3,0,3
GBR,URY,2015.0,2,0,2
SOM,SDN,2009.0,1,0,1
BGR,IRL,2013.0,2,0,2
BEL,NER,2020.0,3,0,3
MKD,MEX,2019.0,1,0,1
MNE,USA,2020.0,2,0,2
COL,LUX,2020.0,1,0,1
KOR,TZA,2018.0,2,0,2
AFG,,2011.0,3,0,3
ASM,,2015.0,1,0,1
,ERI,2002.0,5,0,5
KAZ,CAN,2024.0,1,0,1
AUS,PYF,2022.0,2,0,2
PAK,KGZ,2011.0,1,0,1
ITA,ALB,2014.0,4,0,4
JPN,IRQ,2010.0,1,0,1
UKR,JPN,2023.0,2,0,2
BWA,LSO,2018.0,1,0,1
MOZ,LBR,2014.0,1,0,1
TUR,COL,2016.0,1,0,1
ZAF,AFG,2019.0,1,0,1
,BTN,2009.0,20,0,20
HUN,VNM,2006.0,1,0,1
MYS,IRN,1999.0,1,0,1
PLW,GBR,2016.0,1,0,1
MAC,POL,2003.0,1,0,1
MAC,PRT,2014.0,3,0,3
PHL,LAO,2021.0,1,0,1
MRT,USA,2015.0,1,0,1
GTM,,2016.0,21,0,21
SUR,,2015.0,4,0,4
PAN,AUS,2021.0,1,0,1
PRI,IRN,2019.0,1,0,1
ARM,TWN,2006.0,3,0,3
ECU,GBR,2010.0,1,0,1
TON,,2017.0,1,0,1
SEN,BFA,2013.0,6,0,6
THA,BTN,2013.0,3,0,3
CHE,MLI,2021.0,2,0,2
BWA,ZAF,2024.0,1,0,1
GTM,CHL,2012.0,3,0,3
CHL,GTM,2014.0,3,0,3
DNK,ETH,2021.0,5,0,5
EST,AUS,2016.0,5,0,5
BEN,DEU,2024.0,1,0,1
NER,DNK,2003.0,1,0,1
,PNG,2012.0,42,0,42
COL,SAU,2012.0,2,0,2
PRT,SGP,2018.0,7,0,7
CHL,BGD,2016.0,1,0,1
ZAF,CZE,2004.0,1,0,1
AUS,LTU,2020.0,3,0,3
CCK,,2025.0,8,0,8
VUT,,2016.0,3,0,3
ZMB,CHE,2022.0,2,0,2
JPN,ROU,2018.0,2,0,2
BRN,IDN,2021.0,1,0,1
ECU,DEU,2005.0,3,0,3
PRI,IND,2009.0,3,0,3
MAR,BEN,2018.0,3,0,3
VNM,ZAF,2015.0,2,0,2
BRA,ISL,2021.0,2,0,2
EST,TUR,2020.0,1,0,1
YEM,,2003.0,9,0,9
SEN,COG,2017.0,1,0,1
NAM,CHE,2019.0,2,0,2
PAK,OMN,2008.0,2,0,2
,TLS,2012.0,7,0,7
IND,TLS,2018.0,1,0,1
GRC,BOL,2008.0,1,0,1
POL,ISR,2015.0,3,0,3
CHE,MNG,2014.0,1,0,1
NIC,,2008.0,6,0,6
ZMB,,2001.0,8,0,8
SLB,AUS,1999.0,1,0,1
URY,BOL,2001.0,1,0,1
THA,BEL,2024.0,1,0,1
SWE,MOZ,2018.0,5,0,5
KOR,MEX,2020.0,5,0,5
CAN,BMU,2020.0,4,0,4
PSE,OMN,2023.0,1,0,1
ESP,MDA,2022.0,1,0,1
TUR,AUT,2023.0,7,0,7
IRL,KAZ,2018.0,1,0,1
,CPV,2015.0,10,0,10
MLI,,2007.0,4,0,4
UGA,KOR,2018.0,1,0,1
CPV,,2020.0,7,0,7
ISR,MWI,2023.0,1,0,1
BIH,BRA,2019.0,3,0,3
BRA,MAC,2019.0,3,0,3
ECU,,2002.0,9,0,9
CHE,PAK,2017.0,1,0,1
,ERI,2005.0,6,0,6
PSE,,2005.0,9,0,9
COL,HND,2020.0,1,0,1
LBY,,2003.0,13,0,13
CHN,COD,2021.0,3,0,3
SGS,USA,2022.0,1,0,1
PNG,KOR,2021.0,1,0,1
QAT,SDN,2008.0,3,0,3
BRA,BFA,2022.0,2,0,2
OMN,ITA,2023.0,1,0,1
RUS,MNG,2022.0,2,0,2
USA,SYC,2015.0,1,0,1
TCD,PRT,2018.0,1,0,1
BGR,IND,2022.0,3,0,3
TON,,2022.0,3,0,3
BRA,KOR,2013.0,4,0,4
PER,ISR,2021.0,1,0,1
GRC,BGR,2013.0,4,0,4
TLS,,2019.0,6,0,6
HKG,ESP,2020.0,1,0,1
NZL,TON,2009.0,1,0,1
CRI,KHM,2016.0,1,0,1
GHA,HUN,2021.0,2,0,2
JPN,MAR,2017.0,2,0,2
BRB,SWE,2017.0,1,0,1
MEX,KEN,2014.0,1,0,1
BRB,IND,2014.0,1,0,1
CHL,CRI,2004.0,1,0,1
BLR,SGP,2014.0,1,0,1
CAN,SVK,2017.0,2,0,2
CHN,FJI,2021.0,2,0,2
ITA,NER,2021.0,2,0,2
,ATG,2015.0,2,0,2
AUT,RWA,2021.0,1,0,1
KAZ,LTU,2021.0,1,0,1
NZL,KGZ,2019.0,1,0,1
KEN,PAK,2016.0,3,0,3
MDG,CAN,2019.0,1,0,1
SLE,,2019.0,38,0,38
BLR,PRT,2001.0,4,0,4
BRA,PAN,2004.0,2,0,2
TTO,BHS,2019.0,1,0,1
JPN,LSO,2022.0,1,0,1
EST,IDN,2017.0,1,0,1
THA,CYP,2019.0,1,0,1
UGA,,2007.0,22,0,22
CYP,,2009.0,22,0,22
NZL,SAU,2023.0,1,0,1
NZL,MAR,2021.0,2,0,2
ETH,COG,2006.0,2,0,2
ETH,SWZ,2019.0,1,0,1
IRL,TCA,2021.0,1,0,1
BRB,VCT,2023.0,1,0,1
RWA,KOR,2018.0,1,0,1
EGY,TWN,2019.0,4,0,4
IRN,QAT,2014.0,3,0,3
LKA,IRL,2023.0,3,0,3
CAN,LUX,2021.0,5,0,5
ZAF,SOM,2022.0,2,0,2
BEL,ISL,2003.0,1,0,1
SYC,,2006.0,2,0,2
AZE,UKR,2007.0,1,0,1
,BEN,1999.0,15,0,15
TJK,RUS,2014.0,6,0,6
ETH,ERI,1997.0,1,0,1
FIN,ROU,1997.0,1,0,1
DEU,LBY,2009.0,3,0,3
EST,ETH,2013.0,1,0,1
URY,ZAF,2003.0,4,0,4
SWE,COL,2006.0,2,0,2
TZA,NGA,2014.0,3,0,3
AUS,MEX,1998.0,4,0,4
POL,HRV,2022.0,3,0,3
ARG,ZAF,2005.0,1,0,1
ZMB,,2014.0,21,0,21
DNK,BFA,2006.0,1,0,1
,KGZ,2001.0,10,0,10
ISR,CRI,2003.0,1,0,1
NER,,2010.0,7,0,7
MUS,,2002.0,4,0,4
KGZ,DEU,2000.0,1,0,1
SYR,,2007.0,18,0,18
THA,PHL,2008.0,2,0,2
BRA,PAN,2015.0,2,0,2
USA,GAB,2001.0,2,0,2
GAB,USA,2002.0,2,0,2
GRC,AUT,2002.0,6,0,6
BLR,ESP,1997.0,2,0,2
OMN,CHE,2003.0,1,0,1
PNG,,2012.0,14,0,14
ZAF,NAM,2005.0,1,0,1
BWA,NAM,2021.0,1,0,1
GRD,ESP,2007.0,1,0,1
CHN,UKR,2003.0,1,0,1
BLR,SRB,2001.0,1,0,1
PNG,,2005.0,13,0,13
NLD,LBY,2016.0,1,0,1
CMR,ITA,2002.0,1,0,1
BRA,UKR,2015.0,1,0,1
,COD,1998.0,1,0,1
,COM,1999.0,1,0,1
,COM,1998.0,2,0,2
NPL,CHN,1999.0,1,0,1
CHN,NPL,2001.0,1,0,1
KEN,IDN,2013.0,1,0,1
KGZ,,2002.0,7,0,7
GTM,GBR,1999.0,4,0,4
JPN,MDG,2003.0,2,0,2
MKD,CHE,2021.0,2,0,2
AUT,NPL,2014.0,1,0,1
SWE,UGA,2005.0,2,0,2
HRV,MAR,2010.0,5,0,5
PRI,PER,2007.0,1,0,1
AUS,YEM,2003.0,1,0,1
BIH,,2002.0,6,0,6
AFG,CZE,2002.0,1,0,1
SLB,,2017.0,16,0,16
QAT,SDN,2015.0,1,0,1
,VUT,1996.0,5,0,5
GEO,DEU,1999.0,2,0,2
BGR,KWT,2006.0,1,0,1
GBR,YEM,2012.0,1,0,1
,NCL,1997.0,7,0,7
FJI,USA,2005.0,5,0,5
USA,MOZ,2005.0,1,0,1
,RWA,1996.0,5,0,5
TZA,,2001.0,15,0,15
NLD,BIH,2010.0,1,0,1
SRB,ALB,2009.0,3,0,3
ROU,SGP,2015.0,2,0,2
MLT,NLD,2007.0,3,0,3
BGD,LKA,2004.0,1,0,1
URY,CHL,2012.0,6,0,6
MAR,BEN,2017.0,2,0,2
USA,KAZ,2005.0,3,0,3
DMA,,2008.0,3,0,3
FIN,NZL,2001.0,1,0,1
COL,ZAF,2023.0,2,0,2
GMB,GHA,2015.0,2,0,2
ZAF,GMB,2013.0,7,0,7
USA,LAO,2004.0,1,0,1
BEL,PAK,2009.0,1,0,1
GRC,EGY,2018.0,3,0,3
NOR,BGR,2022.0,1,0,1
DZA,ARE,1997.0,2,0,2
VNM,SEN,2020.0,1,0,1
LUX,MEX,2014.0,1,0,1
UKR,CZE,2003.0,4,0,4
,DOM,2003.0,11,0,11
DEU,YEM,2007.0,1,0,1
SGP,SEN,2010.0,1,0,1
ARG,RUS,2022.0,3,0,3
GBR,BRN,2011.0,6,0,6
ZMB,NOR,2010.0,1,0,1
IND,CYM,2015.0,1,0,1
OMN,QAT,2023.0,2,0,2
JAM,BRB,2010.0,2,0,2
DNK,NGA,2017.0,1,0,1
AUS,BIH,2017.0,1,0,1
AFG,TWN,2021.0,1,0,1
BRA,EST,2018.0,4,0,4
BTN,,2015.0,2,0,2
LBN,CHL,2010.0,2,0,2
,GUF,2005.0,11,0,11
GRC,CHL,2014.0,3,0,3
UZB,FIN,2017.0,1,0,1
MUS,,2012.0,10,0,10
JPN,QAT,2020.0,1,0,1
,BEN,2007.0,63,0,63
SLV,NLD,2016.0,1,0,1
SLV,CHL,2021.0,1,0,1
CHL,SLV,2023.0,1,0,1
PHL,IDN,2013.0,3,0,3
BRB,,2014.0,8,0,8
,AND,2007.0,3,0,3
IND,ABW,2019.0,1,0,1
CAN,RWA,2013.0,5,0,5
DEU,ISL,2008.0,4,0,4
KOR,TZA,2016.0,2,0,2
URY,CAN,2018.0,1,0,1
SAU,DNK,2014.0,1,0,1
,ZMB,2002.0,30,0,30
ITA,DZA,2006.0,4,0,4
ISR,SVK,2018.0,2,0,2
SVK,ISR,2020.0,1,0,1
LBY,CAN,2010.0,1,0,1
NPL,OMN,2020.0,1,0,1
ZMB,CHE,2018.0,2,0,2
PRI,COL,2016.0,1,0,1
,SLB,2010.0,7,0,7
IND,LBY,2008.0,10,0,10
NOR,SAU,2014.0,3,0,3
TZA,CHN,1997.0,1,0,1
SWZ,TZA,2021.0,2,0,2
BLR,LVA,2019.0,1,0,1
AUS,MAC,2013.0,3,0,3
PRI,GBR,2003.0,2,0,2
TUR,ROU,2017.0,2,0,2
TCD,,2021.0,13,0,13
CAN,PYF,2020.0,2,0,2
PYF,CAN,2021.0,1,0,1
IND,SYR,2012.0,1,0,1
CUB,FRA,2013.0,7,0,7
RUS,IND,2008.0,6,0,6
BEL,TTO,2015.0,2,0,2
JPN,PAN,2019.0,1,0,1
TWN,MAR,2016.0,4,0,4
SRB,AUT,2013.0,6,0,6
SGP,RWA,2019.0,1,0,1
CAN,NOR,2024.0,1,0,1
BRN,USA,2023.0,2,0,2
AGO,ITA,2018.0,1,0,1
SGP,PRT,2019.0,2,0,2
PSE,GRD,2019.0,1,0,1
FRA,SRB,1997.0,3,0,3
CHN,SLE,2020.0,6,0,6
VUT,,2022.0,4,0,4
LAO,BRA,2017.0,2,0,2
,VUT,2014.0,4,0,4
PSE,,2012.0,13,0,13
PRT,LUX,2016.0,3,0,3
UGA,JPN,2018.0,3,0,3
IRL,NAM,2017.0,1,0,1
PRY,ARG,2012.0,1,0,1
ARG,PRY,2021.0,3,0,3
TUR,MDV,2020.0,1,0,1
SYC,,2023.0,14,0,14
LKA,PRT,2023.0,1,0,1
HKG,BEL,2019.0,2,0,2
BRA,GHA,2022.0,1,0,1
GBR,LAO,2006.0,1,0,1
ESP,RWA,2019.0,1,0,1
MEX,EGY,2021.0,4,0,4
BGR,KOR,2009.0,1,0,1
BLR,IND,2010.0,3,0,3
PER,JPN,2002.0,1,0,1
NOR,UGA,2013.0,4,0,4
MKD,ALB,2023.0,1,0,1
MWI,SWE,2022.0,1,0,1
AFG,KOR,2022.0,1,0,1
USA,BFA,2016.0,4,0,4
TJK,MYS,2014.0,1,0,1
PRT,BGD,2015.0,2,0,2
MDA,USA,2023.0,1,0,1
,TCD,2016.0,18,0,18
ITA,TCD,2018.0,1,0,1
,ARM,2019.0,136,0,136
MUS,PAK,2014.0,1,0,1
BWA,KEN,2013.0,1,0,1
CUB,GBR,2020.0,2,0,2
AUS,ZAF,2006.0,12,27,-15
USA,NIC,2007.0,4,3,1
JPN,SVK,2004.0,3,1,2
ARG,TUR,2018.0,11,4,7
NZL,ZAF,2013.0,5,8,-3
IRN,IND,1997.0,1,5,-4
SGP,HKG,2009.0,26,36,-10
BRA,IND,1997.0,1,3,-2
BEL,FIN,2001.0,3,1,2
CAN,PRT,2003.0,7,7,0
NLD,KEN,2014.0,11,9,2
MDA,ESP,2007.0,2,2,0
BRN,AUS,1997.0,1,2,-1
SWE,IRL,2009.0,15,12,3
USA,ETH,2015.0,21,27,-6
AUS,ETH,2022.0,10,22,-12
MEX,JPN,2017.0,14,5,9
PER,MEX,2016.0,12,7,5
BGD,AUS,2002.0,3,2,1
DEU,CHL,2011.0,21,30,-9
SWE,LVA,2017.0,4,5,-1
DEU,HKG,2018.0,19,16,3
HUN,CAN,2013.0,15,5,10
CAN,CUB,2011.0,6,4,2
ISR,AUS,2009.0,28,9,19
MYS,ITA,2011.0,3,1,2
USA,SEN,2001.0,2,5,-3
TWN,JPN,2013.0,30,33,-3
DEU,IRN,2010.0,29,46,-17
DEU,TWN,2008.0,16,20,-4
SWE,TUR,2016.0,10,14,-4
ASM,USA,2013.0,1,3,-2
FRA,NZL,2015.0,10,18,-8
JPN,CHE,2016.0,37,42,-5
CHL,BRA,2013.0,19,12,7
SAU,FRA,2022.0,19,28,-9
PHL,FRA,2012.0,3,1,2
PRT,BRA,2008.0,55,65,-10
NOR,IND,2011.0,6,10,-4
MYS,BRN,2011.0,3,1,2
GNB,DNK,2002.0,5,3,2
PAK,DEU,1999.0,5,5,0
DEU,PAK,2001.0,7,8,-1
MTQ,USA,2012.0,1,1,0
EGY,KOR,2015.0,3,10,-7
UKR,FRA,2016.0,15,12,3
IND,KWT,2017.0,7,3,4
BGR,GBR,2013.0,11,8,3
CAN,PRT,2013.0,8,11,-3
BWA,AUS,2013.0,3,1,2
QAT,EGY,2013.0,3,6,-3
MYS,CAN,2017.0,33,8,25
TZA,SWE,2020.0,10,6,4
COL,ECU,2015.0,6,1,5
HRV,GBR,2020.0,8,10,-2
POL,CZE,2016.0,26,11,15
ESP,CHN,2000.0,5,4,1
THA,KOR,2019.0,15,10,5
LBN,CAN,2013.0,7,12,-5
NZL,ITA,2016.0,8,8,0
BRA,SWE,2015.0,23,10,13
GBR,PER,2022.0,16,9,7
ALB,DEU,2017.0,2,4,-2
ITA,PRT,2016.0,31,30,1
KEN,FRA,1997.0,2,1,1
FRA,ZAF,2010.0,29,17,12
GBR,SRB,2016.0,9,12,-3
BEL,NZL,2021.0,6,2,4
BEL,HRV,2018.0,1,4,-3
TZA,DEU,2014.0,4,6,-2
POL,DNK,2016.0,9,7,2
DEU,IRL,1997.0,4,6,-2
SWE,TUR,2018.0,7,26,-19
AUS,ARE,2014.0,14,12,2
KOR,NOR,2007.0,2,2,0
BWA,USA,2010.0,10,9,1
IND,NLD,2011.0,20,17,3
NGA,GBR,2003.0,10,30,-20
PRT,NOR,2021.0,10,11,-1
LUX,USA,2019.0,6,13,-7
CAN,NGA,2020.0,6,26,-20
FIN,IRN,2015.0,4,13,-9
BGR,JPN,2015.0,1,5,-4
PHL,IND,2000.0,8,3,5
CAN,ARE,2015.0,28,8,20
HUN,DNK,2022.0,8,4,4
FRA,NZL,2008.0,15,15,0
MWI,GBR,2001.0,6,7,-1
CHN,CHE,2004.0,11,17,-6
CHN,PRK,2016.0,4,3,1
NCL,FRA,2016.0,28,26,2
FRA,BFA,2019.0,15,12,3
BHR,GBR,2017.0,3,10,-7
MAR,MLI,2015.0,4,1,3
MEX,CHE,2021.0,17,6,11
MAR,CAN,1999.0,4,4,0
USA,LTU,2015.0,8,5,3
NZL,LKA,2019.0,8,2,6
ZAF,RWA,2022.0,3,1,2
THA,ITA,2017.0,5,1,4
CAN,DZA,2016.0,9,4,5
NZL,IRL,2013.0,3,6,-3
PRT,TUN,2020.0,2,5,-3
GRD,USA,2017.0,12,12,0
NZL,WSM,2016.0,3,1,2
KEN,JPN,2017.0,10,12,-2
CHN,BRA,2016.0,10,8,2
JOR,SYR,2016.0,1,5,-4
UGA,NLD,2013.0,2,2,0
CHL,VEN,2011.0,3,6,-3
SGP,GBR,2000.0,26,52,-26
ZWE,CHE,2006.0,4,1,3
BGD,SAU,2018.0,4,8,-4
MNG,AUS,2020.0,1,1,0
MLT,USA,2017.0,3,2,1
IDN,DEU,2017.0,12,31,-19
ROU,USA,2012.0,19,38,-19
SAU,JPN,2019.0,8,22,-14
UKR,CHE,2019.0,4,1,3
TZA,UGA,2018.0,2,2,0
TZA,CHN,2016.0,3,2,1
HRV,DNK,2021.0,3,2,1
AUS,BRA,2014.0,19,52,-33
NPL,NOR,2015.0,4,3,1
POL,HUN,2020.0,7,4,3
PSE,IRN,2019.0,1,1,0
LTU,ITA,2016.0,3,2,1
GBR,LUX,2014.0,7,5,2
CHN,THA,2018.0,32,37,-5
GBR,IDN,2018.0,34,24,10
JPN,BEL,2019.0,15,18,-3
IDN,HUN,2021.0,10,1,9
DNK,PAK,2020.0,7,7,0
DEU,UGA,2021.0,5,5,0
IRN,TUR,2015.0,21,8,13
GBR,BGD,2006.0,12,6,6
GBR,BGD,2010.0,15,8,7
ARE,EGY,2016.0,12,14,-2
FRA,POL,2023.0,22,29,-7
LUX,CAN,2017.0,4,2,2
VNM,SGP,2015.0,3,3,0
AUS,NPL,2016.0,7,13,-6
MYS,THA,2018.0,22,5,17
ETH,TWN,2014.0,2,1,1
CZE,HUN,2018.0,3,8,-5
DNK,GRC,2018.0,4,10,-6
IRN,SVK,2018.0,2,1,1
JPN,AUT,2011.0,7,11,-4
PAK,ITA,2020.0,20,16,4
IND,ISR,2012.0,17,15,2
BGD,THA,2012.0,6,5,1
NZL,SWE,2021.0,12,8,4
IND,PAK,2008.0,12,12,0
IRN,BRA,2023.0,11,2,9
SEN,ZAF,2015.0,2,1,1
NGA,IND,2014.0,5,13,-8
BGD,SGP,2010.0,1,1,0
EGY,JOR,2021.0,11,3,8
FRA,SRB,2018.0,6,12,-6
CHE,NGA,2017.0,1,6,-5
VEN,PRT,2011.0,5,1,4
LUX,DEU,2009.0,11,18,-7
LUX,CHN,2021.0,5,5,0
TUR,IND,2021.0,10,6,4
RUS,IRQ,2021.0,14,6,8
EGY,IND,2021.0,8,8,0
BEL,BOL,2005.0,4,1,3
CUB,CHL,2017.0,10,3,7
KOR,RWA,2022.0,5,1,4
LKA,GBR,2023.0,25,8,17
MLI,CHN,2018.0,1,5,-4
NAM,ZAF,2023.0,5,12,-7
CHN,NPL,2023.0,19,11,8
FRA,CHN,2004.0,49,32,17
HKG,NLD,2023.0,5,3,2
KEN,CHE,2011.0,3,3,0
RUS,FIN,2011.0,15,9,6
CHN,BGD,2018.0,14,31,-17
ECU,DEU,2018.0,9,14,-5
ARG,AUS,2019.0,7,5,2
BRA,PAK,2019.0,10,6,4
ITA,CRI,2021.0,1,2,-1
TWN,AUS,2012.0,20,21,-1
VNM,FIN,2019.0,1,2,-1
BLR,POL,2021.0,5,4,1
RUS,HKG,2017.0,3,3,0
ESP,EGY,2010.0,3,3,0
BGR,USA,2006.0,14,13,1
THA,AUS,2005.0,9,30,-21
MEX,IND,2010.0,2,2,0
CAN,SRB,2018.0,5,6,-1
THA,CHN,2009.0,6,8,-2
ESP,HND,2017.0,2,1,1
LTU,FIN,2005.0,2,1,1
NLD,ROU,2011.0,3,4,-1
DZA,DEU,2007.0,7,4,3
DEU,DZA,2009.0,3,1,2
FIN,FRA,2011.0,13,19,-6
ESP,CRI,2010.0,5,3,2
BFA,DEU,2008.0,3,1,2
CHE,JOR,2022.0,2,1,1
VNM,JPN,2007.0,8,11,-3
CAN,BFA,2007.0,2,1,1
ROU,CAN,2000.0,5,1,4
GBR,SVN,2007.0,8,13,-5
SWE,POL,2014.0,18,23,-5
LAO,THA,2015.0,10,5,5
ARG,CAN,2015.0,18,18,0
IRN,USA,2005.0,36,41,-5
GBR,DZA,2020.0,6,3,3
SWE,BRA,2011.0,9,13,-4
BEL,ECU,2005.0,4,2,2
NGA,ZAF,2005.0,11,7,4
BRA,GRC,2022.0,2,2,0
GBR,URY,2010.0,1,1,0
NGA,BFA,2020.0,2,1,1
JOR,ARE,2013.0,13,5,8
BRA,IRL,2012.0,5,4,1
KEN,ZAF,2009.0,4,9,-5
FRA,URY,2015.0,6,5,1
LSO,ZAF,2008.0,4,2,2
FIN,MYS,2012.0,3,1,2
GRC,TUR,2020.0,6,9,-3
JOR,AUS,2017.0,7,14,-7
PRT,POL,2015.0,10,13,-3
ZMB,ZWE,2019.0,4,5,-1
KEN,UGA,2014.0,9,8,1
VNM,AUT,2009.0,2,1,1
USA,CIV,2012.0,5,4,1
NOR,UGA,2009.0,3,2,1
HKG,JPN,2023.0,3,11,-8
USA,LTU,2004.0,10,8,2
SEN,FRA,1997.0,17,18,-1
COL,MEX,2013.0,26,26,0
LTU,LVA,2008.0,7,5,2
VEN,ARG,2007.0,3,2,1
NLD,IND,2008.0,10,16,-6
NLD,GHA,2015.0,7,3,4
SRB,BRA,2019.0,2,1,1
CHE,SVN,2018.0,6,9,-3
FRA,UGA,2010.0,3,1,2
EST,IND,2021.0,5,5,0
GBR,CHL,1997.0,4,4,0
AUS,BGR,1997.0,8,1,7
TUR,FRA,2009.0,13,8,5
MMR,USA,2015.0,4,1,3
CHE,SAU,2019.0,7,7,0
NGA,GHA,2019.0,10,1,9
TUR,ESP,2015.0,10,13,-3
ROU,NLD,2012.0,10,8,2
DNK,TUR,2014.0,6,3,3
FRA,MTQ,2001.0,7,15,-8
CHL,CAN,2006.0,9,16,-7
DEU,EST,2010.0,6,6,0
GBR,OMN,2011.0,10,3,7
ETH,NOR,2016.0,5,8,-3
GRC,CAN,2008.0,11,9,2
BEL,BEN,2009.0,6,1,5
CHE,GRC,2020.0,30,33,-3
CUB,USA,1998.0,3,5,-2
SWE,CZE,2019.0,14,12,2
ARE,CAN,2010.0,7,13,-6
HND,USA,1998.0,1,1,0
HRV,AUT,2003.0,2,6,-4
CAN,JOR,2004.0,5,6,-1
USA,PAN,2015.0,13,20,-7
UKR,POL,2008.0,15,13,2
ZAF,FRA,2018.0,16,33,-17
CUB,BRA,2009.0,17,3,14
NLD,ZWE,2015.0,1,2,-1
GBR,ETH,2019.0,7,6,1
RUS,ESP,2007.0,11,14,-3
ESP,JOR,2007.0,1,2,-1
SVN,AUT,2010.0,5,3,2
AUT,THA,2008.0,5,4,1
DEU,THA,2010.0,22,22,0
CAN,BEL,2004.0,13,25,-12
USA,ETH,2014.0,24,25,-1
SAU,NLD,2020.0,8,15,-7
RUS,NZL,2009.0,3,1,2
SRB,RUS,2004.0,10,14,-4
GRC,AUT,2018.0,7,5,2
GRC,ITA,2008.0,14,21,-7
NLD,THA,2012.0,12,6,6
FRA,BFA,2009.0,15,3,12
CHE,SWZ,2009.0,7,5,2
JPN,BRA,2004.0,11,11,0
BEL,CZE,2007.0,4,5,-1
CYP,FRA,2012.0,4,2,2
ESP,GRC,2009.0,4,10,-6
CAN,NOR,2008.0,16,5,11
HKG,GBR,2000.0,35,36,-1
RUS,BEL,2022.0,14,10,4
USA,LUX,1999.0,3,1,2
TZA,CHE,2009.0,6,1,5
NZL,SGP,2010.0,10,8,2
BEL,CMR,2013.0,4,3,1
FRA,MCO,2008.0,13,3,10
BGD,ARE,2019.0,1,1,0
MAR,FRA,2007.0,34,85,-51
NLD,VNM,2008.0,6,2,4
AUS,THA,2009.0,43,16,27
KOR,ZAF,2016.0,8,4,4
MYS,JPN,2015.0,42,77,-35
DNK,CZE,2012.0,3,5,-2
YEM,SAU,2015.0,13,3,10
DEU,MAR,2017.0,6,2,4
GBR,COL,2023.0,13,18,-5
BEL,HKG,2021.0,1,3,-2
ZWE,KEN,2018.0,3,1,2
PER,ARG,2017.0,3,10,-7
KOR,DEU,2003.0,22,28,-6
BEL,ZAF,2014.0,16,11,5
ITA,MEX,2023.0,23,23,0
ISL,GBR,2023.0,4,4,0
PHL,BGD,2017.0,2,3,-1
NPL,IND,2014.0,31,22,9
BTN,THA,2019.0,4,2,2
PHL,CAN,2022.0,4,2,2
COL,NLD,2018.0,14,5,9
SWZ,ZAF,2022.0,9,16,-7
LUX,CHN,2019.0,4,2,2
LUX,ITA,2023.0,8,9,-1
NER,USA,2015.0,4,3,1
NGA,ZMB,2021.0,1,1,0
THA,VNM,2017.0,10,11,-1
FRA,DJI,2017.0,3,2,1
LUX,NLD,2021.0,9,9,0
ITA,IDN,2021.0,3,1,2
SGP,HKG,2011.0,17,35,-18
DNK,POL,2021.0,10,7,3
RUS,KGZ,2017.0,5,4,1
AUS,ARG,1999.0,3,2,1
GBR,EST,2023.0,6,9,-3
HUN,SVK,2017.0,15,5,10
JPN,CMR,2020.0,5,1,4
SYR,CAN,2021.0,2,1,1
ESP,DZA,2007.0,5,1,4
GBR,COL,2006.0,11,7,4
RUS,DNK,2019.0,7,6,1
ARG,JPN,2020.0,4,1,3
CHE,KEN,2017.0,3,7,-4
AUS,TWN,2015.0,15,17,-2
FRA,CMR,2017.0,21,24,-3
DEU,IDN,2017.0,31,12,19
GBR,KWT,1999.0,3,3,0
BIH,SRB,2019.0,12,15,-3
PRT,GRC,2017.0,1,4,-3
FRA,PSE,2017.0,2,1,1
TZA,USA,2015.0,17,25,-8
CAN,ROU,2018.0,2,6,-4
NLD,HUN,2005.0,8,5,3
BEL,SRB,2006.0,7,3,4
BWA,IND,2013.0,1,2,-1
CZE,RUS,2007.0,5,9,-4
CZE,ITA,2004.0,5,9,-4
FRA,IDN,1997.0,3,2,1
ITA,SVK,2010.0,7,2,5
RUS,THA,2006.0,1,1,0
RUS,SVK,2017.0,5,3,2
FRA,ARG,2009.0,16,22,-6
THA,DEU,2012.0,22,26,-4
USA,CMR,2001.0,10,6,4
CHN,ZAF,2014.0,13,6,7
NLD,LUX,2002.0,3,1,2
ZMB,USA,2005.0,1,5,-4
USA,LVA,2018.0,6,3,3
KWT,OMN,2005.0,1,1,0
ITA,MEX,2010.0,7,12,-5
GRC,HUN,2003.0,1,1,0
NZL,NLD,2013.0,14,16,-2
SRB,GBR,2004.0,16,14,2
MEX,PHL,2011.0,1,2,-1
FIN,BEL,2021.0,4,16,-12
NLD,IDN,1999.0,3,3,0
JAM,USA,2015.0,9,15,-6
ITA,HUN,2005.0,5,9,-4
USA,DZA,2003.0,7,2,5
ESP,URY,2003.0,11,8,3
FRA,BEN,1998.0,2,4,-2
USA,BLR,2013.0,3,3,0
LUX,BEL,2013.0,7,8,-1
TZA,GBR,2001.0,7,7,0
QAT,GBR,2022.0,20,30,-10
AUS,ISR,2006.0,5,9,-4
IND,MYS,1997.0,9,3,6
DEU,IRN,2006.0,12,9,3
CAN,EGY,2007.0,22,14,8
GBR,MAR,2008.0,1,3,-2
PRT,ARG,2009.0,2,1,1
JPN,JOR,2001.0,1,1,0
UZB,RUS,1998.0,9,7,2
CAN,THA,2004.0,6,11,-5
SVK,POL,2019.0,4,3,1
FRA,NZL,2004.0,7,3,4
ROU,MDA,2019.0,4,5,-1
BLR,BRA,2001.0,4,1,3
CZE,AUT,2019.0,15,22,-7
AUT,ESP,1998.0,6,4,2
POL,UKR,2004.0,10,13,-3
ZAF,UGA,2005.0,1,5,-4
RUS,GEO,2009.0,8,3,5
PAK,OMN,2010.0,6,1,5
PHL,GBR,2004.0,2,5,-3
CZE,AUT,2021.0,23,15,8
CAN,SVK,1997.0,3,1,2
RUS,ARM,2012.0,6,7,-1
KEN,CAN,2001.0,4,3,1
CZE,ESP,2004.0,1,6,-5
LUX,NLD,2019.0,9,10,-1
BGR,DNK,1998.0,3,1,2
USA,BGR,2001.0,12,46,-34
CAN,ARM,2006.0,1,1,0
CAN,CRI,1998.0,1,2,-1
NZL,OMN,2018.0,2,1,1
NER,MLI,2013.0,1,1,0
ZAF,NGA,2009.0,8,24,-16
POL,CHE,2004.0,17,9,8
ALB,SRB,2022.0,12,18,-6
IND,CHN,2000.0,6,1,5
URY,USA,2021.0,13,16,-3
ZAF,PHL,2007.0,1,1,0
JPN,EGY,1998.0,12,7,5
CZE,POL,2006.0,7,4,3
USA,BGR,2008.0,11,15,-4
IRN,RUS,2003.0,2,3,-1
ESP,LVA,2001.0,1,1,0
NLD,BGR,2003.0,7,2,5
TZA,SWE,2007.0,2,4,-2
ITA,FIN,2023.0,14,14,0
BEL,CHL,2010.0,5,2,3
SRB,BIH,2013.0,13,12,1
AUS,FIN,2015.0,15,13,2
CZE,HUN,2017.0,3,8,-5
ITA,POL,1998.0,17,7,10
ZAF,NZL,2004.0,10,11,-1
MOZ,SWE,2002.0,1,1,0
DNK,HUN,2008.0,5,2,3
JPN,VNM,2003.0,12,8,4
MEX,NLD,1998.0,4,3,1
FRA,MRT,2023.0,6,1,5
FIN,IRN,2004.0,2,1,1
DEU,SRB,2004.0,32,20,12
AUT,NOR,2007.0,7,1,6
DEU,BGD,2000.0,1,4,-3
BFA,CIV,1999.0,3,2,1
IND,POL,2008.0,8,1,7
EST,FIN,1997.0,8,1,7
ROU,ITA,2011.0,12,11,1
SWE,CHL,2020.0,4,8,-4
USA,IDN,1997.0,16,6,10
IDN,NLD,2000.0,8,6,2
GHA,DEU,1998.0,2,1,1
KEN,ETH,2000.0,1,4,-3
CHE,RUS,2000.0,9,19,-10
CAN,IRL,2002.0,17,12,5
JPN,NGA,2006.0,5,3,2
CUB,PRT,2014.0,3,1,2
CHE,BRA,2017.0,20,38,-18
ITA,IND,2002.0,14,9,5
IND,NLD,2009.0,32,11,21
CAN,MAR,2001.0,5,1,4
CHE,MAR,2010.0,1,1,0
ESP,MAR,2002.0,5,3,2
FRA,LUX,2008.0,19,7,12
SLV,SVK,2011.0,8,1,7
NZL,FRA,2009.0,13,10,3
IRN,DEU,2009.0,35,29,6
SVN,GRC,2019.0,1,2,-1
ZAF,NZL,2008.0,8,4,4
ARM,DEU,2008.0,5,2,3
DEU,TWN,2001.0,9,13,-4
NGA,ETH,2010.0,3,2,1
LBN,DEU,2013.0,7,2,5
COL,PAN,2017.0,1,2,-1
QAT,DZA,2023.0,1,1,0
GRC,BEL,2010.0,10,8,2
GBR,FIN,2009.0,32,54,-22
SVK,CHE,2013.0,7,2,5
AUT,IRL,2010.0,6,11,-5
ITA,ARG,2020.0,18,18,0
DEU,ROU,2010.0,25,22,3
SVN,FRA,2017.0,7,9,-2
HKG,KOR,2013.0,8,9,-1
ARG,SWE,2020.0,6,5,1
NLD,ROU,2019.0,8,4,4
NGA,GHA,2011.0,4,3,1
AUS,ITA,2010.0,34,47,-13
JPN,ZMB,2006.0,2,3,-1
FJI,IND,2016.0,1,7,-6
CAN,ARE,2014.0,30,14,16
COL,AUS,2006.0,1,1,0
SVK,NLD,2006.0,4,2,2
PAK,AUT,2008.0,7,6,1
PAK,DNK,2015.0,4,3,1
HUN,HRV,2023.0,3,2,1
TUR,JPN,2007.0,8,15,-7
CZE,BRA,2015.0,6,4,2
IND,NZL,2008.0,9,2,7
SWE,URY,2011.0,2,3,-1
TUR,GBR,2015.0,51,58,-7
CHN,ROU,2010.0,1,3,-2
LAO,USA,2019.0,5,4,1
NLD,SVN,2023.0,3,1,2
FRA,PAK,2012.0,26,6,20
PRT,JPN,2014.0,3,3,0
ARM,EST,2018.0,1,1,0
BEL,KEN,2019.0,5,5,0
CHN,MYS,2015.0,9,19,-10
NOR,HUN,2015.0,1,2,-1
NLD,POL,2011.0,16,10,6
IRN,HKG,2023.0,4,3,1
PRT,DNK,2013.0,9,3,6
DZA,JPN,2009.0,1,1,0
IRL,TUR,2021.0,4,9,-5
RUS,VNM,2011.0,7,1,6
CAN,CHL,2007.0,7,32,-25
AUT,HRV,2010.0,3,3,0
SWE,KEN,2017.0,2,6,-4
USA,TJK,2012.0,1,1,0
ARE,QAT,2014.0,12,1,11
AUS,TUR,2009.0,2,5,-3
CAN,MAR,2014.0,9,4,5
GBR,EST,2010.0,6,5,1
ITA,ZAF,2012.0,11,4,7
CAN,ARE,2008.0,24,1,23
MYS,JPN,2008.0,15,37,-22
YEM,MYS,2012.0,5,16,-11
IRN,TWN,2006.0,1,1,0
CZE,ROU,2006.0,2,1,1
GBR,UZB,2011.0,2,1,1
KAZ,SAU,2014.0,1,3,-2
URY,BRA,2021.0,3,21,-18
EGY,NLD,2012.0,1,6,-5
CHE,SVK,2017.0,5,8,-3
IRN,ESP,2008.0,4,2,2
USA,LTU,2008.0,10,6,4
NZL,SGP,2000.0,7,7,0
IND,NGA,2012.0,9,9,0
MAR,SAU,2013.0,3,1,2
DEU,NZL,2021.0,25,33,-8
EST,ESP,2012.0,5,2,3
FRA,SAU,2007.0,6,1,5
FRA,LUX,2004.0,19,1,18
BRA,PER,2009.0,7,8,-1
PER,BRA,2010.0,6,11,-5
USA,MLI,2009.0,3,6,-3
SAU,ESP,2023.0,7,10,-3
ESP,FIN,2011.0,18,12,6
NLD,MEX,2013.0,6,7,-1
SVN,GBR,2016.0,17,12,5
IRQ,GBR,2014.0,14,25,-11
IRL,NLD,2012.0,12,8,4
AUT,SWE,2011.0,17,12,5
EGY,YEM,2014.0,5,4,1
COL,DEU,2019.0,23,25,-2
ROU,DEU,2009.0,24,30,-6
PRT,AUS,2017.0,19,4,15
NAM,ZAF,2006.0,6,1,5
FRA,GIN,2005.0,3,2,1
VNM,CHN,2020.0,14,44,-30
GBR,KOR,2013.0,53,48,5
GHA,SWE,2015.0,3,1,2
AZE,TUR,2012.0,3,4,-1
TUR,AUT,2014.0,6,8,-2
FRA,SVN,2017.0,9,7,2
PHL,NLD,2016.0,4,4,0
CHN,ISR,1999.0,5,7,-2
MCO,ESP,2009.0,1,1,0
SRB,ITA,2003.0,6,11,-5
ESP,HRV,2014.0,3,6,-3
BHR,TUN,2023.0,1,4,-3
PAK,FIN,2014.0,3,1,2
MEX,VEN,2003.0,7,6,1
AUS,TLS,2015.0,2,1,1
POL,UKR,2015.0,15,27,-12
LUX,CAN,2022.0,2,4,-2
IRL,DEU,2002.0,15,15,0
CHL,ARG,2010.0,8,23,-15
CHN,MAC,2010.0,36,33,3
NOR,HRV,2010.0,2,2,0
DEU,LKA,2011.0,2,2,0
IND,EGY,2012.0,4,5,-1
FRA,MLI,2014.0,12,5,7
SRB,CHE,2013.0,6,3,3
USA,JPN,2024.0,5,2,3
SVK,HUN,2015.0,6,8,-2
SWZ,CHE,2014.0,8,11,-3
BEN,USA,2021.0,4,3,1
SWE,KOR,2005.0,5,5,0
ESP,SGP,2019.0,4,8,-4
EGY,DNK,2016.0,2,2,0
SGP,CHN,2000.0,27,85,-58
FRA,TWN,2017.0,18,9,9
KOR,FRA,1998.0,6,8,-2
SRB,HRV,2017.0,17,16,1
SGP,AUT,2015.0,7,3,4
PRI,COL,2012.0,5,1,4
AUS,TWN,2014.0,13,22,-9
TWN,MYS,2018.0,11,15,-4
TUR,SGP,2012.0,3,4,-1
BEL,LUX,2013.0,8,7,1
URY,ARG,2014.0,7,7,0
PSE,GBR,2013.0,3,6,-3
ZAF,NZL,2015.0,14,5,9
JPN,ISR,2000.0,6,7,-1
NLD,RUS,2022.0,8,19,-11
BEL,NZL,2019.0,3,7,-4
TZA,GBR,2015.0,11,15,-4
CHE,QAT,2020.0,5,1,4
IRL,IND,2013.0,7,14,-7
USA,MDG,2014.0,1,2,-1
NLD,PER,2016.0,2,2,0
ISR,UKR,2011.0,5,4,1
USA,TUN,2013.0,6,8,-2
POL,CZE,2017.0,19,19,0
TUR,IRN,2014.0,7,30,-23
NOR,ESP,2014.0,9,17,-8
PER,CAN,2015.0,2,1,1
AGO,BRA,2017.0,1,2,-1
FIN,POL,2023.0,5,4,1
CZE,ESP,2015.0,15,37,-22
DNK,VNM,2016.0,7,2,5
BGD,SGP,2006.0,2,1,1
BRA,IND,2012.0,6,7,-1
TWN,MYS,2017.0,5,15,-10
MYS,ESP,2021.0,4,7,-3
TZA,JPN,2019.0,1,6,-5
SAU,FRA,2016.0,15,56,-41
MYS,USA,1997.0,6,6,0
IRQ,BRA,2018.0,1,1,0
FRA,TWN,2022.0,6,8,-2
NOR,GHA,2021.0,5,3,2
OMN,CAN,2003.0,2,4,-2
MAR,BFA,2016.0,1,1,0
NZL,JPN,2018.0,12,8,4
ESP,HUN,2010.0,4,10,-6
KOR,LKA,2020.0,4,2,2
DNK,SRB,2016.0,2,2,0
ISL,USA,2009.0,11,22,-11
DEU,MAR,2022.0,6,4,2
USA,NAM,2013.0,3,1,2
TGO,BEN,2022.0,1,4,-3
ZAF,VNM,2016.0,1,1,0
AUS,TUR,2019.0,10,21,-11
BEN,CAN,2020.0,3,3,0
BEL,JPN,1997.0,9,6,3
CYP,TUR,1999.0,5,2,3
OMN,QAT,2014.0,2,1,1
RUS,NLD,2022.0,19,8,11
GBR,ARG,2017.0,20,22,-2
NLD,TUR,2017.0,26,23,3
BRA,SGP,2018.0,2,1,1
EGY,YEM,2015.0,3,3,0
NLD,CZE,2023.0,4,5,-1
KEN,DEU,2015.0,14,13,1
MYS,KOR,2022.0,15,5,10
LBR,KEN,2018.0,1,1,0
ZAF,NAM,2016.0,10,4,6
NLD,BGD,2022.0,1,4,-3
ESP,PER,2021.0,39,29,10
ZAF,ZWE,2015.0,21,31,-10
KOR,ITA,2014.0,9,4,5
CHE,CMR,2016.0,3,1,2
CUB,CAN,2020.0,9,1,8
PER,ARG,2016.0,2,5,-3
ARG,FIN,2021.0,1,2,-1
NGA,THA,2012.0,2,1,1
ZAF,TZA,2023.0,5,4,1
BRA,SWE,2004.0,5,5,0
IRN,SAU,2015.0,2,1,1
DEU,ARM,2001.0,8,1,7
ITA,NGA,2006.0,1,2,-1
PRT,ARE,2018.0,5,1,4
FIN,BRA,2018.0,6,13,-7
ITA,MYS,2020.0,8,2,6
RUS,GEO,2021.0,4,3,1
MDA,USA,2015.0,5,2,3
GHA,NZL,2019.0,2,2,0
CHN,HUN,2021.0,11,10,1
FIN,RUS,2005.0,9,17,-8
DZA,ITA,2019.0,4,9,-5
CUB,BRA,2011.0,10,4,6
PAK,JPN,2022.0,6,10,-4
IRN,PSE,2020.0,1,1,0
SRB,FIN,2020.0,1,2,-1
CHE,KEN,2016.0,3,4,-1
ESP,BGD,2019.0,4,2,2
ECU,NLD,2020.0,2,6,-4
KEN,JPN,2016.0,5,9,-4
USA,SWZ,2021.0,5,7,-2
ISR,CHN,2012.0,11,6,5
MYS,MAC,2017.0,1,1,0
COL,SWE,2022.0,5,2,3
GRC,DNK,1997.0,2,4,-2
QAT,TUR,2019.0,4,5,-1
AUS,CRI,2021.0,1,1,0
CHE,HUN,2019.0,8,14,-6
CHE,HUN,2021.0,17,16,1
CAN,COL,2022.0,7,35,-28
BRN,PHL,2022.0,1,1,0
KAZ,JPN,2003.0,1,4,-3
GEO,RUS,2016.0,5,6,-1
FRA,HUN,2020.0,13,13,0
AUT,ROU,2016.0,4,3,1
CUB,ESP,2004.0,12,33,-21
NZL,RUS,1999.0,1,3,-2
CAN,URY,2008.0,1,1,0
SWE,BRA,2021.0,18,44,-26
ROU,IRL,2019.0,4,1,3
COG,USA,2021.0,4,4,0
ECU,KOR,2021.0,3,2,1
RUS,BLR,2018.0,19,20,-1
AUT,IDN,2011.0,3,2,1
COL,BEL,2021.0,8,1,7
NPL,THA,2023.0,4,6,-2
KOR,NPL,2021.0,18,8,10
AUT,HRV,2023.0,5,2,3
EST,FIN,2002.0,7,13,-6
FIN,EST,2003.0,12,8,4
FRA,IRL,2023.0,19,24,-5
SRB,KOR,2015.0,3,1,2
KOR,SRB,2017.0,1,1,0
ZWE,DEU,2021.0,3,1,2
BRA,SGP,2022.0,2,2,0
THA,FIN,2017.0,4,1,3
COL,PER,2017.0,7,5,2
CHL,NOR,2015.0,1,2,-1
BHR,SAU,2021.0,9,9,0
TWN,PAK,2021.0,10,13,-3
BGD,ITA,2022.0,7,5,2
IND,PAK,2004.0,7,6,1
CRI,NLD,1999.0,4,2,2
IRQ,CHN,2021.0,6,20,-14
HRV,ITA,2021.0,6,10,-4
DEU,VEN,2008.0,5,4,1
ROU,PRT,2021.0,3,3,0
SWE,POL,2015.0,9,26,-17
SAU,ZAF,2016.0,11,9,2
GBR,CHN,2024.0,13,22,-9
ESP,AZE,2019.0,1,1,0
GRC,IRL,2021.0,7,4,3
ETH,GBR,2013.0,12,10,2
IRN,ARE,2013.0,1,1,0
KAZ,CAN,2015.0,4,2,2
TUR,NLD,2023.0,21,13,8
THA,CZE,2014.0,1,4,-3
DEU,PNG,2013.0,1,1,0
SRB,ESP,2020.0,6,1,5
IND,IRN,2017.0,20,9,11
TUN,KWT,2023.0,1,1,0
ITA,COL,2015.0,18,3,15
PER,CHL,2019.0,5,5,0
ISR,CZE,2000.0,4,1,3
CZE,NZL,2014.0,2,1,1
PHL,TWN,2022.0,8,8,0
RUS,MDA,2016.0,4,11,-7
LKA,NZL,2020.0,7,5,2
MAR,CAN,2007.0,5,6,-1
EGY,IND,2011.0,1,5,-4
GBR,BHR,2013.0,8,4,4
YEM,EGY,2022.0,7,11,-4
CZE,FIN,2022.0,9,3,6
KOR,ARE,2016.0,10,3,7
BGD,BRN,2019.0,3,4,-1
LAO,THA,2014.0,1,4,-3
SWE,SGP,2022.0,7,6,1
BIH,DEU,2015.0,3,3,0
AUS,NPL,2018.0,8,14,-6
FIN,KOR,2016.0,4,2,2
TWN,THA,2016.0,15,7,8
ISR,CHE,2014.0,23,18,5
FRA,MAR,2024.0,1,1,0
THA,ZAF,2017.0,1,3,-2
LAO,JPN,2017.0,4,3,1
CAN,GTM,2023.0,1,1,0
CHE,ROU,2006.0,3,3,0
NLD,BGD,2016.0,4,3,1
SAU,FRA,2018.0,16,60,-44
GBR,KWT,2020.0,26,8,18
MEX,URY,2021.0,6,1,5
NCL,FRA,2017.0,16,37,-21
CZE,EGY,2021.0,3,1,2
KOR,NPL,2019.0,7,6,1
CHL,ISR,2019.0,2,1,1
AUT,IRN,2016.0,10,14,-4
GBR,LTU,2017.0,6,5,1
BOL,SWE,2014.0,3,4,-1
AUT,NLD,2017.0,24,44,-20
BFA,CAN,2017.0,3,4,-1
FIN,MWI,2016.0,1,3,-2
KEN,TZA,2016.0,7,3,4
GBR,LKA,2022.0,15,20,-5
LBR,UGA,2017.0,1,1,0
ZWE,USA,2022.0,8,5,3
DZA,TUR,2021.0,7,2,5
ETH,TWN,2015.0,4,1,3
PHL,GBR,2001.0,5,5,0
GHA,RWA,2020.0,2,1,1
KWT,SAU,2017.0,4,8,-4
ISR,SWE,2003.0,5,3,2
SRB,AUS,2022.0,6,2,4
SWE,PER,2019.0,2,1,1
LTU,FRA,2019.0,3,5,-2
BHR,OMN,2020.0,3,2,1
IRQ,TUR,2023.0,8,13,-5
AUS,CRI,2019.0,2,1,1
CAN,PSE,2023.0,3,1,2
VNM,DNK,2020.0,2,7,-5
NER,ITA,2022.0,2,1,1
ISR,AUT,2023.0,1,1,0
JOR,HUN,2021.0,5,6,-1
JPN,NPL,2008.0,8,5,3
SVN,GRC,2021.0,1,1,0
NZL,JPN,2022.0,6,5,1
SAU,HUN,2017.0,3,1,2
RUS,SVN,2019.0,2,2,0
CHN,PRT,2020.0,12,12,0
SEN,BFA,2019.0,6,3,3
IRL,FIN,2021.0,8,4,4
CHN,ECU,2021.0,2,3,-1
POL,CAN,2019.0,14,17,-3
IND,PAK,2014.0,27,19,8
SWE,ZAF,2019.0,11,17,-6
NGA,FIN,2019.0,2,2,0
IRL,EGY,2023.0,5,1,4
ITA,IRL,2001.0,8,7,1
ETH,ITA,2019.0,8,5,3
BEN,MAR,2019.0,1,1,0
AUT,IDN,2021.0,7,6,1
SDN,USA,2019.0,4,4,0
ITA,BGD,2018.0,4,3,1
AUT,POL,2022.0,9,5,4
TUN,ESP,2021.0,5,7,-2
KWT,GBR,2021.0,6,18,-12
GBR,LTU,2022.0,8,8,0
CUB,BRA,2021.0,7,12,-5
USA,JAM,2009.0,9,12,-3
BGD,PAK,2006.0,4,1,3
MAR,NZL,2022.0,1,1,0
LBY,EGY,2022.0,4,4,0
CRI,COL,2022.0,2,1,1
SAU,YEM,2021.0,5,15,-10
GBR,JAM,2019.0,5,6,-1
KEN,ZAF,2021.0,18,34,-16
KOR,FIN,2001.0,1,1,0
UGA,AUT,2021.0,1,1,0
SAU,ZAF,2018.0,7,16,-9
DEU,URY,2009.0,1,2,-1
THA,TWN,2023.0,7,18,-11
DNK,KEN,2001.0,1,2,-1
TWN,IND,2003.0,19,34,-15
PHL,KOR,2019.0,7,15,-8
KOR,BEL,2017.0,10,15,-5
SWE,IRN,2018.0,16,49,-33
IRL,TWN,2014.0,1,2,-1
DNK,HUN,2001.0,1,7,-6
AUS,FJI,2021.0,4,13,-9
IDN,FRA,2022.0,7,7,0
PRK,CHN,2021.0,6,9,-3
QAT,GRC,2021.0,3,1,2
COD,COG,2008.0,14,11,3
ARM,USA,2016.0,14,9,5
THA,NPL,2006.0,2,1,1
MAR,DEU,2001.0,5,2,3
CZE,RUS,1998.0,10,6,4
TUR,ISR,2011.0,2,2,0
BWA,ZAF,2001.0,6,2,4
SRB,RUS,2014.0,5,3,2
HUN,AUS,2002.0,3,3,0
USA,SLV,2020.0,6,2,4
NGA,NER,2007.0,6,5,1
NOR,DNK,1999.0,16,11,5
TZA,GBR,2004.0,6,5,1
CAN,BFA,1998.0,2,1,1
ROU,MDA,2011.0,6,5,1
UGA,KEN,2008.0,5,2,3
POL,NLD,2002.0,16,17,-1
CZE,ZAF,2008.0,1,2,-1
CHE,POL,2003.0,9,15,-6
CMR,SWE,2016.0,1,2,-1
NOR,PRT,2012.0,2,3,-1
ARM,FRA,2004.0,2,2,0
JPN,PRT,2007.0,3,1,2
BLR,UKR,2001.0,4,1,3
GBR,KWT,2007.0,7,8,-1
LAO,FRA,2018.0,3,8,-5
ETH,CAN,2022.0,10,5,5
SWE,BEL,2002.0,14,17,-3
GHA,DEU,2007.0,5,2,3
CRI,FRA,2002.0,1,1,0
TUR,ITA,2010.0,13,15,-2
CIV,CHE,2004.0,2,2,0
USA,SEN,2015.0,6,12,-6
ARE,GBR,2002.0,3,13,-10
FRA,BEN,1999.0,3,1,2
ZAF,BEN,2014.0,1,2,-1
BGR,RUS,2015.0,5,4,1
CAN,SAU,2005.0,21,15,6
BWA,ZAF,2008.0,9,4,5
BGR,JPN,2004.0,4,2,2
CZE,NLD,2021.0,14,16,-2
USA,ARM,2012.0,4,5,-1
AUS,LBN,2018.0,4,2,2
GBR,GHA,2004.0,8,3,5
OMN,ROU,2009.0,9,5,4
AUT,IND,2000.0,3,3,0
OMN,CHE,2009.0,1,1,0
FRA,BLR,2005.0,2,5,-3
AGO,PRT,2000.0,1,1,0
IRQ,LBY,2003.0,2,2,0
JPN,LTU,2019.0,2,2,0
EST,DEU,2004.0,3,3,0
MLT,GBR,1999.0,5,6,-1
BGD,GBR,2006.0,6,12,-6
BEL,MAR,2003.0,8,2,6
AUT,DNK,2015.0,17,13,4
NOR,BWA,2004.0,1,1,0
MYS,JPN,2001.0,8,6,2
GRC,ITA,2004.0,13,18,-5
TUR,NLD,2006.0,4,5,-1
DEU,GAB,2002.0,1,4,-3
GBR,LBN,2002.0,1,2,-1
EST,CAN,2020.0,2,3,-1
GBR,ECU,2001.0,4,4,0
BGR,GBR,2003.0,12,11,1
AGO,BRA,2016.0,2,1,1
DZA,ARG,2000.0,2,1,1
BDI,BEN,2019.0,1,2,-1
NZL,CHE,1999.0,2,3,-1
PHL,ESP,2001.0,5,13,-8
BEL,FIN,2004.0,4,2,2
POL,AUT,2002.0,7,6,1
DNK,GNB,2001.0,2,1,1
GRC,CYP,2009.0,28,12,16
CZE,SVK,1998.0,12,12,0
NOR,UGA,2011.0,1,4,-3
POL,PRT,2012.0,10,8,2
LBN,LBY,2004.0,3,3,0
LBY,LBN,2018.0,2,1,1
MKD,FRA,2007.0,1,1,0
LUX,ESP,2010.0,2,4,-2
FIN,GRC,2007.0,1,3,-2
GRC,FIN,2009.0,2,2,0
SVN,BEL,2009.0,8,1,7
EGY,ITA,2004.0,2,3,-1
CZE,EGY,2009.0,2,1,1
GBR,SEN,2021.0,2,3,-1
TZA,ZAF,2012.0,1,4,-3
DZA,DEU,2020.0,5,6,-1
ECU,BRA,2012.0,3,1,2
ITA,ARG,1998.0,9,13,-4
ARG,MEX,2007.0,7,12,-5
BRN,AUS,2002.0,3,1,2
TUR,ESP,2014.0,13,6,7
TZA,SWE,1998.0,1,3,-2
BRA,PRY,2014.0,4,3,1
FRA,TUR,2000.0,9,7,2
YEM,POL,2008.0,1,1,0
IDN,USA,1997.0,6,16,-10
AUS,ECU,2018.0,3,3,0
POL,IRL,2008.0,12,1,11
CHL,NZL,2007.0,3,2,1
CZE,MEX,2010.0,2,2,0
OMN,CAN,2013.0,6,16,-10
TUN,USA,2017.0,12,14,-2
GBR,MKD,2010.0,1,1,0
KEN,GBR,2002.0,14,23,-9
DEU,IRL,2002.0,15,15,0
NOR,ZAF,2020.0,6,9,-3
ZAF,NOR,2021.0,9,4,5
MEX,CUB,2018.0,13,38,-25
RUS,SRB,2002.0,5,1,4
NOR,LUX,2013.0,3,2,1
KOR,PHL,2006.0,2,3,-1
MYS,IDN,2009.0,16,6,10
PAK,KOR,2006.0,5,2,3
POL,CHL,2012.0,3,2,1
DEU,COL,2011.0,13,13,0
JPN,CHL,2013.0,5,3,2
BEN,FRA,2010.0,8,9,-1
CHN,UKR,2019.0,8,19,-11
FRA,TWN,2016.0,12,11,1
HUN,CZE,2013.0,4,5,-1
NLD,AUT,2005.0,6,6,0
TWN,RUS,2014.0,3,2,1
MNG,CHN,2011.0,1,1,0
AUS,FIN,2004.0,10,13,-3
THA,NPL,2010.0,1,3,-2
PRT,NOR,2011.0,8,2,6
ITA,ZAF,2005.0,4,4,0
POL,PRT,2005.0,3,2,1
GBR,NPL,2011.0,4,2,2
EGY,OMN,2010.0,4,4,0
AUT,FRA,2009.0,26,28,-2
MEX,DNK,2010.0,4,2,2
CHL,FRA,1999.0,4,15,-11
USA,JAM,2019.0,9,12,-3
KEN,DEU,2004.0,6,6,0
LTU,BLR,2001.0,1,1,0
ZWE,USA,2016.0,5,16,-11
PHL,KOR,2011.0,5,6,-1
CAN,LBN,2010.0,7,4,3
COL,AUT,2021.0,6,3,3
AUS,FIN,2014.0,13,14,-1
ZAF,AUT,2011.0,1,2,-1
CYP,AUT,2022.0,2,2,0
AUT,ITA,2012.0,35,35,0
POL,BRA,2020.0,6,14,-8
ESP,DNK,2013.0,22,17,5
EGY,OMN,2000.0,3,2,1
TUR,AZE,2012.0,4,3,1
UGA,SWE,2006.0,2,1,1
TUR,CHE,2012.0,11,7,4
SLE,NGA,2014.0,1,1,0
KEN,BWA,2007.0,1,1,0
MAR,USA,2007.0,2,4,-2
KOR,AUS,2008.0,13,23,-10
POL,CAN,2011.0,18,15,3
CAN,POL,2013.0,12,13,-1
ECU,PER,2015.0,1,3,-2
ITA,CZE,2006.0,5,5,0
JPN,MNG,2002.0,5,3,2
JPN,NOR,2002.0,11,3,8
AUS,CZE,2013.0,3,7,-4
OMN,KOR,2023.0,2,3,-1
BWA,USA,2006.0,2,12,-10
POL,NLD,2005.0,13,8,5
NPL,JPN,2000.0,2,3,-1
BRA,RUS,2013.0,8,11,-3
FRA,ZAF,2006.0,10,16,-6
NZL,CHN,2012.0,17,17,0
EGY,BRA,2022.0,1,1,0
USA,GHA,2001.0,6,2,4
PRT,JPN,2001.0,2,4,-2
USA,PNG,2008.0,2,5,-3
USA,VEN,2014.0,14,25,-11
AUS,PHL,2006.0,5,4,1
PHL,HKG,2004.0,1,1,0
ETH,GBR,2003.0,7,7,0
KOR,AUS,2001.0,14,13,1
ISR,ARG,2006.0,3,1,2
JPN,SGP,2009.0,30,15,15
DEU,MYS,2010.0,3,8,-5
MYS,DEU,2011.0,7,10,-3
CHE,AFG,2009.0,2,1,1
QAT,IND,2013.0,2,7,-5
ARG,CHE,2013.0,10,7,3
LVA,CHE,2014.0,3,1,2
CHE,LVA,2015.0,1,5,-4
FRO,DNK,2006.0,3,1,2
LTU,RUS,2023.0,2,1,1
DEU,SRB,2008.0,20,6,14
IRN,FRA,2010.0,16,32,-16
JPN,NGA,2010.0,10,5,5
PRT,SWE,2013.0,15,9,6
SWE,BRA,2009.0,7,6,1
KOR,SAU,2014.0,20,6,14
FIN,DZA,2016.0,1,2,-1
CAN,ISL,2016.0,4,1,3
COL,DEU,2011.0,13,13,0
USA,KHM,2011.0,5,2,3
MYS,QAT,2011.0,1,2,-1
MYS,GHA,2020.0,7,3,4
IRL,AUT,2016.0,7,3,4
DEU,ARG,2015.0,20,29,-9
KOR,NZL,2002.0,4,1,3
USA,TZA,2011.0,6,14,-8
LKA,AUS,2007.0,9,3,6
CAN,HKG,2010.0,19,23,-4
CAN,VNM,2019.0,7,2,5
CMR,BEL,2012.0,4,5,-1
COL,BRA,2010.0,18,20,-2
MEX,CZE,2015.0,1,3,-2
AUT,SRB,2003.0,5,4,1
NZL,TWN,2002.0,2,1,1
BGD,SWE,2008.0,4,2,2
GBR,HUN,2008.0,17,40,-23
CYP,ESP,2015.0,1,3,-2
NZL,SGP,2006.0,5,7,-2
NOR,CZE,2013.0,10,2,8
MAR,MEX,2019.0,3,1,2
ESP,PER,2011.0,11,12,-1
CAN,ROU,2016.0,8,4,4
BRA,KOR,2011.0,4,1,3
HUN,EGY,2012.0,2,1,1
PHL,THA,2010.0,3,1,2
CHE,NOR,2015.0,26,13,13
ABW,IND,2021.0,1,1,0
RWA,SWE,2022.0,2,2,0
EGY,AUT,2011.0,4,6,-2
IND,LBY,2010.0,7,1,6
DNK,KOR,2015.0,4,7,-3
FIN,BEL,2011.0,6,3,3
ROU,DEU,2011.0,23,31,-8
ISR,HUN,2014.0,1,3,-2
FIN,EST,2013.0,11,8,3
ISR,CHE,2015.0,19,16,3
TWN,HKG,2006.0,4,12,-8
GTM,USA,2010.0,12,4,8
FRA,COL,2009.0,15,7,8
HRV,DEU,2020.0,24,17,7
BRA,AUT,2014.0,11,4,7
NLD,PRT,2016.0,17,38,-21
NOR,KOR,2015.0,1,3,-2
DNK,GRC,2016.0,3,11,-8
MYS,OMN,2015.0,13,1,12
FRA,NER,2016.0,4,3,1
NLD,VNM,2014.0,5,2,3
ECU,MEX,2015.0,5,14,-9
MLI,SEN,2020.0,4,4,0
SWE,IRN,2016.0,29,29,0
ISL,GBR,2010.0,6,12,-6
CAN,DZA,2018.0,11,11,0
TUR,IRL,2015.0,3,3,0
GHA,TGO,2016.0,1,2,-1
USA,AFG,2011.0,10,8,2
NOR,JPN,2014.0,8,8,0
JPN,BRA,2014.0,20,9,11
SVK,ITA,2013.0,2,5,-3
CAN,GHA,2022.0,8,12,-4
NGA,NLD,2019.0,6,6,0
GBR,ZMB,2017.0,5,6,-1
NGA,IND,2015.0,12,5,7
JPN,NOR,2012.0,3,4,-1
DEU,NPL,2013.0,5,1,4
BWA,ETH,2015.0,2,3,-1
USA,IRQ,2015.0,13,11,2
MEX,FIN,2014.0,3,1,2
GBR,BGR,2014.0,8,11,-3
AUS,MCO,2018.0,1,1,0
CAN,PAK,2013.0,16,20,-4
NAM,USA,2013.0,1,3,-2
LUX,CAN,2018.0,4,4,0
DEU,URY,2021.0,2,2,0
IDN,TWN,2017.0,21,30,-9
KWT,EGY,2023.0,4,8,-4
CHL,AUS,2003.0,3,2,1
KOR,CHN,2000.0,11,19,-8
AUS,KHM,2005.0,2,1,1
CHN,PRT,2007.0,8,1,7
FIN,JPN,2000.0,5,10,-5
MYS,KOR,2016.0,19,13,6
ESP,TUN,2014.0,12,5,7
FRA,PSE,2016.0,4,3,1
CHN,NOR,1998.0,5,2,3
PAN,MEX,2013.0,2,1,1
ESP,URY,2013.0,16,12,4
LTU,CAN,2013.0,1,3,-2
SVN,HRV,2007.0,5,1,4
IND,NZL,2014.0,8,12,-4
ESP,PRI,2017.0,5,4,1
NZL,JPN,2016.0,11,2,9
ESP,GTM,2019.0,3,2,1
BRN,SGP,2015.0,3,6,-3
GRC,BGR,2011.0,1,4,-3
SGP,TUR,2016.0,7,11,-4
SVN,SLV,2019.0,8,7,1
ZAF,IND,2014.0,20,66,-46
KHM,JPN,2007.0,1,3,-2
TUR,UKR,2015.0,1,1,0
CRI,ESP,2014.0,11,11,0
HUN,SVK,2016.0,12,8,4
AUT,EST,2016.0,3,1,2
NLD,SAU,2017.0,7,6,1
COL,AUT,2019.0,3,2,1
BRA,JPN,2016.0,12,21,-9
IDN,TWN,2018.0,19,48,-29
PSE,CHE,2020.0,1,1,0
IDN,IND,2015.0,14,20,-6
FRA,BEN,2020.0,16,8,8
MAR,CHN,2020.0,3,44,-41
FIN,CHN,2007.0,6,6,0
KOR,FRA,2007.0,14,20,-6
ITA,VNM,2022.0,4,1,3
ARG,ECU,2021.0,8,7,1
USA,BFA,2002.0,2,1,1
KHM,PHL,2016.0,1,1,0
HUN,CHN,2012.0,3,2,1
JPN,FIN,2021.0,11,10,1
CHN,ITA,2016.0,40,48,-8
TWN,GRC,2006.0,2,1,1
LVA,ITA,2019.0,1,2,-1
BIH,MNE,2019.0,1,1,0
ISR,CZE,2023.0,4,4,0
TGO,GHA,2016.0,2,1,1
GHA,TGO,2018.0,1,1,0
USA,HRV,2017.0,15,11,4
AUS,CAN,2024.0,4,2,2
AUS,ETH,2018.0,4,13,-9
GHA,IRL,2018.0,2,1,1
POL,BEL,2008.0,13,4,9
NZL,MYS,2002.0,1,3,-2
CUB,COL,2020.0,4,1,3
FIN,SGP,2009.0,2,3,-1
BEL,HRV,2016.0,1,2,-1
EGY,ITA,2014.0,7,5,2
ISL,CHN,2021.0,4,1,3
CZE,EGY,2019.0,3,3,0
USA,GRD,2023.0,4,3,1
ITA,ECU,2018.0,7,5,2
FIN,BEL,2019.0,11,10,1
GAB,DEU,2006.0,2,2,0
BRA,GRC,2016.0,2,1,1
IRN,TWN,2023.0,3,4,-1
KOR,PRK,2019.0,4,5,-1
SGP,ESP,2019.0,8,4,4
CHN,MAC,2024.0,6,55,-49
BRA,MYS,2017.0,1,2,-1
ITA,IDN,2019.0,4,1,3
GBR,LAO,2015.0,2,1,1
BGD,SAU,2016.0,9,7,2
KOR,MYS,2020.0,15,15,0
GBR,ZMB,2022.0,8,2,6
SDN,USA,2021.0,4,3,1
POL,EGY,2017.0,2,4,-2
KOR,IRN,2023.0,5,18,-13
CHE,CMR,2022.0,3,2,1
VNM,NZL,2020.0,4,4,0
ITA,PER,2020.0,8,4,4
NZL,DNK,2000.0,2,1,1
GBR,SLE,2023.0,6,3,3
GRC,NOR,2008.0,6,1,5
PRT,PER,2019.0,4,3,1
ITA,EST,2022.0,4,1,3
CYP,OMN,2019.0,2,1,1
BRA,PAK,2021.0,5,3,2
COL,FIN,2018.0,2,2,0
UGA,ZAF,2011.0,2,4,-2
BRA,SWE,2017.0,26,10,16
IRN,ESP,2018.0,30,22,8
JPN,ITA,2013.0,18,23,-5
MYS,RUS,2014.0,1,1,0
MLI,MAR,2017.0,3,3,0
IRL,IRN,2009.0,7,4,3
BGD,GBR,1997.0,4,6,-2
NOR,CHL,2009.0,4,1,3
ROU,HUN,2018.0,10,18,-8
IRN,ROU,2016.0,2,1,1
SWE,UGA,2014.0,5,2,3
SWE,KOR,2000.0,5,1,4
FRA,COD,2021.0,8,2,6
MYS,NZL,2021.0,18,11,7
ARG,DEU,2014.0,23,37,-14
NOR,CHN,2010.0,8,24,-16
GBR,CIV,2012.0,2,1,1
KOR,ITA,2022.0,14,10,4
JPN,TUR,2012.0,7,13,-6
CHE,SVK,2008.0,2,3,-1
CAN,IDN,2016.0,10,3,7
PRT,USA,2003.0,38,62,-24
IND,CHL,2011.0,2,4,-2
CZE,RUS,2011.0,5,10,-5
FIN,TUR,2002.0,1,2,-1
SWE,SAU,2012.0,4,2,2
IND,ITA,2009.0,37,16,21
BEL,HRV,2008.0,1,2,-1
THA,FIN,2004.0,1,3,-2
DEU,LUX,1998.0,7,2,5
VNM,SGP,2017.0,3,8,-5
FRA,QAT,2023.0,7,2,5
USA,BIH,2009.0,4,4,0
JOR,DEU,2003.0,5,10,-5
CHE,GRC,2009.0,16,13,3
CHN,SVN,2012.0,2,2,0
ETH,KEN,2001.0,3,2,1
HRV,CAN,1999.0,1,1,0
MOZ,SWE,2000.0,1,1,0
NLD,IRL,2010.0,13,11,2
AUT,POL,2004.0,2,3,-1
ARG,DEU,2004.0,19,13,6
TUR,AZE,2010.0,10,9,1
PNG,GBR,2001.0,2,2,0
BGR,CZE,1999.0,2,1,1
THA,DEU,2010.0,22,22,0
PAN,COL,2014.0,2,3,-1
MEX,SAU,2023.0,3,1,2
MEX,CHL,2019.0,27,16,11
BEN,CAN,2021.0,2,3,-1
ECU,MEX,2017.0,9,16,-7
KEN,JPN,2014.0,3,8,-5
MYS,DEU,2007.0,5,5,0
PRT,CHE,2009.0,7,10,-3
DNK,ISL,2020.0,5,6,-1
IRN,NOR,2009.0,6,1,5
CHL,DEU,2015.0,30,46,-16
ITA,ISL,2012.0,1,2,-1
MYS,SWE,2014.0,2,5,-3
ECU,BEL,2018.0,8,6,2
JOR,DEU,2013.0,8,9,-1
TWN,POL,2017.0,2,3,-1
RUS,TJK,2013.0,5,2,3
FRA,CZE,2013.0,30,12,18
PAK,QAT,2016.0,5,5,0
SVK,MEX,2022.0,1,2,-1
BEL,VEN,2016.0,3,1,2
CAN,TWN,2022.0,21,6,15
CZE,IND,2014.0,5,21,-16
COL,VEN,2014.0,6,24,-18
GBR,LKA,2015.0,29,11,18
URY,DNK,2012.0,1,1,0
ZAF,NOR,2020.0,9,6,3
UKR,TUR,2015.0,1,1,0
IRL,MYS,2019.0,9,6,3
PAK,ESP,2021.0,8,7,1
DNK,TUR,2017.0,4,7,-3
PAK,SWE,2010.0,8,3,5
CUB,ESP,2022.0,20,10,10
LBY,USA,2021.0,2,6,-4
NGA,SAU,2021.0,12,9,3
IND,BGR,2021.0,2,4,-2
CHE,BRA,2014.0,13,25,-12
ITA,SGP,2015.0,9,5,4
AUS,PNG,2022.0,7,7,0
ARG,MEX,2021.0,21,18,3
MKD,SRB,2019.0,18,12,6
SWE,ZAF,2020.0,15,15,0
SWE,IDN,2021.0,4,2,2
POL,PRT,2006.0,6,2,4
AUT,ALB,2016.0,1,1,0
IRN,USA,2024.0,5,5,0
BEN,GHA,2021.0,4,3,1
ESP,MAR,2010.0,11,8,3
GEO,DEU,2003.0,4,4,0
DEU,MDA,2015.0,3,1,2
BEL,KEN,2007.0,8,1,7
RUS,AZE,2006.0,9,4,5
HRV,CAN,1998.0,2,1,1
FRA,MLI,2016.0,8,6,2
DNK,GRC,2004.0,3,2,1
GEO,RUS,2004.0,6,6,0
NPL,JPN,2012.0,5,7,-2
LTU,LVA,2017.0,3,1,2
AUS,PHL,2002.0,2,11,-9
BEL,SAU,2009.0,3,1,2
PHL,IND,2005.0,2,6,-4
URY,ESP,2004.0,8,9,-1
GBR,LKA,2008.0,13,4,9
NOR,ISR,2003.0,3,2,1
BRN,SAU,2023.0,1,1,0
IDN,DEU,2004.0,5,4,1
KEN,FRA,2010.0,2,8,-6
USA,VEN,2018.0,13,27,-14
KEN,NLD,2010.0,7,6,1
GBR,BOL,2002.0,2,1,1
CZE,HUN,2015.0,2,8,-6
ESP,NIC,2012.0,1,1,0
CHL,DEU,2008.0,21,21,0
IRL,MYS,2009.0,3,1,2
FRA,THA,2012.0,22,15,7
VNM,JPN,2009.0,9,27,-18
IRL,SWE,2011.0,10,11,-1
ECU,CHN,2021.0,3,2,1
ISR,ESP,2013.0,6,9,-3
KGZ,TUR,2013.0,3,2,1
SVN,SWE,2006.0,2,3,-1
QAT,CHN,2018.0,5,1,4
OMN,PAK,2022.0,5,12,-7
TUR,SAU,2016.0,11,2,9
SAU,SGP,2021.0,1,8,-7
PAK,FIN,2016.0,3,2,1
BEL,ECU,2023.0,3,1,2
NLD,CHL,2023.0,10,9,1
SAU,QAT,1999.0,3,0,3
CAN,PHL,2010.0,4,0,4
PAK,SDN,2009.0,1,0,1
CHE,OMN,2007.0,2,0,2
BRA,IDN,2009.0,1,0,1
DEU,GRD,1999.0,1,0,1
GRD,DEU,2015.0,1,0,1
NAM,SAU,2008.0,1,0,1
LKA,ZAF,2021.0,1,0,1
SUR,,2019.0,12,0,12
MNG,,2005.0,5,0,5
,SLV,1999.0,6,0,6
,LBR,1998.0,1,0,1
SVK,HKG,2011.0,1,0,1
UKR,TWN,2009.0,2,0,2
,BDI,2010.0,12,0,12
VNM,CAN,1999.0,1,0,1
,YEM,2005.0,28,0,28
IRN,EST,2017.0,3,0,3
BEL,DZA,2016.0,6,0,6
ITA,COG,2016.0,1,0,1
,NIC,2010.0,20,0,20
AUT,BFA,2014.0,2,0,2
,AGO,2010.0,19,0,19
ZMB,SDN,2019.0,2,0,2
SDN,ZMB,2020.0,1,0,1
IRL,UGA,2011.0,1,0,1
GBR,BRN,2004.0,3,0,3
YEM,ITA,2018.0,1,0,1
COG,,2014.0,44,0,44
CAN,VNM,2010.0,7,0,7
CIV,CHN,2019.0,1,0,1
CHN,CIV,2021.0,2,0,2
EGY,BIH,2014.0,2,0,2
TUR,ARE,2015.0,7,0,7
HUN,GRC,2015.0,4,0,4
,TON,2010.0,2,0,2
AGO,,2017.0,24,0,24
MNG,CHN,2010.0,1,0,1
NCL,NZL,2005.0,2,0,2
HKG,PAN,2023.0,3,0,3
SHN,USA,2022.0,1,0,1
MTQ,,2023.0,8,0,8
PNG,KHM,2010.0,2,0,2
,MNG,2005.0,49,0,49
NGA,HKG,2017.0,3,0,3
MLI,ITA,2017.0,1,0,1
KEN,CRI,2018.0,1,0,1
,SSD,2013.0,6,0,6
THA,NOR,2020.0,2,0,2
,SLB,2013.0,17,0,17
SEN,COM,2017.0,1,0,1
WSM,NZL,2019.0,1,0,1
ROU,EGY,2023.0,1,0,1
MCO,,2023.0,22,0,22
MYS,AFG,2016.0,2,0,2
UKR,KWT,2005.0,1,0,1
,BLZ,2007.0,3,0,3
FJI,SLB,2021.0,2,0,2
BRA,NLD,2024.0,2,0,2
IRL,OMN,2021.0,1,0,1
,GNB,2014.0,7,0,7
LSO,ZMB,2022.0,3,0,3
NGA,HKG,2016.0,2,0,2
GNB,BFA,2018.0,1,0,1
IND,TTO,2011.0,5,0,5
MYS,ESP,2023.0,5,0,5
GIN,USA,2020.0,3,0,3
IRL,IDN,2021.0,1,0,1
,ATA,2016.0,2,0,2
ATA,GBR,2019.0,1,0,1
MWI,NOR,2023.0,2,0,2
,VCT,2018.0,2,0,2
BRA,KEN,2006.0,2,0,2
UGA,THA,2023.0,1,0,1
THA,KOR,2024.0,2,0,2
HKG,RWA,2021.0,1,0,1
FRO,,2018.0,4,0,4
YEM,IDN,2018.0,1,0,1
,AZE,2004.0,93,0,93
GRC,IND,2009.0,2,0,2
ITA,TUN,2007.0,4,0,4
MDA,NLD,2010.0,1,0,1
GBR,BIH,2012.0,3,0,3
TLS,,2008.0,1,0,1
TUR,MEX,2010.0,5,0,5
PAK,PHL,2013.0,1,0,1
,ZWE,1999.0,53,0,53
UKR,SVN,2010.0,2,0,2
MSR,,2011.0,1,0,1
KHM,SVK,2019.0,2,0,2
MYS,CMR,2016.0,1,0,1
IND,BWA,2004.0,2,0,2
NLD,UGA,2004.0,2,0,2
MCO,,2010.0,12,0,12
GBR,URY,2011.0,1,0,1
GRD,,2018.0,12,0,12
SAU,JPN,2000.0,1,0,1
OMN,CHE,2023.0,1,0,1
LUX,AUT,2013.0,3,0,3
LTU,TUR,2018.0,2,0,2
SWE,MLI,2014.0,1,0,1
ROU,MDA,2010.0,6,0,6
GBR,LBY,2005.0,4,0,4
FIN,THA,2014.0,5,0,5
COD,FRA,2008.0,3,0,3
PRT,AUT,2004.0,4,0,4
MNE,,2010.0,3,0,3
MDG,CHE,2003.0,1,0,1
,MAC,2009.0,57,0,57
GEO,SAU,2023.0,1,0,1
NAM,DEU,2023.0,2,0,2
JPN,SAU,2003.0,3,0,3
FJI,SWE,2019.0,1,0,1
JPN,YEM,2016.0,1,0,1
,AFG,2006.0,12,0,12
IDN,KOR,2005.0,3,0,3
NPL,,2006.0,30,0,30
ARG,EST,2010.0,1,0,1
CZE,GRC,2007.0,3,0,3
AUS,TZA,2019.0,2,0,2
EGY,SOM,2018.0,2,0,2
SYC,FRA,2018.0,1,0,1
LVA,MLT,2017.0,1,0,1
PYF,MCO,2020.0,2,0,2
BTN,,2019.0,12,0,12
NOR,KWT,2019.0,1,0,1
IRQ,BGR,2014.0,1,0,1
CHE,MLT,2018.0,2,0,2
,COM,2017.0,9,0,9
COM,,2023.0,8,0,8
AFG,DNK,2019.0,1,0,1
BRB,GBR,2022.0,3,0,3
ROU,AUT,2018.0,7,0,7
USA,GNQ,2017.0,3,0,3
LBN,MAR,2016.0,1,0,1
PNG,MLI,2014.0,1,0,1
HUN,PSE,2023.0,1,0,1
,PRK,2014.0,50,0,50
PAK,ARE,2010.0,6,0,6
UKR,LTU,2019.0,5,0,5
OMN,QAT,2003.0,1,0,1
ETH,TZA,2009.0,1,0,1
TGO,,2003.0,6,0,6
CRI,NLD,2002.0,3,0,3
HRV,HKG,2002.0,1,0,1
RUS,FJI,2001.0,1,0,1
VEN,SWE,2000.0,2,0,2
GAB,,2005.0,11,0,11
BGR,CZE,2023.0,1,0,1
SEN,MAR,2013.0,1,0,1
SWE,EGY,2000.0,3,0,3
UKR,ROU,1998.0,2,0,2
PHL,FRA,1998.0,3,0,3
TON,,2020.0,4,0,4
KAZ,,2001.0,28,0,28
KEN,CIV,2017.0,2,0,2
BRB,AUS,2003.0,1,0,1
ETH,,2008.0,43,0,43
AUT,PSE,2007.0,1,0,1
CIV,CRI,2016.0,3,0,3
IRQ,LBN,2019.0,2,0,2
MNG,,2012.0,22,0,22
MEX,QAT,2015.0,1,0,1
CUB,CHE,1999.0,1,0,1
ROU,PRT,2000.0,3,0,3
ROU,AUS,1998.0,2,0,2
ITA,ALB,2009.0,4,0,4
MLI,FIN,2007.0,1,0,1
BEL,ECU,1998.0,1,0,1
ECU,CHE,2000.0,1,0,1
URY,CAN,1999.0,1,0,1
KHM,DNK,2007.0,1,0,1
,PSE,2006.0,39,0,39
IDN,MMR,2018.0,2,0,2
BIH,BEL,1997.0,2,0,2
,BRB,1998.0,11,0,11
QAT,,2003.0,6,0,6
,GLP,1997.0,13,0,13
KEN,COD,2009.0,1,0,1
COD,KEN,2011.0,1,0,1
DNK,ARG,2008.0,1,0,1
JPN,HRV,2016.0,2,0,2
AZE,,2002.0,14,0,14
JPN,CHL,2004.0,4,0,4
COL,ARM,2004.0,1,0,1
ZAF,ECU,2002.0,1,0,1
FIN,SVK,2000.0,2,0,2
SAU,TUR,2000.0,2,0,2
,NAM,1997.0,13,0,13
,MTQ,2020.0,5,0,5
ITA,CRI,2006.0,2,0,2
MWI,,1999.0,5,0,5
BEL,BWA,2010.0,4,0,4
BFA,NGA,2006.0,3,0,3
HKG,LKA,2001.0,1,0,1
HKG,LKA,2004.0,2,0,2
BRA,ALB,2014.0,2,0,2
TZA,,2011.0,52,0,52
AUS,SYR,2011.0,1,0,1
ARE,HUN,2006.0,1,0,1
,MAC,1994.0,5,0,5
KOR,PRI,2009.0,1,0,1
SEN,TUN,2004.0,1,0,1
CAN,SWZ,2017.0,1,0,1
CAN,TZA,2002.0,2,0,2
TWN,SAU,2011.0,5,0,5
ETH,MLI,2018.0,1,0,1
,TKM,2006.0,2,0,2
RUS,LBY,2005.0,1,0,1
GRC,BRA,2006.0,1,0,1
DEU,GHA,1999.0,1,0,1
ISR,DZA,1998.0,2,0,2
POL,LBY,2022.0,2,0,2
LVA,USA,2000.0,5,0,5
HUN,GRC,2001.0,1,0,1
HRV,TUR,1997.0,1,0,1
UKR,CZE,2000.0,5,0,5
BFA,,2001.0,12,0,12
SRB,MAR,2000.0,1,0,1
GBR,MNE,2008.0,1,0,1
LAO,PHL,2015.0,1,0,1
AUS,FLK,2011.0,1,0,1
FLK,AUS,2013.0,1,0,1
USA,PRY,2015.0,3,0,3
ZAF,CHL,2011.0,4,0,4
GUF,,2012.0,3,0,3
ROU,EST,2021.0,1,0,1
USA,SLE,2009.0,3,0,3
GRD,TTO,2010.0,6,0,6
AFG,,2014.0,11,0,11
TCD,FRA,2006.0,2,0,2
CAN,SYR,2009.0,2,0,2
BWA,,2010.0,18,0,18
CRI,ECU,2019.0,2,0,2
HUN,SGP,2013.0,1,0,1
COG,KOR,2018.0,1,0,1
CYM,,2012.0,4,0,4
,NIC,2006.0,22,0,22
SOM,,2015.0,4,0,4
PRI,RUS,2013.0,1,0,1
RUS,PRI,2014.0,1,0,1
TWN,ZAF,2000.0,1,0,1
ZAF,TWN,2001.0,1,0,1
USA,NAM,2008.0,3,0,3
TUN,PRT,2014.0,6,0,6
TUR,SYR,2018.0,2,0,2
CHE,CYP,2018.0,1,0,1
ARM,BEL,2011.0,1,0,1
DNK,CYP,2023.0,2,0,2
ROU,TWN,2003.0,4,0,4
POL,MKD,2007.0,1,0,1
NER,,2013.0,9,0,9
USA,MNE,2023.0,1,0,1
LUX,,2026.0,26,0,26
REU,,2013.0,7,0,7
SWZ,GBR,2020.0,1,0,1
TUR,QAT,2010.0,1,0,1
TZA,KOR,2013.0,1,0,1
,SYC,2006.0,2,0,2
CHL,BOL,2022.0,2,0,2
UGA,CHE,2011.0,3,0,3
GUY,IND,2021.0,1,0,1
JPN,VUT,2009.0,1,0,1
MLI,MAR,2013.0,1,0,1
TUV,AUS,2010.0,1,0,1
MYS,CHE,2010.0,1,0,1
THA,HUN,2018.0,1,0,1
LVA,FIN,2007.0,2,0,2
GBR,MNG,2016.0,1,0,1
JAM,AUS,2008.0,1,0,1
ZAF,IRQ,2016.0,2,0,2
,PYF,2010.0,12,0,12
NPL,ARE,2017.0,1,0,1
NZL,ETH,2015.0,1,0,1
KWT,PAK,2019.0,1,0,1
EGY,CHL,2022.0,2,0,2
PRT,MYS,2016.0,3,0,3
CYP,SAU,2018.0,1,0,1
PAK,NPL,2003.0,1,0,1
,AFG,2010.0,18,0,18
ETH,,2004.0,24,0,24
ARG,TLS,2013.0,1,0,1
TLS,,2015.0,6,0,6
PLW,,2023.0,9,0,9
JAM,CAN,2008.0,3,0,3
MYS,CMR,2018.0,2,0,2
MWI,SWE,2020.0,1,0,1
COL,COM,2013.0,4,0,4
LBR,IND,2017.0,1,0,1
CAN,IRQ,2013.0,1,0,1
HKG,LKA,2015.0,2,0,2
NLD,PAN,2021.0,3,0,3
CAN,MKD,2015.0,1,0,1
MKD,CAN,2017.0,1,0,1
FJI,JOR,2018.0,1,0,1
MEX,NGA,2017.0,1,0,1
MMR,,2015.0,10,0,10
,KNA,2012.0,11,0,11
SWE,BHR,2017.0,1,0,1
,NAM,2012.0,37,0,37
BHS,,2023.0,23,0,23
BGD,IRL,2009.0,1,0,1
BDI,UGA,2016.0,1,0,1
AUS,CCK,2023.0,2,0,2
JOR,KWT,2013.0,4,0,4
,BHS,2012.0,11,0,11
ZWE,DEU,2023.0,3,0,3
LUX,SWE,2014.0,1,0,1
SRB,DNK,2015.0,1,0,1
MEX,NOR,2018.0,3,0,3
KOR,JOR,2017.0,1,0,1
KOR,MEX,2016.0,3,0,3
ISL,NZL,2007.0,1,0,1
ZWE,MLI,2012.0,1,0,1
,GLP,2012.0,24,0,24
CUB,ARG,2016.0,5,0,5
,LAO,1999.0,7,0,7
,SWZ,2003.0,7,0,7
DOM,DMA,2014.0,5,0,5
CYP,BGD,2022.0,2,0,2
TUR,QAT,2023.0,8,0,8
BEN,NGA,2023.0,1,0,1
CAN,BRN,2023.0,1,0,1
THA,MAR,2023.0,1,0,1
EGY,IRQ,2016.0,9,0,9
HUN,TUR,2000.0,2,0,2
GRD,,2016.0,21,0,21
IND,YEM,2012.0,9,0,9
,NIC,2000.0,8,0,8
,MLI,1997.0,24,0,24
IRN,LBN,2017.0,1,0,1
POL,GRL,2021.0,1,0,1
KWT,ESP,2022.0,1,0,1
,MTQ,2007.0,6,0,6
NOR,PRT,1998.0,3,0,3
IRQ,CZE,2021.0,3,0,3
,VIR,2015.0,9,0,9
CZE,NOR,2022.0,8,0,8
SLB,,2020.0,18,0,18
JOR,LBY,2017.0,1,0,1
NCL,GBR,2020.0,2,0,2
NLD,ARE,2016.0,9,0,9
SWE,GRL,2022.0,1,0,1
ESP,MRT,2022.0,1,0,1
KOR,MAC,2017.0,1,0,1
JPN,KAZ,2012.0,6,0,6
,EUE,2003.0,6,0,6
BGD,CHN,2012.0,8,0,8
SLE,,2008.0,2,0,2
HRV,IND,2010.0,1,0,1
EGY,ISR,2021.0,1,0,1
AUS,UZB,2021.0,1,0,1
ESP,NLD,2024.0,1,0,1
BWA,CMR,2004.0,1,0,1
SVN,AUS,2023.0,4,0,4
KGZ,ALB,2021.0,1,0,1
MEX,KEN,2021.0,1,0,1
GRC,SRB,2022.0,1,0,1
UGA,,2026.0,19,0,19
RUS,MLT,2017.0,1,0,1
COD,,2018.0,13,0,13
CHL,HND,2017.0,1,0,1
VEN,PAN,2018.0,2,0,2
GUY,,2002.0,2,0,2
BOL,VNM,2012.0,1,0,1
VNM,BOL,2014.0,1,0,1
AFG,IRN,2015.0,1,0,1
CHE,SGP,1997.0,3,0,3
JOR,CHE,2017.0,3,0,3
AUS,TLS,2013.0,3,0,3
CMR,,2001.0,18,0,18
BGR,LVA,2022.0,1,0,1
BRA,BLZ,2018.0,2,0,2
,MRT,2012.0,16,0,16
IND,BRB,2011.0,2,0,2
TZA,SLE,2019.0,1,0,1
FIN,COL,2023.0,1,0,1
TUR,SDN,2021.0,2,0,2
GHA,ETH,2021.0,2,0,2
NGA,KOR,2019.0,4,0,4
CUB,SWE,2020.0,2,0,2
ZMB,ITA,2019.0,1,0,1
LTU,RUS,2019.0,5,0,5
JPN,TZA,2022.0,6,0,6
USA,POL,2024.0,2,0,2
CYP,MYS,2015.0,1,0,1
,PAN,2020.0,41,0,41
CHN,QAT,2015.0,6,0,6
KHM,TZA,2019.0,1,0,1
MWI,,2007.0,17,0,17
GBR,BTN,2019.0,1,0,1
,CPV,2011.0,7,0,7
CPV,PRT,2014.0,1,0,1
ESP,PSE,2022.0,1,0,1
KEN,GEO,2022.0,1,0,1
AUS,TZA,2021.0,2,0,2
,SMR,2000.0,1,0,1
,KIR,2008.0,1,0,1
TUR,YEM,2023.0,4,0,4
ESP,SVK,2023.0,2,0,2
ISR,UZB,2022.0,2,0,2
ESP,ECU,2024.0,1,0,1
ITA,SLE,2021.0,1,0,1
SLE,ITA,2022.0,1,0,1
DNK,NGA,1998.0,1,0,1
,CAF,2001.0,8,0,8
ALB,SYR,2008.0,1,0,1
FRA,SYR,2007.0,1,0,1
AIA,,2024.0,11,0,11
ZMB,,2011.0,12,0,12
RWA,KEN,2000.0,1,0,1
,BRB,1999.0,4,0,4
,BTN,2001.0,3,0,3
POL,IRL,2003.0,2,0,2
,LAO,1998.0,13,0,13
VEN,BRA,2022.0,8,0,8
,GAB,1999.0,14,0,14
CRI,AUS,2007.0,1,0,1
LBY,HUN,1998.0,3,0,3
,KIR,2001.0,1,0,1
,MNG,1997.0,10,0,10
SWE,ARM,2012.0,3,0,3
,MNG,2002.0,26,0,26
LKA,PHL,2005.0,3,0,3
PHL,LKA,2008.0,1,0,1
LKA,LAO,2016.0,1,0,1
,TCD,1999.0,1,0,1
BWA,CAN,2009.0,2,0,2
,SOM,2017.0,10,0,10
NLD,GHA,2003.0,1,0,1
KHM,DEU,2000.0,1,0,1
KWT,BGR,2011.0,1,0,1
FRA,BDI,2014.0,1,0,1
NOR,SJM,2003.0,1,0,1
HUN,EGY,2007.0,6,0,6
IRN,IRL,2001.0,3,0,3
CZE,CRI,2003.0,1,0,1
EST,DNK,2001.0,2,0,2
PRI,ITA,1999.0,1,0,1
MYS,BHR,2003.0,1,0,1
EGY,SYR,2008.0,2,0,2
ALB,TUR,2002.0,1,0,1
ALB,,2003.0,6,0,6
DEU,GAB,2007.0,4,0,4
,LBY,1999.0,14,0,14
PRT,BGR,2005.0,1,0,1
BRB,SWE,2020.0,1,0,1
,SYC,2000.0,3,0,3
MKD,BGR,2005.0,4,0,4
BEN,,2010.0,12,0,12
HRV,GRC,2018.0,4,0,4
UZB,KEN,2016.0,1,0,1
ERI,SWE,1999.0,1,0,1
ERI,,2008.0,3,0,3
LSO,ZAF,2003.0,4,0,4
GRC,NZL,2016.0,4,0,4
GLP,FIN,2001.0,1,0,1
SVN,ESP,2009.0,3,0,3
SLV,CHL,2008.0,1,0,1
NGA,ISR,2003.0,1,0,1
ESP,GRD,2016.0,2,0,2
FIN,GHA,2017.0,3,0,3
RUS,HUN,1998.0,1,0,1
FIN,BWA,2004.0,1,0,1
VUT,IDN,2006.0,1,0,1
CZE,HRV,1999.0,3,0,3
LKA,,2000.0,10,0,10
DZA,TWN,2002.0,1,0,1
AUS,LKA,2003.0,5,0,5
BOL,ECU,2003.0,1,0,1
CMR,NLD,2009.0,1,0,1
CYM,ZMB,2008.0,1,0,1
ZMB,ISL,2014.0,1,0,1
OMN,DEU,2008.0,2,0,2
ZMB,NGA,2006.0,1,0,1
PSE,NLD,2007.0,1,0,1
TUR,ECU,2017.0,1,0,1
MKD,FRA,2012.0,1,0,1
GBR,QAT,2002.0,1,0,1
ITA,MKD,2009.0,1,0,1
PER,HKG,2022.0,1,0,1
ESP,SGP,2006.0,3,0,3
MDA,CZE,2017.0,2,0,2
MEX,CHE,2024.0,2,0,2
CUB,GBR,2016.0,3,0,3
CAN,GLP,2012.0,1,0,1
SWZ,,2010.0,6,0,6
SUR,,2009.0,2,0,2
SUR,,2021.0,8,0,8
DNK,ETH,2008.0,1,0,1
IRL,LBY,2015.0,3,0,3
IRL,LBY,2008.0,2,0,2
,ALB,2003.0,13,0,13
NOR,IDN,2007.0,1,0,1
MYS,QAT,2010.0,1,0,1
THA,LKA,2005.0,1,0,1
MYS,OMN,2003.0,2,0,2
LAO,NLD,2014.0,1,0,1
NLD,MDA,2000.0,1,0,1
NER,GBR,2021.0,1,0,1
LBR,CHE,2020.0,2,0,2
SGP,HUN,2001.0,1,0,1
IND,POL,2013.0,7,0,7
UKR,LVA,2016.0,3,0,3
JPN,KGZ,2013.0,2,0,2
VNM,SEN,2018.0,1,0,1
GHA,MYS,2012.0,3,0,3
ECU,AUS,2007.0,1,0,1
TKM,TUR,2019.0,1,0,1
BRA,PAK,2006.0,1,0,1
ALB,,2013.0,23,0,23
MKD,DNK,2013.0,1,0,1
DNK,MKD,2015.0,1,0,1
ZAF,LTU,2019.0,1,0,1
PRT,MOZ,2010.0,1,0,1
CAN,SLV,2013.0,1,0,1
,TJK,2007.0,11,0,11
PHL,VEN,2010.0,1,0,1
THA,MMR,2011.0,1,0,1
,GAB,2007.0,33,0,33
GRC,GHA,2016.0,1,0,1
GRC,GHA,2018.0,1,0,1
KEN,BRA,2016.0,1,0,1
PRT,PAK,2014.0,1,0,1
BRA,GLP,2007.0,1,0,1
BEL,EST,2013.0,1,0,1
SSD,GMB,2021.0,1,0,1
ETH,KOR,2012.0,1,0,1
BRA,IDN,2021.0,2,0,2
DEU,BMU,2018.0,1,0,1
PYF,AUS,2014.0,1,0,1
GAB,SLE,2012.0,1,0,1
KWT,BEL,2010.0,1,0,1
POL,LVA,2007.0,2,0,2
,SYC,2010.0,4,0,4
CHN,JOR,2004.0,1,0,1
JOR,FIN,2009.0,1,0,1
OMN,GEO,2021.0,1,0,1
GBR,FJI,2011.0,3,0,3
GBR,LCA,2013.0,1,0,1
LCA,TTO,2017.0,1,0,1
PER,MYS,2023.0,1,0,1
,MDV,1994.0,3,0,3
ZWE,SWE,2015.0,1,0,1
CHN,TCD,2017.0,1,0,1
IND,MAR,2016.0,3,0,3
HRV,CHE,2013.0,5,0,5
IND,RUS,2011.0,3,0,3
TTO,ARE,2018.0,1,0,1
ETH,CHN,2014.0,4,0,4
SLE,IRL,2016.0,2,0,2
NPL,CHE,2016.0,2,0,2
IRN,GEO,2022.0,2,0,2
BTN,JPN,2017.0,2,0,2
CHN,BHS,2020.0,1,0,1
,MDV,2011.0,2,0,2
MNE,BIH,2016.0,1,0,1
IDN,MMR,2017.0,1,0,1
POL,PER,2021.0,1,0,1
ARM,NOR,2021.0,1,0,1
EGY,AUT,2023.0,4,0,4
CHN,PER,2013.0,1,0,1
CMR,ZWE,2020.0,1,0,1
FRA,ECU,2004.0,1,4,-3
KEN,JPN,1998.0,5,4,1
NCL,AUS,2010.0,3,1,2
CHE,POL,2010.0,9,22,-13
PHL,DEU,2019.0,7,9,-2
FRA,LAO,2008.0,1,3,-2
THA,ESP,2017.0,5,1,4
USA,HRV,2007.0,17,16,1
IND,MEX,2000.0,6,1,5
AUS,AUT,2000.0,30,25,5
PRI,ESP,2003.0,1,1,0
RUS,SGP,2003.0,1,3,-2
CAN,CRI,2017.0,5,3,2
SGP,DEU,2017.0,39,41,-2
CYP,GBR,2002.0,2,8,-6
FRA,VEN,2012.0,4,7,-3
FRA,MYS,2010.0,7,5,2
CHL,JPN,2002.0,1,1,0
NLD,ZAF,2006.0,18,12,6
CHN,FIN,2000.0,7,6,1
CUB,DEU,2004.0,4,4,0
RUS,BLR,2007.0,9,16,-7
SWE,IRL,2015.0,9,12,-3
HKG,SAU,2011.0,3,1,2
TWN,FRA,1998.0,5,4,1
SAU,CAN,2002.0,18,24,-6
SRB,UKR,2004.0,2,3,-1
HUN,ISR,1998.0,2,1,1
MEX,COL,1999.0,4,8,-4
IND,BEL,1998.0,5,3,2
IRN,JPN,2021.0,13,13,0
DEU,UGA,2001.0,4,1,3
DEU,LTU,2008.0,8,12,-4
PAK,CAN,2012.0,20,12,8
IDN,KOR,2016.0,15,15,0
PRT,FRA,1998.0,14,19,-5
DEU,IRQ,2022.0,5,6,-1
ETH,IND,2016.0,11,45,-34
EGY,QAT,2019.0,15,11,4
OMN,EGY,2020.0,6,8,-2
MYS,NOR,2018.0,7,2,5
TUR,CYP,2006.0,6,4,2
SAU,ZAF,2020.0,9,21,-12
AUS,ISR,2013.0,12,15,-3
NLD,KOR,2020.0,6,18,-12
FRA,MYS,2023.0,3,7,-4
DEU,SYR,2018.0,2,7,-5
PHL,JPN,2023.0,12,15,-3
MOZ,ESP,2018.0,5,6,-1
LBN,NLD,2022.0,10,3,7
DNK,JPN,2022.0,7,11,-4
GBR,EST,2013.0,3,10,-7
FRA,SDN,2021.0,1,2,-1
KOR,QAT,2015.0,3,1,2
CHE,IRN,2017.0,15,24,-9
IND,CZE,2023.0,19,19,0
FRA,MCO,2021.0,9,10,-1
BTN,AUS,2017.0,9,2,7
ZAF,ZWE,2019.0,45,38,7
SYR,IND,2017.0,1,1,0
KEN,ESP,2016.0,2,2,0
JPN,COG,2013.0,1,1,0
SRB,DEU,2007.0,42,18,24
RUS,FIN,2001.0,34,17,17
BEL,NOR,2009.0,6,5,1
TUR,PRT,2021.0,6,1,5
IND,MWI,2018.0,1,1,0
HRV,BIH,2023.0,4,7,-3
AUT,BEL,2021.0,18,25,-7
ESP,HND,2020.0,2,4,-2
IDN,DEU,2020.0,12,35,-23
BOL,FRA,2023.0,1,1,0
CHN,IRQ,2022.0,12,4,8
SAU,DEU,2023.0,9,11,-2
NLD,IND,2011.0,17,20,-3
NAM,ZWE,2013.0,1,1,0
GRC,CYP,2004.0,5,5,0
JPN,ARE,2019.0,8,2,6
ARG,BEL,2012.0,6,2,4
ZAF,NGA,2008.0,12,17,-5
RUS,NLD,2007.0,10,12,-2
COL,NGA,2013.0,1,1,0
BWA,IND,2000.0,4,2,2
SVN,CZE,2010.0,2,1,1
ARE,KWT,2006.0,3,2,1
CAN,PAK,2010.0,11,15,-4
FRA,NER,1998.0,3,8,-5
GRC,NOR,2019.0,9,6,3
PAK,EGY,2015.0,3,2,1
SVK,SVN,2010.0,13,27,-14
ARG,AUS,2008.0,7,5,2
ITA,IRL,2009.0,24,10,14
JPN,LAO,2014.0,4,1,3
AUT,PRT,2011.0,7,1,6
ISL,IRL,2013.0,3,1,2
KEN,TZA,2020.0,17,4,13
AUT,MYS,2010.0,2,3,-1
RUS,BRA,2006.0,8,6,2
FRA,MYS,2006.0,4,1,3
DEU,TUN,2005.0,2,1,1
BEL,BGR,2017.0,4,6,-2
AUS,KOR,2017.0,31,65,-34
PAK,ITA,2018.0,14,21,-7
BGD,SAU,2020.0,4,7,-3
CZE,IRN,2018.0,4,10,-6
KOR,LKA,2022.0,8,5,3
PRT,ARG,2015.0,6,3,3
HRV,DEU,2018.0,18,16,2
FRA,SVN,2020.0,9,5,4
DEU,UGA,2004.0,2,2,0
BEL,POL,2011.0,8,10,-2
PAK,PRT,2021.0,3,2,1
NOR,SRB,2010.0,6,4,2
IRL,ROU,2009.0,2,1,1
ARM,RUS,2000.0,3,8,-5
FRA,HRV,2005.0,4,4,0
HUN,CHE,2005.0,11,6,5
NGA,TZA,2008.0,1,2,-1
KOR,DEU,2006.0,22,19,3
BGR,NOR,2000.0,1,2,-1
MEX,BRA,2008.0,12,12,0
NZL,DEU,2000.0,17,9,8
POL,AUS,2001.0,2,5,-3
NOR,AUT,2005.0,4,3,1
SVK,POL,2008.0,1,5,-4
CAN,ZAF,1997.0,5,6,-1
JPN,HUN,2014.0,5,7,-2
BGR,CHE,1998.0,5,4,1
GHA,USA,2010.0,7,13,-6
VEN,GBR,2005.0,3,8,-5
NLD,ROU,2001.0,3,8,-5
CAN,GRC,2006.0,12,9,3
ISR,BEL,1999.0,5,6,-1
ISR,ZAF,2006.0,3,2,1
BEL,GRC,2010.0,8,10,-2
BEL,SAU,2017.0,7,2,5
TUR,SAU,2009.0,2,8,-6
ARM,FRA,2011.0,2,2,0
GRC,POL,2009.0,4,4,0
IRN,AZE,2010.0,2,6,-4
IRQ,USA,2008.0,9,3,6
IRN,ESP,2011.0,6,10,-4
NZL,DNK,2003.0,5,4,1
CAN,FIN,2015.0,12,18,-6
HKG,IND,2011.0,3,7,-4
ECU,ITA,2009.0,2,1,1
PAK,ARE,2015.0,8,4,4
DNK,BRA,2006.0,5,2,3
RUS,POL,2016.0,8,13,-5
NGA,CHE,2017.0,6,1,5
FRA,THA,2013.0,24,13,11
CHE,PRT,2010.0,8,12,-4
CAN,JOR,2011.0,12,12,0
GRC,CAN,2019.0,11,17,-6
CHL,BRA,2010.0,9,19,-10
DEU,VEN,2009.0,5,9,-4
ESP,MOZ,2010.0,2,3,-1
TUR,CHL,2015.0,1,3,-2
GBR,SVN,2018.0,15,9,6
JAM,BRB,2019.0,4,1,3
GBR,AFG,2014.0,2,3,-1
IND,IRN,2020.0,16,5,11
DEU,KOR,2010.0,35,41,-6
FIN,HKG,2019.0,3,5,-2
ARG,CAN,2021.0,22,10,12
TUR,DEU,2014.0,45,56,-11
BTN,IND,2018.0,2,6,-4
DEU,TZA,2022.0,5,6,-1
IND,YEM,2018.0,6,2,4
NOR,PAK,2016.0,4,5,-1
RUS,EST,2012.0,5,2,3
CYP,IRN,2015.0,2,2,0
CZE,ESP,2019.0,14,28,-14
PRT,CHN,2015.0,18,8,10
FRA,KEN,2020.0,7,5,2
ESP,ROU,2015.0,8,11,-3
CAN,TTO,2016.0,5,2,3
POL,NOR,2012.0,6,1,5
KHM,USA,2020.0,10,7,3
DNK,CHL,2023.0,4,4,0
NLD,NZL,2018.0,19,15,4
BEL,IRL,2015.0,9,13,-4
TWN,ETH,2019.0,7,5,2
BRA,SGP,2020.0,1,1,0
SAU,DZA,2021.0,16,6,10
MAR,CAN,2016.0,8,10,-2
NOR,GHA,2014.0,2,1,1
MEX,NLD,2017.0,19,13,6
ITA,LKA,2018.0,2,1,1
CHN,PRK,2020.0,14,10,4
AUS,FJI,2014.0,13,7,6
BRA,GEO,2022.0,1,1,0
AUT,ROU,2020.0,3,4,-1
DEU,KOR,2000.0,18,12,6
ARE,QAT,2021.0,10,10,0
CHL,BEL,2023.0,5,2,3
ITA,PER,2022.0,2,3,-1
IRN,EGY,2019.0,3,2,1
CHN,RWA,2023.0,5,3,2
JOR,GBR,2022.0,20,41,-21
NLD,JPN,2022.0,13,25,-12
BEL,UKR,2009.0,2,3,-1
THA,NLD,2023.0,2,4,-2
FRA,ARE,2023.0,16,10,6
IRN,SAU,2011.0,2,1,1
ARG,COL,2022.0,13,18,-5
FJI,NZL,2017.0,2,2,0
SAU,MEX,2016.0,1,4,-3
PRT,CHE,2016.0,20,12,8
ITA,CYP,2016.0,4,1,3
CHE,LTU,2016.0,3,5,-2
BRN,BGD,2019.0,4,3,1
VNM,USA,2014.0,21,26,-5
CHL,PRT,2018.0,3,2,1
PER,IND,2022.0,2,2,0
IRQ,IRN,2018.0,13,22,-9
MAR,POL,2020.0,2,1,1
CHL,AUT,2022.0,4,1,3
POL,ESP,2010.0,20,15,5
PRT,QAT,2014.0,3,1,2
DNK,PRT,2020.0,14,8,6
FRA,LTU,2019.0,5,3,2
SWE,LKA,2005.0,2,1,1
PAK,DNK,2021.0,5,7,-2
TZA,GBR,2021.0,9,21,-12
PER,DEU,2017.0,4,2,2
ETH,USA,2002.0,4,2,2
GBR,TZA,2002.0,10,4,6
JPN,PHL,2000.0,10,13,-3
HUN,JPN,2012.0,8,6,2
PRT,JPN,2009.0,1,5,-4
PAN,BRA,2014.0,3,3,0
MAR,MAC,2013.0,12,8,4
ITA,VEN,1999.0,3,4,-1
BWA,AUS,2006.0,4,1,3
BRA,PAK,2014.0,5,7,-2
SRB,RUS,2009.0,2,2,0
TUR,FRA,2001.0,7,11,-4
FRA,TUR,2003.0,11,5,6
NLD,PHL,2000.0,1,2,-1
MLI,FRA,2000.0,3,4,-1
AUT,FRA,2004.0,18,14,4
THA,JPN,2006.0,31,64,-33
DEU,MEX,2001.0,18,14,4
FIN,CHE,2010.0,13,10,3
FRA,SVN,2007.0,4,4,0
JPN,FIN,2004.0,8,11,-3
CYP,GRC,2001.0,8,3,5
PRT,FIN,2004.0,2,1,1
UKR,ESP,2004.0,4,2,2
PHL,DEU,2011.0,4,5,-1
MEX,GTM,2007.0,2,1,1
NGA,GHA,2015.0,4,7,-3
DNK,POL,2014.0,6,7,-1
MYS,EGY,2017.0,9,6,3
JOR,OMN,1999.0,3,2,1
SWE,UGA,2007.0,4,6,-2
CIV,FRA,2012.0,19,47,-28
SVN,DEU,2002.0,5,9,-4
KGZ,RUS,2022.0,3,8,-5
POL,JPN,2014.0,7,9,-2
ETH,NGA,2020.0,4,3,1
DJI,FRA,2012.0,1,5,-4
GBR,MCO,2010.0,2,1,1
CAN,CZE,2014.0,13,10,3
BEL,LUX,2010.0,16,6,10
PRT,BEL,2014.0,15,7,8
PRT,URY,2016.0,2,1,1
ARG,GTM,2021.0,1,1,0
JOR,QAT,2012.0,5,1,4
GBR,KEN,2010.0,18,27,-9
MEX,BEL,2018.0,5,10,-5
LKA,CHN,2010.0,1,1,0
SWE,VNM,2012.0,3,2,1
GBR,BIH,2018.0,4,2,2
CIV,FRA,2005.0,16,19,-3
ARE,USA,2011.0,23,62,-39
AUS,KWT,2010.0,3,1,2
DEU,CRI,2023.0,3,4,-1
HRV,NLD,2022.0,5,6,-1
PER,AUS,2023.0,3,1,2
KOR,ITA,2023.0,3,7,-4
PSE,DEU,2019.0,5,7,-2
COL,NZL,2022.0,2,3,-1
NGA,KEN,2023.0,4,2,2
UZB,CHN,2012.0,1,2,-1
IND,NOR,2011.0,10,6,4
IRL,EGY,2014.0,2,2,0
ARE,AUS,2015.0,5,15,-10
MYS,IRL,2018.0,4,7,-3
TWN,THA,2012.0,7,2,5
AUS,ISL,2010.0,3,1,2
BRA,SGP,2012.0,2,1,1
VEN,PAN,2007.0,1,1,0
MEX,RUS,2020.0,7,7,0
SWE,HKG,2018.0,8,9,-1
ARE,CHN,2013.0,2,1,1
HUN,NLD,2022.0,14,10,4
ECU,ESP,2011.0,4,10,-6
IDN,CHE,2013.0,2,1,1
URY,ZAF,2013.0,1,2,-1
JOR,BHR,2009.0,1,2,-1
PRT,DZA,2021.0,4,2,2
FRA,QAT,2016.0,19,6,13
GBR,MUS,2021.0,2,3,-1
NLD,HUN,2016.0,10,12,-2
HUN,NLD,2018.0,17,9,8
SWE,EST,2020.0,7,3,4
LUX,HUN,2015.0,1,1,0
CHE,HRV,2008.0,2,6,-4
ARM,CAN,2012.0,3,2,1
DNK,BRA,2011.0,6,2,4
BHR,USA,2000.0,2,1,1
IRN,JPN,2010.0,23,24,-1
USA,BWA,2006.0,12,2,10
BFA,MLI,2021.0,1,7,-6
CHL,SWE,2004.0,3,1,2
COL,GBR,2002.0,11,19,-8
HUN,CHE,2007.0,12,8,4
DNK,IRN,2018.0,15,21,-6
CZE,IRL,2010.0,4,1,3
MYS,AUT,2010.0,3,2,1
KOR,PRT,2011.0,12,1,11
CRI,DEU,2013.0,5,2,3
PRI,COL,2018.0,1,1,0
HKG,SWE,2014.0,6,2,4
ESP,URY,2011.0,6,12,-6
HUN,BEL,2011.0,8,6,2
DNK,GRL,2015.0,5,5,0
ARG,ITA,2011.0,12,20,-8
SAU,HKG,2013.0,1,1,0
CHE,SVN,2012.0,2,3,-1
VNM,FRA,2013.0,12,24,-12
BGD,KOR,2009.0,15,5,10
ARG,URY,2014.0,7,7,0
JAM,GBR,2012.0,4,6,-2
AUS,ITA,2015.0,30,61,-31
ITA,EGY,2009.0,10,2,8
COD,COG,2006.0,10,6,4
PAK,NLD,2012.0,7,12,-5
ISR,NZL,1999.0,2,3,-1
BRA,ITA,2000.0,15,37,-22
DMA,DOM,2018.0,4,6,-2
CAN,TUR,2023.0,11,31,-20
DEU,UKR,2022.0,11,42,-31
AUT,PER,2009.0,1,1,0
MOZ,GBR,2014.0,2,4,-2
NOR,POL,2013.0,4,9,-5
JPN,TUR,2015.0,7,5,2
IRL,DNK,2009.0,5,3,2
BMU,GBR,2018.0,2,1,1
LAO,AUS,2017.0,2,2,0
CHN,ARM,2022.0,2,1,1
SVN,ESP,2014.0,4,4,0
POL,CHN,2014.0,3,2,1
IND,KEN,2019.0,3,1,2
PRT,MEX,2010.0,5,11,-6
FRA,CRI,2015.0,2,3,-1
ARG,CHE,2011.0,3,4,-1
ZAF,MUS,2009.0,1,1,0
GBR,OMN,2013.0,16,5,11
DNK,FIN,2006.0,12,11,1
AUS,MUS,2018.0,3,1,2
CIV,GBR,2020.0,1,1,0
AUT,HRV,2014.0,2,8,-6
TUR,FRA,2013.0,18,14,4
IRL,AUT,2012.0,9,5,4
NLD,THA,2022.0,7,6,1
BIH,USA,2020.0,6,2,4
TUR,CYP,2009.0,11,13,-2
FRA,IRL,2001.0,12,14,-2
SGP,IDN,2012.0,4,2,2
EST,DEU,2006.0,3,3,0
FRA,IDN,2016.0,15,5,10
NGA,BGD,2020.0,1,2,-1
IDN,AUS,2012.0,18,32,-14
ITA,GHA,2021.0,3,3,0
EST,FRA,2017.0,6,4,2
KOR,KAZ,2019.0,4,11,-7
JPN,GRC,2021.0,3,2,1
ARE,PAK,2017.0,3,12,-9
PAK,FRA,2007.0,1,1,0
BGD,DEU,2007.0,3,2,1
LKA,GBR,2014.0,8,19,-11
CHE,ETH,2018.0,1,8,-7
TWN,CHE,1998.0,1,1,0
HKG,FRA,2020.0,1,13,-12
CYP,GBR,2020.0,24,54,-30
USA,PSE,2015.0,7,11,-4
BLR,KOR,1998.0,1,2,-1
MEX,PRT,2016.0,1,8,-7
EST,JPN,2020.0,2,2,0
DNK,MEX,2018.0,2,2,0
GIN,GNQ,2016.0,3,6,-3
COL,ITA,2017.0,7,12,-5
DEU,COD,2023.0,1,1,0
ZAF,SEN,2020.0,4,3,1
SVN,NLD,2021.0,4,5,-1
SGP,CHN,2001.0,27,80,-53
UKR,ZAF,2019.0,1,1,0
RUS,CZE,2020.0,21,7,14
USA,MNG,2019.0,7,4,3
GIN,USA,2016.0,2,5,-3
BEL,CHN,2005.0,23,14,9
BEN,FRA,2015.0,16,18,-2
PRT,HKG,2020.0,1,1,0
DEU,SGP,1998.0,6,2,4
USA,COG,2011.0,5,4,1
EST,USA,2010.0,6,7,-1
CUB,ECU,2020.0,18,8,10
ESP,ZAF,2011.0,4,3,1
DEU,HKG,2005.0,8,8,0
HKG,DEU,2006.0,11,5,6
LBY,ITA,2012.0,1,1,0
RUS,ROU,1999.0,3,1,2
USA,SVK,2004.0,7,27,-20
ARG,CHE,2019.0,11,6,5
SAU,PSE,2015.0,1,1,0
LBY,IRQ,2003.0,2,2,0
AUS,IDN,2007.0,25,11,14
URY,ESP,2002.0,5,8,-3
CHE,TUR,2001.0,7,2,5
CHE,SRB,2009.0,2,3,-1
GHA,NLD,2023.0,2,4,-2
IRN,DNK,2017.0,16,4,12
DNK,ITA,1999.0,13,15,-2
TUR,SAU,2006.0,3,3,0
JPN,MYS,1999.0,3,5,-2
FRA,ISR,2009.0,20,23,-3
COL,FRA,2023.0,11,12,-1
SWE,GRC,2005.0,6,1,5
NPL,THA,2008.0,2,2,0
SRB,HRV,2005.0,4,13,-9
URY,AUS,2015.0,2,2,0
BLR,LTU,2021.0,2,2,0
JPN,CHL,2019.0,6,9,-3
IND,GRC,2005.0,1,1,0
CZE,POL,2001.0,6,5,1
IND,ZAF,2000.0,4,3,1
JAM,GBR,1997.0,4,4,0
TUR,SWE,2018.0,26,7,19
SRB,ITA,2021.0,7,9,-2
CAN,KNA,2021.0,1,1,0
PRK,KOR,2009.0,4,1,3
QAT,AUS,2011.0,3,5,-2
BOL,ESP,2021.0,2,3,-1
MYS,BEL,2023.0,2,2,0
EGY,KOR,2006.0,4,1,3
BEL,ECU,2022.0,4,5,-1
IND,ZMB,2022.0,2,1,1
HUN,KEN,2023.0,2,4,-2
DEU,CYP,2023.0,3,3,0
USA,CYP,2007.0,17,7,10
CHE,BGR,2010.0,5,2,3
TUR,UZB,2021.0,1,1,0
QAT,SAU,2022.0,7,13,-6
IND,KEN,2021.0,8,3,5
USA,SVN,2022.0,3,14,-11
ARE,TWN,2021.0,2,4,-2
FIN,IRN,2023.0,10,20,-10
SAU,PHL,2022.0,2,2,0
JPN,SAU,2023.0,9,6,3
IRQ,PAK,2022.0,4,1,3
ARM,RUS,2019.0,5,6,-1
BEL,CAN,2005.0,32,18,14
UGA,ETH,2004.0,1,1,0
HUN,CHE,1998.0,7,6,1
USA,NPL,2003.0,8,5,3
IRL,RUS,2002.0,1,2,-1
AUT,ISR,2009.0,6,5,1
JPN,ZAF,2001.0,2,1,1
DEU,ROU,2004.0,19,28,-9
DEU,KEN,2007.0,13,5,8
CHL,POL,2020.0,2,5,-3
JPN,BEL,2003.0,10,10,0
MYS,PHL,2012.0,1,2,-1
PER,BRA,2014.0,14,14,0
MYS,BEL,2010.0,2,1,1
JPN,NPL,2006.0,10,2,8
TUR,HUN,2004.0,1,1,0
SRB,JPN,2000.0,4,2,2
NOR,AUT,1998.0,6,2,4
RUS,UZB,2016.0,9,5,4
AUT,FIN,1998.0,6,1,5
RUS,AUS,1999.0,8,6,2
DNK,KOR,2010.0,4,5,-1
TWN,FRA,1997.0,5,2,3
USA,NAM,2021.0,6,8,-2
BEL,SWE,2001.0,10,14,-4
FRO,DNK,2008.0,3,2,1
BHR,GBR,2002.0,2,2,0
SVK,GBR,2013.0,9,14,-5
CHE,ISL,2020.0,1,1,0
UKR,TUR,2002.0,2,2,0
BGR,ITA,2008.0,5,3,2
BEL,BRA,1998.0,13,2,11
BRA,AUS,2004.0,17,5,12
NLD,SRB,1999.0,1,1,0
SWE,ARG,1998.0,3,2,1
THA,CHE,1999.0,4,2,2
ITA,PRT,2002.0,7,8,-1
CYP,GBR,1999.0,2,5,-3
ISR,ESP,1998.0,2,7,-5
BEL,AUS,1999.0,7,7,0
CHL,PER,2003.0,1,3,-2
EGY,QAT,2000.0,4,2,2
IRN,AUS,2000.0,1,13,-12
ARE,CAN,2008.0,1,24,-23
ECU,AUS,2016.0,2,6,-4
PRT,CAN,2009.0,5,6,-1
GRC,RUS,2000.0,2,6,-4
PAK,FRA,1999.0,1,2,-1
BLR,POL,2003.0,4,6,-2
ISR,AUT,2008.0,2,5,-3
FIN,OMN,2012.0,1,1,0
NGA,ITA,2017.0,5,4,1
DNK,ISL,2003.0,3,8,-5
NOR,IND,2003.0,2,4,-2
AUS,DNK,1997.0,8,5,3
SWE,ARE,2017.0,8,2,6
CAN,ARE,2000.0,3,7,-4
DEU,MEX,2003.0,20,20,0
COL,AUS,2001.0,2,2,0
BEL,BLR,2013.0,1,4,-3
FRA,LTU,2000.0,3,4,-1
SWE,URY,2013.0,3,1,2
GBR,MLT,1998.0,4,3,1
TUR,DEU,2003.0,27,18,9
CAN,RUS,2007.0,20,37,-17
GRC,ITA,2000.0,6,11,-5
CUB,VEN,1998.0,1,1,0
USA,LTU,2006.0,9,6,3
NLD,MWI,2022.0,2,2,0
FRA,BGR,1999.0,6,14,-8
ESP,HUN,2004.0,3,3,0
DNK,ITA,2020.0,41,55,-14
GBR,BLR,1998.0,4,4,0
IND,SVN,1998.0,1,1,0
GBR,PER,2005.0,2,1,1
PHL,CHE,1998.0,1,2,-1
IND,MEX,2009.0,7,8,-1
MYS,JPN,2000.0,10,10,0
UGA,USA,2001.0,10,10,0
TWN,POL,2010.0,4,3,1
MEX,JPN,2002.0,3,11,-8
ZAF,PRT,2021.0,5,4,1
COD,COG,2000.0,3,1,2
CHE,THA,1998.0,2,1,1
GAB,FRA,1999.0,3,7,-4
JOR,USA,2006.0,14,40,-26
NLD,ETH,2003.0,4,3,1
ISR,RUS,2016.0,10,5,5
NZL,AUT,1997.0,2,1,1
MEX,COL,2002.0,4,4,0
NOR,FIN,1999.0,4,7,-3
DNK,RUS,1997.0,7,7,0
DNK,RUS,2005.0,5,6,-1
LUX,BEL,2011.0,8,15,-7
NOR,CZE,2009.0,3,3,0
KWT,USA,1999.0,4,16,-12
MYS,AUS,1997.0,2,2,0
EGY,MYS,2004.0,3,1,2
GBR,PSE,2001.0,1,1,0
ARE,DEU,2014.0,4,8,-4
NLD,SVK,2005.0,1,7,-6
SVK,NLD,2008.0,6,4,2
ARE,SAU,1998.0,3,3,0
NOR,CZE,2019.0,6,2,4
SWE,IRQ,2014.0,2,1,1
GRL,DNK,2014.0,6,3,3
RUS,BEL,1997.0,6,7,-1
CHN,NLD,1999.0,11,10,1
USA,GHA,2000.0,2,4,-2
KEN,BEN,1999.0,1,1,0
CHE,MEX,2006.0,6,4,2
BIH,HRV,2011.0,7,14,-7
BIH,TUR,2010.0,1,2,-1
NLD,POL,2013.0,18,24,-6
TTO,GBR,2000.0,4,3,1
KOR,BRN,2017.0,1,1,0
NOR,SGP,2011.0,2,4,-2
PHL,FRA,2017.0,3,3,0
BWA,USA,2008.0,8,7,1
GBR,MUS,2019.0,4,1,3
PSE,GBR,2009.0,1,4,-3
DEU,BEN,2006.0,1,1,0
LTU,CAN,2021.0,1,2,-1
LBY,IND,2011.0,4,8,-4
LAO,THA,2010.0,1,2,-1
FRA,DJI,2012.0,5,1,4
JOR,CAN,2013.0,9,7,2
BGD,JPN,2007.0,28,41,-13
ZAF,BRA,2020.0,6,10,-4
JPN,BRA,2006.0,15,7,8
AUT,JPN,2007.0,13,8,5
SRB,RUS,2010.0,5,1,4
SAU,MYS,2012.0,6,35,-29
TWN,HKG,2001.0,9,9,0
SRB,HRV,2012.0,7,12,-5
AUT,GRC,2020.0,9,8,1
CHE,HRV,2014.0,4,9,-5
DEU,PSE,2020.0,5,4,1
NGA,COD,2023.0,1,1,0
BEL,COL,2017.0,5,7,-2
HRV,JPN,2013.0,2,1,1
CMR,USA,2023.0,7,5,2
KOR,PAK,2012.0,9,15,-6
KEN,NLD,2022.0,6,10,-4
BRA,IRL,2018.0,12,5,7
AUS,LAO,2016.0,3,1,2
VNM,THA,2016.0,7,10,-3
MYS,SGP,2012.0,23,14,9
TUR,IRN,2010.0,3,8,-5
KWT,SRB,2007.0,1,2,-1
PER,CHE,2012.0,2,1,1
PHL,AUS,2009.0,9,7,2
NLD,PHL,2019.0,3,2,1
KAZ,KGZ,2009.0,2,3,-1
NOR,SRB,2021.0,1,1,0
RWA,SWE,2012.0,1,1,0
USA,GAB,2014.0,5,2,3
NLD,CRI,2013.0,1,1,0
CRI,PER,2018.0,1,1,0
TUR,AUS,2011.0,8,4,4
IND,POL,2010.0,3,2,1
SAU,CHE,2013.0,1,2,-1
MEX,SAU,2016.0,4,1,3
BEL,CUB,2010.0,3,2,1
BGD,NLD,2015.0,4,4,0
IRL,ZAF,2011.0,4,2,2
THA,ETH,2016.0,2,1,1
BRB,TTO,2014.0,1,2,-1
ISR,KEN,2011.0,1,1,0
YEM,DEU,2015.0,3,1,2
CZE,SWE,2011.0,6,4,2
MYS,IRL,2016.0,5,9,-4
AUS,TZA,2015.0,1,3,-2
BFA,GBR,2020.0,2,1,1
GRC,ZAF,2022.0,3,3,0
BRA,CUB,2015.0,2,20,-18
ZAF,NZL,2010.0,10,9,1
GBR,GIB,2009.0,1,1,0
RUS,NGA,2018.0,3,1,2
FRA,GAB,2016.0,11,7,4
RUS,MNG,2017.0,2,1,1
NZL,BEL,2021.0,2,6,-4
URY,SWE,1999.0,2,3,-1
CHE,LUX,2016.0,6,4,2
SEN,ESP,2017.0,7,1,6
KEN,FRA,2016.0,9,9,0
NZL,FJI,2019.0,5,2,3
USA,DMA,2017.0,2,5,-3
BEL,MDG,2014.0,2,1,1
HUN,SWE,2016.0,12,5,7
JPN,MNG,2017.0,11,1,10
ARE,PRT,2020.0,1,4,-3
NLD,TZA,2019.0,3,9,-6
PSE,FRA,2019.0,4,6,-2
TUR,LTU,2017.0,2,1,1
SWE,HUN,2018.0,3,15,-12
HUN,TUR,2013.0,3,2,1
AUT,ARE,2015.0,2,1,1
CHE,PNG,2012.0,4,1,3
ETH,BEL,2019.0,9,6,3
MYS,BGD,1999.0,4,3,1
FRA,QAT,2017.0,13,3,10
PHL,KOR,2013.0,7,10,-3
NOR,PRT,2017.0,2,13,-11
PER,VEN,2019.0,1,4,-3
IRN,CHL,2022.0,3,1,2
CHE,TUR,2014.0,14,16,-2
CHL,CAN,2014.0,20,27,-7
MAR,MAC,2014.0,17,15,2
GNB,DNK,2018.0,2,1,1
TJK,RUS,2015.0,5,9,-4
MEX,EGY,2019.0,2,2,0
FRA,THA,2015.0,22,12,10
IRQ,CHN,2013.0,2,4,-2
TZA,BEL,2018.0,3,3,0
SYR,DEU,2015.0,7,4,3
EST,LVA,2021.0,3,5,-2
VEN,IND,2014.0,1,1,0
DEU,BFA,2015.0,4,1,3
BRA,PRY,2023.0,4,1,3
IDN,CAN,2014.0,3,3,0
CHN,QAT,2019.0,5,3,2
SVN,SWE,2016.0,6,3,3
KGZ,KAZ,2009.0,3,2,1
CAN,UKR,2023.0,3,4,-1
IND,MMR,2023.0,1,2,-1
PAK,AFG,2012.0,3,1,2
FLK,GBR,2022.0,7,1,6
NLD,QAT,2016.0,4,1,3
ESP,CRI,2008.0,5,1,4
EST,FIN,2017.0,11,17,-6
CHL,BEL,2011.0,5,9,-4
TUR,LUX,2023.0,1,1,0
CZE,AUT,2013.0,10,10,0
ITA,NGA,2014.0,4,5,-1
USA,MAC,2007.0,3,1,2
DZA,USA,2021.0,5,5,0
ESP,POL,2015.0,17,21,-4
TZA,CIV,2019.0,2,1,1
CYP,CHN,2021.0,2,2,0
TZA,DEU,2023.0,1,3,-2
ITA,JOR,2017.0,6,1,5
MAC,HKG,2016.0,7,15,-8
BRA,IND,2016.0,12,37,-25
TUR,OMN,2017.0,2,3,-1
OMN,TUR,2019.0,1,1,0
LTU,TUR,2020.0,2,1,1
SVK,NOR,2017.0,1,1,0
EGY,BGD,2018.0,2,2,0
MEX,IRL,2021.0,3,2,1
CIV,SEN,2018.0,2,5,-3
ITA,SRB,2021.0,9,7,2
CHL,MEX,2009.0,6,4,2
EGY,NLD,2018.0,2,5,-3
EGY,RUS,2017.0,8,2,6
NGA,KAZ,2022.0,2,1,1
LUX,AUT,2023.0,3,1,2
DNK,CZE,2016.0,4,6,-2
IRN,TWN,2015.0,2,2,0
DEU,GIN,2017.0,4,2,2
ITA,SDN,2019.0,2,1,1
ECU,BRA,2017.0,5,6,-1
NOR,SDN,2017.0,1,2,-1
SWE,TWN,2015.0,5,6,-1
GBR,BRB,2023.0,1,1,0
HKG,IRL,2014.0,3,3,0
PHL,GBR,2010.0,3,4,-1
IND,LBY,2014.0,3,3,0
CZE,BGR,2013.0,1,2,-1
AUS,GRC,2018.0,10,14,-4
NGA,BEL,2015.0,1,3,-2
FIN,BEL,2003.0,7,3,4
HKG,CHE,2016.0,9,7,2
TTO,USA,2015.0,14,11,3
POL,PRT,2018.0,4,5,-1
PAK,FIN,2023.0,7,1,6
BWA,AUS,2019.0,3,4,-1
MEX,CZE,2023.0,3,1,2
TWN,NZL,2014.0,2,2,0
GHA,ITA,2021.0,3,3,0
SGP,IRL,2022.0,7,4,3
LBN,AUS,2021.0,3,3,0
HKG,SWE,2015.0,3,3,0
SWE,HKG,2016.0,3,8,-5
CAN,HUN,2021.0,5,11,-6
VNM,SGP,2023.0,5,3,2
PER,BRA,2008.0,4,13,-9
NZL,KOR,2020.0,3,4,-1
PAK,BGD,2007.0,7,3,4
TGO,USA,2021.0,1,2,-1
BGD,THA,2022.0,7,5,2
IND,TUN,2019.0,1,1,0
LUX,BEL,2009.0,5,12,-7
JOR,JPN,2017.0,2,2,0
PRT,MYS,2020.0,1,1,0
RWA,CHN,2020.0,1,8,-7
DZA,POL,2021.0,2,2,0
SVK,ITA,2019.0,3,3,0
PER,CAN,2023.0,4,3,1
THA,NPL,2015.0,8,4,4
KOR,GBR,1998.0,12,18,-6
AFG,FRA,2020.0,3,3,0
NOR,NZL,1999.0,2,1,1
ISR,IND,2000.0,7,23,-16
JPN,DNK,2021.0,9,10,-1
SAU,ITA,2015.0,4,23,-19
MWI,ZWE,2016.0,1,2,-1
LBY,IRL,2020.0,1,2,-1
SRB,USA,2022.0,17,18,-1
CHE,LKA,2018.0,2,2,0
HKG,CHE,2018.0,11,7,4
ETH,MYS,2017.0,2,3,-1
NZL,ZAF,2021.0,5,15,-10
USA,BGD,2024.0,2,2,0
AUS,QAT,2022.0,13,9,4
NLD,TWN,2023.0,3,5,-2
USA,BFA,2022.0,4,5,-1
UZB,DEU,2011.0,2,2,0
KWT,AUS,2021.0,3,3,0
CIV,FRA,2020.0,11,29,-18
THA,DEU,2022.0,10,12,-2
CHN,VNM,2023.0,15,9,6
THA,AUS,2022.0,20,27,-7
JPN,MAR,2022.0,1,1,0
USA,ITA,2024.0,4,3,1
NOR,ROU,2021.0,2,1,1
ITA,THA,2022.0,3,5,-2
KGZ,KAZ,2021.0,9,4,5
BEL,CMR,2021.0,4,3,1
MEX,SAU,2022.0,3,3,0
EST,USA,2023.0,9,3,6
GUM,USA,1998.0,3,10,-7
PRT,RUS,1999.0,3,11,-8
USA,GTM,2008.0,3,8,-5
CHE,BRA,1997.0,9,6,3
DEU,TWN,2000.0,9,4,5
PRT,IRL,1998.0,1,1,0
PRI,IND,2011.0,2,2,0
ZAF,FRA,1997.0,3,7,-4
EGY,DNK,2002.0,5,2,3
LBN,EGY,2016.0,3,6,-3
ESP,ISR,1997.0,5,2,3
POL,CAN,2013.0,13,12,1
FRA,NZL,2000.0,9,3,6
KEN,ITA,2003.0,1,1,0
CAN,VEN,2000.0,2,3,-1
NOR,KOR,2010.0,3,4,-1
ISR,TWN,2005.0,1,1,0
COL,GBR,2005.0,5,13,-8
BRA,CHE,1999.0,3,5,-2
JOR,CAN,2003.0,7,4,3
BIH,USA,1999.0,3,2,1
CAN,BHR,1998.0,2,1,1
ARE,SAU,2007.0,3,9,-6
USA,BOL,2011.0,7,5,2
BOL,ESP,2011.0,2,3,-1
ZAF,PRT,2011.0,3,4,-1
USA,BWA,2023.0,6,6,0
CHE,IRL,1998.0,4,3,1
ZAF,NAM,1997.0,2,2,0
SGP,IND,1998.0,5,22,-17
SVN,GBR,2002.0,5,5,0
TWN,CAN,1998.0,7,11,-4
GAB,FRA,1998.0,2,7,-5
AFG,USA,2021.0,10,1,9
DEU,COL,2003.0,6,4,2
USA,BMU,2020.0,2,1,1
BMU,USA,2021.0,1,3,-2
JPN,BEL,2013.0,19,17,2
USA,VIR,2000.0,3,1,2
VIR,USA,2002.0,2,2,0
ISR,MEX,2008.0,1,2,-1
IND,THA,2016.0,13,11,2
BRA,CUB,2004.0,5,6,-1
PAK,POL,2020.0,5,1,4
MAC,KOR,2018.0,2,1,1
RUS,AZE,2018.0,6,5,1
MYS,DNK,2015.0,4,5,-1
KOR,ITA,2010.0,10,2,8
HUN,ESP,2018.0,6,7,-1
MEX,TWN,2018.0,2,1,1
IRL,GHA,2014.0,1,1,0
KOR,TUR,2017.0,3,6,-3
NLD,IRN,2007.0,8,13,-5
NZL,EST,2016.0,1,1,0
TWN,SWE,1999.0,1,1,0
GAB,USA,2012.0,1,2,-1
HRV,SRB,2011.0,9,12,-3
PRY,CHL,2017.0,1,3,-2
SAU,DZA,2023.0,5,5,0
NLD,CHL,2018.0,9,14,-5
GIN,GNQ,2017.0,4,2,2
CZE,VNM,2023.0,8,2,6
IRN,IND,2018.0,7,15,-8
KOR,AUS,2000.0,6,8,-2
CUB,BRA,2003.0,6,8,-2
GBR,BRN,2021.0,7,1,6
RUS,PRT,2013.0,3,2,1
ARE,SDN,2022.0,2,5,-3
CHN,MMR,2018.0,5,6,-1
YEM,CHN,2021.0,2,5,-3
SYR,IRQ,2022.0,1,1,0
PHL,MYS,2021.0,1,3,-2
EGY,FIN,2023.0,1,2,-1
GRC,CHN,2022.0,4,6,-2
LBN,EGY,2018.0,4,13,-9
NPL,PAK,2021.0,4,1,3
CHN,SWE,1997.0,12,12,0
GBR,HRV,2023.0,4,8,-4
IND,EGY,2022.0,3,7,-4
TUN,JPN,2021.0,3,2,1
USA,KNA,2011.0,2,1,1
NLD,PRT,1997.0,4,8,-4
FRA,BGR,2007.0,12,8,4
AUT,JPN,1999.0,8,2,6
MLI,BFA,2017.0,1,5,-4
GBR,EST,2001.0,3,5,-2
PER,FRA,1998.0,1,1,0
CAN,PER,2000.0,1,2,-1
DEU,LBN,2007.0,3,1,2
IND,ESP,1999.0,3,4,-1
AUT,SGP,2014.0,5,2,3
CAN,FIN,2003.0,17,20,-3
JPN,ISR,2008.0,5,2,3
FRA,ARG,2003.0,15,27,-12
PHL,AUS,2011.0,9,9,0
OMN,SAU,2014.0,4,4,0
AUT,BEL,2010.0,10,9,1
USA,SLE,2008.0,2,1,1
PRT,SRB,2004.0,4,4,0
NCL,SEN,2006.0,1,1,0
JOR,SAU,2004.0,4,5,-1
COG,USA,2003.0,1,3,-2
ZAF,BRA,1998.0,1,1,0
MDA,RUS,2010.0,2,2,0
ARM,RUS,2009.0,6,8,-2
DEU,PHL,2012.0,4,8,-4
ROU,BEL,2006.0,7,3,4
GRC,BEL,2004.0,5,11,-6
NLD,BGR,2019.0,2,3,-1
SRB,PRT,2001.0,2,1,1
CHE,FIN,2011.0,9,24,-15
PRT,RUS,2007.0,2,11,-9
IND,OMN,2002.0,4,4,0
PHL,MYS,2019.0,2,2,0
ARE,DZA,2009.0,1,1,0
MEX,NOR,2007.0,1,2,-1
GRC,ISR,1998.0,1,1,0
BEL,SRB,2008.0,2,1,1
MCO,DEU,2015.0,1,1,0
UKR,AUT,2004.0,2,6,-4
SVN,FRA,2005.0,4,5,-1
USA,ETH,2006.0,7,3,4
EGY,NZL,2003.0,1,1,0
CHE,SVN,2005.0,2,2,0
SVN,DEU,2007.0,4,10,-6
CHE,IND,2007.0,10,20,-10
USA,URY,1998.0,3,6,-3
KOR,RUS,2008.0,7,13,-6
POL,DNK,1997.0,4,7,-3
VNM,GBR,2007.0,6,10,-4
SGP,MYS,2008.0,11,8,3
MAR,ITA,1997.0,1,1,0
ESP,AUS,2023.0,11,33,-22
SWE,UKR,2018.0,6,9,-3
SGP,ROU,2004.0,1,1,0
IDN,BEL,2019.0,1,6,-5
ITA,AUT,1999.0,17,10,7
BGR,CZE,2013.0,2,1,1
CHE,HUN,2003.0,7,10,-3
KWT,BHR,2004.0,1,1,0
BEL,FIN,2006.0,3,3,0
MEX,RUS,1999.0,5,16,-11
DEU,OMN,2017.0,3,5,-2
SAU,CAN,1998.0,14,16,-2
VEN,GBR,1999.0,8,7,1
CHE,BRA,2002.0,10,8,2
ROU,SWE,2003.0,3,4,-1
MAR,ESP,1999.0,3,5,-2
LIE,DEU,2002.0,3,5,-2
NLD,BEN,2014.0,1,2,-1
KEN,JPN,2012.0,6,10,-4
CHL,MEX,2011.0,12,19,-7
HUN,SVK,2012.0,7,4,3
AUT,CHN,2015.0,17,23,-6
UKR,KAZ,2017.0,2,2,0
FIN,TUR,2014.0,1,4,-3
TUN,CAN,2018.0,7,9,-2
QAT,PSE,2019.0,2,1,1
MWI,GBR,2010.0,8,18,-10
POL,EST,2020.0,4,1,3
AUS,BHR,2016.0,1,2,-1
HKG,IRL,2008.0,4,1,3
ESP,EST,2010.0,3,3,0
BWA,AUS,2011.0,1,5,-4
MEX,AUS,2010.0,11,9,2
HKG,NLD,2014.0,4,9,-5
FIN,BGR,2013.0,1,2,-1
IRN,BRA,2014.0,9,1,8
IRN,ESP,2010.0,13,3,10
PRT,AUT,2011.0,1,7,-6
IRN,SGP,2016.0,7,9,-2
IRL,CYP,2018.0,2,2,0
MOZ,SWE,2016.0,1,6,-5
DOM,ESP,2017.0,3,9,-6
IDN,NZL,2020.0,3,16,-13
AUS,NPL,2012.0,4,6,-2
TWN,CAN,2007.0,12,18,-6
FIN,SGP,2013.0,3,3,0
CHN,ARE,2016.0,7,5,2
PER,BRA,2015.0,8,26,-18
MDV,ESP,2019.0,1,1,0
PHL,MYS,2011.0,1,1,0
IRL,NOR,2010.0,1,2,-1
ISL,IRN,2017.0,2,2,0
SRB,SVK,2011.0,2,2,0
MAC,USA,2022.0,7,6,1
HRV,NLD,2017.0,2,1,1
HUN,IRL,2016.0,4,2,2
PRT,FIN,2013.0,2,2,0
MAC,AUS,2014.0,1,1,0
KEN,AUS,2015.0,2,6,-4
BGD,THA,2016.0,1,3,-2
SWE,QAT,2019.0,2,3,-1
ESP,KAZ,2019.0,1,1,0
IND,SVN,2020.0,4,1,3
SVN,BIH,2021.0,2,3,-1
IDN,DEU,2012.0,4,32,-28
IND,HRV,2017.0,1,1,0
GRC,IND,2015.0,2,5,-3
ESP,CRI,2004.0,4,1,3
KEN,ITA,2013.0,3,5,-2
ITA,KEN,2014.0,3,3,0
HRV,CHN,2018.0,1,2,-1
MYS,HKG,2016.0,4,3,1
SVN,SLV,2013.0,5,5,0
DNK,UGA,2014.0,2,1,1
SYC,ZAF,2021.0,1,4,-3
AUS,BHR,2018.0,4,1,3
BOL,BEL,2018.0,2,5,-3
TUR,IRQ,2023.0,13,8,5
ITA,BLR,2017.0,1,1,0
COL,BEL,2013.0,8,3,5
PRT,COL,2018.0,4,3,1
COL,PRT,2020.0,5,6,-1
AUT,SVK,2016.0,11,19,-8
KEN,EGY,2020.0,1,1,0
DEU,BGD,2004.0,4,6,-2
POL,SGP,2018.0,2,6,-4
KOR,THA,2019.0,10,15,-5
SVN,AUT,2015.0,4,3,1
FIN,ARE,2022.0,2,1,1
CZE,THA,2014.0,4,1,3
BRA,NGA,2022.0,5,3,2
SDN,KEN,2016.0,1,1,0
LAO,AUS,2016.0,1,3,-2
EST,FIN,2018.0,8,7,1
OMN,JPN,2009.0,1,2,-1
GRC,SRB,1998.0,1,2,-1
CMR,CHN,2020.0,3,7,-4
BRA,VNM,2021.0,2,2,0
JOR,FRA,2014.0,1,5,-4
RUS,GRC,2018.0,3,1,2
FJI,GBR,2019.0,3,2,1
TGO,USA,2019.0,1,2,-1
NZL,IDN,2021.0,8,2,6
CZE,LTU,2019.0,1,3,-2
FIN,THA,2021.0,3,2,1
JPN,GHA,2018.0,4,6,-2
ESP,TUR,2013.0,10,8,2
BFA,GHA,2013.0,2,2,0
DEU,UGA,2013.0,3,2,1
NZL,NOR,2003.0,3,2,1
ESP,GIB,2016.0,2,1,1
NOR,SGP,2021.0,3,9,-6
GBR,JOR,2005.0,8,6,2
LUX,GBR,2019.0,6,23,-17
MUS,MDG,2021.0,1,2,-1
USA,ALB,2017.0,4,2,2
ITA,KAZ,2018.0,2,3,-1
CHL,CHE,2017.0,8,12,-4
QAT,DEU,2020.0,4,11,-7
BHR,CAN,2017.0,2,2,0
UKR,KAZ,2016.0,2,2,0
CHL,FIN,2022.0,4,3,1
BEL,ARG,2020.0,3,5,-2
POL,PAK,2021.0,3,9,-6
PAN,ESP,2020.0,3,11,-8
KWT,USA,2007.0,8,7,1
VNM,CZE,2023.0,2,8,-6
DOM,DEU,2012.0,1,1,0
AUS,PAK,2012.0,9,15,-6
DNK,HKG,2011.0,3,1,2
KOR,ISR,2008.0,2,1,1
CHE,BEL,2000.0,14,27,-13
IND,NZL,2023.0,5,5,0
OMN,JOR,2021.0,4,3,1
SVN,CHN,2021.0,6,2,4
DEU,GAB,2022.0,7,2,5
FRA,SVK,2006.0,5,5,0
KEN,JPN,2002.0,6,7,-1
URY,DEU,2009.0,2,1,1
BEL,MAR,2009.0,8,5,3
DEU,MWI,2008.0,4,1,3
JPN,NGA,2008.0,4,6,-2
NGA,BEN,2005.0,2,1,1
USA,PLW,2001.0,2,1,1
IDN,NLD,2001.0,7,9,-2
LAO,JPN,2002.0,2,1,1
SWE,LAO,2011.0,2,1,1
BEL,KEN,2003.0,3,6,-3
GBR,RWA,2013.0,1,1,0
RWA,GHA,2020.0,1,2,-1
AUT,ROU,2012.0,3,5,-2
PER,CAN,2006.0,1,2,-1
NOR,HUN,2000.0,1,3,-2
MDA,ITA,2008.0,1,1,0
ITA,NGA,2008.0,4,2,2
BEN,USA,2003.0,1,1,0
SAU,DZA,2010.0,6,4,2
ITA,ISL,2015.0,5,3,2
GBR,LKA,2002.0,8,11,-3
HRV,AUT,2011.0,6,3,3
NOR,TZA,2003.0,2,2,0
RUS,AUS,2007.0,7,7,0
CAN,ISL,2005.0,2,2,0
TZA,AUS,2009.0,2,2,0
ISR,BEL,2005.0,5,4,1
SAU,ZAF,2005.0,1,3,-2
BEL,TUR,2010.0,7,14,-7
ESP,CRI,2015.0,6,8,-2
JPN,TZA,1998.0,2,1,1
JPN,ARG,2013.0,3,1,2
MAR,SAU,2019.0,4,4,0
PRT,ROU,2013.0,1,4,-3
IND,KWT,2005.0,8,4,4
NER,MLI,2021.0,1,4,-3
DEU,GEO,2010.0,2,8,-6
FIN,POL,2001.0,2,7,-5
THA,PHL,2014.0,3,1,2
SVK,ISR,1999.0,1,1,0
NLD,PHL,2021.0,3,7,-4
DEU,THA,2004.0,9,8,1
IDN,FRA,2012.0,3,10,-7
PAK,ZAF,2019.0,4,1,3
DEU,TUN,2007.0,2,1,1
BFA,DEU,2006.0,2,1,1
MKD,GRC,2012.0,1,1,0
KEN,IND,2003.0,3,3,0
CHE,LIE,2014.0,4,2,2
NOR,BEL,1998.0,2,3,-1
BEL,EGY,2005.0,4,2,2
IDN,JPN,2005.0,5,47,-42
ZAF,ISR,2006.0,2,3,-1
FRA,COL,2003.0,4,6,-2
RUS,PRT,2003.0,10,5,5
DNK,HUN,2000.0,5,3,2
CIV,USA,1998.0,2,4,-2
AUS,SAU,2006.0,3,4,-1
THA,TWN,2008.0,3,1,2
BIH,NLD,2015.0,1,1,0
PHL,BRA,2018.0,3,1,2
ROU,ITA,2013.0,13,14,-1
NPL,JPN,2001.0,4,4,0
MYS,ARE,2007.0,2,2,0
AUT,BEL,2006.0,7,9,-2
NOR,LTU,2001.0,1,4,-3
HUN,EGY,2016.0,6,1,5
GBR,GMB,2014.0,12,4,8
ZAF,TZA,2014.0,10,8,2
GBR,SVK,2018.0,5,7,-2
UGA,KEN,2010.0,3,5,-2
SRB,KOR,2006.0,1,1,0
AFG,USA,2009.0,1,12,-11
USA,MNG,2009.0,4,1,3
VNM,USA,2013.0,9,43,-34
SRB,SVN,2003.0,2,3,-1
CAN,THA,2006.0,9,9,0
FIN,POL,2004.0,3,3,0
USA,LVA,2005.0,3,2,1
AUS,PYF,2017.0,1,1,0
NZL,ITA,1997.0,2,1,1
NLD,ARE,2007.0,2,1,1
AUS,FIN,2010.0,5,12,-7
KOR,BEL,2002.0,1,1,0
BRA,ISR,2009.0,3,4,-1
NLD,TUR,2005.0,8,8,0
NLD,CHN,2003.0,9,29,-20
USA,MDG,2010.0,5,2,3
TZA,JPN,2013.0,2,4,-2
CAN,UKR,2010.0,5,6,-1
ESP,EGY,2001.0,2,2,0
MDA,RUS,2023.0,1,2,-1
THA,SGP,2015.0,6,10,-4
CZE,POL,2004.0,5,2,3
TWN,PRT,2013.0,1,2,-1
URY,BRA,2013.0,6,8,-2
EST,NOR,2003.0,2,2,0
NZL,AUT,2005.0,1,3,-2
GBR,KGZ,2003.0,1,1,0
IND,CHN,2008.0,6,8,-2
MEX,VEN,2009.0,9,4,5
RUS,MEX,2007.0,4,6,-2
ECU,VEN,2012.0,1,3,-2
CAN,MLI,2008.0,1,2,-1
THA,SGP,2008.0,9,1,8
FIN,TUR,2008.0,3,3,0
OMN,DEU,2011.0,2,4,-2
ROU,FIN,2020.0,1,3,-2
DJI,FRA,2007.0,1,1,0
MEX,DNK,2008.0,2,1,1
FRA,CAF,2007.0,6,5,1
GBR,CUB,2011.0,2,4,-2
BEL,ZAF,2010.0,4,3,1
PAK,CAN,2007.0,8,11,-3
PRI,DEU,2009.0,1,1,0
GBR,HRV,2006.0,3,5,-2
ISR,MEX,2004.0,1,1,0
ESP,CHN,2008.0,10,8,2
SAU,PSE,2014.0,3,2,1
TWN,NPL,2011.0,1,1,0
LTU,GBR,2013.0,4,9,-5
NZL,HKG,2008.0,5,1,4
ARM,USA,2002.0,9,5,4
IDN,DNK,2015.0,1,3,-2
IRQ,FRA,2023.0,2,2,0
IRN,AUS,2006.0,5,16,-11
CZE,MEX,2008.0,2,4,-2
ROU,AUT,2007.0,2,3,-1
CZE,BEL,2011.0,9,7,2
UKR,MEX,2019.0,3,1,2
SRB,MKD,2017.0,9,9,0
CHE,SAU,2013.0,2,1,1
IND,IRN,2002.0,5,5,0
NOR,IRN,2021.0,4,36,-32
BEL,CUB,2006.0,3,3,0
POL,AUT,2017.0,7,9,-2
ISL,AUS,2018.0,2,3,-1
AUT,IRN,2012.0,6,7,-1
TUN,CAN,2016.0,3,19,-16
ESP,HRV,2010.0,2,3,-1
SVK,GBR,2003.0,11,12,-1
SWE,MOZ,2016.0,6,1,5
BWA,GBR,2008.0,2,4,-2
SVN,SVK,2015.0,8,13,-5
HUN,CAN,2019.0,9,9,0
CAN,ARE,2006.0,17,5,12
USA,KHM,2013.0,8,3,5
BEL,IRN,2009.0,7,10,-3
COL,ARM,2009.0,2,1,1
NPL,GBR,2007.0,5,3,2
NPL,KOR,2007.0,4,1,3
ARE,AUS,2008.0,3,15,-12
CZE,BEL,2009.0,5,5,0
SVK,NLD,2004.0,3,2,1
HKG,LKA,2009.0,1,2,-1
AUT,SVN,2014.0,5,13,-8
FIN,ISR,2011.0,2,2,0
THA,HKG,2003.0,1,2,-1
GBR,JAM,2013.0,4,2,2
GBR,FJI,2014.0,6,2,4
BEL,CMR,2011.0,2,2,0
CHE,TUR,2008.0,1,6,-5
DNK,ARG,2011.0,1,1,0
FIN,NOR,2007.0,5,8,-3
MEX,FRA,2006.0,20,39,-19
ROU,AUS,2017.0,2,1,1
VNM,NLD,2011.0,4,5,-1
PHL,CHN,2010.0,3,3,0
GNB,DNK,2017.0,3,2,1
BWA,AUS,2021.0,1,2,-1
AUS,FJI,2013.0,5,9,-4
OMN,EGY,2012.0,3,6,-3
BRA,CZE,2014.0,8,2,6
CHN,IRL,2007.0,6,5,1
TUR,KAZ,2018.0,5,11,-6
ITA,PAN,2023.0,2,1,1
CYP,BEL,2016.0,1,2,-1
FRA,COG,2016.0,7,13,-6
GBR,VNM,2009.0,8,16,-8
TTO,JAM,2013.0,8,6,2
LBN,ARE,2018.0,9,2,7
AUS,CHL,2009.0,5,5,0
NPL,CHE,2007.0,1,1,0
MYS,CAN,2012.0,14,6,8
PRT,CAN,2021.0,12,6,6
PNG,AUS,2008.0,2,6,-4
GBR,PHL,2010.0,4,3,1
SAU,QAT,2016.0,20,4,16
LKA,KOR,2012.0,1,1,0
NZL,ARE,2022.0,4,1,3
AUT,IND,2014.0,4,15,-11
LTU,FRA,2013.0,4,5,-1
LUX,ITA,2015.0,6,11,-5
NIC,SWE,2012.0,2,1,1
USA,SLE,2014.0,10,1,9
ITA,KOR,2018.0,6,11,-5
NOR,PHL,2021.0,1,1,0
AUT,DNK,2023.0,9,8,1
FIN,ISR,2019.0,4,1,3
ESP,EGY,2015.0,15,6,9
AZE,TUR,2016.0,4,8,-4
BRA,PER,2013.0,4,16,-12
COL,NZL,2018.0,4,3,1
AUS,MOZ,2017.0,1,2,-1
ZAF,NOR,2013.0,3,2,1
EGY,BEL,2021.0,5,2,3
HUN,IRQ,2020.0,1,4,-3
PAK,JPN,1997.0,5,3,2
ISR,HKG,2020.0,2,2,0
CHE,LUX,2018.0,8,3,5
ISR,MEX,2015.0,2,3,-1
MAR,SEN,2018.0,1,1,0
FRA,GIN,2022.0,2,1,1
ARE,NZL,2021.0,2,5,-3
COL,PER,2012.0,2,2,0
USA,BRB,2023.0,2,3,-1
PHL,IND,2001.0,4,5,-1
USA,PSE,2001.0,1,3,-2
SDN,MYS,2006.0,1,1,0
HUN,AUS,2016.0,7,2,5
IRL,BRA,2023.0,6,11,-5
DEU,MKD,2015.0,2,3,-1
IND,KWT,1997.0,4,2,2
KWT,USA,1998.0,12,6,6
ITA,ETH,2021.0,7,6,1
NIC,CRI,2016.0,1,2,-1
LVA,SWE,2017.0,5,4,1
KOR,TWN,2020.0,15,7,8
LVA,SWE,2016.0,2,2,0
SVN,ITA,2016.0,14,8,6
KAZ,ESP,2021.0,1,3,-2
PAK,BGD,2020.0,8,10,-2
RUS,MNG,2018.0,1,2,-1
AUT,KEN,2013.0,1,1,0
NZL,GHA,2018.0,5,1,4
CHE,NPL,2014.0,1,1,0
SDN,GBR,2015.0,1,5,-4
NGA,TUR,2016.0,2,3,-1
KAZ,SGP,2020.0,3,1,2
TUR,ESP,2010.0,6,7,-1
VEN,PRI,2016.0,2,1,1
SAU,JPN,2013.0,3,17,-14
SAU,CHL,2020.0,1,1,0
UKR,CHN,2015.0,2,2,0
IND,HRV,2022.0,7,2,5
NLD,EGY,2021.0,3,10,-7
USA,GMB,2017.0,1,4,-3
IRL,VNM,2022.0,1,4,-3
KNA,USA,2016.0,5,11,-6
USA,KNA,2019.0,6,1,5
AUS,SVN,2019.0,2,4,-2
MYS,CHE,2013.0,1,2,-1
CHL,CUB,2016.0,5,7,-2
USA,SVN,2018.0,17,14,3
SRB,MKD,2016.0,5,7,-2
MAR,HUN,2020.0,2,1,1
ISR,FIN,2019.0,1,4,-3
HUN,BEL,2019.0,4,7,-3
KOR,ISR,2015.0,5,7,-2
PRT,SAU,2022.0,2,1,1
HRV,MKD,2020.0,2,1,1
PRT,BLR,2023.0,1,1,0
ECU,JPN,2018.0,1,2,-1
MUS,FRA,2017.0,1,2,-1
POL,CHL,2018.0,2,3,-1
JAM,USA,2023.0,5,12,-7
GBR,BFA,2013.0,2,1,1
BFA,SEN,2015.0,2,3,-1
HRV,FRA,2010.0,4,7,-3
KOR,FIN,2023.0,5,1,4
IDN,SWE,2021.0,2,4,-2
NPL,IND,2023.0,11,18,-7
AUS,KEN,2022.0,4,2,2
ESP,TUN,2023.0,5,5,0
CMR,CAN,2022.0,4,4,0
POL,ETH,2022.0,2,2,0
UGA,GHA,2022.0,3,1,2
DEU,CUB,2022.0,2,7,-5
UGA,TZA,2020.0,3,8,-5
TWN,NGA,2022.0,3,1,2
ITA,TUR,2003.0,4,11,-7
CHE,CMR,2005.0,3,1,2
ZAF,POL,2011.0,2,2,0
AUT,THA,2006.0,4,1,3
PER,ESP,1998.0,4,1,3
ESP,AUT,2009.0,14,29,-15
FRA,MLI,2000.0,4,3,1
COL,NLD,2005.0,2,1,1
DNK,CHN,1998.0,8,2,6
LTU,LVA,2006.0,4,1,3
KEN,UGA,2006.0,2,4,-2
GBR,VEN,2013.0,3,3,0
TUR,CAN,2008.0,11,11,0
BEL,SRB,2001.0,1,8,-7
MTQ,BEL,2011.0,1,1,0
IND,RUS,2004.0,2,3,-1
KOR,MEX,1998.0,2,1,1
NOR,JPN,2006.0,2,6,-4
CHL,DEU,2005.0,15,21,-6
PSE,EGY,2003.0,1,4,-3
IRN,SWE,2006.0,8,7,1
ZAF,NLD,1999.0,5,9,-4
TZA,KEN,2008.0,2,3,-1
GBR,IDN,2002.0,5,9,-4
HUN,HRV,2001.0,7,1,6
COL,BRA,2004.0,8,6,2
CMR,CHE,2004.0,2,3,-1
USA,GTM,2001.0,2,2,0
BLR,USA,2018.0,5,4,1
TUR,NZL,2005.0,2,1,1
DEU,UZB,2013.0,2,6,-4
PER,BRA,2004.0,3,9,-6
UKR,JPN,2006.0,4,3,1
GBR,CYP,2005.0,11,1,10
POL,SGP,2017.0,3,2,1
USA,DZA,2011.0,2,4,-2
GAB,FRA,2007.0,7,8,-1
PHL,NLD,2005.0,1,1,0
USA,CMR,2010.0,5,10,-5
CYP,GRC,2003.0,4,6,-2
OMN,AUS,2019.0,4,10,-6
LTU,RUS,2001.0,1,2,-1
GBR,LVA,2004.0,2,4,-2
SVK,UKR,2024.0,1,2,-1
SWE,HUN,2017.0,9,8,1
COG,BFA,2022.0,2,2,0
MEX,AUT,2013.0,9,1,8
FRA,ISL,2018.0,4,1,3
RWA,BEL,2012.0,2,4,-2
ETH,BGD,2012.0,1,1,0
ZAF,BWA,2009.0,7,15,-8
USA,MAR,2015.0,5,6,-1
KEN,ZWE,2010.0,1,1,0
KEN,IND,2013.0,3,1,2
SWE,SRB,2006.0,6,7,-1
KOR,SWE,2000.0,1,5,-4
PRT,KOR,2016.0,3,4,-1
PRT,AUS,1997.0,1,2,-1
DNK,CHN,1999.0,4,10,-6
FIN,NOR,1999.0,7,4,3
SWE,COL,2010.0,2,1,1
FRA,TGO,2001.0,5,2,3
SGP,HKG,2003.0,21,18,3
ARE,AUS,2004.0,2,4,-2
CHN,AUT,2004.0,3,1,2
SYR,JOR,2014.0,7,2,5
NZL,FRA,2003.0,7,5,2
CHE,TWN,2005.0,2,3,-1
ZWE,USA,1997.0,2,4,-2
BRB,GBR,2007.0,1,4,-3
IRL,CHN,2001.0,2,2,0
TWN,CHE,2007.0,3,6,-3
ROU,JPN,2021.0,2,2,0
ZWE,USA,2005.0,10,6,4
PHL,CHN,2000.0,4,2,2
SWE,ISR,2006.0,2,3,-1
DNK,CHN,2007.0,13,8,5
CHN,ITA,1997.0,9,20,-11
BWA,CAN,2001.0,1,1,0
CAN,IDN,2000.0,2,2,0
IDN,JPN,1997.0,4,14,-10
TWN,MNG,2010.0,1,2,-1
MEX,POL,2009.0,3,3,0
JPN,POL,2010.0,13,7,6
ZAF,HKG,2013.0,1,2,-1
GBR,ZMB,1997.0,2,2,0
GBR,PNG,2003.0,2,1,1
PRY,BRA,2009.0,3,3,0
USA,LTU,2000.0,2,6,-4
NLD,PHL,2009.0,1,1,0
CHL,ARG,2008.0,13,13,0
GBR,LTU,2005.0,5,4,1
IDN,PER,2022.0,1,2,-1
GBR,IDN,1997.0,4,3,1
BGD,IND,2004.0,7,7,0
LUX,GBR,2011.0,4,10,-6
BRA,NGA,2017.0,2,4,-2
ESP,NIC,2014.0,1,4,-3
HRV,ITA,2013.0,5,4,1
ISR,ARG,2004.0,1,5,-4
LUX,ESP,2014.0,4,7,-3
POL,SVN,2015.0,3,2,1
RUS,BGR,2017.0,5,4,1
BGD,GBR,2014.0,12,17,-5
UKR,SVK,2013.0,1,1,0
PAN,DEU,2008.0,1,1,0
ESP,PHL,2008.0,4,6,-2
ITA,EST,2012.0,7,1,6
SVN,NLD,2011.0,2,6,-4
TUN,DEU,2008.0,1,2,-1
CHL,IND,2013.0,2,1,1
RUS,IRN,1999.0,1,1,0
CHE,HKG,2012.0,2,5,-3
USA,DZA,2009.0,7,7,0
NZL,CHL,2006.0,2,3,-1
IRL,IND,2009.0,7,16,-9
TUR,UKR,2010.0,2,1,1
KEN,SVK,2019.0,4,2,2
SWE,ROU,2008.0,5,1,4
JAM,USA,2000.0,10,5,5
DNK,AUS,1998.0,8,14,-6
AUT,ARE,2014.0,2,2,0
ESP,HUN,2014.0,4,5,-1
MKD,BEL,2014.0,1,2,-1
SWE,ETH,2013.0,4,2,2
FRA,LTU,2023.0,5,3,2
DNK,GRL,2008.0,8,6,2
ZAF,SWE,2006.0,5,2,3
OMN,POL,2022.0,1,0,1
ECU,COL,2014.0,4,0,4
,MOZ,2010.0,29,0,29
MOZ,BEL,2013.0,2,0,2
GHA,COG,2020.0,2,0,2
,SLV,2010.0,21,0,21
,BWA,2009.0,58,0,58
BHR,,2002.0,10,0,10
SYC,,2022.0,14,0,14
PNG,,2001.0,13,0,13
CIV,GHA,2016.0,6,0,6
HRV,SWE,2015.0,6,0,6
MLT,KWT,2018.0,1,0,1
UGA,SLE,2018.0,1,0,1
JPN,PRT,2019.0,2,0,2
IND,ISL,2019.0,2,0,2
THA,CHL,2015.0,1,0,1
GEO,FRA,2014.0,6,0,6
ZAF,CIV,2006.0,2,0,2
BRB,NLD,2018.0,1,0,1
,IRQ,2006.0,142,0,142
TWN,KEN,2016.0,2,0,2
BGR,JOR,2008.0,1,0,1
NPL,FJI,2023.0,1,0,1
REU,IND,2018.0,1,0,1
BLR,GBR,2020.0,2,0,2
TZA,ETH,2020.0,4,0,4
HUN,CHL,2017.0,1,0,1
VGB,USA,2015.0,1,0,1
IND,MAC,2017.0,4,0,4
PAK,SWE,2024.0,1,0,1
CIV,,2008.0,31,0,31
,COG,2009.0,66,0,66
NZL,NGA,2017.0,1,0,1
FRA,COM,2019.0,2,0,2
,BHS,2011.0,15,0,15
MWI,IND,2019.0,1,0,1
ZMB,,2002.0,8,0,8
,PYF,2007.0,12,0,12
LBY,TUN,2017.0,1,0,1
,MLT,2001.0,25,0,25
,AND,2003.0,4,0,4
CZE,ARG,2023.0,4,0,4
,MCO,2018.0,10,0,10
,SLB,2018.0,14,0,14
MYS,MLI,2010.0,4,0,4
IND,JOR,2007.0,7,0,7
TUR,LTU,2023.0,1,0,1
JOR,NGA,2019.0,1,0,1
AUT,BGD,2021.0,1,0,1
THA,MLT,2021.0,1,0,1
SSD,,2023.0,12,0,12
UKR,IRQ,2021.0,1,0,1
RWA,COD,2021.0,3,0,3
CZE,VNM,2016.0,1,0,1
IDN,YEM,2021.0,1,0,1
,SYR,2020.0,136,0,136
SYR,BRA,2023.0,1,0,1
JPN,CMR,2011.0,6,0,6
BEL,CIV,2021.0,3,0,3
CHN,BEN,2022.0,5,0,5
MNG,,2011.0,14,0,14
UGA,AUS,2016.0,2,0,2
HND,ESP,2014.0,2,0,2
BGR,COG,2016.0,2,0,2
,NCL,2004.0,21,0,21
LVA,GBR,2011.0,2,0,2
EGY,BRA,2008.0,3,0,3
DNK,DZA,2018.0,1,0,1
IND,GRC,2008.0,3,0,3
DNK,MWI,2015.0,1,0,1
IND,TLS,2006.0,1,0,1
CUB,RUS,2015.0,2,0,2
MEX,GRC,2013.0,2,0,2
POL,ZAF,2010.0,1,0,1
FJI,,2014.0,10,0,10
AUT,NPL,2012.0,2,0,2
PHL,PAK,2019.0,2,0,2
SEN,RWA,2010.0,1,0,1
,MSR,2003.0,1,0,1
SVK,KHM,2016.0,5,0,5
KHM,KEN,2019.0,1,0,1
,TTO,2006.0,55,0,55
,GUF,2004.0,8,0,8
GUF,,2009.0,6,0,6
NER,BEL,2010.0,3,0,3
DEU,BTN,2011.0,1,0,1
NOR,LVA,2004.0,1,0,1
USA,BRN,2008.0,2,0,2
AUS,GTM,2014.0,1,0,1
CAN,LVA,2022.0,1,0,1
TUR,OMN,2023.0,5,0,5
,MDV,2005.0,2,0,2
,GUF,2001.0,7,0,7
,MNG,1994.0,36,0,36
,TKM,2007.0,3,0,3
GBR,PSE,2005.0,3,0,3
TUR,MYS,2007.0,2,0,2
CHL,PRT,2009.0,1,0,1
DZA,JAM,2015.0,1,0,1
JAM,DZA,2018.0,1,0,1
KOR,ARM,2014.0,1,0,1
,SYR,1999.0,21,0,21
JOR,ESP,2008.0,1,0,1
CHL,ISR,2007.0,1,0,1
MLI,BEL,2003.0,1,0,1
NGA,NOR,2014.0,1,0,1
CAN,ALB,2013.0,1,0,1
PNG,,2014.0,21,0,21
MAC,POL,2020.0,1,0,1
DZA,CHE,2008.0,1,0,1
LKA,BRA,2011.0,1,0,1
TCA,NOR,2019.0,1,0,1
MDA,,2003.0,30,0,30
WLF,USA,2010.0,1,0,1
TZA,CHE,2007.0,3,0,3
PSE,,2014.0,37,0,37
ARG,ALB,2017.0,2,0,2
SEN,TCD,2013.0,1,0,1
FRA,TCD,2017.0,5,0,5
LBY,USA,2009.0,1,0,1
CUB,QAT,2014.0,2,0,2
PRT,MMR,2020.0,1,0,1
MEX,THA,2020.0,2,0,2
,MMR,2012.0,36,0,36
IND,UGA,2009.0,1,0,1
TTO,CAN,2022.0,1,0,1
BIH,KAZ,2020.0,1,0,1
CHN,BGR,2021.0,4,0,4
MAR,CIV,2020.0,2,0,2
GRC,ARM,2020.0,1,0,1
,REU,2014.0,9,0,9
ARE,LUX,2023.0,2,0,2
AUS,ZMB,2017.0,4,0,4
SRB,KAZ,2017.0,2,0,2
LTU,,2003.0,52,0,52
NLD,CRI,2007.0,3,0,3
PRT,GRC,2004.0,1,0,1
YEM,,1999.0,2,0,2
RUS,MNG,2000.0,2,0,2
FIN,SRB,2004.0,2,0,2
LIE,,2008.0,7,0,7
FJI,,2008.0,7,0,7
FRA,ZWE,2010.0,4,0,4
KEN,SWE,2003.0,4,0,4
MUS,,2015.0,21,0,21
IND,IRN,2001.0,7,0,7
TZA,,2005.0,36,0,36
CIV,,2004.0,29,0,29
KWT,BRA,2001.0,1,0,1
ITA,EST,2001.0,1,0,1
BRA,TWN,2004.0,1,0,1
MEX,ROU,2003.0,1,0,1
LUX,THA,2003.0,1,0,1
VNM,,2000.0,16,0,16
HUN,BRA,2000.0,3,0,3
BEN,,1999.0,4,0,4
BEL,TZA,2006.0,2,0,2
NLD,NER,2002.0,1,0,1
KOR,JOR,2013.0,2,0,2
ZAF,MEX,2003.0,3,0,3
GEO,,2005.0,34,0,34
CUW,,2024.0,20,0,20
TTO,,2018.0,36,0,36
ISL,AUS,2000.0,1,0,1
NOR,IRL,2003.0,2,0,2
FRA,AND,2015.0,1,0,1
,SLV,2000.0,9,0,9
IRL,ARG,2015.0,1,0,1
IND,SYR,2004.0,1,0,1
,TKM,1998.0,3,0,3
MUS,GBR,1999.0,1,0,1
CIV,DNK,2000.0,1,0,1
ETH,NOR,2001.0,5,0,5
NER,BEL,2000.0,2,0,2
,BTN,1995.0,1,0,1
ROU,SRB,2010.0,1,0,1
KOR,LUX,2022.0,3,0,3
TTO,ZAF,2003.0,1,0,1
TWN,DZA,2007.0,1,0,1
LAO,,2006.0,3,0,3
NOR,COG,2004.0,1,0,1
MNE,JPN,2002.0,1,0,1
DEU,COD,2018.0,3,0,3
KEN,ERI,2001.0,1,0,1
JPN,TZA,2003.0,5,0,5
USA,PSE,1997.0,2,0,2
CZE,SDN,2010.0,1,0,1
ROU,SVN,2006.0,2,0,2
SVN,PRT,2008.0,1,0,1
CAF,,2006.0,7,0,7
SEN,COG,2006.0,1,0,1
BIH,SVN,2014.0,3,0,3
FLK,AUS,2017.0,1,0,1
DEU,KWT,2017.0,4,0,4
AZE,PRT,2010.0,1,0,1
ZMB,FIN,2021.0,1,0,1
ZWE,SWZ,2009.0,1,0,1
SEN,NER,2011.0,1,0,1
NZL,EST,2010.0,1,0,1
,GRD,2006.0,16,0,16
FRA,ARM,2012.0,5,0,5
AUS,CIV,2019.0,1,0,1
ZMB,,2012.0,14,0,14
,GAB,2000.0,12,0,12
,ZWE,2006.0,75,0,75
HUN,EGY,2006.0,7,0,7
NIC,,2012.0,10,0,10
CYP,DEU,2010.0,2,0,2
FIN,ROU,2001.0,2,0,2
HND,,2015.0,9,0,9
,TJK,2006.0,11,0,11
FRA,GEO,2004.0,2,0,2
GBR,KGZ,2020.0,2,0,2
DZA,LBY,2018.0,1,0,1
PSE,,2015.0,43,0,43
CHN,BDI,2015.0,1,0,1
BDI,,2017.0,6,0,6
RUS,ARM,2023.0,7,0,7
CHE,SYC,2011.0,1,0,1
DEU,MWI,2012.0,1,0,1
MAR,MLI,2018.0,3,0,3
SRB,EST,2021.0,1,0,1
NZL,BGD,2008.0,2,0,2
,SUR,2006.0,4,0,4
CZE,MNG,2015.0,1,0,1
SWE,LUX,2013.0,2,0,2
MDG,,2013.0,32,0,32
BRA,MWI,2023.0,1,0,1
GRC,AZE,2010.0,1,0,1
,GAB,2010.0,29,0,29
NGA,BRN,2016.0,1,0,1
RWA,SWE,2014.0,2,0,2
NAM,,2014.0,12,0,12
,LSO,2010.0,15,0,15
NGA,COG,2014.0,4,0,4
CYP,FRA,2023.0,2,0,2
,PSE,2007.0,49,0,49
CHN,LVA,2021.0,1,0,1
,MAC,1997.0,6,0,6
POL,MAC,2005.0,1,0,1
SWE,MLT,2015.0,2,0,2
,GUM,2006.0,5,0,5
,FJI,2010.0,32,0,32
TUN,GIN,2008.0,1,0,1
IND,ALB,2012.0,2,0,2
LVA,AUT,2019.0,1,0,1
PNG,,2004.0,14,0,14
BEL,ARE,2013.0,1,0,1
,LAO,2010.0,49,0,49
SDN,AUS,2017.0,1,0,1
CHN,SLE,2013.0,1,0,1
HRV,MKD,2013.0,4,0,4
GBR,MDV,2017.0,1,0,1
MYS,PNG,2019.0,1,0,1
PNG,CAN,2020.0,1,0,1
DZA,CHN,2013.0,1,0,1
LKA,DEU,2016.0,2,0,2
,TTO,2010.0,47,0,47
IND,SVK,2015.0,2,0,2
POL,LBY,2013.0,2,0,2
JPN,MMR,2013.0,6,0,6
DEU,PER,2016.0,9,0,9
COG,BDI,2016.0,1,0,1
BDI,GIN,2019.0,1,0,1
FJI,PAK,2017.0,1,0,1
BEN,ZAF,2016.0,1,0,1
BGD,CHL,2015.0,1,0,1
,NER,2012.0,41,0,41
PLW,,2020.0,8,0,8
,VUT,2012.0,6,0,6
GBR,VUT,2018.0,1,0,1
NOR,SVN,2016.0,1,0,1
HKG,MYS,2007.0,1,0,1
TWN,POL,2016.0,3,0,3
CIV,BFA,2018.0,4,0,4
AND,,2024.0,17,0,17
HUN,FIN,2019.0,4,0,4
MAR,NGA,2015.0,1,0,1
,AND,2013.0,4,0,4
IRQ,SWE,2013.0,4,0,4
BGD,CYP,2017.0,1,0,1
BOL,BRA,2015.0,2,0,2
LBN,CHN,2017.0,2,0,2
NLD,PER,2015.0,3,0,3
AUT,IRQ,2015.0,1,0,1
MAR,YEM,2023.0,3,0,3
MAR,GRC,2005.0,2,0,2
ISL,ITA,2023.0,1,0,1
,BRB,2000.0,15,0,15
CUB,CHN,2018.0,4,0,4
SVK,KHM,2017.0,1,0,1
HUN,NGA,2021.0,4,0,4
MKD,GRC,2008.0,5,0,5
LVA,NOR,2018.0,1,0,1
MTQ,,2020.0,10,0,10
,JAM,2011.0,44,0,44
BEN,KEN,2000.0,2,0,2
SRB,DZA,2021.0,2,0,2
BGR,PRT,2004.0,4,0,4
KOR,IRQ,2021.0,2,0,2
TCD,DEU,2020.0,1,0,1
FRA,AFG,2023.0,1,0,1
IRQ,NGA,2015.0,1,0,1
IDN,NAM,2011.0,1,0,1
NAM,GBR,2014.0,2,0,2
PAK,SLE,2005.0,1,0,1
MWI,SDN,2004.0,1,0,1
EGY,BGR,2015.0,1,0,1
AUS,FJI,1999.0,3,0,3
FJI,,2001.0,2,0,2
,COG,2019.0,67,0,67
BGR,CYP,2021.0,1,0,1
,MAC,2005.0,30,0,30
USA,EGY,2024.0,1,0,1
BRA,PHL,2021.0,2,0,2
NGA,OMN,2022.0,1,0,1
,FRO,2019.0,8,0,8
ALB,KGZ,2022.0,1,0,1
BHR,OMN,2021.0,1,0,1
AUT,GAB,2021.0,1,0,1
KEN,TON,2018.0,1,0,1
MAC,NPL,2021.0,1,0,1
MYS,CAF,2021.0,1,0,1
FRA,GNQ,2019.0,1,0,1
,GNQ,2018.0,4,0,4
PSE,GRC,2006.0,2,0,2
GTM,ESP,2014.0,2,0,2
CZE,ECU,2013.0,1,0,1
SYR,SLE,2022.0,2,0,2
ZWE,VUT,2016.0,1,0,1
GBR,TON,2019.0,1,0,1
,SOM,2013.0,12,0,12
DEU,UZB,2020.0,3,0,3
SYC,,2016.0,4,0,4
GBR,CRI,2019.0,2,0,2
SMR,,2020.0,4,0,4
PSE,IRL,2015.0,1,0,1
TUR,FIN,2017.0,4,0,4
JOR,DNK,2013.0,1,0,1
MNE,IND,2021.0,1,0,1
CHL,IDN,2018.0,1,0,1
CZE,MLT,2019.0,1,0,1
TJK,,2017.0,21,0,21
CUB,CAN,2019.0,8,0,8
MDG,CMR,1998.0,1,0,1
GBR,MMR,2013.0,2,0,2
MRT,,2017.0,9,0,9
AUS,GEO,2016.0,2,0,2
MRT,,2018.0,5,0,5
BEL,JOR,2018.0,2,0,2
JOR,OMN,2014.0,4,0,4
BEL,COM,2023.0,1,0,1
MAR,TGO,2020.0,1,0,1
ZWE,UGA,2013.0,2,0,2
,BHS,2009.0,8,0,8
LBY,CAN,2018.0,5,0,5
ZMB,GHA,2022.0,3,0,3
COL,HUN,2021.0,1,0,1
,TGO,2016.0,46,0,46
MWI,CAN,2012.0,1,0,1
BEN,DNK,2020.0,1,0,1
DNK,BEN,2023.0,1,0,1
SVK,VNM,2014.0,2,0,2
,GRL,2019.0,7,0,7
IRN,ISL,2022.0,1,0,1
IRL,ROU,2022.0,3,0,3
TWN,PER,2022.0,1,0,1
JPN,RWA,2021.0,1,0,1
,TLS,2015.0,6,0,6
MKD,DNK,2022.0,1,0,1
,GUY,2016.0,6,0,6
LBN,,2004.0,48,0,48
,GNQ,2017.0,8,0,8
KOR,BGD,2024.0,2,0,2
ZWE,AUS,2022.0,1,0,1
,YEM,2019.0,71,0,71
YEM,TUR,2021.0,3,0,3
COG,SWE,2007.0,1,0,1
CAN,VCT,2021.0,1,0,1
NLD,CYP,2022.0,4,0,4
RWA,JPN,2023.0,1,0,1
ISR,MEX,2005.0,3,0,3
LKA,IRN,2021.0,1,0,1
BLZ,JAM,2023.0,1,0,1
SYR,OMN,2015.0,1,0,1
DEU,KWT,2022.0,2,0,2
,DOM,1999.0,8,0,8
EGY,SDN,2001.0,1,0,1
AZE,QAT,2021.0,1,0,1
ZWE,MEX,2004.0,1,0,1
,SYC,1998.0,4,0,4
AFG,CZE,2001.0,1,0,1
PNG,,2008.0,12,0,12
,PRY,1995.0,12,0,12
AUS,RWA,2023.0,1,0,1
MDG,,2003.0,10,0,10
HUN,PRT,2010.0,4,0,4
BFA,CAN,2001.0,1,0,1
EST,,1999.0,8,0,8
BRN,NGA,2013.0,1,0,1
JPN,MKD,2015.0,1,0,1
BGR,QAT,2018.0,1,0,1
SWE,KHM,2013.0,1,0,1
ALB,CAN,2002.0,2,0,2
UGA,,2003.0,19,0,19
ITA,SYR,2004.0,2,0,2
DZA,,2003.0,27,0,27
CAN,BEN,2003.0,5,0,5
IRQ,,2002.0,5,0,5
PRT,SEN,2005.0,1,0,1
ZAF,MAR,2002.0,2,0,2
,MKD,2001.0,47,0,47
GRL,,2023.0,18,0,18
ISR,SVN,2002.0,3,0,3
SYR,ESP,2015.0,1,0,1
MNE,MKD,2002.0,1,0,1
GUF,,2011.0,5,0,5
GBR,MLT,2003.0,5,0,5
,VUT,1997.0,1,0,1
NAM,,2015.0,25,0,25
UKR,CHN,2002.0,3,0,3
,MTQ,2006.0,7,0,7
ECU,,2004.0,20,0,20
GRC,CRI,2023.0,1,0,1
ZAF,DNK,2009.0,7,0,7
ARE,HUN,2007.0,5,0,5
HUN,ARE,2009.0,2,0,2
JOR,TUR,2009.0,1,0,1
,LSO,2000.0,7,0,7
ESP,ARM,2007.0,1,0,1
PHL,KEN,2009.0,1,0,1
LVA,ITA,1998.0,3,0,3
FIN,ZAF,2002.0,1,0,1
MLI,GHA,2003.0,1,0,1
SVN,ESP,2002.0,1,0,1
ITA,LVA,2021.0,8,0,8
ISR,NGA,2005.0,1,0,1
BEL,TTO,2005.0,1,0,1
YEM,AUS,2004.0,1,0,1
CAN,UGA,2003.0,1,0,1
,AFG,1998.0,1,0,1
TUR,BRA,2005.0,2,0,2
NGA,TZA,1999.0,1,0,1
FRA,PRY,2003.0,1,0,1
IDN,VUT,2007.0,1,0,1
KEN,TZA,2004.0,2,0,2
FRA,AFG,2000.0,2,0,2
NZL,MYS,2000.0,1,0,1
,MOZ,2000.0,13,0,13
FRA,MNE,2010.0,1,0,1
ITA,ALB,1997.0,1,0,1
TUN,CAF,2014.0,3,0,3
USA,GLP,2008.0,1,0,1
GBR,PSE,2012.0,3,0,3
ITA,CYM,2004.0,1,0,1
BGR,BGD,2011.0,2,0,2
LBN,ARE,2000.0,1,0,1
KHM,,2010.0,21,0,21
PHL,CHE,2003.0,1,0,1
FRA,MKD,2011.0,3,0,3
ARE,LBN,2003.0,1,0,1
CZE,IRN,2011.0,1,0,1
CAN,NER,2006.0,1,0,1
NER,CAN,2007.0,1,0,1
GAB,,2009.0,9,0,9
LBN,SAU,2023.0,3,0,3
BLR,POL,2007.0,4,0,4
HKG,BLR,2006.0,1,0,1
USA,BRN,2014.0,1,0,1
,HTI,2002.0,6,0,6
MUS,CAN,2006.0,1,0,1
BGR,IND,2006.0,2,0,2
NOR,SAU,2002.0,1,0,1
YEM,OMN,2012.0,1,0,1
SYC,GBR,2011.0,1,0,1
TCD,SEN,2009.0,1,0,1
UKR,PRI,2000.0,1,0,1
MAR,CMR,2005.0,1,0,1
BRN,,2015.0,24,0,24
PHL,NLD,2004.0,3,0,3
BRA,LUX,2018.0,2,0,2
FRA,DJI,2008.0,4,0,4
NZL,LKA,2007.0,1,0,1
JOR,PSE,2002.0,1,0,1
NGA,DNK,2014.0,2,0,2
LUX,THA,2013.0,1,0,1
ROU,ALB,2020.0,1,0,1
NZL,KOR,2003.0,3,0,3
TWN,AFG,2019.0,1,0,1
TUR,TKM,2014.0,1,0,1
CMR,PHL,2015.0,1,0,1
REU,ROU,2010.0,2,0,2
PAK,BRA,2007.0,2,0,2
HKG,TUR,2012.0,2,0,2
LKA,FJI,2014.0,1,0,1
ERI,PAK,2013.0,1,0,1
ATG,,2025.0,11,0,11
SEN,NCL,2019.0,1,0,1
GAB,MAR,2011.0,3,0,3
MAR,GAB,2018.0,2,0,2
UGA,SDN,2011.0,2,0,2
GRC,ARE,2014.0,7,0,7
QAT,DNK,2020.0,2,0,2
NLD,ARE,2013.0,6,0,6
TZA,COD,2015.0,1,0,1
DZA,TUN,2008.0,4,0,4
ITA,MAR,2015.0,4,0,4
ROU,SVN,2010.0,1,0,1
ISR,PRT,2007.0,3,0,3
BLR,AUT,2019.0,1,0,1
LTU,NZL,2010.0,1,0,1
MLT,ITA,2016.0,6,0,6
ZAF,REU,2019.0,2,0,2
ITA,SVK,2012.0,5,0,5
PHL,DNK,2016.0,2,0,2
FJI,,2015.0,10,0,10
BGD,PRT,2017.0,2,0,2
PAK,DZA,2019.0,1,0,1
IND,BRN,2013.0,2,0,2
HND,BRA,2019.0,1,0,1
FRA,MKD,2019.0,1,0,1
LUX,QAT,2016.0,1,0,1
MEX,PAN,2015.0,1,0,1
ITA,PSE,2018.0,6,0,6
DJI,,2017.0,3,0,3
USA,SSD,2015.0,2,0,2
KHM,CAN,2012.0,2,0,2
ISR,LUX,2016.0,1,0,1
SWE,CRI,2018.0,4,0,4
CRI,SWE,2020.0,3,0,3
NPL,AUT,2010.0,2,0,2
,MDV,2002.0,1,0,1
IND,PNG,2018.0,2,0,2
FRA,SDN,2016.0,3,0,3
NAM,LAO,2016.0,1,0,1
SGP,KAZ,2019.0,4,0,4
,BRB,2006.0,21,0,21
THA,AFG,2018.0,1,0,1
LBN,JOR,2016.0,2,0,2
SYC,GBR,2019.0,2,0,2
ESP,BGR,2015.0,2,0,2
REU,,2017.0,7,0,7
FRA,MUS,2019.0,2,0,2
NOR,ARM,2019.0,1,0,1
JPN,UGA,2016.0,2,0,2
CUB,HND,2020.0,1,0,1
ESP,KWT,2021.0,1,0,1
CUB,JPN,2018.0,2,0,2
,SSD,2016.0,8,0,8
EGY,SWE,2024.0,1,0,1
GIN,TCD,2021.0,2,0,2
BEL,TGO,2019.0,1,0,1
CRI,HND,2019.0,1,0,1
HND,FRA,2022.0,1,0,1
CHN,MUS,2019.0,1,0,1
CZE,CMR,2021.0,3,0,3
BOL,ECU,2017.0,2,0,2
TTO,BRA,2020.0,1,0,1
PAK,KHM,2018.0,1,0,1
ZWE,IRL,2023.0,1,0,1
RUS,LUX,2020.0,5,0,5
HKG,TZA,2020.0,1,0,1
GRC,TUN,2019.0,1,0,1
CAN,MDG,2023.0,1,0,1
SAU,PER,2003.0,2,0,2
NOR,PER,2022.0,2,0,2
,WSM,2019.0,11,0,11
SLB,,2024.0,16,0,16
,MRT,2019.0,17,0,17
IND,RWA,2021.0,2,0,2
RWA,IND,2023.0,3,0,3
FJI,SAU,2017.0,1,0,1
,AFG,2020.0,66,0,66
FJI,PAK,2022.0,1,0,1
MEX,DNK,2002.0,1,0,1
CYP,JOR,2022.0,3,0,3
CAN,VEN,2022.0,3,0,3
CHE,BTN,2022.0,1,0,1
,EUE,2018.0,4,0,4
RUS,ETH,2022.0,3,0,3
LVA,GBR,2009.0,2,0,2
CIV,MAR,2009.0,3,0,3
EGY,LBN,2007.0,2,0,2
ZAF,ERI,2018.0,2,0,2
ITA,JOR,2006.0,3,0,3
,MMR,2005.0,9,0,9
ISL,AUS,2006.0,2,0,2
IND,YEM,2011.0,4,0,4
TUR,TZA,2018.0,1,0,1
MYS,CAN,2004.0,2,0,2
BRA,CRI,2015.0,1,7,-6
COL,IRL,2021.0,1,1,0
MDA,FRA,2013.0,2,4,-2
ARE,OMN,2018.0,5,10,-5
ISR,DNK,2022.0,7,5,2
NLD,JPN,2012.0,15,24,-9
PAK,CZE,2020.0,2,3,-1
PRT,MAR,2023.0,1,3,-2
HRV,SVN,2017.0,12,8,4
HRV,SVN,2022.0,1,5,-4
RUS,LUX,2023.0,2,1,1
IND,VNM,2019.0,6,5,1
BEL,MEX,2018.0,10,5,5
UKR,CZE,2023.0,11,6,5
ZAF,KEN,2003.0,7,6,1
FRA,LAO,2006.0,3,1,2
ISR,USA,2024.0,5,3,2
NPL,GBR,2018.0,9,9,0
ZWE,IND,2020.0,2,1,1
DZA,GBR,2017.0,2,6,-4
DZA,GBR,2022.0,5,1,4
KOR,PHL,2019.0,15,7,8
IND,NOR,2008.0,6,3,3
BFA,USA,2022.0,5,4,1
YEM,ITA,2022.0,1,1,0
NOR,MWI,2019.0,3,1,2
DEU,UGA,2023.0,4,2,2
ESP,SGP,2023.0,4,5,-1
SSD,SDN,2020.0,2,4,-2
VNM,THA,2020.0,8,32,-24
LVA,RUS,2022.0,4,6,-2
MMR,NLD,2021.0,1,1,0
EGY,OMN,2019.0,7,8,-1
ESP,SAU,2020.0,11,6,5
GBR,BFA,2010.0,1,1,0
IRL,VNM,2020.0,3,2,1
CRI,FRA,2020.0,6,7,-1
VEN,COL,2021.0,21,14,7
CHE,ARG,2001.0,2,2,0
NGA,PRT,2018.0,2,2,0
JPN,LKA,2022.0,7,5,2
MEX,ARG,2012.0,17,14,3
ISR,FRA,1997.0,16,20,-4
EGY,IRQ,2022.0,8,6,2
TUR,SWE,2020.0,25,14,11
ITA,MEX,2019.0,21,19,2
ARE,IND,2005.0,2,5,-3
KOR,NZL,2020.0,4,3,1
ECU,BRA,2020.0,6,18,-12
KOR,FRA,2005.0,6,12,-6
IRL,CHL,2013.0,2,1,1
ARE,SDN,2020.0,3,4,-1
SWE,LKA,2022.0,4,4,0
PAK,BRA,2010.0,3,1,2
DZA,SAU,2022.0,5,8,-3
TWN,SWE,2022.0,8,2,6
MEX,NOR,2022.0,2,2,0
BGR,ROU,2017.0,2,3,-1
ESP,DNK,2001.0,10,9,1
USA,PSE,2021.0,7,9,-2
AUS,PER,2016.0,2,1,1
IRL,BEL,2022.0,12,12,0
ZAF,UGA,2020.0,10,4,6
DEU,LKA,2023.0,1,2,-1
IND,QAT,2023.0,7,5,2
AUT,LIE,2023.0,4,1,3
CHN,SLE,2022.0,3,1,2
JPN,QAT,2022.0,1,3,-2
BEL,VNM,2022.0,9,6,3
NLD,ECU,2012.0,2,2,0
AUS,SVN,2014.0,2,1,1
SWE,ARE,2020.0,7,5,2
POL,JPN,2010.0,7,13,-6
ESP,BOL,2011.0,3,2,1
SVK,HUN,2003.0,6,3,3
EGY,IRL,2016.0,4,2,2
HUN,IND,2010.0,1,3,-2
JPN,VNM,2001.0,6,2,4
BEL,COG,2011.0,3,7,-4
CAN,GRC,2014.0,9,18,-9
ZWE,CHE,2019.0,3,1,2
SWE,KOR,1998.0,8,2,6
POL,IND,2016.0,6,13,-7
ZMB,GBR,2021.0,7,8,-1
AUS,ARE,2013.0,13,8,5
BEL,CZE,2012.0,8,7,1
BEL,BRA,2018.0,24,21,3
IND,ETH,2010.0,7,13,-6
IRN,NOR,2012.0,14,1,13
SRB,ITA,2014.0,7,6,1
IRN,DEU,2006.0,9,12,-3
BRA,CRI,2004.0,1,1,0
IRL,DNK,2015.0,4,5,-1
NGA,MYS,2011.0,12,10,2
MEX,BRA,2006.0,15,5,10
ARM,FRA,2013.0,1,2,-1
CAN,TUN,2022.0,3,6,-3
PRT,CHE,2012.0,10,9,1
BRA,CUB,2009.0,3,17,-14
BRA,URY,2023.0,8,3,5
AUT,HRV,2019.0,6,9,-3
FIN,CHN,2005.0,13,9,4
PER,GBR,2004.0,1,1,0
NZL,ESP,2017.0,6,4,2
NZL,CHL,2013.0,4,7,-3
SWE,CHL,2002.0,5,2,3
AFG,FRA,2017.0,2,4,-2
JOR,GBR,2012.0,11,23,-12
BHR,TUN,2021.0,2,3,-1
MEX,NLD,2012.0,7,8,-1
MOZ,USA,2017.0,9,9,0
IDN,SAU,2016.0,4,3,1
NOR,MOZ,2010.0,1,1,0
TZA,IND,2011.0,1,3,-2
PRT,DNK,2004.0,2,1,1
RUS,MYS,2014.0,1,1,0
NPL,JPN,2009.0,5,10,-5
GBR,MAC,2016.0,4,1,3
NLD,HRV,2018.0,5,5,0
IRN,ITA,2010.0,12,9,3
ITA,CMR,2011.0,3,2,1
SGP,PAK,2017.0,4,6,-2
GBR,BWA,2010.0,2,3,-1
JPN,CHL,2014.0,8,3,5
BGD,FRA,2009.0,2,1,1
AUS,PHL,2019.0,14,21,-7
ARE,TUR,2016.0,4,4,0
QAT,DEU,2018.0,6,4,2
ISR,BRA,2012.0,6,2,4
NPL,CHE,2017.0,2,1,1
FIN,ZAF,2011.0,4,1,3
NLD,PAK,2017.0,16,6,10
REU,FRA,2005.0,4,13,-9
USA,ETH,2013.0,14,26,-12
UKR,ESP,2000.0,5,3,2
GAB,DEU,2009.0,4,4,0
KOR,TUR,2020.0,5,7,-2
SAU,JPN,2010.0,2,13,-11
DNK,TUR,2013.0,4,2,2
THA,IND,2015.0,7,9,-2
IDN,KEN,2010.0,1,1,0
ESP,JPN,2015.0,23,15,8
PAN,DEU,2011.0,2,1,1
MYS,JPN,2013.0,27,78,-51
COL,BEL,2010.0,3,2,1
BEL,IDN,2017.0,5,1,4
ECU,CUB,2022.0,2,7,-5
GBR,SVN,2012.0,6,7,-1
AUS,PAN,2010.0,1,2,-1
IRL,AUS,2024.0,2,1,1
ESP,FIN,2000.0,7,5,2
FIN,DNK,2015.0,20,10,10
RUS,AUS,2016.0,11,14,-3
ERI,USA,2019.0,1,2,-1
ITA,GEO,2007.0,4,1,3
KOR,LKA,2012.0,1,1,0
NZL,IND,2014.0,12,8,4
UGA,DEU,2009.0,1,1,0
CZE,ROU,2009.0,2,1,1
BLR,POL,2010.0,3,7,-4
JPN,MMR,2016.0,12,1,11
SWE,CMR,2012.0,1,1,0
IDN,NOR,2016.0,2,3,-1
DNK,NPL,2021.0,1,2,-1
FRA,PRT,2000.0,31,20,11
PAK,ZAF,2015.0,2,1,1
NPL,IND,2013.0,17,29,-12
GBR,SDN,2016.0,6,2,4
PAK,IRL,2018.0,8,7,1
ISR,MEX,2019.0,5,4,1
RUS,CZE,2017.0,19,15,4
ITA,NGA,2019.0,7,2,5
GHA,USA,2015.0,22,39,-17
NLD,ROU,2000.0,1,6,-5
CIV,CAN,2004.0,2,1,1
CZE,SRB,2017.0,2,2,0
USA,TTO,2018.0,11,16,-5
GBR,PSE,2021.0,9,11,-2
BEL,HUN,2002.0,10,8,2
ESP,DOM,2016.0,6,2,4
ESP,QAT,2019.0,4,2,2
RUS,BRA,2014.0,13,5,8
RUS,BRA,2015.0,8,5,3
GBR,MDG,2017.0,7,7,0
HKG,TWN,2012.0,9,4,5
POL,VNM,2017.0,2,1,1
HRV,IRL,2020.0,2,1,1
BEL,VNM,2016.0,11,7,4
IRN,IRL,2014.0,12,8,4
SGP,DEU,2005.0,6,20,-14
NZL,PAK,2018.0,10,9,1
JPN,SRB,2014.0,1,2,-1
ARE,MAR,2017.0,3,3,0
LUX,ESP,2019.0,7,13,-6
NPL,MYS,2020.0,2,1,1
NOR,ESP,2003.0,4,5,-1
RUS,GRC,2007.0,1,3,-2
AFG,IND,2020.0,3,2,1
MLI,BFA,2007.0,1,1,0
CZE,AUS,2012.0,2,2,0
ISR,CZE,2021.0,7,5,2
ZAF,POL,2004.0,2,2,0
PRI,ESP,2011.0,4,5,-1
ROU,HUN,2013.0,10,10,0
DEU,PER,2003.0,2,1,1
NOR,GRC,2011.0,2,1,1
EGY,IRN,2021.0,2,4,-2
UKR,JPN,2003.0,5,5,0
DEU,IRL,1999.0,12,5,7
SGP,FRA,1999.0,2,3,-1
FIN,IND,2002.0,2,3,-1
CHL,JPN,2016.0,5,8,-3
OMN,SAU,2009.0,3,3,0
DEU,ARG,2003.0,12,28,-16
IRL,GHA,2021.0,1,1,0
MEX,SAU,2020.0,5,1,4
DEU,CHL,2023.0,14,23,-9
NZL,SGP,2021.0,12,12,0
COL,PRT,2018.0,3,4,-1
RUS,IRL,2003.0,5,3,2
AUS,ARG,2005.0,1,4,-3
CMR,TZA,2019.0,1,1,0
PAK,FRA,2016.0,8,16,-8
IND,DNK,2012.0,15,11,4
SWE,BGD,2022.0,4,6,-2
ITA,ZAF,1999.0,2,2,0
HRV,ESP,2022.0,6,6,0
PER,AUT,2023.0,2,1,1
PAK,TWN,2022.0,11,9,2
CZE,MEX,2021.0,3,11,-8
GUM,USA,2022.0,8,17,-9
SEN,CAN,2022.0,1,3,-2
GTM,MEX,2021.0,4,7,-3
NGA,CMR,2022.0,5,4,1
UZB,DEU,2014.0,1,5,-4
NOR,NPL,2014.0,4,5,-1
JOR,PAK,2020.0,2,5,-3
CHN,GRC,2016.0,3,9,-6
CIV,USA,2022.0,4,2,2
CHN,LBR,2022.0,4,1,3
NAM,ZMB,2023.0,1,1,0
REU,FRA,2002.0,6,3,3
SWE,SVK,2001.0,2,4,-2
SVN,SVK,2019.0,28,23,5
BRA,RUS,2004.0,7,7,0
VEN,MEX,2015.0,12,10,2
JPN,HUN,2006.0,7,7,0
BGR,FRA,2007.0,8,12,-4
USA,HUN,2017.0,54,76,-22
BEL,CZE,2002.0,8,8,0
VNM,USA,2006.0,5,11,-6
NOR,POL,2000.0,6,3,3
SWE,IRQ,2011.0,4,2,2
BEL,CHE,1999.0,18,10,8
COD,COG,2003.0,4,3,1
FRA,MLI,2013.0,3,7,-4
FIN,BEL,2000.0,5,3,2
CAN,BGR,1999.0,2,2,0
FRA,BFA,2023.0,1,2,-1
GMB,USA,2000.0,4,1,3
USA,LUX,2012.0,4,5,-1
NLD,IRL,1998.0,5,5,0
MAC,HKG,2007.0,4,15,-11
GHA,JPN,2002.0,2,3,-1
NZL,DNK,2009.0,10,5,5
BFA,NGA,2010.0,1,1,0
LUX,FRA,2002.0,3,9,-6
AZE,TUR,1998.0,6,2,4
USA,MLT,2021.0,4,1,3
LUX,DEU,2000.0,2,4,-2
IRL,DNK,2014.0,6,3,3
ITA,ROU,2006.0,11,14,-3
CAN,PRT,2004.0,5,3,2
AUT,NZL,1997.0,1,2,-1
PYF,FRA,2005.0,5,7,-2
FRA,COG,1999.0,3,4,-1
MDA,RUS,2003.0,3,3,0
JPN,ISR,2011.0,5,7,-2
SAU,JOR,1998.0,2,1,1
LSO,USA,2013.0,3,2,1
FIN,ESP,2006.0,6,5,1
ESP,AUT,2001.0,7,13,-6
CAN,PHL,2000.0,3,2,1
KEN,IDN,2010.0,1,1,0
THA,CAN,2017.0,14,17,-3
SWE,UKR,1999.0,3,9,-6
TUR,AUT,2003.0,4,3,1
HTI,FRA,2023.0,1,3,-2
BGR,BLR,2009.0,2,1,1
BEN,FRA,2021.0,10,9,1
FRA,GAB,1999.0,7,3,4
HUN,ESP,1998.0,4,1,3
FIN,RUS,2007.0,5,13,-8
UKR,ITA,2005.0,4,2,2
USA,EST,2002.0,7,5,2
AUS,BRN,2000.0,1,1,0
ITA,HRV,2006.0,3,3,0
JPN,NOR,1998.0,7,11,-4
BGD,IND,2011.0,14,15,-1
SWE,URY,2010.0,2,1,1
NGA,ZWE,2002.0,1,1,0
AUT,ITA,1999.0,10,17,-7
FRA,PYF,2002.0,9,6,3
VEN,CUB,2000.0,1,1,0
RUS,GRC,1999.0,3,1,2
SWE,LKA,2018.0,6,1,5
MWI,GBR,2003.0,4,7,-3
ZMB,GBR,2011.0,3,1,2
NLD,HRV,2022.0,6,5,1
ISR,UKR,2010.0,1,1,0
ESP,NOR,2012.0,13,12,1
FRA,HUN,1997.0,11,9,2
ARE,DZA,2004.0,1,1,0
POL,TWN,2008.0,1,3,-2
FRA,VEN,2018.0,4,4,0
EST,FIN,1998.0,4,5,-1
SYR,MAR,2015.0,3,1,2
ESP,HRV,2013.0,4,5,-1
ISR,HRV,2006.0,1,1,0
GBR,COL,2011.0,11,9,2
UZB,RUS,1997.0,6,12,-6
RUS,UZB,1999.0,4,7,-3
TWN,MAR,2007.0,1,1,0
NOR,SGP,2008.0,4,6,-2
RUS,BGR,2007.0,7,3,4
DEU,BLR,2007.0,8,9,-1
VNM,JPN,2002.0,4,8,-4
POL,HUN,2002.0,5,3,2
SRB,BRA,2006.0,4,1,3
IRQ,SWE,2018.0,2,5,-3
RUS,ZAF,2001.0,6,3,3
NZL,CHE,2002.0,6,6,0
ISR,GRC,2004.0,3,1,2
NLD,UKR,1999.0,2,3,-1
BEL,KEN,2000.0,2,3,-1
SWE,UKR,1998.0,4,10,-6
ARG,ITA,2008.0,11,21,-10
ITA,ISL,2021.0,1,4,-3
HKG,DEU,2003.0,11,10,1
JPN,IRL,2005.0,5,4,1
FIN,IND,2012.0,3,16,-13
HRV,GBR,2002.0,5,4,1
AFG,DEU,2021.0,4,2,2
SWE,AUT,2015.0,23,26,-3
TZA,JPN,2010.0,1,3,-2
CIV,DEU,2018.0,1,2,-1
IDN,VNM,2014.0,1,1,0
FRA,BFA,2010.0,7,17,-10
ITA,TWN,2012.0,4,7,-3
CAN,UGA,2016.0,1,4,-3
ISL,DNK,2010.0,6,9,-3
UKR,SGP,2004.0,1,1,0
POL,IND,2017.0,4,13,-9
FRA,PHL,2016.0,5,3,2
ISR,SGP,2010.0,3,4,-1
NGA,BEL,2011.0,3,2,1
HUN,ROU,2006.0,7,4,3
SRB,HUN,2011.0,2,2,0
CAN,LTU,2018.0,3,4,-1
KOR,RUS,2009.0,8,10,-2
BLR,POL,2006.0,4,4,0
KOR,THA,2014.0,5,6,-1
ITA,LTU,2014.0,6,3,3
SWE,CZE,2010.0,4,4,0
TUR,FRA,2000.0,7,9,-2
NZL,CHE,1997.0,5,2,3
ZAF,MWI,2010.0,4,2,2
NLD,GEO,2017.0,2,2,0
USA,SVN,2007.0,11,16,-5
DEU,HRV,2013.0,6,14,-8
DEU,QAT,2022.0,4,6,-2
POL,ITA,2016.0,15,13,2
CAN,PYF,2017.0,2,1,1
DNK,NIC,2012.0,1,1,0
PRT,CHN,2010.0,8,8,0
IND,GUY,2014.0,1,1,0
DNK,BGD,2020.0,3,2,1
MLT,GBR,2012.0,5,10,-5
TGO,SEN,2012.0,2,1,1
IRN,ZAF,2014.0,6,2,4
KEN,SWE,2018.0,5,4,1
JPN,NGA,2009.0,5,5,0
LAO,AUS,2020.0,2,1,1
KOR,THA,2001.0,3,1,2
NOR,ISL,2011.0,3,7,-4
IRQ,IND,2014.0,4,7,-3
UGA,CAN,2016.0,4,1,3
CAN,UGA,2017.0,5,5,0
UGA,CAN,2018.0,5,1,4
SWE,TZA,2011.0,3,1,2
USA,HND,2015.0,2,2,0
AUS,ARG,2012.0,5,8,-3
LVA,LTU,2017.0,1,3,-2
MAR,ESP,2016.0,6,13,-7
EST,RUS,2011.0,3,6,-3
ESP,ROU,2010.0,9,7,2
EGY,BEL,2014.0,5,5,0
MKD,SRB,2012.0,11,4,7
BLR,DEU,2013.0,2,3,-1
JOR,QAT,2016.0,5,2,3
FRA,ARG,2010.0,18,35,-17
AUT,ISR,2014.0,6,3,3
ARE,NZL,2014.0,2,3,-1
FRA,ARM,2011.0,2,2,0
ARM,IRN,2019.0,1,1,0
COL,PRI,2014.0,3,5,-2
USA,MLT,2019.0,2,2,0
POL,LTU,2016.0,4,7,-3
KOR,ESP,2008.0,5,2,3
USA,AFG,2006.0,2,1,1
AFG,USA,2008.0,4,3,1
COL,ARG,2022.0,18,13,5
ISR,ITA,2018.0,16,30,-14
ESP,IRN,2013.0,5,17,-12
ARG,PER,2017.0,10,3,7
GBR,ETH,2010.0,12,5,7
BGR,GBR,2014.0,11,8,3
LBN,SAU,2020.0,5,3,2
POL,NGA,2020.0,1,4,-3
NLD,GRC,2013.0,8,24,-16
ITA,DZA,2013.0,4,5,-1
FRA,KAZ,2021.0,1,2,-1
RUS,COL,2019.0,2,1,1
SAU,NZL,2016.0,3,3,0
FIN,EGY,2013.0,3,2,1
DNK,NZL,2021.0,4,6,-2
ARE,IRN,2020.0,5,3,2
DNK,ESP,1997.0,6,9,-3
LTU,TUR,2022.0,2,1,1
NGA,CMR,2017.0,2,1,1
CAN,LTU,2022.0,2,2,0
ECU,CAN,2018.0,4,2,2
SEN,CIV,2009.0,4,2,2
DEU,CRI,2013.0,2,5,-3
ZMB,ZAF,2018.0,7,21,-14
NLD,ARE,2017.0,3,1,2
CAN,LBN,2019.0,15,13,2
NOR,ITA,2013.0,8,16,-8
GBR,SVK,2020.0,7,4,3
FIN,AUS,2020.0,15,24,-9
MAR,YEM,2020.0,3,2,1
USA,VIR,2013.0,3,7,-4
MWI,TZA,2019.0,1,1,0
BRA,ZAF,2018.0,7,5,2
SWE,ZAF,2023.0,7,7,0
USA,MNG,2014.0,7,4,3
RUS,CUB,2014.0,1,1,0
EGY,OMN,2009.0,3,6,-3
CZE,PAN,2023.0,2,1,1
ZAF,ETH,2017.0,12,6,6
FLK,GBR,2020.0,2,3,-1
NZL,KOR,2022.0,6,2,4
CHE,COL,2017.0,5,6,-1
CHN,BWA,2018.0,1,2,-1
CUB,BEL,2017.0,7,1,6
ARE,BRA,2020.0,1,6,-5
PHL,AUS,2014.0,14,9,5
CZE,GRC,2020.0,5,6,-1
LTU,SWE,2014.0,5,7,-2
GHA,CHN,2015.0,12,7,5
MYS,CHL,2019.0,2,1,1
FIN,ARE,2020.0,2,1,1
CIV,SEN,2020.0,3,4,-1
SWE,TUN,2018.0,3,3,0
BRA,ISR,2014.0,4,2,2
IDN,IND,2013.0,14,16,-2
TUN,CHE,2020.0,2,1,1
UGA,TZA,2022.0,4,3,1
NGA,GMB,2022.0,2,3,-1
SAU,PSE,2021.0,5,1,4
AUS,HRV,2022.0,4,1,3
AUT,BFA,2015.0,1,1,0
ARG,NGA,2022.0,1,1,0
GBR,MDG,2018.0,4,6,-2
HRV,ESP,2016.0,6,4,2
TWN,IRN,2016.0,3,3,0
CHE,TZA,2023.0,5,2,3
BEL,IDN,2016.0,5,4,1
AUS,GRC,2020.0,6,6,0
ISR,JPN,2022.0,4,2,2
SDN,ITA,2021.0,2,1,1
SGP,ROU,2019.0,1,1,0
ISL,NOR,2018.0,5,7,-2
BEN,NLD,2016.0,4,4,0
CAN,MLT,2021.0,4,1,3
NZL,IRN,2020.0,6,31,-25
MUS,GBR,2023.0,2,1,1
ESP,SLV,2021.0,2,2,0
YEM,DEU,2019.0,1,1,0
ROU,DNK,2014.0,3,2,1
LUX,SAU,2022.0,1,1,0
THA,KHM,2022.0,9,4,5
ITA,LTU,2015.0,4,1,3
IND,PRI,2005.0,1,1,0
BIH,AUT,2019.0,1,1,0
USA,TTO,2017.0,9,6,3
NAM,FIN,2020.0,1,1,0
PAN,IND,2019.0,1,1,0
PRT,NOR,2023.0,3,6,-3
KEN,RWA,2023.0,4,4,0
KWT,BHR,2019.0,2,1,1
CAN,LBY,2023.0,2,1,1
ITA,URY,2021.0,3,2,1
UKR,NOR,2019.0,3,1,2
MOZ,NLD,2019.0,2,2,0
SWE,MEX,2019.0,7,6,1
MAC,SGP,2018.0,2,1,1
DNK,IRL,2023.0,4,6,-2
AUT,SVN,2019.0,6,13,-7
POL,IND,2018.0,7,13,-6
FRA,PAK,2007.0,1,1,0
ROU,IND,2019.0,2,2,0
NOR,RUS,2001.0,12,7,5
ECU,ITA,2013.0,3,5,-2
SAU,NZL,2018.0,3,4,-1
GBR,MAC,2017.0,3,1,2
BRB,USA,2015.0,3,3,0
SDN,GBR,2019.0,4,8,-4
CHE,EST,2022.0,5,4,1
NZL,ARE,2020.0,9,2,7
AUS,EST,1997.0,1,1,0
CHE,VNM,2018.0,4,2,2
SAU,IRL,2021.0,3,18,-15
ETH,FIN,2023.0,1,1,0
PSE,BEL,2013.0,1,1,0
CHL,CRI,2021.0,4,1,3
PSE,CAN,2019.0,2,1,1
TUN,BEL,2022.0,5,1,4
TWN,CHE,2022.0,6,12,-6
CRI,GTM,2022.0,1,1,0
EGY,JOR,2023.0,5,6,-1
ZAF,MWI,2023.0,3,8,-5
SYR,DEU,2021.0,2,1,1
ARE,PAK,2020.0,12,29,-17
ISR,EGY,2006.0,1,1,0
DNK,CAN,2022.0,19,21,-2
CHE,RUS,2019.0,22,29,-7
AUT,TUR,2018.0,6,21,-15
SVK,IND,2022.0,2,5,-3
MLT,BIH,2021.0,1,2,-1
JPN,SDN,2022.0,2,1,1
ISR,CHN,1999.0,7,5,2
UKR,NLD,2001.0,3,2,1
JOR,CAN,2023.0,4,4,0
VEN,MEX,2004.0,7,6,1
FRA,NGA,2007.0,2,2,0
CUB,CAN,2002.0,3,1,2
DEU,LIE,1998.0,6,2,4
BRA,IND,2007.0,5,5,0
SDN,ARE,2012.0,3,1,2
LBN,CAN,2008.0,10,5,5
CHN,NZL,2000.0,6,3,3
PRT,ITA,1998.0,4,5,-1
GBR,DZA,2002.0,3,1,2
JPN,PRT,1997.0,2,1,1
CHN,NZL,2010.0,7,8,-1
THA,BGD,2002.0,1,2,-1
CYM,USA,2010.0,3,2,1
IND,SWE,2005.0,14,7,7
SGP,NZL,2016.0,10,14,-4
FRA,HRV,2017.0,8,6,2
JPN,GRC,2008.0,5,1,4
RUS,KOR,2009.0,10,8,2
ISL,NLD,2007.0,2,4,-2
ARG,JPN,2002.0,3,2,1
MEX,ARG,2002.0,8,8,0
BHR,CAN,2007.0,1,2,-1
KOR,ETH,2014.0,2,3,-1
HKG,AUS,1997.0,7,25,-18
FIN,AUT,2008.0,4,5,-1
TUR,SAU,2003.0,2,2,0
NZL,BRA,2021.0,1,20,-19
BRA,IND,1998.0,2,5,-3
IND,MYS,1999.0,8,4,4
BWA,USA,2021.0,9,10,-1
GHA,AUS,2010.0,3,3,0
SWE,ESP,2003.0,23,26,-3
TZA,CHE,2006.0,2,1,1
NZL,IND,2001.0,2,6,-4
SVK,JPN,2005.0,3,4,-1
GBR,CUB,2004.0,6,3,3
IRL,CAN,2001.0,17,15,2
IRL,JPN,2008.0,7,5,2
NLD,IND,2003.0,9,19,-10
DZA,SAU,2018.0,9,8,1
ESP,HUN,2009.0,5,6,-1
BEL,NER,2016.0,1,1,0
BLR,CAN,2002.0,7,1,6
PRT,POL,2013.0,6,4,2
AUS,HUN,2008.0,5,4,1
VNM,POL,2017.0,1,2,-1
HUN,IND,2023.0,4,2,2
CZE,NOR,2018.0,12,5,7
BEL,KHM,2011.0,1,2,-1
EGY,NLD,2020.0,3,10,-7
HKG,MAC,2017.0,17,3,14
LKA,AUT,2019.0,1,1,0
IND,ECU,2019.0,2,1,1
PER,BOL,2009.0,2,1,1
LBR,USA,2017.0,8,15,-7
MYS,ARE,2016.0,22,3,19
FIN,NZL,2019.0,5,2,3
HKG,JPN,2021.0,12,12,0
PHL,FRA,2020.0,4,1,3
JPN,ESP,1997.0,11,8,3
TUR,BIH,2018.0,3,3,0
IRN,NLD,2002.0,5,4,1
ARG,COL,2012.0,13,11,2
PRT,CZE,2008.0,4,2,2
FRA,KHM,2017.0,8,5,3
LTU,AUS,2013.0,2,2,0
DNK,THA,2018.0,4,2,2
CUB,USA,1997.0,5,2,3
IND,ZMB,2020.0,1,1,0
USA,MAC,2016.0,11,7,4
THA,TWN,2021.0,10,27,-17
FIN,IND,2005.0,3,3,0
CHE,CHL,2018.0,11,11,0
KOR,NPL,2023.0,5,7,-2
DZA,ITA,2023.0,2,2,0
SVK,CHE,2015.0,4,3,1
SWE,CZE,2023.0,7,9,-2
PAN,ESP,2022.0,4,7,-3
PAK,CMR,2021.0,1,3,-2
MYS,ITA,2023.0,4,3,1
UKR,CAN,2023.0,4,3,1
SVK,NLD,2021.0,2,5,-3
BIH,SRB,2023.0,7,7,0
BGR,SWE,2012.0,2,1,1
CAN,CIV,2021.0,3,2,1
PER,BOL,2021.0,1,2,-1
IRQ,TUR,2021.0,13,37,-24
SAU,CHN,2012.0,4,18,-14
POL,ZAF,2020.0,6,1,5
FIN,AUS,1999.0,7,7,0
AUS,FIN,2003.0,6,18,-12
PER,BRA,2019.0,13,51,-38
AUT,ARE,2009.0,3,1,2
ISL,GBR,2011.0,7,7,0
PRI,IND,2008.0,4,6,-2
FIN,FRA,2010.0,23,22,1
LUX,BEL,2014.0,5,23,-18
SWE,LUX,2016.0,3,2,1
TUN,DZA,2018.0,7,5,2
BRN,IND,2006.0,1,2,-1
THA,JPN,2001.0,37,43,-6
PHL,USA,1998.0,14,14,0
PRT,ROU,2010.0,3,3,0
JPN,AUT,2006.0,8,6,2
POL,MEX,1998.0,3,4,-1
DNK,ISR,2008.0,3,3,0
CHE,SWZ,2010.0,9,10,-1
BRB,USA,2008.0,1,1,0
USA,ALB,1999.0,1,1,0
EGY,FRA,1998.0,2,7,-5
ISR,AUT,2011.0,7,4,3
RUS,PRT,2010.0,6,1,5
CZE,UKR,2018.0,4,14,-10
MEX,IND,2011.0,3,3,0
VEN,MEX,2014.0,17,10,7
JOR,JPN,1999.0,2,1,1
NOR,DNK,1997.0,10,15,-5
CHN,FIN,2001.0,8,7,1
AUS,ESP,2000.0,7,5,2
DNK,ROU,2006.0,2,2,0
NOR,RUS,2015.0,6,7,-1
ZWE,NLD,2010.0,2,1,1
ITA,LSO,2004.0,1,1,0
ITA,TUN,2020.0,9,9,0
CHN,RUS,2010.0,5,6,-1
VNM,DEU,2005.0,4,5,-1
GBR,ARE,2002.0,13,3,10
USA,GAB,2011.0,4,3,1
DEU,LTU,2000.0,7,12,-5
BEL,ROU,2007.0,4,10,-6
ITA,EGY,2001.0,3,1,2
BOL,ESP,2015.0,2,6,-4
ITA,MEX,2009.0,11,9,2
SRB,ESP,1997.0,1,4,-3
USA,NAM,2004.0,1,2,-1
ZAF,RUS,2003.0,3,7,-4
GBR,FJI,2019.0,2,3,-1
POL,ISR,2021.0,6,5,1
ESP,SVK,2000.0,1,6,-5
KWT,FIN,2003.0,3,1,2
FRA,SVK,2003.0,7,3,4
PRT,NOR,2010.0,3,2,1
USA,PRY,2008.0,3,2,1
ROU,SWE,2000.0,2,3,-1
FRA,GUY,2000.0,1,3,-2
RUS,ESP,2005.0,14,9,5
NPL,NOR,2013.0,3,2,1
IND,MYS,1998.0,7,3,4
BGR,ROU,2016.0,5,1,4
GRC,TUR,2005.0,6,2,4
EGY,NLD,1999.0,2,1,1
ESP,AUT,2004.0,8,11,-3
DEU,ECU,2011.0,5,1,4
SWE,MAR,2022.0,1,3,-2
SRB,DNK,2001.0,2,2,0
SDN,USA,2006.0,3,2,1
VNM,ITA,2004.0,1,1,0
BGR,GBR,2015.0,9,12,-3
PHL,NPL,2015.0,1,1,0
ISL,SWE,1998.0,6,8,-2
ITA,HUN,1998.0,5,7,-2
CRI,BRA,2010.0,2,4,-2
CZE,MEX,2011.0,4,3,1
ZAF,NZL,2013.0,8,5,3
NZL,ZAF,2015.0,5,14,-9
NOR,ISL,2019.0,2,3,-1
HUN,BEL,2015.0,9,6,3
BRA,URY,2006.0,7,3,4
BOL,FRA,2001.0,5,3,2
LTU,SWE,2008.0,6,5,1
JPN,CHL,2015.0,4,2,2
BRA,CZE,2011.0,3,2,1
POL,GRC,2016.0,1,4,-3
BWA,SWE,2008.0,2,1,1
ROU,AUS,2007.0,2,2,0
FJI,NZL,2012.0,5,3,2
GBR,BHR,2015.0,6,4,2
GBR,CUB,2014.0,2,2,0
IRN,RUS,2014.0,4,1,3
RUS,IRN,2016.0,6,7,-1
FIN,PHL,2013.0,2,1,1
EGY,MEX,2015.0,1,3,-2
JOR,NLD,2012.0,1,1,0
AUS,PRT,2017.0,4,19,-15
IRN,POL,2012.0,3,1,2
JPN,DNK,2004.0,14,7,7
PHL,CHE,2016.0,3,2,1
CHL,VEN,2023.0,1,3,-2
JPN,NZL,2015.0,3,10,-7
NZL,TWN,2020.0,4,6,-2
CYP,GRC,2010.0,7,28,-21
SWE,SAU,2019.0,8,4,4
CHN,CHL,2013.0,5,6,-1
TUR,SRB,2015.0,7,2,5
KEN,AUS,2011.0,4,7,-3
HRV,IRL,2007.0,1,1,0
KEN,IND,2010.0,1,1,0
IND,KEN,2014.0,5,1,4
HKG,JPN,2011.0,11,6,5
KAZ,EGY,2010.0,1,1,0
DEU,BIH,2018.0,4,4,0
TTO,FRA,2013.0,1,3,-2
SAU,SDN,2007.0,6,6,0
TWN,NZL,2009.0,3,2,1
AUS,TWN,2013.0,15,7,8
SWE,TWN,2021.0,6,7,-1
GBR,ECU,2013.0,4,1,3
VNM,CHN,2012.0,1,4,-3
CAN,JOR,2013.0,7,9,-2
SVN,CAN,2012.0,1,1,0
ITA,CYP,2012.0,2,2,0
GBR,LUX,2013.0,12,9,3
UKR,AUT,2021.0,4,4,0
CHN,SVN,2011.0,3,2,1
NOR,CRI,2020.0,1,1,0
JOR,ITA,2014.0,1,3,-2
BGD,THA,2020.0,5,4,1
CZE,HKG,2014.0,1,1,0
IRN,THA,2022.0,5,4,1
TUR,SGP,2020.0,5,5,0
TWN,HKG,2021.0,12,22,-10
SWE,TUN,2017.0,2,4,-2
AUS,BRN,2023.0,1,2,-1
USA,BLR,2014.0,4,8,-4
USA,BHR,2015.0,6,2,4
HKG,KOR,2015.0,6,13,-7
QAT,IRL,2021.0,1,3,-2
JOR,DEU,2016.0,14,20,-6
MDA,USA,2013.0,1,3,-2
CAN,LKA,2017.0,7,3,4
AUS,KOR,2002.0,10,14,-4
UGA,CAN,2022.0,1,2,-1
ITA,KOR,2020.0,8,16,-8
CHL,JPN,2018.0,4,2,2
GHA,ZAF,2014.0,5,7,-2
EGY,PAK,2014.0,4,1,3
DNK,EGY,2018.0,6,3,3
MLI,GHA,2017.0,1,1,0
AGO,PRT,2021.0,3,6,-3
BEL,BGD,2013.0,7,3,4
NAM,USA,2014.0,4,1,3
HKG,MYS,2023.0,2,5,-3
ZAF,TWN,2015.0,3,1,2
AUS,SYC,2014.0,1,1,0
ZMB,THA,2018.0,2,1,1
NZL,BEL,2014.0,4,3,1
DOM,USA,2020.0,7,6,1
BEL,LUX,2004.0,14,4,10
KWT,GBR,2010.0,5,10,-5
ESP,NZL,2017.0,4,6,-2
GUY,FRA,2018.0,1,1,0
CHN,MEX,2020.0,8,9,-1
EGY,TUR,2016.0,1,4,-3
GUY,FRA,2017.0,2,1,1
THA,CHE,2017.0,4,7,-3
OMN,GBR,2017.0,13,15,-2
LKA,USA,2016.0,11,21,-10
UGA,ETH,2021.0,2,4,-2
GBR,BRN,2001.0,1,1,0
ITA,ROU,2023.0,4,9,-5
CUB,MEX,2017.0,27,12,15
RUS,IRN,2022.0,7,8,-1
EGY,KWT,2005.0,11,3,8
ESP,QAT,2021.0,2,2,0
LKA,ITA,2021.0,2,1,1
SLE,USA,2017.0,8,19,-11
IRQ,GBR,2013.0,9,18,-9
CHN,DZA,2022.0,8,1,7
AFG,GBR,2022.0,2,1,1
CHE,THA,2017.0,7,4,3
TUR,BRA,2021.0,3,2,1
KOR,AUT,2018.0,4,10,-6
SWE,NPL,2022.0,3,2,1
SWZ,USA,2022.0,5,2,3
SGP,RUS,2023.0,1,4,-3
EGY,CHE,2021.0,6,2,4
DEU,LUX,2000.0,4,2,2
USA,AZE,2004.0,2,1,1
KOR,BRA,2020.0,1,3,-2
KEN,CHN,2021.0,6,27,-21
USA,IDN,1998.0,23,12,11
MEX,AUT,2010.0,3,1,2
ROU,SWE,2023.0,1,1,0
TUN,CAN,1998.0,3,4,-1
SRB,AUT,2006.0,2,5,-3
AUT,SRB,2008.0,1,3,-2
NZL,IRL,2001.0,4,1,3
RUS,PAK,2008.0,1,1,0
MAR,SAU,2001.0,1,1,0
EGY,PAK,2008.0,4,1,3
BEN,NGA,2000.0,2,2,0
GRC,ROU,2007.0,7,6,1
PLW,USA,2014.0,2,1,1
TWN,BEL,2002.0,1,1,0
ETH,GHA,2023.0,2,1,1
BEL,IRL,2010.0,12,7,5
IND,HKG,2005.0,3,3,0
BEL,CZE,1997.0,2,5,-3
ROU,CHN,2015.0,1,2,-1
IND,TUR,1999.0,2,3,-1
TUR,IND,2000.0,4,1,3
SVK,ITA,2004.0,3,2,1
ITA,POL,2005.0,11,9,2
USA,TZA,2006.0,8,4,4
ISL,DNK,2000.0,2,2,0
THA,IND,2001.0,2,4,-2
MDA,UKR,2018.0,1,1,0
IRL,BRA,2013.0,4,7,-3
MYS,FRA,2002.0,4,1,3
IND,ETH,2006.0,9,2,7
PRY,USA,2008.0,2,3,-1
ESP,AUS,2003.0,14,13,1
AUS,CZE,2015.0,10,9,1
ITA,CUB,2008.0,3,5,-2
NOR,GRC,2021.0,4,7,-3
FRA,MDG,1999.0,3,5,-2
GBR,NPL,2010.0,7,2,5
LBN,DEU,2014.0,2,3,-1
BEL,BEN,2006.0,4,1,3
JOR,ITA,2008.0,2,1,1
GEO,ITA,2012.0,1,3,-2
POL,NOR,2017.0,7,6,1
THA,PHL,2019.0,8,3,5
SWZ,USA,2016.0,5,5,0
USA,MUS,2005.0,1,1,0
MWI,USA,2004.0,3,3,0
NLD,ARG,2007.0,3,2,1
FRA,IDN,2007.0,7,3,4
CHE,SRB,2014.0,4,3,1
PRT,THA,2008.0,3,1,2
AUS,PHL,2009.0,7,9,-2
NPL,JPN,2021.0,4,14,-10
CZE,AUT,2006.0,11,6,5
HRV,ITA,2010.0,7,3,4
MAR,CAN,2012.0,5,15,-10
USA,EST,2012.0,4,10,-6
ZAF,GHA,2002.0,3,1,2
KAZ,RUS,1997.0,11,8,3
FRA,LUX,2003.0,10,4,6
JPN,ROU,2007.0,6,8,-2
ITA,HRV,2000.0,1,3,-2
UGA,ZAF,2002.0,1,3,-2
BRA,CRI,2014.0,5,3,2
FRA,ETH,2012.0,3,1,2
KEN,DEU,2003.0,6,4,2
GBR,ZWE,2022.0,9,8,1
AUT,HUN,2006.0,8,12,-4
TUR,CYP,2004.0,5,3,2
ZAF,CMR,2005.0,3,2,1
IND,NPL,2002.0,18,8,10
HUN,POL,2003.0,2,6,-4
TUR,ISR,2000.0,3,4,-1
DEU,PSE,2017.0,6,5,1
UKR,CZE,2006.0,3,3,0
GHA,CAN,2000.0,1,1,0
USA,ARM,1998.0,3,8,-5
ISR,GRC,2001.0,1,3,-2
SGP,CHE,2012.0,14,17,-3
COG,FRA,1999.0,4,3,1
ISR,BRA,2005.0,2,1,1
TUR,SVK,2011.0,1,1,0
NLD,BEN,2009.0,2,3,-1
ITA,MYS,2012.0,5,2,3
NLD,POL,2006.0,10,11,-1
JPN,KWT,2019.0,3,1,2
IRL,LUX,2013.0,3,1,2
IND,ZAF,2003.0,4,4,0
JPN,UKR,2016.0,8,3,5
CHL,BEL,2001.0,2,5,-3
HKG,TWN,1997.0,5,1,4
QAT,SDN,2011.0,2,1,1
BEL,PER,2022.0,3,3,0
UKR,MEX,2001.0,5,1,4
MAR,CMR,2021.0,2,3,-1
POL,FIN,2001.0,7,2,5
POL,CHN,2009.0,2,2,0
TZA,NLD,2021.0,5,5,0
AUT,NZL,2012.0,3,5,-2
COL,ARM,2014.0,1,1,0
VEN,MEX,2008.0,6,10,-4
NLD,SDN,2017.0,4,1,3
VEN,ECU,2011.0,1,1,0
NGA,JPN,2010.0,5,10,-5
JPN,MWI,2007.0,1,1,0
DZA,CAN,2010.0,3,2,1
FIN,ISR,2004.0,2,2,0
AFG,USA,2014.0,1,7,-6
UKR,CAN,2010.0,6,5,1
CAN,UKR,2013.0,3,5,-2
THA,NLD,2008.0,2,5,-3
JOR,ITA,2015.0,3,3,0
ISR,PSE,2003.0,12,1,11
CHE,ARG,2008.0,5,4,1
SAU,SYR,2014.0,1,5,-4
DEU,TWN,2003.0,6,8,-2
AUS,GRC,2007.0,9,5,4
CHL,JPN,2017.0,6,5,1
ESP,ISL,2012.0,1,2,-1
ZAF,DNK,2002.0,2,3,-1
BEN,SEN,2010.0,1,5,-4
KGZ,RUS,2005.0,1,1,0
LTU,POL,2006.0,4,1,3
ITA,IRQ,2017.0,1,1,0
CMR,ZAF,2010.0,5,5,0
FRA,COL,2010.0,20,13,7
ITA,THA,2007.0,1,1,0
MLT,GBR,2002.0,4,4,0
UGA,CHE,2019.0,3,3,0
CHE,UGA,2020.0,2,3,-1
BEL,BEN,2010.0,2,2,0
BWA,CHN,2015.0,1,1,0
TUR,AZE,2020.0,12,2,10
IRN,AUT,2007.0,3,2,1
KEN,ETH,2009.0,1,4,-3
IRL,ISR,2009.0,6,17,-11
NAM,ZAF,2009.0,1,5,-4
KWT,JOR,2012.0,2,2,0
GBR,CAN,2024.0,3,1,2
CAN,HUN,2015.0,7,16,-9
POL,AUT,1998.0,3,3,0
LTU,DNK,2010.0,3,1,2
BOL,BEL,2007.0,2,1,1
MWI,USA,2008.0,7,9,-2
TZA,NOR,2008.0,2,9,-7
BGD,SGP,2009.0,1,1,0
LKA,ZAF,2019.0,1,1,0
HKG,FIN,2010.0,2,1,1
MAR,USA,2012.0,5,8,-3
CZE,CAN,2016.0,13,12,1
MEX,PER,2005.0,3,1,2
LBN,CHE,2014.0,6,1,5
GRL,DNK,2009.0,5,6,-1
SGP,ESP,2010.0,3,6,-3
THA,BEL,2003.0,1,2,-1
SAU,NZL,2017.0,7,4,3
GBR,CMR,2011.0,4,4,0
NAM,ZWE,2019.0,1,2,-1
RUS,SRB,2007.0,2,10,-8
ROU,FIN,2017.0,1,1,0
FRA,MDG,2007.0,10,6,4
MOZ,AUS,2008.0,1,2,-1
SWE,SVK,2014.0,6,5,1
CZE,JPN,2017.0,13,9,4
BLR,USA,2020.0,3,4,-1
PER,FRA,2022.0,8,5,3
ARE,BHR,2017.0,3,3,0
IRQ,MYS,2011.0,4,17,-13
DNK,ISR,2014.0,4,2,2
GBR,EST,2019.0,13,10,3
FIN,CZE,2012.0,5,6,-1
ISR,IRL,2018.0,4,12,-8
IRL,ISR,2021.0,4,4,0
KOR,ISR,2009.0,3,1,2
CHN,HUN,2023.0,5,7,-2
CHL,AUS,2004.0,2,1,1
NIC,USA,2010.0,1,2,-1
SGP,NOR,2018.0,3,4,-1
POL,HUN,2012.0,2,3,-1
SWE,TZA,2009.0,5,3,2
ROU,BEL,2013.0,11,11,0
QAT,BRA,2013.0,1,1,0
DEU,SYR,2012.0,5,2,3
CAN,URY,2013.0,1,2,-1
CHE,HRV,2021.0,4,8,-4
ESP,NGA,2019.0,2,1,1
COL,ARM,2015.0,2,4,-2
SWE,NGA,2023.0,1,5,-4
FRA,SGP,1998.0,2,1,1
NPL,NLD,2022.0,2,2,0
IRL,PRT,2015.0,4,9,-5
CHL,ITA,2016.0,13,23,-10
ESP,TUN,2013.0,10,5,5
SVN,JPN,2017.0,2,1,1
JPN,SVN,2018.0,3,3,0
CHN,MNG,2012.0,7,1,6
DNK,GHA,2013.0,1,1,0
VNM,IRL,2017.0,1,2,-1
TUR,IRQ,2013.0,3,1,2
USA,BLR,2008.0,6,5,1
GBR,MAC,2022.0,5,1,4
NGA,BRA,2016.0,2,2,0
KOR,GHA,2017.0,2,1,1
MMR,CHE,2016.0,1,1,0
OMN,AUS,2015.0,6,5,1
TJK,IRN,2014.0,3,2,1
ARE,AUS,2011.0,4,10,-6
PHL,IND,2009.0,2,3,-1
CYP,USA,2000.0,3,6,-3
FRA,BGD,2011.0,1,3,-2
BHR,MYS,2021.0,1,5,-4
TWN,EGY,2016.0,4,2,2
BRA,ZAF,2016.0,2,3,-1
ZAF,BRA,2017.0,2,4,-2
CHE,MYS,2019.0,4,4,0
CZE,KOR,2020.0,3,6,-3
ITA,NGA,2021.0,4,5,-1
DNK,SAU,2021.0,4,2,2
CHN,FRA,2024.0,5,7,-2
COG,MAR,2021.0,2,1,1
SWE,NZL,2005.0,11,4,7
THA,SGP,2009.0,5,4,1
ESP,PER,2006.0,5,5,0
FJI,NZL,2005.0,2,2,0
SWE,BGD,2018.0,6,6,0
ESP,DNK,2008.0,15,19,-4
PSE,CAN,2021.0,3,1,2
FRA,COG,2020.0,2,3,-1
IRQ,CYP,2021.0,1,1,0
CZE,NOR,2017.0,6,6,0
SVK,SLV,2014.0,5,2,3
SVN,NLD,2001.0,3,3,0
TUR,AUS,2004.0,3,2,1
COL,MEX,2001.0,3,5,-2
PRT,IND,2019.0,13,15,-2
IRN,SDN,2018.0,1,1,0
CHE,LUX,2007.0,3,1,2
TWN,PAK,2023.0,6,7,-1
BRA,PRI,2021.0,2,5,-3
EGY,OMN,2021.0,7,11,-4
TUR,ESP,2013.0,8,10,-2
ISR,TUR,2022.0,3,1,2
NGA,CMR,2018.0,4,2,2
NOR,AUS,2001.0,4,3,1
IRL,IRN,2002.0,1,1,0
DZA,MAR,2018.0,3,4,-1
GMB,GHA,2021.0,1,1,0
PRY,ESP,2021.0,2,8,-6
ZWE,COG,2022.0,5,2,3
WSM,NZL,2021.0,3,3,0
CHN,LBN,2020.0,1,1,0
ARE,IRQ,2019.0,3,3,0
KOR,AUT,2016.0,6,4,2
ARE,IRQ,2021.0,3,4,-1
ROU,GBR,2004.0,13,10,3
PRT,RUS,2022.0,2,10,-8
ESP,SEN,2019.0,3,1,2
TUR,SRB,2014.0,10,3,7
COD,BEL,2021.0,10,18,-8
BFA,GHA,2010.0,1,1,0
UGA,FIN,2019.0,1,1,0
FIN,UGA,2020.0,2,1,1
THA,NPL,2019.0,7,4,3
AZE,USA,2019.0,7,1,6
SVK,USA,2023.0,5,2,3
SRB,HUN,2019.0,4,2,2
NLD,IRQ,2023.0,1,1,0
KAZ,DEU,2022.0,2,2,0
ETH,ITA,2023.0,3,1,2
PAK,SRB,2023.0,1,3,-2
CAN,PAK,2004.0,6,8,-2
PHL,IDN,2023.0,4,3,1
SLE,USA,2022.0,3,1,2
PSE,USA,2022.0,10,2,8
NPL,GBR,2017.0,12,7,5
GRC,FIN,2023.0,3,1,2
PAK,FRA,2022.0,11,13,-2
SAU,BHR,2021.0,9,9,0
TWN,IRN,2022.0,9,11,-2
CAN,LBN,2021.0,13,24,-11
PRT,FIN,2023.0,6,6,0
LTU,EST,2020.0,2,1,1
PRT,CHN,2023.0,10,18,-8
ETH,MEX,2022.0,1,1,0
KHM,FRA,2016.0,5,2,3
SAU,BGD,2023.0,6,6,0
DZA,IND,2021.0,1,1,0
GHA,NZL,2023.0,1,2,-1
LTU,POL,2023.0,4,4,0
VNM,IRL,2022.0,4,1,3
IDN,GBR,2002.0,9,5,4
ARG,NLD,2014.0,7,4,3
USA,GTM,2009.0,7,4,3
USA,MAR,2011.0,5,2,3
IDN,IND,2003.0,3,3,0
LKA,SGP,2018.0,1,3,-2
SRB,ITA,2004.0,10,8,2
ROU,GRC,2004.0,3,3,0
TUR,SWE,2007.0,4,4,0
GHA,NGA,2016.0,3,4,-1
POL,SVK,2000.0,5,4,1
NOR,POL,2010.0,6,11,-5
COL,JPN,2004.0,2,3,-1
ZAF,KEN,2013.0,19,15,4
ARE,IND,1997.0,1,1,0
ROU,RUS,2020.0,3,3,0
NLD,PHL,2014.0,1,5,-4
IDN,SWE,2001.0,2,2,0
CHL,COL,2006.0,4,4,0
ARM,DEU,2013.0,4,2,2
CZE,CAN,2017.0,7,16,-9
ZMB,GBR,2009.0,3,3,0
IND,LBN,2017.0,2,2,0
OMN,ZAF,2012.0,1,2,-1
LSO,SWZ,2018.0,1,1,0
ISL,NOR,2016.0,5,6,-1
FRA,CRI,2009.0,3,4,-1
ARG,BEL,2018.0,7,6,1
RUS,ZAF,2015.0,4,3,1
SAU,BHR,2011.0,3,4,-1
CHE,IRN,2005.0,2,3,-1
BGR,ITA,2019.0,2,8,-6
GRC,TUR,2012.0,7,4,3
BEL,ECU,2020.0,7,7,0
IRQ,LBY,2004.0,1,2,-1
DNK,LTU,2023.0,2,3,-1
TZA,DNK,1999.0,3,1,2
GHA,CHE,2002.0,3,2,1
SVK,FRA,2005.0,8,1,7
ARG,ITA,2001.0,15,12,3
SVN,TUR,2017.0,4,1,3
PSE,EGY,2023.0,3,1,2
EGY,TUN,2011.0,2,3,-1
LVA,USA,2010.0,6,5,1
BRA,PER,2006.0,6,1,5
TUR,BRA,2009.0,1,1,0
TUR,HKG,2009.0,2,1,1
PYF,FRA,1997.0,8,7,1
HUN,IRN,2008.0,2,1,1
ZMB,ZWE,2010.0,1,1,0
MEX,CHN,2016.0,4,4,0
PRI,DEU,2008.0,1,1,0
ZAF,ARG,2010.0,2,2,0
POL,ROU,1999.0,1,1,0
POL,SAU,2018.0,1,1,0
ZAF,BWA,2001.0,2,6,-4
BWA,ZAF,2003.0,2,6,-4
DZA,CAN,2006.0,2,1,1
ARE,LBN,2016.0,2,1,1
USA,BOL,2001.0,4,2,2
FIN,POL,2009.0,3,4,-1
SGP,BEL,2023.0,2,2,0
SEN,MLI,2010.0,3,2,1
ESP,TUR,2000.0,1,1,0
CHN,ISR,1997.0,2,3,-1
TWN,CHE,2016.0,4,5,-1
GRC,CHN,1999.0,1,1,0
PAK,CHE,2011.0,2,1,1
FRA,MYS,2004.0,1,1,0
NLD,ZAF,2014.0,20,25,-5
ISR,CHN,1998.0,3,9,-6
CHN,PHL,1998.0,1,6,-5
MDG,FRA,2002.0,8,11,-3
AUS,VNM,2007.0,7,3,4
CHN,ISR,2012.0,6,11,-5
JPN,MEX,2003.0,3,5,-2
ARE,GBR,2007.0,8,28,-20
GBR,NPL,2006.0,4,6,-2
LAO,GBR,2019.0,2,2,0
ROU,MDA,2023.0,1,4,-3
ZAF,TZA,2019.0,8,10,-2
UGA,NGA,2022.0,8,11,-3
MYS,AFG,2022.0,3,2,1
IRL,IRN,2012.0,8,9,-1
CZE,BEL,2014.0,8,12,-4
CAN,ARM,2011.0,1,3,-2
IND,MEX,2008.0,1,1,0
PHL,JPN,2004.0,10,19,-9
DEU,SDN,2015.0,4,4,0
AUT,BGR,2005.0,1,2,-1
SRB,CHE,2008.0,3,3,0
DNK,IRL,2006.0,6,3,3
URY,DEU,2014.0,1,3,-2
KOR,AUT,2017.0,11,4,7
FIN,JPN,2019.0,8,14,-6
NZL,BRA,2019.0,4,12,-8
ZMB,GBR,2019.0,10,7,3
IND,NGA,2020.0,14,12,2
BEL,HKG,2000.0,1,1,0
ROU,RUS,1998.0,1,5,-4
ESP,URY,2001.0,8,11,-3
SAU,ESP,2021.0,7,14,-7
PAK,EGY,2023.0,4,2,2
KOR,MYS,2012.0,7,12,-5
GEO,DEU,2022.0,2,4,-2
JPN,GHA,2007.0,1,1,0
BGR,BEL,2002.0,9,6,3
SVK,SLV,2008.0,4,3,1
PRT,UKR,2004.0,1,1,0
CZE,SWE,2001.0,3,8,-5
JPN,PAK,1997.0,3,5,-2
FIN,AUT,2001.0,3,6,-3
CAN,HUN,2004.0,5,10,-5
NZL,CHN,1999.0,1,3,-2
AUS,ARG,1997.0,1,1,0
JPN,ROU,1998.0,6,5,1
FRA,IRN,2004.0,15,3,12
FIN,IND,1997.0,1,1,0
FRA,COG,2007.0,11,2,9
ZAF,SAU,2007.0,1,4,-3
LTU,DEU,2007.0,9,12,-3
CHE,PAK,2020.0,11,4,7
OMN,PAK,2013.0,5,9,-4
HRV,USA,2016.0,14,29,-15
QAT,ITA,2015.0,2,8,-6
ARE,KWT,2014.0,2,3,-1
BEL,LTU,2014.0,1,1,0
MEX,VEN,2015.0,10,12,-2
SRB,SVN,2010.0,11,4,7
ISR,AUT,2019.0,3,3,0
ZMB,ZAF,2016.0,5,6,-1
FRA,SVK,2013.0,4,2,2
KWT,FRA,2021.0,2,5,-3
CHN,SDN,2015.0,5,6,-1
NZL,HKG,2019.0,3,9,-6
ZAF,ESP,2023.0,8,5,3
SVN,DEU,2017.0,10,8,2
SEN,CIV,2021.0,4,1,3
CHL,BOL,2017.0,5,1,4
IRQ,AUS,2022.0,5,26,-21
CHE,GHA,2020.0,4,2,2
DZA,SAU,2016.0,6,5,1
SRB,PAK,2023.0,3,1,2
PRK,CHN,2023.0,8,6,2
NGA,TUR,2020.0,4,8,-4
VNM,NOR,2023.0,2,1,1
EGY,LBY,2018.0,2,5,-3
BRA,PAK,2023.0,2,3,-1
CAN,UGA,2022.0,2,1,1
CRI,DEU,2023.0,4,3,1
HUN,ESP,2020.0,11,1,10
IDN,NZL,2022.0,6,3,3
LBY,IND,2001.0,3,3,0
KEN,USA,1998.0,12,13,-1
KOR,AUS,2003.0,10,16,-6
CAN,MYS,2001.0,4,5,-1
FIN,AUT,2004.0,2,2,0
TZA,GBR,2003.0,6,12,-6
FRA,PYF,1997.0,7,8,-1
CAN,BHR,2017.0,2,2,0
ARE,DNK,2018.0,3,4,-1
CHE,TZA,2010.0,2,1,1
SVK,SLV,2015.0,6,9,-3
SAU,CHE,2023.0,1,5,-4
ROU,FIN,2016.0,2,3,-1
NGA,IRN,2021.0,1,4,-3
MYS,PAK,2007.0,1,1,0
FRA,PER,2003.0,2,2,0
AUT,ISR,2008.0,5,2,3
IND,NGA,1999.0,1,1,0
DEU,SVN,1997.0,6,6,0
KOR,GHA,2016.0,2,1,1
ETH,DEU,2002.0,4,3,1
SVK,SRB,2001.0,2,2,0
GRC,CYP,2000.0,9,3,6
HUN,JPN,2016.0,3,8,-5
DNK,BRA,2004.0,2,1,1
USA,ZMB,2005.0,5,1,4
JPN,GHA,1998.0,5,1,4
AUT,CHN,2011.0,9,11,-2
KOR,GRC,2015.0,2,3,-1
TTO,USA,2011.0,10,9,1
NOR,NPL,2015.0,3,4,-1
MOZ,FRA,2022.0,2,1,1
ESP,PAK,2022.0,7,9,-2
ISR,JPN,2018.0,6,4,2
TUR,IND,2023.0,7,6,1
HRV,ESP,2018.0,4,9,-5
NOR,NLD,2014.0,13,39,-26
SVN,BEL,2023.0,3,1,2
FRA,PAK,2020.0,19,14,5
CHE,FIN,2015.0,10,24,-14
FIN,HUN,2016.0,7,5,2
SAU,KOR,2012.0,2,12,-10
GRC,CZE,2020.0,6,5,1
FRA,GAB,2020.0,15,4,11
IRN,TWN,2021.0,12,4,8
SWE,IRQ,2021.0,4,4,0
NLD,COL,2022.0,7,11,-4
VEN,GBR,2018.0,4,2,2
BOL,USA,2010.0,3,5,-2
IND,TZA,2014.0,4,1,3
LTU,EGY,2020.0,1,1,0
CAN,IDN,2003.0,2,1,1
RUS,ROU,2018.0,3,1,2
HRV,BRA,2007.0,1,1,0
MMR,USA,2013.0,3,1,2
MWI,BWA,2006.0,1,1,0
HRV,ITA,2000.0,3,1,2
PHL,DEU,2003.0,1,1,0
PRY,USA,2014.0,2,5,-3
FRA,EST,2012.0,1,1,0
OMN,AUS,2004.0,2,1,1
HKG,TUR,2021.0,2,2,0
EST,GRC,2008.0,1,1,0
SGP,KHM,2014.0,1,1,0
CHE,DNK,2005.0,7,13,-6
CAN,MUS,2002.0,1,1,0
PER,ITA,2010.0,1,1,0
ISL,PRT,2020.0,1,2,-1
SVN,JPN,2016.0,2,1,1
SYR,FRA,2019.0,2,10,-8
KHM,BRA,2021.0,1,1,0
TUR,CHE,2007.0,5,6,-1
JOR,PSE,2011.0,2,3,-1
ARG,AUS,2010.0,9,8,1
CZE,POL,2009.0,2,9,-7
MEX,SWE,2012.0,9,3,6
SVK,IRL,2012.0,2,2,0
FRA,ARG,2023.0,7,21,-14
USA,DZA,2004.0,5,1,4
ARE,NZL,2015.0,2,4,-2
USA,ZMB,2012.0,8,9,-1
TUR,SVN,2022.0,1,1,0
NIC,MEX,2008.0,2,1,1
BEL,COG,2009.0,3,4,-1
BRA,VEN,2005.0,7,4,3
JPN,IRL,2012.0,3,5,-2
JPN,UKR,2017.0,1,3,-2
JOR,MYS,2013.0,8,18,-10
BEL,PHL,2018.0,4,1,3
CUB,BRA,2006.0,8,4,4
VNM,ETH,2023.0,1,1,0
GRC,AUS,2020.0,6,6,0
MAR,BEL,2020.0,6,10,-4
SRB,NLD,2020.0,3,6,-3
HUN,NOR,2006.0,3,2,1
GRC,SAU,2023.0,3,2,1
IRN,AZE,2008.0,4,1,3
ALB,ITA,1998.0,2,2,0
COG,CHE,2018.0,3,2,1
MLI,FRA,2004.0,2,6,-4
NZL,DNK,2011.0,7,7,0
SYR,CAN,2010.0,4,1,3
KOR,NLD,2002.0,3,2,1
MEX,CHL,1999.0,4,5,-1
PAK,BHR,2023.0,5,1,4
BGD,MYS,2008.0,10,5,5
JPN,HKG,2002.0,8,10,-2
TTO,CAN,2015.0,2,1,1
RUS,SVN,2021.0,4,2,2
SWE,ZAF,2009.0,3,5,-2
SWE,CHE,2014.0,68,62,6
TUR,SRB,2013.0,3,2,1
SRB,GBR,2015.0,6,15,-9
CAN,DZA,2017.0,8,13,-5
ISR,RUS,2005.0,19,12,7
MEX,ECU,2017.0,16,9,7
AUT,ESP,2020.0,25,38,-13
MEX,AUT,2021.0,5,1,4
MEX,CHL,2007.0,11,6,5
GBR,UKR,2001.0,7,17,-10
IND,GHA,2021.0,8,2,6
GBR,JOR,2017.0,27,12,15
CAN,ECU,2017.0,3,1,2
BDI,BEL,2019.0,1,3,-2
SAU,ZAF,2017.0,14,11,3
ESP,IRL,2012.0,9,23,-14
FRA,COL,2011.0,17,10,7
HUN,NLD,2012.0,9,6,3
BRA,ARG,2020.0,45,36,9
SWE,THA,2004.0,3,6,-3
NOR,ISL,2023.0,5,5,0
COG,USA,2019.0,8,3,5
AUS,CHL,2013.0,7,23,-16
IRL,SWE,2007.0,3,7,-4
JPN,TUN,2018.0,6,1,5
DNK,IRL,2021.0,6,16,-10
GRC,SVN,2015.0,2,1,1
PRT,HUN,2008.0,1,6,-5
CHE,PHL,2009.0,2,2,0
CHE,LAO,2011.0,1,1,0
CHE,ESP,2007.0,43,23,20
ALB,SRB,2016.0,8,8,0
CUB,ITA,2012.0,7,3,4
SVK,UKR,2004.0,1,1,0
SVK,HUN,2001.0,2,2,0
AUT,RUS,2013.0,8,14,-6
GBR,GHA,2008.0,17,7,10
FRA,ZWE,2012.0,1,2,-1
GRC,ITA,2014.0,43,25,18
CHE,DZA,2007.0,1,1,0
GBR,UGA,2007.0,8,10,-2
AUT,UKR,2020.0,4,6,-2
CHE,KOR,2006.0,9,9,0
LUX,USA,2021.0,12,20,-8
IRL,SWE,2020.0,9,11,-2
NOR,ARG,2018.0,2,1,1
RWA,SWE,2017.0,4,2,2
GBR,NPL,2021.0,8,9,-1
VIR,USA,2022.0,9,12,-3
SWE,MYS,2018.0,6,2,4
ZWE,USA,2018.0,9,12,-3
CHE,BRA,2018.0,24,44,-20
LKA,JPN,2017.0,3,19,-16
ITA,ARE,2015.0,12,1,11
USA,NGA,2005.0,12,22,-10
CUB,DEU,2011.0,9,2,7
SVK,NLD,2000.0,4,3,1
JPN,IDN,2001.0,21,19,2
SGP,BEL,2019.0,9,7,2
NLD,ZAF,2013.0,21,16,5
NLD,KEN,2008.0,4,3,1
DEU,VEN,2004.0,2,5,-3
ZWE,USA,2017.0,6,19,-13
GRC,JPN,2018.0,2,2,0
MEX,ARG,1999.0,2,7,-5
CAN,TUR,2008.0,11,11,0
TUN,CAN,1997.0,3,1,2
BEL,JPN,2005.0,7,11,-4
SWE,SGP,2017.0,10,14,-4
NGA,DEU,2005.0,4,9,-5
EST,ESP,2002.0,1,2,-1
MAR,BEL,2002.0,9,2,7
GBR,KHM,2003.0,2,1,1
ARE,HUN,2019.0,4,1,3
BEL,BGR,2020.0,7,1,6
COG,FRA,2012.0,4,8,-4
ITA,GEO,2012.0,3,1,2
NZL,ZAF,2003.0,3,10,-7
ITA,BGR,1997.0,6,4,2
FRA,MLI,2008.0,4,11,-7
NLD,ARG,2012.0,6,6,0
USA,ASM,2013.0,3,1,2
DNK,ESP,1998.0,8,8,0
DNK,ARG,2003.0,2,2,0
LUX,AUT,2015.0,3,1,2
LUX,FRA,2007.0,10,26,-16
SVN,BEL,2011.0,2,5,-3
DNK,NZL,2006.0,4,4,0
RUS,IND,2023.0,12,14,-2
SWE,THA,2015.0,11,8,3
CAN,TWN,2015.0,15,15,0
SVN,CAN,2007.0,3,1,2
FIN,COL,2019.0,1,1,0
BRA,SGP,2016.0,3,1,2
CHE,ZAF,2016.0,14,23,-9
MEX,NZL,2012.0,3,1,2
ISL,DNK,2019.0,5,3,2
IND,NPL,2007.0,8,26,-18
ITA,DZA,2015.0,9,1,8
DNK,BGD,2012.0,1,4,-3
LBN,SAU,2012.0,6,3,3
VEN,DEU,2022.0,2,1,1
CAN,ARG,1999.0,5,16,-11
THA,TWN,2010.0,5,5,0
IND,CHN,2010.0,17,9,8
KOR,NZL,2012.0,2,3,-1
IRN,FIN,2015.0,13,4,9
PRI,BRA,2013.0,6,2,4
KOR,SWE,2014.0,10,8,2
CHN,AUT,2006.0,6,6,0
LUX,DEU,2019.0,17,45,-28
VNM,BEL,2016.0,7,11,-4
TUN,NLD,2021.0,1,2,-1
CZE,IND,2018.0,15,21,-6
SRB,HRV,2018.0,16,20,-4
CHE,ISR,2019.0,28,24,4
CHN,IRN,2020.0,19,83,-64
ESP,LTU,2019.0,4,4,0
MEX,CHL,2020.0,26,12,14
COL,NLD,2017.0,11,7,4
HUN,ESP,2012.0,11,5,6
EGY,BEL,2013.0,6,5,1
URY,ARG,2015.0,6,9,-3
CHL,ISR,2021.0,4,4,0
LKA,JPN,2018.0,12,12,0
BEL,CZE,2020.0,14,6,8
ESP,BOL,2010.0,2,2,0
VIR,USA,2018.0,7,4,3
NLD,TCD,2018.0,1,1,0
USA,CUB,2004.0,8,11,-3
MYS,CHE,2019.0,4,4,0
CHE,LAO,2021.0,2,1,1
CZE,PAK,2022.0,6,2,4
NZL,CZE,2016.0,2,1,1
MDA,RUS,2015.0,4,6,-2
GRC,EST,2016.0,2,1,1
CAN,MAR,2008.0,4,6,-2
SVN,HUN,2020.0,2,2,0
FRA,LUX,2015.0,31,18,13
IRN,ESP,2014.0,13,10,3
PRY,URY,2019.0,5,1,4
ECU,PRY,2021.0,1,1,0
VEN,DEU,2016.0,6,2,4
DNK,RUS,2017.0,6,6,0
CHL,SWE,2023.0,3,1,2
CHL,CHN,2022.0,6,6,0
MEX,GTM,2017.0,4,3,1
MYS,ZAF,2019.0,4,1,3
CYP,TWN,2021.0,1,1,0
PAK,AFG,2022.0,1,2,-1
IRL,CHN,2023.0,24,31,-7
NLD,IRL,2002.0,10,6,4
NLD,GRC,2004.0,17,6,11
BRA,ARG,1999.0,16,24,-8
AUS,IRN,1998.0,13,2,11
NGA,ITA,2005.0,1,3,-2
BLR,POL,2019.0,5,3,2
DEU,ETH,1998.0,4,2,2
FIN,BLR,2003.0,3,1,2
DOM,USA,2012.0,3,7,-4
GBR,PHL,2001.0,5,5,0
MEX,GBR,2009.0,36,39,-3
IRL,PRT,2003.0,3,2,1
CHE,BEL,2001.0,18,20,-2
JPN,GRC,2013.0,2,3,-1
USA,GRD,2006.0,3,2,1
BRA,SWE,2001.0,11,3,8
USA,GHA,2014.0,21,17,4
BGR,NLD,2003.0,2,7,-5
BRA,DNK,2005.0,2,2,0
HUN,FIN,2007.0,3,4,-1
CHE,NZL,2007.0,10,7,3
AUS,FIN,2008.0,5,13,-8
NGA,DEU,2012.0,7,8,-1
MEX,PER,2007.0,1,2,-1
FIN,ZAF,2006.0,3,2,1
BGR,RUS,2008.0,4,6,-2
SWE,ISR,2008.0,2,6,-4
VNM,DEU,2007.0,2,4,-2
DEU,VNM,2008.0,6,5,1
ROU,HUN,2008.0,5,11,-6
IND,SAU,2007.0,7,5,2
GTM,MEX,2006.0,4,1,3
AUS,UKR,2008.0,2,3,-1
SWE,IRL,2011.0,11,10,1
JPN,KEN,2002.0,7,6,1
ISL,ITA,2012.0,2,1,1
DEU,GEO,2008.0,7,4,3
GBR,MWI,2004.0,14,3,11
ECU,ESP,2003.0,1,6,-5
ARE,USA,2004.0,6,19,-13
RUS,JPN,2014.0,17,22,-5
CMR,DEU,2014.0,5,11,-6
ZAF,UGA,2012.0,6,5,1
THA,KOR,2011.0,5,4,1
TZA,USA,2008.0,10,5,5
COL,ITA,2012.0,3,6,-3
SRB,BEL,2016.0,7,4,3
FJI,IND,2017.0,4,6,-2
AZE,EGY,2015.0,2,2,0
GRD,USA,2016.0,12,6,6
AUS,ISL,2014.0,2,1,1
KHM,AUS,2013.0,1,3,-2
AUS,TWN,2004.0,9,7,2
PAN,JPN,2020.0,1,2,-1
PRT,AGO,2014.0,4,3,1
ETH,SWE,2019.0,3,4,-1
IND,BGD,2016.0,12,17,-5
SWE,KOR,2002.0,4,5,-1
IRL,PAK,2009.0,2,3,-1
PRT,ISR,2016.0,2,2,0
KEN,JPN,2022.0,3,10,-7
IRL,NLD,1997.0,6,11,-5
KOR,QAT,2019.0,3,1,2
FIN,ZAF,2023.0,1,3,-2
PSE,TUR,2019.0,1,6,-5
IRL,KOR,2023.0,4,2,2
PAK,NLD,2017.0,6,16,-10
LUX,NLD,2001.0,1,0,1
KEN,RWA,2004.0,3,0,3
RWA,,2008.0,2,0,2
,PSE,1996.0,21,0,21
BLR,CHN,2011.0,4,0,4
MCO,DEU,2013.0,2,0,2
NLD,AZE,2001.0,1,0,1
GBR,PAN,2001.0,3,0,3
,SUR,1995.0,6,0,6
SDN,DEU,2000.0,1,0,1
JPN,LVA,2015.0,1,0,1
BHR,,2003.0,13,0,13
PSE,UKR,2014.0,1,0,1
ISR,FIN,2000.0,2,0,2
MYS,MDA,2015.0,1,0,1
ARG,KEN,2000.0,1,0,1
AUT,MKD,1998.0,1,0,1
RUS,MKD,2003.0,2,0,2
FRO,,2005.0,1,0,1
CYM,USA,2001.0,2,0,2
PHL,LAO,2000.0,1,0,1
ARG,IND,2009.0,3,0,3
JPN,CHL,2006.0,4,0,4
NGA,SWE,2002.0,2,0,2
SVN,MNE,2008.0,3,0,3
CHE,BGR,2009.0,3,0,3
STP,BRA,2000.0,1,0,1
TTO,AUS,2012.0,2,0,2
UGA,ESP,2005.0,1,0,1
,MCO,1994.0,26,0,26
SVK,BRA,2016.0,1,0,1
BRA,SVK,2018.0,2,0,2
CUB,AUT,1999.0,1,0,1
ITA,VNM,1999.0,3,0,3
BOL,,2009.0,21,0,21
JOR,DZA,2018.0,1,0,1
HKG,SVK,2013.0,1,0,1
PER,KOR,2011.0,1,0,1
OMN,THA,2018.0,1,0,1
ESP,MYS,2018.0,7,0,7
,CYM,2003.0,3,0,3
CYM,,2016.0,6,0,6
SLV,,2019.0,18,0,18
JPN,AFG,2015.0,3,0,3
ARE,LTU,2023.0,1,0,1
IRN,POL,2018.0,7,0,7
,SWZ,2009.0,15,0,15
BLR,CZE,2016.0,2,0,2
BIH,SAU,2017.0,1,0,1
FRA,NAM,1998.0,1,0,1
NPL,,2004.0,14,0,14
BEL,BDI,2013.0,2,0,2
MRT,SAU,2015.0,1,0,1
FSM,GUM,2019.0,2,0,2
ARE,OMN,2002.0,5,0,5
PAK,HUN,2017.0,2,0,2
BGD,FJI,2016.0,2,0,2
TUR,ETH,2017.0,1,0,1
CHE,BFA,2020.0,1,0,1
GAB,CIV,2016.0,1,0,1
POL,IRQ,2019.0,6,0,6
PRT,TUN,2016.0,4,0,4
COM,SEN,2019.0,1,0,1
AUS,BRB,2023.0,1,0,1
MAR,PAK,2016.0,1,0,1
YEM,FJI,2023.0,1,0,1
BGR,NOR,2006.0,1,0,1
HUN,GRC,2006.0,2,0,2
USA,BHS,2019.0,3,0,3
GUF,,2018.0,6,0,6
SWE,PSE,2019.0,3,0,3
,TON,2014.0,2,0,2
RWA,,2015.0,11,0,11
EGY,PER,2022.0,3,0,3
JOR,SYR,1998.0,1,0,1
,SYR,1996.0,37,0,37
MLI,MYS,2009.0,4,0,4
DEU,CZE,2024.0,1,0,1
COG,,2010.0,21,0,21
BIH,ARE,2020.0,1,0,1
UKR,ARE,2021.0,1,0,1
MDG,,2012.0,31,0,31
,MKD,1999.0,65,0,65
NPL,BGD,2009.0,1,0,1
,BRN,2006.0,11,0,11
NLD,MDA,2008.0,1,0,1
NER,KEN,2007.0,1,0,1
MWI,DNK,2012.0,1,0,1
CMR,BRA,2016.0,1,0,1
NLD,SGP,1997.0,2,0,2
REU,MUS,2012.0,1,0,1
,COD,2002.0,11,0,11
NGA,COL,2009.0,1,0,1
COL,UGA,2014.0,1,0,1
UGA,BFA,2017.0,1,0,1
DEU,PSE,2012.0,5,0,5
PYF,USA,2007.0,1,0,1
USA,PYF,2009.0,3,0,3
AUT,VNM,2008.0,1,0,1
TGO,,2009.0,5,0,5
PSE,ARE,2019.0,2,0,2
UZB,,2010.0,54,0,54
MDA,NLD,2014.0,1,0,1
GLP,,2011.0,6,0,6
,TON,2004.0,4,0,4
CHL,ZAF,2006.0,2,0,2
BDI,,2021.0,13,0,13
IND,JOR,2008.0,2,0,2
GIN,,2010.0,7,0,7
IND,ARE,1999.0,3,0,3
IRQ,BRA,2007.0,1,0,1
,TZA,2000.0,66,0,66
TZA,ETH,2004.0,1,0,1
BWA,,2004.0,8,0,8
JOR,CYP,2000.0,2,0,2
JOR,NOR,2007.0,1,0,1
MLT,,2015.0,20,0,20
FRA,GUY,2004.0,1,0,1
JPN,ZAF,2013.0,4,0,4
MWI,NAM,2013.0,1,0,1
CAN,KWT,2004.0,5,0,5
IRL,ISL,2008.0,3,0,3
DNK,EGY,2012.0,2,0,2
SRB,DNK,2006.0,2,0,2
,KHM,2004.0,43,0,43
ARM,CHE,2011.0,1,0,1
SRB,BIH,2000.0,7,0,7
JPN,MAC,2018.0,1,0,1
SWE,ARM,2016.0,1,0,1
ARM,MDA,2019.0,1,0,1
HKG,GUM,2009.0,1,0,1
ITA,BEN,2000.0,1,0,1
BEN,MAR,2001.0,1,0,1
USA,SWZ,2008.0,1,0,1
ARG,SGP,2011.0,1,0,1
IND,NER,2023.0,2,0,2
AUS,HND,2008.0,1,0,1
BRA,LBN,2013.0,1,0,1
COL,GTM,1997.0,1,0,1
VEN,PAN,2012.0,2,0,2
PAK,SOM,2023.0,1,0,1
HRV,NZL,2014.0,1,0,1
,SYC,2014.0,7,0,7
SDN,AUS,2009.0,1,0,1
,WSM,2017.0,10,0,10
NGA,IRL,2022.0,2,0,2
DJI,,2019.0,3,0,3
,AGO,2014.0,14,0,14
FIN,PSE,2021.0,1,0,1
SGP,IDN,2007.0,3,0,3
LTU,KAZ,2017.0,5,0,5
NOR,AFG,2016.0,1,0,1
TWN,ESP,2020.0,5,0,5
ESP,IDN,2017.0,1,0,1
GNQ,USA,2023.0,1,0,1
VCT,,2023.0,4,0,4
MWI,SWZ,2018.0,2,0,2
DOM,,2020.0,36,0,36
DJI,KEN,2022.0,1,0,1
OMN,AUT,2023.0,2,0,2
FRA,IRQ,2019.0,12,0,12
FRA,BHR,2007.0,1,0,1
NLD,GUY,2000.0,1,0,1
COL,PAN,1999.0,1,0,1
SAU,SYR,2000.0,1,0,1
SYR,SAU,2002.0,1,0,1
ISR,ARE,2009.0,1,0,1
ERI,,2006.0,6,0,6
MRT,DEU,2017.0,1,0,1
URY,FRA,1997.0,1,0,1
HKG,HRV,2004.0,2,0,2
GEO,,2003.0,43,0,43
SRB,ARG,2004.0,1,0,1
ZWE,,2007.0,31,0,31
BGR,AUS,2006.0,3,0,3
ISL,ISR,2003.0,3,0,3
KHM,SGP,2011.0,1,0,1
ARM,ITA,2010.0,4,0,4
MDG,GIN,1998.0,1,0,1
REU,,2011.0,8,0,8
,BRB,1995.0,19,0,19
EST,JPN,2002.0,1,0,1
MKD,CZE,2002.0,1,0,1
LVA,GRC,1997.0,1,0,1
NLD,SRB,2005.0,7,0,7
ITA,ALB,2003.0,3,0,3
SWE,MLI,2000.0,1,0,1
EST,ITA,2000.0,1,0,1
,GMB,1995.0,30,0,30
LKA,PRT,2009.0,1,0,1
,GTM,1997.0,23,0,23
HUN,UKR,2013.0,2,0,2
BEL,HRV,1998.0,3,0,3
DZA,SAU,2002.0,3,0,3
COL,PAN,2007.0,2,0,2
,NCL,1998.0,11,0,11
,PNG,1999.0,22,0,22
USA,BEN,2012.0,3,0,3
AUS,LTU,1997.0,1,0,1
CRI,ITA,2009.0,3,0,3
HUN,CZE,2010.0,6,0,6
TJK,IRN,2000.0,1,0,1
AUT,NPL,2003.0,1,0,1
LBY,,2004.0,9,0,9
LBN,,1999.0,19,0,19
,MLT,1999.0,21,0,21
ARG,IRL,2009.0,1,0,1
LSO,,2017.0,9,0,9
MDG,,2002.0,14,0,14
MLI,GHA,2012.0,1,0,1
HRV,CAN,2004.0,1,0,1
AGO,,2012.0,4,0,4
ERI,KEN,2004.0,1,0,1
PSE,,1999.0,1,0,1
TZA,PNG,1999.0,2,0,2
,CAF,2000.0,8,0,8
ZMB,TZA,2005.0,1,0,1
MOZ,,2016.0,15,0,15
ITA,IRQ,2012.0,3,0,3
,DOM,2004.0,10,0,10
FLK,AUS,2021.0,1,0,1
BGR,NLD,2010.0,3,0,3
SWZ,,2015.0,5,0,5
USA,GIN,2005.0,3,0,3
CAF,GHA,2016.0,2,0,2
,UZB,2006.0,97,0,97
MYS,THA,2007.0,2,0,2
MYS,MAR,2014.0,3,0,3
SGP,CZE,2018.0,4,0,4
SRB,CHN,2017.0,1,0,1
GAB,,2017.0,26,0,26
JOR,FIN,2013.0,2,0,2
FIN,JOR,2019.0,1,0,1
ALB,,2011.0,6,0,6
NCL,NZL,2022.0,1,0,1
NOR,VNM,2010.0,1,0,1
ARM,CAN,2007.0,2,0,2
NCL,OMN,2012.0,1,0,1
QAT,CHN,2009.0,1,0,1
RUS,PRI,2006.0,1,0,1
,GIN,2006.0,10,0,10
NAM,USA,2006.0,2,0,2
DNK,LVA,2018.0,2,0,2
FRA,MYS,2024.0,1,0,1
CAF,USA,2004.0,1,0,1
FIN,NZL,2013.0,3,0,3
LBY,DZA,2017.0,1,0,1
NLD,UZB,2007.0,1,0,1
CYP,SWE,2018.0,1,0,1
BRA,KOR,2008.0,2,0,2
LBY,IND,2000.0,1,0,1
PNG,KHM,2015.0,2,0,2
BOL,ITA,2009.0,1,0,1
SAU,GRC,2010.0,1,0,1
SAU,JPN,2001.0,2,0,2
MAC,,2010.0,10,0,10
NGA,SEN,1999.0,1,0,1
KGZ,PAK,2015.0,1,0,1
JOR,TUN,2023.0,2,0,2
,MKD,1998.0,65,0,65
GBR,BRB,2009.0,2,0,2
FIN,PHL,2021.0,1,0,1
GAB,,2016.0,23,0,23
BGR,HRV,2013.0,2,0,2
,MDG,2009.0,87,0,87
MWI,BWA,2014.0,1,0,1
KHM,SWE,2018.0,1,0,1
BEL,ISL,2015.0,2,0,2
DEU,LBY,2010.0,6,0,6
HRV,BEL,2001.0,2,0,2
KOR,GEO,2016.0,1,0,1
MNE,,2014.0,9,0,9
VEN,CAN,2013.0,5,0,5
BEL,NPL,2014.0,1,0,1
AUS,GRL,2023.0,1,0,1
TUR,ARE,2006.0,1,0,1
DEU,MDG,2010.0,2,0,2
NOR,ZWE,2015.0,1,0,1
ATG,MEX,2012.0,1,0,1
SRB,JPN,2021.0,1,0,1
SWE,MWI,2019.0,2,0,2
NLD,SVN,2013.0,3,0,3
COM,,2015.0,2,0,2
ESP,CPV,2019.0,3,0,3
GUY,,2018.0,7,0,7
JPN,RWA,2017.0,1,0,1
TWN,BFA,2020.0,2,0,2
BRA,SEN,2014.0,1,0,1
ITA,CMR,2013.0,3,0,3
MEX,SVK,2017.0,1,0,1
,MUS,2002.0,12,0,12
ATG,,2022.0,3,0,3
ARM,POL,2017.0,1,0,1
BRA,BHS,2019.0,1,0,1
ROU,ALB,2014.0,1,0,1
VUT,GBR,2017.0,1,0,1
UKR,MDA,2016.0,1,0,1
LBN,KWT,2016.0,1,0,1
GUY,GBR,2016.0,2,0,2
,COM,2012.0,9,0,9
HUN,KAZ,2018.0,2,0,2
NGA,MLI,2014.0,8,0,8
ESP,AND,2013.0,4,0,4
VEN,FRA,2023.0,3,0,3
BHS,ESP,2022.0,1,0,1
KEN,LBR,2021.0,1,0,1
RUS,ECU,2014.0,1,0,1
MAR,ARE,2018.0,2,0,2
KEN,TCD,2016.0,1,0,1
TUR,HUN,2003.0,2,0,2
MNG,CHE,2016.0,1,0,1
SAU,MAR,2022.0,7,0,7
IRL,UKR,2012.0,1,0,1
,SLB,1994.0,5,0,5
NCL,,2008.0,6,0,6
NAM,,2007.0,12,0,12
BEN,CHN,2020.0,2,0,2
PRT,URY,2017.0,2,0,2
BGR,BEL,2022.0,2,0,2
MYS,BRN,2015.0,7,0,7
VIR,,2019.0,1,0,1
ROU,ETH,2021.0,1,0,1
AFG,PAK,2018.0,1,0,1
BRA,GRC,2020.0,4,0,4
CHN,PER,2019.0,3,0,3
EUE,ESP,2006.0,5,0,5
GRD,,2012.0,5,0,5
HUN,PSE,2001.0,1,0,1
FRA,NPL,2020.0,1,0,1
ESP,SLV,2003.0,4,0,4
CHN,HUN,2001.0,4,0,4
,TGO,2019.0,50,0,50
JPN,CIV,2021.0,1,0,1
SYC,ITA,2023.0,1,0,1
JPN,VNM,2024.0,1,0,1
ATG,ARE,2021.0,1,0,1
NER,NGA,2022.0,6,0,6
OMN,DZA,2021.0,1,0,1
COL,PAK,2021.0,1,0,1
NRU,USA,2021.0,1,0,1
MKD,USA,2003.0,3,0,3
MKD,,2026.0,9,0,9
,GIN,2010.0,13,0,13
FIN,MWI,2020.0,2,0,2
,COD,2012.0,21,0,21
LKA,EST,2022.0,2,0,2
TON,USA,2022.0,1,0,1
TZA,HKG,2017.0,1,0,1
IND,SYC,2017.0,1,0,1
PAN,GBR,2018.0,3,0,3
BGD,POL,2023.0,2,0,2
MYS,EST,2019.0,3,0,3
ARE,TWN,2023.0,2,0,2
AUS,SOM,2018.0,1,0,1
HKG,ISR,2021.0,4,0,4
CAF,TUN,2017.0,4,0,4
AUS,MMR,2018.0,1,0,1
,SWZ,1994.0,9,0,9
,GNQ,2019.0,11,0,11
NLD,NPL,2013.0,1,0,1
CAN,BFA,2022.0,3,0,3
MWI,FIN,2018.0,2,0,2
IRQ,IND,2024.0,1,0,1
BGR,SRB,2003.0,3,0,3
DEU,KAZ,2012.0,3,0,3
AZE,KAZ,2019.0,2,0,2
KOR,SAU,2009.0,1,0,1
FJI,PAK,2019.0,1,0,1
,AUT,2021.0,18,0,18
TUR,ALB,2020.0,2,0,2
THA,AFG,2019.0,2,0,2
COL,NOR,2019.0,3,0,3
BEN,MAR,2015.0,1,0,1
NGA,HUN,2023.0,1,0,1
AUT,EGY,2002.0,4,0,4
IDN,YEM,2022.0,1,0,1
SVK,ALB,2022.0,1,0,1
PER,DNK,2023.0,1,0,1
,ALB,2019.0,102,0,102
SWZ,LSO,2021.0,1,0,1
TUR,PAK,2004.0,1,0,1
VEN,BEL,2023.0,1,0,1
TGO,BFA,2021.0,1,0,1
SVN,ARM,2021.0,1,0,1
USA,BRB,2021.0,5,0,5
KIR,,2025.0,10,0,10
,GLP,2018.0,6,0,6
GBR,BRN,2023.0,2,0,2
,MCO,2019.0,10,0,10
TUR,DZA,2023.0,4,0,4
BRA,EGY,2021.0,1,0,1
,BTN,2006.0,6,0,6
CMR,,2000.0,11,0,11
QAT,SYR,2009.0,1,0,1
KAZ,POL,2000.0,1,0,1
TZA,,2003.0,18,0,18
BWA,ETH,2009.0,1,0,1
,TCD,1995.0,4,0,4
TCD,,2006.0,4,0,4
,AIA,2011.0,2,0,2
SYR,,2005.0,12,0,12
UGA,,2002.0,13,0,13
BTN,USA,2007.0,2,0,2
MMR,DNK,2000.0,1,0,1
MEX,PRI,1999.0,1,0,1
PHL,KOR,2004.0,3,0,3
MDG,,2005.0,12,0,12
ZWE,IDN,2000.0,1,0,1
LAO,LKA,2015.0,1,0,1
SEN,PRT,2002.0,1,0,1
KEN,BEN,2002.0,1,0,1
JPN,SDN,2005.0,3,0,3
MNE,,2008.0,2,0,2
IRQ,ARE,2005.0,1,0,1
ZAF,BEN,2011.0,1,0,1
MKD,MNE,2017.0,1,0,1
,AGO,1996.0,5,0,5
GBR,CIV,2003.0,1,0,1
,ZMB,1998.0,25,0,25
ITA,PRI,2018.0,1,0,1
NLD,MOZ,2007.0,1,0,1
NAM,CAN,2003.0,1,0,1
BEN,,2001.0,4,0,4
SYR,AUT,2012.0,1,0,1
ZMB,ZAF,2002.0,2,0,2
SRB,CHE,2000.0,3,0,3
ESP,GRD,2005.0,1,0,1
CZE,EGY,2008.0,6,0,6
PRI,ARG,2022.0,4,0,4
GIN,,2000.0,2,0,2
FRA,AZE,2003.0,1,0,1
GAB,DEU,2003.0,5,0,5
NCL,MEX,2015.0,1,0,1
MEX,HUN,2004.0,1,0,1
SWE,BRB,2021.0,1,0,1
CIV,USA,2002.0,5,0,5
SWE,BIH,2005.0,1,0,1
,PNG,1998.0,21,0,21
MNG,RUS,2004.0,1,0,1
POL,KGZ,1998.0,4,0,4
DZA,,2002.0,26,0,26
CIV,,1999.0,6,0,6
NLD,UGA,2006.0,1,0,1
BGD,AUT,2001.0,1,0,1
ZMB,GHA,2011.0,1,0,1
FRA,MWI,2007.0,1,0,1
CHN,KGZ,1998.0,1,0,1
NIC,,2003.0,4,0,4
MOZ,CRI,2009.0,1,0,1
BEN,CMR,1997.0,1,0,1
SLV,MEX,2003.0,1,0,1
SLV,,2011.0,3,0,3
TUN,DZA,2005.0,1,0,1
TUR,KWT,2015.0,2,0,2
IDN,PHL,2002.0,1,0,1
NGA,LKA,2019.0,1,0,1
QAT,,2011.0,32,0,32
SVN,CZE,2000.0,2,0,2
DZA,EGY,2007.0,2,0,2
JPN,BDI,1999.0,1,0,1
PRT,NGA,2017.0,2,0,2
ESP,KAZ,2006.0,1,0,1
CIV,NGA,2006.0,1,0,1
NGA,ZMB,2004.0,1,0,1
DEU,ISL,2003.0,2,0,2
SWE,SVK,2006.0,2,0,2
JPN,ISL,2015.0,2,0,2
PRT,BLR,2009.0,2,0,2
HUN,MEX,2017.0,1,0,1
PRY,,2014.0,10,0,10
MKD,CZE,2012.0,1,0,1
PRT,BLR,2011.0,2,0,2
COG,GBR,2007.0,1,0,1
PRT,EST,2012.0,1,0,1
AUS,BWA,2009.0,3,0,3
DNK,PRT,2007.0,4,0,4
MNG,,2017.0,29,0,29
PER,MYS,2015.0,5,0,5
SLV,BRA,2010.0,3,0,3
BRB,,2013.0,8,0,8
BLR,HKG,2007.0,1,0,1
HKG,PHL,2007.0,1,0,1
UGA,AUS,2009.0,1,0,1
BGR,DNK,2018.0,1,0,1
GBR,SEN,2004.0,1,0,1
FIN,GRD,2014.0,1,0,1
ARE,DZA,2000.0,1,0,1
CAN,UGA,2012.0,3,0,3
JPN,TON,2006.0,1,0,1
MNE,SVN,1998.0,1,0,1
ETH,ARE,2013.0,1,0,1
SVK,KEN,2006.0,1,0,1
MAR,ARE,2016.0,2,0,2
,SYC,2001.0,4,0,4
GBR,SYC,2018.0,2,0,2
,PSE,2001.0,21,0,21
DEU,URY,2001.0,2,0,2
SEN,CHE,2011.0,4,0,4
GRC,NPL,2010.0,1,0,1
UKR,PRT,2011.0,3,0,3
SVN,HUN,2022.0,1,0,1
GBR,LAO,2011.0,4,0,4
IRL,JOR,2018.0,1,0,1
SEN,CAN,2012.0,1,0,1
PRT,UKR,2010.0,2,0,2
PHL,NLD,2007.0,1,0,1
GTM,VEN,2015.0,1,0,1
HUN,QAT,2014.0,1,0,1
POL,DZA,2011.0,1,0,1
,REU,2007.0,11,0,11
JPN,MDA,2017.0,1,0,1
UGA,ARE,2021.0,1,0,1
,PNG,2007.0,16,0,16
SGP,LKA,2014.0,6,0,6
RUS,SAU,2015.0,2,0,2
COG,CAF,2013.0,1,0,1
SVN,IRN,2015.0,1,0,1
GHA,GRC,2017.0,1,0,1
ARG,SWE,2018.0,5,0,5
ZAF,BOL,2005.0,1,0,1
BRA,TUR,2018.0,3,0,3
SWE,UKR,2022.0,2,6,-4
AUS,JOR,2022.0,10,2,8
RUS,ITA,2009.0,22,21,1
SEN,CMR,2022.0,3,2,1
ITA,DZA,2023.0,2,2,0
KOR,THA,2009.0,5,2,3
AUT,SVK,2022.0,8,5,3
AUS,JOR,2016.0,9,6,3
FRA,URY,2010.0,2,8,-6
CAN,MYS,2019.0,12,34,-22
FRA,TGO,2014.0,6,1,5
RUS,CHN,2007.0,8,4,4
PAK,THA,2015.0,4,9,-5
THA,CAN,2007.0,10,19,-9
IRN,PRT,2015.0,13,2,11
SWE,CZE,2003.0,3,5,-2
GRC,NOR,2010.0,5,1,4
EGY,SWE,2017.0,6,4,2
IDN,NLD,2004.0,3,6,-3
MEX,DNK,2014.0,6,1,5
CAF,FRA,2002.0,3,3,0
KHM,USA,2012.0,8,4,4
POL,HRV,2017.0,1,2,-1
USA,NER,2015.0,3,4,-1
ECU,GBR,2023.0,1,3,-2
ESP,PRI,2002.0,1,4,-3
AUS,ECU,2002.0,3,1,2
CHN,YEM,2022.0,6,3,3
EGY,SYR,2021.0,2,4,-2
URY,AUS,2001.0,2,2,0
FRA,GEO,2002.0,1,1,0
EST,DEU,2010.0,6,6,0
ESP,CHL,1998.0,14,12,2
FRA,ARM,2004.0,2,2,0
TUR,ITA,2001.0,6,10,-4
JPN,PRY,2003.0,3,1,2
URY,ESP,2005.0,8,1,7
CZE,CHE,2004.0,10,8,2
PHL,IND,2014.0,6,4,2
DNK,SRB,2005.0,6,1,5
NGA,KWT,1998.0,1,3,-2
NOR,ITA,2000.0,4,3,1
RUS,SVK,2002.0,3,4,-1
ESP,TWN,2013.0,2,5,-3
NOR,HUN,2010.0,2,4,-2
NZL,DNK,2014.0,10,3,7
UZB,LKA,2011.0,1,2,-1
ROU,ESP,2012.0,8,9,-1
LVA,POL,2011.0,1,2,-1
THA,KOR,2003.0,3,1,2
CAN,UGA,2020.0,3,5,-2
AUT,SRB,2009.0,4,2,2
PRT,ZAF,2021.0,4,5,-1
HUN,PRT,2016.0,2,3,-1
BEL,NZL,2013.0,4,4,0
MYS,PSE,2013.0,4,1,3
NZL,IRL,2019.0,7,9,-2
SWE,ARE,2016.0,4,3,1
GRC,ZAF,2018.0,3,1,2
CRI,USA,1998.0,19,10,9
MAC,HKG,2017.0,3,17,-14
LBN,AUS,2011.0,1,1,0
IRQ,SWE,2020.0,3,4,-1
PAK,ARE,2013.0,7,1,6
AZE,IRN,2020.0,4,5,-1
POL,ZAF,2022.0,2,5,-3
ESP,CRI,2001.0,2,3,-1
POL,FIN,2021.0,8,11,-3
IRN,SGP,2018.0,11,3,8
UGA,GBR,2016.0,68,14,54
ALB,ITA,2017.0,4,8,-4
PER,MEX,2005.0,1,3,-2
CIV,BFA,2023.0,2,1,1
ETH,BEL,2021.0,14,20,-6
EST,AUS,2017.0,1,3,-2
SRB,ITA,2019.0,5,7,-2
GBR,SVK,2016.0,6,3,3
JPN,BGR,2020.0,2,5,-3
USA,VEN,2023.0,6,6,0
KWT,FIN,2000.0,1,1,0
HRV,CHE,2023.0,6,1,5
SAU,IRQ,2022.0,6,3,3
IND,TTO,2014.0,4,1,3
SWE,BGD,2007.0,2,1,1
NZL,ARG,2007.0,1,1,0
ARE,BRA,2022.0,6,6,0
GBR,TZA,2007.0,6,11,-5
IND,NZL,2010.0,9,3,6
CAN,NOR,2006.0,19,8,11
BGD,USA,1997.0,8,7,1
DEU,BLR,2022.0,3,3,0
PHL,ESP,2010.0,2,2,0
DEU,AZE,2011.0,2,1,1
MNG,CHN,2013.0,7,4,3
TWN,TUR,2021.0,3,5,-2
CAN,JOR,2006.0,4,1,3
EGY,SGP,2021.0,5,2,3
SRB,MKD,2022.0,6,8,-2
ARE,QAT,2023.0,4,4,0
AUT,NLD,2005.0,6,6,0
EST,GBR,2002.0,2,1,1
JAM,GBR,2002.0,6,2,4
BRA,SWE,2000.0,4,3,1
BRB,USA,2019.0,3,8,-5
POL,AUS,2003.0,2,7,-5
TUR,CAN,2004.0,14,10,4
AUS,CZE,2009.0,5,7,-2
HRV,ESP,1998.0,2,1,1
SWE,ROU,2001.0,2,2,0
BRA,BOL,2020.0,5,1,4
USA,BRB,2006.0,2,1,1
CAN,BRB,1998.0,1,1,0
SWE,EST,1999.0,8,4,4
HRV,SVN,1999.0,1,7,-6
CAN,MYS,2009.0,7,5,2
MAR,SAU,2011.0,6,3,3
QAT,IND,2019.0,7,18,-11
HKG,MYS,2013.0,4,2,2
NGA,DEU,2018.0,7,6,1
NCL,AUS,2011.0,1,1,0
KEN,BEL,2019.0,5,5,0
GHA,ZAF,2011.0,5,8,-3
GBR,AZE,2016.0,3,1,2
KOR,CHL,2019.0,5,4,1
KAZ,USA,2012.0,5,12,-7
BHS,USA,2015.0,2,4,-2
GBR,BGR,2006.0,10,8,2
IRN,RUS,2011.0,2,3,-1
LUX,DEU,2003.0,11,5,6
CYP,PAK,2021.0,2,1,1
SVK,BEL,2007.0,3,4,-1
NGA,IND,2006.0,8,2,6
NZL,IDN,2009.0,2,1,1
URY,BRA,2003.0,3,3,0
HKG,IND,2000.0,3,10,-7
OMN,GBR,2007.0,7,16,-9
GBR,MMR,2020.0,2,3,-1
IRL,PRT,2009.0,3,6,-3
GRL,DNK,2008.0,6,8,-2
ZAF,IRL,2004.0,3,6,-3
PHL,IND,2004.0,3,1,2
SRB,ITA,2009.0,8,5,3
GUF,FRA,1999.0,7,3,4
BGR,ESP,1997.0,3,5,-2
NGA,KOR,2015.0,2,1,1
DNK,UKR,2006.0,3,1,2
GRC,IRL,2003.0,1,4,-3
ARE,KWT,2019.0,5,3,2
USA,FSM,2003.0,1,1,0
FRA,NZL,2010.0,13,13,0
NLD,KEN,2010.0,6,7,-1
TWN,ITA,2016.0,3,6,-3
ISR,NZL,2020.0,2,1,1
GRC,AUT,2005.0,2,2,0
DNK,GRL,2014.0,3,6,-3
AUS,BWA,2023.0,3,1,2
SWE,ARG,2020.0,5,6,-1
TUN,BHR,2011.0,2,1,1
ZAF,ETH,2007.0,9,2,7
EGY,LBY,2020.0,7,3,4
ZWE,DEU,2013.0,1,1,0
NZL,HKG,2015.0,1,10,-9
ARM,USA,2012.0,5,4,1
BGD,NLD,2004.0,1,1,0
ISR,ITA,2020.0,19,21,-2
BHR,IND,2023.0,3,4,-1
PHL,BEL,2019.0,4,4,0
TUR,KAZ,2022.0,11,7,4
MYS,CAN,2002.0,2,1,1
GRC,UKR,2002.0,4,3,1
FLK,ZAF,2015.0,1,1,0
GBR,CMR,2008.0,4,1,3
MEX,BRA,2003.0,6,7,-1
SGP,NZL,1999.0,1,5,-4
GBR,BRB,2010.0,2,2,0
ETH,GBR,2009.0,5,7,-2
CHE,ZAF,2005.0,9,7,2
SDN,SAU,2009.0,2,4,-2
AUS,PHL,2008.0,9,5,4
KEN,JPN,1997.0,1,1,0
ETH,ZAF,2004.0,3,2,1
VEN,COL,2001.0,7,4,3
CHN,THA,2005.0,3,2,1
CHE,TWN,2002.0,3,2,1
AUS,IDN,1998.0,8,3,5
OMN,EGY,1997.0,5,1,4
NOR,ETH,2002.0,2,3,-1
PER,IDN,2021.0,1,3,-2
NZL,DNK,2015.0,5,2,3
CAN,COL,1997.0,2,2,0
ROU,BEL,2010.0,6,16,-10
BEL,IRL,2013.0,5,8,-3
BEL,DNK,2005.0,6,6,0
TUN,MAR,2008.0,3,2,1
EST,GBR,2005.0,2,7,-5
IRN,FIN,2010.0,5,4,1
PAN,CAN,2010.0,2,3,-1
GBR,BHR,2009.0,5,1,4
JPN,KHM,2013.0,2,0,2
PSE,SWE,2021.0,1,0,1
ETH,LBY,2023.0,1,0,1
CUB,ETH,2016.0,1,0,1
KHM,NLD,2023.0,1,0,1
GRC,CRI,2020.0,1,0,1
DNK,USA,2024.0,1,0,1
,COM,2016.0,7,0,7
ESP,SDN,2020.0,1,0,1
ETH,CIV,2022.0,1,0,1
CUB,PER,2020.0,4,0,4
MEX,NZL,2020.0,4,0,4
ITA,COM,2019.0,1,0,1
CCK,NZL,2019.0,1,0,1
IRN,ITA,2024.0,1,0,1
TUN,FIN,2023.0,1,0,1
SLE,ECU,2020.0,1,0,1
,HTI,2019.0,19,0,19
HRV,DNK,2023.0,1,0,1
,LAO,2020.0,16,0,16
PAK,OMN,2011.0,4,0,4
JPN,UZB,2022.0,2,0,2
AUT,VNM,2023.0,5,0,5
,GMB,2020.0,14,0,14
LTU,ESP,2023.0,1,0,1
,ATG,2019.0,2,0,2
EUE,MLT,2021.0,2,0,2
IRL,HUN,2001.0,2,0,2
IND,CZE,2004.0,1,0,1
IRL,EGY,2009.0,1,0,1
IRL,EGY,2011.0,2,0,2
IRL,GLP,2016.0,1,0,1
DEU,MCO,2004.0,1,0,1
KWT,LBN,1997.0,1,0,1
CHE,LKA,2020.0,3,0,3
SMR,ITA,2009.0,1,0,1
IRN,IRL,2008.0,2,0,2
ISR,COL,2012.0,2,0,2
MNG,CHN,2006.0,1,0,1
BGR,MLT,2020.0,1,0,1
DEU,MWI,2011.0,3,0,3
CHN,GIN,2021.0,3,0,3
ESP,MOZ,2008.0,2,0,2
AUT,TZA,2010.0,1,0,1
USA,CCK,2009.0,1,0,1
BEL,SVK,2018.0,4,0,4
TWN,BLZ,2017.0,1,0,1
HKG,IRL,2009.0,4,0,4
PAK,ARE,2006.0,2,0,2
TUR,ARE,2008.0,3,0,3
JPN,COD,2014.0,1,0,1
FRA,DOM,2018.0,2,0,2
LKA,SGP,2016.0,2,0,2
JOR,BHR,2015.0,2,0,2
,GNB,2004.0,4,0,4
CAN,EST,2013.0,4,0,4
MEX,IDN,2015.0,2,0,2
SLV,ESP,2015.0,1,0,1
MKD,SVN,2019.0,3,0,3
NLD,LTU,2021.0,2,0,2
MAC,THA,2019.0,1,0,1
HUN,KOR,2005.0,2,0,2
NPL,DNK,2020.0,2,0,2
CZE,IDN,2020.0,3,0,3
,GRL,2012.0,7,0,7
BRN,NLD,2005.0,1,0,1
,LCA,2012.0,1,0,1
MAC,,2015.0,20,0,20
CHN,IDN,2008.0,3,0,3
,WSM,2012.0,12,0,12
SGP,KHM,2015.0,1,0,1
SVK,CHN,2023.0,2,0,2
CAN,BWA,2000.0,2,0,2
COG,CHE,2016.0,2,0,2
SEN,CAF,2016.0,2,0,2
NZL,CHL,2003.0,3,0,3
POL,BHR,2023.0,1,0,1
,FRO,2012.0,7,0,7
FRO,,2017.0,2,0,2
PHL,ARE,2017.0,1,0,1
MAR,BGR,2014.0,2,0,2
TUR,ISL,2023.0,2,0,2
SWE,JOR,2020.0,2,0,2
DNK,TWN,2000.0,2,0,2
BGD,CAN,1998.0,4,0,4
ECU,GBR,2003.0,3,0,3
IRL,TUR,2000.0,1,0,1
OMN,JPN,2001.0,1,0,1
FIN,SYC,2002.0,1,0,1
,CYM,2011.0,2,0,2
GLP,,2013.0,12,0,12
FIN,BOL,2013.0,1,0,1
IND,CYM,2011.0,2,0,2
CHN,DZA,2018.0,4,0,4
GEO,UKR,2020.0,1,0,1
MMR,PAN,2022.0,1,0,1
,NER,2019.0,31,0,31
,ZWE,2020.0,91,0,91
THA,CRI,2022.0,1,0,1
,MDV,2019.0,15,0,15
PAK,JOR,2017.0,1,0,1
MEX,NGA,2022.0,3,0,3
ETH,TGO,2022.0,1,0,1
MKD,FRA,2005.0,2,0,2
BGD,UGA,2003.0,1,0,1
LBN,LBY,2003.0,2,0,2
MCO,SEN,2007.0,1,0,1
ETH,NLD,2006.0,2,0,2
MDA,FIN,2003.0,1,0,1
FRO,,2022.0,7,0,7
ZAF,FJI,1998.0,1,0,1
HUN,IND,2006.0,1,0,1
COL,KEN,2006.0,2,0,2
FIN,BGR,2006.0,2,0,2
ARG,SLV,2006.0,1,0,1
JPN,AZE,2000.0,1,0,1
AZE,GBR,2009.0,2,0,2
JPN,PRY,2006.0,1,0,1
DNK,ZMB,2001.0,1,0,1
SAU,BRA,2008.0,1,0,1
MKD,KWT,2011.0,1,0,1
JPN,ARM,2006.0,1,0,1
USA,NAM,2001.0,1,0,1
IRN,IND,1998.0,4,0,4
ZWE,MWI,2004.0,2,0,2
LTU,ISR,1999.0,1,0,1
GHA,CHE,1997.0,2,0,2
THA,KOR,2000.0,2,0,2
ISR,MKD,2012.0,1,0,1
UKR,AUS,2000.0,2,0,2
MYS,URY,2016.0,1,0,1
NLD,VNM,2003.0,3,0,3
BLR,HUN,1997.0,1,0,1
ITA,SAU,1999.0,1,0,1
DNK,KEN,2003.0,9,0,9
BEL,GAB,2005.0,3,0,3
MDG,DNK,2010.0,1,0,1
BLR,LVA,2001.0,1,0,1
NER,GBR,2011.0,1,0,1
MYS,TZA,2018.0,4,0,4
ITA,JOR,1998.0,2,0,2
DEU,LAO,2003.0,1,0,1
LAO,PHL,2004.0,1,0,1
HRV,ISR,2003.0,1,0,1
PRI,GBR,2000.0,4,0,4
NOR,FRA,2024.0,1,0,1
UZB,USA,2018.0,4,0,4
PSE,FIN,2014.0,1,0,1
PSE,ROU,2020.0,1,0,1
KEN,FRA,1999.0,2,0,2
AUT,GRL,2013.0,1,0,1
GRC,ARM,2000.0,2,0,2
GBR,NAM,2002.0,1,0,1
CUB,CAN,2005.0,3,0,3
SAU,BRN,2002.0,1,0,1
AUS,PAN,2000.0,1,0,1
PAN,AUS,2015.0,4,0,4
LKA,MAR,2018.0,1,0,1
GRC,HRV,2015.0,1,0,1
NGA,KOR,2009.0,3,0,3
LKA,UZB,2009.0,1,0,1
FIN,GEO,2021.0,1,0,1
,GIN,2004.0,20,0,20
GIN,GNQ,2007.0,1,0,1
LVA,AUS,2013.0,2,0,2
TTO,KOR,2013.0,1,0,1
MLI,ZAF,2014.0,1,0,1
ARM,ARG,2020.0,1,0,1
,GRD,2007.0,10,0,10
GBR,COM,2012.0,1,0,1
WSM,,2014.0,3,0,3
AUT,NPL,2009.0,2,0,2
USA,CPV,2015.0,1,0,1
GBR,LSO,2014.0,1,0,1
ZAF,HKG,2010.0,1,0,1
ARG,THA,2018.0,7,0,7
CAN,NPL,2013.0,2,0,2
AUS,MLT,2021.0,1,0,1
LTU,BEL,2010.0,1,0,1
COD,IND,2010.0,1,0,1
AUT,GEO,2014.0,1,0,1
IRL,URY,2013.0,1,0,1
MNG,RUS,2006.0,1,0,1
JOR,RUS,2010.0,1,0,1
RUS,SVN,2023.0,3,0,3
MHL,USA,2010.0,2,0,2
LVA,FIN,2020.0,4,0,4
SGP,ECU,2019.0,2,0,2
MLI,CHE,2018.0,1,0,1
PRT,VEN,2010.0,4,0,4
FRA,YEM,2013.0,2,0,2
KAZ,CZE,2013.0,1,0,1
KOR,CHL,2014.0,5,0,5
SGP,ZAF,2017.0,1,0,1
NLD,LUX,1999.0,1,0,1
BMU,NZL,2013.0,1,0,1
PRT,ARG,2023.0,1,0,1
SWE,GTM,2022.0,1,0,1
BRN,IDN,2015.0,1,0,1
AZE,UKR,2018.0,1,0,1
IND,VEN,2017.0,1,0,1
KOR,ZWE,2019.0,5,0,5
CYP,PSE,2017.0,1,0,1
,HTI,2009.0,22,0,22
GUF,CZE,2017.0,1,0,1
CZE,CYP,2018.0,1,0,1
AUT,PSE,2020.0,1,0,1
AUS,FJI,2024.0,1,0,1
GBR,KGZ,2010.0,1,0,1
TUR,AFG,2017.0,1,0,1
CHN,SVK,2019.0,1,0,1
SWZ,TWN,2013.0,1,0,1
KGZ,GEO,2021.0,2,0,2
MLT,NLD,2022.0,2,0,2
LAO,KOR,2016.0,1,0,1
CHL,CRI,2019.0,7,0,7
IRN,NGA,2018.0,2,0,2
DNK,MOZ,2019.0,1,0,1
TUN,COG,2020.0,1,0,1
BEL,SEN,2004.0,1,0,1
GIN,CIV,2018.0,2,0,2
GBR,KNA,2016.0,1,0,1
FIN,CMR,2021.0,3,0,3
BFA,GAB,2015.0,2,0,2
VNM,PAK,2024.0,1,0,1
AUT,GHA,2019.0,1,0,1
TZA,NZL,2018.0,2,0,2
UGA,NAM,2014.0,1,0,1
TUR,IDN,2017.0,3,0,3
,PLW,2004.0,2,0,2
KGZ,UZB,2020.0,2,0,2
KOR,ECU,2023.0,3,0,3
GBR,DOM,2020.0,2,0,2
QAT,ECU,2017.0,2,0,2
HUN,MLT,2019.0,1,0,1
IDN,PSE,2023.0,1,0,1
CHL,CUB,1998.0,2,0,2
SDN,SSD,2023.0,1,0,1
PAN,ITA,2017.0,2,0,2
FJI,MHL,2018.0,2,0,2
POL,BGD,2022.0,2,0,2
POL,SVN,2019.0,4,0,4
TZA,AUT,2022.0,1,0,1
COL,PHL,2020.0,1,0,1
JOR,ISL,2021.0,1,0,1
,TCD,2020.0,20,0,20
BLR,KOR,2022.0,1,0,1
GBR,FLK,1997.0,2,0,2
NGA,ZWE,2012.0,1,0,1
,FRO,1997.0,1,0,1
MWI,NZL,2001.0,2,0,2
THA,BRA,2000.0,3,0,3
ZAF,FIN,2009.0,1,0,1
,DOM,2000.0,5,0,5
,PAN,1999.0,13,0,13
PAN,JPN,2002.0,1,0,1
PAN,FRA,1997.0,2,0,2
EGY,ZAF,1999.0,1,0,1
PAK,EGY,2000.0,1,0,1
CYP,,2001.0,10,0,10
JPN,ARG,2006.0,6,0,6
BHR,CAN,1999.0,2,0,2
LKA,AUS,1997.0,2,0,2
NIC,ECU,1999.0,1,0,1
MYS,CHE,2000.0,1,0,1
ESP,PRY,2015.0,4,0,4
PRI,CAN,2017.0,1,0,1
NIC,,2009.0,15,0,15
IND,EGY,1999.0,2,0,2
GRD,DEU,2014.0,1,0,1
NZL,FIN,2005.0,1,0,1
GBR,NAM,1997.0,2,0,2
HKG,PAK,2003.0,1,0,1
VNM,EST,2015.0,1,0,1
ERI,ETH,2010.0,1,0,1
BLZ,,2015.0,2,0,2
BHR,ARE,2015.0,3,0,3
CHE,SAU,2010.0,3,0,3
GBR,MNG,2017.0,2,0,2
GAB,,2002.0,4,0,4
ZWE,UGA,2022.0,2,0,2
PRY,,2000.0,4,0,4
ROU,SWE,2006.0,5,0,5
KOR,MYS,2002.0,1,0,1
PRY,CAN,2014.0,1,0,1
CRI,IRQ,2018.0,1,0,1
IRQ,CRI,2020.0,1,0,1
KAZ,CHE,2022.0,1,0,1
VNM,EGY,2021.0,1,0,1
GTM,ITA,2022.0,2,0,2
ETH,IRL,2023.0,2,0,2
,GIN,1996.0,4,0,4
CHN,SAU,2010.0,11,0,11
MKD,SVN,2021.0,2,0,2
ESP,GEO,2002.0,1,0,1
GEO,ESP,2003.0,1,0,1
GBR,KHM,2004.0,4,0,4
MAC,,2001.0,1,0,1
ROU,AUS,1999.0,1,0,1
MEX,POL,2008.0,2,0,2
MEX,TUR,2006.0,3,0,3
TUN,AUT,1998.0,1,0,1
SVK,NOR,2007.0,2,0,2
NLD,JOR,2013.0,4,0,4
TZA,FJI,2000.0,1,0,1
ECU,BRA,1998.0,1,0,1
MDG,GLP,2022.0,1,0,1
KEN,OMN,2021.0,1,0,1
ITA,MLT,2010.0,1,0,1
PER,NLD,2003.0,2,0,2
NGA,JPN,2000.0,2,0,2
NGA,BFA,2002.0,4,0,4
ESP,IRL,1998.0,5,0,5
VEN,THA,2021.0,1,0,1
JPN,ISL,2000.0,1,0,1
SDN,,2000.0,14,0,14
GEO,ISR,1997.0,1,0,1
MRT,DEU,2002.0,2,0,2
NGA,TUN,1999.0,1,0,1
GIB,,2025.0,13,0,13
PLW,USA,2008.0,1,0,1
CZE,EST,2009.0,1,0,1
NGA,RUS,2002.0,1,0,1
NLD,THA,1999.0,1,0,1
BGD,KOR,2001.0,3,0,3
ARM,GBR,1997.0,1,0,1
CHN,ROU,2011.0,2,0,2
ZMB,USA,1998.0,1,0,1
ZMB,,2009.0,12,0,12
CZE,EST,2011.0,1,0,1
SVK,FIN,2002.0,2,0,2
AUS,OMN,1997.0,1,0,1
GIN,GNB,2017.0,3,0,3
RUS,SGP,2021.0,6,0,6
BFA,MDG,2002.0,1,0,1
JPN,MAR,2007.0,1,0,1
HKG,AUT,1998.0,1,0,1
VEN,CUB,2010.0,3,0,3
,GAB,1998.0,16,0,16
MNE,BIH,2018.0,3,0,3
JPN,EST,2008.0,2,0,2
DNK,CZE,2007.0,2,0,2
GAB,,2012.0,9,0,9
DEU,TZA,2005.0,2,0,2
TUR,FJI,2010.0,1,0,1
SWE,LUX,2017.0,4,0,4
FRA,PAN,2007.0,1,0,1
CYP,PSE,2016.0,1,0,1
NGA,IRL,2012.0,2,0,2
SGP,UGA,2013.0,1,0,1
LTU,IRL,2011.0,2,0,2
MAC,IND,2013.0,2,0,2
BRN,BFA,2012.0,1,0,1
PAK,TZA,2010.0,1,0,1
SLV,CHL,2015.0,1,0,1
IRQ,MYS,2009.0,3,0,3
TUR,HUN,2011.0,3,0,3
VNM,TTO,2012.0,1,0,1
QAT,NZL,2010.0,1,0,1
TJK,,2013.0,9,0,9
SVK,CAN,2014.0,5,0,5
SAU,ERI,2002.0,1,0,1
FIN,LTU,2016.0,3,0,3
,SUR,2007.0,2,0,2
NOR,ROU,2014.0,1,0,1
TLS,MYS,2020.0,1,0,1
DEU,HUN,2024.0,1,0,1
SYR,IRQ,2020.0,1,0,1
AUT,ETH,2010.0,4,0,4
CMR,SVN,2023.0,1,0,1
TCD,,2015.0,5,0,5
SWE,GRL,2016.0,1,0,1
ALB,DZA,2019.0,1,0,1
SGP,QAT,2012.0,2,0,2
,TKM,2010.0,2,0,2
TKM,KAZ,2013.0,2,0,2
ESP,CYP,2021.0,2,0,2
PRT,AGO,2013.0,6,0,6
UKR,CHN,2009.0,1,0,1
TCD,GBR,2015.0,5,0,5
DOM,MEX,2023.0,3,0,3
BFA,,2015.0,37,0,37
ESP,GRD,2018.0,2,0,2
URY,ITA,2018.0,2,0,2
PAK,CHE,2009.0,2,0,2
THA,CZE,2013.0,1,0,1
BEL,KHM,2009.0,2,0,2
TUR,NOR,1997.0,1,0,1
NOR,TUR,1998.0,1,0,1
EGY,RUS,1999.0,3,0,3
USA,SOM,2019.0,1,0,1
KOR,JOR,2016.0,2,0,2
UKR,LVA,2018.0,1,0,1
BFA,NGA,2023.0,1,0,1
NOR,FRO,2022.0,1,0,1
YEM,DEU,2021.0,4,0,4
CHE,BGD,2015.0,1,0,1
TCD,,2004.0,1,0,1
ZAF,AGO,2017.0,2,0,2
NLD,HND,2010.0,1,0,1
ESP,EST,2013.0,3,0,3
IND,MMR,2013.0,4,0,4
,ABW,2013.0,2,0,2
,KNA,2005.0,3,0,3
ROU,ITA,2024.0,1,0,1
GIB,ITA,2017.0,1,0,1
SLV,VEN,2007.0,1,0,1
NCL,FJI,2021.0,3,0,3
GBR,FRO,2019.0,1,0,1
GUY,FRA,2016.0,2,0,2
,AIA,2013.0,6,0,6
GBR,LVA,2021.0,7,0,7
NGA,TZA,2023.0,2,0,2
BGD,ZAF,2020.0,1,0,1
LUX,NGA,2023.0,1,0,1
GTM,SLV,2013.0,1,0,1
CHL,PRI,2011.0,3,0,3
RUS,GBR,2024.0,1,0,1
SWE,BOL,2018.0,3,0,3
JPN,ETH,2010.0,2,0,2
COG,,2001.0,7,0,7
BGR,SRB,2011.0,1,0,1
CYP,TUR,1997.0,2,0,2
,SLE,1995.0,18,0,18
DEU,QAT,2017.0,5,0,5
DNK,CHL,2001.0,3,0,3
MRT,,2003.0,1,0,1
MTQ,,2000.0,9,0,9
RWA,GHA,2017.0,1,0,1
MLT,,2010.0,12,0,12
NGA,LSO,2020.0,1,0,1
PAK,ZAF,2014.0,4,0,4
LVA,POL,2001.0,2,0,2
UKR,FIN,2001.0,3,0,3
ISR,ARE,2003.0,2,0,2
AUT,NOR,1997.0,2,0,2
,LSO,1999.0,4,0,4
AUT,VNM,2000.0,1,0,1
ITA,NAM,2000.0,1,0,1
SVK,IDN,2015.0,1,0,1
MKD,HRV,2010.0,4,0,4
,TKM,2000.0,1,0,1
ZAF,MOZ,1997.0,2,0,2
NAM,BWA,2001.0,1,0,1
ERI,,2001.0,1,0,1
CHE,MDG,2007.0,1,0,1
NOR,BRA,2002.0,2,0,2
,ERI,1995.0,2,0,2
NGA,TTO,1998.0,1,0,1
,KGZ,1994.0,23,0,23
GBR,IOT,2009.0,1,0,1
DNK,TWN,2006.0,1,0,1
ARM,KAZ,2017.0,1,0,1
ZWE,SLE,2017.0,1,0,1
HKG,BHR,2002.0,1,0,1
FRA,COG,1998.0,3,0,3
MYS,DZA,2002.0,1,0,1
CCK,,2014.0,2,0,2
BLR,IRL,2004.0,1,0,1
,FLK,2002.0,5,0,5
DEU,SYR,1997.0,1,0,1
CZE,IRL,2003.0,1,0,1
ARG,CZE,2005.0,1,0,1
SWE,LAO,2015.0,2,0,2
IDN,CMR,2012.0,1,0,1
BGR,LVA,2018.0,1,0,1
TGO,KEN,2001.0,1,0,1
COG,,2004.0,3,0,3
ITA,LBY,2000.0,1,0,1
CAF,DJI,2000.0,1,0,1
CUB,FRA,2010.0,5,0,5
RWA,,2000.0,4,0,4
ECU,NOR,2020.0,1,0,1
ISL,DEU,2004.0,3,0,3
BMU,USA,2001.0,4,0,4
,FRO,2002.0,3,0,3
SAU,CMR,2019.0,1,0,1
,KNA,2002.0,1,0,1
KNA,TTO,2008.0,1,0,1
ZAF,HKG,2006.0,1,0,1
AUS,KEN,1999.0,2,0,2
EGY,COD,2002.0,1,0,1
IND,NOR,2004.0,2,0,2
KEN,MWI,2005.0,2,0,2
BMU,CYM,2020.0,1,0,1
MLT,TUN,2010.0,3,0,3
JOR,FRA,2009.0,2,0,2
TJK,RUS,2009.0,5,0,5
MDG,SEN,2021.0,1,0,1
,MCO,2003.0,6,0,6
FIN,MNG,2018.0,1,0,1
SGP,BHR,2011.0,1,0,1
OMN,HKG,1997.0,1,0,1
BGR,SVK,2011.0,1,0,1
AUT,ISR,2015.0,3,0,3
GEO,ISR,2012.0,1,0,1
BEN,GAB,2002.0,2,0,2
TKM,,1999.0,1,0,1
CAN,RWA,2006.0,1,0,1
MAR,MAC,2009.0,4,0,4
TWN,COL,2011.0,1,0,1
COL,CHN,2015.0,2,0,2
KAZ,KGZ,2014.0,2,0,2
SVN,BRA,2010.0,1,0,1
TUR,SWE,1999.0,3,0,3
MWI,JPN,2006.0,2,0,2
DEU,ALB,2013.0,1,0,1
PRI,CZE,2011.0,1,0,1
ISR,FIN,2008.0,3,0,3
ITA,WSM,2003.0,1,0,1
OMN,SGP,2005.0,1,0,1
HKG,ISR,2013.0,2,0,2
FLK,,2018.0,1,0,1
GMB,CHE,2006.0,2,0,2
SWE,CHL,2005.0,1,0,1
BRA,CIV,2011.0,1,0,1
LKA,IDN,2014.0,1,0,1
IRN,SAU,2013.0,1,0,1
SVK,ROU,2008.0,3,0,3
,NAM,2005.0,13,0,13
ZMB,LSO,2018.0,1,0,1
GBR,RWA,2010.0,2,0,2
SVK,ARE,2019.0,1,0,1
NOR,PAK,2005.0,1,0,1
AUS,REU,2011.0,1,0,1
FJI,KAZ,2012.0,1,0,1
NER,TUN,2007.0,1,0,1
TUN,NER,2009.0,1,0,1
GHA,TUN,2014.0,1,0,1
CRI,CHL,2012.0,2,0,2
COL,JPN,2008.0,2,0,2
FSM,,2017.0,3,0,3
,FRO,2005.0,4,0,4
ETH,ISR,2007.0,1,0,1
BOL,ESP,2004.0,3,0,3
PRT,FIN,2006.0,4,0,4
,MRT,2005.0,6,0,6
GEO,POL,2020.0,1,0,1
NLD,URY,2002.0,3,0,3
BEL,CYP,2023.0,1,0,1
NGA,AUS,2013.0,3,0,3
VEN,AGO,2015.0,1,0,1
BOL,DEU,2010.0,1,0,1
GHA,SEN,2016.0,1,0,1
TUR,JOR,2012.0,3,0,3
PHL,TON,2009.0,1,0,1
IND,VNM,2011.0,2,0,2
BLR,CAN,2012.0,1,0,1
GHA,ITA,2015.0,2,0,2
CHN,COM,2014.0,1,0,1
TUN,CIV,2017.0,1,0,1
IND,JOR,2023.0,3,0,3
GIN,,2015.0,4,0,4
SDN,IND,2021.0,1,0,1
ZAF,LBR,2018.0,1,0,1
VNM,ZAF,2019.0,1,0,1
GRD,,2026.0,1,0,1
ITA,SDN,2015.0,1,0,1
RWA,AUS,2017.0,2,0,2
FIN,LVA,2015.0,1,0,1
PYF,CHE,2016.0,1,0,1
NAM,FLK,2020.0,1,0,1
MCO,MDG,2013.0,2,0,2
BEN,CMR,2018.0,2,0,2
CHE,GHA,2007.0,2,0,2
AUS,MMR,2012.0,1,0,1
MMR,AUS,2017.0,2,0,2
BGD,FIN,2019.0,3,0,3
CHN,MEX,1998.0,4,0,4
BGD,OMN,2009.0,1,0,1
IRQ,SYR,2023.0,2,0,2
GBR,GRD,2016.0,1,0,1
ZWE,CIV,2021.0,1,0,1
BRN,SAU,2020.0,2,0,2
GRC,SDN,2008.0,1,0,1
NLD,CRI,2023.0,2,0,2
NPL,IDN,2013.0,2,0,2
JPN,PAN,2008.0,2,0,2
COG,CHE,2017.0,3,0,3
,NAM,2002.0,10,0,10
NAM,SWE,2013.0,1,0,1
IRN,SYR,2018.0,1,0,1
TON,AUS,2022.0,1,0,1
BFA,AUT,2019.0,1,0,1
HKG,DNK,2012.0,2,0,2
,COL,2021.0,9,0,9
GBR,CIV,2021.0,2,0,2
BEL,MTQ,2020.0,1,0,1
COL,QAT,2019.0,2,0,2
EST,PRT,2017.0,1,0,1
CHL,HND,2022.0,3,0,3
MYS,SDN,2023.0,4,0,4
CHN,COG,2022.0,1,0,1
HUN,HND,2022.0,2,0,2
CZE,BGD,2022.0,2,0,2
USA,TCD,2021.0,3,0,3
,GNB,2015.0,13,0,13
,LBY,2020.0,42,0,42
DEU,MOZ,2021.0,2,0,2
ITA,MMR,2023.0,1,0,1
HUN,SDN,2022.0,1,0,1
ZMB,TZA,2022.0,4,0,4
AFG,ETH,2022.0,1,0,1
NGA,ITA,1998.0,2,0,2
HRV,HUN,2005.0,1,0,1
SYC,,2013.0,4,0,4
DNK,IDN,2007.0,1,0,1
BEL,BIH,2002.0,2,0,2
MTQ,,2006.0,5,0,5
FRA,NIC,2009.0,1,0,1
SLV,DEU,2013.0,1,0,1
ISR,NGA,2009.0,2,0,2
BEL,CIV,2012.0,6,0,6
LKA,PAK,2003.0,3,0,3
MDA,EST,2010.0,3,0,3
EST,MDA,2016.0,3,0,3
CUB,FRA,2006.0,2,0,2
QAT,PHL,2003.0,1,0,1
SRB,NZL,2001.0,2,0,2
NGA,FRA,2006.0,5,0,5
OMN,BGR,2020.0,1,0,1
BIH,QAT,2018.0,1,0,1
UKR,TKM,2014.0,1,0,1
GTM,ITA,2016.0,1,0,1
CZE,ISR,1997.0,3,0,3
AUT,ZWE,2005.0,3,0,3
VEN,NGA,1999.0,2,0,2
ZAF,CIV,2007.0,3,0,3
CAN,LUX,2001.0,1,0,1
UKR,DNK,2000.0,1,0,1
BTN,,2009.0,4,0,4
CMR,CAF,2016.0,1,0,1
ARE,UKR,2014.0,1,0,1
GUY,,2005.0,6,0,6
KEN,SVN,2010.0,1,0,1
NOR,COL,2016.0,3,0,3
LBY,IRQ,2006.0,3,0,3
KEN,IND,2000.0,1,0,1
,HTI,1994.0,2,0,2
CUB,NIC,2022.0,1,0,1
CAF,MWI,2011.0,1,0,1
TUR,SVN,2016.0,3,0,3
IRL,PHL,2000.0,1,0,1
LBY,,2006.0,12,0,12
NZL,MYS,1998.0,3,0,3
YEM,,2006.0,7,0,7
MAR,TWN,1997.0,1,0,1
BHR,ARE,2001.0,1,0,1
BEL,SEN,2001.0,2,0,2
COM,ETH,2011.0,1,0,1
MDG,GBR,2000.0,2,0,2
TWN,IDN,2005.0,1,0,1
IRN,ZAF,2001.0,1,0,1
USA,MDA,2012.0,3,0,3
NIC,USA,2000.0,4,0,4
HRV,HUN,2012.0,4,0,4
ERI,,2004.0,2,0,2
ESP,PNG,1999.0,1,0,1
THA,CHN,2006.0,1,0,1
KWT,SGP,2001.0,1,0,1
ZAF,CIV,1998.0,2,0,2
UGA,RWA,2003.0,1,0,1
GBR,TJK,2006.0,1,0,1
GBR,QAT,1997.0,2,0,2
SDN,IRL,2013.0,1,0,1
NIC,,2000.0,2,0,2
ARE,NAM,2002.0,1,0,1
POL,AFG,2019.0,1,0,1
,PAN,2005.0,29,0,29
DOM,,2016.0,13,0,13
NGA,MYS,2006.0,1,0,1
PRT,MEX,2001.0,1,0,1
,KGZ,2010.0,19,0,19
COL,LKA,2014.0,1,0,1
BFA,AUT,2010.0,1,0,1
BGD,BRB,2011.0,1,0,1
PAK,GRD,2021.0,1,0,1
GTM,,2012.0,10,0,10
IND,GRD,2017.0,2,0,2
BHR,KWT,2014.0,5,0,5
,NER,2010.0,28,0,28
GEO,CHE,2003.0,1,0,1
BHS,,2019.0,10,0,10
NAM,,2016.0,16,0,16
RUS,JOR,2014.0,1,0,1
MYS,KWT,2007.0,1,0,1
BIH,EGY,2013.0,1,0,1
ITA,NPL,2014.0,3,0,3
BRB,,2023.0,36,0,36
UGA,RWA,2015.0,3,0,3
PAK,UKR,2023.0,3,0,3
PHL,NZL,2015.0,3,0,3
NOR,JOR,2022.0,1,0,1
BDI,,2015.0,5,0,5
MDA,FRA,2014.0,2,0,2
UZB,AUT,2015.0,1,0,1
AUT,UZB,2017.0,1,0,1
BIH,,2026.0,12,0,12
VNM,CZE,2014.0,1,0,1
VUT,GBR,2020.0,1,0,1
QAT,SWE,2020.0,3,0,3
IRL,SYC,2019.0,1,0,1
NOR,LVA,2022.0,1,0,1
,SWZ,2014.0,32,0,32
,SLB,2014.0,12,0,12
SLB,GBR,2017.0,1,0,1
BRA,CYM,2022.0,1,0,1
BHR,BWA,1998.0,1,0,1
NGA,MYS,2024.0,3,0,3
BRN,NPL,2018.0,2,0,2
PHL,CZE,2018.0,1,0,1
MMR,ZAF,2017.0,1,0,1
DZA,NOR,2021.0,2,0,2
DEU,COG,2008.0,2,0,2
IND,SYR,2016.0,1,0,1
BRN,TWN,2020.0,1,0,1
NZL,TWN,2012.0,3,0,3
,PLW,2013.0,6,0,6
DNK,OMN,2019.0,2,0,2
GHA,,2007.0,37,0,37
LVA,GEO,2017.0,1,0,1
GEO,LVA,2019.0,1,0,1
MAR,TGO,2019.0,1,0,1
IRN,KAZ,2023.0,3,0,3
TWN,IRQ,2022.0,1,0,1
BHR,,2006.0,16,0,16
ITA,SEN,2016.0,1,0,1
ESP,IRQ,2022.0,2,0,2
QAT,GRD,2021.0,1,0,1
IDN,CZE,2021.0,4,0,4
,PNG,2017.0,39,0,39
BGR,AUT,2019.0,3,0,3
CAN,BOL,2022.0,2,0,2
,COG,1999.0,20,0,20
PRI,CHN,2014.0,4,0,4
JPN,VEN,2008.0,1,0,1
NLD,MNG,2022.0,2,0,2
MUS,,2016.0,16,0,16
,TGO,2004.0,21,0,21
SLV,,2015.0,11,0,11
FIN,UKR,2008.0,3,0,3
HKG,CHL,2008.0,1,0,1
SDN,,2009.0,31,0,31
MNG,,2020.0,51,0,51
PRT,COL,2005.0,1,0,1
TZA,DNK,2012.0,2,0,2
TUR,TTO,2023.0,1,0,1
CHE,LBN,2006.0,1,0,1
BFA,NGA,2019.0,1,0,1
GBR,LSO,2003.0,1,0,1
,CYP,2005.0,95,0,95
TZA,CHE,2011.0,7,0,7
BWA,,2009.0,28,0,28
CMR,MYS,2014.0,1,0,1
PYF,,2014.0,11,0,11
MLT,,2009.0,10,0,10
IRL,EST,2007.0,1,0,1
BTN,GBR,2012.0,1,0,1
TUR,FIN,2001.0,2,0,2
GRC,LUX,2012.0,2,0,2
IND,MOZ,2017.0,2,0,2
PAK,CHE,2000.0,3,0,3
BRA,SRB,2018.0,2,0,2
ZAF,ROU,2007.0,3,0,3
MDA,BEL,2010.0,1,0,1
CHN,BDI,2017.0,1,0,1
UZB,CHN,2017.0,4,0,4
USA,PSE,2006.0,8,0,8
ARE,QAT,2008.0,3,0,3
,SLV,2005.0,7,0,7
,HND,1995.0,11,0,11
IRL,CIV,2011.0,1,0,1
ISR,SAU,2011.0,2,0,2
CUB,DEU,2009.0,6,0,6
NGA,FRA,2009.0,4,0,4
CYP,JOR,2004.0,2,0,2
NOR,JOR,2017.0,2,0,2
ITA,MLT,2011.0,5,0,5
TUN,KOR,2016.0,1,0,1
SYR,ARE,2017.0,2,0,2
,MMR,2006.0,14,0,14
,BRB,2002.0,17,0,17
CAN,OMN,2011.0,9,0,9
KHM,THA,2009.0,1,0,1
JAM,,2001.0,10,0,10
NZL,PRT,2009.0,2,0,2
DZA,BRA,2011.0,1,0,1
BEN,,2009.0,12,0,12
SVN,MNE,2009.0,3,0,3
QAT,CUB,2020.0,1,0,1
CUB,DOM,2018.0,2,0,2
CRI,BRA,2011.0,4,0,4
CAN,MAC,2021.0,2,0,2
MCO,PYF,2017.0,1,0,1
POL,COL,2017.0,3,0,3
USA,TGO,2018.0,2,0,2
PAN,ARG,2021.0,2,0,2
BGR,IRQ,2016.0,1,0,1
ARE,ISR,2019.0,3,0,3
CHN,OMN,2022.0,5,0,5
CRI,IND,2004.0,1,0,1
EST,POL,2023.0,2,0,2
TCA,,2019.0,2,0,2
USA,BRN,2017.0,2,0,2
FIN,OMN,2018.0,1,0,1
SLV,SVN,2006.0,3,0,3
LVA,NLD,1998.0,1,0,1
GUF,,1999.0,2,0,2
BEN,,2011.0,16,0,16
THA,RUS,2014.0,2,0,2
TGO,,2001.0,13,0,13
,COG,1998.0,22,0,22
LTU,BEL,2009.0,2,0,2
ARG,PRT,2019.0,4,0,4
SGP,KHM,2013.0,1,0,1
ARE,FIN,2015.0,2,0,2
,YEM,1998.0,14,0,14
MAR,,2000.0,53,0,53
JPN,NOR,2005.0,3,0,3
FIN,LVA,2003.0,4,0,4
JPN,SAU,2004.0,1,0,1
,MNG,1999.0,18,0,18
JPN,EST,2003.0,1,0,1
PHL,MEX,2012.0,1,0,1
GRC,ETH,2014.0,1,0,1
OMN,RWA,2014.0,1,0,1
ALB,,2008.0,8,0,8
PER,AUS,2001.0,2,0,2
IRN,NLD,1999.0,2,0,2
GBR,MAR,2014.0,4,0,4
CHE,ECU,2009.0,1,0,1
CAN,URY,2001.0,3,0,3
MAR,SEN,2012.0,1,0,1
ROU,MEX,1998.0,1,0,1
FRA,ETH,1998.0,1,0,1
LBN,SAU,2002.0,3,0,3
SVK,SLV,2003.0,2,0,2
TTO,,2001.0,11,0,11
GRC,SAU,2011.0,2,0,2
MCO,USA,1998.0,1,0,1
LVA,UKR,1998.0,1,0,1
SGP,TZA,2012.0,1,0,1
MDA,CAN,2002.0,1,0,1
CHN,IRQ,2007.0,2,0,2
JOR,KOR,2011.0,2,0,2
FJI,THA,2015.0,1,0,1
SVK,FIN,1999.0,1,0,1
SEN,BFA,2009.0,2,0,2
UKR,BGR,1999.0,4,0,4
PAK,AUS,1999.0,4,0,4
PER,,1999.0,12,0,12
ZMB,,2006.0,20,0,20
BLR,CHE,2008.0,2,0,2
,GMB,2002.0,19,0,19
ARM,,2001.0,27,0,27
CHN,CIV,2010.0,4,0,4
FRA,MRT,2006.0,1,0,1
UGA,COL,2001.0,1,0,1
ARG,IRL,2014.0,1,0,1
BGD,NLD,2010.0,4,0,4
HUN,IRL,2002.0,1,0,1
IRL,HUN,2003.0,2,0,2
UZB,GHA,2006.0,1,0,1
DZA,PRT,2004.0,2,0,2
BEL,AGO,2008.0,2,0,2
TTO,,2015.0,54,0,54
,COD,1995.0,8,0,8
JAM,JPN,1997.0,3,0,3
TGO,,2015.0,13,0,13
DZA,DEU,1999.0,4,0,4
AUS,GHA,1997.0,1,0,1
HRV,RUS,2013.0,2,0,2
SAU,GHA,2017.0,1,0,1
LUX,AUT,2004.0,1,0,1
POL,CHL,2002.0,2,0,2
NLD,ECU,1998.0,1,0,1
CZE,BGR,2009.0,1,0,1
DEU,PRI,1997.0,2,0,2
ESP,MOZ,2013.0,5,0,5
NOR,BWA,2015.0,1,0,1
BRB,,2010.0,14,0,14
POL,SGP,2005.0,2,0,2
EST,ROU,2018.0,1,0,1
GHA,CAF,2015.0,1,0,1
BLR,VNM,2010.0,1,0,1
ITA,PER,2007.0,1,0,1
HND,,2017.0,16,0,16
,CYM,2006.0,4,0,4
TUR,BRA,2006.0,2,0,2
NIC,,2010.0,10,0,10
SRB,BRA,2021.0,1,0,1
AFG,,2013.0,14,0,14
FRA,SYR,2012.0,10,0,10
IDN,UKR,2023.0,2,0,2
PAK,QAT,2008.0,1,0,1
CHL,TUN,2013.0,1,0,1
FJI,,2016.0,11,0,11
FRA,TZA,2010.0,2,0,2
,NER,2006.0,19,0,19
CHN,BRN,2023.0,2,0,2
POL,GEO,2009.0,1,0,1
SRB,AUT,2011.0,1,0,1
ITA,EGY,2003.0,4,0,4
UZB,BEL,2009.0,1,0,1
LSO,USA,2014.0,2,0,2
,KGZ,2006.0,18,0,18
ECU,ITA,2008.0,2,0,2
JAM,NGA,2019.0,1,0,1
KAZ,FRA,2007.0,2,0,2
,LAO,2002.0,16,0,16
FRA,ASM,2011.0,1,0,1
ARM,CHN,2015.0,2,0,2
SYC,,2014.0,1,0,1
MYS,BHR,2015.0,5,0,5
VEN,PER,2017.0,5,0,5
CUB,CAN,2007.0,4,0,4
TWN,PHL,2012.0,5,0,5
AUT,COL,2008.0,2,0,2
HND,SWE,2009.0,2,0,2
SWE,HND,2012.0,1,0,1
CHE,MYS,2006.0,1,0,1
COG,DEU,2013.0,2,0,2
DEU,COG,2014.0,1,0,1
KEN,SLE,2018.0,1,0,1
VEN,SWE,2011.0,2,0,2
BOL,,2014.0,32,0,32
NOR,VNM,2013.0,4,0,4
BRA,NGA,1997.0,1,0,1
NZL,NGA,2014.0,2,0,2
BEL,JOR,2015.0,1,0,1
BRA,MLT,2023.0,1,0,1
ETH,SEN,2023.0,1,0,1
DEU,NER,2017.0,1,0,1
ISL,LUX,2015.0,1,0,1
MNG,NLD,2013.0,1,0,1
TTO,ESP,2020.0,2,0,2
RUS,LUX,2011.0,1,0,1
CYP,NOR,2022.0,1,0,1
LKA,HKG,2014.0,2,0,2
BEL,PRY,2017.0,1,0,1
PHL,CHL,2019.0,4,0,4
CYP,FIN,2020.0,1,0,1
,NER,2000.0,9,0,9
UKR,TUR,2017.0,2,0,2
FRA,HTI,2017.0,1,0,1
BDI,SGP,2018.0,1,0,1
GRC,JPN,2017.0,1,0,1
BHS,,2021.0,8,0,8
,LBY,2012.0,52,0,52
MYS,HKG,2005.0,1,0,1
CHN,MDV,2021.0,1,0,1
CHL,CRI,2010.0,2,0,2
THA,NPL,2000.0,1,0,1
NGA,IRN,2023.0,2,0,2
NOR,COG,2017.0,1,0,1
FJI,NZL,2020.0,8,0,8
FJI,USA,2022.0,1,0,1
PRK,,2018.0,3,0,3
RUS,MNE,2016.0,3,0,3
,GAB,2012.0,32,0,32
NAM,,2018.0,19,0,19
TTO,KNA,2016.0,3,0,3
GEO,LAO,2017.0,4,0,4
QAT,UGA,2020.0,1,0,1
TKM,,2002.0,3,0,3
SGP,MAR,2006.0,1,0,1
IRN,LUX,2021.0,2,0,2
MOZ,,1999.0,1,0,1
BTN,VNM,2021.0,1,0,1
,SDN,2001.0,44,0,44
,LBY,2005.0,25,0,25
AUT,CYP,2018.0,1,0,1
ROU,IND,2010.0,2,0,2
IND,ROU,2013.0,2,0,2
NGA,ITA,2002.0,5,0,5
NER,DZA,2019.0,1,0,1
DZA,NER,2021.0,1,0,1
JOR,HUN,2019.0,4,0,4
MWI,ISR,2020.0,1,0,1
GRL,USA,2023.0,2,0,2
BRN,KOR,2020.0,1,0,1
ERI,ETH,2009.0,2,0,2
PAN,PRT,2012.0,1,0,1
,KGZ,2000.0,7,0,7
SXM,USA,2023.0,3,0,3
IRN,LUX,2019.0,3,0,3
UZB,AUS,2022.0,1,0,1
,DOM,2019.0,42,0,42
CHN,PSE,2021.0,2,0,2
AUT,VNM,2011.0,2,0,2
NGA,DNK,2022.0,1,0,1
PAK,LBN,2017.0,1,0,1
CMR,POL,2021.0,1,0,1
,NRU,2018.0,1,0,1
CUB,BOL,2022.0,2,0,2
HKG,SAU,2001.0,1,0,1
CHN,BFA,2019.0,1,0,1
AZE,DEU,2021.0,2,0,2
BIH,ESP,2018.0,1,0,1
AUT,ALB,2015.0,2,0,2
CHL,PRY,2015.0,2,0,2
VNM,TJK,2017.0,1,0,1
FIN,LUX,2022.0,1,0,1
KHM,SLE,2017.0,1,0,1
FSM,USA,2014.0,2,0,2
FIN,IDN,2023.0,2,0,2
SVK,VNM,2016.0,1,0,1
UZB,KAZ,2016.0,7,0,7
PHL,KAZ,2018.0,2,0,2
ISR,LUX,2014.0,1,0,1
TUN,CAF,2016.0,8,0,8
SVK,SWE,2019.0,1,0,1
,PRK,2013.0,20,0,20
QAT,GIN,2023.0,1,0,1
,LSO,2012.0,12,0,12
SWZ,ZWE,1997.0,1,0,1
BLZ,BRA,2019.0,3,0,3
TWN,ROU,2016.0,1,0,1
PHL,EGY,2016.0,1,0,1
COM,,2025.0,21,0,21
AUT,ETH,2019.0,4,0,4
MEX,SLV,2016.0,3,0,3
,MDV,2006.0,1,0,1
MMR,KHM,2018.0,1,0,1
SGP,GBR,2024.0,1,0,1
LBN,KWT,2020.0,3,0,3
JOR,UGA,2013.0,1,0,1
EGY,SVK,2019.0,1,0,1
QAT,UZB,2020.0,1,0,1
IRN,MEX,2022.0,7,0,7
BLR,FRA,2022.0,3,0,3
FRA,SWZ,2020.0,1,0,1
NGA,ZMB,2019.0,2,0,2
CHN,KGZ,2022.0,1,0,1
IND,YEM,2020.0,13,0,13
TUR,JOR,2020.0,8,0,8
PAK,BWA,2023.0,1,0,1
ZAF,MDG,2015.0,1,0,1
DEU,PRI,2005.0,1,0,1
BOL,NIC,2022.0,1,0,1
BEL,KHM,2006.0,2,0,2
KOR,SRB,2022.0,1,0,1
JAM,BLZ,2022.0,1,0,1
COL,IRL,2023.0,3,0,3
IND,ZAF,2004.0,14,0,14
BRA,PHL,1999.0,5,0,5
DEU,MRT,2001.0,1,0,1
UGA,FRA,1997.0,2,0,2
,ALB,2001.0,19,0,19
PRT,SGP,2005.0,1,0,1
,LBY,2002.0,18,0,18
,TJK,2005.0,16,0,16
BEL,BFA,1999.0,1,0,1
NGA,HTI,2009.0,1,0,1
,MOZ,2002.0,26,0,26
,SWZ,1996.0,9,0,9
COG,,2003.0,5,0,5
KWT,NGA,2014.0,1,0,1
ZAF,MDG,2008.0,1,0,1
RUS,VNM,2009.0,2,0,2
KGZ,KAZ,2013.0,1,0,1
,MTQ,2002.0,6,0,6
CMR,,2003.0,7,0,7
BEL,COG,2000.0,2,0,2
PHL,LKA,2003.0,1,0,1
GAB,COG,2006.0,1,0,1
,KHM,1994.0,4,0,4
,MNE,2001.0,9,0,9
SJM,,2007.0,1,0,1
HRV,NLD,2005.0,3,0,3
,GLP,1999.0,10,0,10
IRL,GHA,2006.0,1,0,1
QAT,,2004.0,10,0,10
,MNE,1996.0,2,0,2
NOR,OMN,2013.0,1,0,1
VUT,AUS,2002.0,1,0,1
,NAM,1998.0,9,0,9
GEO,,2000.0,13,0,13
PRY,,2009.0,3,0,3
SWE,TWN,2006.0,3,0,3
LSO,ZWE,2012.0,1,0,1
HUN,LBY,2017.0,1,0,1
,BWA,1999.0,30,0,30
COD,COG,2001.0,1,0,1
GBR,BRB,2008.0,1,0,1
,TGO,2001.0,20,0,20
LVA,POL,2013.0,1,0,1
,ALB,1996.0,18,0,18
SWE,ERI,2004.0,1,0,1
PAN,,2004.0,3,0,3
ARE,MLT,2018.0,1,0,1
CAN,PER,2004.0,2,0,2
ZWE,EGY,2001.0,1,0,1
LKA,AUS,1999.0,3,0,3
UGA,SWE,2000.0,1,0,1
GNQ,CAN,2011.0,1,0,1
ALB,CAN,2006.0,1,0,1
ZMB,,2000.0,10,0,10
,SLB,1996.0,4,0,4
,TCD,1997.0,4,0,4
BWA,FIN,2001.0,1,0,1
ITA,ZAF,2002.0,3,0,3
TZA,KEN,2000.0,2,0,2
AFG,,2003.0,2,0,2
,BDI,1994.0,14,0,14
BDI,,2001.0,5,0,5
ZWE,NZL,1998.0,1,0,1
,FJI,2002.0,25,0,25
LVA,AUT,1999.0,1,0,1
MWI,,2012.0,27,0,27
MOZ,,2007.0,8,0,8
MDG,USA,1999.0,2,0,2
BEL,CYP,2009.0,1,0,1
FRA,COD,2007.0,1,0,1
CIV,ITA,2006.0,1,0,1
BRA,POL,2010.0,1,0,1
MLI,USA,2000.0,3,0,3
AUS,NCL,2003.0,1,0,1
PNG,AUS,2006.0,3,0,3
MYS,EST,2014.0,1,0,1
TUR,MNG,2018.0,1,0,1
SEN,CHE,2001.0,2,0,2
BLR,PRT,2010.0,4,0,4
PRT,GEO,2013.0,1,0,1
USA,SLV,2007.0,3,0,3
LVA,CZE,2013.0,1,0,1
IRN,OMN,2015.0,5,0,5
TUR,QAT,2011.0,2,0,2
MDG,CAN,2003.0,2,0,2
UKR,TUR,2018.0,3,0,3
PRI,MEX,2005.0,2,0,2
LTU,LVA,2015.0,6,0,6
PHL,AUT,2008.0,1,0,1
TWN,POL,2004.0,3,0,3
NER,CAN,2011.0,1,0,1
IRQ,BHR,2023.0,1,0,1
GRC,UKR,2018.0,2,0,2
ARG,SAU,2011.0,1,0,1
SWE,CMR,1999.0,2,0,2
CHE,FJI,2012.0,1,0,1
FJI,THA,2014.0,1,0,1
SGP,SEN,2015.0,2,0,2
CAN,LVA,2008.0,1,0,1
ITA,ISL,2010.0,1,0,1
CUB,PER,2005.0,1,0,1
USA,LBR,2012.0,6,0,6
ARG,RUS,2005.0,1,0,1
,TCD,2002.0,3,0,3
IND,TTO,2000.0,1,0,1
NLD,MAR,2012.0,1,0,1
CAN,EST,2015.0,2,0,2
SLV,HUN,2016.0,1,0,1
TWN,BWA,2012.0,1,0,1
SWE,KWT,2023.0,1,0,1
ARE,ZAF,2011.0,1,0,1
PHL,BGD,2016.0,3,0,3
,GMB,2005.0,17,0,17
SGP,MAC,2016.0,4,0,4
GNB,,2012.0,5,0,5
CYP,KOR,2012.0,1,0,1
TGO,,2008.0,4,0,4
FRA,SGP,1997.0,2,0,2
AUT,TZA,2011.0,2,0,2
UKR,EST,2023.0,4,0,4
BWA,ZMB,2017.0,2,0,2
FJI,LKA,2016.0,1,0,1
ISR,THA,2018.0,1,0,1
ITA,JOR,2005.0,4,0,4
RUS,CMR,2005.0,1,0,1
TGO,,2014.0,17,0,17
GLP,BRA,2010.0,1,0,1
LUX,QAT,2015.0,1,0,1
KWT,FIN,2001.0,2,0,2
VGB,NLD,2013.0,1,0,1
MYS,MAR,2011.0,3,0,3
GMB,SSD,2019.0,1,0,1
,VEN,2020.0,54,0,54
IDN,BRA,2014.0,1,0,1
BRA,TWN,2016.0,1,0,1
MWI,TZA,2010.0,1,0,1
MDV,PHL,2016.0,1,0,1
SAU,VNM,2017.0,1,0,1
MAR,POL,2018.0,1,0,1
LUX,QAT,2014.0,1,0,1
IND,FJI,2014.0,4,0,4
LUX,IRL,2019.0,1,0,1
AUS,BHR,2012.0,1,0,1
CZE,VNM,2015.0,1,0,1
SDN,PAK,2013.0,3,0,3
AUS,VUT,2022.0,1,0,1
USA,TLS,2017.0,2,0,2
AUS,KAZ,2018.0,3,0,3
HND,,2026.0,1,0,1
ZWE,TWN,2023.0,1,0,1
YEM,QAT,2021.0,1,0,1
,CPV,2010.0,5,0,5
DJI,,2015.0,10,0,10
LVA,ESP,2016.0,2,0,2
GBR,TLS,2018.0,1,0,1
DEU,MDG,2013.0,1,0,1
ITA,SMR,2006.0,4,0,4
MYS,FIN,2020.0,1,0,1
OMN,SDN,2008.0,1,0,1
GBR,BHS,2016.0,2,0,2
IRQ,HUN,2017.0,4,0,4
,MRT,2020.0,7,0,7
UGA,IRN,2016.0,1,0,1
HKG,CZE,2020.0,1,0,1
KWT,,2026.0,19,0,19
GUY,,2020.0,7,0,7
NOR,ECU,2018.0,2,0,2
CZE,SVN,2013.0,2,0,2
GAB,COG,2010.0,1,0,1
MDV,ITA,2022.0,1,0,1
MAR,SDN,2017.0,1,0,1
,MLI,2020.0,32,0,32
,SUR,2012.0,4,0,4
JOR,AFG,2021.0,1,0,1
LAO,KHM,2014.0,2,0,2
NZL,NPL,2017.0,3,0,3
PAK,QAT,2014.0,5,0,5
SVK,TWN,2021.0,1,0,1
KWT,POL,2022.0,2,0,2
GBR,LBN,1997.0,4,0,4
JPN,ISR,2023.0,2,0,2
GHA,TGO,2022.0,2,0,2
AUS,PAK,2008.0,5,3,2
AUS,BGD,2011.0,7,32,-25
DEU,THA,2005.0,13,6,7
BRN,IND,2020.0,1,2,-1
MYS,NGA,2009.0,3,5,-2
AUS,KOR,2009.0,13,18,-5
FIN,EGY,2017.0,2,6,-4
BRA,DNK,2010.0,6,4,2
UGA,USA,2005.0,10,18,-8
SAU,PAK,2001.0,4,10,-6
USA,MKD,2004.0,3,3,0
NLD,BGD,2004.0,1,1,0
BGD,GBR,2005.0,9,15,-6
ECU,CHL,2023.0,4,6,-2
SVK,AUT,2020.0,10,7,3
ARE,KOR,2014.0,3,6,-3
DOM,USA,2010.0,3,5,-2
PRT,KOR,2010.0,1,4,-3
URY,AUT,2013.0,1,1,0
SRB,HRV,2015.0,14,17,-3
NZL,PAK,2013.0,10,6,4
MNP,USA,2011.0,1,1,0
MAR,BEL,2023.0,6,4,2
EGY,ITA,2017.0,8,11,-3
NZL,CHE,2009.0,9,10,-1
JPN,JOR,2017.0,2,2,0
SVK,GBR,2020.0,4,7,-3
CZE,NLD,2007.0,9,4,5
ITA,BGD,2015.0,3,3,0
ARG,SWE,2011.0,3,5,-2
ITA,HUN,2006.0,9,5,4
FRA,BGD,2012.0,3,1,2
SAU,SDN,2023.0,13,12,1
AUS,VNM,2010.0,13,12,1
THA,DNK,2011.0,5,4,1
DEU,IRN,2005.0,11,13,-2
MYS,NZL,2011.0,10,12,-2
NER,NGA,2009.0,12,27,-15
USA,ETH,2016.0,30,29,1
SRB,IND,2015.0,2,2,0
TWN,FRA,2015.0,11,10,1
MYS,NGA,2011.0,10,12,-2
MYS,BGD,2013.0,22,38,-16
AUT,NOR,2011.0,3,5,-2
DNK,SVK,2002.0,1,2,-1
MEX,ARG,2011.0,11,9,2
BGR,ITA,2012.0,3,2,1
FIN,ESP,1998.0,3,3,0
GHA,NLD,2018.0,5,3,2
NGA,JPN,2007.0,4,4,0
USA,BIH,2021.0,6,5,1
BEL,NOR,2016.0,6,7,-1
ITA,MEX,2002.0,10,6,4
BEN,BEL,2013.0,3,1,2
BWA,ZWE,2020.0,1,4,-3
NGA,KEN,2016.0,3,4,-1
EST,ESP,2010.0,3,3,0
KAZ,USA,2015.0,9,25,-16
NOR,TWN,2020.0,3,3,0
SGP,CHN,1997.0,12,30,-18
SDN,GBR,2012.0,5,5,0
ESP,NZL,2003.0,1,1,0
PAK,BGD,2013.0,8,3,5
ITA,ALB,2012.0,4,5,-1
LUX,JPN,2016.0,2,1,1
BIH,DEU,2016.0,1,2,-1
JPN,PRT,2011.0,3,3,0
DZA,ESP,2018.0,6,13,-7
MEX,CHN,2003.0,4,1,3
LTU,JPN,2019.0,2,2,0
QAT,ESP,2016.0,1,6,-5
LIE,CHE,2012.0,1,2,-1
GNQ,GIN,2017.0,2,4,-2
HRV,FRA,2016.0,7,10,-3
GNQ,GIN,2016.0,6,3,3
PHL,ESP,2016.0,2,4,-2
MEX,CUB,2015.0,6,35,-29
YEM,SAU,2017.0,10,5,5
CHN,MAC,2005.0,6,3,3
CHE,MCO,2001.0,1,1,0
SWE,TUR,2014.0,7,8,-1
BEL,URY,2014.0,1,1,0
GIN,SEN,2014.0,1,3,-2
SEN,ZAF,2016.0,6,1,5
HUN,VNM,2022.0,3,3,0
SWE,BRA,2020.0,9,42,-33
IDN,SGP,2020.0,10,11,-1
TUR,NOR,2021.0,9,4,5
CHL,PRY,2017.0,3,1,2
BRA,NZL,2018.0,8,3,5
BEL,POL,2017.0,12,15,-3
CHN,PHL,2023.0,8,9,-1
CHL,JPN,2003.0,2,1,1
NGA,NZL,2021.0,7,2,5
QAT,SWE,2019.0,3,2,1
GBR,HRV,2018.0,14,16,-2
RUS,SWE,2022.0,24,14,10
GRC,LUX,2023.0,1,4,-3
BLR,CZE,2021.0,1,1,0
BEL,HKG,2020.0,1,2,-1
TUR,SAU,2017.0,16,5,11
NGA,IND,2016.0,13,9,4
BGR,ITA,2002.0,6,8,-2
CHE,CHN,2002.0,16,16,0
ISR,AUT,2012.0,8,2,6
HUN,IRL,2010.0,8,2,6
NLD,VNM,2017.0,10,2,8
ITA,PHL,1997.0,1,1,0
PAN,ESP,2003.0,1,3,-2
ITA,URY,2005.0,1,1,0
CHE,IND,2003.0,9,15,-6
IND,FJI,2018.0,4,1,3
ISR,BEL,2015.0,9,5,4
NPL,AUS,2000.0,1,1,0
DEU,ARM,2018.0,5,3,2
DNK,CHE,2008.0,20,25,-5
AUS,MEX,2013.0,10,13,-3
GTM,USA,2002.0,5,6,-1
TUR,PAK,1998.0,1,1,0
MLI,CAN,2012.0,2,1,1
KOR,NLD,2011.0,4,9,-5
CHN,BRA,2004.0,2,3,-1
CZE,RUS,2009.0,10,10,0
FRA,DJI,2004.0,3,2,1
NLD,VNM,2016.0,6,5,1
SGP,EGY,2022.0,1,1,0
ROU,ITA,2007.0,18,15,3
IND,GHA,2020.0,3,3,0
COL,DNK,2020.0,3,1,2
DZA,BEL,2019.0,2,10,-8
KAZ,CAN,2018.0,5,5,0
RWA,KEN,2020.0,5,5,0
BEL,ARG,2013.0,6,5,1
HRV,TUR,2019.0,4,2,2
DNK,GRC,2014.0,8,18,-10
RUS,KOR,2012.0,10,7,3
BLR,EST,2020.0,2,1,1
EGY,CHN,2003.0,2,1,1
TZA,SWE,2019.0,3,7,-4
BEL,ZAF,2022.0,10,14,-4
ZWE,CHN,2023.0,3,1,2
BGR,CHE,2008.0,3,5,-2
NPL,NOR,2022.0,4,2,2
KOR,CMR,2021.0,2,2,0
USA,SVN,2023.0,9,8,1
IRQ,GBR,2022.0,21,65,-44
VNM,CZE,2022.0,3,7,-4
DEU,ZMB,2022.0,2,1,1
BEL,ETH,2014.0,9,7,2
ZAF,ZMB,2023.0,8,5,3
BGR,SWE,2019.0,3,1,2
NPL,NOR,2016.0,5,4,1
KHM,KOR,2022.0,2,2,0
MOZ,BRA,2022.0,5,13,-8
TZA,ITA,2023.0,3,1,2
CHN,TJK,2019.0,3,1,2
EST,ESP,2000.0,3,1,2
SEN,FRA,2023.0,18,9,9
LKA,HKG,2022.0,1,4,-3
ARE,SAU,2013.0,11,9,2
CHE,HUN,1999.0,9,5,4
CAN,ZAF,2003.0,11,21,-10
ISR,NOR,1997.0,2,1,1
NZL,HKG,2002.0,4,5,-1
HKG,NZL,2003.0,4,2,2
BRA,SRB,2001.0,2,2,0
GRC,CYP,2007.0,20,6,14
EST,RUS,1997.0,1,3,-2
RUS,PRT,1999.0,11,3,8
CZE,AUS,2009.0,7,5,2
CHE,CHL,2013.0,14,5,9
NZL,MYS,2006.0,3,2,1
TJK,RUS,2002.0,2,1,1
HRV,ITA,1998.0,3,3,0
SOM,USA,2020.0,1,1,0
BGR,CHE,2004.0,4,3,1
DEU,SVK,2006.0,15,13,2
UGA,USA,2002.0,5,8,-3
DNK,CZE,2000.0,1,2,-1
YEM,EGY,2015.0,3,3,0
ISR,AUS,1999.0,3,6,-3
BGR,DNK,2011.0,1,2,-1
USA,SLV,2011.0,2,2,0
TUN,GBR,2001.0,3,1,2
URY,FRA,2003.0,5,1,4
ITA,ROU,1998.0,7,8,-1
JPN,BEL,1999.0,11,14,-3
BGR,CAN,1998.0,7,2,5
AUT,HRV,2002.0,6,6,0
TUR,NLD,2002.0,7,6,1
MWI,NLD,2004.0,3,1,2
DNK,NZL,1997.0,2,1,1
AUT,LUX,2003.0,1,2,-1
KOR,IND,2000.0,2,9,-7
LTU,FIN,2000.0,1,1,0
USA,SVN,2000.0,12,14,-2
JPN,JAM,2009.0,1,2,-1
HKG,NZL,2013.0,5,4,1
COG,FRA,2000.0,2,1,1
KEN,FRA,2023.0,2,1,1
NOR,GRC,2005.0,3,2,1
USA,TZA,1999.0,4,4,0
NOR,DEU,2006.0,14,46,-32
CHE,RUS,2002.0,12,33,-21
NLD,ISR,2001.0,9,10,-1
CZE,DNK,2000.0,2,1,1
MYS,FRA,2011.0,3,8,-5
FJI,AUS,2002.0,3,2,1
NLD,CHN,1999.0,10,11,-1
QAT,GBR,2008.0,2,8,-6
USA,LKA,1999.0,7,5,2
POL,ISR,2002.0,3,1,2
NLD,CRI,1999.0,2,4,-2
SRB,HRV,2004.0,7,5,2
SVK,POL,2020.0,10,8,2
BGR,SWE,2009.0,1,3,-2
CHL,DEU,2001.0,12,21,-9
SVN,SRB,2003.0,3,2,1
RUS,AZE,2000.0,7,5,2
MEX,RUS,2013.0,4,2,2
AUS,ISR,1997.0,10,6,4
ISR,AUS,1998.0,4,6,-2
MTQ,FRA,2004.0,4,22,-18
TUN,BEL,2003.0,1,1,0
EGY,AUT,1999.0,2,1,1
SWE,HUN,2006.0,3,8,-5
FRA,THA,2005.0,9,5,4
KWT,SAU,2001.0,2,2,0
EGY,OMN,2005.0,4,4,0
NGA,ITA,2006.0,2,1,1
ESP,PER,1998.0,1,4,-3
DNK,LTU,1998.0,2,2,0
SVN,ITA,2006.0,6,7,-1
ARE,TUR,2013.0,3,3,0
IRL,ITA,2004.0,3,11,-8
ITA,CZE,2005.0,5,6,-1
HRV,NLD,2023.0,5,1,4
SAU,BEL,2000.0,1,1,0
TUR,ROU,2006.0,1,2,-1
LBN,LBY,2017.0,1,1,0
DEU,EST,2002.0,4,3,1
DNK,RUS,2008.0,7,3,4
BLR,GBR,2007.0,7,1,6
SWE,CZE,1999.0,5,5,0
HUN,KOR,2011.0,1,1,0
PHL,CAN,2001.0,5,1,4
HRV,UKR,2017.0,2,1,1
JPN,ROU,2006.0,6,1,5
ARE,PSE,2012.0,1,2,-1
CYP,GBR,2003.0,2,12,-10
NZL,ARE,2010.0,2,1,1
MEX,ECU,2008.0,1,1,0
CHE,LKA,2010.0,1,1,0
ITA,VEN,2001.0,3,2,1
UKR,BRA,2021.0,1,1,0
THA,SWE,2010.0,7,5,2
PHL,USA,2000.0,19,22,-3
RUS,SRB,2006.0,5,16,-11
CHL,NOR,2017.0,2,4,-2
GAB,FRA,2013.0,6,8,-2
ZAF,BEL,2003.0,6,4,2
NLD,CHN,1998.0,11,8,3
RUS,SVK,2004.0,1,1,0
CZE,FIN,2008.0,5,3,2
ITA,IRL,2016.0,34,16,18
JPN,TZA,2013.0,4,2,2
IRN,NZL,2014.0,10,3,7
FIN,PRT,2013.0,2,2,0
CAN,COL,2001.0,4,5,-1
SRB,SWE,2016.0,6,2,4
AUT,KWT,2016.0,2,1,1
KHM,CHE,2009.0,3,1,2
CZE,ESP,2018.0,18,33,-15
LBN,KWT,2019.0,2,1,1
RUS,NGA,2006.0,1,1,0
MAR,DZA,2011.0,1,2,-1
SGP,GBR,1997.0,10,30,-20
CAN,HKG,1997.0,25,10,15
JPN,PRT,2009.0,5,1,4
KOR,TWN,2013.0,9,15,-6
BFA,CHE,2017.0,2,2,0
HUN,SWE,2010.0,14,7,7
BEL,COG,2012.0,12,1,11
COL,GBR,2015.0,9,21,-12
MLT,GBR,2011.0,10,7,3
CHL,PER,2007.0,9,2,7
SVN,DEU,2013.0,8,4,4
NZL,ARG,2013.0,2,2,0
TZA,GBR,2016.0,10,11,-1
PER,ESP,2003.0,4,2,2
ROU,DEU,2007.0,24,24,0
BEN,CAN,2009.0,3,2,1
CHN,BGD,2008.0,1,1,0
SYR,JPN,2013.0,1,1,0
DNK,SRB,2014.0,2,2,0
LBN,EGY,2023.0,3,2,1
YEM,MYS,2010.0,3,5,-2
TUR,DNK,2012.0,6,3,3
OMN,FRA,2018.0,1,1,0
VNM,CZE,2017.0,3,2,1
ARM,USA,2008.0,2,3,-1
ESP,DZA,2011.0,3,2,1
BRA,BEL,2010.0,19,11,8
TUN,MAR,2012.0,1,1,0
FJI,AUS,2012.0,12,4,8
AUS,EST,2021.0,3,2,1
AUS,EST,2019.0,1,2,-1
SWE,TZA,2012.0,7,3,4
RWA,TZA,2020.0,1,8,-7
POL,CZE,2014.0,15,12,3
SDN,IND,2012.0,1,1,0
LBN,LBY,2018.0,1,2,-1
CYP,GBR,2013.0,10,31,-21
IRL,SRB,2012.0,1,2,-1
TWN,VNM,2011.0,7,3,4
TGO,FRA,2011.0,2,5,-3
NLD,ISR,2014.0,9,9,0
BRN,GBR,2019.0,4,6,-2
CHL,CHN,2014.0,5,7,-2
IRN,ARM,2016.0,1,4,-3
COL,CHE,2010.0,6,2,4
SAU,MEX,2019.0,1,3,-2
THA,CHN,2007.0,2,11,-9
MWI,ZAF,2019.0,6,12,-6
CHE,LUX,2006.0,3,1,2
CHN,CYP,2023.0,1,1,0
THA,BEL,2016.0,4,5,-1
RUS,UZB,2023.0,8,4,4
ROU,BEL,2017.0,7,9,-2
KOR,ARE,2015.0,4,1,3
FRA,LTU,2018.0,3,4,-1
HUN,UKR,2012.0,3,2,1
CMR,ETH,2022.0,1,1,0
NLD,HUN,2023.0,5,8,-3
CHE,KGZ,2018.0,2,2,0
SAU,FRA,2014.0,7,42,-35
PHL,TWN,2014.0,5,9,-4
KOR,LAO,2017.0,2,1,1
AUT,JPN,2013.0,9,13,-4
IRQ,FRA,2022.0,4,5,-1
CAN,COL,2015.0,20,13,7
NOR,IND,2020.0,12,42,-30
HKG,FRA,2013.0,6,7,-1
ARE,IND,2011.0,4,22,-18
MLI,SEN,2021.0,2,1,1
SEN,GBR,2022.0,2,2,0
SGP,THA,2019.0,5,5,0
SRB,RUS,2018.0,8,12,-4
AUT,MEX,2016.0,5,5,0
MYS,CHN,2013.0,8,10,-2
ITA,SAU,2010.0,6,1,5
MEX,PER,2011.0,7,4,3
FRA,PER,2017.0,8,5,3
VEN,JPN,2013.0,1,1,0
CHE,MEX,2016.0,13,9,4
ZAF,PAK,2020.0,5,3,2
SEN,BEL,2018.0,1,2,-1
ITA,SVN,2011.0,8,5,3
JPN,BEL,2020.0,19,13,6
EST,CAN,2019.0,3,3,0
QAT,FRA,2023.0,2,7,-5
UGA,KEN,2016.0,4,11,-7
RUS,MDA,2014.0,4,4,0
NGA,NER,2019.0,7,11,-4
BRA,BOL,2013.0,2,2,0
LVA,CHE,2018.0,6,2,4
PRT,EGY,2006.0,2,2,0
COG,GBR,2015.0,2,1,1
DNK,SGP,2018.0,3,4,-1
TWN,ESP,2014.0,3,4,-1
DNK,FIN,2018.0,20,24,-4
RUS,IRL,2016.0,2,3,-1
MYS,OMN,2017.0,18,2,16
AUT,THA,2016.0,4,6,-2
IDN,DEU,2015.0,12,29,-17
ISR,IRN,2017.0,1,1,0
MDG,FRA,2019.0,11,12,-1
FRA,AUT,2014.0,38,27,11
COL,NZL,2010.0,2,1,1
USA,TJK,2010.0,2,1,1
PHL,CAN,2014.0,5,1,4
RUS,TUR,2016.0,2,5,-3
DEU,SRB,2016.0,11,19,-8
MEX,AUS,2017.0,8,13,-5
IND,CHL,2021.0,13,6,7
BEL,SAU,2021.0,5,2,3
COG,USA,1999.0,1,2,-1
TWN,AUT,2020.0,3,2,1
BGR,PRT,2014.0,2,3,-1
NGA,FRA,2007.0,2,2,0
NLD,KEN,2018.0,4,11,-7
CMR,CAN,2010.0,3,4,-1
AUT,NOR,2019.0,16,11,5
LKA,DEU,2018.0,2,3,-1
SWE,THA,2017.0,16,7,9
THA,BEL,2018.0,3,2,1
LVA,USA,2020.0,2,4,-2
ITA,UKR,2021.0,7,7,0
KOR,NOR,2019.0,11,3,8
ARG,GBR,2023.0,13,8,5
BRA,IRQ,2018.0,1,1,0
AUT,CRI,2020.0,1,1,0
FIN,IRN,2018.0,3,15,-12
MAC,MAR,2013.0,8,12,-4
HKG,IRN,2018.0,5,5,0
BEL,POL,2016.0,16,7,9
USA,MDG,2016.0,4,3,1
CAN,SVN,2020.0,4,2,2
SVN,CAN,2021.0,4,3,1
QAT,CHN,2022.0,4,4,0
SDN,MYS,2018.0,5,14,-9
MYS,NOR,2021.0,5,1,4
SWE,VNM,2003.0,2,1,1
CAN,MAR,2016.0,10,8,2
ITA,LKA,2019.0,1,1,0
ITA,DZA,2017.0,3,5,-2
EGY,YEM,2016.0,5,4,1
KOR,EST,2020.0,2,1,1
TUR,DEU,1998.0,9,10,-1
ITA,CZE,2012.0,8,5,3
IDN,FRA,2015.0,4,11,-7
DEU,IRQ,2019.0,12,3,9
CHL,TWN,2020.0,3,1,2
COL,ZAF,2016.0,2,2,0
GBR,GEO,2015.0,3,1,2
BEL,SVK,2013.0,1,3,-2
USA,EST,2021.0,11,6,5
LKA,CAN,2015.0,2,5,-3
TWN,ESP,2015.0,3,4,-1
TGO,FRA,2021.0,6,2,4
IDN,HUN,2020.0,2,2,0
NGA,NER,2021.0,3,2,1
CUB,FRA,2020.0,6,2,4
BTN,AUS,2021.0,5,1,4
MYS,DZA,2019.0,4,1,3
FIN,EGY,2016.0,5,3,2
MYS,PRT,2019.0,2,3,-1
HKG,IRN,2017.0,3,4,-1
ARG,VEN,2019.0,3,8,-5
BRA,NZL,2022.0,6,7,-1
NLD,GHA,2018.0,3,5,-2
SYR,IND,2021.0,1,2,-1
PSE,MYS,2016.0,3,12,-9
CAN,JAM,2015.0,2,5,-3
THA,BTN,2020.0,4,3,1
HKG,SAU,2017.0,1,5,-4
IDN,CHE,2020.0,2,1,1
USA,SWE,2024.0,1,2,-1
SRB,CAN,2022.0,2,4,-2
GBR,LKA,2001.0,4,10,-6
TTO,USA,2005.0,6,3,3
NZL,VNM,2021.0,6,3,3
CHL,AUT,2021.0,7,5,2
ARG,JPN,2019.0,3,1,2
EST,DEU,2022.0,10,9,1
KAZ,CZE,2016.0,1,2,-1
BRB,CAN,2022.0,1,1,0
SRB,MNE,2015.0,10,7,3
CAN,IRQ,2022.0,3,3,0
JOR,CAN,2020.0,19,20,-1
GBR,ECU,2022.0,12,7,5
GBR,REU,2022.0,1,1,0
ROU,NLD,2010.0,6,6,0
FIN,LBN,2022.0,1,1,0
ARG,ECU,2020.0,5,9,-4
JOR,EGY,2022.0,4,11,-7
GBR,LBN,2023.0,7,14,-7
USA,NIC,2011.0,3,12,-9
IRQ,EGY,2023.0,5,7,-2
LTU,AUS,2022.0,2,1,1
IRN,SGP,2023.0,5,2,3
GRC,FIN,2020.0,6,3,3
CHE,COL,2013.0,1,5,-4
JPN,OMN,2018.0,2,1,1
EGY,JPN,2023.0,26,30,-4
GBR,TTO,2022.0,5,5,0
ZAF,EGY,2018.0,4,3,1
GUY,NGA,2020.0,4,1,3
IND,IRQ,2022.0,6,2,4
PAK,BEL,2017.0,4,1,3
PSE,ISR,2022.0,5,14,-9
GUF,GLP,2004.0,1,1,0
UKR,BLR,2002.0,6,3,3
FJI,NZL,2009.0,1,2,-1
SLV,SVN,2002.0,4,1,3
AUS,ITA,2005.0,25,18,7
KEN,KOR,2014.0,2,1,1
SWE,PRT,2004.0,5,8,-3
ITA,KEN,2002.0,1,1,0
TWN,NZL,2002.0,1,2,-1
SGP,HKG,1998.0,10,13,-3
CAN,KWT,1999.0,5,1,4
JPN,KEN,2006.0,7,4,3
FRA,COL,1999.0,4,3,1
ZAF,NAM,2004.0,5,3,2
JPN,PRT,2021.0,1,4,-3
JPN,PAK,2009.0,13,6,7
CHL,JPN,2013.0,3,5,-2
NZL,SWE,1999.0,5,5,0
GBR,PNG,1999.0,2,3,-1
CHE,MEX,2017.0,11,10,1
ESP,BOL,2012.0,1,2,-1
ITA,VNM,2004.0,1,1,0
VNM,USA,2007.0,4,9,-5
SAU,GBR,1998.0,4,14,-10
NZL,JPN,2004.0,5,15,-10
NZL,JPN,2015.0,10,3,7
PRY,ESP,2012.0,1,4,-3
BRA,CUB,2002.0,6,12,-6
DNK,NZL,2012.0,6,6,0
KOR,NZL,2006.0,5,3,2
SWE,ARG,2013.0,4,5,-1
BGR,UKR,2001.0,4,1,3
LUX,DEU,2007.0,3,22,-19
USA,AFG,2020.0,6,27,-21
BGR,ITA,1997.0,4,6,-2
CZE,TWN,2017.0,1,2,-1
GRC,ESP,2005.0,6,5,1
ARE,AUS,2005.0,4,8,-4
ITA,MLI,2000.0,3,1,2
FRA,PHL,2003.0,1,2,-1
BEL,SWE,1997.0,6,8,-2
URY,SWE,2013.0,1,3,-2
MEX,ISR,2006.0,3,3,0
ISR,CHN,2000.0,3,14,-11
IDN,BGD,2017.0,1,2,-1
PHL,IND,2012.0,2,4,-2
GBR,CYP,2001.0,7,5,2
CHN,ITA,2001.0,12,11,1
CHN,CUB,2021.0,1,4,-3
NZL,CHL,2022.0,4,2,2
MAC,TWN,2016.0,2,2,0
DEU,BGD,2012.0,9,8,1
JOR,PAK,2023.0,1,2,-1
GBR,QAT,2009.0,3,2,1
DNK,ARE,2017.0,1,1,0
KOR,AUT,2013.0,4,1,3
GUM,USA,2013.0,5,7,-2
GBR,CMR,2012.0,1,2,-1
USA,GTM,2005.0,7,2,5
NZL,PHL,2021.0,2,1,1
PRT,FIN,2007.0,3,1,2
AUS,MMR,2021.0,6,1,5
CHN,BLR,2021.0,3,3,0
LKA,THA,2017.0,2,3,-1
TWN,NGA,2023.0,1,3,-2
CAN,EST,2022.0,4,1,3
LBY,GBR,2022.0,5,9,-4
SRB,GBR,2022.0,9,11,-2
ARE,BGD,2022.0,2,1,1
IRN,JPN,2022.0,11,9,2
NZL,MYS,2010.0,15,10,5
COL,CHE,2023.0,3,4,-1
DNK,EGY,2013.0,5,3,2
BLR,POL,2020.0,3,5,-2
LTU,BRA,2019.0,1,1,0
PHL,IDN,2007.0,2,1,1
FRA,ISL,2006.0,2,1,1
FRA,EGY,2009.0,14,12,2
AUS,NOR,2009.0,13,13,0
NOR,NZL,2013.0,4,3,1
BGR,AUT,1999.0,4,1,3
IND,BHR,2005.0,3,2,1
BEL,KEN,1999.0,2,2,0
MLI,SEN,2009.0,2,1,1
SRB,MNE,2004.0,7,7,0
TUR,ITA,2005.0,6,5,1
CHE,TUR,1997.0,3,5,-2
MEX,IND,2002.0,3,3,0
RUS,TUR,2022.0,7,2,5
BEL,KEN,1998.0,4,2,2
SWE,GRC,2001.0,8,4,4
ZAF,CIV,2000.0,1,6,-5
CIV,USA,2003.0,5,4,1
MEX,AUT,1998.0,2,1,1
POL,MEX,2006.0,1,1,0
BEL,ARG,2003.0,1,5,-4
NZL,FRA,1998.0,3,5,-2
ISR,JPN,2013.0,1,7,-6
CHL,DEU,2004.0,13,10,3
HKG,NLD,1997.0,1,1,0
USA,LUX,2011.0,8,4,4
CAN,GRD,2008.0,1,1,0
CHE,HUN,2007.0,8,12,-4
SEN,USA,1997.0,3,1,2
USA,NPL,1998.0,4,3,1
MEX,COL,2001.0,5,3,2
THA,IDN,2013.0,2,5,-3
ZAF,CAN,2004.0,10,9,1
QAT,SRB,2018.0,5,2,3
MEX,PER,2009.0,3,3,0
AUT,NZL,2011.0,4,5,-1
CHE,KEN,2014.0,6,1,5
SRB,DEU,2004.0,20,32,-12
NLD,MYS,2013.0,6,8,-2
GRC,DNK,2000.0,2,2,0
BLR,ITA,2015.0,2,1,1
DZA,CAN,1998.0,1,2,-1
NLD,SRB,2013.0,4,3,1
ITA,SVK,1997.0,5,2,3
LVA,DEU,1998.0,3,1,2
EGY,ESP,2006.0,2,3,-1
LBN,ITA,2002.0,1,1,0
BEN,FRA,2005.0,6,14,-8
LKA,JPN,2004.0,5,9,-4
EGY,DNK,2004.0,3,4,-1
MDA,DEU,1998.0,5,2,3
IRL,BHR,2014.0,2,1,1
ITA,FIN,1997.0,6,6,0
USA,MAR,2012.0,8,5,3
JPN,AUT,1999.0,2,8,-6
CHE,SVN,2008.0,2,2,0
CHE,TUR,2002.0,4,6,-2
MEX,IND,2005.0,2,3,-1
QAT,USA,2003.0,2,8,-6
AUT,DNK,2018.0,10,11,-1
BRB,IND,2012.0,1,2,-1
CHN,AUT,2005.0,7,10,-3
GRC,BGR,2007.0,3,3,0
DNK,SRB,2004.0,5,1,4
RUS,ARM,2000.0,8,3,5
CZE,CHE,1997.0,3,9,-6
KOR,BGD,2000.0,1,2,-1
BRA,VEN,2009.0,6,4,2
BLR,GBR,1998.0,4,4,0
JPN,ISR,2005.0,5,4,1
ECU,DEU,2015.0,4,8,-4
ESP,CHN,1997.0,1,8,-7
NLD,BRA,2010.0,18,24,-6
KEN,MYS,2005.0,1,1,0
COL,GBR,2001.0,6,14,-8
DEU,ROU,2005.0,20,19,1
ESP,RUS,2003.0,10,15,-5
TUR,ESP,2016.0,9,7,2
VEN,GBR,2003.0,9,12,-3
CHE,SEN,2003.0,1,1,0
GBR,JAM,1999.0,6,3,3
SWE,ROU,2002.0,3,3,0
SWE,ROU,2005.0,4,3,1
JOR,KWT,2016.0,7,1,6
BRA,ECU,2011.0,4,1,3
DEU,MYS,2012.0,7,8,-1
MYS,LKA,2013.0,5,1,4
LKA,MYS,2019.0,6,5,1
NOR,KOR,2016.0,5,2,3
SVN,BEL,2020.0,6,7,-1
KOR,DNK,2014.0,12,1,11
GEO,POL,2010.0,2,1,1
NLD,SGP,2013.0,14,10,4
GBR,URY,2012.0,7,1,6
CHL,NLD,2010.0,4,5,-1
URY,MEX,2014.0,2,4,-2
VEN,BRA,2003.0,3,12,-9
BEL,BFA,2009.0,4,1,3
PRT,AUS,2014.0,9,5,4
ZAF,ISR,2017.0,4,3,1
MDA,RUS,2018.0,4,4,0
CZE,IRL,2018.0,5,2,3
ARG,BEL,2013.0,5,6,-1
AUS,OMN,2009.0,7,4,3
CZE,TUR,2008.0,3,2,1
AUT,FIN,2013.0,9,8,1
DEU,IRQ,2011.0,2,1,1
KEN,CMR,2013.0,2,2,0
BWA,ZAF,2016.0,8,14,-6
ROU,ESP,2014.0,8,6,2
FIN,LTU,2013.0,4,2,2
SGP,IRN,2019.0,11,8,3
CHE,ZAF,2014.0,8,9,-1
LKA,AUS,2009.0,5,2,3
TUR,IRL,2016.0,4,3,1
LKA,AUS,2011.0,12,10,2
IRL,POL,2014.0,3,5,-2
SGP,AUT,2016.0,3,2,1
FIN,KOR,2015.0,4,4,0
IRL,MEX,2017.0,2,3,-1
CHL,CHN,2015.0,8,6,2
CHE,ARM,2018.0,3,1,2
COL,FRA,2017.0,12,32,-20
BFA,CAN,2015.0,3,6,-3
BGD,AUS,2006.0,4,2,2
SRB,TUR,2012.0,6,2,4
MYS,DNK,2012.0,3,1,2
GHA,KEN,2013.0,2,2,0
GBR,BWA,2020.0,5,3,2
IRN,PRT,2012.0,11,1,10
SWE,CHN,1999.0,14,22,-8
KEN,MWI,2019.0,4,4,0
MYS,FIN,2011.0,1,1,0
AZE,IRN,2013.0,5,7,-2
USA,ZMB,2009.0,8,6,2
RUS,ESP,2009.0,15,14,1
CHN,MEX,2000.0,5,2,3
VNM,DEU,2009.0,5,10,-5
QAT,GBR,2015.0,11,51,-40
KOR,TUR,2023.0,4,5,-1
BGR,CHE,2014.0,5,2,3
CHE,BGR,2017.0,3,1,2
ITA,PSE,2017.0,5,1,4
CAN,UKR,2017.0,5,5,0
SAU,MYS,2008.0,1,7,-6
TWN,THA,2014.0,12,4,8
LTU,ITA,2014.0,3,6,-3
CHE,TWN,2015.0,4,11,-7
MEX,ECU,2015.0,14,5,9
ECU,MEX,2018.0,10,17,-7
CAN,JOR,2016.0,11,13,-2
FRA,DJI,2015.0,4,3,1
JPN,MEX,2022.0,5,11,-6
DEU,LIE,2023.0,4,1,3
IND,MYS,2000.0,10,5,5
STP,PRT,2015.0,1,2,-1
HKG,MYS,2020.0,8,5,3
NZL,RUS,2019.0,4,1,3
CHE,CHN,2005.0,18,16,2
CAN,BWA,2020.0,3,2,1
BFA,BEL,2021.0,7,5,2
PRT,CHL,2013.0,4,2,2
AUT,NLD,2004.0,6,7,-1
IRL,AUT,2014.0,4,2,2
HUN,FIN,2021.0,3,4,-1
IRL,AUS,1998.0,13,8,5
SAU,ZAF,2014.0,7,17,-10
UGA,TZA,2013.0,4,6,-2
TWN,NLD,2019.0,1,1,0
AUS,EGY,2015.0,8,9,-1
NLD,CYP,2018.0,1,4,-3
GHA,MLI,2018.0,1,1,0
TTO,KNA,2015.0,3,5,-2
COL,PAN,2014.0,3,2,1
OMN,EGY,2014.0,4,6,-2
SYR,USA,2011.0,2,6,-4
IRL,IRN,2019.0,5,15,-10
BEL,HRV,2015.0,2,3,-1
THA,LAO,2008.0,3,1,2
LAO,THA,2017.0,7,7,0
IDN,AUT,2014.0,1,5,-4
HUN,SRB,2020.0,4,6,-2
THA,RUS,2018.0,2,2,0
SAU,DZA,2017.0,5,5,0
PRT,NZL,2015.0,1,2,-1
ZAF,DNK,2019.0,5,2,3
ETH,KEN,2014.0,4,3,1
IDN,AUT,2015.0,2,3,-1
POL,SGP,2023.0,1,4,-3
CHN,MYS,2017.0,11,55,-44
ZAF,CMR,2011.0,4,6,-2
UGA,RWA,2018.0,3,3,0
BWA,ZAF,2018.0,7,19,-12
PRT,HUN,2016.0,3,2,1
LVA,UKR,2019.0,4,4,0
FRO,NOR,2020.0,2,1,1
AUT,IRN,2015.0,10,11,-1
SVN,ITA,2023.0,4,10,-6
AUS,MKD,2018.0,1,1,0
BEL,HUN,2021.0,6,6,0
ESP,GHA,2023.0,2,1,1
EST,USA,2017.0,6,16,-10
HRV,CZE,2013.0,5,1,4
ITA,UKR,2011.0,3,3,0
NZL,ISR,2020.0,1,2,-1
NLD,TUN,2021.0,2,1,1
EST,FRA,2023.0,1,2,-1
IRN,NZL,2015.0,10,2,8
NOR,BEL,2013.0,3,9,-6
NOR,BRA,2021.0,6,22,-16
ISR,JPN,2003.0,5,7,-2
TTO,USA,2012.0,5,8,-3
UGA,DEU,2012.0,2,1,1
ROU,CHE,2017.0,10,6,4
AUS,UGA,2019.0,4,1,3
ROU,PRT,2020.0,2,7,-5
MLT,ITA,2018.0,4,7,-3
SGP,POL,2018.0,6,2,4
PHL,VNM,2018.0,2,1,1
VNM,PHL,2019.0,2,3,-1
PHL,VNM,2022.0,2,3,-1
ZAF,SGP,2014.0,1,2,-1
NZL,CHN,2000.0,3,6,-3
PRT,POL,2018.0,5,4,1
TWN,ETH,2018.0,3,2,1
SGP,PAK,2013.0,2,2,0
HRV,IND,2020.0,4,1,3
NGA,THA,2023.0,6,4,2
PER,JPN,2015.0,3,3,0
AUS,FJI,2020.0,11,5,6
VNM,SWE,2006.0,2,2,0
HUN,KOR,2021.0,1,2,-1
GRC,TUR,2019.0,5,2,3
ZAF,NZL,2022.0,11,2,9
CUB,PRT,2022.0,1,1,0
MDA,RUS,2022.0,4,1,3
TUR,SAU,2022.0,8,7,1
LKA,MYS,2021.0,6,9,-3
LVA,GBR,2019.0,4,4,0
PAK,AUS,2009.0,6,9,-3
NPL,SWE,2021.0,3,4,-1
PAK,DNK,2016.0,3,2,1
ECU,HUN,2021.0,2,1,1
BRA,IRN,2021.0,2,15,-13
GBR,MAR,2022.0,3,5,-2
QAT,CHN,2016.0,3,1,2
PRT,GHA,2022.0,1,2,-1
BWA,NGA,2021.0,2,3,-1
TWN,MYS,2014.0,7,7,0
DEU,MNG,2022.0,3,4,-1
CHE,SVK,2015.0,3,4,-1
ROU,EGY,2020.0,1,1,0
AFG,IND,2010.0,2,1,1
USA,MDG,2018.0,5,4,1
USA,CUB,2016.0,6,13,-7
CAF,COG,2012.0,1,2,-1
UKR,FRA,2004.0,8,12,-4
KWT,GBR,2007.0,8,7,1
ARE,OMN,2003.0,1,1,0
CHL,COL,2007.0,9,4,5
IDN,NLD,2005.0,5,8,-3
CAN,URY,2016.0,4,4,0
HUN,SRB,2007.0,1,11,-10
CAN,ARM,2012.0,2,3,-1
RUS,UZB,2010.0,7,4,3
LTU,NOR,2002.0,1,6,-5
CAN,ROU,2001.0,2,13,-11
ERI,IND,2011.0,1,2,-1
IDN,JPN,2001.0,19,21,-2
USA,CIV,2006.0,2,2,0
IDN,AUS,2004.0,9,12,-3
NAM,NOR,2004.0,1,1,0
NOR,CHN,2000.0,5,7,-2
OMN,MYS,2013.0,2,7,-5
GBR,MOZ,2005.0,1,1,0
UZB,RUS,2021.0,9,17,-8
URY,ESP,2008.0,10,9,1
SWE,GRC,2004.0,3,4,-1
SVK,POL,1999.0,3,3,0
NZL,ISL,2004.0,1,1,0
SVN,DEU,2003.0,7,6,1
MEX,CRI,2014.0,2,3,-1
DEU,BLR,2010.0,3,13,-10
AUT,FIN,2003.0,4,5,-1
IRN,NZL,2004.0,4,2,2
TUR,BEL,2007.0,8,4,4
KOR,MNG,2007.0,1,1,0
SAU,MAR,2021.0,6,1,5
AUT,ROU,2001.0,5,3,2
ITA,THA,2010.0,1,5,-4
DEU,TZA,2009.0,4,1,3
SWE,BEL,2000.0,6,11,-5
DZA,CHE,2015.0,1,1,0
CZE,AUS,2011.0,3,2,1
EGY,PSE,2003.0,4,1,3
ESP,SRB,2011.0,2,7,-5
YEM,EGY,2014.0,4,5,-1
EGY,YEM,2018.0,9,1,8
CHE,UKR,2018.0,3,7,-4
ZWE,USA,2014.0,6,13,-7
PHL,THA,2012.0,4,2,2
GBR,SYR,2009.0,6,2,4
IDN,FRA,2014.0,16,15,1
LUX,USA,1999.0,1,3,-2
ARG,DZA,2015.0,3,3,0
NLD,ISR,2004.0,6,11,-5
POL,ROU,2006.0,4,1,3
GBR,LBY,2011.0,6,1,5
NLD,HUN,2010.0,9,12,-3
FRA,CMR,2008.0,16,17,-1
GHA,DEU,2011.0,5,5,0
SGP,POL,2017.0,2,3,-1
USA,UGA,2001.0,10,10,0
USA,HTI,2012.0,6,16,-10
NOR,FRA,2007.0,16,26,-10
SVK,UKR,2016.0,2,4,-2
HUN,IRL,2006.0,2,1,1
SWE,THA,2018.0,8,3,5
LUX,AUT,2016.0,4,2,2
NLD,HUN,2006.0,6,8,-2
FRA,MOZ,2008.0,2,3,-1
THA,AUT,2012.0,4,8,-4
BHR,USA,2016.0,5,2,3
THA,FRA,2006.0,9,9,0
ITA,DZA,2018.0,5,2,3
VNM,NGA,2015.0,1,1,0
FIN,BRA,2004.0,1,1,0
USA,BMU,2003.0,2,5,-3
KEN,ITA,2020.0,2,3,-1
IRL,GRC,2019.0,7,8,-1
LSO,USA,2016.0,1,3,-2
USA,BMU,2013.0,3,5,-2
AUS,VEN,2005.0,2,2,0
RUS,EST,2003.0,3,1,2
ZAF,FIN,2012.0,5,1,4
AUT,IRL,2012.0,5,9,-4
MDG,GBR,2020.0,3,4,-1
GRC,CHN,2010.0,1,1,0
ISR,DNK,2013.0,5,2,3
FRA,MDG,2006.0,9,9,0
HKG,TWN,2009.0,9,12,-3
PHL,CAN,2004.0,2,1,1
ISR,BRA,2011.0,4,3,1
TJK,RUS,2012.0,1,1,0
JPN,OMN,2017.0,3,1,2
FRA,GAB,2010.0,6,6,0
UKR,CZE,1998.0,1,3,-2
ZAF,GMB,2007.0,1,1,0
PRT,AUS,2008.0,5,3,2
CHN,IND,2000.0,1,6,-5
MEX,CHN,2013.0,7,4,3
BOL,DEU,2007.0,3,1,2
IND,YEM,2009.0,1,1,0
BEL,CHL,2002.0,2,5,-3
CHE,TWN,2004.0,2,2,0
TUR,JPN,2009.0,8,12,-4
DEU,BEN,2017.0,4,3,1
JPN,ECU,2018.0,2,1,1
USA,GMB,2006.0,1,5,-4
GRC,JPN,2004.0,2,4,-2
ECU,VEN,2014.0,3,15,-12
JPN,NGA,2012.0,4,6,-2
GRC,SRB,2013.0,6,3,3
SWE,LVA,2004.0,5,2,3
ARE,DEU,2012.0,8,7,1
GBR,BGR,2017.0,5,10,-5
ROU,CAN,2002.0,11,5,6
CHL,NZL,2009.0,2,1,1
CUB,CAN,2011.0,4,6,-2
GRC,DNK,2023.0,7,4,3
SYR,EGY,2018.0,3,1,2
SRB,HRV,2008.0,9,15,-6
BEL,BGR,2019.0,7,4,3
JPN,BLR,2014.0,2,1,1
GEO,BEL,2009.0,2,1,1
AUT,ROU,2008.0,3,4,-1
NLD,VNM,2022.0,4,6,-2
CAN,ZWE,2006.0,1,1,0
CHE,NZL,2009.0,10,9,1
NGA,BEN,2014.0,6,7,-1
ZMB,USA,2023.0,8,8,0
NLD,LTU,2012.0,1,1,0
MEX,DNK,2005.0,4,1,3
IRN,CZE,2013.0,4,4,0
BEL,BOL,2010.0,2,2,0
BEL,BOL,2006.0,2,1,1
BEL,SRB,2012.0,4,3,1
USA,SLV,2019.0,6,8,-2
CMR,NER,2009.0,2,2,0
LVA,DEU,2007.0,3,4,-1
ARE,AUS,2012.0,7,8,-1
SWE,MYS,2015.0,4,8,-4
IND,OMN,2008.0,11,5,6
SVN,GBR,2014.0,13,7,6
IRN,SAU,2018.0,1,1,0
ESP,EST,2017.0,4,2,2
CMR,BEL,2010.0,1,6,-5
CAN,JOR,2022.0,12,9,3
SRB,BGR,2006.0,1,4,-3
BEN,ZAF,2017.0,7,2,5
NPL,JPN,2005.0,4,7,-3
AUS,FJI,2007.0,2,9,-7
ROU,HUN,2017.0,14,17,-3
DNK,IND,2016.0,17,21,-4
ISR,ETH,2016.0,1,2,-1
PAK,SAU,2005.0,11,10,1
CHN,TUN,2014.0,1,1,0
BRA,CHE,2013.0,9,13,-4
FIN,IND,2019.0,8,23,-15
CHN,ESP,2006.0,6,4,2
ESP,HKG,2009.0,1,1,0
KHM,CHE,2011.0,2,2,0
MAR,CHE,2021.0,2,3,-1
NOR,ZAF,2009.0,4,3,1
UKR,CAN,2007.0,9,3,6
UGA,NOR,2014.0,2,2,0
YEM,FRA,2009.0,1,1,0
SVK,FRA,2011.0,8,4,4
BRA,BEL,2006.0,10,8,2
USA,DOM,2010.0,5,3,2
HUN,FIN,2009.0,3,5,-2
AUS,RUS,2012.0,3,12,-9
DZA,PRT,2018.0,3,1,2
FLK,AUS,2016.0,1,2,-1
MAR,USA,2009.0,6,5,1
OMN,BRN,2011.0,1,1,0
GRC,TUR,2009.0,5,1,4
ROU,CHE,2018.0,9,10,-1
ROU,CHE,2022.0,8,4,4
SWE,PRT,2015.0,12,15,-3
FIN,KOR,2014.0,3,5,-2
AUS,BTN,2023.0,2,4,-2
ROU,MDA,2020.0,4,8,-4
IND,AUT,2016.0,10,9,1
SGP,ISR,2019.0,7,6,1
BRA,AUT,2017.0,10,9,1
PER,ESP,2013.0,10,17,-7
NER,USA,2017.0,1,2,-1
CIV,TUN,2014.0,1,2,-1
AUT,ROU,2015.0,6,5,1
IRL,CHE,2021.0,12,14,-2
MAR,PRT,2015.0,2,1,1
PRT,MAR,2020.0,4,4,0
SRB,GBR,2017.0,14,7,7
BFA,CAN,2014.0,3,1,2
CAN,BFA,2019.0,1,4,-3
SVN,ITA,2010.0,5,5,0
BEL,PRT,2013.0,7,7,0
NZL,COL,2021.0,1,1,0
BRA,CUB,2012.0,8,9,-1
NOR,ZAF,2021.0,4,9,-5
JOR,ESP,2015.0,2,6,-4
EGY,LBY,2013.0,2,3,-1
EGY,ITA,2016.0,10,18,-8
ARG,IRL,2017.0,1,1,0
BEL,CUB,2016.0,1,8,-7
UGA,NOR,2015.0,4,8,-4
NZL,CHL,2018.0,3,8,-5
IRN,ISL,2017.0,2,2,0
SWE,PHL,2019.0,1,1,0
SRB,ESP,2009.0,2,2,0
DEU,ALB,2016.0,2,1,1
NLD,ZWE,2017.0,4,4,0
MWI,FIN,2019.0,1,1,0
AUT,UKR,2019.0,3,2,1
BEL,SAU,2019.0,5,1,4
HUN,IND,2020.0,8,10,-2
IND,TTO,2012.0,3,2,1
TGO,CHN,2021.0,2,1,1
PRT,COL,2023.0,1,4,-3
SVK,SWE,2020.0,2,1,1
LAO,USA,2020.0,6,3,3
DEU,MDA,2004.0,6,1,5
IRL,MYS,2021.0,6,8,-2
ISL,SWE,2010.0,9,21,-12
MYS,TUR,2012.0,2,1,1
BRA,AUT,2016.0,6,7,-1
ITA,ECU,2014.0,5,1,4
BTN,IND,2021.0,4,5,-1
AUS,CHE,1997.0,10,18,-8
CYP,IRL,2019.0,4,1,3
ZAF,ARE,2023.0,4,2,2
KEN,NOR,2023.0,2,2,0
IDN,AUS,2014.0,19,65,-46
QAT,KOR,2020.0,3,1,2
CAN,PER,2017.0,3,5,-2
LBN,NLD,2021.0,5,6,-1
GBR,SEN,2020.0,2,1,1
MAR,MEX,2020.0,2,1,1
MYS,BEL,2017.0,1,3,-2
BEL,SGP,2023.0,2,2,0
USA,SEN,2016.0,12,16,-4
BGR,GRC,2009.0,1,5,-4
USA,LVA,2014.0,1,4,-3
ZAF,SAU,2000.0,2,3,-1
SVN,AUS,2020.0,5,5,0
CRI,NIC,2016.0,2,1,1
ISR,SGP,2020.0,4,10,-6
DNK,TWN,2020.0,4,1,3
IND,MMR,2017.0,1,1,0
DNK,KOR,2016.0,5,9,-4
BGD,ITA,2015.0,3,3,0
COG,BEL,2019.0,6,5,1
SGP,AUT,2017.0,2,3,-1
NZL,MEX,2021.0,2,1,1
IND,CHE,2015.0,43,32,11
GBR,UKR,2022.0,2,4,-2
GHA,IND,2015.0,2,3,-1
DMA,USA,2016.0,2,1,1
DOM,USA,2023.0,4,3,1
CAN,HKG,2012.0,15,23,-8
AUS,NGA,2021.0,8,10,-2
VIR,USA,2014.0,2,3,-1
DNK,BGD,2023.0,1,1,0
KAZ,HUN,2021.0,4,1,3
TWN,IRL,2021.0,1,1,0
CAN,NZL,2023.0,17,14,3
COL,KEN,2020.0,1,2,-1
AUT,ZAF,2021.0,2,8,-6
FIN,SVK,2020.0,1,2,-1
FRA,PAK,2023.0,13,14,-1
SDN,SSD,2020.0,4,2,2
KEN,DNK,2020.0,1,1,0
HUN,IRL,2000.0,3,1,2
RUS,NZL,1999.0,3,1,2
AZE,TUR,2023.0,4,5,-1
CHE,LUX,2023.0,2,4,-2
COL,ARG,2013.0,11,12,-1
ARM,CHN,2022.0,1,2,-1
PHL,HKG,2022.0,2,1,1
ESP,UKR,2023.0,2,6,-4
BWA,MWI,2020.0,1,1,0
MYS,BHR,2018.0,6,2,4
EST,LTU,2023.0,1,1,0
ALB,ITA,2023.0,2,5,-3
BRA,EGY,2022.0,1,1,0
IND,AUT,2022.0,14,7,7
KHM,FRA,2013.0,2,7,-5
FIN,CZE,2021.0,6,9,-3
MAC,TWN,2017.0,2,2,0
PAK,HUN,2021.0,5,3,2
PSE,JOR,2023.0,3,4,-1
PSE,MYS,2022.0,2,11,-9
HUN,JOR,2023.0,4,1,3
LAO,THA,2022.0,4,4,0
FRA,PYF,2009.0,11,9,2
GBR,PNG,2007.0,3,1,2
SDN,USA,2020.0,5,5,0
EGY,DNK,2001.0,4,4,0
TGO,FRA,2009.0,4,2,2
IRL,RUS,2014.0,3,2,1
SVN,AUT,2005.0,2,3,-1
PHL,DEU,2018.0,6,2,4
GUY,USA,2015.0,2,2,0
AUS,VEN,2002.0,3,1,2
AUS,SRB,2004.0,2,3,-1
ZAF,NLD,2003.0,13,10,3
FRA,ZAF,1997.0,7,3,4
ETH,JPN,2003.0,2,1,1
ISR,UKR,1999.0,3,3,0
THA,PHL,2012.0,2,4,-2
KEN,JPN,2004.0,3,7,-4
FRA,SVN,2004.0,3,1,2
NLD,SVK,2004.0,2,3,-1
SGP,ISR,2011.0,2,5,-3
GHA,UGA,2018.0,3,1,2
CHL,VEN,1999.0,2,1,1
CUB,VEN,2003.0,2,1,1
ESP,MAR,2006.0,10,4,6
DNK,CMR,2010.0,1,1,0
EGY,NOR,2019.0,3,1,2
ITA,ALB,2005.0,2,1,1
GMB,ZAF,2018.0,5,1,4
IRL,ESP,2000.0,4,3,1
RUS,BGR,2010.0,4,3,1
PNG,AUS,1997.0,8,1,7
LUX,DEU,1998.0,2,7,-5
VNM,DNK,2009.0,1,4,-3
SWE,ARE,2010.0,3,2,1
ZAF,RWA,2015.0,1,12,-11
PRT,BGR,2021.0,1,1,0
ISL,SWE,2000.0,4,14,-10
NGA,COG,2015.0,1,1,0
RUS,BGR,2000.0,3,12,-9
BWA,GBR,2002.0,4,2,2
ZAF,FRA,2001.0,7,11,-4
ZAF,MOZ,2009.0,1,1,0
IRL,ISR,2005.0,4,2,2
ITA,URY,2002.0,2,1,1
NOR,FIN,2013.0,9,12,-3
ITA,BGR,2006.0,6,10,-4
KEN,FRA,2000.0,1,1,0
ESP,ROU,1998.0,1,3,-2
FRA,SYR,2006.0,6,6,0
ISR,NOR,2012.0,2,2,0
ITA,VEN,2004.0,1,1,0
ZAF,UGA,2006.0,2,1,1
THA,SGP,2002.0,1,3,-2
POL,AUT,2000.0,7,1,6
SVK,USA,2020.0,7,17,-10
GHA,CAN,1998.0,1,6,-5
ARE,IND,2009.0,3,16,-13
AUS,ESP,1998.0,3,1,2
TWN,HKG,2002.0,5,10,-5
ISR,CHN,2006.0,8,9,-1
GBR,BMU,2012.0,1,1,0
OMN,USA,1999.0,1,5,-4
TWN,ROU,2001.0,2,1,1
HKG,CHE,2010.0,4,6,-2
PRI,GBR,1999.0,1,2,-1
CHE,IRL,2013.0,8,13,-5
CAN,ATG,2017.0,1,1,0
NZL,AUT,2008.0,2,3,-1
AUT,NZL,2009.0,2,2,0
CHN,IRL,2003.0,2,1,1
HKG,SGP,1999.0,15,9,6
FIN,JPN,2005.0,11,11,0
JOR,SYR,2015.0,1,6,-5
NZL,SGP,2002.0,3,6,-3
CHN,ISR,2009.0,10,13,-3
BRB,TTO,2012.0,3,2,1
USA,ZWE,1998.0,7,8,-1
CHE,TWN,2008.0,3,7,-4
TWN,FRA,2001.0,3,9,-6
AUT,CHN,2002.0,6,5,1
ESP,CHN,2005.0,1,2,-1
JAM,GBR,2015.0,3,2,1
HKG,NLD,2002.0,2,3,-1
TWN,HKG,2012.0,4,9,-5
CHE,TWN,2014.0,3,7,-4
IND,IDN,2003.0,3,3,0
POL,SRB,2003.0,3,1,2
JPN,PSE,2013.0,1,1,0
BEL,SVN,2002.0,2,1,1
MYS,ARE,2013.0,6,1,5
NZL,CHE,2011.0,9,8,1
FRA,SRB,2014.0,4,4,0
USA,GEO,1998.0,10,26,-16
USA,MCO,1997.0,1,1,0
LAO,FRA,2008.0,3,1,2
UKR,ISR,2016.0,3,1,2
BEL,NOR,2018.0,9,9,0
GRD,USA,2008.0,3,5,-2
IND,DNK,2009.0,17,4,13
AUS,LBN,2014.0,4,4,0
BEL,EGY,2015.0,8,3,5
THA,TWN,2012.0,2,7,-5
TWN,THA,2015.0,5,2,3
ESP,EUE,2009.0,1,1,0
SGP,PHL,2006.0,5,3,2
HUN,ROU,2007.0,3,6,-3
RUS,ESP,2011.0,15,6,9
CUB,USA,2021.0,5,7,-2
GBR,GMB,2012.0,4,5,-1
NPL,DNK,2000.0,1,1,0
DEU,CMR,2003.0,2,2,0
BEL,HRV,2004.0,3,1,2
NOR,ISL,2012.0,1,10,-9
JPN,KGZ,2016.0,1,1,0
RUS,GRC,2006.0,3,1,2
PAK,IND,2008.0,12,12,0
ALB,NLD,2014.0,1,1,0
RUS,MEX,2013.0,2,4,-2
SVN,JPN,2013.0,2,1,1
POL,PRT,2010.0,8,6,2
PAK,CHN,2004.0,4,3,1
HKG,ITA,2011.0,3,2,1
DEU,LUX,1999.0,2,3,-1
PAK,CHE,1997.0,1,1,0
DNK,NZL,2005.0,5,5,0
FRA,SRB,2015.0,7,6,1
TUR,AUT,2017.0,8,6,2
EGY,AUS,2009.0,2,3,-1
GBR,BMU,2005.0,1,2,-1
ETH,KEN,2015.0,4,2,2
BLR,DEU,2016.0,9,2,7
TZA,DEU,2022.0,6,5,1
JPN,CIV,2016.0,1,1,0
NLD,NGA,2010.0,2,5,-3
BRA,NGA,2010.0,3,1,2
MEX,KOR,2008.0,2,1,1
SAU,AUS,2001.0,1,2,-1
TUR,QAT,2020.0,5,1,4
URY,CHL,2014.0,8,1,7
TZA,ZAF,2023.0,4,5,-1
CRI,ESP,2018.0,6,11,-5
THA,LKA,2011.0,1,1,0
SWE,LVA,2015.0,3,3,0
DEU,MAR,2015.0,7,2,5
IDN,IRQ,2022.0,1,0,1
,GNB,2019.0,7,0,7
,BLR,2020.0,131,0,131
ARE,IRN,2022.0,2,0,2
,BHR,2009.0,39,0,39
BFA,TCD,2021.0,1,0,1
CHE,LKA,2022.0,1,0,1
,MUS,2020.0,12,0,12
BHR,IRL,2022.0,5,0,5
MDG,GMB,2021.0,1,0,1
,FSM,2008.0,4,0,4
ISR,JPN,2007.0,4,0,4
MEX,FIN,2023.0,3,0,3
HRV,RUS,2011.0,1,0,1
ISL,FIN,2022.0,2,0,2
DNK,KEN,2010.0,2,0,2
MDG,IDN,2008.0,1,0,1
GRC,THA,2010.0,2,0,2
BOL,VEN,2020.0,1,0,1
GBR,MUS,2009.0,3,0,3
,DMA,2005.0,4,0,4
MOZ,DNK,2009.0,1,0,1
AUT,MYS,2011.0,3,0,3
ISR,KAZ,2014.0,2,0,2
PAK,FIN,2006.0,1,0,1
POL,JOR,2006.0,2,0,2
MYS,MEX,2007.0,1,0,1
MEX,MYS,2008.0,1,0,1
LKA,ARE,2018.0,2,0,2
GAB,GUF,2007.0,1,0,1
PAK,NLD,1997.0,2,0,2
GIN,,2011.0,4,0,4
BWA,TZA,2014.0,1,0,1
COL,URY,2014.0,1,0,1
GMB,AUS,2018.0,2,0,2
GRL,,2018.0,6,0,6
ARG,LUX,2022.0,1,0,1
FJI,USA,2002.0,1,0,1
FRA,JAM,2020.0,1,0,1
ITA,RWA,2015.0,1,0,1
DEU,PAN,2007.0,2,0,2
TJK,,2010.0,8,0,8
SRB,PRT,2008.0,1,0,1
KOR,AUS,2024.0,1,0,1
PHL,LKA,2021.0,1,0,1
CHN,YEM,2018.0,4,0,4
ARG,LUX,2017.0,1,0,1
SRB,ARE,2016.0,1,0,1
VGB,USA,2012.0,1,0,1
NOR,SDN,2018.0,1,0,1
HND,,2012.0,7,0,7
BGD,EGY,2011.0,3,0,3
NPL,DNK,2022.0,3,0,3
HRV,BGR,2015.0,3,0,3
GRL,,2022.0,10,0,10
KWT,CHN,2013.0,2,0,2
TWN,ARE,2014.0,2,0,2
KHM,DNK,2016.0,1,0,1
KHM,DNK,2022.0,1,0,1
AUT,KAZ,2016.0,3,0,3
UKR,IRN,2016.0,1,0,1
MDG,BEL,2020.0,2,0,2
SDN,QAT,2002.0,1,0,1
BEN,NER,2011.0,2,0,2
MEX,TWN,2022.0,7,0,7
ZAF,UKR,2023.0,6,0,6
FRO,,2020.0,8,0,8
NGA,OMN,2006.0,1,0,1
HTI,,2005.0,1,0,1
PAN,,2000.0,3,0,3
USA,GAB,2004.0,3,0,3
BLR,LVA,2011.0,1,0,1
SLE,SWE,2018.0,1,0,1
NLD,UKR,2017.0,4,0,4
NOR,ERI,2003.0,1,0,1
TZA,AUT,1998.0,1,0,1
SYC,,2010.0,2,0,2
SLV,SWE,1997.0,1,0,1
BLR,NLD,2012.0,1,0,1
LUX,AUT,2006.0,1,0,1
NIC,,2001.0,4,0,4
GUM,,2022.0,14,0,14
NIC,AUS,2007.0,1,0,1
,IOT,2018.0,1,0,1
GTM,NLD,2022.0,2,0,2
,MHL,2019.0,5,0,5
ROU,RUS,2022.0,1,0,1
HRV,CHN,2022.0,2,0,2
ITA,BEN,2019.0,1,0,1
SVN,FRA,1997.0,2,0,2
BIH,AUS,2012.0,1,0,1
MEX,MAR,2003.0,1,0,1
CHL,EGY,1999.0,1,0,1
PAK,OMN,2004.0,2,0,2
ITA,CHL,1998.0,4,0,4
NPL,THA,2004.0,1,0,1
ITA,VEN,1997.0,3,0,3
BDI,CHE,2002.0,1,0,1
CIV,TUN,2002.0,1,0,1
TUN,CIV,2007.0,1,0,1
ARM,TWN,2010.0,3,0,3
USA,COD,2013.0,3,0,3
DNK,SGP,2000.0,1,0,1
TUR,PRT,2000.0,1,0,1
PRT,TUR,2002.0,1,0,1
HKG,COL,2012.0,2,0,2
MEX,PRI,2002.0,3,0,3
ARM,MEX,1999.0,1,0,1
MDA,GBR,1998.0,1,0,1
DZA,JPN,2003.0,2,0,2
USA,NAM,2011.0,1,0,1
FIN,NGA,1997.0,1,0,1
ISR,ARG,2008.0,2,0,2
USA,LSO,2012.0,3,0,3
LKA,KWT,2008.0,1,0,1
AZE,GBR,2001.0,2,0,2
COL,NLD,2002.0,2,0,2
IRN,CHE,1999.0,3,0,3
,DJI,1994.0,2,0,2
NZL,BGD,1997.0,1,0,1
CAN,UZB,1999.0,2,0,2
TTO,GLP,2003.0,1,0,1
ISR,LTU,2001.0,1,0,1
YEM,JOR,1997.0,1,0,1
SEN,GMB,2006.0,1,0,1
FIN,LTU,1999.0,1,0,1
NLD,BIH,2006.0,4,0,4
CAF,MWI,2001.0,1,0,1
DZA,ARE,2002.0,1,0,1
DNK,MDG,2009.0,1,0,1
ZMB,,2004.0,3,0,3
MDG,IND,2014.0,2,0,2
MEX,ECU,1997.0,2,0,2
LKA,CHE,2009.0,1,0,1
HUN,POL,2000.0,3,0,3
BRB,,2004.0,4,0,4
ARM,ISR,2001.0,1,0,1
NGA,BEL,2001.0,2,0,2
BRN,GHA,2005.0,1,0,1
,HTI,1996.0,10,0,10
PRT,AGO,2010.0,1,0,1
DZA,AUS,2023.0,1,0,1
EGY,ROU,2013.0,1,0,1
PAK,CMR,2015.0,1,0,1
KWT,IDN,2006.0,1,0,1
TTO,,2000.0,7,0,7
GUF,CHE,2012.0,1,0,1
ISR,CHL,2010.0,2,0,2
CHN,TZA,2011.0,2,0,2
UKR,PAK,2017.0,1,0,1
ARG,ARM,2017.0,1,0,1
DEU,MCO,2011.0,1,0,1
NAM,SWE,2010.0,1,0,1
BFA,NOR,2017.0,2,0,2
IND,IRQ,2010.0,7,0,7
MAC,,2011.0,14,0,14
PAK,YEM,2009.0,1,0,1
MAR,SYR,2019.0,3,0,3
GRC,KEN,2010.0,1,0,1
KEN,DNK,2013.0,4,0,4
MYS,SEN,2011.0,1,0,1
BIH,CHE,2016.0,2,0,2
FRA,BDI,2019.0,2,0,2
LBN,OMN,2022.0,3,0,3
CUB,PER,2022.0,3,0,3
KWT,YEM,2007.0,1,0,1
VEN,ITA,2011.0,2,0,2
CHN,CYP,2016.0,1,0,1
CYP,CHE,2016.0,3,0,3
GHA,BOL,2014.0,1,0,1
SWZ,,2013.0,5,0,5
GIB,,2014.0,2,0,2
CHN,NAM,2015.0,1,0,1
TZA,CAN,2008.0,1,0,1
MEX,PRI,2012.0,3,0,3
,BRN,2009.0,37,0,37
MYS,PER,2019.0,2,0,2
NZL,ECU,2011.0,1,0,1
ISR,QAT,2018.0,3,0,3
TUN,EST,2019.0,1,0,1
SYR,IRQ,2017.0,2,0,2
KOR,CZE,2010.0,2,0,2
KEN,SEN,2013.0,2,0,2
,SMR,2003.0,1,0,1
LSO,USA,2023.0,5,0,5
NGA,MDG,2014.0,1,0,1
SDN,ITA,2014.0,1,0,1
JOR,KWT,2010.0,4,0,4
VNM,GHA,2011.0,1,0,1
CHL,KOR,2023.0,1,0,1
FRA,GMB,2019.0,2,0,2
MEX,HRV,2019.0,1,0,1
ZMB,NOR,2023.0,1,0,1
NPL,CAN,2009.0,1,0,1
CHE,CIV,2021.0,2,0,2
EGY,SGP,2019.0,5,0,5
TUN,MYS,2017.0,1,0,1
AUS,SVK,2023.0,1,0,1
BRA,COG,2013.0,3,0,3
EGY,KOR,2024.0,1,0,1
BEN,KEN,2017.0,1,0,1
THA,ZWE,2016.0,1,0,1
ARG,GTM,2023.0,2,0,2
THA,LTU,2016.0,1,0,1
LTU,THA,2018.0,1,0,1
GBR,MLI,2017.0,5,0,5
PRI,GBR,2013.0,4,0,4
JPN,ZWE,2021.0,1,0,1
DZA,KWT,2020.0,1,0,1
BRA,QAT,2022.0,1,0,1
IND,TLS,2022.0,1,0,1
BIH,EGY,2019.0,1,0,1
,LAO,2017.0,37,0,37
,BRB,2016.0,11,0,11
SVK,UGA,2020.0,1,0,1
CHN,SEN,2010.0,1,0,1
,ASM,2017.0,1,0,1
PER,HKG,2020.0,1,0,1
ALB,USA,2023.0,2,0,2
ARG,QAT,2022.0,1,0,1
GBR,DOM,2022.0,2,0,2
SVK,THA,2022.0,1,0,1
,CAF,2019.0,10,0,10
GMB,BEL,2004.0,2,0,2
NER,CZE,2022.0,1,0,1
FJI,FRA,2022.0,1,0,1
,BEN,2020.0,63,0,63
PRT,THA,2021.0,3,0,3
,FIN,2021.0,14,0,14
SXM,,2025.0,3,0,3
VEN,ISR,1999.0,1,0,1
ISR,BLR,1999.0,1,0,1
ARG,HND,2019.0,1,0,1
RWA,USA,2006.0,1,0,1
BRA,THA,2001.0,1,0,1
GBR,FJI,2015.0,2,0,2
CHE,CYP,1999.0,2,0,2
BGD,SWE,2006.0,2,0,2
NPL,GBR,1999.0,3,0,3
ESP,BOL,2008.0,4,0,4
EGY,KAZ,2020.0,1,0,1
AUS,KWT,2000.0,4,0,4
BRN,SGP,2023.0,1,0,1
,LIE,1995.0,12,0,12
CAN,PRI,2016.0,2,0,2
PAK,IND,1997.0,6,0,6
CAF,NLD,1999.0,1,0,1
NZL,KOR,1999.0,1,0,1
,MAC,1996.0,7,0,7
,GUY,2000.0,4,0,4
MLT,AUS,1999.0,1,0,1
AUS,FLK,2004.0,1,0,1
LIE,,2005.0,3,0,3
PHL,VNM,2010.0,2,0,2
ARE,CHN,2003.0,2,0,2
,VUT,2015.0,4,0,4
,GBR,2021.0,65,0,65
POL,TTO,2018.0,1,0,1
PAK,BHR,2015.0,4,0,4
TWN,FIN,2013.0,2,0,2
SVK,SRB,2021.0,1,0,1
IND,EST,2007.0,1,0,1
NER,COM,1999.0,1,0,1
EST,NZL,2019.0,3,0,3
,PRY,2009.0,33,0,33
SEN,AUT,2017.0,1,0,1
VEN,KOR,2022.0,1,0,1
LUX,CHN,2003.0,1,0,1
USA,ERI,2023.0,1,0,1
DNK,GNB,2023.0,2,0,2
CRI,ITA,2023.0,2,0,2
IND,SLE,2019.0,1,0,1
BEN,ZAF,2023.0,1,0,1
BLR,IRQ,2022.0,2,0,2
MYS,BHR,2023.0,5,0,5
MAR,AUS,2005.0,1,0,1
ZAF,GEO,1999.0,1,0,1
SDN,ITA,2004.0,1,0,1
USA,UGA,1997.0,3,0,3
TUN,GHA,2009.0,1,0,1
GHA,TUN,2011.0,1,0,1
ZAF,HRV,2003.0,1,0,1
FJI,VUT,2015.0,3,0,3
TTO,TCA,2020.0,1,0,1
NZL,KEN,2002.0,2,0,2
ALB,USA,2000.0,3,0,3
SWE,SRB,2010.0,2,0,2
FRA,AGO,2002.0,2,0,2
IRL,SAU,2009.0,2,0,2
BIH,ITA,2011.0,2,0,2
BRA,ZAF,1999.0,1,0,1
MAR,BRA,2018.0,1,0,1
NLD,KEN,2000.0,4,0,4
ARG,URY,2004.0,2,0,2
SAU,DZA,2000.0,1,0,1
ISL,JPN,1999.0,1,0,1
KWT,JPN,2002.0,1,0,1
NZL,EGY,2002.0,1,0,1
ITA,IRL,2024.0,1,0,1
MLT,,2003.0,5,0,5
AUS,GIB,2015.0,1,0,1
ZAF,KEN,2000.0,2,0,2
HRV,SWE,1997.0,1,0,1
CRI,MEX,1999.0,1,0,1
WSM,,2011.0,1,0,1
YEM,BHR,2016.0,1,0,1
BIH,MNE,2013.0,1,0,1
MDA,EST,2013.0,2,0,2
SUR,CHE,2021.0,1,0,1
ISR,LTU,2014.0,2,0,2
BFA,GAB,2011.0,2,0,2
URY,GBR,2008.0,2,0,2
CHE,MYS,2008.0,2,0,2
ZWE,BRA,2011.0,1,0,1
NLD,JOR,2010.0,2,0,2
PAK,QAT,2010.0,2,0,2
CHN,IDN,2011.0,2,0,2
BFA,SWZ,2016.0,1,0,1
IRN,PRT,2008.0,3,0,3
SDN,BEL,2011.0,1,0,1
NLD,TWN,2006.0,4,0,4
CHN,BWA,2020.0,1,0,1
GRC,LUX,2016.0,4,0,4
MYS,MMR,2014.0,3,0,3
MMR,SGP,2023.0,2,0,2
TUN,RUS,2010.0,1,0,1
NLD,ZMB,2012.0,1,0,1
LKA,FIN,2016.0,1,0,1
LKA,ZAF,2015.0,1,0,1
TUN,MEX,2015.0,1,0,1
SRB,TUR,2008.0,1,0,1
DEU,AFG,2005.0,1,0,1
NOR,EGY,2016.0,1,0,1
SVN,ZAF,2012.0,1,0,1
NGA,BRN,2023.0,1,0,1
TUR,OMN,2022.0,6,0,6
,DJI,2011.0,7,0,7
NLD,BFA,2016.0,1,0,1
,NCL,2005.0,22,0,22
ITA,URY,2001.0,1,0,1
IDN,GTM,2016.0,1,0,1
GBR,CYM,2007.0,1,0,1
ZAF,CHL,2014.0,4,0,4
NAM,CHE,2021.0,3,0,3
PRT,SGP,2016.0,2,0,2
DEU,LBY,2019.0,3,0,3
GBR,TCD,2016.0,2,0,2
ISR,GHA,2018.0,1,0,1
BEL,TZA,2017.0,8,0,8
SVK,SLV,2021.0,2,0,2
SEN,ESP,2018.0,3,0,3
NGA,THA,2017.0,2,0,2
ISL,PRT,2017.0,1,0,1
KOR,MMR,2007.0,2,0,2
TUR,ALB,2012.0,4,0,4
ZWE,THA,2020.0,2,0,2
GBR,FRO,2015.0,2,0,2
RUS,YEM,2012.0,1,0,1
COM,MDV,2019.0,1,0,1
BRN,,2005.0,3,0,3
BLZ,,2019.0,12,0,12
CUB,PER,2017.0,2,0,2
VEN,SLV,2008.0,1,0,1
GRC,CHL,2015.0,2,0,2
LBR,FRA,2022.0,2,0,2
CHL,RUS,2009.0,2,0,2
COL,KOR,2020.0,1,0,1
PSE,ROU,2022.0,1,0,1
CIV,ITA,2008.0,2,0,2
DNK,SLB,2015.0,1,0,1
ETH,RUS,2023.0,1,0,1
HRV,JPN,2003.0,1,0,1
ISR,NZL,1998.0,1,0,1
MEX,CZE,2006.0,4,0,4
RUS,SVK,2005.0,4,0,4
CUW,,2022.0,3,0,3
IRN,IDN,2023.0,2,0,2
ITA,OMN,2013.0,1,0,1
,BLZ,2017.0,9,0,9
ZWE,PNG,2023.0,1,0,1
JAM,NZL,2022.0,1,0,1
TGO,TUN,2000.0,1,0,1
TUR,BIH,2007.0,2,0,2
IRL,ISL,2003.0,2,0,2
AUS,ZMB,2006.0,1,0,1
SLE,USA,1999.0,3,0,3
FSM,USA,2000.0,2,0,2
TUN,SYR,2012.0,1,0,1
JOR,TUN,2021.0,4,0,4
PRT,MAC,2015.0,2,0,2
PER,MLI,2010.0,1,0,1
NER,,2000.0,1,0,1
,REU,1997.0,3,0,3
ECU,MEX,2006.0,2,0,2
GLP,,2006.0,6,0,6
ESP,MNP,2012.0,1,0,1
BRA,JOR,2007.0,1,0,1
GUF,GUY,1997.0,1,0,1
JOR,FRA,2008.0,3,0,3
CIV,,2002.0,11,0,11
VNM,BWA,2018.0,1,0,1
CUB,PRI,2017.0,2,0,2
JPN,TUN,2002.0,1,0,1
ZAF,CAF,2011.0,1,0,1
RUS,MKD,2008.0,1,0,1
BGR,AUS,2019.0,3,0,3
ITA,ECU,1997.0,1,0,1
,MNG,1995.0,22,0,22
TZA,,2004.0,19,0,19
FRA,SPM,2010.0,1,0,1
BEN,GIN,2019.0,2,0,2
EGY,BRA,2005.0,4,0,4
TZA,KEN,2001.0,1,0,1
AUT,CYP,2005.0,2,0,2
GRC,ISR,1999.0,3,0,3
MUS,,2005.0,4,0,4
,KGZ,1996.0,17,0,17
BFA,NGA,2003.0,4,0,4
GBR,MKD,2008.0,1,0,1
SLE,,2011.0,3,0,3
BFA,GBR,2007.0,1,0,1
MAR,MCO,2009.0,1,0,1
FRA,OMN,2000.0,1,0,1
CMR,IDN,2019.0,2,0,2
YEM,SAU,2010.0,2,0,2
BRN,FRA,2009.0,1,0,1
BGR,OMN,2010.0,1,0,1
RUS,PAN,1999.0,1,0,1
HKG,PHL,2005.0,1,0,1
BEL,LSO,2015.0,1,0,1
MYS,QAT,2013.0,3,0,3
FRA,RWA,2016.0,2,0,2
DEU,MLT,2004.0,2,0,2
HKG,ARG,2006.0,1,0,1
HKG,NLD,2004.0,1,0,1
BOL,SRB,2005.0,1,0,1
NCL,USA,2019.0,5,0,5
VEN,PRI,2017.0,2,0,2
AUS,SRB,2002.0,1,0,1
ARE,UKR,2011.0,1,0,1
URY,SWE,1998.0,3,0,3
ROU,ARE,2015.0,1,0,1
BRA,KOR,2003.0,1,0,1
CAN,BGR,2017.0,2,0,2
TUN,ZAF,2006.0,2,0,2
AUS,MOZ,2016.0,1,0,1
SVK,KHM,2006.0,1,0,1
KOR,BHR,2010.0,1,0,1
AUS,UKR,2010.0,1,0,1
FIN,SDN,2008.0,1,0,1
ISR,HRV,2013.0,1,0,1
BRA,SVN,2009.0,1,0,1
SVK,ISR,2007.0,1,0,1
WSM,USA,2011.0,2,0,2
ARE,BHR,1999.0,2,0,2
CRI,ECU,2014.0,1,0,1
CYP,KGZ,2014.0,1,0,1
CHN,SWZ,2010.0,1,0,1
EGY,POL,2004.0,1,0,1
SYR,,1999.0,4,0,4
CAN,MAC,2003.0,1,0,1
FRA,CAF,2020.0,7,0,7
CAF,,2022.0,15,0,15
MYS,FJI,2017.0,1,0,1
JAM,BHS,2006.0,1,0,1
CIV,BRA,2009.0,2,0,2
ZMB,SWE,2008.0,1,0,1
CHE,ALB,2011.0,1,0,1
OMN,ARE,2023.0,4,0,4
IRL,IDN,2015.0,1,0,1
GRL,CAN,2017.0,1,0,1
NPL,MUS,2014.0,2,0,2
CZE,YEM,2012.0,2,0,2
KGZ,ESP,2018.0,1,0,1
ETH,CAN,2005.0,2,0,2
MEX,TZA,2008.0,1,0,1
MWI,ETH,2015.0,1,0,1
ETH,MWI,2021.0,1,0,1
TUN,NER,2004.0,1,0,1
ZAF,FIN,2008.0,2,0,2
TON,,2016.0,2,0,2
IND,TTO,2008.0,5,0,5
,NCL,2002.0,6,0,6
CMR,ESP,2004.0,1,0,1
DEU,LKA,2013.0,1,0,1
NOR,NAM,2012.0,1,0,1
CYP,ITA,2021.0,2,0,2
PER,ITA,2003.0,1,0,1
DEU,MNE,2020.0,1,0,1
CHE,NPL,2008.0,1,0,1
DEU,BOL,2023.0,1,0,1
MEX,HRV,2011.0,1,0,1
ZMB,DEU,2014.0,1,0,1
,BMU,2005.0,5,0,5
SGP,HRV,2017.0,3,0,3
NIC,MEX,2011.0,2,0,2
SWE,GTM,2020.0,1,0,1
SWE,RWA,2009.0,1,0,1
PYF,MDV,2018.0,1,0,1
MDV,PYF,2019.0,1,0,1
CYP,PAK,2019.0,3,0,3
,PNG,2002.0,14,0,14
PHL,NZL,2010.0,2,0,2
ZAF,BFA,2020.0,5,0,5
MCO,TUN,2023.0,1,0,1
CAF,,2018.0,15,0,15
MAC,BEL,2015.0,1,0,1
KAZ,SWE,2015.0,2,0,2
VIR,CAN,2019.0,1,0,1
BFA,ITA,2015.0,1,0,1
,MCO,2010.0,7,0,7
LTU,ISR,2016.0,3,0,3
SVN,KOR,2009.0,2,0,2
EST,THA,2021.0,1,0,1
WSM,FJI,2016.0,2,0,2
SMR,,2003.0,1,0,1
MDG,KHM,2019.0,2,0,2
SRB,ARE,2022.0,1,0,1
COG,FRA,2022.0,3,0,3
CAN,ERI,2019.0,1,0,1
ERI,CAN,2022.0,1,0,1
,COD,2020.0,97,0,97
BIH,RUS,2016.0,1,0,1
SRB,ARE,2017.0,3,0,3
COG,NOR,2016.0,1,0,1
BRA,MNE,2018.0,1,0,1
KHM,NLD,2003.0,1,0,1
CYP,PSE,2020.0,2,0,2
SEN,CZE,2020.0,1,0,1
GAB,TGO,2019.0,1,0,1
TGO,MRT,2019.0,1,0,1
CMR,MOZ,2019.0,1,0,1
IRN,SYR,2020.0,2,0,2
TLS,,2021.0,7,0,7
KWT,NLD,2021.0,1,0,1
GTM,,2026.0,1,0,1
NZL,RWA,2019.0,1,0,1
SWZ,ETH,2022.0,2,0,2
BEL,OMN,2022.0,2,0,2
TWN,HUN,2023.0,1,0,1
NZL,SVK,2003.0,1,0,1
IND,AFG,2022.0,2,0,2
BLR,SWE,2020.0,2,0,2
,GIB,2012.0,1,0,1
VGB,,2025.0,5,0,5
IRL,USA,2024.0,1,0,1
TUN,ROU,2022.0,1,0,1
IRN,CZE,2007.0,2,0,2
BRA,SLV,2022.0,2,0,2
BDI,SEN,2020.0,1,0,1
ZWE,CHE,2004.0,1,0,1
AUS,SYC,2011.0,2,0,2
UKR,SGP,2011.0,1,0,1
SGP,UKR,2013.0,2,0,2
GBR,MDA,2017.0,3,0,3
CHE,COL,2007.0,3,0,3
ZAF,FLK,2020.0,1,0,1
TKM,TUR,2001.0,1,0,1
TUR,TKM,2002.0,1,0,1
TWN,CZE,2019.0,3,0,3
SSD,,2022.0,6,0,6
BEL,PHL,1999.0,3,0,3
SRB,CYP,2009.0,1,0,1
ZMB,ZAF,1999.0,3,0,3
TKM,,2018.0,1,0,1
TUR,PSE,2007.0,2,0,2
NGA,VEN,1998.0,1,0,1
ZMB,GBR,2001.0,7,0,7
TGO,,2006.0,5,0,5
,COD,1999.0,7,0,7
USA,TGO,1997.0,1,0,1
RUS,CIV,2008.0,1,0,1
ALB,,2006.0,2,0,2
GBR,MKD,2004.0,2,0,2
MWI,COG,2009.0,1,0,1
CAN,MNG,2004.0,2,0,2
EGY,TUN,2004.0,2,0,2
CMR,DNK,2004.0,1,0,1
CAF,,2016.0,8,0,8
AZE,SWE,2011.0,1,0,1
ZAF,MEX,1998.0,1,0,1
VUT,FRA,2006.0,2,0,2
SAU,BGR,2023.0,1,0,1
THA,LAO,2005.0,5,0,5
JPN,PNG,2011.0,1,0,1
NAM,,2002.0,6,0,6
POL,EGY,1997.0,2,0,2
BRA,KEN,2003.0,2,0,2
USA,TCD,2008.0,1,0,1
SAU,PNG,2017.0,1,0,1
PER,COL,2011.0,3,0,3
MRT,,2006.0,1,0,1
AUS,LBN,2012.0,1,0,1
CAF,USA,2013.0,2,0,2
NGA,SDN,1998.0,1,0,1
IDN,TWN,2002.0,1,0,1
UZB,KAZ,2012.0,2,0,2
SAU,OMN,1998.0,3,0,3
CHE,MMR,2017.0,2,0,2
CHN,GRC,1998.0,1,0,1
IND,BRB,2001.0,1,0,1
BRB,IND,2004.0,2,0,2
SHN,QAT,2018.0,1,0,1
JPN,MMR,1999.0,6,0,6
ZMB,NGA,2003.0,1,0,1
ESP,MAC,2015.0,2,0,2
MAC,MAR,2020.0,5,0,5
HRV,MKD,2007.0,2,0,2
AUS,TON,2014.0,1,0,1
GIB,AUT,2007.0,2,0,2
,GNB,1994.0,4,0,4
VNM,KOR,2000.0,1,0,1
PRY,,2013.0,11,0,11
GBR,ARM,2011.0,1,0,1
,HND,1999.0,1,0,1
STP,ZAF,2007.0,1,0,1
CAN,GHA,2005.0,4,0,4
TUR,ARE,2009.0,4,0,4
MMR,ESP,2020.0,1,0,1
NLD,SDN,2007.0,1,0,1
TUR,PRT,2010.0,2,0,2
IND,SYR,2005.0,1,0,1
LKA,FIN,2022.0,3,0,3
GBR,SDN,1998.0,3,0,3
NLD,PAK,1999.0,2,0,2
LUX,,1999.0,2,0,2
KWT,DZA,2011.0,1,0,1
ROU,REU,2000.0,1,0,1
LIE,CHN,2010.0,1,0,1
ESP,CHN,2001.0,2,0,2
IRL,MEX,2006.0,2,0,2
DMA,,2014.0,4,0,4
BRA,TTO,2008.0,1,0,1
NLD,ABW,2005.0,1,0,1
BHR,PAK,2006.0,1,0,1
CHN,NGA,2016.0,14,7,7
FIN,EST,2010.0,7,3,4
IRL,CHN,2013.0,17,11,6
IND,IRN,1999.0,4,5,-1
CHE,KOR,2003.0,9,11,-2
USA,VNM,2005.0,4,7,-3
USA,MYS,1997.0,6,6,0
ARE,SWE,2016.0,3,4,-1
SGP,SAU,2010.0,14,1,13
FIN,KWT,2019.0,1,1,0
DNK,SGP,2021.0,2,6,-4
ARG,SWE,2016.0,2,3,-1
QAT,USA,2012.0,16,26,-10
CZE,CHE,2003.0,6,7,-1
FIN,AUT,2023.0,7,8,-1
TUR,ESP,2009.0,6,4,2
GIN,MLI,2014.0,1,2,-1
AFG,PAK,2016.0,1,1,0
THA,IDN,2012.0,7,1,6
COL,AUS,2013.0,9,3,6
ISL,DEU,2023.0,2,3,-1
EGY,MYS,2013.0,6,3,3
CHN,GHA,2015.0,7,12,-5
DEU,SVN,2018.0,5,12,-7
CHN,ZAF,2011.0,7,7,0
CHN,GRC,2012.0,5,4,1
CZE,EGY,2015.0,3,2,1
ESP,SLV,2013.0,3,1,2
MYS,OMN,2011.0,5,4,1
CHN,IRN,2017.0,4,25,-21
UKR,JPN,2021.0,2,1,1
TZA,MWI,2013.0,2,2,0
VEN,CUB,2004.0,6,4,2
PER,FRA,2012.0,7,10,-3
MAR,USA,2018.0,8,11,-3
TUR,PAK,2014.0,4,7,-3
JPN,PRT,2018.0,4,9,-5
POL,MAR,2020.0,1,2,-1
MYS,BEL,2021.0,2,2,0
GBR,LBY,2016.0,8,5,3
NZL,PHL,2016.0,1,2,-1
MLT,USA,2020.0,5,5,0
FRA,DNK,2006.0,22,27,-5
HKG,KOR,2006.0,5,1,4
SRB,LBY,2016.0,4,2,2
AUS,FJI,2015.0,13,10,3
KOR,CAN,2002.0,35,20,15
JOR,CAN,2001.0,3,5,-2
EGY,KWT,2022.0,7,14,-7
BGD,HKG,2021.0,3,3,0
NZL,BGD,2020.0,3,1,2
IND,GRC,2007.0,2,1,1
IND,PAK,2011.0,17,11,6
HKG,KOR,2000.0,6,1,5
POL,CHN,2013.0,3,3,0
USA,CYM,2022.0,3,3,0
UKR,GBR,1999.0,17,14,3
OMN,SAU,2003.0,1,2,-1
HKG,FRA,2012.0,7,4,3
CHE,IRL,2002.0,6,7,-1
NOR,UKR,2017.0,1,4,-3
OMN,QAT,2019.0,5,2,3
ESP,KOR,2017.0,4,9,-5
AUS,PRI,2005.0,3,1,2
ESP,IRN,2019.0,13,38,-25
ARM,AUS,2020.0,1,1,0
PRT,ARE,2020.0,4,1,3
CZE,LTU,2023.0,2,2,0
KOR,DNK,2007.0,2,2,0
USA,PAN,2009.0,17,12,5
GRC,JPN,2020.0,4,1,3
MYS,NZL,2017.0,17,31,-14
CAN,NGA,2017.0,5,8,-3
SWE,SVN,2014.0,3,3,0
MYS,BRN,2014.0,6,8,-2
IRL,CHN,2003.0,1,2,-1
PER,ARG,2007.0,1,4,-3
AUT,COL,2021.0,3,6,-3
BHS,GBR,2018.0,1,1,0
BRA,MOZ,2018.0,4,5,-1
JPN,IRL,2018.0,6,7,-1
OMN,IND,2023.0,9,25,-16
IRL,NOR,2021.0,1,9,-8
MAR,CHN,2022.0,4,8,-4
IDN,MYS,2012.0,20,35,-15
MEX,SWE,2016.0,7,9,-2
ROU,BEL,2019.0,9,6,3
PAK,RUS,2020.0,3,3,0
RWA,CAN,2022.0,7,2,5
DEU,SVN,2022.0,11,16,-5
NLD,ZAF,2023.0,6,16,-10
IRQ,RUS,2023.0,2,6,-4
UZB,DEU,2006.0,4,3,1
ETH,AUS,2018.0,13,4,9
DEU,AFG,2020.0,3,2,1
TGO,FRA,2017.0,1,7,-6
CHN,EGY,2017.0,12,28,-16
PAK,PRT,2019.0,3,1,2
RUS,TUR,2009.0,4,3,1
RUS,IRL,2009.0,5,1,4
FRA,MEX,2022.0,25,50,-25
THA,DNK,2018.0,2,4,-2
COL,CHN,2023.0,3,2,1
MNG,USA,2018.0,6,4,2
POL,NZL,2022.0,3,1,2
IRL,IRN,2016.0,8,11,-3
SWE,NZL,2017.0,8,14,-6
SGP,KOR,2023.0,13,22,-9
BGD,IND,2013.0,15,15,0
CMR,FRA,2023.0,9,5,4
CHN,BEN,2021.0,2,2,0
ZAF,SWZ,2023.0,6,9,-3
PHL,NLD,2020.0,3,9,-6
ITA,SVN,2016.0,8,14,-6
CHE,SVK,2020.0,4,2,2
BFA,CAN,2020.0,2,3,-1
BGR,ESP,1999.0,7,4,3
MOZ,BRA,2019.0,8,6,2
MAR,DEU,2019.0,8,2,6
DNK,ARE,2019.0,4,7,-3
SDN,QAT,2020.0,1,1,0
SAU,LBN,2020.0,3,5,-2
ESP,DOM,2002.0,1,1,0
CUB,USA,2017.0,18,7,11
RUS,HKG,2020.0,5,7,-2
LAO,THA,2021.0,4,8,-4
PRT,ECU,2016.0,1,2,-1
RUS,MDA,2020.0,3,4,-1
CHN,BLR,2018.0,2,3,-1
CAN,PER,2019.0,7,3,4
JOR,EGY,2021.0,3,11,-8
MMR,USA,2019.0,5,6,-1
FRA,MWI,2020.0,4,3,1
TWN,IDN,2016.0,24,18,6
ZAF,ITA,1997.0,5,2,3
IND,COL,2013.0,2,1,1
IND,GRC,2020.0,2,3,-1
TUR,GHA,2022.0,2,2,0
MYS,BGD,2012.0,20,31,-11
QAT,IND,2023.0,5,7,-2
BEN,GHA,2022.0,3,2,1
FIN,CZE,2022.0,3,9,-6
DNK,BEL,2011.0,3,2,1
CYP,ITA,2023.0,2,1,1
BEL,IRL,2008.0,8,7,1
SRB,NOR,2021.0,1,1,0
PAK,KEN,2023.0,4,1,3
KEN,NGA,2022.0,8,5,3
IRN,ISR,2019.0,1,3,-2
BEL,BFA,2022.0,8,2,6
NOR,PAK,2022.0,7,8,-1
NZL,IND,2010.0,3,9,-6
DEU,COL,2008.0,5,10,-5
COL,DEU,2015.0,6,24,-18
URY,DEU,2023.0,4,1,3
DEU,NPL,2023.0,2,1,1
MKD,SRB,2018.0,8,11,-3
CRI,COL,2020.0,2,3,-1
BOL,PER,2022.0,2,2,0
CHL,IND,2014.0,3,9,-6
BEL,MAR,2023.0,4,6,-2
ISR,ESP,2005.0,6,1,5
CZE,PRT,2019.0,2,5,-3
EST,CAN,2018.0,4,2,2
COL,FRA,2009.0,7,15,-8
TUR,FIN,2011.0,3,10,-7
USA,EST,2017.0,16,6,10
GBR,MWI,2009.0,16,15,1
KEN,CAN,2011.0,7,6,1
GBR,BWA,2015.0,2,3,-1
THA,CAN,2002.0,8,9,-1
AUS,CHL,2010.0,7,9,-2
PRT,POL,2011.0,9,5,4
THA,GRC,2021.0,1,1,0
IRN,TUR,2009.0,7,2,5
FRA,KWT,2015.0,4,1,3
PRT,HUN,2021.0,3,4,-1
GBR,TZA,2012.0,14,13,1
GBR,MWI,2019.0,25,22,3
DEU,TCD,2017.0,1,1,0
KAZ,GBR,2016.0,2,9,-7
CHN,MNG,2016.0,5,4,1
NOR,BRA,2018.0,8,14,-6
CHE,SAU,2008.0,3,1,2
AUT,NZL,2016.0,7,3,4
ITA,ETH,2010.0,1,2,-1
FRA,OMN,2019.0,3,1,2
MEX,AUS,2009.0,8,4,4
DNK,GNB,2011.0,5,1,4
CHN,ARG,2020.0,1,2,-1
JPN,ISR,2013.0,7,1,6
AUT,IRL,2013.0,5,9,-4
NZL,BEL,2010.0,4,3,1
DEU,PHL,2007.0,2,1,1
IRL,GRC,2018.0,4,15,-11
CZE,NOR,2012.0,2,1,1
ZAF,IRN,2017.0,4,6,-2
GRL,DNK,2013.0,3,5,-2
DEU,BEN,2009.0,3,3,0
GBR,JOR,2007.0,14,4,10
ROU,NOR,2008.0,2,1,1
BGR,AUT,2004.0,1,1,0
CYP,GBR,2012.0,14,37,-23
ITA,SVN,2017.0,12,7,5
CAN,OMN,2014.0,3,5,-2
NLD,GAB,2015.0,1,4,-3
BRA,LUX,2021.0,4,3,1
ESP,DNK,2006.0,9,7,2
THA,HRV,2016.0,1,1,0
JPN,KAZ,2017.0,1,2,-1
CAN,LKA,2012.0,2,2,0
BEL,BRA,2012.0,19,19,0
TUR,FRA,2014.0,19,16,3
RUS,IRN,2002.0,5,1,4
IRN,RUS,2006.0,2,8,-6
COL,AUT,2015.0,3,1,2
TUR,IRL,2019.0,7,8,-1
USA,COG,2010.0,7,3,4
USA,CUB,2009.0,5,12,-7
DNK,MYS,2016.0,3,5,-2
FRA,BEN,2022.0,9,11,-2
DEU,UGA,2014.0,2,3,-1
CHE,ROU,2013.0,7,9,-2
COG,USA,2008.0,4,1,3
DEU,GEO,2009.0,15,6,9
KEN,ZMB,2023.0,1,1,0
LTU,NLD,2018.0,3,1,2
CAN,JOR,2021.0,14,19,-5
JPN,KAZ,2016.0,6,1,5
ETH,AUS,2016.0,14,3,11
FRA,EST,2016.0,3,2,1
FRA,KOR,1997.0,5,2,3
BEL,IRL,2004.0,5,4,1
TWN,SGP,2023.0,4,5,-1
PAK,FRA,2005.0,2,1,1
OMN,ZAF,2022.0,1,1,0
DEU,BGD,2013.0,8,6,2
MYS,KHM,2016.0,2,1,1
KHM,PAK,2019.0,1,1,0
CHN,CHL,2021.0,9,4,5
FRA,SAU,2017.0,38,15,23
USA,MWI,2015.0,21,16,5
CMR,USA,2011.0,13,8,5
HND,USA,2016.0,6,2,4
GBR,SVN,2016.0,12,17,-5
MNG,CHN,2014.0,5,5,0
SVK,DEU,2014.0,18,11,7
GRC,TUR,2017.0,5,6,-1
PAK,NZL,2016.0,6,6,0
NZL,SRB,2018.0,1,1,0
RUS,EGY,2018.0,4,8,-4
GBR,ROU,1998.0,5,8,-3
EGY,CHN,2012.0,3,5,-2
NOR,JPN,2019.0,5,13,-8
SGP,EGY,2021.0,2,5,-3
GUF,FRA,1997.0,5,4,1
POL,EGY,2007.0,2,1,1
HRV,POL,2017.0,2,1,1
MYS,FIN,2016.0,2,4,-2
SAU,SGP,2018.0,4,8,-4
UGA,ZAF,2016.0,7,15,-8
THA,UKR,2016.0,1,1,0
AUT,IND,2013.0,5,11,-6
LKA,IND,2022.0,2,5,-3
ISR,PSE,2011.0,19,20,-1
PER,USA,2000.0,13,20,-7
ARM,DEU,2011.0,3,5,-2
NZL,BEL,2023.0,5,1,4
MEX,JPN,1999.0,3,4,-1
VNM,GBR,2005.0,8,2,6
ESP,ROU,2001.0,4,4,0
VNM,FRA,2008.0,7,9,-2
MEX,CUB,2007.0,14,15,-1
NLD,POL,2004.0,7,11,-4
ZAF,NLD,2012.0,18,18,0
GHA,CHN,2023.0,12,37,-25
CZE,UKR,2005.0,1,2,-1
FRA,NER,2020.0,6,2,4
IRN,ROU,2019.0,1,1,0
AUS,KWT,2021.0,3,3,0
TUN,BHR,2023.0,4,1,3
AUT,HKG,2022.0,4,3,1
GMB,GBR,2022.0,14,16,-2
BTN,AUS,2022.0,4,4,0
MYS,DEU,2014.0,7,14,-7
TWN,POL,2021.0,4,3,1
KAZ,FRA,2018.0,3,3,0
THA,BGD,2022.0,5,7,-2
BGR,ESP,2007.0,3,4,-1
SVK,UKR,2021.0,2,13,-11
ITA,CYP,2022.0,6,2,4
SGP,IRN,2022.0,7,6,1
ESP,PAN,2019.0,11,2,9
KHM,KOR,2019.0,2,5,-3
AUS,HUN,2000.0,1,1,0
BRB,JAM,2021.0,3,2,1
CZE,ISR,2022.0,4,6,-2
SRB,BIH,2023.0,7,7,0
IND,RWA,2022.0,3,2,1
UZB,CHN,2020.0,3,6,-3
VNM,CHN,2022.0,10,23,-13
AUS,RUS,2013.0,3,10,-7
SAU,ZAF,1998.0,6,3,3
IRN,DEU,2001.0,10,6,4
DEU,IRN,2003.0,10,6,4
CYP,GRC,2008.0,9,24,-15
HRV,SRB,2006.0,9,12,-3
DEU,ROU,2003.0,11,28,-17
AUS,PAK,1998.0,1,2,-1
IRQ,YEM,2004.0,1,1,0
BGD,USA,1998.0,9,8,1
CHE,HUN,2001.0,10,6,4
FRA,SRB,2007.0,4,17,-13
GRC,PRT,2018.0,9,1,8
KAZ,KGZ,2010.0,1,2,-1
TUR,FIN,2009.0,6,1,5
FIN,AUT,2000.0,4,4,0
RUS,PRT,2004.0,7,10,-3
UKR,CHE,2001.0,5,2,3
JPN,NGA,2003.0,5,4,1
CAN,LKA,2005.0,4,1,3
FRA,BOL,2002.0,3,5,-2
ZMB,JPN,2003.0,3,2,1
COD,USA,2014.0,3,1,2
POL,FIN,2010.0,6,2,4
SWE,EST,2005.0,7,3,4
DNK,GRC,1998.0,3,1,2
PAK,JPN,1999.0,5,5,0
DNK,IRL,2004.0,4,4,0
CAN,OMN,2001.0,3,1,2
CAN,CZE,2008.0,12,16,-4
USA,COG,2006.0,3,2,1
ESP,DNK,2000.0,9,6,3
TUR,SAU,2011.0,4,2,2
AUT,FIN,2002.0,7,5,2
FIN,NOR,2005.0,7,5,2
KEN,CHE,2001.0,2,2,0
PRT,CAN,2006.0,4,6,-2
DEU,KAZ,2002.0,2,1,1
FJI,USA,1999.0,2,2,0
FRA,BGR,2005.0,7,12,-5
USA,BLR,2006.0,4,9,-5
ECU,FRA,2000.0,2,2,0
CHE,THA,2012.0,5,4,1
BRA,ISR,2006.0,1,2,-1
USA,CRI,2000.0,9,14,-5
AUS,BEL,2002.0,8,17,-9
BRA,RUS,2006.0,6,8,-2
EGY,QAT,2009.0,8,3,5
USA,TTO,1997.0,2,1,1
USA,PNG,2011.0,1,3,-2
MYS,AUS,1998.0,5,6,-1
DNK,ZWE,2002.0,1,2,-1
PRY,JPN,2004.0,2,2,0
ARM,USA,1999.0,4,1,3
ARG,DNK,2003.0,2,2,0
CAN,PRT,2010.0,5,3,2
NLD,IRN,2002.0,4,5,-1
ARG,CUB,2013.0,4,4,0
BLR,BGR,2010.0,2,2,0
PNG,AUS,2003.0,4,6,-2
BEL,LUX,2006.0,11,6,5
GAB,FRA,1997.0,5,2,3
KOR,UZB,2006.0,3,2,1
UZB,KOR,2009.0,2,2,0
UKR,SVK,2004.0,1,1,0
SRB,SVN,2004.0,6,2,4
POL,BLR,2002.0,2,4,-2
BGR,AUT,2001.0,9,1,8
KOR,HKG,2005.0,1,10,-9
FRA,IRN,2000.0,4,1,3
UKR,POL,2011.0,15,15,0
AUT,POL,2007.0,6,9,-3
CZE,AUT,2001.0,10,6,4
DNK,PRT,1999.0,3,2,1
ARG,TUR,2020.0,5,1,4
GBR,LKA,1998.0,6,5,1
LTU,FRA,2001.0,3,4,-1
POL,MDA,1998.0,2,1,1
USA,BHR,2006.0,4,1,3
BGR,RUS,2009.0,4,2,2
SVN,AUS,2008.0,2,1,1
VNM,RUS,2012.0,3,7,-4
PER,ESP,1997.0,2,4,-2
JPN,UKR,2012.0,8,1,7
ARE,EGY,1999.0,6,10,-4
CUB,CHL,2007.0,3,3,0
ZAF,IND,2009.0,8,16,-8
PER,GBR,2006.0,1,5,-4
JPN,MYS,2002.0,18,4,14
KEN,DNK,2001.0,2,1,1
CHE,HUN,2004.0,7,13,-6
DEU,ARM,2011.0,5,3,2
THA,CHE,1997.0,2,1,1
DEU,NGA,2000.0,6,6,0
GBR,ISL,2005.0,4,9,-5
GBR,ISL,2012.0,8,5,3
ETH,NLD,2004.0,2,1,1
ISR,HUN,2011.0,1,1,0
TUN,USA,1999.0,3,4,-1
ROU,BEL,2011.0,7,7,0
BEL,AUS,2005.0,8,8,0
RUS,DNK,2004.0,10,6,4
DEU,CHL,2004.0,10,13,-3
GBR,ZMB,1998.0,4,2,2
IND,OMN,2007.0,8,5,3
CHN,RUS,2008.0,2,4,-2
CHN,GRC,2005.0,2,4,-2
AUS,HRV,2005.0,1,1,0
SVK,NLD,2003.0,4,3,1
LTU,SWE,2000.0,7,8,-1
NGA,ISR,2011.0,1,1,0
SWE,KEN,1999.0,3,1,2
BHR,JOR,2008.0,1,2,-1
BEL,NGA,1999.0,1,1,0
LUX,USA,2015.0,3,7,-4
ITA,TUR,2001.0,10,6,4
KWT,USA,2012.0,6,17,-11
AUS,PAN,2014.0,2,1,1
GBR,MLT,1997.0,2,3,-1
ITA,RUS,2004.0,16,26,-10
BEN,USA,2004.0,2,2,0
MEX,CHE,2001.0,2,5,-3
TZA,JPN,2014.0,1,7,-6
FIN,SGP,2015.0,2,3,-1
VNM,IDN,2022.0,6,3,3
AUT,DNK,2009.0,9,12,-3
PER,COL,2006.0,1,1,0
GBR,LUX,2011.0,10,4,6
CHE,KHM,2011.0,2,2,0
LBY,FRA,2015.0,1,2,-1
CAN,LBY,2015.0,4,2,2
USA,MDG,2009.0,7,5,2
CHL,FRA,2018.0,35,49,-14
ETH,FRA,2011.0,3,2,1
CZE,GEO,2011.0,2,1,1
SDN,JPN,2020.0,2,2,0
GRC,PRT,2017.0,4,1,3
SWE,LVA,2020.0,4,1,3
SVK,AUT,2015.0,14,7,7
USA,LTU,2009.0,8,5,3
LTU,DNK,2014.0,4,3,1
ESP,ETH,2020.0,4,3,1
IRN,POL,2017.0,6,3,3
KNA,IRL,2016.0,1,1,0
NLD,POL,2014.0,19,20,-1
GNQ,GIN,2009.0,3,1,2
BEN,NGA,2015.0,5,3,2
ETH,SWE,2008.0,1,5,-4
ETH,BEL,2010.0,3,3,0
CAN,BEL,2009.0,32,33,-1
ZAF,IRN,2016.0,5,6,-1
SWE,KEN,2020.0,4,6,-2
AUS,ARG,2022.0,6,4,2
DNK,ISR,2010.0,3,2,1
IRL,BRA,2019.0,6,22,-16
COL,BEL,2014.0,3,6,-3
CRI,TWN,2019.0,1,1,0
BEL,EST,2019.0,1,4,-3
HUN,FIN,2017.0,5,1,4
ZAF,TWN,2010.0,1,2,-1
DEU,CYP,2011.0,3,4,-1
BHR,NZL,2019.0,2,1,1
MAC,GBR,2016.0,1,4,-3
CAN,CUB,2014.0,2,2,0
OMN,KWT,2023.0,1,1,0
AUT,BRA,2017.0,9,10,-1
MEX,FIN,2011.0,1,1,0
FIN,MEX,2015.0,2,1,1
ITA,SMR,2013.0,5,2,3
TUR,AUS,2010.0,6,4,2
ISL,CHE,2016.0,3,2,1
MCO,FRA,2011.0,4,13,-9
OMN,AUS,2010.0,5,2,3
PAK,AUT,2009.0,7,7,0
MEX,VEN,2023.0,1,4,-3
PAK,BRA,2014.0,7,5,2
CAN,BEN,2012.0,1,1,0
AUT,LTU,2013.0,2,1,1
ZAF,IRL,2013.0,4,8,-4
COL,ARG,2012.0,11,13,-2
PHL,AUS,2010.0,14,7,7
CAN,PHL,2014.0,1,5,-4
ITA,NGA,2013.0,3,1,2
LTU,POL,2008.0,2,2,0
USA,LBY,2012.0,2,3,-1
CZE,ISR,2017.0,2,2,0
TWN,BEL,2016.0,3,4,-1
SGP,ISR,2017.0,4,4,0
ARE,SWE,2018.0,4,8,-4
SVK,NLD,2013.0,3,6,-3
ITA,HRV,2015.0,12,5,7
DNK,ROU,2014.0,2,3,-1
IND,MUS,2012.0,1,1,0
LBN,ITA,2013.0,3,3,0
CAN,THA,2019.0,19,13,6
BEL,NZL,2015.0,3,2,1
AUT,NZL,2018.0,3,3,0
ROU,TUR,2013.0,1,2,-1
SWE,URY,2004.0,1,1,0
SWE,COL,2019.0,3,8,-5
PRT,FIN,2008.0,1,7,-6
UGA,BEL,2014.0,3,3,0
DMA,USA,2019.0,1,2,-1
NLD,RWA,2017.0,1,1,0
AUS,NGA,2017.0,3,8,-5
TWN,NLD,2022.0,6,7,-1
USA,SWZ,2015.0,6,1,5
LUX,IND,2019.0,2,5,-3
CHN,PRI,2016.0,3,2,1
CRI,DEU,2014.0,3,3,0
PAK,ITA,2016.0,9,26,-17
EST,GBR,2020.0,8,11,-3
KHM,KOR,2021.0,2,2,0
NGA,VNM,2020.0,3,2,1
CMR,FRA,2010.0,18,29,-11
IRN,VNM,2019.0,18,1,17
JOR,FRA,2013.0,3,4,-1
SVK,FIN,2017.0,2,1,1
THA,KAZ,2015.0,2,1,1
SGP,DNK,2014.0,6,2,4
LVA,NLD,2017.0,1,1,0
LVA,USA,2014.0,4,1,3
GBR,COG,2014.0,1,1,0
GBR,FLK,2018.0,1,1,0
SYR,GBR,2014.0,3,3,0
DEU,URY,2015.0,2,3,-1
USA,CMR,2021.0,13,19,-6
USA,MDG,2021.0,7,7,0
MYS,CHE,2014.0,5,1,4
SDN,EGY,2021.0,3,4,-1
ARG,IND,2011.0,2,1,1
PHL,KOR,2014.0,6,9,-3
UKR,SVK,2014.0,4,1,3
MEX,URY,2014.0,4,2,2
BOL,USA,2015.0,2,10,-8
CRI,DEU,2015.0,5,8,-3
ROU,SWE,2014.0,3,5,-2
GRC,NLD,2010.0,18,16,2
AUT,CUB,2017.0,1,1,0
GBR,ZMB,2020.0,5,6,-1
GBR,NAM,2016.0,2,5,-3
BGR,NZL,2018.0,1,1,0
CHN,QAT,2023.0,5,2,3
SDN,ERI,2017.0,1,1,0
TUN,SWE,2017.0,4,2,2
DZA,BEL,2017.0,5,1,4
ARM,DEU,2019.0,2,3,-1
CHE,PER,2021.0,3,1,2
KOR,FIN,2019.0,2,3,-1
FIN,KOR,2020.0,4,7,-3
SRB,IND,2020.0,1,1,0
ESP,THA,2021.0,4,2,2
RUS,ESP,2016.0,9,19,-10
MYS,ESP,2015.0,3,2,1
LVA,GBR,2016.0,4,2,2
ARG,IRL,2021.0,3,1,2
PAK,NZL,2017.0,9,14,-5
ZAF,MOZ,2018.0,5,3,2
KWT,JOR,2017.0,2,7,-5
IDN,GBR,2017.0,17,35,-18
SRB,DEU,2020.0,24,11,13
ITA,MLT,2015.0,2,2,0
MYS,NOR,2022.0,2,2,0
KHM,JPN,2016.0,2,2,0
GBR,PHL,2019.0,9,6,3
JPN,SGP,2001.0,14,8,6
NOR,ESP,2019.0,23,31,-8
ISR,SWE,2023.0,5,5,0
IRN,IRQ,2017.0,14,5,9
MLI,CIV,2020.0,2,2,0
GUY,FRA,2012.0,1,2,-1
CIV,BFA,2019.0,3,2,1
SVN,HRV,2017.0,8,12,-4
BEL,DZA,2002.0,5,4,1
PRT,POL,2021.0,9,6,3
NOR,EST,2021.0,6,3,3
ESP,PER,2014.0,17,9,8
CIV,BFA,2021.0,3,2,1
PHL,PRT,2020.0,1,1,0
GHA,HKG,2020.0,3,3,0
GRC,NOR,2011.0,1,2,-1
TZA,AUS,2023.0,2,2,0
UGA,RWA,2019.0,4,4,0
KOR,FIN,2021.0,14,3,11
CHL,PRT,2022.0,1,3,-2
ETH,CHN,2023.0,5,21,-16
SLE,AUS,2019.0,1,1,0
LUX,GRC,2023.0,4,1,3
MYS,GHA,2022.0,4,2,2
ITA,CYP,2017.0,1,4,-3
DNK,FIN,2009.0,4,9,-5
IND,IRQ,2021.0,13,9,4
ROU,BEL,2009.0,3,5,-2
BTN,IND,2017.0,1,4,-3
NZL,NOR,2001.0,4,4,0
BGR,BRA,1999.0,4,1,3
IND,BWA,2000.0,2,4,-2
USA,BHS,2009.0,3,2,1
FJI,KOR,2018.0,1,1,0
HKG,TWN,2016.0,11,12,-1
CZE,BRA,2019.0,3,13,-10
IDN,AUT,2020.0,2,3,-1
CHE,MEX,2021.0,6,17,-11
ESP,EST,2021.0,6,6,0
SRB,HRV,1998.0,1,6,-5
TWN,BEL,2022.0,4,4,0
MEX,PER,2022.0,9,7,2
HUN,KAZ,2022.0,3,2,1
USA,MUS,2022.0,2,1,1
DZA,BEL,2022.0,2,2,0
ITA,NPL,2019.0,1,1,0
LKA,NZL,2022.0,10,4,6
AUS,ECU,2020.0,7,2,5
VNM,CZE,2021.0,6,11,-5
TUR,JOR,2022.0,3,2,1
BLR,NLD,2007.0,2,1,1
USA,SLV,2018.0,3,8,-5
DNK,IND,2011.0,11,14,-3
ISR,JPN,2002.0,7,10,-3
ESP,IND,2006.0,8,11,-3
SLE,NGA,2011.0,1,2,-1
PAK,CAN,1997.0,4,2,2
SVN,SLV,2001.0,6,4,2
PRT,SWE,2006.0,7,4,3
LKA,JPN,2007.0,3,4,-1
SGP,DNK,2008.0,5,1,4
CAN,MYS,2010.0,12,12,0
UKR,TUR,1998.0,4,1,3
NLD,SAU,2007.0,3,2,1
COL,ESP,2002.0,11,19,-8
THA,SGP,2003.0,4,3,1
USA,RWA,2010.0,5,7,-2
BEL,MEX,1997.0,2,5,-3
ZAF,FRA,1998.0,5,7,-2
CHE,IND,1997.0,8,8,0
USA,CRI,2006.0,9,12,-3
COL,DEU,2008.0,10,5,5
DNK,ISL,2004.0,6,2,4
PRT,SWE,2010.0,9,5,4
BRA,ARE,2020.0,6,1,5
KEN,TUR,2021.0,1,1,0
DEU,BIH,2002.0,4,1,3
SVN,FRA,1998.0,4,2,2
MEX,CHE,2014.0,9,6,3
BRA,AUT,2011.0,5,5,0
GBR,SAU,1999.0,12,11,1
TWN,NZL,2013.0,5,2,3
IRL,ITA,1999.0,11,4,7
URY,USA,2004.0,15,8,7
CUB,BRA,2001.0,5,5,0
NGA,GBR,2000.0,12,22,-10
ISR,SWE,2006.0,3,2,1
SGP,IND,1997.0,3,7,-4
FRA,GUY,2008.0,1,2,-1
CUB,GBR,2002.0,6,3,3
FRA,GLP,1998.0,11,16,-5
AUS,NCL,2010.0,1,3,-2
UKR,EGY,1998.0,1,1,0
DNK,NZL,2003.0,4,5,-1
CAN,BLR,1999.0,1,1,0
HKG,FRA,2005.0,5,4,1
AUS,ROU,2014.0,2,2,0
NLD,TWN,2009.0,4,4,0
SWE,PER,2008.0,2,1,1
CHE,BGR,2019.0,3,4,-1
CAN,URY,2019.0,1,2,-1
IRL,AUT,2020.0,7,4,3
ECU,BEL,2021.0,8,6,2
USA,GUM,2014.0,3,7,-4
EGY,FIN,2021.0,2,1,1
BRA,CHN,2012.0,5,4,1
FJI,CHE,2016.0,1,1,0
USA,GUY,2016.0,1,1,0
GHA,JPN,2016.0,3,3,0
CAN,TGO,2018.0,2,2,0
GHA,UGA,2019.0,2,3,-1
COL,VEN,2020.0,8,33,-25
HND,ITA,2021.0,2,1,1
KOR,NLD,2017.0,7,7,0
SAU,SGP,2017.0,2,8,-6
AUS,OMN,2016.0,5,5,0
ZAF,BEL,2005.0,5,5,0
ZMB,IND,2021.0,9,4,5
NGA,GUY,2023.0,2,1,1
PAK,BGD,2002.0,1,3,-2
LUX,FRA,2017.0,13,42,-29
USA,SDN,2004.0,1,1,0
ESP,PER,2008.0,8,5,3
CUB,COL,2022.0,2,3,-1
HUN,ARE,2018.0,2,2,0
KWT,IRL,2021.0,2,3,-1
SVK,TUR,2021.0,1,2,-1
SWE,PHL,2022.0,2,1,1
ITA,CHN,2000.0,14,12,2
HUN,FRA,2020.0,13,13,0
BEL,TUR,2021.0,13,15,-2
SVK,CHE,2000.0,2,2,0
FRA,SVK,2021.0,2,3,-1
BRA,MOZ,2022.0,13,5,8
KOR,MNG,2015.0,9,1,8
KOR,ETH,2023.0,5,4,1
COL,CRI,2019.0,4,2,2
POL,BRA,2022.0,5,14,-9
QAT,LBN,2021.0,2,5,-3
VNM,USA,2004.0,8,8,0
ARE,AUT,2014.0,2,2,0
ARE,ZAF,2014.0,2,1,1
ZAF,CAN,1999.0,11,12,-1
USA,SRB,2007.0,6,37,-31
SVK,POL,2004.0,4,2,2
ZAF,THA,2008.0,1,1,0
AUS,NLD,1997.0,13,15,-2
LAO,PHL,2006.0,1,1,0
ARM,USA,2007.0,13,1,12
KEN,BEL,2010.0,5,3,2
FRA,ISR,2000.0,21,23,-2
SWE,PRT,2007.0,6,8,-2
HUN,CHE,1997.0,11,6,5
SWE,LVA,2007.0,3,2,1
BEL,ARG,2005.0,2,4,-2
ISR,DNK,2012.0,7,4,3
CZE,JPN,1997.0,8,7,1
CZE,SWE,2010.0,4,4,0
BRB,USA,2000.0,2,2,0
USA,BRB,2009.0,1,2,-1
GTM,DEU,1999.0,1,1,0
FRA,BFA,2001.0,10,6,4
POL,GRC,2012.0,1,1,0
PRI,ARG,2018.0,2,2,0
VNM,USA,2001.0,6,3,3
ZWE,NLD,2001.0,2,1,1
NZL,FRA,2001.0,12,7,5
MYS,IND,2000.0,5,10,-5
TWN,PER,2019.0,1,1,0
ITA,NGA,2003.0,7,2,5
SWE,GRC,2020.0,15,34,-19
SRB,RUS,2021.0,2,2,0
COL,PRI,2006.0,2,2,0
KEN,CHE,2015.0,5,6,-1
JOR,QAT,2005.0,2,1,1
PER,ESP,2002.0,9,4,5
ARG,ITA,2000.0,11,16,-5
SAU,CAN,1997.0,11,16,-5
CZE,BEL,2010.0,5,5,0
ISR,POL,2018.0,3,5,-2
JPN,CHE,1999.0,23,17,6
HUN,SRB,2001.0,3,1,2
SRB,HUN,2003.0,1,6,-5
SAU,ZAF,2007.0,4,1,3
BGD,USA,1999.0,7,12,-5
PRY,USA,2006.0,2,1,1
BRB,GBR,2002.0,1,1,0
RUS,MEX,1997.0,10,4,6
VEN,BRA,2012.0,8,5,3
CZE,CHN,2000.0,2,1,1
LUX,DEU,2001.0,2,6,-4
IND,IDN,1997.0,1,1,0
CAN,DZA,1998.0,2,1,1
SRB,CHN,2022.0,1,3,-2
VEN,MEX,2000.0,11,5,6
MYS,SGP,2007.0,1,12,-11
OMN,USA,2001.0,4,4,0
SDN,ARE,2017.0,2,2,0
JPN,HUN,2001.0,9,6,3
ISR,BRA,2018.0,1,6,-5
COL,CHL,2012.0,14,15,-1
ISL,DNK,2001.0,5,7,-2
ROU,GRC,2000.0,5,2,3
UZB,RUS,2017.0,8,10,-2
RUS,NOR,2004.0,8,7,1
JPN,ARG,2001.0,3,4,-1
OMN,IND,2006.0,4,6,-2
LTU,USA,1997.0,4,12,-8
TUN,ITA,2014.0,4,3,1
CHE,MEX,2011.0,3,4,-1
GNQ,GIN,2019.0,7,2,5
ARG,AUS,2001.0,4,1,3
UZB,USA,1997.0,1,1,0
FIN,SRB,2020.0,2,1,1
UKR,BLR,2013.0,1,2,-1
ROU,SWE,2001.0,2,2,0
AUT,SVN,2013.0,3,9,-6
RUS,PRT,2001.0,6,5,1
BLR,ITA,2007.0,3,1,2
SWE,LTU,2006.0,5,3,2
NGA,BWA,2014.0,4,1,3
BWA,NGA,2016.0,2,1,1
ARE,JOR,2014.0,7,15,-8
USA,LSO,2020.0,4,4,0
DEU,TZA,2016.0,9,1,8
LSO,ZAF,2009.0,7,2,5
GAB,FRA,2012.0,6,9,-3
BEL,CHN,1999.0,6,6,0
FRA,GHA,2023.0,3,2,1
NZL,NOR,2015.0,4,1,3
SRB,SWE,2011.0,3,1,2
TUR,IRN,2011.0,5,11,-6
LTU,FRA,2014.0,4,5,-1
ZAF,MYS,2018.0,1,3,-2
IDN,PHL,1997.0,1,1,0
BLR,CHE,2009.0,1,1,0
SAU,COL,2017.0,2,2,0
CUB,MEX,2002.0,22,18,4
SGP,IRN,2016.0,9,7,2
KOR,CHE,2015.0,12,11,1
VEN,FRA,2010.0,8,8,0
CMR,NGA,2014.0,3,1,2
SWE,POL,2011.0,17,22,-5
CHL,CRI,2013.0,3,1,2
BHR,IND,2019.0,2,5,-3
BEL,SEN,2010.0,1,1,0
CRI,VEN,2010.0,3,1,2
TWN,MYS,2020.0,3,16,-13
BGD,MYS,2009.0,14,8,6
PSE,BEL,2021.0,1,1,0
MYS,SDN,2008.0,3,1,2
GRC,GBR,2024.0,1,1,0
CHE,SWZ,2014.0,11,8,3
CHN,ZAF,2009.0,6,4,2
HTI,USA,2011.0,6,5,1
AUT,UGA,2014.0,1,2,-1
MEX,JPN,2020.0,12,6,6
DEU,VNM,2009.0,10,5,5
IDN,IND,2021.0,14,29,-15
LTU,POL,2015.0,2,3,-1
ECU,GBR,2009.0,2,1,1
NOR,ITA,2011.0,9,12,-3
TUR,SRB,2010.0,2,1,1
ZAF,CMR,2016.0,6,8,-2
ZMB,ZAF,2012.0,3,2,1
ESP,URY,2023.0,5,11,-6
CYP,SWE,2016.0,1,2,-1
RUS,ARE,2020.0,2,1,1
TUN,SWE,2018.0,3,3,0
TZA,DEU,2011.0,3,2,1
BRA,PER,2001.0,3,1,2
CMR,KEN,2017.0,1,3,-2
URY,FRA,2002.0,9,2,7
KEN,IND,2014.0,1,5,-4
EST,NLD,2020.0,2,7,-5
EGY,TUR,2012.0,3,2,1
VEN,ARG,2016.0,4,1,3
DEU,SAU,2014.0,20,4,16
RWA,SWE,2020.0,5,5,0
KAZ,CZE,2019.0,3,1,2
CUW,USA,2022.0,1,1,0
ITA,SRB,2010.0,6,1,5
BHR,OMN,2022.0,1,6,-5
NZL,BRA,2013.0,1,6,-5
CMR,BEN,2020.0,2,1,1
ISR,PRT,2015.0,2,3,-1
GBR,SRB,2020.0,21,14,7
USA,LVA,2020.0,4,2,2
FRA,LVA,2019.0,3,1,2
DNK,KEN,2019.0,3,1,2
IRN,OMN,2021.0,3,1,2
CHN,IRL,2012.0,10,16,-6
SGP,POL,2019.0,3,4,-1
POL,JPN,2015.0,7,11,-4
FJI,NZL,2016.0,2,1,1
SUR,USA,2015.0,1,1,0
HRV,CAN,2014.0,1,4,-3
NOR,GEO,2014.0,1,1,0
LKA,HKG,2019.0,2,3,-1
IRQ,CHN,2015.0,3,9,-6
KEN,MWI,2017.0,3,1,2
AUS,ARG,2017.0,5,4,1
PER,NLD,2021.0,1,2,-1
NGA,GMB,1997.0,1,1,0
SAU,KWT,2007.0,5,2,3
IND,CHN,2003.0,4,7,-3
NZL,SAU,2021.0,3,4,-1
HUN,BEL,2023.0,2,1,1
SRB,GBR,2019.0,10,8,2
MKD,DEU,2020.0,2,2,0
ARE,CHN,2014.0,2,2,0
JPN,IRL,2017.0,5,10,-5
AUS,OMN,2018.0,8,2,6
USA,BIH,2016.0,6,5,1
IRL,MYS,2016.0,9,5,4
TUN,POL,2020.0,1,1,0
IRL,NOR,2019.0,6,5,1
MYS,AUT,2019.0,2,1,1
SVK,EST,2017.0,1,1,0
TUR,FIN,2021.0,12,9,3
KOR,PHL,2013.0,10,7,3
EGY,KOR,2021.0,10,15,-5
FRO,GBR,2018.0,2,1,1
FRA,EST,2022.0,4,2,2
SVK,POL,2015.0,5,8,-3
PAK,THA,2013.0,4,20,-16
DNK,IRL,2008.0,7,5,2
LBY,GBR,2021.0,7,13,-6
CZE,MEX,2003.0,4,1,3
LKA,JPN,2020.0,3,26,-23
USA,AFG,2015.0,5,3,2
BEL,ISR,2014.0,4,6,-2
JPN,ETH,2004.0,3,2,1
CRI,CHE,2022.0,2,1,1
YEM,CHN,2023.0,2,4,-2
IRN,HRV,2022.0,2,1,1
KEN,NGA,2018.0,3,2,1
IDN,NLD,2003.0,6,11,-5
GRC,BGR,2001.0,4,8,-4
NGA,CMR,2012.0,2,2,0
CAN,LKA,2002.0,2,1,1
BHR,SAU,2015.0,4,8,-4
GHA,RWA,2018.0,1,1,0
CAN,PER,2009.0,3,3,0
CAN,GHA,1998.0,6,1,5
USA,MNG,2010.0,4,4,0
POL,BEL,2011.0,10,8,2
CIV,USA,2012.0,4,5,-1
ITA,FIN,2003.0,8,8,0
FIN,ESP,2008.0,8,18,-10
COG,ITA,2007.0,1,1,0
IND,ERI,2006.0,2,1,1
AUT,JPN,2005.0,3,9,-6
POL,EGY,2020.0,3,2,1
PRI,BRA,2000.0,2,4,-2
BFA,CAN,2007.0,1,2,-1
MNP,USA,2017.0,1,4,-3
EGY,BEL,2000.0,3,2,1
IDN,BEL,2000.0,2,1,1
NOR,BEL,2005.0,1,3,-2
MEX,DOM,2007.0,2,1,1
MHL,USA,2004.0,1,1,0
CZE,BRA,2009.0,1,2,-1
NER,USA,2011.0,1,1,0
TJK,RUS,2013.0,2,5,-3
GHA,CAN,2008.0,2,1,1
VEN,VNM,2012.0,4,1,3
VNM,VEN,2013.0,1,1,0
NZL,ZAF,2006.0,2,3,-1
RUS,CZE,2005.0,11,11,0
BLR,FRA,1998.0,3,3,0
MYS,LKA,2012.0,2,1,1
POL,EGY,1999.0,2,4,-2
HKG,MYS,2008.0,4,1,3
RUS,SVK,2007.0,5,4,1
BRA,CZE,2003.0,1,2,-1
DEU,CMR,2005.0,4,1,3
DEU,HKG,1998.0,4,3,1
FRA,SVK,2011.0,4,8,-4
HUN,ZAF,2013.0,1,1,0
CAN,PRT,2000.0,4,1,3
BEL,THA,2013.0,4,1,3
NLD,ETH,2004.0,1,2,-1
SRB,CHE,2023.0,4,1,3
BWA,MWI,2004.0,1,1,0
BWA,MWI,2008.0,2,1,1
GBR,PNG,2001.0,2,2,0
POL,BEL,2009.0,6,9,-3
GRC,BGR,2014.0,3,3,0
DNK,HKG,2000.0,1,2,-1
FIN,ESP,2001.0,9,3,6
CAN,CZE,2001.0,8,4,4
GBR,VEN,2004.0,5,4,1
USA,ARE,2001.0,16,7,9
TUR,ISR,2004.0,5,5,0
LUX,BEL,2000.0,8,5,3
AUS,ESP,2001.0,5,24,-19
VEN,DEU,2007.0,6,6,0
LBN,CAN,2000.0,6,4,2
DNK,SGP,2009.0,2,3,-1
GBR,IRQ,2004.0,2,4,-2
AUT,ROU,2007.0,3,2,1
VNM,KEN,2023.0,2,1,1
BHR,USA,2021.0,2,6,-4
JOR,CAN,2004.0,6,5,1
GMB,GBR,2017.0,7,4,3
SWE,RUS,2007.0,15,17,-2
NLD,BEN,2013.0,2,2,0
TZA,DEU,2021.0,3,11,-8
KOR,PAK,2007.0,6,4,2
PRT,POL,2019.0,9,6,3
LUX,USA,2014.0,7,12,-5
AUT,IRN,2007.0,2,3,-1
POL,FIN,2000.0,5,3,2
ESP,SGP,2008.0,2,1,1
MEX,RUS,2005.0,4,8,-4
SRB,AUS,1999.0,3,2,1
CYP,GBR,2005.0,1,11,-10
CHE,HUN,2014.0,10,21,-11
LUX,IRL,2015.0,1,2,-1
KEN,ETH,2013.0,1,2,-1
TUR,DNK,2013.0,2,4,-2
SGP,CAN,2006.0,20,22,-2
AUS,ROU,2001.0,2,3,-1
SAU,DEU,2010.0,3,28,-25
PAK,IRN,2008.0,1,1,0
KOR,SWE,2009.0,10,4,6
CHL,BEL,2000.0,2,1,1
MCO,ITA,2016.0,1,2,-1
USA,MKD,2007.0,5,1,4
SYR,LBN,2009.0,1,1,0
CHN,COL,2017.0,2,1,1
GBR,AFG,2015.0,4,2,2
HRV,ISR,2011.0,1,1,0
CHN,ITA,2007.0,15,15,0
BWA,GBR,2003.0,5,7,-2
CAN,QAT,2005.0,3,2,1
ISL,USA,2008.0,13,12,1
GBR,ECU,2009.0,1,2,-1
CMR,GBR,2005.0,5,6,-1
KOR,PRT,2010.0,4,1,3
SYR,SAU,2012.0,5,2,3
ARG,PRI,2012.0,1,6,-5
SGP,AUT,2011.0,2,1,1
MYS,IRN,2005.0,3,1,2
USA,MTQ,2012.0,1,1,0
MWI,BWA,2015.0,1,1,0
ESP,TWN,2008.0,2,2,0
TTO,JAM,2014.0,13,9,4
FIN,GRC,2016.0,3,6,-3
SWE,URY,2014.0,1,1,0
IND,JOR,2004.0,4,1,3
NOR,JPN,2009.0,3,5,-2
ARG,PRT,2004.0,4,2,2
NZL,CHL,2011.0,3,6,-3
GEO,DEU,2012.0,6,5,1
KEN,UGA,2009.0,1,2,-1
ITA,TWN,2018.0,3,6,-3
KGZ,DEU,2021.0,4,4,0
NZL,IRL,2010.0,4,9,-5
CZE,NLD,2015.0,9,13,-4
KEN,ETH,2003.0,2,1,1
JPN,LKA,2012.0,8,3,5
MYS,QAT,2014.0,3,1,2
HRV,ESP,2012.0,6,4,2
CYP,IRL,2018.0,2,2,0
BRN,MYS,2016.0,4,7,-3
DNK,ETH,2000.0,4,1,3
POL,DNK,2007.0,7,6,1
FRA,HRV,2002.0,3,3,0
USA,SLV,2016.0,2,2,0
NOR,UGA,2014.0,2,2,0
AUS,ARE,2009.0,11,6,5
PAK,AUT,2011.0,6,22,-16
CHE,LBN,2013.0,4,1,3
TUR,CHN,2010.0,4,1,3
JOR,SWE,2010.0,4,1,3
CHE,ARE,2015.0,5,2,3
COL,PRI,2010.0,2,2,0
BWA,GBR,2013.0,3,1,2
LBN,AUS,2010.0,1,1,0
TZA,NOR,2010.0,3,10,-7
LUX,FIN,2014.0,1,2,-1
POL,VNM,2012.0,2,1,1
FIN,ROU,2020.0,3,1,2
NLD,GRC,2009.0,12,19,-7
EGY,ITA,2009.0,2,10,-8
MRT,FRA,2011.0,2,2,0
SVK,SWE,2015.0,1,2,-1
AUS,CZE,2010.0,1,4,-3
JPN,ITA,2012.0,17,23,-6
LKA,FRA,2021.0,2,1,1
ITA,CHL,2005.0,8,2,6
HRV,AUS,2016.0,2,1,1
PHL,CHE,2005.0,5,1,4
GHA,NOR,2009.0,1,2,-1
JOR,ARE,2006.0,6,5,1
CAN,TUR,2009.0,10,10,0
GMB,USA,2008.0,2,2,0
UKR,ISR,2011.0,4,5,-1
CHL,BEL,2010.0,2,5,-3
URY,FRA,2012.0,3,9,-6
GBR,IRQ,2014.0,25,14,11
LBN,DEU,2023.0,6,1,5
AUT,BRA,2016.0,7,6,1
GHA,FIN,2022.0,3,2,1
CZE,IRN,2016.0,3,6,-3
USA,AFG,2014.0,7,1,6
PER,BEL,2013.0,4,3,1
NPL,GBR,2012.0,6,2,4
NOR,MWI,2013.0,1,1,0
JPN,NZL,2023.0,4,7,-3
BGD,GBR,2013.0,12,12,0
CHL,VEN,2015.0,4,6,-2
CHN,ITA,1998.0,10,17,-7
AUS,POL,2010.0,2,11,-9
NIC,ESP,2012.0,1,1,0
CZE,CHL,2018.0,1,2,-1
URY,ITA,2012.0,1,1,0
LVA,GBR,2018.0,3,1,2
ISR,ESP,2012.0,2,4,-2
IRN,ISR,2009.0,1,2,-1
TUR,HUN,2013.0,2,3,-1
SWE,MEX,2013.0,3,8,-5
THA,ARG,2017.0,3,2,1
THA,CHE,2012.0,4,5,-1
AUS,KAZ,2020.0,6,1,5
SRB,TUR,2013.0,2,3,-1
TUR,ARG,2014.0,1,1,0
SVK,GBR,2015.0,9,9,0
BRN,IND,2014.0,1,2,-1
PSE,USA,2002.0,5,2,3
ITA,TZA,2018.0,5,2,3
PRT,SRB,2013.0,4,1,3
ITA,TZA,2017.0,1,2,-1
SRB,AUS,2020.0,1,1,0
CRI,GBR,2020.0,5,1,4
NLD,CRI,2004.0,3,1,2
IRN,ARM,2019.0,1,1,0
JOR,EGY,2011.0,2,3,-1
ARE,NZL,2023.0,1,7,-6
ARE,CHN,2008.0,1,1,0
NLD,KOR,2007.0,6,6,0
BRA,MOZ,2017.0,8,8,0
ARE,KOR,2020.0,6,21,-15
PAK,QAT,2019.0,10,3,7
PHL,GBR,2021.0,12,8,4
MAR,DZA,2018.0,4,3,1
SDN,CHN,2016.0,4,10,-6
MDA,USA,2019.0,6,6,0
CAN,LBY,2014.0,2,2,0
KOR,ITA,2011.0,7,4,3
ISR,NLD,2010.0,6,6,0
NOR,CAN,2008.0,5,16,-11
TWN,CHE,2005.0,3,2,1
MAC,CHN,2012.0,21,52,-31
MYS,KWT,2016.0,2,1,1
TWN,KOR,2012.0,18,10,8
BGR,BEL,2017.0,6,4,2
BEL,BGR,2018.0,10,3,7
ZAF,CHE,2002.0,8,6,2
USA,ZMB,2016.0,14,26,-12
CHE,UKR,2021.0,3,9,-6
RUS,CZE,2012.0,8,3,5
NLD,TZA,2023.0,2,1,1
NOR,SRB,2023.0,2,1,1
ARM,GBR,2017.0,3,2,1
ESP,CRI,2013.0,10,5,5
FRA,IRN,2023.0,16,26,-10
IDN,HKG,2018.0,1,1,0
CZE,IRL,2009.0,4,3,1
EGY,BEL,2023.0,6,2,4
IND,KWT,2020.0,5,3,2
GHA,UGA,2021.0,2,1,1
ZAF,BWA,2023.0,7,10,-3
NZL,CHL,2019.0,4,6,-2
MDG,USA,2017.0,4,2,2
GBR,MKD,2013.0,2,1,1
KHM,GBR,2017.0,4,2,2
SAU,KOR,2017.0,14,26,-12
SVK,EGY,2020.0,4,1,3
EGY,BGR,2020.0,2,1,1
SDN,ARE,2022.0,5,2,3
AUT,RUS,2023.0,2,22,-20
GEO,LTU,2021.0,1,1,0
IRN,PAK,2014.0,1,1,0
AUS,MMR,2022.0,4,3,1
MDG,USA,2022.0,6,5,1
AUT,UKR,2017.0,5,6,-1
COG,BEL,2022.0,3,2,1
CHE,PRT,2006.0,9,8,1
MYS,KOR,2007.0,6,1,5
BEL,BEN,2014.0,3,1,2
DZA,PRT,2019.0,4,5,-1
ESP,KOR,2016.0,8,10,-2
BRA,NZL,2011.0,4,2,2
IRN,QAT,2013.0,3,1,2
BGD,SWE,2011.0,6,7,-1
NOR,NLD,2010.0,8,27,-19
THA,GBR,2010.0,33,58,-25
IRN,ISR,2011.0,1,2,-1
FIN,IND,2017.0,14,17,-3
USA,CMR,2009.0,6,3,3
DNK,TUR,2021.0,6,10,-4
BFA,CHE,2009.0,2,1,1
SDN,EGY,2011.0,5,2,3
BRA,AUS,2013.0,30,24,6
SWE,PAK,2012.0,5,6,-1
BEL,ZAF,2019.0,15,11,4
KOR,AUT,2012.0,4,3,1
ITA,PAN,2019.0,4,1,3
CZE,NZL,2021.0,5,3,2
UKR,ESP,2015.0,6,4,2
ESP,GRC,2015.0,17,21,-4
SVN,JPN,2012.0,1,1,0
HRV,SVN,2012.0,14,10,4
RUS,ROU,1997.0,1,1,0
POL,ISR,2003.0,2,2,0
NOR,FRA,2015.0,22,34,-12
JPN,UKR,2005.0,4,3,1
URY,ESP,1998.0,6,4,2
USA,AIA,2017.0,1,7,-6
GBR,JOR,1999.0,13,6,7
POL,HUN,2022.0,3,5,-2
CHN,JOR,2023.0,3,1,2
HKG,THA,2023.0,2,2,0
BEN,CAN,2022.0,1,1,0
USA,PSE,2003.0,3,1,2
NGA,KEN,2019.0,6,4,2
HUN,JPN,2005.0,4,4,0
SWE,ARG,1997.0,4,2,2
PRT,RUS,2005.0,3,2,1
DEU,KEN,1997.0,1,5,-4
FIN,MDA,1998.0,1,1,0
AUT,GRC,2012.0,5,6,-1
CAN,FIN,2004.0,13,19,-6
IRL,FIN,2008.0,3,9,-6
RUS,AUS,1997.0,8,3,5
ISL,DNK,2014.0,4,3,1
TUN,OMN,2002.0,1,1,0
GRC,CYP,2001.0,3,8,-5
SWE,LKA,2002.0,1,1,0
DNK,ITA,1997.0,11,13,-2
FIN,NOR,1997.0,4,5,-1
USA,BOL,2010.0,5,3,2
ISR,DNK,2002.0,4,2,2
CHN,SWE,2007.0,30,50,-20
BRN,JPN,2018.0,1,1,0
POL,BLR,2005.0,4,3,1
USA,UGA,2007.0,13,11,2
MWI,USA,2006.0,4,5,-1
ISL,RUS,2022.0,1,2,-1
ITA,LTU,2010.0,5,4,1
BEL,TUN,2016.0,6,2,4
ESP,PAN,2011.0,3,1,2
BEL,BFA,2017.0,1,5,-4
MOZ,ESP,2016.0,3,5,-2
ZAF,NZL,2011.0,11,7,4
ZAF,CMR,2018.0,10,7,3
HRV,ITA,2014.0,7,2,5
QAT,CHN,2021.0,4,3,1
ARG,ITA,2023.0,13,6,7
BRA,PRY,2009.0,3,3,0
ETH,SAU,2019.0,2,1,1
EGY,AUT,2015.0,4,7,-3
TUR,ESP,2019.0,11,14,-3
SYR,NZL,2014.0,2,1,1
TZA,FRA,2016.0,1,2,-1
TZA,KEN,2013.0,6,8,-2
NOR,BRA,2017.0,8,4,4
POL,DNK,2020.0,7,5,2
NZL,SVK,2014.0,1,1,0
BEL,CZE,2016.0,10,4,6
CYP,CHN,2023.0,1,1,0
ZAF,ISR,2011.0,3,1,2
MUS,IND,2016.0,1,1,0
BEL,NGA,2020.0,2,3,-1
AUT,PRT,2021.0,6,10,-4
LBY,JOR,2021.0,1,4,-3
LBN,BEL,2022.0,9,1,8
NCL,USA,2023.0,5,5,0
CRI,USA,1997.0,12,9,3
IND,ESP,2005.0,7,5,2
MAR,GBR,2005.0,3,2,1
FRA,KEN,1998.0,1,2,-1
USA,NIC,2016.0,2,4,-2
PRT,ZAF,2010.0,1,3,-2
SGP,BRN,2020.0,2,1,1
GBR,ROU,2007.0,15,12,3
ISR,ESP,1997.0,2,5,-3
VEN,BRA,2002.0,5,1,4
NOR,KOR,2021.0,7,9,-2
VNM,NLD,2023.0,3,4,-1
ETH,ITA,2008.0,2,2,0
CHN,NGA,2018.0,9,17,-8
CHN,NLD,1997.0,8,7,1
AUT,NOR,2022.0,5,17,-12
JOR,CAN,2008.0,5,9,-4
ARG,IND,2021.0,4,1,3
DZA,POL,2023.0,1,1,0
NLD,TWN,2021.0,5,7,-2
ARE,JOR,2008.0,3,7,-4
ECU,USA,2002.0,6,7,-1
JPN,AUT,2001.0,9,8,1
LUX,BEL,2006.0,6,11,-5
FIN,HUN,2005.0,3,5,-2
IND,BEL,1999.0,7,3,4
FIN,POL,2013.0,1,3,-2
BRA,TWN,2007.0,1,1,0
PHL,DEU,2009.0,3,2,1
SVN,DEU,2005.0,8,5,3
TWN,GBR,1998.0,12,19,-7
AUS,MEX,2002.0,2,5,-3
ZAF,BEL,2012.0,7,7,0
GBR,VNM,2006.0,6,4,2
ROU,CHN,2010.0,3,1,2
LBN,USA,1999.0,9,28,-19
BEL,SVK,2012.0,5,2,3
KWT,JOR,2022.0,3,8,-5
SAU,SGP,2022.0,6,5,1
ARE,DNK,2012.0,1,1,0
UKR,NLD,2006.0,5,1,4
JAM,BRB,2021.0,2,3,-1
AUS,MEX,2012.0,11,14,-3
GHA,NLD,2011.0,2,3,-1
AUT,UKR,2018.0,2,5,-3
CMR,ZAF,2014.0,3,5,-2
TUR,NOR,2016.0,6,4,2
MLT,GBR,2018.0,20,19,1
PAK,IND,1998.0,4,5,-1
IRN,FRA,2003.0,5,6,-1
GTM,USA,2013.0,9,15,-6
CHL,IND,2015.0,2,5,-3
VNM,NZL,2016.0,2,3,-1
ARM,RUS,2010.0,4,2,2
GHA,MYS,2022.0,2,4,-2
JAM,CAN,2010.0,4,1,3
BEL,RWA,2018.0,3,2,1
AUS,ROU,2015.0,2,3,-1
ECU,ITA,2021.0,8,1,7
MEX,CRI,2020.0,5,4,1
ITA,IRN,2017.0,18,53,-35
SLE,NGA,2019.0,2,4,-2
KAZ,HUN,2022.0,2,3,-1
PER,JPN,2020.0,2,3,-1
JPN,LKA,2005.0,4,4,0
MNP,USA,2022.0,4,1,3
IDN,DEU,2007.0,2,13,-11
URY,ESP,2007.0,9,8,1
LKA,IND,2018.0,8,7,1
CHE,ROU,2003.0,3,6,-3
SVK,POL,2014.0,6,3,3
GRC,IND,2013.0,2,1,1
USA,BWA,2011.0,9,6,3
GBR,LKA,2007.0,12,6,6
ECU,SWE,2021.0,1,1,0
HKG,JPN,2003.0,8,10,-2
BRA,IRQ,2019.0,1,1,0
NPL,JPN,2003.0,4,6,-2
CHN,DNK,2007.0,8,13,-5
LTU,GBR,2004.0,4,2,2
DEU,MYS,2003.0,1,1,0
DNK,TUR,2009.0,2,1,1
JPN,TZA,2012.0,5,4,1
ZAF,NOR,2014.0,7,1,6
KOR,DEU,2000.0,12,18,-6
DEU,TJK,2021.0,2,1,1
FIN,SGP,2008.0,2,1,1
KGZ,KAZ,2010.0,2,1,1
VEN,ECU,2013.0,7,2,5
ITA,GRC,1997.0,11,11,0
CAF,FRA,2007.0,5,6,-1
USA,SUR,2015.0,1,1,0
PAN,CAN,2011.0,1,4,-3
NLD,CZE,2013.0,11,11,0
ETH,KEN,2007.0,3,4,-1
CAN,GRL,2018.0,1,2,-1
DNK,POL,2004.0,5,4,1
IRN,ITA,2008.0,13,1,12
GBR,BWA,2014.0,8,3,5
CAN,SVN,2014.0,2,1,1
ROU,ESP,2007.0,8,1,7
UGA,TZA,2012.0,2,4,-2
JOR,AUS,2007.0,1,5,-4
GBR,GMB,2003.0,15,9,6
CRI,ESP,2009.0,7,7,0
ARG,JPN,2017.0,3,2,1
PAK,MYS,2007.0,1,1,0
ERI,IND,2016.0,2,1,1
MYS,CHN,2012.0,6,5,1
USA,EST,2018.0,3,8,-5
MAR,CHN,2017.0,6,2,4
TGO,CHN,2017.0,1,1,0
CHN,TGO,2019.0,2,1,1
IRN,HUN,2013.0,1,3,-2
TWN,RUS,2019.0,2,2,0
CAN,JOR,2019.0,17,7,10
CHN,CMR,2020.0,7,3,4
GBR,PHL,2018.0,5,5,0
SWE,BGD,2013.0,3,4,-1
ARM,USA,2015.0,8,6,2
LUX,ARG,2021.0,1,1,0
BRA,FIN,2011.0,2,2,0
ARE,JOR,1999.0,1,5,-4
NZL,ARE,2006.0,2,2,0
DEU,KWT,2016.0,2,1,1
NOR,POL,2007.0,4,6,-2
FRA,CAF,2003.0,7,2,5
VNM,IRN,2022.0,11,2,9
KAZ,SAU,2022.0,4,2,2
SYR,EGY,2022.0,1,1,0
SAU,QAT,2023.0,6,2,4
KEN,DNK,1998.0,2,1,1
DEU,CHL,1999.0,7,15,-8
MYS,GBR,1999.0,21,47,-26
ITA,SVK,2002.0,4,14,-10
TUR,AZE,2000.0,5,5,0
JPN,ZMB,2002.0,2,1,1
NOR,AUT,2003.0,1,1,0
ITA,TUR,2007.0,6,4,2
NLD,SVK,2001.0,7,3,4
BRN,AUS,2010.0,1,2,-1
DEU,SVK,2000.0,14,25,-11
NOR,TZA,1999.0,3,2,1
DEU,MAR,2004.0,3,2,1
CAN,KEN,2001.0,3,4,-1
SWE,SAU,1997.0,4,2,2
RUS,NLD,2015.0,14,19,-5
ITA,ROU,2020.0,13,14,-1
SWE,BLR,2010.0,2,1,1
BEL,BFA,2011.0,4,4,0
ITA,JPN,2013.0,23,18,5
AUS,FIN,2016.0,9,20,-11
TZA,UGA,2015.0,4,2,2
IRL,THA,2018.0,2,1,1
BEN,NLD,2013.0,2,2,0
GBR,BGR,2016.0,7,6,1
BEL,UGA,2013.0,2,2,0
CAN,LTU,2013.0,3,1,2
AUT,BIH,2013.0,4,1,3
FRA,SVN,2015.0,3,1,2
POL,DNK,2014.0,7,6,1
IRN,THA,2013.0,1,1,0
TUN,SWE,2021.0,1,1,0
ITA,TUN,2023.0,5,4,1
NOR,KOR,2022.0,4,9,-5
USA,CMR,2016.0,6,11,-5
IND,PRT,2018.0,14,19,-5
MNG,CHN,2020.0,10,9,1
HKG,NLD,2012.0,5,4,1
ECU,ITA,2022.0,6,1,5
CHN,MAR,2023.0,7,2,5
SGP,HKG,1999.0,9,15,-6
SWE,PRT,2001.0,6,4,2
GRC,MKD,2019.0,1,1,0
KEN,JPN,2008.0,11,5,6
FRA,BOL,2003.0,1,6,-5
ZMB,JPN,1997.0,1,2,-1
AUT,SGP,2012.0,6,5,1
IDN,FRA,2004.0,3,5,-2
TWN,FRA,2008.0,7,11,-4
IND,BRA,2009.0,3,6,-3
QAT,IRN,2021.0,2,2,0
CHN,ARE,2024.0,1,1,0
ETH,CHE,2021.0,3,5,-2
IND,TUR,2023.0,6,7,-1
ZMB,IND,2022.0,1,2,-1
GBR,LBN,2000.0,2,2,0
NZL,JPN,2008.0,7,13,-6
BFA,SEN,2002.0,3,1,2
PHL,SGP,2013.0,6,4,2
FRA,TUR,2005.0,5,8,-3
KOR,VNM,2003.0,8,1,7
CHL,DNK,2019.0,3,1,2
ZAF,ETH,2013.0,8,9,-1
ISR,HRV,2020.0,2,1,1
MYS,FRA,2009.0,3,5,-2
HRV,POL,2019.0,3,1,2
GBR,QAT,2011.0,8,6,2
PER,BRA,2005.0,1,5,-4
PHL,GBR,2017.0,4,5,-1
MYS,EGY,2019.0,8,1,7
DEU,BGR,2022.0,3,6,-3
AUS,TWN,2018.0,14,21,-7
CHL,PRY,2022.0,4,1,3
MYS,FIN,2021.0,3,2,1
UKR,ESP,2020.0,5,4,1
FRA,NER,2001.0,3,5,-2
ZAF,MAR,2005.0,1,1,0
DEU,CRI,2018.0,10,4,6
TUR,KWT,2020.0,8,3,5
BEL,BEN,1998.0,2,2,0
ARG,ISR,2003.0,2,2,0
CHE,NZL,2021.0,14,10,4
DEU,PER,2018.0,7,2,5
UZB,MYS,2014.0,2,1,1
FRA,KOR,2003.0,6,1,5
CAN,TWN,2016.0,18,13,5
CAN,PER,2016.0,2,7,-5
HRV,CAN,2020.0,5,5,0
ZAF,CMR,2009.0,5,5,0
GBR,SVN,2011.0,4,6,-2
HKG,JPN,2005.0,6,6,0
LBY,OMN,2022.0,2,1,1
FIN,CZE,2011.0,7,2,5
CHE,THA,2013.0,4,5,-1
MYS,HKG,2023.0,5,2,3
ZWE,AUS,2017.0,3,2,1
CAN,PHL,2020.0,8,6,2
DEU,COL,1999.0,2,4,-2
ARM,DEU,2022.0,4,2,2
HUN,DNK,2001.0,7,1,6
USA,BIH,2011.0,7,2,5
KWT,GBR,1999.0,3,3,0
CZE,FIN,2014.0,5,3,2
BGR,IRL,2007.0,1,1,0
ESP,FIN,1998.0,3,3,0
CAF,FRA,2015.0,3,2,1
AUS,ISR,2002.0,13,10,3
NLD,ROU,1999.0,3,1,2
SRB,BEL,2008.0,1,2,-1
NOR,ISR,2013.0,3,2,1
SGP,TWN,2020.0,12,12,0
ITA,KEN,2005.0,2,2,0
COL,CRI,2016.0,3,2,1
IRL,SVN,2020.0,3,2,1
MYS,CZE,2021.0,3,2,1
GBR,HRV,2016.0,10,14,-4
ARG,AUS,2020.0,10,2,8
MAR,DEU,2017.0,2,6,-4
FRA,COD,2020.0,4,3,1
ITA,ECU,2022.0,1,6,-5
SVK,HRV,2021.0,1,1,0
RWA,UGA,2023.0,3,6,-3
BGD,SAU,2022.0,10,11,-1
BGD,FRA,2023.0,1,1,0
NLD,LBN,2022.0,3,10,-7
DNK,IRL,2019.0,6,6,0
FRA,BFA,2011.0,14,15,-1
USA,MDA,2020.0,4,7,-3
JPN,MDG,2021.0,1,1,0
SDN,FRA,2020.0,3,1,2
CHE,NZL,2020.0,19,7,12
TJK,KGZ,2020.0,1,1,0
MYS,PSE,2021.0,8,3,5
CHL,IND,2021.0,6,13,-7
BLR,GBR,2021.0,2,1,1
SAU,BHR,2023.0,5,4,1
USA,SDN,2021.0,3,4,-1
PER,DEU,2007.0,5,2,3
MEX,CUB,2016.0,4,41,-37
SVN,CHE,2022.0,11,4,7
ETH,NOR,2022.0,3,9,-6
SDN,TUR,2022.0,3,2,1
OMN,EGY,2022.0,11,13,-2
BEL,HRV,2022.0,1,2,-1
PER,DEU,2020.0,5,6,-1
DZA,ARE,2022.0,3,3,0
KAZ,USA,2022.0,16,13,3
GEO,GBR,2023.0,5,1,4
TUR,QAT,2021.0,10,4,6
RUS,SVK,2022.0,10,4,6
LKA,JPN,2022.0,5,7,-2
TUR,ITA,2023.0,18,3,15
TUR,DNK,2023.0,7,1,6
SGP,TWN,2021.0,22,12,10
SRB,DEU,2022.0,6,9,-3
TUR,TWN,2021.0,5,3,2
MMR,USA,2014.0,1,2,-1
PSE,GRC,2012.0,1,2,-1
EST,USA,2014.0,15,5,10
SGP,IDN,2017.0,7,4,3
NLD,ROU,2009.0,6,4,2
SRB,USA,2012.0,9,31,-22
BEL,TUR,2014.0,14,8,6
CAN,THA,2001.0,9,8,1
DNK,GRC,2022.0,7,12,-5
FRA,KEN,2017.0,2,7,-5
IRL,BRA,2015.0,7,8,-1
BIH,CHE,2012.0,1,2,-1
IRN,JPN,2015.0,13,8,5
JOR,GBR,2007.0,4,14,-10
SVN,SVK,2000.0,5,2,3
KAZ,TUR,2017.0,3,9,-6
DNK,IRN,2012.0,6,17,-11
TUR,IRN,2008.0,4,1,3
JPN,HKG,1997.0,2,6,-4
HKG,JPN,2000.0,5,8,-3
IDN,IND,2008.0,8,8,0
NGA,MYS,2010.0,11,5,6
CRI,CAN,2016.0,1,3,-2
CAN,CRI,2020.0,6,4,2
NPL,DEU,2010.0,4,2,2
NOR,NLD,2013.0,24,34,-10
CHN,FIN,2003.0,11,3,8
GBR,MWI,2001.0,7,6,1
IRL,CAN,2003.0,11,13,-2
CHE,NOR,2008.0,12,6,6
NOR,TZA,2009.0,7,4,3
COL,CHE,2012.0,2,3,-1
BRA,CHL,2013.0,12,19,-7
FRA,SVK,2015.0,4,2,2
CHE,CMR,2017.0,4,4,0
GNB,DNK,2012.0,5,5,0
UKR,GBR,2022.0,4,2,2
ESP,SVK,2009.0,2,3,-1
TUR,SAU,2015.0,8,7,1
GHA,CAN,2009.0,3,2,1
DNK,POL,2011.0,3,7,-4
POL,AUT,2012.0,11,12,-1
HKG,JPN,2010.0,10,7,3
IRL,FIN,2011.0,6,1,5
USA,MAR,2006.0,7,3,4
SGP,RUS,2011.0,1,3,-2
FIN,NLD,2011.0,13,24,-11
CZE,MYS,2021.0,2,3,-1
VNM,KOR,2008.0,2,11,-9
NPL,JPN,2010.0,2,6,-4
KEN,NLD,2012.0,5,9,-4
NLD,KEN,2015.0,12,7,5
ZMB,KEN,2021.0,4,1,3
NZL,ITA,2022.0,8,3,5
FIN,TUR,2010.0,7,1,6
AUS,BGD,2007.0,5,8,-3
IDN,KOR,2007.0,2,2,0
GBR,JAM,2009.0,3,5,-2
KOR,EGY,2009.0,4,5,-1
THA,MYS,2003.0,2,1,1
BRA,IND,2002.0,7,2,5
IRL,NOR,2001.0,4,4,0
SAU,GBR,2009.0,22,45,-23
VNM,FRA,2009.0,5,14,-9
VEN,PER,2018.0,4,1,3
IRN,IND,2012.0,10,21,-11
ITA,SVN,2007.0,7,3,4
CHL,AUT,2020.0,7,5,2
EST,NLD,2022.0,2,4,-2
AUT,COL,2014.0,3,2,1
VNM,USA,2009.0,8,14,-6
ISR,TWN,2017.0,4,3,1
DNK,FIN,2014.0,9,18,-9
BIH,SRB,2009.0,7,8,-1
BEN,FRA,2006.0,7,8,-1
GEO,NLD,2017.0,2,2,0
BEN,USA,2009.0,4,1,3
UZB,DEU,2013.0,6,2,4
VEN,AUS,2012.0,2,1,1
ZAF,QAT,2022.0,3,2,1
HUN,RUS,2009.0,5,2,3
TWN,NOR,2016.0,2,1,1
IDN,CZE,2019.0,2,1,1
IRL,PAK,2019.0,9,10,-1
IND,NZL,2015.0,12,8,4
ITA,SVN,2020.0,15,11,4
CHN,BRA,2017.0,7,18,-11
CHL,GBR,2001.0,1,10,-9
PAK,BRN,2020.0,3,1,2
ITA,EGY,2013.0,12,4,8
JPN,POL,2015.0,11,7,4
GRC,IRL,2019.0,8,7,1
MNG,CHN,2021.0,14,6,8
LIE,CHE,2010.0,1,4,-3
RUS,PRT,2011.0,4,9,-5
RUS,PRT,2019.0,5,9,-4
GNQ,GIN,2015.0,2,1,1
NOR,POL,2021.0,9,8,1
JPN,NLD,2010.0,16,19,-3
SWE,MYS,2017.0,5,1,4
URY,ESP,2017.0,9,17,-8
ISR,SGP,2021.0,9,7,2
GBR,CYP,2016.0,43,20,23
HKG,DEU,2015.0,8,17,-9
HRV,POL,2020.0,4,1,3
USA,MOZ,2016.0,9,11,-2
KHM,USA,2018.0,4,11,-7
SAU,IRN,2015.0,1,2,-1
SLV,USA,2018.0,8,3,5
ARG,DZA,2017.0,1,1,0
GBR,ETH,2011.0,6,8,-2
CAN,TUR,2015.0,27,15,12
MEX,ARG,2020.0,28,22,6
LVA,DEU,2021.0,4,6,-2
BRA,NZL,2014.0,1,6,-5
NZL,BGD,2022.0,5,1,4
IND,ITA,1999.0,18,7,11
TWN,DNK,2003.0,1,1,0
GRC,RUS,2008.0,3,3,0
ISR,IND,2001.0,10,20,-10
AUS,ECU,2022.0,3,6,-3
MYS,USA,2005.0,15,21,-6
AUS,ARE,2001.0,4,3,1
TWN,CRI,2019.0,1,1,0
CHE,HRV,2000.0,2,8,-6
OMN,USA,2021.0,7,6,1
DNK,FIN,2001.0,7,5,2
SAU,TUR,2009.0,8,2,6
BRA,CUB,2000.0,6,6,0
MTQ,FRA,2017.0,23,17,6
IRQ,GBR,2008.0,3,7,-4
KAZ,DNK,2020.0,1,1,0
DEU,ROU,2000.0,15,27,-12
SDN,SSD,2019.0,10,3,7
ETH,FJI,2020.0,1,1,0
CHE,SGP,1998.0,3,1,2
SGP,CHE,1999.0,3,6,-3
PAK,DEU,1998.0,4,4,0
DEU,PHL,2022.0,3,7,-4
SAU,BGD,2019.0,7,9,-2
GMB,USA,2021.0,3,3,0
FRA,CMR,2022.0,13,16,-3
EGY,KOR,2014.0,3,6,-3
COL,SAU,2022.0,4,1,3
MYS,RUS,2018.0,3,1,2
RUS,KGZ,2022.0,8,3,5
PAK,EGY,2021.0,6,10,-4
CYM,USA,2021.0,3,2,1
GUY,FJI,2022.0,1,1,0
BHR,IRQ,2022.0,2,2,0
UZB,CHN,2022.0,5,12,-7
HUN,IDN,2022.0,5,6,-1
MYS,CAN,2022.0,25,12,13
MYS,THA,2022.0,11,9,2
TUN,CAN,2012.0,5,6,-1
DNK,SVN,2023.0,2,2,0
BGR,SWE,2007.0,5,2,3
DNK,UGA,2000.0,3,1,2
MAR,MEX,2011.0,1,4,-3
ARE,FRA,2012.0,4,8,-4
RUS,IRL,2001.0,4,1,3
ISR,AUT,2006.0,5,1,4
RUS,ARM,1997.0,5,9,-4
CHE,UKR,2014.0,2,6,-4
JPN,IRN,2002.0,9,6,3
SAU,SDN,2005.0,6,4,2
IND,LKA,2014.0,4,5,-1
DEU,SVN,1998.0,4,3,1
DNK,JPN,1998.0,10,5,5
EGY,YEM,2008.0,3,1,2
BGR,RUS,2014.0,7,5,2
UKR,GBR,2016.0,20,20,0
AUS,ISR,2000.0,3,8,-5
BGR,POL,2006.0,2,1,1
FRA,URY,2004.0,5,1,4
SGP,THA,2007.0,6,3,3
ITA,BLR,1997.0,2,1,1
HRV,DEU,1998.0,12,15,-3
CHL,CHE,2012.0,9,12,-3
SRB,JPN,2004.0,1,5,-4
NOR,DEU,1997.0,17,8,9
IRN,JPN,2004.0,6,13,-7
DEU,BLR,2012.0,3,10,-7
ROU,PRT,2011.0,4,2,2
IRN,AUS,2004.0,8,15,-7
HUN,POL,2001.0,1,2,-1
BEL,ISL,2019.0,1,1,0
ESP,JPN,2003.0,4,12,-8
BEL,FIN,2014.0,9,10,-1
ROU,HUN,2001.0,7,1,6
JPN,ROU,1997.0,3,7,-4
GBR,BGR,2001.0,11,29,-18
SLV,ARG,2009.0,1,1,0
RUS,BGR,2002.0,5,8,-3
GBR,AZE,2012.0,1,3,-2
USA,ARM,2005.0,6,8,-2
UKR,SWE,1997.0,6,4,2
BEL,UZB,1997.0,1,1,0
NOR,CAN,2009.0,8,14,-6
DNK,CZE,2002.0,1,2,-1
CIV,MLI,2017.0,4,4,0
DEU,PRT,1999.0,11,12,-1
BGR,GRC,2020.0,1,2,-1
GRC,BGR,2021.0,3,4,-1
ZAF,SAU,1997.0,5,4,1
DNK,CZE,1997.0,2,2,0
USA,CMR,2015.0,13,11,2
POL,SVK,2019.0,3,4,-1
AZE,RUS,1998.0,11,4,7
ARM,JPN,2000.0,1,1,0
CHE,BGR,2008.0,5,3,2
ITA,UKR,2007.0,3,5,-2
TUR,ARG,2019.0,3,2,1
MAR,USA,1999.0,6,5,1
EST,USA,2001.0,6,5,1
BLR,POL,2011.0,3,2,1
KOR,THA,2003.0,1,3,-2
ITA,UKR,1999.0,1,3,-2
DMA,USA,2015.0,3,2,1
FRA,PYF,1998.0,4,5,-1
AUT,CHN,2010.0,12,18,-6
FRA,MLI,2015.0,5,6,-1
PAK,EGY,2019.0,3,2,1
NGA,PNG,1998.0,1,1,0
MYS,IND,2003.0,6,20,-14
ITA,KOR,1997.0,1,1,0
ESP,BOL,2006.0,4,1,3
DNK,AUT,1997.0,2,3,-1
TZA,AUS,2013.0,2,2,0
SAU,ITA,2000.0,1,2,-1
USA,UZB,2008.0,1,2,-1
COG,COD,1999.0,1,5,-4
CAN,UKR,2004.0,2,9,-7
HKG,CAN,2002.0,28,32,-4
KEN,GBR,1997.0,13,9,4
TUN,CHE,2005.0,2,2,0
USA,BIH,1999.0,2,3,-1
EST,DEU,2001.0,2,5,-3
CAN,URY,2014.0,1,1,0
COL,MEX,2003.0,7,9,-2
TUR,CHE,1997.0,5,3,2
BEL,ROU,2012.0,5,14,-9
DNK,RUS,2018.0,5,9,-4
DEU,PER,2008.0,2,1,1
KHM,LKA,2000.0,1,1,0
CIV,BEN,2018.0,1,13,-12
BOL,USA,2009.0,6,3,3
PSE,GBR,2003.0,2,1,1
DNK,SGP,2015.0,3,4,-1
SWE,HUN,2005.0,2,10,-8
ISR,RUS,2012.0,11,7,4
CHL,NOR,2014.0,1,1,0
AUS,PAN,2019.0,1,1,0
CHL,FRA,2007.0,26,30,-4
FRA,HKG,2000.0,3,2,1
SAU,ITA,2010.0,1,6,-5
SWE,IRN,2017.0,13,31,-18
ITA,TUR,2011.0,7,11,-4
VEN,AUS,2002.0,1,3,-2
GBR,TTO,2001.0,11,3,8
LBY,FRA,2011.0,2,1,1
IRN,JPN,2008.0,12,23,-11
GBR,COL,2010.0,10,10,0
BEL,NGA,2016.0,2,3,-1
ESP,ROU,2011.0,5,7,-2
USA,HRV,2018.0,14,11,3
JPN,DZA,2014.0,1,2,-1
SDN,DEU,2013.0,3,6,-3
ITA,SAU,2012.0,12,2,10
ISR,AUT,2010.0,3,2,1
SAU,JOR,2012.0,8,42,-34
ESP,ECU,2009.0,3,6,-3
NLD,LKA,2020.0,3,1,2
MEX,ECU,2016.0,6,5,1
CZE,AUT,2011.0,14,8,6
SWE,NGA,2009.0,1,3,-2
EGY,MYS,2006.0,2,1,1
DEU,DZA,2011.0,4,1,3
BEL,FIN,2015.0,4,8,-4
CAN,COL,2016.0,8,21,-13
UGA,NOR,2016.0,3,3,0
NOR,UGA,2019.0,2,4,-2
BEL,COG,2010.0,3,1,2
NZL,CHL,2015.0,6,4,2
JOR,CAN,2011.0,12,12,0
ZAF,DNK,2020.0,6,1,5
COL,BEL,2009.0,2,2,0
HKG,PHL,2017.0,2,2,0
SVK,SLV,2013.0,2,8,-6
MYS,YEM,2009.0,3,5,-2
BEL,MYS,2011.0,2,1,1
IRL,POL,2022.0,4,2,2
TUN,ESP,2011.0,6,5,1
BGD,SWE,2014.0,5,4,1
POL,SVK,2011.0,4,5,-1
DNK,PRT,2018.0,4,11,-7
LTU,LVA,2014.0,3,4,-1
TUN,USA,2016.0,8,7,1
ESP,AND,2010.0,2,1,1
ITA,TUR,2009.0,7,8,-1
TUR,AUS,2013.0,3,6,-3
DNK,ISL,2009.0,3,3,0
GAB,USA,2017.0,2,2,0
LBY,FRA,2009.0,1,2,-1
URY,CAN,2012.0,1,2,-1
USA,CUB,2014.0,9,14,-5
SVK,ESP,2010.0,4,2,2
GAB,USA,2016.0,1,5,-4
SRB,AUT,2019.0,9,4,5
UGA,GBR,2012.0,10,17,-7
IND,POL,2015.0,8,4,4
SAU,EGY,2024.0,9,4,5
FIN,AUS,2012.0,14,15,-1
MEX,HND,2021.0,2,2,0
KEN,IDN,2019.0,2,1,1
TTO,BRB,2016.0,2,1,1
CYP,USA,2019.0,9,14,-5
SGP,BEL,2011.0,7,6,1
NGA,ITA,2012.0,3,7,-4
EGY,KWT,2007.0,6,6,0
HKG,KAZ,2021.0,1,1,0
HUN,SRB,2021.0,2,7,-5
DEU,LTU,2019.0,11,12,-1
NLD,SVK,2016.0,3,5,-2
GBR,PAN,2019.0,6,1,5
ZAF,GRC,2020.0,3,1,2
USA,MMR,2018.0,3,3,0
DEU,VEN,2014.0,6,1,5
SVK,AUT,2021.0,17,9,8
IRQ,CHN,2011.0,2,2,0
BWA,KEN,2021.0,4,2,2
RUS,NOR,2021.0,17,4,13
FRA,THA,2006.0,9,9,0
SWE,EGY,2021.0,5,2,3
KEN,BEL,2013.0,2,3,-1
PSE,ISR,2014.0,7,21,-14
USA,EST,2020.0,8,10,-2
LUX,CHE,2018.0,3,8,-5
TWN,FIN,2019.0,1,3,-2
NGA,AUS,2015.0,5,2,3
IND,SVK,2017.0,3,1,2
UKR,POL,2001.0,17,13,4
ECU,ITA,2014.0,1,5,-4
DNK,MYS,2020.0,5,6,-1
CRI,CAN,2017.0,3,5,-2
CHN,MNG,2007.0,4,1,3
DNK,LUX,2016.0,2,1,1
ITA,EST,2017.0,5,1,4
PRT,THA,2013.0,1,2,-1
SVN,FRA,2016.0,9,6,3
ZAF,NAM,2017.0,15,9,6
GHA,USA,2013.0,10,21,-11
ITA,ECU,2017.0,7,4,3
IND,FJI,2008.0,2,2,0
OMN,AUS,2013.0,1,3,-2
USA,COG,2013.0,3,5,-2
USA,LVA,2016.0,7,4,3
TWN,ETH,2014.0,1,2,-1
IRQ,USA,2011.0,8,11,-3
NGA,PAK,2017.0,5,3,2
BRB,USA,2013.0,3,4,-1
SDN,ETH,2020.0,1,1,0
IRL,SGP,2017.0,5,2,3
AFG,TUR,2018.0,1,1,0
GRC,CZE,2012.0,3,1,2
FRA,EST,2020.0,5,3,2
COL,CRI,2014.0,3,2,1
SAU,HKG,2019.0,6,3,3
MLI,NLD,2016.0,1,2,-1
ZAF,EGY,2014.0,5,3,2
FRA,PSE,2018.0,5,2,3
RWA,SWE,2016.0,3,4,-1
GBR,ZMB,2018.0,7,11,-4
CAN,TTO,2020.0,2,3,-1
GHA,JPN,2020.0,3,8,-5
COL,DNK,2019.0,3,5,-2
BHR,USA,2008.0,4,1,3
HKG,SWE,2023.0,7,7,0
ZAF,ESP,2021.0,7,6,1
THA,ESP,2020.0,6,5,1
AUS,PHL,2023.0,9,8,1
HKG,IRN,2014.0,1,4,-3
PHL,GBR,2014.0,8,9,-1
ARM,EST,2017.0,1,1,0
SAU,KWT,2016.0,5,2,3
AUT,ISR,2013.0,4,7,-3
TUR,ITA,2000.0,3,4,-1
RUS,SAU,2021.0,5,4,1
ARE,KOR,2018.0,4,14,-10
CAN,ARG,2020.0,8,24,-16
MAR,MRT,2018.0,4,1,3
KHM,THA,2021.0,2,17,-15
SAU,MAC,2018.0,1,2,-1
DEU,URY,2019.0,3,3,0
IRQ,FRA,2015.0,2,1,1
CUB,FRA,2021.0,8,3,5
PRI,IND,2013.0,1,3,-2
KEN,CAN,2008.0,3,1,2
VNM,DEU,2020.0,14,30,-16
IND,PAN,2020.0,2,1,1
DZA,CAN,2019.0,10,8,2
IRQ,OMN,2020.0,2,1,1
TGO,CIV,2019.0,1,1,0
POL,CHN,2024.0,1,1,0
BEL,MYS,2009.0,3,3,0
NZL,NPL,2018.0,4,3,1
SGP,MMR,2019.0,1,2,-1
TUR,FRA,2021.0,27,25,2
KEN,ITA,2019.0,5,2,3
GBR,COG,2021.0,1,1,0
ITA,SVK,2023.0,2,2,0
NLD,RWA,2020.0,4,3,1
CHL,PER,2019.0,5,5,0
SLB,FJI,2022.0,1,1,0
SWE,SVN,2019.0,5,5,0
BRN,MYS,2020.0,2,12,-10
FRA,GUY,2021.0,2,1,1
TWN,AUS,2005.0,4,14,-10
ESP,CUB,1997.0,7,16,-9
VNM,NOR,2019.0,3,1,2
GBR,BFA,2021.0,2,2,0
AUT,VNM,2021.0,7,3,4
IND,CHN,2024.0,1,5,-4
SAU,JPN,2021.0,7,8,-1
SWE,ISL,2003.0,14,14,0
COD,CHN,2022.0,1,2,-1
GBR,SYR,2020.0,4,2,2
CRI,NLD,2020.0,3,6,-3
JPN,ARG,2021.0,2,2,0
FRA,CIV,2023.0,14,6,8
NLD,SVK,2017.0,2,6,-4
KEN,MWI,2020.0,4,2,2
THA,ARE,2023.0,4,1,3
PAK,IND,2016.0,19,44,-25
PRT,TUR,2022.0,1,6,-5
BIH,GBR,2022.0,4,1,3
BEL,ZAF,2008.0,9,4,5
TWN,NLD,2020.0,5,9,-4
SVN,CHE,2018.0,9,6,3
IRN,NZL,2022.0,6,5,1
PHL,COL,2021.0,2,2,0
COL,NLD,2022.0,11,7,4
SVN,FRA,2022.0,9,3,6
BLR,PRT,2023.0,1,1,0
ECU,ESP,2013.0,5,27,-22
RUS,TUR,2001.0,5,3,2
CHE,NZL,1998.0,7,2,5
AUS,COL,2007.0,3,2,1
LKA,IND,2007.0,6,3,3
GBR,BEN,1999.0,1,1,0
BRA,BEL,2005.0,11,6,5
KAZ,ISR,2016.0,1,1,0
PRT,CAN,2003.0,7,7,0
CHE,SGP,1999.0,6,3,3
NZL,FJI,2003.0,6,2,4
USA,GTM,2000.0,5,10,-5
CZE,TWN,2014.0,4,2,2
IND,AUT,2001.0,5,2,3
LUX,GBR,2013.0,9,12,-3
USA,BRB,2001.0,4,3,1
CHN,PRT,1999.0,6,2,4
NPL,JPN,2006.0,2,10,-8
HRV,GBR,1998.0,5,1,4
DEU,BGD,2006.0,6,1,5
PYF,FRA,1998.0,5,4,1
FRA,AUS,2005.0,42,43,-1
NLD,IND,2004.0,10,15,-5
GUY,GBR,1999.0,1,1,0
DEU,PAK,2004.0,7,6,1
PAK,USA,1998.0,9,15,-6
DNK,UKR,2004.0,1,1,0
PRT,CHN,2011.0,9,13,-4
PAK,SWE,2005.0,1,2,-1
GBR,VEN,2011.0,7,4,3
CZE,AUS,1999.0,2,3,-1
AUT,IND,2010.0,7,11,-4
KOR,SGP,2004.0,5,3,2
LBY,FIN,2011.0,1,1,0
USA,VIR,2004.0,3,1,2
GRC,CHN,2005.0,4,2,2
BRA,AUS,2006.0,7,11,-4
NGA,CHE,2020.0,3,25,-22
KHM,LAO,2020.0,3,3,0
HUN,RUS,2019.0,3,5,-2
SVN,AUS,2019.0,4,2,2
SVK,FRA,2007.0,3,8,-5
SAU,HKG,2021.0,6,2,4
ETH,KEN,2022.0,4,4,0
KEN,ETH,2023.0,4,4,0
EGY,IND,2009.0,2,3,-1
LTU,BEL,2019.0,3,1,2
GRC,AUT,2017.0,8,4,4
DEU,KOR,2003.0,28,22,6
DEU,MYS,2023.0,3,4,-1
IND,PRT,2008.0,9,2,7
CZE,FIN,2017.0,4,8,-4
DNK,MUS,2021.0,1,1,0
IRQ,POL,2018.0,5,2,3
EST,IND,2019.0,1,2,-1
NGA,FIN,2021.0,1,2,-1
RUS,IND,2024.0,1,1,0
JPN,IRN,2012.0,14,13,1
SVK,USA,2019.0,14,13,1
BEL,COD,2018.0,11,4,7
USA,MAR,2010.0,8,5,3
TUR,RUS,2012.0,3,2,1
ISR,IND,2008.0,12,17,-5
NLD,KOR,2016.0,10,7,3
IND,IRN,2018.0,15,7,8
MEX,PRI,2018.0,1,1,0
JPN,MEX,2001.0,4,1,3
NGA,IND,2008.0,5,5,0
ISR,FIN,2003.0,2,2,0
ITA,LUX,2016.0,16,3,13
COL,NLD,2016.0,5,5,0
PAK,THA,2010.0,3,2,1
BEL,EGY,2017.0,5,5,0
FIN,ROU,2017.0,1,1,0
THA,PHL,2023.0,6,4,2
SVN,GBR,2018.0,9,15,-6
MYS,PHL,2022.0,5,5,0
CMR,PAK,2022.0,1,2,-1
ITA,MLT,2021.0,5,8,-3
HKG,PHL,2022.0,1,2,-1
MCO,ITA,2020.0,1,1,0
IRL,KWT,2021.0,3,2,1
ITA,CZE,2023.0,14,13,1
AUS,FIN,2001.0,3,8,-5
FIN,AUS,2002.0,6,12,-6
SWE,UKR,2002.0,2,9,-7
BEL,CZE,1999.0,4,4,0
KNA,USA,2012.0,3,4,-1
USA,KNA,2013.0,4,2,2
TTO,KNA,2017.0,9,1,8
AZE,RUS,1999.0,3,6,-3
IND,PRI,1999.0,1,1,0
SVK,POL,2009.0,6,6,0
NGA,IND,2001.0,3,6,-3
IND,NGA,2002.0,1,2,-1
NGA,IND,2004.0,1,2,-1
DNK,ISL,2021.0,10,3,7
SRB,AUS,2016.0,2,1,1
AUS,SRB,2017.0,3,2,1
SAU,DEU,2003.0,2,3,-1
JPN,TUR,2006.0,13,9,4
FRA,MDG,1997.0,4,4,0
FRA,MDG,2012.0,17,5,12
UKR,BRA,1999.0,1,1,0
SRB,ESP,1998.0,3,6,-3
GBR,VNM,2003.0,9,6,3
FIN,RUS,1997.0,11,12,-1
SWE,CZE,2011.0,4,6,-2
PER,CHL,2021.0,11,14,-3
USA,BRB,2004.0,6,1,5
USA,NPL,2009.0,8,11,-3
DNK,PHL,2006.0,1,1,0
AUS,PHL,2010.0,7,14,-7
GRC,POL,2001.0,1,2,-1
GRC,POL,2004.0,3,1,2
GRC,POL,2014.0,4,2,2
CAN,CZE,2019.0,9,7,2
CAN,EGY,1998.0,6,3,3
UKR,CZE,2011.0,3,1,2
CHE,PAK,2002.0,1,2,-1
PAK,CHE,2006.0,2,2,0
FRA,MDG,2002.0,11,8,3
USA,IRQ,2008.0,3,9,-6
SAU,JOR,2005.0,2,4,-2
NLD,ZWE,2008.0,3,3,0
BFA,GHA,2011.0,1,1,0
IND,NZL,2001.0,6,2,4
BEN,KEN,2005.0,2,1,1
RUS,KOR,2023.0,7,2,5
RUS,ZAF,2003.0,7,3,4
EGY,FRA,2005.0,7,10,-3
GHA,KOR,2018.0,2,2,0
FIN,IND,2007.0,4,2,2
BEL,IND,1997.0,6,6,0
PAK,EGY,2009.0,3,2,1
AUS,KWT,2015.0,7,2,5
FRA,SVK,2008.0,6,4,2
NOR,DEU,2005.0,12,39,-27
MEX,AUS,2001.0,7,5,2
TZA,USA,2004.0,7,8,-1
ARG,MEX,1998.0,6,3,3
NCL,SEN,2004.0,1,2,-1
JOR,GBR,1998.0,4,7,-3
JPN,SRB,2003.0,3,1,2
CHE,FIN,2003.0,16,6,10
AUS,IRN,1999.0,18,3,15
SWE,UKR,2012.0,3,9,-6
THA,FRA,2002.0,8,14,-6
BRB,CAN,2014.0,4,2,2
AZE,DEU,2011.0,1,2,-1
BRA,ARG,1998.0,8,21,-13
NPL,PHL,2017.0,1,1,0
CHE,KHM,2008.0,2,1,1
FRA,LAO,2021.0,1,4,-3
PRT,ITA,2005.0,3,8,-5
GHA,JPN,1999.0,6,1,5
RUS,UZB,1997.0,12,6,6
RUS,DNK,2009.0,4,4,0
BLR,UKR,2015.0,3,2,1
KWT,HUN,1998.0,1,1,0
DNK,NOR,1999.0,11,16,-5
TUR,IRQ,2015.0,6,3,3
PAK,AUT,2015.0,7,19,-12
PAK,SWE,2012.0,6,5,1
TUN,MAR,2010.0,3,2,1
ZAF,COG,2016.0,2,2,0
POL,SGP,2012.0,2,1,1
CAN,PRI,2012.0,6,1,5
VNM,THA,2012.0,2,5,-3
CAN,JOR,2014.0,13,8,5
BEL,SVN,2023.0,1,3,-2
NZL,FJI,2013.0,1,3,-2
ARE,ITA,2023.0,9,8,1
EGY,PRT,2011.0,3,1,2
ETH,KEN,2016.0,4,6,-2
CMR,USA,2015.0,11,13,-2
CAN,LBY,2021.0,5,2,3
TUN,ITA,2019.0,5,7,-2
ESP,IRN,2014.0,10,13,-3
FRA,LTU,2015.0,3,5,-2
CMR,USA,2004.0,5,2,3
DEU,AZE,2013.0,2,2,0
KWT,GBR,2011.0,7,10,-3
RUS,UZB,2012.0,6,1,5
SDN,GBR,2010.0,2,5,-3
GBR,ECU,2014.0,5,3,2
USA,GTM,2010.0,4,12,-8
DEU,HKG,2016.0,8,14,-6
VEN,FRA,2013.0,7,12,-5
DNK,IND,2014.0,14,13,1
USA,SDN,2011.0,1,2,-1
AUT,ROU,2017.0,5,5,0
COL,DNK,2009.0,2,1,1
SEN,BEL,2008.0,2,1,1
CHL,GRC,2018.0,1,2,-1
PRT,JPN,2015.0,3,3,0
MOZ,ZAF,2011.0,5,1,4
AUS,HUN,2013.0,2,4,-2
QAT,ARE,2021.0,10,10,0
DNK,PRT,2016.0,3,14,-11
CAN,LBN,2023.0,2,16,-14
CZE,ITA,2015.0,9,23,-14
LKA,GBR,2010.0,13,9,4
HUN,NOR,2021.0,7,4,3
SWZ,CHE,2015.0,7,13,-6
ESP,KOR,2020.0,6,11,-5
KOR,DNK,2017.0,11,5,6
BRA,SGP,2017.0,6,3,3
LTU,POL,2021.0,7,1,6
GBR,PHL,2015.0,3,7,-4
GRC,NOR,2015.0,13,3,10
JPN,PAK,1999.0,5,5,0
NPL,IND,2001.0,4,10,-6
FIN,SVK,2021.0,2,1,1
MEX,AUS,2014.0,12,11,1
SAU,HKG,2011.0,1,3,-2
CHE,HKG,2017.0,5,6,-1
NOR,SGP,2013.0,2,3,-1
CHE,BGR,2015.0,5,6,-1
IRL,NZL,2011.0,3,8,-5
FRA,TUR,2023.0,11,11,0
NGA,KEN,2008.0,5,1,4
CPV,PRT,2013.0,3,1,2
QAT,TUR,2021.0,4,10,-6
HKG,QAT,2020.0,2,1,1
ROU,NOR,2011.0,5,1,4
LUX,CHE,2017.0,5,4,1
BGD,PHL,2019.0,1,1,0
HRV,IND,2019.0,1,1,0
BRA,PER,2011.0,5,12,-7
SRB,QAT,2017.0,3,1,2
DEU,GEO,2015.0,4,5,-1
SRB,HUN,2010.0,5,1,4
NIC,USA,2019.0,5,2,3
IRN,CHN,2014.0,15,7,8
DEU,UGA,2019.0,2,3,-1
NER,IND,2016.0,2,1,1
DNK,GNB,2014.0,1,6,-5
BEL,COD,2017.0,11,3,8
BIH,TUR,2015.0,1,2,-1
IRN,AZE,2013.0,7,5,2
MOZ,BRA,2015.0,2,10,-8
OMN,JPN,2013.0,1,4,-3
TUR,IRL,2014.0,3,5,-2
ZAF,NAM,2018.0,10,8,2
KOR,CZE,2014.0,5,1,4
LSO,ZAF,2015.0,4,1,3
TZA,KOR,2014.0,1,2,-1
KNA,TTO,2013.0,1,2,-1
DEU,LKA,2019.0,3,6,-3
BRA,CRI,2013.0,2,1,1
FRA,SVN,2016.0,6,9,-3
FRA,TGO,2023.0,3,2,1
USA,PAN,2004.0,11,10,1
COL,PAN,2016.0,2,2,0
PAN,COL,2018.0,2,1,1
RUS,TUR,2014.0,3,6,-3
MEX,DOM,2022.0,4,2,2
AUS,PNG,2015.0,4,9,-5
NLD,DZA,2002.0,1,2,-1
CHE,SRB,2013.0,3,6,-3
BEL,MAR,2013.0,6,2,4
USA,LTU,2014.0,9,6,3
USA,HND,2013.0,2,3,-1
RUS,KGZ,2018.0,6,1,5
SVN,FRA,2018.0,2,7,-5
PHL,TWN,2017.0,3,10,-7
NLD,PER,2017.0,1,1,0
KWT,SAU,2018.0,6,6,0
NLD,BOL,2021.0,1,1,0
BEL,CHL,2023.0,2,5,-3
NOR,TUR,2002.0,3,3,0
HUN,ISR,2018.0,4,1,3
LVA,GBR,2020.0,5,8,-3
GBR,LVA,2023.0,2,2,0
KEN,TZA,2017.0,8,5,3
CRI,ARG,2017.0,1,2,-1
ETH,CAN,2017.0,2,2,0
ISL,DNK,2021.0,3,10,-7
UKR,ITA,2007.0,5,3,2
CHN,ARE,2012.0,4,1,3
NLD,IDN,2007.0,11,3,8
CAN,DNK,2023.0,18,17,1
TUN,NLD,2019.0,1,3,-2
CHE,SVK,2016.0,3,7,-4
ZAF,AUT,2021.0,8,2,6
NGA,JPN,2019.0,10,14,-4
MKD,DEU,2016.0,6,3,3
NOR,IRN,2013.0,4,15,-11
BEL,HUN,2007.0,6,8,-2
ETH,ITA,2011.0,2,1,1
JPN,ETH,2021.0,3,4,-1
GHA,BFA,2010.0,1,1,0
IRL,IRN,2020.0,2,18,-16
MEX,GTM,2016.0,11,7,4
IRL,OMN,2023.0,1,1,0
EGY,POL,2023.0,2,2,0
FRA,NER,2018.0,4,2,2
ISL,GBR,2006.0,4,6,-2
SVK,GBR,2011.0,10,3,7
GBR,SVK,2012.0,4,14,-10
SWE,NGA,2021.0,2,2,0
DEU,BGR,2014.0,10,18,-8
MNE,SVN,2017.0,1,1,0
BEL,BFA,2020.0,4,1,3
KOR,FIN,2015.0,4,4,0
FIN,KOR,2017.0,4,7,-3
TUN,CHN,2023.0,1,2,-1
HKG,SWE,2010.0,2,3,-1
YEM,IND,2018.0,2,6,-4
CAN,CUB,2021.0,2,9,-7
SAU,FIN,2018.0,3,1,2
PRT,IND,2023.0,5,6,-1
GBR,PSE,2023.0,1,4,-3
GBR,BOL,2000.0,2,3,-1
NGA,TZA,2021.0,2,2,0
VNM,FIN,2021.0,1,4,-3
MYS,SWE,2022.0,6,4,2
COD,DEU,2021.0,2,1,1
CAN,POL,2003.0,17,17,0
HUN,EGY,2005.0,2,1,1
SWE,LBN,2021.0,1,1,0
BEN,USA,2019.0,4,3,1
FRA,EST,1998.0,3,4,-1
FRA,MLI,2004.0,6,2,4
MLI,USA,2006.0,3,6,-3
GRC,ROU,2002.0,1,4,-3
TTO,GBR,2004.0,2,3,-1
THA,ITA,2016.0,5,7,-2
ROU,BEL,2001.0,6,2,4
IDN,CAN,2000.0,2,2,0
MAR,MAC,2006.0,2,1,1
FRA,IDN,2005.0,4,1,3
HRV,AUT,2013.0,5,1,4
SWE,BEL,1997.0,8,6,2
HKG,THA,2003.0,2,1,1
VEN,DEU,2018.0,10,3,7
UKR,FRA,2018.0,11,22,-11
LUX,ITA,2000.0,1,1,0
ARG,URY,2000.0,3,2,1
BLR,JPN,2013.0,1,1,0
IRL,FRA,2008.0,20,33,-13
MYS,OMN,2014.0,6,8,-2
LKA,THA,2004.0,2,1,1
NOR,GRC,2010.0,1,5,-4
BWA,GBR,2010.0,3,2,1
THA,FRA,2005.0,5,9,-4
DEU,EST,2000.0,8,3,5
CZE,AUS,2020.0,8,15,-7
PAN,COL,2022.0,3,1,2
QAT,EGY,2003.0,2,5,-3
PSE,JPN,2013.0,1,1,0
DEU,AFG,2018.0,5,5,0
CMR,DEU,2001.0,4,1,3
USA,IDN,2005.0,16,16,0
MDA,USA,2014.0,2,1,1
CRI,PER,2002.0,2,1,1
ROU,PRT,2009.0,3,3,0
NGA,NER,1999.0,2,1,1
PRY,USA,2003.0,1,1,0
KEN,UGA,2001.0,4,1,3
FRA,LTU,2001.0,4,3,1
ESP,DZA,2020.0,13,9,4
ISR,GRC,2003.0,2,1,1
CMR,DEU,2004.0,6,3,3
MYS,IRQ,2007.0,1,3,-2
USA,MMR,2016.0,2,8,-6
GBR,LVA,2006.0,2,2,0
LBN,BEL,2007.0,1,1,0
BLR,DEU,2008.0,13,5,8
CHE,ARE,2011.0,3,1,2
PHL,NLD,2018.0,2,7,-5
SDN,NOR,2021.0,1,2,-1
TUN,DEU,2006.0,1,3,-2
DEU,GHA,2002.0,4,3,1
NGA,JPN,2009.0,5,5,0
GBR,DZA,2007.0,7,1,6
MWI,ZAF,2007.0,2,2,0
CMR,CHE,2006.0,4,2,2
GHA,CAN,2011.0,4,3,1
ITA,SVK,2000.0,5,3,2
LBY,GBR,2008.0,2,12,-10
CHL,CUB,2002.0,1,2,-1
DEU,BOL,2004.0,1,2,-1
NAM,GBR,2022.0,3,1,2
FRA,HUN,1999.0,8,28,-20
TUR,ARE,2013.0,3,3,0
RUS,ISR,2006.0,8,14,-6
ZAF,SAU,2005.0,3,1,2
SYR,CAN,2011.0,2,2,0
DNK,SGP,2001.0,2,1,1
USA,ALB,2005.0,2,1,1
FRA,COG,2005.0,9,3,6
ITA,THA,2002.0,2,3,-1
DEU,ISL,2006.0,2,1,1
ITA,ARE,2008.0,1,1,0
BEL,SGP,2002.0,2,1,1
ROU,CHE,2001.0,6,1,5
IDN,FRA,2017.0,8,16,-8
TZA,KEN,2006.0,2,5,-3
CHE,SWZ,2011.0,7,10,-3
AUS,SAU,2008.0,10,8,2
ITA,CUB,2003.0,11,2,9
PRT,DEU,2003.0,17,19,-2
MYS,EGY,2007.0,3,1,2
UKR,CAN,2011.0,3,1,2
KOR,FRA,1999.0,4,6,-2
SVN,RUS,2018.0,2,1,1
IRL,RUS,2018.0,2,5,-3
ROU,SRB,2012.0,5,2,3
IND,RUS,2010.0,1,5,-4
IND,SWE,2007.0,11,8,3
SEN,USA,2006.0,4,2,2
MDA,USA,2004.0,5,2,3
RUS,MDA,2022.0,1,4,-3
DEU,ARE,2012.0,7,8,-1
IDN,NLD,2006.0,4,8,-4
DEU,MAR,2016.0,6,1,5
NZL,SWE,2009.0,7,8,-1
COL,VEN,2016.0,7,38,-31
BEL,CHL,2000.0,1,2,-1
LTU,SWE,2003.0,5,6,-1
TUR,ISR,2019.0,5,3,2
FIN,DNK,2013.0,8,14,-6
THA,BEL,2008.0,2,2,0
DNK,ISR,2013.0,2,5,-3
SDN,GBR,2023.0,3,1,2
NER,BEL,2005.0,1,1,0
ZMB,NAM,2023.0,1,1,0
SWZ,ZAF,2016.0,3,4,-1
SRB,GRC,2011.0,3,16,-13
HKG,BEL,2013.0,2,1,1
JPN,MWI,2002.0,2,1,1
QAT,SDN,2010.0,1,1,0
LKA,CAN,2018.0,6,11,-5
SWE,NZL,2007.0,6,3,3
NZL,SWE,2011.0,6,3,3
KEN,MEX,2019.0,1,1,0
PRT,MEX,2004.0,2,1,1
LTU,UKR,2021.0,6,5,1
AUT,SGP,2010.0,5,2,3
IRN,CHN,2008.0,1,2,-1
SWE,BWA,2013.0,1,1,0
SAU,KWT,2018.0,6,6,0
GRC,CAN,2004.0,1,11,-10
GBR,PER,2016.0,8,5,3
BHR,KWT,2004.0,1,1,0
BWA,USA,2000.0,1,1,0
CHN,BRA,2018.0,4,16,-12
NZL,BEL,2013.0,4,4,0
VEN,ECU,2010.0,1,1,0
AFG,USA,2013.0,8,2,6
CUB,ITA,2005.0,5,3,2
SAU,IRN,2014.0,1,1,0
IND,THA,2012.0,5,4,1
THA,IND,2013.0,3,10,-7
BRA,UKR,2006.0,1,5,-4
ZAF,CIV,2005.0,2,2,0
TUR,JPN,1999.0,1,9,-8
BGD,AUT,2009.0,1,1,0
BLR,NLD,2018.0,1,1,0
LBY,USA,2020.0,2,3,-1
GBR,TUR,2024.0,3,2,1
SWE,URY,2019.0,1,4,-3
SAU,MAR,2020.0,5,5,0
HKG,MYS,2021.0,7,6,1
GBR,TTO,2008.0,10,3,7
BRN,GBR,2020.0,2,9,-7
PHL,CHN,2015.0,4,3,1
GBR,AFG,2009.0,4,1,3
JPN,TUN,2017.0,3,1,2
USA,PLW,2006.0,2,2,0
CAN,ROU,2022.0,2,2,0
GBR,NPL,2009.0,3,3,0
SRB,ROU,2012.0,2,5,-3
NPL,USA,2008.0,8,10,-2
BIH,DEU,2008.0,2,3,-1
GBR,KHM,2013.0,4,2,2
DEU,LVA,2016.0,7,9,-2
AUT,SVN,2010.0,3,5,-2
AUS,CYP,2013.0,2,1,1
ZAF,SWE,2008.0,3,6,-3
ZAF,OMN,2012.0,2,1,1
SWE,ISR,2014.0,8,7,1
TWN,THA,2017.0,15,5,10
TON,FJI,2020.0,2,1,1
TTO,DEU,2015.0,1,1,0
TUR,CZE,2005.0,1,1,0
AUT,HUN,2009.0,13,13,0
ROU,AUS,2012.0,3,1,2
MWI,GBR,2004.0,3,14,-11
DNK,GNB,2015.0,6,6,0
BWA,GBR,2006.0,3,5,-2
TWN,ITA,2012.0,7,4,3
GAB,USA,2018.0,3,5,-2
ISR,IND,2015.0,22,75,-53
ZWE,NLD,2011.0,2,2,0
FIN,ROU,2016.0,3,2,1
ITA,CYP,2020.0,8,7,1
IRN,QAT,2010.0,2,1,1
NZL,AUT,2016.0,3,7,-4
AUT,NZL,2020.0,5,1,4
PER,ITA,2009.0,1,3,-2
IRL,NLD,2002.0,6,10,-4
MUS,CHE,2012.0,1,1,0
NZL,ISR,2009.0,1,1,0
ERI,IND,2007.0,2,3,-1
TTO,JAM,2021.0,6,1,5
DEU,BOL,2014.0,1,2,-1
TTO,GBR,2001.0,3,11,-8
VEN,CUB,2011.0,3,2,1
ETH,ZAF,2010.0,1,1,0
THA,SGP,2010.0,4,3,1
CHE,ROU,2023.0,2,2,0
MEX,BRA,2011.0,19,11,8
PRT,HUN,2014.0,2,2,0
KEN,KOR,2016.0,1,1,0
NLD,ISR,2016.0,10,15,-5
QAT,NZL,2021.0,2,3,-1
BRA,CZE,2023.0,10,3,7
POL,FIN,2013.0,3,1,2
THA,NZL,2019.0,3,5,-2
MWI,ZWE,2012.0,1,1,0
JOR,OMN,2018.0,6,4,2
CHE,BFA,2017.0,2,2,0
CHE,BFA,2022.0,1,2,-1
TWN,FRA,2018.0,8,16,-8
SRB,DNK,2003.0,4,3,1
DEU,TZA,2020.0,11,8,3
JPN,UGA,2014.0,1,1,0
SRB,MKD,2012.0,4,11,-7
IND,ERI,2013.0,1,2,-1
KEN,CAN,2015.0,13,9,4
HUN,SRB,2019.0,2,4,-2
AUT,ROU,2022.0,3,3,0
MWI,NLD,2022.0,2,2,0
ZWE,NAM,2015.0,2,1,1
NOR,UGA,2021.0,8,2,6
RWA,USA,2014.0,8,20,-12
BEL,TUR,2015.0,8,12,-4
CRI,ESP,2015.0,8,6,2
USA,MKD,2018.0,3,3,0
ISR,BEL,2018.0,3,9,-6
PER,PRT,2016.0,2,3,-1
NLD,LBN,2016.0,2,1,1
CUB,NLD,2022.0,3,1,2
ETH,UGA,2018.0,3,1,2
AUT,BEL,2014.0,11,19,-8
RUS,SRB,2012.0,1,1,0
KEN,FRA,2012.0,6,9,-3
JPN,NLD,2023.0,10,16,-6
SRB,AUS,2017.0,2,3,-1
FRA,MLI,2001.0,3,4,-1
PAK,KOR,2010.0,8,6,2
SWE,LVA,2016.0,2,2,0
MEX,VEN,2013.0,3,17,-14
ESP,BGR,2017.0,2,1,1
KOR,DNK,2022.0,12,8,4
CUB,RUS,2017.0,2,1,1
ROU,ITA,2021.0,14,10,4
SGP,BRN,2016.0,2,2,0
KOR,QAT,2009.0,1,1,0
NGA,NOR,2022.0,4,1,3
BEL,MYS,2019.0,3,4,-1
MYS,NZL,2020.0,13,9,4
CMR,BEN,2017.0,1,1,0
TZA,UGA,2022.0,3,4,-1
HKG,PHL,2018.0,5,3,2
FRA,KWT,2019.0,13,3,10
AUT,CZE,2018.0,13,23,-10
KOR,DNK,2018.0,8,3,5
BLR,BEL,2018.0,1,1,0
BEL,PSE,2019.0,3,1,2
MEX,CRI,2018.0,7,2,5
HRV,CHE,2001.0,1,5,-4
CMR,NGA,2019.0,2,3,-1
AUS,EGY,2018.0,4,14,-10
BRA,BEN,2017.0,1,1,0
GHA,CHE,2020.0,2,4,-2
CMR,SEN,2019.0,1,4,-3
AUS,TUR,2021.0,10,20,-10
RWA,GBR,2019.0,1,3,-2
CHN,MWI,2019.0,5,2,3
COG,GAB,2022.0,3,1,2
YEM,IND,2022.0,2,16,-14
BHR,JOR,2019.0,2,8,-6
KAZ,GHA,2022.0,4,1,3
AUT,ZAF,2007.0,2,1,1
CHE,NGA,2022.0,4,7,-3
DOM,BRA,2021.0,3,1,2
CRI,CAN,2022.0,2,1,1
ALB,DEU,2018.0,1,1,0
HUN,NOR,2019.0,7,3,4
HKG,NOR,2019.0,3,2,1
PAK,ESP,2020.0,4,9,-5
CMR,COD,2022.0,2,1,1
THA,TWN,2024.0,2,1,1
NZL,VNM,2020.0,4,4,0
USA,PSE,2023.0,3,3,0
CUW,NLD,2022.0,3,6,-3
FRA,ARM,2023.0,1,2,-1
FIN,BRA,2022.0,9,7,2
GIB,GBR,2022.0,1,1,0
MKD,ITA,2021.0,1,1,0
THA,ZAF,2022.0,1,1,0
LVA,ESP,2022.0,2,1,1
SVN,HRV,1999.0,7,1,6
HUN,SVN,2002.0,2,1,1
HRV,ITA,2011.0,2,6,-4
THA,AUT,2010.0,6,3,3
SWE,LBY,2009.0,1,1,0
BFA,SEN,2006.0,2,2,0
TUN,ARE,2013.0,4,1,3
AUT,UKR,2007.0,2,7,-5
FRA,LVA,2015.0,2,1,1
JPN,VEN,2014.0,1,1,0
ESP,PHL,2000.0,5,10,-5
NLD,NZL,2007.0,9,5,4
FRA,COG,2002.0,2,5,-3
JAM,CAN,2003.0,1,2,-1
USA,BIH,2007.0,6,4,2
GRC,ARE,2022.0,6,2,4
THA,AUS,2002.0,10,19,-9
TUR,FIN,2008.0,3,3,0
CIV,ZAF,2005.0,2,2,0
SVK,ITA,2003.0,3,7,-4
UKR,ISR,2015.0,2,1,1
LBY,USA,2007.0,1,1,0
CHE,LIE,2010.0,4,1,3
ISR,CHL,2014.0,2,1,1
MWI,ZAF,2020.0,9,18,-9
HKG,IND,2001.0,5,6,-1
CRI,FRA,2012.0,1,2,-1
RUS,ZAF,2013.0,2,2,0
RUS,LVA,2012.0,3,1,2
TZA,BEL,2002.0,1,1,0
DEU,CUB,2005.0,7,1,6
BFA,COG,2013.0,3,1,2
PHL,ESP,2008.0,6,4,2
SWE,ETH,2011.0,5,4,1
USA,BWA,2004.0,5,9,-4
SWZ,DEU,2019.0,1,1,0
SVK,JPN,2007.0,3,1,2
MAR,BEL,2005.0,1,3,-2
CMR,BEL,2005.0,3,2,1
NLD,GRC,2015.0,8,27,-19
IRN,HUN,2006.0,1,1,0
AUT,ARG,2017.0,4,1,3
OMN,USA,2019.0,8,7,1
SVK,GBR,2009.0,5,8,-3
PYF,FRA,1999.0,5,11,-6
GBR,PHL,2004.0,5,2,3
DEU,MDA,2018.0,5,2,3
GBR,QAT,1998.0,1,2,-1
GLP,GUF,2012.0,1,0,1
GBR,PNG,2015.0,1,0,1
FRA,MOZ,2007.0,3,0,3
,AND,2005.0,2,0,2
BGR,NOR,2023.0,1,0,1
OMN,NLD,2022.0,2,0,2
MLT,,2014.0,19,0,19
VUT,IDN,2014.0,1,0,1
BGD,NGA,2023.0,1,0,1
LSO,,2016.0,4,0,4
ECU,FIN,2013.0,1,0,1
MCO,AUS,2019.0,1,0,1
AUS,MCO,2020.0,1,0,1
SYR,TUR,2016.0,3,0,3
PAK,DZA,2017.0,2,0,2
BLR,SAU,2017.0,2,0,2
BGD,FJI,2017.0,1,0,1
CYM,,2022.0,1,0,1
FRA,TCD,2019.0,3,0,3
RWA,BGD,2018.0,1,0,1
HND,BRA,2017.0,1,0,1
GHA,BRN,2014.0,1,0,1
BRN,GHA,2020.0,1,0,1
NLD,EGY,2010.0,7,0,7
IND,PAN,2018.0,2,0,2
,DJI,2010.0,8,0,8
ESP,LVA,2019.0,1,0,1
,PLW,2010.0,3,0,3
PLW,GUM,2017.0,1,0,1
,GNB,2010.0,9,0,9
CHN,VNM,2011.0,3,0,3
IRN,SAU,2019.0,1,0,1
ITA,PAK,2004.0,4,0,4
UZB,NLD,2017.0,3,0,3
EGY,HRV,2019.0,1,0,1
VUT,USA,2016.0,2,0,2
UZB,NLD,2018.0,1,0,1
CMR,FIN,2018.0,2,0,2
VEN,CHN,2020.0,1,0,1
RUS,TUN,2017.0,1,0,1
FIN,KEN,2015.0,1,0,1
FIN,ISL,2015.0,4,0,4
NZL,KAZ,2014.0,1,0,1
GRC,POL,2019.0,3,0,3
PRT,NOR,2014.0,11,0,11
AUT,PAK,2020.0,11,0,11
SYC,,2019.0,6,0,6
URY,GBR,2003.0,3,0,3
MYS,FIN,2022.0,2,0,2
SVK,IRQ,2014.0,2,0,2
LAO,GBR,2013.0,4,0,4
PRT,ECU,2017.0,2,0,2
RWA,BFA,2021.0,1,0,1
CHN,BGR,2022.0,3,0,3
LBN,NOR,2023.0,1,0,1
IDN,RWA,2019.0,1,0,1
CIV,ETH,2023.0,1,0,1
CAN,ISR,2024.0,1,0,1
TUR,CMR,2022.0,4,0,4
,WSM,2016.0,15,0,15
BGD,QAT,2022.0,5,0,5
SDN,EGY,2019.0,1,0,1
AUS,ISL,2019.0,4,0,4
PER,NLD,2019.0,1,0,1
GEO,ESP,2019.0,1,0,1
,SLE,2020.0,38,0,38
NLD,SLE,2014.0,1,0,1
,SLB,2019.0,5,0,5
DEU,PER,2011.0,2,0,2
KWT,FJI,2012.0,1,0,1
PSE,AUT,2022.0,1,0,1
SWE,LBR,2022.0,1,0,1
SRB,ZAF,2022.0,1,0,1
,BOL,2019.0,54,0,54
,SWZ,2019.0,22,0,22
,MNE,2019.0,34,0,34
PAN,PER,2010.0,1,0,1
MEX,HRV,2010.0,2,0,2
MMR,,2010.0,12,0,12
KWT,SVK,2000.0,1,0,1
USA,SLB,2007.0,1,0,1
KEN,IRL,2018.0,2,0,2
PRT,MAR,2008.0,2,0,2
ZAF,URY,2016.0,1,0,1
CRI,BRA,2001.0,2,0,2
NPL,BRN,2011.0,1,0,1
NPL,FRA,2018.0,2,0,2
AUS,BFA,2019.0,1,0,1
YEM,HUN,2001.0,1,0,1
IRL,CZE,2012.0,1,0,1
JPN,DZA,2011.0,2,0,2
TUR,MYS,2008.0,2,0,2
SAU,BRN,2022.0,2,0,2
ITA,BEN,2006.0,1,0,1
,MNP,2006.0,2,0,2
NLD,PAK,2005.0,1,0,1
AFG,,2010.0,2,0,2
PAN,ECU,2016.0,1,0,1
PRT,PAN,2021.0,1,0,1
KEN,PER,2016.0,4,0,4
PER,KEN,2017.0,1,0,1
SAU,ARE,1997.0,3,0,3
COG,JPN,2011.0,1,0,1
RWA,LUX,2010.0,2,0,2
GBR,BMU,2013.0,2,0,2
BEL,QAT,2011.0,3,0,3
PAN,CAN,2009.0,2,0,2
PYF,,2011.0,5,0,5
GBR,MDG,2012.0,4,0,4
PAN,,2011.0,7,0,7
LKA,PHL,2018.0,1,0,1
GNQ,TZA,2019.0,1,0,1
LCA,,2022.0,3,0,3
JPN,LAO,2015.0,7,0,7
NZL,LAO,2018.0,1,0,1
AZE,ISR,2001.0,1,0,1
LIE,CHE,2003.0,1,0,1
MAC,ZAF,2012.0,2,0,2
DEU,ALB,2021.0,5,0,5
MAR,ISR,2015.0,1,0,1
TWN,NPL,2023.0,3,0,3
MCO,JAM,2009.0,1,0,1
BOL,ITA,2021.0,1,0,1
CHN,MUS,2022.0,2,0,2
TUN,SEN,1997.0,1,0,1
SRB,JPN,2011.0,1,0,1
ISR,MYS,2011.0,2,0,2
PAN,,2009.0,15,0,15
ESP,LUX,2002.0,1,0,1
LUX,ESP,2003.0,1,0,1
USA,HTI,2003.0,3,0,3
COG,CIV,2003.0,2,0,2
LBN,AFG,2017.0,1,0,1
SWE,SLE,2017.0,1,0,1
ERI,NOR,2005.0,1,0,1
NPL,MOZ,2017.0,1,0,1
,GUY,2009.0,8,0,8
TTO,BRA,2015.0,1,0,1
SEN,NOR,2023.0,1,0,1
HKG,RUS,2006.0,2,0,2
NPL,CAN,2023.0,3,0,3
URY,AUS,2013.0,2,0,2
CHE,BOL,1997.0,1,0,1
BRA,SVK,2022.0,4,0,4
CYP,,2010.0,40,0,40
DNK,KAZ,2017.0,2,0,2
MAR,MRT,2020.0,3,0,3
KWT,THA,2022.0,1,0,1
MUS,,2007.0,2,0,2
MYS,CZE,2018.0,3,0,3
,GRL,2018.0,4,0,4
,SSD,2019.0,8,0,8
HKG,ISR,2019.0,4,0,4
BEN,ITA,2016.0,3,0,3
,PNG,2020.0,17,0,17
TGO,SWE,2023.0,1,0,1
MAR,ROU,2022.0,3,0,3
SWE,OMN,2014.0,1,0,1
RUS,URY,2000.0,1,0,1
DNK,UGA,2003.0,3,0,3
ETH,UGA,2007.0,1,0,1
MAR,MEX,2001.0,1,0,1
UGA,,2005.0,20,0,20
JPN,PNG,2010.0,2,0,2
SWE,AGO,2006.0,1,0,1
GRC,JOR,2004.0,1,0,1
ARE,SRB,2004.0,1,0,1
LIE,,1999.0,2,0,2
CHL,AUS,2000.0,3,0,3
SEN,TUN,2000.0,2,0,2
HRV,MKD,1997.0,1,0,1
SWE,BGD,1997.0,2,0,2
LBY,IRQ,2008.0,1,0,1
SGP,FJI,2015.0,1,0,1
USA,KHM,2014.0,8,0,8
FRA,BHR,1999.0,2,0,2
EGY,SGP,2006.0,1,0,1
UZB,DEU,2000.0,4,0,4
TTO,GRD,1998.0,1,0,1
CAN,GTM,2003.0,1,0,1
ZWE,DNK,2000.0,1,0,1
CHL,ISL,2009.0,1,0,1
AUT,CYP,2020.0,1,0,1
QAT,IND,2006.0,1,0,1
QAT,CZE,2006.0,1,0,1
CZE,QAT,2007.0,1,0,1
ZMB,,2003.0,10,0,10
CYM,BRA,2012.0,1,0,1
CUB,ARG,2012.0,3,0,3
JPN,TUN,2007.0,1,0,1
SEN,MAR,2011.0,1,0,1
GRC,HUN,2000.0,1,0,1
BEL,GIN,1998.0,1,0,1
GIN,BEL,2000.0,1,0,1
MRT,MUS,2011.0,2,0,2
QAT,ARE,2001.0,1,0,1
TWN,UKR,2010.0,1,0,1
USA,MNE,2001.0,1,0,1
MNE,USA,2002.0,1,0,1
UZB,SRB,2005.0,1,0,1
NGA,PAK,1998.0,1,0,1
EGY,PSE,1997.0,1,0,1
PAK,BIH,2004.0,1,0,1
,DMA,1999.0,5,0,5
TUR,ARE,2010.0,1,0,1
MDG,DNK,2004.0,1,0,1
COD,FRA,2000.0,1,0,1
HKG,CYP,2004.0,2,0,2
CYP,HKG,2006.0,1,0,1
OMN,FRA,2009.0,1,0,1
LKA,KHM,1997.0,1,0,1
CHL,SWE,2003.0,3,0,3
,AND,2002.0,1,0,1
,GIN,2000.0,8,0,8
JOR,BHR,2006.0,2,0,2
JOR,BHR,2010.0,1,0,1
CHE,ALB,2006.0,1,0,1
SLE,,2000.0,2,0,2
SRB,CRI,2006.0,1,0,1
HTI,FRA,2008.0,3,0,3
VNM,IDN,2016.0,5,0,5
VNM,IDN,2018.0,1,0,1
JPN,ETH,2015.0,4,0,4
BEL,EST,2011.0,2,0,2
UGA,NGA,2012.0,1,0,1
ISL,FJI,2017.0,1,0,1
USA,BLZ,2011.0,4,0,4
SYR,LBN,2019.0,3,0,3
BRA,LUX,2011.0,1,0,1
LSO,CHE,2013.0,3,0,3
GUY,CHN,2016.0,1,0,1
SEN,GBR,2009.0,1,0,1
AUS,CUB,2020.0,1,0,1
TUR,EGY,2010.0,1,0,1
AUS,ZMB,2019.0,3,0,3
,TON,2015.0,5,0,5
MYS,BHR,2011.0,1,0,1
BEL,MYS,2014.0,3,0,3
IND,COG,2011.0,1,0,1
PHL,MYS,2010.0,1,0,1
IND,LTU,2024.0,1,0,1
URY,IRL,2012.0,1,0,1
RUS,JOR,2011.0,2,0,2
OMN,BRN,2022.0,1,0,1
ESP,LUX,2012.0,3,0,3
,PRY,2006.0,17,0,17
MYS,ZAF,2015.0,3,0,3
TUR,LVA,2012.0,1,0,1
LVA,BRA,2014.0,1,0,1
NOR,FRO,2012.0,2,0,2
YEM,FRA,2018.0,1,0,1
IRN,IDN,2021.0,2,0,2
SGP,CUB,2021.0,1,0,1
MOZ,BFA,2009.0,1,0,1
BFA,MOZ,2012.0,1,0,1
LBN,QAT,2008.0,1,0,1
IRN,ALB,2013.0,1,0,1
EST,TUR,2012.0,1,0,1
SRB,FIN,2016.0,1,0,1
NGA,RUS,2016.0,1,0,1
MEX,BOL,2013.0,1,0,1
BEN,JPN,2020.0,1,0,1
FJI,VNM,2021.0,1,0,1
FIN,ETH,2014.0,1,0,1
BLR,CAN,2018.0,1,0,1
,BTN,2010.0,10,0,10
,CAF,2010.0,7,0,7
MEX,AUT,2015.0,5,0,5
ZAF,DZA,2017.0,7,0,7
ARM,QAT,2012.0,1,0,1
BOL,CAN,2013.0,1,0,1
DNK,NER,2016.0,1,0,1
THA,JOR,2023.0,1,0,1
KOR,CMR,2017.0,2,0,2
MYS,GHA,2018.0,3,0,3
MYS,ARG,2009.0,1,0,1
TJK,KGZ,2018.0,1,0,1
PRT,BGR,2016.0,3,0,3
,NOR,2021.0,6,0,6
ITA,TZA,2022.0,5,0,5
AUS,CYP,2010.0,3,0,3
JPN,IRQ,2009.0,2,0,2
KEN,ARE,2022.0,2,0,2
MYS,TUN,2018.0,1,0,1
CHN,LTU,2024.0,1,0,1
CMR,FIN,2022.0,1,0,1
USA,BIH,2017.0,8,0,8
GUY,CHN,2017.0,1,0,1
JPN,CRI,2019.0,1,0,1
SVN,KWT,2022.0,1,0,1
PLW,,2014.0,2,0,2
GRD,ROU,2019.0,1,0,1
BFA,CIV,2022.0,4,0,4
PHL,UKR,2021.0,1,0,1
FRA,GEO,2020.0,41,0,41
PSE,IDN,2022.0,1,0,1
TJK,ARM,2020.0,1,0,1
NCL,ISR,2019.0,1,0,1
ROU,ECU,2020.0,2,0,2
JPN,URY,1997.0,5,0,5
IRN,AZE,2006.0,5,0,5
SUR,SVK,2021.0,1,0,1
KHM,BGD,2021.0,2,0,2
,KNA,2017.0,22,0,22
ESP,LBY,2017.0,1,0,1
JPN,SRB,2023.0,1,0,1
SDN,LBN,2022.0,1,0,1
GRC,BWA,2022.0,1,0,1
GHA,RWA,2022.0,2,0,2
EST,KAZ,2021.0,2,0,2
AZE,,2026.0,11,0,11
PNG,SWE,2003.0,1,0,1
TUN,EST,2024.0,1,0,1
MNE,HRV,2017.0,5,0,5
CZE,GHA,2022.0,3,0,3
FLK,IRL,2003.0,1,0,1
EGY,SVK,2001.0,1,0,1
CHN,PAK,1997.0,2,0,2
BEN,,2004.0,8,0,8
NGA,SLE,2010.0,2,0,2
KEN,MDG,2009.0,1,0,1
TUR,KEN,2018.0,1,0,1
,DOM,2001.0,5,0,5
CAN,BHR,2005.0,2,0,2
IND,QAT,2008.0,5,0,5
HKG,QAT,2016.0,3,0,3
MCO,,2004.0,4,0,4
COG,ESP,2001.0,2,0,2
GUF,GUY,1999.0,1,0,1
BRN,,2007.0,4,0,4
MLI,ITA,2012.0,1,0,1
,PYF,1996.0,10,0,10
VIR,USA,1998.0,4,0,4
ISL,,2001.0,10,0,10
,DOM,1996.0,12,0,12
KWT,BRB,2001.0,1,0,1
,IOT,1995.0,1,0,1
CYM,GBR,2014.0,1,0,1
,ERI,2007.0,4,0,4
NZL,BWA,2011.0,2,0,2
LAO,KHM,2021.0,1,0,1
KHM,LAO,2022.0,1,0,1
VUT,USA,2018.0,1,0,1
ZAF,AUT,2014.0,5,0,5
AUS,URY,2009.0,1,0,1
YEM,IRQ,2013.0,2,0,2
SRB,SVK,2023.0,1,0,1
EST,IND,2008.0,1,0,1
FIN,NGA,2020.0,2,0,2
NGA,KWT,2012.0,1,0,1
LBN,BHR,2008.0,1,0,1
OMN,,2009.0,37,0,37
GEO,VEN,2019.0,1,0,1
UZB,AUT,2019.0,2,0,2
SDN,QAT,2007.0,1,0,1
EGY,QAT,2011.0,12,0,12
IND,BRN,2002.0,2,0,2
BRN,IND,2004.0,1,0,1
CHE,PHL,2015.0,3,0,3
OMN,ARG,2017.0,1,0,1
ARG,OMN,2019.0,1,0,1
BWA,NGA,2018.0,2,0,2
NPL,EGY,2022.0,1,0,1
SLV,ESP,2023.0,1,0,1
PRI,IND,2006.0,2,0,2
CMR,PAK,2020.0,1,0,1
RUS,MOZ,2021.0,1,0,1
LBY,DEU,2022.0,1,0,1
GRC,PAK,2020.0,1,0,1
,ITA,2021.0,79,0,79
NZL,PAK,1997.0,1,0,1
ZAF,GEO,1997.0,1,0,1
ITA,SDN,2000.0,1,0,1
IND,RUS,2013.0,4,0,4
NAM,KEN,2007.0,1,0,1
MDG,SEN,2003.0,1,0,1
AUS,SYR,2013.0,1,0,1
MLT,FRA,2009.0,1,0,1
SAU,CHE,2004.0,1,0,1
NCL,,2004.0,4,0,4
IRL,ISL,2004.0,1,0,1
KWT,ARE,2003.0,5,0,5
SVN,IRL,2003.0,1,0,1
IRL,SVN,2004.0,1,0,1
HKG,SAU,2009.0,1,0,1
AGO,FRA,2001.0,2,0,2
POL,GRC,2002.0,4,0,4
GRC,POL,2011.0,4,0,4
NZL,PRT,2001.0,1,0,1
IRL,POL,1998.0,1,0,1
BEL,KNA,2021.0,1,0,1
CAF,NCL,2001.0,1,0,1
CZE,HKG,2006.0,1,0,1
NLD,PER,1999.0,1,0,1
MDA,FIN,2009.0,3,0,3
GUY,,2016.0,7,0,7
BFA,NGA,2004.0,3,0,3
ISR,GEO,1998.0,1,0,1
ROU,KWT,2003.0,1,0,1
PER,VEN,2000.0,1,0,1
DEU,MCO,2010.0,2,0,2
IDN,ZWE,2017.0,1,0,1
SAU,HUN,2007.0,1,0,1
MOZ,ZAF,2008.0,2,0,2
FRA,GEO,1998.0,1,0,1
BWA,NLD,2003.0,1,0,1
NPL,DEU,2003.0,2,0,2
BRA,BGR,2001.0,3,0,3
AUT,NIC,2000.0,2,0,2
UKR,BGR,2022.0,1,0,1
ROU,SGP,2003.0,1,0,1
ETH,NPL,2010.0,1,0,1
CHN,UKR,2008.0,1,0,1
PAN,NZL,2000.0,1,0,1
SEN,AUS,2017.0,1,0,1
MTQ,CRI,2000.0,1,0,1
MTQ,,2014.0,5,0,5
SEN,NLD,1998.0,1,0,1
SRB,FIN,2022.0,2,0,2
DJI,FRA,1997.0,1,0,1
USA,BEN,2002.0,4,0,4
USA,MCO,2003.0,7,0,7
MCO,,2014.0,11,0,11
GIN,CMR,2019.0,1,0,1
JAM,TUN,2010.0,2,0,2
NER,,2011.0,5,0,5
,PYF,2008.0,7,0,7
IRN,KAZ,2013.0,1,0,1
KAZ,IRN,2014.0,1,0,1
THA,KOR,2008.0,3,0,3
JPN,BWA,2021.0,1,0,1
CHN,CAF,2019.0,3,0,3
PHL,FIN,2010.0,1,0,1
CAN,PHL,2015.0,3,0,3
NLD,MNG,2007.0,1,0,1
LTU,IND,2018.0,2,0,2
ESP,GLP,2014.0,1,0,1
JAM,CHE,2009.0,1,0,1
LBY,TUR,2012.0,1,0,1
JPN,LVA,2014.0,2,0,2
HUN,TUR,2015.0,5,0,5
ZAF,THA,2014.0,2,0,2
CYP,IRL,2017.0,2,0,2
IRN,LUX,2014.0,3,0,3
LTU,NLD,2022.0,6,0,6
FRA,BRA,2024.0,2,0,2
HKG,CZE,2016.0,2,0,2
STP,,2022.0,4,0,4
JOR,DZA,2017.0,1,0,1
HUN,BGD,2017.0,1,0,1
SEN,,2026.0,6,0,6
CUB,HUN,2018.0,1,0,1
HUN,CHL,2021.0,1,0,1
USA,KGZ,2023.0,3,0,3
FRA,DNK,2024.0,2,0,2
USA,NAM,2010.0,2,0,2
KEN,SSD,2018.0,2,0,2
BEL,CIV,2018.0,5,0,5
GUY,USA,1999.0,2,0,2
LVA,UKR,2017.0,3,0,3
BGR,CYP,2022.0,1,0,1
USA,RWA,2024.0,1,0,1
UKR,BEL,2017.0,2,0,2
IRQ,KAZ,2018.0,1,0,1
TWN,ZAF,2014.0,9,0,9
PAK,IDN,2012.0,1,0,1
ARM,NLD,2017.0,1,0,1
DEU,UGA,2008.0,5,0,5
NLD,JOR,2021.0,2,0,2
LVA,CHE,2021.0,4,0,4
MYS,IND,2024.0,2,0,2
,SLE,1999.0,5,0,5
IOT,,2022.0,1,0,1
IND,YEM,2017.0,6,0,6
FRA,GUY,2015.0,3,0,3
SWE,VNM,2005.0,2,0,2
PAK,MEX,2022.0,1,0,1
LBR,MMR,2016.0,1,0,1
JPN,HRV,2005.0,1,0,1
IDN,CHE,2001.0,2,0,2
PAK,BRN,2022.0,1,0,1
PAN,CAN,2021.0,1,0,1
TUR,TCD,2021.0,1,0,1
DEU,CYP,2009.0,4,0,4
BHR,PAK,2019.0,3,0,3
IRL,CHL,2021.0,3,0,3
GEO,CHE,2023.0,1,0,1
AUT,MEX,2009.0,2,0,2
TZA,GHA,2021.0,1,0,1
CRI,POL,2023.0,1,0,1
,TCA,2018.0,1,0,1
BOL,CHL,2023.0,2,0,2
IRL,ISL,2014.0,1,0,1
AUS,NCL,2023.0,1,0,1
ETH,JPN,2005.0,2,0,2
MNE,,2015.0,8,0,8
SLE,,2010.0,3,0,3
KOR,KAZ,2010.0,2,0,2
JPN,LAO,2004.0,3,0,3
LAO,SWE,2008.0,2,0,2
MKD,RUS,2000.0,1,0,1
EGY,ZMB,2009.0,1,0,1
,LAO,1995.0,7,0,7
SWE,GLP,2003.0,2,0,2
BEL,NER,1997.0,1,0,1
,GUY,1994.0,7,0,7
CAN,MUS,2017.0,1,0,1
DNK,EGY,2005.0,4,0,4
BWA,,2001.0,10,0,10
BRN,CAN,2005.0,1,0,1
GHA,AUS,2001.0,1,0,1
NAM,IRL,2001.0,1,0,1
RUS,LUX,2015.0,1,0,1
MUS,,1999.0,1,0,1
IRL,TUR,2004.0,2,0,2
BRA,NOR,2000.0,1,0,1
EGY,LBY,2005.0,3,0,3
KGZ,,1999.0,3,0,3
LBN,LBY,2009.0,2,0,2
MMR,,2006.0,6,0,6
SWE,LUX,2012.0,1,0,1
,ERI,1998.0,4,0,4
UZB,EGY,2017.0,1,0,1
SDN,,2001.0,6,0,6
SWE,ECU,2001.0,1,0,1
CHE,SWE,2024.0,1,0,1
ZAF,BFA,2002.0,2,0,2
RUS,THA,2003.0,1,0,1
ZAF,TZA,2003.0,8,0,8
NZL,LKA,2001.0,1,0,1
AUT,LIE,2014.0,2,0,2
BEN,,2008.0,13,0,13
PNG,IDN,2000.0,4,0,4
DEU,YEM,2005.0,2,0,2
ALB,,2009.0,9,0,9
ZWE,MWI,2006.0,2,0,2
NZL,REU,2007.0,1,0,1
TUR,TWN,2008.0,4,0,4
MEX,SYR,2008.0,2,0,2
CIV,BFA,2009.0,7,0,7
UKR,PSE,2002.0,1,0,1
UGA,ZWE,1998.0,1,0,1
GRC,SVN,2011.0,1,0,1
MOZ,DEU,2017.0,1,0,1
CYP,,2000.0,6,0,6
SWE,NGA,2004.0,3,0,3
MKD,ISL,2014.0,1,0,1
KEN,LAO,2013.0,1,0,1
SVN,SRB,2002.0,1,0,1
ZWE,CAN,2009.0,3,0,3
LBN,BHR,2001.0,2,0,2
ITA,PAN,2011.0,2,0,2
TUR,PAK,2008.0,3,0,3
IND,IRL,1998.0,1,0,1
DOM,,2007.0,6,0,6
USA,GNB,2021.0,3,0,3
ROU,AUT,1997.0,1,0,1
COL,ARM,2006.0,1,0,1
KOR,NGA,2016.0,3,0,3
CHN,CMR,2008.0,1,0,1
HKG,TUR,2003.0,2,0,2
NGA,BRA,2012.0,4,0,4
IRN,ARE,2006.0,1,0,1
SWE,SDN,2008.0,2,0,2
NGA,LCA,2009.0,1,0,1
,SLV,1995.0,7,0,7
PHL,MYS,2000.0,2,0,2
BRN,,1999.0,1,0,1
NLD,UGA,2010.0,3,0,3
PHL,WSM,2009.0,1,0,1
THA,PRT,2006.0,2,0,2
FRA,CAF,2005.0,5,0,5
CAF,MOZ,2017.0,1,0,1
MYS,UZB,2022.0,3,0,3
NIC,USA,2004.0,1,0,1
WSM,ITA,2004.0,2,0,2
MDG,GLP,2012.0,1,0,1
SWZ,,2014.0,10,0,10
TJK,CHN,2014.0,1,0,1
FRA,ARE,2006.0,3,0,3
GMB,CHE,2001.0,4,0,4
CHL,NOR,2011.0,4,0,4
UKR,BRA,2017.0,2,0,2
PSE,CAN,2013.0,1,0,1
,HND,2005.0,5,0,5
MEX,CZE,2009.0,2,0,2
GNB,SWE,2000.0,2,0,2
SWE,GNB,2010.0,2,0,2
NOR,ERI,2001.0,1,0,1
ERI,NOR,2002.0,1,0,1
GBR,DNK,2024.0,3,0,3
CAN,PYF,2012.0,1,0,1
CAN,GAB,2012.0,1,0,1
,FSM,2003.0,8,0,8
LBN,KWT,2022.0,2,0,2
KOR,MNG,2008.0,2,0,2
HKG,KAZ,2015.0,1,0,1
FIN,HKG,2011.0,2,0,2
JPN,FJI,2016.0,4,0,4
DNK,ECU,2010.0,3,0,3
,DJI,2006.0,2,0,2
LVA,BEL,2008.0,2,0,2
FJI,GBR,2010.0,2,0,2
CZE,FIN,2007.0,5,0,5
IND,PNG,2009.0,3,0,3
CYM,GBR,2008.0,1,0,1
DEU,TUN,2012.0,3,0,3
TUN,CHN,2013.0,1,0,1
POL,LBN,2019.0,1,0,1
ISL,THA,2015.0,1,0,1
IRL,SVK,2013.0,3,0,3
FRO,,2012.0,4,0,4
BEL,MAR,2006.0,1,0,1
,PYF,2001.0,8,0,8
NZL,NGA,2009.0,2,0,2
TUN,QAT,2012.0,4,0,4
GBR,YEM,2007.0,4,0,4
PHL,IRN,2010.0,2,0,2
,HND,2002.0,7,0,7
DEU,ZMB,2019.0,2,0,2
NZL,COL,2017.0,1,0,1
KOR,MNG,2014.0,4,0,4
BHR,TUN,2013.0,1,0,1
RWA,LUX,2006.0,1,0,1
TCA,GBR,2015.0,2,0,2
JPN,CMR,2018.0,2,0,2
ARG,ECU,2014.0,2,0,2
NGA,OMN,2021.0,2,0,2
AUT,KEN,2014.0,5,0,5
MYS,KWT,2017.0,5,0,5
FRA,GMB,2023.0,1,0,1
IRL,JOR,2016.0,1,0,1
TUN,MCO,2022.0,1,0,1
SEN,NER,2018.0,3,0,3
FRA,DJI,2020.0,1,0,1
MYS,BHR,2019.0,5,0,5
CHN,FIN,2024.0,2,0,2
WSM,IND,2016.0,1,0,1
ETH,CHE,2016.0,2,0,2
GEO,BEL,2016.0,1,0,1
JOR,KWT,2011.0,2,0,2
GLP,,2021.0,7,0,7
NOR,ROU,2023.0,1,0,1
PER,NZL,2007.0,1,0,1
CAN,SYR,2011.0,2,2,0
POL,NZL,1997.0,1,2,-1
SGP,ZAF,2016.0,4,2,2
HKG,MAC,2018.0,13,8,5
NOR,JPN,2013.0,5,6,-1
PAK,SWE,1999.0,4,1,3
JOR,NLD,2005.0,1,1,0
NOR,MWI,2011.0,2,1,1
ARE,CAN,2011.0,7,20,-13
PRT,COL,2020.0,6,5,1
MLT,GBR,2005.0,1,7,-6
BFA,MLI,2014.0,2,1,1
THA,DNK,2005.0,3,2,1
ITA,IRL,2003.0,7,8,-1
COG,USA,2006.0,2,3,-1
VNM,CHE,2015.0,4,1,3
COL,CAN,1998.0,3,2,1
USA,PSE,2009.0,3,3,0
ZMB,CHE,2020.0,1,1,0
CHE,ARG,2004.0,1,5,-4
BOL,ESP,2014.0,1,1,0
KOR,KWT,2019.0,1,1,0
FRA,BEN,2012.0,12,16,-4
BEN,BEL,2016.0,3,7,-4
HRV,BEL,2000.0,2,1,1
PRT,COL,2007.0,2,1,1
BEL,KEN,2010.0,3,5,-2
CHE,EGY,2013.0,7,2,5
MNG,RUS,2010.0,2,3,-1
RUS,VNM,2010.0,5,1,4
SYC,USA,2019.0,3,1,2
LTU,LVA,2003.0,1,1,0
UKR,AUT,2011.0,2,2,0
ISR,AUT,2009.0,5,6,-1
PER,FRA,2017.0,5,8,-3
CYP,NLD,2013.0,1,1,0
IND,SRB,2017.0,1,2,-1
SWE,LKA,2016.0,4,3,1
SWE,BEL,1998.0,8,7,1
SGP,HKG,2006.0,15,20,-5
JPN,HKG,1999.0,5,6,-1
EGY,JPN,1999.0,8,13,-5
PAK,IRN,2010.0,2,1,1
CZE,SGP,2021.0,1,2,-1
PRI,ESP,2009.0,9,9,0
USA,CRI,2008.0,11,14,-3
NOR,LUX,2015.0,2,1,1
UKR,MEX,2015.0,1,2,-1
AUS,POL,2014.0,3,9,-6
MYS,HKG,1998.0,2,1,1
KWT,USA,2017.0,14,30,-16
SWE,ROU,2011.0,4,3,1
CUB,CAN,2012.0,4,2,2
EST,CAN,2012.0,2,1,1
MAR,TUN,2005.0,1,2,-1
SVN,POL,2011.0,2,3,-1
CUB,BEL,2018.0,1,5,-4
AUT,NOR,2005.0,3,4,-1
ITA,SVK,2011.0,3,5,-2
DNK,ZAF,2022.0,2,5,-3
CHL,URY,2015.0,5,3,2
CMR,GBR,2016.0,3,4,-1
MUS,AUS,2011.0,1,1,0
ITA,TUR,2000.0,4,3,1
IND,QAT,2010.0,6,1,5
UKR,LVA,2022.0,5,1,4
GRC,ESP,2011.0,14,12,2
NZL,PHL,2012.0,3,2,1
GAB,NLD,2015.0,4,1,3
CHN,POL,2010.0,3,2,1
JPN,IRL,1997.0,1,1,0
SLE,GBR,2014.0,1,1,0
NLD,EGY,2014.0,4,4,0
TZA,IRL,2017.0,1,1,0
USA,CMR,2013.0,3,7,-4
NOR,VNM,2014.0,4,2,2
CIV,CMR,2015.0,3,3,0
AUT,MEX,2013.0,1,9,-8
IRN,JPN,2013.0,9,18,-9
IND,NPL,2012.0,17,23,-6
DEU,ISL,2021.0,6,5,1
PSE,CHN,2019.0,1,1,0
IND,ROU,2015.0,5,1,4
UGA,CAN,2017.0,5,5,0
LBN,BEL,2012.0,2,3,-1
IRN,PRT,2011.0,5,1,4
BEL,FIN,2003.0,3,7,-4
LVA,SWE,2007.0,2,3,-1
ISL,CHE,2012.0,2,3,-1
GHA,NLD,2013.0,4,6,-2
COL,SGP,2018.0,1,1,0
BEL,RWA,2012.0,4,2,2
AUS,HRV,2018.0,3,1,2
AUT,LUX,2018.0,3,3,0
HKG,BEL,2008.0,1,1,0
MYS,FRA,2012.0,2,4,-2
CHN,SDN,2014.0,6,1,5
NGA,BRA,2017.0,4,2,2
JPN,MEX,2013.0,4,4,0
DEU,LBN,2018.0,7,8,-1
SLE,ITA,2017.0,1,1,0
POL,CHN,2011.0,2,7,-5
NGA,FRA,2010.0,3,4,-1
UGA,ZAF,2012.0,5,6,-1
KAZ,CAN,2013.0,1,1,0
NLD,ARE,2018.0,7,1,6
ESP,TWN,2006.0,3,1,2
KEN,DEU,2013.0,7,10,-3
COL,CRI,2013.0,2,3,-1
LUX,BEL,2015.0,9,15,-6
TZA,SWE,2012.0,3,7,-4
BGD,FRA,2021.0,2,2,0
DEU,SVK,2020.0,11,8,3
MEX,CHE,2010.0,5,4,1
PAK,IRN,2023.0,1,3,-2
JAM,IRL,1998.0,1,1,0
NPL,GBR,2016.0,4,7,-3
AUS,PER,2017.0,1,1,0
BGD,IDN,2018.0,1,1,0
JPN,SVN,2016.0,1,2,-1
LVA,ITA,2010.0,1,1,0
IRN,EST,2022.0,6,1,5
NPL,JPN,2019.0,6,14,-8
GRL,DNK,2019.0,4,13,-9
SVN,SRB,2022.0,6,9,-3
SVK,DNK,2021.0,1,1,0
PRT,SAU,2020.0,2,3,-1
ESP,HKG,2012.0,2,1,1
NLD,HKG,2019.0,10,8,2
GBR,CUB,2015.0,1,2,-1
CUB,GBR,2017.0,2,1,1
LCA,GBR,2020.0,1,1,0
ARG,PAN,2018.0,2,1,1
PRT,KOR,2020.0,4,3,1
ITA,BGR,2020.0,1,11,-10
USA,GTM,2019.0,9,18,-9
IRL,IRQ,2018.0,2,1,1
JPN,ZAF,2021.0,4,4,0
IND,HKG,2002.0,7,1,6
HKG,IND,2003.0,6,3,3
PSE,JOR,2020.0,2,6,-4
ZAF,MEX,2017.0,4,3,1
JPN,PRT,2012.0,10,2,8
MWI,RWA,2023.0,1,1,0
CHE,TUN,2022.0,2,1,1
ESP,NIC,2021.0,2,1,1
BGD,THA,2007.0,2,2,0
ESP,CUB,2020.0,13,31,-18
LTU,SVN,2021.0,2,1,1
IRL,JPN,2014.0,6,6,0
NLD,NZL,2005.0,7,8,-1
COL,CZE,2019.0,1,2,-1
RUS,BGR,2020.0,3,9,-6
RUS,MEX,2022.0,5,10,-5
SAU,IRQ,2020.0,10,3,7
ZMB,ZAF,2017.0,6,6,0
ZMB,ZAF,2022.0,4,13,-9
CIV,DEU,2022.0,2,2,0
MNE,USA,2018.0,1,1,0
SGP,TWN,2023.0,5,4,1
FRA,JPN,2024.0,1,1,0
EGY,TUN,2019.0,1,2,-1
CZE,KAZ,2016.0,2,1,1
ARE,CHE,2018.0,1,2,-1
ETH,JPN,2018.0,2,5,-3
CHE,PRT,2008.0,5,11,-6
GNQ,ESP,2006.0,1,1,0
TWN,KOR,2016.0,13,16,-3
DEU,BOL,2013.0,2,1,1
MEX,CHL,2002.0,5,5,0
KOR,IRN,2021.0,6,33,-27
PAK,BGD,2022.0,11,10,1
ARG,DNK,2019.0,2,2,0
ETH,DEU,2012.0,7,5,2
GHA,CHE,2005.0,6,1,5
ISR,ZAF,2001.0,2,3,-1
BEL,IND,1999.0,3,7,-4
AUT,UKR,2005.0,4,3,1
THA,TWN,2009.0,2,1,1
BEN,USA,2006.0,2,1,1
BGR,SWE,2002.0,1,1,0
COG,USA,2010.0,3,7,-4
HRV,CAN,2000.0,3,1,2
KWT,ARE,2011.0,1,3,-2
EGY,NOR,1997.0,2,1,1
DNK,SAU,2019.0,3,5,-2
TUR,JPN,1997.0,6,8,-2
THA,AUS,1998.0,4,21,-17
AZE,TUR,1999.0,3,2,1
AUT,TWN,2009.0,2,1,1
CHL,NZL,2012.0,6,3,3
IRL,CHE,2005.0,4,7,-3
GBR,ARE,1997.0,7,6,1
MYS,DEU,2006.0,1,2,-1
ROU,NLD,1998.0,5,2,3
MEX,ARG,1997.0,2,2,0
UKR,ESP,2006.0,3,4,-1
MEX,BEL,2002.0,5,5,0
GBR,UZB,2000.0,2,1,1
DNK,UKR,2003.0,2,4,-2
SAU,NGA,2005.0,1,1,0
NER,FRA,2000.0,2,2,0
FRA,ECU,2000.0,2,2,0
COL,CHE,1998.0,1,1,0
CYP,GRC,2000.0,3,9,-6
NOR,FRA,2000.0,12,17,-5
CHE,KOR,2009.0,6,8,-2
FRA,MYS,2008.0,2,7,-5
SRB,NLD,1999.0,1,1,0
AUS,RUS,2009.0,9,14,-5
SVK,SRB,2004.0,6,1,5
SVK,AUS,1998.0,1,1,0
SVK,AUT,2000.0,10,10,0
SWE,ISL,2008.0,9,5,4
BFA,TGO,2004.0,1,1,0
ETH,BEL,2014.0,7,9,-2
NCL,USA,2004.0,1,3,-2
AUT,NZL,2002.0,4,1,3
SVK,RUS,2007.0,4,5,-1
DEU,EGY,1999.0,15,20,-5
PRT,MEX,2013.0,4,4,0
ITA,SRB,2008.0,7,10,-3
JOR,GBR,2005.0,6,8,-2
UKR,CHE,2000.0,4,1,3
CAN,NGA,1997.0,1,1,0
EST,USA,2003.0,6,5,1
CZE,DNK,1999.0,2,3,-1
PSE,DEU,2008.0,6,3,3
ZAF,BWA,2004.0,6,7,-1
NOR,GRC,2009.0,1,3,-2
CHN,RUS,2000.0,5,9,-4
JPN,POL,2013.0,9,11,-2
CHE,DNK,1997.0,2,4,-2
SRB,CAN,2003.0,3,6,-3
ISR,JOR,1997.0,1,1,0
AUT,RUS,2015.0,8,9,-1
VEN,AUS,2020.0,2,2,0
ARM,DEU,2003.0,6,3,3
CAN,KWT,2000.0,3,3,0
CHL,CHE,1999.0,3,2,1
JPN,ROU,1999.0,1,13,-12
LSO,ZAF,2013.0,2,2,0
ISR,BRA,1997.0,3,1,2
LKA,AUS,2005.0,6,2,4
HRV,GBR,2005.0,3,2,1
KEN,MWI,2002.0,1,1,0
CHL,CUB,2007.0,3,3,0
MEX,ITA,2001.0,5,8,-3
NZL,ZAF,2014.0,3,4,-1
TWN,HKG,2009.0,12,9,3
FIN,SGP,2010.0,3,1,2
ARE,LBN,2017.0,3,5,-2
ITA,TUR,2006.0,6,3,3
BGR,NLD,2001.0,6,2,4
TWN,VNM,2012.0,6,1,5
GBR,KAZ,2012.0,5,1,4
BWA,AUS,2001.0,3,1,2
ROU,BGR,2016.0,1,5,-4
IRN,THA,2017.0,2,1,1
CHE,HRV,2009.0,6,5,1
PRT,EGY,2020.0,2,1,1
HUN,NLD,1999.0,4,8,-4
EGY,FIN,2013.0,2,3,-1
ARM,CHE,2013.0,2,1,1
PHL,KOR,2010.0,2,2,0
NZL,CHE,2012.0,9,11,-2
BFA,ZAF,2013.0,4,1,3
GHA,NGA,2018.0,5,7,-2
NGA,GHA,2010.0,4,5,-1
CAN,NCL,2020.0,1,1,0
TWN,CZE,2014.0,2,4,-2
HKG,THA,2014.0,6,1,5
BEL,ISR,2010.0,6,2,4
TUN,CIV,2016.0,1,1,0
IRQ,SYR,2010.0,1,2,-1
AUS,GHA,2020.0,14,25,-11
FSM,USA,2013.0,2,1,1
ROU,BGR,2022.0,2,2,0
CZE,UKR,2017.0,2,15,-13
NZL,AUS,2024.0,2,1,1
GAB,NLD,2008.0,2,1,1
KOR,IRN,2009.0,3,3,0
JPN,ROU,2020.0,2,2,0
NLD,TZA,2015.0,6,1,5
IRQ,USA,2010.0,3,6,-3
EGY,BHR,2023.0,2,4,-2
SWE,HUN,2020.0,5,8,-3
BWA,USA,2011.0,6,9,-3
POL,GEO,2010.0,1,2,-1
BEL,CHL,2009.0,6,3,3
LTU,CAN,2015.0,5,1,4
CAN,LTU,2016.0,1,3,-2
TWN,NLD,2012.0,2,4,-2
IRL,IND,2001.0,2,2,0
ITA,ETH,2015.0,5,2,3
POL,LTU,2017.0,3,1,2
POL,LTU,2022.0,3,2,1
USA,BOL,2014.0,3,4,-1
ESP,SLV,2019.0,6,2,4
ETH,CHE,2012.0,1,2,-1
SWE,HKG,2020.0,3,13,-10
DJI,FRA,2016.0,1,4,-3
EGY,POL,2011.0,4,1,3
SRB,BIH,2014.0,17,25,-8
IND,ROU,2014.0,1,3,-2
SRB,MKD,2020.0,6,14,-8
IRL,JPN,2015.0,6,1,5
DEU,NGA,2015.0,5,3,2
CIV,USA,2018.0,2,5,-3
NER,MLI,2015.0,1,1,0
NGA,SWZ,2015.0,1,1,0
KEN,GBR,2007.0,13,15,-2
USA,MAC,2022.0,6,7,-1
MUS,IND,2012.0,1,1,0
AUS,NOR,1997.0,1,4,-3
FRA,BOL,2017.0,1,3,-2
ARE,TUN,2023.0,2,3,-1
HKG,RUS,2001.0,2,3,-1
AUT,GRC,2017.0,4,8,-4
GBR,NPL,2000.0,3,2,1
ARG,BEL,2017.0,4,3,1
BGR,ITA,2021.0,3,7,-4
SVK,ESP,2019.0,1,4,-3
LUX,NLD,2023.0,4,7,-3
BRB,USA,2004.0,1,6,-5
CZE,ZAF,2013.0,1,1,0
CZE,EGY,2010.0,3,2,1
SRB,BGR,1999.0,2,2,0
DEU,MYS,2019.0,7,19,-12
RUS,MNG,2020.0,2,2,0
RUS,MEX,2016.0,6,6,0
CAF,CMR,2021.0,2,3,-1
VEN,CHL,2022.0,7,2,5
PRT,CHL,2022.0,3,1,2
IRL,PAK,2023.0,4,6,-2
THA,MMR,2021.0,8,12,-4
IND,CMR,2017.0,2,1,1
NGA,POL,2022.0,3,3,0
SDN,IRL,2004.0,1,1,0
JPN,HUN,2000.0,3,13,-10
GBR,PRI,2002.0,1,1,0
LUX,FIN,2023.0,2,2,0
VUT,NCL,2012.0,1,1,0
NLD,ECU,2002.0,1,1,0
JPN,HKG,1998.0,4,6,-2
AUT,RUS,2008.0,3,9,-6
DEU,GEO,2003.0,4,4,0
SRB,RUS,2003.0,3,8,-5
CAN,NZL,1999.0,18,14,4
ARE,KAZ,2013.0,2,1,1
NZL,CHN,2007.0,8,8,0
SAU,DEU,2008.0,2,4,-2
SWE,PRI,2009.0,1,1,0
HRV,CZE,2017.0,3,4,-1
ISR,HUN,2003.0,3,1,2
CAN,ARG,1997.0,6,4,2
TJK,RUS,2011.0,1,6,-5
MEX,SGP,2008.0,2,1,1
KEN,NGA,2012.0,6,1,5
MYS,EGY,2012.0,2,6,-4
IDN,THA,2011.0,4,2,2
TWN,BEL,2012.0,1,1,0
SVK,GBR,2023.0,9,5,4
ITA,THA,2020.0,6,5,1
KEN,BEL,2008.0,3,3,0
DNK,CZE,1999.0,3,2,1
QAT,BHR,2020.0,1,2,-1
BGR,GRC,2005.0,4,1,3
GBR,CHL,1998.0,5,4,1
UZB,KOR,2003.0,3,1,2
DNK,PHL,2021.0,1,1,0
NLD,ZWE,2003.0,1,1,0
ECU,ESP,2004.0,7,2,5
PAK,SWE,1998.0,1,2,-1
JAM,CAN,2001.0,3,1,2
ISR,ROU,2011.0,2,1,1
AUT,BRA,2005.0,4,2,2
TUR,TWN,2006.0,1,3,-2
FLK,GBR,1998.0,2,2,0
NLD,BRA,1999.0,9,9,0
KWT,DEU,2016.0,1,2,-1
ARE,DZA,2014.0,2,1,1
TUR,SGP,2007.0,2,1,1
THA,CHE,2016.0,2,9,-7
ARG,FIN,2023.0,2,2,0
MNG,JPN,2010.0,6,8,-2
USA,NAM,2015.0,3,6,-3
JPN,TUR,2021.0,8,6,2
IND,LKA,2013.0,5,3,2
ECU,NLD,2012.0,2,2,0
CAN,VNM,2006.0,1,2,-1
EGY,AUT,2010.0,3,8,-5
SYR,DEU,2011.0,3,1,2
CHE,SEN,2017.0,2,2,0
AUT,ARE,2021.0,4,2,2
EGY,IRL,2022.0,5,4,1
OMN,CAN,2008.0,3,9,-6
OMN,JPN,2014.0,1,2,-1
KEN,AUT,2012.0,1,1,0
AUT,ZAF,2012.0,5,2,3
BRA,FIN,2012.0,4,3,1
USA,PNG,2013.0,2,1,1
BOL,MEX,2010.0,1,1,0
HKG,BEL,2015.0,1,4,-3
ETH,NLD,2010.0,3,3,0
IRL,MYS,2012.0,7,3,4
DEU,AZE,2014.0,4,1,3
MYS,DNK,2011.0,3,3,0
BRA,CUB,2011.0,4,10,-6
SWE,HKG,2007.0,1,3,-2
HKG,SWE,2009.0,6,3,3
DEU,ARE,2007.0,6,1,5
VEN,COL,2009.0,7,6,1
FIN,TWN,2019.0,3,1,2
ITA,SRB,2014.0,6,7,-1
ISR,ESP,2017.0,9,13,-4
EST,DEU,2013.0,2,9,-7
EST,ESP,2020.0,3,6,-3
EGY,AUS,2012.0,4,3,1
TZA,KEN,2019.0,9,8,1
TUN,CAN,2020.0,11,8,3
MDG,BEL,2017.0,1,1,0
JPN,GRC,2015.0,4,1,3
PRT,ZAF,2014.0,2,1,1
DNK,ISL,2023.0,2,6,-4
NGA,JOR,2022.0,1,1,0
AZE,RUS,2002.0,1,5,-4
NOR,BGR,2020.0,2,1,1
VNM,CAN,2007.0,3,2,1
HKG,ZAF,2019.0,4,3,1
HKG,ZAF,2021.0,2,1,1
FIN,ISL,2023.0,1,2,-1
BGD,NLD,2011.0,4,1,3
UKR,NLD,2015.0,6,5,1
ALB,USA,2013.0,4,2,2
PRI,BRA,2015.0,5,5,0
JOR,CHN,2016.0,1,1,0
BGD,NLD,2019.0,5,3,2
UGA,IND,2019.0,1,1,0
IRL,CZE,2016.0,3,1,2
NPL,CHE,2022.0,2,1,1
POL,PRT,2020.0,9,7,2
PRY,ESP,2011.0,1,5,-4
CHN,LUX,2015.0,1,1,0
NLD,SVN,2019.0,3,1,2
KOR,SGP,2003.0,6,3,3
IDN,SAU,2017.0,1,2,-1
CHE,VNM,2017.0,4,2,2
GBR,DZA,1997.0,2,3,-1
PER,COL,2014.0,4,2,2
SWE,ROU,2021.0,1,1,0
CRI,MEX,2017.0,4,3,1
HUN,UKR,2021.0,1,2,-1
SVN,AUT,2021.0,7,13,-6
TUN,QAT,2018.0,2,3,-1
NLD,MYS,2018.0,8,10,-2
ZAF,BRA,2018.0,5,7,-2
CAN,BEN,2018.0,3,1,2
BGR,AUS,2004.0,2,1,1
EGY,PSE,2022.0,4,4,0
CHE,LUX,2020.0,3,11,-8
ISR,ROU,2019.0,1,1,0
CZE,ARG,2020.0,3,3,0
ISL,DNK,2023.0,6,2,4
IDN,DNK,2019.0,3,1,2
USA,SYC,2019.0,1,3,-2
BWA,JPN,2020.0,2,1,1
NGA,ESP,2019.0,1,2,-1
URY,BRA,2023.0,3,8,-5
ESP,PAK,2017.0,5,3,2
TTO,AUS,2017.0,1,1,0
TZA,KEN,2021.0,8,9,-1
FIN,LTU,2017.0,3,1,2
SAU,OMN,2016.0,5,8,-3
IND,LBY,2019.0,1,1,0
IND,BRA,1997.0,3,1,2
MAR,LBN,2008.0,1,1,0
SGP,TWN,2000.0,3,2,1
IDN,SGP,2023.0,3,6,-3
BRA,PAN,2011.0,2,1,1
BGD,MYS,2003.0,2,2,0
KGZ,TUR,2022.0,4,8,-4
PRT,IRL,2022.0,6,8,-2
ISR,CZE,2009.0,3,3,0
ESP,PER,2000.0,6,4,2
BGR,CAN,2010.0,3,3,0
CHE,CIV,2004.0,2,2,0
GBR,LUX,2003.0,2,2,0
LUX,GBR,2004.0,2,4,-2
USA,GHA,2003.0,9,5,4
CAN,BGD,2008.0,9,11,-2
ESP,EGY,2009.0,9,4,5
UKR,IRL,2002.0,1,1,0
GRC,KAZ,2018.0,2,1,1
KAZ,GRC,2023.0,1,1,0
NGA,FRA,2000.0,3,2,1
GBR,PHL,2003.0,6,2,4
COL,MEX,2004.0,8,11,-3
KEN,CMR,2017.0,3,1,2
ARG,CHE,2008.0,4,5,-1
DNK,EGY,2017.0,2,2,0
NGA,NER,1997.0,2,1,1
NLD,GEO,2018.0,1,2,-1
GRC,ISR,2022.0,1,4,-3
POL,SAU,2016.0,2,3,-1
ITA,NOR,2004.0,6,7,-1
JOR,EGY,2013.0,3,2,1
CAN,LKA,2016.0,6,4,2
CYP,DEU,1998.0,2,3,-1
GNB,DNK,1999.0,1,1,0
GRL,DNK,2021.0,6,12,-6
USA,COG,2004.0,4,2,2
HRV,DEU,2002.0,13,15,-2
FRA,LVA,2003.0,1,2,-1
ROU,DNK,2008.0,2,8,-6
HUN,KWT,2002.0,2,1,1
NZL,FIN,2002.0,1,1,0
BEN,GBR,1999.0,1,1,0
DEU,OMN,2007.0,1,1,0
BFA,CMR,2010.0,2,1,1
USA,NER,2011.0,1,1,0
UKR,JPN,2013.0,5,2,3
BEL,MAR,2001.0,6,3,3
HUN,OMN,2001.0,1,1,0
KWT,EGY,2009.0,12,11,1
KEN,CHN,2011.0,5,2,3
NCL,AUS,2004.0,1,2,-1
CMR,BEL,1999.0,1,1,0
GBR,KWT,2002.0,8,5,3
USA,HND,2014.0,3,4,-1
NLD,ARG,1999.0,3,1,2
BRA,AUT,2003.0,4,3,1
TWN,AUS,1998.0,5,11,-6
ISR,AUS,2000.0,8,3,5
LUX,USA,2000.0,1,2,-1
BEL,PER,2018.0,2,3,-1
PER,BEL,2019.0,5,2,3
CHN,MEX,2007.0,1,3,-2
PAK,AUS,2002.0,2,3,-1
AUT,IRL,2009.0,5,5,0
PRT,JPN,2003.0,3,9,-6
FIN,FRA,2006.0,9,10,-1
AUT,SGP,2019.0,4,2,2
SDN,NLD,2002.0,3,1,2
VEN,CAN,2011.0,3,1,2
JPN,HUN,2010.0,4,6,-2
IRL,GRC,2005.0,4,3,1
MUS,GBR,2010.0,2,3,-1
BEL,ZAF,2003.0,4,6,-2
IDN,NLD,2009.0,5,15,-10
RUS,TJK,2017.0,4,1,3
CAN,UKR,2003.0,4,7,-3
ARG,ITA,2014.0,13,14,-1
ISL,GBR,2009.0,4,3,1
DEU,CIV,2011.0,2,2,0
GBR,BRB,2013.0,2,3,-1
POL,LUX,2015.0,1,1,0
NGA,ESP,2011.0,3,1,2
KOR,HUN,2015.0,1,2,-1
ITA,IRQ,2018.0,4,1,3
DNK,POL,2010.0,5,13,-8
HUN,SVN,2020.0,2,2,0
THA,AUT,2009.0,2,7,-5
KEN,COL,2017.0,1,2,-1
IRL,LBN,2018.0,1,1,0
BEL,ROU,1998.0,6,4,2
ARG,ISR,2018.0,4,2,2
IND,TTO,2019.0,4,4,0
TZA,MWI,2011.0,1,1,0
BRN,SGP,2013.0,2,3,-1
AUS,MEX,2022.0,5,11,-6
ZAF,BEN,2003.0,3,2,1
ITA,SVN,2005.0,1,2,-1
CHE,KHM,2013.0,2,2,0
BEN,CMR,2017.0,1,1,0
GTM,USA,2011.0,9,5,4
DNK,BRA,2014.0,8,13,-5
DOM,VEN,2016.0,1,2,-1
GBR,BMU,2009.0,1,3,-2
NER,CIV,2015.0,1,1,0
TZA,NLD,2009.0,2,7,-5
ARE,BEL,2005.0,1,2,-1
URY,BRA,2010.0,6,5,1
DNK,GNB,2013.0,1,3,-2
IND,BHR,2011.0,3,1,2
TWN,CAN,2022.0,6,21,-15
CUB,URY,2020.0,2,1,1
ESP,TUR,2023.0,13,7,6
LBN,MAR,2022.0,2,3,-1
DEU,SDN,2004.0,2,1,1
KOR,CHE,2010.0,4,14,-10
NGA,CHE,2012.0,1,2,-1
GBR,CIV,2011.0,3,3,0
ESP,GHA,2020.0,1,1,0
NLD,OMN,2017.0,2,1,1
VNM,TWN,2007.0,1,1,0
IRN,NLD,2005.0,5,2,3
THA,MYS,2014.0,9,11,-2
NOR,BLR,2015.0,1,1,0
BGD,KOR,2004.0,3,1,2
ITA,HRV,2010.0,3,7,-4
TZA,GBR,2013.0,4,14,-10
CZE,BEL,2004.0,8,4,4
HUN,ESP,1999.0,2,3,-1
PAK,NOR,2018.0,1,2,-1
LTU,USA,2017.0,5,3,2
CMR,CAF,2017.0,2,2,0
IRL,BEL,2017.0,7,7,0
SGP,ESP,2023.0,5,4,1
MAR,TUR,2019.0,1,2,-1
SUR,NLD,2015.0,1,7,-6
IRQ,TUR,2019.0,8,24,-16
VNM,ITA,2008.0,1,2,-1
ITA,CHL,2018.0,25,12,13
PHL,SGP,2018.0,2,7,-5
GBR,PHL,2013.0,3,4,-1
AUT,IDN,2023.0,1,5,-4
NOR,IRN,2014.0,1,18,-17
LUX,CHN,2023.0,1,1,0
MEX,IND,2021.0,9,14,-5
MOZ,USA,2018.0,7,9,-2
KEN,FRA,2020.0,5,7,-2
CHE,COL,2022.0,4,7,-3
NLD,CHN,2024.0,1,8,-7
VNM,SWE,2020.0,5,9,-4
ROU,BGR,2017.0,3,2,1
KHM,FRA,2022.0,1,4,-3
QAT,MYS,2019.0,5,10,-5
USA,LKA,2000.0,4,10,-6
SWE,HUN,1998.0,3,10,-7
CHE,IRN,2002.0,2,1,1
JPN,EGY,1997.0,7,4,3
USA,MDG,2003.0,2,1,1
OMN,AUS,2008.0,4,3,1
UKR,BRA,2005.0,1,1,0
BFA,FRA,2004.0,9,3,6
ZAF,GMB,2010.0,2,2,0
POL,BLR,2018.0,2,5,-3
ITA,CYP,2002.0,1,1,0
NOR,TZA,2006.0,4,3,1
DEU,SVN,2005.0,5,8,-3
MDG,BEL,2022.0,1,2,-1
MEX,UKR,2005.0,3,2,1
CMR,CIV,2001.0,1,1,0
ARG,NLD,2004.0,4,2,2
IND,FIN,2002.0,3,2,1
LTU,FIN,2020.0,1,5,-4
AUT,ZAF,1997.0,2,1,1
IDN,DNK,2009.0,1,2,-1
ESP,NOR,2005.0,6,6,0
NGA,CAN,1998.0,3,1,2
CRI,DEU,2000.0,2,3,-1
EGY,LBN,2006.0,1,2,-1
SRB,KWT,2000.0,1,1,0
KOR,FRA,2002.0,7,7,0
SVK,GBR,2006.0,3,13,-10
POL,FIN,2004.0,3,3,0
GRL,USA,2011.0,1,1,0
EST,FRA,1999.0,3,4,-1
TUR,ARE,2004.0,1,1,0
FRO,DEU,2022.0,1,1,0
BEL,GRC,2001.0,6,12,-6
USA,OMN,2001.0,4,4,0
MAR,CHE,2002.0,1,1,0
ARM,POL,2002.0,1,1,0
USA,FJI,2001.0,1,2,-1
URY,CAN,2007.0,2,1,1
GBR,KHM,2008.0,7,1,6
USA,ZWE,2006.0,4,4,0
FRA,LTU,2003.0,3,3,0
LTU,FRA,2006.0,3,1,2
ZAF,SEN,2022.0,2,1,1
DEU,CUB,1999.0,3,5,-2
ETH,DNK,2000.0,1,4,-3
RUS,TWN,2005.0,3,2,1
SDN,GBR,2009.0,3,5,-2
USA,PNG,2003.0,4,2,2
RUS,CRI,1998.0,1,11,-10
OMN,IND,2008.0,5,11,-6
ISL,SWE,1999.0,5,11,-6
BRN,AUS,2020.0,2,4,-2
JPN,PER,2016.0,2,1,1
JPN,UZB,2018.0,3,2,1
NIC,ESP,2017.0,2,1,1
FIN,IRL,2020.0,4,3,1
HUN,NOR,2010.0,4,2,2
NGA,SLE,2014.0,1,1,0
BFA,SEN,2021.0,1,6,-5
LBN,DEU,2008.0,1,4,-3
ASM,USA,2015.0,4,4,0
ITA,UKR,2005.0,2,4,-2
KEN,NLD,2007.0,5,6,-1
DNK,SVN,2019.0,5,3,2
AUS,COL,2012.0,4,6,-2
MEX,PRT,1998.0,1,1,0
DZA,CHN,2017.0,3,5,-2
AND,ESP,2018.0,4,2,2
AND,ESP,2022.0,3,7,-4
BEL,ARG,2016.0,6,8,-2
BIH,USA,2016.0,5,6,-1
SWE,SRB,2013.0,2,1,1
DEU,TZA,2012.0,2,2,0
CZE,MKD,2018.0,1,1,0
ZAF,PRT,2014.0,1,2,-1
HRV,AUT,2008.0,2,3,-1
SRB,CHE,2014.0,3,4,-1
CHE,SRB,2015.0,6,6,0
NZL,MEX,2012.0,1,3,-2
TWN,SGP,2008.0,7,7,0
JPN,SDN,2018.0,1,1,0
AUT,IND,2019.0,8,18,-10
VNM,COL,2020.0,1,2,-1
NGA,COL,2013.0,1,1,0
VNM,THA,1998.0,2,1,1
BFA,NLD,2013.0,2,1,1
SVK,DNK,2011.0,3,1,2
SVK,UKR,2013.0,1,1,0
VEN,FRA,2014.0,6,4,2
CAN,NGA,2005.0,3,5,-2
PRT,CHL,2018.0,2,3,-1
HRV,DEU,2005.0,4,11,-7
EST,FRA,2020.0,3,5,-2
IRN,BLR,2009.0,1,3,-2
NZL,FRA,2023.0,10,10,0
NLD,MYS,2022.0,4,2,2
VNM,SVN,2012.0,1,1,0
CHE,FRA,2024.0,1,1,0
TUN,DEU,2009.0,2,2,0
SYR,IRN,2017.0,1,1,0
HKG,NLD,2009.0,5,2,3
TWN,POL,2013.0,1,3,-2
USA,COD,2010.0,1,2,-1
IDN,NZL,2016.0,3,7,-4
CZE,SAU,2014.0,2,1,1
ARG,PER,2016.0,5,2,3
AUS,KHM,2020.0,8,5,3
ZWE,GBR,2017.0,5,14,-9
PRT,IRN,2012.0,1,11,-10
NGA,GMB,2016.0,4,3,1
VNM,THA,1999.0,2,2,0
ESP,CRI,2011.0,6,4,2
ISL,ISR,2011.0,2,1,1
PRT,AUT,2015.0,6,5,1
ZAF,POL,2015.0,3,2,1
GBR,BMU,2019.0,3,1,2
LKA,CHN,2008.0,1,1,0
MDA,FIN,2013.0,1,1,0
RUS,IND,2009.0,2,2,0
BWA,CAN,2011.0,1,2,-1
IRN,ARE,2008.0,2,1,1
TUR,CHN,2015.0,6,8,-2
NOR,IRN,2015.0,5,15,-10
ZAF,TZA,2009.0,1,1,0
NOR,CZE,2001.0,2,1,1
MYS,NLD,2022.0,2,4,-2
SWE,SVN,2023.0,4,4,0
BHR,TUR,2020.0,2,1,1
SRB,GRC,2006.0,3,6,-3
PSE,ISR,2003.0,1,12,-11
MYS,LKA,2016.0,4,4,0
BIH,SRB,2006.0,7,12,-5
ZAF,SWZ,2008.0,2,2,0
SVK,POL,2006.0,3,4,-1
CHE,LBN,2011.0,1,1,0
PAK,KOR,2009.0,6,7,-1
MYS,KAZ,2015.0,4,2,2
CHN,ISL,2015.0,2,1,1
PRT,ITA,2007.0,2,13,-11
ARE,HKG,2017.0,2,3,-1
FRA,BOL,2018.0,2,2,0
USA,DZA,2001.0,3,2,1
MYS,LKA,2018.0,3,3,0
IRL,SWE,2005.0,3,3,0
TUN,PRT,2015.0,2,1,1
KEN,AUS,2009.0,3,4,-1
CHE,GHA,1999.0,1,1,0
GBR,BLR,2018.0,1,2,-1
JPN,PAK,2002.0,4,9,-5
JPN,CHL,2008.0,4,1,3
LKA,NZL,2005.0,1,2,-1
MAC,CAN,2017.0,2,1,1
SVN,ESP,2019.0,4,4,0
JPN,GRC,2004.0,4,2,2
SGP,NOR,2016.0,2,1,1
CUB,USA,2012.0,8,3,5
CHE,LTU,2005.0,1,1,0
COL,CHN,2014.0,1,2,-1
ISL,CHN,2010.0,1,1,0
BGD,NZL,2018.0,2,1,1
NOR,HUN,2013.0,3,5,-2
BEL,HUN,2012.0,2,13,-11
SRB,TUR,2021.0,2,4,-2
FIN,GHA,2018.0,1,1,0
NOR,BRN,2021.0,1,1,0
ZAF,COD,2021.0,5,2,3
ITA,EGY,2014.0,5,7,-2
MEX,ISR,2020.0,6,3,3
CHN,UGA,2019.0,4,4,0
NLD,IRL,1999.0,5,8,-3
BGD,NLD,2021.0,5,12,-7
RUS,GRC,2020.0,2,3,-1
COL,URY,2009.0,1,1,0
FRA,NGA,2020.0,3,11,-8
JPN,ESP,2002.0,11,10,1
SVK,RUS,1999.0,3,2,1
SVK,RUS,2020.0,3,4,-1
ISR,SGP,2023.0,2,4,-2
CMR,BEL,2020.0,3,8,-5
LTU,BEL,2006.0,1,2,-1
BEL,LTU,2008.0,1,1,0
FRA,AFG,2020.0,3,3,0
PHL,CHE,2022.0,2,2,0
IDN,NGA,2021.0,1,1,0
CZE,AUS,2005.0,2,4,-2
POL,PRT,2007.0,3,2,1
UKR,ESP,2010.0,5,2,3
GBR,MMR,2022.0,3,3,0
CZE,EGY,2023.0,1,2,-1
SGP,ARE,2023.0,5,1,4
ISL,NOR,2022.0,5,3,2
PAN,VEN,2022.0,1,1,0
ARE,CHN,2024.0,1,1,0
LKA,NLD,2020.0,1,3,-2
HKG,NZL,2022.0,4,2,2
CRI,FRA,1999.0,2,1,1
SVN,TUR,2022.0,1,1,0
DZA,ARG,2019.0,4,2,2
NZL,BEL,2001.0,2,5,-3
PER,GBR,2008.0,5,4,1
ESP,MDA,1998.0,1,2,-1
DNK,MEX,2007.0,3,1,2
DEU,CUB,2007.0,1,2,-1
CHN,PRI,2005.0,3,1,2
NZL,SWE,2006.0,8,5,3
BMU,USA,2004.0,1,2,-1
FRA,SAU,1997.0,3,1,2
BRA,DNK,1999.0,1,4,-3
ISR,NZL,2018.0,2,2,0
KWT,IND,1998.0,2,9,-7
LBN,CAN,2004.0,3,7,-4
PLW,USA,2001.0,1,2,-1
CRI,ESP,2013.0,5,10,-5
NOR,CAN,2006.0,8,19,-11
ZAF,ZWE,2003.0,1,11,-10
LVA,SWE,1999.0,4,4,0
ECU,PRT,2016.0,2,1,1
IRL,CHE,1997.0,4,1,3
GBR,KAZ,2002.0,1,1,0
ZAF,JAM,2015.0,1,1,0
ESP,AND,2019.0,3,2,1
PAN,CHE,2019.0,1,2,-1
NPL,USA,2003.0,5,8,-3
ZAF,IRL,2019.0,6,2,4
MDG,GBR,2010.0,2,3,-1
PRT,AUT,2001.0,1,4,-3
PRY,ESP,2019.0,1,9,-8
ZAF,JPN,2005.0,4,3,1
SAU,NGA,1997.0,3,1,2
PAK,DEU,2002.0,4,8,-4
SEN,CHE,2003.0,1,1,0
ARM,RUS,2008.0,5,3,2
SAU,SWE,1997.0,2,4,-2
NLD,IDN,2002.0,4,4,0
LAO,KOR,2017.0,1,2,-1
ARG,AUS,2006.0,4,2,2
HKG,NZL,2017.0,9,7,2
ESP,SGP,2010.0,6,3,3
UZB,USA,2016.0,4,2,2
IND,SWE,1997.0,4,5,-1
BEL,ZWE,2003.0,1,1,0
TUN,ESP,2010.0,5,3,2
PHL,FIN,2001.0,1,1,0
FIN,PHL,2003.0,1,1,0
CYP,USA,2010.0,4,24,-20
JPN,NOR,2007.0,4,4,0
BGR,DNK,2012.0,1,1,0
ETH,SWE,2006.0,3,2,1
TUR,UKR,2003.0,1,1,0
QAT,EGY,2001.0,5,2,3
KGZ,RUS,2002.0,2,1,1
FIN,BGR,2000.0,1,1,0
NGA,GHA,2023.0,4,4,0
THA,IND,2004.0,4,3,1
HKG,RUS,2015.0,2,3,-1
KWT,AUS,2014.0,2,3,-1
OMN,SAU,2021.0,3,6,-3
USA,GRD,2011.0,5,4,1
AUS,HUN,2014.0,2,6,-4
POL,AUS,2000.0,5,3,2
CMR,NGA,2006.0,2,3,-1
ERI,IND,2012.0,1,1,0
UGA,CHE,2021.0,3,4,-1
ETH,ARE,2021.0,1,1,0
BOL,USA,2023.0,1,2,-1
NOR,HRV,2021.0,2,1,1
NOR,PRT,2020.0,2,7,-5
SVK,ITA,2015.0,7,4,3
ESP,NZL,2016.0,5,3,2
RUS,EST,2018.0,6,6,0
SRB,ALB,2015.0,1,10,-9
ISL,NLD,2020.0,3,1,2
ZAF,TTO,2016.0,1,1,0
FRA,VEN,2017.0,2,5,-3
TWN,CZE,2001.0,1,1,0
ECU,ESP,2008.0,7,3,4
BLR,KAZ,2020.0,2,2,0
CHN,KAZ,2015.0,4,2,2
FRA,CRI,2019.0,6,4,2
MEX,BEL,1997.0,5,2,3
AUT,FIN,2017.0,8,9,-1
BEN,FRA,2019.0,10,12,-2
EGY,SGP,2015.0,1,1,0
FRA,MRT,2019.0,4,3,1
AUS,FJI,2023.0,6,3,3
ISL,IRN,2020.0,1,5,-4
BWA,GBR,2019.0,4,8,-4
JOR,CHN,2017.0,2,1,1
KWT,MYS,2021.0,3,4,-1
BRA,SAU,2023.0,5,1,4
ZAF,PAK,2023.0,2,3,-1
MLI,BFA,2020.0,1,3,-2
MAR,GBR,2016.0,2,3,-1
USA,GUF,2017.0,1,1,0
CAN,RWA,2023.0,3,4,-1
SDN,MYS,2013.0,3,4,-1
NZL,MYS,2020.0,9,13,-4
OMN,SWE,2017.0,4,1,3
FRA,ISL,1999.0,2,1,1
ITA,CMR,2019.0,4,1,3
UZB,CZE,2018.0,2,4,-2
PRT,CHL,2016.0,4,3,1
SWE,EST,2017.0,4,12,-8
ROU,CAN,2019.0,4,5,-1
FIN,BEL,2023.0,5,8,-3
CMR,CAN,2020.0,3,6,-3
ECU,CAN,2017.0,1,3,-2
USA,EST,1997.0,4,5,-1
NZL,QAT,2021.0,3,2,1
TJK,KAZ,2019.0,1,1,0
BEL,PRT,2017.0,12,21,-9
SVN,AUT,2009.0,4,5,-1
POL,PAK,2014.0,1,1,0
UGA,BEL,2023.0,5,2,3
BGD,IRL,2021.0,4,2,2
MWI,UGA,2020.0,3,1,2
MAR,JPN,2020.0,3,1,2
NPL,CHE,2018.0,1,1,0
RUS,SRB,2020.0,4,7,-3
NLD,MAR,2020.0,1,1,0
ARE,ITA,2021.0,5,13,-8
BRA,UKR,2021.0,1,1,0
URY,FRA,2017.0,2,5,-3
GTM,GBR,2022.0,2,1,1
USA,LBY,2022.0,2,3,-1
GAB,FRA,2022.0,4,8,-4
PHL,IND,2019.0,4,10,-6
ECU,BOL,2022.0,1,2,-1
TUN,ITA,2023.0,4,5,-1
NGA,IDN,2020.0,1,1,0
NPL,GBR,2022.0,5,9,-4
LIE,CHE,2021.0,6,2,4
KEN,EGY,2022.0,1,1,0
IRN,DNK,2007.0,2,1,1
BEN,TGO,2006.0,1,2,-1
AUS,COG,2006.0,2,1,1
BEL,SEN,2014.0,1,2,-1
ARE,DEU,2009.0,2,6,-4
UZB,GBR,2008.0,1,1,0
PER,ITA,2006.0,1,1,0
CHL,VEN,2006.0,2,4,-2
PSE,DEU,2014.0,3,4,-1
PER,IDN,2015.0,1,1,0
IRL,HRV,2014.0,1,2,-1
CHL,SWE,2009.0,2,3,-1
LKA,UZB,2011.0,2,1,1
PRT,ZAF,2015.0,7,1,6
COL,BOL,2011.0,2,1,1
NZL,MEX,2005.0,2,1,1
ISR,NOR,2009.0,3,2,1
DNK,TZA,2008.0,2,3,-1
BEN,NGA,2006.0,1,1,0
ARM,RUS,2015.0,2,8,-6
FIN,SVK,2010.0,1,2,-1
BEL,MYS,2010.0,1,2,-1
SAU,DEU,2004.0,2,1,1
JPN,KEN,2007.0,8,2,6
ZAF,COL,2004.0,3,1,2
GBR,BRN,2008.0,4,2,2
FIN,TUR,2021.0,9,12,-3
TUR,EGY,2015.0,1,1,0
CMR,COG,2020.0,1,1,0
JPN,LAO,2000.0,1,1,0
CAN,CMR,2008.0,5,5,0
NLD,COG,2020.0,1,1,0
ITA,IND,1998.0,13,13,0
MWI,ZAF,2012.0,4,7,-3
NOR,SVK,2018.0,4,1,3
CHN,QAT,2014.0,1,1,0
GRC,HKG,2000.0,1,1,0
SDN,CHE,2021.0,1,1,0
LKA,SGP,2022.0,3,2,1
ARG,ISR,2017.0,2,1,1
CZE,SRB,2018.0,3,5,-2
CRI,GTM,2016.0,2,1,1
TUN,SAU,2002.0,2,4,-2
BGR,KOR,2008.0,1,2,-1
NGA,MWI,2014.0,1,2,-1
SWE,IRL,2000.0,8,2,6
KEN,CMR,2018.0,2,3,-1
PAN,ESP,2016.0,3,8,-5
PRT,JPN,2013.0,1,5,-4
NOR,KEN,2021.0,1,2,-1
IRL,KAZ,2020.0,1,1,0
NOR,CHN,1998.0,2,5,-3
CZE,DNK,2020.0,3,6,-3
NAM,CHN,2021.0,1,1,0
ZAF,JOR,2022.0,1,1,0
DZA,USA,2015.0,10,5,5
NOR,SGP,2014.0,1,5,-4
SGP,NOR,2017.0,1,1,0
TWN,EGY,2018.0,3,2,1
SRB,IRL,2022.0,4,1,3
CYP,ISR,2015.0,1,2,-1
MLI,CAN,2021.0,2,2,0
AUT,IND,2011.0,4,6,-2
MDG,ITA,2019.0,1,1,0
MOZ,GBR,2021.0,1,1,0
LBN,DNK,2022.0,2,1,1
PAK,TWN,2018.0,5,3,2
ITA,SVK,2019.0,3,3,0
PER,BRA,2009.0,8,7,1
MEX,POL,2015.0,2,2,0
AFG,GBR,2018.0,2,5,-3
ITA,JOR,2020.0,3,4,-1
ARE,PAK,1999.0,1,1,0
URY,CAN,2020.0,2,1,1
ZWE,FRA,2020.0,2,1,1
BEL,PHL,2017.0,3,3,0
ROU,NOR,2000.0,1,1,0
EST,FIN,1999.0,4,4,0
CHE,CIV,2008.0,1,3,-2
NLD,TZA,2004.0,2,1,1
IRL,NLD,1998.0,5,5,0
SWE,LTU,2008.0,5,6,-1
VNM,NLD,2004.0,3,4,-1
ARM,ITA,2001.0,1,3,-2
NLD,ARG,1998.0,2,5,-3
NGA,TZA,2010.0,1,1,0
BRA,CZE,2009.0,2,1,1
JOR,ARE,2004.0,3,5,-2
GRC,DNK,1999.0,1,1,0
USA,LKA,2006.0,4,8,-4
IND,ITA,2002.0,9,14,-5
LTU,NLD,2002.0,1,1,0
ASM,USA,2008.0,3,1,2
BEL,RWA,1997.0,1,1,0
SVK,CHE,2001.0,4,3,1
ARM,RUS,2014.0,4,7,-3
AUS,POL,2001.0,5,2,3
AUS,POL,2004.0,5,1,4
BRA,NOR,2004.0,2,1,1
NOR,BRA,2005.0,2,1,1
UGA,GBR,1998.0,1,8,-7
BGD,CHE,2001.0,3,1,2
SWE,SVN,2006.0,3,2,1
SEN,BFA,2006.0,2,2,0
AUT,SGP,2011.0,1,2,-1
POL,MEX,1999.0,2,2,0
LUX,AUT,2003.0,2,1,1
CZE,AUS,2002.0,2,3,-1
PRT,MOZ,2006.0,1,1,0
CAN,BGR,2007.0,2,5,-3
NGA,CHE,2005.0,2,1,1
USA,DZA,2015.0,5,10,-5
MYS,USA,1998.0,5,9,-4
KWT,OMN,1998.0,1,1,0
COG,UGA,2014.0,1,1,0
UGA,NGA,2017.0,3,4,-1
BEN,KEN,1999.0,1,1,0
BRA,FIN,2005.0,2,1,1
GRC,FIN,2006.0,3,1,2
BEL,ISR,2006.0,2,3,-1
SWE,ZWE,2002.0,3,2,1
BHR,EGY,2018.0,1,6,-5
ETH,SWE,2000.0,4,1,3
CAN,TTO,1997.0,2,3,-1
USA,SDN,2000.0,3,1,2
BGR,FIN,2002.0,2,1,1
AUT,MNG,2005.0,1,1,0
FIN,LBY,2016.0,2,2,0
ISL,IRL,2021.0,1,3,-2
GHA,KEN,2016.0,2,4,-2
LTU,GBR,2023.0,2,5,-3
MOZ,ITA,2021.0,4,1,3
SYR,USA,2012.0,1,5,-4
PRT,THA,2015.0,3,1,2
CAN,BFA,2012.0,1,1,0
SWE,SVK,2015.0,2,1,1
DNK,HKG,2014.0,3,4,-1
IND,ERI,2015.0,2,1,1
ISL,DNK,2006.0,5,1,4
NLD,COL,2017.0,7,11,-4
HKG,IDN,2007.0,1,1,0
ROU,TUR,2019.0,2,4,-2
EGY,IND,2006.0,2,1,1
NPL,DEU,2009.0,2,3,-1
IDN,NZL,2018.0,3,7,-4
BRB,USA,2001.0,3,4,-1
OMN,IND,2004.0,3,4,-1
IND,FJI,2003.0,1,1,0
JPN,QAT,2018.0,1,3,-2
SGP,THA,2002.0,3,1,2
MEX,SWE,2002.0,5,7,-2
KOR,PHL,2011.0,6,5,1
VNM,IND,2023.0,4,2,2
DEU,TUN,2016.0,3,5,-2
,TCD,2006.0,4,0,4
ARM,POL,2011.0,1,0,1
NPL,BRN,2016.0,1,0,1
HUN,LUX,2011.0,2,0,2
IND,PAN,2011.0,1,0,1
CHL,ISL,2022.0,2,0,2
SGP,DNK,1999.0,1,0,1
NLD,SXM,2020.0,1,0,1
ARG,GTM,2016.0,1,0,1
MYS,TUR,2005.0,1,0,1
NPL,AUS,2010.0,6,0,6
BEN,BWA,2007.0,1,0,1
MAR,ARE,2009.0,1,0,1
AUS,MOZ,2010.0,2,0,2
AUS,LBY,2009.0,1,0,1
URY,LUX,2020.0,1,0,1
ITA,PHL,2012.0,1,0,1
,DOM,1998.0,7,0,7
BMU,GBR,2023.0,1,0,1
ATG,,2009.0,2,0,2
PRT,KWT,2016.0,1,0,1
BLZ,CAN,2021.0,1,0,1
SEN,SVN,2016.0,1,0,1
MDG,AUS,2014.0,1,0,1
AUT,ISL,2009.0,2,0,2
HRV,SLV,2008.0,1,0,1
LKA,KOR,2008.0,1,0,1
BEL,BFA,2019.0,4,0,4
KAZ,KOR,2015.0,1,0,1
BEL,JOR,2017.0,1,0,1
ESP,LIE,2021.0,2,0,2
HKG,KWT,2011.0,2,0,2
ZAF,PNG,2019.0,1,0,1
PER,KOR,2016.0,1,0,1
CAN,MAC,2020.0,1,0,1
NGA,SOM,2016.0,1,0,1
MYS,SWE,2008.0,2,0,2
SLV,,2017.0,14,0,14
AUS,BOL,2019.0,1,0,1
UKR,NOR,2005.0,1,0,1
GBR,WSM,2021.0,1,0,1
UGA,SDN,2019.0,1,0,1
HND,,2008.0,4,0,4
GUY,FRA,2013.0,2,0,2
AFG,LBN,2015.0,1,0,1
,BLZ,2006.0,6,0,6
LBN,IRL,2017.0,2,0,2
GUY,,2019.0,8,0,8
MDA,DNK,2016.0,1,0,1
KOR,PRK,2007.0,1,0,1
COL,ITA,2024.0,2,0,2
ERI,IND,2021.0,3,0,3
SAU,KAZ,2023.0,2,0,2
LBR,ETH,2017.0,1,0,1
SGP,UGA,2022.0,4,0,4
PRI,AUS,2019.0,1,0,1
SRB,CHN,2021.0,3,0,3
PER,IND,2021.0,2,0,2
BEL,SGP,2024.0,1,0,1
NGA,ZWE,2019.0,1,0,1
SAU,GUY,2023.0,1,0,1
BFA,DJI,2014.0,1,0,1
POL,FRA,2024.0,1,0,1
MCO,,1999.0,2,0,2
BIH,AUS,2008.0,1,0,1
SVK,SWE,1999.0,1,0,1
LKA,PHL,2019.0,1,0,1
BLR,SVN,2000.0,1,0,1
KGZ,,2015.0,23,0,23
PHL,TTO,2017.0,1,0,1
MKD,HRV,1998.0,1,0,1
KEN,CHE,1998.0,1,0,1
MDA,FIN,2018.0,2,0,2
NGA,BFA,2011.0,1,0,1
ROU,SGP,2002.0,1,0,1
JPN,LUX,1998.0,1,0,1
ETH,NZL,1999.0,1,0,1
NOR,FRO,2003.0,1,0,1
NGA,FIN,1998.0,1,0,1
POL,LVA,2000.0,1,0,1
PER,CHL,1999.0,2,0,2
DZA,SWE,2004.0,1,0,1
SWE,DZA,2008.0,1,0,1
FIN,KEN,1999.0,1,0,1
AZE,JPN,1999.0,1,0,1
FRA,OMN,2017.0,1,0,1
IND,QAT,1999.0,1,0,1
CZE,QAT,2001.0,1,0,1
BRA,SAU,2007.0,1,0,1
NOR,SVN,2022.0,2,0,2
CHN,ARG,2004.0,1,0,1
KWT,MKD,2008.0,1,0,1
URY,MEX,2004.0,3,0,3
ETH,CHE,2011.0,1,0,1
UZB,ITA,2010.0,2,0,2
ZWE,,2004.0,29,0,29
GBR,KAZ,2011.0,2,0,2
BIH,NLD,2005.0,7,0,7
NLD,MLT,2004.0,2,0,2
BEL,GAB,2009.0,1,0,1
TUR,ROU,2010.0,3,0,3
ROU,TUR,2012.0,2,0,2
DNK,SVK,2012.0,4,0,4
FRA,GRD,2007.0,1,0,1
SEN,GHA,2014.0,1,0,1
HUN,VNM,2017.0,3,0,3
MEX,LTU,1999.0,1,0,1
NOR,SJM,2018.0,1,0,1
FIN,PSE,2017.0,1,0,1
IND,MDG,2002.0,1,0,1
FRA,ISL,2000.0,2,0,2
NOR,ZMB,2000.0,2,0,2
RUS,VEN,1998.0,1,0,1
VEN,RUS,2007.0,1,0,1
FRA,LBY,2013.0,1,0,1
AGO,,2013.0,5,0,5
CRI,CIV,2021.0,3,0,3
MWI,DEU,2015.0,3,0,3
ZMB,,2005.0,4,0,4
USA,FRO,2015.0,1,0,1
DJI,,2016.0,1,0,1
MAR,SEN,2010.0,1,0,1
RUS,ISL,2023.0,3,0,3
GBR,TUN,2008.0,2,0,2
MCO,DEU,2012.0,1,0,1
CHE,LSO,2012.0,1,0,1
JPN,WSM,2011.0,1,0,1
SEN,TGO,2013.0,2,0,2
GHA,BEN,2009.0,1,0,1
ZAF,ISR,2016.0,1,0,1
,SMR,2007.0,1,0,1
RUS,ARE,2014.0,1,0,1
NOR,LAO,2020.0,1,0,1
MNG,,2009.0,16,0,16
CHE,KGZ,2016.0,1,0,1
TON,,2024.0,3,0,3
CYM,MYS,2012.0,1,0,1
THA,ARG,2019.0,5,0,5
SDN,IRN,2006.0,1,0,1
FIN,IDN,2012.0,2,0,2
MHL,,2013.0,1,0,1
ETH,SAU,2017.0,1,0,1
THA,IRL,2017.0,2,0,2
PNG,UGA,2017.0,1,0,1
UGA,PNG,2018.0,1,0,1
KOR,IRL,2019.0,3,0,3
AFG,LBN,2014.0,1,0,1
LIE,,2015.0,3,0,3
TKM,,2024.0,8,0,8
TZA,KOR,2017.0,1,0,1
KEN,PRT,2020.0,1,0,1
TWN,MNG,2016.0,3,0,3
,GMB,2010.0,13,0,13
HUN,SDN,2013.0,1,0,1
LBR,BGD,2020.0,1,0,1
TUR,ETH,2021.0,1,0,1
MDA,GBR,2013.0,1,0,1
CHE,CMR,2015.0,3,0,3
,BMU,2008.0,5,0,5
SLE,IND,2018.0,1,0,1
,TCD,2010.0,9,0,9
SAU,THA,2020.0,2,0,2
PSE,MOZ,2020.0,6,0,6
HTI,,2015.0,7,0,7
SVN,ZAF,2014.0,1,0,1
CYP,CZE,2015.0,1,0,1
PRT,SYC,2013.0,1,0,1
BEL,SDN,2020.0,1,0,1
ECU,CAN,2013.0,2,0,2
,CAN,2021.0,62,0,62
UGA,DNK,2021.0,1,0,1
MMR,SGP,2017.0,2,0,2
TWN,KEN,2018.0,1,0,1
THA,AFG,2017.0,2,0,2
EST,CAN,2021.0,3,0,3
ROU,IRQ,2018.0,9,0,9
CHE,COD,2023.0,5,0,5
FJI,BRN,2015.0,1,0,1
MLI,GBR,2014.0,5,0,5
CHE,KGZ,2017.0,1,0,1
CYM,,2021.0,4,0,4
ZAF,PHL,2019.0,1,0,1
,NER,2005.0,28,0,28
KOR,CMR,2019.0,1,0,1
HKG,PRT,2002.0,2,0,2
BHS,BRB,2011.0,1,0,1
ARG,IRL,2018.0,3,0,3
SUR,SVK,2018.0,3,0,3
ETH,ESP,2009.0,3,0,3
GUY,,2021.0,10,0,10
KEN,ARE,2021.0,1,0,1
,PSE,2020.0,168,0,168
FRA,SDN,2022.0,2,0,2
PRT,PAN,2022.0,1,0,1
PRT,BLR,2022.0,1,0,1
BGD,MEX,2023.0,1,0,1
TKM,RUS,2021.0,1,0,1
ROU,NOR,2020.0,3,0,3
EUE,DEU,2021.0,1,0,1
,KNA,2019.0,8,0,8
,GUY,2017.0,15,0,15
,GLP,2019.0,9,0,9
TUR,JAM,2002.0,1,0,1
SVN,PRT,2004.0,1,0,1
LIE,,2001.0,3,0,3
IND,OMN,2001.0,3,0,3
SGP,NOR,2003.0,3,0,3
DOM,CHL,2005.0,1,0,1
NAM,,2001.0,8,0,8
,AGO,1998.0,5,0,5
AGO,,2003.0,2,0,2
MAR,CHN,2011.0,1,0,1
THA,BRA,1999.0,1,0,1
SAU,POL,2022.0,3,0,3
LIE,AUT,1998.0,1,0,1
NIC,,2002.0,7,0,7
PRT,MCO,1998.0,1,0,1
PRI,SWE,2011.0,1,0,1
MSR,USA,2004.0,1,0,1
ESP,COG,1998.0,1,0,1
IRL,TUR,1998.0,2,0,2
DEU,GRD,2010.0,1,0,1
REU,,2018.0,4,0,4
DMA,ECU,2021.0,1,0,1
PER,KEN,2011.0,1,0,1
TWN,MNG,2018.0,4,0,4
,BLZ,2010.0,4,0,4
MSR,TTO,1998.0,1,0,1
GBR,BIH,2019.0,1,0,1
CHN,POL,1999.0,1,0,1
GRL,DNK,2002.0,3,0,3
COM,FRA,2004.0,1,0,1
PSE,PAN,2004.0,1,0,1
PSE,,2008.0,8,0,8
EGY,SWE,2006.0,3,0,3
DEU,SAU,2007.0,5,0,5
BGD,ITA,2008.0,2,0,2
CHN,TUR,1998.0,1,0,1
,SLE,1996.0,4,0,4
ZWE,SWZ,2021.0,2,0,2
,DOM,2020.0,26,0,26
MYS,NPL,2014.0,1,0,1
TTO,DEU,2022.0,1,0,1
ECU,KEN,2021.0,1,0,1
,MCO,2017.0,12,0,12
ZAF,PSE,2022.0,3,0,3
PER,NLD,2022.0,2,0,2
TZA,,2002.0,14,0,14
DNK,LKA,2020.0,2,0,2
BRA,LTU,2017.0,3,0,3
LBN,SWE,2004.0,1,0,1
BGR,MEX,2009.0,1,0,1
ZAF,ARE,2010.0,2,0,2
ZWE,BGD,2005.0,1,0,1
AUS,SRB,2008.0,1,0,1
JOR,ISR,1998.0,1,0,1
MNE,,2007.0,1,0,1
IND,TTO,2005.0,3,0,3
HRV,ZAF,2002.0,1,0,1
JAM,GRD,2008.0,1,0,1
TUR,BHR,2018.0,2,0,2
NOR,SVK,2003.0,2,0,2
,NER,2002.0,11,0,11
MDA,FIN,2016.0,1,0,1
MDA,FIN,2022.0,1,0,1
ESP,PER,1999.0,5,0,5
CZE,SRB,2003.0,1,0,1
NLD,THA,2000.0,2,0,2
PSE,,2004.0,5,0,5
NLD,UZB,2008.0,1,0,1
NLD,MUS,2020.0,1,0,1
HUN,SAU,2005.0,1,0,1
TUN,NGA,1998.0,1,0,1
LAO,USA,1999.0,3,0,3
IRL,BRB,2001.0,2,0,2
SEN,CIV,2012.0,2,0,2
MDV,NLD,2023.0,2,0,2
RWA,FRA,2001.0,1,0,1
DZA,CAN,1999.0,2,0,2
NLD,BGD,2001.0,1,0,1
BGD,NLD,2002.0,3,0,3
NLD,VEN,2014.0,2,0,2
CZE,PAN,2020.0,1,0,1
BRA,BLR,2014.0,1,0,1
ITA,ARM,2004.0,1,0,1
BRB,IND,2005.0,1,0,1
NIC,AUT,2001.0,1,0,1
BRA,IRL,2006.0,2,0,2
NPL,PHL,2014.0,2,0,2
AUT,SAU,2006.0,1,0,1
SVK,NOR,2010.0,1,0,1
NOR,PAN,1998.0,1,0,1
ZWE,BEN,2009.0,1,0,1
CHE,BEN,2014.0,1,0,1
ITA,PHL,2005.0,1,0,1
NGA,EGY,2001.0,1,0,1
SEN,MAR,2022.0,1,0,1
BHR,YEM,2011.0,1,0,1
RUS,GLP,2000.0,1,0,1
LIE,LTU,2013.0,5,0,5
USA,ARM,2023.0,5,0,5
SRB,BGR,2010.0,2,0,2
BGR,SRB,2012.0,3,0,3
CHE,SUR,2014.0,1,0,1
ITA,MDA,2016.0,2,0,2
,LSO,2006.0,1,0,1
ISR,KOR,2003.0,5,0,5
,PNG,2001.0,22,0,22
CRI,GBR,2008.0,1,0,1
MMR,PHL,2018.0,2,0,2
CYP,NZL,2009.0,1,0,1
CHE,IDN,2019.0,4,0,4
CMR,KEN,2011.0,1,0,1
NLD,ETH,2007.0,3,0,3
USA,ABW,2010.0,1,0,1
ESP,UZB,2017.0,1,0,1
GLP,ARE,2015.0,1,0,1
THA,ZAF,2015.0,1,0,1
GNB,PRT,2018.0,2,0,2
RUS,TUN,2011.0,1,0,1
SRB,BEL,2014.0,4,0,4
SGS,GEO,2018.0,1,0,1
LBR,NZL,2023.0,1,0,1
FRA,IDN,2010.0,9,0,9
SRB,FIN,2019.0,2,0,2
COL,TLS,2017.0,1,0,1
COL,MYS,2022.0,1,0,1
CMR,NLD,2002.0,1,0,1
NGA,CHE,2019.0,8,0,8
CHL,PAN,2017.0,3,0,3
TTO,CYM,2020.0,1,0,1
RWA,BFA,2017.0,1,0,1
RUS,NZL,2020.0,3,0,3
,GLP,2009.0,8,0,8
KGZ,ROU,2018.0,1,0,1
FRA,MUS,2021.0,2,0,2
PAN,COL,2015.0,3,0,3
PRY,PRT,2011.0,1,0,1
PRT,NPL,2017.0,1,0,1
GRD,ESP,2013.0,1,0,1
CHE,PAK,2010.0,4,0,4
MWI,DEU,2014.0,3,0,3
BEL,PSE,2020.0,2,0,2
ECU,NOR,2024.0,1,0,1
UZB,AUS,2014.0,1,0,1
BRN,,2014.0,9,0,9
SAU,AUT,2019.0,3,0,3
SRB,ARE,2023.0,2,0,2
CHE,LAO,2020.0,2,0,2
LBN,FIN,2023.0,1,0,1
GLP,,2022.0,13,0,13
MKD,AUS,2017.0,2,0,2
FRA,IDN,2024.0,1,0,1
DEU,MNG,2017.0,2,0,2
SGP,CZE,2019.0,5,0,5
ARE,BEL,2021.0,4,0,4
CMR,POL,2020.0,2,0,2
VNM,SWE,2000.0,2,0,2
SLB,RUS,2018.0,1,0,1
CUB,CHL,2001.0,1,0,1
BRA,GTM,2022.0,1,0,1
GUF,CHE,2008.0,2,0,2
PLW,JPN,2003.0,1,0,1
,PAK,2021.0,104,0,104
JPN,GHA,2000.0,1,0,1
OMN,ITA,2016.0,1,0,1
OMN,QAT,2018.0,2,0,2
,SWZ,2017.0,16,0,16
ZWE,NAM,2022.0,1,0,1
AUT,QAT,2020.0,1,0,1
VNM,CHN,2009.0,1,0,1
CRI,CUB,2006.0,1,0,1
THA,NOR,2010.0,2,0,2
HKG,AUT,2000.0,1,0,1
MEX,NZL,2000.0,2,0,2
USA,FSM,1999.0,2,0,2
NGA,ZMB,2020.0,2,0,2
HUN,NOR,1998.0,2,0,2
DEU,BEN,2016.0,3,0,3
BIH,,2004.0,13,0,13
SVN,SVK,1997.0,2,0,2
EGY,CHE,2005.0,1,0,1
CAF,BEL,2005.0,1,0,1
SEN,BFA,1998.0,1,0,1
NZL,KEN,2008.0,1,0,1
URY,,1999.0,7,0,7
DMA,MEX,2002.0,2,0,2
GRL,,2006.0,2,0,2
DZA,ITA,1999.0,1,0,1
PHL,KHM,2014.0,2,0,2
PER,MEX,2004.0,1,0,1
,TON,1999.0,2,0,2
TON,CAN,2002.0,2,0,2
CAN,TON,2003.0,1,0,1
MEX,TUR,1998.0,3,0,3
CZE,MEX,2005.0,2,0,2
ISL,FIN,2006.0,1,0,1
NZL,LSO,1999.0,1,0,1
ABW,,2013.0,1,0,1
SYR,,2003.0,10,0,10
DEU,LIE,2000.0,4,0,4
LIE,,2004.0,6,0,6
,NCL,1996.0,16,0,16
MLT,,1999.0,2,0,2
GEO,CHN,2002.0,1,0,1
MYS,LBY,2010.0,2,0,2
DOM,,2001.0,2,0,2
,LAO,2000.0,10,0,10
CAN,JAM,2014.0,2,0,2
IDN,CMR,2021.0,1,0,1
GBR,TGO,2007.0,1,0,1
HTI,,2014.0,9,0,9
NLD,BIH,2018.0,1,0,1
BEN,,2007.0,10,0,10
CHE,LBN,2005.0,1,0,1
BRA,PHL,2019.0,2,0,2
DJI,,2018.0,9,0,9
KHM,,2006.0,9,0,9
LSO,,2019.0,6,0,6
CMR,ITA,2004.0,1,0,1
UKR,HUN,2023.0,1,0,1
ZWE,BWA,2010.0,7,0,7
SVK,BEL,2003.0,1,0,1
BFA,NER,2006.0,1,0,1
,BMU,1996.0,1,0,1
CUB,CHL,2004.0,2,0,2
NIC,,2005.0,7,0,7
GBR,TUN,2004.0,2,0,2
TUN,MLT,2009.0,2,0,2
TTO,JAM,2007.0,1,0,1
JAM,NZL,2010.0,1,0,1
AUT,NPL,2002.0,1,0,1
,KHM,1998.0,14,0,14
CHN,GRC,2013.0,4,0,4
POL,SAU,2013.0,4,0,4
GHA,CIV,2017.0,1,0,1
AUT,ECU,2020.0,2,0,2
IRN,GRC,2007.0,1,0,1
NOR,GHA,2007.0,1,0,1
MKD,MNE,2009.0,1,0,1
NLD,BLR,2009.0,2,0,2
VNM,VEN,2002.0,6,0,6
SRB,EGY,2005.0,1,0,1
HTI,FRA,1999.0,4,0,4
ZAF,MKD,2003.0,1,0,1
JPN,BLR,2001.0,2,0,2
GMB,BEL,2012.0,2,0,2
MDA,POL,1999.0,1,0,1
ITA,SWZ,1998.0,1,0,1
PSE,ESP,2009.0,1,0,1
ESP,PSE,2013.0,2,0,2
NOR,SAU,2012.0,4,0,4
BGD,BRA,2014.0,1,0,1
CAF,,2010.0,4,0,4
CAF,SEN,2009.0,2,0,2
PRI,ARG,2009.0,4,0,4
MUS,,2008.0,3,0,3
CAF,AUS,2003.0,1,0,1
ITA,PER,2011.0,2,0,2
NLD,ERI,2009.0,1,0,1
ERI,NLD,2015.0,1,0,1
VUT,THA,2018.0,1,0,1
GMB,CHE,1999.0,4,0,4
CHE,GMB,2004.0,3,0,3
JAM,JPN,2006.0,1,0,1
MCO,SVN,1999.0,1,0,1
LBN,KWT,2011.0,2,0,2
NPL,SWE,2009.0,1,0,1
IRN,SAU,2017.0,1,0,1
UKR,BRA,2011.0,1,0,1
LBY,ITA,2004.0,1,0,1
IND,SLB,2016.0,1,0,1
MAR,UZB,2021.0,1,0,1
MEX,UKR,2011.0,3,0,3
KOR,OMN,2010.0,1,0,1
HRV,PRT,2008.0,2,0,2
POL,ARG,2015.0,2,0,2
,HTI,2005.0,12,0,12
FRA,ISL,2010.0,3,0,3
CAN,BWA,2007.0,2,0,2
ROU,SRB,2006.0,2,0,2
CHE,MKD,2018.0,1,0,1
BRA,LUX,2016.0,1,0,1
ZAF,LKA,2020.0,2,0,2
ZMB,GHA,2018.0,1,0,1
ITA,BIH,2018.0,2,0,2
EGY,MYS,2005.0,1,0,1
OMN,ZAF,2009.0,1,0,1
OMN,YEM,2021.0,2,0,2
ARG,IND,2022.0,2,0,2
ECU,KEN,2019.0,1,0,1
THA,MDG,2007.0,1,0,1
IDN,NZL,2013.0,3,0,3
MOZ,,2011.0,5,0,5
AUS,FSM,2007.0,2,0,2
NCL,FJI,2005.0,1,0,1
UKR,DNK,2020.0,1,0,1
USA,SLB,2014.0,1,0,1
,FSM,2012.0,3,0,3
SVN,HUN,2011.0,1,0,1
,CYM,2005.0,4,0,4
FIN,LUX,2008.0,2,0,2
ZWE,NAM,2017.0,1,0,1
HUN,PRT,2023.0,1,0,1
ESP,PNG,2010.0,2,0,2
BTN,,2012.0,4,0,4
NLD,URY,2009.0,1,0,1
ARG,SWE,2019.0,6,0,6
IRN,SGP,2010.0,7,0,7
DEU,ZMB,2016.0,1,0,1
EST,RUS,2005.0,2,0,2
KOR,IRQ,2009.0,1,0,1
MLI,GHA,2013.0,1,0,1
ZMB,TZA,2013.0,2,0,2
COD,BEL,2005.0,1,0,1
,LIE,2009.0,5,0,5
LUX,SEN,2017.0,1,0,1
FIN,ARE,2023.0,5,0,5
CAF,SRB,2014.0,1,0,1
ARM,PRT,2017.0,1,0,1
GRC,PAK,2015.0,1,0,1
CHN,GIN,2012.0,2,0,2
DNK,ROU,2020.0,1,0,1
AFG,THA,2013.0,1,0,1
MAR,COM,2013.0,1,0,1
COM,,2020.0,1,0,1
DOM,,2014.0,11,0,11
GMB,FRA,2022.0,2,0,2
SDN,ITA,2012.0,1,0,1
SGP,BRN,2004.0,1,0,1
TUN,NOR,2019.0,3,0,3
SVK,BRA,2019.0,4,0,4
FRA,ALB,2012.0,3,0,3
,WSM,2009.0,3,0,3
NER,SEN,2013.0,1,0,1
CHE,GUY,2018.0,1,0,1
BRA,BEN,2015.0,1,0,1
SVN,FIN,2015.0,3,0,3
BLR,CHE,2016.0,1,0,1
PAK,COL,2018.0,1,0,1
NER,COG,2013.0,1,0,1
CRI,,2002.0,10,0,10
CHN,MEX,2006.0,2,0,2
SAU,JOR,2024.0,2,0,2
MYS,BHR,2017.0,3,0,3
NPL,KEN,2022.0,1,0,1
NZL,BWA,2017.0,1,0,1
IND,GEO,2014.0,1,0,1
CAN,ECU,2008.0,2,0,2
LUX,QAT,2017.0,1,0,1
BGR,IRL,2020.0,2,0,2
BMU,DEU,2020.0,1,0,1
BEL,BLR,2020.0,6,0,6
FRA,MAC,2016.0,2,0,2
CHE,SYC,2021.0,2,0,2
PAN,JPN,2011.0,2,0,2
,COM,2013.0,1,0,1
EST,LTU,2010.0,1,0,1
BLR,USA,2023.0,4,0,4
TUR,UGA,2021.0,1,0,1
MUS,JPN,2021.0,1,0,1
SRB,LBY,2021.0,1,0,1
ARE,YEM,2020.0,2,0,2
GNQ,GIN,2022.0,1,0,1
POL,MYS,2021.0,2,0,2
DJI,IRN,2019.0,1,0,1
ITA,BGR,2023.0,1,0,1
ROU,SEN,2021.0,1,0,1
COG,CAN,2022.0,2,0,2
CUB,ECU,2013.0,7,0,7
TGO,BFA,2022.0,1,0,1
ZWE,CAN,2022.0,1,0,1
IRN,LUX,2020.0,3,0,3
ARG,GTM,2022.0,1,0,1
,TWN,2021.0,46,0,46
GEO,GRC,2003.0,1,0,1
USA,VIR,2017.0,3,0,3
SEN,MRT,2010.0,1,0,1
CAN,KEN,2004.0,5,0,5
HND,,2001.0,2,0,2
NIC,FRA,2010.0,2,0,2
FRA,TGO,2012.0,3,0,3
BEL,MTQ,2010.0,3,0,3
HUN,UKR,2002.0,3,0,3
BRA,LBN,2005.0,1,0,1
LBY,,1999.0,7,0,7
MUS,,2004.0,9,0,9
LTU,ITA,2001.0,1,0,1
BEL,GHA,2009.0,1,0,1
MWI,GHA,2010.0,1,0,1
GHA,ZMB,2015.0,1,0,1
,RWA,2002.0,11,0,11
RWA,GAB,2009.0,1,0,1
GAB,COG,2012.0,3,0,3
BGR,OMN,2016.0,1,0,1
LKA,TWN,1999.0,1,0,1
PRY,MEX,2011.0,2,0,2
ZAF,HTI,2009.0,1,0,1
GTM,GBR,2003.0,1,0,1
PHL,OMN,2008.0,1,0,1
,TCD,2000.0,4,0,4
BRA,ARM,2006.0,1,0,1
NGA,JPN,1999.0,4,0,4
CMR,DNK,2012.0,1,0,1
CHE,KAZ,2004.0,1,0,1
BFA,ETH,2001.0,1,0,1
CAF,FRA,2001.0,2,0,2
COL,PER,2004.0,2,0,2
BLR,AZE,2021.0,1,0,1
ETH,NGA,2014.0,2,0,2
JOR,ESP,2001.0,2,0,2
ISL,CHE,2021.0,2,0,2
MLI,,2003.0,2,0,2
ITA,LUX,2008.0,1,0,1
BEL,IRL,1998.0,4,0,4
SOM,KEN,2012.0,1,0,1
ITA,BWA,2014.0,1,0,1
TTO,CYM,1998.0,1,0,1
DOM,USA,2000.0,3,0,3
HUN,HRV,2002.0,1,0,1
BEL,RWA,2011.0,6,0,6
ESP,COG,2007.0,1,0,1
ARG,ARE,2007.0,1,0,1
JPN,GUM,2010.0,1,0,1
ITA,LUX,2001.0,1,0,1
BGR,SDN,1998.0,1,0,1
ETH,RWA,2017.0,1,0,1
GNB,NAM,2018.0,1,0,1
PHL,TWN,2001.0,2,0,2
IND,NGA,2024.0,1,0,1
PRT,HKG,2003.0,1,0,1
CHE,KOR,1997.0,3,0,3
GRC,CHN,2000.0,1,0,1
NLD,JOR,2018.0,2,0,2
,GIB,2004.0,3,0,3
ITA,NIC,1998.0,4,0,4
IDN,PER,2023.0,1,0,1
MCO,SVK,2007.0,1,0,1
CHE,TZA,1998.0,1,0,1
ZAF,NOR,1998.0,3,0,3
MYS,BRA,2006.0,1,0,1
IRQ,ARE,2013.0,3,0,3
USA,CCK,2012.0,1,0,1
,KGZ,2005.0,13,0,13
ETH,TTO,2011.0,1,0,1
TUN,KWT,2005.0,2,0,2
ESP,SGP,1998.0,1,0,1
SYR,RUS,2007.0,1,0,1
IRN,SWZ,2012.0,1,0,1
BEL,LBY,2007.0,1,0,1
CAF,,2000.0,2,0,2
,MHL,1995.0,1,0,1
,ASM,2000.0,2,0,2
GMB,TZA,2020.0,1,0,1
,RWA,2005.0,20,0,20
KOR,ISR,2002.0,3,0,3
JOR,NPL,2009.0,1,0,1
SLV,USA,2008.0,2,0,2
CHN,ARE,2010.0,2,0,2
FIN,JOR,2017.0,1,0,1
AUS,BLR,2017.0,1,0,1
POL,SVN,2008.0,2,2,0
USA,MYS,1998.0,9,5,4
NOR,ROU,2009.0,2,2,0
TUR,NZL,2012.0,3,2,1
ZAF,THA,2013.0,2,2,0
SGP,VNM,2016.0,8,3,5
DNK,NZL,2014.0,3,10,-7
CHL,NIC,2015.0,1,1,0
LVA,SWE,2018.0,3,4,-1
DEU,GAB,2018.0,9,2,7
GAB,GBR,2017.0,2,1,1
BMU,USA,2009.0,6,2,4
SWZ,CHE,2006.0,1,1,0
PRY,USA,2019.0,2,5,-3
NZL,LKA,2013.0,2,6,-4
AZE,USA,2014.0,3,5,-2
MEX,MAR,2013.0,2,1,1
ZAF,FIN,2014.0,2,6,-4
PER,CHN,2017.0,1,1,0
SGP,NLD,2012.0,11,15,-4
NZL,IND,2021.0,9,20,-11
HUN,BRA,2016.0,2,2,0
DZA,ROU,2011.0,1,1,0
CHE,ROU,2014.0,5,3,2
FRA,JOR,2013.0,4,3,1
JOR,FRA,2015.0,4,1,3
IRL,EGY,2015.0,1,1,0
ROU,IND,2014.0,3,1,2
EST,ITA,2011.0,1,2,-1
EST,ITA,2021.0,6,1,5
CHE,ZAF,2012.0,14,13,1
VNM,ITA,2009.0,3,1,2
DNK,MEX,2017.0,5,3,2
SWE,CZE,2013.0,9,8,1
JOR,IRQ,2020.0,9,2,7
IRN,AZE,2011.0,3,10,-7
JOR,SWE,2019.0,2,1,1
PRT,JPN,2010.0,3,1,2
POL,FIN,2009.0,4,3,1
BRN,AUS,2018.0,4,2,2
SWE,ZAF,2013.0,8,9,-1
VNM,MYS,2013.0,1,2,-1
IRN,HUN,2014.0,2,2,0
VNM,BEL,2012.0,6,7,-1
USA,OMN,2009.0,6,7,-1
KOR,KEN,2014.0,1,2,-1
MEX,JPN,2012.0,4,5,-1
CHN,PHL,2016.0,1,4,-3
GEO,GBR,2014.0,2,2,0
JPN,NOR,2016.0,9,7,2
URY,GBR,2014.0,2,1,1
GUF,FRA,1998.0,2,9,-7
POL,JPN,2013.0,11,9,2
ZAF,CHN,2009.0,4,6,-2
IND,TTO,2015.0,3,2,1
SRB,CZE,2020.0,5,3,2
NLD,ARE,2020.0,4,6,-2
TUN,AUT,2016.0,1,1,0
SWE,LVA,2012.0,5,4,1
MEX,ZAF,2020.0,3,1,2
ECU,FRA,2019.0,7,8,-1
KEN,SWE,2020.0,6,4,2
IDN,SAU,2020.0,1,9,-8
TLS,IDN,2022.0,1,2,-1
HKG,IRN,2023.0,3,4,-1
FIN,MAR,2022.0,2,5,-3
FRA,HKG,2004.0,5,2,3
QAT,BGD,2023.0,3,4,-1
LVA,FIN,2022.0,2,2,0
VNM,CAN,2022.0,7,6,1
CHN,COG,2020.0,1,1,0
DEU,ZMB,2023.0,3,1,2
SGP,SAU,2009.0,3,1,2
PAK,ZAF,2021.0,3,4,-1
IRL,FRA,2023.0,24,19,5
IND,TZA,2019.0,3,2,1
FIN,THA,2011.0,2,3,-1
GRC,SRB,2007.0,4,8,-4
ZWE,MWI,2009.0,2,2,0
BEL,PRT,2020.0,13,28,-15
GEO,DEU,2020.0,7,4,3
HUN,POL,2023.0,4,4,0
IDN,AUS,1997.0,4,3,1
PHL,HKG,2023.0,3,2,1
GRC,EGY,2022.0,3,2,1
GBR,PHL,2000.0,2,2,0
BEL,ROU,2017.0,9,7,2
MOZ,GBR,2008.0,1,1,0
RUS,BGR,2022.0,3,4,-1
SRB,FRA,2020.0,5,11,-6
ARE,BHR,2020.0,1,3,-2
SAU,IDN,2018.0,4,3,1
BLR,ISR,2020.0,2,1,1
NLD,QAT,2022.0,1,6,-5
DEU,URY,2013.0,2,1,1
CAN,CYP,2016.0,2,6,-4
HUN,NZL,2021.0,1,3,-2
CAN,JOR,2023.0,4,4,0
JPN,NZL,2019.0,11,10,1
POL,IRN,2021.0,2,32,-30
SAU,IND,2002.0,6,11,-5
USA,BLR,2009.0,3,8,-5
VNM,CAN,2016.0,2,5,-3
MEX,VEN,2021.0,3,6,-3
HUN,ESP,2022.0,4,3,1
HUN,AUT,2001.0,8,6,2
DNK,ARG,2021.0,1,8,-7
BEL,ARG,2007.0,2,1,1
PRI,BRA,2011.0,4,4,0
ZWE,NLD,2013.0,3,2,1
GBR,IDN,2005.0,7,1,6
ISR,CZE,2014.0,1,1,0
ZAF,SWZ,2011.0,6,2,4
USA,CYP,1999.0,6,2,4
GBR,TTO,2000.0,3,4,-1
FRA,NER,2002.0,2,5,-3
AUT,PER,2011.0,1,1,0
DEU,MYS,2004.0,5,1,4
JPN,SVK,2000.0,2,6,-4
EGY,PSE,2020.0,3,2,1
FRA,UKR,2015.0,8,14,-6
NLD,ARG,2018.0,5,7,-2
LKA,DEU,2006.0,1,4,-3
FRA,ECU,2003.0,1,10,-9
USA,UGA,2002.0,8,5,3
USA,LIE,2005.0,2,2,0
CAN,IDN,2006.0,1,1,0
IDN,DEU,1997.0,2,2,0
SRB,FRA,1998.0,3,3,0
SGP,NLD,2005.0,5,3,2
ESP,AUS,2000.0,5,7,-2
AUS,BEL,2007.0,11,18,-7
DEU,IDN,1997.0,2,2,0
GEO,RUS,1997.0,2,3,-1
PRT,JPN,2000.0,4,2,2
SAU,AUS,1997.0,2,4,-2
BEL,POL,2010.0,8,14,-6
SGP,NLD,2002.0,2,2,0
CHE,SVN,1997.0,1,2,-1
ISR,ESP,1999.0,6,6,0
NLD,GRC,2000.0,8,9,-1
BRA,RUS,2021.0,3,9,-6
MDA,DEU,2003.0,2,2,0
EGY,DEU,1998.0,10,17,-7
ITA,GEO,2018.0,3,2,1
HKG,JPN,2008.0,8,17,-9
FRA,NER,1997.0,3,6,-3
SGP,PHL,2016.0,4,10,-6
AUS,MEX,1999.0,3,1,2
IND,BEL,1997.0,6,6,0
CUB,PRT,2010.0,2,3,-1
FRA,REU,1999.0,4,2,2
USA,PSE,2004.0,2,1,1
CAN,URY,2006.0,1,2,-1
JPN,GRC,2009.0,7,2,5
GTM,USA,2015.0,7,13,-6
AUS,PHL,2001.0,10,3,7
AUS,ESP,2003.0,13,14,-1
AUS,BEL,1998.0,7,4,3
BLR,UKR,2000.0,3,2,1
CHL,RUS,2011.0,3,3,0
GRC,ESP,2004.0,6,4,2
NLD,ISR,1997.0,6,3,3
GBR,ZWE,1998.0,8,6,2
RUS,GEO,2003.0,6,7,-1
GEO,GBR,2004.0,3,1,2
GBR,GEO,2005.0,1,3,-2
GBR,MLT,2007.0,1,1,0
JOR,JPN,2016.0,1,2,-1
CZE,NOR,1998.0,2,2,0
IND,BWA,2009.0,1,2,-1
THA,BEL,2000.0,3,2,1
POL,MEX,2017.0,3,2,1
BHR,USA,2010.0,3,3,0
COG,UGA,2009.0,1,2,-1
DEU,MDG,2009.0,2,1,1
MDG,DEU,2011.0,2,2,0
NZL,BRA,2014.0,6,1,5
DEU,MDG,2011.0,2,2,0
ESP,ROU,2013.0,5,12,-7
NLD,BGR,2009.0,1,3,-2
USA,CUB,2000.0,5,14,-9
IRL,ITA,1997.0,3,6,-3
SRB,AUS,2012.0,2,1,1
PHL,IND,2008.0,4,3,1
BGR,ROU,2020.0,4,3,1
THA,IND,2011.0,3,9,-6
FRA,SYR,2017.0,5,6,-1
BGR,FRA,2018.0,9,7,2
ISR,HUN,2006.0,1,1,0
EGY,ITA,2010.0,6,9,-3
GBR,LSO,2011.0,1,2,-1
BHS,USA,2014.0,2,3,-1
USA,BHS,2023.0,2,1,1
NLD,CRI,2003.0,2,2,0
KOR,AUT,2007.0,3,1,2
IND,LKA,2006.0,3,1,2
TUR,POL,2019.0,4,2,2
HTI,USA,2023.0,3,2,1
THA,SWE,2016.0,8,9,-1
CZE,MEX,2015.0,3,1,2
ROU,PRT,2013.0,4,1,3
IRN,ZAF,2009.0,1,2,-1
ROU,POL,1999.0,1,1,0
AUS,MEX,2020.0,11,7,4
AUT,TWN,2015.0,1,2,-1
FRA,MYS,2011.0,8,3,5
USA,MLI,2013.0,4,5,-1
IRL,JPN,2019.0,4,9,-5
IRQ,AUS,2007.0,1,1,0
ITA,NZL,2011.0,4,4,0
NZL,ITA,2012.0,4,3,1
PRI,BRA,2009.0,3,2,1
BIH,USA,2007.0,4,6,-2
RWA,KEN,2013.0,1,1,0
AUT,IRL,2008.0,4,4,0
ETH,BEL,2009.0,2,4,-2
CZE,HRV,2017.0,4,3,1
USA,MDG,2006.0,3,1,2
NLD,HKG,2015.0,3,4,-1
VCT,IND,2015.0,1,1,0
AUT,SAU,2018.0,1,2,-1
CMR,JPN,2012.0,2,3,-1
USA,GTM,2014.0,7,9,-2
LKA,BRN,2014.0,2,1,1
CAN,TUN,2007.0,4,2,2
MYS,NLD,2007.0,1,4,-3
POL,SGP,2022.0,4,6,-2
SGP,POL,2023.0,4,1,3
BFA,SEN,2014.0,2,6,-4
AUS,HUN,2021.0,2,6,-4
QAT,ITA,2021.0,5,8,-3
THA,FRA,2018.0,14,39,-25
IND,HRV,2016.0,2,3,-1
SAU,SRB,2015.0,1,1,0
CUB,CHN,2023.0,3,2,1
GRC,ESP,2001.0,6,3,3
MAR,ITA,2012.0,2,5,-3
MEX,PRT,2018.0,7,4,3
DEU,MYS,2015.0,7,17,-10
SVK,RUS,2017.0,3,5,-2
ESP,CMR,2021.0,2,1,1
POL,JPN,2003.0,9,17,-8
DNK,RUS,2002.0,6,10,-4
IND,NER,2011.0,1,1,0
MLI,IND,2016.0,1,1,0
ITA,PRT,1997.0,3,4,-1
EST,ZAF,2018.0,1,1,0
TUN,ARE,2019.0,6,2,4
SRB,PRT,2004.0,4,4,0
NLD,COG,2017.0,1,1,0
TUN,ESP,2013.0,5,10,-5
NZL,THA,2015.0,2,6,-4
PNG,AUS,2014.0,7,7,0
FRA,SVN,2012.0,7,6,1
UKR,CHN,2014.0,5,1,4
SVN,ESP,2008.0,2,3,-1
KOR,UZB,2019.0,4,3,1
ZAF,CZE,2008.0,2,1,1
AUS,URY,2006.0,3,1,2
BEL,IDN,2020.0,7,8,-1
SDN,KEN,2018.0,1,3,-2
CHE,ROU,2004.0,4,4,0
PRT,SGP,2022.0,2,3,-1
RUS,TJK,2020.0,7,2,5
TWN,PHL,2016.0,6,3,3
CRI,FRA,2017.0,4,4,0
USA,BLR,2011.0,2,6,-4
ARM,FRA,2023.0,2,1,1
KEN,BEL,2021.0,8,2,6
BGD,USA,2005.0,6,12,-6
JAM,CAN,2021.0,5,5,0
DZA,PRT,2023.0,2,2,0
HND,MEX,2022.0,1,2,-1
AUT,TWN,2001.0,2,1,1
EGY,MAR,2022.0,1,1,0
PRT,GHA,2023.0,2,2,0
BGR,ITA,2014.0,6,3,3
KAZ,KGZ,2021.0,4,9,-5
MAC,HKG,2022.0,8,12,-4
CUB,ESP,2023.0,11,8,3
SGP,NZL,1998.0,3,2,1
ISL,NOR,1999.0,3,5,-2
ISR,PSE,2000.0,4,6,-2
PHL,GBR,2000.0,2,2,0
BEL,VNM,2007.0,2,3,-1
RUS,BGR,2016.0,2,3,-1
POL,DNK,2002.0,8,4,4
DNK,POL,2003.0,9,7,2
ESP,POL,2004.0,4,5,-1
ZAF,ISR,2000.0,4,3,1
UKR,HUN,2017.0,3,1,2
DEU,IRN,2001.0,6,10,-4
GHA,NLD,2000.0,1,1,0
NIC,SWE,1997.0,2,1,1
PRT,ZAF,2009.0,2,2,0
SRB,MNE,2002.0,3,5,-2
LIE,USA,2005.0,2,2,0
BRA,RUS,2009.0,4,2,2
FIN,KOR,2002.0,2,1,1
NAM,ZAF,2001.0,1,1,0
HUN,AUS,2018.0,7,8,-1
AUS,HUN,2019.0,4,1,3
CHE,THA,1999.0,2,4,-2
IDN,THA,2001.0,2,1,1
CHE,VNM,2020.0,7,2,5
EGY,PAK,2009.0,2,3,-1
AUS,RUS,2004.0,8,15,-7
SWE,PAK,1999.0,1,4,-3
AUT,PRT,2010.0,6,5,1
PRT,SRB,2001.0,1,2,-1
CHN,BRA,1997.0,5,1,4
KHM,AUS,2021.0,3,4,-1
BLR,GBR,2003.0,1,4,-3
CHE,ARE,2013.0,1,1,0
TWN,CHE,1999.0,1,3,-2
PHL,THA,2014.0,1,3,-2
HRV,PRT,2012.0,2,2,0
FRA,HKG,2001.0,7,3,4
CAN,ECU,2005.0,1,2,-1
ESP,TUR,2003.0,4,2,2
BFA,SEN,2008.0,4,1,3
MAR,PRT,2012.0,1,1,0
MAC,TWN,2023.0,3,1,2
NCL,AUS,2019.0,4,1,3
NCL,AUS,2021.0,1,3,-2
CHE,PAK,2022.0,3,7,-4
MLI,COD,2017.0,2,1,1
DNK,CZE,2017.0,5,3,2
MAC,USA,2017.0,7,14,-7
MLT,GRC,2021.0,2,3,-1
ZMB,GBR,2008.0,1,2,-1
ESP,GTM,2013.0,4,1,3
UKR,ESP,2013.0,4,5,-1
NLD,LUX,2016.0,3,8,-5
POL,CHL,2016.0,3,3,0
TWN,KOR,2007.0,6,3,3
USA,SYR,2011.0,6,2,4
ALB,SRB,2012.0,6,10,-4
DNK,SGP,2010.0,4,3,1
MEX,SGP,2019.0,1,1,0
HUN,CZE,2009.0,4,4,0
CHE,LIE,2015.0,1,2,-1
NLD,MAR,2016.0,3,1,2
MAR,NLD,2020.0,1,1,0
CIV,DEU,2020.0,4,3,1
KAZ,ZAF,2022.0,1,1,0
ITA,MDG,2019.0,1,1,0
NGA,GMB,2020.0,6,2,4
ETH,NOR,2012.0,5,6,-1
GBR,MOZ,2014.0,4,2,2
MYS,IRL,2017.0,7,5,2
NOR,AUS,2009.0,13,13,0
CAN,POL,2009.0,16,14,2
TZA,NLD,2014.0,1,7,-6
BIH,ITA,2021.0,2,2,0
IRQ,EGY,2017.0,2,10,-8
MKD,ITA,2013.0,2,1,1
LTU,NOR,2014.0,2,2,0
UKR,PRT,2006.0,3,1,2
ROU,IND,2015.0,1,5,-4
EST,ESP,2018.0,3,2,1
NPL,ISR,2019.0,1,2,-1
NLD,MEX,2021.0,10,18,-8
LAO,IDN,2014.0,1,1,0
SWE,FRO,2015.0,1,1,0
BHR,IRL,2017.0,2,1,1
FRO,ISL,2017.0,1,1,0
DOM,ESP,2016.0,2,6,-4
CHE,CHL,2007.0,6,5,1
DEU,CUB,2018.0,3,7,-4
VNM,CHE,2019.0,3,4,-1
DEU,GIN,2016.0,1,1,0
KOR,MAC,2020.0,1,1,0
CAN,MAR,2023.0,4,3,1
GRC,HUN,2019.0,3,1,2
CRI,AUS,2016.0,2,1,1
TUN,CAN,2022.0,6,3,3
USA,DOM,2018.0,1,1,0
CZE,ARG,2017.0,2,1,1
USA,PLW,2014.0,1,2,-1
MNG,TWN,2021.0,4,1,3
DEU,TWN,2024.0,1,1,0
FRA,GAB,2018.0,13,5,8
ARE,ARG,2020.0,1,1,0
PAK,TWN,2020.0,6,5,1
SWE,KOR,2017.0,7,11,-4
VNM,ITA,2019.0,3,6,-3
ISR,CYP,2022.0,2,2,0
TUN,CHE,2018.0,5,4,1
CHN,LUX,2021.0,5,5,0
POL,HRV,2018.0,1,1,0
POL,MEX,2018.0,4,1,3
DEU,PER,2023.0,1,8,-7
ROU,CHE,2023.0,2,2,0
ECU,AUS,2017.0,3,3,0
ETH,ZAF,2014.0,7,7,0
GBR,BLR,2007.0,1,7,-6
HRV,CZE,2020.0,3,1,2
ITA,JOR,2016.0,4,4,0
SRB,ISR,2019.0,1,1,0
DZA,MAR,2020.0,3,5,-2
USA,TUN,2021.0,2,9,-7
ISR,DNK,2007.0,4,1,3
BOL,FRA,2019.0,1,3,-2
ZAF,TWN,2019.0,1,4,-3
CRI,MEX,2020.0,4,5,-1
SVN,BIH,2019.0,4,5,-1
EGY,ETH,2022.0,1,1,0
IRQ,EGY,2022.0,6,8,-2
USA,MCO,2008.0,1,1,0
BRB,JAM,2006.0,1,1,0
IND,AUT,2000.0,3,3,0
SGP,RUS,2013.0,3,2,1
ZAF,TUR,2011.0,2,3,-1
NAM,ZAF,2004.0,3,5,-2
GIN,FRA,2016.0,3,3,0
MYS,LBY,2022.0,12,2,10
ECU,CHL,2022.0,9,13,-4
FRA,JOR,2003.0,1,1,0
VIR,USA,2012.0,2,2,0
GHA,USA,2009.0,5,6,-1
POL,SVN,2004.0,1,1,0
UZB,USA,2007.0,3,4,-1
NER,USA,2000.0,1,1,0
BLR,NLD,2005.0,2,1,1
ARG,URY,2001.0,6,4,2
NLD,ISR,2005.0,5,12,-7
TGO,BEN,2005.0,2,1,1
ISL,GBR,2004.0,3,2,1
HUN,IRL,2022.0,2,2,0
IRN,MYS,2006.0,1,2,-1
MEX,GRC,2007.0,1,2,-1
MAR,ITA,2005.0,2,6,-4
ITA,FIN,2004.0,6,10,-4
TJK,RUS,2001.0,4,2,2
SAU,BHR,2014.0,3,3,0
ISR,GRC,2021.0,3,1,2
EGY,BEL,2009.0,3,2,1
BEL,EGY,2012.0,5,2,3
ATG,USA,2017.0,4,1,3
BEL,SVK,2007.0,4,3,1
VEN,FRA,2009.0,6,13,-7
TWN,ESP,2002.0,3,1,2
GRC,SGP,2013.0,3,2,1
VEN,CAN,2004.0,4,3,1
DEU,PHL,2005.0,3,4,-1
NLD,POL,2003.0,9,18,-9
PAN,POL,2003.0,4,1,3
GRC,CAN,2010.0,13,7,6
BWA,USA,2004.0,9,5,4
PRT,BRA,2024.0,4,1,3
DNK,THA,2007.0,1,1,0
ARG,PRT,2013.0,1,4,-3
AUS,KEN,2016.0,2,7,-5
CHE,PNG,2002.0,2,1,1
ISL,NOR,2007.0,2,3,-1
DEU,LVA,2002.0,8,6,2
BRA,CHE,2007.0,8,8,0
KOR,POL,2021.0,5,3,2
OMN,ARE,2010.0,3,1,2
SGP,IDN,2005.0,2,2,0
OMN,TUN,2018.0,1,5,-4
MNG,JPN,2003.0,1,6,-5
ETH,ZAF,2001.0,5,3,2
OMN,AUS,2011.0,1,5,-4
AUT,EGY,1999.0,1,2,-1
HUN,GRC,2019.0,1,3,-2
GBR,BWA,2003.0,7,5,2
ROU,RUS,2016.0,2,3,-1
BRB,ARE,2005.0,1,1,0
KOR,ISR,2004.0,1,2,-1
CZE,DNK,2016.0,6,4,2
CAN,CZE,2013.0,10,11,-1
IRL,ISL,2013.0,1,3,-2
HKG,NZL,2020.0,8,4,4
DNK,NZL,2008.0,8,4,4
ISR,DNK,1998.0,1,1,0
HKG,NLD,2008.0,3,1,2
HKG,DEU,2000.0,3,7,-4
CRI,CUB,2018.0,1,1,0
PAK,CHN,2002.0,3,4,-1
IND,OMN,2005.0,9,5,4
FJI,GBR,2009.0,2,2,0
TWN,DNK,2011.0,1,3,-2
JPN,MYS,1998.0,5,7,-2
NZL,IRL,2011.0,8,3,5
KOR,TWN,1999.0,3,4,-1
MWI,GMB,2012.0,1,1,0
TZA,IND,2015.0,6,4,2
ISR,ZAF,2009.0,1,1,0
GBR,LUX,2006.0,2,3,-1
LUX,GBR,2009.0,3,6,-3
GBR,LUX,2023.0,6,3,3
PAK,SGP,2015.0,3,6,-3
SAU,PAK,2005.0,10,11,-1
ZWE,ZMB,2011.0,2,3,-1
DEU,KAZ,2007.0,2,1,1
GBR,BGD,2001.0,11,8,3
ETH,ITA,2013.0,2,1,1
NOR,CAN,2013.0,13,17,-4
IRL,FRA,2000.0,12,14,-2
CHE,BGR,2006.0,3,5,-2
ROU,CHE,2006.0,3,3,0
ARM,CZE,1998.0,1,1,0
KEN,CHN,2014.0,2,4,-2
TTO,GRD,2012.0,10,1,9
CIV,BFA,2006.0,3,2,1
UKR,KOR,2011.0,4,3,1
MEX,CUB,1997.0,7,6,1
VNM,BEL,2005.0,3,2,1
MDA,FRA,2010.0,3,1,2
JPN,ARE,2010.0,5,1,4
AUS,RUS,2001.0,3,13,-10
AUS,ITA,2008.0,17,27,-10
NZL,HKG,2004.0,2,6,-4
ITA,COG,2007.0,1,1,0
HKG,KOR,2009.0,6,1,5
KOR,SWE,2010.0,2,3,-1
NLD,PHL,2011.0,2,2,0
COL,VEN,2005.0,3,2,1
JPN,NAM,2014.0,2,1,1
GRC,BRA,2013.0,1,2,-1
DEU,BFA,2008.0,1,3,-2
ERI,SDN,2017.0,1,1,0
CHN,PAK,1998.0,1,1,0
QAT,SAU,2017.0,6,17,-11
ISR,IRL,2007.0,3,1,2
ESP,AND,2008.0,6,2,4
IDN,SGP,2013.0,1,6,-5
NOR,MEX,2016.0,1,2,-1
SRB,BEL,2012.0,3,4,-1
CPV,PRT,2019.0,1,3,-2
MAR,LBN,2021.0,1,2,-1
NGA,MYS,2008.0,4,1,3
AUT,IRL,2015.0,3,5,-2
ECU,USA,1999.0,7,6,1
IRN,ZAF,2021.0,2,7,-5
FRA,VNM,2007.0,10,5,5
SAU,TUR,2003.0,2,2,0
SVN,SRB,2007.0,1,3,-2
MEX,VEN,2011.0,3,9,-6
CIV,BEL,2010.0,2,1,1
HUN,CHN,2018.0,3,6,-3
SAU,ZAF,1997.0,4,5,-1
POL,BLR,1999.0,3,3,0
BGD,THA,2018.0,2,3,-1
LTU,FIN,2022.0,4,6,-2
GBR,AFG,2013.0,1,2,-1
BEL,PAK,2019.0,5,4,1
ARE,NZL,2019.0,3,8,-5
USA,BHS,2010.0,1,4,-3
JOR,OMN,2012.0,1,4,-3
TWN,CYP,2021.0,1,1,0
JPN,SDN,2007.0,3,1,2
HUN,AUS,2022.0,2,1,1
HUN,BRA,2022.0,3,7,-4
BIH,JPN,2018.0,1,1,0
AUS,PER,2020.0,2,3,-1
LUX,NLD,2013.0,4,5,-1
SEN,MWI,2021.0,1,1,0
MCO,MAR,2020.0,1,1,0
KEN,FIN,2018.0,2,1,1
USA,VIR,2023.0,4,8,-4
ISR,AZE,2016.0,1,1,0
ALB,USA,2010.0,4,9,-5
BGR,UKR,2005.0,1,1,0
GBR,ROU,2002.0,9,16,-7
FIN,ITA,1999.0,4,11,-7
FRA,MYS,2019.0,8,10,-2
KAZ,UZB,2020.0,7,2,5
ARG,ISR,1999.0,4,4,0
BEL,FIN,2010.0,4,8,-4
CAN,IRQ,2010.0,1,1,0
AUS,NCL,2019.0,1,4,-3
CZE,CAN,1998.0,3,10,-7
ITA,GRC,1998.0,14,8,6
COL,KEN,2013.0,2,1,1
NOR,CAN,2003.0,9,6,3
ROU,BEL,2000.0,2,2,0
OMN,AUS,2009.0,4,7,-3
BEL,ARG,1998.0,1,1,0
ARE,FRA,2017.0,3,17,-14
DNK,ZAF,2007.0,2,3,-1
OMN,DEU,2021.0,2,3,-1
NGA,KOR,2001.0,2,2,0
TZA,USA,2000.0,4,5,-1
CHL,ARE,2014.0,1,1,0
SWE,KEN,2002.0,6,1,5
FRA,THA,2001.0,4,7,-3
BOL,FRA,2009.0,4,6,-2
CHE,NGA,2005.0,1,2,-1
GRC,ITA,2006.0,11,21,-10
UKR,MEX,2009.0,2,3,-1
TUR,HKG,2004.0,1,1,0
ITA,SVK,2004.0,2,3,-1
DZA,USA,2011.0,4,2,2
AUS,LKA,2000.0,3,2,1
NOR,JPN,2000.0,1,3,-2
TWN,SWE,2007.0,1,3,-2
PAK,IND,2002.0,3,4,-1
NLD,LBN,2012.0,2,1,1
NOR,FRA,2003.0,8,11,-3
EGY,YEM,2010.0,5,3,2
PHL,DNK,2006.0,1,1,0
USA,COG,2009.0,6,5,1
SAU,KEN,2019.0,1,1,0
ARE,JOR,2013.0,5,13,-8
SYR,CHN,2010.0,2,1,1
HRV,CHE,2006.0,4,5,-1
NCL,USA,2011.0,3,1,2
THA,IRL,2006.0,1,1,0
GBR,GMB,2015.0,5,5,0
HKG,RUS,2011.0,1,2,-1
MYS,VNM,2018.0,8,2,6
TUN,BHR,2021.0,3,2,1
DNK,BEL,2010.0,3,7,-4
IRL,PRT,2011.0,5,2,3
MNG,AUT,2005.0,1,1,0
UGA,BEL,2013.0,2,2,0
MEX,CHN,2007.0,3,1,2
ARE,USA,2000.0,6,28,-22
MOZ,PRT,2015.0,1,2,-1
DZA,GBR,2007.0,1,7,-6
DNK,SVK,2014.0,1,1,0
UGA,NAM,2019.0,1,1,0
ISR,CZE,2008.0,3,3,0
MOZ,ETH,2019.0,1,1,0
SWE,PRT,2012.0,13,6,7
CAN,PER,2010.0,4,1,3
OMN,ETH,2020.0,1,1,0
ITA,URY,2014.0,3,2,1
NLD,TUR,2002.0,6,7,-1
LTU,DNK,2013.0,4,1,3
PRI,ESP,2014.0,3,7,-4
CHN,MAC,2008.0,11,16,-5
MYS,SDN,2013.0,4,3,1
HRV,DNK,2013.0,2,1,1
SWE,MEX,2015.0,4,6,-2
ITA,MLT,2013.0,3,1,2
FIN,EGY,2023.0,2,1,1
HUN,EGY,2018.0,2,7,-5
BRA,ARM,2016.0,1,1,0
NLD,LUX,2022.0,2,5,-3
QAT,SAU,2016.0,4,20,-16
PRT,CAN,2011.0,6,11,-5
MNG,JPN,2013.0,5,5,0
PRT,IND,2008.0,2,9,-7
NOR,EGY,2017.0,1,1,0
LKA,DNK,2004.0,1,3,-2
DEU,MMR,2017.0,1,1,0
CIV,CRI,2020.0,1,4,-3
EGY,SYR,2011.0,3,1,2
CUB,ARG,2020.0,6,5,1
COL,MEX,2009.0,10,4,6
ISR,SGP,2013.0,4,4,0
CMR,IDN,2011.0,1,1,0
GBR,CMR,2014.0,6,6,0
RUS,SGP,2014.0,6,2,4
DEU,CIV,2015.0,1,1,0
ARE,HRV,2017.0,1,1,0
NOR,CZE,2011.0,4,6,-2
CZE,ESP,2006.0,3,5,-2
TUR,CAN,2015.0,15,27,-12
WSM,AUS,2018.0,1,1,0
ETH,NLD,2003.0,3,4,-1
DNK,BGR,2002.0,1,4,-3
CZE,HUN,2002.0,4,1,3
EGY,GBR,1997.0,3,9,-6
EST,CZE,2022.0,2,4,-2
NLD,SVN,2008.0,2,4,-2
BEL,SRB,2004.0,4,2,2
DNK,HRV,2020.0,3,3,0
HKG,ZAF,2008.0,1,2,-1
COL,JPN,2011.0,1,3,-2
TZA,NLD,2008.0,4,4,0
FRA,VEN,2007.0,5,6,-1
SAU,ITA,2014.0,7,11,-4
KGZ,KAZ,2011.0,3,1,2
GRC,AUT,2012.0,6,5,1
NZL,HKG,2014.0,3,3,0
IND,ABW,2021.0,1,1,0
DNK,ETH,2019.0,5,1,4
URY,PRT,2009.0,1,1,0
NZL,NGA,2023.0,1,4,-3
THA,RUS,2006.0,1,1,0
BEL,THA,2008.0,2,2,0
GRC,ROU,2018.0,7,3,4
JPN,BLR,2002.0,1,2,-1
COG,UGA,2021.0,1,3,-2
COG,DEU,2021.0,2,1,1
CZE,UKR,2007.0,3,2,1
ITA,SVK,2015.0,4,7,-3
ZWE,BWA,2022.0,2,1,1
BGD,ITA,2012.0,4,4,0
VNM,HUN,2019.0,2,2,0
AUT,CHN,2008.0,6,9,-3
TWN,NOR,2012.0,3,1,2
ISR,SWE,2019.0,7,3,4
BHR,IRL,2018.0,3,4,-1
JPN,CHL,2021.0,4,1,3
USA,DMA,2018.0,1,3,-2
ISL,AUS,2022.0,3,2,1
BEN,CMR,2020.0,1,2,-1
TUN,CHE,2022.0,1,2,-1
LTU,FIN,2018.0,1,1,0
CZE,KOR,2016.0,2,3,-1
BRN,NGA,2020.0,1,1,0
TWN,ITA,2018.0,6,3,3
CHN,BEN,2023.0,3,1,2
CAN,SRB,2002.0,3,1,2
IND,FJI,2023.0,2,1,1
DNK,THA,2020.0,2,2,0
IDN,PAK,2023.0,2,3,-1
ARE,CYP,2023.0,1,1,0
NLD,CZE,2001.0,5,9,-4
ISR,MEX,2001.0,1,4,-3
ARG,PER,2020.0,6,3,3
LVA,RUS,2007.0,1,1,0
GTM,CHE,2023.0,1,2,-1
AUT,IND,2001.0,2,5,-3
SMR,ITA,2014.0,2,1,1
CHN,ZMB,2016.0,3,1,2
ESP,VNM,2020.0,2,2,0
ZAF,ISR,2023.0,3,1,2
GBR,MLI,2022.0,1,1,0
CHE,ETH,2022.0,1,2,-1
CRI,ESP,2023.0,8,5,3
TWN,HKG,2015.0,8,10,-2
EGY,ZAF,2022.0,2,4,-2
EGY,RWA,2022.0,1,1,0
NLD,DZA,2022.0,1,1,0
UGA,NLD,2021.0,4,7,-3
PRI,COL,2022.0,1,3,-2
BGR,AUT,2003.0,6,2,4
PER,CAN,2000.0,2,1,1
MKD,DEU,2002.0,3,1,2
DEU,MKD,2008.0,3,2,1
DEU,MKD,2014.0,1,3,-2
COL,BRA,2008.0,7,17,-10
ZWE,CHN,2016.0,2,1,1
ARG,NZL,1999.0,1,1,0
VIR,USA,2005.0,3,1,2
ITA,SVK,2014.0,3,2,1
PRT,NOR,2013.0,3,5,-2
SWE,PAK,2007.0,1,3,-2
BLR,FRA,2005.0,5,2,3
DJI,FRA,1998.0,1,1,0
PAK,AUT,2000.0,1,2,-1
USA,PNG,2000.0,5,4,1
PNG,USA,2008.0,5,2,3
TTO,USA,2001.0,8,6,2
UZB,GBR,2011.0,1,2,-1
ZWE,FRA,2022.0,2,3,-1
SWE,TWN,2008.0,2,2,0
LBN,EGY,2017.0,6,3,3
CYP,KOR,2018.0,1,1,0
CHN,MYS,2010.0,3,8,-5
AUT,VNM,2013.0,4,1,3
ITA,CUB,2021.0,1,2,-1
COL,FRA,2006.0,4,10,-6
CHE,HKG,1997.0,1,2,-1
AUS,PAK,2002.0,3,2,1
SWE,TUR,1997.0,2,2,0
BEL,COL,2016.0,5,6,-1
SAU,AUS,2005.0,4,1,3
HND,CAN,2019.0,1,2,-1
ARE,SAU,1999.0,2,8,-6
BEL,KHM,2014.0,1,1,0
AUS,KHM,2022.0,2,6,-4
SAU,TUN,2002.0,4,2,2
SAU,PAK,1997.0,2,2,0
AUS,SAU,2000.0,1,4,-3
BRN,SAU,2017.0,1,2,-1
KWT,EGY,2004.0,2,13,-11
DNK,IDN,2018.0,1,1,0
PRT,DNK,2009.0,2,3,-1
ISR,TWN,2002.0,2,1,1
GBR,MDG,2020.0,4,3,1
AUT,SAU,2016.0,4,1,3
MKD,USA,2014.0,8,1,7
LBN,GBR,1999.0,2,2,0
IRQ,JOR,2007.0,4,2,2
AUS,HUN,2011.0,4,6,-2
ESP,PRI,2005.0,5,2,3
KEN,JPN,2005.0,4,6,-2
JPN,SVN,2020.0,2,2,0
CZE,DNK,2017.0,3,5,-2
ALB,SRB,2005.0,1,1,0
COL,NZL,2016.0,1,1,0
GBR,TCD,2017.0,3,1,2
DEU,SDN,2019.0,5,1,4
AUS,KHM,2016.0,1,4,-3
PRT,LTU,2021.0,1,1,0
IDN,ESP,2016.0,1,2,-1
SGP,BRN,2012.0,2,1,1
LBN,FIN,2022.0,1,1,0
SVN,JPN,2020.0,2,2,0
NZL,IRL,2009.0,5,5,0
KOR,HUN,2021.0,2,1,1
FRA,UKR,2014.0,12,23,-11
MLT,ITA,2006.0,2,2,0
SRB,IRL,2020.0,1,2,-1
THA,AUT,2015.0,2,10,-8
MYS,DNK,2014.0,5,2,3
GAB,DEU,2014.0,5,4,1
IRL,BEL,2007.0,4,4,0
UGA,SWE,2014.0,2,5,-3
USA,LAO,2015.0,5,3,2
CRI,FRA,2018.0,2,8,-6
POL,TWN,2019.0,1,4,-3
TWN,POL,2023.0,2,2,0
FIN,TWN,2015.0,2,4,-2
FIN,TWN,2014.0,1,2,-1
KWT,MAR,2019.0,1,1,0
USA,DMA,2016.0,1,2,-1
SRB,SWE,2023.0,3,2,1
CHE,CIV,2019.0,2,4,-2
CYP,CAN,2016.0,6,2,4
ARE,LBN,2020.0,3,11,-8
CMR,CAN,2017.0,4,2,2
ITA,IRQ,2020.0,4,2,2
NLD,SWZ,2019.0,1,2,-1
USA,BFA,2017.0,4,3,1
NOR,KEN,2015.0,4,2,2
USA,MNG,2021.0,7,1,6
ZAF,SGP,2012.0,2,1,1
EST,DEU,2023.0,6,2,4
LUX,ITA,2014.0,3,13,-10
TUR,IDN,2020.0,2,2,0
ZAF,MUS,2019.0,2,1,1
PSE,ISR,2023.0,7,8,-1
POL,BGR,2020.0,4,2,2
BGR,FRA,2022.0,3,4,-1
ISR,TUR,2020.0,3,2,1
POL,NGA,2022.0,3,3,0
BEL,TWN,2022.0,4,4,0
JPN,UZB,2007.0,2,1,1
IRL,LUX,2023.0,1,2,-1
LTU,HUN,2020.0,1,1,0
PRT,ZAF,2011.0,4,3,1
BEL,MAR,2021.0,7,8,-1
AUS,LKA,2023.0,12,23,-11
PHL,IRN,2021.0,1,2,-1
ARE,CZE,2019.0,1,1,0
TUR,RUS,2022.0,2,7,-5
DNK,PRT,2002.0,5,2,3
IND,PNG,2023.0,2,1,1
DNK,KEN,2023.0,1,1,0
TWN,PHL,2022.0,8,8,0
DEU,PRI,2016.0,2,1,1
CMR,ZAF,2003.0,2,3,-1
BLZ,USA,2004.0,3,2,1
USA,PAN,2006.0,10,14,-4
ITA,ALB,2004.0,1,3,-2
LTU,DNK,2003.0,1,1,0
CZE,ITA,2006.0,5,5,0
EST,DEU,2000.0,3,8,-5
LUX,ISL,2018.0,1,1,0
PNG,USA,2001.0,3,2,1
DEU,HRV,2006.0,5,8,-3
KOR,POL,2009.0,4,1,3
MAR,BEL,2018.0,5,5,0
MEX,NZL,2016.0,4,2,2
ISR,SWE,2009.0,2,2,0
SDN,DEU,2011.0,1,3,-2
ETH,USA,2007.0,6,10,-4
AUS,BWA,2006.0,1,4,-3
HUN,CZE,2021.0,8,3,5
TUR,BEL,2003.0,1,2,-1
KEN,DEU,2006.0,5,3,2
KEN,CAN,2006.0,2,1,1
ISR,CZE,2015.0,1,3,-2
BRB,TTO,2015.0,1,1,0
ZAF,PRT,2009.0,2,2,0
BLR,PRT,2004.0,3,1,2
DEU,PER,2006.0,3,2,1
FIN,ISR,2009.0,1,2,-1
USA,COG,2019.0,3,8,-5
ISL,CAN,2010.0,1,1,0
IND,TUR,2018.0,8,10,-2
IDN,CAN,2008.0,1,5,-4
AUT,HRV,2008.0,3,2,1
SWE,KEN,2012.0,4,2,2
SVN,GBR,2012.0,7,6,1
CHE,SDN,2020.0,1,1,0
YEM,DZA,2019.0,1,1,0
UZB,FRA,2022.0,1,2,-1
CHN,ZMB,2022.0,7,1,6
URY,FRA,2007.0,3,3,0
NOR,IRL,2020.0,4,10,-6
IND,RUS,2014.0,3,2,1
DEU,HKG,1997.0,3,5,-2
MAC,AUS,2008.0,1,1,0
SAU,BRA,2019.0,2,2,0
KOR,TUR,2018.0,3,3,0
POL,IRL,2023.0,6,4,2
ZWE,RWA,2016.0,2,1,1
GBR,MAR,2023.0,4,5,-1
AUS,GHA,2017.0,9,14,-5
CMR,BEL,2016.0,3,3,0
MRT,MAR,2017.0,1,2,-1
IRL,ROU,2010.0,3,3,0
MYS,VNM,2017.0,6,3,3
ARE,ISL,2020.0,1,1,0
TZA,NOR,2021.0,1,14,-13
CAN,ROU,2002.0,5,11,-6
GBR,BRA,2024.0,1,2,-1
YEM,MYS,2022.0,4,21,-17
YEM,USA,2020.0,1,1,0
CZE,BEL,2019.0,10,9,1
KWT,DEU,2020.0,1,1,0
KOR,HUN,2019.0,2,2,0
MEX,NOR,2020.0,3,1,2
PHL,ITA,2020.0,3,2,1
DEU,NPL,2019.0,7,6,1
LVA,EST,2023.0,1,1,0
POL,MDA,1997.0,2,1,1
OMN,GBR,1999.0,6,5,1
BWA,GBR,2001.0,1,5,-4
RUS,GEO,2013.0,4,2,2
PRT,CZE,2011.0,3,1,2
MWI,GBR,2000.0,4,8,-4
BIH,SRB,2003.0,4,3,1
USA,LVA,1997.0,2,2,0
MLT,USA,2012.0,3,3,0
PRI,ESP,2004.0,2,3,-1
ARG,CHL,2000.0,3,4,-1
ARE,CZE,2021.0,1,2,-1
ZMB,JPN,2014.0,2,3,-1
USA,NCL,2004.0,3,1,2
DNK,SRB,1997.0,4,1,3
TZA,NGA,2008.0,2,1,1
POL,SVK,2003.0,5,2,3
NGA,SLE,2019.0,4,2,2
IRL,BRA,2010.0,4,1,3
CHE,MAR,2004.0,1,2,-1
IRL,CHL,2010.0,2,4,-2
ARE,NZL,2011.0,1,3,-2
PRI,MEX,2017.0,2,1,1
IRL,BGR,2012.0,1,1,0
BLR,FRA,2012.0,2,2,0
MAR,GBR,1999.0,1,5,-4
DZA,CAN,2003.0,2,1,1
SWE,LVA,2005.0,5,1,4
BGR,ESP,2005.0,3,4,-1
IRL,POL,2012.0,5,5,0
BOL,FRA,2011.0,5,4,1
ZAF,IRL,2001.0,1,2,-1
GBR,ARG,1997.0,7,13,-6
AUT,GEO,2021.0,1,1,0
NLD,SAU,1997.0,2,1,1
CAN,TUN,1998.0,4,3,1
NOR,SAU,2015.0,1,3,-2
GBR,MAR,2000.0,2,4,-2
SAU,KWT,2012.0,4,4,0
TUR,KGZ,2012.0,1,3,-2
ESP,ROU,2003.0,4,7,-3
FJI,AUS,2001.0,1,2,-1
ESP,EGY,2004.0,3,1,2
NER,FRA,2003.0,1,8,-7
NGA,CMR,1998.0,2,3,-1
IRN,TUR,2006.0,1,1,0
HUN,NOR,2003.0,2,2,0
MAR,SYR,2021.0,1,1,0
NAM,BWA,2019.0,1,1,0
NPL,USA,2000.0,7,6,1
RUS,LTU,2004.0,3,3,0
FRA,ZAF,2001.0,11,7,4
FRA,TWN,1997.0,2,5,-3
GTM,USA,2008.0,8,3,5
GBR,UZB,2003.0,1,1,0
ITA,VEN,2002.0,2,1,1
PSE,ISR,2000.0,6,4,2
GBR,PHL,2006.0,4,7,-3
IRL,JPN,2011.0,4,6,-2
BEN,NGA,2013.0,2,8,-6
IDN,FRA,2002.0,6,5,1
MKD,ESP,2011.0,2,1,1
ROU,HUN,2000.0,4,2,2
PAK,JPN,2012.0,6,13,-7
JPN,HKG,2016.0,9,16,-7
RWA,NLD,2011.0,2,2,0
TUR,SRB,2021.0,4,2,2
JPN,PER,2020.0,3,2,1
ZAF,NAM,2012.0,9,3,6
IRL,CHN,2008.0,6,5,1
ARG,POL,2011.0,1,1,0
HUN,DNK,2012.0,3,4,-1
POL,CHL,2017.0,2,1,1
BRA,NGA,2016.0,2,2,0
ARG,DZA,2012.0,1,1,0
AUT,ISR,2011.0,4,7,-3
ISR,AUT,2014.0,3,6,-3
POL,LUX,2021.0,3,1,2
GBR,KHM,2011.0,3,1,2
ARE,SGP,2016.0,1,5,-4
RWA,BEL,1997.0,1,1,0
SAU,TUR,2013.0,4,6,-2
PER,MEX,2012.0,1,3,-2
CZE,ZAF,2010.0,1,1,0
EGY,OMN,2008.0,5,3,2
CHN,AUT,2001.0,3,6,-3
ISR,KOR,1999.0,1,1,0
PAK,JOR,2020.0,5,2,3
CRI,ESP,2000.0,2,1,1
LUX,IND,2023.0,2,5,-3
DEU,PAN,2020.0,2,4,-2
POL,EGY,2002.0,4,2,2
KEN,PAK,2018.0,3,2,1
CZE,ALB,2022.0,1,1,0
SAU,ESP,2015.0,4,5,-1
SVK,TUR,2023.0,1,1,0
SEN,CIV,2014.0,2,3,-1
DNK,UKR,2023.0,1,1,0
LBN,NLD,2020.0,2,1,1
CHN,KWT,2023.0,2,1,1
KHM,USA,2017.0,9,5,4
PER,PRT,2017.0,1,3,-2
CMR,IND,2022.0,2,1,1
SGP,LKA,2019.0,4,3,1
FRA,THA,2000.0,3,5,-2
BEL,ETH,2022.0,7,10,-3
SVN,AUS,2011.0,3,1,2
MUS,GBR,2011.0,2,3,-1
AUS,JOR,2012.0,6,2,4
AUS,SEN,2012.0,1,1,0
DEU,PER,2014.0,5,5,0
PER,BEL,2006.0,2,2,0
NLD,LTU,2010.0,2,4,-2
GRC,IND,2023.0,4,3,1
ZAF,FIN,2010.0,1,1,0
CHN,POL,2011.0,7,2,5
SAU,FRA,2017.0,15,38,-23
PAK,JPN,2016.0,12,11,1
FRA,TUR,2010.0,15,17,-2
FIN,EGY,2015.0,6,1,5
HKG,GBR,2006.0,44,31,13
CHN,DEU,1998.0,63,59,4
RUS,BEL,2018.0,11,9,2
SGP,POL,2014.0,3,9,-6
ESP,ISR,2018.0,12,8,4
ITA,MAR,2022.0,5,5,0
NLD,HUN,1997.0,7,6,1
GBR,ARE,1999.0,7,7,0
SGP,ESP,2021.0,7,6,1
AUS,ECU,2017.0,3,3,0
ISR,FRA,2007.0,23,17,6
USA,UZB,2004.0,3,7,-4
ZAF,MOZ,2020.0,6,4,2
USA,ZMB,2020.0,17,10,7
BRB,IND,2010.0,1,1,0
CHN,ZAF,2008.0,3,6,-3
IRL,SGP,2022.0,4,7,-3
HUN,BEL,2003.0,9,6,3
CMR,MAR,2023.0,2,1,1
JOR,GBR,1999.0,6,13,-7
BGR,RUS,2001.0,1,6,-5
LBN,EGY,2012.0,6,3,3
FRA,PYF,1999.0,11,5,6
KHM,USA,2016.0,8,5,3
HRV,FRA,2001.0,4,6,-2
SWE,SRB,2008.0,2,3,-1
ROU,CAN,2006.0,3,6,-3
MEX,NLD,1999.0,4,4,0
UKR,JPN,2004.0,6,4,2
BEL,SWE,2000.0,11,6,5
IRL,POL,2016.0,6,4,2
CAN,NGA,1998.0,1,3,-2
UKR,BLR,2000.0,2,3,-1
ARG,CAN,2001.0,10,16,-6
ARG,CHE,2003.0,4,3,1
BOL,USA,2011.0,5,7,-2
SAU,LBN,2018.0,3,1,2
TWN,POL,2015.0,1,1,0
DNK,BRA,2013.0,7,5,2
SVN,SLV,2009.0,4,2,2
SRB,ROU,2005.0,1,2,-1
NOR,THA,2017.0,1,1,0
NOR,TZA,2011.0,4,2,2
BFA,ZAF,2014.0,2,3,-1
CZE,AUT,2009.0,6,13,-7
SEN,MAR,2014.0,4,1,3
CIV,BFA,2014.0,1,2,-1
SRB,DNK,2013.0,3,2,1
VEN,MEX,2013.0,17,3,14
LVA,USA,2009.0,2,4,-2
SWE,KOR,2012.0,10,7,3
ARE,DEU,2010.0,2,6,-4
AUS,KWT,2014.0,3,2,1
ARE,VNM,2018.0,2,1,1
MEX,ITA,2003.0,8,10,-2
ROU,ESP,2016.0,8,8,0
NOR,GHA,2011.0,1,1,0
SWE,GRC,2017.0,9,37,-28
FIN,IRN,2014.0,4,14,-10
PSE,DEU,2013.0,4,4,0
JOR,EGY,2014.0,1,3,-2
UGA,BEL,2011.0,2,2,0
CRI,CIV,2020.0,4,1,3
FRA,SVN,2018.0,7,2,5
CAN,MAR,2015.0,8,7,1
KEN,TZA,2018.0,2,9,-7
JOR,ITA,2013.0,1,2,-1
USA,LSO,2022.0,8,1,7
USA,EST,1999.0,5,4,1
BRA,TWN,2017.0,2,4,-2
BLR,ITA,2017.0,1,1,0
FIN,ESP,2019.0,17,26,-9
AUS,WSM,2018.0,1,1,0
THA,KOR,2021.0,7,18,-11
URY,MEX,2017.0,7,2,5
COG,ITA,2022.0,2,1,1
RUS,PRT,2021.0,3,7,-4
SVN,PRT,2016.0,2,1,1
COL,PER,2018.0,6,3,3
DEU,BWA,2016.0,1,2,-1
IRN,NLD,2007.0,13,8,5
NLD,KOR,2017.0,7,7,0
ARE,MYS,2018.0,3,32,-29
CHL,DOM,2019.0,1,1,0
GBR,FLK,2020.0,3,2,1
MWI,JPN,2019.0,2,2,0
BEL,ISR,2021.0,4,7,-3
GMB,FRA,2014.0,1,1,0
DEU,SRB,2014.0,8,21,-13
BRA,IND,2005.0,6,2,4
SWE,ARE,1997.0,1,1,0
NLD,IND,2001.0,6,9,-3
FRA,SGP,2002.0,7,4,3
AUS,SGP,1997.0,12,7,5
ATA,ITA,2019.0,1,1,0
PER,AUS,2015.0,2,1,1
NLD,BIH,2015.0,1,1,0
BEL,KOR,2020.0,3,12,-9
JPN,ZAF,2010.0,4,6,-2
FRA,HKG,2023.0,7,2,5
SOM,USA,2021.0,2,5,-3
JPN,CZE,1998.0,3,6,-3
BEL,CZE,1998.0,4,1,3
RUS,KOR,2010.0,9,15,-6
MDG,FRA,2007.0,6,10,-4
CHL,MEX,2003.0,4,4,0
JPN,IRL,1998.0,1,1,0
SRB,QAT,2016.0,2,1,1
MDA,ESP,1998.0,2,1,1
HUN,SWE,1997.0,8,5,3
BEL,SRB,2010.0,1,2,-1
CYP,USA,2011.0,11,23,-12
IRL,BRA,2008.0,3,5,-2
ZMB,USA,2002.0,3,5,-2
AUT,PAK,2017.0,8,5,3
THA,LAO,2018.0,6,4,2
FIN,UKR,2015.0,1,8,-7
GHA,IRN,2019.0,2,2,0
AUS,ROU,2011.0,5,3,2
TUN,ITA,2011.0,4,2,2
HKG,TWN,1998.0,3,5,-2
CHL,URY,2013.0,2,4,-2
GBR,QAT,2007.0,4,2,2
ITA,VEN,2016.0,7,4,3
TUN,DEU,2010.0,2,4,-2
IRL,TUR,2019.0,8,7,1
USA,MOZ,2017.0,9,9,0
CAN,ECU,2018.0,2,4,-2
BGR,CHE,2016.0,4,3,1
SWE,JOR,2012.0,1,1,0
JOR,EGY,2015.0,2,2,0
FRA,NZL,2014.0,14,8,6
USA,TGO,2017.0,2,1,1
ITA,PAK,2009.0,1,2,-1
GUF,GUY,2016.0,2,2,0
RUS,IRL,2015.0,3,2,1
CAN,JAM,2017.0,6,3,3
PRT,ESP,2024.0,2,2,0
ITA,VNM,2016.0,7,3,4
MDG,USA,2020.0,8,6,2
FRA,TGO,2006.0,5,2,3
COL,CAN,1997.0,2,2,0
ESP,UKR,2005.0,3,9,-6
DEU,UZB,2009.0,3,4,-1
KEN,GHA,2015.0,4,1,3
SEN,COG,2005.0,1,1,0
URY,ESP,2016.0,6,17,-11
GHA,GBR,1997.0,5,3,2
ZAF,AUT,2019.0,4,1,3
IRN,IND,2002.0,5,5,0
JAM,CAN,2013.0,2,2,0
LKA,CAN,2016.0,4,6,-2
ARE,AUS,2000.0,1,5,-4
RUS,GEO,2011.0,5,3,2
SRB,ALB,2013.0,1,8,-7
NLD,ISR,2017.0,11,13,-2
SGP,PHL,2005.0,1,3,-2
DNK,IRL,2009.0,3,5,-2
FIN,SVK,2009.0,3,1,2
DEU,PER,2015.0,5,6,-1
TTO,JAM,2011.0,10,2,8
IRL,ITA,2016.0,16,34,-18
CAN,VEN,2004.0,3,4,-1
EST,FRA,2012.0,1,1,0
DEU,MYS,2006.0,2,1,1
NZL,HKG,2010.0,3,4,-1
LTU,CAN,2003.0,1,2,-1
AUS,LKA,2015.0,14,30,-16
SEN,BEN,2013.0,1,1,0
BEL,KEN,2009.0,4,2,2
AUT,ESP,2007.0,13,11,2
PRI,ARG,2020.0,5,3,2
RUS,PRT,2009.0,8,5,3
PHL,DEU,2008.0,5,5,0
SGP,TWN,2009.0,9,9,0
MYS,BRN,2019.0,5,1,4
CZE,TUN,2021.0,2,7,-5
AFG,NLD,2019.0,2,1,1
CHN,PHL,2012.0,3,5,-2
KOR,FJI,2010.0,1,2,-1
JPN,SVK,2015.0,2,1,1
DEU,LTU,2009.0,3,6,-3
EST,NLD,2016.0,2,2,0
BEL,ISR,2009.0,4,2,2
HUN,POL,2014.0,5,4,1
TZA,NOR,2013.0,7,4,3
POL,KOR,2018.0,5,5,0
ESP,NIC,2010.0,1,1,0
MYS,BEL,2015.0,3,3,0
NZL,AUT,2018.0,3,3,0
NOR,TUR,2012.0,3,2,1
ALB,ITA,2012.0,5,4,1
IND,KWT,2018.0,6,5,1
PAK,NGA,2017.0,3,5,-2
GHA,NLD,2015.0,3,7,-4
MLI,CIV,2017.0,4,4,0
JOR,ESP,2018.0,2,6,-4
PHL,KAZ,2017.0,1,3,-2
CHE,SVK,2022.0,4,5,-1
BFA,MLI,2013.0,2,1,1
MEX,AUS,2004.0,1,2,-1
TWN,FRA,2022.0,8,6,2
LKA,CAN,2017.0,3,7,-4
KHM,CHN,2021.0,1,1,0
UZB,KAZ,2022.0,2,2,0
ITA,ALB,2006.0,1,1,0
JPN,ARG,2009.0,2,2,0
COG,COD,1998.0,2,7,-5
IRN,CHN,2004.0,1,1,0
ISR,SGP,2009.0,4,4,0
CRI,FRA,2005.0,2,2,0
COG,BEL,2007.0,1,7,-6
USA,BIH,1998.0,1,1,0
ESP,EST,2004.0,2,1,1
AUS,PNG,2001.0,3,7,-4
ITA,LTU,2013.0,5,3,2
POL,IRL,2006.0,4,3,1
IDN,FRA,2005.0,1,4,-3
USA,ALB,2022.0,4,1,3
IRL,KOR,2015.0,4,4,0
AUS,EGY,2012.0,3,4,-1
SAU,IDN,2022.0,4,2,2
BOL,CHE,2021.0,1,1,0
PSE,USA,2020.0,4,5,-1
BEL,SGP,2017.0,11,4,7
DOM,USA,2016.0,5,4,1
SLB,NCL,2021.0,1,1,0
CHN,DNK,2002.0,16,4,12
ROU,MDA,2013.0,2,3,-1
CHL,SWE,2014.0,2,3,-1
ESP,NIC,2008.0,2,1,1
FRA,MCO,2023.0,5,7,-2
COG,CMR,2021.0,1,5,-4
IND,HUN,2016.0,3,1,2
NGA,POL,2020.0,4,1,3
SVN,ESP,2001.0,3,1,2
TWN,DNK,2021.0,3,1,2
ERI,SDN,2022.0,1,1,0
BGR,POL,2001.0,2,4,-2
SVN,GBR,1997.0,2,1,1
IND,BEL,2002.0,9,2,7
ZAF,CAN,1997.0,6,5,1
ISR,TUR,1999.0,2,5,-3
JPN,POL,2000.0,17,21,-4
CRI,BRA,2013.0,1,2,-1
ARG,BEL,1999.0,6,2,4
DEU,LUX,2003.0,5,11,-6
BEL,SVN,2001.0,1,1,0
DEU,TWN,2023.0,7,14,-7
MAR,ESP,2007.0,5,8,-3
IRL,BHR,2012.0,5,2,3
BEL,CHL,2001.0,5,2,3
UZB,KAZ,2002.0,3,1,2
CHE,SVK,2012.0,1,5,-4
NLD,BGR,2021.0,1,1,0
TUR,POL,2011.0,3,1,2
POL,IRQ,2023.0,1,1,0
CHE,UGA,2016.0,2,2,0
CUB,CHL,2002.0,2,1,1
CMR,BFA,2010.0,1,2,-1
SWE,HUN,2022.0,11,9,2
QAT,FRA,2016.0,6,19,-13
TWN,JOR,2018.0,3,1,2
PHL,CHN,2006.0,5,3,2
URY,CHE,2015.0,2,1,1
HUN,NLD,2017.0,12,14,-2
BEN,SEN,2013.0,1,1,0
DNK,GRC,2012.0,1,13,-12
DNK,ARG,2019.0,2,2,0
DNK,NLD,2006.0,15,25,-10
CHL,CUB,2022.0,5,6,-1
JAM,BRB,2006.0,1,1,0
NPL,BGD,2023.0,1,1,0
DEU,SGP,1999.0,16,5,11
BRA,JPN,1997.0,9,13,-4
AUS,NCL,2021.0,3,1,2
BWA,USA,2001.0,5,1,4
THA,CHE,1998.0,1,2,-1
BGD,IRL,2004.0,1,2,-1
SWE,BGD,1999.0,4,1,3
IND,KWT,2012.0,2,1,1
ESP,NIC,2004.0,2,1,1
HKG,NZL,1998.0,5,5,0
FIN,EST,2009.0,9,2,7
SEN,CMR,2018.0,1,1,0
ESP,KEN,2014.0,1,1,0
AUT,LUX,2020.0,4,3,1
NLD,NGA,2016.0,1,3,-2
NOR,BEL,2020.0,9,12,-3
USA,BHR,2011.0,6,2,4
NGA,BRA,2020.0,8,2,6
CHN,KAZ,2019.0,5,3,2
KOR,CHL,2021.0,4,6,-2
HKG,IND,2023.0,4,10,-6
BRA,NZL,2023.0,5,3,2
GBR,GIB,2019.0,2,1,1
DEU,MAR,2005.0,3,3,0
ISR,URY,2018.0,1,1,0
MOZ,BRA,2023.0,8,7,1
CAN,COL,2012.0,7,25,-18
BOL,MEX,2003.0,2,1,1
ISR,DNK,1999.0,2,3,-1
EGY,LBN,2013.0,4,3,1
KOR,MEX,1999.0,3,1,2
GBR,MAR,2010.0,1,2,-1
TWN,FRA,2005.0,3,4,-1
CRI,GBR,2012.0,2,3,-1
GBR,ECU,2023.0,3,1,2
BRA,RUS,2019.0,8,8,0
GEO,RUS,2005.0,5,8,-3
AUS,FIN,2000.0,9,9,0
FRA,BRB,2009.0,1,1,0
ESP,RUS,1999.0,9,14,-5
MEX,ISR,2016.0,3,4,-1
CHN,LTU,2019.0,2,2,0
ZAF,TZA,2015.0,8,3,5
KEN,CHN,2015.0,3,7,-4
GRC,LUX,2017.0,3,1,2
PHL,DEU,2006.0,1,3,-2
DNK,GNB,2006.0,2,11,-9
POL,ZAF,2017.0,3,4,-1
TGO,CAN,2018.0,2,2,0
TWN,MAC,2018.0,3,4,-1
ZWE,GBR,1999.0,7,11,-4
BEL,IDN,2007.0,1,1,0
UGA,MWI,2014.0,1,1,0
KOR,ITA,2006.0,1,4,-3
CHE,SVK,2005.0,3,5,-2
VNM,CHE,2009.0,1,2,-1
CHE,MAR,2001.0,3,1,2
JPN,ISR,2004.0,4,9,-5
IND,CHN,2001.0,5,2,3
ETH,USA,1999.0,5,4,1
USA,ERI,2006.0,1,1,0
DNK,GRL,2004.0,7,4,3
ISL,CAN,2006.0,1,1,0
ITA,CMR,2008.0,1,1,0
GBR,UZB,2013.0,2,2,0
IRN,SGP,2017.0,8,6,2
FRA,CRI,2014.0,6,1,5
DEU,MDA,2012.0,4,6,-2
FIN,IRL,2016.0,5,7,-2
USA,MOZ,2012.0,2,5,-3
CAN,BWA,2013.0,1,3,-2
PRT,CZE,2009.0,4,1,3
BEL,AUT,1997.0,2,4,-2
NOR,TUR,2017.0,1,6,-5
IND,QAT,2013.0,7,2,5
SVK,ESP,2014.0,2,2,0
JOR,OMN,2005.0,1,5,-4
SSD,SDN,2016.0,2,1,1
VEN,COL,2004.0,2,3,-1
GRC,CZE,2022.0,2,9,-7
HUN,VNM,2023.0,3,1,2
NIC,ESP,2020.0,2,2,0
PHL,BEL,2021.0,3,3,0
ARE,HKG,2020.0,2,1,1
CZE,MEX,2004.0,3,1,2
SEN,BFA,2003.0,2,2,0
PER,FRA,2020.0,8,6,2
KAZ,JPN,2019.0,2,8,-6
HKG,AUT,2018.0,1,3,-2
EGY,IDN,2022.0,2,1,1
UKR,SWE,2022.0,6,2,4
AUS,ARE,2000.0,5,1,4
CHE,IRL,1999.0,3,1,2
PAN,VEN,2020.0,1,1,0
AUT,MEX,2010.0,1,3,-2
ESP,BGR,1997.0,5,3,2
TUR,BIH,2020.0,2,3,-1
KWT,EGY,2008.0,10,10,0
NGA,ITA,2018.0,1,3,-2
MEX,CRI,2005.0,1,1,0
BEL,EGY,2002.0,3,1,2
KWT,ARE,2004.0,4,2,2
IND,BTN,2014.0,1,1,0
CZE,SLV,2013.0,1,1,0
LTU,USA,1999.0,4,8,-4
CHE,UGA,2022.0,1,2,-1
LTU,DEU,2016.0,6,3,3
GBR,MKD,2014.0,1,1,0
LBN,ITA,2015.0,3,5,-2
PRT,PAK,2011.0,1,1,0
POL,VNM,2020.0,4,1,3
BRA,JPN,2012.0,8,22,-14
IRQ,ITA,2019.0,2,4,-2
VNM,EST,2021.0,2,1,1
MWI,TWN,2019.0,1,1,0
QAT,PSE,2021.0,1,3,-2
SWE,BGD,2020.0,9,3,6
ESP,HRV,2023.0,4,5,-1
SGP,AUT,2023.0,3,2,1
ARE,DEU,2001.0,1,2,-1
HRV,CZE,2007.0,1,3,-2
FRA,SVN,2005.0,5,4,1
SEN,CAN,2020.0,2,7,-5
TUR,ROU,2016.0,1,1,0
ITA,NZL,2009.0,4,1,3
LAO,FRA,2002.0,1,2,-1
MLI,CMR,2007.0,1,1,0
AUS,ISL,2023.0,1,2,-1
RUS,IND,2015.0,2,3,-1
GHA,SEN,2020.0,1,1,0
FIN,HKG,2023.0,3,1,2
NLD,LTU,2008.0,4,1,3
CAN,ARM,2001.0,2,1,1
CAN,EST,2000.0,1,1,0
KEN,BEN,2007.0,1,1,0
ISR,BEL,1997.0,3,4,-1
PNG,AUS,2001.0,7,3,4
DZA,EGY,2005.0,1,1,0
DEU,SDN,2011.0,3,1,2
URY,FRA,1998.0,2,1,1
ZWE,BWA,2018.0,2,1,1
GAB,DEU,2015.0,10,1,9
IRN,AZE,2009.0,3,4,-1
EGY,PRT,2013.0,3,2,1
ISR,IRL,2020.0,3,5,-2
DNK,HKG,2021.0,2,6,-4
ZAF,QAT,2020.0,5,1,4
ESP,ISL,2018.0,1,2,-1
LBY,USA,2022.0,3,2,1
HRV,HUN,2017.0,4,4,0
MAR,USA,2017.0,9,13,-4
CHE,COG,2019.0,5,1,4
SWE,ARG,2012.0,2,4,-2
IDN,CHN,2012.0,1,2,-1
ITA,PSE,2021.0,3,3,0
PHL,CAN,2020.0,6,8,-2
QAT,LBN,2019.0,3,3,0
BEL,CMR,2010.0,6,1,5
IRN,VNM,2021.0,12,10,2
CZE,POL,2003.0,2,6,-4
BRA,PRY,2019.0,6,3,3
BEL,HUN,2022.0,2,1,1
ARG,MEX,2022.0,10,10,0
GBR,EST,2003.0,2,1,1
CHE,COL,2012.0,3,2,1
TUR,ISR,2015.0,3,1,2
BEL,MEX,2005.0,2,4,-2
GHA,DEU,2022.0,11,18,-7
BGD,CZE,2018.0,2,2,0
JPN,PRT,2022.0,3,6,-3
NOR,AUS,2023.0,10,11,-1
BFA,TGO,2023.0,2,1,1
COG,UGA,2023.0,1,3,-2
NGA,CIV,2021.0,3,1,2
CAN,CMR,2023.0,2,1,1
CHN,KAZ,2023.0,6,4,2
CHE,BWA,2022.0,1,1,0
GTM,USA,2003.0,4,10,-6
RUS,CZE,1997.0,5,13,-8
GBR,BGR,2011.0,16,16,0
LVA,FRA,2010.0,1,1,0
SWE,LTU,2010.0,4,4,0
CUB,VEN,2005.0,3,1,2
PYF,MDG,2001.0,1,1,0
RUS,IRL,2011.0,2,3,-1
GMB,BEL,2013.0,1,1,0
AUS,PHL,2013.0,11,8,3
THA,CAN,2005.0,4,13,-9
DEU,KEN,2005.0,5,3,2
KEN,NGA,2016.0,4,3,1
BLR,BEL,1999.0,3,1,2
ARM,RUS,2006.0,2,3,-1
JPN,TZA,2002.0,4,4,0
BDI,USA,2019.0,1,1,0
BRA,COL,2005.0,11,7,4
COD,COG,2009.0,14,24,-10
MWI,TWN,2010.0,3,1,2
KEN,CAN,2021.0,4,4,0
NLD,PHL,2010.0,2,1,1
DNK,IRL,2001.0,2,1,1
CHE,CHL,2005.0,6,1,5
BEL,FIN,2011.0,3,6,-3
SWE,BRA,2004.0,5,5,0
SDN,SWE,2017.0,3,2,1
USA,BHS,2011.0,4,1,3
MWI,ZAF,2018.0,7,6,1
SAU,ARE,2012.0,11,11,0
ARG,JPN,2016.0,1,2,-1
CHL,COL,2001.0,1,2,-1
ISR,UKR,2004.0,1,2,-1
NZL,THA,2003.0,1,1,0
DZA,USA,2000.0,2,1,1
ZAF,SWZ,2010.0,3,1,2
PHL,AUS,2006.0,4,5,-1
ZAF,RWA,2007.0,2,1,1
BRA,TUR,2017.0,2,5,-3
JOR,BHR,2000.0,1,2,-1
FRA,ARE,2010.0,5,2,3
DEU,DZA,2008.0,3,2,1
USA,BOL,2000.0,3,2,1
GBR,BWA,2004.0,5,2,3
ZWE,NLD,2004.0,4,2,2
SVN,BEL,2008.0,3,1,2
ISR,IRL,2002.0,4,2,2
SVK,GBR,2008.0,8,6,2
HUN,HRV,2013.0,3,2,1
SDN,GBR,2003.0,6,1,5
GBR,ZWE,1997.0,5,4,1
JPN,UZB,2002.0,2,1,1
MDG,GBR,2014.0,2,2,0
DNK,KOR,2021.0,7,6,1
CZE,TWN,2011.0,5,1,4
TWN,CAN,2002.0,12,12,0
TWN,CHE,2012.0,2,3,-1
CHN,IRL,2002.0,4,3,1
TWN,DEU,1997.0,5,6,-1
CHE,CHN,2003.0,13,15,-2
IDN,AUS,1999.0,10,11,-1
FRA,TWN,1998.0,4,5,-1
JOR,MAR,2020.0,1,1,0
DNK,KOR,2019.0,6,12,-6
USA,ZWE,2004.0,3,8,-5
ESP,CHN,2003.0,2,5,-3
TWN,HKG,2003.0,5,10,-5
GBR,MUS,2023.0,1,2,-1
NAM,GBR,1999.0,1,1,0
SGP,MAC,2007.0,1,2,-1
USA,JAM,2004.0,5,15,-10
USA,JAM,2008.0,8,12,-4
POL,CHN,2003.0,1,1,0
NLD,HKG,2003.0,2,3,-1
HKG,NZL,2005.0,2,2,0
MNG,JPN,2004.0,2,4,-2
SVN,BEL,2001.0,1,1,0
PAK,ZAF,2010.0,3,2,1
ARE,ZAF,2008.0,1,1,0
AUS,DNK,1998.0,14,8,6
PHL,ESP,2011.0,1,1,0
CRI,ITA,2021.0,2,1,1
BGR,JPN,2009.0,1,4,-3
CMR,GHA,2015.0,3,1,2
SWE,LTU,2000.0,8,7,1
NOR,MYS,2022.0,2,2,0
DNK,POL,2008.0,8,10,-2
CUB,BRA,2008.0,6,4,2
SVN,SLV,2014.0,9,4,5
ISR,NOR,2003.0,2,3,-1
BEN,FRA,2013.0,9,14,-5
ZAF,RUS,2011.0,3,2,1
HUN,DNK,2020.0,5,7,-2
HUN,NOR,2014.0,7,3,4
IRQ,ARE,2012.0,1,1,0
ROU,GRC,2006.0,5,3,2
IRN,PAK,2004.0,1,1,0
FRA,ALB,2013.0,2,2,0
ALB,FRA,2016.0,1,2,-1
GBR,LTU,2020.0,9,9,0
COG,BEL,2016.0,9,11,-2
USA,MLT,2013.0,1,1,0
CUB,BEL,2012.0,4,4,0
ITA,UKR,2018.0,3,3,0
IDN,BEL,2010.0,1,5,-4
SVK,SWE,2014.0,5,6,-1
JPN,PER,2005.0,1,1,0
AUS,KWT,2009.0,1,1,0
BOL,FRA,2006.0,2,4,-2
USA,GRD,2003.0,2,1,1
GBR,JAM,2008.0,4,5,-1
BRA,ZAF,2012.0,1,4,-3
GBR,KHM,2010.0,1,2,-1
ESP,JPN,2023.0,10,15,-5
ESP,ROU,2008.0,8,2,6
CAN,BGD,2010.0,6,13,-7
IRL,NOR,2009.0,4,1,3
ZAF,DNK,2018.0,4,2,2
ARM,GBR,2016.0,1,1,0
CZE,AUT,2008.0,8,9,-1
ESP,ISR,1998.0,7,2,5
PER,ESP,2005.0,2,6,-4
SVK,ITA,2010.0,2,7,-5
ZAF,MUS,2023.0,2,1,1
NLD,SVK,2007.0,2,3,-1
SVK,IRL,2017.0,1,2,-1
SAU,AUT,2016.0,1,4,-3
ARE,GRC,2017.0,3,13,-10
VNM,DNK,2017.0,3,5,-2
GBR,SVN,2017.0,7,18,-11
JOR,IRQ,2012.0,6,4,2
MNG,JPN,2014.0,4,13,-9
TUR,JOR,2017.0,5,1,4
MYS,QAT,2015.0,5,1,4
ARE,ISR,2015.0,1,1,0
GBR,BFA,2015.0,1,3,-2
QAT,SWE,2017.0,3,2,1
FIN,ZAF,2013.0,4,3,1
ROU,HUN,2009.0,5,12,-7
SVN,SRB,2012.0,7,5,2
AUT,IDN,2015.0,3,2,1
SRB,ZAF,2018.0,1,1,0
ZAF,BRA,2012.0,4,1,3
FIN,NLD,2015.0,20,23,-3
IRN,ESP,2009.0,5,5,0
PAK,DZA,2016.0,3,1,2
SDN,USA,2015.0,4,4,0
BIH,USA,2012.0,4,7,-3
MNG,USA,2017.0,1,6,-5
MAR,DZA,2022.0,5,3,2
MYS,PSE,2014.0,5,2,3
COL,ECU,2021.0,3,13,-10
ESP,TUN,2011.0,5,6,-1
SGP,IRN,2017.0,6,8,-2
SGP,BEL,2014.0,4,8,-4
CHN,BLR,2016.0,1,1,0
BLR,CHN,2019.0,3,1,2
MEX,UKR,2016.0,1,2,-1
KHM,THA,2008.0,2,2,0
KAZ,FIN,2014.0,1,1,0
CIV,BFA,2011.0,2,1,1
PSE,CHE,2022.0,1,2,-1
SLV,SVN,2013.0,5,5,0
POL,JPN,2004.0,9,10,-1
DEU,HKG,1999.0,8,9,-1
TWN,KOR,2002.0,6,4,2
KOR,HKG,2012.0,5,6,-1
CHN,ZAF,2021.0,7,22,-15
LTU,ESP,2014.0,3,1,2
SWE,UGA,2020.0,2,2,0
SGP,QAT,2018.0,2,4,-2
BRA,FIN,2017.0,8,7,1
LBN,QAT,2015.0,3,4,-1
IRQ,CAN,2011.0,1,1,0
BEL,TUR,2019.0,5,22,-17
EST,CAN,2022.0,1,4,-3
BWA,IND,2023.0,2,1,1
NLD,ISL,2018.0,3,3,0
COG,USA,2014.0,3,13,-10
NZL,ITA,2020.0,6,5,1
FRA,IRQ,2021.0,10,2,8
NGA,NZL,2022.0,4,1,3
NOR,UKR,2016.0,2,2,0
DEU,ZMB,2021.0,4,1,3
BFA,FRA,2023.0,2,1,1
TUR,PRT,2019.0,3,1,2
IND,NLD,2001.0,9,6,3
ARG,ISR,1997.0,5,3,2
SVK,GBR,2001.0,8,12,-4
ESP,IRN,2009.0,5,5,0
TWN,CAN,2012.0,16,19,-3
MLI,BEL,2012.0,1,2,-1
PHL,AUS,2023.0,8,9,-1
CHN,IRL,2005.0,7,2,5
USA,GUY,2022.0,1,1,0
NLD,MLT,2020.0,3,1,2
CAN,GRD,2020.0,1,3,-2
IRL,DNK,2023.0,6,4,2
IRN,JPN,2011.0,15,22,-7
URY,DEU,2010.0,1,2,-1
SRB,BEL,2007.0,5,2,3
ESP,MOZ,2023.0,4,4,0
ITA,NZL,2010.0,3,2,1
QAT,BRA,2021.0,2,1,1
PAK,HKG,2018.0,10,10,0
NZL,FJI,2023.0,1,1,0
MWI,IND,2022.0,1,1,0
BEL,KEN,2004.0,5,2,3
AUT,HUN,2004.0,7,8,-1
EGY,CHE,2003.0,2,1,1
TUR,UZB,2006.0,1,1,0
HRV,AUT,2000.0,4,4,0
URY,ITA,2002.0,1,2,-1
USA,LKA,2004.0,7,9,-2
GBR,NPL,2004.0,3,4,-1
ZAF,FRA,1999.0,8,7,1
UKR,AUT,2003.0,6,1,5
IND,BHR,2003.0,2,1,1
GBR,COG,2008.0,1,1,0
ISR,AUT,2003.0,4,2,2
NOR,IND,2015.0,5,13,-8
AUT,FIN,1997.0,2,5,-3
TUR,AUS,2000.0,3,2,1
ISR,GRC,2006.0,4,1,3
GRC,UKR,1999.0,1,3,-2
FRA,LAO,2014.0,2,3,-1
RUS,BEL,2007.0,13,14,-1
FRA,AUT,1998.0,5,17,-12
ITA,SVK,2003.0,7,3,4
MEX,POL,2000.0,1,5,-4
ROU,JPN,2006.0,1,6,-5
BGR,NLD,2000.0,7,2,5
MYS,DZA,2017.0,3,1,2
SRB,AUS,1998.0,4,1,3
MEX,KOR,1999.0,1,3,-2
AUT,JPN,1997.0,6,7,-1
BRA,PAN,2003.0,2,1,1
EGY,BHR,2014.0,1,4,-3
SWE,BGR,2002.0,1,1,0
BOL,ESP,2000.0,1,1,0
USA,UZB,2011.0,3,5,-2
BRA,CRI,2010.0,4,2,2
ARE,SAU,2002.0,8,7,1
ARE,JOR,2015.0,5,12,-7
RUS,SVK,1999.0,2,3,-1
FIN,NLD,2004.0,6,8,-2
FRA,CRI,2003.0,3,1,2
KOR,TUN,2015.0,1,3,-2
BIH,ITA,2023.0,1,1,0
ECU,ESP,2010.0,3,4,-1
GRC,SWE,1999.0,4,6,-2
GRC,HUN,2010.0,2,1,1
UKR,CZE,2004.0,5,2,3
SRB,BRA,2004.0,4,7,-3
JPN,BGR,2005.0,3,7,-4
BRB,USA,2006.0,1,2,-1
VEN,DEU,1998.0,2,3,-1
CAN,SRB,1998.0,5,3,2
ZAF,RUS,2021.0,3,3,0
NLD,CRI,2001.0,3,1,2
PER,FRA,2005.0,1,1,0
SAU,KWT,1998.0,1,1,0
ARE,BGD,2009.0,1,2,-1
EGY,IRL,2012.0,1,1,0
LBN,IND,2014.0,1,1,0
CHE,PRT,2000.0,7,2,5
NOR,BRA,2016.0,7,8,-1
VEN,CUB,2001.0,1,5,-4
BIH,HRV,2006.0,9,17,-8
DEU,NGA,2010.0,6,8,-2
CHL,ISR,2014.0,1,2,-1
GBR,KHM,2006.0,1,1,0
NOR,NLD,2006.0,5,11,-6
GRC,CAN,2011.0,10,7,3
NPL,GBR,2002.0,2,1,1
OMN,JOR,2023.0,2,1,1
THA,IRN,2023.0,3,6,-3
PAK,FRA,2002.0,2,1,1
BGR,IRL,2014.0,2,1,1
DZA,CAN,2014.0,5,8,-3
BWA,CHE,2022.0,1,1,0
GBR,SYR,2016.0,3,2,1
BGR,CAN,2014.0,2,2,0
AUT,EGY,2012.0,4,4,0
BEN,ZAF,2021.0,2,1,1
CHE,FIN,2023.0,13,15,-2
SWE,SRB,2021.0,4,3,1
UZB,DEU,2010.0,3,3,0
DEU,UZB,2015.0,4,3,1
LBN,DEU,2006.0,1,1,0
GHA,NGA,2012.0,2,6,-4
TZA,BEN,2015.0,2,1,1
TUN,ESP,2015.0,10,5,5
DNK,KEN,2011.0,1,1,0
TWN,AUT,2014.0,3,2,1
MEX,URY,2008.0,3,2,1
VNM,PHL,2022.0,3,2,1
LSO,USA,2011.0,2,3,-1
RWA,USA,2009.0,4,7,-3
KEN,RWA,2015.0,6,1,5
AUT,ETH,2014.0,3,3,0
HKG,NLD,2013.0,3,5,-2
GBR,SYR,2018.0,3,4,-1
FJI,USA,2007.0,4,4,0
AUS,PNG,2009.0,7,8,-1
BEL,HKG,2015.0,4,1,3
SAU,GRC,2023.0,2,3,-1
NZL,FRA,2015.0,18,10,8
IND,SVK,2020.0,7,3,4
SLV,USA,2020.0,2,6,-4
AUS,CCK,2014.0,2,1,1
SEN,BFA,2015.0,3,2,1
BEN,ZAF,2019.0,2,4,-2
LVA,DEU,2004.0,2,4,-2
NZL,CHL,2021.0,3,3,0
BRN,IDN,2023.0,2,4,-2
IDN,MYS,2005.0,4,2,2
GHA,CHE,2018.0,2,5,-3
SVK,FRA,2017.0,3,3,0
PRT,SRB,2003.0,3,1,2
NOR,IRN,2010.0,1,5,-4
AUS,PNG,2019.0,7,14,-7
JPN,ARE,2011.0,2,2,0
ZAF,MEX,2005.0,1,2,-1
ESP,HRV,2021.0,2,5,-3
BGD,BRN,2015.0,1,3,-2
SWE,IND,2002.0,6,14,-8
NGA,IND,2021.0,8,20,-12
SAU,COL,2022.0,1,4,-3
DEU,NGA,2006.0,8,8,0
PER,BRA,2013.0,16,4,12
JPN,CHL,2010.0,4,1,3
CMR,KEN,2018.0,3,2,1
GBR,SYR,2017.0,1,5,-4
GBR,LAO,2019.0,2,2,0
SAU,BGD,2014.0,2,4,-2
MMR,USA,2021.0,10,6,4
BRA,ISR,2023.0,5,1,4
NLD,EGY,2023.0,6,3,3
PRT,DZA,2023.0,2,2,0
DZA,PRT,2021.0,2,4,-2
ITA,CUB,2000.0,5,3,2
SDN,CHN,2022.0,7,15,-8
SWE,LUX,2005.0,1,1,0
HKG,FRA,2002.0,4,8,-4
SGP,HKG,2008.0,15,24,-9
CHL,PER,2001.0,2,1,1
BEL,TUR,2011.0,7,10,-3
GBR,MLT,2005.0,7,1,6
JPN,VNM,2000.0,3,1,2
CHE,IRN,2016.0,5,22,-17
KEN,IDN,2015.0,3,1,2
NAM,ZAF,2003.0,4,8,-4
NLD,ZWE,2011.0,2,2,0
CAN,BMU,2005.0,1,1,0
VEN,SWE,2001.0,2,1,1
SWE,VEN,2003.0,2,1,1
LBN,IND,2015.0,1,1,0
DEU,SAU,2001.0,3,3,0
DEU,SAU,2004.0,1,2,-1
CHL,PER,2004.0,3,1,2
SWE,NIC,2004.0,1,2,-1
CAN,GRL,2022.0,1,1,0
NER,AUS,2012.0,1,1,0
AUT,CZE,1999.0,9,4,5
MYS,SGP,1999.0,4,2,2
DEU,EST,2003.0,4,3,1
CHE,COL,2005.0,1,1,0
NER,SEN,2005.0,2,1,1
NZL,KOR,2005.0,4,1,3
HKG,MAC,2005.0,5,2,3
FRA,PYF,2017.0,13,24,-11
KWT,SRB,2012.0,1,1,0
LTU,USA,2005.0,10,8,2
USA,ECU,1998.0,2,4,-2
FIN,NOR,2002.0,11,12,-1
BRA,JPN,1998.0,11,15,-4
CHL,MEX,2006.0,4,6,-2
GIB,GBR,2007.0,1,1,0
ARE,JPN,2007.0,3,3,0
NOR,BEL,1997.0,2,3,-1
CAN,UZB,2002.0,1,1,0
ESP,ECU,2001.0,8,4,4
CHE,ZAF,1998.0,6,1,5
COL,VEN,2007.0,1,7,-6
ESP,ISR,2007.0,5,4,1
NOR,CHL,2018.0,1,8,-7
USA,VNM,2002.0,5,6,-1
BEL,EGY,2007.0,6,1,5
BEN,NGA,2001.0,6,2,4
GBR,GRC,2024.0,1,1,0
IRN,BEL,2002.0,3,1,2
CAN,ETH,2000.0,1,2,-1
HUN,MEX,2016.0,3,1,2
AUT,ZAF,2016.0,5,4,1
PHL,CAN,1998.0,2,1,1
NLD,PHL,2006.0,3,1,2
PRT,UKR,2006.0,1,3,-2
AUT,JPN,2012.0,10,18,-8
CHE,IRL,1997.0,1,4,-3
USA,BOL,2023.0,2,1,1
BRA,AUT,2009.0,3,6,-3
DNK,KOR,2009.0,2,3,-1
IRL,HUN,2010.0,2,8,-6
SAU,IRN,2011.0,1,2,-1
AUT,ZAF,2018.0,4,7,-3
COL,FRA,2011.0,10,17,-7
BEL,SRB,2013.0,4,2,2
LVA,NOR,2021.0,1,1,0
HKG,SWE,2003.0,2,1,1
TUR,MEX,2014.0,2,1,1
HUN,ITA,2012.0,9,10,-1
SVK,CHE,2006.0,2,2,0
ROU,IRN,2016.0,1,2,-1
ZAF,ESP,2015.0,4,13,-9
PAN,ESP,2012.0,3,7,-4
HRV,BIH,2010.0,6,7,-1
HKG,EGY,2007.0,1,1,0
BRA,NLD,2008.0,14,15,-1
AUT,MNG,2018.0,1,1,0
LUX,NLD,2015.0,5,8,-3
ISR,JOR,2018.0,1,2,-1
CIV,NER,2015.0,1,1,0
LAO,THA,2011.0,4,3,1
GBR,SVN,2022.0,12,5,7
NZL,TUR,2016.0,1,2,-1
NLD,RWA,2022.0,4,3,1
BEL,ISR,2015.0,5,9,-4
JPN,IRQ,2019.0,1,2,-1
FRA,CRI,2013.0,2,3,-1
BLR,DEU,2011.0,4,4,0
IDN,BRN,2011.0,1,1,0
DNK,THA,2002.0,3,1,2
ESP,PRY,2006.0,1,1,0
POL,BRA,2016.0,2,2,0
RUS,TUR,2019.0,4,9,-5
SRB,SWE,2021.0,3,4,-1
IDN,VNM,2023.0,2,1,1
MNG,CHE,2017.0,2,1,1
TWN,FIN,2015.0,4,2,2
KOR,NOR,2016.0,2,5,-3
OMN,NLD,2017.0,1,2,-1
SGP,MAC,2020.0,3,1,2
LTU,UKR,2015.0,1,2,-1
USA,AZE,2023.0,4,1,3
LUX,NOR,2015.0,1,2,-1
ZAF,HKG,2014.0,1,1,0
NLD,ECU,2018.0,4,2,2
PRT,CHN,2001.0,3,8,-5
BRN,BFA,2016.0,4,1,3
UGA,BWA,2021.0,1,1,0
GMB,NGA,2015.0,4,1,3
NOR,KOR,2019.0,3,11,-8
SVK,FIN,2016.0,1,1,0
IDN,JPN,1999.0,7,11,-4
NLD,ETH,2015.0,4,6,-2
HND,ESP,2020.0,4,2,2
CAN,CUB,2004.0,2,1,1
ARE,ESP,2021.0,4,11,-7
SRB,BEL,2020.0,2,4,-2
ARG,SWE,2017.0,5,3,2
UZB,RUS,2016.0,5,9,-4
ROU,CHE,2019.0,10,8,2
ESP,TZA,2019.0,15,1,14
MYS,MMR,2013.0,3,2,1
ISL,CAN,2019.0,1,4,-3
PRT,KWT,2019.0,1,1,0
DZA,IRN,2014.0,1,1,0
SAU,NLD,2018.0,4,15,-11
USA,TUN,2006.0,3,4,-1
ROU,CHE,2021.0,4,11,-7
CHE,UKR,2019.0,1,4,-3
KHM,IND,2023.0,1,1,0
QAT,IRN,2022.0,4,2,2
KOR,KHM,2022.0,2,2,0
CHN,LAO,2020.0,1,1,0
SGP,ITA,2022.0,7,9,-2
LAO,JPN,2020.0,2,4,-2
GHA,HUN,2023.0,3,1,2
ARM,DNK,2022.0,1,1,0
MAR,SWE,2020.0,2,2,0
KOR,NGA,2022.0,1,4,-3
CAN,JAM,2020.0,3,5,-2
RWA,CAN,2016.0,1,2,-1
BEL,EGY,2020.0,8,3,5
ECU,MEX,2021.0,7,9,-2
MYS,DZA,2022.0,3,1,2
AUT,IND,2003.0,3,5,-2
DNK,SGP,2019.0,5,15,-10
SAU,MAR,2016.0,1,2,-1
ITA,SRB,2023.0,3,6,-3
NLD,IND,2009.0,11,32,-21
BRA,ROU,2022.0,2,1,1
JPN,DZA,2009.0,1,1,0
ISR,BRA,2022.0,3,7,-4
MNG,USA,2022.0,4,4,0
PER,CAN,2021.0,5,2,3
HND,BRA,2018.0,1,1,0
BEL,SVK,2002.0,2,4,-2
KEN,PHL,2019.0,1,1,0
CHN,POL,2014.0,2,3,-1
AUS,HRV,2002.0,3,1,2
SRB,SVN,2008.0,3,4,-1
IRL,HUN,2023.0,1,3,-2
ROU,CAN,2003.0,7,3,4
LTU,GBR,2001.0,4,1,3
GBR,CMR,2013.0,4,3,1
CHE,ARG,2010.0,4,6,-2
KWT,NGA,2019.0,1,1,0
FIN,HUN,1997.0,6,3,3
GHA,KEN,2002.0,1,1,0
UZB,IRN,2022.0,1,1,0
IND,POL,2009.0,1,3,-2
BRA,MEX,2002.0,7,6,1
IRL,ISR,2003.0,2,1,1
UZB,KGZ,2001.0,1,1,0
MEX,POL,2010.0,2,2,0
ESP,JPN,2000.0,7,9,-2
FRA,LBY,2005.0,1,1,0
BEL,CHN,2007.0,13,14,-1
ESP,PER,2004.0,5,1,4
SEN,CAN,2002.0,1,2,-1
GBR,LTU,1999.0,5,2,3
BWA,KEN,2014.0,2,4,-2
EGY,HUN,2000.0,1,2,-1
GEO,CHE,2000.0,1,1,0
FIN,FRA,2015.0,15,32,-17
FRA,BDI,2006.0,1,1,0
GBR,UZB,2015.0,4,2,2
ESP,AND,2003.0,1,3,-2
CZE,EST,2013.0,2,3,-1
ESP,EST,2011.0,3,2,1
BOL,USA,2014.0,4,3,1
LVA,DEU,2001.0,5,8,-3
MEX,KOR,1998.0,1,2,-1
HRV,SRB,2000.0,2,12,-10
SVK,USA,2015.0,10,19,-9
POL,ISR,2013.0,3,5,-2
ARE,SAU,2012.0,11,11,0
GEO,RUS,1999.0,4,12,-8
KOR,THA,2010.0,2,3,-1
OMN,TUR,2010.0,2,1,1
SEN,CIV,2003.0,1,1,0
IDN,FRA,2007.0,3,7,-4
CHN,PRI,2018.0,1,2,-1
ZAF,DEU,1997.0,4,10,-6
DEU,HRV,2021.0,11,20,-9
MYS,CHN,2002.0,2,4,-2
SWE,TWN,2003.0,1,2,-1
ZAF,CHE,1997.0,3,8,-5
USA,TZA,2008.0,5,10,-5
THA,CHN,2008.0,6,5,1
NZL,HKG,2003.0,2,4,-2
SGP,ARE,2015.0,7,1,6
EGY,TWN,2000.0,2,1,1
ZAF,HKG,2008.0,2,1,1
GHA,BFA,2013.0,2,2,0
JPN,OMN,2009.0,2,1,1
MUS,GBR,2001.0,1,1,0
MUS,AUS,2013.0,1,1,0
JOR,OMN,1998.0,3,2,1
MOZ,ZAF,2014.0,3,2,1
BWA,ZWE,2008.0,1,3,-2
TUN,ESP,2014.0,5,12,-7
DEU,RWA,2014.0,1,1,0
SGP,UKR,2004.0,1,1,0
CHN,BLR,2017.0,1,1,0
IRL,TWN,2021.0,1,1,0
CHL,ITA,2012.0,7,5,2
BRA,RUS,2010.0,7,1,6
KNA,CAN,2023.0,1,1,0
HRV,FRA,2011.0,4,4,0
IRL,NZL,2015.0,7,11,-4
TTO,IND,2018.0,1,1,0
ZAF,GAB,2011.0,3,1,2
LKA,USA,2005.0,10,10,0
DEU,EST,2013.0,9,2,7
HRV,SVN,2005.0,3,1,2
ZAF,JPN,2017.0,6,3,3
ROU,MDA,2014.0,2,2,0
USA,KHM,2008.0,6,1,5
CZE,ZAF,2019.0,2,2,0
AUT,THA,2011.0,4,7,-3
URY,MEX,2007.0,3,2,1
PAN,NLD,2014.0,1,1,0
BEL,ZAF,2011.0,5,10,-5
BEL,LVA,2013.0,1,1,0
LVA,NLD,2018.0,2,1,1
HRV,CAN,2008.0,1,2,-1
ESP,HRV,2011.0,1,2,-1
AUT,IDN,2014.0,5,1,4
BOL,MEX,2008.0,2,4,-2
KAZ,CHN,2020.0,6,5,1
JOR,MYS,2011.0,4,9,-5
ETH,CHE,2017.0,5,2,3
LBN,KWT,2017.0,3,1,2
GBR,SRB,1999.0,1,12,-11
FSM,USA,2011.0,1,2,-1
USA,KNA,2006.0,1,1,0
MEX,ITA,2000.0,3,1,2
GBR,VEN,2008.0,5,5,0
FIN,LTU,2012.0,1,2,-1
JPN,POL,2011.0,6,3,3
YEM,SAU,2009.0,1,1,0
SWE,ETH,2015.0,3,2,1
USA,MAR,2013.0,10,6,4
PRT,CAN,2000.0,1,4,-3
RUS,DNK,2014.0,5,5,0
MYS,CZE,2017.0,2,2,0
PRT,SWE,2023.0,7,7,0
SVK,ITA,2000.0,3,5,-2
AUS,SAU,2009.0,4,6,-2
VEN,CHL,2012.0,6,4,2
BGR,BEL,2016.0,6,4,2
NOR,POL,2004.0,2,1,1
DEU,BGD,2003.0,2,2,0
LTU,POL,2001.0,1,1,0
ARM,GBR,2018.0,3,1,2
CHE,ARG,2023.0,5,8,-3
ESP,ZAF,2010.0,7,3,4
HUN,ROU,2014.0,5,13,-8
DEU,ARM,2021.0,1,3,-2
NOR,CHE,2023.0,12,13,-1
HRV,MYS,2015.0,4,1,3
CZE,ISR,2016.0,4,1,3
ZAF,GMB,2014.0,1,1,0
MWI,KEN,2019.0,4,4,0
MAR,TUN,2022.0,1,2,-1
IRL,GRC,2022.0,5,5,0
MOZ,USA,2012.0,5,2,3
BEL,TUN,2018.0,6,3,3
FJI,NZL,2018.0,2,5,-3
ESP,GTM,2015.0,4,1,3
CHN,BEL,2024.0,3,1,2
DZA,BEL,2018.0,3,11,-8
GRC,TUR,2022.0,2,7,-5
GRC,NOR,2009.0,3,1,2
NOR,TZA,2001.0,5,1,4
DEU,ARM,2019.0,3,2,1
TWN,CHE,2002.0,2,3,-1
BGR,CAN,2008.0,3,2,1
QAT,EGY,2006.0,2,3,-1
DEU,COL,2001.0,1,9,-8
SVN,FRA,1999.0,1,3,-2
GMB,ZAF,2009.0,2,1,1
TUR,IND,2001.0,4,1,3
SGP,ARE,2001.0,1,1,0
ARE,SWE,2017.0,2,8,-6
USA,URY,1997.0,6,3,3
GBR,CYP,1999.0,5,2,3
KEN,JPN,1999.0,3,7,-4
ESP,AUT,2006.0,7,7,0
VEN,ESP,2005.0,19,22,-3
SWE,PRT,1999.0,2,4,-2
KOR,EGY,2014.0,6,3,3
POL,SRB,1997.0,1,1,0
THA,CHE,2002.0,3,2,1
ISL,FRA,2021.0,2,3,-1
BEL,ARG,2002.0,2,4,-2
ITA,HRV,2004.0,2,1,1
CRI,CAN,1998.0,2,1,1
USA,TZA,2001.0,6,4,2
LTU,DNK,2001.0,3,1,2
CHE,SRB,2010.0,2,4,-2
ESP,EGY,2003.0,2,4,-2
ETH,SWE,2001.0,4,6,-2
RUS,TUR,2011.0,2,2,0
BGR,ISR,2002.0,1,2,-1
FRA,HRV,1997.0,4,2,2
ARG,PRT,2008.0,1,1,0
NZL,RUS,2022.0,3,4,-1
BRA,ZAF,2002.0,2,1,1
ARG,IRL,2011.0,2,1,1
CHE,ZAF,2007.0,5,10,-5
SRB,BEL,1998.0,1,1,0
FRA,NZL,2009.0,10,13,-3
SWE,TWN,2013.0,2,1,1
GRC,IRL,2001.0,2,3,-1
SRB,AUT,2008.0,3,1,2
DEU,KWT,2021.0,1,1,0
ESP,IND,2010.0,13,18,-5
HRV,FRA,2019.0,8,6,2
CAN,GHA,2007.0,2,3,-1
KOR,VNM,2005.0,3,2,1
GBR,KAZ,2022.0,3,9,-6
USA,NPL,2008.0,10,8,2
LKA,ZAF,2013.0,1,1,0
GHA,FRA,2014.0,1,3,-2
CHE,CIV,2010.0,1,1,0
USA,IRN,2024.0,5,5,0
FIN,TZA,2011.0,2,1,1
SWE,SRB,2011.0,1,3,-2
NOR,SGP,2010.0,4,1,3
ESP,SGP,2014.0,6,4,2
SVN,AUS,2015.0,3,1,2
PER,GBR,2010.0,5,3,2
AUT,PRT,2019.0,4,4,0
FRA,KWT,2014.0,2,2,0
CYP,USA,2008.0,7,20,-13
PRT,IRL,2012.0,6,4,2
CHN,NZL,2001.0,2,1,1
DEU,MNG,2011.0,1,1,0
ESP,TUR,2004.0,3,2,1
PER,CHL,2008.0,2,6,-4
NLD,SGP,2005.0,3,5,-2
JPN,LKA,2002.0,5,5,0
THA,NPL,2013.0,6,1,5
MAR,CHE,2022.0,1,5,-4
SVK,DNK,2013.0,1,2,-1
PHL,CHN,2009.0,2,2,0
FIN,NGA,2007.0,1,1,0
ITA,LTU,2023.0,4,4,0
SRB,SWE,2019.0,6,3,3
PRY,BRA,2023.0,1,4,-3
FRA,EST,2017.0,4,6,-2
PRT,PRI,2011.0,2,1,1
EGY,ITA,2011.0,2,8,-6
UKR,JPN,2011.0,2,3,-1
ARE,NZL,2010.0,1,2,-1
IND,BRN,2012.0,2,1,1
CHE,BOL,2012.0,2,1,1
CHL,SWE,2013.0,5,1,4
SVN,FRA,2020.0,5,9,-4
BFA,CIV,2016.0,2,1,1
LTU,LVA,2019.0,2,2,0
USA,VIR,2019.0,4,13,-9
TUN,TUR,2022.0,2,1,1
AUT,PER,2023.0,1,2,-1
BIH,GBR,2020.0,2,2,0
FIN,EGY,2021.0,1,2,-1
BGD,NPL,2018.0,1,1,0
DEU,TZA,2018.0,6,2,4
PRT,TUN,2017.0,2,1,1
THA,KOR,2001.0,1,3,-2
GBR,JAM,2014.0,1,1,0
JAM,BHS,2019.0,1,1,0
KOR,ITA,2009.0,2,5,-3
SGP,ESP,2015.0,5,9,-4
LKA,HKG,2011.0,3,3,0
FRA,SYC,2015.0,2,1,1
KAZ,DEU,2002.0,1,2,-1
CAN,SVN,2015.0,3,1,2
SVN,CAN,2016.0,1,2,-1
BWA,USA,2013.0,5,6,-1
TWN,BEL,2017.0,1,4,-3
SVN,BIH,2006.0,3,1,2
SAU,SWE,2016.0,2,5,-3
NOR,CZE,2023.0,1,3,-2
AUS,SRB,1998.0,1,4,-3
LTU,BLR,2019.0,2,1,1
CHL,PER,2008.0,6,2,4
BGD,SGP,2013.0,1,4,-3
BFA,NGA,2014.0,2,2,0
FRA,LBY,2012.0,2,1,1
THA,BEL,2009.0,2,2,0
LTU,USA,2012.0,4,6,-2
HKG,RUS,2023.0,1,9,-8
DEU,LVA,2007.0,4,3,1
ISR,POL,2022.0,5,5,0
DZA,JPN,2014.0,2,1,1
IRN,GBR,2024.0,1,1,0
GBR,LTU,2007.0,3,9,-6
NOR,ISL,2013.0,3,6,-3
CAN,MAC,2014.0,3,1,2
ESP,PRI,1999.0,2,1,1
TWN,NLD,2018.0,6,6,0
IND,BTN,2013.0,1,1,0
LTU,CHE,2007.0,1,2,-1
ESP,ECU,2004.0,2,7,-5
SAU,NLD,2017.0,6,7,-1
IRQ,JOR,2012.0,4,6,-2
CIV,MLI,2020.0,2,2,0
MYS,PHL,2020.0,2,2,0
GHA,CHE,2016.0,2,1,1
TUR,KGZ,2020.0,4,4,0
GHA,TUR,2019.0,2,1,1
SGP,IRN,2018.0,3,11,-8
FIN,BRA,2020.0,2,27,-25
ETH,TWN,2021.0,4,13,-9
RUS,TWN,2022.0,2,1,1
YEM,EGY,2020.0,4,10,-6
KWT,IRL,2019.0,1,1,0
FIN,IRN,2019.0,4,29,-25
DNK,MYS,2018.0,3,4,-1
KAZ,KOR,2020.0,2,9,-7
CAN,EST,2011.0,5,2,3
ROU,LUX,2019.0,1,1,0
BLR,CZE,2022.0,1,1,0
NZL,NPL,2020.0,5,2,3
GRC,IRL,2008.0,4,5,-1
TUR,ISR,2014.0,5,3,2
JOR,TUR,2022.0,2,3,-1
BRB,USA,2023.0,3,2,1
SYR,CHN,2019.0,1,1,0
CAN,LUX,2023.0,1,5,-4
NPL,THA,2013.0,1,6,-5
MWI,SEN,2021.0,1,1,0
DZA,QAT,2023.0,1,1,0
BHR,KWT,2021.0,1,1,0
DNK,GNB,2021.0,2,1,1
TUR,SRB,2023.0,2,1,1
BRA,COL,1997.0,4,1,3
SYR,EGY,2021.0,4,2,2
IDN,HKG,2022.0,2,6,-4
BGD,KOR,2000.0,2,1,1
JPN,CMR,2022.0,2,1,1
CMR,SEN,2015.0,1,2,-1
GBR,BRN,2006.0,2,1,1
MKD,DEU,2007.0,2,2,0
POL,LTU,2002.0,2,2,0
LVA,DEU,2014.0,3,3,0
PRT,VEN,2004.0,1,1,0
TUR,NLD,2003.0,9,3,6
CUB,DEU,2008.0,2,4,-2
DNK,BRA,2000.0,4,2,2
GAB,FRA,2002.0,5,8,-3
BOL,USA,2008.0,2,6,-4
TWN,ESP,1998.0,1,2,-1
THA,HKG,2008.0,4,1,3
GBR,UZB,2001.0,1,2,-1
JAM,ZAF,2014.0,1,1,0
ETH,MEX,2005.0,1,1,0
MEX,PAN,2020.0,1,1,0
IND,LKA,2011.0,3,4,-1
UGA,AUS,2019.0,1,4,-3
BRA,POL,2013.0,4,2,2
PAN,ESP,2002.0,1,2,-1
GHA,COG,2015.0,2,2,0
SDN,USA,2001.0,2,1,1
PAK,ZAF,2000.0,2,1,1
KOR,LAO,2019.0,1,1,0
BEL,PRT,2005.0,4,2,2
HUN,IND,2015.0,2,4,-2
HRV,JPN,2001.0,1,2,-1
RUS,PRI,2000.0,1,1,0
ISR,GRC,2000.0,2,1,1
QAT,ARE,2004.0,2,2,0
ESP,TUR,2008.0,2,7,-5
SAU,FRA,2007.0,1,6,-5
JPN,FIN,2014.0,6,11,-5
ETH,AUT,2014.0,3,3,0
AZE,HUN,2021.0,3,1,2
EST,GRC,2023.0,1,2,-1
ARG,ISR,2002.0,1,5,-4
ISR,ARG,2003.0,2,2,0
MKD,TUR,2003.0,1,1,0
NLD,EST,2003.0,2,1,1
BGR,JPN,2021.0,1,6,-5
PRT,BEL,2008.0,6,5,1
ARG,NLD,2000.0,4,5,-1
NZL,AUT,2007.0,2,3,-1
BGR,PRT,1999.0,1,2,-1
NOR,HUN,2021.0,4,7,-3
COL,ESP,1997.0,3,7,-4
SDN,USA,2014.0,4,7,-3
GRC,FIN,2001.0,3,2,1
IRL,IND,2006.0,1,13,-12
COL,SWE,1999.0,2,1,1
GBR,BLR,2012.0,3,2,1
CZE,BEL,2023.0,9,7,2
CUB,CRI,2018.0,1,1,0
TWN,AUT,2015.0,2,1,1
TWN,MNG,2021.0,1,4,-3
MEX,URY,2015.0,5,1,4
DNK,BRA,2023.0,7,29,-22
AUT,VNM,2014.0,1,1,0
PHL,CHN,2011.0,3,5,-2
SRB,BIH,2010.0,4,7,-3
ZAF,SDN,2017.0,3,1,2
USA,LAO,2013.0,1,2,-1
LAO,USA,2014.0,6,2,4
CZE,BEL,2000.0,2,3,-1
BRA,LTU,2019.0,1,1,0
CHL,PRT,2017.0,5,3,2
BLR,DEU,2009.0,8,4,4
DNK,ARM,2016.0,2,1,1
CHN,CUB,2016.0,4,3,1
CAN,GRC,2023.0,4,5,-1
RUS,TWN,2017.0,1,3,-2
HND,USA,2018.0,3,3,0
CHE,EST,2012.0,3,6,-3
COL,ZAF,2019.0,2,2,0
PSE,MYS,2019.0,2,6,-4
BGR,GRC,2016.0,2,3,-1
ESP,SRB,2016.0,4,4,0
ISR,JPN,1997.0,7,3,4
BGR,FIN,2016.0,1,1,0
KOR,THA,2023.0,9,4,5
RUS,JOR,2021.0,2,1,1
FRA,SYC,2014.0,2,2,0
ECU,PER,2019.0,2,12,-10
NOR,PSE,2021.0,1,1,0
NOR,HKG,2022.0,2,4,-2
DEU,PHL,2020.0,5,8,-3
PRT,PAK,2023.0,2,4,-2
MDA,DEU,2015.0,1,3,-2
KHM,JPN,2018.0,2,4,-2
CHE,QAT,2018.0,2,3,-1
MWI,NLD,2020.0,1,2,-1
HKG,DNK,2022.0,2,6,-4
OMN,GBR,2012.0,6,10,-4
AUT,KOR,2004.0,2,3,-1
MWI,ZAF,2022.0,9,15,-6
SAU,SGP,2016.0,3,8,-5
SWE,LTU,2023.0,3,3,0
IRL,LUX,2021.0,4,2,2
PER,ARG,2020.0,3,6,-3
CHL,CZE,2018.0,2,1,1
PAK,GHA,2022.0,1,1,0
TGO,SEN,2022.0,1,2,-1
JPN,JOR,2019.0,1,3,-2
CHN,HUN,2015.0,1,4,-3
GHA,TWN,2021.0,1,1,0
AUT,MEX,2021.0,1,5,-4
KHM,USA,2007.0,1,1,0
FRA,TGO,2013.0,4,3,1
PAK,DNK,2009.0,2,2,0
CRI,CAN,2007.0,3,1,2
SWE,ETH,2008.0,5,1,4
KWT,AUS,2010.0,1,3,-2
ITA,BFA,2006.0,2,1,1
CZE,PRT,2011.0,1,3,-2
TUR,NZL,2020.0,8,4,4
HRV,BEL,2014.0,3,1,2
BIH,AUT,2013.0,1,4,-3
NER,FRA,2001.0,5,3,2
SVK,HUN,2019.0,10,9,1
NGA,GMB,2012.0,2,1,1
AUT,TUR,2002.0,4,4,0
HUN,ROU,2015.0,10,21,-11
ESP,MCO,2009.0,1,1,0
MNG,DEU,2005.0,1,1,0
TUN,DEU,2003.0,1,1,0
NZL,MEX,2017.0,4,8,-4
CUB,CHN,2021.0,4,1,3
SAU,JPN,2014.0,3,19,-16
BEL,FIN,2016.0,7,5,2
JPN,KHM,2016.0,2,2,0
MAR,TUN,2021.0,4,1,3
KOR,ARE,2014.0,6,3,3
DNK,ESP,2011.0,14,14,0
KAZ,FRA,2011.0,1,2,-1
GBR,MLT,2013.0,5,7,-2
LBY,GBR,2018.0,2,20,-18
USA,BRB,2018.0,5,6,-1
MYS,LBY,2023.0,3,3,0
NLD,NZL,2011.0,14,13,1
BEL,EGY,2008.0,4,3,1
VEN,DOM,2021.0,1,1,0
DNK,MEX,2006.0,2,3,-1
AUT,CZE,2014.0,16,8,8
RWA,BEL,2014.0,2,1,1
JPN,TUN,2014.0,4,1,3
CYP,USA,2020.0,10,20,-10
SRB,FRA,2013.0,6,8,-2
AUT,SVK,2023.0,10,2,8
COL,CRI,2017.0,2,1,1
LTU,RUS,2012.0,2,1,1
NOR,ETH,2015.0,3,5,-2
AUS,BRN,2020.0,4,2,2
HKG,IND,2017.0,10,17,-7
AUS,LTU,2013.0,2,2,0
JOR,EGY,2018.0,3,1,2
MAR,PRT,2014.0,1,1,0
KHM,SWE,2019.0,1,2,-1
GEO,ITA,2011.0,2,1,1
MLI,NER,2015.0,1,1,0
BEN,KEN,2010.0,1,1,0
ARE,CHE,2013.0,1,1,0
TWN,KOR,2003.0,3,8,-5
HKG,CHE,2006.0,2,6,-4
MOZ,ZAF,2020.0,4,6,-2
IRL,CHN,2005.0,2,7,-5
SGP,NLD,2004.0,3,3,0
CHE,PHL,1998.0,2,1,1
NPL,NOR,2017.0,2,7,-5
DZA,ESP,2016.0,4,7,-3
VNM,PHL,2021.0,3,3,0
CUB,CHN,2016.0,3,4,-1
CHN,CUB,2019.0,4,1,3
NGA,NOR,2015.0,2,2,0
KEN,GHA,2018.0,6,2,4
BGD,HKG,2018.0,4,3,1
HKG,BGD,2019.0,2,3,-1
ITA,EST,2014.0,7,3,4
ALB,DEU,2014.0,1,1,0
CHN,ZAF,2017.0,6,15,-9
NZL,JPN,2014.0,7,10,-3
QAT,GBR,2014.0,6,33,-27
CRI,COL,2014.0,2,3,-1
BEL,ETH,2015.0,5,6,-1
SAU,SWE,2021.0,8,12,-4
RUS,EGY,2019.0,9,9,0
BFA,NER,2023.0,1,1,0
PAN,GBR,2019.0,1,6,-5
TUR,MYS,2020.0,3,15,-12
ROU,DZA,2021.0,1,1,0
HUN,POL,2018.0,2,3,-1
SWE,NGA,2020.0,2,1,1
BGD,NOR,2022.0,3,1,2
ESP,PAN,2022.0,7,4,3
PAK,ESP,2019.0,5,10,-5
THA,NGA,2021.0,6,5,1
ARM,CHE,2016.0,1,1,0
ITA,IDN,2020.0,4,1,3
IRQ,OMN,2019.0,1,1,0
GBR,EST,2012.0,8,8,0
HUN,MEX,2021.0,2,4,-2
SGP,AUT,2018.0,4,4,0
JPN,POL,2022.0,11,6,5
RUS,SRB,2023.0,6,1,5
SEN,ZAF,2017.0,5,7,-2
MYS,BEL,2022.0,5,2,3
BFA,GIN,2013.0,2,1,1
HUN,SVK,2008.0,2,1,1
FRA,MOZ,2004.0,1,1,0
ETH,NLD,2020.0,9,17,-8
ITA,MYS,2019.0,3,1,2
GBR,RWA,2020.0,2,7,-5
PER,CHL,2020.0,4,14,-10
SAU,IRN,2018.0,1,1,0
FRA,GUF,2001.0,8,4,4
CAN,IDN,2022.0,4,6,-2
UZB,KAZ,2015.0,4,3,1
GBR,PER,2014.0,2,6,-4
GTM,CHE,2018.0,1,2,-1
SDN,ETH,2011.0,1,1,0
ARE,CAN,2005.0,5,8,-3
FRA,SGP,2000.0,3,2,1
IDN,USA,2023.0,15,15,0
SWE,CHL,2009.0,3,2,1
LVA,IND,2022.0,1,2,-1
JOR,IND,2021.0,2,3,-1
PAK,JPN,2008.0,6,12,-6
BIH,TUR,2017.0,1,5,-4
DEU,BOL,2017.0,1,1,0
ZAF,IRN,2019.0,1,12,-11
BHR,IND,2022.0,2,6,-4
PAK,BEL,2016.0,5,1,4
BGD,SWE,2017.0,6,3,3
USA,BLZ,2022.0,2,4,-2
CZE,NZL,2022.0,2,4,-2
VNM,MYS,2020.0,5,18,-13
HKG,SRB,2001.0,1,1,0
ISR,RUS,2010.0,7,8,-1
ITA,TWN,2011.0,5,2,3
DEU,NOR,1997.0,8,17,-9
SAU,KWT,2001.0,2,2,0
UGA,JPN,2010.0,1,1,0
EGY,IND,1998.0,2,1,1
BLR,SWE,2003.0,1,1,0
BEL,IND,2000.0,4,7,-3
USA,ZWE,2007.0,4,14,-10
NCL,FRA,2004.0,10,18,-8
MEX,CUB,2004.0,11,19,-8
THA,ARG,2021.0,1,2,-1
TUR,NOR,2011.0,3,2,1
FRA,FIN,2003.0,8,8,0
IRL,POL,2004.0,1,3,-2
JPN,NOR,2000.0,3,1,2
LIE,DEU,2014.0,1,2,-1
SAU,KWT,2008.0,1,2,-1
AUS,EGY,2001.0,1,2,-1
JPN,UKR,2013.0,2,5,-3
ZAF,NGA,1999.0,2,6,-4
LBN,EGY,2006.0,2,1,1
CAN,KOR,1997.0,10,4,6
NGA,KEN,2018.0,2,3,-1
ESP,UKR,2010.0,2,5,-3
RUS,DNK,1999.0,9,4,5
DEU,MYS,1997.0,1,5,-4
MYS,DEU,1998.0,1,1,0
SWE,SVN,2007.0,2,1,1
SVN,AUT,1997.0,3,3,0
DEU,LKA,2007.0,2,1,1
CAN,PHL,1999.0,3,2,1
NER,FRA,2007.0,2,4,-2
THA,SWE,2000.0,2,3,-1
RUS,KOR,1997.0,6,6,0
GBR,CHL,2000.0,6,6,0
FRA,MDG,2000.0,6,9,-3
IRL,SGP,2004.0,1,1,0
UGA,CHE,2002.0,2,1,1
MDG,SEN,2002.0,2,6,-4
DEU,LIE,2006.0,2,1,1
POL,JPN,1998.0,9,8,1
TZA,KEN,2005.0,5,4,1
NGA,ETH,2005.0,2,2,0
CZE,AUT,1999.0,4,9,-5
LVA,USA,1998.0,4,3,1
HTI,FRA,2007.0,2,1,1
SVK,RUS,2000.0,5,5,0
TZA,SWE,2009.0,3,5,-2
CHL,CAN,1997.0,2,2,0
FRA,UGA,2005.0,1,2,-1
IDN,FRA,2001.0,5,3,2
CRI,FRA,2000.0,1,1,0
IRL,DEU,2000.0,11,12,-1
ISR,ARG,1997.0,3,5,-2
KEN,CHE,1999.0,2,2,0
TJK,RUS,1997.0,1,1,0
ARG,BEL,2003.0,5,1,4
DEU,PER,2022.0,4,6,-2
BEL,IRL,1999.0,3,1,2
AUS,MEX,2003.0,8,1,7
SAU,JOR,2010.0,7,34,-27
LKA,JPN,2001.0,2,4,-2
GBR,URY,1997.0,3,1,2
UKR,SWE,2006.0,1,3,-2
GRL,DNK,1997.0,1,1,0
UKR,FRA,2008.0,11,7,4
GRC,ROU,2010.0,3,4,-1
QAT,ARE,2020.0,6,6,0
USA,LTU,2016.0,7,4,3
FRA,SRB,2008.0,3,5,-2
ARE,JOR,1998.0,3,3,0
VEN,PRI,2006.0,2,1,1
ESP,IRL,2000.0,3,4,-1
CZE,NLD,1999.0,3,7,-4
NLD,CZE,2002.0,2,9,-7
NLD,MWI,2006.0,1,1,0
FRA,AGO,2014.0,1,1,0
RUS,ARM,2006.0,3,2,1
PRI,ARG,2011.0,2,2,0
FJI,AUS,2005.0,4,4,0
GBR,ETH,2007.0,4,4,0
TUR,AUT,2022.0,3,4,-1
FIN,OMN,2015.0,1,1,0
LBN,ARE,2010.0,2,2,0
NLD,UKR,2010.0,2,5,-3
BLR,FRA,2001.0,4,2,2
BOL,ECU,2022.0,2,1,1
ARG,AUT,2009.0,1,1,0
IND,ARE,2008.0,4,5,-1
ROU,SWE,2007.0,1,1,0
POL,IRQ,2017.0,3,2,1
ARM,USA,2014.0,6,9,-3
KHM,BEL,2010.0,1,1,0
KWT,SAU,2015.0,4,4,0
VNM,IND,2020.0,7,10,-3
MEX,BEL,2009.0,3,6,-3
EGY,FIN,2016.0,3,5,-2
PRT,SAU,2023.0,2,1,1
CHL,CUB,2010.0,3,13,-10
USA,LVA,2001.0,3,3,0
ROU,ESP,2008.0,2,8,-6
PAK,NZL,2021.0,5,3,2
ARG,ARE,2020.0,1,1,0
SAU,SVK,2018.0,1,1,0
MYS,HKG,2010.0,3,5,-2
AUT,THA,2018.0,5,3,2
CHL,NZL,2021.0,3,3,0
ZMB,CHE,2006.0,1,1,0
JPN,MEX,2017.0,5,14,-9
MNG,USA,2011.0,2,4,-2
VNM,IDN,2019.0,2,3,-1
MLI,USA,2012.0,3,2,1
DNK,CZE,2010.0,2,2,0
DNK,KEN,2016.0,3,2,1
DNK,KEN,2018.0,4,1,3
BEL,CUB,2017.0,1,7,-6
COL,AUS,2012.0,6,4,2
KEN,TZA,2015.0,9,6,3
KOR,ITA,2017.0,5,17,-12
USA,BFA,2023.0,2,5,-3
FRA,COD,2019.0,7,1,6
FIN,POL,2005.0,4,1,3
ISR,EGY,2007.0,1,1,0
NLD,TWN,2017.0,4,5,-1
VNM,DNK,2011.0,2,1,1
BRA,LTU,2018.0,1,1,0
KOR,OMN,2023.0,3,2,1
FRA,NER,2014.0,4,8,-4
TUR,ZAF,2010.0,3,2,1
POL,IDN,2021.0,1,4,-3
HND,USA,2011.0,2,5,-3
CAN,MAR,2017.0,15,6,9
QAT,CUB,2021.0,1,1,0
NOR,ETH,2008.0,7,2,5
AUS,VUT,2014.0,2,1,1
CHE,HUN,2020.0,11,14,-3
ROU,SAU,2013.0,1,1,0
ROU,ISR,2015.0,2,1,1
FRA,LTU,2016.0,1,3,-2
NZL,ITA,2014.0,4,8,-4
DEU,LVA,2014.0,3,3,0
DEU,JOR,2004.0,3,3,0
ESP,CZE,2006.0,5,3,2
JPN,SVN,2013.0,1,2,-1
ARE,ESP,2018.0,2,10,-8
ESP,GRC,1998.0,3,1,2
FIN,LUX,2015.0,2,3,-1
ARG,CZE,2019.0,4,2,2
NPL,DEU,2012.0,3,2,1
CHL,NLD,2006.0,2,2,0
NLD,CRI,2020.0,6,3,3
HUN,ESP,2000.0,2,3,-1
BEL,BGD,2018.0,5,7,-2
KEN,CHE,2020.0,6,12,-6
CHN,MNG,2021.0,6,14,-8
SEN,GBR,2017.0,1,4,-3
TTO,GBR,2017.0,4,9,-5
AZE,RUS,2011.0,5,4,1
LBY,LBN,2015.0,6,2,4
URY,ARG,2018.0,5,12,-7
ISR,BRA,2019.0,2,13,-11
AUS,ISL,2022.0,2,3,-1
ISL,AUS,2023.0,2,1,1
COG,FRA,2006.0,4,7,-3
GRL,DNK,2012.0,4,3,1
RUS,BEL,2004.0,10,9,1
SEN,MLI,2007.0,2,1,1
AUT,PRT,2017.0,5,14,-9
DNK,AUT,2010.0,3,11,-8
LBY,EGY,2015.0,5,4,1
GRC,PRT,2019.0,3,3,0
CYP,USA,2007.0,7,17,-10
PRT,SGP,2010.0,1,1,0
CAF,FRA,2004.0,1,4,-3
BRA,URY,1998.0,3,2,1
DEU,MKD,1997.0,1,1,0
BRA,MOZ,2019.0,6,8,-2
FRA,URY,2016.0,8,4,4
EST,FRA,2000.0,3,5,-2
NCL,FRA,2008.0,11,22,-11
CHN,THA,2004.0,3,3,0
GRC,PRT,2021.0,3,3,0
SAU,FRA,2004.0,3,7,-4
IRN,VNM,2022.0,2,11,-9
PRT,MEX,2022.0,3,2,1
TWN,ESP,2008.0,2,2,0
TUR,PRT,2022.0,6,1,5
TWN,MWI,2018.0,2,1,1
COD,ZMB,2019.0,1,1,0
RUS,HKG,2001.0,3,2,1
CHE,IRN,2009.0,2,7,-5
NOR,BGR,2000.0,2,1,1
BGR,FRA,2023.0,2,1,1
ECU,DEU,2004.0,4,1,3
TUR,KOR,2006.0,2,1,1
AUT,SVN,2005.0,3,2,1
CUB,DEU,2007.0,2,1,1
AUT,IND,2002.0,5,1,4
VNM,RUS,2013.0,5,10,-5
GRC,ZAF,2000.0,3,3,0
VNM,BEL,2004.0,3,2,1
VNM,BEL,2008.0,2,5,-3
KWT,DEU,2003.0,3,3,0
TUR,ITA,2002.0,8,7,1
JPN,ZAF,2002.0,3,1,2
NIC,SWE,2008.0,2,2,0
ITA,HKG,2004.0,1,1,0
CUB,BRA,1998.0,3,1,2
FJI,NZL,2019.0,2,5,-3
ESP,EGY,2005.0,6,2,4
ISL,GBR,2002.0,7,16,-9
GRL,CAN,2023.0,1,1,0
VEN,CAN,2002.0,2,5,-3
ZAF,MWI,1998.0,3,1,2
IRL,RUS,2004.0,1,6,-5
ECU,SWE,2018.0,3,1,2
FIN,RUS,2010.0,10,34,-24
BEL,ROU,2006.0,3,7,-4
IND,IRL,2004.0,6,2,4
SWE,UKR,2000.0,3,5,-2
GRC,ROU,2000.0,2,5,-3
VNM,COL,2010.0,1,1,0
ISR,BRA,2009.0,4,3,1
GBR,GMB,1997.0,3,7,-4
VNM,AUS,2009.0,4,7,-3
MAR,ITA,2008.0,1,1,0
RUS,PRT,1998.0,3,2,1
AUS,FLK,2002.0,1,1,0
PER,CHE,2015.0,2,3,-1
SAU,ZAF,2001.0,3,5,-2
ISR,IRL,2013.0,5,5,0
CHL,ITA,2003.0,5,6,-1
KOR,DNK,2008.0,2,1,1
GMB,USA,1999.0,1,2,-1
SGP,TWN,1999.0,2,4,-2
NOR,ESP,2018.0,12,28,-16
CHE,PHL,2007.0,1,2,-1
GBR,GEO,2014.0,2,2,0
PHL,DEU,2017.0,7,6,1
NER,DEU,2009.0,1,1,0
NGA,DEU,2010.0,8,6,2
MEX,DNK,2012.0,3,3,0
HRV,DEU,2011.0,10,9,1
CHL,CZE,2019.0,5,2,3
USA,MWI,1998.0,3,2,1
TTO,GBR,2018.0,2,1,1
NGA,JPN,2020.0,9,5,4
CZE,ZAF,2016.0,4,1,3
KOR,CHN,1997.0,3,9,-6
FRA,BGR,2013.0,8,3,5
SVN,ESP,2012.0,4,5,-1
ARE,JPN,2015.0,1,2,-1
LTU,IND,2019.0,1,1,0
HUN,KEN,2022.0,3,1,2
KEN,HUN,2023.0,4,2,2
LBN,QAT,2020.0,3,1,2
TZA,GBR,2017.0,12,13,-1
CHE,COG,2022.0,5,3,2
FRA,HKG,2012.0,4,7,-3
NZL,SAU,2016.0,3,3,0
YEM,SAU,2016.0,7,3,4
SVN,SRB,2013.0,6,3,3
SGP,FRA,2000.0,2,3,-1
KOR,BEL,2008.0,5,2,3
MAC,GBR,2019.0,5,5,0
HKG,ITA,2021.0,1,8,-7
SGP,ESP,2007.0,2,1,1
NLD,ECU,2011.0,2,1,1
ARE,KAZ,2022.0,5,1,4
CHN,IRQ,2011.0,2,2,0
IRQ,JPN,2020.0,1,1,0
NPL,SWE,2011.0,1,1,0
BLR,USA,2010.0,2,4,-2
TWN,NLD,2011.0,8,2,6
KOR,CHE,1999.0,1,2,-1
SRB,SWE,2017.0,2,2,0
GBR,SYC,2009.0,2,1,1
IND,SVN,2013.0,3,2,1
MOZ,PRT,2012.0,1,1,0
MEX,CRI,2015.0,2,5,-3
NLD,UKR,2006.0,1,5,-4
FJI,IND,2004.0,2,3,-1
TZA,DEU,2017.0,6,4,2
HRV,DNK,2020.0,3,3,0
TWN,PRT,2020.0,1,1,0
CMR,DEU,2016.0,5,3,2
IND,EST,2013.0,1,1,0
CZE,BIH,2014.0,1,1,0
KEN,NLD,2023.0,6,10,-4
TWN,FIN,2020.0,2,2,0
EGY,IND,2020.0,5,10,-5
IND,UGA,2021.0,1,1,0
CHN,ESP,2010.0,14,17,-3
MLI,BEN,2019.0,1,1,0
LKA,JPN,2015.0,3,17,-14
MDV,GBR,2018.0,2,3,-1
CZE,BRA,2022.0,7,14,-7
ARE,KAZ,2018.0,2,2,0
BRN,SGP,2018.0,2,1,1
GIN,DEU,2017.0,2,4,-2
USA,MDA,2019.0,6,6,0
MMR,USA,2016.0,8,2,6
EGY,SDN,2015.0,1,1,0
IND,BEL,2004.0,8,2,6
PAK,KOR,2005.0,2,2,0
NLD,HRV,2003.0,2,1,1
ARE,ETH,2021.0,1,1,0
ESP,TZA,2017.0,2,2,0
LVA,EST,2018.0,3,3,0
DEU,CYP,2022.0,8,8,0
TZA,NLD,1997.0,1,1,0
CHE,TZA,1999.0,2,2,0
PAK,PRT,2022.0,2,3,-1
ETH,KOR,2019.0,4,15,-11
JPN,MNG,2023.0,6,3,3
KOR,LUX,2017.0,2,1,1
MWI,KEN,2017.0,1,3,-2
KEN,MWI,2021.0,1,2,-1
BWA,NGA,2011.0,1,1,0
BEL,CZE,2019.0,9,10,-1
GRC,JOR,2020.0,2,1,1
POL,IRL,2022.0,2,4,-2
PAK,CHE,2002.0,2,1,1
USA,NIC,2019.0,2,5,-3
JOR,TUR,2021.0,5,3,2
SEN,COG,2023.0,2,1,1
LUX,FIN,2020.0,1,1,0
FJI,USA,2004.0,1,1,0
PRT,TUN,2021.0,2,4,-2
BGR,CHN,2019.0,2,2,0
IND,LBY,2012.0,2,12,-10
ITA,PSE,2022.0,6,2,4
SWE,GRC,2008.0,8,6,2
NZL,FRA,1999.0,5,3,2
PAK,AUT,2016.0,5,14,-9
RUS,EGY,2009.0,2,1,1
LSO,USA,2022.0,1,8,-7
DEU,BWA,2015.0,3,2,1
DEU,BGD,2002.0,2,1,1
SOM,GBR,2022.0,2,1,1
QAT,NOR,2018.0,2,2,0
USA,SEN,2022.0,9,4,5
CHE,MAR,2002.0,1,1,0
POL,CHN,2012.0,4,5,-1
IRN,BEL,2003.0,2,2,0
DEU,ALB,2017.0,4,2,2
NLD,LUX,2006.0,2,1,1
AUS,PAK,2001.0,4,2,2
AUT,MEX,2017.0,2,5,-3
MAR,MAC,2012.0,6,10,-4
SGP,ISR,2009.0,4,4,0
DNK,EST,2008.0,2,2,0
PAN,USA,2005.0,11,16,-5
CHE,BRA,2008.0,8,7,1
AUS,PHL,2005.0,8,4,4
ITA,CMR,2012.0,2,5,-3
CYP,GRC,2007.0,6,20,-14
TUR,CHE,2000.0,4,6,-2
SAU,MAR,2019.0,4,4,0
GHA,CAN,1999.0,5,1,4
COG,NGA,2018.0,2,1,1
KEN,GMB,2015.0,1,1,0
CAN,EST,2018.0,2,4,-2
JPN,GHA,2010.0,3,2,1
LBY,LBN,2004.0,3,3,0
USA,MWI,1999.0,2,1,1
ITA,THA,2023.0,1,2,-1
NOR,UGA,2007.0,3,2,1
KAZ,TUR,2001.0,1,1,0
AUT,ARG,2004.0,1,1,0
NLD,HKG,2005.0,2,1,1
GEO,NLD,2001.0,1,1,0
CIV,BEL,2017.0,5,4,1
BLR,FRA,2004.0,3,2,1
FRA,BLR,2006.0,3,2,1
AZE,RUS,2021.0,4,4,0
ZAF,ETH,2003.0,4,4,0
KWT,JOR,2021.0,9,7,2
MAR,USA,2011.0,2,5,-3
DNK,ITA,2003.0,11,13,-2
ISL,DNK,1999.0,4,2,2
AUS,PHL,1997.0,2,4,-2
MWI,NLD,2001.0,2,1,1
PRI,CHN,2016.0,2,3,-1
RUS,BGR,2006.0,3,1,2
PAK,IND,2001.0,3,4,-1
IND,CHN,2002.0,6,3,3
GBR,CRI,2011.0,3,3,0
CHE,BRA,2001.0,4,5,-1
HKG,JPN,2002.0,10,8,2
CHN,NZL,1998.0,2,1,1
TWN,HKG,1997.0,1,5,-4
SGP,ITA,2011.0,2,6,-4
AUT,JPN,2003.0,7,18,-11
CHE,CHN,1997.0,3,4,-1
NZL,BRA,2002.0,3,1,2
SGP,IRL,2023.0,2,3,-1
USA,MUS,2009.0,2,1,1
THA,CHN,1999.0,1,1,0
SVK,RUS,2010.0,6,4,2
RUS,GEO,2007.0,5,6,-1
GEO,RUS,2008.0,4,3,1
ZAF,NZL,2017.0,10,8,2
ZMB,USA,2006.0,2,5,-3
ESP,POL,2005.0,5,15,-10
SYR,CAN,1998.0,1,1,0
THA,NZL,2007.0,1,5,-4
MLT,GBR,2009.0,6,7,-1
BLR,CHN,2016.0,1,1,0
PHL,CHN,2016.0,4,1,3
HKG,DNK,2009.0,1,1,0
BRN,SGP,2016.0,2,2,0
THA,DNK,2009.0,3,2,1
BFA,CAN,2008.0,1,1,0
AUS,BLR,2016.0,1,1,0
ZAF,UGA,2010.0,9,7,2
GIN,SEN,2015.0,7,1,6
COG,ZWE,2008.0,2,2,0
GBR,SYR,2021.0,5,5,0
BGR,CAN,2007.0,5,2,3
AUT,IRN,2008.0,1,5,-4
ARE,JPN,2004.0,1,1,0
GBR,PER,2008.0,4,5,-1
SVK,GRC,2009.0,1,3,-2
ARE,EGY,2015.0,9,18,-9
EGY,NLD,2006.0,1,3,-2
SEN,ZAF,2018.0,1,5,-4
ITA,VNM,2008.0,2,1,1
SWE,LVA,2014.0,3,4,-1
GRC,ROU,2006.0,3,5,-2
BEN,ITA,2009.0,1,1,0
CHN,MEX,2010.0,2,5,-3
JPN,ARG,1999.0,3,5,-2
ITA,PER,2019.0,2,2,0
SWE,HKG,2010.0,3,2,1
RUS,PRT,2007.0,11,2,9
PYF,USA,2014.0,3,1,2
CAN,ROU,2014.0,3,5,-2
USA,GUM,1999.0,3,7,-4
BRA,SGP,2014.0,2,3,-1
NOR,HUN,2017.0,3,7,-4
ITA,CHL,2013.0,18,4,14
EGY,GRC,2012.0,1,3,-2
ESP,SGP,2007.0,1,2,-1
MDA,USA,2016.0,1,5,-4
CUB,CHE,2000.0,3,1,2
BEL,ISR,1999.0,6,5,1
TWN,AUS,2000.0,3,7,-4
COL,CHL,2003.0,3,2,1
SVN,CHE,2001.0,1,3,-2
ISL,ISR,2012.0,4,1,3
BGR,SRB,2002.0,1,1,0
NZL,ESP,2013.0,7,5,2
ISL,CHE,2009.0,1,1,0
BEL,HRV,2014.0,1,3,-2
IND,NZL,2016.0,9,12,-3
GAB,BEL,2012.0,2,1,1
SRB,POL,2005.0,4,1,3
POL,LTU,2003.0,6,7,-1
ARM,DEU,2017.0,4,3,1
NIC,USA,2020.0,2,1,1
GNQ,GIN,2018.0,8,5,3
GIN,CHE,2022.0,2,4,-2
PAK,DNK,2018.0,4,6,-2
EGY,SWE,2023.0,5,3,2
CAN,TGO,2021.0,1,1,0
LKA,THA,2018.0,3,4,-1
THA,LKA,2019.0,3,1,2
SYC,GBR,2021.0,2,3,-1
SWE,CHL,2021.0,1,6,-5
BLR,CHN,2018.0,3,2,1
CHL,CZE,2021.0,3,1,2
MAC,IND,2018.0,1,3,-2
POL,IRQ,2018.0,2,5,-3
RUS,TWN,2021.0,2,7,-5
FRA,MAC,2017.0,1,1,0
KOR,IND,2024.0,7,11,-4
PER,JPN,2014.0,2,3,-1
CHN,MMR,2023.0,3,3,0
LIE,AUT,2020.0,1,2,-1
UKR,AUT,2012.0,1,3,-2
VNM,CAN,2000.0,1,1,0
BEL,NGA,2015.0,3,1,2
ESP,HUN,1997.0,1,1,0
USA,ZWE,1999.0,6,8,-2
DEU,IRN,1997.0,1,2,-1
GBR,LVA,2002.0,4,3,1
DEU,SAU,1998.0,3,1,2
CZE,POL,2002.0,2,3,-1
CMR,ITA,2008.0,1,1,0
ISR,ARG,2002.0,5,1,4
SWE,ARE,2006.0,2,3,-1
ZAF,ITA,2003.0,3,4,-1
GAB,FRA,2003.0,7,2,5
FRA,SVN,2001.0,2,2,0
CHN,PHL,2010.0,3,3,0
SAU,AUT,2009.0,1,2,-1
GRC,ALB,1999.0,1,1,0
POL,ISR,1997.0,3,3,0
JOR,SAU,2005.0,4,2,2
SAU,JOR,2006.0,5,7,-2
GRC,SWE,2001.0,4,8,-4
NLD,THA,2010.0,5,6,-1
AUT,HRV,1997.0,1,3,-2
NLD,ROU,1998.0,2,5,-3
DNK,UGA,2002.0,1,2,-1
CZE,DNK,2006.0,2,3,-1
CAN,LBN,1997.0,4,1,3
PRT,NOR,1999.0,1,1,0
OMN,EGY,2001.0,2,3,-1
ITA,HRV,2007.0,3,1,2
HRV,ESP,2003.0,3,1,2
UKR,ITA,2009.0,4,2,2
LKA,SGP,2003.0,1,1,0
MEX,SVN,2012.0,2,1,1
TUR,RUS,2010.0,2,1,1
PAK,JPN,2001.0,2,5,-3
USA,CMR,2022.0,8,9,-1
USA,KHM,2020.0,7,10,-3
CZE,ROU,2012.0,2,1,1
TWN,RUS,2022.0,1,2,-1
RUS,NZL,2007.0,2,1,1
MEX,PRT,2010.0,11,5,6
SAU,IND,2008.0,5,22,-17
NOR,CAN,2007.0,5,12,-7
CRI,DEU,1999.0,2,1,1
MLT,USA,2008.0,2,2,0
CUB,CHL,2014.0,7,3,4
DEU,CUB,2006.0,5,3,2
BRA,UZB,1999.0,2,1,1
KOR,CZE,2016.0,3,2,1
KWT,QAT,2023.0,3,1,2
MOZ,USA,2013.0,4,4,0
ETH,CAN,2004.0,1,2,-1
ZWE,BWA,2000.0,2,1,1
CAN,GHA,2014.0,5,6,-1
PAK,NLD,2014.0,7,20,-13
IRN,SAU,2022.0,2,2,0
NLD,SAU,2008.0,3,1,2
SLE,CHN,2018.0,2,1,1
SEN,JPN,2013.0,1,2,-1
THA,CAN,2003.0,5,13,-8
BEL,BEN,2007.0,2,2,0
GBR,BWA,2007.0,1,2,-1
BEL,PER,2013.0,3,4,-1
NLD,LUX,2023.0,7,4,3
BFA,CIV,2011.0,1,2,-1
SAU,MAR,2011.0,3,6,-3
JAM,GBR,2001.0,1,6,-5
BOL,ECU,2018.0,4,1,3
ARG,CRI,2012.0,2,1,1
CRI,FRA,2023.0,4,2,2
AUS,ROU,2007.0,2,2,0
GBR,SDN,2013.0,5,5,0
VNM,BEL,2015.0,6,17,-11
CZE,UKR,2013.0,2,13,-11
TUR,PRT,2016.0,1,2,-1
ISR,HUN,2018.0,1,4,-3
CHE,ROU,1997.0,2,1,1
CZE,FIN,2015.0,4,5,-1
MYS,DNK,2002.0,1,2,-1
SGP,SWE,2022.0,6,7,-1
MMR,KOR,2020.0,2,2,0
DEU,NAM,2017.0,1,1,0
MAR,GBR,2013.0,1,4,-3
NOR,ZAF,2011.0,4,5,-1
ECU,COL,2015.0,1,6,-5
IND,THA,2010.0,5,3,2
KEN,TZA,2008.0,3,2,1
GBR,IDN,2004.0,4,3,1
LKA,NZL,2011.0,3,1,2
TUR,IND,2007.0,1,5,-4
IRL,SGP,2015.0,7,2,5
FRA,MOZ,2014.0,3,1,2
ARG,JPN,2011.0,2,2,0
PSE,ISR,2016.0,6,40,-34
MNG,KOR,2012.0,1,2,-1
CMR,USA,2018.0,7,13,-6
NLD,MLT,2014.0,1,1,0
TUR,OMN,2010.0,1,2,-1
DEU,IRN,2002.0,8,9,-1
MWI,FIN,2011.0,1,1,0
FIN,LUX,2014.0,2,1,1
MCO,AUS,2018.0,1,1,0
TWN,EGY,2013.0,1,1,0
DJI,FRA,2013.0,6,1,5
CAN,SRB,2008.0,5,1,4
IRN,EGY,2017.0,2,1,1
LUX,CHE,2014.0,4,2,2
EGY,FIN,2022.0,2,1,1
UGA,SWE,2012.0,5,7,-2
AUS,PRT,2013.0,3,10,-7
NPL,BGD,2017.0,1,1,0
CRI,NLD,2019.0,2,1,1
LUX,ITA,2012.0,1,13,-12
PER,ARG,2014.0,2,1,1
BMU,GBR,2010.0,2,1,1
TJK,DEU,2020.0,1,2,-1
ARG,PER,2003.0,2,2,0
THA,VNM,2008.0,4,2,2
MAR,TUN,2011.0,1,2,-1
USA,ALB,2006.0,3,2,1
CHN,THA,2008.0,5,6,-1
ISR,UKR,2020.0,4,3,1
IDN,LKA,2010.0,1,1,0
SRB,ESP,2019.0,6,1,5
LVA,LTU,2013.0,2,6,-4
MMR,DEU,2021.0,1,3,-2
SGP,ISR,2021.0,7,9,-2
ZAF,BRA,2013.0,5,2,3
CAN,VEN,2017.0,1,7,-6
JPN,BTN,2020.0,1,1,0
LSO,USA,2018.0,4,2,2
MYS,BEL,2016.0,2,4,-2
PAK,DNK,2017.0,2,2,0
SVN,AUT,2002.0,3,4,-1
MDG,JPN,2021.0,1,1,0
AUS,URY,2017.0,1,1,0
CYP,ESP,2022.0,3,2,1
POL,ZAF,2023.0,3,4,-1
NOR,ZAF,2019.0,3,4,-1
PRT,ECU,2021.0,1,4,-3
ESP,VEN,1997.0,5,6,-1
MAR,CAN,2011.0,3,12,-9
CZE,ISR,2009.0,3,3,0
DEU,MAR,2008.0,2,1,1
CUB,CHN,2022.0,7,1,6
BHR,KWT,2016.0,1,1,0
DEU,EST,1997.0,2,1,1
AUT,PRT,2016.0,2,9,-7
HRV,ITA,1999.0,1,2,-1
NLD,KEN,2016.0,7,7,0
POL,CHL,2023.0,1,3,-2
FIN,BEL,2007.0,4,4,0
POL,SVK,2007.0,3,9,-6
DEU,KGZ,2002.0,1,1,0
KEN,TZA,2014.0,6,2,4
QAT,CHN,2017.0,1,4,-3
BRA,IRL,2010.0,1,4,-3
TUR,SWE,2006.0,5,1,4
NCL,FRA,2001.0,6,9,-3
MLI,CIV,2015.0,3,2,1
SAU,RUS,2014.0,2,1,1
SVN,CHE,2004.0,1,1,0
SRB,NLD,2006.0,3,6,-3
TUR,GRC,2013.0,2,4,-2
PRT,HUN,2018.0,1,1,0
SVK,HUN,2022.0,8,12,-4
BWA,ZAF,2017.0,11,17,-6
JPN,DZA,2016.0,2,2,0
SWE,UGA,2015.0,4,1,3
ITA,BGD,2014.0,3,4,-1
EST,DEU,2018.0,10,11,-1
SAU,TUR,2020.0,3,10,-7
BEL,ISL,2020.0,1,1,0
DNK,PAK,2019.0,4,5,-1
THA,AUT,2005.0,5,1,4
NZL,FIN,2021.0,7,1,6
DNK,GNB,2017.0,2,3,-1
USA,MAR,2002.0,7,11,-4
PAK,FIN,2022.0,3,1,2
JPN,MEX,2018.0,9,8,1
ARE,ESP,2022.0,2,11,-9
DZA,DEU,2019.0,4,7,-3
SYR,IND,2019.0,1,1,0
SGP,MAC,2014.0,3,1,2
KOR,KHM,2019.0,5,2,3
IND,KHM,2023.0,1,1,0
AZE,DEU,2020.0,3,2,1
CHL,KOR,2022.0,3,1,2
NZL,NGA,2022.0,1,4,-3
LVA,CHE,2022.0,1,1,0
KAZ,HKG,2020.0,1,1,0
KOR,RUS,1997.0,6,6,0
DNK,GHA,2022.0,2,1,1
TZA,GHA,2022.0,1,2,-1
SRB,MKD,2023.0,6,2,4
GBR,UZB,2020.0,1,1,0
PRT,NOR,2020.0,7,2,5
USA,BRB,2022.0,3,4,-1
IRL,CHL,2018.0,3,2,1
CMR,BEL,2023.0,5,3,2
BDI,KEN,2021.0,2,3,-1
PAK,QAT,2018.0,6,5,1
RUS,ARG,2021.0,1,1,0
BGD,ESP,2020.0,3,1,2
CZE,ZAF,2022.0,2,7,-5
PSE,EGY,2020.0,2,3,-1
LTU,JPN,2021.0,1,2,-1
ITA,MYS,2011.0,1,3,-2
URY,VEN,2021.0,1,2,-1
DEU,GEO,2022.0,4,2,2
SGP,IRN,2021.0,1,7,-6
DNK,IRN,2023.0,3,40,-37
MLI,SEN,2019.0,4,6,-2
BLR,FRA,2015.0,3,2,1
FIN,JPN,1997.0,7,3,4
ZAF,IRL,1997.0,1,1,0
DNK,FRO,2023.0,3,4,-1
GNB,DNK,2010.0,4,4,0
MYS,HKG,2006.0,1,4,-3
EGY,AUT,2020.0,4,8,-4
USA,GRD,2002.0,1,1,0
GRD,USA,2004.0,1,3,-2
CHE,BRA,2004.0,8,9,-1
CHN,NZL,1999.0,3,1,2
FIN,VNM,2020.0,3,1,2
ARE,MYS,2014.0,3,12,-9
USA,TTO,2003.0,11,7,4
DEU,MDA,2001.0,1,2,-1
IRQ,USA,2007.0,5,5,0
BHR,ITA,2004.0,1,1,0
CAN,KEN,2008.0,1,3,-2
THA,PHL,2005.0,1,1,0
NOR,FIN,2003.0,5,8,-3
CAN,BEN,2013.0,1,1,0
IND,TUR,2010.0,3,9,-6
KHM,CHE,2019.0,2,1,1
USA,SDN,2020.0,5,5,0
FRA,ARM,2002.0,4,2,2
PAK,SGP,2012.0,6,3,3
VEN,BRA,2013.0,9,5,4
JPN,JAM,2011.0,1,2,-1
BEL,EGY,2001.0,5,1,4
SWE,ISR,2018.0,7,3,4
CAN,TUN,2003.0,6,2,4
BRA,IND,2006.0,3,1,2
NGA,UGA,2015.0,3,5,-2
VEN,ARG,2011.0,2,1,1
SVK,POL,1998.0,4,5,-1
POL,SVK,1999.0,3,3,0
IND,TUR,2000.0,1,4,-3
QAT,SAU,2010.0,4,1,3
BRA,AUS,1997.0,2,3,-1
CAN,NPL,2016.0,1,1,0
BLR,NLD,2001.0,1,1,0
DNK,BGR,2014.0,1,1,0
NGA,UGA,2014.0,2,1,1
POL,BGR,2013.0,2,1,1
THA,TWN,2002.0,1,1,0
RUS,HKG,2014.0,2,2,0
CHE,URY,2015.0,1,2,-1
BGR,CHE,2001.0,4,4,0
ITA,NGA,2005.0,3,1,2
CZE,IND,2015.0,7,16,-9
AUS,GHA,2010.0,3,3,0
BEL,NOR,2017.0,10,5,5
URY,GBR,2002.0,1,3,-2
PAK,BGR,2013.0,1,2,-1
MRT,TUN,2021.0,1,1,0
CYP,GRC,1999.0,2,5,-3
EGY,DNK,2015.0,1,3,-2
LUX,AUS,2021.0,2,5,-3
SRB,AUS,2015.0,4,1,3
NOR,UGA,2020.0,3,1,2
POL,HUN,2021.0,3,6,-3
MNG,AUS,2021.0,3,4,-1
BRN,USA,2018.0,1,1,0
EGY,BRA,2014.0,1,1,0
BRA,EGY,2017.0,2,1,1
BHR,EGY,2013.0,2,4,-2
ESP,ISR,2004.0,3,8,-5
SLV,USA,2014.0,4,2,2
GTM,ESP,2015.0,1,4,-3
DNK,HUN,2018.0,6,8,-2
THA,DNK,2019.0,2,1,1
ZAF,EGY,2016.0,4,1,3
KAZ,TUR,2014.0,2,5,-3
GHA,KOR,2015.0,1,2,-1
IND,HRV,2023.0,2,1,1
MEX,CZE,2016.0,4,4,0
PAK,NPL,2017.0,2,1,1
NZL,NOR,2020.0,4,4,0
DEU,MAR,2014.0,4,1,3
MAR,DEU,2018.0,4,6,-2
TUR,CZE,2023.0,4,4,0
CHN,COL,2019.0,4,3,1
NLD,POL,2020.0,14,22,-8
PHL,CHN,2017.0,8,3,5
CAN,TZA,2021.0,2,1,1
PRT,IRN,2019.0,4,16,-12
ARE,GRC,2021.0,3,2,1
ESP,SGP,2020.0,7,7,0
GBR,PHL,2022.0,7,14,-7
SVK,UKR,2017.0,5,5,0
JOR,KWT,2022.0,8,3,5
SYR,GBR,1998.0,1,2,-1
EST,AUS,2010.0,2,1,1
NGA,AUS,2022.0,9,8,1
CRI,ESP,2016.0,7,5,2
UGA,CHN,2020.0,1,8,-7
GBR,MAR,2018.0,3,5,-2
ETH,BWA,2019.0,2,2,0
TGO,FRA,2019.0,1,3,-2
BGD,PRT,2018.0,1,1,0
POL,HRV,2023.0,3,2,1
BHR,PAK,2022.0,1,3,-2
RUS,TUR,2018.0,2,2,0
BEN,GHA,2019.0,2,2,0
BEN,CIV,2019.0,4,1,3
SAU,SWE,2019.0,4,8,-4
CHN,PRT,2009.0,9,9,0
ITA,VNM,2015.0,5,2,3
IDN,BRN,2022.0,1,2,-1
RWA,MWI,2022.0,1,1,0
CHN,ARE,2023.0,13,12,1
ZAF,BEN,2022.0,1,2,-1
PAK,PRT,2016.0,1,2,-1
KAZ,DEU,2013.0,3,1,2
CHL,PRY,2016.0,2,2,0
RUS,IRQ,2020.0,4,5,-1
FRA,PER,2022.0,5,8,-3
AUS,MNG,2021.0,4,3,1
SAU,IRN,2022.0,2,2,0
LBN,CHN,2022.0,1,2,-1
RWA,ETH,2022.0,1,2,-1
PER,BRA,2002.0,1,4,-3
ITA,KOR,2000.0,1,2,-1
BWA,KEN,2020.0,4,1,3
RUS,TUR,2017.0,1,7,-6
DEU,ARE,2000.0,1,1,0
ALB,ITA,2006.0,1,1,0
PRT,GNB,2015.0,1,2,-1
TTO,ZAF,2013.0,1,1,0
ZAF,ARG,1999.0,1,1,0
EST,ESP,2023.0,4,4,0
BWA,USA,2002.0,2,2,0
MWI,ZAF,2011.0,2,7,-5
JPN,NGA,2005.0,5,3,2
NGA,NLD,2007.0,1,3,-2
ESP,CRI,2005.0,2,2,0
BRA,ECU,2009.0,3,3,0
CMR,ZAF,2007.0,1,3,-2
CZE,ISR,2011.0,2,2,0
NGA,CHN,2008.0,4,3,1
ESP,HUN,2005.0,3,2,1
DNK,ZAF,2003.0,2,3,-1
NGA,BEN,2015.0,3,5,-2
NLD,HKG,2002.0,3,2,1
ZAF,NGA,2007.0,4,21,-17
USA,UZB,2016.0,2,4,-2
GBR,PER,2015.0,7,7,0
BFA,ITA,2012.0,2,3,-1
MYS,DZA,2021.0,6,1,5
TTO,CAN,2016.0,2,5,-3
SAU,HKG,2020.0,5,4,1
DNK,CZE,2023.0,3,6,-3
SAU,NGA,2019.0,5,8,-3
ZAF,ISR,2018.0,2,1,1
ZAF,EGY,2017.0,1,4,-3
KOR,BGR,2010.0,1,3,-2
CHE,LVA,2018.0,2,6,-4
USA,TTO,2013.0,3,13,-10
PAN,ESP,2013.0,2,7,-5
PSE,BEL,2017.0,2,2,0
JOR,HKG,2015.0,2,2,0
PRT,STP,2015.0,2,1,1
QAT,LBN,2016.0,5,7,-2
CHE,ISR,2020.0,11,18,-7
IRL,BRA,2016.0,7,8,-1
ISR,BRA,2021.0,5,7,-2
HKG,DNK,2019.0,3,3,0
SVK,GRC,2021.0,3,3,0
GBR,CRI,2021.0,2,2,0
NZL,PHL,2019.0,2,6,-4
NLD,MAC,2023.0,2,1,1
BEL,EST,2022.0,4,4,0
SRB,NLD,2023.0,4,1,3
ESP,EST,2018.0,2,3,-1
FRA,BEN,2021.0,9,10,-1
OMN,TUN,2006.0,1,2,-1
TUN,OMN,2013.0,2,2,0
GRC,AUS,2010.0,4,6,-2
BEL,HUN,2019.0,7,4,3
BEL,CZE,2021.0,15,4,11
NOR,EST,2022.0,3,5,-2
PAK,TZA,2020.0,2,1,1
PHL,CHE,2013.0,3,6,-3
ETH,ZAF,2002.0,3,1,2
SRB,AUS,2001.0,3,2,1
AUS,SRB,2014.0,1,2,-1
GBR,GUY,2004.0,1,1,0
PER,ARG,2001.0,1,2,-1
TZA,NLD,2002.0,1,3,-2
CYP,CAN,2000.0,1,2,-1
SDN,EGY,2022.0,2,3,-1
NZL,FIN,2011.0,2,2,0
LBY,EGY,2014.0,4,4,0
TZA,NLD,2005.0,1,2,-1
SWE,SGP,2001.0,1,3,-2
BEL,BDI,1997.0,1,1,0
SWE,URY,1999.0,3,2,1
SRB,MKD,2000.0,6,3,3
GAB,DEU,2002.0,4,1,3
POL,AUS,1999.0,4,4,0
VEN,COL,1997.0,1,2,-1
KWT,SAU,2014.0,3,6,-3
PAK,EGY,2007.0,1,2,-1
GBR,GEO,2004.0,1,3,-2
SWE,BGR,2013.0,2,2,0
BRA,MEX,2003.0,7,6,1
PER,CAN,2018.0,4,5,-1
QAT,CAN,2011.0,2,5,-3
MOZ,PRT,2002.0,1,2,-1
CMR,NGA,1999.0,1,4,-3
BRN,AUS,2000.0,1,1,0
LKA,ZAF,2002.0,1,1,0
GRC,DNK,2010.0,2,4,-2
COL,CAN,2006.0,6,7,-1
KWT,PAK,2005.0,1,2,-1
FIN,ROU,2008.0,2,1,1
RUS,UZB,2006.0,10,7,3
ETH,UGA,2004.0,1,1,0
FIN,NZL,2002.0,1,1,0
UKR,SWE,2023.0,5,1,4
ETH,SWE,1998.0,2,1,1
SWE,SGP,2008.0,7,4,3
ZAF,KNA,2017.0,2,1,1
ZAF,KNA,2022.0,1,1,0
SWE,ETH,1998.0,1,2,-1
VNM,ARE,2018.0,1,2,-1
IRL,AUT,2008.0,4,4,0
GRC,DNK,2006.0,2,4,-2
CRI,MEX,2013.0,4,2,2
AUS,ISL,2018.0,3,2,1
USA,MKD,2001.0,1,2,-1
IND,RUS,2012.0,3,1,2
ROU,NLD,2000.0,6,1,5
FRA,GAB,2023.0,3,3,0
POL,CHL,2010.0,1,3,-2
KWT,ARE,2002.0,2,4,-2
DEU,GAB,2010.0,2,5,-3
DNK,GHA,2018.0,3,3,0
CAN,UKR,2018.0,4,6,-2
MAC,HKG,2010.0,2,6,-4
ESP,DOM,2013.0,1,1,0
USA,LBY,2013.0,7,2,5
DNK,COL,2021.0,1,3,-2
SLE,NGA,2018.0,2,1,1
IRQ,FRA,2018.0,2,20,-18
ITA,COG,2013.0,1,1,0
GBR,ETH,1999.0,4,1,3
USA,NPL,2007.0,2,7,-5
MEX,CUB,2008.0,5,10,-5
GNB,DNK,2000.0,2,1,1
AUS,ROU,2020.0,1,1,0
MYS,BRA,2010.0,2,2,0
CHN,CUB,2011.0,1,1,0
GRC,ESP,1997.0,2,1,1
USA,GMB,2000.0,1,4,-3
SWE,TZA,2002.0,2,3,-1
ESP,AND,2005.0,1,3,-2
AUS,EGY,2008.0,1,3,-2
ESP,HRV,2016.0,4,6,-2
ITA,IRN,2009.0,6,13,-7
CHE,THA,2003.0,2,2,0
MAR,MLI,2016.0,1,1,0
USA,MOZ,2014.0,9,3,6
KOR,NZL,2023.0,2,2,0
NLD,KOR,2015.0,8,12,-4
MOZ,ESP,2019.0,6,5,1
ESP,PAN,2018.0,4,2,2
EGY,ESP,2010.0,3,3,0
LBN,JOR,2022.0,1,3,-2
BGR,AUT,1998.0,1,1,0
CZE,CAN,2003.0,6,7,-1
JOR,NLD,2019.0,1,3,-2
EGY,ISR,2012.0,1,2,-1
CHN,MUS,2021.0,1,1,0
NZL,GHA,2023.0,2,1,1
PER,CRI,2002.0,1,2,-1
TUR,GHA,2021.0,1,1,0
ISR,COL,2019.0,1,1,0
NZL,CHE,2019.0,8,11,-3
CZE,VNM,2018.0,6,4,2
PAK,BGD,2003.0,3,9,-6
ETH,HUN,2020.0,1,1,0
IND,UZB,2015.0,1,1,0
SWE,SVN,2020.0,4,5,-1
ITA,TWN,2021.0,4,5,-1
CZE,DZA,2023.0,1,1,0
IND,BRA,2021.0,10,11,-1
PRT,MOZ,2020.0,3,5,-2
ZWE,ETH,2019.0,2,1,1
BHR,IRL,2023.0,1,2,-1
UKR,TWN,2005.0,3,3,0
ALB,TUR,2019.0,1,2,-1
ITA,VEN,2008.0,5,2,3
TZA,IND,2012.0,2,2,0
DNK,CZE,2006.0,3,2,1
HRV,AUS,2011.0,1,3,-2
EGY,BHR,2020.0,1,3,-2
SRB,BLR,2008.0,1,1,0
FIN,IND,2009.0,4,11,-7
HKG,MAC,2003.0,2,2,0
KEN,CHN,2005.0,1,1,0
CHN,KEN,2006.0,3,2,1
TZA,BEL,2023.0,1,2,-1
ETH,NOR,2015.0,5,3,2
FRA,BOL,2013.0,2,4,-2
TUN,ESP,2007.0,2,2,0
BEL,UKR,2022.0,2,2,0
POL,GRC,2003.0,2,1,1
AUS,ZWE,2000.0,2,2,0
FIN,HUN,2013.0,1,4,-3
ZMB,GBR,1997.0,2,2,0
ESP,PHL,2002.0,3,8,-5
KEN,COG,2023.0,2,1,1
BHR,QAT,2020.0,2,1,1
ITA,SVN,2009.0,6,5,1
THA,DEU,2000.0,3,5,-2
AUT,GRC,2003.0,4,5,-1
FRA,KEN,2014.0,5,3,2
SWE,JOR,2010.0,1,4,-3
ETH,CHE,2009.0,2,1,1
DNK,HRV,2013.0,1,2,-1
RUS,IRN,2003.0,3,2,1
DEU,VEN,2022.0,1,2,-1
TZA,JPN,1998.0,1,2,-1
KOR,UKR,2006.0,1,3,-2
CHN,IRN,2009.0,2,6,-4
NOR,HKG,2019.0,2,3,-1
KOR,FIN,2018.0,3,2,1
UGA,CAN,2013.0,3,1,2
MYS,PSE,2020.0,8,5,3
ESP,HRV,2018.0,9,4,5
GBR,BRB,2017.0,2,3,-1
CZE,TUR,2015.0,3,5,-2
NGA,RUS,2019.0,2,1,1
MOZ,SWE,2023.0,2,1,1
IRL,CHE,2011.0,8,9,-1
GBR,JOR,2001.0,12,3,9
TGO,BFA,2018.0,3,3,0
NLD,SVN,2002.0,2,2,0
NOR,HUN,2016.0,4,9,-5
EST,DEU,2016.0,5,8,-3
CZE,TUR,2014.0,2,8,-6
MWI,RWA,2020.0,2,1,1
ITA,POL,2009.0,14,15,-1
AUS,PNG,2016.0,5,9,-4
IRN,POL,2019.0,12,2,10
RUS,SVK,2014.0,3,3,0
AUS,HRV,2003.0,2,1,1
AUS,JOR,2006.0,6,1,5
IND,SVK,2014.0,1,1,0
ITA,DZA,2022.0,6,5,1
USA,ARE,1999.0,9,7,2
LKA,IND,2011.0,4,3,1
AUS,KEN,2010.0,2,7,-5
BRN,PAK,2009.0,1,1,0
IRL,IRN,2021.0,5,24,-19
NOR,IRL,2013.0,1,3,-2
NLD,RWA,2019.0,2,1,1
SGP,EGY,2017.0,3,2,1
ESP,SLV,2012.0,2,1,1
BRN,AUS,2023.0,2,1,1
MKD,DEU,2015.0,3,2,1
KWT,JPN,2001.0,1,1,0
BRN,MYS,2021.0,4,10,-6
IRN,KWT,2022.0,1,2,-1
AUS,BRN,1999.0,4,1,3
ZWE,NLD,1998.0,2,3,-1
DNK,THA,2003.0,3,1,2
PSE,USA,2013.0,3,7,-4
USA,TGO,2008.0,1,2,-1
CHE,MLT,2013.0,2,1,1
NLD,KOR,2004.0,3,4,-1
ZAF,BEL,2013.0,12,13,-1
MWI,GMB,2008.0,1,1,0
UKR,CAN,1998.0,3,2,1
BEN,NGA,2007.0,3,4,-1
SWE,UKR,2006.0,3,1,2
OMN,USA,2020.0,1,9,-8
USA,PYF,2016.0,1,1,0
CAN,CHL,2009.0,5,11,-6
SWE,BGR,2003.0,1,2,-1
PAK,AFG,2015.0,2,2,0
RUS,AUT,2004.0,8,5,3
SWE,IRL,1999.0,2,3,-1
POL,IRL,2017.0,6,6,0
TGO,BFA,2017.0,4,1,3
ITA,ARM,2008.0,2,1,1
CHE,KEN,2008.0,3,1,2
DNK,LTU,2007.0,3,3,0
PHL,IND,2002.0,3,5,-2
UKR,AUT,1997.0,5,3,2
CHE,CYP,2013.0,2,3,-1
CHL,PRT,2019.0,5,5,0
EST,CHE,2013.0,1,2,-1
CUB,COL,2011.0,2,2,0
NOR,BRA,2009.0,3,1,2
LTU,USA,2013.0,4,11,-7
KHM,LAO,2009.0,1,1,0
CHN,HUN,2007.0,1,1,0
ETH,ZWE,2006.0,2,1,1
PAK,ITA,2011.0,6,3,3
ITA,MKD,2012.0,4,1,3
KOR,HKG,2003.0,2,3,-1
DNK,GRL,2012.0,3,4,-1
IRL,RUS,2015.0,2,3,-1
GBR,JOR,2004.0,8,3,5
EST,NLD,2015.0,4,3,1
COL,NLD,2014.0,6,9,-3
POL,EGY,2014.0,4,1,3
DEU,NCL,2013.0,1,1,0
USA,KAZ,2001.0,3,1,2
BRB,CAN,2018.0,2,1,1
IRL,CHN,2002.0,3,4,-1
AUS,ZAF,1997.0,6,14,-8
USA,GUM,2020.0,8,6,2
POL,CAN,1998.0,12,7,5
NOR,ISL,2002.0,3,9,-6
CHE,PNG,2014.0,1,1,0
SWE,SRB,2022.0,5,3,2
HKG,CHE,2000.0,2,1,1
ZMB,NZL,2020.0,1,1,0
MNG,HUN,2021.0,1,2,-1
LBY,MYS,2023.0,3,3,0
UKR,CHE,2007.0,1,1,0
QAT,SRB,2017.0,1,3,-2
IDN,DEU,2008.0,6,15,-9
FRA,COG,2010.0,4,8,-4
GBR,SEN,2007.0,3,1,2
DZA,DEU,2021.0,3,5,-2
NPL,BTN,2022.0,1,1,0
AND,ESP,2003.0,3,1,2
HUN,NOR,1999.0,1,1,0
SGP,TUR,2015.0,3,7,-4
TWN,RUS,2017.0,3,1,2
OMN,UKR,2010.0,1,1,0
EST,RUS,2002.0,2,2,0
NLD,ZWE,2018.0,2,3,-1
MYS,KWT,2021.0,4,3,1
DNK,HUN,2017.0,7,5,2
BEL,QAT,2022.0,3,1,2
FRA,IDN,2000.0,4,3,1
UKR,BEL,2021.0,3,2,1
BFA,SEN,2012.0,4,2,2
BEL,RWA,2009.0,1,2,-1
DEU,GUF,2005.0,1,2,-1
EGY,POL,2002.0,2,4,-2
,ERI,2008.0,4,0,4
ITA,MAR,2014.0,4,0,4
CHN,ETH,2013.0,1,0,1
NGA,NZL,2011.0,2,0,2
IRL,TTO,2012.0,1,0,1
BRA,IRN,2009.0,2,0,2
SRB,QAT,2015.0,3,0,3
,GIB,2008.0,5,0,5
JAM,ISR,2015.0,1,0,1
SGP,VNM,2006.0,3,0,3
COL,SWE,2001.0,3,0,3
NOR,PSE,2016.0,1,0,1
PER,IND,2011.0,1,0,1
SGP,COL,2020.0,1,0,1
ARG,BOL,2020.0,2,0,2
NRU,NCL,2015.0,1,0,1
ARM,POL,2019.0,4,0,4
HND,VEN,2011.0,4,0,4
CZE,URY,2010.0,1,0,1
MYS,CZE,2019.0,2,0,2
CCK,AUS,2010.0,1,0,1
HRV,HUN,2011.0,3,0,3
CMR,IND,2004.0,1,0,1
KOR,ISR,1997.0,1,0,1
FRA,CUB,1997.0,2,0,2
ARG,BLZ,2019.0,1,0,1
BLZ,ARG,2021.0,1,0,1
SRB,KWT,2020.0,2,0,2
USA,VCT,2011.0,2,0,2
ERI,GBR,2014.0,1,0,1
PAK,BRN,2011.0,2,0,2
SVN,ARG,2013.0,1,0,1
RWA,FRA,2014.0,1,0,1
PHL,SAU,2019.0,2,0,2
TUN,GBR,2015.0,4,0,4
,AIA,2016.0,1,0,1
GHA,NER,2020.0,1,0,1
ITA,BHR,2019.0,1,0,1
FRA,TJK,2022.0,2,0,2
MUS,BRA,2023.0,2,0,2
OMN,IRQ,2023.0,1,0,1
MLT,NOR,2008.0,1,0,1
NOR,MLT,2009.0,1,0,1
BHR,,2005.0,10,0,10
CHN,BFA,2007.0,4,0,4
TKM,,2023.0,2,0,2
ETH,TLS,2019.0,2,0,2
NZL,PLW,2001.0,1,0,1
SLE,AUS,2017.0,1,0,1
ROU,PRT,1999.0,2,0,2
DEU,DNK,2024.0,2,0,2
DEU,COD,2022.0,2,0,2
NIC,USA,1998.0,1,0,1
SUR,,2005.0,1,0,1
DNK,VNM,2004.0,1,0,1
TTO,TUR,2020.0,1,0,1
POL,UZB,2003.0,1,0,1
POL,KGZ,2001.0,1,0,1
NAM,,2008.0,6,0,6
GTM,,2006.0,11,0,11
THA,ARG,2011.0,1,0,1
BEN,USA,1998.0,1,0,1
TWN,IRL,2009.0,1,0,1
MMR,BEL,2012.0,2,0,2
SAU,GHA,2008.0,1,0,1
CUB,CHN,2017.0,1,0,1
ITA,AGO,2006.0,1,0,1
UZB,AUS,2001.0,1,0,1
JOR,YEM,2013.0,2,0,2
AUS,TUN,1998.0,1,0,1
PNG,FJI,2008.0,2,0,2
HUN,RUS,2007.0,1,0,1
IRN,PAK,1998.0,2,0,2
THA,MAC,2011.0,1,0,1
TUR,ISR,1998.0,1,0,1
LIE,USA,2001.0,1,0,1
CRI,IDN,1998.0,1,0,1
GRC,ARE,2015.0,2,0,2
RWA,,1999.0,3,0,3
MDG,CMR,2007.0,1,0,1
GMB,,2008.0,10,0,10
RWA,ITA,2014.0,1,0,1
GTM,,2000.0,7,0,7
NOR,TGO,2015.0,1,0,1
TGO,NOR,2017.0,1,0,1
NLD,SVN,2005.0,4,0,4
IRL,FIN,1998.0,2,0,2
TUR,HRV,2010.0,1,0,1
BEL,TGO,2009.0,1,0,1
AUT,LTU,2005.0,1,0,1
LAO,GBR,1997.0,1,0,1
SAU,FIN,2008.0,1,0,1
FRA,MLT,2002.0,1,0,1
CHE,ISL,2003.0,3,0,3
NOR,ARE,2004.0,2,0,2
HKG,MYS,1999.0,3,0,3
ZMB,BWA,2006.0,1,0,1
TWN,NZL,2005.0,1,0,1
ITA,URY,1997.0,1,0,1
MWI,TZA,2005.0,1,0,1
BRA,BFA,2010.0,3,0,3
BIH,SVN,2008.0,1,0,1
,KHM,1999.0,6,0,6
AUT,ARG,2008.0,1,0,1
BGD,PHL,2007.0,1,0,1
CUB,UGA,2014.0,1,0,1
LBN,HKG,2013.0,1,0,1
NOR,LKA,2011.0,1,0,1
ATG,TTO,2023.0,1,0,1
KEN,GMB,2014.0,1,0,1
IDN,KEN,2020.0,3,0,3
KOR,ROU,2019.0,2,0,2
HRV,ARE,2019.0,1,0,1
AZE,ISR,2007.0,2,0,2
CHE,PER,2017.0,3,0,3
NZL,WSM,2014.0,1,0,1
SYR,DZA,2011.0,1,0,1
UKR,HUN,2010.0,1,0,1
TWN,AUT,2007.0,2,0,2
MYS,TWN,2009.0,1,0,1
,REU,2008.0,12,0,12
GBR,YEM,2014.0,1,0,1
IRQ,CAN,2016.0,1,0,1
GBR,SLE,2012.0,1,0,1
DNK,BEN,2010.0,1,0,1
MAR,ARE,2011.0,1,0,1
JPN,COL,2010.0,2,0,2
LBY,JOR,2018.0,3,0,3
GMB,BRA,2013.0,1,0,1
,SLV,2006.0,6,0,6
CHE,URY,2014.0,1,0,1
CHE,GHA,2006.0,1,0,1
KOR,DZA,2019.0,2,0,2
IRN,MAR,2020.0,1,0,1
REU,NZL,2018.0,1,0,1
NIU,,2021.0,2,0,2
TTO,CHN,2015.0,2,0,2
EGY,JOR,1998.0,1,0,1
NOR,DEU,2024.0,1,0,1
DOM,CAN,2014.0,1,0,1
,GRL,2009.0,5,0,5
ISR,TWN,2001.0,2,0,2
DMA,,2005.0,1,0,1
JPN,KGZ,2022.0,2,0,2
ZWE,AUS,2016.0,1,0,1
BRN,BGD,2017.0,2,0,2
GIN,CMR,2018.0,1,0,1
JOR,AUS,2004.0,3,0,3
MYS,SLE,2019.0,1,0,1
GBR,CMR,1997.0,4,0,4
ARM,AUS,2008.0,2,0,2
GHA,HKG,2015.0,1,0,1
THA,ROU,2022.0,1,0,1
URY,AUS,2005.0,1,0,1
SRB,PRT,2005.0,3,0,3
DZA,ZAF,2021.0,1,0,1
JPN,ECU,2017.0,2,0,2
SAU,BGD,2007.0,1,0,1
LBN,PSE,2023.0,1,0,1
ZMB,CHE,2023.0,5,0,5
IRQ,EUE,2021.0,1,0,1
MYS,UZB,2021.0,2,0,2
AFG,AUS,2021.0,1,0,1
RUS,CHL,1999.0,2,0,2
THA,NPL,2005.0,3,0,3
SLV,SVK,1998.0,4,0,4
SYR,LBN,2016.0,3,0,3
MCO,,2020.0,13,0,13
BLR,ISR,2013.0,1,0,1
BMU,CAN,2000.0,1,0,1
IRL,ZWE,1997.0,1,0,1
GTM,,2010.0,10,0,10
ZAF,SRB,2001.0,1,0,1
SWE,SDN,1998.0,1,0,1
MDG,NER,2004.0,2,0,2
AUS,PAN,2007.0,1,0,1
,MNP,1995.0,1,0,1
NAM,AGO,2014.0,1,0,1
COG,ITA,2015.0,2,0,2
ARM,AUT,2005.0,1,0,1
FJI,KWT,2001.0,1,0,1
IRL,AUT,2001.0,1,0,1
EGY,ETH,2000.0,1,0,1
SVN,MKD,2001.0,1,0,1
DOM,,2004.0,1,0,1
KAZ,SAU,2016.0,1,0,1
DNK,ROU,1999.0,1,0,1
LBN,IND,1998.0,1,0,1
,NIC,1998.0,6,0,6
,BLZ,2000.0,3,0,3
HRV,PRT,2015.0,3,0,3
PRI,GBR,1998.0,1,0,1
NLD,BFA,2006.0,2,0,2
MYS,ROU,2014.0,1,0,1
VUT,NCL,2019.0,1,0,1
ECU,DOM,2016.0,1,0,1
FRA,MRT,2012.0,1,0,1
FIN,KWT,2018.0,1,0,1
KEN,MDV,2016.0,1,0,1
KGZ,JPN,2015.0,1,0,1
BEN,ESP,2011.0,1,0,1
SVK,BIH,2016.0,2,0,2
DNK,LAO,2018.0,1,0,1
PSE,ARE,2017.0,1,0,1
GNQ,ISR,2012.0,1,0,1
HKG,TUN,2014.0,1,0,1
USA,YEM,2011.0,1,0,1
EST,ROU,2015.0,3,0,3
YEM,IRQ,2012.0,1,0,1
GHA,TWN,2018.0,1,0,1
STP,TWN,2011.0,4,0,4
KOR,FJI,2012.0,2,0,2
ITA,OMN,2020.0,2,0,2
NGA,IRQ,2017.0,1,0,1
BRN,GRC,2020.0,1,0,1
BDI,TZA,2017.0,1,0,1
FIN,NGA,2015.0,2,0,2
COD,GBR,2017.0,1,0,1
SWE,LBY,2020.0,2,0,2
BGD,NZL,2013.0,1,0,1
NLD,GTM,2017.0,1,0,1
LBN,JPN,2014.0,1,0,1
CRI,BEL,2018.0,2,0,2
GHA,KAZ,2018.0,1,0,1
FRA,MUS,2011.0,3,0,3
AUS,QAT,2006.0,1,0,1
SYR,RUS,1998.0,1,0,1
MAR,UGA,2016.0,1,0,1
SVN,FIN,2014.0,2,0,2
TON,,2023.0,7,0,7
ISL,FRA,2016.0,2,0,2
CHL,KNA,2023.0,1,0,1
GBR,TCA,2018.0,2,0,2
HKG,CHL,2022.0,1,0,1
FIN,BGD,2023.0,2,0,2
JOR,HUN,2020.0,4,0,4
BLR,HKG,2001.0,1,0,1
HUN,EST,2023.0,1,0,1
AUT,LAO,2016.0,1,0,1
PRI,ARG,2021.0,1,0,1
CAN,KGZ,2017.0,1,0,1
AUS,CRI,2020.0,3,0,3
TWN,MNG,2022.0,2,0,2
FRA,HTI,2014.0,4,0,4
ARG,SWE,2021.0,11,0,11
GUF,CHE,2004.0,2,0,2
BTN,ESP,2020.0,1,0,1
GRD,PSE,2018.0,1,0,1
IDN,SDN,2022.0,1,0,1
AFG,BGD,2022.0,1,0,1
AFG,JPN,2007.0,1,0,1
JOR,AFG,2020.0,1,0,1
ETH,SAU,2022.0,2,0,2
IRQ,NZL,2023.0,1,0,1
CYP,RUS,2019.0,3,0,3
IRN,LTU,2021.0,4,0,4
LKA,BGD,2012.0,2,0,2
,LCA,2019.0,3,0,3
UZB,TJK,2020.0,1,0,1
ZWE,PNG,2022.0,1,0,1
TWN,BEN,2021.0,1,0,1
PER,SWE,2023.0,3,0,3
RWA,LBR,2022.0,1,0,1
THA,CZE,2022.0,1,0,1
URY,ISR,2012.0,2,0,2
,AGO,2020.0,13,0,13
,STP,2019.0,2,0,2
STP,,2025.0,7,0,7
UGA,BEN,2022.0,1,0,1
ECU,GUY,2005.0,1,0,1
HUN,UKR,1997.0,1,0,1
ETH,ERI,2001.0,1,0,1
,DJI,1995.0,6,0,6
NLD,EST,2002.0,2,0,2
KHM,RUS,2017.0,1,0,1
KGZ,,2004.0,7,0,7
MWI,TZA,2002.0,1,0,1
DEU,ECU,2002.0,1,0,1
TZA,ZAF,2006.0,1,0,1
GBR,FJI,2012.0,5,0,5
ZAF,SDN,2009.0,1,0,1
PYF,,2016.0,9,0,9
LVA,DNK,1997.0,2,0,2
CHE,GMB,2015.0,1,0,1
MWI,,2010.0,11,0,11
EST,CZE,2010.0,1,0,1
SWE,PHL,2011.0,1,0,1
ESP,IRQ,2014.0,1,0,1
JPN,MMR,2003.0,2,0,2
GLP,,2018.0,5,0,5
NLD,QAT,2010.0,1,0,1
PNG,CHE,2000.0,3,0,3
PNG,SGP,1999.0,1,0,1
GTM,USA,1997.0,4,0,4
NER,USA,2016.0,2,0,2
SAU,QAT,2000.0,1,0,1
MUS,,2001.0,6,0,6
ZWE,MOZ,2009.0,1,0,1
LBY,GHA,2002.0,1,0,1
UZB,TWN,2002.0,1,0,1
LKA,FRA,2018.0,2,0,2
NOR,MCO,1998.0,1,0,1
COD,,2003.0,1,0,1
,LBR,2000.0,1,0,1
ERI,USA,2005.0,3,0,3
USA,ATA,2008.0,1,0,1
ARE,BRB,2006.0,1,0,1
BGD,IDN,2013.0,1,0,1
IDN,ESP,2000.0,1,0,1
DEU,GRD,2000.0,1,0,1
VEN,PER,2014.0,2,0,2
BRA,TWN,2008.0,1,0,1
SYR,JPN,2003.0,1,0,1
ETH,KWT,2007.0,1,0,1
NLD,NPL,2002.0,2,0,2
HKG,HUN,2004.0,1,0,1
IRL,CHN,1997.0,2,0,2
USA,ATG,1998.0,2,0,2
MEX,AUT,2007.0,2,0,2
KEN,NZL,2004.0,1,0,1
YEM,,2007.0,7,0,7
MDG,PYF,1999.0,2,0,2
PER,ITA,1998.0,1,0,1
CHN,EGY,2009.0,6,0,6
BEL,MCO,2006.0,2,0,2
AUT,ALB,2018.0,2,0,2
IND,RUS,2005.0,4,0,4
NGA,ZWE,2011.0,1,0,1
ZWE,COG,2013.0,1,0,1
,FSM,2005.0,3,0,3
CUB,SWE,2010.0,1,0,1
KAZ,HUN,2009.0,1,0,1
MWI,TZA,2012.0,1,0,1
VNM,LAO,2008.0,1,0,1
NLD,URY,2011.0,2,0,2
ETH,MAR,2019.0,1,0,1
,SUR,2000.0,2,0,2
NIC,ESP,2003.0,2,0,2
NLD,PAN,2012.0,1,0,1
LBR,BRA,2017.0,1,0,1
BGD,CHN,2009.0,1,0,1
,VUT,2005.0,1,0,1
MYS,THA,2004.0,3,0,3
ZAF,SDN,2011.0,2,0,2
NIC,PRI,2020.0,1,0,1
AUS,KAZ,2014.0,1,0,1
BEL,COL,2006.0,1,0,1
SWE,CMR,2019.0,2,0,2
SAU,IDN,2010.0,2,0,2
GUY,ECU,2007.0,1,0,1
SLV,ITA,2018.0,1,0,1
IRL,ARE,2013.0,4,0,4
MKD,TUR,2002.0,2,0,2
HRV,SVK,2003.0,1,0,1
SDN,OMN,2021.0,2,0,2
GNB,,2010.0,2,0,2
ISL,JPN,2013.0,2,0,2
SAU,ISR,2013.0,1,0,1
LBN,IRL,2016.0,1,0,1
PAK,NPL,2018.0,3,0,3
TUR,LUX,2018.0,2,0,2
HKG,IDN,2023.0,3,0,3
NZL,MWI,2017.0,1,0,1
AFG,FRA,2013.0,1,0,1
EUE,MKD,2021.0,1,0,1
FRA,MAC,2018.0,1,0,1
COL,ETH,2019.0,1,0,1
MWI,MOZ,2010.0,1,0,1
HUN,LUX,2021.0,2,0,2
NLD,NER,1997.0,1,0,1
SVN,TUR,2013.0,1,0,1
IND,ETH,1999.0,1,0,1
BFA,CMR,2020.0,2,0,2
JAM,,2026.0,3,0,3
ISR,HRV,1998.0,1,0,1
MWI,KEN,2018.0,3,0,3
AUT,SGP,2002.0,3,0,3
MYS,TUR,2002.0,2,0,2
LAO,KHM,2016.0,1,0,1
GBR,NCL,2000.0,1,0,1
RUS,SAU,1999.0,1,0,1
SAU,RUS,2004.0,1,0,1
ITA,MEX,1997.0,3,0,3
NLD,CUB,2002.0,1,0,1
BEL,MYS,2007.0,1,0,1
GRL,,2010.0,1,0,1
DZA,SAU,2003.0,2,0,2
HND,,2004.0,5,0,5
KAZ,EST,2000.0,3,0,3
GBR,SLV,2006.0,1,0,1
NLD,ETH,1998.0,2,0,2
FRO,DEU,2003.0,1,0,1
DEU,FRO,2009.0,1,0,1
GEO,ARM,2016.0,1,0,1
DEU,OMN,2010.0,5,0,5
NGA,PRT,2003.0,1,0,1
BGD,AUS,2000.0,1,0,1
WSM,ITA,1999.0,1,0,1
UGA,COD,1998.0,1,0,1
GRC,KWT,2014.0,2,0,2
IRN,QAT,2012.0,2,0,2
BRA,TUR,2011.0,2,0,2
SLV,HND,2020.0,1,0,1
CHL,FIN,2006.0,1,0,1
NOR,JOR,2001.0,1,0,1
BRA,BLR,2004.0,1,0,1
PRT,ARG,2007.0,2,0,2
BRB,TTO,2002.0,1,0,1
AUS,ECU,2004.0,3,0,3
NLD,ZMB,2001.0,1,0,1
PRT,SDN,2008.0,1,0,1
SVK,PRT,2015.0,1,0,1
GBR,GNB,2004.0,1,0,1
AUT,TZA,2007.0,1,0,1
SEN,BFA,2007.0,2,0,2
FRA,GEO,2008.0,2,0,2
NOR,ARE,2001.0,1,0,1
BGR,NZL,2009.0,1,0,1
FRA,KAZ,2012.0,1,0,1
MWI,MMR,2012.0,1,0,1
COL,SWE,2008.0,3,0,3
COL,LKA,2017.0,1,0,1
SVN,RUS,2014.0,1,0,1
ARG,ECU,2007.0,1,0,1
MNE,TUR,2017.0,1,0,1
MEX,SAU,2006.0,1,0,1
IND,MAR,2003.0,2,0,2
,VIR,1995.0,3,0,3
KOR,TUN,1999.0,1,0,1
NPL,AUT,2023.0,2,0,2
DOM,,2008.0,3,0,3
ECU,URY,2014.0,1,0,1
ZAF,BFA,2003.0,1,0,1
UGA,SLE,2017.0,2,0,2
ZWE,ETH,2009.0,1,0,1
TZA,KEN,2002.0,2,0,2
GBR,BHS,2015.0,2,0,2
CAN,ISL,2004.0,1,0,1
CAN,ISL,2008.0,3,0,3
JPN,LBY,2013.0,1,0,1
TGO,ZAF,2004.0,2,0,2
BTN,IND,2009.0,2,0,2
NZL,GMB,2023.0,1,0,1
NIC,CRI,2010.0,1,0,1
CHN,IRQ,2009.0,4,0,4
ESP,MUS,2020.0,1,0,1
GRD,,2013.0,7,0,7
SDN,IRQ,2012.0,1,0,1
CHE,MAR,2012.0,1,0,1
CZE,THA,2012.0,1,0,1
HRV,HUN,2009.0,1,0,1
IRN,SGP,2006.0,1,0,1
CRI,BOL,2012.0,1,0,1
IRN,SDN,2013.0,1,0,1
ESP,AGO,2018.0,2,0,2
GBR,VCT,2013.0,1,0,1
ZWE,MOZ,2011.0,3,0,3
JPN,ARE,2017.0,5,0,5
LTU,IRN,2005.0,1,0,1
ISL,PRT,2023.0,1,0,1
LBY,ITA,2014.0,1,0,1
CHN,LKA,2014.0,2,0,2
CHN,BEN,2016.0,1,0,1
CMR,NOR,2017.0,1,0,1
,REU,1996.0,2,0,2
BFA,ZAF,2017.0,2,0,2
CIV,GBR,2013.0,1,0,1
GMB,JPN,2014.0,1,0,1
TGO,TUN,2016.0,1,0,1
AUS,PSE,2010.0,1,0,1
NOR,IND,1999.0,1,0,1
HKG,FIN,2020.0,4,0,4
BLR,SRB,2002.0,4,0,4
DZA,ARE,2015.0,3,0,3
LKA,SYC,2011.0,1,0,1
SYC,,2017.0,5,0,5
NZL,TWN,2010.0,5,0,5
GBR,BEN,2011.0,3,0,3
KWT,BHR,1997.0,1,0,1
KWT,BHR,2012.0,1,0,1
USA,TGO,2015.0,1,0,1
SYR,MEX,2013.0,1,0,1
EST,ISR,1999.0,1,0,1
HKG,ZAF,2005.0,2,0,2
PAK,HRV,2016.0,1,0,1
CIV,MLI,2014.0,2,0,2
BHR,SDN,2020.0,2,0,2
SWE,SVN,1998.0,2,0,2
SRB,SVN,1999.0,4,0,4
LBN,SEN,2008.0,1,0,1
USA,MSR,2017.0,2,0,2
CAF,TUN,2019.0,1,0,1
MYS,BRA,2023.0,1,0,1
,WSM,2011.0,2,0,2
MYS,BWA,2020.0,2,0,2
BRA,BFA,2000.0,1,0,1
GBR,MDG,2003.0,1,0,1
POL,IRQ,2016.0,1,0,1
MLI,GIN,2016.0,2,0,2
SRB,NOR,2017.0,2,0,2
DEU,THA,1997.0,1,0,1
LBN,BHR,2020.0,1,0,1
GHA,TUR,2018.0,1,0,1
MLI,BFA,2023.0,3,0,3
LKA,ESP,2020.0,3,0,3
SWE,SDN,2020.0,2,0,2
NGA,MOZ,2015.0,1,0,1
MYS,AUT,2022.0,2,0,2
ZAF,TUN,2019.0,6,0,6
PRI,MEX,2000.0,1,0,1
BGR,AZE,2020.0,1,0,1
HRV,BLR,2020.0,1,0,1
ARG,PAK,2019.0,1,0,1
CAN,TZA,2009.0,2,0,2
MRT,CAN,2015.0,1,0,1
SYR,AUS,2009.0,2,0,2
THA,NPL,2002.0,2,0,2
ESP,CPV,2022.0,1,0,1
GMB,TWN,2022.0,1,0,1
SLE,JPN,2020.0,1,0,1
RUS,LVA,2006.0,2,0,2
SDN,EGY,2018.0,2,0,2
FIN,LIE,2010.0,1,0,1
BEL,CRI,2019.0,3,0,3
GBR,PLW,2022.0,1,0,1
SGP,LAO,2022.0,1,0,1
EST,LTU,2006.0,2,0,2
MYS,POL,2022.0,2,0,2
GIN,ESP,2022.0,1,0,1
NZL,UKR,2023.0,1,0,1
GRC,CZE,2023.0,2,0,2
MLI,COD,2023.0,1,0,1
RUS,LTU,2002.0,1,0,1
GBR,PRY,2022.0,1,0,1
KGZ,ROU,2022.0,1,0,1
FRA,OMN,2022.0,1,0,1
CUB,CHE,2023.0,2,0,2
UGA,FRA,2023.0,1,0,1
BFA,GMB,2022.0,1,0,1
CYP,CMR,2022.0,1,0,1
DEU,PRI,2000.0,3,0,3
DEU,BFA,2005.0,2,0,2
BRB,,2002.0,4,0,4
JPN,MKD,2001.0,1,0,1
VGB,USA,2014.0,1,0,1
THA,OMN,2013.0,4,0,4
ASM,THA,1999.0,1,0,1
MWI,CMR,2001.0,1,0,1
MYS,BRN,1998.0,1,0,1
LAO,LKA,2020.0,2,0,2
HKG,CHL,2016.0,2,0,2
SAU,ESP,1997.0,1,0,1
SGP,KWT,2010.0,1,0,1
NZL,BRN,2003.0,2,0,2
ESP,TWN,1999.0,2,0,2
NIC,SWE,2001.0,3,0,3
GAB,CAF,2008.0,1,0,1
ESP,TWN,2007.0,2,0,2
,BMU,2001.0,1,0,1
ZWE,MEX,2015.0,1,0,1
EGY,BGD,2010.0,1,0,1
JPN,GHA,2006.0,3,0,3
CAN,BLR,2014.0,1,0,1
GBR,NCL,2010.0,1,0,1
SVN,TUR,2003.0,1,0,1
PER,CHN,2000.0,1,0,1
PRT,HUN,2017.0,2,0,2
CHN,ROU,2005.0,1,0,1
TUN,MRT,2018.0,1,0,1
KEN,OMN,2012.0,1,0,1
BGR,DNK,2009.0,1,0,1
SWE,NGA,1998.0,1,0,1
TWN,JOR,2000.0,1,0,1
SVK,NLD,1997.0,3,0,3
NGA,ESP,1997.0,2,0,2
IND,AGO,2009.0,1,0,1
MYS,UZB,2019.0,3,0,3
DEU,URY,1998.0,1,0,1
SGP,TJK,2016.0,1,0,1
LBR,ZAF,2011.0,1,0,1
BGR,PAK,2012.0,1,0,1
SAU,NZL,2003.0,1,0,1
ARG,BGR,2010.0,1,0,1
IRL,KEN,2017.0,1,0,1
GBR,BEN,2019.0,2,0,2
LBN,PHL,2021.0,1,0,1
USA,BRN,2015.0,1,0,1
LTU,PRT,2019.0,1,0,1
BEN,RUS,2017.0,1,0,1
BRN,BHR,2016.0,1,0,1
SYR,ROU,2016.0,1,0,1
BRN,THA,2007.0,2,0,2
BTN,AUT,2014.0,1,0,1
CYP,COL,2015.0,1,0,1
ISR,EGY,2020.0,1,0,1
CMR,BFA,2018.0,1,0,1
CHN,TGO,2022.0,3,0,3
COG,CUB,2015.0,1,0,1
POL,DZA,2022.0,2,0,2
SWZ,NLD,2017.0,1,0,1
MCO,ITA,2019.0,4,0,4
CMR,DEU,2022.0,7,0,7
PLW,,2007.0,2,0,2
PNG,NLD,2018.0,1,0,1
MNG,CHE,2019.0,2,0,2
FRA,GNB,2017.0,1,0,1
YEM,SDN,2019.0,1,0,1
MAR,BDI,2018.0,1,0,1
ZAF,DZA,2019.0,1,0,1
GUF,GIN,2015.0,1,0,1
NIC,ARG,2021.0,1,0,1
PAK,MEX,2021.0,3,0,3
PSE,NOR,2019.0,5,0,5
NZL,KHM,2019.0,1,0,1
BGR,FIN,2021.0,1,0,1
NER,MAR,2017.0,1,0,1
IRL,LTU,2022.0,1,0,1
ZMB,CHN,2010.0,1,0,1
AUT,KAZ,2023.0,1,0,1
CIV,MLI,2004.0,1,0,1
KOR,LAO,2022.0,2,0,2
ERI,ETH,2020.0,2,0,2
RWA,JPN,2024.0,1,0,1
CHN,LBN,2023.0,3,0,3
MYS,BHR,2022.0,3,0,3
SYR,CHN,2022.0,1,0,1
IDN,HND,2023.0,1,0,1
SOM,BRA,2023.0,1,0,1
GNQ,,2008.0,1,0,1
AUT,BMU,2012.0,1,0,1
CHN,BDI,2008.0,1,0,1
ZMB,NLD,2008.0,1,0,1
CAN,PRI,2010.0,2,0,2
HRV,DZA,2010.0,1,0,1
NAM,MWI,2006.0,1,0,1
NAM,GBR,2001.0,2,0,2
VEN,AUS,2023.0,1,0,1
SLE,KEN,2012.0,1,0,1
PRI,DNK,2008.0,2,0,2
PAK,GMB,2015.0,1,0,1
CAN,ECU,2014.0,1,0,1
PAK,KWT,2016.0,2,0,2
SEN,CAN,2003.0,1,0,1
NOR,SVN,2017.0,2,0,2
NLD,LKA,2011.0,2,0,2
CYM,,2019.0,1,0,1
VCT,BRB,2013.0,1,0,1
LKA,BRN,2012.0,2,0,2
FJI,PRT,2022.0,1,0,1
BRA,TWN,2001.0,1,0,1
SYR,TUR,2009.0,1,0,1
DEU,CIV,2002.0,3,0,3
CUB,JAM,2007.0,1,0,1
MYS,NCL,2006.0,1,0,1
VEN,HUN,2002.0,1,0,1
ZAF,GIN,2006.0,1,0,1
IND,SYR,2008.0,1,0,1
GRC,HKG,1999.0,1,0,1
AUT,ALB,2017.0,2,0,2
NGA,MEX,2018.0,2,0,2
TWN,BHR,2016.0,1,0,1
STP,,2021.0,2,0,2
MDA,MDV,2018.0,1,0,1
GIN,COD,2019.0,1,0,1
HRV,NOR,2013.0,2,0,2
IND,MMR,2016.0,3,0,3
STP,,2019.0,2,0,2
TWN,SVN,2013.0,2,0,2
COG,ZMB,2023.0,1,0,1
DZA,NOR,2007.0,1,0,1
RUS,ETH,2017.0,2,0,2
ITA,SYC,2022.0,1,0,1
CMR,ETH,2017.0,1,0,1
KHM,MMR,2014.0,1,0,1
FRA,JOR,2020.0,2,0,2
AZE,EGY,2017.0,1,0,1
TWN,GMB,2023.0,1,0,1
NLD,GUF,2021.0,1,0,1
,SHN,2016.0,1,0,1
GBR,AND,2021.0,1,0,1
SVK,HRV,1998.0,1,0,1
CIV,SEN,2010.0,1,0,1
LBY,EGY,2004.0,1,0,1
CYP,EGY,2006.0,1,0,1
OMN,CYP,2014.0,1,0,1
DEU,UGA,1998.0,2,0,2
CHN,GEO,2010.0,1,0,1
NLD,MLT,2015.0,1,0,1
KOR,MLT,2022.0,1,0,1
CRI,RUS,2009.0,1,0,1
JPN,NGA,1997.0,2,0,2
SWE,ZMB,2002.0,1,0,1
SRB,SVN,1998.0,2,0,2
DEU,MOZ,1997.0,1,0,1
POL,GEO,2007.0,1,0,1
KWT,SLE,2023.0,1,0,1
UKR,KWT,2011.0,1,0,1
THA,COG,2018.0,1,0,1
CAN,CYP,2010.0,4,0,4
GEO,GBR,2002.0,2,0,2
LCA,BRB,2016.0,1,0,1
USA,LCA,2019.0,1,0,1
SRB,BGR,2000.0,1,0,1
CAN,MTQ,2003.0,1,0,1
NPL,FJI,2000.0,1,0,1
NZL,RUS,2011.0,2,0,2
MDA,SWE,2002.0,1,0,1
NGA,CRI,2001.0,1,0,1
PSE,ISL,2022.0,1,0,1
ZWE,KEN,2014.0,1,0,1
GIB,USA,2009.0,1,0,1
POL,KGZ,2004.0,2,0,2
PNG,VIR,2001.0,1,0,1
NGA,BFA,2021.0,2,0,2
COL,SWE,2004.0,1,0,1
MWI,FRA,2000.0,2,0,2
ZWE,CHE,2002.0,1,0,1
EGY,BHR,2007.0,1,0,1
MNG,AUT,2004.0,1,0,1
ARG,CRI,2005.0,1,0,1
BDI,,2018.0,4,0,4
RUS,MNE,2014.0,2,0,2
FIN,MWI,2004.0,1,0,1
BEL,KHM,2002.0,1,0,1
BWA,HUN,2009.0,1,0,1
HUN,BWA,2012.0,1,0,1
UKR,KEN,2018.0,1,0,1
ZAF,SGP,2001.0,2,0,2
JOR,IRN,2011.0,2,0,2
HUN,LBN,2016.0,1,0,1
ARE,HKG,2003.0,1,0,1
HTI,LBR,2017.0,1,0,1
IND,QAT,1998.0,1,0,1
SVK,LTU,2017.0,1,0,1
GRC,CMR,2014.0,1,0,1
ISR,LBN,2013.0,1,0,1
MNE,AUT,2019.0,2,0,2
HKG,LUX,2016.0,1,0,1
AUS,VUT,2004.0,2,0,2
MYS,CHN,2003.0,5,0,5
POL,KOR,2001.0,2,0,2
MCO,KOR,2010.0,1,0,1
NZL,TWN,2006.0,3,0,3
ARE,KOR,2008.0,1,0,1
THA,TZA,2013.0,2,0,2
KWT,POL,2001.0,1,0,1
KOR,SYR,2018.0,1,0,1
CHN,NIC,2017.0,1,0,1
RUS,THA,2012.0,1,0,1
MNG,HUN,2019.0,1,0,1
CHN,ZMB,2023.0,2,0,2
,NRU,2014.0,1,0,1
KOR,LAO,2018.0,1,0,1
MDG,CHN,2019.0,1,0,1
MYS,KWT,2009.0,1,0,1
GBR,COM,2021.0,1,0,1
ZWE,KOR,2021.0,3,0,3
VNM,KHM,2020.0,1,0,1
NZL,UGA,2023.0,1,0,1
,AIA,2017.0,3,0,3
ALB,,2026.0,5,0,5
CHN,SYR,2001.0,1,0,1
ISR,SLE,2022.0,1,0,1
,PYF,2020.0,2,0,2
,KHM,2020.0,48,0,48
,BDI,2020.0,8,0,8
ETH,SAU,2016.0,1,0,1
FLK,GBR,2010.0,2,0,2
ARE,GRC,2009.0,2,0,2
,NCL,2001.0,7,0,7
LSO,DEU,2007.0,1,0,1
BGR,ESP,2014.0,2,0,2
SAU,AFG,2017.0,1,0,1
SDN,USA,1998.0,1,0,1
GNQ,PRT,2008.0,4,0,4
ETH,UGA,2001.0,1,0,1
FRA,NPL,2014.0,1,0,1
NGA,ARG,2007.0,1,0,1
BRN,,2001.0,5,0,5
SLE,THA,2022.0,1,0,1
CAN,CIV,2012.0,2,0,2
CHN,UKR,2007.0,2,0,2
PRY,FRA,2001.0,1,0,1
PRT,TUN,2019.0,4,0,4
VEN,GRD,2017.0,1,0,1
TWN,THA,2004.0,2,0,2
HUN,TWN,2011.0,1,0,1
NZL,AUT,2004.0,2,0,2
MLI,ETH,2019.0,1,0,1
CAF,MWI,2002.0,1,0,1
CAF,VNM,2008.0,1,0,1
TWN,SGP,2001.0,3,4,-1
JPN,PAK,2012.0,13,6,7
EGY,JOR,2006.0,5,1,4
IND,PRT,2003.0,5,1,4
PHL,DEU,2013.0,3,5,-2
EGY,CHE,2011.0,2,3,-1
RUS,ZAF,2014.0,5,4,1
PSE,GBR,2014.0,3,3,0
VEN,ARG,2012.0,2,1,1
GBR,GMB,2011.0,5,9,-4
PHL,IRN,2015.0,1,1,0
BEL,NPL,2010.0,3,1,2
MEX,ZAF,2018.0,3,1,2
ZAF,SAU,1998.0,3,6,-3
USA,GRD,2021.0,9,21,-12
NOR,TUR,2007.0,2,2,0
AUT,LKA,2019.0,1,1,0
PRI,VEN,1998.0,1,1,0
PRT,CAN,2015.0,16,9,7
DNK,POL,2006.0,2,5,-3
FRA,BGD,2009.0,1,2,-1
ITA,BGR,1999.0,4,10,-6
MAR,MAC,2011.0,10,9,1
FRA,TCD,2013.0,1,1,0
MKD,HRV,2000.0,1,1,0
EGY,LBN,2010.0,3,2,1
PSE,JOR,1999.0,1,2,-1
TUR,CHE,1999.0,7,4,3
AUS,CZE,2008.0,5,6,-1
EGY,KWT,2002.0,6,6,0
FRA,IDN,1999.0,8,4,4
ITA,NZL,2001.0,2,5,-3
BRA,POL,2009.0,1,1,0
AUT,SGP,2009.0,4,2,2
DEU,SEN,2002.0,1,1,0
BWA,IND,2014.0,2,2,0
ECU,CAN,2022.0,4,4,0
ISR,SWE,2015.0,3,4,-1
UGA,DEU,2011.0,1,1,0
IRL,KOR,2009.0,1,5,-4
ITA,MDG,2015.0,1,1,0
IRL,ESP,2007.0,10,15,-5
TJK,RUS,2021.0,3,2,1
KOR,IRL,2012.0,4,4,0
ETH,IND,2005.0,6,4,2
IND,MEX,2001.0,6,5,1
UKR,BEL,2005.0,2,4,-2
NIC,BEL,2016.0,1,1,0
MDG,FRA,2012.0,5,17,-12
KAZ,GBR,2012.0,1,5,-4
EST,POL,2019.0,2,1,1
SWE,ARG,2022.0,4,5,-1
IRL,ARE,2022.0,2,4,-2
ROU,POL,2017.0,5,1,4
ESP,GRC,2023.0,14,15,-1
DNK,PHL,2019.0,2,1,1
ISR,KAZ,2019.0,2,4,-2
IRN,DEU,2024.0,1,1,0
USA,BEN,2022.0,4,2,2
FRA,NZL,2003.0,5,7,-2
DNK,SGP,2013.0,7,5,2
JOR,FRA,2011.0,1,4,-3
FRA,IDN,1998.0,3,5,-2
ISR,NLD,2004.0,11,6,5
IRL,CZE,2017.0,1,3,-2
IRL,OMN,2019.0,1,3,-2
NOR,EST,2003.0,2,2,0
NOR,TWN,2023.0,2,1,1
FJI,GBR,2014.0,2,6,-4
IRQ,ARE,2018.0,2,1,1
ITA,PER,1997.0,1,1,0
KEN,BWA,2012.0,2,1,1
MDA,ROU,2013.0,3,2,1
ZAF,CMR,2012.0,4,2,2
HUN,NLD,2007.0,3,10,-7
SAU,AUT,2002.0,1,2,-1
MEX,PRT,2007.0,1,3,-2
IND,BRA,2012.0,7,6,1
AUT,SVN,2011.0,2,3,-1
RUS,GEO,2023.0,4,4,0
FIN,KAZ,2017.0,1,2,-1
SAU,SWE,2012.0,2,4,-2
UZB,JPN,2018.0,2,3,-1
AUT,GRC,2018.0,5,7,-2
GEO,CHE,2004.0,1,1,0
SWE,VNM,2017.0,5,2,3
CHL,AUS,2001.0,3,2,1
NLD,NGA,1998.0,1,1,0
OMN,IRL,2019.0,3,1,2
MOZ,ZAF,2010.0,2,4,-2
LBN,LBY,2013.0,3,1,2
FIN,DNK,2001.0,5,7,-2
VNM,DNK,2012.0,1,4,-3
GBR,BWA,2006.0,5,3,2
ARG,CHN,2015.0,1,1,0
COG,FRA,2007.0,2,11,-9
BFA,CIV,2012.0,1,2,-1
SRB,BGR,2020.0,1,2,-1
DNK,TWN,2023.0,1,2,-1
IRQ,JOR,2017.0,5,4,1
BWA,ZWE,2023.0,1,4,-3
UKR,ISR,2013.0,1,1,0
MEX,ISR,2007.0,2,4,-2
FIN,UKR,2013.0,1,2,-1
SGP,KOR,2004.0,3,5,-2
GBR,BRB,2003.0,2,1,1
ARE,ZAF,2023.0,2,4,-2
PRT,IND,2009.0,5,14,-9
CUB,DEU,2010.0,4,2,2
NGA,BRA,2022.0,3,5,-2
CHN,ETH,2017.0,3,13,-10
ITA,IRQ,2016.0,1,1,0
CAN,PSE,2021.0,1,3,-2
TWN,ITA,2020.0,3,4,-1
ZAF,AUT,2010.0,2,2,0
GBR,SDN,2017.0,4,2,2
LTU,RUS,2021.0,3,2,1
IDN,PHL,2022.0,3,4,-1
USA,BRB,2013.0,4,3,1
DEU,PSE,2016.0,7,3,4
GNB,PRT,2013.0,1,1,0
VEN,ITA,2004.0,1,1,0
SWE,TWN,2009.0,2,3,-1
PRT,FIN,2010.0,1,4,-3
DZA,SAU,2017.0,5,5,0
AUS,PER,2018.0,2,2,0
NOR,IRL,2018.0,3,6,-3
FRA,GAB,1998.0,7,2,5
SGP,QAT,2016.0,2,1,1
JOR,NGA,2022.0,1,1,0
SAU,NLD,2016.0,2,11,-9
CAN,IRN,2024.0,1,6,-5
COG,BEL,2018.0,3,10,-7
ARE,RUS,2022.0,1,3,-2
ITA,UKR,2022.0,5,3,2
FIN,BEL,2008.0,5,2,3
CAN,ISL,1999.0,3,2,1
AUT,ISR,2006.0,1,5,-4
FIN,POL,2003.0,4,4,0
THA,NZL,2001.0,3,2,1
ETH,USA,2012.0,20,13,7
ROU,AUT,2002.0,4,1,3
UGA,NOR,2007.0,2,3,-1
AUS,LKA,2009.0,2,5,-3
BEL,SRB,2003.0,5,2,3
SVN,RUS,2020.0,3,4,-1
CHE,TWN,2020.0,3,8,-5
KOR,HKG,2002.0,2,3,-1
QAT,GBR,1998.0,2,1,1
ZWE,USA,1999.0,8,6,2
CHN,NZL,2004.0,2,5,-3
GBR,MUS,2010.0,3,2,1
USA,BHR,2000.0,1,2,-1
JPN,NGA,2013.0,5,2,3
JOR,NLD,2017.0,2,1,1
DEU,PAN,2005.0,1,1,0
PHL,KOR,2008.0,4,1,3
NOR,BWA,2011.0,1,1,0
EGY,DEU,2005.0,7,32,-25
BEL,BEN,2008.0,6,1,5
NLD,ARE,2012.0,3,1,2
PRT,MEX,2019.0,5,5,0
IRL,MEX,2009.0,2,4,-2
DNK,ZAF,2012.0,1,3,-2
TWN,HKG,2013.0,14,4,10
GHA,BEN,2018.0,1,1,0
MLI,FRA,2010.0,12,11,1
LUX,AUS,2018.0,3,1,2
FRO,DNK,2013.0,1,1,0
GBR,BHS,2020.0,3,2,1
TUR,EGY,2023.0,1,3,-2
ALB,USA,2021.0,3,2,1
PRT,FIN,2014.0,10,4,6
CHE,ZMB,2013.0,1,1,0
HUN,SRB,2015.0,5,3,2
KOR,TWN,2002.0,4,6,-2
PSE,TUR,2015.0,1,1,0
TGO,BFA,2019.0,2,3,-1
ITA,ETH,2023.0,1,3,-2
ETH,GBR,2010.0,5,12,-7
ECU,FRA,2010.0,3,3,0
TUR,BGD,2020.0,6,1,5
MMR,THA,2013.0,1,3,-2
COL,ECU,2009.0,2,1,1
MMR,JPN,2021.0,6,18,-12
NGA,BRN,2021.0,4,1,3
ARE,POL,2020.0,3,4,-1
ROU,ESP,1998.0,3,1,2
NGA,AUS,2009.0,1,3,-2
UKR,DNK,2004.0,1,1,0
ARM,TWN,2009.0,1,1,0
IRN,ITA,2001.0,2,2,0
TUN,BEL,2002.0,2,3,-1
BEN,NGA,2004.0,5,1,4
FRA,ARM,2003.0,2,1,1
NZL,SWE,2001.0,7,5,2
UZB,BEL,2001.0,3,1,2
NLD,OMN,2002.0,1,2,-1
ARG,FRA,1997.0,10,19,-9
FRA,PER,2019.0,10,6,4
BEL,NZL,2001.0,5,2,3
DZA,DEU,2017.0,4,5,-1
TWN,NLD,2017.0,5,4,1
UKR,CAN,2014.0,5,3,2
ITA,ALB,2013.0,8,2,6
ISR,AUS,2014.0,21,15,6
LBN,CAN,2010.0,4,7,-3
TUR,CYP,2024.0,1,3,-2
DNK,TUR,2011.0,7,3,4
NPL,GBR,2005.0,6,4,2
SWE,ZWE,2017.0,1,3,-2
FIN,MEX,2014.0,1,3,-2
CHE,FIN,2006.0,6,11,-5
BEL,BEN,2015.0,4,2,2
BEL,BGD,2009.0,1,1,0
DEU,MNG,2021.0,1,4,-3
NGA,NZL,2018.0,3,2,1
ITA,HRV,2001.0,5,2,3
ISL,DNK,2008.0,3,2,1
ISR,DNK,1997.0,3,3,0
BEL,KEN,2015.0,4,1,3
FRA,CAF,2002.0,3,3,0
MYS,SDN,2014.0,7,3,4
GEO,BEL,2022.0,1,1,0
BEL,CMR,2023.0,3,5,-2
ISL,DNK,2004.0,2,6,-4
RUS,NOR,2001.0,7,12,-5
FIN,HUN,2002.0,5,1,4
FIN,TUR,2003.0,2,2,0
SWE,THA,2019.0,9,5,4
ZAF,AUT,2008.0,3,3,0
BEN,BEL,2012.0,2,4,-2
NLD,MYS,2012.0,9,4,5
KWT,FIN,2019.0,1,1,0
CUB,FRA,2015.0,5,5,0
QAT,CUB,2016.0,3,1,2
PRT,TUN,2022.0,2,2,0
DEU,TZA,2017.0,4,6,-2
SAU,YEM,2015.0,3,13,-10
ARE,NGA,2020.0,1,3,-2
NGA,ZWE,2016.0,2,1,1
MYS,KHM,2022.0,1,3,-2
ITA,BGD,2020.0,3,4,-1
TZA,KOR,2021.0,3,5,-2
IRQ,ESP,2018.0,1,1,0
HKG,MYS,2004.0,1,2,-1
ESP,HUN,2013.0,5,7,-2
KAZ,RUS,2022.0,12,57,-45
LVA,GBR,2022.0,3,3,0
HRV,SVN,2002.0,9,7,2
UKR,CAN,2008.0,4,4,0
CAN,DZA,2007.0,3,4,-1
KEN,SWE,2005.0,2,2,0
BIH,HRV,2000.0,6,8,-2
MEX,AUT,2001.0,2,2,0
GBR,ETH,2015.0,6,10,-4
RUS,TJK,2012.0,1,1,0
BGR,CAN,2015.0,1,3,-2
DNK,ISR,2000.0,3,1,2
IRN,CHE,2005.0,3,2,1
USA,LKA,2008.0,11,8,3
DZA,GBR,2005.0,2,3,-1
BRB,CAN,2009.0,1,1,0
NZL,KOR,2012.0,3,2,1
NGA,TZA,2015.0,1,3,-2
GMB,MWI,2008.0,1,1,0
BLR,SWE,2005.0,3,1,2
BOL,PER,2018.0,1,1,0
RUS,KAZ,2000.0,10,10,0
CZE,ZAF,2021.0,1,7,-6
BOL,ESP,2006.0,1,4,-3
DNK,SVN,2013.0,2,1,1
PAN,DEU,2013.0,1,3,-2
AUT,BIH,2005.0,3,1,2
FRA,MDA,2008.0,2,1,1
HRV,SWE,2020.0,6,1,5
KEN,ZAF,2008.0,3,8,-5
MOZ,ESP,2017.0,6,3,3
HKG,BEL,2010.0,1,2,-1
SDN,AUS,2021.0,1,1,0
USA,AZE,2006.0,1,1,0
GRC,SVN,2019.0,2,1,1
ITA,COL,2009.0,2,3,-1
PRT,DEU,2000.0,10,11,-1
UKR,MDA,2018.0,1,1,0
ROU,CZE,2016.0,1,2,-1
NZL,ZAF,2023.0,2,2,0
PAN,CAN,2019.0,1,1,0
ARE,NZL,2006.0,2,2,0
AUT,SRB,2000.0,2,1,1
AUT,ISR,2000.0,2,7,-5
URY,GBR,2013.0,2,4,-2
FRA,BOL,2005.0,5,5,0
LKA,CAN,1998.0,1,1,0
NOR,NZL,2002.0,2,6,-4
CHE,SVN,2007.0,2,3,-1
UKR,ITA,2017.0,3,3,0
FRA,REU,2002.0,3,6,-3
CYP,NLD,2019.0,3,5,-2
CAN,SVN,2008.0,1,2,-1
DEU,SDN,2010.0,2,5,-3
PSE,ISR,2009.0,8,15,-7
COL,AUT,2014.0,2,3,-1
ALB,FRA,2017.0,1,1,0
CHE,HUN,2008.0,5,11,-6
IDN,CHE,2014.0,1,4,-3
BGR,AUT,2015.0,2,1,1
NGA,DZA,2010.0,2,1,1
IDN,BGD,2021.0,1,2,-1
SGP,SWE,2011.0,7,9,-2
SWE,ISR,2019.0,3,7,-4
HKG,MYS,2015.0,3,6,-3
BRN,PAK,2017.0,1,2,-1
AUS,NGA,2016.0,2,5,-3
CHE,TZA,2008.0,3,2,1
SWE,IRL,2004.0,5,2,3
JOR,KOR,2014.0,1,2,-1
OMN,IND,2010.0,4,23,-19
SAU,MEX,2022.0,3,3,0
THA,DNK,2017.0,3,4,-1
NPL,VNM,2019.0,1,2,-1
SYR,BEL,2012.0,1,2,-1
TUR,BEL,2001.0,2,5,-3
USA,BMU,2002.0,3,3,0
CHL,DOM,2015.0,2,1,1
ECU,MEX,2019.0,6,20,-14
COL,DEU,2001.0,9,1,8
SWE,BGD,2012.0,1,7,-6
BRA,VEN,2016.0,6,6,0
ISL,DNK,2015.0,2,2,0
PHL,CHE,1997.0,1,2,-1
KEN,AUT,2022.0,1,3,-2
IRL,POL,2020.0,6,5,1
SRB,ALB,2006.0,1,1,0
SAU,ROU,2016.0,1,2,-1
KEN,ITA,2014.0,3,3,0
AFG,MYS,2020.0,1,8,-7
POL,TUR,2014.0,1,2,-1
LUX,CHN,2015.0,1,1,0
DZA,ITA,2015.0,1,9,-8
LTU,BRA,2018.0,1,1,0
NOR,BGD,2020.0,1,2,-1
HUN,FIN,2018.0,3,3,0
NGA,ARE,2023.0,3,2,1
KEN,ESP,2018.0,1,4,-3
KOR,KAZ,2023.0,3,3,0
USA,HND,2023.0,3,3,0
TUR,PAK,2015.0,4,16,-12
AUS,BRA,2009.0,10,18,-8
KEN,CHN,2013.0,5,6,-1
MEX,IRL,2010.0,2,1,1
KEN,ITA,2008.0,5,1,4
GIN,SLE,2001.0,1,0,1
GRD,USA,1997.0,1,0,1
GLP,,2010.0,7,0,7
TTO,GLP,2013.0,1,0,1
ECU,DOM,2010.0,1,0,1
DOM,ECU,2012.0,1,0,1
SLV,CHL,2011.0,1,0,1
ARE,NOR,2002.0,1,0,1
SRB,SAU,2013.0,3,0,3
COG,CIV,2015.0,1,0,1
UGA,GHA,2016.0,2,0,2
CHE,VEN,2017.0,1,0,1
ROU,MKD,2018.0,1,0,1
DZA,IND,2014.0,1,0,1
CZE,TWN,2000.0,1,0,1
KAZ,LTU,2011.0,1,0,1
SWE,ARE,2022.0,7,0,7
MAR,BFA,2012.0,1,0,1
RUS,LTU,2015.0,3,0,3
DEU,TGO,2011.0,1,0,1
CIV,TUN,2012.0,1,0,1
PRT,MLT,2021.0,1,0,1
GIN,BFA,2018.0,1,0,1
ZMB,SWZ,2020.0,1,0,1
SVK,MEX,2006.0,1,0,1
FRA,GEO,2012.0,2,0,2
IRL,TUR,2013.0,3,0,3
CHN,LUX,2009.0,2,0,2
BEL,LTU,2021.0,3,0,3
MDA,KAZ,2016.0,2,0,2
BEL,NAM,2003.0,1,0,1
NZL,LUX,2015.0,2,0,2
PHL,CIV,2019.0,1,0,1
MAC,MKD,2021.0,1,0,1
BHR,AUS,2014.0,1,0,1
TKM,,2016.0,4,0,4
PRT,THA,2019.0,2,0,2
,MTQ,2016.0,5,0,5
AIA,USA,2019.0,1,0,1
CUB,SLV,2023.0,1,0,1
KOR,PRT,2019.0,4,0,4
FJI,TON,2021.0,1,0,1
MKD,CZE,2020.0,2,0,2
IND,LCA,2016.0,1,0,1
MYS,SOM,2021.0,1,0,1
BEL,BOL,2022.0,1,0,1
UKR,SGP,2019.0,2,0,2
MYS,MUS,2021.0,1,0,1
NOR,MMR,2020.0,1,0,1
,RWA,2001.0,5,0,5
,GUM,2016.0,1,0,1
PRT,PAK,2009.0,1,0,1
GBR,CPV,2013.0,1,0,1
GEO,AUT,2019.0,1,0,1
BHS,,2013.0,2,0,2
KOR,SVK,2020.0,1,0,1
,GUF,2012.0,13,0,13
NOR,SOM,2019.0,2,0,2
KAZ,TKM,2019.0,1,0,1
ETH,SDN,2009.0,1,0,1
AUT,MAR,2013.0,2,0,2
JPN,SVN,1999.0,2,0,2
KNA,PRI,2022.0,1,0,1
PER,PHL,2021.0,2,0,2
MOZ,BEN,2023.0,1,0,1
THA,SOM,2022.0,1,0,1
BHR,SGP,2021.0,1,0,1
BGD,FRA,2008.0,1,0,1
IND,LKA,2023.0,3,0,3
ITA,CHL,1999.0,1,0,1
OMN,QAT,2010.0,2,0,2
MEX,IRN,2005.0,2,0,2
BEL,ETH,1997.0,1,0,1
SEN,NPL,2003.0,1,0,1
CHE,UKR,2010.0,2,0,2
KGZ,,2005.0,2,0,2
USA,BEN,1999.0,1,0,1
ROU,BGR,2007.0,1,0,1
PYF,NCL,2017.0,3,0,3
PRY,CZE,2013.0,4,0,4
PER,ARG,2005.0,1,0,1
IRQ,JOR,1998.0,2,0,2
NPL,NLD,2007.0,3,0,3
LBN,CUB,2019.0,1,0,1
AZE,DEU,2003.0,1,0,1
NOR,BWA,2023.0,1,0,1
UKR,ZAF,2011.0,1,0,1
UZB,AUS,2005.0,1,0,1
PRT,POL,2000.0,2,0,2
NGA,GUY,2019.0,4,0,4
POL,THA,2002.0,1,0,1
IRQ,ARE,1999.0,1,0,1
IDN,CRI,1999.0,1,0,1
SVN,AUT,2004.0,5,0,5
DZA,MYS,2004.0,1,0,1
SEN,CHE,2006.0,1,0,1
ISR,PAN,1999.0,1,0,1
NGA,ETH,2008.0,1,0,1
BOL,ESP,2009.0,2,0,2
MEX,GRC,1999.0,1,0,1
ZAF,MEX,1999.0,1,0,1
MDA,UKR,1998.0,1,0,1
MTQ,BEL,2019.0,1,0,1
ISL,ISR,2015.0,1,0,1
HRV,SLV,2012.0,2,0,2
SEN,CHE,2000.0,1,0,1
AGO,COG,1997.0,2,0,2
ZAF,FIN,2001.0,1,0,1
ARM,AUS,1997.0,1,0,1
MEX,PAN,1997.0,1,0,1
MLI,BEL,2007.0,1,0,1
SAU,TUN,1997.0,1,0,1
USA,BRN,1997.0,1,0,1
SEN,ITA,1998.0,1,0,1
MAR,ETH,2000.0,1,0,1
TUR,BRA,2001.0,1,0,1
NLD,MLI,2007.0,2,0,2
AUS,BRN,2003.0,2,0,2
UKR,POL,2024.0,1,0,1
AUS,CYP,2011.0,4,0,4
CUB,ARE,2020.0,1,0,1
MTQ,,2003.0,3,0,3
CUB,PER,2016.0,3,0,3
AGO,CUB,2008.0,3,0,3
HUN,LBY,2005.0,2,0,2
URY,CUB,2009.0,1,0,1
HKG,ARE,2019.0,2,0,2
TUR,DNK,2008.0,5,0,5
TUR,TUN,2007.0,1,0,1
LKA,NOR,2013.0,2,0,2
AFG,CHN,2009.0,1,0,1
CUB,ETH,1998.0,1,0,1
TUR,SGP,2022.0,3,0,3
NAM,GBR,2012.0,1,0,1
NPL,PAK,2009.0,1,0,1
FIN,GRL,2010.0,1,0,1
GRL,,2017.0,6,0,6
ZWE,SWE,2009.0,1,0,1
MEX,EGY,2011.0,1,0,1
SYR,IRQ,2018.0,2,0,2
TWN,UKR,2011.0,2,0,2
MEX,PAN,2002.0,1,0,1
NLD,ALB,2020.0,3,0,3
KEN,VNM,2012.0,1,0,1
GUF,KHM,2023.0,1,0,1
RUS,SAU,2013.0,2,0,2
COD,SEN,2021.0,4,0,4
PRY,NOR,2019.0,1,0,1
GMB,GNB,2004.0,1,0,1
BEL,URY,2012.0,1,0,1
MWI,FRA,2018.0,2,0,2
IRN,ARE,2009.0,2,0,2
GRC,SVK,2017.0,2,0,2
SLV,MEX,2015.0,2,0,2
LVA,FIN,2016.0,1,0,1
NER,SAU,2017.0,1,0,1
IND,IRL,2002.0,3,0,3
EGY,NGA,2023.0,2,0,2
GHA,ISR,2011.0,1,0,1
POL,HKG,2015.0,1,0,1
SEN,ETH,2018.0,3,0,3
MDV,SAU,2015.0,1,0,1
MEX,ECU,2012.0,4,0,4
URY,CHN,2021.0,1,0,1
CUB,DNK,2015.0,1,0,1
ROU,FIN,1998.0,3,0,3
GBR,SUR,2019.0,1,0,1
MYS,RUS,2012.0,1,0,1
TUR,VEN,2012.0,1,0,1
SLV,ESP,2009.0,1,0,1
CAN,MLT,2014.0,1,0,1
GRL,USA,2001.0,1,0,1
ITA,LTU,2019.0,5,0,5
MAC,CHN,1999.0,3,0,3
,KIR,2011.0,3,0,3
GRD,GBR,2018.0,2,0,2
THA,JOR,2021.0,1,0,1
MEX,AUT,2003.0,1,0,1
IDN,RUS,2018.0,1,0,1
FRA,MRT,2015.0,1,0,1
PRT,HRV,2017.0,2,0,2
GBR,NCL,2016.0,1,0,1
THA,PAK,2007.0,1,0,1
BGD,SAU,2005.0,2,0,2
FRA,PAN,2022.0,2,0,2
HRV,RUS,2021.0,1,0,1
MDV,BGD,2019.0,1,0,1
CZE,HUN,2012.0,4,0,4
DOM,,2005.0,4,0,4
IDN,FIN,2013.0,2,0,2
UZB,KOR,2000.0,2,0,2
LVA,DNK,2008.0,2,0,2
PSE,NGA,2022.0,1,0,1
IRL,EGY,2008.0,1,0,1
MSR,USA,2005.0,1,0,1
USA,MSR,2006.0,2,0,2
ATF,AUT,2003.0,1,0,1
YEM,EGY,1997.0,1,0,1
LVA,CAN,1999.0,1,0,1
CAN,JAM,1997.0,1,0,1
SVN,FIN,2005.0,1,0,1
TTO,,2006.0,12,0,12
NOR,FRO,1998.0,1,0,1
JPN,COD,2011.0,1,0,1
COD,JPN,2012.0,1,0,1
AGO,NAM,2017.0,2,0,2
CAN,KHM,2011.0,3,0,3
BEL,NGA,1997.0,1,0,1
ITA,COL,2006.0,2,0,2
BGD,IDN,2007.0,1,0,1
EGY,BRA,1997.0,1,0,1
NER,SEN,1998.0,1,0,1
BGD,ARE,2003.0,1,0,1
THA,MAR,2013.0,1,0,1
UZB,CAN,1997.0,1,0,1
CZE,ARM,2009.0,1,0,1
RUS,FLK,2000.0,2,0,2
HKG,ISR,2006.0,2,0,2
GEO,TUR,2020.0,1,0,1
IND,PER,1998.0,1,0,1
NAM,ITA,2005.0,1,0,1
,FLK,1995.0,2,0,2
CRI,GBR,2005.0,3,0,3
CHE,TWN,1997.0,2,0,2
SVK,HKG,2001.0,1,0,1
HKG,SVK,2004.0,2,0,2
MOZ,BRA,2006.0,1,0,1
FRA,GRD,2003.0,1,0,1
LBN,QAT,2013.0,2,0,2
SGP,POL,2000.0,1,0,1
AUT,BDI,2011.0,1,0,1
ESP,IRN,2000.0,1,0,1
PAK,BEL,2023.0,2,0,2
ARE,DZA,2019.0,2,0,2
,ATG,2008.0,1,0,1
BIH,SVK,2014.0,1,0,1
NZL,ETH,2019.0,1,0,1
LAO,DNK,2017.0,1,0,1
LUX,PRT,2023.0,1,0,1
THA,HKG,2013.0,4,0,4
FRA,AZE,2014.0,1,0,1
HKG,SAU,2010.0,1,0,1
CRI,NIC,2006.0,1,0,1
AUS,KWT,2006.0,2,0,2
SWZ,TWN,2010.0,1,0,1
NGA,CZE,2014.0,1,0,1
CHN,MMR,2016.0,2,0,2
COD,THA,2015.0,1,0,1
HTI,CUB,2013.0,2,0,2
DZA,QAT,2019.0,1,0,1
BRA,BEN,2012.0,1,0,1
JPN,YEM,2020.0,1,0,1
HKG,ISR,2023.0,2,0,2
CYP,BEL,2018.0,3,0,3
UGA,ETH,2014.0,1,0,1
ITA,SYR,2012.0,2,0,2
PYF,MUS,2018.0,1,0,1
USA,VGB,2017.0,1,0,1
VGB,,2019.0,1,0,1
AUT,PAK,2005.0,2,0,2
CYP,BGD,2020.0,1,0,1
KOR,SVN,2021.0,1,0,1
CHN,LSO,2016.0,1,0,1
DNK,NPL,2014.0,1,0,1
NGA,CAF,2022.0,2,0,2
AUS,TON,2015.0,1,0,1
COG,MAR,2014.0,1,0,1
MEX,ROU,2020.0,1,0,1
KAZ,ARE,2016.0,2,0,2
BRA,COD,2021.0,1,0,1
MUS,MDG,2019.0,1,0,1
MAR,CHL,2021.0,2,0,2
DEU,GIN,2018.0,2,0,2
MAC,NOR,2009.0,1,0,1
IRL,KAZ,2017.0,2,0,2
BGD,POL,2019.0,1,0,1
BGD,FRA,2004.0,1,0,1
OMN,CZE,2020.0,1,0,1
ITA,CIV,2019.0,1,0,1
GBR,CYM,2020.0,1,0,1
,HTI,2004.0,15,0,15
SEN,TZA,2017.0,2,0,2
MOZ,GBR,2015.0,2,0,2
KOR,MOZ,2018.0,1,0,1
AFG,BEL,2019.0,2,0,2
CAN,NER,2016.0,1,0,1
MDA,CHE,2015.0,2,0,2
IDN,LKA,2018.0,1,0,1
PAN,CHN,2019.0,1,0,1
ZAF,OMN,2016.0,1,0,1
AFG,JOR,2019.0,1,0,1
ROU,IDN,2021.0,1,0,1
CRI,BEL,2023.0,1,0,1
ROU,PAK,2017.0,1,0,1
NOR,SSD,2020.0,1,0,1
BIH,IND,2018.0,1,0,1
JPN,ZAF,2014.0,5,0,5
KEN,EST,2020.0,1,0,1
RUS,OMN,2022.0,1,0,1
GBR,TCD,2022.0,2,0,2
LBN,JOR,2023.0,3,0,3
GRC,POL,2023.0,1,0,1
BGR,SAU,2019.0,1,0,1
GUY,ZAF,2021.0,1,0,1
FIN,ISR,2021.0,2,0,2
MYS,EST,2023.0,2,0,2
,DJI,2019.0,5,0,5
POL,LBN,2006.0,1,0,1
CIV,CHE,2006.0,1,0,1
NER,KEN,2012.0,2,0,2
MDG,BOL,2002.0,1,0,1
MAR,DJI,2022.0,1,0,1
COL,SWE,2002.0,1,0,1
JOR,QAT,1999.0,1,0,1
CAF,ZAF,2007.0,2,0,2
ZWE,TZA,2000.0,1,0,1
SGP,BLR,2021.0,1,0,1
NOR,ETH,2005.0,4,0,4
PNG,BTN,2016.0,1,0,1
IND,MMR,2010.0,1,0,1
POL,PAK,2009.0,1,0,1
SUR,,2001.0,1,0,1
CUB,ITA,2017.0,3,0,3
UGA,IND,2004.0,1,0,1
VCT,IND,2001.0,1,0,1
GRC,LVA,2006.0,1,0,1
LVA,GRC,2007.0,1,0,1
NLD,GEO,2007.0,1,0,1
BFA,BRA,2003.0,2,0,2
IRQ,,2001.0,4,0,4
KHM,MDG,2022.0,1,0,1
FRA,LBY,1999.0,1,0,1
MEX,KOR,2005.0,2,0,2
JPN,UZB,2020.0,4,0,4
HUN,ISR,2005.0,1,0,1
DNK,BOL,2002.0,1,0,1
BGR,ARE,2013.0,1,0,1
DNK,MNG,2004.0,1,0,1
NLD,MLT,2005.0,1,0,1
,VIR,1994.0,4,0,4
NAM,,2012.0,7,0,7
NGA,SWZ,2009.0,2,0,2
IDN,VUT,2003.0,1,0,1
TTO,BRA,2003.0,1,0,1
HRV,COL,2022.0,1,0,1
AUS,NAM,2013.0,1,0,1
GRD,DEU,2011.0,1,0,1
SGP,MAC,2005.0,1,0,1
HUN,HKG,2007.0,1,0,1
GLP,,2000.0,2,0,2
PRT,CUB,2006.0,2,0,2
PRI,ESP,2001.0,2,0,2
NZL,KEN,2005.0,1,0,1
,CYM,2004.0,4,0,4
GBR,FJI,2008.0,1,0,1
MYS,CHN,1998.0,1,0,1
DEU,KEN,1999.0,4,0,4
ISR,MDA,2002.0,1,0,1
NLD,BWA,2012.0,1,0,1
ITA,NPL,2023.0,3,0,3
UKR,NOR,2014.0,3,0,3
AUS,MUS,2016.0,1,0,1
GEO,ARM,2010.0,1,0,1
NLD,BWA,2005.0,1,0,1
DNK,PER,2015.0,1,0,1
DEU,BWA,2005.0,1,0,1
BWA,CAN,2008.0,2,0,2
ARM,CHE,2010.0,1,0,1
BRB,CAN,2006.0,2,0,2
BHR,EGY,1999.0,2,0,2
PAK,BRA,2003.0,2,0,2
VCT,USA,2010.0,1,0,1
BEL,BDI,2015.0,2,0,2
SEN,CIV,2015.0,2,0,2
IND,ATG,2013.0,1,0,1
RUS,PAK,2009.0,2,0,2
ESP,UGA,2010.0,2,0,2
CHL,PHL,2016.0,1,0,1
GIN,,2009.0,8,0,8
PAK,SGP,2014.0,3,0,3
ARE,IRL,2008.0,1,0,1
GBR,CAF,2023.0,1,0,1
AUT,UGA,2003.0,1,0,1
MDA,BEL,2001.0,3,0,3
MDA,FRA,2006.0,1,0,1
BRA,TUN,2014.0,1,0,1
IRN,FIN,2006.0,1,0,1
MNE,BRA,2012.0,1,0,1
HKG,IRL,2004.0,4,0,4
ARG,CHN,2019.0,1,0,1
MTQ,,2013.0,3,0,3
SWZ,AUS,2010.0,1,0,1
KAZ,EGY,2013.0,2,0,2
GNB,,2016.0,4,0,4
,AND,1999.0,3,0,3
CUB,URY,2017.0,3,0,3
SWE,LBN,2013.0,1,0,1
CHL,CHN,2005.0,1,0,1
IRN,FIN,2024.0,2,0,2
NGA,TZA,2013.0,2,0,2
GUF,PER,2012.0,2,0,2
BGR,PRT,2002.0,2,0,2
SRB,CUB,1998.0,1,0,1
VEN,HUN,2001.0,2,0,2
POL,EGY,2005.0,1,0,1
ISR,ISL,2009.0,3,0,3
NLD,IRQ,2013.0,1,0,1
QAT,ARE,2003.0,3,0,3
BIH,DEU,2000.0,2,0,2
TTO,IRL,2017.0,1,0,1
UKR,ZAF,2021.0,1,0,1
,TON,2013.0,4,0,4
CHN,TTO,2017.0,1,0,1
SRB,EUE,2018.0,1,0,1
GRC,HRV,2019.0,2,0,2
FRA,BDI,2021.0,2,0,2
ARM,GRC,2021.0,1,0,1
JPN,BIH,2022.0,1,0,1
MNG,CAN,2019.0,1,0,1
NOR,IRQ,2022.0,2,0,2
DEU,MWI,2004.0,2,0,2
AGO,,2020.0,14,0,14
IRL,CMR,2017.0,1,0,1
CHN,ARM,2017.0,2,0,2
ITA,AGO,2017.0,1,0,1
GHA,CZE,2019.0,2,0,2
JPN,ECU,2010.0,1,0,1
GBR,EST,2004.0,4,0,4
NGA,BEL,2008.0,1,0,1
ETH,ITA,2003.0,2,0,2
ZWE,BEL,1999.0,1,0,1
,FRO,1995.0,2,0,2
IRQ,CAN,2000.0,2,0,2
GMB,SEN,2009.0,1,0,1
ITA,MDA,2006.0,1,0,1
EST,HUN,2011.0,1,0,1
CMR,BFA,2000.0,2,0,2
MOZ,USA,1999.0,2,0,2
CMR,AUT,1998.0,1,0,1
NPL,PHL,2002.0,1,0,1
JPN,ARE,2000.0,2,0,2
,TCA,1995.0,2,0,2
JPN,ARM,2003.0,2,0,2
MCO,,2003.0,4,0,4
EST,KAZ,2006.0,1,0,1
KWT,SRB,1998.0,1,0,1
SWE,SDN,2003.0,3,0,3
CPV,SWE,2002.0,2,0,2
USA,GRL,2010.0,1,0,1
IND,UKR,1999.0,1,0,1
,FSM,1996.0,2,0,2
BRB,,2001.0,2,0,2
SVN,MEX,2011.0,1,0,1
NER,,2006.0,5,0,5
BIH,GBR,2005.0,1,0,1
GNQ,USA,2009.0,1,0,1
JOR,NOR,1997.0,1,0,1
ESP,VNM,1998.0,1,0,1
LIE,,2012.0,5,0,5
UKR,AUS,2003.0,1,0,1
UGA,NGA,1999.0,1,0,1
GTM,ITA,2007.0,1,0,1
CUB,NIC,1998.0,1,0,1
FIN,BRA,2002.0,3,0,3
HRV,GRC,2007.0,1,0,1
GRC,HRV,2011.0,3,0,3
CZE,CUB,1999.0,1,0,1
KGZ,,2012.0,5,0,5
FRA,PNG,2002.0,3,0,3
TWN,NOR,2005.0,1,0,1
CYP,SGP,2015.0,1,0,1
ARG,NOR,2009.0,4,0,4
,SYC,2003.0,2,0,2
NGA,SYC,2008.0,1,0,1
ASM,,2008.0,1,0,1
ITA,LBY,2013.0,1,0,1
CYM,IND,2018.0,1,0,1
CRI,ESP,2006.0,2,0,2
FIN,ARG,2016.0,2,0,2
JPN,SEN,2014.0,3,0,3
POL,GEO,2003.0,1,0,1
ARE,HKG,1998.0,1,0,1
NER,AUS,2007.0,1,0,1
SRB,HUN,2008.0,1,0,1
FIN,HKG,2006.0,1,0,1
BTN,DNK,2008.0,1,0,1
BEL,REU,2006.0,1,0,1
AUS,URY,2010.0,2,0,2
TUR,MNE,2015.0,1,0,1
MLT,USA,1997.0,2,0,2
BWA,ZAF,2000.0,2,0,2
BRA,STP,2007.0,1,0,1
USA,MKD,2012.0,5,0,5
SAU,BLR,2014.0,1,0,1
NGA,MAR,2016.0,1,0,1
IRL,QAT,2008.0,1,0,1
AZE,CHN,2008.0,2,0,2
NPL,BTN,2023.0,1,0,1
TZA,GHA,2023.0,2,0,2
IRL,COL,2008.0,2,0,2
GLP,BRA,2015.0,1,0,1
ATG,IND,2020.0,1,0,1
PHL,IRN,2009.0,1,0,1
CHE,SEN,2020.0,4,0,4
GAB,CMR,2004.0,1,0,1
JPN,CYP,2020.0,1,0,1
LBY,AUT,2019.0,1,0,1
SJM,DNK,2006.0,1,0,1
BLZ,,2011.0,2,0,2
ITA,LIE,2020.0,1,0,1
ZWE,GNQ,2015.0,1,0,1
HUN,SVN,2018.0,3,0,3
FRO,ISL,2018.0,1,0,1
PRI,PRT,2021.0,2,0,2
FJI,SLB,2015.0,1,0,1
AUT,MCO,2016.0,1,0,1
JPN,KWT,2015.0,2,0,2
ZAF,FJI,2017.0,1,0,1
ZAF,VGB,2022.0,2,0,2
POL,TWN,2011.0,2,0,2
BEN,KOR,2019.0,1,0,1
ROU,AUS,2018.0,2,0,2
GMB,NGA,2013.0,2,0,2
PHL,SEN,2013.0,1,0,1
CHE,MAR,2014.0,2,0,2
IRN,SRB,2013.0,1,0,1
CYP,SGP,2014.0,1,0,1
SWE,CYP,2011.0,1,0,1
GRC,NPL,2021.0,1,0,1
VEN,SAU,2013.0,1,0,1
ARM,HKG,2014.0,1,0,1
SRB,BLR,2005.0,1,0,1
HUN,UKR,2014.0,2,0,2
PRI,,2026.0,1,0,1
BRA,STP,2020.0,1,0,1
ITA,PHL,2014.0,3,0,3
NOR,ZMB,2017.0,3,0,3
MAR,DEU,2010.0,4,0,4
URY,ISR,2015.0,1,0,1
RUS,JAM,2002.0,1,0,1
CHL,ISR,2013.0,2,0,2
GRC,MEX,2012.0,1,0,1
PAN,CAN,2000.0,1,0,1
YEM,RUS,1999.0,1,0,1
ZAF,CUB,2015.0,1,0,1
VEN,NOR,2017.0,1,0,1
NLD,EST,2014.0,2,0,2
FIN,QAT,2015.0,1,0,1
RUS,THA,2015.0,1,0,1
NPL,LAO,2018.0,1,0,1
HRV,PAK,2019.0,1,0,1
OMN,SDN,2006.0,1,0,1
SYR,ARE,1997.0,2,0,2
BRA,MLT,2015.0,1,0,1
FJI,BRN,2002.0,1,0,1
WSM,AUS,2016.0,2,0,2
MAR,SAU,2009.0,3,0,3
CHL,CHN,2012.0,3,0,3
ARM,SGP,2020.0,1,0,1
LVA,AUS,2000.0,1,0,1
AUS,LVA,2011.0,2,0,2
SVN,MEX,2019.0,1,0,1
LTU,RUS,2014.0,3,0,3
KAZ,LVA,2022.0,1,0,1
NAM,CZE,2020.0,1,0,1
SEN,MRT,2018.0,1,0,1
FJI,THA,2000.0,1,0,1
CHN,KGZ,2002.0,1,0,1
KHM,IND,2021.0,1,0,1
CHE,PER,2023.0,2,0,2
UKR,LVA,2020.0,2,0,2
SYR,JOR,2001.0,1,0,1
CPV,ESP,2023.0,3,0,3
IRL,PER,2021.0,1,0,1
NZL,MMR,2020.0,1,0,1
GBR,PAN,2003.0,4,0,4
CZE,BGR,2003.0,1,0,1
GBR,LSO,2021.0,1,0,1
,LBR,2017.0,25,0,25
JOR,JPN,2022.0,2,0,2
LIE,FRA,2018.0,1,0,1
,MTQ,2017.0,5,0,5
SGP,GHA,2020.0,2,0,2
KWT,DEU,1998.0,1,0,1
CMR,GBR,2007.0,4,0,4
,GRD,2017.0,18,0,18
SWE,CAF,1998.0,1,0,1
,CZE,2021.0,15,0,15
CAN,CYP,2022.0,3,0,3
BGD,GMB,2019.0,1,0,1
CHE,UZB,2023.0,1,0,1
SVN,NOR,2023.0,1,0,1
HRV,RUS,2019.0,2,0,2
BRA,LUX,2023.0,3,0,3
,TCD,2017.0,13,0,13
BGR,ISR,1998.0,1,0,1
DEU,MKD,2004.0,2,0,2
CRI,PAN,2023.0,3,0,3
CZE,MEX,2001.0,2,0,2
UKR,COL,2015.0,2,0,2
IND,BHR,2008.0,3,0,3
BOL,ECU,2000.0,2,0,2
KHM,ZWE,2004.0,1,0,1
LAO,LKA,2013.0,1,0,1
IRL,ISR,2001.0,1,0,1
CAN,MAC,2013.0,3,0,3
,PLW,1994.0,4,0,4
USA,NFK,2012.0,1,0,1
ESP,BOL,2001.0,1,0,1
ESP,NZL,1998.0,1,0,1
AUT,PAK,2002.0,1,0,1
KOR,HKG,1998.0,2,0,2
ZWE,IDN,2009.0,1,0,1
GRD,ESP,2020.0,2,0,2
AUS,MNE,2011.0,1,0,1
CHL,PRY,2006.0,1,0,1
GBR,SLE,2015.0,7,0,7
COL,NLD,1997.0,1,0,1
JPN,UGA,2000.0,1,0,1
SGP,ETH,2012.0,1,0,1
BGR,UKR,1997.0,1,0,1
DOM,,2002.0,3,0,3
IRL,SLV,1999.0,1,0,1
SLV,IRL,2001.0,2,0,2
QAT,,2000.0,7,0,7
USA,SLB,1997.0,1,0,1
UKR,NZL,2010.0,1,0,1
CMR,NLD,2014.0,2,0,2
NLD,CMR,2015.0,2,0,2
ZAF,CYP,2012.0,1,0,1
TWN,PAK,2013.0,1,0,1
GRC,SAU,2003.0,1,0,1
ARE,NOR,1997.0,1,0,1
SAU,MYS,2002.0,1,0,1
ISR,ROU,2004.0,2,0,2
TWN,HND,2016.0,1,0,1
BOL,ARG,2000.0,1,0,1
TUR,MKD,2022.0,1,0,1
BGR,SAU,2009.0,2,0,2
USA,ETH,2024.0,1,0,1
ECU,ARE,2018.0,1,0,1
NOR,COG,2012.0,1,0,1
FIN,ETH,2013.0,1,0,1
BLR,KOR,1999.0,1,0,1
ESP,BMU,2000.0,1,0,1
SLV,CZE,2015.0,1,0,1
GBR,CYP,1997.0,1,0,1
TTO,ARE,2020.0,1,0,1
PER,ZAF,2021.0,1,0,1
IND,BWA,2011.0,1,0,1
TUR,ZMB,2019.0,1,0,1
USA,TJK,2018.0,2,0,2
BEN,GBR,2017.0,1,0,1
NAM,GHA,2017.0,1,0,1
PAK,PRT,2010.0,2,0,2
COG,ZMB,2016.0,1,0,1
LVA,PRT,2019.0,1,0,1
HUN,SGP,2023.0,1,0,1
KAZ,BLR,2019.0,1,0,1
ISR,ARG,2014.0,1,0,1
ISR,LUX,2023.0,1,0,1
CZE,LUX,2018.0,1,0,1
KWT,MAR,2011.0,1,0,1
TUN,IRL,2019.0,2,0,2
COL,CHN,2011.0,1,0,1
EST,SRB,2017.0,1,0,1
JPN,PER,2007.0,1,0,1
,ATG,2014.0,4,0,4
CHN,YEM,2017.0,1,0,1
,TKM,2013.0,1,0,1
IRQ,PAK,2016.0,2,0,2
ISR,IDN,2017.0,2,0,2
KEN,NOR,2018.0,1,0,1
NLD,MAR,2022.0,1,0,1
DZA,HUN,2017.0,1,0,1
IRN,EST,2020.0,6,0,6
PRT,EGY,2018.0,5,0,5
BRA,GUY,2021.0,1,0,1
UKR,NLD,2019.0,7,0,7
ZAF,VGB,2016.0,1,0,1
JAM,AUS,2021.0,2,0,2
GBR,MLI,2016.0,3,0,3
JOR,LBN,2024.0,1,0,1
NLD,LVA,2014.0,2,0,2
DOM,ARG,2014.0,2,0,2
ETH,EGY,2018.0,1,0,1
,KIR,2019.0,3,0,3
MDV,CAN,2023.0,1,0,1
NGA,IDN,2022.0,1,0,1
SDN,NGA,2022.0,1,0,1
GIB,CAN,2023.0,1,0,1
SVK,EGY,2002.0,1,0,1
DOM,PRI,2022.0,2,0,2
BGR,BLR,2008.0,2,0,2
BLR,BGR,2011.0,3,0,3
IRN,UZB,2007.0,1,0,1
SVK,CHE,2009.0,4,0,4
USA,MHL,2005.0,2,0,2
HUN,GEO,2009.0,1,0,1
MOZ,PAK,2006.0,1,0,1
PAK,CHE,2014.0,2,0,2
BRA,EGY,2006.0,1,0,1
VIR,GRC,2022.0,1,0,1
DNK,MLI,2014.0,2,0,2
MCO,GBR,2007.0,1,0,1
YEM,RUS,2007.0,1,0,1
JOR,NZL,2004.0,1,0,1
CMR,PAK,2012.0,1,0,1
MOZ,PHL,2022.0,1,0,1
PRT,EST,2007.0,1,0,1
PHL,FIN,2011.0,1,0,1
CHN,CHL,2006.0,1,0,1
TWN,COL,2015.0,3,0,3
RUS,PRI,2009.0,1,0,1
NIC,THA,2011.0,1,0,1
UKR,EST,2014.0,1,0,1
KOR,ARE,2012.0,4,0,4
FRA,LAO,2003.0,2,0,2
ITA,MAC,2005.0,1,0,1
FRA,TCD,2000.0,1,0,1
VCT,,2009.0,1,0,1
PAK,BEL,2010.0,1,0,1
ITA,BFA,2019.0,3,0,3
USA,SMR,2011.0,1,0,1
KEN,NZL,2012.0,1,0,1
BGR,KOR,2011.0,1,0,1
KOR,BGR,2016.0,1,0,1
UGA,BGD,2014.0,1,0,1
CHN,MLT,2020.0,1,0,1
COG,IND,2016.0,1,0,1
MWI,NZL,2021.0,1,0,1
MDV,MDA,2017.0,1,0,1
PAK,QAT,2006.0,2,0,2
DMA,TTO,2018.0,1,0,1
SGP,MAC,2012.0,1,0,1
GNB,,2017.0,4,0,4
VNM,KHM,2013.0,2,0,2
DEU,AZE,2009.0,1,0,1
ZAF,TWN,2021.0,3,0,3
CZE,BGD,2020.0,1,0,1
IRQ,DOM,2019.0,1,0,1
,BLZ,2016.0,4,0,4
UGA,SSD,2021.0,1,0,1
IRN,NGA,2020.0,1,0,1
KAZ,KOR,1997.0,1,0,1
JPN,ZAF,2004.0,3,0,3
ISR,NGA,2001.0,1,0,1
FIN,COL,2013.0,1,0,1
BFA,MEX,2003.0,1,0,1
ARG,PER,1999.0,1,0,1
CHE,EGY,2006.0,3,0,3
CHE,CYP,1998.0,2,0,2
AUS,CYP,2019.0,3,0,3
GMB,,2012.0,5,0,5
NIC,CAN,1998.0,1,0,1
ZWE,KEN,1997.0,1,0,1
UGA,SWE,2001.0,3,0,3
UGA,SWE,2004.0,1,0,1
GHA,SLE,2019.0,1,0,1
SLE,DEU,2023.0,1,0,1
MAR,SWE,2002.0,1,0,1
CHN,LBY,2005.0,1,0,1
MWI,KEN,2010.0,1,0,1
URY,CHL,1997.0,1,0,1
CMR,BOL,2002.0,1,0,1
LKA,KWT,2004.0,1,0,1
TUN,BEL,2007.0,2,0,2
NOR,KEN,2004.0,1,0,1
GBR,PRY,2006.0,2,0,2
SWE,ZMB,2004.0,1,0,1
EGY,PSE,1998.0,1,0,1
NZL,NPL,1997.0,1,0,1
MMR,JPN,2000.0,1,0,1
URY,NLD,1999.0,1,0,1
IRL,TUN,2002.0,2,0,2
NLD,LBN,2002.0,1,0,1
BRA,BEN,2002.0,1,0,1
PYF,TWN,2015.0,1,0,1
NGA,GHA,2003.0,1,0,1
NZL,NCL,1998.0,1,0,1
NCL,,2003.0,5,0,5
ROU,HKG,2002.0,1,0,1
IND,BLR,2003.0,1,0,1
PAK,HRV,2000.0,3,0,3
PYF,,2000.0,4,0,4
KNA,ZAF,2018.0,1,0,1
ETH,MMR,2022.0,2,0,2
CHE,CHL,1998.0,3,0,3
ISL,AUS,2017.0,1,0,1
FRA,MWI,2002.0,1,0,1
DOM,CHL,2004.0,1,0,1
SRB,JPN,2010.0,2,0,2
VEN,AUS,2018.0,3,0,3
POL,IND,1999.0,1,0,1
BRA,EGY,2010.0,2,0,2
GRC,CMR,2012.0,1,0,1
IDN,TGO,2008.0,1,0,1
TGO,IDN,2010.0,1,0,1
HUN,NZL,2011.0,1,0,1
UZB,AUS,2012.0,1,0,1
COG,ZMB,2022.0,1,0,1
MYS,KEN,2021.0,2,0,2
ARM,ISR,2014.0,1,0,1
PRT,HRV,2016.0,1,0,1
ROU,AUT,1998.0,1,0,1
MOZ,AUT,2019.0,1,0,1
PER,POL,2012.0,1,0,1
SGP,NPL,2013.0,2,0,2
TUR,MDA,2022.0,1,0,1
IRL,PAN,2011.0,1,0,1
EST,IRL,2020.0,2,0,2
BIH,AUT,2014.0,3,0,3
USA,ABW,2022.0,1,0,1
BRN,OMN,2021.0,1,0,1
BEL,ARM,2012.0,2,0,2
SYR,KOR,2019.0,1,0,1
SWE,SVK,2021.0,3,0,3
BLZ,FIN,2000.0,1,0,1
LBN,DZA,2020.0,1,0,1
GBR,CIV,2005.0,1,1,0
NLD,MYS,2003.0,4,1,3
BDI,BEL,1998.0,2,1,1
NIC,USA,1999.0,3,2,1
CZE,MEX,2002.0,2,3,-1
SWE,LKA,2013.0,4,1,3
CHE,KEN,2001.0,2,2,0
LTU,ITA,2004.0,2,4,-2
USA,ARM,2010.0,4,12,-8
ESP,ARE,2012.0,3,1,2
TUN,USA,2001.0,4,6,-2
COL,VEN,2001.0,4,7,-3
AUS,COL,2009.0,2,3,-1
MYS,THA,2008.0,5,4,1
CAN,ROU,2015.0,1,3,-2
SEN,USA,2005.0,3,2,1
COG,ESP,2020.0,1,1,0
NLD,SVN,2012.0,2,4,-2
WSM,NZL,2012.0,1,1,0
DMA,USA,2018.0,3,1,2
CHE,ROU,2012.0,5,10,-5
FRA,TGO,2002.0,3,7,-4
PRI,ESP,2002.0,4,1,3
COL,VEN,2004.0,3,2,1
SGP,TUR,2014.0,4,2,2
GRC,CYP,1999.0,5,2,3
AUT,HRV,2005.0,3,3,0
THA,ESP,2011.0,1,1,0
KGZ,USA,2016.0,1,1,0
TZA,IND,1997.0,3,1,2
SWE,TUR,2001.0,2,3,-1
SWZ,LSO,2018.0,1,1,0
ECU,BRA,2023.0,6,11,-5
IRN,AUT,2006.0,1,1,0
BEL,DZA,2013.0,6,4,2
GBR,ZMB,2008.0,2,1,1
CHL,NOR,2016.0,4,1,3
CZE,GRC,2010.0,1,3,-2
IND,HKG,2009.0,1,9,-8
MOZ,GBR,2005.0,1,1,0
NGA,CAN,2010.0,7,2,5
SGP,CHE,2009.0,7,9,-2
GBR,DZA,2019.0,8,6,2
AUS,SVK,2017.0,2,1,1
IRL,TWN,2022.0,2,1,1
ITA,EST,2008.0,1,1,0
SVK,IRL,2009.0,1,1,0
MKD,MAC,2017.0,4,2,2
CHE,MEX,2018.0,7,6,1
GRC,CYP,1998.0,4,3,1
FIN,UKR,2016.0,2,4,-2
GRC,SGP,2020.0,3,3,0
ISL,CAN,2017.0,1,2,-1
MYS,OMN,2016.0,7,3,4
USA,MNP,2018.0,4,2,2
DZA,ARG,2012.0,1,1,0
FRA,CYP,2009.0,1,1,0
ROU,ZAF,2015.0,1,1,0
ZAF,ROU,2021.0,1,4,-3
IRL,HKG,2015.0,2,2,0
LSO,GBR,2007.0,1,1,0
CHL,ITA,2013.0,4,18,-14
ARM,FRA,2018.0,1,1,0
MAR,SWE,2015.0,1,2,-1
KOR,ZAF,2015.0,2,8,-6
LTU,NOR,2012.0,3,2,1
ALB,SRB,2015.0,10,1,9
VNM,FRA,2007.0,5,10,-5
NPL,KOR,2013.0,2,2,0
SAU,CZE,2019.0,3,2,1
BRA,ZAF,2013.0,2,5,-3
CZE,ZAF,2018.0,3,3,0
AUS,KWT,2016.0,4,4,0
VNM,NOR,2020.0,3,1,2
YEM,IND,2014.0,1,3,-2
CHE,DZA,2019.0,3,1,2
CIV,BFA,2016.0,1,2,-1
CHN,CHL,2017.0,5,5,0
NOR,PAK,2019.0,4,2,2
DEU,ALB,2018.0,1,1,0
NZL,SAU,2018.0,4,3,1
MYS,BHR,2016.0,1,1,0
URY,CHL,2015.0,3,5,-2
GBR,LVA,2012.0,1,2,-1
CHE,PNG,2015.0,2,1,1
EGY,KOR,2017.0,5,9,-4
KEN,LBR,2018.0,1,1,0
DEU,CYP,2018.0,6,7,-1
LTU,LVA,2016.0,2,4,-2
PHL,AUT,2018.0,2,3,-1
EGY,FIN,2018.0,4,9,-5
SRB,CAN,2017.0,6,3,3
DEU,GHA,2023.0,6,8,-2
KOR,NOR,2021.0,9,7,2
LSO,ZAF,2017.0,1,3,-2
USA,MDG,2017.0,2,4,-2
MDG,USA,2019.0,5,8,-3
SRB,LBY,2019.0,2,1,1
MAC,TWN,2022.0,2,2,0
MEX,KOR,2014.0,1,1,0
QAT,FIN,2021.0,1,1,0
IND,CAN,2024.0,1,1,0
ESP,THA,2017.0,1,5,-4
LKA,BEL,2010.0,1,2,-1
LBN,NLD,2019.0,3,3,0
DZA,VNM,2019.0,1,2,-1
CHE,LTU,2021.0,2,7,-5
PAK,LTU,2022.0,2,1,1
BRN,BGD,2016.0,4,2,2
GHA,CHE,2021.0,3,3,0
IND,FJI,2017.0,6,4,2
NGA,MLI,2020.0,2,1,1
COD,GBR,2022.0,2,4,-2
MYS,KHM,2019.0,2,2,0
SVK,UKR,2018.0,5,5,0
RUS,SYR,2023.0,4,1,3
SEN,ZAF,2022.0,1,2,-1
BGD,CZE,2021.0,1,2,-1
PAK,TUR,2024.0,1,1,0
BEL,CUB,2022.0,1,4,-3
MYS,PAK,2006.0,3,4,-1
ETH,USA,2003.0,4,3,1
NPL,DEU,2005.0,1,1,0
ZAF,BRA,2003.0,1,1,0
KWT,EGY,2005.0,3,11,-8
CAN,COL,2004.0,2,4,-2
RUS,COL,1997.0,1,1,0
JPN,CYP,2003.0,1,1,0
KWT,SAU,2008.0,2,1,1
HUN,SVK,2001.0,2,2,0
ISR,BGR,2019.0,2,1,1
DEU,TZA,2011.0,2,3,-1
MAR,GBR,2003.0,2,1,1
GBR,BMU,2002.0,3,1,2
NAM,GBR,2008.0,1,1,0
KHM,ITA,2022.0,1,1,0
SEN,BEL,2017.0,2,2,0
PHL,KEN,2019.0,1,1,0
SVN,BGR,2012.0,2,1,1
NZL,OMN,2014.0,1,1,0
HKG,PAK,2016.0,4,5,-1
PRT,NZL,2014.0,3,1,2
NLD,COL,2013.0,9,5,4
RUS,KGZ,2014.0,4,4,0
SAU,NOR,2023.0,3,1,2
ISL,ARE,2020.0,1,1,0
NOR,ETH,2014.0,4,5,-1
ALB,SRB,2014.0,5,5,0
SYC,GBR,2009.0,1,2,-1
NPL,THA,2012.0,3,2,1
NLD,LKA,2019.0,1,2,-1
NLD,ZWE,2022.0,2,2,0
ESP,NZL,2013.0,5,7,-2
EGY,BRA,2015.0,1,1,0
MAR,ZAF,2021.0,1,3,-2
ALB,ESP,2014.0,1,2,-1
CHE,PER,2018.0,6,1,5
CHE,GEO,2015.0,2,1,1
RUS,HKG,2015.0,3,2,1
USA,VIR,2018.0,4,7,-3
TZA,DEU,2016.0,1,9,-8
USA,YEM,2019.0,2,1,1
LBN,LBY,2016.0,1,1,0
URY,MEX,2015.0,1,5,-4
GRD,USA,2014.0,3,9,-6
AUS,BWA,2017.0,1,3,-2
HKG,ISR,2017.0,3,1,2
ECU,ITA,2016.0,1,9,-8
PRI,ESP,2012.0,3,5,-2
NGA,TUR,2023.0,2,2,0
EGY,HKG,2023.0,2,3,-1
BEN,NGA,2020.0,5,4,1
DNK,COL,2019.0,5,3,2
SDN,EGY,2017.0,1,1,0
SVK,RUS,2023.0,1,1,0
USA,LTU,2017.0,3,5,-2
KAZ,CHN,2015.0,2,4,-2
LKA,ZAF,2005.0,1,1,0
SAU,JPN,2007.0,1,5,-4
USA,DOM,2023.0,3,4,-1
DEU,KAZ,2003.0,1,2,-1
DZA,NLD,2022.0,1,1,0
SVN,FRA,2015.0,1,3,-2
ARG,NZL,2003.0,2,1,1
QAT,BGD,2016.0,1,1,0
DOM,MEX,2007.0,1,2,-1
HUN,POL,2017.0,1,2,-1
AUT,PAK,2008.0,6,7,-1
PER,BEL,2012.0,2,1,1
DNK,ISL,1998.0,1,1,0
GUY,USA,2008.0,2,2,0
PAK,TUR,2010.0,1,1,0
AUS,NPL,2004.0,1,1,0
HKG,JPN,2012.0,14,9,5
NOR,EST,2018.0,2,2,0
SRB,SVN,2007.0,3,1,2
CAF,FRA,2014.0,3,3,0
FIN,GRC,2021.0,3,6,-3
ITA,TZA,2021.0,4,1,3
CHE,SVK,2001.0,3,4,-1
ISR,COL,2009.0,3,1,2
USA,BRN,2004.0,1,3,-2
QAT,GBR,2004.0,1,3,-2
AUT,GRC,2013.0,3,9,-6
GBR,NAM,2021.0,2,2,0
SVK,BEL,2013.0,3,1,2
NOR,THA,2015.0,2,3,-1
SRB,JPN,2022.0,1,1,0
SWE,ROU,2012.0,2,3,-1
NLD,SAU,2015.0,3,8,-5
CHL,KOR,2018.0,1,1,0
DNK,HUN,2022.0,4,8,-4
DNK,IDN,2010.0,1,1,0
ALB,FRA,2019.0,1,2,-1
LVA,CHE,2016.0,3,2,1
ARM,DEU,2016.0,4,3,1
ITA,TZA,2019.0,2,4,-2
NOR,ITA,2016.0,9,31,-22
BGD,CHN,2011.0,2,5,-3
MCO,ITA,2021.0,1,2,-1
BIH,TUR,2016.0,4,4,0
IRL,BGR,2015.0,2,1,1
CHE,HRV,1997.0,2,2,0
ZAF,IRN,2021.0,7,2,5
ZAF,FRA,2004.0,5,12,-7
PHL,NLD,2014.0,5,1,4
MOZ,BRA,2017.0,8,8,0
ESP,UGA,2017.0,1,1,0
TWN,IDN,2009.0,1,1,0
LKA,IND,2019.0,7,9,-2
LUX,TUR,2023.0,1,1,0
IRQ,CAN,2017.0,2,2,0
GHA,NLD,2017.0,3,12,-9
NLD,GHA,2022.0,7,2,5
IDN,IND,2017.0,6,35,-29
ESP,IDN,2019.0,2,1,1
HUN,NOR,2007.0,2,1,1
UKR,AUT,2005.0,3,4,-1
AZE,POL,2017.0,1,1,0
HUN,KOR,2019.0,2,2,0
CIV,NER,2020.0,1,1,0
VNM,CZE,2018.0,4,6,-2
SAU,LBN,2004.0,1,2,-1
PRY,ARG,2015.0,1,1,0
BRA,ARE,2014.0,1,1,0
JPN,TWN,1997.0,14,7,7
ZMB,RWA,2022.0,1,1,0
BRN,PAK,2019.0,2,2,0
MNE,HRV,2021.0,1,1,0
PER,AUS,2022.0,1,3,-2
MMR,SGP,2016.0,1,1,0
DNK,MYS,2021.0,4,4,0
HRV,SVK,2013.0,1,1,0
UKR,JPN,2018.0,4,4,0
ROU,ESP,2004.0,4,3,1
USA,BRN,2001.0,3,1,2
RUS,LBN,2018.0,1,1,0
BFA,GHA,2020.0,1,1,0
USA,SGP,2024.0,1,1,0
FJI,JPN,2013.0,2,1,1
FRA,KEN,2004.0,1,3,-2
HUN,ISR,2014.0,3,1,2
THA,FIN,2008.0,2,1,1
SAU,QAT,2006.0,4,1,3
OMN,QAT,2017.0,2,1,1
GHA,DEU,2009.0,1,3,-2
BRA,PER,1999.0,4,1,3
RWA,ZWE,2010.0,1,1,0
ARG,URY,2005.0,4,4,0
MEX,UKR,2009.0,3,2,1
JPN,ZAF,2005.0,3,4,-1
CHE,LIE,2012.0,2,1,1
GUF,GUY,2004.0,1,3,-2
POL,ISR,2012.0,3,1,2
JPN,FRA,2024.0,1,1,0
MWI,NLD,2008.0,1,2,-1
CUB,ITA,2000.0,3,5,-2
IRQ,OMN,2011.0,1,1,0
VEN,JPN,2003.0,2,1,1
FRA,ETH,2011.0,2,3,-1
ESP,CRI,2002.0,5,1,4
BHS,USA,2012.0,2,1,1
SVN,GBR,2004.0,3,4,-1
PRT,IND,2005.0,2,8,-6
UZB,KGZ,2007.0,2,1,1
PHL,KOR,2007.0,3,2,1
USA,GUY,2011.0,1,1,0
HND,USA,2009.0,2,3,-1
AGO,PRT,2005.0,1,1,0
EGY,PRT,2007.0,1,1,0
USA,PLW,2005.0,1,1,0
SWE,ZWE,2019.0,2,1,1
NGA,FRA,1999.0,2,3,-1
NZL,ITA,2008.0,3,5,-2
CZE,FIN,2004.0,2,1,1
ITA,HRV,1999.0,2,1,1
BLR,POL,1999.0,3,3,0
BEL,NZL,1999.0,1,1,0
ARE,MAR,2013.0,1,2,-1
BRA,DNK,2000.0,2,4,-2
CHE,PAK,2023.0,2,5,-3
HUN,EGY,2010.0,1,1,0
AUS,TUR,1998.0,1,1,0
BEL,SAU,2011.0,2,1,1
VAT,ITA,2012.0,1,1,0
GBR,ZMB,2004.0,3,1,2
ITA,KEN,2012.0,1,2,-1
GRC,IRN,2015.0,1,3,-2
NZL,PNG,2007.0,1,1,0
GEO,GBR,2005.0,3,1,2
EGY,RUS,2010.0,1,2,-1
CMR,BWA,2023.0,1,1,0
IRL,EGY,2012.0,1,1,0
ARE,ZAF,2007.0,1,1,0
GBR,TTO,2018.0,1,2,-1
YEM,MYS,2006.0,1,1,0
SWE,NPL,2013.0,1,4,-3
CHE,ROU,2005.0,1,4,-3
ISR,NZL,2013.0,1,2,-1
BFA,DEU,2017.0,1,1,0
EGY,KWT,2011.0,6,15,-9
MLI,SEN,2011.0,3,1,2
SRB,HUN,2012.0,3,1,2
HUN,EGY,2000.0,2,1,1
SAU,DZA,2016.0,5,6,-1
LTU,GBR,1998.0,3,1,2
CHE,QAT,2011.0,1,1,0
PAK,IRN,2020.0,3,7,-4
PSE,JOR,2010.0,1,3,-2
TWN,NLD,2009.0,4,4,0
LBN,ITA,2012.0,1,1,0
IRN,HKG,2012.0,3,1,2
CHE,UKR,2016.0,3,7,-4
NZL,CZE,2015.0,4,2,2
AUS,IRQ,2013.0,4,3,1
RUS,POL,2009.0,7,8,-1
ITA,MAC,2008.0,1,1,0
JOR,OMN,2004.0,2,2,0
OMN,BHR,2005.0,1,1,0
BHR,IND,2017.0,1,2,-1
USA,SYC,2012.0,1,1,0
BGD,FRA,2012.0,1,3,-2
IRL,PAK,2020.0,8,10,-2
BGD,HKG,2016.0,3,4,-1
JOR,LBN,2022.0,3,1,2
FIN,SGP,2020.0,1,3,-2
NGA,DEU,2023.0,10,10,0
ZAF,GHA,2009.0,3,2,1
FRA,ITA,2024.0,2,3,-1
BGD,DEU,2003.0,2,2,0
NLD,TUR,2004.0,3,3,0
ITA,BLR,2006.0,3,1,2
CYP,GRC,1998.0,3,4,-1
TZA,PAK,2019.0,1,1,0
VNM,GBR,2003.0,6,9,-3
ESP,PYF,2007.0,1,1,0
UZB,TWN,1997.0,1,1,0
COL,BRA,2005.0,7,11,-4
MDA,CHE,1997.0,2,1,1
SWE,BRA,1998.0,3,6,-3
BTN,USA,2014.0,2,3,-1
RUS,HKG,2004.0,3,1,2
ITA,ZAF,2000.0,2,4,-2
SWE,COL,2018.0,8,3,5
ESP,BGR,2008.0,2,6,-4
SRB,HUN,1997.0,1,2,-1
ZAF,AUT,1999.0,2,3,-1
VIR,USA,2001.0,1,1,0
IRL,NZL,1998.0,1,2,-1
EGY,IND,2007.0,3,2,1
IND,EGY,2010.0,3,5,-2
SRB,NLD,2000.0,2,2,0
PAN,BRA,2007.0,1,2,-1
FRA,HRV,2013.0,3,8,-5
ITA,VEN,2015.0,3,4,-1
LAO,FRA,2014.0,3,2,1
BIH,SVN,2015.0,2,4,-2
BFA,CAF,2009.0,1,1,0
BRA,SAU,2020.0,5,3,2
ESP,EGY,2002.0,2,1,1
GBR,PSE,2002.0,3,1,2
TUR,RUS,2000.0,3,4,-1
PHL,FRA,2000.0,2,2,0
BLR,BEL,2001.0,2,1,1
ROU,NOR,1999.0,1,1,0
LUX,CAN,2008.0,1,2,-1
MEX,SVN,2002.0,1,1,0
SWZ,CHE,2016.0,4,11,-7
SVN,RUS,2015.0,4,3,1
LBR,USA,2013.0,1,2,-1
POL,NOR,2003.0,4,7,-3
PAK,NLD,2008.0,1,1,0
FRA,ETH,2009.0,1,2,-1
LTU,BLR,2018.0,1,1,0
USA,BRB,2016.0,4,7,-3
FRA,TCD,2018.0,1,1,0
FJI,NZL,2011.0,3,1,2
CIV,MLI,2015.0,2,3,-1
ZAF,GRC,2021.0,1,1,0
BRN,MYS,2011.0,1,3,-2
CHN,NPL,2012.0,2,1,1
CHE,NZL,2011.0,8,9,-1
TUR,NZL,2015.0,3,2,1
SGP,THA,2011.0,4,7,-3
GTM,MEX,2012.0,2,4,-2
IRL,FIN,2020.0,3,4,-1
ZAF,JPN,2009.0,1,3,-2
BGR,JPN,2017.0,5,3,2
IRN,OMN,2017.0,2,1,1
CAN,UKR,2016.0,1,6,-5
LVA,JPN,2018.0,1,2,-1
SLV,USA,2015.0,2,1,1
NGA,SEN,2015.0,2,2,0
AZE,USA,2012.0,2,3,-1
CHE,ARE,2020.0,7,1,6
DEU,KAZ,2013.0,1,3,-2
CAN,HTI,2017.0,2,1,1
DNK,PAK,2009.0,2,2,0
QAT,TUR,2020.0,1,5,-4
ZAF,PSE,2017.0,1,1,0
PRT,JPN,2017.0,2,3,-1
CHE,EGY,2018.0,6,7,-1
USA,BIH,2019.0,6,1,5
JPN,PER,2013.0,3,1,2
JOR,AUS,2014.0,5,7,-2
USA,AGO,2015.0,1,1,0
CHL,KOR,2017.0,1,6,-5
KOR,BEL,2004.0,1,1,0
LAO,KHM,2018.0,1,1,0
ZAF,AUT,2007.0,1,2,-1
ZAF,NOR,2007.0,1,2,-1
PRI,ESP,2005.0,2,5,-3
BRA,UZB,1998.0,2,2,0
CZE,BRA,2016.0,5,1,4
SYR,DEU,2012.0,2,5,-3
VNM,NZL,2021.0,3,6,-3
JPN,JOR,2016.0,2,1,1
NGA,CHN,2014.0,8,8,0
QAT,OMN,2019.0,2,5,-3
SWE,MOZ,2023.0,1,2,-1
PER,AUS,2017.0,1,1,0
MEX,JPN,2008.0,3,5,-2
PAK,NOR,2013.0,1,5,-4
KAZ,THA,2021.0,1,1,0
ITA,KAZ,2023.0,1,2,-1
ESP,SRB,2021.0,3,4,-1
LTU,PRT,2021.0,1,1,0
BRA,IRN,2011.0,1,6,-5
ETH,TWN,2022.0,2,11,-9
CHN,TWN,2024.0,2,1,1
GBR,DEU,2024.0,2,4,-2
LKA,JPN,2008.0,1,2,-1
ZAF,NAM,2001.0,1,1,0
CHN,PER,2017.0,1,1,0
PRT,BEL,1999.0,1,3,-2
ESP,PAK,2013.0,3,1,2
KAZ,USA,2001.0,1,3,-2
JPN,SGP,1998.0,6,2,4
ZWE,USA,2008.0,6,7,-1
PAN,DEU,2005.0,1,1,0
PAN,DEU,2012.0,1,1,0
MLT,SWE,2013.0,1,2,-1
NZL,JPN,2001.0,5,14,-9
KEN,NGA,2021.0,4,5,-1
ECU,ITA,2017.0,4,7,-3
LUX,CZE,2014.0,1,1,0
ECU,COL,2008.0,1,3,-2
AUS,TZA,2012.0,3,2,1
FIN,BRA,2015.0,2,10,-8
LUX,CAN,2014.0,2,1,1
ESP,SRB,2009.0,2,2,0
NOR,NZL,2003.0,2,3,-1
BLR,CHN,2017.0,1,1,0
COG,CAN,2016.0,1,1,0
BHR,TUN,2012.0,1,1,0
HKG,ETH,2021.0,1,3,-2
CRI,BRA,2020.0,3,5,-2
ITA,ARM,2014.0,2,2,0
GBR,MKD,2012.0,1,1,0
SGP,IRL,2006.0,2,1,1
AUS,KWT,2018.0,6,4,2
JOR,SYR,2014.0,2,7,-5
SAU,BHR,2012.0,1,1,0
COG,MWI,2013.0,1,1,0
FRA,PHL,2013.0,1,3,-2
NZL,NCL,2013.0,1,3,-2
MYS,ETH,2009.0,1,3,-2
KOR,NLD,2009.0,3,5,-2
SWE,KOR,2023.0,4,14,-10
AGO,BRA,2014.0,1,5,-4
SGP,AUT,2022.0,5,2,3
KEN,IND,1999.0,2,1,1
FRA,COG,2000.0,1,2,-1
CRI,SWE,1998.0,1,2,-1
VEN,DEU,2014.0,1,6,-5
HKG,KAZ,2020.0,1,1,0
PSE,EGY,2007.0,1,1,0
HUN,SRB,1999.0,1,2,-1
EGY,TUN,2012.0,4,1,3
GUF,MTQ,2007.0,1,1,0
PRI,COL,2006.0,2,2,0
SVN,AUS,2007.0,1,2,-1
LBN,GBR,2003.0,5,3,2
BEL,ISR,2007.0,3,2,1
ISR,IRL,2003.0,1,2,-1
PRT,RUS,2013.0,2,3,-1
GIB,GBR,2015.0,1,1,0
AUS,ETH,2014.0,1,4,-3
NZL,THA,2005.0,4,1,3
ESP,ECU,2007.0,2,3,-1
UGA,DEU,2005.0,3,2,1
DEU,UGA,2007.0,2,1,1
IRL,SDN,2004.0,1,1,0
HUN,NLD,2006.0,8,6,2
ARE,BGD,2016.0,1,1,0
JOR,OMN,2008.0,3,1,2
BGR,SWE,2011.0,2,1,1
DZA,ARE,2014.0,1,2,-1
GRC,SVK,2010.0,1,2,-1
SLE,NLD,2020.0,1,1,0
URY,CHL,2004.0,1,2,-1
USA,CYM,2021.0,2,3,-1
ESP,MDG,2019.0,1,1,0
DEU,SYR,2009.0,4,3,1
BRA,THA,2005.0,1,1,0
IND,NGA,2006.0,2,8,-6
TWN,RUS,2016.0,1,4,-3
SGP,MYS,1997.0,2,1,1
IRL,HKG,2008.0,1,4,-3
BGD,THA,2010.0,2,2,0
BRA,CHN,2003.0,1,6,-5
SGP,NLD,2001.0,3,2,1
MYS,BRN,1999.0,1,1,0
NLD,KOR,2008.0,1,4,-3
ARG,AUS,2007.0,10,17,-7
TWN,HKG,2005.0,4,7,-3
FSM,USA,2017.0,2,1,1
JPN,URY,2003.0,2,2,0
USA,DMA,2010.0,1,1,0
CHE,MKD,2016.0,1,3,-2
CHE,MEX,2022.0,3,17,-14
BFA,BEL,2009.0,1,4,-3
MYS,GHA,2011.0,1,1,0
HRV,CAN,2007.0,3,2,1
ISR,AUT,2005.0,3,3,0
FRA,LTU,2017.0,1,8,-7
ZWE,BEL,2003.0,1,1,0
AUT,IRN,2014.0,7,14,-7
VEN,AUS,2006.0,2,1,1
LKA,ZAF,2012.0,1,1,0
CHL,ECU,2011.0,1,1,0
COL,PER,2014.0,2,4,-2
MAR,DZA,2019.0,1,5,-4
SYR,DEU,2005.0,2,3,-1
FIN,TUR,2012.0,1,5,-4
MNG,USA,2009.0,1,4,-3
GHA,DNK,2008.0,1,1,0
LBY,USA,2011.0,3,1,2
SYR,GBR,1999.0,1,4,-3
TZA,ITA,2010.0,2,1,1
NZL,NOR,2007.0,1,1,0
NZL,FIN,2009.0,4,4,0
NOR,PAK,2009.0,1,2,-1
IRL,GRC,2011.0,2,2,0
POL,CYP,2015.0,1,1,0
UZB,USA,2013.0,1,3,-2
NLD,BGD,2008.0,1,1,0
DEU,ARM,2017.0,3,4,-1
ARE,SWE,2019.0,5,3,2
TZA,SWE,2011.0,1,3,-2
NLD,MOZ,2004.0,1,1,0
IRL,KOR,2012.0,4,4,0
CUB,VEN,2013.0,2,4,-2
TUN,DEU,2005.0,1,2,-1
DEU,BIH,2013.0,3,3,0
VNM,TWN,2010.0,2,5,-3
BIH,AUT,2012.0,1,1,0
IRN,KWT,2018.0,2,1,1
HKG,ISR,2016.0,2,2,0
CAN,IDN,2017.0,3,1,2
USA,NER,2012.0,1,1,0
NOR,BGD,2001.0,1,1,0
KAZ,ITA,2021.0,2,2,0
IDN,GBR,2011.0,1,12,-11
MWI,JPN,2007.0,1,1,0
BLR,UKR,2017.0,1,2,-1
AUS,NPL,2014.0,3,8,-5
MLI,KEN,2022.0,1,1,0
POL,CHN,2005.0,2,1,1
QAT,SAU,2006.0,1,4,-3
TWN,LUX,2022.0,1,1,0
ALB,DEU,2008.0,3,1,2
BLR,DEU,2022.0,3,3,0
LTU,DEU,2010.0,2,9,-7
LVA,CHE,2017.0,2,1,1
DNK,MEX,2010.0,2,4,-2
NZL,MEX,2011.0,3,1,2
IRL,BGD,2019.0,1,1,0
PHL,HKG,2016.0,4,4,0
SWE,KEN,2015.0,3,4,-1
BFA,DEU,2016.0,1,3,-2
NZL,PHL,2011.0,2,1,1
FJI,IND,2015.0,2,2,0
SVN,SLV,2007.0,2,1,1
CYP,USA,1998.0,2,8,-6
BTN,AUT,2015.0,1,1,0
GBR,PRI,2011.0,3,2,1
MEX,SLV,2014.0,1,1,0
MEX,TUR,2007.0,4,1,3
SWE,MEX,2012.0,3,9,-6
BGR,MKD,2013.0,1,1,0
ALB,USA,2016.0,3,5,-2
BGD,KEN,2014.0,1,1,0
GBR,CMR,2002.0,1,3,-2
CMR,GBR,2003.0,1,3,-2
CMR,NGA,2007.0,3,1,2
CHN,MEX,2023.0,1,6,-5
DEU,UGA,2020.0,4,7,-3
UGA,BEL,2020.0,3,5,-2
KOR,CHE,1998.0,2,1,1
ARE,ZAF,2020.0,1,9,-8
CZE,CHL,2019.0,2,5,-3
USA,NPL,1999.0,4,2,2
MAR,JPN,2023.0,2,3,-1
BFA,CIV,2019.0,2,3,-1
RUS,GHA,2021.0,2,1,1
VNM,AUT,2020.0,1,4,-3
SEN,CHE,2017.0,2,2,0
PAK,SVN,2020.0,1,1,0
NOR,LKA,2021.0,3,1,2
CAN,IRQ,2017.0,2,2,0
MAR,MLI,2017.0,3,3,0
DZA,PRT,2016.0,1,2,-1
LVA,EST,2022.0,1,2,-1
USA,COD,2020.0,6,2,4
ROU,IRQ,2017.0,4,2,2
PRI,VEN,2006.0,1,2,-1
FRA,HRV,2003.0,1,5,-4
DEU,ISL,2002.0,1,2,-1
PRT,TUN,2011.0,1,2,-1
NOR,MYS,2021.0,1,5,-4
COL,IND,2019.0,2,2,0
SRB,GRC,1999.0,3,2,1
GBR,TUN,2001.0,1,3,-2
NZL,ARG,2003.0,1,2,-1
BEL,DNK,2004.0,4,6,-2
GRC,UKR,2015.0,1,1,0
ETH,KEN,2004.0,1,3,-2
KEN,ETH,2005.0,3,1,2
FRA,ZMB,2019.0,2,1,1
ISR,CZE,2005.0,1,3,-2
BRA,IDN,2005.0,1,1,0
RUS,SRB,2010.0,1,5,-4
IND,KWT,2008.0,6,3,3
EGY,CHE,2002.0,4,3,1
ESP,ECU,1999.0,1,2,-1
GBR,COL,1997.0,2,1,1
ARG,DNK,2005.0,2,2,0
CUB,DEU,1998.0,3,3,0
AUT,ARG,2001.0,1,3,-2
FRA,CIV,1997.0,3,10,-7
CAN,ROU,2004.0,2,6,-4
CYP,CHE,2000.0,1,1,0
FIN,ROU,2014.0,2,4,-2
SVK,DNK,1997.0,2,1,1
NOR,UKR,2009.0,2,1,1
AZE,USA,2002.0,2,2,0
TUR,IND,1999.0,3,2,1
BFA,ITA,2002.0,1,3,-2
SAU,TUN,2004.0,1,1,0
NZL,OMN,2001.0,2,1,1
TZA,CHE,1999.0,2,2,0
MEX,CRI,2004.0,2,5,-3
UKR,TUR,2004.0,1,2,-1
GRC,UKR,2001.0,2,3,-1
USA,MOZ,2008.0,2,1,1
THA,SGP,2005.0,2,2,0
CAN,BGR,2010.0,3,3,0
ECU,DEU,2014.0,1,6,-5
CRI,CHL,2011.0,2,4,-2
PRT,MEX,2018.0,4,7,-3
PRT,MYS,2013.0,2,2,0
LVA,SWE,2010.0,2,5,-3
CHE,ETH,2010.0,2,3,-1
NZL,KEN,2014.0,1,1,0
BEN,ITA,2021.0,1,1,0
LTU,AUT,2013.0,1,2,-1
MDA,CAN,2010.0,1,1,0
TON,USA,2019.0,1,1,0
GEO,CAN,2011.0,2,1,1
ARG,SGP,2016.0,2,2,0
PER,CHL,2007.0,2,9,-7
NLD,RWA,2011.0,2,2,0
CAN,NGA,2011.0,1,12,-11
KGZ,RUS,2019.0,4,7,-3
UGA,FRA,2010.0,1,3,-2
RUS,IRN,2013.0,2,2,0
ARE,GBR,2000.0,7,14,-7
URY,GBR,2012.0,1,7,-6
KEN,CHE,2007.0,1,2,-1
USA,MMR,2015.0,1,4,-3
SYR,USA,2009.0,3,2,1
POL,CHN,1997.0,2,4,-2
CHN,PHL,2000.0,2,4,-2
SWE,UKR,2010.0,2,5,-3
ISL,IRL,2012.0,1,1,0
CAN,VEN,2016.0,3,2,1
SAU,CZE,2021.0,1,1,0
LUX,CHE,2008.0,1,2,-1
URY,ESP,2015.0,6,20,-14
GBR,GEO,2008.0,2,2,0
USA,MNP,2017.0,4,1,3
ZAF,TZA,2012.0,4,1,3
NLD,HRV,2013.0,2,4,-2
DEU,LBN,2013.0,2,7,-5
SAU,TWN,2023.0,3,3,0
CHE,KOR,2005.0,4,4,0
NAM,ZAF,2012.0,3,9,-6
BHR,KWT,2018.0,1,2,-1
IRL,IDN,2012.0,2,1,1
CRI,NIC,2018.0,3,2,1
NLD,RWA,2021.0,4,1,3
AUS,SRB,2015.0,1,4,-3
KEN,IND,1998.0,3,2,1
CHE,ARM,2016.0,1,1,0
FRA,GIN,2023.0,3,1,2
TUR,ETH,2019.0,1,1,0
MNE,USA,2013.0,2,1,1
GRC,SVK,2023.0,1,1,0
ISR,CHL,2018.0,1,4,-3
SGP,FIN,2013.0,3,3,0
EGY,SWE,2010.0,2,2,0
MOZ,BRA,2016.0,4,4,0
BEL,CYP,2020.0,2,1,1
TWN,ZAF,2020.0,1,1,0
MNP,USA,2019.0,1,3,-2
ALB,USA,2022.0,1,4,-3
PAK,MEX,2019.0,1,1,0
BGD,IRQ,2020.0,1,1,0
CZE,NPL,2019.0,1,1,0
BRA,IRN,2019.0,3,16,-13
LTU,FRA,2020.0,2,4,-2
ROU,IRQ,2022.0,3,3,0
GBR,GTM,2021.0,2,3,-1
TCD,FRA,2020.0,1,2,-1
AUS,KEN,2023.0,2,4,-2
GHA,MYS,2019.0,2,5,-3
ROU,NLD,2023.0,3,2,1
IND,HUN,2023.0,2,4,-2
SGP,VNM,2023.0,3,5,-2
MKD,AUT,2020.0,1,1,0
FIN,MAR,2023.0,3,2,1
MYS,AUT,2018.0,2,1,1
THA,ESP,2019.0,2,1,1
IRL,NOR,2022.0,3,5,-2
THA,ITA,2001.0,1,2,-1
PRT,NZL,2008.0,2,2,0
MCO,USA,2011.0,1,2,-1
THA,VNM,2004.0,2,1,1
KAZ,KOR,2014.0,1,1,0
CHE,LVA,2022.0,1,1,0
TTO,FRA,2016.0,1,1,0
CMR,BEN,2014.0,1,2,-1
BRA,URY,2007.0,4,5,-1
ZAF,COG,2014.0,3,2,1
USA,GRD,2012.0,4,3,1
TUR,DNK,2005.0,1,3,-2
ZAF,COG,2015.0,3,1,2
BFA,DEU,2018.0,2,1,1
CAN,ROU,2008.0,2,3,-1
GBR,URY,2005.0,1,3,-2
SRB,TUR,2005.0,3,1,2
ARG,PRT,2020.0,2,1,1
CZE,GHA,2021.0,2,1,1
BGD,IND,1997.0,3,4,-1
HUN,ETH,2020.0,1,1,0
HRV,BRA,2023.0,1,1,0
MUS,IND,2011.0,1,1,0
ZAF,LBY,2022.0,2,1,1
MEX,TUR,2020.0,1,2,-1
FRA,IRQ,2016.0,1,1,0
TUR,KEN,2021.0,1,1,0
PRI,NLD,2021.0,1,1,0
FRA,PAN,2023.0,1,1,0
EGY,LBN,2020.0,3,8,-5
CHN,BGD,2015.0,8,6,2
USA,HTI,2002.0,2,1,1
PRI,ZAF,2007.0,1,1,0
SAU,KWT,2015.0,4,4,0
URY,ITA,2003.0,1,1,0
DEU,CUB,2010.0,2,4,-2
IND,IRL,2001.0,2,2,0
DEU,LBN,2003.0,2,2,0
NZL,THA,2012.0,2,1,1
CUB,GBR,2003.0,3,1,2
EGY,CMR,2003.0,1,1,0
QAT,ESP,2022.0,2,2,0
SAU,AUS,2004.0,4,7,-3
NOR,NAM,2004.0,1,1,0
BEL,PER,2003.0,1,2,-1
FRA,IDN,2006.0,5,3,2
IRL,RUS,2008.0,2,5,-3
OMN,LKA,2017.0,1,1,0
PSE,USA,2003.0,1,3,-2
ARE,SGP,2006.0,1,1,0
NOR,MEX,2006.0,1,1,0
GRC,CZE,2006.0,2,1,1
FIN,ISL,2020.0,2,1,1
BRA,HUN,2014.0,1,1,0
SDN,GBR,2002.0,3,6,-3
SWE,AUS,2024.0,1,1,0
SEN,GBR,2018.0,2,2,0
THA,TUR,2017.0,1,1,0
BHR,IND,2016.0,1,2,-1
BRA,EGY,2016.0,1,3,-2
IRN,CYP,2015.0,2,2,0
UKR,ITA,2019.0,2,1,1
ZAF,AUT,2020.0,3,2,1
MYS,NZL,2009.0,4,8,-4
SGP,NZL,2003.0,4,6,-2
CMR,ITA,2015.0,4,6,-2
MLI,MAR,2016.0,1,1,0
NLD,SVN,1997.0,1,4,-3
GBR,BLR,2013.0,1,1,0
ISR,TWN,2015.0,1,4,-3
HKG,POL,2016.0,2,1,1
DEU,MKD,2012.0,1,2,-1
ESP,HKG,2021.0,3,3,0
KEN,ESP,2021.0,2,1,1
MUS,GBR,2020.0,1,3,-2
USA,MKD,2015.0,5,3,2
PHL,VNM,2016.0,2,2,0
IND,PRI,2021.0,2,2,0
PAK,HUN,2019.0,1,1,0
NOR,CHL,2021.0,1,1,0
CAN,MLI,2012.0,1,2,-1
NPL,BGD,2018.0,1,1,0
ITA,BHR,2009.0,1,1,0
PAN,GBR,2021.0,2,2,0
FRA,IDN,2023.0,3,7,-4
HKG,NOR,2020.0,2,4,-2
BOL,SWE,2022.0,3,3,0
LBN,IRN,2019.0,1,1,0
MUS,ZAF,2021.0,1,4,-3
URY,CAN,2023.0,2,1,1
NOR,PER,2016.0,1,1,0
SMR,ITA,2012.0,1,6,-5
ARE,BIH,2021.0,1,1,0
DNK,ARE,2022.0,1,2,-1
DEU,SLV,2021.0,1,1,0
DZA,ITA,2020.0,5,10,-5
USA,MDA,2021.0,2,4,-2
MDA,USA,2022.0,5,1,4
EGY,ESP,2000.0,2,1,1
SEN,NER,2021.0,3,1,2
KEN,SDN,2021.0,1,3,-2
VNM,SGP,2016.0,3,8,-5
MEX,PRT,2023.0,1,2,-1
LTU,PAK,2022.0,1,2,-1
ETH,ZAF,2012.0,4,6,-2
ITA,JOR,2023.0,1,2,-1
VNM,PAK,2020.0,2,11,-9
ZMB,JPN,2002.0,1,2,-1
JPN,CMR,2021.0,1,3,-2
QAT,JOR,2021.0,2,8,-6
GBR,COD,2023.0,4,3,1
EGY,NLD,2023.0,3,6,-3
IRQ,TUN,2023.0,3,1,2
MAR,EGY,2020.0,5,3,2
ECU,CRI,2020.0,2,1,1
CHE,OMN,2006.0,1,1,0
OMN,SDN,2016.0,1,3,-2
GBR,LAO,2022.0,1,2,-1
IND,BRB,2012.0,2,1,1
PNG,AUS,2002.0,4,4,0
USA,LAO,2012.0,4,1,3
USA,SLV,2009.0,1,2,-1
MKD,USA,2005.0,3,5,-2
CMR,GAB,2016.0,1,2,-1
UKR,JPN,2022.0,1,2,-1
PAK,ROU,2016.0,2,2,0
ITA,VEN,2014.0,1,1,0
PER,NLD,2016.0,2,2,0
NLD,CMR,2005.0,1,1,0
COL,VNM,2010.0,1,1,0
ZAF,DNK,2021.0,3,4,-1
ECU,BRA,2010.0,3,2,1
GHA,CAN,2007.0,3,2,1
POL,DZA,2016.0,1,2,-1
NGA,BEL,2012.0,2,1,1
ITA,MAR,2008.0,1,1,0
JPN,KEN,2010.0,3,6,-3
ETH,SWE,2007.0,1,2,-1
PHL,NLD,2008.0,1,2,-1
GBR,NAM,2009.0,2,1,1
PHL,NZL,2016.0,2,1,1
CHE,GTM,2023.0,2,1,1
SVK,JPN,2011.0,3,2,1
ROU,DZA,2011.0,1,1,0
CHE,GEO,2004.0,1,1,0
SGP,GRC,2016.0,1,4,-3
BGR,ITA,2005.0,2,6,-4
NER,BFA,2014.0,1,1,0
THA,FRA,2000.0,5,3,2
CHL,ISR,2020.0,1,3,-2
YEM,EGY,2008.0,1,3,-2
ETH,NGA,2004.0,1,1,0
CYP,CAN,2006.0,1,2,-1
DNK,EGY,2003.0,1,1,0
ESP,ROU,2007.0,1,8,-7
TZA,JPN,2007.0,1,5,-4
JPN,CUB,2004.0,1,2,-1
CAN,RWA,2020.0,4,3,1
DEU,BWA,2014.0,1,1,0
RUS,HRV,2014.0,1,1,0
UKR,ESP,2007.0,1,1,0
CRI,GBR,2015.0,1,5,-4
PHL,SGP,2003.0,1,2,-1
IND,CHL,2009.0,3,1,2
THA,NGA,2011.0,1,1,0
BGR,GRC,2011.0,4,1,3
AUS,JOR,2010.0,3,3,0
MAC,USA,2010.0,1,7,-6
BRA,GRC,2014.0,3,2,1
QAT,ZAF,2020.0,1,5,-4
ZAF,EGY,2022.0,4,2,2
ZAF,KOR,2011.0,4,3,1
CZE,GRC,2006.0,1,2,-1
KOR,NPL,2007.0,1,4,-3
AUT,IRN,2004.0,2,1,1
AUS,GRC,2006.0,2,3,-1
CHN,ARG,2015.0,1,1,0
QAT,DEU,2013.0,1,8,-7
BTN,AUS,2009.0,1,1,0
AUT,ZAF,2009.0,3,1,2
THA,CHE,2003.0,2,2,0
MDG,BEL,2013.0,1,1,0
PER,BOL,2005.0,1,3,-2
BOL,PER,2009.0,1,2,-1
DZA,CAN,2007.0,4,3,1
PRT,ARG,2020.0,1,2,-1
ESP,IRL,2006.0,2,7,-5
ETH,ESP,2019.0,1,2,-1
OMN,SAU,2012.0,2,4,-2
PRT,URY,2009.0,1,1,0
LKA,JPN,2014.0,3,13,-10
COL,SWE,2014.0,4,6,-2
EGY,PRT,2020.0,1,2,-1
HUN,MEX,2019.0,1,4,-3
ERI,CHN,2020.0,1,2,-1
CHN,UZB,2019.0,2,2,0
IND,PHL,2013.0,3,8,-5
KAZ,SAU,2018.0,2,3,-1
GHA,BEN,2021.0,3,4,-1
CZE,NGA,2022.0,2,1,1
IRN,ITA,1999.0,2,2,0
IND,RWA,2019.0,3,2,1
KAZ,FRA,2021.0,2,1,1
IRQ,ESP,2019.0,1,1,0
PRY,ARG,2008.0,1,2,-1
NOR,UKR,2019.0,1,3,-2
NOR,MYS,2011.0,1,3,-2
NZL,POL,2023.0,1,1,0
NZL,CHN,2024.0,1,1,0
TGO,SEN,2021.0,1,1,0
BRN,GBR,2021.0,1,7,-6
ARG,SGP,2018.0,2,1,1
NZL,BGD,2015.0,2,1,1
TWN,PHL,2023.0,5,15,-10
ISR,ETH,2022.0,2,1,1
ETH,HKG,2023.0,3,1,2
AUT,MNE,2022.0,2,1,1
HKG,BGD,2021.0,3,3,0
GBR,LBR,2020.0,2,2,0
PRT,IRN,2021.0,1,16,-15
SDN,FRA,2021.0,2,1,1
LSO,ZAF,2022.0,3,6,-3
NPL,PHL,2015.0,1,1,0
ARE,AUT,2020.0,2,1,1
TZA,DNK,2000.0,1,2,-1
KHM,MDG,2006.0,1,1,0
PER,KOR,2017.0,1,1,0
IDN,EST,2020.0,1,1,0
ARM,CHE,2018.0,1,3,-2
ZWE,USA,2004.0,8,3,5
TUR,HRV,2006.0,1,1,0
FIN,ZAF,2005.0,1,1,0
ESP,TWN,1998.0,2,1,1
TUN,USA,2004.0,4,6,-2
SAU,OMN,2003.0,2,1,1
HRV,CZE,2003.0,3,2,1
CZE,HRV,2006.0,2,1,1
CAN,SVN,2007.0,1,3,-2
RUS,TKM,2010.0,1,3,-2
SWE,NGA,2007.0,1,1,0
GHA,,2002.0,10,0,10
ARG,TWN,2006.0,2,0,2
ZAF,TWN,2008.0,1,0,1
CHN,HUN,2006.0,1,0,1
MUS,GBR,2006.0,1,0,1
IRL,MYS,2005.0,2,0,2
CMR,COG,1998.0,2,0,2
ARE,CZE,2001.0,1,0,1
GBR,BIH,1997.0,1,0,1
SGP,ITA,2005.0,1,0,1
NIC,ITA,1997.0,2,0,2
LBY,,2000.0,12,0,12
CHN,JOR,2008.0,1,0,1
ZMB,NOR,2013.0,2,0,2
GUF,NLD,2016.0,2,0,2
GBR,SLE,2009.0,1,0,1
NCL,,2010.0,8,0,8
NPL,,2000.0,9,0,9
,VUT,1994.0,2,0,2
VUT,,1999.0,2,0,2
CIV,NER,2006.0,1,0,1
CAN,FJI,2017.0,1,0,1
IND,CZE,2008.0,2,0,2
ETH,LBY,2010.0,1,0,1
UKR,SVK,2006.0,2,0,2
,PLW,1996.0,1,0,1
FRA,ALB,2021.0,1,0,1
BGR,TZA,2015.0,1,0,1
ERI,,2014.0,1,0,1
ETH,FIN,2010.0,1,0,1
PER,CRI,2011.0,1,0,1
SWE,HND,1999.0,1,0,1
KEN,PHL,2003.0,2,0,2
FRA,BOL,2016.0,1,0,1
SVN,SEN,2011.0,1,0,1
,LIE,2005.0,5,0,5
CIV,JPN,2014.0,1,0,1
EGY,AUS,2005.0,3,0,3
SVK,BGR,2009.0,2,0,2
AUS,GUF,2013.0,1,0,1
BEL,FRO,2008.0,1,0,1
FRA,PRY,2018.0,1,0,1
MOZ,DEU,2002.0,1,0,1
MDA,DEU,2006.0,2,0,2
TUN,NZL,2021.0,1,0,1
ASM,,2011.0,3,0,3
SVN,HUN,2005.0,1,0,1
ALB,DNK,2023.0,1,0,1
GRC,CHL,2009.0,1,0,1
GRL,NOR,2019.0,1,0,1
BRA,MAR,2022.0,4,0,4
NIC,JPN,2020.0,1,0,1
KOR,HUN,2014.0,1,0,1
CHL,THA,2019.0,1,0,1
ZAF,SWZ,2004.0,3,0,3
NIC,COL,2017.0,1,0,1
ISR,ARE,2013.0,1,0,1
,BTN,2008.0,12,0,12
SWE,SOM,2020.0,2,0,2
DEU,IRQ,2012.0,3,0,3
IND,DZA,2017.0,1,0,1
IND,PER,2016.0,1,0,1
IRN,BGD,2015.0,3,0,3
CAN,TZA,2012.0,2,0,2
HKG,BRN,2015.0,1,0,1
KWT,GHA,2018.0,2,0,2
FIN,KAZ,2016.0,3,0,3
GHA,GIN,2015.0,1,0,1
SDN,CHE,2011.0,1,0,1
MEX,DNK,2011.0,4,0,4
,GUF,1995.0,3,0,3
LUX,CHN,2010.0,2,0,2
PLW,BGD,2005.0,1,0,1
VCT,,2015.0,1,0,1
DZA,UGA,2019.0,1,0,1
BRA,KNA,2022.0,3,0,3
NOR,EGY,2020.0,1,0,1
DZA,QAT,2015.0,2,0,2
,VUT,2011.0,9,0,9
,MOZ,2020.0,55,0,55
LBN,SGP,2011.0,1,0,1
ROU,SVK,2018.0,1,0,1
ROU,COL,2022.0,1,0,1
USA,MUS,2012.0,1,0,1
BFA,NER,2020.0,5,0,5
KWT,VNM,2020.0,1,0,1
MTQ,CAN,2016.0,1,0,1
PAK,CUW,2021.0,1,0,1
COL,KEN,2023.0,2,0,2
IND,JOR,2000.0,2,0,2
JOR,IND,2002.0,1,0,1
MEX,HUN,2023.0,1,0,1
COL,CZE,2021.0,2,0,2
MOZ,UGA,2020.0,1,0,1
SEN,GMB,2013.0,3,0,3
GBR,CYM,2018.0,1,0,1
MMR,ITA,2021.0,2,0,2
MYS,GBR,2024.0,2,0,2
NPL,CAN,2001.0,1,0,1
MAR,AUT,2012.0,1,0,1
MAC,,2008.0,10,0,10
PAK,LUX,2021.0,2,0,2
GMB,PAK,2021.0,1,0,1
BRA,QAT,2020.0,2,0,2
BEN,MOZ,2021.0,1,0,1
SAU,TTO,2019.0,1,0,1
BGD,RWA,2022.0,1,0,1
NGA,KWT,2017.0,2,0,2
ESP,GNQ,2002.0,1,0,1
ETH,PER,2018.0,1,0,1
PER,IRQ,2022.0,1,0,1
ETH,DEU,1997.0,2,0,2
DNK,HKG,2001.0,2,0,2
KWT,BGD,2001.0,1,0,1
BRA,TUR,2002.0,1,0,1
ETH,MWI,2008.0,1,0,1
ROU,SAU,2017.0,3,0,3
AUS,UZB,2009.0,1,0,1
SWE,SAU,2009.0,2,0,2
MEX,UKR,1997.0,1,0,1
SHN,RUS,2018.0,3,0,3
DNK,SGP,2003.0,2,0,2
TWN,ISR,1999.0,1,0,1
SEN,CIV,2011.0,1,0,1
PAN,BRA,2006.0,1,0,1
NER,CMR,1997.0,1,0,1
NLD,BFA,1998.0,2,0,2
SEN,BOL,2008.0,1,0,1
CYP,IND,2004.0,1,0,1
EST,SVK,2022.0,1,0,1
ITA,TZA,1997.0,1,0,1
NLD,LVA,2019.0,1,0,1
IND,UGA,2005.0,1,0,1
CRI,ZAF,1998.0,1,0,1
LAO,THA,2003.0,2,0,2
KHM,JPN,1997.0,1,0,1
SVN,BEL,2000.0,1,0,1
CZE,SLV,2010.0,1,0,1
SLV,CZE,2011.0,1,0,1
SVK,ROU,2001.0,2,0,2
EST,ITA,2015.0,4,0,4
RUS,CHL,2010.0,2,0,2
RUS,VEN,2000.0,1,0,1
TGO,FRA,1997.0,1,0,1
IND,JOR,2006.0,2,0,2
ZWE,NZL,2002.0,3,0,3
CUB,CHN,2013.0,2,0,2
EGY,PER,2012.0,1,0,1
FRA,UGA,2009.0,4,0,4
GBR,COD,2020.0,2,0,2
QAT,PRT,2021.0,1,0,1
CRI,RUS,2002.0,1,0,1
GBR,FLK,2002.0,3,0,3
ZMB,NAM,2021.0,1,0,1
ETH,NER,2016.0,1,0,1
MOZ,,2002.0,5,0,5
IND,FJI,2013.0,2,0,2
CMR,GHA,2006.0,1,0,1
IRN,HKG,2011.0,2,0,2
UKR,AUS,2006.0,2,0,2
ETH,ROU,2012.0,3,0,3
JAM,AUS,2001.0,1,0,1
LKA,NZL,2012.0,2,0,2
,GLP,2005.0,13,0,13
CMR,IDN,2015.0,3,0,3
FIN,TUN,2005.0,1,0,1
HRV,BEL,2023.0,2,0,2
BEL,USA,2024.0,1,0,1
BEN,KEN,2020.0,2,0,2
USA,BDI,2020.0,2,0,2
CMR,BFA,2003.0,2,0,2
,VIR,2001.0,1,0,1
VIR,TTO,2006.0,1,0,1
GBR,AGO,2021.0,2,0,2
KWT,BHR,2009.0,1,0,1
USA,MNE,2010.0,1,0,1
SVN,NZL,2019.0,1,0,1
MDG,BFA,2017.0,1,0,1
ESP,QAT,2011.0,2,0,2
SYR,CAN,2006.0,2,0,2
ITA,PER,2012.0,1,0,1
PAK,CMR,2019.0,1,0,1
NZL,PNG,2000.0,1,0,1
OMN,MAR,2013.0,2,0,2
BRN,LKA,2018.0,1,0,1
CHN,COG,2016.0,3,0,3
,FSM,2011.0,4,0,4
FSM,,2016.0,4,0,4
,NIU,2012.0,2,0,2
ITA,SWZ,2010.0,1,0,1
MHL,,2016.0,2,0,2
,LIE,2012.0,8,0,8
MYS,AFG,2017.0,1,0,1
LUX,DNK,2023.0,2,0,2
ASM,,2021.0,1,0,1
HUN,GRC,2014.0,1,0,1
PAK,JOR,2018.0,1,0,1
HUN,MNG,2020.0,2,0,2
KOR,CHE,2000.0,4,0,4
POL,IRN,2004.0,1,0,1
SYR,CHN,2003.0,2,0,2
IRN,YEM,2017.0,1,0,1
NOR,ROU,2004.0,3,0,3
BEL,NER,2018.0,2,0,2
NGA,MLI,2000.0,1,0,1
THA,SAU,2012.0,2,0,2
NOR,BRA,1997.0,1,0,1
GBR,SLE,2011.0,2,0,2
SLE,,2014.0,3,0,3
MLT,CAN,2003.0,1,0,1
SRB,ARE,2020.0,5,0,5
PHL,KEN,2002.0,2,0,2
NZL,ARM,2006.0,1,0,1
KEN,MEX,2010.0,1,0,1
OMN,PRT,2018.0,1,0,1
BGD,ZWE,2022.0,1,0,1
ROU,CZE,1997.0,2,0,2
VNM,SAU,2021.0,5,0,5
RUS,SAU,2023.0,6,0,6
,ARG,2021.0,7,0,7
KOR,CHE,2024.0,1,0,1
IRN,SYR,2022.0,1,0,1
BGD,ARE,2023.0,3,0,3
,TTO,2020.0,28,0,28
DZA,ISL,2023.0,1,0,1
JPN,URY,2017.0,1,0,1
DOM,USA,1999.0,4,0,4
HRV,JPN,2000.0,2,0,2
DEU,GMB,2006.0,1,0,1
DNK,GNB,2003.0,6,0,6
MSR,GBR,2002.0,1,0,1
IND,MWI,1997.0,1,0,1
SDN,SWE,1997.0,1,0,1
FIN,SVN,2006.0,1,0,1
KHM,IDN,2006.0,1,0,1
CRI,SWE,2010.0,1,0,1
MCO,,2006.0,6,0,6
GBR,GIB,2008.0,2,0,2
HKG,IRN,2003.0,2,0,2
BEL,NIC,2003.0,1,0,1
NLD,LKA,2002.0,3,0,3
TUR,GEO,2016.0,3,0,3
LBR,,2007.0,1,0,1
PNG,ARE,2003.0,1,0,1
JPN,ECU,2013.0,2,0,2
TTO,ESP,2012.0,2,0,2
POL,SGP,1999.0,1,0,1
SRB,THA,2019.0,1,0,1
BDI,,2013.0,5,0,5
PAK,AUS,1997.0,1,0,1
KAZ,SLE,2023.0,1,0,1
HND,ECU,1999.0,1,0,1
TCD,,2014.0,1,0,1
CAN,LTU,2017.0,3,0,3
ESP,TUN,2003.0,2,0,2
ZAF,SSD,2015.0,1,0,1
FRA,MRT,2009.0,2,0,2
FRA,MMR,2012.0,1,0,1
DEU,MDG,2015.0,1,0,1
LBY,TWN,2012.0,1,0,1
MDV,KEN,2021.0,1,0,1
CRI,LBR,2011.0,1,0,1
AFG,THA,2016.0,1,0,1
ROU,AZE,2012.0,1,0,1
CHN,LBR,2018.0,1,0,1
ITA,CIV,2015.0,2,0,2
GHA,HUN,2015.0,1,0,1
MYS,ISR,2009.0,1,0,1
CHN,AFG,2015.0,1,0,1
GRC,ALB,2010.0,1,0,1
NZL,ARG,2017.0,1,0,1
ITA,KWT,2017.0,2,0,2
IND,CYP,2016.0,1,0,1
TWN,BGD,2011.0,1,0,1
ARG,SVK,2023.0,1,0,1
CAN,GEO,2015.0,2,0,2
BRA,IRL,2007.0,2,0,2
TZA,BDI,2015.0,1,0,1
ISR,HKG,2022.0,1,0,1
TUN,NER,2021.0,2,0,2
DNK,TZA,2014.0,5,0,5
PAK,AUT,2003.0,3,0,3
ZAF,JPN,2012.0,4,0,4
DZA,KOR,2017.0,1,0,1
LAO,KHM,2013.0,1,0,1
SAU,IRQ,2007.0,1,0,1
NOR,LTU,2021.0,2,0,2
PRY,,2010.0,7,0,7
NZL,ECU,2015.0,2,0,2
DEU,BFA,2019.0,2,0,2
,PLW,2014.0,2,0,2
AUS,GMB,2019.0,1,0,1
SEN,TGO,2017.0,1,0,1
MRT,USA,2021.0,1,0,1
GEO,KOR,2021.0,1,0,1
COL,SGP,2022.0,1,0,1
SWE,AFG,2019.0,1,0,1
SEN,CHN,2017.0,1,0,1
DEU,KGZ,2019.0,2,0,2
PER,PHL,2001.0,1,0,1
POL,LBY,2016.0,2,0,2
CMR,ESP,2019.0,1,0,1
CZE,LUX,2020.0,2,0,2
SSD,NOR,2018.0,1,0,1
DEU,RWA,2023.0,2,0,2
IND,DZA,2022.0,2,0,2
NGA,EST,2023.0,2,0,2
SAU,EST,2022.0,2,0,2
ZWE,SWE,2001.0,1,0,1
IRN,MAR,2023.0,2,0,2
NER,SEN,2022.0,1,0,1
,CYM,2019.0,3,0,3
CYM,ESP,2023.0,1,0,1
,OMN,2021.0,3,0,3
CAN,RWA,2024.0,1,0,1
SYR,USA,1997.0,4,0,4
HKG,LAO,2013.0,1,0,1
HKG,DNK,1997.0,2,0,2
NOR,UGA,2006.0,4,0,4
MLI,NGA,2019.0,2,0,2
ETH,NAM,2014.0,1,0,1
BLZ,BGR,2018.0,1,0,1
NRU,USA,2003.0,1,0,1
CYP,FRA,1998.0,1,0,1
GRC,HRV,2008.0,1,0,1
CMR,CIV,2004.0,2,0,2
ZAF,CAF,2008.0,1,0,1
CHE,MAR,2011.0,1,0,1
GBR,LBY,1997.0,1,0,1
LTU,IND,2005.0,1,0,1
GBR,PRI,2012.0,1,0,1
BGR,CZE,2006.0,2,0,2
GMB,KEN,2016.0,1,0,1
MAR,KOR,2005.0,1,0,1
CYP,ARE,2018.0,3,0,3
USA,ALB,1998.0,2,0,2
NOR,MYS,2005.0,2,0,2
EGY,MEX,2004.0,1,0,1
KEN,BWA,2002.0,4,0,4
RWA,CAN,2005.0,1,0,1
HRV,LTU,2020.0,1,0,1
MAR,TWN,2012.0,2,0,2
BDI,ITA,2005.0,1,0,1
IND,KEN,2004.0,2,0,2
BFA,AUT,2009.0,1,0,1
TUR,KAZ,1999.0,1,0,1
EST,ESP,2007.0,2,0,2
IND,BLZ,2015.0,1,0,1
BEL,CUB,2003.0,4,0,4
ISR,MOZ,1997.0,1,0,1
LBY,FRA,2000.0,2,0,2
VEN,BOL,2012.0,1,0,1
CZE,GEO,2003.0,1,0,1
MNG,AUS,2002.0,2,0,2
POL,NZL,2012.0,1,0,1
BOL,DNK,2007.0,2,0,2
,BLZ,1998.0,1,0,1
BLZ,,2004.0,1,0,1
GMB,ESP,2017.0,1,0,1
NLD,AIA,2014.0,3,0,3
COL,TZA,2022.0,1,0,1
DEU,URY,2006.0,3,0,3
DNK,CHL,2004.0,3,0,3
GRC,CHN,2007.0,2,0,2
NZL,URY,2014.0,1,0,1
CUB,PRT,2003.0,2,0,2
PSE,QAT,2004.0,1,0,1
CYM,HKG,2007.0,1,0,1
ISR,MLI,2018.0,1,0,1
BLR,CZE,2012.0,2,0,2
OMN,JPN,2004.0,1,0,1
MWI,TZA,2009.0,1,0,1
AUS,OMN,2012.0,3,0,3
AUS,MOZ,2020.0,1,0,1
NLD,LTU,2009.0,1,0,1
UKR,GEO,2007.0,2,0,2
SVN,CZE,2014.0,7,0,7
COL,MYS,2013.0,1,0,1
GUM,SAU,2002.0,1,0,1
ITA,UZB,2009.0,1,0,1
JPN,SVN,2022.0,1,0,1
UGA,ESP,2016.0,1,0,1
LBN,IRL,2013.0,1,0,1
GIN,CAN,2011.0,3,0,3
,WSM,2005.0,2,0,2
CMR,SEN,2010.0,1,0,1
EGY,SYR,2004.0,1,0,1
TTO,UKR,2011.0,1,0,1
CHN,NAM,2011.0,1,0,1
KHM,CHE,2012.0,4,0,4
ISR,POL,2005.0,2,0,2
DEU,TGO,2015.0,2,0,2
ITA,MCO,2008.0,2,0,2
MEX,BOL,2011.0,2,0,2
SSD,COG,2019.0,1,0,1
,TCD,2007.0,7,0,7
TCD,FRA,2010.0,1,0,1
MAR,COM,2016.0,1,0,1
AFG,IRQ,2022.0,2,0,2
CAN,CRI,1997.0,3,0,3
ARM,IRN,2011.0,5,0,5
USA,GUY,1997.0,1,0,1
SGP,BGD,2020.0,5,0,5
VEN,HUN,2011.0,1,0,1
RUS,MKD,2021.0,3,0,3
,GLP,2002.0,8,0,8
DZA,IRQ,2008.0,1,0,1
ITA,COL,2003.0,2,0,2
TWN,NPL,2014.0,2,0,2
ARG,AUT,2012.0,5,0,5
SVN,SLV,2000.0,2,0,2
ISR,URY,1998.0,1,0,1
CHE,MOZ,2020.0,2,0,2
CHN,DZA,2016.0,1,0,1
CHE,SDN,2018.0,1,0,1
LBN,KWT,2012.0,1,0,1
SGP,GHA,2017.0,1,0,1
ARG,SAU,2023.0,2,0,2
KOR,ASM,2018.0,1,0,1
BFA,BRA,2006.0,1,0,1
CHL,LUX,2009.0,1,0,1
BHS,GBR,2012.0,2,0,2
BGD,GMB,2014.0,1,0,1
ZAF,TUN,2012.0,2,0,2
JOR,LBY,2016.0,1,0,1
POL,EST,2016.0,1,0,1
DMA,,2019.0,7,0,7
AZE,IRL,2018.0,1,0,1
GMB,BEL,2019.0,1,0,1
DEU,LIE,2020.0,3,0,3
NER,NLD,2014.0,1,0,1
HUN,KWT,2005.0,1,0,1
MAR,DZA,2002.0,1,0,1
IRN,QAT,2009.0,1,0,1
USA,SUR,2023.0,1,0,1
BEL,COL,1998.0,3,0,3
IND,GHA,2006.0,1,0,1
AUS,OMN,2002.0,1,0,1
FRA,OMN,2003.0,4,0,4
CYP,ITA,2001.0,1,0,1
BLR,AUT,1997.0,1,0,1
AUT,CMR,1999.0,2,0,2
VEN,ECU,2009.0,1,0,1
PNG,NGA,2009.0,1,0,1
TCA,GBR,2000.0,1,0,1
MMR,MYS,2001.0,1,0,1
GBR,SLV,1999.0,1,0,1
KOR,IRL,2005.0,1,0,1
BOL,IND,2004.0,1,0,1
,CPV,1994.0,1,0,1
GRL,USA,2009.0,1,0,1
CRI,DOM,2011.0,1,0,1
DEU,FRO,2002.0,1,0,1
SGP,OMN,2009.0,1,0,1
SWE,NAM,2002.0,1,0,1
NAM,AUS,2000.0,1,0,1
BOL,BEL,1998.0,1,0,1
SEN,KEN,2014.0,2,0,2
KEN,CHL,1997.0,1,0,1
MWI,ZWE,1999.0,1,0,1
ZWE,GHA,2007.0,1,0,1
ITA,PAK,2000.0,1,0,1
URY,CAN,1998.0,2,0,2
CIV,CAN,2001.0,1,0,1
NLD,BOL,2000.0,1,0,1
AUS,BWA,2003.0,2,0,2
SAU,QAT,1998.0,2,0,2
USA,MLT,2011.0,6,0,6
AUT,SAU,2007.0,1,0,1
GNB,,2007.0,1,0,1
CHE,GHA,1998.0,1,0,1
GHA,EGY,2008.0,1,0,1
EST,NZL,2001.0,2,0,2
NOR,TWN,2006.0,2,0,2
SYC,NGA,2009.0,1,0,1
IND,PRI,1997.0,1,0,1
HRV,JPN,2010.0,1,0,1
NAM,DEU,2000.0,1,0,1
ARG,FIN,2010.0,2,0,2
NLD,KWT,2006.0,1,0,1
,SUR,1998.0,2,0,2
IRL,BWA,2013.0,1,0,1
USA,ATG,2010.0,2,0,2
PNG,IDN,2008.0,2,0,2
NOR,VNM,2015.0,4,0,4
ARM,CMR,2008.0,2,0,2
SAU,MEX,2005.0,1,0,1
LBN,SAU,2007.0,3,0,3
ZAF,OMN,1999.0,3,0,3
CUB,CHE,2007.0,1,0,1
ZWE,DEU,2006.0,2,0,2
NZL,BWA,2013.0,1,0,1
VNM,PER,2020.0,1,0,1
TZA,PAK,2005.0,1,0,1
DZA,BRA,2006.0,1,0,1
LKA,BFA,2011.0,1,0,1
CZE,SRB,2016.0,2,0,2
SAU,NLD,2005.0,2,0,2
CIV,AUT,2010.0,1,0,1
CRI,BRA,2006.0,1,0,1
ETH,OMN,2017.0,1,0,1
IND,COL,2011.0,2,0,2
SGP,FIN,2016.0,4,0,4
,CAF,2008.0,5,0,5
TZA,BWA,2013.0,1,0,1
JOR,KOR,2010.0,1,0,1
LTU,PRT,2012.0,1,0,1
IND,LUX,2014.0,2,0,2
,BRN,2004.0,3,0,3
PRI,PAN,2017.0,1,0,1
MSR,,2025.0,2,0,2
HUN,HKG,2017.0,1,0,1
NOR,CYP,2021.0,1,0,1
COL,ITA,2007.0,3,0,3
BHS,JAM,2022.0,1,0,1
ESP,AFG,2006.0,1,0,1
SYR,KOR,2014.0,2,0,2
IRN,ARG,2014.0,1,0,1
LTU,IRN,2009.0,1,0,1
MWI,BEL,2015.0,2,0,2
BEL,MWI,2016.0,1,0,1
EST,HKG,2016.0,1,0,1
ZMB,NOR,2003.0,1,0,1
CZE,NLD,2024.0,1,0,1
DEU,ZWE,2014.0,1,0,1
FJI,CZE,2008.0,1,0,1
GMB,GAB,2018.0,1,0,1
JPN,SRB,2015.0,1,0,1
MYS,CZE,2012.0,1,0,1
HND,USA,1997.0,1,0,1
AZE,DZA,2010.0,1,0,1
COL,USA,2024.0,1,0,1
BGR,CHL,2005.0,1,0,1
SWZ,HKG,2014.0,1,0,1
HUN,QAT,2023.0,1,0,1
NER,GBR,2009.0,1,0,1
SVN,PAK,2012.0,1,0,1
CHN,ZWE,2019.0,2,0,2
GEO,FIN,2001.0,1,0,1
ABW,,2016.0,1,0,1
COM,CMR,2014.0,3,0,3
SLB,ARG,2017.0,1,0,1
GAB,COG,2019.0,2,0,2
SWZ,FRA,2021.0,1,0,1
BLR,NOR,2021.0,1,0,1
ITA,LVA,1997.0,1,0,1
GBR,NCL,2007.0,2,0,2
SDN,NPL,2015.0,2,0,2
SGP,THA,1997.0,3,0,3
IND,PER,2017.0,1,0,1
ASM,AUS,2018.0,1,0,1
MUS,AUS,2021.0,1,0,1
COG,CIV,2019.0,3,0,3
MKD,IND,2021.0,3,0,3
URY,RUS,2020.0,1,0,1
SEN,TCD,2017.0,1,0,1
SAU,EST,2018.0,2,0,2
IRN,PER,2018.0,1,0,1
PAK,MAR,2022.0,2,0,2
PAK,MAR,2018.0,1,0,1
SRB,PRT,2019.0,3,0,3
AZE,BGR,2019.0,1,0,1
MDG,SEN,2011.0,2,0,2
CPV,GBR,2016.0,1,0,1
PHL,THA,2009.0,3,0,3
ZMB,VNM,2020.0,1,0,1
TUN,BHR,2014.0,2,0,2
LKA,ISR,2020.0,1,0,1
SAU,LBY,2022.0,1,0,1
IRQ,KOR,2022.0,2,0,2
EGY,BRN,2022.0,2,0,2
ZAF,ERI,2003.0,3,0,3
THA,BTN,2023.0,1,0,1
IRL,QAT,2011.0,1,0,1
GHA,BFA,2021.0,2,0,2
,BLZ,2020.0,2,0,2
BDI,MUS,2022.0,1,0,1
EGY,BEL,2004.0,3,0,3
TWN,FIN,2010.0,1,0,1
CHE,SWZ,2000.0,3,0,3
ISR,BGR,2005.0,2,0,2
PHL,LAO,2008.0,1,0,1
LAO,PHL,2014.0,1,0,1
FRO,SWE,2017.0,1,0,1
IND,PRI,2002.0,2,0,2
BEL,SYR,2008.0,1,0,1
VEN,PRT,2006.0,4,0,4
TKM,RUS,2002.0,1,0,1
OMN,SWE,2016.0,2,0,2
BGR,DNK,1997.0,1,0,1
BRN,AUS,2007.0,2,0,2
SAU,NOR,1999.0,1,0,1
KOR,PRI,2011.0,1,0,1
PRI,KOR,2012.0,1,0,1
SAU,SGP,1997.0,1,0,1
CHL,PAK,2019.0,1,0,1
CHL,PRY,2013.0,1,0,1
MEX,AUT,2000.0,1,0,1
HKG,JOR,2017.0,2,0,2
,BHS,1997.0,3,0,3
KWT,KOR,2021.0,1,0,1
DEU,SEN,2012.0,1,0,1
EST,VNM,2017.0,3,0,3
ZAF,OMN,1998.0,1,0,1
VNM,KHM,2000.0,1,0,1
VNM,CRI,2019.0,1,0,1
NOR,ARM,2012.0,1,0,1
AUT,BGR,1997.0,2,0,2
PNG,CHE,1998.0,1,0,1
HKG,CHE,1999.0,3,0,3
SRB,CHL,2002.0,1,0,1
CYP,ZAF,2014.0,1,0,1
EGY,TWN,2001.0,1,0,1
CHN,PER,2003.0,1,0,1
ARM,ASM,2009.0,2,0,2
NPL,ITA,2004.0,2,0,2
HKG,TZA,2010.0,1,0,1
KAZ,UKR,2019.0,2,0,2
NLD,TZA,2001.0,4,0,4
SEN,PNG,1999.0,1,0,1
BLR,ISR,2016.0,1,0,1
TUN,IND,2013.0,1,0,1
IND,TUN,2015.0,1,0,1
AUT,KEN,2023.0,1,0,1
ARE,NLD,2001.0,1,0,1
BGD,ESP,2010.0,1,0,1
BGR,PAK,2009.0,1,0,1
POL,ROU,2020.0,3,0,3
SWE,MAR,2018.0,3,0,3
BGD,NGA,2014.0,1,0,1
MNP,,2017.0,2,0,2
GHA,ARE,2017.0,1,0,1
LBN,ESP,2018.0,3,0,3
MUS,AUS,2019.0,2,0,2
KWT,BGD,2004.0,2,0,2
CHN,TZA,2015.0,2,0,2
DEU,MTQ,2015.0,1,0,1
GEO,AUT,2015.0,1,0,1
ALB,KWT,2021.0,1,0,1
CAN,MWI,2015.0,2,0,2
CHN,HND,2019.0,1,0,1
NLD,BEN,2019.0,1,0,1
UZB,UGA,2017.0,1,0,1
EGY,TUR,2017.0,5,0,5
TCA,,2023.0,2,0,2
EGY,DZA,2015.0,2,0,2
SYR,GBR,2023.0,3,0,3
HUN,DZA,2020.0,3,0,3
CYP,ARE,2017.0,1,0,1
AUT,JOR,2018.0,1,0,1
TUR,PSE,2022.0,5,0,5
,VGB,2016.0,2,0,2
SEN,COD,2019.0,4,0,4
PER,SEN,2023.0,1,0,1
KHM,GHA,2022.0,1,0,1
ISL,AUT,2004.0,1,0,1
AUT,ISL,2005.0,1,0,1
GUY,CAN,2012.0,2,0,2
GEO,AUT,2004.0,1,0,1
UGA,MWI,2019.0,1,0,1
IDN,EGY,2017.0,1,0,1
GHA,COD,2020.0,1,0,1
CYM,GBR,2010.0,1,0,1
DOM,NLD,2022.0,1,0,1
,CHE,2021.0,11,0,11
MDV,GBR,2013.0,1,0,1
GMB,CHE,2023.0,2,0,2
MWI,IRN,2022.0,1,0,1
CMR,CAF,2022.0,4,0,4
CYP,USA,2024.0,1,0,1
,GNQ,2003.0,2,0,2
PNG,ITA,2016.0,1,0,1
NZL,ROU,2004.0,1,0,1
ROU,NZL,2007.0,2,0,2
BMU,AUT,2013.0,1,0,1
CHE,IDN,2012.0,1,0,1
AUS,MAC,2006.0,1,0,1
MEX,ARE,2008.0,2,0,2
ESP,DZA,2005.0,2,0,2
GRC,RUS,2003.0,2,0,2
ESP,SGP,2000.0,2,0,2
KHM,COL,2012.0,2,0,2
BGD,SEN,2013.0,1,0,1
UKR,BRA,2012.0,2,0,2
FRA,VUT,2007.0,1,0,1
BEL,SYR,2014.0,1,0,1
IRL,SAU,2004.0,2,0,2
BWA,AUS,2004.0,1,0,1
HUN,TUN,2008.0,1,0,1
TUN,HUN,2009.0,1,0,1
BEL,CIV,2002.0,1,0,1
PRT,FJI,2019.0,1,0,1
LAO,COD,2008.0,1,0,1
KAZ,JPN,2001.0,2,0,2
ZMB,BWA,1999.0,2,0,2
GBR,MMR,2017.0,1,0,1
ECU,POL,2021.0,2,0,2
ERI,,2015.0,3,0,3
,LIE,2002.0,7,0,7
SWE,MAR,2017.0,1,0,1
IND,SRB,2022.0,2,0,2
AFG,,2008.0,3,0,3
GIN,,2014.0,5,0,5
HRV,TUR,2002.0,1,0,1
SEN,CHN,2016.0,2,0,2
ECU,CHN,2002.0,1,0,1
NZL,SMR,2022.0,1,0,1
MOZ,PRT,2009.0,2,0,2
BRA,KOR,2006.0,1,0,1
MWI,CAN,2021.0,3,0,3
BGR,KOR,2014.0,1,0,1
PHL,NGA,2015.0,1,0,1
SVK,ISR,2016.0,1,0,1
GIN,GBR,2017.0,1,0,1
CAN,MAC,2006.0,2,0,2
POL,ZAF,2007.0,2,0,2
ARG,JPN,2012.0,2,0,2
KEN,CZE,2022.0,1,0,1
MEX,TUR,2023.0,1,0,1
SVN,TWN,2017.0,1,0,1
JOR,ZAF,2021.0,1,0,1
MLT,AUS,2018.0,2,0,2
ITA,AZE,2012.0,1,0,1
MEX,SHN,2018.0,1,0,1
SHN,MEX,2019.0,1,0,1
DNK,JOR,2023.0,1,0,1
IRQ,JPN,2023.0,1,0,1
ZWE,TUR,2020.0,1,0,1
,VCT,2016.0,1,0,1
ITA,IRQ,2022.0,4,0,4
GNB,,2020.0,5,0,5
CHL,VUT,1999.0,1,0,1
POL,MYS,2002.0,1,0,1
SLB,,1999.0,1,0,1
SEN,GMB,2003.0,1,0,1
JPN,SLE,2003.0,1,0,1
CZE,ARE,2012.0,2,0,2
GLP,BEL,1997.0,1,0,1
TZA,KWT,2014.0,1,0,1
LTU,NLD,2005.0,2,0,2
SWE,SDN,2000.0,1,0,1
LBN,IRQ,2021.0,1,0,1
CMR,KEN,1997.0,1,0,1
KEN,ITA,2006.0,1,0,1
ZMB,CHL,2011.0,2,0,2
BGR,CRI,2002.0,1,0,1
BEL,LBN,2002.0,2,0,2
TTO,JAM,2000.0,2,0,2
RUS,CHL,2006.0,1,0,1
RUS,AZE,2007.0,5,0,5
BLR,JPN,2004.0,1,0,1
IDN,LAO,2009.0,1,0,1
LVA,FRA,2004.0,1,0,1
,GUM,1998.0,4,0,4
JPN,MAR,1998.0,1,0,1
GRC,LBN,1998.0,1,0,1
QAT,IRN,2002.0,1,0,1
USA,GIB,2005.0,1,0,1
KEN,DNK,2000.0,2,0,2
JPN,ETH,2006.0,3,0,3
PAK,NZL,2005.0,1,0,1
NZL,QAT,2011.0,2,0,2
NOR,ZWE,2010.0,1,0,1
ITA,THA,1999.0,1,0,1
JPN,LUX,2010.0,1,0,1
OMN,GHA,2011.0,1,0,1
HUN,NZL,2015.0,2,0,2
CAN,TZA,1997.0,1,0,1
BEN,MTQ,2012.0,1,0,1
MOZ,,2012.0,8,0,8
HKG,CUB,2014.0,3,0,3
DEU,BMU,2017.0,1,0,1
DEU,BMU,2022.0,1,0,1
DOM,PER,2019.0,1,0,1
SWE,BOL,2017.0,5,0,5
FRA,IRQ,2013.0,2,0,2
BWA,KAZ,2017.0,2,0,2
HUN,SDN,2018.0,1,0,1
FIN,LVA,2001.0,2,0,2
SAU,ARG,2008.0,1,0,1
TTO,BRA,2010.0,1,0,1
ESP,MCO,2013.0,1,0,1
FRA,BIH,2011.0,3,0,3
JPN,SYR,2005.0,2,0,2
NGA,SAU,2017.0,1,0,1
SAU,ZAF,1999.0,1,0,1
ASM,MNP,2021.0,1,0,1
,MNP,2010.0,2,0,2
USA,BRN,2007.0,2,0,2
JOR,NPL,2017.0,1,0,1
KOR,IRL,2018.0,3,0,3
VNM,LAO,2020.0,2,0,2
LBN,NGA,2019.0,1,0,1
AFG,ALB,2020.0,1,0,1
TZA,GHA,2019.0,2,0,2
CAN,BRN,2014.0,2,0,2
GLP,GBR,1997.0,1,0,1
AFG,CHE,2021.0,2,0,2
AZE,FRA,2020.0,2,0,2
PRT,STP,2020.0,1,0,1
COD,TZA,2019.0,1,0,1
TZA,COD,2020.0,1,0,1
SSD,ETH,2022.0,1,0,1
ROU,PNG,2019.0,1,0,1
BEN,DEU,2021.0,2,0,2
QAT,ROU,2022.0,1,0,1
,CUW,2019.0,2,0,2
NGA,PNG,2022.0,1,0,1
GBR,GIB,2023.0,6,0,6
VGB,,2024.0,10,0,10
DEU,SYC,2021.0,1,0,1
GUM,AUS,2023.0,1,0,1
KHM,SWE,2022.0,1,0,1
PRY,GBR,2000.0,1,0,1
COG,ZWE,1998.0,1,0,1
SWE,GEO,2006.0,1,0,1
BFA,,2000.0,7,0,7
SVK,ESP,2003.0,2,0,2
,SYC,1996.0,3,0,3
BEL,PER,2002.0,1,0,1
UGA,ZWE,2007.0,2,0,2
,TON,1996.0,1,0,1
FJI,,2007.0,5,0,5
FJI,PYF,2002.0,1,0,1
NCL,FJI,2013.0,1,0,1
PAK,LKA,2002.0,5,0,5
TWN,TUR,2010.0,2,0,2
PHL,NCL,2006.0,1,0,1
AZE,USA,2003.0,1,0,1
BIH,ISR,2011.0,1,0,1
CHN,SLE,2005.0,1,0,1
CHE,CMR,1999.0,1,0,1
JPN,BRN,2006.0,1,0,1
MEX,PRY,2007.0,2,0,2
BEN,,2014.0,32,0,32
OMN,PHL,2004.0,1,0,1
SGP,LKA,2004.0,1,0,1
UGA,IRL,2021.0,1,0,1
CZE,IRQ,2019.0,1,0,1
MTQ,,2015.0,10,0,10
GBR,MNG,2002.0,1,0,1
AUS,SLE,2018.0,2,0,2
GBR,JAM,2004.0,5,0,5
,BTN,2000.0,5,0,5
CUB,DEU,2001.0,5,0,5
MCO,,2008.0,6,0,6
ZWE,MWI,2000.0,1,0,1
OMN,BGD,2020.0,3,0,3
USA,NAM,2000.0,1,0,1
UGA,ETH,2013.0,3,0,3
COD,SLE,2018.0,1,0,1
ZAF,FLK,2002.0,1,0,1
BRA,MAR,2002.0,1,0,1
AZE,IRN,2002.0,2,0,2
IND,ROU,2000.0,1,0,1
THA,CZE,2011.0,2,0,2
HKG,ESP,2002.0,2,0,2
IND,ZWE,2003.0,1,0,1
ALB,ARM,2003.0,1,0,1
GMB,,2007.0,7,0,7
MAR,LBN,2010.0,1,0,1
AUS,SVK,2011.0,3,0,3
USA,COD,2008.0,2,0,2
ZMB,ZWE,2014.0,1,0,1
BFA,COG,2023.0,1,0,1
GBR,BRB,2011.0,3,0,3
BES,,2024.0,1,0,1
,ERI,1999.0,3,0,3
FRO,,2002.0,1,0,1
MLI,MDG,2021.0,1,0,1
,HND,1997.0,10,0,10
NPL,CHE,2012.0,2,0,2
VNM,GHA,2010.0,1,0,1
RWA,TTO,2004.0,1,0,1
JAM,ATG,2022.0,1,0,1
SWE,SGP,1998.0,2,0,2
AUT,TWN,2013.0,5,0,5
MUS,GBR,2008.0,2,0,2
ETH,CAN,1998.0,1,0,1
TWN,PAK,2004.0,1,0,1
EGY,ECU,2003.0,1,0,1
ZMB,SLE,2018.0,1,0,1
ZAF,MEX,2012.0,1,0,1
BEL,MKD,2004.0,1,0,1
CRI,IDN,2008.0,1,0,1
MRT,,2011.0,3,0,3
KHM,SGP,2019.0,1,0,1
LKA,IRL,2011.0,1,0,1
USA,PRY,2010.0,1,0,1
NER,,2019.0,23,0,23
USA,PYF,2019.0,2,0,2
EUE,ESP,2010.0,1,0,1
OMN,DEU,2023.0,1,0,1
ARG,ISR,2005.0,2,0,2
SVN,LUX,2008.0,1,0,1
LUX,SVN,2010.0,1,0,1
GHA,TGO,2007.0,1,0,1
KWT,TUN,2003.0,1,0,1
ITA,LBN,2006.0,1,0,1
IND,SYR,2007.0,1,0,1
SRB,KOR,2009.0,1,0,1
IRN,JOR,2005.0,2,0,2
NCL,,2001.0,3,0,3
JPN,WSM,2017.0,1,0,1
BEL,MKD,2008.0,1,0,1
CHL,PAN,2009.0,1,0,1
KOR,DZA,2016.0,2,0,2
NGA,GRC,2012.0,2,0,2
GRC,NGA,2015.0,1,0,1
NGA,KEN,2011.0,2,0,2
GRC,BGD,2020.0,1,0,1
GUF,,2016.0,7,0,7
PSE,BGD,2010.0,1,0,1
KAZ,DNK,2016.0,1,0,1
PSE,SAU,2012.0,1,0,1
JPN,IRQ,2011.0,1,0,1
ARE,CYP,2011.0,1,0,1
,AGO,2008.0,11,0,11
ISL,IRQ,2016.0,1,0,1
JOR,TUR,2016.0,1,0,1
GRC,KOR,2013.0,1,0,1
BEL,KWT,2019.0,1,0,1
CHE,DZA,2016.0,2,0,2
GIB,,2013.0,1,0,1
GHA,FRA,2015.0,2,0,2
PER,IND,2018.0,1,0,1
IND,UZB,2020.0,4,0,4
ZAF,HRV,2008.0,1,0,1
BEL,NER,2012.0,1,0,1
TWN,BGD,2013.0,3,0,3
BGR,FIN,2018.0,2,0,2
BFA,MAR,2011.0,1,0,1
KEN,ISR,2010.0,1,0,1
ARM,COL,2011.0,4,0,4
ISL,FRA,2011.0,4,0,4
ETH,CZE,2012.0,1,0,1
GHA,KWT,2020.0,1,0,1
GEO,SWE,2012.0,2,0,2
FIN,KAZ,2012.0,1,0,1
,SLE,2007.0,8,0,8
CHN,KAZ,2024.0,1,0,1
MAR,CIV,2014.0,1,0,1
ESP,BGD,2008.0,1,0,1
HRV,SVK,2012.0,3,0,3
PRT,URY,2022.0,2,0,2
CRI,ITA,2019.0,1,0,1
TWN,MEX,2001.0,3,0,3
JPN,PLW,2004.0,2,0,2
MDV,ERI,2015.0,1,0,1
LCA,,2017.0,1,0,1
,MCO,2011.0,8,0,8
EGY,NOR,2018.0,4,0,4
ISL,CZE,2021.0,1,0,1
NPL,SWE,2018.0,1,0,1
GBR,LCA,2019.0,1,0,1
HUN,NZL,2006.0,3,0,3
,GRL,2016.0,6,0,6
TUN,MRT,2019.0,3,0,3
IRQ,OMN,2022.0,2,0,2
BEL,MLI,2021.0,2,0,2
NOR,MYS,2016.0,2,0,2
BRA,UKR,2013.0,2,0,2
BHR,NGA,2021.0,1,0,1
LBN,JOR,2021.0,2,0,2
HND,,1999.0,2,0,2
,COD,2005.0,7,0,7
TTO,NOR,2004.0,1,0,1
MYS,PRT,2022.0,3,0,3
DMA,,2013.0,1,0,1
ARM,UKR,2021.0,1,0,1
JPN,ECU,2019.0,1,0,1
LKA,VNM,2004.0,1,0,1
LBN,CZE,2022.0,1,0,1
DEU,SLV,2022.0,1,0,1
GHA,MLI,2021.0,1,0,1
IND,SSD,2023.0,1,0,1
TWN,BHR,2021.0,1,0,1
CUB,NIC,1997.0,3,0,3
SRB,HKG,2002.0,1,0,1
HKG,SRB,2007.0,1,0,1
PRT,MEX,2011.0,3,0,3
JPN,UGA,2011.0,1,0,1
TCD,FRA,2014.0,2,0,2
NOR,IRL,2002.0,1,0,1
MDG,ETH,2008.0,1,0,1
ISR,MMR,2003.0,1,0,1
MOZ,PSE,2006.0,3,0,3
IRL,PAK,2001.0,1,0,1
KOR,CHL,2006.0,1,0,1
AUS,UZB,2003.0,1,0,1
KEN,PNG,1999.0,1,0,1
PAK,IRN,2001.0,2,0,2
THA,MEX,2017.0,1,0,1
POL,TUR,2004.0,1,0,1
TJK,RUS,2003.0,4,0,4
CHE,COL,1997.0,1,0,1
ARM,AUS,1998.0,1,0,1
BLR,ISR,2005.0,1,0,1
IRL,SGP,1999.0,2,0,2
ISR,TWN,1998.0,1,0,1
NOR,SGP,2000.0,1,0,1
GEO,ITA,2017.0,2,0,2
GRC,MEX,1998.0,1,0,1
HKG,GRC,2018.0,1,0,1
BEL,SDN,2001.0,2,0,2
CMR,CIV,2000.0,1,0,1
LTU,AUT,2002.0,2,0,2
AUT,LVA,2000.0,1,0,1
LVA,ESP,1999.0,1,0,1
USA,LIE,1998.0,1,0,1
ZMB,NGA,2015.0,2,0,2
NCL,PYF,2016.0,1,0,1
BHR,JOR,2004.0,1,0,1
IRL,BHR,1999.0,1,0,1
ROU,SVK,2002.0,1,0,1
MLT,NLD,2002.0,1,0,1
LUX,,2005.0,12,0,12
SGP,TUR,1999.0,1,0,1
ERI,LSO,2012.0,1,0,1
KOR,KEN,2013.0,1,0,1
SDN,SSD,2014.0,5,0,5
PAN,CHL,2010.0,1,0,1
CUB,AGO,2004.0,2,0,2
ZMB,SDN,2013.0,1,0,1
REU,,2019.0,4,0,4
HKG,EST,2018.0,1,0,1
ARE,PRI,2022.0,1,0,1
PAK,KWT,2009.0,3,0,3
CHN,AFG,2010.0,2,0,2
PAN,GHA,2014.0,1,0,1
GLP,ITA,2013.0,1,0,1
ROU,ETH,2011.0,1,0,1
SVK,SAU,2013.0,1,0,1
TUR,BRA,2003.0,1,0,1
ISR,SAU,2014.0,2,0,2
COL,CRI,2011.0,2,0,2
FRA,HTI,2020.0,4,0,4
TCD,CMR,2009.0,2,0,2
ZAF,BHR,2013.0,1,0,1
,BMU,1999.0,2,0,2
IND,ARG,2023.0,3,0,3
IND,GUY,2010.0,1,0,1
BFA,GIN,2012.0,1,0,1
NOR,PRY,2018.0,1,0,1
TUN,ZAF,2009.0,1,0,1
BRA,GMB,2012.0,1,0,1
PSE,LBN,2008.0,2,0,2
SVK,GRC,2016.0,1,0,1
TTO,ESP,2018.0,3,0,3
SAU,ARM,2005.0,1,0,1
SWE,ZWE,2018.0,1,0,1
ISR,ARE,2021.0,1,0,1
BEN,SEN,2014.0,2,0,2
ATG,,2017.0,1,0,1
JPN,SVK,2009.0,2,0,2
AUS,FSM,2014.0,1,0,1
SAU,MDV,2014.0,1,0,1
USA,LCA,2016.0,2,0,2
GRC,JPN,1998.0,3,0,3
IDN,MYS,2002.0,3,0,3
BEN,TGO,2015.0,3,0,3
AUS,TLS,2011.0,2,0,2
BEN,DNK,2001.0,1,0,1
NOR,KAZ,2017.0,4,0,4
PAN,DMA,2001.0,1,0,1
ZAF,PNG,2022.0,1,0,1
ESP,PYF,2015.0,1,0,1
BTN,SGP,2020.0,1,0,1
BGD,BRA,2020.0,1,0,1
LVA,ARE,2012.0,1,0,1
SMR,,2001.0,1,0,1
OMN,CYP,2020.0,2,0,2
JPN,CMR,2016.0,3,0,3
BLR,MKD,2019.0,1,0,1
PRT,CZE,2006.0,1,0,1
NGA,SLB,2015.0,1,0,1
CMR,CIV,2023.0,1,0,1
SDN,ROU,2018.0,1,0,1
EUE,,2023.0,1,0,1
ARM,PRT,2021.0,1,0,1
PER,NLD,2009.0,1,0,1
CRI,IDN,2004.0,1,0,1
SAU,BGR,2021.0,1,0,1
EGY,SDN,1999.0,1,0,1
NZL,ISR,2001.0,1,0,1
CAN,BMU,1997.0,1,0,1
IND,BRN,2005.0,1,0,1
AUS,GUF,2021.0,1,0,1
THA,KHM,2005.0,1,0,1
CHE,COL,2002.0,2,0,2
SWE,CRI,2011.0,1,0,1
FRO,NOR,2001.0,1,0,1
NOR,FRO,2005.0,1,0,1
FRO,NOR,2008.0,1,0,1
EGY,ZMB,2011.0,1,0,1
CAN,BGD,2000.0,4,0,4
ISR,UKR,2014.0,3,0,3
PRT,SYC,2002.0,3,0,3
VIR,PRI,2003.0,1,0,1
GBR,BRN,2010.0,1,0,1
POL,KGZ,1999.0,1,0,1
CAN,BRB,1997.0,2,0,2
PAK,KAZ,2012.0,1,0,1
ISR,HKG,2002.0,1,0,1
FLK,,2005.0,3,0,3
ISR,CZE,2013.0,1,0,1
MEX,ARE,2023.0,2,0,2
ECU,CAN,2002.0,1,0,1
FIN,GHA,2012.0,2,0,2
JPN,KGZ,2019.0,2,0,2
FRA,TZA,2013.0,1,0,1
CHE,LBY,2016.0,1,0,1
UGA,COG,2012.0,1,0,1
IRN,HKG,2013.0,5,0,5
GHA,HUN,2010.0,1,0,1
BHS,,2014.0,4,0,4
,GNQ,2009.0,6,0,6
GMB,ZAF,2011.0,1,0,1
LIE,DNK,2017.0,1,0,1
IDN,BRN,2019.0,1,0,1
FJI,BEL,2017.0,1,0,1
ZAF,KAZ,2023.0,2,0,2
KAZ,KHM,2019.0,2,0,2
SRB,ETH,2016.0,1,0,1
BEL,KAZ,2015.0,1,0,1
ECU,SWE,2019.0,1,0,1
ITA,PER,2017.0,2,0,2
RUS,COL,2013.0,2,0,2
GMB,MWI,2015.0,1,0,1
IND,TUN,2006.0,1,0,1
IRQ,SAU,2010.0,1,0,1
ITA,IDN,2015.0,1,0,1
POL,NZL,2018.0,3,0,3
SVK,JPN,2016.0,2,0,2
IRL,BHR,2007.0,1,0,1
CRI,HRV,2017.0,1,0,1
ESP,ISL,2022.0,1,0,1
COG,GRC,2015.0,1,0,1
MRT,NLD,2014.0,1,0,1
FRA,GNQ,2018.0,1,0,1
BRN,BGD,2021.0,3,0,3
TUN,VNM,2017.0,1,0,1
IND,COD,2019.0,1,0,1
PLW,SWE,2017.0,1,0,1
QAT,IND,2024.0,1,0,1
CUB,FIN,2020.0,1,0,1
CHE,BFA,2007.0,2,0,2
CYP,BIH,2018.0,2,0,2
BRA,MDG,2018.0,3,0,3
CHE,GUF,2003.0,1,0,1
UGA,BWA,2019.0,1,0,1
AFG,SWE,2020.0,1,0,1
TUR,RWA,2021.0,3,0,3
MKD,AUT,2004.0,1,0,1
AUT,MKD,2007.0,1,0,1
COG,JPN,2019.0,4,0,4
COL,POL,2018.0,1,0,1
ARE,IDN,2010.0,1,0,1
USA,SJM,2017.0,1,0,1
JPN,SVK,2021.0,1,0,1
CYP,JOR,2019.0,2,0,2
ROU,ISR,2020.0,1,0,1
PHL,PER,1998.0,1,0,1
SWE,ECU,2015.0,1,0,1
,AFG,2004.0,6,0,6
MYS,LVA,2019.0,1,0,1
BEL,ZWE,2019.0,1,0,1
COL,PAK,2019.0,1,0,1
SVK,JPN,2018.0,2,0,2
TUR,BFA,2023.0,1,0,1
NGA,COD,2019.0,1,0,1
ESP,LKA,2018.0,2,0,2
MNG,VNM,2020.0,1,0,1
OMN,HKG,2022.0,1,0,1
FRA,MUS,2022.0,1,0,1
IND,ARG,2000.0,3,0,3
SXM,,2024.0,6,0,6
HKG,LUX,2021.0,1,0,1
GHA,MEX,2022.0,1,0,1
NOR,AUT,2002.0,3,0,3
SAU,CHE,2001.0,1,0,1
HRV,SVK,1997.0,1,0,1
ZWE,BEL,2002.0,3,0,3
ETH,GHA,2004.0,1,0,1
JPN,TZA,2005.0,6,0,6
NAM,LSO,2021.0,1,0,1
CHE,BLR,2004.0,2,0,2
PRT,MOZ,2008.0,1,0,1
,GUF,1998.0,5,0,5
BEN,TUN,2012.0,1,0,1
DEU,DZA,2001.0,2,0,2
ISR,MLI,2005.0,1,0,1
,COD,1997.0,2,0,2
FRA,BIH,2003.0,2,0,2
ESP,PSE,2012.0,2,0,2
CZE,SRB,1997.0,6,0,6
KWT,,1999.0,18,0,18
VEN,BEL,2000.0,1,0,1
RWA,FRA,1998.0,2,0,2
ITA,MAR,2007.0,3,0,3
LKA,DNK,2003.0,2,0,2
ITA,SEN,2007.0,1,0,1
SVN,AUS,2004.0,2,0,2
AUT,NGA,2010.0,1,0,1
HRV,OMN,2018.0,1,0,1
DEU,BEN,2011.0,3,0,3
CHN,PSE,2014.0,1,0,1
AUT,CHL,2005.0,2,0,2
SGP,MEX,2015.0,3,0,3
CUB,IRL,2002.0,1,0,1
NZL,TCA,2016.0,1,0,1
MLI,,2005.0,6,0,6
NZL,NCL,2002.0,1,0,1
LVA,FRA,2000.0,3,0,3
GBR,ZWE,2012.0,1,0,1
BEL,LBY,2008.0,1,0,1
TJK,,2009.0,7,0,7
ETH,ZMB,2008.0,1,0,1
COG,PNG,2011.0,1,0,1
PHL,SWE,2001.0,3,0,3
HUN,BGR,2014.0,2,0,2
GBR,VCT,1997.0,1,0,1
NLD,ISL,2017.0,2,0,2
PER,BOL,2013.0,2,0,2
MDG,KHM,2023.0,1,0,1
IRL,KEN,2009.0,2,0,2
TWN,UZB,2003.0,1,0,1
NOR,GHA,2008.0,1,0,1
GAB,NGA,2008.0,1,0,1
SAU,YEM,2004.0,1,0,1
ZWE,KEN,1999.0,2,0,2
VUT,NCL,2018.0,1,0,1
ATA,USA,2009.0,1,0,1
IND,CUB,1999.0,1,0,1
PER,IDN,2000.0,1,0,1
ISR,NZL,2005.0,2,0,2
NAM,SAU,2023.0,1,0,1
NZL,FJI,2000.0,1,0,1
BEL,IDN,2005.0,2,0,2
KEN,ITA,2001.0,3,0,3
PYF,,2009.0,6,0,6
DEU,KWT,2011.0,1,0,1
POL,MOZ,2020.0,1,0,1
NPL,CAN,2000.0,1,0,1
DOM,MEX,2008.0,1,0,1
NLD,SDN,2005.0,1,0,1
DNK,BWA,2015.0,1,0,1
BGR,NOR,2010.0,1,0,1
KOR,HUN,2000.0,2,0,2
TUR,GEO,2012.0,1,0,1
CRI,HRV,2018.0,1,0,1
IRL,MLT,2012.0,2,0,2
NZL,NCL,2012.0,1,0,1
IND,LAO,2000.0,1,0,1
BGR,SRB,2013.0,1,0,1
MYS,PAN,2010.0,1,0,1
MCO,BEL,2005.0,2,0,2
MDA,MDV,2009.0,2,0,2
MEX,NAM,2009.0,1,0,1
BEL,HRV,1999.0,1,0,1
CMR,AUS,2006.0,2,0,2
BLR,JPN,2006.0,2,0,2
IRN,GRC,2014.0,1,0,1
ZWE,NGA,2018.0,1,0,1
DZA,RUS,1997.0,1,0,1
ISR,NZL,2012.0,2,0,2
BLR,EST,2014.0,1,0,1
BEL,ZMB,2008.0,1,0,1
BEL,MDA,2004.0,1,0,1
ZAF,SGP,1999.0,2,0,2
PER,DNK,2010.0,1,0,1
UKR,TTO,2008.0,1,0,1
SDN,NZL,2005.0,1,0,1
AZE,GEO,2013.0,1,0,1
ECU,GUF,2005.0,1,0,1
CAN,GMB,2015.0,1,0,1
ITA,NZL,2006.0,5,0,5
PRT,MOZ,2004.0,2,0,2
MOZ,AUS,2006.0,1,0,1
PRT,RUS,2012.0,3,0,3
JPN,LKA,1997.0,2,0,2
TGO,CIV,2004.0,1,0,1
ITA,IDN,2014.0,2,0,2
SGP,CHL,2004.0,1,0,1
BTN,,2013.0,4,0,4
DEU,RWA,2015.0,1,0,1
PRK,KOR,2010.0,2,0,2
IDN,SLV,2017.0,1,0,1
IRN,DZA,2010.0,1,0,1
ESP,BLR,2008.0,1,0,1
SGP,SAU,2006.0,2,0,2
ARM,BEL,2013.0,1,0,1
BEL,SDN,2015.0,1,0,1
PHL,VNM,2011.0,2,0,2
SVN,BIH,2000.0,1,0,1
ESP,COG,2004.0,1,0,1
PAN,PRI,2009.0,1,0,1
BLR,TWN,2000.0,1,0,1
UKR,UZB,2006.0,3,0,3
SDN,FRA,2017.0,1,0,1
NGA,VCT,2018.0,1,0,1
CYP,MYS,2023.0,1,0,1
UKR,IRL,2017.0,1,0,1
BGD,QAT,2018.0,2,0,2
ZMB,UGA,2016.0,1,0,1
GHA,CZE,2023.0,1,0,1
IRN,MEX,2020.0,6,0,6
ZMB,KEN,2015.0,1,0,1
IND,ARE,1998.0,2,0,2
CMR,BFA,2021.0,1,0,1
NZL,CZE,1998.0,1,0,1
ITA,LKA,2016.0,1,0,1
LKA,KEN,2018.0,1,0,1
COL,ARG,1997.0,2,0,2
NLD,KWT,2004.0,1,0,1
SEN,GMB,2011.0,1,0,1
MDA,ITA,2003.0,3,0,3
BOL,FRA,2000.0,2,0,2
MOZ,BFA,2019.0,1,0,1
MDA,ROU,2009.0,1,0,1
CHE,ISL,2005.0,1,0,1
ZWE,JPN,2002.0,1,0,1
BLR,BRA,2019.0,1,0,1
LUX,CAN,1998.0,1,0,1
AGO,,2002.0,1,0,1
IRL,CZE,1997.0,2,0,2
MAR,RUS,2017.0,1,0,1
POL,EST,2012.0,1,0,1
EST,POL,2013.0,2,0,2
SVK,DNK,2003.0,2,0,2
QAT,AUS,2000.0,1,0,1
IND,IDN,2005.0,3,0,3
MCO,ROU,2021.0,2,0,2
CAN,URY,2009.0,2,0,2
MAR,SAU,2006.0,1,0,1
PNG,EGY,2005.0,1,0,1
DNK,LTU,2004.0,2,0,2
LKA,COL,2012.0,1,0,1
NOR,JOR,1998.0,1,0,1
JOR,NOR,1999.0,1,0,1
BRA,BLR,1998.0,1,0,1
BLR,BRA,2009.0,1,0,1
CRI,IND,2011.0,2,0,2
CAN,LKA,1997.0,1,0,1
SWE,SDN,2004.0,1,0,1
GMB,SEN,2000.0,2,0,2
KEN,CHE,2004.0,4,0,4
POL,SAU,2005.0,1,0,1
LBY,ARE,2000.0,2,0,2
NZL,NOR,2004.0,1,0,1
BRA,UZB,2008.0,1,0,1
TWN,NOR,2007.0,1,0,1
MAR,CIV,2004.0,1,0,1
DEU,NER,2007.0,1,0,1
ARG,FIN,2015.0,2,0,2
ARE,ARG,2012.0,1,0,1
BFA,CIV,2017.0,3,0,3
IRL,THA,2009.0,4,0,4
IDN,PNG,2007.0,1,0,1
AUT,LIE,2008.0,1,0,1
SLV,,2009.0,1,0,1
CHE,GEO,2007.0,2,0,2
VNM,DZA,2021.0,1,0,1
USA,DZA,2006.0,1,0,1
STP,BRA,2010.0,1,0,1
MAR,IND,2001.0,1,0,1
IND,MAR,2002.0,2,0,2
,BMU,1998.0,7,0,7
FRA,SYC,2001.0,1,0,1
DNK,CUB,2006.0,1,0,1
KWT,NGA,2009.0,1,0,1
PSE,,2007.0,6,0,6
DNK,TZA,2010.0,1,0,1
CAF,GIN,2013.0,1,0,1
PRT,MOZ,2001.0,1,0,1
URY,ECU,2010.0,1,0,1
UGA,ITA,2012.0,1,0,1
CHN,AZE,2013.0,1,0,1
BWA,NZL,2012.0,1,0,1
ZWE,CAN,2011.0,1,0,1
CAN,VNM,2015.0,5,0,5
IND,YEM,2016.0,4,0,4
CIV,AUT,2008.0,1,0,1
UGA,ZMB,2023.0,1,0,1
MKD,ITA,2008.0,1,0,1
BEN,BLZ,2017.0,3,0,3
PRI,PRT,2010.0,1,0,1
FRA,LTU,2011.0,3,0,3
MLT,NLD,2012.0,1,0,1
VEN,PRT,2014.0,2,0,2
PER,CAN,2011.0,1,0,1
SYR,CAN,2015.0,1,0,1
HUN,ARE,2016.0,3,0,3
PAK,ROU,2009.0,1,0,1
OMN,THA,2017.0,1,0,1
PRT,AGO,2011.0,2,0,2
IRQ,KWT,2010.0,1,0,1
IRL,EST,2017.0,2,0,2
SAU,BRA,2010.0,3,0,3
JAM,GBR,2020.0,2,0,2
IND,CZE,2010.0,3,0,3
AUT,BGD,2016.0,1,0,1
ESP,BRA,2024.0,1,0,1
REU,KEN,2012.0,1,0,1
THA,CHL,2020.0,1,0,1
,TKM,2008.0,1,0,1
COM,,2014.0,3,0,3
NZL,THA,2013.0,2,0,2
CYP,RUS,2016.0,1,0,1
LUX,AUS,2016.0,3,0,3
THA,BTN,2015.0,1,0,1
HRV,ARE,2016.0,1,0,1
HRV,ARE,2018.0,2,0,2
FRA,UZB,2014.0,1,0,1
NLD,GMB,2016.0,1,0,1
URY,SAU,2015.0,1,0,1
UKR,URY,2019.0,1,0,1
,SLB,2011.0,4,0,4
CUB,PRT,2019.0,1,0,1
DZA,AZE,2008.0,1,0,1
TUR,QAT,2008.0,1,0,1
MKD,NLD,2012.0,2,0,2
BGR,SWE,2017.0,1,0,1
NGA,FIN,2014.0,1,0,1
THA,RUS,2019.0,1,0,1
LAO,NPL,2019.0,1,0,1
IND,PNG,2019.0,4,0,4
SGP,QAT,2017.0,4,0,4
CIV,GUF,2007.0,1,0,1
MSR,USA,2020.0,3,0,3
,ABW,2011.0,3,0,3
SDN,SSD,2015.0,2,0,2
EST,CHN,2000.0,1,0,1
NPL,IDN,2019.0,1,0,1
BIH,BRA,2010.0,1,0,1
SVK,CHN,2015.0,2,0,2
ZWE,NZL,2016.0,1,0,1
TUR,QAT,2014.0,1,0,1
JPN,LBN,2006.0,2,0,2
CHN,MDA,2022.0,2,0,2
OMN,KWT,2010.0,1,0,1
,GNQ,2011.0,6,0,6
IRL,ISL,2001.0,1,0,1
THA,GHA,2000.0,1,0,1
BEL,GUY,2020.0,2,0,2
ECU,MAR,2023.0,1,0,1
TUR,TCD,2019.0,1,0,1
ESP,GNQ,2022.0,1,0,1
ESP,IRQ,2020.0,6,0,6
PRT,PRI,2019.0,1,0,1
THA,BTN,2014.0,1,0,1
ROU,JOR,2020.0,2,0,2
DEU,NAM,2021.0,2,0,2
KHM,HND,2021.0,1,0,1
LBY,KOR,2018.0,1,0,1
TJK,UKR,2019.0,1,0,1
CAN,MRT,2012.0,1,0,1
SEN,MDA,2020.0,1,0,1
GEO,ARE,2021.0,2,0,2
TWN,SVK,2013.0,1,0,1
PRY,GBR,2023.0,1,0,1
CZE,MLT,2017.0,1,0,1
LTU,BEL,2004.0,1,0,1
ZAF,MLT,2022.0,1,0,1
CYP,JOR,2021.0,6,0,6
FIN,MLI,2022.0,1,0,1
COD,GBR,2019.0,1,0,1
SVK,KHM,2021.0,1,0,1
CMR,ETH,2021.0,2,0,2
NPL,EGY,2017.0,1,0,1
RUS,ETH,2021.0,1,0,1
JPN,SDN,2002.0,2,0,2
CHE,CRI,2017.0,1,0,1
LTU,RUS,2003.0,3,0,3
QAT,CUB,2022.0,1,0,1
TZA,GNQ,2022.0,2,0,2
CYP,SVK,2022.0,1,0,1
ZAF,YEM,2021.0,1,0,1
GHA,EGY,2023.0,1,0,1
,NGA,2021.0,17,0,17
BGD,EGY,2023.0,1,0,1
TUR,BGR,2022.0,2,0,2
TWN,USA,2024.0,3,0,3
FRA,SDN,2019.0,4,0,4
BRA,NOR,2024.0,2,0,2
CIV,TGO,2021.0,2,0,2
MAR,TCD,2022.0,1,0,1
HRV,CHL,2021.0,1,0,1
UZB,LTU,2022.0,1,0,1
NOR,LUX,2006.0,2,0,2
SWE,GNB,2006.0,2,0,2
PAK,ZAF,2006.0,2,0,2
DOM,CAN,1999.0,1,0,1
IND,CUB,1998.0,1,0,1
HKG,MAC,2002.0,3,0,3
PER,IDN,2006.0,1,0,1
GIB,USA,2016.0,1,0,1
OMN,ZWE,2000.0,1,0,1
DNK,TWN,2008.0,2,0,2
FIN,CRI,2009.0,1,0,1
PAK,CHL,2021.0,1,0,1
GBR,SLE,2003.0,1,0,1
BGD,GHA,2014.0,1,0,1
MNE,AUS,2013.0,1,0,1
NLD,PER,2007.0,1,0,1
MEX,ZWE,2018.0,1,0,1
BHS,,2004.0,1,0,1
VEN,SAU,2015.0,1,0,1
CAN,QAT,1997.0,1,0,1
PRT,IRL,1997.0,2,0,2
PRT,PSE,2006.0,1,0,1
ZAF,PAK,2001.0,2,0,2
IND,SVN,2002.0,1,0,1
FSM,ITA,2017.0,1,0,1
USA,ERI,2011.0,1,0,1
ISR,ISL,2010.0,1,0,1
SAU,BRN,2016.0,1,0,1
BRA,ZAF,1997.0,3,0,3
NGA,SGP,2002.0,1,0,1
IRQ,ITA,2006.0,1,0,1
PNG,SEN,2000.0,1,0,1
USA,OMN,2000.0,5,0,5
PRT,AUT,2000.0,2,0,2
GEO,SGP,2017.0,1,0,1
BLR,KOR,1997.0,2,0,2
GAB,AUT,1999.0,1,0,1
ESP,BGD,2014.0,1,0,1
,TON,2008.0,2,0,2
BEN,CMR,2005.0,2,0,2
SWE,BGR,1997.0,1,0,1
USA,LBY,2002.0,3,0,3
TWN,RUS,2011.0,3,0,3
BEN,CHE,2020.0,1,0,1
HKG,LVA,2018.0,1,0,1
BGD,NGA,2010.0,1,0,1
NGA,BGD,2012.0,1,0,1
AUT,MNG,2017.0,1,0,1
TJK,LKA,2021.0,1,0,1
JOR,RUS,2015.0,1,0,1
SAU,GHA,2020.0,2,0,2
BTN,JPN,2012.0,1,0,1
FIN,USA,2024.0,1,0,1
MDG,AUS,1999.0,1,0,1
HRV,ROU,2016.0,1,0,1
BEN,MAR,2014.0,1,0,1
KEN,TUR,2019.0,1,0,1
TUR,GIN,2020.0,1,0,1
ZMB,NGA,2014.0,1,0,1
MKD,QAT,2020.0,1,0,1
BFA,CMR,2015.0,1,0,1
HTI,GIN,2017.0,1,0,1
TWN,KEN,2021.0,2,0,2
SYC,ZAF,2023.0,1,0,1
IRN,ISL,2019.0,1,0,1
AUT,ISL,2018.0,1,0,1
TTO,KNA,2020.0,1,0,1
EST,AUT,2022.0,3,0,3
MAR,MLI,2019.0,5,0,5
EGY,SRB,2018.0,3,0,3
ZAF,NER,2020.0,1,0,1
BRA,ROU,2017.0,1,0,1
,PLW,2000.0,3,0,3
MDA,BEL,2013.0,1,0,1
PAK,PRI,2023.0,1,0,1
PER,MAC,2019.0,1,0,1
GTM,SLV,2011.0,1,0,1
BWA,THA,2022.0,1,0,1
TUR,TZA,2019.0,3,0,3
JOR,LBN,2019.0,1,0,1
HKG,CMR,2021.0,1,0,1
NOR,UZB,2020.0,1,0,1
BTN,DEU,2023.0,2,0,2
CAN,HTI,2009.0,1,0,1
DNK,ATG,2019.0,1,0,1
DNK,ZWE,2005.0,1,0,1
PRT,PAN,2019.0,1,0,1
PRT,PRY,2021.0,4,0,4
LSO,USA,2021.0,2,0,2
BEN,TGO,2008.0,1,0,1
DNK,TZA,2023.0,2,0,2
LBN,YEM,2022.0,1,0,1
PSE,MAR,2022.0,1,0,1
,GIB,2020.0,2,0,2
JOR,DZA,2022.0,5,0,5
MDG,NOR,2023.0,1,0,1
CYP,PER,2019.0,1,0,1
SRB,EST,2022.0,1,0,1
,LIE,2017.0,7,0,7
CHN,PRI,2022.0,1,0,1
GAB,USA,1999.0,3,0,3
DNK,CYP,2014.0,3,0,3
PRT,IDN,2013.0,1,0,1
NGA,BWA,2001.0,2,0,2
MAR,CIV,2015.0,2,0,2
BDI,,2011.0,2,0,2
ZAF,ESP,2004.0,1,0,1
MDA,TWN,2004.0,1,0,1
NOR,TZA,2004.0,3,0,3
,GNB,2000.0,5,0,5
RWA,COD,2022.0,3,0,3
ITA,MCO,2006.0,1,0,1
KHM,AUS,2010.0,4,0,4
NZL,MNE,2010.0,1,0,1
VNM,MYS,2008.0,2,0,2
MYS,TTO,2011.0,1,0,1
PER,FIN,2013.0,1,0,1
CIV,CHN,2013.0,1,0,1
PHL,BDI,2023.0,1,0,1
NGA,GHA,2004.0,1,0,1
USA,FSM,2019.0,2,0,2
COD,DEU,2019.0,1,0,1
,CCK,2016.0,1,0,1
ARG,PRT,2021.0,5,0,5
THA,FIN,2022.0,3,0,3
PAK,LBY,2022.0,1,0,1
LBY,PAK,2023.0,1,0,1
ITA,FIN,2024.0,1,0,1
,NIC,2019.0,16,0,16
IDN,HUN,2019.0,4,0,4
AFG,CAN,2021.0,2,0,2
DMA,,2024.0,9,0,9
BWA,ZMB,2022.0,1,0,1
PER,BEL,2023.0,2,0,2
ARE,VNM,2022.0,2,0,2
ZMB,NLD,2022.0,2,0,2
GAB,ZAF,2022.0,1,0,1
GBR,GEO,2022.0,3,0,3
ARG,VNM,2022.0,1,0,1
,AGO,2019.0,21,0,21
,DOM,2009.0,21,0,21
,YEM,2020.0,47,0,47
IDN,AUT,2022.0,9,0,9
ZAF,NER,2022.0,1,0,1
MAR,CIV,2011.0,3,0,3
SVK,KWT,2008.0,1,0,1
FIN,ISL,2021.0,3,0,3
DNK,KEN,2014.0,4,0,4
TUR,OMN,2005.0,2,0,2
EGY,AUS,2007.0,2,0,2
BOL,BRA,2016.0,3,0,3
SAU,IRL,2010.0,1,0,1
POL,NZL,2020.0,2,0,2
YEM,,2011.0,17,0,17
NLD,ABW,2022.0,2,0,2
AFG,JOR,2013.0,1,0,1
DEU,LBY,2013.0,3,0,3
NZL,TZA,2000.0,1,0,1
FRA,BHR,2018.0,2,0,2
MYS,JOR,2008.0,4,0,4
TUR,JOR,2007.0,2,0,2
TON,TUN,2015.0,1,0,1
TWN,LKA,2020.0,1,0,1
ZAF,URY,2007.0,1,0,1
URY,ZAF,2009.0,2,0,2
SGP,VNM,2005.0,2,0,2
AUS,ARM,2010.0,2,0,2
RUS,SGP,2006.0,4,0,4
PER,NLD,2014.0,2,0,2
LBY,OMN,2015.0,2,0,2
HUN,PRT,2005.0,1,0,1
RWA,ITA,2016.0,2,0,2
BRA,KEN,2011.0,1,0,1
,HTI,2006.0,9,0,9
SVN,SEN,2010.0,1,0,1
CYP,PRT,2014.0,1,0,1
BFA,ZAF,2008.0,1,0,1
QAT,SRB,2014.0,1,0,1
DNK,EST,2017.0,2,0,2
MYS,ZAF,2021.0,2,0,2
BLR,GRC,2020.0,1,0,1
NGA,ZWE,1998.0,4,0,4
PAK,BHR,2010.0,1,0,1
RUS,CHL,2019.0,1,0,1
,LIE,1999.0,2,0,2
,KHM,2009.0,65,0,65
GNQ,,2022.0,6,0,6
RUS,LVA,2002.0,2,0,2
PNG,,2017.0,19,0,19
SAU,QAT,2012.0,7,0,7
GEO,UKR,2012.0,1,0,1
TUN,SUR,2015.0,1,0,1
ARG,TWN,2009.0,1,0,1
FRA,ARE,2003.0,2,0,2
CHN,HUN,2009.0,2,0,2
,NIC,1994.0,19,0,19
USA,GAB,2006.0,5,0,5
POL,ZAF,2002.0,1,0,1
SYC,,2004.0,6,0,6
HKG,SRB,2017.0,1,0,1
AIA,,2021.0,2,0,2
IND,RWA,2007.0,1,0,1
CAN,VNM,2011.0,5,0,5
GTM,,2005.0,8,0,8
,PYF,2019.0,11,0,11
MYS,COL,2021.0,2,0,2
BLR,CYP,2022.0,1,0,1
BIH,MNE,2021.0,1,0,1
SDN,YEM,2021.0,1,0,1
MOZ,CAN,2022.0,1,0,1
IOT,BRA,2021.0,1,0,1
HUN,AUS,1997.0,2,0,2
CMR,KOR,2023.0,1,0,1
SYR,RUS,2019.0,2,0,2
DEU,UZB,2019.0,2,0,2
,SYC,2019.0,8,0,8
TUN,MLT,2020.0,1,0,1
MLT,TUN,2021.0,1,0,1
,IRL,2021.0,12,0,12
,TJK,2012.0,21,0,21
,NAM,2020.0,37,0,37
BRA,CMR,2012.0,1,0,1
IND,HKG,1998.0,5,0,5
FIN,TUR,2000.0,3,0,3
YEM,IRQ,2010.0,1,0,1
SRB,OMN,2009.0,1,0,1
IRL,SVK,2000.0,1,0,1
NOR,PRT,2002.0,2,0,2
CHN,ESP,2002.0,4,0,4
SEN,MCO,2008.0,1,0,1
MCO,,2011.0,5,0,5
IRQ,LBY,2013.0,1,0,1
DEU,SYR,1998.0,2,0,2
IRL,GRC,1999.0,3,0,3
RUS,ISR,2024.0,2,0,2
CUB,CAN,1998.0,1,0,1
BGR,FIN,1999.0,3,0,3
,ASM,2005.0,3,0,3
URY,CAN,2005.0,2,0,2
SYR,NLD,2017.0,1,0,1
GTM,CAN,2004.0,1,0,1
SAU,NLD,1999.0,2,0,2
ARG,CHN,2003.0,1,0,1
MKD,KWT,2000.0,1,0,1
ISR,CHL,2004.0,3,0,3
,MTQ,1997.0,7,0,7
FRA,ISL,1997.0,2,0,2
MWI,NGA,2005.0,1,0,1
ARG,RUS,2002.0,1,0,1
SWE,LBN,2011.0,1,0,1
MKD,ISR,2019.0,1,0,1
LTU,FIN,1997.0,1,0,1
HUN,ESP,2002.0,3,0,3
UKR,JPN,2014.0,4,0,4
PHL,,1999.0,15,0,15
MLI,KEN,2001.0,1,0,1
KEN,MLI,2009.0,1,0,1
LVA,BLR,1999.0,1,0,1
ROU,MEX,1999.0,1,0,1
SRB,ARE,2002.0,1,0,1
SVN,ROU,2012.0,1,0,1
CYP,HKG,2003.0,1,0,1
CYP,HKG,2013.0,1,0,1
FRA,EST,2007.0,1,0,1
DZA,ZAF,1999.0,2,0,2
AUS,PAN,2009.0,1,0,1
ESP,CYP,2000.0,1,0,1
MSR,FRA,1998.0,1,0,1
AUS,GRC,1997.0,1,0,1
USA,PSE,2000.0,2,0,2
TUR,ZAF,2002.0,1,0,1
ZAF,TUR,2003.0,1,0,1
EGY,NGA,2014.0,1,0,1
FRO,DNK,2000.0,2,0,2
ISL,FIN,1997.0,2,0,2
RUS,VEN,2009.0,1,0,1
BRA,TUN,2024.0,1,0,1
HUN,AUT,2024.0,1,0,1
AUT,PAN,2013.0,1,0,1
NLD,NER,2010.0,1,0,1
KWT,QAT,2012.0,3,0,3
SEN,MAR,2008.0,2,0,2
BHS,,2011.0,3,0,3
,LIE,2007.0,4,0,4
THA,MMR,2010.0,2,0,2
SRB,NOR,2014.0,3,0,3
,NAM,2007.0,19,0,19
PRT,EGY,2012.0,2,0,2
SWE,UGA,2017.0,3,0,3
SEN,GHA,2018.0,2,0,2
DEU,AFG,2017.0,2,0,2
ISR,ZWE,2018.0,1,0,1
SMR,ITA,2010.0,1,0,1
EGY,ZAF,2012.0,3,0,3
FRA,OMN,2015.0,1,0,1
MLT,,2011.0,7,0,7
SEN,MYS,2018.0,1,0,1
MEX,PAN,2017.0,2,0,2
LAO,IND,2016.0,1,0,1
MYS,PHL,2017.0,2,0,2
ARE,ARM,2007.0,1,0,1
PHL,IRN,2003.0,1,0,1
TUR,MLT,2022.0,2,0,2
NLD,BTN,2012.0,1,0,1
MYS,MAR,2019.0,2,0,2
IND,ALB,2010.0,3,0,3
VNM,VEN,2010.0,5,0,5
KGZ,,2016.0,13,0,13
GRC,KWT,2022.0,2,0,2
KWT,BGR,2023.0,1,0,1
USA,PNG,2014.0,2,0,2
IRN,MEX,2016.0,1,0,1
GHA,IRL,2017.0,1,0,1
GMB,,2017.0,11,0,11
EGY,SYR,2013.0,2,0,2
,CYM,2010.0,3,0,3
GHA,CHN,2013.0,4,0,4
PSE,,2026.0,10,0,10
BOL,MYS,2015.0,1,0,1
VEN,PER,2016.0,1,0,1
CAN,LBN,2024.0,1,0,1
PAN,KOR,2014.0,1,0,1
,VUT,2010.0,2,0,2
THA,MWI,2015.0,1,0,1
NLD,NAM,2018.0,2,0,2
LSO,CHE,2023.0,1,0,1
SMR,,2009.0,2,0,2
,MDV,2010.0,3,0,3
,HTI,2010.0,18,0,18
ZAF,QAT,2018.0,5,0,5
NZL,URY,2013.0,1,0,1
TJK,USA,2013.0,1,0,1
CUB,AUT,2016.0,2,0,2
KEN,JOR,2018.0,1,0,1
SAU,PRT,2018.0,1,0,1
PRT,ROU,2019.0,6,0,6
PER,CHE,2016.0,6,0,6
PHL,CAN,2016.0,5,0,5
SAU,UGA,2020.0,1,0,1
BEL,BLR,2021.0,2,0,2
KEN,DNK,2021.0,2,0,2
TUN,BEN,2013.0,1,0,1
GRC,SGP,2021.0,1,0,1
IRQ,EGY,2012.0,1,0,1
,BRB,2012.0,14,0,14
ITA,BWA,2016.0,2,0,2
,GUY,2001.0,4,0,4
PAK,SWE,2002.0,3,0,3
BRA,ECU,1999.0,1,0,1
EGY,GHA,2021.0,2,0,2
DEU,SLV,2020.0,1,0,1
MLI,ZWE,1998.0,1,0,1
REU,CHE,2019.0,2,0,2
TWN,AUT,2021.0,1,0,1
SDN,IDN,2018.0,1,0,1
,BWA,2020.0,50,0,50
FRA,GMB,2013.0,3,0,3
MYS,KHM,2020.0,1,0,1
NGA,KNA,2017.0,1,0,1
SGP,MAR,2023.0,2,0,2
MOZ,JOR,2022.0,1,0,1
PAK,TZA,2021.0,2,0,2
ITA,BIH,2008.0,2,0,2
BRA,BIH,2021.0,1,0,1
ETH,IRQ,2021.0,2,0,2
JOR,ISL,2023.0,1,0,1
CHL,DOM,2021.0,2,0,2
PAK,RUS,2022.0,5,0,5
JPN,MKD,2016.0,1,0,1
CUB,AGO,2021.0,3,0,3
BWA,FRA,2003.0,1,0,1
MEX,IRL,2003.0,2,0,2
MYS,PAK,2002.0,1,0,1
ISR,VEN,1998.0,1,0,1
MYS,HKG,2002.0,2,0,2
BEL,TWN,1997.0,1,0,1
CHN,MAR,2012.0,1,0,1
FRA,ISL,2002.0,1,0,1
ISL,FRA,2008.0,2,0,2
GUM,,2005.0,5,0,5
VUT,,2005.0,1,0,1
CUB,PER,2002.0,1,0,1
TTO,IRL,1997.0,1,0,1
IND,FIN,1998.0,3,0,3
MCO,PRT,2001.0,1,0,1
JPN,CRI,2008.0,2,0,2
ESP,UGA,2004.0,1,0,1
PHL,FRA,2002.0,1,0,1
FLK,AUS,2008.0,1,0,1
IOT,CYM,2004.0,1,0,1
,MSR,1995.0,7,0,7
GNQ,ESP,2009.0,1,0,1
NLD,CUB,2000.0,1,0,1
SDN,CHE,2023.0,1,0,1
CMR,COD,2016.0,1,0,1
BEL,ZWE,2014.0,3,0,3
,MRT,2007.0,4,0,4
MRT,,2014.0,2,0,2
QAT,,2001.0,9,0,9
SLV,SVK,2019.0,3,0,3
SWE,CRI,2004.0,2,0,2
,SWZ,2001.0,5,0,5
JPN,DZA,2015.0,2,0,2
AGO,ESP,2021.0,1,0,1
ESP,NGA,2006.0,1,0,1
ALB,NLD,2022.0,1,0,1
TUR,CHN,2013.0,3,0,3
PHL,SWE,2021.0,3,0,3
PAK,CMR,2023.0,1,0,1
TUR,ITA,2024.0,1,0,1
UGA,FIN,2023.0,1,0,1
ARG,DZA,2022.0,1,0,1
NPL,CZE,2022.0,1,0,1
NLD,KWT,2019.0,1,0,1
PNG,ZAF,2017.0,1,0,1
CMR,CHE,2023.0,3,0,3
IND,NGA,2005.0,3,0,3
ISR,JOR,1999.0,1,0,1
,BOL,2001.0,23,0,23
AUT,MEX,2004.0,1,0,1
CHN,IND,1997.0,1,0,1
SRB,BRB,2011.0,1,0,1
SVK,NOR,2002.0,1,0,1
FJI,CHE,2007.0,1,0,1
JPN,COL,1997.0,1,0,1
KHM,,2005.0,4,0,4
GLP,CAN,1998.0,1,0,1
CAN,GLP,1999.0,1,0,1
LSO,GBR,2019.0,1,0,1
NLD,ZMB,2017.0,3,0,3
HKG,CZE,2007.0,2,0,2
MDA,FIN,2004.0,1,0,1
FIN,MDA,2017.0,1,0,1
COL,ETH,1998.0,1,0,1
ITA,LBN,2003.0,1,0,1
,MRT,1999.0,11,0,11
USA,QAT,2001.0,3,0,3
AUT,ARE,2010.0,3,0,3
ZAF,MOZ,2007.0,2,0,2
NLD,MDV,2020.0,2,0,2
ITA,SYR,2017.0,1,0,1
MDG,MLI,2004.0,2,0,2
BGD,NLD,2000.0,2,0,2
CIV,BEL,2004.0,2,0,2
PAN,CZE,2022.0,1,0,1
MYS,BRB,2002.0,1,0,1
AUT,CUB,1998.0,1,0,1
PNG,IDN,2003.0,2,0,2
CRI,MTQ,2006.0,1,0,1
PRT,MAR,2011.0,1,0,1
PHL,MEX,1997.0,1,0,1
NER,,2008.0,8,0,8
EGY,NGA,2004.0,1,0,1
NZL,HUN,1997.0,1,0,1
MAR,JPN,2002.0,3,0,3
ITA,OMN,2019.0,3,0,3
HKG,IRL,2010.0,4,0,4
ECU,SWE,2004.0,3,0,3
OMN,BHR,2010.0,1,0,1
IRL,NGA,2016.0,2,0,2
MYS,MAR,2021.0,3,0,3
BGR,CAN,2009.0,2,0,2
KAZ,UKR,2010.0,1,0,1
SWE,LIE,2019.0,1,0,1
BEL,BWA,2019.0,1,0,1
USA,HTI,2010.0,1,0,1
ERI,SAU,1999.0,1,0,1
SWE,SWZ,2020.0,1,0,1
IRN,ISL,2014.0,1,0,1
IDN,MOZ,2011.0,1,0,1
KOR,CHL,2013.0,4,0,4
ZAF,PHL,2020.0,2,0,2
ITA,MOZ,2011.0,2,0,2
IRL,HUN,2013.0,1,0,1
SWE,DZA,2017.0,1,0,1
MLT,IRL,2011.0,1,0,1
BRA,TWN,2018.0,3,0,3
JAM,BHS,2015.0,1,0,1
POL,DZA,2014.0,2,0,2
SVN,CMR,2017.0,1,0,1
TTO,CAN,2014.0,3,0,3
GEO,PAK,2013.0,2,0,2
DNK,IRQ,2013.0,1,0,1
IRN,BGD,2013.0,1,0,1
FIN,ETH,2021.0,2,0,2
,FLK,2007.0,2,0,2
,GRL,2007.0,5,0,5
FIN,DZA,2017.0,1,0,1
UKR,NOR,2023.0,3,0,3
GBR,PSE,2010.0,4,0,4
BGD,BEL,2010.0,2,0,2
CMR,BEN,2016.0,1,0,1
BLR,NLD,2022.0,2,0,2
CYP,LUX,2023.0,1,0,1
ZAF,OMN,2002.0,2,0,2
SAU,IRQ,2012.0,1,0,1
SYC,GBR,2020.0,1,0,1
HND,GBR,2014.0,1,0,1
IRN,SVK,2022.0,7,0,7
RUS,EGY,1998.0,3,0,3
,NIC,2011.0,17,0,17
CRI,SAU,2017.0,1,0,1
BEL,KWT,2015.0,2,0,2
GRC,MEX,2018.0,1,0,1
COL,ARE,2019.0,3,0,3
CMR,COD,2018.0,2,0,2
HKG,COL,2017.0,2,0,2
DNK,SEN,2020.0,1,0,1
BRN,GBR,1998.0,3,0,3
POL,JAM,2011.0,1,0,1
ESP,SLV,2006.0,3,0,3
ZAF,SLE,2013.0,1,0,1
BRA,ARE,2018.0,6,0,6
MMR,NOR,2019.0,1,0,1
NGA,DZA,2013.0,1,0,1
,REU,2018.0,6,0,6
PER,GTM,2016.0,1,0,1
GTM,PER,2017.0,2,0,2
CZE,LIE,2013.0,1,0,1
BRA,HRV,2022.0,2,0,2
ISR,THA,2022.0,1,0,1
UKR,UZB,2013.0,3,0,3
SLV,GTM,2012.0,1,0,1
SAU,PSE,2010.0,1,0,1
COD,LAO,2021.0,2,0,2
TZA,KAZ,2022.0,1,0,1
GAB,DEU,2023.0,6,0,6
DEU,URY,2011.0,1,0,1
PHL,TUR,2002.0,1,0,1
USA,SLE,2006.0,1,0,1
ESP,TUN,2004.0,2,0,2
,MRT,1998.0,3,0,3
BRA,LBN,2006.0,1,0,1
MEX,MTQ,2007.0,1,0,1
MTQ,,2011.0,10,0,10
TJK,RUS,2010.0,2,0,2
LAO,,2005.0,5,0,5
ZWE,NZL,1999.0,2,0,2
ITA,GHA,2003.0,1,0,1
FRA,ZWE,2002.0,1,0,1
IRQ,,2000.0,6,0,6
GUY,,1999.0,1,0,1
GRC,LKA,2010.0,1,0,1
,GUM,1997.0,6,0,6
GHA,GMB,2004.0,2,0,2
ZAF,CAF,2003.0,2,0,2
TON,,2005.0,1,0,1
GBR,MOZ,2000.0,2,0,2
RUS,TUN,2007.0,1,0,1
,MLI,1998.0,18,0,18
MAC,,2003.0,1,0,1
MTQ,,2009.0,3,0,3
GUM,,2002.0,1,0,1
ARM,DEU,2004.0,4,0,4
SPM,,2014.0,1,0,1
ETH,GHA,2019.0,4,0,4
CHE,BEN,2016.0,2,0,2
BRA,EGY,2004.0,1,0,1
FRA,MYS,2003.0,4,0,4
KWT,ARE,2000.0,1,0,1
BHR,CAN,2002.0,1,0,1
ISR,HRV,2009.0,1,0,1
PHL,DNK,2008.0,1,0,1
DNK,PHL,2010.0,1,0,1
JPN,ROU,2012.0,3,0,3
BOL,,2008.0,7,0,7
CRI,ECU,2023.0,2,0,2
THA,RUS,2004.0,1,0,1
LIE,,2018.0,11,0,11
,WSM,1999.0,5,0,5
MDA,POL,2009.0,1,0,1
MCO,,2009.0,7,0,7
SYR,DEU,2000.0,4,0,4
CIV,,2026.0,1,0,1
LBY,IRQ,2011.0,2,0,2
PRT,CZE,2013.0,1,0,1
BGR,IND,2005.0,2,0,2
GLP,,2001.0,3,0,3
UGA,DEU,2000.0,2,0,2
JOR,BHR,2003.0,1,0,1
BHR,JOR,2011.0,1,0,1
SWE,IDN,2007.0,4,0,4
TUR,ZAF,2012.0,2,0,2
REU,NZL,2008.0,1,0,1
THA,ESP,1999.0,1,0,1
LBN,CHE,2003.0,1,0,1
COG,RWA,2010.0,1,0,1
BEL,TZA,2005.0,2,0,2
USA,MLT,2000.0,2,0,2
JOR,BRA,2004.0,2,0,2
REU,,2015.0,8,0,8
DZA,ALB,2012.0,1,0,1
KEN,VNM,2017.0,1,0,1
ARG,HKG,2004.0,1,0,1
ITA,UGA,2013.0,4,0,4
CHE,TTO,2003.0,1,0,1
MDG,SEN,2023.0,1,0,1
ARM,BEL,2006.0,1,0,1
KWT,JPN,2017.0,1,0,1
DNK,NAM,2021.0,1,0,1
USA,DOM,2005.0,6,0,6
BLR,DNK,1998.0,2,0,2
LKA,GHA,2007.0,1,0,1
OMN,SGP,2007.0,2,0,2
BRA,FIN,2007.0,3,0,3
BRA,HND,2015.0,1,0,1
TJK,DEU,2019.0,1,0,1
RUS,TKM,1997.0,2,0,2
COL,CHN,2013.0,3,0,3
KGZ,DEU,2004.0,1,0,1
DEU,PYF,2013.0,1,0,1
ZWE,NER,2000.0,1,0,1
SWE,SAU,2010.0,2,0,2
ECU,GBR,2008.0,1,0,1
PHL,SLB,1997.0,1,0,1
LUX,IRL,2009.0,1,0,1
,DJI,2003.0,1,0,1
BRA,NZL,2015.0,7,0,7
CHN,BDI,2016.0,2,0,2
MOZ,ETH,2013.0,1,0,1
GLP,,2015.0,10,0,10
FJI,EST,2019.0,1,0,1
UGA,DEU,2006.0,2,0,2
SGP,PHL,2002.0,1,0,1
AUT,GAB,2007.0,1,0,1
CAN,PAN,2013.0,2,0,2
PAN,CAN,2014.0,4,0,4
BLR,BEL,2017.0,2,0,2
MKD,SVN,2010.0,1,0,1
CMR,PAK,2016.0,1,0,1
NLD,CRI,2009.0,1,0,1
UKR,MEX,2013.0,4,0,4
CHE,JOR,2016.0,3,0,3
RUS,MKD,2010.0,1,0,1
BOL,CUB,2010.0,2,0,2
NLD,AFG,2018.0,1,0,1
LKA,KEN,2007.0,1,0,1
KEN,NOR,2012.0,2,0,2
GRL,AUS,2020.0,1,0,1
RWA,GBR,2011.0,2,0,2
DNK,ETH,2003.0,2,0,2
VEN,BEL,2003.0,1,0,1
MYS,SDN,2019.0,7,0,7
RWA,,2011.0,5,0,5
GHA,ZMB,2017.0,1,0,1
ISR,FIN,2013.0,2,0,2
KEN,VNM,2016.0,1,0,1
,TON,2009.0,2,0,2
SWE,NCL,2018.0,1,0,1
PLW,USA,2003.0,3,0,3
IRN,TWN,2010.0,1,0,1
FIN,MAR,2012.0,1,0,1
CHN,JOR,2013.0,2,0,2
CIV,SWZ,2015.0,1,0,1
,MOZ,2005.0,25,0,25
ECU,MEX,2001.0,1,0,1
PNG,BEL,2013.0,1,0,1
PRY,CHL,2002.0,3,0,3
MWI,BWA,2019.0,1,0,1
NER,JPN,2014.0,1,0,1
CAN,LBY,2009.0,1,0,1
KOR,FIN,2004.0,1,0,1
COL,NZL,2012.0,2,0,2
,FLK,1998.0,2,0,2
DNK,IRN,2005.0,1,0,1
,CPV,2006.0,2,0,2
NOR,QAT,2016.0,3,0,3
,MTQ,2012.0,17,0,17
THA,CHL,2018.0,1,0,1
IND,SDN,2020.0,3,0,3
CAN,GMB,2021.0,1,0,1
SEN,NGA,2017.0,1,0,1
NOR,TUN,2018.0,1,0,1
BRA,SVK,2020.0,1,0,1
,PYF,2009.0,9,0,9
IRQ,HUN,2016.0,1,0,1
OMN,PER,2015.0,2,0,2
PER,OMN,2017.0,1,0,1
JAM,CHE,2014.0,2,0,2
AND,FRA,2009.0,1,0,1
PAN,PAK,2015.0,1,0,1
CHE,MLI,2013.0,1,0,1
CZE,TUR,2016.0,4,0,4
CHN,TGO,2014.0,2,0,2
PHL,IRL,2015.0,2,0,2
LBY,FRA,2019.0,2,0,2
SDN,ITA,2010.0,1,0,1
BRN,VNM,2017.0,1,0,1
IRN,HKG,2024.0,2,0,2
NZL,NGA,2004.0,1,0,1
OMN,KWT,2013.0,1,0,1
SLE,PAK,2018.0,1,0,1
BGD,SWE,2001.0,2,0,2
IRL,BGR,2018.0,3,0,3
,VIR,2013.0,1,0,1
BTN,NPL,2018.0,1,0,1
ARG,SLV,2019.0,1,0,1
NLD,ABW,2017.0,2,0,2
NOR,COD,2020.0,1,0,1
BRA,HUN,2018.0,2,0,2
PHL,IDN,2011.0,1,0,1
MNP,ASM,2022.0,1,0,1
CZE,MAR,2020.0,1,0,1
GRC,CZE,2005.0,1,0,1
ETH,VNM,2022.0,1,0,1
MMR,ARE,2020.0,1,0,1
JPN,KOR,2024.0,1,0,1
ASM,WSM,2017.0,1,0,1
ASM,,2024.0,3,0,3
CHN,IDN,2013.0,1,0,1
JPN,MOZ,2022.0,1,0,1
VEN,CZE,2022.0,1,0,1
GRC,KWT,2018.0,3,0,3
CHN,MUS,2020.0,4,0,4
IND,CHL,2020.0,12,0,12
UKR,DNK,2021.0,2,0,2
KHM,SWE,2020.0,2,0,2
TUN,HUN,2023.0,1,0,1
EGY,ROU,2019.0,1,0,1
REU,NCL,2022.0,1,0,1
PAK,SGP,2023.0,3,0,3
NLD,LTU,2023.0,3,0,3
GIB,,2024.0,7,0,7
BEN,JPN,2022.0,1,0,1
GEO,EST,2020.0,1,0,1
AUS,HKG,2024.0,1,0,1
CAN,GRD,2022.0,1,0,1
ROU,TUN,2023.0,1,0,1
TZA,ZMB,2023.0,3,0,3
GTM,,2002.0,4,0,4
GRC,GEO,2010.0,1,0,1
MRT,ITA,2014.0,1,0,1
GBR,SYR,2007.0,6,0,6
SYR,PRT,2013.0,2,0,2
CAN,CMR,2003.0,2,0,2
HUN,CZE,2003.0,3,0,3
CRI,CZE,2010.0,1,0,1
GRC,BRA,2011.0,1,0,1
TZA,BWA,2001.0,2,0,2
MUS,HKG,2001.0,1,0,1
GMB,TZA,2021.0,1,0,1
KEN,SSD,2020.0,2,0,2
HRV,UKR,2001.0,1,0,1
LBN,PSE,2002.0,2,0,2
BHR,,2000.0,7,0,7
USA,BDI,2012.0,1,0,1
OMN,ISR,2018.0,1,0,1
CZE,COG,2003.0,1,0,1
DEU,GRD,2012.0,2,0,2
GRD,DEU,2013.0,2,0,2
CUB,AGO,2019.0,2,0,2
CHE,ZMB,2010.0,1,0,1
SUR,,2000.0,3,0,3
AUS,KEN,1997.0,1,0,1
,SWZ,2004.0,4,0,4
TGO,,2004.0,4,0,4
CMR,COD,2017.0,2,0,2
TUN,EGY,2002.0,2,0,2
ZWE,FRA,2005.0,2,0,2
IDN,GHA,2010.0,1,0,1
NER,GBR,2006.0,1,0,1
SGP,BGD,2005.0,5,0,5
SWZ,RUS,1997.0,1,0,1
AUT,KAZ,2002.0,1,0,1
NGA,COD,2015.0,1,0,1
ZWE,MWI,2003.0,2,0,2
MWI,ZWE,2005.0,1,0,1
,SYC,1994.0,5,0,5
TUN,SAU,2007.0,4,0,4
PHL,BEL,2003.0,2,0,2
HKG,TUR,2010.0,1,0,1
GRC,MKD,1998.0,1,0,1
AUT,MEX,2014.0,3,0,3
SDN,NGA,1997.0,1,0,1
,PYF,2011.0,9,0,9
THA,JOR,2003.0,1,0,1
GHA,NLD,2001.0,2,0,2
ECU,JPN,2002.0,1,0,1
MAC,PHL,2016.0,1,1,0
BGD,NPL,2012.0,2,1,1
AUT,KOR,2010.0,3,4,-1
CHN,IND,1999.0,2,3,-1
ARG,CHN,2014.0,3,1,2
DZA,GBR,2018.0,11,1,10
NZL,SWE,2023.0,2,4,-2
CAN,EGY,2002.0,3,6,-3
MEX,BOL,2019.0,1,1,0
KWT,BIH,2022.0,1,1,0
PRT,CAN,2001.0,8,8,0
QAT,IRL,2019.0,2,4,-2
IRL,PRT,2008.0,1,8,-7
CHE,SWZ,2006.0,1,1,0
ZAF,CZE,2019.0,2,2,0
QAT,ZAF,2023.0,2,1,1
JOR,CHE,2022.0,1,2,-1
AUT,IND,2021.0,10,10,0
HRV,FIN,2018.0,4,1,3
PSE,TUR,2023.0,1,2,-1
RUS,SYR,2020.0,1,1,0
SAU,IRL,2019.0,3,10,-7
USA,GMB,2020.0,2,3,-1
BRA,UGA,2021.0,1,1,0
TUR,RUS,1998.0,1,3,-2
NPL,PAK,2015.0,1,2,-1
TUR,NGA,2021.0,6,2,4
BEL,KEN,2023.0,5,1,4
DNK,ISL,2000.0,2,2,0
MYS,LKA,2022.0,4,2,2
BEN,SEN,2023.0,1,2,-1
AUS,MAC,2023.0,2,3,-1
ESP,ECU,2000.0,2,4,-2
GEO,PAK,2014.0,1,1,0
DZA,CAN,2023.0,2,3,-1
DZA,CAN,2000.0,2,1,1
GHA,GBR,1999.0,9,4,5
VNM,CHE,2001.0,2,1,1
IRL,FIN,2023.0,3,3,0
SRB,BIH,2001.0,5,4,1
MEX,CHE,2006.0,4,6,-2
MEX,BEL,2005.0,4,2,2
DZA,USA,2004.0,1,5,-4
CHL,PER,2010.0,1,5,-4
NLD,BGR,2008.0,1,2,-1
CHL,IRL,2001.0,1,1,0
IDN,USA,1998.0,12,23,-11
COG,USA,2000.0,1,1,0
QAT,AUS,2015.0,3,7,-4
TTO,GBR,2013.0,3,5,-2
SEN,BFA,2010.0,3,2,1
GBR,ETH,2006.0,5,3,2
KWT,GBR,2006.0,4,11,-7
ISR,NGA,2011.0,1,1,0
BEN,ZAF,2003.0,2,3,-1
CMR,CAN,2007.0,2,4,-2
MLT,GRC,2014.0,2,1,1
POL,ARE,2022.0,3,1,2
AUS,HUN,2015.0,5,2,3
NLD,EGY,2015.0,6,2,4
FIN,CZE,2005.0,3,5,-2
SWE,ETH,2000.0,1,4,-3
KAZ,DEU,2017.0,6,8,-2
DEU,ISL,2011.0,7,5,2
CHL,NLD,2007.0,2,1,1
ZWE,BDI,2021.0,1,1,0
DEU,GAB,1998.0,1,4,-3
BRA,IDN,2019.0,1,1,0
ZAF,UGA,2007.0,4,3,1
BEL,ZMB,2006.0,2,1,1
ITA,UGA,2014.0,2,4,-2
CZE,ISR,2002.0,3,1,2
DZA,USA,2001.0,2,3,-1
NER,NGA,2005.0,2,11,-9
QAT,CHE,2016.0,2,1,1
GAB,FRA,2017.0,7,7,0
ARG,NLD,2008.0,2,7,-5
GBR,BRN,2014.0,3,1,2
KEN,ZWE,2013.0,2,2,0
PSE,SAU,2018.0,2,2,0
ARE,SGP,2020.0,3,9,-6
NAM,USA,2004.0,2,1,1
PRI,ESP,2021.0,3,3,0
GEO,CHE,2015.0,1,2,-1
THA,FRA,1998.0,3,3,0
ALB,ITA,2020.0,7,6,1
SGP,ITA,2012.0,2,9,-7
DEU,CYP,2013.0,2,1,1
KEN,ZAF,2006.0,4,5,-1
NZL,BEL,2008.0,4,3,1
BRA,NOR,2008.0,1,1,0
BRA,ISR,2008.0,3,2,1
MOZ,ZAF,2006.0,1,1,0
NGA,BWA,2010.0,2,4,-2
CHN,UZB,2012.0,2,1,1
UGA,COG,2017.0,1,1,0
ECU,ESP,2001.0,4,8,-4
SEN,BFA,2023.0,1,1,0
DZA,ITA,2010.0,1,1,0
NCL,USA,2015.0,2,1,1
FRA,GMB,2014.0,1,1,0
CZE,BEL,2015.0,8,11,-3
FRA,ARM,2019.0,3,2,1
HTI,USA,2013.0,9,4,5
USA,AZE,2015.0,2,1,1
YEM,CAN,2021.0,2,1,1
USA,BIH,2012.0,7,4,3
FIN,PRT,2022.0,3,3,0
SVK,ITA,2014.0,2,3,-1
CHE,MWI,2018.0,4,1,3
TUR,NOR,2012.0,2,3,-1
NOR,AUT,2018.0,8,15,-7
CAN,CZE,2023.0,6,6,0
AUT,BRA,2012.0,5,6,-1
NOR,ZAF,2012.0,3,7,-4
TUN,JPN,2015.0,1,6,-5
SRB,ALB,2014.0,5,5,0
MAC,PRT,2021.0,2,5,-3
DEU,MDG,2014.0,2,4,-2
TUN,KWT,2021.0,2,1,1
USA,BHS,2013.0,1,3,-2
TWN,AUS,2007.0,5,17,-12
DZA,ESP,2013.0,2,4,-2
SVK,CHE,2014.0,2,2,0
BEN,BEL,2018.0,4,1,3
GRC,DNK,2020.0,11,6,5
CHN,RUS,2024.0,2,1,1
OMN,TUN,2020.0,2,5,-3
TUR,HUN,2021.0,4,2,2
POL,TWN,2015.0,1,1,0
PRT,HUN,2003.0,1,4,-3
CIV,BRA,2015.0,3,1,2
CHN,JOR,2015.0,2,1,1
GRC,POL,2013.0,4,2,2
ESP,SEN,2021.0,2,1,1
MAC,MAR,2018.0,7,4,3
SVN,CHN,2015.0,1,3,-2
AUS,BTN,2020.0,2,7,-5
ISR,UKR,2023.0,1,6,-5
EGY,KEN,2018.0,2,1,1
IRN,IND,1999.0,5,4,1
IND,KAZ,2022.0,1,1,0
SWE,GHA,2021.0,2,1,1
USA,MTQ,2018.0,1,1,0
AUS,LAO,2020.0,1,2,-1
UKR,AUT,2019.0,2,3,-1
FIN,LTU,2018.0,1,1,0
AZE,IRN,2017.0,3,2,1
EST,CZE,2020.0,2,1,1
GHA,THA,2018.0,2,1,1
RUS,AUS,2022.0,10,6,4
DNK,MYS,2012.0,1,3,-2
KNA,USA,2020.0,5,7,-2
CHN,DZA,2017.0,5,3,2
NZL,PER,2022.0,1,1,0
KWT,ITA,2021.0,1,1,0
IDN,PRT,2020.0,2,2,0
PAK,BHR,2021.0,2,2,0
BGD,FRA,2019.0,1,5,-4
POL,HUN,1997.0,2,1,1
LUX,NLD,2006.0,1,2,-1
HUN,FIN,2002.0,1,5,-4
BRN,NOR,2021.0,1,1,0
ECU,NLD,2002.0,1,1,0
ARE,FRA,1998.0,1,2,-1
NOR,SRB,2001.0,1,1,0
USA,BMU,2017.0,2,1,1
KHM,AUS,2008.0,2,1,1
TZA,DEU,2013.0,4,4,0
KOR,NLD,1997.0,1,1,0
GRC,IRL,2006.0,1,1,0
SAU,CZE,2005.0,1,1,0
DNK,TZA,2001.0,2,5,-3
AUS,BGD,2005.0,2,3,-1
CHL,NZL,2005.0,1,3,-2
QAT,EGY,2008.0,1,1,0
BRA,IRN,2012.0,1,5,-4
HRV,NOR,2022.0,2,1,1
CHL,POL,2018.0,3,2,1
THA,PRT,2015.0,1,3,-2
ARE,IND,2012.0,4,19,-15
CHN,GRC,2017.0,4,7,-3
UGA,SWE,2019.0,4,6,-2
DEU,PAN,2016.0,1,1,0
GHA,DEU,2012.0,3,6,-3
DEU,MKD,2019.0,1,3,-2
PRT,MAC,2021.0,5,2,3
CHN,HRV,2009.0,1,1,0
MYS,CUB,2018.0,1,1,0
IRN,ZAF,2004.0,1,4,-3
AUS,BWA,2013.0,1,3,-2
PRT,CPV,2019.0,3,1,2
JPN,MAR,2020.0,1,3,-2
KOR,ETH,2015.0,3,6,-3
RWA,CHN,2017.0,2,4,-2
QAT,AUS,2014.0,3,9,-6
ZAF,MAR,2019.0,2,1,1
ZAF,TUR,2015.0,3,3,0
ZAF,ROU,2012.0,1,2,-1
CHN,ZMB,2020.0,3,2,1
NZL,TWN,2007.0,1,3,-2
AUT,IRL,2021.0,2,6,-4
CAN,TTO,2012.0,1,4,-3
ZWE,AUS,2013.0,2,1,1
IRN,FIN,2003.0,1,1,0
ROU,BGR,2018.0,1,3,-2
KAZ,IND,2015.0,1,1,0
ECU,AUS,2020.0,2,7,-5
CZE,CHN,2004.0,1,1,0
FIN,PRT,2018.0,2,6,-4
CPV,PRT,2015.0,1,3,-2
GHA,EST,2023.0,1,1,0
CAN,PHL,2023.0,4,8,-4
NPL,BEL,2022.0,1,1,0
USA,ATG,2023.0,2,1,1
KOR,MNG,2023.0,3,1,2
ESP,ROU,2023.0,3,5,-2
USA,AFG,2023.0,2,5,-3
ESP,MLT,2018.0,1,1,0
KOR,MMR,2018.0,2,1,1
ZAF,AUT,2023.0,5,4,1
SWE,ISR,2003.0,3,5,-2
THA,CHN,2000.0,1,3,-2
CZE,ISR,2012.0,1,1,0
KEN,CHN,2009.0,2,5,-3
PER,BEL,2009.0,1,2,-1
CAN,CIV,2019.0,5,2,3
GBR,SWZ,1999.0,1,1,0
CZE,ISR,2005.0,3,1,2
CUB,PRT,2013.0,2,2,0
JPN,BGR,2017.0,3,5,-2
KGZ,RUS,2012.0,2,2,0
FRA,CAF,2016.0,1,2,-1
GRC,FIN,2010.0,3,4,-1
SAU,SYR,2015.0,1,3,-2
AUS,CYP,2015.0,2,2,0
DNK,ROU,2010.0,1,4,-3
THA,DNK,2012.0,2,4,-2
UKR,BLR,2011.0,2,1,1
ITA,COL,2013.0,4,3,1
BEL,SVK,2016.0,4,3,1
EST,NOR,2000.0,2,2,0
MOZ,FRA,2016.0,1,1,0
JPN,CMR,2012.0,3,2,1
MEX,CHL,2005.0,4,4,0
UKR,MEX,2008.0,3,2,1
ESP,HUN,2011.0,3,5,-2
AUT,LUX,2017.0,3,2,1
CHN,NPL,2009.0,2,1,1
IRN,FRA,2009.0,11,24,-13
FRA,LBY,2017.0,3,1,2
POL,BGR,2018.0,1,1,0
AUS,NCL,2015.0,3,1,2
TUR,BIH,2022.0,2,1,1
DNK,EGY,2016.0,2,2,0
CHN,ETH,2016.0,2,8,-6
JPN,LAO,2023.0,1,1,0
NLD,UKR,2020.0,4,6,-2
SVK,POL,2023.0,1,4,-3
DNK,ISR,2015.0,1,3,-2
BGD,LKA,2011.0,1,1,0
DEU,CMR,2016.0,3,5,-2
ISR,CZE,2019.0,4,2,2
BEL,CMR,2001.0,2,3,-1
ESP,LBN,2019.0,3,2,1
URY,FRA,2022.0,2,4,-2
MEX,KEN,2019.0,1,1,0
SAU,GRC,2015.0,1,5,-4
KAZ,NOR,2016.0,1,3,-2
TUR,POL,2014.0,2,1,1
KAZ,NOR,2022.0,1,1,0
POL,PAK,2015.0,3,1,2
GNB,DNK,2020.0,2,5,-3
ARE,CHE,2017.0,1,1,0
ECU,CAN,2016.0,3,3,0
ITA,CHL,2017.0,16,18,-2
JOR,GBR,2002.0,2,4,-2
MNG,CZE,2021.0,2,1,1
SWZ,USA,2018.0,4,5,-1
MLT,LBY,2019.0,2,1,1
GRL,USA,2021.0,1,2,-1
AUS,GUY,2018.0,1,1,0
CAN,ETH,2015.0,2,3,-1
GRC,ISR,2016.0,3,2,1
IDN,SWE,2015.0,2,2,0
EGY,PSE,2017.0,2,4,-2
IDN,GBR,1997.0,3,4,-1
IDN,SAU,2018.0,3,4,-1
NOR,PRT,1999.0,1,1,0
USA,BIH,2005.0,4,1,3
GBR,SYR,1997.0,1,1,0
TUR,POL,2015.0,2,2,0
PAK,SYR,2009.0,1,1,0
MAR,BEL,1999.0,1,3,-2
RUS,VNM,2023.0,12,4,8
IRN,QAT,2021.0,2,2,0
CHE,ISL,2022.0,2,2,0
SEN,TCD,2022.0,1,1,0
GUY,NGA,2023.0,1,2,-1
ROU,NLD,1999.0,1,3,-2
GBR,UZB,2010.0,2,1,1
DEU,URY,2010.0,2,1,1
GRC,IND,2011.0,1,3,-2
DZA,MAR,2016.0,5,3,2
EGY,AUS,2002.0,2,2,0
JOR,BHR,2008.0,2,1,1
NER,FRA,2010.0,3,4,-1
TUR,AUS,2008.0,5,6,-1
ZWE,BWA,2020.0,4,1,3
NLD,CMR,2011.0,1,1,0
HRV,ITA,2006.0,3,3,0
GBR,LBY,2002.0,2,5,-3
UGA,MWI,2011.0,2,2,0
UGA,MWI,2021.0,3,2,1
NLD,MEX,2004.0,4,6,-2
JPN,MNG,1999.0,2,1,1
MEX,SGP,2004.0,1,2,-1
RUS,PRT,2023.0,3,2,1
HND,USA,2012.0,2,1,1
GBR,MCO,2008.0,1,1,0
GBR,BWA,2023.0,2,1,1
SWE,COL,2003.0,1,1,0
UKR,SGP,2001.0,3,2,1
NER,FRA,2006.0,4,5,-1
MMR,GBR,2011.0,1,1,0
SLB,AUS,2018.0,2,2,0
AUS,SLB,2020.0,1,1,0
BWA,MUS,2019.0,1,1,0
CHN,RUS,2006.0,4,3,1
UGA,NLD,2014.0,2,2,0
BLR,GBR,2000.0,3,2,1
BEL,ARE,2016.0,4,1,3
USA,KGZ,2004.0,2,2,0
CZE,KWT,2005.0,2,2,0
SYR,USA,2002.0,4,7,-3
ESP,UKR,1998.0,1,4,-3
UKR,MEX,2004.0,3,1,2
HRV,NLD,1999.0,2,1,1
BEL,LBN,2012.0,3,2,1
FRA,EGY,1997.0,2,3,-1
ETH,SEN,2019.0,1,2,-1
ISL,FRA,2013.0,2,5,-3
ZAF,SEN,2017.0,7,5,2
SWE,CZE,2006.0,3,6,-3
BWA,USA,2009.0,4,7,-3
URY,BRA,2006.0,3,7,-4
EST,ARM,2017.0,1,1,0
GMB,NGA,2010.0,2,2,0
CZE,SWE,2014.0,11,3,8
BGD,PHL,2023.0,1,1,0
NLD,EST,2011.0,2,1,1
NGA,BEL,2009.0,1,1,0
FRA,CRI,2011.0,3,2,1
GRC,NZL,2017.0,1,2,-1
AFG,JPN,2023.0,2,3,-1
SAU,JOR,2007.0,2,6,-4
LKA,DNK,2011.0,1,1,0
IND,THA,2007.0,2,5,-3
CAN,SVK,1998.0,3,2,1
CRI,DNK,2015.0,1,1,0
ISL,USA,2010.0,4,25,-21
USA,COG,2015.0,4,6,-2
HUN,CHN,1999.0,3,2,1
QAT,DEU,2016.0,2,5,-3
KWT,USA,2018.0,9,29,-20
NZL,NOR,2010.0,3,1,2
DNK,LKA,2010.0,1,1,0
DEU,LIE,2007.0,5,1,4
SAU,KAZ,2020.0,2,1,1
KEN,PAK,2020.0,1,3,-2
CYP,ITA,2015.0,3,5,-2
SDN,USA,2023.0,4,2,2
SWE,ARG,2016.0,3,2,1
GBR,CUB,2008.0,2,1,1
POL,IRN,2014.0,1,3,-2
ISR,KOR,2017.0,3,2,1
IRQ,DEU,2007.0,1,1,0
MEX,MYS,2019.0,1,2,-1
AUT,VNM,2010.0,3,2,1
MAR,CMR,2019.0,2,1,1
GBR,MMR,2016.0,1,1,0
EST,NOR,2023.0,2,1,1
USA,SEN,2013.0,3,5,-2
CUB,BRA,2023.0,1,3,-2
MUS,ITA,2010.0,1,1,0
IRL,BGD,2005.0,2,1,1
BHR,JOR,2000.0,2,1,1
GHA,ZAF,2015.0,6,8,-2
PAK,BGD,2017.0,10,13,-3
AUS,BRN,2006.0,2,1,1
DEU,BIH,2017.0,3,6,-3
PRT,MEX,2003.0,2,2,0
ARG,AUS,2023.0,4,1,3
HKG,KOR,2008.0,8,2,6
AFG,GBR,2016.0,2,1,1
ITA,PHL,2021.0,6,5,1
CAN,CZE,2006.0,5,9,-4
NOR,FRA,2006.0,8,25,-17
USA,MWI,2000.0,2,8,-6
BMU,USA,2008.0,3,1,2
RUS,CRI,1999.0,1,5,-4
NOR,ZAF,2002.0,1,3,-2
NLD,BGR,2001.0,2,6,-4
SWE,ECU,2000.0,1,1,0
ESP,HKG,2005.0,1,3,-2
NZL,BRA,2011.0,2,4,-2
HUN,FIN,1997.0,3,6,-3
UZB,IND,2021.0,1,5,-4
ESP,IND,2004.0,1,9,-8
LIE,CHE,2019.0,4,4,0
USA,GMB,1999.0,2,1,1
IRL,SVN,2006.0,1,1,0
HND,USA,2002.0,2,1,1
BRA,BEL,1998.0,2,13,-11
CAN,TTO,2005.0,4,1,3
VEN,PRI,1998.0,1,1,0
CAN,VEN,2003.0,4,2,2
GBR,JAM,2000.0,3,8,-5
ESP,PRY,2008.0,2,2,0
PRY,ESP,2009.0,1,5,-4
VEN,ITA,2008.0,2,5,-3
CHL,SWE,2011.0,4,7,-3
CYP,ISR,2014.0,1,1,0
SGP,IRN,2002.0,1,1,0
SRB,SWE,2003.0,2,3,-1
QAT,JPN,2014.0,2,3,-1
GMB,USA,2006.0,5,1,4
LVA,RUS,2017.0,3,5,-2
EST,FRA,1998.0,4,3,1
HUN,ARE,2005.0,1,4,-3
PRT,CHE,2002.0,3,8,-5
RUS,EGY,2012.0,1,1,0
EGY,TUR,2022.0,5,2,3
USA,SVN,1999.0,1,14,-13
DZA,DEU,2002.0,2,2,0
IND,POL,2003.0,2,3,-1
HKG,NOR,2006.0,1,2,-1
UZB,DEU,2015.0,3,4,-1
LUX,BEL,2008.0,2,11,-9
ITA,LTU,2004.0,4,2,2
PRI,GBR,2010.0,2,1,1
MDG,CAN,2014.0,2,2,0
MOZ,ESP,2012.0,3,2,1
KGZ,TUR,2017.0,3,5,-2
NGA,ETH,2009.0,1,2,-1
MRT,FRA,2003.0,1,1,0
FRA,MRT,2011.0,2,2,0
BEL,SVN,2021.0,3,1,2
NOR,BEL,2017.0,5,10,-5
DEU,YEM,2022.0,1,2,-1
FIN,SGP,2006.0,3,1,2
TUR,BHR,2013.0,1,1,0
JOR,IRQ,2017.0,4,5,-1
IND,NAM,2017.0,2,3,-1
NLD,HKG,2009.0,2,5,-3
HRV,DZA,2020.0,1,1,0
VNM,MYS,2010.0,2,1,1
UGA,ITA,2017.0,2,4,-2
AUS,NCL,2014.0,1,1,0
BHS,USA,2021.0,3,4,-1
NOR,SAU,2019.0,2,4,-2
BEL,TUN,2012.0,1,2,-1
MKD,SVN,2009.0,1,1,0
ITA,VAT,2018.0,2,1,1
GUF,USA,2010.0,1,1,0
ISR,ZAF,2004.0,2,1,1
PRI,FRA,2019.0,1,1,0
DEU,OMN,2020.0,2,2,0
NOR,SGP,2015.0,3,4,-1
NPL,BEL,2017.0,1,1,0
IDN,ESP,2020.0,1,4,-3
BIH,USA,2018.0,2,10,-8
MEX,EGY,2015.0,3,1,2
OMN,CAN,2001.0,1,3,-2
ESP,AND,2011.0,1,8,-7
CHE,DOM,1999.0,1,1,0
BGD,SWE,2013.0,4,3,1
AUT,DNK,2003.0,4,4,0
NLD,NGA,2007.0,3,1,2
TGO,FRA,2005.0,1,4,-3
BHR,JOR,2023.0,1,4,-3
CHE,LBN,2021.0,2,10,-8
BGD,OMN,2019.0,2,4,-2
ZAF,IND,2003.0,4,4,0
IRL,MWI,2019.0,1,2,-1
EGY,BEL,2015.0,3,8,-5
MAR,HUN,2017.0,1,1,0
PAN,ESP,2017.0,2,6,-4
KOR,QAT,2023.0,4,1,3
ESP,MOZ,2014.0,3,1,2
DZA,CHN,2022.0,1,8,-7
ALB,GRC,2021.0,1,1,0
KEN,MWI,2012.0,1,1,0
MWI,CHE,2017.0,2,2,0
NGA,RWA,2018.0,3,3,0
SVK,AUT,2023.0,2,10,-8
UKR,IRN,2020.0,2,2,0
BGD,SGP,2019.0,2,5,-3
ISR,ROU,2021.0,2,3,-1
QAT,MYS,2021.0,4,9,-5
UKR,LTU,2021.0,5,6,-1
TZA,CHE,2023.0,2,5,-3
UGA,IND,2021.0,1,1,0
NGA,BGD,2022.0,1,2,-1
USA,CIV,1998.0,4,2,2
SAU,SDN,1998.0,2,1,1
AUS,CZE,2001.0,2,3,-1
CHN,MEX,1999.0,1,5,-4
NPL,PAK,2014.0,1,2,-1
VNM,THA,2007.0,2,1,1
USA,KHM,2006.0,4,3,1
CHE,CHL,2016.0,7,5,2
GMB,USA,2010.0,1,2,-1
UKR,NOR,2009.0,1,2,-1
BMU,GBR,2007.0,2,2,0
PER,FRA,2016.0,1,9,-8
HUN,POL,2013.0,1,4,-3
AFG,PAK,2012.0,1,3,-2
CZE,IRN,2012.0,2,1,1
IRQ,IRN,2012.0,2,8,-6
AUS,UKR,2013.0,2,1,1
ALB,MKD,2018.0,1,1,0
ARE,TUR,2017.0,2,11,-9
DEU,TTO,2014.0,1,1,0
RWA,KEN,2023.0,4,4,0
SRB,SVK,2008.0,2,1,1
SVK,BEL,2022.0,2,1,1
SDN,DEU,2014.0,2,3,-1
CHN,RWA,2015.0,2,2,0
RUS,BIH,2020.0,1,1,0
JPN,CZE,2012.0,5,6,-1
POL,ARE,2017.0,1,1,0
AUT,ZAF,2005.0,3,4,-1
EGY,GRC,2019.0,3,1,2
KOR,OMN,2020.0,4,1,3
IRL,ZAF,2015.0,1,2,-1
IND,SEN,2021.0,1,1,0
CAN,PAN,2001.0,1,2,-1
DNK,AUT,1998.0,1,1,0
BGD,CAN,1999.0,1,1,0
USA,YEM,2012.0,1,1,0
BEN,DEU,2003.0,2,2,0
AUS,FJI,2010.0,5,7,-2
GBR,LBN,1999.0,2,2,0
KEN,CAN,2003.0,1,5,-4
UKR,BGR,2005.0,1,1,0
KOR,UZB,2015.0,1,2,-1
IRL,HUN,2014.0,1,2,-1
USA,RWA,2008.0,4,2,2
MDA,DEU,2010.0,1,2,-1
UKR,CHE,2006.0,3,1,2
NIC,CHL,2015.0,1,1,0
ZAF,AUT,2006.0,3,2,1
ISR,HUN,2013.0,2,5,-3
VNM,FRA,2006.0,4,13,-9
ZMB,MWI,2015.0,2,1,1
AUT,ISR,2004.0,1,3,-2
LTU,SWE,2015.0,5,3,2
FRA,EGY,2002.0,5,2,3
RUS,KAZ,2001.0,8,11,-3
IND,KEN,2001.0,2,2,0
SDN,SAU,2004.0,2,4,-2
BOL,USA,2000.0,2,3,-1
JPN,TZA,2016.0,1,2,-1
GEO,CAN,2012.0,1,1,0
ARG,CHE,2001.0,2,2,0
ITA,ZMB,2017.0,1,1,0
MAR,MAC,2019.0,4,10,-6
SGP,ISR,2012.0,1,8,-7
COL,BEL,2000.0,1,1,0
NLD,ROU,2006.0,3,4,-1
POL,AUS,2006.0,4,2,2
JPN,KEN,1998.0,4,5,-1
DEU,DZA,2000.0,3,2,1
UGA,FRA,2007.0,1,3,-2
MMR,KOR,2006.0,1,1,0
GBR,UGA,1997.0,3,6,-3
CHN,ESP,1999.0,1,3,-2
ARG,CUB,2011.0,2,6,-4
USA,SDN,2006.0,2,3,-1
USA,BLZ,2003.0,1,2,-1
THA,IND,2008.0,5,6,-1
SYR,GBR,2000.0,1,2,-1
USA,KNA,2008.0,3,2,1
BWA,IND,2001.0,1,1,0
GBR,MAR,2013.0,4,1,3
VEN,PAN,2022.0,1,1,0
GHA,CMR,2017.0,1,2,-1
DEU,MNG,2013.0,1,1,0
CUB,DEU,2023.0,3,1,2
HKG,SAU,2013.0,1,1,0
KEN,GHA,2013.0,2,2,0
POL,TWN,2014.0,2,2,0
NZL,ESP,2016.0,3,5,-2
ETH,LKA,2011.0,2,1,1
CZE,BRA,2013.0,5,5,0
CIV,CAN,2014.0,2,3,-1
SYR,DEU,2009.0,3,4,-1
TUN,DEU,2011.0,1,1,0
CAN,GRC,2015.0,4,19,-15
PRI,MEX,2007.0,1,1,0
USA,SLV,2012.0,1,1,0
PRI,PRT,2008.0,1,1,0
LUX,NOR,2010.0,1,1,0
CHE,LIE,2009.0,2,1,1
ROU,AUT,2017.0,5,5,0
GBR,LVA,2019.0,4,4,0
VNM,NLD,2015.0,2,11,-9
NGA,DZA,2008.0,3,2,1
USA,TTO,2022.0,6,5,1
BOL,CHL,2014.0,2,1,1
SWE,URY,2000.0,2,1,1
PRI,MEX,2020.0,2,1,1
MEX,CYP,2016.0,1,1,0
LVA,EST,2013.0,3,1,2
ITA,KAZ,2020.0,2,1,1
UKR,BLR,2021.0,1,3,-2
HKG,BEL,2014.0,1,1,0
THA,LKA,2012.0,1,3,-2
USA,NCL,2011.0,1,3,-2
KEN,IND,2023.0,1,3,-2
ISR,PRT,2000.0,1,1,0
BGR,NLD,2014.0,3,2,1
CAN,BHS,2017.0,1,1,0
MEX,ISR,1999.0,1,3,-2
BGD,TUR,2019.0,1,1,0
MEX,CZE,2003.0,1,4,-3
AUS,TUR,2006.0,1,1,0
SLV,SVN,2009.0,2,4,-2
SGP,MEX,2010.0,1,1,0
BMU,USA,2015.0,3,1,2
IRN,OMN,2013.0,1,1,0
BEL,ARG,2017.0,3,4,-1
ZAF,EGY,2013.0,1,4,-3
FRA,BIH,2021.0,2,1,1
PSE,DEU,2015.0,3,6,-3
CMR,KOR,2021.0,2,2,0
MNE,MKD,2019.0,2,1,1
HKG,TUR,2019.0,2,1,1
BEL,EST,2003.0,1,1,0
PHL,THA,2019.0,3,8,-5
HRV,NLD,2020.0,7,2,5
GHA,THA,2017.0,1,2,-1
CHE,CHL,2022.0,5,6,-1
CHN,MMR,2020.0,3,5,-2
NOR,ZMB,2020.0,5,1,4
IRL,KOR,2011.0,1,3,-2
OMN,NLD,2002.0,2,1,1
BEL,MOZ,2010.0,1,1,0
BFA,AUT,2021.0,2,1,1
ARG,VEN,2012.0,1,2,-1
DNK,IND,2003.0,2,4,-2
CYP,LBN,2022.0,2,2,0
THA,BGD,2012.0,5,6,-1
KWT,BHR,2011.0,2,1,1
IRQ,BHR,2021.0,1,2,-1
IRN,ARE,2014.0,1,1,0
CHE,GIN,2022.0,4,2,2
KEN,BFA,2007.0,1,1,0
LTU,FRA,2000.0,4,3,1
EGY,BEL,2008.0,3,4,-1
ESP,SRB,2002.0,4,3,1
IRL,SRB,2009.0,2,1,1
QAT,EGY,2004.0,1,5,-4
SVK,SLV,2004.0,1,3,-2
SLV,SVK,2006.0,4,1,3
LUX,FRA,1997.0,3,4,-1
CHE,BOL,2016.0,1,1,0
BEL,BLR,2006.0,3,4,-1
DEU,LTU,2006.0,2,8,-6
ITA,CUB,2001.0,4,7,-3
SAU,GRC,2014.0,1,5,-4
BEL,TUN,2002.0,3,2,1
ITA,GEO,1999.0,1,1,0
CRI,FRA,2007.0,2,2,0
USA,MWI,2010.0,7,5,2
AZE,RUS,2012.0,1,9,-8
GBR,MAR,2003.0,1,2,-1
DNK,MEX,1999.0,1,2,-1
COG,COD,1997.0,3,1,2
SVN,CAN,2002.0,1,2,-1
PNG,GIN,2000.0,1,1,0
BWA,TZA,2021.0,1,2,-1
RUS,ARM,1998.0,5,11,-6
NGA,SAU,1997.0,1,3,-2
TZA,CHE,2010.0,1,2,-1
EGY,AUT,2000.0,1,2,-1
AZE,USA,2011.0,1,3,-2
NZL,BEL,2004.0,1,2,-1
NZL,NCL,2016.0,1,1,0
NZL,NOR,2000.0,2,1,1
NZL,LUX,2011.0,1,1,0
KOR,PRT,2014.0,2,7,-5
VEN,BEL,2014.0,1,1,0
BHR,ZAF,2004.0,1,2,-1
GBR,SHN,2021.0,1,3,-2
COD,USA,2010.0,2,1,1
AUS,HRV,2016.0,1,2,-1
IND,SRB,2016.0,1,1,0
ROU,AUT,2022.0,3,3,0
HUN,HKG,2018.0,1,1,0
USA,BFA,2007.0,2,2,0
TTO,CAN,2013.0,4,4,0
GRC,DNK,2007.0,8,1,7
SWE,ZAF,2006.0,2,5,-3
PAK,TUR,1998.0,1,1,0
UKR,NLD,2008.0,2,3,-1
CAN,LUX,2015.0,2,2,0
BEL,HKG,2010.0,2,1,1
GBR,CRI,2012.0,3,2,1
DEU,NGA,2014.0,8,9,-1
COL,KEN,2010.0,1,1,0
RUS,IRQ,2010.0,1,1,0
PRT,TUN,2012.0,2,1,1
BHR,SAU,2010.0,1,3,-2
SRB,DNK,2004.0,1,5,-4
TUR,ZAF,2007.0,1,1,0
VEN,VNM,2018.0,2,3,-1
CAN,LUX,2008.0,2,1,1
SWE,KOR,2007.0,2,4,-2
THA,GAB,2009.0,1,2,-1
NLD,SRB,2016.0,3,5,-2
CAN,BWA,2010.0,1,1,0
BGR,JPN,2013.0,3,5,-2
SGP,FIN,2017.0,1,6,-5
MLI,BEL,2017.0,1,1,0
ARE,LBN,2022.0,3,20,-17
BWA,DEU,2015.0,2,3,-1
NLD,SVN,2021.0,5,4,1
ESP,VNM,2016.0,1,2,-1
USA,GIN,2016.0,5,2,3
ARE,IRL,2021.0,3,7,-4
BOL,USA,2006.0,2,5,-3
LBR,USA,2016.0,3,7,-4
ARE,CHE,2016.0,3,5,-2
SRB,CAN,2013.0,3,3,0
MYS,MMR,2019.0,2,1,1
NLD,CUB,2021.0,4,1,3
ECU,BOL,2018.0,1,4,-3
NLD,EST,2019.0,4,3,1
CHN,NAM,2019.0,2,1,1
SRB,CZE,2022.0,7,3,4
FRA,UKR,2021.0,5,8,-3
USA,CAF,2009.0,1,1,0
NGA,ETH,2021.0,3,3,0
MWI,CHN,2019.0,2,5,-3
JOR,JPN,2020.0,1,2,-1
PAK,BRA,2023.0,3,2,1
USA,DMA,2020.0,1,3,-2
NLD,ETH,2023.0,1,5,-4
PAK,DNK,2013.0,2,1,1
NZL,FJI,2015.0,2,2,0
DNK,BRN,2014.0,1,1,0
ESP,KEN,2021.0,1,2,-1
EGY,LBN,2023.0,2,3,-1
LVA,LTU,2022.0,3,7,-4
SWE,EGY,2023.0,3,5,-2
DZA,MEX,2023.0,1,1,0
BHR,SAU,2023.0,4,5,-1
NIC,HND,2020.0,1,1,0
LKA,IND,2005.0,2,4,-2
KWT,IRQ,2020.0,1,1,0
SGP,BGD,2007.0,1,2,-1
KOR,NPL,2010.0,2,3,-1
MKD,BGR,2012.0,1,3,-2
CAN,CHL,1997.0,2,2,0
ITA,NZL,2004.0,1,1,0
GHA,CAN,2010.0,3,1,2
BWA,DEU,2014.0,1,1,0
CIV,SEN,2007.0,1,1,0
RWA,NLD,2014.0,2,3,-1
FRA,ESP,2024.0,1,7,-6
KEN,ITA,2010.0,1,1,0
MEX,CZE,2013.0,3,2,1
SWE,ROU,2009.0,2,1,1
GHA,ZAF,2008.0,1,2,-1
LBN,SYR,2009.0,1,1,0
MEX,SWE,2005.0,1,4,-3
NOR,EST,2013.0,3,2,1
JPN,ISR,2009.0,6,9,-3
POL,MEX,2007.0,3,2,1
GRC,EGY,2007.0,1,1,0
SGP,DNK,2010.0,3,4,-1
GBR,KNA,2018.0,2,1,1
COL,RUS,2006.0,1,3,-2
DEU,DZA,2006.0,2,3,-1
BGR,SWE,2005.0,2,3,-1
IRQ,CHN,2010.0,2,5,-3
BRA,NGA,2020.0,2,8,-6
IRN,UZB,2022.0,1,1,0
CHE,PHL,2010.0,3,3,0
HKG,IDN,2020.0,1,2,-1
ESP,RUS,2022.0,7,25,-18
IRQ,ROU,2017.0,2,4,-2
BRN,NGA,2018.0,1,1,0
SEN,MLI,2000.0,1,2,-1
BEN,BEL,2017.0,3,5,-2
SVN,IND,2007.0,1,1,0
FIN,NZL,2011.0,2,2,0
BLR,SVK,2001.0,1,1,0
DNK,HUN,2003.0,9,4,5
USA,BOL,2004.0,2,6,-4
JPN,ARE,2013.0,5,1,4
HKG,RUS,2004.0,1,3,-2
USA,NIC,1997.0,1,1,0
IRN,EGY,2013.0,6,3,3
ZAF,JPN,1997.0,2,2,0
HRV,GBR,1997.0,3,3,0
PRT,SRB,2021.0,2,3,-1
USA,HND,2001.0,3,1,2
SWE,KWT,2011.0,1,1,0
PAK,ITA,2002.0,2,3,-1
KEN,NLD,1999.0,1,3,-2
LKA,OMN,2015.0,1,2,-1
NOR,TUR,1999.0,1,5,-4
MYS,NZL,2002.0,3,1,2
TUN,ITA,2006.0,1,2,-1
HKG,GRC,2012.0,1,1,0
MYS,MMR,2011.0,1,1,0
MWI,FRA,2020.0,3,4,-1
USA,BHR,2014.0,1,3,-2
MNG,USA,2012.0,2,4,-2
GBR,KWT,2005.0,7,4,3
MEX,IRL,2014.0,1,4,-3
TZA,BEL,2007.0,2,1,1
ESP,MOZ,2015.0,3,1,2
ITA,VAT,2016.0,1,1,0
PER,COL,2015.0,3,4,-1
CHE,EST,2018.0,3,4,-1
KHM,MYS,2018.0,1,2,-1
BGD,VNM,2020.0,1,3,-2
PAN,BRA,2010.0,2,1,1
ARE,ITA,2011.0,1,2,-1
FRA,MYS,2001.0,2,1,1
LUX,ESP,2021.0,1,15,-14
ARE,PRT,2018.0,1,5,-4
PHL,MYS,2015.0,1,2,-1
GBR,MDG,2022.0,4,1,3
GHA,CMR,2018.0,1,2,-1
EGY,SYR,2015.0,1,3,-2
FRA,CUB,2021.0,3,8,-5
SVK,CAN,2008.0,1,1,0
MLT,GBR,1997.0,3,2,1
CZE,ROU,2021.0,2,1,1
SWE,TZA,2021.0,7,4,3
MUS,FRA,2020.0,1,2,-1
TUN,BEL,2016.0,2,6,-4
CAN,MLI,2019.0,1,1,0
USA,MLI,2023.0,1,2,-1
ARM,AZE,2021.0,1,1,0
AUS,MWI,2018.0,2,1,1
ESP,PHL,2019.0,2,4,-2
USA,ASM,2015.0,4,4,0
NGA,TWN,2018.0,1,1,0
ITA,SOM,2021.0,1,2,-1
CHE,MMR,2020.0,3,2,1
BEL,KAZ,2023.0,2,4,-2
CZE,BGD,2018.0,2,2,0
ECU,POL,2019.0,1,1,0
IND,MUS,2018.0,2,3,-1
ZMB,JPN,2019.0,5,1,4
IRL,PAK,2010.0,1,2,-1
BEL,SVK,2022.0,1,2,-1
TUR,DNK,2009.0,1,2,-1
SRB,PRT,2021.0,3,2,1
MEX,NLD,1997.0,6,3,3
LBY,TUR,2022.0,1,3,-2
JOR,PRT,2021.0,1,1,0
USA,ISR,2024.0,3,5,-2
FRA,PHL,2022.0,1,2,-1
DNK,PER,2021.0,1,1,0
NLD,MWI,2007.0,1,1,0
COG,NLD,2020.0,1,1,0
NOR,MMR,2017.0,1,1,0
UZB,RUS,2012.0,1,6,-5
CHN,HRV,2021.0,2,1,1
JPN,GHA,1999.0,1,6,-5
ISL,FIN,2020.0,1,2,-1
JPN,PER,2018.0,4,1,3
SWE,ETH,2023.0,3,1,2
KWT,CHN,2023.0,1,2,-1
NOR,MEX,2020.0,1,3,-2
TZA,IND,2019.0,2,3,-1
LAO,USA,2010.0,1,1,0
USA,DOM,2020.0,6,7,-1
BEL,MAR,2014.0,2,5,-3
HRV,BEL,2010.0,1,2,-1
BGD,IDN,2017.0,2,1,1
CHE,DZA,2005.0,1,2,-1
BGR,GRC,2012.0,1,3,-2
SVN,HRV,1997.0,1,1,0
USA,NIC,2005.0,1,2,-1
SVK,JPN,2012.0,1,1,0
EGY,ZAF,2020.0,1,2,-1
NLD,CHL,2007.0,1,2,-1
SYR,SAU,2018.0,1,3,-2
NGA,NER,2012.0,4,14,-10
UGA,NGA,2016.0,1,2,-1
GRC,MLT,2015.0,1,1,0
BWA,MWI,2006.0,1,1,0
FIN,UKR,2003.0,1,2,-1
PRT,CUB,2013.0,2,2,0
USA,MNG,2004.0,1,1,0
AND,ESP,2017.0,2,5,-3
AUS,MUS,2007.0,1,1,0
BRA,BGR,2010.0,1,1,0
SVN,SWE,2007.0,1,2,-1
ROU,CZE,2012.0,1,2,-1
COG,COD,2005.0,4,4,0
NOR,LTU,2011.0,1,2,-1
EGY,ISR,2011.0,1,1,0
NLD,ZWE,2013.0,2,3,-1
OMN,ESP,2022.0,2,1,1
JPN,MNG,2007.0,2,3,-1
TWN,NZL,2011.0,1,4,-3
ISR,MEX,2009.0,1,3,-2
BGR,POL,2009.0,1,1,0
PRI,AUS,2005.0,1,3,-2
VEN,URY,2019.0,4,1,3
SYR,GBR,2006.0,1,2,-1
TWN,UKR,2015.0,1,2,-1
GRC,SGP,2010.0,1,1,0
SGP,GRC,2013.0,2,3,-1
BEL,LKA,2004.0,1,1,0
JOR,TUN,2015.0,1,2,-1
NOR,GRL,2016.0,1,1,0
SWE,TWN,2019.0,4,5,-1
UZB,DEU,2008.0,3,1,2
SAU,TWN,2020.0,6,6,0
KOR,NLD,2005.0,1,7,-6
NZL,IDN,2008.0,2,1,1
HKG,PRT,2009.0,1,1,0
UGA,RWA,2013.0,1,1,0
CHE,PAK,1998.0,1,1,0
PAN,AUS,2014.0,1,2,-1
SDN,GBR,2011.0,1,5,-4
ARE,ESP,2023.0,3,4,-1
EGY,NLD,2017.0,5,3,2
DZA,QAT,2021.0,4,1,3
IDN,BEL,2021.0,4,11,-7
TUR,KOR,2018.0,3,3,0
MDA,CZE,2020.0,1,1,0
CZE,KAZ,2020.0,2,2,0
USA,LBR,2018.0,9,10,-1
PRT,AUT,2019.0,4,4,0
BWA,UGA,2020.0,3,1,2
MKD,DEU,2005.0,1,1,0
ESP,PER,2003.0,2,4,-2
ROU,NLD,2016.0,1,6,-5
KGZ,KAZ,2019.0,5,4,1
NLD,TZA,2021.0,5,5,0
ZAF,PAK,2013.0,4,2,2
PER,DNK,2021.0,1,1,0
ISR,ZAF,2021.0,2,1,1
JPN,DNK,2009.0,14,9,5
POL,AUT,2022.0,5,9,-4
ITA,GEO,2022.0,1,1,0
GRC,NOR,2023.0,4,1,3
LKA,HKG,2023.0,2,1,1
GBR,UKR,2000.0,3,21,-18
ISR,AUT,2004.0,3,1,2
ECU,USA,1998.0,4,2,2
BWA,IND,2009.0,2,1,1
FRA,CRI,2008.0,1,3,-2
CRI,COL,2012.0,2,1,1
PER,CHL,2003.0,3,1,2
SAU,SYR,2009.0,1,2,-1
ZWE,ZMB,2019.0,5,4,1
BGD,BEL,2001.0,5,1,4
NLD,GHA,2006.0,1,4,-3
TUR,EGY,2009.0,1,2,-1
BLR,FRA,1997.0,1,1,0
DNK,TUR,2006.0,1,1,0
PHL,KOR,2003.0,2,3,-1
PAK,FRA,1998.0,1,2,-1
ARE,DZA,2021.0,1,4,-3
RUS,ZAF,2019.0,4,6,-2
ZAF,IRL,2014.0,2,11,-9
ZAF,LSO,2004.0,3,1,2
AUT,BIH,2007.0,2,1,1
AUT,PRT,2006.0,1,3,-2
FRA,NER,2012.0,9,3,6
OMN,CAN,2009.0,2,9,-7
JPN,MEX,2010.0,4,5,-1
ISL,DEU,2019.0,3,6,-3
JPN,TZA,1999.0,4,2,2
OMN,FRA,2010.0,2,1,1
CIV,ZAF,2022.0,2,3,-1
BFA,COG,2019.0,1,4,-3
PHL,THA,2001.0,2,1,1
THA,PHL,2004.0,2,2,0
LBY,ARE,2021.0,1,1,0
ISR,CZE,2001.0,2,3,-1
MEX,GTM,2002.0,2,1,1
ITA,QAT,2014.0,2,2,0
MYS,CYM,2022.0,1,1,0
TUR,DNK,2004.0,2,3,-1
FRA,SVK,2023.0,2,2,0
CAN,PHL,2013.0,4,4,0
USA,BRN,2012.0,2,1,1
ESP,UKR,2017.0,2,2,0
GHA,NLD,2010.0,4,2,2
GMB,USA,2003.0,1,3,-2
ZAF,MMR,2020.0,1,1,0
GRC,POL,2006.0,2,3,-1
CUB,BEL,1999.0,1,1,0
DEU,NPL,2009.0,3,2,1
TUR,AUT,2000.0,3,1,2
TUR,GRC,2007.0,3,3,0
UKR,TWN,2015.0,2,1,1
ISL,AUT,2019.0,1,1,0
GRL,DNK,2004.0,4,7,-3
AUS,NPL,2005.0,1,1,0
NIC,BEL,2007.0,1,2,-1
USA,ECU,2005.0,5,8,-3
ITA,LBN,2021.0,4,5,-1
SAU,BEL,2017.0,2,7,-5
PAN,BRA,2003.0,1,2,-1
KNA,GBR,2018.0,1,2,-1
GBR,KNA,2020.0,3,1,2
BEL,PRT,1998.0,1,1,0
OMN,JOR,2009.0,2,2,0
BWA,CAN,2014.0,3,1,2
KOR,OMN,2017.0,3,2,1
IRQ,TUR,2014.0,1,3,-2
IND,RUS,2015.0,3,2,1
QAT,ITA,2019.0,2,8,-6
IRQ,DEU,2018.0,1,17,-16
LKA,CHN,2011.0,2,3,-1
TUR,RUS,2018.0,2,2,0
BHR,PAK,2023.0,1,5,-4
CHE,MWI,2020.0,1,1,0
MCO,DEU,2008.0,1,1,0
LVA,JPN,2023.0,1,1,0
GHA,KEN,2020.0,2,9,-7
EGY,MYS,2014.0,7,5,2
EGY,QAT,2023.0,4,4,0
SGP,BEL,2013.0,3,3,0
PRT,NOR,2003.0,2,2,0
BRA,SVN,2019.0,3,2,1
HUN,SVN,2016.0,1,1,0
AUT,BIH,2020.0,4,2,2
DOM,USA,2022.0,4,7,-3
CUB,ITA,2016.0,4,3,1
NZL,CHL,2010.0,2,1,1
NOR,NZL,2020.0,4,4,0
DNK,IRN,2017.0,4,16,-12
ITA,GHA,2019.0,3,2,1
SEN,DEU,2002.0,1,1,0
CZE,LUX,2016.0,1,1,0
PRT,ARG,2013.0,4,1,3
FIN,PAK,2017.0,3,8,-5
DEU,HKG,2012.0,8,15,-7
DNK,GRC,2005.0,2,6,-4
PER,MEX,2002.0,1,2,-1
BOL,DNK,2018.0,1,1,0
FRA,NGA,2022.0,6,6,0
EST,ESP,2022.0,5,7,-2
GTM,FRA,2016.0,1,1,0
UGA,NGA,2020.0,5,6,-1
LBY,GBR,2023.0,1,2,-1
ARE,IRN,2017.0,3,3,0
SVN,POL,2004.0,1,1,0
NOR,ISR,2020.0,5,1,4
LKA,SWE,2021.0,3,2,1
FJI,TON,2019.0,1,1,0
SWE,PAK,2020.0,7,13,-6
DEU,KWT,2006.0,2,1,1
MUS,CHE,2017.0,1,1,0
NZL,GHA,2022.0,2,1,1
UGA,COL,2023.0,1,1,0
FIN,LTU,2020.0,5,1,4
MEX,ISR,2018.0,6,1,5
NZL,FJI,2011.0,1,3,-2
IDN,PRT,2022.0,2,2,0
ZWE,AUS,2023.0,1,1,0
SGP,SAU,2019.0,4,7,-3
QAT,ESP,2023.0,1,2,-1
UGA,BRA,2021.0,1,1,0
OMN,PAK,2023.0,7,12,-5
BEN,BEL,2020.0,1,6,-5
BHR,EGY,2020.0,3,1,2
HKG,BEL,2021.0,3,1,2
NOR,IDN,2022.0,3,3,0
NOR,JPN,2023.0,4,6,-2
RWA,KOR,2022.0,1,5,-4
BHR,USA,2023.0,5,4,1
IRN,FRA,2004.0,3,15,-12
LBY,EGY,2012.0,3,5,-2
AUS,BTN,2017.0,2,9,-7
UGA,CMR,2022.0,1,2,-1
ESP,EST,2023.0,4,4,0
JOR,KWT,2023.0,3,3,0
CUB,CHL,2005.0,2,1,1
ISR,NOR,2015.0,1,5,-4
USA,BRB,2000.0,2,2,0
TWN,MYS,2012.0,3,2,1
PNG,GBR,2005.0,1,1,0
BRB,USA,2009.0,2,1,1
IND,BHR,2004.0,1,2,-1
BHR,IND,2010.0,2,3,-1
FIN,JPN,2008.0,8,13,-5
NZL,BRA,2008.0,3,1,2
NOR,KWT,2008.0,1,1,0
ISR,HUN,2023.0,2,1,1
NZL,HUN,2016.0,1,2,-1
TTO,GBR,2006.0,2,8,-6
FRA,LUX,2000.0,1,3,-2
TUR,UKR,2000.0,2,7,-5
LKA,SWE,2009.0,1,1,0
JPN,UKR,2020.0,2,3,-1
SGP,IND,1999.0,4,19,-15
MYS,LBY,2017.0,8,2,6
BWA,ZWE,2013.0,1,2,-1
POL,AUS,2013.0,12,8,4
USA,ASM,2021.0,2,2,0
BEL,CUB,2023.0,3,2,1
CRI,CAN,2012.0,6,3,3
CAN,PSE,2014.0,2,1,1
PSE,QAT,2019.0,1,2,-1
CMR,ITA,2012.0,5,2,3
ITA,CMR,2014.0,4,2,2
HKG,FIN,2013.0,1,1,0
RUS,LVA,2016.0,3,3,0
LKA,NLD,2017.0,1,2,-1
COD,LAO,2013.0,2,2,0
CYM,USA,2013.0,2,1,1
GBR,ZMB,2012.0,6,2,4
DEU,MDG,2019.0,4,1,3
TWN,TUR,2019.0,1,5,-4
LTU,EST,2018.0,1,5,-4
POL,ROU,2016.0,2,3,-1
DEU,CRI,2010.0,2,4,-2
ITA,LTU,2021.0,6,7,-1
KEN,QAT,2014.0,1,1,0
SAU,IDN,2016.0,3,4,-1
PAK,CHE,2015.0,2,2,0
ARG,KOR,2021.0,2,1,1
YEM,CHN,2019.0,2,1,1
NLD,BEN,2015.0,2,1,1
CZE,HRV,2016.0,1,7,-6
KEN,ZAF,2003.0,6,7,-1
EGY,CZE,2018.0,1,4,-3
UKR,KOR,2021.0,3,1,2
ITA,COL,2000.0,1,1,0
SGP,PHL,2022.0,3,5,-2
RUS,ROU,2020.0,3,3,0
CAN,NCL,2018.0,1,2,-1
POL,PRT,2022.0,1,3,-2
IND,CMR,2020.0,3,4,-1
CAN,PSE,2015.0,2,1,1
GRC,CAN,2023.0,5,4,1
CHE,GHA,2018.0,5,2,3
KEN,HUN,2022.0,1,3,-2
MWI,ZWE,2022.0,1,1,0
GUY,FRA,2020.0,1,1,0
AUT,MEX,2023.0,3,1,2
KEN,UGA,2023.0,8,8,0
GBR,UKR,2023.0,1,8,-7
AUS,ROU,2003.0,3,2,1
ETH,NLD,2013.0,7,8,-1
TUR,NLD,2004.0,3,3,0
SWZ,ZAF,2002.0,1,3,-2
OMN,FRA,2006.0,1,1,0
ISR,CZE,2004.0,3,1,2
GBR,BGD,2015.0,9,19,-10
SYR,FRA,2015.0,4,9,-5
PER,BRA,2001.0,1,3,-2
CHE,GHA,2016.0,1,2,-1
SVN,CHE,2012.0,3,2,1
EST,DNK,2019.0,3,1,2
THA,PRT,2011.0,2,3,-1
CRI,ESP,2010.0,3,5,-2
HUN,NOR,2013.0,5,3,2
TUN,MAR,2014.0,4,4,0
SLV,SVN,2015.0,2,9,-7
ARG,FIN,2013.0,3,2,1
CZE,EST,2014.0,1,2,-1
GBR,EST,2008.0,8,5,3
SWZ,DEU,2013.0,1,1,0
YEM,AUS,2005.0,1,1,0
LVA,RUS,2020.0,5,3,2
EGY,BEL,2019.0,1,6,-5
KEN,PAK,2017.0,2,3,-1
TUR,PAK,2013.0,3,3,0
SWE,TZA,2015.0,5,2,3
PRI,ESP,2015.0,5,9,-4
IRL,GBR,2024.0,2,1,1
UZB,IND,2014.0,1,1,0
MAC,KOR,2022.0,1,1,0
SAU,IRN,2023.0,2,2,0
VNM,IRN,2023.0,1,1,0
GMB,BEL,2001.0,3,1,2
OMN,DEU,2019.0,2,3,-1
DEU,OMN,2022.0,1,2,-1
DNK,SVN,2015.0,1,5,-4
MWI,CHE,2020.0,1,1,0
AUS,GHA,2016.0,3,17,-14
OMN,TUN,2022.0,1,1,0
IRL,LBY,2011.0,2,2,0
MYS,BRA,2017.0,2,1,1
EST,LVA,2019.0,3,2,1
DEU,GEO,2006.0,2,10,-8
NZL,SYR,2014.0,1,2,-1
EGY,SWE,2016.0,6,6,0
DEU,TUN,2020.0,1,15,-14
BRB,GBR,1998.0,2,2,0
GBR,BRB,2000.0,2,1,1
TWN,NZL,2008.0,1,4,-3
USA,OMN,2021.0,6,7,-1
SRB,NLD,2018.0,1,3,-2
NGA,BEL,2014.0,3,3,0
EGY,ESP,2016.0,8,27,-19
ISR,SRB,2018.0,2,2,0
NOR,THA,2012.0,1,1,0
SVK,POL,2013.0,6,7,-1
BRA,UKR,2008.0,1,1,0
NLD,SVN,2001.0,3,3,0
KWT,IND,2018.0,5,6,-1
RUS,MNG,2016.0,5,2,3
TUR,TUN,2020.0,2,1,1
HKG,THA,2009.0,1,1,0
LUX,CHE,2012.0,4,4,0
EGY,KOR,2010.0,4,9,-5
EST,KOR,2020.0,1,2,-1
PAK,IDN,2020.0,3,2,1
BEL,AUS,1998.0,4,7,-3
TGO,BFA,2006.0,1,1,0
IRQ,SDN,2020.0,1,1,0
ROU,PAK,2016.0,2,2,0
NOR,BGR,2017.0,1,1,0
IND,TWN,1997.0,4,1,3
BHR,MYS,2014.0,2,3,-1
BEL,GMB,2001.0,1,3,-2
VNM,KOR,2024.0,2,2,0
BTN,JPN,2020.0,1,1,0
MDG,ITA,2001.0,2,2,0
ROU,ZAF,2012.0,2,1,1
ZAF,TZA,2008.0,4,4,0
NCL,CAN,2009.0,5,1,4
AUT,HRV,2001.0,2,7,-5
IND,MMR,2006.0,1,1,0
COG,ZWE,2005.0,1,2,-1
NLD,CMR,2004.0,1,1,0
CMR,NLD,2008.0,1,3,-2
NIC,MEX,2009.0,1,2,-1
AUT,FIN,2007.0,3,1,2
ITA,IRL,2006.0,9,8,1
ARG,CHE,2009.0,2,3,-1
UGA,ITA,1998.0,1,1,0
LKA,CAN,2005.0,1,4,-3
USA,MCO,2001.0,3,2,1
TGO,BFA,2010.0,1,1,0
KAZ,CZE,2000.0,2,1,1
NZL,THA,2004.0,1,2,-1
JAM,GBR,2005.0,3,2,1
AUS,HRV,1998.0,2,1,1
SAU,FIN,2012.0,2,2,0
THA,KHM,2007.0,1,1,0
BRA,SRB,2002.0,3,1,2
SWE,SAU,2008.0,4,2,2
ESP,BOL,2014.0,1,1,0
PAK,KWT,2010.0,1,1,0
BEL,KEN,2013.0,3,2,1
CHN,AFG,2019.0,1,1,0
JPN,UGA,2010.0,1,1,0
CHE,TUR,2004.0,3,6,-3
SVN,FIN,2012.0,1,1,0
THA,BEL,2006.0,2,3,-1
CHN,GRC,2020.0,4,8,-4
CHL,BEL,2009.0,3,6,-3
NZL,ITA,2002.0,3,4,-1
PSE,FRA,2009.0,1,4,-3
CHL,URY,2019.0,2,2,0
IRL,HKG,2005.0,1,1,0
KOR,DNK,2012.0,5,3,2
SRB,HUN,2014.0,3,1,2
YEM,GBR,2019.0,1,1,0
NLD,UKR,2022.0,1,2,-1
FRA,VEN,2020.0,6,2,4
CHN,POL,2013.0,3,3,0
MYS,VNM,2016.0,2,1,1
PER,GBR,2009.0,3,1,2
EGY,BHR,2003.0,1,1,0
AUS,MUS,2017.0,3,1,2
LBN,CHE,2011.0,1,1,0
COL,JPN,2009.0,3,1,2
MYS,SGP,1997.0,1,2,-1
NLD,BEL,2024.0,1,2,-1
FIN,BEL,2013.0,4,2,2
FRA,ARM,2008.0,1,1,0
SGP,LKA,2013.0,1,1,0
KEN,COG,2016.0,1,1,0
BLR,GBR,2013.0,1,1,0
UGA,COG,2007.0,1,1,0
AZE,IRN,2007.0,1,1,0
URY,SWE,2020.0,1,2,-1
PAK,KEN,2021.0,1,3,-2
PSE,MYS,2010.0,3,1,2
SYR,DEU,2014.0,4,3,1
ZAF,ZWE,2006.0,3,16,-13
FRA,ALB,2015.0,3,2,1
BGD,SAU,2002.0,2,1,1
BGD,MYS,2006.0,4,5,-1
BRA,CUB,2008.0,4,6,-2
SAU,IND,1997.0,3,8,-5
IRQ,SAU,2021.0,1,2,-1
ARG,NZL,2007.0,1,1,0
UGA,DEU,2004.0,2,2,0
SYC,USA,2014.0,1,2,-1
CAN,GUY,2013.0,1,1,0
PHL,FRA,2016.0,3,5,-2
CHE,COD,2022.0,2,4,-2
GBR,SVK,2022.0,2,3,-1
NGA,HKG,2020.0,3,2,1
MEX,IRL,2019.0,3,1,2
JOR,POL,2019.0,1,1,0
LAO,THA,2023.0,2,4,-2
BIH,DEU,2010.0,2,3,-1
EST,CHE,1999.0,1,2,-1
ARE,ROU,2017.0,2,3,-1
FRA,KEN,2005.0,1,1,0
DEU,GEO,2000.0,2,4,-2
IDN,NLD,2014.0,8,31,-23
COL,CUB,2013.0,1,7,-6
ESP,CHN,2004.0,5,1,4
FIN,UKR,2000.0,2,4,-2
TUR,ROU,2022.0,4,3,1
ZAF,ITA,1999.0,2,2,0
RUS,TUR,2010.0,1,2,-1
LVA,USA,2003.0,1,3,-2
DNK,FIN,2000.0,5,7,-2
EGY,ARE,1998.0,4,3,1
CAN,VEN,2010.0,2,7,-5
KEN,ETH,2004.0,3,1,2
FIN,ZAF,2014.0,6,2,4
JAM,CAN,2019.0,3,5,-2
FIN,FRA,2003.0,8,8,0
NZL,DNK,2001.0,3,5,-2
CHN,GRC,1999.0,1,1,0
AUS,HRV,2007.0,1,1,0
SWE,MEX,2001.0,4,1,3
UKR,AUT,2001.0,2,2,0
JPN,TUR,2001.0,5,7,-2
RUS,IRL,2000.0,1,1,0
ROU,IRL,2003.0,1,1,0
CIV,USA,1999.0,2,3,-1
TUR,EGY,2021.0,6,2,4
CHE,COL,1998.0,1,1,0
USA,CIV,2018.0,5,2,3
BRA,CHN,2007.0,1,2,-1
GBR,MUS,2011.0,3,2,1
AUT,ROU,2002.0,1,4,-3
DMA,USA,2010.0,1,1,0
CZE,ROU,2008.0,2,2,0
CAN,JAM,2005.0,2,1,1
MEX,ISR,2017.0,5,3,2
GBR,CIV,2015.0,4,2,2
BLR,LTU,2019.0,1,2,-1
DEU,GAB,2016.0,4,11,-7
BLZ,USA,2015.0,3,1,2
PRY,ESP,2004.0,1,3,-2
EGY,CHE,2008.0,1,4,-3
SRB,MNE,2012.0,5,3,2
UGA,SWE,2008.0,3,3,0
OMN,NZL,2015.0,1,2,-1
NZL,GRC,2014.0,1,1,0
SDN,ZAF,2015.0,1,1,0
IRN,RUS,2009.0,1,4,-3
BLR,UKR,2010.0,2,6,-4
LKA,SGP,2020.0,2,1,1
IND,KAZ,2020.0,2,2,0
ESP,TUN,2010.0,3,5,-2
CHE,LBN,2015.0,2,2,0
BRA,NZL,2006.0,3,1,2
NZL,VUT,2016.0,1,1,0
DEU,MCO,2019.0,3,1,2
QAT,SGP,2022.0,2,3,-1
HTI,FRA,2013.0,1,1,0
HKG,DEU,2010.0,5,12,-7
MEX,POL,2011.0,2,3,-1
LBY,CAN,2023.0,1,2,-1
LAO,GBR,2014.0,1,4,-3
SAU,ETH,2018.0,1,1,0
LKA,JPN,2012.0,3,8,-5
KWT,CAN,2011.0,1,13,-12
DNK,BGR,2005.0,1,1,0
DEU,NGA,2009.0,6,4,2
SWE,MLI,2011.0,1,2,-1
COL,VEN,2002.0,4,4,0
POL,LTU,2020.0,1,5,-4
LVA,DEU,2003.0,5,3,2
USA,UZB,2010.0,1,2,-1
LKA,CHN,2019.0,4,6,-2
IND,CHN,2004.0,7,2,5
SAU,YEM,2013.0,2,4,-2
UKR,KAZ,2018.0,1,2,-1
POL,BEL,2023.0,3,8,-5
BEL,SEN,2009.0,2,2,0
USA,ALB,2016.0,5,3,2
CUB,BEL,2020.0,4,6,-2
CZE,SRB,2020.0,3,5,-2
SGP,HUN,2019.0,2,2,0
KOR,CZE,2023.0,2,2,0
CMR,CIV,2021.0,2,1,1
IDN,ESP,2022.0,3,2,1
FIN,PAK,2022.0,1,3,-2
JPN,LKA,2007.0,4,3,1
USA,KNA,2009.0,2,2,0
ISL,AUS,2016.0,2,1,1
DEU,OMN,2018.0,3,3,0
TUN,BEL,1999.0,1,2,-1
SVN,DEU,1998.0,3,4,-1
CHE,KOR,2001.0,2,6,-4
DEU,CRI,2006.0,3,1,2
LKA,DEU,2023.0,2,1,1
IRL,ARG,2005.0,1,1,0
GMB,BEL,2014.0,1,1,0
TZA,CHE,2013.0,2,2,0
GNQ,ESP,2003.0,1,1,0
SVK,ESP,2001.0,2,1,1
MYS,CAN,2005.0,6,1,5
RUS,HKG,2012.0,1,3,-2
FRA,KHM,2007.0,1,1,0
USA,KAZ,2002.0,1,2,-1
THA,VNM,2005.0,1,1,0
SWE,VEN,2001.0,1,2,-1
GBR,NPL,2003.0,3,3,0
PRT,NLD,2007.0,8,19,-11
ZWE,SWE,2019.0,1,2,-1
COL,SWE,2005.0,2,1,1
BGD,ZAF,2018.0,1,1,0
EGY,OMN,2014.0,6,4,2
LVA,USA,2013.0,1,2,-1
HUN,AUS,2017.0,5,3,2
THA,MYS,2009.0,3,4,-1
BEL,PSE,2013.0,1,1,0
HUN,HRV,2014.0,4,2,2
CHL,FIN,2017.0,1,5,-4
BHR,SAU,2013.0,2,3,-1
SWE,CYP,2019.0,3,1,2
MEX,ARE,2021.0,3,1,2
SRB,TUR,2014.0,3,10,-7
SVK,CHE,2019.0,4,7,-3
COG,FRA,2017.0,4,6,-2
PRT,CPV,2015.0,3,1,2
IND,PRT,2000.0,4,2,2
PRT,COL,2017.0,3,3,0
IND,SRB,2020.0,1,1,0
AFG,CHN,2019.0,1,1,0
SVK,BEL,1998.0,1,1,0
LBN,DEU,2009.0,4,1,3
NZL,IND,2009.0,3,8,-5
SAU,NOR,2022.0,2,3,-1
YEM,USA,1998.0,1,1,0
ARE,IDN,2021.0,1,1,0
CZE,POL,2008.0,3,4,-1
ISR,HUN,2010.0,2,3,-1
SRB,HUN,2001.0,1,3,-2
AUT,POL,1997.0,8,3,5
PRT,THA,2011.0,3,2,1
ITA,MAR,2012.0,5,2,3
SEN,USA,2004.0,1,2,-1
IND,ERI,2009.0,2,3,-1
AUS,SVN,2009.0,1,2,-1
CZE,BLR,2021.0,1,1,0
IDN,IND,2000.0,4,3,1
CUB,GBR,2007.0,2,1,1
FIN,BRA,2005.0,1,2,-1
SYR,GBR,2013.0,5,9,-4
AZE,DEU,2013.0,2,2,0
NOR,NAM,2005.0,1,1,0
SWE,NGA,2003.0,1,1,0
IRL,PAK,2013.0,4,4,0
SWE,TUR,2005.0,6,2,4
LTU,GBR,2003.0,4,3,1
GBR,CMR,2001.0,3,2,1
SWE,MYS,2005.0,1,1,0
PSE,CAN,2015.0,1,2,-1
BEL,PRT,1999.0,3,1,2
TTO,GBR,2023.0,4,3,1
USA,PSE,2008.0,2,5,-3
ESP,ZAF,2021.0,6,7,-1
CAN,GEO,2011.0,1,2,-1
CAN,GEO,2019.0,1,1,0
ESP,MOZ,2011.0,3,2,1
ITA,ALB,2008.0,2,1,1
TWN,KOR,1998.0,4,2,2
IND,LBY,2001.0,3,3,0
CHN,ZMB,2017.0,1,1,0
CHN,MAC,2001.0,2,1,1
IND,ARE,1997.0,1,1,0
ZAF,SGP,2005.0,2,1,1
FLK,GBR,2017.0,1,4,-3
NLD,SGP,1999.0,2,1,1
CUB,GBR,1999.0,1,1,0
TWN,DEU,1999.0,7,10,-3
BRA,CHN,1998.0,2,8,-6
PNG,GBR,2012.0,2,1,1
BRA,CHN,1999.0,3,2,1
DEU,JAM,2004.0,1,1,0
CUB,ARG,1998.0,2,2,0
ARG,CUB,2001.0,4,3,1
NLD,BEN,2008.0,1,2,-1
COG,BFA,2017.0,1,3,-2
LUX,GRC,2011.0,1,1,0
ROU,SGP,2004.0,1,1,0
USA,TTO,2007.0,5,3,2
BEL,PER,2007.0,2,4,-2
KNA,ZAF,2022.0,1,1,0
HUN,SRB,2013.0,4,2,2
ZAF,RUS,2006.0,1,4,-3
BRA,BOL,2007.0,1,1,0
CZE,GEO,2010.0,1,1,0
FJI,IND,2005.0,1,2,-1
EGY,QAT,2010.0,3,2,1
TUR,AUS,2009.0,5,2,3
EGY,NLD,2016.0,2,5,-3
DEU,URY,2003.0,4,2,2
MUS,GBR,2003.0,1,2,-1
LUX,NOR,2013.0,2,3,-1
VEN,MEX,2009.0,4,9,-5
IDN,CAN,2004.0,1,2,-1
NZL,IRN,2016.0,1,20,-19
GBR,MDG,1999.0,2,2,0
NOR,ISR,2007.0,2,2,0
SAU,DNK,2015.0,2,3,-1
AUT,CHL,2020.0,5,7,-2
RUS,KGZ,2012.0,2,2,0
NLD,VNM,2010.0,6,1,5
ISL,ITA,2018.0,6,1,5
ITA,PAK,2003.0,1,1,0
HUN,SVN,2017.0,1,1,0
USA,BHR,2021.0,6,2,4
PRI,PRT,2011.0,1,2,-1
LBY,MYS,2017.0,2,8,-6
PHL,NZL,2000.0,2,2,0
CAN,BHS,2020.0,1,2,-1
COL,CHE,2016.0,3,4,-1
NZL,ARE,2017.0,2,1,1
JPN,SDN,2020.0,2,2,0
CHE,LBN,2014.0,1,6,-5
JAM,TTO,2018.0,3,8,-5
HRV,IRL,2016.0,1,4,-3
BGD,IRL,2008.0,1,2,-1
ITA,UGA,2021.0,3,5,-2
ZAF,HUN,2020.0,3,1,2
POL,ISR,2008.0,2,1,1
KHM,AUS,2019.0,2,6,-4
COG,CAF,2015.0,2,1,1
IDN,THA,2014.0,3,8,-5
FRA,NER,2005.0,3,1,2
MEX,JPN,1997.0,2,4,-2
CHN,HUN,2013.0,2,2,0
OMN,EGY,2002.0,3,3,0
DEU,SDN,2021.0,2,2,0
MEX,JPN,2005.0,2,5,-3
BRA,MEX,1999.0,4,7,-3
MEX,CZE,2010.0,2,2,0
CYP,MEX,2016.0,1,1,0
BEL,MEX,2007.0,2,2,0
ISR,BEL,2012.0,2,2,0
DEU,BFA,2014.0,2,1,1
FRA,PER,2023.0,6,2,4
PRY,CHL,2022.0,1,4,-3
ROU,CHN,2021.0,3,1,2
ZAF,PRT,2019.0,3,2,1
USA,AZE,2019.0,1,7,-6
IRL,SAU,2021.0,18,3,15
PRI,IND,2021.0,2,2,0
ISR,KOR,2020.0,6,7,-1
GHA,BEL,2020.0,2,2,0
IRL,PAK,2003.0,2,1,1
SRB,PRT,2015.0,1,1,0
CMR,BEL,2018.0,2,3,-1
SDN,USA,2003.0,1,1,0
TUR,SAU,2023.0,5,5,0
NOR,KOR,2023.0,2,6,-4
DEU,MDG,2021.0,1,1,0
THA,GHA,2019.0,1,1,0
CMR,COG,2018.0,1,2,-1
ARE,NLD,2021.0,3,1,2
BRN,IDN,2011.0,1,1,0
NGA,CMR,2020.0,3,1,2
BWA,CHN,2021.0,1,2,-1
BEL,COL,2022.0,3,7,-4
KAZ,ESP,2019.0,1,1,0
BEL,GMB,2015.0,1,1,0
POL,TWN,2009.0,1,2,-1
KAZ,TUR,2012.0,2,1,1
HUN,PAK,2011.0,2,1,1
KOR,TUR,2022.0,4,10,-6
IRL,POL,2005.0,1,7,-6
SLE,GBR,2019.0,5,4,1
AUT,HRV,2015.0,2,5,-3
FRA,GUF,1997.0,4,5,-1
VNM,NLD,2009.0,2,5,-3
USA,MLT,2015.0,1,1,0
TUN,GBR,2002.0,1,1,0
SWE,PAK,1998.0,2,1,1
BGR,TUR,2004.0,2,1,1
JOR,MYS,2006.0,1,1,0
ITA,UZB,2008.0,1,1,0
COL,AUT,2003.0,1,1,0
AUT,ARG,2002.0,3,1,2
NOR,NZL,2007.0,1,1,0
AUS,TUR,2013.0,6,3,3
NOR,LUX,2021.0,3,1,2
TZA,GBR,2000.0,7,13,-6
BEL,COD,2002.0,1,1,0
UKR,NOR,2008.0,2,1,1
PRT,RUS,2020.0,1,7,-6
RWA,ZWE,2016.0,1,2,-1
DEU,PAK,2000.0,1,5,-4
CHL,KOR,2010.0,1,1,0
IRL,BEL,1999.0,1,3,-2
TZA,BWA,2010.0,1,1,0
TWN,AUT,2003.0,1,1,0
IRN,JPN,2000.0,1,4,-3
ITA,KAZ,2017.0,4,3,1
CZE,BRA,2000.0,1,1,0
DEU,LVA,1997.0,2,2,0
CAN,THA,2000.0,5,5,0
HKG,ESP,2007.0,2,1,1
DNK,VNM,2012.0,4,1,3
SVK,SLV,2011.0,1,8,-7
JPN,ZMB,2015.0,3,1,2
QAT,TUN,2019.0,1,9,-8
SVK,CAN,2019.0,1,1,0
DOM,ESP,2022.0,2,5,-3
DEU,GIN,2022.0,1,1,0
POL,RUS,2011.0,7,13,-6
ROU,CHN,2019.0,3,2,1
IRQ,RUS,2011.0,1,2,-1
PRI,BRA,2021.0,5,2,3
NPL,FIN,2016.0,1,1,0
IND,ERI,2011.0,2,1,1
TUN,PRT,2011.0,2,1,1
DEU,BGD,2008.0,2,4,-2
CAN,MWI,2009.0,1,1,0
DNK,ROU,2013.0,3,4,-1
VNM,SGP,2010.0,3,5,-2
EST,RUS,2001.0,1,3,-2
KOR,SWE,2006.0,1,3,-2
BFA,USA,2007.0,2,2,0
QAT,EGY,2009.0,3,8,-5
CZE,GRC,2018.0,2,9,-7
LBN,DEU,2011.0,1,3,-2
FIN,CHL,2019.0,1,6,-5
COL,CRI,2006.0,1,1,0
BLR,BGR,2009.0,1,2,-1
SVN,CZE,2021.0,3,5,-2
MLI,BEL,2020.0,1,1,0
GRC,ROU,2016.0,2,6,-4
DNK,IDN,2016.0,2,1,1
AUS,KEN,2017.0,5,10,-5
ZAF,ARE,2017.0,1,2,-1
PER,NLD,2023.0,1,1,0
HRV,NOR,2020.0,2,2,0
VNM,SWE,2017.0,2,5,-3
EGY,BGD,2016.0,1,1,0
EGY,IRN,2014.0,2,2,0
IRQ,DEU,2017.0,2,7,-5
TZA,GBR,2023.0,7,7,0
USA,GNQ,2020.0,1,1,0
SHN,GBR,2021.0,3,1,2
AUS,HRV,2020.0,1,2,-1
MLT,ITA,2023.0,1,4,-3
ETH,MYS,2022.0,1,1,0
FIN,LVA,2021.0,1,1,0
QAT,NOR,2023.0,1,2,-1
AUS,BTN,2022.0,4,4,0
KOR,OMN,2022.0,2,2,0
IRN,THA,2020.0,3,1,2
NOR,BIH,2021.0,1,2,-1
NOR,FRO,2020.0,1,2,-1
CHE,BGR,2023.0,3,2,1
IRN,UKR,2020.0,2,2,0
JOR,NZL,2008.0,2,1,1
IDN,TUR,2022.0,3,2,1
DNK,CHL,2009.0,1,3,-2
NER,BEL,2016.0,1,1,0
PER,ECU,2014.0,1,1,0
QAT,BEL,2019.0,2,1,1
IND,ARG,2011.0,1,2,-1
PAK,IRQ,2023.0,3,2,1
NZL,ITA,2005.0,2,1,1
BWA,ETH,2023.0,1,3,-2
KOR,EGY,2013.0,4,11,-7
NLD,VEN,2012.0,1,1,0
MKD,USA,2008.0,2,1,1
LUX,ITA,2004.0,1,1,0
DNK,TWN,2003.0,1,1,0
ISR,IRN,2010.0,1,4,-3
NGA,GMB,2007.0,1,2,-1
KAZ,JPN,2009.0,2,1,1
ZAF,SWE,2010.0,5,6,-1
LTU,FRA,2003.0,3,3,0
BRA,PRI,2008.0,1,1,0
AUS,SAU,2024.0,1,1,0
BVT,BRA,2020.0,2,1,1
FJI,GBR,2021.0,2,2,0
BGD,NGA,2021.0,1,2,-1
DZA,HUN,2022.0,1,1,0
LBY,ARE,2011.0,1,1,0
ITA,BGR,2022.0,3,2,1
DNK,ROU,2003.0,1,2,-1
NLD,TWN,2000.0,2,1,1
ESP,PAN,2006.0,1,1,0
PHL,MEX,2018.0,1,2,-1
ARE,IRL,2015.0,1,2,-1
AUT,NGA,2019.0,1,1,0
DNK,ZAF,1999.0,1,1,0
SVK,PRT,2002.0,1,1,0
ZAF,ARG,2003.0,2,1,1
NZL,TTO,2010.0,1,1,0
HUN,ROU,2003.0,5,3,2
DEU,CMR,1998.0,1,1,0
LTU,RUS,2008.0,1,2,-1
MEX,IRL,2009.0,4,2,2
CHL,JPN,2007.0,1,6,-5
VEN,SWE,2003.0,1,2,-1
NZL,BHR,2019.0,1,2,-1
UGA,CHE,2014.0,2,3,-1
USA,GRD,2004.0,3,1,2
ISR,ARG,2015.0,1,2,-1
SWE,KWT,2014.0,1,1,0
JPN,BLR,1997.0,2,2,0
BGD,MEX,2018.0,2,1,1
ISR,FIN,2009.0,2,1,1
SWE,ROU,2014.0,5,3,2
DMA,DOM,2017.0,1,2,-1
CHE,EGY,2000.0,1,1,0
JPN,COL,2016.0,2,1,1
ROU,JPN,2009.0,1,7,-6
ZAF,ARE,2016.0,2,1,1
EGY,CHE,2015.0,2,2,0
MDG,GBR,2013.0,1,1,0
SRB,GRC,2003.0,1,7,-6
ARE,IRQ,2014.0,1,1,0
NOR,HRV,2014.0,1,1,0
POL,CHL,2022.0,3,2,1
CHE,MOZ,2017.0,1,1,0
ARG,NLD,2011.0,3,2,1
AUT,NPL,2015.0,1,1,0
ITA,MCO,2021.0,2,1,1
LVA,LTU,2007.0,1,3,-2
FRA,KEN,2002.0,1,2,-1
TWN,ZAF,2013.0,1,8,-7
BEL,BDI,2014.0,1,1,0
IND,MLI,2016.0,1,1,0
ITA,SDN,2021.0,1,2,-1
BGD,DNK,2021.0,4,3,1
SWE,BLR,2022.0,1,2,-1
MDG,DEU,2021.0,1,1,0
HUN,ZAF,2014.0,2,1,1
NLD,VNM,2023.0,4,3,1
BRA,ETH,2019.0,1,1,0
MOZ,ITA,2015.0,2,1,1
PSE,FRA,2021.0,1,11,-10
ZMB,CHN,2018.0,2,6,-4
NAM,UGA,2019.0,1,1,0
ALB,MKD,2020.0,1,2,-1
CYP,LBN,2020.0,2,1,1
ETH,SDN,2011.0,1,1,0
IND,BWA,2019.0,2,1,1
MYS,KAZ,2019.0,2,1,1
SVK,IRN,2021.0,1,6,-5
USA,MDG,2023.0,3,4,-1
IRQ,SAU,2019.0,2,4,-2
CHN,LBN,2022.0,2,1,1
SDN,KEN,2022.0,1,1,0
LTU,BEL,2013.0,2,2,0
JPN,ZMB,2001.0,1,2,-1
TUN,IRQ,2023.0,1,3,-2
AUS,PNG,2023.0,2,1,1
NZL,THA,2008.0,2,1,1
TUR,SYR,2020.0,1,1,0
DNK,ARE,2024.0,1,1,0
CHN,RUS,2013.0,3,8,-5
TUR,RUS,2016.0,5,2,3
IDN,AUS,2005.0,5,15,-10
ITA,UGA,2011.0,3,1,2
DEU,BIH,2007.0,3,2,1
NPL,DEU,2004.0,1,2,-1
BEL,SVN,2015.0,3,8,-5
NGA,DZA,2009.0,1,2,-1
NLD,LTU,2014.0,1,2,-1
IND,TZA,2011.0,3,1,2
ARM,FRA,2010.0,1,1,0
LAO,VNM,2021.0,1,4,-3
HRV,ISR,2006.0,1,1,0
NGA,AUS,2010.0,1,1,0
USA,VIR,2010.0,1,6,-5
ITA,HRV,2003.0,3,5,-2
MEX,BOL,2015.0,1,1,0
CAN,IDN,2010.0,3,2,1
ESP,PRI,2012.0,5,3,2
GEO,AUT,2021.0,1,1,0
ZAF,TZA,2001.0,2,2,0
DEU,NER,2012.0,1,1,0
PHL,THA,2004.0,2,2,0
TUR,SDN,2014.0,1,1,0
ALB,DEU,2012.0,2,2,0
QAT,FRA,2022.0,1,6,-5
SAU,DEU,2011.0,1,22,-21
CZE,ROU,2015.0,1,2,-1
NLD,CMR,2008.0,3,1,2
NLD,MKD,2016.0,1,2,-1
KEN,CHN,2004.0,1,1,0
ALB,USA,2006.0,2,3,-1
ZAF,JAM,2009.0,1,1,0
SAU,BHR,2004.0,2,1,1
BGD,NLD,2008.0,1,1,0
MEX,NIC,2009.0,2,1,1
ISR,ZAF,2011.0,1,3,-2
ZAF,CZE,2014.0,1,1,0
JPN,URY,1998.0,1,1,0
QAT,FRA,2017.0,3,13,-10
MAC,CHN,1998.0,1,1,0
IRL,SGP,2002.0,1,2,-1
URY,MEX,2012.0,1,1,0
MLI,NGA,2015.0,1,1,0
NPL,JPN,2004.0,3,3,0
KOR,DNK,2005.0,2,1,1
MEX,ZAF,2007.0,2,2,0
RWA,GBR,2013.0,1,1,0
ROU,GRC,2019.0,3,2,1
SWE,ISR,2010.0,3,4,-1
NOR,KEN,2008.0,1,1,0
BEL,MYS,2013.0,2,1,1
ECU,PER,2023.0,4,7,-3
CHL,IRL,2009.0,2,1,1
ESP,ECU,2003.0,6,1,5
CYP,AUT,2012.0,1,1,0
DEU,DZA,2013.0,2,3,-1
SYR,MEX,2007.0,1,1,0
SWE,MLI,2009.0,1,1,0
MAR,BEL,2017.0,2,9,-7
BIH,ITA,2009.0,1,1,0
POL,ISR,2014.0,1,3,-2
GRC,IRN,2012.0,1,1,0
JPN,LBN,2021.0,1,1,0
SVK,NOR,2022.0,1,1,0
TZA,ETH,2003.0,1,1,0
MYS,THA,2005.0,2,1,1
THA,BEL,2010.0,2,3,-1
BEN,FRA,2002.0,2,7,-5
LVA,SWE,2023.0,2,2,0
CHE,LVA,2016.0,2,3,-1
PRT,ISR,2014.0,3,1,2
KOR,TUR,2010.0,3,2,1
ARM,FRA,2022.0,1,2,-1
QAT,CHE,2013.0,1,2,-1
OMN,PAK,2017.0,2,5,-3
SVN,FRA,2001.0,2,2,0
GBR,CCK,2021.0,1,1,0
TZA,RWA,2023.0,2,1,1
HKG,MYS,1998.0,1,2,-1
BLR,BEL,2004.0,3,4,-1
PHL,VNM,2017.0,1,1,0
POL,DNK,2004.0,4,5,-1
SEN,MDG,2000.0,1,1,0
TZA,DEU,2018.0,2,6,-4
BGR,RUS,2016.0,3,2,1
ETH,DEU,2019.0,3,13,-10
GHA,KEN,2003.0,1,1,0
ARE,FIN,2016.0,1,4,-3
SAU,ZAF,2004.0,1,1,0
AUS,UKR,2022.0,1,1,0
FJI,USA,2015.0,1,1,0
POL,KOR,2015.0,2,2,0
CHE,LVA,2017.0,1,2,-1
NOR,LTU,2012.0,2,3,-1
IRL,BRA,2022.0,7,30,-23
RWA,CAN,2021.0,4,1,3
ETH,RUS,2016.0,1,1,0
NAM,IND,2017.0,3,2,1
ZAF,GRC,2011.0,1,1,0
DEU,MKD,2002.0,1,3,-2
GBR,ISL,2013.0,9,8,1
SVK,FRA,2021.0,3,2,1
UKR,BEL,2011.0,7,1,6
NGA,SAU,2009.0,1,2,-1
AUS,SVK,2022.0,1,1,0
FIN,IRL,2023.0,3,3,0
DNK,LTU,2020.0,4,1,3
SRB,AUT,1999.0,3,2,1
CHE,GHA,2023.0,2,5,-3
KAZ,CAN,2017.0,1,5,-4
QAT,HKG,2018.0,1,1,0
GRC,IND,2012.0,2,2,0
OMN,NLD,2019.0,1,4,-3
CZE,IRL,2017.0,3,1,2
DEU,UZB,2007.0,4,4,0
CAN,LKA,2013.0,3,4,-1
SVN,ITA,2000.0,1,7,-6
MOZ,ESP,2009.0,3,2,1
MEX,GTM,2014.0,2,1,1
BHR,EGY,2003.0,1,1,0
LTU,RUS,1997.0,3,1,2
LTU,IRL,2005.0,2,1,1
MOZ,NLD,2002.0,3,2,1
SGP,BRA,2010.0,2,1,1
MEX,IND,1997.0,2,1,1
KEN,SAU,2012.0,1,1,0
BEL,EST,2018.0,1,2,-1
BRA,BEN,2014.0,1,1,0
BGR,RUS,2017.0,4,5,-1
BWA,CAN,2012.0,1,1,0
ISL,CHN,2020.0,1,2,-1
CZE,NZL,2018.0,1,2,-1
ZAF,SDN,2019.0,5,4,1
KNA,USA,2023.0,3,2,1
BEL,QAT,2018.0,3,1,2
DZA,DEU,2011.0,1,4,-3
PAK,BRN,2009.0,1,1,0
PER,NLD,2017.0,1,1,0
DNK,THA,2013.0,4,3,1
ROU,IRL,2007.0,1,1,0
ETH,EGY,2023.0,1,1,0
SVN,MKD,2015.0,1,1,0
MEX,FIN,2016.0,1,4,-3
CMR,GHA,2020.0,1,1,0
CUB,RUS,2014.0,1,1,0
EGY,IRN,2012.0,2,5,-3
NAM,ZAF,1997.0,2,2,0
ISR,DNK,2003.0,3,2,1
NOR,ARG,2015.0,1,3,-2
TUR,FIN,2016.0,1,3,-2
EST,USA,2016.0,5,6,-1
NPL,FRA,2019.0,1,2,-1
NGA,FRA,1998.0,4,2,2
ISR,POL,2019.0,3,7,-4
FRA,BHR,2008.0,1,1,0
CHL,POL,2013.0,2,1,1
AUT,MNG,2019.0,2,1,1
ZAF,MAR,2013.0,1,1,0
BGR,ITA,2013.0,3,14,-11
LKA,THA,2009.0,1,1,0
UKR,JPN,2019.0,1,3,-2
SAU,CAN,2005.0,15,21,-6
RUS,SVK,2020.0,4,3,1
CZE,HUN,2007.0,5,2,3
DEU,COL,2004.0,2,2,0
USA,FJI,2010.0,5,1,4
AZE,KAZ,2021.0,1,1,0
FRA,LTU,2021.0,5,3,2
MYS,GHA,2017.0,2,2,0
KWT,LBN,2017.0,1,3,-2
ZWE,NAM,2021.0,1,1,0
SGP,ISR,2018.0,8,4,4
IRQ,GBR,2009.0,4,5,-1
HKG,SAU,2019.0,3,6,-3
ZWE,ETH,2018.0,2,3,-1
KWT,SAU,2007.0,2,5,-3
SRB,ALB,2023.0,7,3,4
NIC,PER,2018.0,1,1,0
NIC,USA,2015.0,1,4,-3
AUS,COL,2016.0,5,13,-8
EGY,SDN,2020.0,3,4,-1
FRA,JOR,2015.0,1,4,-3
ESP,ROU,2004.0,3,4,-1
UKR,SVK,2015.0,4,2,2
SVK,UKR,2019.0,3,6,-3
ROU,CHN,2023.0,5,4,1
GHA,GMB,2019.0,1,1,0
TUR,GMB,2022.0,1,1,0
HRV,AUT,2023.0,2,5,-3
LUX,GBR,2023.0,3,6,-3
TUR,POL,2023.0,5,1,4
CHN,NPL,2013.0,2,3,-1
ESP,SRB,2022.0,3,3,0
EGY,CHE,2013.0,2,7,-5
MYS,FIN,2017.0,2,1,1
ARG,NLD,2006.0,6,5,1
GHA,ZAF,2006.0,3,3,0
PRY,ARG,2020.0,3,3,0
CHE,EGY,2019.0,4,6,-2
POL,BLR,2012.0,1,5,-4
COL,IND,2017.0,3,1,2
ISR,JPN,2012.0,2,1,1
FRA,CAN,2024.0,2,1,1
GIN,RUS,2019.0,1,1,0
NOR,CZE,2010.0,4,3,1
CYP,USA,2004.0,5,19,-14
JOR,IRL,2005.0,1,1,0
DNK,GNB,2009.0,2,6,-4
POL,NOR,2002.0,3,7,-4
AUT,BEL,2011.0,3,8,-5
UKR,SVK,2008.0,2,1,1
DEU,AZE,2006.0,2,1,1
FIN,HKG,2009.0,2,1,1
PAK,JPN,2020.0,3,11,-8
GBR,MAR,2009.0,1,1,0
NLD,ROU,2004.0,3,7,-4
MEX,VEN,2010.0,6,15,-9
ITA,VEN,1998.0,3,2,1
ITA,ARM,1999.0,1,2,-1
BEL,NZL,2004.0,2,1,1
KOR,RUS,2013.0,8,9,-1
HRV,BEL,2015.0,3,2,1
URY,BRA,2004.0,4,1,3
IND,TZA,2023.0,2,2,0
IRL,ZAF,2000.0,1,1,0
LUX,SWE,2006.0,1,1,0
FRA,LKA,2001.0,1,1,0
BFA,SEN,2003.0,2,2,0
GUY,FRA,2005.0,2,4,-2
DNK,BGR,1999.0,1,1,0
ZAF,MWI,2004.0,3,2,1
AUT,LUX,2002.0,2,1,1
DZA,GBR,2002.0,1,3,-2
GRC,NLD,2006.0,5,11,-6
GBR,TZA,2005.0,9,3,6
BGR,MKD,2012.0,3,1,2
MKD,BGR,2017.0,3,2,1
GMB,NGA,2008.0,1,4,-3
ROU,FIN,2012.0,3,1,2
DZA,GBR,1997.0,3,2,1
MAR,SYR,2010.0,1,3,-2
SWE,ETH,2001.0,6,4,2
EGY,BHR,2015.0,3,3,0
ARE,JOR,2004.0,5,3,2
ITA,SGP,1998.0,1,1,0
THA,ITA,1998.0,1,1,0
GBR,YEM,1998.0,1,1,0
OMN,ARE,2019.0,7,5,2
THA,TWN,2013.0,4,2,2
SWE,CHL,2016.0,2,3,-1
JPN,HRV,2002.0,1,1,0
SGP,KOR,2000.0,1,5,-4
CAN,THA,2011.0,9,16,-7
CHL,POL,2012.0,2,3,-1
VEN,MEX,2023.0,4,1,3
OMN,DNK,1997.0,2,1,1
RUS,TWN,2018.0,4,5,-1
SEN,GBR,2021.0,3,2,1
HRV,CHE,2019.0,3,2,1
AUT,LVA,2010.0,2,1,1
TWN,DNK,2010.0,2,3,-1
BEL,PRT,1997.0,3,1,2
UKR,KOR,2000.0,3,2,1
CAN,HRV,2020.0,5,5,0
DEU,URY,2014.0,3,1,2
CHN,RUS,2004.0,5,6,-1
TKM,CHN,2017.0,1,1,0
PRT,PER,2015.0,2,1,1
VNM,KOR,2011.0,5,26,-21
DOM,ECU,2020.0,6,3,3
KEN,ZAF,2001.0,3,3,0
HRV,POL,2018.0,1,1,0
EGY,CAN,2000.0,8,13,-5
PRT,AUT,2023.0,7,5,2
SRB,CAN,2019.0,6,2,4
ETH,NLD,2015.0,6,4,2
ESP,TUR,2014.0,6,13,-7
OMN,CHE,2015.0,1,2,-1
SVN,KWT,2018.0,2,1,1
ITA,MYS,2018.0,5,6,-1
ETH,BWA,2018.0,3,4,-1
FIN,UKR,2019.0,1,6,-5
USA,BIH,2022.0,1,2,-1
IRQ,FRA,2021.0,2,10,-8
CAN,VEN,2021.0,1,2,-1
QAT,EGY,2023.0,4,4,0
CIV,TGO,2019.0,1,1,0
ETH,NOR,2020.0,5,20,-15
VIR,USA,2007.0,4,3,1
NOR,ZAF,2022.0,3,15,-12
QAT,KOR,2015.0,1,3,-2
IRL,ROU,2021.0,2,1,1
VNM,CZE,2019.0,1,10,-9
FRA,PER,2009.0,3,12,-9
CHN,CUB,2022.0,1,7,-6
PHL,VNM,2019.0,3,2,1
USA,PRY,2023.0,3,2,1
CHL,URY,2023.0,1,1,0
MDV,MYS,2022.0,1,1,0
BTN,IND,2022.0,3,5,-2
CHL,AUS,2023.0,5,7,-2
TWN,UKR,2006.0,1,1,0
VEN,BRA,1997.0,2,1,1
EGY,CHN,2002.0,2,1,1
NLD,BGR,2000.0,2,7,-5
FIN,DNK,2000.0,7,5,2
NGA,FRA,2001.0,1,1,0
CMR,GAB,2019.0,4,3,1
LUX,NLD,2014.0,2,7,-5
ZMB,DEU,2003.0,1,1,0
ITA,ETH,2000.0,2,1,1
DNK,LTU,2014.0,3,4,-1
PER,COL,2010.0,5,1,4
HUN,SVK,2007.0,1,1,0
RUS,NZL,2014.0,3,3,0
PHL,NZL,2011.0,1,2,-1
NLD,VNM,2011.0,5,4,1
FRA,TGO,2003.0,3,2,1
CHL,VEN,2004.0,3,3,0
ZAF,ETH,2005.0,4,3,1
NLD,TUR,2007.0,5,13,-8
BEN,SEN,2004.0,1,2,-1
SEN,BEN,2010.0,5,1,4
GUM,AUS,2000.0,1,1,0
PHL,THA,2003.0,2,1,1
THA,AUT,2013.0,4,7,-3
CUB,ARG,2002.0,4,2,2
MEX,AUT,2008.0,3,1,2
GMB,NGA,2014.0,1,2,-1
ZAF,CHL,2013.0,2,1,1
SWE,CZE,2014.0,3,11,-8
CUB,BEL,2002.0,1,3,-2
ISL,DEU,2006.0,1,2,-1
BIH,SRB,2004.0,4,10,-6
CMR,NLD,2013.0,1,1,0
RUS,TJK,2002.0,1,2,-1
IDN,CAN,2003.0,1,2,-1
MDA,RUS,2011.0,3,2,1
IRL,JPN,2010.0,4,6,-2
CZE,NLD,2014.0,8,14,-6
MEX,KOR,2007.0,3,1,2
ROU,CHE,2011.0,4,3,1
PSE,EGY,2015.0,2,3,-1
AUS,POL,2006.0,2,4,-2
PRT,ETH,2012.0,1,1,0
ETH,ESP,2016.0,1,2,-1
MOZ,ZAF,2015.0,2,2,0
YEM,SAU,2011.0,1,1,0
USA,TTO,2002.0,4,9,-5
HKG,SWE,2013.0,4,2,2
CMR,GBR,2002.0,3,1,2
GBR,IRQ,2008.0,7,3,4
SWE,NIC,2008.0,2,2,0
BHS,USA,2003.0,1,1,0
GBR,NAM,2022.0,1,3,-2
MEX,ITA,2006.0,4,2,2
ARE,GRC,2016.0,2,5,-3
LUX,FIN,2015.0,3,2,1
GBR,RWA,2015.0,3,1,2
QAT,ARE,2014.0,1,12,-11
CYP,SWE,2017.0,2,3,-1
ISR,ZAF,2023.0,1,3,-2
NPL,KOR,2012.0,4,2,2
CAN,BFA,2016.0,4,2,2
TUN,MRT,2021.0,1,1,0
UGA,AUS,2021.0,1,1,0
THA,SAU,2017.0,3,3,0
FRA,MDA,2015.0,1,2,-1
USA,BRB,2011.0,5,1,4
ESP,LTU,2014.0,1,3,-2
LVA,EST,2019.0,2,3,-1
PAK,ZAF,2023.0,3,2,1
USA,SDN,2014.0,7,4,3
ECU,NLD,2016.0,2,1,1
EST,ITA,2010.0,1,1,0
PRT,SWE,2000.0,4,4,0
DEU,LTU,2015.0,8,4,4
ARE,TUN,2015.0,1,14,-13
BFA,GBR,2002.0,1,1,0
BRN,MYS,2017.0,3,12,-9
HTI,FRA,2015.0,2,1,1
NER,FRA,2015.0,3,5,-2
SDN,ERI,2022.0,1,1,0
URY,BRA,2001.0,2,3,-1
USA,MOZ,1998.0,1,1,0
SWE,RWA,2023.0,3,3,0
NOR,LKA,2018.0,2,3,-1
RUS,NZL,2015.0,1,1,0
FIN,BEL,2001.0,1,3,-2
LTU,UKR,2014.0,1,4,-3
RWA,GBR,2015.0,1,3,-2
YEM,SAU,2019.0,6,6,0
NPL,NZL,2018.0,3,4,-1
UKR,CAN,2015.0,4,1,3
USA,GAB,2013.0,1,2,-1
CHL,TWN,2015.0,2,1,1
AGO,RUS,2017.0,1,1,0
KOR,NPL,2014.0,2,8,-6
HKG,ITA,2022.0,2,6,-4
IRQ,CAN,2019.0,2,6,-4
THA,MYS,2023.0,6,10,-4
JPN,PRY,2004.0,2,2,0
POL,PAK,2023.0,1,10,-9
QAT,KWT,2020.0,2,2,0
LKA,MYS,2017.0,2,8,-6
MAC,TWN,2019.0,2,5,-3
UKR,CZE,2014.0,4,4,0
ARM,DEU,2021.0,3,1,2
AUS,COL,2022.0,8,6,2
PAK,NLD,2020.0,8,13,-5
LTU,FRA,2008.0,4,1,3
HKG,ITA,2016.0,2,2,0
GTM,ESP,2020.0,1,4,-3
COL,IND,2022.0,1,2,-1
BHR,ITA,2020.0,1,1,0
BEL,UGA,2005.0,1,1,0
LKA,KOR,2020.0,2,4,-2
QAT,ITA,2023.0,3,3,0
DNK,PAK,2017.0,2,2,0
EST,ITA,2023.0,2,1,1
PRT,ISL,2020.0,2,1,1
IDN,BEL,2023.0,4,1,3
GHA,BEN,2022.0,2,3,-1
AFG,PAK,2022.0,2,1,1
TUR,LBN,2022.0,1,2,-1
GBR,TUN,2020.0,3,2,1
AUT,EGY,1997.0,1,2,-1
JPN,BGR,1997.0,6,6,0
FRA,BOL,1997.0,3,3,0
LBY,IRQ,2004.0,2,1,1
COL,GBR,1998.0,3,2,1
NZL,SGP,2003.0,6,4,2
AFG,USA,2006.0,1,2,-1
COG,ZAF,2014.0,2,3,-1
USA,ASM,2010.0,2,7,-5
USA,UZB,2009.0,2,3,-1
ARG,FIN,2001.0,1,2,-1
PRT,SVN,2017.0,2,1,1
LKA,USA,2002.0,5,7,-2
JPN,UKR,1997.0,2,8,-6
HUN,BEL,2000.0,6,7,-1
SGP,MYS,2003.0,4,1,3
NZL,PRT,2008.0,2,2,0
SWE,MEX,2003.0,2,2,0
MYS,NLD,2005.0,3,2,1
EGY,BEL,2006.0,2,3,-1
ZAF,CHN,2006.0,5,4,1
ITA,TWN,2016.0,6,3,3
ETH,FRA,2019.0,1,6,-5
CAN,HUN,2023.0,2,3,-1
NGA,NLD,2015.0,2,5,-3
GTM,MEX,2013.0,4,5,-1
ABW,NLD,2021.0,2,1,1
CHN,ISL,2010.0,1,1,0
GBR,BIH,2022.0,1,4,-3
ISR,SGP,2015.0,6,4,2
IND,PHL,2012.0,4,2,2
IRQ,GBR,2011.0,4,8,-4
CAN,URY,2021.0,4,2,2
DZA,TUN,2020.0,8,8,0
KEN,SDN,2016.0,1,1,0
NZL,ESP,2012.0,5,13,-8
PSE,ESP,2016.0,2,2,0
USA,WSM,2018.0,1,1,0
VNM,ESP,2017.0,1,3,-2
GBR,LVA,2013.0,2,1,1
JPN,BLR,1998.0,1,1,0
ISR,BEL,2020.0,6,7,-1
VNM,BGD,2013.0,2,1,1
BFA,NLD,2021.0,1,1,0
JPN,LUX,2015.0,2,2,0
KAZ,IRL,2016.0,1,1,0
HKG,DNK,2016.0,1,2,-1
BEL,PSE,2015.0,2,2,0
KOR,TWN,2005.0,2,4,-2
TTO,ESP,2016.0,1,2,-1
NLD,ZMB,2020.0,3,4,-1
LBR,NGA,2020.0,3,1,2
CHN,MNG,2018.0,4,4,0
BRN,USA,2019.0,4,1,3
BEN,CAN,2017.0,1,1,0
FIN,EGY,2019.0,3,3,0
QAT,TUN,2023.0,2,1,1
USA,PNG,2019.0,2,1,1
ITA,PER,2016.0,1,1,0
BEL,LBN,2022.0,1,9,-8
IND,LUX,2023.0,5,2,3
SRB,ESP,2022.0,3,3,0
BWA,CMR,2023.0,1,1,0
HUN,KOR,2022.0,2,3,-1
PHL,MYS,2023.0,3,2,1
FIN,KOR,2007.0,3,1,2
CMR,CHE,2013.0,1,2,-1
BEL,ARE,2005.0,2,1,1
CRI,DEU,2004.0,1,3,-2
CRI,BRA,2014.0,3,5,-2
CHL,DNK,2017.0,3,4,-1
TZA,JPN,2004.0,2,5,-3
SGP,PRT,2010.0,1,1,0
BGR,CAN,2004.0,3,3,0
BLR,IND,2009.0,1,1,0
LUX,GBR,2010.0,4,8,-4
DNK,SVK,2013.0,2,1,1
PER,CAN,2009.0,3,3,0
NPL,KOR,2005.0,1,1,0
THA,AUT,2003.0,2,6,-4
EST,GBR,2007.0,4,4,0
MEX,PHL,2001.0,1,1,0
BHR,IND,2011.0,1,3,-2
KOR,EGY,2008.0,3,3,0
GBR,HRV,2011.0,2,11,-9
HRV,CZE,2012.0,2,1,1
FIN,ITA,1997.0,6,6,0
MWI,TZA,2013.0,2,2,0
AUS,UKR,2011.0,2,2,0
KAZ,USA,2007.0,1,4,-3
NZL,PRT,2014.0,1,3,-2
GRC,AUT,2007.0,1,7,-6
MWI,USA,2010.0,5,7,-2
CYP,NLD,2021.0,1,2,-1
DEU,ALB,2019.0,1,3,-2
BGR,RUS,2011.0,2,7,-5
KOR,RWA,2020.0,4,1,3
ESP,ECU,2008.0,3,7,-4
GRC,JPN,2007.0,2,5,-3
MWI,NOR,2014.0,2,2,0
IND,FJI,2021.0,3,2,1
IRL,AUT,1999.0,1,1,0
AUT,IRL,2003.0,2,2,0
BEL,GHA,2016.0,2,1,1
CZE,COL,2017.0,1,1,0
LKA,CHE,2010.0,1,1,0
ESP,GNQ,2018.0,1,1,0
ARG,CRI,2013.0,1,1,0
KHM,GBR,2018.0,2,6,-4
IRQ,HUN,2020.0,4,1,3
FRA,URY,2019.0,4,2,2
FRA,MUS,2018.0,3,1,2
DEU,SDN,2023.0,3,1,2
THA,HKG,2015.0,1,2,-1
GBR,JAM,2015.0,2,3,-1
KWT,CHN,2014.0,2,1,1
THA,HKG,2014.0,1,6,-5
GHA,FIN,2018.0,1,1,0
ARE,AUT,2015.0,1,2,-1
TZA,KOR,2019.0,1,4,-3
NPL,NZL,2016.0,1,2,-1
HND,USA,2017.0,1,1,0
RUS,ETH,2019.0,1,1,0
GBR,CRI,2016.0,1,2,-1
PAK,CHN,1998.0,1,1,0
ITA,BEL,2024.0,3,1,2
KEN,DNK,2015.0,2,2,0
DEU,SYR,2017.0,4,4,0
BGD,PHL,2015.0,3,2,1
PHL,BGD,2020.0,1,4,-3
GIN,CHE,2021.0,3,1,2
ZWE,NAM,2019.0,2,1,1
GMB,BEL,2003.0,1,1,0
GBR,HRV,2019.0,4,22,-18
LBY,CAN,2021.0,2,5,-3
ISL,CHE,2018.0,1,1,0
JPN,MEX,2021.0,5,7,-2
USA,BLR,2010.0,4,2,2
EGY,JOR,2014.0,3,1,2
BRA,NOR,2006.0,2,1,1
DNK,ISL,2015.0,2,2,0
KAZ,USA,1999.0,1,1,0
SVK,PRT,1998.0,1,1,0
ESP,FIN,2004.0,3,4,-1
MNG,JPN,2001.0,5,2,3
ZAF,GMB,2001.0,1,1,0
MLI,USA,2003.0,4,2,2
USA,HND,2010.0,2,3,-1
DZA,ESP,2009.0,1,4,-3
RUS,ZAF,2010.0,5,2,3
DNK,LTU,2015.0,2,2,0
AUS,CZE,2006.0,1,6,-5
GBR,IDN,1998.0,5,5,0
HRV,BEL,2008.0,2,1,1
NOR,IND,2008.0,3,6,-3
SRB,BRA,2001.0,2,2,0
KOR,CHE,2001.0,6,2,4
ITA,NZL,2000.0,2,1,1
NOR,LTU,2013.0,1,2,-1
LBY,LBN,2020.0,1,1,0
POL,LTU,2012.0,1,2,-1
LTU,POL,2014.0,3,3,0
MAR,DEU,2009.0,1,1,0
GAB,FRA,2005.0,3,3,0
USA,MLI,2015.0,6,6,0
CZE,ARM,2023.0,1,1,0
TZA,PAK,2017.0,2,1,1
HUN,MEX,2018.0,3,2,1
BEL,ISL,2014.0,3,1,2
MYS,NLD,2002.0,2,2,0
CIV,CAN,2010.0,1,2,-1
LUX,DEU,2004.0,2,9,-7
ROU,CZE,2018.0,3,1,2
PHL,SGP,2012.0,3,1,2
UKR,NLD,2023.0,3,3,0
BFA,DEU,2021.0,1,1,0
BEN,DEU,2009.0,3,3,0
ESP,DZA,2016.0,7,4,3
SGP,BRN,2007.0,1,1,0
FRA,SRB,1998.0,3,3,0
MAR,DZA,2016.0,3,5,-2
KEN,GHA,2011.0,2,1,1
CMR,USA,2009.0,3,6,-3
FRA,CAF,2012.0,3,8,-5
DNK,BEL,2009.0,7,6,1
NZL,HKG,2013.0,4,5,-1
BMU,USA,2010.0,1,2,-1
CUB,COL,2018.0,3,2,1
GBR,FRO,2013.0,2,1,1
LUX,BRA,2020.0,1,2,-1
BGD,PAK,2003.0,9,3,6
KOR,VNM,2002.0,1,8,-7
SVK,FRA,2022.0,3,2,1
MYS,ITA,2014.0,3,4,-1
AUS,FJI,2001.0,2,1,1
ROU,ESP,2020.0,7,8,-1
KGZ,KAZ,2023.0,2,1,1
GHA,CHE,2022.0,3,4,-1
IND,NOR,2024.0,1,1,0
IND,JOR,2015.0,1,2,-1
AUT,POL,1998.0,3,3,0
USA,IRQ,2009.0,3,5,-2
LBN,NLD,2016.0,1,2,-1
SRB,POL,2003.0,1,3,-2
SGP,IND,2002.0,4,18,-14
ZAF,JPN,2022.0,3,1,2
HRV,SWE,1998.0,3,3,0
IND,PHL,1997.0,2,1,1
HRV,ITA,2001.0,2,5,-3
SWE,HRV,2000.0,1,2,-1
HUN,RUS,2004.0,1,2,-1
HUN,ROU,2004.0,4,2,2
SEN,USA,2003.0,1,3,-2
ARE,CYP,2019.0,3,2,1
SWE,BGR,2012.0,1,2,-1
JAM,GBR,1999.0,3,6,-3
FRA,VNM,2002.0,4,3,1
VNM,FRA,2004.0,2,7,-5
SWE,CHL,2017.0,1,9,-8
MEX,CHE,2008.0,5,1,4
NZL,FRA,2004.0,3,7,-4
ARE,HUN,2004.0,1,2,-1
ARE,HUN,2014.0,1,1,0
BLR,JPN,2000.0,1,2,-1
ROU,POL,2002.0,3,4,-1
IND,IOT,2010.0,2,1,1
USA,LKA,2001.0,3,4,-1
IND,ETH,2004.0,4,4,0
NZL,BEL,2006.0,2,4,-2
AUT,TUR,1997.0,2,2,0
NOR,HUN,2019.0,3,7,-4
SVN,ESP,2013.0,1,6,-5
ITA,HRV,2014.0,2,7,-5
TUR,BEL,2004.0,3,3,0
SVK,SVN,2023.0,6,1,5
MAC,CHN,2005.0,3,6,-3
ZAF,UKR,2019.0,1,1,0
KEN,RWA,2014.0,2,1,1
UZB,TJK,2014.0,4,1,3
NOR,ZAF,2017.0,2,5,-3
KHM,FRA,2012.0,2,5,-3
DNK,HUN,2021.0,5,5,0
SAU,MAR,2017.0,2,4,-2
KGZ,RUS,2016.0,3,4,-1
COL,SWE,2007.0,2,1,1
NLD,GHA,2009.0,1,3,-2
FRA,PER,2011.0,4,7,-3
BEL,SVN,2013.0,2,2,0
FIN,PSE,2019.0,1,1,0
DNK,ISL,2014.0,3,4,-1
IDN,SWE,2010.0,3,1,2
CHN,HUN,2014.0,3,3,0
BLR,POL,2015.0,2,5,-3
SAU,SWE,2017.0,5,10,-5
ZAF,IRN,2018.0,1,8,-7
VNM,DEU,2016.0,7,22,-15
JOR,ESP,2020.0,2,4,-2
CMR,GBR,2012.0,2,1,1
BEL,MAR,2010.0,1,1,0
ISR,KAZ,2013.0,2,1,1
TZA,SWE,2018.0,2,4,-2
GBR,LAO,2021.0,2,1,1
MDA,DEU,2001.0,2,1,1
CMR,GAB,2009.0,2,1,1
UZB,JPN,2012.0,1,1,0
USA,NAM,2023.0,4,1,3
SEN,BEL,2009.0,2,2,0
TGO,FRA,2016.0,4,3,1
THA,LKA,2017.0,3,2,1
ETH,COG,2009.0,1,1,0
BFA,BEL,2022.0,2,8,-6
SRB,DNK,2010.0,3,1,2
MYS,FRA,2016.0,7,9,-2
AUS,CZE,2023.0,3,2,1
CUB,CHL,2020.0,9,4,5
AUS,UKR,2019.0,2,2,0
OMN,IND,2024.0,1,2,-1
KOR,LKA,2018.0,4,3,1
CZE,AUT,2014.0,8,16,-8
JOR,BHR,2023.0,4,1,3
POL,LUX,2023.0,2,1,1
LKA,THA,2021.0,2,1,1
KEN,MWI,2022.0,4,2,2
ARE,BEL,2022.0,2,4,-2
CHE,ISL,2012.0,3,2,1
IND,ESP,2002.0,2,4,-2
PAK,CAN,2002.0,4,2,2
COL,PER,2007.0,1,2,-1
BEL,GMB,2013.0,1,1,0
CHN,BRA,2007.0,2,1,1
CHE,HKG,2007.0,3,3,0
BOL,ESP,2010.0,2,2,0
GBR,GUY,1999.0,1,1,0
GRC,TWN,2006.0,1,2,-1
AUS,BRN,2008.0,2,1,1
ETH,ITA,2015.0,2,5,-3
MAR,ZAF,2017.0,1,7,-6
SDN,GBR,2013.0,5,5,0
GRC,ISR,2012.0,2,2,0
THA,NZL,2014.0,2,9,-7
HUN,SGP,2019.0,2,2,0
ZAF,KOR,2016.0,4,8,-4
IRN,RUS,2023.0,7,3,4
SAU,VNM,2020.0,1,2,-1
CMR,NGA,2008.0,2,1,1
CHL,JPN,2012.0,4,4,0
YEM,ARE,2013.0,1,1,0
BIH,TUR,2011.0,1,2,-1
LTU,BGD,2023.0,1,1,0
MNG,KOR,2013.0,1,4,-3
IRL,GRC,2016.0,1,7,-6
HKG,IRN,2019.0,1,2,-1
KEN,AUS,2013.0,2,6,-4
POL,COL,2020.0,2,2,0
VNM,ESP,2022.0,1,1,0
KEN,ZWE,2021.0,2,2,0
BLR,IRN,2012.0,1,1,0
MMR,USA,2011.0,1,1,0
GBR,CUB,2000.0,2,2,0
ITA,DZA,2009.0,2,1,1
ESP,NZL,1997.0,2,1,1
BFA,USA,2012.0,4,3,1
NOR,KOR,2011.0,4,4,0
BGD,PAK,2013.0,3,8,-5
ZAF,PAK,2015.0,1,2,-1
PAK,NOR,2012.0,2,1,1
ISR,HUN,2019.0,2,3,-1
SYR,FRA,2003.0,2,4,-2
AUS,MAC,2008.0,1,1,0
TUN,ESP,2001.0,1,2,-1
NGA,RUS,2018.0,1,3,-2
THA,LAO,2007.0,2,1,1
CZE,BRA,2011.0,2,3,-1
BEL,DZA,2005.0,1,1,0
BRA,PRI,2013.0,2,6,-4
ITA,SGP,2007.0,6,2,4
KWT,GBR,2004.0,4,5,-1
UZB,KAZ,1998.0,1,1,0
BFA,COG,2010.0,1,2,-1
SYR,GBR,2001.0,1,1,0
CHL,ZAF,2010.0,1,2,-1
PRT,AUS,1999.0,1,1,0
QAT,YEM,2008.0,1,1,0
SVK,CAN,2010.0,3,1,2
RUS,SVK,1998.0,5,5,0
AUT,HUN,2001.0,6,8,-2
NGA,CMR,2005.0,2,2,0
GRC,BGR,2004.0,1,1,0
CAN,LBY,2008.0,2,2,0
CUB,FRA,2014.0,6,2,4
GBR,NAM,2017.0,2,2,0
HRV,BEL,2004.0,1,3,-2
CAN,OMN,2004.0,2,4,-2
BLR,UKR,2021.0,3,1,2
NLD,TUR,1999.0,1,3,-2
COG,USA,2004.0,2,4,-2
NZL,IND,2006.0,4,6,-2
FRA,BOL,2012.0,1,5,-4
SWE,TZA,2013.0,2,1,1
BEL,ETH,1998.0,1,1,0
ETH,BEL,2000.0,1,1,0
USA,BOL,2006.0,5,2,3
NGA,JAM,2011.0,1,1,0
PLW,FSM,2004.0,1,2,-1
UGA,KEN,2009.0,2,1,1
BGD,DEU,2002.0,1,2,-1
AUT,MEX,2011.0,2,1,1
NOR,ISR,2012.0,2,2,0
GBR,LKA,1999.0,4,4,0
BRA,KOR,2014.0,2,6,-4
FRA,PHL,2012.0,1,3,-2
NZL,ESP,2002.0,1,4,-3
SAU,AUS,1999.0,3,6,-3
JPN,SRB,2006.0,1,6,-5
DNK,KEN,2009.0,1,1,0
RUS,CHN,2002.0,5,8,-3
BFA,GBR,2012.0,2,5,-3
HKG,ESP,2012.0,1,2,-1
VNM,CHE,2006.0,1,3,-2
CHE,TWN,1999.0,3,1,2
DNK,CHN,2002.0,4,16,-12
ZAF,LBY,2021.0,4,2,2
DMA,USA,2011.0,3,1,2
NOR,GRC,2013.0,2,1,1
TUN,DZA,2012.0,2,2,0
MYS,JOR,2009.0,8,6,2
ECU,ESP,2006.0,3,2,1
KOR,UGA,2019.0,2,1,1
DNK,GHA,2009.0,2,1,1
SRB,NOR,2009.0,2,7,-5
QAT,EGY,2010.0,2,3,-1
DZA,SAU,2012.0,7,5,2
JPN,SVN,2012.0,1,1,0
FRA,YEM,2009.0,1,1,0
NGA,NLD,2008.0,2,2,0
IRN,MAR,2015.0,2,1,1
OMN,CAN,2010.0,2,12,-10
SAU,BRN,2017.0,2,1,1
USA,LVA,2007.0,1,2,-1
POL,FIN,2006.0,4,2,2
MEX,UKR,2018.0,1,1,0
DEU,PAN,2012.0,1,1,0
MOZ,DEU,2016.0,1,1,0
SWE,ISR,2009.0,2,2,0
TUR,MAR,2020.0,2,2,0
DEU,VEN,2019.0,1,7,-6
NGA,GHA,2014.0,5,1,4
LUX,SWE,2023.0,4,4,0
OMN,AUS,2023.0,3,2,1
BGR,POL,2013.0,1,2,-1
JPN,SRB,2000.0,2,4,-2
ECU,NZL,2020.0,2,3,-1
FIN,CZE,2017.0,8,4,4
ESP,BOL,2013.0,2,2,0
RUS,GEO,2001.0,3,9,-6
BEL,GEO,2022.0,1,1,0
SVK,BEL,2005.0,4,2,2
IRN,GRC,2015.0,3,1,2
SRB,GRC,2014.0,2,3,-1
AUT,PRT,2009.0,3,5,-2
JOR,ITA,2023.0,2,1,1
ISR,MEX,2003.0,2,1,1
PER,CHL,2014.0,2,6,-4
NZL,KHM,2016.0,1,1,0
SLE,CHN,2021.0,2,6,-4
CZE,AUS,2022.0,4,2,2
MYS,KHM,2018.0,2,1,1
OMN,EGY,2007.0,3,1,2
HUN,RUS,2015.0,1,1,0
NLD,TWN,2019.0,1,1,0
IRL,MEX,2011.0,2,2,0
CHE,ARE,2014.0,1,1,0
DEU,DZA,2015.0,3,3,0
DZA,USA,2023.0,4,3,1
ALB,SRB,2020.0,6,12,-6
JPN,PRT,2016.0,3,5,-2
GBR,COG,2015.0,1,2,-1
SVK,HUN,2011.0,2,4,-2
THA,NZL,2015.0,6,2,4
GRC,RUS,2009.0,3,1,2
THA,RUS,2021.0,3,2,1
CAN,TUN,1997.0,1,3,-2
PER,GBR,2023.0,2,4,-2
DNK,COL,2016.0,2,1,1
GHA,NLD,2021.0,5,5,0
ECU,FRA,2023.0,2,1,1
BGD,HKG,2019.0,3,2,1
ARM,FRA,2019.0,2,3,-1
CHL,PRY,2021.0,3,1,2
GRC,RUS,2019.0,2,2,0
MYS,ETH,2016.0,1,1,0
CHE,CRI,2022.0,1,2,-1
KEN,SDN,2018.0,3,1,2
BGR,GRC,2017.0,1,3,-2
POL,SVK,2008.0,5,1,4
GHA,SWE,2019.0,1,2,-1
BLR,CHN,2021.0,3,3,0
EST,BEL,2002.0,1,1,0
IRL,DZA,2020.0,1,2,-1
DEU,CRI,2009.0,2,2,0
AUS,UGA,2022.0,2,1,1
SAU,AUS,2007.0,4,6,-2
DNK,GRC,2020.0,6,11,-5
HND,USA,2022.0,5,5,0
SWE,KAZ,2023.0,1,1,0
QAT,TUR,2015.0,3,3,0
BGR,CHE,2020.0,2,4,-2
GBR,BHR,2023.0,3,4,-1
ZAF,BEN,2021.0,1,2,-1
VNM,IRN,2019.0,1,18,-17
ITA,BIH,2021.0,2,2,0
IND,ETH,2008.0,6,3,3
JPN,KAZ,2018.0,4,5,-1
HUN,RUS,2014.0,2,2,0
MOZ,BEL,2012.0,1,2,-1
SEN,DEU,2020.0,4,1,3
BEL,FIN,2009.0,2,7,-5
OMN,CAN,2006.0,2,6,-4
GRC,SRB,1997.0,2,3,-1
CZE,KWT,2016.0,1,2,-1
SVN,SRB,2005.0,3,5,-2
COL,PER,1998.0,1,2,-1
ROU,SWE,2008.0,1,5,-4
AZE,RUS,2016.0,4,18,-14
SRB,IRL,2012.0,2,1,1
ARE,CAN,2003.0,2,12,-10
ECU,SWE,2009.0,2,1,1
SGP,MEX,2004.0,2,1,1
ZWE,USA,1998.0,8,7,1
NPL,GBR,1997.0,1,1,0
OMN,IRN,2016.0,1,3,-2
BIH,SRB,2008.0,1,18,-17
CRI,BRA,2004.0,1,1,0
ITA,SRB,2000.0,3,6,-3
AGO,FRA,2014.0,1,1,0
AUS,PAN,2001.0,1,1,0
TUN,BEL,2005.0,5,1,4
MEX,ECU,1998.0,1,2,-1
ROU,FIN,2005.0,2,2,0
OMN,ARE,2011.0,3,2,1
CAN,PAK,2000.0,3,4,-1
SWE,LVA,1999.0,4,4,0
CAN,COL,1999.0,1,1,0
LBN,DEU,2000.0,1,1,0
USA,TUN,2000.0,3,1,2
ITA,BFA,2000.0,1,1,0
MAR,ESP,2002.0,3,5,-2
THA,PHL,2003.0,1,2,-1
LVA,ITA,2014.0,1,1,0
SWE,NGA,2014.0,2,1,1
RWA,BDI,2020.0,1,1,0
EGY,KOR,2011.0,8,7,1
TWN,SWE,2012.0,4,1,3
ESP,THA,2011.0,1,1,0
GHA,FRA,2008.0,1,1,0
DNK,BGR,2007.0,1,2,-1
LVA,CAN,2012.0,2,1,1
MDA,FRA,2011.0,1,3,-2
MKD,ITA,2015.0,1,1,0
BEL,AUT,1998.0,3,4,-1
ARG,CUB,2003.0,3,1,2
ZAF,SGP,2007.0,2,3,-1
KHM,BGD,2011.0,1,1,0
CAN,BWA,2014.0,1,3,-2
BEL,MLI,2019.0,1,1,0
IRN,ETH,2021.0,4,2,2
SAU,RUS,2020.0,3,5,-2
NZL,RUS,2016.0,2,1,1
VNM,HUN,2023.0,1,3,-2
CHN,MUS,2016.0,1,1,0
NPL,NLD,1997.0,2,1,1
SGP,SAU,2023.0,2,3,-1
MAR,GBR,2002.0,2,1,1
NPL,CZE,2020.0,2,1,1
ESP,NZL,2005.0,1,1,0
DNK,ARM,2022.0,1,1,0
MWI,IRL,2020.0,1,1,0
HKG,EGY,2020.0,1,1,0
ARM,CHE,2019.0,2,2,0
MAC,GBR,2022.0,1,5,-4
BRA,CHL,2024.0,1,1,0
PAK,AFG,2020.0,1,1,0
UKR,BEL,2016.0,2,2,0
THA,DNK,2022.0,1,2,-1
MYS,SRB,2019.0,1,1,0
GBR,YEM,2020.0,1,2,-1
NGA,ZWE,2022.0,1,1,0
LBN,AUS,2023.0,1,2,-1
USA,VIR,2011.0,1,2,-1
BHR,SAU,2014.0,3,3,0
BGR,PAK,2013.0,2,1,1
COL,DEU,2004.0,2,2,0
BEL,THA,2003.0,2,1,1
BIH,DEU,2009.0,1,1,0
IND,UGA,2022.0,1,3,-2
GRC,DZA,2010.0,1,1,0
HKG,CZE,2017.0,1,1,0
PAK,IND,2007.0,5,15,-10
NLD,IRN,2005.0,2,5,-3
AFG,CHE,2009.0,1,2,-1
MYS,PHL,2007.0,1,1,0
RUS,NZL,2004.0,2,3,-1
THA,NZL,2008.0,1,2,-1
LUX,ESP,2013.0,1,7,-6
DZA,CAN,2004.0,2,1,1
EST,NOR,2014.0,2,1,1
IRN,CZE,2012.0,1,2,-1
SVN,CHN,2023.0,2,3,-1
BRA,POL,2003.0,1,1,0
IRN,CHN,2011.0,3,4,-1
ITA,MOZ,2015.0,1,2,-1
DNK,GRC,2007.0,1,8,-7
TUR,SRB,2006.0,4,1,3
SRB,TUR,2003.0,1,1,0
COG,CAN,2021.0,1,2,-1
ARE,JPN,2020.0,2,4,-2
KHM,JPN,2022.0,1,11,-10
CHN,SYR,2020.0,2,1,1
COD,JPN,2020.0,2,1,1
USA,TLS,2020.0,1,1,0
GHA,ESP,2023.0,1,2,-1
USA,CRI,2023.0,4,14,-10
GBR,SRB,2007.0,3,16,-13
NOR,CHE,2006.0,5,10,-5
URY,ARG,2011.0,1,2,-1
DEU,IDN,1998.0,4,2,2
EGY,PAK,2023.0,2,4,-2
QAT,ESP,2019.0,2,4,-2
FIN,QAT,2013.0,1,1,0
MDG,PYF,2001.0,1,1,0
AUT,ARG,1999.0,2,3,-1
BEL,NZL,2014.0,3,4,-1
BGR,POL,2003.0,3,2,1
CRI,CAN,1999.0,1,2,-1
BGD,NLD,2013.0,4,2,2
SYR,GBR,2008.0,2,5,-3
GRD,JAM,2016.0,1,1,0
SWE,PHL,2018.0,1,1,0
FRA,VNM,1997.0,3,1,2
OMN,FRA,2021.0,2,1,1
TZA,IND,2013.0,2,2,0
ROU,SWE,2015.0,2,2,0
TZA,FRA,2018.0,1,1,0
USA,HTI,2013.0,4,9,-5
JPN,SDN,2012.0,2,1,1
CRI,DEU,2008.0,1,1,0
BLR,GBR,2008.0,2,1,1
AUT,COL,2019.0,2,3,-1
LUX,PRT,2019.0,1,4,-3
LUX,PRT,2021.0,1,5,-4
SAU,BHR,2013.0,3,2,1
PSE,FRA,2010.0,1,1,0
KOR,CZE,2013.0,2,1,1
ZMB,AUS,2018.0,1,1,0
POL,VNM,2018.0,2,2,0
BFA,GBR,2022.0,1,1,0
CAN,KWT,2023.0,6,4,2
ITA,MKD,2021.0,1,1,0
THA,KEN,2018.0,1,1,0
IDN,HUN,2023.0,4,2,2
ECU,FRA,2008.0,1,5,-4
MEX,MYS,2011.0,1,1,0
HRV,NLD,2007.0,1,2,-1
KEN,BEL,2001.0,3,2,1
MLI,FRA,2015.0,6,5,1
SAU,JPN,2006.0,1,3,-2
EGY,PSE,2016.0,2,1,1
BLR,UKR,2013.0,2,1,1
ITA,CUB,2004.0,3,2,1
ISR,ZAF,2008.0,3,1,2
POL,BGR,2016.0,1,2,-1
MYS,IDN,2010.0,12,6,6
VEN,ITA,2014.0,1,1,0
ESP,BOL,2021.0,3,2,1
DEU,TUN,2017.0,4,6,-2
IRL,GHA,2019.0,1,1,0
DEU,NPL,2004.0,2,1,1
CHL,MEX,2004.0,5,4,1
DNK,JPN,2012.0,4,11,-7
CHL,PRT,2012.0,3,1,2
BRA,BOL,2022.0,1,3,-2
LKA,SWE,2014.0,1,2,-1
NLD,HRV,2017.0,1,2,-1
TUN,OMN,2017.0,2,1,1
CUB,ARG,2022.0,1,2,-1
BGR,ROU,2018.0,3,1,2
ROU,AUS,2020.0,1,1,0
MLT,ESP,2020.0,2,1,1
RUS,ARM,2007.0,2,3,-1
SWE,LTU,2004.0,6,3,3
MYS,YEM,2006.0,1,1,0
YEM,MYS,2007.0,2,1,1
CHE,ALB,2004.0,1,1,0
RUS,UZB,2007.0,4,13,-9
ESP,JOR,2012.0,1,1,0
PER,CHL,2010.0,5,1,4
BEL,GHA,2012.0,2,1,1
BGR,AUT,2010.0,2,1,1
UKR,ESP,2023.0,6,2,4
MAC,SAU,2021.0,1,1,0
TZA,KEN,2011.0,2,1,1
CMR,DEU,2003.0,2,2,0
FRA,NGA,1998.0,2,4,-2
CHE,ARM,2013.0,1,2,-1
BOL,FRA,2004.0,2,4,-2
IND,CMR,2016.0,1,1,0
DNK,TUN,2021.0,1,1,0
DEU,MCO,2008.0,1,1,0
NLD,VNM,2013.0,9,1,8
VNM,NLD,2014.0,2,5,-3
FRA,SGP,1999.0,3,2,1
CAN,PAN,2008.0,1,4,-3
BFA,FRA,2001.0,6,10,-4
MEX,PER,2012.0,3,1,2
ROU,DNK,2001.0,5,1,4
DNK,ZAF,2017.0,2,5,-3
GEO,DEU,2018.0,3,3,0
TUN,EGY,2007.0,1,3,-2
AZE,AUT,2020.0,1,1,0
CMR,NLD,2021.0,1,1,0
GHA,SWE,2013.0,1,1,0
NAM,ZAF,2019.0,8,26,-18
POL,IRL,2013.0,5,12,-7
ARM,ROU,2020.0,1,1,0
ETH,JPN,2017.0,2,1,1
AUT,MYS,2014.0,2,2,0
KOR,POL,2014.0,2,1,1
NGA,BEL,2019.0,1,4,-3
NZL,BRN,2017.0,1,1,0
CHE,ETH,2020.0,5,3,2
GHA,CMR,2016.0,2,1,1
ESP,PSE,2018.0,2,1,1
FRA,TGO,2021.0,2,6,-4
SDN,USA,2010.0,1,2,-1
CHE,LIE,2021.0,2,6,-4
DEU,LTU,2023.0,5,2,3
GBR,SDN,2022.0,1,4,-3
CHN,GHA,2010.0,1,1,0
BRA,IND,1999.0,1,9,-8
VEN,SRB,2002.0,1,3,-2
ARE,NZL,2004.0,2,1,1
GBR,PSE,2011.0,1,1,0
ETH,ZWE,2020.0,1,2,-1
PRT,BGD,2019.0,1,2,-1
PRI,BRA,2014.0,4,2,2
AUT,SGP,2021.0,2,3,-1
IND,ERI,2008.0,3,2,1
KEN,TUR,2003.0,1,1,0
ESP,ECU,2006.0,2,3,-1
NLD,NPL,2009.0,2,3,-1
DEU,KAZ,2018.0,4,4,0
NCL,AUS,2014.0,1,1,0
CHE,LAO,2023.0,1,2,-1
ESP,PHL,2009.0,1,5,-4
MYS,PSE,2010.0,1,3,-2
FRA,BGD,2021.0,2,2,0
LUX,SGP,2021.0,1,2,-1
ROU,DNK,2015.0,2,1,1
DZA,MYS,2021.0,1,6,-5
EST,IND,2023.0,5,8,-3
CIV,GBR,2018.0,1,2,-1
HUN,RUS,2023.0,1,2,-1
PRY,BRA,2014.0,3,4,-1
BFA,USA,2017.0,3,4,-1
KAZ,UZB,2022.0,2,2,0
NGA,SAU,2005.0,1,1,0
SRB,RUS,2013.0,3,4,-1
BRN,AUS,1999.0,1,4,-3
GBR,SVN,1997.0,1,2,-1
FIN,HUN,2018.0,3,3,0
SAU,TUR,2023.0,5,5,0
SRB,VEN,1999.0,1,1,0
ARE,KWT,2004.0,2,4,-2
AUT,SRB,2004.0,2,5,-3
AUS,BGD,2002.0,2,3,-1
AUS,SVN,2008.0,1,2,-1
SRB,IRL,2016.0,1,2,-1
LUX,ITA,2011.0,1,5,-4
DEU,CMR,2018.0,3,8,-5
ABW,NLD,2013.0,1,1,0
ESP,PRY,2014.0,1,3,-2
THA,NZL,2023.0,1,3,-2
NOR,MEX,2007.0,2,1,1
PRT,LUX,2020.0,2,2,0
DMA,DOM,2020.0,4,4,0
ZAF,ARE,2007.0,1,1,0
PSE,JPN,2015.0,1,1,0
VNM,RUS,2016.0,5,14,-9
HRV,CAN,2023.0,1,1,0
SAU,BGD,2000.0,1,1,0
TUR,GRC,2016.0,4,7,-3
CHN,EGY,2005.0,3,2,1
ZAF,CAF,2004.0,2,3,-1
GBR,CMR,2009.0,2,3,-1
BEN,TGO,2010.0,1,1,0
GBR,SYR,2005.0,1,1,0
AUT,COL,2003.0,1,1,0
TWN,NLD,2002.0,1,1,0
SGP,LKA,2010.0,1,2,-1
KOR,QAT,2013.0,6,3,3
PAN,CRI,2022.0,2,1,1
ETH,HKG,2022.0,2,2,0
PSE,QAT,2021.0,3,1,2
IRN,ROU,2023.0,1,1,0
LBR,GBR,2022.0,1,1,0
CAN,ISL,2002.0,2,1,1
UKR,CHN,2004.0,1,1,0
ARE,KWT,2011.0,3,1,2
ITA,UGA,2009.0,1,1,0
TUR,NZL,1997.0,3,1,2
NGA,JPN,2003.0,4,5,-1
SWE,KAZ,2019.0,3,1,2
USA,SEN,2023.0,3,6,-3
ZAF,SWE,2000.0,2,7,-5
CZE,THA,2008.0,1,2,-1
BRN,AUS,2016.0,2,3,-1
SAU,CYP,2019.0,1,1,0
AUS,ROU,2013.0,3,3,0
AUS,SLB,2022.0,2,2,0
ARG,NLD,2021.0,7,3,4
DEU,LIE,2018.0,1,3,-2
CAN,KEN,2012.0,4,4,0
PER,ECU,2015.0,3,1,2
FRA,ZWE,2018.0,4,1,3
ETH,MYS,2016.0,1,1,0
TWN,MAC,2017.0,2,2,0
ETH,JPN,2020.0,3,8,-5
USA,ISL,2012.0,13,11,2
RUS,BRA,2009.0,2,4,-2
SGP,ARG,2016.0,2,2,0
FRA,CUB,2015.0,5,5,0
TWN,GRC,2008.0,1,1,0
NZL,ARG,1999.0,1,1,0
LAO,USA,2013.0,2,1,1
DZA,SAU,2007.0,6,2,4
BRA,URY,2003.0,3,3,0
FIN,BRA,2012.0,3,4,-1
MLI,USA,2008.0,2,4,-2
SYR,GBR,2003.0,2,3,-1
TZA,ITA,2017.0,2,1,1
NZL,THA,2014.0,9,2,7
LBN,ARE,2016.0,1,2,-1
EST,ZAF,2017.0,1,1,0
SVK,DNK,2014.0,1,1,0
IRQ,TUR,2015.0,3,6,-3
CMR,BEL,2017.0,2,4,-2
ISR,URY,2016.0,1,1,0
IRN,TUR,2024.0,1,1,0
GBR,MAR,2006.0,2,1,1
TGO,BEN,2012.0,3,2,1
USA,SDN,2013.0,2,3,-1
SVN,CZE,2009.0,3,2,1
CRI,FRA,2016.0,4,5,-1
NOR,MEX,2022.0,2,2,0
BHR,IRL,2016.0,4,2,2
BFA,NER,2016.0,1,1,0
LAO,GBR,2015.0,1,2,-1
KWT,QAT,2018.0,2,1,1
CAN,VNM,2013.0,5,1,4
SWE,BGD,1998.0,1,2,-1
OMN,USA,2013.0,3,9,-6
ISR,ZAF,2019.0,2,4,-2
LKA,USA,1999.0,5,7,-2
LUX,ESP,2008.0,2,4,-2
ARG,BEL,1998.0,1,1,0
HKG,HUN,2002.0,1,2,-1
CAN,QAT,2007.0,4,1,3
CAN,EST,2023.0,1,2,-1
ZAF,POL,2019.0,5,4,1
ITA,UGA,2019.0,3,6,-3
EGY,CZE,2016.0,3,7,-4
SWE,SAU,2015.0,4,3,1
KGZ,IND,2023.0,1,1,0
KEN,NLD,2017.0,4,8,-4
EGY,OMN,2015.0,6,5,1
SGP,SWE,2000.0,4,3,1
MLI,SWE,2009.0,1,1,0
CHE,TUN,2020.0,1,2,-1
ESP,UKR,2022.0,2,6,-4
RUS,KGZ,1997.0,2,1,1
MEX,NZL,2022.0,3,1,2
DEU,SLE,2019.0,2,1,1
SLV,USA,2005.0,2,2,0
COL,JPN,2019.0,2,2,0
MLI,CIV,2012.0,4,4,0
GEO,GBR,2001.0,1,1,0
TWN,GRC,2015.0,1,1,0
GIB,GBR,2005.0,1,2,-1
TZA,GBR,2006.0,8,13,-5
MLT,CHE,2017.0,1,1,0
JPN,ETH,2003.0,1,2,-1
AUS,TZA,2004.0,1,1,0
NLD,EST,2001.0,1,1,0
GTM,USA,2004.0,2,8,-6
IRL,ITA,2002.0,7,10,-3
EGY,PSE,2007.0,1,1,0
POL,ROU,2017.0,1,5,-4
CHE,MNG,2008.0,1,1,0
DEU,ARM,2010.0,1,6,-5
NLD,SUR,2018.0,3,3,0
COL,DEU,2003.0,4,6,-2
JOR,AUS,2012.0,2,6,-4
BGR,POL,2008.0,1,2,-1
MYS,TUR,2014.0,2,2,0
UZB,KOR,2006.0,2,3,-1
IRN,HKG,2015.0,5,1,4
MMR,USA,2023.0,1,2,-1
EGY,PAK,2019.0,2,3,-1
PAK,CAN,1999.0,3,4,-1
PRI,ESP,2008.0,1,3,-2
POL,BGR,1999.0,1,1,0
ECU,MEX,2000.0,1,1,0
JPN,BIH,2018.0,1,1,0
CMR,SWE,2012.0,1,1,0
CZE,SVN,2021.0,5,3,2
TWN,ISR,2018.0,1,1,0
SLV,ESP,2019.0,2,6,-4
GHA,SLE,2021.0,1,1,0
MLI,MRT,2019.0,2,1,1
CAN,IDN,2023.0,1,4,-3
BWA,GBR,2015.0,3,2,1
OMN,NZL,2008.0,1,1,0
GRC,IRQ,2020.0,2,1,1
KOR,TWN,1998.0,2,4,-2
COL,CHL,2007.0,4,9,-5
SYR,MAR,2021.0,1,1,0
KOR,MEX,2007.0,1,3,-2
USA,SYR,2021.0,4,3,1
BRA,SRB,2005.0,1,6,-5
HUN,DNK,2002.0,6,4,2
AFG,IND,2018.0,1,1,0
TUN,MAR,2001.0,1,2,-1
ISR,SRB,2017.0,1,2,-1
CAN,SRB,2012.0,3,1,2
GEO,FRA,2005.0,1,1,0
PHL,VNM,2023.0,3,1,2
IRQ,IDN,2020.0,3,1,2
GRC,SRB,2020.0,4,1,3
ZAF,COL,2019.0,2,2,0
UKR,KOR,2019.0,1,4,-3
CHE,MOZ,2018.0,1,2,-1
KAZ,POL,2021.0,1,4,-3
RUS,MYS,2021.0,2,4,-2
USA,MKD,2002.0,2,2,0
BRA,POL,2008.0,2,2,0
COL,ARG,2007.0,3,4,-1
NZL,JOR,2008.0,1,2,-1
PRI,IRL,2010.0,1,1,0
TWN,ISR,2017.0,3,4,-1
OMN,IND,2009.0,4,17,-13
PHL,FRA,2022.0,2,1,1
NLD,CZE,2004.0,3,6,-3
ARG,CUB,2008.0,2,1,1
KOR,BEL,1997.0,2,2,0
ABW,USA,2023.0,1,0,1
NZL,GRC,2009.0,1,0,1
SVK,HRV,2023.0,1,0,1
KOR,MCO,2000.0,1,0,1
QAT,CHN,2013.0,1,0,1
ARM,BEL,2009.0,1,0,1
ZMB,LKA,2018.0,1,0,1
KAZ,AUT,2017.0,2,0,2
EST,BRA,2023.0,2,0,2
NRU,,2024.0,1,0,1
PAK,VNM,2017.0,1,0,1
CIV,ROU,2019.0,1,0,1
GIN,CAF,2017.0,1,0,1
GHA,ARE,2022.0,1,0,1
BEL,MWI,2022.0,1,0,1
NGA,LBR,2017.0,2,0,2
FLK,DEU,2017.0,1,0,1
ISR,EGY,2010.0,1,0,1
PHL,ARE,2016.0,1,0,1
MEX,SVK,1997.0,1,0,1
UZB,MMR,2015.0,1,0,1
GMB,CAF,2022.0,1,0,1
AUT,URY,2023.0,1,0,1
KOR,VEN,2005.0,1,0,1
VEN,KOR,2007.0,1,0,1
CRI,SLV,2022.0,2,0,2
,VIR,2004.0,7,0,7
SVN,IRN,2023.0,1,0,1
URY,NLD,2022.0,2,0,2
NGA,LBR,2022.0,1,0,1
KEN,BFA,2020.0,2,0,2
BFA,BEN,2023.0,1,0,1
MDV,LKA,2022.0,1,0,1
LVA,ETH,2022.0,1,0,1
IND,BRN,2022.0,2,0,2
BWA,MWI,2023.0,1,0,1
BEL,MKD,2023.0,1,0,1
POL,NZL,2002.0,3,0,3
COD,NGA,2018.0,1,0,1
BWA,KEN,2010.0,1,0,1
IRL,CHL,2003.0,1,0,1
AFG,SAU,2018.0,1,0,1
USA,WSM,2005.0,1,0,1
CYP,MAR,2011.0,1,0,1
NIC,NOR,2001.0,2,0,2
ARG,NGA,2016.0,1,0,1
PAK,TZA,2023.0,3,0,3
LAO,,2007.0,3,0,3
,MRT,1997.0,4,0,4
SWE,MOZ,2007.0,1,0,1
GUF,DEU,2006.0,1,0,1
BLR,LVA,2015.0,1,0,1
CHE,LTU,2002.0,1,0,1
,BHS,2002.0,2,0,2
MYS,IDN,2000.0,2,0,2
CAN,TTO,2002.0,3,0,3
MWI,CAF,2000.0,1,0,1
DEU,FJI,2007.0,1,0,1
TUR,EGY,2001.0,2,0,2
GBR,LSO,2008.0,2,0,2
SDN,SWE,2002.0,2,0,2
,LSO,1998.0,1,0,1
IND,MLI,1999.0,1,0,1
PAN,JPN,2005.0,1,0,1
FRA,KWT,2006.0,1,0,1
MRT,,2013.0,6,0,6
IND,KEN,2015.0,4,0,4
GIN,USA,1999.0,1,0,1
GIN,USA,1998.0,1,0,1
BMU,,2018.0,2,0,2
BWA,BRN,2012.0,1,0,1
MKD,,2002.0,4,0,4
VNM,IND,2000.0,1,0,1
MYS,KEN,2001.0,1,0,1
CCK,COG,2015.0,1,0,1
GIN,,2004.0,2,0,2
KOR,COL,2018.0,2,0,2
PRT,MKD,2013.0,1,0,1
AUT,ISR,2001.0,2,0,2
ZAF,SHN,2003.0,1,0,1
MAC,GBR,2012.0,1,0,1
HRV,AUT,2004.0,2,0,2
CMR,IDN,2008.0,2,0,2
BFA,GIN,2016.0,2,0,2
DEU,URY,2000.0,1,0,1
PRT,ECU,2012.0,1,0,1
CMR,DNK,2011.0,1,0,1
,GRL,2005.0,6,0,6
SDN,PHL,2021.0,2,0,2
TUR,FIN,2013.0,2,0,2
PYF,AUS,2008.0,1,0,1
MOZ,,2005.0,3,0,3
KAZ,NLD,2011.0,1,0,1
KOR,SVK,2016.0,2,0,2
MOZ,TTO,2017.0,1,0,1
GHA,GIN,2008.0,1,0,1
TWN,UKR,2014.0,3,0,3
ROU,EST,2009.0,2,0,2
SVK,SWE,2000.0,3,0,3
BRB,BRA,2015.0,1,0,1
PHL,IRN,2008.0,1,0,1
JOR,IND,2012.0,1,0,1
HKG,ARE,2014.0,1,0,1
ZAF,LKA,2010.0,1,0,1
ESP,CMR,2001.0,1,0,1
CHE,AND,2022.0,1,0,1
IND,ISL,2012.0,1,0,1
,VUT,2009.0,2,0,2
EST,NOR,2010.0,1,0,1
,WLF,2009.0,3,0,3
LTU,NPL,2012.0,1,0,1
CHN,NER,2015.0,1,0,1
PAK,IRQ,2013.0,2,0,2
ITA,KOR,1998.0,1,0,1
NOR,MAR,2023.0,1,0,1
FRA,NIC,2019.0,1,0,1
ALB,BEL,2013.0,2,0,2
ISR,JOR,2012.0,2,0,2
CHN,UGA,2009.0,1,0,1
PRT,MAC,2011.0,1,0,1
SVK,NLD,2011.0,10,0,10
MNE,BGR,2015.0,1,0,1
SVN,CHN,2008.0,2,0,2
JPN,QAT,2016.0,2,0,2
FIN,ZMB,2020.0,1,0,1
,STP,2012.0,2,0,2
BEL,BOL,2020.0,1,0,1
CHN,JAM,2020.0,2,0,2
VNM,MAC,2018.0,1,0,1
FIN,PSE,2013.0,2,0,2
SLV,HRV,2018.0,1,0,1
ZWE,FRA,1998.0,1,0,1
SRB,EUE,2020.0,1,0,1
EUE,SRB,2021.0,1,0,1
SAU,NLD,2002.0,3,0,3
NLD,MDV,2012.0,1,0,1
UZB,CZE,2017.0,1,0,1
BGR,KAZ,2017.0,1,0,1
HND,MEX,2020.0,1,0,1
TUR,TUN,2018.0,3,0,3
MWI,SOM,2017.0,1,0,1
KGZ,UKR,2020.0,2,0,2
BEL,HTI,2021.0,1,0,1
UKR,HUN,2020.0,2,0,2
ROU,KAZ,2019.0,1,0,1
KOR,MMR,2022.0,1,0,1
TCA,,2024.0,2,0,2
URY,IRL,2022.0,1,0,1
SGP,LKA,2023.0,2,0,2
IRL,FJI,2019.0,1,0,1
VEN,CRI,2017.0,1,0,1
OMN,NLD,2012.0,2,0,2
LVA,NLD,1997.0,1,0,1
LVA,NLD,2002.0,1,0,1
LVA,NLD,2005.0,1,0,1
NZL,MCO,2021.0,1,0,1
PAK,VNM,2018.0,4,0,4
NLD,RWA,2005.0,1,0,1
NLD,CHL,1999.0,1,0,1
HKG,BGD,1997.0,1,0,1
JPN,KWT,2011.0,1,0,1
ITA,MCO,2001.0,2,0,2
MCO,ITA,2002.0,1,0,1
PRT,LUX,2007.0,1,0,1
MYS,NZL,1997.0,2,0,2
VCT,IRL,1998.0,1,0,1
PRI,BRA,2001.0,2,0,2
HUN,NZL,2008.0,2,0,2
PRI,CRI,2005.0,1,0,1
ZAF,PAN,1999.0,1,0,1
PAN,ZAF,2001.0,1,0,1
CZE,SAU,2004.0,1,0,1
CHE,KWT,1997.0,1,0,1
PNG,JAM,2001.0,1,0,1
IDN,VEN,2000.0,1,0,1
GBR,UZB,2006.0,1,0,1
MEX,NIC,2004.0,2,0,2
NIC,SLV,2016.0,1,0,1
,CYM,2009.0,5,0,5
ZAF,LKA,2023.0,1,0,1
HTI,ISR,2017.0,1,0,1
JPN,BIH,2020.0,1,0,1
GEO,KOR,2011.0,1,0,1
POL,UZB,2016.0,1,0,1
DEU,TUR,2024.0,1,0,1
DZA,RUS,2018.0,2,0,2
MYS,MEX,2017.0,1,0,1
ARE,ISL,2018.0,1,0,1
GBR,SYC,2012.0,1,0,1
HKG,MEX,2015.0,1,0,1
GBR,GTM,2012.0,1,0,1
IRN,PAK,2024.0,1,0,1
LUX,JPN,2013.0,1,0,1
PRI,CHE,2014.0,1,0,1
AGO,RUS,2012.0,1,0,1
MUS,SWE,2009.0,1,0,1
DEU,LBY,2014.0,2,0,2
NGA,JOR,2017.0,1,0,1
CZE,UGA,2020.0,1,0,1
SLE,,2001.0,2,0,2
SEN,KEN,2008.0,1,0,1
MYS,UGA,2019.0,2,0,2
VNM,BRA,2022.0,1,0,1
AUS,SWZ,2015.0,1,0,1
VUT,FRA,2003.0,1,0,1
NZL,TWN,1999.0,1,0,1
BGD,IRN,2014.0,1,0,1
COL,CHN,2004.0,1,0,1
IND,KAZ,2016.0,2,0,2
TWN,JOR,2020.0,3,0,3
FRA,FLK,2017.0,1,0,1
KOR,GRC,2014.0,1,0,1
UGA,SGP,2021.0,2,0,2
ESP,CMR,2015.0,1,0,1
AUS,TON,2019.0,1,0,1
CAN,CYM,2019.0,1,0,1
CYM,CAN,2021.0,1,0,1
,MSR,2018.0,1,0,1
,NFK,2020.0,1,0,1
NER,FRA,2023.0,1,0,1
GBR,FIN,2024.0,1,0,1
EUE,TUR,2022.0,1,0,1
TZA,ETH,2023.0,4,0,4
,MEX,2021.0,18,0,18
KEN,BDI,2022.0,2,0,2
CRI,JPN,2010.0,1,0,1
MEX,HKG,2002.0,2,0,2
NLD,COG,2007.0,1,0,1
GRC,ARM,2006.0,2,0,2
MEX,ROU,2022.0,1,0,1
PHL,MOZ,2014.0,1,0,1
BGR,GLP,2009.0,1,0,1
SVN,MNE,2010.0,1,0,1
CAN,CMR,2004.0,2,0,2
MOZ,ZAF,2000.0,1,0,1
JPN,ZWE,2014.0,1,0,1
MYS,PNG,2012.0,2,0,2
ZAF,TUR,2008.0,2,0,2
ROU,IRL,2006.0,3,0,3
BEN,PHL,2014.0,1,0,1
GLP,CAN,2005.0,2,0,2
BMU,,2017.0,2,0,2
CHL,LBN,2007.0,1,0,1
OMN,TUN,2007.0,1,0,1
PER,IND,2012.0,1,0,1
NER,BOL,2002.0,1,0,1
UKR,AUS,2023.0,1,0,1
DNK,LKA,2006.0,1,0,1
UGA,PAK,2021.0,1,0,1
EST,SVK,2018.0,1,0,1
GRD,POL,2011.0,1,0,1
WSM,AUS,2007.0,3,0,3
SRB,IRL,2018.0,2,0,2
MCO,LTU,2010.0,1,0,1
MYS,BRN,2006.0,2,0,2
GEO,KOR,2009.0,1,0,1
PRI,SVN,2015.0,1,0,1
USA,BTN,2018.0,1,0,1
AUS,PSE,2020.0,1,0,1
UKR,ROU,2007.0,1,0,1
URY,NLD,2018.0,2,0,2
AUT,TWN,2019.0,2,0,2
URY,ECU,2008.0,1,0,1
MYS,SEN,2014.0,1,0,1
FIN,SDN,2019.0,1,0,1
CHE,NPL,2021.0,2,0,2
NGA,FIN,2023.0,2,0,2
TZA,ESP,1999.0,1,0,1
VNM,IDN,2012.0,1,0,1
TUR,GEO,2017.0,2,0,2
TUR,GEO,2022.0,1,0,1
ISL,POL,2019.0,3,0,3
LAO,LUX,2021.0,1,0,1
BRN,UGA,2023.0,1,0,1
COL,BOL,2009.0,1,0,1
OMN,IRL,2009.0,1,0,1
CAN,BRB,2017.0,2,0,2
DNK,IDN,2020.0,1,0,1
,ASM,2007.0,1,0,1
AUT,BIH,2016.0,1,0,1
,MDV,2009.0,6,0,6
BRB,BRA,2014.0,2,0,2
KEN,MLI,2010.0,1,0,1
PAK,IDN,2018.0,3,0,3
BEN,CMR,2022.0,1,0,1
CHN,PSE,2023.0,2,0,2
,COM,2018.0,1,0,1
BHR,IND,2013.0,1,0,1
BFA,TGO,2001.0,1,0,1
PAK,NPL,2013.0,4,0,4
USA,LCA,2012.0,1,0,1
JOR,AFG,2023.0,1,0,1
IRL,SRB,2011.0,1,0,1
COG,GIN,2020.0,2,0,2
,MAC,2021.0,18,0,18
EST,VNM,2022.0,2,0,2
,NPL,2021.0,7,0,7
TUR,IND,2024.0,1,0,1
THA,CHN,2024.0,2,0,2
NLD,BEN,2021.0,3,0,3
,ARE,2021.0,13,0,13
HKG,BEL,2001.0,1,0,1
BEN,,2000.0,7,0,7
PRI,PRT,2004.0,1,0,1
ITA,MDG,2004.0,2,0,2
BGR,CYP,2012.0,2,0,2
,DJI,1996.0,1,0,1
CAN,GLP,2002.0,1,0,1
GNQ,CIV,2006.0,1,0,1
GLP,MTQ,2007.0,1,0,1
IRL,KNA,2013.0,1,0,1
CHE,COG,2003.0,1,0,1
BFA,DNK,2005.0,1,0,1
SYR,POL,2023.0,1,0,1
FIN,ETH,2006.0,1,0,1
LSO,,2012.0,2,0,2
SYR,SRB,2003.0,1,0,1
OMN,BEN,2014.0,1,0,1
ISL,FIN,1999.0,2,0,2
CZE,SVN,2008.0,2,0,2
SGP,UKR,2010.0,1,0,1
BHS,CAN,2008.0,1,0,1
ESP,SVN,2005.0,1,0,1
FRA,SDN,2003.0,7,0,7
ZWE,RWA,2007.0,2,0,2
LBN,EGY,1998.0,1,0,1
OMN,BWA,2016.0,1,0,1
MYS,SDN,2000.0,1,0,1
MLI,ESP,2000.0,1,0,1
YEM,SAU,2003.0,1,0,1
BHS,,2006.0,1,0,1
UKR,CHL,2000.0,1,0,1
TZA,ZAF,1999.0,2,0,2
HKG,GRC,2002.0,1,0,1
MLI,ZAF,2008.0,1,0,1
ZAF,MLI,2010.0,1,0,1
CMR,CAN,1999.0,2,0,2
EGY,PHL,2018.0,2,0,2
WSM,ASM,2006.0,1,0,1
TUR,VNM,2019.0,7,0,7
IRN,TWN,2009.0,3,0,3
DEU,MLT,2011.0,1,0,1
ISR,LBN,2017.0,1,0,1
PER,COD,2018.0,1,0,1
AUS,VEN,2009.0,1,0,1
KOR,PRT,2015.0,2,0,2
MYS,EGY,1997.0,1,0,1
BHR,HUN,2001.0,1,0,1
JPN,COL,2007.0,1,0,1
ZWE,BFA,2014.0,1,0,1
POL,TTO,2020.0,1,0,1
TUN,BGR,2011.0,1,0,1
DEU,GUY,2002.0,1,0,1
NOR,LBY,2012.0,1,0,1
FJI,DEU,2009.0,2,0,2
FJI,VUT,2021.0,1,0,1
PHL,MYS,2001.0,1,0,1
ARE,SDN,1998.0,1,0,1
BEN,BDI,2018.0,1,0,1
THA,GRC,2013.0,2,0,2
LAO,IDN,2019.0,1,0,1
IRL,MLT,2022.0,1,0,1
CMR,TCD,2022.0,1,0,1
CHN,SVK,2009.0,1,0,1
MWI,BRA,2022.0,1,0,1
TGO,TTO,2019.0,1,0,1
NLD,GAB,2023.0,1,0,1
IRN,LBN,2022.0,2,0,2
UGA,SOM,2022.0,1,0,1
ARM,GRC,2001.0,1,0,1
JPN,GRC,2001.0,2,0,2
SYC,AUS,2017.0,1,0,1
JPN,GIN,2014.0,1,0,1
ESP,BFA,2010.0,1,0,1
KEN,FRA,2007.0,2,0,2
SAU,DNK,2009.0,1,0,1
SOM,,2001.0,1,0,1
QAT,TUR,2000.0,1,0,1
ITA,ZAF,1998.0,2,0,2
EGY,JOR,2000.0,3,0,3
GIN,BFA,1999.0,1,0,1
IRL,MYS,1997.0,2,0,2
BLR,SVN,1998.0,1,0,1
IRL,JOR,2002.0,2,0,2
CHE,KWT,2005.0,1,0,1
CIV,KEN,2001.0,1,0,1
BLR,FIN,1997.0,1,0,1
FIN,BLR,2004.0,1,0,1
LKA,DEU,2003.0,1,0,1
IRN,SGP,1999.0,1,0,1
MSR,,2009.0,3,0,3
FJI,NZL,2002.0,1,0,1
ITA,NIC,2000.0,2,0,2
CAF,BEL,2011.0,1,0,1
SLE,TUN,2008.0,1,0,1
BRA,IRL,1998.0,1,0,1
FRA,BIH,2009.0,1,0,1
URY,ZAF,2006.0,1,0,1
PRT,MAR,2000.0,1,0,1
ETH,CHE,2005.0,1,0,1
HUN,TUR,2006.0,1,0,1
DNK,HKG,2004.0,1,0,1
PAK,ISR,1999.0,2,0,2
USA,NER,2019.0,2,0,2
NER,CHE,2021.0,1,0,1
MAC,BRA,2018.0,1,0,1
SVK,SLE,2017.0,1,0,1
VUT,NLD,2015.0,1,0,1
PAN,PER,2015.0,1,0,1
ESP,EUE,2005.0,2,0,2
NOR,KEN,2019.0,1,0,1
PAN,ISR,2016.0,2,0,2
NLD,ARM,2018.0,1,0,1
BEL,CYP,2010.0,1,0,1
SWE,HKG,1998.0,1,0,1
ESP,SLV,2011.0,1,0,1
IRL,CYP,2007.0,1,0,1
VEN,NLD,2008.0,3,0,3
CIV,SAU,2013.0,1,0,1
AZE,PRT,2020.0,1,0,1
MWI,CAF,2010.0,1,0,1
ITA,UGA,2008.0,1,0,1
COD,LAO,2010.0,1,0,1
COD,BDI,2018.0,1,0,1
BDI,THA,2022.0,1,0,1
BOL,NLD,2002.0,2,0,2
SAU,CHL,2016.0,1,0,1
GEO,AUS,2015.0,1,0,1
GRD,GBR,2020.0,1,0,1
LKA,AUT,2021.0,1,0,1
COM,ETH,2009.0,1,0,1
TZA,MDG,2018.0,1,0,1
HRV,JPN,2023.0,1,0,1
BGD,AFG,2006.0,1,0,1
GHA,FRA,2000.0,1,0,1
UZB,BEL,2006.0,1,0,1
SDN,SVK,2017.0,2,0,2
AUT,LIE,2006.0,2,0,2
COL,ARE,2023.0,2,0,2
COL,AUT,2006.0,1,0,1
IRQ,ARE,2016.0,2,0,2
NIC,COL,2018.0,2,0,2
RUS,BRN,2015.0,1,0,1
SLV,HRV,2017.0,1,0,1
AZE,UZB,2013.0,1,0,1
MUS,IND,1997.0,1,0,1
BLR,SWE,2017.0,2,0,2
QAT,CYP,2017.0,1,0,1
SLE,KEN,2011.0,1,0,1
HRV,NPL,2021.0,1,0,1
GRC,ALB,2023.0,1,0,1
HKG,QAT,2012.0,2,0,2
DEU,KWT,2013.0,1,0,1
THA,HUN,2017.0,1,0,1
CRI,CUB,2020.0,1,0,1
EGY,EST,2020.0,1,0,1
KHM,COG,2022.0,1,0,1
USA,MNP,2013.0,1,0,1
ZMB,DNK,2019.0,1,0,1
IND,CYM,2019.0,1,0,1
,SHN,2013.0,1,0,1
,PLW,2008.0,5,0,5
TZA,ZWE,2020.0,1,0,1
GBR,JEY,2021.0,1,0,1
TUN,HUN,2021.0,2,0,2
PHL,DZA,2021.0,1,0,1
MYS,SAU,2007.0,2,0,2
MEX,ISL,2021.0,1,0,1
LKA,NOR,2006.0,1,0,1
DEU,PRY,2020.0,2,0,2
CPV,PAN,2022.0,1,0,1
HUN,NOR,2023.0,1,0,1
IDN,MMR,2022.0,2,0,2
MCO,USA,2002.0,2,0,2
AUS,ISL,2013.0,1,0,1
BEL,TUN,1997.0,3,0,3
FRA,CUB,2011.0,1,0,1
ECU,PER,2003.0,1,0,1
LTU,LUX,2008.0,1,0,1
SGP,PRI,2004.0,1,0,1
EGY,LBN,2000.0,1,0,1
,SPM,2010.0,1,0,1
BRB,ATG,2010.0,1,0,1
,BRN,2001.0,3,0,3
HUN,RUS,2006.0,1,0,1
HUN,BRA,1999.0,1,0,1
ARE,KWT,2008.0,1,0,1
GUY,GBR,1997.0,1,0,1
GBR,CUB,2001.0,3,0,3
QAT,SAU,2007.0,3,0,3
IRL,MLT,2016.0,1,0,1
NPL,AUS,1999.0,1,0,1
GBR,KNA,2022.0,1,0,1
STP,,2012.0,1,0,1
KEN,THA,2004.0,1,0,1
ZAF,TCD,2002.0,1,0,1
BEL,MMR,2020.0,1,0,1
IND,DZA,2016.0,1,0,1
COL,MLI,2017.0,1,0,1
POL,LUX,2014.0,2,0,2
CHN,MUS,2012.0,2,0,2
DEU,MLI,2007.0,1,0,1
ZMB,TZA,2017.0,1,0,1
LUX,ROU,2014.0,1,0,1
EST,JPN,2018.0,2,0,2
ALB,MKD,2016.0,1,0,1
BEL,TGO,2012.0,1,0,1
BEL,LAO,2013.0,1,0,1
BEL,JOR,2013.0,1,0,1
LVA,CAN,2016.0,1,0,1
SVN,BEL,2024.0,1,0,1
NGA,KWT,2022.0,1,0,1
CHE,DOM,2020.0,1,0,1
TUN,EGY,1999.0,1,0,1
PHL,IDN,2006.0,1,0,1
BEL,LBY,2010.0,1,0,1
CZE,ROU,2011.0,1,0,1
GIN,BFA,2020.0,1,0,1
ERI,SAU,2012.0,1,0,1
NPL,ESP,2017.0,1,0,1
NOR,CHL,2005.0,1,0,1
SLE,,2015.0,4,0,4
BGD,TUR,2011.0,1,0,1
USA,ALB,2007.0,2,0,2
GBR,MUS,2014.0,2,0,2
MAC,AUS,2011.0,1,0,1
NER,CHE,2009.0,1,0,1
RWA,,2006.0,2,0,2
SLV,,2003.0,1,0,1
TUR,JOR,2005.0,2,0,2
SWE,COG,2001.0,2,0,2
POL,MCO,2017.0,1,0,1
,MNP,1996.0,1,0,1
PYF,CAN,2008.0,1,0,1
GBR,ARM,2001.0,2,0,2
TUR,IRL,2003.0,2,0,2
TUV,RUS,2019.0,1,0,1
NOR,IRN,2004.0,1,0,1
IRN,NOR,2005.0,2,0,2
GBR,GIB,2004.0,1,0,1
TON,FJI,2005.0,2,0,2
MEX,ISR,1998.0,2,0,2
PRT,URY,2012.0,1,0,1
ITA,AGO,1998.0,2,0,2
ROU,BLR,2009.0,1,0,1
MAR,SAU,2014.0,1,0,1
SAU,TWN,2007.0,1,0,1
PHL,IRN,2001.0,1,0,1
TGO,NCL,2008.0,1,0,1
UZB,CZE,2022.0,1,0,1
WSM,CAN,2003.0,1,0,1
GRC,PHL,2001.0,2,0,2
NLD,SLE,2023.0,1,0,1
DEU,SDN,2001.0,1,0,1
JPN,BEN,2017.0,2,0,2
PRY,JPN,2000.0,1,0,1
MLT,,2006.0,3,0,3
UGA,UKR,2019.0,1,0,1
JPN,KAZ,1997.0,1,0,1
BLZ,,2008.0,2,0,2
DEU,TGO,2001.0,1,0,1
MDG,ESP,2021.0,1,0,1
YEM,GBR,2004.0,1,0,1
,GNB,1996.0,1,0,1
GNB,ZAF,2013.0,1,0,1
DEU,TZA,2002.0,2,0,2
CAN,LAO,2003.0,1,0,1
CMR,IDN,2001.0,1,0,1
KHM,,2007.0,4,0,4
COL,PRI,2001.0,3,0,3
MOZ,DNK,2001.0,1,0,1
LBN,MLT,2016.0,1,0,1
BRN,MYS,1997.0,2,0,2
MLI,PER,2007.0,1,0,1
MLI,PER,2020.0,1,0,1
MYS,NCL,2007.0,1,0,1
ZAF,THA,2000.0,1,0,1
IRL,MYS,2002.0,1,0,1
LTU,TWN,2002.0,2,0,2
ARG,CHN,2001.0,1,0,1
HKG,JOR,2016.0,1,0,1
ZMB,RWA,2013.0,1,0,1
CPV,USA,2004.0,1,0,1
CHL,PYF,2022.0,1,0,1
FRA,KWT,2010.0,2,0,2
NZL,QAT,2009.0,1,0,1
POL,ROU,2007.0,2,0,2
GIN,,2008.0,5,0,5
GIN,PNG,2017.0,1,0,1
CYP,AUS,2001.0,1,0,1
KEN,MYS,2011.0,1,0,1
,CAF,2004.0,11,0,11
SRB,POL,2021.0,1,0,1
FRA,SWZ,2002.0,1,0,1
KGZ,DEU,2013.0,1,0,1
GIB,,2009.0,1,0,1
GNQ,BRA,2009.0,1,0,1
SYR,AUS,2002.0,1,0,1
SAU,HKG,2006.0,2,0,2
FRA,LBY,2018.0,4,0,4
IRN,PRT,2009.0,1,0,1
GBR,KIR,2006.0,1,0,1
,MHL,2004.0,4,0,4
KEN,MAR,2021.0,1,0,1
MOZ,PSE,2001.0,1,0,1
CAN,SVN,2000.0,1,0,1
PRY,DEU,2014.0,1,0,1
GBR,MKD,2011.0,3,0,3
LCA,GUY,2011.0,1,0,1
NOR,ISR,2017.0,1,0,1
VNM,SVK,2013.0,1,0,1
CAN,PAN,2015.0,2,0,2
BLR,GBR,2023.0,2,0,2
MMR,MYS,2004.0,1,0,1
URY,GBR,2021.0,2,0,2
GEO,AUS,2008.0,1,0,1
VNM,MYS,2024.0,1,0,1
JAM,AUS,2015.0,1,0,1
BWA,CAN,2021.0,2,0,2
NLD,DOM,2007.0,1,0,1
ISR,UZB,2018.0,1,0,1
MDV,GBR,2003.0,1,0,1
BRA,HKG,2000.0,1,0,1
SOM,,2014.0,1,0,1
MDG,KHM,2004.0,1,0,1
RUS,SVN,2000.0,2,0,2
ESP,ZAF,2001.0,2,0,2
KOR,PAN,2017.0,1,0,1
BEL,PER,2016.0,3,0,3
THA,TZA,2017.0,1,0,1
ITA,BFA,2014.0,1,0,1
NCL,PYF,2012.0,1,0,1
TUN,ARE,2008.0,1,0,1
ARE,TUN,2010.0,1,0,1
VNM,BGD,2021.0,3,0,3
KOR,PNG,2019.0,1,0,1
IDN,TZA,2014.0,1,0,1
BEL,ARE,2017.0,3,0,3
ARM,MEX,2016.0,2,0,2
GEO,PAK,2008.0,1,0,1
ETH,CIV,2016.0,1,0,1
MEX,CYP,2017.0,1,0,1
YEM,USA,2017.0,1,0,1
ALB,BGR,2019.0,1,0,1
NER,ZAF,2011.0,1,0,1
ALB,MKD,2022.0,2,0,2
KEN,ALB,2017.0,1,0,1
ESP,PAK,2016.0,2,0,2
FRA,PHL,2018.0,5,0,5
SLV,HRV,2016.0,2,0,2
VEN,QAT,2019.0,1,0,1
AUT,ETH,2023.0,3,0,3
EST,MEX,2013.0,1,0,1
MAR,BEN,2020.0,1,0,1
NAM,MEX,2017.0,1,0,1
KHM,BEL,2020.0,1,0,1
,BRB,2020.0,5,0,5
GIN,GUF,2019.0,1,0,1
URY,CHE,2021.0,1,0,1
PRT,IDN,2019.0,1,0,1
MEX,DZA,2018.0,1,0,1
CHN,LUX,2014.0,2,0,2
MAR,MUS,2023.0,1,0,1
CMR,POL,2023.0,1,0,1
CHE,RWA,2018.0,1,0,1
BRN,CZE,2019.0,1,0,1
ZMB,AUS,2022.0,1,0,1
AFG,CAN,2023.0,1,0,1
TZA,ESP,2020.0,1,0,1
EGY,ETH,2020.0,1,0,1
POL,GEO,2000.0,1,0,1
GIN,GNB,2016.0,1,0,1
SXM,NLD,2023.0,2,0,2
TUN,SEN,2022.0,1,0,1
JOR,BEL,2022.0,2,0,2
ITA,BFA,2001.0,2,0,2
COG,BEL,2002.0,1,0,1
AUS,CYM,1997.0,1,0,1
NGA,CHE,1997.0,1,0,1
FRA,KWT,2000.0,1,0,1
MTQ,AUS,1997.0,1,0,1
LBN,GRC,2018.0,1,0,1
NLD,GTM,2003.0,1,0,1
NPL,CAN,2004.0,1,0,1
FIN,GRD,2010.0,1,0,1
COL,UKR,2018.0,1,0,1
FRA,UZB,2006.0,1,0,1
GEO,POL,1998.0,1,0,1
GEO,ITA,1997.0,1,0,1
VEN,NLD,2004.0,1,0,1
ZWE,SWE,2004.0,1,0,1
IRL,LVA,2007.0,1,0,1
SVN,SWE,1999.0,1,0,1
SWE,SVN,2000.0,1,0,1
HUN,VNM,2003.0,1,0,1
CAN,ZWE,1998.0,1,0,1
SYR,MAR,2004.0,1,0,1
HUN,MDA,2010.0,1,0,1
MDA,SRB,2014.0,1,0,1
RWA,BGD,1997.0,1,0,1
KHM,NOR,1997.0,1,0,1
BEL,UZB,1999.0,1,0,1
RUS,SAU,2010.0,1,0,1
MKD,SVK,1998.0,1,0,1
COL,JOR,2002.0,1,0,1
CHE,TZA,2000.0,1,0,1
MEX,POL,2004.0,2,0,2
TTO,PHL,2019.0,1,0,1
AUS,KEN,1998.0,1,0,1
UKR,BRA,2002.0,3,0,3
VEN,DNK,2018.0,1,0,1
CAF,COG,2019.0,1,0,1
,BDI,2006.0,1,0,1
SGP,JOR,2019.0,1,0,1
FIN,BLR,2014.0,1,0,1
MYS,MAR,2023.0,1,0,1
ARG,BOL,2010.0,2,0,2
UKR,IRN,2007.0,1,0,1
NLD,KAZ,2010.0,1,0,1
HND,CHL,2008.0,2,0,2
KWT,ITA,2011.0,1,0,1
MWI,CIV,2012.0,1,0,1
KEN,LAO,2021.0,1,0,1
IRL,KHM,2011.0,1,0,1
ITA,LBN,2004.0,1,0,1
USA,MCO,2019.0,1,0,1
YEM,MNE,2012.0,1,0,1
AFG,DEU,2011.0,1,0,1
CAN,LVA,2013.0,3,0,3
PRY,VEN,2015.0,1,0,1
SEN,IND,2011.0,1,0,1
MWI,CAN,2019.0,2,0,2
CMR,MAR,2011.0,2,0,2
AUS,AFG,2016.0,1,0,1
TUR,MYS,2006.0,1,0,1
KHM,AUS,2004.0,2,0,2
VCT,,2014.0,1,0,1
JPN,TZA,2018.0,3,0,3
SVN,NLD,2014.0,3,0,3
GIN,MYS,2016.0,1,0,1
HKG,PRT,2021.0,1,0,1
CHN,GIN,2019.0,3,0,3
CHL,ECU,2012.0,3,0,3
SYR,JOR,2021.0,1,0,1
PSE,ARE,2013.0,2,0,2
BEN,MLI,2023.0,1,0,1
BOL,ECU,2013.0,1,0,1
GRC,KAZ,2017.0,3,0,3
ZAF,HKG,2023.0,1,0,1
GBR,BDI,2020.0,1,0,1
,BMU,1995.0,3,0,3
MKD,BEL,2019.0,3,0,3
ZAF,VGB,2020.0,1,0,1
IDN,COD,2018.0,1,0,1
PRT,TLS,2023.0,1,0,1
IRN,BLR,2021.0,1,0,1
GAB,BEN,2021.0,1,0,1
MEX,GUF,2021.0,1,0,1
MAR,CIV,2023.0,1,0,1
IND,HUN,2007.0,4,0,4
,GRD,2020.0,11,0,11
TZA,NGA,2019.0,2,0,2
LBN,RUS,2023.0,1,0,1
IRQ,COL,2022.0,1,0,1
,TJK,2020.0,12,0,12
ETH,NZL,2023.0,1,0,1
,GAB,2020.0,26,0,26
CHE,MAR,2019.0,2,0,2
,SLV,2020.0,6,0,6
IDN,CZE,2023.0,2,0,2
SVK,SWE,2023.0,1,0,1
CHE,UGA,1999.0,2,0,2
CMR,NER,2012.0,1,0,1
PSE,LBN,2006.0,1,0,1
LBN,ISR,2009.0,1,0,1
CHN,NAM,2009.0,2,0,2
ZWE,ZMB,2004.0,1,0,1
ESP,LBN,2011.0,1,0,1
TGO,CRI,2004.0,1,0,1
HRV,IRN,2015.0,1,0,1
MEX,FIN,2013.0,2,0,2
IRN,DZA,2008.0,1,0,1
DNK,SYR,2002.0,1,0,1
DEU,MMR,2007.0,1,0,1
CYM,USA,2006.0,1,0,1
ZAF,IDN,2017.0,1,0,1
AFG,ITA,2007.0,1,0,1
YEM,BRA,2005.0,1,0,1
ROU,PRT,2006.0,2,0,2
MYS,QAT,2006.0,1,0,1
PAK,PNG,2007.0,1,0,1
DNK,ARE,2013.0,1,0,1
UGA,KEN,2003.0,3,0,3
JPN,GUF,2007.0,1,0,1
THA,ZMB,2015.0,1,0,1
MAC,KEN,2022.0,1,0,1
CAN,ALB,2022.0,1,0,1
BEN,BRN,2017.0,1,0,1
KOR,GMB,2022.0,1,0,1
IND,NER,2008.0,1,0,1
ZAF,PRI,2006.0,1,0,1
MLI,SEN,1997.0,1,0,1
ISR,SGP,2000.0,1,0,1
SLB,CAN,2002.0,1,0,1
PNG,BRA,2001.0,1,0,1
SEN,BFA,2000.0,3,0,3
NZL,IRN,1998.0,1,0,1
TUR,IND,2006.0,1,0,1
ESP,GAB,2006.0,1,0,1
KOR,TUR,1999.0,1,0,1
SLV,BRA,2014.0,2,0,2
TUR,KWT,2000.0,1,0,1
POL,NPL,2008.0,1,0,1
PYF,MDG,2000.0,1,0,1
SVK,MEX,2003.0,1,0,1
MEX,SVK,2005.0,1,0,1
VEN,PRI,2007.0,1,0,1
CAN,MCO,2001.0,1,0,1
LIE,AUT,2000.0,1,0,1
KWT,SWE,2018.0,1,0,1
SWE,KWT,2019.0,2,0,2
ARG,LVA,2007.0,1,0,1
UKR,MDA,1997.0,1,0,1
UKR,MDA,2005.0,4,0,4
MAR,TUN,2002.0,2,0,2
BIH,PRT,2016.0,1,0,1
ARG,FIN,2006.0,1,0,1
FIN,ARG,2007.0,1,0,1
ZWE,DNK,2008.0,1,0,1
DEU,NPL,2008.0,2,0,2
ISL,IRL,2011.0,2,0,2
MEX,BGD,2019.0,1,0,1
BGD,MEX,2020.0,1,0,1
NLD,KWT,2000.0,1,0,1
SWE,IDN,2005.0,2,0,2
LVA,NOR,2013.0,1,0,1
NOR,VNM,2008.0,1,0,1
COL,PRI,2008.0,3,0,3
IRQ,SAU,2014.0,1,0,1
IND,MMR,2003.0,1,0,1
ITA,ARE,2013.0,1,0,1
SWZ,,2006.0,2,0,2
MNG,PRT,2018.0,1,0,1
IDN,VNM,2004.0,1,0,1
ZAF,MLI,2006.0,2,0,2
IRN,ITA,2000.0,2,0,2
MKD,USA,2021.0,3,0,3
NGA,BGD,2017.0,1,0,1
RUS,MKD,2009.0,1,0,1
CHN,MNG,2002.0,1,0,1
HRV,ALB,2014.0,1,0,1
MNG,BEL,2022.0,1,0,1
SRB,NZL,2015.0,1,0,1
KEN,SAU,2011.0,1,0,1
BLR,IRN,2016.0,2,0,2
SLV,CRI,2021.0,1,0,1
TWN,SVK,2019.0,1,0,1
TZA,COL,2019.0,1,0,1
HKG,ARE,2015.0,1,0,1
TUR,ARE,2001.0,2,0,2
LTU,HUN,2017.0,1,0,1
MLI,GNQ,2020.0,1,0,1
COL,MAR,2018.0,1,0,1
THA,ARE,2019.0,1,0,1
ZAF,MLI,2023.0,2,0,2
ASM,,2019.0,2,0,2
CHL,JAM,2020.0,1,0,1
TWN,KIR,2019.0,1,0,1
VUT,CAN,2019.0,1,0,1
LBN,ROU,2019.0,1,0,1
ROU,KWT,2021.0,1,0,1
BFA,GBR,2017.0,2,0,2
GBR,AGO,2019.0,3,0,3
HND,COL,2018.0,1,0,1
ZAF,PER,2017.0,1,0,1
ECU,IRL,2019.0,2,0,2
TWN,GMB,2020.0,1,0,1
SDN,ETH,2012.0,1,0,1
IRN,LBN,2016.0,1,0,1
,AND,2018.0,2,0,2
SYR,CYP,2023.0,1,0,1
BOL,FIN,2020.0,1,0,1
,VCT,2017.0,3,0,3
TTO,LCA,2020.0,1,0,1
PNG,LAO,2021.0,1,0,1
TWN,NZL,2021.0,5,0,5
GBR,FRO,2021.0,1,0,1
NGA,KWT,2018.0,1,0,1
PER,PHL,2008.0,1,0,1
CAN,MLI,2011.0,1,0,1
MKD,HRV,2023.0,1,0,1
MDV,NZL,2023.0,1,0,1
THA,SAU,2005.0,1,0,1
GBR,UZB,2023.0,1,0,1
HUN,TUR,2023.0,1,0,1
SVN,PER,2020.0,1,0,1
SWE,LKA,2017.0,2,0,2
AUT,LBY,2006.0,1,0,1
IRQ,IRN,2005.0,1,0,1
,WSM,2002.0,1,0,1
WSM,,2008.0,1,0,1
KHM,THA,2006.0,1,0,1
AUT,KOR,2006.0,2,0,2
USA,RWA,2004.0,1,0,1
CHE,LSO,2019.0,1,0,1
MDG,USA,1997.0,1,0,1
BIH,ALB,2015.0,1,0,1
AND,,2020.0,3,0,3
THA,KEN,2016.0,1,0,1
CHL,PER,2000.0,2,0,2
RUS,VEN,2006.0,1,0,1
DMA,,2009.0,1,0,1
BOL,HND,2012.0,1,0,1
FRA,HND,2019.0,1,0,1
,WSM,1997.0,3,0,3
BEN,MAR,2006.0,1,0,1
JOR,IRQ,2018.0,6,0,6
SLB,USA,2008.0,1,0,1
BGR,CHN,2005.0,1,0,1
NZL,UGA,2007.0,1,0,1
CMR,BDI,2017.0,2,0,2
PRI,ROU,2007.0,1,0,1
TZA,ZAF,2007.0,2,0,2
DZA,COG,2009.0,1,0,1
CHE,ALB,2008.0,1,0,1
MEX,THA,2010.0,1,0,1
TUN,JOR,2017.0,1,0,1
TTO,NZL,2003.0,1,0,1
KNA,GBR,2007.0,1,0,1
VEN,CRI,2018.0,2,0,2
TUN,NER,2011.0,1,0,1
SVN,CZE,2001.0,2,0,2
MAC,MYS,2010.0,1,0,1
ITA,BHR,2002.0,1,0,1
URY,DEU,2004.0,1,0,1
MEX,URY,2010.0,1,0,1
GBR,BOL,2009.0,1,0,1
ESP,MLT,2022.0,1,0,1
LUX,DNK,2010.0,1,0,1
TLS,KOR,2022.0,1,0,1
TWN,PHL,2007.0,2,0,2
CZE,HRV,1998.0,1,0,1
SGP,IRL,1998.0,1,0,1
BFA,GAB,2004.0,1,0,1
FRA,SAU,2002.0,1,0,1
SWE,GNB,2001.0,1,0,1
CZE,SGP,2011.0,1,0,1
PAN,ARG,2010.0,1,0,1
ZAF,JAM,2008.0,1,0,1
FRA,BLZ,2018.0,1,0,1
CHN,UGA,2011.0,1,0,1
CAN,CRI,2005.0,1,0,1
IRQ,OMN,2005.0,1,0,1
TLS,,2014.0,2,0,2
MLI,SWE,2008.0,1,0,1
NLD,SEN,2006.0,1,0,1
IND,BIH,2009.0,1,0,1
BRN,,2008.0,2,0,2
ZAF,CIV,2023.0,2,0,2
NGA,NAM,2011.0,1,0,1
BMU,ITA,2013.0,1,0,1
CHN,NPL,2002.0,1,0,1
TWN,BGR,2017.0,1,0,1
IDN,NPL,2017.0,1,0,1
ITA,TCD,2006.0,1,0,1
ISL,RUS,2009.0,1,0,1
TTO,BRB,2001.0,1,0,1
BRB,TTO,2005.0,2,0,2
ZAF,RWA,2008.0,2,0,2
ARE,BRN,2012.0,1,0,1
CYP,BWA,2020.0,1,0,1
BEL,MOZ,2007.0,1,0,1
ALB,PHL,2010.0,1,0,1
IDN,CMR,2009.0,1,0,1
AUT,LTU,2012.0,2,0,2
USA,LSO,2004.0,1,0,1
CRI,BRA,1998.0,3,0,3
GRC,IRQ,2013.0,1,0,1
GAB,BFA,2008.0,1,0,1
TWN,PER,2018.0,1,0,1
USA,TLS,2014.0,5,0,5
SVK,KOR,2014.0,1,0,1
NLD,ZWE,2016.0,3,0,3
NPL,DNK,2010.0,2,0,2
GIN,GHA,2005.0,1,0,1
CHE,BFA,2004.0,1,0,1
,ATG,2005.0,2,0,2
COL,BGR,2009.0,1,0,1
BGR,COL,2013.0,1,0,1
IRL,BHR,2001.0,1,0,1
FRA,NIC,2005.0,1,0,1
CHN,PRI,2009.0,3,0,3
CUB,JPN,2016.0,1,0,1
ETH,LBN,2019.0,1,0,1
LBN,ETH,2021.0,1,0,1
MLI,ITA,2013.0,2,0,2
PRI,MEX,2006.0,1,0,1
GMB,LBR,2022.0,1,0,1
VNM,PHL,2009.0,1,0,1
PYF,CHE,2013.0,1,0,1
UGA,COG,2013.0,2,0,2
ZAF,QAT,2014.0,1,0,1
USA,AGO,2014.0,1,0,1
COL,EST,2008.0,1,0,1
GEO,AFG,2010.0,1,0,1
GEO,ISR,2019.0,2,0,2
ARE,CYP,2016.0,1,0,1
,FRO,2009.0,7,0,7
JPN,IRQ,2016.0,1,0,1
CRI,BEL,2016.0,2,0,2
GMB,FRA,2016.0,1,0,1
DEU,BFA,2012.0,2,0,2
KAZ,ROU,2021.0,1,0,1
,CPV,2012.0,16,0,16
LTU,SVN,2012.0,1,0,1
YEM,QAT,2020.0,1,0,1
ISR,ARG,2012.0,1,0,1
MRT,,2026.0,1,0,1
UKR,NZL,2018.0,2,0,2
BWA,USA,1997.0,2,0,2
USA,MOZ,2001.0,1,0,1
SYR,ARE,2014.0,3,0,3
NOR,TZA,1998.0,1,0,1
BGD,PSE,2011.0,1,0,1
RWA,COD,2019.0,1,0,1
BWA,SWZ,2018.0,1,0,1
CAN,BTN,2017.0,1,0,1
LBN,KWT,2021.0,4,0,4
COL,CHE,2000.0,2,0,2
CHE,IDN,2021.0,1,0,1
,RWA,1997.0,3,0,3
SAU,IRN,2016.0,1,0,1
AUT,PHL,2022.0,2,0,2
FRA,GTM,2011.0,1,0,1
AUS,AFG,2003.0,2,0,2
VNM,THA,2024.0,1,0,1
NOR,PER,2017.0,2,0,2
CHN,BHS,2023.0,1,0,1
ATG,,2019.0,1,0,1
KAZ,BEL,2024.0,2,0,2
CAN,GUF,2019.0,1,0,1
TWN,HUN,2022.0,2,0,2
ARE,CHN,2007.0,1,0,1
COL,UGA,2020.0,1,0,1
MAC,SGP,2003.0,1,0,1
PAN,IRL,2020.0,2,0,2
GLP,MTQ,2024.0,1,0,1
,VGB,2003.0,1,0,1
BEL,MKD,2020.0,1,0,1
KIR,,2022.0,4,0,4
GMB,NOR,2008.0,1,0,1
NOR,GMB,2011.0,1,0,1
ATG,GUY,2020.0,1,0,1
NGA,IRQ,2022.0,1,0,1
BEL,MLI,2022.0,1,0,1
GIN,COD,2021.0,2,0,2
CRI,ITA,2022.0,1,0,1
,TCA,2019.0,2,0,2
OMN,SDN,2022.0,3,0,3
ARE,PAK,2024.0,2,0,2
IND,BGR,2011.0,1,0,1
THA,TWN,2005.0,1,0,1
KHM,IDN,2007.0,2,0,2
BWA,,1999.0,1,0,1
USA,VGB,2000.0,1,0,1
NPL,MYS,2006.0,1,0,1
,CPV,1997.0,2,0,2
CYM,USA,1998.0,1,0,1
BLR,USA,2000.0,10,0,10
MWI,CAN,2002.0,2,0,2
TUN,EGY,2010.0,5,0,5
NAM,NLD,2003.0,1,0,1
CRI,COL,2001.0,1,0,1
PAK,BRA,1998.0,1,0,1
BRA,PAK,1999.0,1,0,1
FJI,PNG,1998.0,1,0,1
MYS,PAK,2000.0,1,0,1
PAK,MYS,2001.0,4,0,4
NIC,SWE,2014.0,1,0,1
MYS,NOR,2009.0,1,0,1
EST,SWZ,2022.0,2,0,2
GBR,GUY,2014.0,4,0,4
HRV,LKA,2013.0,1,0,1
THA,MMR,2012.0,2,0,2
BLR,CZE,2009.0,2,0,2
PAK,PER,2022.0,1,0,1
URY,MLI,2013.0,2,0,2
GTM,DEU,2014.0,2,0,2
JPN,MWI,2023.0,2,0,2
TGO,DEU,2014.0,1,0,1
CMR,COD,2015.0,2,0,2
HRV,CHN,2010.0,2,0,2
MAR,AUS,2015.0,1,0,1
CHN,SYR,2008.0,1,0,1
GTM,GBR,2013.0,1,0,1
VIR,,2018.0,1,0,1
NLD,BFA,2023.0,1,0,1
TUR,SOM,2019.0,2,0,2
NLD,GRL,2014.0,1,0,1
ITA,ECU,2015.0,5,0,5
CUB,LUX,2016.0,1,0,1
TWN,BFA,2015.0,2,0,2
GRC,POL,2017.0,4,0,4
FIN,MWI,2015.0,1,0,1
,IOT,2010.0,1,0,1
TON,GBR,2016.0,1,0,1
JOR,CZE,2023.0,3,0,3
ITA,AZE,2021.0,2,0,2
KEN,ZAF,1998.0,2,0,2
ISR,ARE,2018.0,2,0,2
,TLS,2004.0,2,0,2
AUS,DZA,2014.0,2,0,2
SWZ,MOZ,2020.0,1,0,1
GBR,SWZ,2010.0,1,0,1
MDV,,2010.0,1,0,1
AFG,PAK,2009.0,1,0,1
KWT,KOR,2012.0,1,0,1
ROU,MEX,2019.0,3,0,3
AUS,SYR,2012.0,1,0,1
RWA,COD,2009.0,1,0,1
MEX,GTM,2004.0,2,0,2
SWE,MYS,2004.0,1,0,1
HKG,PRT,2005.0,1,0,1
CAN,COG,2014.0,1,0,1
PRY,PER,2015.0,1,0,1
CHE,JOR,2015.0,1,0,1
JOR,LBN,2018.0,2,0,2
SVK,EST,2009.0,1,0,1
CMR,BEN,2008.0,1,0,1
ISR,BGR,2011.0,2,0,2
EGY,GRC,2005.0,2,0,2
CIV,TUN,2004.0,1,0,1
EST,AFG,2020.0,1,0,1
ALB,AUT,2013.0,1,0,1
CCK,PYF,2013.0,1,0,1
NOR,PSE,2018.0,2,0,2
ITA,MNG,2019.0,2,0,2
CUB,AUS,2017.0,1,0,1
SVK,VNM,2015.0,1,0,1
SVK,SDN,2016.0,1,0,1
BEL,GMB,2002.0,5,0,5
KAZ,ITA,2011.0,1,0,1
CRI,ARG,2015.0,2,0,2
TWN,KHM,2015.0,2,0,2
MAC,CHE,2019.0,1,0,1
ITA,TGO,2020.0,1,0,1
IDN,TLS,2014.0,1,0,1
PNG,WSM,2023.0,1,0,1
TZA,BWA,2017.0,1,0,1
FRA,OMN,2016.0,2,0,2
EST,NLD,2004.0,1,0,1
LUX,VNM,2015.0,1,0,1
ZAF,CYP,2004.0,2,0,2
KOR,TZA,2023.0,1,0,1
KHM,NOR,2021.0,1,0,1
ETH,CAN,2014.0,1,0,1
AFG,GUF,2021.0,1,0,1
ISL,IDN,2023.0,1,0,1
COL,NOR,2022.0,5,0,5
GRD,CHE,2019.0,1,0,1
NGA,GLP,2006.0,1,0,1
IDN,BRN,2016.0,1,0,1
LUX,JPN,2018.0,1,0,1
ISR,BLZ,2017.0,1,0,1
AUS,SLE,2021.0,1,0,1
ESP,CPV,2018.0,2,0,2
ISL,ROU,2020.0,2,0,2
NOR,GHA,2020.0,3,0,3
GUY,AUS,2020.0,1,0,1
THA,SAU,2019.0,1,0,1
UKR,ROU,2023.0,1,0,1
PHL,BRN,2021.0,1,0,1
HKG,ZMB,2020.0,1,0,1
NZL,VNM,2019.0,3,0,3
TJK,GBR,2018.0,1,0,1
GBR,TJK,2020.0,1,0,1
CAN,HRV,2001.0,2,0,2
ASM,,2012.0,2,0,2
IRN,CHL,2023.0,1,0,1
NGA,EST,2020.0,1,0,1
GIN,MLI,2007.0,1,0,1
BRA,POL,2002.0,3,0,3
SWE,NCL,2014.0,1,0,1
ATG,,2011.0,1,0,1
BEL,ERI,2013.0,1,0,1
IDN,PAK,2017.0,4,0,4
HRV,MNE,2023.0,1,0,1
FRA,PRI,2001.0,1,0,1
ARE,SYR,2000.0,1,0,1
UZB,JOR,2015.0,1,0,1
IRN,IND,2024.0,1,0,1
,TUN,2021.0,14,0,14
,ETH,2021.0,1,0,1
MOZ,VNM,2022.0,1,0,1
SAU,AFG,2022.0,2,0,2
GHA,SEN,2013.0,1,0,1
RUS,HRV,2008.0,1,0,1
NGA,IRN,1997.0,1,0,1
POL,LBY,2003.0,2,0,2
ETH,NOR,2004.0,2,0,2
IND,PSE,2008.0,2,0,2
COG,GBR,2001.0,1,0,1
FRA,ALB,2005.0,1,0,1
LBN,AUT,1999.0,1,0,1
PAN,DEU,2002.0,1,0,1
CIV,GNQ,1998.0,1,0,1
KHM,GRC,2019.0,1,0,1
FRA,TTO,2008.0,1,0,1
MEX,PAN,2004.0,1,0,1
ZMB,JPN,2005.0,1,0,1
IDN,MYS,2003.0,2,0,2
BEN,BRA,1998.0,1,0,1
NOR,MWI,2005.0,1,0,1
BRN,,2004.0,2,0,2
MAR,IND,2007.0,1,0,1
IND,LSO,2009.0,1,0,1
POL,ARG,2004.0,1,0,1
BEN,OMN,2012.0,1,0,1
MNG,JPN,1998.0,1,0,1
EST,AUS,2006.0,1,0,1
ESP,ETH,2008.0,1,0,1
NGA,COG,2004.0,1,0,1
SGP,FJI,1998.0,1,0,1
MLI,ESP,1999.0,1,0,1
MKD,MAC,2016.0,3,0,3
SRB,PRT,2002.0,2,0,2
ZAF,NER,2015.0,2,0,2
RWA,MWI,2016.0,1,0,1
UKR,SVK,1998.0,2,0,2
NGA,FJI,2019.0,1,0,1
NGA,FJI,2021.0,2,0,2
NGA,IRQ,2018.0,5,0,5
CUB,DOM,2008.0,3,0,3
AUT,GAB,2011.0,1,0,1
PAK,PHL,2018.0,1,0,1
BEL,THA,1997.0,1,0,1
ESP,MLI,2004.0,1,0,1
PNG,BWA,1997.0,1,0,1
ITA,GEO,2000.0,1,0,1
ISR,EGY,1999.0,1,0,1
SWE,MWI,2016.0,1,0,1
MAR,AUT,2011.0,1,0,1
,ASM,2006.0,2,0,2
KGZ,IND,2018.0,1,0,1
BIH,SWE,2020.0,3,0,3
URY,CZE,2015.0,1,0,1
CMR,IND,2014.0,1,0,1
SRB,CHN,2009.0,2,0,2
LAO,GEO,2013.0,2,0,2
EGY,PER,2019.0,1,0,1
ZMB,ETH,2014.0,1,0,1
KEN,MWI,2009.0,3,0,3
MWI,LBR,2011.0,1,0,1
LBR,BEL,2012.0,1,0,1
MCO,BMU,2009.0,1,0,1
FRA,TTO,2015.0,3,0,3
TTO,FRA,2017.0,1,0,1
ESP,LBN,2012.0,2,0,2
ISR,ARM,2017.0,2,0,2
FRA,SVK,2018.0,5,0,5
AUS,CMR,2012.0,1,0,1
FSM,,2013.0,2,0,2
ARE,KEN,2014.0,1,0,1
ESP,CYP,2012.0,2,0,2
,NFK,2006.0,1,0,1
IND,VNM,2012.0,1,0,1
,VUT,2002.0,5,0,5
AUS,EST,2011.0,2,0,2
GMB,NLD,2004.0,1,0,1
GBR,NAM,2019.0,1,0,1
PER,CHN,2023.0,2,0,2
ARG,AFG,2003.0,1,0,1
ARE,PAK,2000.0,1,0,1
DNK,BOL,2004.0,1,0,1
THA,CHN,1998.0,2,0,2
PHL,BGD,2008.0,1,0,1
BHR,CAN,2010.0,1,0,1
IDN,TTO,2010.0,1,0,1
ITA,BWA,2015.0,1,0,1
HUN,KGZ,2016.0,1,0,1
FJI,PNG,2007.0,1,0,1
ISL,GEO,2014.0,1,0,1
NGA,ISR,2022.0,1,0,1
USA,VUT,2019.0,2,0,2
NIC,SLB,2010.0,1,0,1
TTO,TGO,2013.0,3,0,3
AUS,KWT,2022.0,5,0,5
RWA,LBN,2023.0,3,0,3
DEU,BGD,1997.0,1,0,1
FIN,TWN,2005.0,1,0,1
ISR,EST,1997.0,1,0,1
CMR,RWA,2012.0,1,0,1
BFA,ESP,2007.0,1,0,1
CZE,MEX,1997.0,1,0,1
FIN,URY,2010.0,1,0,1
AFG,CHE,2017.0,1,0,1
BMU,PAK,2005.0,1,0,1
UGA,ZWE,2015.0,2,0,2
USA,BTN,2013.0,2,0,2
HUN,LBY,2004.0,1,0,1
FIN,HKG,2017.0,1,0,1
HRV,AUS,2009.0,1,0,1
USA,MNE,1998.0,1,0,1
CUB,DOM,2001.0,1,0,1
AUS,FJI,1998.0,1,0,1
COL,PAK,2016.0,1,0,1
NOR,TUN,2004.0,1,0,1
BRA,URY,1999.0,4,0,4
MYS,SYR,2003.0,1,0,1
MAR,PRT,2001.0,3,0,3
BEL,MCO,2010.0,2,0,2
DEU,GRD,2006.0,1,0,1
ESP,TTO,2002.0,2,0,2
AZE,DEU,1998.0,1,0,1
YEM,ESP,2000.0,1,0,1
CAN,CIV,1997.0,1,0,1
GRL,GRC,2014.0,1,0,1
POL,HUN,2009.0,2,0,2
OMN,BRN,2019.0,1,0,1
,REU,2001.0,1,0,1
ITA,CYP,2019.0,4,0,4
PRT,BHS,2014.0,1,0,1
MLI,BFA,2010.0,2,0,2
NLD,FJI,2016.0,2,0,2
VEN,PER,2015.0,1,0,1
USA,SLE,2012.0,3,0,3
POL,ZAF,2006.0,2,0,2
HRV,BRA,2010.0,1,0,1
LBN,NLD,2011.0,1,0,1
NZL,PRT,2007.0,2,0,2
TZA,BWA,2018.0,2,0,2
GIN,ESP,2016.0,1,0,1
BGD,THA,2006.0,2,0,2
CAF,MWI,2012.0,1,0,1
CUB,BEL,2013.0,2,0,2
GBR,KNA,2013.0,2,0,2
DEU,COD,2017.0,1,0,1
FIN,NZL,2012.0,2,0,2
TUN,GRC,2017.0,1,0,1
MLT,MAR,2010.0,2,0,2
CAN,ISL,2015.0,3,0,3
BEL,LBN,2011.0,1,0,1
MEX,BFA,2019.0,1,0,1
UKR,IRL,2021.0,1,0,1
VNM,BRA,2013.0,1,0,1
BRA,CIV,2012.0,1,0,1
GTM,SLV,2016.0,1,0,1
UKR,KAZ,2023.0,7,0,7
BHS,FRA,2011.0,1,0,1
LTU,CHE,2015.0,2,0,2
FIN,TZA,2017.0,1,0,1
BHR,IRQ,2014.0,2,0,2
PAK,SRB,1999.0,1,0,1
IRL,DZA,2014.0,2,0,2
EGY,THA,2009.0,1,0,1
DEU,MDA,2008.0,2,0,2
NLD,GEO,2013.0,1,0,1
ECU,PRI,2018.0,1,0,1
MDA,RUS,2017.0,4,0,4
ETH,ZMB,1999.0,1,0,1
TZA,ESP,2000.0,1,0,1
PHL,BGD,2014.0,3,0,3
NOR,SEN,2018.0,1,0,1
USA,MUS,2021.0,2,0,2
TUN,IRQ,2018.0,1,0,1
THA,MWI,2016.0,1,0,1
IOT,BRA,2020.0,1,0,1
IRN,PSE,2021.0,1,0,1
UGA,BEN,2018.0,1,0,1
EGY,EST,2024.0,1,0,1
DNK,SEN,2019.0,1,0,1
SRB,KAZ,2016.0,1,0,1
DEU,SSD,2019.0,1,0,1
SHN,,2021.0,1,0,1
BRB,CAN,2016.0,1,0,1
GRC,QAT,2013.0,6,0,6
THA,KAZ,2020.0,1,0,1
CHN,BGD,2001.0,1,0,1
EGY,LBN,1999.0,2,0,2
,SHN,2018.0,2,0,2
ITA,LKA,2011.0,1,0,1
NGA,ARG,2020.0,2,0,2
CUB,ITA,2023.0,1,0,1
AUT,TWN,2005.0,1,0,1
CHL,CHN,2004.0,3,0,3
IDN,NZL,2003.0,1,0,1
IRL,ARG,2004.0,1,0,1
MEX,THA,1998.0,2,0,2
FLK,GBR,2000.0,2,0,2
SAU,BRN,2019.0,1,0,1
NAM,ZMB,2020.0,1,0,1
MRT,SEN,2007.0,1,0,1
PNG,IND,2000.0,1,0,1
AFG,NLD,2007.0,1,0,1
GUY,USA,2004.0,1,0,1
KEN,SDN,2009.0,1,0,1
PRT,MRT,2005.0,1,0,1
STP,PRT,2001.0,1,0,1
PRT,VEN,1998.0,1,0,1
CHL,SAU,2022.0,1,0,1
ZAF,PSE,2018.0,1,0,1
USA,TJK,2023.0,1,0,1
PRI,CRI,2019.0,2,0,2
HUN,MAR,2011.0,1,0,1
TWN,PSE,2017.0,1,0,1
COL,MLI,2013.0,1,0,1
CHL,BIH,2013.0,1,0,1
GBR,BIH,2009.0,1,0,1
NGA,COD,2022.0,5,0,5
BEL,JOR,2016.0,1,0,1
SDN,BHR,2014.0,1,0,1
ITA,PSE,2016.0,3,0,3
HKG,MAR,2009.0,1,0,1
BEN,CHN,2014.0,1,0,1
ECU,NZL,2004.0,1,0,1
SVK,GRC,2019.0,1,0,1
SWZ,AUS,2018.0,1,0,1
USA,CAF,2005.0,1,0,1
CRI,ISR,2015.0,1,0,1
GUM,,2000.0,1,0,1
USA,LIE,2004.0,2,0,2
USA,LIE,2008.0,1,0,1
GRC,EGY,2023.0,3,0,3
MEX,PAN,2014.0,4,0,4
UKR,KAZ,2000.0,1,0,1
MMR,LAO,2002.0,1,0,1
LUX,LAO,2016.0,1,0,1
SVN,POL,1997.0,1,0,1
GBR,HTI,2017.0,1,0,1
BRA,LUX,2017.0,1,0,1
BWA,SRB,2006.0,1,0,1
SRB,BWA,2007.0,1,0,1
TUN,SWZ,2011.0,1,0,1
USA,BDI,2010.0,1,0,1
BLR,NLD,2008.0,1,0,1
KWT,ITA,2002.0,1,0,1
PAK,CHE,2005.0,1,0,1
LVA,FIN,2000.0,2,0,2
PAK,PSE,2010.0,1,0,1
NGA,SVK,2007.0,1,0,1
SVK,CHN,1999.0,1,0,1
BLR,CZE,2011.0,1,0,1
NGA,TUR,2006.0,1,0,1
DEU,LKA,2020.0,2,0,2
MUS,ZAF,2011.0,2,0,2
NPL,PRT,2007.0,1,0,1
LKA,MYS,2009.0,1,0,1
LAO,,2000.0,1,0,1
ETH,AUS,2009.0,5,0,5
JOR,SRB,2004.0,1,0,1
BIH,BHR,2015.0,1,0,1
UZB,KAZ,2001.0,2,0,2
UKR,TUR,2008.0,1,0,1
SDN,OMN,2011.0,1,0,1
NLD,RWA,2009.0,1,0,1
ARE,BHR,2003.0,1,0,1
COD,BEL,2012.0,1,0,1
IND,CIV,2013.0,3,0,3
KHM,ETH,2008.0,1,0,1
GBR,KAZ,2009.0,1,0,1
NLD,PER,2008.0,2,0,2
IRN,TJK,2023.0,1,0,1
NOR,JOR,2008.0,1,0,1
BEN,JPN,2015.0,1,0,1
IND,FJI,2022.0,1,0,1
RWA,,2007.0,2,0,2
TUN,NER,2012.0,1,0,1
LVA,ITA,1999.0,1,0,1
CAN,PSE,2005.0,1,0,1
ISR,HUN,2016.0,1,0,1
CUB,JOR,2011.0,1,0,1
GEO,CAN,2021.0,3,0,3
GUY,FRA,2003.0,1,0,1
URY,BOL,2002.0,1,0,1
CIV,COG,2001.0,1,0,1
NLD,CHL,2000.0,1,0,1
VEN,TWN,1999.0,1,0,1
IND,LBY,1997.0,1,0,1
GBR,NIC,1999.0,1,0,1
QAT,TWN,2021.0,1,0,1
BEL,TWN,2000.0,2,0,2
USA,DMA,2006.0,1,0,1
MWI,IRL,2001.0,1,0,1
AUS,BHR,2010.0,1,0,1
VEN,CHL,2003.0,1,0,1
ZAF,THA,1998.0,1,0,1
,GIB,2015.0,2,0,2
ROU,BRA,1999.0,2,0,2
DEU,TUN,2013.0,4,0,4
SRB,OMN,2020.0,1,0,1
IDN,TLS,2008.0,1,0,1
ROU,SGP,2005.0,1,0,1
PYF,CHL,2021.0,1,0,1
KWT,TUR,2021.0,2,0,2
RUS,MUS,2010.0,1,0,1
GIN,SEN,2004.0,1,0,1
PNG,GIN,2020.0,4,0,4
IRL,BHR,2015.0,2,0,2
LKA,GHA,2021.0,1,0,1
GUY,,2009.0,5,0,5
BRA,GNQ,2008.0,1,0,1
MMR,AUS,2013.0,1,0,1
BRA,SRB,2015.0,2,0,2
LAO,CHE,2008.0,1,0,1
MEX,PRI,2008.0,1,0,1
MLI,NER,2004.0,1,0,1
MYS,DZA,2011.0,1,0,1
GBR,BWA,1998.0,1,0,1
IRQ,MYS,2002.0,1,0,1
ZAF,LSO,2005.0,2,0,2
SWE,HKG,2024.0,1,0,1
JOR,ISR,2007.0,1,0,1
STP,,2009.0,5,0,5
IRL,CYP,2023.0,1,0,1
ESP,SAU,2010.0,2,0,2
PRT,CPV,2012.0,2,0,2
PRY,URY,2007.0,1,0,1
ITA,LBY,2020.0,2,0,2
PAN,CAN,2018.0,2,0,2
QAT,THA,2017.0,2,0,2
JOR,PSE,2005.0,2,0,2
VEN,PRI,2000.0,2,0,2
BHS,GBR,2011.0,1,0,1
IND,KAZ,2003.0,1,0,1
UZB,MAR,2016.0,1,0,1
ZAF,LBY,2018.0,2,0,2
DEU,CIV,2012.0,1,0,1
UKR,PRT,2017.0,1,0,1
CUB,AUT,2015.0,1,0,1
USA,SWZ,2007.0,2,0,2
TUN,CAF,2015.0,1,0,1
SDN,OMN,2019.0,3,0,3
ZWE,NZL,2019.0,1,0,1
MAR,MRT,2015.0,2,0,2
GBR,MAC,2013.0,3,0,3
BRN,BEL,2023.0,1,0,1
BEL,BRN,2024.0,1,0,1
BGD,BRA,2015.0,1,0,1
MDG,VNM,2013.0,1,0,1
SRB,MEX,2001.0,1,0,1
GBR,PRI,2019.0,3,0,3
TUR,MAR,2014.0,1,0,1
MAR,ISR,2007.0,1,0,1
MEX,TWN,2010.0,3,0,3
KWT,MEX,2000.0,1,0,1
MDA,FRA,2016.0,1,0,1
SGP,LBN,2019.0,2,0,2
DMA,ESP,2020.0,1,0,1
SOM,GBR,2017.0,1,0,1
CMR,COG,2010.0,1,0,1
LSO,,2011.0,1,0,1
IRN,IDN,2018.0,2,0,2
CIV,BEL,2022.0,1,0,1
HTI,,2004.0,1,0,1
AUT,COD,2020.0,1,0,1
PAK,UZB,2023.0,4,0,4
DOM,JPN,2020.0,1,0,1
NGA,ISR,2018.0,1,0,1
BIH,GRC,2021.0,1,0,1
GRC,BIH,2022.0,2,0,2
IRL,MMR,2019.0,1,0,1
ZWE,GAB,2009.0,1,0,1
ZMB,ZWE,1998.0,1,0,1
CHL,BOL,2013.0,3,0,3
BRN,USA,2022.0,1,0,1
VNM,NZL,2009.0,1,0,1
CHL,PHL,2023.0,1,0,1
HUN,AUS,2023.0,2,0,2
BIH,UKR,2008.0,5,0,5
GEO,JPN,2001.0,2,0,2
USA,MRT,2002.0,1,0,1
ZMB,FRA,2018.0,1,0,1
VEN,URY,2005.0,1,0,1
KGZ,UZB,2006.0,2,0,2
KGZ,UZB,2010.0,2,0,2
KOR,PHL,2002.0,2,0,2
GLP,TTO,2010.0,2,0,2
QAT,IRL,2005.0,1,0,1
GBR,NAM,2011.0,1,0,1
AUS,BRN,1998.0,1,0,1
MEX,URY,1998.0,1,0,1
UKR,VNM,2000.0,1,0,1
SWE,SAU,2002.0,2,0,2
MCO,GRC,2021.0,1,0,1
DOM,CRI,2006.0,1,0,1
MEX,PHL,1998.0,1,0,1
SLE,MYS,2000.0,1,0,1
NAM,AUS,1999.0,1,0,1
PRT,GRC,2001.0,1,0,1
CHE,MKD,2022.0,1,0,1
NCL,JPN,2002.0,1,0,1
BLR,NOR,2005.0,3,0,3
LVA,USA,1999.0,2,0,2
FRA,AGO,2004.0,1,0,1
FRA,PRY,2013.0,1,0,1
BFA,SEN,1997.0,1,0,1
BIH,JPN,2000.0,1,0,1
POL,SAU,2003.0,1,0,1
GAB,SEN,2006.0,1,0,1
DNK,ZWE,2003.0,2,0,2
ECU,FJI,2017.0,1,0,1
SRB,KWT,1999.0,1,0,1
PAK,AFG,2008.0,2,0,2
BEL,BOL,2000.0,1,0,1
POL,EGY,2001.0,1,0,1
AUS,JOR,2000.0,2,0,2
BWA,NGA,2019.0,1,0,1
SVK,ISR,2013.0,1,0,1
ARM,IRN,2005.0,1,0,1
FIN,SGP,1998.0,2,0,2
EST,ISR,2007.0,1,0,1
COL,URY,2012.0,1,0,1
ARM,TWN,2016.0,1,0,1
LTU,GRC,2010.0,1,0,1
JPN,KGZ,2017.0,2,0,2
MCO,HRV,2015.0,1,0,1
PYF,,2026.0,2,0,2
HKG,POL,2018.0,1,0,1
KEN,JOR,2015.0,1,0,1
VGB,CAN,2011.0,1,0,1
JPN,KAZ,2011.0,2,0,2
ESP,NCL,2014.0,1,0,1
GUM,PHL,2016.0,1,0,1
USA,TON,2018.0,1,0,1
PAK,ESP,2009.0,1,0,1
CUB,CRI,2011.0,2,0,2
MOZ,ZWE,2018.0,1,0,1
MCO,USA,2021.0,2,0,2
NER,CMR,2011.0,1,0,1
HRV,MAR,2017.0,1,0,1
VEN,IND,2012.0,1,0,1
IND,VEN,2013.0,1,0,1
FIN,NPL,2012.0,1,0,1
CHN,SUR,2018.0,1,0,1
ARG,RUS,2006.0,1,0,1
SAU,SRB,2012.0,1,0,1
ARM,ISR,2012.0,1,0,1
GRC,MAR,2017.0,1,0,1
UKR,CHN,2012.0,1,0,1
LBY,SAU,2013.0,1,0,1
CRI,CHE,2011.0,2,0,2
FLK,NZL,2021.0,1,0,1
LUX,GHA,2014.0,1,0,1
,AGO,1999.0,3,0,3
AGO,USA,2007.0,1,0,1
LBR,KEN,2014.0,1,0,1
UGA,IDN,2022.0,1,0,1
POL,NZL,2019.0,1,0,1
CAN,TTO,2019.0,1,0,1
MLT,TUR,2017.0,1,0,1
,TON,2007.0,1,0,1
JPN,LUX,2020.0,1,0,1
MAR,KOR,2019.0,1,0,1
KWT,LBY,2019.0,1,0,1
SWE,BHR,2013.0,1,0,1
EGY,JPN,2024.0,2,0,2
NLD,MCO,2013.0,1,0,1
CHL,AGO,2019.0,1,0,1
GMB,TUR,2019.0,1,0,1
TUR,GMB,2021.0,1,0,1
KGZ,USA,2022.0,1,0,1
,BHS,2019.0,5,0,5
MEX,VNM,2019.0,2,0,2
SWZ,CAN,2016.0,1,0,1
,DMA,2015.0,7,0,7
USA,DJI,2018.0,1,0,1
GBR,GTM,2019.0,1,0,1
BEN,GAB,2019.0,1,0,1
MCO,TUN,2017.0,1,0,1
CMR,ISR,2017.0,1,0,1
BWA,FIN,2018.0,1,0,1
GTM,FRA,2023.0,1,0,1
ESP,SAU,2024.0,1,0,1
BGR,BRA,2015.0,1,0,1
BRA,DZA,2023.0,2,0,2
,SYC,2020.0,3,0,3
FRA,SGP,2024.0,1,0,1
NZL,JOR,2012.0,2,0,2
IRN,CHE,2003.0,1,0,1
NAM,CHN,2012.0,1,0,1
ISR,GEO,2015.0,1,0,1
KEN,COG,2006.0,1,0,1
MDG,COD,2018.0,1,0,1
OMN,ISR,2014.0,1,0,1
BLR,AUT,2009.0,1,0,1
GBR,CYM,2003.0,3,0,3
GUM,FJI,2004.0,1,0,1
AUT,HKG,2011.0,1,0,1
NZL,ARE,2000.0,1,0,1
SWE,MAR,2013.0,1,0,1
PNG,PAK,2010.0,1,0,1
PRT,ROU,2007.0,1,0,1
MTQ,GBR,2021.0,1,0,1
ETH,GUY,2020.0,1,0,1
GUY,ETH,2021.0,1,0,1
NZL,BOL,2020.0,1,0,1
,SSD,2017.0,2,0,2
ZWE,RUS,2023.0,1,0,1
,BVT,2017.0,1,0,1
BOL,DEU,2020.0,1,0,1
PHL,TLS,2021.0,1,0,1
NOR,MOZ,2020.0,1,0,1
BRN,NLD,2019.0,1,0,1
PSE,HUN,2020.0,1,0,1
NGA,IDN,2023.0,2,0,2
FIN,TUR,1997.0,1,0,1
PAN,GTM,2004.0,1,0,1
BHR,SAU,1998.0,1,0,1
OMN,KEN,2002.0,1,0,1
PRI,SVK,1999.0,1,0,1
MEX,TWN,2006.0,3,0,3
SEN,GAB,2008.0,1,0,1
,BHS,1994.0,2,0,2
GAB,ESP,2005.0,1,0,1
AFG,PAK,2019.0,3,0,3
BGD,SYR,2013.0,1,0,1
MCO,CAN,2009.0,1,0,1
BRA,ARE,2008.0,4,0,4
,GRD,2000.0,1,0,1
KWT,SWE,2013.0,1,0,1
HUN,KWT,2011.0,1,0,1
CMR,GHA,2007.0,2,0,2
LVA,ARG,2004.0,1,0,1
ARG,LVA,2010.0,1,0,1
MYS,AUT,2016.0,1,0,1
IND,COL,2012.0,1,0,1
TUR,IND,1998.0,1,0,1
PRT,BIH,2014.0,1,0,1
PRT,EGY,2010.0,1,0,1
SEN,BGD,2007.0,1,0,1
IRN,JOR,2013.0,2,0,2
CIV,BEN,2008.0,1,0,1
ROU,TGO,2014.0,1,0,1
CHE,LBN,2002.0,2,0,2
PRI,GTM,2019.0,2,0,2
CUB,DNK,2002.0,1,0,1
NLD,ZMB,2014.0,1,0,1
FRA,PSE,2015.0,3,0,3
EGY,NOR,2009.0,1,0,1
CIV,IND,2018.0,2,0,2
,DMA,2001.0,1,0,1
AUS,GEO,2017.0,2,0,2
BEL,MAC,2016.0,1,0,1
BOL,NZL,2010.0,1,0,1
HND,PER,2017.0,1,0,1
CHE,MNE,2014.0,1,0,1
PRT,NPL,2016.0,1,0,1
IRN,ISL,2016.0,1,0,1
ISR,GEO,2014.0,2,0,2
ESP,BFA,2020.0,1,0,1
GRC,SVN,2022.0,1,0,1
BOL,VEN,2013.0,1,0,1
NLD,AUT,2024.0,1,0,1
LBN,TUN,2007.0,1,0,1
TTO,GRD,2015.0,1,0,1
VNM,COL,2023.0,1,0,1
ARG,FIN,1998.0,1,0,1
CIV,CHE,2022.0,1,0,1
SOM,BGD,2017.0,1,0,1
,GUM,2010.0,3,0,3
GUM,JPN,2015.0,1,0,1
UGA,SWZ,2019.0,1,0,1
MOZ,SOM,2020.0,1,0,1
HKG,MWI,2018.0,1,0,1
NER,NOR,2019.0,1,0,1
MYS,KOR,2004.0,2,0,2
NZL,SRB,2019.0,1,0,1
BEL,IRQ,2020.0,1,0,1
GMB,TWN,2018.0,1,0,1
ITA,SMR,2005.0,1,0,1
SDN,,1999.0,3,0,3
COL,POL,2021.0,2,0,2
BTN,CHN,2023.0,1,0,1
BRN,EGY,2019.0,1,0,1
BIH,DEU,2022.0,4,0,4
IRN,HRV,2021.0,3,0,3
IND,MWI,2021.0,1,0,1
RUS,JOR,2022.0,2,0,2
SGP,BGD,2000.0,1,0,1
IRL,JOR,2021.0,2,0,2
BRN,BFA,2011.0,1,0,1
GHA,CIV,2018.0,2,0,2
POL,PRY,2019.0,1,0,1
ZWE,NAM,2018.0,1,0,1
ZWE,CAN,2017.0,2,0,2
PRT,NAM,2021.0,2,0,2
HKG,PHL,2008.0,2,0,2
,FRO,2011.0,3,0,3
BLR,KAZ,2023.0,1,0,1
GRC,TUN,2021.0,1,0,1
,SMR,2020.0,3,0,3
SYR,TUR,2021.0,3,0,3
,HTI,1997.0,1,0,1
ARG,IRN,2010.0,1,0,1
DNK,UGA,2005.0,1,0,1
GBR,GUF,2019.0,1,0,1
MDA,BEL,2012.0,1,0,1
NAM,GBR,2004.0,5,0,5
SLB,,2010.0,2,0,2
KEN,BGD,2012.0,1,0,1
THA,LAO,2004.0,1,0,1
MDG,ZMB,2014.0,1,0,1
SVK,YEM,2009.0,1,0,1
VGB,LCA,2020.0,1,0,1
CMR,KEN,2009.0,1,0,1
RUS,LTU,2005.0,4,0,4
MWI,CMR,2014.0,1,0,1
SWE,ZMB,2005.0,1,0,1
LVA,BEL,2007.0,1,0,1
GBR,DMA,2005.0,1,0,1
,MTQ,2000.0,2,0,2
TCD,NOR,2008.0,1,0,1
NER,BFA,2015.0,4,0,4
AUT,KEN,2007.0,1,0,1
IND,UKR,2003.0,1,0,1
,FSM,2002.0,1,0,1
JOR,NZL,2002.0,1,0,1
GTM,CHE,2017.0,1,0,1
TZA,CHN,2004.0,1,0,1
GBR,YEM,2001.0,3,0,3
CHN,BGR,2009.0,1,0,1
IND,MNG,2002.0,1,0,1
NLD,OMN,2013.0,1,0,1
BDI,COG,2012.0,1,0,1
YEM,IRQ,2005.0,1,0,1
FRA,GRL,2003.0,1,0,1
JPN,MKD,2014.0,1,0,1
NZL,KNA,2005.0,1,0,1
SWE,EGY,2020.0,1,0,1
GLP,NCL,2013.0,1,0,1
KWT,CYP,2021.0,1,0,1
SEN,FRA,2024.0,1,0,1
NOR,THA,2014.0,1,0,1
ITA,BHR,2011.0,1,0,1
CIV,BEN,2004.0,2,0,2
FRA,AND,2004.0,1,0,1
SLV,MEX,2012.0,1,0,1
TKM,,2000.0,1,0,1
COL,AUT,2007.0,2,0,2
BFA,NLD,2018.0,1,0,1
KAZ,ISR,2004.0,1,0,1
GBR,CRI,2009.0,3,0,3
OMN,TWN,2012.0,1,0,1
PAK,TUR,2006.0,1,0,1
MAR,TUN,2009.0,1,0,1
PHL,QAT,2014.0,1,0,1
BLZ,CAN,2011.0,1,0,1
CAN,BLZ,2012.0,1,0,1
GNB,GIN,2008.0,1,0,1
LUX,KEN,2019.0,1,0,1
AUT,CYP,2015.0,1,0,1
TLS,GBR,2014.0,1,0,1
UKR,EST,2012.0,2,0,2
PER,BEL,2005.0,2,0,2
MWI,IRL,2008.0,1,0,1
FRA,QAT,2010.0,3,0,3
CAN,QAT,2003.0,1,0,1
JOR,QAT,2013.0,4,0,4
HRV,IRL,2006.0,1,0,1
FRA,PSE,2004.0,1,0,1
BMU,FRA,2009.0,1,0,1
TUR,PHL,2015.0,1,0,1
ARE,CHE,2003.0,1,0,1
CHN,YEM,2010.0,1,0,1
THA,IRQ,2023.0,1,0,1
MNG,KGZ,2012.0,1,0,1
CUB,AUS,2016.0,2,0,2
MTQ,CAN,2013.0,2,0,2
LUX,ARE,2021.0,1,0,1
CYM,ESP,2020.0,1,0,1
SWE,IRQ,2012.0,2,0,2
IRN,NGA,2013.0,1,0,1
TUN,CHL,2016.0,1,0,1
FIN,JOR,2016.0,1,0,1
FIN,JOR,2022.0,1,0,1
BRN,IRN,2018.0,1,0,1
DNK,KAZ,2021.0,1,0,1
COM,COL,2015.0,1,0,1
ESP,AFG,2020.0,1,0,1
AUT,COL,2016.0,1,0,1
CYP,POL,2022.0,1,0,1
FRO,ISL,2010.0,1,0,1
KGZ,CHE,2013.0,1,0,1
MMR,BGD,2022.0,1,0,1
UGA,OMN,2013.0,2,0,2
MKD,IND,2012.0,1,0,1
ARM,EST,2014.0,1,0,1
CAN,BRB,2013.0,1,0,1
UKR,BRA,2019.0,2,0,2
COL,KEN,2007.0,1,0,1
MHL,USA,2020.0,1,0,1
LTU,SYR,2018.0,1,0,1
BRN,ARE,2021.0,1,0,1
GHA,AUT,2017.0,1,0,1
ZAF,LUX,2019.0,1,0,1
ISR,POL,2009.0,3,0,3
CYP,NZL,2019.0,1,0,1
NGA,IRL,2019.0,1,0,1
TTO,IND,2021.0,3,0,3
MNE,AUT,2021.0,1,0,1
CIV,TGO,2022.0,2,0,2
LAO,FRA,2004.0,1,0,1
MLT,CHE,2006.0,1,0,1
TTO,NGA,2004.0,1,0,1
NGA,TTO,2006.0,1,0,1
TTO,NGA,2014.0,1,0,1
HRV,JPN,1999.0,2,0,2
SDN,BHR,2008.0,1,0,1
CMR,DNK,2005.0,1,0,1
DNK,CMR,2006.0,1,0,1
CUB,PRI,2006.0,1,0,1
IDN,SGP,1998.0,1,0,1
ESP,CRI,1997.0,2,0,2
SYR,FRA,1997.0,2,0,2
ZAF,ARG,1998.0,3,0,3
GBR,GTM,2011.0,1,0,1
IRL,SVK,2005.0,1,0,1
EST,LVA,2010.0,1,1,0
TUR,GRC,2012.0,4,7,-3
ITA,MYS,2016.0,5,7,-2
IRL,TUR,2014.0,5,3,2
URY,AUT,2012.0,1,1,0
POL,IRL,2019.0,4,4,0
POL,TWN,2023.0,2,2,0
MEX,POL,2023.0,3,5,-2
GEO,ITA,2022.0,1,1,0
IRL,FIN,2014.0,4,5,-1
LIE,DEU,1998.0,2,6,-4
CAN,ROU,1999.0,3,7,-4
USA,ASM,2006.0,3,1,2
IRL,HKG,1998.0,1,1,0
EST,USA,2009.0,4,8,-4
ZWE,COG,2005.0,2,1,1
RUS,DNK,2001.0,4,6,-2
ARG,POL,2010.0,1,1,0
UKR,ISR,2009.0,2,1,1
PAK,NPL,2021.0,1,4,-3
NLD,ROU,2014.0,2,13,-11
FIN,HUN,2012.0,5,4,1
IRL,EST,2022.0,1,1,0
NGA,JPN,2015.0,3,1,2
NLD,ZWE,2021.0,2,1,1
NOR,ALB,2016.0,2,1,1
CHN,PAK,2005.0,2,3,-1
KOR,IRL,2022.0,4,2,2
KAZ,ISR,2020.0,3,1,2
LAO,FRA,2020.0,3,5,-2
CMR,ZAF,2008.0,4,1,3
PHL,IDN,2015.0,2,1,1
SWE,SVN,2015.0,2,7,-5
CHE,MAR,2003.0,2,1,1
SVN,HRV,2022.0,5,1,4
RUS,MDA,1999.0,3,3,0
BEL,MYS,2008.0,2,2,0
PHL,ESP,2009.0,5,1,4
NOR,POL,2001.0,3,7,-4
COL,MEX,2000.0,2,1,1
TUR,IRL,2009.0,1,1,0
NLD,GHA,2011.0,3,2,1
GBR,CMR,2003.0,3,1,2
AUS,MNG,2018.0,2,1,1
SRB,IND,2007.0,3,1,2
ISL,CAN,2009.0,2,2,0
LBN,KWT,2018.0,2,3,-1
SYR,LBN,2011.0,2,2,0
BGD,PRT,2019.0,2,1,1
MOZ,NLD,2013.0,1,1,0
TWN,KOR,2005.0,4,2,2
BEL,SAU,2018.0,5,3,2
USA,MNG,2023.0,2,4,-2
OMN,FIN,2015.0,1,1,0
BRB,JAM,2019.0,1,4,-3
KAZ,TUR,2020.0,5,12,-7
CZE,HKG,2023.0,2,1,1
MEX,SVK,2022.0,2,1,1
SLE,DEU,2019.0,1,2,-1
LKA,HKG,2021.0,1,1,0
ECU,ESP,2000.0,4,2,2
USA,BHR,2010.0,3,3,0
IND,NOR,2006.0,2,3,-1
UGA,NOR,2020.0,1,3,-2
NPL,NLD,2012.0,3,2,1
COL,DNK,2015.0,2,2,0
IDN,SGP,2008.0,5,2,3
ARM,IRN,2013.0,5,3,2
PRT,CPV,2013.0,1,3,-2
CYP,NGA,2023.0,1,2,-1
ARM,ITA,2006.0,1,1,0
GBR,NPL,2014.0,8,11,-3
PAN,GTM,2020.0,1,1,0
PNG,GBR,1999.0,3,2,1
CZE,LTU,2010.0,1,1,0
ITA,ATA,2019.0,1,1,0
ZAF,EST,2014.0,1,1,0
USA,MLI,2001.0,6,5,1
DNK,TWN,2014.0,1,3,-2
USA,BHR,2023.0,4,5,-1
TWN,BEL,2018.0,5,6,-1
PAK,FRA,2012.0,6,26,-20
CHL,COL,2004.0,2,7,-5
GBR,OMN,2004.0,6,4,2
MYS,ESP,2014.0,4,4,0
ESP,SVK,2008.0,3,2,1
BWA,ZWE,2015.0,4,1,3
BGR,JPN,2011.0,3,4,-1
BHR,USA,2011.0,2,6,-4
KHM,COL,2018.0,1,2,-1
BLR,SVK,2000.0,2,1,1
MKD,HRV,2008.0,2,1,1
FRA,DJI,2007.0,1,1,0
JOR,MYS,2009.0,6,8,-2
ARE,GRC,2018.0,2,10,-8
LKA,SWE,2010.0,1,2,-1
SVK,FRA,2016.0,3,3,0
POL,KEN,2008.0,2,1,1
CHL,DNK,2016.0,2,2,0
LVA,DEU,2015.0,3,3,0
ZAF,GHA,2016.0,5,11,-6
EST,USA,2011.0,6,8,-2
ARE,AUS,2013.0,8,13,-5
POL,DNK,1999.0,4,8,-4
DNK,ZAF,2002.0,3,2,1
AUT,BGR,2018.0,2,2,0
VEN,ESP,1997.0,6,5,1
NOR,ETH,2007.0,1,6,-5
FRA,KHM,2012.0,5,2,3
THA,BGD,2016.0,3,1,2
ZAF,SDN,2016.0,2,1,1
ARG,VEN,2016.0,1,4,-3
LKA,SGP,2005.0,2,1,1
BRA,GTM,2019.0,2,1,1
ITA,ROU,2014.0,10,18,-8
NZL,KEN,2020.0,2,2,0
LVA,AUT,2016.0,1,2,-1
SRB,ESP,2016.0,4,4,0
NLD,BIH,2009.0,1,1,0
PAK,OMN,2003.0,1,1,0
MKD,HRV,2015.0,3,1,2
ZAF,EGY,2011.0,3,2,1
KOR,HUN,2023.0,1,2,-1
CAN,PER,2021.0,2,5,-3
KEN,ESP,2022.0,1,1,0
TWN,PAK,2015.0,2,1,1
USA,AFG,2008.0,3,4,-1
SWE,EGY,2014.0,4,5,-1
MLI,MAR,2011.0,1,1,0
BEL,RWA,2017.0,1,2,-1
RWA,CAN,2017.0,1,1,0
COG,NGA,2021.0,1,2,-1
PRT,ROU,2014.0,5,1,4
MAR,GBR,2012.0,2,1,1
USA,FJI,2006.0,3,2,1
NZL,ZAF,2000.0,2,6,-4
SVN,ESP,2003.0,1,3,-2
UKR,CAN,2004.0,9,2,7
DEU,MLT,2013.0,1,1,0
OMN,USA,2008.0,5,9,-4
ISR,NOR,2013.0,2,3,-1
CUB,CHN,2011.0,1,1,0
IRL,ZAF,2023.0,1,6,-5
LUX,BRA,2007.0,1,1,0
CHL,JPN,2005.0,4,2,2
DEU,NER,1999.0,1,1,0
BEL,TUR,2009.0,5,9,-4
THA,ITA,2007.0,1,1,0
ECU,DEU,2020.0,5,10,-5
NZL,ESP,2005.0,1,1,0
YEM,EGY,2007.0,1,2,-1
SRB,SVK,2010.0,1,1,0
SAU,MEX,2017.0,2,3,-1
HKG,THA,2010.0,1,1,0
RUS,SVN,2015.0,3,4,-1
NZL,MEX,2018.0,4,2,2
FRA,BFA,2004.0,3,9,-6
URY,MEX,2020.0,1,3,-2
FIN,EST,2006.0,8,3,5
PHL,HKG,2021.0,6,1,5
ITA,VEN,2020.0,1,3,-2
PHL,ESP,2021.0,2,3,-1
UKR,BEL,2022.0,2,2,0
GBR,LTU,1998.0,1,3,-2
CHN,KGZ,2020.0,1,2,-1
EGY,PRT,2015.0,2,2,0
GRD,TTO,2014.0,1,1,0
VNM,BEL,2007.0,3,2,1
ZAF,IRL,2003.0,2,3,-1
NLD,MYS,2005.0,2,3,-1
CHL,VEN,2001.0,1,1,0
CAN,COL,1998.0,2,3,-1
ARE,TUR,2012.0,1,2,-1
BWA,ETH,2019.0,2,2,0
BHR,GBR,2007.0,1,1,0
QAT,JOR,2017.0,2,11,-9
DZA,ITA,2014.0,1,3,-2
ARE,ETH,2018.0,1,1,0
UZB,USA,2012.0,3,3,0
MNG,RUS,2014.0,1,2,-1
PRT,TUR,2020.0,2,6,-4
ITA,KEN,2003.0,1,1,0
SVK,SWE,2008.0,1,1,0
ARE,MYS,2007.0,2,2,0
BEL,QAT,2021.0,1,3,-2
SAU,NGA,2016.0,1,2,-1
OMN,PAK,2019.0,2,12,-10
IRL,IND,2000.0,1,1,0
UZB,GBR,2000.0,1,2,-1
BRA,SRB,2007.0,1,1,0
JPN,HUN,2008.0,1,6,-5
CHL,JPN,1997.0,1,1,0
CHE,SEN,2012.0,3,1,2
FSM,USA,2004.0,1,2,-1
FRA,IDN,2002.0,5,6,-1
USA,MAR,2000.0,5,7,-2
EST,USA,2008.0,1,9,-8
BMU,GBR,2005.0,2,1,1
AUS,NOR,1999.0,5,6,-1
NLD,PHL,2003.0,2,3,-1
MYS,TUR,2023.0,11,2,9
ARE,ESP,2014.0,2,1,1
IRL,CHN,2006.0,6,8,-2
TTO,GBR,2014.0,4,3,1
KOR,SGP,2001.0,4,3,1
KOR,DNK,2016.0,9,5,4
AUT,NZL,2007.0,3,2,1
DNK,IND,2001.0,3,4,-1
ARE,AUS,2010.0,7,12,-5
NZL,CHN,2005.0,6,4,2
KOR,CHE,2009.0,8,6,2
JAM,GBR,2018.0,3,1,2
NLD,HKG,2000.0,3,3,0
SRB,POL,2006.0,4,7,-3
ISR,GRC,2013.0,2,3,-1
CHL,VEN,2009.0,5,5,0
DEU,ARM,2008.0,2,5,-3
SYR,GBR,2009.0,2,6,-4
ARG,NLD,2003.0,2,7,-5
JPN,KHM,2008.0,3,2,1
FRA,LAO,2009.0,3,3,0
NOR,IND,2009.0,1,11,-10
MLI,BFA,2012.0,3,1,2
JOR,CAN,2009.0,5,7,-2
AUS,KOR,2007.0,8,14,-6
CMR,ZAF,2011.0,6,4,2
CHN,MEX,2005.0,1,3,-2
MLT,USA,2016.0,2,4,-2
BRA,PRT,2002.0,32,43,-11
NLD,SVN,2000.0,2,1,1
RUS,BGR,2005.0,4,2,2
FRA,MKD,2007.0,1,1,0
AUT,MKD,2018.0,5,1,4
USA,ETH,2001.0,7,5,2
BFA,FRA,2003.0,8,16,-8
POL,ROU,2012.0,3,1,2
KWT,GBR,2009.0,5,7,-2
NLD,ETH,2009.0,4,5,-1
SVK,UKR,2015.0,2,4,-2
AUS,SVN,2013.0,2,2,0
NZL,NOR,2009.0,4,3,1
IRN,AUT,2012.0,7,6,1
PRT,TUR,2018.0,5,6,-1
ARE,IRQ,2010.0,1,3,-2
MYS,FRA,1999.0,2,1,1
LTU,GBR,2019.0,6,7,-1
SGP,PHL,2012.0,1,3,-2
GRC,EGY,2012.0,3,1,2
NOR,CHN,2002.0,2,10,-8
BEL,CUB,2015.0,3,1,2
SDN,GBR,2000.0,2,1,1
ARE,AUT,2021.0,2,4,-2
EGY,KOR,2008.0,3,3,0
BLR,USA,2005.0,8,5,3
BEN,DEU,2001.0,4,1,3
AUT,PRT,2008.0,2,1,1
NGA,NLD,2009.0,2,4,-2
GBR,UGA,1999.0,4,6,-2
CUB,SWE,2002.0,1,1,0
OMN,LKA,2015.0,2,1,1
BGD,NOR,2014.0,3,1,2
ISR,PSE,2015.0,14,20,-6
HKG,DNK,2020.0,5,2,3
DNK,VNM,2018.0,4,1,3
UKR,AUS,2019.0,2,2,0
USA,LVA,2022.0,4,2,2
SAU,DZA,2015.0,6,2,4
GAB,GBR,2012.0,2,2,0
CRI,CHL,2007.0,2,1,1
DNK,VNM,2017.0,5,3,2
IND,TZA,2013.0,2,2,0
COL,NIC,2013.0,1,1,0
CHN,MNG,2020.0,9,10,-1
SWE,QAT,2013.0,1,1,0
CHE,BLR,2009.0,1,1,0
FIN,TUR,2023.0,2,7,-5
BRA,HUN,2017.0,3,4,-1
CHE,URY,2017.0,1,1,0
ROU,DZA,2020.0,3,2,1
SDN,ARE,2020.0,4,3,1
NPL,THA,2010.0,3,1,2
BEL,VEN,2014.0,1,1,0
VNM,SGP,2008.0,4,1,3
BIH,HRV,2013.0,5,12,-7
SGP,QAT,2020.0,2,2,0
AUT,EST,2017.0,2,2,0
SVK,SWE,2011.0,1,3,-2
USA,LSO,2018.0,2,4,-2
LTU,ITA,2017.0,4,1,3
IDN,NLD,2010.0,8,23,-15
NPL,AUS,2012.0,6,4,2
ESP,ECU,2011.0,10,4,6
HUN,IRN,2013.0,3,1,2
MNG,JPN,2011.0,4,8,-4
SWE,COL,2014.0,6,4,2
JPN,POL,2014.0,9,7,2
KHM,THA,2019.0,4,2,2
COL,CRI,2008.0,3,1,2
CHE,MEX,2015.0,7,10,-3
CHN,TUR,2011.0,3,2,1
TGO,USA,2013.0,1,1,0
COL,FRA,2008.0,5,11,-6
CHN,NZL,2011.0,8,16,-8
AUS,BRN,2011.0,1,3,-2
GBR,GEO,2016.0,3,3,0
ISR,ARG,2000.0,4,1,3
JOR,LBN,2015.0,1,1,0
THA,IND,2003.0,1,2,-1
ZAF,TWN,2013.0,8,1,7
NPL,NOR,2014.0,5,4,1
PER,AUS,2014.0,3,2,1
SGP,SWE,2015.0,9,11,-2
KEN,MLI,2019.0,1,1,0
MDA,ROU,2015.0,1,6,-5
PRT,LUX,2012.0,1,1,0
ZAF,HKG,2021.0,1,2,-1
SWE,COL,2015.0,4,3,1
NER,BFA,2022.0,1,2,-1
TUR,MYS,2019.0,6,10,-4
SGP,BEL,2021.0,6,7,-1
HRV,AUS,2020.0,2,1,1
IND,NOR,2003.0,4,2,2
AUS,OMN,2020.0,6,4,2
ESP,CRI,2000.0,1,2,-1
CRI,ESP,2001.0,3,2,1
AUT,SVN,2023.0,2,5,-3
AUT,LIE,2019.0,4,2,2
EGY,SVK,2021.0,1,1,0
NOR,PAK,2020.0,1,6,-5
CHN,CUB,2020.0,3,5,-2
MYS,QAT,2021.0,9,4,5
CAN,SRB,2022.0,4,2,2
PAN,GBR,2020.0,3,4,-1
RWA,CHE,2017.0,1,1,0
SAU,TUR,2021.0,7,14,-7
SLV,SVN,2010.0,2,11,-9
AUT,THA,2014.0,8,6,2
MAR,SWE,2022.0,3,1,2
SRB,AUT,2021.0,8,8,0
USA,ALB,2012.0,2,1,1
SVN,AUT,2023.0,5,2,3
AUS,BRN,2021.0,2,2,0
POL,HUN,1999.0,2,1,1
GBR,MOZ,2010.0,2,1,1
ETH,CHE,2020.0,3,5,-2
COD,ZAF,2020.0,1,2,-1
IDN,POL,2021.0,4,1,3
KEN,AUT,2020.0,4,2,2
ZAF,NOR,2009.0,3,4,-1
SWE,SGP,2018.0,10,16,-6
CRI,BRA,2019.0,4,6,-2
VNM,BEL,2017.0,7,21,-14
THA,ITA,2022.0,5,3,2
GBR,UGA,1998.0,8,1,7
CHN,SEN,2014.0,2,1,1
CHE,HUN,2011.0,5,23,-18
PSE,EGY,2021.0,2,5,-3
GBR,SVK,2005.0,6,12,-6
ARE,IRL,2023.0,1,5,-4
PHL,SWE,2019.0,1,1,0
TUR,BGD,2022.0,3,6,-3
SWE,MEX,2006.0,5,2,3
COL,PER,2022.0,8,4,4
BEL,ISR,2011.0,5,4,1
IRL,BGR,2016.0,2,1,1
DNK,MEX,2012.0,3,3,0
FRA,PER,2008.0,7,3,4
GBR,SVN,1998.0,6,4,2
SWE,ZAF,2011.0,5,3,2
NLD,ZWE,2014.0,4,1,3
IDN,GBR,2007.0,2,12,-10
PAK,AUS,1998.0,2,1,1
BLR,USA,1997.0,4,4,0
LVA,DEU,2009.0,6,4,2
SGP,BGR,2017.0,1,1,0
PRT,ITA,1997.0,4,3,1
ISR,SWE,2013.0,5,5,0
SVN,HUN,1999.0,1,1,0
SEN,CMR,2002.0,1,1,0
PER,AUT,2009.0,1,1,0
NLD,NPL,2006.0,1,4,-3
UKR,JPN,2001.0,8,13,-5
CZE,ESP,2001.0,5,6,-1
SVN,SWE,2002.0,2,1,1
ITA,ARG,1999.0,7,10,-3
YEM,EGY,2017.0,1,7,-6
GRC,DNK,2002.0,4,2,2
ITA,IRN,1999.0,2,2,0
IND,AUT,2008.0,6,3,3
KEN,DEU,2008.0,8,6,2
BEL,CHL,2006.0,2,5,-3
GRC,AUS,2002.0,2,3,-1
CZE,AUS,2007.0,3,3,0
DEU,THA,2023.0,10,8,2
USA,PAK,2024.0,5,7,-2
AUT,NZL,1998.0,3,1,2
MOZ,ESP,2020.0,2,3,-1
JPN,CZE,1999.0,3,2,1
IND,KEN,2013.0,1,3,-2
RUS,TWN,1999.0,3,1,2
BGR,SWE,1999.0,3,1,2
JPN,ROU,2002.0,5,5,0
MOZ,BRA,2014.0,4,2,2
AUT,SVK,2005.0,4,13,-9
USA,UZB,2014.0,2,1,1
BRA,BEL,1997.0,7,13,-6
UKR,BLR,2006.0,2,3,-1
ZMB,NGA,2021.0,1,1,0
SWE,SRB,2001.0,2,1,1
AUT,UKR,1999.0,2,1,1
CHE,MEX,2001.0,5,2,3
TGO,BFA,2004.0,1,1,0
DNK,RUS,2016.0,5,3,2
IRN,SWE,2004.0,4,4,0
TUR,AUT,2015.0,4,3,1
BRA,AUS,2000.0,8,8,0
ZAF,GRC,1999.0,3,1,2
TUR,NLD,2000.0,8,3,5
FRA,TGO,2000.0,3,2,1
PRI,VEN,2005.0,1,2,-1
EGY,ESP,2005.0,2,6,-4
BGD,THA,2002.0,2,1,1
POL,MEX,1997.0,3,2,1
IND,BWA,2013.0,2,1,1
GBR,LBN,2012.0,10,5,5
SVN,GBR,2017.0,18,7,11
MYS,SDN,2011.0,3,1,2
JPN,TUR,2000.0,6,3,3
POL,AUT,2005.0,5,3,2
NZL,HUN,2005.0,2,1,1
SGP,BGD,2012.0,4,2,2
OMN,IND,2013.0,4,19,-15
ZMB,GBR,2010.0,3,4,-1
TUR,FIN,2014.0,4,1,3
BEL,EGY,2016.0,5,7,-2
UGA,KEN,2014.0,8,9,-1
PRT,CHE,2007.0,8,5,3
MNG,RUS,2011.0,1,2,-1
BEL,IRN,2013.0,5,17,-12
USA,MUS,2020.0,4,2,2
LTU,BEL,2011.0,2,2,0
PAK,QAT,2015.0,6,1,5
FRA,BLR,1997.0,1,1,0
IND,GRC,2017.0,3,1,2
AUS,TUR,2011.0,4,8,-4
BHS,USA,2010.0,4,1,3
SRB,SWE,2015.0,3,1,2
USA,BHS,2015.0,4,2,2
ARE,CAN,2006.0,5,17,-12
TUR,DNK,2010.0,5,3,2
ISR,PRT,2021.0,2,1,1
BMU,CAN,2005.0,1,1,0
ITA,IRN,2007.0,4,7,-3
GBR,KAZ,2020.0,8,7,1
COL,AUS,2010.0,5,6,-1
ALB,NLD,2018.0,1,1,0
AUS,EST,2020.0,1,2,-1
CHE,ZAF,2022.0,6,14,-8
JPN,JOR,2014.0,3,1,2
ZAF,LSO,2010.0,2,5,-3
LSO,ZAF,2014.0,1,1,0
TUR,SVK,2023.0,1,1,0
TWN,RUS,2008.0,3,5,-2
VEN,CHE,2013.0,1,1,0
KEN,ITA,2011.0,3,2,1
NZL,CHL,2014.0,4,6,-2
NZL,PRT,2011.0,2,1,1
CHE,KEN,2018.0,6,9,-3
IRL,NOR,2015.0,4,2,2
SRB,BGR,2002.0,1,1,0
ISL,CAN,2014.0,1,4,-3
EST,NOR,2019.0,4,4,0
ZAF,TUR,2013.0,3,4,-1
TWN,THA,2018.0,16,8,8
ZAF,BEN,2004.0,1,2,-1
ZMB,BWA,2012.0,2,1,1
MEX,FIN,2015.0,1,2,-1
BEL,TWN,2012.0,1,1,0
SAU,THA,2011.0,1,1,0
RUS,THA,2023.0,2,1,1
ITA,URY,2023.0,2,2,0
PHL,DNK,2001.0,2,1,1
DNK,GRL,2000.0,1,1,0
SVK,POL,2011.0,5,4,1
NOR,KOR,2008.0,1,3,-2
KOR,NOR,2020.0,11,5,6
HKG,NLD,2006.0,5,3,2
HRV,CHE,2015.0,6,3,3
MCO,FRA,2004.0,7,16,-9
MCO,FRA,2015.0,3,16,-13
TZA,CHN,2022.0,2,21,-19
HRV,GBR,1999.0,4,4,0
MAC,AUS,2023.0,3,2,1
LBN,ITA,2023.0,3,1,2
IND,GRC,2022.0,1,3,-2
NZL,THA,2023.0,3,1,2
GHA,DNK,2022.0,1,2,-1
TWN,MYS,2022.0,10,13,-3
THA,LAO,2022.0,4,4,0
SAU,PRT,2022.0,1,2,-1
AZE,ARM,2021.0,1,1,0
BRA,JPN,2022.0,9,13,-4
UGA,COD,2021.0,3,3,0
ETH,CMR,2022.0,1,1,0
USA,DOM,2002.0,1,1,0
BEL,CIV,1998.0,3,1,2
NOR,ISL,2000.0,4,1,3
ARE,SGP,2012.0,1,8,-7
ROU,BRA,2009.0,1,1,0
JOR,SAU,2006.0,7,5,2
SYR,TUR,2020.0,1,1,0
PSE,DEU,2003.0,2,1,1
ESP,ISR,2022.0,11,10,1
NGA,SAU,1999.0,1,1,0
MSR,GBR,2007.0,1,2,-1
CRI,ESP,2008.0,1,5,-4
ZAF,SWE,2004.0,3,8,-5
DEU,KWT,2001.0,2,2,0
ECU,GBR,2001.0,4,4,0
BMU,CAN,2002.0,1,1,0
NOR,ESP,2004.0,6,5,1
SWE,NIC,2011.0,1,4,-3
AUS,NGA,1999.0,2,3,-1
IDN,IND,2001.0,8,1,7
UKR,ITA,1999.0,3,1,2
AUS,NER,2013.0,1,1,0
CHE,GEO,2018.0,1,2,-1
SWE,ISL,2013.0,11,19,-8
TUR,UKR,2004.0,2,1,1
GRL,DNK,2010.0,1,2,-1
DNK,GRL,2023.0,5,3,2
CIV,ZAF,2002.0,2,5,-3
IND,BRA,2007.0,5,5,0
UZB,KOR,2008.0,3,1,2
SWE,HRV,2013.0,2,1,1
SGP,DNK,2009.0,3,2,1
FRA,KWT,2009.0,2,1,1
DEU,OMN,1997.0,1,1,0
DNK,IND,2004.0,5,4,1
IND,DNK,2007.0,7,4,3
HRV,DEU,1999.0,6,18,-12
MEX,HUN,2019.0,4,1,3
ZAF,AUT,2009.0,1,3,-2
GHA,USA,2003.0,5,9,-4
PHL,MYS,2013.0,2,4,-2
DZA,USA,2003.0,2,7,-5
ITA,CYP,1999.0,2,1,1
COL,HKG,2020.0,1,1,0
PNG,USA,2000.0,4,5,-1
ARE,AUS,2006.0,4,6,-2
BGD,CAN,2005.0,7,5,2
AUS,SAU,2004.0,7,4,3
CHL,CUB,2012.0,4,5,-1
QAT,LBN,2015.0,4,3,1
KOR,NPL,2011.0,1,3,-2
GRD,TTO,2011.0,1,7,-6
BEL,CUB,2014.0,1,2,-1
DEU,UKR,2012.0,10,29,-19
HKG,GBR,2024.0,3,1,2
GMB,GBR,2007.0,6,6,0
IRL,DNK,2013.0,9,5,4
QAT,ESP,2015.0,1,6,-5
SRB,SVN,2009.0,2,1,1
POL,TUR,2011.0,1,3,-2
CHE,SVN,2016.0,3,11,-8
USA,GRD,2010.0,6,4,2
VNM,FIN,2011.0,1,1,0
BRA,SAU,2021.0,7,1,6
GBR,VEN,2019.0,1,3,-2
MAR,MRT,2017.0,2,1,1
NGA,COG,2018.0,1,2,-1
PRY,MEX,2020.0,2,1,1
GRC,AUT,2022.0,5,8,-3
POL,TUR,2021.0,2,10,-8
SVN,BEL,2019.0,4,2,2
PRT,CUB,2001.0,1,2,-1
UGA,FRA,2012.0,2,3,-1
MYS,HKG,2012.0,3,13,-10
SGP,DNK,2011.0,2,2,0
SVN,ITA,2012.0,11,6,5
BEN,CIV,2020.0,2,6,-4
NOR,EST,2015.0,2,4,-2
USA,KHM,2019.0,8,8,0
ARG,AUS,2011.0,5,7,-2
RUS,ARM,2002.0,3,6,-3
ISL,FRA,2014.0,6,3,3
QAT,DNK,2019.0,2,1,1
JOR,SYR,2018.0,2,1,1
PAK,KWT,2015.0,2,1,1
GEO,CHN,2023.0,1,1,0
IDN,IND,2014.0,5,27,-22
AUS,BRN,2019.0,5,3,2
ARE,MYS,2022.0,5,22,-17
ITA,EST,2016.0,3,2,1
ETH,KEN,2017.0,7,8,-1
TZA,DEU,2015.0,8,5,3
KOR,ZAF,2017.0,7,4,3
GTM,SLV,2014.0,1,1,0
AUS,UZB,2023.0,1,1,0
COL,CRI,2015.0,1,6,-5
ZAF,PAK,2021.0,4,3,1
LVA,DEU,2019.0,3,5,-2
FRA,JOR,2011.0,4,1,3
TWN,ETH,2015.0,1,4,-3
JPN,BEL,2021.0,12,13,-1
SWE,KEN,2022.0,2,4,-2
MYS,EGY,1999.0,2,1,1
TWN,ESP,2017.0,1,5,-4
ZAF,COG,2017.0,2,2,0
MAC,THA,2023.0,1,1,0
CRI,DEU,2021.0,5,8,-3
CRI,CHL,2020.0,5,1,4
RUS,SGP,2023.0,4,1,3
BWA,ZWE,2019.0,2,1,1
GHA,KOR,2017.0,1,2,-1
BFA,SEN,2010.0,2,3,-1
ARE,CHN,2019.0,5,9,-4
LAO,FRA,2017.0,6,3,3
SDN,JPN,2018.0,1,1,0
SGP,NLD,2017.0,13,23,-10
BHR,USA,2015.0,2,6,-4
BLR,FRA,2016.0,1,1,0
BRA,URY,2019.0,15,11,4
AUS,BGR,2005.0,2,1,1
LKA,GBR,2006.0,5,10,-5
PER,CHE,2018.0,1,6,-5
VNM,NGA,2022.0,1,1,0
COD,JPN,2022.0,2,2,0
FJI,USA,2017.0,1,2,-1
FRA,THA,2023.0,3,6,-3
GHA,PRT,2022.0,2,1,1
IRN,QAT,2023.0,3,1,2
FIN,TWN,2023.0,2,3,-1
NZL,CHE,2020.0,7,19,-12
LBN,BEL,2020.0,4,9,-5
ITA,HKG,2022.0,6,2,4
MAR,TUR,2023.0,2,1,1
GHA,NZL,2021.0,1,1,0
NLD,ISL,2007.0,4,2,2
SWE,LTU,2013.0,5,5,0
NPL,TWN,2021.0,2,1,1
LBN,QAT,2019.0,3,3,0
BEN,TGO,2021.0,2,3,-1
CHL,CAN,2023.0,11,13,-2
MCO,USA,2007.0,2,1,1
TWN,HKG,2010.0,9,7,2
ZAF,COG,2022.0,2,3,-1
DEU,BWA,2017.0,1,1,0
DEU,BGD,2010.0,2,4,-2
LTU,ITA,2022.0,4,5,-1
TUN,BRA,2022.0,1,1,0
AUT,ARG,2022.0,1,5,-4
PHL,CZE,2022.0,1,2,-1
GIN,FRA,2012.0,3,3,0
JOR,AUS,2022.0,2,10,-8
GHA,ETH,2006.0,2,2,0
ZMB,GBR,2023.0,6,4,2
MYS,CHE,2021.0,3,5,-2
ARE,FRA,2002.0,1,2,-1
MOZ,PRT,2006.0,1,1,0
LKA,THA,2014.0,1,2,-1
BRN,AUS,2005.0,2,2,0
SGP,SAU,2013.0,4,1,3
SVK,AUT,2011.0,7,11,-4
CZE,BEL,2013.0,11,10,1
USA,HTI,2023.0,2,3,-1
PRT,HUN,2004.0,1,1,0
BGR,ITA,2000.0,5,6,-1
HRV,HUN,2020.0,1,2,-1
LUX,FRA,1999.0,1,2,-1
MEX,BOL,2006.0,1,1,0
PRI,GBR,2011.0,2,3,-1
EGY,DNK,2018.0,3,6,-3
ESP,UKR,2012.0,2,3,-1
PHL,FIN,2003.0,1,1,0
TTO,USA,2000.0,1,6,-5
DOM,ESP,2002.0,1,1,0
SGP,ISR,1999.0,1,1,0
EGY,POL,2006.0,1,3,-2
MUS,CAN,2002.0,1,1,0
GBR,GMB,2000.0,4,6,-2
TWN,AUT,2009.0,1,2,-1
ITA,FIN,2006.0,8,6,2
HKG,BGD,2007.0,2,1,1
EST,USA,2004.0,5,7,-2
USA,MDG,2001.0,2,2,0
ESP,VEN,2000.0,14,18,-4
BEL,IND,2002.0,2,9,-7
HUN,BRA,2012.0,3,2,1
CAN,IDN,2001.0,2,2,0
USA,MWI,2009.0,15,6,9
IRL,MYS,2007.0,1,2,-1
USA,ZWE,2021.0,16,4,12
USA,BWA,2014.0,12,5,7
SRB,RUS,2008.0,3,2,1
BEN,CHE,2018.0,2,1,1
TZA,DEU,2001.0,1,3,-2
MUS,IRL,2000.0,1,1,0
TUN,CHE,2002.0,1,3,-2
GBR,EST,2000.0,1,1,0
TWN,VNM,2007.0,1,1,0
LAO,JPN,2016.0,2,4,-2
JPN,LAO,2019.0,8,2,6
ARE,GEO,2018.0,1,1,0
CHN,KEN,2005.0,1,1,0
CHN,KEN,2012.0,2,1,1
SWE,LTU,2003.0,6,5,1
ARE,JOR,2019.0,11,35,-24
SWZ,NGA,2018.0,1,4,-3
NCL,VUT,2016.0,1,1,0
AUT,ESP,1999.0,4,9,-5
NOR,RUS,2013.0,8,10,-2
KWT,IND,2005.0,4,8,-4
NLD,NZL,1999.0,3,9,-6
KOR,FIN,2008.0,1,2,-1
TUR,IND,2009.0,3,6,-3
SGP,SWE,2001.0,3,1,2
ESP,KOR,2007.0,7,2,5
OMN,SAU,2006.0,2,3,-1
ISR,ZAF,2003.0,4,1,3
TWN,SGP,2003.0,3,3,0
AUT,MEX,2008.0,1,3,-2
IRL,SGP,2018.0,5,3,2
NGA,NAM,2020.0,1,1,0
HKG,KOR,2003.0,3,2,1
GBR,COD,1997.0,1,1,0
LVA,POL,2003.0,1,1,0
ARE,MYS,2016.0,3,22,-19
GMB,ZAF,2014.0,1,1,0
GBR,MUS,2003.0,2,1,1
MDG,MUS,2021.0,2,1,1
NZL,CHN,2002.0,4,4,0
ARE,QAT,2015.0,11,1,10
HUN,NLD,2005.0,5,8,-3
IRN,BRA,2010.0,4,1,3
DNK,SVN,2006.0,1,1,0
ITA,SVK,2006.0,2,2,0
GRC,ARE,2016.0,5,2,3
USA,GUM,2009.0,4,6,-2
NLD,MOZ,2018.0,2,2,0
THA,AUT,2006.0,1,4,-3
FRA,GEO,2018.0,6,32,-26
ETH,ITA,2021.0,6,7,-1
JPN,KEN,2005.0,6,4,2
COG,ZWE,2016.0,2,1,1
FJI,AUS,2006.0,3,4,-1
SWE,CUB,2009.0,2,1,1
BWA,KEN,2009.0,1,1,0
PAN,CAN,2008.0,4,1,3
KOR,UKR,2012.0,4,4,0
FRA,MDA,2011.0,3,1,2
UGA,USA,2006.0,9,16,-7
DZA,ESP,2014.0,3,9,-6
MDA,DEU,2009.0,3,4,-1
PRT,FIN,2009.0,2,2,0
NLD,EGY,2013.0,4,1,3
DNK,SVN,2010.0,1,2,-1
USA,FJI,2013.0,2,1,1
BEL,ZAF,2004.0,7,7,0
LVA,BEL,2009.0,2,1,1
TWN,SGP,2013.0,11,15,-4
SWE,LVA,2018.0,4,3,1
TUR,SAU,2001.0,2,1,1
BRA,BLR,2018.0,2,1,1
BOL,BRA,2017.0,1,3,-2
TUR,PRT,2014.0,1,2,-1
PRT,TUR,2017.0,1,5,-4
SDN,ZAF,2010.0,1,1,0
ARG,VEN,2007.0,2,3,-1
PRT,BEL,2011.0,5,13,-8
PRT,GNB,2016.0,3,1,2
AUS,COL,2020.0,6,14,-8
NZL,MYS,2012.0,8,15,-7
CAN,PER,2014.0,2,1,1
CZE,PAK,2018.0,4,2,2
USA,ASM,2003.0,1,1,0
MAR,IND,2019.0,1,2,-1
ZAF,NZL,2014.0,4,3,1
SRB,BEL,2017.0,4,2,2
SWE,NZL,1999.0,5,5,0
TUR,IND,2011.0,5,3,2
ISR,MEX,2023.0,1,1,0
ARE,KOR,2017.0,4,13,-9
FIN,BGR,2011.0,1,2,-1
HRV,BEL,2011.0,3,1,2
PHL,CHN,2001.0,4,1,3
ESP,HUN,2000.0,3,2,1
KAZ,HUN,2020.0,1,2,-1
SAU,NGA,1998.0,2,2,0
QAT,IRL,2023.0,3,1,2
FIN,MEX,2019.0,2,5,-3
PER,COL,2013.0,3,1,2
FRA,JOR,2019.0,4,1,3
IRN,IRL,2013.0,9,6,3
HKG,CHE,1997.0,2,1,1
FIN,KOR,2018.0,2,3,-1
CMR,NGA,2021.0,6,2,4
GTM,ESP,2017.0,3,3,0
POL,EGY,2016.0,3,1,2
CHE,NPL,2010.0,2,1,1
ISR,NOR,2000.0,1,1,0
TUR,NOR,1999.0,5,1,4
BGR,GRC,1999.0,2,3,-1
RUS,KOR,2000.0,8,2,6
IND,POL,2001.0,3,1,2
ITA,CMR,2006.0,1,1,0
DNK,HUN,2004.0,3,2,1
THA,NLD,2003.0,4,2,2
NZL,ARE,2012.0,5,1,4
SWE,MEX,2000.0,1,2,-1
BGR,ITA,2010.0,5,2,3
ITA,MDA,2008.0,1,1,0
BRA,DNK,2002.0,2,1,1
CAN,CYP,2012.0,2,1,1
IND,TUR,2002.0,9,2,7
ALB,USA,2001.0,3,2,1
BGR,ESP,2016.0,1,3,-2
ISR,POL,1999.0,3,2,1
LTU,NLD,2007.0,2,1,1
NZL,ARE,2005.0,4,2,2
MYS,BEL,2008.0,2,2,0
DNK,SVK,2006.0,1,1,0
FIN,POL,2006.0,2,4,-2
DEU,CIV,2000.0,1,2,-1
EGY,OMN,2006.0,2,1,1
CHE,UGA,2002.0,1,2,-1
CAN,UKR,2001.0,4,6,-2
COL,FRA,2004.0,3,10,-7
CZE,HRV,2005.0,2,1,1
SVK,SVN,2013.0,8,16,-8
ZAF,GRC,1998.0,1,1,0
TUR,BRA,2010.0,2,1,1
NLD,KOR,2018.0,8,15,-7
GRC,RUS,2001.0,3,6,-3
NER,FRA,2009.0,2,8,-6
JPN,ZAF,2006.0,2,2,0
MEX,BGR,1997.0,1,1,0
KEN,CHE,2009.0,4,1,3
PSE,ISR,2008.0,11,9,2
MDA,RUS,2004.0,4,2,2
CYP,CHE,2012.0,2,2,0
GBR,TTO,2004.0,3,2,1
FRA,MLT,2006.0,1,1,0
GHA,CHE,1999.0,1,1,0
TUN,PRT,2013.0,1,1,0
TUR,KGZ,2017.0,5,3,2
ARG,NOR,2013.0,1,1,0
KHM,GBR,2007.0,2,1,1
CAN,EST,2008.0,2,1,1
AUS,BWA,2014.0,1,1,0
COD,COG,2004.0,1,2,-1
BRA,SWE,2008.0,8,7,1
ARG,ARE,2011.0,1,1,0
CIV,CHE,2008.0,3,1,2
BGR,JPN,2008.0,4,5,-1
AUS,ZMB,2001.0,1,1,0
GBR,NAM,2020.0,4,2,2
GBR,VEN,2009.0,1,8,-7
DEU,SDN,2013.0,6,3,3
CHE,PHL,2021.0,2,1,1
BEL,SAU,2007.0,1,1,0
CZE,TWN,2001.0,1,1,0
OMN,FRA,2001.0,1,1,0
NZL,IND,2013.0,9,15,-6
GBR,GTM,2020.0,2,4,-2
SVK,NOR,2012.0,5,2,3
BRA,NOR,2013.0,4,3,1
BRN,IND,2019.0,3,1,2
CYP,ITA,2013.0,1,3,-2
FRA,IRN,2003.0,6,5,1
AFG,ITA,2005.0,1,1,0
SWE,EGY,2011.0,1,3,-2
NIC,CRI,2012.0,3,1,2
POL,AUS,2011.0,5,8,-3
BEL,RWA,2020.0,5,4,1
GBR,ZMB,2016.0,3,4,-1
LAO,SWE,2011.0,1,2,-1
JPN,ALB,2016.0,1,1,0
LUX,IND,2015.0,2,1,1
MOZ,GBR,2010.0,1,2,-1
FIN,PHL,2015.0,1,1,0
BEL,HUN,2020.0,6,4,2
BEL,KHM,2010.0,1,1,0
SDN,EGY,2014.0,2,5,-3
ARE,JPN,2018.0,4,7,-3
BEL,COL,2012.0,4,4,0
BFA,FRA,2013.0,6,18,-12
GBR,HRV,2008.0,1,4,-3
RUS,IRL,2014.0,2,3,-1
PER,IRN,2021.0,2,2,0
LUX,CHE,2016.0,4,6,-2
KEN,MDG,2015.0,1,2,-1
SGP,EGY,2015.0,1,1,0
SWE,LAO,2013.0,2,1,1
GBR,ALB,2013.0,3,1,2
NCL,AUS,2013.0,2,1,1
ITA,PSE,2015.0,3,1,2
MYS,EGY,2020.0,13,4,9
JOR,OMN,2016.0,3,4,-1
ZAF,MWI,2011.0,7,2,5
USA,LSO,2016.0,3,1,2
TUR,NGA,2023.0,2,2,0
GRC,FIN,2021.0,6,3,3
PRI,DEU,2003.0,1,2,-1
ZWE,DEU,2019.0,1,3,-2
CZE,EST,2023.0,1,4,-3
ISR,CZE,2010.0,2,1,1
CHE,MEX,2014.0,6,9,-3
HUN,RUS,2021.0,1,2,-1
COL,VEN,2022.0,5,16,-11
TGO,BEN,2018.0,2,2,0
PRT,CUB,2008.0,1,2,-1
KOR,QAT,2011.0,3,2,1
DEU,ROU,2023.0,11,13,-2
HUN,AUS,2012.0,4,1,3
SAU,COL,2020.0,1,2,-1
GBR,EST,2006.0,1,3,-2
CIV,MLI,2016.0,2,1,1
ESP,TUN,2015.0,5,10,-5
FIN,SGP,2019.0,5,6,-1
SDN,BHR,2022.0,2,1,1
HKG,FIN,2019.0,5,3,2
DEU,BLR,2005.0,7,12,-5
QAT,ARE,2011.0,3,7,-4
KEN,FRA,2005.0,1,1,0
PAK,NPL,2014.0,2,1,1
TUR,ITA,2006.0,3,6,-3
MEX,CRI,2016.0,4,4,0
RUS,HRV,2018.0,1,1,0
IND,SVK,2018.0,3,1,2
SRB,CHN,2020.0,2,2,0
KAZ,HKG,2021.0,1,1,0
FIN,AUS,1997.0,5,5,0
PAK,NGA,2018.0,5,1,4
GEO,RUS,2017.0,2,3,-1
CMR,JPN,2022.0,1,2,-1
DMA,USA,2014.0,4,2,2
DEU,BGD,2023.0,4,10,-6
ESP,CRI,2023.0,5,8,-3
PHL,CHN,2014.0,2,7,-5
EST,ISR,2019.0,1,2,-1
ALB,SRB,2018.0,4,5,-1
JOR,ESP,2022.0,2,1,1
UZB,KAZ,2018.0,4,7,-3
GAB,USA,2022.0,5,6,-1
SAU,IRL,2023.0,3,1,2
BGR,CHE,2018.0,3,4,-1
CAN,SVK,2002.0,2,1,1
PAK,NLD,2018.0,3,15,-12
ISR,MEX,2006.0,3,3,0
ESP,CPV,2015.0,1,1,0
UGA,FRA,2005.0,2,1,1
USA,DEU,2024.0,4,5,-1
CHE,SWZ,2021.0,3,10,-7
NER,BFA,2018.0,1,4,-3
PER,ARG,2022.0,6,11,-5
NLD,BGD,2018.0,5,6,-1
BGD,ARE,2009.0,2,1,1
ETH,SWE,2021.0,5,5,0
LBY,EGY,2017.0,1,5,-4
IND,ZAF,2001.0,5,7,-2
SVN,CAN,2020.0,2,4,-2
AUS,CZE,2003.0,5,3,2
MEX,PRT,2005.0,1,1,0
BEN,COD,2022.0,2,1,1
EGY,LBN,2021.0,4,12,-8
BGD,PAK,2023.0,4,3,1
KOR,BGD,2002.0,1,1,0
AUS,JAM,2022.0,2,1,1
CAN,CHL,1998.0,5,5,0
CHL,CAN,2000.0,5,5,0
ARM,RUS,2013.0,5,5,0
DEU,LVA,2017.0,3,6,-3
LBY,EGY,2016.0,3,4,-1
CHL,CHE,2002.0,4,6,-2
GMB,ZAF,2001.0,1,1,0
BHR,IND,2014.0,2,1,1
POL,MEX,2005.0,1,1,0
PHL,AUS,2003.0,7,9,-2
ITA,JOR,2002.0,1,1,0
FRA,URY,2001.0,5,2,3
NZL,NPL,2022.0,1,3,-2
AUT,NOR,1999.0,1,2,-1
THA,AUS,2012.0,17,32,-15
BGD,CAN,2002.0,3,3,0
IRL,ISR,2000.0,1,1,0
GBR,NAM,1999.0,1,1,0
DEU,GAB,1997.0,2,1,1
IRL,CHE,1998.0,3,4,-1
AUT,IND,2006.0,4,9,-5
IND,BRA,1999.0,9,1,8
DNK,KOR,2008.0,1,2,-1
OMN,SAU,2010.0,1,5,-4
AUT,MEX,2001.0,2,2,0
URY,BRA,2009.0,4,2,2
KAZ,GBR,1998.0,1,1,0
QAT,LBN,2014.0,1,2,-1
IND,PNG,2014.0,3,2,1
USA,GUM,2011.0,15,2,13
CHN,RUS,2009.0,4,10,-6
AUS,URY,2015.0,2,2,0
CHN,MWI,2021.0,5,1,4
CIV,ZAF,2012.0,2,1,1
CAN,GUY,2009.0,4,1,3
BGR,FRA,2012.0,3,13,-10
IND,DNK,1998.0,5,7,-2
NGA,FRA,2019.0,7,2,5
SVN,SWE,1997.0,1,2,-1
ARM,FRA,2001.0,5,2,3
JOR,ARE,2003.0,3,2,1
CHE,ISR,2009.0,14,11,3
BRA,DNK,2012.0,9,1,8
ARE,QAT,2004.0,2,2,0
IND,HUN,2012.0,2,3,-1
GBR,RWA,2019.0,3,1,2
RWA,GBR,2021.0,3,3,0
COL,KEN,2021.0,2,1,1
TUN,CAN,2005.0,4,2,2
DNK,ISR,2003.0,2,3,-1
AUS,BRA,2004.0,5,17,-12
BGR,DNK,1999.0,1,1,0
SWE,HUN,2012.0,5,14,-9
OMN,KWT,2003.0,1,1,0
CMR,SEN,2011.0,2,1,1
RUS,HRV,2016.0,1,4,-3
ZAF,JAM,2013.0,1,1,0
LUX,PRT,2015.0,1,2,-1
PRT,IND,2006.0,3,8,-5
IRL,BHR,2016.0,2,4,-2
KOR,BGD,2005.0,2,9,-7
ETH,SWE,2009.0,5,8,-3
LKA,THA,2001.0,2,3,-1
GBR,FJI,2006.0,1,1,0
AUT,PRT,2001.0,4,1,3
BLR,DEU,2014.0,5,4,1
UGA,NOR,2017.0,3,2,1
MAR,SWE,2016.0,1,1,0
CHE,COG,2015.0,3,2,1
CHN,BTN,2021.0,3,1,2
BRA,EGY,2015.0,1,1,0
EGY,BRA,2016.0,3,1,2
DNK,BOL,2018.0,1,1,0
SDN,MYS,2014.0,3,7,-4
NAM,GBR,2017.0,2,2,0
JPN,TUN,2016.0,4,1,3
USA,MKD,2016.0,1,3,-2
BLR,FRA,2018.0,4,1,3
CAN,LVA,2014.0,1,1,0
SWE,UGA,2016.0,4,2,2
KHM,KOR,2014.0,1,1,0
EST,AUT,2020.0,1,3,-2
KHM,BEL,2012.0,1,1,0
MSR,TTO,2021.0,3,1,2
LTU,CHE,2018.0,5,1,4
TUN,FIN,2019.0,1,1,0
NGA,KOR,2023.0,3,4,-1
TUN,GBR,2022.0,1,2,-1
RUS,NZL,2021.0,1,1,0
PNG,DEU,2013.0,1,1,0
FRA,COM,2020.0,1,1,0
BOL,MEX,2019.0,1,1,0
NLD,BGD,2017.0,6,3,3
CAN,RWA,2019.0,1,4,-3
BOL,USA,2019.0,1,8,-7
LKA,JPN,2016.0,5,11,-6
ESP,CHN,2024.0,3,4,-1
SWE,KEN,2018.0,4,5,-1
MOZ,ZAF,2021.0,5,7,-2
TZA,CHN,2018.0,7,3,4
CHN,UZB,2020.0,6,3,3
TZA,CHN,2017.0,2,6,-4
KWT,GBR,2019.0,10,17,-7
ESP,SVK,2021.0,2,2,0
BRN,PAK,2020.0,1,3,-2
BGR,TUR,2006.0,1,1,0
NOR,LKA,2020.0,2,1,1
BOL,BRA,2022.0,3,1,2
FRA,MOZ,2022.0,1,2,-1
IND,COL,2023.0,4,1,3
SEN,MLI,2021.0,1,2,-1
HKG,NGA,2022.0,1,4,-3
JOR,OMN,2022.0,3,4,-1
LIE,DEU,2022.0,2,2,0
CHE,HRV,2023.0,1,6,-5
ISR,BEL,2022.0,1,4,-3
PAK,IRN,2019.0,2,4,-2
ROU,ESP,2022.0,5,6,-1
COL,SWE,2016.0,1,3,-2
KWT,FRA,2023.0,1,4,-3
GRC,SAU,2021.0,3,3,0
PER,ECU,2023.0,7,4,3
YEM,PAK,2022.0,1,1,0
DEU,ISL,2023.0,3,2,1
MEX,MAR,2019.0,1,3,-2
ARE,AUT,2009.0,1,3,-2
UGA,ZWE,2017.0,2,1,1
TUN,USA,2018.0,6,9,-3
SRB,ITA,2013.0,5,5,0
NGA,KOR,2010.0,1,1,0
THA,PRT,2013.0,2,1,1
QAT,MYS,2023.0,4,6,-2
GEO,GBR,2006.0,4,3,1
FRA,LTU,2004.0,1,1,0
CHE,IDN,2020.0,1,2,-1
BLZ,USA,2006.0,2,1,1
FIN,EGY,2014.0,1,5,-4
FIN,BEL,2009.0,7,2,5
SRB,BEL,2022.0,5,2,3
ETH,UGA,2016.0,1,2,-1
MCO,ESP,2011.0,1,1,0
EGY,SWE,2005.0,1,1,0
ETH,NLD,2009.0,5,4,1
ESP,PER,2009.0,6,9,-3
ITA,TWN,2007.0,1,3,-2
IDN,KEN,2011.0,1,1,0
FIN,NGA,2018.0,1,3,-2
ZAF,BWA,2013.0,7,7,0
GBR,LAO,2014.0,4,1,3
SGP,ARE,2019.0,3,2,1
MAC,ITA,2008.0,1,1,0
AUT,HRV,2006.0,3,1,2
LVA,USA,2019.0,2,6,-4
NOR,ESP,2008.0,5,10,-5
BRA,AUT,2015.0,6,3,3
ETH,SLE,2020.0,1,1,0
USA,PSE,2010.0,4,8,-4
MDG,CHE,2015.0,1,1,0
GBR,PAN,2021.0,2,2,0
SGP,GRC,2015.0,2,6,-4
GRC,IRN,2016.0,2,1,1
AUS,GHA,2012.0,2,2,0
USA,LVA,2017.0,2,7,-5
CHN,BFA,2021.0,2,2,0
CUB,DEU,2019.0,7,2,5
MDA,MDV,2015.0,1,2,-1
MNG,AUT,2018.0,1,1,0
EGY,AZE,2015.0,2,2,0
SYR,USA,2020.0,3,2,1
IND,PRI,2007.0,2,2,0
ESP,SVK,2019.0,4,1,3
GBR,BFA,2019.0,4,2,2
BEL,EGY,2022.0,3,7,-4
CAN,KEN,2022.0,9,8,1
CAN,JAM,2022.0,2,9,-7
CAN,JAM,2018.0,4,4,0
NLD,URY,2020.0,1,2,-1
CAN,SRB,2017.0,3,6,-3
JOR,LBN,2008.0,1,1,0
ARM,DEU,2001.0,1,8,-7
BEL,UKR,2004.0,4,2,2
SGP,ESP,2011.0,6,9,-3
MYS,DZA,2020.0,5,3,2
NLD,ARG,2005.0,5,3,2
FRA,NZL,2001.0,7,12,-5
HUN,ARE,1999.0,1,1,0
TUR,KGZ,2022.0,8,4,4
NOR,ESP,2001.0,5,5,0
NLD,HUN,2012.0,6,9,-3
ITA,BLR,2012.0,1,1,0
DNK,LTU,2011.0,1,2,-1
LUX,BEL,2003.0,2,11,-9
IRL,KOR,2006.0,1,2,-1
NLD,BRA,1997.0,3,7,-4
VEN,MEX,2003.0,6,7,-1
LVA,SWE,2002.0,3,3,0
FIN,AUS,2005.0,6,12,-6
NPL,AUS,2002.0,2,4,-2
DNK,AUT,2005.0,5,4,1
THA,DEU,2005.0,6,13,-7
EGY,JOR,2011.0,3,2,1
POL,ZAF,1997.0,1,1,0
CZE,DNK,1997.0,2,2,0
MEX,DNK,2006.0,3,2,1
KAZ,SAU,2015.0,2,1,1
ISL,SWE,2002.0,4,19,-15
MWI,ZAF,1998.0,1,3,-2
EGY,ESP,2002.0,1,2,-1
SVN,RUS,2022.0,2,2,0
AGO,PRT,2023.0,1,1,0
AUS,URY,2001.0,2,2,0
CHE,TUR,2000.0,6,4,2
MCO,FRA,2001.0,4,10,-6
EGY,BHR,2019.0,2,4,-2
FRA,NOR,1999.0,16,12,4
EST,USA,2015.0,3,5,-2
THA,LKA,1999.0,1,1,0
ESP,AND,2023.0,2,2,0
USA,GTM,2006.0,2,5,-3
CHL,CHE,1997.0,3,2,1
TTO,CAN,2001.0,1,1,0
DEU,VNM,2001.0,2,3,-1
NOR,POL,2011.0,2,8,-6
NLD,HUN,2002.0,6,11,-5
RUS,LTU,2000.0,2,1,1
DNK,TZA,2003.0,2,1,1
ESP,NOR,2007.0,3,6,-3
BMU,USA,2013.0,5,3,2
EGY,BRA,2017.0,1,2,-1
BGR,MYS,2017.0,1,1,0
CIV,BFA,2015.0,1,12,-11
IRQ,MYS,2010.0,8,3,5
GHA,DNK,2017.0,1,4,-3
MNG,USA,2020.0,6,7,-1
GBR,GUY,2017.0,2,1,1
NLD,TWN,2008.0,2,2,0
KOR,IND,2002.0,7,31,-24
BEL,CYP,2019.0,3,1,2
SYR,FRA,2010.0,2,12,-10
HND,ARG,2014.0,1,0,1
CHE,MAR,2008.0,1,0,1
MWI,BEL,2021.0,1,0,1
SRB,SDN,2017.0,1,0,1
NIC,NOR,2021.0,1,0,1
CHE,OMN,2018.0,1,0,1
MAR,YEM,2022.0,2,0,2
KGZ,BGR,2018.0,1,0,1
BGR,KGZ,2020.0,1,0,1
GEO,KGZ,2023.0,3,0,3
FIN,NIC,2020.0,1,0,1
NIC,GBR,2021.0,2,0,2
ARE,MAC,2020.0,1,0,1
IND,UZB,2012.0,2,0,2
WLF,FRA,2013.0,1,0,1
BOL,FRA,2021.0,2,0,2
JPN,KHM,2010.0,3,0,3
NER,PAK,2022.0,1,0,1
DEU,CAF,2022.0,1,0,1
RUS,HUN,2017.0,4,0,4
TWN,LVA,2021.0,1,0,1
MKD,DNK,2023.0,1,0,1
SYR,PRT,2019.0,1,0,1
NPL,POL,2023.0,1,0,1
GBR,MDA,2022.0,2,0,2
,SOM,2020.0,64,0,64
EST,DNK,2011.0,2,0,2
BRA,MAR,1998.0,1,0,1
KEN,CMR,2020.0,1,0,1
TZA,MWI,2001.0,1,0,1
ALB,DEU,2002.0,1,0,1
BIH,GBR,2002.0,1,0,1
PNG,LKA,2019.0,1,0,1
GMB,BFA,2008.0,1,0,1
CHE,VEN,2022.0,1,0,1
TZA,BWA,2000.0,1,0,1
NZL,ESP,2007.0,3,0,3
WSM,,2009.0,2,0,2
BEN,,2003.0,5,0,5
FRA,NPL,2012.0,2,0,2
DEU,BEN,2010.0,2,0,2
NGA,KEN,2006.0,2,0,2
POL,LTU,1999.0,1,0,1
ZMB,CAN,2014.0,1,0,1
CYP,TJK,2020.0,1,0,1
MWI,TZA,2004.0,1,0,1
ZAF,EST,2003.0,1,0,1
,HND,1998.0,4,0,4
NGA,ISR,2010.0,1,0,1
AUT,CCK,2007.0,1,0,1
GBR,PAN,2013.0,1,0,1
LVA,FRA,2011.0,1,0,1
ISL,GRC,2001.0,1,0,1
DNK,EST,2002.0,2,0,2
ZAF,BEN,2006.0,3,0,3
BFA,TZA,2010.0,1,0,1
JOR,SWE,2011.0,1,0,1
PYF,,2006.0,3,0,3
CAN,MKD,2009.0,1,0,1
THA,ARE,2014.0,3,0,3
NAM,MYS,2000.0,1,0,1
DEU,MAR,1997.0,1,0,1
VNM,CAF,2005.0,1,0,1
CAN,BWA,2003.0,1,0,1
SVK,CHN,2013.0,1,0,1
CHN,SVK,2014.0,2,0,2
ITA,URY,2015.0,4,0,4
PRT,VEN,2003.0,1,0,1
CIV,BEN,2005.0,2,0,2
IRL,BHR,1997.0,1,0,1
CAN,MLT,2004.0,1,0,1
GTM,ARG,2013.0,1,0,1
CHE,BHR,2017.0,1,0,1
BHR,GRC,2021.0,1,0,1
,CCK,2005.0,4,0,4
NCL,,2013.0,2,0,2
MYS,POL,2006.0,1,0,1
ITA,HKG,2002.0,1,0,1
MKD,PRT,2011.0,1,0,1
NGA,CYM,2019.0,1,0,1
EGY,DZA,2019.0,3,0,3
ESP,NGA,2008.0,1,0,1
ETH,SWZ,2021.0,1,0,1
,ATA,1998.0,3,0,3
ITA,GMB,2008.0,1,0,1
PER,KOR,2010.0,1,0,1
ISR,BOL,2020.0,1,0,1
TWN,ARM,2007.0,2,0,2
CZE,SAU,2011.0,2,0,2
LBN,TWN,2007.0,1,0,1
ROU,MYS,2009.0,1,0,1
IRL,NOR,2006.0,3,0,3
USA,NAM,2009.0,1,0,1
NZL,TLS,2020.0,1,0,1
,GRL,1995.0,3,0,3
DNK,GRL,2001.0,4,0,4
NGA,MOZ,1997.0,1,0,1
ESP,SEN,2014.0,2,0,2
,SLE,2005.0,4,0,4
BGR,POL,2014.0,1,0,1
DEU,KNA,2004.0,1,0,1
,DJI,2009.0,6,0,6
HTI,SLE,2022.0,2,0,2
VNM,FJI,2020.0,1,0,1
FJI,VNM,2023.0,1,0,1
MAR,YEM,2018.0,2,0,2
DEU,MLI,2017.0,1,0,1
CHN,ZWE,2014.0,1,0,1
IRN,ZAF,2011.0,6,0,6
PNG,CAN,2013.0,1,0,1
ISL,POL,2015.0,1,0,1
GBR,WLF,2018.0,1,0,1
WLF,,2021.0,1,0,1
GIN,AUS,2000.0,1,0,1
AFG,ARM,2017.0,1,0,1
MKD,TUR,2015.0,3,0,3
CIV,BEN,2012.0,1,0,1
AUS,TZA,2014.0,2,0,2
NIC,FRA,2018.0,1,0,1
MAR,JPN,2016.0,1,0,1
IRL,ERI,2017.0,1,0,1
IND,ECU,2014.0,3,0,3
ECU,IND,2018.0,1,0,1
TUR,SRB,2009.0,2,0,2
AZE,OMN,2008.0,1,0,1
OMN,TUR,2011.0,2,0,2
UGA,KOR,2016.0,1,0,1
ARM,SAU,2022.0,1,0,1
NGA,QAT,2012.0,1,0,1
NZL,UKR,2016.0,1,0,1
HKG,ZAF,2001.0,1,0,1
KHM,NLD,2013.0,1,0,1
CHE,GRD,2016.0,2,0,2
IRL,HKG,2012.0,2,0,2
ISR,PAK,2018.0,2,0,2
SWE,RWA,2019.0,3,0,3
MYS,ISR,2015.0,2,0,2
PSE,BGD,2009.0,1,0,1
KWT,OMN,2016.0,1,0,1
BGR,HUN,2015.0,2,0,2
ZWE,FRA,2017.0,1,0,1
MAR,NOR,2019.0,1,0,1
MDV,,2016.0,3,0,3
AFG,CHE,2006.0,1,0,1
TWN,CHL,2014.0,1,0,1
BEN,BFA,2017.0,4,0,4
UKR,FIN,2021.0,1,0,1
OMN,IRQ,2016.0,2,0,2
CUB,ZAF,2016.0,1,0,1
MEX,TWN,2017.0,1,0,1
UGA,CUB,2016.0,1,0,1
PSE,SRB,2017.0,1,0,1
TZA,MWI,2015.0,1,0,1
AUS,BMU,2005.0,3,0,3
JOR,QAT,1998.0,3,0,3
HKG,SEN,2008.0,1,0,1
CHL,ISL,2023.0,1,0,1
TTO,PRI,2020.0,1,0,1
DEU,LIE,2017.0,6,0,6
SGP,ROU,2014.0,1,0,1
EGY,MAR,2018.0,1,0,1
LBN,TUR,2021.0,2,0,2
BEN,GBR,2018.0,4,0,4
GUY,JPN,2021.0,1,0,1
UGA,BEL,2003.0,2,0,2
GRC,SVN,2023.0,1,0,1
WSM,FJI,2018.0,1,0,1
IDN,LKA,2017.0,1,0,1
FRA,SYR,2022.0,2,0,2
CUB,CHE,2022.0,2,0,2
KWT,IRQ,2022.0,1,0,1
NLD,LVA,2001.0,1,0,1
VNM,LUX,2002.0,1,0,1
THA,KHM,1999.0,1,0,1
VGB,USA,2002.0,1,0,1
KEN,NPL,2000.0,1,0,1
NGA,DNK,1997.0,1,0,1
URY,MEX,1997.0,1,0,1
DOM,USA,2017.0,2,0,2
LUX,PRT,2006.0,1,0,1
LUX,PRT,2010.0,1,0,1
LCA,GBR,2017.0,2,0,2
FRA,BOL,1999.0,3,0,3
,BHS,1995.0,1,0,1
PNG,ITA,1999.0,1,0,1
TZA,LBN,1998.0,1,0,1
BEL,MTQ,2018.0,1,0,1
KWT,AUS,2011.0,1,0,1
UKR,TUR,2005.0,1,0,1
PRT,CHL,1999.0,1,0,1
VEN,IRL,2009.0,3,0,3
ARE,QAT,2010.0,2,0,2
QAT,DNK,2013.0,1,0,1
FIN,CUB,2008.0,1,0,1
SYC,ZAF,2019.0,1,0,1
CAN,AFG,2012.0,1,0,1
VEN,PRY,2016.0,1,0,1
BGD,PRT,2010.0,2,0,2
PHL,LKA,2009.0,1,0,1
JOR,MAR,2012.0,1,0,1
DOM,PRI,2017.0,2,0,2
ARM,ASM,2008.0,1,0,1
ESP,MKD,2015.0,1,0,1
,GUM,2018.0,3,0,3
IRQ,FIN,2013.0,2,0,2
THA,RUS,2024.0,1,0,1
ARG,DNK,2015.0,3,0,3
ARM,PRT,2010.0,1,0,1
JPN,BTN,2013.0,1,0,1
DNK,BEL,2024.0,1,0,1
DEU,PRK,2015.0,2,0,2
GEO,CHE,2011.0,1,0,1
TWN,MAR,2017.0,1,0,1
NAM,FIN,2022.0,2,0,2
IRL,YEM,2023.0,1,0,1
UGA,CZE,2016.0,1,0,1
NZL,EST,2017.0,1,0,1
IND,CZE,2011.0,2,0,2
,BMU,2012.0,3,0,3
BMU,,2020.0,2,0,2
GRL,NLD,2021.0,1,0,1
UKR,UGA,2014.0,4,0,4
CAN,LVA,2023.0,1,0,1
TZA,BRA,2019.0,1,0,1
CMR,ESP,2014.0,1,0,1
SEN,CAN,2007.0,2,0,2
IRN,ESP,2024.0,1,0,1
GMB,ZAF,2023.0,1,0,1
IND,TUN,2021.0,1,0,1
,GNQ,2000.0,2,0,2
UKR,UZB,2021.0,2,0,2
TJK,GBR,2010.0,1,0,1
ZWE,KEN,2005.0,2,0,2
ARG,FLK,2015.0,1,0,1
ISR,KOR,2007.0,2,0,2
ESP,PSE,2007.0,1,0,1
ESP,NGA,2004.0,1,0,1
ITA,SMR,2004.0,1,0,1
,HTI,2001.0,6,0,6
MDA,ITA,2015.0,1,0,1
,CPV,2004.0,2,0,2
BEN,USA,2013.0,1,0,1
HKG,IRN,2000.0,1,0,1
IDN,PNG,2005.0,1,0,1
TUN,CHN,2015.0,2,0,2
OMN,RUS,2011.0,1,0,1
KEN,KWT,2013.0,1,0,1
ZWE,ZMB,2009.0,2,0,2
BTN,,2008.0,2,0,2
BFA,CHN,2006.0,1,0,1
MTQ,MOZ,2015.0,1,0,1
DNK,IRQ,2021.0,1,0,1
KWT,IRN,2020.0,1,0,1
IRL,MAC,2011.0,1,0,1
,CPV,2008.0,4,0,4
IDN,DNK,2008.0,1,0,1
VEN,CAN,2014.0,2,0,2
THA,FJI,2020.0,1,0,1
GMB,BEL,2008.0,1,0,1
CZE,LAO,2014.0,1,0,1
CHN,MLI,2015.0,1,0,1
BGR,KOR,2019.0,2,0,2
CYP,CHN,2019.0,4,0,4
FRA,FJI,2015.0,3,0,3
TTO,IRL,2018.0,1,0,1
CAN,GAB,2020.0,3,0,3
BHR,MYS,2008.0,1,0,1
NPL,LKA,2017.0,1,0,1
GEO,AUS,2019.0,1,0,1
KOR,SVN,2019.0,1,0,1
CHE,GRD,2018.0,1,0,1
GLP,NGA,2008.0,1,0,1
COD,KEN,2015.0,1,0,1
PAK,RUS,2012.0,1,0,1
BOL,COL,2012.0,1,0,1
IRN,CHL,2017.0,3,0,3
IND,CYP,2020.0,1,0,1
SDN,PAK,2021.0,2,0,2
CHE,ISL,2007.0,2,0,2
SVK,IDN,2021.0,1,0,1
TTO,CAN,2023.0,1,0,1
BLZ,NLD,2013.0,1,0,1
BGD,ISL,2013.0,1,0,1
SYR,SWE,2019.0,1,0,1
FRA,GHA,2009.0,3,0,3
MMR,FRA,2000.0,1,0,1
NPL,NOR,2024.0,1,0,1
,AFG,2003.0,3,0,3
LBY,ETH,2011.0,1,0,1
KOR,ITA,2024.0,1,0,1
CHN,COD,2019.0,1,0,1
,TUR,2021.0,42,0,42
MDG,CAF,2006.0,1,0,1
,TZA,2021.0,3,0,3
,ROU,2021.0,4,0,4
,ECU,2021.0,3,0,3
,EST,2021.0,5,0,5
HRV,RUS,2009.0,1,0,1
URY,ITA,1999.0,1,0,1
IRN,NGA,1998.0,1,0,1
USA,MCO,2015.0,1,0,1
NOR,BEN,2005.0,1,0,1
GBR,YEM,2005.0,2,0,2
YEM,SAU,2006.0,1,0,1
ALB,GRC,2001.0,1,0,1
NGA,JAM,2006.0,1,0,1
KEN,SVK,2011.0,1,0,1
TUN,BGR,2008.0,1,0,1
GUF,REU,2009.0,1,0,1
IND,GMB,2011.0,1,0,1
NOR,FRO,1999.0,1,0,1
FIN,TZA,2006.0,1,0,1
BGR,ROU,1998.0,1,0,1
TUN,CHN,2001.0,1,0,1
CHN,TUN,2002.0,3,0,3
MYS,UGA,2015.0,1,0,1
COM,FRA,2005.0,1,0,1
ZWE,SWE,2011.0,1,0,1
BGD,PRT,2023.0,1,0,1
CRI,GRC,2000.0,2,0,2
NGA,LKA,2010.0,1,0,1
SRB,SYR,2006.0,1,0,1
SGP,MEX,2013.0,4,0,4
NLD,BEN,2004.0,2,0,2
JPN,KWT,2014.0,2,0,2
MEX,ECU,2002.0,1,0,1
CHL,ZAF,2019.0,3,0,3
NOR,BGD,2002.0,3,0,3
MDA,SWE,2001.0,1,0,1
TJK,UZB,1998.0,1,0,1
JPN,CUB,2005.0,1,0,1
GAB,AUT,2005.0,1,0,1
GAB,AUT,2012.0,1,0,1
ABW,USA,2003.0,1,0,1
EGY,ISR,2001.0,1,0,1
MOZ,NAM,2011.0,1,0,1
SOM,SWE,1999.0,1,0,1
JPN,BLR,2005.0,1,0,1
MLI,,1999.0,4,0,4
CZE,SGP,2004.0,1,0,1
IRN,CHN,2000.0,2,0,2
AUT,PHL,2010.0,2,0,2
PAN,CRI,2018.0,1,0,1
DEU,SWZ,2010.0,1,0,1
GAB,SEN,2018.0,1,0,1
,SLB,2006.0,4,0,4
LBN,ISR,2014.0,1,0,1
QAT,IRQ,2014.0,1,0,1
FRA,PSE,2012.0,2,0,2
ROU,POL,1998.0,7,0,7
MAC,ITA,2010.0,1,0,1
NPL,ITA,2011.0,1,0,1
IND,TON,2015.0,1,0,1
NOR,BIH,2011.0,2,0,2
JPN,MEX,2006.0,6,0,6
MCO,DEU,2014.0,1,0,1
CHE,GAB,2015.0,1,0,1
USA,BDI,2016.0,2,0,2
AND,PRT,2012.0,1,0,1
COL,ARE,2003.0,1,0,1
JOR,DNK,2020.0,1,0,1
DEU,AFG,2012.0,1,0,1
ISR,QAT,2017.0,1,0,1
ITA,MCO,2009.0,2,0,2
FRA,TZA,2015.0,1,0,1
ISR,MLI,2020.0,2,0,2
UKR,NOR,2015.0,2,0,2
UGA,FRA,2022.0,1,0,1
VUT,FJI,2007.0,1,0,1
USA,FJI,2011.0,1,0,1
BRB,GBR,1999.0,1,0,1
CHN,NPL,2004.0,1,0,1
BGD,JOR,2002.0,1,0,1
LUX,AUT,2010.0,2,0,2
JAM,BWA,2004.0,1,0,1
CHE,ZWE,2017.0,1,0,1
ESP,TZA,2010.0,1,0,1
MSR,,2015.0,1,0,1
GTM,JPN,2005.0,2,0,2
SYR,DEU,2001.0,2,0,2
ITA,MUS,2014.0,2,0,2
BLR,KOR,2007.0,3,0,3
,ASM,2016.0,3,0,3
BWA,DEU,2019.0,3,0,3
QAT,BHR,2022.0,3,0,3
RWA,LBN,2022.0,1,0,1
,SLE,2002.0,2,0,2
SLE,KHM,2007.0,1,0,1
ZWE,MAR,2022.0,1,0,1
SPM,BEL,2009.0,1,0,1
SVN,RUS,2002.0,2,0,2
RUS,SVN,2003.0,1,0,1
NOR,QAT,2005.0,1,0,1
CMR,MTQ,2007.0,1,0,1
AUS,SYR,2008.0,2,0,2
KHM,CUB,2004.0,2,0,2
DEU,VEN,2000.0,1,0,1
ROU,AUT,1999.0,2,0,2
ESP,SGP,2003.0,1,0,1
IRN,ISL,2010.0,1,0,1
USA,BES,2016.0,1,0,1
ESP,BFA,2013.0,1,0,1
PAK,BMU,2006.0,1,0,1
NOR,GRC,2004.0,1,0,1
JPN,QAT,1998.0,1,0,1
LAO,VNM,2011.0,2,0,2
ARM,CAN,2002.0,1,0,1
BRA,PAN,2008.0,1,0,1
NPL,BGD,2010.0,1,0,1
ISL,TUR,2015.0,1,0,1
POL,CZE,2005.0,6,0,6
SYR,MYS,2009.0,1,0,1
NZL,JOR,2014.0,1,0,1
MTQ,GLP,2009.0,1,0,1
GLP,MTQ,2018.0,1,0,1
IOT,IND,2012.0,1,0,1
CHL,POL,2007.0,2,0,2
ARM,KOR,2003.0,1,0,1
NAM,NOR,2002.0,2,0,2
JPN,TUN,1997.0,1,0,1
PHL,COL,2013.0,2,0,2
GRC,GRL,2012.0,1,0,1
NOR,ZWE,2003.0,1,0,1
CYM,GBR,2013.0,1,0,1
PER,ARG,2002.0,2,0,2
IRN,FJI,2021.0,1,0,1
CCK,USA,2008.0,1,0,1
ITA,HTI,2009.0,1,0,1
ZAF,JAM,2019.0,1,0,1
LIE,CHL,2006.0,1,0,1
RUS,BIH,2018.0,1,0,1
SAU,OMN,2007.0,1,0,1
KWT,VNM,2018.0,1,0,1
TWN,SAU,2014.0,9,0,9
USA,BLZ,2010.0,1,0,1
MRT,FRA,2010.0,1,0,1
MKD,POL,2020.0,1,0,1
ITA,MDG,2011.0,1,0,1
MYS,BIH,2010.0,1,0,1
MEX,JOR,2015.0,1,0,1
AZE,PRT,2018.0,1,0,1
EST,POL,2015.0,3,0,3
PSE,FIN,2011.0,1,0,1
CHE,ZMB,2015.0,1,0,1
SAU,IRQ,2018.0,3,0,3
SRB,POL,2014.0,1,0,1
MAC,JPN,2014.0,1,0,1
PER,CZE,2012.0,1,0,1
FIN,UGA,2018.0,1,0,1
MYS,TZA,2020.0,1,0,1
ITA,LUX,2002.0,1,0,1
HRV,MNE,2018.0,3,0,3
FIN,THA,2019.0,2,0,2
SGP,GRC,2023.0,1,0,1
HKG,VNM,2013.0,2,0,2
OMN,BWA,1999.0,1,0,1
COM,CMR,2011.0,1,0,1
GRC,MAR,2000.0,1,0,1
ARM,SVK,2002.0,1,0,1
SEN,ESP,2022.0,1,0,1
DNK,EGY,1999.0,1,0,1
MUS,IRL,2001.0,1,0,1
ETH,BRA,2003.0,1,0,1
SRB,TWN,2016.0,1,0,1
IRN,TJK,2017.0,1,0,1
TJK,IRN,2019.0,1,0,1
TTO,ZAF,2020.0,2,0,2
ZAF,ARE,2018.0,3,0,3
BRA,ITA,2024.0,3,0,3
,FSM,2015.0,5,0,5
DEU,NIC,2016.0,1,0,1
SYR,ITA,2018.0,1,0,1
IND,POL,2006.0,2,0,2
ARM,CHE,2023.0,1,0,1
GTM,ECU,2019.0,1,0,1
LBR,,2017.0,4,0,4
UZB,DNK,2018.0,1,0,1
PER,PAN,2021.0,1,0,1
ETH,THA,2020.0,1,0,1
SEN,BEL,2000.0,3,0,3
IND,BWA,2021.0,4,0,4
MAR,TGO,2013.0,1,0,1
CZE,CYP,2020.0,1,0,1
IRL,VNM,2016.0,1,0,1
IRQ,NOR,2021.0,1,0,1
UGA,JPN,2022.0,1,0,1
SWZ,CYP,2022.0,1,0,1
EUE,CZE,2021.0,1,0,1
AUT,PSE,2018.0,1,0,1
CCK,AUS,2017.0,1,0,1
ARG,IRL,2006.0,2,0,2
SEN,CIV,2001.0,1,0,1
GIN,IND,2012.0,1,0,1
PAK,JOR,1998.0,1,0,1
PER,CHN,2016.0,1,0,1
PER,CHN,2018.0,1,0,1
KWT,JPN,2005.0,2,0,2
DOM,MEX,2003.0,1,0,1
BEL,THA,2001.0,3,0,3
LBR,ETH,2010.0,1,0,1
GBR,URY,2001.0,1,0,1
THA,LUX,2017.0,1,0,1
MMR,GBR,2001.0,1,0,1
BOL,GBR,1997.0,1,0,1
PRT,STP,2002.0,1,0,1
GAB,USA,1997.0,1,0,1
TUR,UZB,2019.0,1,0,1
YEM,QAT,2013.0,1,0,1
HUN,BGR,2013.0,2,0,2
,GIN,2009.0,15,0,15
ETH,HKG,2017.0,1,0,1
IRN,GRD,2021.0,1,0,1
ROU,SRB,2016.0,1,0,1
ROU,LUX,2010.0,1,0,1
MUS,ARE,2009.0,1,0,1
NZL,EGY,2012.0,2,0,2
CZE,IRQ,2023.0,1,0,1
GHA,BGD,1997.0,1,0,1
BIH,RUS,2017.0,1,0,1
PHL,PRT,2012.0,1,0,1
JOR,PSE,2015.0,4,0,4
ROU,BRA,2013.0,2,0,2
MOZ,NLD,2015.0,2,0,2
MAR,SGP,2015.0,1,0,1
PHL,URY,2010.0,1,0,1
SUR,MEX,2019.0,1,0,1
CYP,IRQ,2019.0,1,0,1
CCK,,2011.0,2,0,2
USA,MLT,2014.0,2,0,2
ZAF,CHL,2001.0,1,0,1
MTQ,GLP,2021.0,1,0,1
SWE,ZMB,2001.0,1,0,1
ECU,BEL,2000.0,1,0,1
GIN,BFA,2017.0,1,0,1
VEN,CHE,2009.0,1,0,1
CMR,GAB,2000.0,1,0,1
TUR,BGD,2012.0,1,0,1
AUS,BWA,2000.0,4,0,4
VEN,BEL,2011.0,2,0,2
CRI,PAN,2006.0,1,0,1
HKG,TUR,2014.0,1,0,1
CHE,NER,2012.0,2,0,2
ITA,KWT,1999.0,1,0,1
NAM,CAN,2004.0,1,0,1
SWE,BRB,2010.0,1,0,1
ARM,IND,2006.0,1,0,1
IRL,TUN,2005.0,1,0,1
DEU,MDA,1997.0,1,0,1
CMR,GBR,1998.0,2,0,2
HKG,LAO,2010.0,1,0,1
KAZ,KOR,2002.0,1,0,1
BRA,NPL,2005.0,1,0,1
URY,SAU,2013.0,1,0,1
MMR,JPN,2006.0,2,0,2
RWA,UGA,2001.0,1,0,1
UZB,MYS,2012.0,2,0,2
AUT,DNK,2000.0,6,0,6
CAN,BEN,1999.0,1,0,1
SVK,ISR,1998.0,1,0,1
GBR,GEO,1997.0,1,0,1
CAN,LIE,2020.0,1,0,1
MLI,ITA,2020.0,1,0,1
BDI,FRA,1999.0,1,0,1
BEL,KWT,2023.0,1,0,1
TZA,RUS,1998.0,1,0,1
LSO,NGA,2005.0,1,0,1
JAM,NGA,2013.0,1,0,1
FSM,,2007.0,3,0,3
CAN,GEO,2009.0,1,0,1
NIC,CHE,2003.0,1,0,1
QAT,GHA,2021.0,1,0,1
SAU,MRT,2020.0,2,0,2
UKR,COL,2008.0,1,0,1
SWZ,MWI,2001.0,1,0,1
TUR,PAK,2003.0,2,0,2
MMR,THA,2001.0,1,0,1
SGP,BRN,1997.0,1,0,1
SWE,GHA,2004.0,1,0,1
GRL,NOR,2004.0,1,0,1
MLI,PER,2018.0,1,0,1
JAM,DEU,2002.0,2,0,2
AUS,LBN,1997.0,1,0,1
KEN,KOR,2002.0,1,0,1
,MHL,1994.0,1,0,1
ESP,QAT,2008.0,1,0,1
CYP,QAT,2015.0,1,0,1
JAM,CUB,2019.0,1,0,1
TLS,,2011.0,1,0,1
MRT,JPN,2015.0,1,0,1
HKG,LTU,2018.0,1,0,1
SYR,ETH,2015.0,2,0,2
BGR,LVA,2020.0,1,0,1
POL,PER,2004.0,1,0,1
CUB,SWE,2016.0,2,0,2
HKG,ISL,2010.0,1,0,1
ROU,COG,2004.0,1,0,1
PER,COL,2009.0,1,0,1
SEN,TWN,2010.0,1,0,1
NOR,MNE,2014.0,1,0,1
BRN,CZE,2001.0,1,0,1
KIR,,2024.0,4,0,4
ETH,HUN,2013.0,1,0,1
TUR,MKD,2018.0,2,0,2
NPL,MYS,2017.0,1,0,1
GEO,CZE,2007.0,2,0,2
KOR,LUX,2010.0,1,0,1
IND,GTM,2008.0,1,0,1
AUT,COM,2011.0,1,0,1
COM,AUS,2015.0,1,0,1
SLV,BRA,2011.0,2,0,2
TCD,SWE,2012.0,1,0,1
PAN,ARG,2013.0,1,0,1
URY,PRY,2011.0,2,0,2
VEN,PRT,2013.0,1,0,1
CIV,CMR,2009.0,1,0,1
SVK,VNM,2012.0,1,0,1
HKG,ROU,2012.0,1,0,1
FRA,MNE,2016.0,1,0,1
SYR,TWN,2006.0,1,0,1
SRB,ISR,2021.0,1,0,1
CHL,HRV,2019.0,1,0,1
GIB,,2015.0,1,0,1
HUN,SAU,2015.0,1,0,1
MEX,IRN,2012.0,2,0,2
TON,DNK,1998.0,1,0,1
BRN,,2002.0,1,0,1
CMR,IRN,2010.0,1,0,1
NLD,GTM,2010.0,1,0,1
KNA,CHN,2021.0,1,0,1
GBR,BLZ,2016.0,1,0,1
COG,NLD,2016.0,1,0,1
NIC,MEX,2021.0,1,0,1
BGR,EST,2010.0,1,0,1
IRL,TTO,2004.0,1,0,1
RUS,ARE,2002.0,1,0,1
CZE,NAM,2018.0,1,0,1
MEX,KNA,2010.0,1,0,1
ATG,MEX,2020.0,1,0,1
HRV,BGR,2001.0,1,0,1
,DMA,2012.0,6,0,6
FIN,PRT,1998.0,1,0,1
DMA,MEX,2015.0,1,0,1
MAC,IND,2023.0,2,0,2
ALB,KEN,2020.0,1,0,1
COG,RWA,2004.0,1,0,1
FRO,GRL,2015.0,1,0,1
ESP,ABW,2017.0,1,0,1
COG,CMR,2011.0,3,0,3
IRL,CHL,2023.0,1,0,1
MWI,ITA,2018.0,1,0,1
SDN,TZA,2016.0,1,0,1
ZAF,CPV,2019.0,1,0,1
FLK,,2020.0,2,0,2
YEM,RUS,2020.0,1,0,1
USA,HTI,2001.0,2,0,2
CIV,ZWE,2004.0,3,0,3
DZA,IRL,2018.0,1,0,1
BLZ,DEU,2020.0,1,0,1
BHS,CHE,2021.0,2,0,2
LSO,ZMB,2020.0,1,0,1
TWN,PSE,2023.0,1,0,1
PHL,GRC,2020.0,2,0,2
SAU,COD,2021.0,1,0,1
TUN,ZAF,2023.0,1,0,1
ZAF,NER,2012.0,1,0,1
MAC,JPN,2008.0,1,0,1
IRQ,GBR,2000.0,1,0,1
FRA,PHL,1999.0,2,0,2
SYC,,2000.0,1,0,1
IRL,SLV,1998.0,1,0,1
SYR,EGY,2023.0,4,0,4
MKD,KWT,2001.0,1,0,1
SRB,COD,2021.0,1,0,1
,FSM,2014.0,2,0,2
MWI,UGA,2022.0,1,0,1
TWN,MNG,2023.0,1,0,1
FIN,OMN,2002.0,1,0,1
BLR,UKR,2023.0,2,0,2
DEU,CYP,2006.0,1,0,1
VNM,RUS,1999.0,1,0,1
GUY,USA,2005.0,2,0,2
KWT,CZE,2019.0,1,0,1
WLF,,2019.0,1,0,1
USA,MRT,2004.0,2,0,2
PSE,USA,1999.0,2,0,2
BRA,VNM,2011.0,1,0,1
BRA,VNM,2019.0,1,0,1
TWN,POL,2000.0,1,0,1
QAT,RUS,2015.0,1,0,1
GUY,NLD,1998.0,1,0,1
CUB,BEL,1998.0,1,0,1
KOR,VNM,1998.0,1,0,1
LAO,TWN,2008.0,1,0,1
RUS,COL,2014.0,1,0,1
PYF,USA,1997.0,1,0,1
KWT,POL,2012.0,1,0,1
CAN,BRN,2003.0,1,0,1
JPN,NCL,2003.0,1,0,1
VNM,CZE,2006.0,1,0,1
NLD,COL,1998.0,2,0,2
SVK,BGR,2001.0,3,0,3
BIH,JPN,2016.0,1,0,1
ZAF,BEL,1998.0,3,0,3
THA,URY,2001.0,1,0,1
ZMB,BEL,2000.0,1,0,1
SEN,GAB,2005.0,1,0,1
GAB,BEN,2008.0,1,0,1
KAZ,ISR,1997.0,3,0,3
MDV,USA,1997.0,1,0,1
LVA,IRL,2009.0,1,0,1
AZE,UZB,2010.0,1,0,1
FJI,SUR,2019.0,1,0,1
ITA,MDA,2000.0,1,0,1
PAK,ETH,2006.0,1,0,1
ISR,ETH,2006.0,1,0,1
LBN,CHN,2000.0,1,0,1
AZE,BEL,2011.0,1,0,1
BEL,AZE,2014.0,1,0,1
ARE,HKG,1999.0,1,0,1
SAU,DZA,2006.0,1,0,1
IDN,THA,2008.0,2,0,2
ISR,EST,2008.0,1,0,1
UKR,FIN,2009.0,2,0,2
MOZ,BRA,2000.0,1,0,1
SDN,SOM,2021.0,1,0,1
MYS,CHN,1999.0,2,0,2
CHN,MYS,2000.0,1,0,1
DNK,FJI,2010.0,1,0,1
ALB,NLD,2012.0,1,0,1
AUT,LIE,2013.0,3,0,3
GBR,SHN,2015.0,2,0,2
POL,ISL,2016.0,4,0,4
ESP,PYF,2013.0,1,0,1
CYP,ITA,2011.0,1,0,1
USA,BEN,2007.0,2,0,2
CUB,MCO,2017.0,1,0,1
CMR,COG,2017.0,2,0,2
AUS,BWA,2010.0,3,0,3
,REU,2002.0,3,0,3
MNG,TWN,2011.0,1,0,1
CIV,MOZ,2015.0,2,0,2
TUN,MRT,2010.0,2,0,2
KHM,PER,2015.0,1,0,1
VEN,AGO,2019.0,2,0,2
AGO,ECU,2021.0,1,0,1
NLD,MAC,2017.0,1,0,1
MAR,HRV,2016.0,1,0,1
TWN,KHM,2012.0,1,0,1
USA,PYF,2010.0,1,0,1
HTI,MOZ,2015.0,1,0,1
IND,SEN,2014.0,2,0,2
HRV,ISR,2010.0,1,0,1
USA,MMR,2012.0,2,0,2
GAB,KHM,2015.0,1,0,1
BRB,CHE,2014.0,1,0,1
FSM,,2020.0,2,0,2
MNP,,2020.0,3,0,3
GHA,COD,2016.0,1,0,1
COD,GHA,2017.0,1,0,1
COL,PRT,1999.0,1,0,1
EST,LTU,2022.0,2,0,2
KHM,,2026.0,1,0,1
VEN,RUS,2013.0,1,0,1
FRA,BTN,2020.0,1,0,1
IDN,UGA,2019.0,1,0,1
HTI,ITA,2021.0,1,0,1
SEN,RWA,2016.0,1,0,1
CHN,SVN,2014.0,2,0,2
MMR,FIN,2016.0,3,0,3
NGA,IRN,2015.0,1,0,1
TTO,CAN,2000.0,3,0,3
ITA,KWT,2020.0,2,0,2
ALB,AUT,2020.0,3,0,3
PHL,MEX,2016.0,1,0,1
PRT,SAU,2017.0,4,0,4
IND,FRA,2024.0,1,0,1
ARE,LTU,2019.0,2,0,2
TGO,NGA,2019.0,1,0,1
SLV,THA,2020.0,1,0,1
DEU,TGO,2019.0,2,0,2
BEL,SEN,2019.0,1,0,1
CHN,MAR,2016.0,2,0,2
ROU,BGD,2018.0,1,0,1
IDN,MYS,1999.0,2,0,2
,GTM,2020.0,18,0,18
,COM,2020.0,2,0,2
,HND,2020.0,24,0,24
HRV,MNE,2016.0,3,0,3
LTU,NZL,2016.0,1,0,1
ITA,LSO,2009.0,1,0,1
BGD,CHE,2009.0,1,0,1
YEM,CZE,2005.0,1,0,1
UKR,HKG,2013.0,1,0,1
ETH,TZA,2014.0,3,0,3
ROU,TWN,2010.0,1,0,1
LBR,PAK,2017.0,1,0,1
MAR,IDN,2006.0,1,0,1
IDN,MAR,2016.0,1,0,1
UZB,KGZ,2003.0,1,0,1
MOZ,PER,2020.0,1,0,1
ETH,MOZ,2023.0,1,0,1
KOR,LBN,2022.0,1,0,1
CZE,MEX,2014.0,3,0,3
JOR,PSE,2004.0,1,0,1
TZA,NGA,2004.0,2,0,2
BHR,ARE,2009.0,1,0,1
MYS,PER,2009.0,1,0,1
CAN,GMB,2003.0,1,0,1
GAB,COM,2007.0,1,0,1
FRA,LBY,2007.0,1,0,1
ZAF,BGR,2003.0,1,0,1
GRC,NGA,2013.0,1,0,1
USA,MTQ,1998.0,1,0,1
THA,RUS,2010.0,1,0,1
KEN,TUR,2023.0,1,0,1
RUS,ZWE,2022.0,2,0,2
FJI,ETH,2018.0,1,0,1
MAR,BGD,2024.0,1,0,1
NZL,UKR,2022.0,1,0,1
BEL,DZA,2020.0,5,0,5
DNK,HRV,1998.0,1,0,1
CZE,BIH,1997.0,1,0,1
TWN,MEX,2013.0,1,0,1
PAN,GUM,1998.0,1,0,1
FRA,IRQ,2000.0,1,0,1
ECU,IRL,2004.0,1,0,1
PRT,NZL,2002.0,2,0,2
ZAF,EGY,2010.0,1,0,1
GAB,ESP,2001.0,1,0,1
NPL,POL,2010.0,1,0,1
AUS,VEN,2008.0,1,0,1
ZMB,NLD,2002.0,1,0,1
BGD,SYR,1999.0,1,0,1
ETH,SWZ,2011.0,1,0,1
SWZ,ETH,2016.0,2,0,2
MKD,AUT,2013.0,1,0,1
ARE,BHR,1998.0,1,0,1
TWN,STP,2009.0,1,0,1
ZAF,UKR,2000.0,1,0,1
MYS,RUS,1997.0,1,0,1
PER,BEL,2001.0,1,0,1
HUN,ZAF,2008.0,2,0,2
BEL,CYP,2003.0,1,0,1
IRQ,NOR,2009.0,1,0,1
ZAF,EGY,2000.0,1,0,1
VEN,URY,2001.0,1,0,1
MEX,BGD,2008.0,1,0,1
WSM,ASM,2003.0,2,0,2
DEU,ECU,2008.0,2,0,2
FRA,TZA,2014.0,1,0,1
TUR,THA,2016.0,2,0,2
NOR,LVA,2012.0,1,0,1
HUN,NZL,2009.0,4,0,4
GUY,FRA,2007.0,1,0,1
DZA,CIV,2016.0,1,0,1
CIV,TUR,2016.0,1,0,1
MYS,ZAF,2013.0,1,0,1
THA,GUY,2007.0,1,0,1
HUN,MCO,2016.0,1,0,1
CAF,EGY,2008.0,1,0,1
GLP,GUF,1998.0,1,0,1
NOR,PHL,2019.0,2,0,2
BWA,SWE,2021.0,1,0,1
NOR,RWA,2020.0,1,0,1
SEN,NLD,2005.0,2,0,2
BEL,MNG,2023.0,1,0,1
POL,ARG,2002.0,1,0,1
CZE,ECU,2020.0,1,0,1
TUN,ARE,2009.0,1,0,1
COL,VNM,2017.0,1,0,1
HUN,ARG,1997.0,1,0,1
AUS,NRU,2014.0,1,0,1
NGA,ETH,2015.0,1,0,1
KAZ,LVA,2016.0,1,0,1
MLI,IND,2017.0,1,0,1
CYP,HUN,2020.0,1,0,1
AUS,CYP,2021.0,1,0,1
VEN,CHE,2019.0,2,0,2
TUV,,2020.0,1,0,1
FJI,VUT,2014.0,1,0,1
CAN,AIA,2020.0,1,0,1
QAT,PAK,2024.0,1,0,1
URY,PRY,2021.0,1,0,1
MLT,GRC,2019.0,1,0,1
MYS,BRB,2017.0,1,0,1
DOM,GBR,2017.0,2,0,2
ARE,ROU,2016.0,1,0,1
BFA,NGA,2013.0,1,0,1
UGA,ZMB,2019.0,1,0,1
BIH,CHE,2022.0,2,0,2
UGA,SOM,2020.0,1,0,1
CYP,NGA,2019.0,1,0,1
NGA,THA,2016.0,1,0,1
MAC,PRT,2008.0,1,0,1
CHL,BGD,2022.0,2,0,2
MKD,KWT,2014.0,1,0,1
LKA,SWE,2019.0,1,0,1
UZB,FRA,2018.0,1,0,1
CYP,SRB,2003.0,1,0,1
AUS,PSE,2016.0,1,0,1
NGA,CHN,2005.0,1,0,1
IDN,NPL,2010.0,1,0,1
TUR,IDN,2007.0,1,0,1
TCD,,2011.0,1,0,1
,CYM,2001.0,1,0,1
CYM,CAN,2015.0,1,0,1
AFG,YEM,2015.0,1,0,1
ALB,BIH,2017.0,1,0,1
IND,UZB,2005.0,1,0,1
FRA,ALB,2008.0,2,0,2
ECU,COL,2005.0,1,0,1
,FSM,2001.0,4,0,4
TZA,IND,2008.0,1,0,1
,VGB,1999.0,1,0,1
IDN,MLI,2008.0,1,0,1
NOR,MNG,2021.0,2,0,2
ISR,THA,2012.0,1,0,1
ALB,BEL,2010.0,1,0,1
THA,ETH,2018.0,2,0,2
MKD,TUR,2008.0,1,0,1
BRA,TGO,2010.0,1,0,1
SEN,BEN,2011.0,1,0,1
NER,CHE,2004.0,2,0,2
UZB,SWE,2017.0,1,0,1
IRN,SAU,2006.0,1,0,1
UKR,GEO,2018.0,1,0,1
KWT,FIN,2006.0,1,0,1
HUN,MKD,2002.0,1,0,1
NAM,KEN,2012.0,1,0,1
GMB,NGA,2003.0,1,0,1
SRB,BEL,2005.0,3,0,3
BEL,DZA,2007.0,2,0,2
UGA,,1999.0,3,0,3
USA,AFG,2003.0,2,0,2
GBR,GUY,2012.0,1,0,1
KOR,BGR,2022.0,1,0,1
CHE,NAM,2010.0,2,0,2
GRD,,2007.0,1,0,1
CAN,GUY,2003.0,1,0,1
AUT,GRC,1999.0,1,0,1
SGP,TUR,2005.0,1,0,1
DEU,GMB,2003.0,3,0,3
RWA,,2003.0,1,0,1
AUT,YEM,1999.0,1,0,1
KAZ,ARE,2017.0,1,0,1
BHR,ITA,2012.0,1,0,1
MAR,MYS,2009.0,1,0,1
SAU,IRL,2008.0,1,0,1
GRC,PSE,2002.0,1,0,1
CUB,JPN,2006.0,1,0,1
EGY,NGA,2006.0,1,0,1
HND,CRI,2014.0,1,0,1
HUN,ZAF,2004.0,1,0,1
NLD,BFA,2022.0,1,0,1
NLD,AND,2020.0,1,0,1
IRL,LBY,2019.0,1,0,1
DNK,UGA,2004.0,1,0,1
RWA,PHL,2015.0,1,0,1
GHA,GMB,2006.0,1,0,1
HUN,ECU,2013.0,1,0,1
,GUF,2002.0,1,0,1
,GIB,2005.0,4,0,4
,CYM,1996.0,1,0,1
TLS,GBR,2012.0,1,0,1
ARG,DNK,2014.0,1,0,1
BOL,BRA,2012.0,1,0,1
FRA,BMU,2012.0,1,0,1
LBN,CYP,2021.0,1,1,0
CZE,HRV,2020.0,1,3,-2
OMN,USA,2010.0,4,10,-6
UGA,NGA,2018.0,2,6,-4
GBR,VEN,2010.0,1,4,-3
BEL,THA,2009.0,2,2,0
SGP,BRA,2020.0,1,1,0
TZA,NLD,2011.0,2,3,-1
HKG,SWE,2011.0,2,2,0
PAN,CHL,2014.0,1,1,0
MKD,USA,2009.0,3,1,2
HRV,AUS,2002.0,1,3,-2
NLD,TWN,2013.0,3,2,1
FJI,FRA,2020.0,1,1,0
HRV,MKD,2016.0,2,1,1
BIH,DEU,2013.0,3,3,0
NLD,ETH,2010.0,3,3,0
GRC,NOR,2013.0,1,2,-1
ZWE,MWI,2015.0,1,1,0
FRA,NGA,1999.0,3,2,1
MYS,DZA,2012.0,1,1,0
TUR,HUN,2009.0,1,4,-3
MYS,SDN,2010.0,1,6,-5
ROU,JPN,2015.0,2,5,-3
TWN,DNK,2015.0,1,1,0
CMR,CHN,2016.0,2,1,1
IRN,NGA,2016.0,3,2,1
ISR,EST,2019.0,2,1,1
ARG,NZL,2018.0,2,1,1
NZL,ARG,2022.0,1,1,0
ZAF,MDG,2013.0,1,1,0
CHL,IRL,2015.0,2,2,0
ZWE,UGA,2017.0,1,2,-1
BHR,KWT,2013.0,1,1,0
BWA,NGA,2012.0,1,4,-3
PSE,MYS,2013.0,1,4,-3
NGA,BEL,2021.0,3,4,-1
HRV,CHN,2020.0,1,1,0
KHM,GBR,2012.0,2,2,0
GNQ,GIN,2013.0,4,1,3
SAU,CZE,2012.0,1,2,-1
COG,CMR,2015.0,1,1,0
DEU,GAB,2020.0,3,5,-2
TUR,AFG,2018.0,1,1,0
TUR,SVK,2021.0,2,1,1
IDN,DZA,2018.0,2,1,1
GRD,FRA,2021.0,1,1,0
AZE,SAU,2020.0,2,1,1
PSE,SAU,2017.0,2,2,0
ISR,POL,1997.0,3,3,0
MAR,QAT,2021.0,1,2,-1
POL,ISL,2020.0,1,1,0
TUR,HKG,2021.0,2,2,0
SWE,QAT,2015.0,3,1,2
COL,PRT,2017.0,3,3,0
SRB,AUT,2010.0,3,6,-3
FIN,BEL,2006.0,3,3,0
IRN,ISL,2013.0,2,1,1
MKD,USA,2019.0,2,3,-1
SDN,SAU,2008.0,5,5,0
SLB,AUS,2022.0,2,2,0
IRL,KOR,2021.0,3,5,-2
SRB,AUT,2000.0,1,2,-1
SRB,SVK,2004.0,1,6,-5
TUR,AUS,2001.0,3,1,2
DNK,ARG,2004.0,1,2,-1
JPN,COL,1999.0,1,1,0
CMR,CHE,2009.0,1,2,-1
SVN,CAN,2005.0,1,2,-1
BGR,TUR,2021.0,1,3,-2
CAN,PHL,2006.0,3,2,1
IDN,FIN,2006.0,1,2,-1
JPN,VEN,2003.0,1,2,-1
GHA,USA,2001.0,2,6,-4
MYS,NZL,2005.0,2,1,1
DEU,EST,2009.0,3,6,-3
BLR,UKR,2003.0,3,2,1
IRQ,USA,2006.0,2,3,-1
IRL,CZE,2018.0,2,5,-3
NZL,FRA,2000.0,3,9,-6
ETH,ITA,2000.0,1,2,-1
TUR,ESP,2003.0,2,4,-2
MEX,UKR,2012.0,2,2,0
CAN,BFA,2002.0,1,1,0
GHA,BFA,2011.0,1,1,0
NLD,SYR,2005.0,1,1,0
SYR,ETH,2009.0,1,3,-2
EST,DNK,2008.0,2,2,0
KEN,IND,2006.0,2,3,-1
SRB,DNK,2014.0,2,2,0
IND,BRA,2005.0,2,6,-4
CIV,ZAF,1999.0,2,3,-1
TZA,SWE,1997.0,1,1,0
FIN,IRL,2007.0,2,4,-2
CHN,POL,2006.0,1,2,-1
ETH,ESP,2005.0,1,1,0
CHL,MEX,2001.0,2,5,-3
DZA,DEU,2005.0,2,2,0
DEU,LAO,2013.0,2,1,1
KEN,BEL,2004.0,2,5,-3
ETH,TZA,2011.0,1,1,0
UKR,DNK,2006.0,1,3,-2
GHA,JPN,2012.0,1,1,0
CHE,MYS,2011.0,1,1,0
NAM,ZWE,2021.0,1,1,0
THA,NLD,2015.0,3,14,-11
DZA,BEL,2005.0,1,1,0
SAU,ITA,2011.0,1,5,-4
ESP,PSE,2016.0,2,2,0
CAN,BHR,2022.0,2,2,0
EGY,SWE,2007.0,2,2,0
LBN,AUS,2004.0,1,1,0
DEU,UZB,2010.0,3,3,0
AUT,CHL,2017.0,2,3,-1
MAR,ZAF,2005.0,1,1,0
CIV,CMR,2014.0,3,1,2
CMR,CIV,2015.0,3,3,0
LTU,CAN,2014.0,2,1,1
USA,LAO,2009.0,1,1,0
BOL,CHN,2016.0,1,1,0
EGY,TWN,2015.0,2,1,1
CHN,COG,2017.0,3,2,1
BFA,COG,2015.0,1,1,0
MEX,SGP,2014.0,1,1,0
JPN,QAT,2017.0,2,1,1
KWT,ARE,2019.0,3,5,-2
QAT,SVK,2016.0,1,1,0
CRI,PER,2020.0,1,1,0
FRA,PRY,2017.0,1,1,0
FRA,GHA,2014.0,3,1,2
SEN,SWE,2015.0,1,1,0
THA,BEL,2013.0,1,4,-3
PER,CAN,2013.0,4,1,3
TWN,MAC,2020.0,4,3,1
LUX,POL,2015.0,1,1,0
MDA,GBR,2016.0,1,1,0
ECU,BEL,2013.0,5,6,-1
SYR,SAU,2016.0,2,2,0
ARE,GRC,2012.0,1,5,-4
IND,COL,2021.0,3,2,1
ISR,HKG,2016.0,2,2,0
VNM,CHL,2016.0,1,1,0
SWE,RWA,2015.0,1,1,0
IRN,SYR,2017.0,1,1,0
ECU,PRT,2022.0,1,2,-1
SDN,DEU,2008.0,2,1,1
LTU,CZE,2018.0,1,1,0
BTN,JPN,2016.0,1,1,0
LUX,NOR,2023.0,3,1,2
TUR,BRA,2019.0,1,2,-1
BRN,GBR,2005.0,1,1,0
BRN,IDN,2014.0,1,1,0
ROU,UKR,2022.0,1,3,-2
MTQ,GLP,2015.0,2,1,1
ZAF,MAR,2021.0,3,1,2
GAB,CMR,2019.0,3,4,-1
BRA,DOM,2021.0,1,3,-2
AUS,SDN,2020.0,1,1,0
SAU,DNK,2021.0,2,4,-2
GHA,FRA,2023.0,2,3,-1
GRC,ROU,2020.0,2,1,1
HKG,FIN,2023.0,1,3,-2
IRQ,JOR,2022.0,1,8,-7
ROU,FIN,2022.0,1,1,0
CYP,DNK,2019.0,1,1,0
ESP,SRB,2012.0,2,1,1
NAM,NLD,2017.0,1,1,0
LVA,FRA,2015.0,1,2,-1
BGD,NLD,2009.0,1,2,-1
SWE,HRV,2014.0,1,4,-3
BOL,ARG,2013.0,1,1,0
DEU,MWI,2019.0,2,2,0
LBY,USA,2012.0,3,2,1
JPN,ZMB,2019.0,1,5,-4
USA,LAO,2021.0,1,1,0
VNM,ZAF,2021.0,7,2,5
BRA,ECU,2012.0,1,3,-2
COG,JPN,2013.0,1,1,0
EGY,IRL,2018.0,4,4,0
PER,FIN,2009.0,1,2,-1
FRA,OMN,2013.0,2,1,1
TZA,IND,2021.0,1,3,-2
NOR,KOR,2013.0,2,4,-2
URY,DEU,2015.0,3,2,1
BWA,AUS,2015.0,2,1,1
GBR,BEN,2005.0,2,1,1
NZL,LKA,2023.0,4,1,3
CMR,GBR,2017.0,1,8,-7
JPN,ZWE,2015.0,1,1,0
ECU,GBR,2013.0,1,4,-3
NOR,IND,2010.0,3,10,-7
ISR,NPL,2019.0,2,1,1
ZAF,THA,2023.0,1,1,0
IND,BWA,2014.0,2,2,0
DOM,CHL,2019.0,1,1,0
BLR,LTU,2001.0,1,1,0
TUR,MDA,2007.0,1,1,0
ZAF,DZA,2012.0,1,1,0
ZWE,COG,2017.0,1,1,0
ZMB,ZWE,2000.0,1,1,0
BGR,NOR,2008.0,1,1,0
SVN,ESP,2011.0,1,1,0
SWE,GHA,2011.0,2,1,1
USA,TCA,2014.0,1,1,0
MNG,DEU,2022.0,4,3,1
AZE,RUS,2005.0,5,5,0
SOM,USA,2023.0,1,2,-1
CHE,SWZ,2023.0,4,3,1
FIN,TUR,2019.0,5,17,-12
EGY,SYR,2014.0,1,2,-1
SRB,SVK,2001.0,2,2,0
BLR,USA,2007.0,4,9,-5
BWA,ZWE,2006.0,1,2,-1
UZB,GBR,2015.0,2,4,-2
BEL,DZA,2017.0,1,5,-4
NLD,BFA,1999.0,1,3,-2
SVN,DNK,2006.0,1,1,0
UGA,COG,2022.0,2,1,1
TGO,USA,2014.0,1,1,0
LTU,SWE,2004.0,3,6,-3
GBR,URY,2009.0,1,3,-2
NZL,CHN,1998.0,1,2,-1
HKG,TUR,2009.0,1,2,-1
MNG,JPN,2006.0,3,2,1
TUR,CYP,2001.0,1,2,-1
VUT,AUS,1999.0,1,1,0
BHS,USA,2009.0,2,3,-1
ZWE,NGA,2002.0,1,1,0
USA,AZE,2008.0,2,1,1
GRC,BRA,2010.0,1,2,-1
IDN,CAN,2009.0,2,1,1
SVN,AUS,2010.0,1,1,0
LKA,ZAF,2011.0,2,2,0
CHN,KWT,2019.0,1,1,0
CMR,NLD,2011.0,1,1,0
URY,ARG,2003.0,2,2,0
UKR,SVK,2010.0,1,1,0
USA,GAB,2009.0,1,2,-1
ROU,RUS,1999.0,1,3,-2
SWE,PER,2006.0,2,2,0
ARE,TUR,2018.0,3,4,-1
ARG,DNK,2011.0,1,1,0
BEL,BEN,2000.0,1,2,-1
FIN,TUR,2009.0,1,6,-5
PHL,CHN,2013.0,2,2,0
KAZ,BLR,2014.0,1,1,0
MLI,SEN,2012.0,1,4,-3
USA,COG,2008.0,1,4,-3
ARE,BHR,2022.0,2,4,-2
ARE,NLD,2015.0,1,5,-4
SWE,MAR,2016.0,1,1,0
CHE,MWI,2017.0,2,2,0
FRA,TGO,2009.0,2,4,-2
USA,AZE,2014.0,5,3,2
UGA,ESP,2022.0,1,1,0
MKD,IND,2019.0,1,1,0
CUB,ITA,1998.0,3,3,0
PER,AUS,2013.0,1,2,-1
ISR,TUR,2016.0,2,1,1
UGA,ESP,2017.0,1,1,0
KWT,SRB,2016.0,1,1,0
LVA,RUS,2016.0,3,3,0
RUS,LVA,2020.0,3,5,-2
URY,AUS,2021.0,1,2,-1
HRV,AUT,2015.0,5,2,3
GHA,NGA,2017.0,4,8,-4
CIV,DEU,2016.0,1,1,0
CMR,NLD,2019.0,1,2,-1
PAK,NOR,2017.0,2,11,-9
URY,GBR,2019.0,4,1,3
DEU,PSE,2022.0,3,1,2
HKG,JOR,2018.0,2,4,-2
QAT,MYS,2011.0,2,1,1
BGD,AUS,1999.0,4,1,3
JPN,BHR,2020.0,1,1,0
IND,FIN,1997.0,1,1,0
IRL,FIN,2000.0,1,4,-3
CHE,ARM,2003.0,1,1,0
ITA,UKR,1997.0,1,3,-2
ISR,PRT,2023.0,1,2,-1
FRA,PAK,1999.0,2,1,1
MEX,ZAF,2016.0,1,2,-1
FIN,IRN,2003.0,1,1,0
IRN,RUS,2004.0,2,3,-1
IRN,AZE,2004.0,1,1,0
ARE,HKG,2016.0,1,3,-2
JPN,PRT,2002.0,1,6,-5
KOR,FRA,1997.0,2,5,-3
BWA,ZWE,2000.0,1,2,-1
BWA,AUS,2014.0,1,1,0
BRA,PAK,2010.0,1,3,-2
MAR,GBR,2017.0,2,4,-2
AZE,EGY,2013.0,1,1,0
IRL,EGY,2019.0,1,4,-3
FRA,TZA,2011.0,1,1,0
CHN,CZE,2012.0,1,4,-3
USA,NAM,2014.0,1,4,-3
RWA,CHN,2016.0,1,3,-2
CHE,MUS,2012.0,1,1,0
ERI,IND,2005.0,2,3,-1
JPN,EST,2015.0,3,2,1
HUN,IRN,2014.0,2,2,0
ESP,NGA,2011.0,1,3,-2
NPL,BEL,2016.0,1,2,-1
USA,GEO,2024.0,2,1,1
ITA,URY,2011.0,1,1,0
BGD,TUR,2021.0,2,3,-1
SGP,ARE,2006.0,1,1,0
NZL,GHA,2020.0,1,2,-1
MNG,DEU,2016.0,2,1,1
NOR,MWI,2009.0,1,1,0
HRV,SVK,2018.0,1,1,0
DEU,YEM,2017.0,1,2,-1
GBR,MAC,2018.0,1,3,-2
NZL,ARG,2018.0,1,2,-1
GAB,THA,2009.0,2,1,1
CMR,BEL,2007.0,4,1,3
AFG,USA,2015.0,3,5,-2
NOR,HRV,2019.0,1,2,-1
UKR,ITA,2002.0,2,1,1
SLE,GHA,2021.0,1,1,0
ZAF,JAM,2014.0,1,1,0
CHE,GTM,2020.0,1,1,0
NGA,HKG,2018.0,3,3,0
TWN,BGD,2019.0,1,1,0
CHE,GIN,2018.0,1,1,0
ARG,ISR,2022.0,1,4,-3
LBN,ESP,2016.0,1,2,-1
IRL,TUR,2023.0,2,8,-6
TUR,LTU,2020.0,1,2,-1
BTN,JPN,2022.0,2,1,1
KWT,TUN,2021.0,1,2,-1
BHS,CAN,2015.0,1,1,0
MNE,BIH,2017.0,2,1,1
LBR,GBR,2020.0,2,2,0
BRB,TTO,2011.0,1,4,-3
ISR,ARG,2019.0,2,2,0
BGD,NZL,2022.0,1,5,-4
POL,HRV,2020.0,1,4,-3
MWI,ZMB,2020.0,2,2,0
NPL,NLD,2017.0,1,2,-1
RUS,NZL,2023.0,1,1,0
LIE,AUT,2023.0,1,4,-3
JOR,YEM,2022.0,2,2,0
GBR,NPL,2023.0,3,5,-2
NGA,ZWE,1997.0,3,4,-1
CAN,FRA,2024.0,1,2,-1
MEX,NOR,2016.0,2,1,1
DEU,BEN,2003.0,2,2,0
ZAF,POL,2008.0,4,1,3
KEN,EGY,2018.0,1,2,-1
UKR,GEO,1999.0,1,1,0
PHL,IRN,2004.0,2,1,1
GRC,BGR,2006.0,2,1,1
IDN,ZWE,2002.0,2,1,1
BGR,FRA,2020.0,2,11,-9
ISR,UKR,2006.0,1,2,-1
CZE,BRA,2003.0,2,1,1
BHR,CAN,1998.0,1,2,-1
FRA,KHM,2016.0,2,5,-3
FRA,ALB,2019.0,2,1,1
NLD,TWN,2003.0,1,1,0
MDA,RUS,2013.0,1,6,-5
BGR,DNK,2002.0,4,1,3
IDN,UGA,2008.0,1,1,0
PRT,CHN,2000.0,2,5,-3
GEO,CHN,2019.0,2,1,1
ZAF,KOR,2012.0,4,8,-4
BGD,CHE,2014.0,1,1,0
MNG,KOR,2011.0,2,2,0
SGP,KOR,2001.0,3,4,-1
NLD,BGR,2004.0,1,3,-2
CIV,NGA,2001.0,1,1,0
COG,CMR,2014.0,1,1,0
SVN,SRB,2018.0,1,6,-5
NOR,BIH,2015.0,2,1,1
BOL,NLD,2012.0,1,1,0
ZWE,COG,2016.0,1,2,-1
AGO,FRA,2010.0,3,3,0
IRL,QAT,2021.0,3,1,2
BFA,BEL,2012.0,1,1,0
CHL,POL,2017.0,1,2,-1
LAO,GBR,2009.0,1,2,-1
GRL,NOR,2009.0,1,1,0
DEU,MWI,2009.0,1,2,-1
PNG,AUS,2011.0,4,9,-5
ESP,UKR,2007.0,1,1,0
BGR,POL,2011.0,2,3,-1
USA,LAO,2011.0,1,1,0
USA,GTM,2011.0,5,9,-4
SYR,FRA,2021.0,3,5,-2
COL,CAN,1999.0,1,1,0
SGP,THA,2005.0,2,2,0
GAB,DEU,2011.0,1,4,-3
FRA,MDA,2010.0,1,3,-2
DOM,USA,2007.0,3,1,2
TWN,DNK,2014.0,3,1,2
BEL,LVA,2009.0,1,2,-1
ITA,ISL,2011.0,1,2,-1
NLD,PSE,2013.0,1,1,0
PAK,EGY,2006.0,1,2,-1
ALB,AUT,2016.0,1,1,0
CHL,URY,2004.0,2,1,1
BFA,SEN,2019.0,3,6,-3
CHE,GUF,2021.0,1,1,0
PRT,AUT,2008.0,1,2,-1
MWI,ITA,2020.0,1,1,0
CHL,DNK,2012.0,1,2,-1
AUS,ROU,2010.0,2,2,0
GRC,TWN,2008.0,1,1,0
NAM,ZAF,2011.0,3,9,-6
FIN,HUN,2022.0,1,5,-4
CMR,ESP,2021.0,1,2,-1
IRN,PAK,2010.0,1,2,-1
NGA,THA,2020.0,1,6,-5
SAU,LBY,2017.0,1,2,-1
MLT,ITA,2013.0,1,3,-2
IRL,ETH,2019.0,1,1,0
URY,ECU,2015.0,1,1,0
CAN,ETH,2004.0,2,1,1
TJK,RUS,2019.0,2,7,-5
VNM,JPN,1997.0,4,2,2
ARG,NZL,2022.0,1,1,0
MAR,EGY,2023.0,1,2,-1
FIN,SAU,2021.0,1,3,-2
KOR,MAC,2018.0,1,2,-1
IRL,SVK,2009.0,1,1,0
ZAF,MEX,2018.0,1,3,-2
CHL,ISR,2023.0,2,1,1
KEN,SAU,2019.0,1,1,0
NLD,NPL,2021.0,1,4,-3
ZAF,DNK,2005.0,3,2,1
AUS,GUM,2009.0,1,1,0
EGY,ESP,1998.0,1,1,0
FIN,ZAF,2019.0,1,5,-4
HND,USA,2005.0,3,1,2
BGR,MEX,1997.0,1,1,0
LTU,FIN,2007.0,3,2,1
KOR,MEX,2017.0,4,3,1
DOM,ESP,1999.0,1,4,-3
ESP,NOR,1997.0,3,2,1
SVN,AUS,2006.0,2,1,1
PRI,PRT,2015.0,2,1,1
OMN,FRA,2013.0,1,2,-1
CAN,SVK,2007.0,1,1,0
BGD,ETH,2012.0,1,1,0
IND,SVN,2016.0,1,1,0
AUT,ISL,2012.0,1,1,0
FIN,THA,2015.0,1,2,-1
JPN,SEN,2011.0,1,1,0
GBR,AZE,2020.0,1,2,-1
SRB,ESP,2012.0,1,2,-1
FRO,DNK,2011.0,1,2,-1
DZA,MYS,2019.0,1,4,-3
AUS,PNG,2013.0,3,9,-6
MDA,DEU,2023.0,1,3,-2
BEL,BOL,2007.0,1,2,-1
JPN,BGR,2018.0,2,2,0
EST,JPN,2017.0,1,2,-1
JPN,ARG,2000.0,1,3,-2
SMR,ITA,2011.0,3,2,1
COG,CHE,2022.0,3,5,-2
SGP,PAK,2016.0,2,4,-2
NGA,TWN,2016.0,1,1,0
TWN,SAU,2019.0,4,8,-4
ESP,GRC,2000.0,1,5,-4
CHE,PRT,2001.0,4,12,-8
ITA,PHL,2019.0,4,2,2
MEX,GRC,2022.0,1,1,0
TTO,IRL,2020.0,1,1,0
DEU,MNE,2017.0,1,2,-1
SEN,BEN,2004.0,2,1,1
PRY,BRA,2015.0,1,3,-2
COL,IND,2005.0,1,2,-1
POL,ARM,2002.0,1,1,0
QAT,SDN,2019.0,1,3,-2
ITA,SLE,2019.0,1,1,0
EGY,TWN,2008.0,1,1,0
CHN,NAM,2021.0,1,1,0
NLD,DZA,2020.0,1,1,0
LBN,AUS,2015.0,1,10,-9
PER,ITA,2023.0,1,1,0
PAN,DEU,2021.0,1,3,-2
SWE,NIC,2006.0,1,1,0
GEO,BRA,2022.0,1,1,0
KWT,HUN,2002.0,1,2,-1
HRV,RUS,2014.0,1,1,0
POL,PAN,2003.0,1,4,-3
DNK,URY,2009.0,1,1,0
ARE,AUT,2023.0,1,1,0
USA,BHR,2008.0,1,4,-3
ISR,KOR,2016.0,3,3,0
BRN,DNK,2014.0,1,1,0
KEN,COL,2016.0,1,3,-2
VNM,VEN,2011.0,2,2,0
BEL,TUN,2005.0,1,5,-4
TZA,AUS,2004.0,1,1,0
KEN,BEL,2015.0,1,4,-3
CRI,RUS,2012.0,2,2,0
ITA,UKR,2012.0,3,2,1
NGA,RWA,2022.0,2,2,0
TZA,MWI,2019.0,1,1,0
IRN,HKG,2019.0,2,1,1
CUB,ITA,2007.0,4,2,2
SAU,MRT,2017.0,2,1,1
ATG,IND,2018.0,1,1,0
CMR,CHN,2018.0,2,3,-1
MEX,BOL,2021.0,2,1,1
DEU,MNE,2018.0,1,1,0
MYS,FIN,2012.0,1,3,-2
PHL,MMR,2021.0,1,1,0
CYP,BEL,2020.0,1,2,-1
MYS,MMR,2021.0,3,1,2
THA,HKG,2023.0,2,2,0
NLD,MKD,2020.0,2,1,1
ZMB,CHN,2020.0,2,3,-1
ESP,GTM,2023.0,1,4,-3
ARG,PRY,2008.0,2,1,1
ESP,PHL,2011.0,1,1,0
BEN,TZA,2013.0,1,1,0
COL,IRL,2019.0,1,1,0
CHN,PRI,2012.0,1,2,-1
DNK,ETH,2014.0,1,2,-1
CAN,ARM,2019.0,1,1,0
BEL,TUR,2003.0,2,1,1
ARG,SWE,1997.0,2,4,-2
THA,KHM,2016.0,2,3,-1
THA,NGA,2012.0,1,2,-1
FRA,BLR,2007.0,2,4,-2
GEO,NOR,2014.0,1,1,0
PAK,THA,2009.0,1,1,0
HUN,SRB,2010.0,1,5,-4
HUN,CZE,2004.0,1,3,-2
UKR,ITA,1997.0,3,1,2
HUN,IRN,2015.0,1,1,0
IDN,PAK,2013.0,1,1,0
ZWE,CHE,2021.0,1,1,0
LUX,ESP,2011.0,1,1,0
DNK,TZA,2015.0,2,1,1
MRT,FRA,2013.0,1,1,0
IRL,TWN,2013.0,2,3,-1
SAU,BEL,2007.0,1,1,0
CZE,TWN,2013.0,1,4,-3
BIH,RUS,2020.0,1,1,0
MKD,CZE,2018.0,1,1,0
AUT,CHL,2022.0,1,4,-3
JOR,GRC,2016.0,1,1,0
DEU,BGD,2009.0,4,4,0
OMN,MYS,2016.0,3,7,-4
TUR,HKG,2019.0,1,2,-1
CHE,ISL,2016.0,2,3,-1
AUS,MDV,2021.0,2,1,1
ALB,CAN,2019.0,1,1,0
ETH,POL,2023.0,2,2,0
TUR,BEN,2022.0,1,1,0
PSE,SAU,2022.0,1,9,-8
SRB,JPN,2003.0,1,3,-2
MNE,SRB,1999.0,2,2,0
TUN,ARE,2004.0,1,2,-1
DEU,JAM,2019.0,2,1,1
KEN,COG,2007.0,3,1,2
BEL,SAU,1997.0,1,1,0
EST,LTU,2020.0,1,2,-1
COG,BFA,2020.0,1,3,-2
FIN,SVK,2006.0,1,1,0
GRC,ZAF,1998.0,1,1,0
BRA,RUS,2008.0,1,4,-3
USA,BHR,2004.0,2,1,1
BHR,AUS,2009.0,2,2,0
MAR,NLD,2016.0,1,3,-2
BEL,MYS,2023.0,2,2,0
SRB,HUN,2009.0,1,1,0
EGY,NLD,1998.0,1,2,-1
USA,MCO,2009.0,1,1,0
CHE,EGY,2003.0,1,2,-1
KWT,CAN,2001.0,1,5,-4
IND,NPL,1997.0,2,1,1
BEL,BGR,2005.0,5,3,2
ISR,HKG,2018.0,1,1,0
BGD,SGP,2021.0,1,2,-1
CHL,DNK,2005.0,1,3,-2
EGY,SOM,2022.0,1,1,0
KHM,VNM,2014.0,2,1,1
MYS,TUR,2011.0,1,2,-1
CHE,QAT,2012.0,1,1,0
IRL,COL,2019.0,1,1,0
JPN,ZMB,2011.0,3,2,1
MWI,CAN,2011.0,1,1,0
GBR,MOZ,2009.0,1,1,0
MAC,USA,2007.0,1,3,-2
IRQ,SWE,2017.0,4,4,0
NGA,SWE,2017.0,1,5,-4
SWE,SVK,2008.0,1,1,0
NAM,GHA,2020.0,1,1,0
ISR,HKG,2017.0,1,3,-2
FRA,CYP,2012.0,2,4,-2
IRQ,IND,2015.0,1,7,-6
GHA,NAM,2020.0,1,1,0
SYC,AUS,2018.0,1,1,0
AUT,EGY,2022.0,3,2,1
BRN,LKA,2017.0,1,1,0
NLD,DZA,1999.0,1,1,0
DZA,KWT,2018.0,1,1,0
QAT,PAK,2013.0,1,3,-2
TWN,SWZ,2021.0,1,1,0
NOR,NZL,2017.0,1,9,-8
GRC,EGY,2020.0,4,2,2
MCO,DEU,2019.0,1,3,-2
ZMB,CAN,2021.0,1,2,-1
RWA,CHN,2022.0,1,11,-10
USA,HKG,2024.0,1,1,0
KHM,MYS,2017.0,1,2,-1
BRA,NOR,2001.0,1,1,0
IND,ZWE,2021.0,1,1,0
CHN,SLE,2018.0,1,2,-1
AUS,PYF,2020.0,1,2,-1
ZAF,PAK,2010.0,2,3,-1
GBR,HRV,2003.0,1,5,-4
POL,SVN,2021.0,1,2,-1
ARE,DNK,2022.0,2,1,1
BGD,FIN,2021.0,1,1,0
PAK,POL,2018.0,1,1,0
BGR,CAN,2023.0,1,1,0
CAN,VNM,2023.0,1,5,-4
QAT,CAN,2005.0,2,3,-1
SRB,SWE,2013.0,1,2,-1
KWT,AUS,2008.0,1,2,-1
CMR,CHE,2011.0,3,7,-4
CZE,NLD,2006.0,2,5,-3
GEO,GBR,2011.0,1,3,-2
ZAF,IRN,2012.0,2,4,-2
HKG,CHE,1998.0,1,1,0
BEL,TZA,2007.0,1,2,-1
USA,ARM,2007.0,1,13,-12
PAN,ITA,2022.0,1,1,0
KOR,POL,2015.0,2,2,0
BEL,FIN,2013.0,2,4,-2
LKA,CHE,2004.0,1,1,0
USA,FJI,2004.0,1,1,0
SAU,NOR,2020.0,3,3,0
CMR,ZAF,2006.0,1,2,-1
ETH,ZAF,2009.0,1,3,-2
LUX,BEL,2001.0,2,10,-8
THA,TZA,2016.0,1,1,0
KGZ,UZB,2007.0,1,2,-1
IRL,SRB,2021.0,1,2,-1
UGA,SWE,2009.0,1,4,-3
TWN,BRA,2007.0,1,1,0
UKR,KAZ,1998.0,1,1,0
KHM,DNK,2020.0,1,1,0
FSM,USA,2003.0,1,1,0
KEN,HUN,2020.0,1,1,0
ETH,AUT,2000.0,1,2,-1
BEL,KOR,1997.0,2,2,0
CHN,POL,2024.0,1,1,0
NGA,NER,2002.0,1,1,0
ESP,CZE,1998.0,2,2,0
BGR,NLD,2008.0,2,1,1
BLR,GBR,2010.0,1,1,0
NZL,HUN,2007.0,1,2,-1
MEX,POL,2014.0,1,4,-3
WSM,DEU,2000.0,1,1,0
SVN,ROU,2007.0,1,1,0
COL,VNM,2020.0,2,1,1
TUR,CHN,2014.0,1,8,-7
FRA,LVA,2013.0,1,1,0
CHL,NOR,2013.0,1,3,-2
TZA,NOR,2014.0,1,11,-10
CHN,TZA,2014.0,2,1,1
KHM,JPN,2012.0,3,3,0
BRB,USA,2014.0,4,4,0
BFA,DEU,2013.0,1,2,-1
CIV,USA,2016.0,2,8,-6
MKD,POL,2016.0,1,1,0
TWN,IRL,2012.0,1,2,-1
VEN,ITA,2001.0,2,3,-1
TWN,UKR,2001.0,1,4,-3
TWN,UKR,2008.0,1,1,0
GTM,MEX,2011.0,1,5,-4
MDG,USA,2005.0,1,4,-3
SVN,IRL,2019.0,1,1,0
CAN,PSE,2019.0,1,2,-1
ZAF,ISR,2003.0,1,4,-3
MAR,CZE,2021.0,1,1,0
CUB,FRA,2023.0,2,2,0
ITA,TUR,2023.0,3,18,-15
QAT,KOR,2023.0,1,4,-3
BHR,OMN,2005.0,1,1,0
PRT,ZAF,2001.0,1,4,-3
IND,CIV,2016.0,3,1,2
KWT,PAK,2021.0,1,1,0
SGP,PHL,2007.0,1,2,-1
AUS,HUN,2004.0,1,6,-5
MCO,USA,1997.0,1,1,0
HRV,IND,2023.0,1,2,-1
ZAF,NOR,2000.0,1,2,-1
GBR,URY,2019.0,1,4,-3
KAZ,NLD,2021.0,1,1,0
NER,SEN,2017.0,1,3,-2
SGP,BEL,2006.0,2,3,-1
PHL,CHE,2018.0,2,2,0
HRV,NOR,2018.0,1,1,0
CAF,CMR,2019.0,1,1,0
MOZ,GBR,2009.0,1,1,0
JPN,SDN,2016.0,2,1,1
CYP,CHE,2020.0,1,2,-1
ISR,NOR,2019.0,4,5,-1
SRB,TUR,2019.0,1,13,-12
ARG,CUB,2019.0,2,5,-3
BRB,TTO,2019.0,1,2,-1
ARG,CUB,2021.0,1,4,-3
LVA,SWE,2020.0,1,4,-3
MWI,CHN,2021.0,1,5,-4
DEU,NPL,2014.0,1,5,-4
COL,CUB,2010.0,1,4,-3
ZAF,PRT,2015.0,1,7,-6
UKR,DNK,2023.0,1,1,0
FRA,GIN,2020.0,3,4,-1
SYR,RUS,2023.0,1,4,-3
CUB,ARG,2017.0,3,7,-4
TWN,EGY,2017.0,1,3,-2
RWA,GBR,2023.0,1,1,0
UZB,DEU,2004.0,2,2,0
DEU,UZB,2006.0,3,4,-1
NLD,BLR,2005.0,1,2,-1
TTO,CAN,2003.0,1,1,0
HUN,BGR,2006.0,1,3,-2
ISR,FIN,2004.0,2,2,0
USA,BIH,2002.0,2,1,1
JPN,ZMB,2009.0,2,1,1
BEN,ITA,2012.0,1,1,0
HUN,IRL,2007.0,1,1,0
IRL,HUN,2008.0,1,4,-3
BEL,GAB,2012.0,1,2,-1
GBR,JAM,2010.0,1,3,-2
ZAF,ISR,2013.0,1,3,-2
SEN,AUS,2012.0,1,1,0
CYP,JPN,2003.0,1,1,0
TUN,CAN,2007.0,2,4,-2
FRA,ARE,2004.0,1,1,0
FJI,DEU,2021.0,1,1,0
ROU,SGP,2019.0,1,1,0
NGA,MWI,2008.0,1,1,0
CAN,PER,2013.0,1,4,-3
JPN,ZAF,2011.0,2,3,-1
ITA,BOL,2008.0,1,2,-1
NLD,TTO,2003.0,1,1,0
LBN,SYR,2011.0,2,2,0
COG,SEN,2016.0,1,2,-1
RUS,GEO,2010.0,2,9,-7
SWE,GHA,2009.0,1,1,0
TTO,JAM,2006.0,2,1,1
CHE,MEX,2003.0,2,4,-2
JPN,UKR,2018.0,4,4,0
POL,IRN,2015.0,2,3,-1
SWE,LTU,2015.0,3,5,-2
VNM,RUS,2017.0,2,11,-9
ARM,GBR,2012.0,1,2,-1
FRA,UGA,2011.0,1,1,0
SGP,CHE,2002.0,2,3,-1
SRB,GRC,2010.0,2,17,-15
IRL,MAC,2014.0,1,1,0
TUR,BGR,2012.0,2,1,1
BEN,COG,2021.0,1,2,-1
LKA,IND,2012.0,3,3,0
CHL,AUT,2002.0,2,1,1
KOR,LAO,2013.0,1,1,0
AUT,IRL,2011.0,2,6,-4
PHL,THA,2011.0,1,1,0
NOR,EGY,2007.0,1,2,-1
HUN,CHN,2007.0,1,1,0
VNM,NLD,2008.0,2,6,-4
BTN,BGD,2019.0,1,1,0
NOR,IND,2000.0,1,2,-1
KOR,MAC,2016.0,1,1,0
DEU,PAN,2018.0,1,4,-3
NER,BEN,2018.0,1,3,-2
GRC,SRB,2018.0,1,2,-1
SOM,TUR,2021.0,1,5,-4
HKG,ESP,2018.0,1,2,-1
ESP,NZL,2022.0,3,8,-5
NOR,SVK,2017.0,1,1,0
PRY,CHL,2020.0,1,2,-1
RWA,UGA,2021.0,3,4,-1
LVA,DEU,2023.0,2,1,1
IND,LBY,2021.0,1,2,-1
IND,PRI,2012.0,1,1,0
CHE,NZL,1997.0,2,5,-3
TUR,FIN,2003.0,2,2,0
BIH,NLD,2009.0,1,1,0
SWE,ZWE,2005.0,2,2,0
AUT,BGR,2002.0,1,3,-2
TZA,JPN,2000.0,2,1,1
NLD,KEN,2003.0,5,3,2
PAK,SGP,2011.0,1,2,-1
ITA,ETH,2008.0,2,2,0
DEU,NPL,2001.0,1,1,0
SRB,ARG,2006.0,1,1,0
IND,PHL,2016.0,2,11,-9
ITA,MLT,2006.0,2,2,0
QAT,CAN,2012.0,2,9,-7
CMR,NGA,2000.0,2,4,-2
MAR,SYR,2015.0,1,3,-2
DEU,GHA,1998.0,1,2,-1
DEU,ZMB,2003.0,1,1,0
KAZ,GBR,2002.0,1,1,0
ITA,EGY,2004.0,3,2,1
NOR,CZE,2004.0,1,2,-1
USA,DOM,2007.0,1,3,-2
USA,JEY,2023.0,1,1,0
ESP,PSE,2017.0,2,2,0
CHL,BOL,2018.0,1,6,-5
COD,CHE,2015.0,1,2,-1
IND,MUS,2022.0,2,1,1
TUR,NGA,2011.0,1,2,-1
MYS,ITA,2010.0,2,4,-2
ZWE,CMR,2021.0,1,1,0
NLD,LTU,2011.0,1,4,-3
BEL,BFA,2012.0,1,1,0
ECU,BRA,2007.0,1,1,0
BHR,SAU,2006.0,1,1,0
ARE,ITA,2009.0,1,2,-1
HRV,MKD,2017.0,1,1,0
USA,KGZ,2008.0,2,1,1
LUX,SGP,2019.0,1,2,-1
NPL,CAN,2014.0,1,1,0
NLD,ALB,2018.0,1,1,0
MAR,DEU,2013.0,2,1,1
QAT,NLD,2016.0,1,4,-3
EST,AUS,2020.0,2,1,1
USA,BHS,2003.0,1,1,0
ARG,PRI,2016.0,1,2,-1
ETH,TUR,2023.0,2,5,-3
ARE,ARG,2018.0,1,3,-2
HRV,SVK,2017.0,1,2,-1
TZA,KEN,2009.0,1,2,-1
DNK,SYR,2005.0,1,1,0
ARM,CHE,2003.0,1,1,0
ARE,FRA,1999.0,1,2,-1
LBY,HUN,1999.0,1,1,0
BGR,ITA,2011.0,5,5,0
BGR,IRL,2010.0,1,2,-1
NGA,BWA,2006.0,2,2,0
ITA,BLR,2007.0,1,3,-2
BGR,DNK,2005.0,1,1,0
SVN,IND,1998.0,1,1,0
ARG,AUT,2002.0,1,3,-2
IND,CZE,2001.0,1,1,0
BOL,PER,2005.0,3,1,2
RUS,ZAF,2008.0,2,4,-2
FRA,BLR,1998.0,3,3,0
ITA,GEO,2020.0,3,3,0
IND,NOR,2001.0,1,1,0
FIN,ZAF,2021.0,2,8,-6
BEL,ZWE,2013.0,1,1,0
BGR,MKD,2022.0,1,1,0
MAR,TUN,2012.0,1,1,0
TUR,PAK,2024.0,1,1,0
MDG,USA,2012.0,1,6,-5
NGA,CZE,2021.0,1,1,0
KAZ,SGP,2016.0,1,1,0
DNK,IRN,2007.0,1,2,-1
POL,SAU,2012.0,2,0,2
CMR,SWE,2007.0,2,0,2
,DJI,2000.0,1,0,1
KEN,SEN,2015.0,2,0,2
IND,BRB,2003.0,1,0,1
CAN,VNM,2004.0,2,0,2
ARM,MEX,2005.0,1,0,1
ARM,MEX,2012.0,1,0,1
ARM,ESP,2012.0,1,0,1
HKG,MYS,2014.0,4,0,4
TUR,SYR,2005.0,1,0,1
NGA,GHA,2008.0,3,0,3
NZL,CZE,2007.0,1,0,1
PLW,,2008.0,1,0,1
KEN,TWN,2011.0,1,0,1
RUS,COL,2003.0,2,0,2
BRA,VUT,2015.0,1,0,1
YEM,AUS,2007.0,1,0,1
BEL,ESP,2024.0,1,0,1
ESP,KWT,2016.0,1,0,1
NLD,GIN,2015.0,1,0,1
DZA,TUR,2015.0,1,0,1
CRI,PHL,2021.0,1,0,1
QAT,HKG,2021.0,1,0,1
CHN,LVA,2022.0,1,0,1
PER,DOM,2016.0,1,0,1
QAT,PAK,2011.0,2,0,2
,ATA,2012.0,2,0,2
ATA,,2021.0,1,0,1
USA,COD,2015.0,2,0,2
UGA,OMN,2012.0,1,0,1
IND,VCT,2019.0,1,0,1
IRL,ISL,2015.0,4,0,4
RWA,SDN,2019.0,1,0,1
,MDV,2013.0,6,0,6
GBR,BOL,2003.0,3,0,3
,SYC,2004.0,8,0,8
USA,CZE,2024.0,3,0,3
MKD,CHE,2023.0,1,0,1
IRN,ISR,2021.0,3,0,3
TGO,NGA,2023.0,1,0,1
,SHN,2019.0,1,0,1
QAT,MEX,2021.0,1,0,1
COD,CMR,2020.0,1,0,1
BGD,NOR,2021.0,2,0,2
VCT,,2024.0,4,0,4
KOR,IRQ,2017.0,2,0,2
SOM,CZE,2021.0,1,0,1
TUR,BHR,2011.0,1,0,1
ZAF,ESP,2008.0,4,0,4
LKA,JPN,1998.0,1,0,1
FLK,SLB,2018.0,1,0,1
MEX,TUR,2001.0,3,0,3
AZE,DEU,2001.0,1,0,1
DEU,AZE,2023.0,1,0,1
DNK,MKD,2000.0,1,0,1
ARE,LBN,2012.0,4,0,4
TWN,PRT,2004.0,1,0,1
ROU,MDA,2008.0,2,0,2
NGA,BWA,2008.0,2,0,2
BEN,TZA,2011.0,1,0,1
BGR,IRL,2008.0,1,0,1
BDI,,2009.0,3,0,3
COL,URY,2003.0,2,0,2
ROU,KAZ,2013.0,2,0,2
GEO,AUT,2010.0,1,0,1
MYS,ECU,2016.0,1,0,1
NLD,SAU,1998.0,2,0,2
UKR,DNK,2001.0,3,0,3
UKR,CHN,2013.0,2,0,2
DEU,ERI,2004.0,1,0,1
CMR,NGA,2004.0,1,0,1
BEN,BRA,2001.0,1,0,1
MYS,DEU,2001.0,3,0,3
PYF,USA,1999.0,2,0,2
NGA,QAT,1998.0,1,0,1
THA,BLR,2000.0,2,0,2
NGA,GMB,2005.0,2,0,2
SYR,MAR,2023.0,1,0,1
CMR,KEN,2016.0,2,0,2
DEU,BWA,1999.0,1,0,1
CIV,MDG,2004.0,1,0,1
ARE,BLR,2021.0,1,0,1
ARE,KWT,2023.0,1,0,1
JPN,LTU,2015.0,1,0,1
FIN,BGR,2001.0,1,0,1
COL,CUB,2004.0,3,0,3
MTQ,,2008.0,7,0,7
IDN,SAU,2002.0,1,0,1
BDI,CAN,1997.0,1,0,1
CAN,BDI,2001.0,1,0,1
SRB,RUS,2011.0,3,0,3
NLD,LBN,2007.0,1,0,1
NPL,HKG,2002.0,1,0,1
PRT,BGR,2018.0,1,0,1
TUR,PRT,2011.0,2,0,2
ALB,CHE,2015.0,1,0,1
ARE,OMN,2012.0,1,0,1
CHL,GRC,2020.0,2,0,2
CZE,VNM,2009.0,1,0,1
SMR,,2014.0,1,0,1
TUR,BIH,2012.0,3,0,3
,REU,1998.0,4,0,4
USA,LAO,2003.0,2,0,2
MDA,TUR,2018.0,1,0,1
MSR,USA,1998.0,1,0,1
SYR,JPN,2012.0,1,0,1
MLT,LTU,2015.0,1,0,1
KOR,PRT,2000.0,1,0,1
ESP,PRI,1998.0,2,0,2
ECU,DOM,2019.0,1,0,1
EGY,SVK,2008.0,1,0,1
IRN,HRV,2018.0,1,0,1
BIH,SWE,2015.0,2,0,2
JPN,UGA,2019.0,3,0,3
GMB,DEU,2017.0,1,0,1
ISL,CZE,2019.0,1,0,1
JAM,DEU,2020.0,1,0,1
GBR,SYC,2017.0,3,0,3
HKG,POL,2019.0,4,0,4
IND,SDN,2018.0,1,0,1
MAR,KOR,2022.0,3,0,3
KAZ,ESP,2023.0,2,0,2
MYS,PNG,2018.0,1,0,1
KOR,ROU,2016.0,2,0,2
LKA,GRC,2018.0,1,0,1
EST,EGY,2022.0,2,0,2
UZB,IND,2013.0,1,0,1
MLI,JPN,2014.0,1,0,1
,WLF,2003.0,1,0,1
FRA,WLF,2017.0,1,0,1
WLF,,2024.0,2,0,2
ARG,CZE,2022.0,3,0,3
USA,AIA,2022.0,3,0,3
BGD,EGY,2024.0,1,0,1
EGY,GHA,2014.0,2,0,2
EST,CHN,2024.0,1,0,1
NGA,LTU,2023.0,1,0,1
,NCL,2020.0,7,0,7
,ERI,2020.0,10,0,10
HUN,QAT,2015.0,1,0,1
SAU,POL,2009.0,1,0,1
SVK,NZL,2008.0,1,0,1
LBN,MAR,2012.0,1,0,1
DNK,LAO,2011.0,2,0,2
HRV,NOR,2005.0,1,0,1
BHR,EGY,2002.0,1,0,1
SWZ,,2001.0,1,0,1
LTU,CAN,2000.0,1,0,1
GEO,CHN,2003.0,1,0,1
VEN,CHE,2023.0,1,0,1
CHE,SYR,2015.0,1,0,1
MAR,LUX,2012.0,1,0,1
ARG,NZL,2002.0,2,0,2
LKA,OMN,2010.0,1,0,1
FRA,NPL,2007.0,2,0,2
RWA,,2004.0,1,0,1
PAK,EGY,2004.0,1,0,1
HKG,FIN,2015.0,3,0,3
CAN,MCO,2010.0,2,0,2
LKA,TLS,2020.0,1,0,1
CAN,BEN,1997.0,1,0,1
JPN,SLE,2019.0,1,0,1
FRA,PRY,2002.0,1,0,1
CUB,FIN,2007.0,1,0,1
AND,ESP,1997.0,1,0,1
PNG,UGA,2011.0,1,0,1
BEL,LTU,2000.0,2,0,2
DEU,MDG,2006.0,1,0,1
MEX,SLV,1998.0,1,0,1
SVK,NGA,2003.0,2,0,2
IDN,AUT,1998.0,1,0,1
ISL,BGR,2019.0,1,0,1
HKG,ISR,2009.0,1,0,1
ITA,LVA,2018.0,2,0,2
GNQ,ESP,2015.0,2,0,2
KOR,MNG,2004.0,1,0,1
AUS,CYP,2006.0,1,0,1
KWT,DNK,1999.0,1,0,1
DNK,KWT,2000.0,1,0,1
FRA,OMN,2011.0,6,0,6
USA,GIN,2002.0,1,0,1
ZWE,AUS,2011.0,1,0,1
ISR,CZE,2003.0,3,0,3
LSO,USA,2009.0,1,0,1
GBR,YEM,1999.0,2,0,2
MLT,CAN,2009.0,1,0,1
CHE,ARE,2008.0,1,0,1
ISR,TUR,1997.0,1,0,1
JAM,NGA,2015.0,1,0,1
NOR,CUB,2010.0,2,0,2
ETH,SWZ,2023.0,1,0,1
,PRY,2000.0,3,0,3
,COM,2005.0,3,0,3
ESP,VNM,2012.0,1,0,1
ASM,,2013.0,3,0,3
ROU,KOR,2015.0,1,0,1
USA,SJM,2016.0,1,0,1
RUS,IRQ,2008.0,1,0,1
SUR,,2003.0,2,0,2
PER,GHA,2000.0,2,0,2
GIN,CAN,2013.0,1,0,1
,VGB,2005.0,3,0,3
CAN,BIH,2005.0,1,0,1
DZA,SVK,2012.0,1,0,1
CRI,JPN,2015.0,1,0,1
NLD,SDN,2012.0,2,0,2
IND,IRQ,2011.0,1,0,1
LKA,KOR,2007.0,1,0,1
BEN,ZAF,2009.0,1,0,1
SVN,MEX,2010.0,1,0,1
HTI,CUB,2014.0,1,0,1
CUB,HTI,2016.0,1,0,1
SDN,EGY,2009.0,1,0,1
SLE,IND,2021.0,1,0,1
FJI,VNM,2019.0,1,0,1
RWA,CAN,2018.0,2,0,2
AUS,NER,2010.0,1,0,1
LTU,TWN,2018.0,1,0,1
HKG,BRA,2020.0,2,0,2
AUT,AFG,2015.0,1,0,1
GRC,SAU,2008.0,1,0,1
ITA,LSO,2006.0,1,0,1
FRA,MUS,2016.0,3,0,3
MAR,NOR,2024.0,1,0,1
NZL,CIV,2014.0,1,0,1
VEN,FIN,2019.0,2,0,2
GEO,IND,2019.0,1,0,1
NLD,SYR,2018.0,1,0,1
MMR,DEU,2022.0,3,0,3
PAN,COL,2020.0,2,0,2
BEL,REU,2009.0,2,0,2
GBR,BFA,2001.0,1,0,1
HRV,KOR,2015.0,1,0,1
HND,SWE,2015.0,1,0,1
PRT,MKD,2019.0,1,0,1
TON,FJI,2022.0,3,0,3
IND,FJI,2009.0,1,0,1
MOZ,USA,2002.0,1,0,1
COD,ITA,2018.0,2,0,2
DJI,HRV,2014.0,1,0,1
STP,USA,2016.0,2,0,2
LUX,NZL,2018.0,1,0,1
POL,EGY,1998.0,1,0,1
COL,NOR,2021.0,2,0,2
TTO,ITA,2016.0,1,0,1
LBR,KEN,2020.0,1,0,1
LVA,KOR,2013.0,1,0,1
,AND,2012.0,2,0,2
USA,MKD,2020.0,4,0,4
BIH,UZB,2020.0,1,0,1
BEN,CIV,2017.0,4,0,4
CHN,SAU,2008.0,1,0,1
TUR,BHR,2021.0,2,0,2
,FRO,2017.0,12,0,12
CHN,MUS,2018.0,2,0,2
LBN,NLD,2017.0,1,0,1
CRI,PRT,2018.0,1,0,1
AUS,GMB,2003.0,1,0,1
,ATG,2013.0,1,0,1
MYS,UZB,2018.0,3,0,3
PRY,ARG,1999.0,1,0,1
AUT,SYR,2018.0,1,0,1
HND,NIC,2022.0,1,0,1
SEN,SRB,2017.0,2,0,2
CZE,EUE,2020.0,1,0,1
,SMR,2014.0,4,0,4
ARE,MWI,2016.0,2,0,2
ALB,CHN,2019.0,2,0,2
IDN,IRL,2023.0,1,0,1
MEX,IRL,2023.0,1,0,1
UGA,TCD,2019.0,1,0,1
ITA,LTU,2006.0,10,0,10
ZAF,ECU,2017.0,1,0,1
,LCA,2016.0,1,0,1
SVK,LTU,2021.0,3,0,3
,GRL,2017.0,7,0,7
KOR,BEL,1998.0,2,0,2
SOM,IRL,2022.0,1,0,1
,REU,2020.0,4,0,4
SDN,OMN,2017.0,3,0,3
TUR,MAC,2022.0,1,0,1
USA,GNB,2011.0,1,0,1
NLD,LVA,2003.0,1,0,1
PYF,USA,1998.0,1,0,1
MTQ,BRA,2020.0,1,0,1
JPN,SDN,1997.0,2,0,2
SDN,JPN,1998.0,2,0,2
VIR,USA,1999.0,2,0,2
RWA,NLD,2006.0,1,0,1
ESP,PRY,2023.0,3,0,3
LUX,GBR,2000.0,2,0,2
SAU,MLT,2010.0,1,0,1
RUS,MMR,2005.0,1,0,1
MMR,DNK,2010.0,1,0,1
RWA,TCD,2001.0,1,0,1
ZAF,COG,2007.0,1,0,1
EGY,TUN,2013.0,2,0,2
SEN,BOL,2006.0,1,0,1
IRL,SGP,2020.0,3,0,3
YEM,PAK,1999.0,1,0,1
NLD,ARE,2005.0,2,0,2
NIC,SWE,1999.0,1,0,1
SWE,NIC,2015.0,1,0,1
SRB,MLT,2018.0,2,0,2
SRB,MLT,2022.0,1,0,1
PHL,KHM,2020.0,1,0,1
EGY,KEN,2012.0,1,0,1
CYM,USA,2014.0,1,0,1
CAN,BHR,2012.0,4,0,4
HTI,ISR,2012.0,2,0,2
LAO,IDN,2013.0,1,0,1
LTU,AUS,2011.0,2,0,2
ZMB,DNK,2013.0,1,0,1
MAR,JOR,2013.0,1,0,1
,ABW,2009.0,5,0,5
CHN,MAC,2003.0,6,0,6
ITA,LVA,2016.0,1,0,1
MCO,,2015.0,8,0,8
SRB,MLT,2016.0,1,0,1
IND,ATG,2014.0,2,0,2
ATG,,2016.0,4,0,4
RWA,COD,2018.0,1,0,1
COD,LAO,2014.0,1,0,1
IRL,TWN,2019.0,2,0,2
ABW,FJI,2012.0,1,0,1
MYS,BIH,2019.0,1,0,1
LSO,,2018.0,3,0,3
JOR,NGA,2016.0,1,0,1
JOR,NGA,2018.0,1,0,1
MMR,MDG,2019.0,1,0,1
IRN,CYP,2020.0,3,0,3
JAM,IND,2013.0,1,0,1
AFG,CHE,2019.0,2,0,2
SRB,BHR,2016.0,1,0,1
SEN,PER,2011.0,1,0,1
CHN,ECU,2015.0,1,0,1
LBY,AUS,2016.0,1,0,1
CAN,KAZ,2014.0,2,0,2
NGA,SWE,2012.0,1,0,1
MMR,CAN,2022.0,1,0,1
,BMU,2020.0,3,0,3
NFK,AUS,2023.0,1,0,1
ROU,UGA,2022.0,1,0,1
CHN,COD,2023.0,1,0,1
,EUE,2019.0,1,0,1
USA,MDV,2022.0,2,0,2
KOR,PAK,1999.0,1,0,1
IDN,RWA,2021.0,1,0,1
NER,USA,2021.0,1,0,1
GEO,ARM,2019.0,1,0,1
ZWE,KEN,2007.0,3,0,3
ITA,ARM,2007.0,1,0,1
JPN,CRI,2011.0,1,0,1
MCO,NCL,2014.0,1,0,1
ISR,HRV,2004.0,2,0,2
KWT,MAR,2023.0,1,0,1
SWZ,,2008.0,6,0,6
CRI,GBR,2007.0,2,0,2
BGD,PNG,2015.0,1,0,1
RUS,PAK,2006.0,1,0,1
HTI,BEL,2005.0,1,0,1
UGA,RWA,2009.0,3,0,3
CHE,GMB,2007.0,1,0,1
GRC,HKG,2014.0,1,0,1
KEN,GHA,2009.0,2,0,2
ITA,MOZ,2014.0,1,0,1
UZB,JPN,2005.0,3,0,3
CYP,RUS,2022.0,1,0,1
SWE,COD,2018.0,1,0,1
BHR,SGP,2010.0,1,0,1
CHN,COG,2005.0,1,0,1
PAK,UGA,2022.0,1,0,1
IRN,KWT,2019.0,3,0,3
IRN,KWT,2021.0,2,0,2
AFG,EST,2021.0,1,0,1
PRY,CZE,2015.0,1,0,1
KHM,EGY,2018.0,1,0,1
CYP,IRL,2022.0,4,0,4
IRL,MMR,2016.0,1,0,1
FJI,BHR,2018.0,1,0,1
ATA,,2025.0,2,0,2
VNM,ITA,2010.0,1,0,1
TUR,MAC,2018.0,1,0,1
MUS,IOT,2012.0,1,0,1
KNA,DNK,2019.0,1,0,1
FJI,PYF,2012.0,1,0,1
MAR,TCD,2016.0,1,0,1
CMR,MEX,2010.0,1,0,1
SWE,UZB,2018.0,1,0,1
UKR,AUS,2015.0,3,0,3
GUY,DOM,2011.0,1,0,1
CUB,LUX,2021.0,2,0,2
KHM,BEN,2017.0,1,0,1
BLR,ESP,2020.0,1,0,1
VNM,KHM,2015.0,5,0,5
GUF,AFG,2022.0,1,0,1
SRB,TUN,2016.0,1,0,1
RUS,IDN,2022.0,5,0,5
SVN,SAU,2017.0,1,0,1
SLE,IRQ,2021.0,1,0,1
IND,TJK,2017.0,1,0,1
NOR,MLI,2004.0,1,0,1
NOR,MLI,2014.0,1,0,1
RWA,DEU,2018.0,2,0,2
SGP,ESP,2004.0,2,0,2
SYR,PAK,2010.0,1,0,1
NOR,BFA,2019.0,1,0,1
CZE,KEN,2020.0,1,0,1
CZE,ARM,2010.0,1,0,1
UGA,AUS,2011.0,1,0,1
URY,ISR,2013.0,1,0,1
,VNM,2021.0,24,0,24
,MAR,2021.0,27,0,27
GUY,NIC,2023.0,1,0,1
GHA,GUY,2022.0,1,0,1
,NZL,2021.0,7,0,7
,HRV,2021.0,6,0,6
ZAF,BFA,2012.0,3,0,3
PRI,CAN,1997.0,1,0,1
MYS,HUN,2000.0,1,0,1
UGA,BFA,2022.0,1,0,1
LBY,LBN,1998.0,2,0,2
IRL,MNG,2014.0,1,0,1
GUF,TTO,2000.0,1,0,1
GMB,IND,2020.0,1,0,1
COL,ARG,2002.0,2,0,2
CAN,UGA,2005.0,2,0,2
CIV,USA,2005.0,1,0,1
LUX,NOR,2001.0,1,0,1
,REU,1999.0,3,0,3
IND,HTI,2011.0,1,0,1
HTI,GIN,2018.0,2,0,2
DNK,GHA,2011.0,1,0,1
SEN,BFA,2004.0,4,0,4
CHL,PRI,2003.0,1,0,1
,SYC,2008.0,5,0,5
BLR,KOR,2005.0,2,0,2
CAN,MUS,2018.0,1,0,1
CYP,JPN,2009.0,1,0,1
GHA,IRL,1999.0,1,0,1
MCO,GBR,2005.0,1,0,1
USA,MMR,1999.0,1,0,1
NAM,,1999.0,2,0,2
ZWE,DNK,2010.0,1,0,1
ERI,ROU,2011.0,1,0,1
IDN,MEX,2008.0,1,0,1
CIV,BRA,2000.0,1,0,1
BRA,CIV,2003.0,1,0,1
SVN,JPN,1997.0,1,0,1
PNG,IDN,2010.0,4,0,4
WSM,ASM,2014.0,1,0,1
VNM,TUR,2018.0,1,0,1
CHN,SRB,2012.0,1,0,1
USA,MNG,2006.0,2,0,2
BEL,MWI,2005.0,1,0,1
MWI,LUX,2007.0,1,0,1
BEL,LBR,2013.0,1,0,1
SYC,,2011.0,1,0,1
BLR,LTU,2023.0,2,0,2
TTO,FRA,2009.0,1,0,1
ITA,NPL,2009.0,1,0,1
ECU,DEU,2007.0,2,0,2
BRA,SVN,2006.0,1,0,1
ITA,CIV,2010.0,1,0,1
DNK,LKA,2014.0,1,0,1
DEU,MCO,2006.0,2,0,2
GEO,NLD,2020.0,1,0,1
KEN,MEX,2008.0,1,0,1
BHR,HUN,2006.0,1,0,1
NER,JPN,2011.0,1,0,1
NLD,ARM,2012.0,1,0,1
TJK,NGA,2013.0,1,0,1
JPN,ECU,2009.0,1,0,1
LBY,FRA,2004.0,1,0,1
NFK,NOR,2010.0,1,0,1
ARM,CHN,2019.0,1,0,1
LBN,JPN,2007.0,1,0,1
FIN,IRN,2009.0,2,0,2
VUT,USA,2022.0,1,0,1
SAU,PER,2005.0,3,0,3
CAN,BRN,2008.0,1,0,1
SAU,BGD,2008.0,2,0,2
FRA,ETH,2017.0,3,0,3
IND,GEO,2020.0,1,0,1
BRA,LUX,2019.0,1,0,1
IRL,KEN,2021.0,1,0,1
SLE,USA,2002.0,3,0,3
TTO,RUS,2012.0,1,0,1
ROU,LBN,2022.0,2,0,2
CRI,RUS,2017.0,3,0,3
EGY,SGP,2023.0,1,0,1
PAK,PRI,2010.0,1,0,1
NER,,2009.0,8,0,8
GHA,ZWE,1998.0,1,0,1
SWE,KEN,1998.0,1,0,1
KWT,PER,2000.0,1,0,1
PAN,SWE,2003.0,1,0,1
USA,ATG,2015.0,2,0,2
ITA,VNM,1998.0,2,0,2
ECU,COL,1999.0,1,0,1
ISL,MWI,2022.0,1,0,1
LBN,BHR,2004.0,1,0,1
VNM,LAO,2007.0,1,0,1
MWI,IRL,1999.0,1,0,1
DNK,KNA,2014.0,1,0,1
ETH,FIN,2008.0,1,0,1
DOM,ARG,2003.0,1,0,1
ALB,DEU,1999.0,2,0,2
USA,SUR,2004.0,2,0,2
NLD,LIE,2001.0,1,0,1
GBR,LIE,2008.0,1,0,1
,SLE,1998.0,3,0,3
TUR,ISL,2008.0,1,0,1
MYS,CHL,2003.0,1,0,1
BEL,ARG,1997.0,3,0,3
VEN,CZE,2020.0,2,0,2
AUS,MAC,2001.0,2,0,2
DEU,BFA,2003.0,1,0,1
SYR,UZB,2012.0,1,0,1
AUT,LUX,2005.0,1,0,1
ZAF,GAB,2021.0,1,0,1
SUR,NLD,2006.0,1,0,1
PHL,BRN,2016.0,1,0,1
REU,,2009.0,3,0,3
BEL,UGA,1997.0,1,0,1
CRI,POL,2006.0,1,0,1
FRA,KHM,1997.0,1,0,1
SLV,ESP,2010.0,3,0,3
BOL,TZA,2017.0,1,0,1
PER,AUS,2011.0,1,0,1
GIN,MLI,2008.0,1,0,1
NLD,BOL,2001.0,1,0,1
ITA,UGA,2010.0,1,0,1
CHE,KWT,2018.0,1,0,1
URY,DOM,2011.0,1,0,1
KEN,BWA,2018.0,1,0,1
LVA,KWT,2017.0,1,0,1
ITA,QAT,2013.0,4,0,4
CYP,SWE,2022.0,3,0,3
CZE,PER,2014.0,1,0,1
CIV,BRA,2010.0,1,0,1
PRY,CRI,2017.0,1,0,1
FRA,BHS,2004.0,1,0,1
ETH,DNK,2015.0,2,0,2
ISL,CHN,2014.0,2,0,2
BTN,NPL,2020.0,2,0,2
BIH,MNE,2008.0,2,0,2
CHE,BRN,2017.0,1,0,1
TCD,COM,1997.0,1,0,1
ROU,JPN,2010.0,3,0,3
MYS,PSE,2008.0,1,0,1
AGO,BRA,2007.0,1,0,1
ESP,LVA,2021.0,2,0,2
ZMB,KEN,2001.0,2,0,2
BFA,MLI,2006.0,1,0,1
COG,ETH,2017.0,1,0,1
RUS,HKG,1998.0,1,0,1
QAT,YEM,2014.0,1,0,1
BFA,NLD,2011.0,2,0,2
HKG,ARE,2010.0,1,0,1
QAT,PSE,2023.0,2,0,2
CCK,,2024.0,5,0,5
NGA,CZE,2013.0,1,0,1
FRO,GBR,2016.0,1,0,1
KAZ,PRT,2022.0,1,0,1
MYS,KEN,2023.0,1,0,1
VAT,,2020.0,3,0,3
DJI,,2011.0,1,0,1
BEL,GAB,2017.0,2,0,2
COG,KHM,2023.0,1,0,1
ZWE,MWI,2023.0,1,0,1
PRT,MKD,2021.0,2,0,2
CUB,GNB,2018.0,2,0,2
ARG,SVN,2022.0,2,0,2
RWA,ETH,2019.0,2,0,2
NLD,MMR,2019.0,1,0,1
ZAF,MYS,2017.0,4,0,4
PHL,KEN,2018.0,1,0,1
KAZ,ITA,2016.0,1,0,1
BGR,GBR,2023.0,2,0,2
HKG,CZE,2022.0,2,0,2
FRA,LVA,2021.0,2,0,2
MMR,IND,2022.0,2,0,2
NGA,COL,2021.0,1,0,1
HND,CHE,1998.0,1,0,1
NZL,SVN,2013.0,2,0,2
PRT,CRI,2012.0,1,0,1
SWE,PAN,2006.0,1,0,1
NGA,NPL,2007.0,1,0,1
ATG,JAM,2011.0,1,0,1
PHL,VEN,2015.0,1,0,1
PAK,PHL,2021.0,1,0,1
MYS,ARE,2002.0,2,0,2
FIN,KOR,1998.0,1,0,1
CUB,VEN,2012.0,1,0,1
BLR,CHE,2019.0,3,0,3
TZA,NPL,2019.0,1,0,1
BGD,PRT,2021.0,2,0,2
USA,LIE,2020.0,1,0,1
USA,SYC,2013.0,3,0,3
THA,LKA,2016.0,1,0,1
NPL,ETH,2017.0,1,0,1
RUS,DZA,2009.0,1,0,1
CZE,ROU,2013.0,1,0,1
SWE,PER,2015.0,1,0,1
POL,LBN,2009.0,1,0,1
NOR,NIC,2012.0,1,0,1
GMB,SAU,2014.0,1,0,1
TUN,KOR,2020.0,2,0,2
CAN,MLT,2013.0,1,0,1
URY,BEL,2017.0,1,0,1
JPN,ETH,2014.0,2,0,2
,MCO,2009.0,9,0,9
SDN,BRA,2001.0,1,0,1
BGD,CHE,2000.0,2,0,2
,BDI,2001.0,3,0,3
FIN,PRI,2016.0,1,0,1
CHL,URY,2010.0,4,0,4
FSM,,2012.0,2,0,2
IRQ,ESP,2016.0,1,0,1
HKG,NOR,2008.0,1,0,1
DNK,SEN,2017.0,1,0,1
ARG,ZAF,2007.0,2,0,2
TJK,,2011.0,4,0,4
POL,QAT,2010.0,1,0,1
FRA,GUY,2001.0,2,0,2
SWZ,TUN,2014.0,1,0,1
YEM,OMN,2003.0,1,0,1
UZB,KOR,2011.0,2,0,2
MCO,POL,2019.0,1,0,1
BLZ,,2010.0,1,0,1
COM,ESP,2012.0,1,0,1
IDN,GIN,2011.0,1,0,1
CUB,QAT,1998.0,1,0,1
,TUV,2016.0,1,0,1
LAO,HKG,2007.0,1,0,1
LSO,ITA,2003.0,2,0,2
LBN,ETH,2016.0,1,0,1
ETH,LBN,2018.0,1,0,1
THA,GRC,2011.0,2,0,2
GBR,GIB,2010.0,1,0,1
GUY,USA,1998.0,3,0,3
DEU,TTO,2010.0,1,0,1
SAU,URY,2020.0,1,0,1
SRB,MEX,2007.0,2,0,2
CUB,PRT,2009.0,1,0,1
MAC,MAR,2002.0,1,0,1
GMB,USA,2004.0,3,0,3
MYS,TUN,2016.0,1,0,1
MLI,GIN,2019.0,1,0,1
BEL,SWZ,2002.0,1,0,1
MNG,CHN,2008.0,1,0,1
TWN,SDN,2010.0,1,0,1
LBY,SDN,2016.0,1,0,1
URY,AUS,2003.0,4,0,4
BFA,ZAF,2011.0,3,0,3
AFG,ESP,2018.0,1,0,1
MEX,PAN,1998.0,1,0,1
PHL,GRC,2002.0,3,0,3
USA,MSR,2011.0,1,0,1
NLD,SLE,2015.0,1,0,1
SVK,ISR,2002.0,1,0,1
USA,UZB,2021.0,1,0,1
BRA,SEN,2001.0,1,0,1
,BDI,1996.0,2,0,2
BEL,PAN,2005.0,1,0,1
JPN,BEN,2005.0,1,0,1
EGY,IND,2004.0,1,0,1
HUN,LTU,2005.0,1,0,1
SEN,CAN,1997.0,1,0,1
BGD,OMN,2013.0,2,0,2
,BLZ,1995.0,1,0,1
MAC,,2006.0,5,0,5
ASM,AUS,1997.0,1,0,1
NLD,OMN,2005.0,2,0,2
MEX,CHN,1997.0,1,0,1
PER,MLI,2019.0,1,0,1
KOR,ZAF,2007.0,2,0,2
SYC,,2021.0,3,0,3
IRL,MWI,2013.0,1,0,1
THA,ZAF,1999.0,1,0,1
ISR,THA,1998.0,1,0,1
SEN,NLD,2007.0,1,0,1
USA,MHL,1999.0,1,0,1
DEU,BRB,2003.0,1,0,1
MKD,CHE,2010.0,2,0,2
TUN,ETH,2019.0,1,0,1
LTU,HKG,2022.0,1,0,1
GIB,USA,2018.0,1,0,1
BHR,EGY,2012.0,2,0,2
BRA,MHL,2020.0,1,0,1
ESP,LTU,2004.0,1,0,1
NOR,ISR,2005.0,2,0,2
FJI,KHM,2015.0,1,0,1
HUN,ETH,2015.0,2,0,2
NGA,AUS,2011.0,7,0,7
SRB,BRA,2014.0,1,0,1
PER,SGP,2020.0,1,0,1
BRA,HRV,2020.0,2,0,2
MLT,ITA,2009.0,1,0,1
KHM,USA,1998.0,1,0,1
ETH,BWA,2017.0,1,0,1
SWZ,BRA,2013.0,1,0,1
MAR,IRN,2010.0,1,0,1
GTM,DEU,2007.0,1,0,1
,TKM,2004.0,1,0,1
MLT,USA,1998.0,1,0,1
BWA,SWZ,2009.0,2,0,2
MAR,SAU,2010.0,1,0,1
AUT,IDN,2008.0,2,0,2
ROU,ARE,2013.0,2,0,2
GRC,JOR,2014.0,1,0,1
EGY,DZA,2010.0,1,0,1
PRT,PER,2014.0,1,0,1
GBR,BIH,2016.0,2,0,2
USA,MNE,2015.0,4,0,4
KAZ,IND,2006.0,1,0,1
KEN,SSD,2017.0,1,0,1
HKG,PHL,1998.0,2,0,2
JPN,OMN,2021.0,2,0,2
ISR,OMN,2015.0,2,0,2
ISR,NGA,2013.0,1,0,1
URY,AUT,2002.0,1,0,1
HKG,BRA,1999.0,2,0,2
SGP,LUX,2014.0,2,0,2
PRT,ISR,1998.0,1,0,1
TUN,HKG,2020.0,1,0,1
TZA,IDN,2016.0,1,0,1
MAR,TUR,2013.0,1,0,1
KNA,NZL,2018.0,1,0,1
MEX,ATG,2018.0,1,0,1
COD,DEU,2015.0,1,0,1
SDN,NER,2017.0,1,0,1
IND,EST,2012.0,1,0,1
AUS,VEN,2003.0,1,0,1
DNK,MAC,2016.0,1,0,1
COL,SGP,2012.0,1,0,1
CUB,PAN,2011.0,2,0,2
ESP,ALB,2020.0,1,0,1
BRN,USA,2021.0,3,0,3
KOR,CMR,2018.0,1,0,1
PAK,ECU,2018.0,1,0,1
GBR,VUT,2019.0,1,0,1
SLV,HND,2014.0,2,0,2
IRL,PAK,2008.0,1,0,1
SWE,MLT,2020.0,1,0,1
PNG,AUT,2018.0,1,0,1
ARG,FIN,2004.0,2,0,2
IRL,LTU,2021.0,1,0,1
BGR,SWE,2018.0,1,0,1
MMR,CAN,2017.0,1,0,1
,STP,2017.0,2,0,2
SDN,SAU,2024.0,1,0,1
VNM,IRL,2012.0,2,0,2
KHM,BFA,2018.0,1,0,1
ZAF,URY,2017.0,1,0,1
ZMB,BEL,2021.0,1,0,1
TTO,BRB,2020.0,1,0,1
USA,AGO,2020.0,2,0,2
AUT,BFA,2023.0,1,0,1
POL,TWN,2006.0,2,0,2
KAZ,IRQ,2012.0,1,0,1
SEN,GIN,2017.0,2,0,2
FJI,BRA,2003.0,1,0,1
TWN,PSE,2019.0,1,0,1
CRI,GTM,2005.0,1,0,1
KWT,MKD,1998.0,2,0,2
PRT,AUS,1998.0,1,0,1
SEN,GIN,2016.0,2,0,2
FIN,CHL,2000.0,1,0,1
GEO,NOR,2023.0,1,0,1
BFA,DEU,2009.0,1,0,1
LVA,RUS,2005.0,2,0,2
IDN,KEN,2001.0,1,0,1
GBR,TUN,1998.0,1,0,1
UGA,DJI,2010.0,1,0,1
MRT,USA,2003.0,1,0,1
EGY,ISR,2003.0,1,0,1
FRA,ZMB,2017.0,1,0,1
UKR,NOR,2003.0,1,0,1
PHL,KOR,2001.0,3,0,3
NOR,ETH,1998.0,1,0,1
CRI,NIC,2009.0,1,0,1
PHL,HKG,2009.0,2,0,2
BEL,VNM,1997.0,1,0,1
GRC,MCO,2016.0,1,0,1
SWE,ECU,2008.0,1,0,1
AUT,VNM,2004.0,1,0,1
DNK,ARG,2006.0,1,0,1
GRC,ARE,1999.0,1,0,1
NLD,ARE,2002.0,1,0,1
MEX,HND,2015.0,1,0,1
SRB,KWT,2014.0,3,0,3
SDN,BWA,1999.0,1,0,1
NOR,BLR,2006.0,1,0,1
BRB,ITA,2006.0,1,0,1
POL,GEO,2004.0,1,0,1
COL,NLD,1999.0,2,0,2
GUM,NCL,2008.0,1,0,1
IRQ,CHN,2004.0,1,0,1
ISR,FIN,2006.0,1,0,1
VEN,CHL,2002.0,1,0,1
MWI,SLE,2020.0,1,0,1
SEN,GAB,2007.0,1,0,1
LVA,IRL,2006.0,1,0,1
RUS,ECU,2015.0,1,0,1
,AGO,2001.0,4,0,4
FRA,LBY,2002.0,1,0,1
USA,AZE,2000.0,1,0,1
ETH,ITA,2004.0,1,0,1
FRA,PNG,1999.0,1,0,1
BOL,PRT,2001.0,1,0,1
NLD,ARM,2005.0,1,0,1
CZE,SVN,2006.0,3,0,3
ZAF,PRT,2000.0,2,0,2
SAU,AZE,2012.0,1,0,1
IRL,TTO,2003.0,1,0,1
VNM,TTO,2017.0,1,0,1
MDA,POL,2001.0,1,0,1
LUX,NZL,2016.0,1,0,1
SWE,NCL,2020.0,1,0,1
CAN,CAF,2016.0,1,0,1
DEU,AUS,2024.0,2,0,2
SHN,GBR,2010.0,1,0,1
DEU,PRK,2013.0,1,0,1
TZA,THA,2010.0,1,0,1
BEN,GAB,2018.0,2,0,2
ZAF,SLE,2010.0,1,0,1
BWA,ARG,2014.0,1,0,1
GIN,DEU,2021.0,1,0,1
LBN,NGA,2021.0,1,0,1
SLV,JPN,2013.0,1,0,1
COL,JOR,2016.0,1,0,1
,GUF,1999.0,4,0,4
JPN,BWA,2011.0,1,0,1
ETH,COG,2021.0,3,0,3
BWA,SWE,2006.0,1,0,1
VGB,GBR,2018.0,1,0,1
LVA,DNK,2013.0,2,0,2
BGD,KEN,2007.0,1,0,1
UGA,DNK,2017.0,2,0,2
BRB,GBR,2005.0,2,0,2
LBN,TUN,2001.0,1,0,1
AFG,PAK,2017.0,1,0,1
FLK,NZL,2018.0,1,0,1
BEL,CIV,2016.0,3,0,3
BGR,JPN,2019.0,1,0,1
BEL,SYC,2011.0,1,0,1
THA,KHM,2012.0,2,0,2
BEL,GHA,2022.0,3,0,3
TUR,IND,2008.0,3,0,3
SDN,JOR,2009.0,1,0,1
BRA,DOM,2013.0,2,0,2
NPL,PAK,2023.0,1,0,1
VEN,DOM,2017.0,1,0,1
ISR,ISL,2023.0,1,0,1
BEL,HKG,2004.0,1,0,1
NGA,SSD,2019.0,1,0,1
EGY,NZL,2015.0,1,0,1
PSE,CHE,2017.0,1,0,1
CAN,ATG,2021.0,1,0,1
CIV,NLD,2016.0,1,0,1
FIN,SGP,2014.0,1,0,1
CUB,NLD,2020.0,3,0,3
KAZ,HUN,2016.0,1,0,1
HTI,,2007.0,3,0,3
NGA,COD,2021.0,1,0,1
BLR,FIN,2022.0,1,0,1
MWI,CMR,2020.0,1,0,1
QAT,FIN,2022.0,1,0,1
HKG,POL,2021.0,1,0,1
BTN,USA,2020.0,3,0,3
SLE,LBR,2018.0,1,0,1
LBR,SLE,2019.0,2,0,2
SYR,ARE,2020.0,1,0,1
CMR,SLE,2021.0,1,0,1
MMR,FRA,2021.0,1,0,1
CIV,MAR,2022.0,1,0,1
COG,CMR,2023.0,1,0,1
,JOR,2021.0,4,0,4
TCD,TJK,2023.0,1,0,1
GUY,ZMB,2021.0,1,0,1
HND,NIC,2018.0,2,0,2
QAT,TUR,2001.0,1,0,1
IRL,GRD,2020.0,1,0,1
SVN,CZE,2024.0,1,0,1
MAC,MYS,2008.0,1,0,1
BWA,KEN,2008.0,2,0,2
RUS,CHL,2008.0,2,0,2
MYS,ARE,2005.0,1,0,1
NOR,MLI,2008.0,1,0,1
BRA,KEN,2008.0,1,0,1
GNQ,PRT,2007.0,1,0,1
SWE,MCO,2015.0,1,0,1
ETH,DNK,2001.0,1,0,1
ZMB,NOR,2009.0,1,0,1
KHM,VUT,2011.0,1,0,1
KAZ,EGY,2004.0,1,0,1
DNK,JOR,2008.0,1,0,1
CYM,NOR,2008.0,1,0,1
UKR,EST,2013.0,2,0,2
CZE,SRB,2002.0,3,0,3
TZA,COG,2013.0,1,0,1
ZAF,DZA,2018.0,2,0,2
HUN,BGR,2008.0,2,0,2
TWN,ARM,2005.0,1,0,1
PAN,MEX,2006.0,1,0,1
TUN,OMN,2005.0,1,0,1
NPL,VCT,2022.0,1,0,1
THA,SVN,2022.0,1,0,1
,STP,2018.0,3,0,3
TTO,VEN,2023.0,1,0,1
BOL,NLD,2022.0,1,0,1
UKR,NZL,2019.0,1,0,1
QAT,BEL,2023.0,2,0,2
HTI,TTO,2009.0,1,0,1
ZAF,PRI,2015.0,1,0,1
SRB,IRL,2002.0,1,0,1
MKD,ITA,2004.0,1,0,1
SVN,BRA,2008.0,1,0,1
AGO,USA,2004.0,2,0,2
SYC,,2009.0,2,0,2
GMB,,1999.0,1,0,1
SVN,SRB,1997.0,3,0,3
ECU,,1999.0,2,0,2
MLI,GLP,1997.0,1,0,1
NZL,PRT,2004.0,3,0,3
POL,VEN,2015.0,1,0,1
HKG,NZL,1997.0,2,0,2
ESP,CYP,2003.0,1,0,1
ESP,GAB,2004.0,1,0,1
NLD,ZMB,1999.0,1,0,1
SGP,BRN,1998.0,1,0,1
MCO,GBR,2012.0,1,0,1
KEN,THA,2000.0,1,0,1
HKG,EGY,1998.0,1,0,1
FRA,LAO,2001.0,1,0,1
BLR,TWN,2010.0,1,0,1
ARG,FIN,2008.0,1,0,1
EGY,PRT,2008.0,1,0,1
TUN,MTQ,2011.0,1,0,1
NGA,SDN,2012.0,2,0,2
GRC,HKG,2008.0,1,0,1
ZWE,AUS,2009.0,3,0,3
MKD,SVN,2013.0,1,0,1
CUB,AGO,2014.0,1,0,1
NOR,LVA,2020.0,1,0,1
PHL,MAC,2013.0,1,0,1
TUR,CIV,2018.0,1,0,1
ZMB,SEN,2012.0,1,0,1
RUS,CHL,2014.0,1,0,1
MDG,GBR,2021.0,4,4,0
PHL,DEU,2001.0,3,1,2
BGD,AUS,2005.0,3,2,1
NOR,CHN,2005.0,7,4,3
GBR,JAM,2011.0,4,4,0
POL,JPN,2011.0,3,6,-3
BRA,VEN,2020.0,6,14,-8
CAN,BWA,2011.0,2,1,1
ALB,ESP,2017.0,1,2,-1
CHN,LKA,2022.0,6,7,-1
SGP,ESP,2009.0,2,3,-1
USA,PRY,2013.0,1,1,0
MEX,MAR,2011.0,4,1,3
CHE,TWN,2016.0,5,4,1
NOR,CHL,2020.0,2,4,-2
POL,KOR,2017.0,3,1,2
THA,DNK,2020.0,2,2,0
PAK,GBR,2001.0,10,23,-13
KOR,ECU,2021.0,2,3,-1
KOR,MNG,2019.0,11,7,4
JAM,BRB,2008.0,1,1,0
SGP,MAC,2018.0,1,2,-1
PAN,BRA,2011.0,1,2,-1
NLD,IRL,2005.0,8,12,-4
SWE,BLR,2002.0,1,2,-1
TUR,ESP,2008.0,7,2,5
ZAF,RUS,2004.0,2,6,-4
MYS,FRA,2007.0,3,8,-5
ISR,NLD,2003.0,8,4,4
BRB,JAM,2008.0,1,1,0
CHE,DNK,1998.0,6,10,-4
LBY,DEU,2007.0,1,1,0
SWE,AUT,2003.0,7,7,0
MEX,AUS,2008.0,9,4,5
CAN,ECU,2016.0,3,3,0
CAN,UKR,2008.0,4,4,0
PHL,IND,2006.0,2,2,0
FRA,CUB,2000.0,4,2,2
IRQ,POL,2022.0,2,1,1
GBR,BWA,2011.0,2,6,-4
RWA,ZAF,2016.0,5,3,2
GBR,PAN,2011.0,1,1,0
KOR,POL,2013.0,3,1,2
BEL,BEN,2011.0,5,2,3
SVN,DNK,2019.0,3,5,-2
PAN,ARG,2009.0,1,1,0
TUR,SWE,2012.0,12,10,2
LTU,FRA,2009.0,3,4,-1
DNK,QAT,2023.0,1,1,0
MMR,JPN,2014.0,1,4,-3
CHE,URY,2016.0,2,1,1
IRL,IND,2003.0,3,6,-3
PER,CHL,2011.0,4,5,-1
PHL,DEU,2014.0,4,5,-1
GBR,VEN,2021.0,1,4,-3
HTI,USA,2015.0,5,13,-8
IND,SYR,2017.0,1,1,0
CMR,GIN,2017.0,1,1,0
FRA,EST,1999.0,4,3,1
IND,AUT,2004.0,4,3,1
DNK,FIN,2015.0,10,20,-10
BEL,TUR,2008.0,5,2,3
KOR,UZB,2003.0,1,3,-2
CHE,IRN,1998.0,2,1,1
AZE,TUR,2005.0,5,4,1
UKR,CHN,2023.0,11,12,-1
ESP,ETH,2016.0,2,1,1
IRL,BGD,2007.0,1,2,-1
BEL,NOR,2001.0,4,2,2
PRT,POL,2004.0,1,2,-1
KEN,VNM,2018.0,2,1,1
JPN,MNG,2012.0,9,2,7
CAN,KEN,2018.0,4,9,-5
CZE,DNK,2012.0,5,3,2
TUR,POL,2013.0,2,1,1
YEM,SAU,2014.0,7,1,6
BEL,ECU,2012.0,2,1,1
BEL,KEN,2011.0,2,1,1
DNK,ISL,2019.0,3,5,-2
BRA,GRC,2017.0,2,2,0
IND,IRQ,2014.0,7,4,3
ESP,MDV,2019.0,1,1,0
JOR,AUS,2016.0,6,9,-3
JAM,BRB,2015.0,2,4,-2
LUX,DNK,2019.0,1,1,0
ESP,TWN,2019.0,5,8,-3
ZAF,LKA,2011.0,2,2,0
ARG,SWE,1998.0,2,3,-1
GTM,USA,2006.0,5,2,3
ETH,FRA,2008.0,2,2,0
BEL,BLR,2019.0,1,3,-2
JPN,GHA,2012.0,1,1,0
CHN,IRN,2007.0,3,2,1
BGD,THA,2005.0,4,2,2
NZL,CHE,1998.0,2,7,-5
SGP,KOR,2003.0,3,6,-3
CUB,PRT,2008.0,2,1,1
CAN,TWN,2004.0,10,14,-4
KGZ,RUS,1999.0,1,1,0
ARM,AUS,2016.0,1,1,0
SWE,NGA,2019.0,2,4,-2
IRN,AUT,2005.0,2,4,-2
MDA,FRA,2015.0,2,1,1
RUS,EGY,2007.0,3,3,0
RUS,ISR,2010.0,8,7,1
JPN,MNG,2005.0,2,3,-1
CZE,FIN,2016.0,3,8,-5
TUR,TWN,2019.0,5,1,4
GBR,ETH,2009.0,7,5,2
JPN,NOR,1997.0,3,3,0
EGY,SWE,2002.0,1,1,0
UKR,CAN,2009.0,7,2,5
POL,KOR,2022.0,7,3,4
IRQ,POL,2017.0,2,3,-1
DNK,BRA,2003.0,3,5,-2
ARE,IRQ,2023.0,2,1,1
MAR,CHE,1999.0,2,1,1
GRC,CHE,2005.0,8,19,-11
EGY,LBN,2009.0,2,1,1
GMB,GBR,1999.0,3,3,0
VNM,KOR,2004.0,1,3,-2
USA,GRL,2008.0,1,1,0
USA,LUX,1998.0,1,1,0
SAU,SWE,1998.0,2,2,0
HKG,NLD,2000.0,3,3,0
CMR,USA,2001.0,6,10,-4
NLD,THA,2002.0,3,3,0
NLD,IDN,1998.0,4,2,2
CHN,CZE,1999.0,1,2,-1
USA,BRN,2018.0,1,1,0
ARE,TUN,2019.0,2,6,-4
REU,FRA,1999.0,2,4,-2
CAN,HUN,2003.0,3,9,-6
ROU,JPN,2003.0,8,12,-4
TZA,KEN,2023.0,4,5,-1
RUS,DNK,2021.0,10,7,3
UKR,ESP,2021.0,1,2,-1
COL,NOR,2008.0,2,1,1
DEU,DZA,2021.0,5,3,2
ZAF,TUN,2020.0,2,3,-1
TZA,CAN,2010.0,3,1,2
BHR,IND,2015.0,2,2,0
NLD,POL,2009.0,17,17,0
DNK,GNB,2008.0,3,1,2
GBR,PRI,1999.0,2,1,1
JOR,ITA,2003.0,2,2,0
USA,BHS,2014.0,3,2,1
JOR,HKG,2018.0,4,2,2
JOR,KWT,2015.0,4,1,3
IND,KWT,2016.0,3,3,0
UKR,BEL,1999.0,3,1,2
VNM,IDN,2020.0,3,4,-1
KOR,BLR,1998.0,2,1,1
IRL,ESP,2005.0,4,9,-5
UKR,JPN,2008.0,4,11,-7
FIN,UKR,2014.0,2,1,1
BEL,GHA,2020.0,2,2,0
ECU,AUS,2005.0,2,1,1
NLD,CRI,2019.0,1,2,-1
IDN,AUT,2016.0,2,8,-6
POL,THA,2022.0,2,1,1
LAO,USA,2021.0,1,1,0
CHE,LTU,2020.0,3,3,0
URY,VEN,2020.0,2,7,-5
NZL,ITA,2018.0,5,5,0
AUT,IRN,2022.0,8,24,-16
SDN,IND,2010.0,2,1,1
MAR,POL,2022.0,1,2,-1
UKR,AUS,2011.0,2,2,0
THA,TWN,2000.0,1,1,0
ZAF,ESP,2019.0,7,10,-3
CAN,CMR,2013.0,2,3,-1
GRC,DNK,2005.0,6,2,4
NLD,SVN,2006.0,2,3,-1
LTU,LVA,2001.0,2,1,1
LBN,SWE,2016.0,1,1,0
ESP,PAN,2015.0,2,3,-1
QAT,CAN,2007.0,1,4,-3
PAK,SAU,2024.0,3,6,-3
SWE,HKG,2012.0,3,3,0
ZWE,ETH,2020.0,2,1,1
SMR,ITA,2023.0,5,1,4
COL,FIN,2016.0,1,2,-1
MEX,TUR,2009.0,3,2,1
CHN,CHL,2015.0,6,8,-2
DZA,ESP,2004.0,1,3,-2
MAR,EGY,2011.0,2,1,1
UKR,BRA,1998.0,4,1,3
KEN,NGA,1999.0,1,1,0
ESP,ZAF,2013.0,10,4,6
JPN,CMR,2009.0,1,4,-3
GBR,LTU,2008.0,3,7,-4
THA,KEN,2013.0,1,1,0
KHM,SWE,2011.0,2,1,1
IRN,TWN,2005.0,1,2,-1
ITA,HUN,2000.0,1,10,-9
RUS,ARM,2010.0,2,4,-2
BIH,TUR,2022.0,1,2,-1
JOR,IRQ,2013.0,2,1,1
THA,KOR,1999.0,1,1,0
ARG,JPN,2021.0,2,2,0
CHE,COG,2018.0,2,3,-1
CAN,DZA,2008.0,3,4,-1
UGA,DEU,1997.0,2,1,1
CAN,TTO,2009.0,3,2,1
USA,CIV,2010.0,1,5,-4
SWE,ROU,1997.0,1,1,0
BEL,SGP,2006.0,3,2,1
BEL,HKG,1999.0,1,3,-2
AUS,ARG,2009.0,1,5,-4
ZAF,ZMB,2006.0,1,1,0
ZAF,ZMB,2010.0,1,2,-1
LTU,CHE,2008.0,2,2,0
MOZ,ESP,2011.0,2,3,-1
NGA,BRA,2013.0,2,1,1
AUT,ZAF,2011.0,2,1,1
VNM,LAO,2015.0,3,1,2
IRN,DEU,1998.0,1,5,-4
ZAF,NAM,2008.0,2,1,1
PAK,KWT,2022.0,4,1,3
DNK,SRB,2008.0,1,3,-2
ROU,RUS,2010.0,2,2,0
DNK,SRB,2001.0,2,2,0
BHR,CAN,2023.0,2,1,1
ZAF,CHL,2005.0,1,3,-2
CHE,TWN,2001.0,3,1,2
FIN,GRC,2009.0,2,2,0
LKA,DNK,2012.0,1,1,0
JAM,TTO,2006.0,1,2,-1
AUS,ZWE,2023.0,1,1,0
PAK,IRL,2003.0,1,2,-1
HUN,DNK,2014.0,4,1,3
URY,FRA,2013.0,5,2,3
GHA,UGA,2022.0,1,3,-2
JPN,SDN,2003.0,2,1,1
FIN,KOR,2008.0,2,1,1
BEL,BDI,2012.0,1,1,0
SRB,SWE,2022.0,3,5,-2
BGD,ITA,2014.0,4,3,1
NLD,LBN,2014.0,1,2,-1
BRA,MYS,2014.0,2,2,0
SVK,ESP,2012.0,2,2,0
GBR,DZA,2009.0,1,3,-2
OMN,CHN,2016.0,1,2,-1
POL,SVN,2012.0,3,4,-1
SLE,NGA,2017.0,1,2,-1
IND,MAC,2018.0,3,1,2
ARE,MYS,2015.0,1,15,-14
CHE,UKR,2017.0,2,5,-3
BRA,PRY,2016.0,4,1,3
IRN,TWN,2012.0,2,1,1
BRA,GTM,2016.0,1,1,0
FRA,PNG,2001.0,2,3,-1
BFA,CHE,2022.0,2,1,1
PRT,HRV,2010.0,1,2,-1
HKG,SWE,2002.0,1,1,0
SEN,BEL,2016.0,2,2,0
CMR,NOR,2018.0,2,1,1
VNM,NPL,2019.0,2,1,1
MYS,BEL,2018.0,5,1,4
BTN,CAN,2019.0,1,1,0
SGP,LKA,2020.0,1,2,-1
ITA,LVA,2019.0,2,1,1
PRT,AGO,2018.0,3,3,0
TUR,BGR,2021.0,3,1,2
QAT,IRN,2019.0,1,3,-2
MAC,NLD,2018.0,2,1,1
GHA,BEN,2019.0,2,2,0
DEU,IND,2024.0,1,1,0
POL,ETH,2023.0,2,2,0
CZE,MAR,2021.0,1,1,0
NLD,NGA,2023.0,1,4,-3
NOR,HKG,2021.0,2,2,0
NOR,KAZ,2021.0,4,1,3
IRQ,PAK,2023.0,2,3,-1
PAK,HUN,2011.0,1,2,-1
CZE,IRN,2021.0,1,23,-22
ARG,PRI,2013.0,2,4,-2
BTN,IND,2019.0,1,4,-3
BIH,USA,2013.0,1,5,-4
ISR,CZE,2012.0,1,1,0
KEN,RWA,2020.0,5,5,0
BOL,SWE,2016.0,2,2,0
AGO,BRA,2015.0,2,1,1
ESP,ALB,2014.0,2,1,1
KWT,PAK,2002.0,2,1,1
RUS,CYP,2020.0,1,1,0
ETH,MYS,2023.0,1,1,0
THA,IRL,2022.0,2,1,1
CAN,BGR,2023.0,1,1,0
PNG,CHE,2010.0,1,2,-1
IDN,THA,2012.0,1,7,-6
USA,LVA,2008.0,1,2,-1
CMR,CAN,2006.0,3,1,2
ZMB,GBR,2005.0,1,1,0
PRY,MEX,2019.0,2,1,1
TUR,FIN,2018.0,4,4,0
MUS,ZAF,2019.0,1,2,-1
CHL,VEN,2007.0,2,5,-3
SVK,FRA,2009.0,3,8,-5
NGA,NLD,1998.0,1,1,0
GRC,ISR,2013.0,3,2,1
NLD,LKA,2009.0,1,2,-1
SVK,ESP,2002.0,1,7,-6
SWE,GHA,2005.0,1,2,-1
SVK,NOR,2006.0,1,1,0
NLD,LTU,2002.0,1,1,0
NZL,OMN,2004.0,1,1,0
AUS,BGR,2010.0,1,2,-1
NGA,MLI,1998.0,1,1,0
AUS,KEN,2000.0,2,2,0
SVN,FRA,2004.0,1,3,-2
PAK,CAN,2003.0,4,4,0
CMR,BEL,2000.0,2,1,1
PHL,THA,2005.0,1,1,0
BEL,COL,2000.0,1,1,0
QAT,ARE,2007.0,1,3,-2
ZAF,LKA,2007.0,1,1,0
MAC,GBR,2011.0,1,3,-2
MOZ,USA,2003.0,1,1,0
CYP,SWE,2019.0,1,3,-2
FRA,MKD,2009.0,1,2,-1
AUS,VEN,2012.0,1,2,-1
CHN,MNG,2011.0,1,1,0
COG,KEN,2022.0,1,2,-1
CMR,NGA,2020.0,1,3,-2
BRA,CUB,2005.0,1,3,-2
ITA,ZAF,2010.0,5,4,1
ZAF,ITA,2013.0,7,12,-5
CRI,PAN,2016.0,1,1,0
SRB,IND,2008.0,1,1,0
QAT,JOR,2011.0,2,3,-1
DEU,SYR,2011.0,1,3,-2
GRD,TTO,2020.0,1,2,-1
BEL,MAC,2018.0,1,1,0
MNG,USA,2021.0,1,7,-6
ARE,IRQ,2012.0,1,1,0
MAR,ARE,2019.0,1,3,-2
NAM,NLD,2013.0,2,3,-1
NLD,NAM,2014.0,1,1,0
NOR,BRA,2019.0,3,8,-5
DNK,TUR,2018.0,3,14,-11
LTU,FIN,2010.0,1,3,-2
SVN,PRT,2015.0,2,1,1
BEL,EST,2017.0,1,1,0
ALB,GBR,2013.0,1,3,-2
AUT,DZA,2018.0,3,1,2
LKA,CAN,2014.0,3,5,-2
LBN,GBR,2013.0,3,9,-6
UZB,TUR,2023.0,2,1,1
UGA,MYS,2014.0,1,1,0
BIH,NOR,2015.0,1,2,-1
FRA,CYP,2019.0,3,1,2
PHL,TWN,2015.0,7,4,3
DNK,GNB,2018.0,1,2,-1
DNK,LUX,2014.0,1,2,-1
ITA,NPL,2022.0,3,1,2
FRA,EST,2019.0,1,1,0
CZE,TUN,2020.0,1,3,-2
CHE,BGR,2016.0,3,4,-1
MUS,USA,2014.0,1,1,0
ISR,HUN,2017.0,3,1,2
TTO,JAM,2020.0,2,4,-2
IDN,NLD,2002.0,4,4,0
CYP,GHA,2021.0,1,1,0
SYR,GBR,2020.0,2,4,-2
IND,RWA,2011.0,1,2,-1
AUS,COL,2011.0,2,14,-12
PAN,ECU,2021.0,1,1,0
ESP,PRI,2004.0,3,2,1
FRA,ETH,2021.0,3,2,1
PRT,TUR,2004.0,1,2,-1
ZAF,RUS,2016.0,4,2,2
CAN,GUM,2006.0,1,1,0
GNB,PRT,2016.0,1,3,-2
HRV,HUN,2021.0,2,3,-1
SRB,POL,1997.0,1,1,0
BEL,BGD,2022.0,1,2,-1
JPN,MAR,2023.0,3,2,1
ITA,UKR,2019.0,1,2,-1
CIV,BEN,2015.0,1,1,0
MLI,IND,2006.0,1,1,0
VEN,SWE,1998.0,3,1,2
TUR,DNK,1997.0,1,3,-2
COL,CUB,1999.0,1,1,0
GBR,MDV,2016.0,1,3,-2
FRA,CUB,2005.0,1,2,-1
CUB,FRA,2007.0,2,3,-1
SAU,POL,2016.0,3,2,1
SGP,TWN,1998.0,1,5,-4
PRT,BGR,2019.0,2,1,1
CAN,EST,2016.0,2,2,0
MMR,IND,2019.0,1,1,0
CRI,FRA,2010.0,2,1,1
CHE,KHM,2017.0,2,1,1
NZL,CZE,2014.0,1,2,-1
CZE,NZL,2017.0,2,3,-1
KOR,ISR,2005.0,3,1,2
GHA,DNK,2014.0,1,3,-2
CZE,ISR,2019.0,2,4,-2
MEX,DOM,2015.0,1,4,-3
IRL,BGD,2021.0,2,4,-2
PRT,CHN,2007.0,1,8,-7
CHE,QAT,2019.0,3,1,2
LUX,PRT,2022.0,1,7,-6
COL,CRI,2018.0,1,4,-3
BRN,BGD,2018.0,3,3,0
DEU,URY,2020.0,3,3,0
POL,BRA,2009.0,1,1,0
FRA,TCD,2016.0,2,1,1
MYS,PHL,2015.0,2,1,1
ISL,ESP,2015.0,1,3,-2
FIN,LTU,2003.0,3,3,0
CHL,CZE,2011.0,1,4,-3
NGA,VNM,2015.0,1,1,0
PRT,POL,2022.0,3,1,2
FIN,HKG,2022.0,1,1,0
PER,PRT,2015.0,1,2,-1
NZL,NGA,2018.0,2,3,-1
GHA,DZA,2022.0,1,1,0
IRQ,DEU,2023.0,1,6,-5
SWE,IDN,2019.0,1,5,-4
SGP,GRC,2018.0,1,1,0
CMR,CAN,2023.0,1,2,-1
CHL,DNK,2009.0,3,1,2
AUS,IND,2024.0,1,5,-4
NOR,IND,2007.0,2,2,0
CHE,LBN,2012.0,1,1,0
KAZ,ITA,2019.0,1,2,-1
SYR,ARE,2015.0,3,2,1
GHA,FIN,2021.0,1,3,-2
LKA,NOR,2020.0,1,2,-1
DEU,CUB,2023.0,1,3,-2
IDN,PAK,2022.0,4,6,-2
EST,CAN,2009.0,1,1,0
CRI,PAN,2022.0,1,2,-1
BGR,AUT,2020.0,3,1,2
AUS,TLS,2022.0,2,1,1
BEL,ARM,2014.0,1,1,0
AUS,UGA,2021.0,1,1,0
BEN,CMR,2013.0,1,1,0
VIR,USA,2015.0,2,2,0
FRA,GIN,2010.0,1,5,-4
PRT,SVK,1998.0,1,1,0
PAK,ARE,1998.0,1,1,0
AUS,LBN,2004.0,1,1,0
ITA,KAZ,2006.0,1,5,-4
CAN,LBN,2005.0,1,4,-3
JOR,FRA,2005.0,1,1,0
DNK,IRN,2006.0,1,1,0
CHE,MUS,2019.0,1,2,-1
USA,BFA,2010.0,2,3,-1
TUR,PSE,2003.0,1,1,0
MLT,USA,2015.0,1,1,0
PER,FRA,2003.0,2,2,0
EGY,NZL,2007.0,1,1,0
LBY,LBN,2001.0,1,1,0
ISR,SGP,1999.0,1,1,0
SLE,UGA,2021.0,1,1,0
DEU,MAR,2001.0,2,5,-3
GRC,JPN,2008.0,1,5,-4
GUM,JPN,2001.0,1,1,0
JPN,BEL,1998.0,6,5,1
CHN,BRA,2001.0,2,2,0
MYS,ETH,2011.0,1,1,0
MDG,GBR,1999.0,2,2,0
IRQ,JOR,2013.0,1,2,-1
ECU,PER,2017.0,2,3,-1
MAR,BEL,2000.0,2,9,-7
FRA,JOR,1999.0,1,3,-2
ROU,TUR,2005.0,1,3,-2
BRA,UKR,1997.0,1,2,-1
TTO,BRB,2008.0,4,2,2
DNK,VNM,2008.0,1,2,-1
KEN,NZL,2014.0,1,1,0
NZL,OMN,2008.0,1,1,0
LBN,SAU,2010.0,3,2,1
BGR,SWE,2021.0,1,3,-2
CHE,PHL,2020.0,3,4,-1
BEL,NZL,1998.0,1,1,0
UKR,COL,2002.0,1,1,0
SWE,UGA,2008.0,3,3,0
LUX,NZL,2011.0,1,1,0
BEL,CIV,2009.0,1,1,0
KWT,OMN,2023.0,1,1,0
ARE,SWE,2009.0,1,2,-1
ZWE,NOR,2001.0,1,1,0
FRA,BLR,2000.0,2,6,-4
GBR,PER,2004.0,1,1,0
ITA,SGP,2008.0,1,4,-3
TWN,NOR,2015.0,1,1,0
PRT,HUN,2022.0,1,3,-2
ISR,JOR,2011.0,1,1,0
CHN,UGA,2012.0,1,1,0
AUS,MAC,2020.0,1,2,-1
HUN,AUS,2000.0,1,1,0
NER,NGA,2021.0,2,3,-1
AUT,ETH,2020.0,1,1,0
KOR,IRN,2012.0,1,7,-6
COG,USA,2020.0,3,7,-4
LBY,QAT,2020.0,2,1,1
PAK,KWT,2017.0,1,1,0
AUT,ZAF,2019.0,1,4,-3
DEU,MNG,2018.0,1,5,-4
KEN,CHN,2012.0,1,2,-1
DEU,LVA,2015.0,3,3,0
SYR,RUS,2020.0,1,1,0
COL,NLD,2008.0,1,4,-3
ZMB,NOR,2018.0,1,2,-1
FIN,MEX,2020.0,1,4,-3
BFA,BRN,2021.0,1,1,0
COD,MAR,2020.0,1,2,-1
MKD,BGR,2021.0,2,1,1
SAU,TUR,1999.0,1,1,0
KOR,BGD,2006.0,2,8,-6
LUX,AUT,2022.0,2,7,-5
RUS,ECU,2020.0,1,1,0
GHA,CYP,2021.0,1,1,0
QAT,GBR,2001.0,3,4,-1
QAT,SAU,2023.0,2,6,-4
CMR,NLD,2005.0,1,1,0
BEL,NZL,2007.0,1,1,0
BWA,NOR,2009.0,1,1,0
DZA,ARE,2004.0,1,1,0
KWT,MYS,1997.0,1,1,0
PRT,BEL,1998.0,1,1,0
MEX,KOR,2015.0,3,1,2
BOL,USA,2007.0,1,2,-1
LBY,DEU,2011.0,1,1,0
IRN,BLR,2012.0,1,1,0
MEX,CHE,1999.0,1,6,-5
AUT,EGY,2003.0,2,3,-1
NOR,EGY,2010.0,1,1,0
ARE,OMN,2013.0,2,3,-1
SRB,CAN,2016.0,4,3,1
ALB,TUR,2021.0,1,1,0
JAM,BRB,2018.0,3,6,-3
HUN,POL,2016.0,2,1,1
SGP,BGD,2010.0,1,1,0
AUS,BHS,2016.0,1,1,0
AUS,PAK,2004.0,4,3,1
ISR,CZE,2002.0,1,3,-2
SVN,IND,2010.0,1,2,-1
CRI,SWE,1999.0,1,1,0
LTU,LVA,2018.0,3,3,0
IDN,GRC,2011.0,1,1,0
MYS,UZB,2009.0,1,2,-1
ESP,ETH,2014.0,4,2,2
IRL,LTU,2016.0,1,1,0
FJI,CHN,2020.0,1,1,0
TUR,NOR,2009.0,2,2,0
HKG,SWE,2012.0,3,3,0
GEO,RUS,2014.0,2,3,-1
TGO,CHN,2019.0,1,2,-1
SSD,ZAF,2019.0,1,1,0
AUS,ZMB,2018.0,1,1,0
IDN,BGD,2018.0,1,1,0
BGD,AFG,2020.0,1,1,0
TWN,PAK,2020.0,5,6,-1
LKA,IRL,2018.0,1,1,0
COD,USA,2020.0,2,6,-4
TUR,GHA,2019.0,1,2,-1
BHR,USA,2022.0,1,2,-1
NZL,MEX,2019.0,2,5,-3
LTU,JPN,2011.0,2,1,1
BEL,HUN,2009.0,3,8,-5
MWI,ZAF,2009.0,2,3,-1
GBR,DZA,2011.0,3,1,2
ISR,POL,2011.0,2,1,1
CMR,MLI,2007.0,1,1,0
IRN,EGY,2022.0,1,1,0
SVK,RUS,2006.0,4,1,3
SWE,IDN,2011.0,2,2,0
PER,SWE,2006.0,2,2,0
ARG,NZL,2013.0,2,2,0
ROU,MDA,1999.0,1,4,-3
PAN,GBR,2011.0,1,1,0
HKG,NLD,2005.0,1,2,-1
JPN,ROU,2023.0,1,2,-1
TTO,USA,1997.0,1,2,-1
DEU,BOL,2018.0,2,2,0
KHM,USA,2008.0,1,6,-5
GRC,MKD,2011.0,1,2,-1
SWZ,NGA,2015.0,1,1,0
HUN,RUS,2020.0,2,4,-2
ESP,SVK,2020.0,1,1,0
QAT,HRV,2020.0,1,1,0
VNM,DNK,2021.0,3,3,0
BFA,TWN,2019.0,1,1,0
AUT,IDN,2020.0,3,2,1
SRB,GRC,2020.0,1,4,-3
AFG,PAK,2021.0,1,1,0
IND,ISR,2024.0,1,1,0
KHM,JPN,2021.0,1,7,-6
SVN,IRN,2020.0,1,3,-2
NOR,PAK,2021.0,2,4,-2
BGD,ARE,2020.0,2,1,1
FIN,EGY,2022.0,1,2,-1
MYS,CHE,2020.0,2,6,-4
PER,URY,2020.0,2,1,1
TWN,MAC,2023.0,1,3,-2
EST,CZE,2023.0,4,1,3
MMR,SGP,2022.0,1,3,-2
GIN,MLI,2020.0,1,1,0
GRC,MYS,2018.0,1,1,0
FIN,ROU,2004.0,1,1,0
PYF,ESP,2007.0,1,1,0
ISR,BEL,2014.0,6,4,2
VEN,CAN,2005.0,1,2,-1
HKG,BGD,2009.0,2,1,1
NOR,BGD,2014.0,1,3,-2
FIN,IRL,2010.0,1,5,-4
FRA,URY,2018.0,3,4,-1
PHL,MAR,2021.0,2,1,1
OMN,ITA,2018.0,1,1,0
QAT,CAN,2009.0,1,10,-9
RUS,LVA,2010.0,3,1,2
TLS,AUS,2010.0,1,1,0
GRC,FIN,2007.0,3,1,2
ZAF,VNM,2004.0,2,1,1
TUN,CHE,2010.0,3,2,1
TZA,KEN,2012.0,2,1,1
NOR,EST,2017.0,1,1,0
ESP,SVK,2007.0,3,1,2
LKA,BRA,2019.0,2,1,1
THA,FIN,2015.0,2,1,1
MUS,FRA,2010.0,1,2,-1
HRV,CHN,2023.0,1,2,-1
FRA,LAO,2007.0,1,1,0
ITA,TUN,2010.0,3,4,-1
IRN,PAK,2007.0,1,1,0
MEX,URY,2007.0,2,3,-1
LAO,ETH,2011.0,1,1,0
LKA,ETH,2010.0,1,1,0
SEN,NGA,2015.0,2,2,0
MYS,SAU,2000.0,1,1,0
GEO,CAN,2019.0,1,1,0
SYR,SAU,2013.0,1,1,0
KAZ,AZE,2014.0,1,2,-1
AZE,KAZ,2017.0,1,1,0
NGA,BRN,2022.0,1,1,0
BEL,PHL,2013.0,1,1,0
ISL,BEL,2013.0,1,1,0
NZL,HKG,2005.0,2,2,0
TUR,KOR,2010.0,2,3,-1
CHN,ECU,2020.0,1,2,-1
MYS,GHA,2019.0,5,2,3
GRC,POL,2018.0,3,1,2
HRV,TUR,2021.0,2,2,0
GHA,SWE,2022.0,1,2,-1
NOR,NGA,2015.0,2,2,0
THA,SAU,2011.0,1,1,0
NLD,TWN,2016.0,1,4,-3
FIN,HKG,2016.0,1,3,-2
COG,CHN,2017.0,2,3,-1
KEN,NPL,2018.0,1,1,0
BRN,BFA,2021.0,1,1,0
BEN,TZA,2016.0,1,1,0
HRV,IRL,2023.0,1,1,0
DZA,JPN,2020.0,1,3,-2
NOR,KAZ,2019.0,3,1,2
AUT,SWE,1998.0,2,4,-2
KOR,UKR,2010.0,2,1,1
CHE,NGA,2008.0,1,1,0
TUN,CAN,2006.0,4,8,-4
MYS,BGD,2003.0,2,2,0
CZE,FIN,2001.0,2,3,-1
DNK,BOL,2008.0,2,1,1
NZL,RUS,2009.0,1,3,-2
ZAF,HKG,1999.0,1,1,0
NIC,SWE,2004.0,2,1,1
CHE,LKA,2000.0,1,2,-1
CHN,PAK,2003.0,2,1,1
AUS,TUR,1999.0,4,2,2
CRI,GTM,2013.0,1,1,0
ARE,PRT,2013.0,1,2,-1
ISL,CZE,2016.0,1,2,-1
DNK,URY,2012.0,1,1,0
NPL,KEN,2018.0,1,1,0
GBR,BRB,2018.0,3,2,1
CHN,BLR,2009.0,2,1,1
SGP,KAZ,2021.0,2,1,1
MYS,IRL,2010.0,2,4,-2
HRV,TWN,2011.0,1,2,-1
TWN,HRV,2013.0,1,1,0
YEM,FRA,2021.0,1,1,0
BEL,TUN,2011.0,2,2,0
CHE,EST,2013.0,2,1,1
SLE,CHN,2016.0,1,3,-2
BEL,SVN,2012.0,1,2,-1
ESP,MYS,2019.0,2,1,1
SAU,MEX,2021.0,1,2,-1
FIN,TZA,2018.0,2,1,1
SRB,JPN,2016.0,1,1,0
BEL,COL,2010.0,2,3,-1
JAM,GBR,2014.0,1,1,0
BHS,AUS,2015.0,1,1,0
PER,NLD,2018.0,3,3,0
AUT,LIE,2020.0,2,1,1
NPL,NOR,2018.0,4,6,-2
CZE,PRT,2018.0,2,9,-7
MWI,KEN,2022.0,2,4,-2
UZB,NLD,2021.0,1,1,0
NPL,NZL,2019.0,2,1,1
EGY,ETH,2023.0,1,1,0
IRL,TWN,2018.0,1,1,0
CZE,TWN,2022.0,1,3,-2
TUR,SOM,2021.0,5,1,4
SLE,MYS,2023.0,1,1,0
TUR,LUX,2022.0,1,1,0
NZL,RUS,2021.0,1,1,0
QAT,BRA,2018.0,1,1,0
BIH,JPN,2023.0,1,1,0
RUS,QAT,2020.0,1,1,0
FRA,GIN,2006.0,1,1,0
BDI,TZA,2022.0,1,1,0
MNG,CHN,2007.0,1,4,-3
NGA,UGA,2008.0,2,1,1
BRA,ZAF,2003.0,1,1,0
MWI,NOR,2020.0,1,2,-1
AUS,ISL,2016.0,1,2,-1
TCD,FRA,2007.0,1,1,0
ZAF,BEN,2017.0,2,7,-5
ARG,COL,2009.0,4,9,-5
JPN,KAZ,2009.0,1,2,-1
TUN,MAR,2005.0,2,1,1
PRT,IRN,2011.0,1,5,-4
LTU,UKR,2020.0,1,4,-3
GBR,AFG,2020.0,4,3,1
CZE,ARE,2021.0,2,1,1
ARG,AUT,2021.0,4,3,1
UKR,IRN,2023.0,1,1,0
POL,NGA,2023.0,1,1,0
DEU,SLV,2019.0,1,1,0
DNK,MEX,2023.0,1,5,-4
MEX,PAK,2023.0,2,4,-2
BEL,BGR,2021.0,2,4,-2
GRC,RUS,2018.0,1,3,-2
LKA,DNK,2005.0,2,1,1
HUN,AUT,1997.0,1,5,-4
BLR,FIN,2019.0,1,1,0
ARE,JPN,2008.0,2,5,-3
ITA,BLR,2000.0,2,4,-2
GRC,AUS,2000.0,2,1,1
BGD,IRL,2005.0,1,2,-1
HUN,BRA,2010.0,2,1,1
BRA,HUN,2015.0,1,1,0
CAN,OMN,1998.0,4,1,3
NGA,JPN,1998.0,2,1,1
CAN,BGR,2006.0,2,4,-2
EGY,AUT,2007.0,2,7,-5
RUS,KGZ,2004.0,5,4,1
MYS,DEU,1999.0,1,2,-1
AUS,MUS,2010.0,1,2,-1
FRA,ECU,2007.0,2,1,1
GAB,DEU,2005.0,1,5,-4
GRC,BGR,1999.0,3,2,1
SWE,NZL,2011.0,3,6,-3
ISR,AUT,2002.0,1,3,-2
GIN,FRA,2006.0,1,1,0
NZL,BGD,2001.0,1,1,0
SDN,MYS,2022.0,2,9,-7
VNM,VEN,2012.0,1,4,-3
ETH,UGA,2015.0,2,2,0
TWN,MWI,2017.0,1,1,0
NOR,TUR,2010.0,2,6,-4
KOR,CZE,2017.0,2,5,-3
DEU,SYR,2021.0,1,2,-1
SDN,ETH,2019.0,1,2,-1
CHN,PRI,2019.0,1,2,-1
PHL,TWN,2008.0,1,2,-1
AGO,GBR,2018.0,1,1,0
EST,RUS,2012.0,2,5,-3
MUS,IND,2021.0,1,3,-2
AUT,ARG,2015.0,1,1,0
LAO,KOR,2013.0,1,1,0
CZE,HUN,2001.0,3,2,1
BRB,GBR,2003.0,1,2,-1
MYS,PAK,2024.0,2,1,1
CHE,PAK,2006.0,2,2,0
AUS,PER,2013.0,2,1,1
KOR,QAT,2020.0,1,3,-2
BEN,JPN,2014.0,1,2,-1
LTU,ITA,2015.0,1,4,-3
UGA,GBR,2006.0,2,7,-5
IND,PAN,2019.0,1,1,0
KOR,FIN,2016.0,2,4,-2
SDN,NLD,2019.0,2,1,1
IRN,ETH,2018.0,2,3,-1
BFA,DNK,2011.0,1,1,0
SVK,FIN,2009.0,1,3,-2
OMN,BGD,2014.0,1,2,-1
ZAF,SAU,2023.0,1,3,-2
ARE,SDN,2023.0,1,3,-2
NZL,COL,2011.0,2,2,0
DNK,IRL,1999.0,3,5,-2
ZWE,NLD,1999.0,1,2,-1
LVA,JPN,2016.0,1,1,0
NZL,TUR,2019.0,1,1,0
PHL,THA,2002.0,1,1,0
CHL,DNK,2021.0,2,5,-3
AUS,ECU,2015.0,1,2,-1
ISL,AUS,2010.0,1,3,-2
ISR,LUX,2022.0,1,1,0
FRA,LVA,2018.0,3,1,2
BRN,LKA,2013.0,1,6,-5
PER,ARG,2015.0,2,2,0
MEX,CZE,2017.0,2,1,1
AUT,DEU,2024.0,3,1,2
KHM,SWE,2021.0,1,1,0
ETH,TWN,2018.0,2,3,-1
ARE,SGP,2023.0,1,5,-4
BFA,NGA,2020.0,1,2,-1
RWA,SWE,2015.0,1,1,0
BLR,UKR,2018.0,1,4,-3
POL,IRQ,2022.0,1,2,-1
TZA,KOR,2022.0,2,1,1
SWE,DEU,2024.0,1,3,-2
GBR,BEN,2021.0,1,1,0
FRA,COL,1998.0,4,2,2
VNM,FIN,2020.0,1,3,-2
NER,MAR,2022.0,1,3,-2
DEU,ARM,2022.0,2,4,-2
COG,FRA,2023.0,2,2,0
IND,AFG,2023.0,2,1,1
RUS,MNG,2023.0,2,2,0
ETH,ITA,1999.0,1,1,0
TUN,TUR,2009.0,1,2,-1
BEN,CAN,2011.0,1,1,0
LVA,LTU,2003.0,1,1,0
CZE,CHL,2021.0,1,3,-2
CHN,THA,2001.0,1,3,-2
BGR,HUN,2002.0,2,2,0
JPN,GEO,2007.0,1,1,0
JOR,AUS,2008.0,2,4,-2
IDN,FRA,2008.0,1,9,-8
RUS,IND,2002.0,3,4,-1
FRA,PAK,2000.0,1,3,-2
PRT,ECU,2019.0,1,2,-1
CRI,FRA,2006.0,2,2,0
DNK,POL,1998.0,2,4,-2
AUS,RUS,1997.0,3,8,-5
ECU,CAN,2003.0,3,1,2
MRT,TUN,2009.0,1,1,0
GBR,SYR,2019.0,2,6,-4
HKG,PHL,2004.0,1,1,0
IRL,POL,2008.0,1,12,-11
LTU,EST,2000.0,1,2,-1
ESP,UGA,2022.0,1,1,0
CHE,VNM,2013.0,1,1,0
IRL,GRC,2009.0,2,4,-2
SRB,NOR,2022.0,2,2,0
SWE,HKG,2000.0,1,1,0
MUS,GBR,2007.0,1,3,-2
AUT,UZB,2014.0,1,1,0
ITA,GEO,2006.0,1,4,-3
DNK,COL,2011.0,1,3,-2
ITA,HKG,2008.0,1,1,0
DNK,EST,2015.0,1,1,0
VEN,PER,2008.0,2,1,1
MYS,NLD,2003.0,1,4,-3
JPN,FJI,2009.0,2,1,1
CRI,CAN,2015.0,1,3,-2
PRT,BGR,2011.0,2,4,-2
CHL,SWE,2002.0,2,5,-3
KEN,FRA,2006.0,1,3,-2
RUS,HUN,2010.0,1,5,-4
CAN,TTO,2011.0,1,2,-1
CHE,NGA,2015.0,1,10,-9
CYM,IND,2010.0,1,1,0
CZE,ARE,2019.0,1,1,0
ZAF,TTO,2013.0,1,1,0
BEL,DNK,2008.0,4,3,1
CHE,HKG,2004.0,1,1,0
CHN,ARG,2014.0,1,3,-2
FRA,CUB,2012.0,1,2,-1
SLV,SVN,2005.0,1,2,-1
EGY,SVK,2020.0,1,4,-3
CHL,PRT,2011.0,2,1,1
UZB,ITA,2006.0,1,1,0
JOR,FRA,2012.0,2,2,0
CZE,TWN,2018.0,1,4,-3
ISL,DNK,1998.0,1,1,0
DNK,ISL,1999.0,2,4,-2
BLR,CAN,2011.0,2,1,1
PHL,FRA,2010.0,3,2,1
POL,NZL,2021.0,2,4,-2
MAR,BEL,2010.0,1,1,0
DEU,SEN,2019.0,1,1,0
ARG,GTM,2017.0,1,1,0
BDI,BEL,2020.0,1,1,0
TUN,IND,2022.0,1,1,0
PAK,NPL,2016.0,1,1,0
SVN,BRA,2020.0,2,1,1
USA,CIV,2023.0,1,3,-2
BOL,ARG,2022.0,1,1,0
IRL,THA,2022.0,1,2,-1
JPN,ARG,2020.0,1,4,-3
COL,CUB,2020.0,1,4,-3
PAK,THA,2012.0,1,10,-9
FRA,COG,2023.0,2,2,0
GBR,GEO,2001.0,1,1,0
BIH,AUT,2005.0,1,3,-2
THA,PHL,2002.0,1,1,0
UKR,GRC,2003.0,1,3,-2
COG,ETH,2009.0,1,1,0
SYR,IRQ,2010.0,2,1,1
ZWE,RWA,2010.0,1,1,0
COL,AUS,2002.0,3,7,-4
EST,LTU,2000.0,2,1,1
USA,MHL,2004.0,1,1,0
DEU,MKD,2005.0,1,1,0
SWE,SAU,2005.0,2,1,1
TZA,UGA,2014.0,1,7,-6
EGY,OMN,1997.0,1,5,-4
MEX,JPN,2001.0,1,4,-3
QAT,LBN,2017.0,2,3,-1
GRC,PRT,2009.0,1,1,0
ISL,ISR,2002.0,1,2,-1
CUB,FRA,1998.0,1,1,0
NGA,BEN,2001.0,2,6,-4
CHL,DOM,2007.0,1,1,0
POL,ROU,2023.0,1,2,-1
VEN,ECU,2012.0,3,1,2
ECU,VEN,2015.0,2,24,-22
MDG,SEN,2012.0,1,1,0
GRC,BGR,2020.0,2,1,1
DNK,PRT,2008.0,1,6,-5
PHL,AUT,2016.0,1,1,0
AUT,PHL,2018.0,3,2,1
ISR,BGR,2009.0,2,1,1
DEU,EGY,2024.0,1,1,0
UZB,PAK,2003.0,1,1,0
SYC,USA,2012.0,1,1,0
SLV,USA,2001.0,1,1,0
ITA,LVA,2009.0,1,1,0
DEU,JAM,2012.0,1,1,0
FIN,SAU,2012.0,2,2,0
THA,KHM,2013.0,2,1,1
AUS,SVK,2016.0,1,2,-1
FRA,CAF,2013.0,3,1,2
HKG,EGY,2015.0,1,1,0
ESP,PHL,2005.0,1,5,-4
GUY,USA,2014.0,1,2,-1
SWE,MOZ,2000.0,1,1,0
KEN,BDI,2013.0,1,1,0
HUN,BGR,2007.0,1,5,-4
ROU,CZE,2021.0,1,2,-1
BEL,NIC,2016.0,1,1,0
CZE,TWN,2016.0,2,2,0
MKD,MNE,2019.0,1,2,-1
SYR,FRA,2002.0,1,5,-4
GIN,CHE,2018.0,1,1,0
MEX,UKR,2019.0,1,3,-2
VCT,USA,2017.0,1,2,-1
ARE,GRC,2011.0,1,1,0
CHE,GHA,2010.0,1,1,0
KEN,KOR,2015.0,2,1,1
TWN,PHL,2006.0,1,1,0
GRC,ISR,2003.0,1,2,-1
DNK,FRO,2006.0,1,3,-2
BEL,COG,2005.0,2,1,1
COG,KEN,2016.0,1,1,0
HRV,ITA,2007.0,1,3,-2
HRV,SWE,2001.0,1,1,0
ITA,PAN,2022.0,1,1,0
ITA,BGR,2010.0,2,5,-3
ZAF,UGA,2000.0,1,1,0
LUX,USA,2007.0,1,2,-1
UZB,KAZ,2004.0,1,1,0
ARE,CYP,2022.0,1,4,-3
COG,ZAF,1999.0,1,2,-1
SGP,RUS,1999.0,1,2,-1
RUS,SGP,2002.0,1,1,0
ZAF,MOZ,2011.0,1,5,-4
NLD,DZA,2006.0,1,1,0
DNK,PRT,2001.0,2,4,-2
IND,CMR,2013.0,1,2,-1
TUR,MEX,2020.0,2,1,1
BRA,BGR,1999.0,1,4,-3
MEX,JPN,2004.0,1,3,-2
UGA,ZAF,2009.0,1,3,-2
COG,GBR,2014.0,1,1,0
HUN,ARE,2019.0,1,4,-3
SRB,BRA,2020.0,1,3,-2
CHE,SWZ,2007.0,2,1,1
CHE,RWA,2013.0,1,1,0
JPN,ZMB,1997.0,2,1,1
BEL,COD,2015.0,1,1,0
MYS,ITA,2020.0,2,8,-6
ITA,KOR,2010.0,2,10,-8
BEL,BGD,2016.0,3,1,2
BLR,BRA,2018.0,1,2,-1
MMR,JPN,2016.0,1,12,-11
IND,EGY,2006.0,1,2,-1
JPN,BIH,2023.0,1,1,0
SWE,SRB,2018.0,1,9,-8
AUT,COL,2018.0,2,1,1
PSE,BEL,2018.0,1,1,0
FRA,TCD,2022.0,1,1,0
PAN,BEL,2023.0,1,1,0
LVA,ESP,2001.0,1,1,0
LTU,EST,2023.0,1,1,0
LBN,IRN,2021.0,1,2,-1
HRV,JPN,2020.0,1,2,-1
IRL,LUX,2022.0,1,2,-1
CHE,ITA,2024.0,1,1,0
IRQ,BGD,2020.0,1,1,0
SAU,IRQ,2023.0,2,5,-3
BRA,BGR,1998.0,1,1,0
ARE,CAN,2002.0,2,6,-4
BEL,KAZ,2020.0,1,1,0
NGA,GHA,2007.0,1,1,0
GBR,FLK,2011.0,1,3,-2
LUX,LTU,2013.0,1,1,0
ARE,JPN,2014.0,1,2,-1
CAN,CUB,2020.0,1,9,-8
MAR,EGY,2007.0,1,1,0
SAU,PRT,2014.0,1,5,-4
MEX,CHE,2007.0,4,6,-2
THA,ZAF,2008.0,1,1,0
CHE,SWZ,1998.0,1,1,0
URY,AUS,2012.0,1,2,-1
CHL,ARG,2002.0,5,12,-7
CAN,CYP,2000.0,2,1,1
PRY,ESP,2002.0,1,1,0
BRA,UKR,2005.0,1,1,0
GMB,USA,1998.0,1,1,0
KEN,AUT,2021.0,1,2,-1
EST,AUT,2021.0,2,1,1
CRI,COL,2008.0,1,3,-2
NCL,SLB,2021.0,1,1,0
CHL,NOR,2022.0,2,1,1
ROU,RUS,2023.0,1,1,0
HKG,AUT,2023.0,1,2,-1
ARG,HUN,2021.0,2,1,1
GBR,EST,2002.0,1,2,-1
NER,AUS,2013.0,1,1,0
KEN,NOR,2006.0,1,1,0
NLD,MOZ,2014.0,2,1,1
CAN,PHL,1998.0,1,2,-1
AGO,PRT,2002.0,1,2,-1
NZL,COL,2009.0,1,2,-1
KOR,DNK,2004.0,2,1,1
NZL,NOR,1999.0,1,2,-1
VEN,CUB,1998.0,1,1,0
PNG,USA,2002.0,2,4,-2
GRL,CAN,2000.0,1,1,0
JOR,AUS,2001.0,2,1,1
SRB,BRA,2007.0,1,1,0
MDA,DEU,1999.0,1,2,-1
AUS,TUR,2007.0,2,4,-2
CAN,GHA,2001.0,1,2,-1
GEO,ITA,2009.0,1,1,0
SWE,KEN,2001.0,2,8,-6
RUS,GEO,1998.0,1,7,-6
SVN,CHE,2008.0,2,2,0
EST,NLD,2001.0,1,1,0
PRI,VEN,2010.0,1,1,0
CYP,RUS,2011.0,1,1,0
ITA,LUX,2004.0,1,1,0
USA,BEN,2003.0,1,1,0
GAB,MAR,2019.0,1,1,0
CHE,IDN,2011.0,1,1,0
BRA,GRC,2015.0,1,1,0
SGP,IRN,2011.0,1,10,-9
BRA,PAN,2012.0,2,2,0
PRT,CHN,1998.0,1,3,-2
KOR,ZAF,2008.0,1,1,0
CAN,PER,2022.0,1,5,-4
LBY,SRB,2016.0,2,4,-2
HKG,PHL,2015.0,1,1,0
NZL,NPL,2015.0,1,2,-1
RUS,LTU,2012.0,1,2,-1
CHE,PER,2022.0,1,1,0
KEN,MLI,2020.0,1,2,-1
NZL,OMN,2015.0,2,1,1
JPN,FJI,2021.0,2,1,1
ISL,CAN,2016.0,1,4,-3
ARE,ESP,2016.0,1,10,-9
MCO,USA,2009.0,1,1,0
USA,MCO,2012.0,1,1,0
IRN,PSE,2019.0,1,1,0
BGD,PRT,2022.0,1,2,-1
SRB,RUS,2016.0,3,7,-4
IRQ,OMN,2021.0,1,1,0
DZA,TUR,2020.0,2,4,-2
SEN,NER,2019.0,1,1,0
MAR,GAB,2017.0,1,1,0
URY,CHL,2001.0,1,3,-2
GMB,ZAF,2017.0,1,1,0
TJK,GBR,2022.0,1,1,0
TUR,BEL,2006.0,2,6,-4
SDN,ITA,2019.0,1,2,-1
CHN,SRB,2022.0,3,1,2
YEM,USA,2016.0,2,1,1
AUT,CHL,2016.0,2,1,1
PRI,DEU,2001.0,1,1,0
PHL,ITA,2017.0,1,3,-2
BHR,TUN,2011.0,1,2,-1
ROU,HUN,2003.0,3,5,-2
GEO,UKR,1999.0,1,1,0
EST,DEU,2003.0,3,4,-1
SWE,EGY,2010.0,2,2,0
POL,TUR,2010.0,1,2,-1
VNM,SWE,2007.0,1,4,-3
QAT,OMN,2012.0,1,5,-4
UGA,TZA,2018.0,2,2,0
IRN,ARM,2013.0,3,5,-2
ARE,FIN,2013.0,2,1,1
RWA,CAN,2012.0,1,1,0
GRC,QAT,2017.0,2,6,-4
URY,CHE,2019.0,1,2,-1
DZA,IRL,2020.0,2,1,1
EST,JPN,2022.0,1,4,-3
IND,BTN,2019.0,4,1,3
JPN,SDN,2017.0,1,2,-1
RUS,DNK,2010.0,5,5,0
VNM,POL,2018.0,2,2,0
HUN,ROU,2023.0,4,11,-7
CHE,LIE,2019.0,4,4,0
OMN,SAU,2019.0,3,7,-4
LBN,DEU,2015.0,3,3,0
BEL,COL,2020.0,3,10,-7
BGR,NLD,2004.0,3,1,2
ARE,DNK,2017.0,1,1,0
LKA,NLD,1998.0,1,1,0
LTU,TUR,2017.0,1,2,-1
FRA,PHL,2017.0,3,3,0
ESP,DOM,2018.0,1,4,-3
GBR,MOZ,2019.0,2,2,0
GIN,MLI,2023.0,1,2,-1
ETH,HKG,2020.0,2,1,1
ESP,PRY,2004.0,3,1,2
JAM,BRB,2013.0,1,1,0
GHA,THA,2022.0,2,1,1
ZAF,AUT,2000.0,2,3,-1
USA,ASM,2004.0,1,1,0
SEN,CAN,2017.0,1,3,-2
TWN,AUT,2023.0,2,2,0
SVN,ISR,2022.0,1,1,0
FIN,IDN,2021.0,2,1,1
ZAF,SEN,2016.0,1,6,-5
PHL,IDN,2010.0,1,3,-2
ASM,USA,2004.0,1,1,0
ARE,HKG,2022.0,1,4,-3
ESP,TUR,2006.0,2,3,-1
GRC,HUN,2008.0,1,1,0
ETH,DEU,2005.0,2,5,-3
DMA,USA,2013.0,1,3,-2
IRL,TUR,2010.0,2,2,0
SVK,SAU,2021.0,1,1,0
IRL,SAU,2015.0,3,2,1
CHE,TUN,2016.0,1,3,-2
JPN,FJI,2002.0,1,1,0
MEX,MYS,2021.0,1,1,0
COL,KEN,2000.0,1,1,0
DEU,GEO,2013.0,2,4,-2
EGY,JOR,2010.0,1,3,-2
TZA,CAN,2011.0,1,2,-1
IRL,SVK,2021.0,1,3,-2
CMR,CIV,2014.0,1,3,-2
IRN,IND,2007.0,4,10,-6
PHL,ZAF,2007.0,1,1,0
USA,MLT,2009.0,3,1,2
ARG,ECU,2010.0,2,1,1
CUB,CHE,2020.0,1,1,0
EGY,PAK,2015.0,2,3,-1
FIN,HKG,2013.0,1,1,0
LKA,BGD,2011.0,1,1,0
URY,DNK,2009.0,1,1,0
IND,SDN,2012.0,1,1,0
ARG,SWE,2005.0,1,1,0
RUS,SGP,2019.0,1,4,-3
BWA,NGA,2002.0,1,1,0
BRB,JAM,2003.0,1,1,0
THA,PHL,2011.0,1,1,0
FIN,PRT,2017.0,2,7,-5
VNM,VEN,2019.0,1,2,-1
DEU,RUS,2024.0,1,1,0
NLD,SDN,2022.0,1,2,-1
IND,COL,2019.0,2,2,0
HRV,NZL,2023.0,1,1,0
PAK,CYP,2021.0,1,2,-1
ARE,KWT,2015.0,1,4,-3
CUB,IND,2018.0,2,1,1
MNE,SRB,2007.0,3,14,-11
ARE,PAK,1998.0,1,1,0
GRC,CHE,1999.0,1,10,-9
VNM,DEU,1997.0,1,2,-1
BRA,URY,2000.0,3,5,-2
BRB,JAM,2013.0,1,1,0
ESP,NIC,2011.0,2,1,1
CIV,GBR,2022.0,1,2,-1
NOR,AUS,2008.0,2,23,-21
ARE,LBY,2020.0,2,2,0
CHN,EGY,2002.0,1,2,-1
LTU,CHN,2020.0,3,2,1
MYS,DNK,2021.0,4,4,0
JPN,LVA,2023.0,1,1,0
IDN,EGY,2022.0,1,2,-1
KHM,IND,2015.0,1,1,0
USA,BLR,2001.0,8,13,-5
KAZ,JPN,2008.0,1,1,0
FRA,EST,1997.0,2,3,-1
TGO,USA,2008.0,2,1,1
HUN,GRC,2008.0,1,1,0
SAU,ESP,2019.0,3,15,-12
KNA,GBR,2020.0,1,3,-2
CZE,JOR,2022.0,1,2,-1
IRN,PAK,2023.0,3,1,2
IND,ERI,2004.0,1,1,0
LTU,CAN,2001.0,1,1,0
JPN,SVN,2017.0,1,2,-1
BEL,IRL,2006.0,2,1,1
LTU,NLD,2012.0,1,1,0
COG,BEL,2012.0,1,12,-11
GBR,IRQ,2006.0,1,1,0
BGR,TUR,2011.0,1,2,-1
PRT,SVK,2006.0,1,1,0
ROU,SAU,2016.0,2,1,1
ITA,NIC,2010.0,1,0,1
GRC,ARM,2010.0,1,0,1
BLZ,ESP,2020.0,1,0,1
HRV,QAT,2014.0,1,0,1
SWZ,SWE,2012.0,1,0,1
PHL,MMR,2011.0,1,0,1
GBR,SWZ,1998.0,1,0,1
SYR,CAN,2000.0,1,0,1
SVK,FIN,2005.0,1,0,1
ESP,KWT,2012.0,1,0,1
LTU,BRA,2002.0,1,0,1
ARM,GRC,2008.0,1,0,1
NPL,TWN,2010.0,1,0,1
MUS,ZAF,2012.0,1,0,1
BEL,MDG,2009.0,2,0,2
NOR,MLI,2010.0,1,0,1
URY,IRL,2018.0,1,0,1
NOR,SAU,2011.0,1,0,1
SWE,LAO,2014.0,1,0,1
CAF,SSD,2022.0,1,0,1
BGD,KAZ,2012.0,1,0,1
NZL,ARG,2016.0,1,0,1
COD,ZWE,2013.0,1,0,1
OMN,TUR,2014.0,1,0,1
SLB,NLD,2021.0,1,0,1
BRB,BEL,2023.0,1,0,1
TUR,QAT,2024.0,1,0,1
GEO,SWE,2016.0,2,0,2
BRB,AUT,2015.0,1,0,1
ESP,HKG,1997.0,1,0,1
FRA,KGZ,2020.0,1,0,1
JAM,CYP,2021.0,3,0,3
PAK,LKA,2018.0,1,0,1
ISL,GRC,2019.0,1,0,1
ITA,IRN,1997.0,2,0,2
GRD,FRA,2019.0,1,0,1
ESP,BIH,2021.0,1,0,1
NGA,BGD,2018.0,2,0,2
SRB,PSE,2020.0,1,0,1
ISR,BLR,2022.0,1,0,1
ALB,CAN,2021.0,1,0,1
ETH,MYS,2007.0,1,0,1
SWE,SJM,2021.0,1,0,1
THA,SOM,2020.0,1,0,1
AUS,CRI,2023.0,1,0,1
SDN,FRA,2012.0,1,0,1
FIN,NLD,2024.0,1,0,1
BRA,GHA,2020.0,1,0,1
COD,CAN,2019.0,1,0,1
COG,SEN,2022.0,1,0,1
TGO,CIV,2023.0,1,0,1
LKA,DNK,2021.0,1,0,1
EGY,ISL,2020.0,1,0,1
MMR,VNM,2021.0,1,0,1
KHM,GUF,2001.0,1,0,1
PNG,USA,2021.0,1,0,1
ITA,NER,2001.0,1,0,1
EGY,AUS,1997.0,1,0,1
RUS,TWN,2012.0,2,0,2
CZE,NZL,2003.0,1,0,1
PHL,NZL,2013.0,1,0,1
DNK,MMR,2023.0,1,0,1
GUM,,1999.0,1,0,1
GHA,SWE,2003.0,2,0,2
UKR,KGZ,1998.0,1,0,1
ISR,ERI,2002.0,1,0,1
SWE,IRQ,2009.0,1,0,1
SYR,MAR,2001.0,1,0,1
CHE,SAU,2000.0,1,0,1
TGO,CIV,2010.0,1,0,1
NCL,,2000.0,1,0,1
FIN,QAT,2009.0,1,0,1
NOR,SRB,2004.0,1,0,1
BFA,ZWE,2004.0,1,0,1
CAF,BFA,2013.0,1,0,1
JPN,MAR,1999.0,1,0,1
USA,BIH,1997.0,1,0,1
NOR,ZAF,1997.0,1,0,1
THA,BFA,2014.0,1,0,1
BLR,AZE,2002.0,1,0,1
AZE,BLR,2016.0,1,0,1
CIV,GHA,2013.0,1,0,1
FIN,ARE,2007.0,1,0,1
USA,AND,2003.0,1,0,1
AND,,2007.0,1,0,1
JAM,CAN,2004.0,2,0,2
BWA,NGA,2005.0,2,0,2
ARG,POL,2014.0,1,0,1
BFA,BEN,2006.0,1,0,1
BLR,CAN,2005.0,1,0,1
KWT,HUN,1997.0,2,0,2
TWN,CZE,2008.0,2,0,2
SEN,COG,2020.0,1,0,1
PSE,FJI,2010.0,1,0,1
MDA,TWN,2006.0,1,0,1
TUN,JOR,2016.0,1,0,1
LAO,VNM,2014.0,4,0,4
TWN,GRC,2019.0,1,0,1
TWN,GRC,2021.0,2,0,2
BEL,KHM,2019.0,1,0,1
SVN,IRN,2006.0,1,0,1
MTQ,BEL,2008.0,1,0,1
UGA,FJI,2011.0,1,0,1
NCL,MEX,2006.0,1,0,1
GRC,DZA,2014.0,1,0,1
PAK,BRA,2024.0,1,0,1
CHE,MKD,2013.0,1,0,1
,SMR,2006.0,2,0,2
SRB,ROU,1999.0,2,0,2
GIB,,2019.0,2,0,2
TUN,TUR,2005.0,1,0,1
ETH,CZE,2016.0,1,0,1
SWE,SAU,2011.0,1,0,1
ZAF,SDN,2005.0,1,0,1
CHN,BOL,2019.0,1,0,1
RUS,QAT,2023.0,1,0,1
LUX,HUN,2019.0,1,0,1
AUT,ZWE,2012.0,1,0,1
AUT,RWA,2015.0,1,0,1
RWA,AUT,2017.0,1,0,1
UGA,GHA,2020.0,1,0,1
GBR,CAF,2013.0,2,0,2
FIN,COL,2010.0,1,0,1
BRA,TUR,2012.0,1,0,1
GUM,,2020.0,6,0,6
DNK,ALB,2018.0,1,0,1
UGA,PER,2016.0,1,0,1
ZAF,SLE,2001.0,2,0,2
SLE,,2004.0,1,0,1
NCL,ITA,2010.0,1,0,1
JOR,TWN,2012.0,1,0,1
FRA,ISL,1998.0,2,0,2
NOR,FRO,2017.0,2,0,2
AUT,KWT,2013.0,1,0,1
ITA,PAK,2006.0,1,0,1
ITA,MDG,2014.0,1,0,1
PAN,HND,2015.0,1,0,1
MOZ,BWA,2020.0,1,0,1
BWA,MOZ,2022.0,1,0,1
CHE,MNG,2021.0,2,0,2
SGP,TLS,2009.0,1,0,1
CYP,LBN,2017.0,1,0,1
TKM,,2020.0,1,0,1
JPN,CMR,2005.0,1,0,1
CZE,THA,2009.0,2,0,2
LKA,THA,2003.0,1,0,1
JPN,FJI,2005.0,1,0,1
SEN,GIN,2012.0,1,0,1
BEN,COG,2019.0,1,0,1
PYF,BEL,2021.0,2,0,2
SRB,LUX,2019.0,1,0,1
CRI,NOR,2012.0,1,0,1
NGA,PRT,2022.0,4,0,4
ISR,URY,2020.0,1,0,1
CHN,BRN,2021.0,1,0,1
CHN,CRI,2020.0,1,0,1
GRC,NZL,2018.0,1,0,1
GMB,SLE,2016.0,1,0,1
SYR,BGD,2020.0,1,0,1
IRN,SGP,2007.0,1,0,1
PHL,SWE,2023.0,1,0,1
ABW,,2022.0,3,0,3
PRT,VNM,2020.0,2,0,2
MOZ,CHE,2023.0,1,0,1
FJI,JPN,2022.0,1,0,1
,GUM,2020.0,6,0,6
CUB,IRL,2022.0,1,0,1
TUN,NGA,2010.0,1,0,1
DEU,BTN,2012.0,2,0,2
DNK,KHM,2018.0,1,0,1
LBY,DNK,2004.0,1,0,1
ZMB,ITA,2021.0,1,0,1
JPN,COD,2015.0,1,0,1
UKR,KOR,2014.0,3,0,3
HKG,ITA,2012.0,1,0,1
SAU,KGZ,2019.0,1,0,1
ESP,KAZ,2014.0,1,0,1
IRL,LIE,2018.0,1,0,1
IND,TGO,2020.0,1,0,1
SGP,SAU,2008.0,2,0,2
MMR,BEL,2019.0,1,0,1
CAN,CRI,2002.0,1,0,1
DEU,GIN,1998.0,1,0,1
MEX,CPV,2022.0,1,0,1
TZA,JPN,2023.0,1,0,1
SDN,IRQ,2019.0,1,0,1
DEU,NCL,2018.0,1,0,1
RWA,ESP,2018.0,1,0,1
NGA,TWN,2017.0,1,0,1
ISR,BGR,2012.0,1,0,1
TGO,KEN,2015.0,1,0,1
THA,UKR,1997.0,1,0,1
ETH,AUT,2006.0,1,0,1
AGO,ITA,1999.0,1,0,1
EGY,BHR,2006.0,3,0,3
GBR,GTM,1997.0,1,0,1
CHN,UKR,2000.0,1,0,1
RUS,MYS,2008.0,1,0,1
ZAF,GRC,2005.0,1,0,1
NIC,CHL,2004.0,1,0,1
LVA,ISR,1999.0,1,0,1
DJI,,2013.0,2,0,2
CAN,PER,2003.0,1,0,1
KOR,EST,2010.0,1,0,1
KHM,BEL,2007.0,1,0,1
AUS,LIE,2012.0,2,0,2
ALB,JPN,2000.0,1,0,1
DNK,SVN,2011.0,1,0,1
BLR,TUR,2006.0,1,0,1
,TON,2000.0,3,0,3
DOM,ESP,2007.0,1,0,1
ARM,AZE,2009.0,1,0,1
FRA,GTM,1997.0,1,0,1
GTM,FRA,1998.0,1,0,1
DEU,VNM,2003.0,4,0,4
NLD,IDN,1997.0,2,0,2
CHE,TCD,2004.0,1,0,1
ITA,ETH,2001.0,2,0,2
USA,BFA,1998.0,1,0,1
ZAF,AZE,2005.0,1,0,1
USA,SUR,2006.0,1,0,1
PRI,PER,2017.0,1,0,1
NZL,ASM,2010.0,1,0,1
MDV,ESP,2004.0,1,0,1
USA,HTI,2009.0,3,0,3
POL,NZL,2005.0,1,0,1
NZL,POL,2007.0,1,0,1
IDN,VNM,2015.0,1,0,1
KWT,ESP,2017.0,1,0,1
ROU,PNG,2013.0,1,0,1
GBR,QAT,2005.0,1,0,1
COL,IRL,2009.0,1,0,1
IRL,COL,2011.0,1,0,1
MKD,MNE,2005.0,1,0,1
FRA,SWZ,2012.0,1,0,1
POL,SVN,2009.0,4,0,4
VEN,AUS,2007.0,1,0,1
CAN,KNA,2014.0,1,0,1
KEN,HKG,2015.0,2,0,2
LTU,RUS,2009.0,1,0,1
ATG,,2012.0,3,0,3
BEN,NLD,2022.0,1,0,1
NOR,MWI,2021.0,2,0,2
FIN,CYP,2009.0,1,0,1
DEU,DOM,2010.0,2,0,2
PYF,NCL,2020.0,1,0,1
MOZ,FRA,2017.0,1,0,1
BLR,IRN,2017.0,1,0,1
CRI,ITA,2013.0,1,0,1
SLV,GBR,2017.0,1,0,1
CYP,FRA,2007.0,1,0,1
BIH,TUR,2013.0,2,0,2
GBR,ALB,2014.0,2,0,2
IDN,IRL,2014.0,1,0,1
SYR,LBN,2013.0,2,0,2
,CPV,2009.0,2,0,2
ZAF,ERI,2013.0,1,0,1
MYS,ZMB,2021.0,1,0,1
CHN,HRV,2011.0,1,0,1
NLD,FJI,2013.0,1,0,1
PRY,JPN,2010.0,1,0,1
GBR,MKD,2021.0,1,0,1
KGZ,PAK,2023.0,2,0,2
ITA,BLR,2020.0,1,0,1
SWE,BIH,2017.0,1,0,1
AUT,MYS,2008.0,1,0,1
IND,ZWE,2019.0,1,0,1
BFA,TGO,2015.0,2,0,2
BHR,SAU,2000.0,2,0,2
NLD,LAO,2012.0,1,0,1
CRI,NIC,2003.0,1,0,1
ECU,WSM,2012.0,1,0,1
TGO,NER,2021.0,1,0,1
BEL,ABW,2019.0,1,0,1
GUF,SEN,1998.0,1,0,1
JPN,BRN,2015.0,1,0,1
UZB,USA,2017.0,1,0,1
BLR,CHE,2003.0,1,0,1
BRA,SVN,2014.0,1,0,1
IRQ,VNM,2019.0,2,0,2
ISR,COL,2002.0,1,0,1
TWN,POL,2003.0,1,0,1
CAN,BHR,2018.0,2,0,2
SRB,AUT,2023.0,1,0,1
TUN,SEN,2018.0,1,0,1
PAK,ARG,2011.0,1,0,1
SVK,GRC,2005.0,2,0,2
NOR,USA,2024.0,1,0,1
,SUR,2020.0,2,0,2
BRN,OMN,2008.0,1,0,1
BGD,NPL,2002.0,1,0,1
ARG,CYP,2003.0,1,0,1
IND,GHA,2010.0,1,0,1
BGD,PHL,2006.0,1,0,1
FRO,,2016.0,2,0,2
CHN,PAN,1998.0,1,0,1
TLS,USA,2015.0,2,0,2
CUB,PAN,2013.0,1,0,1
LIE,LBY,2010.0,1,0,1
POL,SAU,2017.0,2,0,2
BHR,BWA,1997.0,1,0,1
FIN,IDN,2009.0,1,0,1
IRQ,ZAF,2019.0,6,0,6
AUT,MOZ,2013.0,1,0,1
COL,AZE,2016.0,1,0,1
NGA,ECU,2005.0,2,0,2
CHE,DZA,2012.0,1,0,1
SWE,BHR,2016.0,1,0,1
BHR,SWE,2019.0,1,0,1
CAN,SEN,2014.0,3,0,3
BRA,MLT,2019.0,1,0,1
MDG,COG,2017.0,1,0,1
MWI,NGA,2020.0,3,0,3
KOR,COG,2016.0,1,0,1
LSO,KEN,2012.0,1,0,1
ZAF,KWT,2021.0,1,0,1
HRV,SGP,2020.0,2,0,2
USA,BLZ,2013.0,1,0,1
AUT,PER,2014.0,1,0,1
BRN,NZL,2009.0,1,0,1
IDN,CHE,2010.0,1,0,1
MEX,ARM,2020.0,1,0,1
ZAF,CAF,2014.0,1,0,1
PNG,THA,2018.0,1,0,1
SYR,SAU,2017.0,1,0,1
ETH,THA,2017.0,1,0,1
SAU,TTO,2021.0,1,0,1
PAK,KGZ,2014.0,1,0,1
JPN,SYR,1997.0,1,0,1
ITA,CRI,2000.0,1,0,1
BEL,CMR,2004.0,1,0,1
IND,TZA,2001.0,2,0,2
ERI,USA,2009.0,1,0,1
REU,USA,2008.0,1,0,1
PRY,MEX,2005.0,1,0,1
FRA,TZA,2021.0,1,0,1
ALB,MKD,2017.0,1,0,1
CHE,SAU,2006.0,1,0,1
ROU,PRT,2023.0,2,0,2
CYP,LIE,2018.0,1,0,1
LKA,PHL,2012.0,1,0,1
,DJI,2015.0,1,0,1
ZAF,OMN,2020.0,2,0,2
MCO,BRA,2021.0,1,0,1
BRA,MAR,2017.0,1,0,1
TUN,KWT,2019.0,1,0,1
GUY,CUB,2018.0,3,0,3
FJI,GBR,2001.0,2,0,2
USA,VGB,2020.0,2,0,2
LVA,DNK,2021.0,2,0,2
LBY,TUR,2016.0,1,0,1
JOR,NZL,2011.0,1,0,1
KEN,SOM,2022.0,2,0,2
RWA,ESP,2022.0,1,0,1
AFG,IDN,2022.0,2,0,2
,AND,2017.0,1,0,1
SWZ,ZMB,2022.0,1,0,1
ECU,NIC,2014.0,1,0,1
TUN,BEN,2004.0,1,0,1
GRC,ZMB,2015.0,1,0,1
ETH,SDN,2015.0,1,0,1
CAF,,2007.0,3,0,3
TTO,CHL,2006.0,1,0,1
BEL,ALB,2009.0,1,0,1
FRA,COD,2005.0,2,0,2
BFA,YEM,2019.0,1,0,1
BRB,ITA,2004.0,1,0,1
ISR,KAZ,2011.0,2,0,2
ZAF,ARE,1998.0,1,0,1
BEL,GMB,2011.0,1,0,1
SAU,ROU,1997.0,1,0,1
FJI,SLB,2019.0,2,0,2
BEN,COG,2011.0,1,0,1
NLD,LKA,2012.0,2,0,2
PRI,YEM,2001.0,2,0,2
COG,BFA,2007.0,1,0,1
CZE,EGY,2006.0,2,0,2
RWA,AUS,2016.0,1,0,1
TTO,AUT,2019.0,1,0,1
KOR,HRV,2017.0,1,0,1
PYF,AUS,2004.0,1,0,1
NAM,MEX,2022.0,1,0,1
FRA,BDI,2001.0,2,0,2
,ASM,1998.0,1,0,1
TCA,GBR,2010.0,3,0,3
ZAF,SVN,2020.0,2,0,2
LVA,UKR,2005.0,1,0,1
GEO,TUR,2018.0,2,0,2
,MMR,1994.0,6,0,6
MDG,ZAF,2012.0,1,0,1
MYS,JOR,2003.0,1,0,1
ZWE,TZA,2003.0,2,0,2
ZMB,KEN,2000.0,1,0,1
TCD,,2008.0,1,0,1
TCD,COG,1997.0,1,0,1
LTU,CAN,2004.0,1,0,1
HUN,AUS,2007.0,3,0,3
JOR,DNK,2017.0,1,0,1
GTM,AGO,2013.0,1,0,1
USA,KNA,2001.0,1,0,1
HUN,SAU,2011.0,1,0,1
ISR,HND,2018.0,1,0,1
PAN,,2003.0,3,0,3
KOR,BLR,2002.0,1,0,1
TZA,BEL,1998.0,1,0,1
QAT,IRL,2009.0,1,0,1
UKR,SVN,2006.0,1,0,1
MAR,SYR,2008.0,1,0,1
GIB,,2021.0,1,0,1
NPL,SAU,2017.0,2,0,2
KGZ,KAZ,2015.0,1,0,1
NPL,IDN,2003.0,1,0,1
ETH,CUB,2008.0,3,0,3
IRQ,CAN,2003.0,1,0,1
BEN,AGO,2015.0,1,0,1
ZAF,EGY,2003.0,1,0,1
KEN,LAO,2011.0,1,0,1
NZL,IRN,2007.0,2,0,2
NAM,MWI,2007.0,1,0,1
BDI,NLD,2023.0,1,0,1
CAN,VIR,2022.0,1,0,1
PER,ECU,2009.0,2,0,2
JPN,JOR,2013.0,1,0,1
ITA,TZA,2012.0,1,0,1
HKG,TUR,2011.0,1,0,1
SVN,NOR,2013.0,1,0,1
ITA,KEN,2009.0,3,0,3
NLD,CUB,2011.0,1,0,1
MWI,LSO,2019.0,1,0,1
MYS,AUT,2013.0,1,0,1
CRI,BEL,2013.0,1,0,1
KOR,COL,2017.0,1,0,1
CHN,NPL,2011.0,1,0,1
SOM,KEN,2011.0,1,0,1
KEN,SOM,2016.0,1,0,1
,VIR,2008.0,3,0,3
CUB,HTI,2012.0,3,0,3
GHA,TZA,2020.0,1,0,1
AUS,PRI,2022.0,1,0,1
FIN,LBY,2018.0,1,0,1
,KIR,2015.0,2,0,2
LVA,MLT,2022.0,1,0,1
SYR,NOR,2018.0,1,0,1
LBY,QAT,2023.0,1,0,1
KOR,BEN,2023.0,1,0,1
CMR,TGO,2018.0,1,0,1
CYP,PSE,2018.0,1,0,1
BRN,TUR,2021.0,1,0,1
MEX,SVN,2021.0,1,0,1
USA,CAF,2021.0,1,0,1
,VGB,2017.0,1,0,1
MNG,JPN,2000.0,1,0,1
CIV,IND,2003.0,1,0,1
DNK,COL,2002.0,1,0,1
CHE,GIN,2016.0,1,0,1
ZAF,HUN,2017.0,1,0,1
ZWE,DNK,2004.0,1,0,1
FRA,QAT,2007.0,1,0,1
IND,YEM,2002.0,1,0,1
FIN,LVA,2008.0,1,0,1
KNA,CAN,2008.0,1,0,1
BRA,NGA,1999.0,1,0,1
NZL,POL,1999.0,1,0,1
JOR,RUS,2000.0,1,0,1
AZE,UKR,2017.0,1,0,1
DNK,PSE,2015.0,1,0,1
GBR,LBR,2010.0,1,0,1
MEX,ZWE,2012.0,1,0,1
MOZ,MWI,2021.0,1,0,1
MKD,AUT,2023.0,1,0,1
MWI,KOR,2017.0,1,0,1
POL,QAT,2014.0,1,0,1
BEL,DOM,2021.0,1,0,1
MWI,ETH,2011.0,1,0,1
LCA,GBR,1998.0,1,0,1
ITA,COG,2017.0,2,0,2
POL,NAM,2019.0,1,0,1
JPN,NCL,2000.0,1,0,1
NGA,TZA,2006.0,1,0,1
MLI,MDG,2003.0,1,0,1
BLR,ARM,2021.0,1,0,1
IRL,TTO,2019.0,1,0,1
IRL,TTO,2021.0,1,0,1
TUN,KEN,2010.0,1,0,1
KEN,TUN,2015.0,1,0,1
GIN,BEL,2015.0,1,0,1
CHE,BOL,2018.0,2,0,2
BHR,PHL,2018.0,1,0,1
BEL,TWN,1998.0,1,0,1
BHR,OMN,2002.0,1,0,1
CHN,FJI,2015.0,1,0,1
NPL,ISR,2014.0,1,0,1
PAK,ARG,2021.0,1,0,1
BLR,SVK,2004.0,1,0,1
TWN,OMN,2018.0,1,0,1
CZE,HKG,2015.0,1,0,1
COM,CMR,2015.0,1,0,1
HKG,AUT,2007.0,1,0,1
CYP,MAR,2021.0,1,0,1
FLK,USA,2022.0,1,0,1
AUS,MUS,2020.0,2,0,2
JOR,YEM,2017.0,3,0,3
BFA,BRA,2023.0,1,0,1
CHL,KNA,2020.0,3,0,3
ETH,MLI,2016.0,1,0,1
KEN,MRT,2012.0,1,0,1
GEO,IND,2013.0,1,0,1
SEN,SDN,2006.0,1,0,1
EGY,UGA,2015.0,2,0,2
ARE,SYR,2007.0,1,0,1
LBY,IRN,2017.0,1,0,1
GBR,MUS,2015.0,4,0,4
PRI,ABW,2015.0,1,0,1
CMR,CAF,2018.0,1,0,1
,KNA,1997.0,1,0,1
ITA,MOZ,2006.0,1,0,1
CHN,SDN,2008.0,2,0,2
YEM,FIN,2018.0,1,0,1
DEU,MMR,2020.0,1,0,1
HUN,CHL,2013.0,2,0,2
NLD,BGR,2015.0,3,0,3
AZE,USA,2009.0,1,0,1
NZL,LBN,2008.0,1,0,1
GRC,VNM,2014.0,1,0,1
PRY,ECU,2010.0,1,0,1
PNG,VUT,2021.0,1,0,1
MWI,CHE,2022.0,3,0,3
NGA,CYP,2015.0,1,0,1
CHL,HRV,2014.0,1,0,1
QAT,CHE,2022.0,1,0,1
BGD,YEM,2019.0,1,0,1
UGA,GUY,2021.0,1,0,1
PHL,ITA,2016.0,1,0,1
TUN,GUF,2021.0,1,0,1
GAB,CHN,2020.0,1,0,1
USA,BTN,2017.0,1,0,1
ZAF,TTO,2017.0,2,0,2
BGD,SDN,2003.0,1,0,1
POL,TWN,2001.0,2,0,2
MKD,NLD,2018.0,1,0,1
URY,BOL,2021.0,1,0,1
MOZ,TZA,2016.0,2,0,2
THA,TGO,2021.0,1,0,1
GBR,BFA,2000.0,1,0,1
ERI,CHN,2023.0,1,0,1
EST,ISR,2023.0,1,0,1
BRA,LKA,2016.0,2,0,2
LKA,QAT,2022.0,1,0,1
RUS,JOR,2003.0,1,0,1
KWT,NLD,2008.0,1,0,1
JPN,RWA,2012.0,1,0,1
CAN,PSE,2009.0,1,0,1
CYP,LTU,2020.0,1,0,1
BGD,LKA,2021.0,1,0,1
CHN,CHL,2003.0,1,0,1
GRC,JOR,2006.0,1,0,1
LVA,POL,2008.0,2,0,2
CHE,CRI,2012.0,1,0,1
ZWE,BWA,1998.0,1,0,1
BGR,NOR,2014.0,2,0,2
SEN,GNB,2014.0,1,0,1
GNB,ISL,2018.0,1,0,1
CMR,BFA,2013.0,1,0,1
BEL,GMB,2009.0,1,0,1
CHL,QAT,2012.0,1,0,1
TWN,BEL,2005.0,1,0,1
IRL,UKR,2016.0,1,0,1
ISL,NCL,2020.0,1,0,1
BRA,LKA,2018.0,1,0,1
JPN,BRN,2014.0,1,0,1
AUT,PHL,2003.0,1,0,1
PHL,GUM,2006.0,1,0,1
ISR,SVN,2011.0,1,0,1
SGP,TUN,2015.0,1,0,1
MWI,ZAF,2005.0,4,0,4
SGP,MEX,2006.0,1,0,1
LUX,SWE,2008.0,1,0,1
KHM,FIN,2016.0,1,0,1
ZAF,GMB,2006.0,2,0,2
ISR,UGA,2009.0,1,0,1
FRA,ARE,2008.0,2,0,2
VEN,JPN,2016.0,1,0,1
TJK,LTU,2014.0,1,0,1
LTU,TJK,2018.0,1,0,1
POL,ARE,2018.0,1,0,1
UGA,ITA,2016.0,2,0,2
OMN,KOR,2011.0,1,0,1
ISL,CAN,2013.0,2,0,2
DZA,JOR,2016.0,2,0,2
MDA,NOR,2021.0,2,0,2
HND,AUS,2020.0,1,0,1
MNE,POL,2021.0,1,0,1
ETH,CZE,2018.0,1,0,1
,SMR,2010.0,1,0,1
,LSO,2020.0,9,0,9
BLR,GBR,2024.0,1,0,1
EGY,SWE,1999.0,3,0,3
PRT,AGO,2003.0,1,0,1
GEO,HUN,2012.0,1,0,1
ARG,PRT,2000.0,1,0,1
RUS,LBN,2003.0,1,0,1
ZAF,GRC,1997.0,1,0,1
KWT,MEX,1999.0,1,0,1
MLI,SEN,2005.0,1,0,1
HUN,SEN,2015.0,1,0,1
EST,AUS,1999.0,1,0,1
HUN,IRL,1999.0,1,0,1
AUS,MNG,2012.0,1,0,1
RUS,CRI,2007.0,1,0,1
AUS,BHR,1998.0,1,0,1
CHL,FLK,2005.0,1,0,1
SAU,CHL,2018.0,1,0,1
BHR,OMN,2012.0,1,0,1
ECU,PRT,2018.0,2,0,2
ITA,GEO,1998.0,1,0,1
EGY,IDN,1999.0,1,0,1
NZL,SVK,2010.0,1,0,1
PRY,BEL,2008.0,1,0,1
SEN,GNQ,2008.0,1,0,1
GTM,CRI,2014.0,1,0,1
CHE,SYR,2000.0,1,0,1
NZL,NCL,2018.0,1,0,1
CAN,GUY,2000.0,1,0,1
AZE,AUS,1999.0,1,0,1
RUS,FLK,2003.0,1,0,1
AFG,ZAF,2014.0,1,0,1
BGD,DNK,2001.0,1,0,1
MDA,TUR,2002.0,1,0,1
IRN,KEN,2010.0,1,0,1
MLT,JPN,2012.0,1,0,1
KWT,PAK,2011.0,1,0,1
CZE,COL,2012.0,1,0,1
VIR,,2013.0,2,0,2
NZL,ECU,2014.0,1,0,1
BRA,DOM,2019.0,2,0,2
FRO,DEU,2018.0,1,0,1
POL,BIH,2014.0,1,0,1
GUY,BLZ,2016.0,1,0,1
AZE,BEL,2001.0,1,0,1
MEX,FIN,2003.0,1,0,1
NAM,ISR,2015.0,1,0,1
HUN,KOR,2002.0,1,0,1
TWN,CZE,2015.0,3,0,3
PRT,PER,2023.0,2,0,2
GTM,COL,2018.0,1,0,1
SVK,MLT,2008.0,1,0,1
MWI,ETH,2019.0,1,0,1
USA,GUF,2018.0,1,0,1
IND,CYM,2021.0,1,0,1
AUT,JOR,2017.0,2,0,2
ZMB,NAM,2009.0,2,0,2
TJK,CHE,2017.0,1,0,1
NLD,DOM,2020.0,1,0,1
BGR,SGP,2015.0,1,0,1
CHN,SHN,2017.0,1,0,1
ARE,PSE,2021.0,1,0,1
BGD,LBN,2018.0,1,0,1
TUN,AUS,2017.0,1,0,1
ZMB,ESP,2018.0,1,0,1
,VIR,2014.0,1,0,1
TJK,IRN,2015.0,1,0,1
ROU,SVN,2020.0,1,0,1
DNK,UGA,2019.0,1,0,1
FIN,PER,2020.0,1,0,1
ITA,KWT,2018.0,1,0,1
BEL,KHM,2021.0,4,0,4
HKG,BLR,2020.0,1,0,1
ITA,GIN,2020.0,1,0,1
BRA,MLT,2021.0,1,0,1
GBR,TGO,2023.0,1,0,1
BLR,IRN,2018.0,2,0,2
KHM,SAU,2021.0,1,0,1
AUS,GIB,2021.0,1,0,1
BWA,,2000.0,3,0,3
IND,PNG,2013.0,2,0,2
CHL,PAN,2013.0,1,0,1
CHE,CIV,2015.0,3,0,3
USA,PLW,2009.0,1,0,1
FJI,NRU,2013.0,1,0,1
MOZ,PAK,2013.0,1,0,1
CZE,LTU,2008.0,2,0,2
JAM,AUS,2004.0,1,0,1
ZAF,GEO,2018.0,1,0,1
TUV,CCK,2010.0,1,0,1
BEN,ZAF,2013.0,1,0,1
,MHL,2001.0,1,0,1
BRA,LUX,2003.0,1,0,1
UZB,ESP,2007.0,1,0,1
ZAF,EST,2010.0,1,0,1
GBR,GAB,2004.0,1,0,1
AUT,NPL,2011.0,1,0,1
BRN,VEN,2020.0,1,0,1
CZE,ARG,1998.0,1,0,1
JPN,HRV,2018.0,2,0,2
ARG,ECU,2006.0,2,0,2
KWT,TWN,2019.0,1,0,1
FRA,BRB,2008.0,1,0,1
CUB,ZAF,2007.0,1,0,1
GTM,DOM,2022.0,1,0,1
IRQ,CRI,2007.0,1,0,1
DOM,FRA,2007.0,1,0,1
UKR,ZAF,2004.0,1,0,1
ROU,DNK,2004.0,3,0,3
GAB,CMR,2011.0,1,0,1
ARG,PRY,2014.0,1,0,1
USA,CUW,2023.0,1,0,1
RUS,CMR,2020.0,1,0,1
GBR,AFG,2006.0,1,0,1
PAK,ISR,2020.0,1,0,1
NGA,MAR,2020.0,1,0,1
IRL,ISL,2023.0,1,0,1
EGY,ZWE,2022.0,1,0,1
MDG,COG,2022.0,1,0,1
EST,BIH,2021.0,1,0,1
NPL,OMN,2022.0,1,0,1
MDG,BRA,2020.0,1,0,1
BLR,AUT,2002.0,1,0,1
MCO,ESP,2010.0,1,0,1
DMA,,2011.0,1,0,1
PRY,AUS,2002.0,1,0,1
CYP,IRN,2006.0,1,0,1
POL,EST,2018.0,1,0,1
ZWE,IDN,2004.0,1,0,1
ISR,CRI,2000.0,1,0,1
CUB,GNQ,2020.0,2,0,2
WSM,,2001.0,2,0,2
GUY,GUF,2002.0,1,0,1
SVK,UGA,2016.0,1,0,1
MDV,,2007.0,1,0,1
NLD,BLR,1997.0,1,0,1
IND,ERI,2001.0,1,0,1
SGP,BRA,2007.0,1,0,1
FLK,,2017.0,2,0,2
PRY,QAT,2022.0,1,0,1
SWZ,ESP,2014.0,1,0,1
MDG,CHE,2013.0,1,0,1
ESP,ARE,2011.0,1,0,1
PRI,VGB,2009.0,1,0,1
USA,SHN,2018.0,1,0,1
DOM,ESP,1998.0,1,0,1
BRA,CYP,2021.0,1,0,1
IND,LAO,2015.0,1,0,1
BGD,MMR,2018.0,1,0,1
BEL,SAU,2005.0,1,0,1
CYM,GRD,2013.0,1,0,1
PSE,JPN,2014.0,1,0,1
JPN,PSE,2022.0,1,0,1
BFA,KEN,2015.0,1,0,1
ARG,PAN,2017.0,1,0,1
NPL,TJK,2020.0,1,0,1
UGA,SDN,2012.0,1,0,1
NOR,MKD,2015.0,1,0,1
GRC,GEO,2011.0,1,0,1
OMN,BRN,2012.0,1,0,1
BEL,BWA,2023.0,1,0,1
KOR,AZE,2015.0,1,0,1
CUB,SVK,2022.0,1,0,1
MNG,ITA,2022.0,1,0,1
FIN,SDN,2021.0,1,0,1
BEN,PHL,2015.0,1,0,1
FIN,MUS,2019.0,1,0,1
ROU,RUS,2007.0,2,0,2
ESP,NER,2019.0,1,0,1
NLD,SLB,2015.0,1,0,1
BGD,KHM,2020.0,1,0,1
CMR,GTM,2013.0,1,0,1
JPN,MNE,2011.0,1,0,1
MAR,NLD,2018.0,1,0,1
KOR,CHL,2001.0,1,0,1
MEX,LKA,2022.0,1,0,1
RUS,MAR,2015.0,1,0,1
BEN,RWA,2022.0,1,0,1
,DMA,1995.0,2,0,2
KHM,CAF,2010.0,1,0,1
ARE,FJI,2021.0,1,0,1
VNM,HKG,2019.0,2,0,2
CHN,BWA,2017.0,1,0,1
GUY,GAB,2020.0,1,0,1
EUE,,2008.0,1,0,1
DOM,ARG,2009.0,1,0,1
DNK,SEN,2002.0,1,0,1
IDN,ZAF,2020.0,1,0,1
SRB,MLT,2002.0,1,0,1
IRN,KWT,2013.0,1,0,1
CYP,UGA,2017.0,1,0,1
SYR,HUN,2021.0,3,0,3
GBR,AGO,2009.0,1,0,1
PER,VNM,2010.0,1,0,1
TUR,SVN,2018.0,1,0,1
MDG,ITA,2021.0,1,0,1
ETH,IRQ,2023.0,1,0,1
GEO,DNK,2023.0,1,0,1
IRL,JAM,2008.0,1,0,1
CAN,MWI,2001.0,1,0,1
USA,BDI,1998.0,1,0,1
SAU,TWN,1998.0,1,0,1
PER,EGY,2009.0,1,0,1
ZAF,TUR,2001.0,1,0,1
CUB,GTM,2006.0,1,0,1
SGP,CZE,2012.0,1,0,1
HUN,TUN,2015.0,1,0,1
CUB,CRI,2012.0,1,0,1
BWA,UGA,2016.0,1,0,1
TZA,DNK,2020.0,2,0,2
MDV,,2020.0,2,0,2
PHL,CUB,2001.0,1,0,1
CYP,GEO,2017.0,1,0,1
GAB,MAR,2005.0,1,0,1
KAZ,MDA,2018.0,1,0,1
LBY,SAU,2016.0,2,0,2
NGA,CZE,2019.0,1,0,1
HKG,BTN,2016.0,1,0,1
GHA,BFA,2009.0,1,0,1
AUS,MLT,2011.0,1,0,1
TUR,EST,2017.0,1,0,1
MDA,CHE,2019.0,2,0,2
SWZ,NAM,2022.0,1,0,1
VCT,CUW,2021.0,1,0,1
FRA,HND,2021.0,1,0,1
RUS,NGA,2020.0,1,0,1
SVK,CHN,2024.0,1,0,1
MDA,,2026.0,1,0,1
SRB,ISL,2008.0,1,0,1
TUR,LVA,2022.0,1,0,1
ROU,CMR,2021.0,1,0,1
BOL,JPN,2020.0,1,0,1
GBR,SOM,2020.0,1,0,1
TUN,ITA,2024.0,1,0,1
COG,ESP,2023.0,1,0,1
ABW,,2017.0,1,0,1
PAK,GEO,2023.0,1,0,1
THA,EST,2020.0,1,0,1
MNG,GBR,1997.0,3,0,3
YEM,,2000.0,2,0,2
KWT,BGR,2009.0,1,0,1
NGA,SWZ,2004.0,1,0,1
CMR,KEN,2005.0,2,0,2
ESP,SDN,2007.0,1,0,1
BGR,BIH,2003.0,1,0,1
GUY,TTO,2007.0,1,0,1
NLD,BFA,2020.0,1,0,1
GUM,,2007.0,1,0,1
SVK,NOR,1998.0,3,0,3
LBY,IND,2004.0,1,0,1
AUS,BIH,1999.0,1,0,1
PRT,HRV,2020.0,1,0,1
SGP,EST,2019.0,1,0,1
ZWE,BWA,2007.0,2,0,2
HRV,POL,2005.0,1,0,1
GRC,MYS,2013.0,1,0,1
DEU,FJI,1999.0,1,0,1
MUS,FRA,1999.0,1,0,1
BFA,CMR,2006.0,1,0,1
QAT,SDN,2009.0,1,0,1
USA,MNG,2008.0,2,0,2
KWT,LBN,2002.0,1,0,1
ESP,JOR,2005.0,1,0,1
PAN,PRI,2003.0,1,0,1
VNM,VEN,2009.0,2,0,2
,AGO,2000.0,3,0,3
HUN,BGR,2010.0,1,0,1
SGP,CMR,2011.0,1,0,1
CIV,CMR,2008.0,1,0,1
BRA,IRN,2002.0,1,0,1
PAK,ITA,2005.0,1,0,1
RWA,USA,2003.0,1,0,1
CIV,IDN,2016.0,1,0,1
BGD,KHM,2007.0,1,0,1
ESP,GEO,2012.0,1,0,1
ZAF,HRV,2010.0,1,0,1
SDN,IND,2019.0,1,0,1
PRT,NOR,2006.0,1,0,1
GBR,LCA,2003.0,1,0,1
USA,BRB,2003.0,1,0,1
TUR,CHL,2010.0,1,0,1
PER,VEN,2004.0,1,0,1
PRT,FLK,2008.0,1,0,1
FLK,PRT,2009.0,3,0,3
ITA,LBN,2001.0,3,0,3
PYF,NCL,1999.0,1,0,1
PER,DNK,2004.0,1,0,1
CAN,REU,2015.0,1,0,1
BGR,LUX,2011.0,1,0,1
FRA,FJI,2011.0,1,0,1
LBY,OMN,2013.0,1,0,1
BGD,SWE,2003.0,1,0,1
LTU,AUS,2003.0,1,0,1
,BLZ,1999.0,1,0,1
ZMB,PHL,2013.0,1,0,1
NLD,LUX,2007.0,2,0,2
CUB,SWE,2007.0,1,0,1
PSE,DEU,2001.0,1,0,1
BEL,RWA,2005.0,1,0,1
ZMB,BIH,2014.0,1,0,1
IND,CYM,2009.0,1,0,1
GBR,ARM,2015.0,1,0,1
MDA,GBR,2018.0,1,0,1
ARE,BHR,2016.0,2,0,2
ITA,LSO,2001.0,1,0,1
ARE,DNK,2016.0,1,0,1
GLP,USA,2011.0,2,0,2
PRT,CYP,2017.0,1,0,1
BRA,VNM,2015.0,1,0,1
PRI,PER,2016.0,1,0,1
CAN,MAC,2010.0,1,0,1
IDN,COD,2016.0,1,0,1
ETH,SSD,2013.0,1,0,1
SSD,EGY,2020.0,1,0,1
SAU,MRT,2022.0,1,0,1
BEN,BDI,2017.0,1,0,1
DNK,SVK,2019.0,1,0,1
ARM,BEL,2021.0,1,0,1
TLS,AUS,2020.0,1,0,1
AUS,TON,2021.0,1,0,1
GTM,NZL,2020.0,1,0,1
ISR,CYP,2020.0,1,0,1
PRI,IND,2014.0,1,0,1
QAT,IDN,2021.0,1,0,1
LTU,NZL,2020.0,1,0,1
GUM,BEL,2007.0,1,0,1
BEL,SYR,2001.0,1,0,1
DNK,FRO,1998.0,1,0,1
BLR,MDA,2016.0,1,0,1
ITA,OMN,2010.0,1,0,1
THA,BGD,1997.0,1,0,1
COD,AUT,2013.0,1,0,1
NLD,LVA,2009.0,1,0,1
PHL,BRA,1998.0,1,0,1
RWA,CIV,2005.0,1,0,1
ITA,MLT,2000.0,1,0,1
SLV,CZE,2009.0,1,0,1
BFA,BEL,2005.0,1,0,1
POL,NCL,2012.0,2,0,2
THA,IRL,2003.0,1,0,1
MAR,ZAF,2012.0,1,0,1
EGY,HUN,2001.0,1,0,1
SMR,,2000.0,1,0,1
PRT,DZA,2001.0,1,0,1
ARG,FIN,2000.0,1,0,1
TZA,ZWE,1998.0,1,0,1
ISR,PHL,2006.0,1,0,1
DNK,MKD,2004.0,1,0,1
GTM,DOM,2016.0,1,0,1
TJK,USA,2004.0,1,0,1
BLR,GRC,2002.0,1,0,1
GHA,ITA,2001.0,1,0,1
ESP,KOR,1997.0,3,0,3
PRY,USA,2004.0,1,0,1
LBN,QAT,2010.0,1,0,1
COL,CHE,1999.0,1,0,1
ISR,ISL,2001.0,1,0,1
MUS,NOR,2005.0,1,0,1
PER,CHN,2007.0,1,0,1
TUN,MLI,2012.0,1,0,1
JPN,BRN,2001.0,1,0,1
BGD,CHN,2005.0,2,0,2
SVK,BRA,2002.0,1,0,1
MDG,JPN,1997.0,1,0,1
MEX,ROU,2016.0,1,0,1
NPL,AUS,2007.0,2,0,2
CAN,MDV,2004.0,1,0,1
DNK,ARM,1997.0,1,0,1
PRY,VEN,2001.0,1,0,1
JEY,,2025.0,1,0,1
MSR,TTO,2010.0,1,0,1
IND,MSR,2014.0,1,0,1
BWA,UGA,2022.0,1,0,1
ESP,ARE,2009.0,1,0,1
KEN,SEN,2023.0,1,0,1
BIH,BWA,2014.0,1,0,1
EST,NZL,2014.0,1,0,1
MWI,PNG,2012.0,1,0,1
NOR,GTM,2021.0,1,0,1
GIB,CAN,2013.0,1,0,1
THA,UGA,2022.0,1,0,1
NIC,AUS,2018.0,1,0,1
GHA,FRA,2010.0,1,0,1
BHR,OMN,1997.0,1,0,1
NLD,MLI,2017.0,2,0,2
SEN,TUN,2014.0,1,0,1
NIC,SLV,2018.0,1,0,1
SLV,NIC,2021.0,1,0,1
MOZ,MWI,2011.0,1,0,1
SLV,ESP,2008.0,1,0,1
TWN,PAN,2018.0,1,0,1
PAN,TWN,2020.0,1,0,1
DEU,MOZ,2011.0,1,0,1
DZA,LUX,2021.0,1,0,1
SWZ,BEL,2016.0,1,0,1
CHN,PHL,1999.0,1,0,1
CIV,CAN,2015.0,1,0,1
NZL,MMR,2016.0,2,0,2
SAU,TZA,2019.0,1,0,1
BIH,CHE,2020.0,1,0,1
EST,TWN,2023.0,1,0,1
THA,NAM,2019.0,1,0,1
IRN,EST,2018.0,4,0,4
UGA,AUT,2000.0,1,0,1
NOR,CYP,2011.0,1,0,1
BEL,GHA,2002.0,1,0,1
HRV,DNK,2006.0,1,0,1
DNK,SDN,2003.0,1,0,1
ZMB,BEN,2013.0,1,0,1
DZA,POL,2001.0,1,0,1
ITA,BDI,2012.0,1,0,1
ZAF,CZE,2009.0,1,0,1
CZE,SAU,2008.0,1,0,1
BOL,CHE,2001.0,1,0,1
CAN,HTI,2013.0,1,0,1
SGP,CHL,2010.0,2,0,2
ETH,ZWE,1999.0,1,0,1
LBN,TUN,2006.0,1,0,1
ZWE,MWI,2008.0,2,0,2
LBN,DEU,2001.0,1,0,1
WSM,USA,2001.0,1,0,1
SPM,FRA,2013.0,1,0,1
GRC,COL,2021.0,1,0,1
COL,BEN,2022.0,1,0,1
MNG,NLD,2004.0,1,0,1
,SUR,1999.0,2,0,2
TZA,THA,2004.0,1,0,1
CZE,COG,2008.0,1,0,1
FRA,TJK,2013.0,1,0,1
SWE,JOR,2007.0,1,0,1
CHE,COD,2020.0,1,0,1
BEL,LKA,2015.0,2,0,2
SMR,CZE,2017.0,1,0,1
RUS,BIH,1999.0,1,0,1
ESP,PYF,2000.0,1,0,1
COG,TZA,2023.0,1,0,1
ZMB,BWA,1998.0,1,0,1
FIN,TWN,2011.0,1,0,1
PSE,FIN,2015.0,1,0,1
ARE,CMR,2020.0,1,0,1
ZAF,KWT,2019.0,1,0,1
BHR,ZAF,2015.0,1,0,1
ZWE,BEL,2017.0,1,0,1
IRL,IRQ,2022.0,1,0,1
BLZ,BEN,2018.0,2,0,2
TUN,ZAF,2013.0,1,0,1
MDA,MDV,2013.0,1,0,1
GHA,ESP,2015.0,1,0,1
ECU,PER,2013.0,2,0,2
NZL,CCK,2018.0,1,0,1
MYS,SRB,2013.0,1,0,1
NPL,SAU,2018.0,1,0,1
ZMB,CHL,2021.0,1,0,1
CIV,NGA,2015.0,2,0,2
BGD,POL,2015.0,1,0,1
CAN,BHS,2016.0,1,0,1
ZAF,IRQ,2018.0,1,0,1
BEL,TCD,2014.0,1,0,1
ROU,BRA,2011.0,1,0,1
GBR,GNB,2016.0,1,0,1
ZAF,GHA,1999.0,1,0,1
HKG,TWN,1999.0,5,0,5
CHL,PAN,2015.0,1,0,1
ATG,,2020.0,2,0,2
CHN,CZE,1998.0,2,0,2
USA,MUS,1998.0,1,0,1
PHL,CHN,2004.0,4,0,4
CHN,MEX,2002.0,3,0,3
MMR,,2003.0,4,0,4
MKD,BIH,2010.0,1,0,1
,LAO,2005.0,37,0,37
,GRD,2005.0,8,0,8
GNB,,2002.0,1,0,1
VEN,CHN,2016.0,1,0,1
SRB,GRC,2009.0,9,0,9
ZMB,ITA,2000.0,1,0,1
PSE,BEL,2008.0,1,0,1
BEL,PSE,2011.0,1,0,1
ARG,CZE,2007.0,1,0,1
,STP,1999.0,1,0,1
ZAF,GMB,2021.0,2,0,2
DNK,NPL,2006.0,2,0,2
BGD,CHN,2007.0,1,0,1
CIV,BDI,2013.0,1,0,1
GLP,,2014.0,5,0,5
JOR,EGY,2008.0,3,0,3
ESP,ALB,2018.0,4,0,4
NZL,FLK,2019.0,2,0,2
KWT,NZL,2007.0,1,0,1
LBR,GBR,1997.0,1,0,1
BMU,NZL,2008.0,1,0,1
NLD,TGO,2005.0,1,0,1
SLE,GIN,2003.0,1,0,1
DEU,MOZ,2000.0,1,0,1
BEL,ISL,2009.0,1,0,1
IRQ,AUT,2006.0,1,0,1
ISR,REU,2007.0,1,0,1
GBR,UZB,2019.0,3,0,3
FIN,PSE,2008.0,1,0,1
KOR,PRT,2013.0,6,0,6
GMB,ETH,2003.0,1,0,1
NZL,GRC,2010.0,2,0,2
DOM,GBR,2012.0,1,0,1
KEN,SLE,2017.0,1,0,1
FLK,GBR,2012.0,1,0,1
ERI,,2013.0,8,0,8
LTU,IRL,2010.0,1,0,1
SLV,,2014.0,3,0,3
PAK,IRQ,2014.0,1,0,1
SLE,ZWE,2018.0,1,0,1
IRL,BIH,2021.0,1,0,1
VNM,SGP,2001.0,2,0,2
ERI,ZAF,2009.0,1,0,1
NGA,NOR,2016.0,2,0,2
NOR,NGA,2017.0,2,0,2
MEX,QAT,2013.0,1,0,1
ARE,BRA,2012.0,2,0,2
GHA,SDN,2008.0,1,0,1
ISR,KEN,2013.0,1,0,1
ITA,MAR,2016.0,5,0,5
BLR,CHN,2015.0,6,0,6
MYS,VNM,2012.0,5,0,5
KEN,JOR,2016.0,1,0,1
MAR,BFA,2017.0,4,0,4
TWN,IRL,2020.0,2,0,2
MRT,,2015.0,6,0,6
ZWE,KOR,2020.0,5,0,5
AUS,BGR,2012.0,3,0,3
DEU,KWT,2008.0,1,0,1
HKG,LUX,2015.0,1,0,1
MEX,TWN,2012.0,1,0,1
SVK,LBY,2019.0,1,0,1
IDN,BGD,2015.0,1,0,1
GRD,TTO,2021.0,1,0,1
VUT,MDG,2017.0,1,0,1
,TKM,2011.0,3,0,3
PAN,ARG,2019.0,1,0,1
VNM,KWT,2023.0,1,0,1
KEN,LUX,2021.0,1,0,1
HND,,2016.0,13,0,13
LCA,,2020.0,4,0,4
AUT,AFG,2019.0,1,0,1
NGA,HTI,2021.0,1,0,1
MLI,GIN,2015.0,1,0,1
NZL,ISR,2019.0,1,0,1
MAR,THA,2010.0,1,0,1
GUF,TUN,2018.0,1,0,1
PRT,AZE,2019.0,2,0,2
ISR,NGA,2023.0,1,0,1
,BMU,2018.0,2,0,2
PLW,USA,2013.0,1,0,1
MOZ,CHE,2021.0,1,0,1
NLD,ABW,2018.0,2,0,2
BLR,BEL,2022.0,1,0,1
LVA,,2026.0,13,0,13
,BDI,2019.0,15,0,15
BIH,CHE,2002.0,1,0,1
ITA,TWN,1999.0,2,0,2
ETH,RWA,2001.0,1,0,1
RWA,ETH,2008.0,1,0,1
BRA,PRI,2006.0,1,0,1
,MCO,1996.0,11,0,11
SWE,ARE,2002.0,2,0,2
ZAF,BGR,2011.0,1,0,1
MKD,USA,2006.0,2,0,2
TUR,BRA,2000.0,1,0,1
HUN,SVN,1997.0,2,0,2
CHE,LKA,1997.0,1,0,1
MWI,KEN,2004.0,1,0,1
SWE,CMR,2020.0,1,0,1
JOR,PSE,2000.0,2,0,2
AGO,ITA,2012.0,1,0,1
FRA,NGA,1997.0,3,0,3
RUS,SHN,2017.0,3,0,3
CAN,TZA,1998.0,1,0,1
,HTI,2000.0,4,0,4
SGP,IRL,2005.0,1,0,1
PHL,FJI,2019.0,1,0,1
JPN,PRT,1999.0,2,0,2
NOR,BRA,1998.0,1,0,1
SLE,HTI,1998.0,1,0,1
ISR,ISL,2013.0,4,0,4
AUS,SLB,1997.0,1,0,1
USA,QAT,2004.0,12,0,12
RUS,MYS,2013.0,2,0,2
GRC,TUR,1999.0,1,0,1
,AGO,1994.0,3,0,3
BOL,GBR,2017.0,2,0,2
FIN,SAU,2006.0,1,0,1
POL,SGP,2002.0,1,0,1
BFA,TGO,2003.0,1,0,1
DEU,LIE,1997.0,3,0,3
SEN,PHL,2005.0,1,0,1
CHN,PNG,2009.0,1,0,1
MLT,FRA,2001.0,1,0,1
GRL,,2002.0,2,0,2
BGR,FIN,1998.0,2,0,2
CZE,HKG,2003.0,1,0,1
ETH,MAR,1998.0,1,0,1
PHL,BRA,1997.0,1,0,1
THA,ARE,2006.0,1,0,1
MWI,KEN,2001.0,1,0,1
LBY,PSE,2020.0,1,0,1
UKR,NZL,2015.0,2,0,2
OMN,FIN,2019.0,1,0,1
CUB,HND,2009.0,1,0,1
ARG,BOL,2019.0,3,0,3
POL,TUR,2009.0,2,0,2
DEU,RWA,2009.0,2,0,2
CUB,UGA,2022.0,1,0,1
LVA,KAZ,2015.0,1,0,1
EST,SGP,2013.0,2,0,2
TJK,JPN,2018.0,1,0,1
JPN,TJK,2020.0,1,0,1
SRB,SAU,2019.0,2,0,2
BGR,KWT,2014.0,1,0,1
CUB,YEM,2015.0,1,0,1
KWT,NLD,2013.0,1,0,1
USA,BHR,2013.0,4,0,4
BFA,FIN,2010.0,1,0,1
CIV,BEN,2016.0,1,0,1
LTU,DNK,2009.0,1,0,1
VEN,BEL,2013.0,1,0,1
ZMB,NAM,2000.0,1,0,1
,FSM,2006.0,4,0,4
PHL,NZL,2008.0,2,0,2
,MMR,2000.0,14,0,14
MCO,AUS,2015.0,1,0,1
AUS,MCO,2016.0,1,0,1
CYM,,2020.0,2,0,2
AUS,JAM,2016.0,2,0,2
ZWE,NLD,2009.0,1,0,1
SYR,CYP,2011.0,1,0,1
CMR,PAK,2017.0,1,0,1
DNK,BGR,2017.0,2,0,2
ARM,SAU,2002.0,1,0,1
MKD,,2007.0,13,0,13
AUS,KIR,2014.0,2,0,2
,ATG,2010.0,1,0,1
AUS,MHL,2014.0,1,0,1
,ASM,2012.0,3,0,3
ARM,FRA,2015.0,2,0,2
OMN,NGA,2020.0,1,0,1
ATG,ESP,2023.0,2,0,2
NGA,ISR,2015.0,2,0,2
CHN,LAO,2017.0,2,0,2
SYR,LBN,2015.0,2,0,2
MLI,IND,2002.0,1,0,1
MEX,BOL,2023.0,1,0,1
,AGO,2009.0,12,0,12
DNK,PHL,2000.0,2,0,2
USA,GRL,2004.0,1,0,1
KOR,KWT,2000.0,1,0,1
JEY,,2024.0,3,0,3
EGY,BLZ,2019.0,1,0,1
DNK,ARE,2015.0,3,0,3
CHL,CIV,2019.0,1,0,1
BEL,RWA,1999.0,1,0,1
PAK,SYR,2000.0,1,0,1
CZE,PRT,2001.0,1,0,1
UKR,IRN,2002.0,1,0,1
KEN,PHL,2001.0,1,0,1
NCL,ESP,2020.0,1,0,1
KEN,ZWE,2008.0,2,0,2
PRT,OMN,2015.0,1,0,1
EGY,SDN,2016.0,2,0,2
CHL,ROU,2011.0,1,0,1
IRN,LTU,2020.0,1,0,1
PSE,LBN,2021.0,1,0,1
MDV,TLS,2022.0,1,0,1
MEX,PRI,2022.0,2,0,2
FIN,KWT,2014.0,1,0,1
SAU,VNM,2016.0,1,0,1
CMR,IND,2018.0,2,0,2
,GIB,2017.0,1,0,1
ZAF,SVK,2021.0,2,0,2
GRC,ISL,2000.0,1,0,1
KOR,OMN,2012.0,1,0,1
GBR,PSE,2006.0,3,0,3
SYR,LBN,2014.0,5,0,5
SRB,ZAF,1999.0,2,0,2
PRT,AGO,2004.0,1,0,1
ISR,ARE,2004.0,1,0,1
PAN,AUS,2013.0,1,0,1
QAT,DNK,2011.0,1,0,1
ARM,TWN,2001.0,2,0,2
CHL,NLD,1997.0,1,0,1
RUS,THA,2000.0,2,0,2
THA,RUS,2001.0,1,0,1
SRB,PRT,2000.0,1,0,1
GBR,DZA,1999.0,3,0,3
UGA,GHA,2002.0,1,0,1
NLD,KAZ,2019.0,2,0,2
MEX,PRT,1997.0,1,0,1
LKA,BRN,2006.0,1,0,1
AUS,SLB,2005.0,2,0,2
,LBR,2002.0,2,0,2
ARE,PNG,2020.0,1,0,1
CHE,PER,2014.0,3,0,3
ARG,GTM,2008.0,1,0,1
ECU,CRI,2011.0,1,0,1
GRC,CHN,1997.0,5,0,5
DEU,HND,2017.0,1,0,1
ALB,COL,2015.0,1,0,1
GMB,ZAF,2004.0,1,0,1
SLE,,2013.0,5,0,5
MMR,FRA,2015.0,1,0,1
THA,AFG,2015.0,1,0,1
DNK,BOL,2016.0,2,0,2
DNK,LAO,2015.0,1,0,1
LTU,POL,2011.0,1,0,1
NER,,2014.0,8,0,8
ESP,HKG,1999.0,2,0,2
AUT,UGA,2011.0,1,0,1
COL,RUS,2009.0,2,0,2
RUS,COL,2010.0,1,0,1
NZL,ISR,2011.0,1,0,1
TWN,GHA,2019.0,1,0,1
ROU,NGA,2014.0,1,0,1
CZE,NGA,2015.0,2,0,2
HTI,GBR,2015.0,1,0,1
GBR,TGO,2021.0,1,0,1
AUS,KAZ,2022.0,3,0,3
BRN,GHA,2017.0,2,0,2
GRC,MKD,2020.0,2,0,2
UZB,KOR,2001.0,2,0,2
GRD,ZAF,2018.0,1,0,1
ABW,CUW,2022.0,1,0,1
BGD,CYP,2015.0,1,0,1
TUR,ALB,2017.0,3,0,3
MYS,LTU,2018.0,1,0,1
CAN,HTI,2015.0,1,0,1
COG,COM,2014.0,1,0,1
LBN,BGR,2019.0,1,0,1
,TON,2011.0,2,0,2
CHN,BDI,2018.0,1,0,1
CZE,IRL,2014.0,3,0,3
MEX,COD,2019.0,1,0,1
,ABW,2014.0,1,0,1
ABW,BEL,2017.0,1,0,1
ESP,BLR,2019.0,1,0,1
MRT,NLD,2019.0,1,0,1
BEL,GIN,2017.0,1,0,1
JPN,RWA,2020.0,1,0,1
KGZ,TWN,2019.0,1,0,1
COD,MAR,2021.0,1,0,1
HTI,FRA,2009.0,4,0,4
LTU,TUN,2017.0,1,0,1
PER,MMR,2018.0,1,0,1
UKR,LSO,1997.0,1,0,1
LSO,ZAF,2001.0,2,0,2
SLE,CAN,2017.0,2,0,2
NGA,BWA,2009.0,3,0,3
USA,TCA,2013.0,1,0,1
PRT,SVN,2020.0,2,0,2
MEX,SVN,2023.0,1,0,1
KEN,GUY,2020.0,1,0,1
FRA,DJI,2022.0,2,0,2
BEN,GHA,2020.0,1,0,1
BGD,AFG,2019.0,1,0,1
JPN,AFG,2009.0,1,0,1
RUS,SOM,2020.0,1,0,1
,SSD,2015.0,1,0,1
BGD,KEN,2018.0,2,0,2
,DJI,2013.0,2,0,2
IRN,FRA,2024.0,2,0,2
LIE,USA,2022.0,1,0,1
ARG,IND,2001.0,2,0,2
BEN,TWN,2022.0,1,0,1
ZAF,THA,2011.0,1,0,1
CZE,MNG,2022.0,1,0,1
,FRO,2020.0,8,0,8
MWI,,2002.0,7,0,7
ISL,LAO,2002.0,1,0,1
ITA,GTM,1998.0,1,0,1
SWE,KWT,2010.0,1,0,1
HRV,TUR,1999.0,1,0,1
USA,BFA,2005.0,2,0,2
LUX,BLR,2013.0,1,0,1
HUN,ECU,2019.0,1,0,1
ESP,COG,2009.0,2,0,2
GRC,BRN,2018.0,1,0,1
UZB,DEU,2003.0,3,0,3
,BLZ,2002.0,4,0,4
FRA,CYP,1999.0,2,0,2
PHL,THA,2000.0,2,0,2
MDA,ROU,2004.0,2,0,2
RUS,KHM,2015.0,1,0,1
UZB,LTU,1998.0,1,0,1
SVN,NLD,2003.0,5,0,5
CHN,AZE,2010.0,1,0,1
NGA,THA,2005.0,1,0,1
CAN,ATG,2014.0,1,0,1
VGB,TTO,2010.0,1,0,1
TTO,CYM,2011.0,1,0,1
HRV,OMN,2020.0,1,0,1
NOR,EGY,2005.0,1,0,1
CAN,PSE,2006.0,1,0,1
ALB,,2001.0,2,0,2
ESP,ARE,2006.0,1,0,1
BIH,NOR,2016.0,2,0,2
HUN,JOR,2005.0,1,0,1
WSM,,2003.0,1,0,1
GLP,,2008.0,9,0,9
,FLK,1999.0,2,0,2
AUT,GHA,2000.0,1,0,1
NIC,,2006.0,3,0,3
CHN,ZAF,2001.0,5,0,5
AUT,IDN,2009.0,3,0,3
ISR,KEN,2003.0,2,0,2
GEO,ARE,2015.0,1,0,1
TTO,NGA,2017.0,1,0,1
GRC,TUR,1998.0,1,0,1
THA,SAU,2007.0,1,0,1
CMR,NER,2020.0,2,0,2
SWE,PHL,2020.0,1,0,1
JPN,PLW,2019.0,1,0,1
VUT,NCL,2007.0,2,0,2
MYS,NZL,1999.0,1,0,1
CHN,PRI,2020.0,1,0,1
,FRO,1998.0,1,0,1
GIB,,2006.0,1,0,1
POL,MOZ,2017.0,1,0,1
OMN,QAT,2001.0,1,0,1
CHN,FRO,2019.0,1,0,1
USA,ATG,2009.0,1,0,1
BRN,ARE,1998.0,1,0,1
NOR,BLR,2003.0,1,0,1
HUN,KOR,1999.0,1,0,1
BWA,NLD,2010.0,1,0,1
NLD,THA,1997.0,1,0,1
ZWE,BWA,2005.0,3,0,3
GMB,MWI,2011.0,1,0,1
CYP,KAZ,2016.0,1,0,1
BEN,MLI,2021.0,1,0,1
PRT,AGO,2015.0,7,0,7
FRA,GEO,2022.0,1,0,1
RUS,KEN,2011.0,3,0,3
PER,DEU,1998.0,1,0,1
MKD,,1999.0,2,0,2
UKR,KAZ,1997.0,1,0,1
RWA,BDI,2017.0,1,0,1
MDV,MDA,2012.0,2,0,2
LSO,,1999.0,1,0,1
LBN,IRL,2015.0,2,0,2
GRC,IRN,2017.0,2,0,2
KEN,COG,2005.0,1,0,1
DZA,CHL,2009.0,1,0,1
GRD,TTO,2009.0,5,0,5
FRA,MDA,2021.0,1,0,1
DNK,GHA,2001.0,4,0,4
GUF,IRN,2004.0,1,0,1
LUX,MAR,2007.0,1,0,1
VNM,ETH,2019.0,1,0,1
SVN,DNK,2009.0,1,0,1
BEL,LVA,2010.0,2,0,2
LVA,BEL,2011.0,1,0,1
BOL,SWE,2001.0,1,0,1
PRT,AGO,2008.0,1,0,1
,LSO,2005.0,5,0,5
BLR,BRA,2015.0,2,0,2
POL,IRQ,2004.0,1,0,1
BLR,ZAF,2011.0,1,0,1
CHL,SGP,2003.0,1,0,1
JOR,MAR,2017.0,1,0,1
DEU,SWZ,2015.0,1,0,1
SWZ,,2019.0,11,0,11
DZA,ISR,2017.0,1,0,1
CHN,NCL,2023.0,1,0,1
PRT,ARE,2022.0,1,0,1
HUN,VEN,2006.0,2,0,2
IRQ,DZA,2007.0,1,0,1
BLR,NOR,2010.0,1,0,1
SRB,BGR,2005.0,4,0,4
MOZ,CHE,2019.0,1,0,1
BGR,NZL,1998.0,1,0,1
CAN,NCL,1997.0,1,0,1
NCL,CAN,2003.0,1,0,1
KOR,IRQ,2020.0,2,0,2
PHL,ARG,1999.0,2,0,2
AUS,FLK,2000.0,1,0,1
TTO,GRD,2018.0,1,0,1
ETH,IRL,2021.0,2,0,2
,GNQ,2014.0,9,0,9
PRI,GRC,2009.0,1,0,1
,AFG,2009.0,23,0,23
ITA,ARE,2014.0,2,0,2
GBR,MCO,2003.0,2,0,2
NAM,AUS,2019.0,1,0,1
ECU,JPN,2005.0,1,0,1
LBN,QAT,2011.0,2,0,2
LBY,DZA,2007.0,1,0,1
ARG,COL,1998.0,1,0,1
ZMB,BWA,1997.0,1,0,1
USA,NER,2010.0,1,0,1
DNK,LVA,1998.0,2,0,2
IRN,QAT,2006.0,3,0,3
QAT,IRN,2007.0,2,0,2
POL,BWA,2002.0,1,0,1
VCT,USA,2014.0,2,0,2
MEX,SWE,1998.0,3,0,3
KNA,,2016.0,2,0,2
IND,EGY,2002.0,1,0,1
MYS,KGZ,2012.0,1,0,1
JPN,KHM,2004.0,1,0,1
LAO,SWE,2009.0,1,0,1
GMB,BGD,2003.0,1,0,1
NLD,LTU,2006.0,2,0,2
SWE,URY,2009.0,2,0,2
DZA,OMN,1999.0,3,0,3
CIV,CMR,2003.0,1,0,1
COL,KEN,2009.0,1,0,1
RUS,LUX,2021.0,2,0,2
SWZ,ITA,2000.0,1,0,1
CHE,GUF,2010.0,1,0,1
EST,LTU,2005.0,1,0,1
RUS,MAR,2013.0,1,0,1
MNG,USA,1998.0,2,0,2
AUT,HKG,1999.0,1,0,1
BGR,CYP,1998.0,1,0,1
DOM,CRI,2012.0,1,0,1
NAM,SWE,2004.0,1,0,1
CHN,NGA,1999.0,1,0,1
UZB,SWE,2002.0,1,0,1
ROU,MCO,2022.0,1,0,1
COD,UGA,1999.0,1,0,1
ARM,ITA,2003.0,3,0,3
RUS,IND,2006.0,1,0,1
MEX,SVN,2000.0,1,0,1
PYF,NCL,2005.0,2,0,2
PAK,ITA,1998.0,3,0,3
VEN,ITA,2013.0,7,0,7
LVA,FIN,1997.0,1,0,1
SEN,ZAF,2008.0,3,0,3
FIN,BRB,2000.0,1,0,1
HKG,TUR,2006.0,1,0,1
BGR,MEX,1998.0,2,0,2
NZL,EST,2002.0,1,0,1
UZB,BRA,2000.0,2,0,2
FIN,SRB,2017.0,1,0,1
SYC,NGA,2006.0,1,0,1
MYS,QAT,2009.0,1,0,1
NOR,THA,2018.0,2,0,2
THA,RUS,2008.0,1,0,1
HRV,TWN,2007.0,1,0,1
ATA,,2014.0,1,0,1
DZA,ARE,2017.0,1,0,1
SYR,ARG,2007.0,1,0,1
VUT,,2002.0,2,0,2
GRC,BWA,2020.0,1,0,1
SAU,IRQ,2002.0,1,0,1
ZMB,BEL,2001.0,1,0,1
MNG,CZE,2006.0,1,0,1
DEU,MDG,2003.0,1,0,1
NLD,LUX,2005.0,1,0,1
RWA,MLT,2019.0,1,0,1
GHA,UGA,2008.0,1,0,1
SRB,POL,2000.0,1,0,1
PYF,,2004.0,2,0,2
DEU,NAM,2008.0,2,0,2
DNK,BRN,2013.0,1,0,1
AUT,CIV,2009.0,1,0,1
SRB,ARE,2012.0,1,0,1
CUB,CHE,2012.0,1,0,1
CZE,ARM,2003.0,1,0,1
PSE,MOZ,2021.0,2,0,2
USA,LIE,2016.0,1,0,1
AUS,MCO,2017.0,1,0,1
UKR,IRN,2012.0,1,0,1
DZA,YEM,2017.0,1,0,1
ROU,ECU,2017.0,2,0,2
MYS,PSE,2011.0,2,0,2
MEX,EGY,2013.0,1,0,1
LBY,LBN,2022.0,1,0,1
IRN,DZA,2013.0,2,0,2
TZA,NAM,2020.0,1,0,1
KOR,MNG,2009.0,2,0,2
BLR,CZE,2020.0,2,0,2
PRT,ISL,2022.0,2,0,2
HKG,HUN,2016.0,4,0,4
IRN,SVN,2016.0,2,0,2
CIV,AUT,2019.0,1,0,1
AUT,CIV,2021.0,1,0,1
ITA,THA,2012.0,4,0,4
SYR,ARE,2018.0,1,0,1
IRN,MAR,2011.0,2,0,2
NPL,GRC,2020.0,1,0,1
,GUY,2004.0,9,0,9
JPN,MDG,2019.0,2,0,2
FIN,PNG,2022.0,1,0,1
SEN,BFA,2011.0,1,0,1
TUN,TGO,2017.0,2,0,2
NLD,KHM,2021.0,1,0,1
OMN,SDN,2001.0,2,0,2
CRI,NIC,2015.0,2,0,2
CYP,TUR,1998.0,4,0,4
RUS,ARE,2016.0,1,0,1
KEN,SLE,2022.0,1,0,1
MEX,PAK,2005.0,2,0,2
NGA,SWZ,2013.0,1,0,1
DEU,KGZ,2006.0,1,0,1
LTU,BLR,2015.0,2,0,2
KGZ,GBR,2012.0,1,0,1
ISR,EST,2000.0,1,0,1
IRL,KWT,2009.0,1,0,1
MNE,ITA,2022.0,2,0,2
RUS,HUN,2002.0,1,0,1
NGA,MLI,2021.0,1,0,1
PAK,SVN,2011.0,1,0,1
SDN,BHR,2016.0,2,0,2
FIN,GEO,2006.0,1,0,1
ROU,CYP,2023.0,1,0,1
GRC,PSE,2017.0,2,0,2
GEO,AUS,2013.0,2,0,2
GBR,NCL,2012.0,2,0,2
GMB,,2016.0,10,0,10
ZAF,PRT,2013.0,1,0,1
IDN,PSE,2019.0,2,0,2
PAK,RUS,2017.0,2,0,2
TUR,GHA,2020.0,2,0,2
CZE,SYR,2021.0,2,0,2
THA,ETH,2005.0,2,0,2
IND,MKD,2018.0,1,0,1
SWZ,MOZ,2019.0,1,0,1
CHN,KGZ,2018.0,2,0,2
BLR,HRV,2019.0,1,0,1
GBR,MAR,2001.0,9,0,9
VEN,CHN,2018.0,1,0,1
CHN,VEN,2022.0,1,0,1
UGA,GMB,2010.0,1,0,1
BFA,MDG,2007.0,1,0,1
,ERI,2017.0,25,0,25
TUR,TGO,2020.0,1,0,1
MEX,THA,2021.0,2,0,2
CRI,RUS,2020.0,1,0,1
TWN,SVK,2006.0,1,0,1
SVK,TWN,2009.0,1,0,1
CAN,BOL,2017.0,1,0,1
PLW,,2025.0,13,0,13
AUT,QAT,2019.0,1,0,1
CHN,SSD,2023.0,1,0,1
POL,ALB,2021.0,1,0,1
PRI,ZAF,2021.0,1,0,1
PRT,MAR,2021.0,5,0,5
SDN,BHR,2018.0,1,0,1
PHL,MAC,2023.0,1,0,1
,JAM,2020.0,21,0,21
MMR,GBR,2023.0,2,0,2
CAF,SWE,1999.0,1,0,1
UZB,TWN,2023.0,1,0,1
ZAF,LUX,2020.0,1,0,1
DZA,ETH,2019.0,1,0,1
MAR,BFA,2022.0,1,0,1
BFA,TUN,2022.0,1,0,1
,CHL,2021.0,11,0,11
SWZ,CHE,2001.0,3,0,3
COL,PRY,2015.0,1,0,1
ITA,JOR,1997.0,1,0,1
SWE,GNB,2003.0,4,0,4
JOR,PAK,2005.0,3,0,3
GUM,VIR,1999.0,1,0,1
TUN,PRT,2003.0,2,0,2
IRL,LTU,2014.0,1,0,1
BRN,NZL,2000.0,2,0,2
GHA,BGD,2016.0,1,0,1
DEU,MNG,2014.0,2,0,2
PRY,CHL,2012.0,1,0,1
DNK,KOR,2001.0,3,0,3
BRA,PRY,2004.0,1,0,1
SDN,CHN,1998.0,2,0,2
BWA,NLD,2000.0,1,0,1
BOL,ZWE,2005.0,1,0,1
IDN,NLD,2024.0,1,0,1
SGP,VNM,2002.0,2,0,2
HND,CRI,2006.0,1,0,1
NZL,EST,2012.0,1,0,1
ZWE,ETH,1998.0,1,0,1
CHN,COL,2007.0,1,0,1
POL,HUN,2007.0,2,0,2
PER,OMN,2016.0,1,0,1
PHL,BLR,2021.0,1,0,1
IRN,CYP,2016.0,1,0,1
GHA,COG,2009.0,1,0,1
BRA,BGR,2021.0,2,0,2
CAN,NPL,2015.0,2,0,2
SAU,JOR,1997.0,2,0,2
DZA,CAF,2015.0,2,0,2
ARM,CHN,2014.0,1,0,1
GRC,MAR,2001.0,1,0,1
BLR,CAN,2007.0,4,0,4
HND,CAN,2003.0,1,0,1
CAN,HND,2018.0,2,0,2
NCL,FSM,2014.0,1,0,1
ZAF,BGR,2009.0,1,0,1
RUS,PRI,2003.0,1,0,1
ARM,GBR,1999.0,1,0,1
ROU,CHN,2003.0,1,0,1
GRC,EST,2022.0,1,0,1
MKD,MAC,2004.0,1,0,1
PAN,GBR,2007.0,2,0,2
MEX,TWN,1997.0,1,0,1
PRI,ARG,1999.0,1,0,1
ESP,IRN,2001.0,2,0,2
,TCA,2007.0,5,0,5
AUT,GAB,1998.0,2,0,2
,WSM,2007.0,1,0,1
WSM,BRA,2012.0,1,0,1
LKA,MMR,2008.0,1,0,1
TON,NCL,2014.0,1,0,1
UGA,MDG,2017.0,1,0,1
BRA,PHL,2007.0,1,0,1
NGA,PAK,2016.0,2,0,2
USA,MNP,2015.0,3,0,3
RUS,BEN,2019.0,1,0,1
MRT,,2004.0,3,0,3
GHA,SAU,2019.0,1,0,1
ISL,CHN,2011.0,1,0,1
DNK,ARG,2013.0,2,0,2
GHA,BDI,2018.0,1,0,1
CZE,TWN,2004.0,2,0,2
NGA,NPL,2016.0,1,0,1
NPL,ETH,2020.0,1,0,1
PRT,SVN,1998.0,1,0,1
ITA,GUF,2021.0,1,0,1
SWE,MLT,2016.0,1,0,1
IRN,SVN,2018.0,3,0,3
MAR,KWT,2018.0,1,0,1
ZAF,RWA,2017.0,8,0,8
AUT,EST,2018.0,1,0,1
,BHS,2007.0,2,0,2
ARG,IDN,2023.0,1,0,1
BRN,VNM,2018.0,1,0,1
COG,GBR,2017.0,2,0,2
FJI,BHR,2020.0,1,0,1
KEN,TWN,2014.0,1,0,1
,GUY,2014.0,7,0,7
POL,PER,2023.0,1,0,1
GBR,PNG,2011.0,1,0,1
KNA,IRL,2020.0,1,0,1
SVN,LUX,2019.0,2,0,2
AZE,DEU,2019.0,2,0,2
ITA,TZA,2020.0,3,0,3
ALB,ESP,2016.0,1,0,1
SWE,QAT,2003.0,1,0,1
GNB,GIN,2018.0,5,0,5
NGA,EGY,2018.0,1,0,1
,REU,2017.0,4,0,4
NGA,SEN,2018.0,1,0,1
CMR,HKG,2019.0,1,0,1
ETH,SGP,2016.0,3,0,3
TCA,IRL,2017.0,1,0,1
TGO,NER,2023.0,1,0,1
GIN,BEN,2020.0,1,0,1
GRL,FIN,2022.0,1,0,1
KOR,KHM,2020.0,3,0,3
MLI,PAK,2021.0,1,0,1
KAZ,TJK,2022.0,1,0,1
CAN,GUY,2011.0,1,0,1
CHL,TUR,2020.0,2,0,2
PAN,GTM,2016.0,1,0,1
GTM,ZAF,2019.0,1,0,1
LSO,TZA,2022.0,1,0,1
IRQ,BWA,2021.0,1,0,1
ZWE,SWZ,2020.0,2,0,2
HKG,KEN,2022.0,1,0,1
,POL,2021.0,27,0,27
JPN,MAR,2012.0,3,0,3
,TKM,2019.0,4,0,4
DEU,MOZ,2023.0,1,0,1
ITA,PHL,2010.0,1,0,1
LKA,PAK,2004.0,1,0,1
TUR,NZL,2017.0,5,0,5
IRN,BRA,2006.0,1,0,1
BLR,CHE,2014.0,1,0,1
DNK,PAN,2010.0,1,0,1
MYS,PSE,2009.0,1,0,1
NCL,MYS,2011.0,1,0,1
HRV,IRL,2012.0,1,0,1
THA,SGP,2006.0,2,0,2
ZAF,QAT,2016.0,5,0,5
KWT,CHN,2021.0,4,0,4
CAN,SEN,2013.0,1,0,1
ALB,CAN,2000.0,2,0,2
ZWE,IRL,2005.0,1,0,1
CHN,PNG,2019.0,1,0,1
PNG,CHN,2020.0,1,0,1
LKA,ETH,2012.0,1,0,1
,CYM,2000.0,1,0,1
ESP,SAU,2012.0,2,0,2
PRI,ITA,2002.0,1,0,1
MEX,NIC,2013.0,2,0,2
UGA,DEU,2010.0,2,0,2
DEU,RWA,2011.0,1,0,1
MWI,JPN,2011.0,1,0,1
ITA,BFA,2013.0,2,0,2
PER,DEU,1999.0,2,0,2
MLI,DEU,2005.0,1,0,1
IDN,ZAF,2012.0,2,0,2
COD,NLD,2011.0,1,0,1
DZA,NLD,2008.0,1,0,1
TCD,FRA,2011.0,2,0,2
BEL,PAK,2013.0,3,0,3
HUN,IRL,2005.0,1,0,1
KAZ,AZE,2022.0,1,0,1
VUT,CHE,2017.0,1,0,1
NLD,MOZ,2017.0,3,0,3
CHE,PNG,2022.0,1,0,1
SGP,CHL,2011.0,2,0,2
DZA,YEM,2016.0,1,0,1
AUS,MDG,2016.0,1,0,1
BGD,OMN,2010.0,1,0,1
PRT,COL,2012.0,2,0,2
ECU,NZL,2018.0,2,0,2
PAK,LBY,2016.0,1,0,1
KOR,BGR,2012.0,3,0,3
PHL,CMR,2023.0,1,0,1
IND,UZB,2018.0,3,0,3
PRT,STP,2016.0,1,0,1
PRT,STP,2017.0,1,0,1
CHE,MKD,2015.0,2,0,2
BWA,QAT,2017.0,1,0,1
GMB,TUR,2020.0,1,0,1
MYS,PHL,2016.0,2,0,2
ETH,SOM,2021.0,1,0,1
GUF,PER,2017.0,1,0,1
CUB,PHL,1999.0,1,0,1
AND,,2005.0,1,0,1
TUR,NZL,2022.0,3,0,3
VNM,IRQ,2022.0,2,0,2
BGD,NPL,2020.0,2,0,2
KEN,BOL,2011.0,1,0,1
LBN,IND,2019.0,2,0,2
EST,CAN,1999.0,1,0,1
SEN,FIN,2017.0,1,0,1
BGR,CHN,2020.0,1,0,1
GUY,GBR,2007.0,1,0,1
ARM,COL,2001.0,1,0,1
USA,MLT,2010.0,1,0,1
GRC,OMN,2012.0,2,0,2
GTM,GMB,2005.0,1,0,1
LTU,FIN,2002.0,3,0,3
CAN,LBY,2019.0,3,0,3
BGR,IRL,2011.0,1,0,1
CAN,ETH,2003.0,2,0,2
BFA,NLD,2001.0,2,0,2
CHL,ZMB,2012.0,1,0,1
GEO,POL,2002.0,1,0,1
URY,COL,2002.0,2,0,2
IRN,PSE,1999.0,1,0,1
LVA,ISL,2001.0,1,0,1
ESP,ARE,2000.0,1,0,1
TUR,CZE,2012.0,4,0,4
MEX,KEN,2000.0,2,0,2
SAU,KAZ,2012.0,1,0,1
KHM,DEU,2021.0,1,0,1
ITA,YEM,2017.0,1,0,1
NLD,URY,1998.0,1,0,1
CAN,PSE,2000.0,2,0,2
PSE,SVK,2020.0,1,0,1
LBY,JOR,2004.0,1,0,1
AUS,JOR,2005.0,2,0,2
THA,IRL,2008.0,2,0,2
SEN,NLD,2018.0,1,0,1
ITA,SEN,2022.0,1,0,1
FIN,BGR,2009.0,2,0,2
BLR,IND,2001.0,1,0,1
ZWE,SWE,2003.0,1,0,1
POL,SVN,2000.0,1,0,1
ERI,USA,2010.0,1,0,1
BGD,NLD,2006.0,1,0,1
TUR,KAZ,2002.0,1,0,1
IRN,BGR,2012.0,1,0,1
HKG,NPL,1997.0,1,0,1
MYS,BGR,2020.0,1,0,1
BIH,TUR,2014.0,1,0,1
BRA,KWT,2017.0,1,0,1
ESP,LTU,2021.0,3,0,3
LUX,PER,2015.0,1,0,1
BMU,DEU,2021.0,1,0,1
ZWE,AUS,2008.0,2,0,2
SVK,DNK,2002.0,2,1,1
CZE,IRL,2016.0,1,3,-2
MKD,SWE,2019.0,2,1,1
MDA,DEU,2007.0,1,1,0
CMR,NLD,2012.0,1,1,0
LTU,CHE,2014.0,1,4,-3
IRL,AUT,2015.0,5,3,2
ARM,GBR,2009.0,1,1,0
MUS,IND,2009.0,1,2,-1
CHN,GEO,2023.0,1,1,0
BGR,BEL,2019.0,4,7,-3
SEN,MAR,2018.0,1,1,0
FIN,PAK,2023.0,1,7,-6
UGA,LBR,2023.0,1,1,0
BEN,GBR,2006.0,1,2,-1
BRA,BOL,2003.0,1,3,-2
MKD,USA,2002.0,2,2,0
NLD,CHL,2006.0,2,2,0
ZAF,RUS,2022.0,1,5,-4
DEU,LIE,2010.0,3,1,2
POL,IRL,2016.0,4,6,-2
PRT,PRI,2022.0,1,3,-2
TUR,TWN,2007.0,1,2,-1
FRA,LTU,2022.0,4,1,3
JPN,PAK,2021.0,9,9,0
IRQ,FRA,2016.0,1,1,0
GAB,GBR,2006.0,1,1,0
HUN,KAZ,2021.0,1,4,-3
GAB,DEU,1997.0,1,2,-1
ISR,KOR,2013.0,2,7,-5
PRT,ISR,2015.0,3,2,1
GRC,IND,2005.0,1,1,0
NLD,BEN,2012.0,3,2,1
MAR,CMR,2012.0,1,1,0
AUS,ARG,2021.0,6,12,-6
PER,ARG,2008.0,2,1,1
GBR,NPL,1998.0,1,2,-1
VEN,PRI,2010.0,1,1,0
SAU,LBN,2008.0,1,6,-5
USA,KHM,2007.0,1,1,0
KOR,PAK,2008.0,3,4,-1
BEN,GBR,2010.0,2,1,1
LTU,IND,2021.0,1,1,0
MNG,JPN,1999.0,1,2,-1
OMN,NGA,2019.0,2,1,1
UKR,AUS,2007.0,3,1,2
PRT,SVN,2021.0,3,3,0
MDA,FRA,2017.0,1,2,-1
LBN,EGY,2010.0,2,3,-1
UZB,MYS,2008.0,1,1,0
DZA,AUT,2018.0,1,3,-2
BOL,USA,2020.0,4,9,-5
CHN,BFA,2020.0,1,1,0
MEX,ISR,2023.0,1,1,0
LTU,CHN,2023.0,1,1,0
SGP,ROU,2012.0,1,1,0
CMR,ROU,2015.0,1,1,0
SVK,FIN,2019.0,1,1,0
CHE,CRI,2021.0,2,2,0
PAK,IDN,2013.0,1,1,0
MKD,AUS,2018.0,1,1,0
JPN,GHA,2023.0,2,3,-1
ZAF,ROU,2011.0,1,2,-1
JAM,DEU,2004.0,1,1,0
SGP,DNK,2007.0,2,2,0
FIN,IRL,2006.0,1,1,0
USA,HTI,2005.0,1,1,0
PRI,CHN,2018.0,2,1,1
ROU,BEL,2018.0,4,3,1
IRN,MEX,2015.0,1,1,0
VEN,COL,2002.0,4,4,0
BEL,COL,2023.0,2,1,1
LKA,DNK,2002.0,1,1,0
BEL,BOL,2023.0,1,1,0
ZAF,ZMB,2000.0,1,1,0
CAN,LTU,2003.0,2,1,1
BRA,IND,2010.0,1,9,-8
EGY,PSE,2013.0,1,1,0
USA,MKD,2008.0,1,2,-1
GBR,IRQ,1998.0,1,2,-1
SAU,TUR,2007.0,2,2,0
CAN,UGA,2013.0,1,3,-2
SAU,FIN,2015.0,1,4,-3
FRA,SVK,2022.0,2,3,-1
CHE,BIH,2021.0,1,1,0
BFA,GBR,2013.0,1,2,-1
ISL,FIN,2000.0,1,1,0
AFG,IND,2023.0,1,2,-1
PHL,IND,1997.0,1,2,-1
ZAF,TZA,2002.0,1,1,0
LVA,DEU,1999.0,1,4,-3
AUT,CHL,2003.0,1,2,-1
MLI,USA,2005.0,1,8,-7
PRT,ISR,2008.0,1,2,-1
ESP,AGO,2016.0,1,1,0
AUT,BGD,2009.0,1,1,0
DOM,COL,2022.0,1,1,0
ITA,ARE,2009.0,2,1,1
CAN,TUN,2012.0,6,5,1
BEL,MKD,2014.0,2,1,1
USA,SDN,2015.0,4,4,0
SDN,MYS,2011.0,1,3,-2
NCL,NZL,2016.0,1,1,0
HRV,POL,2016.0,1,1,0
RUS,EGY,2016.0,2,3,-1
MNG,CHN,2004.0,1,1,0
NGA,FRA,2014.0,1,1,0
MNG,AUS,2018.0,1,2,-1
ZWE,NGA,2022.0,1,1,0
GRC,THA,2021.0,1,1,0
HKG,ESP,2005.0,3,1,2
SWE,PHL,2017.0,1,3,-2
BFA,BEL,2016.0,3,2,1
MYS,BGD,2002.0,2,5,-3
AUS,CRI,2015.0,1,1,0
FRA,MUS,2017.0,2,1,1
IDN,IND,2009.0,4,6,-2
CRI,ESP,2021.0,4,8,-4
ZAF,NOR,2015.0,4,7,-3
CZE,HUN,1998.0,2,1,1
NLD,CYP,2021.0,2,1,1
VEN,CRI,2012.0,3,1,2
MLI,CAN,2013.0,2,1,1
GBR,CRI,2018.0,3,3,0
PRT,VEN,2008.0,1,1,0
ARG,JPN,2022.0,2,1,1
BOL,SWE,2019.0,2,3,-1
TZA,SWE,2022.0,3,14,-11
FRA,URY,2021.0,3,4,-1
CZE,TWN,2021.0,2,5,-3
KAZ,FRA,2017.0,2,5,-3
SLV,DEU,2019.0,1,1,0
DEU,VEN,2011.0,2,7,-5
POL,KAZ,2023.0,2,1,1
BEL,BGD,2019.0,6,4,2
IRQ,TUR,2013.0,1,3,-2
ARM,COL,2009.0,1,2,-1
DNK,LVA,2017.0,1,1,0
GIN,SEN,2020.0,1,2,-1
CMR,JPN,2020.0,1,5,-4
BEL,DNK,1999.0,3,3,0
CAN,EST,2009.0,1,1,0
SAU,BRA,2023.0,1,5,-4
JPN,UZB,2012.0,1,1,0
GBR,UZB,2014.0,2,2,0
GBR,ZWE,2005.0,1,7,-6
KWT,GBR,2014.0,2,18,-16
PRT,MOZ,2015.0,2,1,1
NGA,BWA,2015.0,1,4,-3
CHL,IRL,2010.0,4,2,2
ALB,GBR,2005.0,1,1,0
RWA,KEN,2014.0,1,2,-1
LTU,NLD,2016.0,3,2,1
ALB,USA,2009.0,2,4,-2
GRC,BGR,2015.0,1,2,-1
SGP,TUR,2007.0,1,2,-1
IND,TTO,2003.0,1,1,0
MYS,KWT,2022.0,2,4,-2
CAN,PHL,2008.0,2,3,-1
LTU,ITA,2007.0,2,2,0
CAN,ETH,2010.0,2,2,0
KWT,LBN,2018.0,3,2,1
SWE,ECU,2014.0,1,1,0
PHL,IDN,2014.0,3,2,1
GTM,CHE,2019.0,1,2,-1
ARG,SVN,2017.0,1,1,0
MNG,RUS,2008.0,2,3,-1
ITA,VEN,2007.0,2,1,1
ITA,HRV,2008.0,2,2,0
CHN,ROU,2013.0,1,1,0
BEL,BWA,2008.0,1,2,-1
DNK,THA,2005.0,2,3,-1
IND,FJI,2011.0,2,1,1
AUS,EST,2017.0,3,1,2
MNG,JPN,2008.0,1,9,-8
VNM,SGP,2019.0,3,17,-14
PER,BEL,2003.0,2,1,1
FRA,GUF,1999.0,3,7,-4
BHS,USA,2013.0,3,1,2
FRA,SYC,2008.0,1,1,0
UKR,TWN,2003.0,2,2,0
AUS,TUR,2004.0,2,3,-1
SDN,USA,2004.0,1,1,0
LIE,DEU,2007.0,1,5,-4
BGR,CAN,2001.0,6,6,0
OMN,MYS,2002.0,1,2,-1
MAR,EGY,2015.0,1,1,0
USA,GRL,2011.0,1,1,0
ISL,DEU,2010.0,1,9,-8
KGZ,USA,2011.0,1,4,-3
ETH,AUT,2001.0,1,2,-1
PNG,GBR,2007.0,1,3,-2
KEN,CIV,2012.0,1,1,0
ITA,BIH,2009.0,1,1,0
TZA,UGA,2007.0,1,1,0
RUS,HKG,2007.0,1,1,0
HUN,MAR,2017.0,1,1,0
HRV,FRA,2009.0,3,4,-1
CHE,IDN,2018.0,3,4,-1
GRC,ISR,2005.0,1,2,-1
ROU,NOR,2015.0,1,1,0
MYS,YEM,2008.0,3,1,2
CIV,BEL,2009.0,1,1,0
ZAF,SWE,2009.0,5,3,2
SGP,POL,2009.0,2,3,-1
USA,ERI,2019.0,2,1,1
BEL,ETH,2007.0,1,3,-2
CYP,ITA,2006.0,1,1,0
BGD,DEU,2005.0,1,3,-2
CHL,VEN,2008.0,2,7,-5
BEL,IRN,2023.0,4,17,-13
HRV,CAN,2015.0,1,1,0
TUR,BGR,2016.0,2,1,1
IRN,SVN,2020.0,3,1,2
MAR,CAN,2018.0,6,13,-7
USA,NIC,2022.0,4,2,2
CHL,CZE,2016.0,2,1,1
TWN,FRA,1999.0,2,7,-5
MYS,POL,2019.0,3,1,2
KEN,ESP,2017.0,1,1,0
ETH,FRA,2021.0,2,3,-1
VNM,NOR,2014.0,2,4,-2
DEU,MWI,2013.0,2,2,0
FIN,JOR,2011.0,1,1,0
NOR,VNM,2023.0,1,2,-1
MRT,FRA,2021.0,2,1,1
POL,BRA,2018.0,4,5,-1
IDN,DNK,2013.0,1,1,0
HRV,AUS,2017.0,2,1,1
MEX,HUN,2015.0,1,1,0
UKR,SVN,2014.0,1,2,-1
AUT,LUX,2012.0,4,1,3
IRN,AFG,2020.0,3,2,1
CHE,EGY,2021.0,2,6,-4
HUN,FIN,2022.0,5,1,4
VNM,DZA,2019.0,2,1,1
GHA,MYS,2016.0,1,1,0
PRT,GRC,2020.0,3,1,2
SGP,FIN,2012.0,4,2,2
DEU,MAC,2020.0,2,1,1
SVK,IRL,2018.0,1,2,-1
DZA,HRV,2020.0,1,1,0
HKG,ETH,2022.0,2,2,0
IRQ,SAU,2023.0,5,2,3
NZL,NGA,2021.0,2,7,-5
CAN,COD,2023.0,2,2,0
ARE,BGD,2019.0,1,1,0
THA,AFG,2021.0,1,2,-1
CHE,ARM,2019.0,2,2,0
FRA,PHL,1997.0,2,1,1
SGP,CZE,2016.0,1,1,0
AUS,EGY,1999.0,2,1,1
KEN,TZA,1998.0,2,1,1
LIE,USA,2007.0,1,1,0
NER,USA,2009.0,2,1,1
HRV,SVN,1997.0,1,1,0
CUB,GBR,2005.0,3,1,2
ROU,ESP,1999.0,1,2,-1
USA,MNG,2000.0,1,2,-1
TUR,BEL,2008.0,2,5,-3
RUS,BRA,2010.0,1,7,-6
CMR,JPN,2007.0,2,2,0
SWE,TZA,2003.0,1,1,0
ETH,GBR,2006.0,3,5,-2
BWA,NZL,2005.0,1,2,-1
BWA,IND,2006.0,1,1,0
BFA,CAN,1999.0,2,1,1
RUS,EST,1997.0,3,1,2
SVK,ITA,2006.0,2,2,0
JAM,CAN,2000.0,1,1,0
ECU,DEU,1998.0,2,1,1
ARG,BEL,2005.0,4,2,2
AUS,SVN,2000.0,1,1,0
PNG,USA,2003.0,2,4,-2
DNK,TZA,2000.0,2,1,1
KOR,UZB,2010.0,1,3,-2
USA,BLZ,2019.0,1,4,-3
FIN,BGR,2014.0,2,1,1
IRL,CZE,2005.0,1,1,0
COL,CHL,2005.0,4,6,-2
NZL,TTO,2011.0,1,2,-1
OMN,DEU,2006.0,1,1,0
IND,IRQ,2009.0,3,1,2
SGP,ESP,2008.0,1,2,-1
SGP,ISR,2016.0,2,5,-3
DNK,BFA,2011.0,1,1,0
LTU,LVA,2009.0,1,3,-2
IRL,ROU,2019.0,1,4,-3
DEU,ARM,2009.0,2,6,-4
GRC,FIN,2015.0,4,4,0
FIN,GRC,2017.0,3,2,1
ETH,SWE,2014.0,2,6,-4
NGA,FRA,2015.0,1,3,-2
TUR,UKR,2019.0,2,2,0
ZAF,CHN,2010.0,3,9,-6
TUR,IRL,2011.0,4,6,-2
TUN,MAR,2013.0,3,2,1
JOR,OMN,2007.0,3,1,2
CZE,ETH,2019.0,1,1,0
KOR,IRL,2016.0,5,1,4
CAF,BFA,2009.0,1,1,0
UKR,NOR,2013.0,1,2,-1
CAN,MYS,2023.0,3,10,-7
IRN,COL,2017.0,1,1,0
GHA,CIV,2019.0,1,1,0
MLT,CAN,2021.0,1,4,-3
USA,TCA,2010.0,1,1,0
AZE,DEU,2015.0,1,1,0
AUS,TLS,2021.0,1,1,0
NLD,LBN,2020.0,1,2,-1
SVN,AUS,2014.0,1,2,-1
SRB,SAU,2015.0,1,1,0
IRL,JPN,2006.0,3,3,0
NGA,RUS,2017.0,2,1,1
ESP,DOM,2012.0,1,1,0
BEN,GHA,2018.0,1,1,0
PRT,IRN,2018.0,2,17,-15
RWA,DEU,2022.0,2,2,0
CHN,UKR,2015.0,2,2,0
ROU,TWN,2009.0,1,1,0
IDN,AUS,1998.0,3,8,-5
CIV,BEN,2020.0,6,2,4
ROU,PRT,2015.0,2,2,0
ETH,SAU,2021.0,1,4,-3
VNM,NZL,2022.0,2,5,-3
GBR,MDV,2021.0,1,1,0
CAN,PAK,2024.0,1,2,-1
SDN,CHN,2017.0,4,5,-1
JPN,THA,2024.0,1,1,0
DNK,ISR,2023.0,4,4,0
MEX,PRI,2020.0,1,2,-1
USA,KNA,2023.0,2,3,-1
BHR,ARE,2023.0,2,1,1
MEX,PRI,2007.0,1,1,0
BGD,NOR,2011.0,3,2,1
ESP,THA,2019.0,1,2,-1
SWE,TUN,2012.0,1,1,0
BIH,MNE,2015.0,1,1,0
BEN,USA,2015.0,2,1,1
GMB,USA,2014.0,3,1,2
SAU,MEX,2018.0,1,3,-2
ESP,SRB,2018.0,3,5,-2
SVN,GRC,2015.0,1,2,-1
VNM,KHM,2014.0,1,2,-1
CRI,CHL,2018.0,2,3,-1
SWZ,CHE,2009.0,5,7,-2
TUN,GBR,2020.0,2,3,-1
COL,UKR,2002.0,1,1,0
MNG,JPN,2015.0,3,8,-5
SWE,CRI,2021.0,1,1,0
AUS,VUT,1999.0,1,1,0
LBN,QAT,2014.0,2,1,1
BGR,BLR,2013.0,1,1,0
TZA,KEN,2003.0,1,1,0
CZE,BRA,2021.0,3,20,-17
DZA,ARE,2007.0,1,1,0
FRA,MRT,2003.0,1,1,0
RUS,HRV,2020.0,1,3,-2
BEN,BEL,2002.0,1,1,0
ESP,PER,2001.0,1,4,-3
NLD,UGA,2000.0,1,1,0
NLD,COL,2012.0,4,6,-2
ZAF,BEL,1997.0,1,2,-1
CHE,THA,2002.0,2,3,-1
BOL,BRA,2007.0,1,1,0
CIV,GHA,2019.0,1,1,0
UZB,GBR,2010.0,1,2,-1
ESP,LVA,2011.0,1,2,-1
USA,MDA,2022.0,1,5,-4
LUX,GBR,2006.0,3,2,1
MCO,USA,2022.0,1,2,-1
BHR,ARE,2010.0,1,2,-1
DNK,BGR,1998.0,1,3,-2
SGP,AUT,2009.0,2,4,-2
SRB,SVK,2006.0,2,2,0
AUS,CHL,2006.0,3,6,-3
ARG,SRB,2006.0,1,1,0
NGA,SWE,2005.0,1,2,-1
ROU,GRC,2010.0,4,3,1
NGA,KWT,2002.0,2,2,0
ZWE,ZMB,2010.0,1,1,0
NLD,CMR,2013.0,1,1,0
BRA,ISR,2010.0,1,1,0
SGP,POL,2011.0,2,3,-1
PRT,IRL,2002.0,3,1,2
MWI,NOR,2015.0,2,3,-1
GBR,ETH,2014.0,4,9,-5
SWE,LVA,1998.0,2,4,-2
TWN,NLD,2016.0,4,1,3
KHM,THA,2014.0,2,1,1
BEL,UKR,2019.0,1,3,-2
SEN,MLI,2014.0,2,2,0
GBR,PRI,2017.0,1,2,-1
ITA,CRI,2014.0,1,1,0
ESP,OMN,2021.0,1,2,-1
USA,BRN,1998.0,1,1,0
AUS,IRQ,2012.0,1,3,-2
PRT,SVN,2016.0,1,2,-1
POL,HUN,2018.0,3,2,1
USA,YEM,2016.0,1,2,-1
AUT,ISR,2023.0,1,1,0
BEL,HKG,2014.0,1,1,0
IRL,BRA,2011.0,1,2,-1
TZA,ETH,2015.0,2,1,1
COG,GHA,2015.0,2,2,0
MEX,RUS,2012.0,2,4,-2
ETH,ESP,2018.0,4,5,-1
PER,COL,2023.0,5,11,-6
LVA,NLD,2022.0,2,1,1
CHE,IDN,2016.0,2,2,0
SGP,CZE,2017.0,1,2,-1
SEN,NER,2017.0,3,1,2
SEN,MLI,2015.0,3,2,1
NLD,LKA,2017.0,2,1,1
CHE,PER,2019.0,2,3,-1
NOR,ZAF,2018.0,1,5,-4
CRI,NLD,2017.0,1,1,0
JOR,OMN,2020.0,3,4,-1
AUT,PAK,2007.0,2,3,-1
KOR,AUT,2005.0,2,1,1
BEL,BFA,2016.0,2,3,-1
MLT,DEU,1999.0,3,1,2
ISR,BRA,2017.0,1,4,-3
DEU,BWA,2007.0,1,1,0
SEN,BFA,2001.0,2,2,0
GRC,AUT,1998.0,1,1,0
BEL,CZE,2017.0,7,12,-5
ISR,TWN,2020.0,1,1,0
ITA,ARM,2020.0,2,1,1
BGD,QAT,2016.0,1,1,0
QAT,BGD,2019.0,1,1,0
PER,GBR,2000.0,1,2,-1
MWI,TWN,2023.0,1,1,0
MOZ,CHE,2014.0,1,1,0
KOR,PHL,2003.0,3,2,1
SLE,GBR,2000.0,1,1,0
NOR,BEL,2002.0,1,1,0
NLD,EGY,2000.0,2,1,1
SGP,NLD,1999.0,1,2,-1
EGY,YEM,2011.0,2,4,-2
PAK,TZA,2015.0,1,1,0
CAN,MAC,2004.0,2,1,1
MAC,CAN,2005.0,1,1,0
TWN,SGP,2000.0,2,3,-1
THA,MMR,2013.0,3,1,2
ETH,DNK,2014.0,2,1,1
CRI,CHL,2022.0,1,2,-1
EGY,BEL,2010.0,3,4,-1
CRI,NIC,2019.0,1,1,0
ERI,IND,2018.0,1,1,0
ZAF,GRC,2018.0,1,3,-2
IRL,FIN,2015.0,1,5,-4
VNM,DNK,2018.0,1,4,-3
CAN,BMU,2002.0,1,1,0
ESP,IDN,2016.0,2,1,1
LUX,POL,2023.0,1,2,-1
GHA,NZL,2015.0,2,2,0
NOR,NPL,2023.0,1,2,-1
BGD,BRN,2014.0,5,3,2
FRA,HUN,2022.0,4,8,-4
CIV,CHE,2011.0,1,2,-1
NGA,BFA,2016.0,1,2,-1
IND,RWA,2018.0,3,2,1
ARG,CZE,2018.0,2,2,0
BGR,HUN,2003.0,1,2,-1
PHL,DNK,2021.0,1,1,0
USA,REU,2018.0,1,1,0
GBR,SEN,2015.0,1,2,-1
BTN,AUS,2018.0,2,7,-5
SDN,DEU,2023.0,1,3,-2
MAR,RUS,2022.0,1,1,0
EGY,AUT,2014.0,1,3,-2
NOR,NZL,2012.0,1,4,-3
USA,SLB,2020.0,1,1,0
MKD,BGR,2022.0,1,1,0
NOR,LUX,2023.0,1,3,-2
BRA,TWN,2020.0,1,1,0
IRN,SAU,2021.0,2,2,0
TCD,CMR,2021.0,1,2,-1
ESP,UZB,2021.0,2,1,1
HUN,ISR,2020.0,2,2,0
AUT,BRA,2022.0,2,17,-15
JPN,TUN,2020.0,2,2,0
LUX,IND,2021.0,1,9,-8
CYM,USA,2015.0,1,1,0
NZL,HRV,2023.0,1,1,0
ECU,HUN,2022.0,1,2,-1
IND,TTO,2013.0,1,1,0
SEN,BEN,2023.0,2,1,1
USA,DZA,2023.0,3,4,-1
CHE,PER,2009.0,3,3,0
KHM,CHE,2017.0,1,2,-1
CHE,KHM,2019.0,1,2,-1
LBN,GBR,2002.0,2,1,1
BLR,UKR,2019.0,2,3,-1
BGD,HKG,2011.0,1,1,0
PER,NOR,2014.0,1,2,-1
JPN,SYR,2017.0,1,1,0
CAN,UKR,2009.0,2,7,-5
IND,MMR,2019.0,1,1,0
SLV,SVN,2003.0,2,1,1
NZL,IND,2000.0,2,2,0
AUS,TTO,2006.0,1,1,0
ETH,ITA,2014.0,5,1,4
SAU,DEU,2000.0,1,3,-2
MEX,NAM,2021.0,1,1,0
MWI,DEU,2020.0,2,3,-1
ITA,MLT,2014.0,5,1,4
SWE,LAO,2010.0,1,1,0
TWN,ZAF,2015.0,1,3,-2
COL,IDN,1999.0,1,1,0
IND,FJI,2019.0,3,1,2
CHE,TWN,1998.0,1,1,0
BIH,CAN,2004.0,1,1,0
JPN,CUB,1999.0,1,1,0
AUS,EST,2018.0,2,3,-1
BEL,IDN,2012.0,2,1,1
ISR,SGP,2008.0,1,4,-3
HKG,UKR,2002.0,1,1,0
GBR,FLK,2017.0,4,1,3
SWE,ZAF,2001.0,2,10,-8
IRQ,POL,2020.0,2,3,-1
NLD,MOZ,2020.0,1,1,0
THA,IND,2006.0,3,5,-2
BEN,USA,2014.0,1,1,0
PAN,GBR,2016.0,2,2,0
JAM,ZAF,2015.0,1,1,0
RWA,ZAF,2007.0,1,2,-1
ESP,CYP,2013.0,3,2,1
ZAF,MWI,2008.0,1,5,-4
CHE,ZAF,1999.0,2,2,0
CRI,VEN,2023.0,1,1,0
CAN,ROU,2020.0,1,9,-8
NLD,ROU,2015.0,3,4,-1
SEN,ZAF,2021.0,1,3,-2
BLR,POL,2014.0,3,8,-5
TWN,FIN,2014.0,2,1,1
CZE,ZAF,2011.0,1,1,0
CHE,UKR,2011.0,2,1,1
LTU,GBR,2014.0,5,10,-5
AUT,ZAF,2022.0,4,7,-3
IND,MEX,2010.0,2,2,0
UGA,SLE,2021.0,1,1,0
LAO,DEU,2020.0,1,1,0
THA,IND,2010.0,3,5,-2
PAK,IRN,2015.0,2,1,1
SRB,NOR,2011.0,2,5,-3
LUX,USA,2008.0,1,3,-2
CAN,YEM,2010.0,1,1,0
ETH,AUT,2015.0,2,2,0
PNG,USA,2013.0,1,2,-1
IDN,PAK,2021.0,1,10,-9
TUR,BGR,2018.0,1,1,0
CAN,SRB,2020.0,2,3,-1
CAN,NPL,2021.0,1,2,-1
SRB,CAN,2021.0,1,4,-3
ARG,JPN,2018.0,2,3,-1
BOL,ECU,2021.0,2,1,1
USA,MMR,2020.0,2,2,0
KEN,TWN,2019.0,1,1,0
CZE,IRL,2021.0,2,5,-3
ETH,CAN,2020.0,3,5,-2
KOR,NGA,2018.0,3,2,1
NPL,NZL,2022.0,3,1,2
NGA,OMN,2019.0,1,2,-1
PSE,MYS,2021.0,3,8,-5
BEL,CIV,2017.0,4,5,-1
BEL,BGD,2011.0,2,4,-2
AGO,BRA,2020.0,1,1,0
AUS,CZE,2024.0,1,1,0
MDG,GBR,2001.0,1,1,0
ZAF,BRA,2002.0,1,2,-1
JPN,ARG,2014.0,1,3,-2
TTO,MSR,2021.0,1,3,-2
YEM,IND,1999.0,1,1,0
KEN,SWE,2002.0,1,6,-5
HND,CRI,2003.0,1,1,0
ITA,HKG,2007.0,1,1,0
SVN,GBR,1999.0,3,4,-1
BEL,CYP,2014.0,2,1,1
PRT,IND,2003.0,1,5,-4
POL,GRC,1997.0,1,1,0
AUS,UKR,2009.0,2,4,-2
NZL,BEL,2000.0,1,1,0
AUT,QAT,2014.0,1,1,0
FJI,GBR,2006.0,1,1,0
AUT,ISL,2017.0,1,2,-1
SVK,QAT,2016.0,1,1,0
MYS,CAN,2007.0,1,8,-7
MNG,TWN,2010.0,2,1,1
IND,PRI,2022.0,1,1,0
EGY,POL,2013.0,1,1,0
ISL,CHN,2015.0,1,2,-1
AUS,MAC,2015.0,2,3,-1
SWE,IDN,2017.0,5,1,4
THA,BEL,2011.0,1,4,-3
JPN,MMR,2012.0,1,3,-2
CZE,BGR,2015.0,1,3,-2
ROU,BRA,2015.0,2,1,1
ARG,ROU,2016.0,1,1,0
USA,COG,2000.0,1,1,0
MEX,CHE,2004.0,3,3,0
SEN,CIV,2013.0,1,1,0
CHE,HRV,2003.0,3,7,-4
NOR,TWN,2015.0,1,1,0
QAT,TWN,2017.0,1,1,0
BGR,NLD,2006.0,1,3,-2
BWA,KEN,2001.0,1,1,0
HKG,NLD,2003.0,3,2,1
CZE,CHL,2022.0,3,1,2
OMN,FRA,2019.0,1,3,-2
SVN,HUN,2017.0,1,1,0
BRA,CAN,2024.0,2,1,1
CIV,TZA,2019.0,1,2,-1
LUX,AUT,2019.0,1,3,-2
DNK,COL,2017.0,1,2,-1
ARE,HUN,2008.0,1,3,-2
VNM,DNK,2016.0,2,7,-5
GHA,KEN,2005.0,1,2,-1
SAU,DZA,2009.0,2,4,-2
DEU,BFA,2013.0,2,1,1
LBY,EGY,2007.0,1,1,0
ITA,ARE,2011.0,2,1,1
PRT,AUS,2007.0,1,3,-2
EGY,DNK,2020.0,1,9,-8
ETH,SWE,2004.0,1,5,-4
QAT,GRC,2015.0,2,2,0
CHL,PAN,2021.0,1,1,0
USA,MWI,2001.0,3,8,-5
NZL,ISR,2015.0,1,2,-1
FRA,JOR,2014.0,5,1,4
GEO,ITA,2018.0,2,3,-1
TZA,JPN,2008.0,2,1,1
CHE,GEO,2020.0,2,1,1
CHL,NOR,2021.0,1,1,0
NOR,CHL,2022.0,1,2,-1
RUS,TJK,2005.0,1,1,0
MKD,ITA,2014.0,1,1,0
BEL,CHL,2003.0,1,1,0
KHM,THA,2015.0,3,3,0
KGZ,TUR,2012.0,3,1,2
TWN,NOR,2020.0,3,3,0
MLT,IND,2022.0,1,1,0
AUT,UKR,2022.0,1,3,-2
DEU,SEN,2018.0,2,2,0
BFA,CHN,2021.0,2,2,0
BFA,ZAF,2009.0,2,6,-4
NZL,IDN,2023.0,1,3,-2
LSO,USA,2019.0,2,5,-3
DNK,PRT,1998.0,2,1,1
GBR,PRI,2018.0,2,1,1
HKG,LKA,2023.0,1,2,-1
DEU,SEN,2017.0,1,1,0
MYS,SOM,2023.0,1,1,0
USA,NCL,2013.0,1,1,0
PRY,BRA,2010.0,4,1,3
LKA,BRA,2017.0,2,1,1
UGA,AUT,2014.0,2,1,1
DEU,ECU,2003.0,1,1,0
QAT,USA,2002.0,1,2,-1
SVK,HRV,2015.0,1,3,-2
MDG,GBR,2015.0,1,2,-1
KEN,AUT,2016.0,1,2,-1
IDN,CHN,2002.0,1,1,0
SRB,AUS,2007.0,2,2,0
ASM,USA,2006.0,1,3,-2
ALB,CHE,2004.0,1,1,0
LVA,GBR,2017.0,1,1,0
PAK,GEO,2014.0,1,1,0
AUT,HKG,2016.0,1,2,-1
TTO,CAN,2009.0,2,3,-1
NGA,CYP,2023.0,2,1,1
AUT,BIH,2012.0,1,1,0
JPN,MEX,2009.0,1,3,-2
KOR,CAN,1997.0,4,10,-6
PAN,ESP,2005.0,1,1,0
NLD,SRB,2012.0,3,6,-3
CHL,SAU,2021.0,1,1,0
LTU,BLR,2021.0,2,2,0
SRB,JPN,2019.0,1,4,-3
GBR,ZMB,2007.0,1,3,-2
LTU,IRN,2013.0,1,1,0
IDN,KEN,2015.0,1,3,-2
CHL,KOR,2011.0,1,2,-1
MYS,KHM,2017.0,2,1,1
SYR,CAN,2014.0,1,1,0
EGY,ARE,1997.0,2,5,-3
KOR,ESP,2010.0,4,2,2
PRT,TWN,2020.0,1,1,0
ZAF,BGR,2014.0,1,1,0
USA,LCA,2017.0,2,1,1
TON,FJI,2018.0,1,1,0
TWN,KEN,2019.0,1,1,0
USA,FJI,2023.0,2,2,0
SDN,SWE,2016.0,1,4,-3
RUS,DZA,2021.0,4,1,3
NZL,PHL,2022.0,1,3,-2
LKA,MYS,2022.0,2,4,-2
ITA,LBN,2023.0,1,3,-2
COD,UGA,2022.0,1,3,-2
KAZ,UZB,2002.0,1,3,-2
BGR,KOR,2010.0,3,1,2
USA,DZA,2000.0,1,2,-1
BRA,EGY,2011.0,2,1,1
MYS,BEL,2011.0,1,2,-1
SVK,SRB,2010.0,1,1,0
PER,ITA,2001.0,1,1,0
NLD,CRI,2014.0,2,1,1
FRA,SVN,1998.0,2,4,-2
KWT,DEU,2012.0,2,2,0
SWE,SVN,2001.0,1,1,0
BEL,VNM,2005.0,2,3,-1
BEL,NER,2005.0,1,1,0
VEN,ITA,2006.0,4,1,3
ZAF,NLD,1997.0,2,4,-2
ALB,USA,2011.0,1,2,-1
CHE,MUS,2017.0,1,1,0
SGP,POL,2021.0,3,4,-1
ESP,KEN,2013.0,1,1,0
NLD,HRV,2002.0,1,3,-2
HRV,ITA,2008.0,2,2,0
NZL,MEX,2016.0,2,4,-2
ITA,PER,2018.0,1,6,-5
USA,BHS,2021.0,4,3,1
SGP,USA,2024.0,1,1,0
EST,CAN,2016.0,2,2,0
CAN,EST,2019.0,3,3,0
EGY,IND,2015.0,2,3,-1
PHL,EGY,2020.0,1,1,0
LBY,USA,2017.0,3,3,0
IRN,IDN,2019.0,1,1,0
SDN,NLD,2017.0,1,4,-3
LBN,IRL,2019.0,1,1,0
NZL,MEX,2022.0,1,3,-2
USA,AIA,2018.0,1,1,0
BEL,CUB,2019.0,2,3,-1
UGA,DNK,2018.0,1,4,-3
CAN,MWI,2023.0,1,1,0
CHN,LUX,2023.0,1,1,0
BEL,SAU,2022.0,2,6,-4
SVN,NLD,2023.0,1,3,-2
FIN,HKG,2021.0,1,2,-1
PRY,USA,2023.0,2,3,-1
ARG,VEN,2022.0,2,5,-3
KAZ,CAN,2021.0,2,4,-2
MAR,DZA,2017.0,1,1,0
BEL,UGA,2012.0,1,1,0
ZWE,ZMB,2000.0,1,1,0
CHE,LTU,2018.0,1,5,-4
NLD,TUN,2022.0,2,1,1
ZAF,NAM,2007.0,2,6,-4
NGA,CMR,2002.0,2,2,0
IRN,ZAF,2006.0,1,2,-1
CAN,KAZ,2015.0,2,4,-2
ROU,SWE,2004.0,2,2,0
ETH,TZA,2003.0,1,1,0
DNK,HUN,2009.0,1,7,-6
DNK,SRB,2020.0,2,2,0
ROU,AUT,2005.0,1,1,0
GBR,RWA,2014.0,5,1,4
DEU,LVA,1998.0,1,3,-2
CAN,ROU,2007.0,1,6,-5
LBN,SWE,2020.0,2,1,1
TUN,ITA,2008.0,1,4,-3
PAK,HUN,2022.0,1,1,0
ISL,CAN,2021.0,1,4,-3
GHA,PAK,2022.0,1,1,0
DNK,LKA,2004.0,3,1,2
NGA,JPN,2004.0,3,5,-2
BIH,USA,2002.0,1,2,-1
KGZ,RUS,2018.0,1,6,-5
CHL,NZL,2016.0,1,9,-8
ITA,NOR,2000.0,3,4,-1
CHL,ITA,1997.0,2,2,0
AUS,PRT,1997.0,2,1,1
JOR,ARE,2000.0,4,2,2
COL,ZAF,2011.0,2,2,0
ISR,SWE,2000.0,2,6,-4
BRA,PRY,2011.0,3,2,1
QAT,ARE,2015.0,1,11,-10
VIR,USA,2020.0,1,6,-5
THA,ESP,2018.0,1,7,-6
SGP,MEX,2014.0,1,1,0
NLD,BLR,2018.0,1,1,0
RUS,IRN,2012.0,1,1,0
MOZ,BRA,2011.0,3,1,2
MUS,IND,2018.0,3,2,1
MYS,CAN,1999.0,3,2,1
COL,CRI,2021.0,1,3,-2
USA,MSR,2019.0,1,1,0
BHR,THA,2018.0,1,1,0
SWE,CZE,2004.0,1,9,-8
CHE,IDN,2022.0,1,2,-1
IDN,DEU,1999.0,2,3,-1
COD,ZAF,2017.0,1,2,-1
KOR,TWN,1997.0,1,1,0
MLT,CAN,2019.0,1,1,0
ARG,SVN,2018.0,1,1,0
NOR,SRB,2006.0,1,4,-3
UGA,ITA,1997.0,1,2,-1
SGP,JPN,1997.0,3,6,-3
AUS,BRN,2014.0,1,1,0
EGY,HUN,2023.0,1,8,-7
AUS,ZMB,2021.0,2,2,0
COL,EST,2020.0,1,1,0
TWN,AUT,2001.0,1,2,-1
IDN,ITA,2023.0,1,2,-1
JPN,CHL,2023.0,1,2,-1
CAN,GHA,1999.0,1,5,-4
GHA,CAN,2001.0,2,1,1
ITA,HKG,1998.0,1,1,0
NGA,NOR,2020.0,4,1,3
MEX,COL,1998.0,1,2,-1
VEN,COL,2003.0,1,3,-2
AUS,PAK,2007.0,2,5,-3
LUX,AUS,2017.0,1,3,-2
MWI,KEN,2021.0,2,1,1
IRQ,CHN,2014.0,2,3,-1
KWT,SAU,2020.0,1,11,-10
SGP,CZE,2022.0,1,2,-1
CZE,BLR,2023.0,1,1,0
BIH,SAU,2018.0,1,1,0
ZMB,COD,2019.0,1,1,0
AUT,DZA,2019.0,1,1,0
KAZ,DEU,2005.0,1,1,0
HUN,GRC,2023.0,3,1,2
MEX,GTM,1998.0,1,1,0
PRT,NGA,2018.0,2,2,0
BFA,BEL,2018.0,1,7,-6
ZMB,BEL,2019.0,1,1,0
MMR,IND,2018.0,1,4,-3
DNK,LUX,2020.0,1,1,0
MUS,ZAF,2022.0,1,1,0
CMR,UGA,2022.0,2,1,1
QAT,SWE,2018.0,1,1,0
AFG,CHN,2023.0,2,1,1
ARE,NLD,2023.0,4,3,1
NOR,ISR,2002.0,2,4,-2
IND,CZE,2000.0,1,1,0
CHL,CZE,2022.0,1,3,-2
TUN,SGP,2007.0,1,1,0
JOR,DEU,1997.0,2,4,-2
LKA,JPN,1999.0,3,4,-1
PRI,GBR,2008.0,1,1,0
NZL,OMN,1999.0,1,1,0
SAU,LBY,2012.0,1,2,-1
MYS,GRC,2018.0,1,1,0
SVN,SLV,2004.0,1,2,-1
UZB,BEL,2004.0,2,1,1
SWZ,ZAF,2007.0,1,2,-1
SWE,ARG,2005.0,1,1,0
NGA,GHA,2001.0,1,1,0
EGY,PSE,2002.0,2,2,0
CHN,DNK,1998.0,2,8,-6
JPN,CYP,2002.0,1,1,0
DZA,ITA,2008.0,1,1,0
JOR,FRA,2003.0,1,1,0
ARM,ITA,2000.0,1,4,-3
COG,NGA,2019.0,1,6,-5
MYS,CAN,1998.0,1,3,-2
BEL,PHL,2012.0,2,5,-3
YEM,QAT,2008.0,1,1,0
SRB,PRT,2013.0,1,4,-3
NOR,UGA,2008.0,1,1,0
TUN,IRQ,2019.0,1,1,0
HUN,GRC,2010.0,1,2,-1
NOR,SAU,2013.0,1,4,-3
SEN,ZAF,2009.0,2,1,1
DNK,HKG,2010.0,1,1,0
ZAF,FIN,2013.0,3,4,-1
AUS,CRI,2014.0,1,1,0
PRT,AGO,2009.0,1,1,0
BFA,TGO,2006.0,1,1,0
LTU,POL,2004.0,1,1,0
DNK,TWN,2015.0,1,1,0
USA,DJI,2011.0,1,1,0
CMR,ZAF,2004.0,3,2,1
IRN,BEL,2005.0,1,2,-1
ITA,URY,2003.0,1,1,0
ZAF,TUR,2010.0,2,3,-1
PAK,IRN,2004.0,1,1,0
IND,ATG,2015.0,1,1,0
ISR,IRN,2009.0,2,1,1
TZA,NLD,2015.0,1,6,-5
SVK,PRT,2012.0,1,1,0
VCT,ZAF,2005.0,1,1,0
CAN,LTU,2020.0,1,3,-2
PRI,MEX,2018.0,1,1,0
ECU,AUS,2018.0,3,3,0
GRD,CAN,2008.0,1,1,0
LBY,IND,2009.0,1,6,-5
FRA,ALB,2014.0,1,2,-1
MLI,ZAF,2009.0,1,1,0
ZAF,MLI,2013.0,1,1,0
SGP,IRL,2018.0,3,5,-2
LIE,CHE,2014.0,2,4,-2
DEU,LIE,2016.0,2,1,1
KOR,UKR,2022.0,1,1,0
KAZ,UKR,2014.0,1,1,0
SWE,JOR,2016.0,2,1,1
IDN,CAN,2015.0,2,8,-6
ITA,MKD,2015.0,1,1,0
SRB,SVK,2019.0,1,2,-1
IRL,KAZ,2016.0,1,1,0
VNM,PRT,2019.0,2,3,-1
TUN,AUT,2022.0,1,1,0
NOR,VNM,2021.0,2,2,0
DZA,IDN,2018.0,1,2,-1
KAZ,JPN,2021.0,3,4,-1
KEN,ISR,2019.0,1,1,0
GRC,NZL,2020.0,2,1,1
LKA,CHE,2019.0,1,3,-2
SVK,UKR,2010.0,1,1,0
JPN,KHM,2023.0,2,3,-1
VNM,POL,2020.0,1,4,-3
NGA,PHL,2021.0,3,1,2
AFG,CHN,2021.0,1,1,0
AUT,NPL,2008.0,1,2,-1
SWE,KEN,1997.0,1,1,0
ESP,SVK,2013.0,2,2,0
GBR,LVA,2001.0,2,6,-4
DNK,SRB,2002.0,1,7,-6
RUS,TUR,2000.0,4,3,1
UKR,BLR,2014.0,2,1,1
FRA,CUB,2004.0,4,1,3
DNK,TUR,2010.0,3,5,-2
SYC,FRA,2007.0,1,1,0
ITA,MAR,1997.0,1,1,0
KNA,USA,2018.0,4,2,2
GAB,FRA,2020.0,4,15,-11
ISR,TWN,2012.0,1,1,0
DEU,YEM,2020.0,1,1,0
AUS,TLS,2010.0,1,1,0
ZMB,NAM,2008.0,1,1,0
OMN,SWE,1998.0,1,1,0
USA,UZB,2000.0,1,3,-2
GBR,LTU,1997.0,3,2,1
VEN,URY,2008.0,1,1,0
BIH,USA,1998.0,1,1,0
MAR,GBR,1998.0,2,3,-1
SVN,FRA,2002.0,1,2,-1
CHE,TZA,2013.0,2,2,0
AUT,EGY,1998.0,1,1,0
DZA,CHE,2005.0,2,1,1
SDN,GBR,2001.0,5,1,4
MLT,FRA,2006.0,1,1,0
NPL,NLD,2020.0,1,3,-2
YEM,EGY,2005.0,3,2,1
FRA,VNM,1998.0,3,1,2
URY,FRA,1999.0,1,1,0
ZMB,JPN,2004.0,1,1,0
ZMB,JPN,2008.0,1,2,-1
AUS,EGY,2002.0,2,2,0
ECU,SWE,2000.0,1,1,0
AZE,USA,2008.0,1,2,-1
DZA,TUN,2012.0,2,2,0
LAO,KHM,2010.0,1,1,0
TWN,MWI,2010.0,1,3,-2
ARM,DEU,2006.0,2,6,-4
RUS,GRC,2017.0,1,2,-1
SVN,DNK,2013.0,1,2,-1
BRA,PRY,2010.0,1,4,-3
GRC,DZA,2009.0,1,1,0
SAU,POL,2023.0,3,1,2
HKG,AUT,2016.0,2,1,1
AUT,IRN,2002.0,1,2,-1
KEN,BEL,2009.0,2,4,-2
NZL,MDV,2018.0,1,1,0
GNB,DNK,2016.0,3,2,1
TTO,BRB,2012.0,2,3,-1
LKA,THA,2010.0,1,1,0
CIV,CMR,2019.0,1,2,-1
ITA,MRT,2012.0,1,1,0
ZMB,JPN,2015.0,1,3,-2
DEU,ZWE,2019.0,3,1,2
CHE,ROU,2008.0,5,4,1
THA,MMR,2014.0,3,1,2
BGR,NLD,2019.0,3,2,1
AUT,ETH,2013.0,2,1,1
EGY,YEM,2023.0,6,6,0
ZMB,GBR,2015.0,2,13,-11
SRB,VNM,2018.0,1,2,-1
UGA,NLD,2019.0,1,5,-4
KWT,AUS,2009.0,1,1,0
SGP,BGD,2016.0,1,2,-1
DEU,MDA,2002.0,2,6,-4
CHE,VNM,2007.0,1,1,0
PRT,IRL,1999.0,2,1,1
GBR,TUN,2002.0,1,1,0
SAU,IRQ,2016.0,1,1,0
VEN,BRA,1998.0,1,3,-2
CHN,ARE,2017.0,2,4,-2
BHR,DEU,2017.0,1,1,0
URY,ARG,2000.0,2,3,-1
FIN,ROU,2005.0,2,2,0
NOR,SVK,1999.0,1,1,0
NLD,NGA,2017.0,1,3,-2
GLP,MTQ,2017.0,1,1,0
ETH,ZWE,2018.0,3,2,1
CZE,UKR,2020.0,3,21,-18
CHE,MOZ,2022.0,1,2,-1
ZWE,CHE,2014.0,1,1,0
KEN,BFA,2016.0,1,1,0
USA,MNE,2013.0,1,2,-1
MLI,GIN,2023.0,2,1,1
NPL,NOR,2023.0,2,1,1
ROU,PRT,2003.0,1,1,0
AUT,SAU,2022.0,1,7,-6
RUS,IND,2004.0,3,2,1
MAR,MEX,2013.0,1,2,-1
CHE,MYS,2015.0,2,2,0
GBR,SLE,2014.0,1,1,0
LTU,AUS,2023.0,2,1,1
NZL,GRC,2015.0,1,2,-1
SDN,JPN,2012.0,1,2,-1
ARE,IRN,2018.0,3,2,1
PAN,CHE,2015.0,1,2,-1
KEN,BGD,2014.0,1,1,0
TGO,DEU,2012.0,1,1,0
BFA,AUT,2015.0,1,1,0
CZE,DNK,2022.0,5,4,1
NGA,AUS,2006.0,3,2,1
KOR,KAZ,2021.0,5,4,1
SWE,NIC,2003.0,2,1,1
KHM,VNM,2011.0,1,2,-1
TWN,MAC,2022.0,2,2,0
CAN,LBN,2001.0,2,5,-3
CHE,CUB,2020.0,1,1,0
ISL,AUT,2021.0,1,1,0
UGA,CHE,2015.0,2,5,-3
GBR,BWA,2013.0,1,3,-2
USA,LBY,2020.0,3,2,1
ATG,USA,2022.0,2,4,-2
ISR,DNK,2020.0,5,5,0
FRA,GHA,2019.0,2,1,1
VNM,SWE,2018.0,1,6,-5
BFA,SEN,2001.0,2,2,0
YEM,DEU,2014.0,1,2,-1
LKA,SGP,2007.0,1,1,0
UGA,KEN,2000.0,3,1,2
THA,AUT,2004.0,2,4,-2
URY,NLD,2020.0,2,1,1
CMR,USA,2006.0,6,2,4
AUS,IRQ,2007.0,1,1,0
ZAF,LSO,2008.0,2,4,-2
MDA,FIN,2006.0,2,2,0
COL,BEL,2003.0,2,2,0
GBR,ZMB,2005.0,1,1,0
CMR,NLD,2004.0,1,1,0
PRT,GRC,2002.0,1,2,-1
ZAF,IND,2000.0,3,4,-1
CHE,KOR,2008.0,5,13,-8
SGP,TWN,2003.0,3,3,0
ITA,COG,2020.0,2,2,0
RUS,ZAF,2011.0,2,3,-1
BWA,SWZ,2006.0,1,1,0
GHA,NLD,2006.0,4,1,3
KEN,ETH,2001.0,2,3,-1
NZL,EST,2022.0,1,1,0
GAB,DEU,2008.0,1,3,-2
LKA,HKG,2010.0,1,1,0
LSO,ITA,2004.0,1,1,0
LBY,IND,2019.0,1,1,0
KNA,CAN,2019.0,1,2,-1
BEL,NGA,2012.0,1,2,-1
RUS,LTU,2008.0,2,1,1
SVK,ESP,2008.0,2,3,-1
BWA,GBR,2014.0,3,8,-5
CAN,BLR,2002.0,1,7,-6
GBR,PER,2012.0,4,5,-1
SYR,FRA,2014.0,3,11,-8
USA,BOL,2021.0,3,7,-4
ISR,ISL,2019.0,1,2,-1
SAU,RUS,2012.0,1,2,-1
URY,DEU,2021.0,2,2,0
SWE,POL,2023.0,6,14,-8
SVN,IND,2022.0,2,4,-2
BIH,AUT,2015.0,2,2,0
THA,SWE,2018.0,3,8,-5
ZMB,CHN,2017.0,1,1,0
GBR,AZE,2018.0,1,1,0
CHE,EST,2020.0,1,4,-3
NZL,NOR,2013.0,3,4,-1
CAN,JAM,2012.0,2,2,0
AUS,VEN,2001.0,1,2,-1
BFA,ITA,2004.0,1,1,0
CAN,BGR,2018.0,2,2,0
COG,FRA,2018.0,2,6,-4
DEU,BIH,2020.0,1,3,-2
ZAF,RUS,2010.0,2,5,-3
GNB,DNK,2022.0,2,3,-1
PSE,EGY,2013.0,1,1,0
KOR,PER,2017.0,1,1,0
AUS,MOZ,2018.0,1,2,-1
EST,FRA,2016.0,2,3,-1
IRN,FRA,2001.0,1,9,-8
DNK,ECU,2019.0,1,1,0
POL,ISL,2018.0,1,1,0
EGY,IND,2013.0,2,2,0
CHE,VEN,2016.0,1,2,-1
BRA,LKA,2020.0,1,1,0
DEU,NPL,2021.0,2,6,-4
NLD,OMN,1999.0,1,1,0
BFA,MLI,2019.0,2,2,0
SAU,NOR,2018.0,1,2,-1
KOR,HUN,2011.0,1,1,0
COL,CRI,2010.0,3,1,2
GBR,JAM,2003.0,2,3,-1
BMU,GBR,2022.0,1,2,-1
BGD,BEL,2014.0,3,4,-1
PRT,ISR,2012.0,2,1,1
ISR,PRT,2013.0,2,1,1
ITA,PSE,2023.0,2,1,1
USA,VIR,2006.0,2,6,-4
COL,VEN,1997.0,2,1,1
LIE,CHE,2008.0,1,2,-1
CUB,FRA,2003.0,2,2,0
SDN,GBR,2014.0,3,4,-1
MWI,DEU,2002.0,1,2,-1
JPN,SAU,2006.0,3,1,2
LVA,FIN,2018.0,2,2,0
BEL,PHL,2020.0,2,4,-2
PAK,GBR,2024.0,1,1,0
SVN,POL,2015.0,2,3,-1
COD,NGA,2020.0,1,2,-1
SWE,CUB,2013.0,1,1,0
ESP,ARE,2014.0,1,2,-1
AUS,SLB,2018.0,2,2,0
SAU,SYR,2019.0,1,4,-3
SRB,TUR,2004.0,1,1,0
AUT,ISR,2019.0,3,3,0
PAK,KEN,2019.0,2,3,-1
DEU,BLR,2018.0,2,4,-2
QAT,MYS,2015.0,1,5,-4
MDG,ITA,2015.0,1,1,0
SYR,IRQ,2016.0,2,1,1
SYR,JPN,1999.0,1,1,0
CYP,CAN,2018.0,1,6,-5
KEN,COG,2017.0,1,1,0
THA,TWN,2015.0,2,5,-3
BRA,ZAF,1998.0,1,1,0
QAT,GBR,2012.0,1,18,-17
ARM,BEL,2014.0,1,1,0
TUN,EGY,2016.0,2,3,-1
DNK,CHL,2019.0,1,3,-2
EGY,MEX,2019.0,2,2,0
GAB,GBR,2016.0,2,2,0
BLR,ISR,2007.0,1,1,0
AUT,BFA,2021.0,1,2,-1
RUS,IND,2001.0,3,3,0
BGD,BTN,2019.0,1,1,0
ARE,SGP,2018.0,3,2,1
SGP,BGD,2022.0,2,2,0
CHN,ERI,2020.0,2,1,1
HUN,DZA,2022.0,1,1,0
IRQ,ROU,2020.0,2,5,-3
IRN,AUS,2024.0,1,2,-1
DNK,IRN,2016.0,3,28,-25
ZMB,CHN,2022.0,1,7,-6
CMR,DEU,2023.0,1,8,-7
SWZ,CHE,2023.0,3,4,-1
GTM,CAN,2023.0,1,1,0
BEN,FRA,2004.0,5,5,0
LTU,CHE,2012.0,2,3,-1
CAN,CIV,2014.0,3,2,1
TZA,KEN,2014.0,2,6,-4
USA,CMR,2006.0,2,6,-4
DEU,BLR,2017.0,5,7,-2
KOR,TUR,2016.0,2,8,-6
NAM,NOR,2005.0,1,1,0
JOR,GRC,2020.0,1,2,-1
ESP,IRN,2010.0,3,13,-10
TZA,NLD,2004.0,1,2,-1
CMR,NGA,2013.0,1,3,-2
GBR,BRB,2006.0,2,1,1
EGY,CHE,2001.0,3,1,2
NZL,HUN,2017.0,1,1,0
GHA,CAN,2013.0,2,5,-3
IRL,THA,2006.0,1,1,0
LBN,LBY,2006.0,2,3,-1
AUS,TUR,2003.0,1,1,0
USA,AZE,2011.0,3,1,2
BRA,CIV,2015.0,1,3,-2
ARE,TUR,2007.0,1,1,0
FRA,URY,2006.0,2,5,-3
IRN,ITA,2003.0,2,3,-1
NLD,BGR,2011.0,1,2,-1
ITA,SYR,2005.0,1,1,0
DEU,ALB,2006.0,2,1,1
IDN,CAN,2001.0,2,2,0
NGA,ETH,2004.0,1,1,0
HKG,NZL,2007.0,1,3,-2
ARM,FRA,2000.0,2,2,0
NLD,EST,2008.0,1,1,0
KWT,ARE,2014.0,3,2,1
TZA,USA,2006.0,4,8,-4
KEN,TUR,2006.0,2,1,1
NGA,CMR,2007.0,1,3,-2
SDN,KEN,2017.0,2,1,1
HUN,DNK,2005.0,1,1,0
CAN,LKA,1998.0,1,1,0
AUT,KOR,2013.0,1,4,-3
GBR,LVA,2008.0,1,1,0
AUT,THA,2010.0,3,6,-3
MOZ,NLD,2014.0,1,2,-1
KHM,FRA,2007.0,1,1,0
HTI,USA,2006.0,1,12,-11
LTU,ITA,2002.0,2,4,-2
ITA,ETH,2011.0,1,2,-1
PER,CAN,2010.0,1,4,-3
SGP,GRC,2010.0,1,1,0
PER,ECU,2008.0,2,1,1
ZWE,BEL,2007.0,1,1,0
QAT,SGP,2016.0,1,2,-1
CAN,IRQ,2023.0,5,2,3
VNM,CHE,2021.0,2,3,-1
CAN,CMR,2009.0,2,3,-1
KEN,AUS,2008.0,2,2,0
EGY,DZA,2009.0,2,1,1
KOR,NPL,2013.0,2,2,0
CAN,SEN,2011.0,2,1,1
AUT,TWN,2014.0,2,3,-1
JPN,CHL,2011.0,2,2,0
NGA,EGY,2012.0,1,2,-1
PHL,HKG,2010.0,1,1,0
CHE,ARG,2011.0,4,3,1
CHE,TWN,2012.0,3,2,1
LAO,VNM,2019.0,3,5,-2
AUS,VEN,2014.0,1,4,-3
TUN,GBR,2012.0,1,2,-1
MYS,DEU,2003.0,1,1,0
SGP,JPN,1999.0,3,8,-5
ISR,GRC,2019.0,1,2,-1
ISR,FIN,2011.0,2,2,0
GRC,EST,2012.0,2,1,1
NOR,LBN,2020.0,1,1,0
HUN,ESP,2016.0,1,6,-5
NZL,ZMB,2020.0,1,1,0
COL,KHM,2016.0,1,1,0
AUS,GRC,2022.0,3,2,1
DEU,MNG,2023.0,1,1,0
HUN,LTU,2020.0,1,1,0
RUS,HUN,2018.0,3,2,1
BFA,NER,2018.0,4,1,3
JPN,IDN,2024.0,1,1,0
BIH,TUR,2023.0,2,1,1
TLS,AUS,2017.0,1,4,-3
CHE,TGO,2018.0,1,1,0
HKG,RUS,2021.0,1,4,-3
BGD,IRN,2021.0,1,2,-1
CHL,SWE,2008.0,1,4,-3
LBN,AUS,2019.0,1,3,-2
KAZ,CAN,2023.0,2,1,1
UKR,ISR,2010.0,1,1,0
ZAF,IND,2006.0,3,11,-8
CZE,ARG,2018.0,2,2,0
AUS,HUN,2009.0,3,4,-1
ETH,KEN,2012.0,3,1,2
GBR,LTU,2012.0,4,7,-3
IRL,RUS,2005.0,2,3,-1
CRI,SWE,2003.0,3,1,2
TWN,RUS,2006.0,1,7,-6
ETH,KEN,2005.0,1,3,-2
GRC,CAN,2000.0,3,11,-8
FIN,PAK,2016.0,2,3,-1
EGY,DNK,1997.0,1,2,-1
SAU,FRA,1997.0,1,3,-2
ZAF,AUT,2003.0,2,1,1
IDN,LAO,2014.0,1,1,0
POL,MDA,2012.0,2,1,1
COG,DEU,2009.0,1,1,0
MYS,POL,2023.0,2,1,1
SVN,POL,2008.0,2,2,0
ITA,BFA,2011.0,2,3,-1
SRB,CAN,2023.0,1,2,-1
COL,AUS,2014.0,4,5,-1
JPN,NGA,2015.0,1,3,-2
AUT,SAU,2017.0,1,2,-1
NOR,IRN,2009.0,1,6,-5
MMR,JPN,2010.0,2,4,-2
DEU,ALB,2010.0,2,1,1
AUT,IRL,2014.0,2,4,-2
KAZ,DEU,2007.0,1,2,-1
CAN,VEN,2006.0,1,9,-8
KWT,PAK,2015.0,1,2,-1
KWT,FRA,2015.0,1,4,-3
TTO,IRL,2016.0,1,1,0
UZB,MYS,2005.0,1,1,0
TZA,BEN,2013.0,1,1,0
PHL,MEX,2022.0,1,1,0
ZAF,BGD,2018.0,1,1,0
OMN,JOR,2019.0,2,5,-3
JOR,OMN,2002.0,1,2,-1
CAN,URY,2010.0,1,2,-1
NLD,MAC,2018.0,1,2,-1
CHN,MEX,2018.0,1,6,-5
NOR,SRB,2019.0,1,3,-2
EGY,HUN,2009.0,1,5,-4
USA,SYR,2009.0,2,3,-1
JPN,LTU,2013.0,2,1,1
NLD,HKG,2008.0,1,3,-2
BRB,TTO,2008.0,2,4,-2
BEL,TWN,2018.0,6,5,1
NLD,TWN,2010.0,2,6,-4
BGR,AUS,2011.0,1,2,-1
AUS,BGR,2017.0,1,1,0
IRN,HUN,2008.0,1,2,-1
EST,NOR,2013.0,2,3,-1
MDA,ROU,2000.0,1,1,0
SVK,CAN,2009.0,3,3,0
USA,LBY,2007.0,1,1,0
BGR,GBR,2009.0,7,9,-2
PHL,BGD,2005.0,1,2,-1
DZA,ARG,2014.0,1,3,-2
ISL,ESP,2012.0,2,1,1
RUS,KGZ,2005.0,1,1,0
PAK,SGP,2004.0,1,2,-1
PAK,KWT,2023.0,1,1,0
FIN,BLR,2019.0,1,1,0
MEX,IDN,2019.0,1,1,0
CHN,PHL,2018.0,3,6,-3
THA,BRN,2002.0,1,1,0
SLV,BRA,2021.0,2,1,1
GEO,UKR,2017.0,1,1,0
GBR,MOZ,2008.0,1,1,0
ESP,MLT,2020.0,1,2,-1
PSE,DEU,2021.0,1,10,-9
KAZ,NGA,2022.0,1,2,-1
CIV,SEN,2022.0,1,1,0
ISL,BEL,2020.0,1,1,0
SWE,SOM,2017.0,1,1,0
BEL,EST,2023.0,2,1,1
AUT,COL,2023.0,1,2,-1
SEN,USA,2014.0,3,11,-8
CAN,CIV,2004.0,1,2,-1
CHE,PAN,2016.0,2,2,0
SDN,USA,2013.0,3,2,1
TZA,DEU,2010.0,2,3,-1
UGA,JPN,2017.0,2,1,1
UKR,AUS,2013.0,1,2,-1
LBN,ISR,2015.0,1,1,0
SLV,SVN,2008.0,2,2,0
ITA,CUB,2009.0,3,3,0
FJI,USA,2012.0,1,2,-1
TUN,SGP,2012.0,1,1,0
CHN,KWT,2014.0,1,2,-1
SDN,DEU,2009.0,1,7,-6
NLD,PAN,2014.0,1,1,0
COG,AUS,2006.0,1,2,-1
DZA,ARG,2008.0,1,1,0
FIN,LTU,2007.0,2,3,-1
SDN,IRN,2018.0,1,1,0
DZA,KOR,2020.0,2,1,1
AUT,CHN,2004.0,1,3,-2
SRB,SVN,2013.0,3,6,-3
ZAF,LSO,2014.0,1,1,0
GBR,NCL,2018.0,1,1,0
ZMB,JPN,2001.0,2,1,1
ROU,DNK,2019.0,3,4,-1
IRQ,SRB,2016.0,1,1,0
DNK,NZL,2015.0,2,5,-3
JPN,GHA,2016.0,3,3,0
CHN,GEO,2016.0,1,2,-1
PRT,PAK,2019.0,1,3,-2
CHL,CRI,2014.0,1,3,-2
SWE,QAT,2021.0,1,2,-1
IDN,ITA,2019.0,1,4,-3
NZL,POL,2022.0,1,3,-2
UGA,NGA,2007.0,1,1,0
ZWE,MWI,2011.0,1,1,0
ESP,ETH,2005.0,1,1,0
LBN,MAR,2020.0,1,2,-1
BEL,FIN,2000.0,3,5,-2
SVN,ESP,2004.0,2,2,0
NPL,THA,2001.0,1,1,0
UKR,NLD,2009.0,2,1,1
FRA,BOL,1998.0,4,4,0
NIC,PAN,2013.0,1,1,0
ZAF,LKA,2013.0,1,1,0
CHN,EST,2018.0,2,2,0
RUS,LVA,2018.0,2,2,0
ZWE,CAN,2006.0,1,1,0
SRB,BEL,2002.0,1,7,-6
SAU,NOR,2016.0,1,3,-2
BHR,IND,2000.0,1,1,0
SWE,BGR,1999.0,1,3,-2
SWE,SGP,2005.0,2,5,-3
UKR,NOR,2001.0,1,2,-1
BLR,BEL,1997.0,1,1,0
FRA,SVN,2002.0,2,1,1
JPN,ZMB,2004.0,1,1,0
IRL,ISR,2004.0,2,1,1
SRB,AUS,2005.0,1,1,0
AUS,SRB,2012.0,1,2,-1
PRI,CHN,2010.0,1,1,0
HUN,CZE,2011.0,2,4,-2
UGA,SWE,2015.0,1,4,-3
BEL,MAR,2019.0,3,7,-4
IRN,QAT,2015.0,2,1,1
MEX,PAN,2012.0,1,2,-1
USA,SUR,2013.0,1,1,0
ARE,IRQ,2015.0,1,1,0
ZAF,MWI,2013.0,3,3,0
SLE,CHN,2010.0,2,1,1
IRL,SRB,2014.0,1,3,-2
IRN,BLR,2008.0,1,1,0
NGA,JPN,2013.0,2,5,-3
GBR,TUN,2012.0,2,1,1
FIN,MYS,2017.0,1,2,-1
FRA,BLR,2016.0,1,1,0
IND,FJI,2006.0,1,1,0
SGP,LKA,2003.0,1,1,0
AUS,KHM,2018.0,3,2,1
IRQ,SRB,2018.0,1,3,-2
EGY,MAR,2017.0,2,2,0
TUR,DNK,2014.0,3,6,-3
IRL,LBN,2020.0,1,4,-3
NGA,IDN,2018.0,1,1,0
COD,FRA,2019.0,1,7,-6
BEL,ITA,2024.0,1,3,-2
GHA,CMR,2020.0,1,1,0
OMN,TUN,2017.0,1,2,-1
UGA,GHA,2018.0,1,3,-2
ETH,EGY,2022.0,1,1,0
SWE,KAZ,2021.0,1,1,0
NGA,THA,2022.0,1,3,-2
TUR,DZA,2021.0,2,7,-5
PER,JPN,2005.0,1,1,0
EUE,ESP,2009.0,1,1,0
MAR,BEL,2016.0,3,10,-7
NOR,MWI,2014.0,2,2,0
SVN,LTU,2021.0,1,2,-1
SYR,SAU,2020.0,1,2,-1
CIV,NGA,2021.0,1,3,-2
UGA,TZA,2007.0,1,1,0
TWN,NPL,2021.0,1,2,-1
NOR,MWI,2015.0,3,2,1
ZAF,CZE,2015.0,1,3,-2
FRA,OMN,2010.0,1,2,-1
BLR,PRT,2008.0,2,1,1
CZE,SVN,2011.0,1,3,-2
LAO,SWE,2013.0,1,2,-1
USA,PNG,2010.0,1,2,-1
CAN,ROU,2005.0,2,4,-2
IND,SRB,2007.0,1,3,-2
TZA,CAN,2015.0,1,1,0
KAZ,BEL,2022.0,2,5,-3
EST,FRA,2022.0,2,4,-2
GBR,SOM,2022.0,1,2,-1
BGD,OMN,2015.0,2,2,0
USA,GMB,2016.0,4,2,2
TWN,RUS,2023.0,2,1,1
IND,LTU,2021.0,1,1,0
SGP,SRB,2022.0,1,1,0
ASM,USA,2019.0,2,4,-2
BGD,GRC,2022.0,1,1,0
SEN,MAR,2023.0,1,1,0
TUN,USA,1997.0,1,3,-2
AUT,ETH,2003.0,1,2,-1
SVN,CHE,2005.0,2,2,0
PRT,PRI,2000.0,1,3,-2
GBR,NIC,2003.0,1,1,0
SUR,USA,2013.0,1,1,0
COL,GBR,1997.0,1,2,-1
POL,ISL,2022.0,1,1,0
DEU,BLR,2016.0,2,9,-7
ZWE,KEN,2012.0,1,2,-1
FRA,ARM,2001.0,2,5,-3
SWE,KWT,2004.0,1,1,0
BEL,GMB,2014.0,1,1,0
THA,PHL,2015.0,3,3,0
ZAF,MEX,2007.0,2,2,0
TWN,UKR,2019.0,2,1,1
ESP,TTO,2014.0,1,1,0
TUN,MAR,2015.0,1,2,-1
SWE,NPL,2020.0,1,4,-3
DOM,CHL,2015.0,1,2,-1
THA,FIN,2012.0,1,1,0
CHE,LKA,2017.0,3,2,1
MMR,MYS,2021.0,1,3,-2
GTM,MEX,2014.0,1,2,-1
PRY,ESP,2014.0,3,1,2
CHE,CMR,2012.0,2,1,1
LVA,EST,2010.0,1,1,0
DEU,PRI,2018.0,1,2,-1
PRT,SRB,2015.0,1,1,0
UKR,AZE,2016.0,1,1,0
RUS,CHL,2003.0,1,1,0
VNM,KOR,2006.0,2,6,-4
ROU,RUS,2017.0,1,3,-2
UGA,ITA,2020.0,2,3,-1
ESP,HUN,2001.0,1,5,-4
COD,CHE,2021.0,1,6,-5
DOM,DMA,2019.0,1,2,-1
SRB,HUN,2004.0,2,2,0
EST,CHN,2021.0,3,3,0
CAN,PHL,2003.0,1,3,-2
RUS,NZL,2003.0,1,2,-1
KOR,TZA,2022.0,1,2,-1
IDN,IND,2023.0,2,5,-3
PER,MEX,1997.0,1,1,0
ITA,HKG,1997.0,1,1,0
PHL,MYS,2009.0,2,1,1
IDN,PHL,2007.0,1,2,-1
GRC,JPN,1997.0,1,2,-1
KEN,THA,2011.0,1,1,0
ARG,BEL,2007.0,1,2,-1
TUR,IND,2003.0,1,2,-1
ALB,GBR,2020.0,1,3,-2
ARE,SDN,2016.0,1,1,0
SLV,ESP,2021.0,2,2,0
DNK,TZA,2021.0,1,6,-5
NGA,KOR,2014.0,1,1,0
MWI,ZMB,2022.0,2,3,-1
BFA,NER,2022.0,2,1,1
GRC,HUN,2021.0,1,1,0
LKA,PAK,2006.0,1,1,0
IRL,LBY,2021.0,1,1,0
ISL,NLD,2022.0,2,1,1
IRN,VNM,2023.0,1,1,0
BRA,CPV,2021.0,1,2,-1
REU,GBR,2021.0,1,1,0
MAR,IRN,2021.0,1,1,0
PAK,BGD,1999.0,1,1,0
POL,DZA,2023.0,1,1,0
CIV,IND,2023.0,1,1,0
ECU,BEL,2023.0,1,3,-2
QAT,SYR,2023.0,1,3,-2
NZL,NPL,2005.0,1,1,0
GBR,MNG,1998.0,3,1,2
CMR,DEU,2006.0,3,2,1
IND,PHL,1999.0,3,2,1
CHE,CYP,2020.0,2,1,1
BFA,CAN,2002.0,1,1,0
DEU,MNG,2010.0,3,1,2
SRB,ALB,2011.0,3,6,-3
COL,ARG,1999.0,2,4,-2
USA,MNP,2006.0,1,2,-1
FLK,AUS,2010.0,1,2,-1
NIC,ESP,1999.0,1,2,-1
CHE,UKR,2006.0,1,3,-2
SVK,CAN,2011.0,1,5,-4
ZAF,TUR,2009.0,2,2,0
FRA,CRI,2004.0,1,3,-2
BOL,BRA,2005.0,1,2,-1
PHL,CAN,2012.0,1,1,0
JPN,ISR,2014.0,2,3,-1
KEN,ZMB,2021.0,1,4,-3
BEL,ISL,2013.0,1,1,0
FRA,CAF,1999.0,1,5,-4
CMR,GAB,2010.0,1,1,0
SWE,KWT,2008.0,1,1,0
ZWE,AUS,2000.0,2,2,0
CHN,HRV,2014.0,1,1,0
NLD,CUB,2008.0,1,1,0
HKG,SWE,2001.0,1,1,0
USA,SWZ,2013.0,1,5,-4
TUR,LTU,2022.0,1,2,-1
AZE,KOR,2022.0,1,1,0
ROU,FIN,2007.0,1,3,-2
ITA,MCO,2011.0,1,1,0
BGD,NZL,2020.0,1,3,-2
AUT,CYP,2012.0,1,1,0
ISL,ITA,2017.0,1,1,0
ROU,TUR,2004.0,2,2,0
IRL,ZAF,2009.0,1,3,-2
SWE,SRB,2023.0,2,3,-1
MDG,DEU,2009.0,1,2,-1
BRN,OMN,2011.0,1,1,0
ESP,NIC,2015.0,1,1,0
ITA,ARM,1997.0,2,1,1
TWN,CHL,2015.0,1,2,-1
DEU,PER,2010.0,1,1,0
NOR,ROU,2011.0,1,5,-4
ETH,CAN,2012.0,1,2,-1
HRV,QAT,2021.0,1,1,0
AZE,ESP,2017.0,1,1,0
KNA,GBR,2017.0,1,1,0
UZB,DEU,2021.0,1,10,-9
HKG,ARE,2009.0,1,1,0
ISR,MEX,2014.0,1,2,-1
ARE,JPN,2012.0,1,3,-2
USA,CIV,2022.0,2,4,-2
QAT,ARE,2013.0,2,6,-4
BEL,NOR,2006.0,1,1,0
CZE,SGP,2015.0,1,2,-1
NLD,GHA,2010.0,2,4,-2
DEU,MAR,2012.0,2,3,-1
CHL,FIN,2016.0,1,5,-4
DEU,THA,2001.0,3,8,-5
MEX,URY,2013.0,1,2,-1
MKD,SVN,2014.0,1,1,0
EST,LTU,2016.0,1,1,0
THA,IRN,2011.0,2,2,0
KWT,IND,2022.0,1,6,-5
BEN,NER,2021.0,1,1,0
IDN,DNK,2014.0,1,2,-1
BFA,COG,2021.0,1,2,-1
EST,VNM,2020.0,1,1,0
CYP,IRQ,2021.0,1,1,0
MAR,JPN,2022.0,1,1,0
NGA,MEX,2023.0,2,1,1
PER,KOR,2023.0,2,1,1
FRO,DNK,2015.0,2,2,0
BEN,DEU,2000.0,2,1,1
USA,BLZ,2006.0,1,2,-1
BIH,AUT,2008.0,1,3,-2
CMR,GBR,1999.0,1,2,-1
NLD,HRV,1999.0,1,2,-1
SWE,SVK,2009.0,1,3,-2
NLD,HRV,2007.0,2,1,1
ZAF,MAR,2015.0,1,3,-2
NGA,SWE,2007.0,1,1,0
PSE,USA,1998.0,1,2,-1
OMN,NZL,2014.0,1,1,0
PRT,GRC,2012.0,1,4,-3
UGA,NLD,2009.0,1,2,-1
USA,LVA,2002.0,1,4,-3
NGA,AUS,2000.0,3,1,2
TWN,MWI,2023.0,1,1,0
CAN,SYR,2014.0,1,1,0
VEN,CUB,2013.0,4,2,2
MUS,FRA,2018.0,1,3,-2
DNK,FRO,2018.0,3,1,2
FIN,SAU,2014.0,2,3,-1
CAN,KAZ,2013.0,1,1,0
ARM,IRN,2008.0,1,1,0
NLD,QAT,2017.0,2,9,-7
PAK,ZAF,2009.0,1,1,0
JPN,MWI,2018.0,2,1,1
FRA,TGO,2008.0,2,2,0
SDN,DEU,2021.0,2,2,0
KEN,THA,2021.0,1,1,0
CAN,CMR,2021.0,2,5,-3
USA,GAB,2015.0,3,5,-2
KHM,THA,2013.0,1,2,-1
SVK,AUS,2017.0,1,2,-1
LVA,DNK,2014.0,1,2,-1
HUN,PRT,2018.0,1,1,0
HUN,AZE,2020.0,2,1,1
DNK,MEX,2016.0,4,3,1
USA,BOL,2009.0,3,6,-3
BEN,BFA,2018.0,1,2,-1
HUN,MYS,2022.0,1,4,-3
ARG,CRI,2014.0,1,3,-2
LTU,ITA,2012.0,1,4,-3
COG,RWA,2015.0,1,1,0
EST,CHE,2020.0,4,1,3
LUX,ROU,2019.0,1,1,0
ARE,IRN,2016.0,2,1,1
TZA,ESP,2016.0,1,1,0
UKR,KGZ,2018.0,1,1,0
SEN,KEN,2021.0,1,3,-2
SRB,IND,2002.0,1,1,0
KWT,QAT,2017.0,1,1,0
SAU,AZE,2020.0,1,2,-1
HRV,SVK,1999.0,1,1,0
JOR,KWT,2006.0,1,1,0
BEL,COG,2001.0,1,2,-1
AZE,USA,2004.0,1,2,-1
OMN,MYS,2007.0,1,1,0
NER,FRA,2013.0,1,10,-9
BRA,HUN,2012.0,2,3,-1
SVK,PRT,2005.0,1,1,0
IND,TTO,2004.0,1,1,0
CHL,CHN,2002.0,1,4,-3
CIV,CAN,2019.0,2,5,-3
FRA,OMN,2006.0,1,1,0
KEN,RWA,2013.0,1,1,0
BGR,SRB,2015.0,1,2,-1
MLI,CAN,2008.0,2,1,1
KAZ,ARE,2018.0,2,2,0
GBR,NER,2019.0,1,1,0
TZA,CAN,2014.0,1,1,0
AUS,TTO,2011.0,1,1,0
LTU,EST,2016.0,1,1,0
QAT,JPN,2021.0,1,2,-1
CMR,BWA,2018.0,1,1,0
ETH,ISR,2016.0,2,1,1
VNM,PRT,2021.0,1,1,0
PAN,AUS,2019.0,1,1,0
BOL,CHL,2019.0,2,3,-1
SGP,IRL,2017.0,2,5,-3
HND,MEX,2018.0,1,2,-1
JOR,EGY,2010.0,3,1,2
BGD,NOR,2010.0,2,1,1
MYS,MDV,2022.0,1,1,0
VNM,SWE,2022.0,1,3,-2
FRA,LVA,2010.0,1,1,0
MEX,NGA,2020.0,2,1,1
RUS,ISL,2022.0,2,1,1
ECU,RUS,2020.0,1,1,0
PAK,CZE,2022.0,2,6,-4
BGD,OMN,2014.0,2,1,1
BDI,CHN,2023.0,1,4,-3
UGA,ESP,2020.0,1,1,0
SAU,BRA,2021.0,1,7,-6
IND,PHL,1998.0,1,6,-5
USA,BMU,2007.0,3,3,0
PAN,CRI,2016.0,1,1,0
PRY,JPN,2003.0,1,3,-2
THA,SGP,2004.0,2,1,1
VEN,CUB,2003.0,1,2,-1
IRL,MEX,2010.0,1,2,-1
KWT,ARE,2001.0,1,1,0
URY,CHL,2005.0,2,1,1
PHL,NLD,2002.0,2,1,1
MYS,DNK,2019.0,1,5,-4
FRA,CAF,2017.0,3,2,1
EST,CAN,2002.0,1,2,-1
QAT,DZA,2021.0,1,4,-3
BEL,MWI,2018.0,2,2,0
RUS,CYP,2023.0,2,1,1
NLD,EST,2021.0,1,3,-2
ZAF,MEX,2016.0,2,1,1
RUS,CHL,2023.0,2,1,1
EGY,KEN,2022.0,1,1,0
USA,SDN,2010.0,2,1,1
NZL,SAU,2013.0,1,1,0
CHN,IND,1998.0,1,1,0
IND,HRV,2020.0,1,4,-3
ISR,POL,2012.0,1,3,-2
SWE,CRI,2003.0,1,3,-2
ESP,MDA,2007.0,2,2,0
NPL,JPN,2011.0,2,8,-6
USA,GUM,2000.0,1,16,-15
ITA,CUB,2014.0,3,3,0
CZE,UKR,2016.0,2,9,-7
BEL,NZL,2000.0,1,1,0
USA,SYC,2021.0,1,2,-1
ZAF,JPN,2002.0,1,3,-2
NGA,ITA,2007.0,2,1,1
BRA,DNK,1998.0,1,3,-2
BHS,USA,2011.0,1,4,-3
GUY,GUF,2005.0,2,1,1
IRL,ZAF,2001.0,2,1,1
DEU,ECU,2009.0,1,1,0
LBR,CHN,2021.0,1,1,0
BGD,EGY,2015.0,2,1,1
IDN,DNK,2021.0,1,4,-3
ATG,IND,2022.0,1,3,-2
LKA,BEL,2020.0,1,1,0
ZMB,NGA,2023.0,1,1,0
CMR,TCD,2018.0,1,1,0
FRA,JOR,2023.0,1,2,-1
POL,TUR,2023.0,1,5,-4
BEL,ARG,2022.0,2,9,-7
CZE,LTU,2004.0,1,1,0
ZAF,CMR,2002.0,1,4,-3
BRA,EGY,2003.0,1,1,0
JOR,NLD,2002.0,1,1,0
AFG,FRA,2018.0,2,5,-3
FRA,ISL,2007.0,1,1,0
CRI,MEX,2018.0,2,7,-5
PRT,MAR,2006.0,1,1,0
NLD,EGY,2001.0,1,2,-1
ESP,HRV,2003.0,1,3,-2
JPN,ARM,2000.0,1,1,0
MNE,DEU,2014.0,1,1,0
HUN,SRB,2000.0,2,2,0
TUN,MAR,2011.0,2,1,1
LKA,IND,2002.0,1,2,-1
PHL,MYS,2008.0,1,3,-2
USA,BEN,2018.0,3,2,1
HKG,VNM,2010.0,1,1,0
POL,BLR,2017.0,2,3,-1
BEL,GUF,2020.0,1,1,0
AUS,SVN,2015.0,1,3,-2
VEN,CAN,2009.0,1,3,-2
CHN,PRT,1997.0,2,2,0
KOR,KHM,2012.0,1,2,-1
SYR,GBR,2010.0,1,4,-3
SVK,SRB,2015.0,1,2,-1
ROU,CYP,2019.0,1,1,0
TWN,ITA,2007.0,3,1,2
HUN,IRN,2004.0,1,1,0
GBR,IRQ,2010.0,1,4,-3
CZE,ECU,2022.0,1,3,-2
NLD,SRB,2018.0,3,1,2
UKR,MEX,2014.0,1,1,0
PER,ISR,2015.0,1,1,0
CHN,LBR,2017.0,1,1,0
SVN,BGR,2021.0,1,1,0
JPN,USA,2024.0,2,5,-3
VEN,CRI,2016.0,1,1,0
IND,ERI,2014.0,1,1,0
OMN,PSE,2016.0,2,1,1
ITA,SAU,1998.0,1,1,0
LTU,FRA,2023.0,3,5,-2
IND,BWA,2001.0,1,1,0
IND,MUS,2016.0,1,1,0
BEN,TUR,2022.0,1,1,0
KHM,THA,2010.0,1,2,-1
EGY,TWN,2014.0,1,3,-2
KAZ,SWE,2019.0,1,3,-2
NER,DEU,2012.0,1,1,0
ARG,MEX,1997.0,2,2,0
GBR,ETH,2000.0,1,10,-9
MEX,AUS,2003.0,1,8,-7
SEN,NER,2005.0,1,2,-1
AUT,UKR,2002.0,2,6,-4
SVK,KWT,2003.0,1,2,-1
EST,RUS,2009.0,2,2,0
EST,DNK,2015.0,1,1,0
BEL,KOR,2002.0,1,1,0
BEL,UKR,2013.0,2,6,-4
DEU,PAK,2003.0,2,4,-2
KWT,FRA,2009.0,1,2,-1
CYP,ITA,2014.0,2,4,-2
TUN,SAU,2005.0,1,1,0
ESP,GTM,2010.0,1,1,0
AUS,LAO,2007.0,1,1,0
FRA,URY,2013.0,2,5,-3
BEL,CMR,2008.0,1,2,-1
BOL,MEX,2006.0,1,1,0
TTO,ZAF,2016.0,1,1,0
MEX,NIC,2008.0,1,2,-1
CAN,CIV,2009.0,1,1,0
CRI,NLD,2005.0,1,1,0
NLD,CRI,2006.0,1,1,0
ARG,CRI,2019.0,1,1,0
EGY,IRN,2019.0,2,3,-1
MWI,CAN,2009.0,1,1,0
NCL,AUS,2015.0,1,3,-2
BEN,NGA,2010.0,1,4,-3
LUX,GRC,2014.0,1,4,-3
CHL,IRL,2008.0,1,1,0
LUX,NLD,2010.0,1,6,-5
ESP,VNM,2022.0,1,1,0
DNK,MLT,2015.0,1,1,0
PER,BEL,2021.0,2,2,0
BRN,USA,2013.0,1,2,-1
UKR,BGR,2002.0,1,1,0
PER,DEU,2002.0,1,3,-2
NZL,RUS,2005.0,2,1,1
NZL,FJI,2001.0,1,2,-1
CRI,RUS,1997.0,1,5,-4
ETH,FRA,2003.0,2,3,-1
NPL,NZL,2005.0,1,1,0
SGP,SWE,2003.0,1,1,0
MCO,MAR,2016.0,1,1,0
MLT,NLD,2017.0,1,1,0
GRC,SRB,2016.0,4,2,2
NOR,PAK,2012.0,1,2,-1
CHE,HRV,2011.0,1,5,-4
MEX,IRL,2015.0,1,1,0
VEN,URY,2021.0,2,1,1
URY,ITA,2022.0,1,1,0
QAT,JOR,2012.0,1,5,-4
ITA,ETH,2014.0,1,5,-4
GBR,ARM,2014.0,1,1,0
TUR,RUS,2020.0,1,1,0
BEL,PAK,2014.0,1,1,0
ECU,ARG,2016.0,1,2,-1
EST,SVK,2017.0,1,1,0
DNK,HRV,2017.0,1,3,-2
PHL,MAC,2019.0,1,2,-1
CHE,RWA,2017.0,1,1,0
CZE,LBN,2021.0,1,2,-1
GMB,KEN,2018.0,1,1,0
DEU,BRN,2018.0,1,1,0
NLD,SWE,2024.0,1,1,0
CAN,BRB,2022.0,1,1,0
LVA,USA,2023.0,1,1,0
BRN,DEU,2004.0,1,1,0
PAN,GBR,2012.0,1,1,0
AUS,UGA,2002.0,1,1,0
BHR,FRA,2008.0,1,1,0
FRA,ETH,2005.0,3,1,2
NER,GBR,2019.0,1,1,0
IND,PER,2022.0,2,2,0
POL,ISR,2011.0,1,2,-1
AZE,DEU,2006.0,1,2,-1
NLD,CUB,2009.0,1,1,0
SRB,KWT,2023.0,1,1,0
ROU,NLD,2007.0,1,7,-6
MLI,GHA,2018.0,1,1,0
UKR,KOR,2015.0,2,1,1
CHE,TZA,2006.0,1,2,-1
UZB,TUR,2020.0,1,1,0
DEU,GMB,2023.0,1,1,0
TWN,RUS,2013.0,1,2,-1
BGR,PAK,2011.0,1,1,0
ARE,OMN,2017.0,1,13,-12
IRN,ARE,2004.0,1,2,-1
DNK,QAT,2021.0,2,1,1
IND,EST,2018.0,2,1,1
CAN,KAZ,2023.0,1,2,-1
USA,BMU,2022.0,1,1,0
QAT,NLD,2018.0,2,5,-3
PRI,CAN,2022.0,1,1,0
ZMB,KEN,2023.0,1,1,0
BIH,NLD,2021.0,1,1,0
ISL,KEN,2018.0,1,1,0
THA,POL,2022.0,1,2,-1
URY,ITA,2017.0,1,6,-5
TWN,BRA,2020.0,1,1,0
ARE,IND,2002.0,1,2,-1
MLI,ZAF,2004.0,1,1,0
VEN,ARG,1997.0,2,2,0
ROU,IND,2011.0,1,1,0
PRT,CHE,1997.0,1,3,-2
AUT,BRA,1997.0,2,1,1
ZAF,ARG,2000.0,1,1,0
SGP,PRT,2014.0,1,2,-1
SGP,DEU,1997.0,2,5,-3
EGY,IRL,2017.0,1,3,-2
ARE,CZE,2014.0,1,1,0
NLD,CYP,2013.0,1,1,0
IRL,DNK,2001.0,1,2,-1
BEL,SEN,2008.0,1,2,-1
IND,SVN,2018.0,1,1,0
SAU,NLD,2012.0,1,2,-1
GRC,SRB,2017.0,1,4,-3
FIN,LVA,2014.0,1,1,0
KAZ,SWE,2021.0,1,1,0
NPL,THA,2011.0,1,2,-1
OMN,ROU,2010.0,2,13,-11
QAT,DNK,2023.0,1,1,0
BDI,FRA,2017.0,1,2,-1
DNK,HKG,2015.0,2,2,0
SWE,CHN,2024.0,1,3,-2
TWN,EGY,2022.0,1,3,-2
NLD,CMR,2019.0,2,1,1
SOM,SWE,2017.0,1,1,0
ARE,CHE,2022.0,2,5,-3
GBR,KNA,2017.0,1,1,0
TUR,ISR,2023.0,1,1,0
SWE,HRV,2001.0,1,1,0
MYS,MEX,2022.0,1,2,-1
DNK,QAT,2019.0,1,2,-1
ZMB,DEU,2021.0,1,4,-3
SYC,USA,2021.0,2,1,1
FJI,ETH,2020.0,1,1,0
ESP,BGD,2023.0,1,3,-2
DEU,BFA,2021.0,1,1,0
KOR,JOR,2018.0,2,1,1
BEN,USA,2023.0,2,2,0
SWE,COL,2013.0,1,5,-4
COG,IDN,2021.0,1,1,0
ARM,ITA,2014.0,2,2,0
BGD,NZL,2016.0,2,1,1
SWE,NGA,2006.0,2,3,-1
AUS,EST,2002.0,1,1,0
TUR,HUN,2019.0,1,3,-2
IRL,ROU,2003.0,1,1,0
PNG,NZL,2007.0,1,1,0
KGZ,RUS,1997.0,1,2,-1
CUB,ITA,1999.0,1,1,0
NZL,TUR,1997.0,1,3,-2
ITA,THA,1998.0,1,1,0
LTU,POL,2000.0,1,1,0
HRV,AUS,2005.0,1,1,0
CHE,ARE,2010.0,1,1,0
LAO,SWE,2010.0,1,1,0
SVK,CAN,2015.0,1,3,-2
BFA,JPN,2012.0,1,1,0
UKR,TWN,2019.0,1,2,-1
DZA,ITA,2000.0,1,2,-1
NZL,SRB,2005.0,1,1,0
DNK,COL,2005.0,1,1,0
BFA,MLI,2015.0,1,2,-1
KEN,CHE,2010.0,1,3,-2
GRC,TWN,2015.0,1,1,0
FRA,HKG,2011.0,2,6,-4
FRA,ARM,2009.0,1,1,0
NOR,CZE,2014.0,1,1,0
ARE,HRV,2020.0,1,1,0
MAC,AUS,2009.0,1,1,0
AUT,COL,2013.0,1,2,-1
SGP,IRL,2007.0,1,2,-1
RUS,MYS,2015.0,1,3,-2
GBR,CIV,2009.0,1,2,-1
EST,ITA,2008.0,1,1,0
TUN,IRN,2016.0,1,1,0
TUN,IRN,2022.0,1,1,0
ITA,KEN,2011.0,2,3,-1
PAN,MEX,2008.0,1,3,-2
ROU,TUR,2011.0,2,1,1
RUS,LVA,2007.0,1,1,0
NGA,ZMB,2023.0,1,1,0
CZE,THA,2019.0,1,1,0
PRI,COL,2020.0,1,2,-1
FRA,PAK,1998.0,2,1,1
EGY,HUN,2014.0,1,3,-2
SYR,SAU,2022.0,1,3,-2
AUS,ARM,2021.0,1,1,0
MLT,GRC,2015.0,1,1,0
PRT,THA,2014.0,1,1,0
CHL,URY,2014.0,1,8,-7
MEX,AUT,2023.0,1,3,-2
SEN,CHE,2013.0,2,1,1
MEX,PER,1997.0,1,1,0
FRA,ZWE,2020.0,1,2,-1
ECU,ARG,2017.0,1,6,-5
KOR,MAC,2022.0,1,1,0
TJK,USA,2015.0,1,2,-1
MYS,ZAF,2023.0,1,1,0
COL,BEL,2023.0,1,2,-1
TZA,IRL,2022.0,1,2,-1
RWA,NGA,2021.0,1,5,-4
FIN,ETH,2023.0,1,1,0
RWA,TZA,2023.0,1,2,-1
VNM,FRA,2024.0,1,1,0
MNG,CHN,2023.0,1,5,-4
TUN,DNK,2021.0,1,1,0
CAN,BGR,1998.0,2,7,-5
PRT,CHN,2024.0,1,2,-1
IRL,ZAF,2008.0,1,6,-5
ITA,MCO,2014.0,1,2,-1
SDN,DEU,2004.0,1,2,-1
POL,HRV,1999.0,1,1,0
UZB,ITA,2007.0,1,1,0
LTU,CAN,2008.0,1,1,0
GBR,SYR,2002.0,1,1,0
LBY,CAN,2003.0,1,1,0
BEL,UKR,2003.0,2,4,-2
AUS,SAU,2003.0,1,2,-1
MYS,SDN,2006.0,1,1,0
PRT,EGY,2007.0,1,1,0
HUN,BGR,2000.0,1,2,-1
MYS,IRL,2007.0,2,1,1
USA,GMB,1998.0,1,1,0
MYS,KWT,1997.0,1,1,0
DNK,ISL,2006.0,1,5,-4
BEL,SVN,2009.0,1,8,-7
LTU,NOR,2011.0,2,1,1
SGP,FRA,1998.0,1,2,-1
CUB,FRA,2000.0,2,4,-2
ARE,KWT,2001.0,1,1,0
EGY,BEL,2001.0,1,5,-4
GRC,AUS,1999.0,2,3,-1
BRN,GBR,2012.0,2,5,-3
CHN,SVN,2019.0,2,2,0
THA,NLD,2001.0,3,2,1
LKA,HKG,2013.0,1,1,0
MYS,ZAF,2010.0,1,2,-1
DEU,SWZ,2013.0,1,1,0
CHE,UKR,2013.0,1,4,-3
ROU,TUR,2021.0,1,3,-2
MAR,IRN,2015.0,1,2,-1
TZA,FRA,2012.0,1,1,0
ROU,SAU,2018.0,1,1,0
IRL,FIN,2006.0,1,1,0
KWT,SVN,2018.0,1,2,-1
HUN,ECU,2023.0,1,1,0
ITA,UZB,2019.0,1,1,0
GBR,BLR,2016.0,1,1,0
CHN,HUN,2010.0,1,2,-1
MAC,KOR,2020.0,1,1,0
COD,DEU,2023.0,1,1,0
IDN,IRN,2022.0,1,1,0
PAK,JOR,2022.0,1,1,0
ZAF,CZE,2011.0,1,1,0
ITA,BFA,2004.0,1,1,0
ESP,CZE,1999.0,2,1,1
GBR,MOZ,2021.0,1,1,0
CHL,NZL,2002.0,2,1,1
SAU,NLD,1997.0,1,2,-1
PER,CRI,2009.0,1,1,0
THA,NPL,2009.0,1,4,-3
NOR,EGY,1999.0,1,1,0
VNM,IDN,2002.0,2,1,1
TUR,EGY,2008.0,1,2,-1
DNK,AUT,1999.0,1,4,-3
MYS,DEU,2000.0,1,1,0
MEX,HND,2006.0,1,3,-2
ITA,NGA,2009.0,2,3,-1
ZAF,FIN,2011.0,1,4,-3
PRY,MEX,2012.0,1,2,-1
BGR,HUN,2021.0,1,2,-1
COL,ZAF,2013.0,1,2,-1
CHE,CIV,2014.0,1,1,0
NPL,SWE,2012.0,1,1,0
GMB,GHA,2019.0,1,1,0
MDG,ESP,2019.0,1,1,0
VNM,KHM,2010.0,1,2,-1
NOR,SVK,2022.0,1,1,0
QAT,TUN,2014.0,1,10,-9
JOR,FIN,2011.0,1,1,0
BGR,TUR,2019.0,1,1,0
EST,KOR,2022.0,1,1,0
COL,ARM,2008.0,1,2,-1
IRN,GRC,2023.0,1,1,0
CHN,ROU,2021.0,1,3,-2
EGY,TTO,2009.0,1,1,0
LBN,SYR,2021.0,1,1,0
KHM,CAN,2019.0,2,1,1
IDN,CAN,2011.0,1,5,-4
SDN,YEM,2023.0,1,1,0
IRQ,NLD,2023.0,1,1,0
NLD,THA,1998.0,1,1,0
SYR,USA,2005.0,2,1,1
AUS,TUR,2000.0,2,3,-1
PAK,DEU,1997.0,1,4,-3
CHE,VNM,2016.0,1,6,-5
CHN,YEM,2020.0,1,3,-2
OMN,AUS,2014.0,1,4,-3
ETH,THA,2016.0,1,2,-1
PHL,CHN,2003.0,1,1,0
CZE,MEX,2019.0,1,3,-2
DOM,ARG,2021.0,1,2,-1
IND,KEN,2008.0,1,1,0
DEU,LBN,2022.0,1,8,-7
FRA,FJI,2019.0,1,1,0
CHE,SLE,2016.0,1,1,0
ISR,HRV,2023.0,1,1,0
DEU,DZA,2023.0,1,2,-1
KEN,COG,2020.0,1,1,0
NGA,TWN,2022.0,1,3,-2
TWN,COL,2019.0,1,1,0
RWA,EGY,2022.0,1,1,0
IND,LBN,2022.0,1,1,0
DZA,GHA,2022.0,1,1,0
IND,CMR,2022.0,1,2,-1
DZA,RUS,2022.0,1,1,0
CHL,BOL,2016.0,1,1,0
GMB,NGA,2023.0,1,3,-2
NLD,SRB,2017.0,2,7,-5
KWT,BHR,2021.0,1,1,0
SEN,IND,2021.0,1,1,0
DEU,SDN,2008.0,1,2,-1
BEL,PHL,2022.0,1,2,-1
CAN,SYR,2021.0,1,2,-1
PRT,HKG,2018.0,1,1,0
SVK,NOR,1999.0,1,1,0
CZE,NLD,2000.0,2,8,-6
HUN,SVN,1999.0,1,1,0
GRC,POL,2003.0,1,2,-1
NZL,TUR,2005.0,1,2,-1
TUN,EGY,2020.0,1,1,0
GRC,MLT,2014.0,1,2,-1
MYS,UZB,2005.0,1,1,0
ARM,FRA,2003.0,1,2,-1
ROU,SVN,2007.0,1,1,0
EST,BEL,2017.0,1,1,0
KGZ,USA,2013.0,1,1,0
GRC,MKD,2012.0,1,1,0
BEL,PYF,2023.0,1,1,0
CAN,BMU,2022.0,1,14,-13
MYS,MEX,2016.0,1,1,0
ZAF,PAK,2000.0,1,2,-1
CHE,MWI,2016.0,1,3,-2
TUN,SWE,2012.0,1,1,0
ITA,COG,2022.0,1,2,-1
OMN,NGA,2002.0,1,1,0
ETH,BWA,2012.0,1,1,0
CHN,SLE,2017.0,1,1,0
PAK,TWN,2017.0,1,2,-1
THA,PRT,2008.0,1,3,-2
ARE,JAM,2018.0,1,1,0
BEL,SEN,2015.0,1,1,0
JAM,ARE,2018.0,1,1,0
BRA,LKA,2017.0,1,2,-1
EGY,BHR,2010.0,2,1,1
NGA,SWE,2018.0,1,2,-1
GRC,SVN,2013.0,1,2,-1
GRC,RUS,2013.0,1,2,-1
ROU,GRC,2008.0,1,8,-7
IND,ATG,2023.0,1,1,0
DEU,VEN,2013.0,1,11,-10
LIE,CHE,2009.0,1,2,-1
TUR,PAK,2010.0,1,1,0
TWN,SWE,2017.0,2,5,-3
SRB,ITA,2001.0,1,7,-6
AUS,COL,2005.0,2,4,-2
MWI,CHE,2018.0,1,4,-3
CHE,BGR,2013.0,1,7,-6
GBR,MUS,2001.0,1,1,0
ESP,BLR,2010.0,1,2,-1
IND,DEU,2024.0,1,1,0
RUS,OMN,2020.0,1,1,0
ZAF,MEX,2022.0,1,1,0
DNK,KOR,2013.0,1,6,-5
CHE,ISL,2018.0,1,1,0
SLB,AUS,2016.0,1,3,-2
BEN,GBR,2020.0,1,2,-1
BHR,EGY,2016.0,1,4,-3
NAM,CHN,2019.0,1,2,-1
CAN,BRB,2018.0,1,2,-1
ARE,BHR,2018.0,1,3,-2
EST,IDN,2020.0,1,1,0
OMN,ARE,2003.0,1,1,0
NOR,NZL,2022.0,1,4,-3
TZA,NOR,2001.0,1,5,-4
CHN,GEO,2020.0,1,3,-2
URY,AUS,2011.0,1,2,-1
TUR,MYS,2010.0,1,1,0
CAN,VNM,2000.0,1,1,0
OMN,CHN,2003.0,1,1,0
TUR,NGA,2009.0,1,1,0
NLD,LKA,1997.0,1,1,0
CIV,CMR,2001.0,1,1,0
AUS,NGA,2002.0,1,4,-3
PSE,EGY,2006.0,1,3,-2
NGA,COL,2003.0,1,1,0
BEN,KEN,2007.0,1,1,0
DNK,POL,2000.0,1,6,-5
FRA,URY,2003.0,1,5,-4
PRT,UZB,2007.0,1,1,0
LBY,DEU,2012.0,1,3,-2
SWE,OMN,2010.0,1,1,0
GBR,GTM,2002.0,1,2,-1
TUN,OMN,2022.0,1,1,0
UGA,SWE,2011.0,1,3,-2
COL,ECU,2013.0,1,2,-1
SVN,ARG,2017.0,1,1,0
ZAF,POL,2014.0,1,2,-1
DEU,PRK,2009.0,1,1,0
IRL,PRI,2010.0,1,1,0
FRA,CAF,2018.0,1,1,0
IRL,PAK,2006.0,1,1,0
OMN,DEU,2001.0,1,3,-2
IND,LUX,2015.0,1,2,-1
PRI,IND,2015.0,1,1,0
SYC,FRA,2016.0,1,1,0
COL,JPN,2015.0,1,1,0
SVK,IND,2017.0,1,3,-2
KWT,OMN,2020.0,1,2,-1
AUS,AFG,2018.0,1,1,0
TZA,CAN,2021.0,1,2,-1
ETH,SWE,2023.0,1,3,-2
BRA,LBN,2019.0,1,1,0
SAU,SWE,2005.0,1,2,-1
SWE,LBN,2023.0,1,2,-1
MEX,ZAF,2022.0,1,1,0
CAN,BEN,2017.0,1,1,0
KOR,EGY,2006.0,1,4,-3
ARM,ITA,2008.0,1,2,-1
CZE,SVN,2004.0,1,2,-1
CRI,DEU,2006.0,1,3,-2
RUS,EGY,2002.0,1,2,-1
LBY,IRQ,2000.0,1,1,0
USA,NER,2009.0,1,2,-1
NOR,UKR,2002.0,1,2,-1
ISR,LVA,2019.0,1,1,0
MYS,FRA,2005.0,1,1,0
TUR,SRB,2004.0,1,1,0
IND,EGY,1998.0,1,2,-1
TUN,FIN,2010.0,1,1,0
PAK,UZB,2007.0,1,1,0
UZB,USA,2022.0,1,2,-1
ZAF,POL,2001.0,1,1,0
SWE,GNB,2008.0,1,2,-1
JPN,ARG,2023.0,1,2,-1
QAT,ARE,2006.0,1,1,0
FRA,GHA,2008.0,1,1,0
COG,BEL,2005.0,1,2,-1
GAB,CMR,2009.0,1,2,-1
BEL,KEN,2006.0,1,1,0
USA,SWZ,2010.0,1,2,-1
MAR,BEL,2007.0,1,10,-9
AUT,MYS,2015.0,1,2,-1
GMB,KEN,2017.0,1,1,0
ARG,PRY,2015.0,1,1,0
KWT,ARE,2009.0,1,1,0
CZE,SAU,2015.0,1,2,-1
CAN,MKD,2001.0,1,1,0
SWZ,BWA,2007.0,1,1,0
SRB,TUR,2011.0,1,6,-5
CAN,UGA,2018.0,1,5,-4
CHL,FIN,2020.0,1,2,-1
EST,CHN,2015.0,1,1,0
ESP,THA,2013.0,3,1,2
MLI,USA,2011.0,1,5,-4
GBR,GIB,2015.0,1,1,0
VNM,MYS,2023.0,1,6,-5
PER,FIN,2011.0,1,1,0
THA,PRT,2014.0,1,1,0
URY,PAN,2010.0,1,0,1
NZL,PNG,2020.0,1,0,1
,CCK,1996.0,1,0,1
IRQ,DEU,2024.0,1,0,1
GBR,LVA,1997.0,1,0,1
GUY,BRA,2002.0,1,0,1
PSE,,2001.0,4,0,4
CZE,EGY,1998.0,1,0,1
NZL,PHL,2009.0,1,0,1
LVA,BGR,2017.0,1,0,1
SEN,DJI,2002.0,1,0,1
CHL,ROU,2020.0,1,0,1
NZL,THA,1997.0,1,0,1
IND,TTO,2002.0,1,0,1
LVA,ISR,2000.0,1,0,1
GEO,NLD,2015.0,1,0,1
ESP,OMN,2017.0,1,0,1
BFA,BRA,2007.0,1,0,1
DNK,IDN,2000.0,1,0,1
KEN,DNK,2007.0,1,0,1
SVK,ESP,2005.0,1,0,1
PRT,SRB,2012.0,1,0,1
CAN,GAB,2013.0,1,0,1
TZA,DNK,2006.0,3,0,3
HUN,LVA,2003.0,1,0,1
JOR,IRN,2019.0,1,0,1
BFA,DNK,2009.0,1,0,1
PAK,RUS,2001.0,1,0,1
SGP,CZE,2009.0,2,0,2
ESP,QAT,2012.0,1,0,1
CHL,MDA,2015.0,1,0,1
ARE,SDN,2010.0,1,0,1
TTO,ESP,2009.0,1,0,1
BLR,NLD,2014.0,1,0,1
TUR,TUN,2003.0,1,0,1
GBR,GLP,2007.0,1,0,1
SVK,KOR,2015.0,1,0,1
HND,FRA,2017.0,1,0,1
PRT,LBN,2018.0,2,0,2
LUX,COL,2015.0,1,0,1
SYC,,2018.0,1,0,1
HUN,AFG,2011.0,1,0,1
GNQ,,2015.0,1,0,1
HKG,POL,2022.0,3,0,3
NLD,CUW,2013.0,2,0,2
CUW,NLD,2015.0,3,0,3
USA,CUW,2020.0,1,0,1
AGO,COG,2008.0,1,0,1
CYP,KAZ,2015.0,2,0,2
GEO,ESP,2016.0,1,0,1
IRN,VNM,2018.0,4,0,4
MLT,DNK,2021.0,1,0,1
HKG,ROU,2008.0,1,0,1
PAN,DOM,2019.0,1,0,1
SYR,JOR,2012.0,1,0,1
ARM,BRA,2014.0,2,0,2
ISR,VNM,2015.0,1,0,1
GBR,DMA,2012.0,1,0,1
IND,MUS,2003.0,2,0,2
DEU,BHR,2019.0,1,0,1
TWN,QAT,2012.0,1,0,1
FIN,SYR,2017.0,1,0,1
SVK,NOR,2000.0,1,0,1
ARG,SLV,2020.0,1,0,1
CAF,BFA,2017.0,1,0,1
KOR,ECU,2020.0,1,0,1
UKR,CRI,2022.0,1,0,1
NER,SDN,2015.0,1,0,1
SDN,NER,2019.0,1,0,1
ISR,PRT,2020.0,1,0,1
MAR,COG,2022.0,1,0,1
AUT,BGR,2021.0,2,0,2
,ABW,2017.0,3,0,3
HUN,AUS,2024.0,1,0,1
IRL,CRI,2022.0,1,0,1
LBY,FIN,2020.0,1,0,1
LSO,SYC,2021.0,1,0,1
IRN,GHA,2020.0,1,0,1
GNQ,ESP,2020.0,1,0,1
TUN,SVN,2022.0,1,0,1
LBN,OMN,2023.0,1,0,1
BMU,CAN,2023.0,1,0,1
CRI,GBR,2004.0,2,0,2
BWA,CHE,2021.0,1,0,1
EGY,SVN,2023.0,1,0,1
DJI,,2022.0,4,0,4
IRN,VNM,2017.0,1,0,1
IRN,PHL,2012.0,1,0,1
SDN,LBN,2011.0,1,0,1
CRI,ITA,2017.0,1,0,1
IRL,NCL,2021.0,1,0,1
PLW,GUM,2021.0,1,0,1
PHL,KEN,2011.0,1,0,1
GHA,LBR,2012.0,1,0,1
ROU,BGR,2013.0,2,0,2
ISL,LUX,2017.0,1,0,1
BGD,ZAF,2023.0,1,0,1
JPN,SLV,2021.0,1,0,1
MAR,RUS,2019.0,1,0,1
MLI,GMB,1997.0,1,0,1
FIN,KWT,2017.0,1,0,1
TUR,ARM,2012.0,1,0,1
UGA,MDG,2014.0,1,0,1
SVN,DNK,2020.0,2,0,2
IRN,COL,2019.0,1,0,1
KEN,PAK,2006.0,1,0,1
HTI,CAN,2022.0,1,0,1
SWE,MCO,1998.0,1,0,1
PER,DOM,2021.0,1,0,1
MYS,ISL,2023.0,2,0,2
TUN,CHE,2023.0,2,0,2
KOR,SOM,2017.0,2,0,2
SOM,KOR,2018.0,2,0,2
GHA,RWA,2019.0,1,0,1
MEX,PHL,2020.0,3,0,3
RUS,MAC,2010.0,1,0,1
JOR,NLD,2009.0,1,0,1
AUT,IRL,2002.0,1,0,1
NGA,CAN,2000.0,2,0,2
GRC,PSE,2015.0,1,0,1
,PLW,1995.0,1,0,1
ESP,NGA,2005.0,2,0,2
BEL,URY,2001.0,1,0,1
GHA,BEL,2003.0,1,0,1
JOR,LBY,2013.0,1,0,1
VEN,NZL,2015.0,1,0,1
CUB,MCO,2023.0,1,0,1
COG,NOR,2000.0,1,0,1
FIN,MDA,2008.0,1,0,1
GBR,CIV,2002.0,1,0,1
,TKM,1999.0,1,0,1
NLD,CIV,2006.0,1,0,1
UGA,IND,2002.0,2,0,2
ITA,QAT,2012.0,1,0,1
GBR,NCL,2023.0,1,0,1
JAM,ITA,2017.0,1,0,1
TON,,2006.0,1,0,1
,WSM,1994.0,2,0,2
DOM,COL,2011.0,1,0,1
DNK,LKA,1998.0,3,0,3
DEU,PRY,2010.0,1,0,1
CHE,MAR,1997.0,2,0,2
NER,KEN,2015.0,1,0,1
LVA,ESP,2014.0,1,0,1
ISR,URY,2000.0,1,0,1
NLD,NCL,2011.0,1,0,1
ETH,GHA,1998.0,1,0,1
IRQ,CHN,1999.0,1,0,1
GRC,KWT,2015.0,5,0,5
TCD,CHE,2006.0,1,0,1
LKA,ITA,2005.0,1,0,1
MAR,MDG,2005.0,1,0,1
IRL,TUN,2014.0,1,0,1
FIN,MYS,2006.0,1,0,1
CHE,PAN,2006.0,1,0,1
BIH,SWE,2007.0,1,0,1
SOM,KOR,2016.0,1,0,1
GMB,AUT,2016.0,1,0,1
CAN,MLT,2005.0,2,0,2
JPN,BTN,2007.0,1,0,1
IRL,GUF,2011.0,1,0,1
KGZ,BGR,2010.0,2,0,2
JOR,ZAF,2005.0,1,0,1
URY,NLD,2003.0,1,0,1
GRC,CRI,2006.0,1,0,1
BLR,PRT,2005.0,3,0,3
UKR,LTU,2012.0,1,0,1
PAN,AUT,2022.0,1,0,1
LSO,KEN,2021.0,1,0,1
FRA,BRN,2017.0,1,0,1
LBR,LBY,2017.0,1,0,1
MAR,SWE,2014.0,1,0,1
ESP,SYC,2018.0,1,0,1
PRT,SVN,2019.0,4,0,4
GHA,GMB,2017.0,2,0,2
FRA,BTN,2013.0,1,0,1
ERI,JPN,2011.0,1,0,1
KGZ,MDA,2018.0,1,0,1
VEN,AUS,2000.0,1,0,1
SWE,PSE,2017.0,1,0,1
UGA,BEN,2016.0,1,0,1
UKR,SRB,2013.0,1,0,1
CYP,ARE,2013.0,1,0,1
BGD,SAU,2004.0,1,0,1
MKD,AUS,2016.0,1,0,1
JPN,ECU,2016.0,3,0,3
ISR,BHS,2015.0,1,0,1
MDA,FRA,2018.0,1,0,1
MKD,GRC,2015.0,1,0,1
BGD,PHL,1998.0,1,0,1
NPL,PRT,2020.0,1,0,1
HUN,YEM,1997.0,1,0,1
BGD,QAT,2021.0,3,0,3
,NIC,1999.0,2,0,2
DNK,BLR,1999.0,1,0,1
HUN,PRT,2006.0,2,0,2
ESP,VNM,2013.0,1,0,1
ARG,ROU,2021.0,1,0,1
CHN,AZE,2012.0,1,0,1
GUM,,2010.0,1,0,1
BGR,VNM,2009.0,1,0,1
NLD,URY,2021.0,2,0,2
WSM,ITA,2020.0,2,0,2
DZA,IND,2012.0,1,0,1
DJI,ITA,2023.0,1,0,1
COL,PRY,2022.0,1,0,1
JOR,LBN,2017.0,1,0,1
VEN,PRT,1999.0,1,0,1
BWA,ZMB,2001.0,1,0,1
GMB,,2004.0,4,0,4
PHL,BGD,2004.0,1,0,1
ESP,PHL,2012.0,1,0,1
PAN,CUB,1997.0,1,0,1
CUB,PAN,2017.0,2,0,2
DZA,ARE,2008.0,2,0,2
PHL,COL,1998.0,1,0,1
SYR,ETH,2005.0,1,0,1
NAM,NZL,2005.0,1,0,1
ITA,MWI,2013.0,1,0,1
MDG,SAU,2013.0,1,0,1
VEN,DMA,2020.0,1,0,1
CUB,IRL,2013.0,1,0,1
BEL,MLI,2016.0,1,0,1
MDA,GEO,2015.0,1,0,1
ZWE,KEN,2015.0,2,0,2
ZAF,ERI,2017.0,1,0,1
ROU,TGO,2015.0,1,0,1
UGA,SLE,2022.0,1,0,1
KWT,MYS,2012.0,2,0,2
BEL,NPL,2020.0,3,0,3
DOM,ECU,2015.0,1,0,1
PAK,NPL,2022.0,2,0,2
MKD,DNK,2016.0,1,0,1
LUX,PRT,2017.0,3,0,3
DZA,ITA,1998.0,1,0,1
LTU,KAZ,2019.0,2,0,2
CIV,CHE,2016.0,4,0,4
SDN,KWT,2021.0,1,0,1
MWI,NLD,2014.0,3,0,3
IRN,KAZ,2012.0,1,0,1
KAZ,OMN,2018.0,1,0,1
COG,MAR,2012.0,1,0,1
MAR,COG,2017.0,2,0,2
BRA,IDN,2012.0,1,0,1
MEX,PRY,2008.0,1,0,1
PRY,MEX,2009.0,1,0,1
KOR,TUR,2000.0,1,0,1
SDN,ETH,2021.0,1,0,1
BEN,IND,2015.0,1,0,1
GUY,CAN,2021.0,1,0,1
NAM,SWE,2018.0,1,0,1
,GIB,2014.0,1,0,1
NCL,NZL,2019.0,1,0,1
NAM,ETH,2020.0,1,0,1
,SMR,1999.0,1,0,1
BEL,GEO,2019.0,1,0,1
CAN,GRD,2015.0,2,0,2
MAR,GAB,2022.0,1,0,1
ARE,SVN,2023.0,1,0,1
NOR,KHM,2018.0,1,0,1
SAU,MDV,2020.0,1,0,1
ISR,IRQ,2021.0,1,0,1
IDN,FIN,2020.0,4,0,4
HKG,BGR,2019.0,1,0,1
DNK,IDN,2023.0,1,0,1
,SVN,2021.0,2,0,2
JPN,CRI,2017.0,1,0,1
TUN,EGY,2023.0,2,0,2
CAN,CYP,2023.0,1,0,1
CHN,COG,2013.0,1,0,1
IND,CYP,2003.0,1,0,1
CRI,NGA,2009.0,1,0,1
HRV,KWT,2019.0,1,0,1
COL,URY,2005.0,1,0,1
MLT,CHE,2010.0,1,0,1
USA,DJI,2016.0,1,0,1
LSO,NGA,2004.0,1,0,1
LVA,RUS,2013.0,2,0,2
IDN,RUS,2006.0,1,0,1
ROU,NOR,2007.0,2,0,2
BWA,CHE,2011.0,1,0,1
ECU,CUB,2003.0,1,0,1
IRL,SLE,2013.0,1,0,1
RUS,TKM,2000.0,1,0,1
NOR,ARG,2014.0,1,0,1
LTU,BEL,2007.0,1,0,1
CHN,TUR,1999.0,1,0,1
,TON,1998.0,1,0,1
VEN,SWE,2007.0,1,0,1
ITA,JOR,2000.0,1,0,1
AGO,KEN,2005.0,1,0,1
BFA,GHA,1998.0,1,0,1
GHA,BFA,2005.0,1,0,1
CAN,BHR,2003.0,1,0,1
VEN,ZAF,2003.0,1,0,1
BRN,TZA,2009.0,1,0,1
TZA,BRN,2012.0,2,0,2
ZMB,KEN,2007.0,1,0,1
BLR,CHN,2022.0,2,0,2
,AIA,2018.0,1,0,1
JPN,BHR,2010.0,1,0,1
SRB,THA,2002.0,1,0,1
CAN,BIH,2003.0,1,0,1
THA,AUT,2002.0,1,0,1
UKR,LTU,1997.0,1,0,1
NPL,FIN,2000.0,1,0,1
FIN,NPL,2005.0,1,0,1
BMU,,2003.0,1,0,1
KNA,,2004.0,1,0,1
CHN,UGA,2005.0,1,0,1
CZE,ROU,2005.0,1,0,1
POL,MNG,2008.0,1,0,1
NOR,KEN,2005.0,1,0,1
ARG,NGA,2013.0,1,0,1
DNK,MWI,2001.0,1,0,1
JAM,ZAF,1999.0,1,0,1
GBR,GUF,2011.0,1,0,1
AUT,MNG,2009.0,1,0,1
PRT,PRY,2018.0,1,0,1
BEN,CHE,2008.0,1,0,1
RUS,COL,2005.0,1,0,1
BEL,SVN,2005.0,2,0,2
DOM,ECU,2008.0,1,0,1
IRL,CZE,2013.0,3,0,3
JOR,JPN,2010.0,2,0,2
CHE,DZA,2011.0,1,0,1
DNK,TUN,2005.0,1,0,1
LUX,NZL,2021.0,1,0,1
PAN,ECU,2009.0,1,0,1
NZL,TWN,2000.0,2,0,2
,DMA,2008.0,1,0,1
MUS,USA,2001.0,1,0,1
PRT,MOZ,2007.0,1,0,1
BIH,FRA,2015.0,1,0,1
MNG,AUT,2008.0,1,0,1
CUB,AUT,2008.0,1,0,1
KOR,ISL,2011.0,1,0,1
FIN,ETH,2020.0,1,0,1
GUF,COL,2012.0,1,0,1
BEL,CRI,2011.0,1,0,1
SYR,LBN,2017.0,1,0,1
NAM,IND,2022.0,1,0,1
ROU,TTO,2015.0,1,0,1
BIH,BEL,2009.0,1,0,1
ESP,UGA,2018.0,1,0,1
EGY,NOR,2021.0,1,0,1
BRA,BMU,2007.0,2,0,2
REU,AUS,2018.0,1,0,1
NLD,HUN,2024.0,1,0,1
CUB,DOM,2015.0,1,0,1
FRA,SYR,2023.0,1,0,1
SDN,RUS,2020.0,1,0,1
ARM,MDA,2022.0,1,0,1
OMN,QAT,2022.0,2,0,2
TUR,CZE,2024.0,1,0,1
KAZ,CZE,2022.0,1,0,1
BGD,BEL,2005.0,1,0,1
AUT,IND,1997.0,2,0,2
MWI,FRA,2006.0,1,0,1
SDN,USA,1999.0,1,0,1
UKR,SVN,1999.0,1,0,1
CYM,GBR,1998.0,1,0,1
UKR,KWT,2009.0,1,0,1
CAN,BLR,2001.0,1,0,1
GNB,,2006.0,3,0,3
NZL,HUN,2000.0,1,0,1
MOZ,CHE,2007.0,2,0,2
HND,ITA,2022.0,2,0,2
VEN,SVN,2005.0,1,0,1
COL,PAN,2001.0,2,0,2
PAN,CHE,2002.0,1,0,1
PAK,PYF,2007.0,1,0,1
USA,SLE,2005.0,2,0,2
FIN,ARE,2000.0,1,0,1
YEM,HUN,1999.0,2,0,2
AFG,EGY,2015.0,1,0,1
TZA,CZE,2011.0,1,0,1
ALB,CHN,2022.0,1,0,1
ISR,BMU,2017.0,1,0,1
USA,YEM,2009.0,1,0,1
FRO,,2013.0,1,0,1
MMR,ISR,2021.0,1,0,1
ISL,CAN,2022.0,1,0,1
JOR,PSE,2012.0,2,0,2
IRL,EST,2021.0,1,0,1
GRC,CHL,2012.0,1,0,1
IND,VCT,2017.0,1,0,1
SDN,NOR,2020.0,2,0,2
BHR,SAU,1999.0,1,0,1
CHN,KWT,2012.0,1,0,1
UKR,IRL,2009.0,1,0,1
BLR,HUN,2021.0,1,0,1
POL,NAM,2012.0,1,0,1
NAM,POL,2017.0,1,0,1
SUR,BEL,2015.0,1,0,1
ZAF,PSE,2016.0,1,0,1
LUX,ARE,2011.0,1,0,1
PER,MMR,2014.0,1,0,1
TLS,GBR,2004.0,1,0,1
IND,COL,2002.0,3,0,3
GHA,AUS,2007.0,1,0,1
DOM,PRY,2017.0,1,0,1
MDA,BLR,2020.0,1,0,1
CAN,KGZ,2018.0,1,0,1
RWA,ZMB,2020.0,2,0,2
BEL,GAB,2019.0,1,0,1
ECU,DNK,2022.0,1,0,1
GBR,PRY,2016.0,1,0,1
ESP,SJM,2022.0,1,0,1
SJM,,2025.0,1,0,1
CHN,EST,2010.0,1,0,1
SAU,BRN,2021.0,2,0,2
HRV,ISR,2017.0,2,0,2
DNK,MWI,2004.0,1,0,1
SVN,MKD,2008.0,1,0,1
URY,DNK,2005.0,1,0,1
ESP,ARM,2020.0,3,0,3
TCD,CHE,2010.0,1,0,1
AUT,SAU,2010.0,1,0,1
MAC,USA,2000.0,1,0,1
LIE,USA,2014.0,1,0,1
NPL,PHL,2001.0,1,0,1
GBR,CAF,2016.0,1,0,1
CAN,GRL,2011.0,1,0,1
DEU,KHM,2001.0,1,0,1
TTO,THA,2008.0,1,0,1
THA,TTO,2011.0,1,0,1
MLT,CAN,2017.0,2,0,2
JOR,HKG,2014.0,1,0,1
FIN,ECU,2015.0,1,0,1
LIE,ITA,2008.0,1,0,1
ITA,HKG,2014.0,1,0,1
CRI,RUS,2021.0,1,0,1
GTM,BRA,2004.0,1,0,1
BRN,CHN,2018.0,1,0,1
CUB,PRT,2017.0,1,0,1
YEM,SYR,2021.0,1,0,1
HUN,VNM,2018.0,1,0,1
GIN,SWE,2018.0,2,0,2
GEO,DNK,2020.0,1,0,1
HKG,LAO,2018.0,1,0,1
CIV,MLI,2008.0,2,0,2
TZA,MOZ,2018.0,1,0,1
HKG,NPL,2023.0,1,0,1
IRQ,DZA,2021.0,1,0,1
FIN,CUB,2005.0,1,0,1
TGO,PAK,2023.0,1,0,1
SRB,TUN,2021.0,1,0,1
ROU,UZB,2023.0,1,0,1
IRN,ISR,2016.0,2,0,2
BEL,GIN,2014.0,2,0,2
DZA,LBY,2022.0,1,0,1
SMR,ITA,1997.0,1,0,1
ISR,TWN,2004.0,1,0,1
EST,KAZ,2016.0,2,0,2
HUN,BRA,2006.0,1,0,1
PHL,BGD,2001.0,1,0,1
NZL,KNA,2012.0,1,0,1
ITA,TUN,2000.0,2,0,2
UZB,UKR,2008.0,1,0,1
ISR,TZA,2013.0,1,0,1
LBN,IRN,2009.0,2,0,2
,SLE,2004.0,3,0,3
JPN,ZMB,2012.0,1,0,1
PER,FIN,1997.0,1,0,1
,WLF,2005.0,1,0,1
MWI,LBR,2021.0,1,0,1
BRN,PAK,2021.0,2,0,2
MWI,SWE,2010.0,1,0,1
CHL,LTU,2020.0,2,0,2
POL,SGP,2010.0,2,0,2
HRV,FIN,2013.0,1,0,1
KHM,CAN,2005.0,1,0,1
MDG,MEX,2013.0,1,0,1
BRA,MYS,2008.0,1,0,1
FIN,HRV,2017.0,1,0,1
TZA,JPN,2020.0,1,0,1
SVN,VNM,2017.0,1,0,1
GBR,TCA,2017.0,1,0,1
PHL,TZA,2022.0,1,0,1
JPN,DZA,2018.0,1,0,1
CRI,UGA,2013.0,1,0,1
TUR,LUX,2016.0,1,0,1
THA,SAU,2009.0,1,0,1
PRI,NLD,2011.0,1,0,1
SGP,MAC,2015.0,3,0,3
IRL,TWN,2016.0,1,0,1
FIN,NIC,2013.0,1,0,1
CHE,NAM,2016.0,1,0,1
PRI,GTM,2011.0,1,0,1
AUS,LBY,2021.0,2,0,2
BLR,SAU,2021.0,1,0,1
NOR,MDA,2022.0,1,0,1
MCO,CAN,2021.0,1,0,1
MMR,SGP,2018.0,1,0,1
LBR,COG,2020.0,2,0,2
EGY,GEO,2006.0,2,0,2
JPN,IRQ,2017.0,1,0,1
OMN,CHN,2017.0,2,0,2
ROU,UKR,2013.0,1,0,1
FRA,LVA,2016.0,1,0,1
MWI,SWE,2023.0,1,0,1
SLV,ITA,2022.0,1,0,1
BGD,COL,2023.0,1,0,1
,CUW,2017.0,1,0,1
AUT,MNE,2018.0,1,0,1
CYP,DEU,2000.0,2,0,2
NOR,FRO,2013.0,1,0,1
MNG,AUS,2009.0,1,0,1
THA,HKG,1998.0,1,0,1
ETH,FIN,1999.0,1,0,1
PLW,NZL,2003.0,1,0,1
FJI,BHR,2011.0,1,0,1
MWI,NGA,2006.0,1,0,1
URY,ROU,2010.0,1,0,1
EST,FRA,2006.0,1,0,1
ARE,ITA,2005.0,2,0,2
SGP,QAT,2019.0,3,0,3
NER,BEL,2006.0,1,0,1
MAR,SEN,2006.0,1,0,1
IRL,TUR,2007.0,1,0,1
LUX,BRA,2015.0,1,0,1
MLI,ITA,2003.0,1,0,1
BGR,IRL,1998.0,1,0,1
BEL,ECU,2006.0,1,0,1
ZWE,CHE,2012.0,1,0,1
DNK,BGD,2000.0,1,0,1
TUR,MDA,2000.0,2,0,2
NGA,KWT,2003.0,2,0,2
CHN,PRI,2011.0,2,0,2
CIV,COG,2014.0,1,0,1
ERI,NAM,2009.0,1,0,1
NAM,TZA,2016.0,1,0,1
LSO,KEN,2011.0,1,0,1
SGP,BGD,2023.0,1,0,1
GHA,GNQ,2013.0,1,0,1
TTO,AUS,2013.0,1,0,1
SWE,BEN,2020.0,1,0,1
MLI,ETH,2021.0,2,0,2
DEU,TJK,2018.0,1,0,1
GHA,IND,2014.0,1,0,1
MAR,GAB,2016.0,2,0,2
BIH,POL,2012.0,1,0,1
PRI,TWN,2013.0,1,0,1
BMU,,2013.0,2,0,2
SWZ,CAN,2018.0,1,0,1
BIH,ISR,2016.0,1,0,1
JPN,IRQ,2018.0,1,0,1
GAB,GMB,2016.0,1,0,1
SRB,NPL,2019.0,1,0,1
MWI,CHN,2012.0,1,0,1
ZAF,ROU,2009.0,1,0,1
CYP,FRA,2006.0,1,0,1
BFA,GMB,2016.0,1,0,1
CMR,ZMB,2023.0,1,0,1
,LCA,2011.0,1,0,1
POL,LVA,2023.0,1,0,1
USA,ERI,2016.0,1,0,1
SEN,AUT,2023.0,1,0,1
COL,ARE,2020.0,1,0,1
HRV,NLD,2000.0,2,0,2
LBN,NZL,2023.0,1,0,1
NIC,ESP,2013.0,1,0,1
LKA,BRA,2021.0,2,0,2
PSE,OMN,2018.0,1,0,1
,CCK,2014.0,1,0,1
URY,PER,2021.0,1,0,1
NZL,MUS,2017.0,1,0,1
BRA,TZA,2015.0,1,0,1
ECU,CHL,2024.0,1,0,1
PAN,EGY,2004.0,1,0,1
EGY,ZAF,2006.0,1,0,1
KNA,,2014.0,1,0,1
ZMB,MYS,2019.0,1,0,1
GEO,ITA,2019.0,1,0,1
MYS,GRC,2019.0,1,0,1
TUR,ISL,2020.0,1,0,1
TUR,CZE,2010.0,1,0,1
IRN,LTU,2019.0,1,0,1
PAK,MKD,2020.0,1,0,1
ITA,SAU,2024.0,1,0,1
IDN,UKR,2012.0,1,0,1
ECU,ISR,2020.0,1,0,1
LIE,GBR,2022.0,2,0,2
IND,JOR,1998.0,1,0,1
BGD,IRL,1997.0,1,0,1
,CCK,2015.0,3,0,3
,CYM,2012.0,1,0,1
GTM,SLV,2022.0,1,0,1
PRK,,2014.0,7,0,7
LBN,UKR,2020.0,1,0,1
BRA,KEN,1999.0,1,0,1
COM,,1999.0,1,0,1
ESP,YEM,2005.0,1,0,1
YEM,ESP,2006.0,1,0,1
USA,MAC,2003.0,1,0,1
MNE,ESP,2018.0,1,0,1
USA,KIR,2012.0,1,0,1
ETH,ZWE,2010.0,1,0,1
MYS,TTO,2017.0,1,0,1
CHN,MKD,2017.0,3,0,3
COG,AUS,2016.0,1,0,1
NLD,BOL,2007.0,1,0,1
NLD,KWT,2020.0,1,0,1
DEU,MLI,2010.0,1,0,1
VUT,CHE,2015.0,1,0,1
PNG,GBR,2014.0,1,0,1
FIN,ARE,2010.0,1,0,1
ZWE,ESP,2023.0,2,0,2
TZA,NGA,2005.0,1,0,1
USA,FSM,2007.0,2,0,2
BRA,GHA,2023.0,1,0,1
NZL,MWI,2022.0,1,0,1
BEN,BRA,2020.0,1,0,1
AGO,ESP,2020.0,1,0,1
GBR,ASM,2009.0,1,0,1
ASM,GBR,2010.0,1,0,1
PRT,UZB,2023.0,1,0,1
AZE,PRT,2023.0,1,0,1
TWN,BRN,2015.0,2,0,2
DEU,BDI,2021.0,1,0,1
CHN,PHL,2024.0,1,0,1
FRA,AUS,2024.0,1,0,1
NOR,BWA,2022.0,1,0,1
DNK,JOR,2007.0,1,0,1
SVN,DNK,1999.0,1,0,1
CHE,PHL,1999.0,1,0,1
HND,ESP,2008.0,2,0,2
SYR,OMN,2001.0,1,0,1
JOR,RUS,2007.0,1,0,1
ISR,AZE,2006.0,1,0,1
MLI,CAN,2002.0,1,0,1
,FSM,1997.0,1,0,1
PRT,ISR,2001.0,2,0,2
CMR,GNQ,2004.0,1,0,1
NPL,FRA,2009.0,1,0,1
ISR,PRT,1999.0,1,0,1
IDN,NGA,2002.0,1,0,1
THA,VEN,2004.0,1,0,1
KOR,PAK,2004.0,1,0,1
MCO,SVN,1998.0,1,0,1
PAN,CRI,2000.0,1,0,1
CMR,NER,2021.0,2,0,2
VEN,TTO,2009.0,1,0,1
GMB,BEL,1997.0,1,0,1
BHS,GBR,2009.0,1,0,1
URY,JPN,2001.0,1,0,1
HKG,SWE,1997.0,2,0,2
AUS,UZB,1997.0,1,0,1
AUT,VNM,1998.0,1,0,1
GBR,VGB,2011.0,1,0,1
FRA,JAM,2013.0,1,0,1
SEN,DEU,2015.0,1,0,1
JAM,LBR,2013.0,1,0,1
PRT,NGA,2011.0,1,0,1
PAN,PRI,2022.0,1,0,1
MYS,BIH,2018.0,1,0,1
KOR,COL,2013.0,1,0,1
CAN,AFG,2008.0,1,0,1
EST,ARG,2016.0,1,0,1
BGR,EGY,2014.0,1,0,1
NGA,PAK,2015.0,1,0,1
RWA,LBR,2018.0,1,0,1
OMN,RWA,2018.0,1,0,1
KNA,CHL,2022.0,1,0,1
RUS,HRV,2001.0,1,0,1
SDN,FIN,2018.0,1,0,1
SGP,KWT,2000.0,1,0,1
RUS,NZL,1998.0,1,0,1
AGO,GBR,2016.0,1,0,1
TTO,DEU,2017.0,1,0,1
KAZ,NOR,2013.0,1,0,1
UKR,TWN,2012.0,1,0,1
THA,MDV,2019.0,2,0,2
KHM,ITA,2017.0,1,0,1
IND,BTN,1997.0,1,0,1
IRN,ISL,2018.0,1,0,1
,CPV,2002.0,1,0,1
RUS,SVN,2007.0,2,0,2
TUR,JOR,2019.0,2,0,2
JAM,BRB,2022.0,1,0,1
NLD,IRQ,2020.0,1,0,1
TZA,MYS,2017.0,1,0,1
MLT,SRB,2003.0,1,0,1
IRN,BRN,2021.0,1,0,1
AGO,AUS,2014.0,1,0,1
SVN,ITA,2024.0,1,0,1
ARM,CAN,2015.0,1,0,1
USA,MLT,2002.0,2,0,2
EST,KAZ,2022.0,1,0,1
COG,NAM,2023.0,1,0,1
ARG,ZAF,2004.0,1,0,1
DNK,AGO,2023.0,1,0,1
MLT,CHN,2022.0,1,0,1
AUS,KAZ,2004.0,1,0,1
MSR,DMA,2012.0,1,0,1
GUY,USA,2001.0,1,0,1
TWN,SAU,1997.0,1,0,1
BRB,,2005.0,2,0,2
EGY,PER,2011.0,1,0,1
CAN,FJI,2003.0,2,0,2
BLR,KOR,2003.0,1,0,1
MMR,GBR,2012.0,1,0,1
NLD,UZB,2001.0,1,0,1
BRN,FJI,2019.0,1,0,1
ZAF,BRN,2004.0,1,0,1
IDN,KHM,2019.0,1,0,1
GHA,ZWE,2014.0,1,0,1
CHL,BHS,2013.0,1,0,1
ERI,GBR,2015.0,1,0,1
CUB,URY,2000.0,1,0,1
BRA,CMR,2010.0,1,0,1
CAN,GMB,2007.0,1,0,1
CRI,GRC,2022.0,1,0,1
ZAF,YEM,2022.0,1,0,1
BEN,RUS,2018.0,1,0,1
COL,HKG,2021.0,1,0,1
GRD,TCA,2019.0,1,0,1
GAB,REU,2017.0,1,0,1
IRQ,DNK,2022.0,1,0,1
EGY,THA,2021.0,1,0,1
SDN,AUS,2022.0,1,0,1
ZMB,AUT,2023.0,1,0,1
TLS,JPN,2023.0,1,0,1
NLD,ABW,2014.0,1,0,1
JOR,IND,2009.0,1,0,1
CPV,BRA,2010.0,1,0,1
BRA,UZB,2020.0,1,0,1
SWZ,NGA,2008.0,1,0,1
GHA,ETH,2012.0,1,0,1
USA,MMR,2004.0,1,0,1
HRV,BGR,2002.0,1,0,1
SEN,NGA,2001.0,1,0,1
FJI,GUY,2002.0,1,0,1
TTO,FRA,2018.0,1,0,1
MTQ,,1999.0,2,0,2
RUS,ISL,2010.0,1,0,1
ZAF,SRB,2015.0,1,0,1
GTM,DEU,2001.0,3,0,3
FRA,GUY,1998.0,1,0,1
YEM,OMN,2005.0,1,0,1
CHN,ZMB,2000.0,1,0,1
DNK,VNM,2015.0,4,0,4
SWE,BIH,2003.0,1,0,1
PNG,GIN,2007.0,1,0,1
NAM,AUS,2007.0,1,0,1
MEX,PRI,2004.0,1,0,1
MNE,RUS,1998.0,1,0,1
AUS,FLK,2005.0,1,0,1
LVA,ESP,2008.0,1,0,1
FIN,OMN,2008.0,1,0,1
TWN,ETH,2016.0,1,0,1
FSM,PLW,2000.0,1,0,1
MWI,SWZ,2019.0,1,0,1
LCA,,2009.0,1,0,1
SWZ,,2007.0,4,0,4
HKG,BRA,2008.0,1,0,1
MAC,BRA,2003.0,2,0,2
BEL,GEO,2011.0,1,0,1
BGD,KHM,2006.0,1,0,1
GBR,MRT,2009.0,1,0,1
NAM,TTO,2011.0,1,0,1
THA,HUN,2003.0,1,0,1
SVN,NZL,2012.0,1,0,1
OMN,THA,2009.0,1,0,1
ITA,LIE,2003.0,1,0,1
LIE,ITA,2015.0,1,0,1
CHL,TUR,2011.0,1,0,1
BGD,TWN,2005.0,1,0,1
AUT,LKA,2012.0,1,0,1
CRI,AUS,2010.0,2,0,2
BDI,CIV,2001.0,1,0,1
IRL,SDN,2008.0,1,0,1
NER,HTI,2011.0,1,0,1
BEL,IDN,2003.0,1,0,1
PHL,AUT,2017.0,2,0,2
COG,JPN,2018.0,1,0,1
SWE,LBY,2007.0,1,0,1
BOL,PER,2011.0,2,0,2
BLZ,PAN,2021.0,1,0,1
CHN,KHM,2009.0,1,0,1
MNG,DEU,2003.0,1,0,1
GHA,BFA,2012.0,1,0,1
NLD,GMB,2009.0,1,0,1
BEN,NGA,1999.0,2,0,2
ECU,COL,2001.0,1,0,1
AUT,IRL,2005.0,2,0,2
NZL,HUN,2010.0,1,0,1
COL,GHA,2020.0,1,0,1
SAU,GHA,2014.0,1,0,1
KOR,BRA,2010.0,1,0,1
COD,BEN,2023.0,1,0,1
MDG,CHE,2016.0,1,0,1
COD,TZA,2016.0,1,0,1
PAK,KHM,2017.0,1,0,1
MMR,FRA,2016.0,1,0,1
KGZ,NLD,2022.0,1,0,1
MEX,ZMB,2020.0,1,0,1
BIH,SAU,2019.0,1,0,1
GLP,TWN,2023.0,1,0,1
ESP,CIV,2016.0,1,0,1
UGA,TCD,2022.0,1,0,1
ARM,GBR,2019.0,1,0,1
USA,WSM,2021.0,2,0,2
HND,GBR,2022.0,1,0,1
KHM,BEL,2023.0,1,0,1
DNK,SAU,2012.0,1,0,1
ETH,PAK,2023.0,1,0,1
PAK,NGA,2014.0,1,0,1
PHL,YEM,2017.0,1,0,1
MWI,KHM,2015.0,1,0,1
ARM,ISR,2005.0,1,0,1
SYR,BEL,2003.0,1,0,1
UKR,THA,1998.0,1,0,1
AUT,BWA,1997.0,1,0,1
BWA,SVN,2005.0,1,0,1
IRQ,QAT,2001.0,1,0,1
SWE,VEN,1997.0,1,0,1
IND,EGY,2000.0,3,0,3
ETH,SYR,1998.0,1,0,1
KEN,BEN,2003.0,1,0,1
ROU,PRT,1998.0,1,0,1
BOL,DEU,1999.0,1,0,1
UZB,BEL,2007.0,1,0,1
NGA,GHA,1999.0,3,0,3
HRV,NLD,2006.0,1,0,1
ETH,BWA,2011.0,1,0,1
SGP,ARE,2007.0,2,0,2
MYS,LBY,2006.0,1,0,1
BFA,LAO,2007.0,1,0,1
ZWE,COG,2003.0,2,0,2
COG,PRT,2016.0,1,0,1
TJK,ISR,2013.0,1,0,1
TTO,JAM,1999.0,1,0,1
THA,ISR,2019.0,1,0,1
CYP,CHE,2010.0,1,0,1
JPN,SVN,2003.0,2,0,2
BEL,CAF,2000.0,1,0,1
POL,MAR,2014.0,2,0,2
GUY,TZA,2000.0,1,0,1
JPN,BFA,2007.0,1,0,1
BEL,BIH,2019.0,1,0,1
JPN,MDG,1998.0,1,0,1
VGB,USA,2001.0,1,0,1
RUS,BWA,2004.0,1,0,1
QAT,TWN,2019.0,1,0,1
CAN,LIE,2013.0,1,0,1
KEN,BWA,2019.0,1,0,1
SYR,CHN,2017.0,1,0,1
DZA,ZAF,2011.0,1,0,1
BFA,CHN,2018.0,1,0,1
GLP,,2026.0,1,0,1
NZL,TTO,2017.0,2,0,2
ARM,PRT,2018.0,2,0,2
CHL,TWN,2007.0,1,0,1
ESP,KEN,2012.0,2,0,2
LBN,PSE,2010.0,1,0,1
MEX,PRI,2001.0,2,0,2
SVN,MAR,2018.0,1,0,1
LIE,USA,2015.0,1,0,1
GLP,CUB,2004.0,1,0,1
MMR,IND,2011.0,2,0,2
ZAF,GMB,2020.0,1,0,1
GIB,GBR,2001.0,1,0,1
ARG,OMN,2022.0,1,0,1
EGY,ESP,2024.0,1,0,1
BRA,MOZ,2009.0,1,0,1
MNG,THA,2016.0,2,0,2
BDI,BFA,2020.0,1,0,1
KWT,JOR,2019.0,2,0,2
ALB,NLD,2015.0,1,0,1
CHE,SUR,2015.0,1,0,1
SLB,CHE,2003.0,1,0,1
SWZ,PHL,2019.0,1,0,1
IND,ISL,2021.0,2,0,2
ARE,SOM,2014.0,1,0,1
CHN,BEN,2018.0,1,0,1
OMN,KAZ,2023.0,1,0,1
ITA,MDA,2017.0,1,0,1
ABW,NLD,2016.0,1,0,1
ZAF,PHL,2021.0,1,0,1
RWA,AUT,2003.0,1,0,1
CYP,ARE,2003.0,1,0,1
GRC,ARE,2008.0,1,0,1
EGY,TJK,2021.0,1,0,1
HND,JPN,2009.0,1,0,1
NGA,MDV,2021.0,1,0,1
FJI,DNK,2019.0,1,0,1
KEN,SEN,2020.0,1,0,1
BEN,ITA,2011.0,1,0,1
CUB,DNK,2005.0,1,0,1
BMU,FRA,2011.0,1,0,1
KEN,ETH,2002.0,3,0,3
LBN,POL,2007.0,1,0,1
FRA,MUS,2009.0,1,0,1
TGO,SEN,2011.0,1,0,1
TWN,GRC,2002.0,2,0,2
TWN,COL,2002.0,1,0,1
MCO,BRA,2002.0,1,0,1
WSM,GBR,2003.0,1,0,1
BRA,LBY,2006.0,1,0,1
PRI,ITA,2006.0,1,0,1
IND,BRN,2003.0,1,0,1
URY,DOM,2018.0,1,0,1
FIN,LBY,2013.0,1,0,1
AUS,ETH,2008.0,1,0,1
AZE,CAN,2015.0,1,0,1
IRQ,ESP,2011.0,1,0,1
TJK,FRA,2010.0,1,0,1
DNK,IDN,2006.0,1,0,1
CAN,MLI,2005.0,1,0,1
FRA,SMR,2017.0,1,0,1
ZAF,ESP,1999.0,1,0,1
EGY,SVK,1999.0,1,0,1
SLE,COG,2018.0,1,0,1
FIN,PSE,2016.0,1,0,1
PNG,FJI,2014.0,1,0,1
VEN,POL,2021.0,1,0,1
NLD,MWI,2023.0,1,0,1
RWA,CHE,2015.0,1,0,1
SLE,COG,2022.0,1,0,1
TUR,TZA,2017.0,1,0,1
YEM,TUR,2019.0,1,0,1
PRT,SVK,2020.0,1,0,1
SWE,BFA,2019.0,1,0,1
KOR,LBN,2010.0,1,0,1
KNA,,2015.0,1,0,1
LBR,ETH,2018.0,1,0,1
PAN,SAU,2015.0,1,0,1
CRI,PAN,2017.0,1,0,1
SAU,ZMB,2022.0,1,0,1
NLD,KGZ,2017.0,1,0,1
NOR,BGD,2015.0,1,0,1
BGD,TZA,2017.0,1,0,1
NOR,QAT,2008.0,1,0,1
CAF,BEL,1997.0,1,0,1
ETH,IRN,2015.0,1,0,1
IRN,ETH,2017.0,2,0,2
UGA,ITA,2003.0,1,0,1
TUN,MRT,2016.0,1,0,1
LVA,NLD,2021.0,1,0,1
TUR,ROU,2023.0,1,0,1
ZWE,COD,2023.0,2,0,2
TUN,MAR,1997.0,2,0,2
JAM,TTO,2023.0,1,0,1
ZAF,THA,2020.0,1,0,1
ISL,RUS,2021.0,1,0,1
OMN,NOR,2020.0,1,0,1
COL,EGY,2020.0,1,0,1
SLV,MEX,2005.0,1,0,1
VEN,PRT,2007.0,1,0,1
BRA,PRI,1997.0,2,0,2
CRI,BRA,1999.0,1,0,1
MDG,SEN,2005.0,1,0,1
TWN,ESP,2001.0,1,0,1
BEN,MLI,2007.0,1,0,1
GMB,CHE,1998.0,1,0,1
ITA,TZA,2009.0,1,0,1
AUS,NPL,2001.0,1,0,1
KOR,SVK,2013.0,1,0,1
AUS,MCO,2001.0,1,0,1
UKR,AUS,1998.0,2,0,2
RUS,SVN,1999.0,1,0,1
THA,SDN,2021.0,1,0,1
MAC,TUN,2021.0,1,0,1
SSD,SOM,2021.0,1,0,1
VEN,IND,2002.0,1,0,1
KEN,NAM,2017.0,1,0,1
LTU,NOR,1997.0,1,0,1
FRA,VUT,2010.0,1,0,1
DZA,TUN,2001.0,1,0,1
BWA,CAN,2002.0,1,0,1
ZAF,GRC,2019.0,1,0,1
FRA,SYR,2000.0,2,0,2
IRQ,USA,1999.0,1,0,1
LTU,CHN,2000.0,2,0,2
CIV,MRT,2006.0,1,0,1
JPN,MWI,2010.0,1,0,1
ERI,SAU,2019.0,1,0,1
AUT,URY,1998.0,1,0,1
MEX,GTM,2001.0,2,0,2
PAN,FRA,2009.0,1,0,1
UGA,MWI,2002.0,1,0,1
CHL,FIN,2010.0,1,0,1
LSO,BWA,1997.0,1,0,1
IDN,PNG,2001.0,2,0,2
MKD,GBR,1999.0,1,0,1
GBR,MDA,2006.0,1,0,1
POL,BWA,2023.0,1,0,1
UGA,CHE,1997.0,1,0,1
FIN,NGA,2004.0,1,0,1
BRA,NGA,2000.0,1,0,1
PHL,TWN,2004.0,1,0,1
SYR,HUN,2012.0,1,0,1
KWT,NGA,2016.0,1,0,1
SLE,USA,2003.0,1,0,1
NGA,CIV,2018.0,2,0,2
DZA,AUT,2017.0,1,0,1
GRC,MEX,2015.0,1,0,1
IRN,ROU,2018.0,1,0,1
NGA,TGO,2013.0,1,0,1
CUB,FIN,2014.0,1,0,1
UZB,ISR,2007.0,1,0,1
CIV,TZA,2018.0,1,0,1
TUR,BHR,2017.0,1,0,1
CHE,GEO,2001.0,1,0,1
AUS,UZB,2002.0,1,0,1
BWA,BRA,2013.0,1,0,1
CHN,ARM,2023.0,1,0,1
CHE,JAM,2005.0,1,0,1
KIR,,2018.0,1,0,1
GBR,PNG,2020.0,1,0,1
PHL,OMN,2015.0,1,0,1
FRA,PSE,2014.0,1,0,1
EST,KAZ,2018.0,1,0,1
TGO,BEN,2014.0,1,0,1
ECU,CYP,2022.0,1,0,1
MAC,IRL,2016.0,1,0,1
MYS,AUT,2017.0,1,0,1
MEX,SVK,2021.0,2,0,2
ESP,ISL,2021.0,1,0,1
ZAF,HKG,1998.0,1,0,1
ROU,CZE,2019.0,1,0,1
SWE,ARM,2021.0,1,0,1
KAZ,ARE,2023.0,1,0,1
USA,AND,2017.0,1,0,1
TWN,KAZ,2021.0,1,0,1
PRT,ISL,2014.0,1,0,1
MAR,COG,2018.0,1,0,1
MNG,NOR,2018.0,1,0,1
HKG,CYM,2022.0,1,0,1
CYM,HKG,2023.0,1,0,1
SAU,ROU,2019.0,1,0,1
IND,SDN,2011.0,1,0,1
ERI,COG,2022.0,1,0,1
,LBN,2021.0,2,0,2
SDN,HUN,2023.0,1,0,1
ATA,USA,2022.0,1,0,1
VEN,FIN,2018.0,1,0,1
CAN,BFA,2018.0,2,4,-2
FIN,ECU,2020.0,1,1,0
SVN,DEU,2012.0,13,12,1
EGY,VNM,2019.0,1,1,0
ROU,JPN,2023.0,2,1,1
CUB,DEU,2015.0,2,8,-6
GHA,IND,2020.0,3,3,0
CAN,IND,2024.0,1,1,0
CHL,BRA,2024.0,1,1,0
NLD,ISL,2022.0,1,2,-1
CHE,IDN,2017.0,1,3,-2
FRA,HTI,2007.0,1,2,-1
FRA,UZB,2015.0,2,2,0
DEU,COD,2021.0,1,2,-1
JPN,CUB,2007.0,1,1,0
NGA,NLD,2004.0,1,1,0
NOR,UGA,2004.0,1,2,-1
THA,VNM,2007.0,1,2,-1
CHN,MYS,2009.0,5,5,0
BEN,SEN,2015.0,1,2,-1
NOR,KAZ,2022.0,1,1,0
GBR,PSE,2003.0,1,2,-1
GHA,TUR,2021.0,1,1,0
CHE,QAT,2016.0,1,2,-1
OMN,CAN,2023.0,3,2,1
IRL,CHL,2019.0,1,2,-1
ESP,PHL,2013.0,1,2,-1
TUR,JOR,2018.0,1,4,-3
CHN,TUN,2020.0,1,7,-6
ECU,URY,2020.0,1,1,0
USA,TON,2019.0,1,1,0
NLD,MYS,2002.0,2,2,0
DNK,ARG,2000.0,1,2,-1
ISR,PRT,2008.0,2,1,1
PHL,CHE,2002.0,3,2,1
NZL,PNG,2014.0,1,1,0
USA,COM,2016.0,1,1,0
HUN,HKG,2002.0,2,1,1
SVN,BEL,2014.0,2,3,-1
CYP,USA,2001.0,3,7,-4
HKG,BEL,2000.0,1,1,0
HUN,CAN,2023.0,3,2,1
DEU,MDA,2020.0,3,2,1
DZA,GBR,2012.0,2,4,-2
OMN,PAK,2021.0,7,14,-7
SWE,CUB,2015.0,1,2,-1
FIN,LUX,2020.0,1,1,0
SVN,POL,2013.0,1,4,-3
SVN,NOR,2019.0,2,1,1
ARE,THA,2023.0,1,4,-3
SAU,SWE,2018.0,7,11,-4
ZWE,ETH,2022.0,1,1,0
HUN,ARE,2022.0,1,3,-2
PRT,CZE,2023.0,1,5,-4
PRT,ROU,2001.0,1,3,-2
CIV,GBR,2012.0,1,2,-1
CAN,LTU,2012.0,2,2,0
GHA,SWE,2011.0,1,2,-1
CAN,BTN,2019.0,1,1,0
BDI,BEL,2014.0,1,1,0
KHM,VNM,2010.0,2,1,1
ZAF,MOZ,2022.0,1,7,-6
ECU,DNK,2019.0,1,1,0
COG,CAN,2019.0,1,1,0
TTO,JAM,2008.0,1,2,-1
PER,CAN,2019.0,3,7,-4
EGY,BHR,2004.0,1,1,0
TZA,CHE,2008.0,2,3,-1
MAR,TGO,2015.0,3,1,2
HUN,NOR,2008.0,2,1,1
NOR,NGA,2020.0,1,4,-3
EST,IND,2014.0,1,1,0
SLV,CZE,2013.0,1,1,0
NOR,BWA,2009.0,1,1,0
ARE,ZAF,2004.0,1,1,0
BEL,BEN,2001.0,1,4,-3
CAN,IDN,2009.0,1,2,-1
SDN,DEU,2010.0,5,2,3
DEU,IDN,1999.0,3,2,1
NAM,DEU,2014.0,1,3,-2
LTU,CAN,2006.0,2,1,1
USA,CYP,1997.0,3,5,-2
KOR,KHM,2016.0,1,1,0
BFA,CHE,2021.0,2,2,0
CHL,NOR,2009.0,1,4,-3
NGA,ARG,2015.0,1,1,0
DEU,LVA,2020.0,3,5,-2
USA,MUS,2017.0,2,3,-1
CHL,AUT,2018.0,4,2,2
GBR,GTM,2022.0,1,2,-1
HRV,MYS,2014.0,1,1,0
SWE,HRV,2010.0,4,2,2
AUS,PER,2012.0,1,2,-1
SAU,AUS,1998.0,2,3,-1
NOR,HKG,2018.0,2,4,-2
DEU,MDG,2023.0,1,2,-1
RWA,GBR,2014.0,1,5,-4
BOL,MEX,2015.0,1,1,0
HUN,BGR,2001.0,1,1,0
SAU,PRT,2020.0,3,2,1
GIN,CHE,2019.0,1,1,0
TCD,SEN,2022.0,1,1,0
DZA,CHE,2007.0,1,1,0
CAF,ZAF,2012.0,1,1,0
HUN,SRB,2004.0,2,2,0
NOR,LUX,2010.0,1,1,0
LVA,ITA,2001.0,1,2,-1
IDN,THA,2003.0,2,3,-1
ETH,COG,2019.0,1,1,0
UKR,CZE,2008.0,2,3,-1
OMN,IRN,2018.0,1,3,-2
BLR,POL,2004.0,2,4,-2
KOR,THA,2006.0,2,2,0
NOR,SVN,2011.0,1,1,0
EGY,PSE,2012.0,1,4,-3
EST,NOR,2008.0,2,1,1
TUN,PRT,2023.0,4,2,2
BHR,KWT,2019.0,1,2,-1
ISR,KOR,2012.0,4,2,2
SAU,CYP,2023.0,1,2,-1
CHE,BGR,2011.0,1,2,-1
UGA,IDN,2021.0,1,1,0
AUT,BGD,2018.0,1,1,0
BEL,EGY,1998.0,2,5,-3
ISL,NOR,2005.0,1,5,-4
IRN,NOR,2017.0,10,2,8
NAM,NGA,2020.0,1,1,0
DEU,GEO,2021.0,2,3,-1
CHN,CHL,2011.0,3,7,-4
GHA,CHN,2010.0,1,1,0
DEU,CMR,2012.0,3,5,-2
NZL,PAK,2012.0,3,3,0
THA,SAU,2018.0,1,2,-1
QAT,CHN,2019.0,3,5,-2
AUT,SVN,2003.0,2,7,-5
SVK,FIN,2018.0,1,1,0
CHN,TGO,2021.0,1,2,-1
AUS,MNG,2017.0,3,1,2
HUN,IRN,2010.0,1,1,0
FJI,JPN,2002.0,1,1,0
USA,COG,2023.0,1,2,-1
PER,DEU,2018.0,2,7,-5
MMR,PHL,2021.0,1,1,0
ISR,JOR,2022.0,1,1,0
MWI,NLD,2007.0,1,1,0
MDA,USA,2021.0,4,2,2
UZB,KAZ,2020.0,2,7,-5
ARE,NLD,2010.0,1,1,0
ARE,JOR,2001.0,3,5,-2
PRI,CAN,2012.0,1,6,-5
ESP,PAN,2009.0,2,2,0
ZWE,NLD,2015.0,2,1,1
UGA,DEU,2013.0,2,3,-1
QAT,IND,2010.0,1,6,-5
ARE,CHL,2014.0,1,1,0
NZL,TUR,2018.0,1,5,-4
NLD,NOR,1997.0,6,5,1
PAK,EGY,2008.0,1,4,-3
MLI,FRA,2006.0,2,11,-9
IRL,HUN,2000.0,1,3,-2
JPN,MYS,1997.0,3,2,1
PAK,SGP,2013.0,2,2,0
USA,SLE,2013.0,2,1,1
NOR,GHA,2015.0,1,1,0
MAR,BDI,2021.0,1,1,0
SLV,DEU,2021.0,1,1,0
GRL,DNK,2003.0,1,5,-4
ISR,DNK,2005.0,2,2,0
RUS,KGZ,1999.0,1,1,0
NPL,CHN,2012.0,1,2,-1
NLD,GAB,2008.0,1,2,-1
RUS,ROU,2002.0,1,3,-2
SAU,FRA,1998.0,1,4,-3
RUS,ROU,2012.0,1,1,0
IRL,EGY,2013.0,1,2,-1
LVA,DNK,2003.0,1,1,0
IRQ,AUS,2012.0,3,1,2
POL,IDN,2022.0,2,4,-2
LBY,GBR,2011.0,1,6,-5
PHL,NZL,2021.0,1,2,-1
ARG,CHN,2000.0,1,1,0
VEN,BRA,2005.0,4,7,-3
NZL,ITA,1999.0,3,2,1
LBY,USA,2018.0,2,4,-2
ISR,KOR,2005.0,1,3,-2
DNK,GNB,2019.0,2,4,-2
AUS,URY,2021.0,2,1,1
GBR,REU,2021.0,1,1,0
COG,ITA,2020.0,2,2,0
LKA,CAN,1999.0,1,1,0
NLD,SGP,2002.0,2,2,0
VNM,NLD,2010.0,1,6,-5
CYM,USA,2008.0,2,1,1
LBY,SWE,2009.0,1,1,0
HKG,GRC,2016.0,1,1,0
COD,BEL,2015.0,1,1,0
JOR,QAT,2007.0,2,1,1
EST,AUS,2018.0,3,2,1
CHE,ZWE,2018.0,1,2,-1
LBY,ARE,2019.0,1,1,0
ISL,CAN,2023.0,2,1,1
IND,IDN,1999.0,2,1,1
UGA,KEN,2006.0,4,2,2
DNK,PHL,2015.0,2,1,1
GRC,IND,2014.0,1,3,-2
CZE,CHN,2009.0,2,3,-1
ARE,HKG,2007.0,1,1,0
LTU,IRN,2014.0,1,1,0
COL,PRI,2009.0,1,3,-2
ARE,ITA,2015.0,1,12,-11
SAU,DEU,2009.0,2,14,-12
BGD,SGP,2015.0,2,2,0
MNG,TWN,2019.0,1,5,-4
ECU,AUT,2018.0,1,1,0
CHN,GEO,2018.0,2,1,1
ISR,BLR,2020.0,1,2,-1
GUM,AUS,2009.0,1,1,0
COL,SWE,2012.0,2,3,-1
GBR,ECU,2000.0,1,1,0
CHE,LUX,2017.0,4,5,-1
HND,CRI,2008.0,1,1,0
IRQ,JOR,2020.0,2,9,-7
ITA,MKD,2014.0,1,1,0
SAU,TWN,2016.0,3,8,-5
NZL,UGA,2016.0,1,1,0
USA,SLE,2015.0,3,6,-3
ARE,QAT,2006.0,1,1,0
AUS,LAO,2017.0,2,2,0
OMN,PAK,2006.0,2,1,1
OMN,PAK,2010.0,1,6,-5
PHL,BGD,2012.0,1,2,-1
LAO,AUS,2022.0,1,1,0
SVN,RUS,2012.0,2,1,1
THA,NOR,2017.0,1,1,0
SVN,CZE,2019.0,4,4,0
GRC,ROU,2017.0,1,4,-3
USA,SDN,2003.0,1,1,0
CIV,KEN,2021.0,4,1,3
BLR,BEL,2005.0,1,6,-5
BEL,CMR,2019.0,3,5,-2
MWI,NLD,2012.0,1,4,-3
ESP,AND,2004.0,1,2,-1
GHA,KEN,2007.0,1,1,0
EST,NLD,2005.0,1,1,0
DEU,MNG,2006.0,1,2,-1
CAN,BHR,2007.0,2,1,1
GMB,BEL,2015.0,1,1,0
IRL,HUN,2011.0,1,2,-1
WSM,NZL,2015.0,1,1,0
BHR,CAN,2016.0,1,3,-2
GAB,BEL,2014.0,1,4,-3
SLB,AUS,2020.0,1,1,0
DEU,HRV,2023.0,5,9,-4
CHE,ROU,2001.0,1,6,-5
FRA,BGD,2015.0,1,2,-1
MYS,BGD,1998.0,1,1,0
LAO,KOR,2020.0,1,2,-1
MEX,SAU,2018.0,3,1,2
NZL,FJI,2009.0,2,1,1
ZAF,POL,2009.0,1,1,0
NLD,ARG,2022.0,3,4,-1
EST,BEL,2020.0,3,1,2
MMR,CHE,2020.0,2,3,-1
GEO,NOR,2021.0,1,1,0
GRC,RUS,2023.0,2,3,-1
JAM,ZAF,2013.0,1,1,0
BLR,SRB,2008.0,1,1,0
LBN,GBR,1998.0,1,2,-1
CHE,HKG,2005.0,1,3,-2
MAC,MKD,2019.0,2,7,-5
DNK,HKG,2009.0,1,1,0
GRD,USA,2002.0,1,1,0
EST,RUS,2008.0,1,1,0
EGY,TUN,2014.0,1,1,0
KEN,TZA,2012.0,1,2,-1
FRA,GHA,2021.0,2,4,-2
ECU,AUT,2022.0,1,3,-2
GIN,BEL,2021.0,2,1,1
SRB,NOR,2023.0,1,2,-1
DNK,TUR,2023.0,1,7,-6
ETH,SWE,2003.0,2,15,-13
BEN,BFA,2016.0,1,2,-1
GBR,LTU,2002.0,2,2,0
SWZ,NGA,2012.0,1,1,0
TTO,CAN,2010.0,2,3,-1
RUS,LTU,2001.0,2,1,1
CHL,CUB,2018.0,1,19,-18
KGZ,UKR,2018.0,1,1,0
CHL,VEN,2013.0,3,10,-7
CYP,ROU,2019.0,1,1,0
URY,COL,2017.0,1,1,0
KAZ,NOR,2020.0,1,2,-1
CHN,AFG,2021.0,1,1,0
KOR,GRC,2021.0,1,2,-1
OMN,CHN,2023.0,1,1,0
ZAF,OMN,2022.0,1,1,0
GEO,GBR,2008.0,2,2,0
CHE,UKR,2000.0,1,4,-3
TUN,PRT,2009.0,1,1,0
AUS,ETH,2012.0,2,6,-4
TZA,IND,2014.0,1,4,-3
SGP,SWE,2006.0,2,5,-3
UGA,GMB,2015.0,1,1,0
UKR,BLR,2001.0,1,4,-3
PSE,FIN,2019.0,1,1,0
PER,SWE,2017.0,1,1,0
PRI,VEN,2016.0,1,2,-1
PSE,SAU,2020.0,1,5,-4
ROU,ESP,1997.0,2,2,0
HUN,ISR,2002.0,1,3,-2
JOR,AUS,2002.0,1,4,-3
AUS,LAO,2018.0,1,2,-1
MCO,CAN,2018.0,1,0,1
IND,LUX,2010.0,1,0,1
GHA,MWI,2013.0,1,0,1
LBY,DEU,2016.0,1,0,1
,PRK,2010.0,5,0,5
PHL,NOR,2020.0,1,0,1
CHE,QAT,2017.0,4,0,4
CIV,IND,2011.0,1,0,1
MOZ,CHE,2015.0,1,0,1
ZMB,ZWE,2008.0,1,0,1
NGA,BRA,2005.0,1,0,1
MCO,BRA,2003.0,1,0,1
MEX,THA,2014.0,1,0,1
TUN,NGA,2015.0,1,0,1
SWE,IRN,1998.0,2,0,2
BEL,MAC,2019.0,1,0,1
PYF,GLP,2008.0,1,0,1
CHE,CIV,2023.0,1,0,1
ZMB,IND,2019.0,1,0,1
CRI,PRT,2017.0,1,0,1
AUS,CYP,2023.0,1,0,1
LUX,NOR,2014.0,3,0,3
MWI,KHM,2020.0,1,0,1
SUR,NLD,2023.0,1,0,1
OMN,QAT,2021.0,1,0,1
HKG,QAT,2022.0,1,0,1
IRL,ECU,2020.0,1,0,1
SLE,ETH,2018.0,2,0,2
QAT,SRB,2019.0,2,0,2
LBN,IRN,2018.0,3,0,3
ARM,CHL,2020.0,1,0,1
KOR,GRC,2023.0,2,0,2
VNM,BTN,2009.0,1,0,1
BTN,VNM,2015.0,1,0,1
PAK,LTU,2019.0,2,0,2
SYR,IRL,2022.0,1,0,1
IRL,SYR,2023.0,1,0,1
BEL,URY,2007.0,1,0,1
SLV,USA,1999.0,1,0,1
FRO,NOR,2015.0,1,0,1
NGA,NAM,2022.0,2,0,2
OMN,CHE,2001.0,1,0,1
BRA,SVN,2023.0,3,0,3
CAN,LVA,2011.0,1,0,1
CAN,HTI,2011.0,2,0,2
ZWE,SWZ,2018.0,1,0,1
MAC,MAR,2005.0,1,0,1
,COM,2002.0,1,0,1
BEL,NAM,2008.0,1,0,1
AUT,UGA,2008.0,2,0,2
NLD,RWA,2018.0,1,0,1
BHS,,2015.0,2,0,2
GBR,REU,2011.0,2,0,2
MOZ,PSE,2010.0,1,0,1
NZL,HRV,2006.0,1,0,1
CMR,MWI,2017.0,1,0,1
CUB,MOZ,2015.0,1,0,1
BIH,PAK,2008.0,1,0,1
CHN,BFA,2008.0,1,0,1
FRA,MMR,2017.0,2,0,2
EGY,NZL,2008.0,1,0,1
ISR,MNG,2017.0,1,0,1
MYS,LAO,2005.0,1,0,1
CHL,PAN,2011.0,1,0,1
KEN,NAM,2011.0,1,0,1
OMN,DZA,2011.0,1,0,1
GBR,ALB,2006.0,1,0,1
POL,LTU,2005.0,3,0,3
,TKL,2002.0,1,0,1
YEM,,2004.0,2,0,2
KWT,NGA,2011.0,1,0,1
BWA,SLE,2014.0,1,0,1
FSM,,2005.0,1,0,1
CHN,SEN,2021.0,3,0,3
USA,BEN,2005.0,2,0,2
CAN,BEN,2005.0,1,0,1
PRT,OMN,2019.0,1,0,1
GUF,USA,2008.0,1,0,1
ZWE,COG,2012.0,1,0,1
CIV,BEN,2007.0,1,0,1
BLZ,,2006.0,1,0,1
SLV,USA,1998.0,1,0,1
GLP,BRA,2003.0,1,0,1
SGP,GRC,2009.0,2,0,2
SGP,GRC,2011.0,1,0,1
COG,CHE,2012.0,1,0,1
NGA,EGY,2007.0,1,0,1
LKA,CAN,2007.0,1,0,1
MWI,CAN,2013.0,2,0,2
BFA,AUS,2003.0,1,0,1
TUN,JOR,2012.0,1,0,1
GBR,RWA,2008.0,3,0,3
TWN,SWE,2005.0,1,0,1
TWN,MEX,2015.0,1,0,1
PHL,RWA,2012.0,1,0,1
ETH,TZA,2013.0,1,0,1
AUS,MCO,2007.0,1,0,1
HUN,POL,2011.0,2,0,2
SWE,LBN,2015.0,1,0,1
IDN,BGD,2009.0,1,0,1
LAO,VNM,2023.0,2,0,2
SVN,QAT,2018.0,1,0,1
BRB,AUS,2009.0,1,0,1
JPN,ARG,2015.0,1,0,1
QAT,KWT,2007.0,1,0,1
SAU,SVK,2009.0,1,0,1
KHM,CHE,2022.0,1,0,1
MMR,PHL,2009.0,1,0,1
PHL,CAN,2007.0,1,0,1
GRC,URY,2017.0,1,0,1
ZAF,VCT,2002.0,2,0,2
RUS,WSM,2009.0,1,0,1
BEL,PSE,2014.0,2,0,2
DEU,NAM,2011.0,1,0,1
NAM,DEU,2015.0,1,0,1
MYS,ZAF,2008.0,1,0,1
BIH,BRA,2023.0,1,0,1
ARG,BHS,2021.0,1,0,1
GNQ,,2020.0,4,0,4
LIE,AUS,2011.0,1,0,1
SYR,CHE,2008.0,1,0,1
ARG,SAU,2015.0,1,0,1
SAU,OMN,2002.0,2,0,2
MAC,ITA,2019.0,1,0,1
MAR,SYR,2006.0,1,0,1
COM,NGA,2004.0,1,0,1
HUN,TUR,2014.0,2,0,2
ITA,SDN,2023.0,2,0,2
GRC,SVN,2009.0,1,0,1
TUN,ZAF,2021.0,1,0,1
IDN,ETH,2017.0,1,0,1
CHL,TUN,2023.0,1,0,1
DZA,ARG,2013.0,2,0,2
MAC,ESP,2020.0,1,0,1
AZE,KAZ,2011.0,1,0,1
BGD,PRT,2011.0,1,0,1
PRT,BGD,2013.0,1,0,1
AFG,JPN,2014.0,1,0,1
VEN,SWE,2014.0,1,0,1
MYS,BWA,2015.0,1,0,1
VNM,IND,2014.0,1,0,1
IRN,NPL,2013.0,1,0,1
PHL,CHL,2015.0,1,0,1
ALB,FRA,2022.0,1,0,1
QAT,SEN,2017.0,1,0,1
KOR,BLR,2018.0,1,0,1
KWT,NZL,2018.0,4,0,4
CHN,DJI,2019.0,1,0,1
PHL,SAU,2016.0,1,0,1
ARG,HRV,2023.0,1,0,1
BRA,KAZ,2020.0,2,0,2
ROU,MDG,2002.0,1,0,1
IND,MWI,2017.0,1,0,1
NER,ITA,1999.0,1,0,1
GEO,FRA,1999.0,1,0,1
GRC,MLT,2000.0,1,0,1
GHA,SEN,2012.0,1,0,1
HRV,ESP,1997.0,2,0,2
USA,NER,2013.0,3,0,3
JPN,HRV,1997.0,1,0,1
FRA,SYC,2004.0,1,0,1
ZAF,HTI,2017.0,1,0,1
FRA,UZB,2004.0,1,0,1
BGR,IRL,2001.0,1,0,1
DZA,SAU,2005.0,6,0,6
BEN,NER,2000.0,1,0,1
NER,BEN,2002.0,1,0,1
CZE,BGR,2004.0,1,0,1
UGA,PER,2012.0,1,0,1
BEL,DZA,2012.0,3,0,3
MAR,SYR,2000.0,1,0,1
TUN,BHR,2010.0,1,0,1
GNB,USA,2004.0,1,0,1
JPN,ERI,2004.0,1,0,1
COL,JPN,2000.0,1,0,1
PRT,HUN,2009.0,1,0,1
CIV,TGO,2009.0,1,0,1
JPN,ARE,2009.0,2,0,2
DEU,KHM,2007.0,1,0,1
SGP,CYP,2011.0,1,0,1
LKA,BWA,2011.0,1,0,1
BRA,GUY,2000.0,1,0,1
JPN,ARG,2008.0,2,0,2
ESP,KEN,2003.0,1,0,1
OMN,QAT,2011.0,1,0,1
SGP,IDN,1999.0,1,0,1
BRN,NLD,2018.0,1,0,1
SRB,GEO,2007.0,1,0,1
SVK,NZL,2004.0,2,0,2
NCL,BEL,2019.0,1,0,1
JPN,MMR,2005.0,1,0,1
AUS,MKD,2011.0,1,0,1
USA,GLP,1998.0,1,0,1
VEN,NLD,2006.0,1,0,1
TWN,HUN,2019.0,1,0,1
IND,JAM,2011.0,2,0,2
AUT,COL,2011.0,1,0,1
NLD,KWT,2001.0,1,0,1
PNG,DEU,2010.0,1,0,1
BFA,GLP,2008.0,1,0,1
GRC,SDN,2010.0,1,0,1
HRV,SLV,2007.0,1,0,1
BGD,ETH,2018.0,2,0,2
SAU,NPL,2004.0,1,0,1
TUR,PSE,2012.0,1,0,1
RUS,PAK,2000.0,1,0,1
IND,SRB,2012.0,1,0,1
GIN,PNG,2012.0,6,0,6
FSM,USA,2009.0,3,0,3
DEU,GUF,2013.0,1,0,1
CZE,ARE,2018.0,2,0,2
SGP,NPL,2008.0,1,0,1
ISR,ZAF,2010.0,1,0,1
HKG,POL,2009.0,2,0,2
KIR,FJI,2011.0,1,0,1
MDV,NZL,2014.0,1,0,1
BGR,ROU,2012.0,1,0,1
FSM,DEU,2014.0,1,0,1
MWI,IRQ,2018.0,2,0,2
HUN,LUX,2017.0,1,0,1
NGA,MOZ,2020.0,2,0,2
PHL,THA,2013.0,2,0,2
HRV,ISR,2019.0,1,0,1
PRT,LIE,2022.0,2,0,2
CHL,SRB,2022.0,1,0,1
BFA,DNK,2018.0,1,0,1
DNK,BFA,2021.0,1,0,1
BFA,DNK,2022.0,1,0,1
SRB,LBY,2018.0,1,0,1
IDN,NOR,2012.0,1,0,1
FIN,VNM,2014.0,2,0,2
FLK,NZL,2016.0,1,0,1
ARM,CAN,2020.0,1,0,1
SLE,ZAF,1999.0,1,0,1
UKR,PRT,2009.0,3,0,3
UKR,FIN,2023.0,2,0,2
IND,JAM,2019.0,1,0,1
CHL,SRB,2017.0,2,0,2
RUS,IRQ,2014.0,1,0,1
ZWE,MDG,2011.0,1,0,1
TTO,DEU,2019.0,1,0,1
SWE,CMR,2017.0,1,0,1
JPN,GEO,2008.0,3,0,3
ETH,AFG,2016.0,1,0,1
SOM,ETH,2013.0,1,0,1
NOR,IRN,2000.0,1,0,1
AZE,CHE,2000.0,1,0,1
BRA,ROU,2018.0,1,0,1
CHE,MWI,2012.0,1,0,1
PNG,FRA,2012.0,1,0,1
ARG,GLP,1998.0,1,0,1
NLD,OMN,1997.0,1,0,1
USA,LBY,1997.0,1,0,1
BOL,LUX,2017.0,1,0,1
CYM,GBR,2001.0,1,0,1
,SYC,2015.0,2,0,2
CYP,AFG,2021.0,1,0,1
BRA,KEN,2015.0,2,0,2
CAN,BTN,2021.0,1,0,1
BFA,CAF,2018.0,1,0,1
IND,TJK,2018.0,1,0,1
IRN,ROU,2021.0,3,0,3
SGP,OMN,2013.0,2,0,2
ISR,MWI,2021.0,1,0,1
IDN,BFA,2018.0,1,0,1
HRV,KGZ,2018.0,1,0,1
PHL,QAT,2020.0,1,0,1
RWA,SRB,2021.0,1,0,1
ESP,LKA,2022.0,1,0,1
THA,SSD,2020.0,1,0,1
HND,GBR,2021.0,1,0,1
CCK,CHL,2017.0,1,0,1
GBR,GUF,2022.0,1,0,1
CIV,BDI,2023.0,1,0,1
,TLS,2020.0,17,0,17
ZAF,MEX,1997.0,1,0,1
,MSR,2005.0,2,0,2
,NRU,2020.0,1,0,1
ARE,IRL,2003.0,1,0,1
IRN,SDN,2012.0,1,0,1
TZA,BDI,2023.0,2,0,2
HRV,MKD,2012.0,1,0,1
GBR,PAN,2014.0,2,0,2
MEX,MAR,2015.0,2,0,2
CRI,KEN,2022.0,1,0,1
KHM,DEU,2015.0,1,0,1
KOR,CYP,2020.0,1,0,1
FRA,SDN,2011.0,1,0,1
BDI,LUX,2014.0,1,0,1
AUS,ZMB,2009.0,1,0,1
CHN,BTN,2014.0,1,0,1
PAK,HUN,2018.0,2,0,2
POL,THA,2020.0,1,0,1
IDN,BFA,2022.0,1,0,1
KOR,LKA,2016.0,2,0,2
KEN,THA,2023.0,2,0,2
JPN,ZMB,2013.0,1,0,1
TGO,IND,2019.0,1,0,1
MWI,CHE,1997.0,1,0,1
TTO,MDA,2021.0,1,0,1
DNK,ECU,2023.0,1,0,1
LAO,CHE,2007.0,1,0,1
UGA,BDI,2022.0,1,0,1
CHE,PNG,2007.0,1,0,1
NIC,CHE,2004.0,1,0,1
IND,PSE,2007.0,1,0,1
NLD,HRV,1997.0,1,0,1
ETH,RWA,2011.0,1,0,1
NOR,JAM,2006.0,1,0,1
SRB,KWT,2004.0,1,0,1
GRC,ARM,2004.0,1,0,1
ITA,LAO,2006.0,1,0,1
JPN,MMR,2002.0,1,0,1
BEL,SYR,2006.0,2,0,2
BFA,DZA,2019.0,1,0,1
MUS,ZAF,2017.0,2,0,2
NPL,SGP,2017.0,1,0,1
EST,UKR,2004.0,1,0,1
ZAF,LBY,2019.0,1,0,1
SEN,NGA,2007.0,1,0,1
GRC,HKG,2001.0,1,0,1
COD,BEL,2003.0,1,0,1
BEN,NGA,2008.0,3,0,3
MSR,USA,1999.0,1,0,1
GBR,LVA,2003.0,3,0,3
LVA,NLD,2016.0,1,0,1
CIV,GIN,2004.0,1,0,1
DZA,MAR,2012.0,1,0,1
AZE,ARM,2014.0,1,0,1
WSM,,2000.0,1,0,1
ESP,SVK,2004.0,1,0,1
CYP,JPN,2019.0,1,0,1
LBY,CAN,2011.0,2,0,2
NIC,CAN,2002.0,1,0,1
SRB,MUS,2007.0,1,0,1
CAN,ISL,1998.0,1,0,1
CHL,CHN,2007.0,3,0,3
NER,MLI,2000.0,1,0,1
MDA,ITA,2013.0,1,0,1
TUN,MEX,2003.0,1,0,1
RUS,VEN,2001.0,2,0,2
COL,IRL,2013.0,1,0,1
STP,USA,2018.0,1,0,1
MUS,USA,2007.0,1,0,1
NOR,NPL,2006.0,1,0,1
REU,USA,2010.0,1,0,1
HUN,SAU,2013.0,1,0,1
CHE,EST,2005.0,1,0,1
SVK,UKR,2011.0,1,0,1
FIN,MEX,2008.0,1,0,1
,ATG,2003.0,1,0,1
KWT,CZE,2000.0,2,0,2
NOR,VEN,2007.0,1,0,1
IRL,PSE,2021.0,1,0,1
IRN,BLR,2013.0,2,0,2
CHE,MUS,2018.0,1,0,1
MAR,COG,2019.0,3,0,3
BEL,GBR,2024.0,1,0,1
LBY,LBR,2015.0,1,0,1
PRT,SVN,2022.0,1,0,1
ESP,LKA,2017.0,1,0,1
ZAF,MDG,2021.0,2,0,2
LAO,ESP,2020.0,1,0,1
PRT,UGA,2018.0,1,0,1
SDN,NLD,2018.0,1,0,1
OMN,NGA,2017.0,2,0,2
BGD,ARE,2014.0,1,0,1
JOR,IND,2022.0,3,0,3
IND,LVA,2018.0,1,0,1
JPN,PRY,2014.0,2,0,2
IRL,NGA,2020.0,1,0,1
BEL,GAB,2018.0,1,0,1
PRY,BRA,2006.0,1,0,1
CAN,BMU,2012.0,1,0,1
LVA,CZE,2023.0,1,0,1
IND,MMR,2021.0,1,0,1
,CYM,2013.0,2,0,2
PHL,BRN,2017.0,1,0,1
THA,MNG,2020.0,1,0,1
CAN,HTI,2021.0,1,0,1
PHL,BGD,1999.0,1,0,1
CHN,SOM,2020.0,1,0,1
BMU,DEU,2014.0,1,0,1
NOR,KEN,2003.0,1,0,1
FRA,MMR,2022.0,1,0,1
SWZ,ZAF,1999.0,1,0,1
EGY,DZA,2023.0,2,0,2
ROU,GIN,2021.0,1,0,1
GBR,GEO,1999.0,1,0,1
ZMB,KEN,2004.0,1,0,1
SGP,PRT,2023.0,1,0,1
GEO,PAK,2024.0,1,0,1
AZE,IRN,2005.0,1,0,1
SGP,PAK,1997.0,1,0,1
UKR,JOR,2023.0,1,0,1
PRI,DEU,2023.0,1,0,1
SOM,SDN,2023.0,1,0,1
PAN,MEX,2023.0,1,0,1
GHA,SLE,2023.0,3,0,3
LBY,OMN,2021.0,1,0,1
CYP,ARG,2010.0,1,0,1
NZL,KOR,1997.0,2,0,2
TWN,NZL,2003.0,2,0,2
JPN,BOL,2014.0,2,0,2
COL,NOR,2011.0,3,0,3
NGA,HRV,2007.0,1,0,1
NLD,MOZ,1999.0,1,0,1
KWT,DEU,2005.0,1,0,1
GBR,TJK,2004.0,1,0,1
IND,LIE,2007.0,1,0,1
AUT,TTO,2008.0,1,0,1
MAC,AUS,2003.0,1,0,1
TZA,PAK,2016.0,1,0,1
PAK,BRA,2004.0,1,0,1
ZAF,PRI,2001.0,1,0,1
QAT,IRN,2016.0,1,0,1
FRA,COM,2017.0,1,0,1
BEN,TZA,2021.0,1,0,1
MCO,CHE,2022.0,1,0,1
PER,NOR,2015.0,2,0,2
KHM,CHE,2018.0,1,0,1
BGR,CHN,2018.0,2,0,2
IND,ERI,2000.0,1,0,1
ITA,MNG,2017.0,1,0,1
DNK,OMN,2014.0,2,0,2
CUB,ECU,2012.0,1,0,1
CMR,BRA,2022.0,2,0,2
ZAF,HKG,2015.0,2,0,2
ARM,SGP,2012.0,1,0,1
CAN,LBY,2004.0,2,0,2
UGA,COD,2015.0,1,0,1
SEN,CAF,2012.0,1,0,1
LTU,JPN,2016.0,1,0,1
LBN,TUR,2024.0,1,0,1
JPN,GMB,2016.0,1,0,1
GBR,GTM,2016.0,1,0,1
GBR,GUY,2020.0,1,0,1
KOR,BLR,2017.0,1,0,1
CAN,SEN,2023.0,3,0,3
VNM,TUR,2016.0,1,0,1
UKR,PRT,2019.0,1,0,1
BWA,ZWE,2004.0,1,0,1
ABW,USA,2015.0,1,0,1
PRY,PRT,2017.0,1,0,1
PRK,CHN,2008.0,1,0,1
TUR,TWN,2015.0,1,0,1
MSR,GBR,2018.0,1,0,1
SMR,,2008.0,1,0,1
NPL,IRN,2019.0,1,0,1
ITA,GBR,2024.0,2,0,2
LBY,IRQ,2014.0,1,0,1
RUS,ARG,2018.0,1,0,1
JOR,TWN,2016.0,1,0,1
IDN,VNM,2010.0,1,0,1
DNK,MAR,2013.0,1,0,1
CHE,ISL,2002.0,1,0,1
AFG,EGY,2020.0,1,0,1
VGB,,2023.0,2,0,2
MMR,ARE,2022.0,1,0,1
NPL,FRA,2017.0,2,0,2
ZMB,NOR,2019.0,1,0,1
BLR,RUS,2024.0,1,0,1
DEU,BTN,2022.0,1,0,1
,KEN,2021.0,5,0,5
TZA,HKG,2022.0,1,0,1
PHL,LKA,2023.0,1,0,1
MAR,GIN,2022.0,1,0,1
COL,PNG,2022.0,1,0,1
LTU,TWN,2022.0,1,0,1
RUS,ALB,2007.0,1,0,1
ITA,SYC,2021.0,2,0,2
IND,IRL,1999.0,1,0,1
CHN,CAF,2011.0,1,0,1
GRC,PSE,2007.0,1,0,1
KHM,NLD,2014.0,1,0,1
NLD,BIH,2011.0,2,0,2
IDN,TWN,2007.0,1,0,1
PRT,GHA,2011.0,1,0,1
,TON,2001.0,1,0,1
FRA,LIE,2013.0,1,0,1
NOR,PER,2009.0,1,0,1
MLI,COG,2009.0,1,0,1
ESP,PSE,2005.0,1,0,1
COM,CMR,2010.0,1,0,1
CMR,CRI,2019.0,1,0,1
ARE,ZAF,2001.0,1,0,1
ROU,ZAF,1999.0,1,0,1
SVN,ZWE,2014.0,1,0,1
MNG,KAZ,2011.0,1,0,1
TWN,LTU,2011.0,1,0,1
FRA,UGA,2013.0,2,0,2
COG,BEN,2010.0,1,0,1
,ASM,1995.0,2,0,2
ASM,WSM,1999.0,1,0,1
NLD,MDG,2015.0,1,0,1
CAF,BFA,2011.0,1,0,1
WSM,IND,2017.0,1,0,1
IND,WSM,2018.0,1,0,1
THA,FIN,1998.0,1,0,1
JPN,MLT,2004.0,1,0,1
AUT,TTO,2015.0,1,0,1
FRA,JOR,2001.0,1,0,1
ITA,LBY,2008.0,3,0,3
SRB,OMN,2015.0,1,0,1
ZWE,MWI,2010.0,2,0,2
COG,ETH,2018.0,1,0,1
GEO,GRC,2002.0,1,0,1
AGO,RUS,2016.0,1,0,1
SRB,MNE,1998.0,2,0,2
UGA,SLE,2019.0,1,0,1
LCA,,2018.0,2,0,2
UKR,NGA,2009.0,1,0,1
BTN,IDN,2018.0,1,0,1
FLK,DEU,2002.0,2,0,2
BMU,AUS,2011.0,1,0,1
ZAF,MDG,2011.0,1,0,1
GHA,CIV,2009.0,1,0,1
TWN,BGR,2009.0,1,0,1
JAM,GBR,1998.0,1,0,1
FRA,RUS,2024.0,1,0,1
ESP,DOM,2005.0,1,0,1
NGA,CIV,2019.0,2,0,2
FRA,GHA,2006.0,1,0,1
BEL,SYC,2019.0,1,0,1
PHL,IND,2003.0,3,0,3
PAK,AFG,1998.0,1,0,1
AFG,,2000.0,1,0,1
HUN,DNK,2007.0,3,0,3
BEL,IDN,2002.0,1,0,1
NPL,NLD,2005.0,2,0,2
SYR,CYP,2001.0,1,0,1
KWT,CHE,2009.0,1,0,1
FRA,KHM,2005.0,1,0,1
AUT,VEN,2008.0,1,0,1
VEN,AUT,2011.0,1,0,1
BWA,ZWE,2001.0,1,0,1
GHA,TTO,2008.0,1,0,1
BGR,BRA,2020.0,2,0,2
LKA,KEN,2016.0,1,0,1
SAU,KNA,2020.0,1,0,1
GRC,LTU,2009.0,1,0,1
LBN,AUT,2014.0,1,0,1
BDI,TZA,2021.0,1,0,1
SWE,BRB,2009.0,1,0,1
EGY,MYS,2003.0,1,0,1
ZWE,DEU,2008.0,1,0,1
SYR,EGY,2009.0,1,0,1
BEL,PRY,1999.0,1,0,1
PRY,,2004.0,4,0,4
SGP,NPL,2015.0,1,0,1
NAM,NLD,2005.0,1,0,1
MDA,FRA,2009.0,1,0,1
GTM,ARG,2004.0,1,0,1
BRA,EGY,2009.0,2,0,2
BTN,DEU,2010.0,1,0,1
CAN,KNA,2010.0,1,0,1
POL,JOR,2009.0,1,0,1
GBR,PER,1999.0,5,0,5
BIH,ZAF,2020.0,1,0,1
CYP,NLD,2011.0,1,0,1
GBR,PAN,2008.0,2,0,2
NPL,PRT,2014.0,1,0,1
SVN,NOR,2009.0,1,0,1
BGD,KAZ,2016.0,1,0,1
JPN,PRY,2015.0,1,0,1
JPN,PRY,2008.0,2,0,2
ITA,TGO,2014.0,2,0,2
BIH,TUR,2009.0,1,0,1
BGR,AUS,2023.0,1,0,1
FIN,EGY,2011.0,3,0,3
HKG,JOR,2012.0,1,0,1
FIN,SGP,2004.0,2,0,2
HTI,GBR,2021.0,1,0,1
BDI,COG,2013.0,1,0,1
ETH,LBN,2017.0,1,0,1
HTI,CUB,2015.0,1,0,1
FJI,PAK,2021.0,1,0,1
UGA,NZL,2018.0,2,0,2
ESP,GEO,2018.0,1,0,1
ETH,CAN,2007.0,1,0,1
ETH,GEO,2017.0,1,0,1
MLI,ZAF,2000.0,1,0,1
ESP,IDN,2018.0,2,0,2
NLD,LKA,2022.0,1,0,1
UGA,BEN,2019.0,2,0,2
BRN,BFA,2022.0,1,0,1
IRL,OMN,2013.0,1,0,1
GNB,PRT,2021.0,1,0,1
MDA,ARM,2021.0,1,0,1
PHL,BEL,2006.0,1,0,1
TJK,NLD,2021.0,1,0,1
MYS,TUR,2003.0,1,0,1
NAM,IND,2021.0,1,0,1
ERI,IND,2022.0,1,0,1
UKR,HRV,2003.0,1,0,1
ARG,PRI,2002.0,2,0,2
PHL,ITA,2002.0,1,0,1
CAN,LVA,2009.0,1,0,1
JPN,TUN,1998.0,1,0,1
UKR,GRC,1997.0,1,0,1
ZAF,GRD,2016.0,1,0,1
LBN,RUS,2014.0,1,0,1
ISR,NCL,2006.0,1,0,1
FIN,LVA,2010.0,2,0,2
CAN,KNA,2006.0,1,0,1
POL,COL,1999.0,2,0,2
SVN,VEN,2004.0,2,0,2
CAN,GAB,2002.0,2,0,2
LBY,ARE,2006.0,1,0,1
MWI,DEU,1999.0,2,0,2
MYS,BGD,1997.0,1,0,1
POL,ARG,2020.0,1,0,1
BIH,MYS,2014.0,1,0,1
NGA,NAM,2017.0,1,0,1
FIN,PRT,2005.0,1,0,1
CMR,TZA,2013.0,1,0,1
CAN,CYM,2013.0,1,0,1
SRB,KEN,2013.0,1,0,1
NIC,GBR,2023.0,1,0,1
IRQ,OMN,2018.0,1,0,1
ESP,BOL,2003.0,2,0,2
COL,MYS,2011.0,1,0,1
MOZ,USA,1997.0,1,0,1
GMB,PHL,2007.0,1,0,1
CIV,DEU,1997.0,1,0,1
PHL,KEN,2017.0,1,0,1
DEU,CIV,2003.0,1,0,1
CAN,LAO,2019.0,2,0,2
BEL,KHM,2013.0,1,0,1
MKD,AUT,2014.0,1,0,1
SEN,TUR,2011.0,1,0,1
CYP,QAT,2013.0,1,0,1
ISR,ROU,2003.0,3,0,3
CRI,RUS,2018.0,3,0,3
MDA,DNK,2011.0,1,0,1
MWI,NZL,2000.0,1,0,1
HUN,NOR,2004.0,2,0,2
KAZ,TUR,2007.0,1,0,1
KOR,HUN,2006.0,1,0,1
OMN,BHR,2003.0,1,0,1
RUS,PAK,2010.0,1,0,1
FRA,MWI,1999.0,1,0,1
EGY,NGA,2009.0,1,0,1
KOR,QAT,2008.0,1,0,1
TWN,PRT,2014.0,2,0,2
UKR,LBY,2011.0,1,0,1
AUS,LBY,2017.0,2,0,2
TGO,GBR,2020.0,1,0,1
MNG,PNG,2020.0,1,0,1
UKR,IRQ,2016.0,1,0,1
MDG,ZAF,2018.0,1,0,1
TCD,MRT,2006.0,1,0,1
HKG,MMR,2021.0,1,0,1
ZAF,CYP,2020.0,1,0,1
ETH,JPN,1997.0,1,0,1
BRA,GEO,2018.0,2,0,2
CYP,IND,2023.0,1,0,1
KGZ,BEL,2014.0,1,0,1
ISR,UGA,2003.0,1,0,1
SGP,UKR,2014.0,1,0,1
PAN,POL,2004.0,1,0,1
AUS,MWI,2005.0,1,0,1
IND,MWI,2016.0,1,0,1
CRI,COL,2007.0,2,0,2
CHN,IDN,2010.0,1,0,1
ZAF,ARG,2014.0,3,0,3
CYP,IRL,2016.0,1,0,1
NIC,SWE,2020.0,1,0,1
USA,MOZ,2007.0,1,0,1
CHL,ROU,2008.0,1,0,1
IDN,CMR,2016.0,2,0,2
MHL,USA,2008.0,1,0,1
HTI,GIN,2016.0,2,0,2
GUY,AUS,2015.0,1,0,1
MYS,QAT,2004.0,1,0,1
HKG,TUR,2013.0,1,0,1
MLT,USA,2007.0,1,0,1
ESP,ISL,2016.0,2,0,2
KEN,GMB,2007.0,1,0,1
CHN,COG,2012.0,1,0,1
UZB,SGP,2011.0,1,0,1
CPV,,2012.0,1,0,1
MEX,NIC,2006.0,1,0,1
KOR,ZAF,1999.0,1,0,1
JOR,IRN,2018.0,3,0,3
SGP,LAO,2021.0,1,0,1
CYP,IRQ,2023.0,1,0,1
DOM,COL,2018.0,1,0,1
IRL,NPL,2023.0,1,0,1
SAU,CZE,2022.0,1,0,1
TUR,LBN,2018.0,1,0,1
UGA,JAM,2018.0,1,0,1
SWZ,EST,2021.0,1,0,1
JPN,MKD,2020.0,1,0,1
ISL,PAK,2020.0,1,0,1
BRN,THA,2001.0,1,0,1
UKR,IRL,2018.0,2,0,2
LBR,ETH,2019.0,1,0,1
MNG,TUR,2020.0,1,0,1
CIV,GHA,2021.0,1,0,1
ARE,BGD,2021.0,1,0,1
HTI,COD,2018.0,1,0,1
IND,MAC,2021.0,1,0,1
MLI,GBR,1999.0,1,0,1
,LVA,2021.0,1,0,1
JPN,COD,2023.0,3,0,3
,GUF,2020.0,6,0,6
SEN,GNB,2023.0,1,0,1
GRC,BHR,2013.0,1,0,1
BEN,ITA,2017.0,1,0,1
DZA,ZAF,2016.0,3,0,3
KNA,NZL,2017.0,1,0,1
IND,SVK,2007.0,1,0,1
PAN,NLD,2008.0,1,0,1
,VCT,2005.0,1,0,1
KEN,TZA,1999.0,3,0,3
PRT,BEN,2016.0,1,0,1
MLT,JOR,2007.0,1,0,1
NLD,GNB,2016.0,1,0,1
DEU,NPL,2006.0,1,0,1
IRL,URY,2009.0,1,0,1
FRA,MKD,2017.0,1,0,1
AUS,SVK,2019.0,1,0,1
GEO,PAK,2006.0,1,0,1
JPN,GTM,2010.0,1,0,1
BGR,YEM,2019.0,2,0,2
SEN,COL,2011.0,1,0,1
COL,SEN,2013.0,1,0,1
KOR,QAT,2014.0,2,0,2
MYS,LBN,2023.0,1,0,1
SEN,ZAF,2019.0,2,0,2
CHE,BWA,2016.0,1,0,1
IRL,VEN,2002.0,1,0,1
UKR,LTU,2013.0,1,0,1
ETH,SAU,2011.0,1,0,1
UGA,CRI,2020.0,1,0,1
SEN,IND,2013.0,1,0,1
KEN,PER,2018.0,1,0,1
FRA,COD,2018.0,1,0,1
BGR,TWN,2002.0,1,0,1
GHA,BRA,2014.0,1,0,1
COD,LAO,2015.0,1,0,1
MWI,CHN,2013.0,2,0,2
CAF,USA,2014.0,2,0,2
MCO,NOR,2021.0,1,0,1
IND,ECU,2013.0,1,0,1
NZL,ISL,2020.0,1,0,1
TUR,ETH,2018.0,1,0,1
CAF,TUN,2018.0,1,0,1
NPL,BTN,2021.0,1,0,1
CIV,BDI,2006.0,1,0,1
ITA,TZA,2016.0,3,0,3
SRB,DNK,2023.0,1,0,1
CZE,NOR,2002.0,2,0,2
GIN,BEN,2022.0,1,0,1
JOR,NLD,2022.0,2,0,2
LVA,FRA,2023.0,1,0,1
,PHL,2021.0,1,0,1
THA,SAU,2022.0,1,0,1
COL,ARM,2010.0,1,0,1
PAK,GEO,2015.0,1,0,1
FSM,,2002.0,1,0,1
AZE,ISR,2004.0,1,0,1
SHN,,2018.0,2,0,2
CYP,IRN,2001.0,2,0,2
CUB,BEL,1997.0,1,0,1
IND,COL,2003.0,1,0,1
RUS,LBN,2019.0,1,0,1
FRA,NER,1999.0,2,0,2
BHR,ARE,2000.0,1,0,1
LVA,HKG,2000.0,1,0,1
FLK,DEU,2005.0,1,0,1
CHL,SAU,2019.0,1,0,1
RUS,VNM,2004.0,1,0,1
MYS,ECU,2022.0,1,0,1
YEM,,2001.0,2,0,2
BLR,ITA,1999.0,1,0,1
DEU,KWT,2019.0,2,0,2
LKA,DEU,2009.0,2,0,2
SAU,NZL,2002.0,2,0,2
NCL,NZL,2017.0,1,0,1
SUR,,2013.0,3,0,3
UKR,CZE,2001.0,4,0,4
ESP,PRY,2000.0,1,0,1
ZAF,AFG,2010.0,1,0,1
JPN,BFA,2015.0,1,0,1
ROU,AZE,2017.0,2,0,2
ARG,ATG,2011.0,1,0,1
BEL,GHA,2018.0,1,0,1
DJI,,2009.0,1,0,1
SWE,NGA,2015.0,1,0,1
MNG,GBR,2018.0,1,0,1
UGA,SDN,2017.0,1,0,1
SRB,CHL,2016.0,1,0,1
UKR,MEX,2010.0,2,0,2
TWN,KAZ,2018.0,1,0,1
KOR,PRK,2015.0,3,0,3
AUS,GMB,2013.0,1,0,1
MLT,POL,2019.0,2,0,2
SVK,MLT,2006.0,1,0,1
TUN,HRV,2018.0,1,0,1
ITA,GLP,2020.0,1,0,1
ZMB,MOZ,2017.0,1,0,1
ROU,MEX,2017.0,1,0,1
BRN,ARE,2016.0,1,0,1
GUF,DEU,2015.0,1,0,1
ETH,QAT,2021.0,1,0,1
HRV,KHM,2020.0,1,0,1
BLR,GBR,2015.0,1,0,1
NLD,CPV,2018.0,1,0,1
JOR,AUT,2022.0,1,0,1
CZE,GHA,2018.0,1,0,1
TKM,RUS,2017.0,1,0,1
IRQ,IRL,2023.0,2,0,2
ISR,PRI,2021.0,1,0,1
CHN,PRI,2017.0,2,0,2
ZWE,AUT,2002.0,1,0,1
SRB,LBY,2022.0,1,0,1
SEN,MAR,2009.0,1,0,1
ECU,IRQ,2023.0,1,0,1
MEX,SRB,2023.0,1,0,1
ITA,NCL,2018.0,1,0,1
HKG,QAT,2017.0,1,0,1
HKG,LVA,2022.0,1,0,1
UKR,IDN,2009.0,1,0,1
COD,ZWE,2021.0,1,0,1
AZE,FIN,2022.0,1,0,1
MLT,,2001.0,2,0,2
GBR,GRD,2002.0,1,0,1
GBR,GRD,2005.0,1,0,1
GEO,AUT,2006.0,1,0,1
,SHN,2011.0,1,0,1
CHE,VNM,2002.0,2,0,2
GBR,MMR,2005.0,1,0,1
HRV,CIV,2019.0,1,0,1
MNE,,2004.0,1,0,1
TTO,IND,2022.0,1,0,1
KIR,,2019.0,2,0,2
PAK,GMB,2007.0,1,0,1
TCD,ZAF,2007.0,1,0,1
GMB,NZL,2010.0,1,0,1
HKG,PAK,2011.0,2,0,2
AUS,TUV,2005.0,1,0,1
MCO,CAN,2022.0,1,0,1
MHL,,2012.0,1,0,1
GLP,BEL,2017.0,1,0,1
NLD,TUN,2017.0,2,0,2
MDG,TZA,2023.0,1,0,1
GRC,BGR,2008.0,1,0,1
RUS,LUX,2014.0,2,0,2
DEU,ALB,2011.0,1,0,1
SVN,IRN,2004.0,1,0,1
HKG,SDN,2020.0,1,0,1
CHL,ISR,2015.0,2,0,2
AZE,TWN,2005.0,1,0,1
TWN,AZE,2016.0,1,0,1
MAR,MEX,2008.0,2,0,2
NGA,FJI,2017.0,1,0,1
SWE,MYS,1999.0,1,0,1
BEL,URY,2020.0,1,0,1
GLP,PRT,2022.0,1,0,1
KEN,ECU,2023.0,1,0,1
ESP,AGO,2019.0,1,0,1
TWN,JPN,2024.0,2,0,2
ITA,PRI,2022.0,1,0,1
SVK,GRC,2022.0,1,0,1
UZB,MYS,1999.0,1,0,1
SWE,TTO,2013.0,1,0,1
AUS,PRY,2001.0,1,0,1
IRN,CYP,2007.0,1,0,1
OMN,SYR,1999.0,1,0,1
CAN,MLI,2003.0,2,0,2
MLI,GHA,2005.0,1,0,1
AUS,FSM,2004.0,1,0,1
VEN,THA,2003.0,1,0,1
VEN,SUR,2012.0,1,0,1
COL,UKR,1997.0,1,0,1
KWT,GRC,2017.0,1,0,1
TZA,POL,2000.0,1,0,1
FIN,BGR,2008.0,1,0,1
SEN,THA,2000.0,1,0,1
SRB,JPN,2009.0,1,0,1
NAM,POL,2021.0,1,0,1
LKA,CHE,2006.0,1,0,1
SDN,ITA,2013.0,1,0,1
LUX,CHN,2008.0,1,0,1
SRB,GEO,2020.0,1,0,1
TTO,VEN,2006.0,1,0,1
VGB,,2006.0,1,0,1
ESP,IRQ,2007.0,2,0,2
TCD,USA,2004.0,1,0,1
QAT,NOR,2011.0,1,0,1
CHE,KWT,2017.0,1,0,1
DEU,SWZ,2011.0,1,0,1
CAF,NGA,2020.0,1,0,1
VIR,,2021.0,1,0,1
BIH,SAU,2022.0,1,0,1
PER,AUS,2009.0,1,0,1
VNM,MAC,2012.0,1,0,1
SYR,TUR,2017.0,2,0,2
UKR,TWN,2013.0,1,0,1
ARE,RUS,2018.0,2,0,2
SVK,ROU,2010.0,2,0,2
MAR,RUS,2018.0,1,0,1
MKD,ALB,2021.0,1,0,1
BRA,SMR,2015.0,1,0,1
CHE,BRN,2016.0,1,0,1
BRN,TWN,2018.0,1,0,1
ISR,ALB,2017.0,1,0,1
CYP,FIN,2018.0,1,0,1
GAB,CAF,2007.0,1,0,1
SLB,ARE,2016.0,1,0,1
BFA,JPN,2016.0,1,0,1
ZWE,PAK,1999.0,1,0,1
AGO,USA,2008.0,1,0,1
SWE,BWA,2000.0,1,0,1
KHM,BGD,2019.0,1,0,1
ZMB,IDN,2019.0,1,0,1
PER,MAR,2020.0,1,0,1
NZL,BLR,2020.0,1,0,1
TZA,KOR,2011.0,1,0,1
SVN,ETH,2017.0,1,0,1
BHR,BEL,2019.0,1,0,1
SEN,KEN,2006.0,1,0,1
WSM,ITA,2015.0,1,0,1
FIN,KOR,1999.0,1,0,1
DNK,LTU,2008.0,2,0,2
GAB,COD,2020.0,1,0,1
BGR,FIN,2022.0,1,0,1
,VIR,2010.0,1,0,1
NLD,PHL,2023.0,2,0,2
BEL,PRY,2020.0,1,0,1
MLT,USA,1999.0,2,0,2
KEN,IDN,2004.0,1,0,1
LVA,BIH,2023.0,1,0,1
BDI,NOR,2023.0,1,0,1
USA,SUR,2001.0,1,0,1
JPN,PAN,2000.0,1,0,1
NOR,IRL,2005.0,1,0,1
CAN,BHS,1997.0,1,0,1
CHN,POL,2004.0,1,0,1
BOL,CZE,2000.0,1,0,1
TUR,ARE,2024.0,1,0,1
UGA,PHL,2001.0,1,0,1
LUX,CHE,1999.0,1,0,1
DEU,NER,2020.0,1,0,1
QAT,KWT,1998.0,1,0,1
HRV,ARE,2022.0,1,0,1
CUB,AGO,2015.0,1,0,1
IRL,IDN,2013.0,1,0,1
KGZ,TUR,2005.0,1,0,1
CHE,VNM,2012.0,1,0,1
HKG,ARE,2024.0,1,0,1
YEM,ZAF,2019.0,1,0,1
IRN,ARE,2023.0,1,0,1
DNK,SYR,2018.0,2,0,2
NGA,SOM,2021.0,2,0,2
LKA,IRL,2021.0,1,0,1
ESP,HKG,2017.0,2,0,2
ETH,FJI,2016.0,1,0,1
CAN,TZA,2022.0,2,0,2
GEO,ESP,2021.0,1,0,1
HRV,OMN,2022.0,1,0,1
KHM,SGP,2021.0,1,0,1
BRN,TZA,2018.0,1,0,1
UKR,IND,2023.0,1,0,1
ETH,QAT,2019.0,1,0,1
SSD,LKA,2023.0,1,0,1
UZB,MEX,2010.0,1,0,1
FIN,GRD,2015.0,1,0,1
BEL,SUR,2002.0,2,0,2
MUS,KWT,2002.0,1,0,1
CAN,UGA,2002.0,3,0,3
IND,LBY,2003.0,1,0,1
IRQ,QAT,1998.0,1,0,1
GAB,CAN,2017.0,1,0,1
GAB,CAN,2022.0,2,0,2
UZB,KAZ,1999.0,2,0,2
BDI,CMR,2000.0,1,0,1
ALB,CAN,2003.0,1,0,1
FRA,PNG,1998.0,1,0,1
AUS,NAM,2014.0,1,0,1
NAM,AUS,2015.0,1,0,1
FJI,GBR,2000.0,1,0,1
AGO,EGY,2008.0,1,0,1
NCL,AUS,2006.0,2,0,2
GIN,GNB,2005.0,1,0,1
DNK,LBN,2017.0,1,0,1
YEM,CZE,2007.0,1,0,1
TZA,FRA,2017.0,1,0,1
BEL,MYS,2004.0,1,0,1
ETH,DJI,2018.0,1,0,1
ZWE,UGA,2002.0,1,0,1
LTU,CZE,2002.0,2,0,2
BDI,CAN,2002.0,1,0,1
PER,NOR,2008.0,1,0,1
KOR,BEL,1999.0,2,0,2
CRI,RUS,2016.0,2,0,2
GMB,ITA,2009.0,1,0,1
BGD,IDN,2002.0,1,0,1
IDN,SGP,2004.0,3,0,3
GEO,ESP,2011.0,1,0,1
TUR,URY,2003.0,1,0,1
GUM,ESP,2013.0,1,0,1
OMN,CYP,2007.0,1,0,1
CYP,OMN,2008.0,1,0,1
,GNQ,1994.0,1,0,1
GNQ,,2007.0,1,0,1
LTU,ESP,2008.0,2,0,2
KAZ,CHE,2005.0,1,0,1
TUR,PRT,2009.0,2,0,2
CMR,PER,2014.0,1,0,1
NLD,KOR,1999.0,1,0,1
NOR,GHA,2001.0,1,0,1
NOR,GHA,2004.0,1,0,1
SVN,DNK,2004.0,2,0,2
EST,IRL,2005.0,1,0,1
COG,DEU,2023.0,1,0,1
TWN,ERI,2006.0,1,0,1
DEU,ZMB,2009.0,1,0,1
NOR,OMN,2010.0,1,0,1
ISL,AUT,2006.0,1,0,1
ITA,ATA,2009.0,3,0,3
ATA,,2011.0,2,0,2
SWE,CUB,2004.0,2,0,2
PHL,SWE,2015.0,1,0,1
GBR,CUB,2010.0,1,0,1
USA,KGZ,2006.0,1,0,1
NZL,KWT,2012.0,1,0,1
SRB,ZMB,2011.0,1,0,1
CZE,CYP,2012.0,1,0,1
TWN,CRI,2014.0,1,0,1
NOR,KEN,2013.0,2,0,2
TUR,KWT,2014.0,1,0,1
AUS,RUS,2010.0,5,13,-8
COD,MLI,2017.0,1,2,-1
DEU,MDA,2017.0,3,4,-1
PRT,KOR,2012.0,2,4,-2
FRA,URY,2008.0,2,1,1
COG,ZAF,2011.0,2,3,-1
BGR,JPN,2014.0,3,3,0
LVA,AUT,2007.0,1,1,0
CAN,BGR,2005.0,1,3,-2
BEL,ROU,1997.0,4,1,3
JPN,PAK,1998.0,1,3,-2
CZE,UZB,2018.0,4,2,2
HRV,CAN,2019.0,3,3,0
TUN,GBR,2018.0,4,5,-1
CMR,DEU,2015.0,6,5,1
MDA,ROU,2014.0,2,2,0
MEX,IND,2000.0,1,6,-5
ARG,CZE,2020.0,3,3,0
IND,FJI,2004.0,3,2,1
UGA,JPN,2002.0,1,1,0
POL,CHN,2000.0,2,3,-1
CAF,USA,2009.0,1,1,0
HUN,TUR,2019.0,3,1,2
TWN,CZE,2013.0,4,1,3
EGY,CHE,2023.0,4,1,3
USA,BIH,2020.0,2,6,-4
CAN,MAC,2019.0,1,2,-1
PSE,CAN,2023.0,1,3,-2
KAZ,ITA,2020.0,1,2,-1
LAO,FRA,2016.0,3,6,-3
MAR,ZAF,2020.0,3,5,-2
ISR,TWN,2022.0,1,6,-5
IND,RUS,2024.0,1,1,0
KOR,PHL,2010.0,2,2,0
MMR,THA,2023.0,6,3,3
KOR,RUS,2023.0,2,7,-5
TGO,FRA,2020.0,5,7,-2
BWA,GBR,2023.0,1,2,-1
TGO,BEN,2017.0,2,1,1
LUX,CZE,2022.0,2,2,0
MNG,CHN,2019.0,3,18,-15
SDN,JPN,2022.0,1,2,-1
MAR,CMR,2023.0,1,2,-1
FRA,CUB,2023.0,2,2,0
GBR,YEM,2022.0,1,6,-5
UKR,SVK,2019.0,6,3,3
NLD,EST,2023.0,2,2,0
BIH,SVN,2022.0,1,1,0
VEN,COL,2023.0,3,5,-2
AUS,OMN,2007.0,2,3,-1
AFG,MYS,2022.0,2,3,-1
BEL,GAB,2007.0,1,1,0
DEU,ALB,2008.0,1,3,-2
IND,SAU,1998.0,3,15,-12
SVN,ITA,2005.0,2,1,1
ESP,BGR,2016.0,3,1,2
BGR,ESP,2017.0,1,2,-1
FRA,LUX,2001.0,6,8,-2
LTU,GBR,2009.0,4,2,2
SRB,GBR,2008.0,6,17,-11
BHR,GBR,2016.0,5,6,-1
ROU,CHE,2014.0,3,5,-2
GBR,CMR,2006.0,2,3,-1
GRC,MLT,2013.0,1,1,0
LUX,GRC,2013.0,1,2,-1
USA,MKD,2017.0,4,3,1
DEU,VEN,2001.0,2,6,-4
BEL,LTU,2013.0,2,2,0
CAN,NGA,2007.0,1,4,-3
JPN,MEX,2004.0,3,1,2
RUS,IRQ,2011.0,2,1,1
ESP,ARM,2019.0,1,1,0
FRA,TGO,2010.0,3,3,0
NGA,CAN,1997.0,1,1,0
TZA,USA,2001.0,4,6,-2
DNK,GRL,2010.0,2,1,1
IRL,CHL,2008.0,1,1,0
NZL,BWA,2004.0,1,1,0
NOR,EST,2014.0,1,2,-1
UKR,KOR,2013.0,1,2,-1
GBR,LBN,2005.0,6,3,3
BRN,BWA,2010.0,1,1,0
PSE,ISR,2004.0,8,8,0
LBY,GBR,2015.0,4,12,-8
BEL,TUR,2004.0,3,3,0
TUR,AUT,2004.0,1,2,-1
TZA,SWE,1999.0,5,1,4
VNM,CAN,2005.0,1,1,0
GRC,ESP,2006.0,7,13,-6
TWN,PAK,2011.0,1,1,0
URY,GBR,2000.0,2,1,1
PNG,USA,2010.0,2,1,1
TGO,FRA,1999.0,7,1,6
PNG,CHE,2012.0,1,4,-3
BRB,JAM,2014.0,1,1,0
CHN,POL,2009.0,2,2,0
IRL,CHN,2000.0,2,3,-1
PRT,CHE,1998.0,3,3,0
CUB,ITA,2002.0,5,3,2
ISR,BRA,2020.0,2,9,-7
CAN,SVK,2005.0,1,1,0
CHE,CZE,1998.0,3,8,-5
AUS,LBN,2017.0,3,2,1
NIC,DNK,2012.0,1,1,0
USA,BRB,2015.0,3,3,0
ZAF,SWZ,2013.0,2,1,1
MAR,EGY,2019.0,1,1,0
ISR,NOR,2023.0,1,1,0
KOR,SDN,2014.0,2,3,-1
CAN,BFA,2020.0,3,2,1
COD,USA,2019.0,5,8,-3
QAT,ZAF,2021.0,2,3,-1
CHE,VEN,2012.0,2,2,0
PER,CAN,2014.0,1,2,-1
PRT,UKR,2013.0,1,1,0
ROU,SWE,2021.0,1,1,0
MLI,USA,2023.0,2,1,1
JPN,ARE,2014.0,2,1,1
DEU,LKA,2021.0,4,4,0
BHR,IRL,2012.0,2,5,-3
BRA,CUB,2023.0,3,1,2
KEN,GHA,2014.0,2,2,0
KOR,CZE,2015.0,3,3,0
SRB,QAT,2018.0,2,5,-3
USA,SYR,2013.0,1,8,-7
AUS,LBN,2016.0,3,4,-1
HUN,ARE,2020.0,2,2,0
CZE,ARE,2020.0,3,2,1
PAK,DNK,2014.0,1,2,-1
IRL,BHR,2018.0,4,3,1
ZAF,CZE,2010.0,1,1,0
VNM,CHN,2007.0,1,1,0
ITA,BGD,2017.0,3,2,1
GBR,CMR,2023.0,2,4,-2
DEU,BEN,2015.0,1,1,0
ARE,IND,2007.0,5,8,-3
ALB,DEU,2016.0,1,2,-1
NZL,NPL,2016.0,2,1,1
AUS,PNG,2014.0,7,7,0
TWN,POL,2014.0,2,2,0
HUN,BGR,2021.0,2,1,1
ESP,SGP,2021.0,6,7,-1
UGA,SDN,2020.0,2,1,1
ETH,FIN,2019.0,1,2,-1
KEN,ITA,2021.0,4,2,2
ESP,MOZ,2003.0,1,1,0
PAK,TZA,2019.0,1,1,0
SWE,LVA,2022.0,2,2,0
MYS,ROU,2022.0,1,1,0
CZE,CHL,2020.0,3,1,2
NZL,BRA,2023.0,3,5,-2
TWN,MEX,2019.0,1,3,-2
GRC,JPN,2016.0,4,2,2
MEX,IND,2023.0,5,8,-3
KWT,ARE,2010.0,2,2,0
SWE,OMN,2021.0,1,1,0
ZAF,LSO,2023.0,3,2,1
HUN,ISR,2017.0,1,3,-2
ITA,VEN,2018.0,2,5,-3
UGA,CHN,2021.0,2,2,0
CAN,SRB,2016.0,3,4,-1
TUR,IRN,2015.0,8,21,-13
SRB,BEL,2018.0,2,4,-2
MYS,PHL,2018.0,2,2,0
MLT,IRL,2019.0,1,3,-2
SVK,FRA,2020.0,3,8,-5
UGA,BEL,2009.0,2,1,1
LUX,CHE,2022.0,3,8,-5
NLD,KHM,2019.0,1,1,0
WSM,ASM,2021.0,1,1,0
LBR,NGA,2018.0,2,5,-3
GTM,ESP,2022.0,1,4,-3
ARE,KOR,2022.0,5,14,-9
BEL,COL,1997.0,1,1,0
IRL,ISR,2023.0,3,1,2
EGY,NZL,2019.0,2,1,1
FRA,NER,2022.0,4,1,3
TUN,MAR,2023.0,2,2,0
NLD,TZA,2003.0,3,1,2
USA,ZWE,2009.0,8,13,-5
MEX,CZE,2004.0,1,3,-2
VEN,CAN,2010.0,7,2,5
PER,SWE,2012.0,2,1,1
SRB,SWE,2001.0,1,2,-1
COL,CAN,2005.0,1,3,-2
ESP,AND,2006.0,6,2,4
NZL,HKG,2000.0,4,3,1
ESP,IRL,1997.0,1,1,0
ECU,PER,2008.0,1,2,-1
IRL,NZL,2009.0,5,5,0
FIN,ARG,2002.0,1,1,0
RUS,HKG,2016.0,2,5,-3
BRA,PRY,2008.0,3,2,1
BGD,MYS,2001.0,5,4,1
NAM,ZAF,2000.0,2,1,1
IRN,AUS,2001.0,2,17,-15
EGY,QAT,2001.0,2,5,-3
MKD,DEU,2018.0,3,1,2
SEN,BEL,2015.0,1,1,0
PAK,NLD,2016.0,4,17,-13
DEU,OMN,2012.0,3,1,2
MOZ,BRA,2008.0,2,1,1
AUT,LTU,2010.0,2,1,1
ISR,POL,2020.0,2,8,-6
ITA,LBN,2013.0,3,3,0
MEX,CUB,2022.0,3,28,-25
JPN,GEO,2019.0,1,1,0
URY,CHL,2022.0,4,6,-2
DNK,GHA,2014.0,3,1,2
ZWE,NLD,2021.0,1,2,-1
PAK,AFG,2016.0,1,1,0
PYF,USA,2016.0,1,1,0
USA,VIR,2014.0,3,2,1
VNM,ESP,2020.0,2,2,0
UZB,KOR,2015.0,2,1,1
BGR,EGY,2017.0,1,1,0
PSE,BEL,2015.0,2,2,0
LTU,ITA,2018.0,5,6,-1
ESP,ALB,2017.0,2,1,1
GHA,IND,2016.0,1,2,-1
GHA,IND,2022.0,3,4,-1
PER,ITA,2019.0,2,2,0
RWA,BEL,2016.0,4,5,-1
FRA,SRB,2017.0,5,11,-6
IND,JAM,2015.0,1,1,0
CMR,GHA,2019.0,2,1,1
EGY,PRT,2021.0,1,3,-2
CMR,ITA,2016.0,3,9,-6
KOR,ECU,2019.0,3,1,2
ECU,CHN,2020.0,2,1,1
CMR,IND,2017.0,1,2,-1
MNE,HRV,2020.0,1,3,-2
USA,MOZ,2022.0,4,11,-7
IND,POL,2014.0,9,2,7
COD,CMR,2022.0,1,2,-1
CZE,NZL,2015.0,2,4,-2
CHE,SWZ,2019.0,5,7,-2
KGZ,USA,2008.0,1,2,-1
IRN,ISR,2014.0,1,1,0
JOR,OMN,2017.0,4,1,3
ITA,BGR,2012.0,2,3,-1
ZAF,MLI,2009.0,1,1,0
PSE,EGY,2009.0,2,1,1
ISR,CHN,1997.0,3,2,1
LVA,USA,2021.0,2,3,-1
SVK,DNK,2006.0,1,1,0
FRA,LTU,2008.0,1,4,-3
SAU,POL,2015.0,1,1,0
CMR,ZAF,2009.0,5,5,0
JPN,CMR,2007.0,2,2,0
KGZ,USA,2015.0,1,1,0
NOR,POL,2009.0,2,5,-3
CHN,TUN,2017.0,1,3,-2
VNM,AUS,2007.0,3,7,-4
KOR,NPL,2009.0,2,3,-1
HUN,GRC,2003.0,1,1,0
MWI,KEN,2015.0,2,1,1
BGR,DNK,2007.0,2,1,1
AUT,BGR,2007.0,2,1,1
COL,ECU,2008.0,3,1,2
AUT,THA,2004.0,4,2,2
KGZ,RUS,2007.0,2,3,-1
BEL,CIV,2007.0,1,1,0
UKR,MDA,2007.0,2,6,-4
NOR,EST,2004.0,1,1,0
KHM,SGP,2014.0,1,1,0
SRB,FIN,2007.0,2,1,1
ARE,ZAF,2019.0,4,5,-1
IRL,IRN,2007.0,2,2,0
CRI,ITA,2014.0,1,1,0
IDN,BEL,2013.0,2,1,1
TZA,FIN,2018.0,1,2,-1
CZE,HUN,2016.0,1,7,-6
PAK,ZAF,2013.0,2,4,-2
BGD,ESP,2019.0,2,4,-2
ISR,BRA,2007.0,2,1,1
SEN,CHE,2015.0,1,3,-2
SVN,CHN,2013.0,4,1,3
GBR,LTU,2016.0,5,12,-7
LBY,CAN,2014.0,2,2,0
RUS,SVK,2018.0,3,3,0
MLI,CHN,2017.0,1,1,0
HKG,HUN,2018.0,1,1,0
EST,UKR,2021.0,1,2,-1
GEO,CAN,2020.0,1,1,0
THA,BTN,2019.0,2,4,-2
POL,CHN,2010.0,2,3,-1
BEL,TWN,2002.0,1,1,0
CMR,JPN,2017.0,2,1,1
BRN,MYS,1999.0,1,1,0
TWN,MAC,2012.0,4,1,3
EGY,AUT,2009.0,3,4,-1
MYS,BHR,2014.0,3,2,1
MEX,HUN,2021.0,4,2,2
FRA,KWT,2021.0,5,2,3
MYS,AUT,2014.0,2,2,0
EGY,HUN,2003.0,2,1,1
GBR,CHE,2024.0,1,1,0
CHL,VEN,2019.0,2,21,-19
MYS,RUS,2022.0,1,1,0
PRT,CAN,2013.0,11,8,3
FRA,NER,2017.0,3,2,1
MMR,JPN,2004.0,2,4,-2
MYS,PAK,2005.0,2,2,0
IND,BLR,2009.0,1,1,0
ROU,TUR,2006.0,2,1,1
GHA,DNK,2018.0,3,3,0
HUN,KWT,1998.0,1,1,0
SGP,ITA,2007.0,2,6,-4
DEU,PHL,2018.0,2,6,-4
DNK,POL,2009.0,5,7,-2
FRA,BLR,2002.0,3,8,-5
SAU,YEM,2009.0,1,1,0
JAM,NGA,2011.0,1,1,0
FIN,UKR,2004.0,1,3,-2
ROU,BEL,2004.0,3,3,0
ESP,EST,2008.0,1,1,0
IRN,FRA,2000.0,1,4,-3
ZMB,NOR,2004.0,1,1,0
GRC,IRL,2009.0,4,2,2
SWE,TZA,2000.0,2,5,-3
USA,MDG,2015.0,5,3,2
BEL,TZA,2002.0,1,1,0
CAN,MYS,2003.0,2,4,-2
THA,AUS,1997.0,2,11,-9
DEU,LTU,2011.0,2,9,-7
ZMB,ZWE,2011.0,3,2,1
PAN,CAN,2001.0,2,1,1
GRC,CHN,2012.0,4,5,-1
IRN,EGY,2008.0,2,1,1
IDN,HKG,2007.0,1,1,0
NGA,CIV,2001.0,1,1,0
SWE,NZL,1998.0,3,2,1
SWE,PER,2021.0,1,1,0
GEO,ITA,1999.0,1,1,0
ZAF,TZA,2000.0,1,7,-6
PHL,ESP,2004.0,4,5,-1
ISR,BRA,1998.0,2,1,1
EST,FIN,2005.0,3,6,-3
NLD,SVK,2018.0,2,1,1
USA,KHM,2009.0,3,6,-3
UZB,FRA,2012.0,1,1,0
NZL,SRB,2007.0,1,1,0
CZE,GRC,2012.0,1,3,-2
USA,BWA,2008.0,7,8,-1
CHE,SVN,2022.0,4,11,-7
GMB,NGA,2009.0,1,1,0
PNG,AUS,2023.0,1,2,-1
DEU,ECU,2006.0,1,1,0
CMR,GHA,2009.0,1,3,-2
PER,PRT,2022.0,1,2,-1
IND,BTN,2006.0,1,1,0
DEU,KWT,2004.0,3,2,1
USA,BOL,2013.0,5,1,4
HKG,CHE,2012.0,5,2,3
DZA,ESP,2015.0,2,6,-4
DEU,SVN,1999.0,4,5,-1
PRT,POL,2014.0,2,9,-7
COL,JPN,2013.0,3,5,-2
COD,CAN,2023.0,2,2,0
DEU,CYP,2008.0,5,1,4
ESP,PAN,2014.0,2,3,-1
EST,NLD,2018.0,4,4,0
LVA,SWE,2012.0,4,5,-1
ROU,IND,2023.0,5,5,0
AUS,BHS,2015.0,1,1,0
BHS,AUS,2016.0,1,1,0
HKG,IND,2015.0,3,16,-13
DEU,GHA,2005.0,2,1,1
HKG,IRL,2006.0,1,1,0
NZL,BEL,2003.0,2,6,-4
BOL,USA,2021.0,7,3,4
BGR,POL,2023.0,2,1,1
ARG,SLV,2009.0,1,1,0
RUS,CRI,2012.0,2,2,0
GRC,BGD,2022.0,1,1,0
PER,CHE,2022.0,1,1,0
IRN,AUT,2002.0,2,1,1
SGP,IRL,2002.0,2,1,1
VNM,ETH,2021.0,1,2,-1
ZAF,IRL,2010.0,3,3,0
VNM,NOR,2011.0,1,4,-3
CUB,USA,1999.0,2,3,-1
DEU,EST,2023.0,2,6,-4
SWE,TZA,2006.0,3,1,2
HKG,DEU,2001.0,5,8,-3
ARG,AUT,1999.0,3,2,1
FIN,IRN,2008.0,1,1,0
GBR,PRI,2007.0,2,1,1
DEU,CRI,2001.0,2,1,1
HTI,USA,2008.0,3,1,2
CHN,ESP,2005.0,2,1,1
HUN,AUS,2005.0,3,3,0
LVA,SWE,1997.0,3,3,0
USA,SEN,2004.0,2,1,1
TTO,CAN,2008.0,2,1,1
BGR,HUN,2000.0,2,1,1
KOR,IND,1997.0,1,2,-1
USA,GMB,2005.0,1,3,-2
SWE,SAU,2000.0,2,2,0
NLD,ZWE,2004.0,2,4,-2
NOR,KOR,2014.0,1,3,-2
BWA,USA,2023.0,6,6,0
ROU,IRL,2011.0,3,1,2
UKR,MEX,2003.0,4,2,2
PHL,FRA,1997.0,1,2,-1
SGP,THA,1999.0,1,2,-1
ECU,MEX,2008.0,1,1,0
CAN,BFA,1999.0,1,2,-1
COL,IND,2020.0,1,2,-1
GAB,ZAF,2018.0,1,1,0
LTU,LUX,2013.0,1,1,0
MEX,AUT,2011.0,1,2,-1
ROU,CZE,2007.0,1,2,-1
JAM,ZAF,2009.0,1,1,0
COG,FRA,2002.0,5,2,3
SDN,QAT,2018.0,2,1,1
DNK,NZL,2010.0,2,6,-4
AUT,MKD,2017.0,2,2,0
BEL,HKG,2011.0,1,2,-1
GIN,MLI,2021.0,2,3,-1
SGP,BRN,2017.0,2,1,1
DZA,TUN,2017.0,3,4,-1
FRO,DNK,2010.0,2,4,-2
CYP,NLD,2015.0,1,1,0
GTM,ESP,2018.0,2,2,0
BRA,HUN,2016.0,2,2,0
PAK,BRA,2019.0,6,10,-4
KEN,NZL,2017.0,1,2,-1
KEN,AUS,2023.0,4,2,2
PAN,COL,2016.0,2,2,0
URY,BRA,2019.0,11,15,-4
IRQ,PAK,2012.0,1,1,0
LBY,GBR,2014.0,3,12,-9
IND,GRC,2018.0,3,2,1
ESP,SRB,2020.0,1,6,-5
AUT,ZAF,1998.0,2,2,0
GAB,CMR,2010.0,1,1,0
GRC,FIN,2011.0,2,3,-1
UKR,CZE,2009.0,4,1,3
RUS,MDA,2018.0,4,4,0
FIN,GRC,2020.0,3,6,-3
BHR,JOR,2021.0,2,3,-1
VEN,COL,2000.0,2,2,0
MYS,BRN,2009.0,2,1,1
ZAF,EGY,2008.0,1,1,0
PNG,GIN,2021.0,3,1,2
BRA,AGO,2021.0,4,2,2
PAK,JPN,2017.0,1,10,-9
USA,PAN,2001.0,4,12,-8
HUN,KOR,2020.0,1,2,-1
MUS,GBR,2021.0,3,2,1
KWT,AUS,2013.0,2,3,-1
PAK,NPL,2015.0,2,1,1
SWE,GRC,2016.0,6,27,-21
ITA,VNM,2018.0,6,1,5
ROU,SGP,2023.0,1,1,0
USA,COD,2021.0,8,4,4
NLD,ZWE,2001.0,1,2,-1
CAN,OMN,2021.0,8,5,3
CRI,DEU,2009.0,2,2,0
FRO,DNK,2023.0,4,3,1
PRT,TUR,2016.0,2,1,1
POL,ISR,2023.0,2,4,-2
USA,SDN,2019.0,4,4,0
GHA,HKG,2016.0,3,1,2
EGY,FRA,2002.0,2,5,-3
PAK,NLD,2022.0,1,9,-8
LBN,EGY,2005.0,2,1,1
NGA,BEN,2022.0,3,2,1
EST,RUS,2023.0,2,7,-5
ZAF,JPN,1999.0,2,1,1
AUS,CHL,2003.0,2,3,-1
BEL,CUB,2004.0,2,1,1
ARE,BRB,2005.0,1,1,0
MRT,FRA,2014.0,1,2,-1
NZL,JPN,2017.0,4,2,2
COG,GBR,2016.0,1,2,-1
ROU,RUS,2002.0,3,1,2
CAN,VEN,2008.0,2,6,-4
USA,ETH,2008.0,4,4,0
SAU,BHR,2010.0,3,1,2
TUR,PRT,2004.0,2,1,1
ETH,IND,2007.0,4,7,-3
ISL,AUS,2012.0,1,5,-4
BRN,IND,2009.0,2,2,0
AUS,GUM,2000.0,1,1,0
BEN,GBR,1997.0,1,1,0
FRA,PER,2015.0,10,2,8
ITA,ETH,2013.0,1,2,-1
KEN,BWA,2020.0,1,4,-3
MAC,HKG,2012.0,3,21,-18
PRY,BRA,2013.0,1,5,-4
CAN,RWA,2021.0,1,4,-3
GRC,AUT,2016.0,3,4,-1
MAR,BEL,2012.0,2,10,-8
HUN,TUR,2009.0,4,1,3
OMN,ARE,2004.0,3,5,-2
CAN,COG,2018.0,2,1,1
NOR,BGD,2018.0,1,4,-3
ESP,PHL,2010.0,2,2,0
BOL,FRA,2013.0,4,2,2
DEU,ZWE,2013.0,1,1,0
ZWE,KEN,2017.0,1,1,0
MLT,ITA,2014.0,1,5,-4
TUR,EGY,2013.0,2,1,1
NZL,CZE,2017.0,3,2,1
HRV,SWE,2022.0,2,2,0
PRT,MAC,2023.0,2,1,1
ITA,SRB,2013.0,5,5,0
LVA,NLD,2020.0,1,3,-2
SAU,DEU,2013.0,4,27,-23
TUR,ISR,2009.0,1,6,-5
JPN,MEX,2008.0,5,3,2
CHL,IND,2019.0,4,12,-8
CRI,ESP,2004.0,1,4,-3
IND,LKA,2004.0,3,4,-1
BGD,HKG,2014.0,2,1,1
COG,USA,2011.0,4,5,-1
PHL,TWN,2016.0,3,6,-3
BLR,GBR,2019.0,2,1,1
JAM,TTO,2002.0,3,2,1
OMN,FRA,2004.0,1,1,0
THA,AUT,2000.0,3,4,-1
TUR,UKR,2001.0,5,6,-1
CHE,UKR,2004.0,2,4,-2
TZA,GBR,2014.0,7,18,-11
BEL,TUN,1999.0,2,1,1
DEU,CUB,2012.0,1,6,-5
FIN,POL,2000.0,3,5,-2
HUN,PRT,2002.0,1,1,0
UKR,NLD,2003.0,3,4,-1
NZL,BRA,2010.0,3,5,-2
JPN,LAO,2011.0,2,2,0
LKA,DEU,2015.0,4,1,3
USA,ETH,2004.0,9,5,4
TUR,SWE,2002.0,1,4,-3
AUS,GRC,2005.0,1,1,0
ITA,TUN,2002.0,2,2,0
LBY,CAN,2015.0,2,4,-2
MKD,HRV,2009.0,1,1,0
BRA,SAU,2019.0,2,2,0
PNG,CHE,2005.0,2,1,1
ROU,HUN,2004.0,2,4,-2
LBN,CAN,2003.0,2,5,-3
GBR,BGR,2008.0,5,8,-3
PRT,AUT,2003.0,2,4,-2
OMN,BGD,2016.0,1,2,-1
SAU,QAT,2005.0,1,1,0
JAM,AUS,2013.0,1,1,0
AUT,ZAF,1999.0,3,2,1
KOR,NZL,2005.0,1,4,-3
SWE,GHA,2010.0,1,2,-1
NOR,JPN,2004.0,3,5,-2
CHE,CHN,2000.0,3,13,-10
CHN,PRT,1998.0,3,1,2
GBR,SYR,1999.0,4,1,3
HKG,JPN,2006.0,5,6,-1
BGR,CAN,2021.0,1,2,-1
PHL,IND,2010.0,3,3,0
PER,BRA,2000.0,3,4,-1
NZL,LUX,2023.0,1,1,0
ZAF,GHA,2007.0,2,1,1
MDG,FRA,1999.0,5,3,2
ITA,DZA,2008.0,1,1,0
IDN,FRA,2016.0,5,15,-10
BEL,COL,2002.0,2,1,1
MKD,USA,2010.0,4,10,-6
HRV,ITA,2009.0,2,2,0
USA,MLI,2011.0,5,1,4
BRN,SGP,2008.0,1,1,0
SAU,THA,2021.0,1,1,0
AUT,ETH,2009.0,3,1,2
ETH,NLD,2011.0,4,4,0
LUX,NLD,2011.0,2,5,-3
LAO,CHE,2022.0,1,1,0
RUS,GHA,2020.0,3,2,1
LUX,PRT,2014.0,1,4,-3
PRY,CZE,2011.0,1,4,-3
MEX,BEL,2007.0,2,2,0
ARG,PRT,2011.0,3,2,1
SWE,ISR,2004.0,2,1,1
MEX,CRI,2017.0,3,4,-1
BRA,AUT,2004.0,4,2,2
EST,RUS,2010.0,4,4,0
DNK,TWN,2011.0,3,1,2
IND,ETH,2009.0,3,6,-3
EGY,BGR,2017.0,1,1,0
MAR,KWT,2022.0,1,1,0
EGY,BHR,2009.0,1,2,-1
PHL,BEL,2013.0,1,1,0
NGA,JPN,2011.0,9,8,1
DEU,MDA,2016.0,2,4,-2
NLD,TTO,2001.0,1,2,-1
UZB,ISR,2009.0,1,1,0
NLD,VEN,2017.0,1,1,0
MEX,THA,2019.0,1,1,0
CAN,BGR,2012.0,1,3,-2
ISR,MEX,2000.0,3,3,0
POL,MEX,2012.0,2,3,-1
MEX,DNK,2000.0,2,3,-1
SRB,KWT,2019.0,2,2,0
OMN,EGY,2016.0,6,6,0
CZE,MEX,2000.0,1,2,-1
TUR,MEX,2009.0,2,3,-1
USA,NCL,2010.0,1,2,-1
NZL,MEX,2007.0,1,3,-2
MNE,ITA,2016.0,1,1,0
IRL,NGA,2018.0,2,1,1
FRA,TCD,2008.0,1,1,0
TCD,FRA,2009.0,1,1,0
AUS,GRC,2002.0,3,2,1
ISL,ESP,2017.0,3,1,2
BRA,PRY,2015.0,3,1,2
CUB,RUS,2016.0,1,1,0
MYS,PSE,2019.0,6,2,4
ESP,IRQ,2018.0,1,1,0
CHN,AUT,2023.0,6,24,-18
FIN,VNM,2019.0,2,1,1
CHN,BLR,2020.0,3,2,1
LKA,KOR,2018.0,3,4,-1
TJK,CHN,2019.0,1,3,-2
RWA,CAN,2020.0,3,4,-1
MAR,ARE,2020.0,3,7,-4
CRI,DEU,2019.0,4,7,-3
FIN,ARG,2005.0,2,1,1
MEX,HND,2019.0,1,1,0
KOR,CHN,2024.0,6,3,3
MLI,CIV,2022.0,2,2,0
MKD,AUT,2021.0,1,1,0
USA,NIC,2020.0,1,2,-1
TZA,IND,2023.0,2,2,0
SWE,URY,2021.0,1,1,0
AUT,HKG,2020.0,2,2,0
SRB,HRV,2022.0,6,5,1
IDN,CAN,2010.0,2,3,-1
KWT,SAU,2016.0,2,5,-3
AUS,KAZ,2016.0,3,2,1
KEN,ESP,2020.0,5,4,1
BEL,BDI,2023.0,2,1,1
COL,SWE,2018.0,3,8,-5
JAM,GBR,2022.0,1,2,-1
KEN,SDN,2020.0,1,2,-1
TWN,POL,2008.0,3,1,2
SVN,ITA,2002.0,1,5,-4
SAU,KWT,2017.0,8,4,4
MLI,CIV,2018.0,2,3,-1
AUS,RUS,2023.0,2,12,-10
CHL,FIN,2002.0,1,2,-1
HRV,NZL,2019.0,1,1,0
VNM,BLR,2022.0,1,1,0
BFA,ITA,2006.0,1,2,-1
DEU,BFA,2006.0,1,2,-1
URY,ARG,2008.0,4,7,-3
JOR,SAU,2000.0,2,1,1
HKG,PHL,2016.0,4,4,0
ARG,DZA,2018.0,1,1,0
POL,FIN,2003.0,4,4,0
LTU,NOR,2000.0,3,3,0
PSE,ISR,2001.0,2,19,-17
LTU,DEU,2002.0,2,9,-7
CYP,GRC,2011.0,9,34,-25
DEU,GEO,2001.0,4,3,1
OMN,NLD,1999.0,1,1,0
CHE,MAR,2000.0,1,1,0
GRC,BGR,2009.0,5,1,4
JOR,TUR,1998.0,1,1,0
SGP,CHL,2021.0,2,1,1
IRL,IRN,1999.0,1,2,-1
DNK,NZL,2000.0,1,2,-1
FRA,GAB,2005.0,3,3,0
JPN,IRN,1997.0,2,1,1
SWE,CHL,1998.0,2,2,0
JPN,HKG,2005.0,6,6,0
GBR,SVN,1999.0,4,3,1
MDA,DEU,2021.0,4,2,2
DEU,MDA,2022.0,4,3,1
ARM,TWN,2008.0,1,1,0
ALB,ITA,2005.0,1,2,-1
BGD,SWE,2015.0,3,4,-1
VEN,SWE,2019.0,1,2,-1
TWN,HUN,2015.0,3,2,1
TUR,IRQ,2014.0,3,1,2
SAU,NPL,2021.0,1,1,0
KEN,MOZ,2017.0,1,2,-1
HRV,KOR,2019.0,1,3,-2
ISR,HRV,2011.0,1,1,0
SGP,VNM,2012.0,3,1,2
CMR,CHE,2010.0,1,7,-6
CHE,LUX,2005.0,3,1,2
CRI,GBR,2018.0,3,3,0
CHE,KEN,2022.0,4,6,-2
RUS,GRC,2012.0,2,2,0
ISR,HUN,2015.0,5,2,3
SAU,YEM,2011.0,1,1,0
ARE,TUN,2021.0,4,10,-6
CMR,CAN,2012.0,3,2,1
ZAF,BEN,2015.0,3,1,2
MEX,UKR,2020.0,1,2,-1
NZL,EGY,2018.0,1,3,-2
TUR,MLT,2018.0,1,1,0
ZAF,COL,2013.0,2,1,1
KOR,IRN,2010.0,1,5,-4
BGD,EGY,2013.0,1,1,0
IRN,EGY,2015.0,1,1,0
URY,MEX,2018.0,3,5,-2
ITA,SMR,2023.0,1,5,-4
BRA,BEN,2016.0,1,1,0
NPL,CZE,2018.0,1,1,0
ECU,KOR,2019.0,1,3,-2
MKD,DEU,2022.0,2,3,-1
KAZ,KOR,2022.0,6,1,5
COL,CZE,2023.0,1,3,-2
BRA,BGR,2019.0,2,1,1
USA,NCL,2023.0,5,5,0
ETH,BRA,2019.0,1,1,0
OMN,NZL,2010.0,1,2,-1
THA,ZAF,2018.0,1,2,-1
ESP,PRI,2018.0,2,7,-5
ZMB,JPN,2006.0,3,2,1
IRL,RUS,2017.0,2,5,-3
EGY,NZL,2011.0,1,2,-1
BEL,BFA,2007.0,3,2,1
AUT,ETH,2011.0,4,3,1
KOR,ETH,2013.0,2,2,0
SRB,BIH,2003.0,3,4,-1
DEU,MWI,2010.0,2,1,1
COG,USA,2009.0,5,6,-1
SVN,IRL,2006.0,1,1,0
IRL,ROU,2008.0,1,4,-3
ROU,IRL,2009.0,1,2,-1
TUR,ESP,2004.0,2,3,-1
ESP,TUR,2009.0,4,6,-2
BEL,FIN,2008.0,2,5,-3
RUS,COL,2000.0,2,1,1
PER,JPN,2018.0,1,4,-3
PHL,CHN,2008.0,3,1,2
SAU,SGP,2020.0,3,8,-5
DEU,NLD,2024.0,2,1,1
SVK,CHN,2021.0,2,2,0
IND,KWT,2022.0,6,1,5
HUN,ETH,2021.0,2,2,0
LBN,SWE,2022.0,4,1,3
MAC,PRT,2023.0,1,2,-1
MNG,RUS,2021.0,1,3,-2
PSE,MAR,2020.0,1,1,0
HKG,NGA,2018.0,3,3,0
CZE,MEX,2023.0,1,3,-2
BGR,CHE,2022.0,2,4,-2
IDN,HKG,2020.0,2,1,1
DNK,CYP,2021.0,2,1,1
IRQ,GBR,2004.0,4,2,2
HTI,USA,2004.0,5,3,2
MLI,SEN,2007.0,1,2,-1
ISR,POL,1998.0,3,4,-1
AUT,IRL,2006.0,4,3,1
LUX,FIN,2009.0,1,1,0
CHE,NZL,1999.0,3,2,1
BEL,ROU,2002.0,2,13,-11
AUT,NOR,1998.0,2,6,-4
KEN,AUS,2000.0,2,2,0
ROU,RUS,1997.0,1,1,0
SVK,FRA,1999.0,3,3,0
SGP,LKA,2011.0,1,1,0
ZAF,ARE,2002.0,1,1,0
IND,BHR,2010.0,3,2,1
DEU,GAB,2012.0,1,5,-4
BEL,KEN,2021.0,2,8,-6
CHE,KHM,2015.0,1,1,0
IRL,SVK,2006.0,1,1,0
USA,BLZ,2015.0,1,3,-2
ESP,KOR,1998.0,2,2,0
LBN,CHE,2013.0,1,4,-3
CHN,MYS,2001.0,1,2,-1
COG,ZWE,2022.0,2,5,-3
LUX,JPN,2015.0,2,2,0
GUY,NGA,2021.0,1,1,0
THA,NZL,2011.0,1,4,-3
NZL,RUS,2007.0,1,2,-1
ISL,ITA,2002.0,1,1,0
VNM,PHL,2020.0,1,1,0
ARE,RUS,2020.0,1,2,-1
BEL,BGD,2015.0,3,7,-4
KOR,SRB,2016.0,3,1,2
BFA,BEL,2007.0,2,3,-1
BGR,SRB,2006.0,4,1,3
BEL,QAT,2015.0,1,1,0
DNK,SGP,2014.0,2,6,-4
TUR,DNK,2006.0,1,1,0
FIN,SVN,2021.0,3,1,2
ROU,CAN,2010.0,5,3,2
RUS,ARE,2022.0,3,1,2
GTM,USA,2023.0,2,9,-7
ARG,JPN,1998.0,1,4,-3
AUT,IDN,2019.0,3,4,-1
ZWE,ARE,2022.0,1,1,0
BHR,GBR,2018.0,2,4,-2
FRA,GIN,1997.0,1,4,-3
ITA,PAK,2011.0,3,6,-3
SGP,CZE,2020.0,3,3,0
BEN,MLI,2019.0,1,1,0
PSE,EGY,2019.0,2,3,-1
ITA,MAR,2018.0,1,3,-2
KOR,MYS,2007.0,1,6,-5
ITA,VEN,2017.0,2,2,0
IRL,ISL,2021.0,3,1,2
KAZ,KOR,2017.0,2,5,-3
AUS,MLT,2023.0,1,1,0
CHN,ZWE,2023.0,1,3,-2
HUN,TUR,2021.0,2,4,-2
FRA,BGD,2023.0,1,1,0
NGA,BEL,2023.0,2,1,1
COL,POL,2020.0,2,2,0
IND,NPL,1998.0,3,3,0
NOR,GEO,2021.0,1,1,0
GEO,ITA,2020.0,3,3,0
FRA,UKR,2023.0,2,7,-5
MYS,NZL,2007.0,5,2,3
VEN,CUB,2009.0,2,1,1
PRT,TWN,2022.0,1,1,0
IDN,MEX,2019.0,1,1,0
GBR,BEN,2020.0,2,1,1
ESP,IDN,2020.0,4,1,3
GHA,JPN,1998.0,1,5,-4
HKG,RUS,2003.0,1,4,-3
ESP,VEN,2023.0,4,6,-2
ESP,EGY,2006.0,3,2,1
HKG,BGD,2020.0,3,5,-2
EGY,SDN,2022.0,3,2,1
UZB,GBR,2013.0,2,2,0
CHE,GRC,1998.0,4,4,0
CMR,NGA,2009.0,2,2,0
ECU,SWE,2014.0,1,1,0
PRT,FIN,2011.0,3,4,-1
FRA,ARM,2010.0,1,1,0
ISR,NOR,2010.0,3,1,2
SVN,POL,2023.0,1,4,-3
JOR,MYS,2014.0,4,11,-7
ECU,BEL,2014.0,1,4,-3
IDN,CZE,2011.0,2,1,1
COD,BEL,2010.0,1,5,-4
TZA,PAK,2020.0,1,2,-1
RUS,KGZ,2016.0,4,3,1
USA,LUX,2007.0,2,1,1
AZE,GBR,2006.0,1,1,0
KEN,NAM,2015.0,1,1,0
NGA,GHA,2009.0,6,2,4
VEN,PER,2022.0,7,1,6
ZAF,LSO,2000.0,1,2,-1
DEU,ALB,2014.0,1,1,0
BOL,COL,2016.0,1,1,0
IRL,LUX,2015.0,2,1,1
CIV,MLI,2022.0,2,2,0
BOL,GBR,2018.0,1,1,0
SEN,DEU,2017.0,1,1,0
DEU,SEN,2020.0,1,4,-3
MEX,CHE,2011.0,4,3,1
KOR,ISR,2023.0,3,4,-1
VEN,SRB,1999.0,1,1,0
NOR,QAT,2022.0,2,1,1
ISR,TWN,2018.0,1,1,0
KEN,COD,2023.0,1,2,-1
QAT,MAR,2022.0,2,3,-1
ESP,PRY,2013.0,1,1,0
NOR,KEN,2006.0,1,1,0
CYP,CAN,2012.0,1,2,-1
CZE,PRT,2008.0,2,4,-2
MWI,CAN,2023.0,1,1,0
NZL,IRN,2012.0,1,8,-7
HUN,ZAF,2006.0,2,1,1
THA,CZE,2008.0,2,1,1
TUR,IRN,2001.0,1,1,0
SVK,TUR,2014.0,1,2,-1
TUR,PAK,2009.0,2,6,-4
PAK,AUS,2007.0,5,2,3
TZA,NLD,2010.0,2,3,-1
PER,BOL,2010.0,1,1,0
SDN,AUS,2015.0,1,1,0
ROU,SWE,2009.0,1,2,-1
ISR,PRT,2009.0,1,4,-3
PER,JPN,2017.0,1,2,-1
BGR,HUN,2006.0,3,1,2
CYM,USA,2011.0,1,1,0
URY,ARG,2001.0,4,6,-2
CHL,VEN,2021.0,3,19,-16
NLD,BEN,2010.0,2,2,0
CHL,SWE,2006.0,1,2,-1
DNK,ROU,2009.0,1,1,0
ITA,ALB,2023.0,5,2,3
HUN,DNK,2017.0,5,7,-2
GIB,ESP,2016.0,1,2,-1
NLD,UKR,2023.0,3,3,0
NZL,SWE,1998.0,2,3,-1
BOL,BEL,2006.0,1,2,-1
UKR,CZE,2007.0,2,3,-1
NLD,SRB,2003.0,1,2,-1
SAU,TUR,1998.0,1,2,-1
DZA,BEL,2011.0,2,3,-1
DEU,TUN,2003.0,1,1,0
ZAF,FIN,2005.0,1,1,0
HUN,ROU,1999.0,1,1,0
DNK,BGR,2004.0,1,3,-2
KEN,AUS,2002.0,1,1,0
ZAF,OMN,2000.0,1,1,0
SVN,MKD,2014.0,1,1,0
USA,CYM,2011.0,1,1,0
MYS,THA,2001.0,1,2,-1
ZAF,BFA,2013.0,1,4,-3
HND,MEX,2006.0,3,1,2
CAN,GHA,2008.0,1,2,-1
NLD,ARE,2003.0,1,1,0
VEN,CAN,1997.0,1,1,0
ISL,RUS,2011.0,1,3,-2
SEN,MLI,1998.0,1,2,-1
NGA,ITA,2000.0,1,5,-4
ZMB,USA,2000.0,3,2,1
LTU,NLD,2019.0,1,4,-3
PAN,BRA,2020.0,1,3,-2
CHN,TUR,2007.0,1,2,-1
COG,BFA,2010.0,2,1,1
MNG,GBR,2019.0,1,1,0
ECU,PER,2018.0,3,5,-2
ZAF,IRL,2012.0,1,4,-3
AUT,ISL,2021.0,1,1,0
IRN,IRQ,2011.0,2,5,-3
CHE,MKD,2017.0,1,1,0
PRT,TUN,2009.0,1,1,0
NGA,BEL,2005.0,1,1,0
QAT,ESP,2018.0,1,6,-5
CAN,BRA,2024.0,1,2,-1
IRN,IDN,2022.0,1,1,0
AUS,SLB,2023.0,1,2,-1
MMR,SWE,2021.0,1,1,0
ISR,CHL,2016.0,1,1,0
BOL,USA,1998.0,1,3,-2
IRL,RUS,2001.0,1,4,-3
KNA,USA,2010.0,1,2,-1
BWA,KEN,1999.0,1,1,0
ETH,SAU,2018.0,1,1,0
NIC,USA,2007.0,3,4,-1
DZA,DEU,2009.0,1,3,-2
HKG,PHL,2014.0,1,2,-1
CUB,ARG,2003.0,1,3,-2
POL,TUR,2020.0,2,8,-6
ARG,DZA,2008.0,1,1,0
BWA,GBR,2012.0,1,4,-3
ZAF,MYS,2019.0,1,4,-3
UKR,AUS,2020.0,1,2,-1
NOR,COL,2013.0,2,2,0
DEU,MNG,2016.0,1,2,-1
NZL,NGA,2016.0,1,2,-1
ZAF,CIV,2010.0,1,8,-7
HKG,DNK,2011.0,1,3,-2
MLT,FRA,2017.0,1,1,0
NER,USA,2018.0,2,3,-1
CAN,KAZ,2020.0,1,1,0
FIN,HKG,2018.0,1,3,-2
EGY,NOR,2011.0,1,1,0
ITA,SEN,2015.0,1,1,0
TZA,CHN,2014.0,1,2,-1
KEN,PER,2019.0,1,1,0
EGY,AZE,2016.0,2,1,1
ARE,KOR,2015.0,1,4,-3
USA,NCL,2012.0,1,5,-4
UGA,RWA,2022.0,1,1,0
SLE,CHN,2022.0,1,3,-2
RUS,MDA,2001.0,1,2,-1
ISL,FRA,2018.0,1,4,-3
OMN,IRN,2021.0,1,3,-2
CHE,UKR,2022.0,1,9,-8
BEL,ETH,2004.0,1,1,0
BEL,GEO,2009.0,1,2,-1
CAN,GHA,2004.0,1,3,-2
RUS,KGZ,2008.0,1,1,0
NIC,ARG,2009.0,1,1,0
EGY,JOR,2007.0,1,2,-1
FIN,SVK,2007.0,1,1,0
FRA,OMN,2018.0,1,1,0
UKR,JPN,2016.0,3,8,-5
CMR,GAB,2022.0,1,1,0
SDN,FRA,2009.0,1,1,0
SGP,RUS,1998.0,1,1,0
GHA,MLI,2017.0,1,1,0
ZAF,DZA,2009.0,1,1,0
GMB,ZAF,2022.0,1,1,0
LAO,THA,2016.0,3,10,-7
BRN,MYS,2019.0,1,5,-4
MAR,DEU,2016.0,1,6,-5
ETH,SGP,2015.0,1,1,0
LUX,CAN,2015.0,2,2,0
SGP,BGD,2006.0,1,2,-1
KWT,IND,2023.0,1,3,-2
ARE,FIN,2022.0,1,2,-1
PER,MYS,2020.0,1,2,-1
PHL,DNK,2022.0,1,1,0
UZB,KOR,2018.0,2,3,-1
LBY,USA,2019.0,1,1,0
MWI,BWA,2020.0,1,1,0
THA,NOR,2023.0,1,2,-1
BHR,BEL,2022.0,1,1,0
KEN,IND,2007.0,1,1,0
SGP,BRN,2008.0,1,1,0
URY,MEX,2008.0,2,3,-1
KEN,ETH,1997.0,1,4,-3
GRL,DNK,2005.0,2,3,-1
PRI,GBR,2007.0,1,2,-1
ZAF,KOR,2009.0,1,1,0
GBR,MDV,2022.0,1,3,-2
NGA,BWA,2007.0,1,1,0
BLR,CHE,2018.0,1,1,0
EGY,CZE,2023.0,2,1,1
ROU,SGP,2012.0,1,1,0
SVN,IND,2023.0,1,4,-3
IDN,CMR,2011.0,1,1,0
CHE,SVK,2014.0,2,2,0
ESP,SVN,2011.0,1,1,0
JOR,PAK,2010.0,1,1,0
NAM,JPN,2014.0,1,2,-1
ARE,GRC,2019.0,1,6,-5
ETH,PRT,2012.0,1,1,0
ARG,AUT,2019.0,3,5,-2
ARE,FIN,2017.0,1,2,-1
TTO,CAN,2017.0,1,6,-5
BRA,CZE,2012.0,1,1,0
NGA,BRN,2018.0,1,1,0
GHA,IRL,2014.0,1,1,0
USA,GMB,2023.0,1,2,-1
NOR,KOR,2018.0,1,12,-11
UZB,CHN,2015.0,1,1,0
ROU,PAK,2010.0,1,1,0
AUT,HKG,2019.0,1,1,0
KHM,KOR,2017.0,1,3,-2
CZE,NZL,2016.0,1,2,-1
BRB,JAM,2016.0,1,5,-4
PRT,NGA,2021.0,1,1,0
LTU,DNK,2020.0,1,4,-3
KAZ,FRA,2019.0,1,5,-4
KAZ,NZL,2020.0,1,1,0
SAU,COL,2021.0,2,6,-4
GHA,NOR,2017.0,1,2,-1
ROU,IRN,2019.0,1,1,0
GIN,DEU,2022.0,1,1,0
TTO,GRD,2014.0,1,1,0
TWN,UZB,1997.0,1,1,0
TUN,CAN,2000.0,2,4,-2
CAN,UKR,2022.0,1,7,-6
FRA,NGA,2000.0,2,3,-1
MRT,FRA,2017.0,1,5,-4
CHL,COL,1998.0,2,2,0
HUN,TUR,2020.0,2,2,0
RUS,DEU,2024.0,1,1,0
ITA,SVK,2005.0,1,1,0
ZAF,HUN,2013.0,1,1,0
UGA,NOR,2001.0,1,2,-1
BEN,CMR,2003.0,1,1,0
GUF,SEN,2000.0,1,2,-1
NOR,BEL,2003.0,1,2,-1
USA,MSR,2018.0,1,1,0
GBR,BWA,1999.0,1,4,-3
FIN,ZAF,2012.0,1,5,-4
ESP,LVA,2022.0,1,2,-1
KOR,ROU,2021.0,1,1,0
PER,AUT,2007.0,1,1,0
UKR,TWN,2002.0,2,3,-1
BEL,COD,2008.0,1,1,0
IRL,KEN,2022.0,1,2,-1
BGR,JPN,2018.0,2,2,0
SGP,LKA,2007.0,1,1,0
DEU,MLI,2023.0,1,1,0
IND,PRI,2011.0,2,2,0
MAR,BRA,2010.0,1,1,0
TON,FJI,2019.0,1,1,0
FRA,GAB,2000.0,1,8,-7
SDN,LBN,2019.0,1,2,-1
CRI,DEU,2007.0,1,3,-2
HRV,NLD,2010.0,1,1,0
ARG,VEN,2011.0,1,2,-1
VNM,THA,2006.0,1,2,-1
TWN,ITA,2006.0,1,3,-2
BGR,TUR,2012.0,1,2,-1
SAU,CHN,2011.0,3,25,-22
IRN,DNK,2006.0,1,1,0
HKG,ITA,2019.0,3,4,-1
DNK,PRT,2004.0,1,2,-1
TCA,USA,2014.0,1,1,0
BEN,COG,2012.0,2,1,1
IRN,ISR,2017.0,1,1,0
GIN,CMR,2017.0,1,1,0
QAT,NOR,2022.0,1,2,-1
MKD,ALB,2018.0,1,1,0
SGP,CZE,2021.0,2,1,1
POL,TUN,2018.0,1,1,0
URY,ITA,2013.0,2,1,1
ESP,TZA,2016.0,1,1,0
CZE,MEX,2012.0,1,4,-3
CHN,KHM,2021.0,1,1,0
GMB,FRA,2017.0,1,1,0
SAU,BEL,2006.0,1,1,0
GUF,GUY,2015.0,1,1,0
THA,MEX,2019.0,1,1,0
NLD,NPL,1997.0,1,2,-1
NLD,HKG,1997.0,1,1,0
IRL,MEX,2018.0,1,2,-1
USA,BHS,2022.0,2,6,-4
JPN,ISR,2012.0,1,2,-1
IRN,AFG,2014.0,1,1,0
DNK,GRL,1997.0,1,1,0
MLT,TUR,2018.0,1,1,0
UKR,DNK,1999.0,1,1,0
GIN,FRA,2023.0,1,3,-2
RUS,LTU,1997.0,1,3,-2
HUN,BRA,2023.0,1,2,-1
FJI,AUS,1997.0,1,2,-1
JOR,SAU,2002.0,1,2,-1
CAN,SVN,1999.0,1,3,-2
EST,BEL,2003.0,1,1,0
SLV,SVK,2007.0,1,5,-4
AUT,ARE,2012.0,1,1,0
WSM,ITA,1998.0,1,1,0
COG,KEN,2017.0,1,1,0
MCO,ITA,2011.0,1,1,0
ISR,HRV,1999.0,1,3,-2
KOR,SRB,2014.0,1,2,-1
SRB,KOR,2016.0,1,3,-2
USA,CIV,2000.0,1,4,-3
GRC,AUT,2004.0,1,3,-2
EGY,AUT,1998.0,1,1,0
QAT,SRB,2016.0,1,2,-1
CHL,ECU,2009.0,1,1,0
TUR,BGR,2011.0,2,1,1
ISL,ESP,2014.0,1,1,0
LKA,MYS,2011.0,1,1,0
ROU,BRA,2020.0,1,1,0
HUN,CHN,2010.0,2,1,1
FLK,AUS,2018.0,1,1,0
GHA,SWE,2017.0,1,2,-1
NPL,JPN,2002.0,1,10,-9
NGA,TZA,2020.0,1,3,-2
CHN,BLR,2019.0,1,3,-2
COL,ITA,2000.0,1,1,0
BEL,KOR,2011.0,1,5,-4
CAN,JAM,2001.0,1,3,-2
THA,MMR,2002.0,1,1,0
LBY,NLD,2009.0,1,1,0
EST,CAN,2011.0,2,5,-3
ISR,TWN,2014.0,1,1,0
PAK,CHN,2001.0,1,5,-4
ZAF,SGP,2004.0,1,1,0
BEL,SGP,2000.0,1,2,-1
KEN,COL,2013.0,1,2,-1
NZL,DNK,1997.0,1,2,-1
GEO,RUS,2015.0,2,7,-5
CRI,DEU,1998.0,1,2,-1
ZMB,GBR,2012.0,2,6,-4
BRA,BLR,2001.0,1,4,-3
DNK,COL,2009.0,1,2,-1
BEL,ROU,2000.0,2,2,0
LAO,GBR,2012.0,1,3,-2
LKA,GBR,1997.0,1,4,-3
SWZ,BWA,2006.0,1,1,0
BHR,JOR,2020.0,1,4,-3
MNG,DEU,2013.0,1,1,0
PRT,IRL,2013.0,4,7,-3
AFG,GBR,2013.0,2,1,1
BEL,QAT,2017.0,1,2,-1
TUR,BGR,2019.0,1,1,0
NLD,SLE,2020.0,1,1,0
FRO,DNK,2012.0,1,3,-2
KHM,KOR,2018.0,1,1,0
BRA,HND,2018.0,1,1,0
ISL,LUX,2018.0,1,1,0
KAZ,CZE,2018.0,1,3,-2
ARE,NOR,2015.0,1,2,-1
GMB,AUS,2023.0,1,1,0
CYP,ESP,2017.0,1,2,-1
KOR,DZA,2021.0,1,2,-1
TUR,RUS,2023.0,1,9,-8
MEX,VNM,2021.0,1,3,-2
BGD,QAT,2019.0,1,1,0
IRQ,KAZ,2021.0,1,1,0
MAR,BRA,2023.0,1,1,0
CHE,ETH,2023.0,1,1,0
ISR,HUN,2022.0,1,1,0
GRC,EST,2008.0,1,1,0
SVK,ESP,1997.0,1,1,0
SVK,ISR,2003.0,1,1,0
NCL,VUT,2014.0,1,1,0
NZL,ESP,2003.0,1,1,0
LAO,GBR,2005.0,1,1,0
NZL,ISR,2007.0,1,3,-2
BEL,BLR,1999.0,1,3,-2
COL,RUS,1998.0,1,2,-1
MWI,JPN,2020.0,1,3,-2
KNA,USA,2006.0,1,1,0
LBR,SLE,2017.0,1,1,0
JPN,CMR,2019.0,1,3,-2
BRN,SGP,2017.0,1,2,-1
BRN,CHN,2017.0,1,3,-2
TTO,BRB,2015.0,1,1,0
KGZ,DEU,2018.0,1,1,0
ECU,URY,2015.0,1,1,0
TCD,CMR,2018.0,1,1,0
BEN,DEU,2018.0,1,5,-4
ISL,RUS,2019.0,1,2,-1
KEN,ZWE,2018.0,1,3,-2
CHL,ISR,1998.0,1,1,0
EGY,MAR,2023.0,2,1,1
CIV,CHE,2017.0,1,3,-2
IDN,BRA,2022.0,1,1,0
MKD,HRV,2020.0,1,2,-1
BWA,GBR,1997.0,1,2,-1
HRV,JPN,1998.0,1,1,0
VNM,FRA,1998.0,1,3,-2
BHR,KWT,2017.0,1,1,0
NGA,FIN,2007.0,1,1,0
BRA,PRT,2024.0,1,4,-3
MAR,PHL,2021.0,1,2,-1
VEN,VNM,2013.0,1,1,0
IND,UZB,2014.0,1,1,0
NLD,SDN,2013.0,1,1,0
IDN,ZAF,2023.0,1,1,0
CAN,CUB,1999.0,1,3,-2
BRN,AUS,2006.0,1,2,-1
BLZ,USA,2002.0,1,2,-1
DNK,SVK,1997.0,1,2,-1
NGA,CHE,2009.0,1,1,0
HUN,BGR,1999.0,1,2,-1
MYS,VNM,2010.0,1,2,-1
BLR,BEL,2008.0,1,6,-5
TUR,NLD,1997.0,1,1,0
GBR,SDN,2003.0,1,6,-5
COL,NLD,2004.0,1,3,-2
SAU,JOR,2000.0,1,2,-1
SAU,QAT,2010.0,1,4,-3
HKG,IRL,2005.0,1,1,0
IRL,SGP,2008.0,1,2,-1
FRO,DNK,2005.0,1,1,0
GRC,BGR,1998.0,1,2,-1
SDN,CHN,2011.0,1,3,-2
KHM,GBR,2011.0,1,3,-2
AUT,UGA,2020.0,1,1,0
SAU,SGP,2009.0,1,3,-2
NLD,CMR,2012.0,1,1,0
SLE,USA,2013.0,1,2,-1
CHN,TGO,2017.0,1,1,0
LAO,JPN,2014.0,1,4,-3
DEU,VEN,2017.0,1,10,-9
FIN,TUN,2019.0,1,1,0
SGP,PAK,2003.0,1,2,-1
USA,TGO,2014.0,1,1,0
COG,CAF,2012.0,2,1,1
KOR,TUR,2006.0,1,2,-1
ECU,NLD,2011.0,1,2,-1
MDA,ROU,2016.0,2,4,-2
SAU,POL,2018.0,1,1,0
ESP,LVA,2017.0,1,1,0
RUS,DZA,2022.0,1,1,0
LBN,CHN,2018.0,1,1,0
ZAF,GAB,2018.0,1,1,0
SGP,NPL,2020.0,1,1,0
CAN,IRQ,2018.0,1,4,-3
ITA,ZAF,2023.0,1,5,-4
ARG,SWE,2009.0,1,3,-2
CAN,TTO,2021.0,2,3,-1
TWN,IRN,2013.0,1,3,-2
IND,MLI,2006.0,1,1,0
CHN,LKA,2008.0,1,1,0
LKA,HKG,2016.0,1,4,-3
LAO,AUS,2010.0,1,1,0
ECU,PRI,2016.0,1,2,-1
FRA,MOZ,2015.0,2,1,1
NZL,WSM,2015.0,1,1,0
BEL,TUN,2009.0,1,1,0
FRA,BLR,2023.0,1,1,0
TUN,ZAF,2017.0,1,58,-57
KHM,KOR,2016.0,1,1,0
GUY,CAN,2009.0,1,4,-3
ITA,CMR,2005.0,1,1,0
UGA,NGA,2013.0,1,2,-1
MEX,PRI,2015.0,1,3,-2
CRI,CHL,2021.0,1,4,-3
NOR,MEX,2023.0,1,1,0
COG,NGA,2022.0,1,4,-3
SGP,BEL,1999.0,1,1,0
EGY,GHA,2020.0,1,2,-1
GRC,RUS,2022.0,1,7,-6
FIN,MYS,2023.0,1,5,-4
ETH,FRA,2016.0,1,1,0
JPN,IRN,2023.0,1,5,-4
MAR,SEN,2023.0,1,1,0
SVN,HUN,2019.0,1,1,0
LTU,FRA,1998.0,2,2,0
JOR,CAN,1999.0,1,2,-1
ITA,ECU,2004.0,1,1,0
SGP,RUS,2007.0,1,3,-2
OMN,ZAF,2019.0,1,1,0
LKA,NLD,2000.0,1,3,-2
TUR,CAN,1997.0,1,5,-4
NGA,ZAF,2000.0,1,5,-4
LBY,BRA,2012.0,1,1,0
GRC,AUT,2001.0,2,2,0
SVN,BEL,2007.0,1,2,-1
DOM,BRA,2020.0,1,1,0
SRB,CZE,2013.0,2,1,1
ARE,TUN,2020.0,1,5,-4
BRN,MYS,2009.0,1,2,-1
FRA,SYC,2007.0,1,1,0
SRB,AUS,2014.0,2,1,1
AUS,MAC,2007.0,1,1,0
DNK,KEN,2022.0,1,5,-4
EGY,DNK,2014.0,1,2,-1
DZA,MYS,2012.0,1,1,0
TUN,SYR,2015.0,1,1,0
ITA,AFG,2005.0,1,1,0
PSE,CHE,2011.0,1,1,0
FIN,KOR,2001.0,1,1,0
AUT,EST,2014.0,1,1,0
DZA,AUS,2018.0,1,1,0
AUT,ISL,2019.0,1,1,0
ESP,LTU,2020.0,1,2,-1
ESP,AND,2012.0,1,3,-2
RUS,ETH,2016.0,1,1,0
BRA,HND,2022.0,1,1,0
CAN,GRL,2019.0,1,1,0
ITA,LKA,2021.0,1,2,-1
ETH,AUT,2020.0,1,1,0
LVA,ITA,2020.0,1,1,0
KOR,PER,2023.0,1,2,-1
GHA,SWE,2018.0,1,2,-1
POL,ISL,2023.0,1,2,-1
DZA,ZAF,2009.0,1,1,0
ISL,FIN,2010.0,1,1,0
NZL,BRA,2005.0,1,2,-1
NAM,CAN,2012.0,1,1,0
THA,HKG,2007.0,1,1,0
PAK,JOR,2003.0,1,1,0
COL,CUB,2007.0,1,6,-5
COG,GBR,2008.0,1,1,0
GBR,MNG,2003.0,1,1,0
CMR,CHE,2005.0,1,3,-2
IRL,AUT,2004.0,1,3,-2
BLR,NOR,2012.0,1,1,0
ESP,BOL,2002.0,1,1,0
VNM,TWN,2006.0,1,1,0
POL,YEM,2008.0,1,1,0
DEU,PHL,2001.0,1,3,-2
ECU,CHL,2010.0,1,1,0
LKA,NLD,2006.0,1,1,0
FRA,CRI,2002.0,1,1,0
EST,NOR,2007.0,1,2,-1
KWT,GRC,2019.0,1,2,-1
CAN,LKA,2003.0,1,1,0
SGP,BEL,2007.0,2,2,0
AUS,LAO,2010.0,1,1,0
THA,GRC,2017.0,1,2,-1
ITA,MLT,1998.0,1,3,-2
BEL,IDN,2013.0,1,2,-1
ZAF,IRN,2009.0,2,1,1
MEX,SYR,2007.0,1,1,0
SWE,URY,2007.0,1,2,-1
PRT,GRC,2014.0,1,2,-1
MUS,ZAF,2009.0,1,1,0
BOL,BRA,2014.0,1,2,-1
SWE,MLT,2014.0,1,1,0
ZAF,GAB,2017.0,1,1,0
FIN,HRV,2018.0,1,4,-3
YEM,IND,2015.0,1,5,-4
CMR,MAR,2012.0,1,1,0
LUX,DNK,2020.0,1,1,0
COL,CRI,2022.0,1,2,-1
TUR,SGP,2010.0,1,1,0
NOR,GRC,2012.0,1,4,-3
JOR,CHE,2013.0,1,1,0
VNM,TUN,2021.0,1,0,1
AFG,COD,2022.0,1,0,1
VAT,ITA,2014.0,1,0,1
MDG,RWA,2006.0,1,0,1
ROU,CMR,2014.0,2,0,2
GUY,PRI,2003.0,1,0,1
GRC,SVN,2010.0,2,0,2
CZE,CHN,2011.0,2,0,2
GRC,ECU,2017.0,1,0,1
ISL,NZL,2018.0,1,0,1
NAM,DEU,2013.0,1,0,1
JPN,ROU,2017.0,2,0,2
SWE,MDG,2014.0,1,0,1
EST,NGA,2012.0,1,0,1
PSE,PRT,2012.0,1,0,1
BEL,ALB,2014.0,2,0,2
PHL,FIN,2019.0,1,0,1
CUB,HND,2013.0,1,0,1
ESP,HND,2012.0,2,0,2
TUR,HRV,2017.0,1,0,1
ESP,ARM,2013.0,1,0,1
GTM,AUS,2011.0,1,0,1
NOR,LUX,2019.0,1,0,1
THA,IRQ,2016.0,1,0,1
CUB,CHE,2016.0,1,0,1
ISR,MAC,2017.0,1,0,1
SLE,GHA,2014.0,1,0,1
MYS,LBN,2019.0,1,0,1
GRC,KAZ,2020.0,2,0,2
BHS,CAN,2019.0,1,0,1
NGA,LBY,2022.0,1,0,1
DNK,TZA,2019.0,1,0,1
RUS,ISL,2017.0,2,0,2
EST,IDN,2022.0,1,0,1
EST,POL,2008.0,2,0,2
ZAF,THA,2003.0,1,0,1
PHL,BEL,2011.0,2,0,2
BEL,SVK,1999.0,1,0,1
IDN,MYS,1998.0,1,0,1
PAK,POL,1999.0,1,0,1
SRB,SEN,2020.0,1,0,1
HTI,JAM,2020.0,1,0,1
MDA,USA,2006.0,1,0,1
MDA,GBR,2007.0,1,0,1
BLR,CHN,2024.0,2,0,2
ESP,ARM,2003.0,1,0,1
SWE,ERI,2000.0,2,0,2
THA,IDN,1999.0,1,0,1
,SWZ,2000.0,4,0,4
PHL,CAN,2005.0,1,0,1
PAN,URY,2013.0,1,0,1
SWE,CRI,2000.0,1,0,1
PAK,THA,2008.0,2,0,2
KEN,THA,2019.0,1,0,1
TCD,FRA,2003.0,2,0,2
CAF,BFA,2000.0,1,0,1
ZWE,CAF,2006.0,1,0,1
AUT,BWA,2014.0,1,0,1
BGD,KEN,2002.0,1,0,1
GTM,VEN,2003.0,1,0,1
BGR,POL,2004.0,1,0,1
ESP,CYP,2001.0,1,0,1
TWN,TUR,2011.0,2,0,2
SGP,OMN,2001.0,1,0,1
CAF,MDG,2011.0,1,0,1
GEO,PAK,2009.0,2,0,2
AUT,SGP,2004.0,2,0,2
NZL,SAU,2000.0,1,0,1
GEO,SRB,2005.0,1,0,1
CAN,LTU,2007.0,2,0,2
TWN,TUR,2009.0,4,0,4
DEU,ISL,2001.0,3,0,3
GNB,GMB,2013.0,1,0,1
AUS,TON,2008.0,1,0,1
FJI,TON,2011.0,1,0,1
BRB,IND,2008.0,1,0,1
ESP,ETH,2012.0,2,0,2
UZB,CAN,2005.0,1,0,1
VEN,ZAF,2007.0,1,0,1
ISR,TUN,2013.0,1,0,1
,TLS,2005.0,1,0,1
FJI,ZMB,2018.0,1,0,1
LKA,PAK,2010.0,1,0,1
HND,CAN,2021.0,1,0,1
VEN,TUR,2003.0,1,0,1
TUR,VEN,2005.0,1,0,1
COL,PER,2005.0,3,0,3
TUR,HUN,2008.0,1,0,1
GRC,DZA,2019.0,1,0,1
HKG,BEL,2009.0,2,0,2
UZB,TJK,2013.0,1,0,1
BGR,AUT,2013.0,1,0,1
DEU,KGZ,2001.0,1,0,1
NLD,LBN,2005.0,2,0,2
,VUT,2001.0,2,0,2
BRA,IDN,2015.0,1,0,1
OMN,IRL,2015.0,1,0,1
DNK,PRI,2014.0,1,0,1
PAK,AUT,2006.0,3,0,3
BFA,TGO,2011.0,2,0,2
BGD,NOR,2000.0,1,0,1
NOR,BGD,2005.0,1,0,1
,MDV,2008.0,2,0,2
LBN,PRT,2016.0,1,0,1
BEL,MYS,2003.0,1,0,1
SWE,GRL,2020.0,1,0,1
CHN,GIN,2014.0,2,0,2
BDI,CMR,2021.0,1,0,1
MYS,CYP,2018.0,1,0,1
ITA,MLI,2018.0,1,0,1
FIN,BFA,2014.0,1,0,1
GIB,ISR,2018.0,1,0,1
KOR,FIN,2006.0,2,0,2
ARM,PHL,2017.0,1,0,1
PRY,DEU,2021.0,1,0,1
GBR,MNG,2020.0,1,0,1
IRN,YEM,2020.0,1,0,1
SGP,PAK,2007.0,4,0,4
PRT,KOR,2018.0,3,0,3
NGA,SWZ,2019.0,1,0,1
ZAF,GIN,2018.0,1,0,1
CZE,ALB,2016.0,1,0,1
MRT,ARE,2018.0,1,0,1
CUB,CHE,2017.0,2,0,2
SLV,AUS,2021.0,1,0,1
DOM,FRA,2016.0,1,0,1
POL,EGY,2012.0,1,0,1
IND,IRL,1997.0,1,0,1
AUT,BHR,2011.0,1,0,1
PAK,CYP,2015.0,1,0,1
PAK,KAZ,2020.0,2,0,2
SWE,CIV,2018.0,3,0,3
TUN,PSE,2019.0,1,0,1
ETH,CYP,2018.0,1,0,1
ISL,EST,2018.0,1,0,1
SYR,SWE,2021.0,1,0,1
GHA,EGY,2019.0,2,0,2
ARG,CHL,2024.0,1,0,1
KEN,COG,2018.0,2,0,2
DOM,JAM,2019.0,1,0,1
KEN,BDI,2020.0,1,0,1
MEX,SVN,2001.0,1,0,1
QAT,VNM,2019.0,1,0,1
PHL,ARE,2020.0,2,0,2
POL,EST,2007.0,1,0,1
UKR,AZE,2022.0,1,0,1
BEN,GBR,2022.0,2,0,2
KOR,JOR,2020.0,1,0,1
URY,PRT,2021.0,1,0,1
RWA,BRA,2022.0,1,0,1
LKA,FRA,2023.0,1,0,1
FIN,BRA,1997.0,1,0,1
BWA,JPN,2022.0,1,0,1
GBR,HND,2018.0,1,0,1
NLD,TTO,2006.0,1,0,1
NPL,MDV,2021.0,4,0,4
MCO,LUX,2020.0,1,0,1
BLR,KOR,2020.0,1,0,1
BFA,CHE,2023.0,1,0,1
IND,AUT,2024.0,1,0,1
LBR,IND,2020.0,1,0,1
,MNP,2019.0,3,0,3
IDN,IND,2024.0,1,0,1
,SXM,2020.0,2,0,2
CUB,JPN,2010.0,2,0,2
BGD,SDN,2023.0,1,0,1
EGY,SLV,2004.0,1,0,1
NPL,IRL,2009.0,1,0,1
WSM,AUS,2022.0,1,0,1
BGD,MEX,2016.0,1,0,1
AGO,MOZ,2018.0,1,0,1
BOL,SWE,2010.0,2,0,2
BRA,LBN,2014.0,1,0,1
GRC,RUS,2010.0,1,0,1
TGO,MRT,2021.0,1,0,1
TUR,HRV,2018.0,2,0,2
USA,AGO,2012.0,3,0,3
ZAF,BGD,2022.0,1,0,1
PRI,TWN,2020.0,1,0,1
AUS,PSE,2017.0,1,0,1
DNK,ETH,2011.0,1,0,1
CMR,AUS,2021.0,1,0,1
NCL,DEU,2017.0,1,0,1
MEX,SGP,2021.0,1,0,1
SWE,MCO,2003.0,1,0,1
CAN,URY,2000.0,1,0,1
NAM,GHA,2022.0,2,0,2
IRL,UGA,2008.0,1,0,1
IND,UZB,2002.0,1,0,1
MAR,CMR,2015.0,2,0,2
DZA,TUR,2003.0,1,0,1
IDN,PER,2017.0,1,0,1
MNE,RUS,2013.0,1,0,1
NAM,DEU,2003.0,2,0,2
MLT,NLD,1999.0,1,0,1
CHE,SWZ,2003.0,1,0,1
PRT,CHL,2007.0,1,0,1
GRC,BRA,2003.0,2,0,2
URY,CHN,2019.0,1,0,1
SWE,GHA,2008.0,1,0,1
BEL,DZA,1999.0,1,0,1
ECU,AUT,2017.0,1,0,1
CHL,NIC,2001.0,1,0,1
NLD,GEO,1998.0,2,0,2
GRC,UKR,2005.0,1,0,1
JPN,ALB,2002.0,2,0,2
DNK,SVN,2001.0,2,0,2
NLD,DZA,2017.0,1,0,1
LKA,OMN,2009.0,1,0,1
ISR,MYS,2000.0,1,0,1
NCL,GBR,2022.0,1,0,1
DZA,IDN,2017.0,1,0,1
LAO,IDN,2001.0,1,0,1
IDN,LAO,2004.0,1,0,1
NOR,SAU,2004.0,1,0,1
AGO,PRT,2001.0,1,0,1
MLI,NGA,2001.0,1,0,1
BRA,BOL,1998.0,1,0,1
CMR,CHE,2014.0,3,0,3
MEX,KEN,2001.0,1,0,1
BEL,IDN,1999.0,1,0,1
MLI,NER,2002.0,1,0,1
LTU,IRL,2015.0,3,0,3
AUT,ARG,2005.0,3,0,3
TUR,MAR,2002.0,1,0,1
MDG,BWA,2008.0,1,0,1
,MDV,2001.0,1,0,1
UKR,PRI,2022.0,1,0,1
PHL,IRL,2006.0,1,0,1
MYS,PAN,2009.0,1,0,1
SGP,COL,2013.0,1,0,1
GUY,BRA,2008.0,1,0,1
KEN,GMB,2002.0,1,0,1
IRL,COL,2014.0,1,0,1
KWT,ZAF,2004.0,1,0,1
USA,BHR,2009.0,3,0,3
NZL,EST,2018.0,2,0,2
SWZ,FRA,2015.0,1,0,1
UKR,SVK,2003.0,1,0,1
BLR,AUS,2012.0,1,0,1
MAR,GBR,2007.0,4,0,4
NZL,QAT,2015.0,1,0,1
TUR,LTU,2016.0,1,0,1
BGR,SGP,2021.0,1,0,1
SMR,ITA,2008.0,1,0,1
KOR,MNG,2003.0,1,0,1
LVA,JPN,2006.0,1,0,1
MDA,CAN,2016.0,2,0,2
BGR,ISR,2020.0,1,0,1
BRB,ATG,2003.0,1,0,1
PAN,SWE,2015.0,1,0,1
MEX,BLR,2007.0,1,0,1
BRA,HRV,2005.0,1,0,1
IRL,BLR,2021.0,1,0,1
CZE,ITA,2024.0,1,0,1
DNK,IND,2024.0,1,0,1
NLD,SDN,2020.0,1,0,1
BTN,FRA,2014.0,1,0,1
KOR,GRC,2011.0,1,0,1
CZE,MYS,2013.0,1,0,1
TGO,TTO,2014.0,2,0,2
MDA,KGZ,2014.0,1,0,1
SRB,CZE,2007.0,2,0,2
BDI,NLD,2013.0,1,0,1
VEN,BEL,2019.0,2,0,2
HND,GTM,2018.0,1,0,1
BRA,PRY,2000.0,1,0,1
CAN,BOL,2012.0,1,0,1
SWZ,ETH,2017.0,1,0,1
LUX,CZE,2012.0,1,0,1
UGA,DEU,2015.0,1,0,1
OMN,DNK,2020.0,1,0,1
ROU,MKD,2016.0,1,0,1
MAR,QAT,2015.0,2,0,2
KWT,TWN,2014.0,1,0,1
,CPV,2001.0,2,0,2
CPV,PRT,2011.0,1,0,1
BRB,CHN,2017.0,1,0,1
BEL,SRB,2015.0,6,0,6
WSM,ECU,2013.0,1,0,1
PLW,FSM,2003.0,1,0,1
BFA,GBR,1999.0,1,0,1
COG,AGO,2021.0,1,0,1
NLD,OMN,1998.0,2,0,2
POL,SRB,1999.0,1,0,1
ERI,,2011.0,1,0,1
QAT,GEO,2023.0,1,0,1
LBY,TUN,2023.0,1,0,1
,VCT,2020.0,4,0,4
VCT,USA,2023.0,3,0,3
COD,GBR,2000.0,1,0,1
,SLE,1997.0,2,0,2
BRA,HUN,2002.0,1,0,1
CHN,GMB,2021.0,1,0,1
GMB,AUS,2022.0,2,0,2
PAN,CUB,2014.0,1,0,1
CHN,ZAF,2024.0,1,0,1
IDN,MMR,2020.0,1,0,1
SGP,FIN,2007.0,1,0,1
ETH,BDI,2018.0,1,0,1
SEN,BEN,2019.0,2,0,2
MNG,FRA,2008.0,2,0,2
GEO,MDA,2019.0,1,0,1
GBR,BOL,2014.0,1,0,1
JPN,PLW,2013.0,1,0,1
SLE,LUX,2012.0,1,0,1
VNM,RWA,2021.0,1,0,1
ISL,NZL,2017.0,1,0,1
AZE,AUT,2018.0,1,0,1
EGY,ETH,2016.0,1,0,1
IRQ,NZL,2017.0,1,0,1
UZB,TUR,2017.0,1,0,1
EST,MMR,2013.0,1,0,1
MOZ,CIV,2014.0,1,0,1
HRV,SGP,2016.0,2,0,2
PNG,USA,2015.0,2,0,2
ESP,VNM,2007.0,1,0,1
THA,ETH,2022.0,1,0,1
TTO,PSE,2022.0,1,0,1
MDA,SRB,2019.0,1,0,1
SVK,NOR,2016.0,1,0,1
GBR,BOL,2015.0,1,0,1
VNM,ZAF,2008.0,1,0,1
MWI,CHN,2015.0,1,0,1
TUR,THA,2018.0,1,0,1
GUF,MAR,2018.0,1,0,1
PNG,NZL,2016.0,1,0,1
BLR,IRN,2020.0,1,0,1
IND,BEN,2017.0,2,0,2
SWE,SOM,2022.0,1,0,1
SWE,SOM,2018.0,1,0,1
DNK,EGY,1998.0,2,0,2
KGZ,NGA,2021.0,1,0,1
BRA,MCO,2020.0,1,0,1
TUN,ARE,2011.0,3,0,3
UGA,ZMB,2021.0,1,0,1
USA,TCA,2021.0,1,0,1
NGA,COL,2023.0,1,0,1
CUB,ZAF,2018.0,2,0,2
MDG,NLD,2021.0,1,0,1
MWI,CAN,2014.0,1,0,1
IDN,BDI,2023.0,2,0,2
AUS,KGZ,2016.0,1,0,1
ITA,JAM,2022.0,1,0,1
JAM,ITA,2023.0,1,0,1
IRL,MAR,2020.0,1,0,1
BGD,UZB,2019.0,1,0,1
KWT,FIN,2023.0,1,0,1
CHL,PHL,2022.0,1,0,1
IRN,EGY,2023.0,1,0,1
KEN,SYR,2009.0,1,0,1
KEN,QAT,2015.0,1,0,1
DZA,ESP,2010.0,1,0,1
ARE,FIN,2024.0,1,0,1
SWZ,TZA,2019.0,1,0,1
,ATG,2001.0,1,0,1
BGR,LBY,2015.0,1,0,1
POL,IRN,2011.0,1,0,1
ERI,,2019.0,2,0,2
KEN,FIN,2017.0,1,0,1
SVK,BGR,2014.0,2,0,2
YEM,DEU,2004.0,1,0,1
BEL,LBY,2013.0,1,0,1
,COM,2007.0,1,0,1
LTU,NOR,2015.0,1,0,1
BGR,BLR,2004.0,1,0,1
THA,KWT,2016.0,1,0,1
BFA,NER,2017.0,2,0,2
GRC,OMN,2016.0,1,0,1
FRA,BWA,2005.0,1,0,1
LTU,IRL,2004.0,1,0,1
SAU,MYS,2005.0,1,0,1
BLR,TUR,2013.0,1,0,1
NLD,HRV,1998.0,1,0,1
GUY,USA,2012.0,1,0,1
TTO,FRA,2010.0,1,0,1
CHE,KGZ,2000.0,1,0,1
LBN,ESP,1998.0,1,0,1
PRY,ARG,2002.0,1,0,1
COL,BDI,2008.0,1,0,1
GUM,,2018.0,2,0,2
KEN,ZMB,2011.0,1,0,1
POL,DZA,2006.0,1,0,1
SAU,DNK,2004.0,1,0,1
LBY,CAN,2000.0,1,0,1
BEL,ARE,1998.0,1,0,1
IDN,BTN,2021.0,1,0,1
NZL,TON,2019.0,1,0,1
TWN,SVK,2001.0,1,0,1
USA,BRN,2002.0,2,0,2
COL,IDN,1997.0,1,0,1
BGD,DEU,1998.0,1,0,1
IRL,TWN,2010.0,1,0,1
KOR,HKG,1999.0,3,0,3
SWE,WSM,2004.0,1,0,1
GRL,NOR,2008.0,1,0,1
SVN,CUB,2018.0,1,0,1
DZA,ARG,2004.0,1,0,1
PAN,ESP,1999.0,1,0,1
MEX,LVA,2022.0,1,0,1
BIH,AUT,2001.0,1,0,1
PLW,,2013.0,3,0,3
ARG,CRI,2004.0,1,0,1
HUN,EST,2016.0,3,0,3
MOZ,MAR,2005.0,1,0,1
MAR,CMR,2014.0,1,0,1
PRT,GEO,2009.0,1,0,1
CHN,NPL,2008.0,1,0,1
AUT,LBN,2011.0,1,0,1
OMN,JPN,2019.0,1,0,1
ZAF,JAM,2021.0,1,0,1
FRA,CUB,2008.0,1,0,1
DNK,PSE,2011.0,1,0,1
ITA,SDN,2011.0,1,0,1
MWI,NAM,2014.0,1,0,1
GHA,SLE,2011.0,1,0,1
SOM,GBR,2010.0,1,0,1
ISL,ARE,2013.0,1,0,1
ARG,NOR,2011.0,1,0,1
SWE,GEO,2009.0,1,0,1
MLI,ITA,1998.0,1,0,1
JPN,OMN,2010.0,1,0,1
JPN,VEN,2010.0,1,0,1
ECU,GBR,2006.0,1,0,1
DNK,GIN,2020.0,1,0,1
BFA,SWE,2009.0,1,0,1
CUB,NLD,2012.0,1,0,1
JOR,UKR,2013.0,1,0,1
JOR,CZE,2016.0,1,0,1
ISL,VNM,2015.0,1,0,1
AUS,BGR,2022.0,1,0,1
BEL,GIN,2012.0,1,0,1
PRT,VNM,2017.0,2,0,2
AUS,BRB,2011.0,1,0,1
SWE,CRI,2023.0,1,0,1
GEO,NLD,2012.0,2,0,2
FJI,ITA,2018.0,1,0,1
NOR,HRV,2015.0,1,0,1
TJK,JPN,2012.0,1,0,1
MOZ,SLE,2022.0,1,0,1
CUB,MOZ,2013.0,1,0,1
IND,NAM,2020.0,1,0,1
MAR,CIV,2013.0,1,0,1
LBY,SAU,2020.0,1,0,1
AUS,KAZ,2012.0,1,0,1
NPL,CZE,2012.0,1,0,1
JAM,NZL,2016.0,1,0,1
KOR,GRC,2019.0,1,0,1
HRV,IRL,2022.0,2,0,2
AZE,CHE,2021.0,1,0,1
PRT,IRQ,2020.0,1,0,1
CMR,GAB,2023.0,1,0,1
BHR,DEU,2018.0,1,0,1
NGA,SLE,2021.0,2,0,2
IRQ,UZB,2020.0,1,0,1
ISR,KOR,1998.0,1,0,1
SLB,USA,2021.0,1,0,1
ROU,ISL,2019.0,1,0,1
IRQ,MYS,2008.0,1,0,1
BEL,PSE,2003.0,1,0,1
SGP,BEL,2003.0,1,0,1
CUB,NOR,2008.0,1,0,1
ITA,PHL,2001.0,1,0,1
MUS,USA,2002.0,1,0,1
URY,PRY,2009.0,1,0,1
BGR,SVN,2009.0,1,0,1
HND,,2002.0,2,0,2
ETH,CAN,1997.0,1,0,1
ITA,SGP,1997.0,1,0,1
KNA,,2012.0,1,0,1
BLR,AUS,2002.0,1,0,1
ARM,ESP,1998.0,1,0,1
,MSR,1999.0,1,0,1
BRA,PAN,2001.0,1,0,1
ESP,STP,2019.0,1,0,1
SAU,FRA,2005.0,2,0,2
BGR,UKR,2012.0,1,0,1
BEL,GUF,2018.0,1,0,1
SRB,QAT,2005.0,1,0,1
KEN,POL,2005.0,1,0,1
,WSM,1995.0,1,0,1
WSM,CHN,2012.0,1,0,1
DEU,COG,2010.0,1,0,1
VCT,CAN,2011.0,1,0,1
PYF,USA,2012.0,1,0,1
DNK,BHR,2021.0,1,0,1
BGD,SVN,2020.0,1,0,1
CIV,ROU,2014.0,1,0,1
BRN,BGR,2011.0,1,0,1
ALB,AUS,2007.0,1,0,1
ECU,RWA,2019.0,1,0,1
DEU,PRK,2014.0,1,0,1
SRB,LUX,2014.0,1,0,1
JPN,EST,2019.0,1,0,1
UGA,LBN,2016.0,1,0,1
CRI,PRI,2017.0,1,0,1
CUB,PRT,2000.0,1,0,1
ITA,CIV,2011.0,1,0,1
,LCA,1995.0,1,0,1
HUN,BLR,2020.0,1,0,1
NAM,POL,2023.0,1,0,1
NCL,JPN,2001.0,1,0,1
DEU,PSE,1999.0,1,0,1
LAO,CAN,2020.0,1,0,1
CZE,IDN,2016.0,1,0,1
SRB,MYS,2016.0,1,0,1
POL,ISL,2017.0,1,0,1
SAU,CYP,2011.0,1,0,1
ROU,ISR,2002.0,1,0,1
CHN,CYM,2019.0,1,0,1
SSD,,2016.0,3,0,3
GBR,TLS,2002.0,1,0,1
FRA,TZA,2004.0,1,0,1
ROU,NZL,2018.0,1,0,1
OMN,DZA,2006.0,1,0,1
ZWE,IRL,2017.0,1,0,1
SSD,,2017.0,2,0,2
MAR,LBY,2020.0,1,0,1
ZWE,NAM,2023.0,1,0,1
MAR,YEM,2017.0,1,0,1
ARG,NIC,2017.0,1,0,1
CHE,MDG,2017.0,1,0,1
TUR,NPL,2021.0,1,0,1
MWI,BEL,2019.0,1,0,1
GNQ,,2012.0,3,0,3
ZAF,ISL,2021.0,1,0,1
AZE,AUS,2017.0,1,0,1
CUB,ZWE,2017.0,1,0,1
BGR,KAZ,2020.0,3,0,3
HKG,TUR,2015.0,1,0,1
NGA,TWN,2020.0,4,0,4
FRA,GRD,2013.0,1,0,1
GMB,ESP,2020.0,1,0,1
CHE,HTI,2020.0,1,0,1
LKA,SAU,2021.0,1,0,1
ZAF,SVN,2018.0,1,0,1
SAU,PSE,2008.0,1,0,1
ARM,GRC,2019.0,1,0,1
CHE,TCD,2009.0,2,0,2
BRB,ISR,2019.0,1,0,1
ISR,BRB,2021.0,1,0,1
CAF,GBR,2019.0,2,0,2
MDA,BEL,2008.0,1,0,1
IRQ,ARE,2007.0,1,0,1
IND,LTU,2011.0,1,0,1
VEN,URY,2004.0,1,0,1
SYR,ETH,2014.0,1,0,1
SAU,TZA,2015.0,1,0,1
VEN,KOR,2018.0,1,0,1
CHN,SDN,2009.0,2,0,2
HUN,GEO,2011.0,1,0,1
DEU,QAT,2007.0,2,0,2
KOR,GRC,2009.0,1,0,1
KWT,BGD,2021.0,1,0,1
ECU,PRY,2013.0,2,0,2
USA,CPV,2009.0,1,0,1
MNG,CAN,2011.0,1,0,1
PER,JPN,1997.0,1,0,1
MKD,ESP,2021.0,1,0,1
UGA,KHM,2016.0,1,0,1
BRN,CHN,2000.0,1,0,1
DNK,IRQ,2019.0,2,0,2
CHL,PRI,2015.0,1,0,1
SYR,YEM,2022.0,1,0,1
GBR,ATG,2020.0,1,0,1
ROU,SVN,2022.0,1,0,1
PRI,CHE,2021.0,1,0,1
CYP,MNE,2018.0,1,0,1
IRN,UKR,1998.0,1,0,1
MOZ,GBR,2004.0,1,0,1
SSD,USA,2017.0,1,0,1
AUT,PRK,2017.0,1,0,1
CAN,COD,2021.0,6,0,6
BGD,KWT,2009.0,2,0,2
BIH,KWT,2021.0,1,0,1
LKA,BEL,2022.0,1,0,1
JOR,BRA,2023.0,1,0,1
SEN,GMB,2023.0,1,0,1
USA,SXM,2021.0,2,0,2
,UZB,2021.0,4,0,4
AUS,SVK,2010.0,1,0,1
AUS,GAB,2008.0,1,0,1
SDN,AUS,2006.0,1,0,1
ALB,NOR,2011.0,1,0,1
MEX,ARE,2011.0,1,0,1
ZWE,BRA,2009.0,1,0,1
UGA,CZE,2018.0,1,0,1
DEU,WSM,2013.0,1,0,1
TUR,BRA,2008.0,1,0,1
KEN,BRA,2007.0,1,0,1
MOZ,AUT,2009.0,1,0,1
TUN,KWT,2015.0,1,0,1
EST,GRC,2019.0,2,0,2
GBR,HND,2017.0,1,0,1
JPN,PER,1998.0,1,0,1
SYR,ARE,2005.0,1,0,1
PER,FIN,2014.0,1,0,1
IRQ,SWE,2007.0,1,0,1
ETH,LAO,2013.0,1,0,1
PNG,SSD,2020.0,1,0,1
MEX,MDA,2016.0,1,0,1
MDA,MEX,2020.0,1,0,1
BGD,AUT,2013.0,1,0,1
ARM,IRN,2015.0,4,0,4
LKA,SYR,2013.0,1,0,1
NGA,GIN,2013.0,1,0,1
BRA,GHA,2018.0,1,0,1
PNG,SGP,2003.0,1,0,1
JPN,EST,2021.0,3,0,3
GRC,TTO,2019.0,1,0,1
IRL,UGA,2015.0,1,0,1
BGR,ZWE,2018.0,1,0,1
KOR,BRN,2016.0,1,0,1
TUN,ROU,2017.0,1,0,1
MAR,RWA,2018.0,1,0,1
USA,CAF,2015.0,2,0,2
TCD,USA,2013.0,1,0,1
URY,CAN,2017.0,1,0,1
PAK,SDN,2014.0,1,0,1
BDI,,2010.0,1,0,1
MEX,KOR,2012.0,1,0,1
IND,BFA,2019.0,1,0,1
SLE,ITA,2020.0,1,0,1
CMR,RUS,2022.0,2,0,2
VNM,COL,2022.0,2,0,2
PHL,AUT,2024.0,1,0,1
BHR,BEL,2023.0,1,0,1
NGA,UGA,2002.0,1,0,1
AGO,,2007.0,2,0,2
DEU,JAM,2015.0,1,0,1
NCL,USA,2009.0,1,0,1
USA,NCL,2014.0,1,0,1
MAR,LBN,2019.0,1,0,1
UZB,KAZ,2005.0,2,0,2
JPN,SVK,2006.0,1,0,1
SYR,LBN,2010.0,1,0,1
DNK,ARG,2009.0,1,0,1
EGY,IRL,1999.0,1,0,1
THA,HUN,1998.0,1,0,1
AUS,CRI,2003.0,1,0,1
NZL,PLW,2002.0,1,0,1
IDN,UGA,2009.0,1,0,1
JOR,BRA,2000.0,1,0,1
HKG,ZAF,2004.0,1,0,1
JPN,GEO,2003.0,1,0,1
DEU,KWT,2010.0,1,0,1
GIN,SEN,2002.0,1,0,1
FJI,FRA,2018.0,1,0,1
COG,GIN,2016.0,1,0,1
POL,BGR,2007.0,1,0,1
SVN,RUS,1997.0,2,0,2
IRL,BGR,1997.0,1,0,1
CUB,SRB,2002.0,1,0,1
SRB,CUB,2020.0,1,0,1
OMN,RUS,2021.0,1,0,1
ESP,SEN,2015.0,1,0,1
EGY,COM,2022.0,1,0,1
PAK,BWA,2015.0,1,0,1
BEN,SWE,2018.0,1,0,1
UKR,SRB,2020.0,1,0,1
SAU,VNM,2012.0,1,0,1
CMR,MLI,2013.0,1,0,1
RUS,NZL,2013.0,3,0,3
MAR,EGY,2013.0,1,0,1
GAB,CHE,2022.0,1,0,1
UKR,SVN,2013.0,1,0,1
MAR,YEM,2016.0,3,0,3
MLI,VNM,2016.0,1,0,1
QAT,EST,2018.0,1,0,1
ROU,TUR,2008.0,2,0,2
VIR,,2023.0,4,0,4
TUR,SDN,2015.0,1,0,1
FRA,RWA,2018.0,1,0,1
CHN,UGA,2004.0,1,0,1
MLT,SVK,2010.0,1,0,1
VEN,URY,2015.0,2,0,2
HRV,QAT,2019.0,1,0,1
SWE,GIN,2016.0,1,0,1
SWE,CRI,2006.0,1,0,1
MAR,PER,2022.0,1,0,1
BHS,DEU,2015.0,1,0,1
DZA,SGP,2018.0,1,0,1
TUN,DNK,2008.0,1,0,1
SVK,ESP,2015.0,1,0,1
VNM,CMR,2015.0,1,0,1
,SSD,2006.0,1,0,1
DEU,AGO,2019.0,1,0,1
CCK,,2019.0,1,0,1
THA,SOM,2018.0,1,0,1
NPL,AUT,2017.0,1,0,1
KNA,TTO,2009.0,1,0,1
USA,STP,2020.0,1,0,1
VEN,CRI,2020.0,1,0,1
HKG,NLD,2001.0,1,0,1
LUX,PER,2023.0,1,0,1
CAN,ZMB,2018.0,2,0,2
PAK,GRC,2013.0,1,0,1
RUS,CUB,2021.0,1,0,1
NAM,PRT,2022.0,1,0,1
THA,COD,2021.0,3,0,3
MLT,BEL,2020.0,1,0,1
NZL,CHL,2023.0,1,0,1
VEN,VNM,1999.0,2,0,2
DEU,MMR,2016.0,2,0,2
ISR,UZB,1999.0,1,0,1
ZWE,BEL,1998.0,2,0,2
TGO,,2000.0,6,0,6
EUE,ESP,2011.0,2,0,2
ERI,NLD,2005.0,1,0,1
NRU,FJI,2015.0,1,0,1
UKR,EST,2015.0,1,0,1
MKD,CHN,2016.0,2,0,2
IND,AFG,2016.0,1,0,1
LTU,CZE,2007.0,1,0,1
RUS,CIV,2004.0,1,0,1
NLD,NPL,2008.0,1,0,1
PHL,ZMB,2012.0,1,0,1
ZMB,MDG,2018.0,1,0,1
ITA,PRY,2014.0,2,0,2
FRA,AGO,2012.0,2,0,2
,MDV,2004.0,2,0,2
GTM,MEX,2008.0,1,0,1
ESP,ZWE,2022.0,2,0,2
BFA,LUX,2014.0,1,0,1
SRB,DNK,2019.0,1,0,1
FRA,BRB,2011.0,1,0,1
BRB,FRA,2012.0,1,0,1
MSR,OMN,2002.0,1,0,1
PHL,ETH,2022.0,1,0,1
LIE,AUS,2010.0,2,0,2
GAB,COG,2008.0,1,0,1
THA,TWN,2001.0,1,0,1
BRA,MDA,2021.0,1,0,1
BLR,LBY,2020.0,1,0,1
AGO,ITA,2022.0,1,0,1
GRC,UGA,2020.0,1,0,1
AFG,HUN,2021.0,1,0,1
SAU,POL,2024.0,1,0,1
MYS,ISL,2018.0,1,0,1
PAK,AFG,2005.0,1,0,1
TCD,CHE,2022.0,1,0,1
KEN,PAK,2022.0,2,0,2
BIH,EST,2019.0,1,0,1
LBY,SRB,2023.0,1,0,1
ISR,ARE,2000.0,1,0,1
TWN,MYS,2005.0,1,0,1
USA,NER,2004.0,3,0,3
SRB,BEL,1997.0,1,0,1
YEM,OMN,2008.0,1,0,1
POL,LUX,2009.0,1,0,1
GMB,ITA,2006.0,1,0,1
RUS,JOR,2006.0,1,0,1
BFA,RWA,2020.0,1,0,1
CHE,HND,1999.0,1,0,1
AUS,MDV,2004.0,1,0,1
DEU,PAN,1998.0,1,0,1
ROU,ZAF,2002.0,3,0,3
NZL,DZA,2002.0,1,0,1
USA,TCD,2001.0,1,0,1
FRA,PAN,2016.0,1,0,1
SLE,ESP,2018.0,1,0,1
NLD,DZA,2018.0,1,0,1
KAZ,NLD,2015.0,1,0,1
LTU,KOR,2014.0,1,0,1
ROU,NZL,2016.0,1,0,1
SRB,VNM,2017.0,1,0,1
ITA,LBR,2020.0,1,0,1
RUS,MAR,2021.0,1,0,1
SDN,PAK,2011.0,1,0,1
FRA,SYC,2013.0,1,0,1
NOR,SDN,2016.0,2,0,2
LIE,USA,2012.0,1,0,1
TWN,GMB,2016.0,1,0,1
CHL,BOL,1998.0,1,0,1
CHE,ZMB,2008.0,1,0,1
JOR,IDN,2012.0,1,0,1
PAK,PNG,2016.0,1,0,1
DZA,SAU,1998.0,1,0,1
TWN,SWZ,2015.0,1,0,1
GBR,POL,2024.0,1,0,1
SVK,SEN,2011.0,1,0,1
LBY,UZB,2001.0,1,0,1
FRA,DOM,2020.0,1,0,1
AUT,MEX,2006.0,1,0,1
BRA,ISL,2019.0,1,0,1
SDN,IRL,2019.0,1,0,1
USA,KGZ,2019.0,1,0,1
MYS,ISL,2022.0,1,0,1
ZAF,TGO,2019.0,1,0,1
ISR,ARE,2023.0,1,0,1
CHE,MEX,2023.0,1,0,1
LBR,PAK,2018.0,1,0,1
ARE,IRQ,2004.0,2,0,2
KHM,NCL,2019.0,1,0,1
MLT,USA,2005.0,1,0,1
DMA,ATG,2020.0,1,0,1
NPL,MUS,2015.0,1,0,1
UKR,NGA,2023.0,1,0,1
GRC,RUS,2024.0,1,0,1
JAM,JPN,2016.0,1,0,1
USA,GRD,2001.0,1,0,1
GBR,MAC,2007.0,1,0,1
BRA,TON,2017.0,1,0,1
JPN,LVA,2013.0,1,0,1
CZE,LKA,2019.0,1,0,1
FIN,PER,2018.0,1,0,1
,ERI,2012.0,3,0,3
SEN,ESP,2016.0,1,0,1
NLD,BTN,2016.0,1,0,1
NOR,OMN,2021.0,1,0,1
DNK,MLT,2011.0,1,0,1
COG,ZMB,2017.0,1,0,1
BEL,PAN,2020.0,1,0,1
COG,BEN,2009.0,1,0,1
DEU,KGZ,2014.0,1,0,1
BTN,CHN,2018.0,1,0,1
JPN,TON,2019.0,1,0,1
NGA,KEN,2000.0,3,0,3
ZAF,CAF,2019.0,1,0,1
SGP,KWT,2022.0,1,0,1
BTN,,2014.0,1,0,1
ITA,PRK,2022.0,1,0,1
CUB,URY,2016.0,1,0,1
GRC,ECU,2016.0,1,0,1
BWA,JPN,2018.0,1,0,1
ZAF,SLE,2021.0,1,0,1
TGO,CAN,2022.0,1,0,1
TUR,MUS,2021.0,1,0,1
PAK,ISR,2016.0,1,0,1
PRI,CUB,2016.0,1,0,1
ISL,SRB,2006.0,1,0,1
PRT,BRN,2015.0,1,0,1
DNK,KOR,2006.0,2,0,2
ZWE,LKA,2023.0,1,0,1
NGA,UGA,2005.0,1,0,1
MEX,UZB,2014.0,1,0,1
MLI,IDN,2002.0,2,0,2
BGR,KWT,2010.0,1,0,1
BWA,NAM,2011.0,1,0,1
BDI,USA,2000.0,1,0,1
DNK,THA,1999.0,1,0,1
DEU,TTO,2009.0,1,0,1
SEN,RWA,2017.0,1,0,1
PER,ZAF,2011.0,1,0,1
UGA,NGA,1998.0,1,0,1
HKG,UKR,2007.0,1,0,1
COG,SEN,1998.0,1,0,1
GMB,CMR,2005.0,1,0,1
LKA,BRN,2008.0,1,0,1
KWT,SDN,2013.0,1,0,1
RUS,AGO,2005.0,1,0,1
NLD,BFA,2017.0,1,0,1
EGY,KEN,2007.0,1,0,1
CIV,BEN,2002.0,1,0,1
NGA,EGY,1997.0,1,0,1
ISL,SLB,2010.0,1,0,1
SWE,LUX,2007.0,1,0,1
UZB,TWN,2004.0,1,0,1
PLW,,2003.0,1,0,1
TUN,MRT,2006.0,1,0,1
NOR,PER,2010.0,1,0,1
ITA,ARM,2005.0,2,0,2
GBR,MDG,1998.0,1,0,1
PHL,CAN,2002.0,1,0,1
SRB,RUS,2024.0,1,0,1
IDN,CIV,2014.0,1,0,1
HRV,ZAF,2014.0,1,0,1
BGR,MCO,2003.0,1,0,1
MCO,VNM,2017.0,1,0,1
NZL,BRN,2020.0,1,0,1
SVN,NZL,2014.0,1,0,1
AUT,CHL,1998.0,2,0,2
NZL,IDN,2011.0,1,0,1
SUR,,2008.0,1,0,1
SDN,IRL,2011.0,1,0,1
UZB,FRA,2016.0,1,0,1
UGA,TTO,2006.0,1,0,1
USA,MMR,2005.0,1,0,1
DZA,,1999.0,3,0,3
AUS,FLK,2014.0,1,0,1
CHE,KAZ,2012.0,1,0,1
KAZ,CHE,2020.0,1,0,1
ESP,LUX,2007.0,1,0,1
RWA,LAO,2013.0,1,0,1
IRN,SDN,2007.0,1,0,1
SYC,CHE,2012.0,1,0,1
FIN,NPL,2008.0,1,0,1
ISR,ETH,2010.0,2,0,2
ETH,ISR,2018.0,1,0,1
AUS,PLW,2016.0,1,0,1
GRC,HKG,2013.0,2,0,2
PRT,CPV,2008.0,1,0,1
JPN,ETH,2013.0,2,0,2
IND,FJI,2000.0,1,0,1
UZB,OMN,2016.0,1,0,1
MKD,NLD,2007.0,1,0,1
TWN,JOR,2017.0,2,0,2
CHN,SEN,2006.0,1,0,1
GLP,BRA,2008.0,1,0,1
THA,BRA,2013.0,1,0,1
SVN,IRL,2014.0,1,0,1
PHL,RUS,2016.0,1,0,1
CHE,MDG,2018.0,1,0,1
HKG,POL,2023.0,1,0,1
NIC,COL,2020.0,1,0,1
BGR,EGY,2012.0,2,0,2
VNM,MWI,2020.0,1,0,1
NLD,KGZ,2023.0,1,0,1
SAU,LSO,2018.0,1,0,1
BDI,SWE,2017.0,1,0,1
SLE,SDN,2020.0,1,0,1
LVA,CZE,2021.0,1,0,1
GHA,ARE,2020.0,1,0,1
MMR,CHE,2007.0,1,0,1
ESP,NPL,2021.0,1,0,1
FRA,MNE,2022.0,2,0,2
ZAF,CAF,2021.0,3,0,3
HUN,BIH,2021.0,1,0,1
FJI,NLD,2023.0,1,0,1
EUE,,2025.0,1,0,1
GHA,CIV,2023.0,1,0,1
IRN,ISL,2023.0,1,0,1
CAN,SYR,2008.0,1,0,1
ISR,ARM,2006.0,1,0,1
PHL,MOZ,2009.0,1,0,1
PYF,USA,2002.0,2,0,2
GBR,BFA,2003.0,1,0,1
BLR,BRA,2000.0,3,0,3
CAN,LAO,2010.0,1,0,1
TZA,MDG,1998.0,1,0,1
GHA,ITA,2009.0,1,0,1
MMR,MYS,2009.0,1,0,1
ETH,FIN,2003.0,1,0,1
BDI,,2006.0,2,0,2
ITA,BOL,2011.0,2,0,2
BEN,TGO,2013.0,1,0,1
DZA,PRT,2000.0,1,0,1
AUT,SEN,2007.0,1,0,1
SVN,BGR,2008.0,1,0,1
BGR,BLR,2001.0,1,0,1
MEX,NPL,2001.0,1,0,1
DZA,ESP,2000.0,1,0,1
LKA,UZB,2001.0,1,0,1
SWE,LKA,1998.0,1,0,1
JPN,CUB,1997.0,1,0,1
GAB,CAF,2002.0,1,0,1
CHE,LIE,2001.0,2,0,2
KEN,ERI,1997.0,1,0,1
TUR,TTO,2008.0,1,0,1
GRC,OMN,2018.0,1,0,1
MLI,JAM,2006.0,1,0,1
,MSR,2007.0,1,0,1
TWN,QAT,2015.0,1,0,1
TWN,QAT,2014.0,1,0,1
COL,SYR,2006.0,1,0,1
FRA,BRN,2006.0,1,0,1
GBR,GAB,2019.0,2,0,2
IRN,SVN,2012.0,2,0,2
LAO,CHE,2012.0,1,0,1
BRA,AGO,2013.0,1,0,1
FRA,KWT,2013.0,3,0,3
VNM,MOZ,2010.0,1,0,1
DNK,PSE,2009.0,1,0,1
GTM,CUB,2007.0,1,0,1
POL,LUX,2019.0,1,0,1
,SOM,2007.0,2,0,2
CUB,GLP,2000.0,1,0,1
CYM,ESP,2013.0,1,0,1
ARE,BRA,2017.0,1,0,1
MYS,KGZ,2018.0,1,0,1
GTM,NOR,2023.0,1,0,1
,GIB,1997.0,1,0,1
JOR,SWE,2009.0,1,0,1
,GUY,2006.0,1,0,1
LKA,NPL,2012.0,1,0,1
VEN,NOR,2016.0,1,0,1
LTU,BLR,2010.0,1,0,1
MNG,MYS,2010.0,1,0,1
PER,AUT,2013.0,1,0,1
FRO,CHN,2013.0,1,0,1
PRK,CHN,2013.0,2,0,2
LBN,CHN,2024.0,1,0,1
FRA,GMB,2021.0,2,0,2
AFG,QAT,2015.0,1,0,1
ZWE,AUS,2010.0,1,0,1
KOR,OMN,2016.0,1,0,1
DEU,SHN,2020.0,1,0,1
TWN,ARE,2015.0,1,0,1
,AIA,2010.0,1,0,1
LKA,POL,2014.0,1,0,1
UZB,ESP,2018.0,1,0,1
VEN,CAN,2015.0,1,0,1
POL,LTU,1998.0,1,0,1
GBR,GUY,2005.0,1,0,1
TZA,ZMB,2015.0,1,0,1
ISR,MLT,2021.0,1,0,1
BEN,KEN,2018.0,1,0,1
UGA,THA,2013.0,1,0,1
CHE,SLB,2004.0,1,0,1
ARE,LBY,2022.0,1,0,1
NPL,MYS,2022.0,1,0,1
IRN,JPN,2024.0,1,0,1
HKG,ARE,2021.0,2,0,2
SVN,SGP,2019.0,1,0,1
NPL,FIN,2017.0,1,0,1
PER,IDN,2019.0,1,0,1
GLP,USA,2015.0,2,0,2
PRI,TTO,2011.0,1,0,1
IND,CIV,2020.0,1,0,1
IND,ARG,2019.0,1,0,1
CHL,EST,2022.0,1,0,1
ARG,CRI,2008.0,1,0,1
PHL,ZAF,2018.0,1,0,1
HRV,LUX,2016.0,1,0,1
DOM,CRI,2018.0,1,0,1
CHL,KOR,2024.0,1,0,1
AZE,GRC,2020.0,1,0,1
GRC,AZE,2022.0,1,0,1
RUS,MNE,2012.0,1,0,1
CHN,ZAF,2000.0,1,0,1
CYP,NOR,2012.0,1,0,1
BGD,ESP,2003.0,1,0,1
FRA,BWA,2012.0,1,0,1
SYC,NLD,2017.0,1,0,1
PRY,CHE,2012.0,1,0,1
DJI,,2006.0,1,0,1
JOR,SYR,2005.0,1,0,1
BGD,SGP,2004.0,2,0,2
BRA,ZAF,2007.0,1,0,1
MLT,ESP,2017.0,1,0,1
BGR,JPN,2023.0,1,0,1
IND,MDV,2008.0,1,0,1
KEN,SWZ,2008.0,1,0,1
PSE,,2002.0,1,0,1
GAB,BEN,2001.0,2,0,2
MHL,NCL,2010.0,1,0,1
PER,FIN,2008.0,1,0,1
ERI,NLD,2012.0,1,0,1
HRV,SWE,2012.0,1,0,1
CIV,COG,2012.0,1,0,1
BGR,THA,1998.0,1,0,1
AUT,CMR,2018.0,1,0,1
PAN,PSE,2019.0,1,0,1
SAU,PHL,2017.0,1,0,1
POL,MKD,2022.0,1,0,1
LBR,NZL,2018.0,1,0,1
HUN,EST,2018.0,1,0,1
NLD,LTU,2015.0,1,0,1
MRT,NER,2019.0,1,0,1
ISR,IDN,2018.0,1,0,1
MSR,ESP,2016.0,1,0,1
NGA,IDN,2017.0,1,0,1
BHS,JAM,2020.0,1,0,1
MMR,NZL,2019.0,1,0,1
ARG,KEN,2019.0,1,0,1
SRB,NLD,2022.0,2,0,2
ALB,ARM,2015.0,1,0,1
ERI,CAF,2009.0,1,0,1
CAF,NAM,2010.0,1,0,1
NCL,DEU,2022.0,1,0,1
ZMB,BEN,2023.0,1,0,1
CYP,ROU,2021.0,1,0,1
MEX,FJI,2023.0,1,0,1
ZMB,COG,2011.0,2,0,2
SYR,ISR,2022.0,1,0,1
LVA,FRA,2009.0,1,0,1
NPL,NOR,2000.0,1,0,1
TUN,PSE,2021.0,1,0,1
CZE,ETH,2023.0,1,0,1
IRN,LBN,2020.0,2,0,2
DNK,UGA,2015.0,1,0,1
NZL,RWA,2021.0,1,0,1
BTN,CHN,2022.0,1,0,1
MNE,DEU,2019.0,1,0,1
PRT,KWT,2023.0,1,0,1
NPL,PAK,2019.0,1,0,1
MEX,NIC,2019.0,2,0,2
MAR,CAF,2023.0,1,0,1
THA,FSM,2023.0,1,0,1
PAK,DNK,2024.0,1,0,1
SAU,LBN,1997.0,1,0,1
MOZ,GBR,2001.0,1,0,1
SAU,HUN,1997.0,1,0,1
NRU,,2013.0,1,0,1
SLV,HND,2013.0,1,0,1
CRI,VEN,2009.0,1,0,1
HKG,EGY,2002.0,1,0,1
BOL,CUB,2001.0,1,0,1
BRB,CHE,2001.0,1,0,1
URY,AUS,2004.0,1,0,1
AUT,ECU,2013.0,1,0,1
SOM,CHE,1997.0,1,0,1
MYS,PER,2021.0,1,0,1
SVK,AZE,2021.0,1,0,1
CAN,EST,2003.0,1,1,0
BRA,KOR,2023.0,1,5,-4
ESP,ROU,2000.0,1,4,-3
ITA,PAK,2024.0,1,1,0
KHM,MYS,2016.0,1,2,-1
PER,CHL,2006.0,1,4,-3
KAZ,SGP,2022.0,1,1,0
KOR,MEX,2022.0,2,1,1
ESP,MYS,2012.0,1,2,-1
JOR,CHN,2022.0,2,6,-4
BDI,BEL,2023.0,1,2,-1
IRL,LBY,2014.0,1,1,0
TUR,TWN,2023.0,1,5,-4
NOR,ROU,2008.0,1,2,-1
JOR,CAN,2010.0,4,13,-9
MMR,AUS,2016.0,1,1,0
PSE,GBR,2008.0,1,4,-3
SWE,ETH,2006.0,2,3,-1
FIN,THA,2008.0,1,2,-1
KWT,IRN,2018.0,1,2,-1
PRT,MAC,2019.0,1,1,0
ECU,CUB,2016.0,2,28,-26
LTU,DNK,2023.0,3,2,1
BEL,PER,2017.0,2,6,-4
JOR,CHN,2018.0,1,1,0
CHN,TUR,2010.0,1,4,-3
SLV,MEX,2011.0,1,2,-1
QAT,AUT,2014.0,1,1,0
DNK,SVK,2011.0,1,3,-2
KAZ,UZB,2017.0,1,4,-3
COL,UGA,2023.0,1,1,0
CAN,MLT,2019.0,1,1,0
JAM,BRB,2003.0,1,1,0
ITA,KEN,2021.0,2,4,-2
DZA,DNK,2022.0,1,1,0
ECU,CUB,2017.0,3,26,-23
DZA,GBR,2016.0,2,7,-5
JOR,FRA,2019.0,1,4,-3
ESP,KEN,2019.0,1,3,-2
ETH,ISR,2020.0,1,1,0
BRB,AUS,2013.0,1,1,0
ZAF,GRC,2012.0,2,1,1
MCO,AUS,2013.0,1,1,0
DEU,TTO,2015.0,1,1,0
USA,ASM,2008.0,1,3,-2
TTO,VEN,2004.0,1,1,0
EST,IRL,2022.0,1,1,0
ESP,UKR,1999.0,1,3,-2
IDN,GBR,2005.0,1,7,-6
MEX,TWN,2020.0,1,1,0
ESP,PRT,2024.0,2,2,0
MDV,AUS,2018.0,2,1,1
GHA,BEL,2016.0,1,2,-1
CHE,HUN,2023.0,2,5,-3
BRN,NGA,2022.0,1,1,0
SVN,HUN,2002.0,1,2,-1
NER,NGA,1997.0,1,2,-1
MAR,IRQ,2021.0,2,1,1
DEU,PRK,2011.0,1,1,0
OMN,PAK,2003.0,1,1,0
SAU,MAR,2012.0,2,4,-2
TZA,JPN,2006.0,1,4,-3
THA,KOR,2006.0,2,2,0
OMN,DEU,2014.0,1,4,-3
KAZ,NOR,2018.0,2,1,1
BRA,VEN,1997.0,1,2,-1
CHE,BGD,2001.0,1,3,-2
THA,FRA,1999.0,1,3,-2
CRI,NLD,2012.0,1,2,-1
QAT,IRQ,2019.0,1,3,-2
CHN,NZL,2024.0,1,1,0
FRA,SYR,1999.0,1,1,0
OMN,JOR,2008.0,1,3,-2
EST,ARM,2018.0,1,1,0
AUS,LTU,2022.0,1,2,-1
IND,IRQ,2015.0,7,1,6
CAF,CMR,2010.0,1,2,-1
ZWE,NLD,2019.0,2,3,-1
USA,MKD,2022.0,3,3,0
EGY,ITA,2001.0,1,3,-2
PAN,COL,2017.0,2,1,1
ZAF,SWE,2015.0,9,4,5
FRA,GRD,2021.0,1,1,0
RUS,SAU,2019.0,6,4,2
TWN,UKR,2003.0,2,2,0
MWI,COG,2013.0,1,1,0
UKR,AUT,2006.0,2,1,1
ARM,RUS,2003.0,5,12,-7
MCO,FRA,2014.0,4,13,-9
ARE,PAK,2005.0,5,3,2
BEN,ZAF,2004.0,2,1,1
PRI,FJI,2008.0,1,1,0
TUR,SAU,2004.0,1,1,0
TZA,ETH,2011.0,1,1,0
IDN,THA,2010.0,2,6,-4
CYP,NLD,2014.0,4,1,3
DEU,BEN,2001.0,1,4,-3
CAN,IDN,2014.0,3,3,0
FIN,CHN,1999.0,5,6,-1
GRC,POL,2008.0,1,1,0
MOZ,ZAF,2009.0,1,1,0
AUT,LTU,2023.0,1,2,-1
JPN,SYR,2007.0,1,1,0
UGA,AUS,2015.0,3,1,2
USA,DMA,2012.0,3,1,2
HRV,FRA,2014.0,5,7,-2
SWE,ISR,2015.0,4,3,1
ZAF,ZWE,2008.0,2,29,-27
EGY,AUS,1999.0,1,2,-1
NZL,SAU,2014.0,4,1,3
PSE,MYS,2015.0,2,9,-7
MNE,SRB,2012.0,3,5,-2
PER,JPN,2016.0,1,2,-1
LIE,DEU,2018.0,3,1,2
SVN,SLV,2021.0,1,7,-6
CMR,USA,2014.0,2,12,-10
USA,SLB,2022.0,1,1,0
BGD,NOR,2001.0,1,1,0
GBR,QAT,1999.0,3,1,2
KWT,EGY,2010.0,6,9,-3
NZL,FIN,2020.0,4,1,3
COL,BEL,2011.0,4,3,1
ESP,ARE,2023.0,4,3,1
FRA,MAC,2014.0,1,1,0
KEN,MOZ,2018.0,3,1,2
ESP,ETH,2017.0,3,4,-1
LBY,LBN,2017.0,1,1,0
ZMB,NLD,2018.0,1,2,-1
PHL,FIN,2013.0,1,2,-1
NZL,KEN,2017.0,2,1,1
EGY,PER,2020.0,1,1,0
THA,KOR,2009.0,2,5,-3
SAU,LBN,2022.0,3,9,-6
MLI,USA,2010.0,3,4,-1
KWT,IND,2012.0,1,2,-1
AUT,THA,2001.0,1,2,-1
ESP,SGP,2009.0,3,2,1
MEX,NZL,2005.0,1,2,-1
EST,DEU,2008.0,4,7,-3
BEL,TZA,2012.0,2,1,1
THA,IRL,2014.0,2,1,1
PAK,CHE,2023.0,5,2,3
LIE,CHE,2023.0,1,3,-2
KHM,PHL,2018.0,1,2,-1
MLT,GBR,1998.0,3,4,-1
KEN,UGA,2008.0,2,5,-3
AUS,KAZ,2017.0,1,2,-1
VNM,NOR,2021.0,2,2,0
PRT,GRC,2016.0,2,5,-3
TUR,CYP,2003.0,2,2,0
CHE,PAK,1997.0,1,1,0
MLI,FRA,2003.0,2,3,-1
POL,ROU,2002.0,4,3,1
USA,ZMB,1999.0,1,3,-2
THA,DEU,2002.0,4,11,-7
PRT,SAU,2012.0,3,1,2
CHE,ARG,2013.0,7,10,-3
CUB,JPN,2004.0,2,1,1
CAN,URY,2015.0,1,1,0
QAT,KWT,2017.0,1,1,0
JAM,TTO,2012.0,1,5,-4
AUS,PNG,2008.0,6,2,4
SYR,DEU,2010.0,2,2,0
ITA,YEM,2022.0,1,1,0
POL,MAR,2022.0,2,1,1
AUT,ETH,2021.0,2,1,1
MEX,BEL,2020.0,3,8,-5
RWA,FRA,2022.0,3,1,2
MDA,RUS,2001.0,2,1,1
SWE,CHL,2007.0,2,2,0
SGP,ARE,2011.0,6,1,5
HUN,FIN,1999.0,2,1,1
GBR,MSR,2007.0,2,1,1
ISL,CHE,2020.0,1,1,0
CHE,SRB,2003.0,2,3,-1
ROU,IRL,2021.0,1,2,-1
BRA,MAC,2013.0,1,1,0
FRA,COG,2012.0,8,4,4
DNK,LKA,2011.0,1,1,0
BEL,COD,2016.0,2,2,0
NLD,ISL,2020.0,1,3,-2
ETH,KOR,2020.0,4,14,-10
NLD,AFG,2017.0,1,1,0
IRN,GRC,2019.0,1,1,0
COL,PRI,2013.0,1,1,0
GHA,HKG,2022.0,1,5,-4
CMR,SEN,2021.0,1,4,-3
DEU,GBR,2024.0,4,2,2
JPN,ESP,1999.0,9,7,2
TUR,PRT,2015.0,2,4,-2
DZA,CAN,2009.0,2,6,-4
ARG,CRI,2023.0,2,1,1
PRT,NZL,2017.0,1,3,-2
FRA,LAO,2019.0,2,5,-3
PRT,JPN,2008.0,2,2,0
CZE,IRL,2015.0,4,3,1
CZE,PRT,2014.0,3,3,0
UGA,KEN,2001.0,1,4,-3
ISR,SGP,2019.0,6,7,-1
FRA,CRI,2010.0,1,2,-1
MAR,DEU,2004.0,2,3,-1
KHM,LAO,2007.0,1,1,0
ARM,FRA,2014.0,1,3,-2
URY,CHL,2018.0,2,2,0
IND,CYM,2010.0,1,1,0
YEM,EGY,2018.0,1,9,-8
AUT,IRL,2023.0,2,6,-4
CAN,HRV,2018.0,3,3,0
SRB,NOR,2001.0,1,1,0
CAN,IDN,2008.0,5,1,4
ITA,MEX,2006.0,2,4,-2
GHA,MYS,2020.0,3,7,-4
CHL,CRI,2023.0,1,1,0
BGD,OMN,2023.0,1,1,0
IDN,CAN,2023.0,4,1,3
ARG,ZAF,2018.0,1,2,-1
TJK,RUS,2023.0,1,1,0
ETH,AUT,2021.0,1,2,-1
ARE,PAK,2012.0,3,5,-2
BGR,USA,2023.0,2,5,-3
COL,BRA,2000.0,3,7,-4
ARE,NLD,2003.0,1,1,0
UKR,FIN,2003.0,2,1,1
SGP,DEU,1998.0,2,6,-4
TZA,UGA,2016.0,1,3,-2
PRT,ARG,2011.0,2,3,-1
IDN,PER,2012.0,2,1,1
AUT,IND,2023.0,4,11,-7
EST,NLD,2017.0,2,3,-1
KEN,PER,2020.0,1,5,-4
ZAF,PAK,2019.0,1,4,-3
PSE,NOR,2020.0,1,4,-3
USA,MAR,2023.0,5,13,-8
MKD,MNE,2020.0,3,1,2
JPN,BTN,2021.0,3,1,2
NAM,IRL,2021.0,1,1,0
SDN,JPN,2016.0,1,2,-1
ZAF,CAF,2013.0,2,1,1
CYM,GBR,2009.0,2,1,1
CZE,ISR,2007.0,3,1,2
CHL,CRI,2000.0,1,2,-1
POL,SVN,2023.0,4,1,3
ESP,JOR,2020.0,4,2,2
AUS,ROU,2021.0,1,2,-1
JAM,GRD,2017.0,1,1,0
GBR,BMU,2010.0,1,2,-1
CHN,MYS,2008.0,3,8,-5
ETH,BEL,2013.0,5,3,2
SWE,EGY,2009.0,3,1,2
TTO,USA,2023.0,2,3,-1
GHA,ZAF,2013.0,6,5,1
BEN,FRA,2023.0,5,6,-1
GEO,RUS,2022.0,1,9,-8
SRB,CAN,2014.0,1,4,-3
VNM,BEL,2018.0,3,19,-16
SEN,MLI,2011.0,1,3,-2
MSR,USA,2018.0,1,1,0
TUR,LBY,2022.0,3,1,2
TZA,JPN,2009.0,2,3,-1
SAU,BGD,2009.0,3,3,0
TUN,DEU,2023.0,3,5,-2
BEL,NGA,2018.0,1,1,0
IND,LKA,2008.0,1,5,-4
AUS,KEN,2005.0,1,3,-2
JPN,NPL,2015.0,9,3,6
FRA,SDN,2001.0,1,3,-2
HKG,ITA,1998.0,1,1,0
BMU,GBR,2012.0,1,1,0
UKR,AUT,2010.0,3,2,1
VNM,LAO,2022.0,2,1,1
THA,NZL,2009.0,2,3,-1
MAR,GAB,2015.0,2,1,1
QAT,HRV,2021.0,1,1,0
PHL,BGD,2022.0,3,1,2
CIV,THA,1999.0,1,0,1
UZB,AUT,2018.0,1,0,1
UKR,DNK,1998.0,1,0,1
CIV,NER,2007.0,1,0,1
KEN,LKA,2004.0,1,0,1
POL,ECU,2005.0,1,0,1
BLR,SAU,2011.0,1,0,1
VEN,HUN,1997.0,1,0,1
MCO,RUS,1999.0,1,0,1
USA,LAO,2002.0,1,0,1
IRN,HKG,2005.0,1,0,1
CMR,ZAF,1998.0,1,0,1
JPN,LAO,1999.0,1,0,1
TKM,ISR,2002.0,1,0,1
GBR,PSE,1997.0,1,0,1
SRB,UKR,2007.0,1,0,1
TUR,PRI,2000.0,1,0,1
ETH,MAR,2021.0,2,0,2
DNK,BIH,2013.0,1,0,1
TGO,CHE,2002.0,1,0,1
AZE,JPN,2020.0,1,0,1
TUR,HUN,2002.0,1,0,1
ARM,JOR,2009.0,1,0,1
NGA,NIC,2007.0,1,0,1
NIC,NGA,2010.0,1,0,1
SLB,JPN,2002.0,1,0,1
DEU,BFA,1997.0,1,0,1
GRC,TUN,2011.0,1,0,1
GBR,GRL,2006.0,1,0,1
GRL,DEU,2008.0,1,0,1
USA,GRL,2017.0,1,0,1
QAT,OMN,2009.0,2,0,2
,DMA,2004.0,1,0,1
RWA,BDI,2014.0,1,0,1
TUN,AUS,2013.0,1,0,1
DEU,BDI,2009.0,1,0,1
KOR,NGA,2011.0,1,0,1
MEX,NOR,2013.0,1,0,1
IRL,SDN,2014.0,1,0,1
IRN,NZL,2008.0,2,0,2
HKG,NOR,2007.0,1,0,1
HKG,FIN,2007.0,1,0,1
KEN,ITA,2007.0,1,0,1
VNM,ESP,2011.0,1,0,1
TJK,TZA,2012.0,1,0,1
HRV,SWE,2008.0,1,0,1
MWI,HTI,2017.0,1,0,1
PRT,VNM,2023.0,1,0,1
MAF,USA,2022.0,1,0,1
TUR,MKD,2023.0,1,0,1
ECU,AUT,2023.0,1,0,1
BRA,MLI,2023.0,1,0,1
VEN,PRT,2020.0,1,0,1
GRC,CHN,2024.0,1,0,1
SUR,USA,2020.0,1,0,1
CHE,ARM,2017.0,1,0,1
NPL,MYS,2010.0,1,0,1
BOL,CUB,2002.0,1,0,1
GNB,GMB,1999.0,1,0,1
CUB,ISR,2001.0,1,0,1
MOZ,NLD,1997.0,1,0,1
NOR,TWN,1999.0,1,0,1
PRI,DOM,2013.0,1,0,1
SLV,URY,2012.0,1,0,1
NLD,URY,2019.0,1,0,1
TWN,BGD,2012.0,1,0,1
MAC,FRA,2011.0,2,0,2
USA,CYM,2009.0,1,0,1
MLI,NLD,2008.0,2,0,2
IND,ZWE,2012.0,1,0,1
BEL,NIC,2018.0,1,0,1
TWN,HUN,2016.0,1,0,1
ESP,LSO,2014.0,1,0,1
MUS,CHN,2013.0,1,0,1
NLD,ZMB,2015.0,1,0,1
COD,ZWE,2022.0,1,0,1
TTO,DMA,2014.0,1,0,1
AUS,MLT,2012.0,1,0,1
ZWE,RWA,2023.0,2,0,2
PRT,PHL,2015.0,1,0,1
ETH,IRN,2014.0,1,0,1
PSE,ARE,2016.0,1,0,1
NOR,BOL,2015.0,1,0,1
LAO,DEU,2014.0,2,0,2
NGA,IRL,2021.0,2,0,2
ITA,HKG,2015.0,3,0,3
HKG,EST,2019.0,1,0,1
SEN,ITA,2013.0,1,0,1
TWN,MAR,2010.0,1,0,1
,TCA,2011.0,1,0,1
BOL,PER,2019.0,1,0,1
UGA,BDI,2011.0,1,0,1
AZE,DZA,2020.0,1,0,1
GHA,THA,2013.0,1,0,1
MAR,TWN,2021.0,1,0,1
MEX,HKG,2009.0,1,0,1
JAM,PER,2019.0,1,0,1
MEX,TWN,2023.0,1,0,1
VAT,USA,2014.0,1,0,1
IRL,ESP,2024.0,1,0,1
BRA,IRQ,2017.0,1,0,1
ZAF,MDG,2016.0,1,0,1
GMB,NLD,2014.0,1,0,1
VCT,USA,2022.0,1,0,1
TWN,LCA,2018.0,1,0,1
MUS,MWI,2012.0,1,0,1
CZE,BTN,2021.0,1,0,1
ITA,SWZ,2020.0,1,0,1
TTO,MYS,2023.0,1,0,1
IRL,LVA,2023.0,1,0,1
CYP,NLD,2016.0,1,0,1
BEL,VEN,2022.0,2,0,2
BRA,SVK,2021.0,1,0,1
,FLK,2019.0,1,0,1
BEN,AUT,2009.0,1,0,1
BLR,KAZ,2006.0,1,0,1
CZE,BGR,2007.0,1,0,1
SRB,PHL,2009.0,1,0,1
JPN,SYR,2009.0,1,0,1
NLD,MAR,2010.0,1,0,1
MDA,BGR,2023.0,1,0,1
NOR,NAM,2008.0,1,0,1
BHR,AUS,2002.0,1,0,1
MAR,MTQ,2016.0,1,0,1
MWI,MAR,2017.0,1,0,1
DNK,BLR,2007.0,1,0,1
ARE,MLT,2015.0,1,0,1
SWE,GHA,2002.0,2,0,2
HUN,MAR,2019.0,1,0,1
FIN,PER,2006.0,1,0,1
AUS,MWI,2013.0,1,0,1
GBR,PNG,1998.0,2,0,2
DEU,PAN,2003.0,1,0,1
FJI,HUN,2006.0,1,0,1
MDA,UZB,2004.0,1,0,1
BLR,NLD,2004.0,1,0,1
ZAF,LBY,2016.0,1,0,1
EGY,VNM,2018.0,1,0,1
COL,DEU,1998.0,1,0,1
EST,ALB,2017.0,1,0,1
SRB,IRN,2015.0,1,0,1
LKA,ITA,2002.0,1,0,1
CZE,CHL,2009.0,1,0,1
SWE,LIE,2007.0,1,0,1
SGP,MAC,2004.0,1,0,1
ROU,ISR,2014.0,1,0,1
ISR,ECU,2021.0,1,0,1
NOR,ISL,1997.0,2,0,2
AFG,NLD,2020.0,1,0,1
DEU,BEN,2022.0,1,0,1
NPL,BRN,2022.0,1,0,1
ALB,SVN,2017.0,1,0,1
ALB,SVN,2022.0,1,0,1
,BVT,2016.0,1,0,1
ARG,BHR,2021.0,1,0,1
SWE,CRI,2022.0,1,0,1
AUS,AGO,2011.0,1,0,1
TWN,ITA,2000.0,1,0,1
POL,VEN,1998.0,1,0,1
GNB,USA,1998.0,1,0,1
VEN,URY,2002.0,1,0,1
UGA,NZL,2011.0,1,0,1
NCL,NZL,2011.0,1,0,1
NER,MDG,2005.0,1,0,1
BRA,IRL,2000.0,1,0,1
AUS,SYR,1997.0,1,0,1
TWN,MYS,2004.0,1,0,1
CHL,PER,1998.0,1,0,1
KOR,MAC,2003.0,1,0,1
NPL,NAM,2011.0,1,0,1
EGY,IRL,2003.0,1,0,1
PYF,BFA,2013.0,1,0,1
ARM,TWN,2018.0,1,0,1
PNG,GBR,2008.0,2,0,2
FRA,ISL,2023.0,1,0,1
TCA,USA,2015.0,1,0,1
SGP,ARG,2023.0,1,0,1
CUB,NLD,2015.0,1,0,1
CMR,KOR,2012.0,1,0,1
NPL,IRN,2018.0,2,0,2
DZA,SDN,2010.0,1,0,1
ZAF,TUN,2011.0,1,0,1
NLD,AFG,2015.0,1,0,1
FIN,GEO,2012.0,1,0,1
GEO,KHM,2016.0,1,0,1
MEX,PRT,2006.0,1,0,1
ARE,ARM,2021.0,1,0,1
TWN,PSE,2016.0,1,0,1
ARG,SAU,2020.0,1,0,1
IRL,COL,2012.0,1,0,1
SGP,LUX,2020.0,1,0,1
SGP,QAT,2011.0,1,0,1
LUX,IDN,2020.0,1,0,1
CAN,LCA,2017.0,1,0,1
KWT,CHE,2016.0,1,0,1
FJI,CHE,2021.0,1,0,1
CHE,FJI,2023.0,1,0,1
GHA,CIV,2022.0,1,0,1
,VCT,2013.0,3,0,3
BEL,HKG,2007.0,1,0,1
MNE,ARE,2023.0,1,0,1
DEU,PRK,2012.0,1,0,1
GEO,IND,2018.0,1,0,1
SLE,JAM,1999.0,1,0,1
AFG,FIN,2019.0,1,0,1
UKR,NZL,2017.0,1,0,1
MYS,SLE,2021.0,1,0,1
WLF,FRA,2020.0,1,0,1
COG,CHN,2018.0,1,0,1
IRL,MEX,2022.0,1,0,1
WSM,BGD,2018.0,1,0,1
NGA,BDI,2022.0,1,0,1
SWE,IDN,2009.0,1,0,1
GBR,CAF,2018.0,1,0,1
IND,MAC,2022.0,1,0,1
BGD,CAN,2024.0,1,0,1
ECU,PRY,2020.0,1,0,1
CHE,MUS,2021.0,1,0,1
PRT,MAR,1999.0,1,0,1
IRQ,SDN,2003.0,1,0,1
,SHN,2017.0,1,0,1
OMN,IRL,2002.0,1,0,1
FIN,NZL,1997.0,1,0,1
NZL,ZMB,2013.0,1,0,1
NGA,LSO,2023.0,1,0,1
RUS,BGD,2000.0,1,0,1
MEX,AUT,1999.0,1,0,1
BRN,NZL,2002.0,1,0,1
RUS,TLS,2005.0,1,0,1
GHA,NZL,1999.0,1,0,1
NZL,GHA,2000.0,1,0,1
NLD,BRN,2011.0,1,0,1
GTM,ESP,2004.0,1,0,1
ARE,ITA,2002.0,1,0,1
LAO,IDN,2002.0,1,0,1
IND,PNG,2022.0,1,0,1
SWE,GRD,2001.0,1,0,1
GLP,BFA,2013.0,1,0,1
DNK,NPL,2002.0,1,0,1
DEU,PRI,2006.0,1,0,1
SYR,ARE,2004.0,1,0,1
KEN,SGP,2008.0,1,0,1
TZA,FIN,2001.0,1,0,1
GRC,LBN,2010.0,1,0,1
MOZ,MWI,2002.0,1,0,1
DEU,ERI,1999.0,1,0,1
USA,FRO,2008.0,1,0,1
USA,FRO,2014.0,1,0,1
ZAF,TZA,2005.0,1,0,1
MLT,IRL,2007.0,1,0,1
NIC,NLD,2020.0,1,0,1
CYM,ISL,2013.0,1,0,1
ISL,CYM,2017.0,1,0,1
GBR,PYF,2016.0,1,0,1
ROU,ARG,2009.0,1,0,1
SVK,IRL,2011.0,2,0,2
DEU,NIC,2010.0,1,0,1
PER,MWI,2017.0,1,0,1
MOZ,UGA,2010.0,1,0,1
BGR,ISR,2013.0,1,0,1
VIR,,2016.0,1,0,1
IRN,SYR,2013.0,1,0,1
JOR,PSE,1997.0,1,0,1
JPN,QAT,2013.0,1,0,1
MLI,BEN,2009.0,1,0,1
IND,BLR,2007.0,1,0,1
IRL,EST,2019.0,1,0,1
GEO,NZL,2012.0,1,0,1
JPN,CRI,2016.0,1,0,1
SGP,CYP,2016.0,1,0,1
THA,MAC,2021.0,1,0,1
CHE,CUB,2013.0,1,0,1
TUR,MAC,2019.0,1,0,1
SDN,UGA,2015.0,1,0,1
ESP,JOR,2011.0,1,0,1
JOR,ESP,2014.0,1,0,1
KGZ,ISR,2002.0,1,0,1
KOR,SDN,2018.0,1,0,1
MYS,SVN,2013.0,1,0,1
THA,CZE,2016.0,1,0,1
BWA,TZA,2012.0,1,0,1
CHN,KGZ,2014.0,1,0,1
GRC,ETH,2017.0,1,0,1
BWA,ZMB,2015.0,1,0,1
ZWE,LSO,2019.0,1,0,1
TWN,IRQ,2015.0,1,0,1
NER,VNM,2000.0,1,0,1
BHS,BRB,2019.0,1,0,1
BIH,BGR,2018.0,1,0,1
PER,UKR,2019.0,1,0,1
LBN,IRL,2022.0,2,0,2
BTN,KOR,2021.0,1,0,1
IRN,ZMB,1998.0,1,0,1
MYS,GUM,2023.0,1,0,1
CAN,DEU,2024.0,1,0,1
LIE,BEL,2021.0,1,0,1
SYC,AUS,2013.0,1,0,1
NOR,NIC,2003.0,1,0,1
ROU,ARE,2005.0,1,0,1
UGA,GRC,2021.0,1,0,1
SWE,NAM,2021.0,1,0,1
KHM,CHN,2020.0,1,0,1
KGZ,UZB,2023.0,1,0,1
ITA,KAZ,2024.0,1,0,1
IRQ,SRB,2023.0,1,0,1
BGD,HUN,2020.0,1,0,1
PRT,OMN,2017.0,1,0,1
ISR,SVN,2005.0,1,0,1
BOL,DNK,2023.0,1,0,1
,NAM,2021.0,1,0,1
CYP,EGY,2023.0,1,0,1
ROU,BGD,2023.0,1,0,1
NAM,,2004.0,1,0,1
ESP,MNE,2010.0,1,0,1
AUT,ETH,2007.0,1,0,1
ZAF,SRB,2004.0,1,0,1
CMR,ITA,2001.0,1,0,1
KAZ,PAK,2008.0,1,0,1
GRL,NOR,2005.0,1,0,1
GBR,FJI,2005.0,2,0,2
GTM,PAN,2001.0,1,0,1
CAN,ECU,2001.0,1,0,1
GBR,SEN,1998.0,2,0,2
BEN,CHE,2001.0,1,0,1
SDN,ZWE,1997.0,1,0,1
SEN,IND,2002.0,1,0,1
SEN,IND,2005.0,1,0,1
SRB,BRA,1999.0,2,0,2
OMN,FJI,2000.0,1,0,1
ITA,KEN,1997.0,2,0,2
FRA,LIE,2002.0,1,0,1
AUS,MUS,2000.0,1,0,1
HKG,QAT,2019.0,2,0,2
IRL,BRN,2009.0,1,0,1
ISR,BLR,2003.0,1,0,1
TUR,MLT,2015.0,1,0,1
BHR,JOR,1998.0,1,0,1
BWA,ITA,1997.0,1,0,1
FLK,ITA,2006.0,1,0,1
FLK,ITA,2010.0,1,0,1
SWE,PER,2007.0,2,0,2
MRT,USA,2005.0,1,0,1
SWZ,ZAF,2001.0,2,0,2
TUR,ALB,2008.0,1,0,1
KHM,CMR,2010.0,1,0,1
CUB,KNA,2007.0,1,0,1
CMR,CHN,2013.0,1,0,1
FRA,SWZ,2009.0,1,0,1
GRL,AUT,2019.0,1,0,1
NLD,KHM,2020.0,1,0,1
PER,TZA,2021.0,1,0,1
TUN,AZE,2010.0,1,0,1
ETH,PHL,2016.0,1,0,1
BGD,NZL,2003.0,1,0,1
SOM,CHE,2008.0,1,0,1
SYR,ESP,2008.0,1,0,1
AGO,ITA,2010.0,1,0,1
TZA,BFA,2008.0,1,0,1
AUS,PYF,2023.0,1,0,1
TUR,KAZ,2010.0,1,0,1
SAU,BWA,2021.0,1,0,1
CMR,GMB,2011.0,2,0,2
OMN,TUN,2023.0,1,0,1
ITA,TZA,2011.0,1,0,1
GBR,LVA,2005.0,1,0,1
VIR,,2017.0,1,0,1
CAN,MOZ,2020.0,1,0,1
TCD,GAB,2020.0,1,0,1
COL,PAK,2022.0,1,0,1
BGD,NPL,2019.0,1,0,1
NAM,MOZ,2022.0,1,0,1
HKG,NOR,1999.0,1,0,1
FRA,CRI,1997.0,1,0,1
CAN,ZMB,2000.0,1,0,1
DNK,MOZ,2012.0,1,0,1
KAZ,UKR,2005.0,1,0,1
NGA,MYS,1997.0,1,0,1
HUN,ZAF,2002.0,1,0,1
RUS,CHL,2007.0,1,0,1
BEL,PAN,2003.0,1,0,1
KAZ,VNM,2020.0,1,0,1
SWE,MOZ,2006.0,1,0,1
IDN,ZWE,2019.0,1,0,1
POL,CYP,2001.0,1,0,1
PER,BOL,2002.0,1,0,1
UKR,NOR,2012.0,1,0,1
AZE,MEX,1999.0,1,0,1
COL,DNK,2007.0,2,0,2
VEN,NOR,2010.0,1,0,1
SWE,JOR,2006.0,1,0,1
ESP,DMA,2015.0,1,0,1
MCO,SWE,2021.0,1,0,1
SEN,MRT,2006.0,1,0,1
AUS,LBN,2001.0,1,0,1
OMN,DZA,2018.0,1,0,1
ISR,SRB,2000.0,1,0,1
AUT,EST,2008.0,1,0,1
HUN,ETH,1998.0,1,0,1
QAT,BRA,2017.0,1,0,1
MAR,FIN,2015.0,1,0,1
COD,SGP,2010.0,1,0,1
LBN,NGA,2022.0,1,0,1
GHA,GMB,2018.0,1,0,1
GHA,GMB,2022.0,1,0,1
SVN,CAN,2019.0,1,0,1
URY,SLV,2017.0,1,0,1
GRD,BWA,2019.0,1,0,1
SVK,NOR,2023.0,1,0,1
KOR,ISL,2021.0,1,0,1
FIN,JOR,2018.0,1,0,1
ARM,CHL,2015.0,1,0,1
KEN,LUX,2020.0,1,0,1
GIN,RUS,2017.0,1,0,1
AUT,OMN,2020.0,1,0,1
LBN,IND,2020.0,1,0,1
HUN,THA,2022.0,1,0,1
CHE,DZA,2021.0,1,0,1
LBN,CZE,2019.0,1,0,1
MEX,CYM,2019.0,1,0,1
GBR,SLB,2021.0,1,0,1
KAZ,FIN,2020.0,1,0,1
PRY,PNG,2010.0,1,0,1
FIN,LUX,2001.0,2,0,2
PHL,SLV,2021.0,1,0,1
FIN,IRQ,2020.0,1,0,1
QAT,BHR,2023.0,1,0,1
BRA,ASM,2020.0,1,0,1
LKA,BTN,2021.0,1,0,1
ECU,AUS,2006.0,1,0,1
CHE,PNG,2008.0,1,0,1
GUY,NCL,2007.0,1,0,1
UKR,ROU,2010.0,1,0,1
ISR,PAK,2010.0,1,0,1
RUS,VNM,2007.0,1,0,1
BRN,ESP,2011.0,1,0,1
TUN,LBN,2003.0,1,0,1
SWE,ATA,2000.0,1,0,1
,SLE,2001.0,1,0,1
CRI,GTM,2003.0,1,0,1
DNK,URY,1997.0,1,0,1
NLD,GRD,2013.0,1,0,1
BWA,BHS,2019.0,1,0,1
BRB,NZL,1997.0,1,0,1
EGY,NZL,1998.0,1,0,1
BLR,NLD,2015.0,1,0,1
GHA,TUR,2016.0,1,0,1
URY,FLK,2018.0,1,0,1
BRN,CHN,2022.0,1,0,1
ZWE,SSD,2021.0,1,0,1
TUN,RUS,2018.0,1,0,1
GHA,BLZ,2018.0,1,0,1
FRA,LBR,2014.0,1,0,1
GBR,SLB,2019.0,1,0,1
TZA,NAM,2021.0,1,0,1
NGA,EGY,2008.0,1,0,1
CMR,BRA,2021.0,1,0,1
HRV,ISR,2022.0,1,0,1
UZB,CAN,2001.0,1,0,1
SWE,NIC,1998.0,2,0,2
BHR,HKG,2018.0,1,0,1
KWT,IRL,2022.0,1,0,1
GIN,IND,2015.0,1,0,1
TUR,BGD,2014.0,1,0,1
ARG,PHL,2021.0,1,0,1
PAK,POL,2013.0,1,0,1
ETH,SVN,2020.0,1,0,1
LBY,CHN,2023.0,1,0,1
JPN,IND,2024.0,1,0,1
ITA,MMR,2020.0,1,0,1
USA,AND,2022.0,1,0,1
BGR,CAN,2020.0,1,0,1
,HUN,2021.0,2,0,2
CUB,PER,2023.0,1,0,1
,YEM,2021.0,2,0,2
CHN,BHR,2023.0,2,0,2
KEN,ITA,1999.0,2,0,2
SRB,ZAF,2009.0,1,0,1
FRA,TUN,2024.0,1,0,1
HKG,EGY,2004.0,1,0,1
DEU,KWT,2018.0,1,0,1
SDN,LBY,2021.0,1,0,1
BEN,KEN,2023.0,1,0,1
CYP,BFA,2021.0,1,0,1
IRN,KWT,2016.0,1,0,1
HUN,COL,2000.0,1,0,1
BGD,UKR,1998.0,1,0,1
DNK,VNM,2001.0,1,0,1
KWT,TUR,2011.0,1,0,1
MYS,ITA,1998.0,1,0,1
GMB,BEL,2005.0,1,0,1
MTQ,USA,2000.0,1,0,1
USA,SUR,1998.0,1,0,1
LAO,CHE,2004.0,1,0,1
ESP,SEN,2005.0,1,0,1
TJK,KAZ,1997.0,1,0,1
DEU,IRQ,2009.0,1,0,1
UZB,JPN,2003.0,1,0,1
SVN,IRL,2002.0,1,0,1
JPN,MLT,2007.0,1,0,1
EGY,CZE,2000.0,1,0,1
DZA,COL,2001.0,1,0,1
JOR,NLD,2011.0,1,0,1
BEL,NER,2013.0,1,0,1
URY,NOR,2012.0,1,0,1
CHE,NAM,2022.0,1,0,1
MNE,NOR,2015.0,1,0,1
SGP,BRN,2014.0,1,0,1
BRA,LKA,2003.0,1,0,1
VEN,DNK,2013.0,1,0,1
LAO,MDG,2014.0,1,0,1
SRB,IRL,2013.0,1,0,1
VNM,NGA,2014.0,1,0,1
CHL,HND,2003.0,1,0,1
POL,CHL,2006.0,1,0,1
VNM,MYS,1998.0,1,0,1
VNM,ECU,2020.0,1,0,1
CHL,CRI,2002.0,1,0,1
SLE,ZAF,2008.0,1,0,1
AUS,MKD,2022.0,1,0,1
BIH,FRA,2014.0,1,0,1
CHE,MCO,2014.0,1,0,1
MEX,SVK,2019.0,1,0,1
QAT,CUB,2019.0,2,0,2
ALB,AZE,2016.0,1,0,1
TUN,ZAF,2022.0,1,0,1
MLT,CHL,2006.0,1,0,1
UKR,BHR,2019.0,1,0,1
TUN,MRT,2022.0,1,0,1
PAK,KHM,2022.0,1,0,1
JPN,FJI,2019.0,1,0,1
FRA,GTM,2019.0,2,0,2
TTO,ECU,2023.0,1,0,1
CRI,FIN,2011.0,1,0,1
VUT,FRA,2017.0,1,0,1
NLD,EST,2012.0,1,0,1
NCL,PYF,2009.0,1,0,1
FRA,PSE,2008.0,1,0,1
COL,RUS,2007.0,1,0,1
POL,GRL,2012.0,1,0,1
GBR,RWA,2007.0,1,0,1
KIR,FJI,2017.0,1,0,1
BWA,SYC,2021.0,1,0,1
TUN,VNM,2019.0,1,0,1
MNP,,2013.0,1,0,1
SWE,MAR,2003.0,1,0,1
MAR,SWE,2004.0,2,0,2
PRT,SAU,2010.0,1,0,1
BEL,GAB,2011.0,1,0,1
AUT,NAM,2018.0,1,0,1
CZE,SLE,2020.0,1,0,1
RUS,ETH,2018.0,1,0,1
COD,TZA,2022.0,1,0,1
LSO,USA,2017.0,1,0,1
BGR,LKA,2001.0,1,0,1
EGY,PNG,2020.0,1,0,1
SLB,KOR,2016.0,1,0,1
PAK,THA,2005.0,1,0,1
ARM,CAN,2008.0,2,0,2
ISR,LKA,2015.0,1,0,1
LBY,POL,2002.0,1,0,1
NOR,MOZ,1998.0,1,0,1
AUT,LIE,2007.0,1,0,1
MAC,FRA,2019.0,1,0,1
MYS,BIH,2017.0,1,0,1
,KNA,2011.0,1,0,1
BRA,GTM,2017.0,1,0,1
DEU,GMB,2020.0,1,0,1
PAN,POL,1999.0,1,0,1
LBY,CHE,2012.0,1,0,1
TUR,SDN,2005.0,1,0,1
ISL,CHE,2011.0,1,0,1
HRV,COL,2023.0,1,0,1
VEN,PRI,2023.0,1,0,1
LIE,FIN,2019.0,1,0,1
ISL,NZL,2023.0,1,0,1
SWE,ARM,2019.0,1,0,1
BRA,ROU,2019.0,1,0,1
HUN,ZAF,2005.0,1,0,1
UZB,POL,2010.0,1,0,1
SAU,ESP,2005.0,1,0,1
NIC,CRI,2000.0,1,0,1
ROU,KWT,1997.0,1,0,1
TTO,BHR,2004.0,1,0,1
LTU,BEL,1998.0,1,0,1
FIN,ISL,1998.0,1,0,1
ITA,MKD,2005.0,1,0,1
PRI,GRC,1998.0,1,0,1
KWT,RUS,2021.0,1,0,1
UKR,GEO,2006.0,1,0,1
ITA,ALB,2002.0,1,0,1
ISR,CYP,2023.0,1,0,1
CHE,GLP,2000.0,1,0,1
CMR,CHE,1997.0,1,0,1
MUS,AUS,2012.0,1,0,1
DNK,UGA,2012.0,1,0,1
COL,PHL,2010.0,1,0,1
TGO,CIV,1998.0,1,0,1
ETH,AUT,1999.0,1,0,1
BRN,TZA,2011.0,1,0,1
SAU,GHA,2001.0,1,0,1
BGR,ROU,2003.0,1,0,1
ZWE,CZE,2004.0,1,0,1
UZB,PRT,2008.0,1,0,1
NOR,ZWE,1998.0,1,0,1
TWN,SRB,2005.0,1,0,1
AZE,AUS,2010.0,1,0,1
MKD,SAU,2020.0,1,0,1
CMR,TGO,2013.0,1,0,1
MKD,FIN,2014.0,1,0,1
MAR,SGP,2012.0,1,0,1
TUR,LTU,2010.0,1,0,1
YEM,BHR,2010.0,1,0,1
MTQ,ITA,2014.0,1,0,1
FJI,SAU,2022.0,1,0,1
ARG,SVN,2011.0,1,0,1
,AFG,1999.0,1,0,1
AFG,FRA,2003.0,1,0,1
HTI,BFA,2020.0,1,0,1
CIV,TGO,2017.0,1,0,1
THA,ARE,2012.0,1,0,1
MWI,GHA,2023.0,1,0,1
TCD,MLI,2021.0,1,0,1
IRQ,JOR,2003.0,1,0,1
AZE,AUS,2006.0,1,0,1
LUX,IND,2016.0,1,0,1
NPL,QAT,2018.0,1,0,1
AFG,SRB,2008.0,1,0,1
CHE,SLE,2013.0,1,0,1
CHE,COD,2010.0,1,0,1
PNG,ESP,2013.0,1,0,1
PER,JPN,2008.0,1,0,1
COL,MYS,2016.0,1,0,1
LVA,AUT,2011.0,1,0,1
MAR,BGD,2018.0,1,0,1
AUT,KOR,1998.0,1,0,1
NGA,ALB,2021.0,1,0,1
USA,MSR,2016.0,1,0,1
OMN,SWE,2013.0,1,0,1
RUS,BGR,2024.0,1,0,1
FJI,CAN,2001.0,1,0,1
CMR,BWA,2000.0,1,0,1
BWA,SEN,2004.0,1,0,1
HRV,SAU,2016.0,1,0,1
ROU,AUS,2000.0,1,0,1
CYP,DZA,2020.0,1,0,1
DEU,MAC,2014.0,1,0,1
TUN,MRT,2017.0,1,0,1
NER,KEN,2001.0,1,0,1
ISR,CHN,2024.0,1,0,1
BRA,KEN,2020.0,1,0,1
ISL,KNA,2019.0,1,0,1
DEU,GUM,2007.0,1,0,1
PAK,MNG,2002.0,1,0,1
SVN,ARG,2003.0,1,0,1
PHL,SWE,2007.0,1,0,1
GHA,MEX,2021.0,1,0,1
KAZ,UKR,2002.0,1,0,1
FIN,ISL,2007.0,1,0,1
ZWE,ISR,1998.0,1,0,1
MLI,NLD,2001.0,1,0,1
URY,LBN,2013.0,1,0,1
PAK,MMR,2019.0,1,0,1
SDN,SYR,2007.0,1,0,1
NER,TUN,2006.0,1,0,1
GTM,MEX,2005.0,1,0,1
CIV,BEN,2001.0,1,0,1
SRB,UKR,1998.0,1,0,1
PRT,ECU,2011.0,1,0,1
ECU,PRT,2013.0,1,0,1
BOL,JPN,2000.0,1,0,1
FRA,LBY,2003.0,1,0,1
TGO,CAN,2006.0,1,0,1
COG,SWE,2020.0,1,0,1
SRB,TWN,2010.0,1,0,1
ESP,MCO,2018.0,1,0,1
MCO,ESP,2020.0,1,0,1
MLI,GBR,2004.0,1,0,1
GUF,USA,2007.0,1,0,1
TZA,UGA,2004.0,1,0,1
JPN,PRY,2007.0,1,0,1
SYR,QAT,2019.0,1,0,1
MEX,HND,2007.0,1,0,1
MDG,IND,2005.0,1,0,1
JOR,DZA,2011.0,1,0,1
QAT,IRN,2011.0,1,0,1
BEN,COG,2002.0,1,0,1
ETH,UGA,2008.0,1,0,1
TUN,CMR,2008.0,1,0,1
CMR,BFA,2022.0,1,0,1
GRC,KOR,2012.0,1,0,1
VUT,VNM,2008.0,1,0,1
AGO,BRA,2001.0,1,0,1
CZE,KOR,2000.0,1,0,1
PRI,ECU,2014.0,1,0,1
LIE,ESP,2007.0,1,0,1
BFA,ROU,1998.0,1,0,1
FJI,COL,2008.0,1,0,1
JAM,DEU,2008.0,1,0,1
MAR,PSE,2012.0,1,0,1
TZA,GHA,2016.0,1,0,1
IDN,NPL,2018.0,1,0,1
NGA,BWA,1998.0,1,0,1
ARG,IRN,2006.0,2,0,2
KAZ,OMN,2016.0,1,0,1
FJI,PHL,2003.0,1,0,1
KEN,GRC,2013.0,1,0,1
IDN,BGD,2016.0,1,0,1
TUR,GHA,2011.0,1,0,1
PRI,NLD,2009.0,1,0,1
VNM,VEN,2005.0,2,0,2
NLD,QAT,2006.0,1,0,1
VNM,AUT,2007.0,1,0,1
GTM,SLV,2018.0,1,0,1
BEL,CIV,2011.0,1,0,1
FIN,SVN,2020.0,1,0,1
LTU,AUS,2017.0,1,0,1
LBN,MEX,2020.0,1,0,1
ARE,BHR,2013.0,1,0,1
ZAF,SGP,2015.0,1,0,1
ITA,GAB,2019.0,1,0,1
ZWE,FRA,2006.0,1,0,1
GNQ,ESP,2007.0,1,0,1
BEL,CHE,2024.0,1,0,1
BHS,USA,2002.0,1,0,1
SYR,ITA,2006.0,1,0,1
HRV,ARE,2011.0,1,0,1
COM,ZAF,2012.0,1,0,1
GBR,YEM,2015.0,1,0,1
KWT,AUT,2020.0,1,0,1
USA,GUY,2019.0,1,0,1
LBN,SWE,2008.0,1,0,1
BEL,KNA,2017.0,1,0,1
HRV,ROU,2011.0,1,0,1
MDA,ESP,2019.0,1,0,1
HRV,KOR,2020.0,1,0,1
AUS,BWA,2022.0,1,0,1
IRL,TWN,2017.0,1,0,1
MWI,SDN,2015.0,1,0,1
FRA,PAK,2024.0,1,0,1
BGD,KAZ,2011.0,1,0,1
KAZ,BGD,2020.0,1,0,1
SOM,ETH,2012.0,1,0,1
GUF,KHM,2018.0,1,0,1
NOR,ALB,2021.0,1,0,1
NPL,VNM,2017.0,1,0,1
GBR,PLW,2017.0,1,0,1
BEL,SVK,2005.0,2,4,-2
ITA,URY,2013.0,1,2,-1
ECU,ARG,2012.0,1,1,0
HRV,ARE,2017.0,1,1,0
BLR,CHN,2009.0,1,2,-1
BEN,BEL,2005.0,1,4,-3
BEL,LBN,2016.0,2,3,-1
NOR,BIH,2010.0,1,2,-1
JPN,JOR,2011.0,1,2,-1
NPL,DEU,2013.0,1,5,-4
BOL,ESP,2023.0,1,1,0
VNM,SGP,2009.0,1,1,0
NOR,CHL,2016.0,1,4,-3
LIE,AUT,2015.0,1,2,-1
FRA,ARM,2013.0,2,1,1
RUS,PAK,2023.0,1,1,0
TUR,MYS,2015.0,1,11,-10
OMN,CHN,2021.0,1,4,-3
CRI,PAN,2021.0,2,1,1
CMR,ITA,2020.0,1,4,-3
PSE,ITA,2023.0,1,2,-1
FIN,ISR,2023.0,1,6,-5
EGY,TWN,2023.0,2,2,0
NOR,HUN,2011.0,1,2,-1
THA,IND,2000.0,2,2,0
FRO,DNK,2003.0,1,5,-4
NOR,ISR,1997.0,1,2,-1
SVK,SWE,2004.0,4,3,1
BFA,GBR,1997.0,1,1,0
SWE,UGA,1999.0,1,1,0
GHA,NGA,1997.0,1,1,0
POL,SVK,2004.0,2,4,-2
SGP,DNK,2004.0,1,1,0
IDN,CHE,2015.0,1,1,0
ISR,THA,2020.0,1,1,0
ITA,GHA,2000.0,1,1,0
PHL,LAO,2006.0,1,1,0
HRV,ITA,2004.0,1,2,-1
ARE,TUN,2004.0,2,1,1
IRL,HUN,2006.0,1,2,-1
MAR,ZAF,2016.0,2,1,1
HUN,LBY,1999.0,1,1,0
VEN,PRT,2004.0,1,1,0
AZE,DEU,2014.0,1,4,-3
PHL,CAN,1999.0,2,3,-1
POL,SRB,2005.0,1,4,-3
SDN,TWN,2017.0,1,1,0
TUN,JPN,2010.0,3,1,2
EST,SWE,2012.0,3,6,-3
PAN,IND,2013.0,1,2,-1
BRN,USA,2009.0,1,1,0
AUS,MAC,2014.0,1,1,0
ESP,EST,2009.0,2,4,-2
AUT,BGR,2017.0,1,1,0
MAR,DEU,2011.0,1,3,-2
DEU,NPL,2010.0,2,4,-2
KEN,BEL,2023.0,1,5,-4
GMB,ZAF,2019.0,1,3,-2
HKG,CZE,2018.0,1,2,-1
MWI,JPN,2014.0,1,1,0
CHE,MYS,2013.0,2,1,1
SVN,DNK,2008.0,1,3,-2
NOR,IRL,2012.0,1,3,-2
CHL,CZE,2017.0,2,5,-3
NPL,JPN,2013.0,2,9,-7
ZAF,GRC,2017.0,1,4,-3
MMR,DEU,2017.0,1,1,0
THA,JPN,2024.0,1,1,0
MEX,PRY,2020.0,1,2,-1
IDN,PAK,2019.0,1,1,0
SDN,ARE,2016.0,1,1,0
ZWE,NGA,2016.0,1,2,-1
BRA,PHL,2018.0,1,3,-2
GHA,COG,2014.0,1,1,0
FIN,LBN,2021.0,1,1,0
AUT,TUN,2022.0,1,1,0
BDI,MAR,2021.0,1,1,0
MNG,AUS,2017.0,1,3,-2
NZL,ESP,1997.0,1,2,-1
SLE,GBR,2010.0,1,1,0
ZAF,BGR,2008.0,1,1,0
AUS,CMR,2013.0,1,1,0
PHL,CHE,2012.0,3,2,1
AUT,ETH,2015.0,2,2,0
MEX,CRI,2007.0,1,3,-2
COL,ECU,2011.0,1,1,0
CUB,FRA,2001.0,2,1,1
ZAF,RUS,2009.0,3,4,-1
HRV,CZE,2005.0,1,2,-1
CAN,TZA,2018.0,2,1,1
PSE,BEL,2019.0,1,3,-2
TTO,EGY,2009.0,1,1,0
BWA,AUS,2023.0,1,3,-2
PRY,ESP,2013.0,1,1,0
ITA,CHE,2024.0,1,1,0
QAT,JOR,2016.0,2,5,-3
IRQ,LBY,2000.0,1,1,0
BGR,EGY,2020.0,1,2,-1
ZWE,NZL,2022.0,1,1,0
MEX,EGY,2023.0,2,1,1
BLR,LVA,2023.0,1,1,0
SVK,TUR,2011.0,1,1,0
PAK,YEM,2023.0,1,1,0
ZAF,PRT,2010.0,3,1,2
ETH,KEN,1998.0,1,2,-1
BRA,GRC,2007.0,2,1,1
SYR,TUN,2015.0,1,1,0
GTM,GBR,2002.0,2,1,1
BHR,KWT,2011.0,1,2,-1
HRV,JPN,2008.0,1,1,0
MYS,DEU,2004.0,1,5,-4
GBR,SDN,2005.0,1,2,-1
BRA,URY,2004.0,1,4,-3
RUS,SGP,2013.0,2,3,-1
ARE,KWT,2010.0,2,2,0
EGY,CHN,2005.0,2,3,-1
TUN,ITA,2001.0,1,2,-1
CAN,HRV,1999.0,1,1,0
BRA,AGO,2015.0,1,2,-1
PHL,BRN,2022.0,1,1,0
PRT,MEX,2021.0,1,3,-2
GHA,GMB,2021.0,1,1,0
KOR,CZE,2011.0,1,1,0
KAZ,KGZ,2023.0,1,2,-1
CYP,IND,2006.0,1,1,0
KEN,SWE,2012.0,2,4,-2
KWT,GBR,2001.0,1,15,-14
TWN,UKR,2000.0,1,1,0
BIH,SVN,2007.0,1,1,0
FRA,VNM,2005.0,1,2,-1
UKR,ESP,2014.0,1,2,-1
MEX,POL,2006.0,1,1,0
GRC,BRA,2008.0,1,2,-1
GRC,BRA,2015.0,1,1,0
USA,HND,2006.0,1,3,-2
GBR,OMN,2001.0,2,6,-4
POL,IND,2002.0,1,5,-4
CMR,BEN,1999.0,1,1,0
TWN,ROU,2007.0,1,1,0
TUR,AUS,2006.0,1,1,0
NOR,SVK,2005.0,1,1,0
LIE,CHE,2013.0,1,3,-2
BGR,BRA,1998.0,1,1,0
NZL,CHL,2009.0,1,2,-1
BLR,FRA,1999.0,2,5,-3
ITA,VAT,2012.0,1,1,0
PRT,MEX,2009.0,3,7,-4
PRT,CHL,2012.0,1,3,-2
ARG,ZAF,1999.0,1,1,0
TTO,CAN,2021.0,3,2,1
SGP,LKA,2015.0,1,2,-1
KOR,ESP,2006.0,1,2,-1
ARG,DOM,2023.0,1,1,0
IRL,NZL,2001.0,1,4,-3
HUN,SRB,2014.0,1,3,-2
COG,GHA,2014.0,1,1,0
KOR,KHM,2018.0,1,1,0
SVN,HUN,2016.0,1,1,0
SVK,CHE,2023.0,1,1,0
NZL,KEN,1999.0,1,1,0
UKR,BGR,2016.0,1,1,0
LBY,SRB,2019.0,1,2,-1
RUS,PRT,2014.0,3,5,-2
ARM,SWE,2022.0,1,1,0
DNK,EST,2020.0,1,2,-1
IND,PNG,2021.0,1,2,-1
LUX,ARE,2022.0,1,2,-1
EST,SVN,2020.0,1,1,0
NOR,KAZ,2018.0,1,2,-1
ISR,POL,2016.0,1,4,-3
GMB,TUR,2022.0,1,1,0
BEL,CUB,2021.0,2,1,1
SWE,PAK,2005.0,2,1,1
KGZ,USA,2021.0,2,2,0
EST,JPN,2012.0,1,1,0
NZL,AUT,1998.0,1,3,-2
SUR,NLD,2010.0,1,1,0
CRI,MEX,2005.0,1,1,0
GRC,IRL,2015.0,1,3,-2
VNM,TUR,2022.0,1,3,-2
BRB,USA,2010.0,1,3,-2
BWA,KEN,2004.0,1,2,-1
LVA,RUS,2012.0,1,3,-2
CAN,GBR,2024.0,1,3,-2
ITA,UZB,2003.0,1,1,0
MAR,ITA,1998.0,2,1,1
AUT,ISR,2010.0,2,3,-1
GBR,UZB,2008.0,1,1,0
RUS,CHL,2015.0,1,1,0
DEU,PER,2009.0,1,1,0
ARE,HKG,2012.0,1,1,0
JOR,IRQ,1997.0,1,1,0
ZAF,COG,1999.0,2,1,1
EGY,NOR,2017.0,1,1,0
NAM,ZMB,2008.0,1,1,0
TUN,MRT,2009.0,1,1,0
GBR,CUB,2023.0,1,1,0
BGD,BEL,2013.0,3,7,-4
JAM,AUS,2006.0,1,1,0
BEL,NPL,2008.0,1,1,0
FJI,PRI,2008.0,1,1,0
YEM,JOR,2020.0,1,3,-2
ISR,MEX,2013.0,1,2,-1
KEN,ZWE,2009.0,1,3,-2
HUN,TUR,2004.0,1,1,0
EGY,LBN,2008.0,3,3,0
MLI,KEN,2019.0,1,1,0
TUR,UZB,2023.0,1,2,-1
CHN,AFG,2023.0,1,2,-1
THA,IND,2024.0,1,1,0
GTM,PAN,2020.0,1,1,0
BRN,KOR,2017.0,1,1,0
HUN,SVK,1998.0,1,1,0
JPN,MAC,2017.0,1,1,0
PAK,JPN,1998.0,3,1,2
FRA,MRT,2013.0,1,1,0
CUB,HUN,2017.0,1,2,-1
KHM,GBR,2022.0,1,5,-4
TWN,IRL,2018.0,1,1,0
ROU,POL,2012.0,1,3,-2
ETH,BWA,2022.0,2,2,0
SRB,SVN,2001.0,1,1,0
AUT,KOR,2008.0,1,5,-4
MAC,IND,2019.0,1,2,-1
MAC,FRA,2017.0,1,1,0
ROU,PRT,2014.0,1,5,-4
ISR,POL,2017.0,1,6,-5
GHA,NOR,2019.0,2,5,-3
ITA,UGA,2023.0,1,2,-1
IND,CZE,2024.0,1,1,0
SLE,CHN,2019.0,1,1,0
LBY,AUS,2018.0,1,4,-3
NLD,SVK,2020.0,1,1,0
USA,TGO,2020.0,1,4,-3
ISR,CHL,2019.0,1,2,-1
PAK,ETH,2021.0,1,1,0
BGR,CZE,2014.0,1,1,0
SVN,CHN,2010.0,1,1,0
CHN,SVN,2013.0,1,4,-3
PLW,USA,2000.0,1,1,0
ITA,TUR,2008.0,2,8,-6
CHE,HKG,1998.0,1,1,0
SWE,CHL,2022.0,1,4,-3
ARE,KAZ,2019.0,2,3,-1
IRL,RUS,1999.0,1,4,-3
NLD,BIH,2021.0,1,1,0
SGP,ZAF,2012.0,1,2,-1
NZL,KOR,2002.0,1,4,-3
IND,LKA,2009.0,2,4,-2
KEN,MLI,2014.0,1,1,0
LBY,GBR,2009.0,1,5,-4
JOR,ESP,2007.0,2,1,1
BFA,BRN,2016.0,1,4,-3
AZE,UZB,2011.0,1,3,-2
SGP,RUS,2014.0,2,6,-4
CAN,MAC,2008.0,1,1,0
BGR,TWN,2012.0,1,1,0
ZAF,CUB,2013.0,1,1,0
NLD,SVK,1999.0,1,1,0
VNM,IRQ,2020.0,1,2,-1
VNM,ISR,2020.0,1,1,0
AGO,USA,2015.0,1,1,0
THA,IRL,2021.0,1,2,-1
ITA,NPL,2021.0,2,2,0
SEN,GHA,2020.0,1,1,0
MUS,IND,2022.0,1,2,-1
MDA,RUS,2009.0,1,4,-3
SGP,DNK,2001.0,1,2,-1
UGA,NZL,2017.0,1,1,0
MEX,TUR,2014.0,1,2,-1
PRT,CUB,2011.0,1,3,-2
TWN,MEX,2014.0,1,1,0
VNM,PHL,2017.0,1,1,0
MDV,GBR,2021.0,1,1,0
THA,VNM,1998.0,1,2,-1
IND,POL,2011.0,1,5,-4
SAU,CZE,2018.0,1,3,-2
CAN,CIV,2013.0,1,2,-1
GHA,BRA,2015.0,1,1,0
NOR,SVN,2019.0,1,2,-1
DZA,JPN,2008.0,1,1,0
FIN,SRB,2007.0,1,2,-1
MYS,CHE,2015.0,2,2,0
IRN,ZAF,2010.0,1,1,0
MKD,GBR,2015.0,1,4,-3
ZAF,SDN,2022.0,1,1,0
ITA,MKD,2013.0,1,2,-1
PER,CHL,2004.0,1,3,-2
SAU,HUN,2020.0,1,1,0
BRA,BVT,2020.0,1,2,-1
IND,LVA,2022.0,2,1,1
SVN,CAN,2022.0,1,6,-5
UKR,BGR,2018.0,1,1,0
CAN,NPL,2019.0,2,9,-7
NAM,GBR,2020.0,2,4,-2
IRL,MEX,2021.0,2,3,-1
BIH,TUR,2021.0,1,1,0
CZE,SVN,2023.0,1,1,0
BEN,CIV,2022.0,1,2,-1
EGY,MEX,2023.0,1,2,-1
IDN,NZL,2012.0,1,1,0
MAR,COG,2021.0,1,2,-1
DZA,ARE,2020.0,1,1,0
FJI,IND,2020.0,1,3,-2
CRI,MEX,2002.0,2,1,1
EST,RUS,2003.0,1,3,-2
CHN,UKR,2004.0,1,1,0
IND,KEN,2010.0,1,1,0
KEN,BEN,2005.0,1,2,-1
MWI,BWA,2008.0,1,2,-1
URY,AUT,2005.0,1,3,-2
HUN,ROU,2001.0,1,7,-6
ZAF,MLI,2004.0,1,1,0
GEO,JPN,2007.0,1,1,0
SAU,IRL,2013.0,1,3,-2
ITA,CUB,2006.0,1,3,-2
GBR,BRN,2000.0,1,3,-2
ESP,GTM,2001.0,1,1,0
OMN,GBR,1997.0,1,3,-2
AUT,TWN,2003.0,1,1,0
NLD,ARE,1997.0,1,1,0
BEL,BLR,2001.0,1,2,-1
FIN,UKR,2011.0,1,1,0
BFA,USA,2002.0,1,2,-1
TWN,SWE,2002.0,1,3,-2
KOR,POL,2010.0,1,3,-2
CHL,TUR,2016.0,1,1,0
KEN,SDN,2017.0,1,2,-1
BRA,HRV,2007.0,1,1,0
USA,AZE,2010.0,1,3,-2
MYS,DZA,2018.0,1,1,0
OMN,KWT,2006.0,1,1,0
MWI,BEL,2010.0,1,1,0
GHA,NOR,2011.0,1,1,0
KEN,CHE,2008.0,1,3,-2
TUR,POL,2010.0,2,1,1
BGR,GRC,2018.0,1,1,0
CYM,GBR,2015.0,1,1,0
ISR,VNM,2020.0,1,1,0
THA,SAU,2016.0,1,1,0
COG,ZAF,2015.0,1,3,-2
TUN,IND,2019.0,1,1,0
CMR,GIN,2020.0,1,2,-1
LUX,JPN,2019.0,1,2,-1
TWN,CZE,2023.0,1,2,-1
NOR,LKA,2022.0,2,2,0
MMR,ZAF,2020.0,1,1,0
PHL,ITA,1997.0,1,1,0
CIV,ITA,2013.0,1,2,-1
GBR,LBR,2015.0,1,1,0
TZA,BWA,2021.0,2,1,1
TUR,IND,2004.0,1,3,-2
UGA,NZL,2016.0,1,1,0
GBR,SYC,2022.0,1,1,0
ZMB,FRA,2019.0,1,2,-1
IRL,THA,2021.0,2,1,1
CZE,PRT,2009.0,1,4,-3
DNK,ROU,2015.0,1,2,-1
KEN,MLI,2015.0,1,1,0
ARM,DNK,2016.0,1,2,-1
VNM,AUT,2014.0,1,1,0
POL,IRQ,2021.0,1,2,-1
SWZ,ZAF,1998.0,1,2,-1
DEU,BHR,2017.0,1,1,0
SEN,BEL,2011.0,1,5,-4
TWN,IRL,2022.0,1,2,-1
HKG,QAT,2018.0,1,1,0
NLD,BGD,2007.0,1,1,0
GBR,DZA,2022.0,1,5,-4
ESP,JOR,2022.0,1,2,-1
RUS,KWT,2023.0,1,1,0
MDG,DEU,2023.0,2,1,1
UKR,QAT,2022.0,1,1,0
SVN,CZE,2023.0,1,1,0
JPN,LTU,2001.0,1,3,-2
LAO,FRA,2007.0,1,1,0
CRI,DEU,2001.0,1,2,-1
NLD,COL,2005.0,1,2,-1
MLI,SEN,2018.0,2,3,-1
CHE,GEO,1999.0,1,1,0
ISR,UKR,2001.0,1,10,-9
POL,NOR,1997.0,1,2,-1
DEU,QAT,2012.0,1,2,-1
SGP,UKR,2001.0,2,3,-1
FIN,THA,2000.0,1,2,-1
SVK,SLV,2006.0,1,4,-3
LIE,AUT,2004.0,1,1,0
SVK,IND,2002.0,1,1,0
UGA,BEL,2001.0,1,1,0
SAU,TUN,1999.0,1,1,0
BEL,LTU,2006.0,2,1,1
QAT,OMN,2017.0,1,2,-1
CZE,UKR,2002.0,1,3,-2
GHA,KEN,1997.0,1,1,0
ESP,ISL,2017.0,1,3,-2
CHE,PHL,2008.0,1,1,0
KWT,JPN,2007.0,1,2,-1
KHM,NLD,2015.0,1,1,0
NGA,MEX,2011.0,2,2,0
ISL,CHE,2022.0,2,2,0
CAN,BWA,2001.0,1,1,0
HRV,IND,2015.0,1,2,-1
RWA,CMR,2023.0,1,1,0
SWE,ROU,2013.0,1,5,-4
VNM,ESP,2018.0,1,3,-2
SWE,GHA,2013.0,1,1,0
GTM,MEX,2003.0,1,3,-2
ZMB,NOR,2011.0,1,2,-1
EST,AUT,2016.0,1,3,-2
VNM,MYS,2014.0,1,5,-4
BGD,DNK,2023.0,1,1,0
BGD,LTU,2023.0,1,1,0
BRA,GTM,2021.0,1,2,-1
CAN,HRV,1998.0,1,2,-1
MYS,ROU,2020.0,1,1,0
CHE,THA,1997.0,1,2,-1
CHL,ITA,2005.0,2,8,-6
CAN,JAM,1999.0,1,1,0
NOR,UKR,2018.0,2,3,-1
DEU,COG,2009.0,1,1,0
ARE,BEL,2016.0,1,4,-3
SGP,KAZ,2016.0,1,1,0
KWT,TUR,2018.0,1,8,-7
MLI,SEN,2017.0,1,1,0
SYR,IND,2022.0,1,2,-1
AUS,URY,2019.0,1,2,-1
OMN,MYS,2012.0,2,6,-4
PRY,MEX,2022.0,2,1,1
LVA,LTU,2012.0,1,6,-5
UGA,CHN,2015.0,1,1,0
SGP,GRC,2019.0,2,1,1
BRA,VEN,2018.0,1,14,-13
GBR,VEN,2015.0,1,9,-8
CAN,CRI,2022.0,1,2,-1
VNM,POL,2012.0,1,2,-1
NLD,SDN,2002.0,1,3,-2
OMN,CHE,2008.0,1,1,0
ZAF,ISR,2021.0,1,2,-1
THA,TWN,2003.0,1,2,-1
ESP,SVK,2001.0,1,2,-1
PRT,RUS,1997.0,1,3,-2
IND,RUS,2003.0,2,3,-1
BEL,CUB,2011.0,1,4,-3
THA,VNM,1999.0,2,2,0
AUS,CZE,2000.0,1,3,-2
TUR,LBN,2017.0,1,1,0
USA,UZB,2019.0,2,1,1
LUX,SVK,2015.0,1,1,0
PAK,IRN,2014.0,1,1,0
MAC,CHE,2017.0,1,1,0
NOR,HKG,2017.0,2,2,0
VNM,NLD,2000.0,2,4,-2
THA,IRL,2019.0,1,1,0
LBY,JPN,2020.0,1,1,0
CHL,NZL,2022.0,2,4,-2
ITA,CHN,2024.0,1,2,-1
LBN,TUR,2023.0,1,2,-1
MCO,USA,2018.0,2,2,0
BIH,KOR,2020.0,1,1,0
AUT,HRV,2013.0,1,5,-4
PHL,MYS,2006.0,1,2,-1
PER,CHL,2001.0,1,2,-1
BFA,CAN,1998.0,1,2,-1
QAT,UKR,2022.0,1,1,0
BEL,GMB,2003.0,1,1,0
SWE,BGD,2002.0,1,1,0
AUS,TUR,2001.0,1,3,-2
LAO,KHM,2009.0,1,1,0
UKR,CHE,2008.0,1,1,0
NOR,GRC,2003.0,1,2,-1
DEU,BIH,2012.0,1,1,0
UZB,MYS,2007.0,1,2,-1
DNK,ROU,2001.0,1,5,-4
MAR,TUN,2017.0,2,4,-2
PRT,DNK,2000.0,1,4,-3
SRB,MNE,1999.0,2,2,0
CAN,UKR,2011.0,1,3,-2
CHN,THA,1999.0,1,1,0
HRV,HUN,2016.0,1,2,-1
BLR,CZE,2017.0,1,2,-1
FRA,BIH,2013.0,1,2,-1
COL,NIC,2010.0,1,1,0
ARE,TUN,2014.0,1,4,-3
ARG,NOR,2023.0,1,1,0
RWA,KEN,2015.0,1,6,-5
BEN,BRA,2014.0,1,1,0
COL,CHL,1997.0,1,7,-6
BWA,ETH,2021.0,1,2,-1
VNM,RUS,2005.0,1,1,0
IRQ,YEM,2008.0,1,1,0
SAU,YEM,2014.0,1,7,-6
PRK,CHN,2015.0,1,3,-2
EST,PAK,2020.0,1,2,-1
BWA,MWI,2015.0,1,1,0
IRN,PAK,2015.0,1,2,-1
PSE,ESP,2018.0,1,2,-1
ETH,RUS,2019.0,1,1,0
IRL,SAU,2023.0,1,3,-2
TUN,PRT,2006.0,1,2,-1
USA,MKD,1999.0,1,4,-3
DEU,LBN,2005.0,1,1,0
SGP,MEX,2008.0,1,2,-1
SWE,OMN,2015.0,1,1,0
UKR,KOR,2010.0,1,2,-1
IND,PRI,2017.0,1,1,0
YEM,USA,2012.0,1,1,0
ALB,DEU,2007.0,1,4,-3
NZL,IDN,2000.0,1,1,0
SWE,NPL,2012.0,1,1,0
CMR,MYS,2009.0,1,1,0
EGY,HUN,2010.0,1,1,0
TZA,DEU,2009.0,1,4,-3
BEL,HKG,2008.0,1,1,0
ARG,VEN,2017.0,1,3,-2
CAN,GEO,2010.0,1,1,0
HKG,LKA,2010.0,1,1,0
MNG,RUS,2001.0,1,1,0
SAU,HKG,2014.0,1,5,-4
RUS,TJK,1997.0,1,1,0
ECU,HUN,2017.0,1,1,0
BEL,CMR,2000.0,1,2,-1
ITA,MAR,1998.0,1,2,-1
GRC,SVN,2021.0,1,1,0
BRB,CAN,2019.0,1,1,0
LBN,CZE,2018.0,1,1,0
CIV,GBR,2005.0,1,1,0
ESP,HRV,2009.0,1,2,-1
POL,ARG,1999.0,1,1,0
NOR,ARE,2020.0,1,3,-2
DEU,CRI,2011.0,1,2,-1
CAN,PHL,2001.0,1,5,-4
SVN,JPN,2002.0,1,2,-1
IND,BWA,2023.0,1,2,-1
USA,LIE,2007.0,1,1,0
SWE,MWI,2009.0,1,1,0
CHL,RUS,2023.0,1,2,-1
KOR,POL,2006.0,1,1,0
FRA,CUB,2003.0,2,2,0
MDG,KHM,2006.0,1,1,0
NOR,UKR,2022.0,1,5,-4
DEU,LKA,2015.0,1,4,-3
CHL,PRY,2019.0,1,2,-1
JPN,CMR,2017.0,1,2,-1
NZL,CZE,2020.0,1,2,-1
GUF,USA,2014.0,2,1,1
POL,BGR,2012.0,1,2,-1
CHE,TUN,2012.0,1,2,-1
THA,BEL,2019.0,2,4,-2
CHN,UKR,2014.0,1,5,-4
FRA,ETH,2016.0,1,1,0
COL,AUS,2003.0,2,2,0
KOR,CHL,2010.0,1,1,0
CZE,CHL,2016.0,1,2,-1
VNM,ESP,2016.0,2,1,1
NLD,KHM,2015.0,1,1,0
NLD,ECU,2016.0,1,2,-1
POL,JOR,2019.0,1,1,0
SYC,CAN,2019.0,1,1,0
AUT,MNG,2016.0,1,1,0
MAR,TUN,2016.0,1,3,-2
IRL,RUS,2007.0,1,5,-4
IND,MWI,2022.0,1,1,0
EGY,NGA,2021.0,1,9,-8
EGY,KAZ,2012.0,1,2,-1
KAZ,EGY,2015.0,1,1,0
IRN,CHE,2002.0,1,2,-1
CUB,FRA,2004.0,1,4,-3
SWE,ARM,2022.0,1,1,0
PER,CHE,2020.0,1,3,-2
PRT,UKR,2000.0,1,5,-4
ETH,NGA,2007.0,1,2,-1
COL,NGA,2003.0,1,1,0
SEN,BFA,2008.0,1,4,-3
MKD,GBR,2014.0,1,1,0
GRC,FIN,2008.0,1,2,-1
IRQ,RUS,2010.0,1,1,0
AUT,MYS,2023.0,1,1,0
GAB,COG,2013.0,1,1,0
TWN,SAU,2013.0,1,1,0
HRV,AUT,2006.0,1,3,-2
USA,SLV,2017.0,1,2,-1
GHA,NGA,2005.0,1,2,-1
ARM,FRA,2009.0,1,1,0
SGP,KAZ,2022.0,1,1,0
DZA,AUT,2019.0,1,1,0
EST,NOR,2004.0,1,1,0
PNG,PHL,2015.0,1,1,0
PAK,PRT,2011.0,1,1,0
DNK,ARE,2009.0,1,1,0
POL,CYP,2020.0,1,2,-1
ROU,ARG,2016.0,1,1,0
URY,SWE,2005.0,1,1,0
SVK,IND,2012.0,1,1,0
BEL,LBY,2014.0,1,1,0
BEL,COD,2007.0,1,1,0
ITA,ECU,2007.0,1,2,-1
RUS,IRN,2005.0,1,3,-2
IRN,LTU,2017.0,1,2,-1
KEN,SGP,2020.0,1,1,0
COM,FRA,2020.0,1,1,0
MYS,NOR,2017.0,1,2,-1
SWE,CHL,2018.0,1,7,-6
LKA,IDN,2010.0,1,1,0
SAU,ROU,2018.0,1,1,0
ZAF,CZE,2013.0,1,1,0
MAR,DJI,2020.0,1,0,1
ITA,ZWE,2020.0,1,0,1
QAT,SVN,2021.0,1,0,1
HRV,SVK,2022.0,1,0,1
KHM,SAU,2019.0,1,0,1
CZE,RWA,2021.0,1,0,1
IDN,UKR,2019.0,1,0,1
TCD,FRA,2023.0,1,0,1
TUR,THA,2020.0,2,0,2
GIN,COG,2023.0,1,0,1
SAU,PHL,1999.0,1,0,1
BRA,LBY,2007.0,2,0,2
LBY,BRA,2011.0,1,0,1
ZAF,ARG,2006.0,1,0,1
AUS,NRU,2009.0,1,0,1
LTU,LUX,2015.0,1,0,1
MHL,IND,2003.0,1,0,1
SYC,USA,2009.0,1,0,1
PRT,CPV,2009.0,1,0,1
CRI,OMN,2008.0,1,0,1
OMN,CRI,2009.0,1,0,1
EGY,HKG,1999.0,1,0,1
CRI,DNK,2004.0,1,0,1
PRY,,2006.0,1,0,1
MCO,AUS,2003.0,1,0,1
TTO,BMU,2011.0,1,0,1
OMN,CHE,2000.0,1,0,1
CAN,SEN,2008.0,1,0,1
RUS,BOL,2021.0,1,0,1
GBR,IRQ,2024.0,1,0,1
LBN,SDN,2008.0,1,0,1
AGO,ESP,2023.0,3,0,3
AUS,UZB,2019.0,1,0,1
OMN,FIN,2023.0,1,0,1
,MAF,2020.0,1,0,1
PAK,HKG,2012.0,1,0,1
PAK,KAZ,2017.0,1,0,1
ESP,LTU,2024.0,1,0,1
AUS,NER,2015.0,1,0,1
NER,AUS,2017.0,1,0,1
MEX,MAR,2010.0,1,0,1
CHE,TCD,2008.0,1,0,1
RWA,SWZ,2013.0,1,0,1
TUR,THA,1998.0,1,0,1
JPN,FJI,1997.0,1,0,1
CHN,LTU,2001.0,2,0,2
NCL,MEX,2010.0,2,0,2
CAN,GRL,2002.0,1,0,1
PHL,KOR,2000.0,1,0,1
AUT,BGD,1997.0,1,0,1
KWT,BGD,2008.0,1,0,1
ETH,ZMB,2010.0,1,0,1
MKD,SWE,2012.0,1,0,1
VEN,CHE,2015.0,1,0,1
NLD,KAZ,2006.0,1,0,1
AUS,SLB,1998.0,1,0,1
ITA,VAT,2017.0,1,0,1
SRB,DZA,2005.0,1,0,1
BGD,ETH,2005.0,1,0,1
BIH,DEU,2003.0,1,0,1
ETH,CHN,2008.0,1,0,1
SVN,ALB,2016.0,1,0,1
EST,GRC,2015.0,1,0,1
SRB,SVK,2014.0,1,0,1
NIC,GBR,2015.0,1,0,1
CYP,ROU,2015.0,1,0,1
GTM,ARG,2010.0,1,0,1
ESP,CYP,2009.0,1,0,1
GIN,PNG,2018.0,2,0,2
FIN,MAC,2015.0,1,0,1
JPN,PSE,2016.0,1,0,1
LBN,LBR,2020.0,1,0,1
CUB,PER,2007.0,1,0,1
AUS,GMB,2009.0,1,0,1
JAM,CHE,2003.0,1,0,1
DNK,PSE,2014.0,1,0,1
AFG,ARE,2015.0,1,0,1
SYR,AUT,2017.0,3,0,3
SGP,CHL,2023.0,1,0,1
BRA,EGY,2013.0,2,0,2
NPL,EST,2015.0,1,0,1
ARG,TJK,2015.0,2,0,2
IRL,SVK,2019.0,1,0,1
MNE,CZE,2016.0,1,0,1
RUS,SVN,2010.0,1,0,1
GRC,ARG,2015.0,1,0,1
IRQ,ROU,2016.0,1,0,1
IND,LBN,2018.0,2,0,2
AUS,QAT,2007.0,1,0,1
LKA,UGA,2007.0,1,0,1
EST,IRL,2018.0,1,0,1
IRL,UGA,2019.0,1,0,1
ALB,PRT,2019.0,1,0,1
MEX,AZE,2022.0,1,0,1
MAR,RWA,2020.0,1,0,1
CAN,BIH,2016.0,1,0,1
SVN,ISR,2018.0,1,0,1
LKA,CZE,2014.0,1,0,1
IRL,DMA,2015.0,1,0,1
,LUX,2021.0,2,0,2
ARG,ISL,2020.0,1,0,1
CHN,ECU,2023.0,1,0,1
CUB,GUY,2021.0,1,0,1
CAN,AND,2022.0,1,0,1
TUN,JPN,2004.0,1,0,1
ITA,AGO,2020.0,1,0,1
IDN,ITA,2008.0,2,0,2
IRN,NOR,2002.0,1,0,1
FRA,CYP,1997.0,1,0,1
IDN,CMR,1997.0,1,0,1
SVK,GRC,1997.0,1,0,1
LKA,KEN,2005.0,1,0,1
ETH,RWA,2013.0,1,0,1
LBN,CHE,2008.0,1,0,1
GHA,GMB,2003.0,1,0,1
TUR,MYS,2000.0,1,0,1
NZL,PHL,2005.0,1,0,1
GBR,LSO,2001.0,1,0,1
YEM,IRQ,2021.0,1,0,1
MYS,BRN,2010.0,2,0,2
CHE,GTM,1998.0,1,0,1
JPN,OMN,2003.0,1,0,1
BLR,GBR,2006.0,1,0,1
CHE,MDG,1999.0,1,0,1
POL,KNA,2021.0,1,0,1
GTM,ZAF,2000.0,1,0,1
BWA,LBN,2004.0,1,0,1
SLB,,2007.0,1,0,1
ROU,FIN,2018.0,1,0,1
TUN,GRC,2013.0,1,0,1
BRA,GNB,2012.0,1,0,1
MLI,MRT,2015.0,1,0,1
CRI,RUS,2005.0,1,0,1
BLR,NZL,2018.0,1,0,1
CUB,IND,2017.0,1,0,1
KAZ,MEX,2006.0,1,0,1
GRL,USA,2019.0,1,0,1
EST,TUN,2013.0,1,0,1
CIV,CAN,2008.0,3,0,3
AUT,LIE,2010.0,3,0,3
ISR,MEX,2011.0,1,0,1
MNE,MEX,2008.0,2,0,2
CHE,NPL,2011.0,2,0,2
DNK,AFG,2020.0,1,0,1
AFG,DNK,2021.0,1,0,1
MLI,COL,2009.0,1,0,1
BRA,MAC,2008.0,1,0,1
ITA,JOR,2007.0,1,0,1
UGA,MLI,2014.0,1,0,1
IRN,UKR,2022.0,1,0,1
MLI,BRA,2022.0,1,0,1
,KAZ,2021.0,5,0,5
COD,,2026.0,1,0,1
PER,KEN,2012.0,4,0,4
VUT,AUS,2020.0,1,0,1
FJI,PHL,2017.0,1,0,1
USA,LBR,1999.0,1,0,1
JPN,CIV,2013.0,1,0,1
CYP,CHE,2007.0,1,0,1
NPL,MYS,2007.0,1,0,1
URY,NLD,2017.0,1,0,1
BGD,TWN,2009.0,1,0,1
GIN,KHM,2023.0,1,0,1
SAU,CHL,2017.0,1,0,1
BRA,KNA,2018.0,1,0,1
LTU,LIE,2016.0,1,0,1
LIE,LTU,2017.0,2,0,2
BGR,IND,2007.0,1,0,1
ZMB,ZWE,2023.0,1,0,1
,FSM,2009.0,1,0,1
FSM,,2018.0,2,0,2
TUR,IDN,2016.0,1,0,1
CMR,FIN,2012.0,1,0,1
ZWE,BDI,2019.0,1,0,1
BRA,MAC,2014.0,1,0,1
MAC,BRA,2017.0,1,0,1
,DJI,2008.0,3,0,3
ZWE,THA,2018.0,1,0,1
IRN,HUN,2011.0,1,0,1
PLW,AUS,2002.0,1,0,1
MAR,TWN,2002.0,2,0,2
ESP,GRL,2020.0,1,0,1
MOZ,BEL,2017.0,1,0,1
TUN,COG,2007.0,1,0,1
BHR,FRA,2015.0,1,0,1
BDI,CAN,2018.0,1,0,1
TUN,DNK,2019.0,1,0,1
LUX,VEN,2021.0,1,0,1
KWT,NLD,2014.0,1,0,1
GMB,ESP,2018.0,1,0,1
ATG,ESP,2021.0,1,0,1
,DJI,2014.0,2,0,2
,VAT,2010.0,1,0,1
NGA,NAM,2012.0,1,0,1
FRO,,2026.0,1,0,1
LTU,ZAF,2020.0,1,0,1
ZAF,LTU,2021.0,1,0,1
ROU,NZL,2020.0,1,0,1
ESP,GRD,2017.0,1,0,1
COL,DNK,2023.0,1,0,1
ISR,ISL,2008.0,1,0,1
NGA,RWA,2017.0,1,0,1
PRY,URY,2023.0,1,0,1
SGP,COL,2023.0,1,0,1
THA,OMN,2022.0,1,0,1
COL,SVN,2017.0,1,0,1
PRI,CAN,2018.0,1,0,1
NLD,GEO,2022.0,1,0,1
MAR,NER,2019.0,1,0,1
UKR,CHE,2023.0,2,0,2
URY,AUT,2018.0,1,0,1
PAK,ESP,2012.0,1,0,1
ROU,TUN,2019.0,1,0,1
COL,TUR,2019.0,1,0,1
MYS,MEX,2018.0,1,0,1
NOR,BLR,2008.0,2,0,2
ZAF,IDN,2022.0,1,0,1
FJI,MYS,2008.0,1,0,1
ZAF,BGD,1999.0,1,0,1
COL,LBN,2003.0,1,0,1
PAK,ISR,2007.0,1,0,1
ITA,BRN,2016.0,1,0,1
NOR,MNE,2009.0,1,0,1
KEN,FIN,2020.0,1,0,1
CAN,PRI,2007.0,2,0,2
MLT,JPN,1997.0,1,0,1
JPN,MLT,2000.0,1,0,1
AUS,BHR,2007.0,1,0,1
BRA,NZL,2003.0,1,0,1
BRA,LIE,1999.0,1,0,1
BLR,DNK,2002.0,1,0,1
BLR,CHE,2013.0,2,0,2
NPL,PNG,2012.0,1,0,1
TUR,JOR,2002.0,1,0,1
URY,COL,2007.0,1,0,1
MAR,IND,2000.0,1,0,1
MYS,NGA,2005.0,1,0,1
NOR,PSE,2013.0,2,0,2
JPN,LAO,2010.0,1,0,1
DEU,IRQ,2002.0,1,0,1
MYS,LBY,2007.0,1,0,1
NOR,HRV,2011.0,1,0,1
UZB,TWN,2019.0,1,0,1
CAN,UZB,2018.0,1,0,1
ZAF,TUN,2002.0,2,0,2
GBR,PRI,2005.0,1,0,1
KAZ,POL,2015.0,1,0,1
SWE,ZMB,2021.0,1,0,1
DEU,JAM,2009.0,1,0,1
ISL,JPN,2016.0,1,0,1
BGR,KOR,2004.0,1,0,1
KOR,BGR,2007.0,1,0,1
JPN,BWA,2013.0,1,0,1
TWN,BGR,2013.0,1,0,1
CIV,CHE,2013.0,1,0,1
SGP,ROU,2009.0,1,0,1
BWA,ZWE,2024.0,1,0,1
GHA,RUS,2019.0,2,0,2
KOR,NZL,2007.0,3,0,3
PYF,CAN,2015.0,1,0,1
QAT,NZL,2023.0,1,0,1
CHL,ZMB,1999.0,1,0,1
IND,ROU,2008.0,2,0,2
ARG,NOR,2001.0,1,0,1
CHN,PRI,1997.0,1,0,1
ZAF,ARE,1999.0,1,0,1
GLP,BEL,2002.0,1,0,1
BLR,NOR,2011.0,1,0,1
PAK,KAZ,2018.0,1,0,1
NLD,BHR,2006.0,1,0,1
HTI,RWA,2012.0,1,0,1
LAO,CHN,2018.0,1,0,1
TWN,ARM,2017.0,1,0,1
CHE,BLR,2010.0,1,0,1
BIH,BEL,2012.0,1,0,1
USA,GMB,2007.0,1,0,1
TZA,GHA,2013.0,1,0,1
KNA,TTO,2001.0,1,0,1
ISR,NOR,2021.0,3,0,3
SWE,PNG,2017.0,1,0,1
TUN,SRB,2018.0,1,0,1
SWE,TUN,2022.0,2,0,2
FRA,ATA,2017.0,1,0,1
JPN,NAM,2019.0,2,0,2
ARG,LUX,2020.0,1,0,1
FRA,BDI,2015.0,1,0,1
GBR,MCO,2014.0,1,0,1
PYF,,2003.0,1,0,1
BRA,KHM,2007.0,1,0,1
AUS,PRI,2016.0,1,0,1
MNE,CZE,2017.0,1,0,1
EST,DNK,2014.0,1,0,1
MWI,BRA,2018.0,1,0,1
,WLF,2011.0,2,0,2
PHL,ZWE,2021.0,1,0,1
PRT,ZAF,2004.0,1,0,1
PAK,POL,2017.0,1,0,1
SVK,ARE,2021.0,1,0,1
TUR,HRV,2020.0,1,0,1
ROU,UKR,2018.0,1,0,1
LIE,NLD,2020.0,1,0,1
LUX,KOR,2013.0,1,0,1
PER,LUX,2020.0,1,0,1
BWA,IRQ,2017.0,1,0,1
IND,MDG,2019.0,1,0,1
HTI,ETH,2017.0,1,0,1
KAZ,IRQ,2016.0,1,0,1
IDN,PER,2020.0,2,0,2
AUS,ROU,2023.0,1,0,1
BIH,HUN,2023.0,1,0,1
PER,ISR,2001.0,1,0,1
URY,PRT,2008.0,1,0,1
CAN,SVN,2023.0,1,0,1
NOR,MMR,2018.0,1,0,1
MNE,PRT,2018.0,1,0,1
KEN,OMN,2019.0,1,0,1
FJI,DEU,2019.0,1,0,1
NZL,UKR,2020.0,1,0,1
HKG,KWT,2012.0,1,0,1
COD,IND,2023.0,1,0,1
HTI,BEL,2022.0,1,0,1
ITA,TWN,1997.0,1,0,1
NPL,BRA,2021.0,1,0,1
LBN,BGR,2023.0,1,0,1
IDN,COD,2022.0,1,0,1
PAK,FJI,2018.0,1,0,1
REU,ESP,2019.0,1,0,1
KWT,AUS,2001.0,1,0,1
,LTU,2021.0,5,0,5
CZE,CHL,2005.0,1,0,1
,ATA,2018.0,1,0,1
COL,VNM,1999.0,1,0,1
KHM,CHL,2017.0,1,0,1
FSM,NZL,2005.0,1,0,1
CHL,SRB,2005.0,1,0,1
MWI,BWA,2010.0,2,0,2
HRV,BRA,1999.0,1,0,1
BGR,SAU,2004.0,1,0,1
LUX,MLI,2012.0,1,0,1
KOR,PRT,2008.0,1,0,1
KOR,ARG,2008.0,1,0,1
DEU,COG,2003.0,2,0,2
CAN,SVN,2006.0,1,0,1
CHE,LUX,1998.0,1,0,1
POL,NCL,2005.0,1,0,1
CHE,IDN,2005.0,1,0,1
POL,ZMB,2006.0,1,0,1
AUS,JOR,1999.0,1,0,1
GRD,RUS,2006.0,1,0,1
SVK,GRC,2002.0,2,0,2
KEN,PER,2005.0,1,0,1
GUM,CHN,2015.0,1,0,1
CZE,LVA,2019.0,1,0,1
GEO,GBR,2019.0,1,0,1
MWI,MOZ,1998.0,1,0,1
DEU,SEN,2005.0,1,0,1
AUT,OMN,2000.0,1,0,1
HUN,ISL,2022.0,1,0,1
SGP,PRT,2008.0,1,0,1
ROU,ISL,2001.0,1,0,1
BGR,NOR,2001.0,1,0,1
BGR,NOR,2004.0,1,0,1
ZWE,BRB,2004.0,1,0,1
URY,PRY,2015.0,1,0,1
KEN,ARE,2012.0,1,0,1
PAK,UKR,2009.0,1,0,1
SWE,BFA,2012.0,1,0,1
LKA,CHE,2014.0,1,0,1
VCT,IND,2011.0,1,0,1
LUX,IND,2013.0,1,0,1
PAK,SYR,2011.0,1,0,1
TWN,SVK,2011.0,1,0,1
COD,FRA,2014.0,1,0,1
DZA,BHR,2014.0,1,0,1
LTU,AUT,2016.0,1,0,1
ARM,CZE,2018.0,1,0,1
NER,,2003.0,2,0,2
CRI,ECU,2009.0,1,0,1
HRV,QAT,2004.0,1,0,1
CMR,KOR,2009.0,1,0,1
ZMB,SWE,2009.0,1,0,1
SWE,ZMB,2011.0,1,0,1
CMR,SEN,2006.0,1,0,1
HRV,NOR,2017.0,1,0,1
OMN,RUS,2014.0,1,0,1
GRC,TWN,2014.0,1,0,1
BEN,MLI,2010.0,1,0,1
ETH,CHN,2015.0,1,0,1
MWI,THA,2017.0,1,0,1
SRB,ROU,2020.0,1,0,1
MDV,IND,2012.0,2,0,2
TUN,ROU,2020.0,1,0,1
IRN,TUN,2021.0,1,0,1
AUT,PHL,2013.0,2,0,2
NGA,CIV,2013.0,1,0,1
COG,AUS,2013.0,2,0,2
BIH,KWT,2014.0,1,0,1
LAO,SGP,2019.0,1,0,1
IND,ZMB,1998.0,1,0,1
ZAF,SYC,2015.0,1,0,1
ROU,LVA,2017.0,1,0,1
BGR,AUS,2015.0,1,0,1
DEU,MOZ,2019.0,1,0,1
CHN,TKM,2023.0,1,0,1
CYP,IRL,2012.0,1,0,1
TUR,ARG,2023.0,1,0,1
AUT,MNG,2012.0,1,0,1
ITA,RWA,2019.0,1,0,1
BHR,SGP,2014.0,1,0,1
CHL,ECU,1997.0,1,0,1
URY,IRL,2016.0,1,0,1
PRT,CZE,2004.0,1,0,1
VNM,BOL,2004.0,1,0,1
IND,ARG,2015.0,1,0,1
KOR,ARG,2015.0,1,0,1
IRQ,UGA,2018.0,1,0,1
HUN,MNE,2019.0,1,0,1
,FLK,2005.0,2,0,2
ESP,CPV,2013.0,1,0,1
COL,BFA,2012.0,1,0,1
DOM,MEX,2006.0,1,0,1
IDN,IRN,2016.0,1,0,1
PAK,LUX,2019.0,1,0,1
IRQ,GBR,2003.0,1,0,1
IDN,UKR,2021.0,2,0,2
ETH,HUN,2023.0,1,0,1
KOR,PRK,2023.0,2,0,2
BGD,EST,2021.0,1,0,1
MLT,NLD,2018.0,1,0,1
,MMR,2021.0,1,0,1
IND,NER,2001.0,1,0,1
BRA,LAO,2002.0,1,0,1
ISL,GRC,2011.0,1,0,1
SWE,ARE,1998.0,1,0,1
NOR,BGR,1999.0,1,0,1
CHE,UGA,1998.0,1,0,1
COL,POL,2012.0,1,0,1
ROU,SVK,2022.0,1,0,1
CRI,NLD,1997.0,1,0,1
AUS,VNM,1998.0,1,0,1
DEU,ARE,1998.0,1,0,1
LBN,SAU,1998.0,1,0,1
HRV,CYP,2021.0,1,0,1
SRB,KOR,2003.0,1,0,1
CMR,BWA,2020.0,1,0,1
ZAF,NCL,2015.0,1,0,1
BRN,USA,2003.0,1,0,1
ESP,OMN,2003.0,1,0,1
RWA,GAB,2005.0,1,0,1
ISR,ARG,2011.0,1,0,1
FLK,FRA,2000.0,1,0,1
USA,REU,2005.0,1,0,1
ETH,CHE,2002.0,1,0,1
DEU,OMN,1999.0,1,0,1
AUS,SVK,2003.0,1,0,1
SVN,BEL,2006.0,1,0,1
FIN,SAU,2009.0,1,0,1
PAN,BRA,2000.0,1,0,1
GBR,BHR,2004.0,1,0,1
SVN,DNK,2000.0,1,0,1
EST,VNM,2018.0,1,0,1
ITA,OMN,2006.0,1,0,1
ESP,CYP,2011.0,2,0,2
SWZ,ITA,2011.0,1,0,1
JPN,GAB,2019.0,1,0,1
NLD,ECU,2005.0,1,0,1
UGA,SEN,2021.0,1,0,1
COD,SEN,2015.0,1,0,1
HUN,LVA,2017.0,1,0,1
FIN,IDN,2011.0,1,0,1
HRV,MYS,2010.0,1,0,1
BIH,ITA,2015.0,1,0,1
ARM,IRQ,2010.0,1,0,1
MEX,LBN,2017.0,1,0,1
URY,DEU,2008.0,1,0,1
BEL,HKG,2006.0,1,0,1
AUS,FLK,2019.0,1,0,1
IRL,TCA,2015.0,1,0,1
MOZ,BFA,2013.0,1,0,1
CMR,ZWE,2007.0,1,0,1
UZB,IRN,2012.0,1,0,1
ISL,CHN,2006.0,1,0,1
IND,NER,2015.0,1,0,1
LBN,OMN,2007.0,1,0,1
IRQ,NAM,2014.0,1,0,1
MAC,BGD,2017.0,1,0,1
LSO,BWA,2021.0,1,0,1
AUS,MNG,2005.0,1,0,1
MAC,,2004.0,1,0,1
USA,GUY,2002.0,1,0,1
TUR,SVK,2019.0,1,0,1
FRA,AZE,2011.0,1,0,1
AUT,LTU,2021.0,1,0,1
IRQ,TUN,2020.0,1,0,1
IND,BHS,2014.0,1,0,1
BHS,IND,2018.0,1,0,1
ROU,PAK,2007.0,1,0,1
SEN,GLP,1998.0,1,0,1
MOZ,DNK,2014.0,1,0,1
ZAF,TUN,2005.0,1,0,1
MYS,NGA,2002.0,1,0,1
CZE,PRT,2003.0,1,0,1
HKG,TTO,2002.0,1,0,1
PSE,OMN,2003.0,1,0,1
SGP,SRB,1999.0,1,0,1
DEU,CAF,2007.0,1,0,1
TUR,PAK,2000.0,1,0,1
UZB,DEU,2001.0,1,0,1
STP,BRA,2004.0,1,0,1
ISR,PAK,1998.0,1,0,1
MEX,KWT,2010.0,1,0,1
SGP,LKA,2006.0,1,0,1
VEN,NLD,2001.0,1,0,1
DEU,BOL,2003.0,1,0,1
KOR,LKA,2002.0,1,0,1
DNK,NER,2012.0,1,0,1
GBR,NCL,1999.0,1,0,1
VEN,FIN,2013.0,1,0,1
GAB,CHE,2020.0,1,0,1
ALB,BIH,2020.0,1,0,1
USA,TCD,2019.0,1,0,1
PRI,PER,2018.0,1,0,1
NOR,POL,2024.0,1,0,1
KNA,TTO,2014.0,1,0,1
ZAF,TTO,2018.0,1,0,1
BFA,CHE,2003.0,1,0,1
ROU,EST,2019.0,1,0,1
BTN,NLD,2018.0,1,0,1
COL,CUB,2006.0,1,0,1
CHN,RWA,2014.0,1,0,1
IRN,SDN,2017.0,1,0,1
ZWE,KOR,2012.0,1,0,1
MMR,MYS,2015.0,1,0,1
BEL,BDI,2011.0,1,0,1
NPL,LAO,2020.0,1,0,1
MLT,SWE,2017.0,1,0,1
SLV,URY,2019.0,1,0,1
BLR,PRT,2019.0,1,0,1
RWA,AUS,2022.0,1,0,1
FIN,KAZ,2022.0,1,0,1
TTO,KWT,2011.0,1,0,1
TUR,COL,2020.0,1,0,1
COL,TUR,2021.0,1,0,1
VEN,CRI,2022.0,1,0,1
SDN,CAN,2023.0,1,0,1
URY,NZL,2022.0,1,0,1
COD,MWI,2022.0,1,0,1
CAN,ZWE,2020.0,1,0,1
BRA,THA,2021.0,1,0,1
USA,GIN,2022.0,1,0,1
SEN,GBR,2003.0,2,0,2
GBR,PNG,2010.0,1,0,1
KAZ,FRA,1997.0,1,0,1
JOR,THA,2019.0,1,0,1
THA,ARE,2009.0,1,0,1
LBN,TUN,2000.0,1,0,1
HKG,MEX,2001.0,1,0,1
AUS,GUM,2011.0,1,0,1
TWN,PRT,2010.0,1,0,1
JPN,PRI,1997.0,1,0,1
NLD,GRD,2018.0,1,0,1
ZAF,TWN,2004.0,1,0,1
BEL,BLZ,2014.0,1,0,1
BRA,BLZ,2016.0,1,0,1
HUN,CHN,1998.0,1,0,1
BWA,IND,2015.0,1,0,1
SGP,KAZ,2012.0,1,0,1
SRB,SEN,2016.0,1,0,1
BFA,MMR,2011.0,1,0,1
GHA,POL,2014.0,1,0,1
POL,GHA,2019.0,1,0,1
,FLK,2012.0,1,0,1
CPV,,2016.0,1,0,1
CUB,URY,2007.0,1,0,1
CHN,MLI,2021.0,1,0,1
DEU,CHL,2024.0,1,0,1
PRT,ETH,2017.0,1,0,1
ECU,FIN,2019.0,1,0,1
POL,LVA,2020.0,1,0,1
TTO,BHS,2015.0,1,0,1
EGY,NPL,2018.0,1,0,1
SLV,SVK,2023.0,1,0,1
MLI,GMB,2019.0,1,0,1
HRV,MKD,2022.0,1,0,1
RUS,LKA,2022.0,1,0,1
CHN,AZE,2021.0,1,0,1
GLP,GUF,2022.0,1,0,1
,CIV,2021.0,1,0,1
KHM,UZB,2022.0,1,0,1
DOM,EGY,2023.0,1,0,1
GBR,CYM,2022.0,1,0,1
PAK,PRT,2013.0,1,0,1
VNM,ISL,2021.0,1,0,1
KOR,BIH,2019.0,1,0,1
KWT,IRN,2017.0,1,0,1
ARM,TUR,1998.0,1,0,1
IRL,GRC,1997.0,1,0,1
HUN,MEX,2002.0,1,0,1
COL,NZL,2007.0,1,0,1
VNM,DNK,2002.0,1,0,1
SYC,GBR,2002.0,1,0,1
JPN,LTU,2000.0,1,0,1
CHE,LVA,2003.0,1,0,1
EGY,DZA,2001.0,1,0,1
VEN,URY,2009.0,1,0,1
NGA,JAM,2003.0,1,0,1
NGA,CHE,2002.0,1,0,1
NLD,CYP,2003.0,1,0,1
HUN,ETH,2006.0,1,0,1
NPL,BRA,2011.0,1,0,1
PER,SAU,2002.0,1,0,1
GUF,KHM,2003.0,1,0,1
KHM,SEN,2013.0,1,0,1
IRQ,DEU,1998.0,1,0,1
QAT,GRC,2024.0,1,0,1
LBY,IRL,2016.0,1,0,1
TTO,SDN,2009.0,1,0,1
DNK,BLR,2006.0,1,0,1
CYP,BRA,2006.0,1,0,1
BRA,CYP,2011.0,1,0,1
BLR,MDA,2022.0,1,0,1
DNK,ARM,2002.0,1,0,1
DNK,UGA,2011.0,1,0,1
EGY,SOM,2017.0,1,0,1
MYS,HRV,2012.0,1,0,1
BRA,ETH,2014.0,1,0,1
EGY,THA,2012.0,1,0,1
GAB,GBR,2020.0,1,0,1
LTU,AUT,2017.0,1,0,1
ALB,ROU,2018.0,1,0,1
MWI,COG,2015.0,1,0,1
DEU,CPV,2015.0,1,0,1
CPV,GBR,2018.0,1,0,1
SDN,AUS,2013.0,1,0,1
BLR,KOR,2016.0,1,0,1
ZMB,BRA,2023.0,1,0,1
POL,QAT,2015.0,1,0,1
HKG,UKR,2022.0,1,0,1
GTM,COL,2017.0,1,0,1
ISR,ISL,2004.0,1,0,1
ABW,LCA,2018.0,1,0,1
VNM,TWN,1999.0,1,0,1
BWA,GHA,2016.0,1,0,1
KHM,COG,2017.0,1,0,1
IND,ARG,2008.0,1,0,1
ISR,CRI,2023.0,1,0,1
UKR,OMN,2012.0,1,0,1
GRC,SGP,2000.0,1,0,1
TUN,IRN,2018.0,1,0,1
IND,SVN,2017.0,1,0,1
FRA,MLT,2021.0,1,0,1
SAU,UKR,2019.0,1,0,1
CHL,MLT,2002.0,1,0,1
,KIR,2014.0,2,0,2
,MNP,2015.0,1,0,1
IRN,JOR,2017.0,1,0,1
EGY,ARM,2009.0,1,0,1
COL,JAM,2010.0,1,0,1
MAR,SAU,2008.0,1,0,1
SWZ,FRA,2011.0,1,0,1
ROU,NOR,2006.0,1,0,1
GNQ,ESP,2010.0,1,0,1
RUS,ISL,2020.0,2,0,2
,KIR,2004.0,1,0,1
ITA,TUN,1998.0,1,0,1
MDG,DEU,2008.0,1,0,1
TUN,DNK,2011.0,1,0,1
THA,SVK,1999.0,1,0,1
ZAF,ROU,2005.0,1,0,1
ITA,IDN,2010.0,1,0,1
MDG,JPN,2002.0,1,0,1
MDG,MCO,2010.0,1,0,1
ESP,KEN,2009.0,1,0,1
VEN,TUR,2010.0,1,0,1
PER,UGA,2017.0,1,0,1
PHL,PSE,1999.0,1,0,1
YEM,DEU,2009.0,1,0,1
CAN,CYP,2020.0,2,0,2
SVK,CHL,2003.0,1,0,1
UZB,JPN,2017.0,1,0,1
EST,DNK,2004.0,1,0,1
TZA,NAM,2012.0,1,0,1
MLI,CMR,2017.0,1,0,1
CMR,COL,2018.0,1,0,1
MRT,BEL,2004.0,1,0,1
HUN,OMN,2008.0,1,0,1
TUR,IDN,2018.0,1,0,1
CHN,LSO,2020.0,1,0,1
USA,GUF,2022.0,1,0,1
SVN,LUX,2023.0,1,0,1
IRN,LUX,2023.0,1,0,1
BRA,SLV,2020.0,1,0,1
BRA,TTO,2019.0,1,0,1
MWI,MOZ,2020.0,1,0,1
ATA,CAN,2021.0,1,0,1
HRV,FIN,2022.0,1,0,1
CHE,BHR,2020.0,1,0,1
CAN,MLI,2009.0,1,0,1
SWE,MOZ,1998.0,1,0,1
COD,ZAF,1997.0,1,0,1
FIN,PAK,1998.0,1,0,1
PRI,GRC,2000.0,1,0,1
NZL,GHA,1998.0,2,0,2
NLD,SYR,2012.0,1,0,1
CIV,GAB,2011.0,1,0,1
CHE,IDN,2002.0,1,0,1
LKA,UGA,1998.0,1,0,1
JPN,MDA,2005.0,1,0,1
MWI,SWZ,1997.0,1,0,1
HRV,HUN,1997.0,1,0,1
PHL,GRC,2016.0,1,0,1
MAR,DZA,2005.0,1,0,1
DEU,LBY,2004.0,1,0,1
MYS,FIN,2002.0,1,0,1
TZA,NAM,2002.0,1,0,1
OMN,BHR,2019.0,1,0,1
MYS,SAU,1999.0,1,0,1
MUS,ITA,2023.0,1,0,1
KWT,KGZ,2023.0,1,0,1
AUS,PAN,2006.0,1,0,1
PAN,AUS,2008.0,1,0,1
FRA,EST,2005.0,1,0,1
TUN,ARE,2001.0,2,0,2
LTU,BGR,2001.0,1,0,1
BGR,LTU,2003.0,1,0,1
UZB,MEX,2001.0,1,0,1
ECU,HTI,2011.0,1,0,1
BEL,BFA,2002.0,1,0,1
LKA,FRA,2013.0,1,0,1
CHE,MNG,2011.0,1,0,1
BEL,CIV,2005.0,1,0,1
MKD,BRA,2019.0,1,0,1
PNG,NCL,2014.0,1,0,1
ITA,MTQ,2012.0,1,0,1
JPN,LBY,2017.0,1,0,1
AZE,ITA,2019.0,1,0,1
FRA,LBY,2016.0,1,0,1
PHL,IDN,2000.0,1,0,1
ZAF,MRT,2016.0,1,0,1
LTU,JPN,2012.0,1,0,1
SYC,ZAF,2014.0,1,0,1
MKD,TUR,2011.0,1,0,1
NOR,KEN,2011.0,2,0,2
UKR,NZL,2013.0,1,0,1
BHR,SAU,2024.0,1,0,1
DOM,CHL,2009.0,1,0,1
PRT,UKR,2015.0,1,0,1
RUS,KWT,2015.0,1,0,1
LBY,CHN,2020.0,1,0,1
EST,LUX,2019.0,1,0,1
CHL,KAZ,2018.0,1,0,1
NGA,MLI,2010.0,1,0,1
BRA,GAB,2022.0,1,0,1
BGD,ESP,2006.0,1,0,1
TTO,HUN,2014.0,1,0,1
CHE,SEN,2022.0,1,0,1
GRC,HTI,2020.0,1,0,1
SEN,CAN,2018.0,2,0,2
KEN,NER,2002.0,1,0,1
NER,USA,2003.0,1,0,1
HTI,CHN,2018.0,1,0,1
BRA,LKA,2022.0,1,0,1
CMR,ESP,2009.0,1,0,1
AIA,,2023.0,1,0,1
EST,AUS,1998.0,1,0,1
GBR,MNE,2014.0,1,0,1
USA,PLW,2011.0,1,0,1
RUS,CMR,2007.0,1,0,1
BLR,ARM,2019.0,1,0,1
CAF,,1999.0,1,0,1
USA,LUX,2002.0,1,0,1
ITA,BEN,2008.0,1,0,1
COL,CZE,2009.0,1,0,1
BRB,DEU,2006.0,1,0,1
NGA,AIA,2014.0,1,0,1
NZL,IDN,2004.0,1,0,1
MEX,PYF,2015.0,1,0,1
IRN,NOR,1997.0,1,0,1
FJI,SLB,2011.0,1,0,1
TJK,DEU,2000.0,1,0,1
DEU,TJK,2003.0,1,0,1
TUN,CIV,2018.0,1,0,1
AGO,ZAF,2000.0,1,0,1
ESP,OMN,2013.0,1,0,1
SWE,PER,2000.0,1,0,1
SWE,COG,2015.0,1,0,1
TWN,SRB,2011.0,1,0,1
IDN,ZMB,2020.0,1,0,1
SVK,IRQ,2006.0,1,0,1
CHE,BTN,2013.0,1,0,1
KEN,NGA,2002.0,1,0,1
RUS,IRQ,2006.0,1,0,1
UZB,GRC,1998.0,1,0,1
MYS,ETH,2012.0,1,0,1
MYS,LBY,1998.0,1,0,1
UGA,ETH,2009.0,1,0,1
PNG,MYS,2004.0,1,0,1
JOR,DZA,2012.0,1,0,1
DEU,BRN,2016.0,1,0,1
UKR,SAU,2011.0,1,0,1
GIN,CIV,2016.0,2,0,2
KOR,GEO,1997.0,1,0,1
GRC,ZAF,2007.0,1,0,1
JPN,SRB,2001.0,1,0,1
MEX,TUR,2000.0,1,0,1
HKG,LKA,2008.0,1,0,1
COL,SEN,2009.0,1,0,1
LVA,CHE,2013.0,1,0,1
DEU,JAM,2011.0,1,0,1
TUN,JPN,2001.0,1,0,1
CRI,SLV,2016.0,1,0,1
MYS,EST,2013.0,1,0,1
CAN,LVA,2003.0,1,0,1
NGA,BWA,2023.0,1,0,1
CAN,TZA,2005.0,1,0,1
NZL,PNG,2010.0,1,0,1
CHE,COG,2013.0,1,0,1
SGP,HUN,2014.0,1,0,1
SLV,GTM,2007.0,1,0,1
SYR,KAZ,2009.0,1,0,1
MDA,CZE,2018.0,1,0,1
JAM,CYM,2015.0,1,0,1
FIN,SVN,2023.0,1,0,1
KEN,THA,2014.0,1,0,1
BHR,IRL,1998.0,1,0,1
PRI,VGB,2011.0,2,0,2
VGB,,2015.0,1,0,1
CZE,ISL,2014.0,1,0,1
SVN,SGP,2014.0,1,0,1
TUR,CZE,2007.0,1,0,1
CHE,NAM,2013.0,1,0,1
DEU,BHS,2023.0,1,0,1
PNG,CZE,2011.0,1,0,1
BHR,SGP,2008.0,1,0,1
IRL,BIH,2010.0,1,0,1
FJI,SLB,2009.0,1,0,1
MDG,KHM,2014.0,1,0,1
GRC,ISL,2009.0,2,0,2
BOL,CUB,2009.0,1,0,1
TUN,COL,2017.0,1,0,1
KEN,BRA,2017.0,1,0,1
ISL,AUT,2015.0,1,0,1
IDN,AFG,2013.0,1,0,1
GMB,SLE,2018.0,1,0,1
ESP,CIV,2013.0,1,0,1
SLE,BFA,2020.0,1,0,1
KEN,CIV,2022.0,1,0,1
USA,CAF,2011.0,1,0,1
SEN,CIV,2019.0,1,0,1
BFA,TWN,2012.0,1,0,1
WSM,ASM,2023.0,1,0,1
IND,KAZ,2018.0,1,0,1
POL,MCO,2018.0,1,0,1
GBR,BMU,2006.0,2,0,2
IRL,BRA,2001.0,2,0,2
BRA,IRL,2002.0,3,0,3
HRV,SWE,2017.0,2,0,2
ISR,ARM,2015.0,1,0,1
POL,LUX,2013.0,3,0,3
FRA,UZB,2019.0,2,0,2
DOM,ESP,1997.0,1,0,1
FJI,FRA,2012.0,2,0,2
POL,PER,2010.0,1,0,1
ESP,AND,2000.0,2,0,2
JAM,TTO,1997.0,1,0,1
UGA,EGY,2010.0,1,0,1
DNK,BGD,1997.0,1,0,1
MEX,KOR,2018.0,5,0,5
ZWE,FJI,2020.0,1,0,1
GRC,CHN,2002.0,1,0,1
TZA,OMN,2016.0,1,0,1
PRI,ESP,2000.0,1,0,1
JOR,JPN,1997.0,1,0,1
BRB,TTO,2006.0,3,0,3
ZWE,LSO,2020.0,1,0,1
PRI,CHL,2008.0,2,0,2
TWN,NZL,2023.0,2,0,2
VNM,ZAF,2010.0,2,0,2
IRL,BWA,2014.0,1,0,1
ESP,CYP,2023.0,2,0,2
IND,SYC,2020.0,1,0,1
SWE,FRO,2023.0,1,0,1
KEN,ERI,2022.0,1,0,1
CRI,PER,2005.0,1,0,1
SRB,LBY,2020.0,4,0,4
COM,AUT,2023.0,1,0,1
PAN,IND,2023.0,1,0,1
MDA,BEL,2000.0,1,0,1
LUX,ARE,2020.0,1,0,1
QAT,FIN,2020.0,1,0,1
IRN,SVN,2022.0,1,0,1
IRQ,ISR,2022.0,1,0,1
NGA,FIN,2009.0,1,0,1
FIN,NGA,2017.0,2,0,2
,GRL,2020.0,7,0,7
KEN,NZL,2022.0,1,0,1
MWI,MLI,2023.0,1,0,1
GUF,COD,2022.0,1,0,1
IND,AZE,2018.0,1,0,1
TUR,ALB,2018.0,3,0,3
LBY,POL,2006.0,1,0,1
EST,KAZ,2008.0,1,0,1
DEU,ALB,2004.0,1,0,1
ECU,BEL,2001.0,1,0,1
NLD,BLR,1998.0,1,0,1
SRB,SVK,2003.0,4,0,4
GAB,,1999.0,3,0,3
ESP,HRV,2015.0,6,0,6
BEL,BGD,2004.0,3,0,3
ZAF,BEN,2001.0,2,0,2
BEL,TTO,2006.0,1,0,1
UGA,ZMB,2013.0,1,0,1
FIN,HKG,2014.0,4,0,4
DEU,CYP,2004.0,2,0,2
DEU,BHR,2007.0,1,0,1
ETH,SAU,2015.0,4,0,4
POL,LIE,2001.0,1,0,1
MKD,BIH,2000.0,1,0,1
FRA,LVA,2014.0,1,0,1
,COM,1995.0,2,0,2
COM,,2009.0,3,0,3
COL,ECU,2004.0,1,0,1
UGA,PNG,2008.0,1,0,1
FRA,YEM,2001.0,1,0,1
POL,ISR,2006.0,2,0,2
SLV,,2001.0,1,0,1
JPN,BFA,2011.0,1,0,1
BRA,DZA,2012.0,1,0,1
CIV,NGA,2003.0,3,0,3
NGA,BFA,2007.0,1,0,1
RUS,LTU,2006.0,2,0,2
FRA,MUS,1998.0,2,0,2
KEN,ZWE,2004.0,2,0,2
NZL,THA,2006.0,1,0,1
LVA,ITA,2011.0,4,0,4
CYM,,1999.0,1,0,1
IRQ,OMN,2007.0,1,0,1
TUR,PRT,2001.0,1,0,1
BHS,USA,2000.0,4,0,4
BFA,CHN,2004.0,3,0,3
LAO,PHL,2013.0,2,0,2
ITA,BMU,2016.0,1,0,1
HUN,QAT,2021.0,1,0,1
CZE,ISR,1999.0,4,0,4
TCD,,2013.0,4,0,4
NPL,BTN,2015.0,1,0,1
,SUR,2002.0,5,0,5
BGD,TZA,2008.0,1,0,1
UGA,FIN,2010.0,1,0,1
ZAF,MLI,2011.0,1,0,1
KEN,MYS,2010.0,1,0,1
MRT,FRA,2008.0,1,0,1
,GUM,2012.0,9,0,9
GUM,MNP,2016.0,1,0,1
ZAF,CYP,2017.0,1,0,1
GUY,,2007.0,1,0,1
SLV,,2004.0,2,0,2
GMB,ITA,2004.0,1,0,1
IDN,VNM,2013.0,1,0,1
ITA,ALB,2010.0,1,0,1
CHE,LUX,2002.0,3,0,3
MEX,PER,1998.0,1,0,1
,SUR,1997.0,2,0,2
CAN,GIN,2012.0,1,0,1
GIN,CHE,2001.0,1,0,1
UGA,CHE,2010.0,2,0,2
EGY,NZL,2009.0,1,0,1
ARG,LUX,2012.0,1,0,1
EST,ROU,2017.0,2,0,2
DEU,PRY,1997.0,1,0,1
CHE,LUX,1997.0,2,0,2
BRA,BRB,2011.0,2,0,2
BRA,KAZ,2018.0,1,0,1
SEN,ESP,2012.0,1,0,1
TUR,TCD,2008.0,1,0,1
TCD,TUR,2013.0,1,0,1
USA,LIE,2017.0,2,0,2
MRT,FRA,2001.0,2,0,2
LKA,AUT,2023.0,1,0,1
IRL,SVK,2010.0,2,0,2
GRC,ZWE,2014.0,1,0,1
AGO,CHE,2017.0,1,0,1
UKR,PRT,2014.0,3,0,3
TGO,ZAF,2016.0,2,0,2
WLF,GBR,2015.0,1,0,1
HRV,KWT,2020.0,1,0,1
CUB,YEM,2014.0,2,0,2
BRA,HKG,2019.0,1,0,1
RUS,MNG,2012.0,2,0,2
ISR,GEO,2018.0,3,0,3
ISR,SVK,2005.0,1,0,1
ROU,ZAF,2022.0,1,0,1
ARE,MEX,2022.0,2,0,2
HKG,MYS,2009.0,1,0,1
ZAF,UKR,2014.0,1,0,1
RUS,CYP,2009.0,2,0,2
KOR,TZA,2012.0,2,0,2
CHN,VNM,2008.0,1,0,1
PER,DOM,2020.0,1,0,1
IRQ,QAT,2018.0,1,0,1
CHN,SVN,2006.0,2,0,2
DZA,CHE,2017.0,4,0,4
CRI,PAN,2015.0,1,0,1
,TON,2019.0,1,0,1
UKR,IRL,2020.0,1,0,1
ISL,VEN,2016.0,1,0,1
FIN,MWI,2017.0,2,0,2
BRA,BVT,2017.0,1,0,1
FRA,PNG,2017.0,1,0,1
DEU,LBR,2016.0,4,0,4
ALB,THA,2019.0,1,0,1
COD,UGA,2020.0,1,0,1
LVA,SVK,2018.0,1,0,1
ECU,CHE,2021.0,3,0,3
DMA,,2023.0,3,0,3
FIN,SSD,2021.0,1,0,1
LBN,SWE,2018.0,1,0,1
SHN,,2020.0,1,0,1
BGR,LTU,2015.0,1,0,1
MEX,DOM,2017.0,6,0,6
NOR,BGD,2017.0,3,0,3
GBR,PNG,2019.0,1,0,1
GBR,KIR,2019.0,1,0,1
PSE,MEX,2015.0,1,0,1
MEX,PSE,2016.0,1,0,1
UGA,CHE,2023.0,1,0,1
BRN,KAZ,2023.0,1,0,1
USA,WSM,2020.0,3,0,3
ASM,,2023.0,3,0,3
CHN,ISL,2003.0,2,0,2
SEN,NGA,2022.0,2,0,2
TWN,BFA,2022.0,1,0,1
HTI,COD,2020.0,1,0,1
ISR,GMB,2020.0,1,0,1
IND,GHA,2019.0,3,0,3
GHA,BWA,2022.0,1,0,1
GRC,JPN,2022.0,4,0,4
KNA,BEL,2022.0,1,0,1
CZE,THA,2023.0,1,0,1
NLD,LVA,2006.0,1,0,1
UGA,NPL,2013.0,1,0,1
PYF,NCL,2002.0,2,0,2
IND,EGY,1997.0,2,0,2
NPL,ISR,2003.0,1,0,1
GBR,BRB,2001.0,1,0,1
PRT,LUX,2005.0,2,0,2
GBR,LCA,2014.0,2,0,2
JOR,LBN,2001.0,1,0,1
HND,PHL,2010.0,1,0,1
CRI,FIN,1998.0,1,0,1
ARG,SGP,2014.0,1,0,1
ISR,HUN,2004.0,1,0,1
SLV,BRA,2003.0,1,0,1
SVN,PRT,2018.0,4,0,4
MYS,KWT,1999.0,1,0,1
ZAF,CHL,2000.0,1,0,1
FJI,GBR,2003.0,3,0,3
SLV,SWE,2017.0,1,0,1
NZL,CHL,2008.0,2,0,2
ZAF,EST,2019.0,1,0,1
MKD,MAC,2015.0,1,0,1
KEN,FIN,2012.0,1,0,1
LKA,UGA,2012.0,1,0,1
,BDI,2009.0,6,0,6
DEU,TZA,1998.0,2,0,2
MMR,PHL,2015.0,1,0,1
GEO,JPN,2017.0,1,0,1
SWE,MOZ,2012.0,2,0,2
SMR,,2019.0,2,0,2
COL,URY,2023.0,2,0,2
BOL,SWE,2015.0,4,0,4
PAN,DNK,2012.0,1,0,1
BEL,NIC,2015.0,1,0,1
NZL,KAZ,2011.0,1,0,1
YEM,THA,2008.0,1,0,1
THA,IRQ,2012.0,1,0,1
SEN,SAU,2014.0,1,0,1
SYR,ESP,2016.0,1,0,1
CHE,TCA,2021.0,1,0,1
TCA,,2025.0,4,0,4
TUN,BRA,2017.0,1,0,1
SLB,FJI,2016.0,1,0,1
BRA,TZA,2018.0,1,0,1
SDN,QAT,2022.0,4,0,4
MYS,RUS,2016.0,2,0,2
BGR,UKR,2017.0,3,0,3
IRL,HKG,2018.0,1,0,1
MSR,,2023.0,1,0,1
,BGR,2021.0,1,0,1
,SMR,2019.0,3,0,3
CAN,MNG,2023.0,1,0,1
ESP,SEN,2006.0,1,0,1
COL,JAM,2009.0,1,0,1
CUB,ZAF,2005.0,1,0,1
,MCO,2001.0,6,0,6
KEN,ZMB,2013.0,1,0,1
RWA,BGD,2007.0,1,0,1
SRB,NOR,2008.0,5,0,5
ARG,ARE,2009.0,2,0,2
UKR,PRI,2012.0,1,0,1
MLI,BEN,1998.0,1,0,1
JPN,FJI,2007.0,1,0,1
LKA,PNG,2021.0,1,0,1
RUS,OMN,2002.0,1,0,1
ESP,PLW,2007.0,1,0,1
LSO,RWA,2013.0,1,0,1
HRV,JPN,2021.0,1,0,1
ALB,DEU,2022.0,2,0,2
,KNA,2020.0,13,0,13
USA,IRQ,2004.0,4,0,4
BGD,BRN,2011.0,1,0,1
PYF,,2015.0,7,0,7
COM,GBR,2018.0,1,0,1
CHE,AGO,2020.0,1,0,1
AGO,CHE,2022.0,1,0,1
PNG,SLB,2014.0,1,0,1
ESP,MYS,2020.0,3,0,3
GNQ,ESP,2021.0,1,0,1
IDN,BGR,2021.0,1,0,1
KNA,,2017.0,1,0,1
CYP,BEL,2012.0,1,0,1
VEN,MAR,2015.0,1,0,1
PYF,JPN,2018.0,1,0,1
NGA,URY,2013.0,2,0,2
CZE,PRY,2017.0,2,0,2
DEU,ZMB,2015.0,1,0,1
ISR,NOR,2006.0,2,0,2
GHA,IRQ,2017.0,1,0,1
NLD,EST,2006.0,1,0,1
GUY,IDN,2023.0,1,0,1
BRA,AUS,2024.0,1,0,1
ROU,NOR,2019.0,2,0,2
IND,RWA,2020.0,3,0,3
NOR,MEX,2012.0,1,0,1
LIE,,2022.0,2,0,2
GHA,SWE,2014.0,2,0,2
IRN,AFG,2017.0,1,0,1
TJK,IND,2021.0,1,0,1
KOR,EST,2021.0,2,0,2
SLV,,2008.0,2,0,2
,GNB,2003.0,2,0,2
PAK,LUX,2023.0,2,0,2
KOR,GTM,2015.0,1,0,1
NCL,SWE,2017.0,1,0,1
,ATG,2006.0,2,0,2
ERI,GBR,2018.0,1,0,1
ZWE,,2026.0,4,0,4
NPL,DEU,2000.0,1,0,1
AUT,LIE,2011.0,1,0,1
LCA,FRA,2014.0,1,0,1
IRL,MWI,2006.0,2,0,2
EGY,LUX,2020.0,2,0,2
COD,ITA,2020.0,1,0,1
IND,TJK,2020.0,1,0,1
PYF,GIN,2017.0,1,0,1
GHA,BFA,2023.0,1,0,1
CHN,NER,2013.0,1,0,1
,MYS,2021.0,25,0,25
,AFG,2021.0,1,0,1
IND,MDG,2000.0,1,0,1
GRC,TUN,2007.0,1,0,1
USA,GUY,2020.0,2,0,2
NIC,GHA,2022.0,1,0,1
GUY,IRL,2022.0,1,0,1
,PRT,2021.0,14,0,14
NAM,SWE,2014.0,1,0,1
HRV,IDN,2008.0,1,0,1
KWT,HUN,1999.0,1,0,1
MUS,FRA,2002.0,1,0,1
ZWE,ETH,2007.0,1,0,1
ETH,ZWE,2012.0,2,0,2
ZMB,DNK,2000.0,1,0,1
COD,BWA,2015.0,1,0,1
BWA,COD,2021.0,1,0,1
PAK,ESP,2007.0,2,0,2
NLD,SUR,2012.0,1,0,1
FJI,SLB,2023.0,1,0,1
SGP,ROU,2006.0,1,0,1
SAU,HUN,2018.0,1,0,1
COM,,2021.0,1,0,1
PSE,BHR,2013.0,1,0,1
DNK,BFA,2004.0,1,0,1
THA,MDG,2019.0,1,0,1
LSO,,2007.0,1,0,1
DEU,GMB,2009.0,1,0,1
GRC,AUS,2012.0,7,0,7
BGD,SWE,2004.0,2,0,2
BLR,GEO,2016.0,1,0,1
MLI,DNK,2018.0,1,0,1
ISR,MKD,1998.0,1,0,1
KEN,TUN,2003.0,1,0,1
NZL,LAO,1998.0,1,0,1
LAO,,2002.0,2,0,2
ARM,CHE,2001.0,1,0,1
FJI,NGA,2023.0,1,0,1
ZAF,ERI,2008.0,1,0,1
SVK,BLR,1998.0,2,0,2
DOM,CUB,2010.0,2,0,2
AGO,ITA,2002.0,1,0,1
KHM,IDN,2009.0,1,0,1
MAR,CAN,1998.0,1,0,1
FRA,VUT,1997.0,1,0,1
LTU,NLD,1999.0,3,0,3
NLD,LTU,2000.0,1,0,1
IRL,MCO,2019.0,2,0,2
,SOM,1995.0,2,0,2
BLR,JPN,2003.0,2,0,2
UKR,ISR,2008.0,1,0,1
RWA,UGA,2010.0,1,0,1
ROU,MEX,2007.0,1,0,1
VNM,ROU,2020.0,1,0,1
KHM,ETH,2016.0,1,0,1
BEL,SGP,1997.0,2,0,2
CRI,POL,2013.0,1,0,1
PAK,TZA,2011.0,2,0,2
ARM,EST,2016.0,1,0,1
BMU,MCO,2010.0,1,0,1
DEU,MAC,2016.0,1,0,1
PAK,GRC,2019.0,1,0,1
SVK,AUS,2012.0,1,0,1
HUN,BHR,2005.0,1,0,1
ZWE,ITA,2014.0,1,0,1
GUY,CAN,2007.0,1,0,1
CHL,SWE,2010.0,2,0,2
PAN,FIN,2019.0,1,0,1
JPN,ECU,2014.0,1,0,1
UGA,BWA,2014.0,1,0,1
ARM,GBR,2007.0,1,0,1
FIN,NAM,2016.0,2,0,2
DEU,ARE,2005.0,3,0,3
AIA,,2025.0,1,0,1
NCL,FJI,2006.0,1,0,1
CHE,GNQ,2016.0,1,0,1
GNQ,CHE,2019.0,1,0,1
BWA,JAM,2005.0,1,0,1
JAM,BWA,2010.0,1,0,1
AUS,MAC,2021.0,3,0,3
YEM,CHN,2003.0,1,0,1
JPN,MCO,1999.0,1,0,1
MCO,JPN,2002.0,1,0,1
IRL,TWN,2008.0,1,0,1
GTM,FRA,2012.0,1,0,1
BWA,MLI,2018.0,1,0,1
TGO,BFA,2014.0,3,0,3
ETH,IDN,2021.0,1,0,1
NOR,BEN,2022.0,1,0,1
TUN,MLT,2007.0,1,0,1
PRI,PHL,2016.0,1,0,1
VNM,MAR,2021.0,1,0,1
,WSM,2020.0,6,0,6
GBR,BIH,1999.0,1,0,1
IRL,URY,2001.0,1,0,1
SAU,NOR,2005.0,1,0,1
BOL,ARG,2014.0,1,0,1
BES,NLD,2019.0,1,0,1
JPN,ZAF,2024.0,1,0,1
BFA,ESP,2011.0,1,0,1
NZL,TUR,1998.0,1,0,1
NOR,SRB,2003.0,1,0,1
DOM,CUB,2000.0,1,0,1
BLR,FIN,1999.0,1,0,1
SGP,IRN,1998.0,1,0,1
LUX,FRA,1998.0,3,0,3
PAK,DNK,2004.0,1,0,1
IRL,TUN,2017.0,1,0,1
TUR,KEN,2007.0,1,0,1
KWT,NOR,2007.0,1,0,1
POL,CHL,2005.0,1,0,1
SVK,CHL,2001.0,1,0,1
ITA,ALB,2000.0,3,0,3
SYC,,2001.0,1,0,1
ZAF,GAB,2004.0,1,0,1
ZAF,GAB,2008.0,5,0,5
BGR,URY,2005.0,1,0,1
URY,BGR,2008.0,1,0,1
GAB,BEL,2006.0,1,0,1
HTI,CHE,2017.0,1,0,1
HUN,POL,2008.0,3,0,3
DNK,FRO,2002.0,1,0,1
GBR,BIH,2007.0,1,0,1
ALB,FRA,2020.0,1,0,1
MAR,TGO,2009.0,1,0,1
VEN,CZE,2018.0,2,0,2
SWE,LBY,2019.0,1,0,1
LKA,UZB,2010.0,1,0,1
GAB,NLD,2013.0,1,0,1
MEX,ISR,2012.0,3,0,3
DEU,AFG,2016.0,2,0,2
GIB,GBR,2018.0,1,0,1
FRA,MRT,2000.0,1,0,1
POL,ISL,2012.0,1,0,1
BHR,TUR,2005.0,2,0,2
COL,ARE,2011.0,1,0,1
IRL,ROU,2001.0,2,0,2
,KNA,2007.0,1,0,1
SWZ,BWA,2005.0,1,0,1
,FRO,2007.0,4,0,4
BIH,NGA,2012.0,2,0,2
NLD,CMR,2023.0,1,0,1
MCO,DEU,2023.0,1,0,1
NGA,TUR,2012.0,1,0,1
JPN,KHM,2014.0,2,0,2
CMR,BFA,2014.0,1,0,1
LAO,GBR,2023.0,3,0,3
SAU,IDN,2012.0,1,0,1
HUN,CMR,2017.0,1,0,1
IND,KGZ,2022.0,2,0,2
AFG,CAN,2009.0,1,0,1
NZL,IRN,2005.0,2,0,2
FRA,COM,2007.0,1,0,1
GNB,,2005.0,2,0,2
MNG,KOR,2010.0,2,0,2
PLW,FSM,2021.0,1,0,1
DNK,KWT,2013.0,1,0,1
SGP,VIR,2018.0,1,0,1
PLW,CHE,2022.0,1,0,1
UKR,HKG,2021.0,1,0,1
USA,BRN,2016.0,2,0,2
ITA,TGO,2021.0,1,0,1
MTQ,,2019.0,4,0,4
CIV,COG,2016.0,1,0,1
PAK,EST,2023.0,2,0,2
EGY,TUN,2000.0,1,0,1
CUB,QAT,2018.0,1,0,1
GRC,ALB,2019.0,1,0,1
GRC,HKG,2019.0,2,0,2
BEL,SEN,2003.0,2,0,2
UGA,BEN,2015.0,1,0,1
,MNP,2013.0,1,0,1
PAK,ALB,2018.0,2,0,2
SDN,TUR,2017.0,2,0,2
FRA,QAT,2005.0,1,0,1
QAT,BGD,2008.0,1,0,1
BGD,SDN,2008.0,1,0,1
ESP,MDG,2020.0,1,0,1
PRK,,2026.0,8,0,8
SEN,COD,2023.0,1,0,1
BGD,HUN,2021.0,2,0,2
FRO,GBR,1998.0,1,0,1
KGZ,RUS,1998.0,2,0,2
HRV,RUS,2003.0,1,0,1
FRA,LIE,2000.0,1,0,1
PER,CHN,2012.0,1,0,1
CHN,PER,2015.0,2,0,2
JPN,COG,2010.0,1,0,1
SVK,BRA,2007.0,1,0,1
PYF,,2001.0,1,0,1
ATA,USA,2001.0,3,0,3
,STP,1998.0,2,0,2
NOR,BEN,2017.0,1,0,1
CHE,NCL,2013.0,2,0,2
GBR,PRI,2020.0,1,0,1
GMB,MWI,2019.0,1,0,1
BWA,BGD,2018.0,1,0,1
UZB,CHN,2016.0,2,0,2
CHE,SSD,2013.0,1,0,1
ALB,MDG,2010.0,1,0,1
FRA,RWA,2012.0,1,0,1
MEX,IRN,2017.0,1,0,1
TUR,HUN,2010.0,1,0,1
BIH,BEL,2020.0,2,0,2
HRV,JPN,2019.0,2,0,2
BFA,CHE,2015.0,2,0,2
NER,COL,2016.0,1,0,1
CAN,PNG,2017.0,2,0,2
FRA,NGA,2012.0,2,0,2
FIN,TZA,2015.0,1,0,1
NLD,BRN,2007.0,1,0,1
ISR,CRI,2021.0,1,0,1
BGD,ZAF,2012.0,1,0,1
BDI,,2008.0,3,0,3
SRB,IND,2018.0,1,0,1
PAN,CAN,2004.0,1,0,1
CAN,LBR,2022.0,3,0,3
ESP,BGR,2022.0,3,0,3
MNG,USA,1999.0,2,0,2
TJK,,2004.0,5,0,5
KHM,,2002.0,1,0,1
IND,ARM,2007.0,1,0,1
BEN,GBR,2012.0,1,0,1
AUT,TWN,2006.0,1,0,1
ALB,USA,2004.0,1,0,1
MNP,USA,1999.0,1,0,1
BEN,ITA,2007.0,2,0,2
NZL,MEX,1999.0,2,0,2
CAN,IRQ,2014.0,3,0,3
UKR,AUT,2023.0,6,0,6
,BLZ,1997.0,2,0,2
ESP,COM,2010.0,1,0,1
BLR,HUN,1999.0,1,0,1
BEL,CUB,2008.0,3,0,3
KOR,KAZ,2003.0,1,0,1
LBN,ETH,2020.0,1,0,1
GRC,MCO,1999.0,1,0,1
GRC,THA,2008.0,1,0,1
PHL,HUN,2022.0,1,0,1
SWE,FRO,2010.0,2,0,2
CHE,CIV,2003.0,1,0,1
MTQ,CHE,1998.0,1,0,1
ALB,,2004.0,3,0,3
HKG,AUT,2005.0,1,0,1
SRB,BRA,2009.0,1,0,1
LVA,FIN,2002.0,1,0,1
USA,PYF,2015.0,2,0,2
CIV,IND,2008.0,1,0,1
SVN,ARE,2010.0,1,0,1
SWE,JOR,2005.0,1,0,1
KHM,SWE,2007.0,1,0,1
CHE,IDN,1999.0,2,0,2
THA,BEL,2004.0,1,0,1
SWE,COG,2003.0,1,0,1
BWA,MWI,2009.0,2,0,2
KAZ,HUN,1998.0,1,0,1
ISR,KAZ,2006.0,1,0,1
PAK,KEN,2013.0,1,0,1
,LIE,1998.0,3,0,3
USA,BHR,2003.0,1,0,1
ISR,MYS,2014.0,1,0,1
ZAF,GNB,2014.0,1,0,1
MDA,KOR,2002.0,1,0,1
SEN,MAR,2001.0,1,0,1
MRT,,2001.0,1,0,1
TUR,KAZ,2005.0,1,0,1
FRA,UGA,2006.0,1,0,1
CZE,CHN,2003.0,2,0,2
HKG,ITA,1999.0,1,0,1
PER,MLI,2008.0,1,0,1
MNG,,2007.0,7,0,7
CHN,PRI,1998.0,1,0,1
HKG,ZAF,2000.0,1,0,1
ZAF,CHN,2003.0,3,0,3
NPL,QAT,2008.0,1,0,1
THA,ISR,1999.0,1,0,1
TWN,LTU,2001.0,1,0,1
HUN,CHN,2005.0,1,0,1
NOR,MEX,2005.0,2,0,2
MCO,NLD,2007.0,1,0,1
MLT,USA,2022.0,1,0,1
JPN,MRT,2012.0,1,0,1
USA,CPV,2013.0,1,0,1
PAN,PHL,2015.0,1,0,1
BHR,THA,2020.0,1,0,1
SWZ,CHE,2004.0,1,0,1
SGP,MMR,2009.0,1,0,1
CHN,SDN,2013.0,2,0,2
SWE,BFA,2007.0,1,0,1
HKG,CHL,2004.0,1,0,1
ALB,DNK,2021.0,1,0,1
YEM,GBR,2013.0,1,0,1
SWZ,,2011.0,2,0,2
GRC,MKD,2007.0,1,0,1
MNG,ETH,2016.0,1,0,1
SVK,VNM,2017.0,1,0,1
THA,QAT,2016.0,1,0,1
THA,QAT,2018.0,1,0,1
HKG,SAU,2008.0,1,0,1
HKG,NOR,2011.0,2,0,2
PRT,TUN,2007.0,2,0,2
SRB,AUS,2018.0,3,0,3
MUS,IND,1999.0,1,0,1
IRQ,CAN,2008.0,2,0,2
KHM,MDG,2005.0,1,0,1
MEX,SAU,2012.0,1,0,1
GTM,NLD,2012.0,1,0,1
NZL,ISL,2022.0,2,0,2
BWA,ETH,2014.0,1,0,1
JPN,NCL,2009.0,1,0,1
TWN,MNG,2015.0,2,0,2
TUR,ISL,2019.0,1,0,1
DZA,USA,2013.0,5,0,5
LVA,AUS,2015.0,1,0,1
TWN,FIN,2009.0,1,0,1
,BHS,1999.0,2,0,2
BHS,BHR,2002.0,2,0,2
PAK,GEO,2011.0,5,0,5
MEX,NZL,2002.0,2,0,2
GRC,MEX,2016.0,3,0,3
IRL,MEX,2008.0,1,0,1
SGP,COL,2021.0,3,0,3
COG,SOM,2016.0,1,0,1
BEL,CMR,2003.0,6,0,6
ZAF,VNM,2018.0,1,0,1
RWA,COG,2012.0,1,0,1
IND,LSO,2007.0,1,0,1
DZA,AGO,2018.0,1,0,1
PSE,MOZ,2011.0,1,0,1
MOZ,PSE,2013.0,1,0,1
COL,EGY,2019.0,1,0,1
LBY,LBR,2019.0,1,0,1
BEN,MAR,2021.0,1,0,1
RUS,COL,2023.0,1,0,1
ESP,GEO,2020.0,1,0,1
PAK,CYP,2023.0,1,0,1
HUN,UZB,2019.0,1,0,1
MAR,AUT,2020.0,1,0,1
HTI,GIN,2020.0,1,0,1
ITA,BHS,2020.0,1,0,1
NLD,BWA,2017.0,1,0,1
PRI,CHL,2014.0,1,0,1
PAK,PRT,2015.0,1,0,1
MDG,JPN,2007.0,1,0,1
WSM,BEL,2021.0,1,0,1
SWE,OMN,2019.0,1,0,1
HKG,PRT,2010.0,2,0,2
KWT,CHN,2009.0,1,0,1
GUF,BFA,1999.0,1,0,1
DEU,MKD,2010.0,3,0,3
DJI,,2014.0,3,0,3
ESP,POL,2024.0,1,0,1
JPN,KHM,2001.0,1,0,1
QAT,BHR,2005.0,1,0,1
CAN,KNA,2013.0,1,0,1
IDN,BRA,2008.0,1,0,1
TTO,GLP,2011.0,2,0,2
AUS,AND,2010.0,1,0,1
SAU,IRL,2000.0,1,0,1
ARE,GRC,1998.0,1,0,1
IND,POL,2004.0,1,0,1
GRC,PRT,1998.0,1,0,1
TUN,MAR,2000.0,1,0,1
KAZ,OMN,2014.0,1,0,1
HUN,NOR,2009.0,4,0,4
SRB,PRT,2006.0,1,0,1
EST,CAN,2007.0,1,0,1
UZB,FRA,2005.0,2,0,2
KWT,THA,2020.0,1,0,1
GEO,POL,2005.0,1,0,1
USA,PYF,2001.0,1,0,1
BGR,SVK,2000.0,1,0,1
SVK,ESP,2006.0,3,0,3
SVK,DNK,2000.0,1,0,1
TUR,JOR,1999.0,1,0,1
KWT,BHR,2010.0,2,0,2
SLE,NOR,2003.0,1,0,1
PSE,ARE,2008.0,1,0,1
EGY,ISR,2000.0,1,0,1
DEU,ETH,1999.0,3,0,3
ITA,SLV,2002.0,1,0,1
NCL,NZL,2020.0,2,0,2
ARM,TWN,2004.0,1,0,1
MOZ,SWE,2005.0,1,0,1
ARE,HUN,2011.0,2,0,2
CUB,AUS,2015.0,1,0,1
ZAF,BHR,2006.0,1,0,1
CUB,CHN,2014.0,3,0,3
NLD,LBN,2018.0,2,0,2
NOR,SDN,2012.0,1,0,1
SDN,CAN,2019.0,1,0,1
TWN,LTU,2014.0,1,0,1
BDI,AGO,2020.0,1,0,1
NLD,TUN,2007.0,1,0,1
GLP,USA,2010.0,1,0,1
GBR,SWZ,2012.0,3,0,3
KWT,PSE,2016.0,1,0,1
PER,KHM,2014.0,1,0,1
FRA,OMN,2014.0,2,0,2
ITA,MNE,2023.0,1,0,1
KWT,BHR,2000.0,1,0,1
AUS,MOZ,2012.0,2,0,2
IND,BRB,2000.0,1,0,1
ITA,PRI,2007.0,2,0,2
BLZ,USA,2000.0,1,0,1
EGY,BGR,2016.0,1,0,1
SRB,PRT,2023.0,3,0,3
ZAF,CYP,2016.0,1,0,1
BRA,BLR,2016.0,1,0,1
,ABW,2008.0,1,0,1
SDN,FIN,2001.0,1,0,1
BEL,LBR,2010.0,1,0,1
USA,SSD,2016.0,1,0,1
GAB,AUT,2016.0,1,0,1
CHE,PSE,2021.0,1,0,1
NLD,GHA,2004.0,2,0,2
BOL,DEU,2019.0,1,0,1
,SMR,2011.0,2,0,2
TWN,KEN,2015.0,1,0,1
BLR,CAN,2020.0,2,0,2
MNE,RUS,2021.0,1,0,1
CAN,HND,2022.0,1,0,1
BRA,BVT,2018.0,1,0,1
TZA,FIN,2022.0,1,0,1
COD,IDN,2019.0,1,0,1
IND,MWI,2020.0,1,0,1
SDN,BGD,2019.0,1,0,1
DMA,KNA,2019.0,1,0,1
BRA,OMN,2022.0,2,0,2
MDG,MOZ,2022.0,1,0,1
CHE,HRV,2024.0,1,0,1
PAN,POL,2021.0,1,0,1
URY,ECU,2013.0,1,0,1
SAU,RWA,2022.0,1,0,1
SVN,MKD,2018.0,1,0,1
BGD,AUT,2019.0,1,0,1
FIN,HKG,2008.0,1,0,1
VEN,SGP,2017.0,1,0,1
UKR,NOR,2006.0,1,0,1
CHL,FIN,2005.0,3,0,3
NOR,AZE,2023.0,1,0,1
,COG,2020.0,34,0,34
EST,ETH,2019.0,2,0,2
NZL,PLW,2016.0,1,0,1
DZA,ZAF,2020.0,1,0,1
TUR,ETH,2020.0,1,0,1
COL,SLV,2022.0,1,0,1
ARE,BLR,2015.0,1,0,1
GHA,BRN,2021.0,1,0,1
FIN,CRI,2014.0,1,0,1
THA,NOR,2002.0,1,0,1
PRT,URY,2007.0,1,0,1
KAZ,VNM,2021.0,1,0,1
ERI,CAN,2012.0,1,0,1
BGD,HKG,2008.0,1,0,1
PAK,PHL,2014.0,1,0,1
MCO,NOR,2004.0,1,0,1
KOR,KAZ,2013.0,2,0,2
GBR,PRY,2001.0,1,0,1
OMN,ISR,2016.0,1,0,1
USA,CYM,2007.0,1,0,1
CHE,PHL,2011.0,2,0,2
ESP,LBN,2006.0,1,0,1
GMB,AUS,2005.0,1,0,1
VNM,ARE,2004.0,1,0,1
NGA,MAR,2012.0,1,0,1
IRL,KNA,2014.0,1,0,1
MYS,FIN,2007.0,1,0,1
ETH,RWA,2014.0,1,0,1
USA,BHS,2008.0,2,0,2
PNG,PAK,2005.0,1,0,1
UKR,NZL,2008.0,1,0,1
AUT,BWA,2010.0,1,0,1
EGY,CZE,2005.0,1,0,1
KOR,EST,2019.0,1,0,1
FRA,LBR,2018.0,1,0,1
NLD,BRN,2020.0,2,0,2
CUB,CHN,2015.0,1,0,1
NLD,BOL,2011.0,1,0,1
ITA,MKD,2000.0,1,0,1
DEU,SYR,2007.0,1,0,1
TWN,MEX,2009.0,2,0,2
TTO,NZL,2014.0,1,0,1
BOL,NZL,2005.0,1,0,1
AUS,ROU,2009.0,2,0,2
GUY,BRA,2010.0,1,0,1
EGY,IRN,2006.0,1,0,1
AUS,TJK,2019.0,1,0,1
SYR,BGD,2012.0,1,0,1
MCO,ITA,1998.0,1,0,1
JPN,PAN,2003.0,1,0,1
BEL,QAT,2008.0,1,0,1
CMR,GHA,2011.0,1,0,1
EGY,ZAF,1997.0,1,0,1
CZE,ARE,2007.0,1,0,1
BLR,AZE,1998.0,1,0,1
MOZ,PAK,2008.0,1,0,1
HUN,BRA,1997.0,1,0,1
ISL,DEU,2013.0,1,0,1
RUS,HRV,2022.0,3,0,3
DNK,HKG,2003.0,1,0,1
JPN,WSM,2020.0,1,0,1
GAB,DEU,2000.0,1,0,1
IND,QAT,2009.0,2,0,2
SWZ,CAN,2008.0,1,0,1
,SYC,2009.0,5,0,5
POL,NPL,2013.0,1,0,1
PRT,ARE,2016.0,1,0,1
ESP,CAF,2000.0,1,0,1
GBR,PAN,2009.0,2,0,2
DMA,USA,2004.0,3,0,3
USA,DMA,2005.0,1,0,1
DMA,GBR,2019.0,2,0,2
ARE,FIN,2014.0,1,0,1
BRN,ARE,2007.0,1,0,1
CIV,TGO,2015.0,1,0,1
ETH,HUN,2019.0,1,0,1
CHL,VNM,2011.0,1,0,1
IND,TUN,2003.0,1,0,1
UGA,SGP,2023.0,1,0,1
KEN,MWI,2007.0,1,0,1
CAN,KAZ,2011.0,2,0,2
,MTQ,2005.0,5,0,5
MKD,FIN,2016.0,1,0,1
ARG,POL,2003.0,1,0,1
CZE,GEO,2014.0,1,0,1
FIN,GRC,1998.0,1,0,1
VNM,LAO,2016.0,5,0,5
TJK,DEU,2011.0,1,0,1
UKR,TJK,1999.0,1,0,1
SVN,FIN,2017.0,2,0,2
BRA,THA,2006.0,1,0,1
JPN,LVA,2021.0,1,0,1
MYS,NPL,2018.0,1,0,1
IND,VUT,2017.0,1,0,1
COL,ZAF,2015.0,2,0,2
CYP,IRL,2020.0,2,0,2
OMN,BRN,2007.0,1,0,1
NLD,COD,2018.0,1,0,1
KAZ,PAK,2022.0,1,0,1
IDN,TLS,2018.0,1,0,1
PAN,SAU,2022.0,1,0,1
SRB,UKR,2021.0,1,0,1
PHL,HUN,2017.0,1,0,1
JOR,SYR,2022.0,1,0,1
DEU,MLT,2023.0,5,0,5
BRN,THA,2021.0,1,0,1
NAM,,2026.0,2,0,2
ISL,NLD,2012.0,2,0,2
SDN,IND,2023.0,1,0,1
VNM,BGD,2023.0,1,0,1
QAT,OMN,1998.0,1,0,1
IRL,BGD,1999.0,1,0,1
ZAF,COG,2018.0,1,0,1
LTU,MDA,2017.0,1,0,1
SDN,QAT,2016.0,3,0,3
MAR,GAB,2004.0,1,0,1
FRA,TCD,2004.0,4,0,4
BWA,ERI,2020.0,1,0,1
SYC,,2015.0,2,0,2
JPN,ZMB,2010.0,5,0,5
SOM,BEN,2007.0,1,0,1
ALB,OMN,2016.0,1,0,1
BEN,MLI,2011.0,1,0,1
SVN,HRV,1998.0,2,0,2
UZB,KOR,2014.0,1,0,1
CUB,AUS,2008.0,2,0,2
POL,DZA,2004.0,1,0,1
COM,,2011.0,1,0,1
CHL,NLD,2005.0,1,0,1
VIR,,2014.0,1,0,1
NGA,NAM,1999.0,1,0,1
COL,PRI,2003.0,1,0,1
TKM,,2005.0,4,0,4
BGD,NOR,2008.0,1,0,1
KEN,MOZ,2016.0,1,0,1
GBR,MDA,2012.0,1,0,1
,TCD,2005.0,5,0,5
NOR,NAM,2018.0,1,0,1
GMB,GHA,2010.0,1,0,1
PHL,DNK,2014.0,1,0,1
UZB,SWE,2012.0,1,0,1
PNG,NGA,2010.0,1,0,1
CMR,NLD,2006.0,1,0,1
ROU,PER,2021.0,1,0,1
JPN,ZWE,2013.0,1,0,1
FIN,EGY,2004.0,2,0,2
PER,VEN,2013.0,1,0,1
FRA,ZWE,1997.0,1,0,1
ZWE,TTO,2001.0,1,0,1
FRA,GHA,2013.0,1,0,1
CUB,PRT,2004.0,2,0,2
AZE,ITA,2000.0,1,0,1
DEU,AGO,2003.0,1,0,1
CHE,KHM,2004.0,1,0,1
CAN,ETH,2013.0,5,0,5
NGA,CHL,2005.0,1,0,1
SEN,TUN,2003.0,1,0,1
AUS,BWA,2008.0,1,0,1
COL,ZAF,2014.0,1,0,1
BRA,NZL,2004.0,2,0,2
LKA,SWE,2003.0,2,0,2
BRB,PAK,2010.0,1,0,1
CRI,HND,2020.0,1,0,1
GBR,RWA,2009.0,2,0,2
COL,CUB,2009.0,2,0,2
BEL,BHR,2016.0,2,0,2
MKD,BIH,2006.0,1,0,1
LKA,MMR,2015.0,1,0,1
TUR,WSM,2017.0,1,0,1
AUS,LKA,2001.0,1,0,1
ITA,MDG,2003.0,2,0,2
,VUT,2006.0,3,0,3
RWA,CIV,2020.0,1,0,1
IND,MEX,2003.0,2,0,2
GBR,COD,2012.0,1,0,1
CZE,DNK,2005.0,1,0,1
MOZ,NLD,2010.0,1,0,1
SRB,TUN,2007.0,3,0,3
NIC,CHE,2021.0,1,0,1
CHE,NIC,2023.0,1,0,1
NZL,PNG,2011.0,1,0,1
PNG,GBR,2017.0,3,0,3
IRN,GRC,2009.0,2,0,2
,SUR,2005.0,1,0,1
NOR,KEN,2010.0,1,0,1
PAN,JPN,2007.0,1,0,1
,GUM,2005.0,4,0,4
MDA,DEU,2011.0,2,0,2
BRA,LTU,2004.0,1,0,1
KEN,AUS,2006.0,1,0,1
BFA,BRA,2011.0,2,0,2
TWN,NPL,2013.0,2,0,2
CHN,TKM,2011.0,1,0,1
UKR,TJK,2020.0,1,0,1
BOL,BEL,2012.0,1,0,1
LUX,POL,2021.0,1,3,-2
IND,ARG,2021.0,1,4,-3
IRQ,MAR,2021.0,1,2,-1
NPL,BGD,2006.0,1,1,0
LSO,ZAF,2023.0,2,3,-1
BGD,BRN,2013.0,3,2,1
VNM,AUT,2013.0,1,4,-3
MRT,FRA,2023.0,1,6,-5
IRL,FIN,2003.0,1,1,0
ETH,TZA,2015.0,1,2,-1
BEL,NGA,2005.0,1,1,0
IRL,JPN,2009.0,3,9,-6
POL,BGR,1998.0,1,1,0
ITA,VNM,2002.0,2,1,1
OMN,GBR,1998.0,1,5,-4
FRA,IRQ,2023.0,2,2,0
USA,KHM,2003.0,1,1,0
ARE,KWT,2009.0,1,1,0
SWE,BGR,2007.0,2,5,-3
BFA,ZAF,2000.0,1,2,-1
TZA,RUS,2020.0,1,1,0
SVN,AUS,2013.0,2,2,0
GRC,RUS,2006.0,1,3,-2
COL,ECU,2000.0,1,1,0
GEO,DEU,1998.0,3,4,-1
CZE,SAU,2021.0,1,1,0
GBR,LVA,2015.0,1,1,0
SVK,RUS,2016.0,1,4,-3
BHR,JPN,2020.0,1,1,0
TUR,NGA,2015.0,2,1,1
SVK,SRB,2011.0,2,2,0
NLD,SVN,2015.0,1,4,-3
ISR,ARG,2001.0,2,1,1
SRB,RUS,2023.0,1,6,-5
COD,BEN,2022.0,1,2,-1
ZWE,CHN,2017.0,1,1,0
JOR,CZE,2022.0,2,1,1
IRN,HUN,2015.0,1,1,0
NZL,AUT,2002.0,1,4,-3
TWN,DNK,2019.0,3,1,2
RWA,IND,2022.0,2,3,-1
TZA,CAN,2001.0,1,1,0
JPN,TUN,2012.0,1,3,-2
JPN,BGR,1998.0,1,8,-7
PRT,POL,2006.0,2,6,-4
USA,SEN,2006.0,2,4,-2
NZL,ARG,2020.0,1,3,-2
BGR,UKR,2002.0,1,1,0
ZMB,ZWE,2013.0,1,1,0
KAZ,KGZ,2011.0,1,3,-2
FRA,LTU,2006.0,1,3,-2
SWE,SEN,2015.0,1,1,0
PSE,TUR,2003.0,1,1,0
POL,IND,1998.0,1,1,0
IRQ,JOR,1999.0,1,1,0
THA,PHL,2001.0,1,2,-1
SYR,NLD,2005.0,1,1,0
AUS,PRT,1999.0,1,1,0
ITA,NGA,2004.0,1,3,-2
TUN,GRC,2010.0,1,2,-1
URY,MEX,2005.0,1,3,-2
IRL,KOR,2008.0,2,3,-1
TUR,FIN,2010.0,1,7,-6
USA,MLT,2008.0,2,2,0
GEO,CHE,2009.0,2,2,0
KWT,OMN,2017.0,1,1,0
COL,PRI,2011.0,1,3,-2
CRI,PRI,2016.0,1,2,-1
CAN,HRV,2012.0,1,1,0
CHE,MMR,2016.0,1,1,0
RWA,ZAF,2012.0,1,2,-1
IRQ,CAN,2010.0,1,1,0
MEX,CRI,2002.0,1,2,-1
CRI,ARG,2012.0,1,2,-1
HRV,BEL,2003.0,1,1,0
CMR,GNQ,2005.0,1,1,0
UGA,LBR,2017.0,1,1,0
BWA,IND,2019.0,1,2,-1
MAC,NLD,2023.0,1,2,-1
FRA,OMN,2023.0,1,1,0
COG,NGA,2023.0,1,1,0
SAU,LBN,2005.0,1,2,-1
PHL,NZL,2023.0,2,4,-2
BRA,UKR,2001.0,1,1,0
COL,PRT,2007.0,1,2,-1
IND,KOR,1997.0,2,1,1
CHE,MYS,2014.0,1,5,-4
PNG,GBR,2002.0,1,1,0
IND,NZL,2000.0,2,2,0
ITA,VNM,1997.0,2,1,1
ARG,BOL,2013.0,1,1,0
ARE,ESP,2010.0,1,1,0
MYS,JOR,2006.0,1,1,0
PRT,CYP,2020.0,1,2,-1
PER,BEL,2014.0,1,5,-4
CAN,SVK,2016.0,1,1,0
KHM,AUS,2011.0,1,4,-3
SWZ,USA,2020.0,2,5,-3
ETH,ISR,2022.0,1,2,-1
MAC,SGP,2020.0,1,3,-2
CZE,ARM,2011.0,1,1,0
EST,IND,2013.0,1,1,0
MEX,KEN,2015.0,1,1,0
ISL,FRO,2017.0,1,1,0
SDN,ZAF,2014.0,1,3,-2
SEN,ITA,2020.0,1,2,-1
GRC,ISR,2020.0,2,1,1
PAN,CHL,2021.0,1,1,0
KOR,BRA,2022.0,1,4,-3
ESP,THA,2006.0,1,1,0
PHL,NGA,2019.0,1,1,0
ARG,PRY,2019.0,1,5,-4
ZAF,TUR,2019.0,2,1,1
ASM,USA,2009.0,1,6,-5
ETH,FRA,2006.0,2,2,0
OMN,NZL,2004.0,1,1,0
USA,SEN,2000.0,1,5,-4
CAN,MDG,2022.0,1,1,0
NLD,KOR,1997.0,1,1,0
MEX,DNK,2004.0,1,2,-1
UKR,GEO,2017.0,1,1,0
IRL,POL,2002.0,1,2,-1
EGY,YEM,2000.0,1,2,-1
NZL,POL,2017.0,1,1,0
KOR,ISR,2014.0,1,5,-4
GHA,NGA,2007.0,1,1,0
TUR,IRN,2006.0,1,1,0
BGD,MEX,2017.0,1,2,-1
IRL,CHN,2004.0,1,4,-3
CMR,SEN,2003.0,1,1,0
NPL,NOR,2010.0,1,5,-4
CAN,PAN,2019.0,1,1,0
SAU,EST,2020.0,1,1,0
EST,CHN,2019.0,1,3,-2
EST,ITA,2009.0,1,2,-1
MEX,IRL,2011.0,2,2,0
NOR,TUR,2022.0,1,10,-9
USA,ASM,2011.0,1,4,-3
FRA,DJI,2002.0,1,1,0
SAU,BEL,2016.0,2,5,-3
CRI,AUS,2017.0,1,2,-1
ARE,CHE,2020.0,1,7,-6
TZA,DNK,2022.0,1,1,0
LAO,CHN,2020.0,1,1,0
CAN,UZB,2020.0,1,1,0
EGY,PHL,2020.0,1,1,0
VNM,BEL,2002.0,1,2,-1
HKG,SWE,2004.0,2,2,0
ESP,SLV,2014.0,1,3,-2
EGY,IRN,2008.0,1,2,-1
PRT,GRC,2005.0,1,2,-1
MLI,USA,2004.0,1,6,-5
IRL,EGY,2001.0,1,1,0
MTQ,USA,2018.0,1,1,0
NLD,VEN,2005.0,1,1,0
GBR,BLR,1999.0,3,4,-1
NZL,ISR,2003.0,2,2,0
FRA,UGA,2001.0,1,1,0
CHE,CIV,2011.0,2,1,1
CHE,HRV,2015.0,3,6,-3
AGO,USA,2013.0,1,1,0
SEN,BEL,2010.0,1,1,0
CAN,NCL,2016.0,1,1,0
OMN,FRA,2023.0,1,1,0
UGA,NLD,2011.0,1,4,-3
BWA,NAM,2019.0,1,1,0
KGZ,DEU,2010.0,1,1,0
GBR,PSE,2014.0,3,3,0
KOR,KEN,2015.0,1,2,-1
FRA,UGA,2014.0,1,9,-8
NGA,AUT,2019.0,1,1,0
NLD,SUR,2017.0,1,2,-1
BOL,DEU,2013.0,1,2,-1
CZE,GRC,2016.0,1,3,-2
CUB,SWE,2017.0,1,1,0
ISR,ROU,2015.0,1,2,-1
SEN,COG,2016.0,2,1,1
CHE,FJI,2016.0,1,1,0
GRC,SWE,2005.0,1,6,-5
RUS,NGA,2017.0,1,2,-1
NER,CIV,2019.0,1,1,0
MYS,SYR,2020.0,1,1,0
CMR,COG,2016.0,1,1,0
HUN,BIH,2019.0,1,1,0
EGY,SWE,2022.0,1,1,0
GBR,MCO,2021.0,1,1,0
WSM,FJI,2022.0,1,1,0
BHR,ARE,2021.0,1,7,-6
IRN,AZE,2021.0,1,3,-2
IRN,ETH,2023.0,1,1,0
GRD,TTO,2013.0,1,2,-1
MLI,BFA,2022.0,2,3,-1
NLD,NPL,2014.0,1,1,0
DEU,LBY,2011.0,1,1,0
DEU,ECU,2004.0,1,4,-3
POL,KOR,2012.0,2,2,0
PAK,CHE,2001.0,1,1,0
USA,VNM,1999.0,2,3,-1
SAU,IRL,2015.0,2,3,-1
PAN,VEN,2007.0,1,1,0
PSE,USA,2007.0,1,4,-3
CUB,ARG,1999.0,1,1,0
CAN,LBY,2003.0,1,1,0
GRC,BGR,2003.0,1,5,-4
TUR,CHN,2011.0,2,3,-1
ARE,NLD,2009.0,1,1,0
CHE,PNG,2005.0,1,2,-1
JPN,BFA,2013.0,1,1,0
THA,AUT,2001.0,2,1,1
CHE,ZWE,2016.0,1,2,-1
CZE,TUR,2005.0,1,1,0
GEO,FRA,2002.0,1,1,0
FRO,USA,2011.0,1,1,0
TWN,EGY,2020.0,2,5,-3
AUT,LTU,2004.0,1,1,0
ESP,MOZ,2009.0,2,3,-1
UKR,FIN,2011.0,1,1,0
KOR,IRN,2008.0,1,2,-1
ZMB,CHN,2016.0,1,3,-2
IRL,SVK,2008.0,1,3,-2
PSE,ARE,2010.0,1,1,0
SYR,PAK,2009.0,1,1,0
KOR,POL,2011.0,1,1,0
KOR,ITA,2000.0,2,1,1
IDN,BGD,2010.0,1,1,0
SRB,TUR,2015.0,2,7,-5
RUS,PAK,2011.0,1,2,-1
ETH,FRA,2010.0,1,4,-3
IND,SVK,2012.0,1,1,0
BIH,NLD,2014.0,1,1,0
TCD,FRA,2013.0,1,1,0
TUR,TWN,2013.0,1,1,0
MAC,KOR,2016.0,1,1,0
NOR,KEN,2014.0,1,1,0
IRN,BLR,2015.0,1,1,0
ARG,RUS,2016.0,1,2,-1
COG,MAR,2015.0,1,2,-1
SLV,MEX,2014.0,1,1,0
NZL,UGA,2017.0,1,1,0
SVK,NLD,2015.0,1,2,-1
JPN,UGA,2023.0,1,1,0
MWI,KOR,2020.0,1,1,0
FRA,NGA,2016.0,1,1,0
CAN,GHA,2002.0,1,5,-4
SAU,ZAF,2002.0,2,2,0
BGD,PAK,2001.0,3,5,-2
CIV,CMR,2021.0,1,2,-1
BRA,MAC,2021.0,1,1,0
TGO,BFA,2023.0,1,2,-1
CZE,ARM,2021.0,1,1,0
OMN,PRT,2020.0,1,1,0
JOR,EGY,2006.0,1,5,-4
LBY,ZAF,2021.0,2,4,-2
KWT,FRA,2014.0,2,2,0
LAO,FRA,2005.0,1,2,-1
ZWE,COG,2007.0,1,2,-1
DEU,PAN,1999.0,1,2,-1
DZA,MAR,1998.0,1,1,0
ETH,NOR,2002.0,3,2,1
ITA,CIV,2009.0,1,1,0
ARE,AUT,2013.0,1,3,-2
SWE,ROU,2015.0,2,2,0
BLR,ITA,1997.0,1,2,-1
BWA,CMR,2019.0,1,1,0
BOL,GBR,2002.0,1,2,-1
KEN,SWE,1999.0,1,3,-2
COL,PER,2002.0,1,2,-1
FRA,CUB,2001.0,1,2,-1
SVK,ZAF,2011.0,1,1,0
KWT,SAU,2002.0,1,3,-2
CHN,SDN,2011.0,3,1,2
CHN,UGA,2015.0,1,1,0
ZAF,TUR,2021.0,1,1,0
MYS,NPL,2012.0,1,1,0
BLR,ITA,2012.0,1,1,0
CHL,BOL,2020.0,1,3,-2
FLK,GBR,2016.0,2,2,0
BGD,FIN,2014.0,1,2,-1
CHN,BRA,2005.0,1,7,-6
TUN,CHN,2014.0,1,1,0
GMB,AUS,2017.0,1,1,0
SRB,DNK,2011.0,1,3,-2
NOR,EST,2023.0,1,2,-1
FIN,PRT,2007.0,1,3,-2
UKR,NLD,2021.0,1,1,0
MEX,PAK,2018.0,1,1,0
PRI,FRA,2014.0,1,2,-1
CHN,NZL,2003.0,1,4,-3
DEU,PER,2000.0,1,1,0
IND,SVK,2002.0,1,1,0
HKG,ESP,1998.0,1,2,-1
CAF,DEU,2012.0,1,1,0
LIE,CHE,2015.0,2,1,1
ZAF,CHE,1998.0,1,6,-5
AUT,MYS,2019.0,1,2,-1
THA,NPL,2001.0,1,1,0
SVK,NOR,2018.0,1,4,-3
NGA,SWZ,2021.0,1,1,0
ISR,UKR,2013.0,1,1,0
KNA,ZAF,2017.0,1,2,-1
LBN,IRL,2023.0,1,1,0
URY,FRA,2020.0,1,5,-4
MUS,BWA,2019.0,1,1,0
LVA,POL,2021.0,1,1,0
JOR,ESP,2012.0,1,1,0
MMR,MYS,2019.0,1,2,-1
BEL,LTU,2019.0,1,3,-2
SUR,NLD,2019.0,1,10,-9
BRA,QAT,2018.0,1,1,0
JPN,MWI,2022.0,1,2,-1
FIN,LVA,2019.0,1,1,0
ESP,NGA,2015.0,1,1,0
KNA,TTO,2021.0,1,1,0
MAR,SAU,2021.0,1,6,-5
IRL,HRV,2021.0,1,5,-4
LBY,MYS,2018.0,2,16,-14
GUF,GUY,2005.0,1,2,-1
NCL,VUT,2012.0,1,1,0
MEX,IND,2008.0,1,1,0
THA,CHE,2007.0,1,7,-6
BGR,MKD,2020.0,1,1,0
MRT,MAR,2018.0,1,4,-3
COD,CHE,2019.0,1,5,-4
IND,KEN,2009.0,1,2,-1
EGY,TUN,2015.0,1,1,0
RWA,MWI,2023.0,1,1,0
ARG,CUB,2014.0,1,6,-5
LVA,FRA,2019.0,1,3,-2
MLT,NLD,2020.0,1,3,-2
IND,ZMB,2017.0,1,1,0
ARM,ITA,2021.0,1,2,-1
MAC,BRA,2020.0,1,3,-2
AUS,BHR,2022.0,1,1,0
PRY,NLD,2022.0,1,1,0
IDN,UGA,2021.0,1,1,0
SWZ,GBR,2022.0,1,3,-2
UZB,IND,2015.0,1,1,0
GHA,DNK,1997.0,1,1,0
SVN,SLV,2003.0,1,2,-1
SLV,SVN,2004.0,2,1,1
NGA,TZA,2003.0,1,1,0
BGR,HUN,2001.0,1,1,0
PAN,MEX,2011.0,1,1,0
MDG,SEN,2004.0,1,2,-1
JPN,KWT,2001.0,1,1,0
PRT,ARG,2003.0,1,4,-3
ISL,FRA,2006.0,1,2,-1
KAZ,UZB,1998.0,1,1,0
PRT,MAR,2013.0,2,1,1
ZAF,KAZ,2021.0,1,1,0
SOM,EGY,2019.0,1,1,0
GBR,GAB,2009.0,1,4,-3
CHN,LBR,2020.0,1,1,0
LVA,BEL,2013.0,1,1,0
DEU,ZWE,2021.0,1,3,-2
IRN,TUN,2015.0,1,1,0
BOL,CHL,2011.0,1,3,-2
FRA,BLR,2018.0,1,4,-3
TUN,MAR,2004.0,1,4,-3
VNM,ZAF,2004.0,1,2,-1
BWA,ZMB,2012.0,1,2,-1
GUY,IND,2014.0,1,1,0
PRK,DEU,2009.0,1,1,0
KOR,DNK,2002.0,1,1,0
KEN,ISR,2011.0,1,1,0
NZL,WSM,2012.0,1,1,0
TCD,CMR,2023.0,1,2,-1
ISR,IND,2024.0,1,1,0
IND,AFG,2018.0,1,1,0
IRN,AZE,2019.0,2,3,-1
QAT,TUR,2013.0,1,2,-1
QAT,PRT,2014.0,1,3,-2
BEL,DZA,1998.0,1,1,0
SRB,ITA,2011.0,2,7,-5
NOR,NPL,2009.0,1,4,-3
SWE,COL,2023.0,1,1,0
BRB,USA,2011.0,1,5,-4
DNK,LTU,2013.0,1,4,-3
IND,BHR,2014.0,1,2,-1
USA,MNP,2010.0,1,1,0
FIN,ROU,2012.0,1,3,-2
ISR,KEN,2019.0,1,1,0
GRC,IRN,2002.0,1,1,0
JPN,COD,2021.0,1,1,0
KEN,AUS,2004.0,1,3,-2
BHR,USA,2006.0,1,4,-3
SRB,ARE,2018.0,1,1,0
PRT,KOR,2022.0,1,3,-2
PHL,NPL,2019.0,1,2,-1
IRN,PHL,2004.0,1,2,-1
BGD,EGY,2021.0,1,1,0
EGY,KEN,2020.0,1,1,0
FIN,HRV,2023.0,1,1,0
RUS,EST,2007.0,1,3,-2
ZAF,HUN,2007.0,1,1,0
UZB,JPN,2007.0,1,2,-1
COL,BRA,2001.0,2,6,-4
DNK,GNB,2000.0,1,2,-1
JPN,QAT,2007.0,1,1,0
POL,KOR,2005.0,1,1,0
KEN,SWE,2007.0,1,1,0
UZB,PAK,2007.0,1,1,0
NOR,UGA,2003.0,1,2,-1
BEL,NOR,2000.0,1,3,-2
KWT,DEU,1999.0,1,1,0
NZL,BEL,2011.0,1,4,-3
IDN,DEU,2002.0,1,6,-5
RUS,EST,1999.0,1,2,-1
IND,KHM,2017.0,1,1,0
FLK,GBR,2018.0,1,1,0
TWN,ROU,2002.0,1,7,-6
ITA,MWI,2020.0,1,1,0
TUR,MYS,2013.0,1,3,-2
SEN,ZAF,2010.0,1,2,-1
BGD,FRA,2014.0,1,1,0
CIV,CHE,2010.0,1,1,0
PRK,DEU,2011.0,1,1,0
COL,AUS,2008.0,1,1,0
POL,LTU,2007.0,1,2,-1
DNK,BGD,2017.0,1,3,-2
AUS,PYF,2018.0,1,1,0
VEN,PAN,2020.0,1,1,0
EST,ESP,2016.0,1,6,-5
NZL,ZWE,2022.0,1,1,0
CAF,COG,2015.0,1,2,-1
ISR,ISL,2011.0,1,2,-1
GRL,CAN,2022.0,1,1,0
HUN,PAK,2019.0,1,1,0
BGR,NLD,2021.0,1,1,0
DEU,VEN,2023.0,1,2,-1
MDV,NPL,2022.0,1,2,-1
TWN,CHN,2024.0,1,2,-1
GEO,GBR,2015.0,1,3,-2
DNK,PHL,2001.0,1,2,-1
BRA,CZE,2004.0,1,1,0
AUS,CUB,2012.0,1,1,0
SWE,GHA,2015.0,1,3,-2
ZWE,FRA,2018.0,1,4,-3
BEL,ZWE,2010.0,1,1,0
FRA,REU,1998.0,1,5,-4
UKR,TWN,2008.0,1,1,0
AUT,GRC,1998.0,1,1,0
BFA,MLI,2011.0,1,3,-2
NGA,PHL,2019.0,1,1,0
ISR,PRT,2003.0,1,1,0
FIN,NZL,2008.0,1,1,0
HRV,ESP,2007.0,1,2,-1
PSE,CAN,2014.0,1,2,-1
OMN,SAU,2008.0,1,1,0
PRI,RUS,2000.0,1,1,0
JAM,DEU,2012.0,1,1,0
KOR,HKG,2007.0,1,6,-5
ROU,ESP,2005.0,2,7,-5
SGP,BRA,2016.0,1,3,-2
AUS,SRB,1997.0,1,1,0
MKD,GBR,2013.0,1,2,-1
GEO,RUS,2012.0,1,5,-4
CHL,IRN,2015.0,1,1,0
QAT,LBY,2014.0,1,3,-2
TUR,THA,2017.0,1,1,0
IRL,SVK,2014.0,1,1,0
DZA,JOR,2020.0,1,3,-2
NPL,DEU,2015.0,1,5,-4
QAT,CHE,2020.0,1,5,-4
DNK,KHM,2020.0,1,1,0
NLD,PER,2012.0,1,1,0
GBR,URY,2014.0,1,2,-1
ETH,AUT,2013.0,1,2,-1
ROU,CMR,2015.0,1,1,0
USA,KOR,2001.0,572,485,87
FRA,CMR,2014.0,28,14,14
POL,FRA,2010.0,47,32,15
ARG,DEU,2001.0,24,14,10
LKA,GBR,2012.0,17,9,8
EGY,SAU,2022.0,336,284,52
FIN,ESP,1999.0,3,6,-3
FIN,ESP,2007.0,12,5,7
POL,UKR,2017.0,18,36,-18
USA,IDN,2010.0,32,16,16
USA,DNK,2016.0,177,155,22
FRA,ROU,2022.0,11,21,-10
IRL,NOR,2017.0,5,4,1
BRA,TWN,2015.0,1,1,0
CHN,TUR,2020.0,14,21,-7
USA,PRI,2011.0,120,141,-21
BIH,SRB,2007.0,11,14,-3
ESP,CHE,2015.0,121,60,61
TUR,PAK,2020.0,29,20,9
USA,DNK,2022.0,149,128,21
ITA,AUS,2001.0,24,20,4
CAN,AUT,2020.0,19,21,-2
USA,CUB,2022.0,4,7,-3
UKR,AUT,2002.0,6,2,4
ESP,CHE,2014.0,119,46,73
SRB,AUT,2007.0,7,1,6
UZB,RUS,2009.0,9,10,-1
SRB,CAN,2018.0,6,5,1
ALB,USA,2017.0,2,4,-2
FIN,FRA,2020.0,17,31,-14
MAR,DZA,2021.0,5,2,3
BOL,NLD,2009.0,2,1,1
SVN,SLV,2020.0,8,9,-1
NZL,ITA,2001.0,5,2,3
PAK,ITA,2021.0,37,12,25
URY,USA,1998.0,6,3,3
NZL,PRT,2020.0,2,5,-3
SRB,BEL,2004.0,2,4,-2
USA,UKR,2004.0,17,43,-26
IND,IRL,2014.0,17,17,0
UKR,CHE,1999.0,3,1,2
NPL,USA,2016.0,31,29,2
ITA,CHL,2003.0,6,5,1
NLD,UKR,2000.0,1,2,-1
KWT,EGY,2002.0,6,6,0
DNK,GRL,2005.0,3,2,1
BRA,MEX,2013.0,19,20,-1
BWA,USA,2012.0,9,11,-2
HUN,DNK,2008.0,2,5,-3
AUS,ETH,2015.0,1,7,-6
MYS,MAR,2020.0,2,2,0
URY,BRA,2020.0,7,34,-27
SWE,UKR,2023.0,1,5,-4
SGP,POL,2022.0,6,4,2
ITA,TUR,1999.0,4,5,-1
MDA,UKR,2003.0,1,1,0
NLD,ISL,2009.0,3,1,2
SGP,THA,2009.0,4,5,-1
USA,MLI,2007.0,3,2,1
IRN,IND,2010.0,4,29,-25
THA,LKA,2021.0,1,2,-1
FRA,UGA,2012.0,3,2,1
MYS,YEM,2007.0,1,2,-1
GBR,BFA,2020.0,1,2,-1
FJI,IND,2008.0,2,2,0
ARM,USA,2004.0,3,4,-1
SAU,NZL,2013.0,1,1,0
ITA,UKR,2009.0,2,4,-2
THA,BGD,2011.0,2,3,-1
QAT,LBN,2018.0,3,4,-1
JPN,UGA,2017.0,1,2,-1
FRA,CRI,2012.0,2,1,1
PRT,AUS,2001.0,1,1,0
LUX,SGP,2012.0,1,1,0
POL,HUN,2019.0,1,6,-5
IND,KWT,2001.0,3,14,-11
LBN,IRL,2018.0,1,1,0
UKR,ISR,2022.0,1,2,-1
UGA,NOR,2008.0,1,1,0
CUB,NLD,2008.0,1,1,0
NER,CMR,2009.0,2,2,0
KEN,ETH,2012.0,1,3,-2
USA,MKD,2014.0,1,8,-7
SVK,UKR,2022.0,2,7,-5
DEU,COG,2018.0,2,1,1
SAU,BEL,2023.0,2,2,0
AUS,GRC,2000.0,1,2,-1
NLD,SUR,2010.0,1,1,0
USA,BHS,2017.0,2,4,-2
JOR,OMN,2015.0,1,3,-2
CHE,ZWE,2006.0,1,4,-3
ISR,JOR,2021.0,1,1,0
BFA,ZAF,2016.0,1,5,-4
TUN,DZA,2013.0,1,3,-2
ESP,OMN,2022.0,1,2,-1
DEU,PSE,2003.0,1,2,-1
SWE,TUR,2004.0,2,1,1
BGD,FIN,2012.0,1,1,0
DNK,MYS,2009.0,1,2,-1
KWT,LBN,2019.0,1,2,-1
PAK,IRQ,2017.0,1,1,0
TZA,BWA,2022.0,1,1,0
NLD,SAU,2001.0,1,1,0
ARE,RUS,2021.0,1,2,-1
ESP,SVK,1998.0,1,2,-1
FRA,HTI,2015.0,1,2,-1
RUS,TUN,2019.0,1,2,-1
NLD,JOR,2017.0,1,2,-1
LTU,BLR,2017.0,1,1,0
PHL,BGD,2015.0,2,3,-1
CHN,BGR,2019.0,2,2,0
GNB,USA,1999.0,1,1,0
UZB,MYS,2001.0,1,1,0
NIC,COL,2013.0,1,1,0
POL,KOR,2014.0,1,2,-1
HUN,SRB,1998.0,1,5,-4
CMR,GAB,2018.0,1,1,0
MMR,THA,2002.0,1,1,0
ZAF,OMN,2010.0,1,1,0
LKA,KOR,2014.0,1,4,-3
HTI,CAN,2017.0,1,2,-1
NGA,BEN,2004.0,1,5,-4
SWE,COD,2021.0,1,1,0
MDA,POL,1998.0,1,2,-1
CZE,PNG,2022.0,1,1,0
BRA,TUR,2009.0,1,1,0
PNG,IND,2023.0,1,2,-1
RUS,LBN,2017.0,1,1,0
CAN,DZA,2004.0,1,2,-1
IND,JOR,1999.0,1,1,0
LBN,DEU,2010.0,2,3,-1
ZWE,BEL,2012.0,1,1,0
SWE,COL,2011.0,1,3,-2
LBY,IND,2010.0,1,7,-6
ARG,POL,2023.0,1,2,-1
BLR,UKR,2011.0,1,2,-1
KEN,SWE,1997.0,1,1,0
CAN,LTU,2002.0,1,2,-1
BFA,TZA,2021.0,1,1,0
SWZ,NLD,2021.0,1,3,-2
AUT,ETH,2001.0,2,1,1
EST,SWE,1997.0,1,11,-10
KOR,PAN,2012.0,1,1,0
SDN,JPN,2007.0,1,3,-2
LKA,THA,2011.0,1,1,0
POL,HUN,2016.0,1,2,-1
PSE,USA,2005.0,2,4,-2
OMN,JOR,2000.0,3,2,1
ARE,SRB,2015.0,1,1,0
ZAF,ITA,2005.0,4,4,0
IDN,CMR,2018.0,2,1,1
FIN,ISL,2001.0,1,2,-1
DEU,PHL,1998.0,2,1,1
KOR,LUX,2019.0,1,3,-2
MEX,TUR,2008.0,1,5,-4
UZB,JPN,2002.0,1,2,-1
ZMB,ZWE,2015.0,2,4,-2
GBR,BFA,2014.0,1,1,0
SWZ,NLD,2019.0,2,1,1
KWT,CAN,2023.0,4,6,-2
COL,IND,2018.0,1,2,-1
AUS,URY,2011.0,2,1,1
CHE,KEN,1999.0,2,2,0
BOL,DEU,2004.0,2,1,1
GUF,GUY,2007.0,1,3,-2
QAT,AUS,2023.0,1,8,-7
PER,VEN,2023.0,1,5,-4
EGY,DNK,2007.0,1,2,-1
HUN,IND,2008.0,1,2,-1
IND,SRB,2002.0,1,1,0
UGA,DEU,2003.0,1,4,-3
SWE,QAT,2023.0,1,1,0
NOR,SGP,2023.0,1,4,-3
ISL,ESP,2020.0,1,3,-2
KWT,SAU,1998.0,1,1,0
NOR,ROU,2000.0,1,1,0
UKR,SRB,2005.0,1,1,0
CAN,VEN,2011.0,1,3,-2
HUN,BGD,2022.0,1,2,-1
TGO,BEN,2020.0,1,3,-2
VNM,CHE,2023.0,1,2,-1
AUT,TUN,2016.0,1,1,0
PHL,DNK,2019.0,1,2,-1
AUS,MMR,2016.0,1,1,0
GUY,GBR,2017.0,1,2,-1
SRB,GRC,2015.0,3,2,1
ITA,ISL,2013.0,1,1,0
BDI,ZWE,2021.0,1,1,0
CHN,CMR,2014.0,1,1,0
BEN,CAN,2016.0,1,6,-5
GHA,BEL,2012.0,1,2,-1
LUX,AUS,2022.0,1,3,-2
BEL,QAT,2019.0,1,2,-1
AUT,UZB,2020.0,1,2,-1
QAT,CHE,2012.0,1,1,0
NOR,IND,2001.0,1,1,0
MAR,ITA,1999.0,1,4,-3
NOR,DZA,2017.0,1,1,0
SVN,NOR,2011.0,1,1,0
ZAF,EGY,2019.0,1,1,0
NGA,KOR,2003.0,1,1,0
BHR,OMN,2018.0,1,1,0
SYR,TUR,2022.0,2,1,1
SRB,AUT,2001.0,1,2,-1
IRL,CHL,2009.0,1,2,-1
MMR,JPN,2011.0,1,3,-2
IRN,ITA,2004.0,2,5,-3
USA,SDN,2001.0,1,2,-1
GHA,ITA,2000.0,1,1,0
IRL,ROU,2011.0,1,3,-2
NZL,COL,2016.0,1,1,0
ARG,AUT,2017.0,1,4,-3
MKD,ALB,2009.0,1,1,0
SVK,NZL,2014.0,1,1,0
GBR,TLS,2020.0,1,1,0
BWA,NGA,2022.0,1,3,-2
CAN,KNA,2023.0,1,1,0
ARE,FIN,2021.0,1,1,0
CHN,POL,2001.0,1,1,0
KEN,AUS,2003.0,1,3,-2
ZAF,AUT,2001.0,1,1,0
IRL,DNK,2000.0,1,3,-2
AUT,CHL,2012.0,1,4,-3
IRL,NOR,2011.0,1,3,-2
TTO,BRB,1999.0,1,1,0
SYR,LBN,2021.0,1,1,0
UZB,CAN,2020.0,1,1,0
KEN,BEL,2006.0,1,1,0
CHE,ARG,2000.0,1,7,-6
BRA,MEX,1997.0,1,2,-1
POL,AUS,2004.0,1,5,-4
IDN,CHE,2004.0,1,2,-1
PAK,ARE,2008.0,1,1,0
MRT,SEN,2008.0,1,1,0
GBR,LAO,2009.0,2,1,1
AUS,BRN,2015.0,2,3,-1
SYC,GBR,2022.0,1,1,0
BRN,QAT,2022.0,1,1,0
QAT,ESP,2021.0,2,2,0
AUT,MKD,2020.0,1,1,0
ZAF,VCT,2005.0,1,1,0
BRA,KOR,2015.0,1,5,-4
TGO,MAR,2015.0,1,3,-2
BEL,HRV,2007.0,1,1,0
NAM,USA,2023.0,1,4,-3
MWI,IND,2018.0,1,1,0
HUN,IRN,2006.0,1,1,0
MEX,SGP,2010.0,1,1,0
FRA,SDN,2009.0,1,1,0
PHL,IRL,2021.0,1,1,0
AUS,SYC,2010.0,1,1,0
MAR,ESP,1997.0,1,1,0
EGY,PSE,2005.0,2,2,0
PRT,NOR,2008.0,1,2,-1
CAN,MLI,2013.0,1,2,-1
FRA,YEM,2021.0,1,1,0
CHE,SRB,2023.0,1,4,-3
CMR,ZAF,2001.0,1,1,0
QAT,GBR,1999.0,1,3,-2
ITA,ARM,1998.0,1,1,0
COL,CRI,2009.0,1,4,-3
UGA,NLD,2000.0,1,1,0
GBR,MCO,2023.0,1,1,0
ISR,UKR,2015.0,1,2,-1
UGA,NLD,2023.0,1,3,-2
SEN,CHE,2021.0,1,1,0
CZE,SWE,2000.0,1,3,-2
USA,PRY,2006.0,1,2,-1
LBY,MLT,2019.0,1,2,-1
NLD,TZA,2000.0,1,1,0
NGA,FRA,2004.0,1,2,-1
PRI,IND,2010.0,1,2,-1
RUS,SAU,2014.0,1,2,-1
VEN,PRT,2008.0,1,1,0
MYS,GHA,2016.0,1,1,0
LUX,CHE,2007.0,1,3,-2
MEX,KEN,2013.0,1,1,0
RUS,USA,2001.0,597,266,331
USA,KHM,2010.0,5,1,4
AUS,JOR,2007.0,5,1,4
NLD,GBR,2009.0,216,226,-10
JPN,EGY,2012.0,81,21,60
USA,NOR,2004.0,67,48,19
THA,GBR,2015.0,32,95,-63
BGR,BEL,1997.0,3,6,-3
CHE,ESP,2005.0,30,36,-6
BGR,AUT,2006.0,3,2,1
ARG,COL,2005.0,3,4,-1
GRC,GBR,2001.0,58,116,-58
DEU,BRA,2005.0,37,48,-11
DEU,MYS,2021.0,8,18,-10
CHE,GBR,2023.0,153,176,-23
BEL,GBR,2001.0,73,92,-19
MEX,ZAF,2017.0,3,4,-1
FRA,TUR,2021.0,25,27,-2
AUS,AUT,2004.0,24,28,-4
HUN,ESP,2007.0,4,5,-1
CZE,GBR,2005.0,30,25,5
MLI,FRA,2014.0,5,12,-7
NZL,CAN,2016.0,37,34,3
RUS,PRT,2000.0,9,3,6
NZL,GBR,1997.0,48,51,-3
BHR,IRL,2020.0,1,3,-2
ISR,BRA,2002.0,2,3,-1
ITA,IRL,2013.0,29,36,-7
BGR,DEU,2008.0,24,23,1
NLD,ZAF,2008.0,19,17,2
NLD,CAN,2016.0,76,72,4
CZE,ESP,2003.0,7,7,0
ROU,MDA,2000.0,1,1,0
FRA,PRT,2023.0,22,25,-3
CUB,ECU,2017.0,26,3,23
CZE,DEU,2017.0,59,60,-1
CHE,IND,2018.0,30,60,-30
SDN,SAU,2014.0,34,4,30
KEN,SWE,2017.0,6,2,4
FRA,PRT,2010.0,45,38,7
JPN,CZE,2002.0,9,7,2
ARE,GBR,1999.0,7,7,0
AUS,LUX,2022.0,3,1,2
NOR,AUS,2015.0,13,15,-2
MNG,JPN,2023.0,3,6,-3
COL,PRI,2015.0,2,6,-4
CHE,GBR,2024.0,1,1,0
ETH,NLD,2023.0,5,1,4
USA,LKA,2010.0,8,12,-4
SWE,PAK,2017.0,14,7,7
ZAF,ITA,2022.0,12,6,6
CAN,LKA,2022.0,4,7,-3
JPN,CHL,2001.0,1,1,0
THA,SGP,2019.0,5,5,0
MCO,GBR,2017.0,1,1,0
SVK,HUN,2013.0,8,6,2
VEN,GBR,2016.0,2,4,-2
HUN,JPN,2022.0,2,4,-2
SWE,VNM,2016.0,3,1,2
CHE,SRB,2001.0,3,2,1
PRT,DEU,2008.0,14,18,-4
BEL,UGA,2017.0,4,4,0
FRA,ETH,1997.0,2,1,1
DEU,PRT,1997.0,3,11,-8
HUN,AUT,2009.0,13,13,0
TWN,CHE,2017.0,8,6,2
MYS,BEL,2013.0,1,2,-1
SWE,BGD,2017.0,3,6,-3
IND,BHR,2021.0,9,8,1
SWE,VNM,2022.0,3,1,2
BRB,IND,2009.0,2,2,0
ITA,CUB,2015.0,4,4,0
HUN,CHE,2016.0,13,17,-4
EGY,MAR,2007.0,1,1,0
BRA,PRI,2019.0,4,2,2
SYR,CAN,2023.0,1,1,0
SLB,AUS,2017.0,2,3,-1
PHL,JPN,2001.0,9,14,-5
JPN,IRN,1998.0,7,3,4
ISR,ZAF,2015.0,3,1,2
SVK,ESP,2011.0,2,3,-1
SAU,PSE,2019.0,8,2,6
NZL,IDN,2015.0,3,4,-1
PAK,ITA,2012.0,1,7,-6
EGY,PRT,2006.0,2,2,0
TUR,BEL,2010.0,14,7,7
MLI,FRA,2001.0,4,3,1
USA,ARM,1999.0,1,4,-3
MAR,SAU,2015.0,4,2,2
QAT,ARE,2023.0,4,4,0
JOR,IRQ,2016.0,4,3,1
MWI,NAM,2019.0,1,1,0
SWE,ETH,2010.0,6,5,1
IRL,JOR,2005.0,1,1,0
PAK,IRL,2016.0,6,3,3
ITA,NOR,2001.0,4,14,-10
SWE,BOL,2022.0,3,3,0
TWN,ARE,2021.0,4,2,2
JOR,CHE,2018.0,2,1,1
VEN,GBR,2022.0,2,1,1
FRA,LAO,2010.0,1,1,0
CHE,RWA,2022.0,1,3,-2
ROU,JPN,2014.0,1,1,0
CAN,KWT,2010.0,9,5,4
USA,BMU,2016.0,1,2,-1
PAK,THA,2011.0,2,3,-1
BEN,NLD,2017.0,1,6,-5
SVN,POL,2021.0,2,1,1
ISL,BEL,2018.0,1,1,0
TWN,PRT,2023.0,1,2,-1
BEL,BEN,2023.0,1,1,0
SVK,HRV,2000.0,1,3,-2
FJI,WSM,2022.0,1,1,0
GBR,SHN,2019.0,1,2,-1
JOR,CAN,2006.0,1,4,-3
PNG,ESP,2016.0,1,1,0
CHE,ECU,2015.0,1,0,1
EGY,ZWE,2012.0,1,0,1
CHN,QAT,2010.0,1,0,1
MAR,GAB,2009.0,1,0,1
OMN,UZB,2017.0,1,0,1
DEU,MAC,2007.0,1,0,1
CHE,SYC,2017.0,1,0,1
SYC,CHE,2020.0,1,0,1
EST,MDA,2012.0,1,0,1
CAN,SUR,2012.0,1,0,1
MLT,SWE,2012.0,1,0,1
ROU,CYP,2013.0,1,0,1
ITA,COD,2019.0,1,0,1
GEO,ITA,2016.0,1,0,1
THA,MDV,2017.0,1,0,1
PRT,BGR,2022.0,1,0,1
MWI,VNM,2023.0,1,0,1
NGA,BFA,2018.0,2,0,2
HUN,NOR,2001.0,1,0,1
UGA,SDN,2018.0,1,0,1
GHA,BEN,2017.0,1,0,1
UZB,NLD,2022.0,1,0,1
OMN,ITA,2021.0,1,0,1
BEL,GIN,2020.0,1,0,1
MLI,CIV,2007.0,1,0,1
ALB,DEU,2020.0,3,0,3
NAM,UGA,2023.0,1,0,1
IRL,IND,2024.0,1,0,1
HRV,JPN,2004.0,1,0,1
IRQ,NLD,2014.0,1,0,1
CAF,GHA,2022.0,1,0,1
,CCK,2020.0,1,0,1
,DMA,2020.0,2,0,2
DNK,UKR,2009.0,1,0,1
KOR,LUX,2011.0,1,0,1
BGR,ROU,2002.0,2,0,2
DEU,HND,1999.0,1,0,1
GUY,AUS,2008.0,1,0,1
URY,UZB,2014.0,1,0,1
BEL,ARE,2002.0,1,0,1
SEN,DEU,1999.0,1,0,1
ARG,PRI,1997.0,1,0,1
ZWE,SWE,2006.0,1,0,1
JPN,TZA,1997.0,1,0,1
MEX,MAR,2004.0,1,0,1
BEN,CHE,2007.0,1,0,1
PRT,DZA,2006.0,1,0,1
CZE,KAZ,2002.0,1,0,1
OMN,BGD,1998.0,1,0,1
ROU,LTU,2023.0,1,0,1
SWE,PNG,1997.0,1,0,1
ISR,TZA,2005.0,1,0,1
UZB,LKA,2000.0,1,0,1
TUR,BIH,2005.0,2,0,2
CHN,SDN,2000.0,1,0,1
HKG,FRA,1997.0,1,0,1
COG,ZWE,2020.0,1,0,1
GRL,RUS,2005.0,1,0,1
OMN,ARG,2016.0,1,0,1
TZA,JPN,2001.0,1,0,1
KOR,NPL,2004.0,1,0,1
ARE,MYS,1998.0,1,0,1
UKR,SGP,2006.0,1,0,1
SGP,UKR,2008.0,1,0,1
IRQ,JOR,2002.0,2,0,2
ARG,HND,2010.0,1,0,1
TTO,MSR,2011.0,1,0,1
TZA,BWA,2009.0,1,0,1
ITA,UGA,2006.0,1,0,1
YEM,DEU,2013.0,1,0,1
AGO,NOR,2005.0,1,0,1
POL,QAT,2023.0,1,0,1
PAK,HRV,2011.0,1,0,1
SVN,BIH,2010.0,2,0,2
IRL,THA,2011.0,1,0,1
USA,PNG,2009.0,1,0,1
HUN,HRV,2003.0,1,0,1
,VIR,2006.0,1,0,1
PSE,DNK,2017.0,1,0,1
SOM,USA,2015.0,2,0,2
GLP,ESP,2008.0,1,0,1
ESP,CYM,2010.0,1,0,1
GBR,BOL,2013.0,1,0,1
GTM,NOR,2019.0,1,0,1
LTU,EUE,2019.0,1,0,1
FRA,BHR,2020.0,1,0,1
BFA,GAB,2023.0,1,0,1
GRC,HKG,2015.0,1,0,1
HKG,GRC,2017.0,1,0,1
JPN,KHM,2011.0,1,0,1
JAM,DEU,2007.0,1,0,1
CRI,PAN,2009.0,1,0,1
NPL,AFG,2010.0,1,0,1
CHN,SDN,2006.0,1,0,1
CHN,FRO,2014.0,1,0,1
PRI,CHN,2021.0,1,0,1
IRL,ARE,2005.0,1,0,1
MLI,NLD,2020.0,1,0,1
SHN,GBR,2023.0,1,0,1
BGR,ISR,1997.0,1,0,1
AIA,,2015.0,1,0,1
POL,LKA,2012.0,1,0,1
ARE,ETH,2016.0,1,0,1
MLT,ISR,2023.0,1,0,1
SGP,MMR,2015.0,1,0,1
LVA,SAU,2019.0,1,0,1
MYS,PER,2010.0,1,0,1
PAN,PRI,2021.0,1,0,1
COL,HUN,2016.0,1,0,1
DZA,TUR,2014.0,1,0,1
VNM,IND,2015.0,1,0,1
BGR,CRI,2016.0,1,0,1
USA,VCT,2016.0,1,0,1
CIV,CHE,2009.0,2,0,2
KOR,LTU,2023.0,1,0,1
SEN,FIN,1999.0,1,0,1
IND,SRB,2005.0,1,0,1
MLI,TCD,2012.0,2,0,2
YEM,JOR,1998.0,1,0,1
FIN,ETH,2004.0,1,0,1
BEL,BDI,2003.0,1,0,1
CMR,AUS,2010.0,2,0,2
BEL,PRI,2003.0,1,0,1
BIH,ITA,2000.0,1,0,1
DZA,SRB,2003.0,1,0,1
HKG,THA,2000.0,1,0,1
GMB,CHE,2008.0,1,0,1
ALB,GRC,2003.0,1,0,1
BRA,COG,2008.0,1,0,1
DNK,SVN,2003.0,2,0,2
LCA,USA,2008.0,1,0,1
GIN,,2006.0,1,0,1
ARG,GTM,2019.0,1,0,1
KWT,SGP,2006.0,1,0,1
KHM,THA,2001.0,1,0,1
BEL,VEN,2009.0,1,0,1
SVK,CAN,2006.0,1,0,1
IRN,OMN,2011.0,1,0,1
BGR,ZAF,2002.0,1,0,1
CHE,BGD,2006.0,1,0,1
BGD,CHE,2010.0,1,0,1
HKG,NOR,2015.0,1,0,1
PRI,NIC,2015.0,1,0,1
,MHL,2010.0,1,0,1
GUY,JPN,2006.0,1,0,1
RWA,CIV,2022.0,1,0,1
OMN,IDN,2022.0,1,0,1
GBR,MAC,2005.0,1,0,1
BGR,VNM,2018.0,1,0,1
SEN,GMB,2019.0,1,0,1
JAM,TGO,2013.0,1,0,1
BDI,USA,2021.0,1,0,1
FRA,BGD,2013.0,1,0,1
,MSR,2012.0,1,0,1
ISL,BGR,2021.0,1,0,1
BWA,CHE,2017.0,1,0,1
DNK,IRQ,2023.0,1,0,1
HUN,KOR,2017.0,2,0,2
EST,CHL,2023.0,1,0,1
HKG,CHL,2019.0,1,0,1
TZA,MOZ,2019.0,1,0,1
BRN,PAK,2016.0,1,0,1
GAB,CMR,2013.0,2,0,2
ZWE,ITA,2019.0,1,0,1
ZWE,ITA,2021.0,1,0,1
MUS,ZAF,2016.0,1,0,1
UKR,ARE,2019.0,1,0,1
BTN,IND,2016.0,1,0,1
GBR,KGZ,2015.0,1,0,1
THA,EGY,2020.0,2,0,2
EGY,THA,2022.0,2,0,2
IRL,FJI,2013.0,1,0,1
IDN,TLS,2020.0,1,0,1
BGD,GMB,2010.0,1,0,1
NZL,LAO,2022.0,1,0,1
NZL,MLT,2012.0,1,0,1
MLI,GMB,2013.0,1,0,1
COL,IND,2016.0,1,0,1
KWT,CZE,2006.0,1,0,1
GTM,JPN,1998.0,1,0,1
HND,SLV,2010.0,1,0,1
HND,SLV,2023.0,1,0,1
BFA,BEN,2001.0,1,0,1
ZMB,CAN,2013.0,1,0,1
JPN,PRY,2001.0,1,0,1
BGD,SAU,1999.0,1,0,1
BGD,EGY,2000.0,1,0,1
OMN,MYS,1997.0,1,0,1
BLR,TUR,2001.0,1,0,1
KOR,ESP,2000.0,1,0,1
BOL,CHE,2000.0,1,0,1
CHE,PNG,1999.0,1,0,1
CHE,VNM,1997.0,1,0,1
FJI,LKA,2020.0,1,0,1
GBR,IRQ,2001.0,1,0,1
ARE,VNM,2020.0,1,0,1
SEN,CAN,2005.0,1,0,1
,COM,1997.0,1,0,1
PER,BGD,2023.0,1,0,1
THA,GHA,2023.0,2,0,2
GHA,SSD,2020.0,1,0,1
ARM,COL,2021.0,1,0,1
,BHS,2017.0,1,0,1
MKD,LUX,2020.0,1,0,1
ZAF,LUX,2017.0,1,0,1
ALB,BEL,2021.0,1,0,1
GTM,AUT,2023.0,1,0,1
SDN,PAK,2023.0,2,0,2
PRI,SGP,2016.0,1,0,1
HUN,ARG,2020.0,1,0,1
MAF,HUN,2023.0,1,0,1
ROU,ARG,2022.0,1,0,1
JPN,PAN,2010.0,1,0,1
BFA,COD,2023.0,1,0,1
VUT,FRA,2011.0,1,0,1
HRV,EST,2004.0,1,0,1
BLR,ESP,1998.0,1,0,1
AUT,GIB,2006.0,1,0,1
JOR,QAT,1997.0,1,0,1
ETH,MLI,2005.0,1,0,1
POL,KOR,2007.0,1,0,1
VEN,GRD,2021.0,1,0,1
SGP,CRI,2014.0,1,0,1
CAN,ERI,2010.0,1,0,1
KGZ,DEU,2011.0,1,0,1
USA,GLP,1999.0,1,0,1
KWT,BGD,2010.0,1,0,1
BEN,CMR,2002.0,1,0,1
PAK,CMR,2003.0,1,0,1
BIH,,1999.0,1,0,1
BEN,TGO,2004.0,1,0,1
VAT,ITA,2013.0,1,0,1
UKR,FIN,2010.0,1,0,1
EST,NLD,1999.0,1,0,1
DNK,MKD,2006.0,1,0,1
CHN,ISL,2000.0,1,0,1
AUT,IDN,2001.0,1,0,1
IDN,FIN,2001.0,1,0,1
NOR,SRB,2000.0,1,0,1
ALB,SVN,2019.0,1,0,1
GBR,FJI,2013.0,1,0,1
GRD,ESP,2012.0,1,0,1
GBR,NIC,2008.0,1,0,1
GEO,AZE,2018.0,1,0,1
UKR,GRC,2012.0,1,0,1
KAZ,USA,1998.0,1,0,1
COL,RUS,2001.0,1,0,1
NGA,LTU,2010.0,1,0,1
BLR,KOR,2012.0,1,0,1
BRN,ARE,2022.0,1,0,1
,CAF,2006.0,6,0,6
,KIR,2010.0,1,0,1
ETH,TWN,2011.0,1,0,1
BFA,NGA,2015.0,1,0,1
COL,RUS,2015.0,1,0,1
MAR,TGO,2014.0,1,0,1
SVN,BRA,2001.0,1,0,1
AZE,POL,2021.0,1,0,1
ZAF,TWN,2006.0,2,0,2
SYR,IRL,2017.0,1,0,1
SRB,LBY,2017.0,1,0,1
LTU,BEL,2015.0,3,0,3
HRV,ROU,2018.0,1,0,1
DEU,BHR,2022.0,1,0,1
CRI,AUT,2021.0,1,0,1
BRN,BFA,2018.0,3,0,3
TUN,CZE,2023.0,1,0,1
STP,TWN,2018.0,1,0,1
BWA,ZMB,2020.0,1,0,1
ETH,KHM,2019.0,1,0,1
TWN,KAZ,2017.0,1,0,1
UKR,ISR,2021.0,1,0,1
UKR,TJK,2016.0,1,0,1
ECU,DOM,2021.0,1,0,1
IDN,BEL,2024.0,1,0,1
HRV,TUR,2022.0,1,0,1
NLD,MMR,2009.0,1,0,1
HND,,2007.0,1,0,1
HND,VNM,1999.0,1,0,1
SEN,SAU,2009.0,1,0,1
DEU,PAN,1997.0,1,0,1
EGY,PRT,2004.0,1,0,1
BEL,PER,1997.0,1,0,1
SWE,SDN,2001.0,1,0,1
AUT,ARG,1998.0,1,0,1
ZAF,TUR,2000.0,2,0,2
MEX,PAN,2007.0,1,0,1
NER,BFA,1998.0,1,0,1
DEU,LKA,2001.0,2,0,2
ROU,CHN,2000.0,1,0,1
GAB,DEU,2013.0,2,0,2
ISR,BGR,2017.0,1,0,1
GRC,SGP,2004.0,1,0,1
SAU,LKA,1999.0,1,0,1
,TKM,1996.0,1,0,1
UKR,MKD,1999.0,1,0,1
SWZ,,2004.0,1,0,1
MEX,HND,2008.0,2,0,2
BFA,BRA,2001.0,1,0,1
JOR,AUT,2016.0,1,0,1
ITA,MLT,2001.0,2,0,2
GBR,SEN,2014.0,1,0,1
HUN,TUR,2001.0,1,0,1
MWI,BEL,2006.0,1,0,1
TKM,DEU,1998.0,1,0,1
CHE,BFA,1998.0,1,0,1
KOR,ARM,2007.0,1,0,1
GTM,CAN,2009.0,1,0,1
NZL,MWI,2019.0,1,0,1
ZMB,NAM,2003.0,1,0,1
CIV,MLI,1999.0,1,0,1
COL,MLI,2012.0,1,0,1
ZWE,NAM,2011.0,1,0,1
URY,DNK,2013.0,1,0,1
KOR,ZWE,2013.0,1,0,1
NLD,KWT,2015.0,3,0,3
CHN,BEN,2009.0,1,0,1
NER,GBR,2013.0,1,0,1
AUT,KEN,2008.0,1,0,1
TUN,ARE,2006.0,1,0,1
MOZ,KEN,2014.0,1,0,1
JOR,KWT,2009.0,1,0,1
COL,JPN,2023.0,1,0,1
SLE,NGA,2009.0,1,0,1
BEL,JOR,2009.0,1,0,1
SYR,HRV,2021.0,1,0,1
ISR,FIN,2010.0,1,0,1
POL,SRB,2012.0,1,0,1
AUT,HKG,2017.0,1,0,1
NZL,PNG,2008.0,1,0,1
AFG,MAR,2019.0,1,0,1
TUN,JPN,2023.0,1,0,1
UZB,IRL,2022.0,1,0,1
BEL,TGO,2017.0,1,0,1
SAU,SYR,2023.0,1,0,1
GNQ,CHE,2008.0,1,0,1
URY,NGA,2011.0,1,0,1
ARG,ARE,2015.0,1,0,1
NLD,GRD,2005.0,1,0,1
MHL,AUS,2006.0,1,0,1
ISR,EGY,2004.0,1,0,1
ECU,DEU,1999.0,1,0,1
UKR,AUS,2014.0,1,0,1
HKG,KAZ,2014.0,1,0,1
IRL,UKR,2005.0,1,0,1
BHR,MYS,2013.0,1,0,1
MCO,SWE,2017.0,1,0,1
ESP,BLR,2001.0,1,0,1
DEU,BIH,1997.0,1,0,1
JPN,HND,2005.0,1,0,1
GUF,MTQ,2004.0,1,0,1
BRB,CAN,2021.0,1,0,1
NOR,VNM,2006.0,1,0,1
QAT,TWN,2022.0,1,0,1
NIC,MEX,2000.0,1,0,1
DEU,ZWE,2000.0,1,0,1
CZE,TUN,2008.0,1,0,1
FLK,ECU,2011.0,1,0,1
ZAF,SYC,2010.0,1,0,1
MCO,MAR,2012.0,1,0,1
ATA,USA,2011.0,1,0,1
REU,DEU,2015.0,1,0,1
MAC,NLD,2021.0,1,0,1
BEN,IRL,2011.0,1,0,1
YEM,NLD,2017.0,1,0,1
SLB,TWN,2017.0,1,0,1
GHA,BRB,2020.0,1,0,1
IND,UGA,2016.0,1,0,1
URY,CHN,2010.0,1,0,1
NOR,TCD,2020.0,1,0,1
TCA,,2015.0,1,0,1
ALB,ESP,1998.0,1,0,1
PSE,CHE,2018.0,1,0,1
MKD,ALB,2019.0,1,0,1
LKA,IRL,2019.0,1,0,1
BGD,ARE,2015.0,1,0,1
OMN,IDN,2018.0,1,0,1
CZE,PNG,2019.0,1,0,1
IRQ,BRA,2020.0,2,0,2
NGA,DMA,2017.0,1,0,1
IND,ARM,2017.0,1,0,1
PRT,TGO,2015.0,1,0,1
MOZ,ZWE,2019.0,1,0,1
MYS,AZE,2020.0,1,0,1
SRB,DOM,2017.0,1,0,1
TUR,LBY,2007.0,1,0,1
PAK,NLD,2007.0,1,0,1
NZL,TTO,2019.0,1,0,1
BLZ,GBR,2005.0,1,0,1
MYS,CHE,2004.0,1,0,1
NGA,KEN,2009.0,1,0,1
GBR,LBR,2008.0,1,0,1
CHE,SWZ,2008.0,2,0,2
LBN,CHE,2010.0,1,0,1
PHL,SRB,2006.0,1,0,1
SVN,ISR,1997.0,1,0,1
AUS,MWI,2012.0,1,0,1
BIH,SAU,2016.0,1,0,1
NLD,NPL,2003.0,1,0,1
JPN,EST,2010.0,1,0,1
GBR,BHS,2007.0,1,0,1
USA,SDN,2008.0,1,0,1
FIN,BLR,2010.0,1,0,1
USA,MAC,2002.0,1,0,1
SYR,SDN,2013.0,1,0,1
MAR,HUN,2005.0,1,0,1
PRT,MAC,2003.0,2,0,2
IND,JAM,2009.0,1,0,1
EST,ISR,2004.0,1,0,1
RUS,JAM,1999.0,1,0,1
GMB,DEU,2022.0,1,0,1
USA,LSO,2007.0,1,0,1
LKA,CHN,2024.0,1,0,1
BHR,OMN,2016.0,1,0,1
OMN,AUS,2024.0,2,0,2
COL,NLD,2007.0,2,0,2
GBR,AFG,2004.0,1,0,1
SRB,NZL,2006.0,1,0,1
UZB,AZE,2007.0,1,0,1
NGA,NAM,2018.0,1,0,1
KAZ,BRA,2019.0,1,0,1
GHA,MDG,2020.0,1,0,1
COL,COG,2013.0,1,0,1
BFA,TUN,2020.0,1,0,1
GAB,SLE,2017.0,1,0,1
BEN,UGA,2010.0,1,0,1
MEX,LUX,2023.0,1,0,1
MEX,SLV,2020.0,1,0,1
PER,GTM,2020.0,1,0,1
ISL,KEN,2012.0,1,0,1
KEN,ISL,2015.0,1,0,1
CHE,BIH,2017.0,1,0,1
ITA,NER,2023.0,1,0,1
DZA,TGO,2020.0,1,0,1
PHL,KAZ,2020.0,1,0,1
COG,JPN,2021.0,1,0,1
KHM,CHE,2016.0,1,0,1
PRT,FLK,2006.0,1,0,1
AZE,CHE,2006.0,1,0,1
FIN,PAN,2000.0,1,0,1
ROU,VEN,1998.0,1,0,1
BRA,LKA,2002.0,1,0,1
CIV,COD,2019.0,1,0,1
CIV,KEN,2010.0,1,0,1
BLR,CHE,2011.0,1,0,1
BEL,BIH,2016.0,1,0,1
GBR,TCA,2011.0,1,0,1
TWN,FJI,2018.0,1,0,1
PNG,CAN,2001.0,3,0,3
ERI,BEL,2019.0,1,0,1
SGP,PAK,2002.0,1,0,1
CUB,HUN,2016.0,1,0,1
CAF,NPL,2020.0,1,0,1
NLD,SEN,2015.0,1,0,1
CHE,MAC,2013.0,1,0,1
HUN,RUS,2001.0,1,0,1
UKR,THA,2014.0,1,0,1
HND,SWE,2014.0,1,0,1
OMN,DEU,2000.0,2,0,2
NER,CMR,2016.0,1,0,1
SDN,CAN,2014.0,1,0,1
VEN,PRT,2015.0,1,0,1
TUR,SOM,2018.0,1,0,1
IRN,LTU,2018.0,1,0,1
HUN,ETH,2014.0,1,0,1
IRN,JAM,2015.0,1,0,1
GMB,CMR,2020.0,2,0,2
DNK,LBN,2016.0,1,0,1
CHE,CRI,2018.0,1,0,1
VUT,FRA,2019.0,1,0,1
USA,REU,2017.0,1,0,1
ARE,MNE,2022.0,1,0,1
TWN,PRT,2008.0,1,0,1
THA,CZE,2021.0,1,0,1
,WLF,2013.0,1,0,1
MDV,IND,2016.0,1,0,1
MDV,ITA,2020.0,1,0,1
URY,PER,2016.0,1,0,1
NPL,POL,2021.0,1,0,1
VEN,FIN,2021.0,1,0,1
HUN,LUX,2022.0,1,0,1
CHE,KGZ,2019.0,1,0,1
FRA,ERI,2022.0,1,0,1
AFG,UGA,2021.0,1,0,1
IRL,SOM,2019.0,1,0,1
SDN,DNK,2021.0,1,0,1
UKR,DEU,2024.0,1,0,1
MAR,BGD,2021.0,1,0,1
SVK,QAT,2022.0,1,0,1
RUS,ROU,2005.0,1,0,1
KEN,RWA,2008.0,1,0,1
UKR,SSD,2022.0,1,0,1
SEN,KHM,2016.0,1,0,1
KHM,SEN,2019.0,1,0,1
,SDN,2021.0,2,0,2
TUR,BHR,2009.0,1,0,1
TZA,QAT,2004.0,1,0,1
CHE,UZB,2021.0,1,0,1
JAM,SUR,2021.0,1,0,1
EUE,,2024.0,1,0,1
IND,ARM,2022.0,1,0,1
BGD,QAT,2017.0,1,0,1
BIH,GBR,1998.0,1,0,1
GUM,PHL,2019.0,1,0,1
NER,KEN,1998.0,1,0,1
JPN,AZE,2008.0,1,0,1
NZL,OMN,1998.0,1,0,1
QAT,JPN,2000.0,1,0,1
SWZ,NZL,2010.0,1,0,1
FIN,ROU,1999.0,1,0,1
KOR,LAO,2011.0,1,0,1
BOL,CHL,2000.0,1,0,1
COG,DEU,2000.0,1,0,1
LVA,SVN,2005.0,1,0,1
ARE,CYP,2009.0,1,0,1
ROU,KOR,2014.0,1,0,1
AUS,MLI,2006.0,1,0,1
BRB,CMR,2013.0,1,0,1
JPN,BFA,2008.0,1,0,1
JPN,GEO,2004.0,1,0,1
UGA,EGY,2013.0,1,0,1
AUT,PER,2006.0,1,0,1
LUX,USA,2004.0,2,0,2
ALB,DEU,1998.0,1,0,1
POL,GEO,2001.0,1,0,1
COG,ZWE,1999.0,1,0,1
SWE,MAC,2020.0,1,0,1
SMR,,2015.0,1,0,1
EST,BEL,2005.0,1,0,1
HKG,IRL,2003.0,1,0,1
CMR,RWA,2013.0,1,0,1
ITA,COG,2012.0,1,0,1
GRC,CHL,2013.0,1,0,1
SVK,IRL,2016.0,1,0,1
ETH,CHN,2006.0,1,0,1
GMB,AUT,2011.0,1,0,1
NLD,PAN,2013.0,1,0,1
PAN,ARG,2004.0,1,0,1
ESP,SYC,2011.0,1,0,1
,GNB,2006.0,3,0,3
OMN,NLD,2018.0,1,0,1
BRN,ARE,2018.0,1,0,1
NGA,WSM,2013.0,1,0,1
TTO,NZL,2021.0,1,0,1
MHL,FJI,2017.0,1,0,1
NZL,SYR,2013.0,1,0,1
GUF,JAM,2001.0,1,0,1
CAN,BHS,2012.0,1,0,1
LVA,NOR,2011.0,1,0,1
HRV,NZL,2015.0,1,0,1
LVA,NOR,2019.0,1,0,1
ITA,LSO,2010.0,1,0,1
MYS,BRN,2004.0,1,0,1
MDG,GUF,2020.0,1,0,1
SVN,CHL,2009.0,1,0,1
NLD,LKA,2016.0,1,0,1
VUT,TON,2020.0,1,0,1
QAT,NPL,2020.0,1,0,1
MEX,ETH,2014.0,1,0,1
SRB,SAU,2008.0,1,0,1
CZE,SRB,2012.0,2,0,2
JPN,QAT,2012.0,2,0,2
GRC,JOR,2015.0,1,0,1
IRN,KGZ,2023.0,1,0,1
VEN,BEL,2010.0,2,0,2
GIN,CHN,2013.0,1,0,1
FIN,LKA,2019.0,1,0,1
BLR,IND,2011.0,1,0,1
BGR,KOR,2023.0,1,0,1
ZAF,TCD,2016.0,1,0,1
AUT,TUN,2018.0,1,0,1
BEL,MUS,2010.0,1,0,1
AUS,COG,2014.0,1,0,1
MUS,JPN,2017.0,1,0,1
PAN,ARG,2014.0,1,0,1
LVA,CRI,2015.0,1,0,1
JPN,DOM,2015.0,1,0,1
MAC,TUR,2020.0,1,0,1
ROU,BRA,2004.0,1,0,1
KOR,ARG,2023.0,1,0,1
TZA,ROU,2021.0,1,0,1
ZAF,COL,2010.0,1,0,1
NER,MDG,2013.0,1,0,1
PAK,EST,2013.0,1,0,1
CMR,DZA,2019.0,1,0,1
QAT,NOR,2019.0,1,0,1
BFA,MDG,2016.0,1,0,1
MOZ,DEU,2018.0,1,0,1
MWI,AUS,2020.0,1,0,1
CHN,TKM,2014.0,1,0,1
LBR,SOM,2020.0,1,0,1
CIV,CRI,2012.0,1,0,1
PRT,THA,2023.0,1,0,1
MDG,MKD,2018.0,1,0,1
MKD,MDG,2019.0,1,0,1
UKR,SVN,2015.0,1,0,1
TWN,LUX,2019.0,1,0,1
IRL,CRI,2019.0,1,0,1
FRA,MOZ,1998.0,1,0,1
BEL,KAZ,2014.0,1,0,1
MKD,MDA,2020.0,1,0,1
BRA,MYS,2020.0,1,0,1
AUS,HRV,1997.0,1,0,1
ARE,POL,1999.0,1,0,1
,BHS,2016.0,1,0,1
IRN,QAT,2003.0,1,0,1
SEN,GMB,2021.0,1,0,1
TZA,AUS,2010.0,1,0,1
UZB,AUS,1999.0,1,0,1
GTM,BRA,2020.0,1,0,1
BHS,,2008.0,1,0,1
WSM,USA,2023.0,1,0,1
KOR,SVN,2023.0,1,0,1
LBY,AUS,2022.0,1,0,1
ZWE,EGY,2021.0,1,0,1
UGA,COG,2005.0,1,0,1
COG,UGA,2010.0,1,0,1
ITA,BDI,2022.0,1,0,1
KWT,RUS,2022.0,1,0,1
GTM,CRI,2023.0,1,0,1
PRT,OMN,2021.0,1,0,1
ECU,PAK,2023.0,1,0,1
AZE,UZB,2021.0,2,0,2
JOR,ARE,2024.0,1,0,1
KWT,FJI,2002.0,1,0,1
ZWE,CMR,2003.0,1,0,1
TZA,MLI,2014.0,1,0,1
JPN,ETH,2001.0,1,0,1
ITA,CRI,2001.0,1,0,1
IRL,PRT,2000.0,2,0,2
PNG,GIN,2001.0,1,0,1
ARM,BLR,2001.0,1,0,1
ARE,NOR,2007.0,1,0,1
BRA,LKA,2012.0,1,0,1
BLR,ESP,2007.0,1,0,1
USA,BTN,2005.0,1,0,1
ZWE,SDN,2008.0,1,0,1
NER,SEN,1997.0,1,0,1
IND,SEN,2003.0,1,0,1
ITA,MDA,2011.0,1,0,1
GBR,BLR,1997.0,2,0,2
GRC,ISR,2002.0,1,0,1
MLI,CMR,1997.0,1,0,1
OMN,POL,2019.0,1,0,1
COG,CMR,2000.0,1,0,1
COG,CMR,2006.0,1,0,1
OMN,ESP,2002.0,1,0,1
CAN,QAT,2002.0,1,0,1
IRQ,BHR,2003.0,1,0,1
ZAF,SVK,2015.0,1,0,1
ARE,BHR,2002.0,1,0,1
UGA,CHN,2014.0,1,0,1
VEN,IRL,2010.0,1,0,1
POL,TUN,2009.0,1,0,1
NZL,BGD,2007.0,1,0,1
BRN,FJI,2017.0,1,0,1
FJI,BRN,2020.0,1,0,1
CIV,ROU,2013.0,1,0,1
ZWE,ETH,2016.0,1,0,1
CAF,CHE,2020.0,1,0,1
IND,QAT,2001.0,1,0,1
CHE,PSE,2014.0,1,0,1
AUT,LKA,2003.0,1,0,1
HKG,SVN,2020.0,1,0,1
COG,BDI,2021.0,1,0,1
KOR,BHS,2020.0,1,0,1
SDN,COG,2021.0,1,0,1
JAM,GLP,2022.0,1,0,1
NLD,GNB,2018.0,1,0,1
IDN,JOR,2020.0,1,0,1
ESP,SGP,2001.0,1,0,1
DZA,MEX,2015.0,1,0,1
HUN,PAK,2023.0,1,0,1
ZAF,KNA,2009.0,1,0,1
PRT,MOZ,2014.0,1,0,1
MMR,THA,2003.0,1,0,1
ERI,GBR,2020.0,1,0,1
SAU,NPL,2001.0,1,0,1
LKA,NOR,2004.0,1,0,1
ZAF,COL,2006.0,1,0,1
ROU,HKG,1999.0,1,0,1
VNM,CYP,2021.0,1,0,1
ARE,SRB,2001.0,1,0,1
DNK,CHL,2006.0,1,0,1
BDI,GHA,2016.0,1,0,1
IDN,NCL,2017.0,1,0,1
WSM,USA,2010.0,1,0,1
,LBR,1995.0,1,0,1
SGP,PAK,2005.0,1,0,1
JPN,JAM,2017.0,1,0,1
NGA,ECU,2017.0,1,0,1
SWE,COL,2009.0,1,0,1
RWA,ZMB,2014.0,1,0,1
CHE,LAO,2014.0,1,0,1
FRA,COD,2017.0,1,0,1
ECU,NER,2012.0,1,0,1
PAK,BRN,2018.0,1,0,1
JOR,PSE,2013.0,1,0,1
MDA,PRT,2010.0,1,0,1
NGA,IRQ,2021.0,1,0,1
HUN,TWN,2018.0,1,0,1
SLB,GBR,2020.0,1,0,1
BFA,TCD,2023.0,1,0,1
ZAF,COG,2020.0,1,0,1
GHA,ITA,2023.0,1,0,1
BRA,ETH,2023.0,1,0,1
THA,TUR,2021.0,1,0,1
CHN,TJK,2022.0,1,0,1
,FLK,2018.0,1,0,1
SMR,FRA,2023.0,1,0,1
KNA,CHL,2021.0,2,0,2
COL,HUN,2022.0,1,0,1
FRA,MYS,2000.0,1,0,1
NPL,CHE,2005.0,1,0,1
ARE,ETH,2017.0,1,0,1
KWT,JAM,2001.0,1,0,1
ISR,CHL,2009.0,1,0,1
ASM,USA,2000.0,1,0,1
GUM,AUS,2010.0,1,0,1
UGA,NOR,1999.0,1,0,1
ITA,CRI,2015.0,1,0,1
USA,BMU,1997.0,1,0,1
EST,PRT,2005.0,1,0,1
MEX,ZWE,2017.0,1,0,1
FJI,BWA,2016.0,1,0,1
VCT,ZAF,2007.0,1,0,1
HND,SWE,2008.0,1,0,1
SVK,BLR,2018.0,1,0,1
RWA,MWI,2019.0,1,0,1
ETH,ZMB,2015.0,1,0,1
MLT,NZL,2015.0,1,0,1
HUN,MAR,2022.0,1,0,1
TJK,TUR,2017.0,1,0,1
PSE,IRL,2020.0,1,0,1
NAM,SWE,2019.0,1,0,1
KAZ,DNK,2018.0,1,0,1
JAM,NLD,2009.0,1,0,1
FRO,GBR,2022.0,1,0,1
SVK,JPN,2022.0,1,0,1
MWI,AUS,2007.0,1,0,1
USA,WSM,2017.0,1,0,1
PER,AUS,2019.0,1,0,1
SVN,THA,2021.0,1,0,1
MKD,ARE,2020.0,1,0,1
CUB,ARG,1997.0,1,0,1
TZA,MYS,2011.0,1,0,1
YEM,DZA,2023.0,2,0,2
NGA,RUS,2022.0,1,0,1
EGY,MDV,2023.0,1,0,1
CIV,TTO,2018.0,1,0,1
SAU,KEN,2023.0,1,0,1
SDN,JOR,2021.0,1,0,1
TGO,DEU,2020.0,1,0,1
BEL,MOZ,2014.0,1,0,1
TUN,IRL,2000.0,1,0,1
POL,GRC,2005.0,1,0,1
ISR,PER,2010.0,1,0,1
CIV,ZWE,2003.0,1,0,1
NOR,SVK,1997.0,1,0,1
IRQ,JPN,2008.0,1,0,1
UKR,BGD,1997.0,1,0,1
FRA,AGO,2007.0,1,0,1
BEN,NLD,2002.0,1,0,1
EGY,POL,2003.0,1,0,1
NZL,PAK,2002.0,1,0,1
CZE,NOR,1997.0,1,0,1
GEO,PAK,2010.0,1,0,1
NOR,COL,2005.0,1,0,1
TUR,ISL,2004.0,1,0,1
JAM,NGA,2004.0,1,0,1
TTO,FJI,2010.0,1,0,1
CHE,BOL,2002.0,1,0,1
BGR,TUR,2003.0,1,0,1
LAO,BOL,2009.0,1,0,1
BRA,NPL,2007.0,1,0,1
ETH,ZMB,2001.0,1,0,1
HKG,UKR,2005.0,1,0,1
MCO,GBR,1997.0,1,0,1
GUF,USA,2004.0,1,0,1
HKG,ARE,2000.0,1,0,1
TTO,ZAF,2002.0,1,0,1
ROU,DNK,2000.0,1,0,1
IRN,CHE,1997.0,1,0,1
MMR,KOR,2004.0,1,0,1
URY,GTM,2013.0,1,0,1
GHA,OMN,2019.0,1,0,1
BEL,ARE,2012.0,1,0,1
FRA,KWT,2008.0,1,0,1
DNK,BLR,2004.0,1,0,1
BRA,CYP,2003.0,1,0,1
IRL,KNA,2021.0,1,0,1
NZL,ARG,2012.0,1,0,1
JOR,IRL,2012.0,1,0,1
SLE,DEU,2021.0,1,0,1
PNG,FSM,2023.0,1,0,1
BFA,DEU,2011.0,1,0,1
ETH,BRA,2015.0,1,0,1
PSE,BEL,2009.0,1,0,1
FJI,MEX,2012.0,1,0,1
NAM,CHE,2023.0,1,0,1
ROU,TZA,2011.0,1,0,1
GEO,CHE,2010.0,1,0,1
UKR,BFA,2008.0,1,0,1
DZA,GRC,2007.0,1,0,1
BOL,IDN,2014.0,1,0,1
SGP,MMR,2014.0,1,0,1
BRA,TGO,2021.0,1,0,1
HKG,MCO,2022.0,1,0,1
NPL,CAN,2006.0,1,0,1
HRV,FLK,2020.0,1,0,1
ARG,ZMB,2013.0,1,0,1
ESP,GNB,2012.0,1,0,1
LKA,NOR,2015.0,1,0,1
PRI,RUS,2021.0,1,0,1
LCA,WSM,2020.0,1,0,1
ZMB,MWI,2010.0,1,0,1
GLP,TUN,2013.0,1,0,1
TUN,FIN,2014.0,1,0,1
SWE,NGA,2008.0,1,0,1
CAN,LCA,2019.0,1,0,1
IND,RWA,2017.0,1,0,1
ISR,TUN,2015.0,1,0,1
ISR,MKD,2018.0,1,0,1
NLD,AZE,2015.0,1,0,1
AFG,MEX,2020.0,1,0,1
NAM,ESP,2023.0,1,0,1
NZL,GRL,2017.0,1,0,1
BIH,CZE,2019.0,1,0,1
USA,GUY,2018.0,1,0,1
RWA,GEO,2017.0,1,0,1
TUR,ARG,2015.0,1,0,1
MKD,BGR,2016.0,1,0,1
MDG,SEN,2013.0,1,0,1
PRT,QAT,2015.0,1,0,1
CMR,CHN,1997.0,1,0,1
ISL,CHN,2004.0,1,0,1
BDI,ZAF,2001.0,1,0,1
MAR,CMR,2003.0,1,0,1
FJI,PNG,2015.0,1,0,1
GRL,USA,2013.0,1,0,1
FRA,JAM,2005.0,1,0,1
KOR,LUX,2021.0,1,0,1
ISL,RUS,2018.0,1,0,1
TCD,,2010.0,1,0,1
CRI,BRA,2008.0,1,0,1
TWN,GRC,2013.0,1,0,1
BRA,LAO,2016.0,1,0,1
SWE,QAT,2010.0,1,0,1
WSM,,2010.0,1,0,1
ETH,NLD,2001.0,1,0,1
SWE,MAR,2005.0,1,0,1
ITA,NAM,2014.0,1,0,1
CHN,TZA,2010.0,1,0,1
JOR,BRA,2011.0,1,0,1
ITA,LBY,2015.0,1,0,1
LVA,AUT,2017.0,1,0,1
COD,CMR,1999.0,1,0,1
RUS,SVN,2001.0,1,0,1
QAT,COL,2007.0,1,0,1
BMU,DEU,2001.0,1,0,1
LBY,IRQ,2015.0,1,0,1
FRA,GEO,2007.0,1,0,1
NOR,JOR,2020.0,1,0,1
UKR,DNK,2014.0,1,0,1
FRA,TTO,1998.0,1,0,1
TZA,IRL,1997.0,1,0,1
IND,TZA,2006.0,1,0,1
GHA,MLI,2019.0,1,0,1
BRA,TUR,2016.0,1,0,1
,STP,2016.0,1,0,1
SWE,CYP,2023.0,1,0,1
SWE,CMR,2022.0,1,0,1
ATA,FRA,2018.0,1,0,1
GHA,FIN,2016.0,1,0,1
ETH,AUT,2008.0,1,0,1
CPV,POL,2019.0,1,0,1
KOR,GEO,2018.0,1,0,1
ARM,SWE,2018.0,1,0,1
CMR,GAB,2021.0,1,0,1
AZE,CZE,2022.0,1,0,1
MWI,BEL,2023.0,1,0,1
CIV,DEU,2005.0,1,0,1
LUX,NLD,2004.0,1,0,1
BFA,NLD,2009.0,1,0,1
GBR,BEN,2016.0,1,0,1
CZE,EGY,2004.0,1,0,1
JOR,SYR,2007.0,1,0,1
GHA,ZAF,2000.0,1,0,1
BDI,FRA,2002.0,1,0,1
BWA,HUN,2016.0,1,0,1
WSM,NZL,2013.0,1,0,1
HUN,BGR,2004.0,1,0,1
KHM,CHN,2014.0,1,0,1
POL,IND,2005.0,1,0,1
SRB,BGD,2006.0,1,0,1
POL,MDA,2007.0,1,0,1
MDA,POL,2008.0,1,0,1
OMN,BHR,2013.0,1,0,1
MLI,GAB,2005.0,1,0,1
DEU,KAZ,1997.0,1,0,1
MDA,GBR,2002.0,1,0,1
BLR,BRA,2011.0,1,0,1
ZAF,ETH,1997.0,1,0,1
ETH,CMR,1998.0,1,0,1
DOM,,1999.0,1,0,1
PNG,ZAF,1999.0,1,0,1
KWT,IRN,2012.0,1,0,1
DZA,CAN,2001.0,1,0,1
GMB,GAB,2012.0,1,0,1
LUX,IND,2009.0,1,0,1
PHL,NGA,2006.0,1,0,1
BRN,IND,2015.0,1,0,1
JPN,KHM,2009.0,1,0,1
CAN,UGA,1997.0,1,0,1
MEX,NIC,2010.0,1,0,1
DNK,CHL,2010.0,1,0,1
IND,ABW,2023.0,1,0,1
NZL,BMU,2007.0,1,0,1
NGA,CIV,2011.0,1,0,1
GHA,LKA,2016.0,1,0,1
HUN,CHL,2019.0,1,0,1
LTU,TUR,2012.0,1,0,1
RWA,DEU,2017.0,1,0,1
DNK,PHL,2013.0,1,0,1
SYR,SDN,2003.0,1,0,1
KOR,PRY,2015.0,1,0,1
SEN,UGA,2015.0,1,0,1
BGD,DNK,2010.0,2,0,2
,GIB,2007.0,1,0,1
ZWE,NZL,2018.0,1,0,1
BHR,QAT,2015.0,1,0,1
KWT,SWE,2012.0,1,0,1
IRQ,IND,2000.0,1,0,1
ETH,IRL,2015.0,1,0,1
GHA,CHE,2017.0,1,0,1
CHN,AGO,2021.0,1,0,1
CZE,COL,2016.0,1,0,1
USA,FSM,2008.0,1,0,1
CHE,PNG,2020.0,1,0,1
SAU,HRV,2013.0,1,0,1
GBR,TUN,2007.0,1,0,1
DEU,GUM,2004.0,1,0,1
JOR,SDN,2022.0,1,0,1
MYS,NER,2020.0,1,0,1
CHN,HTI,2023.0,1,0,1
,VAT,2015.0,1,0,1
PHL,MNG,2023.0,1,0,1
KHM,BTN,2021.0,1,0,1
ESP,CMR,2010.0,1,0,1
LBR,SLE,2021.0,1,0,1
BRN,FRA,2023.0,1,0,1
MAR,FIN,2020.0,1,0,1
COL,PRY,2021.0,1,0,1
GUM,DEU,2008.0,1,0,1
CRI,IDN,2015.0,1,0,1
ZAF,COG,1998.0,1,0,1
BDI,NLD,2008.0,1,0,1
MKD,POL,2002.0,2,0,2
USA,MMR,1998.0,1,0,1
USA,MNE,2008.0,1,0,1
URY,ISR,2003.0,1,0,1
JPN,JOR,2009.0,1,0,1
MWI,COG,2010.0,1,0,1
SVK,LBY,2004.0,1,0,1
ISR,ZWE,1999.0,1,0,1
ZWE,BRB,2000.0,1,0,1
AIA,NGA,2017.0,1,0,1
PYF,MEX,2006.0,1,0,1
SRB,KAZ,2011.0,1,0,1
TWN,TUR,2000.0,1,0,1
NLD,MLI,1997.0,1,0,1
IDN,MMR,2012.0,1,0,1
KWT,ROU,2007.0,1,0,1
TUR,GHA,2017.0,1,0,1
MYS,SDN,2004.0,1,0,1
COD,SLE,2017.0,1,0,1
DEU,KGZ,2003.0,1,0,1
FRA,JOR,2004.0,1,0,1
SVK,CHN,2001.0,1,0,1
PRY,,2001.0,1,0,1
CHE,ARM,2021.0,1,0,1
FJI,MYS,2010.0,1,0,1
PHL,FJI,2015.0,1,0,1
PHL,ARG,2017.0,1,0,1
PHL,ARG,2016.0,1,0,1
CHE,LVA,2011.0,1,0,1
NLD,VCT,2015.0,1,0,1
COD,FRA,2006.0,1,0,1
MEX,OMN,2004.0,1,0,1
MDV,MDG,2021.0,1,0,1
TWN,MEX,2004.0,1,0,1
IDN,BRA,2011.0,1,0,1
DZA,PRT,2009.0,1,0,1
BGD,NZL,2005.0,1,0,1
CHL,QAT,2016.0,1,0,1
TUN,NLD,2001.0,1,0,1
BRA,MYS,2007.0,1,0,1
LKA,PNG,2014.0,1,0,1
ECU,CHE,2008.0,1,0,1
PHL,KEN,2016.0,1,0,1
ECU,CHN,2017.0,1,0,1
GRD,TTO,2008.0,1,0,1
NER,CMR,2017.0,1,0,1
GRC,THA,2019.0,1,0,1
MDA,GRC,2014.0,1,0,1
USA,SHN,2012.0,1,0,1
SRB,ISR,2010.0,1,0,1
SVK,PRT,2007.0,1,0,1
ECU,SWE,2011.0,1,0,1
GTM,CHE,2021.0,1,0,1
EGY,AFG,2007.0,1,0,1
THA,TUR,2019.0,1,0,1
COL,BOL,2013.0,1,0,1
ARE,PRI,2016.0,1,0,1
KOR,HRV,2012.0,1,0,1
IDN,VNM,2006.0,1,0,1
KOR,LBR,2020.0,1,0,1
YEM,IRL,2015.0,1,0,1
BFA,TWN,2016.0,1,0,1
MAR,CMR,2013.0,1,0,1
CZE,ARE,2017.0,1,0,1
SLE,GMB,2021.0,1,0,1
TZA,TJK,2015.0,1,0,1
ISR,JOR,2017.0,1,0,1
UGA,SWZ,2017.0,1,0,1
LTU,KWT,2010.0,1,0,1
FRA,COM,2022.0,1,0,1
MDA,ESP,2016.0,1,0,1
MLI,NGA,2013.0,1,0,1
JOR,ISR,2015.0,1,0,1
CMR,BRA,2018.0,1,0,1
ETH,SOM,2014.0,1,0,1
BGR,DNK,2016.0,1,0,1
COL,KEN,2014.0,1,0,1
PLW,HKG,2022.0,1,0,1
PRT,AGO,2000.0,1,1,0
BEN,NLD,1999.0,1,1,0
ITA,PHL,2008.0,1,2,-1
URY,GBR,2004.0,1,2,-1
ROU,DNK,2009.0,1,1,0
SVN,IND,2016.0,1,1,0
NGA,FIN,2013.0,1,2,-1
MEX,NZL,2018.0,2,4,-2
NOR,BIH,2019.0,1,1,0
MYS,CHL,2004.0,1,1,0
AUT,SGP,2001.0,2,2,0
MAR,DEU,2006.0,2,2,0
SAU,TUN,2005.0,1,1,0
ECU,GBR,2000.0,1,1,0
BEN,CMR,1999.0,1,1,0
NLD,ZWE,2010.0,1,2,-1
MOZ,USA,1998.0,1,1,0
DEU,AUT,2024.0,1,3,-2
BLR,CHN,2010.0,1,2,-1
FRA,RWA,2022.0,1,3,-2
MNG,KOR,2015.0,1,9,-8
KOR,PRT,2021.0,1,2,-1
TWN,IRN,2020.0,1,9,-8
NOR,VNM,2019.0,1,3,-2
ITA,ARM,2002.0,1,1,0
RUS,SVK,2012.0,1,1,0
SYR,JPN,2007.0,1,1,0
DNK,ZAF,2020.0,1,6,-5
ITA,LBN,2009.0,1,1,0
BRA,PAN,2014.0,3,3,0
TZA,RWA,2022.0,2,1,1
ZAF,LSO,2015.0,1,4,-3
IND,ERI,2019.0,1,1,0
TUR,IRN,2024.0,1,1,0
AUS,SVN,2011.0,1,3,-2
GEO,JPN,2002.0,1,1,0
GRL,USA,2008.0,1,1,0
JOR,DEU,1999.0,1,5,-4
RUS,KGZ,2002.0,1,2,-1
NPL,ITA,2019.0,1,1,0
THA,RUS,2023.0,1,2,-1
JPN,DOM,2003.0,1,1,0
BGR,SVN,2021.0,1,1,0
GIN,FRA,2022.0,1,2,-1
SVK,CAN,2021.0,1,2,-1
HKG,LKA,2021.0,1,1,0
TWN,CZE,2011.0,1,5,-4
IND,SVN,2007.0,1,1,0
HKG,PAK,2010.0,1,1,0
USA,BEN,2020.0,1,6,-5
PAK,ROU,2010.0,1,1,0
DNK,MOZ,2015.0,1,2,-1
FIN,JOR,2010.0,1,1,0
IRN,PHL,2015.0,1,1,0
CRI,AUS,2022.0,1,2,-1
ITA,DZA,2010.0,1,1,0
URY,ECU,2021.0,1,2,-1
ZWE,BWA,2017.0,1,1,0
JPN,HRV,1998.0,1,1,0
PRT,IND,2001.0,1,6,-5
JAM,IND,2015.0,1,1,0
IRL,RUS,2012.0,1,6,-5
IDN,BGD,2023.0,1,3,-2
DNK,BGR,2012.0,1,1,0
NGA,GUY,2021.0,1,1,0
KAZ,BEL,2018.0,1,3,-2
SAU,BGD,2013.0,1,4,-3
UKR,GRC,1998.0,1,1,0
KOR,UKR,2017.0,1,1,0
PER,CRI,2015.0,1,1,0
COG,KHM,2019.0,1,1,0
EGY,ZAF,2016.0,1,4,-3
MAR,GAB,2023.0,1,1,0
ZAF,MEX,2020.0,1,3,-2
CMR,ITA,2005.0,1,1,0
SAU,PRT,2012.0,1,3,-2
SGP,BRA,2022.0,2,2,0
THA,CAN,1998.0,1,4,-3
ZMB,MWI,2011.0,1,2,-1
FRA,PHL,2020.0,1,4,-3
IRQ,IND,2009.0,1,3,-2
HUN,GRC,2021.0,1,1,0
SEN,GBR,2010.0,1,2,-1
EST,NZL,2021.0,1,1,0
RWA,NLD,2021.0,1,4,-3
NPL,DEU,2001.0,1,1,0
LSO,ZAF,2006.0,1,1,0
PHL,ESP,2023.0,1,1,0
IND,BHR,2015.0,2,2,0
SSD,EGY,2016.0,1,1,0
KAZ,ARE,2022.0,1,5,-4
DEU,MKD,2023.0,1,1,0
MDG,BEN,2018.0,2,1,1
CHE,LIE,2023.0,3,1,2
IRL,SAU,2013.0,3,1,2
CZE,FIN,2018.0,3,6,-3
BEL,MYS,2021.0,2,2,0
CHE,UGA,2012.0,2,4,-2
MYS,DNK,2010.0,2,1,1
TUR,NZL,2016.0,2,1,1
CHE,KGZ,2015.0,1,1,0
ZMB,MWI,2013.0,1,1,0
UKR,FIN,2013.0,2,1,1
SAU,JPN,2011.0,1,15,-14
OMN,SDN,2014.0,2,3,-1
MEX,POL,2013.0,1,3,-2
SEN,GBR,2015.0,2,1,1
GIN,COG,2021.0,1,1,0
JOR,ESP,2017.0,1,2,-1
MDG,ETH,2019.0,1,1,0
CHL,ROU,2021.0,1,1,0
PRT,MEX,2014.0,4,2,2
MAC,DEU,2020.0,1,2,-1
MEX,DNK,2023.0,5,1,4
BEL,BEN,2021.0,3,8,-5
GBR,BIH,2020.0,2,2,0
NGA,ARG,2019.0,1,1,0
MLT,IRL,2021.0,1,1,0
ECU,GBR,2015.0,3,5,-2
PYF,BEL,2023.0,1,1,0
CHN,CMR,2019.0,2,5,-3
UGA,DEU,2023.0,2,4,-2
GHA,BRA,2019.0,1,1,0
TUR,JOR,1998.0,1,1,0
ZAF,FIN,2006.0,2,3,-1
FRA,NGA,2002.0,3,3,0
ARG,DNK,2000.0,2,1,1
JPN,ARE,2015.0,2,1,1
BEL,UKR,2014.0,2,2,0
CAN,MLT,2006.0,1,1,0
DNK,GRL,2006.0,5,6,-1
UZB,GBR,2003.0,1,1,0
TUR,AUT,2008.0,2,1,1
SWZ,ZAF,2017.0,5,6,-1
GBR,LUX,2004.0,4,2,2
BOL,BEL,2005.0,1,4,-3
IDN,IND,2004.0,2,1,1
TUR,RUS,2002.0,6,12,-6
DOM,ESP,2012.0,1,1,0
ESP,ZAF,2003.0,2,3,-1
IRN,FIN,2008.0,1,1,0
NGA,ZAF,2002.0,3,4,-1
USA,YEM,1998.0,1,1,0
FRA,GAB,1997.0,2,5,-3
GBR,SLE,2000.0,1,1,0
NOR,HUN,2008.0,1,2,-1
KEN,BWA,1999.0,1,1,0
POL,ARG,2017.0,1,2,-1
CAN,BGR,2002.0,1,3,-2
ISL,SWE,1997.0,5,4,1
SWE,ECU,2009.0,1,2,-1
CHE,ETH,2012.0,2,1,1
GMB,USA,2011.0,3,1,2
NOR,SVN,2015.0,1,2,-1
KEN,DNK,2011.0,1,1,0
ESP,SVK,2011.0,3,2,1
BOL,ARG,2015.0,1,1,0
LUX,CZE,2016.0,1,1,0
CAF,BFA,2008.0,1,1,0
USA,LAO,2010.0,1,1,0
CHE,TZA,2009.0,1,6,-5
ARE,BEL,2020.0,2,7,-5
MEX,ARG,1998.0,3,6,-3
NAM,ZAF,2010.0,3,5,-2
DZA,GRC,2017.0,1,1,0
PAN,DEU,2010.0,3,1,2
BEL,SVN,2010.0,2,3,-1
AUT,COL,2015.0,1,3,-2
IND,BRB,2010.0,1,1,0
CHE,ARG,2003.0,3,4,-1
MAR,TUN,1998.0,1,3,-2
JPN,ETH,2009.0,1,1,0
IRL,SVN,2019.0,1,1,0
TZA,ZMB,2010.0,1,1,0
USA,MDG,2008.0,2,4,-2
SWE,ROU,2010.0,2,4,-2
MAR,TUN,2020.0,1,7,-6
NLD,THA,2005.0,4,4,0
THA,BGD,2020.0,4,5,-1
SAU,AUT,2020.0,1,3,-2
AUS,ARE,2004.0,4,2,2
CZE,BLR,2013.0,1,2,-1
THA,IRN,2013.0,1,1,0
NOR,MYS,2020.0,2,4,-2
CMR,RWA,2023.0,1,1,0
ARE,ITA,2010.0,2,1,1
LVA,FRA,2013.0,1,1,0
PRT,MAR,2019.0,1,1,0
UGA,AUS,2014.0,2,1,1
DEU,LVA,2022.0,3,2,1
IRN,RUS,2013.0,2,2,0
USA,MLT,2023.0,1,3,-2
ZAF,NOR,2019.0,4,3,1
NGA,ESP,2010.0,1,1,0
TUN,JPN,2013.0,1,3,-2
NOR,KEN,2023.0,2,2,0
JOR,NOR,2018.0,1,2,-1
RWA,BEL,2018.0,2,3,-1
AUS,ARG,2020.0,2,10,-8
VNM,SRB,2019.0,1,3,-2
PRT,PRI,2014.0,1,1,0
UKR,ITA,2020.0,6,3,3
JPN,COL,2012.0,3,2,1
LBN,JOR,2015.0,1,1,0
ARM,COL,2014.0,1,1,0
PAK,GMB,2022.0,1,2,-1
TUR,KGZ,2018.0,1,4,-3
PRT,GRC,2018.0,1,9,-8
CAN,BOL,2016.0,1,1,0
ROU,ISR,2018.0,3,4,-1
KOR,IRL,2020.0,4,5,-1
CHN,HRV,2023.0,2,1,1
ROU,ARM,2020.0,1,1,0
SWE,UGA,2018.0,2,3,-1
BIH,GBR,2018.0,2,4,-2
BEN,ZAF,2015.0,1,3,-2
TJK,DEU,2021.0,1,2,-1
BRA,PAK,2011.0,1,3,-2
ETH,POL,2021.0,2,1,1
BRA,ROU,2020.0,1,1,0
ETH,NGA,2016.0,1,4,-3
HUN,ESP,2005.0,2,3,-1
ESP,HUN,2006.0,2,4,-2
ESP,BOL,2023.0,1,1,0
TCD,FRA,2021.0,1,4,-3
GRL,DNK,2023.0,3,5,-2
MMR,CHN,2023.0,3,3,0
VNM,SWE,2012.0,2,3,-1
SLV,ESP,2013.0,1,3,-2
BRN,USA,2004.0,3,1,2
DEU,CAF,2012.0,1,1,0
BEL,MOZ,2021.0,1,2,-1
IDN,BRN,2014.0,1,1,0
SDN,TUR,2018.0,1,1,0
PHL,HKG,2015.0,1,1,0
MYS,SWE,2017.0,1,5,-4
ETH,SWE,2011.0,4,5,-1
CHL,IRL,2013.0,1,2,-1
ITA,HKG,2016.0,2,2,0
TWN,PRT,2021.0,1,1,0
CHN,OMN,2016.0,2,1,1
MOZ,ZAF,2019.0,4,5,-1
FRA,ECU,2009.0,3,6,-3
UKR,TWN,2006.0,1,1,0
AUS,SLE,2020.0,2,1,1
CZE,PAK,2017.0,1,2,-1
EST,UKR,2019.0,2,3,-1
CHL,PRT,2020.0,3,5,-2
TUN,KOR,2022.0,1,1,0
USA,MMR,2022.0,7,7,0
COL,AUS,2023.0,4,2,2
NER,FRA,2021.0,4,4,0
ISR,UKR,2019.0,2,4,-2
DZA,BEL,1998.0,1,1,0
SAU,SYR,2013.0,1,1,0
KEN,DEU,2001.0,2,3,-1
SRB,SWE,2008.0,3,2,1
ZAF,PAK,2009.0,1,1,0
BHR,TUR,2012.0,1,2,-1
TUN,MAR,2006.0,2,4,-2
BOL,SWE,2008.0,2,1,1
BEN,ZAF,2014.0,2,1,1
NOR,EGY,1997.0,1,2,-1
EGY,NOR,1999.0,1,1,0
NIC,GBR,2003.0,1,1,0
KWT,JOR,2020.0,1,2,-1
MWI,NOR,2011.0,1,2,-1
DEU,UZB,2011.0,2,2,0
ITA,BEN,2013.0,1,2,-1
GBR,LVA,2010.0,2,2,0
BFA,ZAF,2001.0,1,1,0
NPL,BGD,2004.0,1,1,0
ITA,MDA,2014.0,1,2,-1
SVK,NLD,2010.0,4,3,1
RUS,AUT,2018.0,7,7,0
SAU,SDN,1997.0,1,2,-1
DEU,IRQ,2007.0,1,1,0
KOR,AUS,2004.0,4,17,-13
IRL,ZAF,2003.0,3,2,1
DEU,NAM,2014.0,3,1,2
LAO,USA,2009.0,1,1,0
PRT,VEN,2011.0,1,5,-4
NLD,BLR,2007.0,1,2,-1
FIN,POL,2010.0,2,6,-4
ECU,FRA,2013.0,2,3,-1
BWA,SWE,2013.0,1,1,0
BEL,UKR,2008.0,2,1,1
NLD,MLT,2017.0,1,1,0
POL,IRN,2013.0,1,1,0
GHA,NOR,2015.0,1,1,0
BGD,ITA,2018.0,3,4,-1
BHR,SAU,2011.0,4,3,1
SLV,USA,2016.0,2,2,0
SVN,PRT,2017.0,1,2,-1
FRA,GEO,2017.0,1,28,-27
HUN,POL,2015.0,3,2,1
UGA,MYS,2017.0,1,3,-2
MAC,USA,2012.0,1,10,-9
LUX,RUS,2016.0,1,1,0
SYR,EGY,2014.0,2,1,1
VEN,AUS,2005.0,2,2,0
MWI,CHN,2023.0,1,4,-3
BIH,NOR,2018.0,2,1,1
TWN,ZAF,2019.0,4,1,3
SLV,USA,2022.0,3,6,-3
CIV,CAN,2013.0,2,1,1
BIH,HUN,2019.0,1,1,0
COL,PER,2016.0,6,4,2
BGD,ITA,2017.0,2,3,-1
RWA,CHE,2022.0,3,1,2
NZL,BGD,2016.0,1,2,-1
LKA,CHN,2013.0,1,2,-1
COG,ESP,2019.0,1,1,0
CMR,IND,2016.0,1,1,0
MOZ,DEU,2020.0,1,1,0
SVK,JPN,1999.0,2,1,1
ESP,GTM,2011.0,1,1,0
OMN,IND,2003.0,1,4,-3
SVN,MKD,2017.0,1,1,0
USA,PLW,2000.0,1,1,0
NGA,NOR,2018.0,1,3,-2
CAN,DZA,2022.0,1,8,-7
MDG,GBR,2019.0,4,2,2
GMB,USA,2019.0,5,1,4
CIV,MLI,2018.0,3,2,1
PAK,BRA,2021.0,3,5,-2
RWA,NGA,2023.0,5,2,3
CZE,ISR,2020.0,1,6,-5
SRB,TUR,2023.0,1,2,-1
MNG,RUS,2019.0,1,5,-4
ITA,KEN,2023.0,1,1,0
ESP,HUN,2023.0,3,6,-3
BFA,CIV,2007.0,2,3,-1
TWN,HKG,2000.0,1,5,-4
CZE,DNK,2002.0,2,1,1
TTO,KNA,2018.0,1,1,0
EGY,NLD,1997.0,1,2,-1
THA,BGD,1999.0,1,2,-1
USA,PNG,2001.0,2,3,-1
PNG,CHE,2002.0,1,2,-1
AUS,SAU,2001.0,2,1,1
AUS,MAC,2009.0,1,1,0
CAN,MOZ,2009.0,1,1,0
UKR,BRA,2007.0,1,4,-3
SDN,JPN,2017.0,2,1,1
TTO,JAM,2019.0,2,10,-8
NOR,PER,2014.0,2,1,1
COG,GBR,2018.0,2,3,-1
CAN,ROU,2017.0,4,2,2
BLR,UKR,2014.0,1,2,-1
HUN,NZL,2013.0,1,1,0
SVN,AUS,2021.0,3,3,0
CAN,PER,2015.0,1,2,-1
CHN,MYS,2014.0,2,7,-5
HND,ESP,2018.0,1,3,-2
NLD,CYP,2014.0,1,4,-3
BRA,IRN,2020.0,2,10,-8
TUR,LBN,2020.0,2,1,1
LAO,JPN,2018.0,2,4,-2
HKG,GHA,2017.0,1,1,0
MUS,USA,2017.0,3,2,1
PHL,THA,2023.0,4,6,-2
GBR,SLE,2010.0,1,1,0
KOR,BRA,2012.0,2,2,0
HKG,ETH,2020.0,1,2,-1
IDN,AUT,2018.0,1,4,-3
AUT,ZAF,2020.0,2,3,-1
TWN,BEL,2020.0,4,4,0
SWE,ZWE,2020.0,1,1,0
DNK,IND,2008.0,3,13,-10
MLT,DEU,2022.0,1,1,0
USA,ATG,2019.0,1,2,-1
BGR,CZE,2021.0,1,1,0
ETH,IRN,2022.0,2,6,-4
PRT,FIN,2021.0,1,9,-8
NIC,USA,2021.0,2,1,1
ITA,UKR,1998.0,3,2,1
VNM,CAN,2012.0,1,3,-2
AUT,VNM,2019.0,6,2,4
ALB,USA,2008.0,1,2,-1
COL,SAU,2017.0,2,2,0
JPN,HUN,2021.0,2,4,-2
ITA,QAT,2023.0,3,3,0
AUS,MMR,2020.0,3,3,0
ZAF,ZMB,2012.0,2,3,-1
UKR,ISR,2004.0,2,1,1
CUB,COL,2007.0,6,1,5
TZA,NLD,2000.0,1,1,0
USA,MDA,2007.0,1,1,0
DEU,KWT,2014.0,3,1,2
USA,BLZ,2004.0,2,3,-1
CHE,BGR,2014.0,2,5,-3
AUS,KWT,2008.0,2,1,1
MDG,USA,1998.0,1,3,-2
ECU,COL,2016.0,2,13,-11
AUT,ISR,2003.0,2,4,-2
BGR,BLR,2010.0,2,2,0
MMR,IND,2020.0,1,2,-1
HUN,POL,2004.0,2,1,1
IRN,SWE,2001.0,1,6,-5
LUX,HUN,2010.0,1,1,0
BRA,CZE,2000.0,1,1,0
CAN,LBN,2000.0,4,6,-2
EGY,ITA,2008.0,2,3,-1
BEN,BFA,2012.0,2,2,0
HRV,POL,1999.0,1,1,0
PRT,BLR,2004.0,1,3,-2
CAN,SYR,2010.0,1,4,-3
ITA,DZA,2001.0,1,4,-3
IND,PAK,2001.0,4,3,1
KAZ,KOR,2016.0,1,3,-2
TWN,MEX,2011.0,1,2,-1
THA,SWE,2005.0,1,5,-4
MAR,CHE,1998.0,2,1,1
KEN,NGA,2007.0,3,2,1
IRL,ESP,1997.0,1,1,0
GRC,KEN,2008.0,2,1,1
BIH,SVN,2017.0,2,2,0
LAO,THA,2008.0,1,3,-2
ZWE,BWA,2012.0,3,1,2
IND,KEN,2003.0,3,3,0
NOR,ZAF,1999.0,2,2,0
FIN,THA,2013.0,2,5,-3
LAO,FRA,2022.0,2,2,0
MEX,TUR,2011.0,1,1,0
AUS,GMB,2023.0,1,1,0
ISR,PRT,2011.0,4,1,3
PER,CHL,2009.0,2,1,1
KOR,SWE,2008.0,2,3,-1
LTU,CHE,2017.0,1,3,-2
EGY,CZE,2002.0,1,1,0
CHL,ROU,2009.0,1,1,0
OMN,NLD,2007.0,1,1,0
BEN,DEU,2008.0,1,3,-2
ROU,NOR,2009.0,2,2,0
NOR,ROU,2013.0,1,1,0
SWE,KWT,2006.0,1,1,0
TUR,MEX,2011.0,1,1,0
KEN,NLD,2005.0,2,3,-1
FRA,JOR,2021.0,1,1,0
TUN,CHE,2012.0,2,1,1
CRI,BRA,2009.0,1,2,-1
QAT,KWT,2018.0,1,2,-1
BIH,SVN,2016.0,1,3,-2
HUN,RUS,2011.0,1,4,-3
CHN,CMR,2011.0,2,2,0
IRL,ARG,2017.0,1,1,0
NGA,PAK,2018.0,1,5,-4
LTU,FIN,2012.0,2,1,1
TUR,SAU,2008.0,2,2,0
CHN,SVN,2023.0,3,2,1
HUN,MAR,2020.0,1,2,-1
JPN,ARE,2004.0,1,1,0
ARG,BOL,2021.0,2,1,1
BRA,ECU,2007.0,1,1,0
TUR,FIN,2015.0,5,3,2
VNM,TWN,2002.0,1,1,0
KOR,ISR,2000.0,2,1,1
PER,ITA,2021.0,2,2,0
NER,GIN,2021.0,1,1,0
CIV,BEN,2022.0,2,1,1
TWN,BGD,2010.0,1,1,0
CAN,SVN,2021.0,3,4,-1
ARG,ECU,2009.0,1,1,0
SRB,UKR,2011.0,1,1,0
SYR,EGY,2015.0,3,1,2
BWA,NOR,1998.0,1,1,0
NGA,OMN,2014.0,1,1,0
CHL,SWE,2000.0,2,4,-2
VNM,KHM,2011.0,2,1,1
EGY,NLD,2002.0,2,3,-1
NOR,ISL,2006.0,2,6,-4
BEL,BGR,1999.0,2,7,-5
PRT,POL,2001.0,2,3,-1
ARE,POL,2017.0,1,1,0
TUR,AZE,1997.0,2,3,-1
ARE,FIN,2001.0,1,1,0
EGY,NOR,2007.0,2,1,1
AUT,KEN,2019.0,2,2,0
CAN,UKR,2015.0,1,4,-3
SVN,SVK,2023.0,1,6,-5
CHE,CMR,2018.0,1,1,0
ZAF,CIV,2012.0,1,2,-1
CHE,JOR,2018.0,1,2,-1
CHN,SVN,2010.0,1,1,0
CAN,ISL,2018.0,3,1,2
BRB,JAM,2015.0,4,2,2
TUR,AUS,2003.0,1,1,0
JOR,PSE,2010.0,3,1,2
ITA,CIV,2013.0,2,1,1
IRL,KOR,2000.0,1,1,0
DEU,BEN,2004.0,1,1,0
PHL,HKG,2014.0,2,1,1
VEN,COL,2006.0,2,6,-4
EGY,TWN,2013.0,1,1,0
AUT,SVN,2006.0,3,2,1
MYS,UZB,2007.0,2,1,1
OMN,TUN,2002.0,1,1,0
SRB,CHE,2003.0,3,2,1
BEL,GIN,2016.0,1,1,0
PHL,NLD,2017.0,4,2,2
ARM,COL,2008.0,2,1,1
MEX,HUN,2011.0,1,2,-1
THA,DNK,2007.0,1,1,0
IRQ,SYR,2021.0,1,1,0
DEU,CRI,2008.0,1,1,0
IRN,GHA,2019.0,2,2,0
RWA,BEL,2017.0,2,1,1
KAZ,KOR,2018.0,1,8,-7
RWA,NLD,2013.0,1,3,-2
BLR,AUS,2016.0,1,1,0
DEU,IRN,2024.0,1,1,0
SWE,HKG,2005.0,2,3,-1
BEL,GEO,2020.0,4,2,2
UGA,IDN,2008.0,1,1,0
RUS,HRV,2017.0,1,2,-1
SVN,NOR,2015.0,2,1,1
BFA,DEU,2015.0,1,4,-3
IRL,BGR,2022.0,1,2,-1
NOR,EST,2008.0,1,2,-1
POL,IRL,2015.0,3,7,-4
MDA,TUR,2007.0,1,1,0
GRC,RUS,2015.0,2,2,0
BGR,AUT,2009.0,3,2,1
UGA,GHA,2012.0,1,1,0
CHE,GHA,2005.0,1,6,-5
JOR,RUS,2021.0,1,2,-1
CHL,PAN,2014.0,1,1,0
AUT,KOR,2009.0,2,4,-2
PAK,TUR,2012.0,5,3,2
BOL,ECU,2008.0,2,1,1
USA,PNG,2004.0,1,2,-1
ESP,QAT,2023.0,2,1,1
DEU,RWA,2019.0,2,2,0
MMR,MYS,2013.0,2,3,-1
NOR,JOR,2018.0,2,1,1
GIN,FRA,2005.0,2,3,-1
FIN,SGP,2021.0,3,2,1
LUX,BRA,2022.0,2,2,0
MWI,AUS,2018.0,1,2,-1
EST,ITA,2013.0,1,4,-3
NLD,HKG,2024.0,1,1,0
LUX,USA,2009.0,2,6,-4
DNK,VNM,2022.0,1,3,-2
MAC,FRA,2020.0,1,3,-2
IRN,PAK,2021.0,2,1,1
SVK,FIN,2020.0,2,1,1
COD,SWE,2021.0,1,1,0
DNK,KAZ,2020.0,1,1,0
USA,AFG,2021.0,1,10,-9
GEO,BEL,2020.0,2,4,-2
MYS,UGA,2023.0,1,1,0
ERI,IND,2020.0,3,1,2
BHR,IRQ,2016.0,2,2,0
USA,SOM,2023.0,2,1,1
NPL,SGP,2020.0,1,1,0
TWN,ISR,2005.0,1,1,0
TUR,SWE,2005.0,2,6,-4
TWN,PRT,2009.0,1,1,0
SVN,BRA,2019.0,2,3,-1
ETH,FRA,2015.0,1,2,-1
KOR,TUR,2012.0,1,2,-1
NZL,MYS,2005.0,1,2,-1
LUX,KOR,2015.0,1,3,-2
LBN,SAU,2005.0,2,1,1
CYP,NOR,2017.0,1,2,-1
NLD,MWI,2012.0,4,1,3
HUN,VNM,2015.0,1,1,0
KAZ,CZE,2015.0,2,1,1
BGD,FIN,2010.0,1,1,0
CIV,BEL,2015.0,1,3,-2
TUN,ITA,2009.0,2,2,0
NGA,BWA,2011.0,1,1,0
ITA,USA,2024.0,3,4,-1
FIN,HRV,2014.0,1,1,0
CZE,BRA,2014.0,2,8,-6
ZMB,GBR,2006.0,1,3,-2
VNM,CHE,2013.0,1,1,0
AZE,EGY,2014.0,1,1,0
LBY,EGY,2018.0,5,2,3
MEX,PRT,2012.0,3,6,-3
VNM,ITA,2013.0,1,4,-3
BEL,BHR,2022.0,1,1,0
LBY,SRB,2015.0,1,5,-4
FIN,ISL,2019.0,3,2,1
ETH,DNK,2019.0,1,5,-4
IRQ,JPN,2019.0,2,1,1
IND,GRC,2016.0,1,2,-1
HRV,ARE,2020.0,1,1,0
NGA,CAN,2002.0,3,5,-2
ARE,NGA,2022.0,1,4,-3
IRQ,QAT,2022.0,1,1,0
ETH,DEU,1998.0,2,4,-2
ITA,ZAF,1997.0,2,5,-3
ESP,HKG,1998.0,2,1,1
LKA,PAK,2001.0,2,2,0
BGR,SWE,1998.0,2,2,0
FRA,CRI,2006.0,2,2,0
FIN,IDN,2006.0,2,1,1
ZWE,NGA,1999.0,3,2,1
IRL,RUS,2016.0,3,2,1
BGR,POL,2000.0,2,2,0
VUT,AUS,2012.0,1,2,-1
NLD,LKA,1998.0,1,1,0
JPN,MAR,2005.0,1,1,0
DEU,ARM,2014.0,5,2,3
AUS,NAM,2011.0,1,3,-2
CZE,NPL,2020.0,1,2,-1
LSO,GBR,2011.0,2,1,1
ZWE,ZMB,2013.0,1,1,0
IND,MLT,2022.0,1,1,0
CYP,NOR,2016.0,1,1,0
THA,MMR,2023.0,3,6,-3
MEX,PRI,2017.0,1,2,-1
ZWE,CAN,2014.0,2,2,0
SLE,BEL,2016.0,1,1,0
HKG,ISR,2015.0,2,2,0
PRT,MEX,2015.0,1,5,-4
CHE,MEX,2008.0,1,5,-4
SDN,TUR,2016.0,1,1,0
DZA,TUR,2019.0,1,1,0
IND,EGY,2005.0,1,4,-3
ARG,TUR,2017.0,2,8,-6
PRT,PRI,2015.0,1,2,-1
ZAF,ARG,2021.0,1,5,-4
CHL,CHN,2016.0,2,7,-5
MYS,ROU,2016.0,1,1,0
IRL,ARG,2022.0,1,3,-2
NZL,SAU,2015.0,1,3,-2
BGD,BEL,2023.0,1,2,-1
BHR,IDN,2020.0,2,1,1
JAM,GBR,2016.0,3,3,0
BRN,BGD,2015.0,3,1,2
IND,ISL,2020.0,1,1,0
FRA,ETH,2020.0,2,2,0
BTN,IND,2020.0,2,4,-2
LKA,SWE,2013.0,1,4,-3
DEU,KHM,2022.0,2,3,-1
AUS,LBY,2020.0,1,1,0
JPN,AFG,2021.0,2,6,-4
IRN,KOR,2007.0,2,2,0
SAU,MEX,2020.0,1,5,-4
GHA,FRA,2019.0,1,2,-1
GHA,FRA,2021.0,4,2,2
LBN,JPN,2017.0,1,1,0
MYS,ESP,2019.0,1,2,-1
IRN,MAR,2021.0,1,1,0
SVK,FIN,2007.0,1,1,0
IND,VNM,2023.0,2,4,-2
KWT,MYS,2023.0,1,2,-1
KOR,ZAF,2022.0,1,5,-4
JOR,IND,1999.0,1,1,0
RWA,BEL,2022.0,1,5,-4
PRT,IND,2000.0,2,4,-2
MOZ,NOR,2010.0,1,1,0
NPL,THA,2006.0,1,2,-1
SAU,CZE,2020.0,2,3,-1
NLD,NAM,2017.0,1,1,0
USA,FSM,2011.0,2,1,1
AUS,KEN,2012.0,2,3,-1
ZAF,MWI,2009.0,3,2,1
PRI,FRA,2006.0,1,2,-1
TUR,NOR,2007.0,2,2,0
NPL,TWN,2011.0,1,1,0
ITA,COL,2008.0,4,5,-1
PHL,VNM,2004.0,1,1,0
NOR,ARE,2018.0,1,3,-2
BRA,KOR,2009.0,2,1,1
JPN,JOR,2008.0,2,1,1
BEL,NOR,2004.0,2,5,-3
DNK,SGP,2008.0,1,5,-4
ESP,SRB,2007.0,2,7,-5
BIH,ITA,2013.0,1,3,-2
MWI,JPN,2021.0,1,2,-1
ITA,BHR,2020.0,1,1,0
GBR,RWA,2021.0,3,3,0
CAN,HRV,2022.0,2,3,-1
IND,UGA,2020.0,1,1,0
IND,PRI,1998.0,2,1,1
ALB,USA,2015.0,1,4,-3
CMR,ITA,2022.0,1,2,-1
KWT,TUN,2023.0,1,1,0
FRA,PAK,2005.0,1,2,-1
BGR,BEL,2020.0,1,7,-6
IRL,CHL,2015.0,2,2,0
CUB,SWE,2005.0,1,1,0
ZAF,RUS,2015.0,3,4,-1
PRT,BLR,2008.0,1,2,-1
MWI,KEN,2008.0,1,1,0
KWT,GRC,2020.0,1,2,-1
EGY,AUT,2019.0,1,5,-4
UKR,ESP,2009.0,1,2,-1
GBR,CMR,2000.0,2,4,-2
PER,CAN,2001.0,1,1,0
BLR,CAN,1999.0,1,1,0
CYP,ITA,2003.0,1,2,-1
FRA,GIN,2012.0,3,3,0
DNK,GHA,2008.0,1,1,0
SWE,SVN,2009.0,1,2,-1
CYP,DEU,2012.0,1,3,-2
IDN,CHE,2011.0,1,1,0
BGD,HKG,2015.0,1,3,-2
VNM,TUR,2020.0,2,2,0
CAN,HRV,2017.0,1,1,0
NZL,THA,2010.0,3,7,-4
LUX,RUS,2022.0,1,4,-3
KAZ,IRL,2020.0,1,1,0
AUS,ZMB,2014.0,1,3,-2
YEM,CAN,2010.0,1,1,0
IND,DNK,1999.0,1,2,-1
USA,NIC,1999.0,2,3,-1
NPL,PHL,2016.0,1,2,-1
AUT,VNM,2009.0,1,2,-1
GBR,CUB,2013.0,1,1,0
IND,YEM,1999.0,1,1,0
ESP,EGY,2000.0,1,2,-1
UKR,TWN,2000.0,1,1,0
CPV,ESP,2015.0,1,1,0
HKG,VNM,2021.0,1,2,-1
ETH,HUN,2021.0,2,2,0
IRQ,NLD,2021.0,2,2,0
NOR,QAT,2018.0,2,2,0
KOR,DZA,2020.0,1,2,-1
NGA,NER,2020.0,1,7,-6
JOR,ISR,2021.0,1,1,0
CUB,AUT,2017.0,1,1,0
RWA,DEU,2020.0,2,2,0
ESP,PHL,2023.0,1,1,0
NOR,KAZ,2020.0,2,1,1
GTM,ESP,2016.0,2,4,-2
FJI,IND,2018.0,1,4,-3
PHL,GBR,2008.0,1,3,-2
KWT,PAK,2010.0,1,1,0
ESP,MAR,1997.0,1,1,0
GBR,FLK,1998.0,2,2,0
MDV,IND,2020.0,1,4,-3
PAK,OMN,2006.0,1,2,-1
NPL,NZL,2020.0,2,5,-3
NGA,UGA,2017.0,4,3,1
ARM,DEU,2014.0,2,5,-3
BEL,SAU,1998.0,1,3,-2
ITA,MOZ,2021.0,1,4,-3
IRL,KWT,2019.0,1,1,0
DNK,KOR,2014.0,1,12,-11
IND,BTN,2010.0,1,1,0
CHL,CZE,2020.0,1,3,-2
ARM,BRA,2016.0,1,1,0
BEL,COG,2006.0,1,5,-4
PRT,GRC,2022.0,1,3,-2
PAN,BRA,2019.0,4,3,1
BEL,GIN,2022.0,1,3,-2
CYP,RUS,2020.0,1,1,0
TZA,NLD,2023.0,1,2,-1
CHE,NPL,2023.0,1,1,0
COD,KEN,2023.0,2,1,1
MEX,EST,2020.0,1,1,0
TWN,ISR,2002.0,1,2,-1
COL,CHE,2005.0,1,1,0
LSO,ZAF,2004.0,1,3,-2
ZAF,LSO,2006.0,1,1,0
ZAF,CHL,2010.0,2,1,1
KGZ,GBR,2005.0,1,1,0
TUR,SRB,2003.0,1,1,0
GBR,CIV,2000.0,1,1,0
IRL,CHL,2001.0,1,1,0
LVA,ESP,2017.0,1,1,0
BGR,UKR,2016.0,1,1,0
DOM,USA,2002.0,1,1,0
ESP,BOL,2000.0,1,1,0
LBY,GBR,2004.0,2,3,-1
AUT,BGR,1998.0,1,1,0
SWE,ARE,2012.0,1,2,-1
SEN,MRT,2002.0,1,1,0
GMB,USA,2009.0,2,2,0
HKG,CHE,2005.0,3,1,2
SWE,HKG,2002.0,1,1,0
GEO,ITA,2007.0,1,4,-3
GRC,IRL,2011.0,2,2,0
HKG,DNK,2007.0,1,2,-1
ITA,LTU,2003.0,2,2,0
KWT,BHR,2023.0,2,2,0
SGP,AUT,2001.0,2,2,0
SRB,AUT,2009.0,2,4,-2
MAR,TWN,2007.0,1,1,0
SRB,TUR,2006.0,1,4,-3
LSO,USA,2015.0,1,3,-2
MYS,CHE,2011.0,1,1,0
OMN,LBY,2012.0,1,1,0
SAU,SWE,2007.0,1,1,0
VNM,DEU,1999.0,1,1,0
MWI,CAN,2010.0,1,2,-1
LTU,RUS,2000.0,1,2,-1
CAN,PHL,2009.0,1,2,-1
GRC,PRT,2020.0,1,3,-2
IRL,THA,2014.0,1,2,-1
ISL,ESP,2018.0,2,1,1
DEU,UGA,2011.0,1,1,0
PER,GBR,2013.0,5,8,-3
OMN,NZL,2006.0,1,1,0
ZAF,SYC,2013.0,1,1,0
CRI,DEU,2011.0,2,1,1
RUS,AGO,2017.0,1,1,0
TUR,TKM,2017.0,2,1,1
SWE,SDN,2011.0,1,1,0
PRT,ROU,2009.0,3,3,0
PRT,AUT,2013.0,1,4,-3
LVA,SWE,2005.0,1,5,-4
GHA,KOR,2016.0,1,2,-1
ZAF,VNM,2022.0,1,1,0
ZMB,NLD,2016.0,1,1,0
PRT,ECU,2020.0,1,1,0
CMR,GHA,2021.0,1,4,-3
GHA,NLD,2014.0,2,5,-3
SVN,BRA,2021.0,1,2,-1
URY,PER,2020.0,1,2,-1
MLI,GBR,2022.0,1,1,0
SAU,KWT,2022.0,1,3,-2
DZA,CZE,2023.0,1,1,0
OMN,SAU,2023.0,2,4,-2
BEL,COG,2023.0,1,1,0
NLD,KEN,2001.0,2,3,-1
PRT,HRV,2012.0,2,2,0
GRC,ROU,2005.0,1,4,-3
EGY,NLD,2005.0,2,3,-1
CAN,EST,2001.0,1,1,0
ISR,CZE,2006.0,1,1,0
MYS,NGA,1998.0,1,1,0
MLI,SEN,1999.0,1,2,-1
ESP,ARE,2010.0,1,1,0
FRA,MUS,2020.0,2,1,1
DEU,MKD,2000.0,2,4,-2
SVK,AUS,2002.0,1,1,0
URY,AUS,2006.0,1,3,-2
DEU,MNG,2008.0,1,1,0
EGY,RUS,2002.0,2,1,1
GBR,FJI,2023.0,1,2,-1
PRT,CUB,2015.0,1,1,0
TUR,ESP,2001.0,1,1,0
GBR,BRB,2015.0,1,2,-1
SWE,TZA,2010.0,1,1,0
BEL,IRN,2003.0,2,2,0
LBY,AUS,2007.0,1,1,0
AUS,BWA,2015.0,1,2,-1
GBR,KAZ,1998.0,1,1,0
NGA,SAU,1998.0,2,2,0
CHN,PER,2008.0,1,1,0
VNM,THA,2005.0,1,1,0
MAR,JPN,2005.0,1,1,0
FIN,IRL,2012.0,2,4,-2
ESP,NGA,2010.0,1,1,0
RUS,LTU,2023.0,1,2,-1
SGP,AUT,2014.0,2,5,-3
GHA,NLD,2008.0,2,1,1
TZA,UGA,2017.0,1,6,-5
AUS,MKD,2015.0,1,1,0
DEU,PRI,2002.0,1,1,0
BLR,BGR,2013.0,1,1,0
ARM,IRN,2010.0,1,5,-4
SDN,EGY,2015.0,1,1,0
TWN,TUR,2013.0,1,1,0
ITA,JOR,2012.0,1,1,0
KOR,MAR,2021.0,1,1,0
IDN,CZE,2009.0,1,3,-2
CZE,IDN,2012.0,1,1,0
DZA,FIN,2019.0,1,1,0
TTO,JAM,2009.0,2,6,-4
CZE,ZAF,2014.0,1,1,0
LVA,ITA,2009.0,1,1,0
USA,GLP,2017.0,2,1,1
JPN,TUR,2023.0,2,3,-1
ETH,FRA,2014.0,1,2,-1
SAU,PRT,2016.0,1,5,-4
CAF,FRA,2018.0,1,1,0
ISR,BGR,1999.0,1,2,-1
CHL,CUB,2005.0,1,2,-1
FRA,HKG,2006.0,2,3,-1
CHN,TUN,2022.0,1,5,-4
HUN,FIN,2020.0,2,1,1
NLD,CRI,2021.0,2,3,-1
IRL,QAT,2023.0,1,3,-2
FSM,USA,2015.0,2,3,-1
THA,BGD,2007.0,2,2,0
DNK,NPL,2000.0,1,1,0
AUT,BGR,1999.0,1,4,-3
DEU,ECU,2010.0,2,1,1
BEL,PRY,2016.0,1,1,0
SWE,CHL,1999.0,2,1,1
LVA,FRA,2003.0,2,1,1
ROU,SWE,2011.0,3,4,-1
CYP,DEU,2005.0,1,2,-1
SWE,BLR,2005.0,1,3,-2
PRT,DEU,1999.0,12,11,1
USA,PRT,2006.0,57,40,17
AUS,GBR,2012.0,430,734,-304
NLD,PRT,2010.0,22,19,3
CAN,USA,2022.0,1421,1468,-47
KOR,USA,2013.0,833,1070,-237
ESP,VEN,2018.0,19,30,-11
FRA,CHE,2006.0,249,198,51
USA,CAN,2011.0,1595,1748,-153
ESP,USA,2006.0,324,373,-49
CAN,USA,2018.0,2119,1678,441
USA,GBR,2014.0,1767,1897,-130
USA,CAN,2009.0,1461,1656,-195
CAN,USA,2017.0,2136,1603,533
HKG,CHN,2010.0,745,382,363
USA,AUS,2013.0,777,544,233
ZAF,NLD,2019.0,33,27,6
USA,PSE,2016.0,8,6,2
USA,CHE,2009.0,431,438,-7
SWE,RUS,2006.0,18,25,-7
DNK,HUN,2012.0,4,3,1
PRT,SAU,2014.0,5,1,4
CAN,BEL,2012.0,29,33,-4
AUS,GBR,2002.0,430,457,-27
USA,JPN,2016.0,1012,883,129
USA,JPN,2018.0,880,896,-16
CHN,GBR,2021.0,613,809,-196
GBR,USA,2006.0,1446,1497,-51
CHE,USA,2011.0,435,572,-137
ARG,GBR,2004.0,16,15,1
DEU,USA,2003.0,1373,1310,63
BEL,GBR,2007.0,85,65,20
AUS,GBR,2005.0,375,443,-68
LKA,USA,2009.0,15,9,6
HKG,CHN,2006.0,277,308,-31
NOR,SWE,2012.0,63,75,-12
BEL,DEU,2013.0,104,100,4
GBR,USA,2010.0,1767,1657,110
LBN,USA,2006.0,32,26,6
BRA,USA,2006.0,299,311,-12
USA,BRA,2007.0,349,338,11
ESP,SAU,2015.0,5,4,1
FRA,TUN,2004.0,72,36,36
HKG,USA,2006.0,108,81,27
CAN,CHN,2007.0,160,147,13
ESP,DNK,2007.0,17,18,-1
USA,COL,2009.0,81,73,8
FRA,ISR,2007.0,17,23,-6
DEU,CHE,2003.0,482,333,149
AUS,HKG,2018.0,42,48,-6
CAN,SWE,2019.0,46,46,0
GBR,CHE,2016.0,296,260,36
DEU,ZAF,2009.0,26,19,7
CHN,USA,2008.0,1562,1159,403
DEU,USA,2013.0,1362,1301,61
SWE,GBR,2009.0,136,135,1
ISR,ESP,2019.0,14,11,3
PRT,FRA,2010.0,38,45,-7
USA,GBR,2001.0,1453,1787,-334
IRL,GBR,2002.0,181,251,-70
USA,GBR,2015.0,1808,1889,-81
ZAF,AUS,2016.0,43,35,8
FRA,GRC,2014.0,35,45,-10
AUS,ISR,2018.0,13,14,-1
IND,USA,2002.0,634,340,294
DEU,GBR,2016.0,832,699,133
CHE,DEU,2012.0,499,669,-170
ESP,GBR,2013.0,410,300,110
BEL,GBR,2020.0,150,195,-45
CHE,USA,2021.0,542,593,-51
CHN,HKG,2012.0,726,717,9
SWE,GBR,2011.0,115,158,-43
GBR,AUS,2009.0,627,440,187
USA,IND,2010.0,676,1007,-331
IND,USA,2012.0,997,829,168
USA,FRA,2020.0,740,848,-108
NLD,KOR,2006.0,5,2,3
GBR,DEU,2015.0,687,736,-49
JPN,IDN,2005.0,47,5,42
BRA,USA,2010.0,390,391,-1
USA,GBR,2008.0,1540,1523,17
POL,GBR,2012.0,79,62,17
NLD,DEU,2003.0,180,204,-24
JOR,GBR,2003.0,5,7,-2
USA,RUS,2018.0,230,223,7
AUS,SGP,2008.0,51,58,-7
GBR,ESP,2016.0,304,567,-263
PHL,CHN,2005.0,2,2,0
BEL,COG,2018.0,10,3,7
COD,BEL,2022.0,5,16,-11
TUN,SAU,2013.0,45,5,40
AUT,DEU,2014.0,323,362,-39
FRA,CMR,2006.0,14,18,-4
BEL,ARG,2019.0,4,7,-3
EGY,RUS,2008.0,3,1,2
CAN,GBR,2020.0,456,494,-38
JPN,TWN,2017.0,54,69,-15
FRA,RUS,2020.0,72,54,18
DEU,NLD,2018.0,333,379,-46
DEU,UKR,2004.0,26,46,-20
VIR,USA,2010.0,6,1,5
NLD,HUN,2015.0,11,7,4
JPN,CHN,2009.0,456,298,158
GBR,SGP,2012.0,118,77,41
CHN,USA,2015.0,3092,3179,-87
TWN,CHN,2012.0,176,100,76
USA,GBR,2004.0,1297,1603,-306
CAN,USA,2016.0,2093,1590,503
USA,TWN,2003.0,321,216,105
ESP,MEX,2009.0,120,124,-4
AUS,PNG,2012.0,13,4,9
PNG,AUS,2017.0,14,9,5
PNG,AUS,2022.0,7,7,0
ITA,DEU,2003.0,166,161,5
RUS,USA,2007.0,221,190,31
CHN,JPN,2003.0,289,331,-42
KOR,USA,2003.0,617,669,-52
POL,AUT,2008.0,11,10,1
MAR,GBR,2009.0,1,1,0
PER,ESP,2011.0,12,11,1
USA,BEL,2011.0,148,134,14
ESP,DEU,2012.0,236,185,51
HKG,AUS,2003.0,28,35,-7
PRT,ESP,2016.0,86,138,-52
PRT,ESP,2018.0,97,121,-24
USA,NLD,2007.0,275,309,-34
ESP,USA,2023.0,276,230,46
CHE,USA,2009.0,438,431,7
AUT,DEU,2015.0,304,366,-62
GBR,AUT,2021.0,124,85,39
GBR,AUT,2009.0,44,57,-13
NLD,VNM,2005.0,3,3,0
VNM,NLD,2007.0,4,4,0
USA,IND,2006.0,458,722,-264
AUT,JPN,2009.0,11,7,4
CHN,USA,2001.0,784,457,327
FIN,AUS,2008.0,13,5,8
AUS,FIN,2012.0,15,14,1
SWE,USA,2010.0,224,231,-7
USA,CHN,2012.0,2515,2442,73
KOR,AUS,2012.0,31,18,13
NZL,DEU,2007.0,25,27,-2
USA,DEU,2017.0,1239,1359,-120
GBR,THA,2012.0,83,36,47
USA,VNM,2019.0,56,24,32
USA,DEU,2018.0,1289,1268,21
USA,DEU,2022.0,1031,999,32
ESP,BEL,2008.0,45,27,18
CZE,USA,2012.0,52,47,5
DEU,AUT,2012.0,327,286,41
IND,ARE,2010.0,18,1,17
NLD,MWI,2004.0,1,3,-2
GBR,RUS,2008.0,33,46,-13
FRA,GRC,2004.0,32,18,14
ITA,GBR,1998.0,203,135,68
GBR,FRA,2010.0,442,390,52
FRA,DEU,2012.0,386,353,33
FRA,DZA,2012.0,133,55,78
RWA,NGA,2018.0,3,3,0
KEN,NZL,2010.0,1,1,0
ISR,PSE,2005.0,19,8,11
NLD,DEU,2013.0,263,255,8
BLR,IRN,2009.0,3,1,2
BGD,USA,2000.0,22,6,16
USA,BGD,2002.0,18,17,1
FRA,DEU,2005.0,293,271,22
DEU,DNK,2004.0,55,50,5
DNK,ZAF,2011.0,5,3,2
ISR,CAN,2007.0,56,34,22
GBR,THA,2005.0,71,19,52
FRA,CIV,2016.0,65,19,46
BLR,RUS,2020.0,14,18,-4
BEL,FRA,2019.0,221,259,-38
SAU,KWT,2010.0,6,6,0
NGA,ZAF,2014.0,52,33,19
FIN,JPN,2016.0,16,13,3
CHN,HKG,2002.0,252,262,-10
CHN,USA,2004.0,909,720,189
USA,BRA,2020.0,452,790,-338
NZL,CHN,2008.0,5,5,0
BGD,JPN,2011.0,48,73,-25
JPN,IND,2015.0,98,92,6
CHN,TWN,2014.0,147,150,-3
NPL,GBR,2011.0,2,4,-2
USA,JPN,2017.0,867,930,-63
GBR,GRC,2020.0,181,217,-36
ESP,CHE,2006.0,32,37,-5
AUS,USA,2010.0,571,714,-143
GBR,CHN,2018.0,621,477,144
DEU,CHN,2012.0,250,292,-42
DEU,IND,2015.0,140,162,-22
JPN,DEU,1998.0,104,115,-11
ESP,FRA,2014.0,319,217,102
HUN,NLD,2001.0,9,3,6
BRA,CAN,2007.0,51,38,13
SGP,IND,2011.0,36,54,-18
IND,TWN,2010.0,62,29,33
SGP,CHN,2017.0,376,297,79
GBR,ITA,2002.0,282,286,-4
GBR,NLD,2011.0,230,240,-10
NLD,USA,2012.0,339,362,-23
SAU,EGY,2017.0,249,284,-35
HUN,USA,2013.0,79,68,11
BRA,GBR,2011.0,66,84,-18
GBR,BRA,2012.0,89,72,17
ARG,DEU,2006.0,35,19,16
FRA,CIV,2017.0,57,19,38
CHE,FIN,2020.0,16,20,-4
NGA,GBR,2020.0,78,94,-16
BEL,FRA,2009.0,155,213,-58
DEU,NLD,2016.0,281,334,-53
GBR,DEU,2004.0,385,433,-48
RUS,DEU,2001.0,233,141,92
SAU,MAR,2013.0,1,3,-2
MAR,SAU,2020.0,5,5,0
BRA,PAN,2022.0,3,3,0
BEL,POL,2012.0,14,12,2
CHE,DEU,1997.0,191,243,-52
DEU,AUT,2005.0,252,167,85
JOR,ARE,2007.0,6,5,1
USA,GRC,2009.0,133,118,15
AUS,IRL,2011.0,35,43,-8
AUS,NLD,2011.0,55,73,-18
ESP,USA,2010.0,442,441,1
ARG,ESP,2012.0,85,96,-11
USA,KOR,2000.0,500,414,86
ESP,FRA,2008.0,189,186,3
USA,CHE,2011.0,572,435,137
GBR,GRC,2007.0,153,108,45
FRA,ITA,2001.0,206,198,8
USA,FRA,1999.0,527,790,-263
ESP,SVN,2013.0,6,1,5
DEU,DNK,2008.0,76,50,26
NLD,CAN,2011.0,49,70,-21
USA,PRI,2013.0,96,216,-120
USA,RUS,2017.0,212,186,26
NLD,AUT,2008.0,17,10,7
FRA,TUR,2017.0,25,21,4
GBR,AUS,2011.0,619,504,115
CHN,SWE,2010.0,79,56,23
USA,CHN,2002.0,548,914,-366
SWE,CHE,2012.0,69,50,19
FRA,GBR,2003.0,395,387,8
THA,JPN,2007.0,44,91,-47
NOR,FIN,2019.0,20,23,-3
KOR,VNM,2011.0,26,5,21
IRL,RUS,2006.0,4,6,-2
GBR,DEU,2008.0,405,708,-303
SAU,EGY,2018.0,309,320,-11
USA,IRN,2007.0,42,64,-22
IRN,USA,2008.0,105,41,64
FIN,DEU,2015.0,56,56,0
PRI,USA,2003.0,78,92,-14
CHN,GBR,2009.0,187,207,-20
USA,UGA,2010.0,20,17,3
CHN,IND,2015.0,29,85,-56
CHN,HKG,2005.0,372,265,107
GBR,KEN,2020.0,37,40,-3
KEN,USA,2008.0,27,40,-13
ITA,AUT,2009.0,48,29,19
BEL,AUT,2010.0,9,10,-1
ESP,DEU,2005.0,78,128,-50
NLD,CHE,2013.0,81,76,5
KOR,AUS,2005.0,15,20,-5
POL,ITA,2009.0,15,14,1
GBR,ESP,2017.0,372,538,-166
DEU,POL,2010.0,71,76,-5
SVK,CZE,2005.0,27,23,4
USA,SWE,2001.0,252,338,-86
GRC,CHE,2004.0,10,10,0
IND,CAN,2008.0,92,47,45
DEU,KEN,2011.0,16,9,7
UKR,ITA,2003.0,5,3,2
USA,KOR,2006.0,793,648,145
SWE,DEU,2004.0,88,101,-13
UKR,GBR,2010.0,100,61,39
CHN,USA,2014.0,2879,2938,-59
GBR,AUT,2011.0,70,61,9
GBR,DEU,2001.0,473,473,0
HUN,USA,2003.0,81,83,-2
TUR,USA,2007.0,199,262,-63
HKG,USA,2010.0,136,128,8
RUS,ITA,2007.0,32,19,13
FRA,SGP,2008.0,17,12,5
ESP,IRL,2008.0,18,13,5
GBR,ITA,2012.0,287,456,-169
CHE,SWE,2007.0,38,35,3
DNK,CAN,2011.0,23,29,-6
NZL,CHN,2014.0,28,26,2
DEU,SWE,2017.0,187,143,44
DEU,CHE,2013.0,660,464,196
VNM,JPN,2003.0,8,12,-4
GBR,ZAF,2008.0,79,87,-8
CHN,TWN,2015.0,138,214,-76
BEL,NLD,2009.0,118,136,-18
MYS,USA,2004.0,9,23,-14
DEU,ESP,2007.0,158,106,52
JPN,KOR,2017.0,161,113,48
NLD,BEN,2016.0,4,4,0
IND,USA,2005.0,676,397,279
GBR,RUS,2015.0,67,43,24
GBR,NLD,2019.0,433,359,74
NLD,ITA,2004.0,48,53,-5
USA,ITA,2012.0,453,632,-179
TZA,BEL,2015.0,2,4,-2
GBR,IND,2003.0,94,95,-1
NLD,USA,2005.0,271,253,18
USA,LBN,1998.0,21,7,14
BRA,AUS,2022.0,53,26,27
POL,DEU,2008.0,94,54,40
ITA,GBR,2020.0,574,507,67
TWN,USA,1998.0,121,286,-165
AUT,DEU,2008.0,203,256,-53
ITA,USA,2016.0,677,419,258
AUT,SVK,2015.0,7,14,-7
USA,TUR,2013.0,281,287,-6
FIN,KOR,2010.0,3,4,-1
POL,FRA,2014.0,32,42,-10
GBR,FRA,2006.0,336,383,-47
POL,FRA,2008.0,38,34,4
FRA,POL,2016.0,36,37,-1
UKR,POL,2005.0,20,7,13
GBR,SGP,2002.0,52,44,8
JPN,CHN,2011.0,481,390,91
PRT,BRA,2012.0,119,59,60
BRA,PRT,2014.0,111,125,-14
USA,IND,2023.0,518,918,-400
USA,ITA,2005.0,400,476,-76
DEU,FRA,1999.0,240,248,-8
FRA,DEU,2002.0,342,301,41
CHN,TWN,2008.0,84,95,-11
AUS,IDN,2021.0,92,40,52
ARG,GBR,2014.0,21,17,4
POL,DEU,2004.0,70,45,25
USA,RUS,2022.0,99,145,-46
AUS,USA,2006.0,417,505,-88
JPN,FRA,2004.0,76,80,-4
ITA,GRC,2011.0,15,30,-15
MYS,SGP,2000.0,7,7,0
CHN,SGP,2005.0,92,104,-12
CHN,SWE,2000.0,19,18,1
SWE,BGR,2009.0,3,1,2
CAN,DEU,2014.0,206,184,22
USA,CAN,2021.0,1653,1850,-197
HUN,DEU,2013.0,46,37,9
GRC,CAN,2002.0,10,15,-5
CAN,NZL,2008.0,39,30,9
MEX,ESP,2016.0,178,204,-26
ESP,FRA,2004.0,117,134,-17
ESP,USA,2000.0,335,299,36
USA,FRA,2007.0,703,787,-84
IRN,IND,2004.0,1,13,-12
GBR,AUS,2019.0,634,611,23
BRA,ESP,2008.0,65,41,24
KOR,CHN,2017.0,226,126,100
CHN,IND,2014.0,26,61,-35
IND,MEX,2007.0,3,4,-1
BRA,IND,2014.0,13,17,-4
USA,CHN,2005.0,808,958,-150
TWN,DEU,2009.0,21,15,6
PAK,SAU,2017.0,96,65,31
SAU,ARE,2019.0,34,17,17
IRN,CAN,2007.0,62,72,-10
CIV,FRA,2021.0,13,34,-21
CHN,TWN,2001.0,76,112,-36
CAN,ZAF,2019.0,20,46,-26
GRC,USA,2007.0,95,148,-53
GBR,AUS,2021.0,659,563,96
DEU,IND,2008.0,80,112,-32
BRA,DEU,2002.0,48,47,1
AUS,CHE,2017.0,72,59,13
ZAF,USA,2003.0,129,74,55
BRA,ESP,2004.0,26,32,-6
DEU,CHN,2005.0,124,124,0
ITA,ESP,2003.0,89,91,-2
ITA,CHE,2020.0,296,184,112
ISL,SWE,2004.0,9,12,-3
ESP,SWE,2011.0,47,38,9
SWE,ESP,2012.0,30,46,-16
GBR,JPN,2003.0,142,153,-11
BEL,MAR,2007.0,10,1,9
ISR,CAN,2020.0,78,64,14
SWE,AUT,2007.0,10,5,5
IRL,USA,2002.0,104,88,16
AUT,USA,2005.0,103,88,15
NLD,USA,1997.0,185,179,6
USA,NLD,1999.0,197,262,-65
IND,AUS,2000.0,24,24,0
AUS,USA,2000.0,581,426,155
USA,EGY,2015.0,136,121,15
IND,SAU,2013.0,105,23,82
POL,FRA,2004.0,36,24,12
CZE,FRA,2010.0,28,27,1
USA,SWE,2008.0,175,214,-39
NZL,IND,1998.0,4,3,1
IND,TWN,2006.0,43,17,26
CMR,FRA,2007.0,12,22,-10
BEL,CHE,2008.0,25,24,1
MYS,BGD,2021.0,61,23,38
MEX,AUS,2012.0,14,11,3
ESP,VEN,2017.0,25,29,-4
GBR,USA,2000.0,1535,1292,243
AUS,CHN,2020.0,619,460,159
ESP,CAN,2010.0,47,58,-11
GBR,CHE,2017.0,321,258,63
CHE,USA,2019.0,578,581,-3
SRB,USA,2001.0,41,29,12
TUR,FIN,2005.0,5,3,2
GHA,ZAF,2007.0,1,2,-1
USA,NGA,2014.0,39,51,-12
SWE,LTU,2007.0,9,5,4
JAM,AUS,2020.0,1,2,-1
CAN,GBR,2007.0,302,319,-17
GBR,KOR,1999.0,19,15,4
DEU,KOR,2007.0,30,22,8
JPN,DNK,2007.0,8,11,-3
NLD,ITA,2008.0,54,80,-26
RUS,SWE,2002.0,47,31,16
PER,ARG,2023.0,4,2,2
ITA,AUS,2010.0,47,34,13
SWE,DEU,2008.0,91,123,-32
TUR,NLD,2017.0,23,26,-3
BRA,CHE,2009.0,19,13,6
UKR,GBR,2000.0,21,3,18
DEU,GBR,2018.0,726,807,-81
IND,GBR,2011.0,149,155,-6
ESP,FRA,2015.0,324,218,106
JPN,TWN,2016.0,58,71,-13
GRC,FRA,2012.0,37,27,10
ETH,USA,2009.0,12,9,3
FRA,CAN,2007.0,267,220,47
RUS,UKR,2020.0,84,95,-11
USA,HUN,2011.0,68,74,-6
DEU,GBR,2017.0,824,766,58
HKG,CHN,2023.0,1045,1018,27
EGY,JPN,2004.0,18,29,-11
PRT,ESP,2017.0,111,123,-12
ISR,ZAF,2007.0,2,2,0
USA,DEU,2016.0,1309,1373,-64
AUS,NOR,2013.0,23,6,17
CHE,ITA,2014.0,119,273,-154
AUT,ESP,2013.0,15,31,-16
RUS,NLD,2023.0,18,4,14
SGP,IDN,2010.0,4,4,0
USA,SWE,2014.0,238,233,5
EGY,SAU,2012.0,267,152,115
SAU,EGY,2016.0,267,287,-20
JPN,RUS,2009.0,19,16,3
ARG,CAN,2005.0,13,12,1
SGP,AUT,2012.0,5,6,-1
RWA,UGA,2017.0,5,3,2
DEU,IND,2001.0,45,80,-35
ROU,ESP,2006.0,3,2,1
UKR,USA,2006.0,37,21,16
CAN,DEU,2008.0,126,180,-54
ITA,USA,2017.0,693,451,242
DNK,GBR,2001.0,70,63,7
SWE,AUS,2015.0,44,65,-21
USA,PAK,2016.0,80,119,-39
IND,CAN,2004.0,73,28,45
DEU,THA,2017.0,29,19,10
TWN,JPN,2007.0,28,48,-20
DZA,SAU,2019.0,15,8,7
JPN,KOR,2018.0,128,129,-1
SGP,CHN,2018.0,430,307,123
CMR,CAN,2008.0,5,5,0
USA,CHN,1997.0,328,276,52
FRA,BRA,1999.0,72,54,18
USA,AUS,2003.0,515,548,-33
NZL,NLD,1998.0,9,7,2
DEU,NLD,2017.0,322,346,-24
USA,THA,2007.0,201,111,90
GBR,SWE,2013.0,181,112,69
GBR,GHA,2012.0,19,8,11
DEU,UKR,2015.0,17,36,-19
KEN,USA,2004.0,25,30,-5
USA,KEN,2007.0,37,32,5
NGA,ITA,2008.0,2,4,-2
CAN,CHE,2009.0,99,95,4
AUS,IDN,2009.0,31,7,24
LKA,THA,2012.0,3,1,2
CHN,SGP,2012.0,241,222,19
AUS,IRL,2009.0,27,35,-8
VEN,BRA,2021.0,11,7,4
ZAF,CAN,2006.0,18,14,4
ITA,FRA,2013.0,380,236,144
USA,AUT,2013.0,118,149,-31
THA,GBR,1998.0,10,22,-12
GBR,THA,2002.0,46,20,26
KOR,CAN,2009.0,49,37,12
AUS,PHL,2017.0,11,20,-9
JPN,POL,2012.0,18,6,12
ITA,CHE,1999.0,83,77,6
IRL,SWE,2003.0,7,3,4
AUS,DNK,2006.0,14,15,-1
ITA,AUT,2011.0,38,42,-4
USA,CAN,2019.0,1960,2105,-145
JPN,AUS,2011.0,81,62,19
DEU,CAN,2019.0,189,182,7
TWN,USA,2007.0,237,353,-116
DNK,GBR,2004.0,60,65,-5
KOR,AUS,1997.0,3,4,-1
GRC,DEU,2009.0,54,45,9
GEO,USA,2021.0,223,212,11
AUT,USA,2012.0,129,136,-7
PER,GBR,2007.0,5,3,2
GBR,ITA,2005.0,193,215,-22
PER,FRA,2009.0,12,3,9
ITA,CHN,1998.0,17,10,7
PAN,USA,2017.0,15,20,-5
ESP,MAR,2008.0,13,14,-1
IND,AUS,2006.0,47,28,19
GRC,CHE,2014.0,40,14,26
SWE,IRN,2006.0,7,8,-1
NGA,CAN,2008.0,3,3,0
SWE,FIN,2013.0,50,51,-1
HUN,AUT,2018.0,30,12,18
GBR,IRL,2006.0,208,171,37
GBR,GRC,1998.0,81,42,39
HUN,GBR,2013.0,44,33,11
USA,JOR,2006.0,40,14,26
IND,ESP,2009.0,17,11,6
ITA,EST,2010.0,1,1,0
SAU,CHN,2013.0,12,25,-13
GBR,BEL,2003.0,74,75,-1
BEL,UGA,2009.0,1,2,-1
GBR,NOR,2009.0,60,32,28
NOR,GBR,2014.0,55,85,-30
PRT,ITA,2015.0,36,26,10
CAN,NZL,2014.0,43,40,3
CZE,USA,2005.0,56,45,11
JPN,CHE,2010.0,42,28,14
ARG,ITA,2007.0,20,18,2
GBR,CHN,2017.0,529,404,125
BRA,CAN,1999.0,26,29,-3
BEL,AUS,2009.0,19,14,5
AUS,MYS,2005.0,19,16,3
ESP,PRI,2010.0,3,7,-4
POL,NLD,2008.0,20,9,11
GBR,JOR,2000.0,10,2,8
JPN,BGD,2018.0,78,89,-11
IND,IRL,2010.0,17,12,5
BRA,IRL,2008.0,5,3,2
AUS,EGY,2006.0,3,2,1
TWN,NLD,2013.0,2,3,-1
GBR,CYP,2010.0,23,6,17
DNK,GBR,2008.0,69,81,-12
USA,CZE,2020.0,51,52,-1
GBR,QAT,2013.0,29,1,28
DEU,NOR,2016.0,82,57,25
UKR,HRV,2017.0,1,2,-1
CAN,BRA,2004.0,43,38,5
TUR,CYP,2020.0,125,112,13
ARG,BRA,2003.0,32,24,8
PRT,GBR,2008.0,52,63,-11
GBR,MEX,2021.0,53,55,-2
USA,THA,2020.0,235,151,84
BRA,ITA,2005.0,24,26,-2
VEN,FRA,2007.0,6,5,1
CHN,KOR,2020.0,157,311,-154
CAN,IRN,2007.0,72,62,10
DEU,CAN,2009.0,174,120,54
BEL,HRV,2010.0,2,1,1
CHE,ARG,2020.0,9,11,-2
FIN,TUR,2022.0,2,15,-13
ARG,SWE,2003.0,9,3,6
SWE,ARG,2009.0,3,1,2
RUS,FRA,2010.0,55,30,25
CHE,POL,2007.0,18,13,5
TWN,CHN,2002.0,128,118,10
NLD,USA,2002.0,337,332,5
BGD,KOR,2007.0,12,7,5
CAN,JPN,2010.0,93,95,-2
FIN,SWE,2012.0,53,50,3
ITA,NLD,2009.0,80,49,31
HUN,CHE,2011.0,23,5,18
FRA,NZL,2002.0,7,7,0
PRT,RUS,2011.0,9,4,5
CHE,AUS,2006.0,45,37,8
SGP,AUS,2021.0,91,109,-18
DEU,IDN,2010.0,22,4,18
PRT,DEU,2007.0,21,23,-2
DEU,PRT,2013.0,32,43,-11
AUS,CHE,2016.0,65,66,-1
JPN,THA,2007.0,91,44,47
CHN,ISR,2013.0,6,10,-4
JPN,DEU,1999.0,114,121,-7
USA,BEL,2009.0,118,154,-36
GBR,USA,2023.0,1016,848,168
AUS,DEU,2007.0,92,125,-33
CHN,GBR,2011.0,214,306,-92
NLD,CHE,2003.0,51,43,8
FRA,GLP,2006.0,20,26,-6
FRA,GLP,2010.0,18,46,-28
USA,AUT,2003.0,128,110,18
IND,CHN,2018.0,232,56,176
DEU,BRA,2003.0,42,48,-6
DEU,TWN,2012.0,22,22,0
USA,DNK,1997.0,99,84,15
ISR,DEU,2010.0,33,29,4
GRC,DEU,2011.0,59,44,15
HKG,TWN,2003.0,10,5,5
OMN,DEU,2007.0,1,1,0
ESP,ARG,1998.0,48,49,-1
FIN,USA,2007.0,69,65,4
PHL,FRA,2004.0,1,2,-1
FRA,PHL,2011.0,2,2,0
PHL,NZL,2012.0,2,3,-1
IRL,DEU,2015.0,48,48,0
GBR,CHN,2022.0,830,547,283
GBR,MLT,2021.0,13,11,2
GBR,MYS,2010.0,112,58,54
DEU,ITA,2003.0,161,166,-5
USA,SYR,2007.0,3,3,0
FRA,LBN,2011.0,57,25,32
BEL,CAN,2010.0,41,48,-7
CHN,CAN,2003.0,103,75,28
IND,KOR,2006.0,79,25,54
NZL,KOR,2009.0,5,1,4
KOR,IND,2014.0,131,189,-58
CHL,USA,2016.0,126,165,-39
JPN,IRN,2015.0,8,13,-5
CHN,HKG,1997.0,80,63,17
AUS,CAN,2016.0,171,191,-20
DEU,SWE,2022.0,187,141,46
GBR,DEU,2014.0,702,729,-27
CAN,NOR,2012.0,14,7,7
CYP,TUR,2013.0,23,50,-27
MEX,ESP,2018.0,161,215,-54
USA,COL,2011.0,94,94,0
DEU,IDN,2006.0,5,3,2
DEU,ESP,1999.0,75,81,-6
CAN,DEU,2004.0,96,143,-47
EGY,CHE,2016.0,6,7,-1
ZAF,USA,2013.0,142,125,17
FRA,NLD,2010.0,123,80,43
AUT,GBR,2017.0,95,80,15
BRA,DEU,2012.0,77,84,-7
IND,PRT,2012.0,37,13,24
ESP,CAN,2006.0,30,26,4
FRA,IRN,1998.0,3,2,1
MEX,ARG,2013.0,14,9,5
SGP,NLD,2006.0,7,4,3
CHN,GBR,2019.0,513,679,-166
GBR,EGY,2013.0,65,22,43
MYS,SGP,2010.0,19,18,1
IND,MYS,2015.0,93,74,19
ITA,GBR,2007.0,287,181,106
POL,NLD,2004.0,11,7,4
IRN,GBR,1999.0,8,30,-22
USA,TUR,2003.0,247,172,75
COL,ARG,2009.0,9,4,5
DEU,ESP,2020.0,247,297,-50
SAU,USA,2019.0,146,352,-206
ZWE,KEN,2010.0,1,1,0
JPN,MYS,2011.0,70,18,52
SWE,LVA,2023.0,2,2,0
IND,GBR,2009.0,159,110,49
IRL,USA,2005.0,83,114,-31
GBR,DNK,1998.0,47,47,0
DNK,FIN,2005.0,7,11,-4
TWN,DEU,2011.0,21,23,-2
CAN,IRL,2008.0,26,32,-6
IRL,AUT,2010.0,11,6,5
AUS,SLB,2014.0,3,6,-3
USA,MEX,2010.0,239,257,-18
MLI,USA,2018.0,7,10,-3
GRC,BEL,2018.0,22,12,10
ESP,CHL,2011.0,78,66,12
USA,MEX,2023.0,164,219,-55
AZE,TUR,2004.0,8,7,1
RUS,DEU,2004.0,198,123,75
ITA,GRC,2009.0,20,25,-5
GBR,ESP,2018.0,427,498,-71
BGD,MYS,2012.0,31,20,11
USA,PRI,2003.0,92,78,14
NLD,THA,2014.0,18,6,12
USA,TWN,2013.0,331,274,57
AUS,HKG,2016.0,45,36,9
USA,JPN,2022.0,615,641,-26
GBR,HKG,2003.0,34,39,-5
ITA,POL,2013.0,20,16,4
GBR,NLD,2009.0,226,216,10
GBR,IRN,2010.0,53,33,20
GBR,ARG,2006.0,15,13,2
TWN,USA,1999.0,165,259,-94
ARG,FRA,2021.0,30,29,1
IRL,USA,1997.0,47,53,-6
FRA,AUS,2008.0,90,60,30
BEL,GRC,2007.0,11,4,7
AUS,CHN,2007.0,59,89,-30
ROU,USA,2001.0,48,21,27
BEL,ZAF,2012.0,7,7,0
CHN,SVK,2017.0,1,1,0
NLD,GBR,2018.0,313,388,-75
ROU,USA,2008.0,20,29,-9
ISR,GBR,2004.0,43,19,24
MEX,CRI,2010.0,3,1,2
ISR,DEU,2006.0,29,32,-3
USA,DNK,2012.0,116,116,0
USA,SAU,2006.0,54,17,37
SWE,PRT,2006.0,4,7,-3
CAN,NZL,2004.0,24,28,-4
CHN,DEU,2013.0,310,286,24
FRA,HUN,2003.0,15,21,-6
DEU,GBR,2022.0,495,705,-210
USA,SGP,2014.0,295,218,77
IND,MYS,2008.0,36,21,15
USA,PHL,2010.0,51,19,32
FRA,GUF,2010.0,25,16,9
GUF,FRA,2011.0,23,26,-3
CIV,FRA,2019.0,17,33,-16
TUR,ITA,2018.0,22,11,11
CHE,ESP,2003.0,32,35,-3
KOR,PHL,2016.0,19,11,8
IRL,BEL,2021.0,16,9,7
NOR,BEL,2009.0,5,6,-1
FRA,DNK,1999.0,26,13,13
DEU,CAN,2011.0,172,170,2
MDA,FRA,2012.0,2,1,1
SGP,GBR,2018.0,115,136,-21
USA,QAT,2012.0,26,16,10
BRA,PRT,2004.0,41,36,5
PHL,JPN,2007.0,18,10,8
NOR,AUS,2020.0,19,23,-4
NLD,LKA,2013.0,3,1,2
POL,BEL,2012.0,12,14,-2
DEU,FIN,2010.0,37,54,-17
KOR,AUT,2009.0,4,2,2
FRA,BEL,2009.0,213,155,58
BEL,FRA,2011.0,200,208,-8
USA,NGA,2008.0,16,26,-10
ESP,IRL,2014.0,30,17,13
IRL,GBR,2012.0,277,203,74
BEL,NLD,2011.0,128,141,-13
CHE,ITA,2001.0,95,97,-2
USA,HUN,2009.0,67,77,-10
TZA,IND,2018.0,5,5,0
GUM,USA,2019.0,11,12,-1
EGY,USA,2012.0,70,131,-61
USA,EGY,2014.0,109,91,18
NZL,CAN,2021.0,39,32,7
SWE,DEU,2014.0,132,157,-25
CHE,DEU,2005.0,298,456,-158
FRA,ITA,2014.0,216,347,-131
CAN,CHN,1999.0,44,68,-24
SWE,IND,2009.0,9,29,-20
AUS,MEX,2019.0,9,16,-7
ISR,TUR,2009.0,6,1,5
HKG,USA,2000.0,87,90,-3
FRA,GBR,2013.0,437,438,-1
GBR,CHN,2016.0,476,378,98
USA,SWE,2004.0,202,259,-57
IRN,THA,2011.0,2,2,0
ITA,JOR,2015.0,3,3,0
MAR,DEU,2012.0,3,2,1
ISR,FRA,2003.0,37,19,18
JPN,GBR,2009.0,131,137,-6
DEU,THA,2018.0,36,18,18
USA,FRA,1998.0,583,676,-93
CHE,NLD,2017.0,86,126,-40
AUS,CHN,1998.0,22,32,-10
DEU,SWE,2016.0,201,144,57
CHN,TWN,2004.0,85,55,30
DZA,SAU,2009.0,4,2,2
SWE,AUS,2008.0,46,29,17
FRA,MDG,2015.0,12,16,-4
OMN,QAT,2012.0,5,1,4
KOR,VNM,2009.0,12,9,3
ZAF,IND,2012.0,20,30,-10
NGA,ITA,2014.0,5,4,1
AUS,BEL,2011.0,30,25,5
NCL,FRA,2000.0,6,10,-4
NGA,DEU,2008.0,11,12,-1
BRA,MOZ,2013.0,8,1,7
ARG,ESP,2005.0,86,54,32
BEL,BGD,2012.0,2,5,-3
IND,CHE,2006.0,20,19,1
ITA,VAT,2019.0,2,3,-1
VAT,ITA,2022.0,3,1,2
ROU,BEL,2012.0,14,5,9
EGY,DEU,2011.0,34,52,-18
DEU,EGY,2015.0,70,49,21
AUS,ISR,2016.0,16,18,-2
NZL,POL,2008.0,1,1,0
JPN,GHA,2001.0,9,1,8
AUT,USA,2002.0,147,135,12
ESP,SWE,2021.0,84,60,24
IRL,USA,2012.0,179,139,40
GRC,ESP,2018.0,17,16,1
MAC,CHN,2019.0,340,97,243
NLD,THA,2004.0,11,3,8
FRA,GAB,2008.0,10,4,6
BEL,CHN,2010.0,22,28,-6
SGP,USA,2007.0,136,163,-27
AUS,CAN,2018.0,198,215,-17
FRA,KOR,2009.0,20,27,-7
POL,AUT,2015.0,11,13,-2
KEN,GBR,2004.0,12,14,-2
GBR,KEN,2007.0,15,13,2
KEN,GBR,2014.0,16,33,-17
SGP,FRA,2004.0,10,6,4
USA,DNK,2002.0,117,147,-30
ITA,USA,2022.0,414,391,23
GBR,ESP,2022.0,447,312,135
IND,AUS,2010.0,90,41,49
AUS,IRN,2013.0,33,120,-87
CZE,CAN,2009.0,12,10,2
NLD,ISR,2010.0,6,6,0
GBR,BEL,2013.0,139,91,48
MOZ,USA,2011.0,5,2,3
GBR,NZL,2018.0,115,107,8
USA,UKR,2006.0,21,37,-16
TUR,USA,2020.0,336,309,27
ITA,ISR,1999.0,10,9,1
USA,CHE,2021.0,593,542,51
NGA,SLE,2020.0,5,1,4
JPN,GBR,2021.0,103,139,-36
RUS,DEU,2008.0,141,126,15
GBR,NLD,2021.0,422,299,123
NLD,GBR,2017.0,388,285,103
SAU,PAK,2023.0,60,72,-12
BRA,ESP,2015.0,106,168,-62
AUS,CAN,2017.0,172,212,-40
ZAF,BEL,2019.0,11,15,-4
ESP,CZE,2004.0,6,1,5
NLD,AUS,2010.0,65,47,18
CAN,BRA,2008.0,36,49,-13
USA,NGA,2015.0,54,48,6
THA,MMR,2022.0,5,6,-1
MAC,CHN,2009.0,12,21,-9
CAN,KEN,2010.0,4,8,-4
GBR,IRL,2010.0,261,220,41
DEU,IRN,2016.0,39,101,-62
KOR,DEU,2020.0,88,61,27
SWE,CAN,2002.0,49,35,14
SWE,ITA,2013.0,31,71,-40
CHE,LIE,2022.0,7,6,1
AUS,NZL,2021.0,154,151,3
DEU,IND,2014.0,115,172,-57
USA,ZAF,2019.0,112,159,-47
DNK,SWE,2013.0,81,66,15
CHN,ESP,2004.0,1,5,-4
HRV,BIH,2007.0,13,11,2
GBR,IRL,2000.0,171,144,27
NER,NGA,2013.0,7,8,-1
BGR,DEU,2007.0,24,22,2
USA,VEN,1997.0,30,30,0
CAN,SGP,2009.0,32,28,4
KOR,VNM,2019.0,136,42,94
ESP,MAR,2004.0,5,7,-2
FRA,TUN,2014.0,150,86,64
BRA,AUS,2018.0,73,34,39
AUS,USA,2023.0,322,253,69
FRA,CHN,1997.0,26,13,13
JPN,KOR,2016.0,142,122,20
JPN,ITA,2019.0,29,26,3
SWE,IND,2011.0,22,36,-14
JPN,TWN,2022.0,58,43,15
DJI,USA,2011.0,1,1,0
FRA,SWE,2013.0,83,43,40
USA,ZAF,2011.0,122,87,35
NLD,NOR,2009.0,29,10,19
DEU,AUS,1998.0,49,49,0
DZA,FRA,2009.0,60,85,-25
DEU,FRA,2007.0,341,271,70
FRA,BRA,2007.0,78,76,2
CHE,POL,1998.0,13,14,-1
MYS,USA,2008.0,23,34,-11
FRA,MEX,2013.0,47,36,11
USA,CHE,2019.0,581,578,3
GBR,UKR,2012.0,56,23,33
FRA,NOR,2003.0,11,8,3
CAN,DNK,2017.0,29,33,-4
CHN,KOR,1999.0,14,13,1
POL,VNM,2021.0,4,5,-1
FRA,FIN,2011.0,19,13,6
IND,CAN,2015.0,131,93,38
ISL,DEU,2020.0,9,6,3
NLD,EGY,2007.0,2,4,-2
GBR,BRA,1997.0,53,32,21
IDN,JPN,2006.0,10,39,-29
USA,SGP,2015.0,285,234,51
AUS,NZL,2009.0,100,168,-68
ITA,THA,2008.0,2,3,-1
NLD,NOR,2011.0,25,14,11
LUX,GBR,2020.0,9,18,-9
UKR,DEU,2007.0,34,32,2
GBR,MYS,2006.0,72,16,56
CAN,BRA,2015.0,66,98,-32
SWE,NOR,2010.0,64,53,11
NZL,GBR,2003.0,90,136,-46
JAM,TTO,2004.0,2,1,1
CAN,ISR,2007.0,34,56,-22
CHN,KOR,2007.0,69,77,-8
POL,IRL,2005.0,7,1,6
USA,IRL,2007.0,120,100,20
GBR,MLT,2009.0,7,6,1
CHE,UGA,2014.0,3,2,1
FRA,CHE,2010.0,289,228,61
ITA,USA,2018.0,664,489,175
DEU,JOR,2010.0,12,14,-2
THA,USA,2007.0,111,201,-90
GBR,IDN,2010.0,18,3,15
LBN,FRA,2010.0,23,42,-19
FRA,NOR,2013.0,31,20,11
BEL,JPN,2008.0,15,14,1
ITA,THA,2001.0,2,1,1
NOR,BEL,2021.0,9,15,-6
BEL,IND,2015.0,20,23,-3
ITA,NZL,2007.0,4,5,-1
ITA,NZL,2020.0,5,6,-1
CHN,JPN,2013.0,359,567,-208
GEO,USA,2011.0,45,39,6
SRB,USA,2015.0,19,25,-6
ZMB,USA,2014.0,14,21,-7
BEL,FRA,2021.0,223,263,-40
NLD,ZAF,1999.0,9,5,4
BEL,CHE,2014.0,45,55,-10
CAN,THA,2005.0,13,4,9
THA,DEU,2008.0,20,27,-7
JOR,QAT,2011.0,3,2,1
GBR,CIV,2017.0,1,2,-1
USA,SRB,2006.0,41,40,1
USA,URY,2009.0,15,19,-4
JPN,DEU,2007.0,119,109,10
CHE,IRN,2013.0,6,27,-21
PRT,SWE,2007.0,8,6,2
PRT,SWE,2020.0,22,20,2
DEU,SGP,2009.0,30,24,6
USA,ITA,1997.0,407,365,42
ZWE,USA,2006.0,4,4,0
IDN,AUS,2006.0,8,11,-3
DEU,AUT,2002.0,229,196,33
FIN,DEU,2014.0,46,59,-13
KOR,IND,2015.0,130,232,-102
USA,SWE,2015.0,268,238,30
ITA,AUT,2019.0,66,49,17
HRV,CZE,2021.0,5,2,3
USA,ECU,2010.0,11,7,4
BEL,PRT,2011.0,13,5,8
ARG,BRA,2013.0,36,26,10
ARG,USA,2013.0,125,103,22
CAN,VEN,2005.0,2,1,1
MEX,FRA,2012.0,31,54,-23
ZAF,GBR,2022.0,140,87,53
USA,TUN,2020.0,10,10,0
MEX,USA,2003.0,204,243,-39
CAN,DEU,2015.0,182,187,-5
GBR,TZA,2011.0,15,7,8
TZA,GBR,2012.0,13,14,-1
GHA,GBR,2014.0,12,33,-21
GBR,COL,2022.0,32,29,3
COL,GBR,2023.0,18,13,5
CHE,GHA,2014.0,2,1,1
IRL,CAN,2007.0,23,24,-1
USA,KAZ,2000.0,2,2,0
CAN,ZAF,2009.0,15,25,-10
GBR,ZAF,2014.0,120,79,41
ZAF,GBR,2016.0,100,87,13
ETH,JPN,2011.0,1,1,0
JPN,GRC,2007.0,5,2,3
TUR,CHN,2020.0,21,14,7
RUS,CHE,2002.0,33,12,21
FRA,KOR,2011.0,28,22,6
USA,JOR,2010.0,44,25,19
CMR,FRA,2020.0,12,33,-21
DEU,EGY,2008.0,47,20,27
DEU,EGY,2014.0,73,33,40
SAU,EGY,2022.0,284,336,-52
USA,IRL,2020.0,143,154,-11
UGA,USA,2016.0,34,51,-17
DNK,AUS,2019.0,46,46,0
ZAF,GBR,2018.0,122,94,28
KOR,IDN,2013.0,14,4,10
USA,CYP,2009.0,24,5,19
FRA,ITA,2015.0,232,359,-127
JPN,IRN,2008.0,23,12,11
GBR,IND,2013.0,170,151,19
ARG,CAN,2002.0,21,10,11
ITA,CHE,2007.0,107,84,23
AUS,CHL,2007.0,5,5,0
AUT,NLD,2010.0,23,22,1
NLD,AUT,2015.0,32,31,1
BGD,USA,2010.0,27,23,4
DNK,FRA,2006.0,27,22,5
FRA,DNK,2007.0,35,15,20
GBR,ARE,2013.0,40,11,29
USA,UKR,2010.0,41,26,15
USA,MEX,2000.0,154,217,-63
IRN,USA,2014.0,467,113,354
USA,SGP,2001.0,101,114,-13
SRB,DEU,2006.0,40,28,12
ESP,GBR,2003.0,181,189,-8
DEU,KEN,2009.0,9,7,2
HUN,FRA,2006.0,9,6,3
ITA,LBN,2007.0,3,2,1
GBR,NOR,2011.0,83,41,42
ARE,NOR,2023.0,2,3,-1
CHN,AUS,2003.0,60,51,9
MYS,AUS,2010.0,52,46,6
BRA,ARG,2013.0,26,36,-10
EGY,DEU,2009.0,38,39,-1
SWE,CAN,2005.0,41,21,20
TUR,AZE,2008.0,10,7,3
ITA,GEO,2015.0,3,1,2
NOR,NLD,2007.0,17,16,1
ESP,CHE,2010.0,63,63,0
AUS,ITA,2017.0,37,68,-31
FRA,BEL,2011.0,208,200,8
TUN,CHE,2008.0,3,2,1
USA,NLD,1998.0,214,234,-20
ARE,CHE,2011.0,1,3,-2
MYS,SAU,2014.0,58,22,36
FRA,NLD,2006.0,84,92,-8
ITA,FRA,2003.0,197,180,17
FRA,ITA,2004.0,153,175,-22
GBR,MYS,2000.0,49,13,36
CRI,DNK,2020.0,1,2,-1
AUS,NLD,2009.0,42,56,-14
IRN,USA,2015.0,503,101,402
GBR,HUN,2012.0,22,33,-11
SEN,BEL,2012.0,3,1,2
USA,SLE,2018.0,9,6,3
IND,USA,1997.0,232,190,42
JPN,CAN,2018.0,96,90,6
PRT,SGP,2014.0,2,1,1
ESP,MEX,2021.0,152,157,-5
ITA,LTU,2007.0,2,2,0
ISR,GBR,2001.0,35,46,-11
DEU,IRL,2008.0,47,23,24
ZAF,UGA,2014.0,8,9,-1
IND,KOR,2010.0,148,99,49
CHN,MEX,2004.0,2,2,0
GBR,CHE,2022.0,312,251,61
AUS,LKA,2012.0,14,18,-4
NLD,ARG,2004.0,2,4,-2
FIN,TWN,2018.0,1,3,-2
JPN,QAT,2021.0,2,1,1
COL,BRA,2017.0,69,77,-8
KOR,RUS,2018.0,8,10,-2
CHE,ITA,2008.0,85,168,-83
ITA,DEU,2013.0,308,170,138
ARE,SAU,2019.0,17,34,-17
DEU,POL,2006.0,65,66,-1
FRA,CHN,2012.0,142,144,-2
USA,BLR,2007.0,9,4,5
AUS,BRA,2002.0,13,16,-3
BWA,ZAF,2005.0,2,2,0
POL,SWE,2011.0,22,17,5
GBR,TUR,2022.0,77,87,-10
ITA,NLD,2011.0,112,70,42
NLD,ITA,2015.0,92,119,-27
DEU,BRA,2013.0,83,97,-14
LTU,SWE,1998.0,8,6,2
KOR,DEU,2007.0,22,30,-8
SGP,AUS,2019.0,111,87,24
SWE,BEL,2001.0,14,10,4
IRL,GBR,2005.0,169,208,-39
PRT,IND,2018.0,19,14,5
IRQ,TUR,2022.0,13,23,-10
FRA,EGY,2013.0,19,13,6
USA,CMR,2012.0,3,11,-8
JPN,IND,2008.0,68,84,-16
ESP,NOR,2013.0,11,8,3
BEL,LBN,2013.0,3,3,0
RUS,DEU,2015.0,137,117,20
NOR,GBR,2008.0,40,49,-9
CHL,BRA,2007.0,12,17,-5
SGP,IND,2019.0,82,114,-32
AUT,BRA,2003.0,3,4,-1
DEU,IRL,2014.0,33,43,-10
SVN,DEU,2009.0,11,5,6
IND,ISR,2008.0,17,12,5
MEX,FRA,2002.0,33,49,-16
FRA,MEX,2003.0,51,28,23
TWN,CHN,1997.0,46,44,2
DEU,PAK,2002.0,8,4,4
SGP,JPN,2011.0,19,46,-27
ITA,NLD,2019.0,148,103,45
CAN,QAT,2011.0,5,2,3
ROU,USA,2004.0,33,15,18
ISR,CHN,2015.0,14,21,-7
HUN,DEU,2003.0,59,42,17
USA,GRD,2018.0,13,11,2
AUS,MYS,2012.0,84,64,20
PRT,USA,2011.0,70,71,-1
GEO,USA,2019.0,200,265,-65
NPL,NLD,2009.0,3,2,1
SAU,AUS,2006.0,4,3,1
MAR,ESP,2009.0,5,7,-2
QAT,FRA,2014.0,6,17,-11
IDN,USA,2015.0,25,42,-17
USA,GRC,2019.0,106,142,-36
BRA,JPN,2000.0,22,18,4
BRA,USA,2000.0,278,244,34
FRA,CMR,2010.0,29,18,11
GBR,JPN,2013.0,137,137,0
BRA,GBR,2019.0,144,125,19
FIN,PRT,2009.0,2,2,0
ZAF,DEU,2019.0,44,32,12
NLD,CAN,2009.0,40,46,-6
DEU,AUS,2007.0,125,92,33
RUS,BEL,2006.0,5,7,-2
GBR,KOR,1998.0,18,12,6
CAN,ROU,2010.0,3,5,-2
DEU,AUS,2020.0,171,174,-3
USA,SAU,2010.0,131,39,92
ARE,GBR,2015.0,18,56,-38
GBR,LSO,2007.0,1,1,0
LSO,ZAF,2012.0,3,1,2
NLD,GBR,2016.0,361,290,71
ARG,USA,2003.0,173,125,48
USA,PAN,2012.0,18,18,0
IND,GBR,2021.0,360,252,108
ESP,CHL,2009.0,76,44,32
DNK,ESP,2013.0,17,22,-5
DNK,NOR,2013.0,32,29,3
ARG,DEU,2000.0,18,22,-4
PHL,USA,2004.0,19,16,3
ISR,NLD,2020.0,17,10,7
ESP,MAR,2015.0,23,8,15
JPN,ITA,2009.0,21,12,9
CAN,NLD,2012.0,73,60,13
EGY,JPN,2015.0,28,54,-26
CHN,CHE,2012.0,38,43,-5
HUN,CAN,2020.0,7,10,-3
POL,GBR,2005.0,36,25,11
ARM,RUS,1998.0,11,5,6
DEU,ITA,2013.0,170,308,-138
TUR,TUN,2009.0,2,1,1
JPN,FRA,2001.0,81,78,3
CHE,EGY,2002.0,3,4,-1
EGY,USA,2005.0,56,74,-18
PRT,USA,2009.0,49,65,-16
CAN,IRN,2020.0,86,477,-391
DEU,BEL,2012.0,105,87,18
CHE,KOR,2016.0,19,13,6
DEU,SRB,2012.0,13,11,2
USA,ARG,2013.0,103,125,-22
ITA,CHL,2011.0,8,6,2
BEL,COL,2015.0,7,1,6
CHL,USA,2017.0,137,178,-41
ESP,BEL,2015.0,81,58,23
IND,PRT,2005.0,8,2,6
GBR,TUR,2018.0,92,94,-2
POL,CZE,2010.0,8,5,3
TWN,CHE,2011.0,5,4,1
TWN,CHE,2019.0,14,4,10
JPN,IND,2014.0,124,91,33
NLD,GRC,2012.0,17,23,-6
CZE,SVK,2013.0,59,84,-25
NZL,GBR,2013.0,122,147,-25
AUS,DEU,2020.0,174,171,3
SGP,GBR,2017.0,114,162,-48
QAT,USA,2011.0,11,42,-31
HKG,JPN,2022.0,12,14,-2
SEN,FRA,2008.0,27,32,-5
ZMB,USA,2008.0,2,9,-7
CHN,NOR,2013.0,20,22,-2
USA,RUS,2016.0,235,194,41
DEU,SWE,2018.0,188,169,19
VEN,USA,2010.0,37,28,9
ESP,CUB,2008.0,28,28,0
SAU,USA,2011.0,29,138,-109
HKG,DEU,2005.0,8,8,0
KOR,SWE,2002.0,5,4,1
IDN,MYS,2009.0,6,16,-10
CHE,ITA,2015.0,126,275,-149
FRA,MTQ,1997.0,7,6,1
MTQ,FRA,2000.0,22,9,13
PRT,FRA,2000.0,20,31,-11
DEU,PAK,2012.0,38,15,23
PAK,DEU,2013.0,30,41,-11
EGY,PAK,2020.0,6,11,-5
ITA,CZE,2017.0,15,17,-2
FRA,CAN,1999.0,194,144,50
QAT,USA,2019.0,55,57,-2
NLD,TUR,2010.0,12,29,-17
JPN,FRA,2015.0,84,113,-29
TWN,THA,2010.0,5,5,0
BRA,CHE,2019.0,29,23,6
BRA,USA,2023.0,492,191,301
USA,ITA,2002.0,587,614,-27
POL,DEU,2014.0,91,80,11
FRA,NLD,2000.0,81,86,-5
GBR,CZE,2012.0,31,43,-12
GBR,SAU,2010.0,75,26,49
DZA,SAU,2021.0,6,16,-10
UKR,DEU,1998.0,32,16,16
DEU,UKR,2008.0,21,26,-5
JPN,SWE,2012.0,34,25,9
NLD,BEL,2012.0,125,126,-1
CAN,GBR,1999.0,223,205,18
POL,FRA,2015.0,28,30,-2
USA,PER,2011.0,39,34,5
PER,USA,2020.0,66,65,1
DNK,CZE,2008.0,4,3,1
CHE,IRL,2011.0,9,8,1
JPN,EGY,2013.0,73,17,56
GRC,CHN,2008.0,1,2,-1
GBR,HKG,2013.0,65,47,18
GBR,KOR,2007.0,40,28,12
VEN,ECU,2018.0,38,10,28
EGY,JPN,2014.0,35,61,-26
ARE,EGY,2023.0,21,20,1
AUT,SVN,2018.0,7,7,0
IRQ,JOR,2011.0,3,6,-3
JOR,IRQ,2019.0,6,4,2
DEU,FRA,1998.0,204,246,-42
SRB,USA,2014.0,27,20,7
USA,EGY,2004.0,75,46,29
TUR,ITA,2016.0,33,14,19
JPN,SWE,2005.0,29,31,-2
CAN,LBN,2016.0,12,11,1
AUS,NZL,2019.0,150,160,-10
SVN,FRA,2010.0,3,4,-1
DEU,BEL,2002.0,78,80,-2
KEN,USA,2014.0,55,63,-8
SGP,AUS,2011.0,60,58,2
HKG,MAC,2009.0,9,2,7
ESP,DEU,2002.0,122,101,21
PRI,USA,2013.0,216,96,120
ROU,NLD,2004.0,7,3,4
GBR,DNK,2007.0,54,63,-9
ARG,DEU,2010.0,26,13,13
CHN,KEN,2004.0,1,1,0
GBR,NOR,2019.0,106,57,49
JPN,GBR,2019.0,118,160,-42
OMN,GBR,2009.0,6,9,-3
ISL,DEU,2007.0,2,1,1
FRA,ROU,2005.0,39,30,9
ROU,FRA,2016.0,37,36,1
SLV,SVN,2018.0,9,8,1
USA,NLD,2020.0,515,420,95
FRA,SVK,2002.0,7,6,1
BLR,DEU,2002.0,23,12,11
USA,PER,2009.0,39,38,1
FRA,AUS,2015.0,114,102,12
USA,NIC,2013.0,6,3,3
DEU,MYS,2016.0,17,15,2
SGP,CHE,2013.0,16,19,-3
CHE,NLD,2018.0,100,113,-13
CAN,BRA,2014.0,55,80,-25
CHL,FRA,2013.0,20,41,-21
IND,GRC,2010.0,1,1,0
USA,PER,2019.0,64,75,-11
AUS,ZAF,2022.0,21,22,-1
ESP,MAR,2014.0,29,6,23
DEU,ISR,2018.0,61,61,0
USA,CUB,2002.0,10,8,2
MEX,CUB,2006.0,15,7,8
CHE,MNG,2017.0,1,2,-1
USA,PRT,2010.0,88,59,29
JPN,CHN,2019.0,577,357,220
USA,DOM,2004.0,2,1,1
CHN,AUS,2013.0,278,199,79
IND,LBY,2016.0,3,3,0
LBY,IND,2020.0,3,1,2
USA,OMN,2007.0,9,8,1
AUS,HRV,2011.0,3,1,2
JPN,CAN,2017.0,72,79,-7
CUB,MEX,2009.0,20,6,14
MEX,CHL,2013.0,29,13,16
CAN,SAU,2008.0,47,27,20
CHN,DEU,2003.0,133,84,49
DNK,GBR,2015.0,94,111,-17
BGD,JPN,2009.0,52,54,-2
JPN,NZL,1998.0,6,10,-4
ESP,ARG,2020.0,88,113,-25
CHE,JPN,2011.0,36,32,4
NLD,CZE,2016.0,10,13,-3
TZA,KEN,2022.0,6,4,2
KEN,TZA,2023.0,5,4,1
SVN,USA,1999.0,14,1,13
FRA,MAR,2017.0,99,50,49
USA,PSE,2018.0,9,8,1
CAN,GBR,1998.0,186,197,-11
CAN,GEO,1999.0,2,1,1
CAN,CHN,1998.0,24,55,-31
USA,THA,1998.0,48,38,10
FRA,DZA,1997.0,24,16,8
SWE,FRA,2016.0,58,87,-29
AUS,CZE,1999.0,3,2,1
FRA,REU,2011.0,27,39,-12
GBR,ITA,1997.0,125,143,-18
CHN,SGP,2002.0,92,48,44
IRN,GBR,2007.0,27,87,-60
USA,NGA,2004.0,19,18,1
GBR,IRN,2006.0,82,21,61
EGY,SAU,2005.0,47,37,10
IDN,USA,2014.0,28,33,-5
AUS,SAU,2012.0,13,6,7
NLD,ESP,2013.0,66,100,-34
SEN,CMR,2015.0,2,1,1
GUF,GUY,2010.0,1,1,0
USA,HUN,2019.0,68,58,10
NLD,CAN,2021.0,46,87,-41
PAK,SAU,2018.0,86,87,-1
DEU,FRA,2020.0,406,428,-22
UKR,SWE,2014.0,9,3,6
BEL,ESP,2020.0,71,92,-21
TZA,NOR,2007.0,5,6,-1
IDN,JPN,2010.0,26,88,-62
IND,SGP,2016.0,95,78,17
BEL,ESP,1999.0,29,15,14
ESP,BEL,2001.0,24,24,0
MEX,USA,2013.0,285,230,55
CHE,SVN,2006.0,4,1,3
LKA,JPN,2010.0,4,10,-6
AUS,SGP,2004.0,30,31,-1
IND,JPN,2005.0,63,54,9
SAU,TUN,2023.0,39,67,-28
USA,DNK,2005.0,74,98,-24
AUS,AUT,1998.0,23,37,-14
TZA,DNK,2008.0,3,2,1
ITA,POL,2003.0,27,16,11
KWT,EGY,2022.0,14,7,7
TZA,IND,2016.0,2,5,-3
MAC,CHN,2011.0,30,31,-1
SWE,USA,2006.0,237,180,57
IND,OMN,2010.0,23,4,19
GBR,NZL,2017.0,126,123,3
COL,CHL,2011.0,18,17,1
ISL,SWE,2008.0,5,9,-4
SWE,NLD,2013.0,40,54,-14
COL,VEN,2006.0,6,2,4
AUS,NZL,2011.0,116,197,-81
CRI,PER,2015.0,1,1,0
MYS,PAK,2004.0,4,2,2
FRA,TUN,2001.0,70,44,26
ESP,CAN,2023.0,37,38,-1
ISR,GBR,2008.0,41,24,17
GRC,GBR,2007.0,108,153,-45
HUN,CAN,1999.0,7,8,-1
FRA,IDN,2004.0,5,3,2
ZAF,CAN,2010.0,14,19,-5
USA,BEL,2021.0,176,186,-10
EGY,SAU,1997.0,23,28,-5
NGA,MYS,2018.0,48,100,-52
BEL,ZAF,1997.0,2,1,1
JPN,EGY,2003.0,28,15,13
IND,NOR,2020.0,42,12,30
CAN,NZL,2001.0,29,41,-12
HKG,JPN,2017.0,15,17,-2
JPN,DEU,2020.0,140,128,12
ESP,BRA,2020.0,95,135,-40
IND,KOR,2024.0,11,7,4
JPN,CHN,2021.0,577,454,123
BEL,NLD,2019.0,205,194,11
ITA,NOR,2020.0,34,20,14
ITA,MEX,2018.0,26,19,7
IRN,CZE,2019.0,18,6,12
ZAF,AUS,2018.0,66,31,35
RUS,USA,2020.0,206,173,33
CHN,MAC,2017.0,77,69,8
CHN,MAC,2022.0,368,291,77
TWN,KOR,2021.0,19,14,5
IND,AUS,2023.0,82,57,25
VEN,GBR,2021.0,4,1,3
DZA,FRA,2019.0,47,140,-93
JOR,DEU,2019.0,15,12,3
SGP,CHN,2022.0,505,341,164
SVN,DEU,2021.0,12,11,1
FRA,ISR,2020.0,38,30,8
AUS,IDN,2019.0,93,35,58
EGY,ARE,2021.0,29,23,6
SAU,USA,2021.0,144,367,-223
CHN,FIN,2020.0,52,54,-2
IDN,JPN,2023.0,60,78,-18
BHR,AUS,2018.0,1,4,-3
IRL,SGP,2023.0,3,2,1
SVN,NLD,2020.0,2,6,-4
KOR,CAN,2019.0,54,45,9
AUS,ITA,2022.0,38,30,8
UGA,GBR,2015.0,16,6,10
DNK,HKG,2020.0,2,5,-3
USA,COL,2019.0,152,164,-12
,DEU,1998.0,17386,0,17386
,GBR,1999.0,16517,0,16517
,ITA,2002.0,11476,0,11476
,ESP,2001.0,9644,0,9644
,MOZ,2001.0,16,0,16
,USA,1995.0,131485,0,131485
ESP,,2011.0,5667,0,5667
DEU,,2016.0,17399,0,17399
ESP,,2025.0,113965,0,113965
,AUS,2002.0,6188,0,6188
TUR,,2024.0,26040,0,26040
,CAN,2003.0,10158,0,10158
CAN,,2009.0,5773,0,5773
,KOR,2008.0,13688,0,13688
KOR,,2024.0,39688,0,39688
CZE,,2022.0,3357,0,3357
JPN,,2022.0,31950,0,31950
HKG,,2013.0,857,0,857
,JPN,2001.0,23104,0,23104
,PRT,1995.0,1891,0,1891
PRI,,2008.0,65,0,65
FRA,,2008.0,6858,0,6858
DEU,,2022.0,30982,0,30982
,BRA,2001.0,7706,0,7706
CAN,,2025.0,94015,0,94015
KOR,,2010.0,6055,0,6055
,ESP,1996.0,11357,0,11357
AUT,,2012.0,1255,0,1255
,AUT,2002.0,1835,0,1835
,DEU,1999.0,17088,0,17088
DEU,,2018.0,20466,0,20466
,KOR,2001.0,7462,0,7462
,TWN,2003.0,5602,0,5602
,EST,1999.0,156,0,156
,EST,1998.0,186,0,186
USA,,2013.0,58215,0,58215
,ISR,2000.0,2018,0,2018
,GBR,1998.0,19001,0,19001
,IND,2003.0,11692,0,11692
,KEN,2002.0,228,0,228
,ITA,1997.0,11037,0,11037
SWE,,2015.0,2544,0,2544
,JPN,1996.0,32489,0,32489
CHE,,2007.0,1719,0,1719
FRA,,2014.0,8931,0,8931
,GRC,2004.0,2768,0,2768
,EGY,2007.0,2460,0,2460
CHN,,2007.0,15714,0,15714
CAN,,2011.0,6337,0,6337
,EST,2007.0,339,0,339
GBR,,2014.0,13068,0,13068
GRC,,2016.0,1714,0,1714
IRL,,2025.0,12788,0,12788
FRA,,2015.0,9974,0,9974
BRA,,2012.0,5698,0,5698
,CZE,1999.0,1595,0,1595
CZE,,2018.0,1938,0,1938
,SVN,2003.0,578,0,578
SVN,,2025.0,5332,0,5332
,SGP,2002.0,1477,0,1477
ESP,,2021.0,15668,0,15668
,TUR,1998.0,3154,0,3154
,ZAF,2000.0,1150,0,1150
,RUS,2010.0,8775,0,8775
,KOR,2004.0,9742,0,9742
,NLD,2000.0,4529,0,4529
VEN,,2012.0,471,0,471
,JPN,2004.0,23387,0,23387
JPN,,2018.0,22482,0,22482
GBR,,2015.0,14208,0,14208
SWE,,2014.0,2307,0,2307
,BRA,1996.0,6579,0,6579
,HUN,2003.0,1255,0,1255
PRT,,2024.0,10457,0,10457
,GLP,2003.0,10,0,10
,AUS,1997.0,6180,0,6180
,SWE,2000.0,3078,0,3078
SVN,,2021.0,711,0,711
CAN,,2021.0,14632,0,14632
CHN,,2020.0,108265,0,108265
ESP,,2009.0,4993,0,4993
,ARG,2017.0,2670,0,2670
FIN,,2008.0,1070,0,1070
MYS,,2007.0,195,0,195
,NGA,1997.0,539,0,539
TWN,,2017.0,6412,0,6412
ECU,,2023.0,1111,0,1111
IRL,,2021.0,1796,0,1796
KOR,,2023.0,23964,0,23964
JPN,,2016.0,21310,0,21310
,DEU,2007.0,21099,0,21099
GBR,,2008.0,10190,0,10190
,ROU,1999.0,803,0,803
,BEL,2000.0,2693,0,2693
ITA,,2016.0,8680,0,8680
,THA,2002.0,1142,0,1142
JPN,,2017.0,21575,0,21575
,GRC,2001.0,2183,0,2183
ITA,,2022.0,18336,0,18336
,NGA,2002.0,772,0,772
,NOR,2002.0,1318,0,1318
MYS,,2020.0,3271,0,3271
IRQ,,2022.0,2567,0,2567
LTU,,2009.0,184,0,184
,PAK,2003.0,1070,0,1070
CHE,,2020.0,4727,0,4727
FIN,,2015.0,1372,0,1372
SVN,,2009.0,242,0,242
,BMU,2000.0,9,0,9
,NZL,2002.0,1113,0,1113
,SVK,2010.0,969,0,969
CAN,,2019.0,11694,0,11694
ZAF,,2008.0,551,0,551
AUS,,2007.0,2657,0,2657
,UKR,1996.0,2214,0,2214
,BRA,2004.0,13894,0,13894
RUS,,2013.0,4680,0,4680
DZA,,2025.0,9623,0,9623
,TUN,2003.0,878,0,878
,SGP,2005.0,1356,0,1356
TWN,,2018.0,6325,0,6325
ITA,,2017.0,9871,0,9871
BEL,,2013.0,1846,0,1846
TUR,,2023.0,13595,0,13595
LTU,,2025.0,4348,0,4348
,RUS,2000.0,7212,0,7212
GRC,,2022.0,3104,0,3104
DNK,,2007.0,822,0,822
SWE,,2008.0,1969,0,1969
,BRA,2008.0,17475,0,17475
,NLD,2010.0,6605,0,6605
,TUR,1999.0,3428,0,3428
,CYP,2001.0,57,0,57
BGR,,2023.0,1257,0,1257
,UKR,2001.0,1030,0,1030
ITA,,2018.0,10646,0,10646
,KOR,1996.0,5941,0,5941
,FIN,1999.0,1904,0,1904
,FRA,1994.0,60589,0,60589
IND,,2013.0,8753,0,8753
CHL,,2024.0,7259,0,7259
,NOR,1997.0,1422,0,1422
DEU,,2017.0,18789,0,18789
GRC,,2026.0,275,0,275
,FRA,2009.0,15063,0,15063
,HRV,1997.0,728,0,728
,ITA,2005.0,12860,0,12860
,VEN,2003.0,489,0,489
KWT,,2024.0,815,0,815
,SGP,1997.0,949,0,949
,KWT,2002.0,132,0,132
THA,,2012.0,701,0,701
,ESP,2008.0,13355,0,13355
GRC,,2017.0,1736,0,1736
SAU,,2004.0,211,0,211
,KOR,2014.0,16676,0,16676
SGP,,2018.0,1644,0,1644
ZAF,,2015.0,948,0,948
TWN,,2016.0,6612,0,6612
KOR,,2006.0,3102,0,3102
,JOR,2002.0,205,0,205
DNK,,2020.0,2628,0,2628
TWN,,2022.0,7789,0,7789
BGD,SAU,2010.0,2,0,2
,GEO,2002.0,94,0,94
,IRL,1995.0,1159,0,1159
,COG,2003.0,67,0,67
,NLD,2006.0,5308,0,5308
AUS,,2020.0,8651,0,8651
RUS,EGY,2013.0,3,0,3
TUN,,2013.0,555,0,555
,FRA,2011.0,15445,0,15445
PRT,,2010.0,587,0,587
,SRB,2006.0,1154,0,1154
CHL,,2023.0,4820,0,4820
USA,,2003.0,36365,0,36365
,IRN,1994.0,729,0,729
,ITA,2012.0,15098,0,15098
,GBR,2007.0,19129,0,19129
RUS,PAK,2007.0,1,0,1
,CUB,2003.0,579,0,579
GBR,,2004.0,8877,0,8877
MDA,,2025.0,423,0,423
,HKG,2000.0,1246,0,1246
,EGY,1999.0,1004,0,1004
EGY,,2007.0,305,0,305
ESP,,2019.0,11632,0,11632
,LBN,2003.0,158,0,158
,SVK,2006.0,829,0,829
,DNK,1994.0,7012,0,7012
GRC,ISR,2009.0,1,0,1
,BWA,2003.0,61,0,61
FRA,,2004.0,6317,0,6317
,HRV,2002.0,826,0,826
,MAR,2002.0,414,0,414
,ESP,2004.0,12177,0,12177
,LVA,2002.0,83,0,83
SGP,,2022.0,2582,0,2582
PAK,,2012.0,573,0,573
FIN,,2014.0,1332,0,1332
,EGY,1998.0,1089,0,1089
,JPN,2014.0,22923,0,22923
,ROU,1998.0,758,0,758
,MYS,1995.0,542,0,542
IND,,2003.0,2678,0,2678
DOM,,2010.0,7,0,7
,SWE,2006.0,3225,0,3225
,IRN,2009.0,12182,0,12182
JPN,,2026.0,1466,0,1466
COL,,2014.0,521,0,521
,SVK,2000.0,563,0,563
SVK,,2022.0,1353,0,1353
,AUT,2012.0,2902,0,2902
NZL,,2024.0,5112,0,5112
ITA,,2026.0,2040,0,2040
SGP,,2026.0,358,0,358
IRL,,2009.0,567,0,567
TUR,,2010.0,1649,0,1649
,ETH,2003.0,115,0,115
IRQ,DEU,2008.0,1,0,1
LVA,,2024.0,974,0,974
MWI,,2008.0,16,0,16
,MAR,1997.0,581,0,581
MAR,,2018.0,659,0,659
,POL,1995.0,6108,0,6108
RUS,,2003.0,3605,0,3605
,PHL,1997.0,185,0,185
IRL,,2011.0,653,0,653
,SDN,2002.0,50,0,50
PER,,2013.0,122,0,122
SAU,,2014.0,440,0,440
,JPN,2008.0,22529,0,22529
,BEL,2006.0,3122,0,3122
AUS,,1999.0,895,0,895
,BLR,1994.0,1215,0,1215
FIN,,2004.0,744,0,744
SAU,,2008.0,251,0,251
,HKG,2010.0,1613,0,1613
SGP,,2017.0,1593,0,1593
BGR,,2024.0,2311,0,2311
,THA,1997.0,830,0,830
,ZAF,2006.0,1652,0,1652
LTU,,2011.0,226,0,226
,NZL,1997.0,1222,0,1222
LBN,,2023.0,973,0,973
,FIN,1998.0,1971,0,1971
,DZA,2006.0,898,0,898
,ESP,2014.0,14313,0,14313
KEN,,2009.0,100,0,100
IRL,,2019.0,1284,0,1284
UGA,,2025.0,3023,0,3023
KWT,,2006.0,74,0,74
CHE,,1999.0,608,0,608
CIV,,2010.0,49,0,49
,CHN,2017.0,243557,0,243557
GBR,,2001.0,6973,0,6973
,URY,1999.0,166,0,166
URY,PER,2003.0,1,0,1
,DNK,2011.0,2829,0,2829
NGA,,2015.0,716,0,716
NGA,,2014.0,736,0,736
NZL,,2010.0,677,0,677
GUF,GLP,2006.0,2,0,2
GLP,,2012.0,8,0,8
SVK,,2016.0,642,0,642
TUR,,2006.0,884,0,884
NGA,,2004.0,121,0,121
POL,,2012.0,2145,0,2145
,JPN,2015.0,22764,0,22764
BRA,,2002.0,1037,0,1037
BRA,,2005.0,1493,0,1493
,ARG,2016.0,2823,0,2823
,TUN,2013.0,1511,0,1511
PNG,,2024.0,120,0,120
POL,,2002.0,828,0,828
,RUS,2006.0,6866,0,6866
,SAU,2010.0,1451,0,1451
BGD,,2007.0,79,0,79
,IND,2013.0,33832,0,33832
MAR,,2016.0,555,0,555
HUN,,2012.0,691,0,691
,KEN,1997.0,174,0,174
ZAF,,2014.0,821,0,821
PHL,,2013.0,132,0,132
KEN,,2025.0,4018,0,4018
PRT,,2023.0,5662,0,5662
QAT,,2012.0,44,0,44
FRA,,2001.0,5223,0,5223
CUB,,2018.0,680,0,680
,GRC,1996.0,2091,0,2091
GRC,,2018.0,1841,0,1841
CRI,,2018.0,97,0,97
IRQ,,2018.0,122,0,122
HKG,,2003.0,422,0,422
,NOR,2005.0,1624,0,1624
UKR,,2013.0,822,0,822
NGA,,2008.0,239,0,239
,SRB,2000.0,533,0,533
LBN,,2006.0,50,0,50
,HKG,2006.0,1392,0,1392
ARG,,2012.0,974,0,974
SWE,,2001.0,1082,0,1082
KOR,,2000.0,1125,0,1125
,CMR,2001.0,126,0,126
,EST,2020.0,161,0,161
BLR,,2017.0,224,0,224
CZE,,2016.0,1608,0,1608
CIV,,2023.0,443,0,443
,CZE,2007.0,2407,0,2407
,BGR,1995.0,1180,0,1180
,NCL,2000.0,6,0,6
VEN,ECU,2016.0,28,0,28
BRN,,2023.0,95,0,95
PRT,VNM,2015.0,2,0,2
,AUT,1997.0,1885,0,1885
,CRI,1999.0,74,0,74
HRV,,2002.0,165,0,165
MDA,,2021.0,104,0,104
,VNM,2002.0,214,0,214
,AUT,2005.0,2126,0,2126
UKR,,2003.0,709,0,709
,SWE,2010.0,3911,0,3911
LUX,,2025.0,1466,0,1466
DZA,,2019.0,847,0,847
,AUS,2005.0,6976,0,6976
GEO,,2018.0,188,0,188
DZA,,2021.0,1408,0,1408
,CZE,1998.0,1559,0,1559
SGP,,2016.0,1375,0,1375
EGY,,2020.0,1929,0,1929
SWE,,2004.0,1452,0,1452
VEN,,2005.0,213,0,213
KEN,NGA,2013.0,4,0,4
SVN,,2019.0,584,0,584
BEL,ECU,2008.0,2,0,2
,UKR,2004.0,1025,0,1025
FRO,,2021.0,14,0,14
,ZAF,2010.0,2195,0,2195
CIV,,2024.0,566,0,566
,ISR,2006.0,2321,0,2321
,MNG,2003.0,24,0,24
DOM,,2023.0,73,0,73
CRI,,2022.0,250,0,250
TWN,ISR,2008.0,1,0,1
SRB,,2015.0,649,0,649
CZE,,2026.0,385,0,385
ZAF,,2001.0,402,0,402
JOR,,2022.0,731,0,731
,UGA,1994.0,112,0,112
CHL,,2010.0,537,0,537
KOR,ETH,2007.0,1,0,1
,KOR,2015.0,16981,0,16981
,MDA,2003.0,45,0,45
KHM,,2015.0,32,0,32
MYS,,1999.0,56,0,56
GEO,,2017.0,127,0,127
MDA,,2009.0,17,0,17
,AUS,2012.0,10064,0,10064
MWI,,2015.0,40,0,40
ZMB,,2016.0,40,0,40
CRI,,2017.0,63,0,63
CHN,,1999.0,2886,0,2886
MDG,,2025.0,424,0,424
USA,PNG,2005.0,3,0,3
SVK,RUS,2015.0,4,0,4
NZL,,2023.0,2983,0,2983
BRN,,2024.0,149,0,149
GEO,,2016.0,97,0,97
MYS,KWT,2013.0,1,0,1
,DZA,2000.0,284,0,284
KAZ,,2007.0,28,0,28
,BDI,1995.0,9,0,9
KNA,,2024.0,29,0,29
TWN,,2026.0,517,0,517
KAZ,,2020.0,723,0,723
LTU,,2021.0,582,0,582
GRC,MLT,2020.0,3,0,3
,TUR,2007.0,6938,0,6938
DEU,,2026.0,1532,0,1532
DZA,,2009.0,76,0,76
,DZA,2010.0,1164,0,1164
BLR,,2018.0,209,0,209
,ARM,1999.0,141,0,141
CYP,,2020.0,193,0,193
EST,ITA,2007.0,2,0,2
COL,,2008.0,141,0,141
UGA,GMB,2018.0,1,0,1
,YEM,2003.0,27,0,27
,JAM,2003.0,42,0,42
,ISL,1994.0,286,0,286
COG,,2007.0,20,0,20
,COL,2017.0,3113,0,3113
,CHN,2018.0,259416,0,259416
CHN,AZE,2017.0,1,0,1
,DNK,2009.0,2535,0,2535
,UKR,2015.0,3244,0,3244
,CHL,1995.0,1181,0,1181
HUN,,2005.0,466,0,466
KEN,,2019.0,376,0,376
ZWE,,2023.0,295,0,295
,IDN,2010.0,1330,0,1330
UGA,TZA,2009.0,2,0,2
,ESP,2015.0,14384,0,14384
,ROU,2007.0,3009,0,3009
,CHN,2016.0,206482,0,206482
,PHL,2002.0,167,0,167
KEN,,2011.0,108,0,108
CUB,,2016.0,733,0,733
UGA,,2021.0,262,0,262
LBN,,2024.0,1465,0,1465
COL,THA,2022.0,1,0,1
SVN,,2011.0,265,0,265
MAR,,2017.0,574,0,574
BLR,,2026.0,20,0,20
,NGA,2005.0,1365,0,1365
GBR,YEM,2010.0,2,0,2
ARG,,2005.0,540,0,540
BHR,,2016.0,43,0,43
,UGA,2009.0,296,0,296
,BFA,1999.0,54,0,54
SWE,BOL,2011.0,2,0,2
ETH,EGY,2008.0,1,0,1
,UZB,1998.0,134,0,134
,CAN,2013.0,13259,0,13259
THA,OMN,2011.0,2,0,2
POL,,2005.0,1051,0,1051
,KWT,1997.0,178,0,178
SYR,,2011.0,21,0,21
,SAU,2000.0,414,0,414
NZL,,2000.0,251,0,251
BLR,,2022.0,542,0,542
CUB,,2017.0,708,0,708
,BEL,2010.0,3558,0,3558
,MMR,2017.0,121,0,121
ZWE,,2024.0,490,0,490
VNM,,2014.0,190,0,190
CZE,BHR,2016.0,1,0,1
,BRA,2015.0,22885,0,22885
ZAF,,2004.0,424,0,424
SVK,,2018.0,752,0,752
,SRB,2010.0,1839,0,1839
,GRC,2014.0,2344,0,2344
PSE,,2006.0,14,0,14
MNG,,2013.0,18,0,18
ECU,,2024.0,2073,0,2073
,IDN,2000.0,215,0,215
LKA,NLD,2014.0,1,0,1
BGR,,2010.0,297,0,297
HRV,,2012.0,450,0,450
,AZE,2007.0,259,0,259
GMB,,2010.0,9,0,9
,ZMB,2010.0,80,0,80
BIH,,2023.0,571,0,571
,ARM,1998.0,163,0,163
TZA,CHN,2000.0,7,0,7
TUR,,2000.0,346,0,346
,MDG,1997.0,34,0,34
THA,BOL,2014.0,1,0,1
BLR,,2016.0,195,0,195
MAR,,2022.0,1517,0,1517
,NZL,2005.0,1392,0,1392
ARM,,2012.0,78,0,78
SRB,,2014.0,508,0,508
MDA,,2019.0,53,0,53
DZA,,2011.0,130,0,130
CMR,,2020.0,209,0,209
,FRA,2019.0,11380,0,11380
GEO,SWE,2019.0,2,0,2
,CRI,1998.0,53,0,53
DZA,MAR,2009.0,3,0,3
,SEN,1995.0,156,0,156
ARG,DZA,2010.0,2,0,2
,UZB,1999.0,140,0,140
PSE,CHE,2013.0,1,0,1
PSE,,2023.0,246,0,246
,GEO,1997.0,171,0,171
,FIN,2007.0,1960,0,1960
,BIH,2007.0,233,0,233
LUX,,2011.0,34,0,34
,BFA,1998.0,32,0,32
SVK,,2017.0,674,0,674
,ZWE,1996.0,97,0,97
RUS,MNG,2015.0,4,0,4
IRN,DNK,2004.0,1,0,1
,IRQ,2001.0,39,0,39
IRQ,ARE,2009.0,4,0,4
LVA,,2023.0,575,0,575
CRI,,2016.0,88,0,88
DEU,PRI,2014.0,2,0,2
,BLR,2009.0,229,0,229
,DEU,2020.0,13130,0,13130
NZL,URY,1999.0,1,0,1
,MLI,2003.0,36,0,36
MLI,,2019.0,65,0,65
CZE,IRL,2002.0,1,0,1
SYR,,2009.0,23,0,23
FIN,,2001.0,502,0,502
LBN,,2010.0,69,0,69
,ISR,2010.0,2480,0,2480
KWT,,2023.0,493,0,493
AUS,LAO,2004.0,3,0,3
CZE,,2017.0,1718,0,1718
MDG,,2021.0,96,0,96
KEN,,2021.0,542,0,542
BIH,,2024.0,933,0,933
,GHA,2006.0,178,0,178
SAU,,2015.0,566,0,566
,SYR,1995.0,55,0,55
,TZA,1998.0,72,0,72
TZA,,2016.0,140,0,140
,HND,1994.0,10,0,10
HND,,2023.0,64,0,64
,GUF,2000.0,12,0,12
,MEX,2018.0,5733,0,5733
TZA,,2022.0,318,0,318
,IRN,2011.0,12224,0,12224
SAU,,2001.0,179,0,179
,UKR,2014.0,2933,0,2933
ESP,AND,2016.0,3,0,3
,NZL,2012.0,1520,0,1520
,TWN,2013.0,6263,0,6263
,MDA,2013.0,52,0,52
,LKA,1994.0,156,0,156
LKA,THA,2002.0,2,0,2
JPN,MWI,2008.0,1,0,1
GEO,,2022.0,343,0,343
,UKR,2008.0,1203,0,1203
VNM,,2008.0,78,0,78
DNK,CRI,2014.0,1,0,1
AZE,,2013.0,133,0,133
,TTO,2001.0,55,0,55
,JOR,1997.0,190,0,190
,GBR,2020.0,10720,0,10720
,BRA,2014.0,22045,0,22045
MDA,,2011.0,30,0,30
HRV,FIN,2021.0,2,0,2
QAT,PRT,2022.0,2,0,2
UGA,,2009.0,37,0,37
BRB,,2022.0,36,0,36
ROU,,2013.0,908,0,908
SYR,,2021.0,100,0,100
,BGD,1994.0,520,0,520
LTU,,2019.0,458,0,458
ITA,BFA,2007.0,3,0,3
,CYP,2004.0,78,0,78
PHL,,2003.0,47,0,47
GRD,,2021.0,23,0,23
,IRQ,2004.0,101,0,101
KOR,POL,1998.0,2,0,2
,ZWE,2004.0,110,0,110
BEL,,2003.0,1052,0,1052
SRB,,2008.0,216,0,216
,COL,2018.0,3268,0,3268
THA,NGA,2013.0,1,0,1
ZMB,THA,2009.0,1,0,1
,BRN,1998.0,8,0,8
ZMB,,2022.0,127,0,127
MMR,,2007.0,9,0,9
TWN,SWE,2011.0,6,0,6
CHN,GRC,2009.0,2,0,2
CUB,ZAF,2008.0,1,0,1
,THA,2005.0,1738,0,1738
SVN,DZA,2015.0,1,0,1
CIV,DEU,2009.0,2,0,2
DEU,CIV,2017.0,2,0,2
USA,NIC,2003.0,4,0,4
ROU,,2003.0,243,0,243
UZB,,2020.0,74,0,74
IRQ,,2017.0,91,0,91
,CMR,2004.0,187,0,187
MLI,,2025.0,391,0,391
,TTO,2004.0,52,0,52
,GIN,1999.0,14,0,14
PRT,,2006.0,325,0,325
,CYP,2014.0,226,0,226
,PNG,2000.0,23,0,23
ESP,LSO,2010.0,1,0,1
GIN,,2020.0,21,0,21
UGA,,2019.0,208,0,208
BRA,PRI,2016.0,12,0,12
,LBY,2001.0,27,0,27
JOR,,2016.0,185,0,185
FSM,,2009.0,3,0,3
CHE,CIV,2020.0,7,0,7
KOR,MWI,2012.0,1,0,1
,GHA,2010.0,371,0,371
HUN,,2002.0,411,0,411
NAM,,2000.0,4,0,4
,GTM,1994.0,42,0,42
,IRN,2019.0,11213,0,11213
AUT,,2002.0,650,0,650
PRI,,2015.0,92,0,92
MAR,,2026.0,329,0,329
,MOZ,2004.0,45,0,45
MUS,,2023.0,81,0,81
VEN,,2002.0,121,0,121
NLD,LUX,2008.0,5,0,5
SYR,,2025.0,720,0,720
,BOL,2012.0,62,0,62
UGA,OMN,2011.0,1,0,1
IND,BHR,2018.0,9,0,9
BHR,,2022.0,146,0,146
ARE,,2013.0,114,0,114
MDG,,2019.0,60,0,60
PER,IND,2013.0,2,0,2
NOR,AGO,2015.0,1,0,1
AGO,,2019.0,22,0,22
SRB,IDN,2020.0,1,0,1
,QAT,1994.0,41,0,41
,FJI,1996.0,15,0,15
JOR,SYR,2010.0,1,0,1
,LKA,2009.0,224,0,224
,TZA,1999.0,80,0,80
UZB,,2007.0,59,0,59
MLI,,2011.0,16,0,16
,CMR,1996.0,93,0,93
COG,,2020.0,94,0,94
,GAB,2004.0,26,0,26
KWT,,2010.0,115,0,115
,KWT,2005.0,183,0,183
VEN,AUS,2004.0,2,0,2
HKG,CZE,2013.0,2,0,2
UGA,,2011.0,52,0,52
,GRC,2015.0,2296,0,2296
,KAZ,2016.0,1397,0,1397
,CHE,2016.0,4848,0,4848
,MEX,2017.0,5710,0,5710
,TJK,2014.0,37,0,37
,URY,2020.0,117,0,117
,IRQ,2015.0,1464,0,1464
,CMR,2015.0,460,0,460
,SVN,2013.0,691,0,691
,ROU,2020.0,1332,0,1332
BGD,,2020.0,471,0,471
,VNM,2012.0,930,0,930
,MOZ,2014.0,71,0,71
,PAK,2013.0,3262,0,3262
,BGD,2011.0,905,0,905
,CYP,2015.0,278,0,278
,OMN,2017.0,239,0,239
,ARE,2017.0,769,0,769
,IRQ,2014.0,1111,0,1111
LUX,,2021.0,202,0,202
MAC,,2020.0,106,0,106
SAU,TUR,2017.0,5,16,-11
ESP,GBR,2008.0,213,230,-17
DEU,AUT,2007.0,291,200,91
CHN,USA,2003.0,867,694,173
DEU,DNK,2013.0,103,97,6
GBR,GRC,2012.0,164,191,-27
USA,IND,2009.0,618,917,-299
EGY,SAU,2007.0,93,64,29
USA,ISR,2016.0,384,485,-101
MEX,BRA,2017.0,30,42,-12
PER,USA,2005.0,30,21,9
USA,PER,2006.0,41,20,21
USA,ESP,2018.0,466,577,-111
ARG,ESP,2007.0,86,78,8
CAN,LKA,2010.0,4,4,0
GLP,FRA,2006.0,26,20,6
JPN,USA,2017.0,930,867,63
USA,IRQ,2007.0,5,5,0
GBR,ARG,2011.0,21,13,8
MYS,SWE,2021.0,10,4,6
GBR,BEL,2008.0,88,78,10
ROU,DEU,2016.0,33,24,9
DEU,USA,2001.0,1452,1335,117
DEU,FRA,2005.0,271,293,-22
MKD,AUS,2007.0,2,1,1
GBR,DEU,2003.0,485,461,24
BEL,FRA,2006.0,162,165,-3
FRA,GBR,2014.0,482,434,48
USA,CAN,2006.0,1533,1427,106
CHN,JPN,2004.0,196,381,-185
USA,AUS,2014.0,732,627,105
HKG,USA,2011.0,96,117,-21
FRA,GBR,2015.0,518,450,68
GBR,FRA,2019.0,510,522,-12
JOR,USA,2007.0,22,61,-39
GBR,NOR,2006.0,53,34,19
JPN,GBR,2000.0,149,125,24
USA,GBR,2003.0,1441,1851,-410
TWN,USA,2012.0,291,340,-49
SWE,CAN,2020.0,42,54,-12
USA,TWN,2008.0,310,262,48
FRA,NLD,2009.0,91,93,-2
ITA,AUT,2006.0,22,22,0
GBR,FRA,2009.0,340,401,-61
SWE,USA,2011.0,233,240,-7
USA,KOR,2011.0,983,800,183
NZL,GBR,2001.0,98,115,-17
SWE,FIN,2004.0,40,37,3
FRA,USA,2016.0,991,828,163
USA,CAN,2010.0,1636,1754,-118
ITA,ESP,2008.0,169,90,79
USA,CHN,2007.0,1038,1330,-292
CHN,DEU,2008.0,162,152,10
GBR,FIN,2017.0,54,72,-18
IDN,USA,2003.0,15,31,-16
DEU,ITA,2001.0,149,175,-26
KOR,USA,2014.0,810,1077,-267
POL,USA,2016.0,141,128,13
USA,POL,2018.0,122,138,-16
CAN,BRA,2003.0,48,36,12
ESP,USA,2009.0,419,414,5
ESP,NLD,2018.0,90,88,2
BRA,USA,2009.0,450,356,94
CAN,FRA,2016.0,321,403,-82
AUS,SGP,2003.0,34,43,-9
DEU,USA,2008.0,1248,1048,200
MEX,COL,2009.0,4,10,-6
GBR,USA,2009.0,1606,1555,51
CHN,NLD,2010.0,57,32,25
CHN,USA,2013.0,2577,2730,-153
HKG,CHN,2009.0,454,355,99
CAN,CHE,2010.0,105,82,23
IND,USA,1998.0,347,193,154
USA,BRA,2012.0,405,387,18
USA,THA,2012.0,233,132,101
NLD,DNK,2015.0,41,27,14
AUS,BEL,2023.0,16,8,8
GBR,USA,2011.0,1809,1679,130
JOR,CHE,2006.0,1,1,0
ZAF,ARG,2018.0,2,1,1
FRA,DEU,1999.0,248,240,8
USA,HKG,2016.0,155,153,2
USA,CHE,2006.0,378,373,5
DEU,AUT,1998.0,138,116,22
NLD,POL,2017.0,22,19,3
ESP,GBR,2015.0,541,299,242
CHN,PHL,2003.0,1,1,0
BEL,COD,2021.0,18,10,8
ITA,JPN,2006.0,13,22,-9
SWE,GBR,2010.0,139,115,24
CZE,USA,2007.0,51,43,8
GBR,CAN,2017.0,399,408,-9
ISR,GBR,2013.0,36,43,-7
UKR,DEU,2002.0,52,24,28
KAZ,RUS,2008.0,14,12,2
GBR,IRL,2021.0,458,477,-19
USA,BRA,2005.0,319,309,10
CHN,JPN,2008.0,290,406,-116
ITA,DEU,2001.0,175,149,26
ESP,NLD,2017.0,92,72,20
ESP,USA,2011.0,509,480,29
HKG,CHN,2011.0,733,601,132
CHN,TWN,2013.0,143,171,-28
KOR,BEL,2011.0,5,1,4
JPN,USA,2018.0,896,880,16
NLD,ESP,2004.0,43,49,-6
GBR,DNK,2012.0,79,65,14
GHA,USA,2005.0,8,10,-2
IRL,ESP,2013.0,27,30,-3
JPN,GBR,2010.0,128,126,2
TUR,DEU,2018.0,104,52,52
FRA,GBR,2004.0,337,317,20
AUS,IRN,2008.0,36,27,9
ITA,GBR,2012.0,456,287,169
DEU,JPN,2018.0,159,140,19
TUR,USA,2012.0,249,284,-35
ESP,MEX,2006.0,79,72,7
DEU,USA,2014.0,1372,1270,102
GRC,ISR,2006.0,1,4,-3
RUS,USA,2012.0,155,172,-17
USA,IND,2019.0,888,1576,-688
SVK,UKR,1999.0,1,2,-1
FRA,ROU,2007.0,42,32,10
ESP,PRT,2017.0,123,111,12
NLD,DEU,2015.0,323,291,32
ARG,CHL,1999.0,2,4,-2
NLD,ITA,2003.0,62,70,-8
SGP,AUS,2006.0,54,41,13
DEU,CHE,2008.0,638,351,287
GBR,AUT,2010.0,60,70,-10
DEU,USA,2004.0,1229,1125,104
JPN,ESP,2008.0,14,7,7
FRA,GBR,2008.0,410,380,30
SGP,AUS,2000.0,18,34,-16
JPN,AUT,2016.0,12,13,-1
GRC,GBR,2012.0,191,164,27
CMR,CAF,2010.0,2,1,1
LTU,LVA,2007.0,3,1,2
AUT,NZL,2008.0,3,2,1
CHN,SGP,1999.0,74,16,58
BRA,DEU,2007.0,75,57,18
CHE,USA,2006.0,373,378,-5
USA,CHE,2010.0,462,427,35
ITA,FRA,2008.0,253,176,77
FRA,USA,2017.0,1002,846,156
USA,SWE,2013.0,251,200,51
ISR,GBR,2003.0,50,32,18
KOR,USA,2015.0,834,1030,-196
SWE,CHE,2007.0,35,38,-3
CUB,MEX,2010.0,16,10,6
BEL,ESP,2012.0,28,52,-24
GBR,JPN,2008.0,126,145,-19
PRI,USA,2014.0,193,114,79
IND,USA,2007.0,764,494,270
USA,CHE,2023.0,278,327,-49
USA,MWI,2018.0,18,23,-5
KOR,NPL,2016.0,7,6,1
AUS,NLD,2010.0,47,65,-18
FRA,PRT,2016.0,41,57,-16
CAN,CHN,2005.0,104,127,-23
BEL,NLD,2010.0,119,132,-13
CHN,AUS,2008.0,122,83,39
PHL,USA,2003.0,19,26,-7
ZAF,USA,2008.0,97,77,20
FRA,CHE,2009.0,285,221,64
USA,PRI,2008.0,137,112,25
GHA,CAN,2018.0,3,6,-3
HUN,USA,2015.0,67,76,-9
ITA,ESP,2014.0,160,211,-51
ESP,ECU,2017.0,81,35,46
RUS,PRT,2022.0,10,2,8
ISR,USA,2016.0,485,384,101
USA,IND,2011.0,757,955,-198
POL,DEU,2003.0,69,75,-6
JPN,EGY,2008.0,50,15,35
CHE,FRA,2017.0,260,421,-161
CHN,AUS,2001.0,53,32,21
KOR,IND,2013.0,110,183,-73
USA,AUS,2008.0,634,470,164
AUS,USA,2011.0,645,692,-47
FIN,USA,2002.0,96,106,-10
DNK,CHN,2000.0,9,10,-1
SAU,IND,2011.0,10,87,-77
CHE,USA,2010.0,427,462,-35
HUN,DEU,2008.0,41,49,-8
DEU,HUN,2016.0,45,70,-25
USA,SAU,2009.0,90,36,54
CUB,ESP,2007.0,21,20,1
IND,USA,2020.0,1606,937,669
GBR,THA,1999.0,14,16,-2
DEU,CAN,2006.0,155,88,67
USA,TUR,2015.0,316,265,51
BGD,JPN,2006.0,35,36,-1
DEU,CHN,1999.0,84,76,8
AUT,ESP,2015.0,18,47,-29
TWN,USA,2002.0,229,302,-73
KOR,USA,2008.0,695,914,-219
CAN,CHN,2012.0,278,231,47
IND,ETH,2018.0,62,29,33
CHN,CAN,2015.0,344,333,11
NLD,DEU,2004.0,155,164,-9
IRL,DEU,2013.0,52,27,25
AUT,DEU,2013.0,342,303,39
AUS,NZL,2010.0,100,165,-65
FRA,VEN,2006.0,7,4,3
FRA,ESP,2017.0,266,315,-49
BRA,CAN,2005.0,41,29,12
HKG,AUS,2004.0,26,27,-1
PRI,USA,2004.0,89,78,11
USA,NLD,2012.0,362,339,23
DEU,ESP,2005.0,128,78,50
SRB,DEU,2021.0,24,14,10
CZE,ESP,2020.0,22,35,-13
DNK,DEU,2022.0,105,135,-30
CHN,DEU,2004.0,112,129,-17
USA,CHN,2020.0,4243,4047,196
BRA,USA,2011.0,378,458,-80
USA,NLD,2002.0,332,337,-5
DEU,ARG,2007.0,19,24,-5
USA,CHN,1998.0,304,407,-103
RUS,USA,1997.0,271,187,84
CHN,CAN,2004.0,118,98,20
BEL,ITA,2007.0,35,41,-6
KAZ,DEU,2010.0,2,2,0
CAN,GBR,2012.0,332,388,-56
ZAF,DEU,2010.0,22,22,0
SWE,DNK,2015.0,99,85,14
FRA,ESP,2018.0,256,306,-50
GBR,AUS,2010.0,618,447,171
FRA,GLP,2021.0,19,30,-11
IND,TWN,2009.0,66,28,38
PRI,USA,2008.0,112,137,-25
ARM,USA,2009.0,6,3,3
USA,MEX,2011.0,247,241,6
CAN,GBR,2005.0,256,320,-64
ITA,DEU,2008.0,187,144,43
RUS,FRA,2011.0,81,58,23
FRA,RUS,2012.0,46,62,-16
PER,CHE,2009.0,3,3,0
ISR,CAN,2012.0,68,51,17
JPN,PAK,2008.0,12,6,6
ZAF,USA,2004.0,98,74,24
FRA,ROU,1998.0,23,27,-4
GBR,USA,2019.0,2045,1868,177
GBR,USA,2021.0,1917,1812,105
GBR,NLD,2000.0,158,198,-40
NLD,CHE,2014.0,92,63,29
THA,USA,2012.0,132,233,-101
PRT,GBR,2013.0,85,66,19
POL,DEU,2013.0,70,96,-26
USA,FRA,2012.0,801,904,-103
GBR,ITA,2007.0,181,287,-106
CHN,GBR,2006.0,122,151,-29
USA,SAU,2011.0,138,29,109
GUF,FRA,2006.0,7,15,-8
FRA,GUF,2019.0,34,35,-1
USA,FIN,2016.0,76,101,-25
COL,ESP,2006.0,17,27,-10
ESP,COL,2015.0,140,61,79
GBR,ITA,1998.0,135,203,-68
IRL,GBR,2007.0,159,209,-50
FRA,CHL,2016.0,50,38,12
USA,IRL,2012.0,139,179,-40
NZL,GBR,2004.0,80,128,-48
CHE,GBR,2016.0,260,296,-36
ESP,GBR,2014.0,487,292,195
USA,CMR,2020.0,9,12,-3
USA,ESP,2016.0,366,641,-275
USA,ISR,2022.0,308,307,1
KOR,JPN,2018.0,129,128,1
AUS,GBR,1999.0,275,288,-13
KOR,USA,2001.0,485,572,-87
FRA,BEL,2010.0,198,193,5
USA,ITA,1998.0,419,453,-34
ESP,ROU,2018.0,7,9,-2
USA,TUR,2008.0,240,213,27
FRA,REU,2006.0,23,8,15
CHN,HKG,2020.0,1006,1405,-399
FRA,DEU,2007.0,271,341,-70
GBR,ZAF,2003.0,74,75,-1
USA,CHN,1999.0,299,515,-216
TUN,FRA,2001.0,44,70,-26
FRA,TUN,2003.0,91,35,56
CAN,DEU,2013.0,203,172,31
ZAF,NOR,2022.0,15,3,12
AUS,GRC,2013.0,6,15,-9
ECU,USA,2010.0,7,11,-4
GBR,IRL,2009.0,249,166,83
CHN,NZL,2016.0,32,26,6
FRA,EGY,2008.0,11,6,5
USA,TTO,2010.0,16,10,6
PRT,USA,2010.0,59,88,-29
IND,GBR,2000.0,85,59,26
GBR,OMN,2018.0,19,10,9
TWN,USA,2005.0,200,326,-126
TUN,FRA,2004.0,36,72,-36
THA,JPN,2012.0,62,100,-38
GBR,JOR,2009.0,14,7,7
USA,KOR,2009.0,870,760,110
HRV,CHE,2007.0,5,4,1
KOR,JPN,2016.0,122,142,-20
NLD,DEU,2008.0,202,228,-26
TUR,USA,2005.0,190,250,-60
USA,TWN,2004.0,333,221,112
IND,NPL,2014.0,22,31,-9
CAN,CHN,2002.0,58,122,-64
RUS,CHL,2016.0,2,2,0
RUS,GBR,2016.0,64,50,14
RUS,GBR,2018.0,48,64,-16
BEL,FRA,2010.0,193,198,-5
USA,TUR,2001.0,212,164,48
NLD,FRA,2008.0,119,84,35
DNK,FRA,2019.0,37,72,-35
FRA,TUN,2013.0,135,83,52
CHN,GHA,2016.0,10,9,1
ITA,NLD,2010.0,105,67,38
CHE,AUS,2009.0,48,52,-4
CHN,AUS,2014.0,293,254,39
USA,NZL,2016.0,107,145,-38
CHL,DEU,2009.0,38,27,11
GBR,THA,2007.0,52,33,19
FRA,PRT,2022.0,37,43,-6
AUS,GBR,2020.0,583,665,-82
CHN,SWE,2021.0,133,148,-15
CHN,TWN,2003.0,133,83,50
CZE,FIN,2009.0,1,3,-2
SGP,CAN,2005.0,23,15,8
CAN,SGP,2006.0,22,20,2
JPN,CHE,2009.0,33,33,0
CHE,IND,2006.0,19,20,-1
BEL,CAN,2011.0,46,36,10
PAK,IND,2009.0,9,13,-4
ISR,IRL,2010.0,19,10,9
DEU,CAN,2023.0,89,88,1
KAZ,GBR,2008.0,5,2,3
CUB,BEL,2010.0,2,3,-1
USA,CHE,2000.0,364,422,-58
RUS,USA,2005.0,279,243,36
MEX,FRA,1998.0,26,35,-9
RUS,USA,2002.0,543,311,232
ITA,GBR,2002.0,286,282,4
CAN,SAU,2013.0,92,42,50
ITA,BEL,2012.0,75,47,28
FRA,CAN,2005.0,232,157,75
FRA,ARG,2018.0,43,38,5
FRA,BEL,2006.0,165,162,3
DEU,POL,2009.0,83,87,-4
FRA,CHE,2011.0,291,244,47
TUR,USA,2002.0,158,245,-87
USA,BEL,2010.0,143,150,-7
HKG,CHN,2021.0,1440,1409,31
CAN,DZA,2011.0,4,4,0
IND,MYS,2003.0,20,6,14
JPN,MYS,2010.0,47,16,31
TWN,CHN,2007.0,56,55,1
DEU,FRA,2012.0,353,386,-33
FRA,KOR,2006.0,16,9,7
GBR,DEU,2013.0,713,669,44
NLD,HUN,2003.0,9,8,1
HUN,USA,2014.0,90,69,21
CAN,SWE,2010.0,44,42,2
CHE,USA,2023.0,327,278,49
IDN,VNM,2002.0,1,2,-1
HKG,CHN,2019.0,1272,810,462
USA,BRA,2002.0,367,307,60
NPL,IND,2020.0,34,43,-9
TWN,CHN,1999.0,62,51,11
IND,BRA,2015.0,32,6,26
CIV,FRA,2010.0,42,26,16
ESP,ARG,2005.0,54,86,-32
ZAF,CAN,2021.0,43,17,26
USA,GRC,2006.0,121,93,28
GBR,AUS,2023.0,273,282,-9
ROU,ITA,2016.0,14,16,-2
KOR,FRA,2008.0,14,22,-8
FRA,KOR,2010.0,26,28,-2
DEU,BRA,2008.0,57,63,-6
NLD,USA,2007.0,309,275,34
ARG,USA,2001.0,145,101,44
USA,ARG,2004.0,88,192,-104
CHN,DEU,2001.0,120,83,37
MAR,BEL,2013.0,2,6,-4
USA,CAN,2023.0,814,1060,-246
FRA,GBR,2001.0,457,337,120
GBR,FRA,2011.0,465,422,43
BGR,GBR,2002.0,13,10,3
FRA,CHE,2019.0,395,264,131
IRN,SGP,2013.0,19,4,15
AUS,USA,2009.0,488,622,-134
GBR,NLD,2010.0,249,212,37
BRA,PRT,2013.0,97,95,2
IRL,GBR,1998.0,120,127,-7
GUY,USA,2011.0,1,1,0
IND,JPN,2007.0,68,72,-4
AUT,SWE,2022.0,17,16,1
ARG,BRA,2004.0,27,18,9
BRA,ARG,2008.0,25,24,1
USA,IRL,2005.0,114,83,31
USA,FRA,2005.0,652,733,-81
DZA,FRA,2006.0,35,58,-23
FRA,DZA,2007.0,71,30,41
ROU,HUN,2020.0,15,17,-2
FRA,MEX,2008.0,67,42,25
ESP,USA,2021.0,483,444,39
USA,ESP,2022.0,396,413,-17
USA,AUS,2001.0,467,598,-131
ITA,FRA,2014.0,347,216,131
JPN,IDN,2007.0,55,15,40
IRL,USA,2007.0,100,120,-20
DEU,USA,2015.0,1341,1246,95
ESP,MEX,2010.0,105,133,-28
CHN,SGP,2007.0,110,108,2
DEU,CMR,2010.0,8,4,4
KOR,CAN,2010.0,52,60,-8
FIN,CHE,2005.0,11,8,3
CHE,CAN,2022.0,75,94,-19
CHN,CAN,2008.0,186,165,21
VEN,ESP,2010.0,52,44,8
AUS,NZL,2006.0,95,125,-30
CAN,COL,2019.0,17,21,-4
GBR,GHA,2007.0,16,7,9
SGP,DEU,2008.0,14,38,-24
GBR,JPN,2014.0,153,119,34
ITA,SWE,2004.0,21,14,7
SWE,NOR,2009.0,77,36,41
ISR,USA,2017.0,435,368,67
KOR,FRA,2004.0,9,4,5
IRL,AUS,2017.0,44,39,5
CHE,USA,2000.0,422,364,58
AUS,KOR,2004.0,17,4,13
IRL,GBR,1999.0,148,145,3
NZL,JPN,2009.0,11,12,-1
MEX,FRA,2007.0,35,50,-15
USA,MEX,2019.0,378,295,83
DEU,ITA,2015.0,201,314,-113
USA,AUS,2004.0,486,474,12
BRA,GBR,2006.0,44,75,-31
USA,CHL,2016.0,165,126,39
USA,SEN,2007.0,11,3,8
FRA,ESP,2016.0,226,354,-128
DEU,JPN,2016.0,151,151,0
FIN,NLD,2016.0,25,14,11
USA,BEL,2006.0,114,128,-14
JPN,USA,2016.0,883,1012,-129
USA,ESP,2017.0,463,627,-164
CHE,DEU,1999.0,286,325,-39
IND,ISR,2003.0,22,6,16
NOR,USA,2017.0,80,111,-31
RUS,GBR,2022.0,86,39,47
ITA,DEU,2004.0,147,158,-11
SRB,RUS,2020.0,7,4,3
USA,PRI,2014.0,114,193,-79
PRI,USA,2015.0,219,134,85
MAC,CHN,2010.0,33,36,-3
JPN,POL,1999.0,17,20,-3
JPN,DEU,2012.0,140,112,28
SWE,FIN,2008.0,26,34,-8
FIN,GBR,2011.0,38,50,-12
CHN,UKR,2018.0,6,17,-11
ZAF,SWE,2007.0,6,6,0
ESP,ITA,2016.0,216,230,-14
USA,EGY,2013.0,119,78,41
DEU,ITA,2014.0,190,308,-118
GRC,DEU,2010.0,52,35,17
IRN,USA,2013.0,411,78,333
AUS,SWE,2016.0,55,46,9
CHE,GBR,2022.0,251,312,-61
PRT,HUN,1999.0,1,6,-5
HUN,PRT,2003.0,4,1,3
MEX,BEL,2001.0,4,8,-4
SAU,ZAF,2011.0,10,20,-10
BEL,DEU,2015.0,108,130,-22
AUS,USA,2019.0,717,746,-29
KOR,DEU,2012.0,42,38,4
USA,MEX,2009.0,239,245,-6
CHE,DEU,2007.0,357,508,-151
SWE,GBR,2023.0,88,123,-35
DEU,IND,2013.0,126,139,-13
SWE,NZL,2001.0,5,7,-2
NZL,SWE,2022.0,14,4,10
SGP,NZL,2006.0,7,5,2
ISR,CHE,2007.0,11,6,5
RUS,FRA,2009.0,57,47,10
USA,ECU,2009.0,15,14,1
CHE,ITA,2013.0,131,230,-99
JPN,BRA,2007.0,9,12,-3
ITA,BEL,2005.0,35,48,-13
LUX,DEU,2018.0,33,42,-9
GBR,IND,2014.0,176,160,16
JPN,THA,2005.0,81,35,46
USA,NLD,2005.0,253,271,-18
NLD,CAN,2010.0,63,69,-6
RUS,UKR,2012.0,48,55,-7
DNK,DEU,2018.0,129,165,-36
DEU,ITA,2004.0,158,147,11
CAN,JPN,2011.0,92,98,-6
MYS,BRN,2022.0,11,3,8
USA,TUR,2014.0,355,237,118
HKG,USA,2009.0,120,133,-13
GBR,GEO,2011.0,3,1,2
IND,TWN,2011.0,51,44,7
AUT,ITA,2013.0,46,47,-1
USA,ROU,2017.0,36,21,15
AUS,CHN,2012.0,184,210,-26
NLD,ESP,2014.0,73,115,-42
GBR,HKG,2015.0,62,55,7
NLD,BEL,2020.0,194,209,-15
DEU,BEL,1999.0,61,42,19
GBR,BRA,2007.0,60,48,12
CAN,EGY,2008.0,25,22,3
SAU,PAK,2009.0,10,19,-9
USA,GEO,2022.0,181,133,48
LBN,USA,2019.0,103,63,40
ARG,NZL,2006.0,1,1,0
THA,USA,2005.0,94,174,-80
USA,CYP,2006.0,24,10,14
AUS,BGD,2015.0,23,71,-48
USA,GBR,2013.0,1667,1853,-186
DEU,BEL,2020.0,135,132,3
RUS,BLR,2021.0,23,20,3
GBR,CAN,2018.0,432,416,16
USA,URY,2010.0,14,9,5
DEU,CHE,2004.0,467,299,168
USA,SGP,2013.0,285,207,78
ITA,SWE,2015.0,84,35,49
GBR,QAT,2015.0,51,11,40
GBR,EGY,2008.0,37,24,13
JPN,FRA,2013.0,75,95,-20
IND,ESP,2023.0,19,10,9
ITA,PRT,2009.0,21,8,13
ARG,BRA,2015.0,47,31,16
USA,ITA,2007.0,412,516,-104
DEU,CZE,2005.0,26,33,-7
DEU,IND,2003.0,56,96,-40
GBR,SGP,2007.0,68,43,25
KOR,CAN,2000.0,11,27,-16
DEU,POL,2011.0,98,98,0
HUN,USA,2004.0,89,87,2
DNK,ESP,2014.0,14,34,-20
USA,TWN,2001.0,296,203,93
NLD,USA,2020.0,420,515,-95
GRC,SWE,2011.0,18,6,12
AUT,CZE,2011.0,8,14,-6
DNK,CAN,2000.0,13,17,-4
SGP,USA,2012.0,199,276,-77
CAN,BLR,2011.0,1,2,-1
SWE,DNK,2008.0,95,61,34
AUS,CHN,2005.0,63,55,8
DNK,CHE,2011.0,27,33,-6
MEX,GBR,2022.0,50,44,6
MYS,AUS,2009.0,40,36,4
ISR,USA,2018.0,441,368,73
LTU,DEU,2003.0,8,6,2
NZL,GBR,2008.0,115,136,-21
USA,TUR,2004.0,229,176,53
USA,ARG,2014.0,105,125,-20
CHN,FRA,2016.0,169,228,-59
DNK,FIN,2007.0,8,7,1
FIN,NOR,2010.0,13,6,7
CHE,ARG,2012.0,2,10,-8
FRA,ITA,2003.0,180,197,-17
GBR,KOR,2005.0,33,31,2
MEX,USA,2008.0,177,222,-45
USA,ITA,2020.0,547,581,-34
AUS,GBR,2007.0,401,494,-93
CHN,JPN,2001.0,233,263,-30
BEL,GBR,2012.0,106,98,8
SWE,FIN,2014.0,43,52,-9
PRT,POL,2020.0,7,9,-2
CHE,SWE,2012.0,50,69,-19
SWE,JPN,2006.0,34,22,12
HUN,GBR,2014.0,46,30,16
AUT,AUS,2008.0,29,28,1
IDN,DEU,2009.0,8,13,-5
FIN,DNK,2012.0,14,9,5
EGY,HUN,1997.0,2,1,1
DEU,AUS,2005.0,121,91,30
CHN,BEL,2005.0,14,23,-9
KEN,GBR,2013.0,18,27,-9
AUS,NLD,2006.0,18,42,-24
NLD,AUS,2011.0,73,55,18
GBR,NGA,2007.0,17,25,-8
TWN,JPN,2002.0,23,31,-8
KOR,ARE,2019.0,16,1,15
DEU,GRC,2022.0,52,60,-8
MAR,FRA,2008.0,49,83,-34
ARG,USA,2008.0,111,129,-18
SAU,IND,2019.0,88,161,-73
USA,AUT,2008.0,104,116,-12
CHE,BEL,2020.0,49,77,-28
AUT,DEU,2003.0,180,216,-36
CHE,FRA,2016.0,263,424,-161
SWE,DEU,2013.0,114,173,-59
TWN,GBR,2021.0,32,42,-10
CZE,BGR,2016.0,3,3,0
FRA,CHL,2018.0,49,35,14
ZAF,NLD,2006.0,12,18,-6
SGP,ISR,2015.0,4,6,-2
NOR,GBR,2013.0,45,77,-32
USA,CHL,2017.0,178,137,41
ESP,AUT,2005.0,8,8,0
AUT,ESP,2014.0,15,38,-23
SGP,USA,2005.0,102,125,-23
AUS,DEU,2005.0,91,121,-30
BRA,USA,2019.0,718,445,273
NLD,SGP,2000.0,6,1,5
CAN,FRA,2018.0,309,372,-63
SAU,OMN,2006.0,3,2,1
TUR,CYP,2012.0,42,26,16
GBR,IND,2008.0,112,171,-59
PRT,FRA,2009.0,32,38,-6
JPN,GBR,2023.0,76,64,12
NGA,GBR,2005.0,18,14,4
BRA,FRA,2018.0,148,146,2
USA,AUT,2015.0,149,161,-12
RUS,DEU,2003.0,239,153,86
CHE,ESP,2004.0,43,19,24
USA,THA,2005.0,174,94,80
USA,EGY,2003.0,95,48,47
FRA,SAU,2015.0,38,14,24
AUS,DEU,2002.0,72,104,-32
ITA,GBR,2005.0,215,193,22
NLD,ESP,2015.0,62,84,-22
GBR,NLD,2006.0,139,212,-73
FRA,PYF,2008.0,13,6,7
CHN,RUS,2016.0,16,17,-1
NZL,DEU,2012.0,28,31,-3
JPN,IND,2003.0,61,76,-15
HUN,ITA,2023.0,10,7,3
BGR,CZE,2016.0,3,3,0
CZE,BGR,2018.0,2,2,0
TWN,DEU,2010.0,16,12,4
FIN,CHN,2004.0,11,7,4
SWE,USA,2021.0,254,291,-37
IRN,GBR,2002.0,11,59,-48
ITA,CHE,2012.0,234,108,126
NLD,FRA,2001.0,82,112,-30
CAN,ISR,2012.0,51,68,-17
GBR,HKG,2014.0,74,46,28
ESP,ITA,2017.0,177,223,-46
COL,ARG,2006.0,2,3,-1
ARG,COL,2008.0,5,4,1
FRA,SWE,2001.0,49,52,-3
ZWE,ZAF,2006.0,16,3,13
PRT,FRA,2011.0,38,42,-4
KOR,CAN,2006.0,36,39,-3
NGA,USA,2007.0,18,28,-10
USA,IND,2021.0,894,1602,-708
CAN,ESP,2002.0,28,15,13
IRL,GBR,2020.0,426,512,-86
ITA,GRC,2010.0,28,22,6
LBN,QAT,2022.0,14,2,12
DNK,USA,2016.0,155,177,-22
CIV,ZAF,2013.0,8,1,7
DEU,AUS,2012.0,174,160,14
CHE,ARE,2017.0,1,1,0
IND,AUS,2011.0,81,61,20
AUS,IND,2013.0,62,96,-34
RUS,CHE,2020.0,33,17,16
USA,PRI,2015.0,134,219,-85
CHN,JPN,2014.0,322,592,-270
DNK,ITA,2006.0,9,19,-10
USA,AUT,2014.0,151,147,4
ESP,NOR,2008.0,10,5,5
CHL,FRA,2008.0,25,21,4
DEU,ITA,2008.0,144,187,-43
CHE,ITA,2003.0,87,104,-17
CHN,HKG,2007.0,302,282,20
USA,ARE,2016.0,90,46,44
CHE,BEL,2007.0,24,22,2
DEU,CHE,2001.0,418,373,45
RUS,IRL,2007.0,5,1,4
IND,CHE,2009.0,29,16,13
FRA,ARG,2022.0,24,24,0
ARG,FRA,2023.0,21,7,14
AUS,ARG,2014.0,6,13,-7
GBR,KOR,2002.0,41,23,18
USA,ECU,2011.0,9,11,-2
SWE,USA,2009.0,220,223,-3
IND,KWT,2009.0,7,2,5
CIV,FRA,2023.0,6,14,-8
ESP,CHE,2011.0,74,49,25
BEL,HUN,2008.0,8,6,2
DEU,CAN,2010.0,164,169,-5
GRC,ITA,2007.0,27,22,5
ITA,TUR,2016.0,14,33,-19
GBR,JPN,2004.0,117,113,4
DEU,EGY,2013.0,62,35,27
GBR,POL,1999.0,23,32,-9
GBR,IRL,2019.0,484,286,198
CAN,AUS,2016.0,191,171,20
PRT,BRA,2020.0,176,243,-67
IRN,CYP,2019.0,1,1,0
SVK,CHE,2012.0,5,1,4
GBR,BEL,2014.0,113,129,-16
AUS,NOR,2015.0,15,13,2
AUS,JPN,2017.0,72,57,15
THA,AUS,2013.0,28,36,-8
NZL,USA,2016.0,145,107,38
GBR,FRA,2021.0,480,508,-28
GLP,FRA,2010.0,46,18,28
SGP,THA,2014.0,7,4,3
ESP,ITA,2018.0,197,244,-47
IND,USA,1999.0,400,233,167
USA,GUM,2016.0,12,8,4
USA,GUM,2022.0,17,8,9
CHN,DEU,2015.0,340,335,5
AUT,SAU,2013.0,4,1,3
CHN,GBR,2010.0,208,226,-18
VEN,USA,2009.0,34,34,0
DEU,HRV,2007.0,17,11,6
USA,SWE,2003.0,234,264,-30
IND,BRA,2014.0,17,13,4
USA,CHL,2018.0,140,145,-5
ARM,DEU,2007.0,4,4,0
DEU,ESP,2012.0,185,236,-51
DEU,BRA,2015.0,98,97,1
DEU,CHE,2015.0,663,508,155
NZL,NLD,2012.0,11,15,-4
HUN,SVK,2011.0,4,2,2
NOR,SWE,1999.0,29,55,-26
ESP,PER,2018.0,33,19,14
USA,PRI,2001.0,63,70,-7
USA,PRI,2004.0,78,89,-11
SWE,LVA,2009.0,7,1,6
CHN,SGP,1998.0,57,6,51
SGP,USA,2002.0,133,109,24
HRV,DEU,2001.0,17,10,7
TWN,THA,2019.0,21,8,13
NLD,DNK,2008.0,21,21,0
JPN,HKG,2013.0,11,10,1
IND,GBR,2006.0,125,104,21
GBR,IND,2015.0,187,170,17
GBR,CAN,2016.0,380,432,-52
FRA,SAU,2004.0,7,3,4
SAU,DZA,2007.0,2,6,-4
GBR,IRN,2009.0,68,36,32
ESP,CHL,2006.0,42,36,6
NLD,CHE,2015.0,111,77,34
USA,CAN,2000.0,1102,1578,-476
DEU,EGY,2003.0,30,14,16
IND,OMN,2011.0,14,7,7
NLD,USA,1999.0,262,197,65
FRA,SWE,2008.0,51,52,-1
DNK,FRA,2011.0,22,32,-10
ESP,BEL,2013.0,67,38,29
KOR,AUS,2007.0,14,8,6
NGA,ITA,2003.0,2,7,-5
SAU,TUN,2021.0,75,122,-47
CHE,GBR,2018.0,276,297,-21
BEL,NLD,2006.0,101,77,24
COL,KEN,2017.0,2,1,1
SGP,IND,2010.0,32,54,-22
CHE,DEU,1998.0,251,275,-24
USA,NOR,2005.0,66,53,13
CAN,THA,2007.0,19,10,9
CAN,AUT,2017.0,33,20,13
IND,ITA,2008.0,34,15,19
VNM,JPN,2004.0,4,10,-6
BFA,USA,2010.0,3,2,1
PHL,CHE,2010.0,3,3,0
ESP,BRA,1997.0,25,15,10
GBR,MEX,2023.0,27,27,0
FRA,IRN,2005.0,20,5,15
NLD,ROU,2018.0,7,7,0
POL,GBR,2007.0,53,32,21
DEU,PAK,2020.0,34,42,-8
CHN,ESP,2003.0,5,2,3
JAM,USA,1998.0,8,4,4
HUN,FRA,2011.0,24,15,9
GRC,USA,2005.0,97,109,-12
CHN,BEL,1997.0,9,11,-2
NLD,CHN,2018.0,161,141,20
KOR,MYS,2014.0,25,10,15
GBR,KEN,2012.0,29,14,15
CAN,EGY,2014.0,51,34,17
JPN,USA,2022.0,641,615,26
MEX,USA,2001.0,215,238,-23
FRA,PRT,2017.0,35,60,-25
AUT,NLD,2011.0,20,20,0
POL,SRB,2006.0,7,4,3
JPN,CHN,2006.0,369,250,119
ARG,ESP,2020.0,113,88,25
BRA,USA,2021.0,755,440,315
USA,ARG,2008.0,129,111,18
SWE,NOR,2011.0,76,50,26
USA,MOZ,2009.0,4,2,2
CAN,GBR,2002.0,264,316,-52
USA,ARG,2015.0,130,112,18
ISR,FRA,2001.0,23,28,-5
SWE,USA,2019.0,280,269,11
USA,ISL,2009.0,22,11,11
SVK,FRA,2008.0,4,6,-2
ESP,SWE,2006.0,21,23,-2
ITA,CHN,1997.0,20,9,11
AUS,CHN,1997.0,15,17,-2
AUS,IRL,2010.0,31,48,-17
CHN,KOR,2005.0,41,59,-18
IND,ARE,2011.0,22,4,18
THA,GBR,2005.0,19,71,-52
USA,ARE,2018.0,123,58,65
CHN,CAN,2014.0,316,290,26
IND,CAN,2003.0,53,26,27
USA,DNK,1998.0,89,120,-31
GBR,GRC,2005.0,154,97,57
HKG,USA,2021.0,158,164,-6
HRV,DEU,2015.0,25,7,18
DEU,JPN,2017.0,128,144,-16
KOR,VNM,2006.0,6,2,4
GRC,USA,2002.0,100,141,-41
CAN,EGY,2015.0,45,37,8
ROU,USA,2003.0,49,20,29
ESP,AUS,2007.0,20,14,6
CHN,PRT,2001.0,8,3,5
GRC,NLD,2012.0,23,17,6
HKG,FRA,2010.0,7,7,0
FIN,GBR,2009.0,54,32,22
SGP,CHE,2015.0,16,23,-7
ECU,USA,2006.0,19,11,8
BEL,CHE,2003.0,22,19,3
GBR,SAU,2021.0,273,92,181
DEU,FRA,2002.0,301,342,-41
ESP,BRA,2012.0,103,78,25
NLD,CAN,2000.0,34,40,-6
DEU,TUR,2022.0,43,96,-53
SWE,FIN,2015.0,54,70,-16
GBR,MYS,2011.0,120,42,78
GBR,HUN,2020.0,33,42,-9
CAN,COL,2011.0,10,12,-2
MNG,RUS,2016.0,2,5,-3
CAN,CZE,2016.0,12,13,-1
ESP,GBR,2004.0,161,186,-25
GBR,SWE,2004.0,80,101,-21
ESP,FRA,2013.0,275,166,109
FRA,ITA,2013.0,236,380,-144
USA,AUT,2001.0,118,146,-28
POL,CHE,1999.0,21,17,4
BEL,BOL,2013.0,4,1,3
DNK,CAN,2010.0,19,22,-3
JPN,ITA,2006.0,22,13,9
USA,MNG,2012.0,4,2,2
FRA,HUN,2004.0,12,11,1
IRL,AUT,2011.0,6,2,4
DNK,USA,2018.0,154,176,-22
ESP,CHE,2009.0,48,43,5
SWE,NLD,2008.0,28,31,-3
CAN,AUS,2018.0,215,198,17
IND,JPN,2020.0,137,81,56
BRA,COL,2010.0,20,18,2
CZE,HRV,2003.0,2,3,-1
GBR,CZE,2007.0,39,61,-22
SWE,AUS,2013.0,46,46,0
SGP,NLD,2009.0,10,11,-1
AUT,SWE,2018.0,34,19,15
FRA,IND,2008.0,27,86,-59
ESP,DEU,2020.0,297,247,50
ITA,DEU,2015.0,314,201,113
FIN,BEL,2017.0,14,10,4
FIN,BEL,2022.0,11,15,-4
RUS,FRA,2021.0,69,44,25
JPN,AUS,2010.0,82,58,24
GBR,AUT,2006.0,36,55,-19
AUT,JPN,2010.0,14,13,1
USA,MAC,2010.0,7,1,6
MAC,USA,2013.0,3,10,-7
KOR,JPN,2017.0,113,161,-48
GBR,ARG,2009.0,9,13,-4
DEU,TUR,2018.0,52,104,-52
DEU,FRA,1997.0,184,197,-13
EGY,CAN,2002.0,6,3,3
CHE,FRA,2018.0,283,378,-95
FRA,CHE,2021.0,374,262,112
VEN,ESP,2006.0,25,20,5
ARG,USA,2004.0,192,88,104
KOR,NOR,2008.0,3,1,2
ITA,DEU,2014.0,308,190,118
KOR,NLD,2008.0,4,1,3
USA,JOR,2009.0,48,14,34
SWE,TUR,2011.0,6,8,-2
RUS,NLD,2011.0,13,17,-4
IND,SVN,2010.0,2,1,1
IND,DNK,2015.0,16,7,9
IRN,CAN,2012.0,206,56,150
PSE,ISR,2007.0,2,12,-10
ARG,USA,2015.0,112,130,-18
TWN,KOR,2010.0,20,9,11
NZL,CAN,2023.0,14,17,-3
USA,PHL,2011.0,37,35,2
NZL,ITA,2019.0,6,4,2
SWE,ITA,2008.0,31,40,-9
USA,ZMB,2008.0,9,2,7
USA,ZMB,2015.0,14,18,-4
THA,CAN,2010.0,16,25,-9
SVN,DEU,2006.0,8,8,0
DEU,SVN,2008.0,8,5,3
GBR,LUX,2007.0,3,2,1
IND,JPN,1999.0,80,38,42
DEU,AUT,2020.0,442,340,102
CAN,JPN,2009.0,93,99,-6
ETH,DEU,2014.0,11,9,2
ESP,TUR,2016.0,7,9,-2
TWN,UKR,2005.0,3,3,0
GRC,CHE,2013.0,37,10,27
CHE,GRC,2014.0,14,40,-26
HUN,USA,2008.0,76,75,1
AUS,TUR,2018.0,16,13,3
CUB,CHL,2009.0,3,1,2
HUN,SWE,2013.0,14,11,3
BRA,ESP,2003.0,34,43,-9
CAN,ETH,2012.0,2,1,1
ZMB,USA,2013.0,17,16,1
CAN,ZAF,2006.0,14,18,-4
IRN,NLD,2004.0,3,1,2
BRA,ARG,2015.0,31,47,-16
COL,VEN,2021.0,14,21,-7
GBR,QAT,2004.0,3,1,2
FIN,ITA,2010.0,9,21,-12
CHE,SWE,2005.0,26,34,-8
SWE,IDN,2008.0,2,2,0
ECU,DEU,2011.0,1,5,-4
TUN,USA,2021.0,9,2,7
PER,DEU,2008.0,1,2,-1
IND,SWE,2008.0,15,9,6
FRA,LUX,2020.0,30,19,11
CAN,DEU,2003.0,122,161,-39
NOR,DEU,2013.0,40,75,-35
GBR,SGP,2020.0,137,122,15
PRT,DEU,2005.0,16,18,-2
ESP,NLD,2016.0,115,76,39
NZL,GBR,2014.0,118,127,-9
ZAF,CAN,2011.0,17,19,-2
BEL,DEU,2004.0,68,55,13
ETH,GBR,2005.0,2,3,-1
RUS,FIN,2016.0,31,33,-2
PRT,CHN,2017.0,13,7,6
RUS,CHE,2007.0,19,8,11
FRA,LBN,2010.0,42,23,19
ITA,RUS,2018.0,26,25,1
FRA,CMR,2019.0,24,22,2
FRA,CMR,2021.0,26,15,11
AUT,SVK,2013.0,11,11,0
BEL,PRT,2006.0,4,6,-2
IRN,CAN,2005.0,49,54,-5
OMN,GBR,2006.0,6,9,-3
DEU,DNK,2003.0,75,62,13
DNK,CHE,2009.0,16,28,-12
DNK,CHE,2019.0,49,47,2
DEU,LUX,2016.0,25,28,-3
HRV,AUT,2005.0,3,3,0
MYS,SGP,2009.0,11,22,-11
FRA,FIN,2010.0,22,23,-1
IDN,AUS,2009.0,7,31,-24
ITA,NOR,2002.0,11,12,-1
AUT,AUS,2015.0,37,66,-29
FRA,NLD,2011.0,97,92,5
CHE,AUT,2016.0,67,79,-12
USA,BGD,2007.0,21,16,5
KAZ,RUS,2015.0,30,43,-13
NLD,NZL,2015.0,17,23,-6
FRA,DNK,2005.0,22,18,4
BGD,ITA,2011.0,8,2,6
USA,ARE,2017.0,82,60,22
AUS,USA,2021.0,674,583,91
GBR,MEX,2006.0,50,27,23
FIN,IND,2008.0,4,5,-1
ITA,POL,2015.0,24,22,2
GBR,DNK,2002.0,74,59,15
FRA,MEX,2014.0,40,39,1
DEU,BEL,2007.0,95,54,41
USA,ISR,2018.0,368,441,-73
IRL,SWE,2008.0,8,14,-6
HUN,DEU,2014.0,58,39,19
HUN,FRA,2009.0,13,17,-4
USA,MDG,2007.0,4,4,0
ISR,CAN,2005.0,58,27,31
USA,UGA,2009.0,18,11,7
CAN,MEX,2012.0,33,36,-3
ESP,PRT,2016.0,138,86,52
CHE,CAN,2016.0,99,112,-13
NLD,KEN,2007.0,6,5,1
BGR,BEL,2008.0,3,7,-4
PAK,GBR,2007.0,21,37,-16
SAU,PAK,2019.0,100,92,8
RUS,KGZ,2011.0,5,1,4
AUS,AUT,2005.0,24,18,6
KOR,JPN,2022.0,54,108,-54
CHN,ITA,2009.0,22,20,2
CHN,SWE,2011.0,86,66,20
FRA,RUS,2002.0,60,74,-14
GBR,QAT,2014.0,33,6,27
BEL,TUN,2015.0,2,3,-1
CHE,IRL,2023.0,10,11,-1
TWN,JPN,2012.0,45,38,7
COD,COG,2007.0,6,7,-1
NLD,SWE,2017.0,86,43,43
USA,AUT,2004.0,93,100,-7
TUR,NOR,2001.0,1,2,-1
CYP,TUR,2014.0,52,49,3
FRA,SWE,2004.0,44,42,2
GBR,HKG,2008.0,39,39,0
GBR,ISR,2003.0,32,50,-18
GBR,CZE,1998.0,51,34,17
CZE,DEU,2000.0,30,33,-3
DEU,CZE,2002.0,33,44,-11
EGY,SAU,2020.0,380,338,42
CZE,GBR,2004.0,22,30,-8
IND,KOR,2021.0,240,170,70
FRA,BEL,2000.0,141,151,-10
CAN,RUS,2006.0,16,25,-9
TUN,FRA,2014.0,86,150,-64
FRA,JPN,2016.0,106,83,23
USA,KEN,2012.0,51,45,6
USA,UGA,2011.0,20,26,-6
DEU,SVK,2013.0,12,11,1
GBR,PRT,2017.0,86,135,-49
BGD,USA,2011.0,33,23,10
BRA,FRA,2017.0,131,147,-16
TTO,BRB,2011.0,4,1,3
IRN,BEL,2023.0,17,4,13
IND,GBR,2010.0,123,143,-20
RUS,GBR,2017.0,55,46,9
GBR,ITA,2020.0,507,574,-67
GRC,GBR,2005.0,97,154,-57
BEL,LUX,2012.0,10,10,0
CHE,BRA,2011.0,9,11,-2
TUR,IRQ,2020.0,32,6,26
COL,USA,2016.0,136,150,-14
GBR,SAU,2011.0,86,16,70
GEO,USA,2000.0,26,46,-20
NOR,DNK,2008.0,32,26,6
DEU,RUS,2017.0,118,143,-25
DEU,RUS,2022.0,57,152,-95
GBR,TWN,2011.0,45,28,17
DNK,GBR,2013.0,72,85,-13
GBR,MYS,2009.0,103,46,57
MYS,GBR,2018.0,108,170,-62
MYS,CHN,2023.0,76,73,3
NOR,DNK,2001.0,31,26,5
CHE,GBR,2017.0,258,321,-63
HUN,NLD,2003.0,8,9,-1
DEU,HUN,2018.0,26,61,-35
GBR,DNK,2005.0,49,74,-25
VEN,NLD,2005.0,1,1,0
MEX,DEU,2005.0,18,21,-3
PAK,LKA,2006.0,1,1,0
ISR,IND,2007.0,13,21,-8
FRA,MEX,2001.0,37,22,15
FRA,BFA,2016.0,16,11,5
MEX,USA,2014.0,267,267,0
CHN,BRA,2021.0,8,23,-15
SWE,POL,1999.0,6,15,-9
JPN,SGP,2017.0,36,50,-14
IRL,AUS,2018.0,30,42,-12
NGA,USA,2020.0,70,51,19
GBR,BEL,2015.0,118,127,-9
MAR,FRA,2004.0,63,63,0
CHN,TUR,2016.0,5,6,-1
NGA,GMB,2006.0,3,3,0
CHE,NZL,2008.0,6,6,0
USA,FRA,1997.0,441,526,-85
FIN,SWE,2020.0,79,72,7
DNK,USA,2017.0,165,148,17
RUS,BEL,2009.0,9,1,8
RUS,BLR,2009.0,21,18,3
AUS,SAU,2007.0,6,4,2
JPN,LKA,2006.0,7,2,5
GBR,SWE,2008.0,99,128,-29
ZAF,TWN,2005.0,2,1,1
GRC,CYP,2022.0,55,45,10
USA,FIN,2018.0,68,119,-51
NLD,NOR,2010.0,27,8,19
AUS,GBR,1998.0,249,301,-52
USA,GEO,2017.0,210,140,70
DEU,COL,2016.0,19,21,-2
BRA,FRA,2016.0,165,138,27
PRT,BRA,2007.0,52,48,4
FRA,CMR,2011.0,29,14,15
SAU,CAN,2010.0,31,65,-34
HKG,AUS,2014.0,48,31,17
PRT,DEU,2012.0,30,39,-9
DNK,GHA,1998.0,2,3,-1
GBR,MYS,2019.0,129,87,42
NLD,SWE,2016.0,60,52,8
CAN,SAU,2003.0,19,15,4
POL,USA,2018.0,138,122,16
GBR,GRC,2002.0,144,73,71
USA,OMN,2005.0,11,4,7
IDN,AUS,2019.0,35,93,-58
CAN,BEL,2020.0,51,47,4
JPN,THA,2012.0,100,62,38
EGY,SWE,2013.0,10,6,4
PRT,USA,2006.0,40,57,-17
ESP,CZE,2013.0,21,6,15
USA,KOR,2021.0,797,850,-53
CHE,SWZ,2018.0,7,8,-1
SWZ,CHE,2020.0,10,8,2
ARG,FRA,2010.0,35,18,17
FRA,ISR,2005.0,22,26,-4
ISR,FRA,2008.0,26,19,7
CHL,ITA,2010.0,4,5,-1
IND,DEU,2018.0,211,146,65
GBR,IND,2001.0,74,104,-30
CAN,JOR,2007.0,7,7,0
MYS,PAK,2013.0,22,30,-8
ITA,BRA,2004.0,23,24,-1
FRA,CAN,2012.0,363,283,80
TUR,DEU,2017.0,74,46,28
SWE,DEU,2003.0,97,95,2
SRB,DEU,2009.0,15,11,4
ESP,MEX,2000.0,66,76,-10
MEX,COL,2011.0,25,22,3
USA,GEO,2016.0,171,66,105
ARG,USA,2014.0,125,105,20
CHL,BEL,2012.0,6,5,1
CAN,IRN,2005.0,54,49,5
GRC,SRB,2006.0,6,3,3
DNK,SWE,2014.0,94,75,19
CYP,TUR,2015.0,56,59,-3
SGP,ISR,2008.0,4,1,3
RUS,TWN,2008.0,5,3,2
GBR,ISL,2010.0,12,6,6
AUS,FRA,2017.0,91,103,-12
COL,MEX,2012.0,20,24,-4
DEU,CUB,2013.0,2,12,-10
BEL,CHN,2011.0,31,36,-5
QAT,AUS,2012.0,3,5,-2
IND,HKG,2014.0,8,7,1
CAN,SWE,2023.0,28,15,13
SEN,FRA,2013.0,24,32,-8
FRA,LBN,2006.0,32,15,17
GBR,ITA,1999.0,194,214,-20
CHL,ESP,2013.0,63,132,-69
AUS,NOR,2014.0,13,12,1
IND,ZAF,2020.0,44,30,14
PAK,USA,2014.0,87,67,20
MYS,IDN,2018.0,110,15,95
MYS,JPN,2020.0,39,43,-4
GBR,ZMB,2019.0,7,10,-3
CHE,SWE,2002.0,30,49,-19
ITA,IND,2013.0,49,50,-1
CZE,ITA,2020.0,18,27,-9
CUB,BRA,2018.0,18,8,10
SWE,NOR,2021.0,90,84,6
MEX,CHL,2004.0,4,5,-1
GBR,AUS,2000.0,347,320,27
LKA,IND,2008.0,5,1,4
ESP,FRA,2003.0,135,152,-17
ITA,JPN,2000.0,30,26,4
PRI,NLD,2014.0,1,1,0
DEU,UKR,2003.0,27,46,-19
NLD,CHE,2004.0,47,36,11
CAN,TWN,1999.0,9,6,3
CAN,UKR,1998.0,2,3,-1
DNK,NOR,2015.0,50,41,9
BEL,GBR,2005.0,61,72,-11
RUS,AUT,2009.0,18,8,10
CHE,DNK,2008.0,25,20,5
NZL,GBR,2015.0,126,118,8
USA,AZE,2012.0,3,2,1
TUN,FRA,2008.0,68,113,-45
FRA,NER,2009.0,8,2,6
ESP,SWE,2010.0,40,32,8
ECU,VEN,2021.0,19,16,3
SGP,DNK,2017.0,8,9,-1
USA,ZAF,2010.0,106,95,11
BGR,DEU,2002.0,22,39,-17
SWE,UGA,2009.0,4,1,3
JPN,RUS,2006.0,34,26,8
JPN,RUS,2010.0,24,20,4
ITA,TUR,2017.0,19,19,0
CZE,SRB,2006.0,4,1,3
ARG,ITA,2005.0,16,15,1
POL,ESP,2002.0,10,8,2
ESP,DEU,2007.0,106,158,-52
BRA,MEX,2010.0,26,12,14
UKR,RUS,2018.0,114,85,29
KOR,NLD,2004.0,4,3,1
CAN,AUS,2017.0,212,172,40
GBR,OMN,2016.0,14,9,5
QAT,GBR,2019.0,30,52,-22
USA,SRB,2011.0,36,17,19
GBR,IDN,2011.0,12,1,11
PER,USA,2012.0,25,40,-15
CHE,IRL,2006.0,12,4,8
ESP,BRA,2002.0,37,36,1
SVN,SLV,2017.0,4,4,0
SVK,FRA,2001.0,6,3,3
BRA,CAN,2012.0,77,69,8
JPN,PHL,2012.0,27,17,10
GRC,USA,2012.0,180,104,76
USA,ITA,1999.0,376,477,-101
SGP,AUS,2010.0,71,53,18
CYP,GRC,2017.0,15,55,-40
SWE,POL,2007.0,11,12,-1
BEL,DEU,2008.0,62,89,-27
IRN,AUS,2007.0,25,33,-8
ESP,ARG,2002.0,81,78,3
TUN,USA,2009.0,8,2,6
MYS,QAT,2017.0,5,2,3
POL,CZE,2009.0,9,2,7
EGY,ARE,2010.0,16,9,7
JPN,CHN,2000.0,202,196,6
PSE,EGY,2017.0,4,2,2
ITA,PRT,2011.0,29,19,10
CUB,USA,2001.0,11,6,5
FRA,IND,2014.0,80,83,-3
BEL,MAR,2005.0,3,1,2
THA,JPN,2005.0,35,81,-46
GBR,JPN,2015.0,140,135,5
NLD,IND,1999.0,11,17,-6
ESP,GRC,2017.0,29,18,11
PAK,AUS,2015.0,28,26,2
FIN,IRL,2013.0,2,9,-7
POL,JPN,2016.0,11,22,-11
SAU,CHN,2014.0,20,21,-1
AUT,CHE,2017.0,87,77,10
NOR,CHE,2002.0,9,8,1
FRA,DEU,1998.0,246,204,42
RUS,JPN,1998.0,40,35,5
FRA,BRA,2002.0,91,74,17
USA,NGA,2003.0,15,16,-1
HRV,AUT,1997.0,3,1,2
TWN,CHN,1998.0,53,68,-15
DEU,POL,2019.0,103,83,20
GBR,IRN,2011.0,57,35,22
GBR,QAT,2001.0,4,3,1
NZL,ESP,2023.0,1,1,0
HRV,USA,2000.0,18,16,2
GRC,SAU,2017.0,8,2,6
MDG,FRA,2008.0,7,11,-4
THA,DNK,2008.0,4,1,3
DEU,AUS,1997.0,46,49,-3
DEU,ZAF,2000.0,19,12,7
USA,KOR,2019.0,874,812,62
IRL,AUS,2016.0,41,32,9
GBR,EGY,2015.0,67,32,35
BEL,USA,2018.0,245,190,55
ESP,BEL,2003.0,21,27,-6
GBR,ARE,2008.0,25,9,16
IDN,PHL,2010.0,3,1,2
CAN,DZA,2021.0,14,12,2
NLD,TUR,2011.0,19,28,-9
NLD,AUS,2019.0,91,98,-7
FRA,SWE,2015.0,87,47,40
AUT,FRA,2016.0,35,39,-4
DZA,FRA,2010.0,48,117,-69
ITA,CUB,1997.0,2,3,-1
CAN,NLD,2020.0,73,73,0
AUS,FRA,2018.0,84,89,-5
FRA,ETH,2015.0,2,1,1
OMN,USA,2022.0,7,5,2
FRA,HUN,2008.0,13,15,-2
VEN,USA,2019.0,39,10,29
BEL,BGR,2008.0,7,3,4
NLD,ISR,2021.0,12,17,-5
IND,ITA,2015.0,44,45,-1
USA,TZA,2017.0,27,19,8
GBR,SAU,2009.0,45,22,23
BWA,AUS,2012.0,2,1,1
DEU,GRC,2016.0,53,76,-23
DEU,PRT,2015.0,26,47,-21
AUS,NZL,2023.0,57,84,-27
GBR,TZA,2006.0,13,8,5
GBR,TZA,2010.0,13,5,8
RUS,ESP,2001.0,22,18,4
FRA,IND,2015.0,84,82,2
GBR,CHL,2003.0,21,6,15
AUT,NZL,2014.0,6,6,0
ECU,PER,2020.0,10,5,5
EGY,LBN,2018.0,13,4,9
USA,ZAF,2023.0,56,95,-39
ARG,DEU,2011.0,30,30,0
DEU,KOR,2002.0,13,24,-11
SWE,RUS,2009.0,15,15,0
USA,HRV,2009.0,21,8,13
GRC,BGR,2016.0,3,2,1
SVN,FRA,2011.0,9,1,8
HRV,ITA,2016.0,5,14,-9
ITA,HRV,2017.0,15,6,9
CAN,HUN,2002.0,6,11,-5
MYS,IDN,2016.0,92,11,81
BEL,CHE,2013.0,66,31,35
SAU,GBR,2017.0,62,166,-104
GBR,SAU,2019.0,224,72,152
SWE,CHN,2018.0,123,114,9
SRB,USA,2003.0,23,44,-21
MYS,AUS,2021.0,65,59,6
ITA,SWE,2008.0,40,31,9
PRT,ARG,2016.0,8,2,6
SWE,NOR,2019.0,94,70,24
FRA,IND,2004.0,26,40,-14
CZE,SVK,2015.0,63,79,-16
NZL,CAN,2010.0,34,33,1
SGP,JPN,2010.0,22,33,-11
IRN,ITA,2016.0,38,26,12
FRA,SAU,2014.0,42,7,35
NZL,USA,2018.0,131,144,-13
CAN,KAZ,2017.0,5,1,4
MYS,DEU,2022.0,14,12,2
IRN,DEU,2018.0,99,50,49
MEX,FRA,2020.0,50,30,20
USA,NPL,2018.0,26,46,-20
ITA,ESP,2001.0,94,96,-2
DEU,COL,2022.0,13,33,-20
MAC,CHN,2023.0,343,282,61
AUS,THA,2018.0,43,15,28
LBN,PSE,2022.0,1,0,1
VNM,DZA,2023.0,1,0,1
LVA,IND,2023.0,1,0,1
ECU,MEX,2023.0,2,0,2
ETH,SAU,2023.0,1,0,1
CYP,TGO,2023.0,1,0,1
QAT,BGD,2024.0,1,0,1
PRI,PRT,2009.0,1,0,1
NLD,BEN,2001.0,1,0,1
AZE,CAN,2005.0,1,0,1
MRT,CIV,2004.0,1,0,1
MRT,,2010.0,2,0,2
CRI,SGP,2012.0,1,0,1
PRT,LTU,2011.0,1,0,1
GBR,PYF,2006.0,1,0,1
FRA,AFG,2016.0,3,0,3
SVN,RUS,2005.0,1,0,1
BHS,CAN,2009.0,1,0,1
BGD,KWT,2011.0,1,0,1
JOR,ZAF,2015.0,1,0,1
TJK,RUS,2004.0,1,0,1
CMR,PAK,2002.0,1,0,1
SEN,IND,2008.0,1,0,1
CMR,CAF,1998.0,1,0,1
MAR,AUS,1997.0,1,0,1
DZA,SRB,2004.0,1,0,1
CAF,RWA,2015.0,1,0,1
RUS,TZA,2013.0,1,0,1
VNM,HKG,2014.0,1,0,1
KOR,DNK,1997.0,1,0,1
BFA,DEU,2000.0,1,0,1
ZAF,MAC,2017.0,1,0,1
ROU,SAU,2020.0,1,0,1
JAM,TZA,2007.0,1,0,1
TZA,BRB,2008.0,1,0,1
NGA,LTU,2009.0,1,0,1
PAK,EGY,2003.0,2,0,2
ECU,ITA,2010.0,1,0,1
CAN,PLW,2017.0,1,0,1
FRA,NIC,2014.0,1,0,1
NIC,FRA,2017.0,1,0,1
PSE,HKG,2012.0,1,0,1
ROU,CIV,2021.0,1,0,1
CAN,NAM,2019.0,1,0,1
DEU,NPL,2011.0,2,0,2
COM,ETH,2008.0,1,0,1
POL,MKD,2017.0,1,0,1
ROU,SVN,2017.0,1,0,1
NGA,LSO,2017.0,1,0,1
OMN,IRQ,2017.0,2,0,2
BRA,JOR,2020.0,1,0,1
CMR,PRT,2019.0,1,0,1
KAZ,TWN,2020.0,1,0,1
ROU,LTU,2019.0,1,0,1
LBR,CHE,2016.0,1,0,1
JPN,BHS,2021.0,1,0,1
GHA,ETH,2001.0,1,0,1
URY,PRT,2019.0,1,0,1
POL,SEN,2016.0,1,0,1
BRA,GLP,2017.0,1,0,1
IRN,PHL,2014.0,1,0,1
CZE,LKA,2021.0,1,0,1
MAR,ETH,2023.0,1,0,1
LTU,AUT,2020.0,2,0,2
GHA,GMB,2023.0,1,0,1
TUR,BEN,2020.0,1,0,1
ISL,ARG,2022.0,1,0,1
NZL,MHL,2020.0,1,0,1
MMR,NLD,2008.0,1,0,1
TUR,UKR,2006.0,1,0,1
NOR,LUX,2009.0,1,0,1
DJI,,2010.0,1,0,1
TGO,USA,2011.0,1,0,1
THA,MNG,2002.0,1,0,1
BRA,ARM,2017.0,1,0,1
BRA,ARM,2022.0,1,0,1
JOR,PSE,2001.0,1,0,1
PAN,SGP,1998.0,1,0,1
BRA,THA,2004.0,1,0,1
KWT,VEN,2002.0,1,0,1
RUS,MCO,2000.0,1,0,1
LIE,CHE,2004.0,1,0,1
BEL,EST,2010.0,2,0,2
BEL,REU,2010.0,1,0,1
LAO,JPN,1997.0,1,0,1
BEN,PRT,2000.0,1,0,1
ZAF,CHL,2008.0,2,0,2
VIR,,2010.0,2,0,2
HKG,HUN,2005.0,1,0,1
ARM,JPN,2001.0,1,0,1
URY,AUT,1999.0,1,0,1
AUT,URY,2003.0,1,0,1
USA,ECU,1997.0,1,0,1
UKR,ZAF,2009.0,1,0,1
USA,BRN,2005.0,1,0,1
MAR,HUN,1998.0,1,0,1
CAN,SVN,2003.0,1,0,1
JOR,DNK,1998.0,1,0,1
LBY,ARE,2009.0,1,0,1
MLI,BGD,2007.0,1,0,1
MWI,JPN,2003.0,1,0,1
BRA,HRV,2012.0,1,0,1
AUT,TUR,1999.0,1,0,1
MWI,NZL,2009.0,1,0,1
PYF,USA,2005.0,1,0,1
CUB,BEL,2007.0,1,0,1
BEL,SEN,2021.0,1,0,1
DNK,URY,2014.0,1,0,1
AZE,CYP,2010.0,1,0,1
BEL,IRQ,2013.0,1,0,1
KEN,MOZ,2012.0,1,0,1
SGP,POL,2006.0,1,0,1
NPL,BEL,2007.0,1,0,1
AFG,DEU,2008.0,1,0,1
MAR,GAB,2010.0,1,0,1
GHA,CZE,2011.0,1,0,1
QAT,TUN,2011.0,1,0,1
MLI,NGA,2004.0,1,0,1
TTO,HKG,2018.0,1,0,1
MYS,SWE,2002.0,1,0,1
SDN,IRL,2009.0,1,0,1
BEL,ZWE,2006.0,1,0,1
RUS,VEN,2003.0,1,0,1
UGA,SSD,2019.0,1,0,1
NOR,MOZ,2003.0,1,0,1
TZA,TJK,2013.0,1,0,1
HTI,MWI,2011.0,1,0,1
BGR,NOR,2009.0,2,0,2
GEO,UZB,2022.0,1,0,1
MEX,HND,2003.0,1,0,1
ZWE,KWT,2005.0,1,0,1
KWT,PAK,2008.0,1,0,1
ZMB,ZAF,1998.0,1,0,1
RWA,AUS,1998.0,1,0,1
IRL,UKR,1999.0,1,0,1
DNK,PRT,1997.0,2,0,2
MEX,DOM,2012.0,2,0,2
ZAF,HKG,2003.0,1,0,1
MMR,VNM,2001.0,1,0,1
AUS,NPL,1997.0,1,0,1
CAN,BRB,2020.0,1,0,1
BEL,OMN,2016.0,1,0,1
POL,MEX,2016.0,1,0,1
ARE,BWA,2016.0,1,0,1
CIV,CAN,2011.0,1,0,1
CZE,ARM,2019.0,1,0,1
ARM,CZE,2020.0,1,0,1
SEN,MRT,2016.0,1,0,1
SYC,ZAF,2011.0,1,0,1
EGY,BRB,2017.0,1,0,1
POL,GRL,2015.0,1,0,1
ZWE,ESP,2016.0,1,0,1
NGA,GEO,2021.0,1,0,1
HKG,POL,2010.0,1,0,1
USA,VGB,2022.0,1,0,1
CMR,SAU,2017.0,1,0,1
BTN,NLD,2020.0,1,0,1
MDA,CHE,2014.0,1,0,1
DMA,TTO,2016.0,1,0,1
BGD,GMB,2011.0,1,0,1
OMN,KAZ,2017.0,1,0,1
JPN,LBY,2007.0,1,0,1
BOL,ARG,2023.0,1,0,1
YEM,SGP,2018.0,1,0,1
AUT,KAZ,2018.0,1,0,1
BHR,SWE,2015.0,1,0,1
SWE,BLR,2018.0,1,0,1
IRQ,PAK,2018.0,1,0,1
MYS,JAM,2019.0,1,0,1
CHN,MLI,2014.0,1,0,1
IDN,OMN,2016.0,1,0,1
BIH,CHE,2018.0,1,0,1
,CYM,2014.0,1,0,1
BEN,BRA,2013.0,1,0,1
LTU,ZAF,2017.0,1,0,1
BGD,IRN,2019.0,2,0,2
MYS,MLI,2018.0,1,0,1
PAK,MAC,2020.0,2,0,2
GLP,MTQ,2016.0,1,0,1
CYP,BEL,2022.0,1,0,1
PER,PAN,2019.0,1,0,1
KHM,IND,2019.0,2,0,2
IND,KHM,2022.0,1,0,1
SVN,BLR,2020.0,1,0,1
GUM,FRA,2018.0,1,0,1
MEX,SVN,2008.0,1,0,1
DZA,EST,2019.0,1,0,1
CIV,IND,2000.0,1,0,1
DEU,BRN,1999.0,1,0,1
BLR,ARM,2014.0,1,0,1
KGZ,BGD,2021.0,1,0,1
EGY,FIN,2006.0,1,0,1
SHN,TUR,2018.0,2,0,2
UZB,BRA,2014.0,1,0,1
MEX,BOL,2004.0,1,0,1
PRI,MEX,2016.0,1,0,1
UKR,ISR,2024.0,1,0,1
CMR,SLE,2023.0,1,0,1
IDN,COL,2015.0,1,0,1
ARE,TWN,2009.0,1,0,1
SRB,KAZ,2006.0,2,0,2
ESP,ZAF,2009.0,1,0,1
AZE,GBR,2014.0,1,0,1
PAK,KEN,2011.0,1,0,1
IDN,COL,2008.0,1,0,1
IND,SEN,2015.0,1,0,1
SEN,GBR,2006.0,1,0,1
TUR,UZB,2009.0,1,0,1
PAN,CAN,2023.0,1,0,1
PAK,BGR,2020.0,1,0,1
WSM,,2019.0,1,0,1
KHM,IND,2009.0,1,0,1
GLP,NCL,1998.0,1,0,1
GEO,FRA,1997.0,1,0,1
KWT,IRQ,2016.0,1,0,1
NZL,OMN,2012.0,1,0,1
JPN,JOR,2006.0,1,0,1
ECU,JPN,2022.0,1,0,1
ESP,FJI,2015.0,1,0,1
FRA,LBY,2020.0,1,0,1
COG,CHL,2015.0,1,0,1
DZA,RUS,2020.0,1,0,1
ARM,FRA,2006.0,1,0,1
UKR,MYS,2021.0,1,0,1
MYS,UKR,2022.0,1,0,1
HTI,NPL,2020.0,1,0,1
LBR,PRT,2021.0,1,0,1
SGP,PRT,2021.0,1,0,1
MKD,RUS,2019.0,1,0,1
,TKL,2007.0,1,0,1
ARG,EGY,2020.0,1,0,1
SAU,PHL,2018.0,1,0,1
NGA,TGO,2020.0,1,0,1
ISR,AZE,2022.0,1,0,1
FJI,PHL,1998.0,1,0,1
SGP,BRN,2005.0,1,0,1
SEN,MDG,2017.0,1,0,1
USA,GNB,2000.0,1,0,1
IRN,PAK,2003.0,1,0,1
PAK,TZA,2013.0,1,0,1
CHE,AZE,2004.0,1,0,1
RUS,MLT,1998.0,1,0,1
CRI,POL,2021.0,2,0,2
ISR,KGZ,1999.0,1,0,1
IND,TZA,2009.0,1,0,1
PRI,IRL,2006.0,1,0,1
BLR,NOR,2014.0,1,0,1
THA,MWI,2000.0,1,0,1
DEU,LBY,2021.0,1,0,1
PRT,ARE,2012.0,1,0,1
DNK,SGP,2006.0,1,0,1
ARG,IND,2010.0,1,0,1
LTU,JOR,2020.0,1,0,1
GUM,,2016.0,1,0,1
CIV,CHN,2008.0,1,0,1
SYC,DEU,2008.0,1,0,1
CHE,UGA,2018.0,1,0,1
NPL,CAF,2021.0,1,0,1
ITA,MUS,2015.0,1,0,1
CHE,DEU,2024.0,1,0,1
BOL,CUB,2008.0,1,0,1
CYP,AUS,2009.0,1,0,1
POL,HKG,2008.0,1,0,1
SWE,YEM,2014.0,1,0,1
YEM,FIN,2020.0,1,0,1
JPN,BHR,2018.0,1,0,1
MAR,SEN,2016.0,1,0,1
ISR,EST,2014.0,1,0,1
PSE,GRC,2018.0,1,0,1
NPL,MAR,2020.0,1,0,1
CZE,IDN,2018.0,1,0,1
PER,JPN,2012.0,1,0,1
THA,ISL,2020.0,1,0,1
NOR,GRL,2020.0,1,0,1
IND,ZAF,2024.0,1,0,1
GRL,NOR,2015.0,1,0,1
COL,ISR,2016.0,1,0,1
IRQ,ZAF,2014.0,1,0,1
CHE,IRQ,2020.0,1,0,1
IRL,GHA,2015.0,1,0,1
ZWE,PHL,2019.0,1,0,1
AUT,LBN,2021.0,1,0,1
ERI,THA,2016.0,1,0,1
CZE,BRA,2024.0,1,0,1
VGB,,2021.0,1,0,1
TUN,SVN,2023.0,1,0,1
TTO,SLV,2017.0,1,0,1
PRI,CZE,2015.0,1,0,1
NZL,BTN,2021.0,1,0,1
NGA,SDN,2020.0,1,0,1
WSM,USA,2019.0,1,0,1
BIH,EGY,2021.0,1,0,1
SEN,AUT,2022.0,1,0,1
YEM,ESP,2022.0,1,0,1
ROU,IRQ,2023.0,1,0,1
BEN,BFA,2022.0,1,0,1
HKG,PER,2018.0,1,0,1
CAN,ARM,2014.0,1,0,1
DZA,BGR,1998.0,1,0,1
SLE,SOM,2023.0,1,0,1
COL,CHL,1999.0,1,0,1
CAN,AZE,2012.0,1,0,1
NLD,PER,1997.0,1,0,1
KAZ,ARM,2009.0,1,0,1
BIH,BHS,2019.0,1,0,1
TZA,DEU,2000.0,1,0,1
GEO,PRT,2016.0,1,0,1
USA,GRL,2006.0,1,0,1
IRL,URY,2000.0,1,0,1
VEN,JPN,1999.0,1,0,1
BWA,ITA,2004.0,1,0,1
UZB,IND,2001.0,1,0,1
IDN,CHN,2007.0,1,0,1
ESP,TTO,2015.0,1,0,1
LSO,LBR,1999.0,1,0,1
MYS,NPL,2002.0,3,0,3
NLD,ZWE,2000.0,1,0,1
IDN,CHE,2003.0,1,0,1
SYR,EGY,2000.0,2,0,2
GEO,CZE,1998.0,2,0,2
POL,HKG,2001.0,1,0,1
LAO,SWE,2003.0,1,0,1
CHN,GUM,2018.0,1,0,1
FRA,MRT,2004.0,1,0,1
UKR,TUR,2012.0,1,0,1
ZWE,CHE,2015.0,1,0,1
IND,CIV,1999.0,1,0,1
POL,NGA,2017.0,1,0,1
DEU,ERI,2003.0,1,0,1
ERI,DEU,2009.0,1,0,1
SRB,SYR,2000.0,1,0,1
EGY,TWN,2009.0,2,0,2
DZA,TUN,1997.0,1,0,1
BFA,GMB,2006.0,1,0,1
KGZ,NLD,2010.0,1,0,1
GEO,NLD,2005.0,1,0,1
SWE,ECU,2013.0,1,0,1
NZL,NPL,2012.0,2,0,2
SUR,NLD,2009.0,1,0,1
FIN,SYR,2006.0,1,0,1
LBN,BRA,2007.0,1,0,1
FIN,MAC,2019.0,1,0,1
MDV,NLD,2022.0,1,0,1
SWZ,BWA,2017.0,1,0,1
JOR,PSE,2008.0,1,0,1
ECU,PER,2010.0,1,0,1
ESP,MWI,2009.0,1,0,1
GHA,NOR,2006.0,1,0,1
BHR,ARE,2019.0,2,0,2
,GNQ,2006.0,1,0,1
PAN,PER,2009.0,1,0,1
TON,VUT,2018.0,1,0,1
CRI,PAN,2010.0,1,0,1
DZA,JPN,2013.0,1,0,1
BHR,RUS,2016.0,1,0,1
CHE,NCL,2021.0,1,0,1
GAB,CMR,2014.0,1,0,1
IRN,PRI,2014.0,1,0,1
MUS,BEL,2007.0,1,0,1
AUT,COL,2010.0,1,0,1
SGP,GIB,2021.0,1,0,1
ARG,ESP,2024.0,1,0,1
ZWE,SEN,2012.0,1,0,1
BEL,CUB,2000.0,1,0,1
BWA,DEU,2021.0,1,0,1
LBY,LBN,2005.0,1,0,1
GRD,,1999.0,1,0,1
MDG,KHM,2011.0,1,0,1
GBR,GRL,2018.0,1,0,1
LVA,ROU,2016.0,1,0,1
MAR,BRA,2016.0,1,0,1
SSD,USA,2018.0,1,0,1
PAK,CHL,2023.0,2,0,2
NOR,ESP,2024.0,1,0,1
GEO,MEX,2021.0,1,0,1
LSO,ZWE,2022.0,1,0,1
BRA,DOM,2015.0,1,0,1
CRI,IRL,2020.0,1,0,1
NPL,NLD,1999.0,1,0,1
CHL,MYS,2017.0,1,0,1
MAR,IRN,2009.0,1,0,1
IRN,MAR,2013.0,1,0,1
EGY,TUR,2007.0,1,0,1
CUB,THA,2021.0,1,0,1
NAM,SWE,2023.0,1,0,1
CYP,LBY,2022.0,1,0,1
AUT,NGA,2021.0,1,0,1
BLR,USA,2022.0,1,0,1
OMN,ARE,2024.0,1,0,1
,AND,2020.0,1,0,1
SWE,JOR,2018.0,1,0,1
JOR,LBY,2020.0,1,0,1
KGZ,SAU,2023.0,1,0,1
NZL,KWT,2020.0,1,0,1
ALB,MLT,2023.0,1,0,1
ZMB,IND,2023.0,1,0,1
IRN,PER,2020.0,1,0,1
VEN,IRL,2021.0,1,0,1
,BRN,2021.0,2,0,2
NPL,CAN,2011.0,2,0,2
ROU,LTU,2021.0,1,0,1
EGY,TUR,1999.0,1,0,1
GIN,PNG,1998.0,1,0,1
MDA,ISR,2004.0,1,0,1
CZE,TWN,2006.0,1,0,1
CHE,BFA,2012.0,1,0,1
THA,FIN,2002.0,1,0,1
PRI,PAN,1998.0,1,0,1
KEN,TUR,2000.0,1,0,1
BRA,SRB,1997.0,1,0,1
IRL,ROU,2000.0,1,0,1
AUS,NCL,2009.0,1,0,1
HRV,ISR,2000.0,1,0,1
MKD,KOR,2019.0,1,0,1
SGP,OMN,2014.0,1,0,1
RWA,AUS,1999.0,1,0,1
BFA,CHE,2000.0,1,0,1
CZE,CYP,2007.0,1,0,1
ARE,LBN,1998.0,1,0,1
AZE,USA,2001.0,1,0,1
DNK,QAT,2015.0,1,0,1
FRA,FLK,1999.0,1,0,1
CIV,GUF,2005.0,1,0,1
GUF,BEN,2005.0,1,0,1
IRQ,BHR,2001.0,1,0,1
BHR,IRQ,2002.0,1,0,1
ISL,ESP,1997.0,1,0,1
CMR,KHM,2009.0,1,0,1
CMR,KHM,2011.0,1,0,1
PAK,NPL,2010.0,1,0,1
CHL,GRL,2015.0,1,0,1
FIN,VNM,2013.0,1,0,1
SWE,VNM,1998.0,1,0,1
BWA,NLD,2008.0,1,0,1
CMR,ROU,2012.0,1,0,1
MLT,LVA,2001.0,1,0,1
PAN,ETH,2006.0,1,0,1
RWA,COG,2017.0,1,0,1
ARE,BRN,2014.0,1,0,1
RWA,CMR,2021.0,1,0,1
IRL,ARG,2012.0,1,0,1
CAF,SGP,2018.0,1,0,1
FIN,CMR,2015.0,1,0,1
CMR,MOZ,2009.0,1,0,1
KAZ,CHE,2007.0,1,0,1
JOR,CHE,2007.0,1,0,1
LKA,AUT,2004.0,1,0,1
SYR,JPN,2020.0,1,0,1
PAN,CHN,2011.0,1,0,1
DEU,MOZ,2004.0,1,0,1
MMR,NZL,2021.0,1,0,1
CMR,KOR,2008.0,1,0,1
IRN,TJK,2018.0,1,0,1
TJK,IRN,2021.0,1,0,1
GRC,PHL,2021.0,1,0,1
MUS,ATG,2017.0,1,0,1
SDN,BEL,2021.0,1,0,1
VNM,PER,2022.0,1,0,1
UZB,GBR,2021.0,1,0,1
VNM,CZE,2024.0,1,0,1
BRA,TWN,2002.0,1,0,1
RUS,SGP,2008.0,1,0,1
ZMB,CAN,2001.0,1,0,1
GBR,ERI,2019.0,1,0,1
SDN,IND,2001.0,1,0,1
ARM,BRA,2012.0,1,0,1
CAN,EST,2006.0,1,0,1
BFA,DEU,2010.0,1,0,1
BFA,SDN,2018.0,1,0,1
AUS,KWT,2023.0,1,0,1
BRN,UKR,2017.0,1,0,1
UKR,VNM,2018.0,1,0,1
HTI,,2002.0,1,0,1
BLR,ESP,2012.0,1,0,1
LBR,USA,1998.0,1,0,1
PAK,SGP,2001.0,1,0,1
USA,IRQ,2000.0,1,0,1
DEU,BOL,2006.0,1,0,1
BRA,QAT,2016.0,1,0,1
ITA,PSE,2010.0,1,0,1
PSE,CAN,2008.0,1,0,1
MOZ,IND,2016.0,1,0,1
POL,QAT,2019.0,1,0,1
NGA,DNK,2012.0,1,0,1
PRY,JPN,2013.0,1,0,1
PSE,KWT,2022.0,1,0,1
SEN,COG,2018.0,1,0,1
IRN,SDN,2020.0,1,0,1
AUS,URY,2023.0,1,0,1
NLD,SLE,2013.0,1,0,1
NOR,SVK,2020.0,1,0,1
BRA,OMN,2012.0,1,0,1
PSE,ZAF,2021.0,1,0,1
GEO,KAZ,2018.0,2,0,2
ISR,MYS,2023.0,1,0,1
CHN,PYF,2021.0,1,0,1
IRQ,NOR,2019.0,1,0,1
ZAF,COL,2021.0,1,0,1
RWA,AUS,2020.0,1,0,1
USA,SLB,2005.0,1,0,1
ITA,ISL,2014.0,3,0,3
ASM,URY,2022.0,1,0,1
BEN,ROU,2022.0,1,0,1
POL,BIH,2021.0,1,0,1
IDN,TZA,2021.0,1,0,1
GTM,FRA,2022.0,1,0,1
CZE,ROU,2001.0,1,0,1
CHE,NPL,2004.0,1,0,1
BGD,FIN,2001.0,1,0,1
EGY,IRN,2004.0,1,0,1
TWN,ARG,2004.0,1,0,1
NZL,TTO,2000.0,1,0,1
GRD,NLD,2015.0,1,0,1
BLZ,BEL,2016.0,1,0,1
GMB,UGA,2007.0,1,0,1
SLV,,2010.0,2,0,2
KAZ,UKR,2015.0,1,0,1
BRA,THA,2014.0,1,0,1
KAZ,IND,2011.0,1,0,1
NGA,ARE,2019.0,1,0,1
QAT,SRB,2023.0,1,0,1
UGA,MWI,2015.0,1,0,1
COD,COG,2024.0,1,0,1
TZA,GHA,2010.0,1,0,1
SHN,USA,2020.0,1,0,1
NER,COG,2020.0,1,0,1
BRN,LKA,2020.0,1,0,1
IRN,CHL,2018.0,1,0,1
SRB,DNK,2021.0,2,0,2
DEU,BEN,2023.0,1,0,1
BGD,ZAF,2017.0,1,0,1
LTU,IDN,2022.0,1,0,1
FJI,FRA,2016.0,1,0,1
ZWE,TZA,2023.0,1,0,1
CHL,NOR,2023.0,1,0,1
LAO,PER,2021.0,1,0,1
ARE,NGA,2005.0,1,0,1
TWN,GMB,2017.0,1,0,1
SRB,ROU,2018.0,1,0,1
PNG,NZL,2018.0,1,0,1
FIN,URY,2018.0,1,0,1
DZA,NLD,2023.0,1,0,1
NGA,CIV,2000.0,1,0,1
VNM,TZA,2022.0,1,0,1
MLI,TZA,2023.0,1,0,1
FIN,TWN,2004.0,1,0,1
GMB,SWZ,2014.0,1,0,1
IRL,FRA,2024.0,1,0,1
GBR,BDI,2018.0,1,0,1
NLD,GRC,2024.0,1,0,1
GBR,AGO,2001.0,1,0,1
AUS,PSE,2022.0,1,0,1
LTU,BGD,2021.0,1,0,1
CHL,GTM,2015.0,1,0,1
PSE,NLD,2022.0,1,0,1
PAK,PER,2023.0,1,0,1
,VIR,2019.0,1,0,1
IND,PAK,2024.0,1,0,1
VNM,VEN,2008.0,1,0,1
,AZE,2021.0,1,0,1
AZE,IRL,2020.0,1,0,1
PER,ISR,2011.0,1,0,1
AUT,KHM,2015.0,1,0,1
CAN,KHM,2021.0,1,0,1
QAT,IRQ,2015.0,1,0,1
VGB,,2009.0,1,0,1
DEU,LBN,1999.0,1,0,1
CZE,BRA,2010.0,1,0,1
BEN,DNK,2003.0,1,0,1
PRI,CZE,2001.0,1,0,1
ITA,KWT,1998.0,1,0,1
ZMB,ETH,2002.0,1,0,1
PRT,AGO,2006.0,1,0,1
FJI,USA,1997.0,1,0,1
TUR,PSE,1999.0,1,0,1
RUS,ISL,2016.0,1,0,1
UZB,AZE,2012.0,1,0,1
ZAF,JOR,2020.0,1,0,1
IRQ,SAU,2011.0,1,0,1
AUS,SDN,2016.0,1,0,1
MMR,SGP,2010.0,1,0,1
PRT,LUX,2018.0,1,0,1
HUN,MLT,2015.0,1,0,1
TGO,COG,2012.0,1,0,1
QAT,SDN,2014.0,1,0,1
BWA,PRT,2008.0,1,0,1
PRT,MOZ,2003.0,2,0,2
ZAF,VNM,2005.0,1,0,1
ZAF,SLE,2009.0,1,0,1
MKD,AUS,2006.0,1,0,1
MKD,AUS,2010.0,1,0,1
NLD,CUB,2014.0,1,0,1
AZE,NLD,2017.0,1,0,1
TWN,SVK,2014.0,1,0,1
OMN,RUS,2019.0,1,0,1
CHN,SRB,1998.0,1,0,1
IND,GUY,2009.0,1,0,1
BWA,RWA,2019.0,1,0,1
BRA,MDA,2019.0,1,0,1
ISR,KEN,2009.0,1,0,1
PRT,CRI,2020.0,1,0,1
SLV,DEU,2023.0,1,0,1
MAR,SGP,2014.0,1,0,1
KHM,KNA,2015.0,1,0,1
MAR,DNK,2020.0,1,0,1
AZE,POL,2023.0,1,0,1
SAU,IRL,2001.0,1,0,1
CHE,TCD,2019.0,1,0,1
MDG,SEN,2015.0,1,0,1
PRT,QAT,2013.0,1,0,1
QAT,KEN,2022.0,1,0,1
FRA,AND,2012.0,1,0,1
ZAF,COL,2009.0,1,0,1
CHN,CMR,2003.0,1,0,1
MEX,TUR,2013.0,1,0,1
MMR,ITA,2015.0,1,0,1
ZAF,FIN,2004.0,1,0,1
TLS,,2009.0,1,0,1
BRA,LKA,2007.0,1,0,1
IRL,CHL,2006.0,1,0,1
GAB,COG,2014.0,1,0,1
CCK,,2021.0,2,0,2
CUB,VEN,1999.0,1,0,1
SVK,ZAF,2009.0,1,0,1
NCL,GLP,2018.0,1,0,1
GLP,NCL,2020.0,1,0,1
ITA,SGP,2002.0,1,0,1
ZMB,NLD,2005.0,1,0,1
ECU,IRN,2017.0,1,0,1
CZE,LVA,2001.0,1,0,1
POL,BIH,2011.0,1,0,1
FRA,KAZ,2001.0,1,0,1
UZB,CHE,2012.0,1,0,1
EGY,IDN,2018.0,1,0,1
DZA,SVN,2023.0,1,0,1
ESP,LUX,1998.0,1,0,1
SVN,MKD,2012.0,1,0,1
NLD,DZA,2016.0,1,0,1
KOR,EGY,2003.0,1,0,1
PRI,IRN,2009.0,1,0,1
COG,GHA,2013.0,1,0,1
LSO,CHN,2017.0,1,0,1
NER,IND,2012.0,1,0,1
HKG,PAK,2024.0,1,0,1
THA,SOM,2017.0,1,0,1
SWZ,GBR,2016.0,1,0,1
MWI,SSD,2021.0,1,0,1
ALB,NOR,2019.0,1,0,1
CCK,DEU,2020.0,1,0,1
ARE,LUX,2017.0,1,0,1
AUT,EST,2012.0,1,0,1
PSE,ARE,2023.0,1,0,1
SSD,TZA,2023.0,1,0,1
HUN,BWA,2015.0,1,0,1
POL,PAN,2000.0,1,0,1
CHE,ZMB,2014.0,1,0,1
BGD,KHM,2018.0,1,0,1
BEL,ARE,2007.0,1,0,1
PAK,FIN,2000.0,1,0,1
NER,CHE,2014.0,1,0,1
MHL,,2007.0,1,0,1
SDN,BHR,2012.0,1,0,1
CHL,TZA,2004.0,1,0,1
HRV,ZAF,2001.0,1,0,1
FRA,PHL,2007.0,1,0,1
TUR,IRN,2000.0,1,0,1
PAK,UZB,2022.0,1,0,1
PHL,OMN,2012.0,1,0,1
ASM,ARM,2012.0,1,0,1
BRA,BLR,2005.0,1,0,1
BLR,BRA,2006.0,1,0,1
ARG,CRI,2001.0,1,0,1
DZA,SAU,1999.0,1,0,1
IRN,KWT,2010.0,1,0,1
NER,GHA,1999.0,1,0,1
THA,IRL,2000.0,1,0,1
IRN,TWN,2004.0,1,0,1
ARM,CAN,1997.0,1,0,1
MUS,KEN,1999.0,1,0,1
AUT,ZMB,1998.0,1,0,1
IND,CUB,1997.0,1,0,1
BGR,TWN,1999.0,1,0,1
LUX,ESP,2004.0,1,0,1
PRT,UZB,2016.0,1,0,1
THA,LAO,2002.0,1,0,1
DNK,SAU,2008.0,1,0,1
KWT,SVN,1998.0,1,0,1
ARE,USA,2024.0,1,0,1
CAN,GRD,2012.0,1,0,1
IND,MDV,2014.0,1,0,1
MDV,SWE,2018.0,1,0,1
SLV,DEU,2010.0,1,0,1
NLD,NPL,2015.0,1,0,1
ROU,ISL,2011.0,2,0,2
ISR,CYP,2017.0,1,0,1
DMA,ARG,2011.0,1,0,1
CHL,MYS,2016.0,1,0,1
IRN,JOR,2020.0,1,0,1
ARM,ITA,2009.0,1,0,1
REU,NCL,2012.0,1,0,1
BHR,FRA,2019.0,1,0,1
JOR,LBY,2007.0,1,0,1
GIB,BEL,2010.0,1,0,1
FIN,GEO,2015.0,1,0,1
CHE,COD,2018.0,1,0,1
ESP,PNG,2018.0,1,0,1
HND,SLV,2019.0,1,0,1
HKG,BRA,2012.0,1,0,1
SWE,TON,2005.0,1,0,1
LVA,ISR,2018.0,1,0,1
CAN,SWZ,1999.0,1,0,1
CHN,JAM,2016.0,1,0,1
ITA,BFA,2021.0,1,0,1
CRI,PER,2016.0,1,0,1
PNG,CHE,2017.0,1,0,1
HKG,MEX,2021.0,1,0,1
NZL,MAC,2022.0,1,0,1
KHM,CZE,2020.0,1,0,1
BTN,KHM,2019.0,1,0,1
UGA,LBR,2018.0,1,0,1
GBR,AIA,2021.0,1,0,1
TZA,BDI,2019.0,1,0,1
GHA,BFA,2015.0,1,0,1
MNG,PAK,2001.0,1,0,1
CZE,BRA,2006.0,1,0,1
PLW,JPN,2007.0,1,0,1
GHA,KEN,1999.0,1,0,1
BRN,SGP,2000.0,1,0,1
ZAF,NER,1997.0,1,0,1
CIV,LTU,2015.0,1,0,1
GBR,CUB,2021.0,1,0,1
BEL,QAT,2006.0,1,0,1
ISR,TZA,2020.0,1,0,1
ZAF,VGB,2017.0,1,0,1
ISR,SRB,2016.0,1,0,1
AUS,BGR,2016.0,1,0,1
MNE,,2003.0,1,0,1
IND,IRQ,2006.0,1,0,1
NGA,BGR,2004.0,1,0,1
MKD,GRC,2005.0,1,0,1
ROU,MDA,2003.0,1,0,1
ROU,KWT,2004.0,1,0,1
QAT,KWT,2002.0,1,0,1
GBR,BMU,2001.0,1,0,1
VNM,ARG,2002.0,1,0,1
CHL,LIE,2013.0,1,0,1
ITA,KEN,2004.0,1,0,1
GRC,GEO,2014.0,1,0,1
SYR,SDN,2008.0,1,0,1
USA,PLW,2004.0,1,0,1
UKR,NOR,2004.0,2,0,2
MDA,UZB,1997.0,1,0,1
FRA,UGA,2008.0,1,0,1
BRA,AGO,2003.0,1,0,1
LAO,TZA,2013.0,1,0,1
HUN,PHL,2015.0,1,0,1
BGR,BRA,2005.0,1,0,1
ESP,ARE,2008.0,1,0,1
ARE,DOM,2011.0,1,0,1
DOM,AUS,2015.0,1,0,1
GRC,CHL,2004.0,1,0,1
EST,POL,2004.0,1,0,1
MOZ,ITA,2008.0,1,0,1
KEN,COL,1998.0,1,0,1
ITA,URY,2008.0,1,0,1
BFA,GMB,2000.0,1,0,1
GBR,BMU,2008.0,1,0,1
BHR,AUS,2008.0,1,0,1
USA,GLP,2012.0,1,0,1
ZMB,TZA,1999.0,1,0,1
NLD,TJK,2018.0,1,0,1
DZA,NGA,2007.0,1,0,1
MLT,SVN,2016.0,1,0,1
CHL,ROU,2013.0,1,0,1
ZAF,MAC,2016.0,1,0,1
TWN,STP,2019.0,1,0,1
COL,BOL,2014.0,1,0,1
UKR,HRV,2015.0,1,0,1
PAN,MEX,2009.0,1,0,1
COM,FRA,2012.0,1,0,1
ISL,CZE,2006.0,1,0,1
BOL,ITA,2010.0,1,0,1
CHE,GTM,2022.0,1,0,1
KHM,MDG,2017.0,1,0,1
ARM,EST,2012.0,1,0,1
TZA,MWI,2008.0,1,0,1
ROU,CHN,2009.0,1,0,1
ETH,NER,2020.0,1,0,1
CHE,NPL,2015.0,1,0,1
UGA,KOR,2017.0,1,0,1
TTO,FRA,2023.0,1,0,1
HRV,FIN,2020.0,1,0,1
FIN,SVK,2013.0,1,0,1
MAR,NER,2015.0,1,0,1
IRL,SLE,2020.0,1,0,1
ALB,SVN,2023.0,1,0,1
CHE,LVA,2010.0,1,0,1
CHN,ZWE,2015.0,1,0,1
DNK,KWT,2019.0,1,0,1
ESP,MDA,2017.0,1,0,1
SVN,LTU,2019.0,1,0,1
ZMB,ESP,2020.0,1,0,1
MLI,ZAF,2019.0,1,0,1
FRA,LIE,2014.0,1,0,1
EST,HRV,2018.0,1,0,1
LKA,IDN,2019.0,1,0,1
ZAF,SVN,2017.0,1,0,1
DNK,GUM,2022.0,1,0,1
CAN,HRV,2016.0,1,5,-4
PHL,DEU,2015.0,2,7,-5
MWI,ZMB,2012.0,2,1,1
URY,GBR,2006.0,1,1,0
MNG,GBR,1998.0,1,3,-2
BRA,URY,2009.0,2,4,-2
IRN,FIN,2004.0,1,2,-1
DNK,FRO,2005.0,1,1,0
BFA,GHA,2019.0,4,1,3
PHL,IND,2023.0,4,3,1
PRT,ROU,2021.0,3,3,0
ZAF,ISR,2008.0,1,3,-2
KOR,LAO,2008.0,2,1,1
KOR,CYP,2018.0,1,1,0
EGY,LBN,2011.0,3,4,-1
CZE,HRV,2012.0,1,2,-1
BEL,SRB,2023.0,2,1,1
NLD,TZA,2013.0,2,5,-3
THA,NOR,2012.0,1,1,0
TUR,KAZ,2012.0,1,2,-1
URY,CHL,2016.0,2,5,-3
BOL,MEX,2021.0,1,2,-1
NZL,HKG,2023.0,4,1,3
LIE,DEU,2016.0,1,2,-1
FRA,HTI,2022.0,2,3,-1
LUX,CAN,2016.0,1,1,0
MEX,BOL,2010.0,1,1,0
SVN,UKR,2014.0,2,1,1
USA,CYM,2020.0,1,3,-2
CAF,FRA,2017.0,2,3,-1
DNK,KEN,2015.0,2,2,0
LBY,GBR,2001.0,2,1,1
KEN,ETH,2006.0,2,5,-3
AUS,LBY,2007.0,1,1,0
MAR,DZA,2020.0,5,3,2
COD,FRA,2013.0,2,1,1
UKR,BEL,2007.0,2,2,0
EGY,HUN,2013.0,1,1,0
DNK,TUR,2015.0,3,4,-1
RWA,SWE,2018.0,1,3,-2
UKR,NLD,2013.0,4,3,1
ISL,POL,2023.0,2,1,1
CHN,ROU,2023.0,4,5,-1
NOR,SAU,2023.0,1,3,-2
PRT,ISR,2018.0,1,4,-3
AUS,NCL,2013.0,1,2,-1
BHR,IND,2004.0,2,1,1
JOR,ISR,2011.0,1,1,0
RUS,NZL,2019.0,1,4,-3
BGD,TWN,2023.0,1,1,0
JOR,EGY,2001.0,2,2,0
QAT,KWT,2022.0,1,3,-2
PRT,PER,2021.0,2,2,0
ITA,GMB,2023.0,1,1,0
NZL,ARE,2002.0,2,1,1
COD,FRA,2003.0,2,1,1
VNM,SWE,2002.0,1,6,-5
CAN,IDN,2004.0,2,1,1
CHE,NOR,2001.0,3,8,-5
USA,NER,2000.0,1,1,0
IRL,MEX,2015.0,1,1,0
ARG,CRI,2010.0,1,2,-1
CHE,PER,2015.0,3,2,1
FRA,SDN,2014.0,1,2,-1
IDN,DNK,2010.0,1,1,0
ARE,NOR,2018.0,3,1,2
SDN,MYS,2008.0,1,3,-2
NOR,ETH,2022.0,9,3,6
SGP,LUX,2019.0,2,1,1
TUR,SWE,1997.0,2,2,0
BGD,ESP,2021.0,1,3,-2
SDN,TWN,2020.0,1,1,0
NGA,NZL,2020.0,1,5,-4
CHN,GHA,2011.0,1,2,-1
SRB,KOR,2014.0,2,1,1
ZMB,GBR,2000.0,3,4,-1
DEU,CRI,2014.0,3,3,0
ECU,PER,2001.0,2,1,1
GBR,HRV,2004.0,4,1,3
FIN,SVK,2019.0,1,1,0
TWN,BEL,1999.0,1,1,0
CMR,ITA,2017.0,1,6,-5
PRT,SVK,2019.0,2,1,1
FIN,HKG,2004.0,1,2,-1
MEX,CZE,2008.0,4,2,2
BHR,USA,2004.0,1,2,-1
HRV,FRA,2008.0,1,2,-1
TWN,PRT,2019.0,1,1,0
CAN,TZA,2020.0,1,5,-4
CHE,BEN,2018.0,1,2,-1
COG,GBR,2022.0,1,2,-1
ITA,SOM,2023.0,1,2,-1
JPN,ETH,2011.0,1,1,0
IRQ,IND,2013.0,1,3,-2
IND,JAM,2014.0,1,1,0
NGA,NLD,2011.0,1,3,-2
GRC,IND,2010.0,1,1,0
ARM,FRA,2008.0,1,1,0
BEL,PSE,2021.0,1,1,0
AUS,KHM,2012.0,1,2,-1
PRT,POL,2008.0,1,3,-2
LBY,MYS,2012.0,1,8,-7
OMN,DEU,2013.0,2,2,0
DNK,EST,2018.0,1,3,-2
JAM,DEU,2016.0,1,1,0
LVA,GBR,1998.0,1,3,-2
SRB,IND,2017.0,2,1,1
MKD,AUS,2015.0,1,1,0
SRB,HUN,2023.0,1,3,-2
PHL,DEU,2004.0,2,1,1
FRA,SDN,2015.0,1,5,-4
LBY,ITA,2017.0,4,2,2
POL,AZE,2017.0,1,1,0
COL,DNK,2021.0,3,1,2
AUS,PRK,2011.0,1,1,0
ROU,DNK,2003.0,2,1,1
NLD,VNM,2004.0,4,3,1
DEU,CUB,2002.0,1,3,-2
MLI,KEN,2015.0,1,1,0
ITA,HRV,2009.0,2,2,0
BLR,CHN,2014.0,2,2,0
GBR,JAM,2021.0,2,6,-4
DEU,ECU,2023.0,3,3,0
GNQ,CMR,2005.0,1,1,0
SRB,POL,2023.0,1,2,-1
ARE,SDN,2012.0,1,3,-2
CAN,PER,2001.0,1,1,0
DNK,TZA,2013.0,2,2,0
QAT,AUS,2013.0,2,7,-5
LBN,AUS,2013.0,1,3,-2
DZA,EGY,2022.0,1,5,-4
KEN,THA,2013.0,1,1,0
IDN,FIN,2021.0,1,2,-1
QAT,JOR,2007.0,1,2,-1
BRA,TUR,2020.0,2,2,0
USA,VIR,2001.0,1,1,0
CAN,KAZ,2019.0,3,2,1
DNK,TWN,2021.0,1,3,-2
SAU,BEL,1997.0,1,1,0
AUT,ARE,2023.0,1,1,0
TUN,POL,2018.0,1,1,0
BRA,NOR,2003.0,1,3,-2
ROU,NOR,2021.0,1,2,-1
DNK,COL,2020.0,1,3,-2
MAR,PSE,2023.0,1,1,0
SWE,SAU,2006.0,4,2,2
AZE,USA,2006.0,1,1,0
TZA,CAN,2000.0,1,4,-3
FRA,HTI,2018.0,1,1,0
EGY,POL,2000.0,4,2,2
URY,GBR,2010.0,1,1,0
NLD,BIH,2014.0,1,1,0
DEU,IRN,2000.0,2,2,0
PSE,SWE,2010.0,1,1,0
BOL,ITA,2008.0,2,1,1
KEN,GHA,2001.0,1,1,0
GEO,RUS,2018.0,4,4,0
CHE,UKR,2008.0,1,1,0
CUB,PRT,2015.0,1,1,0
GAB,BFA,2016.0,1,1,0
ITA,UZB,2023.0,1,1,0
CAF,FRA,2016.0,2,1,1
GBR,MYS,2013.0,199,64,135
ESP,USA,2013.0,548,432,116
AUS,TUR,2012.0,10,4,6
USA,TUR,2010.0,259,205,54
GBR,AUS,2008.0,610,451,159
DEU,CAN,2004.0,143,96,47
BEL,AUS,2015.0,28,21,7
DEU,DNK,2009.0,103,60,43
IND,CAN,2009.0,92,50,42
JPN,USA,2002.0,1677,1329,348
CAN,JPN,2013.0,94,91,3
USA,CHE,2015.0,559,565,-6
USA,MEX,2003.0,243,204,39
JPN,MYS,2008.0,37,15,22
JPN,CHN,2008.0,406,290,116
AUS,SGP,2021.0,109,91,18
JPN,GBR,2008.0,145,126,19
NLD,ZAF,2018.0,34,28,6
CHE,USA,2014.0,530,563,-33
CHN,GBR,2014.0,310,409,-99
USA,KOR,2003.0,669,617,52
DEU,DNK,2011.0,110,85,25
HUN,DNK,2013.0,6,4,2
BEL,AUT,2013.0,16,16,0
DEU,USA,2006.0,1329,1083,246
GBR,AUS,2004.0,445,368,77
FRA,USA,2005.0,733,652,81
FRA,AUS,2011.0,100,90,10
AUS,USA,2013.0,544,777,-233
USA,CHE,2008.0,454,425,29
SGP,AUS,2008.0,58,51,7
FRA,CIV,2007.0,33,19,14
ISR,ESP,2014.0,13,12,1
AUS,ROU,2012.0,1,3,-2
GBR,CAN,2005.0,320,256,64
GBR,FRA,2013.0,438,437,1
GBR,MEX,2004.0,34,26,8
JPN,USA,2005.0,1346,1177,169
CHN,USA,2019.0,4018,3924,94
POL,USA,2012.0,99,126,-27
USA,ISR,2005.0,253,352,-99
SWE,NOR,2013.0,66,54,12
JPN,CHN,2004.0,381,196,185
USA,HUN,2015.0,76,67,9
FRA,GBR,2006.0,383,336,47
DEU,CHL,2012.0,39,18,21
USA,GBR,2009.0,1555,1606,-51
ITA,FRA,2010.0,287,179,108
ESP,GBR,2023.0,165,243,-78
AUT,JPN,2008.0,10,12,-2
JPN,DEU,2018.0,140,159,-19
CHN,CAN,2006.0,144,132,12
USA,DEU,2007.0,1019,1284,-265
BRA,IRL,2019.0,22,6,16
IND,CAN,2011.0,135,72,63
USA,KOR,2013.0,1070,833,237
USA,GBR,2021.0,1812,1917,-105
CHN,USA,2009.0,1919,1339,580
GBR,AUS,2015.0,670,518,152
NLD,FRA,2010.0,80,123,-43
NLD,ESP,2010.0,88,65,23
ITA,AUT,2004.0,22,19,3
ITA,KAZ,2021.0,2,2,0
NZL,GBR,2006.0,95,149,-54
FRA,USA,2012.0,904,801,103
USA,FRA,2017.0,846,1002,-156
TUR,USA,2017.0,356,316,40
USA,NOR,2016.0,107,87,20
IND,GBR,2008.0,171,112,59
DEU,FRA,2016.0,393,434,-41
AUS,NZL,2008.0,109,171,-62
NLD,SWE,2002.0,29,39,-10
USA,GBR,2011.0,1679,1809,-130
GBR,USA,2013.0,1853,1667,186
FIN,USA,2018.0,119,68,51
BIH,USA,2015.0,3,6,-3
ISR,USA,2012.0,382,362,20
KOR,USA,2010.0,709,934,-225
USA,JPN,2007.0,1211,1210,1
ITA,DEU,2023.0,212,186,26
JPN,GBR,2004.0,113,117,-4
GBR,DEU,2011.0,634,585,49
USA,KWT,2006.0,22,11,11
USA,TWN,2010.0,376,294,82
USA,ESP,2012.0,447,544,-97
CHN,FRA,2002.0,48,38,10
FRA,CAN,2017.0,360,275,85
SGP,AUS,2001.0,28,36,-8
ESP,ROU,2005.0,7,2,5
USA,KEN,2016.0,70,61,9
USA,KEN,2018.0,74,69,5
CAN,FRA,2012.0,283,363,-80
JPN,NLD,2007.0,16,20,-4
CAN,USA,1999.0,1397,956,441
USA,TWN,2006.0,355,244,111
USA,IND,2013.0,905,1058,-153
FRA,USA,2002.0,924,754,170
KOR,USA,2006.0,648,793,-145
THA,CAN,2008.0,12,19,-7
GBR,HKG,2006.0,31,44,-13
UKR,GBR,2013.0,21,25,-4
CHE,USA,2008.0,425,454,-29
AUS,CAN,2007.0,150,155,-5
ITA,ESP,2010.0,217,109,108
USA,SAU,2003.0,74,32,42
GAB,FRA,2015.0,5,18,-13
COG,BEL,2006.0,5,1,4
NLD,ITA,2009.0,49,80,-31
DZA,FRA,2008.0,52,69,-17
SGP,USA,2017.0,247,256,-9
NLD,DEU,2006.0,190,189,1
ARG,BEL,2014.0,5,6,-1
BEL,BRA,2014.0,20,25,-5
USA,FRA,2018.0,770,989,-219
CAN,USA,2007.0,1449,1552,-103
TUR,DEU,2005.0,28,23,5
CAN,IRL,2011.0,37,28,9
CAN,IRL,2021.0,52,42,10
FRA,CHE,2013.0,339,250,89
USA,JAM,2012.0,10,7,3
GBR,KOR,2022.0,66,78,-12
USA,JPN,2020.0,825,879,-54
CUB,ITA,2009.0,3,3,0
GBR,BEL,2010.0,92,88,4
BEL,FRA,2008.0,174,187,-13
USA,DEU,1999.0,993,1310,-317
THA,USA,2017.0,148,256,-108
USA,THA,2018.0,240,121,119
USA,CAN,2008.0,1529,1617,-88
DNK,GBR,2011.0,56,87,-31
IRN,USA,2009.0,125,66,59
NLD,IRL,2009.0,18,15,3
CHE,ITA,2009.0,114,180,-66
CHE,ITA,2011.0,115,176,-61
SRB,BRA,2005.0,6,1,5
SVK,SVN,2017.0,27,11,16
DEU,GBR,2007.0,543,390,153
GBR,DEU,2009.0,508,591,-83
DNK,USA,2002.0,147,117,30
JPN,USA,2012.0,1016,995,21
JPN,NLD,2020.0,33,23,10
CAN,AUS,2012.0,197,172,25
NOR,USA,2012.0,58,86,-28
USA,PRI,2010.0,158,115,43
GBR,QAT,2010.0,15,2,13
HKG,GBR,2007.0,57,35,22
ESP,GBR,2010.0,266,318,-52
USA,CAN,2015.0,1612,2039,-427
GBR,USA,2003.0,1851,1441,410
CAN,USA,1998.0,1288,878,410
ITA,NLD,2001.0,58,69,-11
SGP,CHN,2020.0,497,383,114
AUT,GBR,2020.0,95,128,-33
JPN,CHN,2001.0,263,233,30
MEX,ESP,2007.0,87,100,-13
ESP,MEX,2014.0,202,124,78
KOR,CHN,2007.0,77,69,8
GBR,CAN,2012.0,388,332,56
LVA,LTU,2008.0,5,7,-2
USA,TWN,2000.0,300,152,148
USA,CAN,2001.0,1349,1831,-482
USA,SWE,2011.0,240,233,7
SWE,DNK,2006.0,65,51,14
DNK,AUS,2008.0,22,23,-1
DEU,ESP,2016.0,184,292,-108
DEU,CHL,2005.0,21,15,6
PRT,USA,2008.0,44,71,-27
NOR,CHE,2017.0,19,23,-4
CHN,POL,2012.0,5,4,1
DEU,SWE,2007.0,90,113,-23
ITA,IND,2011.0,37,43,-6
IND,GBR,2001.0,104,74,30
USA,CZE,2016.0,55,58,-3
USA,CZE,2022.0,44,58,-14
PRI,USA,2006.0,110,101,9
PRI,USA,2010.0,115,158,-43
KOR,TWN,2004.0,7,3,4
MWI,USA,2017.0,11,21,-10
ESP,FRA,2009.0,170,189,-19
RUS,DEU,2009.0,153,111,42
ITA,ISR,2018.0,30,16,14
DEU,FRA,2018.0,383,420,-37
DEU,CHE,2006.0,564,298,266
USA,RWA,2016.0,19,16,3
CRI,USA,2015.0,16,18,-2
USA,CRI,2016.0,33,21,12
USA,TWN,2023.0,105,154,-49
USA,CHE,2001.0,366,463,-97
GBR,ZAF,2009.0,85,75,10
ITA,FRA,2006.0,219,180,39
ISR,GBR,2021.0,68,67,1
CAN,CHN,2016.0,354,404,-50
KOR,IND,2021.0,170,240,-70
JPN,SGP,2002.0,21,9,12
LVA,USA,2012.0,3,8,-5
AUT,GBR,2007.0,52,32,20
JPN,FIN,2012.0,12,7,5
GRC,USA,2016.0,134,101,33
CHE,ESP,2010.0,63,63,0
DEU,CHE,2010.0,631,470,161
HKG,CHN,2003.0,312,281,31
DEU,USA,2010.0,1289,1194,95
CHN,SWE,2013.0,82,77,5
GBR,CHL,2009.0,19,17,2
GBR,CHL,2019.0,55,59,-4
JPN,KOR,2007.0,163,99,64
CHN,NZL,2002.0,4,4,0
IND,ITA,2010.0,46,20,26
DEU,FRA,2017.0,379,421,-42
NCL,FRA,2013.0,20,34,-14
ESP,AUT,2017.0,39,26,13
RUS,NLD,2003.0,27,13,14
ITA,GBR,2022.0,409,465,-56
CHN,TWN,2011.0,140,201,-61
BEL,ROU,2011.0,7,7,0
FRA,LBN,2008.0,32,25,7
CHE,JPN,2008.0,30,50,-20
ESP,ITA,2012.0,148,190,-42
IRL,DEU,2009.0,23,40,-17
URY,JPN,2003.0,2,2,0
NLD,CHN,2005.0,26,14,12
JPN,LKA,2004.0,9,5,4
IND,SGP,1998.0,22,5,17
AUS,HKG,2007.0,27,34,-7
FRA,SWE,2006.0,35,46,-11
SWE,FRA,2007.0,58,54,4
NZL,USA,2012.0,127,127,0
CAN,CHE,2001.0,53,76,-23
CHE,IRL,2004.0,7,5,2
CHL,AUS,2016.0,17,19,-2
ITA,USA,2007.0,516,412,104
AUS,DEU,2018.0,177,212,-35
DNK,USA,2012.0,116,116,0
CAN,SAU,2011.0,74,29,45
USA,DEU,2020.0,1264,1256,8
UKR,DEU,2017.0,43,15,28
IRL,SAU,2018.0,7,6,1
USA,CYP,2004.0,19,5,14
FRA,GBR,2000.0,367,289,78
CAN,USA,2020.0,2045,1851,194
CHN,JPN,2006.0,250,369,-119
ESP,CUB,2009.0,27,33,-6
CHN,AUS,2010.0,174,110,64
CAN,RUS,2014.0,19,19,0
AUS,USA,2003.0,548,515,33
USA,SGP,2009.0,222,166,56
USA,FRA,2016.0,828,991,-163
VNM,RUS,2015.0,2,15,-13
SEN,FRA,2019.0,22,49,-27
ISR,KOR,2014.0,5,1,4
FRA,BEL,2008.0,187,174,13
USA,ISR,2012.0,362,382,-20
TWN,USA,2022.0,219,203,16
FRA,GBR,2010.0,390,442,-52
COL,USA,1997.0,14,19,-5
DNK,AUS,2001.0,32,25,7
RUS,FRA,2003.0,68,63,5
DNK,DEU,2012.0,71,118,-47
PRT,USA,2015.0,102,69,33
JPN,EGY,2010.0,53,26,27
RUS,UKR,2017.0,67,176,-109
NOR,FIN,2008.0,7,14,-7
BEL,NLD,2004.0,90,74,16
POL,DEU,2011.0,98,98,0
NLD,GBR,2007.0,199,163,36
DEU,ESP,2017.0,211,294,-83
DEU,FIN,2013.0,40,38,2
ESP,MAR,2021.0,22,13,9
ISR,USA,2005.0,352,253,99
USA,FIN,2012.0,78,78,0
ITA,NLD,2004.0,53,48,5
BRA,BEL,2009.0,14,9,5
GBR,MYS,2003.0,61,18,43
CHE,FRA,2002.0,195,252,-57
KEN,JPN,2013.0,4,10,-6
POL,DEU,2009.0,87,83,4
KOR,JPN,2002.0,103,160,-57
CZE,SVK,2006.0,31,40,-9
ISR,USA,2002.0,415,363,52
AUS,CAN,1998.0,76,100,-24
FIN,EST,2016.0,12,21,-9
AUS,THA,2012.0,32,17,15
USA,AUS,2010.0,714,571,143
FRA,MAR,2007.0,85,34,51
MAR,FRA,2006.0,35,78,-43
JPN,IND,2011.0,82,100,-18
USA,TUR,2006.0,246,201,45
USA,NLD,2018.0,423,484,-61
DEU,CAN,2008.0,180,126,54
DEU,ZAF,2014.0,42,26,16
ITA,RUS,2005.0,27,25,2
USA,AUS,2006.0,505,417,88
FRA,AUS,2009.0,90,83,7
GBR,GRC,2016.0,129,265,-136
USA,ECU,2013.0,18,13,5
DEU,ESP,2022.0,229,213,16
SGP,USA,2016.0,222,220,2
PRI,BRA,2018.0,5,1,4
THA,DEU,2011.0,13,31,-18
BEL,USA,2012.0,180,158,22
LKA,AUS,2006.0,5,4,1
ESP,FRA,2011.0,214,218,-4
FRA,ESP,2012.0,194,220,-26
USA,AUS,2000.0,426,581,-155
CHN,CAN,2000.0,74,43,31
BRA,USA,2013.0,473,401,72
CAN,GBR,2018.0,416,432,-16
GBR,RUS,2019.0,66,64,2
GBR,NLD,2014.0,264,318,-54
BGD,IND,1998.0,12,3,9
HKG,CHN,2013.0,594,695,-101
KOR,USA,2000.0,414,500,-86
JPN,FRA,2009.0,97,97,0
CHN,GHA,2012.0,1,4,-3
UKR,CZE,2005.0,2,1,1
ITA,BEL,2018.0,136,73,63
SWE,USA,2013.0,200,251,-51
IND,SWE,2006.0,19,5,14
CHL,COL,2012.0,15,14,1
FRA,VEN,2004.0,8,6,2
IND,GBR,2014.0,160,176,-16
USA,CHE,2014.0,563,530,33
DNK,CAN,2004.0,18,10,8
ISR,GRC,2022.0,4,1,3
SGP,AUS,2004.0,31,30,1
USA,CAN,2014.0,1559,1940,-381
AUT,DEU,2011.0,289,342,-53
GRC,CHE,2009.0,13,16,-3
LKA,AUS,2010.0,16,5,11
CHN,CAN,2010.0,240,209,31
CAN,CHN,2017.0,404,360,44
AUT,DEU,2009.0,240,268,-28
BGR,GBR,2017.0,10,5,5
GBR,CAN,2002.0,316,264,52
CAN,ISR,2018.0,66,70,-4
ESP,FIN,2012.0,14,12,2
POL,ITA,2001.0,18,16,2
NLD,CHE,2010.0,62,53,9
DEU,USA,2000.0,1375,1095,280
FRA,CZE,2004.0,22,18,4
DEU,PRT,2006.0,26,16,10
CAN,SAU,2009.0,63,13,50
SAU,QAT,2019.0,26,5,21
BEL,FRA,2001.0,141,178,-37
CHE,FRA,2012.0,210,346,-136
RUS,USA,2017.0,186,212,-26
JPN,MYS,2015.0,77,42,35
GMB,GBR,2000.0,6,4,2
CHE,SGP,2023.0,6,13,-7
DNK,DEU,2005.0,43,50,-7
USA,ZAF,2008.0,77,97,-20
USA,GRC,2004.0,124,101,23
USA,ASM,2022.0,6,1,5
AUS,CAN,2020.0,210,191,19
NLD,CAN,2015.0,75,60,15
SRB,ESP,2006.0,9,5,4
ZAF,SAU,2011.0,20,10,10
SVK,CHE,2018.0,8,2,6
JPN,CAN,2007.0,93,74,19
CHN,DEU,2006.0,113,152,-39
MEX,USA,2000.0,217,154,63
USA,ZAF,2014.0,145,113,32
NOR,DNK,2010.0,28,23,5
GBR,ESP,2020.0,500,389,111
GBR,NLD,2004.0,148,146,2
GBR,SWE,2000.0,109,93,16
DEU,GBR,1999.0,369,323,46
USA,PAK,2007.0,33,38,-5
DEU,RUS,2005.0,133,153,-20
USA,SWE,2019.0,269,280,-11
JPN,AUS,2001.0,57,54,3
CHN,KOR,2016.0,149,200,-51
IND,NPL,2006.0,17,20,-3
JPN,DEU,2017.0,144,128,16
DEU,SWE,1999.0,71,77,-6
RUS,KAZ,2022.0,57,12,45
ZAF,USA,2000.0,94,63,31
DEU,BRA,2006.0,55,59,-4
DEU,CHE,2000.0,356,325,31
GRC,GBR,2017.0,275,144,131
CAN,DEU,2009.0,120,174,-54
FRA,ARG,2012.0,37,23,14
LBN,USA,2013.0,71,59,12
USA,HKG,2012.0,149,135,14
USA,CAN,2004.0,1390,1437,-47
DEU,JPN,2002.0,124,143,-19
AUT,SWE,2012.0,15,12,3
NLD,FRA,2000.0,86,81,5
FRA,NLD,2003.0,107,77,30
NLD,FRA,2006.0,92,84,8
NPL,AUS,2011.0,2,2,0
AUS,IND,2019.0,87,133,-46
CHN,JPN,2010.0,296,491,-195
MYS,IRL,2021.0,8,6,2
BGD,JPN,2004.0,23,19,4
GBR,CHE,1998.0,112,116,-4
RUS,CZE,2015.0,12,5,7
GBR,MEX,2015.0,47,47,0
FRA,IRL,2007.0,28,12,16
SGP,IDN,2013.0,6,1,5
DNK,CHN,2014.0,39,45,-6
USA,KNA,2022.0,3,8,-5
DEU,ITA,2010.0,164,256,-92
ESP,ITA,2005.0,84,101,-17
CAN,GBR,2016.0,432,380,52
VEN,ESP,2014.0,34,33,1
NZL,AUS,2005.0,109,102,7
CHE,GBR,2012.0,204,304,-100
ZAF,GHA,2006.0,3,3,0
ZAF,USA,2010.0,95,106,-11
AUS,COL,2010.0,6,5,1
CAN,CHE,2014.0,103,95,8
GBR,NZL,2007.0,149,106,43
CAN,DEU,2011.0,170,172,-2
USA,THA,2016.0,265,135,130
CAN,CHE,2004.0,49,54,-5
ESP,AUT,2018.0,42,26,16
FRA,BGR,2008.0,16,9,7
FRA,CAN,2016.0,403,321,82
NZL,JPN,2013.0,11,15,-4
GBR,AUS,2014.0,701,527,174
ESP,JPN,2017.0,25,15,10
JPN,HUN,2012.0,6,8,-2
NZL,GBR,2010.0,118,141,-23
USA,EGY,2011.0,127,61,66
JPN,GBR,2014.0,119,153,-34
DEU,ROU,2007.0,24,24,0
CHN,GBR,2008.0,137,152,-15
GBR,CHE,2020.0,381,327,54
NLD,FIN,2015.0,23,20,3
USA,HUN,2004.0,87,89,-2
HUN,USA,2006.0,73,80,-7
ROU,FRA,2007.0,32,42,-10
PRT,NLD,2004.0,9,15,-6
DNK,CHN,2001.0,9,12,-3
GBR,CHN,2007.0,162,114,48
USA,ESP,2002.0,397,355,42
CZE,UKR,2008.0,3,2,1
BRA,BEL,2021.0,35,20,15
GBR,ESP,2007.0,223,191,32
ISR,ITA,2015.0,15,16,-1
USA,GRC,2008.0,137,115,22
CAN,ARG,2006.0,7,15,-8
NZL,AUS,2002.0,113,78,35
GBR,IND,2006.0,104,125,-21
FRA,USA,1997.0,526,441,85
NLD,JPN,2010.0,19,16,3
NLD,ZAF,2016.0,33,26,7
USA,JOR,2003.0,25,11,14
DEU,GBR,2020.0,710,818,-108
DEU,GRC,2012.0,57,69,-12
DNK,SWE,2000.0,52,56,-4
USA,JPN,1999.0,1114,1230,-116
TWN,SGP,2018.0,14,22,-8
NLD,SWE,2012.0,54,47,7
IRN,ARE,2018.0,2,3,-1
IRL,AUS,2002.0,17,10,7
BRA,GBR,2008.0,56,57,-1
FRA,RWA,2019.0,4,1,3
LBN,GBR,2008.0,8,3,5
NLD,NZL,2000.0,11,12,-1
FRA,SGP,2009.0,36,11,25
ITA,SWE,2000.0,30,30,0
NLD,SRB,2004.0,5,1,4
CHN,DEU,2010.0,222,175,47
NZL,SWE,1997.0,3,4,-1
FRA,ESP,2005.0,120,142,-22
NLD,IDN,2010.0,23,8,15
CMR,IND,2013.0,2,1,1
AUS,DEU,2017.0,176,168,8
DEU,AUS,2018.0,212,177,35
AUS,DEU,2022.0,142,98,44
MYS,USA,2021.0,42,35,7
DEU,POL,2013.0,96,70,26
ESP,IRL,2019.0,43,28,15
IRL,ESP,2021.0,33,34,-1
KOR,IND,2009.0,59,135,-76
HKG,USA,2013.0,146,150,-4
USA,NZL,2012.0,127,127,0
ROU,USA,2021.0,27,30,-3
DZA,FRA,2004.0,23,53,-30
FRA,BRA,2018.0,146,148,-2
AUS,JPN,2012.0,63,72,-9
DEU,NLD,2020.0,365,388,-23
KOR,USA,2023.0,537,464,73
FRA,CHE,2003.0,286,207,79
CHE,FRA,2005.0,155,261,-106
SWE,IND,2015.0,22,57,-35
BOL,BRA,2003.0,3,1,2
JPN,KOR,1999.0,105,61,44
AUS,NZL,2014.0,91,183,-92
NZL,ARG,2008.0,1,2,-1
AUS,BGD,2006.0,2,4,-2
ESP,GRC,2005.0,5,6,-1
PAK,USA,2000.0,29,15,14
IND,IRN,2003.0,10,5,5
ITA,USA,1999.0,477,376,101
AUS,HKG,1999.0,30,19,11
BLR,RUS,2016.0,26,18,8
ARG,ZAF,2003.0,1,2,-1
NOR,IND,2012.0,6,7,-1
HUN,AUT,2020.0,34,17,17
FRA,POL,2007.0,33,52,-19
IRL,CHN,2007.0,5,6,-1
TWN,SGP,2016.0,23,14,9
USA,LKA,2012.0,12,17,-5
ISR,DNK,2008.0,3,3,0
ITA,BGR,2011.0,5,5,0
USA,CZE,2018.0,69,54,15
DEU,JPN,2012.0,112,140,-28
CHE,JPN,2014.0,33,35,-2
NZL,GBR,2000.0,94,85,9
NOR,GBR,2021.0,59,136,-77
NZL,CAN,2015.0,36,44,-8
BEL,FRA,2014.0,197,229,-32
GBR,NLD,2015.0,250,369,-119
HUN,USA,2000.0,104,75,29
AUS,SWE,2012.0,40,30,10
NLD,DEU,2010.0,231,237,-6
FRA,CHL,2005.0,22,16,6
CHL,FRA,2006.0,19,16,3
USA,BEL,2004.0,102,122,-20
FRA,ISR,2018.0,34,28,6
HUN,USA,2010.0,95,68,27
TWN,PHL,2009.0,3,2,1
USA,HKG,2002.0,99,125,-26
HKG,USA,2003.0,110,75,35
CAN,AUS,2005.0,110,132,-22
GBR,CHN,2020.0,754,588,166
GRC,ESP,2007.0,10,6,4
ESP,USA,2003.0,355,374,-19
HKG,ZAF,2020.0,2,2,0
RUS,TJK,2015.0,9,5,4
POL,USA,2005.0,160,104,56
USA,THA,2022.0,161,100,61
USA,ESP,2005.0,353,292,61
GBR,JPN,2000.0,125,149,-24
CAN,NZL,2009.0,45,29,16
BLR,USA,2011.0,6,2,4
USA,HRV,2003.0,31,13,18
SAU,ZAF,2013.0,18,13,5
AUS,JPN,1997.0,39,33,6
USA,BEL,2008.0,133,133,0
BEL,BRA,2015.0,25,24,1
USA,BRA,2017.0,473,635,-162
EGY,TUR,2014.0,2,2,0
CAN,RUS,2008.0,8,23,-15
GBR,HKG,2010.0,37,40,-3
ESP,SWE,2004.0,21,24,-3
IRL,QAT,2020.0,5,2,3
LTU,NOR,2007.0,1,1,0
RUS,FIN,2002.0,25,25,0
JPN,CHN,2014.0,592,322,270
ARG,USA,2010.0,103,139,-36
PRT,DEU,2016.0,58,32,26
PRT,DEU,2018.0,60,44,16
POL,DEU,2021.0,79,94,-15
JPN,AUS,2014.0,66,50,16
AUT,AUS,2010.0,36,31,5
DNK,SWE,2006.0,51,65,-14
CHE,POL,2017.0,24,31,-7
ITA,GRC,2008.0,21,14,7
SWE,ITA,2006.0,31,23,8
MEX,USA,2006.0,205,217,-12
USA,PHL,2013.0,32,29,3
JPN,ESP,2010.0,24,32,-8
FRA,ITA,2009.0,178,266,-88
SWE,NLD,2010.0,38,44,-6
CHN,GBR,2001.0,95,104,-9
GLP,FRA,2008.0,29,28,1
KEN,JPN,2003.0,3,5,-2
USA,NLD,2016.0,402,460,-58
ITA,SVN,2006.0,7,6,1
DNK,USA,2005.0,98,74,24
AUS,CHN,2018.0,506,493,13
CAN,CHL,2006.0,16,9,7
AUS,IND,2009.0,35,80,-45
JPN,USA,1997.0,900,978,-78
USA,LBR,2021.0,22,10,12
BEL,USA,2005.0,117,125,-8
DEU,AUS,2017.0,168,176,-8
IND,SAU,2010.0,55,7,48
FIN,AUT,2017.0,9,8,1
MYS,GBR,2002.0,16,55,-39
FIN,CHE,2018.0,25,20,5
FRA,PHL,2001.0,2,2,0
ESP,SWE,2008.0,37,42,-5
SWE,GBR,2015.0,131,199,-68
DEU,GRC,2002.0,47,30,17
GBR,SWE,2010.0,115,139,-24
GBR,ZAF,2011.0,108,74,34
ZAF,AUS,2007.0,35,20,15
FRA,NLD,2013.0,95,104,-9
BEL,CHN,2003.0,12,14,-2
ISR,GBR,2009.0,35,22,13
CHE,BRA,2003.0,8,11,-3
AUS,CAN,1999.0,87,107,-20
NOR,GBR,2009.0,32,60,-28
GBR,NOR,2014.0,85,55,30
AUT,ESP,2006.0,7,7,0
CHN,ISR,2006.0,9,8,1
KEN,USA,2019.0,59,85,-26
SWE,GBR,2008.0,128,99,29
THA,USA,2016.0,135,265,-130
USA,NOR,2017.0,111,80,31
CAN,ISR,2016.0,65,58,7
GRC,NLD,2016.0,33,15,18
COL,USA,2012.0,118,124,-6
NGA,IRL,2010.0,1,1,0
ESP,CHE,2003.0,35,32,3
IDN,DEU,2013.0,9,23,-14
MDA,DEU,2002.0,6,2,4
SWE,ISL,2018.0,13,20,-7
GBR,IRN,2003.0,68,22,46
USA,JPN,1998.0,1035,1105,-70
USA,AUT,2010.0,106,109,-3
GBR,FRA,2003.0,387,395,-8
DNK,GBR,2019.0,114,139,-25
FRA,LBN,2004.0,31,11,20
FRA,IRN,2016.0,24,20,4
IRN,FRA,2020.0,41,16,25
FRA,IRN,2022.0,22,40,-18
CHE,ARG,2016.0,6,12,-6
ARG,MEX,2000.0,10,6,4
ARG,MEX,2010.0,10,8,2
CHN,NZL,2012.0,17,17,0
JPN,TWN,1999.0,9,5,4
SGP,MYS,2007.0,12,1,11
IND,MYS,2011.0,56,32,24
MYS,IND,2016.0,46,80,-34
FRA,ITA,2019.0,332,401,-69
POL,JPN,2002.0,13,17,-4
GBR,IRL,2003.0,207,179,28
FRA,MEX,2010.0,52,44,8
GBR,NLD,2008.0,153,187,-34
CHN,ESP,2009.0,18,5,13
USA,FIN,2002.0,106,96,10
ARG,AUS,2012.0,8,5,3
COL,ARG,2004.0,2,1,1
ARG,COL,2010.0,11,7,4
USA,ZWE,2005.0,6,10,-4
BEL,FRA,2004.0,135,144,-9
ITA,USA,1998.0,453,419,34
CHE,AUT,2012.0,54,84,-30
KOR,IND,2019.0,179,268,-89
IND,GBR,2015.0,170,187,-17
CHE,USA,2004.0,356,445,-89
SGP,IND,2015.0,56,86,-30
USA,IRL,2018.0,174,158,16
ITA,ESP,2006.0,104,102,2
USA,BRA,2016.0,532,601,-69
JOR,CAN,2002.0,3,3,0
GBR,BEL,2006.0,63,77,-14
JPN,MNG,2011.0,8,4,4
SYR,USA,2006.0,3,11,-8
AZE,TUR,2009.0,10,7,3
ROU,GBR,2018.0,23,22,1
IND,CHE,2013.0,48,36,12
DEU,IND,2021.0,152,246,-94
NZL,CAN,2004.0,28,24,4
CHE,GBR,2002.0,161,144,17
GBR,LKA,2013.0,17,10,7
CHN,TWN,2009.0,140,112,28
SWE,ITA,2010.0,20,34,-14
TUR,CYP,2017.0,122,65,57
MYS,BGD,2015.0,36,41,-5
ITA,NLD,2008.0,80,54,26
FIN,GBR,2003.0,42,51,-9
TUR,USA,2016.0,304,322,-18
USA,GBR,2019.0,1868,2045,-177
DNK,ITA,2008.0,17,21,-4
ITA,GBR,2018.0,623,404,219
USA,AUT,2023.0,65,67,-2
DEU,NLD,2007.0,222,176,46
IRN,GBR,2022.0,88,28,60
NLD,IDN,2006.0,8,4,4
MLT,GBR,2010.0,7,10,-3
GBR,MLT,2014.0,15,12,3
NLD,CAN,2014.0,74,72,2
FRA,MRT,1998.0,2,1,1
AUT,FRA,2012.0,34,35,-1
CAN,CHE,2015.0,101,92,9
NLD,GBR,2020.0,385,390,-5
CRI,MEX,2004.0,5,2,3
DEU,IRL,2009.0,40,23,17
IRN,CAN,2018.0,329,93,236
SGP,IND,2008.0,25,43,-18
KWT,IND,2021.0,6,5,1
ESP,BRA,2017.0,130,123,7
FRA,GUF,2013.0,31,30,1
GUF,FRA,2014.0,38,12,26
AUT,FRA,2005.0,23,21,2
CAN,HKG,2007.0,25,26,-1
IDN,JPN,2003.0,11,36,-25
CHE,USA,2001.0,463,366,97
JPN,GBR,2015.0,135,140,-5
AUS,POL,2017.0,6,11,-5
IND,KOR,2013.0,183,110,73
USA,SWE,2009.0,223,220,3
CYP,TUR,2023.0,108,76,32
TUN,CHE,2019.0,3,4,-1
GTM,MEX,2007.0,1,2,-1
GBR,CHN,1999.0,73,78,-5
FIN,CAN,2009.0,19,13,6
FIN,DEU,2011.0,53,35,18
CHE,ESP,2006.0,37,32,5
AUT,FIN,2008.0,5,4,1
DEU,THA,2020.0,33,21,12
ESP,PRT,2012.0,111,68,43
FRA,ITA,2011.0,191,340,-149
GBR,LBY,2010.0,8,3,5
CAN,DEU,2019.0,182,189,-7
USA,TTO,2008.0,12,9,3
TWN,VNM,2010.0,5,2,3
IND,TZA,2017.0,7,3,4
MNP,USA,2006.0,2,1,1
GUM,USA,2014.0,7,3,4
CAN,NZL,2011.0,37,34,3
ESP,ARG,2017.0,125,83,42
FRA,PRT,2005.0,27,22,5
FRA,JPN,2005.0,78,74,4
BEL,NLD,2008.0,111,105,6
BEL,NLD,2015.0,152,190,-38
HRV,DEU,2006.0,8,5,3
ROU,USA,2011.0,38,32,6
BRA,IND,2019.0,17,18,-1
AUS,GHA,2021.0,16,17,-1
ESP,BEL,2011.0,46,36,10
MEX,USA,2010.0,257,239,18
BEL,DEU,2010.0,108,101,7
BEL,BGR,2006.0,4,6,-2
NLD,NZL,2010.0,23,10,13
ITA,CHE,2018.0,304,149,155
SWE,NOR,2003.0,57,56,1
IRL,AUS,2005.0,29,25,4
AUS,IRL,2008.0,30,29,1
USA,POL,2005.0,104,160,-56
USA,POL,2012.0,126,99,27
FRA,TUN,2011.0,137,90,47
ESP,MEX,2008.0,96,86,10
DZA,FRA,2014.0,54,155,-101
ESP,BRA,2018.0,129,120,9
POL,FRA,2009.0,32,39,-7
POL,FRA,2011.0,30,38,-8
NZL,TWN,2011.0,4,1,3
USA,NZL,2005.0,121,92,29
FRA,NOR,2010.0,37,20,17
NOR,FRA,2012.0,36,31,5
AUS,KOR,2006.0,20,17,3
IND,DEU,2005.0,94,66,28
CMR,FRA,2017.0,24,21,3
SWE,DEU,2021.0,177,216,-39
JPN,BGD,2007.0,41,28,13
CHN,FRA,2012.0,144,142,2
AUT,UKR,2006.0,1,2,-1
FRA,CHL,2012.0,32,20,12
AUS,CHE,2007.0,37,54,-17
USA,IDN,2009.0,37,14,23
GRC,USA,2018.0,134,100,34
NOR,ARG,2013.0,1,1,0
USA,NZL,2002.0,127,138,-11
ISR,AUS,2012.0,16,14,2
BEL,MAR,2018.0,5,5,0
ITA,JPN,2004.0,17,16,1
CAN,BHR,2008.0,2,1,1
DEU,IND,2011.0,128,148,-20
IRN,FRA,2007.0,8,19,-11
FRA,PRT,2012.0,53,34,19
AUS,NLD,2008.0,48,55,-7
DZA,CAN,2012.0,3,2,1
GBR,IND,2010.0,143,123,20
PAK,DEU,2010.0,15,16,-1
CHN,MAC,2020.0,236,261,-25
DEU,EGY,2009.0,39,38,1
SGP,USA,2018.0,271,224,47
JPN,AUS,2008.0,63,46,17
USA,GRC,2001.0,104,93,11
CHE,AUS,2013.0,59,57,2
CAN,FRA,2005.0,157,232,-75
ESP,GBR,2006.0,171,199,-28
ESP,IRL,2009.0,12,14,-2
IRL,ESP,2011.0,18,18,0
JPN,UKR,2008.0,11,4,7
IND,AUS,2013.0,96,62,34
CAN,ZAF,2008.0,13,23,-10
AUS,IRN,2006.0,16,5,11
IRN,CAN,2022.0,458,70,388
BRA,USA,2003.0,286,357,-71
ITA,FIN,2007.0,9,13,-4
USA,MEX,2013.0,230,285,-55
FRA,AUT,2013.0,48,37,11
USA,IDN,2021.0,62,43,19
DEU,MEX,2012.0,29,34,-5
CHN,ESP,2011.0,15,15,0
USA,ISR,2002.0,363,415,-52
DEU,IDN,2013.0,23,9,14
SRB,FRA,2008.0,5,3,2
ITA,GBR,2017.0,650,343,307
ESP,ARG,2018.0,113,77,36
ESP,ARG,2022.0,65,125,-60
CAN,POL,2017.0,22,12,10
ITA,GBR,2016.0,628,332,296
DEU,IND,2009.0,90,138,-48
VEN,ESP,2004.0,27,21,6
BRA,PRT,2011.0,113,96,17
CAN,HUN,2016.0,12,9,3
CUB,MEX,2001.0,12,15,-3
AUT,AUS,2000.0,25,30,-5
BRA,ESP,2019.0,115,119,-4
DNK,FRA,2013.0,31,42,-11
GBR,DNK,2016.0,116,106,10
BEL,ECU,2019.0,9,3,6
SGP,CAN,2016.0,36,28,8
KOR,CAN,2004.0,29,23,6
AUS,NLD,2014.0,60,101,-41
ESP,BRA,2016.0,145,110,35
GBR,IRL,2013.0,234,296,-62
GRC,GBR,2022.0,120,185,-65
ROU,DEU,2005.0,19,20,-1
FIN,DEU,2009.0,43,25,18
HRV,IRL,2021.0,5,1,4
URY,FRA,2015.0,5,6,-1
IRN,DEU,2012.0,65,35,30
ZAF,USA,2023.0,95,56,39
CHN,TWN,2019.0,185,400,-215
GBR,PRT,2005.0,45,34,11
FIN,FRA,2005.0,12,11,1
DEU,NZL,2012.0,31,28,3
BRA,DNK,2009.0,8,2,6
DEU,NZL,2005.0,28,12,16
DEU,USA,2023.0,648,587,61
USA,NLD,2017.0,411,426,-15
ESP,DNK,2016.0,44,21,23
FRA,BEL,2015.0,237,227,10
TWN,USA,2017.0,317,222,95
RUS,MEX,2001.0,28,7,21
USA,IND,2003.0,359,599,-240
DEU,BRA,2010.0,64,64,0
GRC,GBR,2016.0,265,129,136
SWE,MAR,2015.0,2,1,1
MAR,SAU,2016.0,2,1,1
JPN,IND,2021.0,85,104,-19
USA,IRL,2016.0,111,195,-84
HUN,IRL,2019.0,3,2,1
PAK,IND,2003.0,7,2,5
SAU,JOR,2021.0,41,33,8
FRA,MAR,1998.0,72,26,46
RUS,MNG,2019.0,5,1,4
CHN,AUS,2006.0,63,73,-10
IND,NOR,2018.0,16,8,8
IND,NOR,2022.0,22,20,2
BRA,NOR,2022.0,13,7,6
SWE,AUS,2011.0,32,36,-4
ZMB,AUS,2014.0,3,1,2
FRA,ETH,2006.0,2,2,0
FRA,ETH,2010.0,4,1,3
ITA,JPN,2001.0,17,30,-13
ITA,JPN,2008.0,22,14,8
HUN,FRA,2003.0,21,15,6
ISR,CHN,2019.0,32,24,8
GBR,ESP,1998.0,106,161,-55
SGP,NOR,2014.0,5,1,4
IND,ISR,2009.0,25,11,14
VNM,BEL,2013.0,6,6,0
ARE,IND,2006.0,1,7,-6
ITA,ZAF,2009.0,4,2,2
JPN,VNM,2018.0,110,32,78
BEL,GBR,2016.0,141,117,24
NLD,ESP,2006.0,51,39,12
JPN,ROU,2021.0,2,2,0
ZAF,NGA,2005.0,7,11,-4
NZL,AUS,2012.0,179,99,80
FRA,BEL,2014.0,229,197,32
HRV,CZE,2004.0,2,1,1
CZE,GBR,2006.0,49,29,20
USA,VNM,2014.0,26,21,5
CHN,JPN,2000.0,196,202,-6
ESP,MEX,2015.0,189,139,50
SWE,DEU,2011.0,115,154,-39
DEU,IRL,2011.0,35,46,-11
NLD,SGP,2014.0,25,5,20
IND,BEL,2013.0,22,17,5
GBR,DEU,2019.0,841,763,78
ETH,IND,2010.0,13,7,6
SAU,USA,2014.0,91,166,-75
ARE,CAN,2007.0,7,10,-3
SGP,CHE,2010.0,13,11,2
FRA,RUS,2018.0,65,56,9
ITA,NOR,2017.0,30,15,15
ITA,FRA,2000.0,192,210,-18
RUS,DEU,2011.0,131,109,22
EGY,JPN,2009.0,29,48,-19
NOR,DEU,2019.0,48,94,-46
TUR,USA,2018.0,358,318,40
USA,SAU,2013.0,152,69,83
ISR,FRA,2006.0,16,25,-9
DEU,NOR,2020.0,76,47,29
BEL,GBR,2018.0,176,113,63
NOR,GBR,2011.0,41,83,-42
POL,USA,2002.0,186,104,82
USA,MYS,2008.0,34,23,11
FRA,EST,2023.0,2,1,1
SWE,IND,2008.0,9,15,-6
GBR,PRT,1997.0,24,15,9
PRT,ESP,1999.0,25,20,5
TUN,FRA,2010.0,98,116,-18
CAN,ESP,2018.0,69,91,-22
GBR,GRC,2017.0,144,275,-131
GRC,GBR,2018.0,249,180,69
ITA,FRA,2023.0,180,170,10
THA,CAN,2004.0,11,6,5
NZL,MYS,2009.0,8,4,4
NLD,RUS,2013.0,13,15,-2
SWE,GBR,2001.0,98,100,-2
JPN,THA,2016.0,118,97,21
CHN,MEX,2019.0,10,13,-3
ETH,DEU,2006.0,2,10,-8
NZL,CAN,2014.0,40,43,-3
CHE,NZL,2006.0,6,4,2
CHE,SGP,2010.0,11,13,-2
NZL,USA,2002.0,138,127,11
RUS,USA,2018.0,223,230,-7
IRL,NZL,2005.0,4,4,0
FRA,HKG,2007.0,8,8,0
CZE,IDN,2011.0,1,2,-1
NLD,GBR,1998.0,140,136,4
BRA,ARG,2010.0,28,29,-1
SWE,USA,2003.0,264,234,30
TUR,AUS,2017.0,22,11,11
GUF,FRA,2004.0,6,13,-7
ARG,CHE,2017.0,11,8,3
SWE,GBR,2014.0,146,170,-24
JPN,NGA,2007.0,4,4,0
CAN,FRA,2002.0,167,268,-101
PRT,BEL,2012.0,8,8,0
BEL,FRA,2015.0,227,237,-10
SVN,CHE,2013.0,5,3,2
VEN,COL,2020.0,33,8,25
CAN,AUS,2002.0,114,130,-16
KOR,TUR,2009.0,1,2,-1
TUR,KOR,2011.0,3,2,1
ETH,IND,2023.0,54,27,27
USA,BEL,2015.0,158,177,-19
GBR,TZA,2014.0,18,7,11
THA,USA,2022.0,100,161,-61
DEU,PRT,2010.0,36,28,8
IRL,ESP,2009.0,14,12,2
USA,ARE,2005.0,30,10,20
COL,GBR,2003.0,5,14,-9
THA,SWE,2011.0,9,3,6
NZL,CAN,2008.0,30,39,-9
FRA,SEN,2006.0,45,30,15
AUT,AUS,2006.0,26,22,4
JPN,TUR,2020.0,11,9,2
HKG,CAN,2011.0,30,21,9
RUS,CAN,2001.0,48,21,27
ZAF,MOZ,2006.0,1,1,0
FIN,ISR,2022.0,3,3,0
CHE,PRT,2016.0,12,20,-8
GBR,TUR,1998.0,50,15,35
SWE,DEU,2009.0,95,121,-26
RUS,ITA,2017.0,14,38,-24
CMR,FRA,2022.0,16,13,3
ZAF,GBR,2007.0,57,68,-11
COL,USA,2002.0,52,42,10
GBR,FIN,2012.0,59,47,12
USA,GRC,2014.0,92,150,-58
CHN,GBR,2015.0,341,452,-111
KOR,JPN,2005.0,85,168,-83
JPN,ITA,2015.0,25,23,2
CHN,FIN,2018.0,43,39,4
ARE,OMN,2004.0,5,3,2
SWE,DNK,2010.0,96,61,35
ZAF,NLD,2008.0,17,19,-2
SRB,MNE,2003.0,2,1,1
FRA,TUN,2019.0,117,123,-6
UKR,TUR,2003.0,1,1,0
USA,UKR,2013.0,15,27,-12
GBR,VNM,2016.0,36,27,9
AUS,VNM,2019.0,72,37,35
ARG,DEU,2013.0,35,28,7
IRL,BEL,2008.0,7,8,-1
ITA,CHE,2017.0,306,115,191
AUS,CHN,2016.0,349,395,-46
AUT,NLD,2013.0,26,22,4
FRA,GRC,2021.0,40,37,3
ROU,AUT,2004.0,1,3,-2
ESP,IRL,2021.0,34,33,1
BRA,IND,2021.0,11,10,1
BRA,FRA,2005.0,74,88,-14
KHM,AUS,2018.0,2,3,-1
NZL,NLD,2018.0,15,19,-4
GBR,CHN,1998.0,67,59,8
CAN,BGD,2022.0,15,43,-28
TUR,BEL,2005.0,6,5,1
HRV,USA,2004.0,15,23,-8
USA,IRN,2016.0,118,561,-443
GRC,AUS,2019.0,14,4,10
AUS,GRC,2021.0,9,2,7
TWN,JPN,2017.0,69,54,15
SAU,CAN,2015.0,72,102,-30
GBR,RUS,2021.0,63,68,-5
AUS,ESP,2005.0,11,13,-2
LTU,USA,2008.0,6,10,-4
NLD,IRN,2008.0,11,15,-4
NLD,CHL,2011.0,6,5,1
JPN,RUS,2004.0,29,30,-1
BRA,GBR,2004.0,52,82,-30
MDG,USA,2010.0,2,5,-3
UKR,MEX,2016.0,2,1,1
USA,ZAF,2004.0,74,98,-24
USA,FRA,2022.0,582,641,-59
ZAF,NOR,2012.0,7,3,4
DEU,UKR,2011.0,29,30,-1
GBR,FIN,2005.0,35,35,0
USA,ZAF,2015.0,114,128,-14
USA,CRI,2018.0,33,31,2
CAN,IRL,2009.0,35,23,12
DEU,SVK,2011.0,13,13,0
IRL,ITA,2013.0,36,29,7
BRA,NGA,2009.0,1,2,-1
FIN,FRA,2012.0,23,25,-2
FRA,FIN,2015.0,32,15,17
RUS,GEO,2002.0,7,5,2
GBR,GEO,2013.0,1,3,-2
NZL,NOR,2012.0,4,1,3
USA,RUS,2007.0,190,221,-31
RUS,KOR,2020.0,14,8,6
CAN,GBR,2017.0,408,399,9
RUS,TWN,2010.0,1,8,-7
IRN,USA,2011.0,239,73,166
AUT,NLD,2003.0,15,26,-11
PRT,ITA,2011.0,19,29,-10
ITA,PER,2023.0,1,1,0
DEU,CAN,2014.0,184,206,-22
USA,BEL,2014.0,156,219,-63
CZE,FRA,2003.0,25,18,7
NOR,DEU,2021.0,68,102,-34
SGP,PRT,2017.0,2,3,-1
MEX,ESP,2020.0,179,184,-5
FIN,DNK,2018.0,24,20,4
KEN,USA,2009.0,32,32,0
DEU,MEX,2002.0,23,10,13
BRA,GBR,2014.0,100,94,6
USA,DEU,1998.0,976,1134,-158
BRA,CAN,2022.0,176,75,101
IRL,DEU,2019.0,42,44,-2
FRA,IRL,2020.0,33,45,-12
USA,GRC,2015.0,101,145,-44
HKG,AUS,2010.0,46,39,7
BLR,RUS,2017.0,20,33,-13
GBR,PAK,2008.0,32,41,-9
JPN,FRA,2011.0,84,89,-5
FRA,BRA,2016.0,138,165,-27
CAN,IRN,2017.0,87,274,-187
ISR,GBR,2011.0,42,40,2
TUN,SAU,2010.0,20,3,17
MEX,GBR,2002.0,28,47,-19
BRA,CHE,2008.0,7,8,-1
ZAF,LSO,2007.0,1,3,-2
NOR,MEX,2009.0,1,3,-2
GBR,PRT,2012.0,67,70,-3
DEU,KOR,2016.0,50,70,-20
FRA,GBR,2023.0,209,195,14
EGY,DEU,2008.0,20,47,-27
DEU,EGY,2011.0,52,34,18
EGY,FRA,2009.0,12,14,-2
TUN,SAU,2023.0,67,39,28
AUS,JOR,2011.0,9,4,5
ESP,CAN,2013.0,71,45,26
CAN,ARG,2023.0,5,11,-6
RUS,DEU,2021.0,156,96,60
USA,GEO,2002.0,41,50,-9
PHL,NLD,2003.0,3,2,1
KOR,CAN,2008.0,42,35,7
ESP,BEL,2009.0,28,40,-12
BEL,CAN,2003.0,34,20,14
ROU,USA,2019.0,21,29,-8
SAU,USA,2008.0,40,53,-13
SVK,GBR,2005.0,12,6,6
BRA,PRT,2009.0,88,70,18
BRA,CHN,2015.0,8,10,-2
PHL,SGP,2008.0,2,4,-2
IND,SGP,2007.0,37,24,13
CHE,GBR,1997.0,98,100,-2
IRL,CAN,2017.0,44,36,8
CAN,IRL,2019.0,52,62,-10
GBR,PAK,2015.0,90,58,32
ZAF,NGA,2012.0,28,38,-10
USA,CHL,2002.0,72,47,25
GBR,RUS,2011.0,33,45,-12
ZAF,MWI,2012.0,7,4,3
NGA,GMB,2008.0,4,1,3
NLD,DNK,2006.0,25,15,10
SWE,FIN,2023.0,34,43,-9
CRI,USA,2004.0,8,16,-8
GBR,ZAF,2019.0,95,113,-18
ZAF,GBR,2020.0,125,84,41
ESP,MAR,2011.0,11,13,-2
ESP,COL,2010.0,83,73,10
NGA,ZAF,2009.0,24,8,16
PSE,USA,2008.0,5,2,3
UGA,USA,2007.0,11,13,-2
PRT,CHE,2010.0,12,8,4
GEO,USA,2014.0,66,87,-21
USA,BRA,2022.0,363,610,-247
COL,DEU,2002.0,8,4,4
AUT,DEU,2019.0,354,407,-53
PRT,USA,2004.0,34,39,-5
BRA,PRT,2019.0,196,141,55
BRA,PRT,2021.0,238,170,68
SWE,JPN,2008.0,29,29,0
PRI,MEX,2009.0,3,2,1
JOR,JPN,2011.0,2,1,1
DEU,HUN,2005.0,49,43,6
ARG,CHE,2016.0,12,6,6
CHE,CHN,2007.0,15,39,-24
DEU,AUS,2022.0,98,142,-44
TUR,CYP,2016.0,105,44,61
CHE,AUS,2003.0,43,31,12
FRA,TUN,2009.0,127,100,27
HRV,USA,2014.0,19,17,2
CZE,CAN,2015.0,8,11,-3
AUS,ITA,2020.0,58,51,7
USA,EGY,2009.0,122,63,59
TZA,KEN,1998.0,1,2,-1
KEN,ZAF,2002.0,6,3,3
CHE,FRA,1997.0,109,121,-12
GBR,IND,2023.0,115,234,-119
TUR,CHN,2018.0,13,11,2
DEU,IND,2019.0,156,216,-60
GBR,GRC,2018.0,180,249,-69
MYS,IDN,2012.0,35,20,15
AUS,NZL,2001.0,88,96,-8
AUS,NZL,2015.0,120,190,-70
AUS,FRA,2012.0,88,116,-28
EGY,IRN,2007.0,1,1,0
IND,GBR,2004.0,125,76,49
GBR,BFA,1997.0,1,1,0
GBR,FIN,2002.0,51,54,-3
ROU,FIN,2008.0,1,2,-1
USA,HUN,2014.0,69,90,-21
HUN,CHE,2014.0,21,10,11
BEL,LUX,2017.0,25,7,18
AUS,BEL,2015.0,21,28,-7
USA,AUS,2023.0,253,322,-69
DEU,SWE,2020.0,220,186,34
TUN,TUR,2010.0,2,3,-1
NZL,FRA,2012.0,13,18,-5
PRT,GBR,2011.0,52,87,-35
PRT,USA,2014.0,79,77,2
BEL,CAN,2013.0,43,32,11
ITA,CHE,2016.0,296,111,185
USA,CHL,2012.0,128,103,25
SRB,AUT,2005.0,6,2,4
CHL,ITA,2014.0,3,7,-4
DEU,CAN,2015.0,187,182,5
BEL,ESP,2016.0,49,84,-35
TUR,CYP,2022.0,130,114,16
AUS,THA,2002.0,19,10,9
NGA,THA,2011.0,1,1,0
CZE,POL,2007.0,4,6,-2
IND,CHN,2020.0,258,105,153
ESP,ARG,2016.0,105,78,27
AUS,BEL,2014.0,19,32,-13
USA,IRN,2017.0,124,604,-480
IRN,USA,2019.0,576,161,415
JPN,AUS,2004.0,57,36,21
UKR,SWE,2009.0,7,2,5
SWE,JPN,2014.0,34,28,6
ZAF,JPN,2010.0,6,4,2
TWN,JPN,2016.0,71,58,13
RUS,NOR,2005.0,9,8,1
JPN,HKG,2019.0,13,11,2
SWE,DEU,2019.0,161,189,-28
NOR,ISL,2007.0,3,2,1
THA,NLD,2018.0,6,12,-6
HKG,KOR,2018.0,16,17,-1
KOR,GBR,2004.0,21,40,-19
GBR,KOR,2016.0,42,62,-20
JPN,FIN,2005.0,11,11,0
NLD,CHE,2006.0,56,47,9
FRA,ESP,2002.0,156,147,9
HKG,FIN,2012.0,2,1,1
FRA,PRT,2002.0,49,27,22
CAN,CHE,2008.0,83,94,-11
PAK,CAN,2008.0,11,11,0
CAN,FRA,1997.0,139,130,9
SVK,USA,2005.0,30,17,13
NOR,RUS,2017.0,15,9,6
BEL,NLD,2014.0,148,172,-24
USA,BRA,2018.0,521,678,-157
DEU,JPN,1997.0,90,75,15
NLD,SGP,2015.0,29,17,12
GBR,ESP,1999.0,159,130,29
CAN,IRN,2018.0,93,329,-236
MEX,NLD,2010.0,7,9,-2
USA,KWT,2010.0,17,8,9
FRA,RUS,2017.0,63,59,4
FIN,USA,2017.0,94,71,23
GBR,MEX,2014.0,49,35,14
USA,PER,2008.0,35,33,2
POL,AUS,2005.0,2,1,1
HUN,DEU,2000.0,50,37,13
CIV,DEU,2015.0,1,1,0
PRT,CHN,2012.0,10,8,2
POL,NLD,2009.0,17,17,0
TUR,CHE,2021.0,25,15,10
JOR,IRQ,2008.0,1,1,0
AUT,HUN,2005.0,10,13,-3
USA,ESP,1997.0,268,241,27
IND,SWE,2010.0,29,16,13
SWE,IND,2014.0,31,38,-7
UGA,SWE,2007.0,6,4,2
DEU,ITA,2000.0,130,145,-15
CHE,ARG,2018.0,11,18,-7
SWE,JPN,2004.0,21,25,-4
ZAF,GHA,2010.0,5,7,-2
LBN,CAN,2018.0,13,12,1
BEL,USA,2002.0,195,119,76
AUS,AUT,2017.0,53,63,-10
USA,KEN,2017.0,102,52,50
JPN,SGP,2005.0,22,11,11
TUR,MDA,2011.0,1,1,0
USA,NOR,2018.0,129,83,46
IRN,CAN,2016.0,266,94,172
PRT,FRA,2013.0,35,44,-9
GEO,USA,2008.0,33,49,-16
GBR,AUS,2001.0,372,404,-32
OMN,GBR,2014.0,9,17,-8
ZAF,TUR,2017.0,1,8,-7
ESP,CHL,2015.0,159,76,83
CHL,ESP,2021.0,140,126,14
COL,CHL,2014.0,19,16,3
PRT,GBR,2009.0,53,64,-11
SWE,BEL,2009.0,15,9,6
PER,USA,2017.0,53,43,10
MYS,PAK,2019.0,143,59,84
ITA,AUT,2008.0,33,17,16
PHL,USA,2019.0,43,54,-11
ITA,BRA,2010.0,46,25,21
CHN,KEN,2009.0,5,2,3
GBR,NOR,2004.0,43,34,9
IRN,NOR,2010.0,5,1,4
BEL,CHN,2013.0,41,33,8
DEU,CHE,2023.0,364,300,64
EGY,PSE,2015.0,3,2,1
CMR,GBR,2008.0,1,4,-3
BEL,AUS,2008.0,8,16,-8
COL,ARG,2008.0,4,5,-1
FRA,THA,2007.0,14,7,7
AUT,CHE,2005.0,31,36,-5
PRT,IRL,2015.0,9,4,5
ESP,FRA,2019.0,291,261,30
AUT,DEU,2021.0,337,402,-65
CAN,SVN,2005.0,2,1,1
NZL,AUS,1997.0,65,54,11
CHE,NLD,1998.0,31,41,-10
CHN,DEU,2000.0,112,77,35
DEU,RUS,2012.0,99,145,-46
USA,RUS,1999.0,153,423,-270
RUS,GBR,2005.0,40,37,3
NZL,USA,2005.0,92,121,-29
ZAF,GBR,1999.0,51,55,-4
GBR,COL,1999.0,6,6,0
DEU,BGD,1999.0,3,2,1
TWN,SGP,2017.0,24,14,10
MEX,CAN,2005.0,17,20,-3
CHE,IND,2014.0,39,42,-3
SGP,USA,2022.0,165,190,-25
ARG,GBR,2009.0,13,9,4
QAT,JOR,2010.0,1,7,-6
HKG,SGP,2002.0,23,10,13
SGP,CHN,2007.0,108,110,-2
IND,IDN,2008.0,8,8,0
SGP,IND,2014.0,64,82,-18
CAN,QAT,2014.0,19,3,16
QAT,USA,2015.0,30,84,-54
CAN,HKG,1998.0,35,14,21
SVK,SWE,2002.0,4,3,1
BGD,JPN,2008.0,44,40,4
USA,SRB,2003.0,44,23,21
MEX,CAN,2012.0,36,33,3
JPN,NOR,2009.0,5,3,2
PHL,USA,2009.0,36,36,0
SVN,GBR,2013.0,11,2,9
DNK,GRL,2007.0,3,3,0
ESP,ITA,1997.0,50,45,5
BEL,GBR,2017.0,161,130,31
SWE,FRA,2020.0,69,110,-41
GBR,KHM,2022.0,5,1,4
FRA,GRC,2009.0,24,33,-9
DEU,ITA,2023.0,186,212,-26
HUN,DEU,2006.0,38,45,-7
HKG,JPN,2007.0,15,10,5
DEU,CZE,2016.0,59,72,-13
ZAF,FRA,2003.0,15,24,-9
NOR,TZA,2005.0,3,1,2
USA,ROU,1997.0,13,12,1
CHE,NLD,2007.0,44,52,-8
BGR,BEL,2006.0,6,4,2
BEL,BGR,2010.0,4,12,-8
SRB,TUR,2007.0,3,1,2
ISR,NLD,2016.0,15,10,5
ISR,NLD,2022.0,14,9,5
DEU,GRC,2005.0,27,22,5
USA,NLD,2022.0,474,318,156
JPN,MYS,2014.0,110,33,77
IRN,USA,2021.0,509,157,352
SWE,ITA,2023.0,41,43,-2
JPN,CAN,1999.0,112,96,16
CAN,JPN,2003.0,97,133,-36
LBN,EGY,2021.0,12,4,8
TWN,CAN,2004.0,14,10,4
KOR,BGD,2011.0,18,15,3
BWA,GBR,2007.0,2,1,1
TWN,CAN,2008.0,15,18,-3
BRA,ESP,2009.0,89,70,19
AUT,CHE,2012.0,84,54,30
ECU,AUS,2009.0,1,1,0
EST,SWE,2004.0,7,13,-6
CAN,ZAF,2014.0,22,15,7
ITA,SAU,2021.0,19,17,2
DEU,ZAF,2001.0,25,15,10
CAN,IRN,2022.0,70,458,-388
GBR,VEN,2005.0,8,3,5
CHE,UGA,2019.0,3,3,0
TWN,JPN,2018.0,62,52,10
JPN,TWN,2020.0,63,52,11
JPN,ZAF,2007.0,5,1,4
USA,MYS,2014.0,48,48,0
IRN,CAN,2017.0,274,87,187
DEU,FRA,2022.0,298,332,-34
IRL,CAN,2022.0,42,47,-5
IND,CZE,2018.0,21,15,6
FIN,KOR,2013.0,2,10,-8
SWE,KOR,2021.0,9,23,-14
NLD,BRA,2009.0,15,21,-6
BRA,ESP,2011.0,79,92,-13
IND,CHL,2010.0,5,2,3
DEU,IRN,2020.0,56,167,-111
JPN,KOR,2020.0,127,97,30
CAN,CHN,2022.0,506,325,181
AUS,ZAF,2020.0,45,59,-14
CAN,BRA,2021.0,111,216,-105
EGY,CAN,2016.0,33,46,-13
HUN,GBR,2023.0,16,9,7
DEU,FJI,2021.0,1,1,0
FRA,CAN,2018.0,372,309,63
THA,SWE,2021.0,3,14,-11
TUN,FRA,2023.0,70,37,33
USA,VNM,2015.0,31,24,7
VNM,THA,2019.0,9,22,-13
MYS,IND,2022.0,61,30,31
ITA,CAN,2020.0,81,58,23
CAN,DEU,2021.0,179,198,-19
DEU,USA,2024.0,5,4,1
GHA,CHN,2017.0,17,18,-1
TZA,ZMB,2020.0,2,1,1
JOR,SWE,2016.0,1,2,-1
ITA,MEX,2020.0,27,29,-2
SAU,NOR,2019.0,4,2,2
IRN,SGP,2019.0,8,11,-3
MEX,DEU,2017.0,40,35,5
RUS,UKR,2018.0,85,114,-29
KOR,DEU,2022.0,54,49,5
NLD,ESP,2000.0,24,36,-12
DNK,MEX,2019.0,1,6,-5
CHN,FIN,2017.0,26,32,-6
PER,USA,2018.0,54,60,-6
AUS,CHN,2022.0,587,380,207
GUM,USA,2008.0,6,5,1
ITA,USA,2020.0,581,547,34
ISR,CAN,2017.0,69,49,20
CHN,FIN,2016.0,22,38,-16
EST,AUS,2021.0,2,3,-1
ARE,AUS,2020.0,18,25,-7
BHS,USA,2020.0,4,4,0
SGP,AUS,2014.0,75,83,-8
CHL,AUS,2022.0,22,19,3
NLD,ITA,2021.0,104,126,-22
USA,SGP,2019.0,249,256,-7
HUN,IRL,2021.0,1,5,-4
USA,IRN,2005.0,41,36,5
NLD,FRA,2014.0,135,111,24
KOR,USA,2004.0,600,681,-81
GBR,AUS,2006.0,474,403,71
CHN,GBR,2000.0,95,75,20
CAN,IND,2012.0,82,134,-52
FRA,USA,2022.0,641,582,59
CAN,VEN,1999.0,4,2,2
CAN,ESP,2012.0,49,65,-16
JAM,USA,1999.0,7,8,-1
KOR,GBR,2023.0,48,40,8
USA,SGP,2003.0,118,137,-19
ITA,FRA,2004.0,175,153,22
ZAF,NGA,2017.0,68,101,-33
JPN,CHN,2010.0,491,296,195
USA,COL,2006.0,67,40,27
BEL,DEU,2014.0,92,105,-13
JOR,ITA,2002.0,1,1,0
JOR,AUS,2019.0,2,6,-4
SWE,CAN,1998.0,27,24,3
USA,AUS,2015.0,692,655,37
SVK,AUT,2018.0,16,5,11
USA,TWN,2014.0,319,308,11
MEX,USA,2004.0,177,222,-45
GBR,CAN,2022.0,366,350,16
DEU,CHE,2014.0,717,540,177
IND,SAU,2014.0,129,33,96
FRA,USA,2018.0,989,770,219
POL,USA,2017.0,144,126,18
IND,MYS,2013.0,88,41,47
NLD,DEU,2014.0,362,251,111
GHA,ZAF,2005.0,3,1,2
RUS,KAZ,2012.0,29,17,12
FRA,BRA,2012.0,132,100,32
USA,GRC,2010.0,125,143,-18
USA,FRA,2002.0,754,924,-170
DNK,SWE,2008.0,61,95,-34
MAR,ESP,2006.0,4,10,-6
CHN,SWE,2009.0,53,53,0
CHE,DNK,2014.0,33,31,2
IND,KOR,2009.0,135,59,76
SWE,ARG,2006.0,4,3,1
GBR,SWE,2014.0,170,146,24
TWN,NLD,2008.0,2,2,0
CHN,CHE,2007.0,39,15,24
CHL,DEU,2011.0,30,21,9
FRA,BRA,2005.0,88,74,14
BRA,FRA,2022.0,149,90,59
CHN,ISR,2001.0,6,8,-2
USA,HUN,2006.0,80,73,7
GBR,NLD,2023.0,210,161,49
IRL,CAN,1997.0,8,9,-1
ARG,AUS,2016.0,9,13,-4
BGD,USA,2009.0,20,26,-6
ITA,HUN,2003.0,5,15,-10
ITA,FRA,2015.0,359,232,127
POL,USA,2022.0,101,104,-3
USA,CZE,2012.0,47,52,-5
OMN,IND,2012.0,13,12,1
FRA,NOR,2008.0,38,13,25
VNM,KOR,2007.0,6,11,-5
FRA,HUN,2015.0,14,18,-4
USA,COL,2010.0,83,103,-20
GBR,POL,2007.0,32,53,-21
GBR,NOR,2023.0,64,52,12
CYP,GBR,2006.0,8,11,-3
DNK,FRA,2009.0,23,28,-5
CHN,GBR,2023.0,398,565,-167
CHE,AUS,2011.0,64,63,1
POL,RUS,1997.0,15,18,-3
KEN,USA,2013.0,45,60,-15
IRN,FIN,2007.0,3,1,2
CAN,FRA,2017.0,275,360,-85
CHE,NOR,2020.0,17,19,-2
GBR,IND,2004.0,76,125,-49
JPN,EGY,2004.0,29,18,11
GBR,BRB,2007.0,4,1,3
BEL,PRT,2010.0,5,4,1
GBR,IRL,2011.0,224,282,-58
IRN,CHE,2010.0,16,1,15
NLD,FRA,2004.0,89,81,8
ESP,GRC,2022.0,21,14,7
SWE,DNK,2014.0,75,94,-19
FRA,UZB,2022.0,2,1,1
AUT,CHL,2010.0,3,1,2
SWE,ESP,2020.0,68,91,-23
ITA,AUS,2011.0,49,31,18
UKR,RUS,2016.0,206,60,146
CHN,BEL,2012.0,38,36,2
GBR,KWT,2004.0,5,4,1
DNK,ESP,2015.0,14,45,-31
EGY,SAU,1998.0,26,21,5
FRA,CZE,2010.0,27,28,-1
JPN,CHE,2011.0,32,36,-4
CZE,CAN,2000.0,10,3,7
BEL,USA,2017.0,253,161,92
KEN,ZAF,2017.0,11,24,-13
GBR,ARE,2015.0,56,18,38
PSE,USA,2010.0,8,4,4
MAR,BEL,2003.0,2,8,-6
SGP,HKG,2017.0,34,37,-3
CAN,TTO,2008.0,1,2,-1
USA,NLD,1997.0,179,185,-6
CUB,CAN,2008.0,4,1,3
IND,IDN,2010.0,10,5,5
REU,FRA,2014.0,30,21,9
CZE,PAK,2021.0,3,6,-3
MYS,AUS,2019.0,135,98,37
MEX,DNK,2022.0,7,4,3
DEU,LBN,2019.0,7,12,-5
ESP,SWE,2019.0,92,48,44
DEU,ISR,2022.0,68,61,7
DEU,NLD,2022.0,370,327,43
CAN,ISR,2020.0,64,78,-14
GRC,USA,2020.0,137,105,32
NLD,HKG,2017.0,11,9,2
HKG,NLD,2018.0,6,10,-4
IRN,CAN,2020.0,477,86,391
NGA,KOR,2022.0,4,1,3
CHL,USA,2018.0,145,140,5
RUS,AUT,2023.0,22,2,20
ETH,IND,2003.0,3,5,-2
FRA,CHE,2023.0,182,175,7
IND,ARE,2023.0,63,24,39
FRA,BEL,2021.0,263,223,40
HKG,RUS,2020.0,7,5,2
JPN,THA,2020.0,159,82,77
AUT,CHN,2016.0,16,22,-6
CHN,SWE,2023.0,72,95,-23
CHN,MAC,2018.0,89,144,-55
MAC,CHN,2021.0,297,309,-12
COL,MEX,2020.0,47,78,-31
USA,PAK,2017.0,91,126,-35
DEU,NOR,2018.0,89,52,37
CYP,GBR,2021.0,17,36,-19
IRQ,TUR,2016.0,8,12,-4
CHE,CHL,2021.0,6,9,-3
PRT,USA,2019.0,64,73,-9
IRN,CHE,2019.0,52,11,41
CHN,NLD,2021.0,195,216,-21
AUS,POL,2020.0,10,12,-2
BEL,CHN,2023.0,66,59,7
THA,JPN,2020.0,82,159,-77
CAN,DNK,2022.0,21,19,2
AUS,DNK,2023.0,19,13,6
GRC,GBR,2020.0,217,181,36
SGP,IND,2021.0,88,85,3
IND,ISR,2015.0,75,22,53
UKR,CHN,2017.0,20,5,15
MEX,ESP,2017.0,140,207,-67
CHN,PAK,2019.0,314,370,-56
QAT,CHE,2021.0,2,2,0
IRQ,ROU,2019.0,1,11,-10
JPN,NLD,2017.0,31,22,9
GRC,USA,1999.0,80,82,-2
CAN,CHN,2020.0,537,430,107
IRL,DEU,2014.0,43,33,10
GBR,PAK,2019.0,90,80,10
CAN,HKG,2018.0,35,18,17
USA,BEN,2019.0,3,4,-1
IRN,CZE,2021.0,23,1,22
AUS,IRL,2019.0,45,45,0
SGP,GBR,2016.0,106,156,-50
PAK,THA,2017.0,4,13,-9
HKG,THA,2020.0,6,9,-3
CAN,MYS,2020.0,13,32,-19
IRL,HKG,2023.0,2,1,1
IDN,MYS,2011.0,16,21,-5
GBR,CHE,2018.0,297,276,21
CHN,UGA,2022.0,3,3,0
CHE,RUS,2022.0,13,49,-36
IDN,AUS,2000.0,9,7,2
MYS,IRN,2009.0,10,43,-33
ITA,PHL,2018.0,3,3,0
AUT,IND,2022.0,7,14,-7
IDN,THA,2022.0,29,25,4
CHE,NLD,2022.0,97,107,-10
GBR,ROU,2023.0,16,9,7
SWE,GBR,2021.0,147,234,-87
THA,NLD,2020.0,8,12,-4
USA,KOR,2023.0,464,537,-73
GBR,IDN,2023.0,23,24,-1
ESP,ARE,2018.0,10,2,8
DEU,GHA,2015.0,10,7,3
DEU,IRL,2015.0,48,48,0
IND,ESP,2021.0,33,24,9
ISR,GBR,2014.0,61,46,15
NLD,THA,2015.0,14,3,11
FRA,VNM,2019.0,63,20,43
PAK,CHN,2023.0,314,297,17
CHN,PAK,2021.0,504,328,176
CAN,DNK,2018.0,36,28,8
PAK,SAU,2022.0,64,90,-26
FIN,GBR,2023.0,41,38,3
AUS,BEL,2021.0,31,23,8
USA,BEL,2019.0,174,217,-43
CHL,CAN,2022.0,35,16,19
CAN,ESP,1998.0,27,19,8
DEU,CZE,2020.0,74,56,18
SWZ,USA,2021.0,7,5,2
GHA,ZAF,2020.0,18,26,-8
KOR,IRN,2018.0,9,21,-12
GHA,USA,2020.0,44,34,10
CMR,TCD,2021.0,2,1,1
USA,KEN,2020.0,65,63,2
KOR,GBR,2021.0,85,74,11
CAN,CMR,2020.0,6,3,3
NLD,CZE,2018.0,8,7,1
ESP,BEL,2014.0,66,34,32
TWN,HKG,2018.0,12,18,-6
CAN,KOR,2017.0,38,67,-29
IRN,CHE,2021.0,42,19,23
CAN,ISL,2023.0,1,2,-1
BEL,NLD,2021.0,183,234,-51
COL,ESP,2019.0,100,146,-46
AUT,CHN,2022.0,30,17,13
NLD,MEX,2020.0,8,14,-6
BEL,IND,2014.0,18,33,-15
BGD,AUS,2014.0,55,23,32
IRN,BEL,2021.0,44,11,33
ITA,GRC,2019.0,37,39,-2
CHL,CHE,2015.0,9,13,-4
SWE,POL,1997.0,7,6,1
HUN,AUT,2022.0,37,20,17
AUT,USA,1997.0,83,91,-8
HRV,USA,2021.0,18,16,2
FRA,CIV,2018.0,42,10,32
ESP,MEX,2019.0,187,163,24
ESP,NZL,2019.0,10,3,7
KOR,CHN,2022.0,270,221,49
EGY,CHE,2017.0,7,4,3
FRA,KHM,2009.0,3,2,1
FRA,CAN,2020.0,372,339,33
CAN,KOR,2018.0,42,61,-19
AUS,CHE,2022.0,66,44,22
CAN,SWE,2021.0,49,40,9
JPN,BGD,2016.0,65,63,2
BGD,JPN,2021.0,54,107,-53
GBR,KOR,2020.0,75,68,7
JPN,KOR,2022.0,108,54,54
KOR,VNM,2021.0,132,57,75
NPL,THA,2022.0,7,5,2
AUT,IND,2017.0,11,15,-4
IRN,DNK,2014.0,25,6,19
IND,TWN,2023.0,60,37,23
RUS,ISR,2022.0,20,12,8
OMN,CAN,2020.0,8,13,-5
IND,IRL,2023.0,36,12,24
BRA,CAN,2020.0,205,99,106
PAK,NGA,2023.0,5,4,1
GBR,GMB,2022.0,16,14,2
EGY,BEL,2020.0,3,8,-5
MAR,QAT,2022.0,3,2,1
FRA,THA,2018.0,39,14,25
JPN,MMR,2019.0,21,5,16
JPN,PHL,2020.0,41,28,13
MAR,NER,2022.0,3,1,2
SGP,GBR,2022.0,110,88,22
EGY,CAN,2020.0,47,50,-3
CHN,NLD,2019.0,205,171,34
PAK,TWN,2021.0,13,10,3
FIN,CAN,2015.0,18,12,6
SEN,CAN,2021.0,3,2,1
PAK,KOR,2022.0,49,92,-43
KOR,PAK,2023.0,50,54,-4
EGY,CHN,2021.0,44,86,-42
JPN,VNM,2020.0,127,32,95
EGY,CHN,2019.0,49,40,9
RUS,USA,1998.0,345,163,182
USA,GRC,2021.0,94,121,-27
ESP,DNK,2020.0,48,40,8
DNK,CHN,2021.0,99,99,0
IRN,AUS,2012.0,101,36,65
RUS,ITA,1998.0,27,29,-2
CHE,KOR,2022.0,15,21,-6
CHE,CHN,2022.0,94,101,-7
USA,IRN,2020.0,136,544,-408
GBR,MYS,2023.0,35,65,-30
CHE,CHN,2018.0,64,70,-6
LKA,USA,2019.0,32,29,3
BRA,ZAF,2019.0,14,6,8
SAU,ZAF,2000.0,3,2,1
CAN,IRL,2015.0,32,43,-11
USA,GRC,2011.0,116,128,-12
CZE,POL,2018.0,14,30,-16
USA,EGY,2008.0,114,52,62
TWN,SGP,2020.0,12,12,0
IRN,ZAF,2020.0,11,4,7
IRN,AZE,2020.0,5,4,1
TUR,DNK,2022.0,11,4,7
USA,PAK,2018.0,103,125,-22
HKG,GBR,2022.0,86,73,13
EGY,OMN,2022.0,13,11,2
OMN,EGY,2023.0,9,12,-3
CAN,CHE,2019.0,118,100,18
QAT,USA,2021.0,58,38,20
ITA,CAN,2017.0,82,46,36
FRA,BRA,2020.0,127,167,-40
CAN,LBN,2018.0,12,13,-1
AUS,NLD,2019.0,98,91,7
CAN,SGP,2019.0,38,37,1
SGP,CAN,2020.0,36,26,10
BGD,AUS,2015.0,71,23,48
PHL,USA,2015.0,27,43,-16
THA,IDN,2019.0,26,11,15
NLD,COL,2021.0,17,16,1
THA,NPL,2022.0,5,7,-2
PHL,JPN,2020.0,28,41,-13
ZAF,MEX,2019.0,5,1,4
SGP,NZL,2019.0,13,20,-7
DEU,ECU,2018.0,14,9,5
MEX,DEU,2020.0,58,36,22
ARG,CHE,2020.0,11,9,2
ZAF,SWZ,2020.0,8,12,-4
SWZ,ZAF,2023.0,9,6,3
NLD,FIN,2019.0,21,20,1
MEX,RUS,2021.0,8,4,4
ESP,PAK,2021.0,7,8,-1
SDN,SAU,2020.0,35,23,12
MYS,OMN,2002.0,2,1,1
RUS,CAN,2019.0,26,17,9
AUS,ITA,2018.0,45,69,-24
PAK,SAU,2016.0,94,46,48
USA,PRT,2023.0,26,36,-10
ETH,ZAF,2016.0,10,9,1
NLD,ITA,2001.0,69,58,11
TUN,MAR,2018.0,6,2,4
JPN,NLD,2022.0,25,13,12
TUN,USA,2000.0,1,3,-2
CHN,BWA,2021.0,2,1,1
BRA,COL,2019.0,107,59,48
SVN,AUT,2018.0,7,7,0
ZAF,ETH,2019.0,19,9,10
CZE,DEU,2019.0,71,72,-1
SWE,USA,2023.0,113,136,-23
ZAF,GBR,2017.0,118,82,36
NGA,ARE,2020.0,3,1,2
MKD,USA,2018.0,3,3,0
AUS,RUS,2018.0,17,18,-1
IND,SGP,2018.0,124,78,46
CHN,BEL,2020.0,83,101,-18
IRN,PRT,2022.0,24,5,19
AUS,IRQ,2019.0,30,8,22
HKG,JPN,2018.0,11,10,1
PRT,USA,2021.0,61,61,0
CYP,DEU,2015.0,6,5,1
AUT,GBR,2018.0,102,97,5
IND,SYR,2023.0,1,2,-1
ZAF,RWA,2023.0,7,4,3
BEL,AUS,2019.0,44,23,21
LBN,GBR,2021.0,26,10,16
MYS,IND,2020.0,80,67,13
USA,CYP,2021.0,11,12,-1
UZB,CHN,2023.0,4,9,-5
FRA,CAN,1998.0,184,128,56
IRL,CHE,2013.0,13,8,5
UKR,DEU,2020.0,32,14,18
USA,MYS,2019.0,56,73,-17
IND,CHN,2022.0,74,160,-86
ZAF,AUS,2022.0,22,21,1
USA,PAK,2022.0,81,185,-104
GBR,PSE,2022.0,7,2,5
BGD,JPN,2019.0,52,108,-56
FRA,MAR,2022.0,65,82,-17
COL,CHL,2021.0,51,32,19
THA,AUT,2022.0,9,6,3
ITA,PRT,2023.0,27,22,5
BGD,GBR,2022.0,36,24,12
NGA,MYS,2022.0,42,105,-63
GRD,USA,2023.0,3,4,-1
CHL,USA,2022.0,137,88,49
CHL,ARG,2022.0,14,39,-25
PSE,USA,2021.0,9,7,2
TUR,ITA,2022.0,26,16,10
COL,ESP,2021.0,126,139,-13
PER,BRA,2017.0,15,44,-29
ZAF,TZA,2022.0,11,5,6
GBR,SAU,2023.0,113,67,46
UKR,NOR,2022.0,5,1,4
USA,SAU,2023.0,144,81,63
VNM,MEX,2021.0,3,1,2
GBR,DNK,2020.0,143,117,26
IND,IDN,2019.0,38,30,8
CAN,KOR,2022.0,33,57,-24
CZE,DEU,2021.0,72,57,15
BEL,ITA,2012.0,47,75,-28
BEL,MAR,2020.0,10,6,4
RUS,EST,2019.0,5,8,-3
DEU,NOR,2022.0,82,55,27
IDN,NLD,2022.0,33,52,-19
FRA,CZE,2021.0,38,18,20
ARE,MAR,2021.0,1,4,-3
IND,BHR,2022.0,6,2,4
BRA,GBR,2021.0,165,109,56
BEL,LUX,2020.0,25,11,14
HKG,NZL,2009.0,3,1,2
FRA,CIV,2022.0,14,12,2
TWN,USA,2020.0,269,237,32
MYS,THA,2023.0,10,6,4
MEX,COL,2023.0,23,21,2
SVN,SRB,2021.0,3,8,-5
USA,COL,2021.0,130,174,-44
NZL,ESP,2021.0,7,4,3
BRA,PRT,2001.0,28,48,-20
PRT,BRA,2002.0,43,32,11
DEU,CMR,2021.0,3,5,-2
KOR,GBR,2019.0,87,59,28
NZL,IRN,2004.0,2,4,-2
GBR,ZAF,2015.0,109,97,12
RUS,UKR,1999.0,71,87,-16
SWE,NOR,2023.0,47,42,5
KOR,GHA,2021.0,8,2,6
ALB,ROU,2021.0,1,2,-1
COL,BRA,2022.0,60,77,-17
GBR,IRN,2023.0,26,76,-50
IDN,AUS,2023.0,33,35,-2
DEU,CAN,2021.0,198,179,19
IDN,MMR,2021.0,2,1,1
PRT,ESP,2022.0,133,118,15
BEN,BEL,2021.0,8,3,5
POL,IND,2021.0,22,41,-19
PER,FRA,2021.0,5,10,-5
THA,PAK,2021.0,19,13,6
CHN,ITA,2023.0,65,62,3
LBN,USA,2023.0,109,39,70
IDN,TWN,2023.0,36,48,-12
ISR,RUS,2008.0,9,13,-4
RUS,CHN,2019.0,49,29,20
FRA,MAR,2018.0,101,61,40
TTO,USA,2022.0,5,6,-1
ESP,LUX,2021.0,15,1,14
LUX,ESP,2022.0,8,8,0
RUS,ITA,2020.0,23,22,1
ESP,CHE,2023.0,67,61,6
JPN,RUS,2021.0,16,14,2
MAR,ESP,2019.0,14,18,-4
IND,ISR,2001.0,20,10,10
BRA,AUS,2016.0,59,53,6
IRL,ITA,2023.0,20,19,1
IRN,KAZ,2022.0,7,1,6
THA,CAN,2021.0,13,20,-7
GHA,CHN,2020.0,29,39,-10
ITA,IRQ,2021.0,2,4,-2
COL,PER,2023.0,11,5,6
EGY,PSE,2021.0,5,2,3
IND,CHE,2023.0,49,23,26
GBR,FRA,2023.0,195,209,-14
ISR,ITA,2021.0,17,28,-11
EGY,TUR,2021.0,2,6,-4
ESP,FRA,2001.0,142,145,-3
NLD,GBR,2022.0,240,359,-119
NLD,MYS,2019.0,13,3,10
ZAF,LSO,2018.0,9,4,5
USA,RWA,2020.0,26,10,16
HKG,GBR,2017.0,67,63,4
USA,VNM,2021.0,68,53,15
POL,ITA,2021.0,32,29,3
CAN,CHE,2021.0,126,97,29
BGD,PAK,2018.0,10,15,-5
GRC,DEU,2021.0,72,67,5
IRN,HUN,2022.0,14,1,13
ITA,AUT,2021.0,72,58,14
USA,PER,2021.0,47,52,-5
AUS,NLD,2021.0,99,85,14
IRN,NLD,2013.0,31,14,17
BEL,DEU,2003.0,78,69,9
NLD,FIN,2021.0,25,28,-3
CMR,CHN,2021.0,4,9,-5
GBR,NZL,2022.0,97,88,9
CHN,BGD,2023.0,41,23,18
URY,ESP,2023.0,11,5,6
GBR,BGD,2018.0,35,22,13
BRA,COL,2021.0,106,60,46
IRN,NGA,2021.0,4,1,3
VNM,GBR,2021.0,20,27,-7
FRA,SEN,2003.0,41,33,8
BEL,BRA,2021.0,20,35,-15
PRK,KOR,2020.0,3,8,-5
SRB,DEU,2000.0,25,10,15
MEX,ESP,2022.0,108,101,7
PAK,POL,2021.0,9,3,6
PRT,HUN,2002.0,1,1,0
HUN,GBR,2003.0,33,24,9
NLD,BEL,2005.0,90,83,7
DEU,LVA,2006.0,3,3,0
TZA,USA,2002.0,20,4,16
FRA,DEU,1997.0,197,184,13
NLD,UKR,2001.0,2,3,-1
NLD,UKR,2004.0,3,8,-5
ARG,CHL,2005.0,16,7,9
TUR,USA,1998.0,90,97,-7
FRA,GAB,2015.0,18,5,13
GRC,ITA,1997.0,11,11,0
FRA,CMR,2000.0,8,11,-3
ITA,SWE,2003.0,28,26,2
FRA,SEN,2013.0,32,24,8
ITA,BEL,1998.0,21,24,-3
NOR,ITA,2012.0,12,14,-2
MYS,CHN,2019.0,56,15,41
NLD,BRA,2014.0,30,31,-1
USA,ARG,2003.0,125,173,-48
CHE,DEU,2002.0,320,467,-147
JPN,NOR,2004.0,5,3,2
GBR,CZE,2005.0,25,30,-5
NZL,SGP,2022.0,9,9,0
FIN,CAN,2004.0,19,13,6
HRV,FRA,1997.0,2,4,-2
CHL,AUT,2003.0,2,1,1
QAT,EGY,1998.0,6,2,4
DEU,POL,2000.0,67,64,3
NPL,IND,2012.0,23,17,6
KOR,IND,2008.0,45,131,-86
ITA,DNK,2002.0,22,20,2
FRA,CHE,2000.0,216,167,49
POL,RUS,2007.0,10,7,3
AUT,DEU,2004.0,158,234,-76
RUS,SWE,2005.0,21,20,1
CAN,DEU,2001.0,127,155,-28
ITA,GBR,1999.0,214,194,20
GBR,BRA,2002.0,77,56,21
SWE,ITA,2003.0,26,28,-2
ESP,BRA,1998.0,29,27,2
CAN,BRA,2001.0,29,45,-16
NPL,JPN,2018.0,5,14,-9
DEU,DNK,2001.0,57,82,-25
IRL,ESP,2014.0,17,30,-13
NOR,CHE,2020.0,19,17,2
GBR,SWE,2003.0,109,110,-1
BEL,GBR,1998.0,55,42,13
IDN,JPN,2000.0,24,23,1
JPN,IDN,2002.0,36,12,24
RUS,JPN,1997.0,36,28,8
SWE,DEU,2001.0,97,90,7
USA,BRA,1999.0,262,227,35
FIN,SWE,2002.0,45,44,1
FRA,TUR,2022.0,19,24,-5
GBR,AUT,2019.0,117,107,10
TUR,SWE,2001.0,3,2,1
GRC,CHE,2001.0,7,11,-4
CHE,FIN,1998.0,8,7,1
FIN,DNK,1999.0,9,10,-1
AUS,AUT,1999.0,64,31,33
RUS,UKR,1998.0,74,66,8
GBR,DNK,1999.0,61,44,17
GBR,CZE,1997.0,29,32,-3
BEL,UKR,2002.0,3,4,-1
DNK,SWE,2003.0,59,60,-1
SWE,USA,2000.0,259,236,23
ARG,ESP,2002.0,78,81,-3
FRA,ISR,1998.0,29,16,13
BRA,ARG,2003.0,24,32,-8
ISR,SWE,1998.0,2,2,0
SVK,CAN,1998.0,2,3,-1
CAN,SVK,2004.0,6,1,5
IND,FRA,2002.0,41,18,23
CAN,TUR,1997.0,5,1,4
SGP,FRA,2014.0,24,40,-16
FRA,SGP,2015.0,48,34,14
BEL,GBR,1999.0,73,56,17
USA,NGA,2001.0,9,19,-10
FIN,SWE,1997.0,30,26,4
USA,BRA,1998.0,214,190,24
GRC,USA,1998.0,57,115,-58
TUN,FRA,2003.0,35,91,-56
BEL,CHL,2016.0,9,7,2
BEL,GRC,1999.0,9,6,3
RUS,USA,1999.0,423,153,270
HUN,FRA,2010.0,18,18,0
GBR,NGA,2005.0,14,18,-4
EGY,ARE,2009.0,9,10,-1
EGY,ITA,2005.0,2,2,0
IND,OMN,2023.0,25,9,16
FRA,RUS,1999.0,57,68,-11
MYS,IND,2007.0,15,32,-17
NZL,CHE,2003.0,7,7,0
NLD,FRA,2003.0,77,107,-30
NLD,RUS,2010.0,7,14,-7
RUS,BGR,2004.0,6,8,-2
BEL,DNK,2000.0,5,8,-3
ITA,CHE,1998.0,97,80,17
GBR,FRA,2000.0,289,367,-78
NLD,IRL,2001.0,8,9,-1
FRA,POL,2022.0,37,37,0
NLD,FRA,2013.0,104,95,9
CHE,SWE,1998.0,24,22,2
JPN,SWE,2002.0,46,29,17
CHE,EST,2021.0,4,1,3
EGY,OMN,2017.0,11,4,7
NLD,BEL,1997.0,56,64,-8
NLD,AUS,2000.0,24,26,-2
ROU,JPN,1998.0,5,6,-1
UKR,DEU,1999.0,38,15,23
EGY,JPN,2001.0,18,17,1
PAK,GBR,2002.0,11,27,-16
AUT,ISR,1998.0,4,1,3
VEN,ESP,2011.0,48,26,22
CAN,IRN,1998.0,12,3,9
USA,LTU,1997.0,12,4,8
GBR,BHR,1999.0,4,1,3
SWE,CHE,2002.0,49,30,19
ZAF,NAM,2000.0,1,2,-1
FRA,AUS,2001.0,37,49,-12
NLD,BEL,2002.0,115,114,1
RUS,KAZ,1998.0,13,15,-2
GBR,ZAF,2001.0,68,87,-19
GBR,ZAF,2004.0,59,64,-5
DEU,CZE,1999.0,32,24,8
FIN,RUS,2004.0,16,21,-5
CAN,IRL,2001.0,15,17,-2
TWN,HKG,2022.0,8,25,-17
ISR,CHE,2002.0,7,15,-8
BEL,TUR,2012.0,8,3,5
NOR,CHE,2007.0,7,16,-9
RUS,BRA,1998.0,12,7,5
KOR,AUT,2019.0,8,8,0
UKR,CHN,2022.0,19,17,2
NLD,ITA,2014.0,59,118,-59
USA,IRL,1999.0,49,67,-18
FIN,CAN,2014.0,22,19,3
ESP,SWE,2009.0,41,33,8
GBR,ISR,2008.0,24,41,-17
ROU,GRC,2007.0,6,7,-1
GRC,ROU,2008.0,8,1,7
CHE,SWE,2020.0,68,67,1
PRT,CAN,2020.0,15,9,6
USA,THA,1999.0,65,45,20
FRA,CHN,2005.0,58,40,18
HUN,FRA,2000.0,8,22,-14
BEL,JPN,2001.0,11,16,-5
CHE,CZE,2003.0,7,6,1
FRA,MDG,2004.0,7,9,-2
HUN,JPN,2011.0,8,6,2
RUS,GRC,2001.0,6,3,3
SGP,MYS,2017.0,25,24,1
CAN,JPN,2006.0,74,117,-43
AUS,DNK,2000.0,19,10,9
USA,ISL,2000.0,15,8,7
UKR,JPN,1997.0,8,2,6
ITA,CHN,1999.0,12,10,2
CHN,ITA,2000.0,12,14,-2
RUS,NLD,2000.0,23,12,11
CAN,BGR,2001.0,6,6,0
POL,BEL,2002.0,14,11,3
AUT,CAN,2002.0,12,12,0
ARM,DEU,1997.0,5,4,1
POL,FRA,2001.0,32,56,-24
SWE,HUN,2008.0,10,11,-1
ZWE,NGA,2003.0,2,2,0
GEO,ITA,2003.0,1,1,0
BRA,ESP,2001.0,34,39,-5
IRL,NLD,2001.0,9,8,1
TTO,CAN,1997.0,3,2,1
BMU,USA,2007.0,3,3,0
SWE,FIN,2003.0,51,40,11
CZE,SVK,2003.0,34,42,-8
DNK,FIN,2002.0,14,11,3
DNK,BEL,2005.0,6,6,0
USA,IRL,1998.0,58,71,-13
BRA,ITA,1997.0,12,27,-15
RUS,MEX,2009.0,8,8,0
ITA,IRL,2012.0,25,9,16
SVN,SRB,2009.0,1,2,-1
PRT,DEU,1998.0,12,13,-1
FIN,CHE,2007.0,10,15,-5
UKR,FRA,2010.0,22,14,8
NGA,SAU,2003.0,4,4,0
ARG,ITA,1999.0,10,7,3
FRA,HUN,2013.0,14,18,-4
AUS,SGP,2001.0,36,28,8
GRC,GBR,1999.0,64,90,-26
FIN,IND,2013.0,6,17,-11
UKR,JPN,2005.0,3,4,-1
CHL,GBR,2002.0,9,13,-4
NLD,TZA,2020.0,2,3,-1
TUN,FRA,2013.0,83,135,-52
GRC,CAN,2005.0,9,10,-1
FIN,NOR,2011.0,20,5,15
GBR,ISR,2001.0,46,35,11
DEU,SRB,2002.0,14,21,-7
IND,JPN,1997.0,44,21,23
GBR,PHL,2005.0,4,4,0
IND,BRA,2013.0,10,6,4
SVK,CZE,2002.0,41,19,22
ITA,DZA,2012.0,5,2,3
GBR,LBN,2001.0,6,1,5
MAR,LBN,2020.0,2,1,1
LBN,MAR,2021.0,2,1,1
FIN,RUS,2008.0,15,16,-1
AUT,AUS,2013.0,58,26,32
JPN,IND,2004.0,69,77,-8
FRA,CZE,2019.0,38,29,9
ISR,RUS,2004.0,11,15,-4
ARG,CHL,1997.0,2,4,-2
BEL,CHN,2000.0,10,15,-5
MEX,ARG,2003.0,12,8,4
THA,ZAF,2023.0,1,1,0
BWA,ZAF,1997.0,3,1,2
AUS,DEU,1999.0,51,77,-26
USA,VEN,2005.0,39,44,-5
FIN,USA,1999.0,104,72,32
GBR,NGA,2012.0,33,31,2
SWE,POL,2005.0,14,15,-1
GUF,FRA,2021.0,25,34,-9
NOR,RUS,1998.0,8,5,3
BHR,EGY,2009.0,2,1,1
DEU,KOR,1998.0,14,14,0
DEU,AUT,1997.0,93,103,-10
JOR,CHE,2019.0,2,1,1
GBR,GHA,2002.0,7,5,2
ESP,AUT,1998.0,4,6,-2
AUT,ESP,2003.0,12,12,0
SWE,RUS,2010.0,19,13,6
RUS,SWE,2012.0,28,12,16
SWE,AUS,2001.0,26,29,-3
COL,FRA,2002.0,8,5,3
SWE,NOR,2006.0,56,31,25
FIN,DEU,2008.0,42,39,3
FRA,MCO,2005.0,7,6,1
USA,MEX,2006.0,217,205,12
TUR,USA,1999.0,136,117,19
KEN,CAN,2002.0,6,3,3
BRA,JPN,2006.0,7,15,-8
SWE,CHE,1997.0,21,12,9
UZB,JPN,2009.0,7,2,5
AUS,NOR,2003.0,10,6,4
TUR,SAU,2005.0,2,4,-2
IRN,BEL,2009.0,10,7,3
IND,JPN,2002.0,88,76,12
JPN,ROU,2001.0,8,12,-4
MEX,DEU,2007.0,22,29,-7
TWN,CAN,2011.0,21,20,1
FRA,POL,2018.0,53,53,0
GBR,SGP,1997.0,30,10,20
ISR,CAN,1998.0,32,22,10
DNK,AUT,2004.0,4,7,-3
AUT,DNK,2005.0,4,5,-1
USA,KEN,1999.0,15,18,-3
USA,IDN,2015.0,42,25,17
GBR,CZE,2002.0,43,43,0
USA,UKR,2000.0,26,66,-40
BRA,MEX,2021.0,36,27,9
FIN,RUS,2015.0,27,31,-4
USA,SVN,2014.0,15,21,-6
DEU,AUS,1999.0,77,51,26
ROU,NLD,2014.0,13,2,11
CZE,CHL,2013.0,3,2,1
UKR,USA,2000.0,66,26,40
LBY,GBR,2002.0,5,2,3
PRI,DEU,1999.0,2,1,1
USA,VNM,2011.0,32,11,21
NLD,FIN,2011.0,24,13,11
CAN,BGR,2004.0,3,3,0
TWN,PHL,2014.0,9,5,4
USA,ZAF,2021.0,97,181,-84
HUN,SWE,2001.0,11,11,0
USA,LVA,2006.0,3,2,1
USA,LVA,2010.0,5,6,-1
USA,ZAF,2009.0,92,96,-4
SWE,DNK,2003.0,60,59,1
FRA,RUS,1998.0,58,49,9
KOR,UKR,2004.0,2,3,-1
ESP,ARG,2007.0,78,86,-8
FRA,TUN,2015.0,138,90,48
CAN,QAT,2009.0,10,1,9
USA,IRN,1999.0,18,10,8
CHE,ITA,2004.0,78,100,-22
ROU,BEL,2002.0,13,2,11
BEL,ROU,2008.0,17,3,14
PER,BRA,2018.0,22,39,-17
KOR,RUS,2017.0,13,10,3
ESP,BRA,1999.0,43,18,25
BRA,ESP,2014.0,75,135,-60
GBR,RUS,2014.0,53,52,1
CIV,ZAF,2001.0,6,3,3
NOR,CZE,1998.0,2,2,0
ITA,ZAF,2014.0,10,4,6
ETH,GBR,1998.0,3,1,2
RUS,FRA,2006.0,54,36,18
POL,UKR,1997.0,6,11,-5
UKR,POL,2012.0,14,18,-4
FRA,ITA,2008.0,176,253,-77
USA,MYS,2011.0,39,31,8
BRA,BEL,2014.0,25,20,5
POL,PAN,1997.0,1,5,-4
GBR,LBN,2004.0,8,3,5
RUS,AUT,2010.0,11,9,2
RUS,TUR,2002.0,12,6,6
GRC,GBR,1998.0,42,81,-39
SAU,ARE,2021.0,40,17,23
CZE,USA,2002.0,67,39,28
CAN,MYS,1998.0,3,1,2
CAF,FRA,2000.0,5,3,2
RUS,JPN,2012.0,24,21,3
CUB,MEX,2011.0,16,12,4
JPN,VNM,2007.0,11,8,3
SWE,IRN,2010.0,19,21,-2
IRN,SWE,2012.0,31,23,8
USA,SAU,2000.0,46,34,12
DNK,NOR,2003.0,22,23,-1
RUS,JPN,2002.0,46,59,-13
IND,PHL,2009.0,3,2,1
ESP,CAN,2000.0,20,21,-1
USA,NOR,1999.0,68,65,3
BEL,AUS,2011.0,25,30,-5
USA,BLR,2020.0,4,3,1
USA,EGY,2001.0,61,78,-17
EGY,USA,2002.0,43,63,-20
FRA,REU,2009.0,24,23,1
LUX,ITA,2017.0,7,16,-9
DEU,ESP,1998.0,61,80,-19
BEL,CAN,2000.0,31,13,18
BRN,SGP,2012.0,1,2,-1
GRC,BEL,2016.0,25,10,15
AUS,CHN,1999.0,27,38,-11
SRB,ITA,1999.0,4,2,2
GHA,GBR,2001.0,5,6,-1
DEU,UKR,2001.0,18,49,-31
UKR,CHN,2018.0,17,6,11
GBR,IRN,2000.0,40,9,31
USA,UKR,2023.0,10,23,-13
ESP,MEX,2011.0,128,133,-5
ESP,CUB,2001.0,24,35,-11
BEL,COD,2010.0,5,1,4
JPN,POL,1997.0,13,13,0
UKR,FIN,1999.0,4,2,2
DEU,BEL,1997.0,46,39,7
RUS,UKR,2007.0,45,38,7
DNK,RUS,2006.0,9,8,1
POL,ROU,2014.0,1,4,-3
RUS,FRA,2000.0,71,55,16
ESP,DNK,1998.0,8,8,0
BLR,DEU,2012.0,10,3,7
DEU,BLR,2015.0,2,4,-2
DEU,MLT,2022.0,1,1,0
GBR,ARG,2010.0,13,7,6
PSE,ISR,2005.0,8,19,-11
ARG,ITA,1998.0,13,9,4
USA,SRB,2000.0,21,36,-15
BRA,SWE,2012.0,9,8,1
AUS,PRT,2011.0,7,5,2
NLD,PAK,2021.0,9,6,3
NOR,SWE,2005.0,23,61,-38
ESP,RUS,2009.0,14,15,-1
BGR,RUS,1997.0,7,6,1
PHL,CHE,2009.0,2,2,0
ARG,ESP,1997.0,37,35,2
FRA,FIN,2009.0,11,13,-2
BGR,SWE,2003.0,2,1,1
CAN,ISR,1998.0,22,32,-10
AUS,ZAF,2016.0,35,43,-8
USA,CZE,1998.0,34,33,1
SWE,RUS,2000.0,24,41,-17
BEL,RUS,2000.0,12,20,-8
NGA,DEU,2001.0,10,6,4
ITA,BRA,2003.0,29,20,9
FRA,ROU,1997.0,28,14,14
ITA,CUB,1998.0,3,3,0
SRB,BIH,1998.0,4,3,1
USA,IDN,2001.0,24,21,3
CHE,BEL,1997.0,16,17,-1
FIN,EST,1998.0,5,4,1
KOR,GBR,2011.0,33,57,-24
HUN,CAN,2007.0,12,7,5
HKG,AUS,2013.0,58,34,24
IRN,BRA,2017.0,14,5,9
TUN,USA,2006.0,4,3,1
USA,TUN,2007.0,3,7,-4
AUS,HUN,2020.0,9,5,4
AUS,GBR,1997.0,230,222,8
FRA,NGA,2014.0,1,1,0
ARG,NLD,2007.0,2,3,-1
JPN,HKG,2004.0,6,8,-2
PAK,ITA,2003.0,1,1,0
USA,TTO,2009.0,15,11,4
USA,CMR,2002.0,11,2,9
MEX,FRA,2005.0,31,57,-26
CAN,POL,1999.0,17,12,5
BGD,IND,2016.0,17,12,5
BGD,IND,2022.0,20,20,0
DEU,EGY,2001.0,19,24,-5
CHL,GBR,1997.0,4,4,0
CHE,SWE,1999.0,32,19,13
NOR,HRV,2018.0,1,1,0
HRV,NOR,2019.0,2,1,1
IRL,ISR,2018.0,12,4,8
TUR,GBR,1997.0,23,35,-12
VEN,FRA,1998.0,6,14,-8
FRA,IND,2013.0,73,71,2
FRA,EGY,2003.0,7,4,3
ITA,IRL,1997.0,6,3,3
IRL,ITA,2000.0,7,8,-1
CHE,SGP,2013.0,19,16,3
BLR,FRA,2000.0,6,2,4
FRA,BLR,2001.0,2,4,-2
FRA,GRC,2015.0,35,49,-14
AUT,LKA,2022.0,1,1,0
CHE,POL,1999.0,17,21,-4
SRB,GBR,2002.0,12,15,-3
KOR,ITA,2005.0,7,1,6
GBR,HRV,2012.0,5,6,-1
SRB,SWE,2005.0,5,5,0
DEU,VEN,2012.0,2,4,-2
RUS,BEL,2000.0,20,12,8
ITA,ISR,1998.0,9,6,3
ZAF,IRL,2016.0,5,4,1
CHN,ESP,2015.0,33,29,4
IRL,CAN,2020.0,33,51,-18
POL,CHN,2016.0,7,5,2
KOR,BGD,2015.0,24,25,-1
PAK,SGP,2017.0,6,4,2
CAN,JPN,2023.0,55,34,21
TUR,SWE,2014.0,8,7,1
SWE,GBR,2019.0,166,194,-28
IRN,BEL,2019.0,21,14,7
CAN,HKG,2017.0,22,22,0
KOR,BRN,2015.0,1,1,0
TUR,SGP,2015.0,7,3,4
ZAF,NLD,2021.0,30,18,12
DNK,ITA,2019.0,38,62,-24
GAB,FRA,2009.0,6,13,-7
NZL,BRA,2022.0,7,6,1
FRA,THA,2016.0,33,13,20
ESP,COL,2013.0,103,63,40
NLD,NGA,2015.0,5,2,3
UGA,DEU,2017.0,9,1,8
DNK,ETH,2020.0,6,2,4
BEL,THA,2016.0,5,4,1
USA,HTI,2018.0,11,16,-5
PAK,CYP,2017.0,1,1,0
TUN,MAR,2022.0,2,1,1
ECU,CAN,2019.0,1,3,-2
IDN,KOR,2013.0,4,14,-10
ESP,CRI,2016.0,5,7,-2
NLD,CAN,2019.0,75,86,-11
ARG,FRA,2009.0,22,16,6
PAK,CAN,2021.0,39,24,15
PER,BRA,2022.0,24,53,-29
AGO,PRT,2022.0,6,3,3
IDN,THA,2018.0,9,20,-11
JOR,SAU,2016.0,42,39,3
ITA,BEL,2020.0,127,97,30
GBR,MAC,2019.0,5,5,0
SWE,ROU,2016.0,3,3,0
IND,SGP,2017.0,111,68,43
ARG,URY,2018.0,12,5,7
ZWE,CHE,2016.0,2,1,1
ROU,JPN,2020.0,2,2,0
FRA,IRL,2017.0,37,24,13
CHL,DEU,2023.0,23,14,9
FRA,DNK,2020.0,52,51,1
PRT,IND,2016.0,11,14,-3
IND,SGP,2022.0,57,71,-14
TUR,GBR,2012.0,31,54,-23
IND,CAN,2014.0,131,91,40
GBR,PER,2023.0,4,2,2
CHE,JPN,2019.0,51,46,5
ZAF,BRA,2021.0,7,8,-1
DEU,MYS,2017.0,5,16,-11
ITA,SMR,2018.0,8,1,7
SAU,CAN,2019.0,95,155,-60
POL,NLD,2015.0,18,10,8
IRQ,TUR,2017.0,5,17,-12
FRA,FIN,2021.0,30,27,3
DEU,IRN,2017.0,46,90,-44
GBR,RUS,2004.0,53,66,-13
IDN,NLD,2017.0,16,48,-32
FIN,CHE,2020.0,20,16,4
GBR,TUR,2016.0,66,45,21
GBR,CMR,2017.0,8,1,7
ESP,URY,2020.0,19,16,3
GBR,IRL,2023.0,208,225,-17
JPN,BGD,2022.0,89,62,27
BEL,SVN,2018.0,4,10,-6
IND,BHR,2017.0,2,1,1
NAM,ZAF,2022.0,8,11,-3
CHN,CAN,2013.0,259,304,-45
IRQ,MYS,2017.0,20,140,-120
NOR,FIN,2021.0,23,34,-11
BEL,NER,2019.0,1,1,0
GBR,CYP,2006.0,11,8,3
ISL,NOR,2011.0,7,3,4
NOR,ISL,2016.0,6,5,1
ESP,VEN,2016.0,28,34,-6
BRA,PRT,2015.0,143,164,-21
NLD,IND,2005.0,13,10,3
GBR,NOR,2021.0,136,59,77
IRQ,AUS,2021.0,8,37,-29
BLR,USA,2001.0,13,8,5
DEU,KEN,2019.0,23,14,9
THA,GBR,2020.0,69,128,-59
DEU,FIN,2023.0,38,32,6
IRN,PRT,2018.0,17,2,15
USA,MYS,2021.0,35,42,-7
NZL,DEU,2020.0,34,33,1
USA,NOR,2020.0,133,69,64
PAK,USA,2013.0,82,65,17
KOR,CHN,2016.0,200,149,51
USA,SLE,2016.0,5,6,-1
CAN,HKG,2022.0,21,35,-14
ESP,CHN,2017.0,57,35,22
TTO,USA,2017.0,6,9,-3
BEL,CAN,2006.0,36,26,10
MYS,IRQ,2013.0,42,8,34
CZE,SWE,2020.0,27,11,16
IRL,PRT,2020.0,8,14,-6
MEX,PER,2013.0,4,3,1
CAN,SWE,2011.0,38,29,9
IND,CZE,2020.0,36,7,29
DNK,CHL,2020.0,4,8,-4
GLP,FRA,2019.0,24,28,-4
BEL,CHL,2017.0,21,4,17
ETH,USA,2021.0,23,32,-9
ESP,JPN,2020.0,17,23,-6
NGA,CAN,2014.0,6,3,3
SAU,CAN,2021.0,92,139,-47
ZAF,CHN,2020.0,25,13,12
THA,CAN,2019.0,13,19,-6
DEU,ISR,2016.0,51,49,2
SAU,BHR,2017.0,2,3,-1
COL,AUS,2016.0,13,5,8
CIV,FRA,2009.0,41,27,14
USA,SGP,2008.0,183,166,17
SGP,CHN,2016.0,336,263,73
SAU,IND,2023.0,57,58,-1
BHR,EGY,2019.0,4,2,2
ESP,IND,1998.0,1,9,-8
CHN,NLD,2011.0,78,52,26
NGA,MYS,2016.0,50,48,2
NGA,ETH,2017.0,4,3,1
IDN,VNM,2020.0,4,3,1
AZE,USA,2016.0,4,7,-3
LKA,CHN,2020.0,3,11,-8
ESP,MLT,2019.0,3,1,2
IND,GBR,2019.0,318,223,95
ISR,GBR,2015.0,54,49,5
ARM,USA,2000.0,9,5,4
USA,ARM,2001.0,4,8,-4
AUS,SGP,2015.0,68,89,-21
NGA,CAN,2015.0,16,5,11
CAN,MLI,2016.0,6,1,5
CHE,HKG,2023.0,5,3,2
SWE,AUS,2014.0,50,57,-7
CHE,IND,2019.0,34,58,-24
SAU,DEU,2020.0,24,34,-10
POL,CHN,2017.0,13,9,4
SWE,AUT,2020.0,29,39,-10
CHE,CHN,2016.0,51,77,-26
ECU,ESP,2020.0,66,82,-16
FRA,HRV,2021.0,3,3,0
ITA,FIN,2018.0,36,21,15
KOR,THA,2020.0,19,12,7
THA,USA,2020.0,151,235,-84
ROU,FRA,2022.0,21,11,10
PER,ESP,2021.0,29,39,-10
AUT,CZE,2023.0,10,16,-6
PHL,ITA,2019.0,2,4,-2
SAU,PSE,2022.0,9,1,8
AUT,GBR,2016.0,86,107,-21
AUS,QAT,2014.0,9,3,6
GRL,DNK,2018.0,7,4,3
MYS,NGA,2013.0,21,23,-2
TUN,DEU,2017.0,6,4,2
DEU,TUN,2021.0,5,5,0
GTM,USA,2018.0,11,17,-6
CHE,COL,2009.0,4,4,0
ITA,CHN,2020.0,87,66,21
TUR,CAN,2018.0,40,27,13
TWN,NZL,2017.0,5,3,2
IRN,LBN,2019.0,1,1,0
FRA,POL,2017.0,43,46,-3
ESP,PHL,2017.0,5,6,-1
NLD,IRL,2015.0,17,15,2
BGR,ZAF,2019.0,1,1,0
NZL,SGP,2017.0,14,10,4
SGP,USA,2020.0,200,238,-38
JPN,NGA,2018.0,12,7,5
JPN,THA,1999.0,34,21,13
USA,LBN,2020.0,78,107,-29
CAN,TWN,2012.0,19,16,3
CYP,GBR,2019.0,23,47,-24
IRN,HUN,2018.0,4,2,2
GHA,GBR,2015.0,10,33,-23
HKG,USA,2023.0,107,132,-25
JPN,BGD,2017.0,91,68,23
VEN,PER,2006.0,1,1,0
HKG,CAN,2014.0,24,26,-2
FRA,ZAF,2018.0,33,16,17
IDN,NLD,2016.0,20,38,-18
ESP,CHE,2024.0,2,1,1
FRA,MAR,2016.0,98,48,50
THA,MMR,2016.0,3,3,0
GRC,DEU,2019.0,78,52,26
SVN,AUT,2017.0,9,3,6
CAN,JOR,2012.0,20,10,10
FRA,LBN,2019.0,106,55,51
KOR,CHN,2018.0,254,162,92
PRT,GBR,2014.0,109,74,35
USA,JOR,2023.0,24,47,-23
IRN,PRT,2016.0,11,8,3
IND,KOR,2023.0,234,112,122
UGA,USA,2018.0,37,41,-4
SWE,JPN,2021.0,19,29,-10
JOR,USA,2012.0,34,45,-11
IND,MEX,2020.0,9,9,0
IRL,CHN,2017.0,26,14,12
ESP,POL,2018.0,28,24,4
LUX,ESP,2017.0,3,7,-4
DEU,SVK,2015.0,6,14,-8
AUS,CHE,2018.0,77,73,4
MEX,CHN,2019.0,13,10,3
ESP,CZE,2015.0,37,15,22
UGA,NGA,2019.0,5,3,2
ESP,LUX,2019.0,13,7,6
SVN,SVK,2022.0,11,2,9
AUS,ZAF,2018.0,31,66,-35
ETH,JPN,2019.0,2,5,-3
VEN,ESP,2009.0,52,27,25
FRA,PER,2012.0,10,7,3
PRT,DEU,2020.0,52,41,11
EGY,CHE,2018.0,7,6,1
PAK,AUS,2013.0,26,12,14
VNM,ITA,2020.0,3,7,-4
FRA,IRN,2007.0,19,8,11
IND,CHN,2017.0,173,45,128
GMB,GBR,2013.0,13,5,8
AUT,JPN,2019.0,17,14,3
FRA,KAZ,2017.0,5,2,3
IRN,FRA,2016.0,20,24,-4
ESP,EGY,2022.0,11,9,2
LBN,ITA,2016.0,7,5,2
USA,SGP,2004.0,103,128,-25
BEL,SVN,2017.0,5,4,1
CAN,SAU,2015.0,102,72,30
MYS,CHN,2021.0,55,48,7
TWN,CHE,2021.0,13,9,4
FRA,REU,2019.0,19,35,-16
CMR,GBR,2021.0,11,9,2
GBR,CMR,2022.0,7,12,-5
COD,FRA,2020.0,3,4,-1
CAN,MEX,2020.0,45,72,-27
COD,BEL,2018.0,4,11,-7
PAK,BHR,2022.0,3,1,2
CAN,SAU,2014.0,116,40,76
RUS,DEU,2014.0,123,127,-4
CHN,TZA,2020.0,19,6,13
IND,CHN,2016.0,135,28,107
ITA,JPN,2019.0,26,29,-3
ESP,CHL,2019.0,168,112,56
JPN,AUS,2019.0,69,58,11
PRT,NLD,2021.0,28,17,11
ESP,DOM,2019.0,3,1,2
FRA,AUT,2023.0,23,23,0
DEU,IRL,2004.0,22,10,12
ARE,BHR,2021.0,7,1,6
DEU,IDN,2023.0,13,6,7
ZAF,ETH,2021.0,18,10,8
IRN,SGP,2014.0,10,4,6
IND,TZA,2020.0,6,2,4
HKG,MAC,2021.0,14,7,7
TWN,DEU,2019.0,27,13,14
MMR,CHE,2019.0,5,1,4
COL,AUS,2022.0,6,8,-2
KEN,SWE,2021.0,3,5,-2
ITA,CAN,2018.0,82,52,30
CHN,THA,2023.0,57,38,19
VEN,ARG,2013.0,1,1,0
TWN,SWE,2021.0,7,6,1
JOR,IRQ,2021.0,10,4,6
DEU,JOR,2023.0,7,5,2
JPN,MYS,2019.0,49,66,-17
SWE,IND,2019.0,41,75,-34
NLD,NZL,2013.0,16,14,2
AUT,CHL,2021.0,5,7,-2
CAN,SGP,2021.0,22,31,-9
ESP,CHN,2018.0,68,43,25
HUN,ITA,2021.0,18,11,7
GRC,NLD,2020.0,36,32,4
IRN,GBR,2020.0,112,43,69
AUT,GBR,2022.0,85,106,-21
CZE,EST,2018.0,7,3,4
KHM,COG,2019.0,1,1,0
FIN,CAN,2001.0,14,17,-3
THA,IDN,2021.0,40,27,13
PAK,CMR,2022.0,2,1,1
IRN,RUS,2020.0,12,4,8
RUS,IRN,2021.0,9,9,0
CHE,COL,2019.0,6,12,-6
UKR,POL,2002.0,22,13,9
ARG,CHE,2007.0,3,2,1
MAR,FRA,2013.0,42,122,-80
BRA,MEX,2019.0,34,36,-2
FRA,IRL,2022.0,39,29,10
PAK,KOR,2017.0,50,62,-12
USA,LBY,2021.0,6,2,4
DEU,ISL,2022.0,6,4,2
FRA,LBN,2021.0,78,88,-10
URY,FRA,2021.0,4,3,1
BGD,GBR,2016.0,20,24,-4
GBR,VNM,2020.0,30,17,13
EGY,DEU,2019.0,56,78,-22
CHN,DNK,2023.0,78,72,6
BGD,SGP,2022.0,2,2,0
SGP,JPN,2019.0,38,42,-4
TUR,AUS,2020.0,21,10,11
AUT,ROU,2023.0,2,1,1
CAN,RUS,2021.0,15,16,-1
NGA,DEU,2015.0,3,5,-2
ITA,NLD,2021.0,126,104,22
JPN,BGR,2021.0,6,1,5
KOR,HKG,2019.0,18,20,-2
IRN,IRL,2020.0,18,2,16
PAK,KOR,2016.0,30,47,-17
ARE,IRL,2022.0,4,2,2
DEU,PSE,2021.0,10,1,9
RUS,KAZ,2020.0,56,49,7
OMN,AUS,2020.0,4,6,-2
ZWE,ZAF,2011.0,17,10,7
NGA,MYS,2017.0,37,104,-67
ECU,USA,2019.0,26,40,-14
JOR,CYP,2020.0,1,2,-1
RUS,CHE,2012.0,21,12,9
RWA,NLD,2020.0,3,4,-1
JOR,SAU,2017.0,32,38,-6
ZWE,ZAF,2021.0,58,53,5
PRT,DZA,2020.0,6,2,4
SWE,CAN,2012.0,34,39,-5
POL,NLD,2001.0,12,14,-2
RUS,IND,2022.0,16,21,-5
MYS,SAU,2015.0,62,14,48
MLI,BEL,2019.0,1,1,0
ZMB,JPN,2016.0,5,6,-1
USA,MAC,2019.0,8,11,-3
FRA,BOL,2019.0,3,1,2
GBR,PAK,2011.0,62,48,14
JPN,AUS,2021.0,58,60,-2
CHE,BRA,2023.0,16,23,-7
KOR,PHL,2022.0,18,13,5
BGD,MYS,2002.0,5,2,3
MEX,ITA,2020.0,29,27,2
NLD,MYS,2021.0,11,9,2
COL,ARG,2021.0,13,21,-8
ARM,USA,2010.0,12,4,8
CHL,ESP,2008.0,52,48,4
BEL,VNM,2021.0,21,7,14
ESP,CHN,2022.0,71,58,13
EGY,DEU,2021.0,53,67,-14
AUS,HKG,2022.0,44,34,10
MYS,NLD,2021.0,9,11,-2
HKG,NZL,2019.0,9,3,6
ARM,DEU,2005.0,5,3,2
JPN,MYS,2021.0,43,52,-9
COL,AUS,2018.0,12,7,5
NIC,ESP,2021.0,1,2,-1
HUN,SGP,2012.0,5,2,3
AUT,JPN,2021.0,15,15,0
FRA,PHL,2019.0,4,1,3
ARE,CAN,2018.0,29,26,3
VEN,COL,2022.0,16,5,11
NPL,CHN,2019.0,8,17,-9
SWE,EST,2019.0,10,8,2
BMU,USA,2020.0,1,2,-1
NGA,HKG,2021.0,6,3,3
NLD,DNK,2003.0,25,21,4
ESP,CHL,2021.0,126,140,-14
BGD,GBR,2017.0,27,14,13
RUS,AUS,2019.0,15,10,5
AUS,CYP,2020.0,3,1,2
PAN,ITA,2019.0,1,4,-3
ZAF,CHE,2021.0,15,12,3
PRT,AUS,2023.0,5,6,-1
FRA,NLD,2023.0,73,59,14
PHL,CAN,2023.0,8,4,4
FIN,POL,2017.0,5,8,-3
IND,RUS,2022.0,21,16,5
SWE,FRA,2017.0,46,93,-47
GNB,DNK,2008.0,1,3,-2
ETH,USA,2019.0,31,33,-2
RUS,BEL,2023.0,16,3,13
CHN,JOR,2020.0,3,2,1
BEL,GRC,2020.0,20,26,-6
VNM,GBR,2011.0,14,20,-6
BEL,ITA,2002.0,44,38,6
HUN,AUT,2017.0,27,20,7
EGY,ARE,2019.0,18,8,10
CHN,IDN,2020.0,12,12,0
IRL,CHN,2022.0,29,36,-7
AUS,RUS,2017.0,9,12,-3
NGA,BEL,2022.0,6,2,4
ARG,FRA,2019.0,50,39,11
HKG,CHN,2024.0,90,37,53
IRN,IRL,1999.0,2,1,1
FRA,IRL,2016.0,34,29,5
QAT,GBR,2023.0,15,11,4
GBR,MOZ,2018.0,4,1,3
BGD,USA,2023.0,122,63,59
JPN,LKA,2019.0,15,9,6
EGY,NLD,2004.0,4,5,-1
SAU,MYS,2010.0,4,19,-15
NGA,NOR,2023.0,1,1,0
CHE,RUS,2017.0,23,15,8
EGY,IRQ,2021.0,15,8,7
TUN,DEU,2022.0,8,2,6
HRV,ESP,2021.0,5,2,3
THA,LAO,2023.0,4,2,2
ARE,SAU,2021.0,17,40,-23
BRA,CHN,2021.0,23,8,15
DNK,GRC,2023.0,4,7,-3
CUB,ECU,2021.0,9,8,1
RWA,CHN,2021.0,6,5,1
KOR,IRN,2022.0,8,42,-34
BEN,FRA,2022.0,11,9,2
LBN,FRA,2023.0,41,26,15
GBR,JOR,2023.0,13,17,-4
VEN,ECU,2022.0,17,5,12
NLD,ZAF,2020.0,32,28,4
LTU,USA,2021.0,12,6,6
DEU,ECU,2022.0,8,11,-3
DEU,SGP,2021.0,31,43,-12
DNK,CHN,2009.0,14,18,-4
ISR,CHN,2001.0,8,6,2
DZA,FRA,2021.0,68,116,-48
SWE,TZA,2022.0,14,3,11
KWT,USA,2021.0,17,29,-12
ITA,CAN,2022.0,58,44,14
TUN,CZE,2020.0,3,1,2
MLT,ESP,2015.0,1,2,-1
ISL,NOR,2021.0,5,8,-3
GBR,TZA,2021.0,21,9,12
VNM,BRA,2021.0,2,2,0
CHN,NPL,2022.0,27,13,14
AUS,PHL,2022.0,13,19,-6
IND,VNM,2022.0,7,13,-6
COL,BRA,2018.0,70,76,-6
FRA,ARM,2022.0,2,1,1
JPN,ITA,2021.0,23,34,-11
TUR,IRL,2005.0,5,1,4
PAK,IRL,2021.0,18,6,12
NLD,SVN,2022.0,3,2,1
PRT,NLD,2019.0,31,22,9
NGA,PAK,2023.0,4,5,-1
RUS,AUS,2021.0,16,9,7
FRA,TUR,2016.0,27,26,1
BGR,USA,2016.0,17,9,8
TWN,THA,2023.0,18,7,11
CZE,POL,2017.0,19,19,0
DEU,POL,2023.0,48,43,5
UKR,LTU,2016.0,2,2,0
SRB,TUR,2022.0,4,2,2
GBR,TWN,2023.0,19,20,-1
BEL,CAN,2023.0,13,27,-14
BRA,POL,2022.0,14,5,9
ITA,CZE,2022.0,40,13,27
ISR,KOR,2021.0,10,5,5
ISR,DEU,2023.0,36,36,0
RUS,CZE,2021.0,23,7,16
TUR,DNK,2018.0,14,3,11
RUS,FRA,2023.0,61,23,38
CHE,JPN,2021.0,36,39,-3
DEU,KOR,2020.0,61,88,-27
JOR,SAU,2018.0,31,41,-10
NLD,NOR,2021.0,43,32,11
FIN,SWE,2005.0,31,30,1
GRC,FRA,1997.0,15,16,-1
GBR,ISR,2014.0,46,61,-15
BRA,CUB,2016.0,8,29,-21
FRA,RUS,2007.0,41,59,-18
DEU,CHN,1997.0,45,61,-16
VNM,JPN,2013.0,10,45,-35
NGA,SAU,2013.0,6,9,-3
MYS,USA,2001.0,16,11,5
FRA,MTQ,2012.0,37,13,24
KOR,HKG,2021.0,10,19,-9
POL,ZAF,2004.0,2,2,0
USA,NAM,2020.0,10,1,9
FIN,ITA,2009.0,11,15,-4
FIN,AUS,2014.0,14,13,1
UKR,JPN,2002.0,13,6,7
GBR,HUN,1997.0,14,20,-6
JOR,OMN,2000.0,2,3,-1
SAU,JOR,2014.0,22,40,-18
BRA,GBR,2009.0,51,63,-12
NPL,IND,2002.0,8,18,-10
BLR,RUS,1999.0,23,14,9
DNK,CHN,2019.0,71,81,-10
IRL,GBR,1997.0,86,84,2
HUN,PRT,2008.0,6,1,5
PRT,HUN,2012.0,3,2,1
SGP,USA,1998.0,52,66,-14
CHN,DNK,2006.0,14,10,4
ZAF,DEU,2009.0,19,26,-7
DEU,ZAF,2011.0,30,21,9
FIN,ITA,2011.0,8,19,-11
PRT,NLD,2009.0,15,16,-1
FIN,GBR,2000.0,30,15,15
BGR,ITA,2017.0,1,4,-3
SWE,ESP,1997.0,9,20,-11
CAN,SRB,2006.0,4,4,0
UKR,CHN,2016.0,13,3,10
TUR,UKR,1997.0,2,2,0
CMR,FRA,1999.0,7,14,-7
HUN,ITA,2009.0,19,6,13
GBR,GRC,1999.0,90,64,26
CAN,COL,2000.0,4,3,1
COL,CAN,2001.0,5,4,1
CHE,AUS,2000.0,32,32,0
FIN,USA,1998.0,69,79,-10
TUR,RUS,2001.0,3,5,-2
CAN,IRN,1999.0,25,4,21
GRC,CHE,2015.0,38,18,20
USA,CRI,1998.0,10,19,-9
JPN,AUS,2009.0,63,57,6
LBN,USA,2000.0,18,35,-17
JPN,SAU,2005.0,3,1,2
PRT,FRA,2006.0,20,31,-11
ITA,ZAF,2001.0,5,7,-2
ITA,FIN,2016.0,24,14,10
JPN,SAU,2012.0,13,3,10
CHE,GRC,2003.0,11,10,1
ASM,USA,1999.0,2,1,1
DNK,AUT,2014.0,6,12,-6
JPN,FRA,2008.0,88,65,23
EGY,FRA,2001.0,4,2,2
CHE,HKG,2006.0,6,2,4
VNM,SWE,2008.0,3,3,0
ISR,CAN,1999.0,29,28,1
BGR,RUS,2002.0,8,5,3
CHE,IND,2011.0,18,35,-17
USA,PAN,2002.0,15,14,1
ITA,NOR,1998.0,16,1,15
SEN,FRA,2001.0,29,21,8
CHE,NLD,2016.0,83,99,-16
SAU,NGA,2003.0,4,4,0
CAN,BEL,1997.0,20,6,14
SWE,ESP,2002.0,24,27,-3
DEU,ARG,1997.0,9,15,-6
ZAF,NZL,2005.0,10,2,8
CAN,RUS,2011.0,16,24,-8
DEU,NGA,1998.0,4,6,-2
FIN,RUS,2014.0,18,29,-11
CHL,CAN,2017.0,20,24,-4
TZA,GBR,2005.0,3,9,-6
SWE,FRA,2022.0,68,96,-28
CHL,ESP,2014.0,73,157,-84
USA,CZE,2007.0,43,51,-8
PAN,DEU,2018.0,4,1,3
BGR,DEU,1999.0,29,13,16
IND,MYS,2004.0,12,12,0
CAN,IND,1999.0,22,39,-17
QAT,EGY,1999.0,6,1,5
DEU,BGR,2002.0,39,22,17
FRA,CHN,2002.0,38,48,-10
CAN,KOR,2016.0,37,43,-6
USA,CYP,2011.0,23,11,12
JPN,DNK,1998.0,5,10,-5
ESP,JPN,1999.0,7,9,-2
RUS,ITA,1999.0,52,26,26
LBY,IND,1999.0,1,1,0
MYS,USA,2014.0,48,48,0
MWI,USA,2007.0,3,6,-3
DEU,CHN,2002.0,80,143,-63
IND,ITA,2003.0,22,14,8
NLD,BGR,1999.0,2,3,-1
IND,FRA,1997.0,22,21,1
CAN,MEX,2007.0,31,25,6
NOR,CHE,1998.0,4,4,0
USA,SVK,2017.0,13,7,6
JPN,MEX,2005.0,5,2,3
RUS,JPN,2005.0,28,35,-7
FRA,SRB,2000.0,5,6,-1
GBR,RUS,2001.0,39,102,-63
GBR,NGA,1997.0,14,20,-6
BFA,BEL,2003.0,2,2,0
NCL,FRA,2010.0,25,11,14
KGZ,TUR,2021.0,4,8,-4
ISR,DEU,2000.0,36,41,-5
BEL,JPN,2004.0,12,12,0
PRT,ITA,2014.0,37,39,-2
USA,IND,2000.0,277,510,-233
SRB,DNK,1998.0,4,3,1
CAN,SVK,2008.0,1,1,0
DEU,ARE,2014.0,8,4,4
ARE,DEU,2016.0,5,11,-6
IND,BGD,2000.0,7,13,-6
AUT,CAN,2005.0,15,15,0
HKG,CHN,2000.0,160,209,-49
IND,NPL,2003.0,16,13,3
CAN,CHE,2011.0,96,81,15
PAK,USA,2003.0,32,32,0
RUS,BLR,2000.0,20,23,-3
CAN,JPN,2000.0,110,125,-15
ITA,DNK,1997.0,13,11,2
MDA,RUS,2012.0,5,2,3
BRA,DEU,2005.0,48,37,11
KEN,BEL,1998.0,2,4,-2
AUT,ITA,2015.0,32,46,-14
SRB,MKD,2001.0,13,13,0
DNK,GNB,2005.0,7,1,6
JPN,RUS,2011.0,20,18,2
IND,TWN,2000.0,17,7,10
BGR,BEL,2003.0,13,4,9
ITA,SAU,2004.0,2,2,0
GLP,FRA,2011.0,34,29,5
GEO,RUS,2006.0,7,5,2
ZAF,CHE,2009.0,7,8,-1
TUR,BIH,2011.0,2,1,1
DEU,IND,2004.0,61,99,-38
IRL,GRC,2003.0,4,1,3
USA,MYS,2009.0,31,16,15
SRB,HRV,2006.0,12,9,3
GUF,FRA,2009.0,21,9,12
NZL,ESP,2011.0,3,4,-1
SGP,USA,1999.0,51,76,-25
FRA,LUX,1997.0,4,3,1
PRT,GBR,2015.0,130,72,58
ZAF,ISR,1997.0,4,1,3
ITA,MEX,2022.0,17,28,-11
JPN,BRA,1997.0,13,9,4
BLR,RUS,1998.0,26,19,7
DEU,BEL,2005.0,59,63,-4
PRT,BRA,2005.0,47,42,5
DEU,HKG,2010.0,12,5,7
CAN,ISR,1999.0,28,29,-1
FRA,ROU,2002.0,22,36,-14
HUN,AUS,2001.0,3,3,0
SVN,HRV,2003.0,3,8,-5
CHE,NOR,2002.0,8,9,-1
NGA,GBR,1999.0,15,20,-5
DEU,NOR,2017.0,78,51,27
CAN,MEX,1999.0,11,18,-7
CHE,GHA,2015.0,1,5,-4
GBR,SAU,2000.0,22,16,6
RUS,SWE,1997.0,25,10,15
ECU,USA,2009.0,14,15,-1
SWE,CAN,1997.0,16,20,-4
SVK,CZE,1997.0,26,10,16
AZE,RUS,2003.0,3,9,-6
RWA,BEL,2000.0,2,1,1
BEL,SWE,2018.0,33,29,4
KOR,IND,2004.0,14,49,-35
ESP,ARG,1999.0,56,47,9
TWN,SGP,2007.0,5,7,-2
NLD,DNK,2013.0,34,15,19
GBR,POL,2002.0,39,46,-7
SRB,MKD,2004.0,42,8,34
ECU,FRA,2007.0,1,2,-1
POL,BEL,2005.0,9,10,-1
VEN,USA,2000.0,45,25,20
DEU,BGR,2005.0,23,23,0
USA,IDN,2008.0,24,11,13
DEU,ARE,2001.0,2,1,1
EGY,USA,1997.0,37,46,-9
VNM,KOR,2005.0,2,3,-1
GBR,TTO,2002.0,5,6,-1
CAN,BEL,2002.0,28,34,-6
FRA,GUF,2000.0,5,4,1
GUF,GUY,2006.0,1,1,0
ROU,GBR,2020.0,27,16,11
BLR,DEU,1997.0,8,10,-2
BEL,ZAF,2002.0,11,7,4
ZAF,SWE,2002.0,5,6,-1
ESP,AUS,2012.0,49,24,25
ITA,BEL,1999.0,41,31,10
TUR,GBR,2002.0,24,72,-48
CHN,CHE,2005.0,16,18,-2
PSE,DEU,1998.0,1,1,0
DEU,PSE,2009.0,6,3,3
AUT,RUS,1998.0,9,7,2
POL,CHE,1997.0,14,19,-5
DEU,HRV,2002.0,15,13,2
HRV,DEU,2003.0,14,15,-1
JPN,UKR,2009.0,3,6,-3
GRC,KOR,2017.0,4,1,3
RUS,POL,2003.0,19,19,0
FRA,BOL,2009.0,6,4,2
UKR,FRA,2000.0,14,7,7
BGD,AUS,2008.0,16,4,12
FIN,RUS,2001.0,17,34,-17
DNK,HUN,2005.0,1,1,0
LUX,BEL,1999.0,4,2,2
VEN,ECU,2017.0,45,4,41
FRA,AUT,2000.0,19,20,-1
SWE,FRA,2018.0,66,84,-18
BEL,THA,2022.0,2,2,0
HKG,CAN,2004.0,27,20,7
LBN,FRA,2000.0,18,18,0
SWE,NOR,2000.0,42,36,6
PRT,JPN,2002.0,6,1,5
JPN,PRT,2003.0,9,3,6
CHN,EGY,2003.0,1,2,-1
ARG,CHL,2002.0,12,5,7
DNK,NLD,2002.0,32,29,3
ISR,JPN,2009.0,9,6,3
RUS,BLR,2010.0,22,25,-3
CZE,ITA,2002.0,10,6,4
SWE,ISL,1998.0,8,6,2
IND,BEL,2006.0,11,8,3
AUT,NLD,2000.0,25,13,12
NLD,AUT,2001.0,19,16,3
POL,CHE,2005.0,16,5,11
FIN,DNK,1998.0,6,7,-1
FIN,DEU,2001.0,34,32,2
CHE,DNK,2003.0,13,13,0
ITA,AUS,2006.0,27,19,8
TWN,FRA,2023.0,5,7,-2
DNK,AUT,2001.0,4,3,1
CZE,FRA,2006.0,13,15,-2
USA,VEN,2002.0,38,65,-27
RUS,NLD,2006.0,15,11,4
JPN,IDN,1997.0,14,4,10
USA,BGR,2012.0,12,15,-3
RUS,AUT,2006.0,8,11,-3
SMR,ITA,2016.0,5,2,3
CHL,ITA,2011.0,6,8,-2
SWE,HUN,2004.0,11,4,7
DNK,BEL,1997.0,5,5,0
USA,HUN,2021.0,48,53,-5
ITA,BLR,2001.0,2,3,-1
USA,KGZ,2007.0,1,1,0
SWE,POL,2002.0,12,10,2
ZAF,AUS,2017.0,48,39,9
BGR,FRA,2004.0,8,11,-3
ESP,DEU,1997.0,62,58,4
JPN,BRA,2012.0,22,8,14
GBR,BRA,2005.0,61,48,13
BGR,DEU,1998.0,18,12,6
AUT,PRT,2012.0,6,2,4
CAN,NOR,1997.0,9,7,2
DEU,ZAF,2019.0,32,44,-12
POL,ESP,1998.0,5,4,1
LKA,NZL,2013.0,6,2,4
ISR,IRL,2011.0,5,28,-23
MEX,ISR,2001.0,4,1,3
ARG,CAN,1997.0,4,6,-2
ARE,IRN,2004.0,2,1,1
NLD,TUR,2006.0,5,4,1
FRA,SVK,1997.0,6,2,4
FIN,CAN,2008.0,26,12,14
UKR,SWE,2004.0,7,3,4
ZAF,NZL,2012.0,8,8,0
GBR,POL,1997.0,35,22,13
BEL,BGR,2003.0,4,13,-9
MYS,JPN,2002.0,4,18,-14
NOR,NLD,1998.0,10,11,-1
NOR,DNK,2003.0,23,22,1
NZL,IRL,1998.0,2,1,1
NLD,AUT,2014.0,28,23,5
SAU,QAT,2015.0,15,5,10
HKG,FRA,2011.0,6,2,4
SVN,GBR,2000.0,5,5,0
POL,RUS,1998.0,13,14,-1
FRA,TUN,2008.0,113,68,45
NOR,ZAF,2003.0,1,2,-1
USA,HTI,2016.0,9,8,1
GHA,SWE,2012.0,2,4,-2
GRC,ESP,2017.0,18,29,-11
CHE,SRB,2020.0,5,7,-2
CHL,ESP,2015.0,76,159,-83
GBR,CHL,2015.0,39,42,-3
TWN,MYS,2023.0,5,9,-4
BRA,NOR,2020.0,24,8,16
KEN,NLD,2015.0,7,12,-5
FRA,PAK,2014.0,44,9,35
SWE,BGR,2021.0,3,1,2
CHE,POL,2020.0,17,27,-10
SGP,JPN,2009.0,15,30,-15
AUS,VNM,2014.0,23,16,7
FIN,BRA,2023.0,3,11,-8
UGA,GBR,2014.0,10,10,0
THA,FRA,2008.0,11,14,-3
IRN,MYS,2012.0,83,98,-15
FRA,THA,2017.0,26,20,6
DEU,CZE,2007.0,33,42,-9
SWE,PRT,2023.0,7,7,0
SGP,KOR,2020.0,41,29,12
IRL,BEL,2011.0,6,9,-3
CAN,PRT,2020.0,9,15,-6
PHL,THA,2018.0,7,3,4
GBR,MEX,2011.0,57,30,27
NOR,GRL,2009.0,1,1,0
DNK,GRL,2017.0,8,11,-3
IND,FRA,2012.0,80,65,15
DNK,HRV,2019.0,3,3,0
GEO,DEU,2009.0,6,15,-9
GRC,ESP,2016.0,17,15,2
USA,LUX,2013.0,11,6,5
NLD,ESP,2003.0,39,41,-2
TZA,SWE,2013.0,1,2,-1
KEN,NOR,2015.0,2,4,-2
JPN,IDN,2012.0,108,24,84
USA,FIN,2013.0,73,98,-25
RUS,FRA,2012.0,62,46,16
GBR,DEU,2018.0,807,726,81
SWE,TWN,2014.0,2,1,1
FRA,CHN,2000.0,34,29,5
EGY,QAT,2006.0,3,2,1
EGY,SAU,2006.0,72,63,9
IRL,ESP,2016.0,23,37,-14
GRC,USA,2021.0,121,94,27
JPN,ITA,1999.0,25,31,-6
DEU,TUR,2013.0,55,34,21
JPN,PHL,2011.0,25,13,12
FRA,ROU,2006.0,41,30,11
HKG,USA,2005.0,104,59,45
USA,IDN,2018.0,44,24,20
ISL,NLD,2018.0,3,3,0
PHL,JPN,2021.0,24,28,-4
KNA,USA,2022.0,8,3,5
BRA,ESP,2022.0,106,69,37
IRN,SWE,2023.0,28,7,21
HUN,JPN,1999.0,4,4,0
JPN,UKR,1999.0,3,14,-11
BGR,ESP,2012.0,3,2,1
HKG,KOR,2019.0,20,18,2
AUT,BEL,2023.0,20,17,3
RUS,GRC,2022.0,7,1,6
BRA,SWE,2010.0,11,10,1
FRA,MTQ,2010.0,19,20,-1
BEN,FRA,2001.0,3,3,0
CHE,POL,2009.0,12,22,-10
NLD,ZAF,2021.0,18,30,-12
CAN,POL,2019.0,17,14,3
ARE,CAN,2001.0,4,11,-7
NOR,NLD,2019.0,23,40,-17
USA,CYP,2020.0,20,10,10
DEU,ECU,2014.0,6,1,5
BEL,TZA,2018.0,3,3,0
CAN,BEL,2023.0,27,13,14
BRA,IND,2017.0,11,28,-17
BEL,CAN,1997.0,6,20,-14
GBR,MWI,2023.0,9,19,-10
IND,EGY,2018.0,6,6,0
SEN,TGO,2020.0,4,1,3
MAC,CHN,2007.0,9,5,4
IRN,MYS,2023.0,13,9,4
HKG,USA,1997.0,40,90,-50
PRT,CZE,2021.0,7,4,3
DEU,CUB,2016.0,5,8,-3
EGY,ZAF,2018.0,3,4,-1
ROU,CAN,2008.0,3,2,1
CHN,LTU,2021.0,5,3,2
TUR,DEU,2013.0,34,55,-21
ASM,USA,2011.0,4,1,3
URY,CHE,2008.0,1,1,0
CUB,DEU,2013.0,12,2,10
CHL,DEU,2012.0,18,39,-21
TUR,ROU,2018.0,2,3,-1
ESP,MEX,1998.0,49,47,2
FIN,AUS,2022.0,8,16,-8
ZAF,NGA,2003.0,11,9,2
EGY,JOR,2013.0,2,3,-1
AUS,PNG,2000.0,8,9,-1
DOM,USA,2018.0,1,1,0
KAZ,POL,2019.0,1,1,0
HUN,CHN,2022.0,4,10,-6
GMB,ZAF,2010.0,2,2,0
PER,ECU,2001.0,1,2,-1
ISL,ITA,2022.0,2,1,1
BLZ,USA,2014.0,2,2,0
GBR,CMR,2015.0,4,3,1
OMN,LBY,2022.0,1,2,-1
LKA,THA,2023.0,2,1,1
ROU,CAN,2015.0,3,1,2
NGA,ARE,2021.0,3,1,2
CHN,DNK,2005.0,9,8,1
SAU,FRA,2012.0,6,32,-26
CHE,PRT,2019.0,15,23,-8
ZAF,ESP,2003.0,3,2,1
ESP,RUS,1998.0,16,8,8
BIH,HRV,2009.0,5,10,-5
FJI,AUS,2004.0,7,7,0
NOR,CHE,2021.0,18,33,-15
MTQ,FRA,2012.0,13,37,-24
SVK,DNK,2008.0,2,1,1
COL,PAN,2012.0,2,4,-2
HUN,ESP,2017.0,5,7,-2
NLD,MEX,2009.0,4,7,-3
JAM,TTO,2016.0,7,4,3
NZL,SWE,2003.0,5,3,2
FIN,HUN,2020.0,1,2,-1
GBR,PER,2002.0,1,2,-1
EGY,LBY,2007.0,1,1,0
MYS,PHL,2002.0,1,5,-4
AUT,URY,2013.0,1,1,0
NOR,HUN,2006.0,2,3,-1
DEU,PSE,1998.0,1,1,0
FIN,BGD,2022.0,3,1,2
PRT,AGO,2023.0,1,1,0
NLD,MYS,2007.0,4,1,3
PER,ESP,2007.0,6,8,-2
IRN,BGD,2021.0,2,1,1
SUR,NLD,2011.0,1,1,0
UKR,BLR,2015.0,2,3,-1
USA,ZWE,2003.0,6,3,3
HRV,NLD,2018.0,5,5,0
MEX,AUS,2023.0,4,3,1
NLD,ARG,2016.0,5,6,-1
IND,AFG,2017.0,3,1,2
FIN,IRL,2017.0,5,4,1
COL,PRI,2021.0,1,6,-5
LIE,DEU,2005.0,3,3,0
URY,PRY,2019.0,1,5,-4
MEX,PRT,2022.0,2,3,-1
SWE,IRL,2013.0,3,14,-11
CZE,SAU,2019.0,2,3,-1
PRT,NZL,2005.0,2,1,1
SWE,MEX,2004.0,3,2,1
KWT,MYS,2015.0,1,1,0
SLV,USA,2012.0,1,1,0
FIN,BGD,2018.0,1,3,-2
EGY,ZAF,2017.0,4,1,3
SRB,DNK,2009.0,2,2,0
PER,CRI,2008.0,1,1,0
DNK,IDN,2017.0,1,2,-1
SYR,FRA,2001.0,1,4,-3
DNK,ISR,2019.0,2,4,-2
AUS,NCL,2011.0,1,1,0
USA,BWA,2000.0,1,1,0
GHA,CZE,2021.0,1,2,-1
SYR,CHN,2023.0,1,2,-1
KOR,PHL,2008.0,1,4,-3
PER,VEN,2011.0,1,1,0
IRN,HUN,2004.0,1,1,0
SVN,IND,2018.0,1,1,0
ISR,ZWE,1997.0,1,1,0
LBN,ITA,2014.0,1,6,-5
FIN,HUN,1999.0,1,2,-1
CAN,BEL,2021.0,45,44,1
USA,JPN,2003.0,1356,1634,-278
COL,MEX,2006.0,7,9,-2
CHN,SGP,2019.0,306,469,-163
DEU,USA,2022.0,999,1031,-32
NZL,GBR,2016.0,122,133,-11
FRA,RUS,2000.0,55,71,-16
SWE,CHN,2001.0,29,28,1
USA,AUS,2022.0,486,614,-128
AUS,IDN,2002.0,14,9,5
ESP,USA,1999.0,295,264,31
USA,ITA,2009.0,416,601,-185
UKR,RUS,2015.0,244,45,199
SAU,EGY,2013.0,173,291,-118
HRV,BIH,2006.0,17,9,8
USA,ISL,2007.0,15,11,4
NLD,USA,2009.0,299,306,-7
DNK,NPL,2013.0,2,2,0
AUT,FRA,2008.0,25,27,-2
VEN,GBR,2012.0,4,2,2
DEU,NOR,2013.0,75,40,35
ITA,FRA,2016.0,396,259,137
FRA,ESP,2001.0,145,142,3
DEU,JPN,2008.0,112,113,-1
ESP,MEX,2005.0,77,62,15
AUS,DEU,2010.0,124,157,-33
CAN,ZAF,2012.0,19,16,3
JPN,CHE,2007.0,29,37,-8
SAU,TUN,2020.0,64,165,-101
DEU,POL,2007.0,77,90,-13
CHL,ARG,2013.0,18,17,1
CAN,ISR,2006.0,15,48,-33
ESP,MEX,2002.0,82,72,10
JPN,AUS,2005.0,54,39,15
GBR,FIN,2001.0,41,45,-4
AUS,EST,2022.0,5,2,3
AUS,PAK,2020.0,35,63,-28
FRA,CHN,2021.0,277,165,112
USA,MDA,2018.0,8,9,-1
BRA,SWE,2021.0,44,18,26
PAK,ESP,2018.0,8,7,1
CHE,AUT,2008.0,37,50,-13
SWZ,CHE,2011.0,10,7,3
AUS,CAN,2003.0,112,127,-15
ARG,BRA,2022.0,26,26,0
DEU,VNM,2021.0,35,19,16
NOR,ETH,2020.0,20,5,15
GBR,IRL,1998.0,127,120,7
PSE,ISR,2019.0,6,30,-24
BGD,IND,2003.0,10,10,0
SWE,CHE,2021.0,65,72,-7
SWE,SGP,1999.0,8,4,4
SWE,NOR,1998.0,53,28,25
GBR,NLD,1997.0,92,108,-16
UKR,RUS,2001.0,61,68,-7
HRV,CHE,2009.0,5,6,-1
ITA,GRC,2002.0,16,22,-6
USA,IRL,2023.0,76,89,-13
HUN,CZE,2000.0,3,2,1
FRA,ARG,2008.0,27,15,12
DEU,CZE,2023.0,37,40,-3
MEX,NLD,2016.0,15,10,5
FIN,SWE,2021.0,77,76,1
PAK,SAU,2013.0,82,22,60
IND,NPL,2017.0,36,17,19
JPN,GBR,2012.0,125,139,-14
MEX,CUB,1998.0,7,16,-9
MTQ,FRA,2020.0,27,20,7
AUS,POL,2000.0,3,5,-2
ZAF,AUT,2004.0,4,3,1
FRA,ISR,2006.0,25,16,9
HUN,DEU,2018.0,61,26,35
AUS,EGY,2020.0,11,20,-9
EGY,ITA,2021.0,19,23,-4
BRA,SWE,2019.0,31,16,15
MAR,ESP,2005.0,10,7,3
CAN,TWN,2011.0,20,21,-1
IRN,MYS,2009.0,43,10,33
SGP,DEU,2018.0,41,37,4
SWE,IRL,2014.0,12,21,-9
NCL,USA,2010.0,2,1,1
AUT,CAN,2019.0,23,23,0
PHL,JPN,2006.0,18,18,0
ZAF,MOZ,2016.0,5,2,3
FRA,MTQ,2021.0,19,25,-6
SAU,GBR,2004.0,12,34,-22
GBR,LBY,2018.0,20,2,18
NLD,MEX,2000.0,4,6,-2
CAN,RUS,2005.0,19,28,-9
EST,SWE,2005.0,3,7,-4
JPN,PHL,2006.0,18,18,0
GUM,USA,2002.0,7,7,0
CAN,ZAF,2002.0,12,23,-11
SWE,SVK,2010.0,3,7,-4
PAK,BEL,2021.0,6,10,-4
AUS,BGD,2017.0,37,77,-40
GEO,RUS,2020.0,5,6,-1
SRB,HRV,1999.0,8,3,5
USA,COL,2005.0,62,40,22
DEU,KEN,2012.0,10,11,-1
PAK,IND,1999.0,2,4,-2
DNK,JPN,2016.0,11,9,2
AUS,IDN,2012.0,32,18,14
TWN,JPN,2010.0,28,51,-23
SVK,HRV,2014.0,2,4,-2
GRC,MKD,2018.0,1,5,-4
ROU,DNK,2010.0,4,1,3
MEX,AUS,2019.0,16,9,7
CHE,BEL,2019.0,55,76,-21
GBR,ETH,2004.0,10,3,7
GBR,MAR,2011.0,1,1,0
CHN,PRT,2018.0,9,19,-10
GBR,TTO,2009.0,7,4,3
GBR,KEN,2000.0,15,6,9
PER,FRA,2002.0,1,1,0
CHL,BRA,2006.0,7,15,-8
UZB,RUS,2022.0,5,8,-3
ZAF,NGA,2014.0,33,52,-19
CHN,AUT,2013.0,12,15,-3
MYS,JPN,2011.0,18,70,-52
CHN,MNG,2022.0,3,14,-11
GHA,ZAF,2010.0,7,5,2
CAN,NLD,2009.0,46,40,6
GEO,RUS,2007.0,6,5,1
NOR,FRA,2008.0,13,38,-25
PHL,KOR,2015.0,5,9,-4
SWE,VNM,2002.0,6,1,5
ESP,BGR,1998.0,3,3,0
VEN,ITA,2000.0,2,3,-1
GEO,RUS,1998.0,7,1,6
AUT,FRA,2014.0,27,38,-11
FJI,USA,1998.0,1,1,0
RUS,AUS,2012.0,12,3,9
GBR,KEN,2006.0,18,13,5
CHN,IRN,2016.0,10,27,-17
CHL,FRA,2017.0,22,58,-36
FRA,LTU,2009.0,4,3,1
SRB,CAN,2009.0,3,5,-2
IND,QAT,2014.0,5,5,0
EST,RUS,2013.0,1,7,-6
NZL,PHL,2017.0,3,4,-1
ITA,KEN,2013.0,5,3,2
AUS,TWN,2011.0,18,13,5
CZE,JPN,2012.0,6,5,1
GNQ,ESP,2008.0,1,2,-1
DEU,ETH,2022.0,12,13,-1
NPL,NOR,2021.0,4,6,-2
GBR,PHL,2021.0,8,12,-4
KHM,JPN,2017.0,1,8,-7
MKD,MNE,2018.0,2,1,1
PHL,VNM,2021.0,3,3,0
SVN,NLD,2000.0,1,2,-1
JOR,DEU,2005.0,10,8,2
BRA,SWE,2011.0,13,9,4
ETH,SWE,2015.0,2,3,-1
CHE,GRC,2017.0,11,39,-28
VNM,NLD,2006.0,3,7,-4
MLI,GIN,2021.0,3,2,1
CUB,DOM,2020.0,2,1,1
UKR,BEL,2018.0,3,3,0
THA,CZE,2019.0,1,1,0
USA,OMN,2023.0,3,8,-5
ARG,BOL,2015.0,1,1,0
MAC,CHN,2002.0,5,3,2
FRA,KOR,2005.0,12,6,6
IND,AUS,1998.0,22,13,9
AUS,SVN,2010.0,1,1,0
GBR,PER,2007.0,3,5,-2
ESP,POL,2003.0,3,8,-5
MDG,USA,2016.0,3,4,-1
LUX,DNK,2014.0,2,1,1
GRC,HUN,2023.0,1,3,-2
AND,ESP,2012.0,3,1,2
UGA,RWA,2021.0,4,3,1
GRD,JAM,2017.0,1,1,0
IND,SYR,2020.0,3,1,2
UZB,KOR,2021.0,7,4,3
OMN,AUS,2006.0,4,2,2
HUN,ITA,1997.0,4,3,1
IRL,THA,2019.0,1,1,0
MLT,ITA,2019.0,6,5,1
NPL,SWE,2017.0,3,1,2
FIN,DZA,2020.0,1,4,-3
ZAF,LSO,2013.0,2,2,0
BRA,VEN,2017.0,5,5,0
FJI,IND,2007.0,2,2,0
SVK,HRV,2001.0,4,1,3
TWN,FRA,2007.0,6,8,-2
SDN,SAU,2006.0,4,5,-1
SYR,DEU,2013.0,2,6,-4
IRN,PAK,2008.0,1,1,0
LTU,BEL,2008.0,1,1,0
OMN,JPN,2023.0,1,1,0
CYP,ESP,2019.0,1,4,-3
SRB,ITA,2000.0,6,3,3
SRB,CHE,2010.0,4,2,2
JPN,BGR,2002.0,9,11,-2
EST,GBR,1999.0,2,2,0
SEN,GBR,2019.0,1,2,-1
PHL,SGP,2005.0,3,1,2
TTO,GBR,2009.0,4,7,-3
NZL,AUT,2020.0,1,5,-4
DNK,POL,2001.0,6,6,0
MDA,ROU,2011.0,5,6,-1
EGY,QAT,2021.0,9,10,-1
CAN,IDN,2019.0,4,4,0
DEU,UZB,2004.0,2,2,0
RWA,NLD,2023.0,1,1,0
QAT,NZL,2014.0,1,3,-2
DEU,PSE,2005.0,2,2,0
CHE,TUN,2005.0,2,2,0
SGP,RUS,2015.0,6,3,3
CHE,KHM,2009.0,1,3,-2
ROU,TUR,2003.0,3,1,2
ARG,URY,2003.0,2,2,0
KWT,EGY,2003.0,8,4,4
TTO,NZL,2011.0,2,1,1
DEU,LTU,2001.0,6,5,1
RUS,CHN,2005.0,5,3,2
KEN,NZL,2020.0,2,2,0
SWE,ISR,2011.0,1,6,-5
DNK,EGY,2002.0,2,5,-3
BRA,FIN,2022.0,7,9,-2
DNK,EGY,1997.0,2,1,1
CHN,CMR,2015.0,1,2,-1
PAK,MEX,2018.0,1,1,0
AUS,SVN,2006.0,1,2,-1
CHN,LTU,2023.0,1,1,0
USA,KAZ,1999.0,1,1,0
NOR,UGA,2015.0,8,4,4
LBY,GBR,2019.0,2,19,-17
IRN,IRQ,2016.0,7,4,3
DEU,SYR,2016.0,3,2,1
KAZ,ITA,2022.0,5,4,1
AUS,IDN,1997.0,3,4,-1
MYS,BEL,2009.0,3,3,0
SGP,AUT,2021.0,3,2,1
NZL,SAU,2019.0,4,6,-2
NPL,BEL,2012.0,3,1,2
ITA,SEN,2020.0,2,1,1
UKR,FIN,2000.0,4,2,2
AUS,PRT,2012.0,4,6,-2
AUS,SRB,2020.0,1,1,0
PAN,MEX,2010.0,3,2,1
ETH,BWA,2016.0,1,1,0
LIE,DEU,1999.0,2,1,1
SWZ,TWN,2021.0,1,1,0
TTO,IND,2017.0,4,2,2
CAN,IDN,2011.0,5,1,4
BRN,PHL,2020.0,1,1,0
COG,SEN,2005.0,1,1,0
SWE,OMN,2008.0,1,1,0
SAU,CHE,2014.0,2,7,-5
DEU,MAR,1998.0,1,1,0
ARG,CHE,2010.0,6,4,2
TUR,IND,2015.0,3,8,-5
GHA,SWE,2009.0,1,1,0
BGR,AUS,2010.0,2,1,1
VNM,ITA,2000.0,1,1,0
SWE,IRL,2001.0,2,11,-9
VEN,CAN,2003.0,2,4,-2
LTU,NOR,2013.0,2,1,1
JPN,EST,2023.0,1,1,0
PHL,BEL,2010.0,2,3,-1
SAU,CHE,2008.0,1,3,-2
CAN,PRT,2023.0,1,8,-7
RUS,NZL,2008.0,1,2,-1
BWA,ZWE,2014.0,1,2,-1
KEN,AUT,2018.0,2,1,1
BEL,BGR,2016.0,4,6,-2
MYS,CZE,2022.0,6,2,4
QAT,TWN,2016.0,1,2,-1
NZL,IND,2023.0,5,5,0
BGD,NOR,2019.0,2,1,1
ESP,MYS,2017.0,2,4,-2
PAK,KHM,2019.0,1,1,0
NOR,KAZ,2016.0,3,1,2
LSO,ZAF,2019.0,2,12,-10
CHE,CYP,2012.0,2,2,0
SVK,FIN,2022.0,1,1,0
SGP,ZAF,2005.0,1,2,-1
GBR,DZA,2018.0,1,11,-10
DJI,FRA,2002.0,1,1,0
CUB,CHN,2019.0,1,4,-3
BEL,MDG,2013.0,1,1,0
SAU,AUT,2017.0,2,1,1
TZA,FIN,2007.0,1,1,0
SGP,ISR,2022.0,1,1,0
CHN,COL,2016.0,1,1,0
IRQ,NGA,2020.0,2,1,1
TTO,ESP,2017.0,1,1,0
SWE,ZWE,2016.0,1,1,0
PER,MEX,2007.0,2,1,1
JOR,SAU,2003.0,2,2,0
SDN,UGA,2020.0,1,2,-1
JPN,MAC,2022.0,1,1,0
MAR,GAB,2019.0,1,1,0
ROU,TWN,2011.0,1,1,0
ZAF,LBN,2007.0,1,1,0
FRA,GTM,2016.0,1,1,0
NOR,ZWE,2001.0,1,1,0
SAU,ESP,2013.0,1,7,-6
GUY,GUF,2016.0,2,2,0
ITA,MAC,2016.0,1,0,1
NGA,COM,2000.0,1,0,1
DZA,MYS,2010.0,1,0,1
CUB,SLV,2015.0,1,0,1
BRA,SLV,2012.0,1,0,1
ETH,SOM,2019.0,1,0,1
SEN,MRT,2012.0,1,0,1
KEN,CAF,2021.0,2,0,2
JOR,FIN,2023.0,1,0,1
GHA,MCO,2015.0,1,0,1
NPL,MDV,2013.0,2,0,2
,STP,2007.0,2,0,2
JPN,KHM,2015.0,3,0,3
THA,MNG,2018.0,1,0,1
FRA,BWA,2022.0,1,0,1
MRT,MAR,2012.0,1,0,1
MWI,NGA,2012.0,1,0,1
USA,GLP,2018.0,1,0,1
GBR,NIC,2019.0,1,0,1
AUS,MTQ,2021.0,1,0,1
BLZ,PAN,2020.0,1,0,1
AFG,IRL,2020.0,1,0,1
IDN,GHA,2023.0,1,0,1
NIU,,2020.0,1,0,1
GMB,NGA,2019.0,1,0,1
ISL,IRL,2024.0,1,0,1
MWI,NLD,2018.0,4,0,4
OMN,CHE,2021.0,1,0,1
CAF,CMR,2023.0,1,0,1
,TLS,2017.0,5,0,5
JPN,ZMB,2023.0,2,0,2
CHE,LBN,2023.0,1,0,1
ARM,HKG,2023.0,1,0,1
,BMU,2017.0,2,0,2
CZE,SGP,2010.0,2,0,2
NZL,MAC,2002.0,1,0,1
HRV,TUR,2007.0,2,0,2
ISR,COL,1998.0,2,0,2
FRA,SYC,2009.0,1,0,1
USA,NAM,2003.0,2,0,2
GMB,DEU,2007.0,1,0,1
CUB,NLD,2018.0,1,0,1
UGA,CMR,1997.0,1,0,1
BRA,ARE,2016.0,1,0,1
MEX,POL,2003.0,1,0,1
GRC,BRN,2016.0,1,0,1
TLS,PHL,2014.0,1,0,1
OMN,ARG,1999.0,1,0,1
SWZ,SRB,2005.0,1,0,1
SRB,SWZ,2007.0,1,0,1
KEN,SWZ,2006.0,1,0,1
MDV,MDA,2002.0,1,0,1
GBR,LUX,2001.0,3,0,3
LUX,ZAF,2013.0,1,0,1
JPN,GHA,1997.0,1,0,1
GHA,NAM,2012.0,1,0,1
URY,VEN,2007.0,1,0,1
RUS,SAU,2009.0,1,0,1
YEM,ARE,2000.0,1,0,1
KEN,UGA,2004.0,2,0,2
KAZ,UKR,2006.0,1,0,1
NLD,MWI,2005.0,1,0,1
SGP,UZB,2002.0,1,0,1
PNG,CZE,2000.0,1,0,1
CYP,CZE,2017.0,1,0,1
JPN,LAO,2009.0,2,0,2
ZWE,CAN,2001.0,1,0,1
TUR,QAT,2009.0,1,0,1
GMB,CHE,2009.0,1,0,1
GMB,FRA,2015.0,1,0,1
USA,MNE,2009.0,1,0,1
GRD,TUR,2020.0,1,0,1
ALB,NLD,2017.0,2,0,2
HKG,GRC,2020.0,1,0,1
ZMB,NGA,2009.0,1,0,1
TTO,SAU,2014.0,1,0,1
HRV,SGP,2012.0,1,0,1
ZAF,CRI,2001.0,1,0,1
VEN,NLD,2013.0,1,0,1
KEN,PRI,2008.0,1,0,1
EGY,DZA,2013.0,1,0,1
CAN,GUM,2005.0,1,0,1
COL,AUT,2009.0,1,0,1
MAC,IND,2015.0,1,0,1
SRB,PRT,2010.0,1,0,1
PAN,PNG,2008.0,1,0,1
RWA,,2009.0,2,0,2
SWE,NER,2013.0,1,0,1
AGO,FIN,2009.0,1,0,1
HKG,CYP,2011.0,1,0,1
LAO,DEU,2018.0,1,0,1
ETH,BGD,2017.0,1,0,1
IND,TZA,2003.0,4,0,4
DNK,TWN,2009.0,1,0,1
BGR,IRL,2009.0,1,0,1
LAO,DEU,2016.0,1,0,1
SVK,LUX,2012.0,1,0,1
CUB,PER,2012.0,1,0,1
KEN,SLE,2016.0,1,0,1
LAO,BRA,2012.0,1,0,1
ITA,NCL,2020.0,1,0,1
ISL,FRA,2015.0,1,0,1
CZE,SGP,2006.0,1,0,1
UKR,BGR,2020.0,4,0,4
CHL,TWN,2019.0,2,0,2
ZWE,NAM,2014.0,2,0,2
UZB,MYS,2016.0,1,0,1
CHE,KAZ,2017.0,1,0,1
ARE,CHN,2009.0,1,0,1
KEN,SDN,2007.0,1,0,1
NLD,LIE,2021.0,1,0,1
UGA,BWA,2015.0,1,0,1
FIN,PHL,2008.0,1,0,1
,FSM,2010.0,3,0,3
COG,ITA,2018.0,1,0,1
HKG,SAU,2015.0,1,0,1
RUS,QAT,2021.0,1,0,1
PSE,ITA,2013.0,2,0,2
CHN,TGO,2015.0,1,0,1
ESP,EST,2014.0,3,0,3
SRB,CHL,2020.0,1,0,1
TUN,NGA,2011.0,1,0,1
ISL,PRT,2012.0,1,0,1
SWE,BLR,2012.0,1,0,1
BEL,QAT,2014.0,1,0,1
MLT,CAN,2015.0,1,0,1
PSE,CAN,2010.0,1,0,1
DNK,ARE,2014.0,2,0,2
CAN,FLK,2012.0,1,0,1
COL,IRN,2021.0,1,0,1
KEN,IDN,2021.0,2,0,2
QAT,NZL,2019.0,2,0,2
TWN,DNK,2013.0,3,0,3
MNG,CAN,2013.0,1,0,1
GHA,ETH,2010.0,2,0,2
FRO,ISL,2012.0,1,0,1
TLS,PRT,2013.0,1,0,1
BHR,VNM,2015.0,1,0,1
KAZ,AZE,2018.0,2,0,2
ESP,AZE,2021.0,1,0,1
JPN,GEO,2011.0,1,0,1
BLR,ESP,2017.0,1,0,1
CUB,JPN,2008.0,1,0,1
COG,JPN,2015.0,2,0,2
TJK,JPN,2017.0,1,0,1
REU,DOM,2017.0,1,0,1
RUS,ARE,2017.0,3,0,3
ARM,GBR,2020.0,1,0,1
IND,GUM,2022.0,1,0,1
LBY,USA,1998.0,1,0,1
IDN,KHM,2020.0,1,0,1
VNM,BLR,2018.0,1,0,1
GUF,CHE,2018.0,2,0,2
,GNQ,2015.0,8,0,8
UGA,BEL,2019.0,2,0,2
MWI,AUS,2022.0,1,0,1
CHL,VNM,2021.0,3,0,3
AUT,ECU,2019.0,1,0,1
HND,JAM,2018.0,1,0,1
TGO,DEU,2018.0,1,0,1
SLE,ZAF,2018.0,1,0,1
PAK,FIN,2015.0,2,0,2
IND,SGP,2024.0,1,0,1
BWA,NGA,2020.0,2,0,2
,DMA,2017.0,2,0,2
PER,AUT,2021.0,2,0,2
IRN,MEX,2018.0,2,0,2
BEL,MLI,2015.0,2,0,2
GHA,IRN,2021.0,1,0,1
UKR,HRV,2000.0,1,0,1
,BHS,2020.0,1,0,1
MNP,PHL,2022.0,1,0,1
TUR,PRT,2008.0,1,0,1
NZL,JOR,2023.0,1,0,1
,STP,2020.0,3,0,3
ARM,IRN,2023.0,3,0,3
ECU,URY,2022.0,2,0,2
NRU,,2025.0,1,0,1
TTO,EGY,2015.0,1,0,1
SGP,MAC,2022.0,5,0,5
,LIE,2020.0,4,0,4
TUN,MRT,2015.0,1,0,1
PHL,IRN,2013.0,1,0,1
LCA,USA,2021.0,2,0,2
NLD,NAM,2016.0,2,0,2
UZB,UKR,2022.0,1,0,1
SDN,NOR,2019.0,1,0,1
DEU,CUB,1997.0,3,0,3
NOR,ARE,2016.0,1,0,1
COG,BDI,2014.0,2,0,2
GMB,IRN,2016.0,1,0,1
SWZ,,2009.0,3,0,3
CYP,ESP,2014.0,2,0,2
NOR,BGD,2016.0,1,0,1
ITA,SYR,2016.0,1,0,1
BDI,,2014.0,1,0,1
CZE,YEM,2022.0,1,0,1
IND,GEO,2017.0,2,0,2
FIN,BHR,2015.0,1,0,1
CAN,MKD,2013.0,1,0,1
IRL,CHL,2014.0,2,0,2
CZE,PER,2019.0,1,0,1
BOL,DNK,2012.0,1,0,1
AUT,IRQ,2022.0,1,0,1
IRQ,AUT,2023.0,1,0,1
MKD,HRV,2021.0,1,0,1
DEU,SWZ,2008.0,2,0,2
ETH,DNK,2009.0,2,0,2
BEN,GBR,2002.0,1,0,1
SRB,EST,2020.0,1,0,1
DNK,MNE,2022.0,1,0,1
TZA,MAR,2023.0,1,0,1
DEU,MAC,2022.0,1,0,1
CMR,CAN,2005.0,2,0,2
MDA,TUR,1999.0,1,0,1
BEL,RWA,2007.0,1,0,1
KHM,TZA,2000.0,1,0,1
AUS,ISL,2015.0,2,0,2
CHN,ARE,2005.0,2,0,2
GRC,ALB,2011.0,2,0,2
URY,BEL,1998.0,1,0,1
ETH,COG,2014.0,1,0,1
UGA,RWA,2008.0,1,0,1
JPN,ISL,2009.0,2,0,2
CAF,,2005.0,2,0,2
ARG,TTO,2008.0,1,0,1
MWI,BRN,2000.0,1,0,1
AUS,VUT,2018.0,3,0,3
LKA,MYS,1999.0,1,0,1
MWI,SWE,2002.0,1,0,1
SWE,MWI,2004.0,1,0,1
USA,MSR,2001.0,1,0,1
KEN,GHA,2004.0,1,0,1
IND,ZWE,2006.0,1,0,1
SGP,PRI,2013.0,1,0,1
,TKM,2009.0,1,0,1
PYF,ISR,2001.0,1,0,1
LBR,NGA,2016.0,1,0,1
KWT,AUT,2019.0,1,0,1
GRC,PRT,1999.0,2,0,2
COL,DOM,2012.0,1,0,1
,LAO,1997.0,2,0,2
VEN,KAZ,2014.0,1,0,1
BFA,PAK,2006.0,1,0,1
LBR,LBN,1998.0,1,0,1
NLD,BIH,2008.0,1,0,1
ZWE,TZA,2004.0,1,0,1
BRA,CMR,2002.0,1,0,1
HUN,MKD,2016.0,1,0,1
RWA,UGA,2006.0,1,0,1
KEN,RWA,2011.0,1,0,1
PAN,FIN,2011.0,1,0,1
AUT,GBR,2024.0,1,0,1
MEX,BGD,2006.0,2,0,2
DNK,LUX,2017.0,2,0,2
MEX,TUN,2000.0,1,0,1
GUF,USA,2019.0,3,0,3
ZAF,KNA,2014.0,1,0,1
CAN,PHL,2011.0,2,0,2
LBR,BWA,2020.0,1,0,1
ARG,FIN,2011.0,1,0,1
RUS,VEN,2019.0,1,0,1
AUS,TON,2006.0,1,0,1
SGP,BGR,2018.0,1,0,1
LTU,JPN,2020.0,2,0,2
CRI,GRC,2008.0,1,0,1
LUX,CHN,2011.0,1,0,1
MMR,CHN,2006.0,1,0,1
SYR,KOR,2013.0,1,0,1
CMR,TWN,2017.0,1,0,1
CYP,CHN,2013.0,1,0,1
GNQ,,2017.0,2,0,2
LVA,ESP,2018.0,1,0,1
ATA,FRA,2020.0,1,0,1
AFG,AUS,2020.0,1,0,1
TGO,GIN,2022.0,1,0,1
CAF,TUN,2020.0,2,0,2
IND,MKD,2017.0,1,0,1
JPN,BIH,2012.0,1,0,1
CYP,AUT,2017.0,2,0,2
FIN,ALB,2019.0,1,0,1
DNK,GTM,2019.0,1,0,1
COG,PER,2020.0,1,0,1
IRN,GRC,2021.0,2,0,2
JPN,PNG,2013.0,1,0,1
MAC,NLD,2015.0,1,0,1
KHM,KEN,2020.0,1,0,1
UZB,AUS,2016.0,2,0,2
SYC,NZL,2016.0,1,0,1
TGO,GHA,2017.0,1,0,1
NLD,LVA,2023.0,1,0,1
MAR,LVA,2019.0,1,0,1
ARG,EST,2019.0,2,0,2
NZL,OMN,2017.0,2,0,2
CYM,BEL,2020.0,1,0,1
NIC,CRI,2002.0,1,0,1
WSM,ECU,2011.0,1,0,1
ECU,CYP,2015.0,1,0,1
CYP,ECU,2020.0,1,0,1
VNM,IRQ,2018.0,2,0,2
PRT,IND,2024.0,2,0,2
LAO,MDG,2016.0,1,0,1
USA,GAB,2000.0,1,0,1
COL,VNM,1997.0,1,0,1
VNM,COL,2002.0,1,0,1
GUY,CAN,1999.0,1,0,1
THA,TWN,2006.0,2,0,2
CIV,BFA,2008.0,2,0,2
BFA,BEN,2009.0,1,0,1
PRY,ESP,2010.0,3,0,3
CZE,IRL,2004.0,1,0,1
MDG,GBR,2009.0,2,0,2
ZMB,BWA,2005.0,1,0,1
MEX,TWN,2002.0,1,0,1
PAN,,2001.0,2,0,2
FIN,IND,1999.0,2,0,2
JAM,NLD,2001.0,1,0,1
KOR,BOL,2019.0,1,0,1
DEU,MWI,2000.0,2,0,2
TWN,SEN,2016.0,1,0,1
AUS,LAO,2012.0,2,0,2
BGR,PRT,2017.0,1,0,1
ISR,JOR,2020.0,1,0,1
EST,COL,2016.0,1,0,1
RWA,TZA,2011.0,1,0,1
PHL,NGA,2013.0,1,0,1
CAN,BWA,2019.0,1,0,1
YEM,PAK,2018.0,1,0,1
BIH,IRL,2019.0,1,0,1
RWA,VNM,2019.0,1,0,1
ERI,IND,1999.0,1,0,1
ETH,NZL,2021.0,1,0,1
PRT,SGP,2012.0,1,0,1
NLD,VUT,2020.0,1,0,1
SVK,PRT,2018.0,1,0,1
ZAF,LTU,2023.0,1,0,1
SRB,NLD,2002.0,2,0,2
GMB,JPN,2017.0,1,0,1
CAF,SEN,2007.0,1,0,1
GTM,MEX,2023.0,1,0,1
KWT,ZAF,2000.0,1,0,1
FIN,IRQ,2021.0,3,0,3
MYS,PAK,1997.0,1,0,1
GRC,CZE,2002.0,1,0,1
THA,CZE,2015.0,1,0,1
SLE,GBR,2013.0,1,0,1
UGA,SVN,2018.0,1,0,1
AUT,AGO,2019.0,1,0,1
JPN,FJI,2020.0,1,0,1
MAR,FIN,2018.0,1,0,1
BWA,QAT,2016.0,1,0,1
MDA,CAN,1997.0,1,0,1
DZA,NOR,2019.0,1,0,1
UKR,IND,2013.0,1,0,1
BDI,NLD,2021.0,1,0,1
MAC,ITA,2014.0,1,0,1
ISR,SVN,2023.0,1,0,1
CHN,SOM,2022.0,1,0,1
ECU,HKG,2020.0,1,0,1
HKG,HUN,2022.0,2,0,2
ALB,JPN,2019.0,1,0,1
IDN,PSE,2021.0,1,0,1
CYP,GHA,2020.0,1,0,1
VNM,LUX,2018.0,1,0,1
TWN,SWZ,2023.0,1,0,1
MDG,JPN,2020.0,1,0,1
ESP,HND,2022.0,2,0,2
FRA,TCD,2015.0,1,0,1
BEL,ARM,2017.0,1,0,1
IRL,DZA,2017.0,1,0,1
KOR,SAU,2008.0,1,0,1
,SLB,2004.0,1,0,1
ESP,PAN,2004.0,2,0,2
ZAF,ERI,2015.0,1,0,1
FIN,KEN,2011.0,2,0,2
ITA,LAO,2013.0,1,0,1
BGR,SVK,2010.0,1,0,1
NLD,NGA,2005.0,1,0,1
OMN,GRC,2022.0,1,0,1
EGY,FJI,2014.0,1,0,1
CAF,COG,2006.0,1,0,1
ITA,IDN,2009.0,1,0,1
NGA,ISR,2008.0,1,0,1
UGA,AUS,2008.0,1,0,1
DEU,GTM,2003.0,2,0,2
FRA,MAC,2008.0,1,0,1
ESP,BEN,2018.0,1,0,1
BEN,ESP,2020.0,1,0,1
ESP,BEN,2022.0,1,0,1
THA,MEX,2007.0,1,0,1
TZA,ZWE,2005.0,1,0,1
CHE,AGO,1999.0,1,0,1
LTU,NZL,2005.0,1,0,1
HUN,SGP,2004.0,2,0,2
ARG,BIH,2012.0,1,0,1
NZL,SAU,2008.0,1,0,1
ESP,NIC,2000.0,2,0,2
ZAF,ROU,2020.0,1,0,1
SVK,HKG,2000.0,1,0,1
PER,IDN,2013.0,1,0,1
DNK,ARE,2008.0,1,0,1
ZAF,CIV,1997.0,1,0,1
CRI,PAN,2001.0,1,0,1
MDA,ISR,2000.0,1,0,1
GMB,TZA,2011.0,1,0,1
KOR,MOZ,2002.0,1,0,1
USA,SLE,2000.0,1,0,1
TZA,ZWE,2002.0,1,0,1
SAU,SRB,2010.0,3,0,3
SRB,SAU,2011.0,1,0,1
GBR,DZA,1998.0,2,0,2
CUB,ZWE,2005.0,1,0,1
USA,YEM,1999.0,1,0,1
NPL,PRT,2019.0,1,0,1
CHE,MLI,2003.0,3,0,3
DEU,PER,2004.0,1,0,1
KEN,NOR,2002.0,1,0,1
NLD,KWT,2011.0,1,0,1
KEN,LKA,2017.0,1,0,1
CHE,ARM,2008.0,1,0,1
BDI,AFG,2010.0,1,0,1
COL,RUS,2021.0,3,0,3
NAM,TZA,2015.0,1,0,1
GBR,BTN,2006.0,1,0,1
SLV,CHL,2013.0,1,0,1
CHL,UKR,2007.0,1,0,1
DEU,TCD,2007.0,1,0,1
DEU,BEN,2014.0,2,0,2
PER,VNM,2019.0,1,0,1
TZA,CAN,2006.0,1,0,1
IDN,RUS,2005.0,1,0,1
IRN,PAK,2009.0,1,0,1
PRY,JPN,2011.0,1,0,1
LTU,GRC,2012.0,1,0,1
LUX,NZL,2020.0,1,0,1
CHN,ZMB,2012.0,1,0,1
TUN,SGP,2016.0,1,0,1
USA,IRQ,2001.0,1,0,1
ECU,AUS,2012.0,1,0,1
SDN,BGD,2011.0,1,0,1
ECU,URY,2018.0,2,0,2
AUT,UGA,2019.0,1,0,1
ATG,USA,2012.0,1,0,1
IRQ,CHE,2018.0,1,0,1
CHN,BDI,2022.0,1,0,1
NLD,NCL,2020.0,1,0,1
CHE,TJK,2022.0,1,0,1
LBR,ZAF,2020.0,1,0,1
LKA,NGA,2018.0,1,0,1
BRN,QAT,2020.0,1,0,1
TJK,CHN,2021.0,3,0,3
CHN,ARG,2016.0,1,0,1
CUB,AUT,2022.0,1,0,1
PAK,ROU,2014.0,2,0,2
ISR,MKD,2020.0,1,0,1
SRB,BRA,2011.0,1,0,1
SVK,UKR,2001.0,1,0,1
PRI,ARG,1998.0,1,0,1
NLD,CMR,2000.0,1,0,1
SWE,SOM,1997.0,1,0,1
GRL,,2012.0,4,0,4
SVN,UKR,2001.0,1,0,1
OMN,SAU,2000.0,3,0,3
ESP,SAU,2002.0,3,0,3
IND,LBY,2006.0,1,0,1
RUS,ZWE,2002.0,1,0,1
AUS,MMR,1998.0,1,0,1
STP,PRT,2022.0,1,0,1
CRI,HND,2007.0,1,0,1
GUF,GUY,2017.0,2,0,2
,GRL,1999.0,2,0,2
ETH,IND,1998.0,1,0,1
GAB,CAN,2007.0,1,0,1
KWT,NLD,2003.0,1,0,1
DEU,ARE,1997.0,1,0,1
MDA,POL,2011.0,2,0,2
TJK,GBR,2014.0,1,0,1
UKR,AZE,2012.0,1,0,1
BEL,BDI,2010.0,2,0,2
GHA,CIV,2014.0,1,0,1
EST,IND,2009.0,1,0,1
UZB,CHE,2017.0,2,0,2
LBR,PAK,2012.0,1,0,1
PHL,SAU,2020.0,2,0,2
VUT,,2012.0,1,0,1
NLD,MAC,2012.0,1,0,1
THA,NGA,2007.0,1,0,1
IDN,NGA,2010.0,1,0,1
SYR,AUS,1999.0,1,0,1
KWT,CHN,2011.0,1,0,1
SEN,BLZ,2016.0,1,0,1
JPN,BHR,2012.0,1,0,1
KEN,PHL,2015.0,1,0,1
MEX,LTU,2021.0,2,0,2
JPN,GUF,2012.0,1,0,1
UZB,BLR,2018.0,1,0,1
MNE,ZAF,2019.0,1,0,1
BEN,TZA,2014.0,1,0,1
TZA,FRA,2007.0,1,0,1
DNK,CHL,2003.0,2,0,2
CYP,EST,2019.0,1,0,1
OMN,BHR,2000.0,1,0,1
LBN,OMN,2005.0,1,0,1
SVK,ROU,2013.0,1,0,1
HND,HTI,2022.0,1,0,1
ZAF,PSE,2015.0,1,0,1
LBY,MAR,2021.0,1,0,1
ZAF,POL,2003.0,1,0,1
PRT,TWN,2017.0,1,0,1
MAR,TGO,2021.0,1,0,1
SAU,FIN,2017.0,1,0,1
NLD,SLE,2019.0,1,0,1
MAR,MRT,2022.0,3,0,3
NIC,ARG,2020.0,1,0,1
SWZ,GHA,2016.0,1,0,1
SDN,SSD,2011.0,1,0,1
ITA,LSO,2013.0,1,0,1
AUT,BRB,2023.0,1,0,1
IRL,TTO,2010.0,1,0,1
ARG,POL,2013.0,1,0,1
GRC,RUS,2004.0,2,0,2
SDN,LBR,2014.0,1,0,1
VEN,FIN,2004.0,1,0,1
BWA,MYS,2019.0,1,0,1
SAU,LKA,2022.0,1,0,1
MWI,ITA,2012.0,1,0,1
CIV,CMR,2013.0,1,0,1
NLD,TTO,2004.0,1,0,1
BEL,ZMB,2011.0,1,0,1
SVK,GRC,2007.0,1,0,1
DNK,URY,2006.0,1,0,1
GRC,ARM,2011.0,1,0,1
ARM,GRC,2013.0,1,0,1
ESP,MCO,2015.0,1,0,1
GNQ,,2016.0,1,0,1
CHE,NAM,2008.0,1,0,1
GIN,HTI,2012.0,1,0,1
BEL,MDA,2009.0,1,0,1
BEL,BHR,2017.0,1,0,1
DEU,TJK,2014.0,1,0,1
PAK,QAT,2004.0,1,0,1
,GNQ,2004.0,2,0,2
ECU,CHE,2019.0,1,0,1
DNK,MLT,2013.0,1,0,1
ETH,AUS,2007.0,1,0,1
SVK,ARG,2019.0,1,0,1
ITA,MCO,2003.0,1,0,1
GMB,GIN,2012.0,1,0,1
ETH,BRN,2015.0,1,0,1
USA,JEY,2021.0,1,0,1
TUR,LBY,2018.0,1,0,1
MEX,AGO,2015.0,1,0,1
CHE,SYR,2021.0,1,0,1
DZA,IRN,2019.0,1,0,1
LAO,SGP,2023.0,1,0,1
ECU,HUN,2020.0,1,0,1
BGD,RUS,2017.0,1,0,1
ZAF,CHL,2023.0,1,0,1
NZL,GRC,2023.0,1,0,1
KOR,LVA,2023.0,1,0,1
VEN,SVN,2006.0,1,0,1
DNK,GEO,2022.0,1,0,1
TWN,BFA,2018.0,3,0,3
PAK,BEN,2022.0,1,0,1
CMR,SVK,2021.0,1,0,1
PRT,GNB,2022.0,1,0,1
PRT,TWN,2018.0,1,0,1
BGD,GRC,1997.0,1,0,1
GRC,BGD,2016.0,1,0,1
POL,GEO,2021.0,4,0,4
CAN,CIV,2023.0,1,0,1
BRA,HRV,2018.0,2,0,2
DEU,PRK,2023.0,1,0,1
,FLK,2020.0,1,0,1
PLW,,2019.0,2,0,2
NCL,USA,2003.0,1,0,1
IRN,IDN,2014.0,1,0,1
SDN,SWE,2007.0,1,0,1
ESP,LVA,2015.0,2,0,2
AUT,IRQ,2017.0,1,0,1
MAC,NGA,2007.0,1,0,1
JAM,GHA,2020.0,1,0,1
QAT,ARE,2009.0,2,0,2
RUS,DZA,2008.0,1,0,1
BEN,GLP,2012.0,1,0,1
VNM,ISR,2022.0,1,0,1
BRA,ZWE,2013.0,1,0,1
BRB,CAN,2008.0,1,0,1
TLS,BGD,2020.0,1,0,1
BEN,PRT,2015.0,1,0,1
,ASM,2002.0,1,0,1
AUT,PSE,2012.0,1,0,1
GRC,HUN,2013.0,3,0,3
WLF,FRA,2011.0,1,0,1
ITA,COD,2014.0,1,0,1
IRQ,PSE,2016.0,1,0,1
LBR,MWI,2022.0,1,0,1
CZE,BOL,2014.0,1,0,1
DEU,LAO,2008.0,1,0,1
PAK,BEL,2001.0,1,0,1
DNK,URY,2010.0,1,0,1
BEN,SEN,2009.0,1,0,1
SYR,AUS,1998.0,1,0,1
BIH,HUN,2009.0,2,0,2
BWA,FIN,2014.0,1,0,1
FIN,LAO,2018.0,1,0,1
FRA,ISL,2012.0,5,0,5
JPN,OMN,2015.0,1,0,1
GRC,KWT,2016.0,2,0,2
USA,FRO,2018.0,1,0,1
SLE,CAN,2022.0,1,0,1
SEN,UGA,2019.0,1,0,1
IND,QAT,2011.0,2,0,2
UKR,IRQ,2020.0,1,0,1
MEX,LUX,2013.0,1,0,1
JPN,CUB,2017.0,1,0,1
PRI,NZL,2020.0,1,0,1
UKR,DZA,2016.0,1,0,1
JPN,SLE,2015.0,1,0,1
ROU,ISR,2016.0,1,0,1
SWE,SYR,2023.0,1,0,1
RUS,IDN,2020.0,3,0,3
ISR,GEO,2022.0,1,0,1
ITA,MLI,2002.0,1,0,1
SGP,CZE,2007.0,1,0,1
MNE,AUT,2007.0,1,0,1
LVA,GBR,1999.0,2,0,2
CYP,DEU,1997.0,1,0,1
JAM,DEU,2018.0,1,0,1
MEX,SYR,2011.0,1,0,1
RUS,LBN,2001.0,1,0,1
BOL,BFA,2002.0,1,0,1
USA,HTI,2000.0,2,0,2
CRI,AUS,2005.0,1,0,1
BGD,MYS,2004.0,2,0,2
FRA,LVA,2001.0,1,0,1
HKG,LVA,2007.0,1,0,1
AUT,NGA,2003.0,1,0,1
ITA,PSE,2008.0,1,0,1
FJI,NZL,2007.0,1,0,1
UGA,IDN,2014.0,1,0,1
PAN,GBR,1999.0,1,0,1
ECU,MYS,2010.0,1,0,1
ROU,GAB,2000.0,1,0,1
JPN,BLR,2016.0,1,0,1
GAB,UGA,1999.0,1,0,1
MCO,ITA,1999.0,1,0,1
ITA,PER,1999.0,1,0,1
SVK,NZL,2009.0,1,0,1
VNM,UKR,2003.0,1,0,1
RUS,ISL,1997.0,1,0,1
ISL,RUS,1998.0,2,0,2
MEX,BGR,2002.0,1,0,1
GMB,KOR,2001.0,1,0,1
USA,SMR,2003.0,1,0,1
SEN,COG,2012.0,2,0,2
GMB,PAK,2023.0,1,0,1
ITA,BOL,2003.0,1,0,1
ECU,ZAF,1997.0,1,0,1
ZAF,ECU,1998.0,1,0,1
CPV,ARE,2005.0,1,0,1
KWT,NGA,2001.0,1,0,1
YEM,JOR,2016.0,1,0,1
AZE,ROU,2018.0,2,0,2
PAN,NLD,2011.0,1,0,1
DOM,CAN,2017.0,1,0,1
JPN,MLT,2011.0,1,0,1
FJI,LKA,2018.0,1,0,1
GBR,LSO,2013.0,2,0,2
SDN,CAN,2021.0,1,0,1
PRT,TLS,2021.0,1,0,1
TUR,SEN,2010.0,1,0,1
MYS,ETH,2020.0,2,0,2
TUR,SVK,2010.0,1,0,1
NGA,COG,2016.0,1,0,1
URY,SLV,2015.0,1,0,1
COD,CHE,2013.0,1,0,1
DOM,CHL,2010.0,1,0,1
NLD,ECU,2007.0,1,0,1
SVK,EGY,2017.0,1,0,1
KOR,HUN,2013.0,1,0,1
BEL,SLE,2013.0,1,0,1
GRC,BGD,2018.0,1,0,1
BRA,SYR,2022.0,1,0,1
IND,UGA,1998.0,1,0,1
BOL,PER,2007.0,1,0,1
MLT,POL,2015.0,1,0,1
CUB,NZL,2011.0,1,0,1
UZB,TUR,2002.0,2,0,2
ITA,SYC,2015.0,1,0,1
MEX,MAR,2021.0,1,0,1
SVN,VEN,2009.0,1,0,1
DNK,SAU,2010.0,1,0,1
CAN,SVN,2011.0,2,0,2
SGP,UKR,2009.0,1,0,1
KHM,HRV,2022.0,1,0,1
COL,UGA,2009.0,1,0,1
CPV,NLD,2016.0,1,0,1
JPN,BWA,2014.0,2,0,2
CZE,AZE,2019.0,1,0,1
JPN,SVK,2014.0,2,0,2
ETH,ZMB,2021.0,3,0,3
TWN,NOR,2022.0,1,0,1
MMR,TWN,2019.0,1,0,1
GHA,EST,2021.0,1,0,1
MRT,CHE,2018.0,1,0,1
ESP,CAF,2023.0,1,0,1
GRC,PAK,2016.0,1,0,1
NOR,GEO,2019.0,1,0,1
IRQ,CZE,2024.0,1,0,1
BFA,ETH,2016.0,1,0,1
PER,IND,2020.0,1,0,1
GBR,LIE,2021.0,1,0,1
URY,PAK,2021.0,1,0,1
SVN,MNE,2021.0,1,0,1
PAK,GEO,2021.0,1,0,1
CRI,ARG,2022.0,1,0,1
SOM,ETH,2023.0,1,0,1
NAM,TZA,2008.0,1,0,1
AUT,GEO,2003.0,1,0,1
SHN,CHN,2014.0,1,0,1
SAU,NIC,2022.0,1,0,1
MLI,LUX,2009.0,2,0,2
ESP,MDV,2021.0,1,0,1
MDG,GAB,2009.0,1,0,1
IDN,CMR,2020.0,1,0,1
CMR,COG,2012.0,1,0,1
USA,MNE,2011.0,1,0,1
NGA,IRL,2007.0,1,0,1
JOR,MYS,2004.0,1,0,1
NLD,KAZ,2009.0,1,0,1
AUS,SVK,2015.0,2,0,2
BEL,MOZ,2011.0,1,0,1
PAK,BEL,2015.0,1,0,1
BIH,SWE,2009.0,1,0,1
BEN,KEN,2012.0,1,0,1
PLW,,2021.0,2,0,2
COD,KEN,2000.0,1,0,1
ESP,UZB,2008.0,1,0,1
CHN,NPL,2010.0,1,0,1
FJI,SLB,2010.0,1,0,1
DOM,CAN,2016.0,1,0,1
CHN,KAZ,2013.0,2,0,2
LTU,BLR,2014.0,1,0,1
MUS,SYC,2018.0,1,0,1
PHL,LKA,2013.0,1,0,1
SEN,AGO,2015.0,1,0,1
LBN,LBR,2002.0,2,0,2
USA,NER,2006.0,1,0,1
FRA,BRB,2013.0,1,0,1
VNM,SVK,2004.0,1,0,1
BHR,CHN,2021.0,1,0,1
AUT,MLT,2020.0,1,0,1
ISL,ARE,2019.0,1,0,1
MAR,TCD,2020.0,1,0,1
KWT,HUN,2020.0,1,0,1
TZA,MWI,2000.0,2,0,2
ATA,NZL,2010.0,1,0,1
JOR,IND,2020.0,1,0,1
BGR,LBN,2022.0,1,0,1
PHL,POL,2023.0,1,0,1
JOR,KWT,2004.0,1,0,1
PNG,NLD,2008.0,1,0,1
BRA,LUX,2014.0,1,0,1
SRB,VEN,2005.0,1,0,1
AUT,NZL,1999.0,2,0,2
GNQ,CUB,2021.0,2,0,2
BLR,PRT,2006.0,2,0,2
MAR,MEX,2009.0,4,0,4
HKG,GRC,1998.0,1,0,1
CHE,EGY,2004.0,1,0,1
CUB,NOR,2006.0,1,0,1
TWN,SYR,2000.0,1,0,1
NZL,CHL,2001.0,2,0,2
CHE,LKA,2012.0,1,0,1
BEL,JOR,2001.0,1,0,1
USA,BHS,2001.0,1,0,1
PRI,JPN,2006.0,1,0,1
DEU,ZWE,2003.0,1,0,1
BIH,CHN,2018.0,1,0,1
SAU,VNM,2018.0,1,0,1
SGP,SRB,2012.0,1,0,1
VGB,USA,2018.0,1,0,1
SYC,GBR,2007.0,1,0,1
ISR,MWI,2014.0,1,0,1
GBR,SLE,2006.0,1,0,1
GHA,SRB,2016.0,1,0,1
QAT,PSE,2013.0,1,0,1
SEN,GAB,2016.0,1,0,1
NPL,DNK,2012.0,1,0,1
AZE,KAZ,2015.0,1,0,1
BRA,BIH,2011.0,1,0,1
SEN,SGP,2012.0,1,0,1
AUS,SVK,2014.0,1,0,1
KIR,,2015.0,1,0,1
PAN,URY,2019.0,1,0,1
ZMB,TUN,2012.0,1,0,1
BGR,CYP,2020.0,1,0,1
HUN,MYS,2012.0,1,0,1
KWT,AUS,2003.0,1,0,1
NOR,QAT,2017.0,1,0,1
TUR,CZE,2002.0,1,0,1
KOR,MAR,2009.0,1,0,1
GMB,COG,2015.0,1,0,1
COG,GMB,2016.0,1,0,1
LUX,VNM,2022.0,2,0,2
TUR,MAR,2017.0,1,0,1
SRB,LUX,2023.0,1,0,1
FRA,UGA,2000.0,1,0,1
BTN,IND,1998.0,1,0,1
IRN,ISL,2015.0,1,0,1
ESP,UZB,2001.0,1,0,1
FIN,NZL,2006.0,2,0,2
GAB,AUT,2018.0,1,0,1
PER,NCL,2018.0,1,0,1
NZL,BRB,2016.0,1,0,1
NLD,NIC,2019.0,1,0,1
ITA,MMR,2019.0,2,0,2
QAT,COL,2016.0,1,0,1
HKG,PSE,2021.0,1,0,1
ARE,YEM,2021.0,1,0,1
DOM,PRT,2021.0,1,0,1
CIV,NER,2021.0,1,0,1
MLT,AIA,2021.0,1,0,1
YEM,DEU,2023.0,1,0,1
BRA,IDN,2023.0,1,0,1
PAN,FRA,2020.0,2,0,2
CHL,PRY,2004.0,1,0,1
CHE,SUR,2018.0,1,0,1
MYS,NOR,2007.0,1,0,1
PHL,NZL,2001.0,2,0,2
CZE,BOL,2001.0,1,0,1
MAR,SDN,2016.0,1,0,1
NPL,BGD,2015.0,1,0,1
ARM,ARG,2012.0,1,0,1
TUR,ISR,2021.0,3,0,3
SYR,OMN,2018.0,1,0,1
FIN,NGA,2022.0,1,0,1
UGA,SWZ,2020.0,1,0,1
NCL,VNM,2019.0,1,0,1
JOR,TWN,1999.0,1,0,1
CRI,JPN,2021.0,1,0,1
BOL,CUB,2006.0,1,0,1
SDN,BDI,2019.0,1,0,1
KOR,CMR,2020.0,2,0,2
CHE,BRB,2016.0,1,0,1
EGY,BRA,2018.0,2,0,2
BRB,JAM,2001.0,1,0,1
ARG,TWN,2021.0,1,0,1
KEN,ARE,2020.0,1,0,1
GBR,BOL,2023.0,1,0,1
IRL,TTO,2023.0,1,0,1
KEN,BFA,2005.0,1,0,1
SEN,LBR,2022.0,1,0,1
IRN,TUN,2023.0,1,0,1
IND,MKD,2016.0,1,0,1
BGD,PAK,2000.0,1,0,1
OMN,NZL,2023.0,1,0,1
ETH,PRT,2023.0,1,0,1
TCD,TGO,2023.0,1,0,1
DNK,CMR,2002.0,1,0,1
TON,JPN,2014.0,1,0,1
FRA,GTM,2007.0,1,0,1
EGY,GTM,2012.0,1,0,1
TON,,2012.0,1,0,1
IRL,LBY,2013.0,1,0,1
MWI,IND,1999.0,1,0,1
BEL,CIV,1999.0,1,0,1
AUS,TUN,2019.0,1,0,1
LVA,CHE,2001.0,1,0,1
LVA,CHE,2004.0,1,0,1
UKR,HKG,2009.0,2,0,2
FRA,MUS,2007.0,1,0,1
EST,KAZ,2001.0,1,0,1
CHE,MDG,2005.0,1,0,1
NPL,NOR,2008.0,2,0,2
ARG,BGR,2005.0,1,0,1
SAU,ETH,2012.0,1,0,1
SVK,LBY,2011.0,1,0,1
AUT,QAT,2021.0,1,0,1
CRI,SWE,2009.0,1,0,1
ETH,ERI,2018.0,1,0,1
KEN,SEN,2019.0,1,0,1
CHN,LTU,2003.0,1,0,1
PER,NLD,2004.0,2,0,2
CAN,NCL,2012.0,1,0,1
UKR,ROU,1997.0,2,0,2
THA,SWE,1997.0,2,0,2
FRA,GUY,2019.0,1,0,1
RWA,COG,2002.0,1,0,1
AUS,BIH,2005.0,1,0,1
,GNQ,2008.0,2,0,2
GNQ,ESP,2011.0,2,0,2
SEN,DNK,1999.0,1,0,1
NCL,REU,2006.0,1,0,1
PNG,FJI,2022.0,1,0,1
DOM,GBR,2005.0,1,0,1
COG,CHN,2004.0,1,0,1
SRB,BGR,1997.0,1,0,1
ISR,KAZ,2000.0,1,0,1
COG,ZWE,2018.0,1,0,1
AUS,VNM,1997.0,1,0,1
CUB,CHE,2002.0,1,0,1
GRC,BHR,2006.0,1,0,1
BEL,GMB,2006.0,1,0,1
IDN,BGD,2004.0,1,0,1
ZWE,CHE,2010.0,2,0,2
RWA,SLE,2010.0,1,0,1
TJK,USA,2003.0,1,0,1
CIV,COG,2018.0,1,0,1
NOR,SAU,2010.0,1,0,1
MAR,ETH,2008.0,1,0,1
ROU,SRB,1997.0,1,0,1
ESP,GUM,2012.0,1,0,1
SDN,IRL,2003.0,1,0,1
ESP,LTU,2011.0,2,0,2
SGP,GRC,2008.0,1,0,1
SGP,ZWE,2006.0,1,0,1
SYR,ETH,2010.0,1,0,1
PAK,VEN,2018.0,1,0,1
PAK,CIV,2003.0,1,0,1
NPL,IRL,2013.0,1,0,1
CHE,KAZ,2016.0,1,0,1
MDG,CHN,2007.0,1,0,1
IND,GHA,2009.0,1,0,1
DNK,SAU,2023.0,3,0,3
JOR,PAK,2012.0,1,0,1
QAT,KOR,2021.0,2,0,2
IND,GRD,2022.0,1,0,1
MOZ,KEN,2011.0,1,0,1
BRA,MUS,2007.0,1,0,1
CMR,RWA,2010.0,2,0,2
SAU,ESP,2006.0,1,0,1
AUS,CCK,2009.0,2,0,2
ECU,PRY,2019.0,1,0,1
IDN,MLI,2006.0,1,0,1
NZL,QAT,2006.0,1,0,1
LTU,UKR,2009.0,1,0,1
PRT,OMN,2008.0,1,0,1
ZWE,EGY,2015.0,1,0,1
USA,GLP,2016.0,1,0,1
SYC,CHE,2016.0,1,0,1
CZE,ETH,2014.0,1,0,1
SDN,USA,2009.0,1,0,1
KEN,NZL,2018.0,1,0,1
KEN,NER,2020.0,1,0,1
,MHL,2003.0,1,0,1
MHL,USA,2011.0,2,0,2
NCL,PRT,2011.0,1,0,1
DNK,GTM,2011.0,1,0,1
HKG,KEN,2017.0,1,0,1
TZA,COD,2018.0,1,0,1
IRQ,HUN,2018.0,2,0,2
MEX,OMN,2021.0,1,0,1
COL,FIN,2017.0,1,0,1
JPN,GTM,2013.0,1,0,1
LBY,SWE,2014.0,1,0,1
USA,GLP,2022.0,1,0,1
CPV,CHN,2016.0,1,0,1
SDN,SLE,2021.0,2,0,2
SVN,FIN,2022.0,1,0,1
MYS,TKM,2023.0,1,0,1
HUN,TWN,2020.0,1,0,1
ARE,SRB,2021.0,1,0,1
BRN,GHA,2022.0,1,0,1
PRY,JPN,2021.0,1,0,1
SVK,ECU,2021.0,1,0,1
PRY,ITA,2021.0,1,0,1
SVK,KAZ,2023.0,1,0,1
DNK,PHL,2024.0,1,0,1
VNM,SAU,2023.0,1,0,1
IRN,HUN,2023.0,1,0,1
MLT,EUE,2023.0,1,0,1
VEN,IND,2006.0,2,0,2
BGR,HRV,2023.0,1,0,1
IRQ,NGA,2016.0,1,0,1
BEL,GUM,2006.0,1,0,1
NZL,THA,2000.0,1,0,1
MKD,ITA,2011.0,1,0,1
DEU,JAM,2000.0,1,0,1
CRI,ITA,2008.0,1,0,1
CHL,CZE,1998.0,1,0,1
USA,PYF,2004.0,1,0,1
NGA,TTO,2012.0,1,0,1
GEO,GBR,2000.0,1,0,1
VNM,KOR,2001.0,1,0,1
CHE,LKA,2002.0,1,0,1
PRI,GTM,2007.0,1,0,1
IND,MHL,1998.0,1,0,1
JOR,PSE,2006.0,2,0,2
SGP,BRA,2005.0,1,0,1
IRL,THA,2004.0,1,0,1
SWZ,ZWE,2005.0,1,0,1
AUS,SVK,2001.0,1,0,1
NZL,URY,2003.0,1,0,1
AUS,GEO,2004.0,1,0,1
SEN,AUT,2002.0,1,0,1
NER,MRT,1999.0,1,0,1
BGR,SVN,2003.0,1,0,1
KAZ,CZE,2001.0,1,0,1
ARG,SRB,2003.0,1,0,1
VNM,LVA,2013.0,1,0,1
CYP,ISR,2003.0,1,0,1
GEO,POL,1997.0,2,0,2
VIR,GBR,1999.0,1,0,1
TUN,ARE,2003.0,1,0,1
NAM,CAN,2006.0,1,0,1
BRA,MUS,1998.0,1,0,1
ZMB,DEU,2006.0,1,0,1
MAR,POL,2016.0,1,0,1
IND,COG,2014.0,1,0,1
DZA,AUS,2001.0,1,0,1
CRI,NLD,1998.0,1,0,1
PAK,OMN,2000.0,1,0,1
GBR,VGB,1999.0,1,0,1
IND,MDV,2000.0,1,0,1
ARM,DNK,1998.0,2,0,2
TWN,MWI,2015.0,1,0,1
ZAF,DZA,2007.0,1,0,1
BEL,URY,2018.0,1,0,1
PRI,ARG,2007.0,1,0,1
JAM,AIA,2020.0,1,0,1
MUS,SWE,2010.0,1,0,1
BWA,BIH,2016.0,1,0,1
PRT,ARM,2020.0,2,0,2
UKR,SAU,2010.0,1,0,1
NZL,LKA,2009.0,1,0,1
SVN,IRN,2011.0,1,0,1
GMB,CMR,2022.0,1,0,1
ECU,FIN,2023.0,1,0,1
ZAF,KHM,2009.0,1,0,1
PRT,TTO,2008.0,1,0,1
ROU,CYP,2010.0,1,0,1
ESP,BFA,2009.0,1,0,1
MDV,,2012.0,3,0,3
BLR,NOR,2023.0,2,0,2
CHN,SAU,2009.0,2,0,2
ITA,PSE,2014.0,1,0,1
ZMB,KEN,2019.0,2,0,2
ETH,GAB,2013.0,1,0,1
BWA,ARE,2020.0,1,0,1
UZB,LKA,2013.0,1,0,1
TZA,BDI,2013.0,1,0,1
FIN,OMN,2022.0,1,0,1
NAM,NOR,2017.0,1,0,1
MCO,USA,2020.0,4,0,4
IRL,GHA,2010.0,1,0,1
,KIR,2013.0,1,0,1
BFA,ETH,2017.0,2,0,2
CHN,ECU,2019.0,1,0,1
ZMB,ARG,2009.0,1,0,1
,RWA,2000.0,1,0,1
SAU,CHE,2011.0,1,0,1
DNK,LBR,2023.0,1,0,1
ARE,RUS,1998.0,1,0,1
SYR,SWE,2013.0,1,0,1
POL,ROU,1997.0,1,0,1
BFA,LKA,2016.0,1,0,1
DEU,CIV,2006.0,1,0,1
NZL,AZE,2019.0,1,0,1
VEN,SLV,2006.0,1,0,1
JOR,LBN,2014.0,1,0,1
NLD,SYC,2018.0,1,0,1
EST,ESP,1997.0,1,0,1
FRA,LVA,2008.0,1,0,1
ITA,GIN,2005.0,1,0,1
UGA,ZAF,1998.0,1,0,1
ARG,PHL,2007.0,1,0,1
FRA,MEX,2006.0,39,20,19
USA,SGP,2011.0,268,171,97
RUS,USA,2016.0,194,235,-41
GBR,KEN,2017.0,29,35,-6
CHN,USA,2011.0,2344,2135,209
ESP,CHE,2013.0,82,62,20
CHN,USA,2021.0,3369,4508,-1139
SWE,IRN,2003.0,3,4,-1
USA,ARG,2010.0,139,103,36
SWE,CHN,2005.0,30,40,-10
USA,PRI,2006.0,101,110,-9
CAN,IND,2017.0,76,164,-88
SAU,EGY,2020.0,338,380,-42
CHE,GRC,2000.0,5,9,-4
GBR,CHE,2007.0,161,194,-33
AUS,IDN,2008.0,19,13,6
AUS,AUT,2022.0,31,12,19
ITA,DEU,2010.0,256,164,92
CHE,USA,2015.0,565,559,6
FIN,IRL,2009.0,5,4,1
DEU,AUS,2016.0,176,186,-10
MAR,FRA,2000.0,55,81,-26
FRA,SYR,2019.0,10,2,8
USA,HKG,2005.0,59,104,-45
DEU,NLD,1998.0,120,124,-4
GBR,JPN,2010.0,126,128,-2
USA,CHE,2004.0,445,356,89
JPN,CHN,2015.0,591,317,274
TWN,IND,2017.0,30,69,-39
POL,ITA,2015.0,22,24,-2
AUS,AUT,2018.0,52,35,17
ITA,PRT,2013.0,29,22,7
GBR,TWN,2003.0,32,22,10
UKR,USA,2003.0,50,36,14
CAN,BRA,2011.0,48,67,-19
CHE,CHN,2020.0,99,115,-16
CAN,KWT,2012.0,11,6,5
DNK,NOR,2023.0,35,29,6
SWE,AUS,2009.0,41,31,10
ITA,DEU,2006.0,149,162,-13
NLD,SWE,2005.0,27,30,-3
CAN,IND,2016.0,110,135,-25
CHE,GBR,2005.0,146,144,2
JPN,DEU,2016.0,151,151,0
DNK,AUT,2021.0,17,23,-6
KOR,GBR,2008.0,25,37,-12
COL,GBR,2013.0,16,16,0
AUS,IDN,2004.0,12,9,3
TWN,USA,2018.0,313,260,53
DNK,NOR,2010.0,23,28,-5
GBR,BEL,2023.0,85,64,21
ITA,CHN,2016.0,48,40,8
FIN,CHL,2016.0,5,1,4
FIN,NOR,2008.0,14,7,7
TWN,ITA,2011.0,2,5,-3
AUS,QAT,2011.0,5,3,2
BRN,THA,2002.0,1,1,0
SWE,MLT,2013.0,2,1,1
CAN,CHL,2010.0,13,14,-1
IND,KOR,2003.0,34,6,28
CAN,IND,2018.0,106,156,-50
DEU,ITA,2006.0,162,149,13
SWE,ETH,2012.0,3,1,2
DEU,KEN,2015.0,13,14,-1
UKR,CAN,1997.0,6,2,4
GBR,ETH,1997.0,4,1,3
SVN,SVK,2007.0,16,27,-11
DEU,SVK,2021.0,10,13,-3
BEL,LUX,2018.0,23,20,3
,KOR,2003.0,8874,0,8874
TUR,,2025.0,64113,0,64113
,USA,2016.0,98567,0,98567
PRT,,2025.0,26427,0,26427
,GBR,1997.0,19287,0,19287
,JPN,2003.0,23357,0,23357
NOR,,2026.0,269,0,269
USA,,2004.0,38505,0,38505
,ESP,2003.0,10737,0,10737
,DEU,2002.0,17485,0,17485
USA,,2008.0,45122,0,45122
,GRC,2003.0,2537,0,2537
,TWN,2001.0,4282,0,4282
,BRA,2003.0,9662,0,9662
,SGP,1999.0,942,0,942
CAN,,2024.0,41420,0,41420
CAN,,2010.0,5995,0,5995
,ITA,1998.0,10982,0,10982
,DEU,2005.0,19080,0,19080
EST,,2018.0,282,0,282
CHE,,2012.0,2360,0,2360
KOR,,2025.0,96740,0,96740
,AUS,1998.0,6034,0,6034
USA,,2015.0,68919,0,68919
,TUR,2002.0,5335,0,5335
,GBR,2002.0,17051,0,17051
BEL,,2008.0,1411,0,1411
,IND,2001.0,9621,0,9621
USA,,2014.0,63227,0,63227
CAN,,2023.0,25491,0,25491
HKG,,2015.0,980,0,980
EST,,2026.0,64,0,64
MEX,,2016.0,2298,0,2298
,HRV,1999.0,848,0,848
ESP,,2010.0,5461,0,5461
,FRA,2000.0,12413,0,12413
,CAN,1996.0,10271,0,10271
MYS,,2012.0,590,0,590
HKG,,2008.0,800,0,800
ESP,,2024.0,49558,0,49558
,GBR,2005.0,18756,0,18756
KOR,,2009.0,4846,0,4846
,FIN,2002.0,1761,0,1761
GBR,,2013.0,11846,0,11846
,FIN,1997.0,1951,0,1951
,DEU,1997.0,18375,0,18375
CHN,,2012.0,36624,0,36624
,UKR,2003.0,1026,0,1026
UKR,,2008.0,526,0,526
CHL,,2011.0,612,0,612
THA,,2007.0,371,0,371
IND,,2015.0,11898,0,11898
HUN,,2020.0,1444,0,1444
CHL,,2025.0,14356,0,14356
RUS,,2014.0,4566,0,4566
,NOR,1999.0,1311,0,1311
,SVN,1996.0,493,0,493
,AUS,2007.0,7914,0,7914
,NLD,1994.0,21180,0,21180
POL,,2007.0,1511,0,1511
IND,,2008.0,4262,0,4262
LBN,,2025.0,2763,0,2763
,IND,1996.0,9271,0,9271
CIV,,2019.0,152,0,152
USA,,2001.0,30204,0,30204
,IND,2004.0,13025,0,13025
RUS,,2008.0,3522,0,3522
NLD,,2022.0,8903,0,8903
BEL,,2015.0,2218,0,2218
BRA,,2020.0,18093,0,18093
,CHN,1995.0,18953,0,18953
VEN,,2020.0,484,0,484
VEN,,2007.0,250,0,250
,HUN,2001.0,1117,0,1117
ARG,,2020.0,2435,0,2435
,CZE,2002.0,1778,0,1778
IRN,,2022.0,12724,0,12724
,CAN,2001.0,8861,0,8861
,ITA,2007.0,13357,0,13357
HUN,,2007.0,513,0,513
IRL,,2024.0,5744,0,5744
,RUS,1994.0,32316,0,32316
NZL,,2025.0,12085,0,12085
,EGY,2002.0,1066,0,1066
GBR,VCT,2010.0,1,0,1
BRA,,2007.0,2248,0,2248
TUR,,2009.0,1701,0,1701
ISR,,2022.0,3496,0,3496
FRA,,2013.0,8491,0,8491
ESP,,2023.0,29700,0,29700
,IRQ,2003.0,63,0,63
TUR,,2019.0,5827,0,5827
,TUR,1997.0,3245,0,3245
,SVN,2004.0,554,0,554
,SWE,1994.0,14929,0,14929
TUR,,2011.0,1981,0,1981
KOR,,2011.0,6586,0,6586
DZA,,2024.0,5220,0,5220
,SGP,1998.0,1012,0,1012
,CZE,2012.0,3059,0,3059
,UZB,2002.0,104,0,104
UZB,,2012.0,64,0,64
,ITA,1999.0,10738,0,10738
,CAN,2004.0,10604,0,10604
,URY,2002.0,128,0,128
KOR,,2019.0,12936,0,12936
KOR,,2021.0,15310,0,15310
,FRA,2006.0,13856,0,13856
RUS,,2004.0,3804,0,3804
NLD,,2016.0,4109,0,4109
CHN,,2002.0,6376,0,6376
AUT,,2007.0,948,0,948
,THA,2007.0,2192,0,2192
NOR,,2018.0,1447,0,1447
BGR,,2025.0,4808,0,4808
SVN,,2023.0,1403,0,1403
,SVN,2001.0,521,0,521
SVN,,2024.0,2598,0,2598
LBN,,2009.0,86,0,86
,TUR,2005.0,5758,0,5758
,JPN,2013.0,22620,0,22620
NZL,,2011.0,662,0,662
,ESP,2013.0,14325,0,14325
PRT,,2021.0,2797,0,2797
,CAN,2008.0,11584,0,11584
AUT,,2020.0,2606,0,2606
,ISR,2009.0,2277,0,2277
ECU,,2009.0,34,0,34
MEX,,2017.0,2703,0,2703
MEX,,2018.0,2885,0,2885
,LAO,2003.0,17,0,17
KWT,,2011.0,169,0,169
,USA,2017.0,96961,0,96961
PRT,,2019.0,2094,0,2094
,BEL,1994.0,9911,0,9911
AUS,,2012.0,3999,0,3999
IND,,2014.0,10424,0,10424
THA,,2020.0,1947,0,1947
HKG,,2014.0,1005,0,1005
,ARG,1995.0,3618,0,3618
ATA,IND,2011.0,1,0,1
,NZL,1998.0,1155,0,1155
,NZL,1999.0,1049,0,1049
NZL,,2019.0,1372,0,1372
,SAU,1994.0,1708,0,1708
LVA,,2025.0,2240,0,2240
ISR,,2018.0,2098,0,2098
,FRA,2010.0,15129,0,15129
,TWN,2004.0,6530,0,6530
,RUS,2011.0,11060,0,11060
BGR,,2011.0,337,0,337
,AUT,1998.0,1777,0,1777
,TWN,2008.0,7432,0,7432
,GAB,2003.0,26,0,26
GAB,,2008.0,14,0,14
,CMR,2003.0,193,0,193
NOR,,2022.0,3004,0,3004
SAU,,2013.0,372,0,372
,IRN,2006.0,7228,0,7228
,IND,2008.0,23510,0,23510
,THA,1999.0,976,0,976
,RUS,2009.0,8405,0,8405
,HUN,1996.0,1669,0,1669
FRA,,2003.0,6162,0,6162
,JAM,1996.0,50,0,50
,IND,2015.0,32188,0,32188
GBR,,2003.0,8545,0,8545
,TUR,2012.0,8189,0,8189
ECU,,2025.0,3235,0,3235
,CHE,1995.0,5077,0,5077
CHE,,2005.0,1445,0,1445
,SVK,1994.0,2613,0,2613
MDA,,2023.0,163,0,163
,MDA,2004.0,40,0,40
EST,,2022.0,500,0,500
,HRV,1998.0,850,0,850
AZE,,2008.0,43,0,43
,TTO,2003.0,54,0,54
NZL,,2021.0,1895,0,1895
TUR,,2021.0,6716,0,6716
,TWN,1996.0,3793,0,3793
MEX,,2022.0,7213,0,7213
HRV,,2007.0,281,0,281
KEN,,2024.0,2097,0,2097
SVN,,2010.0,214,0,214
,PAK,2001.0,734,0,734
,VNM,1998.0,105,0,105
AUS,,2002.0,2027,0,2027
,HKG,1994.0,2847,0,2847
ESP,,2000.0,1957,0,1957
,BEL,2011.0,3638,0,3638
CHN,,2005.0,7980,0,7980
,BLR,2000.0,266,0,266
,COG,2008.0,64,0,64
SWE,,2013.0,2179,0,2179
ZAF,,2003.0,451,0,451
MUS,,2025.0,234,0,234
,JOR,1999.0,159,0,159
,AUT,1999.0,1853,0,1853
,ZAF,1994.0,3757,0,3757
BRA,,1999.0,328,0,328
,AUS,1999.0,5743,0,5743
NLD,,2018.0,5178,0,5178
IRN,,2016.0,3739,0,3739
,DNK,2006.0,1910,0,1910
,POL,2016.0,6072,0,6072
,KOR,2013.0,16982,0,16982
GHA,,2008.0,22,0,22
CAN,,2006.0,3975,0,3975
KEN,,2023.0,1184,0,1184
GRC,ZAF,2013.0,3,0,3
SDN,,2022.0,228,0,228
ISR,,2016.0,1716,0,1716
,POL,2018.0,6879,0,6879
RUS,,2015.0,5246,0,5246
,IDN,2011.0,1720,0,1720
,CUB,2001.0,509,0,509
DNK,,2005.0,683,0,683
,EST,1997.0,219,0,219
,CIV,1995.0,145,0,145
POL,,2020.0,5065,0,5065
,TJK,2003.0,10,0,10
HRV,,2020.0,991,0,991
HRV,,1999.0,66,0,66
BEL,,2001.0,810,0,810
ROU,,2015.0,1222,0,1222
EGY,,2005.0,294,0,294
CHN,YEM,2013.0,1,0,1
YEM,,2017.0,42,0,42
,PHL,1998.0,182,0,182
,NOR,1998.0,1377,0,1377
,CZE,2005.0,2222,0,2222
,MYS,2016.0,5757,0,5757
IRL,,2000.0,246,0,246
ROU,,2014.0,1055,0,1055
,UZB,2005.0,98,0,98
CMR,,2012.0,60,0,60
CHL,,2021.0,2227,0,2227
,SAU,2011.0,1787,0,1787
JAM,,2007.0,28,0,28
,GBR,2012.0,21670,0,21670
NLD,,2017.0,4463,0,4463
,ISR,1994.0,9632,0,9632
CIV,,2021.0,246,0,246
CIV,,2025.0,841,0,841
AUS,,2005.0,2429,0,2429
NZL,,2009.0,586,0,586
IND,,2001.0,2294,0,2294
,NGA,1998.0,565,0,565
SWE,,2003.0,1547,0,1547
MEX,,2026.0,488,0,488
,NGA,1999.0,487,0,487
LBY,,2016.0,44,0,44
LTU,,2024.0,2131,0,2131
,NZL,2007.0,1311,0,1311
,DNK,2010.0,2756,0,2756
IRL,,2023.0,3512,0,3512
ZWE,,2025.0,871,0,871
UGA,,2023.0,638,0,638
,CZE,1997.0,1604,0,1604
,DNK,2000.0,1513,0,1513
,ARM,2005.0,127,0,127
,SVK,2011.0,1150,0,1150
,SVK,2009.0,969,0,969
NOR,,2016.0,1196,0,1196
ISR,,2017.0,1885,0,1885
,TZA,1997.0,95,0,95
IRN,,2017.0,4296,0,4296
,PER,2006.0,277,0,277
NLD,,2026.0,500,0,500
,MDA,2001.0,35,0,35
CHL,,2019.0,1510,0,1510
IND,,2004.0,3028,0,3028
EGY,,2012.0,593,0,593
IRL,,2010.0,585,0,585
ARG,,2007.0,652,0,652
,CAN,2015.0,13185,0,13185
DNK,,2012.0,1057,0,1057
,KEN,1998.0,170,0,170
AUT,GRC,2006.0,3,0,3
BEL,KGZ,2004.0,2,0,2
KGZ,,2009.0,4,0,4
,AUT,2007.0,2461,0,2461
,EST,2002.0,201,0,201
,ROU,2002.0,898,0,898
,ROU,1997.0,948,0,948
ARE,,2008.0,83,0,83
SWZ,,2017.0,11,0,11
ECU,,2021.0,557,0,557
LUX,,2024.0,621,0,621
NOR,,2017.0,1297,0,1297
BGR,,2021.0,610,0,610
,IRN,2000.0,1393,0,1393
,VNM,1999.0,120,0,120
,BRB,2003.0,11,0,11
,TUN,2001.0,607,0,607
,DEU,2012.0,24521,0,24521
,GEO,1998.0,126,0,126
,EST,2005.0,348,0,348
NPL,,2022.0,444,0,444
PER,,2008.0,61,0,61
,VEN,2001.0,451,0,451
FJI,,2025.0,272,0,272
BEL,,2014.0,1934,0,1934
IRN,,2018.0,5220,0,5220
,MAR,1998.0,487,0,487
,FIN,2012.0,2235,0,2235
LTU,,2023.0,1196,0,1196
RUS,,2001.0,2676,0,2676
CHE,BGR,1999.0,2,0,2
SYR,,2023.0,247,0,247
DZA,,2023.0,2962,0,2962
DNK,,2002.0,626,0,626
NLD,BGR,2012.0,3,0,3
UKR,,2014.0,794,0,794
,MEX,1995.0,3407,0,3407
CHE,,2002.0,1496,0,1496
,VEN,1996.0,451,0,451
LTU,,2010.0,207,0,207
BGR,SWE,2004.0,5,0,5
VNM,PRT,2012.0,2,0,2
MDA,,2010.0,17,0,17
VNM,,2013.0,163,0,163
,BWA,1996.0,55,0,55
,HUN,2004.0,1245,0,1245
,UZB,2012.0,106,0,106
ARE,,2015.0,178,0,178
CHL,,2009.0,505,0,505
,BRA,2013.0,20980,0,20980
UKR,,2015.0,808,0,808
,USA,2018.0,99928,0,99928
RWA,,2016.0,28,0,28
,ISL,2000.0,140,0,140
LBN,,2021.0,448,0,448
NZL,IDN,2005.0,1,0,1
,DZA,2011.0,1317,0,1317
PHL,,2015.0,142,0,142
TUN,,2008.0,250,0,250
KNA,,2025.0,66,0,66
,SRB,1994.0,1684,0,1684
IRN,,2026.0,1296,0,1296
PRT,,2009.0,514,0,514
,FIN,2005.0,1853,0,1853
KWT,,2021.0,252,0,252
BRN,,2009.0,5,0,5
HKG,,2001.0,337,0,337
,PHL,1999.0,145,0,145
,IDN,1994.0,346,0,346
,NGA,2007.0,1605,0,1605
FIN,,2013.0,1270,0,1270
ZAF,,2013.0,811,0,811
,EGY,1997.0,1068,0,1068
MDA,,2024.0,246,0,246
IND,EST,2010.0,2,0,2
,ETH,2001.0,84,0,84
,JOR,1998.0,182,0,182
ESP,,2006.0,3539,0,3539
,LTU,1995.0,332,0,332
JOR,OMN,2011.0,4,0,4
SRB,,2013.0,380,0,380
,MOZ,2003.0,23,0,23
SWE,LBY,2017.0,3,0,3
,DZA,1994.0,281,0,281
,CRI,2002.0,96,0,96
,BGD,2000.0,284,0,284
ARG,,1999.0,154,0,154
KEN,,2010.0,106,0,106
EST,,2016.0,231,0,231
,IRN,2010.0,12572,0,12572
,MAR,2020.0,1635,0,1635
,MDG,1998.0,38,0,38
,CUB,1996.0,789,0,789
PRT,,2011.0,583,0,583
IDN,,2018.0,506,0,506
KWT,,2025.0,1594,0,1594
TUN,,2015.0,608,0,608
,BOL,1998.0,25,0,25
PAK,,2020.0,2018,0,2018
URY,,2016.0,123,0,123
,LBY,2003.0,27,0,27
,HUN,2015.0,1610,0,1610
,DZA,2009.0,1053,0,1053
,HUN,2014.0,1717,0,1717
MYS,NOR,2014.0,3,0,3
,COL,1995.0,384,0,384
,IND,2014.0,33445,0,33445
GMB,,2025.0,256,0,256
YEM,,2022.0,87,0,87
,TZA,2002.0,122,0,122
,LKA,2000.0,122,0,122
MDG,,2024.0,331,0,331
IDN,,2022.0,4795,0,4795
,SRB,2011.0,1587,0,1587
,SWE,2009.0,3698,0,3698
,PRT,2018.0,3775,0,3775
LVA,,2021.0,231,0,231
,PAK,1996.0,619,0,619
UGA,,2024.0,1186,0,1186
LKA,,2022.0,420,0,420
,TUN,2008.0,1201,0,1201
,RUS,2019.0,11893,0,11893
PSE,,2025.0,1027,0,1027
,DZA,2019.0,1260,0,1260
,MDG,1999.0,39,0,39
,MAR,1999.0,529,0,529
UKR,,2001.0,489,0,489
MLT,,2017.0,24,0,24
NGA,,2013.0,775,0,775
CAN,,2000.0,2578,0,2578
IRL,,2006.0,390,0,390
,LBN,2015.0,533,0,533
YEM,,2018.0,23,0,23
,AZE,1997.0,69,0,69
PSE,,2019.0,75,0,75
,KEN,1999.0,171,0,171
,TWN,2014.0,5998,0,5998
,LBN,2001.0,167,0,167
,CYP,2003.0,59,0,59
LKA,,2016.0,102,0,102
,HUN,2008.0,1402,0,1402
ISL,,2022.0,260,0,260
LVA,,2011.0,85,0,85
,NLD,2011.0,6645,0,6645
,JOR,2007.0,447,0,447
EST,,2017.0,221,0,221
ESP,SAU,2003.0,2,0,2
,THA,1998.0,868,0,868
NZL,RUS,2001.0,1,0,1
,VNM,2007.0,424,0,424
ARE,,2004.0,48,0,48
BWA,,2016.0,49,0,49
BEL,SAU,2008.0,5,0,5
,SRB,2019.0,900,0,900
,CUB,2004.0,821,0,821
MDA,,2006.0,19,0,19
,ZWE,2003.0,62,0,62
SVK,CHN,2016.0,1,0,1
,ECU,1997.0,37,0,37
ROU,,2008.0,264,0,264
,ISR,2011.0,2445,0,2445
,AZE,2002.0,145,0,145
,CAN,2014.0,12888,0,12888
,NLD,2009.0,6384,0,6384
,EGY,2005.0,1467,0,1467
SWE,IDN,2004.0,2,0,2
,TUN,2004.0,983,0,983
LBY,QAT,2018.0,2,0,2
GMB,,2009.0,11,0,11
,GMB,2003.0,20,0,20
SRB,,2003.0,143,0,143
,TUN,1996.0,469,0,469
ARM,DNK,2014.0,3,0,3
LUX,,2023.0,345,0,345
PAK,,2007.0,242,0,242
,GHA,1994.0,175,0,175
,ROU,2005.0,1407,0,1407
LUX,,2010.0,28,0,28
,ARM,2002.0,112,0,112
ARM,,2007.0,50,0,50
,PAK,2004.0,1365,0,1365
,ZAF,2009.0,2088,0,2088
,ZAF,2011.0,2373,0,2373
GIN,,2005.0,2,0,2
BWA,,2017.0,54,0,54
MOZ,DNK,2005.0,1,0,1
,MLI,2004.0,58,0,58
SWE,URY,2016.0,2,0,2
ITA,LUX,2009.0,7,0,7
BIH,,2025.0,1497,0,1497
TUR,JOR,2014.0,2,0,2
DZA,,2010.0,99,0,99
,MAR,2007.0,711,0,711
DEU,DZA,2016.0,9,0,9
BIH,,2009.0,35,0,35
HND,,2025.0,124,0,124
ARM,,2020.0,112,0,112
,SWE,2011.0,3912,0,3912
VEN,,1999.0,38,0,38
LBN,,2011.0,108,0,108
,BIH,2002.0,133,0,133
TUN,,2014.0,517,0,517
,BIH,2012.0,234,0,234
LIE,,2025.0,87,0,87
,NOR,2007.0,1724,0,1724
RUS,HUN,2013.0,4,0,4
MLI,,2024.0,270,0,270
,SRB,2009.0,1667,0,1667
COL,,2003.0,78,0,78
MNG,,2015.0,31,0,31
,SGP,2007.0,1685,0,1685
,LBN,2004.0,214,0,214
,FJI,2003.0,21,0,21
,CHL,2017.0,2495,0,2495
,JAM,2001.0,40,0,40
TTO,,2007.0,28,0,28
LIE,,2011.0,2,0,2
LKA,,2018.0,147,0,147
,IRL,2016.0,1786,0,1786
,AZE,2012.0,129,0,129
,GUM,2003.0,8,0,8
ZWE,,2011.0,33,0,33
SYR,,2024.0,417,0,417
,ETH,2004.0,153,0,153
BGR,,2009.0,253,0,253
,UKR,2013.0,2307,0,2307
SWE,HND,2003.0,1,0,1
KHM,,2013.0,29,0,29
ECU,,2011.0,31,0,31
,SVN,2014.0,660,0,660
,SVN,2008.0,740,0,740
QAT,,2007.0,22,0,22
,ECU,2002.0,67,0,67
,LBN,1996.0,144,0,144
MWI,,2013.0,42,0,42
,URY,2012.0,283,0,283
SEN,,2008.0,35,0,35
,BLR,2006.0,208,0,208
,TWN,2015.0,5795,0,5795
GHA,,2015.0,71,0,71
SEN,,2015.0,67,0,67
COL,,2013.0,453,0,453
COD,,2023.0,210,0,210
,BFA,2002.0,36,0,36
GBR,GTM,2004.0,1,0,1
CIV,,2011.0,55,0,55
,URY,1997.0,129,0,129
,HKG,2011.0,1765,0,1765
SVK,SRB,2005.0,3,0,3
GEO,BEL,2008.0,1,0,1
GEO,ITA,2014.0,2,0,2
,SLV,2003.0,5,0,5
MDG,,2023.0,203,0,203
KGZ,,2025.0,312,0,312
HKG,EGY,2009.0,1,0,1
BRN,,2025.0,347,0,347
,MNG,2004.0,37,0,37
LVA,NOR,2007.0,1,0,1
COD,,2024.0,379,0,379
,GEO,1999.0,110,0,110
IDN,,2016.0,197,0,197
YEM,,2016.0,52,0,52
ISR,NZL,2000.0,1,0,1
SAU,,2003.0,182,0,182
,SDN,2007.0,156,0,156
IND,BRA,2008.0,7,0,7
,BEL,2009.0,3418,0,3418
,PAK,2015.0,4340,0,4340
PSE,,2011.0,24,0,24
,MNG,2001.0,22,0,22
DOM,,2025.0,205,0,205
BFA,NER,2013.0,4,0,4
,UGA,2006.0,228,0,228
,BWA,2004.0,79,0,79
HUN,,1999.0,152,0,152
,SDN,1999.0,32,0,32
,VEN,2004.0,475,0,475
PHL,,2001.0,34,0,34
,BGD,2010.0,885,0,885
NOR,SGP,2012.0,3,0,3
LBN,,2019.0,215,0,215
,BEN,2010.0,117,0,117
,NAM,2001.0,23,0,23
NAM,,2025.0,324,0,324
THA,ZMB,2012.0,1,0,1
CYP,RUS,2015.0,1,0,1
,NOR,2020.0,1113,0,1113
CZE,DNK,2003.0,2,0,2
MLT,JPN,2014.0,1,0,1
EST,SGP,2012.0,1,0,1
,PER,2000.0,136,0,136
IDN,,2026.0,287,0,287
BOL,,2020.0,72,0,72
POL,URY,2009.0,1,0,1
AGO,,2010.0,2,0,2
,KWT,1999.0,149,0,149
KWT,,2019.0,144,0,144
,LBN,2008.0,221,0,221
BRN,,2021.0,38,0,38
,PAK,2008.0,2493,0,2493
NLD,CYP,2020.0,3,0,3
SEN,,2014.0,58,0,58
SYC,,2007.0,2,0,2
,BRN,1997.0,10,0,10
MUS,,2011.0,12,0,12
IDN,,2017.0,337,0,337
FRA,MUS,2004.0,1,0,1
KWT,TZA,2016.0,2,0,2
AUT,,1999.0,291,0,291
SVN,,2000.0,50,0,50
,PRI,1995.0,170,0,170
ETH,,2012.0,50,0,50
VUT,USA,2004.0,1,0,1
,LIE,2004.0,10,0,10
FIN,,2003.0,762,0,762
PNG,,2025.0,158,0,158
CAN,SVN,2018.0,2,0,2
JPN,PER,2006.0,2,0,2
GBR,DZA,2004.0,4,0,4
SRB,BEL,2009.0,5,0,5
,LKA,2006.0,184,0,184
ZWE,,2009.0,45,0,45
SRB,GEO,2009.0,1,0,1
ESP,AGO,2007.0,1,0,1
KEN,,2006.0,52,0,52
QAT,,2020.0,178,0,178
JPN,CRI,2020.0,1,0,1
VNM,,2003.0,35,0,35
TUR,BOL,2007.0,1,0,1
,PNG,1994.0,93,0,93
TTO,ESP,2008.0,1,0,1
BGR,,2019.0,477,0,477
,NLD,2019.0,5953,0,5953
,YEM,2004.0,28,0,28
,SAU,2009.0,1208,0,1208
BHR,ZAF,2005.0,2,0,2
ARG,ATG,2007.0,1,0,1
ATG,ARG,2010.0,1,0,1
UKR,NLD,2012.0,4,0,4
,KAZ,1995.0,114,0,114
KAZ,CAN,2007.0,3,0,3
,ETH,2015.0,1031,0,1031
,TUN,2015.0,1436,0,1436
,AUS,2020.0,5914,0,5914
,MYS,2018.0,5401,0,5401
,PAK,2014.0,3927,0,3927
,TUN,2014.0,1495,0,1495
,CUB,2015.0,499,0,499
,VEN,2015.0,265,0,265
,BEL,2019.0,3308,0,3308
,POL,2017.0,6924,0,6924
,MNG,2014.0,77,0,77
MCO,,2022.0,15,0,15
,SVN,2015.0,578,0,578
,CMR,2014.0,462,0,462
,COG,2013.0,131,0,131
COD,,2019.0,25,0,25
,GUM,1996.0,9,0,9
,HUN,2013.0,1550,0,1550
,CHE,2018.0,4907,0,4907
,KAZ,2017.0,1501,0,1501
,GUM,2015.0,5,0,5
ETH,,2020.0,325,0,325
PSE,,2024.0,483,0,483
,MEX,2016.0,5863,0,5863
,PRI,2018.0,137,0,137
,COL,2016.0,2987,0,2987
,NPL,2017.0,629,0,629
LBR,,2015.0,5,0,5
,MOZ,2015.0,105,0,105
LIE,,2023.0,26,0,26
COD,,2025.0,641,0,641
,HRV,2005.0,1026,0,1026
SYR,,2019.0,61,0,61
,NOR,2012.0,2095,0,2095
,GAB,2015.0,48,0,48
,PER,2019.0,1481,0,1481
,BGD,2009.0,814,0,814
,PHL,2012.0,541,0,541
,PER,2009.0,352,0,352
,EGY,2020.0,3164,0,3164
,GRC,2008.0,2483,0,2483
,THA,2012.0,2509,0,2509
,FJI,2014.0,58,0,58
,PAN,2015.0,73,0,73
ESP,PSE,2019.0,6,0,6
,GRD,2015.0,31,0,31
,KAZ,2018.0,1339,0,1339
HUN,UKR,2016.0,4,0,4
,NGA,2012.0,1827,0,1827
,TUR,2020.0,5475,0,5475
,DNK,2019.0,2676,0,2676
,ARE,2016.0,720,0,720
,LBR,2015.0,25,0,25
,MAR,2012.0,1231,0,1231
,NPL,2016.0,497,0,497
,NPL,2018.0,903,0,903
,PAN,2014.0,58,0,58
JOR,PSE,2018.0,6,0,6
,TTO,2015.0,88,0,88
,BRB,2015.0,11,0,11
ERI,,2020.0,9,0,9
HTI,,2023.0,81,0,81
,CHE,2017.0,5044,0,5044
,LUX,2016.0,142,0,142
ZAF,BFA,2021.0,2,0,2
,SDN,2005.0,95,0,95
,LAO,2014.0,45,0,45
,KEN,2005.0,296,0,296
,MNE,2012.0,93,0,93
DNK,NPL,2018.0,2,0,2
NAM,,2024.0,211,0,211
,ZWE,2015.0,155,0,155
EST,SGP,2020.0,1,0,1
,GAB,2014.0,34,0,34
,BEN,2009.0,95,0,95
HTI,,2024.0,77,0,77
IRN,NGA,2019.0,2,0,2
,SLV,2015.0,23,0,23
,SLV,2008.0,32,0,32
KGZ,,2024.0,208,0,208
,LTU,2017.0,656,0,656
,SOM,2019.0,40,0,40
,LSO,2015.0,15,0,15
,ARG,2018.0,2556,0,2556
,LUX,2018.0,165,0,165
NGA,DNK,2023.0,1,0,1
,ZWE,2014.0,139,0,139
UGA,ZWE,2023.0,2,0,2
,SGP,2012.0,2414,0,2414
,OMN,2016.0,180,0,180
PRT,,2000.0,166,0,166
,MAC,2018.0,248,0,248
,BHR,2007.0,30,0,30
AGO,,2025.0,89,0,89
,CIV,2016.0,169,0,169
CMR,GUF,2020.0,1,0,1
,JAM,2013.0,43,0,43
,KEN,2012.0,609,0,609
,ETH,2013.0,687,0,687
MMR,,2020.0,62,0,62
CUB,CZE,2019.0,1,0,1
PHL,MAC,2018.0,1,0,1
,LUX,2017.0,164,0,164
,TTO,2014.0,55,0,55
,ZMB,2006.0,58,0,58
BFA,,2020.0,82,0,82
BTN,,2022.0,35,0,35
BIH,CYP,2023.0,1,0,1
,GEO,2012.0,187,0,187
TUR,IDN,2019.0,3,0,3
,ARE,2018.0,923,0,923
,BGD,2019.0,2455,0,2455
,OMN,2018.0,276,0,276
FRA,MLT,2022.0,1,0,1
,LTU,2018.0,643,0,643
NAM,,2023.0,99,0,99
,RWA,2018.0,163,0,163
,MMR,2018.0,134,0,134
,GTM,2019.0,61,0,61
,FIN,2020.0,1040,0,1040
MDG,COG,2021.0,1,0,1
,CZE,2020.0,1276,0,1276
,MDV,2018.0,12,0,12
GMB,,2023.0,60,0,60
PRK,,2023.0,103,0,103
,KGZ,2018.0,94,0,94
ZMB,ETH,2023.0,2,0,2
SYR,HUN,2022.0,2,0,2
,PER,1994.0,164,0,164
,HRV,2012.0,1007,0,1007
ESP,USA,2024.0,4,0,4
,CPV,2018.0,20,0,20
UKR,LVA,2021.0,6,0,6
,CIV,2018.0,150,0,150
ITA,QAT,2016.0,11,0,11
,CIV,2017.0,182,0,182
,UGA,2019.0,548,0,548
PRK,,2024.0,143,0,143
,MDG,2012.0,76,0,76
MDG,BEL,2021.0,4,0,4
FJI,,2024.0,143,0,143
SVK,,2026.0,73,0,73
,QAT,2019.0,717,0,717
TUR,CAF,2023.0,1,0,1
,PRY,2020.0,49,0,49
CUB,,2022.0,891,0,891
,MUS,2019.0,29,0,29
,ECU,2020.0,475,0,475
,KGZ,2016.0,71,0,71
,KGZ,2017.0,103,0,103
ISR,LBN,2021.0,1,0,1
,VUT,2018.0,4,0,4
,RWA,2017.0,156,0,156
HKG,SWE,2022.0,10,0,10
JOR,,2026.0,94,0,94
,UGA,2011.0,338,0,338
KEN,SOM,2021.0,3,0,3
ARG,,2002.0,411,0,411
,LKA,2019.0,510,0,510
,MAC,2017.0,232,0,232
NCL,KHM,2023.0,1,0,1
,IDN,2006.0,462,0,462
,JOR,2012.0,404,0,404
KWT,LBN,2003.0,1,0,1
,MLT,2000.0,31,0,31
COL,,2001.0,49,0,49
GUF,KHM,2002.0,2,0,2
BEL,MDG,2018.0,1,0,1
SRB,,2004.0,139,0,139
TUR,SGP,2004.0,1,0,1
SGP,TUR,2006.0,1,0,1
AUT,,2005.0,900,0,900
ISL,DEU,1999.0,1,0,1
,IRQ,1996.0,39,0,39
DNK,,1999.0,293,0,293
,URY,1998.0,122,0,122
NZL,,2006.0,493,0,493
UKR,MEX,1998.0,6,0,6
KWT,DEU,2009.0,1,0,1
MDG,,2011.0,21,0,21
CUB,PRI,2001.0,1,0,1
TUR,THA,2008.0,1,0,1
SUR,CAN,2005.0,1,0,1
FRA,QAT,2008.0,5,0,5
SRB,AUS,2000.0,2,0,2
KWT,FIN,2012.0,1,0,1
,URY,2007.0,228,0,228
CIV,,2006.0,25,0,25
,BEN,1994.0,56,0,56
BHR,,2017.0,29,0,29
GHA,NLD,2002.0,3,0,3
SRB,NOR,2002.0,2,0,2
,TJK,2001.0,5,0,5
GRL,,2014.0,8,0,8
BEL,ZWE,1997.0,1,0,1
NGA,SWZ,1998.0,1,0,1
,ZWE,2001.0,72,0,72
ARM,,2005.0,44,0,44
CZE,GRC,2008.0,1,0,1
CIV,KEN,1998.0,1,0,1
THA,,2005.0,240,0,240
PAK,,2005.0,186,0,186
KWT,POL,2000.0,1,0,1
BEL,CZE,2003.0,2,0,2
TUN,,2003.0,77,0,77
EGY,,1999.0,117,0,117
KWT,FIN,2005.0,1,0,1
,BOL,1997.0,42,0,42
CHL,,2006.0,245,0,245
OMN,SDN,2012.0,3,0,3
CHL,,2000.0,134,0,134
PAK,,2002.0,123,0,123
,MAR,2005.0,486,0,486
GAB,PRT,2010.0,1,0,1
JPN,UZB,2019.0,1,0,1
JOR,BHR,2007.0,3,0,3
COL,,2015.0,586,0,586
ISR,AZE,2015.0,2,0,2
PRI,,2014.0,120,0,120
,VNM,1997.0,112,0,112
GTM,JPN,2000.0,1,0,1
SEN,,2013.0,40,0,40
UKR,KOR,1999.0,4,0,4
BRA,MUS,2013.0,1,0,1
CHL,URY,1999.0,1,0,1
NCL,TUN,2002.0,1,0,1
JPN,EST,2007.0,1,0,1
,LAO,2001.0,15,0,15
SGP,BRN,2010.0,1,0,1
,AZE,1998.0,73,0,73
LBN,,2000.0,21,0,21
COL,,2004.0,76,0,76
ZMB,,2017.0,38,0,38
SEN,,2003.0,26,0,26
MEX,CRI,2000.0,6,0,6
,CYP,1996.0,49,0,49
CIV,,2000.0,20,0,20
,SDN,2012.0,106,0,106
BGR,,2006.0,200,0,200
,ECU,1998.0,47,0,47
PRI,RUS,2005.0,1,0,1
USA,TGO,2006.0,1,0,1
HUN,SVK,2010.0,7,0,7
ZAF,CHL,2016.0,4,0,4
ECU,,2006.0,14,0,14
GTM,CHE,2002.0,1,0,1
BHR,GBR,2000.0,4,0,4
AZE,,2003.0,21,0,21
,LBN,2013.0,396,0,396
,MNG,2013.0,84,0,84
,LBY,2008.0,84,0,84
JOR,,2018.0,190,0,190
,NAM,2013.0,42,0,42
MAR,CMR,2018.0,2,0,2
,LTU,2016.0,552,0,552
,LVA,2012.0,260,0,260
NIC,,2018.0,29,0,29
,CUB,2013.0,557,0,557
GHA,MWI,2017.0,1,0,1
KGZ,AUT,2017.0,1,0,1
,ISL,2011.0,131,0,131
CPV,,2019.0,7,0,7
,CMR,2008.0,265,0,265
USA,VAT,2017.0,3,0,3
TUR,AFG,2019.0,2,0,2
CIV,TGO,2012.0,1,0,1
ESP,GIB,2015.0,4,0,4
,LKA,2011.0,287,0,287
,PER,2011.0,375,0,375
,DJI,1999.0,2,0,2
MYS,SYR,2021.0,2,0,2
NZL,KGZ,2020.0,1,0,1
PRT,BGD,2016.0,1,0,1
SAU,URY,2000.0,1,0,1
,KWT,2012.0,124,0,124
,QAT,2009.0,117,0,117
IRQ,CZE,2017.0,1,0,1
LBN,SYR,2022.0,1,0,1
,MWI,2012.0,120,0,120
KOR,CHL,2020.0,6,0,6
,GLP,2013.0,6,0,6
,VEN,2013.0,317,0,317
,ZWE,2008.0,96,0,96
,WSM,2013.0,12,0,12
CHL,HND,2019.0,1,0,1
HND,ARG,2022.0,2,0,2
MUS,,2024.0,128,0,128
FSM,,2025.0,12,0,12
NOR,KEN,2022.0,5,0,5
TZA,,2018.0,145,0,145
,YEM,2013.0,35,0,35
IRL,VNM,2014.0,1,0,1
PAK,EST,2018.0,2,0,2
BGD,,1999.0,52,0,52
YEM,DEU,2016.0,1,0,1
,RWA,2016.0,126,0,126
TZA,,2017.0,142,0,142
SWE,IRN,2024.0,1,0,1
LUX,,2019.0,86,0,86
IRN,KAZ,2018.0,2,0,2
IRL,QAT,2016.0,2,0,2
ITA,KAZ,2004.0,5,0,5
AFG,,2020.0,16,0,16
GMB,,2024.0,104,0,104
MWI,FRA,2004.0,1,0,1
,STP,2013.0,1,0,1
,GMB,2008.0,21,0,21
,BHS,2013.0,12,0,12
,HTI,2016.0,20,0,20
,PRI,2016.0,159,0,159
,IRQ,2008.0,318,0,318
,NER,2016.0,35,0,35
,MMR,2016.0,132,0,132
AUT,LBN,2020.0,1,0,1
,MAC,2016.0,235,0,235
BRA,MAC,1999.0,1,0,1
ZAF,IRN,2003.0,3,0,3
COD,,2021.0,84,0,84
TUR,MLT,2023.0,1,0,1
LVA,,2000.0,19,0,19
,TGO,2012.0,50,0,50
IRQ,,2026.0,198,0,198
,TJK,2015.0,23,0,23
,GMB,2015.0,33,0,33
ITA,MWI,2019.0,1,0,1
HKG,MEX,2020.0,1,0,1
,ECU,2007.0,103,0,103
,ARM,2007.0,154,0,154
,SDN,1997.0,40,0,40
AUS,VUT,2000.0,1,0,1
CYP,,2007.0,23,0,23
ESP,NIC,2022.0,1,0,1
VNM,,2015.0,253,0,253
,PHL,2005.0,223,0,223
CAN,HRV,2010.0,1,0,1
BGR,,2000.0,154,0,154
HND,,2024.0,103,0,103
SOM,,2020.0,2,0,2
POL,KWT,2020.0,1,0,1
,VUT,2016.0,6,0,6
CMR,BEN,2023.0,2,0,2
,ISL,2019.0,110,0,110
,UZB,2020.0,211,0,211
TZA,,2026.0,19,0,19
DZA,JOR,2021.0,1,0,1
KGZ,,2023.0,106,0,106
,NER,2018.0,35,0,35
FLK,,2025.0,11,0,11
,GAB,1996.0,25,0,25
CAN,CIV,2018.0,5,0,5
THA,,2002.0,157,0,157
,VNM,2005.0,255,0,255
SXM,SWE,2022.0,1,0,1
NGA,CHN,2024.0,2,0,2
,SUR,2014.0,14,0,14
SUR,,2022.0,14,0,14
VNM,HKG,2022.0,2,0,2
GRD,,2025.0,73,0,73
,FRA,2021.0,59,0,59
,HND,2019.0,40,0,40
,HTI,2018.0,33,0,33
DOM,,2024.0,96,0,96
LVA,DNK,2022.0,5,0,5
SEN,DEU,2023.0,1,0,1
ETH,NOR,2000.0,2,0,2
ARG,NOR,1999.0,1,0,1
GTM,,2008.0,8,0,8
ARG,HUN,2003.0,3,0,3
NLD,MOZ,2000.0,1,0,1
SRB,NLD,2001.0,4,0,4
JOR,,2017.0,180,0,180
GHA,BWA,2010.0,1,0,1
ZWE,,2010.0,38,0,38
DEU,NAM,1997.0,1,0,1
MRT,BFA,2001.0,1,0,1
,ALB,2002.0,17,0,17
TUR,HRV,2004.0,1,0,1
ZWE,MWI,1998.0,1,0,1
USA,ASM,1998.0,2,0,2
SDN,MYS,2002.0,4,0,4
,IRN,2021.0,84,0,84
ISL,SGP,2014.0,2,0,2
CHN,COL,2003.0,1,0,1
GHA,PNG,2003.0,1,0,1
PNG,GHA,2004.0,1,0,1
,SAU,2006.0,579,0,579
ASM,,2018.0,2,0,2
MRT,,2002.0,2,0,2
VCT,CAN,1998.0,1,0,1
DZA,USA,2007.0,4,0,4
GAB,,2003.0,9,0,9
ARM,,2002.0,62,0,62
ECU,,2010.0,28,0,28
DEU,ARE,2004.0,2,0,2
IND,HUN,2014.0,3,0,3
,MUS,1994.0,19,0,19
ZMB,FRA,1997.0,1,0,1
GHA,,2003.0,15,0,15
MKD,,2003.0,15,0,15
CHE,BFA,2006.0,1,0,1
USA,SLV,2003.0,2,0,2
JAM,,2005.0,15,0,15
FRA,AND,2010.0,1,0,1
,MTQ,1996.0,15,0,15
PRI,,2001.0,25,0,25
,BRB,1996.0,21,0,21
HRV,,2005.0,211,0,211
,AZE,1999.0,84,0,84
NGA,,2001.0,86,0,86
PSE,DEU,2007.0,2,0,2
SRB,GEO,2006.0,1,0,1
,BOL,2002.0,34,0,34
HUN,DNK,2010.0,5,0,5
TWN,RUS,1997.0,3,0,3
SRB,,2001.0,110,0,110
,LVA,1997.0,160,0,160
KWT,,2000.0,66,0,66
CZE,SVN,1999.0,1,0,1
BEL,COL,2001.0,1,0,1
HRV,TUN,2002.0,1,0,1
PRT,CZE,1999.0,2,0,2
OMN,,2012.0,59,0,59
SRB,ARE,2014.0,2,0,2
KWT,OMN,2001.0,2,0,2
KGZ,ESP,2014.0,1,0,1
PNG,,2000.0,10,0,10
MCO,SDN,2020.0,1,0,1
,MNE,1997.0,14,0,14
,BIH,1999.0,61,0,61
BRN,,2000.0,2,0,2
NAM,USA,1998.0,1,0,1
GTM,,2004.0,4,0,4
CAN,TZA,2013.0,5,0,5
MEX,IRN,2006.0,2,0,2
CMR,,2007.0,36,0,36
QAT,KWT,2000.0,1,0,1
KOR,YEM,2016.0,1,0,1
,JOR,2005.0,309,0,309
GRC,COL,2016.0,2,0,2
,BRB,2008.0,15,0,15
,GAB,2008.0,28,0,28
VUT,TUR,2008.0,1,0,1
NIC,,2017.0,22,0,22
CHL,GTM,2016.0,2,0,2
,ISL,2009.0,144,0,144
,UZB,2007.0,92,0,92
MWI,,2001.0,3,0,3
,MKD,2000.0,64,0,64
ITA,AGO,2014.0,1,0,1
MAC,MKD,2020.0,11,0,11
COL,MOZ,2011.0,1,0,1
SWZ,USA,2011.0,1,0,1
GHA,TUN,2007.0,1,0,1
,FRA,1996.0,17273,0,17273
FRA,,2025.0,111931,0,111931
,USA,2005.0,78195,0,78195
USA,,2010.0,49633,0,49633
USA,,2024.0,298082,0,298082
USA,,2000.0,25901,0,25901
,CHN,1999.0,23801,0,23801
GBR,,2025.0,156083,0,156083
,USA,1997.0,78894,0,78894
USA,,2006.0,38348,0,38348
DEU,,2007.0,10591,0,10591
ESP,,2015.0,7559,0,7559
DEU,,2020.0,24083,0,24083
,SAU,2003.0,404,0,404
,IND,2010.0,28566,0,28566
,BEL,2003.0,2763,0,2763
AUS,,2017.0,6535,0,6535
,CHE,1999.0,2801,0,2801
,HKG,2003.0,1333,0,1333
USA,,2023.0,188237,0,188237
,CHN,2007.0,86262,0,86262
CHN,,2016.0,67523,0,67523
,NLD,2003.0,4948,0,4948
,USA,2002.0,74932,0,74932
BEL,,2023.0,6878,0,6878
ESP,,2014.0,6989,0,6989
,SRB,2003.0,697,0,697
TWN,,2007.0,1945,0,1945
DNK,,2018.0,2175,0,2175
,JPN,1994.0,107252,0,107252
JPN,,2007.0,16427,0,16427
FRA,,2019.0,14146,0,14146
BEL,,2024.0,11041,0,11041
GBR,,2009.0,11065,0,11065
FIN,,2025.0,18229,0,18229
,SWE,2003.0,3402,0,3402
,FRA,2001.0,11979,0,11979
,HUN,2006.0,1451,0,1451
CHN,,2026.0,47752,0,47752
TUR,,2013.0,2595,0,2595
,IND,2006.0,16721,0,16721
SAU,,2025.0,24144,0,24144
FRA,,2009.0,7325,0,7325
NLD,,2012.0,2885,0,2885
ITA,,2020.0,12572,0,12572
,ISR,2003.0,2297,0,2297
,MEX,1998.0,2271,0,2271
,MEX,2007.0,3921,0,3921
MEX,,2012.0,1698,0,1698
,ESP,1994.0,32727,0,32727
,MEX,1999.0,2240,0,2240
CAN,,2015.0,8313,0,8313
SWE,,2011.0,2110,0,2110
COL,,2025.0,12807,0,12807
GBR,,2011.0,11189,0,11189
,PER,2001.0,172,0,172
TUN,,2024.0,4027,0,4027
,PYF,2012.0,18,0,18
SGP,,2007.0,633,0,633
ZAF,,2011.0,683,0,683
,MYS,2002.0,831,0,831
,VEN,2006.0,751,0,751
GBR,,2021.0,24601,0,24601
AUS,,2026.0,1160,0,1160
,CHN,1998.0,19101,0,19101
CHN,,2022.0,169988,0,169988
,RUS,2003.0,5983,0,5983
RUS,,2023.0,28286,0,28286
,POL,2002.0,4450,0,4450
ITA,,2007.0,4860,0,4860
IND,,2024.0,83685,0,83685
,TWN,2006.0,7004,0,7004
TWN,,2020.0,6306,0,6306
,HUN,2000.0,1231,0,1231
,PRT,1997.0,1328,0,1328
CAN,,2008.0,5008,0,5008
SWE,,2025.0,33879,0,33879
,CAN,2000.0,8531,0,8531
FRA,,2011.0,7730,0,7730
,FRA,2004.0,13564,0,13564
FIN,,2011.0,1147,0,1147
,GRC,1994.0,5433,0,5433
BEL,,2010.0,1554,0,1554
AUS,,2016.0,5846,0,5846
CHN,,2017.0,78232,0,78232
KOR,,2013.0,7189,0,7189
JPN,,2020.0,25271,0,25271
SVK,,2007.0,284,0,284
,SVK,2003.0,638,0,638
ISR,,2012.0,1322,0,1322
ROU,,2024.0,6716,0,6716
MYS,,2022.0,5386,0,5386
PHL,,2010.0,85,0,85
PHL,,2024.0,2481,0,2481
,IRL,2002.0,1127,0,1127
RUS,,2010.0,3929,0,3929
,ITA,1995.0,21100,0,21100
MYS,,2016.0,1528,0,1528
GRC,,2007.0,858,0,858
SRB,,2025.0,9990,0,9990
NZL,,2013.0,778,0,778
,NIC,2002.0,11,0,11
,IRN,2004.0,4519,0,4519
,LTU,1998.0,248,0,248
CAN,,2014.0,7880,0,7880
FIN,,2009.0,1188,0,1188
,DNK,2008.0,2283,0,2283
,UKR,2009.0,1334,0,1334
DNK,MLT,2022.0,1,0,1
KWT,,2013.0,154,0,154
,CAN,2006.0,11106,0,11106
ZAF,,2025.0,17347,0,17347
ESP,,2008.0,4479,0,4479
,IND,2000.0,8866,0,8866
,ZAF,2003.0,1305,0,1305
,DZA,2003.0,512,0,512
,ROU,2017.0,2104,0,2104
,KOR,1994.0,10081,0,10081
RUS,,2024.0,49761,0,49761
IND,,2023.0,45690,0,45690
HKG,,2010.0,877,0,877
TUN,,2023.0,2348,0,2348
IND,,2010.0,5037,0,5037
,FRA,2008.0,14467,0,14467
CHN,,2018.0,87153,0,87153
ISL,,2012.0,84,0,84
,KOR,2011.0,15815,0,15815
,PRT,2002.0,1620,0,1620
TUN,,2010.0,309,0,309
RUS,,2006.0,3649,0,3649
GBR,,2019.0,18370,0,18370
,IRL,1997.0,748,0,748
EGY,,2017.0,1242,0,1242
,POL,1997.0,4016,0,4016
,BRA,1994.0,10857,0,10857
FRA,,2021.0,17181,0,17181
ROU,,2006.0,250,0,250
CYP,,2022.0,328,0,328
,JPN,2009.0,23338,0,23338
,DNK,2001.0,1514,0,1514
CHE,,2017.0,3618,0,3618
FIN,,2019.0,1949,0,1949
,NZL,1995.0,2021,0,2021
CHE,,2022.0,6888,0,6888
SVN,,2014.0,362,0,362
,LTU,1999.0,224,0,224
,ESP,2009.0,14264,0,14264
SWE,,2019.0,3560,0,3560
CHE,,2018.0,4002,0,4002
,IRN,2001.0,1713,0,1713
,HRV,1995.0,1041,0,1041
,AUS,1995.0,9962,0,9962
,MYS,2005.0,1443,0,1443
AUS,,2022.0,12788,0,12788
,DEU,2016.0,24569,0,24569
HKG,,2024.0,4828,0,4828
CZE,,2007.0,635,0,635
,KOR,2009.0,13894,0,13894
,CAN,2010.0,12401,0,12401
SWE,,2009.0,2065,0,2065
,BRA,2009.0,18738,0,18738
,SRB,2013.0,1182,0,1182
ROU,SRB,2019.0,1,0,1
SRB,,2021.0,1276,0,1276
,FRA,2014.0,14994,0,14994
CHE,,2016.0,3467,0,3467
,DNK,1996.0,2139,0,2139
,ARG,1999.0,1757,0,1757
NGA,,2019.0,986,0,986
UKR,,2024.0,11227,0,11227
NGA,,2025.0,14173,0,14173
,GRC,2009.0,2609,0,2609
IND,,2006.0,3470,0,3470
DZA,,2014.0,199,0,199
AZE,,2024.0,736,0,736
KAZ,,2016.0,152,0,152
,USA,2012.0,93427,0,93427
,AUT,1995.0,3003,0,3003
BEL,,2006.0,1127,0,1127
,IRN,2008.0,9570,0,9570
CUB,ECU,2014.0,18,0,18
,RUS,2013.0,15988,0,15988
LTU,,2008.0,134,0,134
JPN,,1999.0,7457,0,7457
IRN,,2012.0,1367,0,1367
IRL,,2015.0,937,0,937
SAU,,2021.0,1794,0,1794
,TWN,2000.0,4008,0,4008
,BOL,1995.0,48,0,48
PER,,2006.0,41,0,41
AUS,,2018.0,7156,0,7156
CAN,,2001.0,2992,0,2992
QAT,MAR,2013.0,1,0,1
MAR,,2007.0,195,0,195
,FIN,2017.0,2002,0,2002
GRC,,2020.0,2201,0,2201
UKR,,2023.0,6879,0,6879
NGA,,2009.0,281,0,281
ROU,,2023.0,3671,0,3671
DEU,,1999.0,4229,0,4229
ESP,,2001.0,2249,0,2249
,CMR,2011.0,293,0,293
,JPN,2011.0,23543,0,23543
FIN,,2021.0,2355,0,2355
,CHE,1998.0,3005,0,3005
NOR,,2012.0,851,0,851
SWE,,2021.0,4558,0,4558
CHL,PRT,2006.0,1,0,1
,COL,1999.0,326,0,326
,CUB,2006.0,726,0,726
,ARG,1998.0,1903,0,1903
,LVA,1995.0,207,0,207
MWI,,2011.0,19,0,19
MWI,,2019.0,92,0,92
MWI,,2025.0,950,0,950
,BRA,2011.0,20645,0,20645
,GBR,2016.0,22322,0,22322
DNK,,2016.0,1616,0,1616
BLR,,2020.0,253,0,253
,GHA,2003.0,111,0,111
,IRL,2005.0,1286,0,1286
PSE,,2013.0,25,0,25
PRI,,2025.0,867,0,867
,POL,2012.0,6371,0,6371
PRI,,2011.0,69,0,69
GEO,,2020.0,189,0,189
,GEO,1995.0,202,0,202
,BGD,1996.0,244,0,244
,VEN,2000.0,468,0,468
EGY,,2018.0,1565,0,1565
,KEN,1995.0,306,0,306
,THA,1995.0,985,0,985
,GBR,2018.0,22444,0,22444
,NCL,2003.0,22,0,22
,LBN,2000.0,138,0,138
,ESP,2011.0,14481,0,14481
SRB,,2019.0,919,0,919
ETH,,2022.0,815,0,815
,BGR,2002.0,442,0,442
KOR,,2003.0,2492,0,2492
NLD,,2005.0,1958,0,1958
CZE,,2020.0,2478,0,2478
,TWN,2010.0,7425,0,7425
MEX,,2002.0,390,0,390
UKR,,2000.0,532,0,532
DEU,KAZ,2014.0,3,0,3
IND,,2000.0,1907,0,1907
NGA,,2011.0,425,0,425
SAU,,2019.0,1186,0,1186
EGY,,2016.0,1088,0,1088
HKG,,2023.0,2616,0,2616
,NGA,1995.0,727,0,727
,CHL,1997.0,760,0,760
,SVN,2000.0,485,0,485
IRL,,2008.0,464,0,464
OMN,TUN,2011.0,3,0,3
,CHL,2002.0,942,0,942
BGR,,2013.0,294,0,294
,FRA,2015.0,14408,0,14408
UKR,,2006.0,572,0,572
VNM,,2025.0,12467,0,12467
,PNG,2003.0,20,0,20
,DNK,2014.0,3012,0,3012
NLD,,2002.0,1929,0,1929
IRL,,2004.0,335,0,335
COL,,2021.0,2268,0,2268
KHM,CHN,2012.0,1,0,1
KEN,,2015.0,192,0,192
,SVN,2006.0,721,0,721
ZAF,,2009.0,604,0,604
,KGZ,1999.0,13,0,13
ZAF,,2021.0,2615,0,2615
,MAR,1995.0,645,0,645
,CIV,1999.0,53,0,53
CMR,,2018.0,197,0,197
SGP,,2020.0,1976,0,1976
ARE,,2024.0,1996,0,1996
VNM,,2009.0,114,0,114
RUS,,2000.0,2202,0,2202
,CHL,2005.0,1419,0,1419
SVN,,2015.0,405,0,405
,NLD,2013.0,6692,0,6692
,HUN,2010.0,1582,0,1582
,CHE,2007.0,3846,0,3846
,SGP,1995.0,1017,0,1017
ARE,,2023.0,1103,0,1103
NGA,,2021.0,1828,0,1828
TWN,,1999.0,723,0,723
,SWE,2013.0,3816,0,3816
,IRN,1996.0,590,0,590
,NOR,1995.0,2565,0,2565
,POL,2005.0,4397,0,4397
,TUN,2000.0,588,0,588
,GBR,2017.0,21979,0,21979
ITA,,1999.0,2177,0,2177
,UKR,1994.0,5560,0,5560
,IDN,2003.0,322,0,322
LTU,,2015.0,309,0,309
,PRT,2005.0,1926,0,1926
TZA,,2007.0,36,0,36
,EGY,2016.0,4549,0,4549
EGY,,2026.0,503,0,503
UKR,,2010.0,582,0,582
,ISL,1996.0,139,0,139
UZB,,2016.0,60,0,60
ESP,,2004.0,3245,0,3245
KEN,,2008.0,89,0,89
IDN,,2005.0,72,0,72
CUB,,2007.0,257,0,257
,BGR,1997.0,633,0,633
ZAF,,2019.0,1667,0,1667
BLR,,2007.0,155,0,155
LVA,,2013.0,77,0,77
,DNK,2004.0,1669,0,1669
SAU,,2009.0,228,0,228
,BGD,2001.0,282,0,282
DNK,,2017.0,1870,0,1870
PRT,,2013.0,873,0,873
CAN,,2004.0,3776,0,3776
,BLR,1996.0,502,0,502
KAZ,,2018.0,355,0,355
,KHM,2002.0,31,0,31
NOR,,2002.0,396,0,396
UGA,,2008.0,28,0,28
PER,,2024.0,2682,0,2682
,ARM,2016.0,152,0,152
,UGA,1996.0,83,0,83
BGD,,2018.0,443,0,443
ETH,,2017.0,133,0,133
IND,CHL,2006.0,3,0,3
RWA,LUX,2022.0,1,0,1
BEL,IRQ,2012.0,1,0,1
CRI,,2007.0,34,0,34
HKG,,2006.0,581,0,581
CMR,,2016.0,121,0,121
PER,,2023.0,1361,0,1361
,PER,2004.0,261,0,261
DNK,,2022.0,3761,0,3761
BEL,,2000.0,705,0,705
,CMR,1994.0,220,0,220
IND,CMR,2015.0,3,0,3
MYS,,2017.0,1900,0,1900
JOR,FRA,2007.0,1,0,1
,BLR,2001.0,263,0,263
CUB,,2020.0,707,0,707
EGY,,2022.0,4151,0,4151
,ISL,2001.0,91,0,91
,ZWE,1994.0,260,0,260
,ARG,2007.0,2500,0,2500
,CZE,2018.0,2541,0,2541
,UKR,2019.0,3393,0,3393
LTU,,2014.0,300,0,300
AFG,,2018.0,14,0,14
GHA,,2024.0,1777,0,1777
,DEU,2017.0,24354,0,24354
,HKG,2013.0,1924,0,1924
,MKD,2003.0,91,0,91
,COG,2000.0,17,0,17
,GRC,2011.0,2383,0,2383
,TUR,2018.0,8502,0,8502
MYS,,2018.0,2378,0,2378
,IDN,2013.0,3347,0,3347
MAC,,2017.0,68,0,68
BLR,CAN,2010.0,1,0,1
BGD,,2022.0,1003,0,1003
CHL,,2013.0,657,0,657
,COL,1998.0,305,0,305
,PAK,2006.0,1824,0,1824
RUS,EGY,2006.0,3,0,3
,ROU,2016.0,1875,0,1875
,CUB,2000.0,586,0,586
SRB,,2009.0,153,0,153
LBR,,2025.0,213,0,213
MAR,,2020.0,782,0,782
MYS,,2026.0,392,0,392
,BGD,2004.0,456,0,456
,BGR,2005.0,570,0,570
TLS,,2016.0,6,0,6
KEN,,2014.0,175,0,175
SVN,,2008.0,176,0,176
LBN,,2013.0,92,0,92
IRQ,,2007.0,13,0,13
,NPL,1999.0,73,0,73
KEN,COG,2011.0,1,0,1
LAO,KGZ,2012.0,1,0,1
CAF,,2025.0,55,0,55
,GAB,2009.0,40,0,40
PHL,,2023.0,1400,0,1400
SLB,,2025.0,50,0,50
,JOR,1995.0,258,0,258
BEL,UGA,2008.0,4,0,4
,BLR,2004.0,278,0,278
,ESP,2019.0,14694,0,14694
,BLR,2008.0,177,0,177
MMR,,2022.0,149,0,149
IRL,,2014.0,892,0,892
ISR,,2005.0,898,0,898
IRN,,2005.0,128,0,128
,DEU,2018.0,24333,0,24333
,MYS,1997.0,452,0,452
,ERI,2003.0,8,0,8
ERI,,2017.0,7,0,7
DEU,GMB,2005.0,2,0,2
GUM,,2025.0,36,0,36
,IRN,2014.0,13147,0,13147
DZA,,2015.0,234,0,234
PNG,BRN,2003.0,1,0,1
TWN,BEL,2006.0,3,0,3
,CYP,2009.0,130,0,130
VNM,,2011.0,125,0,125
DNK,MOZ,2007.0,1,0,1
CZE,,1999.0,196,0,196
SAU,,2011.0,272,0,272
BGD,,2017.0,460,0,460
POL,NZL,2006.0,1,0,1
BHR,,2020.0,68,0,68
BHR,,2007.0,20,0,20
GAB,,2023.0,75,0,75
SWE,GEO,2022.0,2,0,2
MAC,,2022.0,109,0,109
BFA,MLI,2016.0,2,0,2
,PAK,2000.0,656,0,656
MAR,DZA,2010.0,2,0,2
KHM,,2025.0,411,0,411
,LKA,2014.0,391,0,391
SYR,,2008.0,15,0,15
PRI,,2021.0,158,0,158
VNM,,2021.0,983,0,983
COG,,2022.0,107,0,107
SRB,POL,2007.0,6,0,6
,UKR,2011.0,1990,0,1990
,ZAF,2013.0,2592,0,2592
,SEN,2012.0,153,0,153
SEN,,2024.0,579,0,579
HRV,JPN,2012.0,2,0,2
,PYF,2002.0,6,0,6
CAN,GAB,2014.0,2,0,2
DNK,,2026.0,281,0,281
HUN,RUS,2012.0,1,0,1
GEO,,2007.0,46,0,46
SVN,,2001.0,57,0,57
PRI,,2009.0,68,0,68
,EGY,2018.0,5167,0,5167
,ZMB,2003.0,24,0,24
,ETH,2000.0,101,0,101
,PRI,1998.0,98,0,98
BRB,,2020.0,22,0,22
,BEL,2013.0,3686,0,3686
BGD,NZL,2004.0,1,0,1
GUM,,2011.0,4,0,4
KHM,,2009.0,10,0,10
COG,,2016.0,65,0,65
BFA,,2018.0,73,0,73
HND,SWE,1997.0,1,0,1
CHN,BDI,2013.0,1,0,1
KHM,,2011.0,16,0,16
ITA,JOR,2011.0,1,0,1
JOR,,2020.0,294,0,294
,COL,2007.0,1559,0,1559
MKD,,2024.0,497,0,497
,UGA,2001.0,91,0,91
COG,,2017.0,86,0,86
,PAK,2010.0,3016,0,3016
GHA,,2023.0,881,0,881
CIV,,2013.0,68,0,68
,CIV,1998.0,56,0,56
,UGA,2004.0,149,0,149
LKA,,2012.0,54,0,54
,ARE,1998.0,68,0,68
MNE,,2005.0,4,0,4
MEX,,2005.0,579,0,579
,KAZ,2007.0,112,0,112
KAZ,,2022.0,1473,0,1473
CHL,,2003.0,199,0,199
URY,,2012.0,83,0,83
COL,,2011.0,274,0,274
MWI,,2021.0,120,0,120
NGA,BRA,2008.0,1,0,1
ZMB,,2020.0,98,0,98
CAN,PAN,2017.0,3,0,3
EGY,BRN,2015.0,2,0,2
CRI,DNK,2016.0,2,0,2
DNK,CRI,2021.0,2,0,2
,TUN,2006.0,1099,0,1099
,KAZ,1999.0,108,0,108
ARG,THA,2008.0,1,0,1
TWN,FIN,2012.0,3,0,3
,MDA,2000.0,39,0,39
UGA,,2014.0,94,0,94
TZA,,2020.0,199,0,199
,TUR,2017.0,8020,0,8020
,IRN,2015.0,12362,0,12362
AUT,SVN,2007.0,4,0,4
,PHL,1995.0,261,0,261
,BRA,2019.0,18520,0,18520
MNG,,2023.0,188,0,188
UZB,,2022.0,343,0,343
CYP,,2018.0,100,0,100
MDG,,2008.0,21,0,21
MOZ,,2023.0,163,0,163
,IRQ,1994.0,61,0,61
YEM,IRQ,2007.0,2,0,2
COL,,2019.0,1344,0,1344
TUR,,2003.0,500,0,500
EST,,2012.0,128,0,128
GBR,LBY,2006.0,1,0,1
LTU,,2001.0,37,0,37
,OMN,1999.0,82,0,82
AZE,,2000.0,22,0,22
SVK,,2020.0,865,0,865
ROU,,2010.0,467,0,467
NPL,TZA,1997.0,1,0,1
SVK,,1999.0,92,0,92
,TUR,2016.0,7675,0,7675
TUN,,2006.0,138,0,138
,ISL,2004.0,111,0,111
LBY,,2012.0,63,0,63
SRB,,2011.0,299,0,299
DZA,,2008.0,53,0,53
IND,NAM,2008.0,1,0,1
,LKA,2004.0,139,0,139
NZL,,2003.0,407,0,407
NLD,PRI,2015.0,1,0,1
GBR,GRL,2009.0,2,0,2
PRI,IND,2016.0,3,0,3
NER,DEU,2010.0,1,0,1
ISR,,2002.0,759,0,759
MDA,TUR,2010.0,1,0,1
ITA,BOL,2018.0,2,0,2
,OMN,1998.0,102,0,102
,SAU,2013.0,2044,0,2044
MWI,,2009.0,23,0,23
NLD,PAK,2004.0,1,0,1
HRV,NOR,2004.0,1,0,1
,MYS,2012.0,5453,0,5453
CUB,NIC,2004.0,1,0,1
ECU,,2013.0,62,0,62
,LBY,1994.0,32,0,32
PRT,MAR,2005.0,1,0,1
MNG,,2024.0,308,0,308
DOM,,2013.0,9,0,9
NOR,SVK,2008.0,1,0,1
LSO,MWI,2013.0,1,0,1
ROU,OMN,2008.0,11,0,11
,SYC,2002.0,2,0,2
,MUS,2004.0,17,0,17
,CYP,1994.0,105,0,105
CYP,,2016.0,81,0,81
,ETH,2006.0,227,0,227
BGD,,2016.0,384,0,384
,SDN,1995.0,54,0,54
URY,,2002.0,29,0,29
,VUT,1998.0,6,0,6
CRI,,1999.0,12,0,12
GTM,,2011.0,13,0,13
MUS,CAN,2011.0,4,0,4
MOZ,,2010.0,12,0,12
PER,,2010.0,64,0,64
VNM,,2019.0,530,0,530
,KGZ,1998.0,21,0,21
,CZE,2016.0,2624,0,2624
VCT,GBR,2008.0,1,0,1
CUW,,2025.0,20,0,20
CMR,,2022.0,502,0,502
,NIC,1997.0,13,0,13
SYR,,2014.0,46,0,46
GBR,MAC,2004.0,1,0,1
,GMB,1994.0,60,0,60
AGO,NOR,2008.0,1,0,1
SUR,TUN,2016.0,4,0,4
,DNK,2015.0,2847,0,2847
MLT,,2012.0,16,0,16
,JAM,2000.0,47,0,47
,JPN,2019.0,19741,0,19741
,IRL,2012.0,1750,0,1750
,BEN,2015.0,141,0,141
,UGA,2015.0,397,0,397
,CHN,2020.0,252516,0,252516
,BGD,2015.0,1033,0,1033
,SVK,2013.0,1163,0,1163
,KAZ,2020.0,725,0,725
,BLR,2014.0,265,0,265
,KOR,2019.0,16475,0,16475
,PER,2015.0,706,0,706
,FIN,2016.0,2079,0,2079
,BIH,2016.0,327,0,327
,PRT,2012.0,3506,0,3506
,LKA,2015.0,410,0,410
,BLR,2015.0,286,0,286
,EGY,2017.0,4983,0,4983
KHM,HKG,2021.0,1,0,1
POL,KAZ,2017.0,7,0,7
EGY,UKR,2023.0,1,0,1
,BTN,2016.0,38,0,38
COG,ZAF,2019.0,1,2,-1
IND,HKG,2007.0,1,3,-2
ITA,MUS,2010.0,1,1,0
BFA,ITA,2000.0,1,1,0
GHA,IND,2017.0,1,2,-1
ALB,DNK,2019.0,1,1,0
LVA,EST,2014.0,2,4,-2
ZAF,POL,2013.0,2,1,1
JPN,BLR,2017.0,1,1,0
BWA,NGA,2007.0,1,1,0
TZA,ETH,2019.0,2,2,0
HND,ESP,2017.0,1,2,-1
IDN,ISR,2016.0,1,1,0
QAT,PAK,2015.0,1,6,-5
GRC,MEX,2022.0,1,1,0
DOM,MEX,2021.0,1,7,-6
COL,PAN,2022.0,1,3,-2
IRL,TUN,2022.0,1,2,-1
ARE,ETH,2020.0,1,3,-2
MAR,DEU,2015.0,2,7,-5
TWN,BGD,2023.0,1,1,0
IDN,THA,2024.0,1,1,0
ZAF,SRB,2018.0,1,1,0
VNM,ITA,2003.0,1,1,0
KHM,JPN,2020.0,1,13,-12
PAK,HUN,2020.0,2,3,-1
TTO,IND,2020.0,2,1,1
ITA,UZB,2006.0,1,1,0
SAU,DNK,2006.0,2,1,1
CZE,KWT,1999.0,1,1,0
CRI,PAN,2014.0,1,2,-1
IRN,IRL,2003.0,1,7,-6
IND,BHR,2006.0,3,1,2
CHN,MYS,2004.0,1,6,-5
URY,PRT,2013.0,2,1,1
CHE,ARE,2019.0,1,2,-1
EGY,CHE,2000.0,1,1,0
BHS,GBR,2020.0,2,3,-1
VNM,IND,2019.0,5,6,-1
KWT,PAK,2023.0,1,1,0
DNK,NPL,2023.0,1,1,0
NGA,AUS,2001.0,1,5,-4
IRQ,LBN,2023.0,1,3,-2
HKG,PAK,2015.0,2,8,-6
GHA,ETH,2023.0,1,2,-1
ARG,PRT,2009.0,1,2,-1
ZAF,GMB,2009.0,1,2,-1
SVK,HRV,2019.0,1,2,-1
VNM,AUS,1999.0,4,1,3
DNK,SAU,2006.0,1,2,-1
HKG,SWE,2000.0,1,1,0
GBR,TTO,2014.0,3,4,-1
DEU,CIV,2023.0,1,1,0
DEU,KGZ,2010.0,1,1,0
TUR,ZAF,2005.0,1,1,0
BWA,ZWE,2011.0,1,1,0
SAU,NGA,2007.0,2,1,1
COL,AUS,2000.0,1,1,0
FIN,VNM,2011.0,1,1,0
EST,AUS,2002.0,1,1,0
ALB,USA,2014.0,2,5,-3
MWI,USA,2003.0,1,12,-11
IND,NGA,1997.0,1,3,-2
CHL,BEL,2003.0,1,1,0
CMR,CHE,2000.0,1,1,0
NLD,NPL,2010.0,1,1,0
BRN,USA,2001.0,1,3,-2
GBR,URY,2006.0,1,1,0
DEU,UGA,2009.0,1,1,0
GTM,DEU,2018.0,1,1,0
SVK,RUS,1997.0,1,8,-7
HKG,IRN,2015.0,1,5,-4
TUR,BHR,2014.0,1,1,0
BOL,ESP,2013.0,2,2,0
DEU,MNG,2004.0,1,1,0
OMN,IRL,2023.0,1,1,0
IND,MKD,2022.0,1,1,0
UZB,AUT,2014.0,1,1,0
USA,KGZ,2013.0,1,1,0
GTM,CRI,2013.0,1,1,0
CHL,URY,2003.0,1,1,0
ROU,IRQ,2014.0,1,1,0
IRL,NOR,2014.0,1,1,0
LTU,POL,2019.0,1,3,-2
CIV,NER,2019.0,1,1,0
PRT,JOR,2021.0,1,1,0
HND,NIC,2020.0,1,1,0
TWN,AUS,1997.0,3,3,0
TGO,FRA,1998.0,2,6,-4
FIN,GRC,1999.0,1,4,-3
NZL,PNG,2019.0,1,1,0
BWA,GBR,2000.0,1,5,-4
SVN,ESP,2006.0,1,3,-2
MDG,SEN,2000.0,1,1,0
CUB,SWE,1997.0,1,1,0
ZAF,IRL,2000.0,1,1,0
FJI,KOR,2020.0,1,1,0
CZE,ETH,2008.0,1,1,0
ESP,IRN,2008.0,2,4,-2
IRN,IND,2005.0,1,9,-8
FIN,SVN,2011.0,1,1,0
MEX,URY,2009.0,1,1,0
MRT,MLI,2019.0,1,2,-1
SGP,BRA,2012.0,1,2,-1
QAT,KWT,2016.0,1,4,-3
NPL,NOR,2004.0,1,1,0
NOR,NPL,2013.0,2,3,-1
GAB,MAR,2007.0,1,1,0
BEN,TZA,2015.0,1,2,-1
THA,FIN,2016.0,1,2,-1
HUN,IRL,2012.0,2,3,-1
UKR,CHE,2011.0,1,2,-1
CHL,IND,2009.0,1,3,-2
SWE,TWN,2010.0,1,2,-1
PHL,VNM,2014.0,1,2,-1
MAR,CHE,2020.0,1,3,-2
AUS,TZA,2023.0,2,2,0
IRL,GRC,2007.0,1,5,-4
MNG,KOR,2023.0,1,3,-2
EGY,PAK,2013.0,1,4,-3
EGY,ISR,2006.0,1,1,0
ITA,THA,2005.0,1,1,0
BFA,DEU,2004.0,2,1,1
BGR,UKR,2018.0,1,1,0
KOR,ITA,2004.0,1,4,-3
PER,GBR,2003.0,2,3,-1
BEL,SGP,2005.0,1,2,-1
LAO,KHM,2015.0,1,2,-1
PHL,CAN,2017.0,2,4,-2
HRV,AUS,1998.0,1,2,-1
AUS,DZA,2018.0,1,1,0
RWA,USA,2008.0,2,4,-2
SYC,ZAF,2013.0,1,1,0
ZWE,FRA,2012.0,2,1,1
USA,CUB,2015.0,1,9,-8
BRN,GBR,2007.0,1,3,-2
ROU,CHN,2013.0,1,1,0
CHN,OMN,2018.0,2,4,-2
IRQ,CAN,2015.0,1,1,0
VNM,HKG,2010.0,1,1,0
NZL,BGD,2017.0,2,5,-3
GAB,ZAF,2017.0,1,1,0
CIV,CHE,2014.0,1,1,0
POL,TUR,2019.0,2,4,-2
NLD,PHL,2013.0,1,5,-4
BWA,TZA,2010.0,1,1,0
CRI,COL,2017.0,1,2,-1
LUX,NOR,2021.0,1,3,-2
BLR,ESP,2022.0,1,1,0
BGD,TWN,2010.0,1,1,0
KEN,DNK,2019.0,1,3,-2
SGP,LKA,2021.0,1,1,0
KEN,GMB,2017.0,1,1,0
NGA,PAK,2022.0,1,7,-6
ETH,ESP,2020.0,3,4,-1
ESP,ETH,2022.0,1,3,-2
SVK,HUN,2008.0,1,2,-1
NOR,GHA,2009.0,2,1,1
LUX,GBR,2003.0,2,2,0
COL,PAN,2018.0,1,2,-1
CAN,SYR,2023.0,1,1,0
COG,ZWE,2017.0,1,1,0
MDA,FRA,2008.0,1,2,-1
IRN,HUN,2010.0,1,1,0
CAN,CRI,2007.0,1,3,-2
TWN,TUR,2003.0,1,4,-3
USA,SLE,2023.0,1,1,0
DZA,ESP,2001.0,1,1,0
NOR,JPN,2008.0,3,5,-2
LBN,LBY,2001.0,1,1,0
MKD,ARE,2016.0,1,1,0
TUN,EGY,2012.0,1,4,-3
CHL,RUS,2003.0,1,1,0
CHN,PHL,2005.0,2,2,0
BEN,NGA,2011.0,2,3,-1
QAT,KOR,2009.0,1,1,0
CHE,EGY,2008.0,4,1,3
MYS,ZAF,2011.0,1,3,-2
URY,DEU,2013.0,1,2,-1
NZL,HKG,2006.0,1,2,-1
IRN,ARM,2008.0,1,1,0
PER,PRT,2018.0,1,1,0
CZE,BGR,2021.0,1,1,0
CHE,UKR,2015.0,1,3,-2
WSM,NZL,2023.0,1,1,0
AFG,NLD,2021.0,1,2,-1
HUN,ZAF,2023.0,1,2,-1
AUS,VEN,2006.0,1,2,-1
GHA,JPN,2007.0,1,1,0
SYR,ITA,2005.0,1,1,0
USA,FJI,2003.0,3,1,2
CHN,PRI,1999.0,1,1,0
DNK,SGP,2004.0,1,1,0
CHE,EGY,2001.0,1,3,-2
VNM,TWN,2012.0,1,6,-5
DNK,CYP,2019.0,1,1,0
ITA,MEX,2000.0,1,3,-2
PRK,AUS,2011.0,1,1,0
KWT,CHN,2019.0,1,1,0
IND,FIN,2007.0,2,4,-2
GBR,BWA,2009.0,1,5,-4
PHL,NLD,2022.0,2,3,-1
MYS,TUR,2010.0,1,1,0
POL,ISR,2010.0,1,1,0
SVK,UKR,2014.0,1,4,-3
BEL,JOR,2014.0,2,1,1
CRI,SWE,2021.0,1,1,0
HKG,LKA,2013.0,1,1,0
CUB,QAT,2016.0,1,3,-2
ARE,NOR,2022.0,1,3,-2
CMR,ROU,2016.0,1,1,0
FRA,MOZ,2016.0,1,1,0
SDN,OMN,2020.0,1,1,0
ESP,THA,2014.0,2,1,1
IRN,ARM,2014.0,1,4,-3
SVN,RUS,2017.0,1,6,-5
TZA,KOR,2015.0,1,2,-1
EGY,SDN,2017.0,1,1,0
SGP,KAZ,2020.0,1,3,-2
HRV,BEL,2019.0,1,4,-3
MWI,AUS,2017.0,1,1,0
HKG,PAK,2014.0,1,2,-1
MYS,ITA,2019.0,1,3,-2
DEU,VNM,2004.0,1,2,-1
BGD,ITA,2016.0,1,10,-9
BIH,CZE,2014.0,1,1,0
POL,EGY,2022.0,1,2,-1
CRI,BRA,2021.0,2,6,-4
AUS,MNG,2020.0,1,1,0
CHE,PHL,2019.0,1,6,-5
PAK,EGY,2011.0,1,2,-1
CAN,JAM,2016.0,2,4,-2
EST,ISR,2021.0,1,1,0
MUS,ZAF,2020.0,1,4,-3
ARE,HUN,2021.0,1,5,-4
SGP,ROU,2023.0,1,1,0
KAZ,CHN,2016.0,1,3,-2
CHE,GHA,2002.0,2,3,-1
ETH,LKA,2010.0,1,1,0
KEN,IND,2009.0,2,1,1
EST,AUS,1997.0,1,1,0
PRT,VEN,2009.0,2,2,0
LKA,FRA,2001.0,1,1,0
JAM,TTO,2005.0,2,1,1
LBN,DEU,2003.0,2,2,0
SEN,GUF,2001.0,1,1,0
SWE,MOZ,2002.0,1,1,0
QAT,SAU,2005.0,1,1,0
BEN,GBR,2005.0,1,2,-1
MKD,GRC,2016.0,1,4,-3
BEL,NZL,2009.0,1,2,-1
USA,CMR,2004.0,2,5,-3
TUN,CAN,2002.0,1,6,-5
HUN,EGY,1997.0,1,2,-1
ESP,GEO,1998.0,1,1,0
MEX,SLV,2022.0,1,1,0
HUN,ESP,1997.0,1,1,0
KWT,CAN,2003.0,1,3,-2
NLD,BFA,1997.0,1,1,0
AUT,BRA,1999.0,1,2,-1
SDN,DEU,2003.0,1,3,-2
NOR,BGR,2002.0,1,1,0
KWT,OMN,2012.0,1,1,0
GBR,YEM,2017.0,1,3,-2
ETH,AUT,2009.0,1,3,-2
MWI,NOR,2009.0,1,1,0
AUS,SVK,2008.0,1,3,-2
MWI,KEN,2014.0,1,1,0
FIN,CHL,2013.0,1,3,-2
LTU,KAZ,2020.0,1,1,0
ZMB,DEU,2023.0,1,3,-2
GRC,ZAF,2012.0,1,2,-1
HKG,ITA,2007.0,1,1,0
ITA,LVA,2020.0,1,1,0
MLT,ITA,2015.0,2,2,0
MWI,DEU,2016.0,2,3,-1
ZAF,NER,2016.0,1,1,0
UGA,ZWE,2016.0,1,2,-1
BLR,ITA,2016.0,1,3,-2
CHE,SVK,2018.0,2,8,-6
EST,LVA,2013.0,1,3,-2
NZL,PRT,2021.0,3,3,0
JOR,FIN,2010.0,1,1,0
CHN,TZA,2013.0,1,1,0
SRB,IRN,2016.0,1,1,0
VEN,CUB,2019.0,1,1,0
PAK,SGP,2010.0,1,1,0
BIH,MKD,2018.0,2,1,1
NZL,BGD,2018.0,1,2,-1
THA,ISR,2020.0,1,1,0
TTO,BRB,2017.0,1,2,-1
MAR,DEU,2014.0,1,4,-3
SGP,CHE,1998.0,1,3,-2
SVN,FIN,2016.0,1,1,0
SWE,ECU,2021.0,1,1,0
ISR,EGY,2011.0,1,1,0
MLI,KEN,2014.0,1,1,0
YEM,SDN,2020.0,1,1,0
ARG,CUB,2010.0,1,3,-2
IRL,TUR,2009.0,1,1,0
BHS,USA,2023.0,1,2,-1
GRC,POL,2015.0,1,1,0
PER,NZL,2022.0,1,1,0
PER,BRA,2006.0,1,6,-5
BEL,BGD,2001.0,1,5,-4
LKA,NOR,2021.0,1,3,-2
AZE,USA,2023.0,1,4,-3
ERI,USA,2006.0,1,1,0
LUX,TWN,2022.0,1,1,0
OMN,BGD,2022.0,2,1,1
ROU,KOR,2021.0,1,1,0
GRC,AUS,2005.0,1,1,0
GRC,ISL,2010.0,1,1,0
SDN,USA,2011.0,2,1,1
USA,UZB,2001.0,1,6,-5
GRL,DNK,2000.0,1,1,0
ARE,ESP,2004.0,1,1,0
ISR,UKR,2009.0,1,2,-1
ARE,POL,2022.0,1,3,-2
BGR,CHE,2017.0,1,3,-2
USA,BOL,2003.0,1,8,-7
BEL,EST,2004.0,1,1,0
DNK,MEX,2005.0,1,4,-3
CMR,NER,1998.0,1,1,0
UKR,PRT,2004.0,1,1,0
ITA,KOR,2005.0,1,7,-6
ESP,SRB,1999.0,1,5,-4
TUR,ROU,2002.0,1,4,-3
GBR,BOL,2010.0,1,2,-1
LKA,NLD,1997.0,1,1,0
SRB,JPN,2014.0,2,1,1
KHM,NLD,2019.0,1,1,0
JOR,NLD,2020.0,1,1,0
ROU,RUS,2012.0,1,1,0
CHL,ZAF,2013.0,1,2,-1
NGA,BEN,2016.0,1,3,-2
PRY,USA,2013.0,1,1,0
BWA,ZWE,2009.0,1,1,0
ITA,KEN,2010.0,1,1,0
TGO,FRA,2007.0,1,5,-4
KGZ,JPN,2016.0,1,1,0
DZA,BRA,2021.0,1,1,0
LUX,ESP,2023.0,1,5,-4
CYP,THA,2020.0,1,1,0
THA,KAZ,2021.0,1,1,0
GEO,GBR,2010.0,1,1,0
ARE,KOR,2016.0,3,10,-7
BEN,FRA,2000.0,1,2,-1
PRT,DNK,2003.0,1,2,-1
BGR,GRC,1998.0,2,1,1
BEL,BOL,2002.0,1,1,0
TWN,ISR,2012.0,1,1,0
COL,ZAF,2004.0,1,3,-2
USA,SEN,2008.0,2,3,-1
MAR,DEU,2008.0,1,2,-1
IDN,KEN,2019.0,1,2,-1
ITA,BLR,2002.0,1,5,-4
CAN,BGD,2003.0,1,6,-5
TZA,BEL,2012.0,1,2,-1
PRT,PRI,2008.0,1,1,0
LTU,CHN,2012.0,1,1,0
ESP,THA,2015.0,2,4,-2
NGA,KEN,2015.0,1,3,-2
ARE,AUT,2019.0,1,3,-2
TUR,UKR,2014.0,2,3,-1
BGR,TUR,2010.0,1,1,0
CIV,BEL,2014.0,1,5,-4
GRC,IRN,2022.0,1,1,0
SVN,BEL,2021.0,1,3,-2
CHE,NGA,2018.0,1,9,-8
DZA,ITA,2011.0,1,5,-4
ZAF,SGP,2016.0,2,4,-2
TUR,VNM,2023.0,1,3,-2
SWE,ROU,2023.0,1,1,0
IND,BHR,2000.0,1,1,0
MYS,PRT,2020.0,1,1,0
ASM,USA,2003.0,1,1,0
ARE,SWE,2007.0,1,3,-2
NLD,ARG,1997.0,1,4,-3
RUS,BGR,2012.0,1,2,-1
BRN,CHN,2014.0,1,1,0
CHL,CHE,2005.0,1,6,-5
FRA,LKA,2021.0,1,2,-1
IRL,BHR,2017.0,1,2,-1
TUN,GRC,2014.0,1,1,0
MUS,GBR,2019.0,1,4,-3
MAC,IRL,2014.0,1,1,0
MEX,CRI,2022.0,1,7,-6
GHA,KOR,2022.0,1,4,-3
BRA,EGY,2014.0,1,1,0
TZA,MYS,2014.0,1,1,0
SWE,SRB,2015.0,1,3,-2
HKG,NLD,2024.0,1,1,0
ESP,COG,2019.0,1,1,0
VNM,LAO,2017.0,1,2,-1
BGR,IRL,2019.0,1,2,-1
HUN,ISR,2022.0,1,1,0
SVN,IRN,2021.0,1,1,0
SGP,TUR,2018.0,1,6,-5
POL,IDN,2020.0,1,3,-2
GRC,ALB,2021.0,1,1,0
ISR,ETH,2015.0,1,1,0
DEU,MYS,2000.0,1,1,0
NZL,SGP,2023.0,1,11,-10
HRV,IND,2021.0,1,2,-1
GHA,FIN,2020.0,1,4,-3
BFA,SEN,2023.0,1,1,0
EGY,BEL,2003.0,1,2,-1
LKA,AUS,1998.0,1,4,-3
MLI,MAR,2015.0,1,4,-3
MLT,GRC,2013.0,1,1,0
URY,DEU,2003.0,2,4,-2
TZA,NGA,2010.0,1,1,0
BLR,PRT,2000.0,1,1,0
SYR,IND,2020.0,1,3,-2
CHN,ZAF,2004.0,2,1,1
NLD,BOL,2009.0,1,2,-1
LBN,JOR,2008.0,1,1,0
KOR,ISR,2010.0,1,3,-2
MNG,AUT,2016.0,1,1,0
SWE,LBN,2019.0,1,5,-4
GHA,NOR,2014.0,1,2,-1
ETH,BWA,2020.0,1,1,0
ESP,PAN,2001.0,1,1,0
NLD,ZMB,2016.0,1,1,0
TJK,IRN,2013.0,1,1,0
QAT,CHN,2014.0,1,1,0
DNK,KOR,2004.0,1,2,-1
FRA,PRI,2016.0,1,1,0
PSE,MYS,2014.0,2,5,-3
GAB,COD,2018.0,1,1,0
SGP,MEX,2019.0,1,1,0
NPL,DEU,2023.0,1,2,-1
CYM,USA,2019.0,3,3,0
JPN,ARG,2019.0,1,3,-2
TGO,GHA,2018.0,1,1,0
QAT,ZAF,2019.0,1,1,0
ETH,NGA,2018.0,1,2,-1
SEN,MDG,2012.0,1,1,0
ESP,SVN,2007.0,1,1,0
PAK,DNK,2008.0,1,1,0
AUS,ISL,2001.0,1,1,0
LVA,EST,2015.0,1,9,-8
PER,COL,2003.0,1,2,-1
CHE,PER,2001.0,1,1,0
MAR,TUN,2007.0,1,1,0
FIN,ZAF,2010.0,1,1,0
CUB,FRA,2009.0,1,2,-1
KEN,IND,2011.0,1,2,-1
JPN,GHA,2005.0,1,4,-3
BFA,DEU,2014.0,1,2,-1
CMR,DNK,2010.0,1,1,0
CHN,LKA,2018.0,1,1,0
COG,TZA,2019.0,1,1,0
GTM,BRA,2016.0,1,1,0
MWI,DEU,2018.0,1,3,-2
KEN,KOR,2018.0,1,3,-2
MEX,DOM,2018.0,1,1,0
ARE,ESP,2015.0,2,10,-8
SAU,SGP,2007.0,1,2,-1
NER,NGA,1998.0,1,3,-2
KOR,POL,2003.0,1,3,-2
KEN,GMB,2018.0,1,1,0
GHA,HKG,2017.0,1,1,0
NOR,BGD,2022.0,1,3,-2
DZA,FIN,2021.0,1,1,0
SVK,UKR,2008.0,1,2,-1
GBR,CRI,2020.0,1,5,-4
ITA,ARM,2017.0,1,1,0
CHN,IND,2005.0,3,14,-11
GNB,DNK,2005.0,1,7,-6
BEN,DEU,2004.0,1,1,0
FRA,OMN,2001.0,1,1,0
TZA,ZAF,2002.0,1,1,0
PER,AUT,2011.0,1,1,0
POL,ISR,2000.0,1,1,0
SGP,ITA,1998.0,1,1,0
JPN,DZA,2008.0,1,1,0
BIH,HRV,2003.0,1,18,-17
BGD,DNK,2003.0,1,1,0
BLR,BEL,2016.0,1,2,-1
SAU,NGA,1999.0,1,1,0
IRL,HKG,2016.0,1,2,-1
ESP,HKG,2007.0,1,2,-1
MLI,CIV,2016.0,1,2,-1
SEN,MLI,2009.0,1,2,-1
CMR,AUS,2013.0,1,1,0
SRB,TUR,2010.0,1,2,-1
THA,HKG,2009.0,1,1,0
MEX,KOR,2022.0,1,2,-1
PHL,DNK,2015.0,1,2,-1
AUS,BGD,1998.0,1,2,-1
DNK,TWN,2019.0,1,3,-2
AUS,MAC,2019.0,1,5,-4
IRL,PAK,2011.0,1,2,-1
PRY,FRA,2017.0,1,1,0
EGY,AZE,2014.0,1,1,0
TUN,TUR,2020.0,1,2,-1
BRA,DNK,1997.0,1,3,-2
QAT,KOR,2019.0,1,3,-2
CHN,PSE,2019.0,1,1,0
ESP,EST,2015.0,1,3,-2
TUR,DNK,2000.0,1,1,0
GUY,USA,2016.0,1,1,0
ISR,IRN,2014.0,1,1,0
QAT,FRA,2012.0,1,13,-12
COG,NGA,2015.0,1,1,0
HND,BRA,2020.0,1,3,-2
NOR,UKR,2020.0,1,3,-2
CRI,NOR,2020.0,1,1,0
RWA,ZAF,2022.0,1,3,-2
ARE,ZAF,2021.0,1,10,-9
VAT,USA,2018.0,1,4,-3
LKA,BRA,2020.0,1,1,0
NER,NGA,1999.0,1,2,-1
FRA,PAK,2002.0,1,2,-1
JPN,SVK,2008.0,1,2,-1
COL,ITA,1997.0,1,1,0
COL,NGA,2010.0,1,2,-1
GBR,COG,2009.0,1,2,-1
CHE,LVA,2008.0,1,1,0
NER,CMR,1998.0,1,1,0
USA,BLZ,2014.0,2,2,0
AUS,SRB,2016.0,1,2,-1
NLD,SVK,2022.0,1,6,-5
LVA,CHE,2008.0,1,1,0
ZAF,JPN,2007.0,1,5,-4
BRA,BGR,2009.0,1,1,0
GBR,CUB,2003.0,1,3,-2
GRC,IND,2000.0,1,1,0
BGR,BEL,2007.0,1,3,-2
UGA,NLD,2003.0,1,1,0
CAN,NPL,2014.0,1,1,0
PHL,KHM,2016.0,1,1,0
TZA,IND,2010.0,1,3,-2
SWE,NIC,2009.0,1,1,0
KOR,PRK,2009.0,1,4,-3
KEN,DNK,2009.0,1,1,0
NOR,GRC,2023.0,1,4,-3
NAM,GBR,2018.0,1,4,-3
BRA,NZL,2008.0,1,3,-2
DZA,ITA,2009.0,1,2,-1
ISL,GRC,2010.0,1,1,0
ISL,IRN,2012.0,1,1,0
FRA,SYC,2011.0,1,1,0
COL,BOL,2023.0,1,1,0
UKR,ESP,2019.0,1,3,-2
FRA,NPL,2022.0,1,4,-3
BFA,BEN,2021.0,1,1,0
CIV,TUN,2016.0,1,1,0
NLD,VNM,2001.0,1,2,-1
MEX,BOL,2000.0,1,1,0
GTM,ARG,2021.0,1,1,0
DEU,MWI,2006.0,1,1,0
HKG,IRL,2023.0,1,2,-1
JOR,DZA,2020.0,3,1,2
HUN,QAT,2019.0,2,2,0
OMN,BGD,2017.0,1,1,0
NER,DEU,1999.0,1,1,0
NZL,IRL,2003.0,2,5,-3
PRI,COL,2005.0,1,4,-3
LKA,DNK,2010.0,1,1,0
SEN,CHE,2008.0,1,1,0
JPN,GHA,2002.0,3,2,1
MYS,OMN,2004.0,1,1,0
NLD,EST,2000.0,1,2,-1
GBR,TUN,2016.0,1,4,-3
ZAF,GMB,2019.0,3,1,2
ESP,TUN,2001.0,2,1,1
NLD,UGA,2003.0,1,1,0
CUB,COL,1999.0,1,1,0
THA,PHL,2010.0,1,3,-2
BEL,KOR,2007.0,3,3,0
DZA,CAN,2011.0,4,4,0
ISR,ARE,2015.0,1,1,0
ARG,URY,2010.0,2,4,-2
CYP,TZA,2023.0,1,1,0
ZAF,ISR,2004.0,1,2,-1
SVK,HRV,2011.0,2,1,1
BFA,BEL,2020.0,1,4,-3
GNB,PRT,2015.0,2,1,1
NZL,COL,2020.0,1,1,0
TGO,SEN,2020.0,1,4,-3
MYS,SWE,2018.0,2,6,-4
MLT,GBR,2007.0,1,1,0
SVN,CZE,2003.0,2,2,0
ARE,MLT,2017.0,1,1,0
IRN,TUR,2008.0,1,4,-3
ECU,DEU,2016.0,1,9,-8
EGY,DNK,2022.0,1,5,-4
FRA,TTO,2016.0,1,1,0
CIV,BEL,2008.0,1,4,-3
FIN,YEM,2022.0,1,1,0
DEU,BOL,2015.0,1,3,-2
NZL,EGY,2022.0,1,2,-1
GBR,TUN,2017.0,1,4,-3
VNM,LAO,2018.0,2,1,1
PRY,ESP,2006.0,1,1,0
CRI,ARG,2016.0,1,1,0
IRL,PHL,2021.0,1,1,0
NZL,IRQ,2021.0,1,1,0
GBR,URY,2000.0,1,2,-1
MRT,SAU,2021.0,1,3,-2
SLV,MEX,2023.0,1,1,0
JPN,SYR,1999.0,1,1,0
COL,ITA,2005.0,2,2,0
AUT,ARG,2016.0,1,3,-2
SEN,CMR,2012.0,1,1,0
HTI,FRA,2021.0,1,3,-2
USA,GMB,2012.0,1,1,0
FIN,ROU,2022.0,1,1,0
IRN,EGY,2014.0,2,2,0
TUN,KOR,2017.0,1,2,-1
HUN,GHA,2020.0,1,1,0
MKD,USA,2023.0,1,2,-1
MEX,BEL,1998.0,1,4,-3
SWE,ZWE,1998.0,1,2,-1
JAM,GRD,2016.0,1,1,0
GBR,BHS,2018.0,1,1,0
NER,IND,2017.0,1,1,0
SVN,PAK,2020.0,1,1,0
SVN,POL,2010.0,2,1,1
CHL,DNK,2007.0,1,1,0
JPN,CHL,2003.0,1,2,-1
MUS,USA,2022.0,1,2,-1
PRY,ECU,2021.0,1,1,0
VNM,NLD,2013.0,1,9,-8
SVK,PRT,2017.0,1,1,0
AFG,PAK,2020.0,1,1,0
CYP,AUS,2013.0,1,2,-1
TWN,GHA,2021.0,1,1,0
IRN,NOR,2007.0,1,3,-2
NLD,CYP,2015.0,1,1,0
ECU,PER,2014.0,1,1,0
NOR,NGA,2022.0,1,4,-3
USA,AGO,2017.0,1,1,0
DNK,ROU,2021.0,1,1,0
COL,NOR,2014.0,1,1,0
CZE,CHN,2013.0,1,2,-1
MAR,DZA,1998.0,1,1,0
CYP,POL,2015.0,1,1,0
IRL,RUS,2022.0,1,16,-15
ZWE,AUS,2014.0,1,3,-2
SWE,MEX,2010.0,1,3,-2
AUS,BWA,2001.0,1,3,-2
CHL,TWN,2021.0,1,5,-4
BEN,DEU,2015.0,1,1,0
JAM,BRB,2014.0,1,1,0
FRA,OMN,2004.0,1,1,0
BRA,PAN,2010.0,1,2,-1
MEX,UKR,2007.0,1,2,-1
ETH,LAO,2011.0,1,1,0
ZMB,NOR,2008.0,1,2,-1
EGY,FIN,2015.0,1,6,-5
USA,BRB,2008.0,1,1,0
IDN,CAN,2006.0,1,1,0
MLI,ZAF,2013.0,1,1,0
CAN,LCA,2001.0,1,0,1
FIN,EGY,2001.0,1,0,1
FRA,SPM,2001.0,1,0,1
ZAF,COD,2000.0,1,0,1
RUS,ARG,2007.0,1,0,1
ARG,IRL,2008.0,1,0,1
NOR,NPL,2003.0,2,0,2
,LCA,1999.0,1,0,1
MUS,ITA,2009.0,1,0,1
PAK,SGP,2000.0,1,0,1
REU,,2008.0,5,0,5
GMB,BEL,2010.0,1,0,1
PYF,POL,2002.0,1,0,1
TUR,KEN,1999.0,1,0,1
ARM,AUS,2017.0,1,0,1
NLD,TWN,2004.0,1,0,1
AUS,MNG,2007.0,1,0,1
AUS,MKD,2014.0,1,0,1
PSE,PAN,2016.0,1,0,1
IND,CUB,2022.0,1,0,1
NIC,PRI,2011.0,1,0,1
TLS,COD,2019.0,1,0,1
MYS,BRA,2012.0,1,0,1
PRT,YEM,2015.0,1,0,1
MYS,ECU,2020.0,2,0,2
ITA,NPL,2001.0,1,0,1
DEU,MRT,2015.0,1,0,1
UKR,SVN,2011.0,1,0,1
KOR,KEN,2023.0,1,0,1
HUN,IDN,2016.0,1,0,1
EST,HUN,2013.0,1,0,1
UKR,LUX,2020.0,1,0,1
BGR,ISL,2022.0,1,0,1
ITA,ARM,2018.0,1,0,1
LTU,AUS,2004.0,1,0,1
POL,EGY,2018.0,1,0,1
CYP,AUT,2016.0,1,0,1
IRL,ROU,2015.0,2,0,2
DNK,GHA,2015.0,2,0,2
CHE,CHN,2024.0,1,0,1
USA,SUR,2009.0,1,0,1
LTU,CHL,2022.0,1,0,1
JOR,UKR,2019.0,1,0,1
BGR,CZE,2019.0,1,0,1
ARE,LVA,2022.0,1,0,1
CHE,PAK,2012.0,1,0,1
MLI,AUS,2021.0,1,0,1
PSE,KOR,2020.0,1,0,1
GUM,,2012.0,1,0,1
ALB,SWE,2023.0,2,0,2
JPN,JOR,2004.0,1,0,1
MYS,TTO,2008.0,1,0,1
SAU,PHL,2002.0,1,0,1
BWA,SWZ,2001.0,1,0,1
GRL,,2005.0,1,0,1
CUB,BOL,2018.0,1,0,1
JPN,GTM,2003.0,1,0,1
CUB,JPN,2001.0,1,0,1
USA,SYC,2006.0,1,0,1
CAN,ZMB,2012.0,2,0,2
MDV,CAN,2015.0,1,0,1
CPV,SAU,2010.0,1,0,1
MEX,HRV,2003.0,1,0,1
COL,ARE,2021.0,2,0,2
GMB,TZA,2009.0,1,0,1
ARG,AUT,2007.0,2,0,2
NLD,AFG,2016.0,1,0,1
KEN,PAK,2005.0,1,0,1
KOR,CZE,2004.0,1,0,1
CHE,OMN,2002.0,1,0,1
GBR,MCO,2013.0,2,0,2
TUR,HKG,2023.0,1,0,1
CZE,GTM,2021.0,1,0,1
CMR,TZA,2023.0,1,0,1
LUX,TUN,2021.0,1,0,1
NZL,PSE,2020.0,1,0,1
IND,BIH,2023.0,1,0,1
YEM,IRQ,2023.0,1,0,1
PAN,CUB,2023.0,1,0,1
JPN,PAN,2013.0,1,0,1
NAM,KEN,2018.0,1,0,1
UKR,SGP,2003.0,2,0,2
MYS,CHE,2009.0,1,0,1
TWN,NLD,1998.0,1,0,1
EST,HRV,2005.0,1,0,1
SWE,IRQ,2010.0,1,0,1
COL,NZL,2002.0,1,0,1
CAN,GUY,2019.0,1,0,1
CIV,GHA,2004.0,1,0,1
ISL,FRA,2004.0,1,0,1
NLD,MAR,1997.0,1,0,1
GLP,,2004.0,2,0,2
OMN,DZA,2014.0,1,0,1
GBR,LBY,1999.0,1,0,1
RWA,HKG,2019.0,1,0,1
POL,PAN,2008.0,1,0,1
PAN,POL,2009.0,1,0,1
SVN,HUN,1998.0,2,0,2
PER,BOL,2000.0,1,0,1
MDA,FRA,2004.0,1,0,1
PHL,NZL,2014.0,2,0,2
CHE,UGA,2005.0,1,0,1
BGD,UZB,2003.0,1,0,1
DOM,MEX,2009.0,1,0,1
BHR,NLD,1998.0,1,0,1
GMB,FRA,2008.0,1,0,1
ZAF,ARE,1997.0,1,0,1
BGR,MEX,2007.0,1,0,1
ESP,EST,2001.0,1,0,1
VAT,ITA,2023.0,1,0,1
TWN,PHL,2005.0,1,0,1
BRA,IRL,2005.0,1,0,1
TWN,ARG,2010.0,1,0,1
ARG,TWN,2011.0,1,0,1
PAN,BRA,2009.0,1,0,1
TGO,GBR,2017.0,1,0,1
VEN,DOM,2020.0,3,0,3
TUR,BHR,2008.0,1,0,1
SWE,OMN,2009.0,1,0,1
IRL,JOR,1999.0,1,0,1
TKM,CHN,2020.0,1,0,1
ECU,CZE,2023.0,1,0,1
ROU,LUX,2015.0,1,0,1
CYP,JPN,2015.0,1,0,1
EST,KAZ,2014.0,1,0,1
RUS,CIV,2010.0,1,0,1
ESP,AGO,2014.0,1,0,1
TUR,MWI,2020.0,1,0,1
HKG,PSE,2019.0,1,0,1
EGY,KOR,2004.0,1,0,1
ISR,VNM,2018.0,1,0,1
SVK,MEX,2015.0,1,0,1
ZAF,COL,2003.0,2,0,2
ARM,SWE,2020.0,1,0,1
POL,THA,2016.0,1,0,1
PSE,HUN,2019.0,1,0,1
GHA,PAK,2020.0,1,0,1
BOL,NOR,2018.0,1,0,1
SYR,ESP,2018.0,1,0,1
HRV,PRT,2022.0,1,0,1
ABW,NLD,2015.0,2,0,2
CHE,LBR,2013.0,2,0,2
RUS,YEM,2017.0,1,0,1
ZAF,GHA,1998.0,1,0,1
IND,HUN,2002.0,1,0,1
PAK,KWT,2014.0,1,0,1
UKR,SVN,2021.0,3,0,3
SUR,USA,2019.0,1,0,1
USA,SUR,2021.0,1,0,1
CHL,AUT,2007.0,1,0,1
CMR,EGY,2022.0,1,0,1
AUT,UZB,2022.0,1,0,1
DEU,THA,2024.0,1,0,1
COL,LTU,2022.0,1,0,1
DNK,JOR,2021.0,1,0,1
ATG,GBR,2022.0,1,0,1
KGZ,PAK,2021.0,1,0,1
MYS,LTU,2022.0,1,0,1
DOM,ECU,2022.0,1,0,1
MOZ,ITA,2023.0,1,0,1
ESP,YEM,2023.0,1,0,1
CUB,JAM,2021.0,1,0,1
ZMB,JPN,2000.0,1,0,1
NPL,GRC,1998.0,1,0,1
SRB,LBN,2002.0,1,0,1
ALB,SWE,2024.0,1,0,1
SVK,KAZ,2010.0,1,0,1
SEN,IND,2006.0,1,0,1
SAU,SGP,1998.0,1,0,1
ECU,POL,2006.0,1,0,1
HUN,BRA,2005.0,1,0,1
EGY,TUN,2006.0,1,0,1
GAB,IND,2012.0,1,0,1
UZB,KGZ,2019.0,1,0,1
POL,BWA,2012.0,1,0,1
BWA,POL,2014.0,1,0,1
GRC,CRI,2002.0,1,0,1
CHN,ROU,2006.0,1,0,1
SLE,CHN,2001.0,1,0,1
NLD,GAB,2009.0,1,0,1
SEN,SWE,2013.0,1,0,1
IRQ,YEM,2019.0,1,0,1
BIH,CZE,2008.0,1,0,1
FRA,VUT,2005.0,1,0,1
ECU,TUN,2004.0,1,0,1
IDN,ZWE,1999.0,1,0,1
UZB,ITA,2002.0,1,0,1
POL,ARM,1999.0,1,0,1
IND,BEN,2012.0,1,0,1
GTM,CHE,2001.0,1,0,1
NZL,QAT,2000.0,1,0,1
KNA,POL,2023.0,1,0,1
LTU,NLD,1998.0,1,0,1
NLD,SUR,2002.0,1,0,1
MYS,LBY,2005.0,1,0,1
RUS,ISL,2012.0,1,0,1
UKR,HUN,2005.0,1,0,1
ETH,AUS,1998.0,1,0,1
ZAF,ZMB,1997.0,1,0,1
ITA,SAU,1997.0,1,0,1
EST,NOR,2011.0,1,0,1
BDI,ITA,1998.0,1,0,1
MLI,COL,2010.0,1,0,1
CMR,CAN,2002.0,1,0,1
DMA,USA,2008.0,1,0,1
TZA,BFA,2016.0,1,0,1
IRN,TUR,2004.0,1,0,1
ESP,TWN,2009.0,2,0,2
DMA,,2010.0,1,0,1
MDA,DNK,2008.0,1,0,1
COG,BWA,2014.0,1,0,1
VEN,URY,2010.0,1,0,1
IRL,COL,2010.0,1,0,1
SRB,POL,2010.0,1,0,1
NZL,GRC,2006.0,1,0,1
BIH,ARE,2022.0,1,0,1
ZWE,POL,2023.0,1,0,1
BGD,RUS,2022.0,1,0,1
BLR,FIN,2020.0,1,0,1
JOR,PRT,2023.0,1,0,1
CAF,FRA,2022.0,1,0,1
USA,,1998.0,1,0,1
URY,NGA,2015.0,1,0,1
NZL,SLB,2009.0,1,0,1
IRL,URY,2004.0,1,0,1
AUS,RWA,1997.0,2,0,2
JAM,MOZ,1997.0,1,0,1
UKR,IRL,2007.0,1,0,1
LBY,MAR,2019.0,1,0,1
LBR,,2002.0,1,0,1
CYP,CHE,2002.0,1,0,1
BRB,IRL,2002.0,1,0,1
RWA,BWA,2021.0,1,0,1
IRL,NGA,2017.0,1,0,1
DNK,SRB,2017.0,1,0,1
GUM,AUS,2013.0,1,0,1
NGA,GUY,2013.0,1,0,1
NLD,MLT,2016.0,1,0,1
TTO,DMA,2017.0,1,0,1
TWN,FJI,2020.0,1,0,1
ARG,SAU,2009.0,1,0,1
MAR,BFA,2018.0,1,0,1
ETH,POL,2011.0,1,0,1
HKG,VNM,2011.0,1,0,1
AZE,FRA,2016.0,1,0,1
IRN,AFG,2016.0,2,0,2
NZL,NGA,2015.0,1,0,1
BEL,MLI,2014.0,1,0,1
ARE,KAZ,2015.0,1,0,1
TCD,NOR,2017.0,1,0,1
GHA,COG,2019.0,1,0,1
CMR,ESP,2023.0,1,0,1
FJI,LKA,2017.0,1,0,1
VEN,NZL,2016.0,1,0,1
RWA,TUR,2019.0,1,0,1
IDN,NAM,2020.0,1,0,1
ITA,MAR,2017.0,1,0,1
ESP,BLR,2021.0,1,0,1
COL,EST,2018.0,1,0,1
IDN,ARE,2017.0,2,0,2
TUN,BGD,2021.0,1,0,1
DMA,VCT,2020.0,1,0,1
,AIA,2014.0,4,0,4
NZL,PRY,2018.0,1,0,1
NGA,VNM,2018.0,1,0,1
KOR,RWA,2017.0,2,0,2
USA,LAO,2023.0,2,0,2
NZL,KAZ,2021.0,1,0,1
RUS,KEN,2021.0,1,0,1
MYS,DZA,2007.0,1,0,1
ITA,KAZ,2005.0,2,0,2
ESP,LSO,2017.0,1,0,1
CHL,AGO,2020.0,1,0,1
ETH,IRQ,2019.0,3,0,3
CYP,BFA,2020.0,2,0,2
DNK,SDN,2001.0,1,0,1
ETH,ITA,2009.0,1,0,1
BFA,NER,2005.0,1,0,1
LKA,PRT,2004.0,1,0,1
FRA,ETH,2007.0,1,0,1
MAR,MLI,2014.0,1,0,1
BGR,SWE,2020.0,1,0,1
MNE,AUT,2020.0,1,0,1
CHN,CZE,2007.0,1,0,1
POL,ROU,2005.0,1,0,1
GRC,TWN,2003.0,1,0,1
KEN,MNG,2005.0,1,0,1
CUB,TZA,2018.0,1,0,1
BLR,CHE,2001.0,1,0,1
IRL,SRB,2010.0,1,0,1
PNG,IND,2012.0,1,0,1
COL,URY,2006.0,1,0,1
CAN,CPV,2010.0,1,0,1
GRC,KEN,2004.0,1,0,1
ZWE,EGY,2004.0,1,0,1
MYS,ZAF,2009.0,1,0,1
CMR,UGA,1999.0,1,0,1
LBN,KWT,2007.0,1,0,1
FJI,PRT,2014.0,1,0,1
IDN,PER,2002.0,1,0,1
BRN,BFA,2020.0,1,0,1
AUT,OMN,2011.0,1,0,1
FIN,LBN,2004.0,1,0,1
TZA,CAN,2023.0,2,0,2
NIC,NLD,2021.0,1,0,1
AUS,ISL,2008.0,1,0,1
BGR,KOR,2013.0,1,0,1
NOR,AFG,2007.0,1,0,1
SLE,NLD,2021.0,3,0,3
CUB,ZAF,2012.0,1,0,1
DZA,SWE,2022.0,2,0,2
TUN,CMR,2016.0,1,0,1
POL,MNG,2022.0,1,0,1
NOR,MAR,2021.0,1,0,1
IRQ,BWA,2019.0,3,0,3
BLZ,USA,2023.0,1,0,1
BWA,MWI,2021.0,1,0,1
BEN,CHE,2022.0,1,0,1
VNM,SGP,2004.0,1,0,1
MAC,PRT,2000.0,1,0,1
SRB,TWN,1997.0,1,0,1
ETH,SAU,2014.0,1,0,1
COL,TUR,2023.0,1,0,1
BRB,TTO,2000.0,1,0,1
ARE,BRA,2002.0,1,0,1
SYR,SDN,2000.0,1,0,1
KGZ,ISR,2000.0,1,0,1
USA,BDI,2005.0,1,0,1
VNM,UGA,2019.0,1,0,1
,FRO,1999.0,1,0,1
NLD,BHR,2011.0,1,0,1
USA,FLK,2012.0,1,0,1
ZAF,PYF,2016.0,1,0,1
SWE,CYP,2013.0,2,0,2
FIN,QAT,2010.0,1,0,1
AUS,TZA,2006.0,1,0,1
PER,DNK,2013.0,1,0,1
USA,ERI,2014.0,1,0,1
GHA,NZL,2011.0,1,0,1
GHA,TZA,2012.0,1,0,1
HKG,KWT,2007.0,1,0,1
GBR,MDV,2015.0,1,0,1
FRA,NPL,2016.0,1,0,1
NAM,JPN,2018.0,1,0,1
HRV,ISR,2014.0,1,0,1
ISR,HRV,2021.0,2,0,2
GIB,ESP,2017.0,1,0,1
CHE,NGA,2016.0,2,0,2
SEN,MAR,2015.0,1,0,1
MCO,MYS,2016.0,1,0,1
FRA,MOZ,2018.0,1,0,1
BFA,KEN,2013.0,1,0,1
GBR,BHS,2017.0,1,0,1
IRQ,CHE,2022.0,1,0,1
HKG,FJI,2019.0,1,0,1
GHA,IRL,2016.0,1,0,1
SWE,TTO,2023.0,1,0,1
CHE,NLD,2024.0,1,0,1
ROU,MCO,2017.0,1,0,1
CZE,AZE,2021.0,1,0,1
LAO,VNM,2013.0,2,0,2
TUN,IND,2014.0,1,0,1
KOR,NGA,2007.0,1,0,1
ETH,HTI,2020.0,1,0,1
ROU,BIH,2014.0,1,0,1
SLV,TTO,2009.0,1,0,1
PRT,QAT,2019.0,1,0,1
PRT,KAZ,2021.0,1,0,1
FRA,MDA,2019.0,1,0,1
HUN,BGR,2019.0,1,0,1
CMR,PER,2019.0,1,0,1
SWE,MNG,2018.0,2,0,2
CYP,MYS,2013.0,1,0,1
SRB,LVA,2020.0,1,0,1
COD,IND,2021.0,2,0,2
RWA,COD,2020.0,3,0,3
ROU,VNM,2021.0,1,0,1
NGA,EST,2019.0,1,0,1
MKD,ITA,2019.0,1,0,1
KEN,POL,2022.0,1,0,1
ARE,GHA,2021.0,1,0,1
,VAT,2019.0,1,0,1
ITA,ARM,2022.0,1,0,1
ESP,KEN,2024.0,1,0,1
,PYF,2021.0,1,0,1
MLT,LBY,2006.0,1,0,1
MOZ,KHM,2003.0,1,0,1
ZMB,BWA,2002.0,1,0,1
NGA,NAM,2007.0,1,0,1
BTN,,2010.0,1,0,1
PHL,AUT,2004.0,1,0,1
AUT,BLR,2015.0,1,0,1
IRL,TUN,2016.0,1,0,1
SRB,CHL,2007.0,1,0,1
KGZ,USA,2001.0,1,0,1
CHE,LIE,2000.0,1,0,1
ROU,AUS,2005.0,1,0,1
SWE,CRI,2008.0,1,0,1
SVN,MYS,1998.0,1,0,1
CHE,MOZ,2005.0,1,0,1
IRN,BHR,2006.0,1,0,1
BWA,CAN,2023.0,1,0,1
ITA,ARE,2004.0,1,0,1
BEL,COL,2005.0,1,0,1
HKG,POL,2004.0,1,0,1
CHE,BHS,2015.0,1,0,1
CHN,GUM,2012.0,1,0,1
MDA,CHE,2006.0,2,0,2
NGA,AUS,2004.0,3,0,3
PRT,LTU,2013.0,1,0,1
EGY,UGA,2003.0,1,0,1
UKR,GEO,2002.0,1,0,1
SYR,SRB,2001.0,1,0,1
ZWE,NAM,2004.0,1,0,1
TTO,DEU,2004.0,1,0,1
BRB,ZAF,2010.0,2,0,2
SVN,BIH,2013.0,1,0,1
HUN,YEM,2010.0,1,0,1
POL,PAN,2001.0,1,0,1
BRA,SAU,2011.0,1,0,1
DEU,SLE,2013.0,1,0,1
ARG,ROU,2007.0,1,0,1
HKG,BWA,2007.0,1,0,1
BEL,MDA,2021.0,1,0,1
JPN,MWI,2005.0,1,0,1
MWI,JPN,2009.0,1,0,1
SYR,CHN,2014.0,1,0,1
SDN,AUT,2015.0,1,0,1
BHR,DZA,2012.0,2,0,2
NGA,COL,2008.0,1,0,1
CHE,VIR,2013.0,1,0,1
NLD,LBY,2012.0,1,0,1
SWZ,EGY,2021.0,1,0,1
NER,GBR,2010.0,1,0,1
TUR,LUX,2015.0,1,0,1
ARE,THA,2013.0,2,0,2
ARE,MEX,2016.0,1,0,1
DOM,PER,2006.0,1,0,1
TUR,DZA,2013.0,1,0,1
SWZ,TTO,2005.0,1,0,1
VNM,ISR,2017.0,1,0,1
AUS,TUN,2011.0,1,0,1
PHL,AUT,2015.0,1,0,1
GAB,CHE,2012.0,1,0,1
ITA,BIH,2014.0,1,0,1
YEM,ARE,2023.0,1,0,1
NZL,SVK,2019.0,1,0,1
LKA,BGD,2006.0,1,0,1
DEU,BWA,2022.0,1,0,1
BEL,KWT,2014.0,1,0,1
KHM,NZL,2018.0,1,0,1
BHR,IRQ,2017.0,1,0,1
ISR,LUX,2015.0,1,0,1
JPN,BOL,2021.0,1,0,1
SEN,TUR,2015.0,1,0,1
CZE,KHM,2016.0,1,0,1
TON,ZAF,2017.0,1,0,1
USA,SYC,2000.0,1,0,1
IRL,URY,2015.0,1,0,1
JPN,SWZ,2012.0,1,0,1
ARG,IND,2014.0,1,0,1
PER,NIC,2012.0,1,0,1
ZWE,COL,2015.0,1,0,1
ITA,SEN,2018.0,1,0,1
PAK,SSD,2022.0,1,0,1
SVK,SUR,2016.0,1,0,1
KWT,LUX,2021.0,1,0,1
GMB,,2026.0,1,0,1
AUS,UZB,2000.0,1,0,1
PRT,MDA,2016.0,1,0,1
AUT,NPL,2006.0,1,0,1
MDA,JPN,2022.0,1,0,1
VEN,PRT,2021.0,1,0,1
VNM,JOR,2021.0,1,0,1
PAK,SVK,2023.0,1,0,1
CAN,SOM,2021.0,1,0,1
PAK,MEX,2020.0,1,0,1
,TUV,2020.0,6,0,6
MAR,MAC,2023.0,1,0,1
CHN,TJK,2020.0,1,0,1
IRL,MNE,2022.0,1,0,1
AUT,ARE,2024.0,1,0,1
BEL,UZB,2012.0,1,0,1
BLR,NOR,2000.0,1,0,1
NER,LUX,2010.0,1,0,1
ITA,MLI,1997.0,1,0,1
HRV,POL,1998.0,1,0,1
FRA,KWT,2011.0,1,0,1
VEN,PRT,2019.0,1,0,1
EGY,YEM,2004.0,1,0,1
FRA,KAZ,2006.0,1,0,1
SGP,ARE,2009.0,2,0,2
MUS,FRA,1997.0,1,0,1
GBR,NCL,2002.0,2,0,2
VEN,SWE,2009.0,1,0,1
ESP,OMN,2001.0,1,0,1
ITA,FLK,2007.0,1,0,1
ISL,BRA,2018.0,1,0,1
BRA,FIN,1999.0,1,0,1
SWE,VEN,2010.0,1,0,1
PER,SWE,2005.0,1,0,1
LVA,ZAF,2004.0,1,0,1
ZAF,LVA,2006.0,1,0,1
LVA,ZAF,2008.0,1,0,1
ZAF,LVA,2010.0,1,0,1
NGA,TUN,2005.0,1,0,1
OMN,SWZ,2000.0,1,0,1
EGY,JOR,2009.0,2,0,2
AUT,ISL,2007.0,1,0,1
SVK,FRA,1998.0,2,0,2
NGA,CHE,1999.0,1,0,1
GUM,DEU,2019.0,1,0,1
MYS,SLE,2020.0,1,0,1
NOR,MWI,2010.0,1,0,1
AUS,LVA,2003.0,1,0,1
SVN,IND,2012.0,1,0,1
CHE,GRL,2016.0,1,0,1
GRL,DEU,2018.0,1,0,1
IRN,MAR,2019.0,1,0,1
CAN,MCO,2013.0,1,0,1
PRT,CIV,2015.0,1,0,1
TUN,ESP,2009.0,1,0,1
THA,GLP,2009.0,1,0,1
CHN,TUN,2016.0,1,0,1
LBN,TUN,2009.0,1,0,1
BEN,USA,2011.0,1,0,1
PNG,CHE,1997.0,1,0,1
PRT,KWT,2014.0,1,0,1
SVN,KWT,2020.0,1,0,1
BGR,BGD,1999.0,1,0,1
MEX,PHL,2019.0,2,0,2
SVN,CHN,2003.0,1,0,1
CHN,PAN,2012.0,1,0,1
SRB,ARG,2011.0,1,0,1
BIH,SWE,2021.0,1,0,1
NPL,MUS,2006.0,1,0,1
IDN,EST,2021.0,2,0,2
JOR,IDN,2018.0,1,0,1
OMN,ISR,2022.0,1,0,1
CMR,POL,2019.0,1,0,1
NLD,CRI,2011.0,2,0,2
USA,BFA,1997.0,1,0,1
BFA,CMR,2009.0,1,0,1
JPN,GUM,2012.0,1,0,1
ARG,LBY,2004.0,1,0,1
NPL,ZAF,2004.0,1,0,1
KEN,PER,1999.0,1,0,1
SYC,SGP,2011.0,1,0,1
TUR,OMN,2002.0,1,0,1
OMN,TUR,2003.0,1,0,1
BRA,PRY,2001.0,1,0,1
BIH,CHE,2005.0,1,0,1
AUS,COG,2021.0,1,0,1
PAN,BEL,2002.0,1,0,1
TWN,SAU,2010.0,1,0,1
IDN,VNM,2003.0,2,0,2
ERI,ITA,2012.0,1,0,1
PAN,CRI,2005.0,1,0,1
ITA,BIH,2001.0,1,0,1
NLD,PSE,2015.0,1,0,1
NCL,IDN,2016.0,1,0,1
GBR,SWZ,1997.0,1,0,1
BEN,CAN,1998.0,1,0,1
JOR,PAK,2002.0,1,0,1
BRA,MMR,2016.0,1,0,1
LCA,USA,2009.0,1,0,1
IND,SYR,2018.0,1,0,1
SRB,BLR,2017.0,1,0,1
UKR,HKG,2019.0,1,0,1
IND,BGR,2020.0,1,0,1
AFG,CHN,2013.0,1,0,1
NOR,PHL,2013.0,1,0,1
ROU,BFA,2020.0,1,0,1
BGD,JOR,2017.0,1,0,1
CYM,ESP,2021.0,1,0,1
NGA,DNK,2018.0,2,0,2
USA,SWZ,2009.0,1,0,1
LBN,SGP,2023.0,1,0,1
TTO,DNK,2011.0,1,0,1
PSE,RUS,2004.0,1,0,1
GBR,LAO,2004.0,1,0,1
,GNQ,1996.0,1,0,1
LBR,FRA,2005.0,1,0,1
FJI,SGP,2009.0,1,0,1
FIN,BGD,2005.0,1,0,1
CHL,ISR,2011.0,1,0,1
KEN,IRL,2007.0,1,0,1
PNG,SGP,2009.0,1,0,1
LKA,OMN,2013.0,1,0,1
GMB,DEU,1998.0,1,0,1
MEX,NZL,1997.0,1,0,1
NZL,MEX,1998.0,1,0,1
TTO,NZL,2008.0,1,0,1
GBR,BRN,2003.0,1,0,1
CRI,CYP,2014.0,1,0,1
LBN,CYP,2000.0,1,0,1
ZWE,MEX,2016.0,1,0,1
NZL,PNG,2021.0,2,0,2
MWI,NAM,2023.0,1,0,1
RWA,ZMB,2021.0,1,0,1
QAT,BRA,2015.0,1,0,1
KGZ,DEU,2015.0,1,0,1
HKG,TUN,2018.0,1,0,1
KWT,EGY,2024.0,1,0,1
SDN,KWT,2020.0,1,0,1
NZL,SLE,2014.0,1,0,1
BLR,EST,2019.0,1,0,1
SWE,MUS,2018.0,1,0,1
GNQ,DEU,2014.0,1,0,1
MRT,SEN,2021.0,1,0,1
GBR,VGB,2020.0,1,0,1
MRT,USA,2006.0,1,0,1
PRY,ARG,2018.0,1,0,1
IRL,SVN,2021.0,1,0,1
PHL,CHL,2009.0,1,0,1
BHS,AUS,2022.0,1,0,1
ARM,POL,2007.0,1,0,1
IRN,KEN,2021.0,1,0,1
MAR,NGA,2022.0,1,0,1
MCO,ISR,2023.0,1,0,1
TTO,CIV,2016.0,1,0,1
ISR,IDN,2012.0,1,0,1
COL,CUB,2021.0,1,0,1
PAK,LBN,2022.0,1,0,1
AUT,TJK,2021.0,1,0,1
ETH,BGD,2022.0,1,0,1
HRV,PRI,2011.0,1,0,1
,PSE,2021.0,2,0,2
MKD,AUT,2019.0,2,0,2
IRN,KWT,2004.0,1,0,1
USA,BLZ,2001.0,1,0,1
COL,HUN,1999.0,1,0,1
DEU,MAC,2018.0,1,0,1
FIN,JOR,2001.0,1,0,1
ESP,MDA,1997.0,1,0,1
ESP,MDA,2002.0,1,0,1
,VGB,1995.0,1,0,1
SDN,CHE,2010.0,1,0,1
GBR,SYC,1999.0,1,0,1
ITA,CYP,1998.0,1,0,1
NAM,SWE,2001.0,1,0,1
LTU,JPN,1998.0,1,0,1
ITA,LVA,2007.0,1,0,1
URY,VEN,1998.0,1,0,1
GEO,ISR,2020.0,1,0,1
NLD,NGA,2002.0,1,0,1
ETH,ZAF,2000.0,1,0,1
GBR,MLI,2002.0,1,0,1
BEL,SEN,2013.0,1,0,1
BIH,DEU,2014.0,1,0,1
CHE,VEN,2002.0,1,0,1
FIN,ARE,2012.0,1,0,1
DZA,IRN,2009.0,1,0,1
BLR,TWN,2013.0,1,0,1
UZB,FRA,2002.0,1,0,1
AUS,BHR,1997.0,1,0,1
ARM,NLD,1999.0,1,0,1
BRA,CYP,2000.0,1,0,1
DNK,ARM,1999.0,1,0,1
YEM,ZAF,2014.0,1,0,1
MUS,FRA,2012.0,1,0,1
UKR,CYP,2016.0,1,0,1
PHL,AUT,2014.0,1,0,1
ARE,KWT,2013.0,1,0,1
MWI,ETH,2023.0,1,0,1
CUB,AGO,2011.0,1,0,1
KAZ,EGY,2019.0,1,0,1
SWZ,DEU,2009.0,1,0,1
LVA,SAU,2014.0,1,0,1
IRQ,PAK,2005.0,1,0,1
CYP,OMN,2011.0,1,0,1
HKG,ARG,2015.0,1,0,1
RWA,FIN,2011.0,1,0,1
MTQ,GLP,2013.0,1,0,1
SVK,SRB,2013.0,1,0,1
FRA,IRQ,2008.0,1,0,1
CYP,OMN,2021.0,1,0,1
NGA,VNM,2016.0,1,0,1
CHL,NIC,2010.0,1,0,1
LKA,ZAF,2000.0,1,0,1
PAK,SGP,2006.0,1,0,1
NIC,PER,2020.0,1,0,1
ZAF,URY,1999.0,1,0,1
UGA,MYS,2022.0,1,0,1
MEX,AFG,2021.0,1,0,1
TWN,ISR,1997.0,1,0,1
ESP,PNG,2012.0,1,0,1
BLR,EST,2021.0,1,0,1
URY,CHE,2023.0,1,0,1
PRI,GBR,2021.0,1,0,1
CHN,NPL,2006.0,1,0,1
TGO,TUN,2015.0,1,0,1
COG,CAF,2023.0,1,0,1
,EUE,2015.0,1,0,1
MEX,SLB,2023.0,1,0,1
NGA,OMN,2004.0,1,0,1
CHN,CIV,2023.0,1,0,1
BHR,UKR,2018.0,1,0,1
BEN,JPN,2016.0,1,0,1
KHM,SAU,2023.0,1,0,1
GUY,BRB,2022.0,1,0,1
BRN,RUS,2009.0,1,0,1
UGA,ETH,2010.0,1,0,1
PHL,MEX,2005.0,1,0,1
FRA,VUT,2012.0,1,0,1
,TCA,1999.0,1,0,1
ZAF,BDI,2006.0,1,0,1
USA,GRL,2014.0,1,0,1
,PLW,2003.0,1,0,1
BWA,NLD,2006.0,1,0,1
FJI,NOR,2007.0,1,0,1
ZWE,NOR,2017.0,1,0,1
UKR,SVK,2009.0,1,0,1
VNM,PHL,2007.0,1,0,1
FJI,KIR,2020.0,1,0,1
POL,DZA,2008.0,1,0,1
MYS,ESP,2009.0,1,0,1
GHA,MLI,2015.0,1,0,1
SOM,,2013.0,1,0,1
SVK,THA,2005.0,1,0,1
TUN,MRT,2004.0,1,0,1
DNK,MWI,2016.0,1,0,1
NAM,ITA,2016.0,1,0,1
NPL,CZE,2017.0,1,0,1
COD,JPN,2018.0,1,0,1
VEN,ARE,2016.0,1,0,1
ARM,GBR,1998.0,1,0,1
AUT,DZA,2015.0,1,0,1
LTU,AUS,2008.0,1,0,1
NZL,UKR,2002.0,1,0,1
BEL,BDI,2006.0,1,0,1
ROU,SVN,2005.0,1,0,1
CZE,MNG,2017.0,1,0,1
KAZ,FRA,1999.0,1,0,1
CRI,AUT,2008.0,1,0,1
PNG,GHA,2012.0,1,0,1
TTO,FRA,2001.0,1,0,1
NLD,PSE,2004.0,1,0,1
EST,CZE,2005.0,1,0,1
PRT,NGA,2020.0,1,0,1
GAB,SEN,2012.0,1,0,1
ROU,EGY,2021.0,2,0,2
MDV,NZL,2019.0,1,0,1
ERI,ETH,2021.0,1,0,1
LBY,BRN,2018.0,1,0,1
LBR,TZA,2020.0,1,0,1
ERI,ETH,2019.0,1,0,1
JPN,CRI,2014.0,1,0,1
LTU,ISR,2005.0,1,0,1
ECU,DNK,2001.0,1,0,1
CRI,ECU,2006.0,1,0,1
USA,SSD,2022.0,1,0,1
MMR,IND,1999.0,1,0,1
IND,MMR,2001.0,1,0,1
LIE,AUS,2015.0,1,0,1
CHE,ARM,2004.0,1,0,1
ZAF,HKG,2011.0,1,0,1
PRT,BGR,2007.0,1,0,1
POL,MDA,2016.0,1,0,1
NPL,UGA,2021.0,1,0,1
BRA,IRN,1998.0,1,0,1
MDA,BLR,2009.0,1,0,1
MDG,IND,2006.0,1,0,1
MOZ,MTQ,2016.0,1,0,1
ARM,ASM,2010.0,1,0,1
JPN,MUS,2008.0,1,0,1
IDN,CMR,1999.0,1,0,1
COL,NGA,2006.0,1,0,1
TZA,IND,2000.0,1,0,1
BEL,JOR,2008.0,1,0,1
ZMB,AUT,1997.0,1,0,1
LUX,IND,2001.0,1,0,1
GHA,SWE,2001.0,1,0,1
TWN,BGR,2015.0,1,0,1
SVK,FIN,1998.0,1,0,1
UZB,SWE,1997.0,1,0,1
NLD,JOR,2008.0,1,0,1
ISL,ISR,2000.0,1,0,1
BHR,USA,2001.0,1,0,1
CUB,GLP,2014.0,1,0,1
GLP,CUB,2017.0,1,0,1
MEX,PRT,2002.0,1,0,1
TUN,ZAF,2001.0,1,0,1
JPN,MKD,2018.0,1,0,1
CHE,BDI,2011.0,1,0,1
AUT,GTM,2010.0,1,0,1
THA,BHR,2019.0,1,0,1
FIN,TWN,2006.0,1,0,1
NLD,QAT,2012.0,1,0,1
DZA,NOR,2011.0,1,0,1
FRA,BHR,2017.0,1,0,1
KOR,IRL,2007.0,1,0,1
SYR,TUN,2021.0,1,0,1
CHL,DOM,2011.0,1,0,1
ITA,IRN,1998.0,1,0,1
ISR,ALB,2020.0,1,0,1
CHN,LBY,2018.0,1,0,1
SLV,BRB,2021.0,1,0,1
ROU,HKG,2018.0,1,0,1
ALB,NGA,2016.0,1,0,1
NLD,MMR,2015.0,1,0,1
MEX,TUR,2019.0,1,0,1
KOR,BLZ,2017.0,1,0,1
DEU,GMB,2019.0,1,0,1
USA,AGO,2018.0,1,0,1
PAK,NPL,2004.0,1,0,1
ISL,MEX,2017.0,1,0,1
MYS,NER,2018.0,1,0,1
HKG,COL,2018.0,1,0,1
HUN,MEX,2020.0,1,0,1
HUN,MKD,2017.0,1,0,1
AFG,QAT,2023.0,1,0,1
MEX,JAM,2019.0,1,0,1
ETH,IRN,2016.0,1,0,1
MNG,PHL,2021.0,1,0,1
ZMB,MOZ,2020.0,1,0,1
ARG,SVN,1999.0,1,0,1
AZE,GBR,2000.0,1,0,1
CUB,AUS,2014.0,1,0,1
ISR,URY,2005.0,1,0,1
ECU,PER,2004.0,1,0,1
MOZ,CHE,2011.0,1,0,1
FRA,BHR,2016.0,1,0,1
TZA,ISR,2017.0,1,0,1
CHE,IDN,2007.0,1,0,1
BEL,BFA,1998.0,1,0,1
IRN,ISR,2001.0,1,0,1
CAN,GUF,2007.0,1,0,1
ZMB,IDN,2015.0,1,0,1
SEN,BOL,2003.0,1,0,1
ITA,BHR,1999.0,1,0,1
GBR,LBY,1998.0,1,0,1
BHR,QAT,2019.0,1,0,1
NER,CMR,1999.0,1,0,1
MDG,ITA,2000.0,1,0,1
BGR,EST,2004.0,1,0,1
NPL,MMR,2020.0,1,0,1
ESP,HRV,2008.0,1,0,1
BRA,QAT,2012.0,1,0,1
ROU,IND,2006.0,1,0,1
,PRK,2003.0,1,0,1
SEN,COL,2008.0,1,0,1
COL,FJI,2006.0,1,0,1
KOR,BWA,2017.0,1,0,1
ECU,BRA,2002.0,1,0,1
DEU,SEN,2007.0,1,0,1
TKM,RUS,1998.0,1,0,1
PAK,BRN,1998.0,1,0,1
CHN,NGA,2007.0,1,0,1
KHM,PHL,2017.0,1,0,1
PRT,PHL,2017.0,1,0,1
HRV,DNK,2009.0,1,0,1
PRK,CHN,2011.0,1,0,1
NOR,PAK,2007.0,1,0,1
BRB,FRA,2022.0,1,0,1
SVN,MLT,2017.0,1,0,1
GRC,MDA,2015.0,1,0,1
MYS,ITA,2009.0,1,0,1
IRL,ISL,2009.0,1,0,1
IDN,TUR,2012.0,1,0,1
CHL,ARE,2023.0,1,0,1
IRL,SRB,2006.0,1,0,1
SAU,HUN,2016.0,1,0,1
IRN,CHL,2012.0,1,0,1
MLI,MYS,2008.0,1,0,1
AUS,PYF,2012.0,1,0,1
THA,BRA,2011.0,1,0,1
BEN,CAN,2007.0,1,0,1
CAN,MLI,2010.0,1,0,1
SLB,JAM,2009.0,1,0,1
MYS,ARG,2015.0,1,0,1
ISR,BRB,2003.0,1,0,1
BRB,AUS,2008.0,1,0,1
NGA,SLE,2013.0,1,0,1
FJI,ZAF,2020.0,1,0,1
BRA,CPV,2013.0,1,0,1
TWN,IRQ,2016.0,1,0,1
LAO,NCL,2014.0,1,0,1
ISR,LKA,2016.0,1,0,1
USA,POL,2017.0,126,144,-18
KOR,TUN,2022.0,1,1,0
MYS,ITA,2016.0,7,5,2
FIN,NLD,2022.0,24,26,-2
UGA,BEL,2022.0,11,5,6
LBN,BEL,2015.0,5,4,1
GBR,EGY,2014.0,60,33,27
CHN,SAU,2016.0,32,30,2
CHN,GHA,2022.0,71,23,48
USA,POL,2022.0,104,101,3
TWN,CHN,2020.0,332,254,78
CZE,FRA,2019.0,29,38,-9
DEU,MEX,2022.0,26,44,-18
JPN,CHN,2023.0,355,233,122
IRN,ITA,2022.0,105,19,86
COL,USA,2017.0,134,146,-12
AUS,DNK,2019.0,46,46,0
MYS,AUS,2011.0,53,63,-10
CHN,RUS,2018.0,26,18,8
ITA,AUS,2019.0,50,54,-4
AUS,NLD,2023.0,60,31,29
GRC,ITA,2020.0,33,29,4
GUM,USA,2000.0,16,1,15
IND,AUS,2019.0,133,87,46
DNK,IND,2020.0,17,26,-9
USA,KAZ,2019.0,21,29,-8
USA,ISR,2017.0,368,435,-67
GRC,SWE,2019.0,33,18,15
FRA,COL,2016.0,38,24,14
TUR,FRA,2022.0,24,19,5
THA,KOR,2018.0,14,17,-3
USA,LTU,2020.0,12,8,4
ITA,NLD,2023.0,91,66,25
AUS,ESP,2017.0,30,58,-28
JPN,CHE,2021.0,39,36,3
USA,SAU,2021.0,367,144,223
IRN,ETH,2020.0,10,4,6
MEX,ECU,2019.0,20,6,14
MEX,COL,2021.0,56,69,-13
CHE,ISR,2022.0,13,28,-15
USA,IRL,1997.0,53,47,6
GBR,TWN,2021.0,42,32,10
UKR,FRA,2019.0,20,5,15
GBR,IRQ,2018.0,151,22,129
IRQ,GBR,2020.0,18,180,-162
GBR,IRQ,2022.0,65,21,44
COD,COG,2020.0,43,185,-142
ARE,USA,2020.0,76,103,-27
ESP,FIN,2018.0,19,23,-4
PRT,CHN,2018.0,19,9,10
CHN,ITA,2019.0,50,72,-22
FRA,ESP,2022.0,221,209,12
ZMB,ZAF,2023.0,5,8,-3
ESP,PRT,2022.0,118,133,-15
ESP,USA,2019.0,517,481,36
SVK,CZE,2020.0,101,62,39
NLD,KEN,2020.0,10,7,3
IDN,TWN,2019.0,27,44,-17
NLD,CHN,2022.0,202,188,14
CHN,NLD,2023.0,131,128,3
USA,SAU,2019.0,352,146,206
NZL,AUS,2018.0,174,171,3
AUT,FRA,2017.0,40,45,-5
HRV,FIN,2023.0,1,1,0
PHL,CAN,2019.0,10,3,7
BGD,JPN,2023.0,41,44,-3
EGY,USA,2020.0,135,184,-49
THA,CHN,2018.0,37,32,5
IND,SAU,2015.0,177,37,140
ISR,AUS,2018.0,14,13,1
NOR,USA,2022.0,74,89,-15
FRA,CHL,2017.0,58,22,36
MYS,SWE,2019.0,9,4,5
ESP,CHL,2000.0,17,21,-4
CYP,UKR,2021.0,1,1,0
CRI,DEU,2016.0,8,9,-1
COL,USA,2022.0,145,92,53
NGA,ZMB,2022.0,3,4,-1
IRN,NLD,2008.0,15,11,4
NLD,JPN,2014.0,25,13,12
SWE,CAN,2007.0,42,17,25
CHN,DNK,2019.0,81,71,10
FIN,GBR,2021.0,63,87,-24
CYP,GRC,2016.0,17,37,-20
USA,CZE,2005.0,45,56,-11
IRL,USA,2020.0,154,143,11
CHN,JPN,2015.0,317,591,-274
IND,TWN,2021.0,96,61,35
CHL,PER,2018.0,19,8,11
IND,ARE,2019.0,70,25,45
NZL,AUS,2022.0,148,99,49
AUT,CHE,2016.0,79,67,12
DEU,LUX,2018.0,42,33,9
DEU,IDN,2019.0,26,21,5
GBR,MWI,2020.0,21,19,2
USA,HKG,2022.0,157,138,19
EGY,TUR,2023.0,3,1,2
LBN,GBR,2023.0,14,7,7
PAK,USA,2015.0,93,82,11
PAK,MYS,2021.0,90,157,-67
AUS,FRA,2022.0,66,57,9
DNK,CHE,2021.0,53,47,6
HKG,SGP,2018.0,52,40,12
THA,IDN,2023.0,21,24,-3
IRN,NZL,2019.0,30,3,27
BHR,GBR,2021.0,6,7,-1
NLD,ETH,2022.0,13,6,7
AUT,CHE,2022.0,93,54,39
USA,DNK,2020.0,176,148,28
IRN,AUS,2020.0,201,48,153
JPN,AUS,2000.0,38,47,-9
COL,USA,2018.0,160,154,6
BRA,JPN,2019.0,15,12,3
NZL,CHN,2013.0,21,15,6
NOR,FRA,2016.0,16,37,-21
CHE,CAN,2018.0,103,96,7
NOR,ITA,2020.0,20,34,-14
CHN,SWE,2019.0,116,134,-18
SWE,CHN,2022.0,167,108,59
FIN,BRA,2019.0,8,18,-10
IND,TWN,2019.0,81,46,35
NZL,FRA,2018.0,23,17,6
AUS,MYS,2020.0,91,95,-4
CHN,AUS,2015.0,354,293,61
USA,ARE,2022.0,87,74,13
DNK,USA,2022.0,128,149,-21
NPL,USA,2020.0,49,28,21
FRA,CHN,2020.0,256,212,44
SAU,MYS,2019.0,34,84,-50
JPN,CHE,2019.0,46,51,-5
AUT,CAN,2020.0,21,19,2
ZAF,NGA,2018.0,76,91,-15
NLD,SAU,2021.0,16,6,10
BRA,PER,2022.0,53,24,29
CHE,FRA,2022.0,227,333,-106
FRA,JPN,2018.0,88,80,8
ISL,CAN,2020.0,3,2,1
USA,NZL,2018.0,144,131,13
PAK,CHN,2019.0,370,314,56
GBR,BRA,2020.0,123,174,-51
GBR,PRT,2018.0,89,132,-43
USA,HKG,2018.0,133,165,-32
HKG,USA,2019.0,175,164,11
ISR,USA,2022.0,307,308,-1
AUS,BEL,2010.0,18,26,-8
ZAF,ESP,2022.0,11,4,7
SAU,TUN,2019.0,41,184,-143
DNK,BEL,2020.0,18,23,-5
DNK,FRA,2021.0,45,46,-1
THA,CAN,2023.0,8,7,1
USA,JOR,2019.0,68,41,27
SWE,JPN,2023.0,16,6,10
CHN,DEU,2014.0,346,269,77
FRA,DEU,2020.0,428,406,22
TUN,SAU,2015.0,75,11,64
COL,DEU,2017.0,16,21,-5
TWN,RUS,2007.0,3,2,1
SVN,GBR,2019.0,20,11,9
IRN,DEU,2017.0,90,46,44
ISR,DEU,2019.0,79,51,28
ESP,ECU,2018.0,80,53,27
BEL,ISR,2022.0,4,1,3
IRL,MYS,2015.0,8,3,5
CHN,EGY,2015.0,12,11,1
USA,GEO,2018.0,226,221,5
CHN,ITA,2021.0,81,81,0
IDN,JPN,2021.0,118,235,-117
MEX,COL,2019.0,68,56,12
IND,PRT,2020.0,13,21,-8
CHN,CHE,2020.0,115,99,16
TUR,FIN,2020.0,9,3,6
VNM,USA,2022.0,41,43,-2
MEX,USA,2015.0,268,298,-30
USA,COD,2018.0,4,2,2
IND,FRA,2020.0,101,73,28
HKG,MYS,2018.0,4,6,-2
BEL,CAN,2019.0,49,38,11
GBR,GHA,2020.0,30,19,11
PRT,BEL,2018.0,21,14,7
LAO,USA,2017.0,3,8,-5
CHN,SAU,2022.0,59,44,15
CHN,VNM,2020.0,44,14,30
FRA,SEN,2014.0,30,26,4
JPN,IDN,2020.0,261,102,159
PAK,CHN,2021.0,328,504,-176
NGA,JPN,2022.0,6,3,3
GHA,CAN,2022.0,12,8,4
DEU,KOR,1997.0,18,2,16
NGA,TZA,2017.0,3,1,2
JPN,EGY,2015.0,54,28,26
TUN,ITA,2018.0,13,10,3
NZL,SWE,2018.0,16,7,9
ITA,NPL,2020.0,3,2,1
SAU,GBR,2022.0,96,213,-117
SAU,AUS,2019.0,41,68,-27
KOR,VNM,2023.0,72,35,37
HKG,SGP,2022.0,39,43,-4
PAN,FRA,2015.0,1,2,-1
ITA,BEL,2002.0,38,44,-6
GBR,THA,2020.0,128,69,59
CHN,KOR,2012.0,80,208,-128
DEU,SAU,2022.0,15,22,-7
MTQ,FRA,2021.0,25,19,6
AUT,FIN,2023.0,8,7,1
IND,KOR,2019.0,268,179,89
JPN,SGP,2018.0,42,43,-1
CAN,FRA,2022.0,236,306,-70
MWI,IRL,2019.0,2,1,1
ESP,PRT,2018.0,121,97,24
IND,DEU,2022.0,220,132,88
ZWE,ZAF,2023.0,21,26,-5
NZL,USA,2022.0,111,82,29
CHN,PAK,2023.0,297,314,-17
GRC,FRA,2020.0,50,33,17
IND,IRL,2021.0,38,19,19
OMN,GBR,2023.0,13,4,9
GBR,LBY,2014.0,12,3,9
IND,OMN,2021.0,32,24,8
POL,CZE,2019.0,23,20,3
IND,ITA,2014.0,59,39,20
DEU,TUR,2016.0,54,77,-23
SAU,IND,2021.0,95,120,-25
PAK,HKG,2015.0,8,2,6
RUS,VNM,2018.0,27,7,20
BEL,CHN,2019.0,63,83,-20
GBR,JOR,2019.0,43,16,27
SAU,FIN,2021.0,3,1,2
MEX,BRA,2018.0,29,39,-10
ESP,ECU,2022.0,64,62,2
ARG,MEX,2015.0,22,17,5
BEL,NZL,2018.0,6,4,2
DEU,CHN,2020.0,561,550,11
DZA,ESP,2020.0,9,13,-4
CUB,USA,2015.0,9,1,8
AUS,SWE,2022.0,48,29,19
MYS,GBR,2022.0,84,75,9
SGP,RUS,2016.0,2,4,-2
TUR,IND,2018.0,10,8,2
AUT,USA,2020.0,131,157,-26
BGD,DEU,2000.0,4,1,3
ECU,DEU,2019.0,11,10,1
NGA,NLD,2017.0,3,1,2
NGA,BEN,2019.0,4,12,-8
USA,BEL,2023.0,83,101,-18
HRV,AUT,2012.0,9,2,7
SWZ,ZAF,2021.0,8,13,-5
PAK,DEU,2004.0,6,7,-1
DEU,PAK,2007.0,7,16,-9
THA,CHN,2022.0,50,42,8
KEN,TZA,2021.0,9,8,1
BGD,USA,2019.0,113,61,52
TUN,ITA,2022.0,7,12,-5
ZAF,NLD,2023.0,16,6,10
ITA,NLD,2000.0,76,54,22
SAU,YEM,2018.0,5,12,-7
USA,HUN,2023.0,25,22,3
PER,CHL,2018.0,8,19,-11
CHL,PER,2022.0,14,11,3
SWE,IRN,2021.0,19,69,-50
ZMB,ZWE,2018.0,2,1,1
FRA,COL,2017.0,32,12,20
BIH,DEU,2020.0,3,1,2
MYS,GBR,2016.0,102,141,-39
FIN,CHN,2014.0,20,20,0
POL,GBR,2020.0,75,82,-7
FRA,GLP,2019.0,28,24,4
PAN,COL,2019.0,2,3,-1
COL,PAN,2021.0,3,1,2
FIN,AUS,2013.0,14,11,3
BRA,PER,2018.0,39,22,17
LKA,NPL,2019.0,1,1,0
GBR,CZE,2020.0,50,53,-3
IDN,MYS,2023.0,40,44,-4
EGY,GBR,2019.0,58,62,-4
GBR,PRT,2022.0,130,66,64
TUR,IRN,2020.0,21,50,-29
TUR,QAT,2022.0,5,3,2
TWN,PAK,2018.0,3,5,-2
POL,CZE,2021.0,37,20,17
NLD,CHN,2016.0,121,127,-6
BGD,MYS,2020.0,42,81,-39
USA,FIN,2022.0,84,59,25
GBR,BWA,2018.0,8,2,6
CZE,DEU,2023.0,40,37,3
TUR,DEU,2016.0,77,54,23
BGD,ITA,2021.0,4,7,-3
IND,IRN,2019.0,11,6,5
IDN,HUN,2022.0,6,5,1
USA,MEX,2021.0,276,387,-111
CMR,PAK,2021.0,3,1,2
AFG,JPN,2018.0,2,8,-6
IND,KWT,2021.0,5,6,-1
ZAF,NAM,2021.0,20,6,14
EGY,GBR,2021.0,91,54,37
SAU,PAK,2021.0,95,81,14
AUS,ESP,2022.0,43,33,10
VNM,FRA,2022.0,27,47,-20
CAN,AUS,2022.0,134,146,-12
DNK,VNM,2021.0,3,3,0
KEN,RWA,2022.0,8,5,3
UKR,DEU,2012.0,29,10,19
COL,FRA,2020.0,21,25,-4
FRA,COL,2022.0,16,22,-6
CAN,ZAF,2023.0,10,19,-9
ECU,DEU,2021.0,10,9,1
RUS,AUT,2019.0,16,7,9
TUR,DEU,2022.0,96,43,53
GBR,IDN,2021.0,57,40,17
MEX,CAN,2022.0,54,25,29
DEU,JPN,2022.0,95,98,-3
SYR,GBR,2022.0,6,3,3
JOR,CAN,2022.0,9,12,-3
IDN,USA,2013.0,27,32,-5
COL,BEL,2022.0,7,3,4
IDN,TWN,2021.0,71,72,-1
GBR,GEO,2021.0,2,1,1
CHN,LKA,2021.0,10,4,6
ITA,VNM,2021.0,9,3,6
COL,ESP,2023.0,52,41,11
USA,AFG,2022.0,3,5,-2
VEN,PER,2011.0,1,1,0
PER,USA,1997.0,9,7,2
BGD,USA,2021.0,169,66,103
UKR,GBR,2021.0,7,12,-5
PHL,KOR,2022.0,13,18,-5
UKR,LVA,2023.0,4,2,2
SGP,NOR,2023.0,4,1,3
CHE,SWE,1997.0,12,21,-9
TUN,ESP,2022.0,7,12,-5
THA,BTN,2022.0,7,2,5
IDN,DEU,2019.0,21,26,-5
NZL,USA,2017.0,141,118,23
IDN,AUS,2021.0,40,92,-52
DEU,SGP,2023.0,21,27,-6
VNM,FRA,2017.0,18,68,-50
THA,VNM,2021.0,34,6,28
LKA,USA,2023.0,12,14,-2
NLD,AUS,2021.0,85,99,-14
IRN,NZL,2021.0,21,4,17
DZA,CAN,2022.0,8,1,7
SAU,CAN,2023.0,33,36,-3
BRA,GBR,2023.0,82,61,21
KEN,UGA,2020.0,10,8,2
IRQ,USA,2022.0,13,59,-46
CHN,THA,2021.0,50,58,-8
USA,MWI,2022.0,19,13,6
LBN,USA,2021.0,144,60,84
KOR,PRK,2022.0,8,4,4
CHN,PRK,2021.0,9,6,3
IRN,MYS,2020.0,26,75,-49
ARE,JPN,2011.0,2,2,0
CHL,ITA,2023.0,14,4,10
NLD,KHM,2022.0,2,1,1
DNK,NLD,1998.0,10,18,-8
CHN,RUS,2022.0,37,53,-16
HUN,USA,2001.0,98,86,12
GMB,USA,2022.0,1,3,-2
PAK,IND,2021.0,46,49,-3
ESP,ITA,2022.0,204,248,-44
POL,NLD,2013.0,24,18,6
QAT,GBR,2021.0,32,37,-5
GBR,MYS,2021.0,111,95,16
IND,AUS,2021.0,148,103,45
TUR,PAK,2022.0,32,17,15
CHN,NZL,2022.0,33,77,-44
VNM,BEL,2021.0,7,21,-14
DNK,CHN,2023.0,72,78,-6
USA,CHL,2022.0,88,137,-49
ITA,PRT,2021.0,39,45,-6
IRN,DEU,2022.0,142,44,98
FRA,NLD,2021.0,142,105,37
DEU,PRT,2014.0,28,47,-19
CHE,CAN,2017.0,106,127,-21
BEL,CAN,2021.0,44,45,-1
CHE,AUT,2022.0,54,93,-39
GBR,IRN,2021.0,28,115,-87
USA,ECU,2021.0,34,43,-9
EGY,CHN,2023.0,26,63,-37
CHN,DNK,2021.0,99,99,0
YEM,JOR,2021.0,2,3,-1
AUS,EGY,2021.0,15,15,0
MYS,BGD,2023.0,31,28,3
NGA,EGY,2021.0,9,1,8
SGP,AUS,2023.0,49,39,10
IND,NLD,2022.0,50,23,27
GBR,ZWE,2023.0,7,5,2
KEN,JPN,2021.0,7,10,-3
DNK,GBR,2003.0,64,75,-11
PAK,AUS,2014.0,37,25,12
ESP,SVK,2018.0,2,1,1
TWN,SWE,2023.0,6,3,3
ZAF,NGA,2022.0,108,88,20
ESP,PER,2017.0,30,12,18
TUR,ARG,2018.0,4,11,-7
GBR,IRQ,2017.0,88,13,75
PRT,DNK,2012.0,10,5,5
GBR,OMN,2022.0,11,14,-3
CHN,BGD,2021.0,55,39,16
SGP,IND,2023.0,30,37,-7
ESP,SGP,2022.0,7,8,-1
AFG,MYS,2021.0,4,6,-2
AGO,BRA,2021.0,2,4,-2
AUS,JPN,2022.0,75,40,35
SVN,CHE,2021.0,4,4,0
EGY,SDN,2021.0,4,3,1
IND,GBR,2023.0,234,115,119
IND,IRL,2019.0,41,14,27
GLP,FRA,2023.0,8,18,-10
PAK,MYS,2019.0,59,143,-84
IND,ARE,2021.0,77,42,35
RWA,GBR,2022.0,3,3,0
USA,BGD,2020.0,72,153,-81
MYS,THA,2021.0,21,5,16
CHN,UKR,2022.0,17,19,-2
BGD,HKG,2020.0,5,3,2
NLD,CAN,2023.0,35,43,-8
KOR,PAK,2019.0,122,44,78
USA,UGA,2021.0,31,40,-9
USA,ZWE,2018.0,12,9,3
BRA,AUT,2020.0,28,5,23
BRA,PAK,2017.0,14,8,6
CHE,FIN,1997.0,10,9,1
FRA,GUF,2011.0,26,23,3
JPN,GBR,2006.0,118,113,5
LUX,CHE,2011.0,5,7,-2
DEU,AUT,1999.0,156,144,12
MLT,GBR,2014.0,12,15,-3
UKR,NLD,1997.0,2,7,-5
BEL,NLD,2000.0,82,92,-10
UKR,NLD,2002.0,6,1,5
USA,ISL,2019.0,11,13,-2
HRV,SRB,2005.0,13,4,9
GBR,AUT,2000.0,28,34,-6
EGY,USA,1998.0,54,54,0
BHR,SAU,2022.0,9,10,-1
FRA,NER,2011.0,4,6,-2
GBR,GHA,1999.0,4,9,-5
FRA,SEN,2008.0,32,27,5
SVN,NLD,1997.0,4,1,3
NZL,MYS,2003.0,2,1,1
ITA,DNK,1998.0,22,7,15
CHE,SGP,2004.0,7,2,5
BRA,NLD,2016.0,44,37,7
CHE,POL,2002.0,14,12,2
USA,CZE,1997.0,49,36,13
THA,CHN,2016.0,25,12,13
NOR,JPN,2007.0,4,4,0
DEU,BGR,1998.0,12,18,-6
SGP,NZL,2023.0,11,1,10
ESP,GBR,2001.0,174,187,-13
POL,NOR,2006.0,4,1,3
DEU,ESP,1997.0,58,62,-4
DEU,AUS,2002.0,104,72,32
JPN,BRA,1999.0,18,10,8
SVK,DEU,2022.0,11,11,0
EGY,USA,1999.0,42,53,-11
DNK,ITA,2000.0,18,11,7
NLD,ESP,2008.0,53,55,-2
BRA,CHE,2006.0,11,14,-3
NOR,GBR,2003.0,34,50,-16
RUS,UKR,1997.0,76,78,-2
POL,RUS,2002.0,15,18,-3
CHE,DNK,2004.0,15,12,3
USA,KWT,2004.0,17,7,10
BEL,ITA,1999.0,31,41,-10
GBR,UKR,1998.0,17,18,-1
RUS,BRA,1997.0,10,2,8
RUS,SWE,1999.0,38,27,11
KOR,EGY,2016.0,5,5,0
BRA,GBR,2010.0,54,77,-23
BEL,USA,2016.0,234,147,87
TUR,GBR,1999.0,29,54,-25
ESP,DEU,1998.0,80,61,19
PAK,GBR,1999.0,21,13,8
NLD,DEU,2001.0,175,185,-10
OMN,CAN,2002.0,4,3,1
JPN,IRL,2008.0,5,7,-2
BRA,CAN,1997.0,15,23,-8
JPN,DEU,2002.0,143,124,19
ROU,NLD,2003.0,6,2,4
ARG,GBR,2013.0,24,16,8
GBR,CZE,1999.0,35,37,-2
CRI,ESP,2020.0,12,9,3
SWE,FIN,2001.0,50,49,1
ESP,FIN,2016.0,20,21,-1
HKG,AUS,2015.0,49,27,22
SWE,ARG,2010.0,2,4,-2
DEU,CHN,1998.0,59,63,-4
CHL,FRA,2001.0,13,14,-1
IRL,USA,1998.0,71,58,13
MDA,RUS,1999.0,3,3,0
BEL,TUR,1998.0,3,6,-3
CHN,BEL,2002.0,17,14,3
AUT,ITA,2003.0,29,23,6
PER,GBR,2002.0,2,1,1
ISR,AUS,2016.0,18,16,2
POL,GBR,1998.0,32,22,10
NGA,USA,1998.0,23,19,4
NLD,CHE,2008.0,55,50,5
NLD,JPN,2001.0,27,27,0
CAN,CHE,2006.0,56,76,-20
USA,GRC,2000.0,107,79,28
FRA,CAN,2002.0,268,167,101
AUT,ESP,2001.0,13,7,6
RUS,SWE,1998.0,40,21,19
EGY,DEU,2010.0,35,51,-16
GBR,JPN,2001.0,163,156,7
BEL,ESP,1997.0,19,12,7
USA,NOR,2002.0,97,92,5
IRL,ITA,2021.0,37,42,-5
BRA,DEU,1999.0,17,41,-24
UKR,PRT,1998.0,1,1,0
GBR,BEL,2001.0,92,73,19
BEL,GBR,2002.0,83,72,11
CHE,CZE,2014.0,16,19,-3
SWE,THA,2007.0,12,2,10
USA,VEN,1998.0,33,34,-1
IND,DNK,2001.0,4,3,1
USA,IRL,2002.0,88,104,-16
RUS,NLD,2009.0,15,11,4
GRC,GBR,1997.0,36,51,-15
CAN,THA,1999.0,7,2,5
CAN,VEN,1998.0,3,4,-1
JOR,USA,1998.0,9,20,-11
DNK,NOR,2001.0,26,31,-5
JPN,FRA,2003.0,79,69,10
NLD,USA,1998.0,234,214,20
FRA,NOR,2001.0,16,13,3
USA,BGR,2007.0,15,12,3
OMN,EGY,2011.0,7,3,4
USA,BEL,2000.0,107,150,-43
JPN,ROU,2003.0,12,8,4
NOR,USA,2018.0,83,129,-46
MEX,CRI,2011.0,4,2,2
SWE,BGR,2006.0,2,1,1
GBR,MEX,2000.0,38,22,16
CAN,GBR,1997.0,155,172,-17
DEU,GRC,2017.0,51,97,-46
ZAF,NAM,2011.0,9,3,6
ZAF,USA,2015.0,128,114,14
FRA,CZE,2000.0,25,10,15
FIN,RUS,2013.0,15,18,-3
GBR,BRA,1998.0,71,47,24
FIN,DNK,2002.0,11,14,-3
BGR,NLD,2002.0,6,9,-3
NLD,BGR,2005.0,1,1,0
NLD,ITA,2013.0,70,111,-41
BRA,BEL,2003.0,7,6,1
CZE,GBR,2008.0,49,53,-4
BLR,RUS,2002.0,14,41,-27
BLR,RUS,2005.0,15,27,-12
UKR,RUS,2017.0,176,67,109
BRA,DEU,1998.0,25,32,-7
DEU,FIN,2011.0,35,53,-18
CAN,ITA,2018.0,52,82,-30
USA,THA,1997.0,52,28,24
ETH,IND,2004.0,4,4,0
AUS,DEU,1997.0,49,46,3
SRB,DNK,2002.0,7,1,6
AUT,LIE,2017.0,3,1,2
FRA,RUS,1997.0,58,79,-21
VEN,ITA,2002.0,1,2,-1
USA,HUN,2000.0,75,104,-29
CHE,HKG,2009.0,9,10,-1
GBR,BEL,2004.0,57,79,-22
AUT,USA,2007.0,95,88,7
MYS,IND,2012.0,45,69,-24
USA,NZL,2017.0,118,141,-23
CZE,ITA,2007.0,8,9,-1
FRA,HUN,2001.0,18,18,0
UKR,RUS,2022.0,93,49,44
AUS,NOR,2004.0,7,10,-3
GBR,ARE,2004.0,15,5,10
SRB,ITA,2002.0,15,7,8
ITA,SRB,2005.0,6,7,-1
FRA,SRB,2009.0,4,3,1
JPN,DEU,1997.0,75,90,-15
SAU,PAK,2011.0,18,35,-17
BRA,ITA,1998.0,10,19,-9
ITA,GBR,1997.0,143,125,18
NLD,FRA,2015.0,136,112,24
NPL,IND,1998.0,3,3,0
ISR,DEU,2011.0,40,34,6
CZE,SVK,2004.0,23,35,-12
CAN,BEL,1998.0,17,16,1
JOR,ARE,2005.0,5,4,1
GBR,SWE,2001.0,100,98,2
USA,JOR,2011.0,50,26,24
ITA,ROU,2016.0,16,14,2
FIN,DEU,2003.0,40,26,14
MEX,ITA,2002.0,6,10,-4
ZAF,UKR,1999.0,1,1,0
SWE,GBR,2006.0,140,84,56
DEU,RUS,2018.0,107,117,-10
NGA,DEU,2003.0,5,9,-4
DEU,NGA,2005.0,9,4,5
SRB,ITA,2005.0,7,6,1
MLI,SEN,2015.0,2,3,-1
JPN,UKR,2010.0,4,6,-2
MYS,GBR,2017.0,94,134,-40
BRA,ESP,2013.0,69,115,-46
USA,URY,2000.0,9,7,2
IRL,ITA,2011.0,14,29,-15
PRT,BRA,1998.0,38,18,20
ZAF,USA,2001.0,98,76,22
GBR,EGY,2004.0,24,8,16
USA,BRA,1997.0,187,139,48
COL,CAN,2003.0,3,4,-1
ESP,JPN,1997.0,8,11,-3
SAU,GBR,2016.0,65,124,-59
JPN,RUS,2000.0,48,49,-1
ITA,GRC,2006.0,21,11,10
JPN,CZE,2014.0,9,6,3
GBR,RUS,2013.0,50,45,5
HUN,KWT,2001.0,3,1,2
SWE,ITA,2001.0,28,28,0
USA,UKR,2009.0,22,28,-6
CHN,HKG,1998.0,128,83,45
BEL,BRA,2010.0,11,19,-8
SAU,JPN,2016.0,8,23,-15
SAU,JPN,2018.0,7,16,-9
SGP,HUN,2005.0,1,1,0
BEL,DEU,2001.0,62,74,-12
CAN,ESP,1997.0,15,15,0
BEL,FRA,2000.0,151,141,10
CZE,SVK,2014.0,73,86,-13
THA,USA,2002.0,87,119,-32
DEU,TUN,2010.0,4,2,2
AUT,SVK,2003.0,9,11,-2
NOR,UKR,2001.0,2,1,1
GRC,USA,1997.0,69,86,-17
ITA,ARG,2001.0,12,15,-3
USA,DNK,1999.0,100,136,-36
AUT,SWE,2017.0,32,27,5
FRA,REU,2000.0,6,3,3
REU,FRA,2001.0,7,3,4
ARG,MEX,2004.0,5,10,-5
ESP,CUB,2013.0,23,26,-3
GBR,FIN,2016.0,58,70,-12
IND,SWE,2004.0,10,8,2
IND,ITA,2001.0,11,13,-2
HUN,CAN,2012.0,10,8,2
FRA,RUS,2005.0,49,63,-14
ISR,NLD,1997.0,3,6,-3
USA,EST,2001.0,5,6,-1
CHE,POL,1997.0,19,14,5
USA,PER,2000.0,20,13,7
POL,ESP,2012.0,19,19,0
RUS,EST,2000.0,3,4,-1
ITA,SWE,2001.0,28,28,0
KOR,GBR,2000.0,22,26,-4
ZWE,ETH,2014.0,1,1,0
CZE,GBR,2001.0,51,33,18
FIN,HUN,2000.0,6,2,4
ESP,AUT,2002.0,13,21,-8
HUN,BEL,2005.0,9,8,1
ARG,FRA,2006.0,18,23,-5
BGR,RUS,1999.0,4,8,-4
FRA,LBN,2000.0,18,18,0
GBR,KEN,2005.0,12,7,5
HUN,CHE,2010.0,8,20,-12
FRA,ISR,1997.0,20,16,4
NOR,RUS,1997.0,6,8,-2
NOR,NLD,2002.0,18,21,-3
MYS,USA,2003.0,11,22,-11
UKR,FIN,1997.0,4,1,3
USA,PHL,2009.0,36,36,0
UKR,GBR,2011.0,21,117,-96
COL,ARG,2010.0,7,11,-4
DEU,SGP,2000.0,10,2,8
AZE,RUS,2008.0,11,3,8
RUS,JPN,1999.0,49,28,21
IND,KWT,2011.0,7,4,3
THA,JPN,2002.0,50,45,5
AUS,BWA,2020.0,2,2,0
USA,MYS,2010.0,48,12,36
PRT,NLD,2010.0,19,22,-3
FRA,CAN,1997.0,130,139,-9
RUS,AZE,2003.0,9,3,6
UKR,USA,2009.0,28,22,6
IRL,USA,1999.0,67,49,18
CHE,GRC,2004.0,10,10,0
ISR,CAN,2002.0,38,25,13
GBR,LBY,2001.0,1,2,-1
AUT,USA,1999.0,122,100,22
SRB,MKD,2003.0,23,9,14
QAT,OMN,2015.0,2,2,0
USA,ZAF,2006.0,62,74,-12
NLD,BEL,2007.0,86,99,-13
ESP,NOR,2001.0,5,5,0
ZWE,ZAF,2000.0,6,2,4
IRL,FRA,1999.0,4,13,-9
ITA,NOR,2012.0,14,12,2
VEN,GBR,2006.0,12,7,5
MEX,NLD,2014.0,8,8,0
RUS,UKR,2005.0,38,46,-8
ESP,SRB,2004.0,5,3,2
SYR,USA,2001.0,11,2,9
GBR,NOR,2000.0,34,37,-3
GTM,ARG,2017.0,1,1,0
GRC,FRA,1998.0,19,23,-4
MKD,SRB,2001.0,13,13,0
DEU,NGA,2002.0,8,6,2
HUN,DEU,2015.0,45,30,15
BEL,BGR,2004.0,9,5,4
SEN,FRA,2003.0,33,41,-8
GEO,USA,2023.0,135,101,34
POL,IND,2023.0,17,40,-23
SAU,DEU,2002.0,2,5,-3
PAK,USA,2001.0,32,22,10
USA,HUN,2010.0,68,95,-27
AUT,HUN,2022.0,20,37,-17
ROU,BEL,2007.0,10,4,6
CHE,CZE,2001.0,8,10,-2
ITA,SRB,2012.0,9,3,6
JPN,IRL,2001.0,5,4,1
ITA,FRA,2001.0,198,206,-8
RUS,ITA,1997.0,23,28,-5
GBR,SGP,1999.0,35,26,9
CAN,RUS,2000.0,7,40,-33
RUS,ESP,2008.0,14,10,4
FRA,ARE,2012.0,8,4,4
ARE,FRA,2013.0,4,5,-1
GBR,SWE,2015.0,199,131,68
ESP,COL,2008.0,38,25,13
SWE,GBR,2000.0,93,109,-16
JOR,DEU,2000.0,5,4,1
NZL,CHE,2001.0,5,4,1
SGP,NZL,2010.0,8,10,-2
PRI,USA,2001.0,70,63,7
GBR,UKR,1999.0,14,17,-3
CZE,NLD,2017.0,5,6,-1
AUT,RUS,2002.0,10,13,-3
USA,CZE,2002.0,39,67,-28
AUT,ROU,2011.0,5,4,1
SAU,ARE,2000.0,14,6,8
USA,DNK,2007.0,93,95,-2
NOR,CHE,2005.0,1,9,-8
AUS,IRN,2004.0,15,8,7
CUB,MEX,2000.0,18,10,8
NLD,ZAF,2005.0,19,7,12
BRA,CHL,2012.0,15,12,3
GUF,FRA,2010.0,16,25,-9
GUY,GUF,2015.0,1,1,0
QAT,USA,2023.0,45,23,22
EGY,DEU,2006.0,21,36,-15
UGA,KEN,2007.0,7,1,6
KAZ,RUS,2004.0,8,5,3
RUS,GEO,2016.0,6,5,1
SGP,USA,1997.0,36,43,-7
GHA,GBR,2013.0,15,23,-8
GBR,UGA,2001.0,3,2,1
BEL,PRT,2000.0,7,3,4
AUS,POL,1997.0,6,6,0
FRA,AUT,2009.0,28,26,2
AUS,BEL,2006.0,4,8,-4
ITA,SVN,2008.0,6,4,2
FRA,ROU,1999.0,26,28,-2
PSE,ISR,1998.0,4,4,0
UKR,DEU,2005.0,40,17,23
FIN,USA,1997.0,62,74,-12
JPN,DEU,2005.0,128,103,25
SWE,NLD,2001.0,35,41,-6
BLR,DEU,1998.0,14,9,5
GBR,MLT,2010.0,10,7,3
MLT,DEU,2021.0,6,3,3
GBR,ARG,2021.0,22,19,3
CAN,IRN,2012.0,56,206,-150
USA,KEN,2002.0,25,43,-18
CAN,KEN,2009.0,2,6,-4
ESP,BRA,2005.0,29,28,1
EST,DEU,1999.0,3,3,0
IRL,CAN,2012.0,34,33,1
USA,HRV,2021.0,16,18,-2
POL,GRC,2006.0,3,2,1
GRC,POL,2007.0,1,5,-4
ITA,ESP,2015.0,164,201,-37
RUS,ESP,2015.0,8,10,-2
IRN,IRQ,2015.0,11,5,6
VNM,AUS,2015.0,17,20,-3
ESP,RUS,2010.0,7,6,1
USA,TUN,1997.0,3,1,2
UKR,POL,1998.0,21,11,10
CHE,ESP,2008.0,50,61,-11
CHN,AUS,2004.0,63,58,5
IND,BGD,2009.0,12,11,1
CAN,SGP,2000.0,16,13,3
BLR,UKR,1998.0,3,7,-4
NOR,PRT,2013.0,5,3,2
JPN,MEX,1998.0,8,4,4
MEX,FRA,1999.0,21,36,-15
SWE,EST,2000.0,3,11,-8
HKG,ITA,2004.0,1,1,0
JPN,AUS,2006.0,53,42,11
GBR,HKG,2004.0,27,35,-8
CHN,IND,2003.0,7,4,3
GBR,PRT,2016.0,86,131,-45
GBR,VNM,2002.0,14,6,8
ARG,BRA,2014.0,32,39,-7
USA,IRN,2002.0,32,19,13
IRN,CHN,2020.0,83,19,64
USA,TUN,2005.0,7,6,1
JPN,SWE,1998.0,33,27,6
SWE,JPN,2000.0,31,25,6
RUS,ESP,2004.0,7,9,-2
AUT,USA,1998.0,119,83,36
CHE,CHL,2000.0,5,6,-1
FIN,FRA,2017.0,28,34,-6
FIN,FRA,2022.0,25,33,-8
CMR,FRA,2012.0,17,23,-6
CAN,POL,2005.0,12,16,-4
BEL,GRC,2005.0,11,9,2
RUS,CHN,2010.0,6,5,1
ECU,FRA,2012.0,5,4,1
BLR,USA,2003.0,20,15,5
SWE,CHE,1998.0,22,24,-2
USA,ARG,2001.0,101,145,-44
AUT,AUS,2004.0,28,24,4
KOR,IRL,2008.0,3,2,1
RUS,UKR,2002.0,53,70,-17
SAU,USA,2010.0,39,131,-92
ETH,AUT,2018.0,2,5,-3
HRV,PRT,2019.0,3,1,2
POL,CHE,1998.0,14,13,1
UKR,FRA,2011.0,15,15,0
FRA,BGR,2000.0,13,10,3
ITA,KOR,2003.0,2,4,-2
GBR,FIN,2022.0,80,63,17
AUS,NZL,2000.0,86,117,-31
BGD,JPN,2000.0,26,13,13
CHN,FRA,2017.0,191,221,-30
DEU,FIN,2021.0,62,49,13
CHN,BGD,2019.0,33,37,-4
KOR,SGP,2020.0,29,41,-12
SAU,USA,2023.0,81,144,-63
USA,MAC,2023.0,7,5,2
FIN,FRA,2018.0,27,26,1
RUS,VNM,2016.0,14,5,9
COL,CUB,2018.0,2,3,-1
PAK,DNK,2020.0,7,7,0
NZL,AUS,2017.0,156,139,17
FRA,SEN,2015.0,39,28,11
FRA,GAB,2003.0,2,7,-5
GBR,FIN,2018.0,79,56,23
GBR,CYP,2019.0,47,23,24
TUR,FRA,2016.0,26,27,-1
DEU,NZL,2018.0,37,30,7
RUS,DEU,2013.0,110,113,-3
GBR,SRB,2019.0,8,10,-2
NGA,NLD,2016.0,3,1,2
DEU,UGA,2016.0,10,6,4
GBR,PAK,2010.0,52,39,13
ETH,NOR,2021.0,13,10,3
USA,NPL,2016.0,29,31,-2
TUR,PAK,2017.0,14,20,-6
LBN,BEL,2014.0,6,2,4
AUS,JPN,2016.0,76,56,20
SAU,CHE,2018.0,6,16,-10
CHN,POL,2016.0,5,7,-2
BEL,POL,2020.0,18,10,8
DEU,SAU,2018.0,28,24,4
GUM,USA,2023.0,15,5,10
PAK,ITA,2015.0,10,21,-11
USA,NZL,2022.0,82,111,-29
MEX,BRA,2016.0,26,26,0
AUS,NPL,2019.0,12,14,-2
AUS,NPL,2021.0,13,19,-6
AUS,IRL,2023.0,29,24,5
ROU,SWE,2017.0,10,3,7
NCL,FRA,2021.0,29,32,-3
FRA,NCL,2022.0,27,15,12
IRL,FRA,2020.0,45,33,12
USA,GRC,2023.0,43,63,-20
AUS,PRT,2023.0,6,5,1
JPN,SGP,2016.0,54,37,17
GBR,PER,2021.0,6,13,-7
FIN,KOR,2019.0,3,2,1
MYS,FIN,2014.0,3,4,-1
BGD,AUS,2013.0,50,10,40
FRA,PAK,2013.0,38,8,30
SWE,RUS,2011.0,11,15,-4
TWN,ETH,2020.0,16,3,13
TUR,GBR,1998.0,15,50,-35
BRA,PER,2017.0,44,15,29
HUN,NOR,2017.0,7,3,4
FRA,JPN,2022.0,75,57,18
URY,USA,2017.0,16,13,3
KEN,RWA,2017.0,4,1,3
MEX,CAN,2017.0,57,51,6
BEL,UKR,2020.0,3,3,0
USA,TZA,2022.0,25,15,10
AUS,FJI,2017.0,13,8,5
BEL,USA,2022.0,147,142,5
ROU,SWE,2016.0,3,3,0
CAN,ITA,2016.0,50,78,-28
BFA,CAN,2019.0,4,1,3
EGY,FRA,2013.0,13,19,-6
FIN,NOR,2023.0,19,9,10
GBR,ISL,2023.0,4,4,0
IRQ,USA,2016.0,16,20,-4
ESP,CAN,2021.0,69,72,-3
USA,PRT,2019.0,73,64,9
ETH,CAN,2021.0,5,8,-3
FRA,JPN,2017.0,79,91,-12
IRN,NLD,2015.0,30,22,8
LKA,AUS,2015.0,30,14,16
IRQ,CHN,2017.0,4,13,-9
CZE,GBR,2014.0,31,47,-16
CHE,TZA,2018.0,4,10,-6
GBR,NGA,2020.0,94,78,16
AUS,FIN,2020.0,24,15,9
MYS,CHN,2010.0,8,3,5
IRQ,SWE,2023.0,2,4,-2
PAK,CAN,2023.0,27,16,11
NLD,CHN,2017.0,142,122,20
SWE,CHN,2016.0,97,113,-16
CZE,DEU,2010.0,30,29,1
PHL,GBR,2020.0,11,12,-1
POL,BEL,2020.0,10,18,-8
AUS,ARE,2020.0,25,18,7
ISR,TWN,2019.0,2,1,1
FIN,DEU,2013.0,38,40,-2
BGR,CZE,2018.0,2,2,0
DNK,NLD,2020.0,39,59,-20
RUS,TUR,2007.0,4,2,2
ISR,CHE,2020.0,18,11,7
NLD,DNK,2014.0,37,23,14
CHL,DNK,2014.0,1,4,-3
DEU,CHL,2018.0,48,63,-15
ESP,CHL,2023.0,56,87,-31
NOR,ETH,2021.0,10,13,-3
KOR,CHE,2017.0,19,13,6
MYS,SDN,2018.0,14,5,9
SVK,USA,2016.0,15,9,6
ESP,ARG,2012.0,96,85,11
AUS,JPN,2018.0,66,54,12
DEU,MEX,2018.0,35,50,-15
LTU,CHE,2019.0,5,4,1
MYS,IDN,2022.0,63,56,7
DEU,FIN,2019.0,66,62,4
MYS,BRN,2018.0,5,6,-1
FRA,CAF,2000.0,3,5,-2
GBR,IRN,2019.0,50,85,-35
SWE,CHE,1999.0,19,32,-13
SGP,HKG,2022.0,43,39,4
BEL,CHN,2021.0,78,99,-21
QAT,ARE,2018.0,11,7,4
CHN,FRA,2018.0,190,281,-91
NAM,DEU,2022.0,2,1,1
CZE,NLD,2016.0,13,10,3
DNK,AUS,2000.0,10,19,-9
IND,CAN,2013.0,130,96,34
GBR,IRQ,2016.0,55,12,43
REU,FRA,2015.0,35,25,10
GUY,NGA,2022.0,1,1,0
MEX,GBR,2017.0,47,75,-28
CMR,ZAF,2018.0,7,10,-3
JAM,USA,2020.0,23,10,13
BRA,LUX,2020.0,2,1,1
BFA,CIV,2015.0,12,1,11
NGA,CHE,2015.0,10,1,9
PER,ITA,2022.0,3,2,1
FRA,AUT,2019.0,62,38,24
TUR,GBR,2020.0,108,79,29
BEL,NGA,2021.0,4,3,1
KOR,AUS,2020.0,67,29,38
IRN,FIN,2020.0,44,7,37
GBR,HRV,2020.0,10,8,2
SVK,SVN,2005.0,15,10,5
FIN,CHN,2015.0,23,25,-2
JPN,SWE,2020.0,40,23,17
CHN,NOR,2014.0,13,22,-9
ISR,IND,1999.0,4,24,-20
ITA,IRL,2020.0,51,29,22
IRN,DEU,2016.0,101,39,62
FRA,NCL,2016.0,26,28,-2
LBN,QAT,2016.0,7,5,2
CAN,FIN,2017.0,17,29,-12
USA,POL,2016.0,128,141,-13
MAR,CAN,2008.0,6,4,2
MEX,ARG,2015.0,17,22,-5
ITA,LBY,2017.0,2,4,-2
USA,ECU,2019.0,40,26,14
ECU,BEL,2020.0,7,7,0
ROU,CHE,2020.0,15,13,2
MEX,GBR,2018.0,68,62,6
AUT,POL,2021.0,14,17,-3
FRA,DZA,2020.0,123,69,54
RUS,IRQ,2022.0,9,8,1
HUN,ROU,2022.0,15,25,-10
AUS,DNK,2021.0,39,39,0
IRL,CAN,2005.0,22,16,6
IND,NLD,2017.0,32,27,5
LBN,FRA,2011.0,25,57,-32
IND,ETH,2017.0,69,18,51
AUS,SAU,2020.0,87,45,42
IRN,MEX,2021.0,8,1,7
USA,HKG,2017.0,168,133,35
SWE,CHN,2017.0,131,114,17
DNK,DEU,2017.0,99,125,-26
CHE,PRT,2005.0,9,6,3
PRT,CHN,2016.0,14,4,10
IND,CHE,2021.0,57,35,22
OMN,KWT,2005.0,1,1,0
ZAF,FRA,2021.0,35,17,18
ITA,DNK,2020.0,55,41,14
DEU,CHL,2022.0,37,41,-4
PRT,CHE,2008.0,11,5,6
SRB,CAN,2020.0,3,2,1
VNM,KOR,2020.0,39,144,-105
IND,NLD,2018.0,29,40,-11
DNK,FIN,2020.0,18,18,0
USA,SWZ,2017.0,4,3,1
TWN,GBR,2019.0,31,38,-7
JPN,AUS,2023.0,30,32,-2
ARE,KOR,2021.0,8,17,-9
PAK,DEU,2014.0,28,34,-6
SVK,DEU,2017.0,7,17,-10
CAN,TUR,2007.0,10,14,-4
VNM,PAK,2022.0,6,1,5
AUT,KOR,2016.0,4,6,-2
USA,MOZ,2019.0,17,7,10
SAU,SGP,2014.0,4,12,-8
MYS,SGP,2019.0,28,14,14
DZA,CAN,2017.0,13,8,5
DEU,NZL,2016.0,33,34,-1
EGY,GHA,2017.0,2,1,1
ISR,ITA,2023.0,12,12,0
KEN,GHA,2020.0,9,2,7
GBR,VNM,2012.0,22,13,9
SWE,SGP,2021.0,5,16,-11
FRA,SWE,2014.0,86,62,24
DEU,HKG,2021.0,22,28,-6
JPN,POL,2020.0,15,7,8
POL,JPN,2022.0,6,11,-5
IND,ARE,2009.0,16,3,13
TWN,DEU,2024.0,1,1,0
MEX,GBR,2016.0,53,63,-10
CAN,SGP,2023.0,17,18,-1
TUR,PAK,2016.0,11,11,0
MEX,CHL,2014.0,18,14,4
CHL,PRT,2015.0,3,4,-1
DNK,PRT,2019.0,11,11,0
SRB,SVN,2016.0,4,6,-2
PHL,TWN,2019.0,15,7,8
BEL,ITA,1998.0,24,21,3
IND,NLD,2016.0,44,31,13
ISR,DEU,2021.0,80,78,2
NLD,LUX,2013.0,5,4,1
USA,THA,2002.0,119,87,32
DZA,CAN,2018.0,11,11,0
SGP,IRN,2015.0,6,14,-8
KHM,USA,2021.0,5,9,-4
MAR,ITA,2019.0,2,7,-5
VEN,USA,2021.0,18,10,8
IDN,JPN,2019.0,84,195,-111
CAN,KWT,2017.0,20,9,11
NLD,KOR,2019.0,9,10,-1
SWE,KEN,2019.0,7,6,1
MYS,IDN,2017.0,107,15,92
CZE,PRT,2020.0,7,6,1
ARG,ECU,2017.0,6,1,5
IRN,ESP,2020.0,42,25,17
BRA,NZL,2020.0,12,8,4
USA,NPL,2022.0,28,49,-21
NLD,ISR,2019.0,14,24,-10
BRA,DEU,2020.0,177,99,78
ESP,IRN,2020.0,25,42,-17
CHN,HUN,2016.0,2,4,-2
JAM,GBR,2021.0,6,2,4
CHN,GHA,2018.0,18,16,2
DEU,HKG,2019.0,16,35,-19
IRL,BEL,2023.0,10,7,3
MNG,CHN,2018.0,4,4,0
CHN,PRK,2019.0,15,8,7
KOR,CAN,2023.0,44,29,15
VCT,USA,2020.0,2,2,0
MNG,DEU,2023.0,1,1,0
VNM,MYS,2022.0,10,8,2
ETH,SWE,2016.0,2,4,-2
LBN,FRA,2021.0,88,78,10
JPN,ARE,2020.0,4,2,2
DEU,LUX,2017.0,38,31,7
MYS,CHE,2017.0,3,1,2
ERI,IND,2014.0,1,1,0
MEX,BRA,2022.0,14,22,-8
USA,VNM,2023.0,41,27,14
KOR,SWE,2020.0,26,12,14
USA,ETH,2020.0,35,24,11
COL,DEU,2018.0,29,25,4
SGP,NLD,2019.0,22,30,-8
IRN,SWE,2020.0,63,18,45
ECU,VEN,2019.0,8,50,-42
GRC,JPN,2021.0,2,3,-1
GBR,IDN,2019.0,48,29,19
OMN,FRA,2020.0,1,2,-1
SGP,JPN,2023.0,14,24,-10
CAN,ITA,2022.0,44,58,-14
BRA,NLD,2017.0,42,32,10
BRA,ITA,2020.0,72,65,7
DEU,KOR,2012.0,38,42,-4
ESP,CHE,2021.0,126,73,53
COL,BEL,2016.0,6,5,1
HKG,PHL,2019.0,4,5,-1
ESP,CUB,2003.0,21,43,-22
POL,CHE,2007.0,13,18,-5
AUT,HUN,2017.0,20,27,-7
BGR,JPN,2020.0,5,2,3
FIN,ESP,2018.0,23,19,4
IRL,NZL,2022.0,7,6,1
USA,IRQ,2020.0,78,26,52
PAK,JPN,2021.0,9,9,0
CAN,DZA,2019.0,8,10,-2
SWE,PRT,2019.0,17,24,-7
CHE,BRA,2019.0,23,29,-6
BGR,DEU,1997.0,17,10,7
CAN,MEX,1997.0,11,6,5
URY,ESP,2021.0,13,16,-3
CAN,CRI,2015.0,3,1,2
POL,ITA,2023.0,20,20,0
NZL,AUS,2016.0,163,126,37
JPN,KHM,2020.0,13,1,12
GRC,DEU,2023.0,44,35,9
ESP,PER,2016.0,26,22,4
FRA,BEL,2023.0,104,119,-15
NLD,TUR,2019.0,22,36,-14
JPN,FIN,2022.0,7,10,-3
SEN,BFA,2018.0,3,3,0
CHE,USA,2024.0,2,4,-2
CHL,DEU,2019.0,44,42,2
CAN,ECU,2019.0,3,1,2
GBR,CYP,2021.0,36,17,19
ESP,COL,2014.0,119,79,40
TUR,BEL,2022.0,27,6,21
CHN,ETH,2023.0,21,5,16
IND,IRL,2009.0,16,7,9
NPL,AUS,2013.0,11,1,10
KOR,FRA,2014.0,29,33,-4
CHL,ESP,2003.0,13,30,-17
ESP,CHL,2010.0,69,64,5
MYS,KOR,2019.0,13,13,0
IRL,SGP,2021.0,7,7,0
CHN,CAN,2001.0,90,50,40
ARG,CAN,2020.0,24,8,16
NLD,MYS,2023.0,1,2,-1
DNK,ESP,2004.0,11,12,-1
USA,LBN,2012.0,63,48,15
MYS,BGD,2010.0,6,17,-11
GRD,USA,2019.0,17,18,-1
CHN,MYS,2020.0,37,78,-41
MYS,ARE,2023.0,22,11,11
NPL,GBR,2023.0,5,3,2
HRV,CAN,2016.0,5,1,4
JPN,ITA,2023.0,16,7,9
EGY,ARE,2006.0,7,13,-6
ETH,IND,2015.0,11,35,-24
FRA,ARG,2017.0,41,32,9
DEU,IDN,2021.0,37,25,12
ESP,CAN,2019.0,80,59,21
USA,UKR,2019.0,20,19,1
RUS,FRA,2019.0,60,54,6
IND,EST,2023.0,8,5,3
HRV,SVN,2000.0,6,7,-1
SVN,HRV,2001.0,8,3,5
HUN,SVK,2019.0,9,10,-1
UKR,USA,2021.0,22,25,-3
CHE,HKG,2019.0,7,10,-3
AUT,KOR,2018.0,10,4,6
CMR,USA,2020.0,12,9,3
ITA,AUT,2023.0,45,41,4
CHN,NOR,2015.0,29,27,2
CUB,PRT,2007.0,4,2,2
IND,PAK,2020.0,44,37,7
LKA,NOR,2022.0,2,2,0
CRI,DEU,2022.0,7,5,2
LKA,CAN,2021.0,4,6,-2
USA,LKA,2017.0,30,18,12
COD,CMR,2021.0,1,3,-2
SWE,IND,2023.0,22,64,-42
DEU,COL,2018.0,25,29,-4
FRA,FIN,2023.0,12,14,-2
CHL,COL,2022.0,31,29,2
IND,BGD,2021.0,39,24,15
BRA,CHE,2023.0,23,16,7
CHL,DEU,2021.0,49,31,18
AUT,CZE,2021.0,15,23,-8
SGP,BEL,2022.0,6,2,4
FRA,LBN,2023.0,26,41,-15
CAN,CHE,2023.0,52,70,-18
ITA,COL,2020.0,9,16,-7
VNM,GBR,2023.0,11,13,-2
USA,LKA,2022.0,19,29,-10
PAK,IND,2011.0,11,17,-6
MAR,PRT,2019.0,1,1,0
SAU,ZAF,2021.0,9,9,0
COL,PER,2021.0,5,9,-4
AUS,NLD,2000.0,26,24,2
DEU,JOR,2021.0,11,11,0
TUR,IND,2022.0,11,13,-2
NPL,KOR,2023.0,7,5,2
CHE,LVA,2020.0,3,2,1
AUT,JPN,2023.0,11,17,-6
HUN,SVK,2021.0,10,13,-3
MYS,YEM,2017.0,16,7,9
YEM,SAU,2020.0,22,12,10
ZAF,SGP,2021.0,12,14,-2
NZL,PAK,2023.0,5,5,0
AUS,THA,2022.0,27,20,7
EGY,BHR,2022.0,6,5,1
LBN,FRA,2019.0,55,106,-51
NPL,CHN,2023.0,11,19,-8
IRL,AUS,2022.0,39,43,-4
NGA,ZAF,2013.0,46,31,15
DEU,POL,2021.0,94,79,15
DEU,HUN,2022.0,28,41,-13
IRN,THA,2023.0,6,3,3
JPN,BEL,2022.0,6,15,-9
PAK,NGA,2021.0,6,7,-1
BRA,MEX,2023.0,18,10,8
ITA,RUS,2022.0,11,30,-19
BEN,SEN,2022.0,1,1,0
KOR,SAU,2020.0,39,11,28
CHL,IND,2022.0,4,17,-13
HRV,ESP,2023.0,5,4,1
CHE,ARE,2018.0,2,1,1
EGY,KOR,2007.0,3,3,0
ISR,DNK,2023.0,4,4,0
AUS,VNM,2013.0,14,9,5
VNM,AUS,2014.0,16,23,-7
COL,DEU,2022.0,33,13,20
MAC,CHN,2024.0,55,6,49
ITA,MLT,2022.0,4,4,0
EST,IND,2022.0,6,11,-5
LTU,UKR,2018.0,2,1,1
GBR,BWA,2022.0,7,4,3
ISR,IND,2020.0,71,141,-70
ISR,NLD,2012.0,10,12,-2
SAU,ARE,2023.0,30,6,24
CHN,RUS,2017.0,14,26,-12
TUN,SAU,2014.0,50,10,40
SWE,AUT,2005.0,11,6,5
USA,UGA,2019.0,39,25,14
USA,SVN,2013.0,7,13,-6
USA,PHL,2021.0,34,46,-12
KWT,NGA,1998.0,3,1,2
CUB,MEX,2023.0,9,2,7
BEL,POL,1999.0,12,9,3
NER,NGA,2001.0,2,1,1
MAR,TUN,2004.0,4,1,3
FRA,DNK,2002.0,28,23,5
SAU,NGA,2015.0,6,4,2
ITA,ESP,2004.0,106,61,45
UKR,JPN,1998.0,3,6,-3
USA,COL,2000.0,33,46,-13
DNK,SWE,2001.0,54,59,-5
DNK,SWE,2004.0,49,65,-16
ITA,CHE,2002.0,118,86,32
JPN,BGR,2000.0,5,7,-2
CAN,FIN,2016.0,13,16,-3
PRT,NOR,2016.0,10,9,1
ASM,USA,2012.0,3,4,-1
ESP,ECU,2016.0,58,28,30
BEL,FIN,1999.0,2,3,-1
ESP,DNK,2002.0,15,13,2
NOR,RUS,2005.0,8,9,-1
MLI,KEN,2020.0,2,1,1
KEN,NAM,1999.0,1,1,0
NGA,SAU,2015.0,4,6,-2
BEL,GRC,1997.0,4,5,-1
TUR,GBR,2007.0,21,33,-12
ZAF,NAM,2009.0,5,1,4
NOR,ZAF,2001.0,4,4,0
SGP,RUS,2017.0,5,3,2
PAK,CAN,2010.0,15,11,4
GBR,UZB,2022.0,1,1,0
HUN,ITA,2000.0,10,1,9
DEU,RUS,2016.0,126,118,8
NLD,JPN,2008.0,15,24,-9
JPN,SGP,2022.0,22,41,-19
SWE,GRC,2019.0,18,33,-15
CZE,USA,1998.0,33,34,-1
MEX,DEU,1997.0,11,7,4
BRA,ISR,2002.0,3,2,1
MYS,FRA,2014.0,6,10,-4
LBN,SAU,2013.0,7,5,2
AUT,DNK,2020.0,11,20,-9
DEU,ARG,1998.0,11,16,-5
BRA,CHL,2005.0,15,7,8
UKR,POL,2007.0,17,16,1
CHE,JPN,2000.0,18,28,-10
BLR,RUS,2012.0,18,19,-1
MWI,AUS,2019.0,2,1,1
TWN,FRA,2019.0,10,11,-1
NOR,ITA,1999.0,5,6,-1
DEU,BGR,2007.0,22,24,-2
DNK,NLD,1999.0,10,21,-11
LUX,DEU,2022.0,31,24,7
SAU,NGA,2001.0,3,3,0
ESP,SWE,2000.0,17,19,-2
RUS,ITA,2002.0,43,31,12
AUT,UKR,2004.0,6,2,4
RUS,FIN,2022.0,53,13,40
GRC,CAN,1999.0,10,8,2
GBR,MEX,2010.0,43,31,12
ARG,COL,2001.0,2,4,-2
ITA,SWE,2014.0,82,40,42
RUS,SWE,2007.0,17,15,2
NGA,GBR,1997.0,20,14,6
NOR,ETH,2011.0,5,2,3
NOR,ETH,2019.0,19,3,16
EGY,QAT,1998.0,2,6,-4
DNK,ESP,2008.0,19,15,4
NLD,FIN,2010.0,16,18,-2
EGY,ARE,2000.0,16,11,5
SRB,FRA,2000.0,6,5,1
CAN,CHE,2000.0,40,50,-10
CAN,ESP,2005.0,20,20,0
FRA,AUS,2013.0,125,85,40
DNK,JPN,2008.0,10,15,-5
DEU,CHN,2007.0,138,155,-17
FIN,RUS,2003.0,26,27,-1
ESP,SRB,2001.0,3,6,-3
CHE,NOR,1999.0,8,3,5
TZA,USA,1998.0,7,5,2
IND,ZAF,1999.0,11,4,7
PER,USA,2002.0,14,28,-14
PER,KEN,2014.0,2,1,1
VEN,BRA,2000.0,4,2,2
GBR,GRC,1997.0,51,36,15
BEL,BFA,2001.0,1,1,0
PER,ESP,2023.0,14,13,1
TUR,KGZ,2019.0,3,1,2
ZAF,NLD,2010.0,23,24,-1
SVK,POL,2018.0,10,8,2
DNK,MKD,2002.0,1,2,-1
GRC,ITA,1998.0,8,14,-6
PSE,ISR,1999.0,5,1,4
FRA,GRC,2013.0,17,63,-46
DEU,UKR,2013.0,19,24,-5
MYS,SAU,2013.0,48,14,34
AUS,QAT,2013.0,7,2,5
CAN,NLD,1998.0,31,34,-3
NGA,GBR,2002.0,26,18,8
ESP,BGR,2009.0,4,2,2
CZE,BGR,2017.0,3,2,1
FIN,PRT,2000.0,4,2,2
DNK,BRA,1997.0,3,1,2
DEU,HRV,1998.0,15,12,3
FRA,SVK,1999.0,3,3,0
CAN,MEX,2005.0,20,17,3
SGP,CAN,1997.0,4,11,-7
ITA,CHE,2005.0,88,95,-7
ARG,ITA,1997.0,6,12,-6
HUN,CAN,1997.0,2,6,-4
KEN,BEL,2002.0,2,5,-3
DZA,EGY,2009.0,1,2,-1
ARG,ESP,1999.0,47,56,-9
MTQ,FRA,2009.0,23,12,11
HRV,AUT,2002.0,6,6,0
DJI,FRA,2010.0,4,4,0
USA,GHA,1998.0,6,7,-1
USA,KNA,2012.0,4,3,1
NLD,ROU,2017.0,3,6,-3
BGR,GBR,1997.0,9,6,3
BGR,DEU,2012.0,19,13,6
SGP,TWN,2016.0,14,23,-9
CAN,ISR,2002.0,25,38,-13
FIN,USA,2005.0,73,66,7
IND,FRA,1999.0,24,16,8
DEU,MEX,2016.0,26,53,-27
DEU,KAZ,2000.0,2,1,1
AUT,ESP,2004.0,11,8,3
GBR,NGA,1998.0,21,19,2
ITA,IRL,2007.0,12,8,4
GBR,HKG,2001.0,39,37,2
BFA,FRA,2002.0,7,12,-5
MYS,IND,2005.0,15,28,-13
TWN,IND,2012.0,35,44,-9
BRA,SWE,2007.0,8,10,-2
SGP,TWN,2022.0,18,7,11
CHE,ARG,2005.0,2,5,-3
VNM,ITA,2002.0,1,2,-1
JPN,CZE,2004.0,9,5,4
NLD,JPN,2004.0,25,13,12
CAN,HUN,1997.0,6,2,4
SWE,AUS,2003.0,38,25,13
MTQ,FRA,2011.0,10,24,-14
FRA,BRA,1997.0,61,30,31
IRN,CHE,2006.0,7,2,5
IND,THA,2013.0,10,3,7
USA,ZAF,2000.0,63,94,-31
GRC,ARE,2019.0,6,1,5
GBR,THA,1998.0,22,10,12
CAN,PAK,1997.0,2,4,-2
GBR,PAK,2000.0,23,23,0
GBR,UKR,2007.0,14,21,-7
KOR,BGD,2013.0,30,13,17
ROU,FIN,2006.0,1,1,0
CHE,CZE,2015.0,18,21,-3
AUS,ESP,2018.0,49,50,-1
FRA,NZL,1998.0,5,3,2
SWE,BEL,2003.0,11,20,-9
AUT,UKR,2001.0,2,2,0
FIN,ITA,2000.0,7,10,-3
MEX,PER,2015.0,8,3,5
USA,CUB,1999.0,3,2,1
BDI,FRA,2006.0,1,1,0
GBR,SGP,1998.0,29,15,14
CUB,CHL,2011.0,10,2,8
HKG,DEU,2007.0,13,8,5
CAN,POL,2002.0,14,14,0
SWE,NLD,2004.0,24,27,-3
BRA,IND,2003.0,3,6,-3
GBR,AUT,2023.0,69,40,29
POL,BLR,2010.0,7,3,4
DEU,BRA,2004.0,43,41,2
RUS,ITA,2005.0,25,27,-2
RUS,ITA,2012.0,20,16,4
FRA,MTQ,2020.0,20,27,-7
SVN,CHE,2019.0,7,3,4
POL,BRA,2008.0,2,2,0
MAR,AUT,2014.0,1,2,-1
EGY,USA,2007.0,51,112,-61
SDN,SAU,2002.0,2,2,0
RUS,AUS,2010.0,13,5,8
FRA,GUF,2009.0,9,21,-12
IRN,JPN,1998.0,3,7,-4
GBR,ZWE,2000.0,5,5,0
GUF,FRA,2000.0,4,5,-1
NLD,CHE,2001.0,62,38,24
CZE,FRA,2009.0,23,20,3
NLD,IRL,2013.0,16,16,0
ESP,NLD,2022.0,86,73,13
NOR,DNK,2014.0,26,40,-14
ZAF,CAN,2009.0,25,15,10
MTQ,FRA,2019.0,26,30,-4
CAN,IND,1997.0,24,24,0
ARE,USA,1998.0,8,8,0
SWE,DNK,2004.0,65,49,16
FIN,CAN,2013.0,15,14,1
CHE,SRB,2005.0,12,2,10
RUS,CHE,1998.0,17,9,8
NLD,ESP,2001.0,42,40,2
BRA,SWE,1998.0,6,3,3
GRC,SAU,2016.0,7,2,5
URY,DEU,1997.0,3,2,1
NOR,FIN,2000.0,4,7,-3
AUS,AUT,2002.0,38,29,9
UKR,KOR,2005.0,2,4,-2
UKR,KOR,2012.0,4,4,0
BOL,FRA,2005.0,5,5,0
DZA,FRA,2000.0,22,35,-13
BEL,RUS,2019.0,9,12,-3
BEL,JPN,2003.0,10,10,0
IND,MEX,2005.0,3,2,1
JPN,CHL,1997.0,1,1,0
ITA,ISR,1997.0,7,6,1
RUS,CAN,2010.0,30,21,9
AUS,AUT,1997.0,23,26,-3
RUS,KAZ,1997.0,8,11,-3
ISR,SWE,2005.0,4,1,3
USA,IRN,1997.0,5,9,-4
POL,RUS,2012.0,6,13,-7
DNK,NOR,2004.0,22,12,10
CAN,ARE,2020.0,33,29,4
NLD,DNK,2001.0,22,34,-12
ARM,USA,2019.0,10,8,2
FRA,SGP,2013.0,35,21,14
PHL,JPN,2005.0,16,13,3
FRA,NZL,2020.0,20,26,-6
HUN,DNK,2011.0,4,2,2
CMR,FRA,2002.0,19,17,2
BOL,FRA,2012.0,5,1,4
AUT,AUS,2001.0,29,32,-3
DNK,FIN,1999.0,10,9,1
MCO,FRA,2020.0,17,16,1
FRA,TWN,2019.0,11,10,1
FRA,TWN,2021.0,14,9,5
USA,LBN,1997.0,16,7,9
DNK,SRB,2011.0,3,1,2
MEX,CHL,2015.0,21,14,7
AUS,SWE,2018.0,59,57,2
CZE,ITA,1999.0,7,4,3
HUN,SWE,2003.0,9,12,-3
SVK,CZE,2007.0,39,22,17
BEL,GBR,1997.0,37,39,-2
THA,GBR,1997.0,9,16,-7
FIN,EST,2002.0,13,7,6
CHL,GBR,2007.0,19,12,7
JPN,POL,2007.0,10,8,2
HUN,JPN,2000.0,13,3,10
DEU,PRT,2004.0,13,17,-4
USA,PRT,2011.0,71,70,1
SGP,DEU,2001.0,10,4,6
AUS,PNG,1998.0,10,3,7
USA,PAN,1999.0,11,12,-1
NOR,SWE,1998.0,28,53,-25
MAR,FRA,2001.0,59,94,-35
GRC,CHE,2003.0,10,11,-1
RUS,TUR,1999.0,2,4,-2
TUR,RUS,2013.0,3,3,0
BIH,HRV,2002.0,15,6,9
IND,PHL,2010.0,3,3,0
CHE,IND,2023.0,23,49,-26
IRQ,JOR,2000.0,1,2,-1
JOR,DEU,2010.0,14,12,2
ZAF,ZWE,1998.0,3,5,-2
ITA,BEL,1997.0,18,16,2
NOR,FRA,2018.0,34,46,-12
GAB,USA,2009.0,2,1,1
UKR,BRA,2001.0,1,1,0
UKR,BRA,2008.0,1,1,0
BHR,IND,1998.0,4,4,0
IND,AUS,2009.0,80,35,45
URY,ARG,2007.0,5,5,0
SWE,ITA,2004.0,14,21,-7
NLD,FIN,2000.0,11,9,2
AUT,NLD,2019.0,30,42,-12
SRB,GBR,1998.0,14,4,10
RUS,POL,2015.0,15,12,3
BEL,MEX,2010.0,4,4,0
BRA,ITA,2007.0,37,24,13
ITA,BRA,2008.0,47,30,17
USA,ROU,2022.0,20,15,5
CAN,NZL,2003.0,30,27,3
DEU,CAN,2000.0,113,77,36
NOR,DNK,2004.0,12,22,-10
UKR,DEU,1997.0,12,13,-1
GBR,ARE,2001.0,19,6,13
CHN,DNK,2009.0,18,14,4
DNK,CHN,2010.0,20,34,-14
CHN,DNK,2011.0,37,22,15
ZWE,USA,2019.0,9,12,-3
ZAF,USA,2014.0,113,145,-32
SGP,TWN,2018.0,22,14,8
AUT,IRN,2019.0,5,16,-11
CHN,ETH,2021.0,47,20,27
AUT,ITA,2014.0,23,59,-36
ITA,CZE,2016.0,16,13,3
CHE,CZE,2013.0,22,16,6
MYS,IRN,2011.0,59,57,2
NLD,HKG,2016.0,4,11,-7
ZWE,GBR,2019.0,5,10,-5
GEO,DEU,2011.0,6,7,-1
CYP,CHE,2015.0,2,1,1
DNK,NZL,2016.0,3,3,0
NZL,DNK,2017.0,6,8,-2
DEU,ZAF,2021.0,30,53,-23
FRA,AUS,2014.0,106,100,6
NZL,THA,2018.0,5,4,1
CHN,IRL,2011.0,17,15,2
USA,GHA,2012.0,24,14,10
GBR,TWN,2006.0,45,16,29
COL,NLD,2023.0,12,3,9
MYS,CAN,2010.0,12,12,0
MOZ,NLD,2018.0,2,2,0
GBR,TTO,2012.0,9,4,5
COL,VEN,2000.0,2,2,0
ITA,MEX,2017.0,20,16,4
TWN,IND,2020.0,56,93,-37
DEU,KEN,2021.0,15,15,0
COD,COG,2012.0,15,17,-2
ZAF,SAU,2014.0,17,7,10
BRA,PRY,2012.0,2,1,1
COL,ESP,2011.0,71,64,7
NLD,COL,2019.0,14,11,3
CHE,CHL,2011.0,11,10,1
CHE,IRL,2021.0,14,12,2
NLD,BEN,2018.0,4,2,2
SOM,ITA,2021.0,2,1,1
DNK,QAT,2016.0,2,1,1
IND,ZAF,2012.0,30,20,10
BEL,PRT,2021.0,23,24,-1
USA,IDN,2014.0,33,28,5
SAU,SDN,2001.0,4,3,1
DEU,CMR,2011.0,6,5,1
NLD,IDN,2013.0,24,13,11
RUS,CZE,2009.0,10,10,0
NLD,NOR,2019.0,40,23,17
ARG,URY,2016.0,9,12,-3
THA,TWN,2016.0,7,15,-8
BEL,PRT,2009.0,5,6,-1
MYS,USA,2015.0,49,46,3
CHN,PHL,2014.0,7,2,5
ESP,EGY,2016.0,27,8,19
CYP,ITA,2020.0,7,8,-1
ITA,SWE,2013.0,71,31,40
ESP,CZE,2014.0,31,12,19
BEL,VNM,2011.0,6,2,4
FIN,NZL,2017.0,3,6,-3
IND,ESP,2011.0,13,10,3
FIN,ITA,2019.0,20,37,-17
RUS,EST,2011.0,6,3,3
IRQ,MYS,2016.0,21,104,-83
CAN,TUR,2012.0,20,19,1
AUS,ISR,2017.0,12,24,-12
IRN,SGP,2008.0,4,1,3
CAN,NZL,2015.0,44,36,8
GBR,TUR,2017.0,70,74,-4
MKD,NLD,2011.0,1,2,-1
FRA,HRV,2011.0,4,4,0
BRA,ITA,2002.0,20,30,-10
ARE,DEU,2017.0,6,11,-5
MTQ,FRA,2023.0,16,8,8
KOR,PHL,2018.0,10,11,-1
YEM,ITA,2021.0,1,1,0
TUR,CHE,2015.0,14,15,-1
CAN,ESP,2020.0,66,74,-8
CAN,POL,2020.0,13,11,2
SVK,CZE,2012.0,63,52,11
RUS,ESP,2013.0,11,9,2
CAN,SGP,2011.0,23,24,-1
BRA,COL,2011.0,31,29,2
PAK,VNM,2019.0,3,3,0
SWE,HUN,2014.0,6,15,-9
DEU,ROU,2017.0,25,26,-1
USA,PRT,2000.0,41,34,7
TUR,ESP,2012.0,7,8,-1
ROU,FRA,2017.0,21,25,-4
FRA,CZE,2011.0,18,23,-5
DEU,DNK,2015.0,150,75,75
PER,FRA,2011.0,7,4,3
SWE,HKG,2015.0,3,3,0
HKG,SWE,2016.0,8,3,5
USA,URY,2021.0,16,13,3
USA,CRI,2020.0,34,24,10
USA,GHA,2002.0,6,15,-9
TWN,IRN,2021.0,4,12,-8
MYS,LBY,2015.0,8,2,6
DEU,ROU,2016.0,24,33,-9
EGY,TUR,2011.0,3,1,2
THA,FRA,2014.0,20,15,5
CHE,THA,2019.0,6,6,0
ESP,EGY,2017.0,16,14,2
IND,SWE,2013.0,59,23,36
EGY,SYR,2020.0,4,1,3
ROU,USA,2015.0,23,23,0
BHS,JAM,2019.0,1,1,0
BRA,NGA,2015.0,6,1,5
ZAF,NZL,2002.0,10,3,7
HUN,ESP,2015.0,5,6,-1
ESP,HUN,2017.0,7,5,2
COL,ESP,2009.0,42,57,-15
MYS,IRN,2021.0,61,25,36
JOR,ARE,2020.0,31,17,14
DNK,AUS,2009.0,23,18,5
ROU,IND,2022.0,4,3,1
MEX,PRT,2014.0,2,4,-2
JOR,QAT,2021.0,8,2,6
LUX,ESP,2018.0,6,6,0
KEN,ETH,2022.0,4,4,0
USA,HRV,2010.0,30,17,13
ESP,EGY,2018.0,20,15,5
RUS,TJK,2011.0,6,1,5
GBR,GMB,2016.0,8,8,0
CAN,PAK,2007.0,11,8,3
FIN,ZAF,2016.0,9,5,4
ZAF,FIN,2018.0,6,3,3
BEL,KOR,2003.0,6,1,5
SAU,LBY,2019.0,1,4,-3
SGP,VNM,2014.0,5,8,-3
NCL,FRA,2023.0,13,16,-3
DEU,ALB,2012.0,2,2,0
SEN,FRA,2015.0,28,39,-11
DEU,HRV,2012.0,11,8,3
CMR,GBR,2019.0,10,4,6
MYS,JOR,2012.0,12,9,3
ALB,CZE,2022.0,1,1,0
CHE,TUR,2017.0,11,17,-6
JOR,FRA,2017.0,2,4,-2
USA,BGD,2012.0,35,37,-2
ISR,AUT,2022.0,6,4,2
JPN,GBR,2011.0,113,127,-14
UKR,HUN,2015.0,3,1,2
CMR,DEU,2012.0,5,3,2
DEU,CMR,2019.0,7,2,5
AGO,PRT,2018.0,3,3,0
IRN,HKG,2018.0,5,5,0
ISR,ZAF,2020.0,4,8,-4
CAN,IRL,2014.0,27,47,-20
ITA,SVK,2018.0,6,3,3
AUT,CHN,2018.0,22,24,-2
GBR,LKA,2010.0,9,13,-4
SGP,AUS,2009.0,54,55,-1
CHL,BRA,2020.0,16,47,-31
PRT,ITA,2008.0,6,16,-10
ITA,NOR,2007.0,14,9,5
CRI,PRI,2015.0,1,2,-1
MYS,JPN,2005.0,8,10,-2
IRN,CHN,2012.0,6,5,1
FIN,USA,2020.0,104,100,4
KWT,USA,2019.0,20,37,-17
POL,DEU,2015.0,74,86,-12
SWE,UKR,2015.0,5,8,-3
ARE,ITA,2017.0,4,14,-10
USA,LBR,2015.0,5,1,4
FRA,PAK,2015.0,31,5,26
PAK,IDN,2021.0,10,1,9
IDN,FRA,2023.0,7,3,4
NOR,CHN,2015.0,27,29,-2
ZAF,DZA,2013.0,3,1,2
HUN,CHE,2021.0,16,17,-1
USA,TTO,2011.0,9,10,-1
MYS,PAK,2015.0,68,49,19
RUS,LTU,2017.0,5,1,4
IRN,IRQ,2013.0,13,1,12
DEU,SYR,2013.0,6,2,4
ESP,IND,2020.0,26,31,-5
ARE,USA,2012.0,21,68,-47
CAN,BEN,2021.0,3,2,1
TUR,GRC,2011.0,4,3,1
ISR,TUR,2019.0,3,5,-2
JPN,TUR,2017.0,7,7,0
NOR,DEU,2015.0,48,59,-11
CHE,CHL,2019.0,5,9,-4
CAN,QAT,2019.0,28,10,18
NGA,ZAF,2015.0,67,46,21
ISR,ARG,2022.0,4,1,3
IDN,BEL,2020.0,8,7,1
CHE,HRV,2017.0,3,9,-6
IRQ,MYS,2022.0,41,99,-58
TWN,AUS,2015.0,17,15,2
MNG,KOR,2017.0,2,7,-5
SVN,SVK,2018.0,24,19,5
SVK,SVN,2020.0,4,27,-23
CHN,GRC,2011.0,2,5,-3
BRA,CHL,2020.0,47,16,31
FRA,QAT,2014.0,17,6,11
QAT,FRA,2015.0,9,25,-16
JPN,BRN,2020.0,1,3,-2
ARE,CAN,2016.0,15,41,-26
ISR,DNK,2021.0,7,6,1
MYS,CHN,2011.0,9,7,2
FIN,NOR,2021.0,34,23,11
CAN,BGR,2014.0,2,2,0
SGP,FRA,2015.0,34,48,-14
POL,CHN,2018.0,12,13,-1
DEU,MAR,2023.0,3,6,-3
BGR,USA,2017.0,9,22,-13
KOR,ETH,2020.0,14,4,10
CHN,SGP,1997.0,30,12,18
SWE,IND,2021.0,37,73,-36
TUR,CYP,2007.0,14,6,8
NOR,SGP,2020.0,1,5,-4
HKG,GBR,2016.0,67,53,14
SRB,JPN,2012.0,1,1,0
ISR,ITA,2019.0,21,26,-5
GUM,USA,2021.0,15,20,-5
CHN,SLE,2021.0,6,2,4
AUS,BRA,2012.0,15,41,-26
TWN,CAN,2009.0,18,17,1
ITA,BGR,2014.0,3,6,-3
SWE,IRQ,2017.0,4,4,0
IND,ISR,2014.0,68,21,47
DEU,ECU,2016.0,9,1,8
LKA,GBR,2018.0,17,22,-5
UKR,USA,2023.0,23,10,13
CHE,SVN,2023.0,2,2,0
MYS,TUR,2017.0,11,3,8
ARG,MEX,2013.0,9,14,-5
BEL,SGP,2014.0,8,4,4
DEU,KAZ,2011.0,2,2,0
ITA,KOR,2015.0,13,12,1
DZA,KOR,2021.0,2,1,1
BEL,ROU,2015.0,7,12,-5
GBR,COL,2018.0,15,24,-9
LTU,USA,2019.0,6,6,0
ITA,ARM,2006.0,1,1,0
KOR,IRN,2016.0,9,23,-14
IRN,TJK,2014.0,2,3,-1
IND,IRN,2010.0,29,4,25
SWE,EST,2021.0,7,5,2
IRN,FRA,2018.0,36,17,19
AUS,IND,2015.0,68,128,-60
SGP,SWE,2012.0,12,12,0
CZE,HRV,2015.0,3,2,1
ITA,IND,2014.0,39,59,-20
CUB,ITA,2015.0,4,4,0
KOR,SAU,2012.0,12,2,10
FLK,GBR,2014.0,2,2,0
SWE,ISL,2020.0,17,19,-2
DNK,IDN,2015.0,3,1,2
MAR,GBR,2021.0,6,10,-4
BGD,GBR,2018.0,22,35,-13
CUB,ESP,2002.0,22,28,-6
SWE,HKG,2014.0,2,6,-4
THA,AUS,2014.0,32,41,-9
SRB,MNE,2023.0,32,16,16
MYS,MEX,2021.0,1,1,0
CZE,CHE,2022.0,22,11,11
RUS,TJK,2021.0,2,3,-1
UKR,SWE,2015.0,8,5,3
PRY,ESP,2018.0,1,7,-6
GBR,PSE,2018.0,7,3,4
MYS,IRN,2019.0,101,30,71
CZE,GRC,2015.0,1,5,-4
DEU,SRB,1997.0,18,8,10
ESP,IRL,2015.0,51,17,34
TUR,ITA,2017.0,19,19,0
DEU,ISR,2017.0,58,75,-17
NZL,CHN,2015.0,25,17,8
SVN,ITA,2014.0,12,10,2
JPN,TUR,2018.0,12,11,1
AUT,HRV,2018.0,5,9,-4
BIH,HRV,2020.0,11,13,-2
RUS,THA,2018.0,2,2,0
COL,BRA,2016.0,49,54,-5
TWN,DEU,2021.0,31,24,7
AUS,JOR,2014.0,7,5,2
AUS,IRQ,2011.0,2,1,1
ITA,JOR,2014.0,3,1,2
IRL,CHN,2018.0,35,30,5
BEL,ROU,2014.0,7,12,-5
ISL,SWE,2014.0,25,15,10
IND,HUN,2015.0,4,2,2
TTO,USA,2018.0,16,11,5
GRC,SWE,2023.0,12,9,3
CHL,AUT,2013.0,2,4,-2
NZL,CAN,2009.0,29,45,-16
BRA,NGA,2014.0,1,3,-2
GTM,MEX,2016.0,7,11,-4
RUS,KOR,2017.0,10,13,-3
FRA,KOR,2019.0,27,28,-1
CHN,AUT,2016.0,22,16,6
AUT,CHN,2017.0,20,15,5
AUT,IRN,2023.0,7,20,-13
ETH,JPN,2021.0,4,3,1
EGY,IRQ,2019.0,13,1,12
DEU,IRN,2022.0,44,142,-98
PHL,IND,2016.0,11,2,9
GBR,HUN,2005.0,20,23,-3
ARG,URY,2022.0,13,8,5
RUS,CZE,2019.0,23,14,9
GBR,GMB,2018.0,6,14,-8
ARG,FRA,2011.0,29,24,5
SAU,AUS,2010.0,4,9,-5
BEL,AUS,2021.0,23,31,-8
GHA,KOR,2023.0,1,3,-2
MYS,NLD,2009.0,3,2,1
NLD,MYS,2011.0,9,4,5
CHL,CRI,2016.0,4,1,3
MAC,USA,2014.0,6,17,-11
CZE,DNK,2014.0,6,4,2
JPN,NOR,2014.0,8,8,0
THA,PAK,2019.0,5,6,-1
ZAF,DEU,2021.0,53,30,23
HUN,JPN,2019.0,8,4,4
CZE,CHN,2020.0,14,25,-11
TWN,SWE,2019.0,5,4,1
SWE,VNM,2021.0,6,4,2
CHN,MAC,2016.0,86,59,27
ITA,ALB,2018.0,8,3,5
EGY,RUS,2014.0,2,4,-2
VEN,COL,2018.0,40,7,33
HRV,SVN,2021.0,10,14,-4
SGP,ZAF,2021.0,14,12,2
GRC,CZE,2015.0,5,1,4
DNK,EGY,2019.0,6,1,5
MEX,LUX,2020.0,1,1,0
TUR,CAN,2022.0,43,24,19
PRT,FRA,2023.0,25,22,3
ISR,IRL,2021.0,4,4,0
KGZ,KAZ,2020.0,3,4,-1
ETH,CHN,2020.0,16,14,2
DNK,ITA,2021.0,38,52,-14
AUS,PRT,2021.0,7,7,0
FRA,SYR,2015.0,9,4,5
GBR,MEX,2019.0,61,72,-11
ECU,CAN,2021.0,8,6,2
BRA,CZE,2022.0,14,7,7
FRA,THA,2022.0,20,15,5
HUN,EGY,2014.0,3,1,2
RUS,ISR,2017.0,18,12,6
JPN,LKA,2021.0,16,5,11
AUS,IRQ,2021.0,37,8,29
LTU,CZE,2021.0,3,1,2
TUR,SDN,2018.0,1,1,0
THA,SGP,2018.0,5,10,-5
VEN,AUS,2014.0,4,1,3
KGZ,CHN,2020.0,2,1,1
VEN,MEX,2020.0,8,6,2
CHN,DZA,2019.0,10,2,8
PNG,IND,2014.0,2,3,-1
GTM,USA,2017.0,16,7,9
USA,GTM,2018.0,17,11,6
CRI,USA,2021.0,28,23,5
JPN,ZMB,2022.0,4,1,3
BRA,CHN,2019.0,26,4,22
GTM,USA,2022.0,7,12,-5
CHL,ITA,2019.0,13,19,-6
DEU,EST,2022.0,9,10,-1
PAK,FRA,2011.0,12,15,-3
CHN,IRL,2021.0,27,28,-1
MYS,ARE,2019.0,16,6,10
BRA,AUS,2017.0,61,39,22
CHE,TUR,2018.0,15,26,-11
MAR,GBR,2019.0,2,4,-2
THA,MMR,2018.0,13,5,8
EST,GBR,2023.0,9,6,3
PER,BEL,2017.0,6,2,4
POL,SWE,2019.0,36,19,17
GBR,SLE,2017.0,4,4,0
JPN,NOR,2015.0,8,5,3
GBR,NZL,2016.0,133,122,11
ZAF,MAR,2017.0,7,1,6
CZE,CAN,2019.0,7,9,-2
HKG,KOR,2020.0,23,18,5
NLD,SGP,2019.0,30,22,8
BGD,IND,2018.0,17,14,3
IRQ,MYS,2018.0,19,182,-163
POL,FIN,2020.0,4,8,-4
BEL,SWE,2022.0,21,19,2
GBR,BRN,2020.0,9,2,7
GRL,DNK,2017.0,11,8,3
ESP,PHL,2022.0,1,3,-2
CHE,SEN,2021.0,1,1,0
ITA,THA,2014.0,7,5,2
IDN,NLD,2018.0,29,47,-18
CHN,NPL,2017.0,8,10,-2
CHL,CAN,2016.0,23,23,0
NLD,PRT,2006.0,11,5,6
USA,SVN,2008.0,10,14,-4
GRC,AUT,2023.0,4,4,0
THA,USA,1998.0,38,48,-10
NGA,TUR,2014.0,3,4,-1
IND,IRQ,2012.0,6,2,4
THA,TWN,2018.0,8,16,-8
BEL,IND,2008.0,6,9,-3
GBR,SLE,2018.0,9,5,4
NPL,PAK,2020.0,2,4,-2
USA,TTO,2019.0,11,11,0
CHE,PRT,2020.0,12,33,-21
BGD,DEU,2021.0,15,12,3
BRA,JPN,2023.0,9,3,6
BGD,NLD,2018.0,6,5,1
JPN,NZL,2020.0,10,15,-5
ZAF,CZE,2022.0,7,2,5
ETH,ZAF,2017.0,6,12,-6
KOR,TWN,2021.0,14,19,-5
NOR,NLD,2020.0,23,35,-12
RUS,IRN,2019.0,4,17,-13
NLD,EST,2017.0,3,2,1
NPL,DEU,2022.0,4,3,1
BGD,FIN,2018.0,3,1,2
CZE,FIN,2023.0,4,5,-1
FRA,IDN,2014.0,15,16,-1
VNM,TWN,2014.0,7,17,-10
JPN,FRA,2014.0,81,97,-16
YEM,CHN,2020.0,3,1,2
DEU,DNK,2014.0,99,102,-3
ECU,PRT,2021.0,4,1,3
COL,CAN,2014.0,12,16,-4
AUS,KEN,2015.0,6,2,4
AUS,BGD,2013.0,10,50,-40
AUS,AUT,2007.0,30,33,-3
SWE,DNK,2013.0,66,81,-15
CHL,CHE,2014.0,11,10,1
NER,ZAF,2016.0,1,1,0
SLV,MEX,2017.0,3,2,1
NPL,KOR,2019.0,6,7,-1
HUN,SVK,2023.0,4,7,-3
NLD,HRV,2021.0,4,5,-1
ARG,GBR,2001.0,17,11,6
IND,SVN,2021.0,7,3,4
DOM,VEN,2021.0,1,1,0
AUS,SGP,2014.0,83,75,8
SAU,PSE,2017.0,2,2,0
CHE,NOR,2005.0,9,1,8
NOR,ITA,2002.0,12,11,1
GRD,USA,2010.0,4,6,-2
CHE,BRA,2010.0,18,18,0
NOR,EST,2005.0,1,1,0
FRA,SWE,2003.0,49,56,-7
SWE,GRC,2006.0,6,4,2
KOR,SWE,2005.0,5,5,0
FIN,DEU,2004.0,22,27,-5
VEN,FRA,1999.0,10,13,-3
IND,FRA,2005.0,42,21,21
IND,ZAF,2005.0,8,6,2
GRC,FRA,2002.0,31,32,-1
CAN,CHL,2013.0,13,16,-3
COL,ARG,2011.0,9,6,3
CAN,BEL,2005.0,18,32,-14
ITA,NOR,1999.0,6,5,1
AUS,CZE,2020.0,15,8,7
NOR,DEU,2008.0,15,62,-47
ROU,NLD,2001.0,8,3,5
PAK,SWE,2014.0,5,23,-18
ISL,AUS,2001.0,1,1,0
GBR,POL,2012.0,62,79,-17
BRA,IND,2001.0,5,9,-4
KOR,RUS,2016.0,5,3,2
DEU,JAM,2016.0,1,1,0
GRC,SWE,2000.0,7,6,1
FRA,GLP,2023.0,18,8,10
FRA,GRC,2001.0,26,19,7
FRA,VEN,2011.0,11,7,4
JPN,IRN,2004.0,13,6,7
SWE,LVA,2000.0,3,4,-1
RUS,KGZ,2010.0,2,5,-3
VEN,ITA,1999.0,4,3,1
ITA,VEN,2000.0,3,2,1
USA,VEN,2012.0,24,30,-6
IND,LKA,2002.0,2,1,1
CAN,ARG,2013.0,14,15,-1
DEU,UKR,2014.0,14,44,-30
COG,FRA,2001.0,7,2,5
NOR,DEU,2004.0,19,33,-14
AUS,IND,2014.0,62,111,-49
FRA,PYF,2003.0,8,10,-2
DNK,IND,2005.0,6,8,-2
NGA,USA,2002.0,13,18,-5
CAN,RUS,2009.0,22,19,3
CHE,BEL,2012.0,36,35,1
LUX,FRA,2013.0,22,26,-4
ESP,MAR,2001.0,8,2,6
CAN,HUN,1998.0,7,6,1
AUT,PAK,2000.0,2,1,1
CAN,NOR,2002.0,14,11,3
DNK,FRA,2010.0,23,29,-6
AUT,BEL,2005.0,3,4,-1
BEL,AUT,2006.0,9,7,2
ESP,BGR,2006.0,3,1,2
FIN,AUT,1999.0,3,5,-2
NLD,GRC,2002.0,9,9,0
JOR,USA,1997.0,9,10,-1
NCL,FRA,2006.0,16,24,-8
FRA,KEN,2000.0,1,1,0
BGR,JPN,1997.0,6,6,0
ESP,URY,1998.0,4,6,-2
CHE,KEN,2023.0,4,7,-3
ITA,SMR,2022.0,5,4,1
OMN,ESP,2021.0,2,1,1
GBR,LAO,2012.0,3,1,2
HUN,AUT,2016.0,36,8,28
ITA,EGY,1998.0,11,5,6
EGY,ITA,2002.0,4,7,-3
SAU,DEU,1998.0,1,3,-2
USA,FJI,1998.0,1,1,0
NOR,SWE,2002.0,39,61,-22
MEX,BEL,2003.0,4,5,-1
NZL,JPN,2000.0,13,6,7
GBR,UKR,1997.0,31,15,16
SRB,USA,2004.0,33,40,-7
ESP,AUS,2002.0,13,10,3
ESP,AUS,1997.0,2,3,-1
FRA,CZE,2009.0,20,23,-3
AUT,ITA,2004.0,19,22,-3
NLD,BGR,1998.0,4,3,1
DEU,GEO,1997.0,2,7,-5
BRA,RUS,1999.0,11,12,-1
AUS,ITA,2016.0,48,63,-15
AUS,MYS,2002.0,11,15,-4
DNK,NLD,2012.0,24,25,-1
USA,SEN,2002.0,3,3,0
MEX,DEU,1998.0,10,10,0
LBN,USA,2010.0,70,49,21
ARE,USA,2002.0,13,27,-14
GBR,SGP,2005.0,54,40,14
POL,GBR,1997.0,22,35,-13
CAN,NLD,2002.0,49,38,11
NOR,DEU,2001.0,22,28,-6
MAR,FRA,2003.0,52,68,-16
JPN,BGR,2011.0,4,3,1
TZA,UGA,2010.0,1,1,0
GRC,ITA,2002.0,22,16,6
ARM,RUS,1999.0,10,6,4
POL,RUS,2020.0,14,16,-2
RUS,IRL,2002.0,2,1,1
GBR,UGA,2003.0,12,5,7
EGY,CAN,2007.0,14,22,-8
HUN,ESP,2001.0,5,1,4
BEL,RUS,2006.0,7,5,2
HRV,AUT,1999.0,4,5,-1
ESP,AUT,1999.0,9,4,5
ZMB,ZAF,2011.0,4,4,0
NOR,DNK,2013.0,29,32,-3
AUS,KWT,2002.0,2,2,0
DNK,FRA,2000.0,18,21,-3
CHE,BEL,2005.0,13,25,-12
EST,USA,1997.0,5,4,1
AUS,COL,2003.0,2,2,0
FRA,LBN,2009.0,43,21,22
CHL,ESP,2001.0,21,35,-14
HUN,SWE,2008.0,11,10,1
ESP,AUS,2005.0,13,11,2
CHL,NZL,2013.0,7,4,3
THA,SWE,2004.0,6,3,3
KEN,TZA,2006.0,5,2,3
GBR,SVK,2001.0,12,8,4
FRA,MYS,1999.0,1,2,-1
KOR,CAN,2011.0,45,44,1
BGR,FRA,2001.0,16,9,7
ISR,NLD,1999.0,8,4,4
TZA,ZAF,2008.0,4,4,0
CAN,THA,2002.0,9,8,1
KEN,ETH,2018.0,12,9,3
BRA,CHL,2007.0,17,12,5
IND,BEL,2000.0,7,4,3
NLD,IRL,2004.0,5,6,-1
SWE,JPN,2009.0,27,30,-3
TWN,CZE,1998.0,2,1,1
KEN,NLD,2004.0,6,6,0
DEU,ARM,2012.0,5,5,0
FIN,JPN,2017.0,17,17,0
SWE,BEL,2004.0,14,10,4
AUT,SVK,2004.0,5,13,-8
JPN,NLD,2018.0,33,29,4
IND,OMN,2006.0,6,4,2
OMN,IND,2007.0,5,8,-3
EST,FRA,2008.0,1,1,0
IDN,USA,2001.0,21,24,-3
DNK,AUS,2011.0,23,22,1
SGP,JPN,2021.0,34,36,-2
IND,CHE,2010.0,38,24,14
CIV,BEN,2006.0,6,2,4
CAN,ARG,2003.0,13,23,-10
KAZ,UZB,2021.0,2,3,-1
NLD,BRA,2001.0,13,18,-5
ESP,CHE,2000.0,29,26,3
CHE,CMR,2010.0,7,1,6
UKR,IRN,2015.0,1,1,0
IRN,UKR,2019.0,2,1,1
USA,CRI,1999.0,7,12,-5
MEX,RUS,2011.0,6,5,1
CHE,TUN,2011.0,4,3,1
ROU,BEL,1997.0,1,4,-3
SWE,POL,2012.0,18,19,-1
SRB,MNE,2006.0,14,11,3
TUN,GBR,2000.0,1,1,0
GBR,TUN,2006.0,1,1,0
UKR,GBR,2006.0,24,16,8
USA,FJI,1999.0,2,2,0
PHL,USA,2008.0,30,34,-4
AUS,GRC,2004.0,2,3,-1
ESP,POL,2017.0,26,19,7
AUS,IRN,2003.0,20,5,15
BRA,CHL,1998.0,18,4,14
CHE,MEX,2002.0,7,3,4
NLD,SVN,2017.0,5,4,1
BEL,ESP,2007.0,18,20,-2
CAN,NOR,2005.0,6,15,-9
UKR,BEL,2013.0,6,2,4
USA,VNM,2009.0,14,8,6
USA,AZE,1998.0,1,1,0
CAN,MYS,2007.0,8,1,7
AUS,VNM,2015.0,20,17,3
DEU,SVK,2004.0,16,18,-2
HUN,BEL,1999.0,7,1,6
BEL,HUN,2003.0,6,9,-3
NLD,HUN,2008.0,10,13,-3
GBR,PHL,1997.0,5,1,4
SRB,FIN,2003.0,2,2,0
NLD,IRN,2011.0,17,28,-11
CAN,IND,1998.0,27,42,-15
USA,BRN,2006.0,2,1,1
CAN,NGA,2013.0,5,5,0
VEN,FRA,2020.0,2,6,-4
NLD,NZL,2003.0,15,7,8
KOR,DEU,1998.0,14,14,0
GEO,RUS,2000.0,3,4,-1
JAM,USA,2002.0,6,12,-6
DEU,NGA,1999.0,6,6,0
BEL,CHE,2001.0,20,18,2
ARG,NLD,1999.0,1,3,-2
DEU,ROU,2022.0,20,23,-3
SVN,AUT,2016.0,14,2,12
BGR,GBR,1999.0,16,7,9
DEU,EGY,2004.0,29,15,14
SGP,SWE,2005.0,5,2,3
JPN,VNM,1999.0,6,4,2
CZE,ESP,2002.0,3,5,-2
RUS,UZB,2001.0,11,16,-5
UZB,RUS,2003.0,5,7,-2
RUS,UZB,2008.0,11,6,5
DNK,GHA,1997.0,1,1,0
ARE,SAU,2011.0,19,10,9
ISR,CHE,2012.0,18,13,5
USA,CZE,1999.0,35,52,-17
CHE,KEN,2010.0,3,1,2
ISL,SWE,2001.0,13,9,4
USA,GHA,2005.0,10,8,2
AUS,TWN,2012.0,21,20,1
AUS,FIN,2002.0,12,6,6
ESP,SRB,2003.0,8,3,5
AUS,TWN,2005.0,14,4,10
GBR,HUN,2002.0,25,30,-5
USA,SVK,2022.0,5,5,0
SYR,SAU,2009.0,2,1,1
ZWE,BWA,2008.0,3,1,2
SWE,TUR,2010.0,2,3,-1
THA,DEU,2001.0,8,3,5
TUR,AUS,1999.0,2,4,-2
IND,ROU,2020.0,5,2,3
SVK,CHE,1998.0,5,1,4
FIN,HUN,2009.0,5,3,2
BWA,USA,2016.0,7,11,-4
DEU,KOR,1999.0,16,10,6
LBN,SAU,2014.0,7,2,5
DNK,PRT,2006.0,3,3,0
SDN,DEU,1999.0,1,2,-1
DZA,DEU,2003.0,2,3,-1
DNK,QAT,2022.0,3,2,1
RUS,BRA,1999.0,12,11,1
BRA,RUS,2007.0,8,2,6
JPN,SWE,1997.0,19,22,-3
IND,CMR,2021.0,5,2,3
BRA,RUS,1998.0,7,12,-5
NOR,ESP,2002.0,6,7,-1
ESP,NOR,2003.0,5,4,1
FRA,SRB,2006.0,6,8,-2
NOR,GBR,2001.0,39,42,-3
DNK,NLD,2005.0,8,17,-9
USA,RWA,2007.0,4,3,1
RUS,ZAF,1998.0,3,1,2
ZAF,RUS,2002.0,10,2,8
MEX,FRA,1997.0,16,18,-2
GBR,THA,1997.0,16,9,7
IND,NGA,2001.0,6,3,3
PRT,IRL,2009.0,6,3,3
DEU,IRL,2001.0,11,14,-3
SRB,RUS,1997.0,3,13,-10
NLD,SGP,2011.0,17,9,8
UGA,AUS,2002.0,1,1,0
FIN,GBR,2010.0,46,54,-8
DEU,FIN,2000.0,31,27,4
DNK,GBR,2014.0,94,101,-7
CHL,DEU,2010.0,27,22,5
TZA,USA,2012.0,14,18,-4
TZA,NLD,2022.0,2,8,-6
IRN,USA,2004.0,34,34,0
JOR,USA,2002.0,15,22,-7
BEL,CHE,2004.0,28,15,13
POL,ARE,2021.0,1,3,-2
ZWE,ZAF,2019.0,38,45,-7
BEL,SRB,2022.0,2,5,-3
COG,CMR,2020.0,1,1,0
CAN,HKG,2016.0,25,38,-13
ZAF,IRL,2018.0,7,6,1
PER,BRA,2016.0,16,22,-6
NZL,CAN,2019.0,50,37,13
IRQ,TUR,2018.0,10,16,-6
ZMB,GBR,2018.0,11,7,4
TWN,HKG,2017.0,16,11,5
KOR,CAN,2021.0,56,36,20
POL,SWE,2021.0,28,17,11
KOR,DNK,2023.0,8,3,5
DEU,BGD,2016.0,6,9,-3
BFA,GBR,2021.0,2,2,0
SRB,HUN,2018.0,7,3,4
PRY,ESP,2016.0,4,6,-2
PAN,USA,2022.0,29,20,9
BLR,USA,2015.0,8,5,3
AUS,GHA,2015.0,7,5,2
CZE,ITA,2012.0,5,8,-3
QAT,AUS,2020.0,10,11,-1
GBR,PAK,2021.0,96,112,-16
BGD,BEL,2017.0,5,6,-1
IRQ,AUS,2019.0,8,30,-22
ECU,BOL,2021.0,1,2,-1
SWE,RWA,2020.0,5,5,0
IND,PHL,2019.0,10,4,6
RUS,ZAF,1999.0,7,3,4
ROU,CHN,2020.0,5,2,3
KEN,CHN,2018.0,13,12,1
NZL,MYS,2015.0,28,24,4
SRB,IRL,2021.0,2,1,1
CUB,ARG,2019.0,5,2,3
CUB,MEX,2019.0,36,18,18
MOZ,PRT,2022.0,5,6,-1
MYS,LKA,2021.0,9,6,3
POL,CHN,2022.0,16,23,-7
PHL,TWN,2023.0,15,5,10
ZMB,TZA,2019.0,4,2,2
EGY,TWN,2020.0,5,2,3
MYS,MMR,2017.0,5,1,4
CHN,NPL,2016.0,8,13,-5
LBR,USA,2021.0,10,22,-12
GBR,EGY,2003.0,25,16,9
CHN,DNK,2024.0,5,5,0
NOR,AUT,2019.0,11,16,-5
BRA,BOL,2019.0,8,1,7
ESP,CRI,2018.0,11,6,5
RUS,BGR,2014.0,5,7,-2
VEN,ESP,2019.0,26,20,6
COL,PRT,2019.0,6,3,3
TZA,CHN,2023.0,8,10,-2
KOR,BEL,2023.0,13,8,5
CAN,ETH,2020.0,5,3,2
RUS,IND,2018.0,9,14,-5
GBR,CYP,2023.0,24,14,10
CUB,ECU,2019.0,14,11,3
ECU,CUB,2021.0,8,9,-1
FRA,SGP,2014.0,40,24,16
IRQ,KWT,2020.0,1,1,0
LUX,SWE,2020.0,3,3,0
LBN,CHE,2020.0,3,2,1
IDN,DNK,2022.0,2,7,-5
MEX,SWE,2013.0,8,3,5
SWE,MEX,2022.0,8,9,-1
FRA,SVN,2023.0,3,2,1
HRV,SVN,2019.0,14,9,5
IND,ESP,2019.0,22,25,-3
ETH,ZAF,2018.0,9,17,-8
DEU,ISL,2018.0,5,3,2
FRA,VNM,2021.0,68,36,32
CZE,POL,2022.0,28,23,5
GBR,ISR,2015.0,49,54,-5
IRL,CHN,2016.0,38,20,18
TUR,SRB,2020.0,6,1,5
CHE,MAR,2022.0,5,1,4
CMR,MAR,2022.0,3,1,2
BGD,KOR,2020.0,26,48,-22
ITA,FIN,2022.0,19,25,-6
VEN,BRA,2019.0,7,6,1
TUR,POL,2020.0,8,2,6
PRT,ARE,2023.0,4,2,2
SGP,CHE,2003.0,3,4,-1
ETH,GBR,2020.0,10,10,0
VEN,ITA,2020.0,3,1,2
SAU,MYS,2023.0,21,40,-19
ZMB,GBR,2017.0,6,5,1
SVN,ESP,2017.0,8,3,5
VNM,POL,2021.0,5,4,1
ARG,DEU,2023.0,27,8,19
PAK,MYS,2023.0,51,90,-39
COL,ARG,2019.0,16,17,-1
IND,BGD,2023.0,17,21,-4
GBR,VNM,2007.0,10,6,4
IND,BGD,2006.0,8,9,-1
KWT,BHR,2022.0,1,3,-2
BRA,CHL,1999.0,7,8,-1
IRN,ARM,2012.0,2,3,-1
SAU,IND,2000.0,6,10,-4
ETH,USA,2011.0,8,16,-8
IND,KWT,2000.0,11,2,9
KWT,IND,2001.0,14,3,11
BGD,SAU,2000.0,1,1,0
GBR,BGD,2022.0,24,36,-12
NOR,BEL,2011.0,3,7,-4
PAK,KOR,2018.0,50,87,-37
TUN,DZA,2021.0,14,3,11
EGY,HUN,2020.0,9,9,0
CAN,NLD,2005.0,39,45,-6
SYR,DEU,2018.0,7,2,5
CAN,MEX,1998.0,24,13,11
CAN,LKA,2021.0,6,4,2
DEU,BGD,2017.0,12,5,7
BGD,CAN,2015.0,28,14,14
BGD,SAU,2023.0,6,6,0
BGD,IDN,2021.0,2,1,1
LKA,BGD,2022.0,1,1,0
BEL,BGD,2002.0,2,2,0
BGD,ITA,2010.0,3,4,-1
GHA,USA,1998.0,7,6,1
ROU,AUS,2015.0,3,2,1
ESP,CRI,2017.0,10,9,1
RUS,CAN,2011.0,24,16,8
DEU,ROU,2018.0,29,13,16
IND,CAN,2001.0,48,27,21
IRL,IND,2020.0,16,32,-16
UGA,USA,2022.0,27,32,-5
PAK,CHN,2024.0,17,17,0
AUT,PAK,2023.0,1,7,-6
CZE,UKR,2021.0,7,11,-4
USA,OMN,2020.0,9,1,8
CZE,JPN,2021.0,6,7,-1
USA,HTI,2017.0,16,8,8
ZAF,SWZ,2007.0,2,1,1
SVN,SVK,2017.0,11,27,-16
BFA,SEN,2022.0,3,1,2
IND,JPN,2012.0,76,81,-5
DEU,NAM,2012.0,2,1,1
IRL,ETH,2022.0,2,1,1
NPL,NLD,2021.0,4,1,3
GBR,PER,2006.0,5,1,4
CHE,SVK,2006.0,2,2,0
AUS,IRL,2021.0,40,35,5
KEN,GBR,2001.0,23,17,6
GRC,LUX,2014.0,4,1,3
AUS,IND,2008.0,24,74,-50
ETH,ZWE,2014.0,1,1,0
ITA,AUS,2023.0,15,27,-12
FRA,DNK,1998.0,22,16,6
CAN,BGD,2007.0,5,7,-2
BGD,CAN,2008.0,11,9,2
NPL,USA,2002.0,6,5,1
IRL,MLT,2019.0,3,1,2
KOR,UZB,2020.0,9,2,7
CAN,TWN,2002.0,12,12,0
SGP,FRA,2008.0,12,17,-5
KOR,ISR,2016.0,3,3,0
ARE,PAK,2014.0,4,8,-4
FRA,GUF,2006.0,15,7,8
NGA,SWE,2009.0,3,1,2
GHA,NGA,2021.0,11,8,3
IRN,HUN,2017.0,3,3,0
TUR,NLD,2022.0,34,14,20
NZL,IDN,2020.0,16,3,13
LKA,USA,2021.0,25,22,3
SWE,PAK,2021.0,19,6,13
BGR,GBR,2020.0,8,14,-6
MEX,GRC,2021.0,2,1,1
ITA,BRA,2013.0,54,27,27
IRL,BRA,2012.0,4,5,-1
DZA,MAR,2019.0,5,1,4
ITA,CHL,2019.0,19,13,6
ITA,HUN,2008.0,10,11,-1
IRL,CAN,1999.0,9,8,1
ETH,CAN,2010.0,2,2,0
SGP,PAK,2021.0,7,10,-3
PRT,NLD,2011.0,18,18,0
ITA,MWI,2021.0,2,1,1
GEO,RUS,2023.0,4,4,0
COL,MEX,1999.0,8,4,4
AUS,PHL,2016.0,17,7,10
CHE,ESP,2013.0,62,82,-20
HUN,SWE,2014.0,15,6,9
USA,IDN,2004.0,25,15,10
TJK,RUS,2018.0,2,7,-5
BEL,DNK,2006.0,3,6,-3
HUN,CAN,1998.0,6,7,-1
HKG,CAN,2001.0,25,19,6
ITA,BGR,2008.0,3,5,-2
THA,GBR,1999.0,16,14,2
CAN,PRT,1998.0,4,1,3
PRT,CAN,1999.0,9,4,5
FIN,ZAF,2022.0,1,8,-7
DNK,BRA,2007.0,2,1,1
JPN,PHL,1998.0,5,5,0
ITA,SAU,2015.0,23,4,19
NLD,RUS,2000.0,12,23,-11
JPN,CHL,2007.0,6,1,5
NOR,NZL,2009.0,3,4,-1
CZE,NOR,2011.0,6,4,2
SAU,PAK,2010.0,13,25,-12
FRA,MDG,2001.0,6,4,2
MEX,RUS,2019.0,7,4,3
POL,AUT,2001.0,9,6,3
ZAF,FRA,2006.0,16,10,6
USA,NCL,2018.0,8,1,7
USA,BGR,2005.0,14,19,-5
BRA,CHN,2011.0,6,3,3
ITA,HUN,2004.0,5,5,0
MTQ,FRA,2006.0,17,12,5
MTQ,FRA,2010.0,20,19,1
PRT,SWE,1999.0,4,2,2
EGY,SAU,2002.0,37,37,0
IND,THA,2001.0,4,2,2
THA,IND,2007.0,5,2,3
IND,THA,2008.0,6,5,1
PAK,GBR,1997.0,11,13,-2
POL,SWE,2009.0,14,12,2
ITA,JPN,2011.0,24,16,8
BRA,SWE,2005.0,5,9,-4
TWN,JPN,1998.0,10,12,-2
ARE,MYS,2023.0,11,22,-11
EGY,ARE,2011.0,10,8,2
USA,MKD,2010.0,10,4,6
ESP,ARE,2017.0,10,4,6
IDN,AUS,2010.0,8,32,-24
DEU,ARE,2008.0,9,2,7
ARE,GBR,2014.0,15,34,-19
BRA,NZL,2002.0,1,3,-2
COL,CHE,2015.0,7,3,4
AUS,PHL,2018.0,7,19,-12
OMN,IND,2020.0,10,41,-31
ZAF,BRA,2009.0,1,4,-3
FRA,ARE,1998.0,2,1,1
BGD,USA,2006.0,12,9,3
ITA,THA,2015.0,5,4,1
NZL,DEU,1999.0,14,13,1
BEL,POL,2005.0,10,9,1
IND,EGY,2014.0,7,4,3
KWT,SWE,2011.0,1,1,0
DNK,RUS,2000.0,9,14,-5
FIN,NOR,2019.0,23,20,3
DNK,CHE,2006.0,17,14,3
FRA,CAF,2011.0,4,2,2
DNK,CAN,2021.0,25,30,-5
SRB,GBR,1997.0,7,4,3
GBR,SRB,2000.0,8,14,-6
GBR,UKR,2002.0,12,22,-10
VNM,SWE,2001.0,7,2,5
SWE,NZL,2013.0,8,18,-10
ESP,RUS,2021.0,18,12,6
CHE,IRL,2009.0,14,7,7
NOR,LUX,2020.0,3,2,1
IND,HKG,2003.0,3,6,-3
FRA,DZA,2005.0,40,39,1
GTM,COL,2011.0,1,1,0
NLD,MWI,2015.0,3,2,1
CHN,BEL,1999.0,6,6,0
COL,CAN,2015.0,13,20,-7
USA,PHL,2000.0,22,19,3
JPN,CHE,2000.0,28,18,10
USA,KEN,1998.0,13,12,1
ZAF,NAM,2006.0,1,6,-5
SWE,CHE,2005.0,34,26,8
KOR,GBR,2009.0,30,33,-3
DEU,PHL,2010.0,4,6,-2
ZAF,KEN,2005.0,6,9,-3
ZAF,CHE,2011.0,10,18,-8
NZL,IRL,1999.0,3,2,1
SAU,SDN,2004.0,4,2,2
ISR,IND,2002.0,15,16,-1
PHL,USA,2001.0,25,13,12
TUR,AZE,2004.0,7,8,-1
USA,VIR,2005.0,1,3,-2
VIR,USA,2006.0,6,2,4
CHN,HRV,2018.0,2,1,1
SVK,SVN,2007.0,27,16,11
BEL,CUB,2002.0,3,1,2
FRA,IND,2003.0,17,32,-15
CAN,SAU,2004.0,22,22,0
CHE,ZWE,2008.0,2,2,0
CHE,ZWE,2014.0,1,1,0
POL,FIN,1998.0,2,2,0
ISR,EST,2016.0,1,1,0
IRL,IRN,2003.0,7,1,6
GRD,USA,2006.0,2,3,-1
NZL,ZAF,1999.0,2,8,-6
HRV,CHE,1997.0,2,2,0
SGP,CAN,1998.0,6,16,-10
GBR,LBN,2015.0,10,3,7
CIV,FRA,2011.0,22,49,-27
ARE,EGY,2000.0,11,16,-5
CAN,EGY,2013.0,35,27,8
USA,SVN,2015.0,12,14,-2
MLI,FRA,1998.0,4,2,2
AUS,ZAF,2017.0,39,48,-9
BGR,GBR,2007.0,3,12,-9
BGR,ESP,2010.0,4,1,3
IND,DNK,2013.0,17,12,5
FRA,CUB,2016.0,4,5,-1
AUS,POL,1999.0,4,4,0
ECU,CHL,2014.0,12,2,10
NLD,ZAF,2007.0,9,17,-8
ZAF,NLD,2009.0,23,17,6
SAU,OMN,2009.0,3,3,0
ARE,NGA,2023.0,2,3,-1
CHL,BRA,1999.0,8,7,1
NPL,AUS,2014.0,8,3,5
AUT,SVK,2014.0,11,13,-2
CHE,ZAF,2000.0,2,1,1
AUT,NOR,2013.0,11,3,8
BRA,BEL,2004.0,11,10,1
SWE,TUR,2023.0,4,17,-13
COL,PAN,2010.0,3,1,2
ISR,DNK,2011.0,6,2,4
FRA,REU,2021.0,30,22,8
EGY,BEL,2007.0,1,6,-5
JPN,NPL,2002.0,10,1,9
JPN,DNK,1999.0,6,9,-3
CHL,CAN,2018.0,25,22,3
SWE,ESP,2005.0,26,22,4
CAN,POL,2007.0,17,15,2
RUS,BEL,2010.0,14,4,10
IND,LKA,2005.0,4,2,2
ESP,PAK,2019.0,10,5,5
CUB,CHL,2006.0,5,4,1
SWE,AUS,2004.0,40,30,10
SRB,ITA,2007.0,19,5,14
LBY,OMN,2012.0,1,1,0
ARE,USA,2005.0,10,30,-20
USA,BGR,1997.0,9,20,-11
ITA,HUN,2014.0,5,7,-2
OMN,EGY,2010.0,4,4,0
GBR,TWN,2000.0,27,16,11
IRL,CHE,2003.0,6,8,-2
MCO,FRA,2005.0,6,7,-1
BEL,LUX,2007.0,9,9,0
DEU,PHL,2000.0,2,1,1
CHE,MEX,2005.0,6,1,5
DNK,ISR,2020.0,5,5,0
SWE,AUT,1998.0,4,2,2
IRL,FRA,2012.0,47,34,13
GBR,CHL,2001.0,10,1,9
MDA,ROU,1997.0,2,1,1
IND,OMN,2000.0,4,2,2
CHL,FRA,2003.0,14,11,3
USA,BRB,2005.0,9,1,8
KAZ,DEU,2021.0,9,8,1
USA,PAN,2005.0,16,11,5
MKD,SRB,2003.0,9,23,-14
TWN,IND,2007.0,16,43,-27
GBR,TWN,2010.0,46,26,20
AUS,KOR,2003.0,16,10,6
BRA,CAN,1998.0,15,30,-15
NGA,GBR,1998.0,19,21,-2
KOR,BGR,2008.0,2,1,1
DEU,SRB,2005.0,29,21,8
AUS,MYS,1997.0,2,2,0
AUS,IND,2004.0,10,31,-21
DNK,RUS,2010.0,5,5,0
KOR,UKR,2008.0,5,4,1
USA,JOR,2000.0,9,23,-14
OMN,JOR,1998.0,2,3,-1
ESP,ARE,2022.0,11,2,9
IND,BRA,2003.0,6,3,3
NGA,ZAF,2004.0,12,5,7
SAU,AUS,2000.0,4,1,3
QAT,SAU,2008.0,1,2,-1
NLD,PHL,1998.0,2,1,1
FRA,ISR,1999.0,27,23,4
JPN,CHE,2006.0,27,31,-4
TZA,BEL,2004.0,1,1,0
IRN,EGY,2012.0,5,2,3
GBR,NGA,2002.0,18,26,-8
PRT,SRB,2016.0,3,2,1
CMR,FRA,1998.0,14,7,7
RUS,IRN,2009.0,4,1,3
IND,IRN,2006.0,16,7,9
FRA,UKR,2018.0,22,11,11
ARG,NLD,1998.0,5,2,3
CHE,IND,2009.0,16,29,-13
BGR,JPN,2005.0,7,3,4
HUN,ARE,2003.0,2,1,1
SRB,JPN,2002.0,2,5,-3
PRT,SAU,2015.0,7,2,5
DEU,SVK,2001.0,20,24,-4
BIH,USA,2009.0,4,4,0
CAN,IND,2007.0,43,102,-59
POL,GBR,2002.0,46,39,7
FRA,GUF,2023.0,30,21,9
SAU,ARE,2011.0,10,19,-9
VEN,CHL,2019.0,21,2,19
VEN,CHL,2021.0,19,3,16
PER,USA,1999.0,13,15,-2
ARG,MEX,2003.0,8,12,-4
POL,TWN,2007.0,2,1,1
ROU,CAN,2016.0,4,8,-4
MAC,MAR,2011.0,9,10,-1
FRA,ZAF,2017.0,25,18,7
FRA,CAF,2019.0,3,1,2
JPN,CAN,2016.0,84,86,-2
KOR,TWN,2019.0,21,7,14
KOR,ESP,2020.0,11,6,5
ISR,JPN,2019.0,7,10,-3
KEN,GBR,2015.0,18,29,-11
JOR,SAU,2022.0,17,26,-9
ITA,ZAF,2015.0,12,5,7
GBR,SVK,2015.0,9,9,0
HRV,FRA,2012.0,8,3,5
ZAF,ITA,2019.0,13,5,8
JPN,ISR,2016.0,5,7,-2
AUS,RUS,2016.0,14,11,3
BEL,CHE,2015.0,51,42,9
NGA,ZAF,2008.0,17,12,5
ISR,FRA,2013.0,28,33,-5
NZL,HKG,2017.0,7,9,-2
CAN,RUS,2019.0,17,26,-9
NGA,KEN,2012.0,1,6,-5
CHN,BEL,2007.0,14,13,1
BEL,DZA,2019.0,10,2,8
GBR,BHR,2020.0,5,8,-3
CHN,PRT,2013.0,12,8,4
EST,CHN,2020.0,4,4,0
BGR,BEL,2013.0,3,3,0
SGP,ZAF,2011.0,1,2,-1
KOR,NLD,2013.0,8,10,-2
MYS,JPN,2012.0,35,69,-34
ETH,DEU,2013.0,5,10,-5
HRV,USA,2019.0,22,15,7
CHE,DNK,2013.0,25,32,-7
EGY,CAN,1998.0,3,6,-3
NOR,NZL,2011.0,3,2,1
URY,CHN,2020.0,1,1,0
PAK,FRA,2009.0,9,3,6
ITA,SGP,2000.0,2,1,1
ITA,PRT,2010.0,29,10,19
SEN,CIV,2022.0,1,1,0
NOR,BRA,2013.0,3,4,-1
DZA,FRA,2011.0,48,138,-90
IRN,FRA,2022.0,40,22,18
BRN,TUR,2018.0,1,1,0
BGD,TUR,2022.0,6,3,3
KOR,BGD,2014.0,27,18,9
IND,IDN,2011.0,14,8,6
NGA,USA,2012.0,36,41,-5
FRA,MDG,2014.0,14,7,7
ARG,BEL,2011.0,3,1,2
THA,DEU,2015.0,16,28,-12
GBR,UGA,2013.0,7,9,-2
PAK,IND,2010.0,19,16,3
KEN,SWE,2011.0,3,5,-2
CHL,ARG,2018.0,26,36,-10
PRT,MAC,2018.0,4,2,2
BRB,JAM,2012.0,3,3,0
BRA,MAC,2020.0,3,1,2
FRA,MLI,2012.0,10,2,8
HRV,SVN,2011.0,11,6,5
ETH,ISR,2015.0,1,1,0
NLD,JPN,2013.0,22,28,-6
GRC,SRB,2011.0,16,3,13
TWN,SAU,2017.0,4,4,0
BRA,BEL,2015.0,24,25,-1
DNK,FIN,2012.0,9,14,-5
CHE,NZL,2013.0,12,19,-7
ESP,JPN,2007.0,10,21,-11
BRA,CUB,2018.0,8,18,-10
ZAF,DEU,2011.0,21,30,-9
AUT,JPN,2011.0,11,7,4
CHE,LUX,2014.0,2,4,-2
KOR,SGP,2012.0,16,28,-12
TZA,KEN,2018.0,9,2,7
HUN,FIN,2013.0,4,1,3
ABW,NLD,2012.0,1,1,0
POL,CHE,2012.0,16,18,-2
THA,AUS,2015.0,21,47,-26
IND,KEN,2020.0,4,4,0
NOR,GBR,2015.0,50,93,-43
POL,SGP,2014.0,9,3,6
ARE,CAN,2022.0,28,22,6
SYC,USA,2018.0,1,3,-2
NOR,ISR,2019.0,5,4,1
MEX,NLD,2013.0,7,6,1
KEN,CAN,2012.0,4,4,0
PAK,JOR,2019.0,2,1,1
TUN,QAT,2019.0,9,1,8
LBY,SAU,2019.0,4,1,3
AUS,BEL,2019.0,23,44,-21
IRL,ESP,2015.0,17,51,-34
TWN,JPN,2020.0,52,63,-11
RUS,AUS,2009.0,14,9,5
ARE,TUR,2019.0,4,5,-1
FIN,JPN,2018.0,10,11,-1
POL,BGR,2011.0,3,2,1
AUT,GRC,2019.0,3,6,-3
BEL,JPN,2014.0,24,19,5
SWE,PRT,2010.0,5,9,-4
BEL,SWE,2017.0,29,22,7
MYS,BGD,2019.0,64,31,33
NGA,KWT,2019.0,1,1,0
IRL,NLD,2004.0,6,5,1
EGY,GBR,2010.0,18,55,-37
GRC,CAN,2012.0,9,5,4
USA,UGA,2006.0,16,9,7
IRL,ISR,2017.0,15,4,11
KOR,PAK,2010.0,6,8,-2
LTU,ITA,2010.0,4,5,-1
DEU,BOL,2012.0,4,1,3
GLP,FRA,2009.0,32,39,-7
NLD,ARE,2019.0,8,5,3
IRQ,GBR,2012.0,6,7,-1
ESP,CYP,2017.0,2,1,1
PAK,CAN,2009.0,14,11,3
CHE,BGD,2020.0,8,2,6
FIN,LTU,2019.0,2,4,-2
MAC,SGP,2019.0,5,1,4
BEL,HUN,2013.0,7,7,0
THA,GBR,2007.0,33,52,-19
SAU,IRL,2016.0,7,5,2
MEX,PRT,2015.0,5,1,4
ZAF,BEL,2011.0,10,5,5
THA,FRA,2015.0,12,22,-10
IRN,TUR,2012.0,17,7,10
ZWE,AUS,2012.0,1,3,-2
AUT,MEX,2012.0,2,3,-1
ITA,IRN,2013.0,16,32,-16
LVA,SWE,2014.0,4,3,1
CZE,CHE,2016.0,19,16,3
FRA,SAU,2013.0,34,3,31
AUT,SVN,2022.0,4,11,-7
MAR,MAC,2016.0,11,10,1
BEL,SGP,2015.0,11,8,3
JPN,TWN,2018.0,52,62,-10
AUS,IDN,2011.0,35,13,22
ESP,RUS,2019.0,10,15,-5
VNM,KOR,2012.0,7,37,-30
DNK,GRL,2018.0,4,7,-3
LUX,GRC,2020.0,2,5,-3
IDN,MYS,2019.0,27,97,-70
LBN,ITA,2018.0,2,5,-3
ESP,COL,2003.0,19,19,0
SRB,SWE,2002.0,5,1,4
TWN,AUS,2014.0,22,13,9
ITA,MNE,2016.0,1,1,0
NPL,DEU,2016.0,2,4,-2
BOL,CAN,2016.0,1,1,0
AUT,FIN,2021.0,12,17,-5
UKR,AUT,2016.0,6,3,3
TUN,PRT,2020.0,5,2,3
DEU,MYS,2022.0,12,14,-2
PER,ESP,2019.0,20,28,-8
USA,KOR,2024.0,8,7,1
ARE,IRL,2016.0,1,5,-4
POL,NOR,2021.0,8,9,-1
CHN,MEX,2014.0,4,2,2
AZE,USA,2018.0,2,6,-4
FJI,AUS,2018.0,10,9,1
NAM,NLD,2019.0,1,1,0
BGD,SGP,2016.0,2,1,1
AUT,POL,2023.0,5,8,-3
THA,KHM,2021.0,17,2,15
LTU,IRN,2017.0,2,1,1
ARE,LBN,2021.0,3,20,-17
FRA,KHM,2019.0,9,8,1
CUB,USA,2003.0,5,10,-5
USA,CUB,2005.0,6,6,0
GEO,GBR,2016.0,3,3,0
AUT,TUR,2019.0,7,11,-4
ECU,USA,2021.0,43,34,9
FRA,TZA,2016.0,2,1,1
AUT,HRV,2022.0,3,7,-4
IRN,AUT,2015.0,11,10,1
IRL,BEL,2019.0,19,15,4
SWE,BOL,2019.0,3,2,1
EGY,FRA,2014.0,13,23,-10
SRB,ROU,2014.0,1,1,0
NZL,KOR,2019.0,4,7,-3
PHL,AUS,2020.0,23,15,8
SEN,USA,2018.0,13,14,-1
DEU,IRN,2018.0,50,99,-49
ZAF,COD,2017.0,2,1,1
NLD,ARG,2014.0,4,7,-3
PHL,THA,2017.0,7,1,6
JPN,NLD,2016.0,21,25,-4
LBN,NOR,2020.0,1,1,0
RUS,ARE,2023.0,6,2,4
BRA,ECU,2013.0,8,2,6
CHL,ESP,2004.0,32,39,-7
MNG,ITA,2021.0,2,2,0
NOR,SAU,2022.0,3,2,1
CHN,LKA,2023.0,5,4,1
BEL,BDI,2022.0,2,1,1
ITA,CAN,2016.0,78,50,28
CHN,AUT,2022.0,17,30,-13
IND,BTN,2017.0,4,1,3
HKG,SWE,2018.0,9,8,1
USA,SLE,2017.0,19,8,11
NLD,ARE,2011.0,2,3,-1
ZAF,TZA,2018.0,16,4,12
USA,GRD,2017.0,12,12,0
CHE,IND,2021.0,35,57,-22
CAN,GRC,2020.0,10,18,-8
GBR,MEX,2009.0,39,36,3
VIR,USA,2023.0,8,4,4
BEL,SUR,2021.0,2,1,1
IRN,NOR,2013.0,15,4,11
GBR,SLE,2016.0,5,2,3
CHN,COG,2021.0,2,1,1
KAZ,NLD,2017.0,4,1,3
SDN,ZAF,2016.0,1,2,-1
PRT,RUS,2021.0,7,3,4
KOR,JOR,2019.0,1,1,0
NPL,AUS,2015.0,5,7,-2
FIN,ZAF,2017.0,6,2,4
EGY,MYS,2016.0,7,6,1
SWZ,GBR,2014.0,1,1,0
IND,RUS,2018.0,14,9,5
GBR,ARG,2023.0,8,13,-5
ZAF,BEL,2021.0,15,8,7
HRV,BIH,2020.0,13,11,2
ETH,ZAF,2022.0,6,12,-6
BEL,CMR,2020.0,8,3,5
KOR,IRN,2017.0,12,23,-11
DNK,AUS,2021.0,39,39,0
EGY,MYS,2017.0,6,9,-3
NZL,DNK,2018.0,3,8,-5
KOR,FRA,2013.0,19,20,-1
OMN,CAN,2007.0,2,5,-3
GBR,SYR,2013.0,9,5,4
HKG,IRL,2016.0,2,1,1
THA,TWN,2017.0,5,15,-10
ZMB,ZAF,2019.0,7,9,-2
SWE,TZA,2017.0,7,7,0
COL,CHL,2019.0,43,26,17
PER,MEX,2023.0,9,6,3
KHM,FRA,2021.0,7,8,-1
NZL,HKG,2022.0,2,4,-2
TUR,NLD,2016.0,27,29,-2
EGY,IRN,2017.0,1,2,-1
BEL,VNM,2019.0,24,10,14
IRQ,RUS,2020.0,5,4,1
JPN,CHE,2023.0,24,11,13
ZAF,KEN,2012.0,13,9,4
RUS,HKG,2023.0,9,1,8
RUS,CAN,2021.0,16,15,1
KAZ,IND,2020.0,2,2,0
BWA,USA,2022.0,10,8,2
UKR,NLD,2020.0,6,4,2
PER,ECU,2018.0,5,3,2
TGO,GHA,2023.0,1,1,0
BRA,UKR,2018.0,2,3,-1
COL,PRI,2020.0,2,1,1
URY,DEU,2020.0,3,3,0
FRA,BGD,2016.0,2,3,-1
IRL,DEU,2008.0,23,47,-24
PER,SWE,2008.0,1,2,-1
ISL,GBR,2016.0,5,8,-3
GBR,ISL,2019.0,13,12,1
USA,PHL,2006.0,12,16,-4
HKG,BEL,2020.0,2,1,1
LBN,CAN,2020.0,24,10,14
CHN,RWA,2020.0,8,1,7
AUS,KOR,2013.0,32,41,-9
NPL,THA,2018.0,4,4,0
CHN,IRL,2019.0,18,36,-18
QAT,MYS,2017.0,2,5,-3
AUS,LUX,2021.0,5,2,3
DEU,MDG,2020.0,1,2,-1
CZE,JPN,2011.0,7,13,-6
CMR,CHN,2019.0,5,2,3
USA,GRD,2022.0,8,16,-8
FRA,NZL,2012.0,18,13,5
SLB,AUS,2021.0,1,4,-3
SWE,SGP,2023.0,8,4,4
PRI,ESP,2018.0,7,2,5
HKG,IRL,2022.0,3,1,2
NPL,THA,2016.0,7,7,0
FRA,CMR,2023.0,5,9,-4
ETH,BEL,2020.0,4,10,-6
GRC,EST,2023.0,2,1,1
GBR,PAK,2009.0,36,36,0
RUS,KOR,2018.0,10,8,2
KHM,FRA,2019.0,8,9,-1
HUN,NLD,2014.0,11,9,2
POL,ARG,2023.0,2,1,1
PRT,IND,2022.0,18,6,12
SVN,AUT,2022.0,11,4,7
BEL,ARG,2021.0,8,10,-2
BEL,PRT,2019.0,10,22,-12
ZAF,SGP,2023.0,6,3,3
MEX,ARE,2020.0,2,1,1
YEM,GBR,2020.0,2,1,1
ARE,AUS,2022.0,13,28,-15
ECU,CUB,2019.0,11,14,-3
KOR,ARE,2023.0,14,2,12
KEN,BEL,2020.0,2,10,-8
GIN,PNG,2021.0,1,3,-2
CUB,ARG,2009.0,2,4,-2
PAK,IDN,2019.0,1,1,0
CRI,MEX,2021.0,5,7,-2
ROU,ESP,2023.0,5,3,2
GHA,BEL,2021.0,5,1,4
UGA,ITA,2021.0,5,3,2
AUT,TWN,2022.0,3,4,-1
RUS,AZE,2014.0,11,13,-2
THA,VNM,2023.0,13,7,6
SWE,BGD,2021.0,9,6,3
CZE,CHE,2017.0,24,14,10
CHL,JPN,2019.0,9,6,3
SWE,IRQ,2022.0,4,1,3
ITA,VNM,2023.0,3,1,2
FIN,PRT,2021.0,9,1,8
PRT,CZE,2020.0,6,7,-1
FRA,PHL,2021.0,5,4,1
BHR,EGY,2021.0,5,7,-2
BGD,NZL,2019.0,1,3,-2
JOR,FRA,2022.0,2,2,0
IDN,CHN,2021.0,9,12,-3
CAN,BMU,2021.0,6,1,5
USA,MAR,2022.0,12,14,-2
KEN,CHN,2022.0,8,17,-9
RUS,CHN,2021.0,43,40,3
IOT,IND,2010.0,1,2,-1
NOR,CHN,2004.0,4,5,-1
LKA,GBR,2022.0,20,15,5
ETH,TZA,2022.0,4,1,3
UGA,ETH,2022.0,3,6,-3
ECU,VEN,2023.0,4,6,-2
ESP,CRI,2022.0,17,6,11
CHE,VNM,2019.0,4,3,1
RUS,MDA,2023.0,2,1,1
KAZ,KOR,2023.0,3,3,0
PRT,IND,2017.0,21,15,6
URY,ESP,2010.0,5,13,-8
CZE,FRA,2023.0,15,15,0
KAZ,USA,2023.0,13,9,4
FIN,NZL,2018.0,4,2,2
IRL,KOR,2022.0,2,4,-2
CHE,SDN,2021.0,1,1,0
LKA,SGP,2019.0,3,4,-1
HUN,PAK,2020.0,3,2,1
USA,SRB,2023.0,8,9,-1
TUN,USA,2023.0,4,7,-3
ITA,CMR,2018.0,5,3,2
MKD,IND,2022.0,1,1,0
SWE,PAK,2009.0,3,7,-4
SWE,RUS,2023.0,8,15,-7
BRA,COL,2009.0,10,17,-7
SWE,HUN,2001.0,11,11,0
GBR,MWI,2005.0,6,6,0
MWI,DEU,2010.0,1,2,-1
DEU,VNM,2005.0,5,4,1
IDN,USA,2008.0,11,24,-13
POL,EGY,2006.0,3,1,2
UGA,NGA,2011.0,2,3,-1
EGY,KWT,2003.0,4,8,-4
NLD,BRA,2008.0,15,14,1
SRB,CAN,2005.0,4,2,2
MKD,DEU,2000.0,4,2,2
CZE,USA,1997.0,36,49,-13
CHE,ROU,2016.0,8,10,-2
DEU,VEN,2002.0,3,8,-5
ZAF,FRA,2000.0,11,16,-5
JPN,BRA,2005.0,9,6,3
PYF,FRA,2003.0,10,8,2
DEU,MWI,2016.0,3,2,1
IRL,ESP,2001.0,4,4,0
USA,LBN,1999.0,28,9,19
UKR,MDA,2003.0,1,1,0
BEL,TUR,2005.0,5,6,-1
JPN,CZE,2013.0,12,6,6
CZE,JPN,2019.0,8,9,-1
DEU,EST,2016.0,8,5,3
GBR,ARG,2000.0,10,16,-6
HRV,DEU,2013.0,14,6,8
FRA,AUS,2004.0,38,30,8
KWT,ARE,2016.0,3,4,-1
CHE,NOR,1997.0,1,4,-3
PAN,USA,2016.0,14,26,-12
POL,BLR,2009.0,3,2,1
BGR,GBR,1998.0,7,3,4
ITA,CMR,2017.0,6,1,5
PHL,SGP,2019.0,1,11,-10
ESP,CUB,2014.0,29,31,-2
SWE,SGP,2010.0,9,2,7
GBR,URY,2017.0,7,2,5
CZE,ESP,2012.0,10,11,-1
FRA,MTQ,2005.0,15,15,0
JPN,POL,2002.0,17,13,4
RUS,TWN,2003.0,6,3,3
NZL,NLD,2020.0,21,13,8
AND,ESP,2011.0,8,1,7
ESP,UKR,2004.0,2,4,-2
DNK,PRT,2010.0,8,2,6
NZL,NLD,1999.0,9,3,6
ARG,CHE,1998.0,1,2,-1
CHE,ARG,1999.0,2,3,-1
UKR,ISR,2002.0,10,4,6
SRB,USA,2008.0,27,29,-2
DNK,CAN,2019.0,32,27,5
NPL,NOR,2005.0,1,2,-1
FIN,POL,2022.0,4,6,-2
ZAF,FIN,2016.0,5,9,-4
FIN,ZAF,2018.0,3,6,-3
ZAF,FRA,2010.0,17,29,-12
DEU,PRI,2001.0,1,1,0
THA,CHE,2011.0,5,4,1
AUS,PAK,2010.0,8,8,0
USA,CRI,2007.0,17,9,8
AUT,CAN,1997.0,11,9,2
NGA,IND,2002.0,2,1,1
TTO,AUS,2011.0,1,1,0
MEX,SWE,2003.0,2,2,0
IRN,AUS,1997.0,5,5,0
ARE,EGY,2006.0,13,7,6
GBR,ROU,2000.0,6,19,-13
NOR,CHN,2001.0,6,4,2
FIN,AUS,2015.0,13,15,-2
FRA,TWN,2000.0,7,3,4
HRV,SRB,2020.0,14,17,-3
AUT,DNK,1997.0,3,2,1
MKD,DEU,2006.0,4,1,3
JAM,TTO,2015.0,7,9,-2
CHE,AUS,2010.0,66,49,17
UKR,POL,1997.0,11,6,5
NOR,NLD,1999.0,7,11,-4
SVN,USA,2007.0,16,11,5
DEU,BGR,2012.0,13,19,-6
CHN,CHL,2002.0,4,1,3
USA,KNA,2020.0,7,5,2
ARG,GBR,2008.0,17,10,7
NOR,GBR,2004.0,34,43,-9
CUB,ECU,2009.0,1,1,0
SWE,UKR,2004.0,3,7,-4
GRC,NLD,2007.0,8,10,-2
FIN,UKR,1997.0,1,4,-3
CHE,SGP,2003.0,4,3,1
CAN,CHL,2003.0,8,6,2
JPN,NZL,1999.0,11,8,3
BRA,DNK,2001.0,4,2,2
HUN,POL,1997.0,1,2,-1
GBR,ISL,2021.0,7,8,-1
CRI,USA,2009.0,19,14,5
BLR,BEL,2006.0,4,3,1
MUS,USA,2000.0,1,1,0
AUS,DEU,1998.0,49,49,0
FIN,GBR,2006.0,28,30,-2
IRN,CAN,1999.0,4,25,-21
ZAF,SAU,2001.0,5,3,2
AUT,NLD,2006.0,10,19,-9
NOR,AUS,1999.0,6,5,1
UKR,TUR,2000.0,7,2,5
HKG,BEL,1998.0,3,4,-1
GBR,LBN,2008.0,3,8,-5
HKG,DEU,2002.0,14,7,7
NZL,PAK,2011.0,4,4,0
ISR,HUN,2002.0,3,1,2
JPN,THA,1998.0,18,16,2
TUR,CHN,2007.0,2,1,1
FRA,ZAF,2022.0,15,21,-6
NLD,SVK,2000.0,3,4,-1
SGP,MYS,2016.0,14,20,-6
FIN,CHN,2013.0,20,25,-5
USA,UZB,2005.0,4,1,3
DEU,PRT,2003.0,19,17,2
CHL,MEX,1998.0,3,2,1
UKR,USA,2010.0,26,41,-15
IND,MYS,2001.0,10,7,3
CHE,DEU,2020.0,545,745,-200
PRT,FRA,2019.0,45,41,4
ITA,LUX,2019.0,10,8,2
CHN,SGP,2020.0,383,497,-114
MYS,OMN,2020.0,25,4,21
CHN,NZL,2018.0,34,30,4
LUX,CHN,2022.0,5,6,-1
CHN,FRA,2022.0,165,275,-110
FRA,CHN,2007.0,55,58,-3
ITA,ARE,2020.0,7,9,-2
AUT,AUS,2014.0,84,60,24
IRN,TUR,2020.0,50,21,29
BGR,ESP,2011.0,8,2,6
CHE,AUS,2021.0,64,81,-17
BOL,BRA,2021.0,3,3,0
AUS,SWE,2017.0,69,36,33
PHL,SGP,2006.0,3,5,-2
NLD,BEL,1998.0,60,63,-3
KHM,FRA,2006.0,2,2,0
DEU,BGR,1999.0,13,29,-16
ESP,DEU,1999.0,81,75,6
RUS,TWN,2004.0,3,8,-5
FIN,SWE,2007.0,38,40,-2
BEL,CAN,2009.0,33,32,1
CAN,NLD,2007.0,47,41,6
OMN,EGY,2021.0,11,7,4
ITA,CHE,1997.0,78,59,19
USA,VEN,1999.0,52,35,17
NLD,BEL,1999.0,66,75,-9
DEU,ESP,2002.0,101,122,-21
SWE,ESP,1998.0,12,14,-2
GBR,ZAF,2013.0,115,88,27
ARG,ESP,1998.0,49,48,1
HUN,DEU,2001.0,37,48,-11
NLD,AUS,2009.0,56,42,14
IND,JPN,1998.0,58,29,29
RUS,FIN,2018.0,37,22,15
REU,FRA,2008.0,26,15,11
CUB,ESP,1999.0,30,26,4
GBR,DNK,1997.0,42,30,12
ITA,NLD,2006.0,59,59,0
FRA,HUN,2014.0,16,17,-1
CHE,EST,2006.0,2,1,1
GBR,EGY,2001.0,21,9,12
GBR,ISR,2013.0,43,36,7
AUT,RUS,1997.0,3,9,-6
SWE,DNK,2001.0,59,54,5
GBR,RUS,2003.0,69,72,-3
SWE,HUN,2003.0,12,9,3
DEU,BEL,1998.0,52,46,6
ETH,ZWE,2003.0,1,1,0
QAT,USA,2010.0,10,22,-12
SRB,HRV,2019.0,17,18,-1
FRA,REU,2023.0,10,12,-2
GBR,POL,1998.0,22,32,-10
BRA,CAN,2002.0,43,37,6
POL,FRA,2003.0,36,35,1
KOR,AUS,1998.0,3,10,-7
AUS,FIN,1999.0,7,7,0
RUS,KAZ,2005.0,20,13,7
ESP,DZA,2015.0,6,2,4
USA,JOR,2021.0,50,70,-20
IRL,FIN,2022.0,8,8,0
FRA,NLD,2019.0,153,104,49
MYS,PSE,2017.0,7,2,5
CHN,LKA,2019.0,6,4,2
TZA,USA,2020.0,29,32,-3
TUR,USA,1997.0,55,59,-4
BEL,FRA,2023.0,119,104,15
ITA,RUS,2017.0,38,14,24
BRA,NLD,2018.0,43,38,5
IND,CHE,2019.0,58,34,24
SGP,HKG,2018.0,40,52,-12
FRA,ARG,2016.0,42,46,-4
PRT,IRN,2014.0,7,12,-5
ARG,AUS,2022.0,4,6,-2
KOR,SDN,2020.0,3,2,1
ARG,DEU,2021.0,54,22,32
IRN,GBR,2005.0,15,69,-54
JPN,NPL,2020.0,17,8,9
SGP,IDN,2021.0,12,8,4
GRD,USA,2011.0,4,5,-1
JPN,ITA,2000.0,26,30,-4
AUT,FRA,2022.0,42,39,3
UGA,AUT,2022.0,1,2,-1
ISR,PSE,1998.0,4,4,0
BRA,TWN,2021.0,3,2,1
HUN,ETH,2022.0,5,5,0
PRT,JPN,2020.0,3,5,-2
GRC,SGP,2022.0,2,1,1
IND,OMN,2019.0,40,16,24
DEU,SGP,2024.0,1,1,0
ETH,SGP,2021.0,2,2,0
USA,MYS,2000.0,19,17,2
ITA,POL,2001.0,16,18,-2
GLP,FRA,2000.0,19,10,9
FIN,SWE,1999.0,43,36,7
DNK,ESP,2001.0,9,10,-1
FIN,SWE,1998.0,48,25,23
DEU,ARG,2020.0,28,39,-11
FRA,CZE,2006.0,15,13,2
NLD,NZL,2001.0,16,12,4
GRC,GBR,2002.0,73,144,-71
FRA,GLP,2009.0,39,32,7
ISR,BRA,2004.0,3,3,0
IRL,SWE,2014.0,21,12,9
DEU,CUB,2003.0,2,3,-1
SRB,HRV,2011.0,12,9,3
ITA,AUS,2009.0,30,15,15
GRC,NLD,1997.0,7,9,-2
MLI,CIV,2019.0,1,3,-2
POL,DNK,2009.0,7,5,2
AUT,DNK,1999.0,4,1,3
DEU,FIN,2009.0,25,43,-18
SVK,ITA,2002.0,14,4,10
USA,MYS,2006.0,21,11,10
NLD,TUR,2021.0,26,37,-11
USA,CMR,1998.0,2,7,-5
KNA,,2023.0,14,0,14
,AND,2009.0,3,0,3
ARG,CRI,2018.0,1,0,1
DEU,PRI,2004.0,3,0,3
,MOZ,2008.0,29,0,29
GAB,,2013.0,27,0,27
,TTO,2008.0,58,0,58
,TJK,2008.0,19,0,19
SYC,ESP,2020.0,1,0,1
,CRI,2007.0,107,0,107
,CYP,2008.0,112,0,112
BEN,DEU,2012.0,2,0,2
,LAO,2008.0,33,0,33
GHA,,2013.0,79,0,79
MYS,VNM,2015.0,4,0,4
SDN,SAU,1999.0,4,0,4
ZWE,ESP,2014.0,1,0,1
AGO,,2021.0,25,0,25
NER,GAB,2015.0,1,0,1
,FJI,2008.0,26,0,26
,BRN,1999.0,5,0,5
IND,ECU,2017.0,2,0,2
,COD,2009.0,14,0,14
ARE,BRA,2015.0,2,0,2
MKD,,2013.0,52,0,52
GUY,,2013.0,2,0,2
,LBR,2008.0,6,0,6
,BFA,2020.0,87,0,87
URY,CHE,2022.0,1,0,1
,PAN,2008.0,43,0,43
ZMB,,2018.0,63,0,63
,LBY,2015.0,42,0,42
SLB,ISL,2011.0,1,0,1
ISL,SLB,2012.0,1,0,1
SLB,,2015.0,1,0,1
PAN,,2012.0,8,0,8
MEX,NPL,2022.0,3,0,3
GTM,SWE,2011.0,1,0,1
NOR,GTM,2016.0,1,0,1
MWI,,2014.0,34,0,34
GTM,BRA,2010.0,1,0,1
BHR,IND,2012.0,2,0,2
GBR,BRB,2012.0,5,0,5
,TCD,2008.0,5,0,5
TLS,,2020.0,12,0,12
,BLR,2011.0,297,0,297
,BWA,2013.0,57,0,57
,BEN,2011.0,111,0,111
,MLT,2010.0,88,0,88
POL,CYP,2023.0,1,0,1
IND,VNM,2017.0,4,0,4
,COM,2011.0,7,0,7
OMN,IRL,2017.0,2,0,2
,COD,2011.0,29,0,29
TKM,TUR,2018.0,2,0,2
THA,HUN,2019.0,1,0,1
AUT,ARM,2016.0,1,0,1
,MUS,2011.0,28,0,28
ALB,SWE,2016.0,1,0,1
JOR,SGP,2016.0,1,0,1
,QAT,2011.0,169,0,169
BRA,FJI,2021.0,1,0,1
,BIH,2020.0,132,0,132
LIE,,2024.0,33,0,33
ITA,PRY,2017.0,1,0,1
LBY,SAU,2009.0,1,0,1
CHE,VUT,2014.0,1,0,1
BEL,BDI,2018.0,5,0,5
GRC,CZE,2014.0,8,0,8
,MKD,2010.0,163,0,163
OMN,CHN,2012.0,1,0,1
,BTN,2007.0,13,0,13
BGR,SRB,2022.0,2,0,2
VNM,IRL,2019.0,4,0,4
ROU,SGP,2016.0,3,0,3
GHA,ETH,2016.0,2,0,2
,GTM,2011.0,33,0,33
SWE,NPL,2019.0,3,0,3
,BLR,2019.0,315,0,315
,HND,2011.0,19,0,19
KNA,NZL,2013.0,1,0,1
,CRI,2020.0,103,0,103
,GRD,2014.0,17,0,17
THA,OMN,2021.0,1,0,1
HUN,LTU,2021.0,1,0,1
MUS,NGA,2019.0,1,0,1
,SLV,2014.0,15,0,15
PSE,IND,2017.0,1,0,1
LKA,SWE,2020.0,1,0,1
LUX,,2009.0,27,0,27
NZL,BRN,2011.0,3,0,3
MEX,GRD,2017.0,1,0,1
GBR,MAC,2009.0,4,0,4
TUR,HKG,2017.0,3,0,3
SYR,HUN,2018.0,3,0,3
CHN,ARE,2015.0,7,0,7
GHA,LBR,2017.0,2,0,2
,TGO,1997.0,23,0,23
,PNG,2010.0,39,0,39
,MWI,1997.0,33,0,33
MUS,DZA,2017.0,1,0,1
IRN,EST,2019.0,4,0,4
BHR,,2018.0,57,0,57
,LBY,2014.0,38,0,38
PAK,LVA,2018.0,1,0,1
,MLT,2006.0,63,0,63
TUR,NGA,2018.0,6,0,6
GAB,GEO,2003.0,2,0,2
,SLV,2001.0,5,0,5
SLE,,2020.0,34,0,34
,NAM,2003.0,18,0,18
,LVA,2005.0,154,0,154
,GMB,2014.0,53,0,53
CAN,ZMB,2015.0,1,0,1
,KNA,2013.0,5,0,5
BTN,BGD,2018.0,1,0,1
,BLZ,2014.0,9,0,9
FRO,,2019.0,6,0,6
FIN,ARE,2004.0,1,0,1
BLR,CZE,2003.0,3,0,3
LUX,CHE,2000.0,3,0,3
CHE,LUX,2001.0,1,0,1
MEX,BGR,2004.0,1,0,1
AUS,ZMB,2005.0,2,0,2
AZE,KOR,2001.0,1,0,1
DZA,ROU,1998.0,1,0,1
SWE,NOR,2024.0,2,0,2
CHE,GLP,2004.0,1,0,1
ARE,,2003.0,36,0,36
GHA,BWA,2000.0,1,0,1
ZAF,MLT,2013.0,1,0,1
GIN,GUF,2018.0,1,0,1
,LSO,2001.0,5,0,5
BGR,MKD,2009.0,2,0,2
BGR,MKD,2019.0,2,0,2
SRB,SVK,1998.0,2,0,2
,BHR,1998.0,28,0,28
MKD,AUS,1997.0,2,0,2
TTO,,2005.0,16,0,16
DEU,SYR,2003.0,5,0,5
CHN,JOR,1998.0,1,0,1
HRV,NLD,2001.0,1,0,1
,GMB,1996.0,15,0,15
NZL,ECU,2007.0,1,0,1
BLR,CAN,2013.0,2,0,2
NGA,SYR,1999.0,1,0,1
ZWE,BEL,2009.0,3,0,3
ARE,BHR,2011.0,2,0,2
UZB,KOR,2005.0,4,0,4
,GIN,1998.0,10,0,10
HRV,LTU,2004.0,1,0,1
BEL,ARE,2011.0,1,0,1
ZWE,,2006.0,20,0,20
ITA,MAR,2006.0,5,0,5
BEN,IND,2010.0,1,0,1
,BHR,1999.0,22,0,22
CIV,CHE,1997.0,1,0,1
LAO,,2014.0,17,0,17
ITA,SAU,2001.0,2,0,2
ITA,VAT,2009.0,2,0,2
BRA,ISR,1999.0,1,0,1
HUN,FJI,2019.0,2,0,2
MYS,CAN,2006.0,7,0,7
VEN,CHE,2020.0,1,0,1
BRN,,2010.0,6,0,6
IND,PSE,2000.0,1,0,1
TJK,,2012.0,8,0,8
EST,FRA,2004.0,2,0,2
DZA,ARE,2006.0,2,0,2
TWN,NGA,2004.0,1,0,1
AUT,MEX,1997.0,2,0,2
CHN,MYS,1997.0,1,0,1
ITA,AZE,2013.0,1,0,1
FRO,,2025.0,65,0,65
,GHA,2000.0,71,0,71
ECU,FRA,1999.0,2,0,2
IRL,ARG,2023.0,2,0,2
DEU,SDN,1998.0,2,0,2
FIN,TZA,2005.0,1,0,1
GBR,PRY,2012.0,1,0,1
ARE,QAT,2002.0,1,0,1
ARG,RUS,2004.0,1,0,1
PRT,MYS,2009.0,2,0,2
AUT,SRB,1998.0,3,0,3
COG,KEN,2002.0,1,0,1
USA,IRQ,2005.0,7,0,7
DEU,MNG,1997.0,1,0,1
TUR,TUN,2011.0,3,0,3
BGR,AUS,1998.0,3,0,3
URY,MEX,2000.0,2,0,2
EGY,TTO,2016.0,1,0,1
GAB,BEL,2016.0,1,0,1
PRY,MEX,2013.0,3,0,3
FJI,,2023.0,71,0,71
,GEO,2005.0,123,0,123
,FJI,2015.0,28,0,28
TJK,UZB,2019.0,1,0,1
,TCD,2015.0,12,0,12
CHN,ZWE,2022.0,5,0,5
,BLZ,2015.0,9,0,9
,LSO,2014.0,15,0,15
CHE,MDG,2014.0,3,0,3
,LBR,2014.0,25,0,25
VNM,EGY,2022.0,2,0,2
GMB,KEN,2019.0,1,0,1
PAK,UGA,2013.0,1,0,1
FRA,FJI,2017.0,2,0,2
MLI,,2021.0,72,0,72
,MTQ,2015.0,16,0,16
IRQ,QAT,2023.0,2,0,2
,SWZ,2012.0,10,0,10
SWZ,SEN,2022.0,1,0,1
,PAN,2004.0,29,0,29
,LAO,2015.0,42,0,42
,MTQ,2014.0,17,0,17
MYS,KAZ,2020.0,3,0,3
NIC,,2022.0,29,0,29
GBR,MOZ,2017.0,1,0,1
,HTI,2017.0,43,0,43
BEL,PRI,2016.0,1,0,1
KOR,MMR,2021.0,6,0,6
GIN,FRA,2008.0,3,0,3
,PNG,2006.0,25,0,25
GRC,CHL,2017.0,3,0,3
,MCO,1997.0,8,0,8
LKA,BGD,2017.0,1,0,1
PRI,,2004.0,32,0,32
GBR,BHS,2000.0,1,0,1
,BFA,2007.0,88,0,88
CUB,PER,2001.0,5,0,5
PER,,2003.0,22,0,22
FIN,BGD,2015.0,3,0,3
,NER,2017.0,43,0,43
CUB,CHE,2014.0,6,0,6
GNB,,2014.0,5,0,5
GTM,,2014.0,27,0,27
SVK,CHE,1999.0,3,0,3
,FJI,2004.0,25,0,25
DEU,LIE,2004.0,6,0,6
NPL,SVK,2001.0,1,0,1
MMR,RUS,2019.0,1,0,1
RUS,MMR,2021.0,1,0,1
SEN,ETH,2015.0,1,0,1
CHE,CYP,2019.0,2,0,2
GTM,,2015.0,19,0,19
GUM,,2001.0,2,0,2
,PRI,2017.0,116,0,116
LBR,LBY,2012.0,1,0,1
ZWE,,2000.0,25,0,25
,GMB,2001.0,20,0,20
LIE,RUS,2013.0,1,0,1
SVK,KWT,2002.0,2,0,2
NZL,VNM,2013.0,2,0,2
,LIE,2003.0,8,0,8
GUF,,2003.0,1,0,1
SGP,SRB,2001.0,2,0,2
SGP,IRL,2001.0,1,0,1
BWA,VNM,2021.0,1,0,1
VNM,,2001.0,39,0,39
LVA,DNK,2016.0,2,0,2
DEU,BIH,2011.0,4,0,4
ARE,PAK,2004.0,3,0,3
COL,GTM,2009.0,1,0,1
MWI,SDN,2000.0,1,0,1
SDN,MWI,2002.0,1,0,1
SLB,,2008.0,1,0,1
BEL,UKR,1997.0,5,0,5
PHL,FIN,1999.0,1,0,1
GNQ,,2023.0,4,0,4
HKG,SYR,2002.0,1,0,1
BRB,,2017.0,13,0,13
AFG,,2007.0,3,0,3
COL,FRA,1997.0,2,0,2
NZL,TWN,2001.0,3,0,3
ARE,QAT,1997.0,1,0,1
LVA,,2010.0,64,0,64
,TZA,2020.0,265,0,265
KOR,KAZ,2007.0,1,0,1
BEL,IRN,1999.0,3,0,3
QAT,,2005.0,18,0,18
IRQ,DEU,2004.0,1,0,1
PAK,AFG,2006.0,2,0,2
SGP,PAK,2009.0,3,0,3
CHE,MLI,1999.0,1,0,1
IND,TTO,2016.0,7,0,7
NZL,OMN,2000.0,3,0,3
UZB,,1999.0,24,0,24
ESP,THA,2005.0,2,0,2
PHL,DEU,2002.0,6,0,6
DEU,PHL,2023.0,2,0,2
MNE,DEU,1998.0,1,0,1
VNM,TWN,2001.0,1,0,1
DNK,SVK,2016.0,2,0,2
TUR,GEO,2011.0,1,0,1
TJK,PAK,2008.0,1,0,1
ZAF,SLE,2020.0,2,0,2
MDA,USA,2005.0,2,0,2
OMN,,2002.0,15,0,15
ITA,TZA,2013.0,2,0,2
,LBY,2004.0,38,0,38
SAU,BGR,2012.0,1,0,1
ISL,ITA,2001.0,1,0,1
HND,COL,2009.0,1,0,1
JPN,SRB,1999.0,6,0,6
OMN,MYS,2009.0,2,0,2
LBN,ARE,2001.0,1,0,1
,TZA,2007.0,136,0,136
GRC,KOR,2022.0,2,0,2
,MKD,2006.0,164,0,164
NLD,MKD,2015.0,2,0,2
CIV,TCD,2019.0,2,0,2
GBR,CYM,2019.0,1,0,1
,PRY,2007.0,24,0,24
TUR,SYR,2011.0,1,0,1
SYR,TUR,2013.0,3,0,3
ITA,HND,2010.0,2,0,2
MOZ,,2013.0,17,0,17
JAM,,2012.0,22,0,22
ESP,SAU,2014.0,9,0,9
COL,RWA,2013.0,1,0,1
TUR,BGD,2023.0,6,0,6
SAU,IRQ,2015.0,2,0,2
ARE,MYS,2010.0,3,0,3
FRA,BMU,2010.0,1,0,1
BMU,,2025.0,23,0,23
TCA,ARE,2019.0,1,0,1
BRB,GRD,2017.0,1,0,1
BLR,ITA,2023.0,1,0,1
BRB,,2018.0,15,0,15
LSO,,2013.0,5,0,5
LUX,THA,2009.0,1,0,1
MWI,ARE,2019.0,1,0,1
NGA,AUS,2012.0,5,0,5
ARM,IRL,2019.0,1,0,1
KHM,,2014.0,18,0,18
BRA,TWN,2010.0,1,0,1
GRC,IRQ,2019.0,3,0,3
SYR,KAZ,2017.0,1,0,1
LTU,GRC,2014.0,1,0,1
,LSO,2008.0,7,0,7
AUT,BRN,2015.0,1,0,1
UGA,LBR,2015.0,2,0,2
SVN,HKG,2016.0,1,0,1
DEU,MRT,2012.0,1,0,1
THA,MDV,2013.0,1,0,1
ARE,IDN,2020.0,1,0,1
SYC,CHE,2010.0,1,0,1
ETH,THA,2011.0,1,0,1
DNK,VEN,2023.0,1,0,1
MAR,CZE,2018.0,1,0,1
LKA,EGY,2017.0,2,0,2
,MLI,2013.0,37,0,37
CHN,MLI,2022.0,4,0,4
PER,MEX,2000.0,1,0,1
GLP,GBR,2021.0,2,0,2
,LIE,2013.0,11,0,11
SUR,,2018.0,11,0,11
,FLK,2013.0,5,0,5
CPV,GBR,2019.0,1,0,1
CPV,,2025.0,45,0,45
BGR,EGY,2000.0,1,0,1
FSM,,2021.0,7,0,7
COL,IRL,2017.0,2,0,2
,MRT,2013.0,8,0,8
,ALB,2012.0,141,0,141
PNG,,2023.0,82,0,82
,NCL,2010.0,20,0,20
MYS,UGA,2016.0,4,0,4
ARG,NLD,2020.0,6,0,6
BOL,SWE,2005.0,1,0,1
WSM,NZL,2022.0,3,0,3
,GRL,2013.0,8,0,8
MYS,TZA,2019.0,1,0,1
DZA,CZE,2017.0,1,0,1
MDG,IND,2016.0,4,0,4
IND,MDG,2017.0,4,0,4
,COD,2019.0,132,0,132
MAR,NER,2018.0,1,0,1
PRT,AGO,2012.0,1,0,1
NGA,ESP,2022.0,3,0,3
GNB,GHA,2016.0,2,0,2
COL,IRL,2022.0,1,0,1
POL,LBY,2019.0,1,0,1
BGR,TWN,2019.0,1,0,1
MDA,ISR,2022.0,1,0,1
AUS,GUM,2018.0,1,0,1
IRN,EST,2021.0,9,0,9
BHR,,2026.0,7,0,7
COL,BOL,2017.0,4,0,4
YEM,CAN,2018.0,1,0,1
UGA,IRQ,2020.0,2,0,2
,FSM,2016.0,2,0,2
IRN,GEO,2019.0,3,0,3
CZE,BGD,2019.0,1,0,1
DEU,BRN,2019.0,1,0,1
BRN,DEU,2020.0,2,0,2
DEU,BRN,2021.0,1,0,1
LKA,ITA,2022.0,1,0,1
,BRN,2020.0,38,0,38
,CPV,2017.0,13,0,13
,BEN,2019.0,138,0,138
CAN,PSE,2022.0,3,0,3
BLR,ISR,2021.0,1,0,1
TWN,ARE,2022.0,3,0,3
JPN,NAM,2022.0,1,0,1
COL,CZE,2022.0,1,0,1
PNG,ESP,2021.0,1,0,1
TUR,PSE,2021.0,6,0,6
HTI,ETH,2021.0,1,0,1
ARE,PSE,2022.0,2,0,2
BRA,DNK,2008.0,4,0,4
PHL,ISR,2019.0,1,0,1
CUW,NLD,2023.0,2,0,2
MYS,CHL,2022.0,2,0,2
UGA,EGY,2022.0,1,0,1
PRY,BIH,2017.0,1,0,1
USA,BIH,2003.0,1,0,1
GMB,JPN,2000.0,1,0,1
ISR,CYP,2008.0,1,0,1
VNM,PRT,2007.0,1,0,1
CIV,BFA,2005.0,3,0,3
CYP,,1999.0,6,0,6
NLD,QAT,2015.0,5,0,5
SWE,KOR,2004.0,4,0,4
GNB,,2015.0,4,0,4
SWE,ARE,2004.0,3,0,3
,MDG,2002.0,37,0,37
PAN,,2005.0,7,0,7
CMR,ITA,2010.0,5,0,5
URY,GBR,2016.0,3,0,3
SVN,POL,2018.0,3,0,3
,BRB,2004.0,19,0,19
PRI,ESP,2022.0,3,0,3
SGP,BGD,2014.0,2,0,2
IND,POL,1997.0,1,0,1
AZE,BEL,1998.0,1,0,1
NPL,NOR,2002.0,1,0,1
BOL,BRA,2000.0,1,0,1
BOL,BRA,2006.0,1,0,1
,NIC,1995.0,22,0,22
NIC,GBR,1998.0,1,0,1
FRA,MYS,1998.0,3,0,3
CAN,DOM,1997.0,1,0,1
USA,CYM,2003.0,1,0,1
,TTO,1996.0,50,0,50
NOR,PAK,2003.0,1,0,1
NZL,NCL,2009.0,1,0,1
USA,GLP,2000.0,1,0,1
GUM,GLP,2008.0,1,0,1
IND,YEM,2013.0,5,0,5
FIN,CRI,2002.0,1,0,1
CRI,FIN,2003.0,2,0,2
VNM,,2004.0,37,0,37
AUS,TTO,2020.0,1,0,1
ESP,UGA,2002.0,1,0,1
ESP,DJI,2008.0,1,0,1
GLP,,2002.0,8,0,8
SEN,CMR,2001.0,2,0,2
TUN,KOR,2021.0,2,0,2
,VEN,2014.0,249,0,249
PNG,,2021.0,55,0,55
,EGY,2012.0,3231,0,3231
MLT,,2022.0,140,0,140
URY,,2022.0,341,0,341
,MYS,2017.0,6045,0,6045
MNE,,2022.0,69,0,69
,BWA,2015.0,128,0,128
,IDN,2019.0,6805,0,6805
,UGA,2010.0,324,0,324
,GRC,2013.0,2255,0,2255
,KHM,2016.0,110,0,110
,BHS,2014.0,5,0,5
,COG,2014.0,129,0,129
BIH,,2021.0,267,0,267
FSM,MEX,2021.0,1,0,1
IDN,POL,2017.0,1,0,1
,ETH,2014.0,836,0,836
,CHL,2016.0,2563,0,2563
,IRL,2018.0,2082,0,2082
,IRL,2017.0,1931,0,1931
,ISR,2019.0,2572,0,2572
,ROU,2012.0,2132,0,2132
GHA,PRT,2019.0,3,0,3
SDN,,2018.0,89,0,89
RWA,,2022.0,120,0,120
,COG,2015.0,117,0,117
,CHL,2018.0,2444,0,2444
,LBN,2014.0,504,0,504
,IRQ,2013.0,575,0,575
PRK,,2025.0,321,0,321
,OMN,1995.0,66,0,66
FJI,,2021.0,33,0,33
,PRT,2016.0,3301,0,3301
,GHA,2019.0,899,0,899
HTI,,2021.0,26,0,26
,BGD,2006.0,507,0,507
SWE,BGD,2010.0,3,0,3
,PHL,2020.0,558,0,558
GHA,COG,2022.0,2,0,2
RUS,IRN,2000.0,2,0,2
,PRT,2017.0,3671,0,3671
,NGA,2020.0,1703,0,1703
BEL,,2004.0,1052,0,1052
BWA,CHE,2004.0,1,0,1
,IDN,2009.0,1137,0,1137
BEL,ISL,2022.0,1,0,1
IRQ,MEX,2019.0,2,0,2
,PER,2010.0,349,0,349
,AUT,2020.0,1593,0,1593
,MLI,2015.0,49,0,49
PSE,,2021.0,107,0,107
,SVK,2019.0,859,0,859
PAN,,2020.0,39,0,39
SWZ,,2022.0,32,0,32
KEN,GEO,2023.0,1,0,1
ZAF,BFA,2023.0,1,0,1
,ISL,2010.0,151,0,151
,YEM,2015.0,47,0,47
OMN,,2020.0,150,0,150
IDN,NOR,2023.0,1,0,1
,NAM,2015.0,45,0,45
MTQ,,2022.0,26,0,26
,SAU,2019.0,4306,0,4306
BWA,,2022.0,106,0,106
,NZL,2020.0,843,0,843
,ZAF,2019.0,2439,0,2439
,THA,2020.0,2138,0,2138
,ETH,2008.0,255,0,255
BEL,MAC,2020.0,3,0,3
,ITA,2020.0,10375,0,10375
,MLI,2008.0,44,0,44
,SEN,2016.0,101,0,101
,VNM,2020.0,2070,0,2070
,MNG,2015.0,118,0,118
,KNA,2015.0,10,0,10
KNA,,2021.0,12,0,12
COG,CHE,2023.0,3,0,3
,JAM,2015.0,34,0,34
KGZ,,2021.0,52,0,52
,ZWE,2013.0,123,0,123
LBY,,2022.0,82,0,82
,GHA,2011.0,383,0,383
HKG,,2004.0,482,0,482
TWN,IRN,2024.0,1,0,1
HRV,TUR,2015.0,3,0,3
,GHA,2009.0,328,0,328
NOR,GHA,2022.0,3,0,3
,VEN,2008.0,492,0,492
BEL,BOL,2003.0,4,0,4
,BGR,2016.0,698,0,698
,GUF,2011.0,18,0,18
,KEN,2020.0,374,0,374
TTO,,2020.0,55,0,55
,BRN,2012.0,35,0,35
,MUS,2010.0,43,0,43
TUR,LBY,2019.0,3,0,3
DOM,BWA,2018.0,1,0,1
CAN,BWA,2022.0,3,0,3
RWA,DNK,2022.0,1,0,1
,DOM,2018.0,46,0,46
,SYR,2018.0,204,0,204
,HKG,2019.0,2488,0,2488
SDN,ARE,2004.0,2,0,2
,PSE,2017.0,191,0,191
IRN,GHA,2022.0,3,0,3
DNK,EGY,2023.0,2,0,2
,BGR,2018.0,596,0,596
,HKG,2009.0,1637,0,1637
,PSE,2018.0,201,0,201
MLI,,2023.0,125,0,125
,SEN,2018.0,119,0,119
,SEN,2017.0,156,0,156
,SWE,2019.0,3027,0,3027
,BGR,2017.0,644,0,644
CPV,,2023.0,25,0,25
,SGP,2020.0,1549,0,1549
NLD,AFG,2011.0,1,0,1
,AFG,2018.0,77,0,77
ISR,,2026.0,245,0,245
,NIC,2018.0,22,0,22
,MWI,2020.0,85,0,85
TUR,LBY,2021.0,7,0,7
GRD,,2023.0,47,0,47
,LVA,2020.0,213,0,213
MEX,PRY,2021.0,3,0,3
BEL,VNM,2024.0,1,0,1
ABW,,2023.0,4,0,4
CMR,TUR,2021.0,1,0,1
MDA,,2000.0,21,0,21
,HRV,2007.0,1178,0,1178
BMU,AUS,2007.0,23,0,23
LTU,KAZ,2014.0,1,0,1
,JOR,2020.0,776,0,776
,KHM,2018.0,80,0,80
VEN,PRT,2022.0,1,0,1
UZB,BLR,2021.0,1,0,1
SWE,URY,2022.0,1,0,1
,AGO,2018.0,14,0,14
,LVA,2007.0,252,0,252
ECU,,2019.0,206,0,206
MAR,IRN,2005.0,2,0,2
USA,KGZ,2005.0,2,0,2
FRA,TCD,1998.0,3,0,3
JPN,KAZ,2015.0,3,0,3
,GUF,1994.0,15,0,15
,ARE,1995.0,120,0,120
RUS,CHL,2022.0,4,0,4
UKR,,2004.0,685,0,685
ROU,,2001.0,183,0,183
BGD,,2005.0,74,0,74
AUT,CHL,2006.0,3,0,3
MYS,,2002.0,107,0,107
ARE,,2014.0,134,0,134
,SDN,1998.0,40,0,40
UZB,,2005.0,58,0,58
,MKD,1994.0,97,0,97
PHL,,2004.0,46,0,46
CHE,TUN,2000.0,3,0,3
ARG,CZE,2014.0,3,0,3
,MLT,2011.0,84,0,84
UKR,BEL,2001.0,10,0,10
,AZE,2005.0,178,0,178
TUN,,2001.0,47,0,47
ISL,ESP,2009.0,1,0,1
JAM,,2020.0,72,0,72
UGA,NGA,2000.0,2,0,2
PRT,SGP,2013.0,5,0,5
ROU,,2004.0,245,0,245
HRV,AUS,2014.0,4,0,4
IND,TZA,2005.0,2,0,2
EGY,,2002.0,204,0,204
BEN,,2022.0,148,0,148
ESP,UZB,1999.0,2,0,2
LIE,,2021.0,12,0,12
POL,,1999.0,329,0,329
KWT,,2009.0,110,0,110
ZAF,GRC,2001.0,1,0,1
THA,ZAF,2009.0,1,0,1
MDG,,2010.0,27,0,27
UGA,,2006.0,24,0,24
,NPL,1995.0,60,0,60
SRB,SWE,1998.0,1,0,1
COL,IND,2004.0,2,0,2
NGA,,2003.0,109,0,109
MYS,,2005.0,125,0,125
BTN,AUS,2001.0,3,0,3
,UZB,1997.0,128,0,128
FIN,KWT,1999.0,3,0,3
BMU,GBR,2003.0,2,0,2
GHA,,2004.0,15,0,15
PRT,GAB,2009.0,1,0,1
,LUX,1995.0,35,0,35
NOR,AUS,2002.0,12,0,12
IRN,BEL,2006.0,3,0,3
AUS,UKR,1999.0,1,0,1
BOL,,2007.0,16,0,16
ARM,BLR,2017.0,1,0,1
TZA,AUS,2005.0,1,0,1
URY,,2018.0,157,0,157
SRB,SVK,2002.0,2,0,2
,MMR,1995.0,20,0,20
,MDA,1996.0,47,0,47
PAK,,1999.0,25,0,25
,ZMB,1994.0,57,0,57
,COG,2001.0,41,0,41
MLT,ESP,2013.0,1,0,1
DEU,AZE,2002.0,1,0,1
OMN,,2007.0,42,0,42
BEL,TUN,2001.0,3,0,3
BOL,ECU,1999.0,1,0,1
PRI,MEX,2003.0,1,0,1
ARG,DOM,1997.0,1,0,1
ROU,ISL,2002.0,1,0,1
,ECU,2012.0,227,0,227
KHM,GBR,2014.0,6,0,6
HTI,,2025.0,126,0,126
MYS,MAR,2017.0,3,0,3
,MOZ,2013.0,111,0,111
,CMR,2013.0,436,0,436
,GAB,2013.0,51,0,51
,LBY,2013.0,32,0,32
,EST,2012.0,390,0,390
,CRI,2012.0,136,0,136
TUN,FIN,2017.0,1,0,1
,LSO,2013.0,14,0,14
,ALB,2020.0,79,0,79
,TZA,2012.0,309,0,309
ZWE,,2019.0,89,0,89
LKA,,2026.0,26,0,26
,CYP,2013.0,178,0,178
IND,JOR,2018.0,1,0,1
ALB,,2020.0,54,0,54
NLD,KHM,2016.0,1,0,1
BLR,KOR,2023.0,1,0,1
,GMB,2013.0,28,0,28
,NAM,1996.0,44,0,44
,ZMB,2011.0,85,0,85
LTU,,2006.0,85,0,85
,PAN,2013.0,67,0,67
POL,AUS,2016.0,13,0,13
,TTO,2013.0,44,0,44
ISL,,2017.0,102,0,102
,ARM,2012.0,123,0,123
,TJK,2013.0,17,0,17
LVA,,2019.0,182,0,182
SYR,OMN,2019.0,1,0,1
ZWE,,2021.0,158,0,158
,BHR,2012.0,74,0,74
MLT,,2018.0,44,0,44
BRN,,2019.0,35,0,35
NAM,,2021.0,38,0,38
,SYR,2017.0,152,0,152
,ARM,1997.0,111,0,111
GBR,MDV,2020.0,2,0,2
RWA,TZA,2017.0,1,0,1
,TZA,2005.0,162,0,162
,BRB,2013.0,22,0,22
,KWT,1998.0,125,0,125
PER,SGP,2021.0,1,0,1
MNE,,2017.0,20,0,20
IRN,OMN,2020.0,13,0,13
CIV,,2009.0,34,0,34
UKR,SVN,2022.0,2,0,2
SAU,QAT,2013.0,7,0,7
ZAF,BGR,2017.0,1,0,1
MYS,SDN,2016.0,10,0,10
,KEN,2007.0,397,0,397
COD,JPN,2019.0,1,0,1
,ETH,1996.0,88,0,88
OMN,BRA,2003.0,1,0,1
TUN,TGO,2021.0,1,0,1
MAR,CHN,2015.0,2,0,2
LKA,,2017.0,137,0,137
,BFA,2012.0,135,0,135
RUS,YEM,2021.0,1,0,1
,FJI,2013.0,35,0,35
HND,,2019.0,7,0,7
HTI,,2019.0,26,0,26
,PYF,2016.0,14,0,14
NPL,,2018.0,129,0,129
,AGO,2016.0,17,0,17
AGO,,2023.0,48,0,48
DOM,,2021.0,26,0,26
JPN,SDN,2023.0,1,0,1
FRO,,2023.0,12,0,12
,SYR,2016.0,129,0,129
,AFG,2016.0,45,0,45
COD,MDG,2019.0,1,0,1
PAK,SRB,2022.0,1,0,1
GRL,,2013.0,4,0,4
,ERI,2011.0,11,0,11
TGO,,2020.0,42,0,42
GRD,PSE,2020.0,1,0,1
,PSE,2016.0,151,0,151
TJK,,2020.0,25,0,25
,DOM,2016.0,29,0,29
PSE,EGY,2018.0,2,0,2
THA,,1999.0,68,0,68
,MKD,2019.0,89,0,89
,KHM,2017.0,73,0,73
,CUB,2014.0,499,0,499
SMR,,2017.0,4,0,4
,BIH,2005.0,178,0,178
,NIC,2016.0,23,0,23
,CUB,2008.0,794,0,794
COL,ISL,2019.0,1,0,1
KWT,HUN,2015.0,1,0,1
PHL,PRT,2019.0,1,0,1
MNE,AUT,2014.0,1,0,1
BIH,,2019.0,154,0,154
MUS,,2021.0,45,0,45
JPN,ISL,2022.0,1,0,1
SVK,NZL,2022.0,1,0,1
,CRI,2005.0,104,0,104
NPL,,2016.0,110,0,110
HND,,2021.0,37,0,37
GIN,CHE,2020.0,3,0,3
,RUS,2021.0,37,0,37
,MLT,2019.0,109,0,109
,HRV,2020.0,601,0,601
,ZMB,2019.0,161,0,161
THA,MNG,2021.0,1,0,1
LTU,DZA,2021.0,1,0,1
,BDI,2018.0,13,0,13
,SAU,2021.0,48,0,48
,PYF,2018.0,13,0,13
,BWA,2001.0,53,0,53
CYP,PSE,2023.0,1,0,1
SRB,IND,2019.0,2,0,2
THA,CHL,2021.0,1,0,1
BGD,,2012.0,190,0,190
POL,BLR,2024.0,1,0,1
,TLS,2019.0,7,0,7
ABW,,2024.0,9,0,9
,NLD,2021.0,21,0,21
,PNG,2019.0,24,0,24
,SYC,2018.0,15,0,15
URY,,2026.0,9,0,9
NLD,CHL,2003.0,2,0,2
CHL,DNK,2008.0,2,0,2
SRB,CAN,2007.0,6,0,6
,BFA,1997.0,48,0,48
CAN,UZB,2006.0,1,0,1
GHA,PNG,2001.0,1,0,1
,LVA,1998.0,106,0,106
GEO,PRT,2003.0,1,0,1
PRT,GEO,2005.0,1,0,1
WSM,,2012.0,3,0,3
OMN,TUR,2012.0,2,0,2
GBR,BRN,1997.0,2,0,2
MUS,,2019.0,33,0,33
LUX,,2006.0,6,0,6
TUN,,2004.0,102,0,102
FRA,DJI,2009.0,3,0,3
TUN,DZA,2010.0,3,0,3
VEN,CZE,2021.0,1,0,1
AUS,NCL,2005.0,2,0,2
HRV,SRB,1997.0,7,0,7
SWE,ARE,2013.0,3,0,3
SVN,,2006.0,144,0,144
ARE,,2001.0,35,0,35
CYP,,2005.0,10,0,10
AZE,,2014.0,146,0,146
NGA,SYR,2005.0,1,0,1
PAK,DNK,1998.0,1,0,1
BEL,RWA,2001.0,2,0,2
RWA,LUX,2002.0,1,0,1
,FLK,1996.0,2,0,2
PHL,,2008.0,65,0,65
MDA,FRA,1998.0,1,0,1
BFA,,2002.0,9,0,9
LUX,,2000.0,10,0,10
ISR,POL,2001.0,3,0,3
MYS,TWN,2001.0,1,0,1
KOR,SAU,2007.0,1,0,1
URY,,2017.0,99,0,99
NGA,AUT,1997.0,2,0,2
TUN,HRV,2001.0,1,0,1
LVA,JPN,1999.0,2,0,2
LVA,JPN,2007.0,1,0,1
BIH,ITA,1997.0,1,0,1
MKD,,2004.0,16,0,16
CYP,,2002.0,10,0,10
MEX,GRC,2000.0,1,0,1
SDN,MCO,2016.0,1,0,1
,REU,1994.0,10,0,10
RWA,,2018.0,35,0,35
,MNG,2008.0,65,0,65
JPN,VNM,2022.0,79,34,45
COL,MEX,2017.0,36,46,-10
MEX,CHL,2023.0,10,10,0
COL,MEX,2022.0,47,38,9
MEX,DEU,2018.0,50,35,15
AUS,IRL,2001.0,14,12,2
USA,MAC,2015.0,17,2,15
USA,MAR,2020.0,19,12,7
THA,JPN,2018.0,66,159,-93
SRB,HUN,2020.0,6,4,2
CAN,SAU,2019.0,155,95,60
IRN,IRL,2022.0,24,2,22
GHA,ZAF,2018.0,19,17,2
VNM,NLD,2016.0,5,6,-1
NZL,IDN,2018.0,7,3,4
GBR,JPN,2023.0,64,76,-12
NGA,MYS,2020.0,60,133,-73
NLD,DEU,2023.0,199,221,-22
KOR,CHN,2020.0,311,157,154
ARG,USA,2023.0,77,45,32
KEN,NLD,2021.0,4,7,-3
DEU,ISR,2020.0,80,69,11
AUT,ITA,2019.0,49,66,-17
ESP,BEL,2021.0,99,70,29
GBR,DEU,2021.0,795,652,143
FRA,BRA,2022.0,90,149,-59
HKG,CAN,2021.0,41,22,19
DEU,KOR,2018.0,56,71,-15
DEU,PRT,2023.0,24,32,-8
DEU,EGY,2019.0,78,56,22
USA,PAK,2020.0,83,153,-70
PAK,USA,2023.0,127,59,68
USA,SWE,2021.0,291,254,37
NGA,CAN,2019.0,15,9,6
ITA,CHN,2018.0,64,39,25
FRA,CAN,2022.0,306,236,70
TWN,USA,2016.0,282,279,3
GRC,BEL,2020.0,26,20,6
COL,CHE,2019.0,12,6,6
GEO,USA,2004.0,36,36,0
SAU,JOR,2019.0,37,32,5
IND,ITA,2023.0,53,33,20
FRA,IRN,2017.0,25,23,2
RUS,GBR,2012.0,45,48,-3
JPN,VNM,2017.0,89,28,61
THA,USA,2018.0,121,240,-119
IRL,CHN,2020.0,27,29,-2
CAN,SWE,2014.0,49,40,9
USA,EGY,2021.0,173,143,30
USA,URY,2015.0,18,11,7
CAN,GBR,2022.0,350,366,-16
ESP,MEX,2004.0,80,58,22
PRT,AUT,2017.0,14,5,9
USA,EGY,2019.0,170,132,38
USA,IRL,2017.0,154,151,3
IND,CAN,2019.0,178,91,87
JPN,RUS,2015.0,16,20,-4
LBN,CAN,2022.0,21,9,12
TUR,EGY,2018.0,3,3,0
GBR,DNK,2022.0,137,106,31
BWA,CHN,2018.0,2,1,1
CHN,JPN,2023.0,233,355,-122
ISR,CAN,2022.0,48,50,-2
ITA,IND,2021.0,40,72,-32
IND,SWE,2023.0,64,22,42
GBR,SWE,2023.0,123,88,35
ITA,FIN,2020.0,34,22,12
IND,DEU,1997.0,46,34,12
NGA,GBR,2018.0,55,95,-40
AUS,JPN,2002.0,61,73,-12
SGP,IRL,2021.0,7,7,0
IRL,DEU,2021.0,38,43,-5
NGA,CAN,2021.0,17,10,7
SGP,NZL,2015.0,20,15,5
LBN,DEU,2018.0,8,7,1
PHL,AUS,2018.0,19,7,12
CHN,DEU,2023.0,344,408,-64
PRT,GBR,2019.0,132,97,35
IRN,GBR,2018.0,60,42,18
FRA,ZAF,2020.0,23,15,8
EGY,CAN,2018.0,38,64,-26
BHR,IRL,2019.0,4,2,2
NGA,ZAF,2019.0,121,90,31
BEL,CHE,2019.0,76,55,21
BEL,ESP,2018.0,57,87,-30
KEN,USA,2021.0,71,56,15
USA,KEN,2022.0,68,43,25
CAN,NZL,2019.0,37,50,-13
ESP,IND,2017.0,31,22,9
CHE,ITA,2019.0,184,297,-113
IRN,DNK,2019.0,41,6,35
JPN,COL,2019.0,2,2,0
FIN,THA,2018.0,4,2,2
NZL,SGP,2020.0,17,18,-1
RUS,USA,2022.0,145,99,46
CHN,ESP,2021.0,63,74,-11
FRA,DNK,2017.0,70,36,34
BEL,IRN,2022.0,5,48,-43
USA,SGP,2021.0,184,238,-54
FRA,HUN,2010.0,18,18,0
ITA,GHA,2022.0,3,2,1
ITA,NOR,2018.0,43,20,23
URY,DEU,2022.0,4,3,1
GBR,CHL,2021.0,60,65,-5
USA,AUT,2000.0,91,124,-33
ROU,GRC,2017.0,4,1,3
HKG,FRA,2015.0,8,9,-1
DEU,EGY,2021.0,67,53,14
ESP,CAN,2003.0,20,24,-4
RUS,DEU,2019.0,156,108,48
RUS,TWN,2006.0,7,1,6
NLD,DNK,2023.0,28,21,7
GRC,CHE,2021.0,42,19,23
CHE,GRC,2023.0,16,16,0
FRA,AUS,2019.0,100,103,-3
BRN,IDN,2022.0,2,1,1
CZE,POL,2020.0,20,27,-7
KHM,FRA,2014.0,4,5,-1
CHL,CHE,2021.0,9,6,3
SEN,USA,2020.0,13,15,-2
JPN,BGD,2020.0,113,74,39
NLD,PAK,2015.0,18,8,10
LBN,GBR,2014.0,6,11,-5
COL,MEX,2018.0,60,59,1
PER,BRA,2020.0,19,81,-62
NLD,CHE,2023.0,67,69,-2
USA,RUS,2020.0,173,206,-33
KOR,IDN,2023.0,21,14,7
NLD,NOR,2015.0,41,15,26
MYS,SAU,2019.0,84,34,50
SGP,CAN,2022.0,34,23,11
GBR,KOR,2018.0,68,71,-3
MAC,HKG,2019.0,6,12,-6
RUS,KAZ,2018.0,45,49,-4
POL,ITA,2004.0,13,11,2
SAU,CHN,2023.0,32,48,-16
AUS,VNM,2021.0,67,43,24
GBR,UGA,2023.0,14,9,5
BEL,GBR,2022.0,126,133,-7
GMB,GBR,2023.0,6,11,-5
NGA,GBR,2022.0,80,66,14
SAU,SDN,2019.0,13,37,-24
BGR,ITA,1999.0,10,4,6
COL,ITA,2021.0,17,18,-1
NOR,DNK,2023.0,29,35,-6
RUS,ITA,2018.0,25,26,-1
PRT,ESP,2020.0,129,137,-8
NGA,ZAF,2021.0,91,126,-35
ITA,CHN,2022.0,81,85,-4
USA,IRN,2018.0,179,586,-407
SVN,ITA,2021.0,9,21,-12
JPN,FRA,2019.0,83,122,-39
PAK,TUR,2021.0,26,22,4
GBR,DNK,2018.0,127,115,12
BRA,AUS,2020.0,77,35,42
BRA,CAN,2017.0,140,83,57
PRT,CHE,2023.0,12,10,2
ESP,FRA,2021.0,275,238,37
FRA,IND,2023.0,36,59,-23
DEU,RUS,1997.0,122,123,-1
CHE,ITA,2021.0,210,275,-65
DEU,GHA,2019.0,20,16,4
ESP,MOZ,2022.0,5,1,4
TUR,AZE,2021.0,15,5,10
LAO,GBR,2020.0,3,3,0
ESP,FIN,2002.0,6,9,-3
FRA,ESP,1997.0,93,76,17
DEU,ESP,2018.0,231,275,-44
SGP,GBR,2020.0,122,137,-15
THA,JPN,2022.0,55,106,-51
NLD,BFA,2021.0,1,1,0
IND,MYS,2021.0,63,85,-22
IRQ,IRN,2023.0,10,23,-13
GBR,VNM,2018.0,108,20,88
THA,AUS,2019.0,22,54,-32
THA,AUS,2021.0,24,43,-19
AUS,CHN,2017.0,388,458,-70
NLD,UGA,2022.0,9,5,4
BEL,DEU,2023.0,65,76,-11
LUX,BEL,2016.0,14,20,-6
VNM,SWE,2021.0,4,6,-2
THA,DEU,2021.0,23,34,-11
CHN,NPL,2020.0,26,17,9
CHE,IRN,2023.0,8,27,-19
IND,TUR,2019.0,11,8,3
LTU,DEU,2019.0,12,11,1
NGA,GBR,2017.0,45,92,-47
NZL,CHN,2021.0,45,50,-5
ETH,BEL,2018.0,5,14,-9
KOR,KAZ,2018.0,8,1,7
IND,NPL,2023.0,18,11,7
ECU,FRA,2017.0,4,11,-7
ZAF,SWZ,2022.0,16,9,7
THA,DEU,2019.0,22,29,-7
CHN,AUS,2023.0,263,439,-176
GUF,FRA,2015.0,34,26,8
ESP,POL,2020.0,20,21,-1
TZA,ZAF,2021.0,12,17,-5
CHN,CAN,2023.0,225,310,-85
MOZ,ESP,2023.0,4,4,0
DNK,SWE,2023.0,57,63,-6
TUN,CHN,2020.0,7,1,6
CHE,FIN,2018.0,20,25,-5
PER,DEU,2023.0,8,1,7
IND,MEX,2016.0,14,5,9
CMR,CAN,2019.0,4,6,-2
PRT,GBR,2021.0,108,100,8
AUS,PHL,2020.0,15,23,-8
PNG,USA,2020.0,5,4,1
NLD,MEX,2022.0,7,10,-3
DEU,DNK,2021.0,143,125,18
KOR,GBR,2014.0,43,47,-4
JPN,NOR,2021.0,6,5,1
NZL,IDN,2016.0,7,3,4
SVN,SVK,2020.0,27,4,23
TUR,NGA,2020.0,8,4,4
JPN,ESP,2000.0,9,7,2
DNK,GBR,2021.0,116,137,-21
IDN,NLD,2020.0,33,62,-29
ITA,BEL,2022.0,89,83,6
ISL,SWE,2021.0,25,20,5
FIN,IND,2023.0,4,13,-9
RUS,CAN,2014.0,19,19,0
ARE,GBR,2021.0,37,87,-50
GBR,ARE,2023.0,37,29,8
CZE,BEL,2017.0,12,7,5
MYS,LBY,2019.0,20,3,17
ARE,CAN,2020.0,29,33,-4
PAK,CHN,2013.0,60,42,18
CHN,PAK,2015.0,81,141,-60
JPN,MNG,2019.0,24,10,14
CAN,SAU,2021.0,139,92,47
PAK,ITA,2023.0,20,6,14
NLD,IDN,2023.0,22,15,7
IDN,USA,2021.0,43,62,-19
DOM,USA,2021.0,4,12,-8
GBR,COL,2020.0,22,23,-1
ZWE,FRA,2021.0,5,7,-2
LBN,SAU,2021.0,11,3,8
GRC,CHE,2019.0,45,17,28
ESP,DNK,2022.0,41,39,2
PHL,AUS,2022.0,19,13,6
THA,FRA,2021.0,17,30,-13
COG,COD,2023.0,33,44,-11
TUR,USA,2022.0,238,185,53
CHL,NLD,2019.0,16,12,4
AUS,COL,2023.0,2,4,-2
CHN,TWN,2021.0,268,247,21
UKR,IRN,2021.0,1,1,0
MYS,SAU,2021.0,81,31,50
CHL,USA,2020.0,138,144,-6
CUB,MEX,2015.0,35,6,29
VNM,THA,2021.0,6,34,-28
JPN,THA,2022.0,106,55,51
BGD,CAN,2021.0,41,32,9
FRA,NGA,2021.0,4,4,0
KOR,NZL,2021.0,10,4,6
SAU,PHL,2021.0,3,2,1
THA,IND,2022.0,21,27,-6
DEU,CZE,2022.0,56,61,-5
CHN,MNG,2023.0,5,1,4
USA,COL,2004.0,51,32,19
AUS,HKG,2020.0,52,42,10
ESP,HKG,2023.0,3,4,-1
JPN,ESP,2023.0,15,10,5
PAK,AUS,2023.0,37,23,14
MYS,PAK,2021.0,157,90,67
MYS,IND,2018.0,64,65,-1
IND,MYS,2019.0,67,69,-2
PRT,SWE,2022.0,15,16,-1
GBR,MEX,2008.0,46,32,14
ITA,SWE,2023.0,43,41,2
TWN,VNM,2023.0,40,18,22
SGP,KOR,2022.0,28,17,11
CHE,LUX,2021.0,9,2,7
AUT,AUS,2023.0,14,15,-1
JPN,PHL,2022.0,18,21,-3
CZE,CHN,2022.0,22,14,8
COL,ESP,2015.0,61,140,-79
PRI,USA,2023.0,72,103,-31
BRA,ESP,2021.0,122,113,9
NGA,NZL,2023.0,4,1,3
RUS,HUN,2019.0,5,3,2
USA,LBN,2018.0,62,98,-36
IND,CAN,2021.0,178,107,71
ESP,GBR,2000.0,158,129,29
POL,FRA,2021.0,34,51,-17
ITA,SRB,2022.0,6,5,1
DEU,MDA,2003.0,2,2,0
BGD,KOR,2017.0,27,38,-11
BRA,CAN,2018.0,144,90,54
CHN,IND,2021.0,161,163,-2
TWN,IDN,2023.0,48,36,12
IRQ,MYS,2020.0,37,151,-114
PRT,CHL,2014.0,10,2,8
MEX,USA,2023.0,219,164,55
THA,MYS,2022.0,9,11,-2
USA,LBN,2022.0,40,144,-104
GBR,GIB,2017.0,1,4,-3
AUS,IND,2021.0,103,148,-45
ARM,RUS,2018.0,8,3,5
THA,GBR,2022.0,30,61,-31
IRL,ARE,2015.0,2,1,1
NZL,DEU,2016.0,34,33,1
FRA,TUN,2021.0,92,120,-28
SWE,BEL,2021.0,27,31,-4
LTU,DEU,2021.0,11,4,7
OMN,USA,1997.0,3,3,0
THA,PAK,2014.0,13,4,9
CHN,BEL,2022.0,75,100,-25
ESP,AUT,2022.0,41,27,14
FRA,ITA,2021.0,359,360,-1
NZL,EST,2021.0,1,1,0
IND,HKG,2023.0,10,4,6
SWE,DNK,2023.0,63,57,6
NLD,AUT,2021.0,37,44,-7
GBR,BRN,2018.0,12,4,8
ESP,BRA,2022.0,69,106,-37
TWN,ITA,2019.0,7,4,3
ROU,DNK,2017.0,3,3,0
USA,ARG,2006.0,117,140,-23
GBR,GMB,1998.0,8,2,6
SAU,TWN,2021.0,4,4,0
LBN,DEU,2022.0,8,1,7
USA,IRL,2022.0,107,126,-19
FRA,CIV,1999.0,18,9,9
CHN,KAZ,2022.0,8,4,4
ECU,ESP,2022.0,62,64,-2
CHN,IND,2019.0,69,250,-181
RUS,CAN,2015.0,16,25,-9
NLD,JPN,2006.0,27,12,15
ROU,JPN,2022.0,1,1,0
JPN,FRA,2021.0,93,111,-18
GBR,NOR,2001.0,42,39,3
IRL,SAU,2022.0,14,5,9
VNM,NZL,2023.0,3,7,-4
CHN,AUT,2020.0,24,18,6
TWN,JPN,2022.0,43,58,-15
TWN,IND,2022.0,48,87,-39
IND,SAU,2023.0,58,57,1
RWA,NLD,2022.0,3,4,-1
ESP,ZAF,2022.0,4,11,-7
PHL,USA,2021.0,46,34,12
JOR,ARE,2022.0,35,17,18
TWN,AUS,2021.0,20,20,0
CHN,KOR,2022.0,221,270,-49
FIN,CHE,2022.0,19,14,5
ZWE,NGA,2023.0,2,1,1
AZE,USA,2020.0,3,4,-1
CHL,MEX,2022.0,12,15,-3
ISL,SWE,2019.0,14,23,-9
POL,USA,1997.0,75,109,-34
ISR,USA,1997.0,257,257,0
DEU,RUS,2002.0,172,279,-107
USA,FIN,1997.0,74,62,12
SGP,JPN,2001.0,8,14,-6
CHN,FRA,1997.0,13,26,-13
GBR,TUR,1999.0,54,29,25
BRA,FRA,2002.0,74,91,-17
ITA,CAN,1998.0,29,28,1
USA,TZA,1997.0,7,1,6
NZL,CHE,2000.0,6,2,4
SRB,USA,2021.0,27,18,9
GBR,CAN,1997.0,172,155,17
MEX,ITA,2018.0,19,26,-7
CAN,AUT,1997.0,9,11,-2
DEU,GBR,1998.0,314,337,-23
SGP,IND,2004.0,10,35,-25
BGR,ESP,2003.0,4,2,2
SEN,FRA,2011.0,32,37,-5
AUS,FRA,2002.0,37,75,-38
DNK,ITA,2001.0,16,15,1
RUS,BLR,2003.0,8,19,-11
NLD,RUS,2003.0,13,27,-14
ARG,USA,2000.0,129,99,30
NLD,LUX,2011.0,5,2,3
AUT,CHE,1997.0,23,17,6
USA,RUS,1998.0,163,345,-182
IRL,AUS,1997.0,3,6,-3
SAU,USA,2004.0,27,56,-29
DNK,DEU,1997.0,25,43,-18
HRV,BIH,2017.0,19,12,7
DNK,NOR,2000.0,14,17,-3
DEU,HUN,1997.0,32,24,8
SRB,HUN,2007.0,11,1,10
JPN,ISR,1999.0,11,6,5
SVK,NLD,2007.0,3,2,1
POL,CAN,2002.0,14,14,0
RUS,POL,2006.0,14,8,6
GEO,USA,2015.0,63,113,-50
SWE,RUS,2013.0,13,15,-2
CZE,DEU,2014.0,48,59,-11
DEU,CZE,2017.0,60,59,1
AUS,RUS,1999.0,6,8,-2
SAU,EGY,1999.0,24,19,5
USA,ISR,1997.0,257,257,0
CHE,CAN,1997.0,53,46,7
QAT,ITA,2017.0,6,4,2
ESP,ITA,2002.0,91,81,10
AUS,ZAF,1999.0,17,29,-12
MEX,BEL,2000.0,4,2,2
USA,GEO,2012.0,50,42,8
UKR,RUS,1997.0,78,76,2
GBR,DNK,2017.0,127,114,13
DEU,NLD,1999.0,162,121,41
GBR,JPN,2006.0,113,118,-5
CHE,DNK,2023.0,29,33,-4
GBR,BEL,2000.0,82,71,11
CZE,GBR,2000.0,33,32,1
NZL,USA,1997.0,63,65,-2
ESP,VEN,1999.0,9,11,-2
ZWE,GBR,2004.0,8,5,3
BEL,VNM,2015.0,17,6,11
TUR,CAN,1999.0,6,6,0
ARG,SWE,2006.0,3,4,-1
CZE,ARG,2021.0,2,5,-3
GBR,NZL,2020.0,142,120,22
FRA,CHL,2002.0,17,12,5
BEL,USA,1997.0,90,86,4
JPN,CAN,1998.0,88,97,-9
ARE,LBY,2011.0,1,1,0
FRA,ECU,2002.0,4,2,2
USA,PRT,2003.0,62,38,24
PRT,ROU,2005.0,5,2,3
TUR,BEL,1997.0,1,2,-1
UKR,RUS,2002.0,70,53,17
JPN,GBR,2001.0,156,163,-7
RUS,UKR,2016.0,60,206,-146
PRT,USA,2001.0,53,37,16
DEU,BLR,2021.0,2,8,-6
SWE,FIN,2006.0,43,37,6
NOR,DNK,2000.0,17,14,3
AUS,ROU,1997.0,2,1,1
DEU,POL,2003.0,75,69,6
FRA,SWE,2000.0,61,30,31
FRA,MYS,2018.0,8,5,3
FRA,PYF,2023.0,7,8,-1
SWE,ITA,2000.0,30,30,0
NLD,CAN,2004.0,35,29,6
ITA,BEL,2016.0,105,68,37
SWE,NLD,2000.0,36,29,7
BEL,CHL,2020.0,16,4,12
ESP,CHL,2001.0,35,21,14
GBR,EGY,2023.0,35,51,-16
USA,GEO,2005.0,40,22,18
USA,POL,1997.0,109,75,34
FRA,MAR,1999.0,67,49,18
ITA,NOR,2016.0,31,9,22
PRI,USA,2000.0,59,47,12
HKG,GBR,1999.0,26,33,-7
DEU,UKR,2009.0,29,28,1
UKR,DEU,2022.0,42,11,31
USA,NZL,1997.0,65,63,2
NOR,CAN,2005.0,15,6,9
FRA,FIN,2001.0,18,17,1
DNK,BRA,2017.0,15,25,-10
BRA,DNK,2019.0,19,14,5
CHL,USA,1998.0,30,36,-6
FRA,JPN,1997.0,44,34,10
NLD,DEU,2000.0,166,175,-9
BEL,KEN,1997.0,3,2,1
AUS,NLD,2001.0,32,28,4
BEL,NLD,2001.0,92,102,-10
AUS,SGP,2009.0,55,54,1
TZA,NLD,2007.0,3,3,0
CAN,RUS,2004.0,15,35,-20
USA,UKR,2003.0,36,50,-14
BGR,USA,2020.0,11,14,-3
NLD,NOR,2004.0,21,8,13
NZL,HKG,1998.0,5,5,0
JPN,AUS,2015.0,69,52,17
LBN,TUR,2022.0,2,1,1
TUR,LBN,2023.0,2,1,1
GBR,PAK,2001.0,23,10,13
BEN,CAN,2000.0,1,1,0
GBR,RUS,2009.0,34,48,-14
DNK,ITA,2004.0,13,10,3
GRC,NLD,2017.0,32,19,13
GMB,NGA,1997.0,1,1,0
SWE,JPN,2001.0,45,43,2
CZE,CAN,2004.0,6,7,-1
FRA,JPN,2002.0,82,67,15
RUS,FIN,2012.0,24,19,5
HKG,TWN,2023.0,6,10,-4
BEL,BRA,2001.0,12,9,3
BEL,BRA,2004.0,10,11,-1
USA,HUN,2001.0,86,98,-12
FIN,NLD,2002.0,16,12,4
USA,ARG,2000.0,99,129,-30
KWT,SAU,2003.0,1,1,0
GBR,BGD,2020.0,28,23,5
CAN,DNK,1999.0,20,15,5
RUS,AUS,2001.0,13,3,10
ITA,NLD,2015.0,119,92,27
AUT,SVK,2009.0,3,10,-7
NZL,CAN,2001.0,41,29,12
CHE,AUT,1997.0,17,23,-6
ITA,VEN,2003.0,3,1,2
NLD,UKR,2011.0,1,4,-3
JPN,NLD,1998.0,25,19,6
NZL,BEL,2022.0,1,3,-2
SAU,EGY,2007.0,64,93,-29
HKG,CHE,2019.0,10,7,3
RUS,ITA,2022.0,30,11,19
JOR,AUS,2003.0,3,2,1
ZWE,ZAF,2014.0,28,21,7
CHE,SWE,2018.0,69,61,8
FIN,ITA,2015.0,23,18,5
CAN,PRT,2016.0,10,10,0
CAN,PRT,2022.0,13,11,2
CAN,FIN,1997.0,10,10,0
USA,BEL,2001.0,115,158,-43
BGR,ROU,2014.0,3,1,2
GBR,BLR,2001.0,4,5,-1
BLR,GBR,2012.0,2,3,-1
JPN,BEL,2002.0,15,8,7
ESP,RUS,2001.0,18,22,-4
DNK,USA,1997.0,84,99,-15
GBR,ARE,2006.0,11,7,4
FRA,VNM,2014.0,45,19,26
USA,COL,2008.0,74,67,7
CZE,POL,1999.0,18,3,15
ITA,DEU,2000.0,145,130,15
MEX,ESP,1998.0,47,49,-2
SVK,DEU,1997.0,15,9,6
NLD,POL,2005.0,8,13,-5
CAN,DNK,2020.0,31,38,-7
DEU,CAN,2001.0,155,127,28
SAU,GBR,1997.0,6,11,-5
AUS,ESP,1997.0,3,2,1
BRA,COL,2008.0,17,7,10
AUS,ESP,2002.0,10,13,-3
DEU,FIN,2003.0,26,40,-14
DEU,TUR,1997.0,11,12,-1
DEU,BRA,2000.0,49,26,23
KOR,IND,2011.0,90,154,-64
FRA,IRL,1998.0,10,3,7
FRA,PRT,1997.0,14,15,-1
HRV,DEU,2000.0,15,16,-1
AUT,HUN,2012.0,12,16,-4
ARG,USA,2006.0,140,117,23
USA,MLI,2005.0,8,1,7
GRC,DEU,2004.0,28,31,-3
GBR,CHE,1999.0,108,121,-13
IND,DEU,2002.0,98,66,32
PAN,POL,1997.0,5,1,4
RUS,CZE,2001.0,11,13,-2
CZE,RUS,2006.0,18,15,3
BEL,BRA,2008.0,17,8,9
SRB,SVN,2005.0,5,3,2
DEU,PRT,2000.0,11,10,1
USA,ARM,2011.0,10,7,3
GRC,BGR,2002.0,3,6,-3
SEN,FRA,2009.0,40,25,15
HKG,AUS,2000.0,24,39,-15
USA,CHL,2005.0,73,68,5
TUR,AZE,2009.0,7,10,-3
TWN,DEU,2001.0,13,9,4
IND,TWN,2003.0,34,19,15
SWE,CHL,2000.0,4,2,2
AUT,GBR,1999.0,29,30,-1
USA,GEO,1997.0,14,16,-2
DEU,HUN,2002.0,38,48,-10
CHN,PAK,2008.0,16,9,7
CIV,USA,2004.0,6,1,5
BEL,DEU,2000.0,50,76,-26
GBR,NZL,1998.0,72,62,10
TUN,FRA,2000.0,31,66,-35
TWN,CAN,2001.0,16,14,2
POL,SWE,2004.0,21,7,14
USA,PER,2014.0,42,42,0
DNK,SWE,2010.0,61,96,-35
SRB,HUN,1998.0,5,1,4
GBR,ISR,2019.0,53,63,-10
NGA,ZAF,2011.0,33,22,11
SWE,IND,2004.0,8,10,-2
CAN,FIN,2002.0,18,26,-8
DEU,TUR,2012.0,32,40,-8
MAR,FRA,2010.0,51,94,-43
AUS,BEL,2001.0,11,10,1
NPL,GBR,2001.0,5,4,1
GBR,NPL,2002.0,1,2,-1
CZE,SVK,2000.0,16,20,-4
MYS,GBR,2012.0,59,162,-103
RUS,FIN,2005.0,17,9,8
CHN,FRA,2005.0,40,58,-18
GBR,MEX,2001.0,36,30,6
NLD,GBR,1999.0,143,146,-3
GBR,NZL,1999.0,104,69,35
ITA,CAN,1999.0,34,31,3
ITA,SGP,2013.0,14,6,8
LIE,AUT,2005.0,1,1,0
ROU,ITA,2005.0,11,4,7
CHE,ESP,2000.0,26,29,-3
POL,CAN,1997.0,11,14,-3
FRA,CZE,2008.0,21,16,5
ROU,DEU,1997.0,17,8,9
ETH,SWE,1997.0,1,1,0
ROU,FRA,2020.0,22,26,-4
POL,SWE,2001.0,17,20,-3
RUS,FRA,2013.0,56,51,5
BEL,DNK,2013.0,10,11,-1
NLD,CAN,2001.0,36,40,-4
RUS,PRT,1997.0,3,1,2
EST,RUS,1999.0,2,1,1
CHN,NOR,2000.0,7,5,2
PRT,NLD,2001.0,13,17,-4
NLD,PRT,2003.0,14,9,5
AUS,SWE,2002.0,37,30,7
JPN,THA,2017.0,122,69,53
USA,POL,2002.0,104,186,-82
ISR,IRL,2008.0,8,2,6
FRA,ARG,2005.0,15,21,-6
FRA,BEL,2001.0,178,141,37
IND,ITA,2006.0,12,7,5
ITA,CHE,2022.0,223,158,65
NZL,DNK,2020.0,11,5,6
SGP,JPN,2014.0,32,28,4
GAB,FRA,2001.0,10,4,6
GAB,GBR,2009.0,4,1,3
USA,TUR,2000.0,180,158,22
BGR,BEL,2010.0,12,4,8
MEX,IND,1998.0,4,4,0
ISR,AUS,1997.0,6,10,-4
NZL,PHL,2000.0,2,2,0
PHL,USA,2011.0,35,37,-2
USA,URY,2004.0,8,15,-7
CAN,KEN,2003.0,5,1,4
JPN,UZB,2008.0,2,1,1
CHN,GBR,2004.0,117,114,3
GBR,PRT,2002.0,68,24,44
SGP,DEU,2006.0,13,15,-2
RUS,KAZ,2016.0,39,44,-5
SWE,EST,2001.0,13,8,5
DEU,MEX,2005.0,21,18,3
USA,LBN,2017.0,74,80,-6
POL,FRA,2019.0,42,72,-30
RUS,GBR,2002.0,85,58,27
MYS,USA,2011.0,31,39,-8
RUS,ESP,2000.0,20,11,9
AUS,ITA,1998.0,14,5,9
AZE,RUS,2006.0,4,9,-5
RUS,AZE,2009.0,5,2,3
GBR,KWT,2010.0,10,5,5
ISR,CAN,2016.0,58,65,-7
RUS,ISR,1999.0,21,8,13
NLD,POL,1997.0,7,7,0
USA,PHL,2003.0,26,19,7
UKR,CAN,2005.0,10,1,9
HKG,GBR,1998.0,30,45,-15
GBR,NOR,2015.0,93,50,43
CAN,QAT,2015.0,23,14,9
USA,SVN,2011.0,21,19,2
THA,JPN,2016.0,97,118,-21
NLD,ROU,2012.0,8,10,-2
DNK,DEU,2002.0,57,80,-23
USA,ZAF,2001.0,76,98,-22
THA,JPN,2017.0,69,122,-53
CYP,USA,1997.0,5,3,2
USA,HUN,2008.0,75,76,-1
VNM,USA,2005.0,7,4,3
FIN,NLD,2012.0,20,12,8
FRA,FIN,2014.0,24,22,2
TUN,MAR,1998.0,3,1,2
NOR,FRA,2005.0,12,17,-5
AUS,KEN,2011.0,7,4,3
UZB,RUS,2010.0,4,7,-3
ESP,SRB,2006.0,5,9,-4
MEX,GTM,2003.0,3,1,2
GBR,PER,2003.0,3,2,1
LVA,USA,1997.0,2,2,0
USA,ROU,2002.0,21,44,-23
NOR,USA,2002.0,92,97,-5
SAU,SDN,2009.0,4,2,2
URY,BRA,2002.0,9,2,7
BRA,URY,2005.0,3,1,2
SWE,ARG,2004.0,2,5,-3
GBR,ISR,2021.0,67,68,-1
EST,LVA,2022.0,2,1,1
CZE,DEU,2001.0,26,28,-2
FRA,BRA,2017.0,147,131,16
TUR,ARE,2016.0,4,4,0
ITA,ESP,2023.0,159,141,18
IRL,GRC,2006.0,1,1,0
TUR,TWN,2005.0,5,2,3
RUS,CHN,2004.0,6,5,1
ESP,RUS,2004.0,9,7,2
NZL,FJI,2017.0,2,2,0
SWE,AUT,2016.0,26,32,-6
GHA,USA,2022.0,48,39,9
TUR,JOR,2023.0,3,2,1
HUN,JPN,2001.0,6,9,-3
NPL,CHE,2014.0,1,1,0
CAN,SGP,2015.0,31,26,5
SGP,CAN,2018.0,24,39,-15
FRA,AUS,2021.0,71,100,-29
FRA,HUN,2000.0,22,8,14
SGP,NZL,2001.0,5,6,-1
COL,USA,2005.0,40,62,-22
GRC,DEU,2015.0,83,52,31
RUS,DNK,1997.0,7,7,0
USA,CZE,2017.0,51,77,-26
ITA,FIN,1998.0,10,7,3
JPN,RUS,2014.0,22,17,5
LBN,FRA,2013.0,27,62,-35
FRA,LBN,2014.0,79,31,48
RUS,GBR,1997.0,60,57,3
SWE,IRN,2013.0,20,36,-16
CRI,CAN,2003.0,3,1,2
DNK,AUS,2014.0,30,30,0
SGP,GBR,2007.0,43,68,-25
JPN,PHL,2016.0,36,26,10
PHL,JPN,2017.0,31,26,5
JPN,PHL,2018.0,22,19,3
USA,LUX,2010.0,6,5,1
KEN,GBR,2009.0,20,25,-5
ERI,USA,1999.0,1,1,0
ITA,RUS,1997.0,28,23,5
PRT,BEL,2002.0,8,3,5
DEU,JPN,2005.0,103,128,-25
ITA,MEX,1998.0,2,1,1
VEN,MEX,2017.0,15,6,9
BEL,AUS,2004.0,9,8,1
CZE,DEU,2004.0,34,31,3
SRB,USA,2019.0,25,18,7
AUS,AUT,2016.0,56,55,1
ITA,KOR,2011.0,4,7,-3
IND,KEN,2016.0,3,1,2
CUB,USA,2000.0,14,5,9
UGA,GBR,2019.0,12,21,-9
DEU,NOR,2007.0,53,19,34
CRI,MEX,2001.0,3,1,2
AUT,CZE,2013.0,10,10,0
CZE,CHE,2007.0,7,8,-1
CHE,CZE,2010.0,13,12,1
ESP,MEX,2001.0,68,70,-2
AUT,TUR,2014.0,8,6,2
ROU,POL,2015.0,2,3,-1
CHE,CHN,1998.0,12,8,4
CHE,CZE,2006.0,4,11,-7
DEU,BLR,2009.0,4,8,-4
ESP,MLT,2015.0,2,1,1
KEN,USA,2011.0,37,34,3
TWN,KOR,2015.0,12,10,2
HKG,GBR,2020.0,82,86,-4
GEO,DEU,2001.0,3,4,-1
RUS,KOR,1998.0,13,4,9
CHE,JPN,2001.0,27,30,-3
SWE,EST,2004.0,13,7,6
FRA,COL,2005.0,9,7,2
FIN,ESP,2012.0,12,14,-2
BEL,HUN,2006.0,11,9,2
DEU,NZL,2002.0,21,13,8
KOR,JPN,1997.0,35,71,-36
RUS,ESP,2010.0,6,7,-1
AUS,DEU,2016.0,186,176,10
FIN,ITA,2014.0,12,22,-10
JPN,RUS,2001.0,41,51,-10
MEX,DNK,1999.0,2,1,1
IND,MYS,2009.0,50,33,17
ESP,PRT,2002.0,39,30,9
UKR,BLR,1999.0,4,4,0
ROU,FRA,1999.0,28,26,2
MEX,RUS,2004.0,9,8,1
ISR,JPN,2004.0,9,4,5
GBR,SRB,2003.0,16,13,3
KOR,FRA,2023.0,19,18,1
AUS,TUR,2002.0,3,5,-2
VNM,GBR,2001.0,12,8,4
TTO,JAM,2012.0,5,1,4
GBR,CMR,1999.0,2,1,1
CMR,GBR,2001.0,2,3,-1
ISR,MEX,1999.0,3,1,2
IND,AUS,2003.0,29,30,-1
FRA,BOL,2014.0,2,8,-6
USA,TTO,2001.0,6,8,-2
GBR,PAK,2004.0,24,19,5
AUS,PHL,1998.0,6,1,5
UKR,RUS,2005.0,46,38,8
CHE,SGP,2006.0,10,5,5
CIV,FRA,2001.0,22,20,2
HUN,JPN,2015.0,8,6,2
BEL,IRL,1997.0,2,4,-2
DNK,CAN,2001.0,22,16,6
RUS,MEX,2004.0,8,9,-1
FRA,GRC,2019.0,29,40,-11
ITA,CHL,2008.0,8,4,4
JPN,BGD,1999.0,19,8,11
ITA,SWE,2010.0,34,20,14
GBR,QAT,2023.0,11,15,-4
JPN,IRL,2000.0,5,4,1
ZAF,AUT,2005.0,4,3,1
GBR,HKG,2023.0,49,52,-3
JPN,DNK,2017.0,12,6,6
CAN,CHN,2018.0,427,368,59
USA,NOR,2022.0,89,74,15
SGP,KOR,2018.0,31,36,-5
SRB,USA,2011.0,17,36,-19
MEX,IRL,2016.0,3,2,1
USA,RWA,2022.0,11,19,-8
IRL,BHR,2013.0,2,1,1
UKR,DEU,2016.0,47,16,31
MAR,MYS,2016.0,1,1,0
NLD,ZAF,2017.0,37,31,6
NLD,POL,2012.0,21,15,6
ESP,SWE,2015.0,88,35,53
COL,JPN,2017.0,1,2,-1
FRA,MAR,2020.0,83,56,27
NLD,NGA,2019.0,6,6,0
PAK,TUR,2019.0,13,24,-11
UGA,KOR,2021.0,3,1,2
USA,HTI,2020.0,10,4,6
CAN,HKG,2020.0,23,30,-7
CHN,BEL,2018.0,60,70,-10
CAN,PAK,2022.0,18,41,-23
NLD,JPN,2023.0,16,10,6
BGD,AUS,2021.0,100,80,20
ISR,CHN,2021.0,46,42,4
IND,TWN,2013.0,41,34,7
TWN,DEU,2014.0,28,23,5
GBR,KWT,2023.0,8,4,4
OMN,AUS,2016.0,5,5,0
ARG,ITA,2017.0,20,14,6
FIN,CAN,2021.0,17,28,-11
SAU,JOR,2011.0,11,44,-33
CHL,URY,2016.0,5,2,3
BRA,NLD,2012.0,21,23,-2
COL,BRA,2020.0,53,97,-44
BRA,CAN,2016.0,124,74,50
BGR,DEU,2022.0,6,3,3
CHN,NLD,2015.0,106,120,-14
IRL,CAN,2018.0,48,39,9
FRA,CZE,2015.0,28,18,10
BEL,MAR,2016.0,10,3,7
PER,GBR,2022.0,9,16,-7
JPN,NOR,2011.0,7,3,4
ESP,DNK,2017.0,52,35,17
AUS,NOR,2023.0,11,10,1
IRN,PRT,2020.0,18,8,10
ZAF,ZMB,2019.0,9,7,2
REU,FRA,2010.0,33,28,5
NZL,IND,2016.0,12,9,3
LUX,BEL,2018.0,20,23,-3
OMN,CAN,2017.0,9,14,-5
TWN,CZE,2016.0,2,2,0
NZL,DEU,2018.0,30,37,-7
FRA,SGP,2019.0,36,23,13
BRA,RUS,2016.0,15,5,10
NZL,TWN,2019.0,2,2,0
VNM,USA,2012.0,18,21,-3
CHE,NLD,2020.0,95,150,-55
CHN,NLD,2014.0,113,80,33
BGD,AUS,2019.0,94,67,27
FIN,USA,2016.0,101,76,25
IND,SGP,2020.0,106,98,8
HRV,SRB,2016.0,28,18,10
JOR,AUS,2013.0,4,9,-5
JPN,THA,2018.0,159,66,93
ITA,EGY,2016.0,18,10,8
CAN,MEX,2017.0,51,57,-6
CAN,MEX,2022.0,25,54,-29
KOR,TUR,2019.0,4,8,-4
SYR,MAR,2016.0,1,1,0
MAR,SYR,2017.0,1,2,-1
SWE,PRT,2013.0,9,15,-6
BRA,CHL,2017.0,40,16,24
USA,ARG,2023.0,45,77,-32
CZE,ISR,2023.0,4,4,0
THA,NLD,2022.0,6,7,-1
USA,THA,2017.0,256,148,108
TGO,FRA,2000.0,2,3,-1
FRA,TGO,2007.0,5,1,4
CHN,ITA,2013.0,26,40,-14
ITA,NLD,2014.0,118,59,59
SLE,USA,2015.0,6,3,3
ITA,BEL,2017.0,114,82,32
CAN,ESP,2022.0,58,58,0
NLD,ITA,2019.0,103,148,-45
SVK,AUT,2012.0,8,6,2
DEU,NGA,2017.0,13,12,1
NGA,DEU,2019.0,12,11,1
ROU,GRC,2016.0,6,2,4
USA,CIV,2019.0,13,3,10
DEU,CZE,2018.0,72,71,1
MYS,VNM,2019.0,9,3,6
CHE,ESP,2023.0,61,67,-6
IRN,NLD,2023.0,32,11,21
DEU,ZAF,2015.0,37,40,-3
KOR,TWN,2008.0,8,9,-1
CRI,USA,2014.0,18,21,-3
USA,CRI,2022.0,15,21,-6
DNK,HKG,2022.0,6,2,4
SDN,SAU,2018.0,25,16,9
KOR,VNM,2014.0,52,18,34
BEL,JPN,2021.0,13,12,1
ITA,LTU,2018.0,6,5,1
CYP,GBR,2008.0,6,18,-12
BGD,KOR,2016.0,38,21,17
BEL,IND,2021.0,22,41,-19
SWE,AUS,2021.0,49,65,-16
BIH,HRV,2022.0,6,8,-2
ETH,BEL,2016.0,2,14,-12
HUN,GBR,2010.0,33,34,-1
EGY,FRA,2019.0,18,16,2
COL,ESP,2014.0,79,119,-40
ITA,QAT,2020.0,6,4,2
IRN,AUT,2021.0,20,5,15
SEN,CIV,2020.0,4,3,1
SEN,CAN,2015.0,11,3,8
CAN,SEN,2016.0,9,2,7
CIV,USA,2015.0,9,3,6
FRA,KOR,2015.0,24,26,-2
CHN,BEL,2017.0,63,64,-1
SGP,SAU,2017.0,8,2,6
IRL,SWE,2010.0,14,10,4
NGA,GBR,2016.0,41,72,-31
JPN,VNM,2016.0,72,26,46
IDN,ITA,2017.0,6,1,5
USA,UGA,2013.0,17,34,-17
NZL,DEU,2022.0,28,20,8
GTM,USA,2020.0,10,14,-4
MYS,USA,2019.0,73,56,17
CHE,PRT,2022.0,12,19,-7
DZA,POL,2016.0,2,1,1
ETH,CHN,2017.0,13,3,10
KEN,GBR,2019.0,28,37,-9
PER,USA,2016.0,60,40,20
GAB,DEU,2020.0,5,3,2
FRA,IDN,2021.0,19,7,12
ARG,FRA,2014.0,32,33,-1
GBR,AUT,2015.0,85,84,1
SWE,KOR,2019.0,12,12,0
NLD,CHN,2012.0,56,92,-36
EGY,RUS,2019.0,9,9,0
RUS,EGY,2023.0,15,5,10
PAK,AUS,2010.0,8,8,0
CHN,TUR,2002.0,4,1,3
GRC,USA,2017.0,135,98,37
GHA,ITA,2017.0,3,3,0
THA,GBR,2016.0,40,86,-46
PRI,DEU,2018.0,2,1,1
JPN,DEU,2022.0,98,95,3
CHL,ESP,2019.0,112,168,-56
TUR,ZAF,2011.0,3,2,1
DEU,GHA,2021.0,17,21,-4
IND,NOR,2017.0,12,14,-2
KOR,NLD,2023.0,7,8,-1
DEU,SAU,2012.0,20,11,9
PAK,SAU,2020.0,95,71,24
UKR,AUT,2020.0,6,4,2
MWI,USA,2016.0,13,28,-15
LKA,GBR,2020.0,18,28,-10
MEX,ITA,2022.0,28,17,11
ZAF,CHE,2015.0,20,15,5
FRA,CIV,2020.0,29,11,18
SAU,HKG,2012.0,1,5,-4
BRB,USA,2018.0,6,5,1
MEX,DEU,2016.0,53,26,27
PSE,FRA,2016.0,3,4,-1
SAU,PSE,2020.0,5,1,4
NLD,BRA,2019.0,31,45,-14
ISR,CAN,2018.0,70,66,4
FRA,RUS,2016.0,41,47,-6
NAM,MWI,2019.0,1,1,0
CAN,IRN,2016.0,94,266,-172
ARG,JPN,2023.0,2,1,1
ISR,DEU,2013.0,40,46,-6
ROU,IND,2020.0,2,5,-3
SWZ,GBR,2019.0,4,1,3
ARG,GBR,2021.0,19,22,-3
MEX,CAN,1997.0,6,11,-5
IRL,CAN,2016.0,41,41,0
CAN,MEX,2016.0,40,43,-3
LKA,MYS,2023.0,5,2,3
BGD,CAN,2019.0,23,31,-8
PAK,USA,2010.0,69,53,16
FRA,PAK,2019.0,20,14,6
CAN,KOR,2020.0,32,71,-39
JPN,IND,2019.0,108,100,8
ZAF,TUR,2018.0,6,5,1
LBN,DEU,2017.0,5,3,2
SGP,SAU,2018.0,8,4,4
CHE,DNK,2000.0,17,18,-1
FRA,ARE,2018.0,17,10,7
TUN,MAR,2020.0,7,1,6
MAR,TUN,2023.0,2,2,0
EGY,AUS,2023.0,4,4,0
AUS,DNK,2013.0,29,24,5
CHE,ISR,2005.0,8,10,-2
ISR,FRA,2023.0,19,23,-4
SLV,SVK,2012.0,16,6,10
IRL,SAU,2016.0,5,7,-2
VEN,CHE,2016.0,2,1,1
NOR,GBR,2019.0,57,106,-49
CAN,PAK,2017.0,22,28,-6
CHL,CAN,2007.0,32,7,25
JPN,ARG,2002.0,2,3,-1
HUN,ESP,2009.0,6,5,1
DEU,ROU,1999.0,14,19,-5
TUR,NLD,2020.0,47,27,20
MYS,TUR,2020.0,15,3,12
ITA,THA,2019.0,8,4,4
TUR,CAN,2020.0,53,15,38
SAU,DEU,2022.0,22,15,7
UKR,RUS,2012.0,55,48,7
FRA,SEN,2000.0,12,39,-27
CHN,KOR,2017.0,126,226,-100
ITA,ZAF,2021.0,10,7,3
POL,SWE,2014.0,23,18,5
SRB,BIH,2022.0,12,12,0
NLD,IRL,2019.0,24,20,4
CAN,LBN,2020.0,10,24,-14
IND,HUN,2019.0,10,4,6
BGD,EGY,2016.0,1,1,0
EGY,NLD,2021.0,10,3,7
SYR,DEU,2020.0,4,3,1
ESP,IND,2018.0,16,27,-11
HUN,PRT,2021.0,4,3,1
PRT,CZE,2022.0,4,4,0
MYS,IND,2017.0,62,79,-17
COD,BEL,2020.0,6,13,-7
UGA,USA,2020.0,32,42,-10
RUS,CHN,2014.0,10,9,1
BEL,ECU,2021.0,6,8,-2
GHA,GBR,2021.0,32,31,1
NZL,ARE,2021.0,5,2,3
FRA,SWE,2023.0,54,36,18
BEL,COG,2020.0,7,7,0
FRA,ISR,2022.0,30,23,7
BEL,ESP,2022.0,60,60,0
SAU,USA,2015.0,95,171,-76
ECU,BRA,2019.0,8,25,-17
FRA,ISR,2016.0,35,30,5
TUR,AZE,2019.0,14,8,6
JOR,SAU,2020.0,34,32,2
THA,TWN,2020.0,15,18,-3
LUX,FRA,2023.0,15,22,-7
DEU,DNK,2019.0,123,126,-3
GBR,TUR,2020.0,79,108,-29
BEL,COL,2019.0,8,4,4
NGA,CYP,2018.0,3,1,2
AUT,ITA,2021.0,58,72,-14
ARG,COL,2023.0,8,12,-4
PRT,DEU,2017.0,66,30,36
KOR,DEU,2018.0,71,56,15
ARG,FRA,2015.0,48,26,22
BRA,URY,2002.0,2,9,-7
BGD,DNK,2016.0,2,3,-1
EST,ITA,2022.0,1,4,-3
DNK,NZL,2020.0,5,11,-6
SAU,CAN,2014.0,40,116,-76
MAR,CAN,2023.0,3,4,-1
HKG,KOR,2017.0,14,15,-1
CHL,BRA,2018.0,28,47,-19
MYS,DNK,2020.0,6,5,1
IND,EGY,2021.0,8,8,0
IND,ETH,2012.0,23,8,15
CHN,YEM,2019.0,1,2,-1
PRT,SWE,2017.0,22,5,17
MNE,SRB,2019.0,27,5,22
THA,NPL,2020.0,6,7,-1
BIH,RUS,2021.0,1,1,0
IRL,NLD,2019.0,20,24,-4
GBR,GRC,2022.0,185,120,65
HUN,USA,2023.0,22,25,-3
CAN,BRA,2019.0,78,165,-87
PAK,KOR,2020.0,52,104,-52
NZL,POL,2021.0,4,2,2
TUR,ITA,2020.0,28,11,17
NLD,POL,2002.0,17,16,1
MLI,USA,1999.0,2,1,1
BEL,AUS,2014.0,32,19,13
NLD,TZA,2018.0,5,3,2
FRA,MEX,2023.0,18,13,5
USA,IDN,2019.0,50,22,28
IND,THA,2019.0,16,14,2
CAN,EGY,2023.0,22,20,2
ETH,AUS,2023.0,15,8,7
CAN,SWE,2015.0,45,43,2
USA,HKG,1997.0,90,40,50
ITA,CZE,2020.0,27,18,9
CHE,FIN,2017.0,21,20,1
SGP,PHL,2021.0,6,6,0
EGY,DEU,2015.0,49,70,-21
CAN,POL,2022.0,16,15,1
POL,DNK,2013.0,8,9,-1
DEU,MYS,2020.0,6,15,-9
SWE,ISL,2022.0,16,5,11
MYS,BGD,2008.0,5,10,-5
ETH,CHN,2022.0,16,34,-18
PAK,USA,2006.0,40,38,2
PRT,SWE,2018.0,23,8,15
AUS,IRL,2004.0,21,15,6
NGA,NER,2010.0,19,20,-1
SGP,IND,2001.0,11,16,-5
TWN,IND,2016.0,36,81,-45
KOR,BGD,2019.0,36,18,18
FRA,LBN,2015.0,65,43,22
SWE,IND,2001.0,6,9,-3
MYS,IRN,2014.0,119,70,49
SRB,NLD,2019.0,6,1,5
IND,MEX,2017.0,21,7,14
JPN,CAN,2020.0,69,100,-31
FRA,KOR,2004.0,4,9,-5
ISR,DEU,2003.0,33,32,1
FRA,ISR,2017.0,42,28,14
BRA,CHL,2022.0,31,25,6
GRC,USA,2022.0,98,87,11
ESP,BEL,2019.0,85,74,11
IND,BHR,2020.0,8,1,7
PHL,FRA,2011.0,2,2,0
SVN,DEU,2014.0,16,7,9
BRA,BEL,2019.0,29,16,13
FRA,PAK,2021.0,20,10,10
COL,CAN,2019.0,21,17,4
ITA,TUN,2019.0,7,5,2
MEX,ESP,1999.0,38,57,-19
BRA,ECU,2023.0,11,6,5
CHE,ISR,2002.0,15,7,8
RUS,ZAF,2018.0,119,4,115
GBR,KEN,2018.0,33,26,7
NLD,AUT,2019.0,42,30,12
DEU,BGD,2020.0,17,14,3
POL,BRA,2023.0,8,9,-1
KOR,TWN,2015.0,10,12,-2
IRL,IRN,2023.0,7,11,-4
IRN,BRA,2020.0,10,2,8
FRA,ARE,2022.0,20,8,12
SVK,ITA,2022.0,6,2,4
ITA,POL,2000.0,16,10,6
IND,ISR,2019.0,149,59,90
MEX,PER,2023.0,6,9,-3
USA,BFA,2021.0,4,3,1
RUS,AUS,2015.0,13,16,-3
HUN,NLD,2021.0,14,7,7
MAR,USA,2023.0,13,5,8
BEL,CZE,2023.0,7,9,-2
ITA,HUN,2021.0,11,18,-7
GBR,SWE,2006.0,84,140,-56
ITA,UKR,2023.0,2,10,-8
NOR,BRA,2023.0,4,12,-8
NZL,DEU,2017.0,38,38,0
FIN,CHL,2022.0,3,4,-1
FRA,NOR,2023.0,38,19,19
MAR,FRA,2023.0,34,38,-4
HKG,SGP,2005.0,17,10,7
CZE,SVK,2023.0,39,41,-2
IND,BWA,2022.0,3,2,1
USA,NGA,2021.0,62,109,-47
VNM,TWN,2021.0,32,53,-21
KAZ,ZAF,2021.0,1,1,0
BGR,SWE,2023.0,1,1,0
PHL,JPN,2022.0,21,18,3
RWA,CAN,2023.0,4,3,1
BTN,CHN,2021.0,1,3,-2
GIN,BEL,2022.0,3,1,2
SWE,SVK,2022.0,3,2,1
CAN,BGD,2017.0,20,31,-11
CHN,NGA,2023.0,24,16,8
KOR,JPN,2012.0,111,154,-43
SSD,SDN,2021.0,3,20,-17
BGD,KOR,2022.0,32,40,-8
NLD,CHN,2002.0,26,29,-3
FRA,RUS,2022.0,25,82,-57
DNK,CZE,2021.0,5,4,1
ITA,AUS,2013.0,61,31,30
DEU,IRL,2021.0,43,38,5
JPN,MNG,2021.0,20,3,17
IND,VNM,2020.0,10,7,3
CHE,RUS,2007.0,8,19,-11
POL,ESP,2022.0,36,21,15
IRL,SWE,2023.0,10,9,1
DOM,ESP,2021.0,6,5,1
DEU,ISL,2007.0,1,2,-1
HKG,KOR,2022.0,17,12,5
GRC,ESP,2020.0,18,15,3
DEU,KOR,2017.0,48,62,-14
OMN,MYS,2014.0,8,6,2
ITA,NOR,2022.0,34,20,14
ESP,PHL,2020.0,5,11,-6
SWE,AUT,2022.0,16,17,-1
ARG,BRA,2023.0,11,15,-4
FIN,CHN,2023.0,37,40,-3
NLD,ISR,2013.0,9,10,-1
ETH,GBR,2022.0,7,6,1
ITA,TWN,2023.0,1,4,-3
KOR,FRA,2010.0,28,26,2
CMR,COG,2021.0,5,1,4
SWE,NZL,2023.0,4,2,2
MEX,POL,2022.0,9,1,8
FIN,DNK,2022.0,24,17,7
ETH,KOR,2023.0,4,5,-1
ESP,CZE,2021.0,30,21,9
JOR,GBR,2023.0,17,13,4
PRT,DZA,2022.0,5,5,0
PRT,DNK,2022.0,7,4,3
TLS,IDN,2021.0,1,2,-1
TUR,POL,2022.0,12,2,10
DEU,BRA,2023.0,35,103,-68
IRN,DNK,2021.0,45,17,28
MTQ,FRA,2013.0,33,19,14
CHL,USA,1999.0,38,57,-19
USA,FIN,2005.0,66,73,-7
JPN,TUR,1998.0,3,3,0
BGR,AUS,2018.0,2,1,1
LKA,USA,2001.0,4,3,1
DEU,SVK,2009.0,15,21,-6
BIH,HRV,2017.0,12,19,-7
AUS,KOR,2010.0,22,36,-14
SVN,USA,2016.0,23,14,9
DEU,ZAF,2008.0,26,12,14
GBR,LKA,2003.0,14,5,9
FIN,NOR,2001.0,12,11,1
COL,VEN,2013.0,9,15,-6
NOR,PRT,2021.0,11,10,1
GRC,DEU,2001.0,27,41,-14
ARG,BRA,2000.0,30,15,15
NGA,TUR,2011.0,2,1,1
HRV,TUR,2006.0,1,1,0
DEU,CHL,2002.0,15,14,1
JPN,NLD,1999.0,24,28,-4
GBR,MLT,2008.0,9,3,6
ECU,ESP,2017.0,35,81,-46
ROU,FIN,2014.0,4,2,2
NLD,CHN,1997.0,7,8,-1
RUS,NOR,2002.0,11,8,3
SWE,DNK,2000.0,56,52,4
BEL,GRC,2016.0,10,25,-15
SVK,DEU,2002.0,26,18,8
CRI,USA,2001.0,14,10,4
ZAF,NOR,2002.0,3,1,2
FIN,JPN,1998.0,10,5,5
POL,JPN,2005.0,8,12,-4
USA,VNM,2008.0,17,4,13
LKA,USA,2004.0,9,7,2
NOR,FIN,2001.0,11,12,-1
UKR,BEL,2023.0,4,2,2
RUS,BLR,2013.0,24,25,-1
AUS,CHE,1998.0,20,28,-8
RUS,BEL,2003.0,23,12,11
CIV,FRA,2004.0,15,25,-10
KOR,CAN,2001.0,29,18,11
NLD,DNK,2000.0,25,19,6
COL,SWE,2003.0,1,1,0
ISR,RUS,2009.0,8,7,1
BLR,RUS,2018.0,20,19,1
SAU,NLD,2000.0,4,1,3
BEL,DEU,2006.0,47,74,-27
ITA,ESP,2000.0,62,65,-3
FIN,RUS,2021.0,20,43,-23
RUS,NZL,2005.0,1,2,-1
NLD,SGP,2004.0,3,3,0
BWA,GBR,2020.0,3,5,-2
FRA,REU,2004.0,12,5,7
REU,FRA,2006.0,8,23,-15
JPN,FIN,2002.0,21,12,9
BRA,FRA,1997.0,30,61,-31
SWE,FIN,2000.0,38,50,-12
SAU,ARE,2001.0,7,5,2
DEU,ISR,1998.0,33,38,-5
TUR,CHN,2017.0,11,1,10
NLD,ITA,2011.0,70,112,-42
BRA,NLD,2005.0,13,25,-12
ITA,CZE,1998.0,3,5,-2
BEL,RUS,2003.0,12,23,-11
NLD,LKA,2000.0,3,1,2
FRA,TWN,2013.0,19,10,9
FRA,IND,2010.0,42,93,-51
CHE,GRC,2006.0,6,13,-7
FRA,THA,1998.0,3,3,0
ISL,DNK,1997.0,2,1,1
ROU,DEU,2002.0,33,17,16
FRA,CMR,2003.0,21,6,15
ESP,NLD,2005.0,30,31,-1
AUS,NZL,2004.0,90,96,-6
GLP,FRA,2004.0,26,17,9
AUS,ARG,2010.0,8,9,-1
THA,GBR,2018.0,54,110,-56
FRA,NOR,2006.0,25,8,17
FRA,CHL,1997.0,5,6,-1
CAN,PAK,2018.0,23,30,-7
DEU,ARE,2009.0,6,2,4
DEU,ARE,2021.0,15,9,6
ROU,RUS,2011.0,2,1,1
RUS,ROU,2015.0,1,3,-2
CZE,CHE,2020.0,26,29,-3
LIE,DEU,2013.0,2,2,0
FIN,DNK,2017.0,26,15,11
FRA,SWE,2010.0,59,47,12
FRA,MEX,2000.0,35,31,4
CAN,SGP,2004.0,11,18,-7
IRL,BEL,2004.0,4,5,-1
CHE,HUN,1997.0,6,11,-5
USA,ARE,2002.0,27,13,14
AUS,CHL,2016.0,19,17,2
CHL,AUS,2018.0,12,30,-18
EGY,CAN,2017.0,44,52,-8
ITA,FIN,1999.0,11,4,7
CRI,SWE,1997.0,1,4,-3
ESP,PRT,1997.0,12,22,-10
VEN,USA,2003.0,44,62,-18
ESP,VEN,2020.0,16,21,-5
USA,ROU,2005.0,20,27,-7
RUS,BGR,2021.0,7,7,0
DEU,NZL,1997.0,7,12,-5
CHE,SVK,2003.0,1,10,-9
NLD,CAN,2008.0,52,43,9
SAU,ITA,2007.0,2,3,-1
ITA,SAU,2011.0,5,1,4
FRA,IND,2000.0,15,31,-16
KAZ,DEU,2004.0,2,3,-1
KWT,USA,2001.0,16,9,7
GBR,HKG,2000.0,36,35,1
GBR,EST,1998.0,2,2,0
CUB,COL,2000.0,3,4,-1
EGY,GBR,2003.0,16,25,-9
MLI,SEN,2000.0,2,1,1
ESP,PHL,1998.0,8,2,6
POL,BLR,2014.0,8,3,5
FRA,GUF,2003.0,15,10,5
ESP,NZL,2014.0,11,5,6
BGR,CHE,2003.0,5,2,3
JPN,RUS,2008.0,22,21,1
EST,SWE,2014.0,10,5,5
JOR,QAT,2001.0,5,1,4
NLD,SWE,1997.0,15,10,5
FRA,ARG,1997.0,19,10,9
BGR,USA,2007.0,12,15,-3
USA,SVK,1999.0,15,15,0
RUS,POL,2010.0,7,11,-4
ZAF,NLD,2001.0,12,8,4
FRA,REU,2015.0,25,35,-10
JPN,CZE,2000.0,7,4,3
HRV,SVN,2004.0,2,2,0
CHN,NLD,2004.0,18,24,-6
GBR,AUT,2001.0,33,42,-9
AUS,SWE,2005.0,20,40,-20
FRA,HRV,2014.0,7,5,2
ZAF,GBR,1998.0,46,41,5
NOR,NLD,2018.0,34,48,-14
BGD,USA,2013.0,39,35,4
RUS,PRT,2002.0,8,5,3
AUT,ESP,2000.0,6,13,-7
MYS,AUS,2003.0,9,10,-1
SWE,BEL,2019.0,21,37,-16
AUT,ROU,2013.0,2,2,0
UKR,ESP,2002.0,3,4,-1
PHL,IND,1998.0,6,1,5
GTM,USA,1999.0,2,5,-3
DEU,OMN,2009.0,5,3,2
THA,PHL,2020.0,12,2,10
USA,ZMB,2010.0,8,7,1
USA,ZMB,2023.0,8,8,0
FIN,ESP,2002.0,9,6,3
CHE,CAN,2002.0,51,52,-1
PRT,TUN,2006.0,2,1,1
FRA,ECU,2005.0,1,2,-1
CHE,CAN,2012.0,78,88,-10
CAN,CZE,1997.0,11,2,9
JPN,ITA,2014.0,19,23,-4
CZE,DEU,2008.0,35,36,-1
VEN,USA,2013.0,37,12,25
BRA,POL,2007.0,2,2,0
SAU,TUN,2003.0,1,2,-1
USA,KWT,2000.0,10,9,1
SGP,MYS,1998.0,6,4,2
FIN,JPN,2007.0,5,5,0
NOR,IRL,2014.0,1,1,0
GUF,FRA,2001.0,4,8,-4
ESP,CHN,1998.0,4,6,-2
ITA,BRA,2006.0,25,34,-9
NLD,ESP,2023.0,59,48,11
USA,AUT,2006.0,86,109,-23
NOR,USA,2005.0,53,66,-13
ARE,CAN,1998.0,6,2,4
ESP,PER,2012.0,11,7,4
SAU,CAN,2001.0,13,18,-5
CHE,RUS,1999.0,12,12,0
SWE,BRA,1997.0,8,2,6
GRC,CHE,2011.0,19,12,7
SAU,GRC,2022.0,1,3,-2
KOR,GRC,2018.0,1,2,-1
IND,HKG,2006.0,5,2,3
BHR,GBR,2003.0,3,4,-1
USA,URY,2014.0,15,9,6
KOR,UKR,2009.0,4,2,2
HUN,DNK,2003.0,4,9,-5
GBR,ISR,2009.0,22,35,-13
ITA,RUS,2002.0,31,43,-12
FIN,NOR,2004.0,4,6,-2
CAN,EGY,2000.0,13,8,5
SVK,USA,2002.0,30,16,14
NLD,AUS,2013.0,93,53,40
ISL,DNK,2002.0,4,6,-2
CAN,SWE,2001.0,34,44,-10
AUT,JPN,2001.0,8,9,-1
AUT,JPN,2004.0,10,10,0
DNK,AUT,2009.0,12,9,3
AZE,RUS,2010.0,11,8,3
ISR,RUS,2011.0,8,12,-4
POL,RUS,2022.0,12,18,-6
CHL,FRA,2000.0,7,10,-3
SWE,GRC,2003.0,15,2,13
ISR,RUS,2021.0,12,30,-18
HUN,AUT,1999.0,7,6,1
AUT,HUN,2002.0,11,11,0
MEX,COL,2013.0,26,26,0
AUT,SWE,1997.0,1,3,-2
NOR,USA,1997.0,38,44,-6
JPN,BGR,2001.0,11,8,3
BOL,FRA,2017.0,3,1,2
ESP,HUN,2007.0,5,4,1
BEL,SRB,2007.0,2,5,-3
ITA,SVK,2007.0,3,2,1
CHE,CYP,2015.0,1,2,-1
DEU,JOR,2003.0,10,5,5
NLD,DEU,2024.0,1,2,-1
HRV,GBR,2000.0,2,4,-2
UKR,ITA,2023.0,10,2,8
MKD,USA,1999.0,4,1,3
CHL,MEX,2016.0,19,21,-2
KOR,ESP,2022.0,7,6,1
ITA,CHL,2015.0,19,6,13
BRA,ARG,2006.0,15,27,-12
FRA,NOR,2000.0,17,12,5
NOR,FRA,2002.0,17,27,-10
ARE,KWT,2022.0,2,5,-3
AUS,SGP,2011.0,58,60,-2
BFA,CIV,2000.0,1,6,-5
QAT,BEL,2017.0,2,1,1
ESP,NLD,2002.0,47,52,-5
POL,NLD,2011.0,10,16,-6
USA,SVK,2007.0,18,18,0
ISR,UKR,2002.0,4,10,-6
ZAF,DEU,2015.0,40,37,3
CUB,DEU,2002.0,3,1,2
ESP,POL,1999.0,8,1,7
DNK,AUS,2004.0,15,13,2
USA,CHL,1997.0,39,27,12
TZA,SWE,2000.0,5,2,3
GBR,SAU,2013.0,120,28,92
CZE,SVK,2010.0,41,49,-8
AUS,ZAF,2007.0,20,35,-15
AUS,CHL,2017.0,23,18,5
NOR,RUS,2018.0,12,8,4
AUS,FRA,1997.0,25,32,-7
RUS,POL,2000.0,21,18,3
NOR,CAN,2012.0,7,14,-7
TUR,KAZ,2011.0,3,1,2
CMR,NGA,2002.0,2,2,0
CHE,IRL,2008.0,15,7,8
IRL,CHE,2010.0,11,14,-3
SWE,FRA,1999.0,35,46,-11
SGP,JPN,2008.0,16,25,-9
MYS,ARE,2014.0,12,3,9
ARG,URY,2020.0,12,5,7
JPN,KOR,1998.0,82,72,10
NZL,JPN,2003.0,12,11,1
CAN,AUS,1997.0,69,63,6
DEU,TUR,2005.0,23,28,-5
DEU,SAU,2002.0,5,2,3
BEL,ARM,2003.0,1,1,0
IRL,DEU,2011.0,46,35,11
NLD,MKD,2019.0,1,3,-2
CMR,BEL,2011.0,2,2,0
PAK,MYS,2013.0,30,22,8
ESP,JPN,2016.0,27,15,12
OMN,SAU,2020.0,6,4,2
IRN,RUS,2016.0,7,6,1
TWN,ESP,2013.0,5,2,3
SGP,CHE,2023.0,13,6,7
FRA,COG,2011.0,9,5,4
ARG,DEU,2003.0,28,12,16
PAK,TUR,2011.0,4,7,-3
ESP,CHN,2020.0,70,55,15
QAT,AUS,2018.0,7,6,1
AUT,PAK,2013.0,28,7,21
NLD,ETH,2012.0,4,4,0
SDN,SAU,2016.0,26,13,13
RUS,MEX,2008.0,4,2,2
ISR,NLD,2018.0,14,15,-1
CAN,ITA,2012.0,46,62,-16
FIN,USA,2022.0,59,84,-25
JPN,HKG,2021.0,12,12,0
MYS,CHN,2015.0,19,9,10
BEN,BEL,2015.0,2,4,-2
PAK,IRN,2012.0,4,3,1
GBR,PAK,2014.0,79,41,38
IRQ,USA,2012.0,14,4,10
CHE,SWE,2017.0,59,71,-12
MEX,GBR,2012.0,46,47,-1
ISR,GBR,2019.0,63,53,10
DEU,SGP,2014.0,35,35,0
USA,PER,2015.0,47,38,9
VEN,ESP,2015.0,39,37,2
KOR,GBR,2015.0,55,53,2
AUS,IND,2011.0,61,81,-20
JPN,MAR,2021.0,2,4,-2
IND,NLD,2012.0,33,22,11
NLD,NOR,2014.0,39,13,26
JPN,ITA,2001.0,30,17,13
DNK,AUS,2015.0,28,32,-4
NGA,CAN,2011.0,12,1,11
CMR,GBR,2015.0,3,4,-1
CZE,DNK,2009.0,3,2,1
ESP,ZAF,2017.0,14,11,3
FIN,CHE,2017.0,20,21,-1
IND,HKG,2000.0,10,3,7
HUN,JPN,2014.0,7,5,2
FRA,GRC,2011.0,30,53,-23
ESP,SWE,2014.0,62,42,20
NLD,SRB,2015.0,7,3,4
SVK,DEU,2005.0,20,12,8
NOR,NPL,2018.0,6,4,2
USA,ARE,2012.0,68,21,47
IND,DEU,2012.0,133,112,21
SAU,QAT,2021.0,16,9,7
JOR,ARE,2016.0,9,6,3
TWN,ZAF,2012.0,1,1,0
PAK,BRA,2012.0,5,5,0
HRV,BIH,2016.0,11,10,1
SVK,USA,2012.0,11,7,4
BRA,COL,2015.0,43,48,-5
ZAF,SWZ,2017.0,6,5,1
KEN,NLD,2011.0,6,7,-1
ROU,SWE,2012.0,3,2,1
NZL,MYS,2011.0,12,10,2
NZL,IRL,2018.0,8,17,-9
ISL,ITA,2009.0,1,2,-1
BGD,CHN,2023.0,23,41,-18
CIV,FRA,2015.0,26,39,-13
IND,MEX,2018.0,15,8,7
MEX,TWN,2019.0,3,1,2
DEU,SVK,2019.0,7,10,-3
NLD,NGA,2009.0,4,2,2
EGY,JOR,2012.0,2,2,0
BRA,BEL,2011.0,15,10,5
ZAF,SAU,2019.0,22,13,9
NZL,THA,2007.0,5,1,4
NZL,THA,2020.0,5,4,1
MYS,SAU,2009.0,6,3,3
EGY,CHN,2014.0,7,12,-5
LUX,DEU,2012.0,13,35,-22
MYS,CAN,2013.0,23,13,10
GBR,IRQ,2012.0,7,6,1
MOZ,ZAF,2012.0,1,5,-4
ZAF,BEL,2015.0,14,12,2
SWE,AUT,2017.0,27,32,-5
DEU,LUX,2012.0,35,13,22
LUX,GBR,2022.0,10,9,1
USA,ZWE,2012.0,6,5,1
POL,CAN,2012.0,16,17,-1
USA,CRI,2017.0,27,21,6
FRA,VNM,2015.0,41,19,22
ZAF,UGA,2011.0,4,2,2
GRC,CYP,2012.0,34,15,19
ITA,CYP,2023.0,1,2,-1
KOR,NZL,2019.0,7,4,3
FIN,DEU,2021.0,49,62,-13
RUS,EST,2015.0,5,2,3
SWE,FRA,1998.0,29,39,-10
SVN,DEU,2015.0,13,6,7
ESP,CHL,2014.0,157,73,84
GBR,ISR,2011.0,40,42,-2
KOR,CAN,2015.0,49,39,10
SGP,JPN,2015.0,36,49,-13
CHE,TUR,2020.0,13,28,-15
MAC,USA,2019.0,11,8,3
FRA,KHM,2021.0,8,7,1
NLD,AUS,2006.0,42,18,24
CAN,GRC,1998.0,10,5,5
BRA,GRC,2010.0,2,1,1
PHL,JPN,1998.0,5,5,0
AUT,PSE,2015.0,2,1,1
MYS,SAU,2008.0,7,1,6
RUS,MEX,2011.0,5,6,-1
CHL,ARG,2016.0,16,24,-8
KOR,SGP,2002.0,7,3,4
DEU,PSE,2019.0,7,5,2
URY,CUB,2020.0,1,2,-1
USA,PSE,2017.0,10,3,7
GRC,AUS,2015.0,11,6,5
EST,DEU,2002.0,3,4,-1
CAN,TWN,2005.0,10,11,-1
CUB,ESP,2012.0,49,27,22
CAN,DZA,2010.0,2,3,-1
DEU,BIH,2021.0,3,4,-1
MKD,FRA,2013.0,2,1,1
NZL,MYS,2014.0,28,11,17
CHN,ITA,2006.0,12,13,-1
SYR,USA,2013.0,8,1,7
CAN,TTO,2013.0,4,4,0
DEU,ARG,2012.0,26,41,-15
ITA,CHN,2007.0,15,15,0
JPN,IRN,2014.0,13,10,3
ITA,IND,2001.0,13,11,2
ESP,BOL,2022.0,5,3,2
BEN,BEL,2019.0,4,3,1
NZL,KOR,2011.0,4,5,-1
PAN,DEU,2016.0,1,1,0
ESP,AUT,2020.0,38,25,13
DEU,IRQ,2013.0,2,3,-1
IRQ,DEU,2014.0,1,6,-5
AUS,KEN,2014.0,5,10,-5
IND,NPL,2013.0,29,17,12
DZA,USA,2020.0,7,5,2
VEN,PER,2010.0,1,2,-1
USA,CYP,2019.0,14,9,5
PAK,GBR,2012.0,47,98,-51
POL,ROU,2015.0,3,2,1
QAT,EGY,2020.0,14,7,7
HKG,JPN,2016.0,16,9,7
JOR,GBR,2013.0,9,20,-11
CZE,CAN,2021.0,4,10,-6
NZL,THA,2017.0,9,8,1
PRI,ARG,2013.0,4,2,2
SWE,TZA,2016.0,6,3,3
EGY,GBR,2023.0,51,35,16
FRA,QAT,2015.0,25,9,16
CHN,ESP,2014.0,31,26,5
EGY,CAN,1999.0,12,15,-3
PAK,SGP,2016.0,4,2,2
GBR,EST,2017.0,11,10,1
ARE,EGY,2010.0,9,16,-7
UGA,MYS,2023.0,1,1,0
ITA,BLR,2015.0,1,2,-1
USA,FJI,2020.0,7,5,2
THA,AUS,2008.0,18,37,-19
USA,SHN,2021.0,2,1,1
LKA,KOR,2010.0,2,1,1
POL,NLD,2014.0,20,19,1
ARE,CAN,2017.0,24,33,-9
THA,CAN,2009.0,21,18,3
GRC,IND,2016.0,2,1,1
HUN,CHE,2019.0,14,8,6
BEL,AUT,2023.0,17,20,-3
RUS,TJK,2019.0,7,2,5
CZE,LTU,2020.0,2,1,1
VNM,AUS,2013.0,9,14,-5
CHL,CRI,2017.0,3,2,1
MEX,ITA,1999.0,7,5,2
FRA,COG,2015.0,10,7,3
EGY,NLD,2015.0,2,6,-4
AUS,GHA,2014.0,2,6,-4
BEL,CZE,2013.0,10,11,-1
ESP,NZL,2021.0,4,7,-3
CZE,KOR,2015.0,3,3,0
RWA,ZAF,2023.0,4,7,-3
PRI,COL,2015.0,6,2,4
BEL,COG,2017.0,12,10,2
DNK,NZL,2018.0,8,3,5
IRN,FRA,2017.0,23,25,-2
ECU,ARG,2019.0,8,5,3
EGY,IRL,2021.0,8,4,4
NAM,ZAF,2017.0,9,15,-6
CHE,MEX,2012.0,7,10,-3
NZL,HKG,2016.0,5,12,-7
COL,PRT,2021.0,8,4,4
AFG,FRA,2019.0,6,2,4
ISR,JPN,2021.0,9,8,1
GAB,DEU,2016.0,11,4,7
USA,GRD,2016.0,6,12,-6
CHL,ARG,2017.0,19,25,-6
ARG,ISR,2021.0,1,1,0
JAM,USA,1997.0,3,5,-2
SAU,CAN,2011.0,29,74,-45
COL,AUS,2017.0,10,10,0
COL,CZE,2017.0,1,1,0
IRL,SAU,2020.0,19,4,15
POL,IRN,2020.0,2,16,-14
ITA,CHL,2021.0,14,21,-7
USA,BGD,2005.0,12,6,6
USA,MLT,2016.0,4,2,2
CZE,CHE,2018.0,22,18,4
KEN,ETH,2017.0,8,7,1
PAN,USA,2018.0,27,22,5
FIN,IDN,2017.0,3,3,0
MMR,CHN,2018.0,6,5,1
FRA,VNM,2009.0,14,5,9
HRV,MNE,2014.0,3,2,1
MYS,AUS,2023.0,46,22,24
NGA,SWE,2019.0,4,2,2
SVK,ESP,2016.0,2,3,-1
AUS,CHL,2020.0,13,21,-8
PAK,CAN,2019.0,23,28,-5
CZE,DEU,2011.0,39,36,3
SVK,LUX,2015.0,1,1,0
BGR,ITA,2022.0,2,3,-1
SGP,IDN,2023.0,6,3,3
MAC,HKG,2015.0,6,17,-11
ARG,URY,2017.0,11,10,1
AUT,ZAF,2013.0,4,4,0
NOR,GRC,2017.0,1,9,-8
PRT,IRL,2019.0,11,6,5
USA,NCL,2022.0,7,1,6
HKG,CAN,2015.0,29,22,7
FIN,PRT,2019.0,7,5,2
NLD,NPL,2022.0,2,2,0
LSO,CHE,2017.0,1,1,0
PAK,CAN,2011.0,22,11,11
HKG,ZAF,2022.0,3,4,-1
BGR,SRB,2017.0,2,1,1
AUT,CAN,2012.0,25,15,10
ARE,DEU,2022.0,8,8,0
DNK,IRN,2014.0,6,25,-19
IDN,DEU,2023.0,6,13,-7
SGP,IRL,2014.0,7,5,2
BGD,IND,2017.0,25,9,16
USA,HTI,2022.0,3,3,0
PER,USA,2007.0,33,33,0
CHN,PAK,2011.0,42,27,15
PAK,JPN,2006.0,8,13,-5
AUT,HRV,2017.0,3,8,-5
USA,LTU,2005.0,8,10,-2
BEL,RWA,2013.0,4,4,0
SEN,USA,2017.0,6,16,-10
USA,BEN,2021.0,3,4,-1
GBR,PER,2010.0,3,5,-2
DEU,QAT,2021.0,5,2,3
NLD,HUN,2014.0,9,11,-2
USA,MNG,2020.0,7,6,1
DEU,MYS,2018.0,19,18,1
DEU,ETH,2013.0,10,5,5
FIN,IRL,2008.0,9,3,6
SRB,FRA,2021.0,6,4,2
THA,LAO,2010.0,2,1,1
FJI,NZL,2003.0,2,6,-4
IND,POL,2002.0,5,1,4
MEX,CHN,2021.0,8,7,1
EST,NLD,2023.0,2,2,0
ZWE,GBR,2021.0,8,9,-1
IRL,DEU,2001.0,14,11,3
NZL,SGP,2016.0,14,10,4
SRB,CHE,2020.0,7,5,2
MMR,THA,2022.0,6,5,1
USA,COG,2020.0,7,3,4
FRA,UKR,2017.0,15,17,-2
POL,NOR,2019.0,17,7,10
LKA,CAN,2023.0,5,2,3
NOR,MWI,2022.0,3,1,2
UGA,TZA,2021.0,6,5,1
USA,GAB,2017.0,2,2,0
IRQ,ARE,2019.0,3,3,0
NLD,IRN,2021.0,23,72,-49
NGA,CZE,2022.0,1,2,-1
VEN,JPN,2011.0,1,1,0
AUS,TWN,2002.0,15,6,9
CAN,PAK,2020.0,26,33,-7
CHN,IRL,2009.0,12,11,1
CHN,DNK,2000.0,10,9,1
NLD,HKG,2022.0,9,5,4
ROU,AUT,2019.0,4,3,1
ZWE,GBR,2011.0,5,18,-13
GBR,ZWE,2019.0,10,5,5
VEN,BRA,2011.0,4,1,3
ISR,BRA,2013.0,2,1,1
IDN,CAN,2022.0,6,4,2
BEL,BRA,2019.0,16,29,-13
AUS,HKG,2017.0,51,33,18
RUS,IRN,2011.0,3,2,1
ZAF,SWE,2012.0,8,8,0
NLD,HUN,2004.0,4,9,-5
HRV,GBR,2013.0,11,8,3
GHA,GBR,2008.0,7,17,-10
JPN,PRT,2013.0,5,1,4
ISR,IND,2012.0,15,17,-2
VNM,THA,2004.0,1,2,-1
ITA,BEL,2007.0,41,35,6
HUN,ITA,2011.0,8,12,-4
BFA,FRA,2007.0,6,11,-5
JPN,MNG,2004.0,4,2,2
GRC,QAT,2021.0,1,3,-2
NOR,CHN,2014.0,22,13,9
KOR,TUR,2015.0,6,3,3
POL,NOR,2011.0,8,2,6
GBR,MLT,2011.0,7,10,-3
NPL,USA,2012.0,18,8,10
GRC,QAT,2019.0,2,5,-3
ETH,AUS,2013.0,1,2,-1
GRC,SWE,2010.0,9,7,2
CIV,GBR,2011.0,3,3,0
KOR,NZL,2014.0,5,3,2
FRA,AUT,2010.0,28,20,8
BRA,VEN,2003.0,12,3,9
FIN,NOR,2009.0,16,3,13
BEL,COG,2016.0,11,9,2
BRA,JPN,2010.0,15,9,6
COD,COG,2005.0,4,4,0
SWE,BEL,2008.0,9,12,-3
LBN,SAU,2008.0,6,1,5
CHN,EGY,2013.0,9,3,6
NLD,RUS,2006.0,11,15,-4
CAN,HUN,1999.0,8,7,1
KAZ,RUS,2013.0,9,30,-21
CHN,DNK,2010.0,34,20,14
DNK,CHN,2011.0,22,37,-15
PAK,CHN,2006.0,3,3,0
CHN,PAK,2009.0,23,12,11
QAT,EGY,2007.0,6,7,-1
SVK,KEN,2020.0,5,1,4
ISR,PSE,2012.0,21,11,10
ROU,RUS,2015.0,3,1,2
CHE,NOR,2012.0,14,10,4
IND,IRL,2006.0,13,1,12
ZAF,BWA,2007.0,5,8,-3
FRA,TWN,2010.0,10,6,4
COL,NLD,2006.0,3,4,-1
UGA,NLD,2007.0,1,3,-2
AUS,MOZ,2008.0,2,1,1
CHL,DEU,2006.0,12,25,-13
ARG,AUT,2003.0,2,1,1
AUT,ARG,2010.0,2,2,0
GBR,SAU,2006.0,21,17,4
CAN,TUR,2005.0,10,7,3
AUT,EGY,2009.0,4,3,1
GRC,PRT,2013.0,4,3,1
GLP,FRA,2021.0,30,19,11
GBR,JOR,2006.0,19,5,14
POL,LUX,2020.0,3,3,0
LTU,DEU,2004.0,4,9,-5
THA,CAN,2011.0,16,9,7
SAU,SDN,2008.0,5,5,0
ESP,DZA,2013.0,4,2,2
KWT,MYS,2016.0,1,2,-1
KWT,CAN,2020.0,5,20,-15
ZAF,ZWE,2012.0,9,25,-16
FRA,TWN,2006.0,7,6,1
BEL,AUT,2000.0,3,6,-3
CZE,JPN,2009.0,8,10,-2
GRC,NOR,2012.0,4,1,3
IRL,ITA,2010.0,12,23,-11
CHE,ROU,2018.0,10,9,1
SAU,NGA,2013.0,9,6,3
GBR,ROU,2006.0,7,13,-6
IRL,SRB,2016.0,2,1,1
FRA,HRV,2019.0,6,8,-2
GBR,ISL,2011.0,7,7,0
CAN,THA,2012.0,21,13,8
KEN,TZA,2010.0,6,5,1
AUT,PRT,2005.0,5,1,4
IND,BEL,2010.0,28,8,20
ETH,DEU,2003.0,4,2,2
CHE,URY,2010.0,2,2,0
GRC,CHN,2014.0,7,3,4
AUT,IRN,2010.0,8,10,-2
FRA,GRC,2008.0,24,25,-1
KEN,FRA,2014.0,3,5,-2
CUB,USA,2013.0,11,7,4
USA,UGA,2023.0,15,32,-17
TWN,GBR,2010.0,26,46,-20
DEU,JOR,2006.0,10,7,3
IND,ITA,2013.0,50,49,1
ZAF,IND,2005.0,6,8,-2
NOR,BGD,2010.0,1,2,-1
PAK,BGD,2019.0,7,13,-6
JPN,HKG,2008.0,17,8,9
SDN,GBR,2017.0,2,4,-2
RUS,KAZ,2007.0,10,15,-5
JPN,ESP,2013.0,19,14,5
NGA,CHN,2010.0,3,11,-8
MDA,RUS,2005.0,1,8,-7
ESP,RUS,2011.0,6,15,-9
CAN,BEN,2009.0,2,3,-1
NLD,HRV,2011.0,5,4,1
ISL,NOR,2019.0,3,2,1
LTU,CAN,2020.0,3,1,2
FRA,VEN,2009.0,13,6,7
MAR,BEL,2008.0,3,8,-5
SWZ,CHE,2012.0,11,13,-2
NZL,JPN,2010.0,13,17,-4
SWE,NLD,2003.0,39,39,0
PRT,DNK,2020.0,8,14,-6
CUB,GBR,2011.0,4,2,2
IRN,ISL,2012.0,1,1,0
THA,NPL,2016.0,7,7,0
ITA,CMR,2016.0,9,3,6
SGP,NOR,2021.0,9,3,6
USA,TUN,1998.0,3,2,1
LBN,GBR,2009.0,5,9,-4
BLR,RUS,2007.0,16,9,7
AUS,DNK,2010.0,22,20,2
UGA,GBR,2008.0,10,16,-6
SWE,PAK,2011.0,5,12,-7
KOR,TUR,2014.0,6,6,0
JPN,PAK,2013.0,18,5,13
ITA,IRL,2005.0,11,9,2
NLD,IRN,2019.0,25,47,-22
IND,PHL,2011.0,4,5,-1
USA,ARM,2014.0,9,6,3
SRB,MNE,2010.0,9,3,6
BEL,CHL,2018.0,11,11,0
DEU,ISL,2016.0,4,8,-4
UKR,AUT,2018.0,5,2,3
TUR,AUS,2007.0,4,2,2
PAK,OMN,2016.0,6,7,-1
NGA,USA,1997.0,13,12,1
AZE,RUS,2013.0,9,4,5
FRA,MLI,2005.0,4,4,0
ISR,RUS,2015.0,10,16,-6
FIN,BGD,2014.0,2,1,1
KOR,TZA,2014.0,2,1,1
SGP,DEU,2013.0,23,50,-27
SGP,BRA,2015.0,4,6,-2
COL,ITA,2008.0,5,4,1
JPN,MNG,2015.0,8,3,5
GRC,SVK,2008.0,1,2,-1
PRT,LUX,2015.0,2,1,1
SVN,SWE,2015.0,7,2,5
BRA,CRI,2020.0,5,3,2
FRA,IRL,2018.0,33,17,16
SAU,ITA,2017.0,6,25,-19
FIN,GHA,2021.0,3,1,2
ARG,PER,2019.0,9,3,6
ESP,AUT,2007.0,11,13,-2
CHN,ETH,2019.0,17,13,4
FRA,MRT,2017.0,5,1,4
TUR,TUN,2021.0,3,2,1
NLD,KOR,2023.0,8,7,1
NAM,ZAF,2018.0,8,10,-2
SWE,VEN,2017.0,3,1,2
KWT,MYS,2018.0,1,4,-3
IND,BTN,2018.0,6,2,4
ESP,NIC,2017.0,1,2,-1
ITA,PHL,2017.0,3,1,2
ARE,AUS,2016.0,9,26,-17
TUN,JPN,2020.0,2,2,0
CHL,ITA,2021.0,21,14,7
CHE,NPL,2017.0,1,2,-1
KAZ,AUT,2019.0,1,3,-2
PAK,IND,2023.0,27,35,-8
THA,MYS,2020.0,10,16,-6
IND,BEL,2023.0,25,9,16
GBR,COL,2017.0,22,15,7
BHS,USA,2017.0,4,2,2
CHN,AUT,2017.0,15,20,-5
BEL,IDN,2021.0,11,4,7
TUN,BEL,2019.0,5,5,0
USA,GTM,2017.0,7,16,-9
AUS,JOR,2015.0,10,3,7
SAU,BHR,2022.0,10,9,1
FIN,DNK,2020.0,18,18,0
TWN,SAU,2018.0,9,2,7
AUS,TZA,2018.0,3,1,2
CHL,NLD,2014.0,6,7,-1
MYS,ARE,2021.0,26,14,12
KOR,PHL,2017.0,15,9,6
CHE,KOR,2017.0,13,19,-6
GBR,LKA,2023.0,8,25,-17
IDN,AUT,2023.0,5,1,4
THA,AUT,2017.0,9,13,-4
DEU,CZE,1998.0,16,22,-6
PER,FRA,2019.0,6,10,-4
NPL,CHN,2021.0,12,31,-19
ARG,CRI,2017.0,2,1,1
PRT,CAN,2007.0,5,4,1
POL,VNM,2019.0,6,4,2
SRB,ITA,2020.0,12,5,7
BFA,SEN,2018.0,3,3,0
MAR,NZL,2023.0,1,2,-1
OMN,GBR,2019.0,10,18,-8
ETH,MYS,2014.0,3,2,1
DNK,NZL,2022.0,8,4,4
SGP,ISR,2013.0,4,4,0
NGA,CHN,2023.0,16,24,-8
USA,KWT,2003.0,13,6,7
CHE,PAK,2001.0,1,1,0
BRA,MEX,2009.0,14,20,-6
TUR,JPN,2003.0,14,14,0
SWE,LVA,2006.0,7,4,3
LVA,SWE,2008.0,2,5,-3
USA,ETH,2005.0,8,7,1
HRV,AUS,2003.0,1,2,-1
IRL,JPN,1999.0,4,2,2
KEN,DEU,2012.0,11,10,1
KEN,USA,2001.0,27,23,4
PYF,FRA,2013.0,14,16,-2
SWE,ISL,1999.0,11,5,6
NLD,IND,1997.0,6,6,0
NOR,CHE,1999.0,3,8,-5
DNK,ITA,2009.0,18,29,-11
CZE,FRA,2000.0,10,25,-15
CIV,USA,2019.0,3,13,-10
SGP,EGY,2012.0,1,1,0
FRA,SAU,2003.0,3,1,2
JPN,PHL,1999.0,11,4,7
HKG,BGD,2013.0,2,4,-2
USA,VAT,2018.0,4,1,3
RUS,UZB,2004.0,6,6,0
JPN,IRL,2003.0,7,2,5
IRL,FRA,2005.0,17,26,-9
NOR,ESP,1997.0,2,3,-1
FRA,DZA,2002.0,34,37,-3
ARM,DEU,2002.0,3,1,2
BLR,ITA,2000.0,4,2,2
CHE,ZAF,2010.0,8,13,-5
CAN,SWE,2009.0,31,43,-12
KEN,DEU,2002.0,6,4,2
ZAF,CIV,2001.0,3,6,-3
USA,ISL,2006.0,25,9,16
FRA,MCO,2002.0,11,3,8
NOR,JPN,2012.0,4,3,1
NZL,CAN,2011.0,34,37,-3
GBR,CHL,2004.0,13,11,2
MDA,RUS,1997.0,3,2,1
POL,RUS,1999.0,11,16,-5
HUN,NLD,2008.0,13,10,3
GRC,NLD,1998.0,8,2,6
AUS,ARE,2005.0,8,4,4
IRN,GBR,1998.0,9,26,-17
CAN,COL,2006.0,7,6,1
SEN,FRA,2004.0,22,28,-6
DNK,CHE,2000.0,18,17,1
NLD,ZWE,2005.0,1,3,-2
ZWE,USA,2023.0,6,2,4
FIN,AUS,2001.0,8,3,5
TZA,DNK,2001.0,5,2,3
LBN,IRQ,2016.0,3,1,2
JPN,NPL,2005.0,7,4,3
KOR,CZE,2002.0,1,2,-1
ESP,URY,1999.0,4,8,-4
THA,USA,1999.0,45,65,-20
CAN,ESP,1999.0,11,24,-13
BLR,USA,2014.0,8,4,4
PHL,DEU,2005.0,4,3,1
RUS,MNG,2008.0,3,2,1
USA,BLR,1998.0,4,14,-10
NLD,ZAF,1998.0,6,4,2
CAN,GRC,1999.0,8,10,-2
GBR,IDN,2006.0,7,1,6
CHE,PRT,1999.0,4,5,-1
VEN,USA,2006.0,36,46,-10
TTO,CAN,2012.0,4,1,3
ROU,JPN,1999.0,13,1,12
KOR,UKR,2001.0,2,3,-1
SVK,NLD,2016.0,5,3,2
DEU,MDA,2010.0,2,1,1
CAN,ZAF,2011.0,19,17,2
AZE,TUR,2008.0,7,10,-3
SWE,ARE,2015.0,6,1,5
CHE,OMN,2015.0,2,1,1
FRA,MCO,1997.0,5,4,1
PSE,ISR,2012.0,11,21,-10
NGA,IND,1997.0,3,1,2
NZL,RUS,2003.0,2,1,1
VEN,COL,2016.0,38,7,31
SYR,USA,2003.0,2,8,-6
UGA,ZAF,2003.0,1,2,-1
POL,DNK,2006.0,5,2,3
IRN,JPN,2002.0,6,9,-3
BRA,IND,2004.0,2,5,-3
COL,JPN,1999.0,1,1,0
ETH,KEN,2006.0,5,2,3
KEN,ETH,2016.0,6,4,2
FRA,COG,2004.0,5,3,2
RUS,ARM,2004.0,7,6,1
AUS,KWT,2005.0,4,1,3
BRA,MEX,2011.0,11,19,-8
SRB,SWE,2012.0,3,2,1
CHE,FIN,1999.0,12,6,6
CZE,DEU,2009.0,28,37,-9
EGY,ITA,2012.0,6,4,2
JPN,KEN,2004.0,7,3,4
CHL,BRA,1998.0,4,18,-14
ISR,CHE,1997.0,9,2,7
CAN,ARE,2002.0,6,2,4
PHL,ESP,2002.0,8,3,5
POL,BEL,1997.0,6,4,2
EGY,OMN,2016.0,6,6,0
HRV,CHE,2005.0,2,1,1
MLI,BFA,2015.0,2,1,1
SWE,ISR,2002.0,2,7,-5
ISR,NLD,1998.0,8,5,3
FRA,COG,2014.0,6,5,1
BRA,LKA,2009.0,1,1,0
HRV,FRA,2002.0,3,3,0
FRA,PRI,2006.0,2,1,1
MEX,RUS,2009.0,8,8,0
CRI,USA,2011.0,13,15,-2
SGP,HUN,1999.0,1,1,0
CHL,BEL,2020.0,4,16,-12
BEL,CHL,2022.0,7,6,1
DNK,KOR,2002.0,1,1,0
JAM,TTO,2014.0,9,13,-4
NOR,AUS,1998.0,2,9,-7
GBR,KEN,1999.0,16,10,6
GEO,ITA,2013.0,1,2,-1
ZAF,MAR,2022.0,5,1,4
USA,SEN,2005.0,2,3,-1
JPN,NGA,2017.0,11,8,3
JOR,USA,2005.0,19,38,-19
BEL,FIN,2012.0,6,4,2
SAU,JOR,2008.0,4,10,-6
DEU,SVN,2003.0,6,7,-1
NOR,ZMB,2004.0,1,1,0
KOR,DEU,1999.0,10,16,-6
SAU,PAK,2000.0,7,10,-3
USA,EST,2013.0,7,8,-1
KOR,BEL,2006.0,6,4,2
CAN,VEN,2002.0,5,2,3
THA,AUS,2001.0,10,23,-13
GUM,USA,2011.0,2,15,-13
IRL,ESP,2004.0,4,4,0
SWE,MEX,2016.0,9,7,2
NLD,SGP,2021.0,17,19,-2
ETH,CHE,2013.0,2,2,0
DEU,ARG,2002.0,20,22,-2
GBR,MWI,2002.0,11,8,3
MEX,CUB,2000.0,10,18,-8
BEL,ITA,2005.0,48,35,13
ARE,GBR,2008.0,9,25,-16
POL,IND,2009.0,3,1,2
VEN,ESP,2021.0,18,6,12
ECU,CUB,2009.0,1,1,0
MYS,ARE,2011.0,1,2,-1
ITA,DNK,2005.0,16,11,5
AUS,POL,1998.0,4,4,0
VEN,PAN,2009.0,1,1,0
GBR,ARE,2003.0,6,7,-1
CAN,ARE,2012.0,19,10,9
BGR,NLD,1998.0,3,4,-1
CHL,SWE,2016.0,3,2,1
IND,SWE,2003.0,14,7,7
KOR,AUS,2002.0,14,10,4
DEU,HRV,1997.0,8,11,-3
SGP,NLD,2023.0,12,6,6
IRN,JPN,2005.0,12,19,-7
IRN,JPN,2012.0,13,14,-1
ROU,GBR,2007.0,12,15,-3
USA,ECU,2006.0,11,19,-8
CAN,MAR,2002.0,4,8,-4
ROU,HUN,1997.0,1,1,0
FRA,PYF,2013.0,16,14,2
ZAF,KEN,1997.0,2,2,0
OMN,KWT,2020.0,2,1,1
DEU,BLR,2001.0,16,18,-2
DEU,BLR,2004.0,8,8,0
BLR,DEU,2005.0,12,7,5
BEL,ROU,2004.0,3,3,0
MEX,ITA,1998.0,1,2,-1
SWE,MYS,2006.0,1,1,0
FRA,AUT,2006.0,30,17,13
USA,BLZ,2002.0,2,1,1
RUS,SRB,2001.0,4,2,2
SRB,RUS,2002.0,1,5,-4
BWA,ZAF,2012.0,11,10,1
CHE,HKG,2010.0,6,4,2
JPN,GHA,2004.0,4,2,2
CAN,EGY,2003.0,13,5,8
AUT,SVK,2001.0,5,9,-4
SDN,DEU,2020.0,5,2,3
ZAF,IRL,2017.0,6,2,4
VNM,BEL,2000.0,2,2,0
SAU,PAK,2006.0,11,7,4
CAN,MAR,2012.0,15,5,10
CRI,FRA,2015.0,3,2,1
ARG,GBR,2015.0,13,12,1
SWE,LTU,1998.0,6,8,-2
SVN,ITA,2004.0,3,3,0
TUN,CAN,2001.0,3,5,-2
USA,HRV,2000.0,16,18,-2
CHE,RUS,2016.0,13,21,-8
AUT,ARE,2018.0,1,2,-1
ROU,ESP,2010.0,7,9,-2
AUS,FLK,2016.0,2,1,1
AUS,FLK,2018.0,1,1,0
FRA,LUX,2012.0,33,20,13
ITA,SVK,2022.0,2,6,-4
JPN,ROU,2015.0,5,2,3
QAT,JPN,2007.0,1,1,0
DZA,QAT,2020.0,2,1,1
DEU,SVK,2008.0,11,20,-9
DEU,SVK,2014.0,11,18,-7
ZAF,ZMB,2014.0,8,4,4
TUR,SAU,2012.0,3,5,-2
USA,URY,2019.0,14,11,3
MEX,NOR,2009.0,3,1,2
SAU,JOR,2015.0,26,36,-10
SRB,GBR,2012.0,5,17,-12
BIH,HRV,2007.0,11,13,-2
TUN,CAN,2015.0,13,5,8
CAN,TUN,2021.0,5,12,-7
GBR,JOR,2010.0,25,10,15
DEU,EST,2017.0,4,13,-9
LKA,CAN,2006.0,6,3,3
BRA,AUT,2012.0,6,5,1
VEN,GBR,2011.0,4,7,-3
CHL,MEX,2020.0,12,26,-14
CAN,BRB,2009.0,1,1,0
FRA,GAB,2014.0,6,6,0
AZE,IRN,2009.0,4,3,1
CRI,MEX,2009.0,3,1,2
THA,ITA,2010.0,5,1,4
SVN,GBR,2006.0,6,6,0
CHN,SRB,2019.0,3,4,-1
JPN,HKG,2015.0,5,8,-3
HRV,USA,2011.0,27,11,16
SAU,USA,2009.0,36,90,-54
CMR,BEL,2008.0,2,1,1
KOR,MYS,2013.0,12,8,4
MKD,USA,2022.0,3,3,0
USA,MKD,2023.0,2,1,1
ARG,CAN,2012.0,14,8,6
CHE,FIN,2007.0,15,10,5
GRC,DNK,2014.0,18,8,10
EST,SWE,2011.0,5,13,-8
USA,LAO,2018.0,6,1,5
FRA,LUX,2005.0,14,3,11
MKD,SRB,2013.0,7,4,3
SRB,MKD,2014.0,4,9,-5
ESP,KOR,2013.0,4,3,1
GBR,MOZ,2016.0,3,2,1
AUS,SDN,2015.0,1,1,0
DEU,KGZ,2016.0,3,1,2
SYR,FRA,2016.0,2,10,-8
POL,UKR,2012.0,18,14,4
DNK,ITA,2011.0,12,38,-26
CHE,ZAF,2023.0,7,10,-3
AUT,EGY,2011.0,6,4,2
BWA,USA,2017.0,13,11,2
AUS,HRV,2021.0,2,3,-1
VNM,RUS,2021.0,12,28,-16
NLD,EST,2016.0,2,2,0
TUR,NLD,2018.0,30,16,14
BLR,BEL,2010.0,2,3,-1
HKG,IRL,2017.0,2,4,-2
USA,GAB,2016.0,5,1,4
GRC,CHN,2015.0,5,3,2
RUS,KOR,2022.0,8,8,0
DNK,IRN,2008.0,2,4,-2
IND,AUS,2024.0,5,1,4
MCO,FRA,2012.0,7,10,-3
PER,NZL,2010.0,1,1,0
MEX,IND,2016.0,5,14,-9
DNK,BEL,2012.0,13,4,9
KOR,TWN,2009.0,15,11,4
CAN,BEN,2011.0,1,1,0
ITA,IND,2015.0,45,44,1
TUN,EGY,2015.0,1,1,0
MAR,TWN,2003.0,2,1,1
BEL,MEX,2009.0,6,3,3
EGY,KWT,2013.0,14,15,-1
TUR,CZE,2015.0,5,3,2
HKG,FRA,2021.0,7,8,-1
USA,KAZ,2023.0,9,13,-4
CAN,SRB,2010.0,3,3,0
SAU,NZL,2019.0,6,4,2
SMR,ITA,2022.0,4,5,-1
ARG,CZE,2013.0,1,1,0
NLD,EGY,2020.0,10,3,7
MEX,IND,2018.0,8,15,-7
IRL,NLD,2015.0,15,17,-2
URY,ARG,2012.0,4,8,-4
IRL,SWE,2013.0,14,3,11
MAR,ZAF,2013.0,1,1,0
DZA,BEL,2013.0,4,6,-2
PHL,FRA,2014.0,6,4,2
OMN,MYS,2011.0,4,5,-1
BFA,NER,2014.0,1,1,0
DEU,ARE,2015.0,7,4,3
ZWE,ZAF,2009.0,23,4,19
SVN,ESP,2018.0,7,5,2
IND,NGA,2015.0,5,12,-7
GBR,ZWE,2011.0,18,5,13
GBR,CHL,2008.0,10,16,-6
DEU,CUB,2015.0,8,2,6
CHL,BOL,2011.0,3,1,2
CHL,BOL,2021.0,7,3,4
VNM,CHN,2013.0,5,6,-1
GBR,SDN,2011.0,5,1,4
VEN,CHL,2011.0,6,3,3
FRA,SYR,2014.0,11,3,8
ROU,HUN,2012.0,4,9,-5
TWN,PHL,2015.0,4,7,-3
MWI,GBR,2012.0,20,21,-1
FIN,LTU,2011.0,3,4,-1
PAK,GBR,2005.0,15,20,-5
VEN,BRA,2009.0,4,6,-2
EGY,ESP,2015.0,6,15,-9
TUR,CHE,2014.0,16,14,2
CHE,ROU,2017.0,6,10,-4
IRN,IND,2014.0,9,27,-18
ESP,IRL,2004.0,4,4,0
ITA,BGR,2004.0,7,6,1
COL,PER,2006.0,1,1,0
GBR,MWI,2012.0,21,20,1
ZMB,USA,2015.0,18,14,4
KWT,SAU,2010.0,6,6,0
ESP,VEN,2022.0,10,14,-4
NZL,DNK,2016.0,3,3,0
LTU,CZE,2019.0,3,1,2
BFA,FRA,1999.0,7,10,-3
POL,AUT,2014.0,4,5,-1
NOR,MYS,2013.0,1,2,-1
CZE,BGD,2021.0,2,1,1
LTU,LVA,2012.0,6,1,5
AUT,TUR,2021.0,8,8,0
LVA,LTU,2009.0,3,1,2
YEM,EGY,2023.0,6,6,0
ARE,FRA,2015.0,4,19,-15
SWE,GHA,2018.0,2,1,1
MYS,DNK,2016.0,5,3,2
SAU,ESP,2017.0,4,7,-3
NLD,LTU,2016.0,2,3,-1
SGP,MYS,2018.0,16,24,-8
AFG,ZAF,2020.0,1,1,0
SWE,MEX,2017.0,7,6,1
CHE,MWI,2019.0,1,2,-1
ARE,AUS,2017.0,24,18,6
KWT,PAK,2022.0,1,4,-3
NZL,GHA,2015.0,2,2,0
COG,COD,2013.0,22,27,-5
BEL,TZA,2015.0,4,2,2
BEL,HRV,2000.0,1,2,-1
IRL,ARE,2021.0,7,3,4
VNM,DEU,2013.0,8,16,-8
QAT,IND,2020.0,9,22,-13
TUR,SGP,2014.0,2,4,-2
DEU,PSE,2011.0,6,4,2
ESP,POL,2016.0,21,15,6
POL,ESP,2020.0,21,20,1
PRT,MYS,2019.0,3,2,1
EGY,GRC,2022.0,2,3,-1
BRA,POL,2018.0,5,4,1
GUM,USA,2009.0,6,4,2
NLD,AUS,2023.0,31,60,-29
GBR,LVA,2016.0,2,4,-2
KEN,AUS,2016.0,7,2,5
PAK,ITA,2013.0,4,9,-5
NOR,MEX,2015.0,1,1,0
IDN,IND,2012.0,14,19,-5
EGY,AUS,2013.0,9,8,1
SAU,IRL,2018.0,6,7,-1
CHE,LUX,2015.0,3,3,0
USA,PLW,2016.0,2,1,1
NLD,LUX,2015.0,8,5,3
MYS,PAK,2014.0,47,66,-19
MYS,EGY,2013.0,3,6,-3
AUT,SGP,2016.0,2,3,-1
NAM,ZAF,2016.0,4,10,-6
PAK,OMN,2017.0,5,2,3
HUN,CHE,2009.0,17,7,10
NLD,COL,2011.0,4,6,-2
HUN,ITA,2019.0,12,13,-1
PHL,IND,2018.0,7,7,0
KAZ,GBR,2013.0,3,3,0
IND,IDN,2009.0,6,4,2
NOR,NZL,2019.0,4,6,-2
GBR,ECU,2005.0,3,3,0
TUR,GRC,2019.0,2,5,-3
FRA,IRN,2020.0,16,41,-25
SAU,KAZ,2014.0,3,1,2
TUR,CAN,2016.0,26,25,1
CHE,TWN,2023.0,3,5,-2
NLD,HKG,2018.0,10,6,4
POL,BLR,2021.0,4,5,-1
ITA,GRC,2021.0,35,31,4
MEX,BOL,2017.0,3,1,2
ZAF,ARE,2014.0,1,2,-1
ESP,TTO,2016.0,2,1,1
TWN,GBR,2023.0,20,19,1
JPN,TUR,2022.0,2,3,-1
NZL,CHL,2012.0,3,6,-3
ZAF,BWA,2020.0,16,9,7
MAC,CAN,2019.0,2,1,1
THA,JPN,1998.0,16,18,-2
IND,PRI,2013.0,3,1,2
IRL,ARE,2019.0,3,1,2
FRA,MCO,2012.0,10,7,3
SWE,BEL,2015.0,17,27,-10
ITA,ALB,2016.0,9,2,7
PHL,USA,2014.0,25,39,-14
FIN,AUT,2020.0,15,7,8
NLD,CHL,2014.0,7,6,1
HRV,NLD,2015.0,7,4,3
GRC,BEL,2017.0,24,8,16
GRC,ESP,2022.0,14,21,-7
TTO,USA,2016.0,11,7,4
IRL,CAN,1998.0,8,14,-6
GBR,SHN,2018.0,4,3,1
ISL,ITA,2015.0,3,5,-2
EGY,MYS,2022.0,7,8,-1
LVA,LTU,2021.0,6,4,2
IND,KHM,2015.0,1,1,0
SWZ,USA,2019.0,5,6,-1
AFG,USA,2020.0,27,6,21
ITA,PRT,2006.0,6,7,-1
SRB,DNK,2007.0,2,2,0
BEN,FRA,2017.0,16,12,4
NOR,DEU,2014.0,33,66,-33
AUS,RUS,2022.0,6,10,-4
LKA,GBR,2017.0,15,17,-2
NZL,ITA,2023.0,3,3,0
SGP,SAU,2020.0,8,3,5
PAK,THA,2016.0,4,6,-2
PHL,SGP,2021.0,6,6,0
LBN,SAU,2015.0,1,8,-7
FJI,AUS,2017.0,8,13,-5
ETH,UGA,2023.0,3,4,-1
IND,NZL,2012.0,12,5,7
BGD,THA,2015.0,2,5,-3
DEU,ECU,2017.0,7,5,2
SEN,CAN,2019.0,4,2,2
CMR,CHE,2017.0,4,4,0
NLD,TWN,2012.0,4,2,2
CHN,NPL,2018.0,15,15,0
MYS,HKG,2008.0,1,4,-3
FRA,HKG,2018.0,10,8,2
ITA,SAU,2014.0,11,7,4
IRL,SGP,2010.0,9,3,6
BRA,PAN,2016.0,1,2,-1
EGY,FRA,2015.0,18,25,-7
IRL,DEU,2004.0,10,22,-12
DEU,KAZ,2021.0,8,9,-1
FIN,EST,2020.0,22,10,12
AUS,NCL,2020.0,3,1,2
IRN,PRT,2017.0,11,9,2
IDN,NZL,2021.0,2,8,-6
NGA,IRN,2016.0,2,3,-1
TUN,OMN,2021.0,4,1,3
AUS,ETH,2023.0,8,15,-7
BRA,CZE,2018.0,14,2,12
CHL,NLD,2015.0,8,12,-4
RUS,SGP,2017.0,3,5,-2
CHE,TUN,2019.0,4,3,1
EGY,ESP,2014.0,7,8,-1
GHA,BFA,2017.0,3,1,2
GBR,SHN,2017.0,2,1,1
ITA,TUN,2015.0,10,6,4
BEN,FRA,2016.0,8,10,-2
CHN,AUT,2018.0,24,22,2
IRQ,DEU,2015.0,3,6,-3
ARG,PER,2021.0,6,3,3
BGR,DEU,2020.0,9,16,-7
ZAF,TZA,2016.0,9,6,3
CHN,MEX,2015.0,1,4,-3
FRA,ARE,2020.0,19,8,11
BEL,JPN,2015.0,13,19,-6
IRL,HUN,2020.0,1,4,-3
FIN,JPN,2022.0,10,7,3
TLS,AUS,2015.0,1,2,-1
ITA,JPN,2021.0,34,23,11
ISR,POL,2013.0,5,3,2
CHL,MEX,2007.0,6,11,-5
BGR,JPN,2012.0,2,4,-2
NZL,PAK,2019.0,8,8,0
BRA,AUT,2002.0,3,5,-2
DNK,GRC,2000.0,2,2,0
ISR,TUR,2011.0,2,2,0
SAU,IND,2006.0,8,11,-3
GBR,TTO,2005.0,4,1,3
CHE,VNM,2021.0,3,2,1
USA,NER,2018.0,3,2,1
ITA,IND,2008.0,15,34,-19
AUS,PAK,2023.0,23,37,-14
CHN,SDN,2020.0,27,7,20
SVK,IND,2019.0,3,2,1
FIN,POL,2018.0,6,6,0
PSE,USA,2019.0,7,10,-3
ZAF,QAT,2023.0,1,2,-1
NOR,BGD,2023.0,3,2,1
KAZ,TUR,2023.0,4,5,-1
URY,SWE,2019.0,4,1,3
ITA,ISR,2020.0,21,19,2
CHE,IRL,2019.0,18,20,-2
POL,ITA,2019.0,20,45,-25
CHN,KAZ,2020.0,5,6,-1
ITA,MEX,2016.0,25,9,16
AUS,LVA,2020.0,1,1,0
RUS,AUS,2011.0,15,9,6
ITA,FIN,2017.0,25,16,9
BWA,USA,2018.0,8,14,-6
IRL,POL,2023.0,4,6,-2
JOR,DEU,2021.0,11,11,0
JPN,MMR,2021.0,18,6,12
USA,TCD,2016.0,1,1,0
IDN,CHN,2019.0,10,13,-3
IND,IDN,2021.0,29,14,15
CAN,TUN,2019.0,3,14,-11
IRN,TWN,2016.0,3,3,0
JOR,PSE,2022.0,5,2,3
LBN,ITA,2017.0,4,2,2
PHL,MYS,2020.0,2,2,0
AUT,POL,2000.0,1,7,-6
IRL,ZAF,2020.0,3,9,-6
NLD,LUX,2014.0,7,2,5
USA,SRB,2010.0,22,16,6
GBR,CUB,1999.0,1,1,0
OMN,MYS,2021.0,5,28,-23
USA,ECU,2023.0,13,17,-4
ETH,NOR,2023.0,6,4,2
HUN,ZAF,2022.0,2,2,0
PRT,AUT,2020.0,10,7,3
ITA,URY,2022.0,1,1,0
CHL,BOL,2019.0,3,2,1
MYS,AFG,2021.0,6,4,2
BRA,ZAF,2021.0,8,7,1
NZL,DNK,2022.0,4,8,-4
PER,BEL,2022.0,3,3,0
USA,KAZ,2006.0,1,2,-1
EGY,LBY,2021.0,8,3,5
IND,BTN,2022.0,5,3,2
RWA,SWE,2023.0,3,3,0
JPN,MMR,2011.0,3,1,2
IRN,SVK,2023.0,4,2,2
DEU,VNM,2012.0,13,10,3
ZMB,GBR,2022.0,2,8,-6
SAU,ESP,2018.0,4,8,-4
VEN,CAN,2017.0,7,1,6
NLD,CZE,2017.0,6,5,1
IND,IRN,2023.0,7,10,-3
ECU,DEU,2023.0,3,3,0
CAN,GHA,2023.0,4,6,-2
IND,PAK,2012.0,21,23,-2
PAK,BGD,2021.0,14,13,1
BGD,BEL,2022.0,2,1,1
IRQ,HUN,2023.0,6,8,-2
VEN,DEU,2010.0,4,4,0
URY,ITA,2021.0,2,3,-1
NZL,KOR,2021.0,4,10,-6
MYS,TUR,2018.0,10,2,8
UKR,AUT,2022.0,3,1,2
JPN,BEN,2009.0,1,2,-1
ARE,CHE,2021.0,4,6,-2
SGP,PAK,2019.0,2,3,-1
AUS,ISR,2022.0,13,12,1
CYP,NGA,2020.0,6,1,5
EGY,ZAF,2015.0,4,3,1
THA,PHL,2016.0,3,3,0
ARG,BEL,2021.0,10,8,2
VEN,COL,2017.0,47,20,27
FRA,BGR,2021.0,5,6,-1
ECU,BOL,2019.0,2,1,1
USA,LBN,2007.0,28,40,-12
GBR,BGD,2016.0,24,20,4
SWE,VNM,2019.0,7,1,6
RUS,CAN,2009.0,19,22,-3
IND,NZL,1997.0,1,1,0
OMN,GBR,2011.0,3,10,-7
GBR,GMB,2017.0,4,7,-3
UGA,DEU,2016.0,6,10,-4
TUR,KAZ,2014.0,5,2,3
CHL,GBR,2012.0,21,26,-5
IDN,THA,2016.0,4,10,-6
FIN,TUR,2018.0,4,4,0
SAU,BHR,2016.0,5,3,2
IND,VNM,2018.0,5,1,4
CAN,IDN,2012.0,8,3,5
IRN,DNK,2015.0,19,6,13
NZL,JPN,2023.0,7,4,3
SGP,PHL,2014.0,3,4,-1
BGD,LKA,2022.0,1,1,0
ESP,KEN,2018.0,4,1,3
ZMB,ZAF,2021.0,10,12,-2
DEU,MWI,2018.0,3,1,2
SVN,SRB,2019.0,8,4,4
IND,PAK,2005.0,8,12,-4
HKG,FRA,2019.0,11,8,3
AUT,NZL,2013.0,6,4,2
SAU,IRL,2022.0,5,14,-9
CIV,CRI,2019.0,1,6,-5
PER,BEL,2018.0,3,2,1
AUT,IRN,2006.0,1,1,0
FRA,UKR,2016.0,12,15,-3
AUT,FIN,2019.0,12,13,-1
POL,THA,2023.0,1,4,-3
GUF,FRA,2019.0,35,34,1
NZL,BRA,2018.0,3,8,-5
EST,LVA,2020.0,6,4,2
GTM,MEX,2018.0,6,2,4
AUT,NLD,2023.0,21,17,4
UGA,CHE,2022.0,2,1,1
SAU,IRL,2017.0,7,3,4
BLR,NOR,2018.0,2,2,0
AUS,PRT,2019.0,6,8,-2
USA,MAC,2021.0,14,7,7
MYS,CAN,2023.0,10,3,7
DEU,EST,2018.0,11,10,1
ARE,ITA,2018.0,7,15,-8
PNG,AUS,2018.0,4,12,-8
BGD,NLD,2017.0,3,6,-3
CHN,ESP,2008.0,8,10,-2
PHL,CHE,2019.0,6,1,5
COL,CHE,2014.0,6,3,3
KAZ,CHE,2021.0,3,2,1
LKA,IND,2013.0,3,5,-2
SRB,BGR,2014.0,2,2,0
PER,GBR,2020.0,9,7,2
MAC,MAR,2019.0,10,4,6
DNK,SAU,2022.0,3,2,1
PER,COL,2020.0,4,8,-4
AUT,RUS,2020.0,12,18,-6
IRL,GHA,2018.0,1,2,-1
USA,PRY,2020.0,8,2,6
FJI,AUS,2016.0,8,7,1
CAN,DNK,2016.0,26,31,-5
SAU,SDN,2014.0,4,34,-30
POL,KOR,2023.0,3,7,-4
EGY,TUR,2019.0,4,3,1
DEU,SGP,2011.0,32,15,17
KEN,EGY,2021.0,4,1,3
BOL,CHL,2020.0,3,1,2
DNK,BRA,2020.0,15,26,-11
UGA,GBR,2004.0,4,9,-5
SWE,USA,2024.0,2,1,1
COL,BOL,2018.0,2,3,-1
HUN,BEL,2007.0,8,6,2
CUB,MEX,2021.0,12,12,0
JPN,TUR,2016.0,14,8,6
NGA,CMR,2019.0,3,2,1
ARG,ITA,2020.0,18,18,0
ESP,QAT,2017.0,7,3,4
BIH,AUT,2018.0,4,2,2
GBR,GHA,2005.0,7,4,3
AUS,BRA,1997.0,3,2,1
TUR,GBR,2005.0,26,37,-11
SRB,BEL,2023.0,1,2,-1
CRI,USA,2019.0,25,34,-9
DEU,HKG,2023.0,6,14,-8
IRL,ITA,2006.0,8,9,-1
CIV,ZAF,2014.0,12,4,8
DEU,SGP,2019.0,31,48,-17
SVN,USA,2020.0,14,13,1
BEL,DNK,2023.0,12,10,2
USA,LAO,2022.0,4,1,3
KEN,NLD,2014.0,9,11,-2
FIN,AUS,2004.0,13,10,3
SWE,SAU,2022.0,14,12,2
PRI,IND,2007.0,2,2,0
SWE,KEN,2023.0,1,1,0
PAK,BGD,2009.0,9,7,2
ITA,KEN,2022.0,3,4,-1
HKG,CAN,2008.0,21,26,-5
KHM,BEL,2014.0,1,1,0
SRB,CZE,2021.0,2,3,-1
THA,NPL,2018.0,4,4,0
GTM,MEX,2022.0,2,7,-5
PHL,ITA,2021.0,5,6,-1
UZB,RUS,2013.0,10,9,1
TUR,CHE,2004.0,6,3,3
FRA,CRI,2017.0,4,4,0
SWE,MAR,2019.0,1,3,-2
IRN,BEL,2011.0,12,18,-6
BWA,UGA,2021.0,1,1,0
ITA,SVK,2017.0,8,3,5
ITA,QAT,2022.0,2,1,1
GRC,CHL,2022.0,1,1,0
UGA,CAN,2021.0,3,1,2
USA,PHL,2023.0,14,20,-6
CZE,MEX,2022.0,4,8,-4
BGD,DNK,2020.0,2,3,-1
NGA,BRA,2019.0,5,4,1
TWN,CAN,2021.0,17,9,8
LBN,SWE,2023.0,2,1,1
SLE,USA,2021.0,4,7,-3
CHN,PRK,2023.0,6,8,-2
BEL,MAR,1999.0,3,1,2
MAR,BEL,2001.0,3,6,-3
BLR,ESP,2010.0,2,1,1
CAN,GRC,2007.0,8,6,2
JPN,MEX,2012.0,5,4,1
USA,QAT,2002.0,2,1,1
DEU,GEO,2012.0,5,6,-1
IRN,AUS,2002.0,6,23,-17
POL,UKR,2002.0,13,22,-9
MWI,GBR,2002.0,8,11,-3
RUS,KAZ,1999.0,9,5,4
NOR,AUT,2011.0,5,3,2
CHN,IND,2008.0,8,6,2
SAU,IND,2010.0,7,55,-48
EGY,JPN,2008.0,15,50,-35
UKR,NOR,2017.0,4,1,3
CAN,KEN,2006.0,1,2,-1
GBR,ISR,2004.0,19,43,-24
SWE,SAU,2018.0,11,7,4
DZA,ARG,2018.0,1,1,0
NLD,PRT,2000.0,8,9,-1
AUS,VNM,2001.0,6,4,2
DEU,SVN,2013.0,4,8,-4
LTU,USA,2009.0,5,8,-3
IRL,FRA,2002.0,16,21,-5
POL,CHE,2002.0,12,14,-2
PSE,USA,2011.0,7,10,-3
IRL,POL,2006.0,3,4,-1
JPN,MNG,2008.0,9,1,8
USA,SVK,2018.0,19,10,9
SGP,ZAF,2009.0,2,2,0
TWN,ISR,2014.0,1,1,0
EGY,KEN,2009.0,1,2,-1
CHE,THA,2011.0,4,5,-1
ESP,IND,1999.0,4,3,1
EGY,YEM,2005.0,2,3,-1
THA,PHL,2018.0,3,7,-4
ZAF,KEN,2002.0,3,6,-3
ESP,TUN,2005.0,4,3,1
GHA,USA,1999.0,8,3,5
ISL,SWE,2015.0,15,22,-7
PAK,JPN,2010.0,5,13,-8
EGY,YEM,2002.0,3,2,1
DNK,CAN,2009.0,9,16,-7
AUS,FIN,2005.0,12,6,6
FRA,MTQ,2002.0,13,8,5
HRV,FRA,2005.0,4,4,0
PRI,ESP,2016.0,7,8,-1
CHE,BEL,2002.0,22,33,-11
AUS,LKA,2002.0,4,2,2
FRA,MDG,2008.0,11,7,4
IND,KWT,2010.0,5,2,3
JPN,SAU,2002.0,3,1,2
JPN,ROU,2004.0,6,12,-6
ITA,PRT,2000.0,10,6,4
PRT,ITA,2001.0,12,16,-4
THA,AUS,2004.0,10,26,-16
CHE,OMN,2008.0,1,1,0
TZA,KEN,2017.0,5,8,-3
MEX,POL,2007.0,2,3,-1
PRT,AGO,2002.0,2,1,1
AUS,BEL,2009.0,14,19,-5
ITA,ARG,2003.0,9,19,-10
TUN,DZA,2011.0,2,2,0
BEL,POL,2002.0,11,14,-3
ETH,KEN,2000.0,4,1,3
GHA,DEU,2013.0,4,10,-6
IRN,USA,2001.0,23,22,1
SYR,JOR,2016.0,5,1,4
GHA,GBR,2004.0,3,8,-5
RWA,UGA,2018.0,3,3,0
IRL,MYS,2013.0,10,5,5
USA,KAZ,2010.0,4,2,2
RUS,SRB,2004.0,14,10,4
IND,SVK,2023.0,4,1,3
TUR,CHE,2008.0,6,1,5
ALB,USA,2012.0,1,2,-1
FIN,EGY,2012.0,3,2,1
HRV,SRB,2007.0,7,10,-3
NGA,BEN,2000.0,2,2,0
BEL,MAR,1998.0,5,3,2
ROU,HUN,2005.0,5,3,2
NZL,CHE,2013.0,19,12,7
EGY,ESP,2001.0,2,2,0
COL,MEX,2007.0,10,10,0
MEX,COL,2010.0,17,21,-4
PRT,GRC,2006.0,1,1,0
JPN,NOR,2008.0,5,3,2
NOR,SAU,2016.0,3,1,2
CAN,JOR,2005.0,7,6,1
ESP,IRL,2001.0,4,4,0
FRA,VEN,2019.0,4,3,1
RUS,MNG,2001.0,1,1,0
RUS,MNG,2014.0,2,1,1
BLR,UKR,2002.0,3,6,-3
ZAF,ZWE,2005.0,4,17,-13
CMR,BEN,2010.0,1,1,0
LBN,CAN,2007.0,7,5,2
SVK,BEL,2009.0,2,2,0
CAN,GHA,2006.0,3,4,-1
BGR,USA,2022.0,7,6,1
RUS,TUR,2005.0,4,7,-3
USA,HRV,2006.0,14,18,-4
CAN,BFA,2013.0,3,2,1
UGA,MWI,2018.0,1,1,0
HRV,PRT,2010.0,2,1,1
NLD,GRC,2005.0,8,10,-2
SRB,GBR,2005.0,11,13,-2
JPN,VNM,1998.0,2,2,0
GRC,ITA,2012.0,25,29,-4
RUS,BGR,2001.0,6,1,5
IND,TZA,1999.0,3,3,0
MEX,AUS,2002.0,5,2,3
ZAF,ITA,2009.0,2,4,-2
ZAF,ZWE,2002.0,3,10,-7
RUS,AZE,2004.0,7,4,3
FRA,NZL,2005.0,7,9,-2
NGA,USA,2005.0,22,12,10
JPN,EST,2020.0,2,2,0
JPN,LKA,2009.0,7,2,5
GBR,UKR,2005.0,4,17,-13
NZL,CHL,2005.0,3,1,2
SWE,MOZ,2014.0,2,1,1
ARG,ZAF,2010.0,2,2,0
ZWE,BEL,2021.0,2,1,1
AUS,IND,2001.0,22,38,-16
SVK,SVN,1998.0,4,1,3
USA,ISL,2010.0,25,4,21
SAU,DZA,2012.0,5,7,-2
CHN,ARE,2008.0,1,1,0
GBR,LKA,2000.0,10,7,3
IRL,CZE,2019.0,7,3,4
FRA,BEN,2013.0,14,9,5
CZE,SWE,2007.0,6,4,2
ZAF,SAU,2015.0,12,17,-5
USA,MAC,2011.0,9,2,7
ROU,FRA,2018.0,23,25,-2
BGD,CAN,2014.0,27,13,14
SGP,DEU,2003.0,5,14,-9
DNK,CHE,2010.0,22,23,-1
TWN,IRN,2011.0,2,2,0
IND,KEN,1998.0,2,3,-1
NGA,ETH,2016.0,4,1,3
ETH,TZA,2018.0,1,1,0
SRB,FRA,2011.0,4,3,1
ZAF,RWA,2010.0,1,1,0
MAC,TWN,2012.0,1,4,-3
BOL,GBR,2000.0,3,2,1
CZE,MEX,2017.0,1,2,-1
JPN,MNG,2014.0,13,4,9
BGR,FRA,2008.0,9,16,-7
THA,NOR,2015.0,3,2,1
CHE,ZAF,2006.0,5,9,-4
DNK,SRB,2000.0,6,2,4
PRT,AUS,2006.0,8,1,7
ARG,POL,1999.0,1,1,0
NOR,ESP,2012.0,12,13,-1
NPL,GBR,2009.0,3,3,0
CHL,URY,2020.0,4,2,2
RUS,AZE,2001.0,5,11,-6
NOR,ISL,2018.0,7,5,2
OMN,GBR,2021.0,8,27,-19
SWE,SRB,2012.0,2,3,-1
VNM,SWE,2004.0,3,4,-1
SWE,VNM,2009.0,2,1,1
PRT,COL,2014.0,2,2,0
SWE,TWN,2017.0,5,2,3
RUS,UZB,2015.0,4,11,-7
TTO,GBR,2002.0,6,5,1
SVN,SWE,2014.0,3,3,0
ROU,CHE,2002.0,6,4,2
UKR,FRA,2006.0,8,11,-3
SGP,KOR,2007.0,13,6,7
SAU,CAN,2009.0,13,63,-50
CHE,GRD,2015.0,1,1,0
CAN,TTO,2003.0,1,1,0
GRC,ROU,2014.0,4,1,3
ROU,GRC,2020.0,1,2,-1
AUT,ITA,2001.0,31,17,14
HUN,AUS,2004.0,6,1,5
QAT,USA,2009.0,4,15,-11
NLD,CUB,2022.0,1,3,-2
ARE,IND,2013.0,17,28,-11
KEN,EGY,2009.0,2,1,1
TUN,BEL,2009.0,1,1,0
SAU,MRT,2021.0,3,1,2
HRV,SVN,2009.0,6,6,0
FIN,AUT,2007.0,1,3,-2
USA,MAR,2016.0,4,16,-12
DEU,MLT,2018.0,4,2,2
ESP,DOM,2011.0,3,1,2
MYS,HKG,2004.0,2,1,1
CZE,ITA,2005.0,6,5,1
HTI,USA,2012.0,16,6,10
BEL,GRC,1998.0,6,4,2
AUT,SRB,1999.0,2,3,-1
ITA,CHL,2009.0,10,4,6
CYP,GBR,2009.0,7,25,-18
GRC,CHE,2008.0,10,4,6
SWE,KOR,2008.0,3,2,1
HKG,SAU,2012.0,5,1,4
NOR,RUS,2007.0,5,25,-20
PAK,MYS,2010.0,15,6,9
SWE,JPN,2019.0,26,31,-5
KEN,DEU,1997.0,5,1,4
JPN,KEN,2008.0,5,11,-6
NLD,ARG,2008.0,7,2,5
FRA,MYS,2007.0,8,3,5
GBR,TZA,2019.0,7,16,-9
KGZ,RUS,2013.0,4,3,1
THA,NLD,2007.0,7,7,0
FRA,BEN,2003.0,9,5,4
BRA,NGA,2004.0,1,1,0
POL,EGY,2000.0,2,4,-2
CZE,NOR,2021.0,10,9,1
KEN,JPN,2006.0,4,7,-3
NLD,IRL,2008.0,12,9,3
PAK,JPN,2000.0,2,5,-3
CHN,ZWE,2017.0,1,1,0
SGP,ITA,2013.0,6,14,-8
CZE,CAN,2011.0,14,8,6
GMB,GBR,2003.0,9,15,-6
SLV,SVN,2016.0,9,4,5
LTU,JPN,2003.0,3,3,0
THA,SWE,2014.0,5,5,0
CYP,DEU,2014.0,1,2,-1
GBR,SVK,2004.0,11,8,3
CHE,THA,2009.0,3,6,-3
DEU,QAT,2011.0,4,1,3
BRA,BEL,2008.0,8,17,-9
KOR,NLD,2003.0,5,3,2
LKA,CAN,2010.0,4,4,0
EGY,GBR,2006.0,9,26,-17
REU,FRA,2013.0,31,28,3
CAN,ESP,2007.0,28,35,-7
GBR,HRV,2005.0,2,3,-1
CHL,CUB,2014.0,3,7,-4
PAK,ESP,2013.0,1,3,-2
MLI,USA,2016.0,5,12,-7
PER,AUS,2012.0,2,1,1
PAK,SWE,2015.0,7,18,-11
TWN,SAU,2016.0,8,3,5
FRA,HKG,2016.0,7,12,-5
FRA,VNM,2011.0,27,13,14
KHM,GBR,2013.0,2,4,-2
CHE,MYS,2016.0,3,1,2
USA,BMU,2009.0,2,6,-4
AUS,ECU,2010.0,1,1,0
CAN,ZAF,2021.0,17,43,-26
SWE,NPL,2021.0,4,3,1
FRA,IDN,2008.0,9,1,8
LVA,LTU,2011.0,2,2,0
BGD,DEU,2011.0,9,5,4
SWE,BGD,2009.0,2,3,-1
LKA,GBR,2016.0,5,22,-17
TWN,ROU,2000.0,2,1,1
ROU,TWN,2002.0,7,1,6
VNM,GBR,2009.0,16,8,8
TWN,SGP,1998.0,5,1,4
NZL,IRN,2014.0,3,10,-7
SGP,FRA,2001.0,4,4,0
EGY,DNK,2010.0,1,1,0
DNK,EGY,2011.0,2,1,1
AUT,DNK,2012.0,7,11,-4
OMN,MYS,2019.0,5,19,-14
NLD,IND,2012.0,22,33,-11
BRA,DNK,2014.0,13,8,5
CHE,CYP,2011.0,3,2,1
BRA,ITA,2012.0,25,59,-34
BRA,NZL,2012.0,1,5,-4
SAU,ESP,2022.0,7,11,-4
JPN,BLR,2010.0,1,1,0
IND,HRV,2015.0,2,1,1
ESP,IRN,2012.0,7,15,-8
USA,BHR,2020.0,3,3,0
CHN,LBR,2021.0,1,1,0
PRI,ESP,2017.0,4,5,-1
BEL,TZA,2014.0,6,1,5
ZAF,ITA,2021.0,7,10,-3
OMN,SAU,2022.0,4,5,-1
ITA,DNK,2012.0,31,21,10
TWN,IDN,2013.0,10,3,7
CHL,GBR,2005.0,9,16,-7
PSE,SAU,2021.0,1,5,-4
ITA,SMR,2017.0,5,2,3
JPN,KEN,2014.0,8,3,5
TUN,EGY,2014.0,1,1,0
IRL,DNK,2007.0,5,6,-1
MEX,MYS,2022.0,2,1,1
LUX,AUT,2012.0,1,4,-3
TWN,JOR,2015.0,2,2,0
SAU,IDN,2015.0,2,3,-1
NPL,GBR,2021.0,9,8,1
CIV,USA,2009.0,2,2,0
GRC,DNK,2015.0,9,4,5
IRN,AUT,2014.0,14,7,7
ISR,ESP,2009.0,9,7,2
USA,DOM,2014.0,3,6,-3
MEX,BEL,2013.0,5,5,0
RUS,CHN,2009.0,10,4,6
NLD,IRL,2014.0,12,9,3
HKG,DEU,2012.0,15,8,7
OMN,BHR,2018.0,1,1,0
ARE,JPN,2010.0,1,5,-4
FRA,NER,2010.0,4,3,1
KOR,HKG,2011.0,6,7,-1
NOR,GRC,2018.0,3,23,-20
CZE,BEL,2020.0,6,14,-8
COL,FRA,2012.0,13,15,-2
RUS,CHN,2011.0,8,6,2
KOR,HUN,2020.0,2,1,1
THA,PAK,2011.0,3,2,1
IND,TUR,2015.0,8,3,5
ESP,CUB,2015.0,16,28,-12
PAN,FRA,2013.0,2,1,1
NLD,OMN,2019.0,4,1,3
ECU,USA,2011.0,11,9,2
USA,DOM,2015.0,5,2,3
SRB,DEU,2023.0,12,7,5
IND,NGA,2014.0,13,5,8
MYS,CHN,2009.0,5,5,0
JAM,USA,2012.0,7,10,-3
MDG,FRA,2013.0,11,14,-3
GBR,MLT,2019.0,24,13,11
AUS,ISL,2012.0,5,1,4
NGA,IND,2012.0,9,9,0
CIV,USA,2011.0,3,3,0
GBR,MDV,2012.0,1,1,0
BEL,CHN,2006.0,12,14,-2
USA,MAR,2017.0,13,9,4
KOR,SWE,2012.0,7,10,-3
BEL,ARG,2011.0,1,3,-2
EGY,SWE,2015.0,7,5,2
BGD,CHN,2013.0,6,3,3
QAT,IRL,2017.0,1,1,0
KAZ,DEU,2019.0,4,3,1
NZL,AUT,2023.0,2,5,-3
CAN,LUX,2020.0,4,2,2
USA,MLT,2017.0,2,3,-1
PAK,TUR,2015.0,16,4,12
PRT,IRL,2021.0,6,5,1
CHE,TWN,2010.0,7,6,1
AUT,PAK,2010.0,7,11,-4
SGP,CAN,2007.0,17,21,-4
TWN,CHN,2005.0,56,49,7
IRL,JAM,1998.0,1,1,0
SGP,IND,2009.0,22,56,-34
CZE,POL,2016.0,11,26,-15
FRA,IDN,2015.0,11,4,7
ESP,CYP,2022.0,2,3,-1
SRB,HRV,2023.0,5,4,1
GBR,MAC,2011.0,3,1,2
IRQ,EGY,2015.0,2,3,-1
CHN,BEL,1998.0,11,10,1
PRT,MAC,2016.0,5,1,4
MAC,PRT,2018.0,2,4,-2
DNK,MYS,2013.0,3,5,-2
IRN,SGP,2015.0,14,6,8
TWN,AUS,2001.0,8,7,1
SYR,IND,2013.0,1,1,0
MYS,TUR,2016.0,6,1,5
SGP,KHM,2020.0,2,1,1
JPN,ZMB,2018.0,3,2,1
KWT,EGY,2018.0,9,3,6
SRB,HUN,2017.0,7,3,4
BEN,FRA,2018.0,14,19,-5
LUX,ISR,2020.0,1,1,0
TUR,AZE,2015.0,9,7,2
NZL,OMN,2010.0,2,1,1
TUN,ARE,2020.0,5,1,4
BRA,DNK,2015.0,14,15,-1
NOR,CHN,2008.0,9,10,-1
EST,RUS,2018.0,6,6,0
DZA,GBR,2021.0,4,6,-2
SVN,GBR,2023.0,9,6,3
AUT,IND,2018.0,6,21,-15
ARG,PER,2011.0,1,1,0
ZAF,CHE,2019.0,14,10,4
CRI,NLD,2013.0,1,1,0
USA,MAR,2018.0,11,8,3
SLE,CHE,2016.0,1,1,0
IND,RUS,2016.0,12,5,7
IRL,JPN,2020.0,7,13,-6
SAU,NOR,2015.0,3,1,2
USA,MDA,2013.0,3,1,2
NLD,PAK,2019.0,9,9,0
ZMB,GBR,2016.0,4,3,1
CUB,VEN,2019.0,1,1,0
PHL,KHM,2010.0,3,1,2
HRV,CZE,2019.0,6,4,2
GBR,BGD,2017.0,14,27,-13
ITA,EST,2023.0,1,2,-1
DEU,CIV,2016.0,1,1,0
ZAF,FIN,2022.0,8,1,7
CHN,BRA,2010.0,4,4,0
HRV,RUS,2020.0,3,1,2
SVN,DEU,2019.0,12,14,-2
TWN,GRC,2018.0,1,1,0
CHN,BDI,2023.0,4,1,3
IRL,NLD,2014.0,9,12,-3
MEX,IND,2022.0,13,7,6
DZA,CHN,2019.0,2,10,-8
IRL,CZE,2011.0,4,4,0
EST,BEL,2019.0,4,1,3
GBR,ZWE,2021.0,9,8,1
AFG,DEU,2018.0,5,5,0
TUR,RUS,2014.0,6,3,3
TWN,CZE,2020.0,5,1,4
JOR,MYS,2012.0,9,12,-3
OMN,SAU,2018.0,2,12,-10
HKG,ARE,2020.0,1,2,-1
MOZ,PRT,2016.0,2,6,-4
NLD,PER,2023.0,1,1,0
CAN,CIV,2017.0,3,2,1
NGA,KOR,2018.0,2,3,-1
SWE,HUN,2015.0,10,9,1
CHL,AUS,2020.0,21,13,8
AUT,EST,2023.0,1,2,-1
IND,KWT,2023.0,3,1,2
TUR,CAN,2017.0,34,23,11
DEU,GAB,2008.0,3,1,2
TUR,AUT,2005.0,3,2,1
PRT,BGD,2022.0,2,1,1
GAB,DEU,2018.0,2,9,-7
NLD,SDN,2019.0,1,2,-1
MYS,NZL,2013.0,14,21,-7
IRN,CHE,2009.0,7,2,5
OMN,SAU,2016.0,8,5,3
BEL,IRN,2020.0,6,39,-33
JOR,QAT,2019.0,10,5,5
ROU,UKR,2019.0,1,1,0
FJI,,2010.0,13,0,13
BOL,,2005.0,16,0,16
IRQ,,2016.0,98,0,98
BGD,FRA,2022.0,3,0,3
MEX,PAK,2004.0,1,0,1
,FJI,2001.0,12,0,12
,LBY,1996.0,29,0,29
,BOL,2005.0,66,0,66
,GUF,2010.0,20,0,20
FRA,MLT,2018.0,2,0,2
OMN,BHR,2017.0,3,0,3
LUX,BRA,2006.0,4,0,4
SWE,ZMB,2017.0,2,0,2
LAO,,2015.0,26,0,26
BGD,EGY,1999.0,1,0,1
USA,MTQ,2009.0,1,0,1
BRA,SLV,2015.0,3,0,3
DEU,YEM,2011.0,2,0,2
,BHS,2003.0,4,0,4
URY,BOL,2018.0,1,0,1
,SLE,2010.0,8,0,8
USA,GMB,2015.0,3,0,3
THA,KHM,2011.0,1,0,1
GBR,CIV,2016.0,2,0,2
ZAF,TWN,1999.0,1,0,1
QAT,LBY,2017.0,1,0,1
GHA,SGP,2016.0,2,0,2
SGP,GHA,2019.0,1,0,1
EGY,KOR,2005.0,2,0,2
IRN,FJI,2020.0,1,0,1
SAU,MRT,2019.0,2,0,2
DZA,ARG,2016.0,2,0,2
DNK,QAT,2018.0,2,0,2
,BRB,2014.0,19,0,19
LBR,ISL,2018.0,1,0,1
DEU,PYF,2020.0,1,0,1
,GTM,2009.0,32,0,32
BMU,,2019.0,7,0,7
ZAF,MMR,2019.0,1,0,1
BLZ,GBR,2011.0,2,0,2
BLZ,GBR,2021.0,1,0,1
CUB,VEN,2021.0,1,0,1
HKG,ZAF,2018.0,3,0,3
GBR,MCO,2020.0,1,0,1
,VGB,2011.0,1,0,1
,VIR,2007.0,1,0,1
MNG,CAN,2020.0,1,0,1
,GNB,1998.0,1,0,1
DEU,LIE,2015.0,3,0,3
,SWZ,2002.0,9,0,9
NGA,TGO,2021.0,3,0,3
PSE,QAT,2007.0,2,0,2
PAN,,2002.0,5,0,5
SDN,GRD,2020.0,1,0,1
CHN,PRI,2013.0,1,0,1
ITA,BGD,2000.0,1,0,1
NZL,URY,2007.0,1,0,1
THA,SWE,2001.0,4,0,4
AUS,UGA,2013.0,2,0,2
BRA,EGY,2002.0,3,0,3
SGP,MAC,2010.0,2,0,2
FRA,NAM,2010.0,1,0,1
CUB,AUS,2005.0,1,0,1
JPN,QAT,2011.0,1,0,1
GAB,JPN,2014.0,1,0,1
CHN,LAO,2010.0,1,0,1
NOR,MWI,2016.0,4,0,4
ARG,NZL,2009.0,1,0,1
IND,BWA,1999.0,2,0,2
TUR,SWE,2008.0,10,0,10
SWE,KWT,2022.0,1,0,1
ESP,PAK,2011.0,1,0,1
BOL,,2012.0,21,0,21
,TJK,2004.0,11,0,11
,MCO,2005.0,8,0,8
AFG,TTO,2021.0,1,0,1
EST,IRL,2009.0,1,0,1
BEL,NER,2011.0,2,0,2
,GRD,2004.0,9,0,9
,MUS,2009.0,26,0,26
SVN,SWE,2008.0,2,0,2
LVA,CAN,2019.0,1,0,1
MOZ,IND,2015.0,1,0,1
MDV,SWE,2008.0,1,0,1
ARE,NZL,1999.0,1,0,1
,BLZ,2004.0,6,0,6
MOZ,IND,2008.0,1,0,1
,LAO,2004.0,33,0,33
PRT,NZL,2023.0,1,0,1
ZAF,SRB,2000.0,2,0,2
IND,BEN,2014.0,2,0,2
RUS,THA,2022.0,2,0,2
EST,CZE,2015.0,3,0,3
,ECU,1999.0,36,0,36
,SLV,1996.0,1,0,1
JPN,DZA,2012.0,3,0,3
TUR,PRT,2012.0,3,0,3
ERI,,2007.0,2,0,2
NZL,HRV,2007.0,2,0,2
BEL,MLI,2005.0,1,0,1
NIC,CRI,2008.0,1,0,1
ARM,CHE,2012.0,2,0,2
SDN,CHE,2016.0,2,0,2
BIH,,2010.0,45,0,45
CRI,CAN,2006.0,3,0,3
GUM,JPN,2023.0,1,0,1
FRA,CYP,2013.0,2,0,2
SWE,FJI,2020.0,1,0,1
FJI,SWE,2022.0,2,0,2
KGZ,,2010.0,12,0,12
SRB,IRL,2019.0,1,0,1
IND,BRN,2011.0,3,0,3
THA,ETH,2004.0,2,0,2
BWA,KAZ,2019.0,1,0,1
CUB,QAT,2023.0,1,0,1
BGD,FIN,2017.0,4,0,4
CMR,TCD,2019.0,2,0,2
EGY,GBR,2024.0,1,0,1
ITA,LIE,2021.0,4,0,4
ALB,KWT,2018.0,2,0,2
ZWE,BDI,2018.0,2,0,2
QAT,SRB,2012.0,1,0,1
BEL,ALB,2018.0,1,0,1
,GUM,2014.0,3,0,3
VEN,CAN,2018.0,5,0,5
BTN,,2018.0,7,0,7
PSE,FIN,2020.0,1,0,1
ESP,NGA,2017.0,1,0,1
MCO,GBR,2019.0,1,0,1
IND,ECU,2022.0,1,0,1
CAN,PSE,2018.0,6,0,6
CAN,MDG,2015.0,2,0,2
ARM,BEL,2022.0,1,0,1
,TCD,2014.0,18,0,18
PHL,PRT,2006.0,1,0,1
SGP,KWT,2004.0,1,0,1
KWT,SGP,2007.0,1,0,1
ARG,HRV,1999.0,1,0,1
THA,RUS,2005.0,1,0,1
AUT,KWT,1997.0,1,0,1
FJI,RUS,2009.0,1,0,1
VAT,,2024.0,1,0,1
AUS,BGR,2008.0,2,0,2
TTO,,2002.0,12,0,12
SRB,NOR,2012.0,1,0,1
ITA,FSM,2013.0,1,0,1
GMB,,2000.0,10,0,10
AUS,BRB,1998.0,1,0,1
FRA,ZWE,2008.0,1,0,1
RUS,LKA,2011.0,1,0,1
IRL,SGP,2000.0,1,0,1
NGA,OMN,1997.0,2,0,2
TGO,,2012.0,10,0,10
USA,LIE,2006.0,2,0,2
LIE,,2010.0,13,0,13
CPV,BRA,2008.0,1,0,1
BRA,MWI,2004.0,1,0,1
URY,CAN,2004.0,1,0,1
ZMB,USA,2001.0,1,0,1
,BIH,1998.0,51,0,51
BIH,,2006.0,17,0,17
THA,LUX,2001.0,1,0,1
ETH,,1999.0,10,0,10
SEN,NLD,2023.0,1,0,1
FJI,PLW,2005.0,1,0,1
NAM,,2010.0,12,0,12
CHE,COG,2005.0,1,0,1
ISR,GEO,2010.0,1,0,1
GAB,GBR,2001.0,1,0,1
ZAF,POL,1998.0,3,0,3
VUT,FJI,2009.0,1,0,1
,TJK,1996.0,8,0,8
LVA,ESP,2000.0,1,0,1
NGA,NAM,2003.0,1,0,1
BLR,AUT,2003.0,1,0,1
PRY,GBR,1999.0,1,0,1
PRI,KOR,2013.0,1,0,1
IRN,FIN,2002.0,1,0,1
TUN,ETH,2012.0,1,0,1
VEN,KWT,2012.0,1,0,1
TKM,,2014.0,6,0,6
UKR,NLD,2007.0,7,0,7
PAK,SWE,2001.0,2,0,2
MAC,,2007.0,5,0,5
UKR,UZB,1999.0,2,0,2
UZB,UKR,2000.0,2,0,2
UKR,UZB,2020.0,4,0,4
AUT,PHL,1997.0,1,0,1
LBN,JOR,2002.0,1,0,1
PAN,VEN,2011.0,1,0,1
LVA,FRA,1998.0,2,0,2
LVA,TWN,2002.0,1,0,1
NPL,CAN,1998.0,1,0,1
COG,NOR,2001.0,2,0,2
COG,CAF,2017.0,2,0,2
,SYC,1995.0,4,0,4
VEN,BGD,1998.0,1,0,1
BGD,VEN,1999.0,1,0,1
KAZ,ARE,2014.0,2,0,2
BEL,SUR,2011.0,1,0,1
ECU,PER,2002.0,1,0,1
CAN,MAR,1997.0,4,0,4
PRI,DEU,1998.0,2,0,2
DEU,NAM,2005.0,1,0,1
PAK,NLD,2010.0,6,0,6
,REU,2006.0,15,0,15
,COD,1994.0,10,0,10
FIN,IRN,2005.0,1,0,1
AUS,FLK,2022.0,1,0,1
CIV,LTU,2017.0,1,0,1
BEL,NGA,2010.0,1,0,1
,GUF,2006.0,15,0,15
,MWI,2005.0,79,0,79
CHL,ZAF,2007.0,3,0,3
VEN,CRI,2019.0,2,0,2
ECU,CHL,2008.0,1,0,1
YEM,CUB,2008.0,1,0,1
GIN,USA,2008.0,1,0,1
,TCD,2001.0,10,0,10
TCD,,2020.0,17,0,17
IND,FJI,2012.0,1,0,1
IRN,KAZ,2016.0,1,0,1
ESP,PSE,2021.0,5,0,5
,BRN,2007.0,6,0,6
EGY,PSE,2011.0,1,0,1
KGZ,DEU,2012.0,2,0,2
EST,ARM,2021.0,1,0,1
,NCL,2006.0,17,0,17
BWA,NAM,1998.0,1,0,1
MEX,MKD,2022.0,1,0,1
KEN,COG,2008.0,2,0,2
CZE,CYP,2021.0,2,0,2
,ASM,2004.0,3,0,3
TUR,KOR,2008.0,2,0,2
,SLE,2006.0,6,0,6
ZWE,GBR,2009.0,5,0,5
IND,GUY,2020.0,2,0,2
IDN,SDN,2012.0,1,0,1
BOL,FRA,2007.0,4,0,4
YEM,CAN,2022.0,3,0,3
PER,COL,1999.0,1,0,1
BEL,GHA,2013.0,1,0,1
MWI,BRA,2021.0,1,0,1
TUR,ROU,2015.0,2,0,2
,SUR,2008.0,8,0,8
ESP,LBN,2017.0,2,0,2
BEL,ECU,2015.0,11,0,11
MKD,FRA,2003.0,1,0,1
NPL,HKG,2019.0,2,0,2
MYS,THA,2000.0,1,0,1
ISL,NAM,2011.0,1,0,1
IRN,PRI,2018.0,1,0,1
BEL,LVA,2022.0,2,0,2
NIC,,2016.0,16,0,16
ESP,TTO,2022.0,4,0,4
CUB,CAN,2013.0,6,0,6
HKG,DNK,2013.0,4,0,4
CHL,PHL,2014.0,1,0,1
,GUY,2012.0,10,0,10
GUY,SHN,2015.0,1,0,1
SHN,USA,2019.0,2,0,2
TZA,ZWE,2015.0,1,0,1
COG,CAF,2016.0,1,0,1
DNK,KWT,2020.0,1,0,1
CHL,BGD,2014.0,1,0,1
TWN,MAR,2015.0,17,0,17
NER,COG,2019.0,1,0,1
SWE,LUX,2011.0,7,0,7
MDG,FIN,2020.0,3,0,3
TWN,SWZ,2018.0,1,0,1
GLP,ITA,2016.0,1,0,1
MLT,AUS,2019.0,1,0,1
COG,NOR,2015.0,2,0,2
EGY,ISR,2017.0,1,0,1
ARG,NOR,2020.0,2,0,2
GIB,,2018.0,2,0,2
UGA,QAT,2014.0,1,0,1
,TKM,1995.0,6,0,6
TUN,CHN,2018.0,5,0,5
UKR,IRL,2003.0,1,0,1
HKG,PAK,1997.0,3,0,3
HUN,GRC,2020.0,4,0,4
ECU,IRL,2016.0,1,0,1
TWN,ESP,2023.0,1,0,1
MDA,UKR,2019.0,2,0,2
PAK,CYP,2022.0,1,0,1
ISR,KAZ,2018.0,2,0,2
EGY,DZA,2020.0,2,0,2
IND,MUS,2019.0,2,0,2
IND,MDV,2022.0,4,0,4
MAR,MLT,2023.0,1,0,1
POL,SGP,2008.0,3,0,3
AUS,LBY,2003.0,1,0,1
ETH,SEN,2022.0,1,0,1
SGP,OMN,2018.0,3,0,3
,ATG,2018.0,3,0,3
CAN,BHR,2011.0,2,0,2
RWA,GHA,2021.0,4,0,4
ARE,ARG,2019.0,5,0,5
YEM,DEU,2018.0,2,0,2
RUS,IRL,1997.0,2,0,2
CYP,YEM,2022.0,1,0,1
NIC,BLZ,2020.0,1,0,1
CAF,MYS,2022.0,1,0,1
UKR,TUR,2023.0,2,0,2
CHN,BOL,2018.0,1,0,1
,CAF,2020.0,6,0,6
GNQ,,2024.0,24,0,24
BHR,PAK,2005.0,1,0,1
GIN,SLE,2018.0,1,0,1
NZL,CZE,2023.0,2,0,2
ZAF,AGO,2019.0,1,0,1
ESP,BIH,2022.0,1,0,1
BHR,TUN,2018.0,2,0,2
MEX,NIC,2020.0,3,0,3
CAN,COG,2006.0,2,0,2
COG,RWA,2016.0,1,0,1
ETH,LKA,2016.0,1,0,1
BGD,TUR,2018.0,2,0,2
CAN,COG,2023.0,1,0,1
KAZ,UZB,2019.0,5,0,5
CAF,CZE,2017.0,1,0,1
SYR,SDN,2016.0,1,0,1
LTU,GEO,2010.0,1,0,1
,LSO,2004.0,5,0,5
LVA,AUT,2013.0,1,0,1
KEN,ZMB,2020.0,6,0,6
GBR,MMR,2021.0,3,0,3
JPN,PSE,2021.0,1,0,1
HUN,ZAF,2018.0,2,0,2
TZA,RUS,2019.0,1,0,1
IND,PER,2019.0,1,0,1
BFA,CAN,2023.0,2,0,2
FRA,MRT,2022.0,4,0,4
CHE,JOR,2023.0,3,0,3
EGY,SOM,2021.0,3,0,3
SEN,KOR,2020.0,1,0,1
VNM,MAC,2021.0,1,0,1
ZAF,COG,2023.0,2,0,2
MLI,GBR,2023.0,2,0,2
RUS,PER,2015.0,1,0,1
TTO,ZAF,2019.0,1,0,1
NLD,CUW,2021.0,8,0,8
NLD,CUW,2019.0,7,0,7
AND,,2008.0,5,0,5
IND,FIN,2003.0,3,0,3
ALB,DEU,2023.0,2,0,2
TZA,KHM,2020.0,1,0,1
TUR,IDN,2021.0,2,0,2
HKG,ITA,2013.0,1,0,1
MNE,SAU,2021.0,1,0,1
UZB,UKR,2010.0,3,0,3
MLT,NLD,2021.0,2,0,2
TUR,NZL,2023.0,1,0,1
CMR,TUR,2023.0,2,0,2
,CYM,2017.0,3,0,3
MOZ,ITA,2022.0,1,0,1
TCA,FRA,2022.0,1,0,1
VCT,BRB,2021.0,1,0,1
,AZE,2020.0,161,0,161
IDN,EGY,2021.0,2,0,2
MEX,LBN,2021.0,2,0,2
IRN,GEO,2021.0,3,0,3
SDN,EGY,2005.0,1,0,1
USA,SOM,2022.0,2,0,2
MRT,,2005.0,2,0,2
RUS,MDA,2000.0,2,0,2
SYC,NLD,2001.0,2,0,2
BLZ,AIA,2013.0,1,0,1
BFA,,2007.0,10,0,10
SVK,AUS,2004.0,1,0,1
SLB,,2001.0,2,0,2
TZA,BWA,2005.0,3,0,3
RUS,JOR,2005.0,2,0,2
,PSE,1995.0,10,0,10
SWZ,ZAF,2006.0,1,0,1
FRA,PNG,2000.0,2,0,2
KOR,PER,2001.0,1,0,1
,MWI,2002.0,40,0,40
MWI,ZMB,2014.0,2,0,2
,REU,2000.0,4,0,4
AUS,GHA,2008.0,2,0,2
DEU,TZA,2003.0,3,0,3
MAR,SYR,1998.0,2,0,2
SYR,MAR,1999.0,2,0,2
UZB,NZL,2020.0,1,0,1
SEN,COG,2004.0,1,0,1
PNG,,2010.0,15,0,15
IDN,ZAF,2004.0,1,0,1
BEN,KEN,2001.0,3,0,3
ARE,LBY,2008.0,1,0,1
NPL,OMN,2021.0,1,0,1
BDI,UGA,2019.0,2,0,2
RUS,MAC,2014.0,3,0,3
GBR,CYP,2000.0,5,0,5
AUS,GRC,2001.0,4,0,4
MOZ,BEL,2009.0,1,0,1
BIH,AUS,2006.0,1,0,1
PNG,CHE,2004.0,2,0,2
CHE,PNG,2006.0,4,0,4
NZL,KEN,2023.0,1,0,1
ECU,,2000.0,17,0,17
DEU,ZWE,1998.0,1,0,1
NOR,BWA,2012.0,2,0,2
ESP,NER,2018.0,2,0,2
LTU,ITA,2000.0,2,0,2
,ZMB,2000.0,22,0,22
ALB,,2012.0,14,0,14
TZA,BWA,2002.0,1,0,1
KAZ,,1999.0,14,0,14
GNB,,2004.0,2,0,2
UGA,NOR,2010.0,1,0,1
AUT,BGD,2003.0,1,0,1
MAR,HRV,2008.0,3,0,3
,ALB,1997.0,19,0,19
,CAF,1999.0,5,0,5
,MOZ,1996.0,14,0,14
LVA,,2006.0,31,0,31
NLD,QAT,2014.0,6,0,6
MEX,SLV,2006.0,2,0,2
TCD,,2007.0,2,0,2
,PRY,1998.0,7,0,7
CIV,RWA,2008.0,1,0,1
IND,PSE,2010.0,1,0,1
MOZ,SWE,2008.0,2,0,2
,GAB,2001.0,15,0,15
OMN,,2005.0,33,0,33
ALB,AUT,2011.0,1,0,1
CZE,FIN,2000.0,3,0,3
ALB,ITA,2001.0,2,0,2
,CAF,1998.0,8,0,8
BGD,BGR,2009.0,1,0,1
AFG,CZE,2010.0,1,0,1
ZAF,CIV,2004.0,6,0,6
COL,BOL,2022.0,1,0,1
HRV,TUR,2013.0,2,0,2
NLD,MLT,2010.0,1,0,1
POL,SAU,2011.0,2,0,2
KEN,COG,2004.0,1,0,1
USA,BLZ,1997.0,1,0,1
BLZ,,1999.0,1,0,1
EST,PRT,2011.0,1,0,1
PRT,EST,2021.0,2,0,2
QAT,PRT,2018.0,1,0,1
IRN,CZE,2009.0,3,0,3
PRT,ISL,2010.0,1,0,1
GMB,ZAF,2012.0,2,0,2
USA,VGB,2008.0,1,0,1
ZMB,NAM,2022.0,1,0,1
SEN,CHE,2005.0,1,0,1
CUB,NLD,2023.0,1,0,1
CAN,PRY,2003.0,1,0,1
UZB,PAK,2021.0,2,0,2
AFG,GBR,2019.0,2,0,2
SEN,SGP,2008.0,1,0,1
,BLZ,1996.0,4,0,4
TUR,ALB,2010.0,3,0,3
CAN,PRI,2001.0,1,0,1
JPN,TZA,2011.0,2,0,2
GEO,ESP,2005.0,1,0,1
TCD,CHE,2015.0,2,0,2
MDG,,2009.0,22,0,22
TTO,,2012.0,38,0,38
NOR,ZMB,2014.0,1,0,1
EGY,BGD,2014.0,2,0,2
ISR,SRB,2004.0,2,0,2
CHE,BGR,2012.0,4,0,4
AFG,CHE,2012.0,1,0,1
,FRO,2003.0,4,0,4
GRC,COL,2018.0,1,0,1
RUS,YEM,2010.0,2,0,2
ITA,ARE,2012.0,4,0,4
,GNB,2007.0,4,0,4
POL,DZA,2012.0,2,0,2
,GUY,1997.0,8,0,8
ITA,LKA,2013.0,1,0,1
,ALB,2005.0,33,0,33
IRN,HKG,2016.0,4,0,4
,CAF,2007.0,6,0,6
TZA,IDN,2013.0,2,0,2
GHA,IDN,2019.0,1,0,1
,MDG,2005.0,68,0,68
SDN,ARE,2013.0,3,0,3
VEN,ABW,2015.0,1,0,1
NER,CHN,2023.0,1,0,1
NGA,GRC,2011.0,2,0,2
ZAF,BDI,2016.0,1,0,1
ISR,ROU,2017.0,3,0,3
TWN,DNK,2007.0,2,0,2
RUS,LVA,2008.0,2,0,2
JPN,GHA,2014.0,8,0,8
KEN,SWZ,2017.0,1,0,1
LVA,BLR,2013.0,1,0,1
ZWE,AUS,2002.0,3,0,3
PAN,IND,2017.0,1,0,1
TZA,COG,2016.0,1,0,1
MAR,TWN,2013.0,4,0,4
RUS,NGA,2014.0,2,0,2
LSO,CHE,2016.0,2,0,2
MEX,BOL,2016.0,2,0,2
HUN,CHL,2002.0,1,0,1
BGR,IRN,2013.0,1,0,1
SVN,ARG,2019.0,1,0,1
AFG,FRA,2021.0,5,0,5
TWN,MAC,2014.0,1,0,1
CHN,BRA,2000.0,7,0,7
BRA,MAR,2021.0,2,0,2
NGA,HUN,2020.0,2,0,2
USA,ECU,2024.0,1,0,1
PAK,CHE,2016.0,4,0,4
MKD,NZL,2017.0,1,0,1
LTU,IRL,2018.0,2,0,2
CMR,AUS,2020.0,3,0,3
FLK,ZAF,2017.0,1,0,1
USA,MEX,2016.0,268,286,-18
ESP,DEU,2004.0,89,90,-1
FRA,IRL,2010.0,32,38,-6
REU,FRA,2007.0,23,29,-6
SWE,FIN,2020.0,72,79,-7
ESP,PRT,2009.0,66,62,4
CZE,CHE,2010.0,12,13,-1
BGD,IND,2006.0,9,8,1
NLD,GBR,2000.0,198,158,40
CYP,TUR,2007.0,6,14,-8
FRA,SEN,2007.0,36,30,6
USA,HND,2003.0,4,1,3
GRC,USA,2013.0,136,109,27
GBR,CAN,2021.0,418,403,15
IND,DEU,2021.0,246,152,94
GBR,ESP,2023.0,243,165,78
NLD,JPN,2007.0,20,16,4
GBR,BEL,2007.0,65,85,-20
CAN,TWN,2001.0,14,16,-2
LBN,USA,2018.0,98,62,36
USA,DNK,2015.0,173,135,38
THA,JPN,2003.0,40,55,-15
IRN,AUS,2014.0,131,28,103
NGA,VNM,2022.0,1,1,0
BRA,AUS,2010.0,30,14,16
CHL,COL,2021.0,32,51,-19
FRA,GUF,2016.0,23,25,-2
SWE,RUS,2017.0,22,23,-1
GBR,ISR,2002.0,37,33,4
NOR,LTU,2000.0,3,3,0
ITA,BRA,1999.0,24,16,8
FRA,MAR,2000.0,81,55,26
GRC,BEL,2006.0,14,9,5
ISR,BEL,2016.0,4,3,1
SWE,CAN,2008.0,38,35,3
THA,CHN,2021.0,58,50,8
IND,CHE,2017.0,32,43,-11
THA,LKA,2020.0,5,2,3
SAU,LBN,2017.0,3,5,-2
DEU,ARM,2015.0,1,8,-7
SWE,IRL,2019.0,14,16,-2
BWA,ZAF,2004.0,7,6,1
ESP,MAR,2005.0,7,10,-3
BEL,SWE,2006.0,11,13,-2
JOR,USA,2015.0,31,66,-35
GBR,SGP,2001.0,50,33,17
POL,SVN,2010.0,1,2,-1
CAN,ESP,2013.0,45,71,-26
ITA,SWE,1998.0,31,27,4
HUN,SVK,2018.0,10,12,-2
PHL,KOR,2021.0,11,15,-4
POL,JPN,2021.0,13,11,2
AUS,CAN,2023.0,91,88,3
IRL,ESP,2002.0,6,9,-3
DNK,BEL,2014.0,10,16,-6
USA,BGD,2001.0,11,16,-5
GBR,NGA,2014.0,58,35,23
IRL,ITA,2022.0,26,33,-7
AUT,USA,2014.0,147,151,-4
MYS,THA,2016.0,14,5,9
ZAF,EGY,2015.0,3,4,-1
EGY,RUS,2012.0,1,1,0
RUS,SRB,1997.0,13,3,10
ITA,IRL,2004.0,11,3,8
NLD,JPN,1998.0,19,25,-6
ISR,ETH,2008.0,1,1,0
NOR,GBR,2005.0,34,52,-18
DNK,BEL,2001.0,7,8,-1
KEN,IDN,2011.0,1,1,0
FIN,BGD,2012.0,1,1,0
CHE,FIN,2013.0,17,18,-1
USA,LKA,2011.0,13,10,3
USA,PRT,2022.0,51,66,-15
IND,MYS,2005.0,28,15,13
ARG,ECU,2019.0,5,8,-3
KEN,ZAF,2011.0,13,9,4
TTO,USA,2010.0,10,16,-6
LTU,CHE,2016.0,5,3,2
CHN,PRK,2017.0,9,3,6
BEL,IRL,2021.0,9,16,-7
UKR,MDA,1999.0,3,1,2
BGD,GBR,2000.0,11,10,1
ESP,CZE,2002.0,5,3,2
AUS,NOR,1998.0,9,2,7
NOR,ETH,2016.0,8,5,3
VNM,USA,2011.0,11,32,-21
FJI,AUS,2010.0,7,5,2
GBR,TUN,2018.0,5,4,1
BEL,IRL,2011.0,9,6,3
JOR,KWT,2014.0,3,1,2
OMN,EGY,2017.0,4,11,-7
HRV,SWE,2018.0,8,1,7
SYR,GBR,2021.0,5,5,0
IRN,ITA,2009.0,13,6,7
DEU,PHL,2017.0,6,7,-1
CAN,ISL,2017.0,2,1,1
MKD,SRB,2020.0,14,6,8
AZE,TUR,1997.0,3,2,1
CAN,PAK,2003.0,4,4,0
EST,DEU,2014.0,4,9,-5
QAT,ARE,2019.0,7,6,1
IRN,SGP,2002.0,1,1,0
UZB,RUS,1999.0,7,4,3
ZAF,SAU,2002.0,2,2,0
ESP,BEL,2012.0,52,28,24
MYS,DEU,2009.0,4,6,-2
ZAF,MWI,2019.0,12,6,6
CHE,KHM,2014.0,2,1,1
POL,TWN,2013.0,3,1,2
LBN,LBY,2015.0,2,6,-4
RUS,GEO,2019.0,5,4,1
JPN,NZL,2013.0,15,11,4
JPN,LAO,2021.0,4,3,1
TWN,SAU,2023.0,3,3,0
UGA,RWA,2014.0,2,1,1
TWN,FRA,2017.0,9,18,-9
CZE,PRT,2015.0,3,6,-3
USA,ZWE,2011.0,3,10,-7
ARG,CHL,2014.0,24,21,3
TUR,KGZ,2016.0,4,5,-1
NLD,ZAF,2003.0,10,13,-3
DNK,ESP,1999.0,8,7,1
BEL,BGD,2014.0,4,3,1
LUX,DNK,2021.0,2,4,-2
BOL,FRA,2003.0,6,1,5
MNG,CHN,2009.0,1,2,-1
CHE,EGY,2015.0,2,2,0
CHE,ZMB,2006.0,1,1,0
ITA,ISR,2003.0,13,18,-5
HRV,NLD,2012.0,6,4,2
FRA,SYR,2005.0,5,2,3
AUT,LIE,2021.0,1,3,-2
BTN,NPL,2022.0,1,1,0
IND,BHR,2023.0,4,3,1
SAU,ITA,2023.0,5,9,-4
USA,NPL,2011.0,8,14,-6
NOR,HUN,2014.0,3,7,-4
JPN,IRL,2007.0,12,1,11
LBY,IND,2013.0,2,7,-5
USA,MLI,2021.0,5,2,3
URY,CHE,2010.0,2,2,0
BIH,SRB,2021.0,16,23,-7
TZA,NOR,2003.0,2,2,0
BRA,KOR,2021.0,4,3,1
NGA,ETH,2023.0,2,1,1
PHL,NPL,2003.0,1,1,0
KOR,RUS,2000.0,2,8,-6
BOL,BEL,2002.0,1,1,0
DNK,BEL,2004.0,6,4,2
AUT,KOR,2021.0,5,7,-2
RUS,IRL,2008.0,5,2,3
JOR,FRA,2010.0,2,6,-4
ITA,IND,2005.0,11,16,-5
MDG,FRA,1998.0,4,5,-1
LTU,ESP,2019.0,4,4,0
CAN,ECU,2022.0,4,4,0
TUR,MYS,2011.0,2,1,1
MEX,ISR,2002.0,2,5,-3
EGY,DNK,2017.0,2,2,0
ZAF,ISR,2015.0,1,3,-2
CZE,TUR,2022.0,3,8,-5
BEL,NGA,2022.0,2,6,-4
GBR,COL,2000.0,3,8,-5
DEU,LVA,2018.0,3,5,-2
ETH,SYR,2009.0,3,1,2
POL,ZAF,2005.0,1,2,-1
ESP,GTM,2009.0,3,1,2
IND,SYR,2022.0,2,1,1
HRV,CHE,2008.0,6,2,4
BRA,UKR,2000.0,3,3,0
FRA,GAB,2012.0,9,6,3
NLD,GHA,2008.0,1,2,-1
DNK,CHL,2013.0,2,3,-1
BEL,BGR,2007.0,3,1,2
FRA,MWI,2016.0,1,1,0
FRA,IRQ,2015.0,1,2,-1
ITA,SVN,1999.0,1,6,-5
FRA,SVK,2001.0,3,6,-3
IRL,CHE,2007.0,5,12,-7
AUT,AZE,2020.0,1,1,0
IRN,TUR,2001.0,1,1,0
NER,USA,2001.0,2,2,0
PER,ARG,2018.0,1,2,-1
CYP,IRN,2019.0,1,1,0
PRT,CUB,2014.0,1,3,-2
CUB,CAN,1999.0,3,1,2
LAO,COD,2013.0,2,2,0
IRL,CHE,1999.0,1,3,-2
PHL,KHM,2018.0,2,1,1
KAZ,SWE,2023.0,1,1,0
KHM,CHN,2011.0,1,1,0
COL,SWE,2017.0,1,5,-4
ROU,CZE,2020.0,1,2,-1
TZA,DEU,2008.0,3,1,2
JOR,KOR,2019.0,1,1,0
COL,FIN,2022.0,1,1,0
VNM,CHE,2003.0,2,1,1
CHN,EGY,2007.0,2,3,-1
GRC,BRA,2019.0,1,2,-1
OMN,TUN,2012.0,1,1,0
HKG,FIN,2009.0,1,2,-1
IND,CUB,2018.0,1,2,-1
CIV,BEL,2001.0,1,2,-1
USA,PYF,2014.0,1,3,-2
NZL,BRA,2006.0,1,3,-2
TUN,SAU,1999.0,1,1,0
NGA,SAU,2007.0,1,2,-1
PAK,BEL,2014.0,1,1,0
CCK,GBR,2021.0,1,1,0
NLD,SEN,2009.0,1,1,0
KOR,PHL,2020.0,13,14,-1
PAN,DEU,2020.0,4,2,2
ESP,NOR,2023.0,16,10,6
CAN,IND,2022.0,113,175,-62
PRT,ITA,2019.0,31,38,-7
CZE,CHN,2018.0,13,14,-1
NGA,TUR,2021.0,2,6,-4
BWA,CAN,2020.0,2,3,-1
CAN,RUS,2015.0,25,16,9
USA,PRI,2023.0,103,72,31
CHE,RUS,2020.0,17,33,-16
USA,TUR,2023.0,105,192,-87
USA,IRN,2022.0,110,463,-353
CHE,SWE,2022.0,71,55,16
IDN,IRQ,2021.0,1,1,0
TUR,EGY,2016.0,4,1,3
NLD,IRL,2021.0,27,25,2
MNE,SRB,2021.0,84,25,59
MYS,NGA,2023.0,42,44,-2
KAZ,JPN,2016.0,1,6,-5
SAU,USA,2001.0,41,52,-11
DEU,SGP,2008.0,38,14,24
SAU,EGY,1998.0,21,26,-5
BGR,SWE,2000.0,5,2,3
FRA,POL,1999.0,36,37,-1
GBR,NLD,2001.0,181,205,-24
NZL,CHN,2019.0,48,36,12
FIN,RUS,2019.0,16,26,-10
TWN,GBR,2003.0,22,32,-10
FRA,POL,1998.0,36,30,6
BHR,EGY,2004.0,1,1,0
CHE,POL,2018.0,26,20,6
SWE,NGA,2005.0,2,1,1
HRV,SRB,2018.0,20,16,4
CAN,ITA,1997.0,22,19,3
CHN,AUS,2000.0,28,33,-5
GBR,BGD,2007.0,17,15,2
CAN,GRL,2000.0,1,1,0
MYS,CHN,2001.0,2,1,1
HKG,NLD,2020.0,12,4,8
PRT,ITA,2021.0,45,39,6
CHL,BRA,2022.0,25,31,-6
ITA,ISR,2022.0,20,15,5
SEN,TGO,2015.0,3,1,2
ITA,IND,2019.0,40,62,-22
CHN,IDN,2022.0,20,5,15
SRB,ALB,2017.0,3,9,-6
FIN,IRL,2019.0,4,9,-5
UKR,FIN,2016.0,4,2,2
AUS,SGP,2019.0,87,111,-24
IRN,SGP,2021.0,7,1,6
DEU,KOR,2022.0,49,54,-5
HUN,NLD,2019.0,6,12,-6
IND,ISR,2021.0,152,72,80
JPN,NZL,2022.0,5,6,-1
FRA,DNK,2022.0,39,38,1
GBR,IDN,2013.0,15,1,14
SWE,GBR,2004.0,101,80,21
PHL,JPN,2018.0,19,22,-3
ZAF,NLD,2014.0,25,20,5
COL,CHL,2015.0,20,24,-4
MKD,SRB,2006.0,43,18,25
FRA,GLP,2003.0,29,16,13
SGP,QAT,2023.0,2,2,0
ZAF,USA,2006.0,74,62,12
CHE,DNK,2010.0,23,22,1
BEL,HUN,2000.0,7,6,1
COL,CHL,2004.0,7,2,5
SWE,IRL,2005.0,3,3,0
POL,RUS,2017.0,17,15,2
FRA,BFA,2012.0,18,19,-1
DEU,SWE,1998.0,84,44,40
ISL,USA,2002.0,12,27,-15
CAN,SWE,2008.0,35,38,-3
CAN,RUS,2001.0,21,48,-27
ESP,NLD,2012.0,65,75,-10
AUS,IDN,2015.0,94,25,69
HKG,SGP,2017.0,37,34,3
DEU,TUR,2017.0,46,74,-28
SVK,POL,2016.0,8,10,-2
TWN,FIN,2016.0,4,2,2
ESP,TWN,2017.0,5,1,4
MEX,ARG,2014.0,23,17,6
ISR,FRA,2014.0,24,26,-2
ESP,ROU,2017.0,9,11,-2
IRN,NOR,2014.0,18,1,17
AUT,CHE,2018.0,61,72,-11
PAK,ITA,2014.0,14,9,5
FIN,BRA,2011.0,2,2,0
DNK,NOR,2014.0,40,26,14
ESP,NOR,2014.0,17,9,8
NLD,ETH,2017.0,8,10,-2
USA,KHM,2017.0,5,9,-4
GBR,KWT,2008.0,6,7,-1
AUS,IRN,2014.0,28,131,-103
PHL,VNM,2020.0,1,1,0
IND,IRN,2011.0,23,6,17
NZL,MYS,2013.0,21,14,7
NGA,CAN,2013.0,5,5,0
FRA,COG,2013.0,9,4,5
TZA,AUS,2012.0,2,3,-1
SAU,KWT,2011.0,8,3,5
CAN,GRD,2021.0,1,3,-2
USA,KHM,2016.0,5,8,-3
UGA,BEL,2017.0,4,4,0
GBR,MWI,1998.0,3,4,-1
BRA,CHE,2010.0,18,18,0
BRA,ARG,2014.0,39,32,7
BEL,DNK,2019.0,21,20,1
NOR,CAN,2017.0,7,23,-16
SAU,CHE,2022.0,4,6,-2
EGY,SDN,2011.0,2,5,-3
LAO,CHE,2011.0,1,1,0
BEN,NGA,2016.0,3,1,2
GRC,IRL,2017.0,13,2,11
NZL,AUT,2011.0,5,4,1
USA,BRB,2020.0,5,1,4
YEM,EGY,2011.0,4,2,2
SWE,GRC,2021.0,23,43,-20
ZAF,GHA,2004.0,3,1,2
CAN,NLD,1999.0,33,24,9
USA,PAN,2007.0,10,10,0
GBR,UGA,2008.0,16,10,6
IRL,NLD,2013.0,16,16,0
ESP,MAR,2013.0,12,5,7
MAR,ESP,2023.0,6,7,-1
MEX,CAN,2018.0,49,44,5
ROU,MDA,2016.0,4,2,2
BRN,MYS,2014.0,8,6,2
IRL,NZL,2016.0,12,4,8
GRC,SWE,2021.0,43,23,20
CHN,LKA,2011.0,3,2,1
IRL,ITA,2019.0,24,56,-32
TWN,SGP,2002.0,6,4,2
FRA,DNK,2012.0,26,38,-12
IRN,NZL,2011.0,2,2,0
CHE,ESP,2014.0,46,119,-73
BRA,KOR,2022.0,4,1,3
BGR,AUT,2017.0,1,1,0
USA,UKR,2011.0,17,37,-20
PRT,CHE,2014.0,26,15,11
SWE,GRC,2011.0,6,18,-12
THA,NZL,2017.0,8,9,-1
NLD,AUT,2013.0,22,26,-4
AUT,NLD,2021.0,44,37,7
CAN,TUN,2010.0,9,5,4
GBR,NOR,2010.0,65,43,22
SWE,CAN,1999.0,34,31,3
ESP,LTU,2016.0,1,1,0
DEU,CHL,2017.0,35,38,-3
CAN,QAT,2023.0,11,11,0
NOR,SWE,2020.0,73,82,-9
USA,HRV,2011.0,11,27,-16
USA,HRV,2019.0,15,22,-7
FRA,KWT,2017.0,1,2,-1
PYF,FRA,2014.0,8,22,-14
NLD,IDN,2014.0,31,8,23
IND,KOR,2011.0,154,90,64
IDN,AUS,2011.0,13,35,-22
SVK,DEU,2016.0,11,8,3
KEN,DEU,2020.0,15,24,-9
COL,ESP,2010.0,73,83,-10
HKG,NOR,2018.0,4,2,2
CHN,NZL,2017.0,33,28,5
ISL,USA,2016.0,10,12,-2
DEU,NZL,2017.0,38,38,0
DEU,PHL,2019.0,9,7,2
MEX,CUB,2011.0,12,16,-4
VEN,USA,2011.0,37,25,12
NLD,BRA,2013.0,14,23,-9
PHL,JPN,2012.0,17,27,-10
IND,JOR,2016.0,3,2,1
PAK,GBR,2020.0,77,114,-37
PAK,EGY,2016.0,1,2,-1
GBR,PAK,2023.0,40,62,-22
COL,ITA,2013.0,3,4,-1
BRA,SWE,2020.0,42,9,33
GBR,KOR,2012.0,56,29,27
KOR,MNG,2017.0,7,2,5
FIN,ESP,2016.0,21,20,1
RUS,BLR,2011.0,22,12,10
USA,LBN,2005.0,40,36,4
KEN,CHE,2016.0,4,3,1
LUX,FRA,2015.0,18,31,-13
ZMB,ZWE,2016.0,6,1,5
RUS,ARM,2013.0,5,5,0
IND,SVK,2021.0,7,1,6
CAN,SGP,2010.0,22,28,-6
GHA,CHN,2012.0,4,1,3
BEL,PSE,2018.0,1,1,0
GHA,DEU,2014.0,9,4,5
CHL,GBR,2020.0,56,53,3
CHE,AUT,2017.0,77,87,-10
NZL,NOR,2022.0,4,1,3
NLD,PRT,2019.0,22,31,-9
PRT,ITA,2013.0,22,29,-7
DEU,BRA,2014.0,85,108,-23
UKR,CHE,2016.0,7,3,4
BEL,NLD,2023.0,125,120,5
LKA,NZL,2014.0,2,5,-3
SAU,NGA,2014.0,3,2,1
ESP,DNK,2012.0,28,16,12
AUS,LKA,2020.0,31,34,-3
TZA,CHE,2018.0,10,4,6
THA,BTN,2018.0,1,3,-2
ESP,CAN,2011.0,56,46,10
MAR,FRA,2014.0,59,108,-49
AUT,CHL,2023.0,2,2,0
BRA,TUR,2015.0,1,5,-4
NLD,ETH,2016.0,15,3,12
NGA,JPN,2016.0,7,5,2
CAN,KAZ,2018.0,5,5,0
KAZ,CAN,2020.0,1,1,0
MOZ,ZAF,2022.0,7,1,6
DNK,SWE,2015.0,85,99,-14
PRT,GBR,2003.0,27,53,-26
BEL,AUT,2021.0,25,18,7
RUS,SWE,2020.0,21,19,2
ITA,LUX,2021.0,19,6,13
HUN,FRA,2019.0,13,14,-1
URY,USA,2018.0,14,11,3
USA,TWN,2015.0,321,304,17
IDN,JPN,2009.0,15,81,-66
ROU,DEU,2017.0,26,25,1
TUR,EGY,2012.0,2,3,-1
EGY,GBR,2011.0,22,77,-55
USA,TTO,2023.0,3,2,1
RUS,BEL,2021.0,16,4,12
NLD,SWE,2022.0,64,55,9
THA,CHN,2017.0,35,28,7
IND,SWE,2015.0,57,22,35
GRC,CYP,2018.0,40,33,7
BRA,URY,2022.0,6,8,-2
LBN,GBR,2010.0,6,6,0
AUS,SGP,2013.0,75,79,-4
THA,DNK,2014.0,1,5,-4
SGP,ESP,2016.0,10,13,-3
AUS,DNK,2011.0,22,23,-1
BEL,NOR,2020.0,12,9,3
USA,FIN,2017.0,71,94,-23
THA,GBR,2012.0,36,83,-47
JOR,QAT,2023.0,13,3,10
NLD,CAN,2006.0,46,29,17
JPN,BLR,2011.0,2,1,1
IRL,SAU,2012.0,2,3,-1
GMB,GBR,2014.0,4,12,-8
AUS,DEU,2012.0,160,174,-14
ISL,USA,2018.0,11,22,-11
BOL,DEU,2017.0,1,1,0
VNM,USA,2016.0,32,40,-8
DNK,GRC,2021.0,10,14,-4
FRA,TCD,2020.0,2,1,1
IRN,AUT,2013.0,11,5,6
ZAF,CMR,2015.0,12,5,7
SRB,BEL,2019.0,4,6,-2
CZE,BRA,2020.0,3,16,-13
IND,QAT,2017.0,12,6,6
IND,SAU,2008.0,22,5,17
SWE,NZL,2015.0,10,10,0
ITA,IRN,2014.0,17,41,-24
ITA,BGR,2013.0,14,3,11
GRC,HKG,2016.0,1,1,0
ZAF,NGA,2016.0,53,89,-36
NLD,PRT,2011.0,18,18,0
TZA,CHE,2016.0,7,7,0
CHE,TZA,2017.0,3,3,0
HKG,IRN,2020.0,6,9,-3
SVK,SWE,2017.0,3,4,-1
SWE,IRN,2019.0,21,75,-54
ESP,JOR,2015.0,6,2,4
HKG,SGP,2016.0,33,27,6
SAU,BGD,2022.0,11,10,1
NLD,ISL,2015.0,2,2,0
SVN,ITA,2013.0,8,10,-2
ITA,SVN,2015.0,8,4,4
IND,BGD,2011.0,15,14,1
ESP,AUS,2020.0,51,47,4
LKA,CAN,2011.0,3,4,-1
EGY,ZAF,2013.0,4,1,3
HUN,ISR,2011.0,1,1,0
DNK,KOR,2020.0,4,15,-11
UKR,SWE,2013.0,6,3,3
IND,IRL,2011.0,12,10,2
IRL,FIN,2016.0,7,5,2
MMR,JPN,2020.0,6,12,-6
NGA,IRL,2015.0,3,1,2
IRL,CHE,2014.0,11,11,0
GBR,ARE,2014.0,34,15,19
GBR,KWT,2015.0,16,13,3
FRA,AUT,2011.0,27,35,-8
PRT,NLD,2023.0,19,12,7
HUN,DNK,2009.0,7,1,6
ITA,SAU,2013.0,17,4,13
HUN,NOR,2018.0,5,2,3
CHE,AUS,2019.0,74,79,-5
DEU,CHL,2016.0,40,38,2
AUS,DNK,2009.0,18,23,-5
GBR,ROU,2011.0,15,14,1
ROU,GBR,2012.0,27,14,13
SGP,NLD,2011.0,9,17,-8
CAN,JPN,2021.0,65,90,-25
CHL,FRA,2014.0,32,46,-14
GBR,AFG,2017.0,6,6,0
KOR,MNG,2018.0,16,6,10
BRA,BEL,2013.0,20,20,0
EGY,BHR,2018.0,6,1,5
DNK,CAN,2023.0,17,18,-1
LBN,USA,2009.0,50,47,3
SRB,AUT,2018.0,7,1,6
GBR,HUN,1998.0,25,18,7
KOR,MNG,2016.0,11,2,9
UKR,GBR,2009.0,77,27,50
LUX,DEU,2017.0,31,38,-7
KOR,BEL,2021.0,14,12,2
CUB,BRA,2017.0,29,8,21
ETH,USA,2023.0,27,15,12
JPN,MEX,2020.0,6,12,-6
USA,AFG,2018.0,19,4,15
AUT,BEL,2020.0,20,21,-1
KOR,FRA,2015.0,26,24,2
UKR,CHE,2018.0,7,3,4
QAT,ARE,2016.0,8,10,-2
NOR,FIN,2023.0,9,19,-10
CAN,JPN,2019.0,88,85,3
GBR,SEN,2022.0,2,2,0
IRL,GRC,2014.0,4,7,-3
GRC,FIN,2022.0,2,3,-1
IRN,ITA,2017.0,53,18,35
NOR,BEL,2023.0,7,5,2
BRA,CRI,2012.0,4,6,-2
USA,COD,2022.0,12,6,6
CAN,AUT,2022.0,17,26,-9
PAN,ESP,2023.0,4,3,1
ZAF,ZWE,2020.0,44,46,-2
CHE,ESP,2015.0,60,121,-61
CHL,AUS,2012.0,11,9,2
CHN,FIN,2012.0,24,16,8
AUS,IRL,2006.0,16,31,-15
ESP,GRC,2018.0,16,17,-1
HUN,DNK,2019.0,9,5,4
JPN,IND,2013.0,90,92,-2
MYS,IRQ,2014.0,44,16,28
QAT,TUR,2018.0,3,7,-4
ITA,ROU,2018.0,26,13,13
ROU,ITA,2018.0,13,26,-13
JPN,AUT,2022.0,10,13,-3
VEN,ARG,2014.0,3,4,-1
CUB,DEU,2016.0,8,5,3
ISR,BEL,2021.0,7,4,3
BEL,TUN,2014.0,3,7,-4
FRA,MEX,2015.0,60,35,25
LIE,DEU,2019.0,5,2,3
ITA,PAK,2017.0,19,12,7
SVK,JPN,2015.0,1,2,-1
MAR,USA,2015.0,6,5,1
CHE,SGP,2014.0,26,23,3
MYS,PSE,2016.0,12,3,9
GBR,NPL,2018.0,9,9,0
ARE,JOR,2016.0,6,9,-3
HUN,GBR,2015.0,48,32,16
IND,QAT,2016.0,9,4,5
SAU,CHN,2015.0,11,27,-16
IDN,SGP,2022.0,4,8,-4
FIN,PRT,2023.0,6,6,0
EGY,QAT,2020.0,7,14,-7
NLD,POL,2016.0,20,19,1
COL,BEL,2017.0,7,5,2
LKA,AUS,2014.0,20,17,3
IRN,GBR,2012.0,33,51,-18
CAN,TWN,2020.0,13,21,-8
GHA,AUS,2017.0,14,9,5
FIN,BEL,2018.0,12,9,3
BEL,FIN,2020.0,9,7,2
TUR,FRA,2018.0,26,15,11
ESP,PRI,2021.0,3,3,0
GHA,AUS,2016.0,17,3,14
FIN,UKR,2007.0,1,1,0
SWE,IRL,2016.0,11,8,3
JPN,POL,1998.0,8,9,-1
PYF,FRA,2001.0,10,8,2
IND,ETH,2022.0,35,50,-15
POL,IRN,2012.0,1,3,-2
ZAF,CAN,2019.0,46,20,26
USA,NOR,2012.0,86,58,28
IND,SWE,2014.0,38,31,7
IND,BEL,2019.0,32,29,3
ESP,SGP,2016.0,13,10,3
TWN,VNM,2015.0,24,6,18
IND,NZL,1998.0,3,4,-1
MYS,IRQ,2015.0,54,25,29
TUN,ESP,2016.0,7,17,-10
FRA,BFA,2017.0,23,10,13
MYS,CAN,2021.0,24,8,16
TZA,BEN,2016.0,1,1,0
IND,KWT,2019.0,7,6,1
CHN,ESP,2013.0,27,19,8
ROU,PRT,2017.0,8,2,6
PRT,ROU,2018.0,3,2,1
BEL,TUR,2020.0,13,22,-9
IRN,NLD,2014.0,32,11,21
ESP,SWE,2023.0,47,51,-4
LBY,EGY,2021.0,3,8,-5
SRB,LBY,2015.0,5,1,4
EGY,AUS,2015.0,9,8,1
ITA,UKR,2014.0,5,2,3
MYS,NGA,2015.0,41,31,10
CYP,USA,2022.0,8,11,-3
USA,CYP,2023.0,5,5,0
IRL,FIN,2018.0,6,11,-5
CHN,UKR,2016.0,3,13,-10
SGP,DEU,2015.0,36,38,-2
FIN,GBR,2019.0,73,81,-8
MLT,CHE,2013.0,1,2,-1
CAN,NZL,2013.0,47,39,8
AUS,TUR,2016.0,9,8,1
SGP,HKG,2016.0,27,33,-6
BGD,CAN,2013.0,21,15,6
DNK,DEU,2016.0,93,142,-49
KEN,ZAF,2016.0,14,23,-9
PAK,CHN,2011.0,27,42,-15
DEU,GRC,2018.0,48,96,-48
ARE,JOR,2018.0,10,31,-21
USA,PAN,2020.0,30,27,3
JPN,AFG,2018.0,8,2,6
NOR,ESP,2020.0,26,31,-5
GBR,CYP,2011.0,35,6,29
CAN,CZE,2018.0,13,8,5
TUN,USA,2019.0,7,13,-6
TUN,FRA,2015.0,90,138,-48
JPN,ETH,2018.0,5,2,3
USA,TZA,2018.0,19,23,-4
AUS,PAK,2019.0,22,59,-37
NGA,DEU,2013.0,5,7,-2
COL,GBR,2021.0,16,19,-3
KWT,GBR,2016.0,8,22,-14
NLD,JPN,2015.0,11,18,-7
TWN,BRN,2021.0,1,1,0
MYS,YEM,2018.0,20,5,15
USA,UKR,2021.0,25,22,3
JOR,USA,2020.0,58,69,-11
GHA,CAN,2017.0,14,4,10
MEX,JPN,2019.0,4,5,-1
MYS,SDN,2017.0,12,3,9
MEX,DEU,2012.0,34,29,5
AUS,IRN,2015.0,36,149,-113
ZAF,FRA,2011.0,11,29,-18
MLT,ITA,2020.0,5,3,2
BEL,NOR,2007.0,5,3,2
BEL,ETH,2019.0,6,9,-3
CAN,CZE,2017.0,16,7,9
CHN,LAO,2021.0,8,1,7
NZL,FRA,2022.0,12,12,0
BEL,ITA,2020.0,97,127,-30
SWE,POL,2020.0,20,24,-4
SVN,DEU,2023.0,11,5,6
NLD,IRN,2023.0,11,32,-21
FIN,ESP,2017.0,11,20,-9
UKR,CAN,2022.0,7,1,6
ESP,FIN,2022.0,27,13,14
GRC,DEU,2000.0,21,32,-11
AUT,NOR,2015.0,11,5,6
ETH,IRN,2021.0,2,4,-2
MLT,GBR,2001.0,4,7,-3
GBR,MLT,2006.0,8,7,1
RUS,HKG,2021.0,4,1,3
URY,USA,2022.0,10,10,0
USA,URY,2023.0,7,7,0
NOR,USA,2016.0,87,107,-20
EGY,HUN,2002.0,2,4,-2
CHE,ARM,2020.0,1,1,0
PRT,FIN,2016.0,8,4,4
DEU,IRL,2003.0,18,7,11
ITA,DNK,1999.0,15,13,2
ARE,BHR,2010.0,2,1,1
SAU,USA,2000.0,34,46,-12
GEO,RUS,2019.0,4,5,-1
RUS,GEO,2022.0,9,1,8
LTU,FRA,2018.0,4,3,1
GTM,ESP,2019.0,2,3,-1
KAZ,USA,2019.0,29,21,8
FRA,BFA,2018.0,23,14,9
USA,GHA,2020.0,34,44,-10
USA,PHL,2019.0,54,43,11
RWA,FRA,2019.0,1,4,-3
GBR,UGA,2014.0,10,10,0
COL,GBR,2019.0,24,25,-1
AUS,MEX,2023.0,3,4,-1
SVK,DEU,2018.0,7,9,-2
RUS,BEL,2019.0,12,9,3
CHN,DZA,2023.0,5,3,2
BIH,SRB,2018.0,8,19,-11
SWE,CZE,2018.0,18,10,8
ETH,IRN,2019.0,3,2,1
SVK,GBR,2018.0,7,5,2
VNM,IND,2018.0,1,5,-4
IND,BGD,2019.0,25,16,9
LTU,DNK,2018.0,8,4,4
VNM,JPN,2015.0,25,52,-27
AUS,TWN,2020.0,16,28,-12
NGA,JPN,2017.0,8,11,-3
PHL,TWN,2021.0,9,16,-7
THA,ITA,2011.0,3,4,-1
UKR,ESP,2022.0,6,2,4
DEU,PAK,1998.0,4,4,0
FRA,NCL,2017.0,37,16,21
NCL,FRA,2019.0,39,31,8
PRT,NLD,2000.0,9,8,1
FRA,MEX,2004.0,45,29,16
UKR,GBR,2019.0,11,31,-20
RUS,NLD,2019.0,24,16,8
MYS,SGP,2021.0,15,22,-7
ISR,PRT,2018.0,4,1,3
AUS,ARE,2007.0,7,4,3
CAN,AUT,2018.0,25,22,3
IRN,NOR,2015.0,15,5,10
CHN,TUR,2018.0,11,13,-2
SWE,CZE,2022.0,17,10,7
ZAF,SWE,2020.0,15,15,0
NZL,JPN,2019.0,10,11,-1
GBR,POL,2020.0,82,75,7
TZA,DEU,2020.0,8,11,-3
SAU,GBR,2018.0,62,190,-128
LKA,JPN,2019.0,9,15,-6
SAU,DZA,2020.0,8,9,-1
MEX,CHN,2010.0,5,2,3
JPN,IRL,2015.0,1,6,-5
KOR,CHE,2022.0,21,15,6
RUS,NOR,2018.0,8,12,-4
CHE,JPN,2023.0,11,24,-13
CAN,GMB,2022.0,1,1,0
POL,CHE,2020.0,27,17,10
ITA,PRT,2019.0,38,31,7
ROU,NOR,2018.0,1,1,0
RUS,EGY,2014.0,4,2,2
NGA,TWN,2023.0,3,1,2
NGA,PAK,2019.0,7,3,4
HUN,ISR,2019.0,3,2,1
RUS,DNK,2018.0,9,5,4
BEL,COD,2019.0,15,2,13
POL,SVK,2018.0,8,10,-2
ITA,MLT,2018.0,7,4,3
POL,CAN,2018.0,14,21,-7
DNK,ITA,2023.0,22,27,-5
CUB,ESP,1998.0,17,22,-5
DEU,GHA,2013.0,10,4,6
IRL,CAN,2002.0,12,17,-5
TWN,THA,2021.0,27,10,17
OMN,USA,2018.0,6,8,-2
TZA,CHE,2022.0,8,7,1
CUB,ESP,2020.0,31,13,18
ESP,ROU,2016.0,8,8,0
CZE,AUT,2018.0,23,13,10
EGY,AZE,2020.0,1,1,0
NLD,SWE,2018.0,80,77,3
USA,ZWE,2017.0,19,6,13
GBR,LKA,2019.0,24,18,6
ISR,PSE,2020.0,37,14,23
TUN,ESP,2017.0,8,17,-9
ESP,TUN,2020.0,13,11,2
NLD,ARG,2013.0,9,6,3
CAN,ARE,1999.0,11,2,9
CZE,USA,2020.0,52,51,1
IND,ESP,2000.0,7,7,0
USA,NOR,1997.0,44,38,6
ZAF,NZL,1998.0,9,3,6
SWE,KOR,2003.0,9,5,4
LUX,BEL,2012.0,10,10,0
SRB,RUS,1998.0,15,3,12
COL,MEX,2005.0,6,8,-2
MDG,USA,2015.0,3,5,-2
CZE,RUS,2008.0,11,4,7
CAN,POL,1997.0,14,11,3
GRC,SWE,2009.0,9,3,6
TTO,GBR,1998.0,13,2,11
NOR,TUR,2013.0,2,3,-1
ESP,KOR,2004.0,6,2,4
JPN,VNM,2012.0,44,13,31
USA,KWT,2015.0,24,13,11
RUS,TWN,2001.0,6,5,1
POL,BEL,1999.0,9,12,-3
PRT,DEU,1997.0,11,3,8
BEL,TUR,1999.0,3,3,0
JAM,DEU,2019.0,1,2,-1
BEL,UKR,2007.0,2,2,0
DEU,HUN,2017.0,40,49,-9
BEL,ESP,2002.0,22,37,-15
SRB,MNE,2011.0,8,1,7
CAN,GRC,1997.0,11,10,1
FRA,COG,2003.0,5,3,2
ESP,JPN,2002.0,10,11,-1
AUS,KOR,2014.0,25,40,-15
JPN,PHL,2002.0,21,14,7
EST,FIN,2003.0,8,12,-4
CAN,TUR,1999.0,6,6,0
SAU,NGA,2004.0,6,3,3
AUS,MAC,2018.0,2,4,-2
ITA,RUS,2016.0,30,28,2
BRA,ITA,1999.0,16,24,-8
CUB,DEU,2022.0,7,2,5
CZE,USA,1999.0,52,35,17
MYS,JPN,1999.0,5,3,2
JPN,MYS,2000.0,10,10,0
PYF,FRA,2004.0,9,5,4
CRI,NLD,2001.0,1,3,-2
GBR,LTU,2021.0,8,16,-8
ITA,NZL,2002.0,4,3,1
CHE,FIN,2005.0,8,11,-3
PRT,BRA,1999.0,21,31,-10
THA,USA,1997.0,28,52,-24
FRA,GRC,2003.0,31,32,-1
FRA,SEN,2004.0,28,22,6
CZE,SVK,2008.0,24,52,-28
UZB,RUS,2015.0,11,4,7
FIN,ITA,2006.0,6,8,-2
TWN,MYS,2019.0,7,14,-7
CAN,CHL,2001.0,9,10,-1
FRA,ECU,2017.0,11,4,7
SWE,SGP,2011.0,9,7,2
SGP,DEU,2004.0,11,11,0
CAN,FIN,2018.0,22,25,-3
SAU,MAR,2001.0,1,1,0
CIV,FRA,2000.0,16,20,-4
FRA,SEN,2001.0,21,29,-8
CHE,HKG,2011.0,2,10,-8
RUS,CZE,2000.0,11,7,4
CZE,RUS,2001.0,13,11,2
EST,USA,2007.0,5,5,0
NOR,ITA,2007.0,9,14,-5
AUT,RUS,2012.0,6,17,-11
NOR,DNK,2015.0,41,50,-9
IND,OMN,2009.0,17,4,13
RUS,CZE,2006.0,15,18,-3
THA,MYS,2002.0,2,4,-2
UKR,FRA,2009.0,11,13,-2
POL,GBR,1999.0,32,23,9
USA,QAT,2007.0,12,2,10
AUS,FIN,2007.0,6,11,-5
ROU,OMN,2010.0,13,2,11
CAN,MAR,2020.0,14,5,9
TWN,USA,1997.0,119,238,-119
EGY,KWT,2004.0,13,2,11
CHE,ESP,2001.0,29,24,5
AUT,SRB,1997.0,1,2,-1
AUT,JPN,2000.0,6,8,-2
GBR,BGR,1999.0,7,16,-9
POL,SWE,2023.0,14,6,8
FRA,SVK,2007.0,8,3,5
CHE,MEX,1999.0,6,1,5
EGY,ITA,1998.0,5,11,-6
NLD,IND,1998.0,8,9,-1
NZL,NLD,2002.0,17,10,7
MEX,RUS,2000.0,6,16,-10
CAN,BRA,2013.0,52,104,-52
RUS,POL,2014.0,13,10,3
FRA,MCO,2007.0,15,1,14
AUT,TUN,2008.0,1,1,0
CHN,IND,2013.0,27,35,-8
DEU,ZAF,2010.0,22,22,0
VIR,USA,2011.0,2,1,1
GMB,GBR,2008.0,4,11,-7
TWN,ROU,2011.0,1,1,0
ESP,RUS,2000.0,11,20,-9
AUT,RUS,2005.0,7,13,-6
TUR,BEL,2016.0,6,12,-6
GRC,DEU,2006.0,31,31,0
USA,KEN,2005.0,21,27,-6
SWE,EST,2006.0,12,2,10
TZA,USA,2007.0,5,7,-2
KOR,ZAF,2019.0,10,9,1
BEL,NOR,1998.0,3,2,1
IRL,GRC,2001.0,3,2,1
JPN,DNK,1997.0,8,10,-2
CUB,GBR,2000.0,2,2,0
CUB,MEX,2006.0,7,15,-8
JPN,THA,2002.0,45,50,-5
POL,UKR,1998.0,11,21,-10
MOZ,USA,2006.0,2,1,1
NZL,ISR,2017.0,3,3,0
IND,SAU,2004.0,13,7,6
USA,MDG,1998.0,3,1,2
GBR,FLK,2001.0,4,1,3
RUS,AZE,2013.0,4,9,-5
CAN,IRN,2002.0,52,27,25
DEU,KEN,2010.0,9,5,4
CHL,BRA,2002.0,4,6,-2
FRA,FIN,2000.0,15,13,2
NLD,KEN,1999.0,3,1,2
NOR,JPN,1998.0,11,7,4
JPN,FIN,2018.0,11,10,1
ARE,FIN,2020.0,1,2,-1
ESP,DNK,2005.0,9,8,1
NLD,AUT,2003.0,26,15,11
GBR,PRI,2008.0,1,1,0
TWN,ITA,2013.0,4,3,1
BRA,CHL,2002.0,6,4,2
DEU,SVK,2003.0,13,28,-15
NGA,IND,2007.0,4,5,-1
ESP,JPN,2005.0,13,8,5
DEU,TWN,1999.0,10,7,3
FRA,ETH,2004.0,2,2,0
VEN,CHL,2010.0,9,5,4
JPN,SRB,2002.0,5,2,3
SRB,CAN,1999.0,4,4,0
SVN,CAN,2008.0,2,1,1
CZE,FIN,2021.0,9,6,3
USA,CYP,2010.0,24,4,20
PRT,CAN,2002.0,9,7,2
THA,DEU,2003.0,9,6,3
LKA,USA,2000.0,10,4,6
GRC,AUS,2003.0,3,4,-1
BEL,HUN,2004.0,4,6,-2
CHE,ARG,2002.0,1,3,-2
GRC,CYP,2017.0,55,15,40
NOR,MYS,2008.0,4,1,3
BRA,GBR,2000.0,41,81,-40
SVK,JPN,2001.0,8,6,2
PAK,USA,2004.0,33,34,-1
ARG,BRA,2001.0,35,24,11
SRB,FIN,2001.0,3,3,0
HUN,CAN,2002.0,11,6,5
UKR,POL,1999.0,15,13,2
AUS,VNM,2003.0,6,2,4
HUN,BEL,2002.0,8,10,-2
KWT,USA,2000.0,9,10,-1
PHL,GBR,1998.0,5,3,2
IND,NOR,2005.0,2,2,0
NLD,NZL,2004.0,13,7,6
CUB,USA,2008.0,6,14,-8
SWE,SVK,2002.0,3,4,-1
GBR,KOR,1997.0,17,9,8
CHN,KOR,2002.0,32,25,7
USA,PAN,1998.0,9,8,1
OMN,EGY,2009.0,6,3,3
SWE,SGP,2009.0,11,7,4
ESP,CZE,2003.0,7,7,0
JPN,NPL,1999.0,2,1,1
CHE,ISR,2018.0,21,34,-13
USA,ISL,2021.0,18,15,3
HUN,GBR,2004.0,28,27,1
NLD,IND,2020.0,38,59,-21
ZAF,CHE,2006.0,9,5,4
CAN,MEX,2002.0,19,17,2
DNK,AUS,2010.0,20,22,-2
ARE,IND,2015.0,14,37,-23
DEU,PRT,2001.0,17,11,6
CZE,BEL,1997.0,5,2,3
SRB,DNK,1997.0,1,4,-3
JPN,BEL,2016.0,16,15,1
SGP,NZL,2000.0,7,7,0
PRT,RUS,2006.0,9,11,-2
SRB,CHE,2005.0,2,12,-10
CAN,SWE,2000.0,29,39,-10
ROU,GRC,2005.0,4,1,3
NLD,PHL,2002.0,1,2,-1
IND,ISR,2013.0,37,18,19
FIN,HUN,2006.0,3,2,1
CZE,ESP,2007.0,5,5,0
SRB,SWE,2007.0,3,1,2
AUT,ROU,2019.0,3,4,-1
ARG,GBR,2003.0,26,9,17
FRA,AUS,2003.0,57,40,17
GBR,MWI,2007.0,6,9,-3
SWE,ISL,2002.0,19,4,15
NCL,FRA,2009.0,20,12,8
CHE,JPN,2006.0,31,27,4
FRA,DZA,1999.0,28,11,17
GBR,PHL,1998.0,3,5,-2
ZAF,POL,2005.0,2,1,1
NOR,SWE,2007.0,29,67,-38
PHL,ESP,2007.0,3,1,2
GMB,DNK,2002.0,2,1,1
NOR,ESP,1998.0,2,4,-2
SWE,AUT,2002.0,6,15,-9
JPN,VNM,2005.0,11,3,8
KEN,IDN,2022.0,2,1,1
JPN,ESP,2015.0,15,23,-8
USA,KWT,2008.0,13,10,3
DNK,BEL,1998.0,3,4,-1
DEU,SGP,2010.0,35,22,13
IND,HKG,2001.0,6,5,1
EGY,SAU,1999.0,19,24,-5
ITA,IRL,1998.0,3,3,0
SWE,BRA,2016.0,19,23,-4
SRB,CHE,2002.0,3,4,-1
JOR,USA,1999.0,8,19,-11
HKG,AUS,2008.0,44,22,22
VEN,ISR,2010.0,1,1,0
CHL,BRA,1997.0,10,6,4
SGP,ITA,2015.0,5,9,-4
HRV,DEU,2004.0,14,7,7
CAN,ZAF,2000.0,12,14,-2
ARE,GBR,2013.0,11,40,-29
EGY,JPN,2003.0,15,28,-13
THA,BEL,2020.0,4,4,0
JPN,THA,1997.0,17,6,11
RUS,HKG,2011.0,2,1,1
BGD,NPL,2004.0,1,1,0
DEU,TJK,2020.0,2,1,1
ITA,GRC,2000.0,11,6,5
MEX,CHE,2022.0,17,3,14
JPN,PAK,2014.0,11,8,3
NZL,FRA,2016.0,16,17,-1
USA,QAT,2020.0,43,60,-17
JPN,AUT,2018.0,16,9,7
NLD,NZL,2014.0,13,19,-6
POL,CAN,2022.0,15,16,-1
ERI,IND,2015.0,1,2,-1
DNK,HUN,2020.0,7,5,2
HKG,TWN,2015.0,10,8,2
MYS,JOR,2020.0,31,13,18
MWI,GBR,2020.0,19,21,-2
UKR,CZE,2018.0,14,4,10
SRB,DEU,2019.0,25,11,14
KAZ,CZE,2020.0,2,2,0
LKA,JPN,2021.0,5,16,-11
GBR,SRB,2021.0,10,12,-2
AUS,KWT,2020.0,4,3,1
AUT,VNM,2018.0,4,3,1
COL,SWE,2011.0,3,1,2
AUT,ARG,2019.0,5,3,2
CHN,POL,2022.0,23,16,7
BGD,ITA,2019.0,5,3,2
AUS,FJI,2018.0,9,10,-1
FRA,GEO,2021.0,7,2,5
BEL,BGD,2020.0,5,3,2
ISR,AUS,2022.0,12,13,-1
NLD,ZMB,2021.0,3,2,1
PAK,NLD,2019.0,9,9,0
NLD,FIN,2023.0,12,16,-4
IRN,SVK,2021.0,6,1,5
IRQ,HUN,2019.0,6,1,5
ZAF,RUS,2020.0,8,2,6
ROU,ITA,2017.0,20,18,2
GBR,ARG,2019.0,12,21,-9
USA,MMR,2019.0,6,5,1
SAU,KWT,2021.0,5,5,0
USA,JAM,2018.0,12,13,-1
ZAF,NAM,2019.0,26,8,18
KEN,ITA,2016.0,1,4,-3
CHE,SWZ,2017.0,5,18,-13
CAN,ARG,2015.0,18,18,0
IND,NPL,2015.0,43,27,16
EGY,CHN,2006.0,3,1,2
USA,SRB,2019.0,18,25,-7
FRA,COL,2018.0,39,22,17
NPL,NOR,2020.0,3,5,-2
VNM,JPN,2014.0,18,37,-19
ARG,DEU,2019.0,39,30,9
POL,DNK,2019.0,10,10,0
CAN,FIN,2022.0,20,12,8
IRN,VNM,2020.0,18,7,11
USA,BHS,2020.0,4,4,0
SWE,SGP,2019.0,11,13,-2
GBR,LAO,2020.0,3,3,0
ITA,VEN,2021.0,2,2,0
ESP,BGD,2016.0,4,1,3
AUS,JOR,2013.0,9,4,5
TWN,DEU,2023.0,14,7,7
CAN,KEN,2019.0,8,10,-2
CHN,ISR,2015.0,21,14,7
DNK,ISL,2018.0,9,2,7
JPN,SWE,2007.0,40,31,9
ESP,ISR,2019.0,11,14,-3
ETH,POL,2022.0,2,2,0
IND,ETH,2016.0,45,11,34
USA,KEN,1997.0,18,12,6
VNM,USA,2018.0,32,53,-21
SVN,FRA,2021.0,10,6,4
EST,DEU,2020.0,8,7,1
JPN,SWE,1999.0,30,31,-1
ECU,COL,2019.0,13,5,8
COL,ECU,2020.0,12,4,8
USA,SEN,2020.0,15,13,2
ESP,SGP,2018.0,8,5,3
GBR,JOR,2021.0,45,30,15
PAK,IND,2019.0,37,53,-16
RUS,MEX,2023.0,4,3,1
CHN,ITA,2011.0,30,27,3
AUS,PAK,2021.0,26,59,-33
BGR,ESP,2021.0,1,1,0
RUS,BLR,2019.0,15,22,-7
SGP,CHE,2001.0,5,6,-1
CHE,SGP,2008.0,12,6,6
KOR,LUX,2020.0,5,2,3
FRA,NOR,2015.0,34,22,12
MYS,ITA,2018.0,6,5,1
IRN,CHE,2023.0,27,8,19
ARG,CHL,2020.0,24,30,-6
SRB,MNE,2019.0,5,27,-22
VNM,USA,2017.0,28,36,-8
KAZ,TJK,2019.0,1,1,0
IRL,SGP,2019.0,10,9,1
ETH,NLD,2017.0,10,8,2
LBN,USA,2011.0,52,49,3
KOR,DNK,2019.0,12,6,6
ZWE,KEN,2021.0,2,2,0
ZAF,DEU,2023.0,21,11,10
CAN,IND,2002.0,30,53,-23
SVK,UKR,2020.0,6,10,-4
PRT,SWE,2012.0,6,13,-7
ESP,PRI,2009.0,9,9,0
IDN,GBR,2014.0,11,25,-14
IDN,KEN,2017.0,1,1,0
BEL,ESP,2005.0,28,27,1
SWE,BGD,2023.0,4,3,1
CYP,GRC,2018.0,33,40,-7
MEX,CHE,2017.0,10,11,-1
ITA,CHN,2012.0,31,30,1
TZA,GBR,2007.0,11,6,5
CHN,CZE,2001.0,2,3,-1
IND,POL,2020.0,40,10,30
GHA,AUS,2022.0,11,11,0
FRA,CZE,2023.0,15,15,0
RUS,POL,2001.0,18,13,5
SWE,AUT,1997.0,3,1,2
EST,GBR,2021.0,12,10,2
SGP,IND,2000.0,2,24,-22
EST,SWE,2023.0,6,4,2
USA,VEN,2020.0,6,23,-17
CHE,GRC,2001.0,11,7,4
FRA,MLI,2020.0,8,8,0
DEU,ZAF,2006.0,23,10,13
ZAF,FRA,2009.0,11,25,-14
ITA,BGD,2019.0,3,5,-2
RUS,PRT,2018.0,4,8,-4
ARG,ITA,2012.0,9,23,-14
HUN,ROU,2018.0,18,10,8
DEU,HRV,2020.0,17,24,-7
IDN,PAK,2020.0,2,3,-1
FRA,GUF,2021.0,34,25,9
DNK,VNM,2009.0,4,1,3
ROU,USA,2013.0,23,26,-3
BOL,USA,2022.0,6,1,5
NPL,DNK,2013.0,2,2,0
NZL,DEU,1997.0,12,7,5
PER,ITA,2018.0,6,1,5
RUS,ROU,2023.0,1,1,0
TZA,USA,1999.0,4,4,0
NGA,NOR,2019.0,3,1,2
USA,JAM,2022.0,8,11,-3
NOR,NLD,2005.0,7,19,-12
NLD,NOR,2006.0,11,5,6
ZWE,USA,2011.0,10,3,7
QAT,CAN,2014.0,3,19,-16
NZL,CHE,2014.0,17,6,11
ITA,BGD,2011.0,2,8,-6
PHL,AUS,1997.0,4,2,2
EGY,GBR,2009.0,26,33,-7
CAN,BGD,2012.0,12,26,-14
BEL,CZE,2014.0,12,8,4
BEL,LUX,2005.0,11,2,9
TUR,PAK,2018.0,11,22,-11
CAN,BFA,2015.0,6,3,3
RUS,CHE,1999.0,12,12,0
USA,KAZ,2021.0,20,8,12
FRA,VNM,2023.0,16,17,-1
CHE,KEN,2021.0,11,6,5
IND,UZB,2021.0,5,1,4
COL,NLD,2021.0,16,17,-1
SDN,EGY,2020.0,4,3,1
RUS,IRL,2020.0,10,3,7
GBR,ROU,2021.0,20,19,1
BGD,JPN,2010.0,49,54,-5
DZA,FRA,2023.0,18,20,-2
MWI,NLD,2021.0,1,8,-7
SAU,MYS,2021.0,31,81,-50
GMB,GBR,2004.0,7,11,-4
ZAF,ISR,2007.0,2,2,0
IND,BEL,2011.0,20,19,1
USA,MLI,2016.0,12,5,7
HUN,JPN,2006.0,7,7,0
HUN,JPN,2010.0,6,4,2
PAK,FRA,2000.0,3,1,2
ITA,ARG,2015.0,17,20,-3
AUS,BTN,2013.0,4,1,3
BTN,AUS,2015.0,7,2,5
NLD,PRT,2021.0,17,28,-11
PRT,USA,2023.0,36,26,10
ISR,FRA,2004.0,21,29,-8
GBR,BRA,1999.0,68,39,29
POL,FIN,1997.0,4,3,1
NOR,ESP,1999.0,8,7,1
CHE,BRA,2009.0,13,19,-6
IND,DNK,2014.0,13,14,-1
SWE,POL,1998.0,14,9,5
BLR,RUS,1997.0,16,18,-2
BRA,RUS,2005.0,8,6,2
SWE,HUN,2013.0,11,14,-3
NZL,FIN,2014.0,5,3,2
CHE,KEN,2011.0,3,3,0
CAN,ARG,2008.0,9,11,-2
AUS,EGY,2019.0,14,14,0
GBR,BGR,2007.0,12,3,9
USA,MKD,2009.0,1,3,-2
ZAF,MEX,2010.0,1,1,0
BGR,GBR,2005.0,9,8,1
AUT,CAN,1998.0,12,9,3
PER,MEX,2019.0,4,12,-8
USA,PRT,2021.0,61,61,0
SWE,COL,1999.0,1,2,-1
USA,BGR,1998.0,16,17,-1
CHE,BGR,1998.0,4,5,-1
CHE,SAU,2017.0,3,14,-11
FIN,NOR,2006.0,13,8,5
PER,ARG,2009.0,5,3,2
AUT,FIN,2000.0,4,4,0
HKG,NZL,2010.0,4,3,1
ZAF,NZL,1999.0,8,2,6
NZL,ZAF,2002.0,3,10,-7
USA,UZB,1999.0,3,5,-2
ROU,GBR,2002.0,16,9,7
GBR,PAK,2006.0,34,22,12
CAN,IRL,2013.0,31,43,-12
CAN,ISR,1997.0,17,16,1
RUS,POL,2004.0,5,13,-8
GBR,LBN,2003.0,3,5,-2
AUT,CZE,2009.0,13,6,7
HRV,SRB,2002.0,7,6,1
GBR,KEN,2002.0,23,14,9
KEN,GBR,2003.0,9,15,-6
CRI,USA,2006.0,12,9,3
CHN,OMN,2021.0,4,1,3
DNK,BEL,1999.0,3,3,0
ITA,NOR,1997.0,2,5,-3
CHN,FIN,2005.0,9,13,-4
AZE,RUS,2001.0,11,5,6
CHE,ZAF,2021.0,12,15,-3
USA,CRI,1997.0,9,12,-3
SVN,GBR,2009.0,8,13,-5
USA,TTO,2000.0,6,1,5
BEL,AUT,2009.0,5,9,-4
USA,BLR,1997.0,4,4,0
SWE,THA,1999.0,3,3,0
CHL,BEL,2005.0,3,4,-1
ISR,TUR,2000.0,4,3,1
SWE,NLD,2014.0,50,71,-21
SWE,CHL,2008.0,4,1,3
CAN,NOR,1999.0,16,9,7
KAZ,RUS,2014.0,21,32,-11
USA,CRI,2012.0,29,24,5
SDN,NLD,2014.0,1,3,-2
USA,BOL,2002.0,7,7,0
NOR,AUS,2012.0,15,18,-3
DEU,VNM,2020.0,30,14,16
DEU,NZL,2022.0,20,28,-8
USA,PRT,2009.0,65,49,16
HND,USA,2014.0,4,3,1
BRA,DNK,2003.0,5,3,2
DNK,BRA,2005.0,2,2,0
VNM,DEU,2004.0,2,1,1
HUN,DEU,2004.0,56,35,21
NLD,NOR,2000.0,20,13,7
HUN,FIN,2015.0,3,3,0
ZAF,DNK,2014.0,1,4,-3
FRA,EGY,2014.0,23,13,10
BLR,JPN,1997.0,2,2,0
GBR,BLR,2010.0,1,1,0
SGP,CAN,2002.0,31,22,9
KOR,DEU,2002.0,24,13,11
FRA,IND,2001.0,19,29,-10
NLD,IND,2007.0,9,14,-5
BRA,IRL,2013.0,7,4,3
HRV,USA,2006.0,18,14,4
IRN,IRL,2002.0,1,1,0
ROU,BEL,1998.0,4,6,-2
FRA,VEN,2000.0,8,5,3
NLD,MWI,2013.0,1,4,-3
ISL,SWE,2013.0,19,11,8
EGY,CAN,2012.0,25,44,-19
IND,PAK,2007.0,15,5,10
JPN,MYS,2006.0,21,15,6
UKR,ITA,2015.0,3,2,1
ARG,BRA,2008.0,24,25,-1
FRA,CHN,1999.0,31,23,8
ARG,ITA,2002.0,21,15,6
IND,NPL,2008.0,21,24,-3
AUS,POL,2012.0,6,5,1
NGA,SAU,2001.0,3,3,0
PRT,CAN,2012.0,6,7,-1
ITA,AUT,2000.0,15,20,-5
JPN,BRA,1998.0,15,11,4
CAN,SWE,2006.0,21,36,-15
DEU,IRL,2013.0,27,52,-25
CHE,BRA,2021.0,15,52,-37
SVK,AUT,2016.0,19,11,8
ARG,DEU,2009.0,28,19,9
AUT,NOR,2008.0,7,6,1
BRA,PRT,2003.0,44,29,15
LBN,CAN,2005.0,4,1,3
CHN,HKG,1999.0,120,151,-31
BRA,ARG,2004.0,18,27,-9
DNK,ISR,2012.0,4,7,-3
FRA,MTQ,2007.0,19,15,4
SWE,ESP,1999.0,15,23,-8
SGP,KOR,2012.0,28,16,12
FIN,CAN,2003.0,20,17,3
BEL,BRA,2006.0,8,10,-2
UGA,GBR,2013.0,9,7,2
AUS,BRA,1999.0,8,4,4
MEX,NLD,2001.0,2,5,-3
GBR,MAR,1999.0,5,1,4
USA,IDN,2003.0,31,15,16
AUS,AUT,2012.0,27,57,-30
FIN,USA,2012.0,78,78,0
ITA,SYR,2009.0,3,1,2
SAU,AUS,2009.0,6,4,2
CAN,HUN,2012.0,8,10,-2
BGD,MYS,1999.0,3,4,-1
ECU,USA,2000.0,4,8,-4
OMN,CAN,2005.0,2,7,-5
SWE,ESP,2007.0,40,19,21
CHL,CHN,2011.0,7,3,4
PHL,DEU,1999.0,1,3,-2
DEU,PHL,2011.0,5,4,1
FIN,ITA,2023.0,14,14,0
VEN,ARG,2001.0,3,1,2
CAN,CHL,2015.0,27,18,9
RUS,CAN,2000.0,40,7,33
ARE,USA,1999.0,7,9,-2
NGA,SAU,2014.0,2,3,-1
SWE,SRB,2007.0,1,3,-2
VEN,FRA,2002.0,7,9,-2
NGA,USA,1999.0,16,15,1
JOR,CAN,2016.0,13,11,2
HUN,GBR,2001.0,16,33,-17
CAN,ROU,2009.0,7,2,5
EGY,YEM,2007.0,2,1,1
BGR,GBR,2012.0,11,7,4
GBR,KWT,2014.0,18,2,16
MYS,USA,2013.0,50,39,11
SRB,HRV,2009.0,8,18,-10
PAK,DEU,2008.0,14,8,6
CHN,GRC,2023.0,10,10,0
MDA,ROU,1999.0,4,1,3
SRB,HKG,2006.0,1,2,-1
ARE,SAU,2023.0,6,30,-24
MOZ,BEL,2010.0,1,1,0
PRT,USA,2000.0,34,41,-7
SAU,TUR,2018.0,10,19,-9
PAK,GBR,1998.0,11,21,-10
LBN,KWT,2004.0,1,1,0
MAR,GBR,2010.0,2,1,1
FRA,CHN,1998.0,28,19,9
ROU,AUT,2000.0,3,1,2
LBY,GBR,2007.0,4,7,-3
GBR,LBY,2008.0,12,2,10
UZB,USA,2006.0,6,1,5
USA,LBN,2002.0,20,34,-14
TWN,SGP,2012.0,8,8,0
MYS,IND,2002.0,5,22,-17
MYS,SGP,2011.0,14,25,-11
CZE,FRA,2011.0,23,18,5
JOR,LBN,2020.0,3,3,0
ZWE,ZAF,2010.0,29,6,23
BEL,IRN,2012.0,11,17,-6
FIN,NGA,2019.0,2,2,0
CHN,IRN,2015.0,10,14,-4
FRA,PYF,2015.0,20,17,3
CAN,AUT,2016.0,32,21,11
IRL,CHE,2015.0,21,12,9
KOR,AUT,2010.0,4,3,1
IRQ,CAN,2020.0,7,6,1
AUS,ESP,2016.0,41,61,-20
IND,ESP,2010.0,18,13,5
BRA,FIN,2015.0,10,2,8
IDN,CHE,2018.0,4,3,1
DNK,IRL,2022.0,10,8,2
ITA,ZAF,2013.0,12,7,5
TWN,IRL,2014.0,2,1,1
FRA,ISR,2012.0,17,27,-10
BEL,CHN,2009.0,13,27,-14
FIN,FRA,2016.0,29,36,-7
CAN,OMN,2017.0,14,9,5
CHL,BOL,2010.0,1,2,-1
TUR,MAR,2021.0,6,3,3
IRL,ROU,2020.0,5,7,-2
USA,MOZ,2011.0,2,5,-3
UKR,CAN,2018.0,6,4,2
IRN,SWE,2007.0,7,12,-5
BGR,BEL,2014.0,5,4,1
ETH,USA,2010.0,10,12,-2
CHL,AUT,2001.0,2,2,0
NLD,KOR,2011.0,9,4,5
IRL,AUT,2009.0,5,5,0
NOR,CAN,2022.0,21,25,-4
MEX,CHE,2016.0,9,13,-4
FRA,KEN,2019.0,4,6,-2
NER,NGA,2015.0,7,16,-9
TUR,BGD,2021.0,3,2,1
EGY,AUS,2014.0,6,6,0
POL,SGP,2013.0,3,3,0
NLD,TWN,2020.0,9,5,4
TUR,ISR,2018.0,3,5,-2
ISR,CHL,2020.0,3,1,2
ZAF,AUT,2017.0,3,10,-7
IRL,POL,2019.0,4,4,0
POL,IRL,2020.0,5,6,-1
IRL,POL,2021.0,7,6,1
BEL,NZL,2016.0,8,6,2
FIN,MEX,2016.0,4,1,3
KOR,CHE,2016.0,13,19,-6
CUB,FRA,2018.0,4,1,3
SRB,DEU,2011.0,13,10,3
LBY,IRQ,2016.0,3,1,2
NOR,POL,2018.0,9,14,-5
BRB,USA,2012.0,2,6,-4
DEU,COL,2017.0,21,16,5
ISR,ETH,2020.0,1,1,0
COL,VEN,2011.0,7,16,-9
NOR,TZA,2018.0,9,2,7
OMN,MYS,2010.0,1,5,-4
FIN,SGP,2017.0,6,1,5
SRB,MKD,2013.0,4,7,-3
LUX,NOR,2018.0,2,2,0
USA,MWI,2016.0,28,13,15
FRA,LAO,2016.0,6,3,3
CHE,PRT,2012.0,9,10,-1
DEU,SAU,2017.0,37,15,22
KOR,EGY,2022.0,8,9,-1
NIC,SWE,2011.0,4,1,3
USA,IDN,2013.0,32,27,5
NZL,FRA,2017.0,9,17,-8
KEN,IND,2018.0,3,4,-1
PRT,BGR,2014.0,3,2,1
ESP,JPN,2012.0,16,13,3
NZL,NOR,2016.0,4,5,-1
KGZ,USA,2020.0,4,3,1
URY,USA,2016.0,19,12,7
BEL,SAU,2015.0,5,2,3
CMR,CAN,2013.0,3,2,1
CAN,KEN,2011.0,6,7,-1
BEL,RUS,2011.0,7,7,0
PAK,CHN,2009.0,12,23,-11
TWN,GBR,2011.0,28,45,-17
GBR,JAM,2016.0,3,3,0
SVN,BEL,2016.0,3,2,1
MNG,USA,2014.0,4,7,-3
PRT,CHE,2015.0,31,11,20
DEU,PER,2020.0,6,5,1
CHL,PER,2017.0,9,9,0
CAN,ITA,2017.0,46,82,-36
VNM,GBR,2010.0,20,16,4
CYM,USA,2022.0,3,3,0
GBR,CHL,2013.0,26,26,0
NLD,IRN,2010.0,10,22,-12
MEX,ECU,2011.0,3,5,-2
ECU,ESP,2012.0,14,2,12
GBR,HUN,1999.0,19,19,0
GRC,SRB,2010.0,17,2,15
PHL,SGP,2010.0,4,6,-2
LUX,USA,2018.0,16,11,5
FRA,BFA,2022.0,7,7,0
MOZ,CHE,2018.0,2,1,1
HKG,CAN,2013.0,18,27,-9
ITA,AUT,2010.0,41,41,0
GBR,JOR,2011.0,17,10,7
CYP,USA,2016.0,11,14,-3
GRC,CYP,2016.0,37,17,20
NOR,SVN,2020.0,1,3,-2
UKR,USA,2011.0,37,17,20
CHN,PRT,2015.0,8,18,-10
MEX,NLD,2015.0,16,13,3
GNB,DNK,2013.0,3,1,2
MEX,ITA,2012.0,14,12,2
GBR,TWN,2009.0,41,24,17
PAK,MYS,2011.0,21,7,14
EGY,JPN,2013.0,17,73,-56
NOR,RUS,2012.0,17,8,9
CYP,GRC,2022.0,45,55,-10
SVN,HRV,2014.0,9,12,-3
CZE,UKR,2023.0,6,11,-5
RUS,NLD,2021.0,26,14,12
ARE,MYS,2019.0,6,16,-10
ESP,PRI,2011.0,5,4,1
AUT,EGY,2006.0,6,1,5
JPN,HUN,2017.0,4,10,-6
AUS,THA,2016.0,41,23,18
SVN,DEU,2010.0,7,6,1
PER,AUS,2020.0,3,2,1
CZE,FRA,2021.0,18,38,-20
USA,AFG,2017.0,11,9,2
CZE,HUN,2011.0,4,2,2
MYS,CAN,2019.0,34,12,22
CUB,BRA,2016.0,29,8,21
ESP,COG,2017.0,1,1,0
VNM,FRA,2016.0,20,60,-40
PRT,FIN,2018.0,6,2,4
PRT,BEL,2022.0,19,17,2
SGP,DNK,2018.0,4,3,1
DNK,SGP,2020.0,9,9,0
PHL,KOR,2016.0,11,19,-8
SRB,MNE,2009.0,7,2,5
MEX,GTM,2021.0,7,4,3
CAN,PRT,1997.0,3,4,-1
CHL,CHE,2003.0,11,7,4
AUS,BRA,2020.0,35,77,-42
MYS,NGA,2014.0,28,30,-2
SWE,IRL,2018.0,10,9,1
KHM,THA,2022.0,4,9,-5
SWE,ZAF,2018.0,13,22,-9
MUS,USA,2019.0,6,3,3
GBR,UGA,2015.0,6,16,-10
SWE,BRA,2018.0,10,34,-24
LKA,NZL,2015.0,3,3,0
BEL,IRL,2022.0,12,12,0
BRA,COL,2023.0,28,29,-1
ETH,GHA,2018.0,1,1,0
BEL,ISR,2017.0,9,4,5
SWE,IRL,2017.0,14,11,3
JAM,GBR,2009.0,5,3,2
KOR,NZL,2013.0,5,6,-1
PRT,FIN,2022.0,3,3,0
TUR,ESP,2020.0,17,16,1
HKG,NOR,2022.0,4,2,2
COG,ZAF,2016.0,2,2,0
LVA,DEU,2016.0,9,7,2
MLT,GBR,2015.0,8,16,-8
SAU,RUS,2021.0,4,5,-1
ZAF,ESP,2016.0,6,11,-5
GHA,AUS,2018.0,20,14,6
SGP,TUR,2021.0,5,7,-2
AUT,PAK,2011.0,22,6,16
KWT,AUT,2016.0,1,2,-1
QAT,ARE,2017.0,9,13,-4
TUN,ITA,2016.0,3,7,-4
EGY,CZE,2013.0,3,4,-1
NOR,UGA,2018.0,6,6,0
KEN,CHE,2018.0,9,6,3
TWN,MYS,2021.0,11,12,-1
CZE,ISR,2008.0,3,3,0
SGP,LUX,2022.0,4,1,3
RUS,FIN,2017.0,27,30,-3
CZE,DNK,2013.0,5,5,0
NLD,MYS,2010.0,2,3,-1
DNK,IRL,2017.0,10,9,1
NGA,NER,2015.0,16,7,9
ZAF,ESP,2017.0,11,14,-3
PAK,IRN,2022.0,4,7,-3
BEL,ISR,2016.0,3,4,-1
USA,SDN,2018.0,5,4,1
CHE,ARG,1997.0,1,1,0
CHN,TUN,2021.0,2,4,-2
PAK,DEU,2001.0,8,7,1
CRI,USA,2000.0,14,9,5
SGP,BGD,2013.0,4,1,3
BGD,SAU,2021.0,13,14,-1
NLD,SLE,2018.0,2,1,1
DEU,LTU,2017.0,7,10,-3
BEL,SYR,2012.0,2,1,1
DEU,PHL,2021.0,6,14,-8
EGY,AUT,2017.0,5,5,0
ZAF,ETH,2023.0,10,5,5
IRL,TUR,2016.0,3,4,-1
CAN,JOR,2020.0,20,19,1
GBR,HUN,2007.0,22,30,-8
DEU,KWT,2020.0,1,1,0
USA,MWI,2017.0,21,11,10
BGD,BRN,2016.0,2,4,-2
USA,CHE,2024.0,4,2,2
COL,BEL,2018.0,5,7,-2
PHL,AUT,2020.0,1,1,0
KEN,ZAF,2018.0,18,38,-20
NER,FRA,2022.0,1,4,-3
CHL,COL,2017.0,28,30,-2
SWE,EGY,2016.0,6,6,0
PAK,IRN,2017.0,2,2,0
IRN,PAK,2022.0,7,4,3
NGA,BEN,2021.0,7,4,3
IDN,AUT,2021.0,6,7,-1
MOZ,CHE,2022.0,2,1,1
IRN,LUX,2022.0,9,1,8
CHN,ZAF,2020.0,13,25,-12
CZE,AUT,2022.0,24,23,1
VEN,DEU,2019.0,7,1,6
SGP,DEU,2014.0,35,35,0
TWN,MNG,2020.0,3,1,2
EGY,ARE,2023.0,20,21,-1
CZE,GBR,2015.0,38,53,-15
SVK,POL,2017.0,10,7,3
SRB,MNE,2021.0,25,84,-59
ECU,MEX,2020.0,10,15,-5
KAZ,CHN,2021.0,6,15,-9
IND,GRC,2021.0,6,5,1
GBR,ETH,2017.0,11,4,7
PER,CHL,2022.0,11,14,-3
TZA,CHN,2019.0,2,8,-6
PAK,QAT,2020.0,6,5,1
NPL,IND,1999.0,3,13,-10
IND,NPL,2001.0,10,4,6
UKR,POL,2020.0,46,34,12
CUB,FRA,2016.0,5,4,1
IND,AUT,2020.0,15,12,3
BGD,ESP,2016.0,1,4,-3
IND,PHL,2023.0,3,4,-1
BEL,HKG,2022.0,2,4,-2
CHN,PAK,2010.0,25,17,8
SWE,BRA,2022.0,15,42,-27
GRC,IRN,2019.0,1,1,0
AUS,ECU,2021.0,2,3,-1
BRA,JPN,2021.0,8,9,-1
SGP,ESP,2018.0,5,8,-3
HUN,ISR,2021.0,3,2,1
NLD,VNM,2020.0,19,8,11
SVK,USA,2017.0,7,13,-6
TWN,CAN,2023.0,3,8,-5
CMR,GBR,2006.0,3,2,1
MEX,SLV,2019.0,2,1,1
COL,CHL,2023.0,15,15,0
JOR,OMN,2021.0,3,4,-1
MEX,AUS,2020.0,7,11,-4
JPN,MYS,2023.0,14,9,5
CHE,SVK,2021.0,1,3,-2
SWE,CHE,2020.0,67,68,-1
FRA,SVN,2021.0,6,10,-4
ECU,DOM,2020.0,3,6,-3
HKG,DEU,2020.0,23,15,8
FIN,AUS,2003.0,18,6,12
NLD,HUN,2013.0,8,11,-3
FRA,IRQ,2020.0,15,1,14
SWE,SVN,2022.0,5,3,2
CZE,IND,2019.0,10,25,-15
MEX,PHL,2022.0,1,1,0
PRT,BEL,2017.0,21,12,9
SAU,YEM,2017.0,5,10,-5
GBR,TWN,2019.0,38,31,7
CHN,THA,2019.0,34,33,1
DNK,AUS,2023.0,13,19,-6
COG,NGA,2020.0,3,5,-2
EGY,DEU,2023.0,31,31,0
UKR,TUR,2021.0,2,1,1
RUS,NOR,2022.0,12,6,6
BEL,CIV,2014.0,5,1,4
PER,MEX,2021.0,14,21,-7
IRL,HKG,2019.0,2,3,-1
QAT,MAR,2021.0,2,1,1
ETH,ITA,2022.0,5,4,1
ARE,EGY,2021.0,23,29,-6
LBY,LBN,2021.0,6,1,5
NLD,LBN,2021.0,6,5,1
MEX,CAN,2016.0,43,40,3
GRD,USA,2021.0,21,9,12
CHE,HUN,2017.0,13,16,-3
DNK,POL,2017.0,11,13,-2
MYS,QAT,2022.0,4,5,-1
GHA,FRA,2022.0,3,1,2
FRA,KOR,2023.0,18,19,-1
SVK,GBR,2022.0,3,2,1
KEN,CHE,2022.0,6,4,2
IRN,CZE,2023.0,15,2,13
CAN,LKA,2023.0,2,5,-3
LBR,USA,2023.0,22,63,-41
ESP,MEX,2023.0,57,76,-19
RUS,AUT,2021.0,26,10,16
IRQ,HUN,2021.0,20,3,17
UGA,TZA,2023.0,1,4,-3
ESP,LUX,2023.0,5,1,4
ISR,ESP,2023.0,7,5,2
MEX,CUB,2021.0,12,12,0
KEN,ZAF,2022.0,19,31,-12
NOR,CAN,2018.0,17,26,-9
AUT,POL,2011.0,12,6,6
ARE,ZWE,2022.0,1,1,0
SWE,EGY,2022.0,1,1,0
USA,GHA,1999.0,3,8,-5
KWT,USA,2023.0,11,15,-4
PAK,BEL,2020.0,4,4,0
CHN,TUR,2022.0,13,9,4
EGY,NZL,2018.0,3,1,2
USA,MMR,2021.0,6,10,-4
KOR,GBR,2010.0,23,45,-22
NZL,CAN,2000.0,11,32,-21
DEU,VNM,1999.0,1,1,0
ARE,JPN,2021.0,3,4,-1
USA,CRI,2002.0,24,10,14
CRI,FRA,2013.0,3,2,1
SWE,GNB,2005.0,1,1,0
CYP,USA,2017.0,14,8,6
RUS,BRA,2002.0,12,13,-1
USA,CUB,1998.0,5,3,2
CAN,GRC,2002.0,15,10,5
FRA,PYF,2014.0,22,8,14
GBR,ETH,2016.0,14,1,13
CUB,DEU,2018.0,7,3,4
CHL,BRA,2005.0,7,15,-8
ARG,CAN,1999.0,16,5,11
CAN,GRC,2005.0,10,9,1
FIN,AUT,1997.0,5,2,3
CMR,FRA,1997.0,8,11,-3
LAO,FRA,2019.0,5,2,3
GBR,PHL,2020.0,12,11,1
CIV,BFA,2007.0,3,2,1
THA,ESP,2015.0,4,2,2
SWE,ITA,2014.0,40,82,-42
TUR,FRA,2017.0,21,25,-4
BLR,DEU,1999.0,15,5,10
HUN,ESP,2013.0,7,5,2
THA,AUS,2003.0,13,21,-8
MLI,ITA,2000.0,1,3,-2
ARE,EGY,2011.0,8,10,-2
NOR,FRA,2017.0,25,43,-18
FRA,BOL,2010.0,7,4,3
ISR,RUS,2003.0,15,23,-8
ISR,RUS,2013.0,11,7,4
DEU,SDN,2002.0,2,2,0
PRT,RUS,2010.0,1,6,-5
PAK,AUS,2004.0,3,4,-1
CRI,USA,2010.0,24,14,10
NGA,IND,1999.0,1,1,0
CHE,FIN,2002.0,6,14,-8
POL,SVK,2017.0,7,10,-3
MNG,DEU,2010.0,1,3,-2
IND,NOR,2012.0,7,6,1
SRB,HRV,2021.0,10,14,-4
SWE,IND,2010.0,16,29,-13
ITA,ISR,2002.0,11,26,-15
CHE,IND,2010.0,24,38,-14
DNK,AUT,2003.0,4,4,0
DNK,FRO,2003.0,5,1,4
IRL,ITA,2009.0,10,24,-14
GBR,TTO,2007.0,5,1,4
AUT,ESP,2008.0,18,22,-4
USA,LKA,2018.0,28,17,11
NLD,BLR,2001.0,1,1,0
DOM,USA,2013.0,4,4,0
QAT,EGY,2005.0,3,1,2
ECU,ITA,2007.0,2,1,1
RUS,AUS,2000.0,9,5,4
PAK,EGY,2022.0,5,4,1
USA,LVA,2009.0,4,2,2
SDN,SAU,2012.0,15,4,11
DNK,GNB,2007.0,3,2,1
QAT,JOR,2014.0,3,5,-2
AUS,KOR,2001.0,13,14,-1
ISL,NOR,2023.0,5,5,0
NOR,RUS,2002.0,8,11,-3
ARG,FRA,2000.0,17,17,0
FIN,CHN,2008.0,11,12,-1
IND,PAK,1999.0,4,2,2
ESP,URY,2002.0,8,5,3
CHE,DNK,2001.0,14,20,-6
NOR,AUS,1997.0,4,1,3
CAN,IRL,2003.0,13,11,2
NLD,POL,2022.0,16,15,1
AUT,FIN,2010.0,7,5,2
TUN,CAN,2013.0,8,9,-1
ISL,NOR,2006.0,6,2,4
DEU,TWN,2007.0,14,10,4
QAT,SAU,2003.0,3,2,1
ITA,ARG,2008.0,21,11,10
AUT,FRA,2018.0,43,52,-9
AUS,BRN,2016.0,3,2,1
AUS,BRA,1998.0,7,3,4
NOR,BRA,2015.0,6,12,-6
SWE,ZAF,2022.0,10,17,-7
CZE,ITA,1998.0,5,3,2
BEL,HUN,2001.0,9,10,-1
GUF,FRA,2023.0,21,30,-9
LKA,NLD,2003.0,2,1,1
TUR,ARG,2017.0,8,2,6
,CHL,2012.0,2181,0,2181
,PER,2014.0,606,0,606
,MEX,2020.0,2580,0,2580
,PRY,2017.0,104,0,104
,ECU,2016.0,966,0,966
,QAT,2004.0,66,0,66
JPN,ROU,2019.0,6,0,6
,IRQ,2019.0,2111,0,2111
,SYR,2012.0,137,0,137
MOZ,,2024.0,300,0,300
,SOM,2015.0,9,0,9
SOM,BRA,2021.0,3,0,3
,ROU,2018.0,2077,0,2077
,BGD,2014.0,975,0,975
,COD,2015.0,47,0,47
,GRC,2019.0,2516,0,2516
NGA,THA,2019.0,2,0,2
SDN,ETH,2023.0,2,0,2
,BWA,2006.0,43,0,43
,ISL,2015.0,149,0,149
,QAT,2014.0,353,0,353
,UGA,2014.0,310,0,310
GIN,,2022.0,36,0,36
,GTM,2014.0,67,0,67
,TZA,2017.0,401,0,401
,MAC,2007.0,50,0,50
,QAT,2015.0,316,0,316
,ECU,2017.0,1082,0,1082
AZE,,2023.0,467,0,467
PRI,,2019.0,131,0,131
MLI,SEN,2023.0,6,0,6
AUS,MMR,2023.0,9,0,9
,CZE,2017.0,2769,0,2769
NZL,ISL,2013.0,1,0,1
,COG,2010.0,107,0,107
ISL,AUT,2016.0,1,0,1
LAO,,2019.0,39,0,39
MKD,,2023.0,299,0,299
LVA,SRB,2012.0,1,0,1
,ISR,2013.0,2662,0,2662
,ETH,2010.0,420,0,420
LAO,,2025.0,197,0,197
BLR,LBN,2018.0,1,0,1
TWN,IRL,2023.0,2,0,2
BEL,HTI,2020.0,1,0,1
IRQ,,2020.0,322,0,322
ETH,,2018.0,171,0,171
NPL,ITA,2016.0,2,0,2
SGP,KNA,2018.0,1,0,1
,GTM,2015.0,67,0,67
,TTO,1994.0,96,0,96
NPL,,2012.0,56,0,56
,CHE,2020.0,2596,0,2596
,OMN,2020.0,194,0,194
,ARG,2020.0,864,0,864
,NCL,2013.0,29,0,29
,BEN,2014.0,117,0,117
ETH,,2026.0,31,0,31
GTM,,2019.0,37,0,37
,CUB,2010.0,704,0,704
AFG,,2022.0,50,0,50
,BIH,2018.0,269,0,269
GUF,,2024.0,54,0,54
LSO,ETH,2021.0,1,0,1
,EST,2017.0,316,0,316
,TUN,2010.0,1137,0,1137
,LBR,2019.0,34,0,34
NZL,RWA,2022.0,1,0,1
GUF,,2023.0,44,0,44
BFA,,2022.0,142,0,142
IRN,,2002.0,56,0,56
GRC,LUX,2019.0,4,0,4
GTM,ECU,2017.0,1,0,1
,FIN,2018.0,2043,0,2043
,URY,2018.0,250,0,250
,ECU,2018.0,1030,0,1030
,AZE,2018.0,262,0,262
,TZA,2018.0,416,0,416
,UZB,2017.0,423,0,423
,UZB,2018.0,505,0,505
,PRK,2018.0,104,0,104
,CRI,2017.0,254,0,254
,BHR,2018.0,148,0,148
,AZE,2017.0,334,0,334
,BTN,2018.0,52,0,52
,CRI,2018.0,234,0,234
GTM,,2025.0,231,0,231
,GRD,2019.0,24,0,24
,BFA,2018.0,140,0,140
,CYP,2019.0,305,0,305
,EST,2018.0,326,0,326
,PRY,2018.0,78,0,78
,SEN,1997.0,130,0,130
,COL,2020.0,1421,0,1421
FIN,MOZ,2021.0,1,0,1
MDV,,2025.0,47,0,47
,DZA,2013.0,1706,0,1706
,BFA,2016.0,109,0,109
PER,IND,2023.0,5,0,5
UZB,ITA,2021.0,1,0,1
,ARM,2018.0,143,0,143
ZAF,CIV,2021.0,1,0,1
,ISL,2014.0,145,0,145
,OMN,2007.0,106,0,106
,BRN,2017.0,55,0,55
SVK,FIN,2023.0,2,0,2
EGY,NLD,2019.0,6,0,6
GNB,,2025.0,38,0,38
,GNB,2018.0,10,0,10
,KGZ,2020.0,40,0,40
,NPL,2007.0,233,0,233
,IRQ,2011.0,457,0,457
,BFA,2017.0,175,0,175
,LTU,2020.0,291,0,291
SEN,,2023.0,317,0,317
,IRQ,2009.0,458,0,458
,BRN,2016.0,36,0,36
,LBY,2019.0,87,0,87
GMB,,2003.0,1,0,1
LSO,,2023.0,31,0,31
CAN,UGA,2004.0,2,0,2
,MOZ,2019.0,121,0,121
,AZE,2016.0,244,0,244
,BGR,2012.0,567,0,567
LVA,NLD,2010.0,1,0,1
,BIH,2017.0,312,0,312
CHE,,2026.0,285,0,285
MDG,NCL,2021.0,1,0,1
,ARE,2020.0,642,0,642
,PRK,2017.0,114,0,114
KAZ,FRA,2010.0,1,0,1
ARE,,2006.0,52,0,52
KWT,LBN,2006.0,2,0,2
TWN,NZL,1998.0,2,0,2
CHL,AUT,2000.0,2,0,2
BRA,LKA,2004.0,2,0,2
GRC,,1999.0,223,0,223
,ARE,1999.0,87,0,87
TUN,,2000.0,53,0,53
ROU,,2000.0,166,0,166
SMR,ITA,1999.0,1,0,1
NOR,,2005.0,456,0,456
GBR,MDG,2008.0,2,0,2
USA,FJI,2016.0,3,0,3
CAN,SUR,2001.0,1,0,1
NLD,SVN,2007.0,1,0,1
,VNM,1995.0,147,0,147
SGP,,1999.0,132,0,132
GUY,,2010.0,6,0,6
SVN,GRC,2005.0,1,0,1
ROU,BRA,1997.0,1,0,1
ZWE,BEL,2001.0,2,0,2
,PAN,1994.0,63,0,63
SRB,PRT,1999.0,1,0,1
KEN,,2001.0,50,0,50
FIN,ISL,2005.0,2,0,2
ISL,FIN,2009.0,1,0,1
ZWE,UGA,2001.0,1,0,1
ISL,,2005.0,30,0,30
,KWT,1995.0,240,0,240
PRT,,2003.0,286,0,286
SRB,KEN,1999.0,1,0,1
,AFG,2002.0,3,0,3
MDG,,2004.0,10,0,10
KAZ,,2017.0,175,0,175
ITA,SGP,2003.0,3,0,3
KWT,BHR,1999.0,1,0,1
HKG,,2000.0,264,0,264
USA,FSM,1997.0,1,0,1
USA,PLW,2007.0,2,0,2
LUX,,2015.0,68,0,68
NPL,,2005.0,22,0,22
PHL,,2006.0,66,0,66
SVN,,2004.0,98,0,98
,LBR,1994.0,3,0,3
CYM,BMU,2000.0,1,0,1
JPN,MAC,2023.0,1,0,1
USA,MMR,2003.0,2,0,2
UGA,,2001.0,19,0,19
AUT,SGP,2007.0,1,0,1
SRB,IRL,2001.0,1,0,1
SRB,IRL,2004.0,1,0,1
SRB,IRL,2008.0,3,0,3
,GAB,1994.0,49,0,49
PNG,ITA,2001.0,2,0,2
ITA,KWT,2004.0,1,0,1
KWT,,2003.0,41,0,41
,BRB,1994.0,22,0,22
USA,MCO,1999.0,2,0,2
ISR,NER,2008.0,1,0,1
SEN,,2010.0,44,0,44
MUS,PAK,2020.0,1,0,1
FJI,MYS,2018.0,1,0,1
IND,JOR,1997.0,2,0,2
JOR,CYP,2017.0,1,0,1
BIH,SWE,2012.0,1,0,1
EUE,,2022.0,6,0,6
MLT,KEN,2019.0,1,0,1
,LSO,1994.0,7,0,7
BGR,,2003.0,212,0,212
UZB,,2018.0,83,0,83
,NER,1999.0,12,0,12
CYP,,2017.0,103,0,103
GRC,MEX,2003.0,1,0,1
BLR,FIN,2006.0,2,0,2
IRL,ISR,1999.0,1,0,1
SEN,,2000.0,23,0,23
,GUM,1994.0,19,0,19
SEN,,2006.0,34,0,34
SWE,TTO,1998.0,1,0,1
DOM,ARG,1999.0,1,0,1
,MDG,1995.0,35,0,35
,PSE,2012.0,86,0,86
,GHA,2013.0,509,0,509
MNG,NLD,2018.0,1,0,1
,TZA,2016.0,305,0,305
CMR,,2017.0,248,0,248
,ZMB,2013.0,131,0,131
,LBN,2010.0,319,0,319
,MLT,2013.0,113,0,113
LUX,,2008.0,28,0,28
,KHM,2012.0,77,0,77
,LBY,2011.0,42,0,42
,MUS,2001.0,10,0,10
,DOM,2012.0,32,0,32
MAC,,2018.0,52,0,52
,MKD,2013.0,189,0,189
BEN,,2005.0,7,0,7
,ISL,2008.0,164,0,164
COG,,2018.0,63,0,63
KAZ,,2026.0,85,0,85
,LTU,2007.0,580,0,580
CAF,,2009.0,3,0,3
CHE,MLI,2016.0,10,0,10
RUS,PER,2019.0,2,0,2
,BRB,2009.0,12,0,12
IND,RWA,2010.0,2,0,2
,ERI,2013.0,6,0,6
IRQ,AFG,2017.0,1,0,1
,GAB,2011.0,33,0,33
CYP,CHN,2022.0,4,0,4
,CIV,2007.0,174,0,174
,LBN,2006.0,248,0,248
GRL,,2025.0,61,0,61
,GTM,2008.0,35,0,35
GBR,BTN,2020.0,1,0,1
BTN,GBR,2021.0,2,0,2
,VEN,2010.0,426,0,426
,SEN,2005.0,74,0,74
CIV,BDI,2018.0,1,0,1
SVK,KEN,2017.0,2,0,2
MYS,BTN,2018.0,1,0,1
,EST,2016.0,275,0,275
MMR,,2018.0,20,0,20
COD,CHE,2016.0,2,0,2
CAF,,2019.0,7,0,7
STP,BRA,2016.0,1,0,1
UKR,EST,2020.0,2,0,2
BGD,,2026.0,151,0,151
,BHR,2016.0,119,0,119
,PRK,2016.0,79,0,79
,URY,2016.0,300,0,300
,HND,2015.0,39,0,39
ITA,AZE,2023.0,3,0,3
PNG,VUT,2020.0,1,0,1
VUT,,2025.0,24,0,24
THA,ETH,2019.0,3,0,3
,GIN,2016.0,26,0,26
CRI,,2020.0,107,0,107
YEM,TUN,2017.0,1,0,1
TLS,,2022.0,8,0,8
LAO,,2021.0,74,0,74
GAB,,2024.0,177,0,177
,ZWE,2019.0,142,0,142
KHM,,2021.0,111,0,111
,PRY,2016.0,71,0,71
ROU,CHN,2018.0,4,0,4
CHE,JOR,2003.0,1,0,1
JOR,CHE,2008.0,1,0,1
SWE,IDN,2023.0,2,0,2
,YEM,2010.0,49,0,49
GAB,CHN,2019.0,2,0,2
,UZB,2016.0,116,0,116
,ESP,2021.0,86,0,86
,GNQ,1995.0,2,0,2
,BGD,2008.0,689,0,689
BEL,MMR,2021.0,1,0,1
TLS,AUS,2019.0,4,0,4
ZAF,ROU,2023.0,2,0,2
,CRI,2016.0,183,0,183
UKR,KAZ,2021.0,4,0,4
CUB,CAN,2006.0,1,0,1
,SMR,2012.0,3,0,3
,LKA,2001.0,115,0,115
GRC,IRQ,2015.0,2,0,2
,BRN,2018.0,66,0,66
LUX,,2004.0,10,0,10
,BTN,2017.0,36,0,36
TWN,JOR,2019.0,5,0,5
GRC,NPL,2018.0,1,0,1
ZAF,MUS,2018.0,4,0,4
,TCD,2019.0,12,0,12
,CMR,2019.0,594,0,594
,QAT,2001.0,54,0,54
MWI,GHA,2021.0,1,0,1
,GAB,2019.0,52,0,52
NGA,HUN,2022.0,1,0,1
,GIN,2018.0,38,0,38
,TTO,2019.0,35,0,35
,NPL,2020.0,470,0,470
,ARM,2017.0,176,0,176
LSO,,2024.0,52,0,52
,MAC,2020.0,329,0,329
UZB,,2026.0,23,0,23
AND,,2025.0,22,0,22
CAN,CAF,2023.0,1,0,1
UZB,ESP,2019.0,1,0,1
MDV,MDA,2021.0,5,0,5
,URY,2017.0,220,0,220
ARE,,2000.0,29,0,29
TWN,VNM,2000.0,1,0,1
,MOZ,1994.0,20,0,20
MOZ,NLD,1998.0,2,0,2
GHA,,2010.0,29,0,29
BFA,MRT,2006.0,1,0,1
IRL,,2001.0,235,0,235
SMR,USA,2014.0,1,0,1
NAM,,2013.0,5,0,5
COL,,2009.0,174,0,174
ETH,ZAF,1998.0,3,0,3
,LKA,1996.0,117,0,117
ROU,NOR,2002.0,2,0,2
GHA,,2006.0,29,0,29
,ASM,1994.0,3,0,3
UZB,,2017.0,67,0,67
ITA,TTO,2014.0,1,0,1
NZL,RUS,2006.0,4,0,4
MLI,,2004.0,1,0,1
,NPL,1998.0,50,0,50
,KAZ,1998.0,98,0,98
,PER,1996.0,92,0,92
MEX,ZAF,2001.0,1,0,1
JPN,DOM,2002.0,1,0,1
AZE,,2006.0,36,0,36
BEL,BFA,2010.0,3,0,3
LVA,,2003.0,42,0,42
KAZ,FIN,2002.0,1,0,1
BIH,ALB,2016.0,1,0,1
NZL,BLR,2003.0,1,0,1
,MCO,1995.0,16,0,16
ZAF,LSO,1999.0,1,0,1
SWE,ARE,2011.0,1,0,1
MAR,ITA,2003.0,5,0,5
IDN,,2002.0,48,0,48
,MTQ,1994.0,33,0,33
ISR,CRI,1997.0,1,0,1
,QAT,1996.0,33,0,33
FLK,,2004.0,2,0,2
IDN,,2012.0,111,0,111
TUN,SAU,2000.0,1,0,1
,CYP,2011.0,196,0,196
,BEN,1996.0,32,0,32
,MLI,2000.0,35,0,35
GRL,,2019.0,6,0,6
USA,LKA,1997.0,4,0,4
CAN,KNA,2017.0,1,0,1
JPN,LVA,2005.0,2,0,2
KGZ,,2003.0,11,0,11
IRQ,USA,1997.0,1,0,1
NLD,SEN,1997.0,1,0,1
SEN,TGO,2004.0,1,0,1
DEU,MNE,2004.0,1,0,1
MNE,MKD,2007.0,1,0,1
MKD,MNE,2010.0,2,0,2
WSM,,2016.0,2,0,2
CIV,,2003.0,22,0,22
SWE,ARM,2006.0,1,0,1
GRC,NGA,2002.0,1,0,1
NGA,CMR,2001.0,5,0,5
ISR,SVN,1998.0,3,0,3
ZAF,VNM,2013.0,2,0,2
,CMR,2009.0,310,0,310
,UGA,2008.0,241,0,241
TJK,IRN,2016.0,3,0,3
,QAT,2008.0,110,0,110
,BEN,2008.0,66,0,66
,ARE,2007.0,226,0,226
,PER,2008.0,345,0,345
,HND,2008.0,11,0,11
MLI,IND,2019.0,1,0,1
KGZ,,2013.0,8,0,8
,MUS,2008.0,27,0,27
,JAM,2006.0,66,0,66
,LKA,2008.0,172,0,172
BIH,,2013.0,92,0,92
,COD,2008.0,16,0,16
SYR,,2015.0,51,0,51
IND,BWA,2017.0,3,0,3
TZA,AUS,2017.0,4,0,4
ITA,LUX,2013.0,12,0,12
ROU,DNK,2016.0,1,0,1
MWI,ZAF,2008.0,5,1,4
JPN,SAU,2007.0,5,1,4
USA,ZWE,2016.0,16,5,11
CHN,NGA,2014.0,8,8,0
CAN,ROU,2019.0,5,4,1
IND,FIN,2014.0,16,5,11
TUR,KWT,2018.0,8,1,7
TWN,IDN,2015.0,14,12,2
TTO,JAM,2018.0,8,3,5
NLD,GRC,2020.0,32,36,-4
ITA,BRA,2015.0,68,41,27
SRB,AUS,2021.0,3,1,2
IRL,SWE,2015.0,12,9,3
SAU,FRA,2021.0,21,36,-15
DEU,NGA,2012.0,8,7,1
TZA,DNK,2013.0,2,2,0
IND,DEU,2016.0,184,143,41
NGA,GBR,2012.0,31,33,-2
USA,ROU,2018.0,28,23,5
IND,CHE,2011.0,35,18,17
SVN,USA,2012.0,15,22,-7
GBR,LKA,2011.0,7,7,0
TWN,CAN,2010.0,12,22,-10
USA,TUN,2012.0,11,6,5
CHE,HUN,2022.0,6,10,-4
USA,IRN,2012.0,66,326,-260
LTU,BEL,2018.0,4,7,-3
ESP,SGP,2017.0,6,9,-3
LKA,IND,2014.0,5,4,1
SGP,BEL,2018.0,5,10,-5
USA,GHA,2007.0,10,8,2
FIN,KOR,2021.0,3,14,-11
VNM,FRA,2018.0,21,71,-50
GBR,UKR,2020.0,18,13,5
ARE,CHN,2022.0,20,20,0
ETH,SWE,2017.0,7,6,1
MYS,FRA,2015.0,3,12,-9
IRN,IND,2003.0,5,10,-5
FRA,AUT,2021.0,52,32,20
NIC,USA,2018.0,5,3,2
THA,KOR,2017.0,13,14,-1
ITA,HRV,2018.0,11,6,5
ITA,BRA,2014.0,56,43,13
HRV,BIH,2012.0,10,7,3
ARE,CHN,2018.0,5,12,-7
MEX,VEN,2005.0,1,7,-6
GBR,KEN,1997.0,9,13,-4
CAN,ARG,2004.0,16,18,-2
EST,USA,2020.0,10,8,2
COG,COD,2014.0,24,26,-2
ZAF,UGA,2003.0,2,1,1
MYS,BGD,2006.0,5,4,1
MWI,GBR,1998.0,4,3,1
USA,VEN,2007.0,43,38,5
FRA,ISR,2002.0,38,30,8
CHE,BEL,1998.0,16,18,-2
TUR,IND,2017.0,8,12,-4
CMR,GBR,2000.0,4,2,2
USA,EST,2008.0,9,1,8
JPN,ESP,2001.0,10,9,1
HUN,FIN,2001.0,6,3,3
HUN,FIN,2008.0,6,1,5
ISR,IND,1998.0,5,10,-5
VEN,ESP,2000.0,18,14,4
VNM,AUT,2017.0,3,5,-2
AUS,IDN,2023.0,35,33,2
CZE,NLD,2022.0,12,4,8
GBR,ROU,2019.0,29,29,0
MEX,KOR,2019.0,9,1,8
USA,COL,2023.0,36,109,-73
FRA,LAO,2018.0,8,3,5
KOR,IDN,2014.0,11,4,7
LTU,ESP,2022.0,2,2,0
AUS,IDN,2010.0,32,8,24
BEL,KAZ,2022.0,5,2,3
KOR,PAK,2021.0,103,63,40
ITA,CHN,2005.0,15,6,9
CYP,CHE,2013.0,3,2,1
FRA,MOZ,2021.0,1,2,-1
FRA,NOR,2014.0,33,29,4
CHN,NLD,2024.0,8,1,7
CAN,ARG,2001.0,16,10,6
POL,SWE,2000.0,8,11,-3
DEU,BGR,2020.0,16,9,7
GBR,SVN,2008.0,8,9,-1
DNK,LVA,2014.0,2,1,1
LUX,NOR,2022.0,1,1,0
NLD,ZAF,2002.0,13,14,-1
POL,SWE,2006.0,10,8,2
DNK,ISR,1997.0,3,3,0
USA,NPL,2017.0,24,33,-9
CHL,AUS,2005.0,3,2,1
SGP,IND,2006.0,16,31,-15
HUN,GBR,2008.0,40,17,23
MEX,ARG,2001.0,9,7,2
IRL,SWE,2001.0,11,2,9
FIN,DNK,2005.0,11,7,4
FRA,IRN,2002.0,9,4,5
NLD,ARG,2003.0,7,2,5
RUS,SRB,2013.0,4,3,1
MEX,ARG,2004.0,10,5,5
MYS,IRN,2010.0,35,50,-15
HRV,SRB,2012.0,12,7,5
DNK,IRL,2016.0,9,5,4
CHL,ISR,2018.0,4,1,3
USA,BGD,1998.0,8,9,-1
KOR,DEU,2005.0,24,33,-9
BEL,KEN,2016.0,6,7,-1
EGY,BEL,2012.0,2,5,-3
SWE,NLD,2015.0,28,79,-51
IRN,ITA,2018.0,57,26,31
FRA,EGY,2015.0,25,18,7
RUS,VNM,2022.0,8,12,-4
MNG,JPN,2016.0,5,11,-6
NLD,ARE,2023.0,3,4,-1
KOR,EST,2022.0,1,1,0
AUS,IRQ,2023.0,6,1,5
IRN,ISL,2020.0,5,1,4
KOR,FRA,2001.0,9,4,5
AUS,FRA,2016.0,95,107,-12
NZL,BGD,2021.0,6,5,1
USA,CUB,2020.0,7,14,-7
PAK,DEU,2015.0,17,37,-20
RUS,DNK,2022.0,13,6,7
ITA,EST,2021.0,1,6,-5
MEX,NLD,2004.0,6,4,2
ISL,SWE,2003.0,14,14,0
MDA,UKR,2000.0,4,1,3
URY,DEU,2005.0,3,1,2
ISR,UKR,2017.0,2,7,-5
NPL,USA,1999.0,2,4,-2
CHE,ZAF,2011.0,18,10,8
NLD,UKR,2013.0,3,4,-1
NLD,RUS,2019.0,16,24,-8
AUT,SWE,2016.0,32,26,6
NLD,SRB,2006.0,6,3,3
ROU,HUN,1999.0,1,1,0
USA,MDG,2020.0,6,8,-2
RUS,CHN,2024.0,1,2,-1
PAN,SWE,2016.0,1,2,-1
TUR,AUT,2002.0,4,4,0
FRA,KOR,2021.0,19,27,-8
MAC,SAU,2018.0,2,1,1
ZAF,ZMB,2015.0,5,3,2
DNK,ARG,2020.0,1,9,-8
GRC,BEL,2022.0,14,9,5
IND,EST,2021.0,5,5,0
FRA,HKG,2017.0,12,7,5
VNM,RUS,2019.0,5,19,-14
DOM,CHL,2016.0,3,2,1
EGY,TUN,2016.0,3,2,1
RWA,AUS,2021.0,1,2,-1
HUN,IRL,2004.0,3,2,1
BGD,DEU,2019.0,9,8,1
CHN,ROU,2022.0,5,3,2
ITA,GHA,2020.0,5,2,3
NZL,BEL,2020.0,5,2,3
PAK,JPN,2023.0,14,1,13
HRV,SVK,2019.0,2,1,1
POL,BLR,2019.0,3,5,-2
LUX,RUS,2023.0,1,2,-1
LKA,JPN,2023.0,5,4,1
SGP,NZL,2021.0,12,12,0
FIN,KOR,2023.0,1,5,-4
IRL,DNK,2020.0,6,9,-3
ARE,PRT,2019.0,2,4,-2
USA,BMU,2021.0,3,1,2
BEL,IDN,2019.0,6,1,5
IRN,BRA,2022.0,8,9,-1
KOR,MEX,2021.0,2,3,-1
DEU,ZWE,2020.0,1,2,-1
GEO,DEU,2021.0,3,2,1
NLD,JPN,2003.0,13,25,-12
SRB,FRA,2009.0,3,4,-1
SRB,PRT,2018.0,1,1,0
CAN,LBN,2022.0,9,21,-12
COL,CHL,2009.0,8,10,-2
ZWE,COG,2021.0,4,1,3
HKG,EGY,2023.0,3,2,1
BFA,GBR,2019.0,2,4,-2
IRN,TWN,2022.0,11,9,2
HKG,NLD,2022.0,5,9,-4
POL,CZE,2023.0,7,16,-9
THA,PHL,2022.0,8,5,3
PRT,CPV,2022.0,3,2,1
USA,GTM,2022.0,12,7,5
KAZ,POL,2020.0,2,2,0
MNG,KOR,2022.0,5,4,1
KAZ,BLR,2020.0,2,2,0
BGD,PAK,2022.0,10,11,-1
THA,TWN,2022.0,6,16,-10
ESP,HUN,2018.0,7,6,1
CHE,SVK,2023.0,1,1,0
SVK,ITA,2020.0,5,3,2
QAT,SAU,2015.0,5,15,-10
BHR,IND,1997.0,1,3,-2
IND,CHL,2013.0,1,2,-1
IRN,BRA,2018.0,5,4,1
DEU,LIE,2014.0,2,1,1
ISL,CAN,2005.0,2,2,0
HUN,IRL,2008.0,4,1,3
JPN,ROU,2008.0,14,3,11
IRL,EGY,2017.0,3,1,2
TWN,AUS,2008.0,11,12,-1
IND,HUN,2008.0,2,1,1
TUR,BHR,2012.0,2,1,1
SVN,DEU,2011.0,10,7,3
KHM,COL,2013.0,1,1,0
DEU,FIN,2006.0,25,29,-4
MWI,GBR,2005.0,6,6,0
KEN,CIV,2021.0,1,4,-3
SGP,BRA,2014.0,3,2,1
PAN,VEN,2009.0,1,1,0
MLT,GBR,2013.0,7,5,2
RUS,MEX,2021.0,4,8,-4
IRN,CAN,1998.0,3,12,-9
ESP,CZE,2008.0,4,4,0
PRT,MEX,2012.0,6,3,3
URY,FRA,2011.0,6,5,1
FRA,URY,2012.0,9,3,6
DZA,GBR,2009.0,3,1,2
ETH,IND,2013.0,7,14,-7
TGO,FRA,2013.0,3,4,-1
TUR,KOR,2014.0,6,6,0
MYS,BEL,2012.0,6,1,5
HRV,AUT,2020.0,8,4,4
NZL,SGP,2018.0,15,17,-2
EST,DEU,2012.0,7,7,0
CHN,FIN,2007.0,6,6,0
DEU,MAR,2006.0,2,2,0
FIN,HUN,2011.0,4,6,-2
IRN,ESP,2012.0,15,7,8
FRA,LTU,2005.0,2,2,0
DEU,THA,2016.0,32,13,19
FRA,GTM,2013.0,1,1,0
SWE,BEL,2014.0,22,14,8
DEU,MOZ,2016.0,1,1,0
SAU,OMN,2011.0,5,7,-2
ISR,KOR,2019.0,4,6,-2
MYS,FIN,2013.0,1,1,0
FIN,PAK,2014.0,1,3,-2
TWN,MYS,2010.0,5,2,3
DNK,SAU,2017.0,3,1,2
ARG,PER,2009.0,3,5,-2
PER,ARG,2010.0,3,1,2
ZAF,LSO,2016.0,8,4,4
ZAF,URY,2013.0,2,1,1
KOR,GHA,2019.0,5,2,3
FRA,GAB,2004.0,7,2,5
SVK,BEL,2011.0,4,1,3
GRC,AUT,2010.0,4,6,-2
BEL,PER,2009.0,2,1,1
NLD,BRA,2004.0,7,10,-3
PAK,IRL,2011.0,2,1,1
ROU,USA,2014.0,27,29,-2
NPL,KOR,2009.0,3,2,1
MYS,BGD,2011.0,11,25,-14
MAR,ESP,2011.0,13,11,2
DZA,GBR,2019.0,6,8,-2
ARE,FRA,2014.0,3,15,-12
BGR,NLD,2007.0,4,1,3
UGA,ETH,2016.0,2,1,1
CZE,GBR,2013.0,36,42,-6
TUR,CZE,2014.0,8,2,6
FIN,MYS,2015.0,2,2,0
MYS,PHL,2006.0,2,1,1
SAU,QAT,2004.0,2,1,1
BMU,GBR,2014.0,2,1,1
GBR,BMU,2022.0,2,1,1
GNB,DNK,2015.0,6,6,0
AUT,CHL,2019.0,7,3,4
AUS,LAO,2015.0,5,1,4
IRN,CHE,2011.0,18,13,5
RUS,IRL,2012.0,6,1,5
DNK,IRN,2015.0,6,19,-13
GBR,SRB,2010.0,7,5,2
BEN,CMR,2011.0,1,1,0
BFA,FRA,2020.0,8,15,-7
ETH,NGA,2010.0,2,3,-1
ISL,IRL,2017.0,1,1,0
CAN,HRV,2023.0,1,1,0
PER,ESP,2009.0,9,6,3
HUN,HRV,2017.0,4,4,0
UGA,KEN,2012.0,6,4,2
BLR,USA,2004.0,10,9,1
JOR,ARE,1999.0,5,1,4
IRL,NLD,2008.0,9,12,-3
IND,CHE,2000.0,6,8,-2
BGD,PAK,2016.0,15,10,5
NLD,SUR,2015.0,7,1,6
KOR,TWN,2011.0,12,12,0
USA,ETH,2012.0,13,20,-7
LVA,SWE,2004.0,2,5,-3
ROU,MYS,2020.0,1,1,0
KOR,FRA,2003.0,1,6,-5
CHN,SVK,2022.0,5,1,4
ITA,JPN,2009.0,12,21,-9
PRT,MAC,2022.0,2,2,0
BEL,ZAF,2005.0,5,5,0
USA,HRV,2023.0,3,1,2
CHE,HRV,2016.0,6,5,1
MEX,DEU,1999.0,6,16,-10
AUT,SGP,2018.0,4,4,0
MCO,FRA,1997.0,4,5,-1
ARE,IRL,2018.0,3,10,-7
LUX,MEX,2022.0,3,1,2
EGY,MEX,2020.0,2,2,0
NLD,CHL,2015.0,12,8,4
DOM,USA,2015.0,2,5,-3
JPN,SVN,2011.0,1,1,0
ISL,NZL,2001.0,1,2,-1
USA,GIN,2019.0,2,1,1
DEU,MKD,2016.0,3,6,-3
BLR,NOR,2022.0,1,1,0
MAR,ARE,2013.0,2,1,1
AUT,GRC,2009.0,5,5,0
TUR,DNK,2017.0,7,4,3
MYS,MMR,2016.0,1,1,0
SWE,MEX,2018.0,1,10,-9
ETH,CAN,2000.0,2,1,1
ESP,NZL,2009.0,2,2,0
USA,DMA,2014.0,2,4,-2
DNK,NLD,1997.0,13,18,-5
PHL,CHN,2012.0,5,3,2
MEX,CUB,2010.0,10,16,-6
IRL,LBN,2019.0,1,1,0
BEL,FIN,1997.0,2,1,1
ROU,ESP,2000.0,4,1,3
ISR,RUS,2001.0,3,22,-19
THA,NPL,2017.0,8,3,5
TUR,RUS,2015.0,4,4,0
NLD,KOR,2010.0,3,10,-7
JPN,NOR,2001.0,3,5,-2
KOR,PRT,2020.0,3,4,-1
AUT,BIH,2019.0,1,1,0
ZAF,BFA,2019.0,2,1,1
ITA,EGY,2020.0,16,13,3
CUB,ESP,1997.0,16,7,9
ITA,BGD,2023.0,2,3,-1
THA,ITA,2023.0,2,1,1
CHN,CHE,1997.0,4,3,1
JPN,PER,2019.0,4,1,3
CYP,IRQ,2020.0,5,1,4
CHE,MYS,2022.0,2,3,-1
AUT,ARE,2022.0,4,3,1
MOZ,USA,2019.0,7,17,-10
MYS,KOR,2023.0,4,1,3
AZE,USA,2022.0,5,2,3
IRQ,BHR,2022.0,2,2,0
ITA,ALB,2022.0,4,9,-5
MAR,CMR,2022.0,1,3,-2
KOR,MAC,2019.0,1,1,0
KOR,RUS,2022.0,8,8,0
PER,ECU,2022.0,5,6,-1
ESP,EST,2002.0,2,1,1
BGR,NOR,2020.0,1,2,-1
KWT,IND,2004.0,5,11,-6
THA,JPN,1999.0,21,34,-13
JPN,FJI,2013.0,1,2,-1
IRL,RUS,2000.0,1,1,0
ITA,SGP,2010.0,3,2,1
HRV,SRB,1998.0,6,1,5
MYS,NZL,2003.0,1,2,-1
GRC,CAN,1997.0,10,11,-1
DEU,BGR,1997.0,10,17,-7
CHE,BGR,2005.0,3,4,-1
CZE,BEL,1999.0,4,4,0
NZL,IRL,2007.0,7,7,0
USA,URY,2011.0,16,9,7
HUN,SGP,2005.0,1,1,0
SWE,HRV,1998.0,3,3,0
USA,IRN,1998.0,18,10,8
BGD,THA,2004.0,1,2,-1
AUS,FIN,1997.0,5,5,0
NOR,TUR,2001.0,2,1,1
BIH,HRV,1998.0,2,3,-1
FIN,MDA,2006.0,2,2,0
DNK,FIN,1997.0,4,4,0
SWE,THA,2005.0,5,1,4
EST,USA,2002.0,5,7,-2
USA,EST,2003.0,5,6,-1
EGY,FRA,2004.0,3,2,1
IRN,MYS,2005.0,1,3,-2
GBR,HRV,1997.0,3,3,0
EGY,GBR,2000.0,7,11,-4
MYS,IND,1998.0,3,7,-4
BEL,NOR,1997.0,3,2,1
KWT,BHR,2017.0,1,1,0
BEL,ITA,1997.0,16,18,-2
IND,HUN,2004.0,1,1,0
CAN,JOR,1997.0,3,7,-4
AUS,BRA,2005.0,8,11,-3
DEU,OMN,2001.0,3,1,2
UKR,SWE,2001.0,10,3,7
ITA,IRN,2003.0,3,2,1
NGA,BEN,2010.0,4,1,3
CZE,BEL,1998.0,1,4,-3
CAN,PRT,2007.0,4,5,-1
NLD,SAU,2000.0,1,4,-3
FRA,LUX,2002.0,9,3,6
ISR,POL,2003.0,2,2,0
ITA,QAT,2018.0,5,2,3
AUT,POL,2010.0,8,12,-4
MAR,SEN,2014.0,1,4,-3
CHL,BEL,1998.0,2,1,1
ZAF,MEX,2009.0,2,1,1
SRB,RUS,2012.0,1,1,0
HKG,KOR,2007.0,6,1,5
SEN,FRA,2014.0,26,30,-4
ARE,KWT,1999.0,1,1,0
ZAF,FRA,2023.0,11,12,-1
ESP,DNK,1999.0,7,8,-1
FRA,SGP,2001.0,4,4,0
DNK,TUR,1997.0,3,1,2
USA,BLR,1999.0,7,10,-3
URY,SWE,2011.0,3,2,1
KAZ,GBR,2003.0,1,1,0
RUS,BGR,2008.0,6,4,2
NOR,JPN,1997.0,3,3,0
ZAF,TUR,2007.0,1,1,0
CAN,SAU,2001.0,18,13,5
USA,ISL,2023.0,5,14,-9
NLD,MEX,1999.0,4,4,0
ITA,IRL,2002.0,10,7,3
KWT,EGY,2016.0,13,6,7
ECU,GBR,2005.0,3,3,0
BGR,FRA,2014.0,10,7,3
TWN,ITA,2004.0,3,2,1
SAU,ZAF,2010.0,6,30,-24
ARE,DZA,2007.0,1,1,0
ARM,DEU,2012.0,5,5,0
USA,UZB,2002.0,1,7,-6
UZB,USA,2009.0,3,2,1
CHE,BRA,2000.0,6,7,-1
ROU,TUR,2016.0,1,1,0
UZB,KAZ,2006.0,1,2,-1
FIN,EST,1999.0,4,4,0
URY,CAN,2015.0,1,1,0
TUR,CZE,2008.0,2,3,-1
CZE,SWE,1998.0,5,4,1
MDA,ROU,2012.0,7,3,4
GRC,CHN,2004.0,1,1,0
AUS,EGY,2000.0,2,3,-1
GBR,EST,2016.0,6,10,-4
LTU,DEU,2015.0,4,8,-4
NOR,TUR,2015.0,1,3,-2
UKR,NLD,1998.0,2,2,0
DNK,IND,1997.0,3,3,0
URY,ARG,2005.0,4,4,0
NOR,CHL,2013.0,3,1,2
BEL,KOR,2013.0,3,14,-11
SWE,CRI,1997.0,4,1,3
AUT,CZE,2010.0,10,7,3
UKR,BLR,2018.0,4,1,3
TWN,ITA,2014.0,4,4,0
SRB,HUN,2016.0,8,6,2
DEU,KWT,2012.0,2,2,0
ROU,SRB,2008.0,1,2,-1
DNK,AUT,2015.0,13,17,-4
CAN,MDG,2014.0,2,2,0
AUT,CYP,2010.0,1,1,0
PRT,AUS,2010.0,3,4,-1
ECU,CAN,2011.0,2,2,0
SAU,DNK,2018.0,1,3,-2
TWN,KOR,2011.0,12,12,0
HKG,FRA,2009.0,4,6,-2
BEN,NLD,2009.0,3,2,1
LTU,SWE,2007.0,5,9,-4
CAN,URY,2012.0,2,1,1
TWN,GBR,2006.0,16,45,-29
ITA,ISR,2007.0,8,5,3
MEX,DNK,2018.0,2,2,0
GBR,COL,2016.0,19,14,5
HKG,BEL,1999.0,3,1,2
CHN,VNM,2012.0,4,1,3
SRB,BIH,2007.0,14,11,3
BEL,SVK,2009.0,2,2,0
CUB,COL,2013.0,7,1,6
ROU,FIN,2009.0,3,1,2
SEN,CMR,2014.0,2,2,0
EST,FIN,2014.0,7,12,-5
BEL,SGP,2001.0,2,2,0
ARG,NZL,2011.0,2,2,0
CHE,TUR,2016.0,5,18,-13
BRA,ZAF,2009.0,4,1,3
IRL,RUS,2023.0,3,4,-1
PRT,EGY,2015.0,2,2,0
CHL,SWE,2017.0,9,1,8
AFG,THA,2021.0,2,1,1
TWN,HKG,2016.0,12,11,1
ITA,COL,2005.0,2,2,0
IRN,BRA,2016.0,6,3,3
BRA,IRL,2015.0,8,7,1
HUN,NLD,2015.0,7,11,-4
JPN,ITA,2011.0,16,24,-8
TWN,KOR,2009.0,11,15,-4
CAN,QAT,2021.0,21,18,3
POL,IRL,2012.0,5,5,0
ARE,LBN,2011.0,4,4,0
EST,USA,2012.0,10,4,6
LBY,GBR,2012.0,2,12,-10
THA,BEL,2012.0,7,3,4
BEL,THA,2018.0,2,3,-1
FIN,HUN,2021.0,4,3,1
EGY,NGA,2012.0,2,1,1
CHE,JPN,2009.0,33,33,0
ARE,LBN,2009.0,3,1,2
LUX,POL,2020.0,3,3,0
COL,GBR,2010.0,10,10,0
NPL,DEU,2018.0,4,4,0
NGA,NER,2013.0,8,7,1
MLI,CIV,2010.0,4,3,1
DZA,SAU,2011.0,7,2,5
AZE,IRN,2011.0,10,3,7
MMR,THA,2017.0,5,5,0
ISR,ITA,2011.0,7,13,-6
NLD,EST,2022.0,4,2,2
AUS,OMN,2013.0,3,1,2
AZE,GBR,2018.0,1,1,0
COG,FRA,2014.0,5,6,-1
USA,GAB,2018.0,5,3,2
ESP,JPN,1998.0,11,5,6
PRT,CHL,2019.0,5,5,0
LTU,DEU,2008.0,12,8,4
ARG,COL,2013.0,12,11,1
NLD,SVK,2010.0,3,4,-1
BEL,THA,2017.0,3,7,-4
IDN,IRN,2019.0,1,1,0
CAN,MAR,2005.0,5,10,-5
GBR,ROU,2010.0,6,20,-14
GRC,AUS,2004.0,3,2,1
SGP,QAT,2013.0,3,1,2
ISR,CZE,2022.0,6,4,2
SRB,HUN,2022.0,4,2,2
NOR,AUS,2007.0,11,11,0
NLD,BEN,2017.0,6,1,5
PAK,NLD,2023.0,6,4,2
NLD,BRA,2015.0,25,52,-27
IRL,IRN,2013.0,6,9,-3
MMR,THA,2016.0,3,3,0
GTM,USA,2016.0,11,9,2
TUR,NGA,2016.0,3,2,1
BRA,CUB,2017.0,8,29,-21
NOR,RUS,2020.0,13,12,1
AZE,TUR,2015.0,7,9,-2
TUN,CAN,2014.0,15,11,4
CYP,GBR,2011.0,6,35,-29
ZAF,ITA,2011.0,4,10,-6
RUS,TWN,2013.0,2,1,1
DEU,GHA,2014.0,4,9,-5
MEX,IRL,2020.0,4,1,3
TZA,ZAF,2014.0,8,10,-2
NLD,RWA,2013.0,3,1,2
THA,IND,2020.0,11,21,-10
BEL,MDG,2017.0,1,1,0
EST,FIN,2015.0,20,22,-2
NPL,SWE,2013.0,4,1,3
POL,PAK,2020.0,1,5,-4
FIN,IRL,2015.0,5,1,4
CZE,IND,2023.0,19,19,0
FRA,PSE,2023.0,1,1,0
EGY,ZAF,2014.0,3,5,-2
ZAF,CMR,2013.0,4,8,-4
PAK,CHN,2010.0,17,25,-8
ESP,BOL,2018.0,5,2,3
TUR,HUN,2016.0,3,1,2
CZE,IRN,2013.0,4,4,0
EGY,CHN,2011.0,7,2,5
PNG,AUS,2016.0,9,5,4
SGP,NOR,2011.0,4,2,2
ESP,ISR,2023.0,5,7,-2
GBR,EST,2018.0,14,9,5
NOR,UKR,2013.0,2,1,1
BEL,ECU,2014.0,4,1,3
CHN,EST,2014.0,1,2,-1
KWT,ARE,2022.0,5,2,3
AUS,GRC,2015.0,6,11,-5
KOR,KAZ,2020.0,9,2,7
BFA,USA,2019.0,3,6,-3
CZE,FIN,2006.0,1,1,0
AUT,EGY,2019.0,5,1,4
CHE,LBN,2016.0,3,5,-2
CHE,LSO,2017.0,1,1,0
GHA,MYS,2013.0,2,1,1
CHE,PAK,2015.0,2,2,0
CUB,BEL,2019.0,3,2,1
FLK,GBR,2015.0,1,2,-1
PAK,IRL,2019.0,10,9,1
AZE,GBR,2016.0,1,3,-2
POL,HUN,2013.0,4,1,3
FRA,ZAF,2016.0,20,23,-3
DNK,FRA,2023.0,15,34,-19
SRB,ALB,2020.0,12,6,6
ITA,KEN,2017.0,6,4,2
CHN,UGA,2018.0,4,1,3
TUR,GRC,2021.0,3,5,-2
SYR,DEU,2016.0,2,3,-1
BEL,BFA,2013.0,4,3,1
IDN,THA,2017.0,3,7,-4
USA,TJK,2015.0,2,1,1
CZE,TUR,2023.0,4,4,0
POL,PRT,2015.0,13,10,3
LBN,AUS,2020.0,5,5,0
KEN,AUS,2018.0,3,6,-3
GHA,VNM,2018.0,1,1,0
NZL,ESP,2019.0,3,10,-7
BEL,ETH,2023.0,10,14,-4
MEX,IND,2017.0,7,21,-14
TZA,IND,2017.0,3,7,-4
RUS,IND,2017.0,6,10,-4
SWE,KOR,2015.0,10,13,-3
NOR,IRL,2021.0,9,1,8
AUT,IRL,2022.0,6,6,0
FIN,LTU,2021.0,1,6,-5
MAC,JPN,2022.0,1,1,0
ZAF,UGA,2015.0,9,6,3
AUT,LUX,2019.0,3,1,2
AUT,LUX,2021.0,3,3,0
ISR,ESP,2021.0,8,14,-6
NZL,DEU,1998.0,9,11,-2
THA,CHE,2019.0,6,6,0
EGY,OMN,2018.0,2,7,-5
RUS,SRB,2015.0,6,11,-5
SAU,SDN,2015.0,9,17,-8
SEN,BEL,2002.0,1,1,0
TUR,PSE,2019.0,6,1,5
KGZ,TUR,2019.0,1,3,-2
VNM,GBR,2019.0,14,60,-46
NPL,KOR,2021.0,8,18,-10
PAN,CHE,2016.0,2,2,0
GBR,MUS,2020.0,3,1,2
SWE,EST,2009.0,11,4,7
OMN,SWE,2021.0,1,1,0
BRB,GBR,2021.0,2,2,0
SAU,DNK,2017.0,1,3,-2
IND,LBY,2018.0,1,4,-3
BEL,BGR,2013.0,3,3,0
ESP,BOL,2016.0,2,5,-3
NOR,ARG,2023.0,1,1,0
RUS,MEX,2019.0,4,7,-3
FIN,IDN,2018.0,4,1,3
PRT,THA,2020.0,3,1,2
ZAF,CAN,2000.0,14,12,2
QAT,CAN,2013.0,4,13,-9
ARE,DNK,2021.0,1,4,-3
GHA,CMR,2019.0,1,2,-1
GBR,USA,2024.0,7,5,2
PSE,QAT,2020.0,4,1,3
ISR,MEX,2018.0,1,6,-5
MNG,KOR,2018.0,6,16,-10
COL,ITA,2015.0,3,18,-15
CHN,DZA,2021.0,11,2,9
CHN,NAM,2016.0,1,1,0
DNK,PER,2017.0,1,1,0
ARG,CHL,2012.0,22,19,3
NZL,TWN,2015.0,1,5,-4
LAO,CHE,2023.0,2,1,1
DEU,NPL,2020.0,3,2,1
NZL,IRL,2020.0,9,9,0
BFA,SEN,2017.0,7,4,3
MYS,SGP,2023.0,19,12,7
DEU,MMR,2015.0,1,1,0
BEL,PAK,2020.0,4,4,0
OMN,KOR,2022.0,2,2,0
TUR,NGA,2022.0,7,3,4
NLD,PHL,2020.0,9,3,6
GHA,EGY,2020.0,2,1,1
CHE,TUR,2022.0,10,23,-13
ARE,KOR,2023.0,2,14,-12
AUT,ISR,2020.0,2,8,-6
ZAF,BRA,2019.0,6,14,-8
MAC,PHL,2019.0,2,1,1
POL,BGR,2019.0,3,2,1
ROU,IND,2018.0,3,3,0
HRV,SVK,2021.0,1,1,0
SAU,ITA,2016.0,10,18,-8
USA,NCL,2016.0,1,2,-1
UKR,AUT,2017.0,6,5,1
CZE,MEX,2018.0,2,4,-2
SGP,PHL,2015.0,3,1,2
ARG,CHN,2020.0,2,1,1
IND,KOR,2000.0,9,2,7
CHL,CUB,2015.0,2,13,-11
FIN,POL,2016.0,6,7,-1
USA,AZE,2020.0,4,3,1
TWN,SDN,2020.0,1,1,0
IRQ,ARE,2021.0,4,3,1
COL,VEN,2023.0,5,3,2
EST,CHE,2019.0,7,4,3
ESP,ETH,2010.0,2,1,1
ISR,IRL,2019.0,6,2,4
ASM,USA,2020.0,3,3,0
MYS,PER,2020.0,2,1,1
SRB,BIH,2020.0,22,16,6
GTM,GBR,2021.0,3,2,1
GHA,THA,2019.0,1,1,0
UGA,DEU,2022.0,6,3,3
VNM,TWN,2015.0,6,24,-18
IND,SVN,2019.0,5,2,3
TWN,NOR,2023.0,1,2,-1
JOR,ZAF,2022.0,1,1,0
IRQ,LBN,2022.0,2,4,-2
GAB,FRA,2021.0,6,6,0
UKR,GBR,2023.0,8,1,7
KEN,JPN,2023.0,7,6,1
POL,LTU,2021.0,1,7,-6
JOR,CHE,2021.0,1,1,0
MEX,BOL,2022.0,2,1,1
KWT,SRB,2019.0,2,2,0
COL,CHE,2008.0,3,2,1
KAZ,KGZ,2020.0,4,3,1
CAN,SRB,2023.0,2,1,1
PAK,IRL,2009.0,3,2,1
BEL,BRA,2011.0,10,15,-5
BEL,ETH,2000.0,1,1,0
BWA,GBR,2022.0,4,7,-3
CHE,NZL,2003.0,7,7,0
CHE,KOR,2018.0,9,14,-5
NLD,NPL,2016.0,2,4,-2
RUS,ESP,2003.0,15,10,5
CAN,PAK,1998.0,3,1,2
CAN,PAK,1999.0,4,3,1
IND,MEX,1999.0,4,3,1
ITA,AUS,2000.0,20,20,0
AUT,CZE,2006.0,6,11,-5
JPN,RUS,2019.0,11,15,-4
DEU,IDN,2000.0,6,3,3
GBR,LUX,2012.0,15,3,12
BRB,USA,1999.0,2,1,1
SWE,JPN,2011.0,25,44,-19
BGD,CAN,2004.0,5,1,4
DEU,TWN,2002.0,10,3,7
CAN,SEN,2020.0,7,2,5
NZL,BEL,1998.0,1,1,0
KOR,NZL,2001.0,3,2,1
ISR,SWE,1999.0,4,2,2
GRC,JPN,2010.0,4,5,-1
NLD,HRV,2009.0,2,1,1
TUR,AZE,2014.0,9,1,8
CAN,JOR,2002.0,3,3,0
USA,COG,1999.0,2,1,1
BEL,ESP,1998.0,17,15,2
SAU,TUN,2006.0,1,2,-1
USA,BGR,2002.0,8,31,-23
PAK,DEU,2003.0,4,2,2
POL,EGY,2023.0,2,2,0
JPN,BRA,2002.0,19,9,10
BOL,ESP,1999.0,1,1,0
GBR,KEN,1998.0,10,10,0
PRT,PRI,2012.0,1,1,0
CHN,PRT,2003.0,6,4,2
USA,KWT,2013.0,12,7,5
ESP,BEL,2004.0,16,25,-9
NOR,SWE,1997.0,20,25,-5
GBR,HRV,2002.0,4,5,-1
HRV,GBR,2003.0,5,1,4
BEL,LUX,1998.0,4,3,1
JPN,ESP,2003.0,12,4,8
HKG,MAC,2019.0,12,6,6
USA,OMN,1999.0,5,1,4
NER,BEL,2015.0,1,4,-3
HKG,IND,1997.0,2,2,0
KEN,PER,2013.0,4,2,2
EST,VNM,2021.0,1,2,-1
EGY,BGD,2015.0,1,2,-1
ESP,SLV,2017.0,3,1,2
KAZ,NOR,2021.0,1,4,-3
PAK,FRA,2019.0,14,20,-6
URY,CAN,2008.0,1,1,0
AUT,IRL,2018.0,3,3,0
VNM,KOR,2002.0,8,1,7
IRN,IND,2015.0,12,31,-19
TUN,AUT,2008.0,1,1,0
USA,SVK,2016.0,9,15,-6
KOR,BGD,2008.0,7,10,-3
IDN,PHL,2021.0,5,7,-2
JOR,YEM,2019.0,3,1,2
IND,ISR,2004.0,13,7,6
PRT,TUR,2023.0,2,2,0
IND,BGD,2010.0,10,10,0
DZA,RUS,2021.0,1,4,-3
MAR,ESP,2021.0,13,22,-9
HKG,CHE,2014.0,5,4,1
PRT,RUS,2009.0,5,8,-3
CHE,EGY,2012.0,2,6,-4
HKG,NZL,2011.0,3,2,1
DNK,ZAF,2021.0,4,3,1
SVK,ITA,2007.0,2,3,-1
NGA,BRA,2021.0,2,3,-1
MLI,MAR,2012.0,1,1,0
CHN,GRC,2021.0,3,6,-3
THA,SGP,2022.0,1,10,-9
ITA,MAR,2023.0,4,4,0
IRQ,IND,2020.0,7,19,-12
IND,KAZ,2021.0,2,1,1
UZB,IND,2022.0,4,3,1
CAN,UGA,2021.0,1,3,-2
MYS,TUR,2022.0,15,4,11
JOR,LBY,2021.0,4,1,3
RUS,TUR,1997.0,5,1,4
TUR,KAZ,2001.0,1,1,0
PRT,BRA,1997.0,14,19,-5
NLD,ISR,2000.0,6,8,-2
SRB,HRV,2000.0,12,2,10
USA,ARM,2015.0,6,8,-2
ESP,ZAF,2007.0,1,4,-3
KHM,GBR,2003.0,1,2,-1
CUB,CHL,2010.0,13,3,10
LBN,CAN,1999.0,4,2,2
BGR,JPN,2002.0,11,9,2
BGR,ESP,2000.0,5,4,1
BGR,RUS,2012.0,2,1,1
SWE,UKR,2001.0,3,10,-7
MWI,USA,1998.0,2,3,-1
USA,FJI,2007.0,4,4,0
JPN,CZE,2003.0,10,8,2
MEX,POL,1999.0,2,2,0
FIN,CHE,1998.0,7,8,-1
EST,ESP,2004.0,1,2,-1
ISR,DNK,2009.0,5,3,2
BOL,FRA,1998.0,4,4,0
ISR,IND,2005.0,10,15,-5
LBN,BRA,2019.0,1,1,0
CZE,BRA,2002.0,2,1,1
ISR,RUS,2014.0,5,12,-7
ZAF,CAN,2023.0,19,10,9
COD,COG,1997.0,1,3,-2
PRT,SWE,1998.0,3,5,-2
SWE,PRT,2000.0,4,4,0
HUN,NLD,2004.0,9,4,5
ISR,BRA,2003.0,1,3,-2
RUS,CZE,2011.0,10,5,5
SEN,MDG,2014.0,2,1,1
IND,TTO,2017.0,2,4,-2
AUS,HUN,1999.0,1,2,-1
HKG,IND,2005.0,3,3,0
VEN,DEU,2006.0,2,4,-2
SGP,NLD,2010.0,7,8,-1
FIN,ARE,2001.0,1,1,0
ARM,COL,2012.0,3,2,1
RUS,ARM,2008.0,3,5,-2
FRA,GIN,2015.0,2,4,-2
FRA,NZL,1997.0,3,8,-5
GBR,ZMB,2010.0,4,3,1
ITA,VNM,2000.0,1,1,0
CHN,FIN,1999.0,6,5,1
NZL,AUT,2010.0,3,4,-1
KOR,SGP,2005.0,4,11,-7
SWE,LTU,1999.0,5,1,4
GUY,USA,2006.0,2,3,-1
GBR,SDN,2009.0,5,3,2
ITA,BLR,2014.0,1,2,-1
NPL,USA,2005.0,6,5,1
USA,SVN,2001.0,6,15,-9
USA,SVN,2004.0,14,13,1
BGD,AUS,2001.0,1,1,0
DEU,GEO,2002.0,2,3,-1
GEO,CHN,2016.0,2,1,1
UKR,KAZ,2014.0,1,1,0
KAZ,UKR,2018.0,2,1,1
IRL,BHR,2023.0,2,1,1
NOR,PRT,2008.0,2,1,1
ISR,PSE,2002.0,9,3,6
MCO,DEU,2018.0,3,1,2
MAR,USA,2013.0,6,10,-4
POL,DNK,2000.0,6,1,5
UZB,USA,2011.0,5,3,2
FRA,SVN,2006.0,1,1,0
SRB,MKD,2008.0,26,20,6
TWN,IND,1999.0,2,22,-20
USA,ZMB,2003.0,5,3,2
ARE,GBR,2004.0,5,15,-10
CAN,DZA,2000.0,1,2,-1
NLD,EGY,1998.0,2,1,1
BRB,USA,2007.0,1,3,-2
THA,NLD,1998.0,1,1,0
VNM,AUS,2003.0,2,6,-4
AUS,VNM,2004.0,2,2,0
USA,PAN,1997.0,6,5,1
ARM,ITA,2020.0,1,2,-1
ESP,CUB,2004.0,33,12,21
HUN,CHN,2015.0,4,1,3
USA,YEM,2003.0,2,2,0
KHM,KOR,2012.0,2,1,1
CAN,BRB,2019.0,1,1,0
PRT,LUX,2014.0,4,1,3
IDN,BRA,2005.0,1,1,0
GRL,NOR,2016.0,1,1,0
GBR,BGR,2012.0,7,11,-4
HRV,NLD,2004.0,2,3,-1
KEN,DEU,2005.0,3,5,-2
USA,PNG,2002.0,4,2,2
IDN,USA,2004.0,15,25,-10
KEN,NLD,2001.0,3,2,1
ISR,CYP,2015.0,2,1,1
CUB,ESP,2005.0,28,21,7
NLD,GRC,1997.0,9,7,2
SWE,KEN,2000.0,1,2,-1
MAR,PRT,2010.0,1,2,-1
RUS,ROU,2021.0,2,3,-1
AUS,HUN,1998.0,1,1,0
DEU,TWN,2005.0,12,9,3
CHN,PHL,2015.0,3,4,-1
NOR,IRL,2019.0,5,6,-1
JAM,GBR,2000.0,8,3,5
AUT,RUS,2007.0,7,8,-1
ROU,GBR,1999.0,8,12,-4
FIN,TWN,2016.0,2,4,-2
SGP,THA,2013.0,3,14,-11
SGP,MYS,2022.0,21,34,-13
PRI,CAN,2011.0,3,1,2
JPN,HKG,2014.0,13,9,4
NOR,IRL,2011.0,3,1,2
IRL,NOR,2012.0,3,1,2
POL,IND,2011.0,5,1,4
CMR,GBR,2011.0,4,4,0
AUT,ITA,2008.0,17,33,-16
CUB,BEL,2011.0,4,1,3
RUS,IND,2016.0,5,12,-7
KEN,VNM,2023.0,1,2,-1
BRA,CHE,2011.0,11,9,2
BGD,BEL,2018.0,7,5,2
RUS,MDA,2010.0,2,2,0
GBR,FJI,2016.0,3,4,-1
URY,GBR,2017.0,2,7,-5
GBR,EST,2022.0,14,11,3
SRB,DNK,1999.0,3,4,-1
FRA,TCD,2012.0,2,1,1
AUT,FIN,2011.0,6,16,-10
GBR,KWT,2013.0,14,5,9
AUS,MEX,2011.0,8,13,-5
CHL,DNK,2013.0,3,2,1
CZE,FIN,2010.0,8,4,4
TUR,JPN,2013.0,6,13,-7
DEU,BGD,2018.0,14,11,3
LUX,BEL,2007.0,9,9,0
SVK,HUN,2012.0,4,7,-3
BHR,ARE,2020.0,3,1,2
RUS,SGP,2018.0,6,5,1
SWE,GRC,2000.0,6,7,-1
AUS,MEX,2021.0,8,12,-4
BEL,SRB,2016.0,4,7,-3
SRB,FRA,2019.0,5,4,1
ISR,ARG,2017.0,1,2,-1
MEX,GRC,2019.0,1,1,0
USA,IND,2024.0,10,8,2
ISR,JPN,2011.0,7,5,2
TWN,VNM,2013.0,8,3,5
BFA,MLI,2020.0,3,1,2
MYS,OMN,2012.0,6,2,4
KEN,GBR,2008.0,9,16,-7
LBN,EGY,2014.0,3,6,-3
MYS,HKG,2015.0,6,3,3
KOR,HRV,2019.0,3,1,2
CAN,KEN,2023.0,7,7,0
FIN,MYS,2014.0,4,3,1
ITA,QAT,2017.0,4,6,-2
EGY,SWE,2014.0,5,4,1
BEL,SVK,2019.0,2,2,0
USA,PNG,2012.0,2,1,1
SWE,MYS,2010.0,2,1,1
ARG,PRI,2011.0,2,2,0
JPN,NPL,2012.0,7,5,2
CAN,LKA,2019.0,7,4,3
SWE,KHM,2021.0,1,1,0
NGA,DEU,2014.0,9,8,1
BEL,BDI,2016.0,1,1,0
CAN,BHR,2021.0,2,2,0
THA,SWE,2015.0,8,11,-3
HKG,NLD,2016.0,11,4,7
KOR,BRA,2014.0,6,2,4
UKR,EST,2016.0,2,2,0
ZAF,GHA,2013.0,5,6,-1
USA,ZMB,2013.0,16,17,-1
NPL,JPN,2017.0,3,15,-12
OMN,BHR,2022.0,6,1,5
VNM,THA,2015.0,6,16,-10
NPL,JPN,2016.0,8,10,-2
DNK,EGY,2021.0,3,2,1
LUX,CAN,2023.0,5,1,4
MNG,DEU,2019.0,2,3,-1
DNK,NZL,2017.0,8,6,2
RUS,AZE,2015.0,7,5,2
BEN,CMR,2019.0,5,2,3
BEN,CMR,2021.0,2,2,0
KOR,NZL,2015.0,2,5,-3
CMR,CHN,2011.0,2,2,0
KOR,TZA,2015.0,2,1,1
NZL,ECU,2020.0,3,2,1
BEL,COL,2014.0,6,3,3
IRL,AUT,2023.0,6,2,4
CAN,PRT,1999.0,4,9,-5
DEU,PRY,2015.0,3,1,2
NPL,IND,2005.0,13,25,-12
JPN,GHA,2015.0,4,2,2
AUT,POL,2006.0,6,6,0
MAR,BEL,2014.0,5,2,3
IRN,KOR,2013.0,11,9,2
FRA,TWN,2023.0,7,5,2
MYS,LKA,2019.0,5,6,-1
EST,RUS,2016.0,5,1,4
RUS,ISR,2016.0,5,10,-5
ZAF,OMN,2014.0,1,1,0
JPN,TZA,2021.0,5,2,3
KWT,ARE,2018.0,5,4,1
SAU,KWT,2023.0,2,4,-2
DEU,NGA,2020.0,8,10,-2
DNK,JPN,2013.0,5,8,-3
BGR,GRC,2003.0,5,1,4
FIN,CHL,2020.0,2,1,1
IDN,CAN,2017.0,1,3,-2
ARG,CRI,2016.0,1,1,0
HKG,DEU,1997.0,5,3,2
DEU,ISL,2017.0,10,3,7
USA,HND,2007.0,2,3,-1
JPN,DNK,2020.0,12,9,3
ZAF,IRL,2022.0,15,5,10
KAZ,IRQ,2021.0,1,1,0
ETH,BEL,2007.0,3,1,2
DEU,MKD,2017.0,3,5,-2
KNA,USA,2008.0,2,3,-1
HRV,CHE,2012.0,7,4,3
SGP,PAK,2011.0,2,1,1
ISL,IRL,2018.0,1,1,0
OMN,IRL,2022.0,1,2,-1
ARE,LBN,2019.0,4,2,2
LBN,CYP,2022.0,2,2,0
MKD,BIH,2018.0,1,2,-1
ESP,QAT,2018.0,6,1,5
ISL,GBR,2022.0,5,9,-4
JPN,PER,2021.0,3,2,1
AUS,NPL,2023.0,6,7,-1
UGA,FRA,2014.0,9,1,8
NLD,KEN,2012.0,9,5,4
SVK,NLD,2022.0,6,1,5
BRA,POL,2017.0,6,3,3
UKR,EST,2018.0,3,2,1
GBR,IDN,2000.0,4,7,-3
BEL,COD,2023.0,6,4,2
KWT,MYS,2022.0,4,2,2
NIC,ESP,2011.0,1,2,-1
TZA,NGA,2022.0,2,2,0
QAT,ITA,2020.0,4,6,-2
ROU,GBR,1998.0,8,5,3
NGA,PRT,2021.0,1,1,0
GHA,PRT,2023.0,2,2,0
LAO,GBR,2022.0,2,1,1
UKR,ITA,2013.0,6,1,5
ECU,ESP,2007.0,3,2,1
BEL,TUN,2013.0,6,5,1
KAZ,UKR,2022.0,3,4,-1
ARE,AUS,2018.0,16,24,-8
ECU,COL,2023.0,2,5,-3
ALB,SRB,2023.0,3,7,-4
BLZ,USA,2022.0,4,2,2
EGY,CHE,2022.0,2,6,-4
THA,AUT,2018.0,3,5,-2
NGA,ZWE,2003.0,2,2,0
ITA,ETH,2020.0,7,7,0
FIN,ITA,2021.0,16,31,-15
JPN,KEN,2001.0,4,6,-2
EST,FRA,2001.0,1,1,0
SRB,BGR,2015.0,2,1,1
BGR,USA,2018.0,8,16,-8
JOR,DEU,2009.0,5,9,-4
CHL,CHE,2008.0,6,2,4
MAC,PRT,2017.0,1,2,-1
TUR,CHE,2001.0,2,7,-5
CAN,POL,1998.0,7,12,-5
GHA,ETH,2022.0,1,1,0
GBR,PER,2000.0,2,1,1
SWE,SAU,2017.0,10,5,5
USA,BEN,2009.0,1,4,-3
SEN,MDG,2001.0,2,4,-2
GBR,CMR,2016.0,4,3,1
LUX,MEX,2017.0,1,1,0
EGY,ESP,2004.0,1,3,-2
USA,QAT,2005.0,9,4,5
FRA,IDN,2001.0,3,5,-2
JPN,MEX,2002.0,11,3,8
CAN,TWN,1997.0,7,2,5
MDA,USA,2002.0,3,2,1
CAN,TUN,2011.0,7,10,-3
MDA,ROU,2002.0,1,2,-1
ZAF,LSO,2022.0,6,3,3
TZA,USA,2005.0,5,10,-5
LKA,ITA,2018.0,1,2,-1
GAB,USA,2023.0,3,2,1
BRA,IRL,2014.0,6,6,0
JAM,CAN,1999.0,1,1,0
ROU,AUS,2004.0,1,1,0
MOZ,UGA,2004.0,1,1,0
MAR,MLI,2012.0,1,1,0
USA,BWA,2005.0,5,8,-3
FRA,MKD,2013.0,1,2,-1
COG,BEL,2003.0,1,7,-6
TZA,ZAF,2001.0,2,2,0
JAM,USA,2005.0,6,3,3
GBR,TZA,2009.0,11,9,2
ESP,AND,2017.0,5,2,3
GBR,ZMB,2000.0,4,3,1
JPN,NZL,2007.0,10,8,2
NGA,ZWE,2013.0,1,1,0
FRA,SYR,2008.0,4,5,-1
MMR,GBR,2018.0,1,1,0
BHR,ARE,2007.0,2,2,0
ROU,BEL,2005.0,6,8,-2
NOR,ARE,2023.0,3,2,1
BGD,AUS,2004.0,4,5,-1
COG,FRA,2004.0,3,5,-2
DNK,BEL,2002.0,11,12,-1
YEM,GBR,1998.0,1,1,0
DEU,ARM,1997.0,4,5,-1
AUS,KEN,2004.0,3,1,2
ESP,PRI,2006.0,5,2,3
ZAF,MEX,2011.0,1,1,0
ITA,LUX,2000.0,1,1,0
SVK,ITA,1999.0,3,3,0
DNK,KEN,2012.0,2,2,0
NLD,KEN,2002.0,3,4,-1
IND,FJI,2005.0,2,1,1
PER,ECU,2016.0,3,8,-5
NLD,SGP,2009.0,11,10,1
IND,ARE,2006.0,7,1,6
SWE,GRC,2010.0,7,9,-2
TUR,SWE,2015.0,9,13,-4
IND,ERI,2007.0,3,2,1
DEU,PER,2002.0,3,1,2
SWE,THA,2012.0,7,4,3
USA,BFA,2014.0,3,2,1
MOZ,BRA,2012.0,3,3,0
DJI,FRA,2011.0,1,4,-3
FSM,USA,2002.0,1,2,-1
TZA,BEL,2008.0,1,2,-1
DEU,GHA,2008.0,4,1,3
ISR,ITA,2009.0,15,12,3
FRA,NGA,2001.0,1,1,0
PRT,POL,2012.0,8,10,-2
ESP,BGR,2000.0,4,5,-1
ALB,FRA,2013.0,2,2,0
GBR,GEO,2006.0,3,4,-1
NZL,CHN,2004.0,5,2,3
FIN,UKR,2002.0,3,2,1
LBN,FRA,2006.0,15,32,-17
SDN,GBR,2022.0,4,1,3
MWI,KEN,2002.0,1,1,0
DEU,ARG,2005.0,11,23,-12
PRI,MEX,2015.0,3,1,2
NLD,HUN,2001.0,3,9,-6
MWI,NLD,2006.0,1,1,0
CAN,HUN,2007.0,7,12,-5
JOR,EGY,2005.0,2,1,1
PYF,AUS,2020.0,2,1,1
CAN,VEN,2012.0,3,5,-2
EST,USA,2005.0,1,9,-8
LUX,ESP,2016.0,6,8,-2
POL,PRT,2008.0,3,1,2
AND,ESP,2019.0,2,3,-1
ESP,AND,2022.0,7,3,4
NPL,GBR,2019.0,6,11,-5
ECU,DEU,2006.0,1,1,0
BEL,SWE,2016.0,21,30,-9
CHN,SWE,2006.0,28,46,-18
HUN,ESP,2014.0,5,4,1
ZWE,COG,2009.0,3,2,1
LBY,USA,2013.0,2,7,-5
POL,LTU,2019.0,3,1,2
BLR,JPN,1998.0,1,1,0
NLD,IRN,2009.0,13,20,-7
ITA,SRB,1999.0,2,4,-2
SGP,SAU,2007.0,2,1,1
GBR,SDN,2021.0,4,5,-1
MEX,VEN,2007.0,10,4,6
FRA,NGA,2015.0,3,1,2
GEO,RUS,2010.0,9,2,7
SVN,ITA,2008.0,4,6,-2
NOR,ITA,2005.0,3,13,-10
NOR,ISL,2017.0,5,5,0
GHA,NGA,2011.0,3,4,-1
SRB,IND,2006.0,3,2,1
NAM,GBR,2006.0,2,1,1
ISR,NLD,2007.0,9,6,3
ITA,HUN,2015.0,8,7,1
CHN,IRN,2013.0,2,13,-11
COG,FRA,2015.0,7,10,-3
KOR,IND,2001.0,4,24,-20
SYR,SAU,2019.0,4,1,3
ITA,ARG,2013.0,10,15,-5
BEL,BRA,2009.0,9,14,-5
FRA,BGR,2019.0,4,6,-2
DNK,EGY,2009.0,4,1,3
MEX,AUS,1997.0,3,1,2
CAN,ROU,2006.0,6,3,3
HRV,ESP,2019.0,6,6,0
JPN,ZMB,2017.0,4,1,3
SWE,IRQ,2018.0,5,2,3
ISR,CHN,2004.0,10,4,6
ITA,CUB,2007.0,2,4,-2
PRT,ITA,2004.0,6,13,-7
HKG,ZAF,2016.0,1,1,0
BRA,RUS,2020.0,10,4,6
BGD,NLD,2022.0,4,1,3
GBR,BGR,2005.0,8,9,-1
USA,MOZ,2023.0,5,3,2
USA,MDG,2012.0,6,1,5
EGY,YEM,2012.0,7,10,-3
NLD,ISR,2006.0,5,9,-4
BHR,USA,2012.0,1,3,-2
ROU,CHE,2012.0,10,5,5
CAN,LBN,2017.0,5,17,-12
IRN,QAT,2017.0,3,1,2
LTU,USA,2011.0,6,8,-2
NOR,KEN,2017.0,3,1,2
ROU,CAN,2018.0,6,2,4
CUB,SWE,2015.0,2,1,1
ISR,BEL,2010.0,2,6,-4
GUY,USA,2000.0,3,2,1
BEL,BOL,2008.0,3,1,2
USA,ARM,2008.0,3,2,1
ITA,IND,2004.0,7,15,-8
GBR,MUS,2007.0,3,1,2
MYS,SWE,2010.0,1,2,-1
GRL,DNK,2022.0,11,6,5
IRL,SVK,2017.0,2,1,1
EGY,LBY,2011.0,2,6,-4
FJI,NCL,2022.0,2,2,0
TUR,FIN,2012.0,5,1,4
FIN,TUR,2016.0,3,1,2
BGD,MYS,2005.0,5,5,0
MAC,HKG,2014.0,5,12,-7
SGP,NZL,2011.0,10,7,3
GBR,CYM,2009.0,1,2,-1
LKA,DEU,2012.0,3,4,-1
FRA,KEN,2006.0,3,1,2
LKA,USA,2011.0,10,13,-3
TUN,CHN,2017.0,3,1,2
CHN,TUN,2023.0,2,1,1
NAM,ZWE,2016.0,1,1,0
MAR,CAN,2003.0,6,5,1
NLD,EST,2018.0,4,4,0
HRV,USA,2009.0,8,21,-13
GRC,DNK,2008.0,5,5,0
SAU,ROU,2013.0,1,1,0
MEX,COL,2006.0,9,7,2
RUS,NLD,2010.0,14,7,7
NOR,ETH,2010.0,4,2,2
LIE,DEU,2010.0,1,3,-2
MAR,BEL,2004.0,2,6,-4
KOR,HKG,2009.0,1,6,-5
THA,AUT,2016.0,6,4,2
OMN,TUN,2008.0,3,1,2
ZMB,ZAF,2009.0,2,2,0
USA,BRB,2012.0,6,2,4
LUX,CHE,2010.0,4,4,0
IRN,TUR,2005.0,2,1,1
FLK,AUS,2002.0,1,1,0
HRV,SGP,2014.0,1,1,0
BEL,MEX,2021.0,6,11,-5
USA,TUN,1999.0,4,3,1
IND,PAN,2013.0,2,1,1
CZE,LUX,2014.0,1,1,0
COL,SWE,2010.0,1,2,-1
NLD,MYS,2009.0,2,3,-1
PAK,CYP,2018.0,2,1,1
URY,ESP,2006.0,9,7,2
IRN,AUS,2005.0,14,23,-9
CHL,NLD,2001.0,3,2,1
KOR,KEN,2018.0,3,1,2
MDG,ZAF,2013.0,1,1,0
YEM,DEU,2022.0,2,1,1
EGY,MYS,2018.0,9,7,2
IRQ,MAR,2020.0,1,1,0
AUS,ZWE,2014.0,3,1,2
DEU,LBN,2021.0,3,11,-8
NZL,QAT,2017.0,1,2,-1
MOZ,SWE,2014.0,1,2,-1
SWE,SAU,2016.0,5,2,3
CHN,MLI,2018.0,5,1,4
NOR,TUR,2014.0,5,4,1
ZAF,FIN,2017.0,2,6,-4
SVN,CHN,2020.0,3,1,2
TUN,DEU,2016.0,5,3,2
MYS,DNK,2018.0,4,3,1
LBN,ESP,2019.0,2,3,-1
ESP,TUN,2012.0,11,4,7
KOR,ISR,2018.0,5,9,-4
PAK,AUT,2012.0,4,21,-17
NZL,ARE,2014.0,3,2,1
CHN,MNG,2013.0,4,7,-3
IRN,CHN,2005.0,3,1,2
COL,ITA,2014.0,9,11,-2
CMR,COG,2014.0,1,1,0
RUS,HUN,2014.0,2,2,0
SWE,GHA,2017.0,2,1,1
HUN,AUS,2014.0,6,2,4
USA,MAC,2009.0,5,1,4
MEX,ISR,2014.0,2,1,1
CAN,COL,2023.0,6,14,-8
QAT,LBN,2012.0,1,4,-3
NZL,ZAF,2020.0,6,20,-14
FRA,GIN,2014.0,5,2,3
GIN,FRA,2015.0,4,2,2
MKD,USA,2017.0,3,4,-1
POL,BGR,2021.0,1,3,-2
PRT,CHE,2013.0,11,18,-7
IRQ,SWE,2011.0,2,4,-2
SVN,ESP,2016.0,3,5,-2
PRI,COL,2014.0,5,3,2
SDN,ZAF,2018.0,2,5,-3
TUR,NOR,2013.0,3,2,1
DEU,CUB,2004.0,4,4,0
THA,SGP,2017.0,6,5,1
GHA,CHE,2003.0,2,3,-1
MYS,IRL,2015.0,3,8,-5
NZL,HKG,2018.0,4,11,-7
MEX,ISR,2015.0,3,2,1
KHM,FRA,2011.0,2,1,1
NZL,TWN,2014.0,2,2,0
LTU,DEU,2014.0,4,4,0
BRA,BOL,2021.0,3,3,0
USA,BGD,1997.0,7,8,-1
SWE,ISL,2007.0,14,7,7
ITA,KEN,2018.0,7,4,3
NOR,MEX,2014.0,3,3,0
ESP,EST,2012.0,2,5,-3
PAK,NOR,2009.0,2,1,1
KWT,USA,2009.0,8,19,-11
TUR,NGA,2017.0,4,4,0
BHS,CAN,2020.0,2,1,1
EGY,LBY,2019.0,3,5,-2
COD,BEL,2017.0,3,11,-8
UGA,DEU,2018.0,4,1,3
ZWE,NGA,2013.0,1,1,0
TUR,ARE,2020.0,7,2,5
MOZ,ITA,2016.0,1,1,0
NOR,AUT,2021.0,8,25,-17
QAT,SGP,2015.0,2,6,-4
PRT,CHE,2003.0,5,5,0
URY,CAN,2014.0,1,1,0
PAK,IND,2006.0,10,6,4
FRA,KAZ,2022.0,3,1,2
CHE,UGA,2015.0,5,2,3
USA,KGZ,2020.0,3,4,-1
KOR,BEL,2010.0,3,4,-1
IRN,DNK,2008.0,4,2,2
FRA,MYS,2020.0,7,9,-2
JPN,TZA,2019.0,6,1,5
GTM,ESP,2023.0,4,1,3
IND,RUS,2017.0,10,6,4
USA,ASM,2020.0,3,3,0
CHN,ROU,2017.0,3,2,1
COG,CHE,2021.0,9,5,4
SAU,BHR,2018.0,6,4,2
COG,ZWE,2023.0,3,5,-2
NGA,HKG,2019.0,5,2,3
AUS,MWI,2019.0,1,2,-1
IND,CMR,2019.0,5,2,3
SAU,MYS,2000.0,1,1,0
HUN,BEL,2020.0,4,6,-2
GRC,DNK,2001.0,4,5,-1
EGY,QAT,1997.0,3,5,-2
USA,VIR,2012.0,2,2,0
IDN,PHL,2019.0,4,4,0
GAB,FRA,2019.0,7,16,-9
MAR,CZE,2022.0,2,2,0
ITA,SGP,2023.0,5,1,4
NGA,BEL,2016.0,3,2,1
MLI,BFA,2014.0,1,2,-1
AUS,MEX,2009.0,4,8,-4
PRY,BRA,2020.0,3,13,-10
DNK,GRL,2022.0,6,11,-5
GMB,PAK,2022.0,2,1,1
BEL,COG,2022.0,2,3,-1
COD,CMR,2023.0,1,1,0
MNE,SRB,2015.0,7,10,-3
MAR,PRT,2023.0,3,1,2
CHE,NPL,2022.0,1,2,-1
GRC,SRB,2019.0,4,3,1
MMR,GBR,2022.0,3,3,0
MYS,BGD,2009.0,8,14,-6
IND,COL,2022.0,2,1,1
HKG,NGA,2023.0,2,4,-2
NGA,CMR,2021.0,2,6,-4
DNK,SAU,2018.0,3,1,2
ZAF,NAM,2023.0,12,5,7
IND,MAR,2021.0,4,3,1
ISR,CHE,2005.0,10,8,2
AUT,THA,2012.0,8,4,4
BLR,USA,2008.0,5,6,-1
ARG,ISR,2019.0,2,2,0
POL,UKR,2005.0,7,20,-13
UGA,KEN,2005.0,2,3,-1
KEN,ZWE,2012.0,2,1,1
BGR,CHE,2006.0,5,3,2
SWE,EST,2011.0,13,5,8
CZE,SWE,1999.0,5,5,0
NAM,USA,2020.0,1,10,-9
JPN,PHL,2007.0,10,18,-8
NZL,GRC,2017.0,2,1,1
NCL,NZL,2013.0,3,1,2
PHL,AUS,2007.0,3,12,-9
USA,GUY,2003.0,3,2,1
NLD,SAU,2006.0,3,1,2
MMR,GBR,2016.0,1,1,0
SAU,OMN,2021.0,6,3,3
CZE,SVN,2007.0,5,1,4
CZE,UKR,2019.0,5,11,-6
NLD,IDN,2003.0,11,6,5
CHE,CMR,2006.0,2,4,-2
SVN,SRB,2011.0,11,5,6
COG,BEL,2013.0,7,7,0
IRL,HRV,2007.0,1,1,0
JPN,LKA,2011.0,11,5,6
THA,FRA,2004.0,2,9,-7
CHL,CHE,2004.0,2,6,-4
ARE,SAU,2009.0,6,8,-2
ARG,COL,2003.0,2,1,1
IRL,BGR,2010.0,2,1,1
SRB,ROU,2008.0,2,1,1
BHS,USA,2018.0,2,3,-1
NOR,CYP,2016.0,1,1,0
TUN,CAN,2008.0,7,10,-3
JOR,DEU,2011.0,7,11,-4
GHA,USA,2007.0,8,10,-2
GBR,LKA,2006.0,10,5,5
CAF,FRA,2010.0,1,2,-1
LTU,SWE,2020.0,8,7,1
HUN,POL,2002.0,3,5,-2
BEL,TZA,2004.0,1,1,0
BGD,OMN,2016.0,2,1,1
BRA,MYS,2010.0,2,2,0
USA,BOL,2007.0,2,1,1
ITA,KEN,2016.0,4,1,3
IND,KEN,1999.0,1,2,-1
ARE,GBR,2001.0,6,19,-13
CHE,ISL,2009.0,1,1,0
ESP,KOR,2003.0,2,2,0
RWA,ZAF,2010.0,1,1,0
DNK,PRT,2000.0,4,1,3
FRA,URY,2005.0,5,3,2
ARE,OMN,2011.0,2,3,-1
JPN,UGA,2002.0,1,1,0
HUN,SWE,2004.0,4,11,-7
SVK,AUS,2008.0,3,1,2
BFA,COG,2020.0,3,1,2
BWA,CAN,2017.0,2,2,0
BGD,ETH,2013.0,1,1,0
TWN,IND,1998.0,1,18,-17
FRA,BGR,2011.0,4,9,-5
USA,BHR,2007.0,2,3,-1
POL,FIN,2007.0,2,4,-2
LUX,FRA,2003.0,4,10,-6
BRA,VEN,2013.0,5,9,-4
FRA,SRB,2010.0,3,3,0
KAZ,CHN,2023.0,4,6,-2
SVN,USA,1998.0,4,12,-8
GBR,MDG,2019.0,2,4,-2
THA,FIN,2000.0,2,1,1
TWN,GBR,2000.0,16,27,-11
ISR,CHN,2008.0,6,10,-4
ISR,FIN,1998.0,1,1,0
SWE,KOR,2001.0,6,3,3
JPN,COL,2015.0,1,1,0
TWN,FRA,2000.0,3,7,-4
JPN,HKG,2001.0,9,12,-3
USA,HND,1998.0,1,1,0
DEU,TWN,1997.0,6,5,1
ISR,CHN,2014.0,11,12,-1
BEL,TWN,2004.0,1,3,-2
CHN,KOR,1998.0,10,8,2
TWN,BEL,2013.0,1,5,-4
SGP,NLD,2000.0,1,6,-5
SGP,CAN,1999.0,10,17,-7
CHN,FIN,1998.0,3,3,0
CAN,EST,2002.0,2,1,1
HKG,TWN,2013.0,4,14,-10
DEU,HKG,2006.0,5,11,-6
CHN,ISR,2003.0,7,7,0
BHR,USA,2002.0,2,3,-1
ITA,KOR,2001.0,4,3,1
CMR,GBR,2009.0,3,2,1
CAN,ARE,2005.0,8,5,3
SVN,HRV,2013.0,9,8,1
DNK,THA,2011.0,4,5,-1
TUR,KOR,2015.0,3,6,-3
RUS,BLR,2006.0,11,15,-4
ZAF,COD,2020.0,2,1,1
CHE,IND,2015.0,32,43,-11
IND,TUN,2018.0,1,2,-1
CHN,DNK,2013.0,42,27,15
IDN,AUS,2013.0,17,62,-45
ETH,NOR,2013.0,7,4,3
AUT,CHL,2015.0,5,1,4
ITA,KOR,2019.0,9,11,-2
IRN,AUT,2019.0,16,5,11
LTU,CAN,2018.0,4,3,1
ETH,NLD,2012.0,4,4,0
YEM,USA,2015.0,3,1,2
SWE,BRA,2012.0,8,9,-1
JPN,SDN,2008.0,4,4,0
MYS,KOR,2013.0,8,12,-4
BGD,JPN,2015.0,47,72,-25
TWN,IND,2018.0,51,77,-26
IRN,GBR,2016.0,51,41,10
ZAF,MOZ,2023.0,2,2,0
PRT,MOZ,2012.0,1,1,0
DOM,USA,2011.0,3,5,-2
ARG,BRA,2006.0,27,15,12
SRB,ITA,2018.0,5,6,-1
SAU,IND,2013.0,23,105,-82
KEN,AUS,2020.0,7,8,-1
LBN,GBR,2015.0,3,10,-7
DEU,ROU,2020.0,23,19,4
CHE,IRL,2015.0,12,21,-9
GBR,ZAF,2021.0,65,126,-61
PRT,NLD,2015.0,29,26,3
NZL,NLD,2016.0,23,17,6
ARG,MEX,2023.0,7,4,3
THA,DEU,2009.0,13,20,-7
PAK,USA,2024.0,7,5,2
TUR,CYP,2018.0,134,97,37
TUR,PAK,2012.0,3,5,-2
BOL,USA,2012.0,7,2,5
FRA,KHM,2014.0,5,4,1
BGD,CAN,2009.0,10,8,2
USA,KAZ,2013.0,10,4,6
BRA,IND,2011.0,4,6,-2
MYS,AUS,2013.0,103,103,0
FRA,SEN,2010.0,39,36,3
USA,BOL,2016.0,4,7,-3
NOR,AUS,2017.0,14,26,-12
IND,OMN,2013.0,19,4,15
EGY,DEU,2014.0,33,73,-40
CAN,BGD,2018.0,18,33,-15
BEL,CHE,2021.0,72,60,12
BRA,CHL,2018.0,47,28,19
GBR,KOR,2017.0,67,63,4
SWE,BOL,2014.0,4,3,1
IRL,AUS,2012.0,54,32,22
USA,CYP,2014.0,18,12,6
NOR,CHN,2021.0,45,31,14
CAN,POL,2016.0,25,17,8
ESP,URY,2016.0,17,6,11
MWI,NLD,2013.0,4,1,3
HKG,TWN,2006.0,12,4,8
NLD,FIN,2014.0,18,19,-1
ZAF,ESP,2012.0,4,9,-5
IRN,GBR,2017.0,67,48,19
IRL,IND,2016.0,13,24,-11
IND,IRL,2013.0,14,7,7
DEU,COL,2012.0,10,12,-2
ZAF,CAN,2013.0,19,17,2
MYS,IRN,2015.0,129,45,84
CZE,RUS,2023.0,8,15,-7
BRA,CHN,2014.0,4,6,-2
LKA,USA,2015.0,12,25,-13
KEN,TZA,2013.0,8,6,2
USA,COG,2016.0,4,6,-2
POL,RUS,2018.0,15,16,-1
ETH,MYS,2009.0,3,1,2
FRA,SGP,2011.0,32,11,21
HUN,DEU,2010.0,44,36,8
DEU,HUN,2012.0,44,44,0
HUN,FRA,2013.0,18,14,4
USA,NGA,2011.0,25,44,-19
AZE,IRN,2014.0,1,2,-1
USA,COL,2014.0,96,113,-17
MYS,SGP,2013.0,18,20,-2
IRN,BEL,2014.0,15,17,-2
AUS,CHE,2020.0,69,96,-27
CHL,DEU,2013.0,30,29,1
BEL,SWE,2020.0,27,35,-8
CYP,GBR,2014.0,21,38,-17
HKG,THA,2022.0,4,2,2
CMR,CHN,2014.0,1,1,0
OMN,IND,2018.0,19,43,-24
IDN,USA,2019.0,22,50,-28
USA,IDN,2011.0,26,10,16
CAN,CIV,2020.0,8,1,7
ECU,ESP,2018.0,53,80,-27
ZWE,ZAF,2015.0,31,21,10
JOR,CAN,2012.0,10,20,-10
BGD,JPN,2014.0,54,78,-24
PSE,USA,2014.0,5,11,-6
BEL,JPN,2009.0,14,18,-4
KOR,AUT,2015.0,3,7,-4
NLD,UGA,2017.0,4,4,0
MYS,IRQ,2023.0,52,19,33
AUT,SRB,2016.0,4,4,0
RUS,CHN,2015.0,10,22,-12
DZA,GBR,2014.0,5,9,-4
ZWE,GBR,2014.0,3,3,0
PRT,ZAF,2018.0,4,1,3
KWT,CAN,2016.0,14,9,5
NLD,EST,2020.0,7,2,5
IND,MDV,2020.0,4,1,3
KOR,POL,2018.0,5,5,0
POL,DEU,2019.0,83,103,-20
GBR,AUT,2014.0,76,89,-13
AUT,CHN,2020.0,18,24,-6
ROU,GBR,2017.0,24,16,8
USA,CYP,2015.0,11,9,2
HUN,GRC,2017.0,6,1,5
CUB,ARG,2014.0,6,1,5
GHA,USA,2016.0,18,38,-20
ITA,ISR,2016.0,21,18,3
USA,LAO,2020.0,3,6,-3
ZAF,BEL,2014.0,11,16,-5
ESP,LUX,2014.0,7,4,3
HUN,ITA,2015.0,7,8,-1
BRA,GBR,2015.0,108,97,11
DEU,NGA,2022.0,12,14,-2
SGP,AUS,2015.0,89,68,21
IND,KEN,2017.0,4,1,3
BOL,ESP,2016.0,5,2,3
SWE,BLR,2021.0,2,2,0
BRA,DNK,2021.0,32,8,24
ISL,NOR,2015.0,4,5,-1
GBR,TWN,2013.0,42,22,20
ROU,GBR,2016.0,18,19,-1
THA,PRT,2016.0,2,3,-1
IND,BGD,2013.0,15,15,0
PHL,IND,2020.0,9,4,5
AUT,RUS,2018.0,7,7,0
AUS,JPN,2005.0,39,54,-15
CHN,MEX,2021.0,7,8,-1
ROU,ITA,2012.0,16,9,7
EGY,LBY,2014.0,4,4,0
FRA,MDG,2021.0,14,9,5
SUR,NLD,2017.0,2,1,1
NLD,SUR,2021.0,5,4,1
DEU,LIE,2021.0,8,3,5
CHN,DZA,2015.0,1,1,0
QAT,FRA,2021.0,14,10,4
PRY,ESP,2020.0,6,4,2
FIN,EST,2017.0,17,11,6
CHE,LIE,2020.0,8,4,4
CHE,ARG,2022.0,5,13,-8
SWE,SGP,2013.0,9,15,-6
ITA,NZL,2016.0,8,8,0
ITA,CUB,2022.0,2,6,-4
DNK,THA,2014.0,5,1,4
NOR,NPL,2017.0,7,2,5
DOM,USA,2019.0,3,10,-7
GAB,NLD,2016.0,2,2,0
KWT,QAT,2021.0,2,2,0
ESP,CYP,2020.0,2,3,-1
ESP,PRY,2016.0,6,4,2
AUS,IRN,2023.0,25,80,-55
GBR,VNM,2017.0,61,23,38
DEU,IRL,2019.0,44,42,2
IRQ,SAU,2017.0,1,4,-3
TZA,NOR,2016.0,2,6,-4
SAU,DEU,2017.0,15,37,-22
ETH,USA,2014.0,25,24,1
KOR,CHL,2017.0,6,1,5
RUS,DNK,2005.0,6,5,1
DNK,RUS,2013.0,3,8,-5
MAC,CHN,2015.0,25,73,-48
FIN,LTU,2015.0,1,1,0
PHL,CAN,2013.0,4,4,0
SAU,SDN,2011.0,12,5,7
SDN,SAU,2017.0,24,6,18
RUS,KAZ,2017.0,58,56,2
JOR,ITA,2016.0,4,4,0
FIN,DEU,2019.0,62,66,-4
TUR,SWE,2019.0,28,7,21
ESP,DNK,2018.0,27,34,-7
ITA,AUT,2015.0,46,32,14
CAN,ZAF,2015.0,25,20,5
USA,MYS,2015.0,46,49,-3
HUN,CHE,2015.0,17,12,5
SGP,FRA,2019.0,23,36,-13
ARE,IND,2023.0,24,63,-39
BRA,CHL,2016.0,20,18,2
PRT,ESP,2007.0,49,43,6
CHN,KOR,2018.0,162,254,-92
IRN,ITA,2012.0,33,14,19
USA,ARM,2019.0,8,10,-2
JPN,CHE,2013.0,43,31,12
USA,COL,2015.0,109,136,-27
CHL,MEX,2017.0,17,21,-4
DEU,UKR,2019.0,16,38,-22
FRA,DNK,2018.0,78,47,31
ITA,KAZ,2019.0,2,1,1
CHE,ETH,2019.0,6,3,3
NGA,DEU,2021.0,13,13,0
NLD,IRN,2015.0,22,30,-8
IRN,CHE,2015.0,39,7,32
SWZ,USA,2014.0,2,3,-1
JPN,FIN,1997.0,3,7,-4
BRA,COL,2014.0,28,56,-28
IND,MEX,2022.0,7,13,-6
BRA,FRA,2012.0,100,132,-32
ARE,KWT,2016.0,4,3,1
DZA,FRA,2015.0,51,143,-92
DEU,KEN,2014.0,10,10,0
KEN,FRA,2019.0,6,4,2
FIN,AUS,2019.0,14,16,-2
PRT,PAK,2018.0,1,4,-3
CHN,IDN,2017.0,2,3,-1
VEN,BRA,2014.0,11,2,9
ISR,CHN,2011.0,8,13,-5
KWT,GBR,2012.0,6,13,-7
SWE,HUN,2019.0,5,5,0
BEL,SVN,2020.0,7,6,1
CHN,BEL,2016.0,58,60,-2
NLD,HUN,2011.0,7,12,-5
TZA,BEL,2021.0,3,6,-3
SWE,RWA,2016.0,4,3,1
OMN,CAN,2022.0,7,12,-5
GBR,GMB,2020.0,14,13,1
AUS,POL,2022.0,15,7,8
CHN,ARE,2021.0,17,10,7
ISL,DEU,2016.0,8,4,4
EGY,AUT,2012.0,4,4,0
TUR,CZE,2021.0,16,5,11
CHE,IRL,2014.0,11,11,0
MEX,NLD,2023.0,13,5,8
PAK,THA,2020.0,7,12,-5
ARE,IRN,2021.0,2,3,-1
COL,MEX,2016.0,29,54,-25
NLD,TZA,2022.0,8,2,6
SDN,DEU,2017.0,3,3,0
TUR,DNK,2020.0,14,5,9
BEL,ESP,2017.0,53,81,-28
ZAF,SVN,2019.0,1,2,-1
FIN,EST,2022.0,18,12,6
QAT,USA,2014.0,21,75,-54
IRN,RUS,2018.0,6,5,1
CHN,KEN,2019.0,19,8,11
SWE,MOZ,2019.0,3,1,2
AUS,CHL,2022.0,19,22,-3
ETH,GBR,2018.0,10,5,5
CHE,NLD,1999.0,42,36,6
HUN,IRN,2018.0,2,4,-2
VEN,GBR,2008.0,5,5,0
RUS,UKR,2022.0,49,93,-44
PRT,RUS,2015.0,7,3,4
KOR,UZB,2018.0,3,2,1
ZAF,TWN,2017.0,3,3,0
POL,NLD,2019.0,16,19,-3
NZL,GBR,2023.0,49,61,-12
JPN,DNK,2022.0,11,7,4
TZA,ZAF,2019.0,10,8,2
TUR,SWE,2021.0,35,9,26
POL,VNM,2015.0,6,2,4
CHN,AUT,1998.0,10,5,5
BOL,CHL,2018.0,6,1,5
PER,USA,2022.0,48,30,18
ITA,BGR,2021.0,7,3,4
MEX,ITA,2017.0,16,20,-4
CYP,PAK,2018.0,1,2,-1
THA,FRA,2019.0,14,21,-7
JOR,ARE,2018.0,31,10,21
CZE,LTU,2022.0,5,2,3
SVK,AUT,2005.0,13,4,9
BHR,ARE,2017.0,3,3,0
JOR,SAU,1998.0,1,2,-1
AUS,IRN,2024.0,2,1,1
KOR,BGD,2021.0,44,24,20
SVN,USA,2017.0,14,18,-4
DZA,POL,2018.0,2,1,1
TUN,USA,2013.0,8,6,2
EGY,OMN,1998.0,3,4,-1
DEU,CMR,2015.0,5,6,-1
NLD,SDN,2014.0,3,1,2
PER,COL,2018.0,3,6,-3
BEL,GRC,2018.0,12,22,-10
POL,AUT,2021.0,17,14,3
VEN,URY,2020.0,7,2,5
GBR,SVK,2019.0,6,5,1
CUB,ITA,2011.0,5,1,4
CUB,GBR,2015.0,2,1,1
SGP,CAN,2017.0,30,34,-4
NLD,EGY,2022.0,8,9,-1
CHN,KEN,2021.0,27,6,21
GHA,USA,2017.0,27,45,-18
CHL,ARG,1999.0,4,2,2
ESP,IND,2016.0,15,21,-6
GBR,EST,2020.0,11,8,3
NGA,ITA,2021.0,5,4,1
IRQ,AUS,2015.0,7,5,2
ECU,BRA,2021.0,5,15,-10
KOR,UZB,2022.0,12,3,9
DNK,IRN,2021.0,17,45,-28
HRV,AUT,2016.0,9,5,4
BEL,SGP,2021.0,7,6,1
ITA,BRA,2023.0,24,49,-25
RUS,BRA,2017.0,16,5,11
USA,TUN,2017.0,14,12,2
LBN,ARE,2021.0,20,3,17
AUT,NOR,2023.0,10,2,8
IND,NGA,2021.0,20,8,12
ISR,NLD,2017.0,13,11,2
GRC,EGY,2019.0,1,3,-2
MYS,BGD,2014.0,34,41,-7
PRT,DZA,2018.0,1,3,-2
CHN,MEX,2009.0,3,1,2
ARG,ITA,2022.0,26,11,15
EGY,ESP,2019.0,12,18,-6
SGP,VNM,2019.0,17,3,14
JPN,NZL,2018.0,8,12,-4
FRA,ARE,2017.0,17,3,14
HKG,CHE,2021.0,7,5,2
FRA,MDG,2019.0,12,11,1
CZE,DEU,2015.0,49,48,1
COL,DEU,2012.0,12,10,2
BRA,ISR,2022.0,7,3,4
FRA,PHL,2014.0,4,6,-2
NZL,MYS,2019.0,20,20,0
DEU,SDN,2018.0,4,2,2
CHN,LUX,2022.0,6,5,1
GEO,USA,2001.0,51,48,3
FIN,POL,2020.0,8,4,4
SVN,USA,2018.0,14,17,-3
SAU,GBR,2002.0,8,29,-21
CAN,MEX,2018.0,44,49,-5
CHE,KOR,2020.0,17,25,-8
THA,GBR,2017.0,48,85,-37
KWT,CAN,2017.0,9,20,-11
GHA,ITA,2018.0,2,2,0
HKG,CAN,2019.0,29,21,8
DNK,CHN,2015.0,45,63,-18
GBR,IND,2000.0,59,85,-26
UKR,DEU,2018.0,40,20,20
CAN,BGD,2016.0,21,26,-5
SAU,DEU,2018.0,24,28,-4
IRN,HKG,2020.0,9,6,3
CAN,MYS,2018.0,12,34,-22
AUT,EGY,2015.0,7,4,3
CZE,DNK,2021.0,4,5,-1
MYS,NLD,2015.0,7,11,-4
COL,AUS,2020.0,14,6,8
PHL,AUS,2016.0,7,17,-10
POL,SVK,2002.0,2,10,-8
GRC,SWE,2013.0,23,6,17
USA,ECU,2003.0,9,11,-2
NGA,BEL,1999.0,1,1,0
DEU,GAB,2011.0,4,1,3
GBR,FIN,1997.0,20,28,-8
PAK,SAU,2007.0,12,12,0
DEU,LTU,2002.0,9,2,7
NZL,NOR,2002.0,6,2,4
CYP,GRC,2012.0,15,34,-19
CHE,AUT,2005.0,36,31,5
DEU,GRC,1997.0,28,21,7
USA,ISL,2013.0,9,14,-5
CAN,SRB,2003.0,6,3,3
TUR,NOR,2010.0,6,2,4
UKR,FRA,2003.0,23,9,14
ESP,NLD,1997.0,26,31,-5
BRA,MEX,2001.0,4,6,-2
AUS,CZE,2022.0,2,4,-2
CZE,AUS,2023.0,2,3,-1
UKR,GBR,2003.0,22,19,3
IND,RUS,1998.0,2,5,-3
USA,NPL,2002.0,5,6,-1
GLP,FRA,2015.0,46,27,19
RUS,CAN,2004.0,35,15,20
RUS,CAN,2008.0,23,8,15
POL,NOR,2001.0,7,3,4
DNK,AUT,2011.0,8,6,2
FIN,ITA,2001.0,14,12,2
NZL,HKG,2007.0,3,1,2
FIN,TUR,2007.0,3,9,-6
AUS,PHL,2007.0,12,3,9
KWT,EGY,1998.0,8,3,5
NGA,SAU,2000.0,3,3,0
ITA,BRA,2000.0,37,15,22
DEU,LBN,2014.0,3,2,1
ROU,CAN,1999.0,7,3,4
FRA,IDN,2011.0,10,2,8
CZE,ROU,2007.0,2,1,1
NZL,ITA,2003.0,4,4,0
BEL,CHE,2009.0,39,30,9
NLD,CHE,2000.0,28,39,-11
SRB,FRA,2001.0,7,9,-2
POL,SWE,2015.0,26,9,17
MYS,SAU,2011.0,23,5,18
CHL,ITA,2001.0,5,2,3
MEX,RUS,2014.0,2,5,-3
SGP,DNK,2005.0,2,2,0
TJK,RUS,1998.0,5,1,4
GRC,BEL,1998.0,4,6,-2
ARE,ZAF,2002.0,1,1,0
ZAF,BEL,2001.0,11,10,1
ARG,NGA,2015.0,1,1,0
TUR,JPN,2006.0,9,13,-4
JPN,TUR,2007.0,15,8,7
ESP,POL,1998.0,4,5,-1
RUS,ZAF,2022.0,5,1,4
MYS,THA,2003.0,1,2,-1
ITA,TUN,2021.0,14,17,-3
HRV,USA,2001.0,27,23,4
BEL,THA,2020.0,4,4,0
JAM,TTO,2009.0,6,2,4
GLP,FRA,2001.0,20,10,10
AUS,ISR,2007.0,7,10,-3
USA,SDN,1997.0,2,2,0
CAN,CZE,2002.0,3,15,-12
ZAF,CAN,2003.0,21,11,10
BEN,NGA,2012.0,4,5,-1
NLD,FIN,2008.0,20,17,3
IRL,BEL,2001.0,4,1,3
RUS,ISR,1998.0,31,16,15
CHN,BRA,2003.0,6,1,5
PAN,DEU,1999.0,2,1,1
ARE,SWE,2010.0,2,3,-1
DNK,AUT,2019.0,5,11,-6
ARE,GBR,2019.0,27,81,-54
ETH,ZWE,2021.0,3,3,0
RUS,POL,2023.0,10,4,6
GBR,VEN,2002.0,13,4,9
UZB,BRA,1999.0,1,2,-1
GBR,ARE,2000.0,14,7,7
SWE,BGR,2001.0,1,3,-2
USA,MAR,1998.0,4,2,2
DEU,NOR,1999.0,27,15,12
ITA,TUR,2005.0,5,6,-1
BGR,USA,1999.0,31,8,23
DEU,SVN,2000.0,7,4,3
NLD,HRV,2004.0,3,2,1
IND,CHN,2007.0,11,13,-2
SAU,CAN,2004.0,22,22,0
BEL,NZL,2005.0,6,2,4
DNK,NOR,2006.0,29,17,12
CHE,CAN,2005.0,62,47,15
KOR,RUS,1999.0,6,9,-3
FRA,GLP,2013.0,46,24,22
GLP,FRA,2014.0,48,29,19
AUS,MEX,2014.0,11,12,-1
SWE,HUN,2009.0,9,16,-7
USA,PRI,2000.0,47,59,-12
ECU,BOL,2008.0,1,2,-1
SWE,EST,2008.0,9,7,2
KEN,COL,2001.0,1,1,0
SWE,BEL,2011.0,10,21,-11
HUN,GBR,2000.0,26,19,7
TUN,FRA,2006.0,54,89,-35
CHN,PAK,2004.0,3,4,-1
SGP,RUS,2012.0,3,1,2
ISR,FRA,2010.0,25,18,7
POL,RUS,2016.0,13,8,5
AUT,CHE,2002.0,40,22,18
CAN,SRB,2013.0,3,3,0
LKA,GBR,1999.0,4,4,0
LKA,GBR,2007.0,6,12,-6
USA,TZA,2005.0,10,5,5
GBR,KWT,2000.0,5,7,-2
BHR,IRL,2009.0,1,1,0
BEN,FRA,1998.0,4,2,2
THA,CAN,2001.0,8,9,-1
ISR,FRA,2000.0,23,21,2
NOR,AUS,2016.0,16,23,-7
ZAF,ETH,2004.0,2,3,-1
NOR,DEU,2011.0,37,57,-20
FRA,BLR,2009.0,2,1,1
BRA,URY,1997.0,2,1,1
FRA,GUY,2005.0,4,2,2
GUF,FRA,2008.0,13,16,-3
MAR,ESP,2008.0,14,13,1
RUS,AUS,2014.0,7,10,-3
AUT,GBR,1998.0,18,20,-2
TUR,NLD,1999.0,3,1,2
BRA,AUS,2007.0,20,10,10
GRC,DEU,2014.0,87,53,34
AUT,RUS,2016.0,9,16,-7
RUS,BGR,2011.0,7,2,5
ZWE,GBR,2001.0,3,12,-9
KOR,UKR,2011.0,3,4,-1
GBR,AUT,2008.0,45,69,-24
IRN,AZE,2016.0,2,5,-3
JPN,SGP,2012.0,34,15,19
ETH,NOR,2003.0,4,2,2
NGA,BEN,2013.0,8,2,6
VEN,ESP,2008.0,27,24,3
FRA,EGY,2006.0,7,7,0
FRA,BGR,2004.0,11,8,3
AUT,CZE,2003.0,7,9,-2
CHL,AUS,2017.0,18,23,-5
NAM,ZAF,2007.0,6,2,4
SAU,CAN,2008.0,27,47,-20
FIN,BEL,2012.0,4,6,-2
SRB,GRC,2005.0,6,6,0
SVN,NLD,2016.0,2,2,0
USA,MAR,1999.0,5,6,-1
HUN,CHE,2004.0,13,7,6
BGR,FRA,2011.0,9,4,5
FRA,BGR,2015.0,9,4,5
ITA,SWE,2006.0,23,31,-8
CAN,ITA,2005.0,22,38,-16
USA,UGA,2003.0,19,6,13
CUB,BRA,2002.0,12,6,6
NZL,KOR,2004.0,1,2,-1
CHE,IND,2001.0,7,9,-2
USA,PAK,1999.0,21,17,4
DEU,LIE,2011.0,5,4,1
EST,CHE,2001.0,1,1,0
NLD,CZE,1999.0,7,3,4
HKG,TWN,2010.0,7,9,-2
ROU,ITA,1997.0,3,8,-5
ITA,ROU,2005.0,4,11,-7
SWZ,USA,2015.0,1,6,-5
USA,NGA,2009.0,31,26,5
CHE,CZE,2000.0,10,6,4
LTU,NOR,1998.0,2,2,0
JPN,ESP,2006.0,10,6,4
CZE,CHE,1999.0,7,7,0
SVK,SWE,1997.0,2,1,1
RUS,GEO,1997.0,3,2,1
POL,SWE,2008.0,25,15,10
GRC,AUS,2011.0,4,5,-1
USA,PAK,1998.0,15,9,6
PAN,USA,1999.0,12,11,1
NOR,DNK,2006.0,17,29,-12
ISL,DNK,2012.0,4,3,1
KWT,BHR,2020.0,4,1,3
ITA,CAN,2007.0,48,32,16
DNK,GBR,2009.0,53,81,-28
GBR,SAU,2003.0,26,17,9
ARE,OMN,2008.0,3,2,1
OMN,EGY,2013.0,4,6,-2
JPN,CHE,2003.0,27,35,-8
SVK,GBR,1997.0,9,10,-1
USA,PER,2001.0,17,32,-15
DEU,ISR,1999.0,36,29,7
MKD,SRB,2000.0,3,6,-3
BEL,RUS,2013.0,6,3,3
DEU,ZAF,2004.0,13,18,-5
BRA,ARG,2000.0,15,30,-15
BEL,IRL,2002.0,5,4,1
IDN,SWE,2018.0,3,4,-1
ISL,DEU,2018.0,3,5,-2
CHE,ISR,1997.0,2,9,-7
HRV,FIN,2014.0,1,1,0
IND,ARE,2013.0,28,17,11
SYR,USA,2000.0,2,5,-3
FRA,BFA,2005.0,11,6,5
AUS,ARG,2000.0,3,2,1
ROU,ITA,2002.0,11,7,4
FIN,FRA,2002.0,16,27,-11
ITA,UKR,2000.0,2,6,-4
TUR,SWE,2009.0,5,5,0
TUR,SWE,2011.0,8,6,2
DNK,CHE,2003.0,13,13,0
AUS,BEL,2004.0,8,9,-1
NLD,AUS,2003.0,32,43,-11
CZE,NLD,2002.0,9,2,7
HUN,GBR,2006.0,25,27,-2
CHE,SWE,2016.0,68,52,16
CAN,CZE,2005.0,2,8,-6
JPN,AUT,2005.0,9,3,6
HUN,SRB,2005.0,7,2,5
CAN,ITA,2002.0,40,40,0
PHL,ITA,2015.0,1,2,-1
DNK,POL,1997.0,7,4,3
AGO,FRA,2005.0,1,3,-2
SVK,JPN,2000.0,6,2,4
FRA,ECU,2012.0,4,5,-1
DEU,LBN,2008.0,4,1,3
DEU,NOR,1998.0,17,13,4
AUT,IRL,1999.0,1,1,0
AUS,POL,2018.0,15,10,5
DNK,ISR,2022.0,5,7,-2
VNM,THA,2009.0,3,3,0
AUT,FRA,1997.0,13,6,7
CAN,ISR,2022.0,50,48,2
GRC,CYP,2002.0,9,3,6
JPN,EGY,2000.0,11,12,-1
USA,URY,2008.0,14,10,4
CHE,TUR,1999.0,4,7,-3
TUR,DEU,1997.0,12,11,1
DNK,FRA,2003.0,27,29,-2
BEL,CHE,2011.0,49,34,15
RUS,GEO,2005.0,8,5,3
EGY,ARE,2001.0,10,9,1
FRA,CZE,2001.0,17,21,-4
POL,ISR,1998.0,4,3,1
SRB,DEU,2003.0,16,19,-3
CAN,SGP,2014.0,23,35,-12
LBN,USA,2003.0,27,41,-14
NLD,NOR,2008.0,23,15,8
SGP,NLD,2013.0,10,14,-4
HUN,BEL,2016.0,11,9,2
SRB,USA,2009.0,17,26,-9
DEU,CHL,1997.0,5,7,-2
NOR,BEL,2001.0,2,4,-2
JPN,PAK,2006.0,13,8,5
ZAF,AUS,1999.0,29,17,12
COL,ARG,2015.0,11,11,0
CZE,DNK,2019.0,8,4,4
SWE,AUS,2019.0,48,62,-14
CAN,NZL,2021.0,32,39,-7
ARG,LUX,2021.0,1,1,0
BRA,CRI,2022.0,6,1,5
SAU,ARE,2014.0,24,9,15
USA,KWT,2023.0,15,11,4
HUN,CHN,2021.0,10,11,-1
AUS,PAK,2013.0,12,26,-14
CHN,ISR,2023.0,21,24,-3
CHN,SDN,2018.0,16,5,11
BRA,CZE,2020.0,16,3,13
GRC,CHN,2019.0,5,3,2
ESP,PRY,2018.0,7,1,6
AUS,KOR,2023.0,20,25,-5
ESP,CUB,2011.0,24,26,-2
FRA,QAT,2019.0,9,2,7
LBN,SAU,2019.0,6,3,3
VNM,CHE,2016.0,6,1,5
IRN,IRL,2018.0,14,7,7
MYS,NZL,2023.0,4,2,2
PRT,DEU,2022.0,47,44,3
BEL,KOR,2023.0,8,13,-5
KGZ,KAZ,2018.0,9,1,8
TUR,KOR,2019.0,8,4,4
EGY,BEL,2016.0,7,5,2
AUS,BGD,2023.0,47,55,-8
TUR,KOR,2021.0,5,4,1
SRB,ALB,2018.0,5,4,1
FRA,IDN,2019.0,16,3,13
EGY,FRA,2021.0,12,23,-11
HRV,GBR,2023.0,8,4,4
LUX,FRA,2010.0,14,33,-19
USA,NGA,2019.0,53,67,-14
SHN,GBR,2018.0,3,4,-1
USA,BFA,2019.0,6,3,3
ESP,CHL,2008.0,48,52,-4
LKA,NLD,2019.0,2,1,1
ITA,POL,2023.0,20,20,0
HUN,CHN,2019.0,6,8,-2
AUS,IRL,2015.0,28,48,-20
KOR,ETH,2022.0,8,5,3
TWN,AUS,2019.0,21,16,5
IND,CZE,2022.0,31,22,9
IND,NOR,2016.0,14,14,0
AUS,BTN,2019.0,6,8,-2
KOR,TZA,2021.0,5,3,2
PYF,AUS,2018.0,1,1,0
GBR,CYP,2003.0,12,2,10
CZE,LUX,2019.0,5,1,4
AUS,GHA,2019.0,6,18,-12
EGY,CHE,2020.0,3,4,-1
CAN,CHL,2023.0,13,11,2
NLD,HUN,2019.0,12,6,6
CHN,AUS,2024.0,9,17,-8
PAK,TUR,2009.0,6,2,4
SRB,ALB,2016.0,8,8,0
CHL,NLD,2021.0,20,11,9
JPN,NOR,2019.0,13,5,8
BFA,TGO,2018.0,3,3,0
MWI,USA,2018.0,23,18,5
USA,COL,2001.0,33,37,-4
ITA,CMR,2020.0,4,1,3
PAK,ESP,2023.0,7,4,3
PAK,ZAF,2022.0,3,2,1
EGY,SWE,2021.0,2,5,-3
IRQ,IND,2022.0,2,6,-4
AUT,RUS,2022.0,14,13,1
SVN,ESP,2020.0,7,5,2
GRC,DNK,2019.0,11,8,3
KOR,THA,2018.0,17,14,3
AUS,CHL,2018.0,30,12,18
ZAF,DEU,2014.0,26,42,-16
CHE,PRT,2018.0,18,19,-1
NLD,UKR,2021.0,1,1,0
GBR,BHR,2016.0,6,5,1
BIH,HRV,2018.0,9,9,0
MNE,MKD,2020.0,1,3,-2
GTM,MEX,2020.0,3,8,-5
ITA,GRC,2014.0,25,43,-18
ARG,GBR,2011.0,13,21,-8
ROU,ISR,2013.0,1,1,0
MEX,DNK,2020.0,8,10,-2
VNM,JPN,2023.0,22,41,-19
LUX,AUS,2023.0,1,1,0
PNG,NGA,1998.0,1,1,0
FRA,GIN,2009.0,2,2,0
FRA,GIN,2011.0,3,1,2
VNM,GBR,2008.0,5,13,-8
NLD,NZL,2006.0,11,15,-4
ESP,COL,2006.0,27,17,10
USA,JAM,2002.0,12,6,6
THA,CAN,2015.0,12,20,-8
IND,SGP,1999.0,19,4,15
ITA,JPN,2015.0,23,25,-2
KWT,SWE,2004.0,1,1,0
BGD,IND,2020.0,24,26,-2
BIH,SRB,2012.0,14,20,-6
DNK,CAN,2015.0,21,26,-5
BWA,GBR,1999.0,4,1,3
SGP,VNM,2021.0,10,3,7
BGD,IND,1999.0,7,13,-6
CHL,SWE,2020.0,8,4,4
JPN,PHL,2017.0,26,31,-5
NLD,FRA,2023.0,59,73,-14
PER,SWE,2021.0,1,1,0
FIN,SGP,2012.0,2,4,-2
NPL,GBR,2008.0,7,3,4
MEX,ISR,2019.0,4,5,-1
ISR,MEX,2020.0,3,6,-3
ITA,AUS,2003.0,23,15,8
ITA,ALB,2007.0,2,1,1
IND,CZE,2017.0,20,7,13
TUR,AUS,2018.0,13,16,-3
ROU,RUS,2009.0,3,2,1
IDN,GBR,2023.0,24,23,1
IND,HRV,2021.0,2,1,1
AUT,GRC,2015.0,4,10,-6
GBR,BGD,1999.0,10,7,3
MEX,USA,2024.0,4,3,1
GBR,KEN,2016.0,21,29,-8
KOR,GBR,2001.0,22,18,4
RUS,HUN,2009.0,2,5,-3
RUS,HUN,2011.0,4,1,3
GBR,EGY,2010.0,55,18,37
SRB,FRA,2015.0,6,7,-1
BGD,DEU,2004.0,6,4,2
IND,IDN,2014.0,27,5,22
JOR,ARE,2017.0,17,11,6
BRA,AGO,2012.0,2,1,1
ITA,MCO,2016.0,2,1,1
ISR,SWE,2016.0,10,7,3
IDN,SAU,2015.0,3,2,1
SAU,IDN,2019.0,6,2,4
BFA,CAN,2013.0,2,3,-1
CHE,THA,2015.0,4,6,-2
RUS,IND,1998.0,5,2,3
ISR,ITA,2004.0,12,5,7
NZL,VNM,2023.0,7,3,4
ZAF,BWA,2022.0,13,6,7
ESP,CUB,2021.0,15,16,-1
CHN,EGY,2023.0,63,26,37
CHN,RWA,2022.0,11,1,10
ETH,BEL,2022.0,10,7,3
ECU,FRA,2022.0,9,5,4
SVK,SLV,2022.0,2,1,1
MNG,KOR,2020.0,2,9,-7
COL,CAN,2021.0,32,15,17
CHL,ITA,2015.0,6,19,-13
DNK,FRO,2019.0,4,3,1
LUX,BEL,2022.0,11,23,-12
LKA,CHE,2018.0,2,2,0
DNK,CHN,2004.0,8,9,-1
DEU,ETH,2023.0,8,9,-1
CIV,CMR,2018.0,1,1,0
PAK,SGP,2020.0,5,3,2
KWT,MAR,2022.0,1,1,0
PRY,BRA,2018.0,5,6,-1
MEX,COL,2003.0,9,7,2
AUT,HUN,1997.0,5,1,4
NZL,SGP,2007.0,6,6,0
FIN,POL,1999.0,4,1,3
AUS,ISR,1999.0,6,3,3
ISR,AUS,2005.0,18,5,13
CZE,AUT,2002.0,17,11,6
ZWE,NLD,1997.0,3,3,0
WSM,AUS,2019.0,1,2,-1
SWE,HUN,2011.0,7,13,-6
CHL,ESP,2011.0,66,78,-12
GBR,ARG,2003.0,9,26,-17
KOR,RUS,2007.0,15,6,9
ROU,USA,2009.0,28,33,-5
USA,ROU,2012.0,38,19,19
ISR,ESP,2008.0,12,4,8
ESP,CHL,2004.0,39,32,7
SWE,RUS,2003.0,25,36,-11
NLD,FIN,2004.0,8,6,2
FIN,BEL,2005.0,2,2,0
NOR,CZE,2016.0,6,4,2
ARG,AUS,2002.0,6,6,0
CZE,AUT,1997.0,6,9,-3
MDG,FRA,2000.0,9,6,3
FIN,GBR,2013.0,40,52,-12
USA,MYS,2001.0,11,16,-5
ARE,EGY,2003.0,13,8,5
FRA,EGY,2000.0,4,5,-1
EGY,DEU,2001.0,24,19,5
ESP,ISR,2003.0,2,3,-1
BRA,GBR,2001.0,51,84,-33
NLD,DNK,2010.0,26,13,13
NZL,ZAF,2017.0,8,10,-2
ZAF,AUS,1998.0,18,8,10
FRA,UKR,1998.0,6,10,-4
RUS,SGP,1999.0,2,1,1
ROU,FRA,1998.0,27,23,4
USA,PER,2004.0,29,31,-2
BRA,ZAF,2004.0,2,2,0
SWE,NZL,2000.0,6,8,-2
GBR,LBN,2009.0,9,5,4
LBN,GBR,2004.0,3,8,-5
ESP,NOR,2006.0,7,7,0
BGD,GBR,1999.0,7,10,-3
CAN,SWE,2004.0,27,30,-3
PER,ESP,2014.0,9,17,-8
JPN,UKR,2004.0,4,6,-2
AUS,THA,1997.0,11,2,9
AUS,VNM,2009.0,7,4,3
CIV,FRA,2008.0,17,33,-16
SWE,MEX,2020.0,6,13,-7
KWT,SWE,2008.0,1,1,0
USA,VNM,2004.0,8,8,0
BEL,AUS,2001.0,10,11,-1
DNK,CAN,2008.0,19,25,-6
HKG,ITA,2010.0,1,1,0
BEL,BLR,2012.0,8,1,7
BLR,BEL,2013.0,4,1,3
AUS,PRT,2008.0,3,5,-2
ESP,SVK,2002.0,7,1,6
ROU,PRT,2002.0,3,2,1
ARG,MEX,2006.0,6,2,4
BIH,SRB,2002.0,4,6,-2
SWE,VNM,2004.0,4,3,1
CAN,CRI,2000.0,5,1,4
VNM,KHM,2012.0,2,2,0
ITA,SVN,2000.0,7,1,6
AUS,ZAF,1998.0,8,18,-10
ESP,NIC,1999.0,2,1,1
NLD,BOL,2012.0,1,1,0
CAN,COL,2013.0,15,17,-2
AUS,NOR,2010.0,11,15,-4
FRA,TUR,2020.0,15,31,-16
TUR,DEU,2002.0,13,12,1
CHE,BRA,2013.0,13,9,4
BRA,CHE,2015.0,17,20,-3
GBR,CYP,2013.0,31,10,21
SVK,POL,2002.0,10,2,8
KOR,FRA,2000.0,2,11,-9
FRA,KOR,2001.0,4,9,-5
KOR,FRA,2006.0,9,16,-7
CZE,SRB,2001.0,4,1,3
GRC,SWE,2003.0,2,15,-13
ZWE,ZAF,2004.0,11,4,7
IND,ITA,2000.0,11,11,0
NOR,ISL,1999.0,5,3,2
ISL,NOR,2001.0,1,3,-2
VNM,AUS,2023.0,31,30,1
FIN,HUN,2014.0,4,5,-1
DNK,PER,1999.0,2,1,1
DNK,ZAF,2015.0,3,1,2
SAU,GBR,2005.0,14,22,-8
IND,CHE,2003.0,15,9,6
AUS,NLD,2015.0,68,96,-28
FRA,COL,2002.0,5,8,-3
AUS,HKG,1998.0,27,24,3
CRI,NLD,2000.0,1,2,-1
AUS,MEX,2015.0,9,21,-12
FIN,POL,2007.0,4,2,2
FRA,NCL,2012.0,29,15,14
ITA,AUT,2001.0,17,31,-14
CZE,JPN,2008.0,8,5,3
EGY,DEU,2004.0,15,29,-14
VEN,GBR,2001.0,9,10,-1
KWT,ARE,2007.0,1,1,0
NLD,SGP,2001.0,2,3,-1
GBR,ZWE,2001.0,12,3,9
BHR,GBR,2013.0,4,8,-4
CHE,SWZ,2012.0,13,11,2
PAK,CAN,2004.0,8,6,2
ESP,PHL,1999.0,7,3,4
ARE,ITA,2020.0,9,7,2
TZA,NLD,1999.0,5,1,4
EGY,SYR,2016.0,1,2,-1
ARE,DEU,2007.0,1,6,-5
JPN,ITA,2004.0,16,17,-1
SGP,FRA,2011.0,11,32,-21
HUN,SWE,2009.0,16,9,7
CZE,CAN,2008.0,16,12,4
KWT,USA,2014.0,7,21,-14
MEX,ARG,2000.0,6,10,-4
OMN,EGY,2003.0,3,2,1
PRT,AUS,2003.0,2,2,0
DEU,TUN,2001.0,2,1,1
POL,CAN,2005.0,16,12,4
IDN,USA,2009.0,14,37,-23
QAT,ARE,2005.0,2,1,1
LKA,IND,2006.0,1,3,-2
AFG,PAK,2010.0,1,1,0
LIE,DEU,2003.0,2,4,-2
SWE,NLD,2006.0,27,27,0
RUS,KOR,1999.0,9,6,3
FRA,TUR,1998.0,7,7,0
HUN,JPN,2004.0,7,4,3
JPN,HUN,2005.0,4,4,0
NOR,FIN,2004.0,6,4,2
GBR,SVN,2006.0,6,6,0
ISL,USA,2012.0,11,13,-2
ECU,USA,2015.0,10,38,-28
ESP,PRT,2005.0,33,24,9
USA,KNA,2016.0,11,5,6
THA,ESP,2006.0,1,1,0
FIN,BGR,2002.0,1,2,-1
CHL,PER,2012.0,3,1,2
IRL,DNK,2017.0,9,10,-1
IRL,PRT,2016.0,5,7,-2
AUT,SWE,2002.0,15,6,9
PYF,FRA,2006.0,4,11,-7
GTM,USA,2007.0,7,7,0
KOR,VNM,2008.0,11,2,9
THA,BRA,2005.0,1,1,0
ISR,ARG,1999.0,4,4,0
FRA,IDN,2009.0,8,2,6
TWN,AUS,2009.0,11,20,-9
CHN,POL,2002.0,1,1,0
IND,ESP,2004.0,9,1,8
POL,GRC,2001.0,2,1,1
SGP,PHL,2019.0,11,1,10
BRA,CHE,2004.0,9,8,1
TUR,NLD,2007.0,13,5,8
SVN,BEL,2002.0,1,2,-1
USA,GRD,2020.0,15,10,5
SAU,TUN,2013.0,5,45,-40
ESP,EGY,2007.0,6,3,3
JOR,DEU,2001.0,5,5,0
AUT,EGY,2008.0,3,2,1
EGY,PAK,2022.0,4,5,-1
BGR,ITA,2007.0,3,6,-3
SWE,CHN,1997.0,12,12,0
CHL,MEX,2018.0,15,15,0
LVA,LTU,2001.0,1,2,-1
SGP,JPN,2004.0,10,14,-4
NPL,PHL,2003.0,1,1,0
FRA,IND,2006.0,31,47,-16
ISR,TUR,2001.0,4,4,0
CHL,CAN,1998.0,5,5,0
ARE,HUN,2002.0,2,3,-1
ARE,HUN,2005.0,4,1,3
USA,BIH,2010.0,6,3,3
CZE,AUT,2005.0,7,10,-3
UZB,USA,2001.0,6,1,5
NOR,TZA,2002.0,5,2,3
GIN,SEN,2013.0,1,1,0
BGR,BEL,2000.0,6,4,2
POL,BGR,2001.0,4,2,2
JOR,QAT,2008.0,2,2,0
ITA,CYP,2000.0,1,2,-1
CYP,USA,2002.0,8,11,-3
KAZ,RUS,2023.0,18,33,-15
GBR,ARG,2013.0,16,24,-8
FRA,VNM,2008.0,9,7,2
USA,PRT,2013.0,74,84,-10
DNK,CHL,2017.0,4,3,1
AZE,TUR,2019.0,8,14,-6
IRN,IND,2011.0,6,23,-17
THA,IND,2017.0,6,20,-14
HUN,JPN,2008.0,6,1,5
FRA,KOR,2008.0,22,14,8
LTU,NLD,2010.0,4,2,2
SVN,SRB,2014.0,5,7,-2
SVK,GBR,2012.0,14,4,10
NZL,FRA,2005.0,9,7,2
AUS,NLD,2004.0,22,26,-4
ESP,URY,2017.0,17,9,8
GBR,IRN,2013.0,44,50,-6
KOR,DEU,2017.0,62,48,14
IND,ESP,2014.0,13,15,-2
USA,LBN,2016.0,63,83,-20
AUT,BRA,2010.0,4,7,-3
ZAF,CIV,2011.0,12,3,9
NZL,KOR,2008.0,4,2,2
HKG,FRA,2001.0,3,7,-4
TWN,PHL,2021.0,16,9,7
JPN,IRN,2009.0,23,12,11
MEX,CHE,2012.0,10,7,3
USA,EST,2010.0,7,6,1
ARG,DNK,2020.0,9,1,8
CHE,FIN,2016.0,15,16,-1
CHN,GRC,2015.0,3,5,-2
GBR,LBN,2011.0,9,3,6
CHL,BRA,2017.0,16,40,-24
BRA,RUS,2018.0,12,3,9
CAN,VNM,2012.0,3,1,2
AUS,HUN,2018.0,8,7,1
COG,COD,2010.0,18,16,2
AUS,EGY,2013.0,8,9,-1
IRQ,SAU,2016.0,1,1,0
NOR,BRA,2010.0,1,5,-4
BGD,AUS,2011.0,32,7,25
ISR,ITA,2014.0,18,25,-7
CHE,ISR,2012.0,13,18,-5
SWE,ISL,2017.0,15,14,1
GRC,ROU,2011.0,6,3,3
ROU,ESP,2013.0,12,5,7
BEL,NZL,2012.0,2,2,0
UGA,GBR,2021.0,16,27,-11
TZA,ITA,2021.0,1,4,-3
ITA,TZA,2023.0,1,3,-2
SYR,USA,2010.0,2,4,-2
NAM,ZAF,2020.0,10,16,-6
ZAF,AUS,2020.0,59,45,14
TUR,DEU,2012.0,40,32,8
CAN,SGP,2008.0,21,34,-13
ESP,KOR,2010.0,2,4,-2
CHN,NLD,2008.0,33,26,7
TZA,NOR,2017.0,2,10,-8
CRI,COL,2013.0,3,2,1
CHE,GHA,2021.0,3,3,0
JOR,DEU,2008.0,7,14,-7
BRA,QAT,2021.0,1,2,-1
GBR,UGA,2010.0,17,8,9
GRC,DEU,2008.0,33,37,-4
AUS,IRL,2014.0,32,56,-24
EGY,JPN,2019.0,32,86,-54
SWE,CHN,2002.0,17,31,-14
FIN,AUT,2016.0,12,13,-1
ARG,PRT,2002.0,3,1,2
OMN,CAN,2016.0,10,8,2
FIN,HUN,2015.0,3,3,0
BEL,GRC,2022.0,9,14,-5
DNK,ITA,2015.0,17,56,-39
USA,CYP,2008.0,20,7,13
TZA,CAN,2020.0,5,1,4
AUT,ITA,2011.0,42,38,4
BRN,GBR,2000.0,3,1,2
JPN,NGA,2020.0,5,9,-4
KEN,CHN,2020.0,9,13,-4
RUS,SAU,2012.0,2,1,1
CAN,CMR,2017.0,2,4,-2
SVN,ROU,2011.0,1,1,0
CAN,KEN,2013.0,5,7,-2
SGP,FIN,2015.0,3,2,1
NLD,MYS,2015.0,11,7,4
BEL,NER,2014.0,3,1,2
CHN,SAU,2012.0,18,4,14
POL,AUT,2019.0,14,14,0
SGP,PAK,2015.0,6,3,3
FRA,EGY,2010.0,15,11,4
EGY,FRA,2011.0,11,18,-7
IND,GRC,2013.0,1,2,-1
FRA,MDG,2011.0,13,10,3
PHL,JPN,2016.0,26,36,-10
ARE,NZL,2018.0,5,3,2
ITA,JPN,2014.0,23,19,4
URY,USA,2012.0,12,13,-1
CZE,NLD,2012.0,9,10,-1
KAZ,RUS,2010.0,10,16,-6
SVK,SLV,2016.0,2,6,-4
ISR,IRL,2014.0,12,8,4
ZAF,CHN,2016.0,12,9,3
SRB,SVK,2018.0,4,1,3
EGY,OMN,2020.0,8,6,2
POL,SGP,2011.0,3,2,1
AUS,BEL,2008.0,16,8,8
BEL,VNM,2014.0,12,4,8
FRA,KOR,2014.0,33,29,4
VNM,GBR,2014.0,19,30,-11
BGD,IND,2007.0,10,12,-2
IND,RUS,2020.0,24,5,19
BGD,CHE,2018.0,4,1,3
POL,AUT,2011.0,6,12,-6
LTU,FIN,2021.0,6,1,5
TZA,BEL,2019.0,3,2,1
TWN,NLD,2010.0,6,2,4
TWN,GBR,2013.0,22,42,-20
FRA,THA,2020.0,22,18,4
HKG,CAN,2009.0,28,25,3
THA,NOR,2009.0,1,1,0
CYP,GBR,2015.0,25,36,-11
NOR,NLD,2022.0,22,31,-9
HUN,NLD,2011.0,12,7,5
GHA,KEN,2015.0,1,4,-3
HRV,SVN,2015.0,10,9,1
SVN,AUT,2020.0,7,6,1
DEU,PSE,2015.0,6,3,3
LTU,DEU,2011.0,9,2,7
GBR,PER,2013.0,8,5,3
KOR,HUN,2022.0,3,2,1
CAN,ESP,2017.0,60,63,-3
GRL,CAN,2019.0,1,1,0
MYS,FRA,2023.0,7,3,4
COL,ESP,2004.0,13,20,-7
GBR,MUS,2017.0,1,3,-2
KOR,THA,2017.0,14,13,1
KOR,THA,2016.0,17,10,7
JOR,BHR,2022.0,4,4,0
SRB,BIH,2018.0,19,8,11
JPN,HUN,2002.0,9,11,-2
HUN,CHE,2001.0,6,10,-4
GHA,ZAF,2016.0,11,5,6
EGY,CAN,2022.0,44,42,2
MLI,FRA,2017.0,10,7,3
GBR,KWT,2006.0,11,4,7
ESP,CUB,2019.0,15,29,-14
RUS,ZAF,2016.0,2,4,-2
CHE,CHL,2001.0,5,4,1
UKR,SWE,2019.0,7,7,0
PRT,IND,2020.0,21,13,8
MEX,DEU,2022.0,44,26,18
USA,AZE,2017.0,5,1,4
ARG,NLD,2016.0,6,5,1
GBR,BHR,2017.0,10,3,7
BEL,CMR,2017.0,4,2,2
EGY,RUS,2021.0,11,21,-10
AUS,RUS,2020.0,12,14,-2
ECU,USA,2004.0,8,4,4
BEL,ROU,2019.0,6,9,-3
DEU,NGA,2018.0,6,7,-1
EGY,CHN,2008.0,4,3,1
CPV,PRT,2022.0,2,3,-1
QAT,CAN,2010.0,3,9,-6
NOR,HKG,2023.0,2,3,-1
USA,ARM,2021.0,8,8,0
TUR,KAZ,2021.0,12,3,9
MNG,JPN,2012.0,2,9,-7
GRC,NLD,2018.0,24,26,-2
SVK,SVN,2016.0,18,9,9
NPL,CAN,2022.0,7,5,2
VNM,SAU,2020.0,2,1,1
RUS,ITA,2016.0,28,30,-2
CAN,AUT,2012.0,15,25,-10
MYS,GBR,2005.0,23,54,-31
ZAF,CHN,2017.0,15,6,9
GIN,FRA,2019.0,1,6,-5
PER,MEX,2013.0,3,4,-1
ZAF,CHN,2018.0,13,7,6
SGP,DEU,2023.0,27,21,6
FRA,MYS,2022.0,6,10,-4
IRN,NLD,2010.0,22,10,12
ESP,IND,2022.0,22,22,0
PER,DNK,2017.0,1,1,0
NLD,BRA,2021.0,38,75,-37
ETH,ZAF,2020.0,9,17,-8
IND,FIN,2023.0,13,4,9
KOR,VNM,2015.0,52,16,36
CRI,GBR,2013.0,3,1,2
PRT,CAN,2022.0,11,13,-2
RUS,GRC,2021.0,2,4,-2
SEN,ESP,2021.0,1,2,-1
ESP,ZAF,2016.0,11,6,5
ESP,ZAF,2018.0,11,6,5
NLD,ZAF,2022.0,13,28,-15
SRB,CHE,2018.0,8,6,2
POL,KAZ,2018.0,6,4,2
CHN,IRN,2023.0,16,30,-14
CMR,CHE,2020.0,5,2,3
CHE,FIN,2022.0,14,19,-5
NOR,NLD,2016.0,25,49,-24
FRA,IRN,2018.0,17,36,-19
RUS,CZE,2014.0,16,2,14
CZE,LTU,2018.0,1,1,0
BHR,CAN,2021.0,2,2,0
CHN,IRL,2015.0,20,25,-5
ETH,DEU,2023.0,9,8,1
ECU,ESP,2016.0,28,58,-30
CMR,BEL,2019.0,5,3,2
MYS,EGY,2023.0,6,4,2
KWT,DEU,2014.0,1,3,-2
NGA,THA,2021.0,5,6,-1
SAU,NGA,2023.0,7,8,-1
REU,GBR,2022.0,1,1,0
NOR,MWI,2020.0,2,1,1
NGA,SAU,2023.0,8,7,1
JPN,AUT,1997.0,7,6,1
BEL,TUN,2000.0,1,1,0
JOR,ITA,2018.0,4,9,-5
RUS,FIN,1997.0,12,11,1
AUS,ISR,2020.0,21,14,7
ZAF,IRL,2020.0,9,3,6
IRL,EGY,2020.0,2,5,-3
TUR,KAZ,2019.0,6,6,0
HKG,BEL,2022.0,4,2,2
BEL,MAR,2022.0,8,8,0
NZL,ARE,2019.0,8,3,5
COG,GIN,2021.0,1,1,0
NLD,QAT,2021.0,3,3,0
CZE,BEL,2022.0,14,11,3
ARE,SWE,2023.0,7,2,5
AUS,JOR,2021.0,11,7,4
ESP,COL,2000.0,4,7,-3
KWT,USA,2015.0,13,24,-11
FRA,SGP,2021.0,28,30,-2
TUN,CAN,2021.0,12,5,7
IDN,KOR,2023.0,14,21,-7
MAC,HKG,2021.0,7,14,-7
IND,PHL,2014.0,4,6,-2
ESP,AUT,2016.0,35,29,6
ITA,RUS,2012.0,16,20,-4
NZL,IRL,2022.0,6,7,-1
THA,PAK,2015.0,9,4,5
BWA,USA,2020.0,13,15,-2
MDG,DEU,2016.0,3,2,1
VNM,NLD,2022.0,6,4,2
HUN,DEU,2023.0,23,19,4
KWT,EGY,2020.0,19,13,6
NPL,AUS,2021.0,19,13,6
IRL,CHE,2023.0,11,10,1
TUR,AUS,2022.0,9,13,-4
IND,DNK,2006.0,6,3,3
UGA,NLD,2022.0,5,9,-4
IRL,ZAF,2022.0,5,15,-10
KAZ,UKR,2020.0,4,3,1
NOR,TUR,2021.0,4,9,-5
SRB,ITA,2016.0,6,10,-4
LIE,CHE,2020.0,4,8,-4
FRA,NGA,2019.0,2,7,-5
CHN,CIV,2020.0,2,1,1
BEL,CZE,2000.0,3,2,1
ESP,EGY,2020.0,19,9,10
CHN,ESP,2019.0,51,62,-11
CZE,SAU,2018.0,3,1,2
NOR,NLD,2017.0,11,44,-33
SAU,KAZ,2021.0,3,4,-1
BTN,AUS,2023.0,4,2,2
CHE,LKA,2019.0,3,1,2
PRT,MAC,2020.0,3,2,1
URY,CAN,2019.0,2,1,1
PSE,DEU,2018.0,2,7,-5
TWN,DEU,2015.0,21,19,2
KWT,CAN,2022.0,8,12,-4
BEL,LUX,2022.0,23,11,12
LKA,CHN,2022.0,7,6,1
NOR,IRN,2022.0,3,15,-12
FRA,PAN,2021.0,2,1,1
GHA,DEU,2023.0,8,6,2
CHE,LUX,2019.0,11,5,6
VEN,FRA,2022.0,4,2,2
POL,NLD,2021.0,21,20,1
RUS,UZB,2021.0,17,9,8
BGD,KOR,2018.0,17,41,-24
IND,LUX,2022.0,4,3,1
ITA,EGY,2022.0,8,7,1
UKR,LTU,2020.0,4,1,3
KOR,THA,2022.0,12,10,2
CAN,ISR,2017.0,49,69,-20
CAN,EGY,2010.0,26,22,4
SVN,CHN,2017.0,6,1,5
ARG,CHE,2022.0,13,5,8
DEU,ETH,2000.0,2,1,1
VNM,NLD,2018.0,6,11,-5
BFA,MLI,2018.0,4,2,2
MLI,BFA,2021.0,7,1,6
ESP,COL,2023.0,41,52,-11
ARG,NLD,2018.0,7,5,2
PAK,ZAF,2018.0,1,1,0
LKA,AUS,2023.0,23,12,11
IRL,DNK,2022.0,8,10,-2
TUR,DZA,2022.0,4,2,2
KOR,BRA,2019.0,5,3,2
KEN,FRA,2021.0,5,5,0
ZAF,GHA,2023.0,20,17,3
FRA,GIN,2019.0,6,1,5
ISR,SWE,2022.0,4,3,1
ECU,CHL,2021.0,13,20,-7
CHN,TZA,2022.0,21,2,19
TZA,NOR,2022.0,3,4,-1
GBR,ROU,2003.0,9,11,-2
TWN,SGP,2022.0,7,18,-11
EGY,BGD,2021.0,1,1,0
ESP,JPN,2022.0,17,26,-9
QAT,SGP,2021.0,3,3,0
ROU,RUS,2021.0,3,2,1
CHN,DEU,2024.0,7,15,-8
QAT,IND,2022.0,9,15,-6
BRA,ARG,2023.0,15,11,4
BEL,JPN,2011.0,15,17,-2
USA,SYR,2022.0,3,1,2
CHN,PRT,2023.0,18,10,8
BRA,PAK,2012.0,5,5,0
AZE,RUS,2000.0,5,7,-2
JPN,AUT,2012.0,18,10,8
FIN,AUS,2011.0,15,13,2
PRT,VNM,2019.0,3,2,1
USA,ARE,1997.0,9,1,8
JPN,BGD,1998.0,15,10,5
GBR,UGA,2006.0,7,2,5
UGA,GBR,2009.0,11,8,3
NGA,UGA,2013.0,2,1,1
CHL,USA,2007.0,58,86,-28
BRA,AUS,1999.0,4,8,-4
RUS,ARM,2009.0,8,6,2
ESP,VEN,2007.0,24,32,-8
TWN,HKG,1998.0,5,3,2
TUN,USA,2003.0,2,6,-4
SWE,CZE,1997.0,7,1,6
CZE,JPN,2001.0,9,8,1
JPN,BEL,2012.0,13,22,-9
CHL,ESP,2009.0,44,76,-32
UKR,CHN,2020.0,14,10,4
CHE,JPN,2004.0,21,30,-9
SVN,SRB,2004.0,2,6,-4
IRL,CHE,2000.0,7,1,6
JPN,UKR,2001.0,13,8,5
BEL,ISR,1997.0,4,3,1
BLR,POL,1997.0,4,5,-1
BLR,POL,2012.0,5,1,4
FRA,SAU,2010.0,15,1,14
MYS,GBR,1997.0,19,20,-1
MYS,HKG,2019.0,8,10,-2
AUT,ITA,2009.0,29,48,-19
ARG,SWE,2000.0,4,3,1
PRT,SVK,2005.0,1,1,0
KWT,USA,2004.0,7,17,-10
NLD,ISR,2003.0,4,8,-4
JPN,TUR,1999.0,9,1,8
NLD,BRA,2011.0,11,18,-7
NOR,DEU,2009.0,15,63,-48
SVN,DEU,2001.0,7,2,5
TUR,RUS,2009.0,3,4,-1
ZAF,ITA,2001.0,7,5,2
CHE,RUS,1998.0,9,17,-8
USA,HND,2018.0,3,3,0
CHN,ITA,2003.0,11,17,-6
BGR,HUN,2007.0,5,1,4
FRA,HRV,2001.0,6,4,2
PAK,SAU,1998.0,5,2,3
AUS,ZWE,2019.0,2,1,1
BRA,RUS,2017.0,5,16,-11
IND,ZWE,2020.0,1,2,-1
CAN,DNK,1998.0,18,16,2
HRV,DEU,2010.0,16,17,-1
ISR,HKG,2008.0,1,1,0
POL,LTU,2014.0,3,3,0
PNG,AUS,1999.0,5,4,1
TUR,NLD,1998.0,2,2,0
SWE,FIN,2010.0,38,53,-15
NOR,FRA,1997.0,11,11,0
EGY,ARE,2004.0,8,7,1
EGY,POL,2007.0,1,2,-1
HUN,AUT,2007.0,8,16,-8
NOR,TUR,2019.0,3,5,-2
TUR,CHN,2022.0,9,13,-4
VNM,USA,2002.0,6,5,1
JOR,CAN,1997.0,7,3,4
ISR,ITA,2001.0,11,21,-10
RUS,DNK,2002.0,10,6,4
TUR,NZL,2003.0,1,1,0
IND,SAU,2006.0,11,8,3
IRL,POL,2013.0,12,5,7
MEX,BRA,1997.0,2,1,1
USA,CYP,2001.0,7,3,4
RUS,SVK,2013.0,3,3,0
FIN,NOR,2014.0,20,7,13
IND,IRL,2003.0,6,3,3
BGR,NLD,2016.0,1,3,-2
USA,DOM,2011.0,5,3,2
DEU,LUX,2005.0,9,4,5
IND,SWE,2000.0,13,6,7
LAO,AUS,2011.0,4,3,1
MYS,CHN,2014.0,7,2,5
RUS,NOR,1997.0,8,6,2
CHL,COL,2005.0,6,4,2
CAN,SGP,2001.0,17,17,0
BEL,MEX,2014.0,8,5,3
PAK,NOR,2014.0,4,5,-1
PAK,EGY,2012.0,5,1,4
EGY,PAK,2016.0,2,1,1
LVA,DEU,1997.0,2,2,0
DNK,FRO,2009.0,3,3,0
DEU,ISR,2007.0,21,39,-18
FRA,ARG,2002.0,19,25,-6
FIN,DNK,2016.0,28,14,14
LVA,DEU,2002.0,6,8,-2
CAN,AUT,2002.0,12,12,0
ISL,NOR,2014.0,10,7,3
CHE,IND,2004.0,8,20,-12
BRA,UKR,1998.0,1,4,-3
BEL,KOR,2006.0,4,6,-2
CZE,AUS,2000.0,3,1,2
URY,ESP,2003.0,8,11,-3
NLD,AUT,2009.0,8,12,-4
FRA,POL,2020.0,45,31,14
TUN,CAN,2019.0,14,3,11
HUN,NLD,2009.0,14,7,7
SVK,NLD,1999.0,1,1,0
JPN,IRN,2019.0,13,21,-8
HKG,FRA,2004.0,2,5,-3
BOL,USA,2002.0,7,7,0
UZB,USA,2004.0,7,3,4
SGP,CHN,1999.0,16,74,-58
ZAF,CHE,2004.0,6,4,2
ESP,ARE,2020.0,5,5,0
FRA,IRL,1999.0,13,4,9
GBR,LVA,2007.0,3,1,2
LBN,FRA,2003.0,15,30,-15
ZAF,DEU,2008.0,12,26,-14
AUS,FRA,2005.0,43,42,1
RUS,MEX,2015.0,4,6,-2
KOR,CAN,2014.0,48,38,10
USA,COG,2022.0,3,2,1
CUB,CAN,2010.0,4,3,1
MEX,PAN,2013.0,1,2,-1
JPN,SRB,2016.0,1,1,0
NZL,IRL,2017.0,5,4,1
CUB,ARG,2015.0,8,3,5
MEX,ARG,2010.0,8,10,-2
SVN,JPN,2015.0,4,1,3
CZE,RUS,2010.0,4,12,-8
ISR,KOR,2008.0,1,2,-1
PSE,USA,2015.0,11,7,4
SEN,USA,1998.0,2,8,-6
MEX,IND,1999.0,3,4,-1
DEU,EST,1999.0,3,3,0
ETH,CHN,2018.0,13,9,4
BGD,DEU,2015.0,8,12,-4
ISR,CZE,2020.0,6,1,5
BRA,CHE,2014.0,25,13,12
CHN,BRA,2013.0,7,5,2
DOM,DMA,2018.0,6,4,2
POL,ESP,2017.0,19,26,-7
POL,ESP,2018.0,24,28,-4
EST,SWE,2015.0,12,9,3
CHL,ARG,2020.0,30,24,6
COG,ITA,2013.0,1,1,0
UKR,ITA,2024.0,1,1,0
ISR,SWE,2018.0,3,7,-4
IRL,IND,2017.0,12,27,-15
IND,DNK,2023.0,13,13,0
SHN,GBR,2016.0,3,1,2
NZL,PRT,2005.0,1,2,-1
HKG,JPN,2020.0,20,13,7
CHN,PAK,2014.0,67,103,-36
PHL,THA,2007.0,3,4,-1
ITA,THA,2011.0,4,3,1
HRV,GBR,2010.0,4,9,-5
AUS,MEX,2008.0,4,9,-5
JPN,DNK,2016.0,9,11,-2
MEX,CUB,2013.0,7,14,-7
RUS,MYS,2022.0,1,1,0
RUS,UZB,2019.0,15,5,10
MAC,CHN,2014.0,30,55,-25
ARG,PER,2001.0,2,1,1
PER,ARG,2003.0,2,2,0
MEX,NZL,2019.0,5,2,3
CZE,MEX,2020.0,3,6,-3
IRL,IND,2022.0,13,65,-52
ARG,ITA,2018.0,19,16,3
MKD,NLD,2014.0,2,1,1
TWN,TUR,2016.0,2,2,0
NZL,PAK,2014.0,9,6,3
PRT,DNK,2018.0,11,4,7
ROU,POL,2014.0,4,1,3
SWE,AUT,2018.0,19,34,-15
CYP,DEU,2011.0,4,3,1
QAT,DEU,2015.0,3,5,-2
LBN,CAN,2016.0,11,12,-1
USA,LBR,2019.0,8,12,-4
SRB,ESP,2023.0,1,1,0
POL,IRN,2017.0,3,6,-3
BEL,ARE,2014.0,1,1,0
CHN,PRT,2024.0,2,1,1
CHE,POL,2016.0,19,21,-2
DNK,ITA,2014.0,20,35,-15
USA,BLR,2016.0,6,3,3
ISR,JPN,2014.0,3,2,1
IRN,KOR,2023.0,18,5,13
CHE,KEN,2013.0,4,5,-1
IND,HUN,2021.0,7,5,2
KOR,AUT,2014.0,5,3,2
PAK,SWE,2019.0,6,7,-1
AUS,THA,2005.0,30,9,21
NGA,TWN,2008.0,1,1,0
NOR,CHN,2011.0,13,20,-7
HKG,SGP,2012.0,27,22,5
FIN,IND,2006.0,1,4,-3
PAK,SWE,2011.0,12,5,7
BEL,IND,2019.0,29,32,-3
FRA,DNK,2016.0,36,49,-13
POL,BLR,2001.0,4,7,-3
ARE,SAU,2015.0,7,26,-19
HKG,AUS,2023.0,28,38,-10
BFA,FRA,2017.0,10,23,-13
BFA,FRA,2022.0,7,7,0
FRA,HUN,2023.0,2,4,-2
KAZ,GBR,2023.0,7,3,4
HKG,FRA,2008.0,10,10,0
IRQ,DEU,2021.0,6,10,-4
KOR,HKG,2015.0,13,6,7
MNG,CHN,2012.0,1,7,-6
KWT,AUS,2016.0,4,4,0
SVK,SVN,2022.0,2,11,-9
ESP,MOZ,2017.0,3,6,-3
BLR,USA,2019.0,6,3,3
DEU,NPL,2016.0,4,2,2
IRL,GRC,2023.0,10,8,2
FRA,ARE,2016.0,17,7,10
MUS,CHE,2019.0,2,1,1
USA,EST,2023.0,3,9,-6
NPL,DEU,2020.0,2,3,-1
PER,ECU,2020.0,5,10,-5
KOR,DEU,2016.0,70,50,20
ISL,GBR,1998.0,1,2,-1
VEN,ECU,2020.0,30,17,13
IRL,NZL,2002.0,6,2,4
CHE,ARG,2017.0,8,11,-3
HUN,AUS,2021.0,6,2,4
GRC,JPN,2013.0,3,2,1
LBN,CHE,2017.0,4,3,1
JPN,ISR,2020.0,5,10,-5
ARE,MKD,2016.0,1,1,0
DNK,ESP,2010.0,17,23,-6
EGY,SWE,2019.0,5,7,-2
THA,ZMB,2018.0,1,2,-1
ESP,MAR,2019.0,18,14,4
DNK,BRA,2022.0,4,31,-27
ESP,SAU,2019.0,15,3,12
BRA,RUS,2022.0,8,4,4
AUS,CYP,2017.0,4,3,1
USA,MNG,2016.0,5,2,3
TWN,HKG,2020.0,20,21,-1
CHN,UGA,2020.0,8,1,7
AUS,JOR,2019.0,6,2,4
IRL,TZA,2022.0,2,1,1
SWE,HKG,2019.0,3,5,-2
TWN,PHL,2019.0,7,15,-8
HUN,NZL,2012.0,2,0,2
,BWA,2008.0,63,0,63
,NAM,2008.0,16,0,16
,ECU,2005.0,83,0,83
,GEO,2007.0,157,0,157
,YEM,2008.0,48,0,48
ISL,,2018.0,115,0,115
CHE,LAO,2016.0,4,0,4
SDN,,2016.0,72,0,72
PER,,2015.0,138,0,138
CUB,COL,2008.0,3,0,3
CZE,LKA,2012.0,2,0,2
GMB,,2019.0,14,0,14
DNK,LUX,2009.0,1,0,1
PRI,,2013.0,90,0,90
,ISL,2006.0,119,0,119
GUF,CHE,2011.0,1,0,1
PRY,,2018.0,24,0,24
MLT,,2016.0,29,0,29
,PHL,2007.0,285,0,285
,ALB,2007.0,65,0,65
LAO,,2013.0,14,0,14
SMR,,2022.0,10,0,10
TUR,OMN,2013.0,3,0,3
MYS,KEN,2012.0,1,0,1
QAT,CHE,2023.0,1,0,1
MTQ,REU,2013.0,1,0,1
SDN,,2017.0,71,0,71
,MLT,2009.0,55,0,55
HRV,SWE,2019.0,6,0,6
,ALB,1999.0,16,0,16
MYS,CZE,2015.0,6,0,6
,JAM,2008.0,38,0,38
,REU,2011.0,11,0,11
ESP,ZWE,2013.0,1,0,1
MNG,,2014.0,32,0,32
FJI,,2019.0,28,0,28
BRA,LVA,2017.0,2,0,2
,ZMB,2009.0,72,0,72
,FRO,2008.0,7,0,7
FRO,,2024.0,49,0,49
PHL,,2014.0,127,0,127
,LKA,2010.0,240,0,240
BRA,ARE,2011.0,2,0,2
NLD,SAU,2011.0,4,0,4
NCL,,2018.0,17,0,17
,MKD,2011.0,204,0,204
MKD,,2014.0,62,0,62
,MDA,2008.0,48,0,48
MKD,,2015.0,80,0,80
RUS,MAC,2013.0,2,0,2
YEM,QAT,2016.0,1,0,1
PRY,,2017.0,29,0,29
EGY,SVK,2016.0,1,0,1
SGP,IRL,2003.0,1,0,1
PER,,2014.0,127,0,127
ECU,PRT,2023.0,1,0,1
UKR,AUS,2018.0,3,0,3
AUS,SYC,2012.0,2,0,2
NCL,,2017.0,17,0,17
,MWI,2007.0,67,0,67
LVA,SVN,2023.0,1,0,1
CHN,CMR,2017.0,3,0,3
PYF,NCL,2013.0,3,0,3
NCL,CHN,2020.0,1,0,1
PLW,,2022.0,5,0,5
RWA,TZA,2018.0,2,0,2
CAN,HTI,2020.0,1,0,1
ITA,SYR,2019.0,1,0,1
DOM,,2019.0,20,0,20
,TLS,2011.0,10,0,10
MYS,ITA,2017.0,8,0,8
JOR,DZA,2014.0,2,0,2
,BLR,2010.0,206,0,206
,GEO,2020.0,88,0,88
MTQ,,2017.0,9,0,9
HUN,THA,2020.0,1,0,1
JPN,SRB,2005.0,12,0,12
PRY,,2016.0,15,0,15
GMB,,2021.0,12,0,12
,URY,2005.0,162,0,162
MDA,MDV,2020.0,3,0,3
ESP,AZE,2018.0,1,0,1
EGY,LBY,2006.0,2,0,2
SDN,IRL,2012.0,1,0,1
KNA,ESP,2020.0,2,0,2
BEN,,2017.0,54,0,54
NPL,SGP,2014.0,4,0,4
LBY,,2017.0,55,0,55
,PNG,2011.0,30,0,30
KAZ,THA,2014.0,2,0,2
THA,KAZ,2018.0,2,0,2
DNK,NER,2014.0,1,0,1
MYS,SWE,2011.0,5,0,5
UZB,UKR,2011.0,2,0,2
IRL,MCO,2016.0,1,0,1
ISL,,2016.0,99,0,99
ETH,GEO,2015.0,1,0,1
,QAT,2010.0,148,0,148
BEN,,2016.0,40,0,40
DNK,JOR,2018.0,2,0,2
,GIN,2005.0,16,0,16
HUN,MKD,2021.0,1,0,1
LBY,,2018.0,54,0,54
CUB,NZL,2017.0,1,0,1
LTU,PRT,2014.0,1,0,1
IRN,LUX,2018.0,3,0,3
IND,PSE,2019.0,1,0,1
BGD,,2002.0,62,0,62
,BOL,2007.0,48,0,48
MEX,IRN,2019.0,2,0,2
,LCA,2014.0,3,0,3
,GRL,2014.0,9,0,9
BEN,,2018.0,45,0,45
GEO,GAB,2001.0,2,0,2
VNM,ESP,2008.0,4,0,4
,JAM,2014.0,43,0,43
CUB,JOR,2014.0,1,0,1
,YEM,2014.0,42,0,42
,MDA,2014.0,86,0,86
,BWA,2014.0,93,0,93
PRY,,2022.0,72,0,72
TZA,ISL,2021.0,1,0,1
,KNA,2014.0,10,0,10
CHL,GRC,2021.0,4,0,4
PYF,,2020.0,16,0,16
SLV,ESP,2005.0,3,0,3
BRN,RUS,2016.0,2,0,2
,MNE,2007.0,30,0,30
CZE,PER,2018.0,1,0,1
GTM,CHL,2021.0,2,0,2
UZB,KOR,1998.0,2,0,2
CHE,ECU,2017.0,2,0,2
,FRO,2014.0,6,0,6
CZE,BLR,2002.0,3,0,3
ZMB,AUS,2010.0,1,0,1
MAC,SWE,2016.0,1,0,1
TUR,KEN,2008.0,2,0,2
KAZ,,2012.0,48,0,48
AZE,,2004.0,22,0,22
BEL,NOR,1999.0,6,0,6
,CRI,1997.0,61,0,61
BEL,TWN,2003.0,1,0,1
UGA,,2000.0,8,0,8
USA,TON,2020.0,2,0,2
AZE,,2001.0,23,0,23
,KGZ,1995.0,19,0,19
LAO,BEL,2011.0,1,0,1
TWN,ESP,2021.0,4,0,4
ZAF,ARE,2003.0,2,0,2
CHL,AUS,2002.0,3,0,3
SVK,ISR,2000.0,2,0,2
AFG,PAK,2004.0,2,0,2
MKD,BGR,2014.0,1,0,1
CHE,SVN,2009.0,3,0,3
GEO,CHE,2005.0,2,0,2
PHL,SGP,2000.0,3,0,3
SWE,ARE,2003.0,4,0,4
DEU,AZE,2005.0,1,0,1
DNK,TZA,1997.0,2,0,2
,BHR,1997.0,32,0,32
AZE,,2015.0,129,0,129
,BIH,1997.0,70,0,70
TTO,AUS,2000.0,1,0,1
BLR,CHE,1999.0,4,0,4
BLR,FRA,2011.0,2,0,2
MKD,,2008.0,20,0,20
GLP,,2007.0,4,0,4
MYS,LAO,2010.0,2,0,2
GLP,,1999.0,4,0,4
GTM,CAN,1999.0,2,0,2
UZB,,2002.0,53,0,53
NPL,,2017.0,104,0,104
,TGO,1999.0,10,0,10
BEL,FRA,2024.0,3,0,3
ZWE,NGA,2004.0,4,0,4
BLR,ISR,2006.0,1,0,1
UGA,FRA,2003.0,3,0,3
MYS,JOR,1999.0,1,0,1
GMB,FRA,2007.0,2,0,2
LUX,FIN,2018.0,1,0,1
MEX,HUN,2022.0,3,0,3
GHA,,2014.0,76,0,76
JPN,PRT,2004.0,2,0,2
ARG,IRL,2020.0,5,0,5
ETH,CIV,2000.0,1,0,1
NAM,,2009.0,12,0,12
RUS,ARG,2001.0,2,0,2
,QAT,2000.0,53,0,53
DNK,ARG,2002.0,3,0,3
AUS,UGA,2001.0,1,0,1
TJK,DEU,2017.0,3,0,3
SLV,SVK,2018.0,9,0,9
DJI,,2007.0,3,0,3
ESP,HND,2021.0,3,0,3
KEN,SOM,2023.0,3,0,3
ERI,CHN,2018.0,1,0,1
JOR,ESP,2019.0,5,0,5
ISL,,2026.0,20,0,20
,BDI,2017.0,21,0,21
BRA,HKG,2018.0,2,0,2
MOZ,NER,2020.0,1,0,1
ZMB,ETH,2019.0,1,0,1
COL,GRD,2018.0,1,0,1
,MDA,2015.0,52,0,52
,MDG,2007.0,55,0,55
,MLI,2014.0,70,0,70
MWI,HKG,2022.0,2,0,2
BRN,VNM,2019.0,1,0,1
IRN,LUX,2016.0,1,0,1
NOR,ECU,2021.0,1,0,1
KEN,GMB,2021.0,1,0,1
AUS,KAZ,2009.0,1,0,1
TUR,LUX,2020.0,2,0,2
CHN,TKM,2016.0,3,0,3
,MKD,2009.0,174,0,174
,MRT,2015.0,8,0,8
GIN,MLI,2018.0,6,0,6
,BRN,2002.0,11,0,11
FJI,CHN,2016.0,1,0,1
THA,KWT,2013.0,1,0,1
IRL,EST,2001.0,1,0,1
CZE,BFA,2020.0,1,0,1
,SUR,2013.0,18,0,18
COL,AUT,2017.0,3,0,3
EGY,PAK,2002.0,2,0,2
,IDN,2021.0,19,0,19
TZA,PHL,2021.0,1,0,1
KOR,NLD,2001.0,6,0,6
,VIR,2002.0,1,0,1
BEL,MOZ,2016.0,1,0,1
DNK,TZA,2005.0,2,0,2
,QAT,2006.0,92,0,92
KEN,NGA,2001.0,3,0,3
NLD,MLI,2006.0,2,0,2
RUS,ROU,2006.0,1,0,1
,PRY,2012.0,27,0,27
HRV,IND,2018.0,1,0,1
BEN,BFA,2013.0,5,0,5
,SLE,2019.0,47,0,47
MAR,BFA,2019.0,2,0,2
,NCL,1994.0,30,0,30
,SMR,2018.0,5,0,5
ZWE,BEL,2023.0,1,0,1
,BTN,2002.0,6,0,6
,BFA,2005.0,77,0,77
BFA,,2012.0,28,0,28
PRI,BRA,2002.0,4,0,4
POL,BRA,2001.0,4,0,4
PRI,,2003.0,41,0,41
LKA,DEU,1998.0,2,0,2
KAZ,,2005.0,34,0,34
HTI,USA,1998.0,4,0,4
CUB,GBR,2006.0,3,0,3
BWA,AUS,1997.0,1,0,1
KEN,,2000.0,32,0,32
NZL,KHM,2001.0,1,0,1
NZL,COL,2004.0,1,0,1
KWT,SWE,2000.0,1,0,1
ITA,HKG,2009.0,3,0,3
,BMU,1994.0,7,0,7
SLB,,2013.0,7,0,7
HRV,FIN,2000.0,1,0,1
SDN,MWI,1999.0,1,0,1
CHL,MEX,1997.0,1,0,1
ZAF,CPV,2005.0,1,0,1
COL,PRI,1997.0,1,0,1
UKR,NZL,1998.0,2,0,2
MEX,FIN,2007.0,1,0,1
TJK,,2007.0,5,0,5
NCL,,2016.0,13,0,13
OMN,TTO,2012.0,1,0,1
,GIN,1997.0,5,0,5
JOR,BHR,2005.0,4,0,4
IRN,BEL,2000.0,2,0,2
FIN,CHL,1997.0,1,0,1
MLI,,2000.0,5,0,5
,MLI,2001.0,29,0,29
TTO,CAN,1998.0,1,0,1
,HND,2000.0,6,0,6
HND,,2011.0,6,0,6
MLI,CHE,2006.0,1,0,1
CIV,SAU,1998.0,1,0,1
SRB,JPN,2007.0,7,0,7
FLK,USA,2000.0,1,0,1
ECU,MCO,2007.0,1,0,1
MCO,,2017.0,11,0,11
MNE,,2026.0,3,0,3
ZAF,ROU,2014.0,1,0,1
AGO,,2024.0,51,0,51
BGR,SAU,2002.0,1,0,1
,SLE,1994.0,10,0,10
GRD,,2024.0,44,0,44
VEN,SRB,2001.0,6,0,6
IRQ,ITA,2002.0,1,0,1
HKG,SRB,2009.0,2,0,2
,NCL,2009.0,10,0,10
IRQ,LBY,2002.0,3,0,3
ROU,CHN,2012.0,2,0,2
,KWT,2007.0,161,0,161
SOM,USA,2016.0,1,0,1
LTU,ROU,2007.0,1,0,1
PAK,PSE,2013.0,1,0,1
HUN,BGD,2015.0,1,0,1
MCO,,2016.0,10,0,10
PHL,PRT,2011.0,1,0,1
PRT,SAU,2013.0,2,0,2
BDI,,2020.0,12,0,12
NOR,IDN,2013.0,1,0,1
,SLE,2011.0,15,0,15
AZE,KOR,2013.0,1,0,1
IND,LVA,2014.0,1,0,1
LVA,BRA,2018.0,1,0,1
,TGO,2007.0,43,0,43
PER,JPN,2011.0,4,0,4
MAR,ZAF,2014.0,2,0,2
CAN,KNA,2012.0,2,0,2
NGA,MOZ,2011.0,1,0,1
VEN,ARG,2015.0,2,0,2
,ABW,2007.0,1,0,1
NLD,ARE,2006.0,3,0,3
,SWZ,2007.0,13,0,13
TTO,DOM,2011.0,1,0,1
DOM,GBR,2013.0,1,0,1
POL,AFG,2016.0,1,0,1
CHE,LAO,2018.0,3,0,3
FJI,,2011.0,10,0,10
NGA,LAO,2016.0,1,0,1
ZWE,NOR,2011.0,1,0,1
HKG,SVN,2021.0,1,0,1
BDI,EGY,2020.0,1,0,1
QAT,IND,2002.0,1,0,1
ITA,KAZ,2013.0,3,0,3
GAB,,2014.0,18,0,18
BWA,BEN,2020.0,1,0,1
DNK,ARG,2012.0,1,0,1
MWI,IRL,2011.0,1,0,1
SWE,MKD,2004.0,1,0,1
,LAO,2013.0,42,0,42
RWA,DNK,2016.0,1,0,1
,TCD,2013.0,11,0,11
BWA,TUR,2019.0,1,0,1
GBR,GLP,2022.0,1,0,1
PAK,LAO,2018.0,1,0,1
,GIN,2012.0,31,0,31
NPL,SWE,2015.0,2,0,2
USA,FSM,2016.0,5,0,5
,DOM,2017.0,41,0,41
,GRD,2013.0,18,0,18
FLK,,2024.0,7,0,7
,AND,2006.0,29,0,29
SLV,,2020.0,18,0,18
NER,,2020.0,24,0,24
BLR,ISR,2023.0,1,0,1
,NAM,2014.0,44,0,44
SVK,IRQ,2016.0,2,0,2
SDN,SSD,2018.0,7,0,7
GBR,BIH,2015.0,2,0,2
CHL,AFG,2018.0,1,0,1
,GUM,2013.0,6,0,6
NLD,KAZ,2018.0,3,0,3
,CAF,2012.0,10,0,10
NLD,KAZ,2016.0,1,0,1
GTM,,2013.0,18,0,18
ESP,MLI,2021.0,1,0,1
MWI,SLE,2021.0,1,0,1
TWN,PER,2020.0,2,0,2
PRK,,2021.0,19,0,19
ISR,PRT,2022.0,4,0,4
NCL,,2022.0,32,0,32
EGY,MCO,2021.0,1,0,1
GNQ,,2021.0,4,0,4
PAK,LTU,2020.0,1,0,1
EGY,ROU,2022.0,1,0,1
AUS,BEN,2016.0,1,0,1
BEL,ARG,2023.0,4,0,4
,BDI,2016.0,20,0,20
IND,GRC,2019.0,4,0,4
SEN,GMB,2020.0,3,0,3
CPV,,2024.0,35,0,35
,SLE,2009.0,24,0,24
COD,MAR,2022.0,1,0,1
YEM,SOM,2022.0,1,0,1
SWE,UGA,2021.0,4,0,4
,PRY,2005.0,16,0,16
,BMU,2019.0,8,0,8
BMU,,2024.0,17,0,17
PRT,BOL,2021.0,1,0,1
BEN,NLD,2023.0,4,0,4
MRT,GIN,2021.0,1,0,1
,BHR,2005.0,33,0,33
,SDN,2020.0,147,0,147
NPL,,2026.0,29,0,29
NPL,DMA,2022.0,2,0,2
JPN,ROU,2013.0,7,0,7
BIH,CZE,2020.0,1,0,1
PRT,HUN,1998.0,1,0,1
BIH,NOR,2009.0,4,0,4
,MLT,1994.0,41,0,41
CHE,BIH,2008.0,2,0,2
GRC,HUN,2002.0,3,0,3
PHL,BEL,2002.0,1,0,1
BGR,ISR,2010.0,2,0,2
CUB,MDA,2023.0,1,0,1
NLD,LUX,2003.0,3,0,3
SAU,CYP,2012.0,1,0,1
LUX,SRB,2005.0,1,0,1
USA,UZB,1998.0,1,0,1
JPN,PAN,1997.0,1,0,1
AFG,,2012.0,10,0,10
BWA,,2018.0,48,0,48
POL,LTU,2010.0,3,0,3
ISR,FIN,2002.0,4,0,4
MDA,KOR,2003.0,1,0,1
IRL,JAM,2002.0,1,0,1
BEN,NGA,2017.0,8,0,8
MKD,RUS,2002.0,1,0,1
COL,CHL,2000.0,2,0,2
AUT,QAT,2016.0,1,0,1
AUT,BGR,2014.0,3,0,3
MEX,MAR,2022.0,1,0,1
VEN,JPN,2006.0,1,0,1
FRA,PER,2007.0,8,0,8
ARG,HUN,2008.0,1,0,1
AUS,TTO,2005.0,1,0,1
LAO,GBR,2016.0,3,0,3
BLR,VNM,2017.0,2,0,2
BGD,LTU,2020.0,1,0,1
YEM,ITA,2019.0,2,0,2
SAU,AZE,2019.0,3,0,3
BEL,SEN,2020.0,2,0,2
IRQ,TWN,2017.0,2,0,2
CAN,MRT,2021.0,1,0,1
,SSD,2012.0,3,0,3
DZA,EGY,2006.0,2,0,2
BGD,BTN,2020.0,1,0,1
,COM,2009.0,3,0,3
GHA,IRL,2023.0,2,0,2
CUB,DNK,2022.0,1,0,1
ASM,,2022.0,2,0,2
BGD,OMN,2018.0,2,0,2
AUT,PSE,2014.0,1,0,1
COG,IDN,2022.0,1,0,1
GRC,PAK,2023.0,1,0,1
,ARM,2020.0,100,0,100
PAK,SVK,2018.0,1,0,1
,AND,2019.0,5,0,5
KOR,MKD,2022.0,1,0,1
TGO,BEN,2023.0,2,0,2
ECU,NLD,2013.0,1,0,1
BGR,GEO,2015.0,1,0,1
COL,KHM,2014.0,1,0,1
NER,,2012.0,10,0,10
MOZ,PRT,2017.0,3,0,3
THA,VNM,2010.0,5,0,5
PRT,PAK,2007.0,1,0,1
CAN,SEN,1998.0,1,0,1
ESP,BOL,2017.0,7,0,7
KOR,MMR,2011.0,1,0,1
BFA,AUS,2016.0,1,0,1
FRA,AFG,2014.0,1,0,1
JOR,MYS,2005.0,1,0,1
HRV,SWE,2006.0,1,0,1
TZA,AUT,2009.0,3,0,3
CCK,USA,2016.0,1,0,1
MKD,CAN,2011.0,1,0,1
GHA,ETH,2017.0,3,0,3
MYS,SYR,2019.0,2,0,2
BRN,CHE,2020.0,1,0,1
SYR,AUT,2011.0,1,0,1
,MNE,2005.0,18,0,18
TUR,VEN,2006.0,1,0,1
USA,IRQ,2002.0,2,0,2
GBR,BMU,2017.0,3,0,3
TUN,QAT,2021.0,3,0,3
CAN,BLZ,2018.0,2,0,2
SLV,HRV,2009.0,1,0,1
,ERI,2006.0,1,0,1
GIN,BFA,2008.0,2,0,2
MUS,USA,2006.0,1,0,1
CHN,LBY,2006.0,1,0,1
LBY,CHN,2014.0,1,0,1
BGR,HRV,2017.0,1,0,1
BEL,CIV,2003.0,2,0,2
GIB,,2016.0,1,0,1
PRT,IRQ,2021.0,2,0,2
GBR,NAM,2013.0,3,0,3
KOR,PER,2014.0,1,0,1
CHN,SRB,2011.0,1,0,1
PHL,CHN,1997.0,2,0,2
HRV,IRN,2020.0,1,0,1
SOM,KEN,2018.0,1,0,1
,GNQ,2012.0,6,0,6
DNK,KHM,2019.0,1,0,1
BRA,CPV,2020.0,2,0,2
GRC,GEO,2017.0,1,0,1
COG,SAU,2019.0,6,0,6
SAU,COD,2020.0,5,0,5
TGO,CHN,2013.0,1,0,1
KOR,KWT,2022.0,1,0,1
HUN,ARM,2013.0,1,0,1
ARM,BEL,2016.0,2,0,2
SEN,TUN,1998.0,1,0,1
BHR,KOR,2022.0,1,0,1
HRV,MNE,2015.0,2,0,2
BEL,GNQ,2016.0,1,0,1
KNA,JPN,2021.0,1,0,1
,PAN,2001.0,19,0,19
DMA,,2016.0,3,0,3
UKR,KOR,1998.0,3,0,3
,BLZ,2001.0,6,0,6
MYS,OMN,2005.0,2,0,2
ZWE,CHN,2001.0,3,0,3
,GIN,2007.0,10,0,10
JAM,,2002.0,8,0,8
PNG,,2006.0,14,0,14
IND,SYR,2000.0,1,0,1
SYR,TUR,2003.0,1,0,1
IND,IRN,2000.0,3,0,3
GMB,,2006.0,8,0,8
AUS,BRB,2007.0,1,0,1
FIN,GHA,2009.0,2,0,2
MOZ,,2003.0,5,0,5
JOR,ESP,2023.0,1,0,1
,GIN,2020.0,17,0,17
,CYM,2018.0,2,0,2
TTO,AUS,2019.0,2,0,2
,BHR,2020.0,67,0,67
CUB,SWE,2008.0,1,0,1
UKR,DMA,2018.0,1,0,1
UKR,LTU,2022.0,7,0,7
,PRK,2020.0,60,0,60
AUS,SRB,2010.0,1,0,1
ECU,FRA,1998.0,1,0,1
AGO,,2009.0,4,0,4
USA,SOM,2018.0,5,0,5
MDA,FIN,1997.0,2,0,2
FIN,MDA,2000.0,2,0,2
MDA,FIN,2002.0,1,0,1
AUS,CHL,1998.0,2,0,2
KGZ,KAZ,2007.0,1,0,1
ETH,,2007.0,28,0,28
NGA,KEN,1997.0,2,0,2
SGP,HUN,2007.0,2,0,2
OMN,NGA,2003.0,2,0,2
ITA,NZL,1998.0,2,0,2
DNK,FRO,2004.0,3,0,3
FIN,NGA,2000.0,1,0,1
CMR,DEU,1997.0,3,0,3
ARG,ISR,2009.0,2,0,2
ASM,,2017.0,3,0,3
GRD,USA,2000.0,1,0,1
IDN,COL,2017.0,1,0,1
GBR,AZE,2004.0,1,0,1
GBR,AZE,2008.0,3,0,3
FIN,HKG,2002.0,1,0,1
UZB,GBR,1998.0,2,0,2
FJI,,2006.0,10,0,10
FIN,CYM,2009.0,1,0,1
DJI,,2002.0,1,0,1
SVK,TUR,2002.0,1,0,1
FRA,TTO,2000.0,1,0,1
GBR,DZA,2013.0,4,0,4
PAK,NGA,2006.0,1,0,1
PSE,,2010.0,18,0,18
PYF,CHN,2020.0,1,0,1
CAN,JAM,2006.0,1,0,1
MWI,SEN,2005.0,1,0,1
NLD,LBN,2000.0,1,0,1
LBN,NLD,2003.0,1,0,1
MWI,ZMB,2008.0,1,0,1
BOL,ESP,2007.0,3,0,3
ITA,TWN,2003.0,3,0,3
TZA,FIN,2000.0,1,0,1
CAF,GBR,1998.0,1,0,1
GMB,IRL,1998.0,1,0,1
GHA,PER,2015.0,1,0,1
NOR,CZE,2007.0,3,0,3
PSE,GBR,1999.0,1,0,1
PSE,ARE,2005.0,2,0,2
BRA,UKR,2022.0,1,0,1
SWE,BRN,2021.0,1,0,1
ARM,GRC,1998.0,1,0,1
USA,NAM,2007.0,1,0,1
BRN,SAU,2001.0,1,0,1
ZMB,NOR,2002.0,1,0,1
BFA,GIN,2019.0,2,0,2
SLV,,2012.0,8,0,8
TUN,BRA,2023.0,1,0,1
IRN,THA,2021.0,7,0,7
MYS,DNK,2017.0,8,0,8
GEO,CZE,2009.0,1,0,1
MEX,ECU,2010.0,1,0,1
BEL,SVK,2021.0,3,0,3
USA,GUF,2009.0,2,0,2
PAK,UKR,2018.0,1,0,1
ZAF,SRB,2010.0,1,0,1
ESP,NPL,2020.0,2,0,2
SYR,MAR,2020.0,2,0,2
NPL,CAN,2007.0,1,0,1
POL,LAO,2013.0,1,0,1
IRN,BHR,2017.0,1,0,1
BTN,,2016.0,4,0,4
BHR,DEU,2014.0,1,0,1
JOR,POL,2020.0,1,0,1
KOR,BRN,2014.0,1,0,1
,MHL,2007.0,2,0,2
,TGO,2002.0,14,0,14
JPN,MMR,2009.0,3,0,3
KOR,COL,2011.0,1,0,1
KNA,IND,2013.0,1,0,1
HND,CRI,2017.0,2,0,2
BOL,GHA,2016.0,1,0,1
GEO,ISR,2013.0,1,0,1
,BMU,2010.0,6,0,6
MEX,SGP,2020.0,2,0,2
COL,IRL,2018.0,3,0,3
IDN,LBR,2017.0,1,0,1
SWE,GTM,2019.0,1,0,1
GTM,SWE,2021.0,1,0,1
IND,SLE,2020.0,1,0,1
SVK,NOR,2014.0,4,0,4
DMA,,2022.0,3,0,3
VEN,BEL,2020.0,2,0,2
KEN,BDI,2019.0,1,0,1
UKR,AZE,2014.0,2,0,2
MDV,,2015.0,1,0,1
,REU,2010.0,13,0,13
ARG,DNK,2022.0,3,0,3
,SOM,2011.0,1,0,1
URY,COL,2015.0,1,0,1
AUS,TZA,2016.0,4,0,4
SEN,CIV,2016.0,3,0,3
ARG,HND,2020.0,1,0,1
MEX,QAT,2020.0,1,0,1
ROU,TUN,2016.0,1,0,1
THA,ARE,2016.0,1,0,1
SYR,HUN,2017.0,1,0,1
LKA,ITA,2017.0,1,0,1
NZL,TZA,2022.0,1,0,1
PAK,BHR,2017.0,1,0,1
FRA,LIE,2022.0,1,0,1
ROU,KNA,2020.0,1,0,1
IRL,IRQ,2019.0,3,0,3
ZWE,ARE,2023.0,2,0,2
NGA,GMB,2021.0,4,0,4
MYS,ISR,2016.0,1,0,1
SVK,CAN,2020.0,1,0,1
IRN,BGD,2020.0,2,0,2
MHL,,2021.0,2,0,2
SEN,CHN,2009.0,1,0,1
FIN,CYP,2022.0,1,0,1
QAT,POL,2018.0,1,0,1
HTI,,2000.0,3,0,3
CHN,COG,2019.0,1,0,1
ESP,ETH,2023.0,2,0,2
GMB,FRA,2012.0,2,0,2
,SUR,2015.0,13,0,13
SAU,ISR,2019.0,1,0,1
THA,GHA,2020.0,1,0,1
ZAF,GHA,2003.0,2,0,2
CAN,SYR,2022.0,1,0,1
ZAF,HUN,2019.0,3,0,3
ISL,JOR,2022.0,1,0,1
LUX,MMR,2022.0,1,0,1
NGA,EGY,2010.0,3,0,3
CHE,SLE,2019.0,1,0,1
PER,SWE,2001.0,1,0,1
GMB,BWA,2000.0,1,0,1
SVK,EGY,2006.0,1,0,1
PAK,CHN,2000.0,2,0,2
VEN,URY,2017.0,1,0,1
FRO,ISL,2014.0,1,0,1
ISL,FRO,2015.0,2,0,2
KOR,KEN,2017.0,1,0,1
EGY,IRN,2018.0,1,0,1
BHR,CAN,2004.0,2,0,2
JPN,KHM,2005.0,1,0,1
POL,SAU,2021.0,3,0,3
,MNP,1999.0,1,0,1
MCO,PRT,1997.0,1,0,1
MWI,,2004.0,11,0,11
GUY,FRA,2009.0,1,0,1
ZAF,HUN,2011.0,2,0,2
GBR,MSR,2003.0,4,0,4
OMN,CYP,2000.0,1,0,1
AUS,ZWE,2001.0,2,0,2
BLR,CHN,2002.0,2,0,2
CRI,CHE,2003.0,1,0,1
PYF,NCL,2001.0,1,0,1
USA,DMA,2001.0,1,0,1
FIN,LBY,2009.0,1,0,1
NER,MDG,2018.0,1,0,1
MEX,KOR,2000.0,1,0,1
USA,VIR,1997.0,2,0,2
ARE,KWT,1998.0,2,0,2
SLV,ESP,2020.0,1,0,1
USA,LBR,2014.0,7,0,7
SGP,EST,2017.0,1,0,1
ESP,MLT,2021.0,4,0,4
POL,BIH,2007.0,1,0,1
PAN,PSE,2007.0,2,0,2
ITA,PRT,2024.0,1,0,1
AUT,SEN,2019.0,2,0,2
LSO,AUS,2000.0,1,0,1
DNK,UGA,2022.0,2,0,2
ESP,GIB,2014.0,2,0,2
GIB,,2017.0,1,0,1
MYS,KOR,2000.0,2,0,2
NGA,VEN,2009.0,1,0,1
SLE,GBR,1999.0,3,0,3
TUR,LBY,2023.0,4,0,4
MYS,CMR,2021.0,2,0,2
DZA,CZE,2022.0,1,0,1
,FSM,2018.0,2,0,2
BGD,IRL,2022.0,6,0,6
UKR,IND,2020.0,3,0,3
SAU,GHA,2023.0,1,0,1
BRA,MCO,2019.0,1,0,1
PAK,EST,2017.0,4,0,4
KOR,HRV,2021.0,2,0,2
BGR,UZB,2012.0,2,0,2
KHM,BTN,2012.0,1,0,1
DZA,ROU,1999.0,1,0,1
BGD,ZWE,2009.0,1,0,1
CHE,DZA,2003.0,1,0,1
AUS,ARE,1997.0,2,0,2
GBR,KHM,1999.0,1,0,1
GTM,IRQ,2018.0,1,0,1
IRQ,GTM,2019.0,1,0,1
PHL,DNK,2002.0,1,0,1
LAO,NLD,2007.0,1,0,1
DEU,PAN,2009.0,3,0,3
BRA,LBN,2018.0,1,0,1
SVK,NOR,2004.0,1,0,1
COG,AGO,1999.0,1,0,1
KNA,BEL,2023.0,1,0,1
,KHM,1995.0,7,0,7
BOL,,2002.0,11,0,11
HKG,ISR,2012.0,1,0,1
BRA,FLK,2019.0,2,0,2
NGA,ITA,2001.0,1,0,1
CHE,BOL,2011.0,1,0,1
CHN,GUY,2000.0,1,0,1
FIN,KWT,2002.0,3,0,3
KWT,ROU,2006.0,1,0,1
USA,GRL,2002.0,1,0,1
ETH,EGY,2014.0,2,0,2
CHE,SVN,2000.0,3,0,3
KOR,ROU,2003.0,3,0,3
CIV,SEN,2008.0,8,0,8
MEX,IDN,2007.0,1,0,1
EST,CZE,2008.0,2,0,2
MKD,JPN,2002.0,2,0,2
MEX,VEN,1999.0,7,0,7
RUS,NGA,2001.0,1,0,1
SRB,CHE,2007.0,10,0,10
,PAN,1996.0,15,0,15
BRA,ROU,2003.0,2,0,2
BLR,BRA,2012.0,1,0,1
ITA,ARM,2023.0,2,0,2
EGY,KHM,2010.0,1,0,1
ARM,NLD,2003.0,2,0,2
LUX,SAU,2021.0,1,0,1
DNK,IDN,2001.0,1,0,1
CAN,EST,1997.0,1,0,1
MYS,KEN,1998.0,1,0,1
SRB,ISR,2007.0,2,0,2
ZWE,CUB,1999.0,1,0,1
LAO,MDG,2023.0,1,0,1
CAN,THA,1997.0,2,0,2
IDN,ZAF,2014.0,1,0,1
GNB,GNQ,2018.0,2,0,2
IND,AGO,2013.0,1,0,1
UZB,AUT,2002.0,1,0,1
SEN,CHE,2002.0,2,0,2
HUN,NZL,1998.0,2,0,2
GLP,RUS,2002.0,1,0,1
MAR,JPN,2004.0,1,0,1
MAR,JPN,2008.0,2,0,2
TUN,JAM,2008.0,1,0,1
LTU,ISR,2015.0,1,0,1
NZL,ARE,2008.0,4,0,4
IRL,BGD,2013.0,1,0,1
RWA,ZWE,2014.0,2,0,2
GRC,CHL,2016.0,1,0,1
CAN,ECU,2010.0,2,0,2
PHL,MMR,2016.0,1,0,1
ETH,OMN,2019.0,1,0,1
TUR,DNK,2016.0,7,0,7
MNG,AUS,2013.0,1,0,1
UZB,ESP,2015.0,1,0,1
BRA,ARE,2023.0,5,0,5
FRA,MOZ,2023.0,1,0,1
IRN,SYR,2021.0,2,0,2
,SGS,2007.0,2,0,2
GRC,AUS,2014.0,12,0,12
NPL,NLD,2011.0,1,0,1
GBR,BOL,2016.0,2,0,2
NGA,THA,2014.0,1,0,1
ZAF,GUF,2014.0,1,0,1
AUS,MDV,2016.0,3,0,3
PHL,URY,2012.0,1,0,1
DNK,BIH,2011.0,2,0,2
LBR,,2014.0,3,0,3
IRL,OMN,2018.0,1,0,1
IRL,IDN,2016.0,1,0,1
CHN,HRV,2016.0,3,0,3
USA,STP,2019.0,2,0,2
ALB,GBR,2021.0,1,0,1
ZWE,POL,2016.0,1,0,1
CZE,KAZ,2021.0,1,0,1
ROU,AUT,2021.0,6,0,6
ITA,KAZ,2014.0,5,0,5
BEL,IDN,2011.0,2,0,2
ZAF,SYC,2020.0,6,0,6
UZB,MYS,2010.0,3,0,3
TZA,RWA,2015.0,2,0,2
ERI,USA,2017.0,1,0,1
MYS,LBY,2014.0,8,0,8
DNK,COL,2013.0,2,0,2
OMN,SYR,2023.0,1,0,1
MMR,NLD,2017.0,1,0,1
GHA,FIN,2013.0,2,0,2
USA,BRN,2010.0,1,0,1
BGD,GRC,2015.0,1,0,1
TUR,NOR,2003.0,2,0,2
ALB,,2005.0,3,0,3
NOR,MWI,2018.0,2,0,2
OMN,LBN,2017.0,1,0,1
ESP,GNB,2021.0,1,0,1
DNK,EST,2010.0,2,0,2
MKD,BIH,2017.0,1,0,1
GHA,PER,2008.0,1,0,1
KWT,ITA,2016.0,1,0,1
CHN,MMR,2015.0,3,0,3
SLE,ZAF,2006.0,1,0,1
FRA,LBR,2023.0,2,0,2
KWT,HKG,2017.0,1,0,1
AZE,UKR,2019.0,3,0,3
MEX,NOR,2021.0,3,0,3
,PLW,1999.0,1,0,1
EST,VNM,2019.0,6,0,6
KOR,KHM,2013.0,2,0,2
ECU,GTM,2021.0,2,0,2
JPN,SEN,2022.0,2,0,2
ISR,KOR,2011.0,3,0,3
ARE,IRQ,2022.0,3,0,3
AUS,VUT,2023.0,2,0,2
CHN,CIV,2018.0,1,0,1
BGD,SWE,2005.0,1,0,1
SVK,SAU,2022.0,1,0,1
SLE,EGY,2020.0,1,0,1
TCA,ARE,2021.0,1,0,1
PRI,CUB,2004.0,1,0,1
MLI,,2009.0,16,0,16
FIN,IRL,2001.0,1,0,1
NZL,MEX,2003.0,2,0,2
ROU,GRC,1998.0,2,0,2
,LAO,1996.0,7,0,7
ESP,LVA,1997.0,2,0,2
ITA,MDA,2012.0,1,0,1
CIV,COG,2006.0,1,0,1
AZE,BLR,2011.0,1,0,1
NER,BFA,2000.0,1,0,1
TWN,NOR,2010.0,2,0,2
NAM,,2006.0,5,0,5
,MHL,1998.0,3,0,3
PHL,GRC,2009.0,1,0,1
NAM,MWI,2015.0,1,0,1
ITA,DZA,2005.0,5,0,5
KHM,UGA,2018.0,1,0,1
CAF,ZAF,2009.0,1,0,1
TKM,,2015.0,3,0,3
CAF,,2008.0,3,0,3
CAN,GAB,2009.0,1,0,1
TGO,,2002.0,6,0,6
BEL,PAN,2011.0,2,0,2
LKA,MLI,2005.0,2,0,2
UZB,SVK,2004.0,1,0,1
PNG,USA,2016.0,2,0,2
CAN,NER,2008.0,1,0,1
TGO,,2005.0,6,0,6
JPN,BIH,2001.0,1,0,1
AUT,CYP,2023.0,2,0,2
CAN,BHR,2009.0,2,0,2
BEL,JOR,2012.0,1,0,1
CMR,CIV,2007.0,1,0,1
ISR,SVK,2004.0,2,0,2
KGZ,,2000.0,4,0,4
ITA,TCD,2015.0,1,0,1
CAN,ISL,2000.0,3,0,3
LBN,ARE,2008.0,2,0,2
CHE,CRI,2013.0,1,0,1
CHN,GEO,2004.0,2,0,2
,SLE,2000.0,3,0,3
MCO,MAR,2011.0,1,0,1
HUN,GRC,1999.0,2,0,2
UGA,KEN,2002.0,3,0,3
GRC,LVA,2002.0,1,0,1
JPN,TUN,2000.0,1,0,1
OMN,BGR,2014.0,1,0,1
BWA,NAM,1999.0,1,0,1
CUB,MYS,2010.0,1,0,1
RWA,JPN,2015.0,1,0,1
ZAF,BEN,2005.0,3,0,3
FRA,UGA,2018.0,3,0,3
USA,SYC,2017.0,2,0,2
COD,,2009.0,2,0,2
GBR,BMU,2016.0,1,0,1
SDN,GBR,2018.0,3,0,3
JAM,KNA,2013.0,1,0,1
USA,NCL,2017.0,4,0,4
BHR,LBN,2003.0,2,0,2
SVK,TUR,2012.0,4,0,4
ARG,DNK,2016.0,2,0,2
IRN,ESP,2005.0,1,0,1
MRT,MUS,2005.0,1,0,1
,PRY,1999.0,8,0,8
IRL,LVA,2014.0,1,0,1
ITA,JOR,2004.0,4,0,4
GRC,IRN,2006.0,1,0,1
GRC,IRN,2010.0,1,0,1
YEM,SAU,2012.0,3,0,3
BLR,NLD,2006.0,1,0,1
SLE,CAN,2006.0,1,0,1
AUT,GEO,2020.0,3,0,3
LCA,FRA,2012.0,1,0,1
ZWE,SWZ,2013.0,3,0,3
CHN,DZA,2011.0,3,0,3
POL,MDA,2000.0,2,0,2
SWZ,CHE,2002.0,1,0,1
SLB,PHL,2000.0,1,0,1
GAB,USA,2010.0,3,0,3
CZE,PRI,2010.0,1,0,1
CAF,FRA,2006.0,6,0,6
ITA,PRI,2003.0,2,0,2
CAN,MNG,2016.0,1,0,1
ITA,WSM,2002.0,1,0,1
IRN,CHL,2014.0,3,0,3
IND,MOZ,2010.0,2,0,2
CHE,GMB,2000.0,1,0,1
,FLK,2003.0,1,0,1
ESP,LUX,2009.0,3,0,3
MAR,SAU,2007.0,1,0,1
PAK,CMR,2018.0,1,0,1
ITA,FJI,2015.0,1,0,1
HND,,2010.0,2,0,2
KEN,COD,2018.0,2,0,2
MYS,LAO,2019.0,1,0,1
SLB,IND,2015.0,1,0,1
URY,DNK,2018.0,1,0,1
POL,HRV,2014.0,1,0,1
NLD,BFA,2015.0,2,0,2
BEN,BDI,2009.0,1,0,1
BDI,,2012.0,2,0,2
ITA,GEO,2008.0,1,0,1
LSO,ZMB,2021.0,1,0,1
ZMB,BWA,2014.0,1,0,1
SYR,NLD,2010.0,1,0,1
CUB,YEM,2012.0,1,0,1
SAU,GRC,2007.0,1,0,1
HUN,ARE,2013.0,6,0,6
CUB,CAN,2003.0,2,0,2
IND,ARG,2020.0,1,0,1
MDG,THA,2008.0,1,0,1
RWA,BEL,2010.0,2,0,2
BEL,LVA,2016.0,1,0,1
FSM,,2019.0,7,0,7
FSM,,2011.0,6,0,6
SLB,SWE,2017.0,1,0,1
GRD,,2011.0,2,0,2
,MTQ,2004.0,15,0,15
MYS,SAU,2004.0,1,0,1
SVN,CAN,2013.0,5,0,5
FRA,MRT,2016.0,4,0,4
PAN,ITA,2021.0,2,0,2
MOZ,FRA,2009.0,1,0,1
GBR,YEM,2006.0,3,0,3
MEX,ARM,2014.0,1,0,1
MEX,NGA,2009.0,1,0,1
TUR,ZAF,2004.0,1,0,1
ZMB,DEU,2018.0,2,0,2
MLT,AUS,2009.0,1,0,1
UGA,JPN,2008.0,2,0,2
JPN,UGA,2012.0,1,0,1
LBY,THA,2008.0,2,0,2
NLD,CHL,2004.0,3,0,3
BRA,QAT,2014.0,1,0,1
NZL,KWT,2021.0,2,0,2
,HND,2009.0,14,0,14
COL,ECU,2012.0,2,0,2
NOR,RWA,2019.0,1,0,1
NOR,HRV,2016.0,1,0,1
HRV,DZA,2015.0,1,0,1
CMR,FIN,2013.0,1,0,1
TWN,MNG,2012.0,2,0,2
CMR,GMB,2013.0,1,0,1
CHE,MMR,2014.0,1,0,1
,AND,1994.0,2,0,2
ITA,BFA,2020.0,1,0,1
MLI,NER,2010.0,1,0,1
AUS,SYC,2020.0,1,0,1
VEN,SVN,2018.0,1,0,1
CHE,MAC,2018.0,1,0,1
ZWE,SWZ,2003.0,2,0,2
BRA,MLT,2016.0,2,0,2
ITA,JAM,2008.0,1,0,1
ABW,,2025.0,15,0,15
MAR,NER,2016.0,2,0,2
PRT,LTU,2020.0,1,0,1
PAK,TWN,2019.0,3,0,3
ECU,ASM,2018.0,1,0,1
BRA,PRI,2017.0,6,0,6
,SLB,2012.0,6,0,6
COM,REU,2018.0,1,0,1
ISR,LVA,2022.0,1,0,1
,DMA,2010.0,5,0,5
ARE,FRA,2001.0,2,0,2
PRT,PRI,1997.0,2,0,2
NOR,KWT,2018.0,1,0,1
BFA,AUT,2016.0,2,0,2
FIN,NPL,2018.0,1,0,1
CAN,IDN,2005.0,3,0,3
IRL,ETH,2016.0,1,0,1
CZE,NZL,2002.0,1,0,1
,CPV,2016.0,6,0,6
CPV,,2021.0,2,0,2
AZE,CAN,2023.0,2,0,2
SGP,BHR,2022.0,1,0,1
TTO,SGP,2022.0,1,0,1
,VGB,2019.0,3,0,3
BGD,SAU,2024.0,1,0,1
MMR,ITA,2022.0,1,0,1
ZWE,THA,2019.0,2,0,2
VEN,URY,2022.0,4,0,4
MNG,BGR,1997.0,3,0,3
VEN,JPN,2009.0,1,0,1
ZAF,FLK,2011.0,1,0,1
,PYF,1995.0,12,0,12
KIR,,2005.0,1,0,1
PYF,NCL,2008.0,3,0,3
OMN,TUN,2001.0,1,0,1
ZAF,CIV,2015.0,4,0,4
KEN,AUT,2003.0,1,0,1
COG,MUS,2018.0,1,0,1
ISR,BIH,2015.0,1,0,1
MNG,,2003.0,7,0,7
COD,CZE,2001.0,1,0,1
CAF,,2004.0,1,0,1
GBR,LBY,2013.0,8,0,8
IND,CZE,2007.0,3,0,3
ROU,SRB,2004.0,2,0,2
CYP,NOR,2006.0,1,0,1
NAM,NGA,2000.0,1,0,1
TJK,,2005.0,2,0,2
DNK,CMR,2014.0,1,0,1
GRC,MEX,2010.0,1,0,1
TUN,CIV,2011.0,1,0,1
MUS,,2006.0,4,0,4
HND,,2006.0,4,0,4
ITA,EST,2006.0,1,0,1
BLR,IRN,2011.0,1,0,1
GLP,,2005.0,3,0,3
ISR,ARG,2016.0,2,0,2
ETH,CMR,2010.0,1,0,1
TWN,MAR,2004.0,2,0,2
BFA,MLI,1999.0,1,0,1
BLR,CHE,2005.0,1,0,1
ZWE,IND,2004.0,2,0,2
WSM,AUS,2004.0,2,0,2
ETH,COM,2007.0,2,0,2
POL,ISL,2014.0,1,0,1
PYF,,2005.0,3,0,3
FRA,YEM,2005.0,1,0,1
ISR,KEN,1999.0,1,0,1
LUX,SGP,2016.0,1,0,1
SWE,IDN,2003.0,2,0,2
DEU,MDG,1998.0,1,0,1
BRB,,2016.0,16,0,16
GUM,FSM,2014.0,1,0,1
QAT,,2002.0,4,0,4
SDN,TUR,2006.0,1,0,1
AFG,BEL,2020.0,1,0,1
CMR,ZWE,2008.0,1,0,1
GHA,PHL,2008.0,1,0,1
YEM,AUS,2006.0,2,0,2
HND,,2000.0,1,0,1
COL,NOR,2012.0,1,0,1
CHN,ZAF,1997.0,2,0,2
FIN,KOR,2000.0,1,0,1
USA,FLK,2008.0,1,0,1
CAN,IDN,2002.0,4,0,4
BIH,,2000.0,2,0,2
NCL,GLP,2008.0,3,0,3
GLP,NCL,2011.0,3,0,3
NOR,ZMB,2015.0,1,0,1
YEM,ARE,2016.0,1,0,1
GRC,MAR,2012.0,1,0,1
ZAF,GRC,2003.0,1,0,1
CZE,ARG,2008.0,1,0,1
MYS,PAK,2011.0,7,21,-14
SWE,CHN,2012.0,69,71,-2
NLD,THA,2021.0,11,8,3
URY,ESP,2013.0,12,16,-4
IND,MUS,2015.0,2,2,0
BEL,TZA,2021.0,6,3,3
DNK,ESP,2023.0,33,30,3
NPL,GBR,2014.0,11,8,3
AUS,IDN,2014.0,65,19,46
JPN,PAK,2010.0,13,5,8
HKG,THA,2016.0,2,2,0
IRL,BEL,2015.0,13,9,4
BRA,POL,2020.0,14,6,8
BFA,COG,2018.0,3,1,2
SAU,KOR,2023.0,11,20,-9
CHN,LTU,2018.0,1,5,-4
IRN,RUS,2022.0,8,7,1
SAU,PAK,2013.0,22,82,-60
OMN,USA,2005.0,4,11,-7
BEL,COG,2007.0,7,1,6
GBR,AUT,2004.0,33,36,-3
MEX,NLD,2000.0,6,4,2
AUT,HRV,2007.0,4,5,-1
MYS,IRN,2008.0,4,15,-11
JPN,EGY,2006.0,31,14,17
BGD,GBR,2007.0,15,17,-2
MEX,CAN,2002.0,17,19,-2
IRL,AUT,2003.0,2,2,0
KEN,FRA,2011.0,6,2,4
FIN,FRA,1997.0,5,10,-5
RUS,AUS,2004.0,15,8,7
SWE,CZE,2002.0,5,4,1
ESP,URY,2018.0,24,9,15
MOZ,PRT,2020.0,5,3,2
CHL,FRA,2023.0,11,17,-6
USA,FJI,2018.0,3,3,0
ZAF,SAU,2021.0,9,9,0
CHL,BEL,2016.0,7,9,-2
MLI,FRA,2016.0,6,8,-2
TZA,UGA,2013.0,6,4,2
SWE,IRL,2002.0,5,2,3
SWE,BGD,2014.0,4,5,-1
CHL,COL,1997.0,7,1,6
VNM,AUS,2010.0,12,13,-1
CHE,AUT,2002.0,22,40,-18
CHN,AUT,1999.0,6,11,-5
HUN,ISR,2013.0,5,2,3
CHE,GRC,2010.0,11,24,-13
ZWE,ZMB,2017.0,1,2,-1
RUS,CZE,2008.0,4,11,-7
ITA,TUR,1997.0,2,3,-1
EST,GBR,2003.0,1,2,-1
GBR,ISL,2014.0,10,5,5
ZAF,FRA,2013.0,18,32,-14
GBR,TUR,2007.0,33,21,12
PRT,SWE,2016.0,12,6,6
CHN,ISR,2010.0,7,9,-2
DEU,HKG,2013.0,7,12,-5
FRA,GAB,2019.0,16,7,9
NGA,BWA,2012.0,4,1,3
COL,CHE,2011.0,7,5,2
LTU,DEU,2009.0,6,3,3
FRA,CZE,2014.0,22,18,4
ARG,NLD,2022.0,4,3,1
AUT,FRA,2002.0,17,16,1
UKR,AUT,2007.0,7,2,5
BRA,BOL,2014.0,2,1,1
SRB,BIH,2016.0,23,14,9
CZE,ISL,2016.0,2,1,1
TUN,ARE,2022.0,8,1,7
PAK,IND,2013.0,22,27,-5
TUR,VNM,2020.0,2,2,0
DNK,HKG,2018.0,3,7,-4
COL,ARM,2018.0,2,4,-2
IRL,JPN,2017.0,10,5,5
CHN,COL,2023.0,2,3,-1
ETH,,2016.0,140,0,140
ALB,SWE,2020.0,1,0,1
JPN,BIH,2009.0,1,0,1
DNK,TZA,2016.0,2,0,2
BWA,,2012.0,32,0,32
BFA,,2017.0,70,0,70
BEL,BOL,2019.0,3,0,3
LBY,PRT,2021.0,1,0,1
LBR,ITA,2011.0,1,0,1
,SVN,2010.0,720,0,720
DEU,PAN,2015.0,1,0,1
,TTO,2009.0,72,0,72
TTO,GLP,2012.0,1,0,1
,LUX,2007.0,113,0,113
UGA,,2015.0,98,0,98
MYS,BFA,2015.0,1,0,1
BOL,IND,2017.0,1,0,1
,ZWE,2011.0,175,0,175
SYR,USA,2023.0,3,0,3
LBN,DZA,2014.0,1,0,1
,FJI,2011.0,29,0,29
BEL,IDN,2014.0,5,0,5
IRL,IRQ,2015.0,1,0,1
,MOZ,2011.0,42,0,42
BRA,VNM,2018.0,2,0,2
CAN,GEO,2018.0,3,0,3
,FLK,2010.0,4,0,4
,MDA,2006.0,58,0,58
,PAN,2011.0,70,0,70
NLD,COG,2021.0,2,0,2
TUN,BHR,2016.0,3,0,3
MYS,MUS,2016.0,2,0,2
,LAO,2011.0,51,0,51
,GMB,2011.0,26,0,26
GBR,GAB,2022.0,2,0,2
CZE,DZA,2021.0,2,0,2
,KHM,2005.0,53,0,53
,MUS,2015.0,37,0,37
,LUX,2020.0,97,0,97
,PSE,2005.0,61,0,61
NGA,TWN,2014.0,1,0,1
,BRB,2011.0,20,0,20
,SUR,2011.0,4,0,4
CHN,FJI,2017.0,1,0,1
,TJK,2011.0,37,0,37
ESP,KNA,2018.0,1,0,1
,LBR,2011.0,4,0,4
PRK,GBR,2007.0,1,0,1
LBR,,2019.0,13,0,13
CHE,MDA,2016.0,1,0,1
,LSO,2011.0,5,0,5
SRB,BGR,2019.0,3,0,3
GEO,ETH,2018.0,2,0,2
BEL,MNE,2014.0,1,0,1
GIN,,2018.0,22,0,22
FIN,LBY,2015.0,1,0,1
GBR,BRN,2017.0,10,0,10
BGR,NOR,2018.0,3,0,3
NGA,DZA,2018.0,2,0,2
,TTO,2011.0,55,0,55
ARE,DZA,2016.0,6,0,6
,KNA,2010.0,7,0,7
ARM,CZE,2014.0,1,0,1
CZE,ARM,2016.0,1,0,1
FIN,BWA,2016.0,2,0,2
,JAM,2010.0,63,0,63
KEN,AUS,2007.0,4,0,4
UKR,ZAF,2016.0,1,0,1
,MUS,2014.0,38,0,38
SYR,SWE,2018.0,1,0,1
NGA,HUN,2018.0,1,0,1
,GUY,1995.0,6,0,6
EGY,SYR,2017.0,1,0,1
MAR,RWA,2019.0,2,0,2
NOR,BLR,2016.0,2,0,2
MAC,RUS,2016.0,3,0,3
KEN,COD,2020.0,5,0,5
GMB,CAN,2019.0,2,0,2
IND,MAR,2015.0,3,0,3
BLZ,,2022.0,11,0,11
MKD,,2000.0,7,0,7
,VCT,2014.0,1,0,1
,SEN,2002.0,62,0,62
,NAM,2010.0,34,0,34
,TJK,1994.0,35,0,35
,GTM,2001.0,20,0,20
FRA,MLT,1998.0,2,0,2
KEN,,2004.0,52,0,52
CAN,ISL,2003.0,2,0,2
JOR,,2007.0,50,0,50
JOR,,1999.0,11,0,11
MAR,ARG,2015.0,1,0,1
LBN,,2003.0,55,0,55
RUS,COL,1999.0,3,0,3
BGR,CZE,1997.0,1,0,1
MKD,SRB,2010.0,47,0,47
GUF,,2000.0,2,0,2
,MLI,2006.0,46,0,46
VEN,CHE,2018.0,1,0,1
ARM,ISR,1998.0,1,0,1
SDN,,2002.0,11,0,11
JPN,MKD,2003.0,1,0,1
VNM,BEL,2003.0,4,0,4
DEU,PAN,2001.0,1,0,1
ISL,,2002.0,14,0,14
ARE,COL,2012.0,1,0,1
IND,TTO,1999.0,2,0,2
SYR,TZA,2009.0,2,0,2
PER,ITA,2002.0,2,0,2
NLD,GMB,2006.0,1,0,1
ITA,ZMB,2008.0,1,0,1
GEO,,1999.0,16,0,16
ALB,LUX,2022.0,1,0,1
,MWI,1995.0,35,0,35
COL,AUS,1999.0,3,0,3
MAR,,1999.0,38,0,38
GRC,IRL,2002.0,4,0,4
ZWE,IRL,2019.0,2,0,2
NCL,,2012.0,14,0,14
KWT,CHN,2002.0,1,0,1
TZA,,1999.0,9,0,9
NZL,ISR,1997.0,2,0,2
SAU,BHR,2007.0,2,0,2
,PRI,1999.0,106,0,106
SVN,CHE,2003.0,3,0,3
ITA,KWT,2015.0,1,0,1
ESP,GTM,2005.0,5,0,5
GTM,,2009.0,5,0,5
IND,BEN,2011.0,1,0,1
UZB,KAZ,2013.0,6,0,6
BRA,LBY,2021.0,1,0,1
COG,RWA,1999.0,1,0,1
RWA,,2002.0,1,0,1
MUS,,2003.0,6,0,6
,MNE,1995.0,5,0,5
BLR,,1999.0,62,0,62
,LUX,1998.0,27,0,27
VAT,,2013.0,1,0,1
NFK,GBR,2011.0,2,0,2
TUR,MDA,2009.0,1,0,1
,BEN,2001.0,34,0,34
AZE,,2010.0,73,0,73
BLR,ISR,2001.0,1,0,1
ISR,BLR,2004.0,2,0,2
ISR,SRB,2009.0,1,0,1
GHA,,2000.0,11,0,11
FIN,GRC,2000.0,4,0,4
QAT,PSE,2017.0,2,0,2
,SYR,1997.0,56,0,56
AZE,ITA,2007.0,1,0,1
NGA,ETH,1999.0,1,0,1
FRA,AGO,2003.0,2,0,2
ZMB,,1999.0,4,0,4
MKD,,2010.0,32,0,32
MLI,TUN,2000.0,1,0,1
UZB,PAK,2004.0,1,0,1
AFG,CZE,2003.0,2,0,2
TUR,HKG,2007.0,1,0,1
GBR,YEM,2003.0,2,0,2
BEL,CHL,2007.0,4,0,4
EST,,2002.0,29,0,29
,SWZ,1995.0,7,0,7
ARG,VEN,2000.0,3,0,3
BGR,SVK,1998.0,3,0,3
THA,BGD,2000.0,2,0,2
PNG,USA,1999.0,3,0,3
PRT,LTU,2018.0,1,0,1
BLZ,,2017.0,7,0,7
BTN,GBR,2011.0,1,0,1
ZWE,RWA,2021.0,1,0,1
UKR,FIN,2017.0,3,0,3
SEN,BEN,2018.0,2,0,2
ALB,BIH,2021.0,1,0,1
AUS,PYF,2019.0,2,0,2
TUR,OMN,2009.0,2,0,2
BTN,,2020.0,8,0,8
,FJI,2019.0,55,0,55
IDN,IRL,2022.0,1,0,1
GUY,,2023.0,21,0,21
RWA,JPN,2019.0,1,0,1
ROU,CHN,2016.0,3,0,3
PRI,ABW,2018.0,1,0,1
CYM,,2024.0,10,0,10
IRL,MAC,2022.0,1,0,1
MDV,,2021.0,2,0,2
SDN,,2012.0,89,0,89
BRN,,2013.0,8,0,8
,BHR,2017.0,124,0,124
,BRA,2021.0,136,0,136
,HTI,2007.0,7,0,7
HTI,,2013.0,13,0,13
HUN,IND,1997.0,2,0,2
AUS,MMR,2010.0,1,0,1
,BWA,2010.0,49,0,49
,LBY,2009.0,44,0,44
PER,,2000.0,14,0,14
USA,ARG,2024.0,3,0,3
GUF,NCL,2023.0,1,0,1
MLI,,2014.0,36,0,36
,GTM,2004.0,25,0,25
PAN,PER,2016.0,1,0,1
VCT,,2018.0,2,0,2
GEO,SWE,2015.0,2,0,2
CUB,CHL,2013.0,7,0,7
BFA,GBR,2004.0,3,0,3
PAK,ARE,2002.0,2,0,2
,MDA,2010.0,73,0,73
,LAO,2019.0,23,0,23
MUS,THA,2020.0,2,0,2
LUX,,2014.0,44,0,44
NLD,LUX,2009.0,4,0,4
ROU,PAK,2019.0,3,0,3
LKA,OMN,2022.0,2,0,2
,MLI,2010.0,59,0,59
SVK,BGR,1999.0,1,0,1
DZA,CAN,2005.0,5,0,5
PHL,GMB,2001.0,1,0,1
GAB,DEU,1999.0,3,0,3
RUS,LIE,2012.0,1,0,1
IND,PER,2015.0,1,0,1
CAF,SEN,2000.0,1,0,1
EST,,2005.0,34,0,34
PHL,,2000.0,22,0,22
LKA,BRA,2006.0,1,0,1
CUB,,1999.0,45,0,45
CAN,VNM,2002.0,4,0,4
SWE,KWT,2007.0,1,0,1
LBR,USA,2008.0,2,0,2
IDN,COL,1998.0,3,0,3
COL,IDN,2003.0,1,0,1
MDA,,2015.0,47,0,47
BLR,MEX,2000.0,1,0,1
VEN,SAU,2012.0,1,0,1
MWI,SDN,2013.0,1,0,1
,SLB,1995.0,7,0,7
SLB,MYS,2003.0,1,0,1
CPV,MEX,2015.0,1,0,1
MEX,BOL,1999.0,2,0,2
ARE,,2010.0,84,0,84
CHE,LBN,1999.0,1,0,1
,HND,1996.0,13,0,13
,BWA,2000.0,45,0,45
,MUS,1996.0,15,0,15
MUS,IND,2010.0,1,0,1
QAT,OMN,2006.0,1,0,1
CHN,PRI,2006.0,2,0,2
,LAO,1994.0,13,0,13
MYS,ZWE,2001.0,1,0,1
ZWE,,2003.0,33,0,33
HKG,KWT,2010.0,2,0,2
SGP,CHL,2012.0,1,0,1
MLI,CHE,2014.0,1,0,1
EGY,OMN,1999.0,3,0,3
MLI,CHE,2001.0,1,0,1
NLD,OMN,2008.0,4,0,4
,HTI,1998.0,7,0,7
HUN,SRB,2002.0,1,0,1
CHE,SAU,2005.0,2,0,2
SRB,ESP,2000.0,6,0,6
THA,BRA,2002.0,1,0,1
VNM,IND,1997.0,2,0,2
LBY,,2005.0,9,0,9
,CYM,1999.0,1,0,1
GRD,JAM,2000.0,1,0,1
CAN,BHR,2014.0,3,0,3
RUS,TWN,2000.0,5,0,5
AZE,IRN,2015.0,2,0,2
UKR,TUR,2013.0,1,0,1
ROU,KWT,1999.0,1,0,1
KEN,GIN,2010.0,1,0,1
JPN,KNA,2015.0,1,0,1
,PRI,2007.0,139,0,139
,MMR,2007.0,26,0,26
NGA,FIN,2012.0,2,0,2
HND,,2013.0,14,0,14
NIC,CRI,2011.0,1,0,1
LBY,USA,2010.0,3,0,3
CYM,,2023.0,11,0,11
MEX,NGA,2015.0,1,0,1
GRC,QAT,2014.0,9,0,9
DNK,ROU,2012.0,2,0,2
BEN,ITA,2023.0,1,0,1
COD,,2014.0,7,0,7
,NAM,2006.0,15,0,15
VEN,NLD,2016.0,4,0,4
IRN,CHL,2011.0,1,0,1
OMN,TCA,2012.0,1,0,1
AUT,JOR,2014.0,2,0,2
,KGZ,2007.0,25,0,25
FIN,PAK,2011.0,2,0,2
UKR,CHE,2012.0,4,0,4
VEN,PRT,2012.0,2,0,2
LAO,CHE,2013.0,3,0,3
,RWA,2007.0,50,0,50
HKG,LKA,2017.0,7,0,7
UGA,SSD,2016.0,1,0,1
SSD,,2025.0,43,0,43
CRI,SLV,2014.0,1,0,1
DEU,ARE,2011.0,7,0,7
,NER,2007.0,35,0,35
,GLP,2006.0,9,0,9
BGD,CHE,2017.0,1,0,1
CZE,BHR,2007.0,1,0,1
,SYR,2002.0,36,0,36
NOR,ZWE,2012.0,1,0,1
NOR,THA,2013.0,1,0,1
ARG,AFG,2004.0,2,0,2
SEN,CAF,2015.0,3,0,3
ZAF,IRQ,2015.0,1,0,1
TCD,,2022.0,16,0,16
SLE,,2018.0,21,0,21
CUB,BRA,1997.0,2,0,2
,TJK,2009.0,14,0,14
TZA,LSO,2020.0,4,0,4
PRT,ROU,2012.0,5,0,5
JOR,VNM,2019.0,1,0,1
PRK,JPN,2010.0,1,0,1
KHM,,2019.0,63,0,63
,SLE,2013.0,42,0,42
NPL,,2002.0,14,0,14
,PNG,2013.0,22,0,22
HKG,BGD,2010.0,2,0,2
BRN,CHE,2022.0,2,0,2
MAC,,2016.0,41,0,41
ISR,CYP,2021.0,7,0,7
ARE,AFG,2018.0,1,0,1
MMR,RUS,2015.0,1,0,1
USA,TCA,2016.0,2,0,2
CMR,,2026.0,24,0,24
,GRL,2006.0,4,0,4
ESP,ZMB,2019.0,1,0,1
NGA,CHE,2023.0,1,0,1
TZA,BDI,2016.0,1,0,1
ETH,MLT,2022.0,1,0,1
PHL,LVA,2016.0,1,0,1
GHA,GNB,2015.0,2,0,2
GIN,COD,2023.0,2,0,2
,TJK,2019.0,34,0,34
HKG,MAC,2004.0,9,0,9
ITA,BEN,2018.0,2,0,2
BGR,IND,2019.0,3,0,3
TWN,LKA,2023.0,1,0,1
NGA,GRD,2020.0,1,0,1
ABW,COL,2020.0,1,0,1
NER,DEU,2000.0,2,0,2
,KOR,2021.0,200,0,200
CHL,BGD,2019.0,1,0,1
GBR,MAC,2014.0,5,0,5
AZE,CHN,2020.0,1,0,1
MEX,BOL,2020.0,6,0,6
TKM,,2025.0,7,0,7
ETH,SDN,2017.0,1,0,1
MAC,,2026.0,43,0,43
SDN,SWE,2023.0,2,0,2
YEM,KEN,2020.0,1,0,1
CMR,ZMB,2019.0,1,0,1
VNM,NAM,2023.0,1,0,1
BRA,IDN,2020.0,4,0,4
SVK,MAC,2020.0,1,0,1
MAC,SVK,2022.0,1,0,1
KOR,PER,2021.0,1,0,1
BEL,GHA,2023.0,1,0,1
CAN,BHR,2015.0,1,0,1
IRN,CHL,2019.0,4,0,4
MYS,NOR,2023.0,1,0,1
,PAN,2019.0,77,0,77
KOR,IRQ,2023.0,1,0,1
HUN,GEO,2018.0,2,0,2
SRB,DNK,2022.0,2,0,2
,SUR,2019.0,9,0,9
ISL,SGP,2019.0,2,0,2
,RWA,2020.0,109,0,109
KHM,SWE,2023.0,1,0,1
BWA,,2002.0,10,0,10
LKA,NZL,2000.0,1,0,1
GNB,,2009.0,2,0,2
DEU,MKD,1999.0,1,0,1
BEL,PHL,2001.0,2,0,2
HKG,NOR,1997.0,1,0,1
THA,NZL,2002.0,1,0,1
ARE,KEN,2013.0,1,0,1
NPL,ETH,2006.0,1,0,1
BFA,,2016.0,46,0,46
PSE,,2003.0,2,0,2
GTM,NLD,2011.0,3,0,3
ESP,AZE,1997.0,1,0,1
AUT,SGP,1999.0,1,0,1
MDA,,2004.0,19,0,19
NLD,AIA,2016.0,1,0,1
ROU,PRT,1997.0,1,0,1
ARG,PRI,2015.0,2,0,2
NZL,NAM,2015.0,1,0,1
AUS,ECU,2003.0,3,0,3
CHL,PRT,2023.0,2,0,2
ITA,ECU,2003.0,2,0,2
CAN,BGR,2011.0,2,0,2
NZL,BHS,2003.0,1,0,1
FRA,GUM,2005.0,1,0,1
URY,,2005.0,30,0,30
,CPV,2007.0,2,0,2
GRC,BRA,2002.0,1,0,1
NIC,BRA,2008.0,2,0,2
BEL,UZB,2011.0,1,0,1
,BLZ,1994.0,5,0,5
BLZ,USA,1999.0,2,0,2
ISR,COL,2006.0,2,0,2
LKA,,2002.0,21,0,21
MYS,QAT,2012.0,5,0,5
,GMB,2009.0,16,0,16
,COD,2004.0,13,0,13
CAN,SLE,2019.0,1,0,1
NOR,HKG,2010.0,1,0,1
,DOM,2002.0,8,0,8
LBY,,2002.0,16,0,16
,ZWE,2009.0,108,0,108
DMA,DOM,2021.0,3,0,3
MAR,YEM,2021.0,4,0,4
JPN,PRT,2023.0,1,0,1
,LAO,2009.0,42,0,42
,FRO,2000.0,4,0,4
GAB,,2010.0,11,0,11
,GLP,2010.0,14,0,14
GNB,,2021.0,6,0,6
MYS,KEN,2016.0,2,0,2
USA,MTQ,2015.0,2,0,2
MTQ,USA,2019.0,1,0,1
,COG,2006.0,56,0,56
ESP,GHA,2011.0,1,0,1
WSM,,2017.0,7,0,7
,PAN,2009.0,40,0,40
TON,,2021.0,3,0,3
AUS,LBY,2010.0,1,0,1
NZL,NCL,2001.0,1,0,1
AUS,JAM,2003.0,3,0,3
KEN,NZL,2013.0,1,0,1
,MRT,2000.0,4,0,4
HKG,PHL,2013.0,1,0,1
RUS,MYS,2017.0,3,0,3
KEN,FIN,2021.0,2,0,2
PHL,FIN,2022.0,1,0,1
,BDI,2012.0,14,0,14
GTM,,2021.0,58,0,58
IND,EST,2015.0,2,0,2
IND,ERI,2017.0,3,0,3
IDN,ALB,2021.0,1,0,1
KOR,AUT,2001.0,1,0,1
GNB,,2019.0,8,0,8
QAT,PRT,2020.0,2,0,2
ALB,NOR,2018.0,1,0,1
,MNG,2010.0,71,0,71
UGA,DEU,1999.0,1,0,1
POL,QAT,2016.0,1,0,1
GBR,ALB,2018.0,1,0,1
IND,THA,2014.0,7,3,4
BEL,UGA,2011.0,2,2,0
SVK,UKR,2012.0,1,4,-3
KOR,NGA,2003.0,1,1,0
LBY,EGY,2010.0,2,5,-3
ITA,ZAF,2004.0,7,1,6
MLT,SWE,2021.0,2,1,1
CHE,SVN,2010.0,2,3,-1
DEU,TUN,2009.0,2,2,0
SWE,TWN,2018.0,4,7,-3
HRV,TWN,2013.0,1,1,0
ZWE,KEN,2006.0,2,4,-2
AUT,SVN,2016.0,2,14,-12
AUT,BEL,1997.0,4,2,2
KWT,CAN,1998.0,2,8,-6
CZE,BRA,2012.0,1,1,0
NZL,JPN,2006.0,2,7,-5
USA,PRY,2007.0,2,2,0
SRB,BEL,2006.0,3,7,-4
IND,NGA,2008.0,5,5,0
MEX,ISR,2008.0,2,1,1
TUV,RUS,2017.0,1,1,0
KEN,SWE,2019.0,6,7,-1
GRL,DNK,2016.0,2,8,-6
NLD,NGA,2008.0,2,2,0
JPN,GRC,2020.0,1,4,-3
ZAF,UGA,2001.0,1,1,0
EST,FRA,2015.0,3,2,1
ROU,JPN,2007.0,8,6,2
JPN,ROU,2014.0,1,1,0
BEL,MEX,2011.0,6,8,-2
DEU,CYP,2005.0,2,1,1
CAN,MUS,2013.0,1,1,0
MUS,DNK,2021.0,1,1,0
MEX,BGD,2017.0,2,1,1
PRT,KOR,2014.0,7,2,5
IRL,SVK,2018.0,2,1,1
KOR,MAC,2021.0,1,1,0
SAU,KAZ,2015.0,1,2,-1
GLP,MTQ,2015.0,1,2,-1
DNK,GNB,2012.0,5,5,0
ITA,SVN,2013.0,10,8,2
ZAF,NAM,2010.0,5,3,2
IND,FIN,2013.0,17,6,11
VNM,POL,2019.0,4,6,-2
FRA,TUR,2018.0,15,26,-11
ZAF,CZE,2016.0,1,4,-3
GAB,DEU,2022.0,2,7,-5
NLD,NGA,2014.0,1,3,-2
BRB,USA,2020.0,1,5,-4
BGR,SWE,2013.0,2,2,0
MEX,PAK,2015.0,1,1,0
CZE,ROU,2018.0,1,3,-2
THA,KEN,2011.0,1,1,0
GRC,AUS,2008.0,2,3,-1
LVA,RUS,2009.0,1,1,0
IRL,POL,2010.0,4,8,-4
CHL,ITA,2009.0,4,10,-6
LTU,TUR,2011.0,1,1,0
IND,SVN,2009.0,1,3,-2
EGY,IRL,2019.0,4,1,3
DNK,IND,2012.0,11,15,-4
POL,ZAF,2015.0,2,3,-1
ZAF,POL,2020.0,1,6,-5
JAM,BRB,2012.0,3,3,0
EGY,TUR,2009.0,2,1,1
ROU,AUS,2014.0,2,2,0
KOR,ISR,2022.0,6,3,3
MYS,CMR,2009.0,1,1,0
LVA,GBR,2013.0,1,2,-1
IND,BHR,2016.0,2,1,1
NCL,FJI,2018.0,1,1,0
ROU,POL,2019.0,4,3,1
CHE,CYP,2021.0,2,1,1
MEX,CUB,2023.0,2,9,-7
MEX,JPN,2010.0,5,4,1
CRI,AUS,2015.0,1,1,0
BFA,USA,2021.0,3,4,-1
HUN,HRV,2016.0,2,1,1
BRA,BOL,2009.0,1,1,0
HRV,ESP,2011.0,2,1,1
USA,HND,2020.0,4,4,0
NOR,ITA,1997.0,5,2,3
JPN,POL,2005.0,12,8,4
NOR,LTU,2022.0,1,1,0
DNK,MEX,2014.0,1,6,-5
IND,THA,2015.0,9,7,2
THA,CHE,2021.0,12,9,3
KEN,AUS,2017.0,10,5,5
IRL,DNK,1999.0,5,3,2
ESP,URY,2007.0,8,9,-1
ARE,IRN,2014.0,1,1,0
MYS,THA,2010.0,3,6,-3
TZA,AUS,2020.0,1,2,-1
ETH,TZA,2017.0,1,1,0
DZA,MAR,2021.0,2,5,-3
POL,MEX,2015.0,2,2,0
RUS,ARM,2014.0,7,4,3
NIC,ESP,2009.0,1,1,0
BHR,AUS,2016.0,2,1,1
VNM,NGA,2023.0,1,1,0
BEL,TUR,1997.0,2,1,1
BRA,ISR,2020.0,9,2,7
DNK,THA,2021.0,6,7,-1
RUS,EST,2021.0,7,2,5
DZA,ROU,2020.0,2,3,-1
ZMB,DEU,2022.0,1,2,-1
SAU,PAK,2024.0,6,3,3
NOR,SAU,2018.0,2,1,1
PSE,DEU,2020.0,4,5,-1
AUT,UKR,2013.0,3,4,-1
SWE,GHA,2022.0,2,1,1
CHE,RUS,2018.0,16,31,-15
MWI,ZMB,2015.0,1,2,-1
IND,TUN,2020.0,1,2,-1
TWN,SWE,2009.0,3,2,1
CHE,LBN,2022.0,4,8,-4
ARM,RUS,2020.0,5,9,-4
IRL,CZE,2021.0,5,2,3
AUT,SVN,2017.0,3,9,-6
PHL,GBR,2002.0,5,3,2
BFA,CHN,2005.0,1,3,-2
ITA,ISL,2022.0,1,2,-1
COG,CHE,2019.0,1,5,-4
MEX,VEN,2020.0,6,8,-2
AZE,IRN,2019.0,3,2,1
THA,MMR,2017.0,5,5,0
USA,BIH,2013.0,5,1,4
UGA,IND,2022.0,3,1,2
USA,MMR,2000.0,1,2,-1
MMR,AUS,2019.0,1,5,-4
CHN,SVN,2016.0,1,2,-1
SGP,NOR,2019.0,3,2,1
NPL,THA,2017.0,3,8,-5
MCO,FRA,2002.0,3,11,-8
TUR,EGY,2020.0,6,8,-2
IRQ,SWE,2021.0,4,4,0
PHL,THA,2022.0,5,8,-3
GRC,CHL,2018.0,2,1,1
LBR,USA,2019.0,12,8,4
BRA,THA,2022.0,4,1,3
CAN,DZA,2023.0,3,2,1
TWN,ESP,2006.0,1,3,-2
CZE,HUN,2023.0,3,7,-4
YEM,IRQ,2022.0,1,1,0
ISR,BEL,2006.0,3,2,1
VNM,DNK,2003.0,1,2,-1
BRA,PAN,2017.0,4,3,1
IRL,BEL,2009.0,7,4,3
FIN,EST,2007.0,3,8,-5
GRC,NLD,1999.0,11,3,8
FRA,GAB,2001.0,4,10,-6
FRA,BOL,2011.0,4,5,-1
POL,ZAF,2001.0,1,1,0
ETH,BEL,1998.0,1,1,0
AUS,PAK,2000.0,1,2,-1
GRC,UKR,2000.0,4,2,2
DEU,LVA,2010.0,4,3,1
POL,IRL,2002.0,2,1,1
NGA,AUS,2002.0,4,1,3
TTO,GBR,1997.0,1,3,-2
HRV,CZE,2011.0,1,3,-2
AUT,DNK,2002.0,6,7,-1
AUS,ARE,2012.0,8,7,1
GUF,SEN,2001.0,1,1,0
USA,GAB,2022.0,6,5,1
HUN,BEL,1998.0,3,6,-3
CHL,KOR,2002.0,1,1,0
DNK,UKR,2005.0,1,3,-2
CHL,CHE,2001.0,4,5,-1
BEL,TUN,2003.0,1,1,0
TZA,GBR,2002.0,4,10,-6
BEL,POL,1997.0,4,6,-2
IDN,PER,2015.0,1,1,0
RUS,MDA,2006.0,3,2,1
ITA,SRB,2007.0,5,19,-14
FRA,NER,2006.0,5,4,1
SGP,THA,2003.0,3,4,-1
BRA,POL,2016.0,2,2,0
IND,MEX,1998.0,4,4,0
EGY,DNK,2006.0,1,2,-1
DZA,MYS,2018.0,1,1,0
SWE,SGP,2000.0,3,4,-1
PRT,JPN,1997.0,1,2,-1
SWE,NZL,2003.0,3,5,-2
POL,ITA,2011.0,15,23,-8
AUS,SVK,2002.0,1,1,0
MEX,IRL,1998.0,2,1,1
VEN,GBR,2009.0,8,1,7
BFA,NLD,1997.0,1,1,0
FRO,DNK,2022.0,7,5,2
GBR,BMU,2018.0,1,2,-1
MEX,UKR,2003.0,2,4,-2
SVN,NLD,1999.0,1,2,-1
ARG,JPN,2003.0,2,2,0
RUS,SVK,2000.0,5,5,0
JOR,ARE,1998.0,3,3,0
RUS,AUT,2000.0,5,12,-7
CAN,TUR,2002.0,9,14,-5
POL,ESP,2007.0,9,5,4
BEL,DNK,2010.0,7,3,4
CZE,HUN,2000.0,2,3,-1
PSE,ARE,2012.0,2,1,1
CRI,FRA,2004.0,3,1,2
USA,SYC,2018.0,3,1,2
FRA,IRN,1999.0,9,2,7
THA,DNK,2003.0,1,3,-2
NLD,ZWE,1997.0,3,3,0
GRC,ZAF,2014.0,1,2,-1
SAU,FRA,2006.0,2,5,-3
KEN,BEL,1999.0,2,2,0
USA,DZA,2020.0,5,7,-2
SWE,UKR,2008.0,3,4,-1
ARE,DNK,2009.0,1,1,0
CRI,NLD,2003.0,2,2,0
TUN,USA,2010.0,4,20,-16
TUR,UKR,2002.0,2,2,0
GBR,MWI,1997.0,3,1,2
CAN,CYP,2008.0,3,1,2
TWN,FRA,2006.0,6,7,-1
SRB,CHE,1998.0,2,1,1
JPN,SVK,2005.0,4,3,1
LUX,BEL,1998.0,3,4,-1
NGA,CMR,2009.0,2,2,0
DNK,ARG,1999.0,2,1,1
GRC,ARE,2023.0,2,4,-2
BRA,ISR,1998.0,1,2,-1
MEX,POL,1998.0,4,3,1
PRT,JPN,2005.0,4,1,3
BRN,AUS,2008.0,1,2,-1
IRL,IND,2007.0,2,13,-11
GBR,ZMB,2023.0,4,6,-2
TWN,THA,2000.0,1,1,0
NZL,BRA,2016.0,2,4,-2
RUS,CRI,2001.0,1,1,0
GRC,ISR,2021.0,1,3,-2
CUB,ARG,2011.0,6,2,4
AUS,HRV,2019.0,4,5,-1
FLK,GBR,2001.0,1,4,-3
KHM,CHE,2013.0,2,2,0
KEN,JPN,2010.0,6,3,3
JPN,KEN,2015.0,9,6,3
MAC,USA,2015.0,2,17,-15
ITA,NZL,1999.0,2,3,-1
NER,CIV,2020.0,1,1,0
SWE,TWN,2016.0,1,7,-6
RUS,SVK,2010.0,4,6,-2
THA,IDN,2009.0,2,4,-2
RWA,USA,2012.0,6,4,2
SGP,TUR,2023.0,2,2,0
ESP,SRB,2013.0,3,2,1
ALB,ITA,2015.0,4,9,-5
HKG,IRN,2012.0,1,3,-2
IND,HKG,2013.0,7,11,-4
LUX,ITA,2022.0,6,13,-7
IND,POL,2012.0,3,3,0
USA,BHS,2012.0,1,2,-1
BHS,USA,2016.0,6,1,5
SRB,DEU,2010.0,5,8,-3
NER,GBR,2017.0,1,3,-2
UGA,ETH,2018.0,1,3,-2
AUT,IND,2016.0,9,10,-1
FRA,ISL,2014.0,3,6,-3
BHR,GBR,2023.0,4,3,1
FIN,LTU,2009.0,4,2,2
MEX,CZE,2012.0,4,1,3
ISR,AUT,2016.0,4,8,-4
DNK,BGD,2014.0,2,1,1
BGR,TUR,2016.0,1,2,-1
COL,PER,2010.0,1,5,-4
EST,CHE,2011.0,2,1,1
CHE,EST,2019.0,4,7,-3
ESP,QAT,2016.0,6,1,5
BGR,ROU,2019.0,4,1,3
PRT,TWN,2023.0,2,1,1
KEN,BEN,2019.0,1,3,-2
POL,PRT,2014.0,9,2,7
CZE,BEL,2007.0,5,4,1
DZA,ESP,2012.0,2,5,-3
SRB,MKD,2015.0,4,5,-1
TZA,NLD,2018.0,3,5,-2
HUN,JPN,2021.0,4,2,2
ARE,IRL,2017.0,1,3,-2
LKA,NLD,2015.0,2,1,1
IRL,GRC,2013.0,4,8,-4
BFA,CAN,2010.0,1,2,-1
CHE,SLE,2021.0,2,1,1
CZE,DNK,2004.0,3,4,-1
ARE,PAK,2015.0,4,8,-4
GNB,DNK,2014.0,6,1,5
HKG,ESP,2009.0,1,1,0
CHE,ETH,2015.0,2,1,1
FRA,KAZ,2018.0,3,3,0
CHN,BRN,2017.0,3,1,2
MAC,HKG,2008.0,5,6,-1
IRN,IRL,2007.0,2,2,0
ISR,PSE,1997.0,1,1,0
KAZ,JPN,2020.0,2,3,-1
TUR,SAU,2002.0,3,2,1
JOR,YEM,2011.0,1,1,0
FRA,GLP,2000.0,10,19,-9
MEX,CHL,2003.0,4,4,0
USA,CIV,2015.0,3,9,-6
NLD,SAU,2010.0,1,2,-1
ESP,CZE,2001.0,6,5,1
KEN,NOR,2008.0,1,1,0
ESP,PRY,2020.0,4,6,-2
DNK,ISR,1999.0,3,2,1
TWN,MAR,2008.0,1,1,0
FJI,JPN,2021.0,1,2,-1
POL,GRC,2009.0,4,4,0
ARE,DNK,2019.0,7,4,3
TZA,UGA,2023.0,4,1,3
QAT,MYS,2016.0,2,9,-7
PRT,CZE,2007.0,2,2,0
USA,CUB,2012.0,3,8,-5
BGR,NLD,1999.0,3,2,1
IRL,JPN,2007.0,1,12,-11
CHE,GRC,2013.0,10,37,-27
KEN,CMR,2019.0,6,2,4
KOR,BRA,2015.0,5,1,4
SGP,PRT,2020.0,3,3,0
GBR,BGR,2002.0,10,13,-3
NGA,COG,2023.0,1,1,0
MEX,IRL,2007.0,2,2,0
SWE,COL,2012.0,3,2,1
BEL,UGA,2021.0,6,4,2
NLD,PRT,2023.0,12,19,-7
IND,TWN,2024.0,3,1,2
NER,SEN,2021.0,1,3,-2
DEU,PAK,2005.0,3,9,-6
LBN,DEU,2020.0,9,5,4
LBN,IRQ,2022.0,4,2,2
BMU,USA,1999.0,1,4,-3
NLD,PER,2010.0,1,2,-1
FRA,PER,2005.0,1,1,0
ZAF,RUS,1997.0,1,1,0
NLD,UGA,2020.0,4,4,0
DNK,HUN,2002.0,4,6,-2
UZB,USA,2019.0,1,2,-1
FIN,CHE,1999.0,6,12,-6
LVA,FIN,2014.0,1,1,0
SAU,JOR,2004.0,5,4,1
VNM,VEN,2018.0,3,2,1
VEN,VNM,2019.0,2,1,1
DEU,VNM,2002.0,4,4,0
BEL,VNM,2009.0,5,3,2
IDN,DNK,2016.0,1,2,-1
ECU,BRA,2004.0,1,1,0
GBR,ECU,2002.0,4,1,3
DEU,GEO,2005.0,8,3,5
ZAF,BRA,2011.0,5,3,2
HUN,ESP,2004.0,3,3,0
TWN,RUS,2002.0,5,10,-5
SAU,ZAF,2006.0,3,6,-3
NZL,NLD,2007.0,5,9,-4
RUS,IRL,2005.0,3,2,1
MYS,AUS,2006.0,15,13,2
TWN,SGP,1999.0,4,2,2
OMN,AUS,2007.0,3,2,1
KOR,FIN,2005.0,1,6,-5
ZMB,ITA,2017.0,1,1,0
HKG,ARE,2007.0,1,1,0
SAU,DEU,1999.0,1,3,-2
HRV,SWE,2010.0,2,4,-2
FRA,PAK,2001.0,2,1,1
USA,VIR,2002.0,2,2,0
KWT,FRA,2016.0,1,3,-2
EGY,FRA,2008.0,6,11,-5
PRT,UKR,1998.0,1,1,0
CAN,COL,2010.0,8,17,-9
ETH,MEX,2019.0,2,1,1
ITA,SRB,1998.0,4,3,1
TWN,TUR,2007.0,2,1,1
AUT,SVK,2008.0,13,14,-1
SWE,ARG,2011.0,5,3,2
CAN,PER,2005.0,2,2,0
USA,GHA,1997.0,3,4,-1
BRA,ZAF,2011.0,3,5,-2
GBR,SVN,2013.0,2,11,-9
PAK,KEN,2020.0,3,1,2
ARG,CHE,1999.0,3,2,1
SGP,TUR,2010.0,1,1,0
BFA,USA,2009.0,3,1,2
DNK,CZE,2015.0,5,4,1
SAU,BEL,2014.0,1,6,-5
HUN,ISR,2000.0,2,1,1
BEL,ETH,2010.0,3,3,0
USA,BWA,2002.0,2,2,0
SWE,LKA,2021.0,2,3,-1
SWE,MOZ,2015.0,1,3,-2
BGR,FRA,2015.0,4,9,-5
ARE,NLD,2020.0,6,4,2
NZL,NPL,2023.0,2,1,1
NOR,MWI,2017.0,1,1,0
KGZ,TUR,2011.0,1,3,-2
FJI,NZL,2013.0,3,1,2
EGY,KOR,2012.0,7,5,2
TWN,KOR,2019.0,7,21,-14
TWN,IRN,2019.0,2,7,-5
AUT,SRB,2020.0,6,8,-2
ITA,KOR,2014.0,4,9,-5
QAT,GBR,2010.0,2,15,-13
CMR,USA,2012.0,11,3,8
AFG,GBR,2009.0,1,4,-3
BRN,AUS,2015.0,3,2,1
ITA,ISL,2018.0,1,6,-5
SAU,QAT,2014.0,7,2,5
FIN,THA,2020.0,3,1,2
CMR,COG,2015.0,1,1,0
BRA,CMR,2015.0,2,3,-1
DEU,CIV,2022.0,2,2,0
FRA,CUB,2017.0,2,6,-4
EST,FRA,2014.0,3,6,-3
MYS,SGP,2006.0,9,12,-3
DEU,PAN,2021.0,3,1,2
KEN,CHN,2016.0,4,7,-3
MOZ,GBR,2018.0,1,4,-3
MMR,THA,2018.0,5,13,-8
CHL,SWE,2018.0,7,1,6
ITA,GHA,1999.0,1,1,0
POL,ARE,2019.0,3,1,2
KWT,EGY,2017.0,16,10,6
HUN,SWE,2015.0,9,10,-1
USA,ALB,2014.0,5,2,3
LTU,NOR,2018.0,1,1,0
LTU,NOR,2022.0,1,1,0
TUN,DZA,2019.0,10,3,7
NOR,BEL,2019.0,8,10,-2
AUS,EGY,2023.0,4,4,0
GHA,JPN,2013.0,4,2,2
GIN,FRA,2014.0,2,5,-3
LVA,RUS,2021.0,3,4,-1
DEU,MAR,2000.0,5,2,3
CAF,CMR,2017.0,2,2,0
BEL,PHL,2019.0,4,4,0
KOR,PAK,2006.0,2,5,-3
GBR,MDG,2021.0,4,4,0
QAT,IRL,2022.0,3,2,1
FIN,GHA,2019.0,2,3,-1
ESP,ZAF,2020.0,5,11,-6
IRQ,SAU,2020.0,3,10,-7
CHN,SVN,2018.0,1,2,-1
MYS,VNM,2014.0,5,1,4
EGY,GRC,2017.0,2,1,1
RUS,BRA,2020.0,4,10,-6
USA,LVA,2023.0,1,1,0
UKR,NOR,2018.0,3,2,1
ROU,IND,2017.0,1,2,-1
KEN,COL,2019.0,1,2,-1
BGR,ROU,2009.0,1,1,0
PSE,SAU,2019.0,2,8,-6
ISR,MEX,2017.0,3,5,-2
TUR,IRN,2012.0,7,17,-10
ARE,TWN,2020.0,2,2,0
BWA,BEL,2008.0,2,1,1
CHE,ROU,2022.0,4,8,-4
KHM,MYS,2019.0,2,2,0
KWT,IND,2014.0,2,7,-5
ISR,ROU,2018.0,4,3,1
URY,ARG,2002.0,3,5,-2
ESP,CMR,2020.0,2,1,1
IDN,SAU,2019.0,2,6,-4
HKG,NZL,2021.0,3,2,1
THA,DEU,2004.0,8,9,-1
EGY,PAK,2007.0,2,1,1
HUN,IRQ,2021.0,3,20,-17
MWI,USA,2020.0,22,20,2
AUS,BGD,2003.0,2,4,-2
DEU,BGD,2022.0,4,16,-12
PAK,OMN,2022.0,12,5,7
HUN,HRV,2022.0,3,7,-4
GBR,LVA,2022.0,3,3,0
GBR,SLE,2022.0,5,6,-1
GRC,SWE,2006.0,4,6,-2
ITA,TWN,2013.0,3,4,-1
MYS,PHL,2023.0,2,3,-1
TUR,ZAF,2015.0,3,3,0
SAU,AUS,2023.0,12,34,-22
ISR,FIN,2020.0,5,5,0
UGA,ITA,2009.0,1,1,0
FJI,AUS,2022.0,6,4,2
CHN,SVN,2017.0,1,6,-5
SAU,ARE,2009.0,8,6,2
USA,DOM,2001.0,1,1,0
FRA,ARE,1999.0,2,1,1
ESP,SVN,2003.0,3,1,2
GBR,LUX,2005.0,6,2,4
DNK,GMB,2002.0,1,2,-1
GBR,LAO,2005.0,1,1,0
EST,NLD,2000.0,2,1,1
ESP,ISR,2006.0,2,3,-1
PHL,GBR,2005.0,4,4,0
CAN,GHA,2000.0,1,1,0
GBR,LTU,2000.0,4,4,0
HRV,BIH,1999.0,7,3,4
CAN,BLR,2006.0,4,1,3
GBR,NER,2007.0,1,1,0
ROU,NLD,2008.0,8,6,2
CHE,VNM,2009.0,2,1,1
HRV,CHE,2002.0,9,2,7
IDN,DEU,2000.0,3,6,-3
FRA,URY,2002.0,2,9,-7
CHN,MYS,2012.0,5,6,-1
JPN,GHA,2008.0,1,2,-1
ARE,OMN,2019.0,5,7,-2
RUS,HUN,2008.0,1,2,-1
UKR,FRA,2023.0,7,2,5
ITA,SRB,2020.0,5,12,-7
POL,PAN,2002.0,1,2,-1
NOR,AUT,2009.0,3,11,-8
CHE,GEO,2006.0,2,2,0
POL,CZE,2000.0,6,3,3
QAT,DEU,2019.0,6,3,3
NLD,EGY,1999.0,1,2,-1
BLR,FIN,2003.0,1,3,-2
RUS,SVK,2006.0,1,4,-3
JPN,UKR,2019.0,3,1,2
CAN,BFA,2003.0,1,2,-1
JPN,UKR,2011.0,3,2,1
FIN,PRT,2011.0,4,3,1
AUS,MNG,2003.0,3,1,2
ROU,BGR,2009.0,1,1,0
DEU,BLR,2008.0,5,13,-8
JOR,KWT,2012.0,2,2,0
AUT,GRC,2021.0,3,3,0
URY,ESP,2000.0,5,7,-2
CRI,CHL,2013.0,1,3,-2
ZAF,NZL,1997.0,4,2,2
THA,CHE,2009.0,6,3,3
LIE,CHE,2016.0,2,1,1
SDN,SAU,2007.0,6,6,0
TUR,OMN,2008.0,2,1,1
AUS,TWN,1997.0,3,3,0
KOR,NZL,2008.0,2,4,-2
USA,ECU,2000.0,8,4,4
AUT,RUS,1999.0,7,9,-2
CHL,AUS,2007.0,5,5,0
EST,DEU,1997.0,1,2,-1
DEU,HRV,2005.0,11,4,7
CHN,BRA,2023.0,8,9,-1
MYS,IND,1999.0,4,8,-4
MOZ,PRT,2018.0,4,1,3
ZAF,UGA,2008.0,1,3,-2
CAN,NPL,2002.0,2,1,1
AUT,SGP,2017.0,3,2,1
CHE,COL,2011.0,5,7,-2
KOR,SWE,1997.0,2,4,-2
IND,NOR,2007.0,2,2,0
HUN,ISR,2023.0,1,2,-1
THA,FRA,2001.0,7,4,3
CHN,CHE,2002.0,16,16,0
TZA,NGA,2017.0,1,3,-2
CMR,USA,2005.0,3,5,-2
FIN,IRN,2012.0,5,6,-1
CIV,CHE,2012.0,2,3,-1
ZAF,MOZ,2013.0,3,4,-1
CHE,HRV,2018.0,6,11,-5
AUS,GRC,2008.0,3,2,1
EST,FIN,2008.0,11,9,2
MYS,UZB,2013.0,1,1,0
SWE,BLR,2008.0,1,1,0
PHL,CAN,2006.0,2,3,-1
YEM,EGY,2000.0,2,1,1
BLR,UKR,1997.0,3,8,-5
ZAF,CZE,2018.0,3,3,0
ISL,FIN,2001.0,2,1,1
SEN,CIV,2018.0,5,2,3
UZB,ITA,2008.0,1,1,0
ITA,BGR,2001.0,4,8,-4
PNG,NZL,2014.0,1,1,0
PER,KEN,2013.0,2,4,-2
SVK,RUS,2001.0,3,9,-6
IRL,AUT,2006.0,3,4,-1
TWN,NZL,2016.0,3,4,-1
RUS,ZAF,2007.0,3,1,2
AUT,BRA,2013.0,4,6,-2
SWE,AUT,1999.0,7,9,-2
OMN,PAK,2012.0,2,8,-6
COG,ITA,2010.0,3,3,0
FRA,TCD,2002.0,1,1,0
LBN,LBY,2012.0,4,3,1
FJI,USA,2006.0,2,3,-1
ZAF,BEL,2009.0,4,7,-3
BIH,USA,2011.0,2,7,-5
CHE,CUB,2011.0,1,2,-1
FRA,SVN,2010.0,4,3,1
CAN,UGA,2009.0,1,1,0
ARE,SGP,2008.0,2,4,-2
ESP,PHL,2016.0,4,2,2
LVA,SWE,2015.0,3,3,0
SVN,CHE,2010.0,3,2,1
HRV,ESP,2009.0,2,1,1
BRA,FIN,2013.0,6,6,0
NOR,IRN,2020.0,4,32,-28
SGP,PHL,2008.0,4,2,2
BGD,SWE,2012.0,7,1,6
GBR,PHL,2012.0,5,5,0
CAN,SVK,2015.0,3,1,2
CHN,KEN,2015.0,7,3,4
PSE,MYS,2012.0,3,5,-2
NLD,RUS,2023.0,4,18,-14
ARG,CUB,2018.0,1,4,-3
EGY,QAT,2012.0,10,5,5
PRT,CPV,2016.0,4,2,2
ZMB,BEL,1997.0,1,1,0
NLD,MEX,2007.0,14,2,12
THA,BGD,2013.0,4,2,2
FRA,TGO,2016.0,3,4,-1
IND,LKA,2012.0,3,3,0
AUS,LKA,2005.0,2,6,-4
ECU,ARG,2009.0,1,1,0
NLD,OMN,2009.0,2,1,1
UKR,NOR,2016.0,2,2,0
DEU,CYP,2012.0,3,1,2
CAN,IRL,2004.0,10,22,-12
DZA,CHN,2021.0,2,11,-9
SWE,BGD,2011.0,7,6,1
EST,CZE,2014.0,2,1,1
BEL,UKR,2012.0,2,3,-1
SVK,FRA,2013.0,2,4,-2
NZL,ARE,2015.0,4,2,2
POL,NOR,2009.0,5,2,3
IRL,TTO,2016.0,1,1,0
FRA,UKR,2022.0,3,14,-11
SLB,AUS,2019.0,3,1,2
IDN,NOR,2019.0,1,4,-3
IND,DNK,2003.0,4,2,2
CHN,CZE,2013.0,2,1,1
MAR,MYS,2020.0,2,2,0
ARE,PSE,2018.0,1,1,0
BRA,HUN,2023.0,2,1,1
BEL,DZA,2021.0,4,3,1
DOM,DMA,2020.0,4,4,0
ESP,HRV,2002.0,4,7,-3
ZMB,TZA,2021.0,1,3,-2
EGY,POL,2022.0,2,1,1
CHE,THA,2021.0,9,12,-3
CHE,GEO,2000.0,1,1,0
VNM,SWE,2014.0,2,9,-7
MLI,USA,2017.0,5,4,1
TUR,HUN,2017.0,1,1,0
IRN,ARE,2020.0,3,5,-2
SRB,RUS,2005.0,8,8,0
MYS,THA,2006.0,2,4,-2
SWE,UKR,2014.0,3,9,-6
SAU,FRA,2010.0,1,15,-14
DNK,MEX,2004.0,2,1,1
HUN,ISR,2010.0,3,2,1
ISR,HUN,2012.0,2,4,-2
ECU,GBR,2002.0,1,4,-3
IDN,BEL,2007.0,1,1,0
EGY,QAT,2005.0,1,3,-2
USA,MCO,2018.0,2,2,0
BEL,IND,2004.0,2,8,-6
SEN,GMB,2005.0,1,2,-1
BRA,HUN,2010.0,1,2,-1
TTO,CAN,2005.0,1,4,-3
COD,COG,2002.0,2,4,-2
DEU,LVA,2000.0,2,11,-9
DEU,HKG,2000.0,7,3,4
USA,MOZ,2006.0,1,2,-1
ECU,VEN,2010.0,1,1,0
BRA,SWE,2002.0,5,6,-1
SVN,FRA,2006.0,1,1,0
DNK,GRC,2006.0,4,2,2
DNK,GRC,2010.0,4,2,2
NLD,TUR,2000.0,3,8,-5
EGY,BEL,1999.0,1,2,-1
BEL,EGY,2000.0,2,3,-1
LBN,EGY,2015.0,4,9,-5
BEL,NOR,2005.0,3,1,2
MAR,USA,2003.0,4,9,-5
EST,DEU,2005.0,3,4,-1
DNK,UKR,2002.0,2,4,-2
GBR,TTO,1997.0,3,1,2
DNK,HKG,2007.0,2,1,1
GRC,RUS,1997.0,2,1,1
UKR,SWE,2008.0,4,3,1
RUS,CHE,1997.0,14,14,0
SVN,ITA,2001.0,4,5,-1
SVK,ITA,1998.0,4,3,1
BEN,CAN,2013.0,1,1,0
DEU,PAK,1997.0,4,1,3
SYC,FRA,2011.0,1,1,0
OMN,EGY,2000.0,2,3,-1
UGA,GBR,2001.0,2,3,-1
BEL,BOL,2001.0,1,1,0
NGA,ITA,2004.0,3,1,2
OMN,RUS,2020.0,1,1,0
URY,FRA,2009.0,1,7,-6
JPN,PAK,2003.0,5,2,3
JPN,SAU,1997.0,2,1,1
NGA,CHE,2003.0,1,1,0
BRA,BEL,2001.0,9,12,-3
ITA,SGP,2006.0,2,2,0
RUS,ARM,2001.0,4,3,1
DEU,CRI,1997.0,1,1,0
DEU,CRI,2002.0,3,2,1
HUN,JPN,2009.0,3,7,-4
SRB,HRV,2010.0,6,11,-5
NGA,DEU,2004.0,5,8,-3
MLT,CHE,2008.0,1,2,-1
FRA,PSE,2010.0,1,1,0
PSE,GBR,2020.0,8,3,5
PRT,JPN,2012.0,2,10,-8
HRV,NLD,2014.0,5,1,4
CRI,TWN,2012.0,1,1,0
PAK,BRN,2013.0,2,1,1
ISR,MEX,2016.0,4,3,1
GBR,SYR,2003.0,3,2,1
PRI,IND,1998.0,1,2,-1
SVN,CHE,2006.0,1,4,-3
IRN,FIN,2012.0,6,5,1
COL,GBR,2006.0,7,11,-4
ISR,ESP,2011.0,8,3,5
NGA,AUS,2005.0,2,7,-5
GEO,POL,2008.0,1,2,-1
YEM,EGY,2010.0,3,5,-2
SDN,DEU,2007.0,5,1,4
BRA,NOR,2007.0,1,1,0
ARE,KWT,2020.0,2,7,-5
USA,LTU,2012.0,6,4,2
COL,CAN,2004.0,4,2,2
JPN,BGR,2009.0,4,1,3
KOR,MEX,2011.0,3,4,-1
USA,MOZ,2010.0,4,1,3
FRA,CRI,2016.0,5,4,1
CYP,FRA,2015.0,2,3,-1
NCL,AUS,2020.0,1,3,-2
BHR,TUN,2022.0,2,4,-2
AUS,UKR,2012.0,2,3,-1
LIE,CHE,2022.0,6,7,-1
RUS,BLR,2023.0,7,14,-7
ROU,CHE,2005.0,4,1,3
CHE,ARG,1998.0,2,1,1
HUN,CZE,2020.0,6,7,-1
FRA,LBY,2009.0,2,1,1
ISR,CYP,2014.0,1,1,0
FIN,AUT,1998.0,1,6,-5
RUS,ARM,2015.0,8,2,6
AUS,PNG,2002.0,4,4,0
PAK,NZL,2013.0,6,10,-4
NLD,SRB,2009.0,1,2,-1
DNK,KOR,2012.0,3,5,-2
THA,SGP,2016.0,4,11,-7
CAN,ZWE,2014.0,2,2,0
POL,GRC,2021.0,2,4,-2
CHE,PER,2012.0,1,2,-1
YEM,IND,2010.0,1,6,-5
CZE,ESP,2005.0,4,4,0
JOR,BHR,2020.0,4,1,3
CHE,CUB,2021.0,1,1,0
IRQ,JOR,2019.0,4,6,-2
ZAF,IND,2002.0,4,6,-2
MOZ,NLD,2016.0,1,1,0
CHE,LBN,2017.0,3,4,-1
EGY,RUS,2015.0,4,3,1
ITA,BGD,2010.0,4,3,1
ITA,BOL,2020.0,2,1,1
USA,SAU,2024.0,2,1,1
BEL,ZWE,2012.0,1,1,0
USA,MNP,2012.0,1,3,-2
MAR,CAN,2013.0,3,10,-7
EGY,IRN,2016.0,3,2,1
BGD,THA,2014.0,3,5,-2
CUB,ITA,2008.0,5,3,2
GBR,FLK,2013.0,2,2,0
CAN,LKA,2011.0,4,3,1
IRL,ESP,2008.0,13,18,-5
TUN,BEL,2011.0,2,2,0
GRC,ROU,2015.0,4,2,2
CZE,UKR,2011.0,1,3,-2
MNG,KOR,2016.0,2,11,-9
BEL,TZA,2008.0,2,1,1
HKG,CHE,2015.0,7,8,-1
ISR,BEL,2023.0,3,1,2
TUN,MAR,2016.0,3,1,2
KOR,DNK,2010.0,5,4,1
CHN,THA,2010.0,8,10,-2
IRQ,OMN,2013.0,1,1,0
MWI,ZAF,2013.0,3,3,0
SWE,LUX,2021.0,6,3,3
CHN,ZAF,2012.0,3,4,-1
VEN,USA,2023.0,6,6,0
BTN,JPN,2021.0,1,3,-2
MEX,NGA,2011.0,2,2,0
THA,SWE,2008.0,4,7,-3
REU,FRA,2003.0,4,6,-2
BWA,GBR,2017.0,4,4,0
NGA,BRA,2011.0,2,1,1
FRA,MLI,2002.0,5,4,1
ROU,ARE,2017.0,3,2,1
ECU,PRT,2019.0,2,1,1
PHL,FRA,2001.0,2,2,0
HUN,CZE,1999.0,2,5,-3
LTU,DEU,2001.0,5,6,-1
USA,SEN,2012.0,4,5,-1
CZE,SRB,2021.0,3,2,1
SAU,TWN,2015.0,2,16,-14
HUN,CZE,1998.0,1,2,-1
KWT,BHR,2018.0,2,1,1
GBR,SVK,2014.0,4,10,-6
BGR,CHE,2010.0,2,5,-3
CZE,AUS,2013.0,7,3,4
CHE,CHL,2009.0,6,12,-6
ZAF,CHN,2007.0,2,6,-4
ARG,NZL,2021.0,4,1,3
PRT,CUB,2002.0,1,2,-1
IDN,SAU,2021.0,2,6,-4
EGY,NLD,2014.0,4,4,0
ITA,CYP,2013.0,3,1,2
BOL,FRA,2020.0,2,1,1
BLR,JPN,1999.0,5,2,3
ARG,PRI,2019.0,3,2,1
EGY,POL,2016.0,1,3,-2
USA,GMB,2014.0,1,3,-2
NPL,DEU,2017.0,1,2,-1
HUN,CHN,2014.0,3,3,0
GBR,FJI,2017.0,4,2,2
LKA,JPN,2000.0,4,3,1
EST,FIN,2004.0,5,6,-1
GRC,JPN,2000.0,7,3,4
CHN,EST,2015.0,1,1,0
BGD,NZL,2021.0,5,6,-1
NZL,BGD,2023.0,2,2,0
ITA,LBN,2020.0,5,2,3
IRL,JPN,1998.0,1,1,0
SVK,NLD,2017.0,6,2,4
PRK,USA,2017.0,6,1,5
CRI,GTM,2021.0,1,2,-1
NZL,IND,1999.0,3,8,-5
KEN,BDI,2021.0,3,2,1
NAM,CZE,2021.0,1,1,0
NLD,SRB,2019.0,1,6,-5
SWE,TWN,2022.0,2,8,-6
USA,BFA,2004.0,3,1,2
ETH,GBR,2007.0,4,4,0
KAZ,USA,2000.0,2,2,0
NOR,VNM,2020.0,1,3,-2
NLD,ZMB,2023.0,1,1,0
QAT,DZA,2022.0,4,2,2
BRA,USA,2024.0,3,5,-2
COL,PAN,2006.0,1,1,0
AUS,CZE,2007.0,3,3,0
NZL,TWN,2008.0,4,1,3
AUS,LBN,2023.0,2,1,1
SAU,ITA,2022.0,5,18,-13
EGY,PSE,2019.0,3,2,1
FJI,SLB,2022.0,1,1,0
UZB,MYS,2023.0,1,3,-2
PHL,IND,2022.0,6,6,0
BEL,EGY,2010.0,4,3,1
BLR,BEL,2000.0,1,3,-2
DNK,ISR,1998.0,1,1,0
TWN,JPN,1999.0,5,9,-4
TWN,THA,2024.0,1,2,-1
QAT,PRT,2017.0,1,2,-1
MYS,AUS,2000.0,4,9,-5
ESP,MDA,2004.0,1,1,0
ESP,MDA,2008.0,1,1,0
FRA,AGO,2010.0,3,3,0
IRL,QAT,2018.0,3,1,2
CMR,UGA,2003.0,1,1,0
HUN,FIN,2003.0,9,3,6
LKA,ZAF,2022.0,1,1,0
SAU,OMN,2019.0,7,3,4
ECU,ESP,1999.0,2,1,1
VNM,ZAF,2022.0,1,1,0
FRA,BLR,2004.0,2,3,-1
PHL,AUS,1999.0,2,7,-5
CHE,HRV,2022.0,5,5,0
CHL,CRI,2018.0,3,2,1
CRI,PER,2008.0,1,1,0
GBR,BEN,2003.0,2,1,1
BEN,GBR,2004.0,1,1,0
COL,VNM,2014.0,1,1,0
HUN,POL,2005.0,3,2,1
USA,BHR,1998.0,4,2,2
GBR,SRB,2023.0,7,4,3
IRQ,JOR,2009.0,6,1,5
CHL,JPN,2021.0,1,4,-3
AUT,BGR,2003.0,2,6,-4
SAU,KOR,2013.0,5,26,-21
CMR,NLD,2016.0,2,1,1
KOR,UZB,2007.0,2,2,0
BGR,ITA,2018.0,2,7,-5
CAN,HRV,2000.0,1,3,-2
BRA,AUT,2005.0,2,4,-2
IRN,IND,2008.0,4,10,-6
IND,ZAF,2002.0,6,4,2
CUB,ITA,2001.0,7,4,3
DNK,BGR,2000.0,2,1,1
CAN,HUN,2020.0,10,7,3
IDN,DNK,2017.0,2,1,1
ITA,NGA,2017.0,4,5,-1
ITA,NGA,2016.0,2,2,0
LAO,THA,2012.0,3,3,0
JOR,IRQ,2011.0,6,3,3
POL,ESP,1999.0,1,8,-7
EGY,BEL,1998.0,5,2,3
NOR,FIN,2011.0,5,20,-15
TGO,FRA,2003.0,2,3,-1
EGY,QAT,2002.0,4,3,1
ARM,ITA,1998.0,1,1,0
ITA,ARM,2000.0,4,1,3
NLD,ARG,2001.0,5,5,0
NGA,ZAF,2001.0,6,3,3
TWN,FRA,2010.0,6,10,-4
RUS,POL,2013.0,6,17,-11
GHA,NGA,2019.0,1,10,-9
NCL,FJI,2022.0,2,2,0
NOR,JPN,2002.0,3,11,-8
PAK,BGR,2011.0,1,1,0
USA,LTU,2002.0,9,7,2
GBR,BGR,1997.0,6,9,-3
GHA,UGA,2012.0,1,1,0
SVK,BEL,2019.0,2,2,0
NLD,ARE,2021.0,1,3,-2
NGA,ETH,2018.0,2,1,1
SAU,BEL,2015.0,2,5,-3
BRA,IND,2015.0,6,32,-26
KAZ,UKR,2017.0,2,2,0
AUT,BTN,2015.0,1,1,0
BEN,BFA,2014.0,3,4,-1
GBR,MKD,2022.0,1,1,0
MWI,CHE,2021.0,2,5,-3
BTN,IND,2013.0,1,1,0
MWI,NGA,2014.0,2,1,1
IRL,SRB,2022.0,1,4,-3
DNK,SGP,2012.0,3,4,-1
IDN,CAN,2018.0,2,8,-6
HUN,FRA,2023.0,4,2,2
NLD,CZE,2022.0,4,12,-8
TZA,CAN,2017.0,3,2,1
KWT,FRA,2022.0,5,7,-2
CHN,PHL,2008.0,1,3,-2
BRN,IDN,2020.0,3,2,1
SWE,IRN,2023.0,7,28,-21
IND,EST,2019.0,2,1,1
KOR,ALB,2021.0,1,1,0
IRQ,ITA,2020.0,2,4,-2
ITA,MKD,2018.0,1,2,-1
BGD,PAK,2017.0,13,10,3
LBN,GBR,2019.0,4,8,-4
PAN,ESP,2021.0,1,12,-11
AUT,BEL,2012.0,5,12,-7
TWN,NZL,2018.0,3,3,0
NOR,THA,2023.0,2,1,1
ISL,GBR,2017.0,6,9,-3
PAK,OMN,2018.0,6,5,1
SLV,GTM,2014.0,1,1,0
BRN,GBR,2013.0,1,9,-8
IDN,NOR,2021.0,1,2,-1
PRT,CAN,1998.0,1,4,-3
ZAF,MUS,2020.0,4,1,3
SRB,CZE,2019.0,4,2,2
BEN,BDI,2019.0,2,1,1
GHA,ITA,2020.0,2,5,-3
ITA,PHL,2022.0,1,4,-3
EGY,SGP,2020.0,2,1,1
BLR,VNM,2022.0,1,1,0
SGP,FIN,2019.0,6,5,1
FIN,GRC,2013.0,2,6,-4
SVN,SVK,2016.0,9,18,-9
BRA,SWE,1997.0,2,8,-6
PRT,IRN,2013.0,2,14,-12
MOZ,BEL,2021.0,2,1,1
IRN,MEX,2023.0,4,1,3
SVK,IND,2021.0,1,7,-6
FRA,CUB,2022.0,1,4,-3
GRC,IND,2022.0,3,1,2
VNM,CHE,2020.0,2,7,-5
HUN,IRL,2014.0,2,1,1
ARM,USA,2006.0,7,7,0
KOR,NGA,2013.0,1,1,0
NZL,ESP,2009.0,2,2,0
UGA,ITA,2019.0,6,3,3
ITA,UGA,2020.0,3,2,1
AUS,KWT,2012.0,2,2,0
IND,TUR,2014.0,3,2,1
CHE,LIE,2017.0,2,1,1
JPN,IRN,2001.0,4,4,0
IDN,GBR,2013.0,1,15,-14
AUT,BIH,2009.0,1,1,0
SWE,CHL,2013.0,1,5,-4
GRC,CZE,2004.0,1,1,0
NZL,BWA,2005.0,2,1,1
IND,AFG,2014.0,1,3,-2
GHA,CMR,2021.0,4,1,3
NOR,ISR,2009.0,2,3,-1
ERI,NLD,2006.0,2,1,1
EGY,CZE,2015.0,2,3,-1
ESP,NZL,2011.0,4,3,1
PAK,SWE,2008.0,5,2,3
NLD,BGR,2007.0,1,4,-3
POL,AUT,2004.0,3,2,1
GBR,GHA,1997.0,3,5,-2
BWA,AUS,2007.0,1,1,0
MEX,ISR,2004.0,1,1,0
TUR,RUS,2008.0,3,5,-2
COG,FRA,2008.0,2,4,-2
ROU,TUR,2018.0,3,2,1
KEN,NLD,2008.0,3,4,-1
CHL,CHN,2010.0,1,8,-7
ISR,KEN,2007.0,1,1,0
JPN,ZMB,2016.0,6,5,1
KOR,SRB,2006.0,1,1,0
GBR,URY,2018.0,3,1,2
AUS,JOR,2008.0,4,2,2
JOR,AUS,2010.0,3,3,0
HKG,SWE,2017.0,4,6,-2
MOZ,USA,2009.0,2,4,-2
PRT,ZAF,2020.0,3,5,-2
BRA,BLZ,2011.0,2,2,0
POL,CZE,2006.0,4,7,-3
TUN,CHE,2015.0,1,3,-2
ARE,MYS,2024.0,1,2,-1
FRA,KEN,2010.0,8,2,6
AUT,IRL,2016.0,3,7,-4
HRV,AUT,2007.0,5,4,1
NLD,SAU,2023.0,6,7,-1
IRL,EGY,2016.0,2,4,-2
SVN,CZE,2020.0,5,1,4
LAO,GBR,2017.0,3,4,-1
CHN,LTU,2020.0,2,3,-1
SRB,PRT,2016.0,2,3,-1
GHA,BFA,2016.0,3,3,0
MWI,NGA,2008.0,1,1,0
IND,EGY,2015.0,3,2,1
ISR,MEX,2022.0,1,3,-2
ESP,ARE,2016.0,10,1,9
SVK,PRT,2006.0,1,1,0
PRT,GRC,2023.0,1,1,0
CHN,BOL,2016.0,1,1,0
CHE,COD,2015.0,2,1,1
ARE,IRQ,2018.0,1,2,-1
GIN,USA,2014.0,1,1,0
CHN,FJI,2020.0,1,1,0
USA,CYM,2013.0,1,2,-1
TUR,BIH,2019.0,5,2,3
GAB,DEU,2017.0,3,7,-4
AZE,GBR,2017.0,1,2,-1
DNK,CZE,2014.0,4,6,-2
BRA,SRB,2000.0,1,3,-2
SAU,FRA,2023.0,7,13,-6
SYC,AUS,2021.0,1,2,-1
PHL,BEL,2020.0,4,2,2
GHA,ESP,2020.0,1,1,0
CRI,GBR,2023.0,2,2,0
LUX,BEL,2020.0,11,25,-14
GEO,AUS,1998.0,2,1,1
ITA,TUN,2008.0,4,1,3
SAU,NZL,2021.0,4,3,1
CIV,USA,2021.0,9,4,5
IND,UKR,2019.0,3,2,1
MOZ,USA,2021.0,5,9,-4
POL,MEX,2014.0,4,1,3
NGA,LBR,2021.0,4,1,3
CMR,COD,2023.0,1,1,0
OMN,TUN,2015.0,1,1,0
POL,ISR,2016.0,4,1,3
TUR,DZA,2020.0,4,2,2
MAC,BRA,2021.0,1,1,0
FRA,ZWE,2015.0,1,1,0
ZAF,BWA,1999.0,1,2,-1
BOL,BEL,2004.0,2,1,1
USA,BRB,2002.0,1,6,-5
BRB,JAM,2005.0,1,1,0
UKR,BEL,2003.0,4,2,2
ESP,TTO,2017.0,1,1,0
KOR,ESP,2007.0,2,7,-5
NOR,ROU,1999.0,1,1,0
NZL,COL,2003.0,1,1,0
TKM,TUR,2017.0,1,2,-1
UZB,KAZ,2000.0,1,5,-4
GBR,TUN,2000.0,1,1,0
PAK,BEL,2002.0,1,2,-1
MLI,FRA,2007.0,7,1,6
TZA,NLD,2017.0,2,5,-3
BGR,CHE,2000.0,1,3,-2
ESP,PRY,2007.0,1,3,-2
IRL,RUS,2010.0,4,2,2
ESP,ISR,2000.0,5,5,0
ITA,KOR,2004.0,4,1,3
DNK,GRL,2016.0,8,2,6
SVK,JPN,2003.0,4,6,-2
AUS,NPL,2000.0,1,1,0
TZA,GBR,1997.0,4,9,-5
GRC,RUS,2002.0,6,6,0
NOR,BRA,2003.0,3,1,2
TZA,IND,2022.0,1,2,-1
GBR,SRB,2006.0,7,15,-8
ZWE,USA,2000.0,11,8,3
CMR,ITA,2006.0,1,1,0
AUT,SRB,2007.0,1,7,-6
MEX,CZE,2002.0,3,2,1
ISR,SWE,2007.0,2,2,0
LKA,NLD,2004.0,4,1,3
FRA,LVA,2005.0,2,1,1
USA,CMR,2005.0,5,3,2
QAT,DEU,2021.0,2,5,-3
PAK,TUR,2014.0,7,4,3
KWT,SAU,2006.0,1,2,-1
NPL,IND,1997.0,1,2,-1
GRC,NOR,2002.0,1,4,-3
RUS,UZB,2014.0,4,4,0
FRA,MLI,1997.0,3,1,2
KNA,USA,2014.0,2,2,0
TUR,IRN,2005.0,1,2,-1
JPN,GRC,1999.0,2,1,1
ESP,UKR,2015.0,4,6,-2
GBR,LBY,2003.0,3,2,1
PER,CHE,2010.0,3,1,2
BEL,SAU,2013.0,3,1,2
ARM,RUS,2007.0,3,2,1
USA,GTM,2016.0,9,11,-2
ROU,OMN,2009.0,5,9,-4
GHA,ITA,1999.0,1,1,0
THA,IND,1999.0,2,1,1
CAN,GHA,2010.0,1,3,-2
NZL,BEL,1999.0,1,1,0
VNM,BEL,2006.0,4,3,1
CHL,POL,2011.0,2,2,0
JPN,IRL,2013.0,2,16,-14
IDN,FRA,2000.0,3,4,-1
GRC,TUR,2013.0,4,2,2
GBR,MNG,2019.0,1,1,0
ITA,COL,2012.0,6,3,3
SEN,DEU,2006.0,2,2,0
NOR,CYP,2017.0,2,1,1
GBR,FRO,2018.0,1,2,-1
ECU,ARG,2021.0,7,8,-1
JPN,COL,2014.0,3,3,0
POL,ARG,2010.0,1,1,0
CUB,CHE,2015.0,1,1,0
NLD,UKR,2015.0,5,6,-1
ROU,AUT,2009.0,3,2,1
MEX,IRL,1999.0,1,1,0
PRT,TUN,2013.0,1,1,0
UZB,FRA,2015.0,2,2,0
SVN,GBR,2010.0,6,7,-1
NLD,SVN,2018.0,2,8,-6
SVN,POL,2022.0,1,1,0
COL,NLD,2010.0,4,2,2
IDN,DEU,2010.0,4,22,-18
SGP,POL,2012.0,1,2,-1
TZA,KEN,2016.0,3,7,-4
UKR,NLD,1999.0,3,2,1
IND,AUT,2005.0,5,6,-1
ITA,HUN,2001.0,6,4,2
AND,ESP,2009.0,1,3,-2
YEM,MYS,2014.0,5,7,-2
PHL,GBR,2012.0,5,5,0
CZE,DNK,2015.0,4,5,-1
CHN,MLI,2017.0,1,1,0
NGA,UGA,2023.0,8,7,1
EGY,ITA,1997.0,2,5,-3
PRT,EGY,2014.0,2,3,-1
MYS,IRL,2014.0,2,8,-6
HKG,MAC,2011.0,7,1,6
CHN,MYS,2002.0,4,2,2
ESP,KEN,2017.0,1,1,0
FIN,BLZ,1999.0,1,1,0
LIE,CHE,2018.0,3,4,-1
MYS,SWE,2023.0,2,2,0
TUN,DEU,2018.0,2,6,-4
ITA,EGY,2007.0,7,4,3
IRN,SYR,2019.0,2,1,1
NGA,LBR,2019.0,2,1,1
LAO,GBR,2018.0,3,6,-3
TUN,CHN,2022.0,5,1,4
MNG,DEU,2021.0,4,1,3
SLE,GBR,2020.0,5,1,4
IND,ZWE,2017.0,1,1,0
BEL,MDG,2022.0,2,1,1
BWA,GBR,2018.0,2,8,-6
PAK,NOR,2021.0,4,2,2
IRL,QAT,2017.0,1,1,0
CHE,PRT,2007.0,5,8,-3
BIH,USA,2021.0,5,6,-1
DNK,RUS,2023.0,6,11,-5
DNK,IND,2002.0,3,5,-2
VEN,CHL,2009.0,5,5,0
SWE,ISR,1998.0,2,2,0
DEU,MDA,2009.0,4,3,1
MCO,FRA,1998.0,5,4,1
MCO,USA,2001.0,2,3,-1
ROU,JPN,2002.0,5,5,0
ROU,GBR,2005.0,9,13,-4
KOR,HKG,2023.0,9,13,-4
BFA,USA,2023.0,5,2,3
CHE,TZA,2022.0,7,8,-1
ZAF,LKA,2022.0,1,1,0
SVK,HUN,2020.0,9,9,0
MEX,RUS,2010.0,10,4,6
KWT,AUS,2012.0,2,2,0
AUS,BGD,2014.0,23,55,-32
SWE,KOR,2013.0,8,6,2
CHN,SAU,2017.0,39,43,-4
VNM,ITA,1997.0,1,2,-1
IRL,NZL,2018.0,17,8,9
FRA,ECU,2022.0,5,9,-4
ZAF,BWA,2002.0,4,1,3
JPN,FIN,2016.0,13,16,-3
CHN,IRN,2014.0,7,15,-8
LTU,DEU,2013.0,5,10,-5
SAU,SDN,2013.0,5,26,-21
ESP,PRY,2012.0,4,1,3
NOR,AUT,2023.0,2,10,-8
VNM,AUT,2018.0,3,4,-1
BEL,ZAF,1999.0,4,6,-2
KOR,IDN,2015.0,18,6,12
PHL,CHN,2020.0,8,7,1
ESP,ISR,2021.0,14,8,6
CHL,DOM,2016.0,2,3,-1
CHE,ISR,2016.0,15,15,0
MEX,PER,2014.0,7,3,4
PRT,NZL,2021.0,3,3,0
JPN,BEL,2017.0,20,23,-3
IRL,POL,2009.0,4,10,-6
AGO,ESP,2016.0,1,1,0
CYP,USA,2018.0,8,18,-10
PRI,CRI,2015.0,2,1,1
LUX,USA,2022.0,8,7,1
MYS,YEM,2016.0,17,2,15
CMR,NGA,2016.0,1,2,-1
KWT,CAN,2012.0,6,11,-5
CAN,KWT,2016.0,9,14,-5
IND,ESP,2006.0,11,8,3
IND,QAT,2022.0,15,9,6
ISR,BEL,2019.0,4,7,-3
ESP,ARG,1997.0,35,37,-2
DEU,KOR,2005.0,33,24,9
ITA,LVA,2014.0,1,1,0
UZB,KOR,2020.0,2,9,-7
JPN,MNG,2013.0,5,5,0
MYS,FRA,2008.0,7,2,5
FRA,MYS,2012.0,4,2,2
NPL,IND,2007.0,26,8,18
CHL,MEX,2012.0,10,20,-10
MYS,RUS,2021.0,4,2,2
MEX,RUS,2023.0,3,4,-1
PRY,MEX,2015.0,1,1,0
BGR,PRT,2011.0,4,2,2
CHN,PAK,2024.0,17,17,0
PRT,GRC,2021.0,3,3,0
PER,CHL,2017.0,9,9,0
HUN,NOR,2016.0,9,4,5
CHE,JPN,2010.0,28,42,-14
FRA,PER,2020.0,6,8,-2
CHL,TUR,2015.0,3,1,2
IRN,IND,2013.0,12,24,-12
TUR,CHE,2013.0,13,15,-2
ITA,OMN,2018.0,1,1,0
GMB,USA,2016.0,2,4,-2
THA,NZL,2016.0,5,2,3
THA,NZL,2018.0,4,5,-1
VNM,TWN,2013.0,3,8,-5
RUS,POL,2008.0,6,17,-11
ESP,FIN,2017.0,20,11,9
VNM,DEU,2015.0,8,22,-14
BFA,FRA,2012.0,19,18,1
NCL,DEU,2013.0,1,1,0
YEM,MYS,2013.0,2,9,-7
ESP,NOR,2015.0,28,8,20
SYR,GBR,2017.0,5,1,4
CAN,GEO,2012.0,1,1,0
EST,AUT,2014.0,1,1,0
IND,FIN,2015.0,23,8,15
SRB,GBR,2020.0,14,21,-7
HUN,IND,2018.0,4,7,-3
IND,BEL,2009.0,9,5,4
NOR,ARE,2021.0,3,3,0
AUS,PAK,2011.0,11,23,-12
HRV,BEL,2016.0,2,1,1
DEU,TWN,2020.0,14,32,-18
JPN,EGY,2001.0,17,18,-1
NOR,DEU,2003.0,30,42,-12
KWT,JOR,2015.0,1,4,-3
RWA,GBR,2017.0,3,2,1
UGA,NGA,2006.0,1,1,0
MYS,NZL,2014.0,11,28,-17
GRC,TUR,2014.0,10,1,9
AUS,TWN,1998.0,11,5,6
NLD,MEX,2002.0,4,3,1
COG,COD,2015.0,40,31,9
FIN,IND,2014.0,5,16,-11
KOR,NLD,2014.0,7,7,0
USA,JAM,2017.0,11,12,-1
AUT,NOR,2014.0,11,4,7
ITA,MLT,2017.0,13,3,10
ARG,COL,2014.0,14,15,-1
ARG,DZA,2019.0,2,4,-2
SRB,IRQ,2018.0,3,1,2
NLD,POL,2018.0,19,13,6
JPN,BRA,2020.0,7,23,-16
IRQ,IRN,2014.0,13,6,7
TUR,NZL,2021.0,2,3,-1
UKR,CZE,2016.0,9,2,7
COL,DEU,2016.0,21,19,2
MDA,ROU,2020.0,8,4,4
GRC,AUT,2019.0,6,3,3
CZE,BEL,2012.0,7,8,-1
TCD,USA,2018.0,1,1,0
EGY,DNK,2021.0,2,3,-1
NGA,CHN,2011.0,6,4,2
BIH,SRB,2016.0,14,23,-9
GRC,IRL,2022.0,5,5,0
ITA,PAK,2018.0,21,14,7
LTU,GBR,2022.0,8,8,0
SGP,NLD,2021.0,19,17,2
NLD,ETH,2018.0,25,7,18
NLD,SAU,2019.0,13,5,8
ZMB,KEN,2017.0,4,2,2
CAN,KWT,2018.0,10,9,1
KOR,SWE,1998.0,2,8,-6
KOR,SWE,1999.0,9,5,4
UKR,CHE,2017.0,5,2,3
LUX,CHE,2019.0,5,11,-6
IND,GRC,2011.0,3,1,2
NOR,IND,2022.0,20,22,-2
POL,CAN,2017.0,12,22,-10
TUN,GBR,2021.0,1,2,-1
CZE,PHL,2022.0,2,1,1
KOR,MYS,2015.0,13,14,-1
CRI,BRA,2018.0,1,3,-2
PER,DEU,2014.0,5,5,0
SAU,MYS,2011.0,5,23,-18
ECU,USA,2023.0,17,13,4
ISR,AUS,2017.0,24,12,12
UKR,USA,2019.0,19,20,-1
SGP,IRN,2014.0,4,10,-6
NOR,IND,2018.0,8,16,-8
JPN,SAU,2020.0,13,8,5
TZA,GBR,2020.0,7,9,-2
DEU,SAU,2016.0,34,8,26
ESP,SVK,2017.0,2,2,0
NZL,LKA,2016.0,6,4,2
IRL,PAK,2022.0,10,19,-9
HUN,RUS,2018.0,2,3,-1
LBN,QAT,2017.0,3,2,1
AUS,PAK,2009.0,9,6,3
SDN,USA,2018.0,4,5,-1
DZA,JPN,2016.0,2,2,0
ZAF,KEN,2020.0,29,18,11
FIN,KEN,2018.0,1,2,-1
USA,ALB,2013.0,2,4,-2
NLD,DNK,2004.0,15,18,-3
NZL,TWN,2013.0,2,5,-3
ESP,CAN,2009.0,31,36,-5
CHN,POL,2017.0,9,13,-4
IND,HKG,2015.0,16,3,13
ISL,USA,2022.0,10,10,0
CRI,DEU,2018.0,4,10,-6
USA,BHR,2012.0,3,1,2
JPN,HUN,2018.0,9,4,5
NGA,PAK,2021.0,7,6,1
HKG,NGA,2021.0,3,6,-3
POL,UKR,2020.0,34,46,-12
CAN,NOR,2020.0,29,13,16
CIV,FRA,2006.0,19,18,1
ITA,PAK,2022.0,11,53,-42
THA,BGD,2014.0,5,3,2
BEL,JPN,2013.0,17,19,-2
BEL,IND,2013.0,17,22,-5
SWE,NGA,2018.0,2,1,1
CZE,IND,2021.0,15,51,-36
IRN,JPN,2020.0,16,16,0
NLD,ISL,2008.0,3,1,2
USA,PER,2023.0,22,38,-16
NOR,IND,2016.0,14,14,0
DNK,BEL,2007.0,5,4,1
KEN,DEU,1998.0,2,3,-1
POL,DNK,2011.0,7,3,4
IND,TUR,2013.0,6,4,2
SAU,AUS,2021.0,26,93,-67
RUS,KGZ,2021.0,6,7,-1
KOR,SWE,2007.0,4,2,2
AZE,IRN,2010.0,6,2,4
IRN,AZE,2012.0,2,3,-1
CHE,PER,2020.0,3,1,2
COG,USA,2022.0,2,3,-1
IRQ,IND,2012.0,2,6,-4
GBR,LKA,2021.0,20,25,-5
DNK,ISR,2002.0,2,4,-2
IND,IDN,2023.0,5,2,3
TWN,PAK,2022.0,9,11,-2
IND,NPL,2004.0,20,13,7
ARG,ZAF,2021.0,5,1,4
PHL,NOR,2021.0,1,1,0
GAB,USA,2019.0,2,10,-8
CAN,GHA,2021.0,8,10,-2
COL,SAU,2021.0,6,2,4
CHL,JPN,2010.0,1,4,-3
CRI,COL,2019.0,2,4,-2
SAU,AUS,2011.0,4,20,-16
SYR,RUS,2022.0,4,2,2
NLD,RUS,2011.0,17,13,4
CAN,ISR,2005.0,27,58,-31
VEN,FRA,2012.0,7,4,3
BRA,VEN,2004.0,4,5,-1
SAU,USA,2006.0,17,54,-37
JOR,CAN,2018.0,10,13,-3
ITA,HRV,2016.0,14,5,9
DEU,DZA,2017.0,5,4,1
RUS,CAN,2006.0,25,16,9
USA,PER,2010.0,31,56,-25
ZAF,SWZ,2012.0,2,11,-9
SVK,SLV,2012.0,6,16,-10
DEU,CRI,1998.0,2,1,1
CHN,NLD,2006.0,22,33,-11
CHN,MNG,2014.0,5,5,0
POL,FIN,2012.0,8,9,-1
NLD,SGP,2006.0,4,7,-3
BGR,JPN,1998.0,8,1,7
BFA,CAN,2011.0,2,3,-1
SWZ,NGA,2021.0,1,1,0
CHN,NOR,2008.0,10,9,1
MLT,GBR,2008.0,3,9,-6
SGP,KOR,2005.0,11,4,7
CHN,KEN,2013.0,6,5,1
ISR,DEU,2009.0,41,30,11
AUS,ETH,2019.0,11,27,-16
BRA,CHN,2006.0,1,1,0
BEL,ARG,2010.0,6,5,1
IDN,GBR,2008.0,8,10,-2
GRC,ISR,2010.0,3,6,-3
CHN,THA,2009.0,8,6,2
VEN,BRA,2006.0,5,11,-6
ARG,MEX,2014.0,17,23,-6
DEU,PSE,2010.0,6,3,3
GRC,MEX,2011.0,1,1,0
LTU,SWE,2012.0,3,2,1
CAN,SRB,2019.0,2,6,-4
NZL,ARG,2010.0,1,1,0
USA,KAZ,2011.0,7,4,3
SGP,CZE,2015.0,2,1,1
THA,NLD,2005.0,4,4,0
ESP,COL,2004.0,20,13,7
CIV,USA,2010.0,5,1,4
PRT,AUS,2021.0,7,7,0
CHL,DNK,2015.0,4,2,2
IDN,SGP,2018.0,5,7,-2
SGP,IDN,2019.0,10,4,6
USA,CUB,2007.0,5,9,-4
USA,KWT,2001.0,9,16,-7
USA,AFG,2016.0,6,4,2
GRC,IRL,2016.0,7,1,6
HUN,ISR,2009.0,5,3,2
GBR,CRI,2015.0,5,1,4
IRL,MYS,2008.0,3,1,2
GRC,CAN,2020.0,18,10,8
ROU,NLD,2013.0,8,5,3
MYS,KWT,2015.0,1,1,0
LVA,GBR,2004.0,4,2,2
ZWE,COG,2023.0,5,3,2
GHA,NLD,2020.0,9,9,0
LUX,FRA,2014.0,26,38,-12
LUX,NLD,2017.0,4,7,-3
TUR,JPN,2004.0,13,13,0
CYP,GBR,2010.0,6,23,-17
JPN,PHL,1997.0,7,3,4
GBR,QAT,2008.0,8,2,6
DEU,IDN,2009.0,13,8,5
GRC,JPN,2011.0,2,4,-2
SWE,SVN,2018.0,5,6,-1
AUT,EGY,2010.0,8,3,5
NLD,SVK,2009.0,4,4,0
FRA,MTQ,1998.0,7,12,-5
SWE,ITA,2015.0,35,84,-49
DEU,LTU,2018.0,4,11,-7
ESP,DNK,1997.0,9,6,3
ARE,IND,2004.0,1,8,-7
AZE,RUS,2004.0,4,7,-3
ESP,ZAF,2012.0,9,4,5
IRL,BEL,2010.0,7,12,-5
NGA,CHN,2021.0,28,34,-6
BRA,JPN,2011.0,6,18,-12
CAN,OMN,2016.0,8,10,-2
ITA,BEN,2005.0,1,1,0
SAU,JOR,2013.0,17,39,-22
NZL,SWE,2016.0,12,9,3
CYP,TUR,2008.0,9,13,-4
NAM,DEU,2017.0,1,1,0
CHN,NGA,2008.0,3,4,-1
RUS,SAU,2016.0,5,2,3
ZWE,RWA,2013.0,1,3,-2
AUS,TUR,2017.0,11,22,-11
FIN,CHN,2001.0,7,8,-1
ESP,TUR,2022.0,14,20,-6
BEL,MWI,2010.0,1,1,0
AUS,TWN,2007.0,17,5,12
KOR,MYS,2008.0,2,4,-2
DEU,SRB,2007.0,18,42,-24
DEU,CYP,2020.0,8,4,4
FIN,EST,2005.0,6,3,3
EST,SWE,2010.0,5,14,-9
ISR,IRN,2007.0,2,1,1
CZE,HUN,2019.0,7,10,-3
USA,MLI,2017.0,4,5,-1
AUS,MYS,2007.0,23,18,5
IND,LKA,2007.0,3,6,-3
GBR,JAM,2018.0,1,3,-2
EGY,CAN,2005.0,10,13,-3
SWE,PRT,2021.0,8,20,-12
POL,UKR,2007.0,16,17,-1
CHL,NZL,2014.0,6,4,2
PHL,USA,2013.0,29,32,-3
CUB,ARG,2006.0,2,4,-2
GBR,LKA,2009.0,9,5,4
JPN,ARE,2007.0,3,3,0
TCD,FRA,2016.0,1,2,-1
SVK,GRC,2008.0,2,1,1
SAU,CAN,2000.0,10,22,-12
VEN,BRA,2010.0,3,1,2
IRL,SGP,2011.0,6,2,4
AUS,PNG,2020.0,10,4,6
FRA,HRV,2010.0,7,4,3
BHR,USA,1998.0,2,4,-2
ZAF,ITA,2023.0,5,1,4
CAN,VNM,2018.0,5,2,3
TWN,AUT,2022.0,4,3,1
ROU,SWE,2022.0,2,2,0
SWE,IND,2006.0,5,19,-14
FRA,URY,2020.0,5,1,4
SWE,ZAF,2017.0,10,16,-6
ITA,VNM,2019.0,6,3,3
PSE,ISR,2020.0,14,37,-23
DEU,PAK,1999.0,5,5,0
SWE,NZL,2008.0,11,1,10
ITA,HUN,2013.0,12,10,2
ARG,CAN,1998.0,4,11,-7
NGA,IND,2020.0,12,14,-2
FRA,VNM,2006.0,13,4,9
LVA,DEU,2018.0,5,3,2
PAK,ARE,2022.0,19,11,8
RUS,PRT,2017.0,4,10,-6
DEU,DZA,2018.0,5,4,1
CAN,IRQ,2020.0,6,7,-1
OMN,PAK,2020.0,4,8,-4
NLD,KOR,2021.0,16,14,2
CAN,POL,2012.0,17,16,1
FJI,USA,2019.0,3,2,1
CHL,COL,2018.0,37,35,2
USA,GUM,2018.0,15,11,4
GEO,USA,2006.0,27,31,-4
RUS,UZB,2013.0,9,10,-1
ITA,HRV,2022.0,12,3,9
ITA,PSE,2020.0,5,1,4
FRA,NCL,2018.0,24,25,-1
NPL,LKA,2013.0,1,2,-1
NZL,JPN,2021.0,11,6,5
GBR,BGR,2020.0,14,8,6
QAT,ARE,2022.0,8,5,3
CHN,IRL,2023.0,31,24,7
ITA,EST,2019.0,9,4,5
CMR,ZAF,2022.0,8,6,2
IRQ,USA,2017.0,13,36,-23
USA,SRB,2009.0,26,17,9
JPN,ARG,2022.0,1,2,-1
NOR,POL,2017.0,6,7,-1
DNK,POL,2016.0,7,9,-2
BEL,ZAF,2020.0,14,17,-3
GBR,VEN,2018.0,2,4,-2
ETH,TWN,2020.0,3,16,-13
UKR,FRA,2021.0,8,5,3
MDG,GBR,2017.0,7,7,0
SGP,ESP,2017.0,9,6,3
SWE,OMN,2017.0,1,4,-3
BEL,LBN,2015.0,4,5,-1
FRA,MCO,2020.0,16,17,-1
SWE,RUS,2021.0,16,24,-8
CHL,ISR,2022.0,3,2,1
DZA,IRN,2016.0,2,1,1
KWT,GBR,2022.0,11,20,-9
MWI,USA,2005.0,2,5,-3
FRA,MDG,2013.0,14,11,3
MDG,FRA,2015.0,16,12,4
TZA,ZAF,2013.0,6,7,-1
AUT,UKR,2015.0,2,5,-3
CAN,BEL,2007.0,20,25,-5
IRN,CAN,2002.0,27,52,-25
DNK,PRT,2009.0,3,2,1
IND,NZL,1999.0,8,3,5
NZL,FJI,2005.0,2,2,0
BEN,BEL,2000.0,2,1,1
HRV,BIH,2002.0,6,15,-9
BIH,HRV,2005.0,10,21,-11
ISL,FRA,1999.0,1,2,-1
VNM,JPN,2001.0,2,6,-4
JPN,VNM,2002.0,8,4,4
CAN,NGA,2004.0,2,2,0
NOR,CHE,2012.0,10,14,-4
ESP,AUT,2012.0,21,31,-10
CAN,ARG,2014.0,20,12,8
ROU,CHE,1999.0,2,2,0
ARE,SAU,2010.0,11,14,-3
CZE,CAN,2006.0,9,5,4
PRT,ARG,2017.0,3,1,2
AUT,NOR,2001.0,2,1,1
ZMB,USA,2003.0,3,5,-2
USA,ZMB,2004.0,4,3,1
LTU,EST,2003.0,1,3,-2
KHM,CHE,2014.0,1,2,-1
GIN,FRA,2013.0,2,5,-3
FRA,PHL,2000.0,2,2,0
BRA,CHL,1997.0,6,10,-4
AFG,USA,2005.0,3,1,2
DEU,CZE,1997.0,15,20,-5
FIN,CHE,1997.0,9,10,-1
MEX,CUB,2009.0,6,20,-14
MYS,KOR,2009.0,4,6,-2
VEN,GBR,2000.0,7,11,-4
HKG,AUS,2001.0,14,45,-31
FRA,FIN,2006.0,10,9,1
RUS,EGY,2015.0,3,4,-1
GBR,NGA,1999.0,20,15,5
DEU,TZA,2015.0,5,8,-3
POL,NOR,2010.0,11,6,5
CHE,FIN,2012.0,7,11,-4
FRA,MLI,1998.0,2,4,-2
POL,ITA,2000.0,10,16,-6
USA,SVN,2003.0,16,10,6
ARE,EGY,2019.0,8,18,-10
SAU,JPN,2017.0,10,22,-12
JOR,GBR,2001.0,3,12,-9
UKR,NLD,2005.0,6,1,5
CAN,CHL,2004.0,6,8,-2
CHN,UZB,2015.0,1,1,0
HRV,FRA,1999.0,5,3,2
SVN,CZE,2002.0,1,1,0
USA,TZA,2016.0,25,16,9
GHA,USA,2002.0,15,6,9
CAN,EGY,2004.0,10,15,-5
CHE,DNK,2015.0,25,30,-5
GBR,SRB,2011.0,12,8,4
NLD,ZWE,1998.0,3,2,1
DZA,DEU,2015.0,3,3,0
CAN,TTO,2015.0,1,2,-1
IDN,SGP,2016.0,6,11,-5
THA,GBR,2002.0,20,46,-26
ITA,IND,2003.0,14,22,-8
THA,CAN,2006.0,9,9,0
JPN,CZE,2001.0,8,9,-1
FRA,TCD,2007.0,1,1,0
DNK,AUT,2013.0,8,11,-3
SYR,EGY,1998.0,1,1,0
AUT,FIN,2006.0,6,6,0
RUS,MDA,2019.0,4,3,1
MDA,RUS,2020.0,4,3,1
AUS,CZE,2002.0,3,2,1
UKR,KOR,2002.0,4,4,0
NLD,SVK,2019.0,3,3,0
ROU,MDA,2022.0,2,3,-1
ARM,ITA,2002.0,1,1,0
MCO,FRA,1999.0,7,4,3
HUN,ARE,2004.0,2,1,1
MAR,USA,2004.0,3,3,0
DZA,BEL,2001.0,2,2,0
IND,BRA,2001.0,9,5,4
ETH,KEN,2009.0,4,1,3
ROU,HUN,1998.0,4,3,1
LUX,DEU,2016.0,28,25,3
HRV,ESP,2000.0,2,6,-4
SRB,GBR,1999.0,12,1,11
SAU,LBN,2019.0,3,6,-3
BGR,BEL,2001.0,10,4,6
HRV,DEU,2008.0,7,16,-9
UKR,JPN,1999.0,14,3,11
CZE,ISR,2004.0,1,3,-2
CAN,SVK,2003.0,1,8,-7
ALB,SRB,2011.0,6,3,3
NLD,IRL,2003.0,9,10,-1
CZE,JPN,2000.0,4,7,-3
USA,CRI,2005.0,13,8,5
LTU,SWE,2005.0,6,8,-2
CHL,JPN,2000.0,1,2,-1
USA,BGR,2020.0,14,11,3
ISR,SWE,1997.0,4,1,3
SWE,ISR,2007.0,2,2,0
HRV,BIH,2005.0,21,10,11
NLD,GRC,2007.0,10,8,2
IND,SAU,2001.0,10,7,3
NZL,AUT,2019.0,7,6,1
IRQ,USA,2018.0,20,43,-23
ITA,POL,2004.0,11,13,-2
HUN,CHE,2000.0,13,5,8
CAN,HUN,2005.0,3,9,-6
EST,DEU,1998.0,4,1,3
BGR,DEU,2005.0,23,23,0
CAN,THA,1998.0,4,1,3
NLD,IDN,2001.0,9,7,2
SVN,DEU,2000.0,4,7,-3
ITA,POL,2008.0,18,13,5
POL,ITA,2010.0,11,12,-1
ESP,AUT,1997.0,3,11,-8
MEX,SWE,2015.0,6,4,2
ITA,TWN,2004.0,2,3,-1
MAC,CHN,2000.0,2,1,1
SGP,CHE,2008.0,6,12,-6
RUS,GEO,2017.0,3,2,1
MRT,FRA,2007.0,3,1,2
THA,DEU,2013.0,14,39,-25
AUS,CHL,2005.0,2,3,-1
CZE,DEU,2006.0,27,34,-7
NZL,IND,2002.0,2,5,-3
RUS,MEX,2000.0,16,6,10
FRA,SYR,2013.0,10,1,9
CHE,CZE,2008.0,11,15,-4
DEU,JOR,2011.0,11,7,4
VEN,MEX,2002.0,5,1,4
PAK,UZB,2003.0,1,1,0
KOR,UKR,2013.0,2,1,1
PRT,DZA,2002.0,1,1,0
IRL,NLD,2003.0,10,9,1
CZE,AUS,2001.0,3,2,1
NLD,BGR,2002.0,9,6,3
CHE,CHL,2010.0,9,17,-8
MYS,JPN,1998.0,7,5,2
MNG,AUS,2014.0,1,1,0
BGR,JPN,1999.0,9,3,6
KEN,NLD,2003.0,3,5,-2
ISR,CAN,1997.0,16,17,-1
JPN,GRC,2005.0,3,5,-2
CAN,NPL,1999.0,1,1,0
PRT,ITA,2003.0,3,22,-19
COD,COG,1999.0,5,1,4
NLD,THA,2003.0,2,4,-2
USA,BWA,1999.0,3,3,0
PHL,JPN,2002.0,14,21,-7
ZAF,DEU,2000.0,12,19,-7
KWT,SRB,2000.0,1,1,0
DEU,PRT,2008.0,18,14,4
SVN,NLD,2012.0,4,2,2
DEU,HRV,1999.0,18,6,12
DNK,ARG,2005.0,2,2,0
ISR,ESP,2000.0,5,5,0
DEU,JOR,2009.0,9,5,4
CHE,NOR,2007.0,16,7,9
SWE,UKR,2013.0,3,6,-3
CHL,FRA,2004.0,11,16,-5
DEU,SDN,2012.0,3,4,-1
CHN,BRA,2011.0,3,6,-3
AUS,GRC,2003.0,4,3,1
DEU,ETH,2015.0,12,9,3
CAN,MAR,1999.0,4,4,0
MAR,CAN,2001.0,1,5,-4
BFA,FRA,2005.0,6,11,-5
CAN,SRB,2009.0,5,3,2
OMN,JOR,2002.0,2,1,1
LTU,SWE,1997.0,3,2,1
ITA,SVN,2001.0,5,4,1
GBR,BHR,2012.0,5,4,1
CHE,BEL,1999.0,10,18,-8
ZAF,KEN,2007.0,8,15,-7
KOR,TUR,2013.0,7,6,1
COG,COD,2008.0,11,14,-3
NOR,NLD,2012.0,14,18,-4
DZA,FIN,2016.0,2,1,1
DNK,IRL,2018.0,4,7,-3
CMR,USA,2007.0,8,4,4
COL,FRA,1998.0,2,4,-2
MWI,ZAF,2014.0,12,3,9
COL,PAN,2011.0,3,2,1
HRV,USA,2010.0,17,30,-13
ESP,HKG,2015.0,3,1,2
MYS,AUT,2020.0,3,1,2
SWE,EST,2023.0,4,6,-2
FRA,QAT,2013.0,15,3,12
AUT,IRN,2021.0,5,20,-15
SWE,JPN,2010.0,24,43,-19
JPN,DNK,2005.0,5,11,-6
CHE,MEX,2020.0,7,15,-8
SVN,SLV,2018.0,8,9,-1
JPN,PRT,2014.0,3,3,0
CAF,DEU,2009.0,1,1,0
CHE,GRC,2015.0,18,38,-20
JPN,LKA,2010.0,10,4,6
SAU,CAN,2006.0,21,30,-9
COL,CHL,2010.0,18,9,9
BEL,ETH,2009.0,4,2,2
TUR,JPN,2015.0,5,7,-2
NZL,CAN,2006.0,30,29,1
CAN,NGA,2014.0,3,6,-3
RUS,AUT,2011.0,12,9,3
CHE,VNM,2006.0,3,1,2
TUR,SGP,2013.0,3,1,2
MYS,EGY,2015.0,7,6,1
NGA,GHA,2017.0,8,4,4
SRB,BIH,2012.0,20,14,6
IND,FRA,2007.0,44,34,10
BEL,IRL,2018.0,15,13,2
LUX,FRA,2008.0,7,19,-12
JPN,PRT,2015.0,3,3,0
URY,FRA,2010.0,8,2,6
ITA,ARG,2014.0,14,13,1
FRA,ETH,2014.0,2,1,1
LAO,JPN,2011.0,2,2,0
PRT,NOR,2017.0,13,2,11
ETH,IND,2014.0,5,31,-26
NLD,FIN,2006.0,13,15,-2
IDN,MYS,2010.0,6,12,-6
EST,NLD,2011.0,1,2,-1
CHN,PRT,2014.0,9,10,-1
CAN,IDN,2007.0,1,2,-1
PRT,CHN,2022.0,14,16,-2
NZL,IND,2012.0,5,12,-7
NOR,FRA,2022.0,23,38,-15
BEL,CIV,2008.0,4,1,3
NER,FRA,2016.0,3,4,-1
COG,KEN,2007.0,1,3,-2
KOR,GBR,2006.0,20,43,-23
NOR,NLD,1997.0,5,6,-1
MWI,AUS,2011.0,1,1,0
POL,CAN,2016.0,17,25,-8
IRL,CHE,2004.0,5,7,-2
AUS,HUN,2002.0,3,3,0
GAB,FRA,2000.0,8,1,7
CYP,SWE,2014.0,3,1,2
ETH,BEL,2012.0,3,4,-1
NZL,EGY,2011.0,2,1,1
USA,LSO,2019.0,5,2,3
NLD,ZAF,2012.0,18,18,0
MEX,KOR,2011.0,4,3,1
LSO,ZAF,2007.0,3,1,2
NLD,OMN,2010.0,4,1,3
CHE,URY,2019.0,2,1,1
TUN,USA,2011.0,11,8,3
RUS,JPN,2020.0,15,19,-4
CHL,ECU,2015.0,11,2,9
NPL,USA,2007.0,7,2,5
GBR,ETH,2022.0,6,7,-1
LTU,USA,2006.0,6,9,-3
SAU,FRA,2009.0,2,9,-7
SAU,LBN,2011.0,1,3,-2
TUR,MYS,2017.0,3,11,-8
DEU,SVN,2014.0,7,16,-9
KOR,KHM,2014.0,1,1,0
KHM,USA,2009.0,6,3,3
ZWE,MWI,2012.0,1,1,0
LBN,CAN,2012.0,4,13,-9
CHL,CZE,2015.0,2,1,1
HUN,NLD,2013.0,11,8,3
HUN,ROU,2017.0,17,14,3
HKG,CAN,2003.0,26,29,-3
FRA,LUX,2007.0,26,10,16
LTU,FIN,2013.0,2,4,-2
PAK,FRA,2010.0,8,11,-3
CHE,ARE,2016.0,5,3,2
GEO,BEL,2015.0,2,1,1
IRN,KOR,2015.0,13,8,5
FRA,GAB,2013.0,8,6,2
TWN,ZAF,2017.0,3,3,0
DEU,LVA,2021.0,6,4,2
PYF,FRA,2015.0,17,20,-3
SLV,SVK,2016.0,6,2,4
TUR,AUT,2020.0,11,4,7
DEU,JOR,2019.0,12,15,-3
SWE,MYS,2019.0,4,9,-5
SVN,HRV,2015.0,9,10,-1
FRA,SVN,2019.0,3,3,0
CAN,GHA,2019.0,9,8,1
CRI,NLD,2014.0,1,2,-1
KOR,TWN,2023.0,7,16,-9
PAK,NZL,2014.0,6,9,-3
JOR,IRQ,2010.0,8,3,5
MYS,YEM,2022.0,21,4,17
SRB,FRA,2006.0,8,6,2
KOR,QAT,2018.0,7,1,6
ZAF,MWI,2016.0,8,10,-2
SAU,ZAF,2009.0,7,5,2
CHE,TUN,2010.0,2,3,-1
FIN,EST,2012.0,17,12,5
ESP,IRL,2013.0,30,27,3
NZL,LKA,2017.0,3,2,1
KOR,LKA,2015.0,2,2,0
TUN,ESP,2018.0,10,13,-3
LKA,NLD,2013.0,1,3,-2
MAR,FRA,2015.0,54,115,-61
BEN,SEN,2017.0,1,2,-1
BRA,PAK,2018.0,9,6,3
DEU,LTU,2022.0,7,5,2
AFG,AUS,2015.0,2,1,1
SGP,FRA,2013.0,21,35,-14
HRV,IND,2017.0,1,1,0
LTU,ESP,2017.0,1,2,-1
ALB,SRB,2021.0,8,12,-4
HRV,DEU,2014.0,18,15,3
PAK,BRA,2016.0,5,7,-2
CAN,BFA,2014.0,1,3,-2
CHN,SAU,2018.0,47,44,3
PRT,TUR,2019.0,1,3,-2
TUR,PRT,2020.0,6,2,4
BEL,NLD,2024.0,2,1,1
BRA,AGO,2017.0,2,1,1
LBY,MYS,2013.0,4,5,-1
NZL,ZAF,2012.0,8,8,0
CYP,ESP,2020.0,3,2,1
HKG,FIN,2016.0,3,1,2
CAN,JAM,2021.0,5,5,0
GBR,MLT,2023.0,13,5,8
AUS,THA,2017.0,34,24,10
FRA,LAO,2017.0,3,6,-3
NOR,JPN,2020.0,7,11,-4
FRA,ROU,2020.0,26,22,4
JPN,MMR,2010.0,4,2,2
AUT,CZE,2019.0,22,15,7
THA,SWE,2013.0,5,6,-1
NZL,NOR,2018.0,10,5,5
AUT,NLD,2009.0,12,8,4
FRA,ECU,2018.0,13,2,11
TUR,ALB,2019.0,2,1,1
ARG,AUS,2018.0,7,5,2
USA,GUY,2014.0,2,1,1
IRQ,QAT,2019.0,3,1,2
RUS,JPN,2007.0,23,25,-2
GEO,USA,2010.0,43,31,12
ESP,IND,2012.0,9,23,-14
KOR,EGY,2017.0,9,5,4
HUN,FRA,2021.0,16,12,4
SGP,CHE,2014.0,23,26,-3
SWE,RUS,2019.0,23,18,5
LKA,USA,2010.0,12,8,4
CHL,COL,2016.0,20,22,-2
RUS,ZAF,1997.0,1,1,0
PRT,FRA,2021.0,49,51,-2
MAR,DZA,2014.0,3,3,0
MYS,NZL,2015.0,24,28,-4
BRA,PER,2016.0,22,16,6
DZA,TUR,2016.0,4,2,2
NLD,NOR,2023.0,20,16,4
AUS,IRN,2001.0,17,2,15
TTO,GBR,2020.0,5,6,-1
BGR,FRA,2003.0,6,16,-10
SVN,FIN,2021.0,1,3,-2
CHN,NOR,2004.0,5,4,1
USA,TGO,2021.0,2,1,1
EGY,IND,2018.0,6,6,0
TUR,CZE,2013.0,1,2,-1
DZA,SAU,2023.0,5,5,0
ITA,DZA,2020.0,10,5,5
ARG,COL,2015.0,11,11,0
IND,ATG,2018.0,1,1,0
CMR,ZAF,2016.0,8,6,2
CHN,IRL,2010.0,18,10,8
DNK,SRB,2009.0,2,2,0
CHN,CZE,2015.0,4,6,-2
MYS,TWN,2014.0,7,7,0
NOR,CAN,2016.0,14,27,-13
IND,GBR,2024.0,3,2,1
SVN,GBR,2021.0,15,14,1
CAN,RWA,2017.0,1,1,0
UGA,RWA,2020.0,1,3,-2
RWA,KEN,2018.0,6,5,1
PER,ESP,2010.0,10,6,4
AUS,FJI,2016.0,7,8,-1
ETH,UGA,2019.0,1,3,-2
BEL,BRA,2000.0,15,10,5
QAT,CAN,2015.0,14,23,-9
ARE,ZAF,2017.0,2,1,1
ZAF,RWA,2019.0,9,2,7
ITA,ECU,2021.0,1,8,-7
MYS,NOR,2015.0,1,1,0
CZE,AUT,2017.0,15,19,-4
ROU,ITA,2022.0,10,10,0
FIN,SGP,2022.0,3,8,-5
IND,PRI,2008.0,6,4,2
NZL,NLD,1997.0,3,10,-7
CHN,NGA,2015.0,7,16,-9
LKA,IND,2015.0,9,6,3
FIN,NLD,2017.0,21,25,-4
SEN,MLI,2018.0,3,2,1
BIH,SRB,2022.0,12,12,0
IDN,NZL,2023.0,3,1,2
SAU,TUR,2016.0,2,11,-9
IRL,PAK,2016.0,3,6,-3
SGP,RUS,2018.0,5,6,-1
ZAF,KOR,2015.0,8,2,6
AUS,MAC,2022.0,7,4,3
MEX,CRI,2019.0,5,1,4
ARG,PRT,2022.0,4,3,1
GHA,DEU,2015.0,7,10,-3
USA,LVA,2019.0,6,2,4
CHE,CMR,2011.0,7,3,4
ITA,ROU,2017.0,18,20,-2
ISR,CHE,1999.0,8,2,6
ITA,PAK,2016.0,26,9,17
ITA,SGP,2021.0,13,6,7
DNK,VNM,2019.0,7,3,4
ZAF,LKA,2016.0,3,1,2
BGD,KOR,2012.0,19,14,5
DEU,LUX,2022.0,24,31,-7
SVK,GBR,2016.0,3,6,-3
NGA,JPN,2018.0,7,12,-5
IRL,ARE,2023.0,5,1,4
PER,ARG,2019.0,3,9,-6
KEN,NGA,2015.0,3,1,2
AUS,KOR,2008.0,23,13,10
IRL,AUT,2019.0,5,6,-1
DEU,MAC,2019.0,3,1,2
SVN,CHE,2011.0,4,1,3
SAU,ZAF,2019.0,13,22,-9
CUB,USA,2014.0,14,9,5
USA,OMN,1997.0,3,3,0
BRA,ARG,2001.0,24,35,-11
CUB,ITA,2013.0,3,4,-1
LUX,GBR,2005.0,2,6,-4
PSE,EGY,2022.0,4,4,0
SVK,USA,2018.0,10,19,-9
KAZ,TUR,2019.0,6,6,0
ARE,PRT,2023.0,2,4,-2
IDN,FRA,2021.0,7,19,-12
CHN,GBR,2024.0,22,13,9
NOR,LVA,2021.0,1,1,0
POL,AUS,2017.0,11,6,5
SGP,ARE,2022.0,7,5,2
PRT,MOZ,2022.0,6,5,1
KAZ,USA,2021.0,8,20,-12
DEU,KAZ,2023.0,3,2,1
ZAF,RWA,2021.0,3,6,-3
VIR,USA,2019.0,13,4,9
VIR,USA,2021.0,2,13,-11
CYP,PRT,2020.0,2,1,1
BEL,DNK,2021.0,19,25,-6
KEN,TZA,2019.0,8,9,-1
CZE,PAK,2019.0,5,5,0
PRT,NZL,2019.0,3,3,0
ITA,AUS,2021.0,30,47,-17
NGA,CHN,2019.0,37,20,17
JPN,AUT,2017.0,15,10,5
DEU,SRB,2020.0,11,24,-13
ARG,MEX,2001.0,7,9,-2
FRA,KWT,2022.0,7,5,2
THA,LAO,2019.0,14,8,6
CAN,NPL,2020.0,2,3,-1
THA,VNM,2019.0,22,9,13
DEU,KEN,2023.0,4,12,-8
ARG,BEL,2010.0,5,6,-1
LBY,GBR,2020.0,6,24,-18
OMN,IND,1997.0,3,1,2
GBR,SRB,2009.0,10,5,5
TWN,KOR,2023.0,16,7,9
NGA,CIV,2020.0,1,4,-3
RWA,GBR,2018.0,2,2,0
NLD,SXM,2022.0,3,2,1
CHE,SVN,2021.0,4,4,0
JOR,MYS,2020.0,13,31,-18
IRQ,CHN,2022.0,4,12,-8
FRA,CHL,2022.0,23,27,-4
MEX,JPN,2021.0,7,5,2
RUS,MEX,2006.0,5,6,-1
JOR,DEU,2023.0,5,7,-2
BFA,MLI,2012.0,1,3,-2
GAB,USA,2021.0,4,7,-3
SWE,DZA,2021.0,1,1,0
ESP,DOM,2023.0,2,5,-3
CHE,LAO,2022.0,1,1,0
DNK,THA,2023.0,3,2,1
BRA,HUN,2021.0,6,1,5
BRA,NLD,2022.0,56,24,32
NLD,PER,2021.0,2,1,1
JPN,AFG,2022.0,6,4,2
ITA,BGD,2021.0,7,4,3
PER,JPN,2021.0,2,3,-1
DZA,GBR,2023.0,1,2,-1
BGD,ESP,2017.0,3,2,1
USA,CAN,2024.0,5,10,-5
MYS,MAR,2022.0,1,3,-2
JPN,BEL,2018.0,18,19,-1
PRT,BEL,2016.0,21,19,2
DEU,LTU,2016.0,3,6,-3
IND,QAT,2018.0,9,7,2
TWN,CAN,2006.0,8,15,-7
TWN,FRA,2021.0,9,14,-5
ITA,POL,2014.0,21,16,5
PER,CHL,2016.0,4,12,-8
SRB,AUT,2022.0,5,2,3
CZE,ISR,2001.0,3,2,1
ESP,TUR,2017.0,12,10,2
COL,NLD,2019.0,11,14,-3
CAN,RUS,2010.0,21,30,-9
HKG,IND,2020.0,12,17,-5
GBR,SVN,2015.0,8,15,-7
MAR,CAN,2004.0,8,7,1
IND,EGY,2013.0,2,2,0
EGY,IND,2016.0,9,8,1
SGP,MAC,2021.0,4,1,3
CHE,SWZ,2016.0,11,4,7
GBR,NLD,2024.0,2,5,-3
GHA,HKG,2021.0,4,3,1
AUT,ETH,2018.0,5,2,3
MYS,KOR,2021.0,15,12,3
VNM,CHN,2014.0,7,11,-4
ARM,RUS,2012.0,7,6,1
GBR,TZA,2023.0,7,7,0
NOR,GHA,2016.0,1,1,0
TTO,JAM,2022.0,1,3,-2
QAT,GRC,2017.0,6,2,4
CHL,FRA,2015.0,33,56,-23
SVK,SWE,2016.0,5,4,1
ROU,CHE,2007.0,4,6,-2
BEL,IRL,2016.0,7,11,-4
URY,ESP,2019.0,11,12,-1
PER,GBR,2012.0,5,4,1
CAN,MYS,2012.0,6,14,-8
RUS,CHN,2023.0,60,27,33
LTU,GBR,2018.0,13,8,5
BEL,ETH,2021.0,20,14,6
LVA,USA,2017.0,7,2,5
FIN,MWI,2019.0,1,1,0
IRQ,CHN,2016.0,3,21,-18
CZE,JPN,2023.0,3,7,-4
MUS,GBR,2017.0,3,1,2
KOR,NPL,2017.0,8,2,6
CHE,PHL,2018.0,2,2,0
TZA,UGA,2021.0,5,6,-1
ETH,AUS,2015.0,7,1,6
NZL,HUN,2013.0,1,1,0
ROU,AUT,2023.0,1,2,-1
ETH,AUT,2016.0,1,2,-1
NGA,GHA,2016.0,4,3,1
SGP,ARE,2017.0,6,3,3
FRA,KWT,2016.0,3,1,2
JOR,NOR,2019.0,1,1,0
CMR,GHA,2016.0,1,2,-1
KHM,USA,2019.0,8,8,0
TZA,ETH,2022.0,1,4,-3
CIV,BEN,2019.0,1,4,-3
MEX,CZE,2020.0,6,3,3
FRA,PRT,2018.0,63,37,26
NLD,IRN,2006.0,6,3,3
RUS,SVK,2019.0,3,5,-2
IRL,AUT,2021.0,6,2,4
IRN,SRB,2016.0,1,1,0
PRT,FIN,2017.0,7,2,5
SAU,HKG,2022.0,5,3,2
RUS,EST,2023.0,7,2,5
DNK,GNB,2020.0,5,2,3
ARM,COL,2020.0,2,2,0
NLD,MOZ,2019.0,2,2,0
ECU,GBR,2020.0,4,6,-2
DNK,COL,2014.0,1,3,-2
ITA,TWN,2014.0,4,4,0
BEL,HUN,2014.0,8,8,0
CUB,BEL,2023.0,2,3,-1
HRV,CZE,2023.0,4,5,-1
SAU,TUR,2022.0,7,8,-1
ESP,RUS,2023.0,4,9,-5
USA,SDN,2022.0,4,2,2
SAU,FRA,2019.0,10,27,-17
FIN,NGA,2021.0,2,1,1
GHA,GBR,2003.0,4,10,-6
BGD,SAU,2009.0,3,3,0
SAU,BGD,2016.0,7,9,-2
FRA,KEN,2021.0,5,5,0
BRA,PRY,2020.0,13,3,10
POL,SVK,2022.0,12,5,7
KAZ,KOR,2019.0,11,4,7
BRB,JAM,2020.0,3,2,1
MEX,CUB,2019.0,18,36,-18
GHA,FRA,2018.0,2,1,1
FIN,ESP,2022.0,13,27,-14
KHM,THA,2018.0,3,5,-2
COL,ARG,2023.0,12,8,4
ROU,DEU,2022.0,23,20,3
ETH,AUT,2022.0,1,3,-2
YEM,EGY,2021.0,4,9,-5
FIN,KOR,2011.0,1,5,-4
LAO,JPN,2021.0,3,4,-1
IDN,POL,2022.0,4,2,2
ITA,CHN,2002.0,11,21,-10
ZAF,IND,2020.0,30,44,-14
ECU,COL,2021.0,13,3,10
BGD,ARE,2022.0,1,2,-1
PHL,BGD,2021.0,2,1,1
PAK,NOR,2023.0,8,4,4
PAK,FRA,2023.0,14,13,1
HUN,IRQ,2023.0,8,6,2
DNK,ISL,2017.0,6,5,1
GTM,BRA,2019.0,1,2,-1
NGA,COG,2021.0,2,1,1
CAN,EGY,2001.0,13,6,7
AUT,SRB,2002.0,2,1,1
ZAF,CMR,2004.0,2,3,-1
CHE,CUB,2000.0,1,3,-2
MEX,JPN,2009.0,3,1,2
ESP,DZA,2004.0,3,1,2
DEU,TZA,2001.0,3,1,2
DEU,IDN,2011.0,14,11,3
BRA,RUS,2002.0,13,12,1
AUS,PRT,2010.0,4,3,1
ITA,SVN,2014.0,10,12,-2
SAU,SWE,2008.0,2,4,-2
ISR,PSE,2007.0,12,2,10
AUS,ARE,1999.0,3,1,2
DNK,NOR,2008.0,26,32,-6
CAN,CHL,2008.0,10,12,-2
BRB,USA,2002.0,6,1,5
BEL,BGR,2015.0,5,4,1
CRI,CHL,2014.0,3,1,2
AUS,CHN,2002.0,32,47,-15
MEX,DEU,2002.0,10,23,-13
DEU,LBN,2000.0,1,1,0
ZAF,SAU,2003.0,3,1,2
PHL,ESP,2020.0,11,5,6
LAO,THA,2007.0,1,2,-1
JPN,IDN,1998.0,16,8,8
USA,FSM,2017.0,1,2,-1
FRA,JOR,2018.0,1,4,-3
FRA,DNK,1997.0,15,22,-7
AUT,ISR,1997.0,1,3,-2
NOR,BWA,1998.0,1,1,0
JPN,LKA,2000.0,3,4,-1
LVA,SWE,2013.0,6,3,3
DEU,MEX,2017.0,35,40,-5
MWI,ZMB,2013.0,1,1,0
SWE,ISL,2012.0,14,17,-3
KEN,SWE,2000.0,2,1,1
SVK,CZE,1998.0,12,12,0
CZE,SVK,2001.0,23,23,0
AUS,IDN,2000.0,7,9,-2
JPN,BGR,2006.0,7,8,-1
DNK,EST,2021.0,5,4,1
ARM,USA,2011.0,7,10,-3
NLD,HRV,2010.0,1,1,0
DEU,BEN,2020.0,4,2,2
DEU,ARG,1999.0,11,25,-14
THA,ITA,2019.0,4,8,-4
EST,SWE,2000.0,11,3,8
FRA,URY,1999.0,1,1,0
DNK,MYS,2008.0,3,1,2
TTO,GRD,2011.0,7,1,6
FRA,KEN,2011.0,2,6,-4
SWE,IRN,2009.0,14,10,4
SWE,IRN,2011.0,14,32,-18
PHL,AUS,2002.0,11,2,9
BEL,GRC,2002.0,8,7,1
ROU,GRC,2002.0,4,1,3
FRA,GLP,2011.0,29,34,-5
USA,URY,2006.0,12,12,0
KAZ,UZB,2000.0,5,1,4
FRA,BOL,2006.0,4,2,2
AUT,KEN,2016.0,2,1,1
IRN,USA,2003.0,32,34,-2
KOR,DNK,2009.0,3,2,1
COG,BFA,2013.0,1,3,-2
DNK,IND,1998.0,7,5,2
TTO,KNA,2021.0,1,1,0
ITA,SAU,2003.0,2,2,0
ARG,DZA,2009.0,2,3,-1
UZB,USA,2010.0,2,1,1
ARE,HUN,2022.0,3,1,2
TUR,JOR,2001.0,3,1,2
TUR,JOR,2015.0,1,2,-1
BFA,BEN,2016.0,2,1,1
CAN,NOR,1998.0,9,10,-1
IDN,MYS,2006.0,4,5,-1
IND,AUT,2007.0,9,3,6
ESP,SVN,2008.0,3,2,1
CAN,BFA,2008.0,1,1,0
CHE,SGP,2001.0,6,5,1
ITA,ZAF,2003.0,4,3,1
USA,BGD,1999.0,12,7,5
DNK,ECU,2002.0,1,1,0
MKD,SRB,2008.0,20,26,-6
BEN,DEU,1999.0,1,1,0
DEU,TGO,2012.0,1,1,0
MWI,USA,2012.0,16,19,-3
IDN,GBR,2004.0,3,4,-1
SWE,LTU,2005.0,8,6,2
USA,TUN,2002.0,3,7,-4
SWE,LTU,2002.0,7,5,2
EGY,FRA,2003.0,4,7,-3
HRV,SVN,2010.0,4,6,-2
MEX,AUS,1999.0,1,3,-2
NLD,RUS,2009.0,11,15,-4
GRC,FRA,1999.0,18,27,-9
ZWE,USA,2009.0,13,8,5
CZE,IRL,2007.0,5,1,4
CUB,USA,2004.0,11,8,3
POL,JPN,2017.0,8,12,-4
PER,MEX,2009.0,3,3,0
ZAF,MWI,2017.0,10,5,5
LKA,NGA,2011.0,1,1,0
SVK,CZE,1999.0,13,14,-1
EGY,DEU,2000.0,18,16,2
SWE,UGA,2011.0,3,1,2
CAN,IRN,1997.0,7,7,0
MAR,USA,2001.0,7,5,2
USA,ERI,1999.0,1,1,0
PAK,ARE,2016.0,15,5,10
FRA,IDN,2013.0,15,5,10
ZAF,IND,2007.0,7,9,-2
CAN,SVK,2013.0,2,5,-3
SVK,SVN,2012.0,14,21,-7
PRT,ZAF,2002.0,2,3,-1
CIV,ZAF,2003.0,2,3,-1
NGA,CHN,2009.0,3,3,0
KOR,PAK,2009.0,7,6,1
BEL,HUN,2015.0,6,9,-3
IRL,DNK,2002.0,3,2,1
LBN,QAT,2018.0,4,3,1
IND,PRT,2007.0,7,4,3
FRA,EGY,2001.0,2,4,-2
ISL,DEU,2002.0,2,1,1
BEN,NGA,2018.0,7,10,-3
SVK,CHE,2005.0,5,3,2
GRC,FRA,2007.0,21,26,-5
CHL,FIN,2013.0,3,1,2
FRA,TWN,2009.0,5,7,-2
AUS,PNG,2007.0,5,7,-2
CAN,COL,2021.0,15,32,-17
ITA,ISR,2005.0,3,8,-5
DNK,RUS,2009.0,4,4,0
GBR,CRI,2014.0,2,1,1
DEU,LVA,2019.0,5,3,2
SVN,AUS,2016.0,3,1,2
MYS,PHL,2021.0,3,1,2
MEX,HUN,2016.0,1,3,-2
URY,CHL,2019.0,2,2,0
DNK,ITA,2010.0,12,36,-24
COG,FRA,2013.0,4,9,-5
IND,DNK,2008.0,13,3,10
BEN,BEL,2023.0,1,1,0
JOR,EGY,2007.0,2,1,1
UZB,RUS,2001.0,16,11,5
GBR,TTO,1998.0,2,13,-11
GBR,KWT,2001.0,15,1,14
USA,OMN,2002.0,5,9,-4
NGA,KEN,1999.0,1,1,0
LUX,USA,2017.0,11,11,0
SWE,SVN,2016.0,3,6,-3
DNK,COL,2015.0,2,2,0
EST,CAN,2008.0,1,2,-1
GBR,ROU,2009.0,11,10,1
CHE,SGP,2015.0,23,16,7
POL,TWN,2002.0,2,1,1
LKA,SWE,2002.0,1,1,0
THA,BEL,2007.0,2,2,0
IND,IRN,2009.0,24,10,14
DEU,ETH,2008.0,4,4,0
CHN,ZAF,2007.0,6,2,4
DEU,GHA,2003.0,7,3,4
RUS,CZE,2010.0,12,4,8
NLD,SGP,2010.0,8,7,1
ARE,JOR,2022.0,17,35,-18
AUS,EGY,2009.0,3,2,1
DZA,BEL,2004.0,3,3,0
BEL,DZA,2010.0,2,2,0
USA,UZB,2007.0,4,3,1
LTU,UKR,2016.0,2,2,0
UGA,CAN,2010.0,1,1,0
TWN,JPN,2005.0,19,40,-21
CHE,IRN,2014.0,12,24,-12
FIN,CZE,2008.0,3,5,-2
BRA,GUF,2013.0,1,1,0
ARG,NLD,2012.0,6,6,0
UKR,MEX,2005.0,2,3,-1
EGY,BHR,2016.0,4,1,3
MAR,CAN,2015.0,7,8,-1
DNK,CAN,2006.0,25,21,4
MLT,DEU,2019.0,1,2,-1
IRL,GRC,2008.0,5,4,1
FIN,LUX,2009.0,1,1,0
FRA,VNM,2010.0,10,8,2
CHL,ECU,2014.0,2,12,-10
PRY,USA,2005.0,3,3,0
SWE,PRT,2009.0,12,2,10
PRT,NOR,2018.0,9,6,3
ROU,HUN,2007.0,6,3,3
PRT,GRC,2009.0,1,1,0
PAK,BGD,2023.0,3,4,-1
LUX,NLD,2016.0,8,3,5
KEN,IND,2022.0,4,3,1
RUS,BRA,2012.0,5,2,3
RUS,BEL,2011.0,7,7,0
IRL,IND,2012.0,12,18,-6
NOR,ESP,2007.0,6,3,3
ITA,DNK,2007.0,10,12,-2
SRB,ESP,2004.0,3,5,-2
MWI,GBR,2007.0,9,6,3
LUX,BRA,2021.0,3,4,-1
KOR,VNM,2010.0,18,13,5
PRT,UKR,2012.0,2,1,1
CHE,NZL,2014.0,6,17,-11
LKA,JPN,2009.0,2,7,-5
FRA,GEO,2019.0,7,9,-2
JPN,PHL,2005.0,13,16,-3
NLD,KOR,2009.0,5,3,2
CHL,VEN,2017.0,2,14,-12
COL,KEN,2016.0,3,1,2
MEX,NOR,2023.0,1,1,0
FRA,IRN,2012.0,25,21,4
AUT,CAN,2007.0,17,10,7
NZL,RUS,2004.0,3,2,1
IRQ,JOR,2006.0,3,1,2
VNM,DEU,2008.0,5,6,-1
FIN,DZA,2019.0,1,1,0
FIN,DZA,2021.0,1,1,0
AUS,EST,2014.0,2,2,0
USA,MLI,2018.0,10,7,3
NGA,NLD,2018.0,4,6,-2
IRN,IRL,2012.0,9,8,1
EST,NLD,2021.0,3,1,2
BRA,IND,2013.0,6,10,-4
GBR,CYP,2009.0,25,7,18
TZA,JPN,2017.0,2,1,1
NLD,ISR,2011.0,7,11,-4
IRL,PRT,2012.0,4,6,-2
BGD,CHN,2008.0,1,1,0
FRA,VEN,2010.0,8,8,0
GBR,LBN,2013.0,9,3,6
CHE,TWN,2011.0,4,5,-1
DEU,LBN,2010.0,3,2,1
SAU,LBN,2021.0,3,11,-8
GHA,SWE,2007.0,1,1,0
DNK,BRA,2012.0,1,9,-8
FIN,DNK,1997.0,4,4,0
THA,CHE,2006.0,1,2,-1
THA,CHE,2010.0,6,2,4
EGY,KWT,2014.0,21,17,4
URY,ESP,2011.0,12,6,6
NGA,NER,2014.0,12,2,10
SWE,EST,2010.0,14,5,9
CAN,ECU,2021.0,6,8,-2
NLD,TZA,2005.0,2,1,1
GHA,USA,2012.0,14,24,-10
ESP,IDN,2015.0,3,1,2
ARE,KOR,2019.0,1,16,-15
CHN,HUN,2022.0,10,4,6
JOR,CAN,2017.0,8,13,-5
GRC,BRA,2016.0,1,2,-1
TUR,JPN,2008.0,2,11,-9
UGA,NOR,2011.0,4,1,3
ESP,PRI,2019.0,3,7,-4
CHE,SVK,2019.0,7,4,3
ARE,KOR,2011.0,2,1,1
SGP,ARE,2016.0,5,1,4
IRL,NOR,2007.0,4,2,2
DEU,SYR,2015.0,4,7,-3
IND,ATG,2022.0,3,1,2
GBR,ECU,2020.0,6,4,2
CMR,DEU,2007.0,4,2,2
HKG,KOR,2012.0,6,5,1
SGP,TWN,2017.0,14,24,-10
ARG,PER,2010.0,1,3,-2
GBR,NPL,2017.0,7,12,-5
GBR,IDN,2009.0,14,2,12
IRN,ESP,2007.0,3,1,2
NLD,BRA,2003.0,11,12,-1
NLD,ISR,2009.0,14,16,-2
SGP,DNK,2022.0,7,5,2
NLD,VNM,2007.0,4,4,0
OMN,GBR,2010.0,6,4,2
FIN,NLD,2018.0,15,26,-11
GRC,DNK,2013.0,13,1,12
VNM,NLD,2012.0,5,2,3
CHE,CZE,2004.0,8,10,-2
THA,ESP,2014.0,1,2,-1
LUX,USA,2016.0,9,13,-4
IND,NZL,2007.0,4,2,2
AUT,KOR,2017.0,4,11,-7
HUN,IND,2022.0,6,9,-3
ROU,GRC,2012.0,3,3,0
PAK,JPN,2019.0,8,13,-5
KHM,LAO,2015.0,2,1,1
IDN,JPN,2011.0,31,96,-65
SRB,CHN,2015.0,1,1,0
TUR,BEL,2018.0,8,12,-4
JOR,AUS,2011.0,4,9,-5
KOR,NLD,2015.0,12,8,4
ESP,GRC,2016.0,15,17,-2
ESP,NZL,2010.0,1,3,-2
SRB,USA,2013.0,14,20,-6
USA,NGA,2013.0,40,36,4
ITA,LUX,2011.0,5,1,4
ARG,CAN,2007.0,9,16,-7
MYS,IRN,2006.0,2,1,1
SWE,EGY,2017.0,4,6,-2
IRQ,JOR,2023.0,2,2,0
FIN,PRT,2010.0,4,1,3
ARE,JPN,2019.0,2,8,-6
FIN,MEX,2017.0,3,2,1
CHN,BGD,2011.0,5,2,3
GBR,PER,2019.0,4,9,-5
MYS,DEU,2016.0,15,17,-2
SRB,SVN,2022.0,9,6,3
GEO,DEU,2010.0,8,2,6
HUN,SRB,2022.0,2,4,-2
KWT,GBR,2017.0,10,10,0
HKG,FRA,2006.0,3,2,1
CAN,IND,2005.0,30,57,-27
PRT,CAN,2005.0,5,3,2
UKR,SVK,2018.0,5,5,0
BRA,HND,2020.0,3,1,2
NLD,RWA,2014.0,3,2,1
NZL,ITA,2021.0,3,12,-9
SYR,USA,2015.0,3,6,-3
SWE,IRL,2022.0,14,15,-1
IRQ,IRN,2015.0,5,11,-6
NLD,PRT,2009.0,16,15,1
BLR,DEU,2020.0,8,4,4
VEN,GBR,2010.0,4,1,3
CHN,HUN,2018.0,6,3,3
THA,DNK,2015.0,1,4,-3
SRB,NOR,2020.0,3,4,-1
IRQ,ARE,2010.0,3,1,2
GBR,OMN,2017.0,15,13,2
KOR,NPL,2022.0,11,10,1
ALB,ITA,2013.0,2,8,-6
HUN,RUS,2022.0,3,2,1
NLD,IDN,2015.0,21,19,2
ARE,JOR,2017.0,11,17,-6
AUT,PRT,2020.0,7,10,-3
DEU,ETH,2004.0,4,3,1
EST,NLD,2019.0,3,4,-1
SWE,BEL,2013.0,17,27,-10
AZE,RUS,2014.0,13,11,2
KOR,ITA,2007.0,5,5,0
IND,NZL,2020.0,27,11,16
SVN,BEL,2018.0,10,4,6
POL,NOR,2023.0,6,4,2
USA,NIC,2015.0,4,1,3
BEL,IRL,2017.0,7,7,0
IND,IRN,2021.0,10,10,0
ARE,QAT,2007.0,3,1,2
DZA,USA,2012.0,3,3,0
CHN,NLD,2000.0,14,15,-1
AUT,GRC,2023.0,4,4,0
KOR,CHE,2018.0,14,9,5
BGR,IRL,2016.0,1,2,-1
ROU,MDA,2017.0,8,1,7
KHM,THA,2016.0,3,2,1
DNK,LTU,2018.0,4,8,-4
FRA,BEN,2014.0,15,7,8
USA,KHM,2018.0,11,4,7
MKD,HRV,2017.0,1,1,0
IND,CHL,2014.0,9,3,6
HKG,MYS,2022.0,4,7,-3
IND,BEL,2021.0,41,22,19
KOR,UGA,2020.0,3,2,1
RUS,IRQ,2017.0,6,2,4
SAU,HKG,2018.0,6,6,0
CHL,VEN,2016.0,1,15,-14
FRA,PSE,2019.0,6,4,2
USA,ROU,2016.0,19,26,-7
AUT,PAK,2019.0,5,2,3
USA,BWA,2020.0,15,13,2
DOM,MEX,2018.0,1,1,0
EGY,IRQ,2023.0,7,5,2
PSE,TUR,2016.0,3,2,1
BRA,URY,2017.0,14,8,6
PAK,IRN,2016.0,3,2,1
CAN,TUR,2020.0,15,53,-38
DNK,GRC,2009.0,3,7,-4
UGA,TZA,2010.0,1,1,0
CRI,USA,2023.0,14,4,10
LKA,CAN,2019.0,4,7,-3
CHN,THA,2013.0,8,9,-1
GHA,CHN,2018.0,16,18,-2
ITA,BGR,2019.0,8,2,6
BEL,ROU,2021.0,13,9,4
PER,GBR,2018.0,8,9,-1
NPL,AUS,2019.0,14,12,2
HKG,MAC,2014.0,12,5,7
CAN,FIN,2012.0,20,23,-3
CAN,GRC,2016.0,3,15,-12
GBR,NOR,2008.0,49,40,9
ZAF,ARE,2021.0,10,1,9
ESP,KOR,2023.0,15,8,7
ITA,HUN,2019.0,13,12,1
MAC,AUS,2020.0,2,1,1
SGP,NZL,2014.0,8,12,-4
TWN,CAN,2015.0,15,15,0
FRA,BEN,2023.0,6,5,1
HUN,CZE,2016.0,7,1,6
ARE,DEU,2020.0,8,15,-7
POL,TWN,2017.0,3,2,1
VIR,USA,2013.0,7,3,4
CHN,JPN,2024.0,12,14,-2
MWI,ZAF,2023.0,8,3,5
USA,BHR,2018.0,3,2,1
BEL,IND,2011.0,19,20,-1
NIC,ESP,2014.0,4,1,3
IND,MWI,2023.0,2,3,-1
SAU,PAK,2003.0,8,6,2
NPL,THA,2020.0,7,6,1
PRT,ARE,2013.0,2,1,1
LTU,USA,2004.0,8,10,-2
GBR,EGY,2006.0,26,9,17
ISL,NLD,2009.0,1,3,-2
VNM,JPN,2010.0,15,28,-13
PER,EGY,2020.0,1,1,0
GHA,ZAF,2022.0,12,38,-26
GBR,KEN,2022.0,35,30,5
IRQ,RUS,2017.0,2,6,-4
DEU,OMN,2021.0,3,2,1
TWN,ISR,2021.0,2,3,-1
CHN,PHL,2021.0,6,8,-2
EGY,JPN,2021.0,40,70,-30
MAR,USA,2006.0,3,7,-4
DNK,FRO,2021.0,6,4,2
DNK,TZA,2022.0,1,1,0
QAT,EGY,2017.0,5,17,-12
SWE,KOR,2009.0,4,10,-6
ITA,THA,2021.0,5,6,-1
KOR,NOR,2023.0,6,2,4
MYS,LBY,2021.0,22,2,20
QAT,AUS,2022.0,9,13,-4
TUR,SRB,2022.0,2,4,-2
USA,DOM,2021.0,12,4,8
UGA,NLD,2017.0,4,4,0
NLD,UGA,2018.0,1,4,-3
CHN,FIN,2022.0,50,57,-7
CHN,ARE,2019.0,9,5,4
VEN,JPN,2014.0,1,1,0
IRN,AZE,2022.0,4,1,3
USA,MAR,2007.0,4,2,2
FRA,SAU,2023.0,13,7,6
NLD,IRN,2014.0,11,32,-21
FRA,THA,1999.0,3,1,2
KWT,GBR,2005.0,4,7,-3
GBR,OMN,2012.0,10,6,4
DEU,MEX,1997.0,7,11,-4
NLD,ARG,2021.0,3,7,-4
EST,GBR,2013.0,10,3,7
MYS,SDN,2012.0,6,3,3
GBR,ZWE,2004.0,5,8,-3
CRI,DEU,2002.0,2,3,-1
LTU,FRA,2005.0,2,2,0
RUS,CZE,2004.0,6,7,-1
DEU,BFA,2007.0,3,1,2
JPN,TZA,2004.0,5,2,3
ISL,SWE,2011.0,10,9,1
BEL,CZE,2010.0,5,5,0
NGA,SWZ,2018.0,4,1,3
USA,PRY,2016.0,1,3,-2
DEU,IRN,2007.0,13,22,-9
NLD,TUR,2013.0,13,34,-21
SVN,TUR,2014.0,3,1,2
ZAF,PRT,2022.0,6,3,3
RUS,AUT,2013.0,14,8,6
DNK,IRN,2009.0,6,4,2
CAN,TUN,2004.0,10,1,9
SWE,GRC,2013.0,6,23,-17
POL,PRT,2009.0,8,8,0
ITA,GRC,2015.0,30,45,-15
MWI,ZWE,2011.0,1,1,0
CAN,BRA,2009.0,48,64,-16
MEX,TUR,2005.0,4,2,2
TUR,FRA,2005.0,8,5,3
JPN,GRC,2018.0,2,2,0
SAU,MYS,2013.0,14,48,-34
USA,LKA,2005.0,10,10,0
PRT,MYS,2014.0,2,2,0
RUS,CUB,2016.0,1,1,0
DEU,SGP,2015.0,38,36,2
AUT,POL,2003.0,7,5,2
AUS,CZE,2018.0,8,5,3
ITA,KOR,2021.0,8,15,-7
RUS,BEL,2013.0,3,6,-3
MOZ,FRA,2008.0,3,2,1
AUS,JOR,2009.0,9,3,6
SYC,ZAF,2017.0,3,1,2
ZAF,SYC,2018.0,1,2,-1
BWA,AUS,2016.0,3,7,-4
PAK,CAN,2014.0,23,18,5
LTU,USA,2001.0,13,9,4
USA,GUF,2014.0,1,2,-1
USA,PSE,2007.0,4,1,3
CAN,ESP,2016.0,42,76,-34
SWE,LKA,2014.0,2,1,1
HKG,AUS,2006.0,36,29,7
NER,NGA,2010.0,20,19,1
AUS,IRN,2010.0,32,62,-30
ESP,PSE,2014.0,4,1,3
IND,DNK,2010.0,11,6,5
ZWE,ZAF,2008.0,29,2,27
CYP,TUR,2010.0,26,19,7
CAN,KOR,1998.0,17,10,7
FRA,SYR,2009.0,6,1,5
GBR,ISL,2015.0,11,2,9
LBY,IND,2018.0,4,1,3
SRB,IRL,2014.0,3,1,2
SGP,DEU,2010.0,22,35,-13
GUF,DEU,2005.0,2,1,1
THA,SWE,2009.0,5,7,-2
JOR,GBR,2010.0,10,25,-15
MTQ,FRA,2003.0,9,12,-3
TKM,RUS,2010.0,3,1,2
DEU,ROU,1998.0,13,20,-7
THA,FIN,2013.0,5,2,3
POL,FIN,2022.0,6,4,2
CIV,FRA,2014.0,32,20,12
ARE,JOR,2012.0,1,16,-15
FRA,VNM,2004.0,7,2,5
IND,NPL,2010.0,24,32,-8
PRT,CHL,2015.0,4,3,1
FIN,AUT,2018.0,12,13,-1
JPN,CZE,2010.0,7,7,0
SLV,SVN,1999.0,3,2,1
CHE,MDG,2011.0,1,1,0
MDG,FRA,2006.0,9,9,0
GUY,FRA,2008.0,2,1,1
IND,NGA,2009.0,5,4,1
VEN,BRA,2015.0,8,2,6
RUS,MDA,2003.0,3,3,0
CZE,GBR,2010.0,37,68,-31
NLD,IRL,2011.0,14,15,-1
ITA,IRN,2010.0,9,12,-3
SAU,GRC,2017.0,2,8,-6
MYS,ESP,2012.0,2,1,1
HRV,USA,2008.0,12,16,-4
AUT,BIH,2008.0,3,1,2
CHE,HUN,2012.0,6,20,-14
VNM,GBR,2015.0,25,26,-1
DNK,ISL,2012.0,3,4,-1
BRA,LKA,2014.0,1,1,0
DZA,ITA,2012.0,2,5,-3
ITA,HUN,2011.0,12,8,4
HUN,ITA,2014.0,7,5,2
SGP,KHM,2022.0,1,4,-3
ARE,PAK,2019.0,15,21,-6
THA,KHM,2008.0,2,2,0
AUT,SVN,2020.0,6,7,-1
BEL,SWE,2007.0,6,9,-3
TUR,ALB,2013.0,3,1,2
KOR,NZL,2011.0,5,4,1
SGP,PHL,2009.0,6,2,4
BRA,PER,2005.0,5,1,4
TZA,CHE,2012.0,4,1,3
TZA,AUS,2022.0,3,2,1
USA,MWI,2012.0,19,16,3
CAN,OMN,2005.0,7,2,5
TUR,ISR,2012.0,2,7,-5
BRA,CHE,2001.0,5,4,1
BRA,SGP,2013.0,3,1,2
COL,ISR,2019.0,1,1,0
AUT,TWN,2020.0,2,3,-1
EST,ITA,2018.0,5,6,-1
TWN,CHE,2014.0,7,3,4
KOR,USA,2024.0,7,8,-1
GHA,GBR,2019.0,21,31,-10
IRL,DNK,2018.0,7,4,3
IND,ESP,2008.0,16,8,8
IDN,THA,2020.0,18,34,-16
IND,IDN,2015.0,20,14,6
TUR,CHE,2019.0,29,16,13
PAK,KEN,2017.0,3,2,1
MMR,GBR,2020.0,3,2,1
MEX,SWE,2010.0,3,1,2
FRA,CMR,2013.0,25,10,15
SVK,CHE,2017.0,8,5,3
BEL,MEX,2001.0,8,4,4
JPN,EGY,2023.0,30,26,4
USA,RWA,2017.0,23,18,5
ISR,BEL,2013.0,1,5,-4
IRL,PRT,2022.0,8,6,2
FRA,UKR,2020.0,4,9,-5
IRL,BGD,2023.0,1,4,-3
CYP,AUS,2017.0,3,4,-1
CHN,SDN,2016.0,10,4,6
LBN,CAN,2017.0,17,5,12
CHN,CZE,2023.0,9,14,-5
ARG,GBR,2019.0,21,12,9
UZB,JPN,2001.0,1,1,0
ITA,LTU,2017.0,1,4,-3
AFG,USA,2017.0,9,11,-2
KOR,IRN,2020.0,12,29,-17
SVN,IND,2009.0,3,1,2
DZA,QAT,2022.0,2,4,-2
NOR,PAK,2023.0,4,8,-4
RUS,SRB,2009.0,2,2,0
MEX,CRI,2013.0,2,4,-2
CRI,DNK,2017.0,1,2,-1
GBR,LBN,2021.0,10,26,-16
IRQ,ITA,2018.0,1,4,-3
MMR,MYS,2017.0,1,5,-4
HND,MEX,2019.0,1,1,0
BRA,NLD,2002.0,22,11,11
LTU,SWE,2018.0,5,3,2
TUR,ARE,2017.0,11,2,9
CHL,DEU,2003.0,16,15,1
SWE,TZA,2007.0,4,2,2
ARM,GRC,2018.0,1,2,-1
ECU,IND,2019.0,1,2,-1
AGO,PRT,2020.0,5,1,4
CHE,IND,2008.0,12,31,-19
ITA,EST,2013.0,4,1,3
CZE,GBR,2023.0,22,24,-2
SRB,BIH,2017.0,18,10,8
PSE,JOR,2021.0,3,10,-7
JPN,EST,2022.0,4,1,3
TWN,ITA,2021.0,5,4,1
CZE,SWE,2016.0,12,9,3
NZL,MAR,2022.0,1,1,0
IND,AFG,2021.0,3,4,-1
SAU,SDN,2021.0,22,43,-21
NLD,MWI,2019.0,3,1,2
SVN,NLD,2018.0,8,2,6
USA,TUN,2018.0,9,6,3
NZL,NLD,2017.0,13,28,-15
ROU,CAN,2020.0,9,1,8
RUS,ISR,2020.0,29,8,21
SGP,MYS,2020.0,24,30,-6
PAK,CHE,1998.0,1,1,0
NLD,NOR,2001.0,10,12,-2
FIN,CZE,2006.0,1,1,0
ISL,GBR,2007.0,4,7,-3
SVN,SLV,2005.0,2,1,1
CHE,DNK,2006.0,14,17,-3
KWT,IND,2019.0,6,7,-1
BEN,BEL,2004.0,2,3,-1
BEL,BEN,2005.0,4,1,3
ITA,CZE,2007.0,9,8,1
HRV,NLD,2019.0,6,2,4
GBR,ETH,2002.0,3,5,-2
CAN,SVK,2011.0,5,1,4
DEU,SGP,2001.0,4,10,-6
ITA,ZAF,2019.0,5,13,-8
GBR,OMN,2005.0,11,7,4
UKR,SWE,2021.0,9,6,3
IDN,FRA,2003.0,5,9,-4
CYP,GBR,2001.0,5,7,-2
CYP,GBR,2004.0,2,13,-11
JPN,ITA,2008.0,14,22,-8
USA,ZMB,2000.0,2,3,-1
CHE,IRN,2000.0,3,1,2
KAZ,RUS,2006.0,8,7,1
JOR,FRA,1999.0,3,1,2
FRA,JOR,2005.0,1,1,0
LVA,USA,2002.0,4,1,3
RUS,ESP,2006.0,12,8,4
CUB,MEX,2008.0,10,5,5
THA,AUS,2009.0,16,43,-27
ISR,ITA,2008.0,11,9,2
LUX,FIN,2012.0,2,2,0
HRV,BIH,2022.0,8,6,2
ITA,HRV,2002.0,5,3,2
ISR,IRL,2015.0,2,7,-5
ZWE,FRA,2009.0,1,1,0
JPN,GRC,2016.0,2,4,-2
LBN,SAU,2011.0,3,1,2
IRN,KOR,2010.0,5,1,4
GMB,USA,2005.0,3,1,2
ZAF,DEU,2001.0,15,25,-10
AUT,BGR,2006.0,2,3,-1
SWE,TZA,1998.0,3,1,2
COG,COD,2006.0,6,10,-4
SWE,ISL,2016.0,20,15,5
NOR,BRA,2006.0,1,2,-1
SVN,ITA,2009.0,5,6,-1
ITA,SVN,2010.0,5,5,0
QAT,BEL,2016.0,2,5,-3
CAN,TUN,2001.0,5,3,2
LTU,FRA,2002.0,2,1,1
THA,AUT,1998.0,1,1,0
AUT,SVK,2011.0,11,7,4
NLD,SYR,2006.0,2,2,0
SRB,NLD,2011.0,4,2,2
NLD,IRN,2001.0,1,5,-4
USA,TTO,2015.0,11,14,-3
DZA,DEU,2010.0,3,2,1
USA,SVN,2009.0,16,16,0
DNK,POL,2005.0,6,3,3
FRA,NCL,2005.0,27,13,14
FRA,NER,2013.0,10,1,9
ITA,ISR,2017.0,20,20,0
USA,GTM,2007.0,7,7,0
ISL,ITA,2011.0,2,1,1
DZA,FRA,2001.0,27,51,-24
FRA,REU,2001.0,3,7,-4
IND,EGY,2009.0,3,2,1
BLR,GBR,2002.0,8,2,6
MEX,IND,2020.0,9,9,0
NZL,DNK,2007.0,7,5,2
MEX,BEL,2006.0,2,5,-3
CHL,NLD,2011.0,5,6,-1
USA,AZE,2016.0,7,4,3
UKR,ESP,2005.0,9,3,6
COL,BRA,1999.0,2,5,-3
UKR,MDA,2000.0,1,4,-3
CAN,MDA,2010.0,1,1,0
ARG,BEL,2001.0,4,2,2
ALB,SRB,2013.0,8,1,7
UKR,BEL,2010.0,3,2,1
TWN,AUS,2011.0,13,18,-5
ARG,ISR,2001.0,1,2,-1
ARG,ISR,2015.0,2,1,1
UZB,RUS,2000.0,23,7,16
CRI,USA,2008.0,14,11,3
ARE,SWE,2006.0,3,2,1
ETH,SWE,2002.0,4,3,1
IND,PHL,2004.0,1,3,-2
PHL,IND,2007.0,5,7,-2
PHL,CHE,2008.0,1,1,0
JPN,HUN,1997.0,5,6,-1
KOR,DNK,2003.0,3,1,2
SVK,BEL,2001.0,4,3,1
URY,USA,2002.0,9,5,4
CHL,SWE,1998.0,2,2,0
GBR,ISL,2008.0,9,7,2
EGY,IND,2012.0,5,4,1
RUS,NLD,2013.0,15,13,2
FRA,SAU,2006.0,5,2,3
SAU,TUR,2012.0,5,3,2
SGP,GBR,1998.0,15,29,-14
NIC,USA,2005.0,2,1,1
POL,BLR,2004.0,4,2,2
USA,EST,2006.0,6,2,4
SVN,SRB,2008.0,4,3,1
SLV,SVK,2005.0,2,2,0
IND,NLD,2002.0,15,9,6
ARG,CHE,2018.0,18,11,7
GRC,QAT,2015.0,2,2,0
ISR,TUR,2004.0,5,5,0
GUM,USA,2004.0,7,6,1
USA,GUM,2005.0,4,4,0
GBR,UZB,2002.0,2,5,-3
UZB,USA,2014.0,1,2,-1
SWE,MEX,2007.0,2,3,-1
ZAF,NLD,2004.0,15,13,2
SGP,CHE,2006.0,5,10,-5
ROU,CZE,2006.0,1,2,-1
KWT,USA,2008.0,10,13,-3
TUR,ISR,2005.0,4,5,-1
FRA,PHL,2008.0,2,1,1
SRB,ROU,2009.0,2,1,1
MAR,USA,2000.0,7,5,2
BGD,USA,2003.0,19,9,10
CHL,CHE,2011.0,10,11,-1
GBR,JOR,2003.0,7,5,2
GBR,ZMB,2013.0,12,3,9
FRA,PYF,2000.0,2,9,-7
NOR,RUS,2016.0,10,11,-1
BOL,ESP,2018.0,2,5,-3
NOR,POL,1997.0,2,1,1
MEX,PRT,2009.0,7,3,4
ITA,ARG,2000.0,16,11,5
CAN,HKG,1999.0,19,23,-4
TZA,SWE,2006.0,1,3,-2
HKG,CHE,2011.0,10,2,8
BRA,NLD,1997.0,7,3,4
LTU,RUS,1998.0,1,5,-4
DEU,KAZ,2001.0,2,3,-1
UKR,SWE,2011.0,10,1,9
ITA,GRC,2001.0,19,16,3
CAN,AUT,2005.0,15,15,0
IRL,ZAF,2016.0,4,5,-1
UZB,RUS,2006.0,7,10,-3
RUS,UZB,2009.0,10,9,1
FRA,CAF,2004.0,4,1,3
CZE,SWE,2017.0,20,8,12
DEU,BLR,2011.0,4,4,0
MDG,FRA,2010.0,10,15,-5
AUT,SVN,1998.0,3,2,1
SAU,ZAF,2003.0,1,3,-2
MAR,ESP,2001.0,2,8,-6
MOZ,ESP,2010.0,3,2,1
AUS,TZA,2020.0,2,1,1
ZMB,USA,2021.0,14,18,-4
IND,TUR,2011.0,3,5,-2
NLD,PAK,2014.0,20,7,13
MYS,YEM,2012.0,16,5,11
CUB,ECU,2015.0,32,1,31
SGP,SAU,2016.0,8,3,5
YEM,MYS,2009.0,5,3,2
SGP,NOR,2015.0,4,3,1
DEU,LKA,2012.0,4,3,1
DEU,UZB,2012.0,2,4,-2
PAN,USA,2020.0,27,30,-3
KNA,USA,2009.0,2,2,0
DNK,IDN,2009.0,2,1,1
KOR,RUS,2020.0,8,14,-6
JPN,MYS,2004.0,17,9,8
PRT,PAK,2017.0,1,2,-1
PAK,HKG,2023.0,12,3,9
BEL,SVK,2015.0,4,5,-1
AUT,UKR,2010.0,2,3,-1
USA,JOR,2013.0,60,34,26
DNK,IRN,2011.0,6,9,-3
FRA,SVN,2013.0,6,5,1
JOR,GBR,2006.0,5,19,-14
CHN,IRQ,2010.0,5,2,3
BLR,USA,2009.0,8,3,5
BEL,DZA,2014.0,8,3,5
CRI,BRA,2012.0,6,4,2
PRT,NLD,2014.0,24,21,3
KEN,ZAF,2012.0,9,13,-4
TWN,IDN,2010.0,4,2,2
BWA,NGA,2010.0,4,2,2
IDN,TWN,2013.0,3,10,-7
CAN,LKA,2014.0,5,3,2
FRA,PAK,2011.0,15,12,3
ARG,BRA,2010.0,29,28,1
BRA,VEN,2006.0,11,5,6
USA,HRV,2013.0,18,20,-2
KWT,PRT,2019.0,1,1,0
LVA,AUT,2010.0,1,2,-1
HRV,SVN,2014.0,12,9,3
DEU,JOR,2013.0,9,8,1
AUS,GRC,2009.0,3,4,-1
ITA,DEU,2024.0,8,1,7
ZMB,NGA,2012.0,1,1,0
ZAF,CHE,2008.0,7,4,3
MEX,CHL,2006.0,6,4,2
BRA,JPN,2013.0,5,18,-13
KOR,CHE,2012.0,8,11,-3
ITA,ALB,2020.0,6,7,-1
CHE,POL,2022.0,12,23,-11
TUR,BEL,2012.0,3,8,-5
GBR,LVA,1998.0,3,1,2
POL,NOR,2014.0,12,4,8
BRA,MEX,2015.0,22,24,-2
ESP,IRL,2011.0,18,18,0
URY,FRA,2014.0,2,4,-2
PHL,AUS,2017.0,20,11,9
AUS,KEN,2021.0,4,3,1
NGA,ETH,2020.0,3,4,-1
HUN,CZE,2017.0,8,3,5
USA,ZWE,2002.0,7,11,-4
ASM,USA,2016.0,3,2,1
KGZ,RUS,2010.0,5,2,3
JOR,SAU,2007.0,6,2,4
CHN,GRC,2014.0,3,7,-4
IRN,DNK,2009.0,4,6,-2
CHE,KOR,2007.0,4,6,-2
ITA,IRN,2023.0,24,65,-41
BGD,KHM,2011.0,1,1,0
GRC,DNK,2009.0,7,3,4
AUT,MYS,2018.0,1,2,-1
LBN,ARE,2011.0,4,4,0
IND,CZE,2016.0,15,15,0
USA,ISL,2003.0,17,18,-1
IRN,CZE,2015.0,6,1,5
TUN,QAT,2014.0,10,1,9
CZE,SWE,2018.0,10,18,-8
SWE,CYP,2016.0,2,1,1
BEL,ETH,2013.0,3,5,-2
TUN,DEU,2020.0,15,1,14
EGY,ARE,2015.0,18,9,9
CHE,ZAF,2013.0,11,10,1
CHE,TUR,2007.0,6,5,1
USA,ASM,2018.0,3,2,1
BGR,HUN,1999.0,2,1,1
SRB,MKD,2009.0,25,47,-22
SAU,KAZ,2019.0,4,4,0
ZAF,DNK,2010.0,2,1,1
BIH,HRV,2016.0,10,11,-1
NLD,EGY,2016.0,5,2,3
SVK,CHE,2016.0,7,3,4
CHE,ROU,2020.0,13,15,-2
ISR,JPN,2008.0,2,5,-3
ZAF,MAR,2020.0,5,3,2
CAN,DZA,2013.0,5,5,0
SYR,FRA,2020.0,2,4,-2
CZE,HUN,2013.0,5,4,1
TUR,CZE,2019.0,7,6,1
JOR,TUR,2010.0,1,1,0
ESP,CRI,2020.0,9,12,-3
FRA,JPN,2012.0,64,75,-11
FRA,GAB,2021.0,6,6,0
CAN,OMN,2012.0,7,6,1
PHL,TWN,2013.0,2,2,0
IRN,BEL,2015.0,17,16,1
BGD,AUS,2009.0,18,2,16
LUX,GBR,2016.0,11,13,-2
EGY,ESP,2009.0,4,9,-5
BRB,USA,2016.0,7,4,3
ZAF,TWN,2016.0,2,5,-3
NPL,JPN,2007.0,6,7,-1
BEL,ROU,2009.0,5,3,2
FRA,HRV,2015.0,6,6,0
COL,ARG,2014.0,15,14,1
CHL,BRA,2016.0,18,20,-2
IND,FIN,2010.0,7,2,5
BEL,PRT,2001.0,5,4,1
DNK,CAN,2014.0,19,28,-9
IND,IRN,2013.0,24,12,12
SVN,BEL,2012.0,2,1,1
IRL,JPN,2018.0,7,6,1
KEN,MWI,2023.0,3,4,-1
CHL,CZE,2023.0,2,2,0
NLD,SUR,2019.0,10,1,9
GBR,MLT,2015.0,16,8,8
COL,CHE,2021.0,9,2,7
YEM,EGY,2013.0,3,5,-2
NLD,PHL,2018.0,7,2,5
ZAF,MOZ,2010.0,4,2,2
TWN,MYS,2013.0,7,2,5
BEL,CIV,2010.0,1,2,-1
TUN,BHR,2022.0,4,2,2
MEX,ECU,2013.0,4,6,-2
FRA,MKD,2006.0,4,1,3
HUN,BEL,2017.0,10,10,0
SGP,HKG,2005.0,10,17,-7
IRN,CHE,2014.0,24,12,12
ARE,AUS,2007.0,4,7,-3
ISR,BEL,2003.0,5,4,1
IRN,DNK,2011.0,9,6,3
THA,PRT,2018.0,1,1,0
GRC,AUT,2013.0,9,3,6
SVN,SWE,2021.0,5,6,-1
MAC,CHN,2001.0,1,2,-1
PRT,AUT,2016.0,9,2,7
EGY,IRL,2014.0,2,2,0
SLE,GBR,2022.0,6,5,1
IDN,JPN,2013.0,32,122,-90
HKG,THA,2017.0,4,2,2
CUB,MEX,2014.0,20,9,11
USA,SVN,2019.0,13,8,5
GBR,LTU,2013.0,9,4,5
HUN,SVK,2013.0,6,8,-2
SWE,JPN,2015.0,18,25,-7
CZE,COL,2023.0,3,1,2
MYS,LBY,2011.0,5,2,3
MEX,GTM,2013.0,5,4,1
FIN,LVA,2018.0,2,2,0
CHE,HUN,2005.0,6,11,-5
JAM,CAN,2018.0,4,4,0
FIN,EST,2018.0,7,8,-1
NOR,CHN,2019.0,31,37,-6
MAC,CAN,2015.0,2,1,1
IND,PHL,2015.0,11,4,7
ARM,USA,2013.0,8,4,4
FIN,AUS,2021.0,13,26,-13
COL,ESP,2008.0,25,38,-13
CAN,LUX,2017.0,2,4,-2
OMN,USA,2002.0,9,5,4
PRI,COL,2021.0,6,1,5
IRL,NLD,2011.0,15,14,1
POL,IRN,2022.0,5,45,-40
THA,NLD,2017.0,11,10,1
AUT,ISR,2022.0,4,6,-2
NLD,UKR,2009.0,1,2,-1
SRB,MKD,2021.0,7,10,-3
PHL,NPL,2016.0,2,1,1
POL,FIN,2017.0,8,5,3
ZAF,KOR,2023.0,4,1,3
QAT,EGY,2022.0,10,6,4
CHL,IRL,2022.0,4,3,1
LKA,SWE,2016.0,3,4,-1
PAK,OMN,2020.0,8,4,4
CHN,LKA,2013.0,2,1,1
CZE,FRA,2013.0,12,30,-18
SRB,HRV,2013.0,12,17,-5
SRB,ALB,2022.0,18,12,6
MAR,MCO,2016.0,1,1,0
ITA,NGA,2020.0,4,8,-4
SRB,VNM,2019.0,3,1,2
JPN,IND,2009.0,71,85,-14
MYS,NZL,2010.0,10,15,-5
ITA,CHN,2017.0,50,59,-9
NOR,IND,2005.0,2,2,0
SWE,LTU,2016.0,4,8,-4
TTO,USA,2020.0,10,12,-2
IND,EGY,2019.0,5,3,2
PLW,USA,2016.0,1,2,-1
SVK,SVN,2018.0,19,24,-5
EST,FIN,2021.0,15,14,1
USA,NAM,2017.0,7,7,0
NAM,USA,2018.0,6,8,-2
ETH,ARE,2020.0,3,1,2
JPN,DNK,2018.0,12,12,0
AUS,LBN,2013.0,3,1,2
ARG,CUB,2020.0,5,6,-1
ETH,USA,2015.0,27,21,6
RUS,MDA,2013.0,6,1,5
ISR,CHN,2009.0,13,10,3
RUS,BRA,2016.0,5,15,-10
NOR,IRL,2015.0,2,4,-2
CAN,SEN,2022.0,3,1,2
MWI,TZA,2020.0,1,1,0
GRD,CAN,2020.0,3,1,2
HKG,ESP,2015.0,1,3,-2
MAC,KOR,2021.0,1,1,0
BRA,ZAF,2015.0,8,2,6
ITA,EGY,2017.0,11,8,3
ZWE,GBR,2015.0,4,3,1
CAN,MYS,2022.0,12,25,-13
SAU,ESP,2020.0,6,11,-5
SAU,BRA,2018.0,3,1,2
LBN,KWT,2023.0,2,1,1
DNK,CZE,2011.0,6,2,4
MLI,CHE,2015.0,3,1,2
AUT,POL,2013.0,6,8,-2
AND,ESP,2014.0,2,2,0
JPN,HKG,2011.0,6,11,-5
NCL,AUS,2017.0,5,3,2
NCL,AUS,2022.0,1,4,-3
NZL,IDN,2022.0,3,6,-3
CHN,RWA,2018.0,3,4,-1
SGP,FRA,2021.0,30,28,2
NZL,FJI,2018.0,5,2,3
OMN,AUS,2018.0,2,8,-6
CHN,QAT,2017.0,4,1,3
NZL,ESP,2014.0,5,11,-6
CAN,ETH,2022.0,5,10,-5
CHL,AUT,2023.0,2,2,0
CHN,TZA,2016.0,2,3,-1
MLI,BFA,2011.0,3,1,2
ITA,EGY,2018.0,18,12,6
CHN,LBN,2021.0,2,2,0
ITA,SAU,2019.0,15,12,3
IRN,ARE,2016.0,1,2,-1
PRT,IRL,2014.0,4,4,0
PRT,CAN,2017.0,11,6,5
EGY,IRQ,2015.0,3,2,1
CZE,BEL,2018.0,11,10,1
GHA,CHN,2016.0,9,10,-1
NOR,SGP,2018.0,4,3,1
SAU,BHR,2020.0,10,7,3
LKA,CHN,2016.0,3,5,-2
CHL,ARG,1998.0,1,3,-2
SWE,BRA,2005.0,9,5,4
MEX,CHL,2010.0,15,16,-1
ITA,ARG,2010.0,11,15,-4
PER,ESP,2001.0,4,1,3
LUX,ESP,2020.0,4,10,-6
QAT,EGY,2016.0,9,12,-3
SEN,MLI,2012.0,4,1,3
JPN,MYS,2001.0,6,8,-2
ITA,CUB,2016.0,3,4,-1
ECU,USA,2008.0,8,13,-5
CHN,MMR,2021.0,9,9,0
VEN,MEX,2018.0,13,4,9
JOR,JPN,2019.0,3,1,2
NLD,NGA,2021.0,4,6,-2
MYS,GHA,2023.0,4,2,2
EST,FIN,2019.0,19,14,5
LTU,CAN,2022.0,2,2,0
URY,PRT,2016.0,1,2,-1
IRL,ESP,2019.0,28,43,-15
SLE,GBR,2016.0,2,5,-3
HRV,AUT,2018.0,9,5,4
NLD,CHL,2021.0,11,20,-9
JPN,KEN,2019.0,10,6,4
BGR,POL,2020.0,2,4,-2
BLR,USA,2021.0,4,2,2
TZA,NOR,2018.0,2,9,-7
UGA,GHA,2019.0,3,2,1
NZL,NLD,2022.0,9,13,-4
THA,MMR,2020.0,13,4,9
AUT,HRV,2020.0,4,8,-4
BEL,JPN,2019.0,18,15,3
IDN,NLD,1999.0,3,3,0
SVN,SVK,1999.0,2,5,-3
EGY,GBR,2013.0,22,65,-43
PSE,GBR,2018.0,3,7,-4
ESP,GRC,2012.0,9,21,-12
NLD,LUX,2019.0,10,9,1
BRA,NGA,2021.0,3,2,1
NLD,JPN,2000.0,25,33,-8
GRC,SRB,2004.0,1,6,-5
IRN,IRL,2016.0,11,8,3
PRT,NLD,2008.0,19,15,4
MDG,BEL,2014.0,1,2,-1
LUX,NLD,2012.0,4,8,-4
ARE,EGY,2013.0,15,12,3
AUT,LIE,2005.0,1,1,0
MLT,GBR,2023.0,5,13,-8
MAC,HKG,2009.0,2,9,-7
CAN,NGA,2023.0,6,19,-13
IRN,NOR,2023.0,10,8,2
BLR,BEL,2003.0,10,5,5
SRB,CHE,2022.0,3,4,-1
OMN,IRN,2023.0,3,8,-5
GHA,CHN,2022.0,23,71,-48
CHN,IRQ,2023.0,7,3,4
IRN,HUN,2020.0,5,2,3
AUS,SVN,2022.0,3,1,2
BRA,FIN,2023.0,11,3,8
SDN,SAU,2022.0,23,16,7
ROU,MYS,2022.0,1,1,0
THA,AUT,2020.0,4,5,-1
BOL,ESP,2022.0,3,5,-2
BRN,PAK,2023.0,2,1,1
LTU,CHN,2021.0,3,5,-2
TWN,DNK,2022.0,3,2,1
SYC,GBR,2023.0,2,1,1
IND,TUR,2021.0,6,10,-4
BEL,CMR,2022.0,7,4,3
ARE,PAK,2021.0,10,29,-19
IND,TZA,2022.0,2,1,1
IRN,ITA,2005.0,2,4,-2
IDN,VNM,2022.0,3,6,-3
MWI,UGA,2021.0,2,3,-1
HKG,BGD,2023.0,3,7,-4
BFA,BEL,2023.0,3,4,-1
LBY,MYS,2021.0,2,22,-20
PAK,MEX,2023.0,4,2,2
GRC,NLD,2022.0,20,15,5
ARE,KWT,2018.0,4,5,-1
RUS,AUT,2003.0,10,7,3
NLD,CRI,2005.0,1,1,0
TGO,FRA,2023.0,2,3,-1
AUS,QAT,2019.0,9,11,-2
SAU,IRL,2020.0,4,19,-15
FRA,VEN,2008.0,5,6,-1
BGR,NLD,2022.0,5,1,4
ESP,DZA,2023.0,4,1,3
JPN,CHL,2016.0,8,5,3
ZAF,UGA,2021.0,8,13,-5
PER,ESP,2015.0,11,22,-11
MYS,THA,2013.0,5,7,-2
THA,MYS,2018.0,5,22,-17
CHN,CAN,2024.0,11,9,2
AFG,GBR,2015.0,2,4,-2
KOR,DNK,2013.0,6,1,5
CHN,RWA,2017.0,4,2,2
UZB,DEU,2018.0,5,1,4
CRI,MEX,2015.0,5,2,3
HKG,BEL,2017.0,1,1,0
SVK,NLD,2020.0,1,1,0
CZE,SVN,2017.0,2,6,-4
ISR,ESP,2001.0,5,4,1
JPN,TWN,2007.0,48,28,20
BGR,FRA,2019.0,6,4,2
HRV,SRB,2017.0,16,17,-1
USA,GUY,2000.0,2,3,-1
REU,FRA,2023.0,12,10,2
FRA,HKG,2020.0,13,1,12
PRY,BRA,2022.0,5,8,-3
CYP,ITA,2017.0,4,1,3
ISR,SWE,2017.0,5,5,0
GBR,BRN,2016.0,9,3,6
IND,NGA,2019.0,11,19,-8
ITA,NZL,2018.0,5,5,0
GHA,MYS,2023.0,2,4,-2
NOR,FIN,2015.0,8,21,-13
ARM,RUS,2017.0,7,7,0
ESP,KEN,2020.0,4,5,-1
CMR,BEL,2021.0,3,4,-1
NZL,IDN,2017.0,7,8,-1
MAC,MAR,2014.0,15,17,-2
PAK,JPN,2013.0,5,18,-13
SWE,SVK,2017.0,4,3,1
PRK,KOR,2016.0,4,1,3
EGY,CHN,2015.0,11,12,-1
CHN,NOR,2023.0,17,27,-10
NZL,IND,2017.0,7,19,-12
VEN,GBR,2015.0,9,1,8
THA,TWN,2007.0,2,4,-2
ISR,AUT,2020.0,8,2,6
SVK,DEU,2012.0,16,12,4
SWE,PAK,2015.0,18,7,11
IND,THA,2021.0,23,20,3
BRA,NOR,2018.0,14,8,6
MYS,USA,2009.0,16,31,-15
USA,DZA,2016.0,17,5,12
ETH,BEL,2017.0,2,8,-6
FRA,KHM,2015.0,6,2,4
UGA,TZA,2014.0,7,1,6
USA,LUX,2023.0,5,5,0
SEN,CMR,2021.0,4,1,3
CHE,CIV,2017.0,3,1,2
CHE,COL,2015.0,3,7,-4
CHE,ZWE,2019.0,1,3,-2
CHN,IRN,2024.0,1,2,-1
MWI,TWN,2017.0,1,1,0
AUT,IND,2020.0,12,15,-3
CAN,HUN,2017.0,9,13,-4
ESP,JPN,2018.0,19,16,3
CHN,COD,2022.0,2,1,1
CHL,CUB,2019.0,2,13,-11
SRB,ITA,2022.0,5,6,-1
SVK,CAN,2018.0,2,2,0
IRN,TWN,2020.0,9,1,8
JPN,GHA,2021.0,2,6,-4
USA,PSE,2020.0,5,4,1
ZAF,ZMB,2021.0,12,10,2
NGA,ESP,2020.0,2,1,1
ITA,SRB,2016.0,10,6,4
FIN,ITA,2004.0,10,6,4
SRB,MKD,2019.0,12,18,-6
FIN,JPN,2020.0,11,19,-8
NOR,ZAF,2010.0,2,6,-4
CHN,IDN,2016.0,3,3,0
GNB,DNK,2021.0,1,2,-1
ITA,SVN,2023.0,10,4,6
TZA,NLD,2020.0,3,2,1
NLD,HUN,2021.0,7,14,-7
NGA,GHA,2012.0,6,2,4
ATG,USA,2019.0,2,1,1
IDN,SWE,2022.0,4,2,2
ESP,PAK,2015.0,3,1,2
COL,POL,2023.0,3,2,1
ESP,CZE,2019.0,28,14,14
FRA,CRI,2020.0,7,6,1
DEU,MCO,2022.0,1,2,-1
NLD,NZL,2023.0,5,9,-4
KOR,NGA,2023.0,4,3,1
SAU,IDN,2021.0,6,2,4
CHN,HRV,2020.0,1,1,0
MEX,EGY,2017.0,1,2,-1
ZWE,IND,2021.0,1,1,0
NLD,MEX,2017.0,13,19,-6
PRT,CAN,2018.0,9,4,5
FRA,GHA,2017.0,3,2,1
MAR,IRQ,2020.0,1,1,0
TUR,ROU,2019.0,4,2,2
IND,ESP,2001.0,9,6,3
SAU,BGD,2012.0,2,8,-6
HRV,DEU,2023.0,9,5,4
BRN,IDN,2018.0,3,1,2
AUT,NZL,2010.0,4,3,1
USA,GTM,2020.0,14,10,4
BRA,CUB,2020.0,6,12,-6
ESP,KOR,2006.0,2,1,1
BGD,GBR,2020.0,23,28,-5
CHE,UGA,2021.0,4,3,1
SGP,THA,2023.0,4,8,-4
KHM,BEL,2011.0,2,1,1
VNM,TUR,2023.0,3,1,2
VNM,DEU,2023.0,6,12,-6
MEX,ISR,2009.0,3,1,2
CHN,SDN,2022.0,15,7,8
BRA,IRL,2021.0,28,12,16
KOR,CHL,2022.0,1,3,-2
LTU,SWE,2022.0,3,3,0
CHN,IRL,2014.0,18,16,2
TWN,CZE,2018.0,4,1,3
CUB,ITA,2021.0,2,1,1
NGA,TUR,2019.0,4,3,1
CZE,SGP,2020.0,3,3,0
CMR,ZAF,2005.0,2,3,-1
NPL,KOR,2015.0,5,8,-3
CHE,EST,2015.0,4,5,-1
JPN,AUT,2002.0,9,8,1
NLD,ETH,1997.0,1,1,0
GEO,FRA,2013.0,11,1,10
ETH,MWI,2017.0,1,2,-1
GEO,DEU,2015.0,5,4,1
ITA,ETH,2017.0,3,5,-2
BEN,NGA,2002.0,2,6,-4
CAN,TZA,2000.0,4,1,3
BEL,DZA,2015.0,5,1,4
HUN,AUS,2009.0,4,3,1
QAT,LBY,2020.0,1,2,-1
BEL,DZA,2008.0,2,2,0
SWE,TWN,2007.0,3,1,2
TWN,SWE,2008.0,2,2,0
DZA,TUN,2013.0,3,1,2
CMR,ZAF,2002.0,4,1,3
DEU,LTU,2005.0,9,5,4
SAU,IND,2003.0,3,6,-3
ESP,NZL,2004.0,3,1,2
SVK,USA,1997.0,15,18,-3
BRA,IND,2009.0,6,3,3
HRV,POL,2023.0,2,3,-1
JPN,KEN,2011.0,9,4,5
BRA,MOZ,2023.0,7,8,-1
KHM,SWE,2010.0,1,1,0
CUB,FRA,2005.0,2,1,1
CHE,THA,2008.0,4,4,0
GEO,RUS,2003.0,7,6,1
KOR,PHL,2007.0,2,3,-1
PRT,RUS,2004.0,10,7,3
GBR,TZA,2004.0,5,6,-1
CHE,ZAF,2003.0,6,6,0
BEL,DZA,2001.0,2,2,0
MWI,DEU,2003.0,2,1,1
TCD,FRA,2002.0,1,1,0
BRA,UKR,2007.0,4,1,3
CIV,CAN,2017.0,2,3,-1
AUT,ESP,2010.0,17,15,2
CAN,LBN,2007.0,5,7,-2
CAN,SVN,2002.0,2,1,1
USA,ARM,2009.0,3,6,-3
USA,GAB,2007.0,2,5,-3
SVN,HRV,2000.0,7,6,1
ROU,RUS,2019.0,2,2,0
GEO,RUS,2013.0,2,4,-2
EST,DNK,2016.0,4,3,1
PAK,CAN,2015.0,23,20,3
PRT,NZL,2003.0,2,2,0
RUS,SGP,2007.0,3,1,2
POL,CZE,2013.0,6,6,0
AUS,ESP,2012.0,24,49,-25
ARG,NZL,2008.0,2,1,1
VEN,GBR,2014.0,3,5,-2
IDN,USA,2011.0,10,26,-16
ZMB,KEN,2002.0,1,2,-1
KEN,ETH,1998.0,2,1,1
SVK,FRA,2000.0,8,3,5
ZWE,USA,2013.0,13,8,5
BWA,NOR,2006.0,1,2,-1
HRV,ITA,1997.0,2,1,1
RUS,LTU,1999.0,2,1,1
SRB,ITA,2017.0,8,3,5
CAN,COL,2003.0,4,3,1
MNG,DEU,2008.0,1,1,0
CZE,CAN,2001.0,4,8,-4
KEN,ZAF,2005.0,9,6,3
IDN,GBR,2000.0,7,4,3
IRL,SGP,2013.0,4,1,3
DEU,ETH,2006.0,10,2,8
USA,GMB,2011.0,1,3,-2
POL,HUN,2023.0,4,4,0
MEX,RUS,2001.0,7,28,-21
POL,LVA,2011.0,2,1,1
AUT,SVN,1999.0,5,3,2
GBR,BMU,2020.0,3,5,-2
THA,SGP,2020.0,8,6,2
NLD,KOR,2013.0,10,8,2
VEN,FRA,2016.0,6,10,-4
PNG,FRA,2001.0,3,2,1
HUN,BEL,2018.0,12,9,3
USA,LVA,2003.0,3,1,2
ARG,CUB,1998.0,2,2,0
ESP,SVN,2010.0,1,5,-4
FRA,VEN,2001.0,9,5,4
ARE,GBR,2011.0,7,32,-25
POL,AUS,2002.0,8,5,3
BRA,MEX,2004.0,8,9,-1
CHE,CHL,2004.0,6,2,4
PRT,HRV,2011.0,1,2,-1
JPN,LKA,2001.0,4,2,2
ITA,PAK,2002.0,3,2,1
IRN,FRA,1999.0,2,9,-7
PNG,AUS,2007.0,7,5,2
AUT,IRL,2020.0,4,7,-3
IND,THA,2009.0,3,4,-1
SVN,CZE,2017.0,6,2,4
ROU,CAN,2007.0,6,1,5
ETH,USA,2004.0,5,9,-4
AUS,MEX,2001.0,5,7,-2
AUS,MEX,2004.0,2,1,1
ZWE,USA,2003.0,3,6,-3
AUT,NOR,2006.0,4,3,1
EST,SWE,2001.0,8,13,-5
GBR,ISL,2001.0,11,5,6
ISR,IRL,2004.0,1,2,-1
DNK,RUS,2003.0,7,6,1
ISL,NOR,2004.0,2,5,-3
RUS,KOR,2007.0,6,15,-9
MYS,NLD,2008.0,2,3,-1
ECU,AUS,2011.0,2,1,1
FRA,AUT,2003.0,27,23,4
IDN,NLD,2007.0,3,11,-8
IDN,AUS,2003.0,9,16,-7
ESP,MAR,2009.0,7,5,2
MEX,PRT,2019.0,5,5,0
OMN,TUN,2019.0,1,5,-4
CHE,COD,2019.0,5,1,4
DEU,CMR,2004.0,3,6,-3
ITA,ALB,1998.0,2,2,0
JOR,GBR,2000.0,2,10,-8
NLD,AUT,2011.0,20,20,0
TUR,RUS,2011.0,2,2,0
HUN,SWE,2011.0,13,7,6
BGR,USA,1998.0,17,16,1
NOR,CHE,2022.0,20,23,-3
MLI,NGA,2020.0,1,2,-1
BEN,KEN,2019.0,3,1,2
USA,MAC,2014.0,17,6,11
KOR,PAK,2013.0,14,32,-18
NGA,DEU,2011.0,5,8,-3
CHL,POL,2015.0,2,1,1
ZMB,USA,2009.0,6,8,-2
AFG,THA,2014.0,1,1,0
DNK,THA,2004.0,3,1,2
RUS,BGR,2019.0,17,9,8
ZAF,ARE,2009.0,2,1,1
CHL,JPN,2014.0,3,8,-5
BGR,DNK,2006.0,2,1,1
CAN,LKA,2008.0,4,5,-1
BGR,HUN,1998.0,1,1,0
ZAF,FIN,2020.0,5,3,2
USA,MLI,2002.0,5,3,2
TZA,IND,2020.0,2,6,-4
SVK,SWE,2005.0,2,2,0
AUT,CHN,1999.0,11,6,5
CHN,MAR,2019.0,3,41,-38
DNK,CHE,2013.0,32,25,7
VNM,DEU,2010.0,2,18,-16
THA,BGD,2010.0,2,2,0
ZAF,CHE,2014.0,9,8,1
CHE,PHL,2002.0,2,3,-1
ESP,NOR,2010.0,11,11,0
PRT,CHN,2005.0,4,4,0
PRT,MYS,2008.0,1,1,0
IRL,PRT,2018.0,3,7,-4
IND,TUR,2009.0,6,3,3
NZL,HKG,2020.0,4,8,-4
LKA,JPN,2003.0,5,9,-4
BRA,NOR,2017.0,4,8,-4
SWE,LTU,2018.0,3,5,-2
MUS,AUS,2007.0,1,1,0
HUN,EGY,2009.0,5,1,4
URY,CHL,2013.0,4,2,2
ESP,SRB,2023.0,1,1,0
ESP,ROU,2012.0,9,8,1
NZL,SGP,1999.0,5,1,4
AUS,ITA,2007.0,20,21,-1
CAN,KOR,2007.0,43,45,-2
ITA,LBN,2016.0,5,7,-2
ITA,LBN,2022.0,5,6,-1
ITA,SRB,2017.0,3,8,-5
GMB,GBR,2006.0,5,4,1
USA,MNG,2017.0,6,1,5
CHL,FRA,2010.0,23,31,-8
FRA,UKR,2007.0,4,9,-5
FRA,EST,2010.0,4,3,1
GRC,ROU,2019.0,2,3,-1
UKR,CZE,2012.0,3,2,1
AUT,ZAF,2010.0,2,2,0
RWA,KEN,2012.0,3,1,2
BLR,HKG,2003.0,3,1,2
JPN,HKG,2009.0,8,7,1
EGY,NOR,2010.0,1,1,0
EGY,BEL,2018.0,4,11,-7
KOR,EGY,2012.0,5,7,-2
NOR,BLR,2018.0,2,2,0
EGY,JPN,2011.0,14,61,-47
IND,QAT,2012.0,10,4,6
BHR,EGY,2014.0,4,1,3
EGY,KAZ,2015.0,1,1,0
CHE,TUN,2015.0,3,1,2
DEU,MLT,2020.0,3,2,1
SVN,ITA,2011.0,5,8,-3
OMN,IND,2017.0,13,33,-20
GHA,GBR,2009.0,7,15,-8
IND,RUS,1999.0,2,3,-1
SRB,AUT,1997.0,2,1,1
ECU,FRA,2018.0,2,13,-11
URY,BRA,2012.0,4,9,-5
HKG,NZL,2004.0,6,2,4
PSE,EGY,2005.0,2,2,0
NLD,BGD,2013.0,2,4,-2
BGD,PAK,2020.0,10,8,2
PAK,KOR,2007.0,4,6,-2
FRA,PYF,2010.0,7,7,0
IND,ISR,2011.0,18,14,4
DEU,BIH,2015.0,3,3,0
NZL,FRA,1997.0,8,3,5
IRN,CZE,2014.0,6,1,5
GBR,ETH,2012.0,9,6,3
JPN,KEN,2009.0,11,3,8
KEN,GBR,2011.0,25,26,-1
HKG,NZL,2014.0,3,3,0
DNK,IRL,2012.0,1,7,-6
IND,NLD,2005.0,10,13,-3
UZB,ITA,2019.0,1,1,0
BFA,COG,2017.0,3,1,2
PAK,BGD,2015.0,10,13,-3
PRT,BEL,2005.0,2,4,-2
AUS,FJI,1997.0,2,1,1
FJI,USA,2003.0,1,3,-2
PER,BEL,2007.0,4,2,2
PSE,ESP,2006.0,1,1,0
DEU,CMR,2014.0,11,5,6
KOR,BEL,2013.0,14,3,11
GHA,NGA,2015.0,7,4,3
HKG,NLD,2007.0,3,3,0
SWE,TUR,2013.0,8,11,-3
ITA,IND,2009.0,16,37,-21
GRC,TUR,2006.0,2,1,1
NZL,MEX,2010.0,1,3,-2
RUS,ISR,2007.0,4,3,1
CHN,NGA,2010.0,11,3,8
AUT,IDN,2012.0,3,1,2
PAK,NLD,2013.0,6,7,-1
DEU,MYS,2007.0,5,5,0
NLD,SAU,2013.0,6,1,5
JPN,BRN,2018.0,1,1,0
ITA,PRT,2003.0,22,3,19
POL,ZAF,2011.0,2,2,0
SRB,SVK,2017.0,2,1,1
THA,IDN,2014.0,8,3,5
BRA,IRN,2010.0,1,4,-3
SAU,BEL,2011.0,1,2,-1
GBR,BMU,2007.0,2,2,0
FIN,PRT,2014.0,4,10,-6
AUT,FIN,2015.0,6,10,-4
HUN,ROU,2012.0,9,4,5
PAK,ITA,2010.0,2,3,-1
ITA,PAK,2012.0,7,1,6
CHN,BGD,2013.0,3,6,-3
SGP,KOR,2016.0,31,39,-8
DEU,SVN,2010.0,6,7,-1
COL,AUS,2007.0,2,3,-1
DNK,IRN,2019.0,6,41,-35
POL,PRT,2019.0,6,9,-3
GUY,USA,2003.0,2,3,-1
UKR,IRN,2019.0,1,2,-1
GHA,FRA,2012.0,1,3,-2
IRN,IND,2009.0,10,24,-14
SLB,AUS,2014.0,6,3,3
BGD,THA,2019.0,5,4,1
MYS,IRQ,2010.0,3,8,-5
ZAF,ITA,2015.0,5,12,-7
NGA,TTO,2019.0,1,1,0
CZE,NOR,2015.0,6,8,-2
MAC,CAN,2014.0,1,3,-2
BGR,DEU,2016.0,9,16,-7
NZL,ARE,2011.0,3,1,2
CUB,FRA,2012.0,2,1,1
ZAF,BWA,2016.0,14,8,6
CHN,IND,2009.0,13,19,-6
SVN,IND,2021.0,3,7,-4
FIN,NOR,2015.0,21,8,13
FIN,ISR,2016.0,2,3,-1
ISR,FIN,2018.0,2,1,1
ITA,POL,2010.0,12,11,1
IDN,KOR,2010.0,6,7,-1
PER,GBR,2017.0,7,9,-2
ZAF,BWA,2018.0,19,7,12
CHE,JPN,2015.0,38,41,-3
IDN,MYS,2015.0,14,80,-66
PRT,NOR,2012.0,3,2,1
NLD,PRT,2013.0,16,18,-2
TWN,FRA,2013.0,10,19,-9
COL,BRA,2007.0,7,17,-10
FRA,GAB,2011.0,8,6,2
LBY,SAU,2014.0,4,1,3
QAT,IND,2016.0,4,9,-5
POL,AUT,2009.0,8,7,1
EST,FIN,2011.0,8,14,-6
USA,CIV,2011.0,3,3,0
GRC,HUN,2018.0,2,1,1
ARE,SAU,2004.0,5,3,2
VNM,TWN,2011.0,3,7,-4
MOZ,FRA,2004.0,1,1,0
ISR,ESP,2015.0,8,17,-9
TUN,JPN,2018.0,1,6,-5
CUB,CHE,2011.0,2,1,1
TUR,CHE,2009.0,10,10,0
POL,ISR,2020.0,8,2,6
JPN,TWN,1998.0,12,10,2
POL,BLR,2008.0,4,6,-2
IRL,NLD,2009.0,15,18,-3
VNM,NOR,2012.0,2,1,1
FIN,CAN,2019.0,17,21,-4
PRT,EGY,2021.0,3,1,2
SWE,ARG,2014.0,3,4,-1
POL,BLR,2015.0,5,2,3
ZAF,ETH,2014.0,7,7,0
DEU,TZA,2010.0,3,2,1
SGP,LUX,2012.0,1,1,0
BEL,TZA,2011.0,2,1,1
THA,CHN,2012.0,6,8,-2
JPN,LKA,2015.0,17,3,14
COL,JPN,2018.0,2,4,-2
ESP,PRY,2017.0,3,1,2
NOR,NZL,2014.0,3,8,-5
NZL,BGR,2018.0,1,1,0
TUR,CHN,2016.0,6,5,1
SWE,UKR,2011.0,1,10,-9
BGR,ITA,2020.0,11,1,10
CYP,FRA,2011.0,1,2,-1
VEN,ITA,2017.0,2,2,0
ESP,NZL,2008.0,4,2,2
FRA,GAB,2009.0,13,6,7
SLE,USA,2014.0,1,10,-9
TWN,DNK,2018.0,3,1,2
AUS,RWA,2021.0,2,1,1
THA,AUS,2011.0,17,31,-14
ZAF,IRL,2007.0,5,1,4
LUX,SWE,2016.0,2,3,-1
THA,NLD,2016.0,6,12,-6
KOR,PRT,2016.0,4,3,1
MAR,ESP,2014.0,6,29,-23
SLV,ESP,2016.0,2,2,0
KOR,NLD,2010.0,10,3,7
BEL,PRT,2015.0,7,25,-18
THA,VNM,2013.0,7,5,2
JPN,LKA,2014.0,13,3,10
ITA,AUT,2014.0,59,23,36
LTU,SWE,2016.0,8,4,4
FIN,RUS,2011.0,9,15,-6
GHA,AUS,2012.0,2,2,0
ITA,PER,2010.0,1,1,0
CMR,FRA,2016.0,17,25,-8
NLD,MYS,2014.0,11,5,6
CHN,SRB,2014.0,1,1,0
SWE,ZAF,2012.0,8,8,0
IRL,JPN,2016.0,3,6,-3
KEN,BEL,2016.0,7,6,1
POL,CHN,2020.0,11,15,-4
CHL,VEN,2012.0,4,6,-2
NPL,KOR,2014.0,8,2,6
NZL,SWE,2012.0,12,9,3
MEX,ARG,2023.0,4,7,-3
JOR,CAN,2005.0,6,7,-1
DEU,ECU,2020.0,10,5,5
FRA,ZAF,2007.0,9,11,-2
SGP,GBR,1999.0,26,35,-9
HKG,SWE,2020.0,13,3,10
MYS,DEU,2012.0,8,7,1
FIN,CAN,2011.0,9,15,-6
AUS,KOR,2000.0,8,6,2
PRT,IND,2007.0,4,7,-3
AUS,NCL,2022.0,4,1,3
ZMB,ZWE,2012.0,2,2,0
ZAF,TZA,2020.0,13,8,5
ESP,CZE,2009.0,5,9,-4
KWT,QAT,2009.0,1,2,-1
PSE,FRA,2017.0,1,2,-1
FIN,CHN,2010.0,12,21,-9
OMN,IND,2022.0,15,29,-14
CHN,NOR,2010.0,24,8,16
HKG,JPN,1999.0,6,5,1
POL,SGP,2021.0,4,3,1
CHN,PRT,2010.0,8,8,0
BRA,NGA,2019.0,4,5,-1
KAZ,IND,2022.0,1,1,0
IDN,CAN,2020.0,4,8,-4
FRA,SRB,2013.0,8,6,2
NOR,CHE,2018.0,19,26,-7
DNK,BRA,2016.0,9,28,-19
HKG,MAC,2015.0,17,6,11
TUR,SGP,2021.0,7,5,2
GBR,DZA,2023.0,2,1,1
MEX,VEN,2018.0,4,13,-9
KEN,PAK,2021.0,3,1,2
GBR,LVA,2020.0,8,5,3
NOR,BIH,2018.0,1,2,-1
QAT,AUS,2017.0,10,10,0
AUS,CZE,2017.0,13,8,5
TZA,ESP,2019.0,1,15,-14
MOZ,USA,2015.0,10,15,-5
ETH,CHN,2016.0,8,2,6
NGA,GHA,1997.0,1,1,0
CHN,MAR,2021.0,6,6,0
CHN,TZA,2017.0,6,2,4
NOR,RUS,2022.0,6,12,-6
TUR,ARE,2022.0,5,2,3
PSE,ITA,2022.0,2,6,-4
BRA,CRI,2016.0,5,2,3
BFA,MLI,2017.0,5,1,4
FRA,EGY,2023.0,9,7,2
ITA,LBN,2017.0,2,4,-2
LUX,BEL,2017.0,7,25,-18
NZL,MYS,2021.0,11,18,-7
KOR,MEX,2014.0,1,1,0
FIN,NGA,2013.0,2,1,1
CZE,SVN,2018.0,3,3,0
BGR,ESP,2013.0,4,2,2
EGY,SGP,2018.0,3,1,2
GBR,BHR,2022.0,4,8,-4
COL,ARM,2016.0,4,4,0
HUN,SWE,2021.0,11,6,5
ITA,NER,2022.0,1,2,-1
KWT,CZE,2016.0,2,1,1
IRN,IND,2019.0,6,11,-5
IRL,NLD,2021.0,25,27,-2
FIN,TUR,2020.0,3,9,-6
GBR,KHM,2016.0,3,3,0
SVK,CHE,2022.0,5,4,1
EGY,ESP,2021.0,12,23,-11
MEX,SAU,2019.0,3,1,2
SUR,NLD,2018.0,3,3,0
CHN,GRC,2008.0,2,1,1
GRC,CHN,2011.0,5,2,3
ARE,KWT,2017.0,2,3,-1
IND,TUN,2022.0,1,1,0
PRY,USA,2017.0,3,2,1
CHE,PAN,2019.0,2,1,1
USA,AUS,2024.0,2,2,0
PAK,CZE,2019.0,5,5,0
HKG,MYS,2012.0,13,3,10
TWN,PHL,2011.0,3,4,-1
LBN,BEL,2023.0,3,3,0
NER,FRA,1997.0,6,3,3
IDN,ESP,2021.0,4,3,1
CMR,FRA,2018.0,14,28,-14
AUS,SDN,2021.0,1,1,0
TUR,RUS,2019.0,9,4,5
DNK,NZL,1999.0,3,3,0
HUN,BRA,2019.0,4,3,1
ITA,MYS,2023.0,3,4,-1
IDN,IRQ,2019.0,3,1,2
BGR,BEL,2023.0,2,1,1
COL,VNM,2019.0,2,2,0
UZB,RUS,2023.0,4,8,-4
IRN,IRL,2017.0,6,9,-3
COG,FRA,2019.0,4,3,1
VNM,FRA,2012.0,13,20,-7
CHE,THA,2004.0,6,1,5
EST,FRA,2021.0,3,5,-2
PRT,COL,2021.0,4,8,-4
SGP,HKG,2012.0,22,27,-5
COL,CHN,2016.0,1,1,0
QAT,CAN,2023.0,11,11,0
SVK,RUS,2019.0,5,3,2
HRV,USA,2015.0,20,18,2
TUR,OMN,2019.0,1,1,0
MEX,BRA,2012.0,15,14,1
BRA,MEX,2014.0,16,31,-15
CYP,DEU,2021.0,6,9,-3
IRN,POL,2023.0,24,5,19
NZL,IND,2022.0,14,14,0
IND,SAU,2024.0,3,1,2
HUN,ESP,2021.0,9,4,5
NOR,LTU,2020.0,1,2,-1
HUN,SVN,2019.0,1,1,0
ISL,AUS,2021.0,1,1,0
JPN,KEN,2021.0,10,7,3
EGY,ETH,2021.0,1,2,-1
MAR,MYS,2022.0,3,1,2
JOR,TUR,2023.0,2,3,-1
NOR,SRB,2022.0,2,2,0
POL,KAZ,2022.0,6,1,5
KOR,LKA,2023.0,3,2,1
EST,ESP,2021.0,6,6,0
IND,BHR,1998.0,4,4,0
HRV,SRB,2022.0,5,6,-1
RUS,ARM,2021.0,5,5,0
ARM,RUS,2022.0,4,6,-2
PER,CHN,2021.0,1,3,-2
CHE,LUX,2011.0,7,5,2
CAN,SVK,2009.0,3,3,0
VNM,JPN,2000.0,1,3,-2
GBR,MNG,2015.0,3,4,-1
OMN,USA,2012.0,3,8,-5
DEU,ARE,2019.0,13,7,6
CHE,ZWE,2021.0,1,1,0
USA,SRB,2013.0,20,14,6
TUR,KEN,2006.0,1,2,-1
CUB,GBR,2014.0,2,2,0
GBR,ARE,2010.0,26,12,14
NGA,BEL,2020.0,3,2,1
IDN,MYS,2014.0,10,77,-67
KWT,AUS,2018.0,4,6,-2
KEN,DNK,2012.0,2,2,0
ZAF,SWZ,2018.0,5,6,-1
CHN,ARE,2011.0,1,3,-2
NLD,CZE,2020.0,5,10,-5
TUR,CAN,2007.0,14,10,4
BFA,FRA,2018.0,14,23,-9
MWI,ZAF,2010.0,2,4,-2
KOR,ESP,2017.0,9,4,5
SWE,ARE,2021.0,8,6,2
CZE,AUS,2006.0,6,1,5
GRC,SRB,2014.0,3,2,1
MYS,SWE,2013.0,5,3,2
POL,ITA,2014.0,16,21,-5
PRT,ITA,2009.0,8,21,-13
HUN,ITA,2008.0,11,10,1
ITA,HUN,2009.0,6,19,-13
NGA,ITA,2019.0,2,7,-5
HUN,FIN,2010.0,3,1,2
DNK,ISR,2017.0,4,4,0
AUT,ESP,2023.0,17,18,-1
NLD,ARE,2014.0,5,2,3
NZL,CHE,2010.0,8,7,1
SWE,VNM,2015.0,5,2,3
SWE,PAK,2014.0,23,5,18
FIN,MYS,2011.0,1,1,0
BRA,IRN,2023.0,2,11,-9
KOR,IDN,2010.0,7,6,1
FRA,VEN,2015.0,4,15,-11
DEU,UKR,2021.0,14,43,-29
SRB,NLD,2021.0,6,2,4
PRT,CAN,2016.0,10,10,0
SVN,FRA,2013.0,5,6,-1
ROU,DEU,2012.0,39,22,17
CIV,CAN,2016.0,2,2,0
KEN,ZMB,2022.0,2,1,1
AUS,NOR,2006.0,3,9,-6
SWE,ARG,2015.0,3,3,0
TWN,BGD,2020.0,3,1,2
SDN,DEU,2018.0,2,4,-2
IND,BRA,2000.0,4,5,-1
DOM,DMA,2017.0,2,1,1
GAB,NLD,2017.0,1,3,-2
SWE,CZE,2012.0,9,8,1
PER,DEU,2010.0,1,1,0
KEN,IDN,2012.0,1,1,0
HRV,AUT,2017.0,8,3,5
IRL,DNK,2016.0,5,9,-4
BMU,GBR,2021.0,2,2,0
FRA,TUR,2007.0,21,7,14
VEN,BRA,2008.0,7,3,4
MYS,ARE,2015.0,15,1,14
BGD,CAN,2011.0,19,4,15
FIN,CHE,2016.0,16,15,1
KOR,BGD,2009.0,5,15,-10
CMR,BEN,2013.0,1,1,0
IRL,BEL,2014.0,10,7,3
LAO,COD,2016.0,2,2,0
FRA,CRI,2007.0,2,2,0
CRI,FRA,2009.0,4,3,1
IRL,LKA,2018.0,1,1,0
GEO,DEU,2014.0,5,5,0
HRV,HUN,2023.0,2,3,-1
MAC,CHN,2008.0,16,11,5
GBR,MNG,2011.0,1,0,1
BEL,DZA,2009.0,3,0,3
GRC,LUX,2004.0,1,0,1
,SLB,2005.0,5,0,5
SDN,OMN,2013.0,1,0,1
USA,SYC,2022.0,3,0,3
JPN,SVN,2021.0,3,0,3
TZA,BGR,2020.0,1,0,1
NIC,NOR,2007.0,1,0,1
BEL,SGP,2004.0,2,0,2
,ERI,2000.0,4,0,4
GRC,MAC,2012.0,1,0,1
KOR,SRB,2010.0,1,0,1
YEM,PAK,2010.0,1,0,1
JOR,IRN,2003.0,2,0,2
AGO,,2011.0,7,0,7
SEN,SVN,2012.0,1,0,1
REU,ROU,2001.0,2,0,2
,BTN,1998.0,2,0,2
BTN,IND,2003.0,1,0,1
ASM,WSM,2010.0,1,0,1
ECU,AUS,2014.0,1,0,1
IDN,ETH,2013.0,1,0,1
,GUY,2005.0,3,0,3
ABW,,2009.0,1,0,1
BGD,GRC,2014.0,1,0,1
,TGO,2005.0,27,0,27
ROU,DNK,2007.0,3,0,3
TTO,FRA,2005.0,1,0,1
MOZ,BRA,1997.0,1,0,1
DNK,FRO,2014.0,1,0,1
BRA,GAB,2011.0,1,0,1
GBR,CYM,2011.0,1,0,1
IRL,LTU,2012.0,1,0,1
KOR,GRC,2020.0,1,0,1
MWI,TZA,2022.0,2,0,2
TUN,SWE,2013.0,1,0,1
DEU,BRN,2011.0,1,0,1
CHE,VEN,2014.0,1,0,1
ISR,JAM,2016.0,1,0,1
FJI,BGD,2020.0,1,0,1
BLR,SRB,2022.0,1,0,1
,BLZ,2008.0,3,0,3
LTU,NLD,2013.0,1,0,1
SWE,JOR,2014.0,1,0,1
UGA,ISL,2013.0,1,0,1
LTU,AUS,2012.0,2,0,2
KOR,KWT,2016.0,1,0,1
ZAF,BRB,2013.0,1,0,1
DEU,MLT,2017.0,2,0,2
MLT,PRT,2020.0,1,0,1
BGR,CHN,2013.0,1,0,1
GBR,PSE,2016.0,5,0,5
KOR,ZWE,2018.0,3,0,3
OMN,ARE,1997.0,1,0,1
DEU,KWT,1997.0,3,0,3
URY,PRT,2020.0,1,0,1
PHL,CHN,2002.0,4,0,4
SYR,ITA,2014.0,2,0,2
TUR,EST,2019.0,1,0,1
ARG,IRN,2015.0,1,0,1
CHE,LCA,2014.0,1,0,1
MUS,AUS,2022.0,1,0,1
CZE,DZA,2014.0,1,0,1
SVK,MLT,2020.0,1,0,1
QAT,IDN,2016.0,1,0,1
YEM,IRQ,2018.0,2,0,2
GEO,POL,2014.0,1,0,1
AUS,BHR,2015.0,1,0,1
IND,BWA,2020.0,6,0,6
TWN,GMB,2015.0,2,0,2
CUB,PER,2015.0,1,0,1
BHR,ITA,2023.0,1,0,1
JAM,IDN,2022.0,1,0,1
MEX,PRI,2023.0,2,0,2
CHL,RUS,2020.0,1,0,1
WSM,,2020.0,4,0,4
TZA,CMR,2022.0,1,0,1
NIC,ESP,2019.0,2,0,2
AZE,BEL,2020.0,1,0,1
THA,PER,2019.0,1,0,1
ZAF,COD,2018.0,5,0,5
LSO,ITA,2018.0,1,0,1
HUN,UKR,2018.0,3,0,3
HUN,OMN,1999.0,1,0,1
TTO,RUS,2021.0,2,0,2
VEN,IRQ,2021.0,1,0,1
KOR,PAN,2021.0,2,0,2
SEN,CHN,2011.0,2,0,2
COL,KOR,2021.0,1,0,1
,MCO,2002.0,6,0,6
AUS,CZE,1998.0,1,0,1
TUR,TTO,2017.0,1,0,1
CMR,SAU,2001.0,1,0,1
ARE,SVK,2020.0,1,0,1
FIN,IRL,2004.0,2,0,2
ETH,MWI,1998.0,1,0,1
BEL,MMR,2008.0,1,0,1
BEL,MMR,2015.0,1,0,1
NZL,BWA,2002.0,1,0,1
KWT,RUS,2003.0,1,0,1
DNK,SVK,2018.0,1,0,1
NZL,IRN,2001.0,3,0,3
TWN,ARM,2011.0,1,0,1
BFA,,1999.0,3,0,3
CAN,IDN,1997.0,1,0,1
GEO,AUS,1999.0,1,0,1
GEO,AUS,2007.0,2,0,2
ISL,LBN,1998.0,1,0,1
ARM,FRA,1997.0,3,0,3
SRB,SVK,2007.0,2,0,2
ETH,NGA,2006.0,2,0,2
NGA,JAM,2012.0,1,0,1
IRL,SVK,2022.0,1,0,1
NLD,KGZ,1997.0,1,0,1
BEL,MTQ,2015.0,1,0,1
CIV,CMR,1999.0,1,0,1
NZL,SAU,1997.0,1,0,1
OMN,DZA,2012.0,2,0,2
UGA,FRA,2004.0,1,0,1
JPN,JOR,2002.0,2,0,2
UZB,TUR,2001.0,1,0,1
AUS,LAO,2001.0,1,0,1
AUT,NGA,1998.0,1,0,1
JOR,BHR,1999.0,1,0,1
VEN,GRC,2012.0,3,0,3
ITA,SEN,2000.0,1,0,1
TUR,SAU,1997.0,1,0,1
NZL,ERI,2004.0,1,0,1
CYP,ISR,1998.0,1,0,1
KHM,USA,2000.0,1,0,1
IRL,ROU,2012.0,2,0,2
NZL,UKR,2014.0,1,0,1
ISR,EST,2018.0,2,0,2
GEO,GRC,2021.0,2,0,2
UGA,COG,2011.0,1,0,1
CHN,GEO,2008.0,2,0,2
TWN,ARE,2017.0,1,0,1
MEX,ZWE,2013.0,2,0,2
SDN,ZMB,2014.0,1,0,1
COL,IDN,2006.0,1,0,1
ISR,CHL,2012.0,1,0,1
NGA,PHL,2020.0,2,0,2
CUB,URY,2001.0,1,0,1
SGP,EST,2022.0,1,0,1
SAU,EST,2019.0,2,0,2
SAU,EST,2021.0,1,0,1
,BMU,2006.0,6,0,6
KWT,BGR,2016.0,1,0,1
HRV,IRL,2015.0,3,0,3
BEL,KHM,2016.0,1,0,1
CZE,TWN,2012.0,5,0,5
ITA,MLI,2014.0,1,0,1
ETH,CUB,1999.0,1,0,1
SDN,PAK,1999.0,1,0,1
BOL,CHL,2007.0,2,0,2
COG,DEU,2007.0,1,0,1
FRA,MAC,2012.0,1,0,1
CMR,TCD,2011.0,1,0,1
WSM,NZL,2017.0,1,0,1
DEU,POL,2024.0,2,0,2
POL,ROU,2001.0,3,0,3
GEO,TUR,2009.0,1,0,1
TZA,PER,2012.0,1,0,1
,SLV,2004.0,13,0,13
ITA,LUX,2010.0,4,0,4
CAN,TON,2009.0,1,0,1
TON,CAN,2016.0,1,0,1
IRQ,QAT,2010.0,1,0,1
ZAF,GNQ,2007.0,1,0,1
GNQ,,2010.0,1,0,1
TUR,KHM,2007.0,1,0,1
DEU,PRK,2016.0,1,0,1
PHL,PRT,2023.0,1,0,1
GNB,BRA,2009.0,1,0,1
SGP,MAC,2006.0,2,0,2
CHE,KEN,2024.0,1,0,1
ATG,VCT,2011.0,1,0,1
AUS,PLW,2014.0,1,0,1
JPN,SVK,1997.0,4,0,4
VUT,WSM,2018.0,1,0,1
LIE,FRA,2015.0,1,0,1
AUT,TUR,2011.0,6,0,6
ECU,PER,1997.0,1,0,1
JOR,DZA,2013.0,3,0,3
AUS,TLS,2005.0,1,0,1
TLS,AUS,2008.0,1,0,1
LKA,NLD,2008.0,2,0,2
BEN,ZAF,2002.0,2,0,2
COD,CHE,1999.0,1,0,1
ARE,TTO,2011.0,1,0,1
BRA,TTO,2016.0,1,0,1
LAO,IDN,2017.0,2,0,2
ALB,IRQ,2012.0,1,0,1
URY,COL,2004.0,1,0,1
LUX,LBN,2018.0,1,0,1
LTU,IRN,2016.0,1,0,1
AUS,REU,2017.0,1,0,1
PSE,JOR,2014.0,2,0,2
JOR,PSE,2016.0,4,0,4
LBN,OMN,2014.0,1,0,1
,MCO,2012.0,5,0,5
RUS,KGZ,2023.0,3,0,3
NER,USA,1997.0,1,0,1
IDN,MMR,2019.0,2,0,2
TWN,NZL,2022.0,1,0,1
VEN,QAT,2022.0,1,0,1
ZWE,TWN,2022.0,1,0,1
COG,EGY,2022.0,1,0,1
BGD,EGY,2020.0,2,0,2
PRI,AUS,2003.0,1,0,1
THA,TUR,2012.0,1,0,1
NAM,USA,1999.0,2,0,2
,VIR,1998.0,2,0,2
NCL,VUT,2010.0,1,0,1
BGR,SAU,2020.0,2,0,2
NGA,PSE,2023.0,1,0,1
AUT,ATF,2001.0,1,0,1
GEO,,2026.0,7,0,7
ZAF,LBY,1997.0,1,0,1
BRA,ECU,2003.0,1,0,1
BMU,,2021.0,3,0,3
ZWE,SWE,1999.0,2,0,2
JAM,CAN,1998.0,1,0,1
NZL,AUT,2006.0,2,0,2
MWI,ZAF,2003.0,3,0,3
PNG,IND,2001.0,3,0,3
NOR,FRO,2009.0,1,0,1
ITA,COG,2011.0,3,0,3
TUR,AZE,2001.0,4,0,4
COG,IND,2001.0,1,0,1
GRC,PRT,2003.0,1,0,1
ALB,USA,2002.0,1,0,1
GNB,,2001.0,1,0,1
LKA,NLD,2001.0,2,0,2
CUB,CHL,2000.0,4,0,4
ROU,DNK,1998.0,1,0,1
NZL,LUX,2022.0,1,0,1
PAN,PAK,2012.0,1,0,1
,GRD,2008.0,3,0,3
PRT,HRV,2014.0,2,0,2
NOR,CRI,2004.0,1,0,1
GUM,,2014.0,4,0,4
NGA,OMN,2012.0,1,0,1
LBN,JPN,2000.0,2,0,2
MEX,KAZ,2015.0,1,0,1
NOR,KOR,2005.0,1,0,1
NGA,ESP,2016.0,2,0,2
BRA,BLZ,2009.0,2,0,2
AZE,ROU,2010.0,1,0,1
BOL,DNK,2014.0,1,0,1
ISL,VNM,2017.0,1,0,1
CZE,ARG,2015.0,2,0,2
AZE,FRA,2010.0,1,0,1
SYR,YEM,2014.0,1,0,1
ROU,EST,2016.0,2,0,2
RUS,CUB,2020.0,1,0,1
NPL,IRL,2020.0,1,0,1
GHA,HKG,2023.0,6,0,6
KAZ,ISR,2010.0,1,0,1
LTU,LVA,2002.0,2,0,2
SYR,ITA,2015.0,1,0,1
UKR,VNM,2014.0,1,0,1
GTM,ABW,2020.0,1,0,1
ALB,AUT,2021.0,2,0,2
BTN,,2017.0,7,0,7
ESP,GHA,2014.0,1,0,1
ETH,SEN,2016.0,4,0,4
NZL,QAT,2016.0,2,0,2
BRN,BFA,2013.0,2,0,2
KWT,JPN,2006.0,1,0,1
ASM,,2016.0,4,0,4
SYR,BRA,2014.0,1,0,1
SWE,ZMB,2018.0,1,0,1
KWT,QAT,2014.0,2,0,2
HRV,CRI,2019.0,2,0,2
BLR,SWE,2019.0,1,0,1
ISL,ESP,2023.0,1,0,1
CYP,FRA,2004.0,1,0,1
BEL,ABW,2018.0,1,0,1
CIV,DEU,2019.0,2,0,2
NLD,MRT,2017.0,1,0,1
NLD,MRT,2022.0,1,0,1
EGY,SDN,2010.0,2,0,2
TUN,CYP,2019.0,1,0,1
BEL,GMB,2018.0,2,0,2
LAO,ITA,2017.0,1,0,1
GRL,NOR,2018.0,1,0,1
DNK,MAR,2017.0,1,0,1
CAN,NER,2015.0,1,0,1
HUN,DNK,2023.0,3,0,3
LKA,IDN,2020.0,2,0,2
ITA,LUX,2006.0,1,0,1
GBR,BTN,2017.0,1,0,1
PAN,CHE,2022.0,2,0,2
SJM,USA,2018.0,2,0,2
KHM,CZE,2019.0,1,0,1
VEN,VNM,2021.0,1,0,1
DMA,ARM,2020.0,1,0,1
PER,PHL,1999.0,1,0,1
PHL,PER,2000.0,1,0,1
NLD,HTI,2019.0,2,0,2
IRN,AZE,1999.0,1,0,1
IND,BIH,2017.0,1,0,1
ITA,COG,2019.0,2,0,2
IDN,UKR,2022.0,2,0,2
AUS,MDV,2022.0,2,0,2
NCL,USA,1999.0,1,0,1
TUN,GBR,2023.0,1,0,1
USA,BRB,1997.0,1,0,1
LBN,MAR,2009.0,1,0,1
,SXM,2019.0,2,0,2
THA,ZAF,2010.0,1,0,1
HND,CAN,2007.0,1,0,1
,SWZ,1997.0,5,0,5
THA,GIN,2022.0,1,0,1
AZE,GEO,2022.0,2,0,2
PHL,ARE,2019.0,1,0,1
LAO,,2004.0,2,0,2
ITA,JOR,2001.0,2,0,2
MYS,LBY,2008.0,3,0,3
,DOM,1995.0,6,0,6
TUN,NER,2018.0,2,0,2
EST,DNK,2007.0,2,0,2
AUS,MOZ,2004.0,1,0,1
CIV,GHA,2012.0,1,0,1
UZB,IND,2017.0,2,0,2
USA,MDG,2002.0,5,0,5
TZA,UGA,2006.0,1,0,1
ISR,ETH,2002.0,1,0,1
ETH,MWI,1999.0,1,0,1
CHN,TZA,1999.0,1,0,1
CUB,UGA,2006.0,1,0,1
IRN,UZB,2019.0,1,0,1
AUT,MCO,2004.0,1,0,1
PHL,NOR,2000.0,1,0,1
MUS,FRA,2008.0,1,0,1
TUR,LBY,2006.0,1,0,1
GHA,LBR,2022.0,2,0,2
KEN,SDN,2003.0,1,0,1
LIE,,2000.0,1,0,1
GBR,NER,1998.0,1,0,1
LTU,HRV,2019.0,1,0,1
RUS,EGY,2003.0,1,0,1
GBR,DMA,2017.0,1,0,1
NZL,WSM,2000.0,1,0,1
TUR,KEN,2013.0,1,0,1
VNM,TWN,2004.0,1,0,1
BRA,BFA,2004.0,2,0,2
HTI,BRA,2018.0,1,0,1
NER,USA,2002.0,2,0,2
CMR,,1999.0,8,0,8
BOL,DNK,2001.0,1,0,1
DEU,GAB,2001.0,4,0,4
ARE,BRB,2004.0,1,0,1
OMN,NAM,2017.0,1,0,1
,AGO,1995.0,2,0,2
FRO,,2011.0,2,0,2
IDN,BGD,2012.0,1,0,1
,GIB,2000.0,1,0,1
AFG,IND,2001.0,1,0,1
CZE,KOR,2008.0,1,0,1
IRL,MLT,2009.0,1,0,1
BEL,BRN,2015.0,1,0,1
ATG,USA,2008.0,1,0,1
KEN,NZL,2006.0,1,0,1
BHR,PAK,1997.0,1,0,1
TZA,COG,2022.0,1,0,1
DEU,TTO,2020.0,1,0,1
SUR,,2016.0,2,0,2
LKA,SGP,2009.0,1,0,1
BLR,SWE,2009.0,1,0,1
UKR,GRC,2019.0,1,0,1
NLD,MLI,2009.0,2,0,2
KEN,RUS,2009.0,3,0,3
PAN,THA,2013.0,1,0,1
BEL,MCO,2004.0,2,0,2
IRL,SAU,2007.0,2,0,2
AUS,KHM,2015.0,3,0,3
CZE,LBY,2008.0,2,0,2
ECU,BRA,2008.0,2,0,2
CAN,GIN,2014.0,1,0,1
REU,,2012.0,4,0,4
DNK,VNM,2006.0,1,0,1
PHL,ITA,2011.0,1,0,1
IRN,GUF,2003.0,1,0,1
LKA,EGY,2022.0,1,0,1
PRY,ARG,2006.0,1,0,1
JPN,SEN,2016.0,1,0,1
UKR,OMN,2003.0,1,0,1
OMN,POL,2005.0,1,0,1
IRL,KAZ,2015.0,1,0,1
AUT,SAU,2001.0,1,0,1
,SWZ,2005.0,6,0,6
EGY,LBY,2009.0,5,0,5
LBY,PRT,2014.0,1,0,1
ETH,TWN,2012.0,1,0,1
ARE,AFG,2020.0,2,0,2
KNA,,2010.0,1,0,1
CZE,IRN,2003.0,1,0,1
NZL,SDN,2014.0,1,0,1
NOR,GRL,2021.0,1,0,1
GHA,NOR,2012.0,1,0,1
GRC,EGY,2014.0,1,0,1
FIN,CRI,2005.0,1,0,1
BLR,ESP,2006.0,1,0,1
IND,EGY,2001.0,3,0,3
TUR,MKD,2001.0,2,0,2
POL,SRB,2009.0,1,0,1
KOR,KWT,2017.0,1,0,1
GMB,UGA,2019.0,1,0,1
ASM,KOR,2019.0,1,0,1
FIN,NPL,2022.0,1,0,1
BEL,MUS,2020.0,2,0,2
PLW,USA,2020.0,1,0,1
KOR,POL,2020.0,7,0,7
POL,SRB,2011.0,1,0,1
ISR,TWN,2023.0,2,0,2
MYS,ZMB,2018.0,3,0,3
BEL,GMB,2022.0,2,0,2
NPL,CHE,2009.0,3,0,3
JPN,OMN,2002.0,1,0,1
UKR,PRT,2002.0,1,0,1
MLI,FRA,1999.0,4,0,4
KEN,SAU,2018.0,2,0,2
CZE,NZL,1997.0,1,0,1
NGA,GUY,1999.0,1,0,1
GNB,ZAF,1997.0,1,0,1
MWI,NLD,2010.0,6,0,6
KWT,NLD,2007.0,1,0,1
HRV,ISR,1997.0,2,0,2
BWA,POL,2005.0,1,0,1
HUN,BRA,2008.0,1,0,1
USA,VCT,2013.0,1,0,1
ITA,MDA,1997.0,2,0,2
SVN,ARE,2017.0,2,0,2
HUN,EST,2008.0,1,0,1
IRN,AZE,1998.0,1,0,1
CAN,LUX,1999.0,1,0,1
UKR,KAZ,2001.0,1,0,1
SVK,UKR,2002.0,1,0,1
LTU,EST,2004.0,1,0,1
ARE,NGA,2010.0,1,0,1
ZAF,ROU,2003.0,1,0,1
USA,HND,1999.0,3,0,3
AUS,QAT,2001.0,1,0,1
POL,LBN,2005.0,1,0,1
CHL,JAM,2014.0,1,0,1
CAN,ARM,2018.0,2,0,2
ROU,RUS,2001.0,2,0,2
FSM,ZAF,1999.0,1,0,1
SVN,MEX,1998.0,1,0,1
DZA,ESP,2002.0,3,0,3
ZMB,MWI,1998.0,1,0,1
NCL,PYF,2003.0,2,0,2
PYF,,2012.0,5,0,5
BFA,NLD,2005.0,2,0,2
USA,ERI,2002.0,1,0,1
FRA,BLR,2008.0,1,0,1
IND,CRI,2009.0,1,0,1
AZE,CAN,2006.0,1,0,1
PAK,MOZ,2007.0,1,0,1
BOL,CRI,2009.0,1,0,1
SEN,GMB,2002.0,1,0,1
GBR,TUN,2010.0,3,0,3
JAM,SWE,2018.0,1,0,1
SRB,CHE,1999.0,1,0,1
CHE,GHA,2001.0,1,0,1
DNK,SVN,2017.0,2,0,2
GHA,CRI,2004.0,1,0,1
NER,MLI,2020.0,3,0,3
RUS,HKG,2000.0,4,0,4
IND,CYM,2017.0,2,0,2
IND,BHS,2020.0,1,0,1
PRT,THA,2007.0,1,0,1
UZB,KAZ,2010.0,2,0,2
AUS,VNM,2008.0,7,0,7
FRA,CAF,2021.0,1,0,1
DEU,LAO,2012.0,1,0,1
LKA,COL,2011.0,1,0,1
NLD,PER,2006.0,6,0,6
IRL,LUX,2005.0,1,0,1
SEN,LAO,2020.0,1,0,1
FJI,,2000.0,2,0,2
GBR,ALB,2007.0,3,0,3
TUR,DOM,2006.0,1,0,1
ITA,RWA,2018.0,1,0,1
FIN,SAU,2016.0,3,0,3
URY,NOR,2017.0,1,0,1
JPN,PYF,2015.0,1,0,1
KEN,NGA,2003.0,1,0,1
BRN,CAN,2019.0,1,0,1
FRA,BHR,2023.0,1,0,1
BRA,SGP,2023.0,3,0,3
COL,COM,2012.0,2,0,2
BLZ,BEN,2019.0,1,0,1
SAU,MYS,2006.0,1,0,1
ROU,KAZ,2017.0,2,0,2
GLP,CAN,2013.0,2,0,2
UGA,ETH,2017.0,1,0,1
PNG,FJI,2023.0,1,0,1
EST,RUS,2017.0,4,0,4
FJI,PHL,2021.0,1,0,1
CAN,FRO,2015.0,1,0,1
ROU,PAK,2008.0,1,0,1
GIN,SEN,2010.0,2,0,2
KWT,KOR,2018.0,1,0,1
ARM,GBR,2013.0,2,0,2
AUT,ROU,2010.0,1,0,1
FLK,,2019.0,3,0,3
ROU,BGR,2021.0,3,0,3
ISL,CHE,2013.0,3,0,3
IRN,PER,2019.0,1,0,1
NZL,UGA,2008.0,1,0,1
CIV,GAB,2017.0,1,0,1
IRQ,ROU,2011.0,1,0,1
ALB,GBR,2011.0,5,0,5
TUN,TUR,2013.0,2,0,2
DZA,SEN,2023.0,1,0,1
MAR,CHE,2013.0,1,0,1
SVN,TWN,2011.0,1,0,1
THA,ETH,2008.0,1,0,1
JPN,BWA,2012.0,1,0,1
HRV,FIN,2009.0,1,0,1
JPN,PSE,2011.0,3,0,3
BEL,IDN,2009.0,4,0,4
LAO,SGP,2018.0,1,0,1
PSE,AUS,2004.0,1,0,1
NOR,ZMB,2001.0,1,0,1
BRA,MLT,2018.0,1,0,1
CZE,LKA,2020.0,2,0,2
SYR,AUT,2009.0,1,0,1
JAM,IRL,2004.0,1,0,1
SAU,UKR,2018.0,1,0,1
JOR,OMN,2006.0,1,0,1
UKR,YEM,1998.0,1,0,1
SWZ,NGA,2010.0,1,0,1
KGZ,DEU,2005.0,1,0,1
NLD,SUR,2014.0,3,0,3
TUN,IRN,2009.0,1,0,1
KWT,IRL,2012.0,1,0,1
CUB,PRT,2005.0,1,0,1
JOR,HKG,2006.0,1,0,1
HKG,JOR,2009.0,1,0,1
VEN,URY,2016.0,1,0,1
DZA,USA,1999.0,3,0,3
ARG,SLB,2016.0,1,0,1
NRU,FJI,2018.0,1,0,1
SLV,USA,2006.0,1,0,1
CHN,EST,2001.0,1,0,1
BEL,BHR,2006.0,1,0,1
GRC,NZL,2021.0,1,0,1
SYR,MEX,2009.0,1,0,1
AUS,LVA,1999.0,1,0,1
NER,MLI,1999.0,1,0,1
GEO,KOR,2017.0,1,0,1
COL,LUX,2021.0,2,0,2
IRL,ZWE,2018.0,1,0,1
VEN,NOR,2015.0,1,0,1
LKA,BEL,2014.0,2,0,2
,ASM,2014.0,1,0,1
DMA,BRB,2021.0,1,0,1
GRD,,2019.0,12,0,12
USA,PRK,2019.0,1,0,1
CHE,BGD,1999.0,1,0,1
KGZ,CHN,1999.0,1,0,1
PSE,SWE,2018.0,1,0,1
CAN,GAB,2021.0,1,0,1
TTO,AUS,2009.0,2,0,2
GRC,MNE,2019.0,1,0,1
JOR,SYR,2000.0,1,0,1
GMB,UGA,2009.0,1,0,1
GMB,UGA,2011.0,1,0,1
BGD,IRL,2018.0,1,0,1
,MHL,1999.0,2,0,2
,BRB,2001.0,7,0,7
CHN,VNM,2005.0,1,0,1
QAT,IRQ,2016.0,1,0,1
GTM,CRI,2020.0,2,0,2
AGO,SWE,2018.0,1,0,1
NZL,SAU,2012.0,4,0,4
ESP,MAC,2022.0,1,0,1
EGY,BDI,2022.0,1,0,1
NZL,JOR,2022.0,2,0,2
BOL,BRA,2023.0,2,0,2
TWN,UZB,2022.0,1,0,1
,LKA,2021.0,3,0,3
JPN,HRV,2009.0,1,0,1
SVK,DNK,2022.0,2,0,2
CHE,TLS,2022.0,1,0,1
MLI,SEN,2013.0,2,0,2
TUR,SVN,2019.0,2,0,2
GNB,SWE,2007.0,1,0,1
SWE,FRO,2018.0,1,0,1
IDN,PER,2008.0,1,0,1
PRI,CHN,2002.0,2,0,2
JPN,KWT,2022.0,3,0,3
BRN,MYS,2003.0,1,0,1
HUN,VNM,1997.0,1,0,1
VNM,HUN,1998.0,1,0,1
KOR,DNK,2000.0,2,0,2
CMR,KEN,2003.0,1,0,1
VEN,MEX,1998.0,3,0,3
ZAF,JOR,2019.0,1,0,1
KOR,POL,1999.0,1,0,1
GAB,NLD,2007.0,2,0,2
SEN,DEU,2010.0,1,0,1
ITA,BHR,2003.0,1,0,1
GRC,ISR,2011.0,2,0,2
VEN,PAN,2019.0,3,0,3
OMN,ARE,2005.0,4,0,4
USA,MHL,2006.0,2,0,2
MHL,,2009.0,1,0,1
VNM,COL,2015.0,1,0,1
FRA,GTM,2003.0,2,0,2
SLB,USA,1998.0,1,0,1
URY,AUS,2016.0,3,0,3
DJI,BEL,2016.0,1,0,1
GBR,MDG,2011.0,2,0,2
NZL,IDN,1998.0,1,0,1
MDA,FRA,1997.0,2,0,2
CAF,DZA,2017.0,3,0,3
ETH,COL,2014.0,1,0,1
MCO,MDG,2012.0,2,0,2
CAN,LAO,2002.0,1,0,1
PRI,RUS,2002.0,1,0,1
,MTQ,2008.0,4,0,4
SEN,BEL,2005.0,1,0,1
ITA,NPL,2005.0,1,0,1
JOR,LBN,1997.0,1,0,1
TWN,ESP,2010.0,2,0,2
HUN,AZE,2019.0,1,0,1
CAN,CYP,2004.0,3,0,3
BGR,POL,2017.0,4,0,4
TZA,ZWE,2014.0,2,0,2
FRA,JAM,2011.0,1,0,1
AUS,LBN,2000.0,1,0,1
MMR,LKA,2012.0,1,0,1
BGR,ARG,2012.0,1,0,1
CRI,CUB,2014.0,1,0,1
PSE,SAU,2011.0,2,0,2
FRA,BGD,2017.0,3,0,3
BOL,DNK,2015.0,2,0,2
SVN,ISR,2021.0,1,0,1
ISR,CZE,2018.0,5,0,5
ZWE,COG,2011.0,1,0,1
GUF,BEL,2017.0,2,0,2
IDN,LUX,2023.0,1,0,1
SGP,HUN,2020.0,1,0,1
FRA,BLR,2014.0,2,0,2
PRT,LVA,2014.0,1,0,1
MCO,BEL,2021.0,1,0,1
LBN,FIN,2014.0,1,0,1
THA,ETH,2015.0,2,0,2
DMA,,2017.0,2,0,2
AUS,MDV,2017.0,2,0,2
BEN,COG,2017.0,1,0,1
EGY,ISR,2022.0,1,0,1
BRA,GAB,2019.0,1,0,1
JPN,CIV,2012.0,1,0,1
ESP,VNM,2019.0,3,0,3
HND,CHL,2020.0,1,0,1
DZA,CHE,2000.0,1,0,1
VEN,URY,2018.0,2,0,2
MMR,ITA,2017.0,1,0,1
ZMB,SWE,2022.0,1,0,1
BFA,FIN,2018.0,2,0,2
FIN,BFA,2022.0,1,0,1
IND,CYP,2021.0,4,0,4
SRB,EGY,2017.0,3,0,3
DNK,PRI,2018.0,1,0,1
,LBR,2004.0,3,0,3
NZL,ZMB,2019.0,1,0,1
UKR,CYP,2010.0,2,0,2
KEN,BRA,2019.0,1,0,1
,GNQ,1997.0,2,0,2
GNQ,,2006.0,2,0,2
PAK,SOM,2020.0,1,0,1
AZE,ITA,2022.0,1,0,1
PAK,POL,2019.0,2,0,2
BGD,TWN,2022.0,2,0,2
IND,LBR,2023.0,1,0,1
FRA,UGA,2017.0,1,0,1
NZL,VEN,2006.0,1,0,1
GLP,GUF,2021.0,1,0,1
AUT,ISL,2003.0,1,0,1
PRT,CRI,2019.0,2,0,2
LBN,CYP,2018.0,2,0,2
DNK,URY,2022.0,1,0,1
COL,EST,2023.0,1,0,1
SGP,GHA,2021.0,1,0,1
,BTN,2020.0,24,0,24
JPN,SXM,2022.0,1,0,1
AFG,DEU,2022.0,1,0,1
SDN,LAO,2022.0,1,0,1
USA,CAF,2022.0,1,0,1
BIH,AUT,2022.0,1,0,1
DEU,KAZ,2009.0,1,0,1
KHM,,2008.0,7,0,7
IRN,UZB,2009.0,1,0,1
HND,CHL,2007.0,2,0,2
AUS,VEN,2022.0,1,0,1
GRC,VIR,2019.0,1,0,1
AFG,ITA,2008.0,1,0,1
MCO,GBR,2011.0,1,0,1
GBR,NCL,2014.0,2,0,2
UZB,LKA,2007.0,1,0,1
ISL,SGP,2015.0,2,0,2
NIC,CRI,2014.0,1,0,1
LBR,SLE,2012.0,1,0,1
SAU,SYR,2007.0,1,0,1
BOL,COL,2006.0,2,0,2
MUS,ZAF,2013.0,1,0,1
MEX,NZL,2001.0,1,0,1
BFA,CIV,2003.0,1,0,1
ISR,JOR,2003.0,1,0,1
BDI,MOZ,2020.0,1,0,1
AFG,NPL,2014.0,1,0,1
COD,,2011.0,3,0,3
COL,TWN,2014.0,1,0,1
KOR,ARE,2010.0,2,0,2
NER,GUF,2012.0,1,0,1
CZE,ECU,2019.0,1,0,1
ZAF,IDN,2011.0,1,0,1
KEN,FRA,2008.0,2,0,2
CHE,NGA,2010.0,1,0,1
PAK,KEN,2007.0,3,0,3
MYS,BHR,1997.0,1,0,1
ARE,LUX,2008.0,1,0,1
NAM,NOR,2000.0,2,0,2
TUR,ARM,2018.0,1,0,1
KEN,THA,2020.0,1,0,1
NGA,NZL,2013.0,1,0,1
GNQ,GIN,2012.0,2,0,2
DOM,PER,2017.0,3,0,3
NER,GHA,2019.0,1,0,1
PAK,CYP,2016.0,2,0,2
TCD,COD,2020.0,1,0,1
GEO,UKR,2015.0,2,0,2
CMR,ESP,2018.0,1,0,1
CZE,ROU,2017.0,3,0,3
,BGD,2021.0,21,0,21
MCO,MAR,2019.0,2,0,2
MDA,MEX,2019.0,1,0,1
SDN,FRA,2013.0,4,0,4
BEL,SUR,2019.0,1,0,1
BOL,ITA,2012.0,1,0,1
NGA,POL,2021.0,4,0,4
BRB,PAK,2022.0,1,0,1
SSD,UGA,2020.0,1,0,1
,MDV,2016.0,4,0,4
IRL,ARM,2010.0,1,0,1
USA,SSD,2023.0,3,0,3
LUX,TUR,2008.0,1,0,1
SWE,LAO,1998.0,1,0,1
LAO,,2008.0,7,0,7
ERI,NAM,2013.0,1,0,1
EGY,CYP,2007.0,1,0,1
CYP,EGY,2008.0,1,0,1
SLE,GMB,1997.0,1,0,1
CAN,CYP,2001.0,1,0,1
BEL,COM,2015.0,1,0,1
BEL,PAK,1998.0,1,0,1
GMB,GTM,2007.0,1,0,1
CAN,DOM,2005.0,1,0,1
DEU,GHA,2004.0,2,0,2
BIH,DEU,2005.0,3,0,3
ARG,PRY,2007.0,1,0,1
GBR,MAR,1997.0,1,0,1
LBN,ISR,2018.0,1,0,1
GBR,YEM,2000.0,3,0,3
JOR,EGY,2002.0,3,0,3
JAM,LCA,2013.0,1,0,1
ECU,MYS,2017.0,1,0,1
LBN,DZA,2009.0,1,0,1
DEU,KHM,2006.0,1,0,1
CRI,AUT,2012.0,1,0,1
CZE,DZA,2004.0,1,0,1
VIR,PNG,1998.0,1,0,1
OMN,KWT,1999.0,2,0,2
AUS,QAT,2008.0,1,0,1
TCD,CIV,2015.0,1,0,1
HRV,PAK,1999.0,2,0,2
TGO,ZWE,1999.0,1,0,1
AND,CHE,2008.0,1,0,1
SRB,BEL,2000.0,4,0,4
TUR,VNM,2017.0,2,0,2
BLR,PAK,2022.0,1,0,1
SDN,NGA,2015.0,1,0,1
LBN,DEU,1998.0,1,0,1
BDI,,2005.0,1,0,1
SVK,FIN,2003.0,1,0,1
THA,HUN,2009.0,2,0,2
JPN,OMN,2012.0,1,0,1
NZL,MWI,2002.0,1,0,1
SGP,CZE,2013.0,3,0,3
GAB,AUT,2010.0,1,0,1
SVN,TUR,2009.0,1,0,1
CYP,BEL,2008.0,1,0,1
ITA,PRY,2016.0,1,0,1
SRB,TUR,2016.0,4,0,4
MNE,BIH,2011.0,1,0,1
MEX,LBN,2019.0,1,0,1
CHE,MNE,2010.0,1,0,1
LKA,LAO,2011.0,1,0,1
AUS,UZB,2017.0,1,0,1
NLD,LTU,2017.0,1,0,1
ZMB,COG,2020.0,2,0,2
USA,BTN,2011.0,1,0,1
ITA,BWA,2010.0,1,0,1
POL,CHL,2004.0,2,0,2
ARM,ISR,2016.0,1,0,1
USA,BOL,1999.0,4,0,4
BLR,JOR,2006.0,1,0,1
SYR,LBN,2012.0,3,0,3
IDN,TUR,2015.0,1,0,1
SYR,IDN,2011.0,1,0,1
QAT,AUS,1999.0,1,0,1
FJI,IND,2010.0,2,0,2
TZA,IRL,2021.0,1,0,1
GMB,AUS,2014.0,2,0,2
RWA,BFA,1997.0,1,0,1
BEL,MCO,2014.0,1,0,1
SDN,UGA,2010.0,1,0,1
CRI,DOM,2016.0,1,0,1
GRC,NZL,2019.0,1,0,1
LTU,MLT,2014.0,1,0,1
SGP,KOR,1998.0,1,0,1
KOR,PRT,2007.0,2,0,2
SVK,EGY,2010.0,1,0,1
SWE,ARE,2001.0,2,0,2
ZAF,OMN,2015.0,1,0,1
USA,PRT,2024.0,2,0,2
TUR,SVK,2022.0,3,0,3
ISR,NOR,2016.0,1,0,1
BLR,LTU,2020.0,5,0,5
UGA,JPN,2015.0,2,0,2
CAN,CIV,2022.0,1,0,1
PRI,CHE,2020.0,2,0,2
NZL,MYS,2001.0,2,0,2
SGP,KWT,2008.0,1,0,1
JOR,ESP,2000.0,1,0,1
EGY,SDN,2023.0,4,0,4
OMN,IRQ,2014.0,1,0,1
ZAF,TGO,2020.0,1,0,1
DZA,SWE,2023.0,1,0,1
IND,DMA,2016.0,1,0,1
CAF,GMB,2023.0,1,0,1
USA,BOL,2020.0,9,4,5
MYS,JPN,1997.0,2,3,-1
DEU,VEN,2005.0,4,5,-1
MEX,DNK,2017.0,3,5,-2
NOR,SRB,2020.0,4,3,1
QAT,MYS,2022.0,5,4,1
UKR,SAU,2017.0,2,3,-1
KOR,IRL,2013.0,2,3,-1
ESP,MOZ,2020.0,3,2,1
ECU,ESP,1998.0,2,2,0
JOR,YEM,2021.0,3,2,1
IND,OMN,2024.0,2,1,1
POL,DNK,2023.0,2,3,-1
THA,ARE,2022.0,1,1,0
IRN,LBN,2021.0,2,1,1
QAT,HUN,2022.0,1,1,0
CAN,PRI,2015.0,2,2,0
ALB,DEU,2006.0,1,2,-1
FRA,PRY,2019.0,2,1,1
POL,PRT,2001.0,3,2,1
PRT,POL,2005.0,2,3,-1
AUS,OMN,2003.0,1,2,-1
JPN,MNG,2001.0,2,5,-3
GAB,COG,2022.0,1,3,-2
HKG,SRB,2006.0,2,1,1
EST,SWE,2009.0,4,11,-7
SVN,NLD,1998.0,2,1,1
COL,FRA,2005.0,7,9,-2
NZL,ARG,2011.0,2,2,0
PHL,FRA,2008.0,1,2,-1
PHL,FRA,2015.0,4,2,2
OMN,LKA,2012.0,1,1,0
GHA,NGA,2009.0,2,6,-4
ALB,SRB,2010.0,4,2,2
CAN,BGR,2015.0,3,1,2
GBR,ZMB,2006.0,3,1,2
ITA,TUN,2001.0,2,1,1
SWE,LVA,2010.0,5,2,3
VNM,BEL,2023.0,7,5,2
GHA,JPN,2003.0,3,1,2
TZA,SWE,2003.0,1,1,0
GBR,LTU,2006.0,3,5,-2
POL,ZAF,2008.0,1,4,-3
SWE,SVK,1998.0,1,1,0
CZE,RUS,2013.0,6,8,-2
CHN,GRC,2019.0,3,5,-2
ISL,CAN,2002.0,1,2,-1
BFA,USA,2011.0,3,3,0
IND,AUT,2012.0,6,3,3
NLD,NGA,2001.0,2,1,1
NGA,CAN,2004.0,2,2,0
MYS,MEX,2019.0,2,1,1
SVK,CHE,2007.0,3,7,-4
CHE,SVK,2010.0,1,5,-4
CYP,TUR,2003.0,2,2,0
SWE,COL,2005.0,1,2,-1
BIH,MLT,2021.0,2,1,1
GHA,CMR,2009.0,3,1,2
MAR,CHE,2003.0,1,2,-1
NIC,SWE,2006.0,1,1,0
ARM,CAN,2006.0,1,1,0
GHA,DEU,2003.0,3,7,-4
BEL,SVK,2011.0,1,4,-3
KEN,UGA,2005.0,3,2,1
UGA,ITA,2011.0,1,3,-2
KAZ,USA,2010.0,2,4,-2
NPL,USA,1997.0,2,3,-1
LKA,BEL,2004.0,1,1,0
GAB,FRA,2011.0,6,8,-2
TUR,AUT,2012.0,4,5,-1
SWE,ROU,2017.0,3,10,-7
ISR,SWE,2020.0,6,7,-1
ARE,PAK,2008.0,1,1,0
USA,DMA,2015.0,2,3,-1
NOR,HUN,2012.0,1,6,-5
NPL,CHN,2009.0,1,2,-1
ESP,SLV,2016.0,2,2,0
FRA,ALB,2016.0,2,1,1
DEU,TUN,2011.0,1,1,0
ZWE,FRA,2004.0,2,1,1
DNK,IDN,2014.0,2,1,1
ARG,SWE,2013.0,5,4,1
CYP,SAU,2021.0,1,1,0
NLD,LKA,2003.0,1,2,-1
CAN,MLI,2018.0,2,2,0
GRC,RUS,2012.0,2,2,0
CHN,ZAF,2005.0,3,3,0
MAR,DEU,2005.0,3,3,0
AUT,SAU,2015.0,1,1,0
DMA,USA,2012.0,1,3,-2
UGA,FRA,2001.0,1,1,0
CAN,NPL,2012.0,1,2,-1
SGP,IRN,2013.0,4,19,-15
BGR,POL,2016.0,2,1,1
SWE,ROU,2022.0,2,2,0
LAO,AUS,2015.0,1,5,-4
CAN,CRI,2013.0,3,1,2
GHA,KEN,2021.0,2,11,-9
MWI,CHE,2019.0,2,1,1
CUB,ITA,2014.0,3,3,0
TUR,HKG,2018.0,1,1,0
TUR,VNM,2022.0,3,1,2
SDN,ZAF,2022.0,1,1,0
BOL,ESP,2020.0,4,2,2
SAU,SGP,2013.0,1,4,-3
ISR,GRC,2020.0,1,2,-1
THA,PAK,2009.0,1,1,0
PRT,MAC,2017.0,2,1,1
PAK,MYS,2006.0,4,3,1
NGA,GMB,2009.0,1,1,0
UGA,CHE,2016.0,2,2,0
IRL,FRA,1997.0,5,10,-5
IRN,NZL,2006.0,1,4,-3
ARE,SGP,2015.0,1,7,-6
MKD,PRT,2020.0,1,1,0
SVK,SVN,1999.0,5,2,3
PAK,ISR,2015.0,1,1,0
SYR,FRA,2017.0,6,5,1
CIV,GBR,2019.0,2,4,-2
SWE,PAK,2019.0,7,6,1
YEM,MYS,2015.0,3,10,-7
HKG,NLD,2017.0,9,11,-2
TZA,NOR,1999.0,2,3,-1
IDN,DNK,2018.0,1,1,0
KEN,CHN,2017.0,5,15,-10
FIN,ISR,1998.0,1,1,0
PNG,USA,2018.0,2,2,0
ROU,BGR,2019.0,1,4,-3
HRV,NOR,2021.0,1,2,-1
COL,SWE,2023.0,1,1,0
BGR,HUN,2018.0,1,2,-1
CAN,UGA,2019.0,2,3,-1
ISL,GBR,2018.0,6,8,-2
CHE,MYS,2018.0,2,7,-5
RUS,SGP,2016.0,4,2,2
FRA,CUB,2018.0,1,4,-3
MYS,UGA,2017.0,3,1,2
FRA,MLT,2017.0,1,1,0
KOR,ZWE,2017.0,3,2,1
MEX,PER,2003.0,2,1,1
LVA,EST,2012.0,2,1,1
MKD,USA,2016.0,3,1,2
MAR,MAC,2017.0,2,12,-10
BGD,FRA,2018.0,2,1,1
DZA,ARE,2023.0,4,1,3
DEU,CUB,2014.0,1,6,-5
AUS,MDV,2018.0,1,2,-1
NGA,POL,2019.0,1,1,0
NPL,ITA,2020.0,2,3,-1
ITA,NGA,2018.0,3,1,2
CIV,MLI,2010.0,3,4,-1
JOR,OMN,2023.0,1,2,-1
MAC,JPN,2016.0,1,1,0
NZL,IND,2020.0,11,27,-16
TLS,AUS,2014.0,1,2,-1
SLB,USA,2020.0,1,1,0
VNM,NLD,2020.0,8,19,-11
CHN,AFG,2020.0,3,1,2
BEL,SVN,2022.0,2,3,-1
FIN,ISR,2020.0,5,5,0
ITA,UKR,2013.0,1,6,-5
MYS,TWN,2013.0,2,7,-5
IRL,PRT,1999.0,1,2,-1
IRL,OMN,2022.0,2,1,1
DEU,GAB,2014.0,4,5,-1
PRT,IDN,2022.0,2,2,0
TUN,BEL,2021.0,2,9,-7
ESP,HUN,2022.0,3,4,-1
ZAF,AFG,2020.0,1,1,0
HKG,USA,2024.0,1,1,0
DEU,MKD,2022.0,3,2,1
BGD,GRC,2008.0,1,1,0
PHL,THA,2016.0,3,3,0
AGO,PRT,2017.0,4,4,0
DNK,GNB,2002.0,3,5,-2
NPL,JPN,2022.0,6,16,-10
MCO,DEU,2022.0,2,1,1
IND,BRN,2009.0,2,2,0
GBR,VNM,1998.0,2,1,1
ESP,IND,2007.0,4,10,-6
CAN,PSE,2016.0,2,2,0
BRA,DEU,1997.0,14,30,-16
FIN,DNK,2007.0,7,8,-1
CUB,ITA,2004.0,2,3,-1
PRT,IRL,2011.0,2,5,-3
VEN,PER,2023.0,5,1,4
CYP,JPN,2002.0,1,1,0
BRA,NZL,2005.0,2,1,1
IND,MUS,2021.0,3,1,2
PER,CAN,2002.0,3,1,2
PER,COL,2007.0,2,1,1
HUN,ISR,2006.0,1,1,0
GBR,MAR,2002.0,1,2,-1
KOR,ITA,1997.0,1,1,0
ESP,HUN,2016.0,6,1,5
BRA,CHN,2009.0,2,2,0
COL,CHE,2001.0,1,4,-3
MDA,RUS,2002.0,3,3,0
NLD,BGD,2023.0,1,1,0
MKD,DEU,2023.0,1,1,0
SVN,IND,2014.0,2,3,-1
CIV,BFA,2012.0,2,1,1
BFA,CIV,2013.0,2,4,-2
MAR,BEL,2015.0,1,3,-2
AUT,ROU,2000.0,1,3,-2
PAK,CHE,2018.0,5,4,1
THA,PHL,2017.0,1,7,-6
LBN,BEL,2013.0,3,3,0
ESP,MYS,2013.0,2,5,-3
KWT,ARE,2017.0,3,2,1
UGA,SWE,2018.0,3,2,1
PHL,MAC,2016.0,1,1,0
FRA,HKG,2022.0,6,11,-5
CHE,DZA,2013.0,2,1,1
MLT,USA,2023.0,3,1,2
ESP,NIC,2018.0,4,1,3
CZE,KAZ,2019.0,1,3,-2
JPN,ISR,2018.0,4,6,-2
CHN,ZWE,2016.0,1,2,-1
IND,THA,2004.0,3,4,-1
SWE,KOR,2014.0,8,10,-2
IRL,MLT,2021.0,1,1,0
AUS,BWA,2012.0,1,2,-1
SRB,DNK,2020.0,2,2,0
IDN,CAN,2016.0,3,10,-7
NER,BEN,2021.0,1,1,0
IRN,CHL,2015.0,1,1,0
ALB,TUR,2013.0,1,3,-2
PSE,CAN,2016.0,2,2,0
SWE,BGD,2019.0,2,10,-8
PER,DEU,2003.0,1,2,-1
DNK,PRT,2023.0,4,2,2
GBR,MMR,2019.0,1,3,-2
MEX,KOR,2023.0,1,2,-1
CMR,BEL,2015.0,2,9,-7
COL,URY,2022.0,2,2,0
DNK,UGA,2018.0,4,1,3
CMR,CAN,2014.0,2,2,0
FJI,TON,2020.0,1,2,-1
ARE,BRA,2014.0,1,1,0
ROU,AUS,2001.0,3,2,1
CAN,BRB,2011.0,3,1,2
RUS,HUN,2015.0,1,1,0
MYS,NLD,2011.0,4,9,-5
TTO,GBR,2012.0,4,9,-5
CHN,KEN,2008.0,2,1,1
BEL,PER,2011.0,3,1,2
HRV,QAT,2020.0,1,1,0
KWT,USA,2011.0,5,15,-10
TUN,OMN,2019.0,5,1,4
NPL,SAU,2021.0,1,1,0
NPL,AUS,2008.0,1,2,-1
NOR,ESP,2005.0,6,6,0
CZE,DNK,2008.0,3,4,-1
FRA,NGA,2004.0,2,1,1
JPN,TZA,2009.0,3,2,1
SAU,SYR,2020.0,2,1,1
JPN,UZB,2009.0,2,7,-5
ZAF,PRT,2020.0,5,3,2
ECU,CZE,2022.0,3,1,2
CZE,HRV,2014.0,2,1,1
FIN,LBY,2011.0,1,1,0
TWN,AUS,2004.0,7,9,-2
GBR,KHM,2007.0,1,2,-1
CAN,MYS,1999.0,2,3,-1
ARG,IRL,2005.0,1,1,0
BLR,CZE,2013.0,2,1,1
LBN,EGY,2008.0,3,3,0
IND,TUR,2004.0,3,1,2
AUT,TUR,2009.0,4,3,1
IRL,HRV,2020.0,1,2,-1
PAK,FRA,2021.0,10,20,-10
KEN,AUS,2022.0,2,4,-2
CHE,LIE,2018.0,4,3,1
JOR,LBN,2012.0,1,1,0
CHE,MWI,2021.0,5,2,3
CZE,LVA,2017.0,1,1,0
KOR,COL,2019.0,1,1,0
ZAF,CHL,2018.0,1,4,-3
JPN,QAT,2019.0,2,1,1
CHE,TUN,2021.0,1,1,0
TWN,DNK,2020.0,1,4,-3
ARG,BEL,2019.0,7,4,3
ESP,PHL,2018.0,1,4,-3
COL,GTM,2011.0,1,1,0
MLT,NLD,2019.0,1,2,-1
URY,ISR,2018.0,1,1,0
HKG,ESP,2019.0,5,2,3
DEU,KAZ,2019.0,3,4,-1
MEX,POL,2020.0,3,2,1
GEO,TUR,2019.0,1,1,0
NER,BEL,2014.0,1,3,-2
BEL,NER,2021.0,1,1,0
POL,KAZ,2020.0,2,2,0
CMR,CHE,2018.0,1,1,0
CHE,CUB,2019.0,1,5,-4
FRA,TGO,2017.0,7,1,6
AUT,MYS,2020.0,1,3,-2
LSO,ZWE,2015.0,2,1,1
AFG,IRN,2020.0,2,3,-1
PSE,FRA,2020.0,1,3,-2
ISL,NLD,2001.0,1,2,-1
PNG,USA,2017.0,2,2,0
PAK,NOR,2019.0,2,4,-2
EST,RUS,2022.0,1,11,-10
AUS,TZA,2022.0,2,3,-1
CUB,VEN,2009.0,1,2,-1
MAC,AUS,2022.0,4,7,-3
CYP,AUT,2010.0,1,1,0
JPN,UKR,2021.0,1,2,-1
LBR,IND,2021.0,1,3,-2
ITA,CMR,2022.0,2,1,1
NGA,SDN,2021.0,1,2,-1
ARM,CZE,2011.0,1,1,0
EGY,LTU,2020.0,1,1,0
HKG,LKA,2020.0,2,3,-1
ETH,IRN,2023.0,1,1,0
CHN,SWE,2024.0,3,1,2
SWE,TUN,2019.0,1,1,0
USA,LAO,2016.0,2,3,-1
LVA,SWE,2001.0,3,3,0
TWN,POL,2002.0,1,2,-1
ECU,AUS,2015.0,2,1,1
CZE,IRL,2005.0,1,1,0
ISL,NZL,2014.0,1,1,0
MWI,UGA,2014.0,1,1,0
IND,PRT,2002.0,2,2,0
CYP,SAU,2019.0,1,1,0
DNK,HRV,2021.0,2,3,-1
MNE,SRB,2004.0,7,7,0
GBR,ISL,2009.0,3,4,-1
KWT,BHR,2016.0,1,1,0
ZAF,DNK,2013.0,3,7,-4
CZE,AUS,2003.0,3,5,-2
GBR,MAR,2005.0,2,3,-1
KEN,CMR,2021.0,1,3,-2
DNK,TZA,1999.0,1,3,-2
PAK,CHE,2022.0,7,3,4
BEL,EGY,2006.0,3,2,1
CMR,USA,1997.0,2,1,1
UGA,TZA,2019.0,4,8,-4
POL,HUN,2003.0,6,2,4
JPN,BLR,2000.0,2,1,1
NOR,FIN,2009.0,3,16,-13
NLD,KOR,2000.0,1,3,-2
PAN,COL,2006.0,1,1,0
ARG,DNK,2017.0,2,4,-2
IRL,MEX,2012.0,1,1,0
UZB,GBR,2020.0,1,1,0
DEU,BIH,2009.0,1,1,0
ARM,CZE,2021.0,1,1,0
CZE,ROU,2016.0,2,1,1
MEX,CHN,2009.0,1,3,-2
DNK,MEX,2015.0,5,5,0
FRA,CRI,2018.0,8,2,6
CMR,JPN,2010.0,2,2,0
NLD,AUT,2004.0,7,6,1
AUT,PER,2007.0,1,1,0
NOR,ETH,2023.0,4,6,-2
DEU,LVA,2023.0,1,2,-1
BHR,GBR,2010.0,3,2,1
CIV,GBR,2009.0,2,1,1
SGP,GRC,2012.0,1,2,-1
CHE,PRT,1998.0,3,3,0
CMR,KEN,2013.0,2,2,0
HUN,NZL,2007.0,2,1,1
AUS,COL,2013.0,3,9,-6
IDN,TWN,2010.0,2,4,-2
CZE,UZB,2010.0,1,1,0
BRA,IRN,2013.0,2,2,0
EGY,ESP,2008.0,2,8,-6
GBR,BLR,2009.0,1,1,0
ARE,HKG,2009.0,1,1,0
LUX,SGP,2018.0,1,1,0
POL,SGP,2015.0,1,4,-3
ITA,IRQ,2019.0,4,2,2
DZA,NGA,2009.0,2,1,1
BEL,IRN,2007.0,2,3,-1
CZE,SGP,2017.0,2,1,1
EST,AUS,2014.0,2,2,0
DNK,PAK,2013.0,1,2,-1
TZA,ZAF,2015.0,3,8,-5
QAT,SAU,2014.0,2,7,-5
OMN,IND,1999.0,3,2,1
CHN,THA,2000.0,3,1,2
CAN,VEN,1997.0,1,1,0
GBR,ALB,2020.0,3,1,2
ITA,KOR,2008.0,1,5,-4
JPN,SDN,2011.0,1,1,0
UGA,ZAF,2013.0,2,6,-4
RWA,NGA,2022.0,2,2,0
JOR,AUS,2023.0,1,9,-8
IND,EGY,2008.0,3,2,1
YEM,IND,2023.0,10,5,5
FIN,CZE,2013.0,2,2,0
USA,IRQ,2012.0,4,14,-10
CHL,CUB,2008.0,4,5,-1
BIH,DEU,2002.0,1,4,-3
BGD,DEU,2009.0,4,4,0
BGR,PRT,2000.0,1,1,0
CZE,ARM,1998.0,1,1,0
IRL,CZE,2009.0,3,4,-1
ZAF,ISR,2005.0,2,2,0
BWA,GBR,2016.0,1,9,-8
CHE,SRB,1998.0,1,2,-1
ZAF,DNK,2003.0,3,2,1
SRB,NOR,2005.0,1,2,-1
GRC,NOR,2005.0,2,3,-1
NGA,OMN,2002.0,1,1,0
USA,ARM,2004.0,4,3,1
CAN,JAM,2010.0,1,4,-3
CHL,DEU,2000.0,3,21,-18
IDN,AUT,2010.0,1,3,-2
BEL,CMR,1999.0,1,1,0
CMR,BEL,2001.0,3,2,1
MEX,NLD,2003.0,3,5,-2
DEU,MDA,2000.0,1,7,-6
AUT,UKR,2003.0,1,6,-5
DNK,JPN,2003.0,5,14,-9
CHL,MYS,2004.0,1,1,0
NPL,CAN,1999.0,1,1,0
PSE,ISR,1997.0,1,1,0
COL,PRI,2007.0,2,2,0
COL,CAN,2008.0,12,12,0
JPN,ISR,2017.0,5,10,-5
IRL,HUN,2007.0,1,1,0
CHL,MEX,1999.0,5,4,1
FRA,AFG,2015.0,1,2,-1
NLD,IND,2002.0,9,15,-6
CIV,CAN,1998.0,1,1,0
IND,COL,2018.0,2,1,1
DNK,BRA,1999.0,4,1,3
JPN,ZAF,2017.0,3,6,-3
ZAF,SWE,2005.0,5,3,2
USA,UZB,2012.0,3,3,0
GBR,PHL,2002.0,3,5,-2
ZAF,IND,1997.0,1,3,-2
EST,SWE,2019.0,8,10,-2
BGR,CHE,2023.0,2,3,-1
MLI,FRA,2020.0,8,8,0
CIV,DEU,2021.0,2,4,-2
SLE,USA,2011.0,2,3,-1
NZL,MYS,2008.0,5,4,1
PHL,DEU,2012.0,8,4,4
NZL,IND,2007.0,2,4,-2
IRL,EGY,2018.0,4,4,0
ARE,SGP,2014.0,1,5,-4
SGP,FIN,2009.0,3,2,1
USA,ALB,2015.0,4,1,3
CAF,FRA,2023.0,2,1,1
BRN,MYS,2013.0,3,5,-2
AUS,QAT,2015.0,7,3,4
FIN,IRL,2014.0,5,4,1
HUN,EGY,2015.0,1,3,-2
GBR,MMR,2011.0,1,1,0
LVA,RUS,2019.0,3,4,-1
MNE,SRB,2014.0,3,13,-10
NGA,RWA,2021.0,5,1,4
MAR,MAC,2018.0,4,7,-3
CHL,ECU,2013.0,1,1,0
ECU,BRA,2014.0,2,5,-3
SRB,ITA,1998.0,3,4,-1
MWI,TZA,2016.0,1,1,0
BEL,UZB,2014.0,1,1,0
IRQ,BHR,2016.0,2,2,0
NCL,USA,2020.0,4,1,3
GRC,IND,2018.0,2,3,-1
BGD,BEL,2016.0,1,3,-2
EGY,CZE,2014.0,3,5,-2
SYR,JOR,2017.0,3,1,2
UKR,ISR,2012.0,4,1,3
HUN,POL,2012.0,3,2,1
JPN,UZB,2021.0,1,1,0
COL,IND,2013.0,1,2,-1
ETH,KEN,2010.0,3,4,-1
ESP,SEN,2017.0,1,7,-6
ROU,CAN,2017.0,2,4,-2
SVN,VNM,2012.0,1,1,0
ESP,TZA,2002.0,1,1,0
HKG,RUS,1999.0,1,3,-2
ALB,MKD,2009.0,1,1,0
CRI,ESP,2012.0,3,10,-7
NLD,MLI,2011.0,2,1,1
NLD,ISR,2023.0,10,11,-1
IRL,ZAF,2007.0,1,5,-4
TUR,CYP,1999.0,2,5,-3
LAO,KOR,2019.0,1,1,0
MEX,EGY,2020.0,2,2,0
ETH,CZE,2019.0,1,1,0
MAR,ITA,2023.0,4,4,0
POL,ISR,2022.0,5,5,0
KEN,CAN,2005.0,4,2,2
CZE,EST,2022.0,4,2,2
VAT,ITA,2018.0,1,2,-1
ARM,IRN,2016.0,4,1,3
TUR,KAZ,2015.0,4,4,0
BGR,TUR,2017.0,1,3,-2
LUX,ITA,2016.0,3,16,-13
BEL,SEN,1999.0,2,1,1
PAN,DEU,2017.0,2,2,0
NOR,CZE,2020.0,5,7,-2
URY,ISR,2016.0,1,1,0
UKR,LTU,2017.0,3,1,2
HUN,PRT,2015.0,1,1,0
FRA,HTI,2023.0,3,1,2
CHL,JPN,2009.0,1,3,-2
BEN,CHE,2023.0,1,1,0
BEL,LKA,2020.0,1,1,0
ETH,CAN,2023.0,3,4,-1
PHL,BGD,2023.0,1,1,0
COG,SEN,2021.0,2,2,0
DEU,JOR,2000.0,4,5,-1
DEU,MDA,2023.0,3,1,2
OMN,DEU,2020.0,2,2,0
BRN,PAK,2013.0,1,2,-1
ZAF,RUS,2005.0,2,2,0
JAM,CAN,2020.0,5,3,2
KOR,UKR,2015.0,1,2,-1
ERI,IND,2013.0,2,1,1
SEN,MRT,2008.0,1,1,0
NLD,SVK,2006.0,2,4,-2
SVK,NLD,2018.0,1,2,-1
RUS,ROU,2009.0,2,3,-1
CHE,SVK,2000.0,2,2,0
HKG,CHE,2008.0,4,6,-2
VEN,CAN,2016.0,2,3,-1
PHL,ESP,2005.0,5,1,4
SWE,SGP,2006.0,5,2,3
PAK,KWT,2005.0,2,1,1
PAK,BGD,2011.0,8,8,0
DNK,SRB,2010.0,1,3,-2
ZWE,USA,2010.0,12,6,6
AUS,ARG,2003.0,3,9,-6
DEU,PAN,2019.0,1,1,0
SRB,ESP,2013.0,2,3,-1
LKA,AUS,2013.0,7,18,-11
MAR,TUN,2013.0,2,3,-1
NZL,THA,2016.0,2,5,-3
BLR,CHN,2012.0,1,5,-4
CHN,BLR,2013.0,1,4,-3
BTN,AUS,2013.0,1,4,-3
GBR,LBN,2014.0,11,6,5
COL,JPN,2020.0,6,1,5
NZL,COL,2013.0,1,1,0
ITA,TUN,2014.0,3,4,-1
RWA,COG,2015.0,1,1,0
ROU,LTU,2020.0,1,2,-1
DEU,SDN,2020.0,2,5,-3
MOZ,GBR,2022.0,2,1,1
IRN,HKG,2017.0,4,3,1
FRA,PAN,2014.0,2,1,1
CAN,ECU,2006.0,2,4,-2
FJI,USA,2010.0,1,5,-4
KEN,COL,2021.0,1,2,-1
USA,CIV,2014.0,2,3,-1
DEU,LBN,2011.0,3,1,2
KWT,IND,2015.0,3,9,-6
BGR,POL,2018.0,1,1,0
NZL,ZAF,1998.0,3,9,-6
SWE,SRB,2002.0,1,5,-4
IND,MUS,2009.0,2,1,1
ZMB,USA,2004.0,3,4,-1
FIN,ROU,2006.0,1,1,0
USA,SYR,2020.0,2,3,-1
PRT,ISR,2010.0,2,2,0
TTO,GBR,2005.0,1,4,-3
CHE,PAK,2004.0,4,1,3
NOR,MEX,2001.0,1,1,0
ITA,SVN,2003.0,3,2,1
FJI,WSM,2021.0,1,1,0
RUS,SRB,2014.0,3,5,-2
CHN,IND,2001.0,2,5,-3
NLD,THA,2001.0,2,3,-1
FRA,DJI,2010.0,4,4,0
CAN,SRB,2000.0,3,6,-3
SGP,BGD,2015.0,2,2,0
MEX,NZL,2015.0,2,1,1
CAN,UKR,2002.0,1,8,-7
EGY,RUS,2004.0,1,3,-2
NER,NGA,2003.0,4,1,3
DNK,CZE,2004.0,4,3,1
DEU,ARM,2005.0,3,5,-2
ZAF,POL,1999.0,2,2,0
HUN,AZE,2021.0,1,3,-2
GAB,CMR,2016.0,2,1,1
GBR,QAT,2003.0,2,1,1
USA,MNG,2007.0,2,2,0
TZA,AUS,2007.0,1,1,0
CZE,CHN,1999.0,2,1,1
UGA,TZA,2011.0,1,1,0
BLR,CAN,2003.0,1,2,-1
PHL,JPN,1999.0,4,11,-7
PAN,MEX,2020.0,1,1,0
MNE,SRB,2008.0,5,16,-11
ZWE,BEL,2011.0,1,2,-1
ZAF,CIV,2014.0,4,12,-8
KEN,PAK,2015.0,1,2,-1
CIV,ZAF,2008.0,3,2,1
AUT,ARG,2000.0,1,2,-1
ISR,GRC,1998.0,1,1,0
CMR,USA,2002.0,2,11,-9
CYP,CAN,2008.0,1,3,-2
FRA,NER,2000.0,2,2,0
PNG,GBR,2000.0,1,3,-2
USA,BLZ,2012.0,3,3,0
HUN,DNK,2000.0,3,5,-2
IND,SAU,2003.0,6,3,3
KOR,SGP,1997.0,1,2,-1
AUS,GMB,2017.0,1,1,0
GHA,SWE,2005.0,2,1,1
CAN,KEN,2000.0,3,3,0
CHN,MEX,2001.0,4,5,-1
CUB,GBR,2009.0,3,2,1
NZL,CHN,2001.0,1,2,-1
DEU,CUB,2008.0,4,2,2
CHN,ARG,2000.0,1,1,0
PRT,AUS,2000.0,1,2,-1
SVK,SLV,2007.0,5,1,4
CRI,NIC,2012.0,1,3,-2
SLV,BRA,2007.0,2,2,0
CHN,SYR,2023.0,2,1,1
MEX,PAN,2010.0,2,3,-1
FIN,ROU,2000.0,2,1,1
TWN,PHL,2008.0,2,1,1
USA,ETH,2002.0,2,4,-2
IRN,AUT,2008.0,5,1,4
BHR,IRL,2014.0,1,2,-1
CHE,UGA,2008.0,2,1,1
BEL,DZA,2011.0,3,2,1
BRA,CZE,2017.0,2,4,-2
CAN,TUN,2009.0,8,8,0
GBR,GIB,2007.0,1,1,0
ECU,BEL,2005.0,2,4,-2
FRA,PAN,2015.0,2,1,1
GEO,CZE,2011.0,1,2,-1
SAU,SRB,2017.0,1,2,-1
FIN,HKG,2012.0,1,2,-1
MYS,BRA,2014.0,2,2,0
LUX,PRT,2012.0,1,1,0
CHN,ARE,2014.0,2,2,0
CHE,PNG,2010.0,2,1,1
DEU,OMN,2014.0,4,1,3
BRA,CUB,2022.0,2,3,-1
GBR,ECU,2012.0,2,1,1
JAM,JPN,2015.0,2,2,0
GRD,IND,2013.0,1,1,0
IRL,ROU,2005.0,1,1,0
RUS,MKD,2018.0,1,1,0
IND,PHL,2021.0,5,5,0
KOR,ISR,2017.0,2,3,-1
ITA,ISL,2016.0,3,1,2
MWI,ETH,2017.0,2,1,1
BEL,NOR,2012.0,4,3,1
MWI,CAN,2017.0,2,3,-1
CUB,PRT,2002.0,2,1,1
GRC,ISR,2019.0,2,1,1
ZAF,ARE,2004.0,1,1,0
BEL,CUB,2012.0,4,4,0
USA,BFA,2015.0,2,2,0
LTU,ITA,2023.0,4,4,0
KGZ,USA,2012.0,2,2,0
SLV,USA,2023.0,1,2,-1
NOR,GRC,2016.0,3,11,-8
NGA,SWE,2021.0,2,2,0
BHR,MYS,2018.0,2,6,-4
MAC,PRT,2022.0,2,2,0
NOR,HUN,2002.0,6,2,4
DZA,MYS,2017.0,1,3,-2
MLI,CAN,2016.0,1,6,-5
SVK,RUS,2014.0,3,3,0
GBR,KHM,2020.0,4,6,-2
KHM,USA,2023.0,1,6,-5
AUS,SLB,2015.0,5,1,4
BEL,FIN,2002.0,4,4,0
JPN,MEX,1997.0,4,2,2
DNK,MEX,2008.0,1,2,-1
ARE,IRN,2015.0,3,3,0
ROU,FIN,2021.0,3,2,1
LKA,DNK,2016.0,1,2,-1
DEU,MKD,2018.0,1,3,-2
DNK,ZAF,2019.0,2,5,-3
SGP,ZAF,2019.0,8,2,6
MEX,JPN,2023.0,4,2,2
VEN,MEX,2007.0,4,10,-6
VEN,AUS,2001.0,2,1,1
DMA,DOM,2015.0,4,5,-1
SVK,CHE,2020.0,2,4,-2
KAZ,AUS,2015.0,2,3,-1
ARG,PRY,2020.0,3,3,0
NPL,AUT,2015.0,1,1,0
ARE,NLD,2007.0,1,2,-1
BRA,TUN,2022.0,1,1,0
IND,UZB,2023.0,1,2,-1
UGA,CAN,2019.0,3,2,1
CHN,ISL,2020.0,2,1,1
NLD,JOR,2005.0,1,1,0
SVN,ESP,2022.0,3,3,0
GBR,MAC,2021.0,3,4,-1
BEL,LTU,2020.0,2,3,-1
DEU,KGZ,2017.0,2,1,1
ZMB,JPN,2018.0,2,3,-1
THA,ARE,2018.0,1,1,0
FRA,CRI,2022.0,1,2,-1
BRA,GHA,2015.0,1,1,0
COL,ARM,2020.0,2,2,0
FIN,NZL,2016.0,1,3,-2
URY,FRA,2019.0,2,4,-2
LKA,SGP,2021.0,1,1,0
PRT,CHL,2021.0,2,8,-6
CHL,SWE,2022.0,4,1,3
LBY,ARE,2020.0,2,2,0
OMN,JOR,2020.0,4,3,1
ITA,SDN,2020.0,1,1,0
BFA,AUT,2022.0,1,3,-2
ITA,CYP,2003.0,2,1,1
PAK,KWT,2002.0,1,2,-1
LTU,FIN,2015.0,1,1,0
CHL,ZAF,2020.0,2,1,1
CAN,BGD,1999.0,1,1,0
USA,GIN,2021.0,1,2,-1
BLR,FRA,2023.0,1,1,0
BEN,CHN,2023.0,1,3,-2
SAU,KWT,2006.0,2,1,1
FRA,LTU,1997.0,1,2,-1
DEU,SDN,1999.0,2,1,1
FRA,SGP,2004.0,6,10,-4
CRI,ESP,2005.0,2,2,0
SRB,ESP,2003.0,3,8,-5
ISR,BEL,2000.0,3,4,-1
GBR,BRB,1997.0,2,2,0
NOR,RUS,1999.0,4,8,-4
CHE,LVA,2002.0,2,1,1
IND,NZL,2005.0,5,2,3
HRV,SWE,2000.0,2,1,1
NOR,IRN,2007.0,3,1,2
NLD,MEX,1998.0,3,4,-1
ETH,FRA,2012.0,1,3,-2
JOR,OMN,2010.0,4,2,2
VEN,ITA,2007.0,1,2,-1
UKR,MEX,1999.0,4,2,2
ARM,ITA,1999.0,2,1,1
DEU,KWT,2002.0,1,1,0
FIN,ISR,2007.0,1,1,0
GRC,ITA,2005.0,10,11,-1
KWT,NGA,1997.0,1,1,0
KWT,NGA,2002.0,2,2,0
ZWE,RWA,2015.0,1,1,0
CHL,KOR,2012.0,1,2,-1
TUN,SAU,2003.0,2,1,1
RUS,BRA,2007.0,2,8,-6
JPN,ZAF,2016.0,3,6,-3
RUS,SVK,2023.0,1,1,0
CZE,ITA,1997.0,3,8,-5
AUT,ARE,2017.0,2,1,1
TWN,ARM,2009.0,1,1,0
VEN,ARG,2003.0,1,1,0
EST,ESP,2015.0,3,1,2
CHL,ARE,2018.0,2,1,1
HRV,AUS,2013.0,1,2,-1
KAZ,MYS,2015.0,2,4,-2
MNG,DEU,2011.0,1,1,0
CHL,CRI,2022.0,2,1,1
ARG,BEL,2009.0,2,1,1
BOL,DNK,2008.0,1,2,-1
CHL,JPN,2011.0,2,2,0
ITA,KWT,2021.0,1,1,0
PAK,BEL,2012.0,1,1,0
AUS,KHM,2008.0,1,2,-1
PHL,TWN,2010.0,3,2,1
USA,MCO,2022.0,2,1,1
MYS,PRT,2013.0,2,2,0
AUS,BTN,2015.0,2,7,-5
ITA,VEN,2010.0,2,4,-2
NOR,GRC,2022.0,2,4,-2
UKR,MEX,2007.0,2,1,1
THA,IND,1998.0,1,3,-2
BWA,CAN,2016.0,2,1,1
HRV,IRL,2014.0,2,1,1
ZAF,KOR,2013.0,1,2,-1
TWN,HRV,2011.0,2,1,1
USA,SLE,2022.0,1,3,-2
MWI,CAN,2016.0,1,3,-2
ARE,POL,2023.0,1,1,0
MDV,MDA,2015.0,2,1,1
KEN,BEN,2021.0,1,1,0
CMR,CAF,2019.0,1,1,0
RWA,UGA,2016.0,1,3,-2
ETH,KEN,2023.0,4,4,0
LKA,KOR,2023.0,2,3,-1
MAR,CMR,2016.0,2,2,0
NOR,HRV,2022.0,1,2,-1
NAM,CHN,2022.0,1,2,-1
CZE,SRB,2019.0,2,4,-2
NGA,BEL,2017.0,2,2,0
UKR,LTU,2018.0,1,2,-1
PER,ECU,2017.0,3,2,1
CHE,LUX,2008.0,2,1,1
BGD,FIN,2022.0,1,3,-2
AUS,PRT,2009.0,1,4,-3
BVT,BRA,2019.0,2,1,1
LUX,CHE,2023.0,4,2,2
CZE,NOR,2019.0,2,6,-4
LUX,SGP,2022.0,1,4,-3
ESP,LBN,2022.0,1,4,-3
IRQ,ROU,2021.0,3,6,-3
ZMB,NLD,2023.0,1,1,0
GEO,DEU,2019.0,5,4,1
BGD,SGP,2018.0,2,6,-4
ETH,VNM,2023.0,1,1,0
GBR,LTU,2023.0,5,2,3
CRI,ARG,2023.0,1,2,-1
KWT,SAU,2023.0,4,2,2
BHR,AUS,2022.0,1,1,0
YEM,PAK,2023.0,1,1,0
MEX,CRI,2023.0,1,1,0
BEL,PER,2021.0,2,2,0
JPN,NGA,2022.0,3,6,-3
BEL,EGY,2023.0,2,6,-4
HUN,UKR,2017.0,1,3,-2
SAU,ZAF,2023.0,3,1,2
GBR,SWZ,2014.0,1,1,0
GBR,LTU,2010.0,3,4,-1
FIN,LUX,2023.0,2,2,0
ECU,PER,2012.0,1,2,-1
PAN,ESP,2009.0,2,2,0
LTU,FIN,2008.0,2,2,0
KOR,ZAF,2010.0,1,4,-3
NLD,SRB,2011.0,2,4,-2
LAO,JPN,2023.0,1,1,0
ISR,FIN,2007.0,1,1,0
CRI,ARG,2010.0,2,1,1
ISR,CZE,2017.0,2,2,0
IND,NZL,2002.0,5,2,3
CYP,FRA,2014.0,2,5,-3
NOR,ZMB,2008.0,2,1,1
CHL,PRT,2013.0,2,4,-2
NIC,SWE,2010.0,1,2,-1
BRB,TTO,2016.0,1,2,-1
SAU,LBN,2010.0,2,3,-1
JAM,GBR,2010.0,3,1,2
MAR,MCO,2020.0,1,1,0
LBN,ESP,2021.0,5,4,1
JPN,COL,2004.0,3,2,1
QAT,IRN,2013.0,1,3,-2
AZE,UKR,2021.0,1,1,0
BFA,TGO,2020.0,2,1,1
MDV,AUS,2021.0,1,2,-1
TWN,GRC,2022.0,1,2,-1
NOR,NPL,2020.0,5,3,2
DNK,SGP,2005.0,2,2,0
AUS,SAU,2002.0,4,4,0
PRT,POL,2002.0,1,7,-6
POL,PRT,2004.0,2,1,1
SVN,CZE,2007.0,1,5,-4
MEX,MYS,2016.0,1,1,0
AUT,NZL,2003.0,1,2,-1
UKR,ZAF,1999.0,1,1,0
CYP,AUS,2020.0,1,3,-2
ESP,UKR,2008.0,1,6,-5
KWT,IND,2008.0,3,6,-3
FIN,ARG,2001.0,2,1,1
IND,TUR,2001.0,1,4,-3
PER,MEX,2006.0,1,3,-2
IRN,NLD,2003.0,2,5,-3
SAU,QAT,2001.0,2,1,1
GRC,ROU,2001.0,2,2,0
CRI,FRA,2014.0,1,6,-5
NLD,VNM,2012.0,2,5,-3
USA,CUB,1997.0,2,5,-3
MEX,DNK,2016.0,3,4,-1
CRI,AUS,2014.0,1,1,0
NOR,EGY,2015.0,2,1,1
BOL,GBR,2010.0,2,1,1
ARG,CUB,2017.0,7,3,4
CHE,MOZ,2014.0,1,1,0
BRA,THA,2018.0,2,1,1
NZL,THA,2022.0,4,5,-1
SEN,MDG,2004.0,2,1,1
GRC,POL,1997.0,1,1,0
BGD,NGA,2020.0,2,1,1
TUN,IND,2002.0,1,1,0
NLD,UGA,2007.0,3,1,2
TWN,CHE,2009.0,1,2,-1
NOR,PAK,2013.0,5,1,4
JOR,FRA,2018.0,4,1,3
KHM,NZL,2010.0,1,1,0
BEL,MEX,2019.0,6,6,0
ESP,KEN,2022.0,1,1,0
MAC,BEL,2018.0,1,1,0
DJI,FRA,2019.0,2,2,0
HUN,AUS,2008.0,4,5,-1
KEN,FRA,2004.0,3,1,2
KEN,FRA,2015.0,5,4,1
HKG,PRT,2018.0,1,1,0
BWA,ETH,2012.0,1,1,0
ESP,VNM,2021.0,3,2,1
GRC,KOR,2018.0,2,1,1
MLI,CAN,2018.0,2,2,0
MLI,USA,2022.0,3,3,0
LTU,RUS,2022.0,1,1,0
ARE,TUR,2021.0,6,12,-6
MLI,CAN,2022.0,1,1,0
SWE,BOL,2021.0,3,4,-1
DNK,TUR,2012.0,3,6,-3
KOR,MEX,2019.0,1,9,-8
CHN,NAM,2022.0,2,1,1
ECU,FRA,2020.0,6,11,-5
NZL,PAK,2021.0,3,5,-2
GEO,CHE,2020.0,1,2,-1
MYS,KOR,2010.0,2,6,-4
ITA,BGR,2015.0,4,4,0
COG,UGA,2020.0,2,5,-3
NPL,CAN,2020.0,3,2,1
IND,BWA,2007.0,1,1,0
CHE,MLI,2020.0,1,1,0
EGY,MAR,2015.0,1,1,0
ARE,JPN,2023.0,2,6,-4
RUS,YEM,2023.0,2,1,1
NGA,BRA,2009.0,2,1,1
UGA,COG,2009.0,2,1,1
RUS,HUN,2004.0,2,1,1
LTU,LVA,2005.0,2,3,-1
AUS,POL,2007.0,1,8,-7
ALB,ITA,2004.0,3,1,2
AUS,KEN,2008.0,2,2,0
KEN,AUT,2013.0,1,1,0
USA,BMU,2011.0,4,4,0
RWA,BEL,2006.0,1,2,-1
JPN,NGA,2016.0,5,7,-2
JPN,SDN,2009.0,3,2,1
NGA,NOR,2010.0,1,1,0
IRN,ISR,2005.0,1,1,0
KEN,GHA,2005.0,2,1,1
USA,BOL,1998.0,3,1,2
IRL,EGY,2022.0,4,5,-1
PER,BOL,2022.0,2,2,0
AUS,PNG,2005.0,1,5,-4
PHL,MEX,2001.0,1,1,0
PNG,CHE,2015.0,1,2,-1
IDN,NZL,2009.0,1,2,-1
MUS,AUS,2017.0,1,3,-2
FRA,GEO,2010.0,2,1,1
NER,SEN,2019.0,1,1,0
ETH,KOR,2013.0,2,2,0
TGO,BEN,2006.0,2,1,1
EST,ESP,2008.0,1,1,0
JPN,KHM,2012.0,3,3,0
AUT,NOR,2003.0,1,1,0
MWI,USA,1999.0,1,2,-1
TWN,IRL,2013.0,3,2,1
NZL,CHL,2002.0,1,2,-1
FJI,IND,2006.0,1,1,0
AUT,FIN,2009.0,2,6,-4
SVK,HUN,2005.0,3,4,-1
HUN,SVK,2006.0,2,3,-1
SRB,BGR,2004.0,1,8,-7
BFA,FRA,1998.0,5,7,-2
PHL,SGP,2009.0,2,6,-4
DEU,LBY,2007.0,1,1,0
EGY,NLD,2001.0,2,1,1
IND,PAK,2002.0,4,3,1
SEN,JPN,2011.0,1,1,0
CHN,NOR,2003.0,5,4,1
HUN,SVN,2008.0,1,1,0
VNM,THA,2014.0,6,6,0
HUN,AUS,2015.0,2,5,-3
ZMB,JPN,2017.0,1,4,-3
PAN,KOR,2012.0,1,1,0
KEN,UGA,2012.0,4,6,-2
AUT,ZAF,2003.0,1,2,-1
JOR,JPN,2008.0,1,2,-1
CAN,UKR,1997.0,2,6,-4
JOR,AUS,2006.0,1,6,-5
COD,BEL,2016.0,2,2,0
FRO,GBR,2013.0,1,2,-1
AUS,ZWE,2015.0,1,1,0
MNG,GBR,2003.0,1,1,0
HKG,PHL,2023.0,2,3,-1
UKR,JPN,2012.0,1,8,-7
CHE,QAT,2013.0,2,1,1
QAT,CHE,2019.0,1,3,-2
CZE,NOR,2009.0,3,3,0
CHL,CZE,2013.0,2,3,-1
IDN,PHL,2009.0,1,1,0
FRA,PER,2002.0,1,1,0
IDN,IRL,2020.0,2,1,1
SWE,TZA,2018.0,4,2,2
ESP,KEN,2016.0,2,2,0
BEL,SVN,2016.0,2,3,-1
TWN,SAU,2022.0,4,1,3
UGA,COG,2021.0,3,1,2
JOR,QAT,2009.0,3,4,-1
GAB,CMR,2018.0,1,1,0
SDN,ZAF,2017.0,1,3,-2
NOR,NGA,2023.0,1,1,0
HUN,IRL,2015.0,1,4,-3
MMR,JPN,2012.0,3,1,2
ARG,DNK,2018.0,2,4,-2
TUR,HUN,2018.0,3,1,2
FRO,DNK,2018.0,1,3,-2
POL,CHL,2015.0,1,2,-1
CHL,POL,2021.0,3,1,2
CZE,MEX,2016.0,4,4,0
LBN,PAK,2021.0,1,2,-1
ISL,POL,2018.0,1,1,0
GBR,AGO,2018.0,1,1,0
TUR,TUN,2019.0,1,4,-3
ITA,CIV,2020.0,1,1,0
ARM,ESP,2019.0,1,1,0
PRI,BRA,2020.0,2,4,-2
BGD,CHE,2020.0,2,8,-6
BGD,NLD,2016.0,3,4,-1
PAN,COL,2023.0,2,1,1
VNM,SWE,2015.0,2,5,-3
CHE,HKG,2000.0,1,2,-1
CMR,CAF,2021.0,3,2,1
RUS,PAK,2020.0,3,3,0
ZMB,JPN,2022.0,1,4,-3
NLD,LBN,2023.0,3,1,2
IDN,ITA,2020.0,1,4,-3
AFG,CHN,2020.0,1,3,-2
BRB,GBR,2019.0,2,2,0
USA,PSE,2022.0,2,10,-8
SWE,TUN,2021.0,1,1,0
LUX,CZE,2023.0,1,1,0
RUS,ZAF,2020.0,2,8,-6
CHE,BOL,2021.0,1,1,0
GBR,CIV,2022.0,2,1,1
SWE,IRN,2000.0,2,4,-2
TUN,CAN,2004.0,1,10,-9
TTO,NGA,2010.0,1,1,0
LBN,DEU,2007.0,1,3,-2
QAT,SAU,2001.0,1,2,-1
IDN,IND,1997.0,1,1,0
USA,PNG,1997.0,4,1,3
BLR,FRA,2006.0,2,3,-1
BEL,RUS,2010.0,4,14,-10
IRL,LTU,2005.0,1,2,-1
GRC,ROU,2004.0,3,3,0
ECU,DNK,2002.0,1,1,0
DNK,AUT,2008.0,3,9,-6
AUS,PNG,1997.0,1,8,-7
UKR,USA,2013.0,27,15,12
CAN,POL,2018.0,21,14,7
AND,ESP,2008.0,2,6,-4
PAK,DEU,2023.0,15,13,2
SRB,CHE,2017.0,10,4,6
NLD,ARG,2019.0,5,7,-2
SRB,HUN,1999.0,2,1,1
CUB,MEX,2004.0,19,11,8
TWN,FRA,2003.0,7,6,1
ITA,VNM,2013.0,4,1,3
GBR,CHL,2011.0,33,14,19
GBR,ROU,2013.0,16,20,-4
TGO,USA,2017.0,1,2,-1
SWE,LVA,2013.0,3,6,-3
CHN,SWE,2003.0,31,31,0
DEU,PHL,2003.0,1,1,0
EGY,LBY,2015.0,4,5,-1
USA,MOZ,2013.0,4,4,0
USA,URY,2001.0,6,11,-5
AUS,DNK,2003.0,10,16,-6
JPN,BGR,2008.0,5,4,1
ITA,ROU,2012.0,9,16,-7
NLD,THA,2009.0,13,11,2
CHE,PAK,2019.0,6,3,3
TWN,KOR,2008.0,9,8,1
GBR,JOR,2013.0,20,9,11
KOR,TUR,2011.0,2,3,-1
CAN,NCL,2009.0,1,5,-4
FRA,MDG,2009.0,6,9,-3
RUS,EST,2014.0,6,4,2
POL,FIN,2018.0,6,6,0
SWE,NLD,2023.0,45,45,0
IND,UGA,2023.0,4,1,3
ARE,CZE,2022.0,3,2,1
CAN,PAK,2016.0,24,25,-1
PSE,EGY,2012.0,4,1,3
JPN,BGR,2015.0,5,1,4
VNM,TWN,2019.0,24,53,-29
BLR,RUS,2022.0,22,16,6
KNA,USA,2021.0,9,4,5
AUS,SVN,2017.0,2,3,-1
AUS,VNM,2011.0,11,4,7
CHE,MLI,2022.0,1,4,-3
FRA,MEX,2024.0,1,1,0
ROU,GBR,2022.0,19,18,1
FRA,ZWE,2021.0,7,5,2
IRL,ITA,2003.0,8,7,1
GBR,SYR,2010.0,4,1,3
TZA,THA,2016.0,1,1,0
BEL,MOZ,2012.0,2,1,1
MAR,BEL,2021.0,8,7,1
NOR,UGA,2012.0,6,3,3
KNA,TTO,2018.0,1,1,0
SVK,GBR,2002.0,12,16,-4
GBR,MLT,2001.0,7,4,3
KHM,USA,2003.0,1,1,0
DEU,THA,1998.0,1,3,-2
CHL,ECU,2023.0,6,4,2
NER,FRA,2012.0,3,9,-6
IRL,MYS,2010.0,4,2,2
ZAF,BEL,2004.0,7,7,0
ZAF,NLD,2015.0,19,35,-16
ESP,CZE,2011.0,8,6,2
IRL,ISR,2020.0,5,3,2
LBN,DEU,2016.0,4,8,-4
DEU,NPL,2017.0,2,1,1
AUS,BGD,2010.0,6,13,-7
GRC,DNK,2021.0,14,10,4
HRV,NLD,2021.0,5,4,1
KOR,BRA,2021.0,3,4,-1
ARG,FRA,2008.0,15,27,-12
CUB,DEU,2012.0,6,1,5
IRL,TZA,2017.0,1,1,0
GRC,MLT,2018.0,1,1,0
CHL,BEL,2018.0,11,11,0
TZA,CIV,2017.0,2,1,1
THA,JPN,1997.0,6,17,-11
IND,BRN,2006.0,2,1,1
SYR,EGY,2020.0,1,4,-3
CAN,CHL,2014.0,27,20,7
NOR,KOR,2020.0,5,11,-6
ESP,BGD,2017.0,2,3,-1
COL,DNK,2018.0,4,3,1
VEN,ESP,2023.0,6,4,2
UGA,ZAF,2014.0,9,8,1
DNK,CHN,2006.0,10,14,-4
SWE,ETH,2018.0,10,1,9
RWA,ZAF,2021.0,6,3,3
JPN,CHN,2024.0,14,12,2
CHE,COL,2023.0,4,3,1
CMR,NGA,2022.0,4,5,-1
SGP,KOR,1997.0,2,1,1
MEX,AUT,2017.0,5,2,3
GRC,FIN,2016.0,6,3,3
DEU,CZE,2012.0,36,43,-7
BEL,ROU,2013.0,11,11,0
USA,MYS,2023.0,6,40,-34
CZE,CHN,2012.0,4,1,3
ETH,SWE,2022.0,5,3,2
TZA,SWE,2008.0,4,5,-1
GRC,ROU,2013.0,2,2,0
BIH,HRV,2012.0,7,10,-3
BEL,AUS,2023.0,8,16,-8
MAR,GAB,2007.0,1,1,0
BEL,MAR,2012.0,10,2,8
FRA,REU,2010.0,28,33,-5
GRD,USA,2009.0,8,1,7
CAN,KWT,2022.0,12,8,4
JPN,NZL,2002.0,10,14,-4
ARE,SAU,2000.0,6,14,-8
FIN,CHL,2002.0,2,1,1
TWN,DEU,2006.0,8,20,-12
JPN,EGY,2014.0,61,35,26
BEL,AUT,2019.0,14,18,-4
ROU,DEU,2018.0,13,29,-16
MYS,DEU,2017.0,16,5,11
KEN,USA,2003.0,20,38,-18
DEU,ARM,2007.0,4,4,0
ISR,KOR,2000.0,1,2,-1
ARM,CAN,2011.0,3,1,2
SVK,CAN,2005.0,1,1,0
SRB,ALB,2012.0,10,6,4
BEL,AUT,2011.0,8,3,5
ISR,TUR,2006.0,4,4,0
DZA,DEU,2008.0,2,3,-1
ITA,BRA,2001.0,25,18,7
JPN,GHA,2013.0,2,4,-2
CAN,TUN,2000.0,4,2,2
ETH,NGA,2009.0,2,1,1
IRN,BEL,2010.0,11,8,3
MKD,ALB,2020.0,2,1,1
IRN,DNK,2013.0,7,4,3
KOR,ITA,2020.0,16,8,8
AUS,KOR,2015.0,25,37,-12
AUT,NZL,2015.0,6,7,-1
CHE,POL,2012.0,18,16,2
TWN,GBR,2009.0,24,41,-17
USA,ASM,2012.0,4,3,1
DZA,ITA,2018.0,2,5,-3
DNK,JPN,2015.0,9,5,4
UKR,CZE,2017.0,15,2,13
NGA,UGA,2019.0,3,5,-2
ITA,SRB,2002.0,7,15,-8
CHE,TZA,2016.0,7,7,0
SRB,ITA,2012.0,3,9,-6
CHN,CHE,1999.0,9,7,2
HRV,GBR,2014.0,10,8,2
COD,USA,2022.0,6,12,-6
MYS,PSE,2022.0,11,2,9
COL,SWE,2019.0,8,3,5
EGY,KWT,2015.0,12,15,-3
CMR,BRA,2015.0,3,2,1
EST,GBR,2019.0,10,13,-3
LBN,IRL,2020.0,4,1,3
MEX,KOR,2021.0,3,2,1
CAN,OMN,2018.0,9,9,0
ITA,ARM,2021.0,2,1,1
AUS,IND,2003.0,30,29,1
EGY,NGA,2020.0,2,3,-1
CYP,SAU,2023.0,2,1,1
GBR,LUX,2020.0,18,9,9
JOR,ISR,2018.0,2,1,1
PRT,IRL,2023.0,2,3,-1
ZAF,FRA,2019.0,23,25,-2
SVK,SWE,2022.0,2,3,-1
CHE,TWN,2021.0,9,13,-4
HUN,ARG,2021.0,1,2,-1
AUS,ARG,2008.0,5,7,-2
NGA,ZAF,2003.0,9,11,-2
ITA,NOR,2005.0,13,3,10
AUS,MYS,1999.0,12,4,8
BGR,MKD,2006.0,5,1,4
POL,JPN,2018.0,8,16,-8
TUR,SAU,2020.0,10,3,7
LVA,ITA,2022.0,8,4,4
FIN,NOR,2000.0,7,4,3
BEL,ROU,2003.0,5,7,-2
MKD,SRB,2004.0,8,42,-34
FIN,IND,2015.0,8,23,-15
POL,PRT,2013.0,4,6,-2
AUS,KHM,2013.0,3,1,2
BEL,EGY,2019.0,6,1,5
FRA,NZL,2007.0,12,9,3
NLD,IDN,2008.0,15,7,8
ITA,ARG,2004.0,12,26,-14
SGP,BEL,2016.0,6,7,-1
RUS,CZE,2023.0,15,8,7
HKG,DNK,2014.0,4,3,1
CHN,ECU,2018.0,2,3,-1
MEX,BEL,2014.0,5,8,-3
ESP,TUR,2018.0,11,14,-3
ZAF,RWA,2011.0,4,1,3
DZA,EGY,2011.0,2,2,0
VEN,PER,2019.0,4,1,3
SWE,SRB,2020.0,2,6,-4
CAN,TWN,2007.0,18,12,6
IND,RWA,2015.0,1,1,0
UKR,ESP,2016.0,4,4,0
GBR,TUN,2021.0,2,1,1
VNM,MYS,2017.0,3,6,-3
SRB,SGP,2005.0,1,0,1
GBR,PRI,2004.0,1,0,1
,NER,1995.0,25,0,25
PRT,ARE,2009.0,1,0,1
ZAF,LKA,2017.0,1,0,1
AUS,KWT,2007.0,2,0,2
PER,,2001.0,10,0,10
,NCL,2011.0,14,0,14
ZAF,KOR,2001.0,3,0,3
RUS,IRN,2010.0,5,0,5
MWI,JPN,2017.0,1,0,1
ETH,,2005.0,30,0,30
BRN,ARE,2008.0,1,0,1
,GNB,1997.0,5,0,5
PRT,BGR,2001.0,1,0,1
GHA,NAM,2013.0,1,0,1
GHA,ECU,2014.0,1,0,1
TUR,CHL,2017.0,2,0,2
BOL,NLD,2014.0,2,0,2
,COG,2004.0,54,0,54
,GTM,2010.0,27,0,27
PER,LUX,2013.0,1,0,1
USA,MKD,2011.0,4,0,4
PRT,HRV,2013.0,1,0,1
GBR,SYC,2015.0,1,0,1
MOZ,,2015.0,20,0,20
ROU,CZE,2014.0,3,0,3
UGA,SOM,2023.0,1,0,1
NOR,PAK,2015.0,4,0,4
EGY,DJI,2021.0,1,0,1
BIH,SWE,2016.0,3,0,3
BRA,LVA,2016.0,1,0,1
PRT,QAT,2016.0,2,0,2
,FRO,2015.0,11,0,11
,PAN,2003.0,21,0,21
COG,,2012.0,33,0,33
ECU,CHE,2016.0,1,0,1
PAK,NLD,2009.0,8,0,8
GRC,HUN,2005.0,1,0,1
MNE,,2016.0,17,0,17
ZMB,LSO,2023.0,1,0,1
COM,,2022.0,14,0,14
BHS,,2017.0,3,0,3
AUT,BGD,2008.0,1,0,1
,JAM,2004.0,52,0,52
SAU,SWE,2001.0,1,0,1
CMR,,2005.0,18,0,18
NGA,CHE,2001.0,2,0,2
ISR,MDA,2021.0,1,0,1
NZL,KHM,2014.0,1,0,1
NER,GIN,2018.0,1,0,1
GUF,GIN,2021.0,2,0,2
ATA,NLD,2020.0,1,0,1
VEN,SAU,2018.0,1,0,1
MLI,TUR,2020.0,1,0,1
CAN,LBY,2022.0,2,0,2
ARG,KEN,2005.0,1,0,1
,HND,2006.0,13,0,13
COG,BGR,2012.0,1,0,1
SDN,NLD,2008.0,2,0,2
TUN,JPN,2005.0,2,0,2
JPN,TUN,2009.0,1,0,1
DMA,GBR,2016.0,2,0,2
SYR,,2000.0,11,0,11
,LCA,2004.0,2,0,2
LCA,,2014.0,2,0,2
EGY,TWN,2012.0,1,0,1
LSO,,2014.0,2,0,2
,GLP,2004.0,16,0,16
NLD,LBN,2009.0,2,0,2
MYS,PRT,2015.0,4,0,4
NPL,AUT,2013.0,1,0,1
SVK,PRT,2011.0,2,0,2
MOZ,,2014.0,15,0,15
HKG,PAK,1998.0,1,0,1
LVA,LTU,2010.0,1,0,1
POL,EGY,2009.0,3,0,3
COL,LAO,2016.0,1,0,1
COD,ZAF,2008.0,4,0,4
BRA,SEN,2022.0,1,0,1
ARE,BRA,2013.0,1,0,1
TON,FJI,2015.0,1,0,1
,GLP,2001.0,8,0,8
TUR,PSE,2010.0,4,0,4
SRB,BRA,2017.0,2,0,2
,MLI,1996.0,23,0,23
MLI,CIV,2009.0,2,0,2
IRL,LBY,2012.0,3,0,3
,GTM,2006.0,22,0,22
MKD,DEU,2009.0,3,0,3
HRV,BWA,2010.0,1,0,1
EGY,KEN,2023.0,2,0,2
CUB,VEN,2006.0,2,0,2
PER,,2004.0,30,0,30
DZA,JAM,2019.0,1,0,1
BEN,ITA,2001.0,1,0,1
ZAF,ETH,2006.0,5,0,5
BEN,DEU,2007.0,2,0,2
IRL,EST,2015.0,1,0,1
GBR,CUB,2012.0,2,0,2
MLI,,2006.0,7,0,7
TCA,PAN,2014.0,1,0,1
FRA,WLF,2008.0,1,0,1
GBR,LTU,2011.0,6,0,6
NGA,AUS,2007.0,2,0,2
LVA,,2009.0,35,0,35
FJI,,2009.0,11,0,11
MMR,NOR,2022.0,2,0,2
MEX,ECU,2009.0,2,0,2
GRC,SVK,2013.0,2,0,2
PSE,,2009.0,18,0,18
CHL,KEN,2020.0,1,0,1
LIE,,2019.0,7,0,7
CHE,PAK,2003.0,5,0,5
BRA,AGO,2018.0,3,0,3
JPN,UZB,2000.0,1,0,1
KGZ,,2019.0,25,0,25
CAN,VEN,2020.0,1,0,1
UKR,PRT,2020.0,3,0,3
RUS,ETH,2020.0,2,0,2
BLR,EST,2022.0,2,0,2
MYS,PSE,2018.0,11,0,11
TUR,SVN,2023.0,1,0,1
MDG,GBR,2016.0,1,0,1
LVA,JPN,2020.0,1,0,1
NZL,TCA,2015.0,1,0,1
BEL,KWT,2020.0,1,0,1
PRK,,2019.0,13,0,13
,YEM,1996.0,24,0,24
LBN,LBY,1999.0,2,0,2
LBY,GRC,2000.0,1,0,1
OMN,FIN,2017.0,1,0,1
,GLP,1996.0,14,0,14
LUX,GBR,1997.0,1,0,1
CAN,LUX,2002.0,1,0,1
,BEN,2000.0,32,0,32
FJI,NZL,2008.0,4,0,4
NGA,CAN,2003.0,3,0,3
SVK,CAN,2012.0,4,0,4
ARG,SRB,2002.0,1,0,1
PAK,HRV,1998.0,1,0,1
ISR,THA,2021.0,1,0,1
SRB,SWE,1999.0,2,0,2
DEU,MLI,2003.0,1,0,1
CZE,BGR,2022.0,4,0,4
SEN,,2001.0,22,0,22
BGD,PNG,2017.0,1,0,1
UKR,TJK,2014.0,1,0,1
BEL,LTU,2005.0,4,0,4
EST,DNK,2005.0,1,0,1
ROU,UKR,2000.0,2,0,2
FSM,ITA,2014.0,1,0,1
,LVA,1999.0,106,0,106
BRB,AUT,2012.0,1,0,1
MWI,ZAF,2001.0,3,0,3
UGA,,2010.0,32,0,32
GRC,LVA,1999.0,1,0,1
KEN,LKA,2009.0,2,0,2
TUR,KWT,2016.0,9,0,9
DZA,,2006.0,38,0,38
PER,MOZ,2008.0,1,0,1
MOZ,PER,2010.0,1,0,1
BRA,CPV,2005.0,1,0,1
LBY,ITA,2019.0,2,0,2
UKR,ARM,1999.0,1,0,1
THA,IDN,2006.0,2,0,2
NLD,URY,2001.0,1,0,1
HUN,ARE,2015.0,1,0,1
PRT,LKA,2011.0,1,0,1
BIH,,2011.0,48,0,48
ETH,FRA,1999.0,1,0,1
GUF,,2001.0,2,0,2
TON,NZL,2008.0,2,0,2
ESP,HRV,1999.0,3,0,3
UKR,PRT,1999.0,5,0,5
NOR,ZAF,2004.0,1,0,1
BEN,USA,2017.0,3,0,3
SYR,AUS,2001.0,1,0,1
,COG,1996.0,34,0,34
COG,,2002.0,6,0,6
AUS,ISL,1999.0,1,0,1
LKA,CHN,2002.0,1,0,1
SYR,AUS,2014.0,3,0,3
LVA,ISR,2003.0,1,0,1
ZAF,LBY,1999.0,1,0,1
NLD,TUN,2008.0,1,0,1
AUS,CYP,1997.0,1,0,1
ROU,IRN,2015.0,4,0,4
SYR,,2006.0,13,0,13
BGR,MYS,2019.0,1,0,1
LSO,CAN,2015.0,1,0,1
NLD,SUR,2013.0,2,0,2
GHA,PAK,2008.0,1,0,1
CUB,ECU,2006.0,1,0,1
DZA,PRT,1999.0,2,0,2
SDN,MLI,1999.0,1,0,1
MLI,BEL,2000.0,1,0,1
BTN,LAO,1998.0,1,0,1
LBY,RUS,2006.0,1,0,1
SAU,NZL,2010.0,1,0,1
CHL,GRC,2011.0,2,0,2
FRA,LVA,1999.0,1,0,1
,BOL,1999.0,25,0,25
DZA,TWN,2004.0,1,0,1
IDN,ARE,2009.0,1,0,1
MMR,,2002.0,5,0,5
ARG,FIN,2018.0,2,0,2
BWA,BRB,2007.0,1,0,1
SRB,JPN,1998.0,1,0,1
RWA,DEU,2008.0,1,0,1
ISR,KEN,2002.0,2,0,2
DZA,ESP,1998.0,1,0,1
UZB,AZE,2019.0,1,0,1
KAZ,GBR,2001.0,3,0,3
PYF,,2007.0,5,0,5
ALB,,2007.0,2,0,2
IRL,CMR,2013.0,1,0,1
TUN,CHE,2003.0,1,0,1
AUS,LUX,2006.0,1,0,1
SVN,JPN,2000.0,1,0,1
LTU,CIV,2018.0,4,0,4
SMR,CAN,2016.0,1,0,1
SVK,IRL,2004.0,2,0,2
SGP,POL,2007.0,1,0,1
CHE,SVK,2011.0,10,0,10
GRC,IRQ,2023.0,1,0,1
MEX,SRB,2002.0,1,0,1
ESP,CPV,2020.0,1,0,1
AUT,IDN,2017.0,3,0,3
,MUS,2006.0,24,0,24
AUS,HRV,2023.0,1,0,1
THA,ARG,2014.0,5,0,5
GIN,JPN,2009.0,2,0,2
BEN,CAN,2008.0,2,0,2
MDG,CMR,2017.0,1,0,1
,COD,2006.0,14,0,14
,SOM,2006.0,1,0,1
DEU,CYP,2007.0,5,0,5
IRQ,DZA,2004.0,1,0,1
JAM,GRD,2009.0,1,0,1
AUS,MWI,2010.0,2,0,2
CHN,ZMB,2013.0,1,0,1
CUB,FIN,2011.0,2,0,2
,LSO,2003.0,3,0,3
FRA,RWA,2013.0,4,0,4
MLI,,2010.0,17,0,17
HRV,ARE,2008.0,1,0,1
SAU,KAZ,2013.0,1,0,1
AFG,TUR,2021.0,3,0,3
MYS,KWT,2014.0,1,0,1
AFG,UGA,2020.0,1,0,1
POL,LBY,2000.0,1,0,1
CUB,CAN,2015.0,4,0,4
SYC,CHE,2009.0,1,0,1
JPN,SAU,1998.0,4,0,4
SDN,IDN,2019.0,1,0,1
MWI,NLD,2011.0,2,0,2
SWE,HND,2013.0,1,0,1
,RWA,1995.0,4,0,4
RWA,AUS,2006.0,1,0,1
LTU,CHE,2011.0,2,0,2
PAN,,1999.0,2,0,2
GIN,CIV,2006.0,2,0,2
SGP,BGD,2003.0,2,0,2
IND,POL,2007.0,1,0,1
ESP,MCO,2007.0,1,0,1
FIN,PAK,2013.0,3,0,3
OMN,PHL,2017.0,1,0,1
ESP,PLW,2015.0,1,0,1
PRY,USA,2012.0,2,0,2
IND,ARG,2012.0,4,0,4
FIN,VNM,2017.0,3,0,3
ARG,DZA,2021.0,2,0,2
NZL,UGA,2013.0,1,0,1
BGD,ARE,2018.0,1,0,1
BRA,NER,2015.0,1,0,1
ARM,,1999.0,16,0,16
AUS,PAN,2018.0,2,0,2
CUB,HND,2016.0,1,0,1
BRA,KOR,2018.0,5,0,5
ROU,BGR,2010.0,2,0,2
KHM,ETH,2021.0,2,0,2
,ERI,2009.0,7,0,7
,MRT,2014.0,20,0,20
PAN,NLD,2017.0,2,0,2
PAN,NLD,2022.0,3,0,3
BEN,COD,2021.0,1,0,1
DMA,ESP,2016.0,1,0,1
KEN,MEX,2022.0,1,0,1
NCL,SLB,2015.0,2,0,2
,PLW,2012.0,4,0,4
MYS,QAT,2018.0,5,0,5
,BTN,2012.0,22,0,22
,DJI,2012.0,5,0,5
URY,CHN,2012.0,1,0,1
IRL,BGD,2015.0,3,0,3
,BLZ,2013.0,4,0,4
RWA,CAN,2014.0,1,0,1
GRC,ALB,2016.0,2,0,2
COM,,2017.0,2,0,2
NAM,ITA,2019.0,1,0,1
NZL,KAZ,2016.0,1,0,1
USA,WSM,2015.0,3,0,3
UKR,SVN,2016.0,2,0,2
,LBR,2013.0,27,0,27
,MWI,1998.0,38,0,38
PHL,IDN,2017.0,6,0,6
CHE,GMB,2021.0,1,0,1
MNG,CHN,2017.0,5,0,5
MAR,PRT,2009.0,1,0,1
LVA,IND,2007.0,8,0,8
LVA,BEL,2018.0,1,0,1
SDN,GRC,2018.0,1,0,1
BMU,,2023.0,5,0,5
GMB,CHE,2018.0,3,0,3
BWA,KEN,2022.0,2,0,2
CHL,IDN,2020.0,1,0,1
BRA,BIH,2018.0,3,0,3
PAN,ARG,2016.0,1,0,1
SRB,NOR,2007.0,3,0,3
HKG,HRV,2022.0,1,0,1
PAK,ZWE,2011.0,1,0,1
LBR,PAK,2013.0,1,0,1
,BHR,2002.0,30,0,30
,KWT,2020.0,136,0,136
FRA,MWI,2021.0,3,0,3
KAZ,USA,2009.0,1,0,1
CMR,BWA,2003.0,1,0,1
LBY,IRQ,2022.0,2,0,2
CUB,ARG,2023.0,3,0,3
,REU,2019.0,6,0,6
,NIC,2017.0,14,0,14
ARG,PRT,2018.0,1,0,1
,AFG,2017.0,70,0,70
ZWE,ZAF,2024.0,1,0,1
,TGO,2020.0,35,0,35
NLD,IRQ,2018.0,6,0,6
BRB,GUY,2021.0,1,0,1
ETH,TTO,2015.0,1,0,1
AGO,ZAF,2018.0,1,0,1
,SLV,2013.0,31,0,31
,SOM,2000.0,3,0,3
GBR,KGZ,2017.0,1,0,1
TON,NZL,2014.0,1,0,1
SYC,,2020.0,3,0,3
SDN,BRA,2016.0,1,0,1
BRA,SDN,2019.0,3,0,3
BOL,COL,2019.0,2,0,2
FSM,,2024.0,4,0,4
DNK,JOR,2016.0,1,0,1
BRN,BGD,2020.0,2,0,2
BLR,POL,2022.0,11,0,11
MNP,,2024.0,2,0,2
FJI,PAK,2020.0,1,0,1
KOR,PRK,2017.0,3,0,3
RUS,TZA,2016.0,1,0,1
,MRT,2004.0,4,0,4
KOR,SRB,2019.0,1,0,1
TUR,YEM,2022.0,1,0,1
MRT,,2020.0,9,0,9
COM,,2018.0,3,0,3
MDV,ARE,2016.0,1,0,1
BHS,,2016.0,5,0,5
ZAF,SVK,2016.0,1,0,1
MAR,IND,2017.0,1,0,1
GHA,ZMB,2021.0,1,0,1
PRY,ECU,2022.0,1,0,1
BIH,BRN,2023.0,1,0,1
ZMB,NGA,2018.0,1,0,1
,LIE,2014.0,13,0,13
LKA,MYS,2008.0,2,0,2
GBR,MDA,2003.0,1,0,1
,MRT,2008.0,13,0,13
GNQ,,2025.0,23,0,23
HND,DEU,2021.0,1,0,1
WSM,VUT,2021.0,1,0,1
UKR,UZB,2012.0,3,0,3
LSO,SWZ,2023.0,1,0,1
BGD,KEN,2021.0,2,0,2
UZB,HUN,2022.0,1,0,1
PRT,URY,2014.0,3,0,3
CYP,IRN,2022.0,3,0,3
LBY,IRQ,2018.0,3,0,3
BGR,UKR,2021.0,2,0,2
,MNE,2020.0,17,0,17
,MCO,2020.0,4,0,4
BRA,AGO,2022.0,2,0,2
BFA,CAN,2021.0,3,0,3
,DZA,2021.0,10,0,10
TTO,BLZ,2006.0,1,0,1
,UGA,2000.0,88,0,88
IND,PRT,1999.0,1,0,1
AIA,,2018.0,3,0,3
ZAF,URY,2004.0,4,0,4
MDA,ROU,2007.0,5,0,5
,MWI,1999.0,35,0,35
NGA,KWT,2010.0,1,0,1
LBN,HUN,2002.0,1,0,1
,ALB,1998.0,12,0,12
SEN,LAO,2005.0,1,0,1
RUS,ARE,2011.0,2,0,2
,COD,2000.0,6,0,6
KIR,AUS,2004.0,1,0,1
GBR,AZE,2013.0,2,0,2
NGA,IRL,2008.0,1,0,1
COG,,2005.0,4,0,4
MNG,,2008.0,16,0,16
LKA,LAO,2010.0,1,0,1
BEL,GAB,2001.0,1,0,1
PNG,,2011.0,12,0,12
JPN,CRI,1998.0,1,0,1
FJI,GUM,2002.0,1,0,1
LBY,ARE,2002.0,2,0,2
MOZ,,2001.0,4,0,4
MAR,ZAF,2001.0,3,0,3
ZWE,AUS,2007.0,2,0,2
DEU,BHR,2004.0,2,0,2
,MNG,1996.0,19,0,19
IRL,ZAF,2002.0,2,0,2
BLR,PHL,2015.0,1,0,1
KAZ,,2002.0,21,0,21
NER,,2007.0,3,0,3
LIE,,2009.0,3,0,3
ARG,PRY,2005.0,3,0,3
HKG,LKA,2005.0,2,0,2
,PLW,2002.0,4,0,4
DEU,MNG,2007.0,1,0,1
ITA,OMN,2017.0,2,0,2
ZMB,COG,2005.0,1,0,1
GAB,,2015.0,12,0,12
UKR,BRA,2014.0,4,0,4
YEM,USA,2000.0,2,0,2
JOR,KWT,2007.0,1,0,1
KWT,JOR,2008.0,1,0,1
QAT,JOR,2004.0,1,0,1
RUS,LUX,2018.0,2,0,2
TUR,IRN,1999.0,1,0,1
DOM,,2011.0,8,0,8
PRT,HRV,2003.0,1,0,1
BWA,NZL,2006.0,1,0,1
PER,PRI,2010.0,1,0,1
BRA,TUR,2004.0,2,0,2
SWE,IDN,2014.0,2,0,2
TUR,CYP,2002.0,3,0,3
,GLP,2008.0,13,0,13
,MNE,1998.0,3,0,3
SYR,ITA,2003.0,2,0,2
JAM,,1999.0,6,0,6
GHA,,2001.0,14,0,14
BIH,HRV,1997.0,2,0,2
IND,NOR,1997.0,1,0,1
,GUF,2009.0,16,0,16
CAF,,2003.0,1,0,1
SVN,CAN,2001.0,2,0,2
BEL,TZA,2003.0,1,0,1
BEN,MLI,2016.0,1,0,1
ARG,CHN,2012.0,1,0,1
KEN,NGA,2014.0,3,0,3
BOL,COL,2021.0,2,0,2
ROU,MDV,2008.0,1,0,1
,FRO,2001.0,4,0,4
CAN,DJI,2009.0,1,0,1
FRA,MKD,2014.0,2,0,2
FIN,GHA,2010.0,1,0,1
,PRY,2002.0,12,0,12
COL,PRT,2010.0,1,0,1
NAM,IND,2007.0,1,0,1
UKR,ZAF,2005.0,2,0,2
GHA,NGA,2006.0,3,0,3
EGY,FIN,2007.0,1,0,1
PAK,BEL,2007.0,1,0,1
HKG,BLR,2013.0,1,0,1
BEL,UGA,2006.0,1,0,1
DNK,BGR,2019.0,1,0,1
ITA,UGA,2005.0,1,0,1
GLP,CAN,2004.0,1,0,1
CUB,NLD,2019.0,3,0,3
CYP,,2012.0,50,0,50
,SUR,2003.0,8,0,8
,GNB,2002.0,3,0,3
GNB,,2013.0,2,0,2
MWI,CMR,2009.0,1,0,1
HTI,,2009.0,8,0,8
ESP,GEO,2004.0,1,0,1
EGY,SYR,2005.0,1,0,1
ZAF,TCD,2014.0,2,0,2
PRI,UKR,2008.0,1,0,1
BRA,EGY,2020.0,3,0,3
JAM,TTO,2003.0,2,0,2
,NAM,2004.0,15,0,15
AUT,IRQ,2009.0,1,0,1
DZA,FIN,2018.0,3,0,3
RWA,,2017.0,35,0,35
FIN,LUX,2021.0,1,0,1
NPL,ITA,2012.0,1,0,1
FIN,TZA,2020.0,4,0,4
ITA,YEM,2011.0,2,0,2
,SLB,2007.0,6,0,6
MYS,BGR,2015.0,1,0,1
CAF,,2013.0,5,0,5
MEX,MAR,2017.0,1,0,1
JPN,BOL,2016.0,1,0,1
GHA,GRC,2014.0,1,0,1
SGP,LVA,2011.0,1,0,1
BRA,FIN,2008.0,4,0,4
BRA,KEN,2018.0,2,0,2
ABW,ARE,2018.0,1,0,1
AUS,JAM,2009.0,1,0,1
,COM,2010.0,1,0,1
HRV,CZE,2010.0,2,0,2
NLD,VGB,2010.0,1,0,1
ESP,PAK,2010.0,2,0,2
ARE,KAZ,2007.0,1,0,1
GRC,CZE,2013.0,3,0,3
COD,,2000.0,2,0,2
SWZ,AUS,2020.0,1,0,1
KOR,SVN,2002.0,1,0,1
FJI,IRL,2021.0,2,0,2
CAN,JOR,1998.0,1,0,1
COL,MAC,2016.0,1,0,1
JAM,ESP,2013.0,1,0,1
BWA,IND,1997.0,1,0,1
,HND,2010.0,19,0,19
KOR,SGP,1999.0,1,0,1
MKD,FRA,2015.0,1,0,1
,AGO,2017.0,30,0,30
NLD,TJK,2013.0,1,0,1
PLW,,2017.0,2,0,2
CHE,ECU,2018.0,1,0,1
BGD,CHN,2014.0,9,0,9
MDA,LBN,2016.0,1,0,1
JPN,DOM,2018.0,1,0,1
VEN,CUB,2017.0,2,0,2
BOL,MEX,2018.0,2,0,2
BFA,SDN,2003.0,1,0,1
GRC,TWN,2012.0,1,0,1
MDV,MYS,2014.0,1,0,1
ITA,LBY,2016.0,2,0,2
NER,MEX,2017.0,1,0,1
MEX,LTU,2018.0,1,0,1
BEN,,2026.0,7,0,7
NAM,IRL,2018.0,1,0,1
PNG,,2019.0,33,0,33
JPN,MLI,2017.0,1,0,1
PER,VEN,1998.0,2,0,2
CIV,BEN,2023.0,1,0,1
AIA,GBR,2020.0,2,0,2
QAT,SDN,2017.0,2,0,2
FJI,LKA,2023.0,2,0,2
PRY,ESP,2022.0,2,0,2
MKD,KWT,2017.0,1,0,1
SYR,CHN,2002.0,1,0,1
PER,CZE,2023.0,1,0,1
SAU,NIC,2023.0,1,0,1
SDN,ITA,2022.0,1,0,1
COL,TUR,2022.0,1,0,1
AZE,IND,2014.0,1,0,1
ISR,KAZ,2022.0,3,0,3
CRI,FRA,2001.0,3,0,3
EST,PRT,2009.0,1,0,1
BLZ,USA,2016.0,2,0,2
GRC,ARE,2010.0,3,0,3
SWE,THA,2002.0,5,0,5
ITA,THA,2004.0,3,0,3
ZAF,UKR,1997.0,1,0,1
GEO,EGY,2003.0,1,0,1
CHE,MKD,2005.0,1,0,1
RUS,MOZ,2005.0,1,0,1
AFG,PHL,2019.0,1,0,1
NPL,FRA,2013.0,1,0,1
MWI,BFA,2001.0,1,0,1
EGY,SDN,2006.0,1,0,1
BWA,ZMB,2000.0,1,0,1
AUT,ZWE,2013.0,1,0,1
GRC,EGY,2008.0,2,0,2
BHR,DEU,2001.0,2,0,2
GHA,GTM,2011.0,1,0,1
BRN,ARE,2003.0,1,0,1
MDA,JPN,2000.0,1,0,1
KHM,,2001.0,2,0,2
KGZ,,2006.0,4,0,4
TWN,HUN,2012.0,3,0,3
DNK,TUR,2002.0,2,0,2
ALB,,2002.0,3,0,3
DNK,GHA,2005.0,1,0,1
AZE,UKR,2009.0,1,0,1
ECU,COL,2010.0,1,0,1
SWE,JOR,2015.0,4,0,4
LSO,ZAF,2002.0,2,0,2
ALB,ARG,2019.0,4,0,4
GRL,,2008.0,4,0,4
BFA,CAN,2000.0,2,0,2
NLD,GHA,2005.0,1,0,1
MLI,BFA,2008.0,3,0,3
SLE,,2007.0,1,0,1
PNG,CHE,2001.0,2,0,2
ZAF,LAO,2007.0,1,0,1
EGY,RUS,2001.0,2,0,2
MYS,LBY,2004.0,1,0,1
BEL,NGA,2000.0,2,0,2
BTN,NPL,2006.0,1,0,1
BRA,PRY,2005.0,2,0,2
TCD,ITA,2009.0,1,0,1
NZL,WSM,2010.0,1,0,1
JPN,JOR,2012.0,3,0,3
ARG,NOR,2007.0,1,0,1
ZAF,BGD,2004.0,1,0,1
BRA,THA,2016.0,1,0,1
NER,,2002.0,3,0,3
ESP,THA,2012.0,1,0,1
LTU,AUT,2009.0,1,0,1
MEX,EGY,1998.0,1,0,1
IND,TZA,1998.0,2,0,2
EGY,PAK,1999.0,1,0,1
MKD,NOR,2007.0,1,0,1
FRA,GEO,2006.0,2,0,2
ISR,MOZ,2013.0,1,0,1
MUS,MRT,2009.0,1,0,1
BIH,NLD,2017.0,2,0,2
TUR,ZAF,2014.0,1,0,1
DZA,RUS,2019.0,1,0,1
JPN,CRI,2012.0,1,0,1
SVK,LTU,2005.0,1,0,1
SYC,,2012.0,1,0,1
NIC,SWE,2000.0,2,0,2
COL,URY,2018.0,3,0,3
UZB,CHN,2010.0,1,0,1
ECU,CAN,2009.0,2,0,2
BGR,DNK,2013.0,1,0,1
BOL,ESP,1998.0,2,0,2
GHA,HKG,2010.0,1,0,1
USA,BFA,2001.0,1,0,1
SWE,CYP,2020.0,1,0,1
SYR,JPN,2011.0,1,0,1
ERI,USA,2022.0,1,0,1
ARM,DNK,2013.0,1,0,1
GRC,LBN,2015.0,2,0,2
LBN,GRC,2021.0,1,0,1
MNP,,2021.0,1,0,1
AFG,AUT,2013.0,1,0,1
FIN,TWN,2017.0,2,0,2
SDN,SWE,2013.0,1,0,1
KWT,SVN,2021.0,2,0,2
SEN,TCD,2019.0,2,0,2
CYP,BEL,2015.0,1,0,1
CAN,UZB,2019.0,1,0,1
QAT,VNM,2020.0,1,0,1
NOR,HKG,2013.0,1,0,1
DEU,ZMB,2012.0,1,0,1
PER,CAN,2012.0,3,0,3
HRV,SWE,2023.0,2,0,2
CHN,YEM,2015.0,2,0,2
ZAF,FLK,2021.0,1,0,1
REU,BEL,2011.0,1,0,1
GLP,NLD,2011.0,1,0,1
PER,KOR,2012.0,1,0,1
CHN,GEO,2015.0,1,0,1
BVT,,2021.0,1,0,1
DEU,SEN,2003.0,1,0,1
BRA,DOM,2018.0,1,0,1
SEN,EGY,2022.0,1,0,1
RWA,AUS,2019.0,1,0,1
IDN,SWE,2020.0,2,0,2
FIN,UGA,2015.0,1,0,1
UGA,FIN,2016.0,1,0,1
SVN,EGY,2022.0,1,0,1
IRN,TWN,2018.0,4,0,4
PRT,CRI,2021.0,1,0,1
,LCA,2013.0,3,0,3
LBN,VNM,2024.0,1,0,1
LBN,ARE,2015.0,5,0,5
FRA,ARM,2017.0,2,0,2
SLV,SVN,2022.0,2,0,2
IDN,TUR,2014.0,1,0,1
CMR,NLD,2022.0,3,0,3
,ATG,2017.0,2,0,2
,MDV,2017.0,6,0,6
ZAF,LBR,2019.0,1,0,1
CMR,DEU,2002.0,2,0,2
COL,PHL,2015.0,2,0,2
PNG,USA,2022.0,3,0,3
SLV,CAN,2018.0,1,0,1
LAO,KOR,2021.0,1,0,1
RWA,FRA,2023.0,1,0,1
AUT,BIH,2021.0,1,0,1
GTM,ITA,2021.0,1,0,1
UKR,SAU,2022.0,1,0,1
GRC,BGD,2010.0,1,0,1
PAK,SVK,2022.0,1,0,1
ITA,URY,2016.0,3,0,3
DEU,PER,2005.0,2,0,2
USA,OMN,1998.0,9,0,9
ECU,BEL,2002.0,1,0,1
PRI,SWE,2013.0,1,0,1
BGR,PRT,2010.0,5,0,5
ESP,PNG,2001.0,1,0,1
DOM,,2006.0,3,0,3
BGD,CAN,2001.0,1,0,1
QAT,GBR,2000.0,2,0,2
CAF,,2015.0,4,0,4
MYS,ARE,2009.0,3,0,3
KWT,NOR,2003.0,1,0,1
BGR,ISR,2021.0,1,0,1
,VCT,1994.0,1,0,1
FIN,CRI,1997.0,1,0,1
BRA,IRL,2004.0,1,0,1
CRI,PRI,2001.0,1,0,1
NLD,NAM,2006.0,1,0,1
BWA,MNG,2019.0,1,0,1
UZB,GBR,2007.0,1,0,1
PHL,NPL,1998.0,1,0,1
SGP,ISR,2003.0,2,0,2
MLT,SRB,2019.0,1,0,1
ITA,PER,2013.0,2,0,2
LTU,AUT,2011.0,2,0,2
BIH,NLD,2016.0,2,0,2
GHA,TWN,2012.0,1,0,1
IND,BRN,2021.0,1,0,1
FJI,KOR,2013.0,1,0,1
MYS,ETH,2013.0,1,0,1
MKD,AUS,2012.0,2,0,2
ITA,BIH,2012.0,5,0,5
CRI,BOL,2017.0,2,0,2
SRB,EGY,2022.0,1,0,1
ESP,PSE,2011.0,2,0,2
ARG,ARM,2015.0,2,0,2
FIN,LVA,1998.0,1,0,1
KGZ,AUT,2016.0,1,0,1
AUT,EGY,2021.0,3,0,3
PRI,PAN,2019.0,1,0,1
UGA,HKG,2012.0,1,0,1
BGD,KHM,2015.0,1,0,1
SVN,ETH,2013.0,1,0,1
SVK,SGP,2014.0,1,0,1
JOR,PSE,2017.0,2,0,2
CHN,MLI,2016.0,3,0,3
KOR,OMN,2015.0,3,0,3
ETH,MMR,2014.0,1,0,1
BRA,VNM,2020.0,1,0,1
FJI,SLB,2017.0,1,0,1
PAK,ARM,2020.0,1,0,1
BHR,PHL,2019.0,1,0,1
BGR,SVK,2016.0,2,0,2
URY,ISR,2017.0,2,0,2
HRV,MEX,2016.0,1,0,1
POL,UZB,2019.0,1,0,1
SRB,CYP,2020.0,1,0,1
BLR,ISR,2019.0,1,0,1
SYR,BEL,2021.0,1,0,1
BGR,IRQ,2023.0,1,0,1
VNM,PHL,2003.0,1,0,1
GIN,USA,2001.0,1,0,1
UGA,PER,2019.0,1,0,1
TWN,SWZ,2022.0,2,0,2
CRI,ECU,2022.0,1,0,1
GHA,IND,2023.0,3,0,3
HND,CRI,2022.0,1,0,1
NPL,PAK,2007.0,1,0,1
USA,TJK,2008.0,2,0,2
,GMB,2004.0,11,0,11
BEL,IRN,1998.0,2,0,2
PRT,HKG,2011.0,1,0,1
IRN,EST,2011.0,1,0,1
VUT,SLB,2006.0,1,0,1
AZE,AUT,2014.0,1,0,1
CZE,ZAF,2005.0,1,0,1
CHN,SYR,2000.0,1,0,1
LTU,EST,2014.0,2,0,2
ARG,CHN,1998.0,1,0,1
DEU,COG,2012.0,2,0,2
QAT,NLD,2019.0,3,0,3
BLR,FRA,2010.0,2,0,2
TWN,BRA,2014.0,1,0,1
CYP,POL,2012.0,1,0,1
CZE,ECU,2021.0,2,0,2
KEN,THA,2007.0,2,0,2
,GRL,2003.0,4,0,4
GRL,,2015.0,4,0,4
ITA,NCL,2003.0,1,0,1
GUF,CHE,2000.0,1,0,1
ZWE,COG,2019.0,1,0,1
MAR,TUN,2003.0,3,0,3
IND,PER,2009.0,1,0,1
LTU,CZE,2011.0,1,0,1
EGY,ETH,2004.0,1,0,1
PRT,CYP,2019.0,1,0,1
KHM,SGP,2012.0,1,0,1
BLZ,TZA,2005.0,1,0,1
CRI,AUS,2008.0,1,0,1
SVK,LUX,2008.0,1,0,1
SAU,LBY,2021.0,1,0,1
,CCK,2010.0,3,0,3
ZWE,TUR,2014.0,1,0,1
NOR,TJK,2016.0,1,0,1
CIV,LKA,2002.0,1,0,1
BGR,IDN,2019.0,1,0,1
GRC,CMR,2010.0,1,0,1
MEX,JOR,2017.0,1,0,1
TUN,IRN,2019.0,1,0,1
VEN,AUS,2015.0,1,0,1
GUM,,2004.0,3,0,3
SLV,AUS,2020.0,1,0,1
,TLS,2010.0,7,0,7
KGZ,GHA,2011.0,1,0,1
FJI,FRA,2014.0,1,0,1
BGD,IRL,2017.0,2,0,2
EST,PRT,2019.0,2,0,2
IRN,CYP,2023.0,1,0,1
BEL,DOM,2017.0,1,0,1
GEO,CHN,2022.0,1,0,1
SVN,IRL,2018.0,1,0,1
KEN,POL,2023.0,1,0,1
KWT,KAZ,2017.0,1,0,1
KWT,HKG,2018.0,1,0,1
BLZ,,2020.0,3,0,3
SLE,GHA,2022.0,1,0,1
CAN,BMU,2019.0,1,0,1
SGP,IRQ,2017.0,1,0,1
CHE,LBN,2018.0,2,0,2
NGA,PNG,2003.0,1,0,1
DNK,VEN,2006.0,1,0,1
BRN,,2006.0,4,0,4
BMU,GBR,2015.0,2,0,2
KNA,CAN,2020.0,2,0,2
FRA,IRQ,2012.0,2,0,2
ITA,AFG,2017.0,1,0,1
IRL,IRQ,2021.0,2,0,2
MLI,NOR,2013.0,1,0,1
CAN,FRO,2008.0,1,0,1
LBN,DZA,2011.0,2,0,2
BLR,LTU,1999.0,1,0,1
FRA,LBY,2021.0,4,0,4
NLD,CYP,2002.0,1,0,1
CHE,SEN,2019.0,3,0,3
NCL,CHE,2018.0,1,0,1
CHE,NCL,2020.0,1,0,1
CRI,RUS,2003.0,1,0,1
AFG,EGY,2010.0,1,0,1
IRQ,SLV,2019.0,1,0,1
RUS,MNE,2023.0,2,0,2
,DNK,2021.0,13,0,13
CAF,MDG,2007.0,2,0,2
GUY,NIC,2020.0,1,0,1
,PER,2021.0,8,0,8
HRV,IDN,2005.0,1,0,1
ZWE,RWA,2008.0,2,0,2
GTM,,2001.0,5,0,5
BEN,KEN,2008.0,1,0,1
MKD,CHE,2007.0,1,0,1
FIN,NAM,2006.0,1,0,1
THA,ITA,2000.0,1,0,1
SWE,KEN,2006.0,3,0,3
MNG,IRL,2015.0,1,0,1
,SUR,2001.0,3,0,3
SWZ,ZAF,2000.0,3,0,3
CAN,PRI,2004.0,2,0,2
MEX,DOM,2000.0,1,0,1
SWE,ZWE,2013.0,1,0,1
FIN,OMN,2010.0,1,0,1
NGA,LSO,2001.0,1,0,1
HKG,HUN,2000.0,1,0,1
,MNE,2002.0,5,0,5
YEM,PAK,2000.0,1,0,1
JPN,LIE,2001.0,1,0,1
PHL,PER,2006.0,1,0,1
ARM,ARG,2014.0,1,0,1
PRI,CHL,2012.0,1,0,1
AUS,CMR,2018.0,1,0,1
JPN,CYP,2011.0,1,0,1
,GNQ,2002.0,4,0,4
NER,CHE,2022.0,1,0,1
DEU,COG,2005.0,1,0,1
MCO,GBR,2009.0,2,0,2
MLI,BFA,2004.0,1,0,1
DNK,FRO,2001.0,1,0,1
QAT,HUN,2017.0,1,0,1
SVN,MKD,2000.0,1,0,1
GHA,DNK,2000.0,1,0,1
GBR,MMR,2009.0,1,0,1
ITA,TUN,2004.0,3,0,3
SUR,,2017.0,7,0,7
MEX,IDN,1999.0,1,0,1
IDN,VNM,1999.0,2,0,2
LTU,CAN,1998.0,1,0,1
DZA,YEM,2000.0,1,0,1
USA,AZE,1999.0,1,0,1
SEN,PHL,2004.0,1,0,1
SVN,FRA,2000.0,2,0,2
KWT,CZE,2007.0,1,0,1
CYP,CAN,2015.0,1,0,1
PNG,NZL,2015.0,1,0,1
IDN,SRB,2017.0,1,0,1
ROU,POL,2009.0,1,0,1
IND,SYR,2010.0,1,0,1
TZA,HND,2016.0,1,0,1
FRA,KGZ,2015.0,1,0,1
IRQ,CAN,2012.0,1,0,1
,TLS,2006.0,2,0,2
ARM,UZB,2018.0,1,0,1
TWN,UKR,2020.0,1,0,1
EST,LUX,2018.0,1,0,1
MWI,LUX,2006.0,1,0,1
LUX,NZL,2013.0,1,0,1
JPN,MAC,2013.0,1,0,1
BEL,NGA,2006.0,1,0,1
DEU,BFA,2022.0,1,0,1
TUR,PRT,2005.0,2,0,2
NGA,DNK,2010.0,1,0,1
UKR,HUN,2001.0,1,0,1
DNK,CRI,2001.0,1,0,1
PRT,AND,2009.0,1,0,1
KWT,QAT,2015.0,3,0,3
ARM,NLD,2013.0,1,0,1
CHL,TUR,2013.0,1,0,1
LKA,NPL,2010.0,1,0,1
COL,TUR,2018.0,1,0,1
CUB,QAT,2006.0,1,0,1
TZA,MDG,2019.0,1,0,1
BEL,ARE,2009.0,1,0,1
,GUM,2001.0,3,0,3
SWZ,GBR,2015.0,1,0,1
SYC,,2005.0,1,0,1
VEN,PRI,2015.0,1,0,1
WSM,MYS,2004.0,1,0,1
BEN,GEO,2021.0,1,0,1
FRA,TTO,2006.0,1,0,1
JPN,YEM,2011.0,1,0,1
CCK,,2020.0,1,0,1
TTO,MSR,2012.0,1,0,1
JPN,MAR,2015.0,1,0,1
PRT,NZL,2010.0,3,0,3
VNM,HKG,2018.0,1,0,1
IRN,AFG,2023.0,4,0,4
CHN,BLR,2003.0,1,0,1
KOR,BLR,2013.0,1,0,1
,VCT,2019.0,1,0,1
AUS,MLT,2022.0,3,0,3
BEN,JPN,2023.0,1,0,1
COD,CAN,2022.0,2,0,2
MWI,DEU,2023.0,1,0,1
,COM,2019.0,1,0,1
BEL,SPM,2007.0,1,0,1
AUS,ARE,2002.0,1,0,1
ITA,MAR,2010.0,1,0,1
GRD,ESP,2019.0,2,0,2
IDN,SWE,1998.0,1,0,1
GUM,,2008.0,4,0,4
KWT,GRC,2003.0,1,0,1
SAU,SEN,2016.0,1,0,1
MWI,ISL,2023.0,1,0,1
SWE,KAZ,1998.0,1,0,1
NLD,NIU,2007.0,1,0,1
KNA,ARE,2022.0,1,0,1
UGA,NLD,1998.0,1,0,1
NLD,UGA,1999.0,2,0,2
ARG,DOM,2007.0,1,0,1
ALB,USA,1997.0,1,0,1
GUY,TTO,2001.0,1,0,1
FIN,BLR,1998.0,1,0,1
BLR,FIN,2013.0,1,0,1
JPN,QAT,2009.0,1,0,1
ETH,PHL,2005.0,1,0,1
NLD,YEM,2001.0,2,0,2
GRC,LBN,2001.0,1,0,1
FIN,CHL,1999.0,1,0,1
COL,PER,2000.0,1,0,1
MCO,BEL,2009.0,1,0,1
GRD,,2009.0,1,0,1
GAB,ZAF,2006.0,1,0,1
ESP,MSR,2004.0,1,0,1
LUX,LTU,2011.0,1,0,1
NZL,MAC,2014.0,2,0,2
URY,HUN,2013.0,1,0,1
JOR,ZAF,2016.0,1,0,1
BHS,KWT,2016.0,1,0,1
PRI,THA,2018.0,1,0,1
MTQ,COL,2016.0,1,0,1
CHN,GEO,2014.0,1,0,1
ERI,NLD,2010.0,1,0,1
CHE,ISL,2019.0,5,0,5
GRC,NZL,2011.0,1,0,1
BWA,TZA,2016.0,2,0,2
ROU,NGA,2012.0,1,0,1
MKD,IRL,2022.0,1,0,1
TWN,SVK,2022.0,1,0,1
CRI,HUN,2010.0,1,0,1
SAU,CIV,2016.0,1,0,1
IND,NAM,2019.0,1,0,1
SAU,CMR,2018.0,1,0,1
USA,DOM,2008.0,1,0,1
AUS,MUS,2015.0,1,0,1
BEN,KEN,2014.0,1,0,1
IND,BGR,2013.0,1,0,1
ARM,IRN,2017.0,1,0,1
USA,SLV,2013.0,2,0,2
ISL,SVN,2019.0,1,0,1
HKG,AUT,2014.0,2,0,2
VNM,TZA,2015.0,1,0,1
DMA,CAN,2013.0,2,0,2
AUS,PSE,2014.0,1,0,1
FRA,GHA,1999.0,1,0,1
IRN,SYR,2011.0,1,0,1
SRB,AUS,2006.0,1,0,1
DOM,NLD,2011.0,1,0,1
ESP,ETH,2000.0,1,0,1
JPN,GTM,2007.0,1,0,1
OMN,MAR,2002.0,1,0,1
ZMB,MWI,2007.0,1,0,1
TWN,COL,2017.0,1,0,1
GIN,BFA,2014.0,1,0,1
PER,SGP,2023.0,1,0,1
KEN,SAU,2022.0,1,0,1
,FRO,2013.0,7,0,7
BIH,SVK,2017.0,1,0,1
IRL,BGR,2023.0,1,0,1
LTU,KOR,2017.0,1,0,1
ARG,EGY,2021.0,2,0,2
TWN,ARG,2018.0,1,0,1
AUS,LTU,2021.0,2,0,2
GEO,CHN,2017.0,1,0,1
MWI,FRA,2014.0,1,0,1
SVN,EST,2017.0,2,0,2
BRA,DOM,2016.0,1,0,1
TUR,TJK,2021.0,1,0,1
COG,KHM,2020.0,1,0,1
MMR,NLD,2022.0,1,0,1
TUN,HUN,2022.0,1,0,1
CAN,SEN,1999.0,1,0,1
IND,GIN,2011.0,1,0,1
JPN,ARE,2005.0,2,0,2
LIE,FRA,2001.0,1,0,1
GHA,CHN,2007.0,1,0,1
THA,BEL,2002.0,2,0,2
DOM,ESP,2008.0,1,0,1
NLD,AFG,2006.0,1,0,1
FJI,GBR,1999.0,1,0,1
ZAF,NIC,2015.0,1,0,1
FIN,QAT,2018.0,1,0,1
GHA,BEL,2019.0,1,0,1
SDN,KOR,2021.0,2,0,2
UKR,BLR,2016.0,2,0,2
AFG,GBR,2011.0,1,0,1
UKR,JOR,2020.0,2,0,2
BIH,CHL,2012.0,1,0,1
CAN,GUM,2015.0,1,0,1
CIV,MLI,2023.0,1,0,1
TZA,ZMB,2016.0,1,0,1
ISL,FIN,2014.0,1,0,1
CAN,MNG,2017.0,2,0,2
BEL,LAO,2012.0,1,0,1
SEN,ITA,2021.0,2,0,2
COL,NER,2014.0,1,0,1
MYS,TZA,2021.0,2,0,2
RWA,CHE,2023.0,1,0,1
PHL,MEX,2014.0,1,0,1
CAN,COD,2020.0,2,0,2
NGA,AUT,2020.0,5,0,5
COL,BRB,2019.0,1,0,1
BEL,VEN,2012.0,2,0,2
CHL,URY,2007.0,1,0,1
ZAF,BGD,2015.0,1,0,1
PER,BOL,2017.0,3,0,3
CHE,LKA,2015.0,1,0,1
HKG,ISR,2005.0,1,0,1
MOZ,COG,2011.0,1,0,1
BEL,CIV,2013.0,2,0,2
MDV,,2014.0,1,0,1
FRA,GIN,2001.0,1,0,1
RUS,MNE,2000.0,1,0,1
COG,SWZ,2020.0,1,0,1
KEN,ZMB,1999.0,1,0,1
ETH,TUN,2010.0,1,0,1
NOR,ETH,2006.0,2,0,2
NLD,FLK,2006.0,1,0,1
NGA,AUT,2007.0,1,0,1
TZA,RWA,2001.0,1,0,1
CAN,PYF,2009.0,1,0,1
SRB,TWN,2001.0,1,0,1
TWN,SRB,2017.0,1,0,1
ITA,BIH,2005.0,2,0,2
GEO,KEN,2019.0,1,0,1
FIN,THA,2007.0,1,0,1
DJI,,2012.0,2,0,2
MCO,GRC,2003.0,1,0,1
DEU,BHR,2003.0,2,0,2
FRA,OMN,2002.0,1,0,1
UGA,RWA,1997.0,1,0,1
LBY,CHN,2001.0,1,0,1
AGO,ITA,2004.0,1,0,1
CRI,COL,2000.0,1,0,1
BLR,ROU,2008.0,1,0,1
BEL,URY,2000.0,1,0,1
ISR,SVK,2001.0,1,0,1
PAN,FRA,2003.0,2,0,2
VUT,,2014.0,2,0,2
AUS,MUS,2004.0,1,0,1
TWN,MYS,2006.0,1,0,1
PHL,TUR,2004.0,1,0,1
PHL,BRA,2008.0,1,0,1
FRA,CAF,2009.0,3,0,3
AUS,WSM,2000.0,2,0,2
GBR,GRD,2021.0,1,0,1
SYR,AFG,2006.0,1,0,1
ESP,MOZ,2007.0,2,0,2
MAC,MAR,2021.0,1,0,1
NER,,2005.0,4,0,4
KAZ,TUR,2006.0,1,0,1
PER,SWE,2014.0,1,0,1
MAC,TWN,2002.0,1,0,1
TWN,MAC,2004.0,1,0,1
KOR,SVN,2007.0,1,0,1
AUT,PNG,2008.0,1,0,1
VEN,OMN,2001.0,1,0,1
LBN,AUS,1998.0,1,0,1
PER,ARG,2006.0,2,0,2
MYS,IRL,2001.0,1,0,1
BRB,CAN,2012.0,1,0,1
BLR,SWE,2011.0,2,0,2
BRB,BHS,2017.0,1,0,1
MUS,RUS,2012.0,1,0,1
FRA,MOZ,2010.0,1,0,1
BEL,PRI,2017.0,1,0,1
MYS,KEN,2007.0,1,0,1
CAF,,2014.0,2,0,2
CHE,LUX,2004.0,1,0,1
CZE,PRT,2005.0,3,0,3
BEL,ECU,2004.0,2,0,2
NCL,GLP,2015.0,1,0,1
,SUR,2004.0,5,0,5
CHE,MAR,2017.0,2,0,2
SWE,TUN,2009.0,1,0,1
IDN,PER,2014.0,2,0,2
,TCD,2004.0,7,0,7
BRA,SLV,2008.0,2,0,2
NZL,TWN,2004.0,1,0,1
ASM,USA,2007.0,1,0,1
ARG,PAN,2011.0,1,0,1
PNG,CZE,2018.0,2,0,2
KOR,LAO,2012.0,1,0,1
GUF,SEN,2014.0,2,0,2
MNE,USA,2019.0,1,0,1
PRI,VEN,2001.0,1,0,1
MNE,POL,2017.0,1,0,1
POL,MNE,2018.0,1,0,1
MKD,CHN,2014.0,1,0,1
OMN,PSE,2019.0,1,0,1
AUS,MOZ,2015.0,1,0,1
EGY,SOM,2011.0,1,0,1
BHS,GBR,2003.0,1,0,1
,TON,1995.0,1,0,1
THA,SAU,2013.0,1,0,1
LUX,TWN,2023.0,1,0,1
ESP,PRY,1998.0,2,0,2
FRA,ALB,2018.0,1,0,1
CZE,THA,2018.0,3,0,3
SWE,TUR,2000.0,4,0,4
HRV,LUX,2001.0,1,0,1
NLD,QAT,2008.0,1,0,1
CHE,BOL,2019.0,1,0,1
HUN,LBY,2006.0,1,0,1
MAC,SGP,2011.0,1,0,1
BEL,ALB,2017.0,2,0,2
BGD,TUR,2016.0,1,0,1
PHL,TUR,2014.0,1,0,1
ROU,NZL,2014.0,1,0,1
PER,DEU,2013.0,2,0,2
ABW,,2019.0,2,0,2
CAN,MCO,2020.0,1,0,1
GUM,,2015.0,5,0,5
CMR,KOR,2022.0,1,0,1
BEL,LVA,2017.0,1,0,1
FIN,SAU,2022.0,2,0,2
AUS,ECU,2023.0,1,0,1
EGY,BRA,2023.0,2,0,2
DNK,PER,2018.0,1,0,1
DOM,ARG,2017.0,1,0,1
IDN,KHM,2003.0,1,0,1
RWA,NAM,2015.0,1,0,1
UKR,HUN,2008.0,1,0,1
CIV,BFA,2002.0,1,0,1
MAC,RUS,2020.0,1,0,1
CHL,IRL,2020.0,2,0,2
VEN,THA,2016.0,1,0,1
CAN,HND,2023.0,2,0,2
SLE,SEN,2021.0,2,0,2
IDN,BRN,2012.0,1,0,1
ETH,LTU,2020.0,1,0,1
KAZ,NLD,2022.0,1,0,1
DNK,LBR,2017.0,2,0,2
LBR,VNM,2020.0,1,0,1
MWI,MDG,2005.0,1,0,1
ISL,CAN,1997.0,1,0,1
UKR,ISR,1997.0,2,0,2
GBR,SXM,2022.0,1,0,1
FSM,AUS,2021.0,1,0,1
EST,ITA,1999.0,1,0,1
PAK,KWT,2012.0,2,0,2
ITA,KHM,2019.0,1,0,1
BLR,VNM,2016.0,1,0,1
LBN,ISR,2016.0,2,0,2
BRN,BGD,1997.0,2,0,2
NER,DEU,2003.0,1,0,1
SYR,EGY,2002.0,2,0,2
CZE,DNK,2001.0,2,0,2
NLD,TGO,2001.0,1,0,1
MEX,CRI,2006.0,1,0,1
HKG,PHL,2000.0,2,0,2
AND,,2015.0,1,0,1
NZL,EGY,2000.0,1,0,1
AUS,MCO,2023.0,1,0,1
SAU,TUN,2024.0,1,0,1
SYR,AUT,2021.0,3,0,3
VNM,KOR,1997.0,1,0,1
AUT,COL,2002.0,1,0,1
SAU,LBN,2000.0,2,0,2
URY,NZL,2019.0,1,0,1
HND,CHN,2014.0,1,0,1
NZL,EST,2004.0,1,0,1
GMB,TWN,2005.0,1,0,1
ARE,KAZ,2012.0,1,0,1
AUS,NCL,2007.0,2,0,2
TUR,SRB,1999.0,1,0,1
CHN,IRQ,2003.0,1,0,1
CAN,ARE,1997.0,2,0,2
COG,CMR,1999.0,1,0,1
ZWE,DNK,2007.0,1,0,1
SWE,MAC,2000.0,1,0,1
HKG,ISR,1997.0,2,0,2
KWT,HUN,2013.0,1,0,1
POL,TWN,1999.0,1,0,1
SVK,KOR,2006.0,1,0,1
SRB,SWE,1997.0,1,0,1
LUX,MTQ,2019.0,1,0,1
CHN,LBN,2001.0,1,0,1
SVK,QAT,2013.0,1,0,1
AUT,MEX,2002.0,1,0,1
TUR,ESP,2002.0,1,0,1
SLV,,2005.0,1,0,1
ISR,SVK,2008.0,1,0,1
VNM,ARM,2022.0,1,0,1
PAK,ROU,2012.0,1,0,1
CUB,PER,2014.0,2,0,2
BHR,PRT,2017.0,1,0,1
HRV,MCO,2014.0,1,0,1
GEO,BRA,2011.0,1,0,1
BEN,CIV,2013.0,2,0,2
DZA,NGA,2011.0,1,0,1
CHL,LVA,2021.0,1,0,1
THA,TZA,2009.0,1,0,1
TGO,BFA,2012.0,1,0,1
GUY,USA,2023.0,1,0,1
PRI,CAN,2009.0,1,0,1
CAN,VGB,2010.0,1,0,1
DNK,BOL,2010.0,1,0,1
GRC,LUX,2015.0,1,0,1
LUX,DZA,2012.0,1,0,1
LVA,NLD,2013.0,1,0,1
VEN,PRY,2014.0,1,0,1
ETH,LKA,2018.0,1,0,1
ITA,MKD,2016.0,2,0,2
GAB,KHM,2018.0,1,0,1
CHE,BRB,2010.0,1,0,1
TTO,PAK,2021.0,1,0,1
TUR,LBY,2010.0,1,0,1
,PLW,2007.0,1,0,1
BRA,DOM,2017.0,1,0,1
BRA,BLR,2010.0,2,0,2
SDN,JOR,2012.0,1,0,1
EGY,BGR,2023.0,1,0,1
HKG,TLS,2017.0,2,0,2
NLD,ARM,2021.0,1,0,1
CIV,LTU,2016.0,2,0,2
FIN,MMR,2017.0,3,0,3
CMR,TGO,2021.0,1,0,1
GAB,NLD,2020.0,2,0,2
IRL,IDN,2017.0,1,0,1
QAT,KWT,2006.0,1,0,1
HND,CAN,2020.0,1,0,1
FRA,AND,2023.0,1,0,1
CAN,LTU,2019.0,2,0,2
FIN,QAT,2016.0,3,0,3
SYR,JPN,2019.0,3,0,3
ARE,PHL,2022.0,1,0,1
BLR,IRN,2019.0,1,0,1
,CYM,2016.0,4,0,4
GEO,CZE,2019.0,2,0,2
SRB,BIH,1999.0,3,0,3
FJI,VUT,2017.0,1,0,1
GBR,ARG,2024.0,1,0,1
MKD,BEL,2017.0,1,0,1
ISR,CMR,2019.0,1,0,1
GUY,KOR,2019.0,1,0,1
NZL,SYR,2017.0,1,0,1
GBR,URY,2022.0,2,0,2
ITA,UZB,2022.0,3,0,3
COL,SAU,2023.0,1,0,1
PLW,NZL,2019.0,1,0,1
,PLW,2020.0,2,0,2
PRY,PER,2023.0,1,0,1
ALB,MEX,2023.0,1,0,1
TTO,NLD,2008.0,2,0,2
,GUY,2002.0,4,0,4
CYP,IND,2007.0,1,0,1
IND,CYP,2009.0,1,0,1
TTO,VEN,2007.0,1,0,1
CAN,ERI,2007.0,1,0,1
MAR,BFA,2010.0,1,0,1
MNE,SVN,2006.0,1,0,1
TUR,NZL,2006.0,1,0,1
PAK,LBR,2009.0,2,0,2
ITA,MCO,2007.0,1,0,1
ZWE,SLE,2019.0,1,0,1
JOR,KWT,2005.0,2,0,2
MYS,KHM,2003.0,1,0,1
NOR,CYM,2009.0,1,0,1
UGA,CHE,2017.0,1,0,1
IDN,ZAF,2008.0,1,0,1
ESP,CPV,2012.0,1,0,1
KNA,GBR,2015.0,2,0,2
FIN,MYS,2008.0,1,0,1
DZA,BEL,2003.0,1,0,1
SSD,GBR,2012.0,1,0,1
UKR,IRL,2013.0,2,0,2
GRC,IRQ,2011.0,1,0,1
MWI,MOZ,2004.0,1,0,1
TUN,CHE,2014.0,3,0,3
FLK,,2021.0,2,0,2
NGA,DZA,2020.0,1,0,1
COL,SGP,2019.0,2,0,2
IND,ZWE,2022.0,2,0,2
NLD,BES,2020.0,2,0,2
MAR,PRT,2024.0,1,0,1
BOL,NLD,2003.0,2,0,2
ESP,LSO,2006.0,1,0,1
AUS,VUT,2010.0,1,0,1
CZE,BRA,1997.0,1,0,1
USA,BHS,2005.0,1,0,1
BLR,SVK,1999.0,1,0,1
NPL,POL,2005.0,1,0,1
MKD,JPN,2005.0,1,0,1
TZA,GNB,2010.0,1,0,1
ETH,SWZ,2020.0,1,0,1
CYP,BEL,2004.0,1,0,1
NOR,IRQ,2014.0,1,0,1
TWN,ESP,2000.0,1,0,1
COL,TUR,2017.0,1,0,1
GRD,GBR,2015.0,1,0,1
ECU,BRA,2001.0,1,0,1
JPN,CHL,1998.0,1,0,1
LBY,USA,2003.0,1,0,1
BGD,SEN,2005.0,1,0,1
NGA,IDN,2001.0,1,0,1
KWT,NLD,1999.0,1,0,1
SDN,NGA,2014.0,1,0,1
ESP,MKD,2017.0,1,0,1
BLZ,USA,2018.0,3,0,3
HUN,CHN,2004.0,1,0,1
BRA,DMA,2018.0,1,0,1
SEN,DEU,2000.0,1,0,1
IND,CIV,2019.0,1,0,1
FRA,ETH,2013.0,1,0,1
GUF,GLP,2000.0,2,0,2
COL,KHM,2015.0,1,0,1
MMR,CHE,2021.0,1,0,1
ARM,AUS,2006.0,2,0,2
POL,HKG,2017.0,2,0,2
GBR,SLV,2015.0,1,0,1
BIH,DNK,2020.0,1,0,1
IND,BRB,2018.0,1,0,1
POL,ETH,2014.0,1,0,1
MAR,BFA,2023.0,1,0,1
VNM,EGY,2016.0,1,0,1
BGD,HKG,2012.0,1,0,1
NGA,TUN,2014.0,1,0,1
SRB,BGR,2008.0,1,0,1
KEN,SGP,2023.0,1,0,1
MEX,GTM,2010.0,2,0,2
SWE,BWA,2020.0,2,0,2
BIH,OMN,2022.0,1,0,1
GNQ,MLI,2021.0,1,0,1
CAN,MLI,2017.0,2,0,2
ITA,UZB,2018.0,1,0,1
MYS,LUX,2018.0,1,0,1
QAT,IDN,2022.0,1,0,1
COL,HND,2019.0,1,0,1
ZAF,MAR,2018.0,1,0,1
COG,MDG,2020.0,1,0,1
,VUT,2017.0,8,0,8
TUR,HUN,2022.0,2,0,2
GEO,NOR,2020.0,1,0,1
MAR,SWE,2023.0,2,0,2
ESP,MKD,2022.0,2,0,2
THA,ETH,2014.0,1,0,1
SAU,FIN,2023.0,3,0,3
HRV,MKD,2019.0,2,0,2
CUB,AUT,2023.0,2,0,2
UGA,SEN,2022.0,2,0,2
MLI,UGA,2022.0,1,0,1
KOR,BEL,2024.0,2,0,2
COD,EGY,2023.0,1,0,1
TON,,2008.0,1,0,1
SEN,COG,2015.0,1,0,1
MDA,LTU,2016.0,1,0,1
MDA,LTU,2018.0,1,0,1
LTU,MDA,2023.0,1,0,1
MKD,NLD,2009.0,2,0,2
CHN,KGZ,2006.0,1,0,1
BFA,NER,2008.0,1,0,1
MYS,ALB,2008.0,1,0,1
,SLB,2002.0,1,0,1
DMA,,2018.0,2,0,2
THA,ISR,2013.0,1,0,1
NLD,COD,2006.0,2,0,2
OMN,KEN,2017.0,1,0,1
TZA,FIN,2010.0,1,0,1
MDA,GBR,2009.0,1,0,1
FIN,CHL,2007.0,1,0,1
ITA,ETH,2007.0,3,0,3
MWI,SWE,2008.0,1,0,1
NLD,DZA,2014.0,1,0,1
CHE,ARM,2005.0,1,0,1
BHR,IRQ,2010.0,1,0,1
MUS,,2010.0,5,0,5
BRA,IDN,2017.0,1,0,1
ARM,AZE,2016.0,1,0,1
MLT,CZE,2009.0,1,0,1
ARG,CHN,2007.0,1,0,1
CHN,ARG,2010.0,1,0,1
CHE,MNG,2022.0,1,0,1
KWT,SYR,2004.0,1,0,1
GBR,NAM,2003.0,1,0,1
VEN,CHE,2007.0,2,0,2
TKL,,2011.0,1,0,1
NLD,PAN,2016.0,1,0,1
TJK,KAZ,2017.0,1,0,1
FRA,HTI,2010.0,1,0,1
KOR,BGR,2015.0,2,0,2
CAN,LKA,2009.0,2,0,2
CAN,MCO,2007.0,1,0,1
RWA,BDI,2010.0,1,0,1
FRA,GHA,2020.0,2,0,2
LBY,ITA,2006.0,1,0,1
MTQ,ESP,2012.0,1,0,1
IND,FJI,2002.0,1,0,1
DEU,BEN,2005.0,3,0,3
EGY,ZMB,2005.0,1,0,1
BLZ,THA,2016.0,1,0,1
AUS,KHM,2014.0,4,0,4
CYM,DEU,2016.0,1,0,1
ISL,FRA,2005.0,1,0,1
CHE,PAN,2014.0,1,0,1
PER,IRL,2002.0,1,0,1
MDG,CAF,2012.0,1,0,1
DEU,LIE,2008.0,4,0,4
HUN,CYP,2003.0,1,0,1
MMR,VNM,2017.0,1,0,1
PAK,SDN,2016.0,1,0,1
HUN,GRC,2007.0,2,0,2
MEX,SLV,2010.0,2,0,2
BLZ,CAN,2013.0,1,0,1
,GNB,1999.0,2,0,2
GIN,ITA,2009.0,1,0,1
CIV,MLI,2006.0,3,0,3
BEN,LBR,2016.0,1,0,1
ISR,EST,2022.0,2,0,2
SLB,,2004.0,1,0,1
SAU,LBN,2006.0,2,0,2
PAK,NLD,2000.0,1,0,1
ARM,PRT,2012.0,1,0,1
ISR,DZA,2001.0,1,0,1
CZE,IDN,2014.0,1,0,1
SRB,VNM,2015.0,1,0,1
PAK,NOR,2011.0,2,0,2
IND,SDN,2003.0,1,0,1
MMR,BEL,2022.0,1,0,1
FLK,PER,2006.0,1,0,1
NOR,IDN,2014.0,2,0,2
DNK,KAZ,2013.0,1,0,1
TUR,MNG,2006.0,1,0,1
COL,ISR,2008.0,1,0,1
BRA,OMN,2006.0,1,0,1
,BTN,1999.0,2,0,2
BLR,IRL,2007.0,1,0,1
CAN,GRD,2006.0,1,0,1
VUT,NCL,2003.0,1,0,1
TKM,CHN,2013.0,1,0,1
GIN,GNQ,2008.0,2,0,2
ITA,VAT,2011.0,1,0,1
BEN,ETH,2012.0,1,0,1
CMR,ROU,2010.0,1,0,1
PRI,GUY,2006.0,1,0,1
FRA,LTU,2012.0,3,0,3
SAU,SRB,2018.0,1,0,1
CMR,CAF,2009.0,2,0,2
GIN,AUS,2012.0,1,0,1
NGA,IRN,2017.0,1,0,1
BEN,NER,2020.0,1,0,1
KWT,IRQ,2014.0,1,0,1
BEN,ESP,2013.0,1,0,1
BGD,MMR,2019.0,1,0,1
SDN,AUS,2012.0,1,0,1
MMR,LAO,2018.0,1,0,1
PHL,NPL,2020.0,1,0,1
CRI,PAN,2012.0,1,0,1
BEL,BRB,2018.0,1,0,1
IND,VNM,2016.0,2,0,2
HRV,DZA,2014.0,1,0,1
GAB,CHE,2014.0,1,0,1
BEL,MLT,2013.0,1,0,1
PAK,NLD,2006.0,1,0,1
BLR,KOR,2019.0,2,0,2
GHA,IDN,2021.0,1,0,1
MEX,SAU,2015.0,1,0,1
COG,RWA,2018.0,3,0,3
BIH,AUT,2017.0,1,0,1
TWN,TZA,2018.0,1,0,1
URY,COL,2008.0,1,0,1
MEX,ISL,2022.0,1,0,1
PAN,PER,2020.0,1,0,1
SYR,JPN,2021.0,2,0,2
MUS,MDG,2020.0,1,0,1
MEX,ZAF,2021.0,2,0,2
LAO,NLD,2020.0,1,0,1
DNK,SDN,2002.0,1,0,1
COL,ITA,2001.0,1,0,1
AUT,COL,2012.0,1,0,1
SVK,HUN,1997.0,2,0,2
DNK,ECU,1999.0,1,0,1
BEL,HRV,2006.0,1,0,1
CAN,IDN,2020.0,8,4,4
MEX,CRI,2021.0,7,5,2
FRA,MDA,2017.0,2,1,1
FRA,SYC,2016.0,1,1,0
KOR,MNG,2022.0,4,5,-1
TUR,NOR,2014.0,4,5,-1
GBR,UZB,2017.0,1,1,0
ROU,IRN,2014.0,2,2,0
LVA,EST,2020.0,4,6,-2
EGY,AUT,2016.0,5,5,0
VNM,LAO,2019.0,5,3,2
USA,VNM,2010.0,22,11,11
GEO,FRA,2019.0,9,7,2
PAK,POL,2023.0,10,1,9
USA,LKA,2016.0,21,11,10
ITA,TUR,2022.0,16,26,-10
AUS,ECU,2019.0,5,2,3
ITA,YEM,2021.0,1,1,0
MWI,DEU,2021.0,1,3,-2
AUS,TUR,2022.0,13,9,4
DEU,ZAF,2023.0,11,21,-10
TWN,IRQ,2019.0,1,1,0
NGA,ISR,2020.0,1,1,0
MYS,TWN,2015.0,2,8,-6
EGY,DZA,2005.0,1,1,0
DEU,URY,2016.0,4,4,0
BLR,CHN,2020.0,2,3,-1
PER,CAN,2020.0,2,1,1
COL,VEN,2019.0,10,38,-28
NLD,JOR,2020.0,1,1,0
MWI,NOR,2017.0,1,1,0
SVK,NZL,2018.0,1,2,-1
CHN,KGZ,2021.0,2,1,1
LTU,GEO,2021.0,1,1,0
PRT,ARG,2022.0,3,4,-1
PSE,USA,2023.0,3,3,0
PRT,PER,2022.0,2,1,1
GHA,KOR,2019.0,2,5,-3
BGD,IDN,2023.0,3,1,2
NOR,NGA,2021.0,3,2,1
GHA,NGA,2023.0,4,4,0
DZA,ITA,2022.0,5,6,-1
ROU,IRQ,2020.0,5,2,3
IRL,PAK,2017.0,8,7,1
HTI,FRA,2022.0,3,2,1
ARE,IND,2014.0,8,40,-32
PRK,CHN,2022.0,10,12,-2
CHE,SAU,2022.0,6,4,2
TWN,IRN,2023.0,4,3,1
USA,ATG,2022.0,4,2,2
ETH,JPN,2023.0,6,5,1
GBR,AFG,2018.0,5,2,3
BHR,JOR,2022.0,4,4,0
SLB,AUS,2023.0,2,1,1
BHR,IRQ,2019.0,2,1,1
ITA,GRC,2023.0,16,15,1
SWE,HKG,2013.0,2,4,-2
NOR,UGA,2022.0,5,3,2
UZB,KAZ,2021.0,3,2,1
RWA,CHN,2023.0,3,5,-2
CAN,QAT,2010.0,9,3,6
THA,KOR,2022.0,10,12,-2
NLD,ECU,2015.0,8,4,4
BOL,ESP,2012.0,2,1,1
USA,MMR,2011.0,1,1,0
NOR,IND,2017.0,14,12,2
ZAF,ITA,2010.0,4,5,-1
KEN,DEU,2007.0,5,13,-8
KHM,THA,2017.0,3,5,-2
AUT,HUN,2018.0,12,30,-18
CHE,IRN,2015.0,7,39,-32
JPN,IRL,2004.0,7,3,4
IRL,JPN,2005.0,4,5,-1
SVK,FRA,2004.0,4,4,0
CHE,IRL,2010.0,14,11,3
RUS,AUS,2006.0,12,7,5
KWT,USA,2010.0,8,17,-9
SWE,CZE,2017.0,8,20,-12
FRA,TWN,2011.0,16,8,8
KHM,CHE,2008.0,1,2,-1
PRT,MOZ,2016.0,6,2,4
ARE,AUT,2022.0,3,4,-1
CHE,IDN,2014.0,4,1,3
SGP,ITA,2014.0,8,14,-6
NOR,VNM,2012.0,1,2,-1
MYS,KOR,2011.0,5,14,-9
BGD,DEU,2023.0,10,4,6
SAU,KWT,2019.0,13,2,11
SGP,CAN,2012.0,30,31,-1
CHL,BRA,2012.0,12,15,-3
ZAF,BWA,2012.0,10,11,-1
BRA,MEX,2000.0,8,9,-1
ISL,AUT,2012.0,1,1,0
USA,HND,2012.0,1,2,-1
FRA,NPL,2019.0,2,1,1
HUN,ITA,2010.0,14,12,2
SWE,AUT,2012.0,12,15,-3
CMR,FRA,2005.0,9,19,-10
ARE,CYP,2020.0,2,2,0
ROU,TWN,2007.0,1,1,0
QAT,IRN,2015.0,1,2,-1
JPN,IRN,2013.0,18,9,9
MWI,DEU,2009.0,2,1,1
ARE,ZAF,2022.0,4,7,-3
CHE,COL,2010.0,2,6,-4
PRT,ARE,2019.0,4,2,2
BEL,BFA,2014.0,1,1,0
SAU,OMN,2010.0,5,1,4
IRN,IRQ,2014.0,6,13,-7
BEL,KOR,2014.0,13,8,5
PHL,TWN,2009.0,2,3,-1
ZAF,BEL,2023.0,10,8,2
ARG,MEX,2008.0,11,9,2
IND,TZA,2012.0,2,2,0
MKD,SRB,2014.0,9,4,5
EST,LVA,2012.0,1,2,-1
UKR,SVK,2022.0,7,2,5
CZE,SWE,2012.0,8,9,-1
ARE,BEL,2014.0,1,1,0
LBN,ARE,2013.0,3,2,1
MYS,THA,2019.0,9,8,1
CHL,NZL,2015.0,4,6,-2
ITA,EGY,2012.0,4,6,-2
MYS,THA,2009.0,4,3,1
USA,ZMB,2014.0,21,14,7
SWE,VNM,2006.0,2,2,0
EGY,KAZ,2010.0,1,1,0
KAZ,USA,2011.0,4,7,-3
IND,FRA,1998.0,16,8,8
TUR,CHL,2016.0,1,1,0
CZE,TUR,2019.0,6,7,-1
CAN,CHN,1997.0,30,31,-1
CHE,ISR,2017.0,16,20,-4
BEL,GRC,2012.0,11,21,-10
JPN,MEX,2007.0,5,2,3
SGP,AUT,2020.0,4,2,2
BRA,BOL,2010.0,3,1,2
AUT,SRB,2012.0,6,2,4
USA,ETH,2007.0,10,6,4
SWE,NGA,2016.0,3,1,2
SAU,SWE,2014.0,5,7,-2
BRA,JPN,2009.0,9,11,-2
AUS,CHL,2012.0,9,11,-2
IDN,MEX,2017.0,1,1,0
CAN,BGD,2005.0,5,7,-2
CZE,SWE,2002.0,4,5,-1
KWT,GBR,2018.0,7,24,-17
FRA,BEN,2008.0,9,9,0
DEU,CMR,2023.0,8,1,7
HRV,AUS,2015.0,1,1,0
IRL,ISL,2018.0,1,1,0
HRV,CAN,2022.0,3,2,1
CRI,HND,2008.0,1,1,0
ESP,URY,1997.0,5,2,3
TZA,BFA,2021.0,1,1,0
USA,MAC,2006.0,6,1,5
NLD,HRV,2023.0,1,5,-4
EGY,BGD,2013.0,1,1,0
SGP,SWE,2020.0,14,8,6
ESP,TWN,2016.0,5,3,2
ESP,SVN,2015.0,6,4,2
ETH,DNK,2018.0,2,1,1
FRA,MLI,2007.0,1,7,-6
PRY,URY,2018.0,1,2,-1
OMN,IND,2002.0,4,4,0
BEL,BEN,2017.0,5,3,2
TWN,CHE,2023.0,5,3,2
PHL,KOR,2018.0,11,10,1
NZL,CZE,2019.0,4,3,1
ITA,IRN,2015.0,15,39,-24
COL,GBR,2011.0,9,11,-2
SGP,THA,2015.0,10,6,4
ZAF,BEL,2006.0,6,8,-2
CAF,SEN,2014.0,1,2,-1
PRK,CHN,2016.0,3,4,-1
DNK,PRT,2021.0,6,15,-9
SAU,QAT,2003.0,2,3,-1
ITA,CYP,2015.0,5,3,2
CHL,POL,2023.0,3,1,2
EGY,ITA,2020.0,13,16,-3
JPN,IDN,1999.0,11,7,4
MAC,TWN,2020.0,3,4,-1
NOR,UKR,2008.0,1,2,-1
NIC,USA,2016.0,4,2,2
VEN,MEX,2012.0,9,6,3
POL,NLD,2003.0,18,9,9
SDN,CHN,2015.0,6,5,1
HKG,CHE,2013.0,6,6,0
ITA,SGP,2011.0,6,2,4
KAZ,FRA,2014.0,1,1,0
USA,EST,2015.0,5,3,2
GRC,AUT,2011.0,8,2,6
BRA,CHE,2000.0,7,6,1
CAN,BEL,1999.0,10,19,-9
FIN,IRN,2020.0,7,44,-37
FRA,MCO,1998.0,4,5,-1
IND,AFG,2013.0,1,1,0
ZAF,CHE,2023.0,10,7,3
MUS,IND,2015.0,2,2,0
ARE,USA,2007.0,10,27,-17
ITA,HKG,2021.0,8,1,7
SDN,MYS,2020.0,2,14,-12
ISR,PRT,2016.0,2,2,0
RUS,CHN,2000.0,9,5,4
NCL,FRA,2011.0,37,15,22
ESP,IRQ,2021.0,3,3,0
AUS,URY,2020.0,1,3,-2
ESP,IRL,2003.0,9,1,8
MOZ,ZAF,2018.0,3,5,-2
UKR,CHE,2022.0,9,1,8
YEM,IND,2021.0,6,19,-13
SWE,IND,2000.0,6,13,-7
ITA,NZL,1997.0,1,2,-1
HKG,MAC,2006.0,10,5,5
SWE,TUR,2019.0,7,28,-21
IDN,IND,2020.0,14,47,-33
MYS,CHE,2022.0,3,2,1
SGP,LKA,2022.0,2,3,-1
ZWE,GBR,2023.0,5,7,-2
KEN,RWA,2018.0,5,6,-1
VNM,IND,2022.0,13,7,6
TWN,PRT,2022.0,1,1,0
ARE,HKG,2023.0,1,6,-5
KOR,EGY,2018.0,8,7,1
DEU,UGA,2022.0,3,6,-3
DNK,CHN,2024.0,5,5,0
QAT,HRV,2022.0,3,1,2
BEL,BLR,2016.0,2,1,1
FRA,SRB,2021.0,4,6,-2
ROU,BEL,2020.0,11,9,2
DMA,USA,2020.0,3,1,2
NGA,NOR,2021.0,2,3,-1
ZAF,HKG,2022.0,4,3,1
TUR,BGD,2019.0,1,1,0
SVK,AUT,2022.0,5,8,-3
DEU,UZB,2017.0,4,3,1
UZB,CHN,2021.0,3,10,-7
ESP,PER,2022.0,16,20,-4
SAU,JPN,2022.0,7,9,-2
RUS,IRQ,2018.0,12,1,11
SGP,LKA,2017.0,2,1,1
ZWE,USA,2021.0,4,16,-12
OMN,SWE,2010.0,1,1,0
CHE,MEX,2007.0,6,4,2
SAU,SDN,2003.0,1,2,-1
LBY,EGY,2019.0,5,3,2
NOR,ISR,2000.0,1,1,0
PSE,DEU,2005.0,2,2,0
DNK,AUS,2006.0,15,14,1
CMR,BRA,2014.0,1,1,0
ESP,UKR,2003.0,4,5,-1
ARG,ISR,2000.0,1,4,-3
CHL,ITA,2000.0,1,2,-1
ARM,FRA,1998.0,1,1,0
MWI,USA,2002.0,4,3,1
SVK,RUS,2003.0,5,2,3
ARE,EGY,2009.0,10,9,1
PRT,GRC,2019.0,3,3,0
AZE,TUR,2003.0,9,1,8
ARG,CHE,2002.0,3,1,2
KEN,FRA,2013.0,3,4,-1
AUS,SAU,1999.0,6,3,3
NZL,NGA,2020.0,5,1,4
ROU,GBR,1997.0,6,6,0
CHE,THA,2006.0,2,1,1
COD,COG,1998.0,7,2,5
ZAF,COG,2019.0,2,1,1
BGR,CHE,2011.0,2,1,1
ARM,RUS,2002.0,6,3,3
RUS,ARM,2003.0,12,5,7
NLD,MWI,2003.0,1,1,0
SRB,CAN,1998.0,3,5,-2
POL,SWE,2010.0,22,13,9
JPN,IRN,2003.0,6,7,-1
KOR,IND,2003.0,6,34,-28
ISR,BRA,2014.0,2,4,-2
BEL,FIN,2007.0,4,4,0
CIV,USA,2006.0,2,2,0
LIE,DEU,2011.0,4,5,-1
ZAF,DNK,2001.0,3,2,1
CHE,PHL,2016.0,2,3,-1
ISR,BRA,2008.0,2,3,-1
CHE,THA,2000.0,6,1,5
NOR,BEL,2010.0,7,6,1
LVA,UKR,2014.0,1,2,-1
ITA,HKG,2019.0,4,3,1
GRC,NLD,2005.0,10,8,2
ISR,NLD,2002.0,6,9,-3
QAT,EGY,2002.0,3,4,-1
SAU,DEU,2012.0,11,20,-9
THA,FIN,2011.0,3,2,1
ARE,TUN,2016.0,3,4,-1
HKG,BLR,2003.0,1,3,-2
SRB,BIH,2002.0,6,4,2
BEL,CZE,2001.0,5,7,-2
USA,EST,2004.0,7,5,2
EGY,KWT,2001.0,6,11,-5
AUT,TUR,2006.0,7,4,3
USA,BIH,2008.0,6,5,1
FRA,LTU,1998.0,2,2,0
GAB,FRA,2006.0,6,9,-3
POL,BLR,2000.0,3,3,0
POL,BLR,2006.0,4,4,0
POL,UKR,1999.0,13,15,-2
RUS,ZAF,2005.0,2,2,0
GBR,AUS,2024.0,3,4,-1
AUT,ISR,2005.0,3,3,0
SWE,UKR,2003.0,6,6,0
PHL,ESP,1998.0,2,8,-6
CHE,IND,2000.0,8,6,2
FRA,DZA,1998.0,26,21,5
NOR,NPL,2005.0,2,1,1
BGR,SWE,2001.0,3,1,2
PRT,DNK,2002.0,2,5,-3
USA,BLR,2002.0,6,27,-21
AUS,ARG,2015.0,11,6,5
NLD,TZA,2002.0,3,1,2
JAM,USA,2007.0,4,2,2
MLI,FRA,2005.0,4,4,0
USA,ETH,1999.0,4,5,-1
VNM,THA,2003.0,1,2,-1
LTU,USA,2010.0,6,9,-3
MWI,GBR,1999.0,5,5,0
ARG,CHE,2012.0,10,2,8
KWT,NGA,1999.0,3,4,-1
BEL,DNK,2009.0,6,7,-1
GMB,NGA,2016.0,3,4,-1
SRB,RUS,2007.0,10,2,8
CHN,POL,2018.0,13,12,1
QAT,EGY,1997.0,5,3,2
BEL,BGR,2001.0,4,10,-6
DZA,ARE,2009.0,1,1,0
VEN,FRA,2005.0,8,9,-1
TUR,ROU,2013.0,2,1,1
ISR,NLD,2005.0,12,5,7
HRV,ESP,2010.0,3,2,1
BRA,SAU,2022.0,12,2,10
ZAF,DEU,2006.0,10,23,-13
ESP,BGR,2011.0,2,8,-6
GUY,GUF,2004.0,3,1,2
AND,ESP,2010.0,1,2,-1
ROU,JPN,2005.0,5,8,-3
ROU,ISR,2021.0,3,2,1
ZAF,NZL,2020.0,20,6,14
IRN,JPN,2007.0,8,19,-11
ECU,MEX,1998.0,2,1,1
REU,FRA,2004.0,5,12,-7
KGZ,RUS,2014.0,4,4,0
IRL,CHE,2008.0,7,15,-8
ETH,CHE,2001.0,1,1,0
NAM,GBR,2009.0,1,2,-1
FRA,SYR,2003.0,4,2,2
BEL,UKR,1998.0,2,1,1
IRN,NLD,2001.0,5,1,4
NOR,CHL,2015.0,2,1,1
TUR,JPN,2014.0,5,16,-11
JPN,DNK,2002.0,10,7,3
DNK,JPN,2004.0,7,14,-7
POL,FRA,2013.0,27,41,-14
AGO,FRA,2018.0,2,2,0
ARE,NLD,2012.0,1,3,-2
ESP,GTM,2016.0,4,2,2
HUN,BEL,2012.0,13,2,11
NLD,EGY,2012.0,6,1,5
KOR,NGA,2014.0,1,1,0
SGP,BEL,2017.0,4,11,-7
GIN,PNG,2010.0,1,2,-1
TUR,KGZ,2021.0,8,4,4
NGA,UGA,2011.0,3,2,1
RUS,CAN,2023.0,14,9,5
CHN,MYS,2007.0,4,7,-3
TWN,KOR,2006.0,4,5,-1
KOR,TWN,2010.0,9,20,-11
SWE,LTU,2012.0,2,3,-1
USA,ISL,2011.0,12,10,2
COL,CAN,2013.0,17,15,2
CZE,AUS,2015.0,9,10,-1
IRN,POL,2014.0,3,1,2
AUT,BRA,2014.0,4,11,-7
JPN,LAO,2018.0,4,2,2
MEX,PRY,2019.0,1,2,-1
LBN,FRA,2009.0,21,43,-22
MYS,EGY,2004.0,1,3,-2
FIN,ROU,2011.0,2,1,1
MAR,USA,2014.0,3,11,-8
CHL,ZAF,2012.0,2,2,0
NOR,UGA,2017.0,2,3,-1
IND,KEN,2012.0,2,1,1
ZAF,BRA,2010.0,4,5,-1
GBR,DZA,2014.0,9,5,4
GHA,SEN,2023.0,1,1,0
SWE,UGA,2019.0,6,4,2
GBR,SVN,2014.0,7,13,-6
ESP,LUX,2010.0,4,2,2
CZE,NLD,2018.0,7,8,-1
ITA,LTU,2005.0,4,3,1
GHA,ZAF,2012.0,5,5,0
GBR,PER,2011.0,3,5,-2
ESP,TWN,2018.0,6,8,-2
ISL,NOR,2010.0,4,8,-4
COL,NLD,2011.0,6,4,2
MAR,IND,2022.0,3,5,-2
SYR,JPN,2010.0,1,1,0
TUR,QAT,2017.0,6,1,5
UGA,CAN,2023.0,2,1,1
AUT,PAK,2021.0,12,4,8
BEL,ZAF,2007.0,7,3,4
CUB,COL,2014.0,6,5,1
PHL,MYS,2012.0,2,1,1
CAN,CUB,2017.0,3,13,-10
DNK,JPN,2014.0,5,7,-2
CAN,ZAF,2010.0,19,14,5
ARG,CHL,2007.0,13,13,0
PHL,MYS,2002.0,5,1,4
EGY,JOR,2017.0,4,4,0
BEL,VNM,2010.0,6,1,5
VNM,BEL,2011.0,2,6,-4
ITA,ISR,2012.0,16,12,4
QAT,JOR,2015.0,1,6,-5
AUS,OMN,2014.0,4,1,3
CAN,URY,2020.0,1,2,-1
ESP,DZA,2014.0,9,3,6
IDN,FIN,2018.0,1,4,-3
USA,JAM,2016.0,9,14,-5
BRA,PAK,2016.0,7,5,2
SVN,RUS,2021.0,2,4,-2
AUS,IRL,2000.0,8,7,1
DZA,CAN,2016.0,4,9,-5
GBR,BRN,2012.0,5,2,3
DNK,IRN,2013.0,4,7,-3
SAU,ARE,2010.0,14,11,3
NPL,CAN,2012.0,2,1,1
IDN,KEN,2016.0,3,1,2
JPN,BGR,2010.0,2,2,0
LTU,AUT,2010.0,1,2,-1
MEX,NOR,2010.0,2,4,-2
SVK,POL,2022.0,5,12,-7
ESP,KOR,2015.0,10,3,7
LTU,ITA,2021.0,7,6,1
IRL,MYS,2014.0,8,2,6
PAK,USA,2008.0,30,45,-15
SAU,CHE,2017.0,14,3,11
CHE,SAU,2018.0,16,6,10
LBY,AUS,2014.0,1,3,-2
NZL,PAK,2010.0,3,3,0
CUB,FRA,2022.0,4,1,3
USA,KWT,2014.0,21,7,14
PRT,DEU,2002.0,13,17,-4
ZAF,JPN,2015.0,3,5,-2
TWN,ESP,2019.0,8,5,3
IDN,DEU,2011.0,11,14,-3
BRA,GRC,2021.0,2,4,-2
CHN,EGY,2014.0,12,7,5
CMR,GHA,2018.0,2,1,1
NOR,TZA,2017.0,10,2,8
IRN,KOR,2014.0,12,4,8
IDN,KOR,2015.0,6,18,-12
VNM,NGA,2021.0,7,2,5
DZA,ZAF,2015.0,2,3,-1
COL,KHM,2013.0,1,1,0
ETH,SAU,2020.0,3,2,1
AUT,UKR,2014.0,5,6,-1
NOR,POL,2022.0,10,16,-6
MYS,GHA,2014.0,1,3,-2
IRQ,SYR,2016.0,1,2,-1
SLV,USA,2011.0,2,2,0
JPN,HUN,2016.0,8,3,5
FIN,KOR,2009.0,1,3,-2
SWE,TUR,2021.0,9,35,-26
MYS,QAT,2016.0,9,2,7
RWA,DEU,2014.0,1,1,0
ARE,TUN,2017.0,4,3,1
BGD,CHN,2015.0,6,8,-2
COG,USA,2017.0,4,6,-2
MYS,NPL,2021.0,3,1,2
AFG,PAK,2015.0,2,2,0
IND,SVK,2019.0,2,3,-1
COL,CHE,2013.0,5,1,4
IDN,PHL,2023.0,3,4,-1
TUR,IRL,2020.0,7,3,4
BEL,CUB,2020.0,6,4,2
AUS,ROU,2017.0,1,2,-1
POL,VNM,2010.0,1,1,0
CRI,GBR,2021.0,2,2,0
EGY,JOR,2022.0,11,4,7
BDI,BEL,2017.0,1,2,-1
CMR,DEU,2020.0,6,9,-3
AUS,LBN,2021.0,3,3,0
GHA,CHE,2015.0,5,1,4
HUN,NOR,2022.0,5,3,2
IDN,DEU,2021.0,25,37,-12
POL,TUR,2018.0,3,3,0
IRL,NOR,2020.0,10,4,6
NGA,UGA,2021.0,12,3,9
CAN,CMR,2012.0,2,3,-1
IRN,SVN,2021.0,1,1,0
ROU,PRT,2018.0,2,3,-1
UGA,KEN,2020.0,8,10,-2
ZMB,NOR,2020.0,1,5,-4
ESP,KOR,2014.0,4,6,-2
CZE,HUN,2021.0,3,8,-5
USA,MDA,2015.0,2,5,-3
BGR,CHE,2019.0,4,3,1
CHE,BGR,2020.0,4,2,2
LTU,FRA,2016.0,3,1,2
IRQ,BRA,2019.0,1,1,0
UKR,ESP,2018.0,3,2,1
AUT,PAK,2009.0,7,7,0
CMR,ITA,2019.0,1,4,-3
CAN,SVN,2022.0,6,1,5
MAR,MLI,2020.0,3,1,2
AFG,USA,2012.0,6,5,1
DEU,IRQ,2015.0,6,3,3
MLT,CAN,2020.0,1,1,0
URY,BRA,2018.0,9,17,-8
BIH,SRB,2017.0,10,18,-8
NZL,SVK,2017.0,1,1,0
LUX,IRL,2022.0,2,1,1
DNK,POL,2018.0,6,8,-2
NLD,LBN,2019.0,3,3,0
IDN,TLS,2021.0,2,1,1
HRV,GBR,2015.0,15,9,6
TWN,IND,2005.0,9,36,-27
ZWE,NLD,2018.0,3,2,1
ALB,JPN,2016.0,1,1,0
COL,PER,2019.0,10,6,4
PER,NLD,2020.0,5,2,3
CZE,ISR,2014.0,1,1,0
BEL,PRT,2023.0,6,16,-10
SGP,EGY,2020.0,1,2,-1
BHR,EGY,2023.0,4,2,2
CRI,COL,2021.0,3,1,2
EGY,YEM,2020.0,10,4,6
LAO,JPN,2019.0,2,8,-6
MDG,GBR,2018.0,6,4,2
SWE,MLT,2021.0,1,2,-1
POL,EGY,2021.0,5,2,3
CHE,ZAF,2019.0,10,14,-4
FIN,EGY,2020.0,4,2,2
JPN,JOR,2020.0,2,1,1
USA,SRB,2021.0,18,27,-9
CYP,POL,2020.0,2,1,1
CAN,JAM,2019.0,5,3,2
BRA,SGP,2021.0,4,3,1
ETH,NLD,2018.0,7,25,-18
IDN,SDN,2020.0,1,1,0
KOR,FIN,2020.0,7,4,3
NOR,ZAF,2015.0,7,4,3
CAN,KGZ,2020.0,1,1,0
GMB,GBR,2001.0,11,11,0
RUS,KGZ,2019.0,7,4,3
MYS,ZAF,2018.0,3,1,2
NZL,ISR,2022.0,1,6,-5
CAN,ISL,2019.0,4,1,3
POL,AUS,2022.0,7,15,-8
MDA,USA,2020.0,7,4,3
BEL,NPL,2022.0,1,1,0
PAK,IDN,2023.0,3,2,1
DZA,CHN,2023.0,3,5,-2
BEL,BEN,2022.0,4,2,2
ETH,HUN,2022.0,5,5,0
THA,CHE,2023.0,1,2,-1
CAN,OMN,2022.0,12,7,5
NZL,LKA,2022.0,4,10,-6
EGY,KOR,2020.0,10,18,-8
ROU,NOR,2022.0,2,1,1
SRB,KWT,2016.0,1,1,0
ZAF,MWI,2022.0,15,9,6
MAR,IND,2018.0,3,2,1
ZAF,GHA,2014.0,7,5,2
POL,PRT,2003.0,1,3,-2
IND,ZAF,2007.0,9,7,2
ESP,RUS,2006.0,8,12,-4
IND,BRA,2004.0,5,2,3
PRI,AUS,2004.0,1,1,0
AUS,BRA,2007.0,10,20,-10
CHL,ZAF,2005.0,3,1,2
PRT,SWE,2005.0,7,10,-3
ZAF,ITA,2006.0,7,3,4
BRB,CAN,1998.0,1,1,0
IRN,EGY,2020.0,3,2,1
USA,COG,2012.0,11,8,3
BFA,BEL,2001.0,1,1,0
BGD,THA,2003.0,1,1,0
USA,CYM,2008.0,1,2,-1
KWT,CAN,2002.0,1,4,-3
DNK,JPN,2001.0,9,8,1
BOL,FRA,2002.0,5,3,2
SGP,ITA,2008.0,4,1,3
GBR,HRV,1999.0,4,4,0
SGP,JPN,2006.0,12,16,-4
AUT,POL,2019.0,14,14,0
SAU,NLD,2015.0,8,3,5
AUT,TUR,2000.0,1,3,-2
ISR,CHE,1998.0,4,7,-3
IRL,IRN,2014.0,8,12,-4
NLD,MEX,2012.0,8,7,1
AUS,PRT,2006.0,1,8,-7
FIN,IND,2001.0,3,3,0
SRB,RUS,1999.0,8,8,0
NLD,EGY,2005.0,3,2,1
AUS,GHA,2013.0,2,3,-1
THA,FRA,2003.0,4,5,-1
KWT,SAU,2009.0,1,1,0
EGY,CZE,2003.0,1,2,-1
DNK,CZE,2013.0,5,5,0
PRT,OMN,2020.0,1,1,0
DEU,SRB,1999.0,5,22,-17
AUS,CZE,1997.0,2,1,1
DNK,ZAF,2000.0,4,2,2
PHL,JPN,1997.0,3,7,-4
PER,ESP,2000.0,4,6,-2
MLI,FRA,2012.0,2,10,-8
HKG,DEU,1999.0,9,8,1
HKG,MYS,2017.0,5,2,3
NZL,SWE,2017.0,14,8,6
BGD,EGY,2012.0,1,1,0
CHN,FIN,2002.0,6,11,-5
ARG,SWE,2015.0,3,3,0
ETH,USA,2006.0,3,7,-4
HRV,NLD,2013.0,4,2,2
CHN,IDN,2012.0,2,1,1
SVN,GBR,2011.0,6,4,2
ARM,CZE,2023.0,1,1,0
SAU,KOR,2015.0,7,22,-15
DEU,AFG,2019.0,1,5,-4
CHN,KOR,1997.0,9,3,6
IND,PAK,1998.0,5,4,1
BIH,SVN,2019.0,5,4,1
QAT,TUR,2017.0,1,6,-5
KOR,TWN,2000.0,3,2,1
FRA,KWT,2018.0,5,1,4
JPN,PAK,2001.0,5,2,3
QAT,EGY,2012.0,5,10,-5
ARG,BOL,2022.0,1,1,0
COL,FRA,2007.0,6,12,-6
AUS,KAZ,2021.0,3,3,0
GBR,MAC,2023.0,1,2,-1
KAZ,IRN,2022.0,1,7,-6
EGY,LBN,2022.0,5,10,-5
PAK,AFG,2021.0,1,1,0
ITA,TUR,2018.0,11,22,-11
EGY,DNK,2011.0,1,2,-1
BEL,NGA,2011.0,2,3,-1
USA,VNM,2006.0,11,5,6
JOR,ARE,2002.0,3,3,0
THA,FRA,2013.0,13,24,-11
ISL,DNK,2017.0,5,6,-1
KEN,BEL,1997.0,2,3,-1
OMN,USA,2016.0,9,13,-4
COL,PRI,2005.0,4,1,3
EGY,ITA,1999.0,3,2,1
NLD,SDN,2010.0,3,1,2
ARM,DEU,1999.0,5,2,3
ZAF,ISR,2020.0,8,4,4
MAR,CHE,2001.0,1,3,-2
MEX,POL,2005.0,1,1,0
FIN,CHE,2002.0,14,6,8
ISR,JPN,2000.0,7,6,1
SWE,TUR,2009.0,5,5,0
ISR,DNK,2006.0,1,5,-4
CZE,AUS,2014.0,6,13,-7
NPL,USA,1998.0,3,4,-1
FRA,EGY,2004.0,2,3,-1
TGO,SEN,2014.0,1,4,-3
NOR,SVK,2006.0,1,1,0
USA,SEN,1998.0,8,2,6
USA,ARM,2013.0,4,8,-4
POL,GRC,2010.0,4,4,0
COL,MEX,2002.0,4,4,0
LTU,POL,2017.0,1,3,-2
CAN,DZA,2009.0,6,2,4
NGA,IND,1998.0,1,2,-1
MDG,FRA,2004.0,9,7,2
IND,HKG,2008.0,4,3,1
SAU,JOR,2003.0,2,2,0
GAB,USA,2011.0,3,4,-1
AUT,ZAF,2015.0,8,5,3
DEU,VEN,2007.0,6,6,0
AUS,KEN,2013.0,6,2,4
BGR,RUS,1998.0,7,6,1
PHL,DEU,2007.0,1,2,-1
RUS,QAT,2022.0,1,1,0
VNM,RUS,2010.0,1,5,-4
MDA,FIN,1998.0,1,1,0
CHE,KEN,2019.0,4,6,-2
QAT,JOR,2008.0,2,2,0
DZA,SAU,2010.0,4,6,-2
BRA,GRC,2019.0,2,1,1
SWE,BRA,2017.0,10,26,-16
ZAF,RUS,1998.0,1,3,-2
RUS,UZB,2003.0,7,5,2
GRC,NLD,2002.0,9,9,0
NOR,AUS,2005.0,7,16,-9
SVK,ITA,1997.0,2,5,-3
FRA,BEN,2004.0,5,5,0
DNK,EGY,2006.0,2,1,1
BEL,POL,1998.0,11,6,5
ARM,RUS,2005.0,6,4,2
EGY,ETH,2013.0,2,1,1
SAU,IND,2009.0,10,34,-24
TUR,CHE,2003.0,5,3,2
DEU,ARM,1998.0,4,2,2
ESP,BGR,2021.0,1,1,0
NZL,DEU,2005.0,12,28,-16
NLD,KEN,1998.0,1,3,-2
ISR,FRA,2015.0,21,35,-14
GBR,BLR,2000.0,2,3,-1
CHN,VNM,2007.0,1,1,0
MAR,DEU,2007.0,5,6,-1
DEU,MAR,2009.0,1,1,0
MAR,SWE,2021.0,1,2,-1
NZL,DEU,2002.0,13,21,-8
USA,RWA,2012.0,4,6,-2
CHE,ZAF,2009.0,8,7,1
NOR,GRL,2010.0,1,3,-2
UKR,GRC,2000.0,2,4,-2
EST,CZE,2013.0,3,2,1
RUS,IRL,1999.0,4,1,3
NLD,ZWE,1999.0,2,1,1
FIN,AUT,2002.0,5,7,-2
CHE,CYP,2000.0,1,1,0
MEX,ITA,2005.0,9,7,2
ITA,JPN,2010.0,22,23,-1
SVN,USA,2002.0,9,15,-6
PHL,CHN,2007.0,2,2,0
LUX,BEL,1997.0,2,2,0
JPN,MAR,2003.0,1,1,0
DEU,LIE,2003.0,4,2,2
SRB,SVK,2012.0,2,1,1
CZE,BRA,1998.0,2,1,1
TUR,RUS,2003.0,7,10,-3
FIN,ARE,2013.0,1,2,-1
BLR,POL,2018.0,5,2,3
BGD,MYS,2007.0,5,5,0
TWN,FRA,2009.0,7,5,2
MEX,CHL,2008.0,9,8,1
MEX,BEL,2015.0,10,7,3
BIH,FRA,2019.0,2,2,0
NZL,CHE,2015.0,9,8,1
ESP,COL,2001.0,6,12,-6
FRA,CAF,2010.0,2,1,1
NGA,BEN,2011.0,3,2,1
ESP,MYS,2014.0,4,4,0
MYS,BEL,2020.0,3,5,-2
KOR,THA,2012.0,5,4,1
CHE,HUN,2016.0,17,13,4
SAU,HUN,2021.0,1,3,-2
TZA,SWE,2014.0,6,4,2
LVA,ESP,2011.0,2,1,1
SWE,VNM,2010.0,5,4,1
ISR,SGP,2016.0,5,2,3
RUS,NOR,2017.0,9,15,-6
FIN,AUT,2012.0,7,10,-3
MLI,SEN,2014.0,2,2,0
ECU,ARG,2010.0,1,2,-1
FIN,SGP,2018.0,5,7,-2
SGP,FIN,2023.0,4,2,2
SVN,FRA,2009.0,4,4,0
USA,BWA,2007.0,5,6,-1
SGP,QAT,2015.0,6,2,4
IRL,BEL,2006.0,1,2,-1
PAK,NLD,2011.0,8,3,5
TUR,ALB,2021.0,1,1,0
CHL,SRB,2014.0,1,1,0
VEN,CHL,2023.0,3,1,2
FRA,EST,2014.0,6,3,3
GRC,AUS,2013.0,15,6,9
POL,AUS,2018.0,10,15,-5
USA,SLV,2014.0,2,4,-2
TWN,THA,2011.0,5,3,2
MAR,TWN,2014.0,6,1,5
BHR,IND,2020.0,1,8,-7
ZAF,MOZ,2014.0,2,3,-1
CAN,THA,2020.0,19,11,8
DEU,HKG,2011.0,6,9,-3
GBR,KAZ,2014.0,6,3,3
SAU,RUS,2019.0,4,6,-2
QAT,DEU,2023.0,6,3,3
JOR,ARE,2012.0,16,1,15
VNM,BEL,2019.0,10,24,-14
MWI,KEN,2020.0,2,4,-2
BEN,CAN,2014.0,1,1,0
HRV,ITA,2018.0,6,11,-5
HUN,RUS,2016.0,3,1,2
RUS,NOR,2016.0,11,10,1
IRL,HKG,2011.0,1,3,-2
BEL,MYS,2017.0,3,1,2
AUS,TWN,1999.0,7,9,-2
DNK,PRT,2011.0,3,2,1
KOR,MEX,2010.0,7,2,5
MKD,GRC,2011.0,2,1,1
GRC,MKD,2014.0,4,1,3
CHN,BRA,2019.0,4,26,-22
CHL,AUT,2014.0,2,4,-2
BEL,HKG,2016.0,1,2,-1
HUN,FIN,2014.0,5,4,1
HKG,FIN,2022.0,1,1,0
FIN,COL,2018.0,2,2,0
BEL,MEX,2000.0,2,4,-2
TWN,BEL,2015.0,4,1,3
JPN,LVA,2018.0,2,1,1
IND,JOR,2017.0,3,4,-1
SYR,USA,2014.0,5,2,3
RWA,VNM,2018.0,1,1,0
COL,JPN,2012.0,2,3,-1
BEL,KEN,2022.0,5,5,0
RUS,NZL,2018.0,4,3,1
IND,RWA,2014.0,1,1,0
TZA,CHE,2017.0,3,3,0
KOR,NPL,2018.0,12,12,0
NGA,SWE,2023.0,5,1,4
TWN,SWE,2010.0,2,1,1
KOR,BEL,2019.0,6,6,0
ZWE,NLD,2017.0,4,4,0
TUR,NOR,2015.0,3,1,2
KEN,MWI,2015.0,1,2,-1
BFA,GHA,2017.0,1,3,-2
KAZ,GBR,2015.0,6,6,0
PAN,COL,2009.0,1,1,0
MAR,ZAF,2015.0,3,1,2
LKA,NOR,2018.0,3,2,1
GRC,BRA,2022.0,2,2,0
RWA,MWI,2020.0,1,2,-1
BIH,IRL,2017.0,1,1,0
TWN,PHL,2013.0,2,2,0
AUT,IDN,2016.0,8,2,6
MEX,SLV,2011.0,2,1,1
HND,USA,2015.0,2,2,0
USA,BFA,2013.0,4,8,-4
UKR,CZE,2022.0,16,5,11
SAU,YEM,2022.0,11,17,-6
SLV,SVK,2022.0,1,2,-1
CZE,RUS,2014.0,2,16,-14
KEN,DNK,2022.0,5,1,4
IDN,AUT,2019.0,4,3,1
NZL,PRT,2017.0,3,1,2
UGA,ZAF,2015.0,6,9,-3
BOL,SWE,2020.0,6,7,-1
LAO,CHE,2021.0,1,2,-1
NGA,FRA,2016.0,1,1,0
KEN,ITA,2017.0,4,6,-2
JPN,TUN,2021.0,2,3,-1
DEU,URY,2017.0,4,5,-1
USA,BHR,2005.0,3,1,2
NIC,USA,2022.0,2,4,-2
FRA,SVK,2020.0,8,3,5
FRA,GUY,2017.0,1,2,-1
MEX,ECU,2021.0,9,7,2
BRA,ARE,2019.0,5,2,3
FRA,JOR,2017.0,4,2,2
FIN,ISR,1997.0,1,2,-1
CZE,BEL,2002.0,8,8,0
HND,USA,2008.0,4,1,3
TUN,NLD,2022.0,1,2,-1
MEX,GTM,2011.0,5,1,4
FIN,CZE,2015.0,5,4,1
IDN,SGP,2017.0,4,7,-3
NLD,ABW,2021.0,1,2,-1
CRI,CAN,2019.0,4,6,-2
ETH,UGA,2021.0,4,2,2
PER,FRA,2023.0,2,6,-4
SAU,TUN,2011.0,7,29,-22
ESP,LTU,2017.0,2,1,1
QAT,ESP,2020.0,3,4,-1
KEN,MEX,2017.0,1,1,0
DEU,GEO,2007.0,6,6,0
ISR,ITA,2000.0,12,10,2
CHL,CHN,2019.0,7,6,1
LKA,THA,1999.0,1,1,0
QAT,KOR,2017.0,3,4,-1
BEL,BRA,2023.0,7,22,-15
NLD,BGD,2019.0,3,5,-2
PRT,QAT,2017.0,2,1,1
AUS,BEL,2024.0,1,1,0
CZE,IRN,2015.0,1,6,-5
MNG,JPN,2018.0,9,13,-4
HTI,USA,2020.0,4,10,-6
GTM,BRA,2021.0,2,1,1
NLD,BGD,2021.0,12,5,7
PAK,CAN,2006.0,9,12,-3
PER,JPN,2019.0,1,4,-3
NGA,KEN,2020.0,4,8,-4
BOL,USA,2016.0,7,4,3
NER,MAR,2020.0,2,4,-2
ROU,ZAF,2021.0,4,1,3
VNM,CZE,2020.0,3,7,-4
BGD,NPL,2014.0,2,3,-1
HUN,ECU,2022.0,2,1,1
ESP,URY,2012.0,13,11,2
JPN,LUX,2016.0,1,2,-1
IRN,CYP,2021.0,4,2,2
DNK,PAK,2015.0,3,4,-1
GHA,PRT,2021.0,1,2,-1
SWE,NGA,2017.0,5,1,4
CUB,ARG,2010.0,3,1,2
COG,BEL,2015.0,9,10,-1
GBR,ZMB,2021.0,8,7,1
EGY,IND,2022.0,7,3,4
PHL,NLD,2021.0,7,3,4
VEN,FRA,1997.0,4,6,-2
TGO,FRA,2004.0,3,6,-3
RUS,KAZ,2002.0,9,6,3
NAM,USA,2012.0,1,4,-3
BIH,TUR,2020.0,3,2,1
FIN,GRC,2015.0,4,4,0
ZWE,BWA,2013.0,2,1,1
SWE,LVA,2019.0,4,2,2
NLD,IDN,2004.0,6,3,3
FIN,AUT,2005.0,3,4,-1
SWE,ISL,2005.0,8,7,1
MAC,MAR,2010.0,2,7,-5
CIV,BEL,1998.0,1,3,-2
NGA,AUS,2020.0,9,8,1
CRI,MEX,2010.0,1,3,-2
HKG,RUS,2005.0,5,1,4
USA,MNP,2020.0,2,3,-1
PAK,ZAF,2002.0,2,1,1
ROU,ESP,2009.0,6,6,0
UZB,GBR,2002.0,5,2,3
POL,ITA,2006.0,15,8,7
SVK,CHE,2002.0,6,3,3
NGA,PHL,2012.0,2,2,0
CAN,JAM,2009.0,1,3,-2
LVA,GBR,2001.0,6,2,4
POL,SAU,2023.0,1,3,-2
AUT,BRA,2004.0,2,4,-2
TWN,UKR,2002.0,3,2,1
ERI,IND,2004.0,1,1,0
MAR,SAU,2012.0,4,2,2
SVK,IRL,2008.0,3,1,2
AUT,ZAF,2008.0,3,3,0
NZL,JPN,2011.0,8,5,3
CAN,TUN,2006.0,8,4,4
PER,MEX,2011.0,4,7,-3
CMR,USA,1998.0,7,2,5
ISR,GRC,2012.0,2,2,0
ALB,USA,1999.0,1,1,0
SYR,CAN,2016.0,1,1,0
USA,BOL,2005.0,3,3,0
ZAF,VNM,2021.0,2,7,-5
CHE,PHL,2022.0,2,2,0
POL,ESP,2005.0,15,5,10
ZMB,ZWE,2017.0,2,1,1
CAN,NGA,2008.0,3,3,0
USA,EST,2014.0,5,15,-10
DZA,GBR,2010.0,2,1,1
BEL,KOR,2015.0,11,8,3
CHE,CMR,2009.0,2,1,1
BEL,TUR,2007.0,4,8,-4
BLR,POL,2016.0,4,4,0
EGY,HUN,2005.0,1,2,-1
ITA,NZL,2005.0,1,2,-1
IRL,ZAF,2005.0,1,6,-5
AUT,BEL,2007.0,9,6,3
ERI,IND,2008.0,2,3,-1
CHE,GEO,2009.0,2,2,0
CHE,NGA,2009.0,1,1,0
JAM,GBR,2011.0,4,4,0
MEX,AUS,2007.0,5,4,1
CHN,MEX,2013.0,4,7,-3
FRA,PSE,2009.0,4,1,3
ZWE,GBR,2000.0,5,5,0
CAN,MAR,2007.0,6,5,1
TZA,DEU,2007.0,2,3,-1
GBR,CUB,2002.0,3,6,-3
AUT,ROU,2009.0,2,3,-1
COL,FRA,1999.0,3,4,-1
BEL,MEX,2006.0,5,2,3
BRA,HRV,2019.0,1,1,0
GBR,BWA,2016.0,9,1,8
DNK,LTU,2016.0,5,4,1
DEU,RWA,2022.0,2,2,0
GBR,GHA,1998.0,5,5,0
BLR,DEU,2007.0,9,8,1
BEN,GBR,2003.0,1,2,-1
NLD,GHA,2020.0,9,9,0
MEX,URY,2017.0,2,7,-5
ESP,ISR,2011.0,3,8,-5
DEU,GEO,1998.0,4,3,1
USA,LTU,2007.0,11,9,2
USA,PRY,2005.0,3,3,0
ISR,ESP,2010.0,8,4,4
AUS,NOR,2008.0,23,2,21
RUS,SRB,2003.0,8,3,5
AUS,BEL,2000.0,9,13,-4
SAU,TUN,2009.0,3,13,-10
FRA,EST,2015.0,2,3,-1
BEN,NLD,2006.0,2,2,0
JPN,COL,2013.0,5,3,2
ESP,IRN,2007.0,1,3,-2
FRA,KOR,2000.0,11,2,9
RUS,SVN,2016.0,2,3,-1
MEX,URY,2018.0,5,3,2
URY,MEX,2019.0,4,4,0
SVN,USA,2005.0,11,17,-6
MDG,USA,2008.0,4,2,2
IRL,DEU,2003.0,7,18,-11
MEX,UKR,2004.0,1,3,-2
IRN,MYS,2007.0,7,5,2
ISR,SWE,2002.0,7,2,5
URY,CAN,2013.0,2,1,1
BRA,SAU,2016.0,2,2,0
ZWE,COG,2006.0,1,1,0
NOR,EST,2007.0,2,1,1
RWA,USA,2007.0,3,4,-1
CHN,COL,2014.0,2,1,1
BRA,ZAF,2000.0,1,1,0
BEL,BGR,2014.0,4,5,-1
IND,TZA,1997.0,1,3,-2
ZWE,BEL,2010.0,1,1,0
NGA,CMR,2000.0,4,2,2
MWI,AUS,2021.0,4,1,3
NLD,TUR,2009.0,11,18,-7
POL,TUR,2022.0,2,12,-10
CHL,MEX,2005.0,4,4,0
TUR,FIN,2007.0,9,3,6
SAU,NOR,2013.0,4,1,3
FIN,ROU,2019.0,5,1,4
FIN,ROU,2021.0,2,3,-1
AZE,TUR,2013.0,5,8,-3
IND,SWE,2001.0,9,6,3
LTU,DNK,2022.0,4,3,1
JPN,NPL,2007.0,7,6,1
TWN,FRA,2011.0,8,16,-8
SWE,ZAF,2016.0,8,13,-5
KOR,ARE,2021.0,17,8,9
COG,BEL,2008.0,1,5,-4
ETH,KEN,2019.0,7,6,1
KWT,IND,2013.0,2,1,1
KWT,IND,2003.0,6,11,-5
GRC,PRT,2015.0,4,5,-1
MAR,TWN,2008.0,1,1,0
DEU,BIH,2010.0,3,2,1
CAF,FRA,2019.0,1,3,-2
GBR,FLK,2014.0,2,2,0
IRQ,FRA,2020.0,1,15,-14
GBR,HRV,2007.0,5,4,1
BEL,BLR,2018.0,1,1,0
GBR,TTO,2020.0,6,5,1
GBR,MWI,1999.0,5,5,0
AUT,MYS,2012.0,4,1,3
IRL,FRA,2007.0,12,28,-16
BRA,AUT,2007.0,2,2,0
NZL,NLD,2005.0,8,7,1
CHE,SVN,2019.0,3,7,-4
GBR,MLT,2000.0,4,4,0
SWE,GNB,2002.0,1,1,0
PRT,TUN,2015.0,1,2,-1
MEX,UKR,2015.0,2,1,1
GEO,DEU,2006.0,10,2,8
KEN,BWA,2014.0,4,2,2
BEL,NZL,2017.0,4,5,-1
AUS,LBY,2015.0,2,1,1
BEL,TUN,2008.0,4,2,2
IDN,IRL,2012.0,1,2,-1
GAB,CAN,2015.0,1,3,-2
CAN,ROU,2011.0,6,6,0
NPL,GBR,2006.0,6,4,2
SGP,PAK,2010.0,1,1,0
CHE,NGA,2021.0,3,7,-4
FRA,NOR,2004.0,21,13,8
NGA,SAU,2008.0,1,3,-2
MEX,PAN,2011.0,1,1,0
SLV,USA,2021.0,2,6,-4
DEU,LVA,2009.0,4,6,-2
MEX,SWE,2014.0,7,7,0
USA,LUX,2014.0,12,7,5
EGY,LBN,2016.0,6,3,3
SWE,MYS,2009.0,1,2,-1
NOR,SGP,2005.0,1,1,0
MYS,EGY,2014.0,5,7,-2
HKG,THA,2005.0,1,1,0
SAU,IRN,2020.0,4,3,1
CHE,IDN,2015.0,1,1,0
KOR,CHL,2012.0,2,1,1
ARE,CHN,2017.0,4,2,2
NCL,NZL,2015.0,2,1,1
CHN,BRA,2009.0,2,2,0
GBR,ZWE,2006.0,3,8,-5
BRA,GBR,2024.0,2,1,1
CHE,CIV,2012.0,3,2,1
UGA,ITA,2023.0,2,1,1
CZE,CAN,2010.0,6,14,-8
GRC,ARE,2021.0,2,3,-1
LTU,CHE,2021.0,7,2,5
NOR,IRL,2010.0,2,1,1
SRB,CHE,2012.0,4,2,2
NGA,SWZ,2012.0,1,1,0
ITA,PER,2008.0,1,1,0
ZAF,UGA,2013.0,6,2,4
JPN,CZE,2015.0,8,7,1
NOR,UGA,2016.0,3,3,0
URY,NLD,2006.0,3,1,2
SVK,IRL,2014.0,1,1,0
HRV,CAN,2018.0,3,3,0
SGP,PHL,2013.0,4,6,-2
SWE,KEN,2011.0,5,3,2
CAN,GHA,2011.0,3,4,-1
TUN,OMN,2006.0,2,1,1
ZAF,TUR,2005.0,1,1,0
IRL,TUR,2017.0,3,4,-1
NLD,NGA,2013.0,3,2,1
SEN,GHA,2019.0,1,1,0
ISR,BEL,2009.0,2,4,-2
SVN,CHN,2012.0,2,2,0
ZAF,IRN,2004.0,4,1,3
NLD,THA,2013.0,10,8,2
EST,FIN,2013.0,8,11,-3
AUS,BRN,2018.0,2,4,-2
USA,MDA,2014.0,1,2,-1
POL,HUN,2015.0,2,3,-1
TWN,PAK,2017.0,2,1,1
KOR,LKA,2014.0,4,1,3
CMR,JPN,2021.0,3,1,2
THA,HKG,2016.0,2,2,0
POL,HUN,2014.0,4,5,-1
BHR,JOR,2017.0,1,4,-3
CHN,CHL,2020.0,5,10,-5
CHL,CHN,2021.0,4,9,-5
HRV,CHE,2020.0,6,1,5
IND,YEM,2015.0,5,1,4
PER,CHE,2019.0,3,2,1
GRC,DEU,2024.0,2,2,0
ITA,KOR,2013.0,11,7,4
ZAF,SDN,2015.0,1,1,0
PER,DEU,2015.0,6,5,1
BRA,KOR,2016.0,2,5,-3
THA,BTN,2017.0,4,1,3
IRL,IRN,2015.0,6,12,-6
CAN,GRC,2012.0,5,9,-4
ISR,IRN,2020.0,1,2,-1
MYS,ETH,2014.0,2,3,-1
BRA,COL,2006.0,4,8,-4
HKG,GHA,2019.0,3,1,2
LTU,USA,2023.0,6,8,-2
CZE,TUR,2021.0,5,16,-11
PHL,ARG,2015.0,1,2,-1
PRT,PER,2017.0,3,1,2
BRA,MOZ,2014.0,2,4,-2
ESP,SVN,2014.0,4,4,0
CMR,BEN,2019.0,2,5,-3
SWE,CUB,2017.0,1,1,0
IRL,FIN,2017.0,4,5,-1
CUB,CAN,2014.0,2,2,0
KHM,AUS,2012.0,2,1,1
ISL,FRA,2020.0,4,3,1
JPN,PAK,2015.0,6,4,2
MEX,VEN,2012.0,6,9,-3
RWA,SWE,2021.0,4,7,-3
TZA,ETH,2018.0,1,1,0
OMN,CAN,2012.0,6,7,-1
OMN,EGY,2019.0,8,7,1
COL,ESP,2024.0,5,1,4
SWZ,ZAF,2011.0,2,6,-4
PHL,KOR,2017.0,9,15,-6
KWT,JOR,2014.0,1,3,-2
JPN,MMR,2023.0,7,1,6
SWE,LTU,1997.0,2,3,-1
QAT,GBR,2011.0,6,8,-2
IND,PRI,2015.0,1,1,0
NER,FRA,2018.0,2,4,-2
BEL,AUS,2010.0,26,18,8
JPN,IRL,2014.0,6,6,0
LBN,DNK,2023.0,2,1,1
IRL,BGD,2004.0,2,1,1
PRT,NOR,2022.0,6,3,3
DNK,ISL,2022.0,6,3,3
KOR,SGP,2007.0,6,13,-7
BRA,URY,2016.0,11,3,8
RUS,SVN,2022.0,2,2,0
GBR,COG,2016.0,2,1,1
LUX,CZE,2019.0,1,5,-4
DZA,ITA,2017.0,5,3,2
SLV,USA,2019.0,8,6,2
HKG,MAC,2023.0,10,13,-3
BEL,KOR,2008.0,2,5,-3
ITA,SGP,2019.0,10,11,-1
IDN,KEN,2018.0,3,2,1
NLD,SGP,2023.0,6,12,-6
PER,ESP,2006.0,5,5,0
CMR,BEL,2013.0,3,4,-1
THA,NZL,2022.0,5,4,1
FRA,PSE,2021.0,11,1,10
FRA,ARE,2002.0,2,1,1
ITA,MAR,2021.0,6,6,0
GHA,GMB,2020.0,1,2,-1
PRI,BRA,2012.0,4,2,2
CAN,COG,2019.0,1,1,0
USA,VIR,2007.0,3,4,-1
ITA,MAR,2019.0,7,2,5
PRK,CHN,2018.0,2,19,-17
IDN,FRA,2019.0,3,16,-13
SAU,OMN,2023.0,4,2,2
BOL,DEU,2016.0,1,3,-2
HKG,PAK,2020.0,10,11,-1
CHN,SYR,2019.0,1,1,0
SYR,CHN,2020.0,1,2,-1
MAR,EGY,2017.0,2,2,0
CAN,RWA,2022.0,2,7,-5
AFG,JPN,2022.0,4,6,-2
GBR,NPL,2022.0,9,5,4
SEN,GBR,2020.0,1,2,-1
SDN,USA,2022.0,2,4,-2
CAN,VNM,2016.0,5,2,3
PAK,CAN,2000.0,4,3,1
PRT,PER,2018.0,1,1,0
PAK,NOR,2010.0,3,1,2
NOR,PAK,2014.0,5,4,1
SGP,ESP,2022.0,8,7,1
ESP,SVK,2022.0,4,1,3
CHN,CMR,2022.0,4,4,0
CMR,CHN,2023.0,2,8,-6
FRA,KHM,2010.0,1,3,-2
ITA,MYS,2014.0,4,3,1
USA,CUW,2022.0,1,1,0
MWI,JPN,2022.0,2,1,1
ARG,ECU,2022.0,2,3,-1
FIN,GRC,2001.0,2,3,-1
SVN,HRV,2004.0,2,2,0
VEN,MEX,1997.0,5,1,4
GAB,FRA,2023.0,3,3,0
SYC,AUS,2010.0,1,1,0
LTU,NLD,2014.0,2,1,1
SGP,UKR,2018.0,2,1,1
KEN,CAN,2007.0,2,5,-3
ZWE,KEN,2009.0,3,1,2
SVK,BEL,2010.0,3,2,1
COL,CHE,2003.0,2,1,1
MDA,RUS,1998.0,2,3,-1
MLT,ITA,1998.0,3,1,2
DNK,SGP,2007.0,2,2,0
EST,IND,2017.0,4,4,0
BWA,NGA,2004.0,2,3,-1
GRC,PRT,2014.0,2,1,1
USA,NAM,2012.0,4,1,3
GEO,RUS,2021.0,3,4,-1
ITA,LTU,2002.0,4,2,2
ESP,SAU,2013.0,7,1,6
ZAF,NLD,2000.0,11,7,4
IDN,GBR,2001.0,5,5,0
ESP,MAR,2003.0,8,13,-5
AUS,MEX,2010.0,9,11,-2
USA,GUY,2015.0,2,2,0
DEU,BLR,2013.0,3,2,1
ISR,JPN,2010.0,3,5,-2
USA,LTU,1999.0,8,4,4
ISR,ITA,2010.0,12,11,1
PHL,AUS,2012.0,11,10,1
MAR,GBR,2006.0,1,2,-1
CZE,MYS,2022.0,2,6,-4
SWE,SDN,2016.0,4,1,3
HRV,FRA,2007.0,5,2,3
DNK,MEX,2013.0,3,4,-1
CAN,NOR,2007.0,12,5,7
JAM,GBR,2019.0,6,5,1
JPN,ARG,2017.0,2,3,-1
EST,ITA,2005.0,1,1,0
IRQ,GBR,2007.0,5,2,3
LTU,USA,2000.0,6,2,4
IND,IDN,2006.0,4,4,0
CHE,GHA,2003.0,3,2,1
TWN,IND,2002.0,11,34,-23
ISR,UKR,2018.0,3,5,-2
BEL,CMR,2012.0,5,4,1
ESP,HKG,2001.0,2,1,1
ITA,LVA,2001.0,2,1,1
FRA,PYF,2001.0,8,10,-2
ARG,NLD,1997.0,4,1,3
SEN,BEL,1999.0,1,2,-1
ZWE,ZMB,2012.0,2,2,0
ARG,CHL,1998.0,3,1,2
SAU,MYS,2009.0,3,6,-3
RWA,BEL,2009.0,2,1,1
BRA,SWE,1999.0,1,9,-8
GBR,PHL,2007.0,3,2,1
RUS,SVN,2017.0,6,1,5
USA,LUX,2015.0,7,3,4
RUS,MDA,2009.0,4,1,3
HND,USA,2001.0,1,3,-2
IRL,KEN,1999.0,1,1,0
DNK,NLD,2007.0,14,16,-2
CHN,ISR,2004.0,4,10,-6
DEU,TWN,1998.0,4,5,-1
CHN,CHE,1998.0,8,12,-4
ROU,JPN,1997.0,7,3,4
HKG,KOR,2005.0,10,1,9
PHL,CHN,1998.0,6,1,5
HKG,TWN,2014.0,9,13,-4
ZAF,IND,1998.0,3,1,2
AUS,BGD,2004.0,5,4,1
IND,ERI,2005.0,3,2,1
CRI,CAN,2009.0,1,5,-4
IRN,JPN,1999.0,2,10,-8
CHN,CZE,2014.0,7,2,5
TWN,KOR,2000.0,2,3,-1
AUS,IDN,2006.0,11,8,3
SWZ,CHE,1999.0,2,1,1
ZMB,ZAF,2010.0,2,1,1
NGA,NER,2008.0,9,1,8
CHE,LBR,2017.0,3,0,3
LBR,YEM,2020.0,2,0,2
USA,GIN,2015.0,2,0,2
ECU,NOR,2019.0,1,0,1
VNM,CHL,2015.0,1,0,1
,GUF,2013.0,16,0,16
TON,,2025.0,11,0,11
,REU,2013.0,6,0,6
MDA,,2014.0,38,0,38
PYF,COL,2011.0,1,0,1
SWZ,,2012.0,9,0,9
SGP,BGD,2011.0,3,0,3
,SLV,2009.0,27,0,27
JOR,PRT,2020.0,1,0,1
VNM,AUS,2000.0,2,0,2
SVK,SAU,2020.0,3,0,3
SYR,,2001.0,5,0,5
IRL,ARE,2001.0,3,0,3
GUY,,2024.0,37,0,37
GIN,GUF,2020.0,2,0,2
FIN,PER,2021.0,1,0,1
,GIN,2017.0,52,0,52
JOR,IND,2010.0,1,0,1
LBN,NOR,2022.0,3,0,3
,CAF,2018.0,5,0,5
CYP,EGY,2021.0,1,0,1
,PLW,2018.0,5,0,5
SYR,HUN,2020.0,1,0,1
ARG,BIH,2021.0,1,0,1
MNG,,2010.0,20,0,20
SVN,HUN,2023.0,1,0,1
IRL,TUR,2012.0,3,0,3
GBR,MAC,2015.0,7,0,7
USA,DMA,2009.0,3,0,3
ATG,,2010.0,3,0,3
ISL,CHE,2010.0,2,0,2
CHE,ISL,2015.0,3,0,3
TUR,MEX,2002.0,3,0,3
BEL,COD,2013.0,2,0,2
RUS,CUB,2018.0,1,0,1
AGO,,2008.0,4,0,4
RUS,ROU,2014.0,2,0,2
,SOM,2004.0,4,0,4
YEM,,2012.0,23,0,23
NGA,SWZ,2017.0,1,0,1
,PSE,2002.0,24,0,24
PSE,TUR,2005.0,1,0,1
,ALB,1995.0,27,0,27
JPN,AZE,2012.0,1,0,1
FIN,GHA,2015.0,3,0,3
VUT,,2011.0,1,0,1
THA,ETH,2009.0,2,0,2
MDG,,2014.0,39,0,39
,BEN,2004.0,50,0,50
ARM,KOR,2005.0,1,0,1
HND,ESP,2003.0,1,0,1
GRC,GEO,2020.0,1,0,1
ESP,SAU,2011.0,3,0,3
THA,AUT,2007.0,4,0,4
ZWE,,2013.0,20,0,20
ZWE,FRA,2019.0,3,0,3
PNG,,2003.0,15,0,15
SWE,FJI,2018.0,3,0,3
YEM,JPN,2017.0,1,0,1
AUS,TCA,2010.0,1,0,1
MDG,VNM,2001.0,1,0,1
VNM,KHM,2005.0,1,0,1
AFG,,2016.0,13,0,13
THA,KHM,2004.0,1,0,1
LUX,,2001.0,8,0,8
BMU,,2001.0,1,0,1
MDG,,2015.0,43,0,43
CAN,MTQ,2004.0,1,0,1
TUR,LTU,2019.0,1,0,1
LBN,NOR,2016.0,1,0,1
,HND,2014.0,30,0,30
HKG,BGD,2006.0,1,0,1
TWN,EST,2020.0,1,0,1
PNG,CZE,2020.0,1,0,1
BDI,SEN,2001.0,1,0,1
IND,SVN,2008.0,1,0,1
GUM,AUS,2017.0,1,0,1
DNK,TZA,2017.0,4,0,4
LBR,,2021.0,26,0,26
IDN,SGP,2002.0,2,0,2
AUS,RWA,2011.0,1,0,1
GIN,CAN,2020.0,1,0,1
GBR,MCO,2018.0,3,0,3
BRN,NOR,2020.0,1,0,1
DZA,,2004.0,21,0,21
NIC,,2020.0,28,0,28
MYS,KAZ,2018.0,2,0,2
,COD,2014.0,35,0,35
YEM,ARE,1999.0,1,0,1
GBR,DZA,2006.0,6,0,6
AUS,HRV,2004.0,3,0,3
GUY,NLD,2001.0,2,0,2
SAU,ISR,2004.0,2,0,2
COL,BRA,1998.0,6,0,6
,TGO,1995.0,23,0,23
ISR,PRT,1997.0,5,0,5
THA,ISR,2023.0,2,0,2
MDG,BEL,2008.0,1,0,1
,TON,2012.0,3,0,3
FIN,ARE,2011.0,3,0,3
CAF,,2011.0,6,0,6
USA,NER,2007.0,2,0,2
FRA,BIH,1998.0,1,0,1
PHL,MEX,2009.0,1,0,1
MLI,,2001.0,4,0,4
LCA,USA,1997.0,1,0,1
KEN,ETH,1999.0,6,0,6
PAK,CAN,2001.0,7,0,7
ZWE,NLD,2002.0,4,0,4
JPN,ROU,2011.0,4,0,4
MDA,,2001.0,16,0,16
ROU,MEX,2006.0,1,0,1
MEX,CHE,1997.0,3,0,3
MAR,TUR,1998.0,2,0,2
USA,AFG,2002.0,1,0,1
AFG,ZWE,2010.0,1,0,1
ARG,DNK,2007.0,1,0,1
UKR,LVA,2001.0,1,0,1
MLI,BFA,2009.0,4,0,4
FRA,HRV,2004.0,4,0,4
PLW,FJI,2012.0,1,0,1
KWT,PNG,1999.0,1,0,1
AND,,2019.0,1,0,1
PRT,IRN,2006.0,1,0,1
BWA,BEL,2009.0,1,0,1
NGA,BFA,2000.0,3,0,3
ZWE,DEU,2002.0,3,0,3
GBR,NER,2016.0,4,0,4
KEN,RWA,1997.0,4,0,4
RWA,UGA,1999.0,2,0,2
IRL,ARG,2013.0,2,0,2
BFA,RUS,2006.0,1,0,1
NLD,BGD,2003.0,2,0,2
BGR,MYS,2013.0,1,0,1
IRN,NZL,2013.0,9,0,9
TUN,DZA,2004.0,1,0,1
CUB,ECU,2008.0,1,0,1
USA,NER,1998.0,1,0,1
LTU,,2004.0,62,0,62
ZAF,TTO,2004.0,1,0,1
RUS,LAO,2002.0,1,0,1
JPN,MNE,1999.0,1,0,1
FRA,KHM,2001.0,2,0,2
POL,LBY,2004.0,1,0,1
LBY,POL,2020.0,1,0,1
MMR,IND,2000.0,1,0,1
ARG,BEL,2004.0,3,0,3
AUT,LUX,2001.0,2,0,2
SDN,NLD,2000.0,2,0,2
NGA,BEN,2003.0,5,0,5
ZAF,CAF,2018.0,1,0,1
COG,SEN,2001.0,1,0,1
PAK,TZA,2012.0,3,0,3
PHL,LAO,2017.0,2,0,2
PHL,MNG,2018.0,1,0,1
LKA,NOR,2012.0,2,0,2
,YEM,2006.0,29,0,29
CAN,SMR,2017.0,1,0,1
SWZ,GBR,2009.0,1,0,1
JPN,QAT,2004.0,1,0,1
,KNA,2006.0,4,0,4
SVK,BEL,2014.0,4,0,4
CUB,FIN,2013.0,1,0,1
GRC,IRQ,2014.0,1,0,1
USA,CAF,2007.0,1,0,1
NOR,ROU,2016.0,3,0,3
,DOM,2005.0,8,0,8
KOR,COD,2020.0,1,0,1
SRB,MEX,2003.0,2,0,2
PRY,,2005.0,5,0,5
KOR,TUN,2012.0,2,0,2
KWT,PRT,2009.0,1,0,1
GBR,SOM,2011.0,2,0,2
MUS,BRA,2009.0,2,0,2
HRV,AUS,2010.0,2,0,2
,NIC,2005.0,17,0,17
PHL,ASM,2010.0,1,0,1
GAB,GBR,2021.0,2,0,2
,MNG,2006.0,55,0,55
ISR,TZA,2015.0,1,0,1
DEU,QAT,2014.0,11,0,11
SVN,SWE,2011.0,4,0,4
KAZ,BEL,2009.0,2,0,2
ISL,CUW,2020.0,1,0,1
SLE,AUT,2010.0,1,0,1
PSE,GBR,2017.0,5,0,5
PHL,PRI,2007.0,1,0,1
GBR,QAT,2006.0,4,0,4
BLR,GBR,2005.0,1,0,1
SGP,BIH,2007.0,1,0,1
BGR,AUT,2012.0,4,0,4
DNK,ZMB,2018.0,1,0,1
,TUV,2000.0,1,0,1
CAN,NAM,2016.0,1,0,1
PHL,BGD,2013.0,3,0,3
IRN,HRV,2023.0,1,0,1
TUN,CMR,2013.0,1,0,1
SLE,ZMB,2021.0,1,0,1
MCO,ESP,2012.0,1,0,1
AUS,BHR,2021.0,2,0,2
MLI,,2015.0,23,0,23
,PSE,1997.0,12,0,12
ISR,PER,2018.0,3,0,3
PER,ISR,2022.0,1,0,1
TUN,OMN,2014.0,4,0,4
CHE,BFA,2013.0,2,0,2
HRV,NOR,2008.0,1,0,1
,MRT,2010.0,16,0,16
LUX,EGY,2017.0,1,0,1
SLE,,2022.0,39,0,39
AGO,,2015.0,8,0,8
BDI,GBR,2015.0,2,0,2
MEX,ATG,2010.0,1,0,1
COL,CZE,2020.0,2,0,2
AFG,,2017.0,12,0,12
HKG,QAT,2010.0,1,0,1
,MOZ,2009.0,54,0,54
POL,ROU,2021.0,2,0,2
SLE,,2017.0,7,0,7
BGR,ROU,2008.0,1,0,1
COL,ISR,2021.0,1,0,1
ERI,,2016.0,2,0,2
MYS,GMB,2021.0,2,0,2
LVA,POL,2016.0,1,0,1
MCO,MAR,2015.0,1,0,1
MKD,CAN,2014.0,1,0,1
,DMA,2013.0,4,0,4
,AGO,2012.0,24,0,24
COL,NZL,2019.0,4,0,4
PAK,FJI,2015.0,1,0,1
DNK,NER,2006.0,1,0,1
TUR,NZL,2013.0,3,0,3
ARG,LUX,2019.0,2,0,2
CHE,LTU,2023.0,3,0,3
BLZ,,2018.0,3,0,3
TUN,CIV,2015.0,5,0,5
PRI,PRT,2016.0,5,0,5
GHA,ESP,2022.0,2,0,2
OMN,JPN,2022.0,1,0,1
SGP,BRA,2019.0,3,0,3
LAO,JPN,2003.0,1,0,1
TUN,CZE,2022.0,3,0,3
LAO,GEO,2015.0,1,0,1
NZL,URY,2016.0,1,0,1
LBN,SAU,2009.0,5,0,5
UKR,IRL,2000.0,2,0,2
IRL,UKR,2008.0,3,0,3
UKR,IRL,2010.0,2,0,2
ITA,ISL,2020.0,4,0,4
LKA,,2005.0,33,0,33
KEN,HUN,2019.0,1,0,1
MMR,,2016.0,18,0,18
GBR,MMR,2015.0,1,0,1
NLD,BEN,2020.0,3,0,3
MDA,ESP,2023.0,1,0,1
BGD,IRN,2018.0,5,0,5
FIN,UGA,2021.0,1,0,1
BIH,,2003.0,17,0,17
,LBR,2009.0,7,0,7
IND,HRV,2009.0,1,0,1
SWE,QAT,2022.0,6,0,6
,SGS,2018.0,1,0,1
BHR,DZA,2021.0,3,0,3
CIV,JPN,2022.0,1,0,1
ATG,,2023.0,3,0,3
MNG,QAT,2021.0,1,0,1
RUS,ZWE,2021.0,1,0,1
PNG,MYS,2022.0,1,0,1
CHN,LTU,2022.0,7,0,7
ECU,AUT,2021.0,1,0,1
NCL,GBR,2019.0,1,0,1
MWI,FIN,2023.0,1,0,1
,TLS,2013.0,4,0,4
,AFG,2012.0,18,0,18
CZE,LBN,2020.0,1,0,1
HKG,MEX,2022.0,2,0,2
USA,TJK,2021.0,1,0,1
ALB,CAN,2020.0,2,0,2
BOL,MEX,2005.0,1,0,1
LKA,ETH,2019.0,1,0,1
HKG,ITA,2006.0,2,0,2
,BMU,2013.0,6,0,6
,MMR,1998.0,18,0,18
NGA,PHL,2022.0,1,0,1
EST,HUN,2017.0,1,0,1
EGY,HKG,2019.0,1,0,1
IRN,UKR,2014.0,3,0,3
IND,SWE,2024.0,2,0,2
SOM,,2018.0,1,0,1
UGA,DZA,2017.0,1,0,1
TLS,,2017.0,7,0,7
TCD,,2017.0,8,0,8
CHL,ARM,2019.0,1,0,1
GHA,FIN,2023.0,1,0,1
ZAF,KOR,2024.0,1,0,1
SGP,OMN,2020.0,2,0,2
BRA,CPV,2017.0,1,0,1
LSO,ZWE,2021.0,2,0,2
UGA,EGY,2020.0,1,0,1
GEO,FIN,2022.0,1,0,1
LUX,PAK,2016.0,1,0,1
,PLW,2016.0,3,0,3
PRI,COL,2019.0,2,0,2
,GRD,2009.0,17,0,17
,DJI,2016.0,5,0,5
NGA,IDN,2019.0,3,0,3
,AND,2001.0,3,0,3
BRA,MAC,2016.0,1,0,1
MCO,SWE,2023.0,1,0,1
ISR,AGO,2019.0,1,0,1
BLR,PRT,1999.0,2,0,2
,COM,2015.0,5,0,5
CAF,,2021.0,11,0,11
MDA,GBR,2001.0,2,0,2
PRT,GMB,2021.0,1,0,1
VCT,CAN,2022.0,1,0,1
ESP,SDN,2019.0,2,0,2
KHM,GBR,2023.0,2,0,2
HKG,DNK,2023.0,7,0,7
ZAF,SOM,2021.0,1,0,1
MDA,,2008.0,24,0,24
FRA,UGA,1998.0,1,0,1
VEN,SWE,2002.0,3,0,3
NLD,SYC,2003.0,1,0,1
CZE,AFG,1999.0,1,0,1
BWA,,2005.0,13,0,13
ETH,EST,2012.0,1,0,1
BEN,,2002.0,4,0,4
EGY,PSE,2014.0,2,0,2
HTI,JAM,2015.0,1,0,1
NZL,ESP,2001.0,3,0,3
CZE,NLD,1997.0,5,0,5
FJI,NGA,1999.0,1,0,1
KEN,NER,2006.0,1,0,1
,YEM,2000.0,6,0,6
YEM,EGY,2003.0,2,0,2
FRA,MKD,2000.0,2,0,2
SOM,,2022.0,10,0,10
USA,GAB,1998.0,1,0,1
YEM,FRA,2000.0,2,0,2
CIV,GBR,2001.0,2,0,2
PHL,BLR,2012.0,1,0,1
AUT,LUX,2008.0,1,0,1
CHE,ZMB,1998.0,1,0,1
ZWE,LSO,2006.0,1,0,1
UZB,KAZ,2003.0,1,0,1
PLW,,2012.0,1,0,1
KEN,RUS,2008.0,1,0,1
COM,CAN,2002.0,1,0,1
MUS,USA,2003.0,2,0,2
USA,KHM,2005.0,2,0,2
BEN,BDI,2015.0,1,0,1
GRC,HRV,2016.0,1,0,1
COM,CAF,2005.0,1,0,1
GRC,JOR,2005.0,1,0,1
SLE,CHE,2020.0,4,0,4
IDN,VNM,2017.0,5,0,5
CAN,QAT,2001.0,2,0,2
IDN,CAN,1998.0,2,0,2
MDG,JPN,2000.0,1,0,1
DZA,,2001.0,18,0,18
ITA,LVA,2000.0,1,0,1
UGA,AUT,2012.0,2,0,2
SYR,,2004.0,11,0,11
CHN,COD,2017.0,1,0,1
BEL,MKD,2002.0,1,0,1
MKD,,2006.0,10,0,10
TGO,CAN,2011.0,1,0,1
UGA,,2004.0,11,0,11
ITA,JOR,2019.0,8,0,8
VIR,GBR,2000.0,1,0,1
GBR,VIR,2002.0,1,0,1
GBR,PSE,2007.0,3,0,3
DZA,JOR,2004.0,1,0,1
KEN,SDN,2000.0,2,0,2
RWA,,2012.0,9,0,9
HRV,CZE,2001.0,4,0,4
MNE,FRA,2021.0,2,0,2
BEL,IRL,2005.0,3,0,3
CAN,LKA,2001.0,1,0,1
BRN,IDN,2017.0,1,0,1
,MNG,2000.0,15,0,15
BGR,UKR,2013.0,3,0,3
NGA,PRT,2014.0,2,0,2
,SYR,2005.0,49,0,49
TWN,MAC,2011.0,1,0,1
PNG,,2013.0,16,0,16
LTU,SVN,2007.0,1,0,1
EST,CZE,2021.0,3,0,3
MDV,MDA,2011.0,1,0,1
,GUF,2003.0,10,0,10
CHN,EST,2011.0,2,0,2
BLR,PRT,2007.0,4,0,4
SRB,CZE,2008.0,3,0,3
,KHM,1997.0,6,0,6
QAT,TUR,2012.0,1,0,1
MAR,BEN,2009.0,1,0,1
BEN,MAR,2012.0,1,0,1
HRV,ESP,2004.0,1,0,1
UKR,AUS,2005.0,2,0,2
PRT,CHL,2008.0,3,0,3
CZE,MKD,2014.0,1,0,1
IND,NAM,2014.0,1,0,1
EST,PRT,2015.0,1,0,1
,DMA,2003.0,3,0,3
ROU,SVK,2015.0,1,0,1
CAN,NER,2009.0,1,0,1
KOR,ARE,2013.0,4,0,4
HKG,BLR,2009.0,1,0,1
,GLP,2000.0,13,0,13
BGD,CHN,2010.0,6,0,6
GRC,EGY,2011.0,2,0,2
TON,,2009.0,1,0,1
SEN,SGP,2011.0,1,0,1
CHE,TCD,2016.0,1,0,1
UKR,PRI,2009.0,1,0,1
KGZ,RUS,2006.0,1,0,1
GBR,BLZ,2009.0,1,0,1
,HND,2004.0,12,0,12
GAB,,2006.0,9,0,9
ESP,PSE,2004.0,2,0,2
ZAF,ESP,2005.0,2,0,2
PYF,NCL,2011.0,1,0,1
KEN,COL,2015.0,4,0,4
COL,CUB,2005.0,1,0,1
NIC,CRI,2021.0,3,0,3
LTU,ESP,2012.0,1,0,1
BEL,SAU,2010.0,1,0,1
PHL,CIV,2017.0,1,0,1
FRA,GHA,2016.0,4,0,4
NPL,DEU,2007.0,3,0,3
TTO,NGA,2013.0,1,0,1
GHA,RWA,2010.0,2,0,2
SYR,MEX,2015.0,1,0,1
NLD,SLV,2019.0,1,0,1
CAF,CMR,2020.0,2,0,2
PAK,ERI,2011.0,1,0,1
ERI,,2022.0,17,0,17
KOR,SVN,2018.0,1,0,1
FRA,SYR,2011.0,17,0,17
SMR,FRA,2016.0,1,0,1
CZE,HRV,2009.0,2,0,2
BEL,HKG,2012.0,2,0,2
GHA,MYS,2010.0,1,0,1
JOR,DZA,2010.0,1,0,1
KAZ,ARE,2011.0,1,0,1
ISL,AUS,2011.0,3,0,3
,VUT,2007.0,3,0,3
RUS,BGD,2021.0,1,0,1
DZA,PAK,2014.0,4,0,4
COG,SWZ,2016.0,1,0,1
,GRD,2011.0,17,0,17
ZMB,MWI,2018.0,1,0,1
LKA,NZL,2010.0,4,0,4
COL,HND,2014.0,1,0,1
SSD,NLD,2022.0,1,0,1
TWN,MEX,2005.0,1,0,1
GBR,FJI,2020.0,1,0,1
JOR,YEM,2015.0,2,0,2
DEU,MDG,2018.0,3,0,3
HUN,NPL,2018.0,1,0,1
RWA,SGP,2020.0,1,0,1
GUM,,2021.0,6,0,6
ISR,HKG,2014.0,3,0,3
CHE,TGO,2021.0,1,0,1
NOR,LKA,2023.0,1,0,1
SGP,ISL,2020.0,1,0,1
NLD,LKA,2023.0,2,0,2
ZAF,IDN,2015.0,2,0,2
VUT,,2021.0,10,0,10
URY,ECU,2017.0,2,0,2
ARM,KEN,2022.0,1,0,1
MDA,CHE,2020.0,1,0,1
DZA,BEL,2023.0,2,0,2
MKD,NOR,2018.0,1,0,1
POL,KWT,2016.0,1,0,1
EGY,MEX,2022.0,2,0,2
KHM,SAU,2020.0,5,0,5
ETH,SDN,2016.0,1,0,1
NZL,FIN,2023.0,6,0,6
JPN,PER,2001.0,1,0,1
IRL,ZWE,2020.0,1,0,1
AUS,MAR,2019.0,1,0,1
MAR,YEM,2019.0,3,0,3
,VIR,2016.0,1,0,1
,SLV,2019.0,22,0,22
HTI,MWI,2022.0,1,0,1
MYS,KEN,2022.0,1,0,1
ITA,BOL,2022.0,1,0,1
,BRB,2019.0,19,0,19
,BLZ,2019.0,9,0,9
IDN,YEM,2023.0,1,0,1
,GMB,2019.0,41,0,41
,MMR,2020.0,24,0,24
JOR,DZA,2023.0,6,0,6
,JPN,2021.0,96,0,96
CAF,MDG,2018.0,1,0,1
FSM,,2014.0,3,0,3
GBR,NFK,2009.0,1,0,1
BGR,MEX,2010.0,1,0,1
SLB,,2021.0,9,0,9
,SMR,2005.0,2,0,2
FRA,QAT,2011.0,8,0,8
PRT,SGP,2011.0,2,0,2
ETH,TUN,2013.0,1,0,1
TUN,LBN,2015.0,2,0,2
LVA,ESP,2013.0,1,0,1
TCD,DEU,2012.0,1,0,1
BRN,NPL,2013.0,1,0,1
,LIE,2006.0,7,0,7
BRA,LIE,2011.0,1,0,1
ISR,HRV,2012.0,2,0,2
KGZ,ISR,2007.0,1,0,1
ARE,ZAF,2012.0,2,0,2
SXM,,2022.0,1,0,1
ARG,CHN,2018.0,1,0,1
MYS,TUN,2000.0,1,0,1
,TON,2005.0,2,0,2
URY,ZAF,2005.0,2,0,2
GHA,KOR,2013.0,3,0,3
QAT,SVN,2020.0,2,0,2
GIN,,2016.0,16,0,16
,CYM,2007.0,2,0,2
AUS,GMB,2020.0,1,0,1
GMB,AUS,2021.0,1,0,1
NLD,PER,2013.0,3,0,3
MYS,BRA,2011.0,3,0,3
DOM,,2003.0,3,0,3
USA,DOM,2009.0,4,0,4
DOM,DMA,2022.0,1,0,1
GIN,BEL,2018.0,2,0,2
UKR,TJK,2006.0,1,0,1
USA,ATG,2005.0,1,0,1
GEO,ITA,2010.0,2,0,2
BFA,GUF,2012.0,1,0,1
USA,VGB,2011.0,2,0,2
UKR,HUN,2011.0,1,0,1
GBR,MDA,2008.0,1,1,0
TWN,ISR,2015.0,4,1,3
YEM,USA,2021.0,2,1,1
IRN,AUT,2004.0,1,2,-1
GBR,VNM,1999.0,2,2,0
BEL,IND,2001.0,4,7,-3
TUR,FIN,2002.0,2,1,1
LUX,ITA,2018.0,2,17,-15
COG,COD,2003.0,3,4,-1
ARE,KWT,2007.0,1,1,0
ZAF,JPN,2003.0,6,2,4
AUT,THA,1997.0,1,1,0
QAT,FIN,2013.0,1,1,0
DNK,ALB,2019.0,1,1,0
CAN,DZA,2006.0,1,2,-1
PER,NLD,2012.0,1,1,0
RUS,KOR,2016.0,3,5,-2
SLE,GBR,2007.0,1,1,0
DNK,ARG,1998.0,1,1,0
PSE,ISR,2002.0,3,9,-6
PSE,USA,2009.0,3,3,0
RUS,BGR,2015.0,4,5,-1
IRN,QAT,2022.0,2,4,-2
UKR,ISR,2005.0,1,2,-1
THA,BGD,2003.0,1,1,0
SGP,HRV,2014.0,1,1,0
SRB,CAN,1997.0,4,3,1
HUN,BRA,2015.0,1,1,0
MEX,ITA,2007.0,3,9,-6
ESP,UKR,2014.0,2,1,1
AUS,ARG,2013.0,2,7,-5
CHN,SLE,2011.0,1,1,0
SWE,NPL,2011.0,1,1,0
GRC,TWN,2020.0,1,1,0
ITA,JOR,2008.0,1,2,-1
KWT,PAK,2018.0,1,2,-1
HKG,IND,2012.0,2,6,-4
DNK,BRA,1998.0,3,1,2
IRN,RUS,1999.0,1,1,0
DEU,CMR,2009.0,3,7,-4
DZA,GRC,2010.0,1,1,0
GBR,KAZ,2013.0,3,3,0
CZE,KOR,2014.0,1,5,-4
UKR,PRT,2012.0,1,2,-1
PRI,BRA,2007.0,1,1,0
USA,CIV,2008.0,2,2,0
JPN,SVK,2012.0,1,1,0
EST,MYS,2020.0,1,1,0
SVN,IRL,2016.0,1,1,0
AUT,LTU,2022.0,2,4,-2
IRN,RUS,2007.0,1,7,-6
OMN,EGY,2006.0,1,2,-1
SGP,IRL,2008.0,2,1,1
BIH,NOR,2010.0,2,1,1
EGY,NOR,2013.0,1,1,0
NOR,QAT,2023.0,2,1,1
SAU,UKR,2017.0,3,2,1
IRN,LTU,2013.0,1,1,0
BFA,ITA,2016.0,2,2,0
QAT,RUS,2022.0,1,1,0
IRN,POL,2013.0,1,1,0
GIN,CHN,2016.0,1,1,0
BGD,OMN,2017.0,1,1,0
IRL,KOR,2016.0,1,5,-4
BRA,CZE,2016.0,1,5,-4
UGA,SWE,2016.0,2,4,-2
CHN,BRA,2006.0,1,1,0
IRN,NZL,2023.0,5,3,2
MDG,USA,2013.0,5,6,-1
ARE,MAR,2019.0,3,1,2
NZL,IRN,2015.0,2,10,-8
SAU,CHL,2021.0,1,1,0
ISR,AUT,2017.0,7,3,4
HUN,BRA,2014.0,1,1,0
HUN,UKR,2022.0,3,2,1
GTM,ESP,2010.0,1,1,0
NLD,PRI,2021.0,1,1,0
PAK,THA,2022.0,7,7,0
GBR,BLR,2019.0,1,2,-1
GRC,SVK,2015.0,1,1,0
ROU,AUT,2011.0,4,5,-1
BRA,PRI,2018.0,1,5,-4
AUT,ARG,2006.0,1,1,0
URY,CHE,2016.0,1,2,-1
POL,IND,2019.0,8,38,-30
KEN,SOM,2019.0,1,1,0
NGA,ETH,2022.0,6,4,2
TTO,IND,2013.0,1,1,0
DEU,BFA,2016.0,3,1,2
MEX,NOR,2019.0,3,1,2
SVN,ITA,2015.0,4,8,-4
CHL,TUN,2020.0,1,2,-1
ARG,JPN,2013.0,1,3,-2
JOR,JPN,2014.0,1,3,-2
DOM,ESP,2014.0,1,3,-2
AZE,USA,2017.0,1,5,-4
REU,NLD,2015.0,1,1,0
SRB,TUR,2018.0,6,3,3
MAR,FIN,2023.0,2,3,-1
ESP,DOM,2021.0,5,6,-1
YEM,DEU,2017.0,2,1,1
MNG,TWN,2020.0,1,3,-2
GBR,CIV,2018.0,2,1,1
CIV,CAN,2020.0,1,8,-7
HKG,ESP,2021.0,3,3,0
KWT,AUS,2020.0,3,4,-1
PRT,ISR,2023.0,2,1,1
CYP,LBN,2021.0,1,1,0
NLD,PAK,2011.0,3,8,-5
IND,MAR,2019.0,2,1,1
FJI,USA,2023.0,2,2,0
HUN,IDN,2023.0,2,4,-2
EGY,TUN,2022.0,1,1,0
NLD,GEO,2021.0,1,2,-1
MYS,PAK,2008.0,3,8,-5
SAU,IND,2024.0,1,3,-2
GBR,MOZ,2022.0,1,2,-1
HUN,SAU,2022.0,1,1,0
AUS,CUB,2006.0,1,1,0
SAU,BRA,2020.0,3,5,-2
TWN,GRC,2017.0,1,1,0
AUT,THA,2005.0,1,5,-4
LBY,MYS,2015.0,2,8,-6
QAT,OMN,2013.0,1,2,-1
TUR,SDN,2016.0,1,1,0
LBR,CHN,2017.0,1,1,0
MDG,KEN,2015.0,2,1,1
BGD,OMN,2022.0,1,2,-1
OMN,BGD,2023.0,1,1,0
BIH,GBR,2010.0,1,1,0
TWN,QAT,2017.0,1,1,0
NLD,ISL,2013.0,1,1,0
NOR,ISL,2022.0,3,5,-2
BDI,KEN,2013.0,1,1,0
NLD,HRV,2019.0,2,6,-4
THA,KEN,2021.0,1,1,0
BIH,GBR,2023.0,3,1,2
AUS,BTN,2014.0,3,1,2
CHE,PAN,2015.0,2,1,1
IRQ,IDN,2019.0,1,3,-2
ITA,LTU,2020.0,4,6,-2
PAK,SGP,2022.0,3,5,-2
AUS,USA,2024.0,2,2,0
CMR,MAR,2016.0,2,2,0
NLD,JOR,2012.0,1,1,0
IDN,FRA,2006.0,3,5,-2
BEL,UKR,2005.0,4,2,2
ISL,AUS,2014.0,1,2,-1
FRA,SYR,2001.0,4,1,3
DEU,QAT,2019.0,3,6,-3
CRI,HND,2003.0,1,1,0
CAN,CMR,2007.0,4,2,2
RUS,KGZ,2000.0,1,4,-3
RUS,AZE,2008.0,3,11,-8
EGY,TWN,2007.0,1,2,-1
IRQ,AUS,2009.0,1,1,0
LBN,BEL,2003.0,1,1,0
PER,CAN,2005.0,2,2,0
EST,GBR,2006.0,3,1,2
LTU,FIN,2004.0,2,2,0
CIV,CAN,2007.0,1,1,0
CAN,CIV,2016.0,2,2,0
VUT,AUS,2014.0,1,2,-1
RUS,LVA,2014.0,3,3,0
UKR,BLR,2017.0,2,1,1
NLD,LVA,2017.0,1,1,0
NZL,ITA,2000.0,1,2,-1
GBR,FJI,2018.0,1,2,-1
FRA,BLR,2015.0,2,3,-1
GBR,BLR,2021.0,1,2,-1
MEX,GTM,2006.0,1,4,-3
ZAF,MAR,2016.0,1,2,-1
DOM,USA,2004.0,1,2,-1
FIN,ROU,2010.0,1,4,-3
ROU,FIN,2011.0,1,2,-1
DEU,NGA,2007.0,3,10,-7
NZL,KEN,2010.0,1,1,0
MWI,KEN,2012.0,1,1,0
EST,DNK,2020.0,2,1,1
IND,GRC,2000.0,1,1,0
MNG,AUS,2003.0,1,3,-2
EGY,FIN,2012.0,2,3,-1
SDN,SAU,1998.0,1,2,-1
KOR,NZL,2004.0,2,1,1
LKA,SWE,2007.0,1,2,-1
FRA,BGR,2009.0,5,9,-4
BEL,TUR,2002.0,1,2,-1
POL,SVN,2022.0,1,1,0
CHE,EST,2011.0,1,2,-1
GHA,LBR,2018.0,1,1,0
LKA,JPN,2006.0,2,7,-5
GBR,BIH,2013.0,2,1,1
SRB,BEL,2010.0,2,1,1
CHL,NLD,2008.0,3,3,0
BGR,POL,2022.0,1,4,-3
PAN,CRI,2014.0,2,1,1
ARG,DZA,2000.0,1,2,-1
ZAF,SEN,2009.0,1,2,-1
GBR,SVN,2003.0,3,3,0
ISR,DNK,2019.0,4,2,2
SVN,TUR,2021.0,1,1,0
FRA,KEN,2023.0,1,2,-1
MWI,ZWE,2015.0,1,1,0
HUN,ESP,2008.0,4,3,1
ARE,SYR,2015.0,2,3,-1
SAU,DNK,2022.0,2,3,-1
ARG,VEN,2013.0,1,1,0
DOM,USA,2014.0,6,3,3
USA,LBY,2019.0,1,1,0
TGO,BEN,2010.0,1,1,0
CHN,KEN,2014.0,4,2,2
SGP,VNM,2015.0,3,3,0
BEN,BFA,2015.0,1,13,-12
BFA,SEN,2016.0,1,4,-3
BLR,KAZ,2014.0,1,1,0
BWA,ZAF,2002.0,1,4,-3
MEX,SVN,2017.0,1,1,0
SRB,PRT,2022.0,2,1,1
CAN,MLI,2022.0,1,1,0
HKG,TUR,2018.0,1,1,0
IND,MUS,2011.0,1,1,0
NZL,BRA,2017.0,1,6,-5
PRT,CPV,2017.0,1,1,0
RWA,IND,2014.0,1,1,0
AND,ESP,2021.0,3,8,-5
CHL,FIN,2014.0,2,4,-2
ESP,PAN,2005.0,1,1,0
NZL,BEL,2007.0,1,1,0
ITA,ISL,2017.0,1,1,0
CRI,MEX,2011.0,2,4,-2
PAK,DNK,2012.0,1,3,-2
BGD,THA,2008.0,1,3,-2
TUN,IND,2012.0,1,1,0
PSE,ITA,2020.0,1,5,-4
BRA,AUT,1997.0,1,2,-1
BEN,BEL,2011.0,2,5,-3
DEU,BLR,2014.0,4,5,-1
NZL,AUT,2000.0,2,1,1
FRA,VEN,2021.0,1,3,-2
DNK,KOR,2005.0,1,2,-1
FIN,CHN,2003.0,3,11,-8
SAU,PSE,2018.0,2,2,0
THA,DNK,2013.0,3,4,-1
PAN,ESP,2019.0,2,11,-9
ISL,ISR,2018.0,1,1,0
BEN,NLD,2011.0,1,1,0
RUS,GRC,2008.0,3,3,0
GEO,GBR,2017.0,1,1,0
BGR,FIN,2013.0,2,1,1
THA,IRL,2012.0,1,1,0
BOL,CAN,2018.0,1,1,0
IRL,TWN,2012.0,2,1,1
GBR,CRI,2013.0,1,3,-2
AUS,SVN,2020.0,5,5,0
SLV,SVN,2017.0,4,4,0
NLD,LTU,2018.0,1,3,-2
DZA,MYS,2016.0,1,3,-2
CZE,LVA,2018.0,1,1,0
ZWE,BWA,2014.0,2,1,1
SAU,NLD,2003.0,1,1,0
UZB,JPN,2021.0,1,1,0
EST,ITA,2020.0,4,7,-3
OMN,NZL,2018.0,1,2,-1
VNM,CAN,2014.0,2,5,-3
BHS,USA,2022.0,6,2,4
GIN,GNQ,2015.0,1,2,-1
JPN,COD,2020.0,1,2,-1
BFA,BEL,2013.0,3,4,-1
BRA,CMR,2014.0,1,1,0
BGD,FRA,2016.0,3,2,1
TUR,UZB,2020.0,1,1,0
TGO,USA,2020.0,4,1,3
LTU,FIN,2001.0,1,1,0
CZE,GRC,2004.0,1,1,0
URY,GBR,2018.0,1,3,-2
CYP,DEU,2008.0,1,5,-4
NLD,OMN,2021.0,1,2,-1
ETH,SDN,2020.0,1,1,0
BGR,TUR,2018.0,1,1,0
TWN,EGY,2021.0,2,4,-2
CHL,POL,2019.0,2,4,-2
UKR,EST,2022.0,1,3,-2
MNE,BIH,2019.0,1,1,0
DNK,CHL,2007.0,1,1,0
ZAF,CHL,2022.0,2,2,0
COD,MWI,2021.0,1,1,0
PAK,THA,2018.0,3,12,-9
CZE,CYP,2019.0,1,1,0
KAZ,ESP,2020.0,1,2,-1
KOR,ARE,2024.0,2,1,1
SLE,ITA,2019.0,1,1,0
LIE,DEU,2023.0,1,4,-3
ZMB,AUS,2021.0,2,2,0
DNK,NPL,2017.0,3,3,0
IRQ,POL,2023.0,1,1,0
SVN,CHE,2023.0,2,2,0
CZE,SAU,2020.0,3,2,1
MYS,LBN,2020.0,1,1,0
QAT,IRQ,2022.0,1,1,0
NZL,WSM,2023.0,1,1,0
QAT,KEN,2014.0,1,1,0
ZAF,CIV,2008.0,2,3,-1
MAR,ITA,2000.0,1,3,-2
SWE,ARE,2014.0,2,3,-1
IRN,AZE,2007.0,1,1,0
USA,MEX,2024.0,3,4,-1
DEU,TUN,2019.0,5,10,-5
AUS,SVN,2007.0,2,1,1
PRT,CHL,2011.0,1,2,-1
SWE,ISR,2012.0,4,5,-1
LBN,SAU,2004.0,2,1,1
VNM,SGP,2012.0,1,3,-2
KWT,CZE,1999.0,1,1,0
IRL,SGP,2006.0,1,2,-1
KGZ,UZB,2001.0,1,1,0
BEL,SGP,2008.0,1,2,-1
SWE,BGR,2019.0,1,3,-2
HRV,SVK,2011.0,1,2,-1
ZAF,SAU,2008.0,2,7,-5
IDN,IND,2002.0,1,10,-9
FRA,COG,2008.0,4,2,2
THA,ITA,2006.0,1,3,-2
FJI,NCL,2018.0,1,1,0
RUS,EST,2009.0,2,2,0
DEU,MWI,2017.0,4,5,-1
VIR,USA,2000.0,1,3,-2
BGR,RUS,2005.0,2,4,-2
NZL,EGY,2006.0,1,1,0
IND,ZAF,1997.0,3,1,2
DNK,ISR,2007.0,1,4,-3
SAU,SWE,2013.0,1,8,-7
FRA,SYR,2004.0,3,1,2
LUX,CHE,2006.0,1,3,-2
FJI,GUY,2022.0,1,1,0
DEU,ETH,2003.0,2,4,-2
ISL,NOR,2009.0,1,1,0
ITA,EGY,1999.0,2,3,-1
ZAF,CMR,2003.0,3,2,1
ITA,UKR,2003.0,3,5,-2
JPN,KAZ,2003.0,4,1,3
TUR,KEN,2003.0,1,1,0
NLD,TZA,1999.0,1,5,-4
ZAF,SEN,2021.0,3,1,2
KAZ,USA,2006.0,2,1,1
CHE,ETH,2014.0,2,2,0
QAT,SWE,2013.0,1,1,0
BGR,BRA,2010.0,1,1,0
JPN,SYR,2013.0,1,1,0
USA,AZE,2007.0,1,1,0
SDN,QAT,2010.0,1,1,0
FRA,HRV,2009.0,4,3,1
ECU,CHL,2015.0,2,11,-9
IRQ,JOR,2021.0,4,10,-6
THA,TZA,2011.0,1,1,0
FSM,PLW,2004.0,2,1,1
POL,ZAF,2014.0,2,1,1
GBR,SVK,2008.0,6,8,-2
ITA,MAR,2000.0,3,1,2
IRL,QAT,2022.0,2,3,-1
TWN,ITA,2008.0,2,1,1
SYR,DNK,2005.0,1,1,0
FRA,LBY,2011.0,1,2,-1
NPL,KOR,2011.0,3,1,2
LBN,GBR,2011.0,3,9,-6
LTU,IRL,2016.0,1,1,0
CHE,RWA,2019.0,1,1,0
SWE,IRQ,2016.0,3,5,-2
BEN,ITA,2013.0,2,1,1
USA,NER,2017.0,2,1,1
AUS,ARM,2016.0,1,1,0
ETH,MWI,2020.0,2,1,1
ISR,ZAF,1998.0,1,3,-2
JPN,ZAF,2018.0,2,5,-3
MYS,IRL,2008.0,1,3,-2
KWT,PAK,2017.0,1,1,0
BGR,MKD,2021.0,1,2,-1
ISR,AUT,2018.0,5,2,3
GBR,GEO,2023.0,1,5,-4
SDN,MYS,2012.0,3,6,-3
FIN,NZL,2022.0,1,6,-5
GAB,CMR,2022.0,1,1,0
CHN,ITA,2024.0,2,1,1
LBN,ITA,2022.0,6,5,1
PAK,KAZ,2021.0,1,1,0
ESP,BGR,2010.0,1,4,-3
GRC,JPN,2006.0,2,7,-5
BEL,NGA,2023.0,1,2,-1
SWE,KHM,2019.0,2,1,1
IRN,THA,2019.0,2,2,0
IRQ,GBR,2005.0,2,1,1
NLD,LVA,2022.0,1,2,-1
AGO,PRT,2016.0,2,4,-2
COD,CAF,2020.0,1,4,-3
CHN,QAT,2020.0,3,3,0
UGA,NLD,2020.0,4,4,0
USA,MLT,2018.0,3,4,-1
ITA,ECU,2023.0,3,1,2
BLR,SWE,2021.0,2,2,0
BGD,ITA,2023.0,3,2,1
CZE,IND,2000.0,1,1,0
VNM,COL,2014.0,1,1,0
ESP,UKR,2001.0,3,5,-2
DEU,MWI,2022.0,4,2,2
ARM,FRA,2002.0,2,4,-2
PRT,POL,1997.0,2,2,0
USA,GMB,2001.0,1,1,0
BGD,SWE,2002.0,1,1,0
HRV,BIH,1998.0,3,2,1
THA,IDN,2011.0,2,4,-2
PHL,GBR,1997.0,1,5,-4
JPN,ARE,2012.0,3,1,2
CAN,ROU,2000.0,1,5,-4
IDN,DEU,2006.0,3,5,-2
ROU,POL,2011.0,1,1,0
SRB,CAN,2012.0,1,3,-2
LBR,USA,2011.0,3,2,1
EGY,POL,2017.0,4,2,2
CYP,DNK,2017.0,1,2,-1
VEN,GBR,2019.0,3,1,2
TWN,CHL,2016.0,2,1,1
SGP,NZL,2009.0,3,6,-3
CAN,CRI,2003.0,1,3,-2
GBR,BHR,2007.0,1,1,0
NIC,PER,2013.0,1,1,0
PHL,AUS,1998.0,1,6,-5
TZA,BEL,2014.0,1,6,-5
VUT,AUS,2015.0,2,2,0
CIV,CHE,2005.0,1,1,0
RUS,MYS,2020.0,1,4,-3
CHE,COD,2014.0,1,1,0
KHM,BEL,2015.0,1,1,0
CIV,SEN,2014.0,3,2,1
ZWE,ETH,2003.0,1,1,0
SRB,NLD,2004.0,1,5,-4
TUR,GEO,2019.0,1,1,0
ETH,JPN,2009.0,1,1,0
IND,NGA,2004.0,2,1,1
BHR,IND,2005.0,2,3,-1
GBR,KWT,2003.0,3,8,-5
NOR,TUR,2008.0,1,4,-3
CAN,ALB,2019.0,1,1,0
ITA,ZAF,2008.0,2,5,-3
CHE,COL,2021.0,2,9,-7
NOR,NGA,2010.0,1,1,0
DNK,THA,2009.0,2,3,-1
DNK,THA,2019.0,1,2,-1
ARE,QAT,2005.0,1,2,-1
MOZ,ETH,2020.0,1,1,0
CAN,SYC,2019.0,1,1,0
IRL,KOR,2017.0,1,7,-6
POL,SAU,2019.0,1,1,0
GBR,BRN,1999.0,1,2,-1
CZE,ESP,1997.0,2,2,0
ARE,CHE,2019.0,2,1,1
SYR,FRA,2018.0,1,9,-8
DNK,PHL,2022.0,1,1,0
CMR,CHE,2022.0,2,3,-1
CRI,MEX,2019.0,1,5,-4
BRA,LKA,2019.0,1,2,-1
ESP,ISR,2010.0,4,8,-4
CRI,COL,2010.0,1,3,-2
COL,CRI,2012.0,1,2,-1
DEU,BFA,2018.0,1,2,-1
PHL,BGD,2010.0,1,1,0
USA,MDG,2005.0,4,1,3
UZB,DEU,2007.0,4,4,0
ITA,SMR,2016.0,2,5,-3
CAN,ISL,2010.0,1,1,0
ROU,CAN,2022.0,2,2,0
PRY,USA,2020.0,2,8,-6
THA,PRT,2020.0,1,3,-2
FRA,PAK,2004.0,2,3,-1
NZL,PAK,2009.0,1,4,-3
FRA,SVK,2012.0,2,2,0
TWN,QAT,2016.0,2,1,1
ZWE,SWE,2020.0,1,1,0
IRQ,CYP,2022.0,1,1,0
SVK,ESP,2018.0,1,2,-1
TZA,NGA,2018.0,1,2,-1
BIH,USA,2019.0,1,6,-5
USA,GNQ,2021.0,1,1,0
DZA,MYS,2022.0,1,3,-2
CUB,BEL,2021.0,1,2,-1
NGA,TWN,2021.0,2,1,1
ITA,HKG,2023.0,1,5,-4
BOL,COL,2023.0,1,1,0
EGY,SWE,2008.0,2,2,0
CHE,UKR,2005.0,1,3,-2
BRA,SVN,2020.0,1,2,-1
BIH,HRV,1999.0,3,7,-4
IRL,THA,2012.0,1,1,0
ISL,BEL,2019.0,1,1,0
BFA,KEN,2007.0,1,1,0
MYS,LKA,2011.0,1,1,0
ALB,ITA,2008.0,1,2,-1
EGY,KAZ,2011.0,1,1,0
FRA,ALB,2017.0,1,1,0
AUS,LBN,2010.0,1,1,0
ROU,CMR,2016.0,1,1,0
NLD,MWI,2008.0,2,1,1
PAN,ESP,2011.0,1,3,-2
YEM,MYS,2008.0,1,3,-2
CZE,HRV,2004.0,1,2,-1
TGO,CHE,2018.0,1,1,0
PHL,MYS,2007.0,1,1,0
GMB,ZAF,2005.0,2,1,1
NOR,IDN,2015.0,2,2,0
CZE,SGP,2022.0,2,1,1
JPN,SRB,2020.0,1,1,0
COG,MAR,2016.0,1,2,-1
JPN,CHL,2020.0,2,6,-4
DZA,ZAF,2013.0,1,3,-2
ECU,BEL,2012.0,1,2,-1
LTU,RUS,2017.0,1,5,-4
CYP,BEL,2014.0,1,2,-1
TWN,BGR,2012.0,1,1,0
NCL,CAN,2020.0,1,1,0
JOR,ITA,2020.0,4,3,1
CHE,HTI,2019.0,1,1,0
DZA,DEU,2013.0,3,2,1
BEL,PER,2019.0,2,5,-3
RWA,IND,2015.0,1,1,0
MWI,CHN,2018.0,1,2,-1
CAN,PAN,2020.0,1,1,0
GRC,IND,2017.0,1,3,-2
LBR,UGA,2023.0,1,1,0
KOR,KEN,2016.0,1,1,0
COL,PRT,2011.0,2,1,1
ITA,SLE,2017.0,1,1,0
CHL,IRN,2022.0,1,3,-2
NLD,NPL,2017.0,2,1,1
PRT,SRB,2022.0,1,2,-1
IRN,UKR,2021.0,1,1,0
UKR,KOR,2007.0,2,1,1
NLD,CMR,2016.0,1,2,-1
MRT,FRA,2005.0,1,3,-2
ISR,NZL,2009.0,1,1,0
SGP,IRL,2004.0,1,1,0
HUN,PRT,2004.0,1,1,0
FRA,KHM,2011.0,1,2,-1
JAM,BRB,2005.0,1,1,0
ARE,IND,2003.0,1,2,-1
FRA,KAZ,2016.0,1,1,0
BHR,TUR,2014.0,1,1,0
SWE,ISR,1997.0,1,4,-3
NLD,KEN,2005.0,3,2,1
BEL,NOR,2002.0,1,1,0
CRI,FRA,2008.0,3,1,2
MYS,CAN,2000.0,1,1,0
NOR,ISR,2011.0,3,2,1
AUS,IRQ,2009.0,1,1,0
ROU,CHE,1997.0,1,2,-1
ISL,NZL,2004.0,1,1,0
SAU,QAT,2008.0,2,1,1
LKA,ZAF,2018.0,1,1,0
BEL,BDI,2017.0,2,1,1
QAT,CHE,2011.0,1,1,0
VNM,BEL,2010.0,1,6,-5
FJI,JPN,2009.0,1,2,-1
NER,USA,2012.0,1,1,0
LVA,LTU,2019.0,2,2,0
LBN,ARE,2014.0,1,2,-1
ARE,ARG,2011.0,1,1,0
CHN,SLE,2019.0,1,1,0
TUR,ROU,2004.0,2,2,0
BEL,PHL,2021.0,3,3,0
KOR,MEX,2009.0,1,3,-2
AUS,LUX,2019.0,1,3,-2
CHN,GIN,2016.0,1,1,0
GIN,CHN,2018.0,1,1,0
OMN,SAU,2017.0,2,5,-3
USA,BTN,2019.0,1,1,0
TUR,SDN,2022.0,2,3,-1
MAC,AUS,2016.0,1,1,0
CYM,MYS,2022.0,1,1,0
SGP,TUN,2007.0,1,1,0
PRI,FRA,2016.0,1,1,0
DZA,NLD,2002.0,2,1,1
ZAF,TWN,2020.0,1,1,0
RWA,CHN,2019.0,1,7,-6
BRA,IDN,2022.0,1,1,0
SVK,SAU,2018.0,1,1,0
THA,IRN,2020.0,1,3,-2
BEL,CHN,2024.0,1,3,-2
MNE,MKD,2018.0,1,2,-1
ESP,PAN,2002.0,2,1,1
EGY,ZAF,2008.0,1,1,0
BIH,ITA,2020.0,2,2,0
TUR,SVN,2021.0,1,1,0
CRI,ECU,2018.0,2,1,1
ISL,NLD,2014.0,1,2,-1
SVK,ESP,2022.0,1,4,-3
FJI,IND,2023.0,1,2,-1
GRD,ESP,2009.0,1,1,0
NGA,BGD,2021.0,2,1,1
KAZ,SWE,2017.0,2,1,1
VEN,ITA,1998.0,2,3,-1
FRA,PER,1997.0,1,2,-1
ARE,NZL,2020.0,2,9,-7
KEN,CAN,1997.0,4,3,1
PHL,IND,2017.0,1,9,-8
DEU,PHL,2006.0,3,1,2
IND,TTO,2018.0,1,1,0
CHE,KEN,2006.0,1,1,0
AUT,LVA,2007.0,1,1,0
POL,KOR,2010.0,3,1,2
CAN,JAM,2000.0,1,1,0
AUS,JAM,2006.0,1,1,0
NLD,GHA,2012.0,3,2,1
DEU,SDN,2007.0,1,5,-4
NZL,ARG,2021.0,1,4,-3
CHE,ARG,2007.0,2,3,-1
NOR,SGP,2007.0,1,4,-3
EST,ZAF,2014.0,1,1,0
NPL,AUT,2008.0,2,1,1
KGZ,RUS,2003.0,2,4,-2
HUN,DNK,2006.0,2,3,-1
LUX,GBR,2007.0,2,3,-1
TUN,DZA,2009.0,5,2,3
NLD,CHL,2008.0,3,3,0
MOZ,FRA,2021.0,2,1,1
THA,FIN,2023.0,1,3,-2
ARE,CZE,2020.0,2,3,-1
IND,DZA,2021.0,1,1,0
BWA,AUS,2020.0,2,2,0
BGD,USA,2024.0,2,2,0
PAK,AFG,2023.0,1,7,-6
EGY,IRN,2022.0,1,1,0
GIN,GNB,2021.0,2,1,1
EGY,SOM,2019.0,1,1,0
ETH,NGA,2023.0,1,2,-1
KEN,JPN,2000.0,1,7,-6
GBR,LVA,2018.0,1,3,-2
HKG,IND,2002.0,1,7,-6
SAU,FRA,2000.0,2,1,1
NZL,ZAF,2007.0,2,3,-1
SEN,ITA,2011.0,1,1,0
USA,BHR,1999.0,1,2,-1
TWN,NGA,2008.0,1,1,0
NLD,TZA,1998.0,1,1,0
KAZ,RUS,2003.0,8,4,4
KEN,SVK,2020.0,1,5,-4
CHE,LKA,2004.0,1,1,0
GBR,BHS,2010.0,2,1,1
BEL,RUS,2023.0,3,16,-13
UKR,TWN,2016.0,2,2,0
PRT,URY,2013.0,1,2,-1
CHE,IDN,2013.0,1,2,-1
DEU,BFA,2017.0,1,1,0
SMR,ITA,2017.0,2,5,-3
ISR,KAZ,2016.0,1,1,0
SWE,SVK,2020.0,1,2,-1
NLD,GEO,2019.0,1,2,-1
MYS,FRA,2013.0,1,8,-7
MKD,NLD,2019.0,3,1,2
GHA,HUN,2020.0,1,1,0
MAR,QAT,2018.0,1,1,0
QAT,PSE,2020.0,1,4,-3
ETH,FRA,1997.0,1,2,-1
LIE,DEU,2006.0,1,2,-1
GBR,GIB,2020.0,2,2,0
COL,CHE,2004.0,2,1,1
NPL,AUS,2004.0,1,1,0
PRI,CHN,2012.0,2,1,1
SYR,DEU,2017.0,4,4,0
CYP,CHN,2020.0,1,2,-1
TUR,BRN,2018.0,1,1,0
USA,GMB,2008.0,2,2,0
RUS,ROU,2019.0,2,2,0
VNM,LUX,2023.0,2,2,0
UKR,BLR,2022.0,1,1,0
MKD,ESP,2020.0,1,1,0
AUT,SGP,2022.0,2,5,-3
SEN,ITA,2019.0,1,1,0
GHA,BFA,2018.0,3,1,2
SWE,HKG,2004.0,2,2,0
AZE,IRN,2021.0,3,1,2
SWE,MAR,2021.0,2,1,1
NOR,EST,2012.0,1,2,-1
TUR,MAR,2023.0,1,2,-1
VNM,HUN,2020.0,1,2,-1
ITA,UGA,1998.0,1,1,0
COL,PAN,2023.0,1,2,-1
OMN,JPN,2020.0,1,2,-1
DOM,CAN,2023.0,1,1,0
SEN,GHA,2023.0,1,1,0
CHN,SVN,2022.0,2,5,-3
KOR,FIN,2002.0,1,2,-1
FIN,BRA,2010.0,2,2,0
GBR,CUB,2007.0,1,2,-1
PRT,HKG,2009.0,1,1,0
MOZ,ESP,2003.0,1,1,0
MYS,MEX,2011.0,1,1,0
IND,AUT,2002.0,1,5,-4
NZL,ITA,2010.0,2,3,-1
MDG,USA,2003.0,1,2,-1
RUS,LVA,2015.0,1,5,-4
PAK,TWN,2011.0,1,1,0
COL,URY,2017.0,1,1,0
IND,ARE,2024.0,1,1,0
GBR,BOL,2018.0,1,1,0
DZA,ARG,2017.0,1,1,0
LKA,BRN,2017.0,1,1,0
ARE,OMN,2021.0,1,6,-5
KAZ,DEU,2011.0,2,2,0
NER,BFA,2023.0,1,1,0
ARE,OMN,2009.0,2,1,1
USA,ALB,2008.0,2,1,1
HUN,IRQ,2019.0,1,6,-5
GHA,KEN,2019.0,2,3,-1
GHA,TGO,2023.0,1,1,0
MOZ,GBR,2016.0,2,3,-1
DEU,AZE,2020.0,2,3,-1
PRT,CPV,2018.0,1,2,-1
CIV,NGA,2020.0,4,1,3
AUS,MWI,2021.0,1,4,-3
CMR,IND,2023.0,1,2,-1
FIN,NPL,2016.0,1,1,0
FRA,CHE,2024.0,1,1,0
USA,BRN,2000.0,1,2,-1
SWE,LKA,2009.0,1,1,0
BHR,CAN,2008.0,1,2,-1
DEU,GTM,1999.0,1,1,0
CYP,ARE,2019.0,2,3,-1
IRN,JPN,1997.0,1,2,-1
ALB,SRB,2006.0,1,1,0
ZAF,SWZ,1998.0,2,1,1
NLD,TZA,2007.0,3,3,0
BGR,DNK,2003.0,1,1,0
KEN,GHA,2002.0,1,1,0
USA,CMR,1997.0,1,2,-1
OMN,JOR,1999.0,2,3,-1
LUX,AUT,2002.0,1,2,-1
MWI,AUS,2006.0,1,1,0
AUS,MWI,2011.0,1,1,0
SVK,CAN,2007.0,1,1,0
CAN,UKR,2005.0,1,10,-9
GHA,LKA,2013.0,1,1,0
VEN,VNM,2011.0,2,2,0
ROU,HUN,2002.0,1,2,-1
OMN,CAN,1998.0,1,4,-3
IRL,MUS,2000.0,1,1,0
BRA,DNK,2004.0,1,2,-1
FRA,DJI,2006.0,2,3,-1
RWA,UGA,2022.0,1,1,0
IDN,GBR,2003.0,2,6,-4
SWZ,ZAF,2010.0,1,3,-2
BRN,NZL,2017.0,1,1,0
KOR,AZE,2020.0,1,1,0
TTO,NLD,2001.0,2,1,1
JPN,TUN,2010.0,1,3,-2
HKG,PHL,2010.0,1,1,0
DNK,TUR,2005.0,3,1,2
TUR,SRB,2007.0,1,3,-2
GHA,ETH,2018.0,1,1,0
TUN,MAR,2017.0,4,2,2
DEU,ARM,2002.0,1,3,-2
RUS,TUR,2012.0,2,3,-1
LBY,LBN,2010.0,2,1,1
TWN,NLD,2003.0,1,1,0
SGP,IRL,2015.0,2,7,-5
SWE,VNM,2011.0,2,2,0
PRY,USA,2007.0,2,2,0
ISR,UZB,2009.0,1,1,0
CCK,AUS,2014.0,1,2,-1
DEU,BOL,2002.0,1,1,0
KHM,FRA,2009.0,2,3,-1
SGP,VNM,2008.0,1,4,-3
CHE,TUN,2009.0,2,3,-1
CAN,BEN,2019.0,1,3,-2
UGA,GMB,2017.0,1,1,0
HUN,CZE,2007.0,2,5,-3
FRA,PHL,2009.0,1,2,-1
JPN,PAN,2020.0,2,1,1
KEN,SWE,2009.0,1,3,-2
NOR,KOR,2012.0,1,2,-1
POL,BGR,2009.0,1,1,0
TWN,BRA,2015.0,1,1,0
GBR,IRL,2024.0,1,2,-1
MCO,GBR,2021.0,1,1,0
YEM,USA,2019.0,1,2,-1
ARG,NGA,2019.0,1,1,0
SAU,NZL,2009.0,1,1,0
VNM,ZAF,2016.0,1,1,0
DZA,DNK,2019.0,1,1,0
UKR,MEX,2020.0,2,1,1
MUS,CHN,2021.0,1,1,0
PSE,CAN,2017.0,1,1,0
NGA,CYP,2020.0,1,6,-5
ROU,TUR,2022.0,3,4,-1
IRQ,IDN,2021.0,1,1,0
QAT,NLD,2021.0,3,3,0
AFG,MYS,2023.0,2,1,1
TUN,IND,2005.0,1,1,0
RUS,MKD,2022.0,1,4,-3
NLD,ARE,2009.0,1,1,0
SYR,NLD,2006.0,2,2,0
ITA,VEN,2006.0,1,4,-3
BFA,MLI,2007.0,1,1,0
RWA,ZWE,2015.0,1,1,0
HTI,USA,2002.0,1,2,-1
ARE,ESP,2012.0,1,3,-2
BEL,UZB,2004.0,1,2,-1
SVK,FRA,2003.0,3,7,-4
PRT,MEX,2005.0,1,1,0
DZA,PRT,2002.0,1,1,0
IDN,ESP,2014.0,1,1,0
SWE,CRI,2005.0,1,1,0
MKD,DNK,2002.0,2,1,1
DNK,FRO,2008.0,2,3,-1
SWE,ISR,2005.0,1,4,-3
JAM,TTO,2008.0,2,1,1
VNM,THA,2008.0,2,4,-2
QAT,SAU,2004.0,1,2,-1
TUR,AUT,1997.0,2,2,0
PHL,NLD,2000.0,2,1,1
PRT,GRC,2010.0,2,3,-1
GBR,LUX,2002.0,1,3,-2
FRA,ETH,2003.0,3,2,1
ETH,FRA,2005.0,1,3,-2
BIH,BEL,2003.0,1,1,0
BIH,DEU,2012.0,1,1,0
GBR,BHR,1998.0,2,3,-1
AUT,GRC,2011.0,2,8,-6
DEU,MNG,2005.0,1,1,0
DOM,USA,2001.0,1,1,0
ARG,AUT,2013.0,1,3,-2
SWE,UGA,2010.0,1,4,-3
CUB,AUS,2012.0,1,1,0
ROU,NLD,2015.0,4,3,1
AUS,URY,2012.0,2,1,1
DNK,FRO,2015.0,2,2,0
FRO,DNK,2016.0,1,5,-4
TUR,NZL,2010.0,1,1,0
CHN,NGA,2013.0,3,1,2
HRV,MKD,2009.0,1,1,0
KEN,ESP,2013.0,1,1,0
ISR,CZE,2016.0,1,4,-3
MYS,AUT,2012.0,1,4,-3
ISR,ARG,2018.0,2,4,-2
NOR,NZL,2021.0,1,6,-5
JOR,PAK,2015.0,2,1,1
NLD,MKD,2014.0,1,2,-1
NOR,SVK,2019.0,1,2,-1
SRB,ISR,2020.0,1,2,-1
HRV,HUN,2013.0,2,3,-1
BGR,ITA,2016.0,1,7,-6
GEO,GBR,2018.0,2,3,-1
MEX,TWN,2014.0,1,1,0
OMN,KOR,2017.0,2,3,-1
FIN,IDN,2022.0,2,3,-1
SDN,NLD,2013.0,1,1,0
FIN,CZE,2003.0,1,1,0
CAN,ECU,2023.0,1,1,0
NGA,VNM,2023.0,1,1,0
PRT,BGD,2018.0,1,1,0
GUY,CAN,2013.0,1,1,0
MKD,SWE,2013.0,1,1,0
MOZ,SWE,2015.0,3,1,2
SWE,KHM,2011.0,1,2,-1
DEU,TZA,2013.0,4,4,0
ISL,NLD,2008.0,1,3,-2
KWT,FRA,2017.0,2,1,1
ARE,SDN,2014.0,1,1,0
CAN,MWI,2020.0,1,3,-2
CHE,GIN,2019.0,1,1,0
QAT,SDN,2018.0,1,2,-1
NGA,IRL,2013.0,1,1,0
TZA,DEU,2012.0,2,2,0
CMR,DEU,2005.0,1,4,-3
POL,BRA,2013.0,2,4,-2
AUT,MEX,2005.0,2,2,0
BEL,BOL,2004.0,1,2,-1
BOL,BEL,2008.0,1,3,-2
PRT,AGO,2005.0,1,1,0
LAO,JPN,2000.0,1,1,0
PER,COL,1998.0,2,1,1
JPN,GUM,2001.0,1,1,0
UKR,SRB,2011.0,1,1,0
BIH,SVN,2006.0,1,3,-2
SVN,BIH,2007.0,1,1,0
TUR,KGZ,2023.0,1,3,-2
IND,KGZ,2023.0,1,1,0
VNM,NLD,1999.0,1,2,-1
AUS,ETH,2010.0,1,1,0
BLR,ITA,2006.0,1,3,-2
HTI,USA,2005.0,1,1,0
MDV,USA,2010.0,1,1,0
NLD,CHL,2001.0,2,3,-1
AUT,ISR,1999.0,1,3,-2
NOR,EST,1997.0,1,1,0
BGR,ESP,2006.0,1,3,-2
PHL,CAN,2000.0,2,3,-1
BEL,BFA,2003.0,2,2,0
BFA,AUT,2017.0,1,1,0
ETH,ARE,2018.0,1,1,0
BRA,HRV,2023.0,1,1,0
TZA,CAN,2018.0,1,2,-1
TLS,USA,2020.0,1,1,0
NLD,SVN,2016.0,2,2,0
CHN,UGA,2016.0,1,1,0
GBR,LVA,2017.0,1,1,0
TZA,ITA,2015.0,1,2,-1
TUR,BIH,2021.0,1,1,0
NOR,ZAF,2013.0,2,3,-1
FJI,VUT,2018.0,1,1,0
LKA,ZAF,2016.0,1,3,-2
KGZ,CAN,2020.0,1,1,0
GNQ,USA,2020.0,1,1,0
IND,ARE,2000.0,2,2,0
PAN,CZE,2023.0,1,2,-1
CZE,PAK,2023.0,2,3,-1
URY,ARG,1997.0,1,2,-1
MLT,NLD,2009.0,1,1,0
RUS,LVA,2004.0,1,1,0
IND,COL,2017.0,1,3,-2
UKR,FIN,1998.0,2,2,0
IDN,ESP,2015.0,1,3,-2
UGA,CAN,2009.0,1,1,0
LVA,RUS,2011.0,2,2,0
KWT,DEU,2021.0,1,1,0
AUS,JOR,2001.0,1,2,-1
CZE,KOR,2001.0,1,1,0
BEL,TWN,2015.0,1,4,-3
AUS,SAU,2005.0,1,4,-3
AUS,KAZ,2023.0,1,1,0
LBR,CHN,2022.0,1,4,-3
MAR,IRQ,2022.0,1,1,0
KAZ,SGP,2021.0,1,2,-1
ISL,NLD,2015.0,2,2,0
CMR,BEL,2014.0,3,4,-1
ARE,FRA,2004.0,1,1,0
GRC,IRN,2023.0,1,1,0
KOR,ZAF,2023.0,1,4,-3
MEX,IRN,2023.0,1,4,-3
SYR,MYS,2020.0,1,1,0
LAO,FRA,2006.0,1,3,-2
VNM,CHE,2007.0,1,1,0
BEL,ROU,2001.0,2,6,-4
SVK,CAN,1999.0,1,3,-2
AUS,BGR,2004.0,1,2,-1
BRA,SRB,2006.0,1,4,-3
TUR,AUS,1998.0,1,1,0
GBR,BRB,2002.0,1,1,0
BEL,EST,2002.0,1,1,0
SWE,HRV,1999.0,1,3,-2
BOL,BEL,2001.0,1,1,0
NLD,UKR,2008.0,3,2,1
ALB,USA,2005.0,1,2,-1
SWE,MKD,2013.0,1,1,0
ARE,SGP,2001.0,1,1,0
VAT,ITA,2016.0,1,1,0
PAK,RUS,2019.0,2,2,0
SRB,GBR,2007.0,16,3,13
JPN,ITA,2010.0,23,22,1
FRA,CMR,2009.0,14,16,-2
COL,CHL,2006.0,4,4,0
ITA,ROU,2022.0,10,10,0
CMR,GBR,2010.0,3,3,0
NGA,SWE,2006.0,3,2,1
PAK,ARE,2017.0,12,3,9
BOL,BRA,2009.0,1,1,0
ETH,KOR,2015.0,6,3,3
CAN,PAK,2012.0,12,20,-8
FRA,MCO,1999.0,4,7,-3
QAT,FRA,2013.0,3,15,-12
USA,MOZ,2021.0,9,5,4
SGP,DNK,2016.0,12,7,5
CHN,IRQ,2015.0,9,3,6
LTU,ESP,2018.0,2,6,-4
JOR,KWT,2020.0,2,1,1
BEL,AUS,2000.0,13,9,4
ROU,BEL,1999.0,4,2,2
FRA,HTI,2021.0,3,1,2
DEU,SRB,1998.0,5,25,-20
HRV,ISR,1999.0,3,1,2
AUT,EGY,2000.0,2,1,1
GBR,PRI,2001.0,4,2,2
NLD,UKR,2003.0,4,3,1
MLT,USA,2021.0,1,4,-3
BEL,CZE,2015.0,11,8,3
MYS,PHL,2011.0,1,1,0
ARE,QAT,2020.0,6,6,0
LBN,DEU,2012.0,2,1,1
MRT,SEN,2017.0,1,2,-1
GRC,RUS,2020.0,3,2,1
LUX,AUT,2020.0,3,4,-1
ARE,MYS,2021.0,14,26,-12
GTM,CHE,2020.0,1,1,0
SDN,FRA,2014.0,2,1,1
ZAF,DNK,2004.0,3,2,1
TUR,SAU,2007.0,2,2,0
GBR,TZA,2000.0,13,7,6
CHN,EGY,2008.0,3,4,-1
OMN,NLD,2001.0,3,1,2
CAN,LTU,2006.0,1,2,-1
AUS,POL,2002.0,5,8,-3
IND,HKG,2004.0,2,5,-3
THA,NLD,2012.0,6,12,-6
ZMB,NLD,2019.0,2,2,0
ARM,USA,2021.0,8,8,0
GRC,KWT,2019.0,2,1,1
ETH,DEU,2008.0,4,4,0
ISR,SGP,2018.0,4,8,-4
MYS,ZAF,2016.0,7,3,4
BEL,PSE,2017.0,2,2,0
TWN,VNM,2014.0,17,7,10
BGR,SWE,2014.0,4,2,2
PAN,COL,2011.0,2,3,-1
UKR,DNK,2017.0,4,1,3
PAK,ARE,2018.0,13,15,-2
MKD,AUS,2020.0,2,1,1
SRB,BEL,2021.0,4,2,2
AUS,ETH,2021.0,7,25,-18
URY,BRA,2017.0,8,14,-6
POL,SVK,2016.0,10,8,2
PHL,PRT,2021.0,1,1,0
JOR,IND,2015.0,2,1,1
NGA,BWA,2022.0,3,1,2
IND,IRQ,2020.0,19,7,12
ETH,BWA,2015.0,3,2,1
LBN,EGY,2013.0,3,4,-1
NOR,AUT,2006.0,3,4,-1
SWE,SVK,2005.0,2,2,0
TWN,DEU,2000.0,4,9,-5
GRC,IRL,2018.0,15,4,11
ISL,AUS,2003.0,1,1,0
PAK,MYS,2009.0,10,7,3
USA,OMN,2012.0,8,3,5
LBR,NGA,2019.0,1,2,-1
KNA,USA,2013.0,2,4,-2
FIN,VNM,2018.0,3,1,2
CHE,HUN,2018.0,12,15,-3
ZAF,EGY,2020.0,2,1,1
IRL,IND,2005.0,2,5,-3
MKD,DEU,2019.0,3,1,2
TUR,TWN,2018.0,6,1,5
LKA,KHM,2000.0,1,1,0
MYS,ITA,2022.0,4,4,0
MAR,ITA,2021.0,6,6,0
OMN,ARE,2020.0,6,2,4
KOR,PAK,2011.0,9,13,-4
RUS,VNM,2017.0,11,2,9
PRT,ISR,2019.0,3,6,-3
ITA,BFA,2002.0,3,1,2
CHE,ISL,2023.0,3,2,1
ZAF,ZMB,2013.0,1,5,-4
MDA,DEU,2017.0,4,3,1
CHN,ISR,2008.0,10,6,4
GBR,TZA,2015.0,15,11,4
NOR,IDN,2019.0,4,1,3
DEU,EST,2007.0,9,2,7
CIV,GBR,2015.0,2,4,-2
FIN,CHN,2006.0,13,2,11
GHA,ITA,2016.0,1,3,-2
ARE,JOR,2005.0,4,5,-1
ZAF,MYS,2023.0,1,1,0
BEL,IRL,2012.0,7,11,-4
ARM,ITA,2016.0,2,2,0
PAK,IRL,2014.0,1,5,-4
MEX,TWN,2011.0,2,1,1
ARE,IND,2010.0,1,18,-17
TUR,RUS,2021.0,7,4,3
CAN,CIV,2007.0,1,1,0
CHL,RUS,2017.0,1,2,-1
BGR,DEU,2018.0,5,16,-11
UKR,SGP,2017.0,1,1,0
CMR,CHN,2015.0,2,1,1
CAN,KOR,1999.0,13,18,-5
NZL,CHN,2009.0,6,11,-5
BWA,USA,2007.0,6,5,1
RUS,GEO,2012.0,5,1,4
CAF,ZAF,2004.0,3,2,1
GIN,GNQ,2019.0,2,7,-5
CHN,MAC,2007.0,5,9,-4
SVN,NLD,2017.0,4,5,-1
VNM,CAN,2021.0,7,3,4
SGP,ISR,2023.0,4,2,2
ITA,ROU,2002.0,7,11,-4
NLD,SVN,2020.0,6,2,4
EGY,SGP,2017.0,2,3,-1
CHN,SDN,2017.0,5,4,1
CHL,CHE,2019.0,9,5,4
IRQ,AUS,2014.0,4,4,0
MYS,PHL,2013.0,4,2,2
IND,BRA,2010.0,9,1,8
SDN,ZAF,2020.0,5,6,-1
BLR,JPN,2017.0,1,1,0
MMR,MYS,2018.0,2,1,1
NZL,IND,2018.0,13,15,-2
CHN,QAT,2018.0,1,5,-4
UKR,NLD,2016.0,3,2,1
GBR,VEN,1997.0,3,2,1
ECU,AUS,2021.0,3,2,1
OMN,MYS,2004.0,1,1,0
MYS,DEU,1997.0,5,1,4
ROU,NLD,2019.0,4,8,-4
HND,USA,2006.0,3,1,2
SGP,KOR,2017.0,21,32,-11
ARG,FRA,2001.0,16,27,-11
KOR,LKA,2010.0,1,2,-1
ROU,MYS,2016.0,1,1,0
EGY,ARE,2014.0,19,12,7
KAZ,EGY,2012.0,2,1,1
FIN,IND,2000.0,1,3,-2
NPL,THA,2007.0,2,1,1
SAU,ARE,2015.0,26,7,19
JPN,BGR,2014.0,3,3,0
EGY,MYS,2020.0,4,13,-9
ARG,URY,2007.0,5,5,0
ESP,PER,1997.0,4,2,2
EGY,HUN,2018.0,7,2,5
CHE,CHN,1999.0,7,9,-2
AFG,IND,2021.0,4,3,1
SGP,IRN,2023.0,2,5,-3
HKG,LKA,2022.0,4,1,3
IRQ,EGY,2021.0,8,15,-7
PNG,IND,2021.0,2,1,1
ITA,JOR,2021.0,5,3,2
NPL,LKA,2019.0,1,1,0
USA,TUN,2022.0,5,9,-4
UZB,GBR,2022.0,1,1,0
DEU,BLR,2019.0,2,8,-6
NLD,SVK,2013.0,6,3,3
AUT,SVK,2021.0,9,17,-8
IRQ,TUR,2020.0,6,32,-26
AUS,OMN,2023.0,2,3,-1
AFG,USA,2022.0,5,3,2
BGD,SGP,2007.0,2,1,1
SGP,BGD,2009.0,1,1,0
CZE,AUT,2012.0,11,8,3
POL,LTU,2001.0,1,1,0
UZB,ESP,2021.0,1,2,-1
USA,MYS,2004.0,23,9,14
LTU,FRA,1997.0,2,1,1
ISR,BRA,2000.0,2,2,0
TUN,JOR,2015.0,2,1,1
HRV,SVN,2001.0,3,8,-5
ARE,AUS,1999.0,1,3,-2
GBR,PAN,2002.0,2,3,-1
MEX,VEN,2016.0,7,17,-10
AUS,PRT,2001.0,1,1,0
GBR,SVN,2010.0,7,6,1
GBR,JAM,1997.0,4,4,0
PYF,FRA,2000.0,9,2,7
EGY,ARE,2008.0,11,8,3
PRT,GRC,2013.0,3,4,-1
ITA,NZL,2017.0,10,2,8
POL,BGR,2008.0,2,1,1
ZAF,DEU,2004.0,18,13,5
JPN,IRN,2011.0,22,15,7
CAN,DNK,2007.0,9,16,-7
SGP,FRA,2009.0,11,36,-25
GBR,GMB,1999.0,3,3,0
CAN,EGY,2006.0,7,12,-5
AUT,NOR,2000.0,2,2,0
BFA,TGO,2016.0,1,1,0
FRA,NCL,2002.0,9,12,-3
FRA,FIN,2008.0,14,19,-5
COL,CAN,2011.0,12,10,2
PAN,USA,2007.0,10,10,0
IND,DNK,2000.0,8,6,2
FRA,TWN,2003.0,6,7,-1
CHL,ARG,2007.0,13,13,0
DNK,FRO,2011.0,2,1,1
DNK,ZAF,2004.0,2,3,-1
KAZ,UZB,2004.0,1,1,0
DNK,POL,2002.0,4,8,-4
ARG,ISR,2004.0,5,1,4
ARG,FRA,2004.0,17,13,4
DNK,LTU,2005.0,2,1,1
HKG,ITA,2023.0,5,1,4
ESP,FIN,2005.0,5,7,-2
BWA,USA,1998.0,1,1,0
CHE,IRL,2001.0,5,7,-2
SAU,ITA,1998.0,1,1,0
ESP,FIN,1997.0,1,6,-5
FRA,CIV,1998.0,14,16,-2
CHN,NLD,2001.0,19,20,-1
ISR,POL,2000.0,1,1,0
SRB,FRA,2004.0,4,9,-5
IRN,FRA,1998.0,2,3,-1
TWN,CHE,2008.0,7,3,4
DEU,KAZ,2004.0,3,2,1
UKR,CAN,2002.0,8,1,7
CHL,JPN,2001.0,1,1,0
DNK,PRT,2003.0,2,1,1
OMN,IND,2016.0,7,22,-15
BLR,POL,2005.0,3,4,-1
CUB,VEN,2001.0,5,1,4
AUS,SWE,1997.0,12,21,-9
JPN,SVN,2008.0,2,1,1
DEU,LTU,1997.0,7,3,4
PYF,FRA,2010.0,7,7,0
PYF,CHN,2017.0,1,1,0
BEL,SWE,1999.0,6,12,-6
DNK,GRC,2003.0,2,1,1
IRN,DEU,2005.0,13,11,2
USA,AFG,2012.0,5,6,-1
AFG,USA,2016.0,4,6,-2
USA,OMN,2017.0,7,3,4
ETH,USA,2001.0,5,7,-2
JOR,PSE,1999.0,2,1,1
KEN,SWE,2008.0,4,2,2
FIN,NLD,2005.0,10,12,-2
FIN,ESP,2005.0,7,5,2
MEX,GBR,1997.0,15,21,-6
NGA,GMB,2014.0,2,1,1
SRB,GRC,2002.0,4,2,2
VEN,ESP,2001.0,13,19,-6
IND,NLD,1997.0,6,6,0
GAB,BEL,2007.0,1,1,0
CHE,TUR,1998.0,4,4,0
ROU,TUR,2007.0,2,5,-3
ROU,SVN,2011.0,1,1,0
MAR,SYR,2016.0,1,1,0
SYR,MAR,2017.0,2,1,1
AUT,NZL,2000.0,1,2,-1
HRV,CHN,2021.0,1,2,-1
KOR,HUN,2018.0,3,2,1
KWT,GBR,1997.0,1,8,-7
AZE,USA,1998.0,1,1,0
CZE,NOR,2008.0,4,4,0
SAU,LBN,2003.0,1,1,0
NZL,CHE,2006.0,4,6,-2
MAR,TWN,2006.0,2,2,0
GRC,CYP,2005.0,10,5,5
ARE,SAU,2001.0,5,7,-2
HUN,FIN,2006.0,2,3,-1
LKA,CHE,2017.0,2,3,-1
ISR,EGY,2012.0,2,1,1
CHL,CAN,1999.0,3,5,-2
PRT,BEL,1997.0,1,3,-2
GRC,LUX,2011.0,1,1,0
ITA,MEX,1999.0,5,7,-2
ZAF,BEL,2008.0,4,9,-5
HKG,CHE,2009.0,10,9,1
VEN,CAN,2007.0,3,1,2
SAU,GRC,2018.0,5,5,0
DEU,BRN,2015.0,2,1,1
KHM,AUS,2022.0,6,2,4
SWE,KOR,2011.0,5,8,-3
IRN,AUT,2009.0,3,4,-1
EST,LTU,2019.0,2,3,-1
CYP,AUT,2013.0,1,1,0
EST,NOR,2012.0,2,1,1
USA,OMN,2016.0,13,9,4
LTU,CAN,2016.0,3,1,2
FJI,AUS,2020.0,5,11,-6
LTU,ITA,2013.0,3,5,-2
THA,PHL,2007.0,4,3,1
PHL,NLD,2013.0,5,1,4
POL,IRN,2016.0,4,4,0
FRA,ZAF,1999.0,7,8,-1
HKG,IRL,2020.0,2,2,0
NOR,ISR,2015.0,5,1,4
GBR,SVK,2011.0,3,10,-7
CYP,IRQ,2022.0,1,1,0
RUS,ISL,2011.0,3,1,2
DEU,ISL,2020.0,6,9,-3
CHE,MAR,2020.0,3,1,2
NZL,BRA,2020.0,8,12,-4
TZA,CHN,2013.0,1,1,0
NZL,CHE,2023.0,10,2,8
GRD,USA,2013.0,6,5,1
HKG,LKA,2016.0,4,1,3
MNG,USA,2010.0,4,4,0
CHN,KEN,2011.0,2,5,-3
LUX,BRA,2013.0,1,2,-1
ZAF,BFA,2015.0,2,4,-2
CAN,BEN,2015.0,3,1,2
LVA,RUS,2014.0,3,3,0
ZAF,CIV,2009.0,4,2,2
CAN,CMR,2022.0,4,4,0
MEX,BEL,2010.0,4,4,0
BEN,GHA,2010.0,1,1,0
SRB,CZE,2014.0,3,1,2
COL,ITA,2011.0,2,10,-8
TUN,BEL,2014.0,7,3,4
GBR,SVK,2009.0,8,5,3
COL,BEL,2012.0,4,4,0
LBN,CYP,2020.0,1,2,-1
NLD,COL,2014.0,9,6,3
DEU,PHL,2013.0,5,3,2
PHL,SGP,2014.0,4,3,1
BEL,GRC,2017.0,8,24,-16
KEN,GRC,2008.0,1,2,-1
QAT,SAU,2011.0,2,1,1
CAN,CUB,2012.0,2,4,-2
ESP,AND,2020.0,2,4,-2
DZA,DEU,2006.0,3,2,1
NZL,ITA,2013.0,4,14,-10
CHL,ECU,2010.0,1,1,0
ECU,USA,2014.0,14,24,-10
USA,OMN,2018.0,8,6,2
AUT,BRA,2006.0,3,4,-1
TZA,SWE,2010.0,1,1,0
IRL,PRT,2017.0,7,5,2
IND,SDN,2010.0,1,2,-1
PAK,BGD,2014.0,10,9,1
SAU,BEL,2019.0,1,5,-4
FRA,BEN,2010.0,9,8,1
QAT,BEL,2022.0,1,3,-2
POL,IND,2014.0,2,9,-7
DEU,IRQ,2023.0,6,1,5
FIN,LVA,2022.0,2,2,0
ITA,MYS,2010.0,4,2,2
CHL,POL,2014.0,3,1,2
BEL,SGP,2011.0,6,7,-1
GRC,TUN,2010.0,2,1,1
AUT,GRC,2014.0,7,10,-3
CMR,GBR,2014.0,6,6,0
NZL,BEL,2017.0,5,4,1
PRT,AUT,2018.0,4,4,0
BEL,IRN,2016.0,13,23,-10
GBR,GIN,2023.0,1,1,0
NZL,IRN,2011.0,2,2,0
CHL,BOL,2014.0,1,2,-1
BOL,CHL,2017.0,1,5,-4
CUB,VEN,2015.0,3,2,1
VEN,DEU,2013.0,11,1,10
KOR,TZA,2019.0,4,1,3
PAN,ESP,2014.0,3,2,1
CRI,ARG,2013.0,1,1,0
FIN,PRT,2015.0,4,5,-1
BEL,LUX,2016.0,20,14,6
KOR,GHA,2015.0,2,1,1
LUX,NLD,1997.0,1,1,0
CZE,THA,2020.0,1,1,0
BHS,GBR,2010.0,1,2,-1
JPN,ZAF,2020.0,5,5,0
SGP,BGD,2019.0,5,2,3
IRN,ZAF,2017.0,6,4,2
JPN,BEN,2014.0,2,1,1
NER,SEN,2015.0,1,1,0
FRA,SEN,2023.0,9,18,-9
PAK,POL,2015.0,1,3,-2
FIN,MYS,2021.0,2,3,-1
ZAF,UGA,2019.0,14,6,8
ISR,UKR,2012.0,1,4,-3
SLE,GBR,2018.0,5,9,-4
COL,SWE,2013.0,5,1,4
HUN,SWE,2019.0,5,5,0
MEX,POL,2017.0,2,3,-1
JOR,DEU,2015.0,9,12,-3
BEN,GBR,2021.0,1,1,0
SRB,DEU,2013.0,7,10,-3
DNK,SRB,2013.0,2,3,-1
OMN,AUS,2022.0,2,1,1
EST,CHN,2016.0,4,3,1
COL,PAN,2013.0,2,2,0
ZAF,BRA,2014.0,4,2,2
UKR,LVA,2014.0,2,1,1
VEN,MEX,2016.0,17,7,10
JPN,ZMB,2020.0,6,4,2
LAO,VNM,2017.0,2,1,1
SEN,ITA,2015.0,1,1,0
CHN,QAT,2022.0,4,4,0
KEN,SWE,2015.0,4,3,1
ESP,SAU,2021.0,14,7,7
HKG,ARE,2016.0,3,1,2
ISR,FIN,2016.0,3,2,1
AUT,VNM,2012.0,3,1,2
NLD,TZA,2016.0,9,1,8
JAM,GBR,2003.0,3,2,1
ARG,VEN,2010.0,1,4,-3
LVA,ISR,2019.0,1,1,0
TWN,BRA,2019.0,1,5,-4
FRO,SWE,2015.0,1,1,0
LAO,FRA,2013.0,3,6,-3
URY,DEU,2016.0,4,4,0
HUN,HRV,2020.0,2,1,1
DNK,BRA,2018.0,9,27,-18
USA,BOL,2018.0,9,3,6
FRA,SYR,2021.0,5,3,2
JOR,IRQ,2015.0,6,5,1
ARG,SWE,2023.0,2,1,1
ESP,UKR,2019.0,3,1,2
USA,OMN,2022.0,5,7,-2
SGP,SAU,2022.0,5,6,-1
IND,TZA,2018.0,5,5,0
QAT,EGY,2018.0,8,17,-9
JPN,GHA,2019.0,5,6,-1
MEX,ITA,2016.0,9,25,-16
ARG,KOR,2022.0,1,1,0
LTU,FIN,2019.0,4,2,2
IRL,OMN,2020.0,4,1,3
SAU,SWE,2023.0,5,4,1
TWN,SWE,2015.0,6,5,1
HUN,CZE,2022.0,6,7,-1
KAZ,KGZ,2017.0,5,4,1
NAM,USA,2017.0,7,7,0
COG,UGA,2017.0,1,1,0
ITA,GRC,2004.0,18,13,5
CZE,HRV,2021.0,2,5,-3
CZE,SVN,2022.0,3,4,-1
BEL,LTU,2016.0,4,2,2
BEL,SGP,2019.0,7,9,-2
CHN,CYP,2021.0,2,2,0
ARE,NLD,2022.0,4,5,-1
IDN,BEL,2016.0,4,5,-1
PRT,ISR,2003.0,1,1,0
NOR,IRN,2017.0,2,10,-8
BGR,FRA,2021.0,6,5,1
MEX,IRL,2017.0,3,2,1
DEU,EST,2020.0,7,8,-1
DEU,KHM,2013.0,1,1,0
CHL,FIN,2021.0,4,2,2
SAU,NLD,2023.0,7,6,1
ARG,ITA,2016.0,15,29,-14
LBY,IND,2016.0,3,3,0
NZL,IRL,2016.0,4,12,-8
JAM,CAN,2016.0,4,2,2
NLD,NPL,2020.0,3,1,2
PER,COL,2022.0,4,8,-4
FRA,KAZ,2020.0,4,5,-1
NLD,MEX,2016.0,10,15,-5
EGY,BEL,2022.0,7,3,4
PRT,AUT,2022.0,10,15,-5
MEX,PER,2006.0,3,1,2
ZAF,LSO,2020.0,8,3,5
BEN,FRA,2020.0,8,16,-8
IRQ,EGY,2019.0,1,13,-12
NOR,AUS,2022.0,12,21,-9
TZA,NGA,2020.0,3,1,2
NER,NGA,2023.0,4,5,-1
JPN,MWI,2021.0,2,1,1
DEU,MAR,2003.0,3,3,0
SAU,TWN,2019.0,8,4,4
FRA,TGO,2020.0,7,5,2
ITA,KEN,2020.0,3,2,1
COL,ITA,2019.0,6,15,-9
GRC,LUX,2021.0,7,2,5
DNK,IDN,2019.0,1,3,-2
AUS,KEN,2019.0,8,5,3
AZE,IRN,2008.0,1,4,-3
LKA,GBR,1998.0,5,6,-1
NOR,CAN,1997.0,7,9,-2
GBR,TZA,2001.0,7,7,0
SWE,HUN,2021.0,6,11,-5
ITA,SRB,2018.0,6,5,1
JPN,IRL,2023.0,4,6,-2
NPL,JPN,2020.0,8,17,-9
AFG,FRA,2015.0,2,1,1
LAO,AUS,2021.0,2,2,0
ESP,IDN,2023.0,2,1,1
ECU,CHL,2019.0,12,16,-4
MDG,USA,2023.0,4,3,1
MYS,HUN,2022.0,4,1,3
MAR,LBN,2022.0,3,2,1
BFA,COG,2022.0,2,2,0
POL,ZAF,2019.0,4,5,-1
KWT,ARE,1999.0,1,1,0
NPL,MDV,2022.0,2,1,1
PSE,GBR,2022.0,2,7,-5
DEU,MDG,2022.0,3,1,2
EGY,ISR,2007.0,1,1,0
CHL,URY,2022.0,6,4,2
FIN,CZE,2023.0,5,4,1
LBN,CHE,2022.0,8,4,4
ETH,ZWE,2019.0,1,2,-1
BHR,ARE,2022.0,4,2,2
TUR,ETH,2023.0,5,2,3
PER,VEN,2022.0,1,7,-6
ESP,ECU,2012.0,2,14,-12
AUS,QAT,2021.0,4,7,-3
SAU,SYR,2022.0,3,1,2
FIN,BEL,2002.0,4,4,0
DNK,EGY,2004.0,4,3,1
KWT,EGY,1999.0,10,7,3
POL,PRT,2021.0,6,9,-3
ISR,KAZ,2020.0,1,3,-2
USA,SDN,2012.0,4,8,-4
PRT,FRA,2003.0,17,41,-24
ZAF,DNK,2006.0,1,3,-2
NZL,CHN,2011.0,16,8,8
PRT,CHN,2002.0,4,8,-4
ARG,BEL,2008.0,4,1,3
CAN,ZAF,2001.0,9,26,-17
CHE,HRV,1999.0,1,3,-2
SRB,HRV,2003.0,4,3,1
SYR,IND,2006.0,2,1,1
THA,MYS,2016.0,5,14,-9
SEN,FRA,2021.0,30,31,-1
HRV,NLD,2011.0,4,5,-1
NLD,ISL,2006.0,4,2,2
VEN,BRA,2004.0,5,4,1
AUS,ITA,1999.0,7,25,-18
ITA,ROU,1997.0,8,3,5
JPN,ZMB,1998.0,4,2,2
ZMB,JPN,1999.0,2,3,-1
EGY,POL,2020.0,2,3,-1
USA,JAM,1997.0,5,3,2
UKR,DNK,2002.0,4,2,2
NZL,KOR,2001.0,2,3,-1
SGP,ESP,2012.0,5,8,-3
GBR,ISL,2004.0,2,3,-1
HRV,FIN,2001.0,1,1,0
PRT,ESP,1998.0,9,24,-15
KEN,COD,1999.0,1,1,0
NOR,NZL,2008.0,2,3,-1
SGP,TWN,2002.0,4,6,-2
NLD,CZE,2007.0,4,9,-5
SWE,URY,2012.0,1,4,-3
GBR,CYM,2015.0,1,1,0
GBR,NPL,1997.0,1,1,0
BGD,EGY,2018.0,2,2,0
HKG,SGP,1997.0,10,8,2
AUS,SVN,2018.0,6,2,4
ESP,MOZ,2018.0,6,5,1
FIN,CZE,2010.0,4,8,-4
USA,DMA,2019.0,2,1,1
CHN,MMR,2019.0,5,16,-11
MUS,CAN,2019.0,1,1,0
KOR,POL,2022.0,3,7,-4
MLT,ESP,2019.0,1,3,-2
DNK,GRL,1999.0,4,1,3
AUT,GRC,2004.0,3,1,2
IRQ,DEU,2011.0,1,2,-1
ITA,ETH,2022.0,4,5,-1
KWT,GBR,2002.0,5,8,-3
ARG,AUS,2005.0,4,1,3
NLD,CHL,2019.0,12,16,-4
RUS,ESP,2023.0,9,4,5
AFG,DEU,2020.0,2,3,-1
MYS,CHN,2008.0,8,3,5
AUT,FIN,2001.0,6,3,3
UZB,DEU,2022.0,1,2,-1
IND,NGA,2011.0,4,11,-7
IND,FIN,2006.0,4,1,3
SDN,ARE,2023.0,3,1,2
AUT,TUR,2008.0,1,2,-1
KOR,CHN,1999.0,13,14,-1
ISL,FIN,2019.0,2,3,-1
ISL,USA,1997.0,4,10,-6
FRA,MYS,2016.0,9,7,2
JOR,ITA,2022.0,4,5,-1
NOR,AUS,2018.0,14,19,-5
PRK,KOR,2022.0,4,8,-4
ALB,ITA,2021.0,5,14,-9
HND,USA,2023.0,3,3,0
CRI,CHL,2023.0,1,1,0
KGZ,KAZ,2017.0,4,5,-1
ISR,BRA,2006.0,2,1,1
NZL,ARE,2009.0,5,2,3
IND,YEM,2010.0,6,1,5
BGD,QAT,2023.0,4,3,1
MDG,DEU,2022.0,1,3,-2
ZAF,POL,2018.0,3,3,0
RUS,AZE,2011.0,4,5,-1
SVK,GRC,2010.0,2,1,1
PER,CRI,2020.0,1,1,0
SRB,IND,2003.0,1,5,-4
FRA,ZAF,1998.0,7,5,2
THA,FRA,2009.0,16,9,7
JOR,OMN,2003.0,2,2,0
RUS,HKG,2003.0,4,1,3
ITA,TUR,2012.0,15,12,3
POL,AUS,1997.0,6,6,0
BEL,BLR,2002.0,5,6,-1
USA,TZA,2012.0,18,14,4
MEX,AUT,2005.0,2,2,0
SAU,ITA,2020.0,12,9,3
AUS,ROU,2002.0,1,2,-1
BRB,USA,2022.0,4,3,1
KEN,NZL,2003.0,2,1,1
GBR,SVN,2000.0,5,5,0
KHM,USA,2013.0,3,8,-5
ISR,RUS,2019.0,15,23,-8
BEL,AUT,2003.0,4,8,-4
AUS,RUS,1998.0,5,9,-4
MLI,USA,2007.0,2,3,-1
BEL,ISR,2002.0,4,4,0
BEL,PRT,2008.0,5,6,-1
PAN,USA,1998.0,8,9,-1
RUS,NOR,2012.0,8,17,-9
ZAF,AUT,2012.0,2,5,-3
NLD,THA,2011.0,5,11,-6
CHE,PAK,2011.0,1,2,-1
IND,EST,2014.0,1,1,0
ISR,AUS,2002.0,10,13,-3
PER,BRA,1999.0,1,4,-3
GAB,USA,2013.0,2,1,1
SGP,HKG,1997.0,8,10,-2
FIN,MDA,2013.0,1,1,0
KEN,CHE,2012.0,2,5,-3
ESP,BOL,2020.0,2,4,-2
NOR,NZL,2001.0,4,4,0
CYP,USA,2012.0,4,30,-26
IND,CHN,1999.0,3,2,1
ISR,POL,2023.0,4,2,2
ZAF,NAM,2013.0,8,7,1
SRB,NLD,2009.0,2,1,1
ITA,SVK,1999.0,3,3,0
SRB,CZE,2001.0,1,4,-3
GEO,DEU,2004.0,4,3,1
FRA,BEN,2006.0,8,7,1
JPN,BEL,1997.0,6,9,-3
ITA,KOR,2009.0,5,2,3
SVK,FRA,2006.0,5,5,0
HRV,ITA,2002.0,3,5,-2
GEO,CHE,2017.0,1,2,-1
ETH,USA,2008.0,4,4,0
BFA,USA,2014.0,2,3,-1
BEN,CIV,2006.0,2,6,-4
NOR,NPL,2016.0,4,5,-1
KEN,IND,1997.0,1,1,0
ITA,ARG,2006.0,15,15,0
ITA,MYS,2006.0,1,1,0
BGR,GRC,2010.0,4,3,1
SAU,NGA,2000.0,3,3,0
BGR,FRA,2009.0,9,5,4
ESP,SWE,2001.0,17,35,-18
FRA,FIN,2004.0,12,13,-1
DNK,SRB,2003.0,3,4,-1
USA,SDN,2005.0,2,1,1
FIN,ESP,1997.0,6,1,5
DEU,TUR,2002.0,12,13,-1
NLD,SGP,2008.0,7,5,2
BEL,ZMB,1997.0,1,1,0
DEU,SVN,2006.0,8,8,0
COL,ESP,2001.0,12,6,6
CHL,SGP,2018.0,1,1,0
DNK,ISL,2002.0,6,4,2
CAN,GHA,2003.0,5,3,2
GRC,UKR,2003.0,3,1,2
DEU,KEN,2004.0,6,6,0
SVK,BEL,2015.0,5,4,1
BEN,BEL,2001.0,4,1,3
KEN,SWE,2001.0,8,2,6
FRA,PYF,2006.0,11,4,7
UGA,USA,1998.0,6,4,2
RUS,IRN,2004.0,3,2,1
DZA,SAU,2014.0,3,2,1
POL,JPN,1997.0,13,13,0
ROU,PRT,2005.0,2,5,-3
DEU,MKD,2007.0,2,2,0
GBR,JAM,2002.0,2,6,-4
GRC,CHN,2021.0,6,3,3
GRC,BEL,1999.0,6,9,-3
LTU,SWE,2017.0,3,4,-1
SGP,ZAF,2014.0,2,1,1
ITA,CHL,2014.0,7,3,4
CHN,IRN,2010.0,3,5,-2
KWT,JOR,2023.0,3,3,0
FRA,REU,2008.0,15,26,-11
HRV,CAN,2012.0,1,1,0
LUX,ITA,2020.0,5,19,-14
TWN,DEU,2008.0,20,16,4
LKA,USA,2008.0,8,11,-3
MEX,EGY,2018.0,4,1,3
VNM,SWE,2011.0,2,2,0
BRA,ISR,2016.0,4,5,-1
KOR,PRT,2022.0,3,1,2
TUN,KEN,2012.0,2,2,0
BEL,PAK,2017.0,1,4,-3
MYS,BRN,2012.0,6,3,3
AUS,ETH,2013.0,2,1,1
EST,ESP,2019.0,4,4,0
BRA,COL,2004.0,6,8,-2
DNK,CHL,2016.0,2,2,0
TUR,CZE,2011.0,1,1,0
TUR,CHE,2011.0,13,12,1
RWA,CHE,2013.0,1,1,0
LTU,FIN,2011.0,4,3,1
IND,EGY,2011.0,5,1,4
ROU,AUT,2014.0,6,6,0
GRC,DNK,2011.0,7,4,3
CHN,IRL,2008.0,5,6,-1
PRT,IDN,2020.0,2,2,0
YEM,MYS,2019.0,6,26,-20
SAU,AUS,2013.0,11,29,-18
IND,THA,2011.0,9,3,6
THA,ZAF,2013.0,2,2,0
CAN,GRC,2017.0,7,14,-7
CAN,GRC,2022.0,8,9,-1
HUN,AUS,2011.0,6,4,2
TWN,MAC,2019.0,5,2,3
ZAF,DNK,2023.0,3,3,0
AUT,TUR,2015.0,3,4,-1
KOR,ESP,2018.0,15,11,4
PRT,DZA,2016.0,2,1,1
EGY,ZAF,2011.0,2,3,-1
EGY,KWT,2023.0,8,4,4
NZL,PAK,2015.0,10,1,9
LBY,MYS,2011.0,2,5,-3
MOZ,FRA,2014.0,1,3,-2
OMN,GBR,2004.0,4,6,-2
UKR,FRA,2013.0,21,15,6
OMN,JOR,2016.0,4,3,1
BRA,GRC,2013.0,2,1,1
NLD,LBN,2013.0,1,1,0
DEU,GHA,2011.0,5,5,0
USA,NPL,2012.0,8,18,-10
ESP,KAZ,2016.0,1,1,0
KAZ,ESP,2018.0,2,1,1
PAK,CHE,2020.0,4,11,-7
EST,CHE,2014.0,5,1,4
TUN,EGY,2019.0,2,1,1
ARE,FRA,2019.0,5,21,-16
SAU,GRC,2016.0,2,7,-5
CAN,BHS,2015.0,1,1,0
ROU,DNK,2018.0,2,1,1
OMN,IRL,2020.0,1,4,-3
DJI,FRA,2014.0,3,5,-2
FRA,CUB,2007.0,3,2,1
BFA,CIV,2006.0,2,3,-1
CHN,ISR,2000.0,14,3,11
KOR,HKG,2014.0,7,13,-6
HUN,CAN,2017.0,13,9,4
BEL,MAR,2017.0,9,2,7
UGA,DEU,2020.0,7,4,3
ESP,LUX,2015.0,9,4,5
TWN,KOR,2014.0,13,8,5
IRN,IRQ,2023.0,23,10,13
MWI,SWE,2009.0,1,1,0
GBR,ZWE,2015.0,3,4,-1
JPN,CHL,2017.0,5,6,-1
NZL,TWN,2009.0,2,3,-1
SWE,RWA,2018.0,3,1,2
RWA,IND,2019.0,2,3,-1
IND,ZMB,2021.0,4,9,-5
GBR,SDN,2015.0,5,1,4
KWT,NLD,2018.0,1,1,0
CZE,SWE,2022.0,10,17,-7
GBR,SDN,2014.0,4,3,1
JOR,QAT,2015.0,6,1,5
KOR,MNG,2012.0,2,1,1
KWT,CAN,2018.0,9,10,-1
FLK,GBR,2011.0,3,1,2
ZAF,SYC,2022.0,1,2,-1
ARE,BRA,2019.0,2,5,-3
USA,BHR,2016.0,2,5,-3
USA,NAM,2016.0,3,4,-1
CHE,CHL,2014.0,10,11,-1
ASM,USA,2018.0,2,3,-1
PNG,AUS,2020.0,4,10,-6
BEN,CMR,2014.0,2,1,1
THA,LAO,2013.0,3,2,1
TZA,BEL,2011.0,1,2,-1
BRA,PER,2012.0,6,13,-7
CAN,ROU,2013.0,7,5,2
MWI,ITA,2021.0,1,2,-1
TZA,SWE,2023.0,7,5,2
GBR,NPL,2005.0,4,6,-2
TWN,CHE,2015.0,11,4,7
ROU,NLD,2021.0,4,6,-2
CAN,TUN,2014.0,11,15,-4
MEX,SGP,2018.0,1,2,-1
HUN,PRT,2019.0,2,6,-4
GIN,BEL,2016.0,1,1,0
FIN,GRC,2023.0,1,3,-2
NOR,CZE,2018.0,5,12,-7
LUX,FRA,2006.0,4,24,-20
DNK,POL,2012.0,7,8,-1
RUS,IND,1999.0,3,2,1
IRN,ZAF,2022.0,5,5,0
CYP,RUS,2023.0,1,2,-1
CHE,SRB,2016.0,3,5,-2
IRN,AUT,2011.0,9,4,5
LBN,AUS,2016.0,4,3,1
AUT,SRB,2018.0,1,7,-6
POL,TWN,2022.0,3,1,2
CAN,LBY,2005.0,1,1,0
DNK,HKG,2016.0,2,1,1
GBR,VNM,2022.0,11,15,-4
LKA,CHN,2017.0,2,7,-5
OMN,SWE,2015.0,1,1,0
NOR,CZE,2017.0,6,6,0
KGZ,KAZ,2016.0,2,2,0
KOR,TWN,2014.0,8,13,-5
ZAF,MEX,2015.0,3,3,0
DZA,DEU,2023.0,2,1,1
SWE,HKG,2009.0,3,6,-3
ITA,ETH,2016.0,6,3,3
USA,KNA,2017.0,5,7,-2
MYS,TWN,2023.0,9,5,4
CZE,ARG,2019.0,2,4,-2
USA,MNG,2022.0,4,4,0
CUB,PER,2021.0,2,1,1
CHN,DNK,2003.0,6,6,0
POL,ESP,2016.0,15,21,-6
AUS,NCL,2018.0,3,3,0
USA,GUM,2012.0,6,10,-4
DNK,HKG,2017.0,5,2,3
MEX,KEN,2020.0,2,1,1
IND,HRV,2019.0,1,1,0
RUS,UZB,2011.0,8,10,-2
FRA,PHL,2004.0,2,1,1
CHL,RUS,2016.0,2,2,0
GNB,DNK,2009.0,6,2,4
PAK,IRL,2015.0,7,8,-1
SWE,VNM,2008.0,3,3,0
NGA,NER,2023.0,5,4,1
PAK,CHN,2003.0,1,2,-1
PAK,ITA,2024.0,1,1,0
BGD,NLD,2020.0,3,6,-3
JPN,PER,2014.0,3,2,1
CHE,THA,2014.0,5,3,2
THA,CHE,2015.0,6,4,2
AUS,KHM,2021.0,4,3,1
THA,IND,2018.0,10,19,-9
DEU,NGA,2016.0,9,10,-1
PHL,BEL,2022.0,2,1,1
EGY,KWT,2010.0,9,6,3
MEX,GBR,2005.0,11,44,-33
KEN,BEL,2022.0,5,5,0
AUT,BFA,2022.0,3,1,2
PRT,ROU,2002.0,2,3,-1
GHA,JPN,2023.0,3,2,1
BEL,PRT,2004.0,3,3,0
CHN,YEM,2021.0,5,2,3
VNM,PHL,2023.0,1,3,-2
BEL,MYS,2012.0,1,6,-5
CAN,TUN,2008.0,10,7,3
SWE,ARG,2001.0,5,7,-2
MDG,USA,2006.0,1,3,-2
MAR,CAN,2000.0,4,4,0
NGA,JPN,2005.0,3,5,-2
ZAF,NGA,2002.0,4,3,1
MEX,CUB,2003.0,5,17,-12
SAU,LBN,2013.0,5,7,-2
CHE,CHL,2015.0,13,9,4
BGR,CAN,2005.0,3,1,2
BGD,JPN,2001.0,16,22,-6
FRA,NER,2003.0,8,1,7
USA,MNG,2018.0,4,6,-2
GRC,BGR,2005.0,1,4,-3
SWE,CUB,2002.0,1,1,0
CUB,COL,2010.0,4,1,3
FRA,SAU,2000.0,1,2,-1
BEL,EGY,2003.0,2,1,1
GBR,EGY,2000.0,11,7,4
GBR,UZB,2005.0,2,2,0
TUN,CHE,2021.0,1,1,0
BRA,CUB,1998.0,1,3,-2
UGA,CHE,2020.0,3,2,1
DEU,GAB,2009.0,4,4,0
NLD,HKG,2007.0,3,3,0
EST,DNK,2018.0,3,1,2
KAZ,RUS,2000.0,10,10,0
BGD,SAU,2013.0,4,1,3
PAN,COL,2013.0,2,2,0
FRA,TGO,1998.0,6,2,4
CAN,MYS,2017.0,8,33,-25
TUR,MEX,2005.0,2,4,-2
RUS,CHN,2001.0,10,9,1
FIN,LTU,2001.0,1,1,0
SGP,CHN,1998.0,6,57,-51
BWA,NGA,2006.0,2,2,0
CHN,POL,1997.0,4,2,2
MYS,FRA,2006.0,1,4,-3
USA,PRY,2018.0,2,3,-1
USA,LKA,2002.0,7,5,2
DNK,JPN,2000.0,8,9,-1
THA,IND,2016.0,11,13,-2
ESP,LUX,2008.0,4,2,2
SRB,CHE,2016.0,5,3,2
CHE,SRB,2022.0,4,3,1
NZL,ESP,2008.0,2,4,-2
BGR,SRB,2020.0,2,1,1
POL,KOR,2003.0,3,1,2
ESP,POL,2007.0,5,9,-4
SVN,HRV,2006.0,2,8,-6
ITA,HRV,2012.0,8,5,3
SVN,ITA,2019.0,12,13,-1
ARG,FIN,2005.0,1,2,-1
CHE,CMR,2003.0,1,2,-1
UKR,ITA,2010.0,5,2,3
CAN,GHA,2013.0,5,2,3
TUR,SGP,2019.0,2,8,-6
USA,LBY,2008.0,1,1,0
TZA,JPN,2012.0,4,5,-1
LAO,SWE,2012.0,1,3,-2
IND,PHL,2001.0,5,4,1
MAR,CAN,2006.0,4,6,-2
FIN,IND,2010.0,2,7,-5
MWI,ZAF,2006.0,4,5,-1
AUS,IRQ,2015.0,5,7,-2
ESP,PER,2002.0,4,9,-5
TTO,JAM,2005.0,1,2,-1
CHE,PRT,2017.0,15,22,-7
CHE,GTM,2019.0,2,1,1
CAN,KWT,2002.0,4,1,3
BFA,USA,2015.0,2,2,0
EGY,KWT,2006.0,4,2,2
ROU,AUT,2008.0,4,3,1
CHE,VNM,2015.0,1,4,-3
BGR,CZE,2002.0,1,1,0
UGA,FRA,2021.0,1,2,-1
CZE,TUR,2013.0,2,1,1
NLD,CZE,1998.0,4,3,1
FIN,AUS,2009.0,9,10,-1
PER,ESP,2008.0,5,8,-3
VNM,KEN,2018.0,1,2,-1
NZL,ZAF,2016.0,10,7,3
ISR,BGR,2006.0,1,1,0
FRA,BGR,2014.0,7,10,-3
GRC,AUT,2003.0,5,4,1
ITA,MCO,2017.0,3,2,1
AUT,JPN,2014.0,10,13,-3
POL,NOR,2008.0,7,7,0
CUB,DEU,2005.0,1,7,-6
EGY,TUR,2008.0,2,1,1
ZAF,ITA,2008.0,5,2,3
ESP,PER,2005.0,6,2,4
EST,RUS,2007.0,3,1,2
NZL,ESP,2004.0,1,3,-2
CUB,BRA,2012.0,9,8,1
BRA,ISR,2018.0,6,1,5
CHE,BEN,2013.0,1,1,0
MYS,DEU,2005.0,1,4,-3
IND,CHN,1998.0,1,1,0
FIN,BRA,2013.0,6,6,0
HKG,MAC,2008.0,6,5,1
UKR,DNK,2005.0,3,1,2
CMR,CAN,2009.0,3,2,1
ESP,ISR,2013.0,9,6,3
MOZ,AUS,2018.0,2,1,1
PHL,FRA,2019.0,1,4,-3
BEL,BLR,2005.0,6,1,5
AUS,BHR,2009.0,2,2,0
JPN,BEL,2005.0,11,7,4
MEX,CHN,2001.0,5,4,1
IRL,GRC,2010.0,2,2,0
NPL,GBR,2015.0,4,6,-2
ZAF,BRA,2004.0,2,2,0
CMR,NGA,1997.0,1,2,-1
GBR,BWA,2005.0,6,2,4
MDA,POL,1997.0,1,2,-1
SVN,JPN,2008.0,1,2,-1
SGP,HKG,2002.0,10,23,-13
KOR,MYS,2010.0,6,2,4
BEN,FRA,2007.0,2,9,-7
PHL,BEL,2018.0,1,4,-3
CHN,IRL,2004.0,4,1,3
FRA,COG,2009.0,3,5,-2
AUT,CHL,2001.0,2,2,0
PRT,DNK,2016.0,14,3,11
KGZ,RUS,2000.0,4,1,3
RUS,KGZ,2003.0,4,2,2
SYR,SAU,2015.0,3,1,2
BGR,CAN,2012.0,3,1,2
DNK,ZAF,2001.0,2,3,-1
NOR,IRL,2001.0,4,4,0
BEN,NLD,2008.0,2,1,1
TWN,CAN,2014.0,13,10,3
MYS,CAN,2003.0,4,2,2
IRN,DEU,2002.0,9,8,1
ITA,BGR,2009.0,4,4,0
FRA,JOR,2012.0,2,2,0
NOR,CAN,2002.0,11,14,-3
CHE,SRB,2018.0,6,8,-2
GHA,JPN,2010.0,2,3,-1
TUN,ARE,2017.0,3,4,-1
MNE,SRB,2009.0,2,7,-5
NZL,AUT,2013.0,4,6,-2
GBR,JAM,2012.0,6,4,2
TWN,GMB,2011.0,1,1,0
FRA,VEN,2014.0,4,6,-2
EST,SWE,2008.0,7,9,-2
CIV,USA,2001.0,1,2,-1
ISL,USA,2005.0,3,18,-15
MYS,FRA,2010.0,5,7,-2
CAN,NGA,2010.0,2,7,-5
BEN,BEL,2008.0,1,6,-5
NOR,AUT,2014.0,4,11,-7
CHN,PHL,2011.0,5,3,2
PHL,CHE,2014.0,3,2,1
ZAF,UGA,2009.0,3,1,2
GEO,ITA,2006.0,4,1,3
LVA,RUS,2015.0,5,1,4
TUN,CAN,2011.0,10,7,3
SAU,KWT,2013.0,5,1,4
AUS,CZE,2016.0,7,6,1
IRL,CYP,2019.0,1,4,-3
DNK,JPN,2006.0,5,11,-6
BEL,IRN,2018.0,16,22,-6
ETH,DNK,2002.0,3,1,2
MYS,NPL,2013.0,2,2,0
URY,ITA,2004.0,1,1,0
BIH,SRB,2005.0,5,10,-5
CUB,USA,2010.0,7,15,-8
UGA,MWI,2020.0,1,3,-2
CZE,CAN,2014.0,10,13,-3
ARG,JPN,2010.0,1,2,-1
GRL,DNK,2020.0,5,4,1
SAU,DEU,2016.0,8,34,-26
LBY,EGY,2013.0,3,2,1
KOR,ETH,2016.0,2,3,-1
USA,MLI,2012.0,2,3,-1
NOR,BEL,2015.0,6,4,2
ZAF,KOR,2010.0,4,1,3
BRA,CHN,2008.0,5,2,3
CHN,PHL,2009.0,2,2,0
BWA,AUS,2017.0,3,1,2
CYP,TUR,2006.0,4,6,-2
EGY,SWE,2011.0,3,1,2
ITA,UGA,2017.0,4,2,2
FJI,GBR,2016.0,4,3,1
ITA,TWN,2010.0,2,2,0
USA,AZE,2018.0,6,2,4
ROU,FIN,2015.0,4,3,1
AUS,MOZ,2009.0,1,2,-1
TWN,ITA,2009.0,1,3,-2
NAM,DEU,2012.0,1,2,-1
KOR,KAZ,2017.0,5,2,3
CAN,HRV,2013.0,3,2,1
ZAF,MEX,2014.0,1,2,-1
FRA,REU,2014.0,21,30,-9
NOR,CHN,2009.0,10,17,-7
CHN,IND,2011.0,6,22,-16
ZAF,ZMB,2011.0,4,4,0
PRT,SAU,2019.0,3,1,2
ZAF,FLK,2015.0,1,1,0
ZMB,USA,2011.0,11,12,-1
VNM,AUS,2006.0,1,7,-6
PAN,IND,2020.0,1,2,-1
URY,FRA,2004.0,1,5,-4
BRA,MEX,2008.0,12,12,0
VNM,ZAF,2020.0,1,5,-4
USA,GMB,2009.0,2,2,0
FIN,RUS,2009.0,8,21,-13
ISL,NOR,2008.0,4,5,-1
ISR,ZAF,2018.0,1,2,-1
TTO,GRD,2013.0,2,1,1
PAK,TWN,2015.0,1,2,-1
HUN,IND,2012.0,3,2,1
HKG,THA,2018.0,4,1,3
BRA,ISR,2017.0,4,1,3
ISL,DEU,2022.0,4,6,-2
POL,HRV,2021.0,2,3,-1
NZL,QAT,2020.0,3,2,1
DEU,CUB,2021.0,3,4,-1
AUT,FIN,2014.0,4,14,-10
ESP,NZL,2015.0,10,2,8
ITA,GHA,2017.0,3,3,0
GBR,MKD,2020.0,3,4,-1
TWN,NZL,2020.0,6,4,2
NOR,IRN,2018.0,5,14,-9
KOR,SVN,2016.0,2,1,1
SRB,AUT,2012.0,2,6,-4
BEL,PER,2014.0,5,1,4
FRA,HUN,2006.0,6,9,-3
JPN,MMR,2014.0,4,1,3
PRT,SVK,2002.0,1,1,0
BEL,IDN,2015.0,4,4,0
NIC,CRI,2019.0,1,1,0
CMR,CIV,2016.0,1,2,-1
ITA,URY,2020.0,1,2,-1
AUT,ISR,2016.0,8,4,4
POL,ZAF,2021.0,3,6,-3
MYS,FIN,2023.0,5,1,4
EST,LVA,2018.0,3,3,0
BEL,MEX,2015.0,7,10,-3
USA,MLT,2020.0,5,5,0
POL,KAZ,2016.0,2,1,1
NLD,MOZ,2013.0,1,1,0
SWE,ARE,2019.0,3,5,-2
NGA,DEU,2009.0,4,6,-2
IND,ESP,2015.0,19,20,-1
EGY,ETH,2011.0,1,2,-1
THA,SWE,2019.0,5,9,-4
CZE,BGD,2014.0,1,2,-1
PRI,CAN,2015.0,2,2,0
SEN,NGA,2013.0,1,1,0
PHL,MYS,2022.0,5,5,0
USA,BTN,2014.0,3,2,1
ESP,HUN,2020.0,1,11,-10
TZA,ITA,2019.0,4,2,2
AUS,KHM,2011.0,4,1,3
COL,CUB,2012.0,4,4,0
NOR,ISL,2020.0,6,7,-1
EGY,TWN,2017.0,3,1,2
GHA,ISR,2022.0,1,1,0
IND,BTN,2020.0,4,2,2
MRT,MAR,2021.0,1,4,-3
KAZ,POL,2018.0,4,6,-2
MEX,CHN,2004.0,2,2,0
SWE,IRQ,2020.0,4,3,1
SVK,RUS,2021.0,5,3,2
IRQ,SAU,2022.0,3,6,-3
CHN,EGY,2010.0,3,3,0
SGP,NZL,2004.0,10,4,6
EST,ESP,2011.0,2,3,-1
CPV,BRA,2021.0,2,1,1
ISR,FIN,2022.0,3,3,0
ZAF,ARE,2019.0,5,4,1
IRN,ZAF,2016.0,6,5,1
KOR,IRL,2006.0,2,1,1
MKD,RUS,2022.0,4,1,3
USA,ASM,2017.0,2,1,1
ITA,ETH,2018.0,5,2,3
GHA,ZAF,2017.0,16,18,-2
VEN,CHL,2014.0,4,8,-4
AUS,NOR,2000.0,6,6,0
RUS,SGP,2020.0,7,4,3
CHL,URY,2018.0,2,2,0
AUS,GRC,2019.0,4,14,-10
KAZ,ITA,2023.0,2,1,1
USA,DOM,2019.0,10,3,7
LBN,ITA,2020.0,2,5,-3
PSE,FRA,2022.0,1,2,-1
NIC,MEX,2017.0,1,1,0
FRA,COG,2019.0,3,4,-1
EGY,TUN,2020.0,1,1,0
TUN,EGY,2021.0,4,1,3
PAK,BHR,2020.0,3,2,1
JOR,BHR,2017.0,4,1,3
PRT,CZE,2017.0,3,2,1
AFG,USA,2018.0,4,19,-15
SVK,ITA,2017.0,3,8,-5
GHA,GBR,2011.0,6,26,-20
SEN,COD,2020.0,1,1,0
KOR,IRN,2007.0,2,2,0
TZA,DNK,2021.0,6,1,5
AUT,SVK,2019.0,10,11,-1
QAT,SAU,2021.0,9,16,-7
RUS,IND,2020.0,5,24,-19
DEU,AZE,2022.0,2,2,0
SRB,MNE,2013.0,6,5,1
IND,YEM,2023.0,5,10,-5
ITA,ARG,2023.0,6,13,-7
EGY,CZE,2009.0,1,2,-1
CZE,EGY,2012.0,3,2,1
SSD,UGA,2022.0,1,1,0
CZE,IRN,2010.0,2,1,1
ITA,MKD,2020.0,3,1,2
ITA,LTU,2022.0,5,4,1
KHM,JPN,2023.0,3,2,1
CYP,ITA,2022.0,2,6,-4
TUN,IRL,2022.0,2,1,1
BEL,PAK,2022.0,5,3,2
ITA,NGA,1999.0,3,2,1
UKR,GRC,2001.0,3,2,1
CAN,GAB,2015.0,3,1,2
PRI,COL,2011.0,3,1,2
PRT,CHE,2006.0,8,9,-1
POL,ZAF,2009.0,1,1,0
CZE,UKR,2014.0,4,4,0
GRC,BEL,2007.0,4,11,-7
NLD,IDN,2000.0,6,8,-2
ISR,BRA,2023.0,1,5,-4
DEU,SGP,2004.0,11,11,0
BRA,URY,2012.0,9,4,5
ZWE,KEN,2013.0,2,2,0
KOR,ESP,2016.0,10,8,2
CHL,CHE,2009.0,12,6,6
PER,CHL,2005.0,2,4,-2
SWE,HKG,2011.0,2,2,0
PER,COL,2017.0,5,7,-2
BEL,GMB,2020.0,1,2,-1
GMB,DEU,2023.0,1,1,0
NZL,FRA,2002.0,7,7,0
GBR,GUY,2013.0,1,1,0
BIH,USA,2008.0,5,6,-1
BRA,COL,2001.0,6,2,4
PRY,USA,2018.0,3,2,1
DEU,OMN,2011.0,4,2,2
HRV,GBR,2006.0,5,3,2
CMR,CHE,2007.0,2,3,-1
VEN,ARG,2010.0,4,1,3
FIN,ITA,2008.0,8,10,-2
SVN,SWE,2019.0,5,5,0
COL,ARG,2001.0,4,2,2
FRA,TTO,2013.0,3,1,2
SGP,BEL,2005.0,2,1,1
RUS,ARM,2011.0,5,12,-7
NZL,LKA,2005.0,2,1,1
SVN,GBR,2003.0,3,3,0
BFA,BEN,2012.0,2,2,0
VEN,CUB,2005.0,1,3,-2
BGR,GBR,2018.0,3,12,-9
ZAF,ETH,2001.0,3,5,-2
SVN,BIH,2016.0,3,1,2
SWE,JOR,2019.0,1,2,-1
JAM,GBR,2013.0,2,4,-2
ROU,AUT,2015.0,5,6,-1
CHE,HRV,2007.0,4,5,-1
EGY,TUN,2007.0,3,1,2
BWA,USA,1999.0,3,3,0
ECU,USA,2001.0,7,7,0
BEL,THA,1998.0,1,1,0
ESP,GRC,1997.0,1,2,-1
JPN,ROU,2009.0,7,1,6
HKG,ESP,2008.0,2,1,1
BRA,TUR,2010.0,1,2,-1
LBN,ARE,2009.0,1,3,-2
ARE,FRA,2011.0,3,9,-6
RWA,UGA,1998.0,1,1,0
COG,BFA,2019.0,4,1,3
SGP,THA,2010.0,3,4,-1
BEL,SVN,2007.0,2,1,1
CHE,PHL,1997.0,2,1,1
BEL,RWA,2006.0,2,1,1
QAT,USA,2008.0,3,23,-20
SGP,LKA,2005.0,1,2,-1
USA,KHM,2012.0,4,8,-4
NGA,JPN,2002.0,1,8,-7
IND,KWT,2003.0,11,6,5
SGP,NOR,2004.0,1,2,-1
VNM,GBR,2004.0,3,2,1
BMU,GBR,2009.0,3,1,2
IDN,PHL,2014.0,2,3,-1
CHL,JPN,2015.0,2,4,-2
SWE,SGP,2003.0,1,1,0
AUS,YEM,2005.0,1,1,0
CZE,JPN,2015.0,7,8,-1
IND,NPL,2000.0,5,10,-5
CHE,HKG,2003.0,2,1,1
CHN,NOR,2006.0,8,6,2
SGP,TWN,1997.0,2,1,1
SGP,TWN,2005.0,6,3,3
TWN,DEU,2004.0,10,6,4
CHN,PRT,2006.0,2,8,-6
KOR,CHN,1998.0,8,10,-2
TWN,KOR,2001.0,3,5,-2
DNK,JPN,2010.0,9,9,0
CHN,RUS,2005.0,3,5,-2
FIN,CHN,2000.0,6,7,-1
JPN,MMR,2004.0,4,2,2
FRA,BFA,2002.0,12,7,5
MEX,RUS,2015.0,6,4,2
IND,SAU,2000.0,10,6,4
HRV,MKD,2008.0,1,2,-1
CYP,GRC,2005.0,5,10,-5
IDN,PER,2021.0,3,1,2
PER,IDN,2022.0,2,1,1
CHN,NZL,2005.0,4,6,-2
DNK,SVK,2007.0,1,2,-1
HUN,AUT,1998.0,3,3,0
HRV,AUT,2022.0,7,3,4
SWE,NZL,2006.0,5,8,-3
ESP,DOM,2014.0,3,1,2
LVA,SWE,2021.0,3,1,2
AUT,SRB,2017.0,4,4,0
EGY,BEL,2017.0,5,5,0
FRA,LBN,2001.0,25,19,6
FRA,SRB,2003.0,8,5,3
GBR,TZA,2008.0,8,4,4
USA,NPL,1997.0,3,2,1
LUX,DEU,2002.0,4,3,1
BLR,CAN,2006.0,1,4,-3
CHN,AUT,2007.0,7,5,2
TTO,IND,2010.0,3,3,0
MKD,FRA,2006.0,1,4,-3
ZAF,CHE,2001.0,6,9,-3
BFA,CAN,2003.0,2,1,1
IRN,SGP,2011.0,10,1,9
CAN,KWT,2005.0,3,6,-3
HUN,NOR,2012.0,6,1,5
TZA,ZAF,2011.0,4,4,0
ARG,PRT,2005.0,1,1,0
BGR,CHE,2013.0,7,1,6
AUT,IRN,2013.0,5,11,-6
AUT,CHN,2007.0,5,7,-2
PAK,IRN,2005.0,2,1,1
SVK,FRA,2010.0,6,3,3
ETH,ESP,2010.0,1,2,-1
ITA,ZAF,2011.0,10,4,6
SGP,BEL,2002.0,1,2,-1
FRA,COL,2012.0,15,13,2
CZE,HRV,2019.0,4,6,-2
SWE,SVK,2016.0,4,5,-1
SVK,NLD,1998.0,3,4,-1
ISR,AUT,1999.0,3,1,2
ESP,SGP,2012.0,8,5,3
TUR,JPN,2010.0,6,11,-5
CRI,MEX,2008.0,2,4,-2
FRA,BOL,2008.0,3,5,-2
POL,AUS,2012.0,5,6,-1
BEL,KOR,2010.0,4,3,1
PRI,CAN,2008.0,2,1,1
MAR,TUN,2010.0,2,3,-1
USA,ASM,2016.0,2,3,-1
CHN,SRB,2015.0,1,1,0
SGP,ISR,2010.0,4,3,1
ZAF,POL,2022.0,5,2,3
URY,FRA,2008.0,1,2,-1
ISR,KOR,2004.0,2,1,1
ZAF,ITA,2014.0,4,10,-6
ISR,ESP,2004.0,8,3,5
HUN,JOR,2021.0,6,5,1
AUT,GRC,2008.0,4,4,0
ISR,POL,2010.0,1,1,0
FRA,TTO,2003.0,2,3,-1
SVK,IRL,2006.0,1,1,0
GBR,GAB,2016.0,2,2,0
HKG,BEL,2018.0,2,5,-3
SGP,IRL,2019.0,9,10,-1
SWE,SWZ,2010.0,1,2,-1
UKR,BLR,2020.0,3,2,1
SVK,SLV,2017.0,3,7,-4
KEN,ITA,2012.0,2,1,1
MEX,AUT,2012.0,3,2,1
IRL,MWI,2020.0,1,1,0
LKA,JPN,2013.0,4,14,-10
UGA,BEL,2012.0,1,1,0
MEX,BRA,2005.0,5,12,-7
EGY,HUN,2022.0,6,6,0
JPN,CZE,2023.0,7,3,4
ROU,MDA,2012.0,3,7,-4
COG,UGA,2022.0,1,2,-1
DEU,HKG,2003.0,10,11,-1
CAN,MYS,2016.0,9,27,-18
JPN,QAT,2014.0,3,2,1
HRV,BIH,2018.0,9,9,0
MLT,GRC,2018.0,1,1,0
AUS,LAO,2021.0,2,2,0
BRB,GBR,2015.0,2,1,1
CAN,UGA,2015.0,3,1,2
SEN,TGO,2014.0,4,1,3
JOR,BHR,2018.0,1,1,0
GBR,COL,2007.0,8,7,1
GHA,CAN,2012.0,4,4,0
USA,NAM,2022.0,3,4,-1
VNM,RWA,2018.0,1,1,0
BGD,IRN,2016.0,1,1,0
OMN,GBR,2015.0,6,18,-12
GBR,ZWE,2014.0,3,3,0
TUN,JPN,2017.0,1,3,-2
BEL,NER,2015.0,4,1,3
ESP,SVK,2012.0,2,2,0
CHN,HUN,2012.0,2,3,-1
TUR,PSE,2015.0,1,1,0
NLD,HUN,2009.0,7,14,-7
HUN,CAN,2022.0,5,3,2
PRT,PAK,2016.0,2,1,1
PSE,DEU,2017.0,5,6,-1
SAU,KOR,2010.0,1,13,-12
KAZ,JPN,2018.0,5,4,1
HKG,ZAF,1999.0,1,1,0
HKG,FRA,2014.0,4,11,-7
ZAF,CHN,2022.0,10,11,-1
BRN,MYS,2023.0,2,6,-4
SAU,BRN,2023.0,1,1,0
POL,PAK,2022.0,3,12,-9
DNK,GRL,2020.0,4,5,-1
IRL,CZE,2015.0,3,4,-1
EST,ITA,2016.0,2,3,-1
HKG,RUS,2017.0,3,3,0
TWN,EGY,2014.0,3,1,2
KOR,CHL,2016.0,1,3,-2
MOZ,USA,2014.0,3,9,-6
SVK,ROU,2017.0,1,1,0
USA,SVK,2020.0,17,7,10
IRQ,RUS,2022.0,8,9,-1
JAM,TTO,2019.0,10,2,8
MLI,BFA,2019.0,2,2,0
DEU,SVN,2023.0,5,11,-6
COL,NZL,2021.0,1,1,0
NZL,COL,2023.0,2,1,1
MWI,FRA,2019.0,2,1,1
JAM,CAN,2022.0,9,2,7
SAU,NOR,2021.0,6,4,2
ZMB,DEU,2020.0,2,2,0
GRC,IND,2020.0,3,2,1
DEU,MMR,2021.0,3,1,2
OMN,IRQ,2021.0,1,1,0
FRA,GMB,2017.0,1,1,0
ZAF,JPN,2000.0,2,4,-2
KEN,GBR,2021.0,22,31,-9
SWE,ETH,2002.0,3,4,-1
USA,CIV,2021.0,4,9,-5
CHN,PRT,2000.0,5,2,3
PRT,DNK,2017.0,14,15,-1
CPV,USA,2016.0,1,1,0
DZA,MYS,2020.0,3,5,-2
EGY,GRC,2020.0,2,4,-2
GRC,BRA,2018.0,2,0,2
SWE,TUN,2023.0,1,0,1
COL,GRC,2022.0,1,0,1
DEU,RWA,2016.0,2,0,2
ESP,BEN,2019.0,1,0,1
CZE,ECU,2006.0,3,0,3
,FLK,2014.0,2,0,2
TWN,KEN,2020.0,3,0,3
DEU,SWZ,2020.0,2,0,2
SDN,ESP,2022.0,1,0,1
MKD,MDA,2019.0,4,0,4
CHL,ETH,2018.0,2,0,2
JPN,MOZ,2019.0,1,0,1
SDN,SSD,2022.0,12,0,12
SSD,ETH,2015.0,1,0,1
YEM,,2026.0,3,0,3
BIH,AUS,2021.0,1,0,1
TWN,NOR,2021.0,4,0,4
,BEL,2021.0,13,0,13
COD,IND,2022.0,1,0,1
,DMA,2019.0,3,0,3
,HKG,2021.0,41,0,41
,NCL,2019.0,16,0,16
KAZ,SRB,2021.0,1,0,1
KWT,BEL,2022.0,1,0,1
BHR,IND,1999.0,2,0,2
PRT,GNB,2009.0,1,0,1
GRC,PSE,2011.0,1,0,1
SVK,KWT,1998.0,2,0,2
MYS,ARE,2006.0,6,0,6
,BEN,2006.0,45,0,45
TZA,TUR,2020.0,1,0,1
MLT,BGR,2019.0,1,0,1
BHR,OMN,2015.0,1,0,1
LIE,SWE,2014.0,1,0,1
MUS,USA,2011.0,3,0,3
GIN,SEN,2019.0,1,0,1
COL,NOR,1998.0,1,0,1
ZAF,ARE,2013.0,4,0,4
SVK,FRA,2014.0,5,0,5
HKG,THA,2002.0,2,0,2
,MTQ,2003.0,11,0,11
NLD,DZA,2013.0,1,0,1
SVN,QAT,2014.0,1,0,1
THA,LKA,2008.0,2,0,2
NOR,IRL,2000.0,3,0,3
HRV,THA,2017.0,1,0,1
ATG,DEU,2009.0,1,0,1
USA,BMU,2006.0,4,0,4
LKA,BRA,2008.0,3,0,3
CHE,IRN,2004.0,1,0,1
ARM,CHN,2020.0,2,0,2
GUF,BFA,2014.0,1,0,1
KEN,GNQ,2018.0,1,0,1
JPN,ZWE,2012.0,1,0,1
IND,UZB,2009.0,1,0,1
ZAF,BFA,2010.0,3,0,3
ETH,BFA,2010.0,1,0,1
UKR,DNK,2016.0,1,0,1
TWN,NOR,2019.0,4,0,4
NZL,ESP,2000.0,2,0,2
LUX,COL,2019.0,2,0,2
NAM,,2019.0,28,0,28
KOR,BLR,2001.0,1,0,1
MAR,MEX,2018.0,2,0,2
,PRK,2012.0,10,0,10
PLW,,2018.0,1,0,1
ZAF,BGR,2018.0,2,0,2
PAK,ALB,2019.0,1,0,1
ALB,PAK,2020.0,1,0,1
,MHL,2012.0,3,0,3
MHL,,2024.0,7,0,7
GNQ,BEL,2017.0,1,0,1
SLE,YEM,2019.0,1,0,1
BFA,DEU,1998.0,3,0,3
HKG,VNM,2017.0,1,0,1
CAN,BGD,1997.0,1,0,1
BRA,ECU,2015.0,10,0,10
MMR,,2012.0,9,0,9
CHE,SDN,2006.0,1,0,1
TUR,IRL,1999.0,1,0,1
BLZ,,2012.0,6,0,6
JPN,SYR,2004.0,1,0,1
OMN,MYS,2006.0,1,0,1
,LIE,2001.0,3,0,3
GUY,,2014.0,4,0,4
BOL,,1999.0,5,0,5
CYM,,2014.0,1,0,1
ROU,KOR,2018.0,1,0,1
KOR,DNK,2011.0,2,0,2
BGD,RUS,2019.0,1,0,1
,GTM,2000.0,8,0,8
IRQ,GRC,2021.0,2,0,2
CHN,EGY,2004.0,2,0,2
,GUF,2019.0,18,0,18
,ERI,2019.0,11,0,11
ERI,ETH,2022.0,1,0,1
LKA,NPL,2009.0,1,0,1
UGA,THA,2018.0,1,0,1
MHL,USA,2022.0,4,0,4
JOR,MMR,2022.0,1,0,1
USA,GRC,2024.0,1,0,1
,SLB,2020.0,4,0,4
CHE,SWZ,2022.0,8,0,8
AUS,BIH,2003.0,1,0,1
AUS,BIH,2013.0,1,0,1
PAN,GBR,2004.0,2,0,2
ITA,VEN,2019.0,1,0,1
ETH,UGA,2011.0,2,0,2
BFA,ZAF,1998.0,1,0,1
EGY,FIN,1998.0,1,0,1
CRI,RUS,2004.0,4,0,4
VNM,GBR,2000.0,6,0,6
ZWE,AUS,1999.0,1,0,1
BHR,KWT,2007.0,1,0,1
SGP,EGY,2007.0,1,0,1
MEX,CZE,1999.0,3,0,3
NZL,IRQ,2016.0,1,0,1
LBY,CAN,1998.0,1,0,1
NLD,SYR,2015.0,2,0,2
BLR,FIN,2001.0,1,0,1
CYP,AUT,2021.0,1,0,1
JOR,KWT,1998.0,1,0,1
NER,ETH,2003.0,1,0,1
MUS,MRT,2010.0,1,0,1
USA,QAT,1999.0,2,0,2
KWT,SVK,1997.0,2,0,2
THA,KAZ,2017.0,1,0,1
JPN,SYR,2001.0,1,0,1
SYR,JPN,2006.0,1,0,1
FIN,TUN,2001.0,1,0,1
GBR,BHR,2005.0,3,0,3
TUR,ARG,2016.0,6,0,6
SRB,UZB,2006.0,1,0,1
MRT,,2007.0,5,0,5
ZWE,NGA,2001.0,1,0,1
GRC,RUS,1998.0,2,0,2
GMB,NLD,2019.0,1,0,1
LVA,AUT,2001.0,5,0,5
AUT,LVA,2002.0,3,0,3
KAZ,BLR,1997.0,3,0,3
BLR,LVA,1997.0,1,0,1
SVK,YEM,2001.0,3,0,3
FIN,TZA,1998.0,1,0,1
BIH,USA,2000.0,3,0,3
ZAF,DZA,2001.0,1,0,1
PAN,AUS,2012.0,2,0,2
MAR,TWN,2001.0,2,0,2
USA,UZB,2020.0,2,0,2
GRC,PRI,1999.0,2,0,2
,FRO,1996.0,4,0,4
PAN,GRC,1997.0,1,0,1
CMR,,2002.0,5,0,5
NGA,SLE,1997.0,1,0,1
DNK,EGY,2000.0,5,0,5
PAN,AUS,2005.0,1,0,1
OMN,BRN,2015.0,1,0,1
CRI,SRB,2004.0,1,0,1
FRA,AGO,2011.0,1,0,1
MKD,CZE,2010.0,1,0,1
ESP,OMN,2020.0,2,0,2
MDG,CAN,2012.0,1,0,1
IND,MLT,2019.0,2,0,2
PAN,ESP,2010.0,5,0,5
ZAF,PHL,2015.0,1,0,1
LTU,ITA,2009.0,5,0,5
CAN,PYF,2010.0,1,0,1
URY,JPN,2021.0,1,0,1
NOR,BFA,2020.0,1,0,1
ETH,CZE,2010.0,1,0,1
LAO,NOR,2017.0,1,0,1
TCD,ZAF,2011.0,2,0,2
AUS,MAR,2013.0,2,0,2
BEL,CRI,2015.0,1,0,1
,GUY,1998.0,5,0,5
GUY,,2004.0,2,0,2
SVK,EST,2014.0,1,0,1
NGA,EGY,2011.0,2,0,2
MAC,,2012.0,13,0,13
BTN,NLD,2010.0,1,0,1
KGZ,,2011.0,7,0,7
JOR,RUS,2016.0,1,0,1
,MCO,2007.0,9,0,9
FRA,LBY,2006.0,1,0,1
LBY,LBN,2019.0,1,0,1
VEN,ITA,2012.0,4,0,4
HKG,BRA,2009.0,2,0,2
IND,SDN,2015.0,2,0,2
MEX,DOM,2011.0,2,0,2
LVA,CAN,2010.0,1,0,1
VEN,DEU,2021.0,3,0,3
YEM,FRA,2014.0,1,0,1
ISR,GEO,2011.0,1,0,1
NOR,PHL,2012.0,2,0,2
PSE,MOZ,2016.0,1,0,1
,BHS,2004.0,6,0,6
TWN,PAK,2016.0,3,0,3
ESP,MLI,2019.0,1,0,1
,PNG,2009.0,25,0,25
MLT,MLI,2014.0,1,0,1
CUB,CRI,2015.0,1,0,1
BEL,TZA,2013.0,2,0,2
ZWE,KOR,2014.0,1,0,1
SRB,KWT,2017.0,1,0,1
,REU,2009.0,9,0,9
VNM,PHL,2015.0,1,0,1
LSO,,2015.0,6,0,6
AUS,CXR,2016.0,1,0,1
MKD,AUT,2016.0,3,0,3
DEU,LVA,2011.0,8,0,8
JAM,GRD,2021.0,1,0,1
SVK,CHN,2018.0,3,0,3
MAR,FIN,2019.0,1,0,1
JPN,AFG,2016.0,3,0,3
BOL,NOR,2019.0,1,0,1
BFA,,2005.0,15,0,15
,GNB,2012.0,7,0,7
CHN,GUY,2021.0,2,0,2
NIC,USA,2017.0,3,0,3
NLD,ZWE,2020.0,3,0,3
AUT,UGA,2018.0,2,0,2
HRV,DNK,2016.0,4,0,4
COG,GHA,2016.0,3,0,3
NLD,IRN,2000.0,5,0,5
LAO,CHE,2019.0,1,0,1
CIV,GIN,2022.0,3,0,3
MDA,ARM,2020.0,2,0,2
HKG,CHL,2020.0,1,0,1
,GRL,2015.0,3,0,3
UZB,USA,2023.0,1,0,1
IRN,CHE,2024.0,1,0,1
BRB,FRA,2019.0,2,0,2
PYF,GBR,2023.0,1,0,1
BWA,IND,2002.0,1,0,1
ARG,IRL,2007.0,1,0,1
,MDG,2020.0,27,0,27
IRL,GTM,2020.0,1,0,1
DEU,MAC,2021.0,1,0,1
ITA,ECU,2019.0,3,0,3
LBN,MAR,2023.0,2,0,2
CUB,COL,2015.0,7,0,7
MWI,BWA,2022.0,1,0,1
ISR,EGY,2016.0,1,0,1
GRC,ISR,2024.0,1,0,1
,TKM,2018.0,1,0,1
SRB,FRA,2023.0,3,0,3
MKD,VNM,2017.0,1,0,1
DNK,EST,2009.0,1,0,1
SGP,GEO,2020.0,1,0,1
NZL,MWI,1999.0,1,0,1
GTM,,2003.0,8,0,8
SWE,COL,1998.0,2,0,2
CHN,PRT,2004.0,8,0,8
SGP,ZAF,2006.0,1,0,1
PNG,,2009.0,14,0,14
CAN,BHR,2000.0,1,0,1
ECU,CUB,2000.0,1,0,1
AUT,EST,2011.0,2,0,2
SWE,CRI,2007.0,1,0,1
JPN,SDN,2006.0,2,0,2
CRI,GRC,1999.0,1,0,1
,MCO,1998.0,7,0,7
NOR,SGP,2002.0,1,0,1
GLP,,2020.0,9,0,9
FIN,HRV,1998.0,1,0,1
LBY,,2026.0,6,0,6
HKG,QAT,2015.0,1,0,1
DOM,,2009.0,4,0,4
OMN,QAT,2020.0,2,0,2
VNM,PHL,2008.0,1,0,1
SEN,,2004.0,12,0,12
ESP,GNQ,2001.0,2,0,2
KNA,,2011.0,3,0,3
ARG,CHN,2002.0,1,0,1
PRT,SWE,1997.0,2,0,2
,GRL,2004.0,3,0,3
AUT,UZB,2021.0,2,0,2
ESP,MEX,2024.0,1,0,1
IND,PRI,2004.0,2,0,2
FSM,,2023.0,3,0,3
LBY,IRQ,2017.0,1,0,1
DZA,POL,2005.0,1,0,1
MOZ,SOM,2022.0,1,0,1
AUS,MAR,2003.0,1,0,1
PRT,POL,1999.0,1,0,1
GRL,CAN,2013.0,1,0,1
ZWE,MEX,2011.0,1,0,1
GLP,CHE,2002.0,1,0,1
CIV,NER,2022.0,1,0,1
GRD,TTO,2016.0,1,0,1
TCA,,2022.0,5,0,5
,MAC,1995.0,6,0,6
LTU,CAN,2005.0,1,0,1
PAN,,2007.0,3,0,3
ISR,JPN,2006.0,3,0,3
BRB,SRB,2010.0,1,0,1
JPN,JOR,1998.0,1,0,1
JOR,NLD,2015.0,1,0,1
NLD,QAT,2013.0,3,0,3
BLR,CHN,1999.0,1,0,1
TUR,FIN,1998.0,1,0,1
IND,IRQ,2007.0,3,0,3
MNE,CHE,2020.0,1,0,1
NAM,ISR,1997.0,1,0,1
FIN,MDA,2021.0,1,0,1
HKG,RUS,1997.0,1,0,1
IND,HUN,2003.0,1,0,1
JAM,BRB,1998.0,1,0,1
BRB,JAM,1999.0,1,0,1
GBR,BEN,2001.0,2,0,2
CIV,BEN,2009.0,1,0,1
AUT,LUX,2000.0,3,0,3
KEN,AUT,2004.0,3,0,3
CHE,BGD,1997.0,2,0,2
PAN,CZE,2019.0,1,0,1
YEM,USA,2006.0,1,0,1
BRA,GUF,2003.0,1,0,1
GLP,RUS,2007.0,1,0,1
USA,WSM,2008.0,2,0,2
ITA,TUN,2013.0,5,0,5
BEN,ZWE,2008.0,1,0,1
BEN,CHE,2011.0,1,0,1
NGA,KWT,2000.0,1,0,1
YEM,BHR,2003.0,1,0,1
GBR,TTO,1999.0,4,0,4
DEU,MNE,2010.0,2,0,2
DNK,UKR,2007.0,4,0,4
URY,CHL,2009.0,2,0,2
TUN,UGA,2011.0,1,0,1
ETH,ZMB,2016.0,1,0,1
MAC,ARE,2012.0,1,0,1
QAT,NOR,2020.0,2,0,2
GRC,PRT,2008.0,1,0,1
SGP,CHL,2017.0,2,0,2
BEL,PSE,2022.0,2,0,2
SWZ,,2018.0,8,0,8
KAZ,VNM,2018.0,1,0,1
SGS,GEO,2020.0,1,0,1
LBN,KWT,2014.0,2,0,2
GUF,TTO,2012.0,1,0,1
HRV,KOR,2018.0,3,0,3
IDN,ESP,2013.0,2,0,2
ERI,SAU,2004.0,1,0,1
HKG,FJI,2017.0,1,0,1
PHL,ZAF,2013.0,2,0,2
DZA,SWE,2019.0,1,0,1
EGY,NOR,2008.0,2,0,2
CHL,HKG,2018.0,2,0,2
RUS,ECU,2016.0,1,0,1
OMN,MLI,2018.0,1,0,1
TUR,TWN,2022.0,2,0,2
BHS,,2022.0,8,0,8
TJK,DEU,2016.0,2,0,2
ISR,IRL,2006.0,3,0,3
NPL,ARE,2023.0,2,0,2
CAN,ROU,2021.0,5,0,5
GTM,IDN,2015.0,1,0,1
USA,CYM,2004.0,1,0,1
CYM,VNM,2012.0,1,0,1
ZMB,ALB,2014.0,2,0,2
CAN,TTO,2004.0,3,0,3
ECU,NZL,2021.0,1,0,1
NOR,MLI,2018.0,1,0,1
ROU,LUX,2020.0,2,0,2
USA,SUR,2018.0,1,0,1
BRB,AUS,2020.0,1,0,1
NZL,VNM,2015.0,2,0,2
HUN,IRN,2012.0,1,0,1
NLD,SAU,2009.0,4,0,4
RWA,,2026.0,3,0,3
CAN,JAM,2011.0,6,0,6
LBN,JPN,2019.0,2,0,2
DNK,OMN,2018.0,2,0,2
NCL,CAN,2005.0,1,0,1
DZA,,2000.0,19,0,19
JAM,POL,2018.0,1,0,1
LIE,GRC,2017.0,1,0,1
MYS,RUS,2019.0,3,0,3
EST,KAZ,2020.0,1,0,1
MDG,MUS,2017.0,3,0,3
NOR,GRL,2023.0,1,0,1
SLV,ITA,2020.0,1,0,1
,IOT,2013.0,2,0,2
MEX,PAN,2019.0,5,0,5
VEN,TUR,2018.0,1,0,1
MNG,USA,2001.0,6,0,6
TKM,CHN,2015.0,4,0,4
EST,UKR,2017.0,2,0,2
NZL,SAU,2007.0,1,0,1
ITA,LVA,2015.0,1,0,1
IRQ,PSE,2021.0,1,0,1
LBY,QAT,2022.0,1,0,1
SVK,UKR,2007.0,2,0,2
UZB,UKR,2009.0,4,0,4
,BHS,2015.0,6,0,6
IND,MLT,2021.0,1,0,1
EGY,LBY,2023.0,2,0,2
FRA,BHR,2021.0,1,0,1
HKG,UGA,2022.0,1,0,1
AUT,OMN,2016.0,1,0,1
CUB,PRI,2003.0,2,0,2
,CAF,1997.0,6,0,6
TUN,TGO,2019.0,1,0,1
AUT,HKG,2001.0,1,0,1
HKG,AUT,2003.0,1,0,1
TUR,NZL,2009.0,2,0,2
BWA,ZWE,2016.0,4,0,4
TUR,PHL,2009.0,1,0,1
CUB,DOM,2019.0,3,0,3
EGY,KAZ,2023.0,1,0,1
CHE,COL,2006.0,3,0,3
,MUS,2000.0,16,0,16
CHN,COG,2010.0,2,0,2
CHE,EGY,2007.0,2,0,2
BIH,SVN,2011.0,1,0,1
SVN,BIH,2012.0,2,0,2
NGA,HUN,2005.0,1,0,1
IRL,NAM,2003.0,1,0,1
GMB,KEN,2010.0,1,0,1
LUX,IRL,2018.0,3,0,3
NOR,BEN,2009.0,1,0,1
ZAF,CYP,2009.0,1,0,1
TGO,,2007.0,3,0,3
AUS,BGR,2013.0,1,0,1
ECU,ITA,1998.0,2,0,2
NZL,IRN,2003.0,1,0,1
ARG,ARE,2016.0,2,0,2
IDN,EGY,2006.0,1,0,1
TZA,DEU,1999.0,1,0,1
JPN,JOR,2007.0,3,0,3
CIV,CHE,1998.0,1,0,1
HKG,PHL,2011.0,1,0,1
PYF,CHL,2004.0,1,0,1
COL,UKR,2000.0,1,0,1
MUS,,2009.0,4,0,4
UZB,DEU,2005.0,3,0,3
ETH,,2002.0,20,0,20
IND,KEN,2005.0,3,0,3
CRI,BEL,2020.0,1,0,1
WSM,CCK,2010.0,1,0,1
SYR,,2010.0,21,0,21
BLR,AUT,2008.0,1,0,1
,BHS,2001.0,3,0,3
PRT,NGA,2004.0,1,0,1
KAZ,CHE,2006.0,1,0,1
PRI,RUS,2020.0,1,0,1
IND,BGR,2008.0,1,0,1
OMN,,1999.0,4,0,4
,BRN,2005.0,9,0,9
SVK,KWT,1999.0,1,0,1
KAZ,GEO,2017.0,2,0,2
GHA,MYS,2004.0,1,0,1
ITA,ETH,2002.0,3,0,3
IRQ,BRA,2021.0,1,0,1
MOZ,,2008.0,14,0,14
UKR,PRT,2007.0,5,0,5
ZAF,DZA,2008.0,1,0,1
BEL,URY,2009.0,1,0,1
LAO,KEN,2014.0,1,0,1
HKG,ARG,1998.0,1,0,1
SWZ,USA,2000.0,1,0,1
SVK,FIN,2001.0,2,0,2
SRB,BOL,2007.0,1,0,1
BGR,ISR,2000.0,3,0,3
ISR,BGR,2008.0,2,0,2
ERI,,2012.0,4,0,4
EST,LVA,2005.0,1,0,1
COL,PRI,2002.0,1,0,1
KHM,ITA,2007.0,1,0,1
,PRY,1997.0,9,0,9
GNB,USA,2022.0,1,0,1
USA,MSR,2007.0,1,0,1
MSR,USA,2009.0,1,0,1
LTU,,2000.0,25,0,25
ZAF,TUN,2004.0,1,0,1
NOR,LKA,2001.0,1,0,1
GBR,GIN,2015.0,1,0,1
,HTI,1995.0,6,0,6
MEX,AZE,2023.0,1,0,1
BLR,BEL,2011.0,2,0,2
IRQ,CHE,2021.0,1,0,1
AUS,MWI,2023.0,1,0,1
JPN,SVN,2010.0,2,0,2
,CAF,2002.0,4,0,4
SEN,CAF,2010.0,2,0,2
BHR,ARE,2005.0,1,0,1
MTQ,,2018.0,9,0,9
DEU,GLP,2002.0,1,0,1
KEN,MOZ,2021.0,1,0,1
MOZ,KEN,2022.0,1,0,1
ITA,UKR,2008.0,5,0,5
CHE,KHM,2007.0,1,0,1
FRA,VUT,2013.0,1,0,1
CHE,IDN,2008.0,1,0,1
SUR,BRB,2020.0,1,0,1
IRL,SAU,2005.0,1,0,1
ISR,NZL,2006.0,3,0,3
ROU,SVK,2006.0,1,0,1
ISL,DEU,1997.0,2,0,2
AUS,SWZ,2005.0,1,0,1
CYP,HKG,2005.0,1,0,1
HRV,ESP,2006.0,2,0,2
ESP,VNM,2010.0,1,0,1
GEO,ISR,2008.0,1,0,1
GBR,BIH,2004.0,2,0,2
ROU,PRT,2022.0,4,0,4
GUY,,2008.0,3,0,3
BOL,VEN,2000.0,1,0,1
MKD,NLD,2023.0,2,0,2
GHA,ZMB,2019.0,1,0,1
ETH,NAM,2012.0,1,0,1
,COM,2006.0,1,0,1
ITA,SEN,2009.0,1,0,1
ZWE,NOR,2009.0,1,0,1
SWZ,,2016.0,7,0,7
LBN,POL,2017.0,1,0,1
BOL,DEU,2022.0,2,0,2
IRQ,KOR,2010.0,1,0,1
BGD,JPN,2024.0,2,0,2
ZWE,LSO,2008.0,2,0,2
PAK,JOR,2006.0,2,0,2
CPV,CHL,2014.0,1,0,1
SEN,LUX,2018.0,1,0,1
MYS,BWA,2016.0,1,0,1
SVK,ROU,2012.0,1,0,1
QAT,NZL,2018.0,2,0,2
SVK,QAT,2014.0,2,0,2
TZA,PHL,2011.0,1,0,1
MYS,VEN,2012.0,2,0,2
ESP,HND,2011.0,1,0,1
,COD,2010.0,9,0,9
SAU,UGA,2015.0,1,0,1
CRI,NIC,2020.0,1,0,1
NCL,PYF,2015.0,2,0,2
BHR,CAN,2013.0,2,0,2
THA,MCO,2022.0,1,0,1
POL,GAB,2021.0,1,0,1
KNA,,2019.0,4,0,4
MAR,MRT,2019.0,7,0,7
SAU,COL,2014.0,1,0,1
GBR,BFA,2016.0,2,0,2
MLT,BRA,2017.0,4,0,4
MAR,COG,2020.0,4,0,4
BDI,KEN,2015.0,2,0,2
MEX,NZL,2013.0,4,0,4
GBR,BHS,2019.0,1,0,1
SYR,AFG,2009.0,1,0,1
VNM,IRL,2023.0,3,0,3
HUN,MKD,2019.0,1,0,1
,ASM,2013.0,2,0,2
MNP,,2023.0,4,0,4
BRA,BRN,2011.0,1,0,1
BRN,BRA,2012.0,2,0,2
MNE,BRA,2019.0,1,0,1
,TON,2016.0,1,0,1
IND,GHA,2018.0,4,0,4
LBN,BHR,2022.0,3,0,3
ZMB,NZL,2022.0,1,0,1
THA,AFG,2020.0,1,0,1
VIR,USA,2009.0,4,0,4
GMB,NOR,2021.0,2,0,2
CHE,CHL,2023.0,6,0,6
LBN,AUT,2022.0,3,0,3
ESP,KGZ,2020.0,2,0,2
IRN,AFG,2019.0,8,0,8
STP,PRT,2021.0,1,0,1
BGD,BRN,2022.0,1,0,1
AUS,CCK,2022.0,1,0,1
CHN,SYR,2021.0,1,0,1
TUR,BEN,2023.0,1,0,1
MMR,FRA,2020.0,1,0,1
,SMR,2017.0,5,0,5
,GIB,2019.0,1,0,1
,BOL,2020.0,35,0,35
IRQ,COL,2023.0,4,0,4
ARG,ZAF,2019.0,2,0,2
CUB,DOM,2021.0,3,0,3
ITA,NLD,2024.0,3,0,3
GEO,SWE,2000.0,2,0,2
GBR,GUY,2009.0,2,0,2
GUY,,2015.0,2,0,2
ARM,SWE,2008.0,1,0,1
ARM,SWE,2014.0,1,0,1
THA,ZAF,2019.0,1,0,1
MLI,BFA,2003.0,2,0,2
DEU,SLV,2014.0,1,0,1
HRV,NOR,2000.0,1,0,1
TON,FJI,2008.0,1,0,1
UKR,HUN,2003.0,2,0,2
OMN,NGA,2008.0,1,0,1
USA,MNG,2002.0,3,0,3
NGA,ISR,2007.0,1,0,1
GHA,BEL,2006.0,1,0,1
TZA,GMB,2022.0,1,0,1
VUT,PHL,2003.0,1,0,1
COG,BEL,2004.0,3,0,3
LSO,,2001.0,1,0,1
ZWE,AUT,2010.0,1,0,1
HTI,RWA,2014.0,1,0,1
IRL,CZE,2006.0,2,0,2
NOR,PHL,2002.0,1,0,1
HRV,IRL,2003.0,1,0,1
ZMB,CHE,2003.0,1,0,1
ZMB,ETH,2011.0,1,0,1
NZL,UZB,2002.0,1,0,1
LKA,NPL,2021.0,1,0,1
TTO,FRA,2007.0,1,0,1
COG,ARE,2012.0,1,0,1
ARM,BRA,2009.0,1,0,1
MNG,CAN,2002.0,1,0,1
SRB,NZL,2002.0,1,0,1
FRA,BLR,2003.0,3,0,3
SWE,AZE,2014.0,1,0,1
GBR,JAM,2017.0,2,0,2
BEL,VEN,1998.0,1,0,1
RUS,CMR,2003.0,1,0,1
MKD,,2001.0,4,0,4
FLK,,2006.0,2,0,2
TUN,SAU,2008.0,5,0,5
,GIN,2002.0,13,0,13
MDG,,2000.0,4,0,4
,WSM,2001.0,5,0,5
KEN,ISR,1997.0,1,0,1
JPN,CMR,2001.0,1,0,1
GHA,BWA,2019.0,1,0,1
ARE,ARG,2010.0,3,0,3
USA,NIC,2008.0,3,0,3
IRQ,ARE,2006.0,1,0,1
IND,BES,2020.0,2,0,2
NLD,BFA,2003.0,2,0,2
TCD,BEL,2008.0,1,0,1
UKR,ETH,2008.0,1,0,1
NOR,FRO,2000.0,1,0,1
NZL,TUR,2008.0,1,0,1
,GRL,2001.0,6,0,6
MNG,,2001.0,11,0,11
BRA,ROU,2014.0,2,0,2
CHL,AFG,2017.0,1,0,1
FIN,THA,2005.0,1,0,1
PYF,CMR,1999.0,1,0,1
CHN,QAT,2012.0,1,0,1
EST,CAN,2004.0,2,0,2
GRC,ROU,2003.0,4,0,4
NLD,GRD,2006.0,2,0,2
MAR,MYS,1999.0,1,0,1
DEU,MCO,2020.0,1,0,1
DNK,TZA,1998.0,2,0,2
PRI,BRA,1999.0,1,0,1
GTM,GBR,2009.0,1,0,1
SVK,IRL,2003.0,2,0,2
TUR,PRI,2004.0,1,0,1
USA,GNB,2005.0,1,0,1
GNB,JPN,2009.0,1,0,1
JPN,CMR,2003.0,1,0,1
OMN,KWT,2007.0,1,0,1
BWA,NZL,2009.0,1,0,1
MDG,CHL,1999.0,1,0,1
MEX,SGP,2007.0,1,0,1
IND,BEN,2004.0,1,0,1
UKR,KAZ,2008.0,1,0,1
MEX,GTM,2000.0,1,0,1
IDN,AUT,2000.0,1,0,1
QAT,PAK,2012.0,3,0,3
HKG,MAR,2003.0,1,0,1
TTO,IRL,2001.0,1,0,1
CAN,NER,2004.0,1,0,1
DNK,SDN,1997.0,1,0,1
GRC,MLT,1998.0,1,0,1
NGA,BRN,1997.0,1,0,1
SGP,AUT,2005.0,2,0,2
FRA,ARE,2007.0,3,0,3
PHL,MEX,2015.0,1,0,1
NLD,GEO,2011.0,1,0,1
LTU,GEO,2023.0,1,0,1
NLD,ALB,2019.0,1,0,1
MAC,NOR,2007.0,1,0,1
SRB,SVK,1999.0,2,0,2
KEN,FRA,2001.0,1,0,1
NOR,CZE,1999.0,1,0,1
NLD,VEN,2010.0,1,0,1
UZB,ITA,2001.0,1,0,1
MLI,CHE,2011.0,1,0,1
GRC,OMN,2015.0,1,0,1
COL,ZAF,2002.0,1,0,1
BEL,ETH,2006.0,1,0,1
VCT,USA,2005.0,1,0,1
PHL,NPL,1999.0,3,0,3
MNP,,2011.0,1,0,1
MDA,CHL,2013.0,1,0,1
DEU,SWZ,2012.0,1,0,1
ROU,SRB,2001.0,1,0,1
ZAF,ARE,2015.0,2,0,2
NCL,GBR,2004.0,1,0,1
ROU,MLT,2017.0,1,0,1
SWZ,BWA,2015.0,1,0,1
NLD,PSE,2012.0,1,0,1
DEU,OMN,2015.0,3,0,3
LTU,IND,2013.0,1,0,1
SLB,,2014.0,1,0,1
CHE,LKA,2008.0,1,0,1
,VGB,2009.0,1,0,1
PRT,VNM,2014.0,1,0,1
CAN,MLT,2016.0,1,0,1
GBR,SOM,2014.0,1,0,1
AGO,CAN,2017.0,1,0,1
NLD,BGR,2020.0,2,0,2
GLP,MTQ,2014.0,3,0,3
CUB,SWE,2014.0,1,0,1
ALB,KOR,2013.0,1,0,1
NZL,KWT,2019.0,1,0,1
MYS,BRA,2015.0,2,0,2
ZMB,DEU,2017.0,1,0,1
CAN,MNG,2018.0,1,0,1
GAB,COG,2016.0,1,0,1
GRC,ZAF,2015.0,1,0,1
PAK,LBN,2024.0,1,0,1
FLK,PRT,2022.0,1,0,1
IDN,SLE,2012.0,1,0,1
KWT,OMN,2008.0,1,0,1
ROU,HKG,2006.0,1,0,1
URY,NZL,2021.0,3,0,3
QAT,MAR,2023.0,1,0,1
AZE,AFG,2017.0,1,0,1
AFG,IRQ,2019.0,1,0,1
GEO,JPN,2010.0,2,0,2
JPN,COG,2017.0,2,0,2
IRN,NOR,2003.0,1,0,1
ARE,MRT,2020.0,1,0,1
GUF,BEL,2022.0,2,0,2
MAR,IRL,2023.0,2,0,2
DMA,REU,2015.0,1,0,1
BIH,POL,2016.0,2,0,2
DMA,SWE,2013.0,1,0,1
TGO,JPN,1997.0,1,0,1
TWN,HND,2014.0,1,0,1
DNK,KEN,1997.0,1,0,1
,EUE,2002.0,2,0,2
PHL,HKG,2002.0,1,0,1
BHR,AUT,2020.0,1,0,1
PRT,HRV,2001.0,1,0,1
TUN,CHL,2012.0,1,0,1
MEX,PRT,2008.0,2,0,2
MAR,QAT,2016.0,1,0,1
GAB,COG,2018.0,1,0,1
TUN,GUF,2017.0,1,0,1
DZA,TZA,2019.0,1,0,1
GEO,AUS,2020.0,1,0,1
IRN,QAT,2018.0,2,0,2
ERI,USA,2018.0,2,0,2
BRA,IDN,2018.0,1,0,1
POL,EST,2011.0,1,0,1
URY,CRI,2021.0,1,0,1
IND,GEO,2023.0,2,0,2
NLD,MNG,2023.0,1,0,1
KHM,GHA,2021.0,1,0,1
FJI,VUT,2022.0,1,0,1
ETH,CZE,2021.0,1,0,1
IND,BGD,2024.0,1,0,1
MAR,DZA,2013.0,5,0,5
MAR,JOR,2022.0,1,0,1
ROU,CIV,2020.0,1,0,1
PRT,TUR,2006.0,1,0,1
MSR,ESP,2008.0,1,0,1
TWN,BRN,2023.0,1,0,1
,MNP,2020.0,1,0,1
,DJI,2020.0,2,0,2
CYP,DNK,2022.0,1,0,1
CUB,NLD,2010.0,1,0,1
CAN,LAO,2012.0,1,0,1
GEO,CHE,1998.0,1,0,1
GUM,PLW,2020.0,2,0,2
BIH,BRN,2019.0,1,0,1
SAU,FRA,2024.0,1,0,1
CMR,LSO,2007.0,1,0,1
CHE,NAM,2012.0,2,0,2
CMR,TGO,2019.0,1,0,1
CHE,MAC,2022.0,2,0,2
BFA,IDN,2019.0,1,0,1
PHL,HKG,2012.0,1,0,1
BFA,TCD,2020.0,1,0,1
PAK,KWT,1997.0,2,0,2
,ATG,2016.0,2,0,2
YEM,IRQ,2017.0,1,0,1
MYS,HUN,2020.0,1,0,1
LTU,AUT,2019.0,3,0,3
SVN,IRL,2017.0,2,0,2
BDI,CAN,2019.0,1,0,1
SGP,CIV,2020.0,1,0,1
TWN,BRN,2006.0,1,0,1
CHE,NIC,2018.0,1,0,1
LTU,BLR,2002.0,1,0,1
JPN,VIR,2012.0,1,0,1
TZA,KHM,1998.0,1,0,1
CHE,NAM,1997.0,1,0,1
SWE,GTM,2009.0,1,0,1
LBN,LBR,2008.0,3,0,3
KAZ,KOR,2006.0,1,0,1
AUT,CHL,2011.0,2,0,2
ZWE,MWI,2007.0,1,0,1
BFA,CAF,2003.0,1,0,1
BGR,KWT,2012.0,1,0,1
SEN,TUN,1999.0,1,0,1
HKG,GRC,2003.0,2,0,2
BEL,COL,2004.0,1,0,1
EGY,SYR,2007.0,1,0,1
LBY,CZE,2006.0,1,0,1
HUN,EGY,2008.0,2,0,2
YEM,NZL,1998.0,1,0,1
FLK,,2009.0,1,0,1
LVA,ESP,2006.0,1,0,1
FSM,FJI,2001.0,1,0,1
BDI,,2002.0,1,0,1
SEN,TGO,2009.0,2,0,2
MUS,SRB,2005.0,1,0,1
CHE,VNM,2011.0,1,0,1
DNK,PSE,2020.0,1,0,1
ERI,NOR,2011.0,1,0,1
ARE,GRC,2013.0,3,0,3
ISR,MDA,2006.0,1,0,1
LBN,DZA,2019.0,1,0,1
KOR,SOM,2012.0,1,0,1
SVN,UKR,1997.0,2,0,2
,STP,2003.0,1,0,1
USA,STP,2021.0,1,0,1
ZMB,TZA,2011.0,1,0,1
KOR,RWA,2010.0,1,0,1
FRA,OMN,2005.0,1,0,1
SRB,POL,2018.0,3,0,3
CAN,REU,2007.0,1,0,1
BRA,BEN,2010.0,1,0,1
EST,CHE,2009.0,1,0,1
MDV,,2008.0,1,0,1
SVK,UKR,2005.0,1,0,1
,MTQ,2001.0,2,0,2
CHE,BIH,2003.0,1,0,1
BIH,CHE,2004.0,1,0,1
TZA,RWA,2008.0,1,0,1
VEN,BEL,2007.0,1,0,1
ETH,CAN,2006.0,1,0,1
RUS,YEM,2006.0,1,0,1
DNK,TZA,2007.0,1,0,1
BLR,IRL,2020.0,1,0,1
ZMB,THA,2019.0,1,0,1
ISL,ISR,2022.0,1,0,1
DEU,MLT,2016.0,1,0,1
TUN,ARE,2007.0,1,0,1
IND,SRB,2021.0,1,0,1
SLE,MWI,2006.0,1,0,1
MWI,SLE,2010.0,1,0,1
ISL,JPN,2011.0,1,0,1
AUS,LBY,2013.0,2,0,2
ROU,HRV,2019.0,1,0,1
NZL,MCO,2018.0,1,0,1
SYC,FRA,2019.0,1,0,1
MYS,UGA,2018.0,2,0,2
IRL,IDN,2018.0,1,0,1
DNK,PRI,2017.0,1,0,1
UGA,ESP,2021.0,3,0,3
IND,CAF,2020.0,1,0,1
JOR,KWT,2002.0,2,0,2
HUN,BIH,2020.0,2,0,2
LVA,CAN,2021.0,1,0,1
BMU,CAN,2015.0,2,0,2
PSE,SWE,2016.0,1,0,1
POL,EUE,2018.0,1,0,1
GBR,GAB,2007.0,2,0,2
DNK,NPL,2016.0,2,0,2
MOZ,LBR,2017.0,1,0,1
SVK,SUR,2023.0,1,0,1
JOR,BEL,2021.0,2,0,2
USA,MUS,2013.0,1,0,1
SLV,ESP,1999.0,1,0,1
FJI,DEU,2018.0,1,0,1
TUR,GUY,2019.0,1,0,1
PRI,ITA,2004.0,1,0,1
DEU,BMU,2019.0,1,0,1
IRL,BHR,2010.0,1,0,1
FRA,IRQ,2002.0,2,0,2
BHR,ESP,2020.0,1,0,1
ARG,PAK,2013.0,1,0,1
OMN,TTO,1999.0,1,0,1
MWI,GHA,2014.0,1,0,1
ITA,MAC,2023.0,1,0,1
JOR,IND,2013.0,1,0,1
TWN,IRQ,2023.0,1,0,1
AFG,SWE,2023.0,1,0,1
TWN,NPL,2020.0,3,0,3
LBN,SYR,2018.0,1,0,1
JAM,GRD,2010.0,1,0,1
CAN,GEO,1998.0,1,0,1
IND,CZE,1998.0,1,0,1
SVK,CYP,2019.0,1,0,1
IND,LKA,1997.0,1,0,1
JPN,BRN,2007.0,1,0,1
GUM,IDN,2021.0,1,0,1
PHL,MEX,2004.0,1,0,1
TJK,FRA,2008.0,1,0,1
IRL,SAU,1999.0,1,0,1
BLR,JPN,2020.0,1,0,1
LVA,KAZ,2012.0,1,0,1
KAZ,LVA,2014.0,1,0,1
SWE,BHR,2021.0,1,0,1
,SOM,2009.0,2,0,2
CZE,NZL,2012.0,1,0,1
IND,ERI,1998.0,1,0,1
SDN,QAT,2023.0,1,0,1
ISL,KEN,2021.0,1,0,1
GBR,GIN,2013.0,1,0,1
BMU,CAN,2004.0,1,0,1
JPN,JOR,2005.0,1,0,1
KOR,FJI,2016.0,1,0,1
ISR,UGA,2018.0,1,0,1
SEN,CAF,2011.0,1,0,1
SDN,KEN,2015.0,1,0,1
ZAF,LVA,2022.0,1,0,1
ZAF,MUS,2007.0,1,0,1
ERI,SWE,2001.0,1,0,1
SWE,ERI,2002.0,1,0,1
MRT,FRA,2002.0,2,0,2
AFG,GBR,2021.0,5,0,5
MEX,PRY,2010.0,2,0,2
,ABW,2012.0,6,0,6
EST,POL,2017.0,1,0,1
MLT,EUE,2018.0,1,0,1
PRY,ARG,2023.0,1,0,1
LVA,PRT,2020.0,1,0,1
ISR,BLR,2011.0,1,0,1
NPL,MYS,2015.0,1,0,1
FRA,TGO,2018.0,2,0,2
BGR,BGD,2003.0,1,0,1
MHL,,2025.0,2,0,2
HRV,PER,2021.0,1,0,1
GNQ,BRA,2017.0,1,0,1
ITA,MNE,2018.0,1,0,1
IRL,LBR,2016.0,1,0,1
CUB,GUY,2017.0,1,0,1
COL,CZE,2018.0,2,0,2
JOR,CHN,2021.0,3,0,3
IDN,BHR,2017.0,1,0,1
NGA,UGA,2024.0,1,0,1
CRI,ECU,2016.0,2,0,2
SRB,POL,2022.0,2,0,2
MYS,AUS,2024.0,1,0,1
NZL,JOR,2018.0,1,0,1
EST,HUN,2020.0,2,0,2
NLD,NPL,2018.0,2,0,2
SOM,CHN,2021.0,1,0,1
SUR,NLD,2020.0,3,0,3
ZWE,BRA,2020.0,1,0,1
COD,KEN,2022.0,1,0,1
SLE,CAN,2023.0,1,0,1
GBR,YEM,2023.0,2,0,2
URY,GTM,2022.0,1,0,1
BDI,ETH,2022.0,1,0,1
BEN,NER,2007.0,1,0,1
FRA,PSE,2006.0,1,0,1
FRA,BDI,2020.0,2,0,2
RUS,MAR,2007.0,1,0,1
CMR,BRA,2013.0,1,0,1
TUR,JOR,2013.0,1,0,1
SGP,OMN,2017.0,2,0,2
TUR,TKM,2000.0,1,0,1
GHA,SYR,2011.0,1,0,1
MDA,ISR,2017.0,1,0,1
EST,LTU,2008.0,1,0,1
PER,COG,2008.0,1,0,1
VNM,ITA,2007.0,1,0,1
ZWE,KEN,2000.0,1,0,1
YEM,PRI,2002.0,2,0,2
SWE,PHL,2003.0,1,0,1
IDN,ITA,2007.0,1,0,1
HRV,DZA,2008.0,1,0,1
LKA,ETH,2004.0,1,0,1
PSE,,2000.0,1,0,1
MHL,IND,2002.0,1,0,1
GRC,NOR,1997.0,2,0,2
HUN,BIH,2007.0,1,0,1
MLT,ITA,2012.0,1,0,1
POL,HRV,2008.0,1,0,1
CYP,FRA,2001.0,1,0,1
ZAF,VEN,2008.0,1,0,1
ZMB,NAM,2018.0,1,0,1
NOR,EST,2002.0,1,0,1
ITA,SYR,2000.0,1,0,1
FIN,BRA,2006.0,1,0,1
HKG,IDN,2008.0,1,0,1
BEL,TWN,2001.0,2,0,2
CHL,PAK,2018.0,1,0,1
CIV,GHA,2005.0,1,0,1
SGP,PRI,2007.0,1,0,1
BGR,TWN,2011.0,1,0,1
ETH,MYS,2008.0,1,0,1
TUR,LBY,2000.0,1,0,1
CHN,IRN,2003.0,1,0,1
PRT,DZA,2007.0,2,0,2
MTQ,BEL,2007.0,1,0,1
IRQ,QAT,2000.0,1,0,1
COG,ZWE,2000.0,1,0,1
ZWE,CUB,2007.0,1,0,1
WSM,,2007.0,1,0,1
SWE,GHA,2016.0,1,0,1
ZWE,NAM,1997.0,1,0,1
CZE,ZMB,1997.0,1,0,1
CHL,GTM,2018.0,2,0,2
URY,VEN,2013.0,1,0,1
FRA,AGO,2006.0,1,0,1
BHR,EGY,2011.0,1,0,1
PNG,SWZ,2002.0,1,0,1
TJK,,2002.0,1,0,1
CYP,SYR,2003.0,1,0,1
BEL,TZA,2001.0,1,0,1
JPN,SEN,2017.0,1,0,1
NAM,CAN,2017.0,1,0,1
BGR,BRA,2023.0,1,0,1
TUR,ESP,2005.0,2,0,2
GEO,PRT,2008.0,2,0,2
BRA,IDN,2016.0,2,0,2
MHL,IND,2005.0,1,0,1
NPL,NGA,2015.0,1,0,1
IRL,TZA,2007.0,1,0,1
TZA,BDI,2020.0,2,0,2
SLE,GHA,2017.0,1,0,1
TTO,BRB,2010.0,1,0,1
,DMA,2000.0,1,0,1
MNG,TUR,2023.0,1,0,1
GBR,SOM,2008.0,1,0,1
DEU,MDG,2007.0,2,0,2
DEU,BTN,2013.0,1,0,1
JOR,POL,2007.0,1,0,1
DOM,,2000.0,2,0,2
MYS,BIH,2012.0,1,0,1
MSR,,2017.0,1,0,1
NLD,CYP,2012.0,1,0,1
TJK,TUR,2013.0,1,0,1
GIN,DNK,2021.0,1,0,1
CHE,KEN,2000.0,1,0,1
NLD,UZB,2010.0,1,0,1
MNE,ALB,2020.0,1,0,1
NZL,MWI,2012.0,2,0,2
BFA,UGA,2018.0,1,0,1
BRB,CHN,2015.0,1,0,1
EGY,THA,2013.0,1,0,1
TTO,GRD,2023.0,1,0,1
LTU,NOR,2016.0,1,0,1
CHN,LUX,2020.0,1,0,1
MKD,POL,2019.0,2,0,2
CAN,SWZ,2019.0,1,0,1
LAO,KHM,2012.0,1,0,1
CHN,GIB,2023.0,2,0,2
AZE,GBR,2022.0,2,0,2
KOR,SVK,2019.0,1,0,1
MOZ,ITA,2018.0,3,0,3
MWI,BRA,2019.0,1,0,1
MYS,SOM,2020.0,1,0,1
CYP,ARE,2021.0,1,0,1
ROU,PAK,2015.0,1,0,1
USA,NER,2022.0,1,0,1
UKR,SGP,1999.0,2,0,2
SOM,,1999.0,1,0,1
COL,MMR,2018.0,1,0,1
SAU,BEL,2001.0,1,0,1
HUN,ZAF,2016.0,1,0,1
AUT,MYS,1999.0,1,0,1
JPN,LBN,1999.0,1,0,1
MWI,VNM,1999.0,1,0,1
CHE,PER,2005.0,1,0,1
SWE,CRI,2002.0,4,0,4
ITA,GLP,2006.0,1,0,1
JPN,MAR,2001.0,1,0,1
HUN,CHL,1997.0,1,0,1
PRT,PHL,2010.0,1,0,1
QAT,CHE,2009.0,1,0,1
BEL,RUS,2024.0,1,0,1
SVK,HUN,2002.0,4,0,4
GBR,FLK,2003.0,1,0,1
CHE,PAN,2004.0,1,0,1
SDN,TWN,2013.0,1,0,1
THA,IRN,2007.0,1,0,1
ISL,ITA,2008.0,1,0,1
BRA,ETH,2007.0,1,0,1
MLT,NLD,2011.0,1,0,1
ZWE,MEX,2010.0,1,0,1
NOR,ARE,2010.0,1,0,1
IRL,CYP,2014.0,1,0,1
PAK,JOR,2011.0,1,0,1
THA,MWI,2012.0,1,0,1
JPN,NIC,2016.0,2,0,2
ETH,BFA,2011.0,1,0,1
BRA,MLT,2022.0,1,0,1
KHM,NZL,2000.0,1,0,1
SWE,BOL,2009.0,2,0,2
AUT,KNA,2018.0,1,0,1
TUR,JAM,2018.0,1,0,1
CHE,HTI,2009.0,1,0,1
VCT,,2020.0,1,0,1
PRT,BHR,2015.0,1,0,1
ISR,SRB,2001.0,2,0,2
SLB,AUS,2011.0,2,0,2
PER,KEN,2003.0,2,0,2
MLI,NLD,2010.0,1,0,1
NLD,VNM,1997.0,2,0,2
TUR,SEN,2016.0,1,0,1
GRC,IDN,2003.0,1,0,1
GTM,CZE,2023.0,2,0,2
LTU,IRL,2017.0,1,0,1
TUR,KAZ,2004.0,1,0,1
COL,ARM,2007.0,1,0,1
ESP,CYP,2018.0,1,0,1
TWN,QAT,2018.0,1,0,1
USA,SMR,2020.0,1,0,1
ISR,NPL,2017.0,1,0,1
PRY,DOM,2019.0,1,0,1
SAU,COG,2020.0,1,0,1
ITA,SVK,2016.0,2,0,2
SVK,BLR,2003.0,1,0,1
PRY,PAN,2020.0,1,0,1
SVN,IRL,2022.0,1,0,1
GIB,ESP,2023.0,2,0,2
UGA,GAB,2012.0,1,0,1
BRA,STP,2019.0,1,0,1
CZE,LBN,2017.0,1,0,1
IND,CIV,2021.0,1,0,1
MYS,VNM,2004.0,1,0,1
LSO,ITA,2016.0,1,0,1
SLE,GHA,2018.0,1,0,1
GHA,SLE,2020.0,1,0,1
SYC,AUS,2009.0,1,0,1
UZB,MYS,2006.0,2,0,2
FRA,JAM,2009.0,1,0,1
GLP,MLI,2010.0,1,0,1
MLI,CMR,2009.0,2,0,2
DEU,TLS,2011.0,1,0,1
TLS,IDN,2015.0,1,0,1
ETH,SEN,2017.0,1,0,1
TZA,ESP,2001.0,1,0,1
URY,DNK,2016.0,2,0,2
DNK,URY,2017.0,2,0,2
ARM,GRC,2007.0,1,0,1
USA,LIE,2010.0,1,0,1
CIV,IND,2005.0,1,0,1
ETH,PAK,2014.0,1,0,1
ARG,NZL,2019.0,2,0,2
ZAF,OMN,2004.0,1,0,1
HKG,ITA,2003.0,1,0,1
NLD,BRN,2013.0,1,0,1
KHM,CHE,2003.0,1,0,1
MAC,,1999.0,1,0,1
PYF,JPN,2000.0,1,0,1
ECU,FIN,2016.0,1,0,1
GMB,KEN,2011.0,1,0,1
DEU,ZWE,2007.0,1,0,1
SYR,DEU,2022.0,2,0,2
CUB,PRT,2012.0,1,0,1
CPV,USA,2007.0,1,0,1
DNK,QAT,2017.0,1,0,1
NPL,BEL,2021.0,1,0,1
PSE,PAN,2023.0,1,0,1
IRQ,UZB,2021.0,1,0,1
EST,ARE,2022.0,1,0,1
EST,MDA,2019.0,1,0,1
DOM,DNK,2022.0,1,0,1
CAN,UGA,2011.0,2,0,2
BEL,KHM,2018.0,2,0,2
DNK,BGD,2015.0,1,0,1
ZWE,CIV,2022.0,1,0,1
TZA,CHN,2024.0,1,0,1
CRI,SLV,2019.0,1,0,1
MKD,CAN,2019.0,1,0,1
PRY,GBR,2020.0,1,0,1
EST,KAZ,1997.0,2,0,2
EST,KAZ,2005.0,2,0,2
MAR,MRT,2023.0,1,0,1
SVN,MKD,2023.0,1,0,1
TUR,BRN,2022.0,1,0,1
PRT,HKG,2019.0,1,0,1
BIH,KWT,2020.0,1,0,1
COM,FRA,2023.0,1,0,1
YEM,JOR,2023.0,1,0,1
ESP,BEN,2023.0,1,0,1
NLD,ABW,2023.0,1,0,1
KOR,OMN,2014.0,3,0,3
GRC,SWE,2024.0,1,0,1
IND,MWI,2013.0,1,0,1
PRT,TWN,2006.0,1,0,1
TZA,ISR,2006.0,1,0,1
IRN,LBN,2011.0,2,0,2
NGA,THA,2008.0,1,0,1
AUS,TLS,2012.0,1,0,1
GBR,SWZ,2008.0,1,0,1
SWE,MWI,2012.0,1,0,1
POL,VNM,2011.0,1,0,1
IRL,KAZ,2014.0,1,0,1
IRL,UKR,2019.0,1,0,1
BMU,,2009.0,2,0,2
JAM,KAZ,2008.0,1,0,1
URY,ITA,2009.0,1,0,1
PRY,ARG,2010.0,1,0,1
AUS,COD,2022.0,1,0,1
UGA,PAK,2017.0,1,0,1
SVK,THA,2015.0,1,0,1
SVN,ROU,2015.0,1,0,1
UGA,FRA,2015.0,1,0,1
UKR,ISL,2021.0,2,0,2
POL,HRV,2015.0,2,0,2
JPN,KAZ,2013.0,1,0,1
ISL,NZL,2015.0,1,0,1
SYR,LKA,2012.0,1,0,1
PRT,COL,2015.0,2,0,2
CUB,VNM,2014.0,2,0,2
ITA,SLV,2014.0,1,0,1
ESP,SLV,2022.0,1,0,1
ZMB,CAN,2017.0,1,0,1
CZE,MKD,2019.0,1,0,1
SLE,SDN,2019.0,1,0,1
MWI,THA,2019.0,1,0,1
MDA,BEL,2018.0,1,0,1
CMR,PRT,2020.0,1,0,1
ALB,KWT,2022.0,1,0,1
CYP,DNK,2016.0,1,0,1
ARE,ARG,2021.0,1,0,1
FJI,THA,2005.0,1,0,1
PRY,CAN,2020.0,1,0,1
SAU,COL,2013.0,1,0,1
TGO,CHE,2016.0,1,0,1
URY,DEU,2007.0,2,0,2
CIV,CHN,2022.0,1,0,1
BGD,SVN,2021.0,1,0,1
NLD,MOZ,2023.0,1,0,1
SWZ,FRA,2022.0,1,0,1
VNM,BGD,2022.0,1,0,1
BOL,ECU,1997.0,1,0,1
BGR,CHL,2003.0,1,0,1
KAZ,CYP,2018.0,1,0,1
DEU,JAM,2017.0,1,0,1
CMR,NLD,2017.0,2,0,2
NLD,GHA,1997.0,2,0,2
FLK,GBR,2004.0,1,0,1
KWT,KAZ,2018.0,1,0,1
AUS,CHL,1999.0,2,0,2
FLK,DEU,2011.0,1,0,1
ITA,PSE,2005.0,1,0,1
PSE,ITA,2007.0,1,0,1
MLT,MKD,2003.0,1,0,1
FLK,CHL,2006.0,1,0,1
BEL,VEN,1997.0,1,0,1
OMN,FJI,2004.0,1,0,1
KOR,ZAF,2000.0,1,0,1
IRN,ARE,2007.0,1,0,1
CAN,ZWE,2004.0,1,0,1
IDN,EGY,2009.0,1,0,1
BEL,PRY,2006.0,1,0,1
CHE,EGY,1997.0,2,0,2
RUS,ISL,2001.0,1,0,1
ISL,RUS,2003.0,2,0,2
SVN,SWE,2004.0,2,0,2
DNK,BOL,2006.0,1,0,1
CAN,SUR,2009.0,1,0,1
FLK,RUS,2002.0,1,0,1
MAR,CHL,1999.0,1,0,1
AUT,ARG,2023.0,1,0,1
KEN,LSO,2014.0,1,0,1
PAK,LBY,2000.0,1,0,1
LBY,MYS,2001.0,1,0,1
NER,BFA,2010.0,1,0,1
ISR,THA,2010.0,1,0,1
COG,CHE,2011.0,1,0,1
GEO,BRA,2019.0,1,0,1
IRL,SRB,2017.0,1,0,1
URY,SRB,2020.0,1,0,1
FIN,UGA,2014.0,1,0,1
COG,BFA,2014.0,1,0,1
MDA,CHE,2018.0,1,0,1
VIR,PRI,2016.0,1,0,1
,GNB,2020.0,2,0,2
CYP,QAT,2016.0,1,0,1
QAT,CYP,2021.0,3,0,3
SGP,ISL,2017.0,2,0,2
MDG,MLT,2016.0,1,0,1
EGY,CMR,2019.0,1,0,1
AUT,VUT,2015.0,1,0,1
SRB,NZL,1998.0,1,0,1
IRN,ECU,2022.0,1,0,1
OMN,SGP,2003.0,1,0,1
CHN,ZMB,2004.0,1,0,1
IDN,NGA,2016.0,1,0,1
PRI,ISR,2023.0,1,0,1
NGA,MDG,2018.0,1,0,1
SWZ,BWA,2014.0,1,0,1
UZB,FJI,2021.0,1,0,1
KGZ,CHE,2021.0,1,0,1
ARE,ECU,2023.0,1,0,1
SDN,IND,2022.0,1,0,1
SAU,MAC,2023.0,1,0,1
ROU,BRN,2021.0,1,0,1
SGP,MAC,2023.0,1,0,1
HUN,PAN,2021.0,1,0,1
GRD,GBR,2004.0,1,0,1
ITA,MDV,2017.0,1,0,1
BRN,NZL,2022.0,1,0,1
ZWE,TZA,2012.0,2,0,2
EST,DNK,1999.0,1,0,1
,COM,1994.0,1,0,1
BTN,USA,2023.0,2,0,2
DEU,GRD,2001.0,1,0,1
LAO,AUS,2008.0,1,0,1
GMB,AUS,2008.0,1,0,1
PNG,SLB,2005.0,1,0,1
FRA,TCD,2005.0,1,0,1
LTU,SVN,2017.0,1,0,1
ETH,MEX,2021.0,1,0,1
BRN,CHE,2007.0,1,0,1
USA,YEM,2013.0,2,0,2
SWE,QAT,2007.0,1,0,1
ZWE,ETH,2013.0,1,0,1
CHL,THA,2022.0,1,0,1
PYF,NCL,2014.0,1,0,1
YEM,SAU,2005.0,1,0,1
LUX,GRC,2007.0,1,0,1
MHL,NZL,2013.0,1,0,1
BRA,GTM,2002.0,1,0,1
DNK,EST,2000.0,1,0,1
TUN,BGR,2016.0,1,0,1
LUX,BFA,2016.0,1,0,1
BFA,LUX,2017.0,1,0,1
EGY,BGD,2008.0,1,0,1
GRC,GEO,2018.0,1,0,1
GEO,GRC,2019.0,1,0,1
ERI,AUS,2022.0,1,0,1
DNK,KHM,2021.0,1,0,1
BWA,CMR,2007.0,1,0,1
MDG,BEL,2019.0,1,0,1
NAM,JPN,2010.0,1,0,1
LAO,CAN,2021.0,3,0,3
PHL,IRN,2020.0,1,0,1
BLR,LVA,2020.0,1,0,1
PER,GBR,1998.0,1,0,1
BLR,MYS,2023.0,1,0,1
SVK,KAZ,2022.0,1,0,1
TZA,NZL,2019.0,1,0,1
MKD,SVN,2022.0,2,0,2
UKR,CYP,2023.0,1,0,1
ZMB,,2026.0,2,0,2
JOR,CHE,2011.0,1,0,1
TTO,SWE,2014.0,1,0,1
SWE,TTO,2016.0,1,0,1
ESP,MCO,2005.0,1,0,1
PRI,PRT,1999.0,1,0,1
BHR,USA,1997.0,2,0,2
ESP,HND,2006.0,1,0,1
ROU,ZAF,2000.0,1,0,1
THA,RWA,2020.0,1,0,1
IND,UGA,2013.0,1,0,1
UGA,IND,2017.0,1,0,1
MAR,DEU,2002.0,2,0,2
CHL,TUR,2003.0,1,0,1
POL,SRB,2019.0,1,0,1
HND,CHE,2000.0,1,0,1
MMR,AUS,2011.0,1,0,1
ZAF,TWN,2007.0,2,0,2
OMN,GUM,2010.0,1,0,1
BGR,FIN,2003.0,1,0,1
CHN,AZE,2016.0,1,0,1
POL,NAM,2022.0,1,0,1
NZL,HUN,2004.0,1,0,1
ITA,WSM,1997.0,4,0,4
WSM,,1999.0,3,0,3
OMN,PRI,2004.0,1,0,1
ROU,SVN,2004.0,1,0,1
MYS,CYM,2004.0,1,0,1
UGA,RWA,2012.0,2,0,2
MLT,BEL,2011.0,1,0,1
TTO,ESP,2013.0,1,0,1
ARG,GRC,2014.0,2,0,2
ESP,SLE,2019.0,1,0,1
AUS,CYP,2007.0,2,0,2
LAO,SGP,2017.0,1,0,1
SVK,EUE,2020.0,1,0,1
LBN,SVN,2023.0,1,0,1
NZL,NGA,2012.0,1,0,1
AUS,LAO,2014.0,2,0,2
LVA,ISR,2015.0,1,0,1
ESP,IRQ,2023.0,1,0,1
FJI,NCL,2016.0,1,0,1
IDN,GHA,2016.0,1,0,1
DNK,BFA,2012.0,2,0,2
NGA,AUS,1997.0,2,0,2
FIN,SDN,2016.0,1,0,1
SWZ,FRA,2016.0,1,0,1
CZE,TUR,2000.0,2,0,2
FIN,ISR,1999.0,1,0,1
IDN,MDG,2019.0,1,0,1
KWT,JPN,2023.0,1,0,1
BLR,NZL,2021.0,1,0,1
UKR,TWN,2018.0,1,0,1
POL,GHA,2018.0,1,0,1
KAZ,EST,2015.0,2,0,2
NZL,PAN,2014.0,1,0,1
MDG,KHM,2007.0,1,0,1
DNK,HKG,1998.0,1,0,1
NOR,ARE,2000.0,1,0,1
CAN,MLT,2018.0,2,0,2
TUR,BHR,2002.0,2,0,2
MLI,ZAF,2020.0,1,0,1
MYS,SRB,2005.0,1,0,1
SRB,MYS,2008.0,1,0,1
PRT,SGP,2001.0,1,0,1
VNM,PER,2008.0,1,0,1
YEM,ARE,2022.0,1,0,1
CRI,IRL,2021.0,1,0,1
USA,ISL,2024.0,1,0,1
BRN,CAN,2021.0,1,0,1
URY,MEX,2023.0,1,0,1
LBY,PAK,2018.0,1,0,1
ESP,MAC,2016.0,1,0,1
AUS,SRB,2023.0,2,0,2
CHE,FJI,2008.0,1,0,1
EGY,AUS,2003.0,1,0,1
IND,AIA,2012.0,1,0,1
KHM,MOZ,2020.0,1,0,1
NZL,PHL,2003.0,1,0,1
PRI,MSR,2000.0,1,0,1
MSR,,2018.0,1,0,1
BMU,GBR,2004.0,1,0,1
ESP,MOZ,1999.0,1,0,1
ZWE,DNK,1999.0,1,0,1
USA,LUX,2003.0,2,0,2
KHM,JPN,2003.0,1,0,1
GBR,MSR,2013.0,1,0,1
MSR,JAM,2014.0,1,0,1
SUR,GBR,2012.0,1,0,1
ARM,MYS,2018.0,1,0,1
TUR,KGZ,2010.0,1,0,1
PER,FIN,2017.0,1,0,1
LBN,PRT,2015.0,1,0,1
BLR,SGP,2017.0,1,0,1
MAR,COM,2021.0,1,0,1
BTN,CHE,2020.0,1,0,1
SVN,ARE,2018.0,1,0,1
ESP,NGA,2018.0,1,0,1
UGA,NOR,2023.0,2,0,2
CIV,KNA,2018.0,1,0,1
MNE,ITA,2006.0,1,0,1
KEN,KGZ,2013.0,1,0,1
COL,ISR,2014.0,2,0,2
KHM,,2004.0,1,0,1
IRN,NZL,2010.0,2,0,2
GUY,CUB,2019.0,2,0,2
CUB,PRI,2015.0,1,0,1
LKA,PAK,2012.0,1,0,1
AIA,USA,2020.0,1,0,1
PYF,GBR,2021.0,1,0,1
HUN,MNE,2022.0,1,0,1
IRN,SDN,2021.0,1,0,1
OMN,HRV,2023.0,1,0,1
IRQ,NOR,2020.0,1,0,1
MWI,IRL,2023.0,1,0,1
,ISL,2021.0,1,0,1
NZL,EGY,2023.0,1,0,1
ESP,PRI,2023.0,1,0,1
BRA,CPV,2007.0,1,0,1
UZB,BRA,2018.0,1,0,1
JAM,BHS,2012.0,1,0,1
SWE,DZA,2010.0,1,0,1
COG,CHE,2009.0,1,0,1
SWE,LKA,2011.0,1,0,1
BRA,PRI,2022.0,1,0,1
GNQ,NGA,2018.0,1,0,1
ZAF,PRT,2007.0,1,0,1
GUY,CIV,2000.0,1,0,1
HKG,UKR,2011.0,1,0,1
IRN,CYP,2000.0,1,0,1
PSE,NOR,2003.0,1,0,1
KAZ,FRA,2003.0,1,0,1
SWZ,SAU,2001.0,1,0,1
AUS,NGA,2003.0,3,0,3
CAN,TZA,2003.0,1,0,1
BRN,LKA,2011.0,1,0,1
COG,,1999.0,1,0,1
GEO,JPN,2000.0,2,0,2
CAN,ZMB,2008.0,2,0,2
MNP,,2009.0,1,0,1
MDA,KGZ,2017.0,1,0,1
AUS,NCL,1999.0,2,0,2
MDG,NER,2010.0,1,0,1
GNB,GIN,2006.0,1,0,1
LBN,DNK,2009.0,1,0,1
GBR,DOM,2004.0,1,0,1
PHL,BRA,2001.0,1,0,1
ISR,BGR,2003.0,2,0,2
AGO,VEN,2006.0,1,0,1
LAO,,2001.0,1,0,1
PRT,PSE,2007.0,1,0,1
POL,JOR,2012.0,1,0,1
SWE,JOR,2008.0,1,0,1
SGP,SRB,2008.0,1,0,1
CAN,LCA,2005.0,1,0,1
BHR,IRL,2008.0,1,0,1
ITA,BGD,2006.0,1,0,1
KHM,AUS,2007.0,2,0,2
HRV,CHN,2015.0,1,0,1
ALB,DEU,2000.0,1,0,1
BFA,CHE,2005.0,1,0,1
SEN,ZAF,2012.0,1,0,1
LTU,NZL,2008.0,1,0,1
DEU,FJI,2015.0,2,0,2
UZB,AUT,2012.0,1,0,1
SGP,ROU,2018.0,1,0,1
DNK,BGR,2010.0,1,0,1
LCA,TTO,2009.0,1,0,1
PRT,SEN,2017.0,1,0,1
SEN,PRT,2019.0,1,0,1
IND,UZB,2006.0,1,0,1
GIN,RUS,2005.0,1,0,1
SVK,NOR,2001.0,2,0,2
CMR,MYS,2012.0,1,0,1
PSE,PAN,2006.0,1,0,1
TUN,UZB,2015.0,1,0,1
MAR,RUS,2003.0,1,0,1
CUB,CZE,2009.0,1,0,1
SWZ,CMR,2012.0,1,0,1
USA,SMR,1999.0,1,0,1
GHA,NOR,2002.0,1,0,1
COG,NLD,2014.0,1,0,1
IRL,NPL,2007.0,1,0,1
GNQ,FRA,2011.0,1,0,1
URY,CHL,2006.0,4,0,4
VIR,USA,2024.0,1,0,1
GUF,,2013.0,4,0,4
ATG,IND,2021.0,1,0,1
CYM,CAN,2017.0,1,0,1
RWA,SEN,2015.0,1,0,1
GUF,PYF,2010.0,1,0,1
OMN,PRT,2009.0,1,0,1
BHS,TCA,2016.0,1,0,1
BWA,ARE,2013.0,1,0,1
ARE,BWA,2014.0,1,0,1
FIN,MAR,2014.0,1,0,1
DEU,MMR,2014.0,1,0,1
TJK,CHE,2021.0,1,0,1
KWT,GRC,2013.0,1,0,1
SOM,JPN,2020.0,1,0,1
LSO,FRA,2022.0,1,0,1
THA,CZE,2005.0,2,0,2
QAT,GHA,2020.0,1,0,1
ROU,CYP,2018.0,2,0,2
PSE,IND,2022.0,1,0,1
MDG,ITA,2017.0,1,0,1
SSD,COG,2018.0,1,0,1
IRN,THA,2009.0,1,0,1
COL,URY,2016.0,1,0,1
PRT,BRN,2016.0,1,0,1
DOM,GBR,2015.0,1,0,1
KHM,MYS,2021.0,1,0,1
MYS,MUS,2020.0,1,0,1
HTI,ITA,2020.0,1,0,1
ECU,MEX,2005.0,2,0,2
AFG,TUR,2023.0,1,0,1
CAF,CIV,1999.0,1,0,1
MUS,COM,2021.0,1,0,1
ECU,PHL,2020.0,1,0,1
SEN,NGA,2023.0,1,0,1
ETH,ARE,2022.0,2,0,2
IRL,ARE,2011.0,1,0,1
SVN,KOR,1999.0,1,0,1
BRN,VNM,2023.0,1,0,1
EGY,COL,2022.0,1,0,1
POL,EGY,2010.0,1,0,1
POL,ROU,2008.0,1,0,1
SWE,SEN,2018.0,1,0,1
SEN,THA,2007.0,1,0,1
IRQ,CZE,2016.0,1,0,1
BRA,GUY,1999.0,1,0,1
DEU,LAO,2005.0,1,0,1
CIV,RWA,2004.0,1,0,1
IDN,SWE,1999.0,1,0,1
MRT,FRA,1997.0,2,0,2
PNG,FJI,2010.0,1,0,1
BEL,UZB,2008.0,1,0,1
BLR,UKR,2012.0,1,0,1
FRA,GHA,2007.0,1,0,1
ISR,CYP,2001.0,1,0,1
BRB,USA,1998.0,1,0,1
IRN,OMN,2012.0,1,0,1
PER,VEN,1999.0,1,0,1
ISR,QAT,2004.0,1,0,1
IRN,SYR,2009.0,1,0,1
SAU,MEX,2003.0,1,0,1
SRB,ZAF,2003.0,2,0,2
CAN,NAM,1999.0,1,0,1
IRL,DZA,2006.0,2,0,2
COL,NLD,2000.0,2,0,2
MDV,CAN,2002.0,1,0,1
MYS,BHR,2005.0,1,0,1
MSR,IND,2013.0,1,0,1
MAC,ITA,2012.0,1,0,1
BRA,ARE,2006.0,1,0,1
MDG,BEL,2011.0,1,0,1
NLD,MAC,2008.0,1,0,1
EST,NLD,2010.0,1,0,1
CAN,GIN,2015.0,1,0,1
ITA,BEN,2020.0,2,0,2
BOL,VEN,2009.0,2,0,2
CMR,ZWE,2015.0,1,0,1
CUB,GLP,2005.0,1,0,1
GLP,CUB,2006.0,1,0,1
ROU,JOR,2010.0,1,0,1
VEN,NLD,2007.0,1,0,1
IND,TUN,2007.0,1,0,1
ITA,LVA,2013.0,1,0,1
ALB,CAN,2018.0,1,0,1
MAC,SAU,2022.0,1,0,1
LVA,FRA,2020.0,1,0,1
,ERI,2010.0,1,0,1
TWN,PAN,2021.0,1,0,1
YEM,IRQ,2016.0,1,0,1
DNK,BMU,2020.0,1,0,1
HUN,MYS,2014.0,1,0,1
MOZ,SWE,2001.0,1,0,1
LTU,KAZ,2013.0,1,0,1
TUR,SVK,2017.0,1,0,1
,MRT,2003.0,3,0,3
NIC,BEL,2019.0,2,0,2
USA,MCO,2017.0,1,0,1
MDV,AUS,2011.0,1,0,1
SGP,SVN,2020.0,1,0,1
KEN,CIV,2019.0,1,0,1
OMN,LBN,2016.0,1,0,1
NGA,SDN,2019.0,1,0,1
CZE,LUX,2015.0,1,0,1
KEN,DJI,2019.0,1,0,1
MAC,GUM,2016.0,1,0,1
THA,POL,2019.0,3,0,3
ECU,AUT,2015.0,1,0,1
SGP,BRA,2001.0,1,0,1
SYR,SAU,2011.0,1,0,1
PRT,THA,1998.0,1,0,1
GIN,CHN,2022.0,1,0,1
KEN,COG,2015.0,1,0,1
DEU,SLE,2007.0,1,0,1
KEN,ARE,2003.0,1,0,1
THA,NOR,2004.0,1,0,1
BEL,MWI,2011.0,1,0,1
CHE,PRY,2014.0,1,0,1
GTM,FRA,2008.0,1,0,1
EST,TUR,2009.0,1,0,1
THA,ARE,2017.0,1,0,1
GMB,SWZ,2016.0,1,0,1
SEN,GBR,2002.0,1,0,1
NGA,CIV,2005.0,1,0,1
LSO,,2003.0,1,0,1
SUR,NLD,2007.0,1,0,1
PRI,MEX,2014.0,1,0,1
USA,QAT,1997.0,1,0,1
CMR,IND,2010.0,1,0,1
KEN,TUR,2002.0,1,0,1
GBR,TKM,2011.0,1,0,1
FIN,ARG,2014.0,1,0,1
JPN,SVN,2009.0,1,0,1
ZAF,BHR,2017.0,1,0,1
LAO,FRA,2023.0,2,0,2
RWA,CHE,2010.0,1,0,1
MKD,POL,2021.0,1,0,1
SWE,IDN,2013.0,2,0,2
BRA,TUR,2013.0,2,0,2
RWA,COM,2015.0,1,0,1
MLI,DEU,2014.0,1,0,1
CCK,NZL,2022.0,1,0,1
SRB,MYS,2015.0,1,0,1
QAT,NOR,2012.0,1,0,1
BEL,ALB,2016.0,1,0,1
CZE,NPL,2013.0,1,0,1
ESP,LVA,2002.0,1,0,1
CHE,DJI,2020.0,1,0,1
RUS,MAR,2020.0,1,0,1
BGD,JOR,2023.0,1,0,1
CMR,ESP,2016.0,1,0,1
,GUM,2004.0,2,0,2
SSD,BEL,2023.0,1,0,1
PAK,NPL,2012.0,1,0,1
YEM,EGY,2024.0,1,0,1
CHE,MMR,2015.0,2,0,2
MYS,NPL,2023.0,1,0,1
BGR,BRA,2000.0,1,0,1
NLD,MLT,2006.0,1,0,1
UZB,ITA,2004.0,1,0,1
GMB,MLI,2011.0,2,0,2
SAU,ARG,1998.0,1,0,1
ZAF,HUN,2009.0,1,0,1
CUB,BOL,2000.0,1,0,1
,SOM,1994.0,1,0,1
COM,USA,2001.0,1,0,1
FJI,IRL,2023.0,1,0,1
PAK,LUX,2022.0,1,0,1
ISR,ROU,2022.0,1,0,1
EGY,SVN,2014.0,1,0,1
SVN,EGY,2018.0,1,0,1
CAN,JAM,2023.0,1,0,1
VNM,TCA,2023.0,1,0,1
AUT,GTM,2022.0,1,0,1
RUS,BGD,2015.0,1,0,1
KOR,SWZ,2023.0,1,0,1
GNB,GIN,2023.0,1,0,1
IRN,NPL,2022.0,1,0,1
,QAT,2021.0,3,0,3
FIN,GRC,2003.0,1,0,1
VEN,UKR,1997.0,1,0,1
BEN,IND,2006.0,1,0,1
ROU,ISR,2000.0,1,0,1
TWN,UKR,1998.0,1,0,1
EGY,BRA,2000.0,1,0,1
ISL,CAN,2012.0,2,0,2
PNG,NGA,2016.0,1,0,1
NGA,CAN,2001.0,3,0,3
FRA,PAN,2008.0,1,0,1
HUN,SGP,2002.0,1,0,1
COG,CAN,1997.0,1,0,1
CAN,GAB,2019.0,1,0,1
CHE,MDA,2007.0,2,0,2
CHE,KHM,2005.0,1,0,1
TZA,ZAF,2004.0,3,0,3
YEM,ESP,2001.0,1,0,1
MNE,DEU,2007.0,1,0,1
NLD,KEN,1997.0,1,0,1
KHM,SGP,2005.0,1,0,1
USA,LSO,2010.0,1,0,1
BTN,GBR,2001.0,1,0,1
ITA,VAT,2021.0,1,0,1
NGA,FIN,2018.0,3,1,2
CZE,JPN,2006.0,6,7,-1
JPN,CZE,2008.0,5,8,-3
HKG,MAC,2010.0,6,2,4
IDN,FRA,2009.0,2,8,-6
SRB,FRA,2010.0,3,3,0
TUR,TUN,2010.0,3,2,1
ITA,JOR,2003.0,2,2,0
GBR,ZMB,2009.0,3,3,0
ISR,DNK,2010.0,2,3,-1
IRL,SGP,2009.0,4,1,3
CZE,MDA,2020.0,1,1,0
ZAF,CMR,2014.0,5,3,2
BEL,POL,2007.0,8,7,1
SRB,ESP,2001.0,6,3,3
BWA,ZAF,1999.0,2,1,1
GMB,USA,2018.0,6,2,4
MNG,DEU,2006.0,2,1,1
KEN,BEL,2012.0,1,1,0
UGA,BEL,2016.0,2,6,-4
UGA,BEL,2018.0,2,9,-7
UKR,SVK,2016.0,4,2,2
PLW,USA,2005.0,1,1,0
DNK,VNM,2011.0,1,2,-1
AUT,IRN,2011.0,4,9,-5
CAN,ARE,2007.0,10,7,3
CZE,AUS,2008.0,6,5,1
GBR,SVN,2004.0,4,3,1
TUN,ITA,2017.0,8,6,2
CUB,BRA,2022.0,3,2,1
LKA,DEU,2007.0,1,2,-1
AUT,JPN,2006.0,6,8,-2
SAU,BGD,2017.0,5,3,2
PHL,CAN,2009.0,2,1,1
TUR,SWE,2013.0,11,8,3
CHL,NZL,2004.0,3,1,2
FIN,ETH,2017.0,3,2,1
CHN,NOR,2001.0,4,6,-2
NCL,USA,2012.0,5,1,4
VNM,CHE,2005.0,1,2,-1
ZAF,DNK,2008.0,4,1,3
FRA,MWI,2019.0,1,2,-1
IRN,PAK,2017.0,2,2,0
CHE,NZL,2015.0,8,9,-1
SRB,SVN,2017.0,3,6,-3
MEX,UKR,2014.0,1,1,0
PAK,ESP,2014.0,3,3,0
SRB,CHN,2014.0,1,1,0
HRV,CZE,2006.0,1,2,-1
GRC,JPN,2019.0,2,3,-1
NGA,BRA,2006.0,1,1,0
FRA,MAC,2020.0,3,1,2
LKA,OMN,2012.0,1,1,0
ISR,SWE,2012.0,5,4,1
CMR,JPN,2019.0,3,1,2
RUS,GRC,2013.0,2,1,1
CAN,ECU,2011.0,2,2,0
ECU,BRA,2013.0,2,8,-6
HKG,DNK,2015.0,2,2,0
RUS,NZL,2022.0,4,3,1
BWA,ZAF,2007.0,8,5,3
PHL,FRA,2003.0,2,1,1
FRA,PHL,2010.0,2,3,-1
PHL,FRA,2013.0,3,1,2
NOR,GHA,2018.0,4,3,1
IDN,ARE,2021.0,1,1,0
ISL,USA,2017.0,6,15,-9
NIC,COL,2010.0,1,1,0
ITA,CHL,2006.0,11,3,8
FRA,ETH,2008.0,2,2,0
BFA,GHA,2016.0,3,3,0
TUR,QAT,2018.0,7,3,4
USA,TGO,2019.0,2,1,1
SWE,MYS,2021.0,4,10,-6
ISR,POL,2014.0,3,1,2
NOR,ARE,2019.0,1,3,-2
VNM,NOR,2017.0,1,2,-1
HUN,ROU,2016.0,8,14,-6
UGA,COG,2023.0,3,1,2
BRN,DEU,2012.0,1,1,0
ROU,ESP,2011.0,7,5,2
AUS,ECU,2011.0,1,2,-1
SVN,IND,2013.0,2,3,-1
BLR,POL,2017.0,3,2,1
VEN,CHE,2012.0,2,2,0
FRA,GHA,2012.0,3,1,2
ZAF,CHN,2012.0,4,3,1
SLE,USA,2023.0,1,1,0
ZAF,ZWE,2007.0,3,19,-16
NOR,POL,2016.0,7,12,-5
AUS,OMN,2015.0,5,6,-1
LSO,ZAF,2020.0,3,8,-5
DZA,MAR,2023.0,2,1,1
CHL,PRY,2020.0,2,1,1
LKA,THA,2020.0,2,5,-3
JPN,TUN,2019.0,1,2,-1
JPN,PRT,2008.0,2,2,0
TWN,CHE,2010.0,6,7,-1
CRI,BRA,2017.0,5,1,4
CRI,BRA,2022.0,1,6,-5
HRV,DNK,2017.0,3,1,2
USA,KGZ,2012.0,2,2,0
AUS,LTU,2023.0,1,2,-1
SGP,LUX,2017.0,5,1,4
CHN,ISR,2014.0,12,11,1
ARG,DZA,2011.0,3,2,1
NOR,FIN,2010.0,6,13,-7
BFA,CIV,2014.0,2,1,1
CHE,THA,2010.0,2,6,-4
HUN,QAT,2022.0,1,1,0
JPN,NZL,1997.0,10,7,3
NOR,CHN,2013.0,22,20,2
ISR,CHN,2003.0,7,7,0
IRL,JPN,2012.0,5,3,2
NGA,TZA,2018.0,2,1,1
CHE,THA,2023.0,2,1,1
SGP,CHE,2004.0,2,7,-5
LUX,KOR,2020.0,2,5,-3
TTO,CAN,2020.0,3,2,1
KAZ,KOR,2021.0,4,5,-1
KAZ,GBR,2014.0,3,6,-3
DZA,NOR,2017.0,1,1,0
ESP,LTU,2018.0,6,2,4
BGR,ESP,2019.0,3,1,2
VNM,NZL,2014.0,2,1,1
ZAF,QAT,2019.0,1,1,0
SWE,CHL,2015.0,2,5,-3
MNG,CHN,2022.0,14,3,11
NLD,RUS,2021.0,14,26,-12
CIV,MDG,2016.0,1,1,0
BRB,GBR,2023.0,1,1,0
GMB,GBR,2015.0,5,5,0
CHN,GHA,2017.0,18,17,1
PHL,NLD,2019.0,2,3,-1
BDI,RWA,2020.0,1,1,0
GRC,NOR,2020.0,9,2,7
MEX,URY,2016.0,4,2,2
EGY,BHR,2017.0,4,4,0
TUR,BEL,2017.0,13,21,-8
MEX,HND,2022.0,2,1,1
USA,SWZ,2016.0,5,5,0
BHR,IND,2007.0,1,1,0
MAR,FIN,2021.0,1,1,0
COL,DNK,2017.0,2,1,1
MYS,LKA,2023.0,2,5,-3
URY,BRA,2022.0,8,6,2
PHL,DEU,2020.0,8,5,3
DZA,TUN,2021.0,3,14,-11
ESP,IND,2002.0,4,2,2
ZAF,PAK,2022.0,2,3,-1
IRL,LBN,2023.0,1,1,0
ITA,CYP,2014.0,4,2,2
ISR,ITA,2006.0,5,7,-2
DEU,VEN,2020.0,1,10,-9
ETH,GBR,2012.0,6,9,-3
KEN,CHE,2017.0,7,3,4
AUT,PHL,2020.0,1,1,0
TCD,CMR,2020.0,2,3,-1
SDN,USA,2017.0,1,1,0
LTU,ROU,2020.0,2,1,1
ZAF,SRB,2021.0,1,1,0
CAN,RWA,2016.0,2,1,1
AUT,KEN,2022.0,3,1,2
HRV,SVN,2023.0,2,2,0
OMN,HUN,2001.0,1,1,0
IND,LKA,2020.0,10,7,3
HUN,ITA,2006.0,5,9,-4
UZB,RUS,2008.0,6,11,-5
HUN,CHE,2023.0,5,2,3
QAT,KWT,2019.0,2,1,1
MEX,AUT,2022.0,5,5,0
HUN,AUS,2013.0,4,2,2
CUB,CHL,2021.0,15,2,13
BIH,SVN,2021.0,3,2,1
SVK,BIH,2020.0,1,1,0
TUR,IND,2016.0,5,14,-9
ZMB,NGA,2022.0,4,3,1
TUR,BIH,2010.0,2,1,1
SAU,ARE,2024.0,2,1,1
CAN,VNM,2022.0,6,7,-1
BDI,BEL,2022.0,1,2,-1
CAN,CUB,2022.0,2,5,-3
BGD,SWE,2020.0,3,9,-6
NGA,GHA,2022.0,13,3,10
IRL,BGR,2019.0,2,1,1
PAN,BRA,2016.0,2,1,1
BGR,GRC,2014.0,3,3,0
CYP,ITA,2002.0,1,1,0
UGA,GBR,2003.0,5,12,-7
GBR,UGA,2004.0,9,4,5
DNK,PAK,2014.0,2,1,1
MYS,CAN,2011.0,5,7,-2
FRA,PYF,2004.0,5,9,-4
CHE,IRL,2000.0,1,7,-6
MEX,CZE,2007.0,1,3,-2
AUS,NGA,2001.0,5,1,4
CAN,BEN,2000.0,1,1,0
JOR,IRQ,2000.0,2,1,1
AUT,NZL,2001.0,1,1,0
PRT,CHE,2001.0,12,4,8
CHE,PRT,2002.0,8,3,5
BRN,GBR,2008.0,2,4,-2
CAN,RUS,2023.0,9,14,-5
YEM,JOR,2011.0,1,1,0
FRA,KHM,2023.0,4,1,3
ARM,GBR,2014.0,1,1,0
LKA,JPN,2011.0,5,11,-6
LAO,FRA,2021.0,4,1,3
FRA,LAO,2022.0,2,2,0
USA,BHR,2002.0,3,2,1
JPN,CHL,2005.0,2,4,-2
ESP,PSE,2006.0,1,1,0
ITA,CHL,2010.0,5,4,1
AUT,CAN,1999.0,8,14,-6
MDG,FRA,2001.0,4,6,-2
AUS,GEO,1998.0,1,2,-1
ITA,UGA,1997.0,2,1,1
JPN,NOR,2003.0,8,6,2
ZAF,SAU,2013.0,13,18,-5
FRA,SVN,2009.0,4,4,0
AUT,ZAF,2004.0,3,4,-1
AUS,SAU,1998.0,3,2,1
BEL,EGY,2009.0,2,3,-1
MEX,RUS,2006.0,6,5,1
IRL,MEX,1999.0,1,1,0
SWE,BGR,2000.0,2,5,-3
BGR,RUS,2020.0,9,3,6
JPN,HKG,2003.0,10,8,2
PRI,PRT,2005.0,1,1,0
IND,CYP,2006.0,1,1,0
AUS,FJI,2022.0,4,6,-2
SWE,ISL,1997.0,4,5,-1
SAU,HKG,2017.0,5,1,4
TZA,SWE,2004.0,3,2,1
PRT,SWE,2002.0,5,11,-6
MCO,USA,2008.0,1,1,0
ECU,COL,2009.0,1,2,-1
ARE,NZL,2005.0,2,4,-2
ITA,BIH,2020.0,2,2,0
LUX,SWE,2005.0,1,1,0
TWN,CAN,2000.0,6,16,-10
ZWE,GBR,2006.0,8,3,5
ARE,OMN,2006.0,3,4,-1
CZE,UKR,2006.0,3,3,0
MAR,CAN,2014.0,4,9,-5
ESP,AUS,1998.0,1,3,-2
NOR,CHE,1997.0,4,1,3
IRN,CHE,2000.0,1,3,-2
CHE,IRN,2001.0,1,1,0
POL,AUT,2013.0,8,6,2
CHL,BEL,2002.0,5,2,3
DNK,ARM,2001.0,1,1,0
FRA,PER,1998.0,1,1,0
ESP,NOR,2004.0,5,6,-1
GEO,RUS,2011.0,3,5,-2
SGP,JPN,2000.0,7,21,-14
KOR,PRT,2012.0,4,2,2
AUT,ARG,2009.0,1,1,0
EST,USA,1999.0,4,5,-1
THA,BGD,2001.0,3,1,2
BRA,RUS,1997.0,2,10,-8
BGR,BEL,2004.0,5,9,-4
DEU,CYP,1998.0,3,2,1
ZAF,THA,2017.0,3,1,2
ISR,LBY,2019.0,1,1,0
NZL,KOR,2010.0,4,4,0
ETH,NOR,2009.0,4,4,0
BWA,ZAF,2020.0,9,16,-7
CAN,UKR,1999.0,2,6,-4
UKR,CAN,2016.0,6,1,5
BRA,NOR,2012.0,6,4,2
THA,LKA,2004.0,1,2,-1
VEN,CHL,2006.0,4,2,2
PHL,NGA,2012.0,2,2,0
POL,CZE,2011.0,6,14,-8
VEN,DEU,2009.0,9,5,4
MYS,ESP,2016.0,4,3,1
CAN,UKR,2007.0,3,9,-6
POL,IRQ,2020.0,3,2,1
UGA,CMR,2003.0,1,1,0
AUS,HRV,2006.0,2,1,1
CUB,ZAF,2013.0,1,1,0
GEO,CAN,2004.0,1,1,0
SRB,AUT,2017.0,4,4,0
PAK,BRA,2018.0,6,9,-3
FRA,PHL,2023.0,3,5,-2
SWE,PRT,2011.0,6,10,-4
TUR,AUS,2012.0,4,10,-6
SWE,PAK,2010.0,3,8,-5
JPN,SRB,2012.0,1,1,0
KEN,IDN,2018.0,2,3,-1
LKA,USA,2006.0,8,4,4
NOR,IRN,2012.0,1,14,-13
UZB,CHN,2019.0,2,2,0
LKA,IND,2004.0,4,3,1
CZE,AUT,2016.0,14,13,1
SLV,SVK,2017.0,7,3,4
CRI,COL,2009.0,4,1,3
ISR,BEL,2011.0,4,5,-1
ITA,MOZ,2016.0,1,1,0
DEU,TZA,2014.0,6,4,2
AUT,POL,2009.0,7,8,-1
DNK,GRC,2011.0,4,7,-3
BRA,ZAF,2010.0,5,4,1
GRC,RUS,2007.0,3,1,2
KHM,GBR,2015.0,2,4,-2
KEN,DNK,2017.0,1,4,-3
DEU,VNM,2007.0,4,2,2
BEL,ECU,2013.0,6,5,1
BRA,VEN,2008.0,3,7,-4
NOR,FIN,2006.0,8,13,-5
MNE,SRB,2013.0,5,6,-1
JPN,TZA,2010.0,3,1,2
BGD,CHE,2012.0,1,2,-1
MEX,FIN,2020.0,4,1,3
GIN,BFA,2013.0,1,2,-1
PRT,PHL,2021.0,1,1,0
PAK,IRL,2010.0,2,1,1
KOR,DNK,2021.0,6,7,-1
ESP,BGD,2022.0,1,4,-3
BEL,COD,2011.0,1,1,0
IRL,HUN,2012.0,3,2,1
ROU,ISR,2019.0,1,1,0
CMR,JPN,2009.0,4,1,3
TUR,CYP,2005.0,7,9,-2
POL,BRA,2015.0,1,2,-1
BEL,BFA,2015.0,5,2,3
LTU,POL,2016.0,7,4,3
USA,COD,2017.0,2,2,0
SVK,JPN,2008.0,2,1,1
DNK,LUX,2021.0,4,2,2
ZAF,BEN,2020.0,5,2,3
ZAF,KOR,2014.0,3,5,-2
COL,FIN,2019.0,1,1,0
SWE,GRC,2009.0,3,9,-6
KEN,SEN,2016.0,1,3,-2
CMR,GBR,2023.0,4,2,2
TUR,AUS,2005.0,4,1,3
IRN,POL,2015.0,3,2,1
TUN,TUR,2015.0,1,1,0
SAU,ARE,2006.0,7,2,5
BEN,TGO,2018.0,2,2,0
BRN,KOR,2015.0,1,1,0
BEL,NZL,2022.0,3,1,2
AZE,RUS,2015.0,5,7,-2
IDN,CHE,2017.0,3,1,2
SAU,NLD,2014.0,3,6,-3
GBR,SEN,2018.0,2,2,0
GBR,BEN,2004.0,1,1,0
TUR,MEX,2018.0,1,1,0
NZL,ZAF,1997.0,2,4,-2
VNM,DEU,2014.0,6,17,-11
ESP,IND,1997.0,5,3,2
ZAF,EST,2017.0,1,1,0
OMN,SGP,2015.0,1,1,0
HKG,RUS,2012.0,3,1,2
NZL,FJI,2012.0,3,5,-2
TUR,KGZ,2011.0,3,1,2
LBN,SWE,2019.0,5,1,4
ESP,HKG,2014.0,2,3,-1
POL,SRB,2023.0,2,1,1
OMN,USA,2017.0,3,7,-4
MOZ,BRA,2020.0,5,12,-7
BLR,USA,2013.0,3,3,0
ARE,LBN,2023.0,4,18,-14
MEX,DOM,2021.0,7,1,6
CAN,HRV,2019.0,3,3,0
SAU,BGD,2018.0,8,4,4
BGD,SAU,2019.0,9,7,2
MDG,FRA,2014.0,7,14,-7
AUS,LKA,2007.0,3,9,-6
DNK,RUS,2021.0,7,10,-3
BLR,UKR,2020.0,2,3,-1
KWT,ESP,2023.0,4,1,3
ECU,CUB,2023.0,4,1,3
IRL,DNK,2012.0,7,1,6
IRL,CZE,2023.0,4,4,0
CHE,HKG,2021.0,5,7,-2
SWE,ECU,2018.0,1,3,-2
CUB,ITA,2003.0,2,11,-9
SWE,LUX,2023.0,4,4,0
BRN,SGP,2020.0,1,2,-1
HUN,IDN,2021.0,1,10,-9
CZE,HUN,2009.0,4,4,0
USA,CIV,2003.0,4,5,-1
HKG,RUS,2002.0,4,4,0
ARG,VEN,2008.0,7,2,5
ARE,GBR,2003.0,7,6,1
VNM,NLD,2005.0,3,3,0
BGR,GRC,2001.0,8,4,4
VNM,DEU,2001.0,3,2,1
CZE,RUS,2004.0,7,6,1
PRT,IRL,2006.0,1,3,-2
PRI,SWE,2008.0,1,1,0
HUN,BGR,2018.0,2,1,1
DEU,SYR,2014.0,3,4,-1
AUT,BRA,2008.0,5,4,1
ECU,FRA,2005.0,2,1,1
ARM,RUS,1997.0,9,5,4
RUS,BRA,2005.0,6,8,-2
GIN,PNG,2000.0,1,1,0
SWE,CRI,1998.0,2,1,1
KAZ,CHN,2019.0,3,5,-2
NGA,KEN,2007.0,2,3,-1
HUN,SGP,1999.0,1,1,0
USA,BLR,2005.0,5,8,-3
BRA,CHN,2023.0,9,8,1
GIB,GBR,2021.0,2,2,0
BGD,SWE,1998.0,2,1,1
HRV,AUS,2008.0,2,1,1
USA,VNM,2000.0,4,10,-6
EGY,BEL,2005.0,2,4,-2
DNK,FIN,1998.0,7,6,1
SGP,ZAF,2023.0,3,6,-3
KGZ,RUS,2015.0,4,5,-1
UKR,ISR,1998.0,4,3,1
ARG,SWE,2001.0,7,5,2
ITA,MAR,2009.0,2,1,1
SRB,ITA,1997.0,5,4,1
PRT,RUS,2000.0,3,9,-6
CHL,CHE,2013.0,5,14,-9
UKR,JPN,2007.0,2,1,1
CHL,GBR,1999.0,4,7,-3
EGY,KWT,2008.0,10,10,0
CHE,UKR,2020.0,2,13,-11
AUS,MNG,2014.0,1,1,0
HRV,CHE,1999.0,3,1,2
CZE,EGY,2016.0,7,3,4
BEN,CHE,2021.0,1,1,0
UZB,DEU,2012.0,4,2,2
PSE,ESP,2014.0,1,4,-3
GUY,GBR,2004.0,1,1,0
USA,NIC,2014.0,5,5,0
HKG,FRA,2000.0,2,3,-1
CHN,CZE,2004.0,1,1,0
OMN,NGA,2014.0,1,1,0
BEL,IDN,2010.0,5,1,4
JOR,GBR,2015.0,6,29,-23
NPL,NZL,2015.0,2,1,1
HKG,ITA,2008.0,1,1,0
EGY,NLD,2013.0,1,4,-3
KGZ,JPN,2021.0,1,1,0
ZAF,CIV,2013.0,1,8,-7
SGP,LKA,2018.0,3,1,2
ISL,RUS,2008.0,1,1,0
HRV,BEL,2017.0,4,4,0
BEL,HRV,2021.0,3,4,-1
CMR,ZAF,2017.0,5,6,-1
MYS,LBY,2013.0,5,4,1
SAU,SYR,2012.0,2,5,-3
AZE,DEU,2018.0,5,3,2
JPN,LAO,2016.0,4,2,2
KEN,JPN,2011.0,4,9,-5
NZL,CHN,2003.0,4,1,3
THA,VNM,2011.0,6,2,4
SWE,NZL,2014.0,3,14,-11
ESP,PAN,2020.0,11,3,8
CHL,VEN,2022.0,2,7,-5
SGP,MEX,2018.0,2,1,1
GEO,JPN,2019.0,1,1,0
DEU,MAR,2011.0,3,1,2
KOR,ESP,2002.0,3,4,-1
SRB,AUT,2016.0,4,4,0
LBN,IND,2017.0,2,2,0
CIV,DEU,2023.0,1,1,0
PAK,ITA,2008.0,2,1,1
GBR,DZA,2015.0,7,1,6
IRL,RUS,2011.0,3,2,1
SGP,POL,2020.0,4,2,2
SDN,DEU,2012.0,4,3,1
PAK,JPN,2009.0,6,13,-7
PAK,JPN,2011.0,14,14,0
NPL,KOR,2010.0,3,2,1
ECU,URY,2021.0,2,1,1
PRT,TWN,2021.0,1,1,0
RUS,DNK,2017.0,6,6,0
LUX,CHN,2016.0,2,2,0
NZL,BGD,2019.0,3,1,2
CAN,CZE,2022.0,6,14,-8
NZL,ISL,2019.0,1,1,0
VNM,JPN,2008.0,8,18,-10
CYM,USA,2016.0,2,1,1
BEL,BEN,2016.0,7,3,4
IDN,CHE,2016.0,2,2,0
HTI,FRA,2018.0,1,1,0
QAT,NZL,2017.0,2,1,1
CAN,PRT,2012.0,7,6,1
DNK,ISL,2016.0,6,9,-3
DZA,ARE,2021.0,4,1,3
UGA,AUS,2020.0,6,1,5
AUT,THA,2020.0,5,4,1
SAU,YEM,2016.0,3,7,-4
VEN,PER,2021.0,5,1,4
ETH,VNM,2021.0,2,1,1
RWA,USA,2020.0,10,26,-16
LTU,FRA,2017.0,8,1,7
NLD,PAK,2023.0,4,6,-2
ITA,CHL,2023.0,4,14,-10
BEN,BRA,2017.0,1,1,0
HUN,TUR,2018.0,1,3,-2
JPN,FIN,2017.0,17,17,0
KEN,CAN,2020.0,7,7,0
HRV,IND,2016.0,3,2,1
CIV,MLI,2019.0,3,1,2
MAR,TUN,2014.0,4,4,0
GBR,LBR,2022.0,1,1,0
GMB,NGA,2018.0,2,3,-1
HRV,SWE,2021.0,4,3,1
USA,GUM,2017.0,9,12,-3
COL,ESP,2000.0,7,4,3
CAN,TUN,2023.0,3,10,-7
LTU,GBR,2017.0,5,6,-1
LBY,CAN,2020.0,2,6,-4
BEL,EGY,2021.0,2,5,-3
ETH,FIN,2017.0,2,3,-1
BGD,PHL,2017.0,3,2,1
AUS,CRI,2017.0,2,1,1
CUB,NLD,2021.0,1,4,-3
NGA,VNM,2021.0,2,7,-5
ECU,ITA,2020.0,1,9,-8
BRA,SAU,2018.0,1,3,-2
PRT,HUN,2020.0,1,2,-1
CYP,GBR,2023.0,14,24,-10
CHE,BFA,2019.0,2,2,0
JOR,QAT,2010.0,7,1,6
NZL,ITA,2011.0,4,4,0
IND,FJI,2020.0,3,1,2
ROU,ESP,2019.0,6,6,0
JOR,OMN,2019.0,5,2,3
PAN,BRA,2022.0,3,3,0
KWT,SAU,2021.0,5,5,0
NZL,CZE,2021.0,3,5,-2
ESP,ROU,2022.0,6,5,1
PHL,IDN,2022.0,4,3,1
IRN,SAU,2020.0,3,4,-1
CUB,FRA,2017.0,6,2,4
DNK,TUR,2020.0,5,14,-9
NGA,COG,2019.0,6,1,5
BEN,TGO,2022.0,4,1,3
THA,IND,2012.0,4,5,-1
THA,MYS,2012.0,2,4,-2
FRA,HRV,2000.0,5,2,3
IRN,AFG,2021.0,4,5,-1
KOR,QAT,2022.0,2,1,1
COL,CRI,2020.0,3,2,1
TUR,CHN,2002.0,1,4,-3
DNK,IND,2007.0,4,7,-3
URY,ITA,2023.0,2,2,0
ZMB,KEN,2022.0,1,2,-1
MEX,BEL,2008.0,4,4,0
SWE,NZL,2004.0,7,2,5
AUS,PNG,1999.0,4,5,-1
BFA,FRA,1997.0,1,4,-3
LUX,GBR,2002.0,3,1,2
ISL,FRA,2007.0,1,1,0
PRT,MAR,2017.0,2,2,0
CHE,UKR,1999.0,1,3,-2
ARE,SAU,2006.0,2,7,-5
FRA,SAU,2008.0,4,2,2
USA,MKD,2019.0,3,2,1
NGA,ITA,2013.0,1,3,-2
AUS,NOR,2001.0,3,4,-1
AUS,IRQ,2010.0,2,2,0
DZA,BEL,2014.0,3,8,-5
SVK,SVN,2002.0,9,4,5
KWT,LBN,2004.0,1,1,0
LBY,USA,2008.0,1,1,0
KEN,NLD,2013.0,2,10,-8
ZAF,CMR,2001.0,1,1,0
LUX,FRA,2001.0,8,6,2
AUS,CZE,2005.0,4,2,2
IRL,MEX,2007.0,2,2,0
FRA,NZL,1999.0,3,5,-2
MNG,CHE,2008.0,1,1,0
AUS,EGY,2011.0,4,4,0
AUT,GRC,2000.0,1,1,0
ITA,CUB,2012.0,3,7,-4
KOR,FIN,2007.0,1,3,-2
IND,POL,1998.0,1,1,0
SEN,BFA,2017.0,4,7,-3
FRA,MDG,2003.0,4,1,3
AUS,MWI,2006.0,1,1,0
IRL,BGD,2008.0,2,1,1
DNK,TZA,2002.0,4,4,0
USA,GUF,2010.0,1,1,0
SRB,ESP,2008.0,2,1,1
PRT,DNK,2005.0,2,2,0
BRA,MEX,2006.0,5,15,-10
FRA,BEN,2001.0,3,3,0
TUR,AZE,2013.0,8,5,3
AUS,LKA,1998.0,4,1,3
JOR,DEU,2006.0,7,10,-3
USA,HND,2002.0,1,2,-1
COG,FRA,2003.0,3,5,-2
NLD,CHL,2013.0,3,8,-5
KEN,CAN,1999.0,1,6,-5
CYP,ITA,2012.0,2,2,0
PER,IDN,2012.0,1,2,-1
VNM,THA,2013.0,5,7,-2
NLD,LKA,2004.0,1,4,-3
ITA,EGY,2002.0,7,4,3
CAN,TWN,1998.0,11,7,4
BRB,JAM,2007.0,2,1,1
MSR,GBR,2004.0,1,2,-1
ARE,NOR,2019.0,3,1,2
USA,CYP,2000.0,6,3,3
ESP,PAK,2023.0,4,7,-3
POL,VNM,2024.0,1,1,0
HUN,CAN,2005.0,9,3,6
JPN,PRT,2001.0,4,2,2
MAC,CHN,2006.0,7,14,-7
GUM,USA,2006.0,4,3,1
DNK,CHL,2005.0,3,1,2
NOR,BGD,2011.0,2,3,-1
SYR,USA,2008.0,7,3,4
NLD,MEX,1997.0,3,6,-3
AUS,SVK,1998.0,1,1,0
HKG,IND,1999.0,3,3,0
AUS,JOR,2003.0,2,3,-1
THA,BGD,2015.0,5,2,3
EGY,CHN,2010.0,3,3,0
NPL,PHL,2011.0,1,1,0
IRN,KOR,2008.0,2,1,1
GBR,RWA,2022.0,3,3,0
SWZ,CHE,2007.0,1,2,-1
IND,TUN,2012.0,1,1,0
CZE,SAU,2012.0,2,1,1
EGY,CAN,1997.0,4,7,-3
HRV,HUN,2001.0,1,7,-6
LTU,NLD,2008.0,1,4,-3
UZB,MYS,2009.0,2,1,1
POL,RUS,2005.0,13,11,2
TWN,IND,1997.0,1,4,-3
GEO,FRA,2021.0,2,7,-5
USA,COD,2016.0,2,1,1
COD,USA,2017.0,2,2,0
ESP,IND,2005.0,5,7,-2
AUT,BEL,1998.0,4,3,1
SGP,IDN,2011.0,4,5,-1
LTU,FIN,2003.0,3,3,0
FIN,LTU,2010.0,3,1,2
BGR,BRA,2009.0,1,1,0
PAK,RUS,2011.0,2,1,1
NLD,MEX,2005.0,4,4,0
IDN,TWN,2009.0,1,1,0
IDN,TWN,2011.0,5,7,-2
BGD,KOR,2005.0,9,2,7
COL,VEN,2009.0,6,7,-1
MNG,CHN,2016.0,4,5,-1
GRC,CAN,2007.0,6,8,-2
SGP,BRN,2011.0,2,2,0
BEL,VNM,2006.0,3,4,-1
VNM,DNK,2008.0,2,1,1
SVN,HRV,2008.0,4,3,1
ZAF,CHN,2005.0,3,3,0
CAN,UKR,2020.0,4,6,-2
LAO,FRA,2009.0,3,3,0
PHL,NLD,2009.0,1,1,0
CHL,NLD,2013.0,8,3,5
CZE,SAU,2005.0,1,1,0
USA,ARM,2003.0,6,11,-5
MYS,NLD,2010.0,3,2,1
BEL,LBN,2014.0,2,6,-4
KEN,MLI,2022.0,1,1,0
TWN,RUS,1999.0,1,3,-2
GBR,ISL,2006.0,6,4,2
PSE,MYS,2020.0,5,8,-3
TWN,ZAF,2016.0,5,2,3
LVA,DEU,2022.0,2,3,-1
ASM,USA,2005.0,1,2,-1
BGD,AUS,2003.0,4,2,2
MYS,IND,1997.0,3,9,-6
GBR,SVK,2013.0,14,9,5
POL,NOR,2000.0,3,6,-3
PRT,BGR,2008.0,1,2,-1
CZE,IND,2009.0,2,5,-3
GBR,KHM,2012.0,2,2,0
CRI,FIN,2004.0,1,1,0
PRT,CHE,2004.0,3,8,-5
SRB,GRC,2017.0,4,1,3
IND,CZE,2012.0,2,1,1
AUS,LAO,2013.0,2,3,-1
LUX,NLD,2018.0,7,5,2
NLD,COL,2006.0,4,3,1
GRC,FIN,2018.0,4,4,0
NZL,AUT,2021.0,3,7,-4
PRT,MEX,1998.0,1,1,0
IND,FIN,2008.0,5,4,1
JPN,JOR,1999.0,1,2,-1
SAU,HKG,2016.0,2,7,-5
USA,DMA,2013.0,3,1,2
MYS,CHE,2018.0,7,2,5
RUS,LUX,2022.0,4,1,3
LVA,AUS,2020.0,1,1,0
TWN,TUR,1997.0,1,1,0
KOR,CZE,2020.0,6,3,3
LKA,HKG,2020.0,3,2,1
SWE,SDN,2017.0,2,3,-1
KGZ,RUS,2004.0,4,5,-1
BHR,SAU,2018.0,4,6,-2
PRY,ARG,2019.0,5,1,4
GHA,NZL,2018.0,1,5,-4
PAK,BRA,2017.0,8,14,-6
ARE,CHE,2023.0,2,2,0
SAU,TWN,2013.0,1,1,0
JPN,ESP,2014.0,12,24,-12
TWN,AUS,2003.0,7,9,-2
NLD,AFG,2019.0,1,2,-1
NGA,FRA,2018.0,2,4,-2
ETH,NLD,2016.0,3,15,-12
LVA,USA,2022.0,2,4,-2
TWN,RUS,2020.0,5,4,1
YEM,EGY,2019.0,4,11,-7
THA,LKA,2014.0,2,1,1
BEL,RUS,2009.0,1,9,-8
SEN,ZAF,2020.0,3,4,-1
PRI,GBR,2017.0,2,1,1
MEX,IRN,2021.0,1,8,-7
ZAF,AUT,2018.0,7,4,3
CMR,SEN,2018.0,1,1,0
JPN,DZA,2020.0,3,1,2
CHE,SRB,2002.0,4,3,1
USA,DOM,2013.0,4,4,0
GRC,AUT,2021.0,3,3,0
MAR,SWE,2019.0,3,1,2
THA,DNK,2001.0,2,1,1
COG,BEL,2001.0,2,1,1
THA,IND,2002.0,7,3,4
AUT,THA,1998.0,1,1,0
USA,PRY,2002.0,1,1,0
PHL,AUS,2005.0,4,8,-4
POL,IND,2000.0,3,3,0
GBR,SDN,2010.0,5,2,3
NLD,GAB,2017.0,3,1,2
HRV,SVN,2006.0,8,2,6
GRC,ITA,1999.0,12,9,3
ZAF,MOZ,2015.0,2,2,0
TZA,NOR,2005.0,1,3,-2
CAN,CYP,2003.0,1,1,0
URY,ARG,1998.0,2,5,-3
GBR,SVK,2003.0,12,11,1
BWA,NGA,2015.0,4,1,3
URY,FRA,2006.0,5,2,3
AUT,THA,1999.0,5,1,4
URY,SWE,2010.0,1,2,-1
KEN,COL,2010.0,1,1,0
SDN,SAU,2005.0,4,6,-2
USA,DZA,2012.0,3,3,0
JOR,TUR,2001.0,1,3,-2
BRA,ISR,1997.0,1,3,-2
NOR,THA,2009.0,1,1,0
NPL,GBR,2000.0,2,3,-1
DZA,GBR,2000.0,1,2,-1
GBR,MSR,2004.0,2,1,1
TUR,UKR,1998.0,1,4,-3
BOL,CHE,2012.0,1,2,-1
UZB,RUS,2004.0,6,6,0
BEL,IND,2003.0,8,4,4
CYP,TUR,2001.0,2,1,1
IDN,NZL,2000.0,1,1,0
ZWE,DNK,2002.0,2,1,1
ARM,CAN,2019.0,1,1,0
KWT,USA,2006.0,11,22,-11
ITA,WSM,1998.0,1,1,0
DOM,ESP,2013.0,1,1,0
FRA,CYP,2015.0,3,2,1
TZA,GBR,1998.0,5,5,0
DNK,ZAF,2006.0,3,1,2
GBR,ISL,2000.0,5,9,-4
ISR,BGR,2001.0,2,3,-1
IND,PHL,2000.0,3,8,-5
GBR,VEN,2022.0,1,2,-1
JOR,OMN,2009.0,2,2,0
RUS,BGR,2003.0,7,10,-3
NZL,RUS,2014.0,3,3,0
ZAF,SEN,2010.0,2,1,1
BRA,HUN,2019.0,3,4,-1
UKR,MEX,2002.0,2,2,0
ESP,ISR,2009.0,7,9,-2
CAN,SEN,2002.0,2,1,1
KHM,USA,2011.0,2,5,-3
GBR,MAR,1998.0,3,2,1
UKR,ISR,1999.0,3,3,0
AUT,ISR,2002.0,3,1,2
TUR,AUS,2002.0,5,3,2
PRT,SVK,2017.0,1,1,0
USA,BRN,2009.0,1,1,0
PSE,GBR,2002.0,1,3,-2
FRA,BGR,2006.0,6,6,0
BRN,PAK,2014.0,1,2,-1
MCO,FRA,2007.0,1,15,-14
MEX,ISR,2013.0,2,1,1
ITA,IDN,2018.0,1,1,0
GHA,JPN,2004.0,2,4,-2
GEO,DEU,2000.0,4,2,2
BWA,NOR,2008.0,1,1,0
MLI,NER,2021.0,4,1,3
NOR,THA,2021.0,2,1,1
AUS,UKR,2007.0,1,3,-2
FIN,ARG,2013.0,2,3,-1
BEL,AUS,2006.0,8,4,4
CZE,ZAF,2007.0,2,1,1
LKA,SWE,2005.0,1,2,-1
MAR,CHE,2004.0,2,1,1
AUS,LBY,2014.0,3,1,2
ZAF,ROU,2008.0,2,1,1
HRV,HUN,2014.0,2,4,-2
EST,SWE,2006.0,2,12,-10
RUS,SVN,2018.0,1,2,-1
SWE,LKA,2010.0,2,1,1
CRI,FRA,2003.0,1,3,-2
VNM,IDN,2014.0,1,1,0
LTU,BEL,2017.0,2,1,1
POL,BGR,2000.0,2,2,0
CZE,ISR,2015.0,3,1,2
CHL,PER,2016.0,12,4,8
KEN,NGA,2008.0,1,5,-4
LBY,EGY,2011.0,6,2,4
PAK,NZL,2008.0,2,1,1
DEU,UZB,2016.0,3,5,-2
CAN,COL,2009.0,8,13,-5
GBR,LBY,2015.0,12,4,8
GRC,POL,2020.0,3,1,2
SVN,SRB,2010.0,4,11,-7
VEN,MEX,2005.0,7,1,6
BRA,CRI,2005.0,3,2,1
POL,LTU,2000.0,1,1,0
CZE,PRY,2011.0,4,1,3
HKG,NZL,2006.0,2,1,1
EGY,ITA,2007.0,4,7,-3
QAT,KWT,2009.0,2,1,1
SWE,ETH,2017.0,6,7,-1
ETH,SWE,2018.0,1,10,-9
CHN,MUS,2014.0,2,1,1
HUN,TUR,2016.0,1,3,-2
HUN,CHE,2006.0,4,10,-6
SGP,IRN,2008.0,1,4,-3
BGR,BEL,2015.0,4,5,-1
IRN,ZAF,2012.0,4,2,2
ROU,IRL,2016.0,2,2,0
EST,ITA,2012.0,1,7,-6
SVN,SWE,2013.0,4,1,3
EGY,FIN,2020.0,2,4,-2
LBN,LBY,2020.0,1,1,0
PHL,TWN,2011.0,4,3,1
UZB,RUS,2014.0,4,4,0
ECU,COL,2011.0,1,1,0
BRB,GBR,2000.0,1,2,-1
BRA,URY,2018.0,17,9,8
SGP,ISR,2014.0,5,5,0
VNM,AUS,2004.0,2,2,0
USA,LVA,2021.0,3,2,1
JPN,BTN,2022.0,1,2,-1
NOR,CMR,2018.0,1,2,-1
USA,LSO,2011.0,3,2,1
MLI,CIV,2011.0,4,1,3
BGR,DNK,2014.0,1,1,0
NLD,RWA,2015.0,2,1,1
MWI,ZAF,2015.0,6,5,1
LTU,SWE,2002.0,5,7,-2
CZE,PRT,2007.0,2,2,0
BEL,GAB,2014.0,4,1,3
BEL,NPL,2016.0,2,1,1
RWA,GHA,2023.0,1,1,0
NZL,VNM,2014.0,1,2,-1
NCL,NZL,2004.0,1,1,0
ROU,ECU,2021.0,1,2,-1
JPN,SVK,2007.0,1,3,-2
DEU,ARM,1999.0,2,5,-3
TUR,NOR,2008.0,4,1,3
BEL,KAZ,2018.0,3,1,2
SRB,BIH,2005.0,10,5,5
DEU,SVN,2015.0,6,13,-7
MKD,ITA,2018.0,2,1,1
ZAF,BEL,2000.0,4,1,3
LTU,GBR,2016.0,12,5,7
NAM,DEU,2016.0,2,1,1
LBY,LBN,2011.0,2,3,-1
USA,SDN,2017.0,1,1,0
DNK,RUS,2019.0,6,7,-1
KAZ,AZE,2021.0,1,1,0
DEU,IRQ,2014.0,6,1,5
RUS,ESP,2014.0,10,9,1
CHE,SVN,2011.0,1,4,-3
QAT,CAN,2008.0,3,8,-5
SLV,USA,2009.0,2,1,1
SVN,AUS,2018.0,2,6,-4
PAK,NPL,2020.0,4,2,2
BLR,GBR,2016.0,1,1,0
CHN,SRB,2023.0,1,1,0
NOR,SRB,2005.0,2,1,1
IDN,CHE,2022.0,2,1,1
AUS,SVN,2012.0,1,3,-2
DZA,TUR,2018.0,3,2,1
IRN,GRC,2016.0,1,2,-1
NZL,LKA,2018.0,4,4,0
IRL,PAK,2018.0,7,8,-1
TWN,JPN,1997.0,7,14,-7
PER,PRT,2019.0,3,4,-1
NOR,TWN,2016.0,1,2,-1
THA,POL,2023.0,4,1,3
SVK,CHN,2017.0,1,1,0
MYS,IRN,2023.0,9,13,-4
HUN,TWN,2015.0,2,3,-1
ETH,KOR,2014.0,3,2,1
TWN,FIN,2018.0,3,1,2
CUB,SWE,2013.0,1,1,0
MYS,MAR,2018.0,1,1,0
BEL,NGA,2019.0,4,1,3
ITA,BLR,2003.0,2,2,0
USA,BLZ,2020.0,3,1,2
TTO,IND,2015.0,2,3,-1
PAK,BGD,2010.0,2,9,-7
BGD,SWE,2007.0,1,2,-1
MYS,BRN,2016.0,7,4,3
MEX,ISR,2003.0,1,2,-1
DZA,TUN,2011.0,2,2,0
ZAF,CHE,2000.0,1,2,-1
LVA,RUS,2000.0,1,3,-2
ARE,AUT,2017.0,1,2,-1
DEU,ZMB,2020.0,2,2,0
TUR,QAT,2016.0,4,1,3
BHR,IRQ,2021.0,2,1,1
NOR,BRA,2014.0,2,10,-8
MYS,FRA,2001.0,1,2,-1
BEL,LTU,2012.0,2,1,1
PHL,IDN,2016.0,1,1,0
BOL,MEX,2022.0,1,2,-1
SWE,KEN,2021.0,5,3,2
CHE,TWN,2019.0,4,14,-10
IRL,LTU,2020.0,1,2,-1
PAK,NLD,2021.0,6,9,-3
VNM,CAN,2013.0,1,5,-4
KOR,RWA,2021.0,2,1,1
HUN,JPN,2023.0,5,2,3
COL,CUB,2022.0,3,2,1
DEU,URY,2022.0,3,4,-1
PRT,MEX,2007.0,3,1,2
ITA,BGD,2009.0,2,4,-2
NGA,TZA,2022.0,2,2,0
MWI,NOR,2022.0,1,3,-2
ESP,GTM,2022.0,4,1,3
NLD,ROU,2022.0,3,2,1
HUN,VNM,2020.0,2,1,1
SRB,NLD,2013.0,3,4,-1
POL,AUT,2003.0,5,7,-2
BFA,DEU,2007.0,1,3,-2
DOM,CHE,1999.0,1,1,0
JPN,NPL,1998.0,3,2,1
CHL,URY,2002.0,2,7,-5
GBR,GIB,2005.0,2,1,1
OMN,JOR,1997.0,2,1,1
NOR,AUT,2000.0,2,2,0
SRB,CZE,2000.0,4,1,3
FJI,NZL,2004.0,1,3,-2
CHN,IRL,2000.0,3,2,1
FRA,SAU,2001.0,2,1,1
UKR,FIN,2002.0,2,3,-1
AUS,HUN,2005.0,3,3,0
NZL,KOR,2006.0,3,5,-2
SGP,SWE,1999.0,4,8,-4
IND,DNK,2004.0,4,5,-1
USA,MDA,2004.0,2,5,-3
NOR,BEL,2000.0,3,1,2
BHR,USA,1999.0,2,1,1
PRT,IRL,2010.0,3,7,-4
NLD,CRI,2022.0,2,3,-1
ISL,NLD,2013.0,1,1,0
POL,BRA,2014.0,3,3,0
TWN,IDN,2014.0,11,10,1
KWT,AUS,2005.0,1,4,-3
NOR,BRA,2001.0,1,1,0
GHA,ZAF,2002.0,1,3,-2
TUR,JPN,2001.0,7,5,2
NPL,BEL,2010.0,1,3,-2
MYS,BRN,2017.0,12,3,9
PAK,AUS,2001.0,2,4,-2
DEU,SGP,2006.0,15,13,2
AUS,ARG,2004.0,1,3,-2
QAT,TUR,2016.0,1,4,-3
PAK,EGY,2017.0,1,5,-4
NLD,GAB,2016.0,2,2,0
KWT,HUN,2004.0,1,1,0
ISR,CHN,2013.0,10,6,4
TTO,ZAF,2010.0,1,1,0
TUR,UKR,1999.0,3,8,-5
TUR,KAZ,2013.0,1,1,0
NLD,GRC,1998.0,2,8,-6
ARG,ISR,2006.0,1,3,-2
BGR,GRC,2015.0,2,1,1
GRC,BGR,2017.0,3,1,2
HUN,AUS,2003.0,2,4,-2
ARE,KWT,2002.0,4,2,2
DNK,BGR,2011.0,2,1,1
BGD,SWE,1999.0,1,4,-3
KWT,CAN,2005.0,6,3,3
NLD,GRC,1999.0,3,11,-8
BGD,ITA,2009.0,4,2,2
BOL,NLD,2008.0,1,2,-1
AUT,KEN,2018.0,1,2,-1
THA,PAK,2010.0,2,3,-1
CZE,MYS,2017.0,2,2,0
NLD,TZA,2012.0,7,1,6
SAU,FRA,2011.0,1,27,-26
TUN,BHR,2012.0,1,1,0
HUN,FIN,2004.0,4,5,-1
DNK,IND,1999.0,2,1,1
DEU,CRI,2007.0,3,1,2
CHE,BEN,2021.0,1,1,0
PAK,NGA,2019.0,3,7,-4
LTU,FRA,2022.0,1,4,-3
UGA,NOR,2019.0,4,2,2
SGP,TUR,2019.0,8,2,6
AUS,LBN,2019.0,3,1,2
NER,NGA,2014.0,2,12,-10
SGP,KEN,2020.0,1,1,0
JPN,BTN,2016.0,1,1,0
CHE,TWN,2009.0,2,1,1
ESP,SRB,2015.0,5,2,3
BRN,GBR,2001.0,1,1,0
GBR,BRN,2002.0,3,4,-1
CAN,PHL,2017.0,4,2,2
SVN,NOR,2020.0,3,1,2
IND,GHA,2016.0,2,1,1
DEU,KAZ,2010.0,2,2,0
ROU,PRT,2016.0,1,2,-1
ALB,DEU,2019.0,3,1,2
ARE,SGP,2013.0,2,7,-5
AUS,MNG,2015.0,1,1,0
FRA,CYP,2014.0,5,2,3
OMN,THA,2014.0,1,1,0
HKG,NOR,2017.0,2,2,0
PRT,IRN,2015.0,2,13,-11
ESP,TWN,2022.0,4,4,0
BEN,USA,2016.0,2,4,-2
BRA,ECU,2014.0,5,2,3
MYS,NZL,2008.0,4,5,-1
ESP,THA,2020.0,5,6,-1
GIN,CMR,2020.0,2,1,1
ARE,IND,2008.0,5,4,1
HKG,GHA,2021.0,3,4,-1
SRB,GRC,2016.0,2,4,-2
BRA,PAK,2022.0,6,5,1
HUN,DNK,2021.0,5,5,0
THA,HKG,2017.0,2,4,-2
CAN,KEN,2021.0,4,4,0
SAU,BIH,2018.0,1,1,0
GBR,COG,2022.0,2,1,1
FIN,LTU,2023.0,2,2,0
GBR,YEM,2019.0,1,1,0
SVN,BEL,2022.0,3,2,1
LUX,NLD,2022.0,5,2,3
GMB,USA,2017.0,4,1,3
KOR,HKG,2010.0,5,6,-1
FRA,MTQ,1999.0,9,17,-8
ETH,ITA,2017.0,5,3,2
NLD,SVK,2021.0,5,2,3
MAC,HKG,2013.0,3,17,-14
SRB,AUS,2019.0,4,3,1
ETH,NGA,2019.0,2,2,0
BHR,PAK,2020.0,2,3,-1
TUR,BGR,2004.0,1,2,-1
CAN,MAC,2022.0,1,1,0
UGA,BWA,2020.0,1,3,-2
IRQ,CHN,2018.0,2,30,-28
KOR,LAO,2020.0,2,1,1
PHL,CAN,2021.0,5,6,-1
ARG,PER,2023.0,2,4,-2
BGR,PRT,2019.0,1,2,-1
BEL,HKG,2018.0,5,2,3
NGA,HKG,2023.0,4,2,2
DEU,MDA,2019.0,3,3,0
UZB,JPN,2006.0,1,1,0
KOR,GHA,2023.0,3,1,2
LTU,POL,2022.0,2,3,-1
POL,LTU,2023.0,4,4,0
COG,ZWE,2021.0,1,4,-3
BEL,RWA,2014.0,1,2,-1
BEL,MOZ,2022.0,4,1,3
RUS,LUX,2016.0,1,1,0
IRQ,NLD,2022.0,2,1,1
HRV,FRA,1998.0,1,3,-2
EST,BRA,2022.0,2,3,-1
AUT,ECU,2022.0,3,1,2
NAM,GBR,2021.0,2,2,0
IRN,JOR,2023.0,2,1,1
AUS,MEX,2006.0,2,6,-4
COL,GBR,2009.0,3,13,-10
IDN,PNG,2011.0,1,1,0
ETH,DEU,2015.0,9,12,-3
BGD,ARE,2016.0,1,1,0
LBN,CAN,2002.0,6,4,2
SGP,SWE,2007.0,4,10,-6
NLD,SRB,2000.0,2,2,0
CAN,COG,2021.0,2,1,1
AUS,OMN,2008.0,3,4,-1
NLD,ISL,2001.0,2,1,1
URY,ESP,2009.0,7,9,-2
CUB,BEL,2006.0,3,3,0
BWA,KEN,2017.0,1,1,0
IRL,CZE,2010.0,1,4,-3
RUS,MDA,2011.0,2,3,-1
PER,FRA,2006.0,3,3,0
ISL,ITA,2013.0,1,1,0
BRN,AUS,2013.0,5,3,2
FIN,CHE,2012.0,11,7,4
SAU,NLD,2008.0,1,3,-2
CZE,EGY,2018.0,4,1,3
GBR,SYR,2008.0,5,2,3
TTO,GBR,2007.0,1,5,-4
QAT,PAK,2020.0,5,6,-1
MYS,NZL,2004.0,1,1,0
ROU,AUS,2013.0,3,3,0
LBY,FRA,2017.0,1,3,-2
AUT,DNK,2007.0,1,2,-1
POL,BEL,2007.0,7,8,-1
CHL,URY,2005.0,1,2,-1
CHE,IDN,2004.0,2,1,1
FRA,BEN,2015.0,18,16,2
MYS,JPN,2007.0,13,22,-9
CHN,IRL,2006.0,8,6,2
PRT,AUS,2009.0,4,1,3
EST,UKR,2018.0,2,3,-1
HUN,ESP,2003.0,2,6,-4
BRA,ISR,2012.0,2,6,-4
THA,ITA,2021.0,6,5,1
IRL,RUS,2021.0,4,9,-5
CZE,NZL,2020.0,2,1,1
NCL,AUS,2012.0,1,2,-1
TWN,SGP,2005.0,3,6,-3
GRC,TUR,2015.0,1,2,-1
TTO,JAM,2016.0,4,7,-3
TUR,BHR,2020.0,1,2,-1
IRL,BIH,2017.0,1,1,0
SAU,CHE,2016.0,3,1,2
TZA,UGA,2019.0,8,4,4
CUB,CHL,2019.0,13,2,11
RUS,CHL,2017.0,2,1,1
AZE,DEU,2017.0,2,2,0
PRT,AUS,2011.0,5,7,-2
CUB,GBR,2023.0,1,1,0
ROU,CZE,2015.0,2,1,1
CAN,PAK,2005.0,4,12,-8
COG,USA,2018.0,5,13,-8
MEX,PER,2008.0,6,4,2
FLK,GBR,2013.0,2,2,0
KHM,VNM,2012.0,2,2,0
MEX,IRL,2012.0,1,1,0
HKG,SAU,2020.0,4,5,-1
ITA,JPN,2023.0,7,16,-9
MAR,MRT,2021.0,4,1,3
RUS,IRN,2023.0,3,7,-4
ZAF,GHA,2008.0,2,1,1
CZE,BEL,2005.0,4,4,0
CIV,GHA,2020.0,2,1,1
GHA,FRA,2017.0,2,3,-1
SUR,BEL,2021.0,1,2,-1
CYP,JOR,2020.0,2,1,1
CZE,VNM,2020.0,7,3,4
QAT,NLD,2023.0,2,2,0
KHM,NLD,2018.0,1,2,-1
THA,IRL,2020.0,3,2,1
ARE,NGA,2021.0,1,3,-2
BEL,UGA,2023.0,2,5,-3
IDN,GBR,2015.0,7,30,-23
ISL,DNK,2016.0,9,6,3
TUR,MYS,2022.0,4,15,-11
NPL,CHE,2023.0,1,1,0
LKA,KOR,2019.0,2,6,-4
GHA,USA,1997.0,4,3,1
CIV,SEN,2013.0,1,1,0
CHN,IRN,2004.0,1,1,0
IRL,BEL,2000.0,3,5,-2
AUT,PRT,2007.0,1,1,0
AZE,DEU,2022.0,2,2,0
GRC,ISR,2000.0,1,2,-1
MAR,DZA,2015.0,3,4,-1
ITA,EGY,1997.0,5,2,3
EGY,LBY,2010.0,5,2,3
DEU,VEN,1998.0,3,2,1
USA,LUX,2008.0,3,1,2
PHL,HKG,1997.0,1,1,0
SAU,JOR,2001.0,1,5,-4
OMN,CAN,1999.0,1,4,-3
TWN,RUS,2005.0,2,3,-1
KOR,ESP,1998.0,2,2,0
SRB,NLD,2015.0,3,7,-4
SAU,ESP,2016.0,2,16,-14
MEX,GRC,2011.0,1,1,0
ESP,GRD,2009.0,1,1,0
HRV,CHN,2014.0,1,1,0
GEO,CHE,1999.0,1,1,0
CHE,BGR,2002.0,1,5,-4
USA,LBY,2011.0,1,3,-2
RUS,GRC,2015.0,2,2,0
LKA,SGP,2011.0,1,1,0
SWE,COL,1997.0,1,2,-1
JAM,GBR,2006.0,2,2,0
HKG,CHE,2004.0,1,1,0
SWE,HRV,2020.0,1,6,-5
DEU,KGZ,2018.0,1,1,0
ZWE,BWA,2015.0,1,4,-3
POL,HKG,2016.0,1,2,-1
ROU,UKR,2021.0,1,1,0
NAM,MEX,2021.0,1,1,0
ZMB,MWI,2020.0,2,2,0
GTM,MEX,2017.0,3,4,-1
ISR,NOR,2018.0,1,1,0
PER,CHN,2008.0,1,1,0
NLD,SRB,2021.0,2,6,-4
IRL,LBY,2020.0,2,1,1
MAC,AUS,2018.0,4,2,2
NLD,LVA,2018.0,1,2,-1
DOM,CHL,2018.0,1,1,0
BWA,IND,2007.0,1,1,0
SMR,ITA,2018.0,1,8,-7
NOR,LTU,2018.0,1,1,0
ITA,MKD,2022.0,1,1,0
PAK,SWE,2004.0,1,2,-1
USA,SYR,1999.0,1,3,-2
SOM,TUR,2022.0,1,10,-9
MEX,COL,2000.0,1,2,-1
PAK,UZB,2015.0,1,1,0
CAN,PRI,2008.0,1,2,-1
ETH,GBR,1999.0,1,4,-3
IRN,MYS,2002.0,1,3,-2
BGR,ISR,2019.0,1,2,-1
DEU,GAB,2004.0,1,3,-2
OMN,JOR,2007.0,1,3,-2
USA,CIV,2001.0,2,1,1
GHA,NLD,2012.0,2,3,-1
MDG,FRA,2003.0,1,4,-3
MEX,PRT,2004.0,1,2,-1
IRQ,IRN,2013.0,1,13,-12
POL,BRA,2003.0,1,1,0
IND,BRN,2019.0,1,3,-2
HUN,BRA,2004.0,1,1,0
USA,CIV,2004.0,1,6,-5
LIE,CHE,2017.0,1,2,-1
SLV,USA,2010.0,1,1,0
IND,BRB,2022.0,2,1,1
COG,BFA,2015.0,1,1,0
BEL,LBN,2003.0,1,1,0
NGA,BEN,2006.0,1,1,0
VNM,CAN,2008.0,1,5,-4
CHE,MAC,2017.0,1,1,0
IRL,NGA,2010.0,1,1,0
ISL,POL,2022.0,1,1,0
CHN,SYR,2010.0,1,2,-1
MAR,PRT,2006.0,1,1,0
CHL,CHN,2023.0,1,3,-2
QAT,BRN,2022.0,1,1,0
SWE,UGA,2023.0,1,1,0
SVN,FRA,2023.0,2,3,-1
LBY,IRL,2021.0,1,1,0
IDN,JPN,2024.0,1,1,0
KOR,ITA,2002.0,1,4,-3
TTO,IND,2003.0,1,1,0
IRL,MEX,1997.0,1,1,0
LAO,CHN,2021.0,1,8,-7
LUX,VNM,2023.0,2,2,0
IRL,PRT,2007.0,1,4,-3
BOL,ARG,2012.0,1,1,0
ZAF,RUS,2012.0,2,2,0
ZWE,FRA,2015.0,1,1,0
GNB,DNK,2001.0,1,2,-1
TUN,AUT,2015.0,1,1,0
TZA,CAN,2016.0,1,3,-2
AFG,IND,2014.0,3,1,2
ECU,ITA,2012.0,1,3,-2
SVN,JPN,2011.0,1,1,0
JPN,ISR,2022.0,2,4,-2
PRT,PAK,2020.0,1,2,-1
URY,ITA,2019.0,1,1,0
IRN,TUN,2016.0,1,1,0
EGY,HKG,2015.0,1,1,0
AUS,CMR,2017.0,1,1,0
URY,ECU,2020.0,1,1,0
VEN,DEU,2023.0,2,1,1
PNG,CZE,2022.0,1,1,0
NZL,BGD,2006.0,1,1,0
ZAF,LSO,2017.0,3,1,2
NGA,TUR,2015.0,1,2,-1
GBR,SHN,2016.0,1,3,-2
LUX,SRB,2020.0,1,1,0
THA,ESP,2013.0,1,3,-2
IRN,TUN,2022.0,1,1,0
AUT,BFA,2020.0,1,1,0
CAN,GEO,2020.0,1,1,0
LBY,ZAF,2020.0,1,3,-2
DEU,PRI,2008.0,1,1,0
PAN,COL,2010.0,1,3,-2
KHM,CAN,2016.0,1,1,0
ETH,FRA,2002.0,1,1,0
NZL,OMN,2006.0,1,1,0
MAC,JPN,2017.0,1,1,0
PAK,AUS,2003.0,1,1,0
MEX,BGD,2018.0,1,2,-1
NAM,CHN,2016.0,1,1,0
UKR,TUR,2010.0,1,2,-1
NOR,SAU,2017.0,1,3,-2
PRT,AUT,2007.0,1,1,0
TUR,BRA,2017.0,5,2,3
CHN,OMN,2023.0,1,1,0
IRL,ISR,2016.0,2,10,-8
THA,VNM,2006.0,2,1,1
MAC,PRT,2016.0,1,5,-4
GRC,DNK,2004.0,2,3,-1
POL,FIN,1999.0,1,4,-3
NOR,HUN,2005.0,1,1,0
DEU,LBN,2009.0,1,4,-3
KAZ,LTU,2020.0,1,1,0
VNM,IRL,2021.0,2,1,1
DNK,BGR,2006.0,1,2,-1
ISR,SVN,2022.0,1,1,0
SVK,IRN,2020.0,1,7,-6
GHA,SEN,2021.0,1,1,0
CHE,BEN,2023.0,1,1,0
COL,MEX,1998.0,2,1,1
NZL,ARE,2004.0,1,2,-1
AUS,PAK,2006.0,2,3,-1
FRA,LTU,2002.0,1,2,-1
CZE,EST,2016.0,1,2,-1
KOR,FJI,2018.0,1,1,0
AUT,ISR,2007.0,2,2,0
ETH,MYS,2015.0,1,3,-2
EGY,SWE,2004.0,1,3,-2
ECU,COL,2000.0,1,1,0
SEN,CHE,2012.0,1,3,-2
CRI,CAN,2000.0,1,5,-4
COL,VEN,2010.0,2,17,-15
IRQ,AUS,2011.0,1,2,-1
CAF,GAB,2013.0,2,1,1
TCA,USA,2010.0,1,1,0
ROU,SRB,2014.0,1,1,0
RUS,ISL,2008.0,1,1,0
PAK,JOR,2009.0,1,1,0
CRI,COL,2006.0,1,1,0
MRT,ITA,2012.0,1,1,0
GBR,MAR,2012.0,1,2,-1
SRB,NLD,2014.0,2,7,-5
GHA,KEN,2011.0,1,2,-1
ITA,MCO,2020.0,1,1,0
CUB,VEN,2011.0,2,3,-1
MKD,NLD,2021.0,2,1,1
SGP,FIN,2021.0,2,3,-1
MDV,GBR,2012.0,1,1,0
ZAF,ARE,2008.0,1,1,0
LBN,TUR,2020.0,1,2,-1
GRC,POL,2012.0,1,1,0
HKG,ZAF,2017.0,1,1,0
LTU,JPN,2013.0,1,2,-1
BRN,NGA,2021.0,1,4,-3
PRT,SRB,2018.0,1,1,0
PRT,SGP,2015.0,1,3,-2
GHA,SEN,2019.0,1,1,0
KAZ,UKR,2016.0,2,2,0
AUS,PER,2021.0,1,6,-5
THA,TZA,2019.0,1,1,0
PER,BOL,2018.0,1,1,0
CHE,NPL,2018.0,1,1,0
UGA,SWE,2022.0,2,3,-1
TWN,CHL,2022.0,1,1,0
CHE,GIN,2021.0,1,3,-2
TUR,ROU,2014.0,2,3,-1
SHN,USA,2021.0,1,2,-1
NGA,GUY,2020.0,1,4,-3
SAU,AUS,2024.0,1,1,0
FRA,BGD,2018.0,1,2,-1
PAK,MYS,2024.0,1,2,-1
FRA,ARM,2018.0,1,1,0
SWE,MYS,2023.0,2,2,0
ARG,ZAF,2000.0,1,1,0
ESP,AND,2018.0,2,4,-2
IND,KEN,2007.0,1,1,0
BRN,USA,2012.0,1,2,-1
ZWE,CHE,2018.0,2,1,1
USA,UZB,1997.0,1,1,0
KWT,SAU,2000.0,1,3,-2
CAN,ISL,2006.0,1,1,0
HKG,RUS,2007.0,1,1,0
BEN,GBR,2008.0,1,1,0
LUX,SGP,2017.0,1,5,-4
BEL,MLI,2012.0,2,1,1
PRT,DNK,1998.0,1,2,-1
DNK,EST,2023.0,1,3,-2
BEL,ARG,2009.0,1,2,-1
SRB,NZL,2007.0,1,1,0
MAC,ESP,2023.0,2,2,0
NOR,BGR,2008.0,1,1,0
CAN,EST,2012.0,1,2,-1
CZE,UKR,2009.0,1,4,-3
CHN,LKA,2010.0,1,1,0
SVK,RUS,2004.0,1,1,0
DEU,YEM,2019.0,1,1,0
RUS,LTU,2022.0,1,1,0
BFA,JPN,2013.0,1,1,0
NLD,OMN,2011.0,1,2,-1
HUN,PRT,2014.0,2,2,0
MAR,GBR,2011.0,1,1,0
KWT,FRA,2018.0,1,5,-4
ROU,FIN,2019.0,1,5,-4
MEX,KOR,2010.0,2,7,-5
MKD,IRL,2017.0,1,1,0
LKA,DNK,2017.0,1,1,0
BOL,BRA,2010.0,1,3,-2
ZAF,ETH,2011.0,4,7,-3
ROU,RUS,2008.0,1,2,-1
OMN,IRN,2013.0,1,1,0
COL,CHN,2020.0,1,3,-2
CAN,GTM,2022.0,1,1,0
SEN,CAN,2011.0,1,2,-1
LVA,DNK,2017.0,1,1,0
HUN,IRN,2020.0,2,5,-3
JPN,ZAF,2022.0,1,3,-2
CHN,GIN,2018.0,1,1,0
COG,UGA,2007.0,1,1,0
MYS,NOR,2013.0,2,1,1
USA,MMR,2023.0,2,1,1
PER,CRI,2018.0,1,1,0
COG,ZWE,2006.0,1,1,0
IRL,PRT,1998.0,1,1,0
CHE,CMR,2000.0,1,1,0
CIV,DEU,2011.0,2,2,0
BEL,BIH,2003.0,1,1,0
SWE,TUR,2006.0,1,5,-4
BGD,THA,2001.0,1,3,-2
SVK,ROU,2020.0,1,2,-1
HUN,SAU,2017.0,1,3,-2
MDG,GUF,2000.0,1,1,0
SAU,KWT,2000.0,3,1,2
KEN,GHA,1997.0,1,1,0
LTU,SWE,1999.0,1,5,-4
TZA,USA,1997.0,1,7,-6
IND,SYR,2006.0,1,2,-1
GBR,GEO,2010.0,1,1,0
CHE,ETH,2001.0,1,1,0
PRT,ISR,2000.0,1,1,0
NZL,FIN,2003.0,1,2,-1
CHN,IND,2004.0,2,7,-5
CAN,BGR,2008.0,2,3,-1
UKR,FIN,2007.0,1,1,0
DEU,BIH,2019.0,1,2,-1
VNM,EST,2020.0,1,1,0
ETH,NOR,2010.0,2,4,-2
IRN,PER,2021.0,2,2,0
NGA,CHE,2013.0,1,2,-1
FRA,COD,2013.0,1,2,-1
SRB,CZE,2011.0,2,1,1
LBN,JOR,2012.0,1,1,0
QAT,DEU,2011.0,1,4,-3
SAU,NLD,2013.0,1,6,-5
DEU,CIV,2018.0,2,1,1
KHM,PHL,2010.0,1,3,-2
POL,EST,2019.0,1,2,-1
SAU,TUN,2010.0,3,20,-17
CHE,JOR,2010.0,1,1,0
ROU,IND,2016.0,1,2,-1
BEN,BEL,2009.0,1,6,-5
EST,CAN,2003.0,1,1,0
MYS,MMR,2022.0,1,3,-2
PAK,VNM,2021.0,1,13,-12
SYR,IRN,2019.0,1,2,-1
FRA,SVK,2005.0,1,8,-7
FRA,ARM,2016.0,1,3,-2
KWT,CAN,1999.0,1,5,-4
PHL,SGP,2011.0,1,3,-2
JPN,SVK,2002.0,1,4,-3
AUS,BGR,2001.0,1,5,-4
BRN,AUS,2001.0,1,6,-5
SWE,HKG,2001.0,1,1,0
BGD,NPL,2013.0,1,1,0
EGY,SYR,1998.0,1,1,0
ESP,CYP,2016.0,2,1,1
SAU,GRC,2020.0,1,9,-8
KOR,THA,1999.0,1,1,0
BGR,ISR,2009.0,1,2,-1
USA,SEN,1997.0,1,3,-2
USA,RWA,1998.0,1,1,0
OMN,IND,1998.0,1,7,-6
NOR,SVK,2021.0,1,2,-1
MEX,NGA,2019.0,1,2,-1
GEO,CHN,2018.0,1,2,-1
SAU,AUT,2013.0,1,4,-3
CMR,CHE,2016.0,1,3,-2
EST,AUT,2013.0,1,2,-1
DEU,BHR,2013.0,1,2,-1
AUT,ARE,2016.0,1,1,0
KEN,MWI,2013.0,1,5,-4
URY,AUS,2017.0,1,1,0
URY,AUS,2022.0,2,3,-1
CZE,SGP,2016.0,1,1,0
PAK,RUS,2023.0,1,1,0
UGA,JPN,2014.0,1,1,0
MYS,MMR,2018.0,1,2,-1
NPL,DNK,2015.0,1,1,0
PRY,BRA,2007.0,1,1,0
IND,ERI,2020.0,1,3,-2
SYR,EGY,2012.0,1,2,-1
MAC,SGP,2021.0,1,4,-3
CZE,LBN,2018.0,1,1,0
CZE,SVN,2020.0,1,5,-4
SYR,JOR,2018.0,1,2,-1
EGY,KEN,2021.0,1,4,-3
COL,KOR,2019.0,1,1,0
PRI,CHN,2005.0,1,3,-2
GIN,NER,2021.0,1,1,0
ESP,QAT,2022.0,2,2,0
SLV,MEX,2022.0,1,1,0
MEX,SLV,2023.0,1,1,0
SAU,PRT,2023.0,1,2,-1
SVK,ESP,2017.0,2,2,0
CAN,PER,2002.0,1,3,-2
ISR,PAK,2015.0,1,1,0
ZWE,SWE,1998.0,2,1,1
JOR,EGY,2012.0,2,2,0
USA,ASM,1999.0,1,2,-1
SWE,ARE,2008.0,1,3,-2
DNK,ARE,2012.0,1,1,0
CHN,PHL,2001.0,1,4,-3
OMN,KWT,1998.0,1,1,0
NOR,IRL,2009.0,1,4,-3
ISR,ZAF,1999.0,1,1,0
KWT,AUS,1998.0,1,1,0
CHE,MDG,2015.0,1,1,0
ARG,DOM,2020.0,1,1,0
BRB,TTO,2017.0,2,1,1
ARE,SDN,2015.0,1,3,-2
SRB,ARE,2015.0,1,1,0
EST,BLR,2020.0,1,2,-1
USA,TCD,2018.0,1,1,0
SLE,CHE,2017.0,2,4,-2
UKR,FIN,2020.0,1,1,0
ARE,DZA,2020.0,1,1,0
MEX,ZAF,2011.0,1,1,0
MEX,ZAF,2019.0,1,5,-4
DZA,GBR,2011.0,1,3,-2
QAT,KWT,2023.0,1,3,-2
BGR,HUN,2017.0,1,1,0
POL,BLR,2011.0,2,3,-1
CPV,PRT,2020.0,1,3,-2
DEU,PER,2012.0,1,5,-4
OMN,KOR,2018.0,1,5,-4
ETH,ISR,2008.0,1,1,0
DEU,GAB,2015.0,1,10,-9
JOR,ESP,2010.0,1,2,-1
MMR,AUS,2021.0,1,6,-5
KOR,ESP,1999.0,1,3,-2
ARE,KOR,2024.0,1,2,-1
NPL,BGD,2012.0,1,2,-1
CZE,IND,2024.0,1,1,0
KEN,BEL,2007.0,1,8,-7
CYP,ITA,1999.0,1,2,-1
LVA,CHE,2002.0,1,2,-1
SWE,UGA,2006.0,1,2,-1
BFA,ITA,2017.0,2,1,1
NZL,TUR,2003.0,1,1,0
MEX,ZAF,2009.0,1,2,-1
NZL,MYS,2004.0,1,1,0
DEU,VNM,1997.0,2,1,1
BEL,UZB,2001.0,1,3,-2
MNE,SRB,2001.0,2,4,-2
ITA,CUB,1999.0,1,1,0
THA,CYP,2020.0,1,1,0
ITA,HKG,2010.0,1,1,0
PRY,ESP,2017.0,1,3,-2
PAK,IRQ,2012.0,1,1,0
AZE,TUR,2014.0,1,9,-8
LBY,CAN,2012.0,1,1,0
LCA,TTO,2011.0,1,1,0
BRN,AUS,2014.0,1,1,0
TWN,ITA,2015.0,1,4,-3
ISR,KEN,1998.0,1,1,0
KEN,ISR,2007.0,1,1,0
SHN,GBR,2020.0,1,1,0
JPN,DZA,2002.0,2,1,1
TWN,MAR,2014.0,1,6,-5
ESP,NIC,2016.0,1,1,0
URY,CHL,2023.0,1,1,0
MWI,ETH,2016.0,1,1,0
EST,CHE,2021.0,1,4,-3
ARG,THA,2021.0,2,1,1
PHL,NLD,2010.0,1,2,-1
BWA,DEU,2007.0,1,1,0
ECU,GBR,2012.0,1,2,-1
GRC,RUS,2005.0,2,2,0
GEO,FRA,2010.0,1,2,-1
PAK,AFG,2010.0,1,1,0
FRA,EST,2013.0,1,1,0
TZA,DNK,2015.0,1,2,-1
WSM,NZL,2016.0,1,3,-2
GUY,GBR,2013.0,1,1,0
AUS,MWI,2009.0,1,2,-1
DOM,PAN,2021.0,1,1,0
PAK,SGP,2018.0,1,7,-6
ARG,PAN,2009.0,1,1,0
MKD,SVN,2017.0,1,1,0
PRT,PRI,2005.0,1,1,0
TJK,RUS,2017.0,1,4,-3
SVN,SWE,2001.0,1,1,0
LKA,MYS,2013.0,1,5,-4
NGA,PRT,2019.0,1,4,-3
SEN,GIN,2013.0,1,1,0
POL,KOR,2006.0,1,1,0
IDN,NGA,2018.0,1,1,0
VNM,RUS,2011.0,1,7,-6
ZAF,SGP,2010.0,1,1,0
ARG,POL,1998.0,1,1,0
CHE,JOR,2006.0,1,1,0
ARE,ITA,2016.0,1,16,-15
HND,USA,2003.0,1,4,-3
TUR,GRC,2009.0,1,5,-4
BGR,PRT,2006.0,1,1,0
MWI,DEU,2006.0,1,1,0
KEN,ISR,1998.0,1,1,0
NGA,NER,2003.0,1,4,-3
BWA,TZA,2022.0,1,1,0
IRQ,LBN,2016.0,1,3,-2
VNM,THA,2001.0,1,2,-1
TUR,ARE,2007.0,1,1,0
LBY,CAN,2005.0,1,1,0
MKD,BGR,2013.0,1,1,0
JOR,IRQ,2009.0,1,6,-5
TZA,MWI,2016.0,1,1,0
PRT,GRC,2000.0,1,1,0
FRA,COG,2001.0,2,7,-5
NGA,ITA,2015.0,2,4,-2
ROU,TWN,2005.0,1,1,0
PHL,CHE,2021.0,1,2,-1
LKA,GHA,2013.0,1,1,0
CAN,SYR,2017.0,1,1,0
BDI,GBR,2011.0,1,1,0
KEN,NOR,2014.0,1,1,0
BRA,SGP,2010.0,1,2,-1
POL,TWN,2020.0,1,1,0
ECU,ARG,2011.0,1,3,-2
DNK,CRI,2015.0,1,1,0
COL,NZL,2014.0,1,1,0
BHR,MYS,2016.0,1,1,0
IRL,HKG,2006.0,1,1,0
UZB,AUS,2023.0,1,1,0
FRA,TZA,2018.0,1,1,0
TZA,NLD,2016.0,1,9,-8
FRA,MRT,2018.0,1,3,-2
TUN,GBR,2006.0,1,1,0
MWI,GBR,1997.0,1,3,-2
NGA,UGA,2006.0,1,1,0
BHR,USA,2005.0,1,3,-2
NLD,NGA,2004.0,1,1,0
WSM,AUS,2014.0,1,4,-3
JOR,JPN,2001.0,1,1,0
JPN,MWI,2014.0,1,1,0
ZAF,SWE,1997.0,1,1,0
ISR,IRN,2005.0,1,1,0
URY,ITA,2011.0,1,1,0
ESP,GNQ,2003.0,1,1,0
CZE,SRB,2011.0,1,2,-1
MEX,JPN,2000.0,1,6,-5
COD,GBR,1997.0,1,1,0
NLD,JOR,2002.0,1,1,0
SWE,BGR,2011.0,1,2,-1
GRC,AUT,2000.0,1,1,0
ARE,IRN,2008.0,1,2,-1
SWE,SVK,2007.0,1,3,-2
ARG,VEN,2003.0,1,1,0
COD,SEN,2020.0,1,1,0
IND,IRL,2000.0,1,1,0
PER,DNK,1999.0,1,2,-1
SRB,CAN,2002.0,1,3,-2
CAN,LVA,2012.0,1,2,-1
RUS,ROU,2011.0,1,2,-1
PRT,BGR,2003.0,1,1,0
PNG,CHE,2014.0,1,1,0
ESP,LUX,2011.0,1,1,0
GBR,KAZ,2003.0,1,1,0
CAN,PSE,2017.0,1,1,0
BRB,IND,2022.0,1,2,-1
ITA,COL,1997.0,1,1,0
PAK,IND,2000.0,1,4,-3
RUS,PRI,1999.0,1,2,-1
FRA,COD,2003.0,1,2,-1
CRI,ESP,2002.0,1,5,-4
FIN,SAU,2018.0,1,3,-2
DZA,CHE,2010.0,1,1,0
PHL,NLD,2006.0,1,3,-2
NLD,ZWE,2012.0,1,3,-2
TUR,SWE,2004.0,1,2,-1
NLD,MWI,2001.0,1,2,-1
CRI,GBR,2010.0,1,1,0
DNK,LVA,2003.0,1,1,0
HKG,THA,2007.0,1,1,0
BEL,CMR,2007.0,1,4,-3
ZAF,IRN,2013.0,1,8,-7
CAN,SYR,2016.0,1,1,0
KOR,BGD,2004.0,1,3,-2
BRA,ISR,2007.0,1,2,-1
IRL,ISR,2022.0,1,4,-3
DEU,PAN,2011.0,1,2,-1
MEX,ECU,2000.0,1,1,0
NLD,MLT,2023.0,1,1,0
GLP,USA,2017.0,1,2,-1
MEX,KEN,2017.0,1,1,0
CHE,MYS,2017.0,1,3,-2
FRA,ZWE,2004.0,1,2,-1
COL,BOL,2016.0,1,1,0
SRB,IRL,2009.0,1,2,-1
ECU,DEU,2010.0,1,2,-1
EGY,PSE,2009.0,1,2,-1
AUT,IRL,2017.0,2,4,-2
GBR,IRN,2024.0,1,1,0
QAT,IRL,2018.0,1,3,-2
MYS,GHA,2013.0,1,2,-1
LAO,FRA,2010.0,1,1,0
MUS,AUS,2018.0,1,3,-2
LKA,AUT,2022.0,1,1,0
NOR,PRT,2015.0,1,11,-10
POL,MEX,2013.0,3,1,2
NOR,ETH,2009.0,4,4,0
ECU,FRA,2002.0,2,4,-2
BEL,SAU,2014.0,6,1,5
MEX,GTM,2019.0,4,2,2
CHN,THA,2011.0,5,12,-7
KAZ,GRC,2018.0,1,2,-1
FRA,NER,2021.0,4,4,0
PRT,ROU,2016.0,2,1,1
MLT,AUS,2023.0,1,1,0
DEU,MAR,2021.0,3,11,-8
DNK,TWN,2022.0,2,3,-1
DZA,ITA,2016.0,4,9,-5
ARE,SWE,2008.0,3,1,2
UKR,ITA,2001.0,1,4,-3
GBR,TUN,2019.0,1,1,0
ETH,NOR,2011.0,2,5,-3
SRB,SVN,2018.0,6,1,5
OMN,ARE,1999.0,4,5,-1
IND,ITA,2004.0,15,7,8
BRA,MOZ,2015.0,10,2,8
SEN,NCL,2004.0,2,1,1
ETH,GHA,2022.0,1,1,0
AUS,CRI,2022.0,2,1,1
GAB,FRA,2010.0,6,6,0
ECU,NLD,2015.0,4,8,-4
FRA,ISL,2013.0,5,2,3
MRT,SAU,2017.0,1,2,-1
NZL,NOR,2017.0,9,1,8
MAR,COD,2020.0,2,1,1
ARG,ECU,2018.0,10,3,7
AZE,FRA,2021.0,1,2,-1
JOR,EGY,2020.0,12,7,5
ROU,ESP,2021.0,8,9,-1
DEU,TUN,2023.0,5,3,2
GRC,BGR,2022.0,3,2,1
CUB,JPN,1999.0,1,1,0
CHN,GRC,2006.0,2,1,1
ESP,UKR,2013.0,5,4,1
GUM,USA,2010.0,6,4,2
ITA,BGR,2003.0,8,11,-3
MEX,SWE,2008.0,1,5,-4
HUN,CZE,1997.0,2,3,-1
PER,SWE,2013.0,1,1,0
URY,BRA,2016.0,3,11,-8
DNK,IDN,2013.0,1,1,0
TZA,FIN,2011.0,1,2,-1
NGA,GHA,2018.0,7,5,2
AUT,SRB,2005.0,2,6,-4
POL,ESP,1997.0,1,8,-7
CAN,BGD,2002.0,3,3,0
USA,BLR,2012.0,1,4,-3
THA,SWE,2003.0,2,9,-7
BEL,HRV,2019.0,4,1,3
ITA,SEN,2019.0,1,1,0
ARG,VEN,2014.0,4,3,1
USA,BGR,1999.0,8,31,-23
UKR,BEL,2014.0,2,2,0
ITA,IRL,1999.0,4,11,-7
LVA,USA,2018.0,3,6,-3
LTU,JPN,2001.0,3,1,2
AUS,ROU,2016.0,2,4,-2
GNB,SWE,2005.0,1,1,0
DEU,CRI,2020.0,7,8,-1
BGD,IDN,2010.0,1,1,0
NGA,FRA,2017.0,2,1,1
TUR,SRB,2005.0,1,3,-2
IND,THA,2003.0,2,1,1
IRQ,EGY,2013.0,1,2,-1
CRI,CAN,2021.0,2,4,-2
LBN,JPN,2021.0,1,1,0
FRA,BGR,2023.0,1,2,-1
CAN,VEN,2007.0,1,3,-2
MEX,AUT,2018.0,5,4,1
MYS,PRT,2008.0,1,1,0
PRT,AUT,2005.0,1,5,-4
DZA,DEU,2004.0,4,5,-1
USA,VIR,2020.0,6,1,5
NLD,VNM,1999.0,2,1,1
HKG,NGA,2000.0,1,0,1
LAO,DNK,2001.0,1,0,1
BEN,MDG,2020.0,1,0,1
HKG,SAU,2005.0,2,0,2
TUN,IRL,2020.0,1,0,1
CHN,MNE,2018.0,1,0,1
MNE,USA,2021.0,1,0,1
MEX,NOR,2011.0,1,0,1
NGA,JOR,2011.0,1,0,1
CMR,CZE,2010.0,1,0,1
CZE,CMR,2013.0,1,0,1
CHE,CYP,2009.0,2,0,2
CYP,CHE,2008.0,1,0,1
UZB,AUS,2006.0,1,0,1
LBY,BGR,2013.0,1,0,1
VCT,ZAF,2006.0,1,0,1
ARM,CHN,2012.0,1,0,1
SVN,NZL,2018.0,1,0,1
DEU,NAM,2002.0,1,0,1
LTU,RUS,2016.0,1,0,1
,VCT,2011.0,3,0,3
CYP,DNK,2018.0,1,0,1
SWE,SEN,2017.0,1,0,1
LAO,IDN,2018.0,1,0,1
ISR,PER,2020.0,1,0,1
MAR,YEM,2014.0,1,0,1
BEN,KEN,2015.0,1,0,1
ISR,ARE,2012.0,1,0,1
IRN,IDN,2012.0,1,0,1
GRD,CAN,2016.0,1,0,1
KEN,MOZ,2023.0,1,0,1
KWT,ZAF,2018.0,1,0,1
TWN,SRB,2018.0,1,0,1
MDG,REU,2021.0,1,0,1
TWN,STP,2020.0,1,0,1
UZB,KOR,2012.0,1,0,1
PER,CHN,2001.0,1,0,1
SVN,JPN,2019.0,1,0,1
MDA,GBR,2019.0,1,0,1
GLP,BRA,2018.0,1,0,1
OMN,BEL,2021.0,1,0,1
HKG,PRT,2016.0,1,0,1
FIN,DZA,2023.0,1,0,1
MEX,PRY,2023.0,1,0,1
FRA,AGO,2023.0,1,0,1
,ATA,2019.0,1,0,1
ITA,AUS,2024.0,1,0,1
BLR,LUX,2023.0,1,0,1
CHL,HND,2021.0,1,0,1
ARM,GRC,1999.0,1,0,1
AUS,URY,2002.0,1,0,1
NLD,SDN,2011.0,1,0,1
DEU,NER,2006.0,1,0,1
GRC,NPL,1999.0,1,0,1
NOR,JOR,2000.0,1,0,1
UZB,PAK,2011.0,1,0,1
UKR,BGR,2003.0,1,0,1
IRL,DNK,1998.0,2,0,2
TUN,PAK,2010.0,1,0,1
VEN,KWT,2005.0,1,0,1
NOR,AZE,2017.0,1,0,1
FIN,KAZ,2021.0,1,0,1
AUS,MMR,2003.0,1,0,1
CZE,BIH,2006.0,1,0,1
SGP,GRC,2005.0,1,0,1
ZWE,TZA,1997.0,1,0,1
BEL,JOR,2002.0,1,0,1
IRQ,LBY,1998.0,1,0,1
ZMB,NLD,2000.0,1,0,1
MOZ,PSE,2007.0,1,0,1
CHL,BEL,1999.0,1,0,1
KOR,FJI,2022.0,1,0,1
SWZ,CHE,1997.0,1,0,1
NGA,DMA,2003.0,1,0,1
BGD,NGA,1998.0,1,0,1
CHE,AZE,2018.0,1,0,1
VEN,QAT,2018.0,3,0,3
ARE,ARM,2003.0,1,0,1
JPN,MWI,2004.0,1,0,1
TWN,POL,2005.0,1,0,1
AUS,EST,2013.0,1,0,1
BFA,ZAF,1997.0,1,0,1
HRV,BRA,2001.0,1,0,1
TZA,GHA,2005.0,1,0,1
IRN,ESP,1997.0,1,0,1
POL,PER,2018.0,1,0,1
PYF,CHE,2009.0,1,0,1
SEN,BEN,2020.0,1,0,1
PRY,ARG,2000.0,1,0,1
AUT,LKA,2017.0,1,0,1
SWE,CMR,2013.0,1,0,1
MDA,JOR,2005.0,1,0,1
SWZ,ISR,2009.0,1,0,1
JAM,KWT,2023.0,1,0,1
DEU,BLZ,2009.0,1,0,1
ISL,ISR,2017.0,1,0,1
GHA,TZA,2014.0,2,0,2
,GNQ,2005.0,2,0,2
TWN,POL,2012.0,1,0,1
FRA,HTI,2006.0,1,0,1
OMN,PSE,2021.0,1,0,1
RWA,IDN,2023.0,1,0,1
SRB,NLD,2008.0,3,0,3
CMR,ITA,2023.0,1,0,1
DZA,TZA,2021.0,1,0,1
GUY,GHA,2021.0,1,0,1
HND,MEX,2001.0,1,0,1
AUS,MHL,2002.0,1,0,1
ABW,,2021.0,1,0,1
BGD,EGY,1998.0,1,0,1
BGR,NOR,2007.0,1,0,1
GEO,CAN,2003.0,1,0,1
GBR,JEY,2022.0,1,0,1
ALB,NLD,2010.0,1,0,1
NIC,MEX,1998.0,1,0,1
MEX,NIC,1999.0,1,0,1
ZWE,NAM,2012.0,1,0,1
RWA,IRL,2015.0,1,0,1
IRL,UGA,2017.0,1,0,1
ITA,MDV,2018.0,2,0,2
CYM,,2013.0,1,0,1
SVN,IDN,2017.0,1,0,1
HUN,TWN,2013.0,1,0,1
CZE,GEO,2012.0,1,0,1
,GUM,2008.0,1,0,1
AUS,GUM,2022.0,1,0,1
GEO,NGA,2022.0,1,0,1
BTN,SGP,2023.0,1,0,1
CHE,KGZ,2012.0,1,0,1
DMA,BRB,2019.0,1,0,1
NZL,NAM,2011.0,1,0,1
REU,GBR,2020.0,1,0,1
MDA,GBR,2011.0,1,0,1
WSM,AUS,2008.0,1,0,1
MLT,HRV,2013.0,1,0,1
HUN,SVK,2000.0,1,0,1
JAM,GBR,2023.0,1,0,1
IND,ZMB,2014.0,1,0,1
NPL,MDV,2020.0,2,0,2
ERI,IRQ,2012.0,1,0,1
SVK,ZAF,2020.0,1,0,1
TGO,BEL,2018.0,1,0,1
KOR,MMR,2019.0,2,0,2
CHL,PRI,2018.0,1,0,1
ESP,ATG,2020.0,1,0,1
LBN,BRA,2021.0,1,0,1
PHL,HRV,2017.0,1,0,1
ZAF,LTU,2018.0,1,0,1
FIN,BRA,2024.0,1,0,1
CHL,FIN,2015.0,1,0,1
BGD,TWN,2018.0,1,0,1
NZL,BTN,2020.0,2,0,2
PHL,LAO,2020.0,1,0,1
CHN,JOR,1999.0,1,0,1
THA,OMN,2019.0,1,0,1
ARM,GBR,2003.0,2,0,2
AUT,PER,2020.0,1,0,1
ZAF,TTO,2021.0,1,0,1
GBR,BLZ,2004.0,1,0,1
SVK,ISR,2011.0,1,0,1
PHL,DNK,2005.0,1,0,1
BGD,ZAF,2001.0,1,0,1
AUS,ASM,2003.0,1,0,1
CHE,KHM,2002.0,1,0,1
GBR,NER,2020.0,1,0,1
BGD,SAU,2006.0,1,0,1
SRB,IND,2010.0,1,0,1
CHE,MAR,2016.0,1,0,1
GEO,UKR,2014.0,1,0,1
HUN,VNM,2002.0,1,0,1
NPL,UZB,2010.0,1,0,1
BIH,NLD,2022.0,1,0,1
PAN,CYP,2003.0,1,0,1
SGP,TTO,2006.0,1,0,1
CPV,CAN,2012.0,1,0,1
NOR,YEM,2008.0,1,0,1
CHN,NAM,2017.0,1,0,1
MLI,NZL,2015.0,1,0,1
KEN,PAK,2014.0,1,0,1
FRO,DNK,2017.0,1,0,1
MLI,IND,2014.0,1,0,1
ZMB,BWA,2008.0,1,0,1
UZB,TUR,2004.0,1,0,1
ARM,SWE,2003.0,1,0,1
CHN,YEM,2004.0,1,0,1
AZE,KAZ,2012.0,2,0,2
SGP,ARG,2008.0,1,0,1
IND,SDN,2013.0,1,0,1
AUS,ZMB,2012.0,1,0,1
ARE,VNM,2024.0,1,0,1
ARE,CYP,2002.0,1,0,1
PSE,IRQ,2020.0,1,0,1
SVN,ALB,2021.0,1,0,1
TJK,RUS,2016.0,2,0,2
TKL,,2019.0,1,0,1
BIH,NOR,2023.0,1,0,1
BIH,BRA,2020.0,1,0,1
LBR,IRL,2020.0,1,0,1
BEN,BDI,2021.0,1,0,1
ITA,IRQ,2011.0,1,0,1
NGA,AZE,2020.0,1,0,1
TZA,RUS,2021.0,1,0,1
SWE,HKG,2008.0,1,0,1
SWZ,KHM,2019.0,1,0,1
ITA,WSM,2012.0,1,0,1
BRA,NOR,1999.0,1,0,1
ZWE,UGA,2009.0,2,0,2
NZL,UGA,2015.0,1,0,1
ARE,NZL,2007.0,1,0,1
MLT,RUS,2008.0,1,0,1
USA,MTQ,2011.0,1,0,1
AUS,LVA,2007.0,1,0,1
PYF,ZAF,2017.0,1,0,1
ARM,TWN,2012.0,2,0,2
TWN,ARM,2019.0,1,0,1
,PRK,2007.0,9,0,9
SEN,PHL,2014.0,1,0,1
SRB,CHN,2013.0,1,0,1
GMB,NLD,2010.0,1,0,1
HUN,CHL,2012.0,1,0,1
COL,IDN,2023.0,1,0,1
BEN,IND,2023.0,1,0,1
SEN,TGO,2019.0,1,0,1
COL,CRI,2005.0,1,0,1
UGA,AUS,2012.0,1,0,1
ROU,KAZ,2016.0,1,0,1
IRN,CAF,2019.0,1,0,1
JPN,NAM,2017.0,1,0,1
MKD,CHN,2015.0,1,0,1
IDN,LKA,2001.0,1,0,1
MCO,ITA,2013.0,1,0,1
DNK,SAU,2016.0,1,0,1
CHL,PRI,2022.0,1,0,1
PHL,BGD,2000.0,1,0,1
ITA,VEN,2023.0,1,0,1
GRC,PSE,2010.0,1,0,1
BEL,SYR,2020.0,1,0,1
CAN,SDN,2016.0,1,0,1
BLR,SGP,2016.0,1,0,1
SRB,BEN,2022.0,1,0,1
GUY,VEN,2017.0,1,0,1
AGO,DNK,2015.0,1,0,1
NAM,GBR,2023.0,1,0,1
BRA,MWI,2014.0,1,0,1
AGO,GHA,2011.0,1,0,1
OMN,TUR,2020.0,1,0,1
AZE,SAU,2015.0,1,0,1
DEU,PRK,2018.0,1,0,1
CMR,NAM,2021.0,1,0,1
BEL,KHM,2017.0,1,0,1
MOZ,NGA,2022.0,1,0,1
AUS,AFG,2019.0,1,0,1
ZAF,BTN,2016.0,1,0,1
GMB,GNB,2016.0,1,0,1
CHE,VGB,2018.0,1,0,1
SWE,AFG,2018.0,1,0,1
UKR,TWN,2017.0,2,0,2
BRA,KAZ,2023.0,1,0,1
MUS,THA,2018.0,1,0,1
IND,MDV,2018.0,1,0,1
HUN,COL,2014.0,1,0,1
KOR,PAK,2024.0,2,0,2
IRQ,CZE,2022.0,1,0,1
CUB,AUT,2006.0,1,0,1
MYS,CUB,2021.0,1,0,1
BRA,NPL,2023.0,1,0,1
NGA,UKR,2021.0,1,0,1
ETH,OMN,2021.0,1,0,1
AFG,MMR,2021.0,1,0,1
JPN,SDN,2021.0,2,0,2
BLR,IND,1997.0,1,0,1
AUT,BTN,2008.0,1,0,1
DEU,DMA,2007.0,1,0,1
COG,DEU,2020.0,1,0,1
BRA,HRV,2000.0,1,0,1
SAU,BGR,2005.0,1,0,1
ITA,SEN,2023.0,1,0,1
DEU,BEN,2002.0,1,0,1
UKR,ZAF,1998.0,1,0,1
MLT,ITA,2002.0,1,0,1
SRB,VEN,2004.0,1,0,1
KGZ,GBR,2004.0,1,0,1
CMR,SWE,2000.0,1,0,1
KOR,ARG,2007.0,1,0,1
LVA,ESP,2023.0,1,0,1
SYR,AUS,2003.0,1,0,1
SVN,LVA,2003.0,1,0,1
LVA,CZE,2020.0,1,0,1
SRB,MEX,2006.0,1,0,1
UGA,KEN,1997.0,1,0,1
TUR,CZE,2004.0,1,0,1
BDI,RWA,2005.0,1,0,1
VEN,NOR,2014.0,1,0,1
RUS,URY,1999.0,1,0,1
LAO,CHN,2009.0,1,0,1
MEX,KEN,2018.0,1,0,1
SAU,BEL,2004.0,1,0,1
TUR,EST,2021.0,1,0,1
ATG,VCT,2009.0,1,0,1
NIC,DEU,2011.0,1,0,1
KEN,SDN,2013.0,1,0,1
SDN,KEN,2014.0,1,0,1
ETH,OMN,2009.0,1,0,1
BRA,TTO,2018.0,1,0,1
LSO,IRL,2011.0,1,0,1
SDN,LBN,2013.0,1,0,1
DNK,MDG,2007.0,1,0,1
MYS,BHR,2012.0,2,0,2
JOR,EGY,1997.0,1,0,1
WSM,IND,2013.0,1,0,1
NZL,BRB,2010.0,1,0,1
JPN,KWT,2018.0,1,0,1
DZA,CZE,2018.0,1,0,1
BFA,DNK,2013.0,1,0,1
ETH,ESP,2013.0,1,0,1
NCL,CHE,2016.0,1,0,1
UGA,OMN,2021.0,1,0,1
PYF,BFA,2011.0,1,0,1
BIH,IDN,2014.0,1,0,1
CHE,OMN,2014.0,1,0,1
OMN,NZL,2022.0,1,0,1
MAC,THA,2022.0,1,0,1
NOR,NIC,2009.0,1,0,1
LBN,CHE,1998.0,1,0,1
JOR,GRC,2009.0,1,0,1
JAM,IRL,2015.0,1,0,1
NZL,JOR,2017.0,1,0,1
COL,HND,2021.0,1,0,1
IRQ,DZA,2013.0,1,0,1
ROU,SVK,2021.0,1,0,1
HUN,NGA,2013.0,1,0,1
TUR,BLR,2015.0,1,0,1
EGY,TUN,2018.0,1,0,1
MAC,NAM,2022.0,1,0,1
ESP,KHM,2018.0,1,0,1
LBR,FRA,2015.0,1,0,1
HRV,KWT,2013.0,1,0,1
BRB,BHS,2016.0,1,0,1
DEU,MAC,2023.0,1,0,1
,ASM,2015.0,1,0,1
CAN,AFG,2010.0,1,0,1
PRT,SEN,2018.0,1,0,1
JAM,BHS,2005.0,1,0,1
CUB,URY,2008.0,1,0,1
ARM,KAZ,2021.0,1,0,1
LBN,DNK,2021.0,1,0,1
DNK,VNM,2010.0,1,0,1
HUN,CRI,2021.0,1,0,1
ETH,CMR,2023.0,1,0,1
TUV,,2025.0,6,0,6
BTN,NZL,2022.0,1,0,1
KAZ,AZE,2023.0,1,0,1
ARM,CHL,2023.0,1,0,1
NIC,DNK,2014.0,1,0,1
BIH,FRA,2023.0,1,0,1
CMR,ZWE,2004.0,1,0,1
NOR,CHL,2003.0,1,0,1
BLR,AUS,2000.0,1,0,1
OMN,CHN,2002.0,1,0,1
MDG,HTI,2003.0,1,0,1
BEL,VEN,2005.0,1,0,1
ISR,CYP,2004.0,1,0,1
GTM,CHE,2012.0,1,0,1
UKR,SGP,1998.0,1,0,1
SDN,QAT,2000.0,1,0,1
CAN,UZB,2011.0,1,0,1
BLR,ESP,2000.0,1,0,1
BGR,AUS,2007.0,1,0,1
CIV,CAN,1999.0,1,0,1
KOR,MKD,2018.0,1,0,1
ISR,NZL,2021.0,1,0,1
CMR,COG,2004.0,1,0,1
AUS,SVK,1997.0,1,0,1
OMN,JPN,1999.0,1,0,1
GUF,CIV,2010.0,1,0,1
AUS,MCO,2006.0,1,0,1
TWN,ITA,2001.0,2,0,2
LBY,BGD,2008.0,1,0,1
KHM,CMR,2015.0,1,0,1
NPL,MYS,2008.0,1,0,1
MLT,JPN,2003.0,1,0,1
TZA,MWI,2017.0,1,0,1
IRL,VEN,2011.0,2,0,2
BOL,VEN,2019.0,1,0,1
AZE,TUN,2011.0,1,0,1
TUN,POL,2010.0,1,0,1
GAB,JPN,2015.0,1,0,1
CMR,RWA,2022.0,1,0,1
CAF,TUN,2013.0,1,0,1
COG,GBR,2006.0,1,0,1
RUS,HRV,2023.0,1,0,1
NZL,MAC,2008.0,1,0,1
NOR,KEN,2016.0,1,0,1
TZA,ITA,2008.0,1,0,1
BGD,LUX,2021.0,1,0,1
PAK,FIN,2012.0,1,0,1
THA,HUN,2011.0,1,0,1
HUN,THA,2012.0,1,0,1
ZAF,COL,2020.0,2,0,2
IND,NER,2020.0,1,0,1
POL,SVN,2017.0,1,0,1
CUB,NOR,2018.0,1,0,1
FRA,JAM,2021.0,1,0,1
ATG,IND,2019.0,1,0,1
KOR,SRB,2023.0,1,0,1
NPL,ERI,2002.0,1,0,1
,BEN,2021.0,1,0,1
MLI,GHA,2011.0,1,0,1
COL,GTM,2019.0,1,0,1
ITA,SOM,2022.0,1,0,1
LBY,MUS,2023.0,1,0,1
ZAF,TUR,1998.0,1,0,1
SEN,ZAF,2002.0,2,0,2
BRN,AUS,2004.0,1,0,1
ROU,ISR,2010.0,1,0,1
PRY,BRA,1999.0,1,0,1
SRB,BLR,2006.0,2,0,2
AUS,UKR,1997.0,1,0,1
NOR,SGP,1998.0,1,0,1
UZB,PRT,2010.0,1,0,1
TUN,EGY,2008.0,1,0,1
NLD,PSE,2005.0,1,0,1
HND,MEX,2014.0,1,0,1
COG,GBR,2000.0,1,0,1
HRV,CHN,2004.0,1,0,1
LBY,TUN,1997.0,1,0,1
PRI,CHE,1998.0,1,0,1
LKA,KOR,2000.0,1,0,1
ZMB,CHN,2014.0,1,0,1
MYS,CYP,2014.0,1,0,1
GRC,BHR,2017.0,1,0,1
CZE,PRT,2012.0,2,0,2
AUT,TWN,2018.0,1,0,1
DNK,NGA,2015.0,1,0,1
NGA,LBN,2023.0,1,0,1
TWN,ARE,2016.0,1,0,1
BOL,JOR,2013.0,1,0,1
SWE,KWT,2017.0,1,0,1
KWT,SWE,2021.0,1,0,1
DNK,BIH,2019.0,1,0,1
SDN,IRN,2015.0,1,0,1
SLV,URY,2018.0,1,0,1
JPN,YEM,2019.0,1,0,1
YEM,CHE,2023.0,1,0,1
TON,,2014.0,1,0,1
MAR,NLD,2019.0,1,0,1
JOR,SGP,2018.0,1,0,1
CMR,LBR,2020.0,1,0,1
COL,SRB,2019.0,1,0,1
SWE,PRT,2024.0,1,0,1
TTO,KNA,2023.0,2,0,2
NIC,DEU,2019.0,1,0,1
NZL,POL,2014.0,1,0,1
CHE,ETH,2004.0,1,0,1
POL,MNG,2023.0,1,0,1
ESP,HKG,2003.0,2,0,2
LKA,POL,2022.0,1,0,1
MWI,COD,2023.0,1,0,1
PAN,DEU,2022.0,1,0,1
AUS,WSM,2023.0,1,0,1
ROU,EST,2022.0,1,0,1
VUT,NCL,2013.0,1,0,1
GBR,GRD,2011.0,1,0,1
NAM,GBR,2000.0,1,0,1
PNG,PER,2019.0,1,0,1
ARG,IND,2002.0,1,0,1
,MNP,1998.0,1,0,1
IND,CHE,2024.0,1,0,1
MDV,KOR,2018.0,1,0,1
AUT,ALB,2012.0,1,0,1
GHA,TZA,2008.0,1,0,1
,AND,2011.0,1,0,1
JPN,GAB,2017.0,1,0,1
VCT,KNA,2020.0,1,0,1
CIV,CMR,2020.0,1,0,1
GTM,NLD,2015.0,1,0,1
PAK,BHR,2018.0,1,0,1
PAK,CZE,2015.0,1,0,1
ZAF,BGD,2014.0,1,0,1
TUN,POL,2023.0,1,0,1
PER,LAO,2022.0,1,0,1
UGA,COG,2019.0,1,0,1
LSO,ITA,2017.0,1,0,1
SEN,MRT,2014.0,1,0,1
CHL,LUX,2022.0,1,0,1
MLT,IRQ,2018.0,1,0,1
UGA,TWN,2017.0,1,0,1
ISR,CHL,1997.0,1,0,1
IRL,ETH,2018.0,1,0,1
FRA,TGO,2022.0,1,0,1
LTU,TUR,2021.0,1,0,1
GBR,FRA,2024.0,1,0,1
IND,GIN,2009.0,1,0,1
OMN,BEL,2019.0,2,0,2
SVN,UZB,2022.0,1,0,1
IND,CYM,2022.0,1,0,1
ESP,ALB,2023.0,1,0,1
BRA,TWN,2023.0,1,0,1
AGO,GBR,2002.0,1,0,1
YEM,ARE,2018.0,1,0,1
IND,YEM,2003.0,1,0,1
SVN,BIH,2020.0,1,0,1
BGD,RUS,2010.0,1,0,1
PAK,HKG,2013.0,1,0,1
PRI,HRV,2010.0,1,0,1
IND,ABW,2020.0,1,0,1
HKG,PRT,2017.0,1,0,1
KEN,COG,2014.0,1,0,1
ZWE,BFA,2007.0,1,0,1
OMN,ESP,2011.0,1,0,1
TZA,ESP,2004.0,1,0,1
ESP,TZA,2005.0,1,0,1
HUN,SVN,2001.0,1,0,1
KWT,TUR,2013.0,1,0,1
DZA,EGY,2000.0,1,0,1
BGR,ZAF,2021.0,1,0,1
SWE,GNB,1998.0,1,0,1
BEL,LAO,2005.0,1,0,1
BOL,LAO,2008.0,1,0,1
JPN,MKD,2000.0,1,0,1
MLI,GBR,2000.0,1,0,1
BHS,AUS,2000.0,1,0,1
SEN,GUF,1997.0,1,0,1
GUF,GAB,2008.0,1,0,1
TWN,BLR,2014.0,1,0,1
MMR,SGP,2002.0,1,0,1
OMN,GHA,2016.0,1,0,1
SDN,TTO,2004.0,1,0,1
FRA,GNB,2002.0,1,0,1
AFG,NOR,2015.0,1,0,1
,ASM,2008.0,1,0,1
GIN,PNG,2011.0,1,0,1
SDN,EGY,2012.0,1,0,1
TTO,GEO,2015.0,1,0,1
CHN,BRN,2016.0,1,0,1
GAB,ESP,2017.0,1,0,1
ESP,HKG,2013.0,1,0,1
PYF,BEL,2018.0,1,0,1
QAT,POL,2017.0,1,0,1
IRQ,NZL,2014.0,1,0,1
MYS,MAC,2023.0,1,0,1
TTO,FRA,2012.0,1,0,1
TUN,GLP,2011.0,1,0,1
ZAF,VNM,2000.0,1,0,1
MYS,VNM,2001.0,1,0,1
LBR,PAK,2015.0,1,0,1
TZA,COG,2017.0,1,0,1
CHN,SSD,2018.0,1,0,1
CHN,SSD,2022.0,1,0,1
MEX,BFA,2013.0,1,0,1
SDN,IRQ,2017.0,1,0,1
TUR,KOR,2004.0,1,0,1
BEL,ARE,2019.0,1,0,1
PSE,JPN,1999.0,1,0,1
PNG,ESP,2009.0,1,0,1
RUS,LTU,2018.0,1,0,1
BWA,CHE,2013.0,1,0,1
VNM,EGY,2017.0,1,0,1
CAN,GTM,2017.0,1,0,1
BHR,TUN,2017.0,1,0,1
MKD,KWT,2018.0,1,0,1
IND,EST,2011.0,1,0,1
DEU,MNG,2012.0,2,0,2
LTU,HUN,2019.0,1,0,1
BRA,CRI,2007.0,1,0,1
VNM,SAU,2022.0,1,0,1
SYC,GBR,2013.0,1,0,1
PER,CHN,2014.0,1,0,1
NER,GHA,2011.0,1,0,1
GBR,CRI,2003.0,1,0,1
NLD,TTO,2002.0,1,0,1
FLK,GBR,2008.0,1,0,1
MLI,NGA,2017.0,1,0,1
UGA,BGD,2022.0,1,0,1
SAU,KGZ,2016.0,1,0,1
MEX,MNG,2016.0,1,0,1
LTU,EST,2001.0,1,0,1
DZA,AUT,2012.0,1,0,1
SWE,BFA,2003.0,2,0,2
MEX,SAU,2014.0,1,0,1
AUS,LTU,2009.0,1,0,1
LKA,ISR,2008.0,1,0,1
ARG,VNM,2010.0,1,0,1
SVN,ROU,2008.0,1,0,1
AUT,TUN,2013.0,1,0,1
CHN,AZE,2022.0,1,0,1
SAU,LBY,2011.0,1,0,1
IRL,TZA,1998.0,1,0,1
NGA,SYR,1998.0,1,0,1
MLT,SLE,2023.0,1,0,1
LBN,IRQ,2017.0,1,0,1
STP,ZAF,2021.0,1,0,1
KEN,CIV,2009.0,1,0,1
BIH,EGY,2020.0,1,0,1
PER,TUR,2018.0,1,0,1
LBN,MYS,2016.0,1,0,1
TUR,HKG,2022.0,1,0,1
FRA,ATA,2019.0,1,0,1
FIN,ZMB,2004.0,1,0,1
GRC,TUR,2003.0,1,0,1
CRI,NIC,2005.0,1,0,1
BEL,LTU,1999.0,1,0,1
BFA,GBR,2011.0,1,0,1
CZE,BLR,1999.0,1,0,1
VEN,THA,2022.0,1,0,1
ZAF,BEN,2012.0,1,0,1
ARM,ESP,2011.0,1,0,1
QAT,TZA,2017.0,1,0,1
NLD,LBY,2014.0,1,0,1
POL,MDA,2010.0,1,0,1
LUX,AUS,2003.0,1,0,1
UGA,NPL,2020.0,1,0,1
GBR,MUS,1998.0,3,0,3
GTM,ECU,2007.0,1,0,1
TUR,PSE,2011.0,1,0,1
TZA,CHL,2001.0,1,0,1
PAK,UZB,2014.0,1,0,1
PHL,MMR,2017.0,1,0,1
ZWE,NOR,2000.0,2,0,2
CMR,IRL,2000.0,1,0,1
LKA,FRA,2005.0,1,0,1
URY,CHL,2000.0,1,0,1
KGZ,FRA,2005.0,1,0,1
FRA,KGZ,2014.0,1,0,1
IND,LUX,1998.0,1,0,1
NER,NLD,1998.0,1,0,1
POL,KOR,2000.0,1,0,1
KAZ,BRA,2002.0,1,0,1
JPN,ARE,2002.0,1,0,1
MWI,ZWE,2001.0,1,0,1
GUY,USA,2010.0,1,0,1
ISR,ISL,1999.0,1,0,1
FRA,BHR,2000.0,2,0,2
CZE,ZWE,2007.0,1,0,1
CHE,ETH,2008.0,1,0,1
SRB,TWN,2004.0,1,0,1
GIN,JPN,2010.0,2,0,2
NCL,PNG,2013.0,1,0,1
BMU,NZL,2005.0,1,0,1
BEL,GIN,2010.0,1,0,1
MYS,HRV,2013.0,1,0,1
CAN,GUF,2013.0,1,0,1
MUS,USA,2010.0,1,0,1
KAZ,FRA,2013.0,1,0,1
BEL,HTI,2017.0,1,0,1
BFA,HTI,2021.0,1,0,1
ARG,DMA,2009.0,1,0,1
PRY,SAU,2022.0,1,0,1
TUN,KWT,2022.0,1,0,1
CHE,MLI,2007.0,1,0,1
THA,MOZ,2015.0,1,0,1
ESP,PNG,2014.0,1,0,1
DEU,MOZ,2022.0,1,0,1
ALB,NGA,2023.0,1,0,1
,AIA,2012.0,1,0,1
SVN,NZL,2016.0,1,0,1
MDA,NOR,2018.0,1,0,1
ESP,AGO,2012.0,1,0,1
VNM,MWI,2021.0,1,0,1
PSE,SRB,2015.0,1,0,1
CHN,ZWE,2018.0,1,0,1
SRB,SGP,2020.0,1,0,1
AFG,QAT,2022.0,1,0,1
IRL,ETH,2017.0,1,0,1
CZE,DZA,2015.0,1,0,1
MEX,ISL,2016.0,1,0,1
ISL,AUT,2020.0,1,0,1
HUN,TTO,2010.0,1,0,1
ZMB,CAN,2022.0,1,0,1
SWZ,CAN,2002.0,1,0,1
SYR,HUN,2016.0,1,0,1
NGA,RWA,2019.0,1,0,1
SVK,MNE,2021.0,1,0,1
ALB,CZE,2017.0,1,0,1
SDN,IRL,2020.0,1,0,1
FJI,SWE,2016.0,1,0,1
BRN,ITA,2019.0,1,0,1
ECU,THA,2022.0,1,0,1
VEN,FIN,2002.0,1,0,1
CZE,NGA,2012.0,1,0,1
CHE,MOZ,2008.0,1,0,1
ZWE,NAM,2005.0,1,0,1
ISR,UZB,2021.0,1,0,1
FRA,ZWE,2014.0,1,0,1
ALB,FRA,2003.0,1,0,1
IDN,ISR,2023.0,1,0,1
DEU,ALB,2005.0,1,0,1
NGA,COL,2005.0,1,0,1
REU,MDG,2011.0,1,0,1
PYF,USA,2000.0,1,0,1
NGA,GMB,2011.0,1,0,1
DEU,AZE,1999.0,1,0,1
TUN,EGY,2001.0,1,0,1
RWA,ETH,2012.0,1,0,1
BGR,IND,2001.0,1,0,1
PHL,BEL,1998.0,1,0,1
GBR,COD,2015.0,1,0,1
MOZ,BWA,2014.0,1,0,1
HKG,AUT,2004.0,1,0,1
EGY,SWE,2001.0,1,0,1
ZWE,SYR,2005.0,1,0,1
AUT,LVA,2020.0,1,0,1
CAN,ALB,2009.0,1,0,1
BEN,ITA,2003.0,1,0,1
ZMB,NOR,2012.0,1,0,1
IRL,LBY,2007.0,1,0,1
ITA,DOM,2015.0,1,0,1
ISL,CZE,2012.0,1,0,1
SAU,UKR,2016.0,1,0,1
PHL,BEL,2007.0,1,0,1
GBR,KNA,2019.0,1,0,1
VNM,FJI,2009.0,1,0,1
JPN,MRT,2014.0,1,0,1
IND,PNG,2005.0,1,0,1
KHM,NCL,2020.0,1,0,1
LKA,KWT,2017.0,1,0,1
KWT,LKA,2019.0,1,0,1
MYS,JOR,2002.0,1,0,1
FRA,YEM,2002.0,1,0,1
MLI,COG,1997.0,1,0,1
DEU,LBY,2020.0,1,0,1
EST,FJI,2014.0,1,0,1
JOR,TUR,2003.0,1,0,1
COL,PHL,2014.0,1,0,1
BRA,LIE,2015.0,1,0,1
SAU,ABW,2021.0,1,0,1
NPL,IDN,2012.0,1,0,1
ARM,ESP,2021.0,1,0,1
KEN,EGY,2019.0,1,0,1
NLD,TUN,2003.0,1,0,1
IND,TZA,2007.0,1,0,1
GTM,GNQ,2019.0,1,0,1
NGA,GAB,2005.0,1,0,1
COG,NER,2014.0,1,0,1
NER,BEN,2009.0,1,0,1
NLD,BFA,2004.0,1,0,1
CYP,IRL,2013.0,1,0,1
ARG,ROU,2013.0,1,0,1
DNK,CUB,1998.0,1,0,1
SRB,SGP,2007.0,1,0,1
NPL,MUS,2017.0,1,0,1
JPN,CCK,2015.0,1,0,1
GAB,TGO,2020.0,1,0,1
NLD,ERI,2013.0,1,0,1
GAB,ITA,2018.0,1,0,1
CUB,ETH,2011.0,1,0,1
ZMB,ITA,2018.0,1,0,1
QAT,SVK,2019.0,1,0,1
NLD,BHS,1999.0,1,0,1
NIC,JPN,2014.0,1,0,1
BRA,TTO,2017.0,1,0,1
ZWE,SSD,2013.0,1,0,1
ZAF,FJI,2014.0,1,0,1
TUV,,2019.0,1,0,1
CUB,CHL,2024.0,1,0,1
HUN,MNE,2017.0,1,0,1
LTU,SVN,2016.0,1,0,1
PAK,POL,2011.0,1,0,1
BTN,NLD,2019.0,1,0,1
MYS,TTO,2002.0,1,0,1
TTO,MYS,2004.0,1,0,1
SOM,ETH,2022.0,1,0,1
GBR,MKD,2018.0,1,0,1
USA,KOR,2010.0,934,709,225
CZE,GBR,2003.0,35,64,-29
SWE,DEU,2015.0,125,205,-80
CHN,NLD,2009.0,49,38,11
ESP,BRA,2007.0,53,46,7
FRA,BEL,2019.0,259,221,38
BRA,PRT,2008.0,65,55,10
PRT,GBR,2004.0,37,64,-27
ZAF,NLD,2011.0,17,17,0
BEL,FIN,2005.0,2,2,0
GEO,USA,2009.0,46,46,0
JPN,MYS,2009.0,49,13,36
FRA,ROU,2012.0,42,38,4
ITA,ESP,2013.0,183,162,21
RUS,CHE,2005.0,25,12,13
USA,NOR,2007.0,73,55,18
KEN,USA,2015.0,53,50,3
PRI,IND,1999.0,1,1,0
POL,DNK,2010.0,13,5,8
JPN,IND,2001.0,64,108,-44
AUS,AUT,2020.0,55,33,22
AUT,AUS,2003.0,27,33,-6
GBR,SDN,2019.0,8,4,4
UGA,USA,2017.0,26,42,-16
KHM,USA,2010.0,1,5,-4
SEN,USA,2022.0,4,9,-5
DNK,CHE,2023.0,33,29,4
JPN,CAN,2022.0,65,73,-8
AUS,CAN,2022.0,146,134,12
IND,MYS,2014.0,102,36,66
RUS,ISR,2018.0,15,10,5
CAN,BGD,2020.0,28,44,-16
CAN,IND,2020.0,88,201,-113
POL,DEU,2001.0,76,94,-18
USA,NOR,1998.0,65,55,10
CHE,CHN,2017.0,75,82,-7
AUT,DEU,2001.0,198,186,12
FRA,BRA,1998.0,70,42,28
DNK,ESP,2003.0,12,10,2
FRA,FIN,2019.0,38,25,13
ESP,CHN,2016.0,37,34,3
CHE,AUS,2023.0,41,51,-10
IRN,HKG,2022.0,8,2,6
TWN,TUR,2020.0,3,7,-4
GRC,FRA,2005.0,13,31,-18
MEX,AUS,2005.0,1,3,-2
ISR,IND,1997.0,1,12,-11
ARE,DEU,2018.0,6,17,-11
EST,FIN,2001.0,7,11,-4
ITA,ALB,2017.0,8,4,4
GBR,CHL,2014.0,46,30,16
MYS,NLD,2019.0,3,13,-10
HKG,GBR,2018.0,73,69,4
CAN,LTU,2021.0,2,1,1
THA,DEU,2014.0,24,26,-2
ITA,URY,2017.0,6,1,5
ITA,CUB,2020.0,3,5,-2
ITA,NGA,2022.0,7,6,1
URY,SWE,2021.0,1,1,0
IDN,MYS,2021.0,60,98,-38
PRT,GBR,2001.0,48,53,-5
ITA,CZE,2018.0,27,18,9
EST,GBR,2010.0,5,6,-1
PER,USA,1998.0,15,7,8
SEN,USA,2016.0,16,12,4
KOR,AUT,2021.0,7,5,2
BRA,CHE,2021.0,52,15,37
SGP,SWE,2002.0,4,1,3
ARE,ITA,2022.0,7,13,-6
CHE,BRA,2006.0,14,11,3
NGA,GBR,2007.0,25,17,8
DNK,SVN,2022.0,8,1,7
NLD,TUR,2023.0,13,21,-8
ITA,LUX,2023.0,9,8,1
SLE,USA,2019.0,7,10,-3
ESP,POL,2022.0,21,36,-15
SAU,ITA,2018.0,11,10,1
TWN,CAN,2019.0,18,13,5
GBR,POL,2005.0,25,36,-11
CHN,ITA,2010.0,28,20,8
USA,TTO,2021.0,5,16,-11
NLD,FIN,2009.0,17,15,2
AUS,SAU,1997.0,4,2,2
DEU,THA,2022.0,12,10,2
KNA,USA,2015.0,6,3,3
KOR,NOR,2013.0,4,2,2
ARG,CUB,2022.0,2,1,1
USA,LAO,2017.0,8,3,5
USA,BWA,2012.0,11,9,2
NLD,THA,2008.0,5,2,3
SWE,LTU,2020.0,7,8,-1
ZAF,ETH,2009.0,3,1,2
CZE,RUS,2003.0,5,19,-14
THA,KHM,2019.0,2,4,-2
HND,USA,2013.0,3,2,1
ZAF,BFA,2009.0,6,2,4
ISR,IRL,2009.0,17,6,11
MAR,TUR,2022.0,3,1,2
SWE,SRB,2005.0,5,5,0
KOR,ITA,2012.0,7,9,-2
ZAF,TZA,2017.0,14,7,7
CHN,IRQ,2013.0,4,2,2
IND,KWT,2006.0,2,4,-2
CAN,NLD,1997.0,18,24,-6
POL,ISR,2018.0,5,3,2
SWE,GRC,2023.0,9,12,-3
PRT,RUS,2019.0,9,5,4
HRV,SRB,1999.0,3,8,-5
BEL,SRB,2017.0,2,4,-2
KHM,AUS,2020.0,5,8,-3
PRT,DNK,1999.0,2,3,-1
USA,UGA,2000.0,3,7,-4
MYS,SWE,2006.0,1,1,0
ESP,LBN,2016.0,2,1,1
MDG,DEU,2020.0,2,1,1
COL,GBR,2000.0,8,3,5
AUT,CZE,2000.0,5,8,-3
CMR,CAN,2015.0,2,4,-2
AUT,HRV,2016.0,5,9,-4
THA,FIN,2010.0,1,3,-2
POL,ISR,2017.0,6,1,5
EST,SWE,2021.0,5,7,-2
GBR,BRN,2007.0,3,1,2
ARE,USA,1997.0,1,9,-8
BEL,LUX,1999.0,2,4,-2
USA,ALB,2001.0,2,3,-1
LBY,IRL,2011.0,2,2,0
UKR,LVA,2019.0,4,4,0
KHM,USA,2006.0,3,4,-1
EST,GBR,2000.0,1,1,0
IRN,TWN,2017.0,2,2,0
BWA,CAN,2018.0,2,3,-1
ESP,PAN,2012.0,7,3,4
AUT,BEL,2002.0,9,9,0
ESP,HRV,2012.0,4,6,-2
NLD,ARG,2015.0,3,6,-3
CUB,ARG,2021.0,4,1,3
SGP,NOR,2009.0,4,2,2
POL,COL,2023.0,2,3,-1
KAZ,NOR,2019.0,1,3,-2
PAK,ZAF,2020.0,3,5,-2
POL,CHL,2008.0,4,1,3
SWE,ROU,2018.0,2,2,0
LBR,GBR,2015.0,1,1,0
SGP,FIN,2011.0,1,6,-5
ZAF,SAU,2004.0,1,1,0
RUS,SRB,2008.0,2,3,-1
IND,GRC,2023.0,3,4,-1
ISR,KOR,2009.0,1,3,-2
EST,BEL,2021.0,3,2,1
COL,PRT,2009.0,2,1,1
CHE,GHA,2008.0,1,1,0
MMR,CHN,2022.0,2,4,-2
DZA,MAR,2011.0,2,1,1
BEL,SRB,2018.0,4,2,2
KGZ,DEU,2002.0,1,1,0
JOR,YEM,2009.0,1,1,0
LBY,LBN,2006.0,3,2,1
UGA,NGA,2021.0,3,12,-9
LBN,NLD,2013.0,1,1,0
ITA,ETH,1999.0,1,1,0
LBR,CHE,2015.0,1,2,-1
URY,CHE,2017.0,1,1,0
SDN,GBR,2016.0,2,6,-4
CAN,PRI,2014.0,2,1,1
GUY,FRA,2021.0,1,2,-1
ESP,KAZ,2020.0,2,1,1
PHL,TWN,2006.0,1,1,0
SEN,TGO,2021.0,1,1,0
POL,CHL,2014.0,1,3,-2
ZAF,TUR,2020.0,1,4,-3
ZAF,CZE,2017.0,2,1,1
BHR,DEU,2015.0,2,1,1
NLD,TWN,2002.0,1,1,0
NLD,MAR,2014.0,1,2,-1
CHE,LIE,2016.0,1,2,-1
ALB,DEU,2010.0,1,2,-1
NGA,BEL,2018.0,1,1,0
POL,LUX,2016.0,2,1,1
IRN,IND,2021.0,10,10,0
JAM,CAN,2017.0,3,6,-3
ITA,GHA,2018.0,2,2,0
CHE,MYS,2020.0,6,2,4
BGD,DEU,2014.0,8,11,-3
EGY,LBN,2005.0,1,2,-1
NZL,DNK,1998.0,3,2,1
DNK,ARG,2018.0,4,2,2
AUS,VEN,2020.0,2,2,0
PNG,AUS,1998.0,3,10,-7
GRC,SRB,2001.0,3,3,0
AUS,IDN,2001.0,11,7,4
AUS,BRN,1997.0,2,1,1
DEU,CIV,2020.0,3,4,-1
MYS,NGA,2010.0,5,11,-6
ZAF,CMR,2010.0,5,5,0
LKA,IND,2010.0,6,2,4
JPN,PSE,2015.0,1,1,0
DNK,ISR,2018.0,4,7,-3
ISR,NOR,2020.0,1,5,-4
FIN,ARE,2019.0,2,2,0
EGY,DNK,2013.0,3,5,-2
THA,BGD,2023.0,5,5,0
CHL,CAN,2020.0,20,28,-8
MEX,SGP,2017.0,2,3,-1
ESP,URY,2022.0,8,5,3
EGY,PAK,2018.0,2,2,0
SWE,EGY,2002.0,1,1,0
QAT,AUS,2016.0,3,16,-13
NLD,MEX,2018.0,13,17,-4
USA,TTO,2004.0,6,8,-2
ZMB,CHN,2021.0,1,3,-2
CAN,FIN,2005.0,14,13,1
HUN,EGY,2021.0,6,6,0
CHN,HUN,2002.0,1,1,0
IND,SRB,2004.0,4,8,-4
MYS,NLD,2014.0,5,11,-6
NZL,SGP,1998.0,2,3,-1
COL,CHL,2008.0,9,4,5
SVN,DEU,2008.0,5,8,-3
AUS,RUS,2007.0,7,7,0
POL,ITA,2008.0,13,18,-5
SVN,HRV,2010.0,6,4,2
FIN,IRL,2021.0,4,8,-4
JPN,MMR,2015.0,5,2,3
BGD,THA,2021.0,6,4,2
VEN,DEU,2003.0,5,4,1
DEU,THA,2007.0,14,17,-3
AUS,ISR,1998.0,6,4,2
AUS,MNG,2010.0,1,1,0
NZL,FIN,2010.0,4,3,1
MEX,CHN,2015.0,4,1,3
AUS,HUN,2022.0,1,2,-1
SGP,NZL,2008.0,8,15,-7
SAU,ETH,2021.0,4,1,3
SVK,SRB,2018.0,1,4,-3
LBR,CHN,2020.0,1,1,0
FRA,BFA,1997.0,4,1,3
FJI,TON,2018.0,1,1,0
BEN,TGO,2005.0,1,2,-1
BEL,SWE,1998.0,7,8,-1
GBR,OMN,1997.0,3,1,2
TWN,CHE,2001.0,1,3,-2
AUT,NZL,2023.0,5,2,3
KOR,ZAF,2013.0,2,1,1
SWE,SAU,2020.0,5,8,-3
BEL,TZA,2019.0,2,3,-1
ISR,DNK,2014.0,2,4,-2
NAM,USA,2022.0,4,3,1
ARE,SAU,2014.0,9,24,-15
TWN,NER,2013.0,1,0,1
TON,AUS,2010.0,1,0,1
GLP,NCL,2010.0,1,0,1
CHE,CYP,2023.0,1,0,1
CAN,TZA,2004.0,2,0,2
,YEM,2001.0,13,0,13
NLD,GUF,2014.0,1,0,1
GBR,ALB,1997.0,2,0,2
GEO,BRA,2000.0,1,0,1
MKD,FRA,2008.0,2,0,2
NOR,SVN,2007.0,1,0,1
ROU,POL,2010.0,2,0,2
GAB,,2004.0,4,0,4
LUX,GRC,2005.0,1,0,1
BWA,,2026.0,1,0,1
TUR,EST,2023.0,1,0,1
ITA,SGP,2009.0,4,0,4
GUY,MYS,1998.0,1,0,1
GRC,IRN,2011.0,1,0,1
TWN,HRV,2010.0,3,0,3
VEN,PER,2009.0,2,0,2
GBR,SYR,2004.0,1,0,1
SYR,ARE,2021.0,3,0,3
HRV,SAU,2020.0,2,0,2
PHL,CHE,2023.0,2,0,2
NOR,MKD,2005.0,1,0,1
JOR,DZA,2008.0,2,0,2
TTO,DMA,2011.0,2,0,2
RUS,TUV,2016.0,1,0,1
TTO,COL,2011.0,1,0,1
GUY,USA,2009.0,1,0,1
UKR,JOR,2012.0,1,0,1
GIN,,2012.0,3,0,3
CIV,BFA,1998.0,2,0,2
JOR,HUN,2016.0,2,0,2
GNQ,,2009.0,2,0,2
CYP,DEU,2003.0,1,0,1
GRC,SGP,2017.0,2,0,2
FRA,TTO,2011.0,1,0,1
,FLK,2008.0,4,0,4
FRA,AGO,2009.0,2,0,2
,GRL,2008.0,7,0,7
AUS,SLE,2015.0,1,0,1
CYM,BRB,2014.0,1,0,1
CZE,BIH,2011.0,1,0,1
PAK,MEX,2014.0,1,0,1
CHN,BDI,2019.0,4,0,4
BDI,CHN,2020.0,2,0,2
JPN,BTN,2018.0,1,0,1
QAT,SRB,2020.0,1,0,1
ZAF,SRB,2019.0,1,0,1
MRT,MLI,2016.0,2,0,2
BEN,GHA,2014.0,2,0,2
TWN,CZE,2002.0,2,0,2
CIV,GBR,2010.0,3,0,3
THA,MNG,2011.0,1,0,1
BHR,GBR,2011.0,2,0,2
SRB,BLR,2021.0,1,0,1
MHL,USA,2016.0,4,0,4
JPN,PNG,2012.0,1,0,1
,NRU,2009.0,1,0,1
URY,CZE,2011.0,1,0,1
PRT,MAR,2016.0,1,0,1
AUS,CRI,2018.0,3,0,3
GRD,ZAF,2009.0,1,0,1
NGA,LBN,2011.0,1,0,1
TLS,KOR,2010.0,1,0,1
HUN,QAT,2018.0,1,0,1
FRA,NGA,2013.0,2,0,2
KWT,DEU,2000.0,3,0,3
BGR,NGA,2014.0,1,0,1
ARG,KOR,2002.0,3,0,3
NZL,MAC,2013.0,1,0,1
IRL,JAM,1997.0,1,0,1
MTQ,,2016.0,12,0,12
GBR,TUN,2011.0,3,0,3
CHN,PRI,2015.0,1,0,1
IRL,PHL,2016.0,1,0,1
COL,ROU,2019.0,1,0,1
KHM,PAK,2020.0,1,0,1
CRI,ITA,2020.0,1,0,1
CUB,BOL,2021.0,1,0,1
NLD,SLE,2022.0,2,0,2
NLD,ALB,2023.0,1,0,1
AFG,LBN,2019.0,1,0,1
IRN,SYR,2023.0,3,0,3
BFA,IND,2017.0,1,0,1
TUR,NOR,2004.0,2,0,2
,SMR,2016.0,2,0,2
CUB,RUS,2019.0,2,0,2
SMR,,2018.0,3,0,3
IRN,GHA,2017.0,2,0,2
GHA,IRN,2018.0,1,0,1
URY,FRA,2023.0,2,0,2
MYS,BEL,1998.0,1,0,1
KEN,RUS,2006.0,1,0,1
UKR,BGR,2004.0,2,0,2
BGR,IRL,2017.0,1,0,1
BLR,SWE,2000.0,2,0,2
GBR,PHL,1999.0,4,0,4
HKG,BGR,2008.0,1,0,1
BGR,ZAF,2010.0,1,0,1
CUB,LBN,2017.0,1,0,1
ARM,TWN,1999.0,1,0,1
MEX,THA,2018.0,2,0,2
ESP,DOM,2010.0,1,0,1
NGA,CHE,2004.0,1,0,1
CHE,NGA,2011.0,2,0,2
ESP,MYS,2004.0,1,0,1
PAN,ISR,2000.0,1,0,1
NLD,SRB,2010.0,2,0,2
USA,RWA,2002.0,1,0,1
ESP,TUN,1998.0,1,0,1
RUS,HUN,2003.0,3,0,3
IND,CYP,2000.0,1,0,1
SYR,TUN,2018.0,1,0,1
BEL,BIH,2001.0,1,0,1
SDN,BEL,2002.0,2,0,2
GHA,KEN,2000.0,1,0,1
UKR,HKG,2018.0,2,0,2
,MCO,1999.0,6,0,6
CHE,UGA,2003.0,2,0,2
COG,COL,2021.0,1,0,1
NGA,ZMB,2017.0,1,0,1
BEL,ARG,2000.0,4,0,4
SEN,BEL,1998.0,2,0,2
TUN,SAU,2001.0,2,0,2
BRN,USA,1999.0,2,0,2
ZAF,OMN,2013.0,1,0,1
GRC,VEN,2014.0,3,0,3
IND,JAM,2007.0,1,0,1
CAN,ISL,2011.0,2,0,2
FIN,ISL,2017.0,2,0,2
HKG,CZE,2004.0,1,0,1
EST,CHE,2010.0,2,0,2
VEN,RUS,2017.0,1,0,1
PRT,PRI,1998.0,1,0,1
BWA,IND,2012.0,2,0,2
ARG,JPN,2004.0,2,0,2
EST,ISR,2017.0,3,0,3
LAO,MDG,2009.0,1,0,1
COG,GBR,2019.0,2,0,2
UZB,DEU,1997.0,1,0,1
UZB,KAZ,2009.0,3,0,3
FLK,NZL,2008.0,1,0,1
HUN,CHN,2003.0,1,0,1
ROU,AUT,2006.0,2,0,2
UZB,CHN,2009.0,1,0,1
GBR,ECU,2007.0,1,0,1
ZAF,TUN,2008.0,2,0,2
REU,,2020.0,14,0,14
NOR,LKA,2014.0,1,0,1
ITA,GLP,2011.0,1,0,1
RWA,BWA,2017.0,1,0,1
CUB,ARG,2000.0,2,0,2
GBR,PNG,2018.0,2,0,2
CHE,PER,2007.0,1,0,1
ALB,AUT,2010.0,1,0,1
ZAF,IRN,2008.0,1,0,1
MDG,AUS,2021.0,1,0,1
TUR,BGR,2015.0,1,0,1
GRC,MEX,2009.0,1,0,1
TUN,SWE,2014.0,1,0,1
MLT,SWE,2006.0,1,0,1
MKD,GRC,2009.0,2,0,2
PRI,DNK,2009.0,1,0,1
UGA,NAM,2012.0,3,0,3
LUX,MAR,2014.0,1,0,1
IRN,LKA,2011.0,1,0,1
SLV,ECU,2009.0,2,0,2
COL,NLD,2009.0,2,0,2
ITA,BHR,2008.0,1,0,1
GMB,MWI,2017.0,1,0,1
UZB,MYS,2011.0,3,0,3
AUS,EST,2015.0,2,0,2
PLW,,2016.0,4,0,4
SVN,HUN,2015.0,1,0,1
NLD,MYS,2000.0,1,0,1
POL,CHL,2003.0,1,0,1
ARG,ISR,2023.0,3,0,3
KAZ,BGD,2022.0,1,0,1
EST,MAC,2015.0,1,0,1
JOR,SYR,2009.0,2,0,2
AUS,GRD,2016.0,1,0,1
ZMB,MWI,2002.0,1,0,1
UKR,BGR,2015.0,4,0,4
SEN,GAB,2019.0,2,0,2
MDG,,2006.0,4,0,4
HUN,MAR,2015.0,1,0,1
KIR,,2020.0,2,0,2
USA,JEY,2022.0,2,0,2
BRA,CHE,2024.0,1,0,1
SLB,MYS,2021.0,1,0,1
GBR,MCO,2002.0,1,0,1
SVN,DNK,2018.0,1,0,1
HRV,ESP,2024.0,1,0,1
SYR,IND,2015.0,1,0,1
IRN,ARE,2012.0,3,0,3
SYR,PAK,2002.0,1,0,1
KOR,ARG,2012.0,2,0,2
CZE,CMR,2015.0,2,0,2
TUR,KWT,2017.0,13,0,13
CUB,COL,2001.0,1,0,1
GBR,MSR,2001.0,1,0,1
ROU,THA,2012.0,1,0,1
LBY,DEU,2015.0,2,0,2
MKD,BLR,2020.0,1,0,1
AUT,CYP,2019.0,2,0,2
CYP,ETH,2022.0,3,0,3
ZAF,DEU,2024.0,1,0,1
NZL,ARE,2013.0,3,0,3
CHN,FIN,1997.0,2,0,2
SDN,BTN,2021.0,1,0,1
VNM,GBR,2024.0,1,0,1
PRI,GBR,2022.0,1,0,1
SLE,JPN,2022.0,1,0,1
IRN,IDN,2020.0,1,0,1
BGD,MDV,2014.0,1,0,1
ZAF,SEN,2023.0,1,0,1
USA,NAM,2002.0,3,0,3
LIE,CHN,1998.0,1,0,1
PRT,JPN,1998.0,1,0,1
EGY,SWE,2003.0,2,0,2
SVK,SLV,1997.0,3,0,3
ITA,MCO,1997.0,1,0,1
FRA,SGP,2003.0,5,0,5
CAN,LVA,1998.0,1,0,1
GTM,SWE,2000.0,1,0,1
DEU,SYR,2008.0,3,0,3
GUF,,2014.0,6,0,6
HUN,SGP,1998.0,1,0,1
MDG,USA,2004.0,6,0,6
PRT,POL,1998.0,1,0,1
SWE,ECU,2016.0,1,0,1
,GRL,1996.0,5,0,5
BRA,SVK,2001.0,2,0,2
GEO,ITA,2001.0,2,0,2
IDN,ITA,2002.0,3,0,3
IND,COG,1999.0,1,0,1
BOL,ITA,2007.0,1,0,1
FRA,PSE,2011.0,1,0,1
BFA,TGO,2002.0,1,0,1
FRA,PAK,2003.0,2,0,2
GMB,OMN,1998.0,1,0,1
CHE,PER,1998.0,1,0,1
PER,GHA,2002.0,2,0,2
SLB,PHL,2011.0,1,0,1
EGY,DZA,2002.0,1,0,1
CHE,BFA,2011.0,1,0,1
CRI,BEL,2007.0,1,0,1
PER,CAN,2007.0,2,0,2
GMB,,2011.0,9,0,9
GRD,JAM,2001.0,1,0,1
NIC,ESP,2006.0,2,0,2
MWI,USA,1997.0,4,0,4
HRV,SGP,2013.0,2,0,2
GBR,ALB,2012.0,1,0,1
THA,BGR,2020.0,1,0,1
CRI,ITA,2007.0,1,0,1
MDA,GAB,2019.0,1,0,1
LBR,,2013.0,1,0,1
ATG,BRB,2011.0,2,0,2
HUN,GHA,2014.0,1,0,1
,BHS,2008.0,1,0,1
ISR,JOR,2014.0,1,0,1
NER,CIV,2012.0,1,0,1
MYS,EGY,2008.0,3,0,3
BDI,NLD,2017.0,1,0,1
,STP,2008.0,2,0,2
ARG,VNM,2019.0,1,0,1
KOR,THA,2002.0,2,0,2
FIN,NAM,2011.0,1,0,1
SVN,FIN,2019.0,3,0,3
LVA,LTU,2000.0,1,0,1
POL,THA,2021.0,1,0,1
NLD,ECU,2014.0,1,0,1
DEU,KHM,2011.0,1,0,1
KAZ,QAT,2022.0,1,0,1
AFG,AUS,2014.0,1,0,1
MDG,JPN,2015.0,2,0,2
BFA,BRN,2015.0,5,0,5
MEX,ROU,2023.0,1,0,1
TUN,LUX,2017.0,1,0,1
COM,COG,2016.0,2,0,2
BEN,MLI,2017.0,1,0,1
GRC,COG,2012.0,1,0,1
LVA,TUR,2017.0,1,0,1
CHN,OMN,2019.0,2,0,2
KGZ,IND,2020.0,1,0,1
IND,HRV,2013.0,1,0,1
DEU,COD,2020.0,2,0,2
POL,EST,2010.0,1,0,1
COL,SAU,2019.0,1,0,1
ARG,ARE,2017.0,6,0,6
MDA,DNK,2020.0,3,0,3
,LIE,2015.0,7,0,7
,GLP,2014.0,8,0,8
IDN,EGY,2023.0,2,0,2
COL,KEN,2022.0,4,0,4
FIN,IRQ,2017.0,1,0,1
GHA,NER,2017.0,1,0,1
GBR,KGZ,2018.0,3,0,3
KGZ,ITA,2021.0,1,0,1
TCA,,2017.0,1,0,1
KGZ,DEU,2020.0,4,0,4
HND,PER,2020.0,1,0,1
TWN,FIN,2022.0,3,0,3
COL,EST,2021.0,2,0,2
CHN,PER,2020.0,1,0,1
AZE,IRN,2000.0,1,0,1
CRI,SGP,2021.0,1,0,1
SGP,CRI,2022.0,1,0,1
TUN,AUS,2023.0,1,0,1
,TKM,2016.0,1,0,1
IND,BRN,2023.0,2,0,2
MLT,BGR,2021.0,1,0,1
POL,DZA,2020.0,3,0,3
GHA,ZWE,2019.0,3,0,3
RWA,RUS,2022.0,1,0,1
BRA,ZAF,2023.0,5,0,5
TUN,GRC,2020.0,1,0,1
USA,GIN,2010.0,1,0,1
GUY,HND,2010.0,1,0,1
,VIR,1997.0,2,0,2
MCO,,2018.0,4,0,4
MAR,SAU,1997.0,1,0,1
GBR,SLB,2001.0,1,0,1
BRN,GRC,2022.0,1,0,1
THA,LKA,2015.0,1,0,1
ARG,THA,2006.0,1,0,1
TUR,SVN,2006.0,1,0,1
SEN,NER,2014.0,1,0,1
DJI,MAR,2021.0,1,0,1
SGP,ITA,2001.0,2,0,2
MEX,HND,2017.0,1,0,1
BLZ,,2005.0,1,0,1
CIV,CMR,1997.0,1,0,1
CHL,BEL,1997.0,3,0,3
YEM,KWT,2000.0,1,0,1
MWI,,2003.0,11,0,11
NER,,1999.0,3,0,3
BLR,CAN,2004.0,2,0,2
IRN,RUS,1997.0,1,0,1
AUT,BIH,2000.0,1,0,1
BEN,MAC,2008.0,1,0,1
JAM,VGB,2002.0,1,0,1
OMN,HRV,2019.0,1,0,1
MYS,ESP,2022.0,5,0,5
,SLB,1998.0,3,0,3
GRC,POL,1999.0,1,0,1
PHL,MNG,2002.0,1,0,1
PAK,GLP,2014.0,1,0,1
BFA,CAN,2009.0,3,0,3
CHE,TUN,2006.0,1,0,1
GEO,CZE,2000.0,1,0,1
GEO,ARE,2020.0,1,0,1
CAN,BHS,2010.0,1,0,1
FRA,LKA,2022.0,3,0,3
UKR,BIH,2011.0,1,0,1
TUR,IRN,2007.0,4,0,4
SEN,CMR,2013.0,1,0,1
GBR,UZB,2018.0,2,0,2
AUS,BRB,2005.0,1,0,1
,TGO,1998.0,7,0,7
CUB,IND,2000.0,1,0,1
JOR,BRA,1999.0,3,0,3
AIA,,2016.0,3,0,3
PRT,COL,2003.0,1,0,1
COL,CHN,2005.0,1,0,1
AGO,USA,2016.0,3,0,3
SWZ,USA,2023.0,2,0,2
BGD,KWT,2002.0,1,0,1
NPL,NLD,2000.0,1,0,1
IRL,NOR,1998.0,2,0,2
SWZ,AUS,1998.0,1,0,1
TWN,EGY,2010.0,1,0,1
,CYM,1995.0,2,0,2
VEN,AUS,2013.0,1,0,1
ESP,HND,2009.0,2,0,2
COD,GBR,1998.0,1,0,1
GHA,DEU,2001.0,2,0,2
NLD,BWA,2009.0,1,0,1
PHL,NPL,2012.0,2,0,2
VNM,GMB,2023.0,1,0,1
IRQ,QAT,2009.0,1,0,1
MWI,GMB,2009.0,1,0,1
MDG,AUS,2011.0,1,0,1
CIV,DEU,2010.0,1,0,1
ARG,GTM,2007.0,1,0,1
MYS,COL,2017.0,1,0,1
SRB,CHL,2001.0,1,0,1
ITA,ETH,2012.0,1,0,1
USA,VCT,2008.0,1,0,1
IND,ATG,2016.0,1,0,1
EGY,BLR,2011.0,1,0,1
CAN,QAT,2006.0,5,0,5
KOR,KHM,2015.0,2,0,2
CAN,PAN,2005.0,2,0,2
PAN,BEL,2013.0,1,0,1
GBR,PAN,2017.0,3,0,3
SUR,NLD,2005.0,1,0,1
NZL,SDN,2003.0,1,0,1
GEO,AZE,2015.0,1,0,1
TWN,BEL,2014.0,2,0,2
VNM,ITA,2005.0,1,0,1
UKR,TJK,2004.0,1,0,1
DZA,OMN,2015.0,1,0,1
PRT,LBY,2022.0,1,0,1
SYR,KEN,2014.0,2,0,2
BHR,OMN,2014.0,2,0,2
SAU,DEU,2005.0,2,0,2
NLD,TTO,2020.0,1,0,1
CYP,BEL,2013.0,2,0,2
PER,GUF,2010.0,2,0,2
GHA,BGD,2011.0,1,0,1
ITA,IDN,2016.0,1,0,1
IRN,NZL,2009.0,2,0,2
AUS,PLW,2013.0,1,0,1
BLR,ESP,2009.0,1,0,1
FJI,CHE,2014.0,1,0,1
BLR,AUT,2004.0,1,0,1
TTO,AUS,2010.0,2,0,2
IDN,BEL,1997.0,2,0,2
,DMA,2009.0,3,0,3
DMA,DOM,2013.0,2,0,2
KHM,MOZ,2012.0,1,0,1
MYS,NLD,2006.0,2,0,2
BRA,MOZ,2004.0,1,0,1
BIH,CYP,2019.0,1,0,1
BLR,CZE,2015.0,1,0,1
COL,IDN,2019.0,2,0,2
IDN,KAZ,2020.0,1,0,1
ECU,KOR,2017.0,1,0,1
ARE,ZWE,2018.0,2,0,2
ZWE,ARE,2019.0,2,0,2
TTO,NGA,2021.0,1,0,1
SDN,YEM,2017.0,1,0,1
MDV,USA,2019.0,3,0,3
GEO,KWT,2019.0,1,0,1
AUT,LIE,2018.0,2,0,2
LIE,USA,2021.0,2,0,2
MNE,,2018.0,12,0,12
KWT,CHN,2018.0,1,0,1
HRV,EST,2017.0,2,0,2
KEN,SLE,2019.0,1,0,1
KEN,SLE,2021.0,2,0,2
GBR,FSM,2017.0,1,0,1
RUS,MMR,2023.0,2,0,2
SEN,NCL,2015.0,1,0,1
CZE,UZB,2021.0,3,0,3
DZA,MAR,2000.0,3,0,3
ITA,ETH,2005.0,1,0,1
PHL,MYS,2005.0,1,0,1
MTQ,CHE,2004.0,1,0,1
RUS,ROU,2000.0,6,0,6
ROU,RUS,2003.0,1,0,1
ESP,KWT,2014.0,2,0,2
COD,,2010.0,5,0,5
MDG,GAB,2017.0,1,0,1
CAN,KNA,2005.0,1,0,1
OMN,BRA,2013.0,1,0,1
ISL,CHE,2001.0,1,0,1
KHM,LAO,2008.0,2,0,2
AUT,BLR,1998.0,3,0,3
CMR,BEN,2009.0,1,0,1
BGD,GMB,2002.0,1,0,1
URY,SWE,2006.0,2,0,2
IND,SWZ,1997.0,1,0,1
CZE,IRL,1998.0,3,0,3
DNK,IDN,2003.0,1,0,1
BEL,DZA,2006.0,2,0,2
SLV,GBR,2000.0,1,0,1
CHE,BOL,2010.0,1,0,1
MCO,CHL,2006.0,1,0,1
NZL,IDN,2002.0,1,0,1
FRO,DEU,2010.0,1,0,1
DEU,FRO,2014.0,1,0,1
SGP,ARM,2005.0,1,0,1
ARM,GEO,2014.0,1,0,1
UKR,IND,1997.0,1,0,1
FRA,LTU,2007.0,4,0,4
NGA,NAM,2004.0,1,0,1
OMN,QAT,2007.0,1,0,1
KHM,PHL,2021.0,1,0,1
PRI,CAN,2000.0,1,0,1
TUR,ESP,2007.0,5,0,5
CAN,LKA,2000.0,3,0,3
DNK,PAK,2001.0,2,0,2
GBR,SDN,2006.0,2,0,2
EST,ITA,2002.0,1,0,1
BWA,AUS,2002.0,1,0,1
BWA,AUS,2005.0,1,0,1
SDN,PRT,2009.0,1,0,1
SWE,JAM,2015.0,1,0,1
MAR,GHA,2006.0,1,0,1
POL,OMN,1997.0,1,0,1
OMN,POL,1998.0,1,0,1
ARM,CZE,2006.0,1,0,1
GRC,MKD,2004.0,1,0,1
MUS,IND,2008.0,1,0,1
SGP,CYP,2007.0,1,0,1
SRB,FIN,2015.0,1,0,1
JAM,ZWE,1997.0,1,0,1
,GNB,2005.0,1,0,1
,WSM,2004.0,6,0,6
CHN,IRQ,2008.0,1,0,1
GAB,ETH,2011.0,1,0,1
BEL,CRI,2008.0,1,0,1
URY,MEX,2011.0,1,0,1
NOR,NPL,2012.0,1,0,1
FRA,ATA,2010.0,1,0,1
DEU,BIH,2006.0,2,0,2
DNK,MEX,2003.0,2,0,2
ARG,SYR,2002.0,1,0,1
CHN,SYR,2011.0,1,0,1
LAO,ETH,2014.0,1,0,1
ARM,GBR,2008.0,1,0,1
HUN,MEX,2008.0,1,0,1
,VUT,1995.0,3,0,3
COL,ARM,2002.0,1,0,1
NAM,NGA,2019.0,1,0,1
SAU,FIN,2019.0,5,0,5
NOR,URY,2018.0,1,0,1
NAM,,2011.0,5,0,5
PER,VNM,2016.0,1,0,1
BTN,NPL,2019.0,2,0,2
BRA,DZA,2013.0,1,0,1
CYP,ITA,2005.0,2,0,2
AUS,PAN,2017.0,1,0,1
NOR,PAK,2008.0,1,0,1
DEU,MMR,2013.0,3,0,3
IND,ATG,2017.0,1,0,1
,PRK,2005.0,3,0,3
CHL,ISL,2020.0,3,0,3
NLD,MAR,2003.0,1,0,1
NZL,MEX,2004.0,1,0,1
AUT,ALB,2007.0,2,0,2
TZA,PAK,2014.0,1,0,1
MYS,GHA,2015.0,2,0,2
LIE,ITA,2019.0,2,0,2
IRN,SYR,2010.0,1,0,1
GEO,CAN,2014.0,1,0,1
FJI,NLD,2020.0,2,0,2
NPL,RWA,2012.0,1,0,1
RWA,TZA,2016.0,1,0,1
AGO,ESP,2022.0,1,0,1
CAN,KAZ,2016.0,3,0,3
ESP,JAM,2014.0,2,0,2
RUS,ARE,2019.0,2,0,2
MKD,SWE,2014.0,1,0,1
UZB,GBR,2012.0,2,0,2
MKD,DEU,2011.0,1,0,1
PRT,KAZ,2017.0,1,0,1
JOR,COG,2019.0,1,0,1
SWE,JOR,2013.0,3,0,3
KOR,ECU,2016.0,1,0,1
RUS,CYP,2017.0,1,0,1
GHA,IND,2011.0,1,0,1
ETH,IDN,2018.0,2,0,2
SRB,IND,2011.0,2,0,2
GBR,CRI,2001.0,3,0,3
CRI,DNK,2005.0,1,0,1
NZL,NCL,2006.0,2,0,2
ARG,SVN,2014.0,1,0,1
DEU,GIN,2013.0,1,0,1
ETH,BEL,2002.0,1,0,1
BRA,MUS,2004.0,1,0,1
HKG,NGA,2011.0,1,0,1
MAC,KAZ,2016.0,1,0,1
KGZ,USA,1999.0,1,0,1
HUN,BRA,2003.0,1,0,1
CUB,PRT,1999.0,1,0,1
NGA,BFA,2001.0,1,0,1
LBN,LBY,2007.0,3,0,3
TTO,NZL,2020.0,1,0,1
TUN,AUT,2003.0,1,0,1
AUT,TUN,2004.0,1,0,1
SAU,RUS,2011.0,1,0,1
RUS,SAU,2017.0,7,0,7
GUF,FRA,2024.0,3,0,3
,NRU,2011.0,2,0,2
BRN,THA,2018.0,1,0,1
USA,SLV,2004.0,2,0,2
SWE,HRV,2005.0,1,0,1
CMR,TUN,2015.0,2,0,2
ETH,NZL,2022.0,1,0,1
ROU,BWA,2019.0,1,0,1
HKG,PAK,1999.0,2,0,2
JAM,CAN,2002.0,1,0,1
THA,SDN,2014.0,1,0,1
MYS,CHN,2006.0,6,0,6
TWN,ISR,2003.0,2,0,2
ITA,ARM,2019.0,1,0,1
TUN,SGP,2011.0,1,0,1
CIV,COD,2020.0,1,0,1
TTO,BWA,2014.0,1,0,1
COL,EGY,2018.0,1,0,1
RWA,CHE,2021.0,1,0,1
VNM,FIN,2022.0,2,0,2
TCA,USA,2019.0,2,0,2
NZL,IRQ,2018.0,1,0,1
IRL,KWT,2018.0,3,0,3
ISL,NLD,2003.0,1,0,1
MYS,POL,2020.0,3,0,3
KWT,CHN,2016.0,1,0,1
BLR,CYP,2019.0,1,0,1
PNG,AUT,2014.0,1,0,1
NPL,MLT,2020.0,1,0,1
ERI,ZAF,2022.0,1,0,1
NPL,SLE,2018.0,1,0,1
CHE,ALB,2012.0,1,0,1
ARG,GTM,2020.0,2,0,2
BEL,LTU,1997.0,1,0,1
UZB,BLR,2019.0,1,0,1
IDN,LBY,2022.0,1,0,1
JPN,LTU,2022.0,1,0,1
EST,PRT,2023.0,2,0,2
RUS,HKG,2019.0,4,0,4
LBN,UKR,2022.0,1,0,1
SWE,BEN,2022.0,3,0,3
NGA,EGY,2019.0,3,0,3
,SVK,2021.0,1,0,1
DZA,FIN,2022.0,1,0,1
LKA,TWN,2022.0,1,0,1
ERI,,2005.0,3,0,3
,SSD,2020.0,9,0,9
NLD,OMN,2023.0,1,0,1
LAO,DEU,2019.0,1,0,1
POL,TWN,1997.0,1,0,1
UKR,ITA,2004.0,4,0,4
MDA,ESP,2001.0,1,0,1
JPN,SAU,1999.0,1,0,1
ARE,HKG,2006.0,2,0,2
CZE,VNM,1998.0,1,0,1
PAK,SWE,2003.0,2,0,2
TWN,SWE,2000.0,2,0,2
GBR,GRD,2010.0,1,0,1
KEN,PER,2001.0,3,0,3
NAM,DNK,2001.0,1,0,1
IDN,NZL,2010.0,1,0,1
HKG,HUN,2009.0,1,0,1
IND,KEN,2002.0,2,0,2
CRI,HND,2015.0,1,0,1
CRI,CHL,2015.0,1,0,1
BRA,SVK,2008.0,1,0,1
KHM,COL,2004.0,1,0,1
MDG,REU,2010.0,3,0,3
CRI,VNM,2018.0,1,0,1
BEL,DJI,2014.0,1,0,1
POL,LUX,2012.0,2,0,2
ARG,TUR,2021.0,1,0,1
SVN,IND,2003.0,1,0,1
EGY,BEL,1997.0,1,0,1
GRC,MAR,1998.0,1,0,1
TUR,SVN,2000.0,1,0,1
DNK,AUS,2024.0,1,0,1
JPN,UGA,2020.0,4,0,4
SAU,GRC,2002.0,1,0,1
USA,MNE,2022.0,1,0,1
ESP,ZAF,1997.0,3,0,3
SGP,NGA,2006.0,1,0,1
USA,LIE,2019.0,1,0,1
GBR,REU,2007.0,1,0,1
MAC,MKD,2005.0,1,0,1
FJI,GBR,2002.0,2,0,2
EGY,KEN,2010.0,1,0,1
SWE,BGD,2000.0,4,0,4
TUN,NLD,2016.0,1,0,1
TCA,USA,2011.0,2,0,2
JPN,AFG,2017.0,2,0,2
UZB,CAN,2009.0,1,0,1
BTN,IND,2015.0,1,0,1
NLD,TWN,2007.0,1,0,1
BMU,ESP,2001.0,1,0,1
CZE,SLV,2018.0,1,0,1
SDN,OMN,2015.0,2,0,2
CHE,BGR,2007.0,1,0,1
ALB,NLD,2009.0,1,0,1
FIN,GRC,2004.0,2,0,2
NZL,COL,2015.0,1,0,1
ISR,SRB,2013.0,1,0,1
ARE,CHL,2017.0,1,0,1
KEN,IRL,2015.0,1,0,1
BTN,VNM,2017.0,1,0,1
CZE,PER,2017.0,1,0,1
CHE,MWI,2023.0,2,0,2
JPN,KAZ,2014.0,1,0,1
MDA,FRA,2020.0,1,0,1
THA,ROU,2020.0,1,0,1
COL,CHN,2012.0,2,0,2
FRA,MOZ,2019.0,3,0,3
GBR,MSR,2015.0,1,0,1
,PYF,2017.0,10,0,10
SOM,ARE,2020.0,1,0,1
DNK,OMN,2016.0,1,0,1
TTO,KNA,2019.0,2,0,2
GAB,,2001.0,9,0,9
TUR,CHL,2022.0,1,0,1
,TCA,2014.0,3,0,3
ITA,MMR,2018.0,1,0,1
TGO,GMB,2021.0,1,0,1
GUF,USA,2016.0,1,0,1
GTM,ARG,2018.0,1,0,1
IDN,COD,2023.0,1,0,1
TUR,IDN,2010.0,2,0,2
JOR,HUN,2017.0,3,0,3
JOR,AUT,2015.0,1,0,1
MMR,PHL,2020.0,2,0,2
SGP,ETH,2019.0,3,0,3
MAC,CAN,2023.0,1,0,1
UZB,KGZ,2022.0,1,0,1
KOR,ARM,2019.0,1,0,1
HUN,PER,2020.0,1,0,1
SYR,BEL,2023.0,1,0,1
,GUY,2007.0,3,0,3
GUY,GUF,2014.0,1,0,1
GUF,GLP,2019.0,1,0,1
MYS,CHN,2024.0,3,0,3
IDN,KWT,2021.0,1,0,1
LSO,TZA,2021.0,1,0,1
GEO,JPN,2021.0,2,0,2
AZE,IRN,2023.0,1,0,1
NPL,MDV,2012.0,1,0,1
BRA,SOM,2022.0,3,0,3
,BLZ,2003.0,4,0,4
UZB,IRN,2008.0,1,0,1
UZB,PAK,2010.0,1,0,1
PRI,UKR,2014.0,1,0,1
COG,SLE,2009.0,1,0,1
PAN,PRI,2007.0,1,0,1
SYR,CZE,2019.0,1,0,1
NLD,GHA,2007.0,3,0,3
SEN,BGD,2017.0,1,0,1
ITA,VEN,2009.0,2,0,2
KAZ,BRN,2010.0,1,0,1
IND,FIN,2004.0,2,0,2
CMR,NOR,2007.0,1,0,1
USA,TGO,2009.0,2,0,2
ITA,PER,2004.0,2,0,2
NOR,PSE,2007.0,1,0,1
FRA,LBY,2010.0,1,0,1
,VCT,2000.0,1,0,1
MOZ,BDI,2019.0,1,0,1
BRN,LKA,2023.0,1,0,1
SVK,FIN,2008.0,2,0,2
TGO,NLD,2014.0,1,0,1
SEN,KEN,2012.0,2,0,2
KEN,SEN,2018.0,3,0,3
THA,NIC,2010.0,1,0,1
IND,RWA,2008.0,1,0,1
GUF,,2015.0,8,0,8
SRB,KWT,2022.0,1,0,1
ISL,CAN,2007.0,2,0,2
HKG,GRC,2004.0,1,0,1
GHA,BWA,2021.0,1,0,1
ESP,BFA,2017.0,1,0,1
SMR,NZL,2020.0,1,0,1
DZA,AUS,2020.0,2,0,2
ARG,NPL,2000.0,1,0,1
CHE,LUX,2013.0,6,0,6
CMR,PHL,2019.0,1,0,1
SYR,ESP,2021.0,1,0,1
PAK,UGA,2015.0,1,0,1
TUR,MEX,2022.0,1,0,1
,VIR,2012.0,3,0,3
ESP,MDV,2017.0,1,0,1
MDV,ITA,2019.0,3,0,3
SHN,BRA,2019.0,1,0,1
TGO,GHA,2019.0,1,0,1
MYS,ZWE,2023.0,1,0,1
DJI,FRA,2000.0,1,0,1
CZE,IRL,1999.0,1,0,1
EGY,CYP,2005.0,1,0,1
IRN,CHN,1999.0,1,0,1
AUT,LVA,1997.0,1,0,1
LVA,HUN,1998.0,1,0,1
IRN,ZAF,2002.0,3,0,3
KAZ,CZE,2007.0,2,0,2
NGA,UGA,2009.0,2,0,2
CZE,BRA,2007.0,1,0,1
,ERI,1994.0,2,0,2
ERI,SWE,2003.0,1,0,1
USA,DZA,1997.0,1,0,1
FRA,AND,2021.0,2,0,2
LTU,CHE,2013.0,3,0,3
,NIC,2012.0,16,0,16
ZWE,NGA,2000.0,1,0,1
PAN,ITA,2015.0,1,0,1
NIC,GIB,2012.0,1,0,1
CHE,SGP,2000.0,6,0,6
,MAC,1998.0,3,0,3
SEN,CAF,2008.0,1,0,1
MCO,CHE,2000.0,2,0,2
SWE,TGO,2008.0,1,0,1
VNM,HUN,2016.0,2,0,2
FRA,LKA,2012.0,1,0,1
UKR,FIN,2018.0,5,0,5
NZL,ISL,2003.0,1,0,1
MCO,,2002.0,3,0,3
PAK,FRA,2008.0,5,0,5
UKR,NLD,2018.0,8,0,8
RUS,IRQ,2005.0,1,0,1
LUX,PAK,2017.0,1,0,1
,SLV,1994.0,9,0,9
PAK,KAZ,2014.0,1,0,1
SRB,HKG,2015.0,1,0,1
ZAF,CIV,2019.0,6,0,6
URY,GBR,1999.0,1,0,1
GRC,SVK,2011.0,4,0,4
POL,BIH,2018.0,1,0,1
KGZ,AUS,2018.0,1,0,1
AUS,PYF,2021.0,1,0,1
,FRO,2010.0,5,0,5
,GUM,2019.0,7,0,7
NAM,VNM,2019.0,2,0,2
,PRI,2020.0,77,0,77
QAT,PSE,2016.0,2,0,2
JOR,TUN,2018.0,3,0,3
MEX,MAR,2012.0,1,0,1
ECU,,2003.0,8,0,8
FRA,ARM,1999.0,1,0,1
UKR,NOR,1998.0,1,0,1
THA,NPL,1999.0,1,0,1
POL,CHL,2009.0,2,0,2
IRQ,SWE,2015.0,3,0,3
COD,ZAF,2010.0,2,0,2
GRC,FIN,2012.0,5,0,5
HUN,TUR,2005.0,1,0,1
SGP,DNK,2002.0,3,0,3
CMR,CHE,1998.0,1,0,1
UKR,AUS,2002.0,1,0,1
COG,USA,2002.0,5,0,5
MYS,IRN,2004.0,1,0,1
PYF,MEX,2016.0,1,0,1
AUS,ETH,2003.0,1,0,1
ETH,AUS,2006.0,1,0,1
BWA,NLD,2007.0,1,0,1
,GTM,1996.0,9,0,9
PNG,JPN,2016.0,1,0,1
AZE,GBR,2007.0,1,0,1
ARM,DNK,2010.0,1,0,1
LKA,AFG,2009.0,1,0,1
ISL,CHL,2011.0,1,0,1
IRN,ITA,2002.0,3,0,3
NGA,FJI,2000.0,2,0,2
ZMB,DNK,1999.0,1,0,1
BEL,GIN,2003.0,1,0,1
NAM,,2003.0,5,0,5
HUN,TWN,2006.0,1,0,1
ISR,HRV,2002.0,2,0,2
ROU,KOR,2005.0,1,0,1
KOR,ROU,2006.0,1,0,1
VEN,CUB,2002.0,2,0,2
ARM,ESP,2001.0,2,0,2
ESP,ARM,2002.0,2,0,2
CHN,PYF,2018.0,1,0,1
CHE,GLP,2009.0,1,0,1
PRT,ZAF,2017.0,4,0,4
YEM,SVK,2002.0,2,0,2
,COD,1996.0,7,0,7
SGP,QAT,2010.0,2,0,2
HKG,CYP,2012.0,1,0,1
PER,FRA,2001.0,4,0,4
PER,SEN,2012.0,1,0,1
GUF,GUY,2003.0,2,0,2
HUN,RUS,1997.0,2,0,2
SJM,NOR,2019.0,1,0,1
FRA,MSR,1997.0,2,0,2
FRO,,2008.0,1,0,1
BGD,OMN,2007.0,1,0,1
VEN,RUS,1997.0,1,0,1
MTQ,HTI,2017.0,1,0,1
BRA,TUN,2020.0,1,0,1
AUS,BIH,2009.0,1,0,1
JPN,TZA,2015.0,7,0,7
JPN,BRN,2017.0,2,0,2
CMR,ROU,2013.0,2,0,2
GEO,CHE,2022.0,2,0,2
CHE,CIV,2018.0,2,0,2
NGA,KOR,2020.0,6,0,6
NGA,MOZ,2013.0,1,0,1
CMR,PAK,2013.0,1,0,1
CHL,ISR,2002.0,1,0,1
ARM,GBR,2010.0,3,0,3
ARG,KOR,2017.0,2,0,2
BGD,CHN,2006.0,1,0,1
COG,TUN,2008.0,3,0,3
MYS,CYM,2009.0,1,0,1
MLT,AUS,2015.0,1,0,1
CUB,DOM,2013.0,1,0,1
KGZ,UZB,2009.0,1,0,1
UZB,KGZ,2012.0,2,0,2
ARM,AUS,2013.0,1,0,1
NZL,VNM,2010.0,2,0,2
JPN,PRY,2012.0,1,0,1
LTU,AUT,2015.0,1,0,1
COD,,2015.0,6,0,6
CYP,CHN,2017.0,1,0,1
GRL,USA,2020.0,1,0,1
ARE,TUR,2014.0,2,0,2
GUF,USA,2005.0,1,0,1
,LIE,2010.0,3,0,3
KGZ,CHE,2014.0,2,0,2
,TKM,2005.0,4,0,4
TUR,CHL,2012.0,2,0,2
IRL,GHA,2020.0,1,0,1
PRT,KEN,2018.0,2,0,2
RUS,MLI,2018.0,1,0,1
NGA,GUY,2018.0,2,0,2
GRD,,2015.0,9,0,9
BMU,,2015.0,2,0,2
MMR,,2017.0,22,0,22
LBY,ARE,2018.0,1,0,1
DNK,IRQ,2017.0,1,0,1
GBR,MDA,2021.0,2,0,2
IRL,ARE,2014.0,4,0,4
KOR,KEN,2020.0,4,0,4
GHA,LKA,2023.0,1,0,1
LVA,DNK,2020.0,1,0,1
EST,CZE,2019.0,6,0,6
MOZ,PSE,2018.0,1,0,1
NPL,MYS,2019.0,1,0,1
CXR,AUS,2018.0,1,0,1
PAK,NGA,2013.0,1,0,1
REU,NGA,2013.0,1,0,1
ETH,SDN,2018.0,1,0,1
LKA,OMN,2018.0,1,0,1
MYS,ZAF,2012.0,1,0,1
USA,GUF,2015.0,2,0,2
CHL,SRB,2010.0,1,0,1
TUR,POL,2017.0,7,0,7
THA,ARE,2020.0,4,0,4
FIN,LTU,2014.0,4,0,4
NOR,ZMB,2021.0,2,0,2
GMB,KHM,2018.0,1,0,1
SVK,NZL,2012.0,2,0,2
BEL,LKA,2017.0,1,0,1
BRA,GUY,2016.0,2,0,2
CYP,CAN,2019.0,1,0,1
,AFG,2005.0,7,0,7
ISR,PRT,2005.0,2,0,2
KOR,MMR,2015.0,2,0,2
SVK,AUS,2021.0,2,0,2
GAB,COG,2020.0,2,0,2
TZA,RWA,2019.0,2,0,2
MYS,LBN,2017.0,1,0,1
THA,IDN,2015.0,7,0,7
ISR,KEN,2016.0,1,0,1
GHA,COD,2019.0,3,0,3
PAK,CYP,2020.0,1,0,1
VEN,MEX,2022.0,5,0,5
IND,BWA,2016.0,4,0,4
DOM,CHL,2020.0,1,0,1
ZWE,GHA,2011.0,1,0,1
UKR,FIN,2022.0,4,0,4
TUR,HKG,2020.0,1,0,1
MNG,UKR,2015.0,1,0,1
MKD,SVN,2020.0,1,0,1
UGA,SVK,2018.0,1,0,1
PRT,HKG,2001.0,2,0,2
KGZ,CAN,2022.0,1,0,1
SWE,KWT,1999.0,1,0,1
GAB,CMR,2020.0,1,0,1
DNK,CRI,2019.0,2,0,2
SWE,KAZ,2018.0,3,0,3
QAT,POL,2020.0,2,0,2
COL,MLI,2015.0,1,0,1
EGY,NOR,2023.0,5,0,5
,LSO,2019.0,14,0,14
,MDV,2020.0,8,0,8
SWE,PNG,2004.0,2,0,2
ROU,BGD,2019.0,1,0,1
KNA,CAN,2022.0,2,0,2
CUB,USA,2023.0,3,0,3
USA,SXM,2022.0,5,0,5
,RWA,1998.0,2,0,2
BRA,THA,1998.0,1,0,1
THA,BRA,2012.0,1,0,1
AUS,VUT,2003.0,1,0,1
RUS,EGY,2000.0,2,0,2
IRQ,EGY,2009.0,1,0,1
KHM,JPN,2006.0,2,0,2
BLR,AUS,2003.0,1,0,1
SAU,PNG,2019.0,1,0,1
GUY,GUF,2000.0,1,0,1
COD,,2001.0,1,0,1
CRI,JPN,2002.0,1,0,1
NCL,,2005.0,3,0,3
GUY,,2006.0,2,0,2
USA,CYM,2023.0,2,0,2
TWN,PAK,2002.0,1,0,1
NZL,BHR,2016.0,1,0,1
,LIE,2000.0,3,0,3
,ATA,2015.0,2,0,2
MNG,ZAF,2018.0,1,0,1
CAN,HRV,2003.0,2,0,2
PAK,SDN,1998.0,1,0,1
SDN,PAK,2018.0,1,0,1
AUT,SDN,2017.0,1,0,1
GRL,SWE,2007.0,1,0,1
,PYF,2005.0,7,0,7
GBR,PSE,1998.0,1,0,1
MLT,,2005.0,6,0,6
GNQ,USA,2018.0,2,0,2
NGA,SLE,2022.0,2,0,2
PAK,KOR,1998.0,1,0,1
PRI,MWI,2009.0,1,0,1
,LUX,1999.0,20,0,20
PRT,LTU,2022.0,1,0,1
LTU,PRT,2023.0,2,0,2
,UKR,2021.0,8,0,8
SWE,COG,2018.0,1,0,1
JOR,NLD,2023.0,3,0,3
SWE,LBN,2002.0,1,0,1
GEO,ZAF,1998.0,1,0,1
,GRL,2000.0,5,0,5
KEN,DNK,2002.0,2,0,2
UGA,LAO,2001.0,1,0,1
IRL,SRB,2007.0,1,0,1
TZA,NGA,1998.0,2,0,2
MDG,SEN,1999.0,1,0,1
SEN,MDG,2009.0,1,0,1
JPN,AZE,2005.0,1,0,1
NLD,LAO,2006.0,2,0,2
RUS,ROU,2004.0,2,0,2
KEN,MLI,2005.0,1,0,1
AGO,,2004.0,2,0,2
KWT,GHA,2014.0,1,0,1
UKR,TWN,1999.0,3,0,3
CHE,ISL,2014.0,1,0,1
EST,RUS,1998.0,3,0,3
ZMB,NLD,2013.0,3,0,3
NGA,NER,2000.0,1,0,1
DZA,SAU,2001.0,2,0,2
SAU,NGA,2006.0,4,0,4
TUR,EST,2014.0,2,0,2
EST,TUR,2015.0,2,0,2
CHN,GEO,2021.0,1,0,1
DZA,ARE,2003.0,1,0,1
DEU,MCO,2017.0,2,0,2
ITA,URY,1998.0,1,0,1
USA,LAO,1998.0,2,0,2
ROU,KOR,2002.0,2,0,2
BEL,SVN,1999.0,1,0,1
GUF,,2010.0,4,0,4
DNK,SWE,2024.0,4,0,4
CHE,RWA,2014.0,1,0,1
IDN,MEX,2005.0,1,0,1
TUR,GRC,2004.0,3,0,3
MLI,,2008.0,5,0,5
DZA,CAN,1997.0,1,0,1
JPN,MMR,2001.0,4,0,4
BEL,CIV,2000.0,2,0,2
,HTI,1999.0,2,0,2
BRB,MYS,1999.0,1,0,1
IND,BRB,2007.0,1,0,1
COL,RUS,2002.0,1,0,1
CYP,ISR,2016.0,2,0,2
BGD,ITA,2003.0,1,0,1
IND,JOR,2005.0,3,0,3
GRC,MNE,2001.0,1,0,1
RUS,IRN,2008.0,8,0,8
BRB,,2007.0,4,0,4
MDG,BFA,2001.0,1,0,1
LTU,LIE,2014.0,4,0,4
TUR,SGP,2009.0,1,0,1
IND,SVK,2013.0,1,0,1
DEU,LBY,2017.0,1,0,1
MUS,CAN,2009.0,1,0,1
MNE,,2012.0,6,0,6
AUT,FJI,2016.0,1,0,1
FJI,MYS,2022.0,1,0,1
CRI,RUS,2010.0,2,0,2
VNM,KEN,2022.0,1,0,1
THA,DNK,2010.0,1,0,1
KWT,ZAF,2020.0,1,0,1
MAR,ARE,2023.0,3,0,3
SYR,MYS,2022.0,1,0,1
TUN,QAT,2015.0,4,0,4
NZL,SDN,2009.0,1,0,1
JOR,BHR,2016.0,6,0,6
IRL,KAZ,2021.0,3,0,3
TWN,PAK,2012.0,1,0,1
ABW,,2015.0,1,0,1
AUT,BHR,2017.0,1,0,1
GNB,,2011.0,2,0,2
ESP,DOM,2015.0,3,0,3
LUX,ITA,2007.0,1,0,1
MTQ,,2012.0,2,0,2
,MLT,2003.0,16,0,16
IRL,MLT,2015.0,2,0,2
SUR,,2020.0,4,0,4
CPV,,2015.0,6,0,6
CHE,SDN,2015.0,3,0,3
,BHS,2010.0,4,0,4
SDN,IRL,2016.0,2,0,2
GBR,STP,2013.0,1,0,1
CMR,COG,2019.0,1,0,1
COG,CMR,2022.0,2,0,2
NZL,AFG,2015.0,1,0,1
JOR,NIC,2022.0,1,0,1
UGA,ZMB,2017.0,1,0,1
PNG,DNK,2017.0,1,0,1
,TCD,2011.0,6,0,6
,ASM,2011.0,3,0,3
ZAF,CZE,2020.0,2,0,2
MYS,CHE,2005.0,2,0,2
CHE,MYS,2007.0,2,0,2
GNQ,USA,2016.0,2,0,2
BEL,PHL,2015.0,2,0,2
,FJI,2009.0,20,0,20
DEU,LBY,2018.0,2,0,2
ITA,MAC,2013.0,1,0,1
BGD,FIN,2020.0,3,0,3
SAU,CRI,2016.0,1,0,1
FRA,EGY,2024.0,1,0,1
JPN,LBN,2018.0,2,0,2
BEL,ETH,2003.0,1,0,1
,COM,2014.0,3,0,3
NZL,URY,2018.0,1,0,1
MAR,CMR,2020.0,3,0,3
MYS,CYP,2019.0,1,0,1
GRC,LIE,2016.0,1,0,1
LIE,HUN,2021.0,1,0,1
SLV,VEN,2011.0,1,0,1
HRV,DZA,2019.0,1,0,1
SVK,IRL,2023.0,1,0,1
,TKM,2012.0,6,0,6
ITA,CIV,2018.0,1,0,1
GBR,SLV,2021.0,1,0,1
CYP,,2026.0,12,0,12
GUY,ZAF,2022.0,1,0,1
,MHL,2018.0,1,0,1
BGD,CHE,2016.0,2,0,2
MOZ,,2000.0,3,0,3
IRQ,BHR,2020.0,1,0,1
MLT,MYS,2022.0,1,0,1
EGY,LTU,2022.0,2,0,2
ZWE,NGA,2006.0,2,0,2
GRC,ARG,2018.0,2,0,2
OMN,AUT,2018.0,1,0,1
NZL,ARG,2001.0,1,0,1
CHL,BOL,2015.0,2,0,2
SDN,ARE,2000.0,1,0,1
ARE,SDN,2011.0,1,0,1
ESP,AND,2007.0,4,0,4
AND,,2011.0,2,0,2
JPN,LAO,2012.0,6,0,6
SRB,CZE,2004.0,1,0,1
CHE,BIH,2006.0,2,0,2
MDG,CMR,2002.0,1,0,1
ESP,SAU,2009.0,3,0,3
AUT,BIH,2004.0,3,0,3
AUT,CMR,2011.0,1,0,1
BEL,IDN,2004.0,3,0,3
,SLV,2011.0,12,0,12
BLR,LBN,2017.0,2,0,2
EGY,MKD,2016.0,1,0,1
LTU,IND,2006.0,2,0,2
MYS,ITA,2002.0,1,0,1
DEU,TUN,2004.0,2,0,2
LKA,MYS,2010.0,1,0,1
FJI,NGA,2007.0,1,0,1
NZL,MMR,2015.0,2,0,2
FIN,ISL,2012.0,2,0,2
IOT,GBR,2011.0,1,0,1
LAO,UZB,2014.0,1,0,1
BRA,HRV,2003.0,1,0,1
ZMB,,2007.0,12,0,12
CAN,BRB,2015.0,2,0,2
CHL,GRC,2003.0,1,0,1
ETH,NLD,2002.0,5,0,5
,ABW,1995.0,1,0,1
GRC,LBN,2009.0,1,0,1
USA,NIC,2006.0,7,0,7
BHS,,2012.0,2,0,2
FIN,ARG,2009.0,3,0,3
FLK,POL,2008.0,1,0,1
ITA,LBY,2005.0,1,0,1
CZE,ARG,2011.0,1,0,1
BGD,NPL,2000.0,2,0,2
LBR,SAU,2021.0,1,0,1
LAO,KOR,2004.0,1,0,1
,FSM,1998.0,3,0,3
MLT,,2002.0,4,0,4
SEN,RWA,2011.0,1,0,1
RWA,COG,2021.0,4,0,4
DZA,ZAF,2006.0,1,0,1
UGA,FRA,2019.0,1,0,1
FRA,UGA,2020.0,3,0,3
,COD,2001.0,1,0,1
TUN,LBN,2008.0,1,0,1
POL,LBY,2008.0,2,0,2
COD,,2004.0,1,0,1
SWE,IRL,1997.0,4,0,4
IND,CHL,2000.0,2,0,2
RUS,TJK,2008.0,2,0,2
PAN,ITA,2014.0,1,0,1
ARM,CAN,2013.0,5,0,5
CYP,ARM,2004.0,1,0,1
HKG,IRL,2007.0,3,0,3
ESP,NGA,1999.0,1,0,1
NZL,GBR,2024.0,1,0,1
FIN,SGP,2005.0,2,0,2
NGA,CHN,2003.0,1,0,1
JOR,FIN,2007.0,1,0,1
SVK,KEN,2018.0,3,0,3
MEX,EST,2023.0,1,0,1
CMR,MAR,2007.0,1,0,1
,SLE,2003.0,4,0,4
EGY,IRQ,2014.0,4,0,4
COL,TWN,2009.0,1,0,1
MDA,TWN,2012.0,1,0,1
TWN,MDA,2013.0,1,0,1
CMR,COM,2018.0,1,0,1
AUS,PLW,2019.0,2,0,2
IND,ISL,2010.0,1,0,1
HUN,UKR,1998.0,1,0,1
DZA,SAU,2008.0,5,0,5
NPL,KOR,2008.0,3,0,3
CUB,CHL,2003.0,3,0,3
GLP,DEU,2007.0,1,0,1
TWN,MAR,2011.0,1,0,1
BHS,JAM,2008.0,1,0,1
CIV,CHN,2007.0,1,0,1
IND,LUX,2018.0,1,0,1
DEU,ISL,1998.0,1,0,1
DNK,URY,2020.0,2,0,2
HUN,KOR,2010.0,1,0,1
PRT,HRV,2009.0,1,0,1
ARG,POL,2016.0,1,0,1
USA,COD,2012.0,6,0,6
EST,SVK,2008.0,1,0,1
PYF,JPN,2013.0,1,0,1
FSM,PLW,2011.0,1,0,1
NOR,GRL,2014.0,1,0,1
YEM,CUB,2009.0,1,0,1
DEU,KGZ,2007.0,1,0,1
JAM,GUY,2004.0,2,0,2
ARE,SVK,2018.0,1,0,1
CAN,MLI,2007.0,1,0,1
MLI,CHE,2008.0,2,0,2
NPL,MYS,2011.0,3,0,3
NPL,ARE,2015.0,1,0,1
IRN,SGP,2009.0,3,0,3
OMN,KOR,2007.0,1,0,1
,FSM,2007.0,3,0,3
FJI,TON,2017.0,1,0,1
FJI,,2013.0,7,0,7
SLB,USA,2017.0,1,0,1
CAN,KHM,2018.0,2,0,2
DEU,MLI,2021.0,1,0,1
,SYC,2005.0,7,0,7
SYC,NCL,2008.0,1,0,1
ETH,CHE,2006.0,1,0,1
ARM,MEX,2015.0,1,0,1
AGO,,2014.0,11,0,11
UGA,CMR,2021.0,1,0,1
RUS,EST,2004.0,1,0,1
UGA,ITA,2004.0,1,0,1
LSO,ZWE,2009.0,1,0,1
GBR,URY,1998.0,2,0,2
CHL,CPV,2018.0,2,0,2
TON,,2011.0,2,0,2
,TCA,2006.0,4,0,4
,LSO,2009.0,9,0,9
PAK,AUS,2024.0,1,0,1
VEN,MYS,2010.0,1,0,1
,MTQ,2009.0,5,0,5
MYS,TZA,2015.0,1,0,1
NOR,RWA,2015.0,1,0,1
CZE,KWT,2023.0,1,0,1
NIC,CUB,2012.0,1,0,1
CUB,NIC,2015.0,1,0,1
SVK,PRT,2003.0,2,0,2
IRQ,PAK,2011.0,1,0,1
,TCD,2009.0,4,0,4
COG,NER,2021.0,1,0,1
GRC,ARG,2016.0,1,0,1
SLV,COL,2019.0,1,0,1
BLR,LTU,2016.0,1,0,1
DEU,ZWE,2016.0,2,0,2
AUS,VIR,2018.0,1,0,1
SVN,IDN,2020.0,1,0,1
ARG,PRY,2016.0,1,0,1
KAZ,ITA,2010.0,2,0,2
MYS,BHS,2018.0,1,0,1
CAN,AZE,2013.0,1,0,1
CHN,SVK,2020.0,4,0,4
MAR,QAT,2020.0,4,0,4
NPL,ITA,2018.0,2,0,2
NPL,ISL,2023.0,2,0,2
JOR,NZL,1998.0,1,0,1
ETH,MEX,2015.0,1,0,1
QAT,LUX,2021.0,1,0,1
ITA,BOL,2016.0,3,0,3
SDN,CHN,2010.0,1,0,1
TZA,KHM,2016.0,1,0,1
,MTQ,2011.0,5,0,5
HRV,HUN,2000.0,4,0,4
CHE,ALB,2017.0,1,0,1
SDN,IRN,2019.0,2,0,2
ASM,,2020.0,4,0,4
FIN,NPL,2020.0,1,0,1
DNK,TZA,2018.0,1,0,1
LAO,DNK,2021.0,1,0,1
,MHL,2016.0,2,0,2
PER,ARG,2013.0,2,0,2
,CAF,2016.0,9,0,9
HKG,GEO,2018.0,1,0,1
COL,JPN,2022.0,1,0,1
BHR,OMN,2023.0,1,0,1
AUT,BFA,2018.0,2,0,2
NLD,MRT,2020.0,1,0,1
MOZ,AUS,2022.0,1,0,1
JPN,GEO,2012.0,1,0,1
MKD,FRA,2023.0,2,0,2
BFA,GAB,2022.0,3,0,3
MYS,CZE,2023.0,2,0,2
RWA,COD,2023.0,1,0,1
NGA,DZA,2022.0,1,0,1
HUN,FIN,2023.0,1,0,1
HUN,SVN,2009.0,1,0,1
ITA,AGO,2011.0,1,0,1
,NAM,2000.0,12,0,12
UKR,SGP,2016.0,3,0,3
MDA,GBR,2014.0,1,0,1
BEN,CAN,2006.0,1,0,1
VEN,JPN,2015.0,1,0,1
HKG,PHL,2003.0,3,0,3
GBR,KIR,2002.0,1,0,1
LBN,BRA,2008.0,1,0,1
,FJI,1994.0,12,0,12
HKG,MUS,2000.0,1,0,1
GIN,PNG,2014.0,1,0,1
NER,KEN,2013.0,1,0,1
IRL,IRN,2006.0,5,0,5
FRA,MUS,2006.0,1,0,1
NZL,BHR,2017.0,1,0,1
SDN,,2005.0,15,0,15
FRA,LBY,2008.0,2,0,2
IRQ,CZE,2020.0,2,0,2
NGA,UKR,2004.0,2,0,2
DZA,ITA,2002.0,2,0,2
PHL,SAU,2010.0,2,0,2
ZWE,LSO,2010.0,1,0,1
SWE,AZE,2006.0,1,0,1
,VUT,1999.0,2,0,2
LAO,,2009.0,9,0,9
LKA,GHA,2000.0,1,0,1
TUN,MCO,2006.0,1,0,1
GBR,GUY,2003.0,2,0,2
BOL,THA,2009.0,1,0,1
ESP,JOR,2006.0,1,0,1
CZE,NPL,2006.0,1,0,1
ZWE,ZAF,2001.0,3,0,3
ZMB,ZAF,2008.0,3,0,3
TUN,EGY,2009.0,1,0,1
CIV,THA,2002.0,1,0,1
ROU,IND,1999.0,1,0,1
LVA,GBR,2000.0,3,0,3
,NER,1998.0,9,0,9
NER,BFA,2003.0,1,0,1
KEN,SOM,2008.0,1,0,1
NLD,ARM,2004.0,1,0,1
UKR,UZB,2016.0,1,0,1
MOZ,,2006.0,6,0,6
NLD,NIC,2005.0,1,0,1
TUR,SDN,1999.0,1,0,1
GRC,ARM,2005.0,1,0,1
SAU,PER,2014.0,1,0,1
ZWE,COG,2014.0,1,0,1
DNK,PAK,2010.0,1,0,1
ESP,ARE,2007.0,1,0,1
ZAF,ARG,1997.0,1,0,1
,MMR,1999.0,10,0,10
CHE,PSE,2002.0,1,0,1
CZE,LBY,2011.0,2,0,2
BEL,SVN,1998.0,1,0,1
RWA,ROU,2023.0,1,0,1
CAN,UGA,2008.0,3,0,3
CAN,LBN,1998.0,7,0,7
ZMB,GBR,1999.0,2,0,2
MYS,FIN,2010.0,2,0,2
LAO,,2011.0,11,0,11
TZA,CAN,2007.0,2,0,2
LTU,ESP,2005.0,1,0,1
DEU,IRN,1999.0,3,0,3
BEL,SUR,2014.0,3,0,3
ITA,TZA,2006.0,1,0,1
VUT,,2009.0,2,0,2
NAM,ZAF,1999.0,3,0,3
TGO,CAN,2009.0,1,0,1
IRQ,ARE,2008.0,1,0,1
SYR,OMN,2013.0,2,0,2
CYP,AUS,2016.0,2,0,2
PAK,VNM,2008.0,1,0,1
COD,RWA,2010.0,1,0,1
,AGO,2005.0,5,0,5
CHN,LIE,2011.0,1,0,1
LIE,,2013.0,5,0,5
DMA,TTO,2009.0,1,0,1
HRV,SVK,2008.0,1,0,1
BIH,ITA,2016.0,2,0,2
DZA,KOR,2014.0,1,0,1
DZA,SAU,2004.0,2,0,2
SVN,MNE,2012.0,1,0,1
FRA,PRY,2014.0,1,0,1
,GRD,1994.0,3,0,3
TZA,DNK,2011.0,1,0,1
CIV,COG,2013.0,1,0,1
BEL,GIN,2013.0,1,0,1
PER,AUT,2012.0,2,0,2
JAM,KOR,2014.0,1,0,1
BEL,SDN,2012.0,1,0,1
FRA,PRY,2015.0,1,0,1
EGY,AUS,2010.0,5,0,5
ISL,UGA,2020.0,1,0,1
PRI,DOM,2015.0,2,0,2
UKR,MEX,2017.0,2,0,2
TCA,,2012.0,2,0,2
HUN,IRN,2016.0,3,0,3
PAK,SOM,2018.0,1,0,1
QAT,HUN,2020.0,2,0,2
KWT,OMN,2011.0,1,0,1
MEX,PER,2010.0,2,0,2
ERI,AUS,2020.0,1,0,1
THA,KEN,2015.0,2,0,2
UGA,DZA,2016.0,1,0,1
IRL,PHL,2012.0,1,0,1
NAM,UGA,2016.0,1,0,1
GRL,,2021.0,4,0,4
USA,TJK,2019.0,1,0,1
GRC,HRV,2022.0,2,0,2
RWA,NAM,2021.0,1,0,1
SEN,CPV,2020.0,1,0,1
ITA,AZE,2010.0,1,0,1
TUN,MYS,2021.0,1,0,1
SVN,LTU,2022.0,2,0,2
PRT,EGY,2019.0,2,0,2
NZL,BEL,2005.0,2,6,-4
BEL,ZWE,2007.0,1,1,0
GBR,SVN,2001.0,5,5,0
AUS,KWT,1998.0,1,1,0
CHL,RUS,2012.0,2,1,1
THA,CHE,2000.0,1,6,-5
FJI,NZL,2001.0,2,1,1
CAN,TTO,2001.0,1,1,0
CHN,UKR,2017.0,5,20,-15
KOR,ZAF,2011.0,3,4,-1
ZWE,SWE,2002.0,2,3,-1
CZE,ESP,1998.0,2,2,0
BEL,ARE,2000.0,1,1,0
BEL,LUX,2002.0,6,5,1
ISR,UKR,2022.0,2,1,1
ETH,KEN,2021.0,10,5,5
FIN,GRC,2014.0,1,3,-2
QAT,OMN,2014.0,1,2,-1
VNM,AUS,2001.0,4,6,-2
ISR,IRL,2000.0,1,1,0
KEN,TUN,2012.0,2,2,0
USA,TTO,2006.0,5,7,-2
ITA,GHA,1997.0,1,1,0
POL,ARG,2011.0,1,1,0
DEU,SDN,2005.0,3,4,-1
CMR,DEU,1998.0,1,1,0
SWE,CRI,1999.0,1,1,0
MLI,FRA,2002.0,4,5,-1
CHL,GBR,1998.0,4,5,-1
SVN,ARG,2006.0,1,1,0
MNG,GBR,2015.0,4,3,1
NLD,ROU,2016.0,6,1,5
IRL,ZAF,2012.0,4,1,3
DEU,LBN,2006.0,1,1,0
OMN,AUS,2005.0,2,2,0
MYS,FIN,2015.0,2,2,0
PHL,BGD,2019.0,1,1,0
MDA,DEU,2016.0,4,2,2
THA,LAO,2021.0,8,4,4
BEL,GEO,2015.0,1,2,-1
LAO,LKA,2018.0,1,1,0
USA,BIH,2015.0,6,3,3
TUR,KOR,2013.0,6,7,-1
POL,IND,2010.0,2,3,-1
HKG,MYS,2016.0,3,4,-1
ROU,FIN,2010.0,4,1,3
RUS,GEO,2018.0,4,4,0
GHA,JPN,2008.0,2,1,1
UZB,USA,2000.0,3,1,2
DNK,GNB,1999.0,1,1,0
TUN,PRT,2012.0,1,2,-1
NZL,IDN,2012.0,1,1,0
KEN,CAN,1998.0,5,6,-1
TZA,SWE,2001.0,1,9,-8
ZWE,NLD,2022.0,2,2,0
LUX,CHN,2017.0,3,2,1
MLT,GBR,2004.0,4,7,-3
KOR,IRL,2015.0,4,4,0
QAT,KOR,2018.0,1,7,-6
TWN,BEL,2004.0,3,1,2
TTO,BRB,2009.0,1,3,-2
QAT,LBN,2020.0,1,3,-2
KOR,TUN,2017.0,2,1,1
BEL,RUS,2021.0,4,16,-12
ECU,CRI,2018.0,1,2,-1
IDN,FIN,2022.0,3,2,1
CZE,NOR,2010.0,3,4,-1
BGR,FIN,2014.0,1,2,-1
EST,NOR,2018.0,2,2,0
GHA,NZL,2022.0,1,2,-1
IND,LBR,2021.0,3,1,2
KAZ,ISR,2019.0,4,2,2
DZA,PRT,2020.0,2,6,-4
CHE,JOR,2021.0,1,1,0
BEL,MYS,2018.0,1,5,-4
GBR,NIC,2022.0,2,1,1
PHL,HKG,2020.0,4,4,0
NGA,FRA,2022.0,6,6,0
PRT,ISR,2011.0,1,4,-3
COL,PRT,2023.0,4,1,3
LUX,PRT,2020.0,2,2,0
ESP,URY,2005.0,1,8,-7
CRI,PAN,2020.0,2,2,0
ARE,ESP,2020.0,5,5,0
HUN,POL,2020.0,4,7,-3
CAN,EST,2020.0,3,2,1
CHE,PSE,2022.0,2,1,1
FIN,COL,2022.0,1,1,0
ESP,HRV,2020.0,5,5,0
COG,ZAF,2022.0,3,2,1
RUS,IRN,2006.0,8,2,6
ARE,ISR,2022.0,1,1,0
AUT,GRC,2010.0,6,4,2
MYS,SDN,2022.0,9,2,7
SEN,BFA,2022.0,1,3,-2
PAK,TWN,2023.0,7,6,1
SVK,USA,2022.0,5,5,0
ARG,TUR,2019.0,2,3,-1
NGA,COD,2020.0,2,1,1
NZL,SVK,2018.0,2,1,1
ESP,BGD,2018.0,1,1,0
USA,BLZ,2007.0,1,1,0
ARG,NLD,2002.0,9,3,6
ESP,BGR,2019.0,1,3,-2
USA,ZWE,2022.0,5,8,-3
SDN,FRA,2001.0,3,1,2
VNM,PHL,2004.0,1,1,0
JOR,GBR,2014.0,8,38,-30
TZA,GBR,1999.0,11,5,6
BGD,CAN,2003.0,6,1,5
GUY,FRA,2000.0,3,1,2
BRA,COL,2000.0,7,3,4
BGR,CAN,2018.0,2,2,0
THA,BGD,2004.0,2,1,1
ZMB,BWA,2003.0,1,1,0
TUN,JPN,2012.0,3,1,2
GBR,BHR,2002.0,2,2,0
ISL,DNK,2018.0,2,9,-7
IDN,IND,2007.0,5,5,0
IND,GEO,2021.0,1,3,-2
GRC,SGP,2016.0,4,1,3
MYS,BGD,2000.0,3,5,-2
IDN,FRA,2011.0,2,10,-8
ARE,LBN,2010.0,2,2,0
FIN,HUN,2010.0,1,3,-2
BEL,SVK,2000.0,2,3,-1
CRI,BRA,2016.0,2,5,-3
IRN,CHN,2007.0,2,3,-1
IRQ,RUS,2012.0,1,2,-1
USA,SYR,2002.0,7,4,3
ITA,CHL,2000.0,2,1,1
IRL,POL,2011.0,3,4,-1
ITA,IRN,2004.0,5,2,3
ITA,EST,2011.0,2,1,1
RUS,EGY,2004.0,3,1,2
SVK,BEL,2006.0,5,4,1
GBR,MUS,1997.0,1,2,-1
GBR,RWA,2016.0,6,1,5
NER,DEU,2004.0,1,1,0
IND,CHL,2004.0,2,4,-2
CMR,GHA,2017.0,2,1,1
BGR,NOR,2002.0,1,1,0
DNK,TUR,2007.0,2,2,0
JAM,BRB,2007.0,1,2,-1
SDN,OMN,2014.0,3,2,1
ZAF,SGP,2019.0,2,8,-6
NGA,NLD,2022.0,2,5,-3
CAN,PHL,2018.0,5,5,0
CAN,ISL,2021.0,4,1,3
PAK,JOR,2023.0,2,1,1
RWA,ZAF,2009.0,2,2,0
ARE,CHE,2010.0,1,1,0
ARE,TUR,2023.0,4,7,-3
IRN,GBR,1997.0,8,14,-6
ISR,KOR,2006.0,1,3,-2
NZL,CHE,2008.0,6,6,0
BEL,MAR,2002.0,2,9,-7
KOR,NOR,2014.0,3,1,2
CHE,PRT,1997.0,3,1,2
ECU,VEN,2011.0,1,1,0
ITA,COG,2010.0,3,3,0
JPN,DNK,2012.0,11,4,7
TUR,GRC,2010.0,1,4,-3
FRA,KEN,2009.0,2,1,1
MAR,KWT,2019.0,1,1,0
KEN,TZA,2009.0,2,1,1
MEX,HND,2018.0,2,1,1
SVK,CAN,1997.0,1,3,-2
ECU,MEX,2007.0,2,2,0
JPN,ARG,2018.0,3,2,1
AUS,SRB,2009.0,2,3,-1
ARM,FRA,2020.0,1,1,0
USA,BOL,2012.0,2,7,-5
ZAF,QAT,2021.0,3,2,1
FIN,BEL,2016.0,5,7,-2
CAN,NGA,2015.0,5,16,-11
AUS,ZMB,2020.0,2,3,-1
CHL,IND,2016.0,3,7,-4
SAU,THA,2018.0,2,1,1
LBN,NLD,2015.0,3,1,2
LTU,ITA,2011.0,2,6,-4
TUR,SRB,2012.0,2,6,-4
BEL,CYP,2016.0,2,1,1
ZAF,NOR,2018.0,5,1,4
AUT,LIE,2022.0,4,1,3
PHL,SWE,2017.0,3,1,2
AUT,ETH,2017.0,1,2,-1
UKR,TUR,2019.0,2,2,0
GMB,NGA,2022.0,3,2,1
SEN,BEN,2012.0,2,1,1
ROU,SWE,2018.0,2,2,0
ETH,ITA,2016.0,3,6,-3
FJI,IND,2021.0,2,3,-1
JPN,NZL,2012.0,9,12,-3
SDN,SWE,2015.0,1,1,0
MAR,TUN,2015.0,2,1,1
SGP,MEX,2022.0,1,2,-1
GRD,CHE,2015.0,1,1,0
MNG,USA,2015.0,4,4,0
RUS,TWN,2015.0,1,2,-1
BEL,KEN,2017.0,4,4,0
EGY,LBN,2017.0,3,6,-3
IND,CHL,2015.0,5,2,3
CHL,IND,2018.0,2,12,-10
ZAF,IRN,2015.0,5,8,-3
HUN,BGR,2017.0,1,1,0
BEL,MEX,2023.0,3,5,-2
AUT,VNM,2017.0,5,3,2
ESP,EST,2020.0,6,3,3
RUS,TUV,2017.0,1,1,0
HKG,FIN,2018.0,3,1,2
ARM,CHE,2020.0,1,1,0
AUS,UGA,2014.0,1,2,-1
SWE,LBN,2022.0,1,4,-3
ARG,JPN,2001.0,4,3,1
AUS,BRN,2017.0,2,2,0
MYS,BHR,2020.0,9,1,8
CAN,KAZ,2022.0,2,3,-1
THA,ETH,2013.0,1,3,-2
DNK,GRC,2019.0,8,11,-3
USA,PNG,2020.0,4,5,-1
HKG,ARE,2012.0,1,1,0
HKG,BGD,2015.0,3,1,2
BGR,RUS,2007.0,3,7,-4
HKG,KAZ,2018.0,1,1,0
UZB,AUT,2020.0,2,1,1
RWA,TZA,2022.0,1,2,-1
TJK,DEU,2022.0,1,1,0
CZE,SVN,2012.0,2,3,-1
ISR,HKG,2010.0,1,1,0
NOR,CZE,2012.0,1,2,-1
BLR,FRA,2021.0,2,3,-1
BEL,UGA,2010.0,2,1,1
MYS,IRL,2013.0,5,10,-5
VNM,POL,2023.0,4,2,2
BGD,BRN,2018.0,3,3,0
BEL,AUS,2024.0,1,1,0
ARE,NOR,2021.0,3,3,0
ISL,DNK,2022.0,3,6,-3
HRV,FRA,2020.0,4,4,0
ALB,USA,2020.0,3,3,0
PAK,HKG,2014.0,2,1,1
GEO,NLD,2021.0,2,1,1
DEU,NAM,2020.0,2,4,-2
MNG,JPN,2022.0,6,13,-7
VNM,NOR,2022.0,3,4,-1
CHE,CMR,2019.0,3,3,0
SWE,ETH,2022.0,3,5,-2
OMN,SDN,2020.0,1,1,0
JPN,ETH,2022.0,3,3,0
BTN,USA,2019.0,1,1,0
CAN,PRT,2002.0,7,9,-2
ZAF,BWA,1997.0,1,3,-2
BHR,USA,2007.0,3,2,1
MAC,HKG,2003.0,2,2,0
CHL,RUS,2002.0,2,1,1
JOR,IRQ,2006.0,1,3,-2
AUS,MYS,1998.0,6,5,1
CUB,AUS,2007.0,1,1,0
NLD,NZL,2008.0,9,19,-10
ETH,GBR,2002.0,5,3,2
AUS,BGD,2001.0,1,1,0
USA,SLV,2001.0,1,1,0
THA,CAN,2000.0,5,5,0
JPN,GHA,2003.0,1,3,-2
ZAF,BRA,2000.0,1,1,0
QAT,USA,2006.0,3,9,-6
PRY,BRA,2012.0,1,2,-1
CZE,TUR,2011.0,1,1,0
ITA,EGY,2005.0,2,2,0
CZE,RUS,2015.0,5,12,-7
GBR,YEM,2011.0,2,1,1
NZL,IRL,2002.0,2,6,-4
COG,BEL,2014.0,6,9,-3
CZE,FIN,2019.0,6,7,-1
MYS,ARE,2024.0,2,1,1
SWE,ETH,2016.0,4,2,2
IRN,PAK,2016.0,2,3,-1
UGA,DNK,2014.0,1,2,-1
ESP,SRB,2014.0,1,3,-2
MWI,JPN,2018.0,1,2,-1
TWN,MEX,2018.0,1,2,-1
SWE,BGR,2010.0,1,2,-1
GBR,KAZ,2015.0,6,6,0
MKD,SRB,2015.0,5,4,1
SWE,EGY,2018.0,6,11,-5
VEN,DEU,2011.0,7,2,5
COL,PAN,2019.0,3,2,1
DEU,ETH,2014.0,9,11,-2
ZAF,NOR,2016.0,4,8,-4
MKD,AUT,2017.0,2,2,0
SGP,NOR,2010.0,1,4,-3
ZAF,GHA,2015.0,8,6,2
SVK,FIN,2015.0,1,2,-1
FIN,SVK,2016.0,1,1,0
IRL,LUX,2020.0,1,2,-1
ITA,BFA,2012.0,3,2,1
CHN,IRQ,2014.0,3,2,1
BRA,DNK,2013.0,5,7,-2
ETH,AUS,2014.0,4,1,3
PER,CZE,2021.0,1,1,0
RUS,SAU,2018.0,3,2,1
SWE,ISR,2020.0,7,6,1
BIH,USA,2010.0,3,6,-3
SVK,GRC,2015.0,1,1,0
CIV,USA,2023.0,3,1,2
NCL,ESP,2015.0,1,1,0
GBR,LTU,2019.0,7,6,1
JPN,ETH,2016.0,4,5,-1
VNM,CHN,2015.0,4,23,-19
ZAF,ESP,2018.0,6,11,-5
LIE,DEU,2021.0,3,8,-5
GBR,BWA,2017.0,4,4,0
EGY,IND,2017.0,2,2,0
VNM,SGP,2020.0,5,20,-15
ETH,TUR,2022.0,2,4,-2
GBR,VEN,2016.0,4,2,2
CAN,UGA,2010.0,1,1,0
PHL,BEL,2012.0,5,2,3
IRQ,ARE,2023.0,1,2,-1
USA,KHM,2022.0,6,6,0
DNK,LTU,2022.0,3,4,-1
QAT,CHN,2020.0,3,3,0
CHL,TWN,2022.0,1,1,0
IND,GHA,2022.0,4,3,1
RUS,ARE,2021.0,2,1,1
CHE,CMR,2021.0,2,3,-1
HUN,NZL,2005.0,1,2,-1
POL,HUN,2004.0,1,2,-1
JAM,TTO,2013.0,6,8,-2
PRT,TUR,2021.0,1,6,-5
MAR,ESP,2010.0,8,11,-3
TUR,AUT,2007.0,2,6,-4
DEU,SYR,2004.0,3,3,0
TGO,FRA,2008.0,2,2,0
MEX,ARG,2008.0,9,11,-2
TZA,PAK,2015.0,1,1,0
UZB,ITA,2013.0,1,1,0
KEN,TZA,2011.0,1,2,-1
TUR,ZAF,2013.0,4,3,1
DEU,ARE,2013.0,10,1,9
ARE,HUN,2018.0,2,2,0
USA,FRO,2011.0,1,1,0
RUS,KGZ,2009.0,3,3,0
CHE,LTU,2008.0,2,2,0
TZA,NOR,2012.0,6,3,3
BEN,JPN,2009.0,2,1,1
SEN,GIN,2014.0,3,1,2
FRA,GUY,2018.0,1,1,0
GRC,SAU,2018.0,5,5,0
MEX,POL,2012.0,3,2,1
SRB,AUS,2009.0,3,2,1
ROU,ISR,2011.0,1,2,-1
SWZ,CHE,1998.0,1,1,0
EGY,PRT,2017.0,2,3,-1
CZE,MNG,2021.0,1,2,-1
ZAF,EST,2018.0,1,1,0
SVK,AUT,2017.0,4,12,-8
GBR,NPL,2016.0,7,4,3
SEN,BFA,2016.0,4,1,3
SAU,VNM,2019.0,1,1,0
QAT,TUR,2022.0,3,5,-2
ETH,CAN,2019.0,4,3,1
TTO,NGA,2019.0,1,1,0
HKG,TWN,2008.0,10,15,-5
CHE,VNM,2023.0,2,1,1
GTM,COL,2010.0,1,1,0
ETH,ESP,2014.0,2,4,-2
DZA,TUR,2022.0,2,4,-2
DNK,MYS,2015.0,5,4,1
ETH,NGA,2021.0,3,3,0
KOR,RWA,2019.0,1,1,0
UKR,ISR,2020.0,3,4,-1
SGP,MEX,2017.0,3,2,1
SVN,NLD,2002.0,2,2,0
USA,BIH,2014.0,1,3,-2
DEU,LAO,2020.0,1,1,0
SLE,AUS,2020.0,1,2,-1
CAN,BWA,2018.0,3,2,1
MNG,RUS,2017.0,1,2,-1
PRT,PER,2016.0,3,2,1
IRN,CZE,2006.0,1,1,0
SAU,THA,2017.0,3,3,0
PRT,AUS,2019.0,8,6,2
SAU,SGP,2015.0,2,13,-11
BEL,TWN,2013.0,5,1,4
NPL,GHA,2020.0,1,1,0
SYR,USA,2004.0,2,5,-3
PAK,RUS,2021.0,3,2,1
THA,PAK,2023.0,7,8,-1
MEX,CRI,2009.0,1,3,-2
PAK,SWE,2013.0,5,12,-7
KOR,PRK,2018.0,2,1,1
PAN,ESP,2006.0,1,1,0
DNK,RUS,2011.0,2,5,-3
TUR,MYS,2018.0,2,10,-8
BFA,GBR,2010.0,1,1,0
LBN,RUS,2017.0,1,1,0
ETH,NOR,2019.0,3,19,-16
BHR,SAU,2016.0,3,5,-2
PAK,BRA,2022.0,5,6,-1
USA,FJI,2012.0,2,1,1
DNK,GHA,2020.0,3,1,2
RWA,ZWE,2013.0,3,1,2
COD,USA,2018.0,2,4,-2
ZAF,ROU,2015.0,1,1,0
GRC,AUT,2009.0,5,5,0
SVK,BLR,2001.0,1,1,0
LKA,AUS,2004.0,3,5,-2
HUN,ARE,2014.0,1,1,0
BEN,SEN,2016.0,3,1,2
IND,IDN,2000.0,3,4,-1
ZAF,ETH,2010.0,1,1,0
SWE,KEN,2009.0,3,1,2
PRY,USA,2002.0,1,1,0
ZAF,RUS,1999.0,3,7,-4
EST,LTU,2003.0,3,1,2
NER,FRA,2017.0,2,3,-1
TUN,CAN,2003.0,2,6,-4
IND,ERI,2012.0,1,1,0
CRI,ESP,1999.0,3,1,2
IND,MEX,2002.0,3,3,0
BEL,NIC,2007.0,2,1,1
LKA,SWE,1997.0,1,1,0
SWE,ARG,2000.0,3,4,-1
TUR,BGR,2001.0,1,2,-1
MUS,CAN,2013.0,1,1,0
JPN,KEN,2003.0,5,3,2
FRA,VNM,2000.0,5,5,0
LVA,FRA,2005.0,1,2,-1
AUS,ZWE,2003.0,1,1,0
JPN,PAK,2004.0,5,5,0
FRA,NER,2019.0,2,5,-3
CMR,USA,1999.0,3,2,1
MAR,ESP,2000.0,3,4,-1
FRA,IDN,2003.0,9,5,4
CAN,TUR,1998.0,9,2,7
LTU,DNK,2016.0,4,5,-1
NGA,AUS,1999.0,3,2,1
CHE,EGY,1998.0,2,1,1
MYS,OMN,2007.0,1,1,0
BEL,HRV,2011.0,1,3,-2
MDA,USA,2007.0,1,1,0
KHM,FRA,2010.0,3,1,2
ZAF,SWE,1999.0,1,1,0
NLD,UGA,2012.0,4,3,1
TUR,AUS,1997.0,1,2,-1
IRL,SWE,2004.0,2,5,-3
GHA,JPN,2001.0,1,9,-8
BEL,VNM,2000.0,2,2,0
FIN,UKR,1999.0,2,4,-2
BRA,SRB,2019.0,1,2,-1
QAT,ZAF,2022.0,2,3,-1
BEL,CIV,2015.0,3,1,2
AUS,ZWE,2013.0,1,2,-1
PHL,NLD,2011.0,2,2,0
SVN,PRT,2011.0,1,1,0
SWZ,USA,2010.0,2,1,1
USA,SWZ,2018.0,5,4,1
CZE,CAN,2023.0,6,6,0
ZAF,BEL,2010.0,3,4,-1
CHN,PHL,2013.0,2,2,0
SWE,CZE,2016.0,9,12,-3
SWE,SVN,2017.0,2,4,-2
TUR,ALB,2011.0,1,2,-1
MOZ,USA,2010.0,1,4,-3
NZL,AUT,2009.0,2,2,0
PER,FRA,2010.0,5,6,-1
NGA,CMR,2006.0,3,2,1
PER,NIC,2013.0,1,1,0
USA,ATG,2017.0,1,4,-3
SRB,JPN,2020.0,1,1,0
LVA,DEU,2017.0,6,3,3
MYS,ESP,2017.0,4,2,2
AUS,NCL,2012.0,2,1,1
JOR,IND,2001.0,2,1,1
MYS,PAK,2003.0,2,1,1
SAU,CZE,2015.0,2,1,1
NGA,KWT,2006.0,1,2,-1
BEL,COL,2013.0,3,8,-5
EST,CHE,2006.0,1,2,-1
MEX,JPN,2011.0,2,3,-1
KEN,POL,2009.0,2,1,1
NZL,NPL,2019.0,1,2,-1
LKA,SGP,2010.0,2,1,1
GEO,CZE,2010.0,1,1,0
COG,ZWE,2009.0,2,3,-1
DEU,HKG,2009.0,4,12,-8
CHN,SLE,2010.0,1,2,-1
LTU,ESP,2016.0,1,1,0
CHE,SAU,2016.0,1,3,-2
CHN,PRT,2008.0,4,7,-3
CHE,EGY,2020.0,4,3,1
MYS,NOR,2008.0,1,4,-3
HKG,DEU,1998.0,3,4,-1
IND,HUN,2013.0,1,2,-1
USA,GMB,2003.0,3,1,2
GBR,BRB,1998.0,2,2,0
CHN,ARE,2013.0,1,2,-1
ZAF,IND,1999.0,4,11,-7
MYS,PHL,2009.0,1,2,-1
USA,BEN,2023.0,2,2,0
PAK,BGD,2006.0,1,4,-3
GRC,TUN,2014.0,1,1,0
SWE,LUX,2006.0,1,1,0
IRQ,SYR,2022.0,1,1,0
BWA,ETH,2020.0,1,1,0
RUS,MDA,2021.0,1,1,0
NGA,CMR,2023.0,1,2,-1
EST,UKR,2022.0,3,1,2
UGA,NGA,2023.0,7,8,-1
CHL,VEN,2018.0,1,21,-20
TZA,ETH,2017.0,1,1,0
MDA,DEU,2022.0,3,4,-1
SWE,BLR,2003.0,1,1,0
ISR,SRB,2003.0,1,1,0
PAK,TZA,2017.0,1,2,-1
SRB,NZL,2005.0,1,1,0
FIN,UKR,1998.0,2,2,0
BGR,ESP,2009.0,2,4,-2
CHE,NZL,2001.0,4,5,-1
JPN,MEX,1999.0,4,3,1
DEU,OMN,2013.0,2,2,0
LBN,CAN,1997.0,1,4,-3
CHE,MEX,1998.0,1,3,-2
CYP,ARE,2023.0,1,1,0
PER,FRA,2000.0,2,3,-1
SVN,USA,1997.0,2,10,-8
JPN,MNG,2003.0,6,1,5
SWZ,ZAF,2009.0,4,2,2
DEU,BLR,2003.0,6,19,-13
FRA,BLR,2013.0,1,1,0
AUS,CZE,2012.0,2,2,0
ETH,USA,2000.0,8,4,4
BRA,RUS,2012.0,2,5,-3
HUN,ARE,2008.0,3,1,2
IRN,CAN,1997.0,7,7,0
BIH,USA,2006.0,4,5,-1
DNK,HUN,1998.0,2,2,0
ESP,AUS,1999.0,5,7,-2
CHL,POL,2010.0,3,1,2
DNK,ISR,2005.0,2,2,0
PER,COL,2002.0,2,1,1
MEX,CHL,2001.0,5,2,3
AUS,MEX,2000.0,2,2,0
DNK,ZAF,2010.0,1,2,-1
ZAF,ISR,1998.0,3,1,2
BGR,GRC,2004.0,1,1,0
ROU,MDA,2018.0,2,5,-3
EST,GBR,2011.0,3,9,-6
POL,ZAF,2013.0,1,2,-1
IND,ZAF,1998.0,1,3,-2
MYS,HRV,2014.0,1,1,0
COG,ESP,2017.0,1,1,0
BRA,KOR,2017.0,1,7,-6
GBR,NAM,2015.0,1,2,-1
TWN,NLD,2015.0,6,4,2
BOL,USA,2017.0,3,1,2
ISR,SGP,2017.0,4,4,0
GTM,ESP,2009.0,1,3,-2
BRA,IRN,2015.0,2,12,-10
CAF,FRA,2011.0,2,4,-2
LTU,BEL,2016.0,2,4,-2
BEL,MYS,2016.0,4,2,2
SDN,SSD,2016.0,1,2,-1
HUN,SRB,2017.0,3,7,-4
CHE,ETH,2013.0,2,2,0
ETH,CHE,2014.0,2,2,0
UGA,CHN,2016.0,1,1,0
UGA,CHN,2022.0,3,3,0
MYS,VNM,2013.0,2,1,1
SEN,GIN,2015.0,1,7,-6
THA,KHM,2010.0,2,1,1
ZMB,CHE,2013.0,1,1,0
IRQ,AUS,2010.0,2,2,0
VNM,PHL,2014.0,2,1,1
SWE,IDN,2015.0,2,2,0
ECU,CAN,2006.0,4,2,2
DEU,MNG,2020.0,2,2,0
RUS,DNK,2016.0,3,5,-2
ITA,SRB,1997.0,4,5,-1
BEL,NPL,2018.0,1,3,-2
CHE,LTU,2014.0,4,1,3
SVN,RUS,2019.0,2,2,0
GBR,LCA,2020.0,1,1,0
SRB,ROU,2013.0,5,2,3
IND,MEX,2012.0,6,3,3
KOR,UKR,2003.0,1,4,-3
RUS,ZAF,2002.0,2,10,-8
ARE,PAK,2013.0,1,7,-6
EGY,PSE,2006.0,3,1,2
FRA,URY,2007.0,3,3,0
BEL,GIN,2021.0,1,2,-1
HUN,SRB,2016.0,6,8,-2
KEN,ZMB,2002.0,2,1,1
KEN,MWI,2014.0,1,1,0
NLD,BFA,2013.0,1,2,-1
BEL,IRN,2005.0,2,1,1
IND,MKD,2019.0,1,1,0
KAZ,RUS,2001.0,11,8,3
DNK,LTU,2017.0,1,2,-1
BFA,BEN,2018.0,2,1,1
HRV,GBR,2008.0,4,1,3
PAK,FRA,2006.0,2,4,-2
CRI,AUT,2020.0,1,1,0
FIN,BGR,2016.0,1,1,0
COD,LAO,2016.0,2,2,0
ARE,POL,2021.0,3,1,2
BGR,IRL,2022.0,2,1,1
PRY,JPN,2017.0,1,1,0
EST,UKR,2016.0,2,2,0
BEL,KEN,2018.0,7,5,2
CZE,EGY,2017.0,1,5,-4
CMR,IND,2019.0,2,5,-3
ZAF,MWI,2018.0,6,7,-1
VEN,SWE,2017.0,1,3,-2
SDN,USA,2016.0,5,3,2
KEN,ITA,2022.0,4,3,1
IRN,UKR,2023.0,1,1,0
MAR,DEU,1998.0,1,1,0
EGY,DEU,2024.0,1,1,0
DZA,EGY,2021.0,1,4,-3
SVN,CAN,2014.0,1,2,-1
OMN,IND,2005.0,5,9,-4
AUS,NAM,2018.0,1,1,0
BEL,SGP,2013.0,3,3,0
EGY,QAT,2007.0,7,6,1
EGY,AUS,2001.0,2,1,1
IRL,ZAF,1997.0,1,1,0
MEX,CHN,2000.0,2,5,-3
IND,TUR,2003.0,2,1,1
KWT,CAN,1997.0,3,1,2
NOR,BGD,2019.0,1,2,-1
BGD,NOR,2020.0,2,1,1
ZAF,NZL,2007.0,3,2,1
ZMB,BEL,2007.0,1,2,-1
IND,YEM,2014.0,3,1,2
JOR,AUS,2021.0,7,11,-4
UGA,NLD,2012.0,3,4,-1
SWE,COL,2007.0,1,2,-1
ESP,TUN,2007.0,2,2,0
BHR,GBR,2019.0,4,7,-3
ITA,VNM,2009.0,1,3,-2
BRA,FIN,2014.0,2,8,-6
GRC,FIN,2017.0,2,3,-1
BLR,GBR,2018.0,2,1,1
TUR,ISR,2016.0,1,2,-1
ITA,THA,2013.0,4,2,2
AUS,LUX,2023.0,1,1,0
CHE,SRB,2012.0,2,4,-2
NZL,EGY,2019.0,1,2,-1
EGY,NZL,2022.0,2,1,1
ARE,CHN,2016.0,5,7,-2
KEN,RWA,2016.0,2,1,1
MEX,CHN,2023.0,6,1,5
ARM,ITA,2012.0,1,2,-1
NLD,ZMB,2019.0,2,2,0
AUS,SLB,2013.0,3,2,1
NOR,CHL,2014.0,1,1,0
MUS,USA,2009.0,1,2,-1
GBR,BRN,2005.0,1,1,0
PRT,MEX,2020.0,3,7,-4
BEL,SEN,2012.0,1,3,-2
USA,SLV,2015.0,1,2,-1
ISR,TUR,2010.0,1,4,-3
PRT,CUB,2007.0,2,4,-2
POL,GRC,2000.0,1,1,0
GRC,LUX,2013.0,2,1,1
OMN,CAN,1997.0,2,2,0
ZAF,CIV,2003.0,3,2,1
BEL,FIN,1998.0,1,7,-6
DEU,NPL,2005.0,1,1,0
DZA,TUN,2009.0,2,5,-3
FRA,GIN,2013.0,5,2,3
MUS,GBR,2018.0,1,3,-2
FJI,NZL,2015.0,2,2,0
ESP,SVN,2004.0,2,2,0
LBN,GBR,2000.0,2,2,0
GBR,BEN,2008.0,1,1,0
JPN,KAZ,2008.0,1,1,0
ESP,HRV,2007.0,2,1,1
USA,LVA,2011.0,4,5,-1
NOR,AUT,2010.0,6,5,1
GIB,GBR,2009.0,1,1,0
GIB,GBR,2019.0,1,2,-1
CAN,PRT,2005.0,3,5,-2
FRA,VNM,2024.0,1,1,0
BEL,TUN,2004.0,2,3,-1
UKR,JPN,2020.0,3,2,1
KWT,SWE,2006.0,1,1,0
GBR,SYR,2014.0,3,3,0
NZL,IND,2005.0,2,5,-3
CHE,POL,2005.0,5,16,-11
MNG,USA,2004.0,1,1,0
FRA,EST,2001.0,1,1,0
GBR,LBY,2004.0,3,2,1
SWE,KHM,2010.0,1,1,0
CZE,SWE,2005.0,1,9,-8
JPN,KHM,2007.0,3,1,2
COG,USA,2016.0,6,4,2
SWE,COL,2020.0,2,5,-3
COL,SWE,2021.0,7,5,2
BEL,CIV,2001.0,2,1,1
ARG,AUT,2001.0,3,1,2
CAN,BHR,2006.0,2,2,0
LTU,CAN,2002.0,2,1,1
HRV,NOR,2010.0,2,2,0
MAR,GBR,2000.0,4,2,2
PRT,ROU,2017.0,2,8,-6
THA,IND,1997.0,2,2,0
ZAF,MYS,2014.0,2,5,-3
JPN,UKR,2006.0,3,4,-1
GBR,FLK,2015.0,2,1,1
SGP,NOR,2006.0,3,1,2
KOR,DEU,1997.0,2,18,-16
JPN,CHL,2012.0,4,4,0
JAM,CAN,2012.0,2,2,0
ZAF,DNK,2015.0,1,3,-2
MYS,SWE,2009.0,2,1,1
SWE,HKG,2003.0,1,2,-1
PRI,CHN,1999.0,1,1,0
UGA,RWA,1998.0,1,1,0
HKG,TWN,2001.0,9,9,0
CIV,SEN,2003.0,1,1,0
THA,MYS,2005.0,1,2,-1
BRB,GBR,2006.0,1,2,-1
VUT,NCL,2014.0,1,1,0
MEX,NOR,2006.0,1,1,0
MOZ,CAN,2009.0,1,1,0
KOR,HKG,2000.0,1,6,-5
BGD,DEU,2006.0,1,6,-5
ARE,POL,2019.0,1,3,-2
SVN,MKD,2009.0,1,1,0
IND,PHL,2006.0,2,2,0
ATG,CAN,2017.0,1,1,0
THA,BHR,2018.0,1,1,0
CHL,MEX,2002.0,5,5,0
IDN,AUT,2011.0,2,3,-1
PRI,GBR,2018.0,1,2,-1
ZAF,LKA,2018.0,1,1,0
GRC,KAZ,2023.0,1,1,0
CHE,UGA,2013.0,3,6,-3
DNK,THA,2006.0,3,4,-1
IND,AUT,1999.0,1,1,0
CUB,VEN,2000.0,1,1,0
DZA,TUN,2019.0,3,10,-7
UKR,ESP,2017.0,2,2,0
KOR,AUS,1999.0,7,11,-4
NLD,KHM,2018.0,2,1,1
MWI,ZAF,2004.0,2,3,-1
FJI,IND,2019.0,1,3,-2
PRT,THA,2012.0,1,1,0
FIN,LUX,2011.0,1,1,0
JPN,SVK,1998.0,2,4,-2
PNG,CHE,2013.0,1,1,0
JPN,NZL,2005.0,3,6,-3
DEU,PSE,2006.0,3,3,0
TUR,CHN,2012.0,2,5,-3
KHM,JPN,2008.0,2,3,-1
CHN,URY,2020.0,1,1,0
UKR,MEX,2012.0,2,2,0
SVK,FRA,2015.0,2,4,-2
SAU,MAR,2015.0,2,4,-2
NZL,ITA,2009.0,1,4,-3
HRV,ITA,2022.0,3,12,-9
ARE,IRN,2013.0,1,1,0
SWE,LVA,2011.0,3,1,2
BGD,DEU,2010.0,4,2,2
FRA,PAN,2013.0,1,2,-1
CAN,CUB,2018.0,1,15,-14
CAN,VNM,2017.0,5,4,1
PAK,TUR,2013.0,3,3,0
ROU,AUS,2003.0,2,3,-1
NCL,NZL,2014.0,1,1,0
FIN,CZE,2001.0,3,2,1
TTO,NLD,2003.0,1,1,0
SWE,NGA,2022.0,1,2,-1
VNM,GBR,2006.0,4,6,-2
MOZ,ZAF,2016.0,2,5,-3
KEN,IND,2016.0,1,3,-2
DNK,ROU,2017.0,3,3,0
MEX,AUT,2016.0,5,5,0
HRV,CAN,2017.0,1,1,0
PHL,NZL,2020.0,2,2,0
SVN,SLV,2016.0,4,9,-5
MYS,CHE,2016.0,1,3,-2
NOR,EGY,2013.0,1,1,0
MEX,UKR,2001.0,1,5,-4
MEX,UKR,2008.0,2,3,-1
MEX,PRT,2003.0,2,2,0
RUS,MEX,2010.0,4,10,-6
DOM,MEX,2022.0,2,4,-2
BOL,DEU,2018.0,2,2,0
MEX,SWE,2004.0,2,3,-1
NLD,MLT,2019.0,2,1,1
PAK,ZAF,2012.0,2,1,1
ALB,SRB,2019.0,6,12,-6
ALB,FRA,2014.0,2,1,1
PRT,CAN,1997.0,4,3,1
SDN,NOR,2017.0,2,1,1
ESP,ISL,2015.0,3,1,2
CMR,COD,2021.0,3,1,2
CZE,IRL,2020.0,4,7,-3
PER,NOR,2016.0,1,1,0
BLR,SWE,2010.0,1,2,-1
NER,IND,2019.0,2,1,1
SGP,GRC,2020.0,3,3,0
PAK,IRN,2018.0,2,2,0
LTU,AUT,2023.0,2,1,1
EGY,AUT,2018.0,1,7,-6
AUT,ISR,2012.0,2,8,-6
NGA,POL,2023.0,1,1,0
MWI,NLD,2019.0,1,3,-2
IRQ,POL,2021.0,2,1,1
SVN,BEL,2017.0,4,5,-1
MEX,CHE,2018.0,6,7,-1
CIV,MLI,2021.0,4,1,3
JPN,LKA,2023.0,4,5,-1
NLD,IRQ,2022.0,1,2,-1
THA,HKG,2018.0,1,4,-3
IDN,BRN,2020.0,2,3,-1
SAU,NGA,2008.0,3,1,2
GBR,PAN,2022.0,3,3,0
ZMB,IND,2020.0,1,1,0
GMB,SEN,2005.0,2,1,1
ITA,BHR,2004.0,1,1,0
NOR,ARG,2019.0,1,2,-1
CYP,CZE,2019.0,1,1,0
CRI,GBR,2011.0,3,3,0
BGD,THA,2013.0,2,4,-2
IND,SRB,2006.0,2,3,-1
AUT,KOR,2022.0,5,6,-1
VNM,BEL,2009.0,3,5,-2
NZL,ARG,2006.0,1,1,0
KWT,CZE,2005.0,2,2,0
ZWE,SWE,2005.0,2,2,0
GBR,VNM,2005.0,2,8,-6
HUN,POL,1999.0,1,2,-1
NZL,BEL,2012.0,2,2,0
SVK,JPN,2004.0,1,3,-2
PRT,TUN,2008.0,1,2,-1
PRT,NLD,2006.0,5,11,-6
UZB,ITA,2003.0,1,1,0
MAR,TUN,2001.0,2,1,1
OMN,JOR,2005.0,5,1,4
OMN,JOR,2012.0,4,1,3
MDG,USA,2014.0,2,1,1
TUN,BEL,2000.0,1,1,0
KWT,DEU,2006.0,1,2,-1
GBR,ALB,2005.0,1,1,0
ARM,DEU,2020.0,5,4,1
EGY,DNK,2009.0,1,4,-3
ROU,FIN,2000.0,1,2,-1
FIN,ROU,2009.0,1,3,-2
PRT,POL,2007.0,2,3,-1
IRN,RUS,2005.0,3,1,2
DEU,NGA,1997.0,2,3,-1
UZB,AZE,2011.0,3,1,2
NZL,IND,1997.0,1,1,0
HUN,KWT,2004.0,1,1,0
ARG,NLD,2005.0,3,5,-2
KEN,BWA,2001.0,1,1,0
TUR,SAU,1998.0,2,1,1
THA,IDN,2010.0,6,2,4
BEL,SVK,2010.0,2,3,-1
PRI,DEU,2002.0,1,1,0
DEU,PRI,2003.0,2,1,1
ARE,AUT,2018.0,2,1,1
MEX,POL,1997.0,2,3,-1
TUR,UKR,2020.0,4,3,1
CHE,UKR,2007.0,1,1,0
SGP,THA,2008.0,1,9,-8
RUS,EGY,2008.0,1,3,-2
KOR,QAT,2016.0,6,1,5
COG,ZAF,2017.0,2,2,0
KAZ,DEU,2023.0,2,3,-1
NPL,NLD,2010.0,1,1,0
FRA,BGR,2010.0,4,11,-7
CUB,DEU,2017.0,2,3,-1
CHE,URY,2009.0,1,3,-2
PAN,BRA,2017.0,3,4,-1
QAT,IND,2012.0,4,10,-6
FRA,LTU,2020.0,4,2,2
BEN,BRA,2016.0,1,1,0
SGP,BRN,2019.0,2,1,1
RUS,IRQ,2016.0,2,1,1
ARG,ARE,2018.0,3,1,2
DEU,NPL,2012.0,2,3,-1
MAR,USA,2008.0,4,4,0
USA,BLZ,1998.0,1,2,-1
ARE,VNM,2021.0,1,3,-2
PAK,IRL,2006.0,1,1,0
VEN,PRT,2017.0,1,1,0
CAN,BWA,2017.0,2,2,0
SVN,CAN,2015.0,1,3,-2
CAN,SVN,2016.0,2,1,1
ARE,ZAF,2016.0,1,2,-1
TUR,TWN,2016.0,2,2,0
RUS,ROU,2010.0,2,2,0
CAN,PHL,2022.0,2,4,-2
CHE,ARE,2022.0,5,2,3
USA,SYR,2012.0,5,1,4
NLD,REU,2015.0,1,1,0
CAN,SRB,2021.0,4,1,3
TUN,QAT,2023.0,1,2,-1
EST,NOR,2022.0,5,3,2
FIN,ETH,2016.0,1,1,0
CMR,NGA,2018.0,2,4,-2
MEX,PHL,2018.0,2,1,1
LTU,UKR,2017.0,1,3,-2
GBR,SEN,2017.0,4,1,3
DEU,AFG,2021.0,2,4,-2
NLD,CRI,2018.0,1,3,-2
NGA,BRN,2020.0,1,1,0
BEL,COL,2003.0,2,2,0
SRB,GRC,2018.0,2,1,1
JPN,BWA,2020.0,1,2,-1
EGY,AUS,2008.0,3,1,2
AUT,VNM,2016.0,2,1,1
SDN,DEU,2002.0,2,2,0
THA,DNK,2004.0,1,3,-2
SRB,IRL,2023.0,1,1,0
ARE,DNK,2024.0,1,1,0
SGP,MAC,2019.0,1,5,-4
DEU,QAT,2023.0,3,6,-3
GBR,CYM,2023.0,1,1,0
MYS,NLD,2023.0,2,1,1
JOR,ISR,2022.0,1,1,0
SWE,LAO,2012.0,3,1,2
THA,NLD,2002.0,3,3,0
QAT,GRC,2018.0,2,5,-3
ZAF,THA,2022.0,1,1,0
SGP,KOR,2002.0,3,7,-4
KOR,CHL,2002.0,1,1,0
CHE,IRN,2008.0,1,7,-6
UGA,NOR,2009.0,2,3,-1
USA,BMU,2010.0,2,1,1
SEN,MLI,2016.0,3,2,1
DZA,GRC,2009.0,1,1,0
CUB,CAN,2004.0,1,2,-1
MLI,NLD,2011.0,1,2,-1
TWN,ROU,2009.0,1,1,0
PRT,COL,2013.0,1,4,-3
AUT,KEN,2017.0,1,3,-2
PAK,AUT,2007.0,3,2,1
SDN,JPN,2011.0,1,1,0
OMN,FRA,2007.0,2,2,0
FIN,CZE,2014.0,3,5,-2
COL,NZL,2003.0,1,1,0
CHE,NOR,1998.0,4,4,0
KEN,JPN,2009.0,3,11,-8
EGY,HUN,2012.0,1,2,-1
DZA,BEL,2008.0,2,2,0
IRN,ISR,2007.0,1,2,-1
HTI,USA,2007.0,1,3,-2
AUT,TUR,2010.0,2,3,-1
BGR,DNK,2004.0,3,1,2
SRB,SAU,2017.0,2,1,1
CMR,BEN,2021.0,2,2,0
ITA,TWN,2015.0,4,1,3
MAC,MYS,2017.0,1,1,0
AUS,COL,2015.0,6,10,-4
ARG,NZL,2010.0,1,1,0
AUS,SRB,2021.0,1,3,-2
SGP,MMR,2022.0,3,1,2
NER,IND,2011.0,1,1,0
THA,HKG,2022.0,2,4,-2
HRV,BEL,2018.0,4,1,3
CHL,DOM,2018.0,1,1,0
NZL,RUS,2008.0,2,1,1
SVK,ITA,2005.0,1,1,0
MEX,PRI,2011.0,1,1,0
GBR,BIH,2014.0,1,1,0
USA,MLI,2022.0,3,3,0
IRN,EGY,2007.0,1,1,0
NLD,BGD,2009.0,2,1,1
BRA,AUT,1999.0,2,1,1
MLI,FRA,1997.0,1,3,-2
SWE,MOZ,2013.0,1,1,0
GHA,CHE,2014.0,1,2,-1
DNK,BGD,2003.0,1,1,0
BEL,IDN,2000.0,1,2,-1
MDA,UKR,2006.0,1,1,0
LBY,USA,2014.0,2,4,-2
RUS,TUR,1998.0,3,1,2
TWN,AUS,2013.0,7,15,-8
ZAF,COG,2011.0,3,2,1
ZAF,HUN,2006.0,1,2,-1
CAN,LKA,2006.0,3,6,-3
ARG,SWE,2014.0,4,3,1
ZAF,SGP,2009.0,2,2,0
SGP,ZAF,2010.0,1,1,0
ZAF,SGP,2011.0,2,1,1
AUS,CRI,2016.0,1,2,-1
TZA,SWE,2015.0,2,5,-3
PAK,ESP,2015.0,1,3,-2
ARG,PRT,2017.0,1,3,-2
MEX,IRL,1997.0,1,1,0
IRL,NZL,2017.0,4,5,-1
PRT,TWN,2019.0,1,1,0
GHA,NGA,2010.0,5,4,1
MYS,PHL,2019.0,2,2,0
SGP,ARE,2018.0,2,3,-1
FRA,OMN,2007.0,2,2,0
ZAF,DZA,2015.0,3,2,1
MEX,HUN,2018.0,2,3,-1
JPN,OMN,2020.0,2,1,1
SVN,CZE,2012.0,3,2,1
JPN,IRQ,2020.0,1,1,0
NZL,FIN,2015.0,1,6,-5
SAU,KEN,2012.0,1,1,0
ARE,LBN,2006.0,1,3,-2
DEU,MAR,2019.0,2,8,-6
BEL,BFA,2008.0,2,1,1
GTM,ESP,2011.0,1,1,0
NLD,NAM,2019.0,1,1,0
CHL,NOR,2020.0,4,2,2
FIN,SVK,2022.0,1,1,0
ISR,HUN,2020.0,2,2,0
BEN,USA,2018.0,2,3,-1
ZAF,AUT,2022.0,7,4,3
AUT,VNM,2022.0,1,1,0
COL,CUB,2017.0,3,11,-8
SVN,MNE,2017.0,1,1,0
FIN,SVK,2018.0,1,1,0
GHA,CAN,2016.0,2,8,-6
BEL,CZE,2008.0,1,6,-5
HUN,SRB,2018.0,3,7,-4
ETH,RWA,2020.0,1,2,-1
DNK,ETH,2012.0,1,1,0
POL,VNM,2023.0,2,4,-2
VNM,LAO,2021.0,4,1,3
KOR,VNM,2024.0,2,2,0
KEN,JPN,2019.0,6,10,-4
JAM,BRB,2020.0,2,3,-1
LBN,CHN,2020.0,1,1,0
PAK,FIN,2020.0,3,5,-2
CHE,GEO,2021.0,1,1,0
JPN,HUN,2022.0,4,2,2
PRK,CHN,2017.0,3,9,-6
ZAF,IDN,2023.0,1,1,0
CHN,PAK,2006.0,3,3,0
PAK,NZL,2023.0,5,5,0
SVN,DEU,2004.0,4,1,3
MMR,CHN,2020.0,5,3,2
CZE,GRC,2019.0,3,8,-5
CHE,COD,2021.0,6,1,5
PYF,FRA,2023.0,8,7,1
GBR,LBN,2019.0,8,4,4
IRL,ZAF,2018.0,6,7,-1
LKA,AUT,2020.0,1,1,0
JPN,MWI,2019.0,2,2,0
BRB,TTO,1999.0,1,1,0
TTO,JAM,2002.0,2,3,-1
QAT,SWE,2023.0,1,1,0
ARE,SYR,2019.0,1,1,0
SVN,BIH,2022.0,1,1,0
ETH,GBR,2017.0,4,11,-7
SVN,USA,2022.0,14,3,11
MYS,VNM,2021.0,10,12,-2
BGR,ITA,1998.0,3,6,-3
FRA,UKR,1999.0,3,9,-6
IDN,KEN,2002.0,1,1,0
SRB,CHN,2023.0,1,1,0
NZL,ZAF,2022.0,2,11,-9
NLD,SVK,2003.0,3,4,-1
IRL,CHE,2006.0,4,12,-8
GHA,CHE,2010.0,1,1,0
FRA,BOL,2001.0,3,5,-2
FRA,BOL,2004.0,4,2,2
BOL,FRA,2018.0,2,2,0
USA,AZE,2022.0,2,5,-3
SVN,CZE,2018.0,3,3,0
IRL,RUS,2013.0,3,4,-1
ISL,DNK,2005.0,1,4,-3
GBR,UGA,2000.0,3,4,-1
BGR,ROU,2004.0,3,1,2
AUS,NGA,2006.0,2,3,-1
PRT,RUS,2001.0,5,6,-1
SGP,DEU,2000.0,2,10,-8
NLD,ETH,2005.0,4,1,3
NLD,FIN,2001.0,13,11,2
PSE,EGY,2002.0,2,2,0
GRC,ISR,2004.0,1,3,-2
TWN,ARM,2008.0,1,1,0
GBR,ARM,2016.0,1,1,0
IRN,PAK,2005.0,1,2,-1
PAK,DEU,2006.0,11,4,7
LUX,FRA,2000.0,3,1,2
RUS,AUS,2008.0,8,6,2
VNM,FRA,1997.0,1,3,-2
DNK,NZL,2007.0,5,7,-2
KOR,RUS,1998.0,4,13,-9
IRN,DEU,1997.0,2,1,1
IDN,CAN,1999.0,1,2,-1
THA,SGP,1999.0,2,1,1
DOM,ESP,2011.0,1,3,-2
IND,FIN,2000.0,3,1,2
CIV,SEN,2009.0,2,4,-2
BEL,DNK,2003.0,5,6,-1
AUT,IND,1999.0,1,1,0
NER,MDG,1999.0,2,1,1
LTU,GBR,2002.0,2,2,0
AUS,BIH,2019.0,1,1,0
USA,SVK,1998.0,13,15,-2
ARE,JOR,2002.0,3,3,0
ITA,CZE,1999.0,4,7,-3
MEX,CHE,2002.0,3,7,-4
ISR,JPN,2001.0,11,9,2
LIE,USA,2003.0,1,3,-2
NGA,ZMB,2012.0,1,1,0
PAK,ARE,2012.0,5,3,2
UKR,AUT,1998.0,2,7,-5
SDN,GBR,2007.0,4,4,0
FRA,VNM,2001.0,2,4,-2
AUT,IRL,2007.0,2,3,-1
GBR,BGD,1998.0,11,3,8
NER,FRA,2002.0,5,2,3
HUN,CAN,2016.0,9,12,-3
PAK,FRA,2001.0,1,2,-1
NZL,KHM,2010.0,1,1,0
NZL,SWE,2002.0,6,5,1
IDN,CAN,2007.0,2,1,1
PRT,KOR,2011.0,1,12,-11
ARG,DNK,1998.0,1,1,0
BRA,VEN,2000.0,2,4,-2
MLT,GBR,2006.0,7,8,-1
USA,MKD,2013.0,2,2,0
SDN,USA,2012.0,8,4,4
SAU,GBR,2012.0,16,97,-81
AUT,GEO,2017.0,1,1,0
ZAF,BWA,2017.0,17,11,6
COL,CUB,2002.0,4,2,2
PHL,MEX,2011.0,2,1,1
BGR,NLD,2018.0,2,3,-1
CAN,ZWE,2019.0,1,3,-2
ESP,TUR,2012.0,8,7,1
AUS,PRT,2014.0,5,9,-4
BRA,CUB,1999.0,2,5,-3
ESP,BOL,1999.0,1,1,0
NOR,EGY,2019.0,1,3,-2
EST,SAU,2020.0,1,1,0
FJI,JPN,2008.0,1,1,0
IRL,HRV,2016.0,4,1,3
CAN,CZE,2012.0,10,6,4
CUB,VEN,2004.0,4,6,-2
BEL,MEX,2008.0,4,4,0
EGY,AUT,2005.0,2,3,-1
PHL,FRA,2021.0,4,5,-1
ETH,DEU,2010.0,4,3,1
KEN,NLD,2009.0,5,8,-3
ZAF,BFA,2014.0,3,2,1
MAC,MAR,2015.0,7,14,-7
ITA,LBY,2012.0,1,1,0
HTI,FRA,2012.0,1,1,0
BEL,ISR,2012.0,2,2,0
DNK,PAK,2023.0,4,9,-5
JOR,QAT,2014.0,5,3,2
QAT,JOR,2023.0,3,13,-10
THA,FRA,2011.0,13,27,-14
KOR,TWN,2001.0,5,3,2
COL,DEU,2005.0,4,4,0
EGY,MEX,2018.0,1,4,-3
CHE,DZA,2010.0,1,1,0
ECU,VEN,2013.0,2,7,-5
LTU,POL,2012.0,2,1,1
TWN,SAU,2020.0,6,6,0
AUS,MUS,2011.0,1,1,0
THA,DNK,2006.0,4,3,1
HRV,CZE,2015.0,2,3,-1
GMB,MWI,2012.0,1,1,0
CUB,USA,2006.0,5,7,-2
HKG,NZL,2015.0,10,1,9
TUR,ITA,2007.0,4,6,-2
PER,FRA,2015.0,2,10,-8
BGR,SRB,1999.0,2,2,0
SVK,DNK,1998.0,2,3,-1
DNK,SVK,1999.0,2,1,1
HKG,BEL,2016.0,2,1,1
ZAF,SWZ,2016.0,4,3,1
IRL,IND,2018.0,9,34,-25
NLD,THA,2019.0,12,5,7
NOR,FIN,2014.0,7,20,-13
BEL,UGA,2015.0,2,1,1
PRT,CZE,2018.0,9,2,7
MEX,NOR,2014.0,3,3,0
CAN,LTU,2014.0,1,2,-1
NLD,HKG,2020.0,4,12,-8
PAK,FRA,2014.0,9,44,-35
FRA,ARM,2020.0,1,1,0
LVA,DEU,2012.0,7,3,4
AZE,TUR,2021.0,5,15,-10
MAC,SGP,2014.0,1,3,-2
JOR,PSE,2020.0,6,2,4
NLD,TZA,2017.0,5,2,3
NLD,LKA,2006.0,1,1,0
BWA,AUS,2018.0,1,5,-4
UKR,GRC,2015.0,1,1,0
ZMB,ZAF,2014.0,4,8,-4
GUM,USA,2001.0,7,2,5
MLI,NGA,1998.0,1,1,0
FRA,BGR,2001.0,9,16,-7
ARG,COL,2006.0,3,2,1
TTO,BRA,2012.0,1,2,-1
GRL,DNK,2007.0,3,3,0
HKG,RUS,2016.0,5,2,3
NAM,USA,2016.0,4,3,1
KEN,BEL,2018.0,5,7,-2
NLD,OMN,2001.0,1,3,-2
NLD,EGY,2017.0,3,5,-2
NLD,ARE,2015.0,5,1,4
DEU,LIE,2019.0,2,5,-3
NLD,LUX,2021.0,9,9,0
BEL,CMR,2016.0,3,3,0
YEM,CHN,2022.0,3,6,-3
KWT,ARE,2020.0,7,2,5
DZA,BEL,2010.0,2,2,0
MEX,SGP,2022.0,2,1,1
NGA,ZWE,2023.0,1,2,-1
PAN,CHL,2022.0,1,2,-1
COL,PHL,2021.0,2,2,0
ARE,DZA,2022.0,3,3,0
MLI,ZAF,2022.0,2,1,1
JPN,HRV,2001.0,2,1,1
ITA,PER,2006.0,1,1,0
IRN,NLD,2006.0,3,6,-3
USA,ZMB,2006.0,5,2,3
LUX,DEU,2005.0,4,9,-5
ZAF,GRC,2010.0,1,3,-2
GRC,ZAF,2011.0,1,1,0
NPL,JPN,1999.0,1,2,-1
CRI,BRA,2005.0,2,3,-1
IRL,SWE,2000.0,2,8,-6
ZWE,NLD,2012.0,3,1,2
CHL,NZL,2006.0,3,2,1
JPN,ZAF,1998.0,4,1,3
ZAF,JPN,2006.0,2,2,0
FIN,HUN,2004.0,5,4,1
USA,LIE,2003.0,3,1,2
BWA,BRN,2010.0,1,1,0
GUF,MDG,2000.0,1,1,0
FRA,ISL,2019.0,6,8,-2
VEN,COL,2007.0,7,1,6
ZAF,LKA,2002.0,1,1,0
ZAF,NAM,2003.0,8,4,4
CHN,RUS,2002.0,8,5,3
AUS,FJI,2002.0,2,3,-1
USA,BMU,2015.0,1,3,-2
BMU,USA,2017.0,1,2,-1
VEN,CAN,1999.0,2,4,-2
KAZ,USA,2003.0,1,1,0
UZB,TUR,2021.0,1,1,0
ESP,ECU,2005.0,6,2,4
TUR,TWN,1997.0,1,1,0
MAC,GBR,2023.0,2,1,1
AUS,TUR,1997.0,2,1,1
NGA,FRA,2002.0,3,3,0
GBR,GMB,2007.0,6,6,0
NLD,SRB,2014.0,7,2,5
PAK,FRA,2004.0,3,2,1
SRB,AUS,2003.0,2,4,-2
UGA,TZA,2015.0,2,4,-2
TZA,KEN,2020.0,4,17,-13
OMN,GBR,2001.0,6,2,4
BRN,LKA,2014.0,1,2,-1
FRA,NCL,1997.0,5,5,0
COL,CAN,2009.0,13,8,5
SWE,PAK,2004.0,2,1,1
SVK,AUT,2002.0,10,9,1
LUX,NZL,2023.0,1,1,0
ESP,GRD,2014.0,2,1,1
CHL,CUB,2009.0,1,3,-2
VEN,CHL,2004.0,3,3,0
BFA,KEN,2016.0,1,1,0
ROU,NLD,2009.0,4,6,-2
FRA,TUR,1999.0,7,2,5
MEX,TUR,2012.0,2,1,1
TUR,AUS,2016.0,8,9,-1
IRL,AUT,2013.0,9,5,4
USA,PRY,2017.0,2,3,-1
KAZ,DEU,2008.0,3,2,1
SEN,BFA,2012.0,2,4,-2
PAN,ESP,2015.0,3,2,1
ZAF,GMB,2005.0,1,2,-1
TUN,ESP,2005.0,3,4,-1
NOR,BEL,2014.0,4,8,-4
PRT,TWN,2013.0,2,1,1
ECU,DEU,2013.0,3,8,-5
FIN,PRT,2008.0,7,1,6
DNK,CZE,2019.0,4,8,-4
VNM,AUT,2012.0,1,3,-2
SAU,FRA,2013.0,3,34,-31
BFA,FRA,2016.0,11,16,-5
KAZ,USA,2013.0,4,10,-6
HUN,CZE,2018.0,8,3,5
AFG,CHN,2017.0,2,1,1
NGA,NLD,2012.0,3,1,2
SRB,SVN,2012.0,5,7,-2
BEL,PRT,2014.0,7,15,-8
HRV,ITA,2012.0,5,8,-3
EGY,GRC,2007.0,1,1,0
THA,CAN,2014.0,10,18,-8
FJI,KOR,2010.0,2,1,1
NLD,NGA,2011.0,3,1,2
PRY,ESP,2007.0,3,1,2
USA,BLR,2018.0,4,5,-1
POL,FIN,2016.0,7,6,1
DEU,YEM,2014.0,2,1,1
QAT,IND,2017.0,6,12,-6
IRQ,NGA,2013.0,1,1,0
MYS,PAK,2009.0,7,10,-3
ISL,DEU,2017.0,3,10,-7
CAN,TUN,2015.0,5,13,-8
SYC,GBR,2010.0,1,1,0
GBR,CMR,2020.0,6,4,2
IDN,NZL,2015.0,4,3,1
JOR,BEL,2014.0,1,2,-1
IRN,ZAF,2018.0,8,1,7
EST,ITA,2017.0,1,5,-4
CAN,VNM,2005.0,1,1,0
MAR,SAU,2018.0,3,5,-2
MAR,TUN,2006.0,4,2,2
NLD,COL,2015.0,4,10,-6
GNB,DNK,2019.0,4,2,2
CHE,SVN,2013.0,3,5,-2
CRI,CAN,2013.0,1,3,-2
CMR,CAN,2021.0,5,2,3
KOR,ISR,2020.0,7,6,1
KAZ,MYS,2019.0,1,2,-1
AUT,LKA,2020.0,1,1,0
KHM,FRA,2015.0,2,6,-4
FRA,LBY,2014.0,3,2,1
TUN,ITA,2012.0,2,4,-2
PSE,DEU,2016.0,3,7,-4
BRA,NOR,2016.0,8,7,1
ARE,LBN,2014.0,2,1,1
FIN,SVK,2012.0,4,2,2
NOR,CHE,2016.0,10,30,-20
MEX,ZAF,2015.0,3,3,0
KEN,NLD,2019.0,6,13,-7
BHR,IRL,2011.0,2,1,1
FRA,CYP,2010.0,1,2,-1
MMR,THA,2020.0,4,13,-9
GRC,PRT,2023.0,1,1,0
OMN,DEU,2017.0,5,3,2
EST,CAN,2023.0,2,1,1
SEN,COG,2021.0,2,2,0
FRA,GIN,2021.0,3,2,1
RUS,LVA,2019.0,4,3,1
HUN,PAK,2022.0,1,1,0
BRA,ARM,2021.0,1,1,0
FRA,BDI,2017.0,2,1,1
LAO,AUS,2019.0,3,1,2
NLD,PHL,2016.0,4,4,0
DEU,TZA,2023.0,3,1,2
SEN,KEN,2016.0,3,1,2
AUT,BRA,2023.0,5,12,-7
NGA,IDN,2021.0,1,1,0
OMN,CAN,2018.0,9,9,0
USA,BHR,2017.0,1,3,-2
GRC,CZE,2019.0,8,3,5
MYS,HKG,2021.0,6,7,-1
GMB,BEL,1998.0,1,2,-1
JPN,NZL,2017.0,2,4,-2
KOR,ETH,2017.0,5,2,3
USA,DZA,2018.0,10,4,6
CAN,GRC,2018.0,2,12,-10
COL,PRT,2014.0,2,2,0
BGD,NLD,2007.0,1,1,0
TUN,PRT,2022.0,2,2,0
PRT,TUN,2023.0,2,4,-2
PAK,SWE,2021.0,6,19,-13
JPN,IRN,2021.0,13,13,0
SYC,USA,2020.0,3,1,2
POL,ROU,2019.0,3,4,-1
EGY,TWN,2022.0,3,1,2
COL,ITA,2009.0,3,2,1
POL,ETH,2021.0,1,2,-1
GBR,PSE,2020.0,3,8,-5
IRQ,DEU,2019.0,3,12,-9
ETH,HKG,2021.0,3,1,2
IRQ,NZL,2021.0,1,1,0
GRC,ROU,2009.0,7,2,5
GHA,HUN,2022.0,1,3,-2
CZE,HRV,2011.0,3,1,2
PHL,THA,2020.0,2,12,-10
NGA,ARE,2022.0,4,1,3
HRV,IRN,2022.0,1,2,-1
FIN,PAK,2021.0,3,4,-1
MWI,USA,2022.0,13,19,-6
AUT,IND,2007.0,3,9,-6
BGD,NZL,2001.0,1,1,0
BWA,DEU,2016.0,2,1,1
SVN,KOR,2022.0,2,1,1
UKR,SRB,2004.0,3,2,1
USA,HND,2022.0,5,5,0
BEL,BFA,2023.0,4,3,1
NOR,VNM,2022.0,4,3,1
RUS,ARM,2019.0,6,5,1
ROU,CHN,2022.0,3,5,-2
SAU,BRA,2022.0,2,12,-10
USA,SYR,2017.0,1,4,-3
RUS,VEN,2012.0,1,1,0
SWE,ETH,1997.0,1,1,0
SVN,CHN,2016.0,2,1,1
SWE,EGY,2012.0,7,4,3
USA,BEN,2014.0,1,1,0
BFA,USA,2004.0,1,3,-2
CIV,ZAF,2009.0,2,4,-2
DEU,LVA,2013.0,3,5,-2
ISR,SGP,2012.0,8,1,7
ZMB,ZAF,2015.0,3,5,-2
SGP,ARE,2012.0,8,1,7
FIN,GRC,2010.0,4,3,1
MDG,USA,2000.0,1,1,0
THA,DNK,2000.0,1,1,0
BRB,GBR,2014.0,1,2,-1
EGY,DNK,2003.0,1,1,0
CZE,BGR,2002.0,1,1,0
CAN,BLR,2003.0,2,1,1
LTU,AUT,2004.0,1,1,0
ARG,AUT,2010.0,2,2,0
DNK,LKA,2012.0,1,1,0
MCO,GBR,2008.0,1,1,0
POL,IND,2008.0,1,8,-7
POL,MEX,2011.0,3,2,1
SWE,CUB,2012.0,1,1,0
MAR,ESP,2004.0,7,5,2
CAN,BGR,2019.0,3,1,2
HKG,JPN,1998.0,6,4,2
SGP,PAK,2004.0,2,1,1
NER,NGA,2006.0,1,3,-2
PRT,KOR,2009.0,1,3,-2
SWE,BRA,2002.0,6,5,1
URY,USA,2005.0,10,12,-2
HUN,ITA,2001.0,4,6,-2
BRA,HUN,2013.0,3,1,2
TUR,FRA,2012.0,9,24,-15
AUT,NOR,2010.0,5,6,-1
FRA,MDA,2012.0,1,2,-1
USA,MWI,2002.0,3,4,-1
NLD,URY,2006.0,1,3,-2
POL,MEX,2009.0,3,3,0
UZB,GBR,2017.0,1,1,0
CIV,CMR,2022.0,1,1,0
ARM,USA,2003.0,11,6,5
NLD,GEO,2001.0,1,1,0
RWA,UGA,2020.0,3,1,2
NIC,SWE,2003.0,1,2,-1
RUS,EST,2001.0,3,1,2
PAN,GBR,2006.0,1,3,-2
JPN,UKR,2015.0,4,5,-1
TUN,OMN,2015.0,1,1,0
GRC,HUN,2017.0,1,6,-5
FRA,COD,2010.0,1,1,0
DEU,DZA,2012.0,2,1,1
HND,USA,2010.0,3,2,1
COG,COD,2000.0,1,3,-2
BEL,SGP,2009.0,6,4,2
SWE,PAK,2008.0,2,5,-3
ESP,RUS,2008.0,10,14,-4
KOR,NLD,2006.0,2,5,-3
IND,BGD,2003.0,10,10,0
BRA,CHN,2004.0,3,2,1
AUS,NCL,2017.0,3,5,-2
VNM,FRA,2005.0,2,1,1
DNK,ISL,2005.0,4,1,3
USA,COG,2017.0,6,4,2
SWE,ZAF,2002.0,6,5,1
DNK,CHN,2008.0,19,21,-2
USA,GUM,2002.0,7,7,0
MEX,BRA,2002.0,6,7,-1
CHN,PAK,2001.0,5,1,4
AUT,CHN,1998.0,5,10,-5
KOR,AUT,2008.0,5,1,4
NPL,GBR,2004.0,4,3,1
IND,TZA,2016.0,5,2,3
TUR,AZE,2011.0,8,4,4
AUS,OMN,2000.0,3,1,2
IND,BRN,2014.0,2,1,1
NZL,NCL,2015.0,1,2,-1
GBR,BWA,1997.0,2,1,1
TUR,BGR,2010.0,1,1,0
AUS,HUN,2017.0,3,5,-2
UKR,BLR,1998.0,7,3,4
BRA,PAK,2005.0,1,1,0
GNB,DNK,2011.0,1,5,-4
NOR,AUT,2008.0,6,7,-1
ATG,IND,2015.0,1,1,0
USA,KNA,2018.0,2,4,-2
SEN,CMR,2011.0,1,2,-1
ITA,CHL,2001.0,2,5,-3
CZE,CHE,1998.0,8,3,5
BEL,KEN,2012.0,1,1,0
NGA,JPN,2012.0,6,4,2
KOR,KHM,2010.0,2,1,1
DEU,CAF,2009.0,1,1,0
GBR,BHR,2018.0,4,2,2
PAK,NZL,2010.0,3,3,0
USA,MWI,2005.0,5,2,3
CMR,BEL,2009.0,4,3,1
CUB,CHE,2019.0,5,1,4
THA,KHM,2015.0,3,3,0
HUN,CHE,2008.0,11,5,6
BGR,GBR,2016.0,6,7,-1
RUS,AZE,2019.0,6,6,0
KHM,IND,2018.0,2,2,0
THA,KOR,2012.0,4,5,-1
MEX,URY,2005.0,3,1,2
COG,FRA,2011.0,5,9,-4
ESP,MOZ,2016.0,5,3,2
ISR,TUR,2008.0,2,2,0
PER,FRA,2014.0,5,4,1
DNK,ESP,2006.0,7,9,-2
AZE,TUR,2011.0,4,8,-4
THA,CHE,2014.0,3,5,-2
BEN,FRA,1999.0,1,3,-2
ARE,GRC,2023.0,4,2,2
JPN,TZA,2014.0,7,1,6
USA,SVN,2021.0,10,8,2
AUS,BTN,2009.0,1,1,0
COL,RUS,1997.0,1,1,0
NOR,POL,2002.0,7,3,4
SDN,GBR,2020.0,6,5,1
SWE,CZE,2005.0,9,1,8
AUT,KOR,2012.0,3,4,-1
LTU,FIN,2009.0,2,4,-2
DNK,ISR,2016.0,3,3,0
BRA,PRI,2020.0,4,2,2
BRA,JPN,2003.0,7,25,-18
SWE,NZL,2010.0,8,6,2
AUS,FJI,2012.0,4,12,-8
SVK,HRV,2002.0,2,6,-4
ARG,ECU,2012.0,1,1,0
GRC,SRB,2015.0,2,3,-1
IRQ,JOR,2015.0,5,6,-1
UGA,NGA,2015.0,5,3,2
RUS,SRB,2019.0,9,3,6
ISR,SGP,2005.0,1,1,0
CHN,RUS,2012.0,7,11,-4
HUN,LUX,2010.0,1,1,0
NLD,LBY,2009.0,1,1,0
JPN,ARG,2005.0,3,1,2
HRV,SVN,2008.0,3,4,-1
POL,SVK,2012.0,4,5,-1
BGD,ITA,2013.0,4,3,1
KEN,CHE,2002.0,1,4,-3
SGP,TWN,2012.0,8,8,0
HUN,FIN,2000.0,2,6,-4
FIN,HUN,2001.0,3,6,-3
MYS,CHN,2004.0,6,1,5
CPV,PRT,2017.0,1,1,0
DNK,ETH,2017.0,3,2,1
AFG,GBR,2014.0,3,2,1
PRY,CHL,2019.0,2,1,1
USA,PRY,2022.0,4,3,1
GIN,USA,2019.0,1,2,-1
BWA,IND,2018.0,1,1,0
ZMB,GBR,2020.0,6,5,1
CHN,LUX,2018.0,4,3,1
CZE,CHN,2016.0,9,10,-1
MLI,GMB,2020.0,1,1,0
ARE,IRN,2019.0,1,3,-2
IRL,HUN,2022.0,2,2,0
CAN,ETH,2018.0,4,5,-1
VNM,NLD,2017.0,2,10,-8
BEL,IRN,2017.0,9,16,-7
PRT,DZA,2017.0,5,3,2
URY,AUS,2020.0,3,1,2
SLE,GBR,2017.0,4,4,0
SVN,ROU,2021.0,1,1,0
IND,ROU,2022.0,3,4,-1
SLE,KEN,2020.0,2,1,1
OMN,DEU,2018.0,3,3,0
DEU,SDN,2022.0,1,1,0
NLD,EGY,2018.0,5,2,3
VNM,BGD,2020.0,3,1,2
CYP,FRA,2019.0,1,3,-2
CHE,NPL,2007.0,1,1,0
PAK,ARE,2005.0,3,5,-2
ITA,TUR,2002.0,7,8,-1
SWE,TUR,2003.0,2,1,1
TUR,SVN,2014.0,1,3,-2
ARE,IND,2000.0,2,2,0
AUT,HRV,1999.0,5,4,1
NGA,ITA,2009.0,3,2,1
USA,FSM,2002.0,2,1,1
VEN,CAN,1998.0,4,3,1
IND,BEL,2003.0,4,8,-4
ARE,MYS,2013.0,1,6,-5
CHE,VNM,2014.0,5,1,4
SVN,AUT,1999.0,3,5,-2
GAB,FRA,2008.0,4,10,-6
SVN,FRA,2003.0,3,4,-1
UKR,BEL,2000.0,2,2,0
KWT,EGY,2007.0,6,6,0
ESP,BGR,2013.0,2,4,-2
GRC,ESP,1999.0,3,2,1
PAK,JPN,2003.0,2,5,-3
BEL,KEN,2002.0,5,2,3
THA,IDN,2001.0,1,2,-1
ARE,GBR,2009.0,4,20,-16
URY,SWE,2004.0,1,1,0
SWE,URY,2005.0,1,1,0
KAZ,UKR,1998.0,1,1,0
SRB,AUT,2002.0,1,2,-1
SWE,PRT,2003.0,6,7,-1
LTU,DNK,2002.0,1,2,-1
VNM,DEU,2006.0,7,4,3
NOR,BEL,2004.0,5,2,3
ISL,GBR,1999.0,4,3,1
LVA,UKR,2023.0,2,4,-2
MDA,UKR,2001.0,2,1,1
UKR,MDA,2006.0,1,1,0
ETH,NLD,1997.0,1,1,0
CHE,BOL,2015.0,1,1,0
HRV,SVK,2001.0,1,4,-3
SWE,MEX,1999.0,2,3,-1
KOR,ETH,2018.0,7,4,3
CAN,BEN,2014.0,1,1,0
FRA,EST,2000.0,5,3,2
SWE,HRV,2022.0,2,2,0
MNG,JPN,2002.0,3,5,-2
BEL,CHL,1998.0,1,2,-1
IND,RUS,2007.0,2,1,1
URY,CAN,2011.0,2,1,1
KHM,GBR,2010.0,2,1,1
QAT,IRN,2010.0,1,2,-1
FIN,NLD,1997.0,3,10,-7
CZE,JPN,2004.0,5,9,-4
ROU,CAN,1998.0,5,2,3
URY,FRA,2001.0,2,5,-3
CUB,BEL,2004.0,1,2,-1
NCL,PYF,2006.0,2,2,0
PRI,ARG,2010.0,3,1,2
AUS,PER,2014.0,2,3,-1
ZMB,JPN,1998.0,2,4,-2
JPN,ZMB,1999.0,3,2,1
CZE,NLD,2005.0,4,4,0
AUS,IRN,2000.0,13,1,12
SDN,ITA,2020.0,1,1,0
ETH,BWA,2023.0,3,1,2
USA,LUX,2000.0,2,1,1
ITA,IRN,2006.0,4,5,-1
PRT,ARG,2012.0,1,2,-1
ITA,EST,2003.0,1,2,-1
BEL,HRV,2003.0,1,1,0
DEU,CMR,2001.0,1,4,-3
NZL,SWE,2005.0,4,11,-7
PAK,BGD,2004.0,4,2,2
ESP,ROU,2002.0,2,4,-2
SVK,FIN,2010.0,2,1,1
CAN,CYP,2011.0,2,1,1
BEL,ISR,2005.0,4,5,-1
TUR,ITA,1998.0,3,5,-2
SAU,IRQ,2019.0,4,2,2
NLD,HRV,2015.0,4,7,-3
CAN,HUN,2018.0,7,5,2
CAN,HUN,2022.0,3,5,-2
UZB,BRA,1998.0,2,2,0
JPN,BFA,2012.0,1,1,0
NOR,PRT,2011.0,2,8,-6
CHE,EST,2014.0,1,5,-4
TUN,BEL,2008.0,2,4,-2
AUT,EGY,2004.0,4,1,3
THA,NOR,2019.0,2,2,0
HUN,ESP,2011.0,5,3,2
NLD,PAK,2008.0,1,1,0
SGP,IRL,2011.0,2,6,-4
PER,FRA,2008.0,3,7,-4
CAF,FRA,2013.0,1,3,-2
ESP,JOR,2010.0,2,1,1
ESP,HUN,1999.0,3,2,1
TUN,CAN,2009.0,8,8,0
CRI,NLD,2006.0,1,1,0
ARG,SLV,2012.0,1,1,0
DEU,CMR,2008.0,5,6,-1
MYS,HKG,2011.0,3,4,-1
IRQ,JOR,2004.0,2,1,1
IRQ,MYS,2007.0,3,1,2
UGA,ZAF,2010.0,7,9,-2
VIR,USA,2003.0,2,3,-1
SAU,ARE,2008.0,9,3,6
FIN,SAU,2020.0,1,3,-2
CMR,NGA,2012.0,2,2,0
MYS,ARE,2008.0,1,3,-2
SWE,EST,2014.0,5,10,-5
HUN,SAU,2020.0,1,1,0
UKR,SVK,2012.0,4,1,3
FRA,UGA,2007.0,3,1,2
BEL,VNM,2008.0,5,2,3
DNK,THA,2008.0,1,4,-3
LUX,GBR,2017.0,6,9,-3
BLR,IRN,2008.0,1,1,0
DJI,FRA,2015.0,3,4,-1
KOR,JOR,2014.0,2,1,1
VEN,CHL,2015.0,6,4,2
JAM,TTO,2011.0,2,10,-8
NLD,OMN,2015.0,2,1,1
ARE,THA,2022.0,1,1,0
NCL,USA,2016.0,2,1,1
COL,CHE,2009.0,4,4,0
CHE,HUN,2002.0,3,12,-9
THA,OMN,2014.0,1,1,0
ECU,ROU,2021.0,2,1,1
SGP,PHL,2011.0,3,1,2
SGP,DNK,2012.0,4,3,1
HKG,KOR,2016.0,10,11,-1
CHN,PRI,2010.0,1,1,0
SRB,POL,2020.0,1,2,-1
CAN,LUX,2018.0,4,4,0
CHL,DNK,2023.0,4,4,0
SRB,ISR,2018.0,2,2,0
EGY,MEX,2017.0,2,1,1
EGY,HUN,2017.0,3,2,1
SGP,ITA,2010.0,2,3,-1
AUT,KAZ,2019.0,3,1,2
GBR,SRB,2013.0,5,10,-5
TUR,SRB,2018.0,3,6,-3
ARE,RUS,2023.0,2,6,-4
CHE,HKG,2013.0,6,6,0
BEL,TWN,2019.0,3,8,-5
IRL,JPN,2022.0,4,12,-8
JOR,IRQ,2014.0,3,2,1
DNK,LTU,2012.0,4,3,1
TWN,SWE,2014.0,1,2,-1
PSE,JOR,2011.0,3,2,1
ITA,LVA,2010.0,1,1,0
RWA,BEL,2013.0,4,4,0
DNK,LKA,2002.0,1,1,0
MAR,ESP,2015.0,8,23,-15
CHN,TUR,2012.0,5,2,3
PRY,CZE,2012.0,1,2,-1
USA,LBR,2011.0,2,3,-1
PSE,SAU,2014.0,2,3,-1
LBN,CHE,2016.0,5,3,2
EST,POL,2020.0,1,4,-3
REU,FRA,2000.0,3,6,-3
MAR,JPN,2021.0,4,2,2
TUR,ARE,2018.0,4,3,1
RWA,NLD,2017.0,1,1,0
RUS,DNK,2012.0,6,4,2
SGP,BRA,2021.0,3,4,-1
SEN,USA,2007.0,3,11,-8
SRB,SVK,2022.0,1,1,0
ITA,HRV,1997.0,1,2,-1
QAT,IND,2018.0,7,9,-2
KEN,BEL,2017.0,4,4,0
DNK,MKD,2018.0,1,1,0
MDG,FRA,2023.0,1,3,-2
QAT,JPN,2018.0,3,1,2
OMN,ZAF,2000.0,1,1,0
IND,ETH,2005.0,4,6,-2
ETH,IND,2006.0,2,9,-7
FIN,CHL,2017.0,5,1,4
ISR,KOR,2015.0,7,5,2
UGA,NLD,2016.0,1,3,-2
FJI,AUS,2007.0,9,2,7
NPL,PAK,2017.0,1,2,-1
TWN,KOR,2004.0,3,7,-4
DNK,ROU,2005.0,2,1,1
BGR,DEU,2017.0,13,13,0
FJI,GBR,2018.0,2,1,1
RUS,KGZ,2013.0,3,4,-1
OMN,TUR,2017.0,3,2,1
NLD,CIV,2019.0,1,1,0
CRI,VEN,2016.0,1,1,0
ESP,RUS,2014.0,9,10,-1
KOR,AUT,2004.0,3,2,1
ESP,CHN,2007.0,4,10,-6
FRA,COG,2021.0,7,1,6
BEL,CMR,2018.0,3,2,1
ITA,LBN,2018.0,5,2,3
CYP,CAN,2021.0,2,2,0
CHE,GHA,2019.0,2,4,-2
AUT,BIH,2015.0,2,2,0
SVK,IRN,2018.0,1,2,-1
SWE,RWA,2022.0,2,2,0
SWE,PAN,2016.0,2,1,1
URY,DEU,2017.0,5,4,1
NLD,PRI,2014.0,1,1,0
VNM,ITA,2016.0,3,7,-4
HRV,MNE,2021.0,1,1,0
RUS,VNM,2012.0,7,3,4
EST,CAN,2010.0,2,3,-1
ESP,ROU,1997.0,2,2,0
NZL,IRN,2021.0,4,21,-17
POL,PER,2020.0,3,1,2
NLD,PRY,2022.0,1,1,0
KAZ,AUS,2021.0,3,3,0
ZMB,JPN,2020.0,4,6,-2
ETH,KEN,2013.0,2,1,1
GHA,CHE,2023.0,5,2,3
CAN,PSE,2020.0,1,1,0
CRI,FRA,2021.0,3,5,-2
AUS,IRQ,2014.0,4,4,0
RUS,MNG,2021.0,3,1,2
HUN,MNG,2021.0,2,1,1
LTU,DNK,1997.0,1,1,0
NZL,PHL,2023.0,4,2,2
HKG,ARE,2022.0,4,1,3
PAK,DEU,2000.0,5,1,4
SUR,NLD,2022.0,4,5,-1
GBR,BRN,2022.0,2,2,0
ZMB,MWI,2022.0,3,2,1
NGA,CYP,2022.0,2,3,-1
GBR,SVK,2021.0,6,5,1
SVN,CHN,2022.0,5,2,3
GHA,EGY,2022.0,1,2,-1
PAK,SWE,2009.0,7,3,4
UKR,NOR,2020.0,3,1,2
THA,HKG,2005.0,1,1,0
YEM,GBR,2022.0,6,1,5
FRA,BLR,2019.0,3,2,1
EGY,KWT,2000.0,4,10,-6
PRI,GBR,2002.0,1,1,0
BEL,NZL,2002.0,1,3,-2
MKD,DEU,2013.0,2,1,1
MKD,GBR,2012.0,1,1,0
ITA,UKR,2010.0,2,5,-3
ESP,VEN,1998.0,9,8,1
CAN,ARG,2000.0,6,11,-5
MAC,CAN,2004.0,1,2,-1
BEL,THA,2007.0,2,2,0
USA,GUM,1997.0,2,4,-2
SGP,MYS,1999.0,2,4,-2
IRL,NZL,2012.0,6,1,5
AUS,BRN,2005.0,2,2,0
CHL,VEN,2005.0,4,5,-1
USA,NPL,2005.0,5,6,-1
MEX,VEN,2017.0,6,15,-9
SAU,ARE,2004.0,3,5,-2
GAB,DEU,1998.0,4,1,3
QAT,SAU,2009.0,2,4,-2
DEU,UGA,2005.0,2,3,-1
BEL,ARG,2001.0,2,4,-2
GBR,BEN,2006.0,2,1,1
BEL,IND,2009.0,5,9,-4
BGD,PHL,2012.0,2,1,1
IRQ,RUS,2016.0,1,2,-1
BGR,AUT,2002.0,3,1,2
TUN,CHE,2011.0,3,4,-1
FRA,NGA,2011.0,2,3,-1
DEU,COL,2002.0,4,8,-4
SRB,GRC,1997.0,3,2,1
CAN,ARG,2010.0,8,16,-8
BGD,PAK,1998.0,1,2,-1
BGD,PAK,2007.0,3,7,-4
VNM,JPN,2006.0,3,14,-11
TUR,SGP,2011.0,2,1,1
BGR,ZAF,2008.0,1,1,0
KHM,AUS,2016.0,4,1,3
MYS,IRL,2011.0,1,6,-5
THA,MYS,2017.0,5,16,-11
POL,SVK,2005.0,1,1,0
TUR,FRA,1997.0,2,7,-5
CHL,SWE,1999.0,1,2,-1
GRC,NZL,2015.0,2,1,1
BEL,BLR,1997.0,1,1,0
AUT,ETH,2012.0,5,3,2
SRB,LUX,2020.0,1,1,0
EGY,JOR,2005.0,1,2,-1
ISR,ARG,2007.0,1,2,-1
DZA,JPN,2002.0,1,2,-1
FRO,DNK,2007.0,1,2,-1
FRA,QAT,2021.0,10,14,-4
PHL,IND,1999.0,2,3,-1
KOR,BLR,2000.0,4,1,3
TWN,THA,2003.0,2,1,1
MEX,JPN,2003.0,5,3,2
CAN,CHL,2000.0,5,5,0
ITA,POL,2006.0,8,15,-7
JPN,MNG,2009.0,4,4,0
GRC,SRB,2008.0,4,3,1
ROU,SAU,2015.0,3,1,2
DNK,EGY,2014.0,2,1,1
LBN,AUS,2018.0,2,4,-2
IRL,HRV,2017.0,1,5,-4
CHE,KOR,1999.0,2,1,1
CHL,NZL,2010.0,1,2,-1
NOR,HRV,2020.0,2,2,0
RUS,ISL,2019.0,2,1,1
SAU,OMN,2015.0,6,5,1
CAN,PRT,2017.0,6,11,-5
GRC,HUN,2022.0,2,1,1
IND,KEN,2022.0,3,4,-1
FIN,NZL,2020.0,1,4,-3
ESP,CHN,1999.0,3,1,2
CZE,BLR,2022.0,1,1,0
MEX,ZAF,2014.0,2,1,1
PRY,BEL,2016.0,1,1,0
LAO,USA,2012.0,1,4,-3
AUT,ISR,2017.0,3,7,-4
EST,JPN,2015.0,2,3,-1
AUT,HKG,2023.0,2,1,1
CZE,ROU,2020.0,2,1,1
CAN,PRT,2018.0,4,9,-5
TTO,BRB,2003.0,1,1,0
DEU,SDN,2017.0,3,3,0
MOZ,GBR,2020.0,2,1,1
SDN,IRQ,2020.0,1,1,0
GBR,CRI,2023.0,2,2,0
SYC,ZAF,2018.0,2,1,1
GBR,SYR,2000.0,2,1,1
HKG,ARE,2017.0,3,2,1
PSE,FRA,2018.0,2,5,-3
ECU,ROU,2019.0,1,1,0
CHN,JOR,2022.0,6,2,4
AUS,ARM,2020.0,1,1,0
GBR,SVN,2023.0,6,9,-3
OMN,JOR,2018.0,4,6,-2
SLV,SVN,2020.0,9,8,1
USA,GMB,2019.0,1,5,-4
NOR,IDN,2021.0,2,1,1
USA,NAM,2018.0,8,6,2
DZA,MAR,2015.0,4,3,1
CHN,UZB,2023.0,9,4,5
KEN,ETH,2020.0,10,5,5
NPL,DNK,2021.0,2,1,1
URY,GBR,2020.0,3,3,0
ETH,EGY,2021.0,2,1,1
PSE,QAT,2022.0,1,2,-1
GBR,COL,1998.0,2,3,-1
VNM,CAN,2019.0,2,7,-5
LKA,SWE,2022.0,4,4,0
PER,BEL,2020.0,3,3,0
TUN,MAR,2007.0,1,1,0
MAR,NER,2020.0,4,2,2
IDN,BEL,2022.0,4,8,-4
KEN,PAK,2019.0,3,2,1
USA,BDI,2019.0,1,1,0
GHA,BFA,2020.0,1,1,0
ZAF,PRT,2018.0,1,4,-3
KGZ,TJK,2020.0,1,1,0
OMN,AFG,2022.0,1,1,0
MMR,MYS,2022.0,3,1,2
DEU,NPL,2022.0,3,4,-1
MAC,USA,2021.0,7,14,-7
ARG,URY,1998.0,5,2,3
NGA,NER,2006.0,3,1,2
BRA,ZAF,2014.0,2,4,-2
TGO,FRA,2010.0,3,3,0
PAK,LKA,2001.0,2,2,0
EST,FRA,2011.0,1,4,-3
GBR,MLT,2004.0,7,4,3
GBR,MNG,2014.0,3,1,2
ZAF,CMR,2006.0,2,1,1
MWI,ZWE,2009.0,2,2,0
CUB,GBR,2004.0,3,6,-3
IND,TTO,2020.0,1,2,-1
TWN,ZAF,2005.0,1,2,-1
UKR,BRA,2006.0,5,1,4
KEN,ETH,2007.0,4,3,1
ZAF,MYS,2010.0,2,1,1
CHE,JOR,2013.0,1,1,0
DNK,CHL,2018.0,1,3,-2
NLD,MYS,2008.0,3,2,1
BRA,IRL,2011.0,2,1,1
GBR,IDN,2003.0,6,2,4
SAU,TUR,2005.0,4,2,2
FIN,PER,2009.0,2,1,1
TUR,IND,2012.0,4,6,-2
JOR,DEU,2004.0,3,3,0
POL,GRC,2008.0,1,1,0
UZB,USA,2008.0,2,1,1
JPN,CZE,2006.0,7,6,1
USA,BOL,2017.0,1,3,-2
ECU,FRA,2016.0,2,13,-11
GRC,SGP,2012.0,2,1,1
JPN,IRL,2006.0,3,3,0
MOZ,USA,2008.0,1,2,-1
AUS,LAO,2011.0,3,4,-1
GRC,AUS,2009.0,4,3,1
ITA,GEO,2009.0,1,1,0
THA,GHA,2022.0,1,2,-1
TWN,CZE,2017.0,2,1,1
CHE,IRN,2006.0,2,7,-5
CIV,MLI,2003.0,1,1,0
ZAF,POL,2017.0,4,3,1
AUT,RUS,2017.0,12,14,-2
ESP,RUS,2015.0,10,8,2
BEL,PER,2015.0,4,2,2
TUR,ZAF,2021.0,1,1,0
ZAF,TUR,2022.0,1,2,-1
HKG,GRC,2000.0,1,1,0
BFA,GBR,2015.0,3,1,2
EGY,IRL,2015.0,1,1,0
DZA,USA,2016.0,5,17,-12
USA,DZA,2017.0,9,4,5
ESP,QAT,2020.0,4,3,1
ROU,ESP,2003.0,7,4,3
CZE,KOR,2019.0,3,3,0
MKD,CHE,2016.0,3,1,2
KOR,TUR,2021.0,4,5,-1
DNK,IDN,2021.0,4,1,3
GIN,GNQ,2009.0,1,3,-2
DZA,USA,2017.0,4,9,-5
CAN,CYP,2021.0,2,2,0
SWE,HKG,2021.0,2,6,-4
NZL,ZAF,2018.0,6,13,-7
PAK,JOR,2015.0,1,2,-1
CZE,BEL,2016.0,4,10,-6
SEN,BEN,2016.0,1,3,-2
MNG,DEU,2015.0,1,3,-2
USA,SYR,2018.0,2,1,1
CHE,CZE,2023.0,6,17,-11
SYC,AUS,2014.0,1,1,0
FRA,KHM,2008.0,2,2,0
TUR,NOR,2023.0,7,2,5
ROU,IRL,2005.0,1,1,0
KAZ,AUS,2019.0,2,1,1
BEL,CZE,2006.0,7,2,5
TWN,NLD,2023.0,5,3,2
TUR,SDN,2020.0,2,4,-2
SVK,ITA,2018.0,3,6,-3
PAK,CZE,2021.0,6,3,3
COD,FRA,2022.0,4,1,3
TUN,OMN,2008.0,1,3,-2
PSE,JOR,2019.0,1,5,-4
IRN,AZE,2018.0,3,4,-1
SSD,SDN,2019.0,3,10,-7
KEN,ZAF,1997.0,2,2,0
ZAF,ZMB,2009.0,2,2,0
MAR,KOR,2023.0,2,1,1
FIN,LTU,2008.0,2,2,0
UKR,BEL,2006.0,2,2,0
EGY,POL,1999.0,4,2,2
GBR,LTU,2003.0,3,4,-1
USA,LSO,2013.0,2,3,-1
AUS,BTN,2021.0,1,5,-4
CHE,ROU,2007.0,6,4,2
NGA,PHL,2018.0,2,1,1
CHL,CHN,2013.0,6,5,1
ROU,MDA,2002.0,2,1,1
FIN,LTU,2004.0,2,2,0
LTU,GBR,2005.0,4,5,-1
UGA,NGA,2014.0,1,2,-1
EGY,AUT,1997.0,2,1,1
MAR,GBR,2008.0,3,1,2
NLD,LTU,2007.0,1,2,-1
URY,SWE,2001.0,2,5,-3
ESP,BGR,2003.0,2,4,-2
ERI,USA,1998.0,1,1,0
JPN,NGA,1998.0,1,2,-1
BEL,HRV,2013.0,2,3,-1
BLR,POL,2002.0,4,2,2
SWE,TZA,1999.0,1,5,-4
DEU,DZA,2002.0,2,2,0
BRA,CUB,2007.0,5,8,-3
NGA,SEN,2013.0,1,1,0
CYP,CAN,2011.0,1,2,-1
JPN,BGR,2004.0,2,4,-2
AUS,NGA,2000.0,1,3,-2
IRL,TUR,2005.0,1,5,-4
KAZ,UZB,2015.0,3,4,-1
KGZ,TUR,2015.0,2,5,-3
SAU,JPN,1997.0,1,2,-1
NLD,TUR,2003.0,3,9,-6
IND,LBY,1999.0,1,1,0
PRT,CHE,2000.0,2,7,-5
KNA,USA,2019.0,1,6,-5
RUS,LTU,1998.0,5,1,4
AUS,COL,2006.0,1,1,0
AUT,UKR,2000.0,2,6,-4
MAR,BEL,2009.0,5,8,-3
KNA,ZAF,2021.0,1,2,-1
SAU,BEL,2009.0,1,3,-2
ARM,RUS,2016.0,3,5,-2
TUR,ITA,1999.0,5,4,1
CAN,LKA,2015.0,5,2,3
TTO,USA,1998.0,5,2,3
GBR,ETH,2005.0,3,2,1
SGP,ITA,2000.0,1,2,-1
BRA,DNK,2011.0,2,6,-4
GHA,CAN,2002.0,5,1,4
NZL,HUN,2021.0,3,1,2
LKA,AUS,2000.0,2,3,-1
CYP,AUS,2018.0,3,1,2
ROU,NLD,2011.0,4,3,1
IRL,ZAF,2017.0,2,6,-4
ARE,LBY,2021.0,1,1,0
MYS,NOR,2010.0,4,2,2
DNK,EGY,2001.0,4,4,0
NZL,AUT,2003.0,2,1,1
ETH,ZAF,2007.0,2,9,-7
OMN,GBR,2008.0,4,14,-10
MEX,IND,2007.0,4,3,1
NGA,BRA,2015.0,1,6,-5
PRI,IND,2017.0,1,1,0
KWT,PRT,2011.0,1,1,0
CHE,NZL,2000.0,2,6,-4
BRA,AUS,1998.0,3,7,-4
AUT,JPN,2015.0,10,19,-9
CUB,ARG,2008.0,1,2,-1
COG,ZAF,2012.0,1,1,0
IND,OMN,2003.0,4,1,3
GMB,USA,2002.0,5,4,1
TTO,USA,1999.0,5,7,-2
CHE,TZA,2005.0,2,1,1
AND,ESP,2015.0,3,2,1
ARG,JPN,2000.0,3,1,2
KEN,IND,2012.0,1,2,-1
HRV,ESP,2014.0,6,3,3
CAN,CUB,2002.0,1,3,-2
GBR,KHM,2018.0,6,2,4
KOR,HKG,2004.0,2,5,-3
BEL,UGA,2014.0,3,3,0
FJI,NZL,2023.0,1,1,0
MOZ,AUS,2017.0,2,1,1
CHN,CZE,2010.0,1,4,-3
JPN,SGP,1997.0,6,3,3
BGD,DNK,2017.0,3,1,2
IND,SVN,2014.0,3,2,1
IND,HKG,2010.0,3,8,-5
TWN,NZL,2007.0,3,1,2
GBR,HKG,2024.0,1,3,-2
MYS,TWN,2010.0,2,5,-3
USA,BRN,2013.0,2,1,1
EST,FRA,2019.0,1,1,0
JOR,PAK,2009.0,1,1,0
ESP,CRI,1999.0,1,3,-2
EGY,ESP,2011.0,4,4,0
EGY,CZE,2019.0,3,3,0
LUX,MEX,2020.0,1,1,0
PRT,LUX,2021.0,5,1,4
MEX,BEL,2023.0,5,3,2
DEU,LBN,2015.0,3,3,0
TWN,TUR,2017.0,5,1,4
UKR,NLD,2022.0,2,1,1
CHL,BEL,2017.0,4,21,-17
MDG,CAN,2022.0,1,1,0
CHN,ZMB,2019.0,4,1,3
NLD,MKD,2021.0,1,2,-1
SDN,KEN,2021.0,3,1,2
AUT,SGP,2020.0,2,4,-2
EGY,SGP,2022.0,1,1,0
TUR,DZA,2018.0,2,3,-1
MAR,ZAF,2023.0,3,2,1
TUR,DZA,2017.0,2,1,1
AUS,KHM,2019.0,6,2,4
SVK,ESP,1998.0,2,1,1
DEU,NPL,2018.0,4,4,0
QAT,KOR,2012.0,1,1,0
GAB,BEL,2020.0,1,2,-1
HUN,IRN,2022.0,1,14,-13
MWI,TWN,2018.0,1,2,-1
VNM,ITA,2018.0,1,6,-5
LKA,NZL,2023.0,1,4,-3
ETH,CHE,2010.0,3,2,1
DNK,MEX,2021.0,5,3,2
IRL,PAK,2012.0,1,1,0
IRL,SAU,2017.0,3,7,-4
ARE,CAN,1999.0,2,11,-9
NOR,ROU,2022.0,1,2,-1
COL,CHL,2001.0,2,1,1
ITA,FRA,2024.0,3,2,1
SEN,BEN,2022.0,1,1,0
CHL,BEL,2022.0,6,7,-1
KGZ,KAZ,2022.0,7,2,5
VNM,CHE,2022.0,2,2,0
SYR,QAT,2023.0,3,1,2
VNM,CHN,2023.0,9,15,-6
GHA,ITA,2022.0,2,3,-1
SRB,PRT,2020.0,2,2,0
SWE,UKR,2009.0,2,7,-5
EGY,AUS,2000.0,3,2,1
CAN,SEN,2017.0,3,1,2
GBR,EST,2007.0,4,4,0
TUR,DNK,2007.0,2,2,0
GBR,FLK,2006.0,2,2,0
ZAF,ETH,2008.0,4,5,-1
SAU,LBY,2014.0,1,4,-3
GBR,EST,1999.0,2,2,0
BEL,COL,2009.0,2,2,0
BGR,ISR,2001.0,3,2,1
GBR,MDG,2001.0,1,1,0
NOR,ROU,2018.0,1,1,0
USA,MCO,2007.0,1,2,-1
FRA,CAF,2008.0,5,5,0
DEU,MOZ,2020.0,1,1,0
CZE,DNK,2011.0,2,6,-4
RUS,MNG,2011.0,2,1,1
GHA,DEU,2010.0,1,5,-4
DEU,IDN,2003.0,3,2,1
VEN,GBR,2004.0,4,5,-1
FRA,BEN,2000.0,2,1,1
IDN,MYS,2001.0,1,3,-2
MYS,IDN,2005.0,2,4,-2
SWE,ZAF,2005.0,3,5,-2
HUN,ISR,2003.0,1,3,-2
USA,MMR,2013.0,1,3,-2
NZL,FJI,2022.0,4,4,0
USA,TZA,2002.0,4,20,-16
MKD,CAN,2001.0,1,1,0
NGA,ETH,2007.0,2,1,1
DEU,SYR,2010.0,2,2,0
JPN,PRT,2010.0,1,3,-2
SWE,LVA,2003.0,5,2,3
CHN,BFA,2005.0,3,1,2
KOR,UKR,2019.0,4,1,3
ESP,ECU,2002.0,2,1,1
UGA,ZAF,2000.0,1,1,0
ETH,EGY,2011.0,2,1,1
AUS,SRB,2003.0,4,2,2
GHA,ITA,1997.0,1,1,0
SRB,ALB,2005.0,1,1,0
FRA,MYS,2005.0,1,1,0
EST,CAN,2001.0,1,1,0
ZWE,KEN,2011.0,1,1,0
QAT,JOR,2001.0,1,5,-4
MAC,FRA,2014.0,1,1,0
DNK,CYP,2017.0,2,1,1
BGD,KOR,2002.0,1,1,0
SGP,HUN,2012.0,2,5,-3
AUS,BGD,2008.0,4,16,-12
PRT,ZAF,2012.0,1,1,0
NOR,HUN,2007.0,1,2,-1
JPN,GRC,2002.0,1,4,-3
ZAF,POL,2012.0,2,4,-2
OMN,GBR,2000.0,3,7,-4
GBR,TUN,2009.0,4,3,1
ITA,LBN,2012.0,1,1,0
SWZ,ZAF,2019.0,5,12,-7
JPN,KEN,2013.0,10,4,6
ETH,FRA,2020.0,2,2,0
AUT,MEX,2020.0,5,11,-6
IRL,BHR,2021.0,5,1,4
IRL,BHR,2011.0,1,2,-1
ISR,UKR,2016.0,1,3,-2
MLI,MAR,2020.0,1,3,-2
JPN,CHL,2002.0,1,1,0
HKG,IND,2007.0,3,1,2
USA,DZA,2002.0,2,1,1
TCD,FRA,2018.0,1,1,0
TUR,TWN,2017.0,1,5,-4
LBY,AUS,2015.0,1,2,-1
ISR,KOR,2023.0,4,3,1
AUT,ETH,2022.0,3,1,2
EGY,ESP,2003.0,4,2,2
RUS,BGR,2013.0,3,5,-2
KEN,UGA,2007.0,1,7,-6
KOR,TWN,2006.0,5,4,1
BEL,CZE,2004.0,4,8,-4
ETH,EGY,2013.0,1,2,-1
TUN,ZAF,2020.0,3,2,1
DEU,ARM,2020.0,4,5,-1
RUS,TWN,2014.0,2,3,-1
ESP,BLR,2022.0,1,1,0
CIV,BEN,2021.0,4,5,-1
POL,DNK,2021.0,7,10,-3
VNM,RUS,2023.0,4,12,-8
ECU,ARG,2023.0,3,7,-4
LBN,SAU,2003.0,1,1,0
RUS,SVK,2011.0,1,1,0
CAN,IDN,1999.0,2,1,1
HUN,SVK,2009.0,3,3,0
AUT,HUN,2016.0,8,36,-28
RUS,EST,2010.0,4,4,0
TZA,JPN,2016.0,2,1,1
UGA,COD,2022.0,3,1,2
JPN,RUS,2023.0,7,12,-5
EGY,QAT,1999.0,1,6,-5
NZL,IRL,2005.0,4,4,0
MEX,PRT,2013.0,4,4,0
FIN,BRA,2021.0,3,23,-20
GBR,COG,2018.0,3,2,1
PRT,JPN,2007.0,1,3,-2
TWN,SGP,1997.0,1,2,-1
EGY,ESP,2013.0,2,6,-4
EST,GBR,2009.0,4,8,-4
BRA,AGO,2016.0,1,2,-1
BRA,ISR,2005.0,1,2,-1
IRL,ESP,2003.0,1,9,-8
MEX,PER,2001.0,1,4,-3
NLD,PHL,2012.0,2,2,0
UGA,ZAF,2001.0,1,1,0
ZAF,ZMB,2003.0,2,2,0
ARG,AUT,2004.0,1,1,0
GRC,JPN,2009.0,2,7,-5
BRA,ZAF,2006.0,1,1,0
DEU,ALB,2007.0,4,1,3
GBR,ETH,2018.0,5,10,-5
TCD,FRA,2022.0,1,1,0
NOR,IRL,2023.0,2,9,-7
JOR,AUS,2009.0,3,9,-6
ARE,TUN,2022.0,1,8,-7
PAK,EGY,2018.0,2,2,0
POL,BGR,2023.0,1,2,-1
MAR,GBR,2023.0,5,4,1
BGD,HUN,2022.0,2,1,1
DEU,LBN,2023.0,1,6,-5
EST,FRA,2013.0,1,1,0
MNG,RUS,2018.0,2,1,1
SGP,ETH,2021.0,2,2,0
AUT,MKD,2011.0,1,1,0
ARE,MYS,2011.0,2,1,1
CIV,KEN,2012.0,1,1,0
ESP,MYS,2015.0,2,3,-1
BFA,GHA,2018.0,1,3,-2
AUT,UGA,2022.0,2,1,1
EGY,LTU,2018.0,1,0,1
PHL,MLT,2021.0,1,0,1
HKG,QAT,2023.0,3,0,3
NZL,TZA,2020.0,1,0,1
THA,IRN,2016.0,1,0,1
KAZ,BGR,2018.0,3,0,3
MEX,IDN,2018.0,1,0,1
BLR,LVA,2022.0,2,0,2
CHE,TWN,2003.0,3,0,3
BHR,TWN,2020.0,1,0,1
SWE,MOZ,2021.0,3,0,3
RUS,KEN,2002.0,1,0,1
LTU,PRI,1998.0,1,0,1
SRB,HKG,2008.0,1,0,1
BGR,IRL,2002.0,2,0,2
UKR,CHE,1997.0,1,0,1
UZB,FRA,2011.0,1,0,1
AUS,TZA,1999.0,1,0,1
CHE,GHA,2011.0,1,0,1
UZB,ISR,1997.0,2,0,2
ZAF,PAK,1997.0,1,0,1
SVN,ISR,2001.0,3,0,3
BGR,HKG,2006.0,1,0,1
BGR,SGP,2016.0,1,0,1
ZWE,BEL,2004.0,2,0,2
TUR,BRA,1998.0,2,0,2
TWN,AUT,1997.0,1,0,1
SLV,HRV,2001.0,1,0,1
PSE,MOZ,2005.0,1,0,1
SVN,DNK,2012.0,4,0,4
EGY,PSE,2004.0,2,0,2
ISR,LTU,1998.0,2,0,2
MYS,ESP,2005.0,1,0,1
SVK,ZAF,2022.0,1,0,1
USA,NCL,1998.0,1,0,1
UKR,HUN,2019.0,3,0,3
SLB,AUS,2001.0,3,0,3
ARG,NOR,2016.0,3,0,3
SLV,HRV,2014.0,2,0,2
UKR,CHE,2002.0,5,0,5
UGA,IND,2007.0,1,0,1
FRA,CRI,1998.0,1,0,1
TUN,KOR,2013.0,1,0,1
COL,COD,2023.0,1,0,1
SWE,LUX,2004.0,2,0,2
ARE,PAK,2011.0,1,0,1
GBR,SDN,2004.0,3,0,3
ISR,DNK,2004.0,3,0,3
TUR,NOR,2006.0,2,0,2
DZA,USA,2022.0,8,0,8
SWE,LKA,2001.0,1,0,1
BEL,MEX,2004.0,4,0,4
AUS,MAR,2021.0,2,0,2
RUS,ARE,2003.0,1,0,1
GRC,KAZ,2014.0,3,0,3
MKD,BIH,1999.0,1,0,1
HKG,MYS,1997.0,1,0,1
JPN,ARG,1997.0,8,0,8
PHL,GTM,2008.0,1,0,1
GEO,CHN,2007.0,3,0,3
PHL,KOR,2005.0,1,0,1
JPN,GIN,2018.0,1,0,1
UKR,CAN,2012.0,5,0,5
ZMB,COG,2018.0,1,0,1
NOR,IRL,2004.0,2,0,2
UGA,CUB,2019.0,1,0,1
BHR,LBN,2010.0,1,0,1
THA,IRN,2018.0,2,0,2
TTO,ATG,2022.0,1,0,1
HUN,BGR,2012.0,1,0,1
SGP,QAT,2006.0,1,0,1
NGA,RWA,2008.0,1,0,1
POL,ARE,2014.0,1,0,1
BEL,PER,2008.0,4,0,4
,BHS,2006.0,6,0,6
LSO,SWZ,2014.0,1,0,1
LUX,NGA,2005.0,2,0,2
TWN,ARM,2014.0,2,0,2
BRN,POL,2013.0,1,0,1
NLD,BRB,2013.0,2,0,2
,MDV,2007.0,3,0,3
CMR,TCD,2014.0,2,0,2
MOZ,SDN,2020.0,1,0,1
BFA,TUN,2013.0,1,0,1
NER,TUR,2015.0,1,0,1
ARG,PAN,2015.0,1,0,1
BFA,NER,2011.0,2,0,2
BIH,KWT,2016.0,2,0,2
PHL,KEN,2010.0,1,0,1
CHE,MNG,2007.0,1,0,1
BOL,NLD,2010.0,2,0,2
JOR,TWN,2010.0,1,0,1
CHL,BIH,2004.0,1,0,1
ARE,MAR,2014.0,2,0,2
SLE,,2016.0,5,0,5
CHN,NGA,2006.0,2,0,2
GEO,POL,2011.0,1,0,1
IND,ITA,2024.0,1,0,1
AUS,QAT,2009.0,2,0,2
,ATG,2007.0,2,0,2
PNG,FJI,2003.0,2,0,2
MAR,IRN,2022.0,1,0,1
NIU,USA,2020.0,1,0,1
KEN,CIV,2015.0,2,0,2
CCK,,2016.0,1,0,1
GRC,HUN,2016.0,3,0,3
ESP,ATG,2022.0,2,0,2
MYS,ZAF,2005.0,1,0,1
BGR,CZE,2012.0,5,0,5
BGD,KAZ,2023.0,1,0,1
BWA,NLD,1998.0,1,0,1
BFA,PAK,2007.0,2,0,2
PAK,BFA,2008.0,3,0,3
MWI,ZMB,2009.0,2,0,2
NER,IND,2013.0,1,0,1
GUM,ESP,2020.0,1,0,1
COL,URY,1999.0,1,0,1
IRL,GRC,2000.0,2,0,2
RUS,HKG,2013.0,2,0,2
IRN,KAZ,2020.0,3,0,3
FJI,SLB,2020.0,2,0,2
MCO,GBR,2001.0,2,0,2
,GUM,2009.0,10,0,10
GEO,AZE,2006.0,1,0,1
AZE,GEO,2007.0,1,0,1
MSR,BRB,2003.0,1,0,1
MEX,ZWE,2000.0,1,0,1
BGR,SRB,1998.0,2,0,2
CZE,ROU,1999.0,1,0,1
SRB,PRT,1998.0,1,0,1
FRA,VUT,2021.0,2,0,2
ZAF,DZA,2023.0,1,0,1
TWN,JOR,2009.0,1,0,1
ARE,IDN,2022.0,1,0,1
ARG,HRV,2022.0,1,0,1
SRB,LBN,2021.0,1,0,1
SVK,CHN,2012.0,2,0,2
MYS,DZA,2023.0,4,0,4
NGA,RUS,2023.0,3,0,3
CHN,MUS,2023.0,1,0,1
IDN,GBR,2024.0,1,0,1
PRI,AUS,2006.0,1,0,1
TUR,THA,2011.0,1,0,1
PER,CHL,2002.0,3,0,3
ISL,GRC,1999.0,1,0,1
UKR,COL,1998.0,1,0,1
DNK,LVA,2010.0,1,0,1
VNM,AUS,2024.0,2,0,2
GBR,MSR,2000.0,1,0,1
ISR,ROU,1999.0,1,0,1
CAN,BMU,2001.0,1,0,1
GUY,GBR,2000.0,1,0,1
ZAF,PRT,2016.0,4,0,4
AGO,PRT,1999.0,1,0,1
NER,AUS,2014.0,1,0,1
MNP,USA,2000.0,1,0,1
SVK,ESP,1999.0,1,0,1
SGP,HUN,2017.0,1,0,1
KOR,EGY,2002.0,3,0,3
PAN,ESP,2008.0,6,0,6
TUR,UZB,2022.0,3,0,3
,DOM,1997.0,5,0,5
DNK,PER,1998.0,1,0,1
SEN,IRL,2010.0,1,0,1
COL,VNM,2011.0,1,0,1
CAN,PHL,1997.0,1,0,1
ECU,JPN,2021.0,1,0,1
GUY,USA,2013.0,1,0,1
PER,CHE,2013.0,2,0,2
JAM,FRA,2002.0,2,0,2
BRB,TTO,1998.0,2,0,2
MAR,IND,2012.0,1,0,1
OMN,NGA,2010.0,2,0,2
ROU,ECU,2013.0,1,0,1
NZL,GMB,2011.0,1,0,1
SSD,,2019.0,3,0,3
MRT,CHE,2013.0,1,0,1
DEU,PAN,2014.0,2,0,2
IRL,SVN,2012.0,1,0,1
UKR,CHL,2012.0,1,0,1
MEX,SGP,2016.0,3,0,3
CHL,RUS,2018.0,2,0,2
NLD,BDI,2016.0,1,0,1
NGA,ROU,2009.0,1,0,1
CYP,IND,2018.0,1,0,1
VUT,AUS,2021.0,1,0,1
PAK,SDN,2020.0,1,0,1
GHA,BRN,2012.0,1,0,1
ECU,CAN,2015.0,2,0,2
SLE,CMR,2017.0,1,0,1
SVN,TUR,2015.0,1,0,1
,GUM,2011.0,4,0,4
ITA,ESP,2024.0,1,0,1
HUN,TUR,2012.0,2,0,2
MUS,PYF,2021.0,1,0,1
IRN,THA,2014.0,1,0,1
PAK,ZAF,2017.0,3,0,3
MDG,DEU,2017.0,1,0,1
SWE,KGZ,2018.0,2,0,2
MYS,MDV,2019.0,2,0,2
TON,,2019.0,2,0,2
ARG,CRI,2020.0,4,0,4
NGA,HKG,2015.0,1,0,1
QAT,CZE,2018.0,2,0,2
,SOM,2014.0,2,0,2
MEX,ISR,2021.0,2,0,2
BRA,GUF,2021.0,1,0,1
PLW,USA,2018.0,1,0,1
IND,GUY,2018.0,2,0,2
IND,TUN,2017.0,1,0,1
GRC,EGY,2021.0,1,0,1
JPN,ESP,2024.0,1,0,1
BEL,AFG,2017.0,1,0,1
UKR,GEO,2019.0,1,0,1
ECU,SVN,2019.0,1,0,1
KHM,HUN,2019.0,1,0,1
HRV,CHN,2019.0,1,0,1
IRN,QAT,2020.0,2,0,2
DNK,MOZ,2020.0,1,0,1
ISL,EST,2011.0,2,0,2
ITA,PRI,2023.0,1,0,1
BEN,BFA,2019.0,5,0,5
BGR,GRC,2023.0,1,0,1
BLR,UZB,2022.0,1,0,1
MYS,SOM,2022.0,1,0,1
LCA,,2024.0,10,0,10
MDG,HTI,2023.0,1,0,1
SYR,BEL,2015.0,1,0,1
BEL,SYR,2017.0,1,0,1
PHL,SAU,2023.0,2,0,2
ISR,IDN,2021.0,1,0,1
PER,DOM,2023.0,2,0,2
DNK,KWT,2018.0,2,0,2
SLB,,2011.0,1,0,1
JPN,SDN,2014.0,3,0,3
AUS,NRU,1999.0,1,0,1
MEX,QAT,2022.0,2,0,2
LBN,AUT,2012.0,1,0,1
GRC,GEO,2007.0,1,0,1
COD,UGA,2000.0,1,0,1
GIN,,2017.0,11,0,11
MNG,,2006.0,7,0,7
UZB,ISR,2005.0,1,0,1
UGA,CUB,2009.0,1,0,1
NIC,,2007.0,4,0,4
AZE,CHN,2007.0,1,0,1
RUS,TZA,1997.0,1,0,1
MOZ,ITA,1998.0,1,0,1
VNM,PNG,2014.0,1,0,1
BTN,CHE,2017.0,1,0,1
CHN,THA,2003.0,1,0,1
,SUR,1994.0,3,0,3
MUS,,2013.0,10,0,10
ESP,DZA,2006.0,4,0,4
MEX,KAZ,2009.0,1,0,1
CHL,CYP,2010.0,1,0,1
COD,,2008.0,4,0,4
BFA,SEN,1999.0,1,0,1
ZAF,CMR,2000.0,2,0,2
NGA,MLI,2002.0,1,0,1
PLW,JPN,2008.0,1,0,1
IRL,MUS,2003.0,1,0,1
JOR,NLD,2000.0,2,0,2
CUB,BEL,2001.0,6,0,6
AUS,MNG,2000.0,1,0,1
YEM,,2002.0,4,0,4
MTQ,,2005.0,1,0,1
KWT,QAT,2011.0,1,0,1
LSO,ITA,1998.0,3,0,3
TUR,ETH,2000.0,1,0,1
ZWE,GBR,2008.0,3,0,3
ETH,MAR,2024.0,1,0,1
COG,SEN,2008.0,1,0,1
ARG,KEN,2018.0,1,0,1
IRL,MYS,2000.0,1,0,1
JPN,PLW,2005.0,1,0,1
PLW,JPN,2014.0,1,0,1
ISR,NZL,2008.0,3,0,3
BRA,TTO,2007.0,1,0,1
FIN,KOR,2003.0,3,0,3
MEX,CHN,2008.0,5,0,5
PAK,KAZ,2015.0,1,0,1
,AFG,1997.0,2,0,2
EST,AUS,2009.0,2,0,2
IND,SRB,2001.0,2,0,2
TUR,HKG,1998.0,1,0,1
THA,NGA,2006.0,1,0,1
ATG,USA,2011.0,1,0,1
MEX,CRI,2003.0,3,0,3
MDA,ISR,1999.0,3,0,3
POL,LVA,2019.0,1,0,1
SWZ,DEU,1997.0,1,0,1
,HND,2001.0,5,0,5
MUS,MDG,2018.0,1,0,1
MUS,MDG,2022.0,1,0,1
NLD,RWA,2010.0,1,0,1
GEO,CZE,2004.0,1,0,1
PYF,MDG,2005.0,2,0,2
VEN,AUS,2021.0,5,0,5
JPN,GHA,2011.0,6,0,6
TZA,AUT,2008.0,1,0,1
PER,BOL,1998.0,1,0,1
FRA,JOR,2002.0,1,0,1
SGP,BRN,2003.0,2,0,2
DEU,JAM,1998.0,1,0,1
ATG,,2024.0,6,0,6
AZE,ISR,2002.0,1,0,1
LBN,NLD,2006.0,1,0,1
DNK,ECU,2018.0,2,0,2
IRL,LBN,2014.0,1,0,1
CAF,GBR,2022.0,1,0,1
KOR,ROU,2010.0,1,0,1
TTO,UKR,2007.0,1,0,1
UKR,TTO,2012.0,1,0,1
BEL,PSE,2005.0,1,0,1
HUN,ZAF,1998.0,3,0,3
TCD,,2016.0,1,0,1
SYR,CAN,2012.0,2,0,2
BRA,LBR,2014.0,1,0,1
BOL,NER,2009.0,1,0,1
GMB,QAT,2019.0,1,0,1
CHE,CUB,2008.0,3,0,3
CUB,CHE,2009.0,1,0,1
BMU,,2014.0,4,0,4
FRA,AFG,2011.0,2,0,2
ITA,IRQ,2015.0,3,0,3
PRI,NIC,2012.0,1,0,1
CHN,IRN,2006.0,4,0,4
LBY,IND,2017.0,3,0,3
NOR,KEN,2020.0,1,0,1
MLI,NOR,2023.0,1,0,1
NAM,ZAF,1998.0,1,0,1
IRQ,LUX,2014.0,1,0,1
GNB,CHE,2018.0,1,0,1
TTO,NLD,2019.0,1,0,1
SLV,SWE,2013.0,1,0,1
ZAF,FJI,2019.0,1,0,1
RWA,BEN,2018.0,1,0,1
LKA,KOR,2013.0,3,0,3
PLW,AUS,2023.0,1,0,1
GHA,ESP,2018.0,1,0,1
HUN,VEN,1998.0,2,0,2
UKR,TWN,2007.0,2,0,2
CZE,ARE,2010.0,1,0,1
MLT,AUS,2008.0,1,0,1
SYC,ESP,2016.0,1,0,1
SVK,NOR,2011.0,3,0,3
SRB,MEX,2013.0,1,0,1
VNM,PHL,2000.0,1,0,1
BIH,SVN,2003.0,1,0,1
CHE,ISL,2008.0,1,0,1
JPN,ISL,2012.0,1,0,1
JOR,PSE,1998.0,1,0,1
IRQ,EGY,2011.0,1,0,1
SLE,ESP,2011.0,1,0,1
SGP,ARE,2005.0,2,0,2
GHA,ESP,2017.0,1,0,1
ESP,GHA,2021.0,1,0,1
DOM,FRA,2021.0,1,0,1
NAM,CHN,2020.0,1,0,1
ETH,FJI,2023.0,1,0,1
HKG,AUT,2021.0,1,0,1
CHN,KWT,2020.0,1,0,1
ARG,ZWE,2012.0,1,0,1
URY,DEU,2018.0,3,0,3
BGD,VNM,2019.0,1,0,1
MAR,NLD,2004.0,2,0,2
KEN,SDN,2006.0,1,0,1
DZA,CAN,2002.0,5,0,5
BEL,IDN,2008.0,2,0,2
KWT,ESP,2015.0,1,0,1
NLD,MWI,2009.0,2,0,2
MCO,USA,2023.0,2,0,2
CMR,ITA,2003.0,1,0,1
SLV,SVN,1998.0,5,0,5
MUS,ZAF,2010.0,1,0,1
NGA,NLD,1997.0,1,0,1
IND,PER,2001.0,1,0,1
PER,URY,2002.0,1,0,1
MDG,,2001.0,6,0,6
CYP,CAN,2009.0,1,0,1
SVN,POL,1998.0,1,0,1
POL,SVN,1999.0,1,0,1
TUR,MYS,1997.0,1,0,1
CHN,ARM,2021.0,1,0,1
MEX,HND,1997.0,1,0,1
BEL,SDN,2005.0,1,0,1
NLD,ROU,1997.0,1,0,1
,AGO,1997.0,5,0,5
CUB,NLD,2003.0,1,0,1
ITA,SWZ,2002.0,1,0,1
MCO,,2005.0,9,0,9
DNK,IDN,2011.0,1,0,1
GMB,GHA,2007.0,1,0,1
MSR,GBR,2006.0,1,0,1
LTU,CZE,2001.0,1,0,1
SRB,POL,1998.0,2,0,2
JAM,CHL,2016.0,1,0,1
CHL,JAM,2019.0,1,0,1
UKR,IRL,2023.0,2,0,2
ZWE,HUN,2001.0,1,0,1
ARM,SGP,2001.0,1,0,1
HRV,ITA,2005.0,2,0,2
CZE,ARE,2006.0,1,0,1
FRA,SYC,2005.0,1,0,1
KOR,NGA,2006.0,2,0,2
FRA,CUB,1999.0,3,0,3
MCO,,2012.0,5,0,5
PHL,ARG,2010.0,2,0,2
GBR,BIH,2006.0,2,0,2
USA,GNQ,2008.0,1,0,1
NLD,HKG,1998.0,1,0,1
ERI,USA,2007.0,1,0,1
ROU,CZE,2010.0,2,0,2
ITA,GTM,2006.0,1,0,1
RUS,THA,1999.0,1,0,1
ITA,GUF,2005.0,1,0,1
NOR,UGA,2005.0,1,0,1
SDN,OMN,2010.0,1,0,1
SWE,NIC,2005.0,3,0,3
PNG,FRA,2004.0,1,0,1
SWE,SOM,2021.0,1,0,1
UZB,JPN,2014.0,1,0,1
AUS,GRL,2016.0,1,0,1
CHL,ECU,2006.0,4,0,4
NOR,GHA,1997.0,1,0,1
JPN,GHA,2009.0,1,0,1
MAC,ZAF,2008.0,1,0,1
ZAF,MAC,2009.0,1,0,1
POL,GEO,2012.0,1,0,1
IND,URY,2015.0,1,0,1
,MDV,1999.0,1,0,1
LBY,QAT,2012.0,1,0,1
LSO,,2010.0,3,0,3
AND,,2021.0,4,0,4
LKA,ETH,2021.0,1,0,1
HUN,RUS,2005.0,2,0,2
REU,BEL,2008.0,1,0,1
MEX,HUN,2005.0,2,0,2
MNG,DNK,2017.0,1,0,1
SVK,NOR,2009.0,1,0,1
OMN,DNK,2008.0,1,0,1
TTO,CUB,2007.0,1,0,1
FRA,MNG,2016.0,1,0,1
GBR,LBY,2000.0,4,0,4
ITA,CYP,2010.0,2,0,2
TUR,DNK,1999.0,3,0,3
COM,ESP,2014.0,1,0,1
GMB,NZL,2016.0,1,0,1
CAN,KAZ,2012.0,2,0,2
MOZ,PSE,2022.0,4,0,4
BEL,DJI,2010.0,1,0,1
SWE,LAO,2017.0,1,0,1
,SJM,2002.0,1,0,1
MNP,,2015.0,1,0,1
DEU,MMR,2011.0,1,0,1
VCT,,2016.0,1,0,1
GBR,MSR,2023.0,1,0,1
IRN,LUX,2012.0,1,0,1
PHL,OMN,2013.0,1,0,1
EST,HRV,2011.0,1,0,1
ISL,PRT,2019.0,2,0,2
HUN,HKG,2015.0,4,0,4
SGP,HRV,2011.0,1,0,1
NGA,JOR,2015.0,2,0,2
IRL,CYP,2011.0,1,0,1
,COM,2008.0,4,0,4
JPN,PAN,2018.0,1,0,1
ESP,PSE,2015.0,2,0,2
MYS,JAM,2017.0,1,0,1
GRC,NPL,2017.0,1,0,1
SWE,LAO,2018.0,1,0,1
AUS,LUX,2014.0,1,0,1
BGR,DNK,2023.0,1,0,1
LBN,TUR,2016.0,1,0,1
STP,,2024.0,5,0,5
MEX,GRC,2008.0,1,0,1
MEX,GRC,2014.0,1,0,1
URY,NLD,2015.0,1,0,1
UKR,ITA,2006.0,2,0,2
MEX,TUN,2020.0,1,0,1
LBN,IND,2012.0,1,0,1
IRN,TUN,2007.0,1,0,1
NZL,CYP,2017.0,1,0,1
SDN,OMN,2000.0,1,0,1
ZAF,FIN,2007.0,1,0,1
COG,UGA,2016.0,1,0,1
AUT,CYP,2003.0,1,0,1
EGY,SGP,2016.0,2,0,2
BRA,BIH,2012.0,2,0,2
FJI,GBR,2022.0,1,0,1
MDA,CHN,2021.0,3,0,3
MLI,UGA,2020.0,1,0,1
ISL,IRL,1999.0,1,0,1
GHA,LKA,2010.0,1,0,1
JPN,SLB,2021.0,1,0,1
PRT,UKR,2018.0,2,0,2
NLD,PRY,2018.0,2,0,2
TCD,TUR,2017.0,1,0,1
TUR,NPL,2018.0,1,0,1
BIH,ALB,2018.0,2,0,2
CAN,GEO,2022.0,2,0,2
ISR,EST,2020.0,1,0,1
TTO,HUN,2018.0,1,0,1
TUN,BEN,2017.0,1,0,1
PHL,JOR,2020.0,1,0,1
DMA,,2020.0,4,0,4
USA,TCA,2017.0,2,0,2
BDI,ETH,2020.0,1,0,1
PRI,PRT,2017.0,1,0,1
AFG,GBR,2008.0,3,0,3
GHA,MWI,2020.0,1,0,1
LVA,ROU,2019.0,1,0,1
AUS,MNG,2006.0,1,0,1
TUN,DZA,2014.0,4,0,4
SVK,TWN,2005.0,1,0,1
BGR,DZA,2014.0,1,0,1
ISR,LTU,2020.0,1,0,1
DEU,SLE,2018.0,1,0,1
ARM,SAU,2021.0,3,0,3
ERI,USA,2020.0,2,0,2
TUN,HUN,2020.0,2,0,2
KOR,PRI,1999.0,1,0,1
ITA,MDG,2022.0,1,0,1
ESP,BWA,2022.0,1,0,1
,CPV,2020.0,9,0,9
TUR,ZMB,2022.0,2,0,2
MEX,GRC,2001.0,1,0,1
IND,GMB,2022.0,1,0,1
EGY,TZA,2022.0,1,0,1
MAR,BGR,2022.0,1,0,1
MAR,SGP,2020.0,1,0,1
MAR,TUN,2024.0,1,0,1
LUX,MLT,2015.0,1,0,1
MLT,LUX,2019.0,1,0,1
CMR,CYP,2021.0,1,0,1
LKA,POL,2020.0,1,0,1
ZAF,BGD,2019.0,2,0,2
PRY,COL,2018.0,1,0,1
LUX,NOR,2005.0,1,0,1
CRI,RUS,2000.0,5,0,5
PAK,JOR,2004.0,2,0,2
MKD,GBR,2002.0,1,0,1
BGD,BHR,1999.0,1,0,1
ARM,JPN,1999.0,1,0,1
LKA,CHE,2016.0,3,0,3
ETH,LAO,2012.0,1,0,1
LKA,LAO,2014.0,1,0,1
HKG,VEN,1997.0,1,0,1
LTU,IRL,2007.0,1,0,1
GRD,,2014.0,3,0,3
ZWE,IND,2009.0,1,0,1
NFK,USA,2014.0,1,0,1
PER,CMR,2002.0,1,0,1
HUN,SVN,2021.0,6,0,6
BRB,GBR,2004.0,1,0,1
PAK,SYR,1999.0,1,0,1
IRL,MYS,2006.0,2,0,2
ZMB,NZL,1997.0,1,0,1
HUN,CHN,2011.0,4,0,4
PER,CRI,2007.0,1,0,1
IRL,FIN,1997.0,2,0,2
NOR,ISR,2001.0,3,0,3
,MAC,1999.0,5,0,5
ITA,MDG,2018.0,1,0,1
MDG,ITA,2020.0,1,0,1
NZL,UKR,2011.0,1,0,1
JPN,CHL,2022.0,5,0,5
COG,GHA,2012.0,1,0,1
JOR,SAU,1999.0,5,0,5
MDG,BRA,2019.0,2,0,2
LAO,CAN,2001.0,1,0,1
ISR,NOR,1999.0,3,0,3
BEL,ECU,2011.0,5,0,5
CHL,CZE,2010.0,1,0,1
JAM,ZAF,2012.0,1,0,1
BMU,USA,2018.0,2,0,2
NLD,BLR,2000.0,1,0,1
PRI,FRA,1998.0,1,0,1
THA,LKA,2000.0,2,0,2
ESP,NGA,1998.0,2,0,2
AGO,EGY,2012.0,1,0,1
JAM,FRA,2012.0,1,0,1
NZL,PRT,2012.0,1,0,1
AZE,NLD,2019.0,1,0,1
AUT,KOR,1997.0,1,0,1
KAZ,GBR,2006.0,1,0,1
CRI,NLD,2010.0,1,0,1
NIC,USA,2012.0,2,0,2
NGA,BGD,2008.0,1,0,1
AUS,GHA,2011.0,1,0,1
PRT,THA,2017.0,1,0,1
NIC,,1999.0,3,0,3
PRT,LTU,2017.0,1,0,1
TWN,GMB,2021.0,2,0,2
SGP,THA,2024.0,1,0,1
ROU,HRV,2014.0,2,0,2
ETH,NPL,2022.0,1,0,1
NPL,ETH,2023.0,1,0,1
ITA,MLT,2005.0,2,0,2
BEL,MCO,2019.0,1,0,1
CZE,SAU,2017.0,1,0,1
ESP,REU,2015.0,1,0,1
REU,USA,2016.0,2,0,2
ROU,THA,2017.0,1,0,1
CHE,SLE,2015.0,1,0,1
PAK,SGP,1998.0,2,0,2
ARG,HND,2017.0,2,0,2
ESP,SMR,2021.0,1,0,1
TWN,ECU,2018.0,2,0,2
LUX,SVN,2022.0,1,0,1
ZAF,COL,2018.0,1,0,1
JPN,CMR,2023.0,1,0,1
TKM,,2021.0,2,0,2
SAU,IRQ,2009.0,1,0,1
ISL,CHL,2021.0,1,0,1
BGD,CHN,2024.0,1,0,1
IDN,TUR,2011.0,1,0,1
TWN,GMB,2019.0,1,0,1
VGB,ZAF,2023.0,1,0,1
BLZ,MEX,2017.0,1,0,1
THA,ESP,2023.0,2,0,2
ARG,PRY,2017.0,2,0,2
ZAF,JPN,2023.0,3,0,3
SWE,FIN,2024.0,3,0,3
DEU,TGO,2022.0,1,0,1
BEL,SYR,2022.0,1,0,1
IND,GHA,2012.0,1,0,1
HND,IRL,2016.0,1,0,1
ARG,SVN,2023.0,1,0,1
ISL,FRO,2021.0,3,0,3
JOR,JPN,2021.0,2,0,2
JPN,ZWE,2022.0,1,0,1
ZAF,COL,2022.0,1,0,1
SRB,TWN,2019.0,2,0,2
AUT,ARE,2007.0,2,0,2
MYS,NLD,2004.0,1,0,1
GEO,HUN,2006.0,1,0,1
SWE,SVN,2005.0,2,0,2
,PYF,1997.0,12,0,12
COL,KHM,2009.0,3,0,3
MLI,DNK,2013.0,2,0,2
IND,ZWE,2007.0,1,0,1
AUS,KHM,2009.0,2,0,2
SRB,LBY,2010.0,1,0,1
NOR,CMR,2012.0,1,0,1
PER,FIN,2007.0,2,0,2
CHE,LTU,2010.0,2,0,2
MAR,ZAF,2010.0,1,0,1
SGP,PAK,2008.0,2,0,2
VEN,BEL,2018.0,1,0,1
ARE,ECU,2013.0,1,0,1
NGA,SGP,2004.0,1,0,1
MEX,ARM,2011.0,1,0,1
SLV,NOR,2008.0,1,0,1
JPN,KAZ,2006.0,1,0,1
,BMU,2003.0,5,0,5
ZAF,MYS,2006.0,2,0,2
GHA,THA,2014.0,1,0,1
AUS,AFG,2004.0,1,0,1
CMR,CAN,2011.0,2,0,2
BLZ,BRA,2012.0,1,0,1
HUN,VEN,1999.0,1,0,1
DEU,BIH,2004.0,3,0,3
DEU,PRK,2020.0,1,0,1
NZL,OMN,2003.0,3,0,3
ROU,MDA,2005.0,1,0,1
SRB,CZE,2015.0,4,0,4
FRA,PAN,2011.0,1,0,1
CAN,PAN,2022.0,2,0,2
NZL,ECU,2022.0,1,0,1
PRT,MNE,2017.0,1,0,1
AUT,BGR,2000.0,1,0,1
EST,GEO,2017.0,1,0,1
BGR,KOR,2018.0,1,0,1
AUT,SAU,2021.0,3,0,3
FJI,CHL,2016.0,1,0,1
RUS,KWT,2017.0,1,0,1
THA,BTN,2012.0,3,0,3
MYS,CHE,2012.0,3,0,3
AUS,MAC,2005.0,2,0,2
FJI,MAR,2021.0,1,0,1
GIN,CIV,2015.0,1,0,1
ARG,ZAF,2013.0,2,0,2
TUN,BDI,2016.0,1,0,1
MDV,ESP,2016.0,1,0,1
FRA,AND,2003.0,2,0,2
NGA,LTU,2022.0,1,0,1
BWA,TZA,2020.0,2,0,2
ARG,PRY,2022.0,3,0,3
NER,CIV,2018.0,3,0,3
KHM,NPL,2020.0,1,0,1
BEL,RWA,2023.0,5,0,5
IDN,ZAF,2019.0,2,0,2
ESP,MMR,2022.0,1,0,1
SHN,GBR,2022.0,3,0,3
OMN,TUN,2009.0,1,0,1
RUS,GIN,2022.0,1,0,1
BRA,EST,2021.0,3,0,3
CIV,BRA,2016.0,1,0,1
HKG,ZAF,2007.0,2,0,2
PRI,CRI,2000.0,1,0,1
ARG,ROU,2006.0,1,0,1
CHL,CRI,1998.0,2,0,2
RUS,TUN,2000.0,1,0,1
HUN,LVA,2001.0,1,0,1
ZAF,LSO,1998.0,2,0,2
SWE,UGA,2003.0,1,0,1
ARG,PER,2004.0,1,0,1
GRC,FIN,2002.0,1,0,1
MLT,KOR,2021.0,1,0,1
NLD,BEN,2007.0,3,0,3
SEN,CAN,2001.0,1,0,1
ZMB,SWE,1999.0,2,0,2
DEU,MWI,2007.0,4,0,4
KWT,UKR,2014.0,2,0,2
ITA,CMR,2007.0,1,0,1
MLI,THA,2001.0,1,0,1
NZL,LKA,2002.0,1,0,1
ALB,SRB,2003.0,1,0,1
DEU,KHM,2003.0,1,0,1
KHM,DEU,2005.0,1,0,1
YEM,ITA,2015.0,1,0,1
ETH,TZA,1999.0,1,0,1
DEU,PAN,2004.0,2,0,2
ARE,BHR,2004.0,1,0,1
ITA,TZA,2000.0,2,0,2
TUV,RUS,2020.0,2,0,2
CUB,NZL,1997.0,1,0,1
URY,AUS,1998.0,1,0,1
TWN,PYF,2017.0,1,0,1
VIR,JAM,2007.0,1,0,1
FIN,ROU,2013.0,3,0,3
BEL,KEN,2005.0,1,0,1
BGR,FIN,2010.0,3,0,3
UGA,ITA,2001.0,4,0,4
ZWE,TGO,2001.0,1,0,1
GBR,GEO,2003.0,2,0,2
ISL,IRL,2007.0,1,0,1
MOZ,CUB,2001.0,1,0,1
KAZ,GBR,2000.0,1,0,1
FIN,BGR,2005.0,1,0,1
NLD,ECU,2010.0,1,0,1
SWE,MTQ,2017.0,1,0,1
AUS,MAC,2012.0,2,0,2
TGO,UKR,2017.0,1,0,1
GEO,BRA,2015.0,1,0,1
AUT,PER,2016.0,1,0,1
AUT,PER,2022.0,1,0,1
FIN,ZAF,1998.0,1,0,1
BIH,MNE,2012.0,1,0,1
IRL,BGD,2006.0,1,0,1
ISL,JPN,2014.0,1,0,1
SGP,ZAF,2008.0,3,0,3
CHL,POL,2001.0,1,0,1
CMR,CAF,2008.0,1,0,1
BIH,ROU,2016.0,1,0,1
IRN,JOR,2008.0,1,0,1
HUN,MEX,2006.0,1,0,1
AND,FRA,2002.0,1,0,1
SYR,PHL,2011.0,1,0,1
USA,MAC,2008.0,1,0,1
SGP,KHM,2018.0,2,0,2
CHN,PRI,2000.0,1,0,1
MOZ,PRT,1999.0,3,0,3
TTO,ZAF,2014.0,3,0,3
LTU,NZL,2019.0,1,0,1
GBR,GTM,2023.0,1,0,1
SYR,AUS,2023.0,1,0,1
CHE,MDG,2021.0,1,0,1
CHE,CRI,2023.0,1,0,1
GRC,MNE,2015.0,1,0,1
CAN,MDG,2021.0,1,0,1
KEN,SSD,2023.0,2,0,2
ETH,NZL,2012.0,1,0,1
VNM,ZWE,2018.0,2,0,2
ZWE,VNM,2019.0,2,0,2
FRA,HND,2020.0,1,0,1
IRQ,TUN,2021.0,10,0,10
,CAF,2017.0,6,0,6
PRT,SAU,2011.0,1,0,1
BRA,ISL,2022.0,2,0,2
KAZ,ARE,2021.0,1,0,1
SGP,BHR,2020.0,1,0,1
MLI,CAN,2020.0,2,0,2
GUY,SAU,2022.0,1,0,1
,HTI,2020.0,13,0,13
ZMB,VNM,2021.0,1,0,1
BGD,CIV,2001.0,1,0,1
YEM,,2005.0,3,0,3
VEN,COL,1998.0,1,0,1
NOR,HRV,2007.0,2,0,2
THA,ITA,2003.0,1,0,1
BFA,GAB,2017.0,1,0,1
LUX,SAU,2014.0,1,0,1
PRT,GNQ,2009.0,2,0,2
VUT,,2019.0,6,0,6
TUR,DNK,1998.0,1,0,1
NPL,FRA,2010.0,1,0,1
BFA,MWI,2004.0,1,0,1
ROU,NOR,2005.0,5,0,5
ALB,CHE,2005.0,1,0,1
BWA,GHA,2015.0,1,0,1
BHR,,1999.0,5,0,5
GTM,GHA,2008.0,1,0,1
JPN,ISL,1997.0,1,0,1
KOR,HUN,2016.0,1,0,1
URY,ZAF,2002.0,1,0,1
ETH,MLI,2015.0,1,0,1
DEU,MWI,1998.0,2,0,2
MKD,HRV,2002.0,2,0,2
BFA,JPN,2010.0,1,0,1
GBR,KIR,2005.0,1,0,1
AUT,IDN,2005.0,2,0,2
NLD,KWT,2002.0,2,0,2
LSO,,2006.0,2,0,2
ZWE,UGA,2014.0,1,0,1
GIN,PNG,2008.0,1,0,1
COG,MLI,2022.0,1,0,1
GAB,,2000.0,5,0,5
AUT,CMR,2019.0,1,0,1
EGY,ETH,2009.0,1,0,1
PER,PAN,2018.0,1,0,1
FRA,MUS,2000.0,2,0,2
CHL,ISR,2005.0,1,0,1
MKD,NLD,2000.0,2,0,2
UKR,KWT,2015.0,2,0,2
MOZ,BRA,1999.0,1,0,1
BRA,ARE,2021.0,5,0,5
CAN,CRI,2004.0,2,0,2
GUM,,2013.0,3,0,3
CHE,KHM,1998.0,1,0,1
KHM,,2003.0,1,0,1
SVK,PSE,2022.0,1,0,1
LVA,CHE,1999.0,1,0,1
RUS,TUV,2018.0,1,0,1
PAK,KWT,1998.0,1,0,1
ZWE,COG,2010.0,1,0,1
ZAF,CAF,2005.0,1,0,1
BWA,NAM,2012.0,2,0,2
ITA,UGA,2002.0,5,0,5
ZAF,KNA,2020.0,2,0,2
ITA,GHA,2002.0,1,0,1
CHE,ZWE,2003.0,3,0,3
GHA,OMN,2007.0,1,0,1
PNG,IDN,2002.0,2,0,2
DEU,CMR,2000.0,2,0,2
LBY,FIN,2017.0,2,0,2
BGR,IRN,2008.0,1,0,1
KHM,BEL,2003.0,1,0,1
HKG,NPL,2003.0,1,0,1
ARG,SVN,2004.0,1,0,1
BLR,AUT,2001.0,2,0,2
PRT,SVN,2014.0,1,0,1
PER,AUT,2017.0,2,0,2
DEU,SEN,2008.0,1,0,1
CUB,HKG,2013.0,2,0,2
CUB,VEN,2023.0,2,0,2
LBY,NLD,2015.0,1,0,1
USA,GUF,2000.0,1,0,1
ITA,PRI,2014.0,1,0,1
IND,EGY,2003.0,2,0,2
LVA,AUT,2008.0,1,0,1
TZA,IRL,2023.0,1,0,1
BEL,BGD,1998.0,1,0,1
EGY,UGA,2002.0,1,0,1
SAU,CYP,2005.0,1,0,1
CYP,SAU,2006.0,1,0,1
EST,IRL,2023.0,2,0,2
KEN,PRT,2016.0,1,0,1
AUT,EST,2019.0,2,0,2
PRI,BEL,2020.0,1,0,1
PAK,BGD,2024.0,1,0,1
CHN,ARG,2011.0,1,0,1
,LIE,2008.0,6,0,6
,WSM,2015.0,4,0,4
NOR,GEO,2022.0,2,0,2
COL,UGA,2017.0,1,0,1
PSE,HUN,2018.0,1,0,1
FRA,LSO,2020.0,2,0,2
RWA,BDI,2019.0,1,0,1
CAN,ATG,2020.0,2,0,2
CZE,SYR,2017.0,1,0,1
SUR,USA,2017.0,2,0,2
UZB,TJK,2017.0,1,0,1
MYS,LTU,2021.0,2,0,2
TWN,MWI,2020.0,3,0,3
ARG,JOR,2022.0,1,0,1
HKG,EGY,2021.0,3,0,3
,SWE,2021.0,14,0,14
TUR,IDN,2023.0,2,0,2
ZWE,PAK,2021.0,1,0,1
PER,MYS,2022.0,1,0,1
MEX,PAN,2021.0,1,0,1
CYP,ARE,2006.0,1,0,1
BEL,ECU,2003.0,2,0,2
NLD,URY,2008.0,1,0,1
MYS,PNG,2015.0,1,0,1
GAB,GMB,2007.0,1,0,1
CHL,IRL,2005.0,2,0,2
FRA,SDN,2007.0,3,0,3
WSM,USA,2002.0,1,0,1
ESP,GNQ,2004.0,4,0,4
GNQ,,2011.0,3,0,3
AUS,NGA,2008.0,2,0,2
POL,SYR,2021.0,1,0,1
ARE,KWT,1997.0,1,0,1
PER,DEU,2001.0,1,0,1
LBY,DEU,2001.0,1,0,1
JPN,MDA,2004.0,1,0,1
ETH,PER,2000.0,1,0,1
CCK,DEU,2010.0,1,0,1
KWT,LTU,1998.0,1,0,1
TUN,PRT,2005.0,3,0,3
BLR,CHE,2007.0,2,0,2
IND,BGR,2015.0,2,0,2
GIN,COG,2018.0,4,0,4
TUN,SWE,2001.0,1,0,1
SWE,TUN,2006.0,1,0,1
KIR,GBR,2007.0,2,0,2
CZE,IRN,2001.0,1,0,1
MUS,SEN,2014.0,1,0,1
DZA,JOR,2006.0,2,0,2
ARG,LTU,2006.0,1,0,1
LTU,ARG,2007.0,2,0,2
KAZ,FRA,2004.0,1,0,1
KOR,KAZ,2012.0,1,0,1
ZWE,CUB,1997.0,1,0,1
BDI,ZWE,2020.0,1,0,1
,BHS,1996.0,4,0,4
ISR,JOR,2004.0,2,0,2
URY,ITA,2006.0,1,0,1
KOR,MEX,2006.0,4,0,4
SWE,NIC,2016.0,1,0,1
COG,ITA,2009.0,2,0,2
,WSM,2014.0,7,0,7
THA,RUS,2007.0,1,0,1
,MRT,1996.0,3,0,3
GBR,LSO,2005.0,1,0,1
BWA,BGR,2012.0,1,0,1
VUT,GBR,2004.0,1,0,1
ESP,COD,2021.0,1,0,1
GBR,GIN,2001.0,2,0,2
,CAF,2005.0,6,0,6
CAF,CHN,2015.0,1,0,1
THA,NGA,2015.0,1,0,1
BEL,RWA,2008.0,1,0,1
SHN,USA,2010.0,1,0,1
DEU,LBR,2021.0,2,0,2
,GUY,1999.0,3,0,3
ATA,DEU,2001.0,1,0,1
SDN,DNK,1998.0,1,0,1
ZMB,UGA,2014.0,1,0,1
LSO,,2008.0,2,0,2
ESP,GEO,2008.0,1,0,1
CUB,PAK,2005.0,1,0,1
VGB,CAN,2008.0,1,0,1
AUT,ISL,2014.0,2,0,2
HTI,USA,1999.0,3,0,3
CAN,PAN,2012.0,1,0,1
KOR,LKA,2004.0,1,0,1
CRI,ARG,2009.0,1,0,1
YEM,RUS,2000.0,1,0,1
GEO,CHE,2012.0,1,0,1
CUB,AGO,2016.0,1,0,1
NPL,NZL,2014.0,2,0,2
ESP,ARM,2022.0,1,0,1
ROU,SVN,2013.0,2,0,2
,AND,2010.0,1,0,1
NLD,URY,2014.0,1,0,1
VNM,IRQ,2021.0,4,0,4
ZAF,PAK,2016.0,1,0,1
AZE,FIN,2015.0,1,0,1
TUR,POL,2012.0,2,0,2
GUY,CAN,2014.0,1,0,1
BLR,IRN,2010.0,2,0,2
UGA,ZMB,2012.0,1,0,1
ZMB,UGA,2015.0,1,0,1
AUT,GAB,2014.0,1,0,1
HUN,SVN,2013.0,1,0,1
SVN,HUN,2014.0,2,0,2
FLK,,2023.0,5,0,5
USA,BRN,2011.0,2,0,2
SGP,MAC,2009.0,1,0,1
HTI,POL,2016.0,1,0,1
HND,SWE,2016.0,1,0,1
CHL,NOR,2007.0,2,0,2
SWE,SDN,2018.0,2,0,2
RUS,LUX,2017.0,1,0,1
KWT,IDN,2020.0,1,0,1
CZE,BIH,2021.0,2,0,2
,KIR,2012.0,2,0,2
PNG,FJI,2021.0,1,0,1
PSE,FIN,2012.0,2,0,2
TZA,PNG,2011.0,1,0,1
CAN,LBY,2016.0,2,0,2
BGR,CHE,2021.0,4,0,4
MNP,AUS,2016.0,1,0,1
LUX,MAC,2014.0,1,0,1
ISR,ZAF,2012.0,1,0,1
GAB,BFA,2019.0,1,0,1
GNQ,,2019.0,2,0,2
NGA,JAM,2020.0,1,0,1
ARG,SGP,2020.0,1,0,1
MTQ,,2026.0,1,0,1
ESP,DMA,2021.0,1,0,1
DMA,ESP,2022.0,1,0,1
ROU,CHL,2019.0,2,0,2
,SYC,2017.0,6,0,6
HND,NLD,2017.0,1,0,1
,MTQ,2013.0,7,0,7
LUX,IND,2020.0,2,0,2
PHL,IRL,2020.0,1,0,1
IRN,EST,2024.0,1,0,1
TZA,FJI,2022.0,1,0,1
PER,PRY,2022.0,1,0,1
NOR,CMR,2022.0,1,0,1
EGY,PRT,2022.0,1,0,1
POL,EGY,2019.0,2,0,2
ARG,SVK,2022.0,1,0,1
ROU,EGY,2016.0,1,0,1
NLD,VNM,1998.0,2,0,2
SAU,SGP,2004.0,1,0,1
SRB,CHL,2008.0,1,0,1
NZL,KAZ,2018.0,1,0,1
NPL,NOR,1999.0,1,0,1
TWN,MYS,2011.0,4,0,4
SWE,CYP,2012.0,1,0,1
JPN,CYP,2000.0,1,0,1
GBR,LUX,1999.0,1,0,1
BEL,PER,2010.0,1,0,1
USA,ETH,1998.0,4,0,4
CAN,PER,1998.0,1,0,1
TUR,UKR,2007.0,2,0,2
CHL,PRT,2001.0,1,0,1
PAK,HUN,2001.0,1,0,1
SGP,SAU,2005.0,1,0,1
MEX,PAK,2003.0,1,0,1
MEX,NIC,2012.0,2,0,2
GUF,MTQ,2016.0,2,0,2
,BMU,2009.0,5,0,5
GUY,GBR,2015.0,2,0,2
VNM,DNK,2014.0,3,0,3
AZE,SAU,2013.0,2,0,2
JPN,PAN,2012.0,2,0,2
PHL,SWE,2016.0,2,0,2
MKD,DEU,2021.0,3,0,3
ISL,ARE,2016.0,1,0,1
ZAF,COL,2012.0,1,0,1
ASM,FRA,2012.0,1,0,1
BRN,THA,2017.0,1,0,1
FRA,LBY,2023.0,1,0,1
IND,UZB,2019.0,1,0,1
FRA,SYC,2022.0,1,0,1
JPN,KGZ,2020.0,2,0,2
HKG,THA,2012.0,2,0,2
PHL,COL,2016.0,1,0,1
SSD,SLE,2022.0,1,0,1
SYR,LBN,2020.0,1,0,1
GBR,LBR,2016.0,1,0,1
JOR,AFG,2017.0,1,0,1
ITA,GRD,2023.0,1,0,1
RUS,SAU,2022.0,3,0,3
BEL,QAT,2020.0,1,0,1
CHE,PRI,2016.0,1,0,1
BEN,COD,2019.0,2,0,2
HRV,DNK,2018.0,5,0,5
SWE,MUS,2021.0,1,0,1
TWN,CRI,2017.0,1,0,1
NLD,PRK,2007.0,1,0,1
ZAF,SEN,2006.0,2,0,2
SLE,GBR,2002.0,1,0,1
AFG,HKG,2015.0,1,0,1
CHE,AFG,2018.0,1,0,1
MLT,IRL,2018.0,1,0,1
FLK,FRA,2016.0,1,0,1
CYP,SRB,2022.0,1,0,1
NCL,IDN,2019.0,2,0,2
PRT,BGR,2015.0,2,0,2
ECU,KOR,2018.0,1,0,1
GRC,BGD,2019.0,1,0,1
KAZ,UZB,2023.0,2,0,2
SWZ,TWN,2020.0,3,0,3
KAZ,DEU,2006.0,2,0,2
SWE,CUB,2022.0,1,0,1
CAN,SWE,2024.0,1,0,1
BLR,TUR,2022.0,1,0,1
MLI,CHE,2000.0,2,0,2
IND,SYR,2009.0,1,0,1
TLS,PHL,2007.0,1,0,1
,FLK,2004.0,2,0,2
JPN,CYP,2010.0,2,0,2
SLB,NZL,2008.0,1,0,1
EGY,PSE,2010.0,1,0,1
ATG,,2008.0,1,0,1
MOZ,SWZ,2022.0,1,0,1
THA,IND,2005.0,3,0,3
POL,SAU,2010.0,2,0,2
PAK,AFG,2011.0,2,0,2
ISL,SVK,2019.0,1,0,1
MKD,MNE,2014.0,3,0,3
MTQ,CAN,2006.0,1,0,1
JPN,DZA,2007.0,1,0,1
NZL,SVK,2016.0,1,0,1
RUS,OMN,2013.0,1,0,1
ARG,HRV,2005.0,1,0,1
VNM,PAN,2013.0,1,0,1
SGP,KAZ,2004.0,1,0,1
AFG,GBR,2010.0,1,0,1
BRA,MDG,2008.0,1,0,1
LTU,CHE,2009.0,1,0,1
LTU,IND,2014.0,1,0,1
POL,GRD,2008.0,1,0,1
GBR,BLZ,2003.0,1,0,1
SGP,CZE,2008.0,1,0,1
CHE,YEM,2016.0,1,0,1
YEM,CHE,2019.0,2,0,2
SGP,SAU,2012.0,3,0,3
ITA,CRI,2018.0,1,0,1
PRI,AUS,2014.0,1,0,1
CPV,USA,2012.0,1,0,1
CCK,AUS,2013.0,1,0,1
PSE,NOR,2014.0,1,0,1
VNM,KHM,2016.0,2,0,2
IOT,GBR,2013.0,1,0,1
GNQ,ESP,2017.0,1,0,1
MHL,,2023.0,6,0,6
DNK,KNA,2018.0,1,0,1
BTN,USA,2021.0,3,0,3
MDA,MKD,2017.0,2,0,2
PRY,CZE,2018.0,1,0,1
TLS,IDN,2013.0,1,0,1
SGP,KAZ,2015.0,2,0,2
BRN,IRL,2017.0,1,0,1
IRL,ISL,2016.0,1,0,1
IND,SLB,2020.0,1,0,1
BRA,ZMB,2017.0,1,0,1
QAT,ZAF,2017.0,2,0,2
PHL,COL,2018.0,1,0,1
,GLP,2015.0,3,0,3
CRI,SAU,2021.0,1,0,1
TJK,IND,2016.0,1,0,1
MLI,NER,2019.0,1,0,1
KOR,EST,2017.0,1,0,1
CHL,PRY,2007.0,2,0,2
AUT,URY,2022.0,1,0,1
FRA,FIN,2024.0,2,0,2
BFA,MLI,2005.0,4,0,4
MWI,IRL,2009.0,1,0,1
KEN,AGO,2021.0,1,0,1
ISL,BGD,2018.0,1,0,1
ZAF,ARG,2022.0,2,0,2
TJK,IND,2022.0,2,0,2
BES,NLD,2022.0,3,0,3
BGD,DNK,2005.0,1,0,1
BHS,AUS,2019.0,1,0,1
AUS,OMN,2001.0,1,0,1
ITA,STP,2021.0,1,0,1
,GUY,2020.0,10,0,10
GUY,UGA,2022.0,1,0,1
GRC,TUN,2015.0,1,0,1
MDA,GBR,2000.0,3,0,3
HUN,MKD,2011.0,1,0,1
URY,ARG,1999.0,1,0,1
ATG,,2001.0,1,0,1
DNK,ZMB,2002.0,1,0,1
CAN,COD,2012.0,1,0,1
IRL,MNG,2017.0,1,0,1
PAN,ECU,2008.0,1,0,1
DEU,YEM,2000.0,1,0,1
ERI,ETH,2016.0,1,0,1
IND,MAR,2010.0,1,0,1
GMB,DEU,2014.0,1,0,1
MNG,,2004.0,5,0,5
NIC,BEL,2006.0,2,0,2
PRT,AGO,1998.0,1,0,1
LKA,MLI,2007.0,1,0,1
CMR,TGO,2006.0,1,0,1
USA,MUS,2008.0,1,0,1
SVN,BIH,2005.0,1,0,1
NPL,ZAF,2020.0,1,0,1
CAN,BHS,2006.0,1,0,1
TUN,ZWE,2016.0,1,0,1
THA,ARG,2015.0,2,0,2
UKR,UZB,2002.0,1,0,1
CYP,NOR,2019.0,1,0,1
CHE,ARM,1999.0,1,0,1
NPL,NAM,2014.0,1,0,1
NAM,FJI,2018.0,1,0,1
BLZ,,2002.0,1,0,1
IRQ,NGA,2019.0,3,0,3
HRV,MKD,2006.0,3,0,3
AUT,GAB,2004.0,1,0,1
GAB,AUT,2009.0,1,0,1
,ABW,1998.0,2,0,2
HUN,SYR,2001.0,1,0,1
RUS,EST,2006.0,2,0,2
TUR,BMU,2001.0,1,0,1
NLD,JOR,2007.0,1,0,1
MCO,IRL,2020.0,1,0,1
BGR,DNK,2001.0,2,0,2
BGR,CHL,2001.0,1,0,1
BGR,ARE,2017.0,1,0,1
IDN,PNG,2009.0,3,0,3
CMR,SWE,2009.0,1,0,1
ESP,CMR,2012.0,1,0,1
VGB,GBR,2008.0,1,0,1
LIE,DEU,2009.0,2,0,2
ZAF,SWZ,2005.0,1,0,1
SVK,NOR,2013.0,1,0,1
BRN,,2011.0,5,0,5
LIE,GRC,2018.0,1,0,1
LUX,KEN,2008.0,1,0,1
SEN,DEU,2021.0,1,0,1
ESP,VNM,2006.0,1,0,1
SVK,BRA,2014.0,1,0,1
GRC,PAK,2011.0,1,0,1
DNK,NGA,2013.0,1,0,1
LVA,GBR,2014.0,1,0,1
KAZ,GEO,2022.0,1,0,1
MEX,IRN,2009.0,1,0,1
GAB,COD,2019.0,1,0,1
LBN,MCO,2009.0,1,0,1
VNM,ITA,2012.0,3,0,3
TZA,ETH,2016.0,2,0,2
GIN,MLI,2022.0,1,0,1
KGZ,DNK,2005.0,1,0,1
RUS,JOR,2020.0,1,0,1
KAZ,NZL,2017.0,1,0,1
GUF,GIN,2011.0,1,0,1
SLE,,2012.0,4,0,4
BEN,CIV,2014.0,1,0,1
CZE,NOR,2006.0,2,0,2
IND,NGA,2003.0,4,0,4
BGD,DNK,2002.0,1,0,1
BGD,NZL,2010.0,3,0,3
BGD,NOR,1998.0,2,0,2
CHN,LUX,2012.0,2,0,2
BMU,USA,2005.0,1,0,1
BDI,BEN,2022.0,1,0,1
AUS,CCK,2018.0,2,0,2
JPN,HND,2010.0,1,0,1
TTO,GHA,2003.0,1,0,1
BHR,FRA,2012.0,1,0,1
IRN,SVK,2019.0,5,0,5
KOR,BLR,2015.0,1,0,1
BIH,MKD,2021.0,1,0,1
MLT,,2026.0,6,0,6
ASM,ECU,2020.0,1,0,1
PNG,GIN,2022.0,2,0,2
GIN,PNG,2023.0,1,0,1
CYP,LBN,2023.0,3,0,3
PRI,PAK,2015.0,1,0,1
PHL,CZE,2019.0,2,0,2
VEN,SWE,2022.0,1,0,1
CHN,SLE,2023.0,1,0,1
KEN,SEN,2022.0,2,0,2
DEU,ARE,2003.0,3,0,3
UKR,GEO,2013.0,1,0,1
ZWE,JPN,2000.0,1,0,1
JOR,MEX,2020.0,1,0,1
MAR,ITA,2011.0,1,0,1
ARM,CZE,2000.0,1,0,1
BEL,MAR,1997.0,2,0,2
IND,CHL,2001.0,1,0,1
SWE,PAN,2002.0,1,0,1
VEN,SWE,2016.0,2,0,2
SGP,AUS,2024.0,2,0,2
KAZ,TUN,2023.0,1,0,1
MNE,USA,2000.0,2,0,2
NIU,NLD,2008.0,1,0,1
KEN,AUT,2001.0,2,0,2
BEL,LIE,2011.0,1,0,1
CAN,NAM,2002.0,1,0,1
LBN,GRC,2000.0,1,0,1
PSE,FRA,2005.0,2,0,2
JAM,NOR,2010.0,1,0,1
CIV,CHE,1999.0,1,0,1
NOR,ROU,1997.0,2,0,2
DEU,AZE,1997.0,1,0,1
ARG,PHL,2008.0,1,0,1
ALB,FRA,2004.0,1,0,1
NAM,ARG,2018.0,1,0,1
NZL,OMN,2011.0,1,0,1
PRT,PRI,2007.0,2,0,2
NLD,KHM,2017.0,2,0,2
ESP,COG,2018.0,3,0,3
IRN,ARM,2007.0,1,0,1
IDN,KOR,2008.0,1,0,1
MAR,IRN,2012.0,1,0,1
ARG,MOZ,2019.0,1,0,1
SVK,TWN,2016.0,1,0,1
AGO,MLI,2012.0,1,0,1
ITA,VNM,2011.0,1,0,1
ETH,NGA,2011.0,2,0,2
PRT,ECU,2015.0,4,0,4
NIC,ESP,2023.0,1,0,1
URY,NLD,2010.0,1,0,1
JAM,BHS,2007.0,1,0,1
BIH,DNK,2012.0,1,0,1
SEN,NGA,2011.0,1,0,1
MAR,MLT,2009.0,1,0,1
ZWE,DNK,2012.0,1,0,1
SVK,QAT,2015.0,2,0,2
CZE,SYR,2018.0,1,0,1
BFA,MEX,2017.0,1,0,1
ZAF,MLI,2018.0,2,0,2
KEN,SGP,2019.0,2,0,2
BLR,MEX,2008.0,1,0,1
GEO,UZB,2013.0,1,0,1
SVN,ISL,2014.0,1,0,1
TWN,ESP,2011.0,1,0,1
DZA,IRL,2013.0,1,0,1
UKR,ARM,2020.0,1,0,1
NGA,VNM,2019.0,1,0,1
THA,EGY,2011.0,1,0,1
BWA,ARE,2001.0,1,0,1
NLD,DMA,2015.0,1,0,1
PRI,ECU,2019.0,4,0,4
SLB,AUS,2000.0,3,0,3
BLR,CAN,2008.0,2,0,2
COG,ETH,2008.0,1,0,1
BGR,NZL,2008.0,2,0,2
BGR,BRA,2011.0,1,0,1
THA,SAU,2015.0,1,0,1
BFA,GIN,2006.0,1,0,1
BRA,SGP,2011.0,3,0,3
ZAF,URY,2015.0,1,0,1
SYR,IRQ,2013.0,1,0,1
HRV,CZE,2000.0,1,0,1
PSE,IRN,2017.0,2,0,2
AGO,HRV,2017.0,1,0,1
AGO,LBR,2016.0,1,0,1
KOR,LBY,2016.0,1,0,1
BRA,SUR,2013.0,1,0,1
HKG,CYP,2022.0,1,0,1
UKR,AUS,2017.0,1,0,1
BRA,UZB,2016.0,1,0,1
CHN,ECU,2016.0,1,0,1
MNG,FIN,2019.0,2,0,2
ALB,UZB,2021.0,1,0,1
THA,KAZ,2022.0,1,0,1
BFA,TUN,2021.0,1,0,1
ZAF,EST,2022.0,2,0,2
PER,GRC,2022.0,1,0,1
DZA,JPN,2022.0,2,0,2
DZA,KOR,2023.0,1,0,1
USA,AGO,2019.0,2,0,2
KOR,PRT,2005.0,1,0,1
CHN,CHL,1999.0,1,0,1
ARG,IRL,1999.0,1,0,1
BWA,ZMB,2019.0,1,0,1
BHR,BRN,1997.0,1,0,1
SPM,FRA,2020.0,1,0,1
NPL,LBR,2008.0,1,0,1
IND,PNG,1998.0,1,0,1
AUT,ISL,2001.0,1,0,1
SRB,VEN,2003.0,2,0,2
GBR,MMR,2000.0,1,0,1
NLD,OMN,2006.0,1,0,1
GUM,AUS,2002.0,1,0,1
MEX,SGP,2012.0,1,0,1
TCD,ZAF,2009.0,1,0,1
MAR,HUN,2010.0,1,0,1
COL,ECU,2007.0,1,0,1
SWZ,CHL,2012.0,1,0,1
NLD,LAO,2015.0,1,0,1
NLD,KWT,2016.0,1,0,1
JOR,UKR,2018.0,1,0,1
SVN,LBN,2018.0,1,0,1
MDG,MKD,2014.0,1,0,1
BIH,SVN,2009.0,3,0,3
DEU,ZWE,2012.0,1,0,1
AUS,SRB,2011.0,2,0,2
BGR,NZL,2015.0,1,0,1
UZB,CZE,2023.0,1,0,1
NPL,PAK,2005.0,2,0,2
LVA,FRA,2012.0,1,0,1
RWA,NLD,2012.0,2,0,2
BEL,URY,2019.0,1,0,1
LUX,FIN,2017.0,2,0,2
EGY,BGR,2021.0,1,0,1
IND,VEN,2000.0,1,0,1
HKG,COL,2009.0,1,0,1
LIE,USA,2009.0,2,0,2
BOL,PER,2008.0,1,0,1
CHE,BGD,2002.0,1,0,1
PRT,MUS,2008.0,2,0,2
PRI,FIN,2015.0,1,0,1
NER,USA,2020.0,3,0,3
KWT,ROU,2009.0,1,0,1
CRI,ESP,1998.0,3,0,3
HTI,COL,2019.0,1,0,1
SWZ,COG,2019.0,1,0,1
DEU,ETH,2001.0,6,0,6
FLK,,2010.0,1,0,1
LBY,IND,2005.0,2,0,2
COL,NOR,1999.0,1,0,1
SWE,PHL,2014.0,1,0,1
SEN,ZMB,2014.0,1,0,1
NZL,HRV,2012.0,1,0,1
ZAF,PSE,2007.0,1,0,1
NZL,CHL,1998.0,3,0,3
SLV,COL,2013.0,1,0,1
QAT,CUB,2008.0,1,0,1
DOM,ESP,2003.0,1,0,1
ARG,AGO,2001.0,1,0,1
THA,FIN,2009.0,1,0,1
ITA,TUN,2003.0,1,0,1
MEX,SRB,2005.0,2,0,2
USA,TLS,2019.0,2,0,2
HRV,GRC,2000.0,1,0,1
GRC,HRV,2002.0,2,0,2
CHE,LKA,2013.0,1,0,1
NLD,NGA,2003.0,1,0,1
CZE,NOR,2000.0,2,0,2
MYS,NGA,2004.0,1,0,1
ESP,AFG,2017.0,1,0,1
KWT,PHL,2010.0,1,0,1
IRL,DNK,2005.0,1,0,1
CHE,MLT,2023.0,1,0,1
RUS,MNG,2013.0,2,0,2
GEO,CAN,2008.0,1,0,1
CRI,RUS,2015.0,2,0,2
GBR,ARM,2002.0,1,0,1
AUT,MNG,2014.0,2,0,2
IRQ,CAN,2007.0,1,0,1
FRO,,2006.0,1,0,1
DOM,NLD,2000.0,2,0,2
LBY,IND,2002.0,1,0,1
PRI,CAN,2006.0,1,0,1
ZAF,CHN,2002.0,1,0,1
DNK,HUN,1999.0,1,0,1
AUT,BGD,2004.0,1,0,1
NIC,GBR,1997.0,1,0,1
NER,GHA,2010.0,1,0,1
OMN,NLD,2004.0,1,0,1
AUS,MNG,2004.0,1,0,1
DMA,USA,2007.0,1,0,1
RUS,SVK,2009.0,7,0,7
PRT,VEN,2016.0,1,0,1
CHE,VNM,2000.0,1,0,1
THA,KEN,2010.0,1,0,1
NOR,CHL,2008.0,1,0,1
LBY,CAN,2007.0,1,0,1
NCL,VUT,2011.0,1,0,1
SWE,BLR,2013.0,1,0,1
TUR,CMR,2014.0,1,0,1
GHA,EGY,2012.0,1,0,1
CUB,JAM,2016.0,1,0,1
BEL,MUS,2005.0,2,0,2
TUR,KWT,2022.0,5,0,5
TUN,MRT,2007.0,1,0,1
MWI,BEN,2008.0,1,0,1
GIN,COG,2022.0,1,0,1
ISL,SGP,2013.0,1,0,1
TGO,GBR,2011.0,1,0,1
NGA,JOR,2010.0,1,0,1
JAM,AUS,2005.0,1,0,1
BRN,IND,2016.0,1,0,1
TUR,PHL,2019.0,1,0,1
SRB,SAU,2016.0,1,0,1
HKG,SAU,2007.0,1,0,1
NER,NGA,2004.0,5,0,5
CZE,PRY,2009.0,1,0,1
NOR,LUX,2012.0,1,0,1
JOR,IND,2014.0,1,0,1
PAN,ARG,2022.0,1,0,1
CAN,HRV,2021.0,2,0,2
BEL,LKA,2012.0,1,0,1
,STP,2004.0,5,0,5
NZL,NCL,2010.0,2,0,2
TCD,COG,2015.0,1,0,1
,LCA,2008.0,2,0,2
ISL,LKA,2013.0,1,0,1
EGY,NZL,2017.0,3,0,3
PSE,MYS,2007.0,1,0,1
ROU,HKG,2009.0,1,0,1
UGA,COD,2018.0,1,0,1
,GIB,2009.0,2,0,2
BGR,EGY,2019.0,1,0,1
KAZ,EGY,2016.0,1,0,1
KOR,CYP,2011.0,1,0,1
,MDV,1995.0,1,0,1
KHM,MDG,2003.0,2,0,2
SDN,BHR,2011.0,1,0,1
MDA,USA,1998.0,2,0,2
IRN,EST,2023.0,4,0,4
SRB,BIH,1997.0,1,0,1
CIV,NGA,2012.0,1,0,1
ROU,IRL,2017.0,1,0,1
UKR,AUS,2016.0,4,0,4
MLT,MEX,2022.0,1,0,1
MEX,IRL,2005.0,3,0,3
,DMA,2011.0,3,0,3
PAK,TTO,2012.0,1,0,1
HTI,FRA,2016.0,2,0,2
UKR,ARE,2020.0,1,0,1
LUX,SWE,1997.0,1,0,1
COL,PRY,2020.0,1,0,1
NZL,PRT,2022.0,2,0,2
PRT,GNB,2019.0,3,0,3
CHL,PAN,2020.0,1,0,1
BLR,ITA,2019.0,1,0,1
USA,GNB,2020.0,1,0,1
COL,RUS,2022.0,1,0,1
,FLK,2015.0,2,0,2
CHL,CZE,2014.0,3,0,3
NZL,BMU,2019.0,1,0,1
BMU,NZL,2020.0,2,0,2
ESP,VNM,2023.0,2,0,2
LBN,ESP,2010.0,1,0,1
SVN,BHR,2019.0,1,0,1
IRN,GEO,2023.0,3,0,3
AUS,PRY,2022.0,1,0,1
IND,PRK,2018.0,1,0,1
AUS,PRY,2017.0,1,0,1
HND,SLV,2012.0,1,0,1
MYS,ZAF,2022.0,2,0,2
BEL,ZMB,2022.0,1,0,1
PAK,ROU,2020.0,1,0,1
GHA,MOZ,2021.0,1,0,1
,TON,2017.0,3,0,3
JPN,GIN,2012.0,3,0,3
MWI,PAK,2019.0,1,0,1
SWE,MLI,2012.0,2,0,2
CAN,NAM,1997.0,1,0,1
,LIE,1996.0,1,0,1
NGA,PRT,2023.0,1,0,1
BHS,,2018.0,6,0,6
LKA,COL,2023.0,1,0,1
IRQ,AZE,2023.0,1,0,1
SWE,LKA,2006.0,1,0,1
SGP,UKR,2022.0,1,0,1
CMR,KEN,2001.0,1,0,1
CZE,KWT,2001.0,1,0,1
DJI,CMR,2007.0,1,0,1
SEN,WLF,2016.0,1,0,1
PHL,OMN,2009.0,1,0,1
CYM,AUS,2001.0,1,0,1
ISR,LBN,2006.0,1,0,1
LBN,ESP,2000.0,1,0,1
LUX,ZAF,2012.0,1,0,1
IND,GRD,2009.0,1,0,1
MTQ,GLP,2005.0,1,0,1
BOL,GBR,2011.0,1,0,1
MMR,,2005.0,3,0,3
CHE,BIH,2001.0,1,0,1
TWN,CHE,2006.0,3,0,3
NZL,POL,2003.0,2,0,2
PNG,UGA,1998.0,1,0,1
LKA,LAO,2006.0,1,0,1
REU,,2007.0,1,0,1
KAZ,KGZ,2012.0,4,0,4
FRA,ISL,2003.0,2,0,2
SWE,JOR,2003.0,1,0,1
PHL,SYR,2012.0,1,0,1
SYR,PHL,2013.0,1,0,1
MYS,OMN,1998.0,2,0,2
THA,MEX,2001.0,1,0,1
CAN,MYS,1997.0,2,0,2
SWE,PAK,2006.0,2,0,2
CZE,VNM,2007.0,1,0,1
SAU,CYP,1997.0,1,0,1
PAN,AUS,2002.0,2,0,2
PYF,MEX,2002.0,2,0,2
AUS,LVA,2012.0,1,0,1
MEX,FIN,1998.0,1,0,1
NOR,SLE,2002.0,1,0,1
DEU,PSE,2000.0,1,0,1
KOR,NOR,2001.0,1,0,1
FIN,AGO,2013.0,2,0,2
SVN,CZE,2005.0,2,0,2
MTQ,IRL,2014.0,1,0,1
UKR,TUR,2011.0,2,0,2
IRL,HRV,1997.0,1,0,1
HUN,KOR,2004.0,1,0,1
BRA,MOZ,2001.0,1,0,1
JOR,MYS,2007.0,3,0,3
,SHN,2007.0,1,0,1
ARE,CHL,2016.0,1,0,1
BEL,KGZ,2015.0,1,0,1
BHR,ARE,2012.0,1,0,1
ARG,BWA,2011.0,1,0,1
SWZ,GBR,2013.0,1,0,1
KOR,HRV,2023.0,1,0,1
GUF,,2008.0,3,0,3
NOR,ROU,2012.0,2,0,2
GBR,VGB,2014.0,1,0,1
BFA,GAB,2012.0,2,0,2
CHN,PRK,2009.0,1,0,1
MYS,KHM,2008.0,1,0,1
SLB,AUS,2010.0,1,0,1
PAK,BRN,2015.0,1,0,1
NZL,FLK,2017.0,1,0,1
PAN,TUR,2022.0,1,0,1
GHA,NZL,2017.0,2,0,2
BLR,BRA,2020.0,1,0,1
FIN,HKG,1999.0,1,0,1
ABW,GUY,2014.0,1,0,1
TJK,CHN,2016.0,2,0,2
SSD,LBR,2018.0,1,0,1
NLD,ABW,2019.0,2,0,2
NLD,VEN,2019.0,1,0,1
ATG,CAN,2022.0,1,0,1
THA,KAZ,2016.0,1,0,1
PER,NGA,2016.0,1,0,1
PNG,FJI,2019.0,1,0,1
MRT,MLI,2017.0,1,0,1
,MNP,2012.0,2,0,2
ZMB,FRA,2020.0,1,0,1
BMU,,2000.0,1,0,1
AUS,TUN,2018.0,1,0,1
KAZ,TZA,2015.0,1,0,1
URY,BGR,2020.0,1,0,1
NER,CHN,2019.0,1,0,1
LBN,RWA,2021.0,1,0,1
SLE,TGO,2023.0,1,0,1
POL,PAN,2020.0,1,0,1
TGO,DEU,2021.0,1,0,1
GIN,NER,2023.0,1,0,1
BMU,,2010.0,6,0,6
FRA,GUY,2022.0,1,0,1
NGA,CHE,2014.0,2,0,2
TUN,DZA,2023.0,3,0,3
,SWZ,2020.0,6,0,6
IND,KAZ,2023.0,3,0,3
FJI,JPN,2023.0,1,0,1
AGO,VEN,2021.0,1,0,1
MSR,GBR,2008.0,3,0,3
MHL,ISL,2008.0,1,0,1
NAM,BRA,2021.0,2,0,2
BEL,KAZ,2016.0,1,0,1
NZL,OMN,2009.0,2,0,2
OMN,CHE,2016.0,1,0,1
CIV,ETH,2012.0,1,0,1
DJI,,2020.0,6,0,6
BGR,MKD,2010.0,1,0,1
NZL,MEX,2014.0,3,0,3
BTN,CAN,2008.0,1,0,1
MKD,NLD,2006.0,1,0,1
IRN,HRV,2014.0,1,0,1
NLD,ZWE,2007.0,1,0,1
IND,UGA,2015.0,2,0,2
TTO,CAN,2007.0,1,0,1
RUS,AGO,2009.0,1,0,1
FRA,CYP,2008.0,2,0,2
VUT,KHM,2013.0,1,0,1
IND,YEM,2008.0,1,0,1
NZL,BGD,2009.0,2,0,2
ALB,TUR,2014.0,1,0,1
VEN,ARG,2004.0,2,0,2
HTI,CAN,2007.0,2,0,2
GBR,SSD,2010.0,1,0,1
KOR,LAO,2007.0,1,0,1
VUT,NZL,2002.0,1,0,1
PAK,KAZ,2023.0,3,0,3
SVN,THA,2020.0,1,0,1
TCD,PAK,2020.0,1,0,1
BRN,CHN,2020.0,2,0,2
KOR,MAC,2006.0,1,0,1
PRI,ZAF,2016.0,1,0,1
MLI,SEN,2004.0,1,0,1
PRI,IRL,2007.0,1,0,1
ITA,MCO,2012.0,1,0,1
MCO,USA,2014.0,2,0,2
DEU,BWA,2009.0,1,0,1
GUF,GUY,2009.0,3,0,3
SYR,IND,2014.0,1,0,1
AFG,MYS,2011.0,1,0,1
ROU,CHE,1998.0,3,0,3
BHR,NZL,2020.0,1,0,1
GRD,,2010.0,2,0,2
BEL,CMR,2002.0,2,0,2
CHL,SRB,2004.0,1,0,1
LVA,ARG,2009.0,1,0,1
USA,LBY,2006.0,1,0,1
PAK,MOZ,2005.0,1,0,1
CZE,SRB,2023.0,1,0,1
TWN,ISL,2017.0,1,0,1
GBR,PNG,2016.0,1,0,1
AUT,CRI,2016.0,1,0,1
IRL,MYS,2004.0,4,0,4
NGA,SEN,2009.0,1,0,1
SWE,MLT,2011.0,1,0,1
,SWZ,1999.0,2,0,2
UGA,NLD,2005.0,2,0,2
QAT,KAZ,2021.0,1,0,1
BFA,ZAF,2007.0,1,0,1
SLE,GBR,1997.0,1,0,1
MYS,BRA,2013.0,1,0,1
EST,CZE,2003.0,1,0,1
HUN,ETH,2016.0,1,0,1
VNM,CHL,2010.0,1,0,1
ZWE,ZMB,1997.0,1,0,1
IDN,CMR,2014.0,1,0,1
FRA,JOR,2016.0,4,0,4
VEN,BOL,2015.0,2,0,2
AUS,IDN,2024.0,1,0,1
BOL,CHL,2012.0,1,0,1
TUN,ARE,2002.0,1,0,1
BLR,BOL,2011.0,1,0,1
NRU,,2016.0,1,0,1
PNG,BRA,2002.0,1,0,1
CHL,GRC,2019.0,1,0,1
JPN,FJI,2004.0,1,0,1
BHR,THA,2014.0,1,0,1
HKG,HUN,2021.0,1,0,1
KEN,NAM,2020.0,2,0,2
,TUV,2015.0,1,0,1
AGO,,2006.0,1,0,1
USA,FRO,2021.0,1,0,1
IRL,ECU,2021.0,1,0,1
ETH,HUN,2018.0,1,0,1
FIN,LVA,2012.0,1,0,1
COL,DNK,2022.0,2,0,2
,TKM,2017.0,1,0,1
KWT,USA,2024.0,1,0,1
SWE,PER,2018.0,1,0,1
SDN,,2026.0,5,0,5
GRC,BGD,2011.0,1,0,1
CZE,NPL,2015.0,1,0,1
TUN,BEL,2023.0,2,0,2
NLD,COD,2021.0,1,0,1
IND,PSE,2021.0,3,0,3
HRV,DNK,2022.0,1,0,1
ESP,CHL,2024.0,2,0,2
,CUW,2020.0,4,0,4
DZA,NGA,2023.0,1,0,1
DEU,LUX,2002.0,3,4,-1
NLD,COL,2008.0,4,1,3
LUX,SWE,2022.0,1,5,-4
ARE,NZL,2017.0,1,2,-1
TUR,BEL,2002.0,2,1,1
AUT,ARE,2020.0,1,2,-1
DEU,KEN,2001.0,3,2,1
POL,LTU,2008.0,2,2,0
MEX,CHN,2014.0,2,4,-2
CRI,MEX,2014.0,3,2,1
ROU,AUS,2011.0,3,5,-2
FRA,KEN,2013.0,4,3,1
SAU,TUR,2002.0,2,3,-1
UGA,USA,1999.0,3,9,-6
GMB,BEL,2007.0,2,1,1
USA,BFA,2011.0,3,3,0
NOR,CHL,2010.0,2,2,0
BRA,PRI,2007.0,1,1,0
ARG,SWE,2010.0,4,2,2
IND,SRB,2008.0,1,1,0
PER,TWN,2019.0,1,1,0
SGP,RUS,2002.0,1,1,0
PRT,MOZ,2002.0,2,1,1
SLV,SVN,2007.0,1,2,-1
ITA,CHL,2004.0,4,1,3
USA,GIN,2014.0,1,1,0
CHE,VNM,2001.0,1,2,-1
ARE,SGP,2011.0,1,6,-5
GRC,CZE,2011.0,3,1,2
NLD,CHL,2009.0,1,2,-1
EGY,AUS,2006.0,2,3,-1
GRL,DNK,1999.0,1,4,-3
CZE,HKG,2018.0,2,1,1
FIN,JPN,1999.0,4,9,-5
COL,PRI,2022.0,3,1,2
THA,NZL,2005.0,1,4,-3
GBR,BFA,2012.0,5,2,3
USA,SLE,2020.0,10,4,6
SDN,NGA,2021.0,2,1,1
ARE,JPN,2013.0,1,5,-4
IRL,RUS,2003.0,3,5,-2
EST,LVA,2017.0,3,2,1
IRQ,VNM,2020.0,2,1,1
MEX,NOR,2015.0,1,1,0
ZAF,ETH,2015.0,6,9,-3
DZA,MAR,2014.0,3,3,0
HUN,NZL,2017.0,1,1,0
CMR,ZAF,2012.0,2,4,-2
CHN,QAT,2016.0,1,3,-2
SWE,UGA,2013.0,3,1,2
HUN,ROU,2005.0,3,5,-2
SYR,GBR,2012.0,1,9,-8
JPN,TUN,2013.0,3,1,2
NOR,IRN,2016.0,6,8,-2
SYR,SAU,2014.0,5,1,4
TUR,BIH,2015.0,2,1,1
NLD,ECU,2023.0,1,1,0
ISR,ZAF,2017.0,3,4,-1
EGY,HUN,2016.0,1,6,-5
TUN,ARE,2016.0,4,3,1
CZE,CHN,2017.0,6,8,-2
IDN,NOR,2015.0,2,2,0
FIN,UGA,2019.0,1,1,0
FRA,PAK,2009.0,3,9,-6
IRN,RUS,2017.0,4,5,-1
ISR,TUR,2014.0,3,5,-2
PNG,GBR,2003.0,1,2,-1
MWI,CAN,2020.0,3,1,2
BEN,BEL,2014.0,1,3,-2
CHE,COL,2001.0,4,1,3
SAU,NZL,2015.0,3,1,2
FRA,BOL,2015.0,5,4,1
ISL,NLD,2021.0,3,3,0
CMR,IDN,2018.0,1,2,-1
RUS,NGA,2019.0,1,2,-1
MOZ,ESP,2006.0,2,2,0
ASM,USA,2022.0,1,6,-5
SGP,PRT,2022.0,3,2,1
FRA,BGD,2020.0,1,3,-2
EGY,MAR,2019.0,1,1,0
KWT,DEU,2004.0,2,3,-1
BEL,SRB,2020.0,4,2,2
LKA,SWE,2018.0,1,6,-5
RUS,MYS,2018.0,1,3,-2
MNE,DEU,2017.0,2,1,1
NIC,MEX,2016.0,2,1,1
GTM,CRI,2018.0,1,1,0
ITA,GEO,2011.0,1,2,-1
PAK,FRA,2015.0,5,31,-26
TWN,DNK,2017.0,2,4,-2
TWN,MAC,2021.0,2,2,0
MMR,IND,2023.0,2,1,1
TUR,BRA,2020.0,2,2,0
WSM,NZL,2020.0,1,1,0
IND,COL,2020.0,2,1,1
KEN,COG,2019.0,1,3,-2
COG,FRA,2021.0,1,7,-6
SWE,TZA,2020.0,6,10,-4
BFA,SEN,2020.0,4,6,-2
ROU,GRC,2018.0,3,7,-4
OMN,JOR,2022.0,4,3,1
BEN,GHA,2023.0,1,2,-1
TWN,ECU,2022.0,2,1,1
CHN,EST,2021.0,3,3,0
GNQ,USA,2022.0,2,5,-3
HKG,CZE,2023.0,1,2,-1
KOR,AZE,2022.0,1,1,0
RUS,SYR,2021.0,3,5,-2
CHL,ITA,2004.0,1,4,-3
PER,DEU,2006.0,2,3,-1
ZAF,DNK,2000.0,2,4,-2
AUS,PHL,1999.0,7,2,5
PAK,BGD,2001.0,5,3,2
BEL,VNM,2004.0,2,3,-1
MOZ,FRA,2015.0,1,2,-1
NOR,POL,2005.0,2,3,-1
SGP,SVN,2017.0,1,1,0
KAZ,ITA,2006.0,5,1,4
EGY,MYS,1999.0,1,2,-1
LVA,DEU,2005.0,6,4,2
PRI,COL,2009.0,3,1,2
MLT,GBR,2000.0,4,4,0
SWE,CUB,1997.0,1,1,0
NIC,USA,2002.0,1,11,-10
EGY,BRA,2003.0,1,1,0
CHE,COL,2014.0,3,6,-3
SEN,NCL,2006.0,1,1,0
SWE,NIC,1997.0,1,2,-1
NOR,MYS,2010.0,2,4,-2
TUR,FRA,2002.0,8,7,1
CAN,LUX,2022.0,4,2,2
CZE,IDN,2009.0,3,1,2
ZAF,SYC,2017.0,1,3,-2
LKA,NLD,2009.0,2,1,1
ECU,BRA,2009.0,3,3,0
IDN,NZL,2014.0,4,6,-2
CZE,HKG,2017.0,1,1,0
LKA,SGP,2015.0,2,1,1
MEX,JPN,2013.0,4,4,0
TWN,EGY,2015.0,1,2,-1
TTO,KNA,2013.0,2,1,1
PER,VEN,2018.0,1,4,-3
PRY,BRA,2017.0,3,7,-4
CHN,KAZ,2016.0,3,1,2
SYC,FRA,2015.0,1,2,-1
DEU,QAT,2015.0,5,3,2
POL,SGP,2019.0,4,3,1
MAR,SAU,2017.0,4,2,2
ROU,AUT,2001.0,3,5,-2
ARG,NOR,2022.0,3,1,2
ZAF,IRN,2006.0,2,1,1
UGA,LSO,2015.0,1,1,0
SVN,CHN,2018.0,2,1,1
NZL,BEL,2016.0,6,8,-2
FRA,UZB,2012.0,1,1,0
MUS,GBR,2012.0,2,1,1
GRC,HKG,2012.0,1,1,0
KOR,UZB,2017.0,2,3,-1
HUN,PRT,2011.0,2,1,1
GUM,USA,2015.0,4,5,-1
COD,CHE,2022.0,4,2,2
HKG,SWE,2007.0,3,1,2
FJI,USA,2013.0,1,2,-1
VEN,CHL,2001.0,1,1,0
NGA,GMB,2015.0,1,4,-3
EGY,LBN,2012.0,3,6,-3
GRC,TUR,2010.0,4,1,3
FIN,THA,2016.0,2,1,1
PER,COL,2016.0,4,6,-2
POL,NOR,2015.0,8,10,-2
IND,SYR,2013.0,1,1,0
UKR,CZE,1997.0,2,2,0
POL,CHL,2019.0,4,2,2
HKG,JOR,2015.0,2,2,0
JPN,HRV,2008.0,1,1,0
PRT,CPV,2020.0,3,1,2
NLD,CMR,2007.0,2,1,1
GBR,OMN,2002.0,5,6,-1
CHN,ZMB,2021.0,3,1,2
SEN,ESP,2019.0,1,3,-2
SAU,SGP,2023.0,3,2,1
CHN,KAZ,2018.0,1,4,-3
BEL,LTU,2022.0,1,1,0
CYP,NGA,2022.0,3,2,1
VNM,POL,2015.0,2,6,-4
THA,CHE,2008.0,4,4,0
KEN,ITA,2005.0,2,2,0
SWE,CHL,2006.0,2,1,1
FLK,GBR,2019.0,3,2,1
GBR,BWA,2002.0,2,4,-2
PRI,ESP,2007.0,3,4,-1
NZL,NOR,2005.0,1,2,-1
TUN,BEL,2004.0,3,2,1
PRT,THA,2018.0,1,1,0
UKR,ESP,1997.0,3,2,1
BHR,ARE,2018.0,3,1,2
KOR,NPL,2005.0,1,1,0
DEU,PSE,2008.0,3,6,-3
AUS,FJI,2005.0,4,4,0
ISR,UKR,2005.0,2,1,1
IDN,AUT,2013.0,1,3,-2
FRO,ISL,2019.0,3,1,2
RUS,SRB,2021.0,2,2,0
SVN,SLV,2012.0,1,7,-6
PRT,IRL,2008.0,8,1,7
IRL,SRB,2020.0,2,1,1
MWI,UGA,2011.0,2,2,0
UKR,CHE,2005.0,3,1,2
KEN,THA,2018.0,1,1,0
CZE,BLR,2017.0,2,1,1
MYS,LKA,2015.0,3,1,2
AUS,SRB,2013.0,2,2,0
LUX,GBR,2018.0,5,13,-8
MYS,BGD,2001.0,4,5,-1
SLB,AUS,2015.0,1,5,-4
CHN,LUX,2017.0,2,3,-1
SVN,SRB,2015.0,2,8,-6
UZB,DEU,2016.0,5,3,2
SWE,EST,2015.0,9,12,-3
SYC,ZAF,2022.0,2,1,1
CHN,JOR,2016.0,1,1,0
NLD,BGR,2018.0,3,2,1
LUX,GRC,2022.0,3,6,-3
BEL,GMB,1998.0,2,1,1
BEL,GMB,2007.0,1,2,-1
SWE,VNM,2014.0,9,2,7
LVA,CZE,2018.0,1,1,0
MAR,BEL,2019.0,7,3,4
DNK,ARG,2017.0,4,2,2
AUT,ARG,2013.0,3,1,2
AUT,EST,2013.0,2,1,1
SDN,DEU,2022.0,1,1,0
DEU,MDG,2016.0,2,3,-1
QAT,SAU,2019.0,5,26,-21
CUB,CHE,2021.0,1,1,0
SWE,TWN,1999.0,1,1,0
IDN,BEL,2018.0,2,7,-5
LVA,SWE,2009.0,1,7,-6
MEX,POL,2018.0,1,4,-3
POL,MEX,2019.0,2,5,-3
KAZ,ESP,2017.0,1,1,0
MLI,USA,2020.0,5,6,-1
ISL,AUT,2017.0,2,1,1
ESP,KWT,2023.0,1,4,-3
IRQ,ROU,2014.0,1,1,0
MYS,EGY,2010.0,1,7,-6
CPV,PRT,2016.0,2,4,-2
EGY,TWN,2016.0,2,4,-2
TWN,BEL,2023.0,2,3,-1
LVA,FIN,2021.0,1,1,0
ZAF,TWN,2018.0,2,1,1
CHE,LUX,2009.0,3,1,2
MLI,FRA,2018.0,6,8,-2
DOM,CHL,2007.0,1,1,0
CYP,PAK,2017.0,1,1,0
CAN,ZMB,2021.0,2,1,1
THA,LKA,2010.0,1,1,0
THA,GHA,2017.0,2,1,1
TZA,IND,1999.0,3,3,0
NZL,RUS,2023.0,1,1,0
HRV,RUS,2016.0,4,1,3
AUS,JAM,2013.0,1,1,0
ISL,GBR,2020.0,7,9,-2
BWA,ZWE,2012.0,1,3,-2
CAF,FRA,2003.0,2,7,-5
PRT,BGD,2020.0,3,1,2
AFG,PAK,2023.0,7,1,6
SWE,NLD,2024.0,1,1,0
CHN,IDN,2018.0,5,9,-4
NGA,RUS,2006.0,1,1,0
SVK,ESP,2007.0,1,3,-2
ETH,CHE,2023.0,1,1,0
BEL,UGA,2001.0,1,1,0
TUN,SAU,2006.0,2,1,1
HUN,BGR,2002.0,2,2,0
DJI,FRA,2004.0,2,3,-1
ETH,AUT,2012.0,3,5,-2
SAU,JOR,2009.0,5,17,-12
MNG,USA,2000.0,2,1,1
GUY,GUF,2006.0,1,1,0
JPN,ZMB,2007.0,2,1,1
ISR,BRA,2010.0,1,1,0
NOR,ISL,1998.0,2,3,-1
JPN,LTU,2005.0,2,1,1
VNM,FRA,2002.0,3,4,-1
CAN,UGA,2001.0,1,1,0
EST,FIN,2009.0,2,9,-7
ZWE,SWE,2017.0,3,1,2
AUT,ZAF,2006.0,2,3,-1
OMN,NLD,2000.0,2,1,1
AUS,NGA,2010.0,1,1,0
GBR,ARM,2017.0,2,3,-1
DEU,MYS,1999.0,2,1,1
JPN,HRV,2014.0,2,2,0
CZE,RUS,2000.0,7,11,-4
CHE,PAK,2021.0,2,8,-6
IRL,HUN,2018.0,2,5,-3
BDI,BEL,1997.0,1,1,0
ZMB,GBR,2007.0,3,1,2
SVK,AUT,1997.0,8,7,1
CYP,GRC,2002.0,3,9,-6
SVN,JPN,2001.0,3,1,2
THA,IRN,2022.0,4,5,-1
DEU,URY,2005.0,1,3,-2
USA,SWZ,2012.0,1,1,0
TGO,FRA,2006.0,2,5,-3
PRI,DEU,2016.0,1,2,-1
DEU,LTU,2012.0,5,7,-2
THA,SGP,2007.0,3,6,-3
CMR,BWA,2019.0,1,1,0
LKA,CAN,2013.0,4,3,1
SWE,ROU,2020.0,1,1,0
HUN,IRL,2011.0,2,1,1
ARG,PER,2015.0,2,2,0
CAN,TTO,2010.0,3,2,1
GBR,CIV,2020.0,1,1,0
DZA,DEU,2000.0,2,3,-1
JPN,SRB,2022.0,1,1,0
CIV,ITA,2020.0,1,1,0
LVA,GBR,2010.0,2,2,0
TWN,IRN,2015.0,2,2,0
SVN,NLD,2022.0,2,3,-1
THA,NOR,2011.0,2,1,1
SWE,LTU,2017.0,4,3,1
KOR,HKG,2008.0,2,8,-6
KNA,USA,2011.0,1,2,-1
HUN,UKR,2007.0,1,1,0
LUX,USA,2012.0,5,4,1
JPN,COL,2011.0,3,1,2
CHE,NZL,2010.0,7,8,-1
EGY,PAK,2017.0,5,1,4
TUN,ESP,2012.0,4,11,-7
FRA,GUY,2012.0,2,1,1
FRA,BDI,2016.0,1,1,0
AUS,GRC,2011.0,5,4,1
IRN,BEL,2008.0,2,8,-6
ARE,OMN,2015.0,1,3,-2
JPN,LBN,2017.0,1,1,0
CHL,CUB,2011.0,2,10,-8
LVA,GBR,2006.0,2,2,0
DNK,ESP,2000.0,6,9,-3
LUX,SWE,2018.0,1,2,-1
DEU,BGD,2007.0,2,3,-1
SWE,QAT,2017.0,2,3,-1
BGD,PHL,2005.0,2,1,1
SAU,JPN,2012.0,3,13,-10
NIC,GBR,2022.0,1,2,-1
SLV,ARG,2012.0,1,1,0
GBR,TUN,2013.0,1,2,-1
DEU,BIH,2008.0,3,2,1
JPN,PAK,2000.0,5,2,3
BLR,ITA,2003.0,2,2,0
MEX,ETH,2005.0,1,1,0
PRT,AUS,2013.0,10,3,7
PER,PRI,2004.0,1,1,0
ARG,BOL,2012.0,1,1,0
CAN,ROU,2003.0,3,7,-4
USA,BMU,2004.0,2,1,1
POL,GRC,2014.0,2,4,-2
SWE,UKR,2021.0,6,9,-3
RUS,SVK,2003.0,2,5,-3
JOR,NZL,1999.0,1,1,0
MNG,JPN,2005.0,3,2,1
TZA,NLD,1998.0,1,1,0
SWE,HRV,2018.0,1,8,-7
ZWE,NLD,2005.0,3,1,2
FRA,MYS,2017.0,7,11,-4
KWT,TUR,2023.0,1,6,-5
BRA,PER,2002.0,4,1,3
RUS,SVN,2012.0,1,2,-1
BIH,FRA,2013.0,2,1,1
ESP,SVK,1997.0,1,1,0
PHL,IDN,1997.0,1,1,0
NLD,ARG,2009.0,3,8,-5
PSE,USA,2004.0,1,2,-1
LTU,USA,2015.0,5,8,-3
GRC,ESP,1998.0,1,3,-2
CYP,ITA,2018.0,3,2,1
LTU,USA,2014.0,6,9,-3
BGR,HRV,2020.0,1,1,0
TUN,GBR,2013.0,2,1,1
KHM,FRA,2008.0,2,2,0
LTU,ITA,2003.0,2,2,0
DNK,THA,2015.0,4,1,3
USA,LVA,2013.0,2,1,1
BRA,FIN,2010.0,2,2,0
KOR,QAT,2012.0,1,1,0
BEL,COL,2011.0,3,4,-1
JPN,PER,2015.0,3,3,0
USA,BHR,2022.0,2,1,1
NGA,CAN,2009.0,1,2,-1
HRV,SVK,2014.0,4,2,2
YEM,DEU,2020.0,1,1,0
SAU,SYR,2016.0,2,2,0
BEL,LTU,2018.0,7,4,3
BLZ,USA,2020.0,1,3,-2
SAU,QAT,2009.0,4,2,2
YEM,GBR,2017.0,3,1,2
UGA,GBR,2011.0,7,12,-5
ESP,NIC,2020.0,2,2,0
ITA,TUN,2011.0,2,4,-2
NOR,AUT,2015.0,5,11,-6
SGP,NOR,2008.0,6,4,2
UGA,ETH,2020.0,4,1,3
TUN,PRT,2018.0,4,4,0
ZAF,COL,2016.0,2,2,0
IND,ROU,2018.0,3,3,0
IDN,GBR,2010.0,3,18,-15
SGP,NLD,2003.0,3,4,-1
GRC,ISR,2015.0,2,1,1
ISR,GRC,2016.0,2,3,-1
VEN,AUS,2019.0,2,2,0
EGY,IND,2005.0,4,1,3
SRB,FRA,2014.0,4,4,0
NZL,KOR,2015.0,5,2,3
SAU,AUS,2003.0,2,1,1
SAU,BEL,2021.0,2,5,-3
JOR,DEU,2014.0,4,16,-12
TUR,CAN,1998.0,2,9,-7
JPN,ISR,1998.0,5,3,2
UKR,KOR,2016.0,1,2,-1
ITA,SVK,1998.0,3,4,-1
CAN,OMN,2002.0,3,4,-1
DMA,DOM,2019.0,2,1,1
AUS,SLB,2021.0,4,1,3
BGR,GRC,2000.0,1,11,-10
VEN,FRA,2017.0,5,2,3
NER,GBR,2007.0,1,1,0
GBR,SLE,2020.0,1,5,-4
KWT,IND,2011.0,4,7,-3
RUS,GRC,2019.0,2,2,0
POL,GRC,2004.0,1,3,-2
COL,ARM,2017.0,3,2,1
IRQ,TUN,2019.0,1,1,0
IRL,VNM,2021.0,1,2,-1
MOZ,SWE,2019.0,1,3,-2
CPV,PRT,2018.0,2,1,1
EST,LVA,2016.0,2,7,-5
CAN,CMR,2016.0,3,1,2
POL,LTU,2015.0,3,2,1
ECU,COL,2013.0,2,1,1
NLD,HRV,2014.0,1,5,-4
NCL,AUS,2016.0,3,2,1
MEX,SWE,2023.0,4,8,-4
ISR,URY,2019.0,1,3,-2
LBY,MYS,2019.0,3,20,-17
YEM,MYS,2021.0,6,32,-26
AFG,IRN,2022.0,3,5,-2
PRT,PAK,2022.0,3,2,1
EGY,DZA,2022.0,5,1,4
BEL,BGR,2023.0,1,2,-1
GHA,DEU,2006.0,1,4,-3
BWA,NZL,2004.0,1,1,0
KOR,BEL,2003.0,1,6,-5
FLK,GBR,2021.0,3,4,-1
LKA,USA,2014.0,6,20,-14
SDN,USA,1997.0,2,2,0
GNQ,ESP,2005.0,2,3,-1
BEL,BGR,2000.0,4,6,-2
HUN,ROU,1997.0,1,1,0
KWT,PAK,2007.0,2,1,1
TUR,IND,2002.0,2,9,-7
TTO,USA,2007.0,3,5,-2
USA,TTO,2014.0,6,6,0
SAU,ROU,2023.0,1,2,-1
NLD,MYS,2001.0,1,2,-1
BRN,AUS,2011.0,3,1,2
TWN,HKG,2007.0,6,4,2
PSE,ZAF,2017.0,1,1,0
MWI,DEU,2013.0,2,2,0
SDN,KOR,2014.0,3,2,1
DEU,GAB,2021.0,1,7,-6
CZE,IDN,2019.0,1,2,-1
GBR,BWA,2012.0,4,1,3
GMB,USA,2012.0,1,1,0
SWE,CHL,2023.0,1,3,-2
PER,SWE,2019.0,1,2,-1
FRA,LBY,2015.0,2,1,1
GBR,MOZ,2020.0,1,2,-1
CHN,RWA,2016.0,3,1,2
ARE,SGP,2019.0,2,3,-1
BIH,ITA,2017.0,1,1,0
GBR,MDG,2015.0,2,1,1
COL,NLD,2013.0,5,9,-4
ROU,SVN,2021.0,1,1,0
ZMB,MWI,2017.0,1,3,-2
CHE,NZL,2023.0,2,10,-8
BEL,BEN,2012.0,4,2,2
TZA,FIN,2013.0,1,3,-2
ETH,PAK,2021.0,1,1,0
BEL,HUN,2010.0,4,6,-2
ARG,PER,2008.0,1,2,-1
CHN,AFG,2017.0,1,2,-1
CHN,EST,2019.0,3,1,2
GBR,CUB,2017.0,1,2,-1
KOR,NOR,2010.0,4,3,1
FIN,ZAF,2020.0,3,5,-2
BEL,SAU,2000.0,1,1,0
CAN,ECU,2003.0,1,3,-2
POL,NOR,2004.0,1,2,-1
DEU,THA,1999.0,2,3,-1
CHL,PER,2005.0,4,2,2
GLP,GUF,2004.0,1,1,0
UGA,SWE,2020.0,2,2,0
NOR,LTU,1999.0,1,2,-1
CRI,DEU,1997.0,1,1,0
HUN,ITA,2004.0,5,5,0
RUS,IND,2007.0,1,2,-1
JPN,LAO,2002.0,1,2,-1
IND,IDN,2001.0,1,8,-7
ZAF,SDN,2010.0,1,1,0
MEX,NLD,2006.0,4,4,0
ISR,MEX,2007.0,4,2,2
CHE,NGA,2013.0,2,1,1
EST,BEL,2004.0,1,1,0
KOR,HKG,2001.0,2,5,-3
GRC,ISR,2008.0,2,2,0
BEL,CIV,2006.0,3,1,2
RUS,AZE,2021.0,4,4,0
MYS,KWT,2023.0,2,1,1
NLD,SVN,1998.0,1,2,-1
USA,BMU,2008.0,1,3,-2
ZMB,GBR,1998.0,2,4,-2
NOR,COL,2008.0,1,2,-1
CAN,LBY,2012.0,1,1,0
SWE,ETH,2005.0,4,2,2
GEO,CAN,2010.0,1,1,0
HUN,ROU,2002.0,2,1,1
AUS,BGR,2011.0,2,1,1
QAT,PSE,2022.0,2,1,1
ZAF,SAU,2009.0,5,7,-2
CYP,USA,2005.0,5,23,-18
BLZ,USA,1998.0,2,1,1
ERI,IND,2010.0,2,2,0
EST,NLD,2003.0,1,2,-1
CHL,SWE,2007.0,2,2,0
FRA,CUB,1998.0,1,1,0
BRA,PAN,2007.0,2,1,1
PRI,ESP,1999.0,1,2,-1
USA,RWA,2018.0,11,15,-4
USA,GTM,1999.0,5,2,3
COL,PER,2003.0,2,1,1
USA,JAM,2005.0,3,6,-3
GBR,KGZ,2005.0,1,1,0
BRA,SRB,2003.0,3,1,2
MYS,NLD,2001.0,2,1,1
AUS,ARG,2006.0,2,4,-2
EGY,IRL,2001.0,1,1,0
CHL,ZAF,2018.0,4,1,3
ECU,DEU,2003.0,1,1,0
IND,PHL,2008.0,3,4,-1
CAN,BRB,2014.0,2,4,-2
MNG,DEU,2004.0,1,1,0
TUR,KOR,2009.0,2,1,1
QAT,SDN,2020.0,1,1,0
QAT,TUN,2018.0,3,2,1
GHA,KEN,2014.0,2,2,0
IRQ,ITA,2016.0,1,1,0
BEL,ARG,2014.0,6,5,1
ARG,BEL,2015.0,3,1,2
ITA,SMR,2020.0,8,3,5
NLD,TUN,2006.0,2,1,1
CZE,AUS,2010.0,4,1,3
JPN,KWT,2007.0,2,1,1
SGP,VNM,2011.0,4,2,2
FIN,NZL,2007.0,1,3,-2
RUS,MEX,2014.0,5,2,3
PRT,SVK,2012.0,1,1,0
SVK,PRT,2013.0,1,1,0
LIE,CHE,2007.0,3,1,2
MAR,BEL,2011.0,1,10,-9
AUS,OMN,2006.0,2,4,-2
PER,BRA,2007.0,2,4,-2
LBN,QAT,2012.0,4,1,3
AUT,EGY,2014.0,3,1,2
DEU,TUN,2008.0,2,1,1
NIC,ESP,2004.0,1,2,-1
LBN,ITA,2007.0,2,3,-1
LUX,POL,2022.0,1,2,-1
ESP,PRI,2003.0,1,1,0
OMN,MYS,2008.0,1,2,-1
IRL,LKA,2022.0,1,1,0
DEU,PSE,2014.0,4,3,1
CAN,MWI,2016.0,3,1,2
BIH,GBR,2013.0,1,2,-1
GRC,ISR,2014.0,3,3,0
ISR,GRC,2017.0,1,1,0
BRA,ECU,2010.0,2,3,-1
CHE,CHL,2008.0,2,6,-4
BHR,SAU,2012.0,1,1,0
VNM,THA,2011.0,2,6,-4
IDN,SGP,2012.0,2,4,-2
HUN,KOR,2023.0,2,1,1
NOR,IRL,2008.0,2,4,-2
TUR,GRC,2008.0,1,1,0
TUR,GRC,2015.0,2,1,1
SWE,URY,2002.0,2,1,1
CZE,EST,2020.0,1,2,-1
GEO,DEU,2008.0,4,7,-3
THA,VNM,2003.0,2,1,1
HKG,NZL,2008.0,1,5,-4
ZAF,BRA,2015.0,2,8,-6
KOR,IRL,2000.0,1,1,0
SVK,SRB,2017.0,1,2,-1
BIH,CHE,2021.0,1,1,0
BEL,SVK,2001.0,3,4,-1
HRV,SVK,2015.0,3,1,2
BHS,CAN,2018.0,1,1,0
EGY,TUR,2015.0,1,1,0
HRV,CZE,2014.0,1,2,-1
CZE,MEX,2007.0,3,1,2
ITA,NZL,2022.0,3,8,-5
NZL,ESP,2015.0,2,10,-8
ESP,SVN,2023.0,4,3,1
SVN,MEX,2017.0,1,1,0
TWN,UKR,2016.0,2,2,0
PER,MEX,2003.0,1,2,-1
ITA,MEX,2007.0,9,3,6
BIH,USA,2004.0,1,2,-1
USA,BIH,2006.0,5,4,1
NGA,CMR,2008.0,1,2,-1
IND,NER,2017.0,1,1,0
BRA,JAM,2021.0,1,1,0
SRB,MYS,2019.0,1,1,0
MAR,TUR,2020.0,2,2,0
HKG,RUS,2022.0,2,8,-6
NLD,MWI,2021.0,8,1,7
CAN,SVK,2019.0,1,1,0
CAN,CMR,2018.0,2,5,-3
ARG,PER,2014.0,1,2,-1
ITA,SVK,2020.0,3,5,-2
CRI,FRA,2019.0,4,6,-2
KWT,DZA,2018.0,1,1,0
IRQ,IRL,2018.0,1,2,-1
TUR,POL,2018.0,3,3,0
USA,VNM,2001.0,3,6,-3
ISR,CYP,2019.0,1,1,0
GBR,BOL,2020.0,1,1,0
HKG,ARE,2018.0,2,1,1
LBN,MYS,2020.0,1,1,0
USA,SLV,2023.0,2,1,1
SVN,CZE,2016.0,2,1,1
VNM,HUN,2022.0,3,3,0
TUR,KAZ,2009.0,1,2,-1
RWA,NGA,2020.0,3,3,0
GRC,SVK,2021.0,3,3,0
IDN,COL,1999.0,1,1,0
AUT,EGY,2001.0,2,3,-1
GIN,FRA,2011.0,1,3,-2
BRN,IND,2012.0,1,2,-1
BEL,LBN,2023.0,3,3,0
ISR,LBN,2015.0,1,1,0
CMR,SEN,2012.0,1,1,0
IRL,SWE,2006.0,1,11,-10
RUS,PRT,2005.0,2,3,-1
URY,BRA,2005.0,1,3,-2
UKR,MEX,2018.0,1,1,0
BEL,SVK,2008.0,1,2,-1
NLD,SAU,2003.0,1,1,0
TUR,BGR,2006.0,1,1,0
ARG,AUT,2000.0,2,1,1
BEL,SAU,2006.0,1,1,0
URY,USA,1997.0,3,6,-3
CRI,FRA,2011.0,2,3,-1
DNK,SVK,1998.0,3,2,1
SAU,NLD,2006.0,1,3,-2
ZWE,ZMB,2018.0,1,2,-1
LKA,OMN,2017.0,1,1,0
BHR,EGY,2015.0,3,3,0
PSE,USA,2001.0,3,1,2
ZWE,ISR,1997.0,1,1,0
VEN,PRT,2005.0,2,1,1
NZL,DNK,1999.0,3,3,0
ITA,LTU,2016.0,2,3,-1
UKR,BRA,2000.0,3,3,0
UZB,BEL,1997.0,1,1,0
AUT,GRC,2001.0,2,2,0
CHE,TZA,2012.0,1,4,-3
BLR,SWE,2008.0,1,1,0
MDA,DEU,2012.0,6,4,2
HUN,SRB,1997.0,2,1,1
COL,LAO,2012.0,1,1,0
USA,ALB,2009.0,4,2,2
SHN,GBR,2017.0,1,2,-1
BGR,AUS,2017.0,1,1,0
TUR,KGZ,2013.0,2,3,-1
POL,JPN,2012.0,6,18,-12
OMN,IRQ,2019.0,1,1,0
ETH,SWE,2012.0,1,3,-2
NOR,PRT,2019.0,2,16,-14
NGA,GUY,2022.0,1,1,0
TUN,BEL,2015.0,3,2,1
OMN,AUS,2017.0,3,5,-2
GRC,CZE,2021.0,6,3,3
NCL,CAN,2016.0,1,1,0
IND,KEN,2018.0,4,3,1
CZE,JPN,2014.0,6,9,-3
MAC,AUS,2007.0,1,1,0
USA,BMU,2014.0,2,5,-3
BEL,PAK,2018.0,5,8,-3
BGD,NPL,2006.0,1,1,0
IRQ,LBY,2016.0,1,3,-2
CHL,AUT,2010.0,1,3,-2
SRB,SVK,2016.0,2,1,1
IRL,ISL,2012.0,1,1,0
ARE,CHN,2012.0,1,4,-3
UGA,NLD,2018.0,4,1,3
LBN,EGY,2011.0,4,3,1
LTU,DNK,2012.0,3,4,-1
NZL,PAK,2008.0,1,2,-1
SVN,CZE,2022.0,4,3,1
NER,BEL,2021.0,1,1,0
ISL,SWE,2009.0,6,12,-6
JPN,EST,2017.0,2,1,1
ZMB,USA,2019.0,7,25,-18
COL,NZL,2011.0,2,2,0
CHE,HRV,2020.0,1,6,-5
BRA,KOR,2012.0,2,2,0
RUS,EGY,2010.0,2,1,1
BMU,USA,2016.0,2,1,1
IRN,DZA,2016.0,1,2,-1
PAK,AUS,2006.0,3,2,1
GIN,FRA,2021.0,2,3,-1
SAU,QAT,2011.0,1,2,-1
BOL,DEU,2012.0,1,4,-3
MMR,MYS,2016.0,1,1,0
KOR,KAZ,2016.0,3,1,2
TUR,DZA,2016.0,2,4,-2
NLD,PHL,2022.0,3,2,1
OMN,JPN,2017.0,1,3,-2
ZAF,CMR,2023.0,7,4,3
BMU,GBR,2019.0,1,3,-2
LVA,FIN,2019.0,1,1,0
USA,GAB,2020.0,3,11,-8
COL,BEL,2002.0,1,2,-1
CHL,FIN,2019.0,6,1,5
MUS,ZAF,2023.0,1,2,-1
EGY,IRN,2020.0,2,3,-1
BFA,MLI,2022.0,3,2,1
SGP,BGD,2021.0,2,1,1
PAK,MYS,2003.0,1,2,-1
PRI,PRT,2022.0,3,1,2
CYP,BEL,2021.0,2,2,0
MKD,SRB,2023.0,2,6,-4
SYR,IRQ,2021.0,1,1,0
AZE,GBR,2020.0,2,1,1
HRV,QAT,2022.0,1,3,-2
KOR,MEX,2015.0,1,3,-2
IRN,CHE,2008.0,7,1,6
IDN,MYS,2008.0,1,12,-11
TUR,GRC,2014.0,1,10,-9
MNG,KOR,2007.0,1,1,0
ROU,SWE,2005.0,3,4,-1
FRA,DJI,2013.0,1,6,-5
UGA,IND,2020.0,1,1,0
DZA,KOR,2015.0,1,1,0
NZL,TUR,2010.0,1,1,0
CZE,ISR,2010.0,1,2,-1
NPL,CAN,2017.0,2,2,0
ECU,CHL,2009.0,1,1,0
DEU,GAB,2019.0,4,4,0
GBR,NPL,2012.0,2,6,-4
NOR,ZMB,2011.0,2,1,1
JPN,SDN,2015.0,2,1,1
IDN,SGP,2005.0,2,2,0
FIN,CHL,2018.0,3,5,-2
TWN,CZE,2022.0,3,1,2
CHN,RUS,1997.0,2,4,-2
SGP,ITA,2006.0,2,2,0
MAR,CAN,2010.0,1,15,-14
SEN,CAF,2014.0,2,1,1
IND,VEN,2014.0,1,1,0
MUS,GBR,2005.0,2,1,1
PRT,VEN,2005.0,1,2,-1
KEN,NGA,2023.0,2,4,-2
BHS,USA,2007.0,1,1,0
NLD,SUR,2011.0,1,1,0
DZA,GBR,2008.0,3,2,1
LBN,ARE,2019.0,2,4,-2
CHE,PHL,2012.0,2,3,-1
ZWE,BWA,2009.0,1,1,0
SAU,SRB,2020.0,1,5,-4
UGA,ITA,2014.0,4,2,2
THA,NGA,2023.0,4,6,-2
VNM,CHE,2017.0,2,4,-2
CHE,ETH,2021.0,5,3,2
PRY,USA,2022.0,3,4,-1
GBR,IND,2024.0,2,3,-1
NPL,MYS,2009.0,1,1,0
ZAF,CHL,2020.0,1,2,-1
CHL,ZAF,2022.0,2,2,0
MEX,RUS,2008.0,2,4,-2
SGP,THA,2000.0,2,1,1
CAN,MAC,2005.0,1,1,0
ETH,MYS,2011.0,1,1,0
AUT,FIN,2004.0,2,2,0
NER,FRA,2005.0,1,3,-2
IRL,FIN,2012.0,4,2,2
POL,ISR,1999.0,2,3,-1
SVN,SRB,2001.0,1,1,0
BRA,CZE,1998.0,1,2,-1
SVK,BLR,2000.0,1,2,-1
PRT,RUS,2008.0,2,9,-7
BWA,NAM,2017.0,1,1,0
AUS,AFG,2015.0,1,2,-1
MYS,EGY,2006.0,1,2,-1
EGY,MYS,2007.0,1,3,-2
SGP,VNM,2009.0,1,1,0
ZAF,PAK,2002.0,1,2,-1
CHN,NZL,1997.0,2,2,0
CRI,CHL,2000.0,2,1,1
MWI,JPN,2002.0,1,2,-1
GRD,USA,2003.0,1,2,-1
KOR,COL,2015.0,1,2,-1
IND,ARE,2003.0,2,1,1
ZWE,ETH,2006.0,1,2,-1
TUN,ITA,2002.0,2,2,0
IND,SRB,2015.0,2,2,0
DOM,DMA,2016.0,1,6,-5
CUB,ARG,2001.0,3,4,-1
HKG,DNK,2000.0,2,1,1
URY,SWE,2014.0,1,1,0
VNM,SWE,2009.0,1,2,-1
GBR,PAN,2012.0,1,1,0
UGA,ITA,2015.0,1,2,-1
ASM,USA,2017.0,1,2,-1
HKG,TWN,2000.0,5,1,4
ISR,ISL,2018.0,1,1,0
MLT,SWE,2014.0,1,1,0
ARM,KOR,2012.0,1,1,0
RWA,IND,2011.0,2,1,1
KEN,ZMB,2017.0,2,4,-2
CAN,ZAF,2004.0,9,10,-1
GUY,GUF,2010.0,1,1,0
BGR,ZAF,2014.0,1,1,0
ISR,ARG,1998.0,1,4,-3
NZL,NCL,2014.0,1,1,0
CHN,CUB,2023.0,2,3,-1
DNK,LTU,1997.0,1,1,0
BRA,VEN,2010.0,1,3,-2
POL,HRV,2019.0,1,3,-2
GRC,SVK,2009.0,3,1,2
KAZ,KGZ,2022.0,2,7,-5
ZAF,MUS,2022.0,1,1,0
MEX,NIC,2016.0,1,2,-1
QAT,ITA,2018.0,2,5,-3
BFA,GBR,2014.0,1,1,0
KEN,ITA,2002.0,1,1,0
BRA,PAN,2020.0,3,1,2
EGY,TWN,2018.0,2,3,-1
RUS,TJK,2001.0,2,4,-2
DNK,BGD,2021.0,3,4,-1
ESP,SVN,2006.0,3,1,2
POL,LUX,2022.0,2,1,1
UKR,CZE,2002.0,3,1,2
KOR,GRC,2017.0,1,4,-3
JPN,GUM,2019.0,1,1,0
MLI,SEN,2010.0,2,3,-1
SDN,CHN,2023.0,1,6,-5
BGD,DEU,2008.0,4,2,2
VUT,NZL,2016.0,1,1,0
NOR,EGY,2011.0,1,1,0
VEN,ITA,2018.0,5,2,3
JOR,ITA,2017.0,1,6,-5
HRV,BRA,2019.0,1,1,0
BGD,FRA,2020.0,3,1,2
SMR,ITA,2020.0,3,8,-5
QAT,RUS,2020.0,1,1,0
NOR,LUX,2018.0,2,2,0
ARE,FRA,2021.0,6,30,-24
ISL,ITA,2021.0,4,1,3
CYP,DEU,2019.0,2,7,-5
MKD,RUS,2018.0,1,1,0
IRN,BGD,2016.0,1,1,0
IDN,ESP,2019.0,1,2,-1
VNM,CHE,2018.0,2,4,-2
NLD,BGR,2016.0,3,1,2
ISL,CHE,2023.0,2,3,-1
GEO,CHN,2020.0,3,1,2
EGY,MAR,2011.0,1,2,-1
DNK,LBN,2023.0,1,2,-1
AUS,NGA,2023.0,5,8,-3
SOM,MYS,2023.0,1,1,0
GHA,RWA,2023.0,1,1,0
MWI,FRA,2009.0,2,1,1
IRQ,IND,2017.0,2,14,-12
LVA,LTU,2014.0,4,3,1
GRC,TWN,2017.0,1,1,0
NLD,PHL,2017.0,2,4,-2
LVA,CAN,2014.0,1,1,0
ITA,GHA,2016.0,3,1,2
ZWE,COG,2008.0,2,2,0
SAU,MAR,2023.0,1,2,-1
VEN,ITA,2016.0,4,7,-3
AUT,LVA,2016.0,2,1,1
NZL,KEN,2003.0,1,2,-1
GBR,NAM,2006.0,1,2,-1
DNK,VNM,2003.0,2,1,1
SAU,SWE,2006.0,2,4,-2
GRC,FIN,2005.0,1,2,-1
HUN,NOR,2002.0,2,6,-4
VEN,RUS,2012.0,1,1,0
PHL,CAN,2003.0,3,1,2
MAR,BEN,2019.0,1,1,0
CUB,SWE,2009.0,1,2,-1
IDN,PHL,2015.0,1,2,-1
BEL,ARG,2015.0,1,3,-2
BRB,USA,2017.0,4,2,2
FRA,HTI,2013.0,1,1,0
RUS,CUB,2017.0,1,2,-1
TCD,FRA,2012.0,1,2,-1
BGR,MKD,2008.0,1,1,0
GBR,RWA,2012.0,3,1,2
ISR,NOR,2007.0,2,2,0
GBR,JAM,2005.0,2,3,-1
GBR,SLE,2007.0,1,1,0
GTM,USA,1998.0,3,1,2
IND,GRD,2013.0,1,1,0
AUS,PRI,2004.0,1,1,0
BEN,TGO,2012.0,2,3,-1
CHE,TUN,2008.0,2,3,-1
DEU,URY,2012.0,1,1,0
SYR,GBR,2002.0,1,1,0
RUS,ZAF,2017.0,4,115,-111
CHN,POL,2005.0,1,2,-1
KOR,IRL,2010.0,6,6,0
NLD,ARG,2011.0,2,3,-1
ITA,TWN,2006.0,3,1,2
DNK,OMN,1997.0,1,2,-1
SYR,GBR,2005.0,1,1,0
UGA,DNK,2000.0,1,3,-2
MYS,NZL,2006.0,2,3,-1
ISR,HKG,2015.0,2,2,0
GIN,FRA,2009.0,2,2,0
OMN,SWE,2008.0,1,1,0
ISR,VEN,2010.0,1,1,0
DNK,CHL,2022.0,2,4,-2
GBR,SYC,2010.0,1,1,0
AUT,CHL,2014.0,4,2,2
UKR,AUS,2012.0,3,2,1
CHE,COL,2008.0,2,3,-1
POL,PRT,2011.0,5,9,-4
YEM,MYS,2011.0,2,5,-3
POL,CHL,2011.0,2,2,0
JPN,CMR,2010.0,2,2,0
NOR,LUX,2022.0,1,1,0
UZB,DEU,2017.0,3,4,-1
EGY,ZAF,2019.0,1,1,0
GUF,BRA,2013.0,1,1,0
IDN,CZE,2012.0,1,1,0
DNK,CZE,2009.0,2,3,-1
NOR,VNM,2017.0,2,1,1
PSE,NLD,2009.0,1,1,0
CZE,GRC,2011.0,1,3,-2
FIN,SVN,2012.0,1,1,0
PSE,ITA,2017.0,1,5,-4
GRC,CZE,2009.0,1,1,0
NLD,MKD,2011.0,2,1,1
PRI,MEX,2011.0,1,1,0
VNM,ITA,2022.0,1,4,-3
BEL,MTQ,2011.0,1,1,0
COD,BEL,2007.0,1,1,0
ISR,DNK,2015.0,3,1,2
MAC,PRT,2020.0,2,3,-1
IRL,KOR,2020.0,5,4,1
EST,NOR,2005.0,1,1,0
CAN,LTU,2015.0,1,5,-4
DZA,NGA,2008.0,2,3,-1
IDN,FRA,2013.0,5,15,-10
LUX,GRC,2017.0,1,3,-2
KOR,CHE,2005.0,4,4,0
MKD,CHE,2017.0,1,1,0
DEU,MKD,2020.0,2,2,0
FIN,ISR,2017.0,4,1,3
HKG,AUT,2019.0,1,1,0
FRA,CAF,2015.0,2,3,-1
DEU,CUB,2011.0,2,9,-7
NOR,TZA,2012.0,3,6,-3
MAR,NLD,2014.0,2,1,1
TZA,THA,2018.0,2,1,1
ISR,NZL,2015.0,2,1,1
AUS,NCL,2016.0,2,3,-1
ARG,POL,2017.0,2,1,1
USA,HND,2017.0,1,1,0
MYS,ETH,2023.0,1,1,0
MLI,NER,2013.0,1,1,0
ALB,ITA,2019.0,1,12,-11
TWN,BRA,2021.0,2,3,-1
NOR,GRC,2020.0,2,9,-7
CHE,GIN,2015.0,1,1,0
SVK,SRB,2016.0,1,2,-1
URY,MEX,2013.0,2,1,1
BLR,CZE,2023.0,1,1,0
RUS,CHN,2008.0,4,2,2
GBR,AFG,2005.0,1,1,0
HUN,BEL,2022.0,1,2,-1
FRA,AFG,2019.0,2,6,-4
POL,MYS,2023.0,1,2,-1
LBN,TUR,2017.0,1,1,0
SAU,MEX,2023.0,1,3,-2
MEX,IRL,2018.0,2,1,1
MAR,DZA,2023.0,1,2,-1
CZE,UKR,2015.0,2,6,-4
FIN,PAK,2019.0,5,11,-6
CHN,IRL,2001.0,2,2,0
CHE,BGD,2022.0,1,1,0
BHR,MYS,2020.0,1,9,-8
ROU,TUR,2020.0,3,2,1
BGD,BEL,2020.0,3,5,-2
FIN,HUN,2008.0,1,6,-5
NGA,GHA,2005.0,2,1,1
FRA,LAO,2002.0,2,1,1
CHE,MLT,2008.0,2,1,1
NGA,TTO,2011.0,1,1,0
CHE,COL,2004.0,1,2,-1
DEU,PRI,2009.0,1,1,0
SYC,FRA,2014.0,2,2,0
SRB,BEL,2003.0,2,5,-3
ARG,DNK,1999.0,1,2,-1
IRQ,ARE,2015.0,1,1,0
SVN,SRB,2023.0,2,5,-3
KWT,SRB,2023.0,1,1,0
HKG,ESP,2023.0,4,3,1
IRL,TUR,2022.0,4,10,-6
BIH,NOR,2021.0,2,1,1
BEL,VNM,2023.0,5,7,-2
LVA,LTU,2006.0,1,4,-3
DEU,SVN,2004.0,1,4,-3
LUX,BEL,2005.0,2,11,-9
IDN,SWE,2012.0,2,2,0
USA,CMR,2007.0,4,8,-4
IRL,FRA,1998.0,3,10,-7
JOR,GBR,2008.0,2,19,-17
DZA,NGA,2010.0,1,2,-1
AFG,IRN,2012.0,1,1,0
DZA,ESP,2007.0,1,5,-4
BOL,MEX,2017.0,1,3,-2
CZE,ARG,2013.0,1,1,0
KAZ,PAK,2021.0,1,1,0
ITA,MYS,2015.0,1,6,-5
FIN,TZA,2007.0,1,1,0
RUS,VEN,2018.0,1,1,0
BRA,LUX,2007.0,1,1,0
ITA,ECU,2009.0,1,2,-1
GRC,SAU,2022.0,3,1,2
ZAF,GRC,2014.0,2,1,1
CHN,IRN,2008.0,2,1,1
NOR,PSE,2020.0,4,1,3
MNG,CHE,2015.0,1,2,-1
ZMB,ZAF,2000.0,1,1,0
GBR,PER,2009.0,1,3,-2
TUN,CHE,2013.0,2,3,-1
SWE,RWA,2012.0,1,1,0
BEL,SVK,2006.0,4,5,-1
HRV,THA,2016.0,1,1,0
AUT,UKR,2008.0,2,7,-5
SVN,FRA,2019.0,3,3,0
CMR,BEN,2011.0,1,1,0
BLR,UKR,2007.0,1,1,0
CAN,NAM,2012.0,1,1,0
THA,LKA,2001.0,3,2,1
GBR,KAZ,2008.0,2,5,-3
BHR,ITA,2009.0,1,1,0
SDN,FRA,2015.0,5,1,4
RUS,ZAF,2012.0,2,2,0
CHN,SDN,2012.0,3,2,1
CAN,CYP,2013.0,1,2,-1
JPN,TZA,2006.0,4,1,3
LBY,DEU,2008.0,1,2,-1
DEU,LBY,2012.0,3,1,2
RWA,ZAF,2011.0,1,4,-3
DNK,KOR,2007.0,2,2,0
MEX,KOR,2009.0,3,1,2
ESP,KOR,2008.0,2,5,-3
ITA,PAN,2020.0,2,1,1
MCO,GBR,2010.0,1,2,-1
KGZ,USA,2007.0,1,1,0
PAN,ARG,2018.0,1,2,-1
GHA,KOR,2021.0,2,8,-6
BGD,VNM,2013.0,1,2,-1
GRC,BRA,2017.0,2,2,0
DEU,UZB,2018.0,1,5,-4
COG,GBR,2009.0,2,1,1
LBN,IND,2022.0,1,1,0
LTU,CZE,2023.0,2,2,0
SVN,FIN,2011.0,1,1,0
VNM,SRB,2018.0,2,1,1
SAU,KOR,2014.0,6,20,-14
ARE,OMN,2000.0,1,6,-5
LUX,GBR,2012.0,3,15,-12
NZL,MEX,2015.0,1,2,-1
BEL,ETH,2011.0,2,3,-1
POL,BEL,1998.0,6,11,-5
BEL,MOZ,2018.0,1,1,0
GBR,SYR,2015.0,2,7,-5
OMN,IRQ,2013.0,1,1,0
CHL,ITA,2006.0,3,11,-8
USA,PNG,1998.0,1,1,0
NPL,NLD,2006.0,4,1,3
FIN,SVK,2017.0,1,2,-1
ROU,DNK,2005.0,1,2,-1
DEU,KEN,2006.0,3,5,-2
ARG,PRI,2010.0,1,3,-2
BWA,SWZ,2007.0,1,1,0
NOR,KOR,2007.0,2,2,0
MAC,MAR,2006.0,1,2,-1
SVK,HUN,2007.0,1,1,0
URY,DEU,2012.0,1,1,0
CAN,TZA,2014.0,1,1,0
ISR,FIN,2012.0,2,1,1
TUN,CHL,2020.0,2,1,1
ARG,NZL,2023.0,2,2,0
NPL,GBR,2010.0,2,7,-5
IRN,LTU,2014.0,1,1,0
GBR,GAB,2012.0,2,2,0
KAZ,TUR,2011.0,1,3,-2
POL,ARG,2021.0,1,4,-3
TWN,TUR,2002.0,1,2,-1
BRA,TWN,2019.0,5,1,4
LVA,CHE,2020.0,2,3,-1
FIN,MWI,2011.0,1,1,0
NLD,COL,2023.0,3,12,-9
BEL,EST,2020.0,1,3,-2
HKG,ISR,2020.0,2,2,0
DEU,MDA,2021.0,2,4,-2
CUB,CHN,2020.0,5,3,2
GBR,JAM,2022.0,2,1,1
KEN,IND,2017.0,1,4,-3
ITA,IRN,2001.0,2,2,0
OMN,MYS,2023.0,2,11,-9
SYR,GBR,2016.0,2,3,-1
BEN,ZAF,2020.0,2,5,-3
PAK,CAN,2024.0,2,1,1
HKG,PHL,2021.0,1,6,-5
NPL,CZE,2019.0,1,1,0
NZL,NPL,2021.0,2,6,-4
ITA,HKG,2011.0,2,3,-1
SVN,AUS,2022.0,1,3,-2
UGA,NOR,2021.0,2,8,-6
COD,NGA,2023.0,1,1,0
ETH,NLD,2022.0,6,13,-7
VNM,AUT,2022.0,1,1,0
COL,AUT,2018.0,1,2,-1
IND,SVN,2023.0,4,1,3
HKG,BGD,2014.0,1,2,-1
IND,GHA,2017.0,2,1,1
DEU,GEO,2020.0,4,7,-3
VNM,MYS,2016.0,1,2,-1
KAZ,TUR,2021.0,3,12,-9
LIE,AUT,2022.0,1,4,-3
GBR,RWA,2017.0,2,3,-1
MYS,EST,2020.0,1,1,0
LUX,TUN,2022.0,1,2,-1
VNM,IRN,2020.0,7,18,-11
CHE,BFA,2021.0,2,2,0
FJI,IND,2011.0,1,2,-1
GRC,CAN,1998.0,5,10,-5
ESP,HRV,1998.0,1,2,-1
BHR,SDN,2022.0,1,2,-1
UKR,MDA,2001.0,1,2,-1
FRA,URY,1998.0,1,2,-1
HRV,MKD,2000.0,1,1,0
ARM,DEU,1998.0,2,4,-2
NLD,EGY,1997.0,2,1,1
JPN,ESP,2004.0,4,12,-8
BFA,NLD,1999.0,3,1,2
LUX,BEL,2002.0,5,6,-1
MAR,ITA,2009.0,1,2,-1
FIN,IRN,2007.0,1,3,-2
SGP,TUR,2011.0,1,2,-1
SVK,BEL,2000.0,3,2,1
TWN,IRN,2006.0,1,1,0
ARE,SWE,2014.0,3,2,1
PYF,FRA,2008.0,6,13,-7
PAK,PRT,2020.0,2,1,1
ISR,ESP,2006.0,3,2,1
SAU,SWE,2015.0,3,4,-1
BFA,BEL,2008.0,1,2,-1
POL,FIN,2005.0,1,4,-3
ROU,CHL,2009.0,1,1,0
DEU,KEN,2000.0,1,10,-9
POL,BGR,2006.0,1,2,-1
FRA,HRV,2006.0,3,3,0
SGP,PHL,2003.0,2,1,1
TTO,IND,2004.0,1,1,0
ISR,ZAF,2005.0,2,2,0
SAU,LUX,2022.0,1,1,0
KWT,HUN,2001.0,1,3,-2
BGR,NLD,2005.0,1,1,0
CZE,KOR,2013.0,1,2,-1
CZE,JPN,2010.0,7,7,0
CMR,SEN,2022.0,2,3,-1
KEN,DNK,2016.0,2,3,-1
AUT,IRN,2009.0,4,3,1
MNP,USA,2008.0,1,2,-1
MYS,CAN,2009.0,5,7,-2
IRN,ISR,2020.0,2,1,1
COL,PRI,2012.0,1,5,-4
JOR,ITA,2012.0,1,1,0
NLD,COL,2010.0,2,4,-2
CAN,HND,2019.0,2,1,1
ROU,ZAF,2011.0,2,1,1
ZAF,JPN,2008.0,2,2,0
NGA,GMB,2010.0,2,2,0
PRI,PRT,2012.0,1,1,0
HKG,ESP,2010.0,1,1,0
IRQ,JOR,2010.0,3,8,-5
NOR,ISR,2023.0,1,1,0
BEN,BEL,2006.0,1,4,-3
DNK,TWN,2018.0,1,3,-2
IRN,RUS,2012.0,1,1,0
KOR,DZA,2015.0,1,1,0
JPN,PRY,2017.0,1,1,0
TZA,UGA,2011.0,1,1,0
IDN,FIN,2017.0,3,3,0
BRA,IRN,2014.0,1,9,-8
KOR,IRL,2014.0,5,3,2
ZAF,AUT,2016.0,4,5,-1
HUN,IND,2017.0,1,10,-9
AFG,IND,2013.0,1,1,0
PER,ITA,2016.0,1,1,0
IRL,THA,2020.0,2,3,-1
TUN,GBR,2009.0,3,4,-1
IDN,KEN,2022.0,1,2,-1
NLD,CRI,2017.0,1,1,0
CHL,SAU,2020.0,1,1,0
PER,COL,2012.0,2,2,0
FRA,SRB,2019.0,4,5,-1
MNE,HRV,2014.0,2,3,-1
FIN,COL,2016.0,2,1,1
EST,ISR,2016.0,1,1,0
ARG,ECU,2016.0,2,1,1
COL,ARM,2012.0,2,3,-1
BHR,SAU,2017.0,3,2,1
USA,SDN,2016.0,3,5,-2
CAN,BWA,2016.0,1,2,-1
SAU,THA,2016.0,1,1,0
SWE,THA,2020.0,3,9,-6
AUS,SRB,2019.0,3,4,-1
VEN,ITA,2005.0,2,2,0
CZE,COL,2014.0,1,1,0
IRL,PRT,2002.0,1,3,-2
CZE,TWN,2020.0,1,5,-4
IRQ,GBR,1998.0,2,1,1
BHR,DEU,2013.0,2,1,1
DEU,BHR,2015.0,1,2,-1
SEN,NLD,2009.0,1,1,0
ITA,SEN,2011.0,1,1,0
MAR,TUN,2008.0,2,3,-1
ETH,ITA,2018.0,2,5,-3
PRT,MOZ,2018.0,1,4,-3
EGY,NOR,2015.0,1,2,-1
NZL,KOR,2023.0,2,2,0
BEL,ARE,2023.0,2,2,0
SLE,NLD,2018.0,1,2,-1
KWT,SAU,2019.0,2,13,-11
SVN,MEX,2002.0,1,1,0
THA,FIN,2021.0,2,3,-1
URY,ARG,2020.0,5,12,-7
KAZ,ARE,2013.0,1,2,-1
FRA,HRV,2023.0,2,2,0
ROU,BRA,2022.0,1,2,-1
ZAF,HUN,2023.0,2,1,1
GEO,DEU,2023.0,2,2,0
JPN,CUB,2011.0,1,1,0
GBR,SDN,2023.0,1,3,-2
SWE,PAK,2023.0,2,8,-6
NGA,RWA,2023.0,2,5,-3
GEO,NLD,2019.0,2,1,1
BMU,USA,2002.0,3,3,0
MYS,HRV,2015.0,1,4,-3
RUS,TJK,2000.0,1,2,-1
BEL,ISR,2018.0,9,3,6
GBR,PAN,2016.0,2,2,0
AUS,WSM,2021.0,1,1,0
IRL,ISL,2017.0,1,1,0
HKG,ESP,2000.0,1,2,-1
IRN,CZE,2010.0,1,2,-1
AUS,COL,2001.0,2,2,0
ZAF,HKG,2016.0,1,1,0
BIH,AUS,2019.0,1,1,0
OMN,BGD,2019.0,4,2,2
LBY,FIN,2016.0,2,2,0
NZL,TUR,2015.0,2,3,-1
PAN,MEX,2012.0,2,1,1
SRB,SWE,2020.0,6,2,4
ZWE,LSO,2015.0,1,2,-1
CZE,NOR,2023.0,3,1,2
CYP,CAN,2013.0,2,1,1
BEN,TGO,2017.0,1,2,-1
TZA,CHN,2021.0,5,18,-13
PER,PRT,2021.0,2,2,0
AUS,KAZ,2019.0,1,2,-1
AZE,HUN,2020.0,1,2,-1
ERI,CHN,2022.0,1,1,0
DEU,LKA,2018.0,3,2,1
PRY,FRA,2019.0,1,2,-1
BRA,ECU,2004.0,1,1,0
UKR,SWE,2003.0,6,6,0
GBR,SYR,2001.0,1,1,0
KHM,AUS,2005.0,1,2,-1
ZAF,BWA,2005.0,2,2,0
CAN,TZA,2001.0,1,1,0
IND,MUS,2000.0,1,2,-1
NLD,EGY,2002.0,3,2,1
MUS,IND,2014.0,1,1,0
DJI,FRA,2006.0,3,2,1
BHR,JOR,2018.0,1,1,0
BWA,NOR,2004.0,1,1,0
USA,LBR,2013.0,2,1,1
LKA,AUS,2008.0,5,9,-4
LBN,CHE,2012.0,1,1,0
ISR,ISL,2002.0,2,1,1
BEN,CAN,2001.0,1,1,0
SDN,QAT,2019.0,3,1,2
DEU,PER,2007.0,2,5,-3
CAN,PAK,2002.0,2,4,-2
NOR,CZE,2005.0,1,2,-1
CRI,RUS,2001.0,1,1,0
AUT,BGR,2008.0,3,2,1
IRN,TJK,2013.0,1,1,0
LUX,DNK,2018.0,1,2,-1
DNK,LUX,2019.0,1,1,0
IRL,MEX,2020.0,1,4,-3
SAU,HUN,2019.0,2,1,1
ZAF,BRA,2006.0,1,1,0
GRC,NOR,1999.0,1,1,0
NLD,MLT,2009.0,1,1,0
POL,NZL,2008.0,1,1,0
NOR,NZL,2006.0,1,2,-1
BLR,JPN,2002.0,2,1,1
KWT,SAU,2011.0,3,8,-5
CRI,DEU,2017.0,3,4,-1
HKG,TWN,2004.0,2,4,-2
MAR,JPN,2003.0,1,1,0
VEN,RUS,2018.0,1,1,0
GBR,MUS,2012.0,1,2,-1
IRL,GRC,2015.0,3,1,2
TUR,ARE,2012.0,2,1,1
JPN,LVA,2016.0,1,1,0
CRI,ESP,2007.0,2,3,-1
URY,BEL,2014.0,1,1,0
MDG,GBR,2022.0,1,4,-3
NOR,TZA,2016.0,6,2,4
SVN,PRT,2021.0,3,3,0
ESP,UGA,2020.0,1,1,0
KAZ,HKG,2018.0,1,1,0
ARE,AUT,2016.0,1,1,0
ESP,ETH,2021.0,2,7,-5
ISR,LUX,2020.0,1,1,0
UZB,CZE,2010.0,1,1,0
BGR,AUT,2018.0,2,2,0
KAZ,FIN,2017.0,2,1,1
GIN,GBR,2023.0,1,1,0
RWA,FRA,2021.0,2,1,1
IRL,BRA,2020.0,4,22,-18
MMR,KOR,2016.0,2,1,1
GRC,BGR,2018.0,1,1,0
NLD,SLE,2017.0,3,1,2
IRQ,AUS,2023.0,1,6,-5
IRL,BHR,2019.0,2,4,-2
BFA,CHN,2020.0,1,1,0
HRV,GBR,2004.0,1,4,-3
GIN,SEN,2021.0,3,5,-2
ITA,UKR,2001.0,4,1,3
ARE,NLD,1997.0,1,1,0
AUS,FIN,1998.0,1,4,-3
BTN,THA,2018.0,3,1,2
GRC,RUS,1999.0,1,3,-2
ZAF,SWZ,2002.0,3,1,2
TGO,MAR,2017.0,1,4,-3
JOR,PAK,2003.0,1,1,0
BGD,ESP,2022.0,4,1,3
HUN,LUX,2015.0,1,1,0
ISR,PRT,2017.0,3,3,0
IRN,ARM,2020.0,1,1,0
LKA,KOR,2021.0,3,9,-6
CIV,DEU,2000.0,2,1,1
JPN,NOR,2013.0,6,5,1
CUB,PER,2013.0,1,1,0
CIV,GBR,2000.0,1,1,0
NOR,CHN,2003.0,4,5,-1
AUS,ARG,2001.0,1,4,-3
IND,MEX,1997.0,1,2,-1
KOR,MMR,2006.0,1,1,0
GBR,SDN,2000.0,1,2,-1
CAN,ARE,1998.0,2,6,-4
QAT,GBR,2009.0,2,3,-1
KOR,QAT,2017.0,4,3,1
COL,IND,2015.0,2,2,0
IND,MMR,2020.0,2,1,1
DNK,TWN,2016.0,1,1,0
RWA,BEL,2019.0,2,5,-3
ESP,IDN,2014.0,1,1,0
LVA,USA,2016.0,4,7,-3
LSO,USA,2020.0,4,4,0
CMR,ITA,2009.0,1,3,-2
OMN,TUN,2013.0,2,2,0
IND,MAR,2023.0,6,2,4
SAU,CZE,2014.0,1,2,-1
KHM,FRA,2023.0,1,4,-3
NLD,ISL,2014.0,2,1,1
KEN,ISL,2018.0,1,1,0
JOR,TUR,2015.0,2,1,1
QAT,SWE,2014.0,1,1,0
LBY,USA,2015.0,5,2,3
DZA,YEM,2019.0,1,1,0
BWA,ZWE,2018.0,1,2,-1
GEO,RUS,2009.0,3,8,-5
SVK,HRV,2017.0,2,1,1
YEM,IND,2019.0,3,12,-9
FIN,MEX,2018.0,1,3,-2
TWN,BFA,2019.0,1,1,0
CHL,TWN,2016.0,1,2,-1
CZE,CHL,2008.0,1,1,0
MAR,DEU,2020.0,5,8,-3
PAK,DZA,2015.0,1,1,0
JPN,JAM,2015.0,2,2,0
USA,BEN,2006.0,1,2,-1
SEN,DEU,2019.0,1,1,0
KAZ,SAU,2020.0,1,2,-1
ARE,SAU,2024.0,1,2,-1
SYR,GBR,2018.0,4,3,1
PHL,SWE,2018.0,1,1,0
MAR,EGY,2022.0,1,1,0
EGY,GHA,2022.0,2,1,1
RWA,BEL,2021.0,2,10,-8
CZE,EGY,2022.0,1,1,0
NZL,SAU,2020.0,1,9,-8
SWE,URY,2017.0,1,2,-1
CHE,QAT,2015.0,2,1,1
ESP,ALB,2021.0,1,1,0
COG,CHN,2020.0,1,1,0
BWA,ZWE,2022.0,1,2,-1
HKG,BRA,2021.0,1,5,-4
SVN,AUS,2017.0,3,2,1
ECU,TWN,2022.0,1,2,-1
PRT,MAR,2022.0,2,3,-1
RWA,KEN,2022.0,5,8,-3
IND,TUN,2005.0,1,1,0
NOR,TZA,2022.0,4,3,1
ZAF,MLI,2022.0,1,2,-1
TUR,ISR,2022.0,1,3,-2
BOL,USA,2018.0,3,9,-6
DEU,TZA,2008.0,1,3,-2
LVA,SWE,2003.0,2,5,-3
GBR,MDG,2010.0,3,2,1
CAN,GHA,2009.0,2,3,-1
ECU,ESP,2005.0,2,6,-4
SDN,ARE,2014.0,1,1,0
CAN,HRV,2009.0,1,3,-2
NLD,AFG,2021.0,2,1,1
MOZ,SWE,2013.0,1,1,0
VEN,NLD,2012.0,1,1,0
BGD,DNK,2012.0,4,1,3
ZMB,ZAF,2006.0,1,1,0
SVK,RUS,2013.0,3,3,0
BFA,CAF,2008.0,1,1,0
AND,ESP,2006.0,2,6,-4
SVN,HUN,2008.0,1,1,0
USA,GUY,2008.0,2,2,0
KGZ,GBR,2003.0,1,1,0
USA,BRB,2007.0,3,1,2
UKR,BRA,2004.0,2,2,0
BEL,UKR,1999.0,1,3,-2
JPN,ARG,2016.0,2,1,1
ALB,FRA,2015.0,2,3,-1
USA,AZE,2002.0,2,2,0
SVN,ZAF,2019.0,2,1,1
FIN,BRA,2009.0,2,2,0
CHN,BLR,2014.0,2,2,0
HKG,KOR,2002.0,3,2,1
QAT,SGP,2013.0,1,3,-2
TWN,NLD,2001.0,2,2,0
MAR,DEU,1999.0,1,1,0
OMN,NOR,2017.0,1,2,-1
KGZ,RUS,2008.0,1,1,0
USA,BWA,1998.0,1,1,0
JPN,TZA,2000.0,1,2,-1
THA,LAO,2011.0,3,4,-1
BIH,NOR,2019.0,1,1,0
USA,MDA,2001.0,2,4,-2
ETH,DEU,2004.0,3,4,-1
GHA,DNK,2009.0,1,2,-1
SRB,ESP,2014.0,3,1,2
IRL,BHR,2009.0,1,1,0
BHR,IRL,2013.0,1,2,-1
SYR,AUT,2006.0,1,1,0
LAO,USA,2016.0,3,2,1
ZAF,IRN,2014.0,2,6,-4
HRV,GBR,2001.0,1,4,-3
NZL,ARG,2023.0,2,2,0
SWE,BGR,2023.0,1,1,0
KOR,ESP,2012.0,2,2,0
KEN,FRA,2003.0,2,1,1
HUN,BEL,1997.0,3,8,-5
KAZ,TUR,2009.0,2,1,1
CHE,DZA,2015.0,1,1,0
NZL,IRL,2012.0,1,6,-5
EST,DEU,2007.0,2,9,-7
VEN,ARG,2008.0,2,7,-5
CUB,NLD,2009.0,1,1,0
ZWE,IDN,2002.0,1,2,-1
IDN,BEL,2012.0,1,2,-1
CHN,MNG,2015.0,3,22,-19
ZAF,SDN,2014.0,3,1,2
LTU,CAN,2012.0,2,2,0
MYS,PRT,2014.0,2,2,0
ESP,ISL,2014.0,1,1,0
HRV,ITA,2017.0,6,15,-9
PAK,AUS,2008.0,3,5,-2
ITA,GEO,2013.0,2,1,1
RWA,ZAF,2019.0,2,9,-7
AUT,CUB,2014.0,1,1,0
SVK,CHN,2022.0,1,5,-4
BRN,IND,2018.0,1,6,-5
GHA,IRL,2019.0,1,1,0
LBR,NGA,2021.0,1,4,-3
ALB,ESP,2021.0,1,1,0
CHN,CMR,2018.0,3,2,1
LSO,UGA,2015.0,1,1,0
FRA,BOL,2023.0,1,1,0
CHL,PRT,2014.0,2,10,-8
ARG,AUS,2017.0,4,5,-1
PAK,IRL,2023.0,6,4,2
CMR,IND,2021.0,2,5,-3
IND,CMR,2023.0,2,1,1
GHA,IRL,2021.0,1,1,0
UKR,SVK,2017.0,5,5,0
SVK,SLV,2005.0,2,2,0
FRA,JOR,2022.0,2,2,0
LBN,SWE,2021.0,1,1,0
LBN,JOR,2020.0,3,3,0
HRV,SVK,2000.0,3,1,2
BRA,PRY,2007.0,1,1,0
BGR,AUS,1997.0,1,8,-7
BEL,PAK,2012.0,1,1,0
KWT,AUS,2002.0,2,2,0
MEX,VEN,2002.0,1,5,-4
ITA,PER,2001.0,1,1,0
PHL,ESP,1999.0,3,7,-4
TWN,EGY,2000.0,1,2,-1
SWE,SVK,1997.0,1,2,-1
RUS,NZL,2016.0,1,2,-1
GRC,SRB,2000.0,1,3,-2
ISR,HUN,1998.0,1,2,-1
AUT,ZAF,2001.0,1,1,0
ITA,HND,2021.0,1,2,-1
BGR,JPN,2007.0,2,10,-8
ESP,HKG,2008.0,1,2,-1
JOR,EGY,1999.0,1,3,-2
CAN,SRB,2011.0,2,4,-2
ETH,MOZ,2020.0,1,1,0
DNK,FRO,2013.0,1,1,0
COL,GTM,2010.0,1,1,0
NZL,ISR,2016.0,2,5,-3
KOR,MWI,2020.0,1,1,0
ITA,NZL,2012.0,3,4,-1
BOL,ESP,2002.0,1,1,0
CAN,CRI,2014.0,2,1,1
KAZ,FRA,2015.0,2,5,-3
GBR,HRV,1998.0,1,5,-4
SGP,MMR,2016.0,1,1,0
CAN,TZA,2015.0,1,1,0
IRL,ROU,2007.0,1,1,0
DZA,ZAF,2014.0,1,1,0
IDN,KOR,2014.0,4,11,-7
COG,BEN,2012.0,1,2,-1
HKG,CZE,2014.0,1,1,0
MAR,TGO,2017.0,4,1,3
CAN,UGA,2023.0,1,2,-1
RUS,PRT,2016.0,2,8,-6
BLR,FRA,2019.0,2,3,-1
IRL,SDN,2021.0,1,2,-1
ZAF,LBY,2020.0,3,1,2
CMR,SEN,2017.0,2,2,0
FRA,DJI,2019.0,2,2,0
TUN,GBR,2019.0,1,1,0
ITA,IDN,2017.0,1,6,-5
HUN,EGY,2013.0,1,1,0
TWN,EGY,2023.0,2,2,0
KEN,ITA,2018.0,4,7,-3
TUN,BEL,2006.0,1,3,-2
SWE,LBN,2016.0,1,1,0
EGY,SVK,2022.0,1,2,-1
SGP,UKR,2017.0,1,1,0
BEL,DNK,2011.0,2,3,-1
MWI,IND,2015.0,1,2,-1
SDN,QAT,2011.0,1,2,-1
NOR,ISR,2010.0,1,3,-2
ESP,NZL,2023.0,1,1,0
GRC,ARM,2018.0,2,1,1
NGA,BRA,2010.0,1,3,-2
LAO,KHM,2007.0,1,1,0
PAK,MEX,2015.0,1,1,0
OMN,ZAF,2014.0,1,1,0
GRD,IND,2014.0,1,2,-1
UGA,ZAF,2008.0,3,1,2
DEU,PAN,2010.0,1,3,-2
FRA,SVN,2011.0,1,9,-8
CAN,LBY,2017.0,1,1,0
TGO,BEN,2019.0,1,3,-2
JAM,CAN,2005.0,1,2,-1
FRA,MWI,2009.0,1,2,-1
DZA,CHE,2009.0,1,2,-1
SWE,CHL,2014.0,3,2,1
SVN,BRA,2018.0,1,1,0
AUS,ROU,2022.0,1,1,0
AUT,COL,2020.0,1,4,-3
CAN,MAC,2017.0,1,2,-1
PER,ARG,2021.0,3,6,-3
PER,CHE,2021.0,1,3,-2
MKD,GBR,2022.0,1,1,0
LTU,DNK,2017.0,2,1,1
BRA,CHN,2010.0,4,4,0
GHA,DNK,2021.0,1,5,-4
KHM,SGP,2020.0,1,2,-1
GBR,TJK,2022.0,1,1,0
PAK,IRQ,2020.0,2,4,-2
ARG,JPN,2014.0,3,1,2
BLR,ITA,2009.0,1,1,0
ARE,BHR,2023.0,1,2,-1
SXM,NLD,2022.0,2,3,-1
IRN,NOR,2008.0,2,3,-1
ARG,COL,2004.0,1,2,-1
ARM,CAN,2009.0,1,3,-2
TTO,BRB,2019.0,2,1,1
FRA,SRB,2011.0,3,4,-1
PAK,BRN,2014.0,2,1,1
BEL,PAK,2002.0,2,1,1
USA,MUS,2014.0,1,1,0
ISR,BRA,2015.0,1,4,-3
BGR,FRA,2013.0,3,8,-5
TGO,FRA,2014.0,1,6,-5
MNG,GBR,2014.0,1,3,-2
DNK,LKA,2016.0,2,1,1
KEN,IDN,2017.0,1,1,0
MLT,USA,2019.0,2,2,0
IND,FJI,2007.0,2,2,0
AZE,EGY,2020.0,1,1,0
BGD,NZL,2023.0,2,2,0
ARE,SWE,2015.0,1,6,-5
ESP,SVK,2016.0,3,2,1
RWA,GBR,2016.0,1,6,-5
ISR,SGP,2022.0,1,1,0
BGD,PHL,2018.0,1,3,-2
KAZ,THA,2015.0,1,2,-1
COD,JPN,2021.0,1,1,0
AFG,NLD,2017.0,1,1,0
HUN,IND,2016.0,1,3,-2
COL,DNK,2016.0,1,2,-1
TUR,NZL,2019.0,1,1,0
ESP,ETH,2019.0,2,1,1
LUX,DNK,2016.0,1,2,-1
HRV,IND,2022.0,2,7,-5
PRI,IND,2012.0,1,1,0
NGA,ARG,2022.0,1,1,0
HRV,BEL,2022.0,2,1,1
BTN,THA,2022.0,2,7,-5
TUR,PSE,2023.0,2,1,1
GHA,IND,2021.0,2,8,-6
JOR,HUN,2022.0,1,12,-11
OMN,ARE,2007.0,2,1,1
YEM,EGY,2009.0,1,10,-9
SVN,SRB,2006.0,3,5,-2
KAZ,UZB,2006.0,2,1,1
LBN,RUS,2018.0,1,1,0
JPN,UKR,2000.0,3,11,-8
FIN,CZE,2004.0,1,2,-1
TUR,AZE,2003.0,1,9,-8
THA,BGD,2008.0,3,1,2
ARG,CHE,1997.0,1,1,0
SAU,AUT,2015.0,1,1,0
CZE,AUS,2004.0,1,1,0
AUS,PRT,2000.0,2,1,1
DEU,VNM,1998.0,1,1,0
SRB,ESP,2015.0,2,5,-3
NLD,ZAF,1997.0,4,2,2
FRA,EST,2008.0,1,1,0
MRT,FRA,1998.0,1,2,-1
HUN,EGY,2003.0,1,2,-1
ISR,FIN,1997.0,2,1,1
TTO,AUS,2006.0,1,1,0
VNM,SWE,2003.0,1,2,-1
QAT,DNK,2022.0,2,3,-1
ZAF,ITA,2000.0,4,2,2
PHL,DEU,1998.0,1,2,-1
PRI,RUS,1999.0,2,1,1
LAO,KHM,2020.0,3,3,0
AUS,COL,2014.0,5,4,1
BEL,ISL,2018.0,1,1,0
BDI,BEL,2016.0,1,1,0
GRC,SGP,2018.0,1,1,0
CHN,TUR,2017.0,1,11,-10
TJK,USA,2012.0,1,1,0
GIN,GNQ,2013.0,1,4,-3
GNQ,ESP,2018.0,1,1,0
UKR,BEL,2015.0,1,2,-1
TCD,USA,2016.0,1,1,0
HRV,NLD,2003.0,1,2,-1
AUS,UGA,2015.0,1,3,-2
CHN,CMR,2016.0,1,2,-1
NZL,RUS,2015.0,1,1,0
ZAF,NOR,2017.0,5,2,3
ECU,CHL,2013.0,1,1,0
DNK,CHL,2012.0,2,1,1
SDN,TUR,2019.0,1,4,-3
MNE,SRB,2003.0,1,2,-1
ZAF,THA,2018.0,2,1,1
THA,CZE,2020.0,1,1,0
LTU,LVA,2020.0,1,3,-2
SRB,IRQ,2016.0,1,1,0
ARE,CHL,2018.0,1,2,-1
SAU,USA,2024.0,1,2,-1
EST,BEL,2023.0,1,2,-1
NOR,GHA,2017.0,2,1,1
ZAF,EGY,2007.0,1,2,-1
TCD,DEU,2017.0,1,1,0
KOR,NOR,2015.0,3,1,2
GNB,GIN,2021.0,1,2,-1
ETH,AUT,2017.0,2,1,1
AUS,MKD,2020.0,1,2,-1
ITA,CUB,2005.0,3,5,-2
GNB,GBR,2021.0,1,1,0
MYS,AFG,2023.0,1,2,-1
GEO,USA,2024.0,1,2,-1
MYS,KEN,2005.0,1,1,0
COG,KEN,2020.0,1,1,0
GBR,LTU,2009.0,2,4,-2
AFG,BGD,2020.0,1,1,0
POL,IRL,2007.0,2,2,0
CYP,TUR,2004.0,3,5,-2
ZAF,CMR,2008.0,1,4,-3
BRB,FRA,2009.0,1,1,0
USA,BRN,2019.0,1,4,-3
EGY,AUT,2022.0,2,3,-1
ISR,IRL,2023.0,1,3,-2
MKD,BGR,2008.0,1,1,0
LVA,LTU,2023.0,2,3,-1
JOR,GBR,2004.0,3,8,-5
NOR,THA,2019.0,2,2,0
VEN,CUB,2016.0,2,2,0
BIH,FRA,2021.0,1,2,-1
PRT,MKD,2020.0,1,1,0
BEN,USA,2022.0,2,4,-2
NGA,MEX,2020.0,1,2,-1
USA,LTU,1998.0,3,9,-6
MYS,UZB,2001.0,1,1,0
MYS,UZB,2008.0,1,1,0
ESP,PRY,2002.0,1,1,0
BRA,NGA,2013.0,1,2,-1
AZE,ISR,2016.0,1,1,0
BRA,VEN,2015.0,2,8,-6
ZAF,HKG,2017.0,1,1,0
USA,CYM,2015.0,1,1,0
LBN,NLD,2014.0,2,1,1
SVK,HUN,1998.0,1,1,0
BGD,NZL,2006.0,1,1,0
PAN,FRA,2014.0,1,2,-1
GBR,SYC,2004.0,1,1,0
NPL,SWE,2014.0,1,3,-2
BRA,MOZ,2008.0,1,2,-1
SDN,CHN,2014.0,1,6,-5
PRT,AUT,2012.0,2,6,-4
GBR,BFA,2022.0,1,1,0
BRN,GBR,2014.0,1,3,-2
JPN,GRC,1997.0,2,1,1
CAN,MYS,2005.0,1,6,-5
DNK,MYS,2014.0,2,5,-3
AUS,MAC,2016.0,1,1,0
BEL,SEN,2002.0,1,1,0
ITA,TZA,2015.0,2,1,1
ZMB,TZA,2010.0,1,1,0
GHA,JPN,2015.0,2,4,-2
ISL,DEU,2012.0,1,6,-5
HUN,CZE,2002.0,1,4,-3
AUT,IDN,2018.0,4,1,3
VNM,SWE,2013.0,2,7,-5
CHN,IDN,2002.0,1,1,0
GRC,JOR,2016.0,1,1,0
KWT,JPN,2019.0,1,3,-2
HKG,CHE,2003.0,1,2,-1
BEL,LUX,1997.0,2,2,0
PRT,RUS,2023.0,2,3,-1
BTN,THA,2017.0,1,4,-3
AUT,ARG,2021.0,3,4,-1
ZAF,TWN,2012.0,1,1,0
COD,GAB,2018.0,1,1,0
FIN,MEX,2022.0,2,6,-4
VNM,FIN,2018.0,1,3,-2
COG,SEN,2023.0,1,2,-1
PAK,LBN,2021.0,2,1,1
MMR,KOR,2018.0,1,2,-1
BEL,IRN,2002.0,1,3,-2
PHL,SWE,2022.0,1,2,-1
SDN,AUS,2020.0,1,1,0
UKR,CAN,2017.0,5,5,0
TUR,BIH,2023.0,1,2,-1
CRI,MEX,2023.0,1,1,0
ECU,CAN,2023.0,1,1,0
COL,NZL,2013.0,1,1,0
ZAF,PRT,2002.0,3,2,1
BLZ,FIN,1999.0,1,1,0
KOR,NGA,2015.0,1,2,-1
GMB,DEU,2001.0,1,1,0
JAM,BRA,2021.0,1,1,0
CAN,URY,2007.0,1,2,-1
ARG,FIN,2017.0,1,1,0
ARE,BGD,2020.0,1,2,-1
MYS,HKG,2003.0,1,3,-2
DNK,ROU,2018.0,1,2,-1
HND,ESP,2019.0,1,1,0
ESP,GTM,2017.0,3,3,0
COG,GBR,2021.0,1,1,0
GBR,NAM,2008.0,1,1,0
MOZ,ZAF,2017.0,2,9,-7
MLT,DNK,2015.0,1,1,0
BEL,PAN,2023.0,1,1,0
PHL,HUN,2019.0,1,1,0
HKG,FRA,2023.0,2,7,-5
POL,TUN,2020.0,1,1,0
DZA,SWE,2021.0,1,1,0
MEX,DZA,2023.0,1,1,0
NOR,BRA,2004.0,1,2,-1
EGY,JOR,2018.0,1,3,-2
THA,IDN,2024.0,1,1,0
TWN,POL,2020.0,1,1,0
NLD,KAZ,2017.0,1,4,-3
RWA,ZMB,2022.0,1,1,0
JOR,IRQ,2023.0,2,2,0
EGY,PSE,2023.0,1,3,-2
ZAF,ZWE,1999.0,1,3,-2
ITA,CUB,2002.0,3,5,-2
USA,PNG,2007.0,1,1,0
KOR,POL,2012.0,2,2,0
USA,ASM,2005.0,2,1,1
SGP,FIN,2010.0,1,3,-2
NZL,CHL,2007.0,2,3,-1
AUS,POL,2005.0,1,2,-1
CZE,CHL,2015.0,1,2,-1
SGP,TUN,2012.0,1,1,0
ISR,GRC,2005.0,2,1,1
UZB,KOR,2007.0,2,2,0
DEU,KWT,1999.0,1,1,0
GBR,ZWE,2010.0,1,3,-2
TUR,MAR,2019.0,2,1,1
NAM,AUS,2018.0,1,1,0
ITA,MDG,2002.0,1,3,-2
HRV,HUN,2015.0,1,3,-2
MYS,FRA,2004.0,1,1,0
SLE,NGA,2020.0,1,5,-4
GBR,MAR,2020.0,2,4,-2
TUR,MKD,2003.0,1,1,0
NLD,LKA,2015.0,1,2,-1
LKA,GHA,2014.0,1,1,0
AUS,KHM,2003.0,2,1,1
CZE,UKR,2010.0,1,2,-1
MDA,DEU,2018.0,2,5,-3
NPL,MYS,2013.0,2,2,0
DEU,PHL,2009.0,2,3,-1
ESP,HND,2019.0,1,1,0
THA,VNM,2009.0,3,3,0
MCO,ITA,2014.0,2,1,1
UGA,CHN,2018.0,1,4,-3
URY,CHL,2011.0,1,2,-1
BEL,CMR,2005.0,2,3,-1
TWN,TUR,2005.0,2,5,-3
UZB,GBR,2005.0,2,2,0
PAK,JOR,2010.0,1,1,0
AND,ESP,2023.0,2,2,0
RWA,KEN,2017.0,1,4,-3
ITA,JOR,2013.0,2,1,1
SVK,EGY,2021.0,1,1,0
SGP,VNM,2013.0,1,3,-2
DEU,UZB,2022.0,2,1,1
UKR,THA,2016.0,1,1,0
BRA,FIN,2004.0,1,1,0
NZL,KEN,2019.0,3,1,2
AUS,MMR,2015.0,1,1,0
HUN,CZE,2005.0,2,1,1
IRL,SVN,2016.0,1,1,0
BGD,IRQ,2017.0,1,1,0
CMR,NGA,2017.0,1,2,-1
SVN,DNK,2022.0,1,8,-7
ETH,FIN,2016.0,1,1,0
ISR,TWN,2021.0,3,2,1
BGR,PRT,2021.0,1,1,0
NOR,ZAF,2014.0,1,7,-6
KOR,MEX,2023.0,2,1,1
BFA,NGA,2016.0,2,1,1
FIN,SVN,2016.0,1,1,0
TUN,IND,2020.0,2,1,1
ESP,SVN,2001.0,1,3,-2
TGO,BEN,2021.0,3,2,1
SVK,PRT,2019.0,1,2,-1
NLD,UZB,2021.0,1,1,0
THA,KHM,2023.0,4,3,1
IND,TUN,2002.0,1,1,0
IRL,HKG,2021.0,1,7,-6
ISL,NOR,2000.0,1,4,-3
HRV,PRT,2011.0,2,1,1
QAT,KWT,2021.0,2,2,0
ROU,POL,2006.0,1,4,-3
ITA,LTU,2012.0,4,1,3
IRN,AUS,1999.0,3,18,-15
USA,GNB,1999.0,1,1,0
TTO,NGA,2011.0,1,1,0
TZA,DNK,2003.0,1,2,-1
BLR,KOR,2000.0,1,4,-3
AUS,HUN,2012.0,1,4,-3
SWE,IDN,2001.0,2,2,0
TUR,SWE,2003.0,1,2,-1
MEX,VEN,1997.0,1,5,-4
CZE,KAZ,2000.0,1,2,-1
KEN,MWI,2008.0,1,1,0
NOR,NGA,2019.0,1,3,-2
MDA,RUS,2007.0,2,4,-2
BOL,FRA,1997.0,3,3,0
NZL,ZAF,2005.0,2,10,-8
EST,DNK,2012.0,1,2,-1
BRB,USA,2005.0,1,9,-8
BRB,GBR,2010.0,2,2,0
USA,BIH,2004.0,2,1,1
UKR,ISR,2007.0,3,2,1
CHN,LTU,2012.0,1,1,0
NOR,PRT,2003.0,2,2,0
FIN,EST,1997.0,1,8,-7
AUS,NPL,2011.0,2,2,0
NLD,TZA,1997.0,1,1,0
SGP,IRL,2013.0,1,4,-3
ITA,EST,2009.0,2,1,1
URY,MEX,2009.0,1,1,0
ZAF,DZA,2014.0,1,1,0
NLD,BGD,2011.0,1,4,-3
SGP,CHL,2018.0,1,1,0
CMR,ITA,2011.0,2,3,-1
NOR,JOR,2019.0,1,1,0
CIV,BEL,2007.0,1,1,0
ZAF,GMB,2018.0,1,5,-4
EGY,SGP,2012.0,1,1,0
LUX,CHE,2009.0,1,3,-2
ROU,POL,2023.0,2,1,1
COG,CAN,2020.0,1,2,-1
AUS,ECU,2009.0,1,1,0
GUM,JPN,2019.0,1,1,0
LBN,DEU,2005.0,1,1,0
SAU,MAC,2021.0,1,1,0
SAU,BEL,2013.0,1,3,-2
NZL,ISR,2018.0,2,2,0
SWE,ARG,2023.0,1,2,-1
HUN,BRA,2013.0,1,3,-2
BEN,NLD,2010.0,2,2,0
FRA,CAF,2023.0,1,2,-1
MKD,HRV,2016.0,1,2,-1
GBR,TCD,2009.0,1,0,1
BWA,BRN,2006.0,1,0,1
SAU,OMN,2001.0,2,0,2
SWE,ARG,2008.0,1,0,1
ITA,ZWE,2011.0,1,0,1
THA,ASM,2009.0,1,0,1
ARM,ESP,2004.0,1,0,1
AFG,IND,2011.0,1,0,1
GEO,BEL,2006.0,1,0,1
JPN,MDG,2005.0,3,0,3
NZL,NAM,2008.0,1,0,1
SWE,SVK,2018.0,1,0,1
LBN,FIN,2011.0,1,0,1
GHA,FIN,2006.0,1,0,1
GRC,PSE,2013.0,1,0,1
PAK,RUS,2013.0,2,0,2
GUM,,2009.0,2,0,2
USA,KGZ,2018.0,1,0,1
TLS,USA,2016.0,1,0,1
PAK,EGY,1997.0,1,0,1
NZL,EGY,2013.0,1,0,1
SVK,DZA,2011.0,1,0,1
,BDI,2002.0,4,0,4
CUB,ARG,2004.0,2,0,2
CUB,ITA,2019.0,3,0,3
TZA,BEL,2009.0,1,0,1
UZB,CHN,2013.0,1,0,1
GHA,DEU,2000.0,2,0,2
ARE,CHE,2004.0,1,0,1
CMR,SDN,2006.0,1,0,1
CHE,IDN,2023.0,2,0,2
POL,LUX,2017.0,2,0,2
SRB,IRL,2015.0,1,0,1
KHM,PHL,2013.0,1,0,1
BEN,,2012.0,4,0,4
ROU,HRV,2015.0,2,0,2
ROU,SVK,2014.0,1,0,1
ROU,CZE,2023.0,3,0,3
FRO,,2015.0,5,0,5
BIH,NOR,2013.0,1,0,1
ERI,IRL,2013.0,1,0,1
GAB,AUT,2013.0,2,0,2
ECU,IND,2021.0,1,0,1
ROU,KAZ,2020.0,2,0,2
CHN,NER,2018.0,1,0,1
ZMB,CHE,2021.0,3,0,3
BGR,MNE,2013.0,1,0,1
HKG,VNM,2002.0,1,0,1
NOR,MYS,2006.0,2,0,2
BFA,IRN,2012.0,1,0,1
YEM,CHN,2016.0,1,0,1
MKD,PRT,2018.0,1,0,1
NLD,GLP,2013.0,1,0,1
NZL,ZMB,2015.0,1,0,1
SDN,JPN,2013.0,1,0,1
SYR,JOR,2020.0,1,0,1
GUM,,2019.0,3,0,3
KOR,PER,2019.0,1,0,1
SWZ,BWA,2021.0,1,0,1
BFA,KEN,2017.0,1,0,1
SLB,,2019.0,2,0,2
MDV,,2019.0,4,0,4
SYC,IND,2019.0,1,0,1
AUS,SEN,2021.0,2,0,2
IND,ISL,2023.0,1,0,1
ZMB,CHE,2019.0,1,0,1
VNM,LBN,2023.0,1,0,1
TWN,HND,2019.0,1,0,1
GRD,CHN,2023.0,1,0,1
EUE,CZE,2022.0,1,0,1
LTU,BGR,2017.0,1,0,1
,AND,2015.0,2,0,2
BMU,,2004.0,2,0,2
VGB,GBR,2006.0,1,0,1
SDN,ZAF,1998.0,1,0,1
ZAF,SDN,2000.0,1,0,1
TWN,COL,2020.0,1,0,1
ARG,GEO,2016.0,1,0,1
NCL,FJI,2020.0,2,0,2
SGP,KAZ,2023.0,2,0,2
PHL,IRN,2017.0,2,0,2
WSM,,2022.0,9,0,9
GBR,COD,2021.0,2,0,2
BEL,SEN,2022.0,2,0,2
SWE,KAZ,2022.0,1,0,1
ESP,MWI,2022.0,1,0,1
PRY,CRI,2023.0,1,0,1
HUN,PAK,2016.0,2,0,2
SRB,BGR,2021.0,1,0,1
NPL,AFG,2017.0,1,0,1
ITA,KEN,1998.0,1,0,1
CAN,BRB,2004.0,2,0,2
BHR,SAU,2002.0,1,0,1
FIN,TWN,1999.0,1,0,1
WSM,USA,2016.0,2,0,2
NOR,KWT,1998.0,1,0,1
BHS,USA,1998.0,1,0,1
JPN,HND,2004.0,1,0,1
AUT,LBY,2002.0,1,0,1
TCD,AFG,2004.0,1,0,1
NER,SEN,2001.0,1,0,1
HUN,YEM,1998.0,1,0,1
TUR,HKG,1999.0,1,0,1
CHE,ZWE,2011.0,2,0,2
FIN,PRT,2001.0,2,0,2
PRT,FIN,2002.0,3,0,3
HND,USA,2000.0,2,0,2
VEN,PAN,2008.0,1,0,1
ISR,HTI,2014.0,1,0,1
DNK,VNM,2013.0,4,0,4
LTU,AUT,2008.0,1,0,1
FRA,MRT,2020.0,2,0,2
DEU,TGO,2016.0,1,0,1
ABW,CAN,2012.0,1,0,1
COL,BOL,2020.0,3,0,3
SWE,HRV,2016.0,1,0,1
SDN,DEU,2016.0,2,0,2
CHL,URY,2017.0,7,0,7
GRC,SAU,2012.0,2,0,2
BOL,CRI,2015.0,1,0,1
EGY,SRB,2023.0,1,0,1
,ASM,2009.0,1,0,1
AUT,LUX,2014.0,3,0,3
HKG,KEN,2013.0,1,0,1
PRI,CHE,2018.0,1,0,1
SVN,MEX,2018.0,1,0,1
,SYC,2012.0,2,0,2
UZB,CZE,2015.0,1,0,1
NGA,LBR,2015.0,1,0,1
PYF,AUS,2016.0,1,0,1
CHN,COD,2018.0,2,0,2
FRA,FLK,2015.0,1,0,1
FLK,ITA,2019.0,1,0,1
CHN,CZE,2006.0,2,0,2
BHR,SRB,2019.0,1,0,1
BEN,NER,2017.0,2,0,2
BEL,PNG,2017.0,1,0,1
IOT,CAN,2013.0,1,0,1
LBY,IDN,2015.0,1,0,1
ESP,SEN,2020.0,2,0,2
JAM,IND,1998.0,2,0,2
FRA,COD,2023.0,4,0,4
ARG,GRC,2021.0,1,0,1
IRN,PSE,2023.0,1,0,1
IND,ARM,2023.0,1,0,1
AZE,ITA,2020.0,2,0,2
MNG,CAN,2022.0,1,0,1
DEU,TCD,2023.0,1,0,1
NZL,GRC,2007.0,1,0,1
GRC,NZL,2008.0,1,0,1
DEU,MMR,2019.0,1,0,1
JPN,BEN,2008.0,2,0,2
COG,BEN,2016.0,1,0,1
MCO,USA,2006.0,1,0,1
NIC,CAN,2004.0,1,0,1
TUR,PSE,2004.0,1,0,1
,ATG,1998.0,1,0,1
CUB,URY,2019.0,1,0,1
IND,MDV,2007.0,1,0,1
CHE,GHA,2009.0,2,0,2
TWN,JOR,2011.0,1,0,1
BRA,SAU,2012.0,1,0,1
GRC,LBY,2012.0,1,0,1
LBY,GRC,2015.0,1,0,1
SYR,AUS,2010.0,1,0,1
GBR,MOZ,1998.0,2,0,2
BRA,TWN,2013.0,2,0,2
ITA,UZB,2020.0,4,0,4
PNG,MYS,2016.0,1,0,1
DEU,GUF,1998.0,1,0,1
TUR,PAK,1997.0,2,0,2
NZL,ARG,2014.0,2,0,2
ARG,NZL,2015.0,1,0,1
THA,BTN,2005.0,1,0,1
TZA,NGA,2007.0,1,0,1
TUR,PSE,2008.0,1,0,1
IDN,PHL,2001.0,3,0,3
PHL,IDN,2005.0,1,0,1
CHE,PNG,2003.0,3,0,3
CUB,PER,2019.0,4,0,4
BWA,FRA,2016.0,1,0,1
IRL,LIE,2014.0,1,0,1
BGR,ZAF,2001.0,1,0,1
CRI,DEU,2012.0,9,0,9
IRL,CYP,2021.0,5,0,5
PRT,EST,2014.0,1,0,1
CHN,KNA,2014.0,1,0,1
,GRL,2010.0,2,0,2
SVN,ZAF,2013.0,1,0,1
KHM,KAZ,2017.0,1,0,1
MAC,ARE,2018.0,1,0,1
MNG,TWN,2017.0,2,0,2
GBR,TCD,2019.0,1,0,1
LBN,HUN,2017.0,1,0,1
HKG,IDN,2019.0,2,0,2
CHE,TZA,2002.0,2,0,2
KOR,PRT,2017.0,1,0,1
COL,DOM,2021.0,2,0,2
IDN,RUS,2021.0,3,0,3
CHN,ISL,2022.0,3,0,3
OMN,ROU,2012.0,3,0,3
TZA,MWI,1998.0,1,0,1
SAU,CRI,2022.0,1,0,1
BOL,BEL,2021.0,2,0,2
QAT,PRT,2007.0,1,0,1
SWZ,GBR,2021.0,1,0,1
BLR,LTU,2022.0,3,0,3
MLI,NOR,2006.0,1,0,1
NOR,MKD,2022.0,1,0,1
LUX,USA,1997.0,1,0,1
IND,AFG,2009.0,1,0,1
ROU,IRN,2010.0,1,0,1
BRA,BRB,2012.0,1,0,1
,TKM,2002.0,1,0,1
VEN,KOR,2011.0,1,0,1
,DJI,2018.0,4,0,4
ISR,URY,2011.0,2,0,2
ISR,URY,2021.0,1,0,1
BRN,,2003.0,3,0,3
,BLZ,2011.0,4,0,4
BOL,CZE,2022.0,1,0,1
GBR,PRI,2023.0,2,0,2
AFG,,2026.0,3,0,3
,IRQ,2021.0,33,0,33
,GRC,2021.0,9,0,9
CHN,NOR,2024.0,2,0,2
HKG,KWT,2000.0,1,0,1
HUN,MNG,2011.0,1,0,1
BEN,BDI,2004.0,1,0,1
IDN,HRV,2006.0,1,0,1
ZWE,RWA,2011.0,2,0,2
FIN,GUM,1998.0,1,0,1
BFA,UGA,2020.0,1,0,1
PRT,HKG,2015.0,3,0,3
AGO,MOZ,2011.0,1,0,1
MOZ,PAN,2015.0,1,0,1
ERI,SWE,2009.0,1,0,1
AUT,ETH,2002.0,2,0,2
AUS,IRQ,2008.0,3,0,3
,COM,2001.0,1,0,1
FRA,COM,2010.0,2,0,2
GIN,SOM,2020.0,1,0,1
TUR,PSE,2001.0,1,0,1
ETH,UGA,2003.0,1,0,1
JPN,CYP,2008.0,2,0,2
FIN,NGA,2003.0,3,0,3
ZAF,GRC,2006.0,1,0,1
JPN,LTU,2002.0,1,0,1
BRA,JAM,2019.0,1,0,1
TUN,CZE,2018.0,1,0,1
BRA,BLZ,2014.0,1,0,1
HUN,QAT,2012.0,2,0,2
HKG,IDN,2011.0,1,0,1
MKD,ISR,1997.0,1,0,1
MKD,SVN,1999.0,1,0,1
CAN,BHS,2014.0,1,0,1
,REU,2003.0,1,0,1
CYP,NOR,2013.0,1,0,1
WSM,,2018.0,2,0,2
JOR,NLD,2006.0,1,0,1
FJI,NGA,2020.0,1,0,1
AUT,GAB,2006.0,1,0,1
SYR,BEL,2004.0,1,0,1
AUT,BHS,2002.0,1,0,1
CAN,NGA,2006.0,2,0,2
IDN,PHL,2008.0,1,0,1
SVN,ESP,1998.0,1,0,1
IRN,NOR,2006.0,1,0,1
LBN,BEL,2010.0,1,0,1
MEX,ROU,2008.0,1,0,1
ASM,WSM,2013.0,1,0,1
SWE,LBY,2012.0,1,0,1
SRB,CHN,2010.0,1,0,1
UZB,ARM,2019.0,1,0,1
UGA,JPN,2009.0,1,0,1
EGY,BRB,2019.0,1,0,1
PRI,USA,2024.0,2,0,2
GRC,HRV,2017.0,2,0,2
THA,SAU,2023.0,3,0,3
BMU,MCO,2007.0,1,0,1
TON,IND,2018.0,1,0,1
ATG,USA,2021.0,1,0,1
MWI,KHM,2013.0,1,0,1
GHA,CMR,2008.0,1,0,1
DEU,PRI,2019.0,1,0,1
MCO,DEU,2007.0,1,0,1
FIN,JAM,2006.0,1,0,1
AUT,LBN,2017.0,1,0,1
CMR,SWE,2003.0,1,0,1
BGD,IRL,2020.0,1,0,1
GBR,CPV,2012.0,1,0,1
ESP,KHM,2020.0,2,0,2
JPN,NER,2010.0,1,0,1
URY,BOL,2020.0,1,0,1
IND,GTM,2020.0,1,0,1
MYS,KAZ,2016.0,1,0,1
ECU,JPN,2011.0,1,0,1
IDN,KOR,2000.0,1,0,1
BGD,VNM,2011.0,1,0,1
AUS,AIA,2021.0,1,0,1
KOR,BLR,2010.0,2,0,2
JOR,BGD,1997.0,1,0,1
PRY,,2012.0,12,0,12
JPN,WSM,2000.0,1,0,1
JPN,BEN,2004.0,1,0,1
RUS,ARG,2000.0,1,0,1
HKG,KHM,2015.0,1,0,1
JPN,GAB,2020.0,1,0,1
BFA,ZWE,2022.0,1,0,1
CHN,NER,2022.0,1,0,1
SSD,USA,2019.0,1,0,1
BLR,KOR,2014.0,1,0,1
SWE,QAT,2016.0,2,0,2
GEO,ETH,2022.0,2,0,2
COD,UGA,2023.0,3,0,3
PHL,PRI,2020.0,1,0,1
MYS,PRT,2023.0,2,0,2
KNA,MEX,2020.0,1,0,1
ITA,LBY,1997.0,1,0,1
MEX,KOR,2003.0,1,0,1
KOR,MEX,2004.0,2,0,2
AUT,TUR,2001.0,2,0,2
BEL,MDA,1997.0,1,0,1
MDA,BEL,1998.0,2,0,2
LBN,NLD,2024.0,1,0,1
ETH,MEX,2004.0,1,0,1
CUB,KHM,2001.0,1,0,1
ITA,CRI,2002.0,1,0,1
CHE,IDN,2006.0,2,0,2
BRA,GEO,2010.0,1,0,1
PAN,ARE,2010.0,1,0,1
SGP,ESP,2002.0,2,0,2
ISL,ZAF,2014.0,1,0,1
POL,SRB,2004.0,4,0,4
NZL,SRB,2010.0,2,0,2
TWN,UZB,1998.0,1,0,1
CHN,HUN,1997.0,1,0,1
TUN,JOR,2014.0,1,0,1
VNM,CAN,2009.0,3,0,3
CAN,BRB,2001.0,1,0,1
SVK,SWE,2012.0,2,0,2
KAZ,SWE,1999.0,1,0,1
BLR,ISR,2008.0,1,0,1
ISR,BLR,2014.0,1,0,1
AUT,HRV,1998.0,3,0,3
VEN,AUS,2011.0,1,0,1
AUT,KEN,2002.0,1,0,1
SVN,BLR,2008.0,1,0,1
ZAF,SLE,2022.0,1,0,1
JOR,IRL,2001.0,1,0,1
BEL,NER,2004.0,1,0,1
COG,CIV,1999.0,1,0,1
SVN,IRL,2007.0,1,0,1
PHL,DOM,1999.0,1,0,1
KEN,NGA,2010.0,2,0,2
ISR,CYP,2009.0,1,0,1
BGR,MEX,2000.0,2,0,2
SWE,PRI,1999.0,1,0,1
CHE,JAM,2007.0,1,0,1
ITA,SOM,2020.0,1,0,1
ARE,AUS,1998.0,2,0,2
CHL,SVK,2002.0,1,0,1
ESP,YEM,1998.0,1,0,1
MSR,,2007.0,1,0,1
CHE,KEN,2003.0,2,0,2
ARG,NAM,2015.0,1,0,1
SVN,IND,2011.0,1,0,1
AUS,KGZ,2019.0,2,0,2
BIH,RUS,2011.0,1,0,1
ERI,ITA,2009.0,1,0,1
BEL,BRN,2009.0,1,0,1
,MRT,2006.0,2,0,2
PRI,SAU,2018.0,1,0,1
ESP,HTI,2014.0,1,0,1
YEM,DZA,2018.0,1,0,1
ISR,PAN,2015.0,1,0,1
AZE,IND,2011.0,1,0,1
ZAF,BGD,2011.0,1,0,1
ZWE,CHE,2020.0,3,0,3
COL,GRC,2012.0,1,0,1
UZB,SYR,2010.0,1,0,1
ESP,GTM,2012.0,2,0,2
DZA,HRV,2013.0,1,0,1
KNA,GBR,2011.0,1,0,1
MMR,GBR,2007.0,2,0,2
UKR,LUX,2023.0,1,0,1
NGA,BIH,2013.0,4,0,4
MYS,MUS,2018.0,1,0,1
EGY,SDN,2013.0,1,0,1
DEU,CIV,2007.0,1,0,1
GTM,CUB,2014.0,1,0,1
BGR,LVA,2015.0,1,0,1
ITA,MAR,2013.0,3,0,3
AUT,HKG,2010.0,1,0,1
BOL,ETH,2017.0,1,0,1
POL,COL,2013.0,1,0,1
VUT,AUS,2011.0,1,0,1
,TCD,1994.0,2,0,2
COM,FRA,2003.0,1,0,1
SYR,IRN,2014.0,1,0,1
SVK,ARM,2003.0,1,0,1
AUT,SAU,2011.0,1,0,1
BRA,AGO,2005.0,1,0,1
ARE,NPL,2012.0,1,0,1
TUR,MWI,2006.0,1,0,1
COG,ETH,2010.0,1,0,1
GEO,BEL,2010.0,1,0,1
IRN,THA,2015.0,2,0,2
FRA,PRI,2003.0,1,0,1
MKD,IND,2020.0,2,0,2
FSM,PLW,2019.0,1,0,1
BEL,TTO,2020.0,2,0,2
EGY,ZAF,2009.0,2,0,2
JOR,HKG,2013.0,2,0,2
SGP,PER,2022.0,1,0,1
,CCK,2013.0,3,0,3
SEN,NOR,2016.0,1,0,1
ESP,VAT,2016.0,1,0,1
BRA,IOT,2018.0,1,0,1
TCD,,2018.0,4,0,4
AUS,BRB,2017.0,1,0,1
ETH,PAK,2019.0,1,0,1
PAN,MEX,2016.0,1,0,1
CHL,PAK,2020.0,1,0,1
ISL,PRT,2021.0,1,0,1
BEL,LVA,2020.0,4,0,4
BEN,UGA,2017.0,2,0,2
MKD,PRT,2022.0,2,0,2
DNK,ZMB,2017.0,2,0,2
IND,LTU,2017.0,2,0,2
KAZ,THA,2023.0,1,0,1
GBR,ZMB,2003.0,7,0,7
HUN,KWT,2023.0,1,0,1
AFG,AUS,2023.0,3,0,3
BGD,CHN,2000.0,1,0,1
CUB,COL,2023.0,2,0,2
SHN,,2024.0,2,0,2
CYP,SWZ,2021.0,1,0,1
NZL,GUM,2021.0,1,0,1
PAN,GBR,2023.0,2,0,2
SSD,ETH,2023.0,1,0,1
BRN,AUS,2009.0,1,0,1
BRA,SVK,2006.0,1,0,1
ETH,PER,2014.0,1,0,1
PER,ETH,2016.0,1,0,1
ZAF,IRL,1998.0,1,0,1
BRB,,1999.0,1,0,1
PRT,TUR,2003.0,1,0,1
GBR,FJI,1998.0,1,0,1
BRA,PER,1997.0,1,0,1
PAK,TWN,2014.0,2,0,2
TWN,ISR,2009.0,1,0,1
IND,BRN,2008.0,1,0,1
CAN,TTO,2006.0,2,0,2
KNA,GBR,2021.0,2,0,2
THA,CHN,2002.0,3,0,3
TZA,OMN,2013.0,1,0,1
SWE,GNB,2016.0,1,0,1
GNB,SWE,2018.0,1,0,1
CRI,PRI,2011.0,1,0,1
PRY,CHL,2011.0,2,0,2
CUB,CZE,2014.0,1,0,1
SWZ,BEL,2008.0,2,0,2
MEX,PRI,2013.0,1,0,1
MWI,GMB,2013.0,1,0,1
IRL,LKA,2017.0,1,0,1
BGD,BWA,2013.0,1,0,1
SRB,BGR,2009.0,1,0,1
EST,NLD,2013.0,1,0,1
NLD,DZA,2019.0,1,0,1
ETH,NPL,2018.0,1,0,1
GUM,IRQ,2018.0,1,0,1
ROU,KNA,2018.0,1,0,1
SYR,KOR,2017.0,1,0,1
,BLZ,2009.0,5,0,5
ITA,CRI,2012.0,2,0,2
LVA,SVK,2013.0,1,0,1
SLB,FJI,2013.0,2,0,2
SGP,MLI,2020.0,1,0,1
IND,TLS,2021.0,1,0,1
,SUR,2009.0,3,0,3
FRA,PSE,2013.0,2,0,2
,AGO,2002.0,4,0,4
ERI,,2018.0,5,0,5
VEN,BRA,2001.0,3,0,3
LUX,DNK,2012.0,1,0,1
TZA,CAN,1999.0,1,0,1
KAZ,UKR,1999.0,1,0,1
GBR,MMR,2004.0,1,0,1
ZMB,ZAF,2004.0,1,0,1
KEN,CHN,2007.0,3,0,3
MNE,RUS,2002.0,1,0,1
IRL,SWE,2024.0,1,0,1
NLD,SLE,2012.0,2,0,2
ETH,IND,2024.0,1,0,1
JAM,ESP,2009.0,1,0,1
ESP,JAM,2010.0,1,0,1
ZWE,NZL,2000.0,1,0,1
PSE,PAK,2009.0,2,0,2
KEN,BEN,2004.0,1,0,1
GRC,TWN,2016.0,3,0,3
HKG,GRC,2006.0,2,0,2
BIH,NGA,2011.0,2,0,2
IND,ATG,2012.0,2,0,2
SMR,USA,2001.0,2,0,2
MYS,KAZ,2017.0,3,0,3
GBR,GIB,2016.0,2,0,2
,TON,1997.0,2,0,2
SRB,JOR,2007.0,1,0,1
BHR,BIH,2020.0,1,0,1
ALB,FRA,2023.0,1,0,1
SDN,QAT,2013.0,1,0,1
JPN,AFG,2012.0,1,0,1
AZE,CZE,2000.0,1,0,1
BRA,SAU,2005.0,1,0,1
ZWE,COG,2015.0,3,0,3
LBY,ARE,2016.0,1,0,1
NCL,TGO,2006.0,1,0,1
BRA,PHL,2010.0,2,0,2
GEO,GBR,1998.0,1,0,1
COG,SWE,2002.0,1,0,1
SDN,USA,2002.0,2,0,2
SAU,BRA,2017.0,1,0,1
PAK,ARG,1999.0,1,0,1
ARM,GBR,2000.0,1,0,1
MNG,AUT,2013.0,1,0,1
GTM,AUT,2016.0,1,0,1
COG,CIV,2007.0,1,0,1
NOR,ISR,2014.0,1,0,1
ARG,CRI,1998.0,1,0,1
GBR,MLI,2009.0,1,0,1
FIN,MEX,2005.0,2,0,2
CAN,CRI,2010.0,1,0,1
CHN,CUB,2006.0,1,0,1
OMN,VEN,2000.0,1,0,1
KNA,CHE,2010.0,1,0,1
MHL,USA,1997.0,1,0,1
MYS,MAC,2003.0,1,0,1
BFA,COG,2016.0,2,0,2
KHM,IND,2016.0,1,0,1
NCL,MDG,2018.0,1,0,1
CMR,TUR,2013.0,1,0,1
MUS,BEL,2004.0,1,0,1
PAN,SGP,2015.0,1,0,1
GIB,,2020.0,2,0,2
PYF,CHL,2023.0,1,0,1
RUS,KNA,2021.0,1,0,1
BEN,KEN,2011.0,2,0,2
SEN,GIN,2006.0,1,0,1
AUS,CMR,2007.0,3,0,3
TUN,JAM,2009.0,2,0,2
TWN,SEN,2013.0,1,0,1
MNE,NOR,2013.0,1,0,1
ALB,GBR,2004.0,1,0,1
PHL,TUR,2021.0,1,0,1
ITA,AZE,2006.0,1,0,1
CAN,GLP,2010.0,1,0,1
SWE,MOZ,2011.0,2,0,2
NZL,RUS,2000.0,1,0,1
RUS,NZL,2002.0,2,0,2
SVN,ARG,2015.0,1,0,1
ITA,THA,2009.0,2,0,2
ROU,QAT,2013.0,1,0,1
IRL,CZE,2001.0,1,0,1
MKD,RUS,2017.0,1,0,1
BFA,KEN,2018.0,2,0,2
KEN,BFA,2021.0,1,0,1
PRY,DEU,2016.0,1,0,1
DEU,PRY,2019.0,1,0,1
LBN,NZL,2011.0,1,0,1
IRN,BGD,2022.0,2,0,2
PRT,PER,2012.0,1,0,1
CAN,MWI,2018.0,3,0,3
BFA,NGA,2005.0,1,0,1
ARE,ZAF,2005.0,1,0,1
QAT,TWN,2010.0,1,0,1
NLD,COL,2001.0,2,0,2
HUN,MYS,2009.0,1,0,1
CHL,BOL,2008.0,3,0,3
ISR,TWN,2013.0,1,0,1
,BHS,2000.0,3,0,3
PRY,,2002.0,2,0,2
BLZ,GBR,2014.0,1,0,1
YEM,AUS,2013.0,1,0,1
NLD,BGR,2017.0,2,0,2
SVN,RUS,2013.0,1,0,1
KEN,THA,2017.0,3,0,3
IDN,TZA,2018.0,1,0,1
GBR,ARE,2024.0,2,0,2
BRN,LKA,2015.0,1,0,1
AUT,BTN,2019.0,2,0,2
BFA,KEN,2022.0,1,0,1
TUR,SRB,2017.0,2,0,2
PRT,FIN,1997.0,2,0,2
ALB,ZAF,2014.0,1,0,1
AGO,GIN,2021.0,1,0,1
ZAF,TUN,2010.0,2,0,2
NLD,ARE,2008.0,1,0,1
RWA,SLE,2020.0,1,0,1
ZAF,CPV,2018.0,1,0,1
CHL,TUN,2018.0,2,0,2
ECU,PAK,2017.0,2,0,2
IRN,DZA,2017.0,1,0,1
QAT,EST,2019.0,1,0,1
BHR,CAN,2019.0,1,0,1
CAN,CYM,2020.0,1,0,1
IDN,LTU,2020.0,1,0,1
PRT,GEO,2018.0,2,0,2
JPN,BOL,2002.0,1,0,1
NAM,HTI,2017.0,2,0,2
STP,,2023.0,7,0,7
,MNP,2017.0,1,0,1
ZWE,GHA,2021.0,1,0,1
BWA,ITA,2020.0,1,0,1
POL,CMR,2022.0,1,0,1
IND,TTO,2007.0,5,0,5
CZE,BRN,2010.0,1,0,1
ETH,CYP,2021.0,1,0,1
BRN,MDV,2021.0,2,0,2
CHN,BOL,2020.0,2,0,2
KAZ,JPN,2022.0,3,0,3
CUB,SWE,2019.0,2,0,2
NER,ZAF,2007.0,1,0,1
GMB,BEL,1999.0,1,0,1
TTO,JOR,2000.0,1,0,1
EGY,BHR,2005.0,1,0,1
IND,LTU,2022.0,2,0,2
LBN,AUS,2022.0,3,0,3
CAN,EGY,2024.0,1,0,1
ARG,NZL,2004.0,1,0,1
CAF,COG,1999.0,1,0,1
BEL,NER,2001.0,1,0,1
IRN,TWN,2007.0,1,0,1
TWN,IRN,2008.0,1,0,1
CHN,DZA,2004.0,1,0,1
VNM,BRA,2014.0,1,0,1
HRV,ESP,2001.0,3,0,3
ZAF,MWI,2002.0,2,0,2
BEL,ARE,2008.0,1,0,1
IND,VNM,1998.0,1,0,1
OMN,TTO,2017.0,1,0,1
MYS,DNK,1999.0,1,0,1
SAU,LBY,2008.0,1,0,1
BRA,POL,1998.0,1,0,1
VEN,PAN,2015.0,2,0,2
BLR,ZAF,2002.0,1,0,1
FIN,ROU,2003.0,1,0,1
ROU,BRA,2012.0,1,0,1
USA,BLR,2017.0,4,0,4
MMR,ITA,2007.0,1,0,1
ISR,SGP,1997.0,1,0,1
AGO,FIN,2012.0,1,0,1
ISR,EGY,2002.0,1,0,1
MDA,ITA,1999.0,1,0,1
BFA,ITA,1998.0,1,0,1
DEU,LUX,1997.0,1,0,1
BGD,BEL,1999.0,1,0,1
CHE,ARE,1997.0,1,0,1
IRL,MTQ,2013.0,1,0,1
URY,COL,2011.0,1,0,1
TWN,ARM,2015.0,1,0,1
ROU,PAK,2011.0,3,0,3
SWE,MOZ,2009.0,2,0,2
LAO,COL,2010.0,1,0,1
NGA,CMR,2015.0,1,0,1
CHE,LKA,2011.0,1,0,1
HRV,MCO,2019.0,1,0,1
USA,NCL,2007.0,2,0,2
SWE,BFA,2010.0,2,0,2
CAN,SDN,2020.0,1,0,1
KOR,CMR,2010.0,2,0,2
FRA,ISL,2009.0,3,0,3
BMU,CYM,2021.0,1,0,1
TUR,LAO,2014.0,1,0,1
LVA,CAN,2015.0,1,0,1
PRT,TUN,2010.0,1,0,1
BHS,ZAF,2013.0,1,0,1
TWN,SVK,2007.0,2,0,2
KEN,COG,2021.0,2,0,2
KHM,GAB,2017.0,1,0,1
SWE,PHL,2010.0,1,0,1
PHL,SWE,2012.0,1,0,1
TTO,PAK,2014.0,1,0,1
CHN,TTO,2019.0,1,0,1
KOR,MYS,2006.0,1,0,1
KEN,LUX,2012.0,1,0,1
FIN,SDN,2007.0,2,0,2
JOR,SDN,2010.0,2,0,2
BGR,HUN,2020.0,2,0,2
PAK,TTO,2017.0,1,0,1
GBR,DOM,2021.0,1,0,1
IND,NER,2022.0,1,0,1
ITA,HTI,2018.0,1,0,1
UKR,MEX,2022.0,1,0,1
NLD,FRA,2024.0,1,0,1
JPN,PSE,2008.0,1,0,1
EGY,ARG,2022.0,2,0,2
DZA,KEN,2018.0,1,0,1
BWA,DEU,2018.0,2,0,2
FIN,CMR,2020.0,1,0,1
CHN,KAZ,2017.0,2,0,2
VNM,GHA,2016.0,1,0,1
IOT,SRB,2017.0,1,0,1
NGA,HKG,2014.0,2,0,2
RUS,PSE,2021.0,1,0,1
BEN,GAB,2023.0,1,0,1
COG,VGB,2020.0,1,0,1
CMR,MOZ,2016.0,1,0,1
KOR,KWT,2020.0,2,0,2
BGR,URY,2021.0,1,0,1
CUB,ZAF,2019.0,1,0,1
TUR,UGA,2023.0,1,0,1
SMR,FRA,2022.0,1,0,1
HUN,IRL,2009.0,2,0,2
BIH,IND,2019.0,1,0,1
KAZ,FRA,2023.0,3,0,3
,CIV,2020.0,56,0,56
NGA,DZA,2017.0,1,0,1
THA,LSO,2023.0,1,0,1
,NER,2020.0,12,0,12
TGO,NGA,2022.0,1,0,1
NPL,BFA,2022.0,1,0,1
BRA,BHR,2020.0,1,0,1
RWA,GHA,2014.0,1,0,1
GLP,BFA,2015.0,2,0,2
LAO,AUS,2009.0,1,0,1
USA,MAC,2004.0,2,0,2
,FSM,1999.0,2,0,2
FSM,,2008.0,1,0,1
NPL,SWE,2010.0,3,0,3
NZL,OMN,2013.0,1,0,1
CHE,OMN,2019.0,1,0,1
GRC,KAZ,2015.0,1,0,1
PAK,BGR,2014.0,2,0,2
GTM,HND,2012.0,1,0,1
MEX,NZL,2009.0,1,0,1
POL,HUN,2010.0,1,0,1
THA,ESP,2010.0,1,0,1
FIN,PAK,2009.0,1,0,1
LUX,POL,2018.0,1,0,1
MLT,EGY,2007.0,1,0,1
NLD,MLI,2014.0,2,0,2
BEN,COG,2007.0,1,0,1
BRA,SLV,2009.0,1,0,1
KEN,AUT,2010.0,2,0,2
ESP,AFG,2002.0,1,0,1
PER,ETH,2022.0,1,0,1
HKG,AUT,2009.0,1,0,1
BRA,IRL,2009.0,2,0,2
MAR,NGA,2013.0,2,0,2
BGD,ZWE,2004.0,1,0,1
BHR,QAT,2012.0,2,0,2
RWA,CMR,2017.0,1,0,1
RUS,GLP,2009.0,1,0,1
BEN,GBR,2009.0,1,0,1
DEU,SYR,2006.0,2,0,2
,GNB,2017.0,8,0,8
PAK,TCD,2015.0,1,0,1
,KIR,2017.0,2,0,2
LBR,FRA,2019.0,1,0,1
DNK,TUN,2020.0,2,0,2
CHE,BHR,2021.0,1,0,1
IRL,JOR,2023.0,1,0,1
JOR,BRN,2021.0,1,0,1
SEN,ARE,2014.0,1,0,1
KEN,IDN,2005.0,1,0,1
IDN,LKA,2011.0,1,0,1
HRV,DNK,1997.0,1,0,1
ARG,COL,2000.0,1,0,1
IRL,ARE,2004.0,1,0,1
AUS,PAN,1997.0,1,0,1
CAN,SLB,2001.0,1,0,1
GLP,SEN,1999.0,1,0,1
GAB,SEN,2009.0,1,0,1
ARM,SWE,2000.0,1,0,1
MWI,EGY,2000.0,1,0,1
MLT,HKG,1998.0,1,0,1
NZL,THA,1998.0,1,0,1
GAB,ESP,2007.0,1,0,1
TJK,KGZ,2023.0,1,0,1
MYS,MEX,2014.0,2,0,2
COL,PRT,2008.0,1,0,1
CHL,NZL,2000.0,3,0,3
NZL,CYP,2018.0,1,0,1
ESP,GTM,1997.0,1,0,1
NGA,UGA,2003.0,1,0,1
TWN,BLR,2011.0,1,0,1
BLR,TWN,2016.0,2,0,2
COL,KOR,2014.0,1,0,1
ERI,ZAF,2005.0,1,0,1
GBR,GRD,2014.0,1,0,1
SYR,AUT,2014.0,1,0,1
JPN,QAT,2015.0,2,0,2
,WSM,2000.0,2,0,2
ETH,ECU,2016.0,1,0,1
ZAF,LUX,2000.0,1,0,1
IDN,TUR,2009.0,1,0,1
HUN,ZAF,1999.0,1,0,1
ECU,ARE,2019.0,1,0,1
BMU,,2008.0,1,0,1
NZL,VNM,2006.0,1,0,1
UZB,CZE,2014.0,1,0,1
HUN,TUN,2018.0,1,0,1
VNM,IDN,2000.0,1,0,1
BEL,HKG,2005.0,1,0,1
UKR,GRC,2014.0,1,0,1
IND,CIV,2015.0,1,0,1
TZA,COL,2020.0,1,0,1
MTQ,KAZ,2011.0,1,0,1
MEX,IDN,2016.0,1,0,1
GBR,TUN,2003.0,2,0,2
QAT,AUT,2017.0,1,0,1
CHE,CAF,2019.0,1,0,1
NGA,AFG,2019.0,1,0,1
FRA,HKG,1998.0,6,0,6
ALB,DZA,1999.0,1,0,1
IND,COL,1999.0,1,0,1
SWE,MNE,2016.0,1,0,1
GBR,MUS,2022.0,1,0,1
USA,BTN,2015.0,1,0,1
GRC,TUR,2023.0,2,0,2
MWI,CHE,2015.0,4,0,4
POL,HKG,2020.0,3,0,3
ESP,VNM,2015.0,1,0,1
FJI,HKG,2009.0,1,0,1
ROU,LTU,2022.0,1,0,1
CYP,AUS,2022.0,1,0,1
MWI,GHA,2019.0,1,0,1
NER,UKR,2018.0,2,0,2
NER,UKR,2017.0,1,0,1
,MSR,2015.0,2,0,2
MSR,,2020.0,1,0,1
GHA,DEU,2024.0,1,0,1
ARE,ALB,2020.0,1,0,1
GRC,MLT,2017.0,1,0,1
PYF,ZAF,2020.0,1,0,1
GUF,DZA,2019.0,1,0,1
NLD,DZA,2021.0,1,0,1
TTO,LCA,2021.0,1,0,1
LBN,CZE,2023.0,1,0,1
IRN,COL,2023.0,1,0,1
BFA,BRN,2010.0,1,0,1
TZA,KHM,2017.0,1,0,1
PHL,COL,1997.0,2,0,2
BRA,THA,2020.0,1,0,1
JPN,KAZ,2023.0,1,0,1
PHL,PER,2013.0,1,0,1
UGA,CHE,2007.0,2,0,2
LBR,TUN,2023.0,1,0,1
MAR,EGY,2012.0,1,0,1
,ATG,2020.0,2,0,2
BGR,CYP,2023.0,1,0,1
NZL,VNM,2024.0,1,0,1
SDN,FRA,2023.0,1,0,1
BEL,GEO,2023.0,1,0,1
CAN,SLE,2021.0,2,0,2
CHE,SOM,2023.0,1,0,1
,TON,2002.0,4,0,4
FJI,NCL,2007.0,1,0,1
BFA,CMR,2005.0,2,0,2
DEU,PRI,2021.0,1,0,1
IDN,UZB,2020.0,1,0,1
CHE,FLK,2007.0,1,0,1
FLK,AUT,2011.0,1,0,1
SRB,SGP,2016.0,3,0,3
VEN,ECU,2007.0,1,0,1
ARG,CZE,2010.0,1,0,1
CHE,TUN,2004.0,3,0,3
NGA,BLZ,2017.0,1,0,1
BRN,SAU,2009.0,1,0,1
JPN,SDN,2004.0,2,0,2
CHN,CMR,2012.0,1,0,1
ZAF,ARG,2012.0,1,0,1
UZB,BLR,2013.0,1,0,1
SWE,SVN,2012.0,1,0,1
IRN,LBN,2015.0,1,0,1
LBN,IDN,2017.0,1,0,1
BWA,COG,2011.0,1,0,1
DNK,IRQ,2018.0,1,0,1
AND,USA,2011.0,1,0,1
NOR,ZWE,2005.0,1,0,1
GBR,KNA,2008.0,1,0,1
PRT,NOR,2005.0,1,0,1
MCO,CAN,2006.0,1,0,1
CHE,LBN,2007.0,2,0,2
USA,SLV,2000.0,3,0,3
SRB,BHS,2016.0,1,0,1
LUX,LBN,2020.0,1,0,1
SWE,LKA,2004.0,2,0,2
,SOM,2001.0,1,0,1
LBR,PAK,2021.0,1,0,1
KOR,TLS,2021.0,1,0,1
CIV,MLI,2013.0,3,0,3
BGD,DEU,2001.0,1,0,1
SRB,FIN,2010.0,1,0,1
ERI,ZAF,2012.0,1,0,1
ITA,GNB,2010.0,2,0,2
NGA,THA,2009.0,1,0,1
USA,KGZ,2017.0,1,0,1
SWE,OMN,2012.0,1,0,1
ETH,LSO,2006.0,1,0,1
VEN,ISR,2008.0,1,0,1
ESP,GUM,2019.0,1,0,1
CIV,KEN,2018.0,1,0,1
GBR,TLS,2013.0,1,0,1
CHE,CUB,2001.0,1,0,1
ESP,BLZ,2013.0,1,0,1
GBR,MNG,2001.0,1,0,1
SAU,TWN,2009.0,1,0,1
GMB,CAN,2011.0,1,0,1
CRI,CHE,2010.0,1,0,1
VEN,DZA,2008.0,1,0,1
CAN,FJI,2014.0,1,0,1
CUB,VEN,2008.0,1,0,1
IRN,BGD,2017.0,2,0,2
NGA,MWI,2018.0,2,0,2
MWI,NGA,2019.0,1,0,1
NOR,LUX,2016.0,2,0,2
RWA,MDG,2008.0,1,0,1
SVN,GRC,2012.0,1,0,1
ITA,SDN,2017.0,1,0,1
ROU,GRC,2022.0,1,0,1
SLV,BRA,2016.0,1,0,1
NOR,VNM,2018.0,4,0,4
ARE,BRN,2020.0,1,0,1
JOR,FIN,2020.0,1,0,1
THA,COL,2015.0,1,0,1
GTM,ECU,2022.0,1,0,1
,FRO,2006.0,3,0,3
CHN,ERI,2015.0,1,0,1
MAR,MRT,2013.0,1,0,1
TUN,AUS,2015.0,1,0,1
IND,MKD,2013.0,1,0,1
CAN,YEM,2016.0,1,0,1
MYS,DEU,2002.0,2,0,2
NGA,LTU,2018.0,1,0,1
JOR,ROU,2019.0,1,0,1
MWI,FIN,2010.0,1,0,1
IRQ,BEL,2019.0,1,0,1
OMN,CMR,2019.0,1,0,1
COG,MDG,2018.0,1,0,1
THA,BFA,2018.0,1,0,1
NZL,PER,2015.0,1,0,1
NGA,MAR,2021.0,1,0,1
CYP,MLT,2022.0,1,0,1
PSE,SRB,2021.0,1,0,1
MYS,ETH,2010.0,1,0,1
LBR,CHE,2021.0,1,0,1
HUN,MNE,2020.0,1,0,1
ETH,EGY,2019.0,1,0,1
IRL,ISL,2005.0,1,0,1
TZA,ESP,2021.0,1,0,1
NGA,IRL,2023.0,4,0,4
SJM,SWE,2022.0,1,0,1
MDG,ROU,2005.0,1,0,1
TUR,ARM,2020.0,1,0,1
MYS,KGZ,2021.0,1,0,1
AUS,ABW,2021.0,1,0,1
MLT,CHE,2009.0,1,0,1
GBR,MNG,2004.0,1,0,1
BWA,PRT,2007.0,1,0,1
HRV,BEL,2005.0,1,0,1
MYS,MAR,2005.0,1,0,1
SGP,SRB,2009.0,1,0,1
FIN,GRC,2008.0,2,1,1
NGA,CHE,2008.0,1,1,0
BRN,GBR,2015.0,2,10,-8
EGY,SYR,2012.0,2,1,1
ZAF,BFA,2000.0,2,1,1
ITA,IRN,2008.0,1,13,-12
ZWE,GBR,2010.0,3,1,2
ZAF,RWA,2009.0,2,2,0
KEN,BEN,2010.0,1,1,0
DNK,TWN,2017.0,4,2,2
KGZ,TUR,2023.0,3,1,2
AUS,KEN,2003.0,3,1,2
BEL,PHL,2010.0,3,2,1
DEU,SVN,2001.0,2,7,-5
ROU,CHL,2021.0,1,1,0
SVK,GBR,2017.0,6,7,-1
NOR,HUN,2020.0,1,10,-9
JPN,LAO,2017.0,3,4,-1
IND,SYR,2019.0,1,1,0
QAT,HKG,2020.0,1,2,-1
BLR,BEL,2019.0,3,1,2
ESP,DOM,2000.0,1,1,0
POL,EGY,2011.0,1,4,-3
GRC,TUR,2008.0,1,1,0
GHA,MYS,2014.0,3,1,2
BHR,USA,2020.0,3,3,0
PRT,ISR,2021.0,1,2,-1
MLI,GIN,2020.0,1,1,0
FIN,KEN,2022.0,1,1,0
POL,KOR,2021.0,3,5,-2
ARG,PRT,2016.0,2,8,-6
NZL,WSM,2021.0,3,3,0
GBR,CUB,2005.0,1,3,-2
CHE,BGD,2012.0,2,1,1
POL,CHL,2013.0,1,2,-1
MEX,NLD,2008.0,1,9,-8
DZA,CHE,2019.0,1,3,-2
LBN,TUN,2016.0,1,2,-1
IND,SYR,2021.0,2,1,1
RUS,SVK,2021.0,3,5,-2
GBR,GNB,2021.0,1,1,0
JPN,FJI,2015.0,2,1,1
BRA,QAT,2013.0,1,1,0
ARG,SWE,2004.0,5,2,3
CHE,GRC,2008.0,4,10,-6
KOR,ZAF,2009.0,1,1,0
BEN,NGA,2022.0,2,3,-1
SVK,SRB,2012.0,1,2,-1
TWN,NLD,2014.0,5,4,1
SAU,PRT,2019.0,1,3,-2
DNK,EST,2019.0,1,3,-2
PRT,SVN,2015.0,1,2,-1
SDN,DEU,2005.0,4,3,1
POL,KOR,2009.0,1,4,-3
SYC,GBR,2004.0,1,1,0
IRL,RUS,2019.0,2,6,-4
BTN,IND,2014.0,1,1,0
IRL,ARG,2021.0,1,3,-2
AUT,BRA,2015.0,3,6,-3
DEU,CMR,2006.0,2,3,-1
DEU,TUN,2006.0,3,1,2
CHL,JPN,2023.0,2,1,1
COD,USA,2016.0,1,2,-1
SAU,ROU,2015.0,1,3,-2
OMN,NLD,2015.0,1,2,-1
MWI,DEU,2019.0,2,2,0
CZE,SRB,2000.0,1,4,-3
ITA,UKR,2015.0,2,3,-1
OMN,ESP,2023.0,1,0,1
EGY,IRL,2006.0,1,0,1
SWE,ECU,2017.0,1,0,1
LAO,VNM,2012.0,4,0,4
MYS,UKR,2013.0,1,0,1
NPL,UGA,2017.0,1,0,1
MAR,DZA,2008.0,2,0,2
SEN,CAN,2006.0,2,0,2
ROU,KOR,2017.0,1,0,1
NER,ITA,2011.0,1,0,1
SWE,MKD,2008.0,1,0,1
BMU,THA,2015.0,1,0,1
REU,GBR,2012.0,3,0,3
FRA,PNG,2009.0,2,0,2
NER,ETH,2013.0,1,0,1
TTO,SUR,2014.0,1,0,1
HND,MEX,2013.0,1,0,1
FIN,LTU,2006.0,2,0,2
CMR,CHN,2006.0,1,0,1
KOR,ZMB,2022.0,1,0,1
TUR,PSE,2006.0,2,0,2
LBY,BHR,2018.0,1,0,1
MYS,FIN,2004.0,1,0,1
ZAF,TGO,2005.0,1,0,1
PHL,IDN,2018.0,2,0,2
CIV,BFA,2020.0,3,0,3
LSO,,2004.0,1,0,1
NLD,GTM,2007.0,1,0,1
ISL,LAO,2013.0,1,0,1
MKD,BGR,2004.0,1,0,1
THA,HRV,2014.0,1,0,1
MDG,JPN,2001.0,2,0,2
MAR,ZAF,2004.0,2,0,2
BDI,,1999.0,2,0,2
AUS,CYM,2015.0,1,0,1
TTO,ARE,2010.0,1,0,1
BEL,EGY,2011.0,2,0,2
DNK,GHA,2007.0,2,0,2
BRA,MAC,2012.0,1,0,1
ZAF,HUN,2010.0,1,0,1
VEN,NOR,2013.0,1,0,1
GUY,GBR,2008.0,1,0,1
TWN,OMN,2010.0,1,0,1
SRB,NZL,2012.0,1,0,1
MEX,TWN,2003.0,1,0,1
OMN,SWE,2006.0,1,0,1
KEN,BDI,2006.0,1,0,1
BEN,CMR,2006.0,1,0,1
AUT,PRT,1999.0,3,0,3
ECU,CHN,2014.0,1,0,1
OMN,VNM,2018.0,1,0,1
TUN,CAF,2011.0,3,0,3
GBR,TLS,2011.0,1,0,1
SWE,BRB,2007.0,1,0,1
TUN,SRB,2006.0,2,0,2
LKA,SDN,2008.0,1,0,1
CUB,CHE,2003.0,1,0,1
LTU,AUT,2000.0,1,0,1
PRT,URY,2015.0,1,0,1
GRC,JOR,2017.0,1,0,1
IRN,KOR,2001.0,1,0,1
MMR,SGP,2007.0,1,0,1
PAK,KEN,2012.0,1,0,1
FIN,LBY,2010.0,2,0,2
ITA,REU,2012.0,1,0,1
KAZ,DNK,2014.0,2,0,2
IRQ,OMN,2008.0,1,0,1
GBR,COD,2013.0,1,0,1
HUN,IRN,2005.0,2,0,2
IDN,FJI,2014.0,1,0,1
RWA,IND,2013.0,1,0,1
BRA,BIH,2022.0,1,0,1
IRL,LBY,2002.0,1,0,1
MAR,ARE,2015.0,3,0,3
BEN,KEN,2013.0,1,0,1
SVN,GRC,2016.0,2,0,2
CHN,CZE,2008.0,1,0,1
NZL,ISL,2021.0,1,0,1
MDV,NZL,2016.0,1,0,1
BRA,BRB,2018.0,1,0,1
STP,PRT,2011.0,1,0,1
ISL,FRO,2013.0,1,0,1
NPL,PHL,2021.0,1,0,1
IRN,LUX,2017.0,2,0,2
MKD,ITA,2017.0,2,0,2
NLD,MNG,2021.0,2,0,2
CYP,JAM,2019.0,2,0,2
CHE,KAZ,2019.0,1,0,1
FIN,MDG,2018.0,1,0,1
OMN,VNM,2022.0,1,0,1
BGD,AFG,2018.0,1,0,1
,NIU,2015.0,1,0,1
TUR,TUN,2023.0,3,0,3
BGR,ZAF,2000.0,1,0,1
NLD,MOZ,2021.0,1,0,1
CHL,ISR,2017.0,2,0,2
ISL,ARE,2022.0,1,0,1
GHA,AUT,2007.0,1,0,1
MDA,USA,1999.0,1,0,1
EST,CHE,2000.0,1,0,1
BRA,VNM,2005.0,1,0,1
VNM,BRA,2006.0,1,0,1
CIV,BRA,2002.0,1,0,1
NGA,TTO,2003.0,1,0,1
LKA,NPL,2011.0,1,0,1
LAO,,2003.0,2,0,2
IND,LKA,1999.0,1,0,1
GBR,CUB,1997.0,3,0,3
PER,UGA,2010.0,1,0,1
HND,GBR,1999.0,1,0,1
GHA,NLD,1999.0,1,0,1
COG,JPN,1999.0,1,0,1
ERI,,2002.0,1,0,1
SWZ,RWA,2016.0,1,0,1
MDA,MDV,1998.0,1,0,1
ZAF,LUX,2015.0,1,0,1
ABW,NLD,2007.0,1,0,1
THA,PAK,2006.0,1,0,1
SRB,GHA,2007.0,1,0,1
NZL,BWA,2007.0,1,0,1
AUS,LAO,2003.0,1,0,1
ROU,GRC,1997.0,1,0,1
MWI,THA,2006.0,1,0,1
PAK,QAT,1998.0,1,0,1
ITA,PNG,2003.0,1,0,1
NER,THA,2010.0,1,0,1
SEN,GAB,2021.0,1,0,1
BGR,LVA,2010.0,1,0,1
DJI,VNM,2018.0,1,0,1
MLT,GRC,1997.0,1,0,1
KHM,PHL,2009.0,1,0,1
CHE,GMB,2011.0,1,0,1
TUN,BRN,2011.0,1,0,1
RUS,EST,2024.0,1,0,1
AZE,UKR,2000.0,1,0,1
SWE,SWZ,2008.0,2,0,2
CHE,UKR,1998.0,2,0,2
GBR,GAB,2005.0,2,0,2
BWA,MWI,2018.0,1,0,1
MYS,TWN,2008.0,2,0,2
LUX,SVK,2016.0,1,0,1
LIE,GBR,2007.0,1,0,1
KOR,LTU,2005.0,1,0,1
GRC,DZA,2012.0,1,0,1
GRC,SVN,2007.0,1,0,1
,MNP,2005.0,1,0,1
CYP,IRL,2004.0,1,0,1
IDN,VEN,2018.0,1,0,1
FRA,JAM,2000.0,1,0,1
SVK,JOR,2001.0,1,0,1
LAO,KOR,2006.0,1,0,1
ITA,HND,2009.0,1,0,1
FRA,HTI,2011.0,2,0,2
NIC,CRI,2013.0,1,0,1
AUS,NLD,2024.0,1,0,1
UKR,IRN,2013.0,1,0,1
MDG,RWA,2020.0,1,0,1
JPN,LUX,2017.0,1,0,1
SRB,CHL,2015.0,1,0,1
MDG,ZWE,2009.0,1,0,1
ROU,HKG,2011.0,1,0,1
NLD,NIC,2017.0,1,0,1
TLS,SGP,2010.0,1,0,1
UKR,DNK,2018.0,2,0,2
,SOM,2010.0,1,0,1
MEX,THA,2016.0,1,0,1
DZA,MEX,2016.0,2,0,2
JPN,TJK,2015.0,1,0,1
BRA,BIH,2016.0,1,0,1
GEO,ARM,2020.0,1,0,1
VUT,NCL,2001.0,1,0,1
KAZ,MYS,2013.0,1,0,1
BRA,HKG,2022.0,3,0,3
MYS,ROU,2019.0,1,0,1
TUN,MRT,2020.0,1,0,1
JAM,NLD,2020.0,1,0,1
PRT,PYF,2015.0,1,0,1
LAO,IND,2019.0,1,0,1
SGP,NPL,2022.0,2,0,2
BRA,RWA,2020.0,1,0,1
KEN,CZE,2023.0,1,0,1
ARG,AUT,2014.0,2,0,2
ESP,GRD,2023.0,1,0,1
NER,BFA,2021.0,2,0,2
IDN,CZE,2022.0,1,0,1
BLR,JOR,2021.0,1,0,1
ROU,COL,2023.0,1,0,1
IRQ,ABW,2022.0,2,0,2
LUX,TZA,2021.0,1,0,1
SLV,EGY,2006.0,1,0,1
MOZ,,2004.0,3,0,3
OMN,BGD,2021.0,2,0,2
DJI,FRA,2023.0,1,0,1
NGA,TUN,2013.0,1,0,1
PAN,GBR,2015.0,3,0,3
HUN,TWN,2014.0,1,0,1
GBR,GUM,2004.0,1,0,1
CAN,SVN,2017.0,1,0,1
ARG,BOL,2017.0,1,0,1
NZL,KHM,2015.0,1,0,1
SGP,ARG,2013.0,1,0,1
NLD,BOL,2017.0,2,0,2
CHE,PAN,2013.0,1,0,1
MDG,CHE,2020.0,1,0,1
PRY,MEX,2014.0,1,0,1
IDN,BFA,2014.0,1,0,1
PSE,AUS,2013.0,1,0,1
POL,LUX,2005.0,1,0,1
OMN,CHN,2020.0,1,0,1
CHE,MWI,2000.0,1,0,1
SDN,TUN,2021.0,1,0,1
MMR,SGP,2020.0,2,0,2
HUN,AZE,2023.0,1,0,1
LBN,MEX,2016.0,1,0,1
JPN,QAT,2010.0,1,0,1
MAR,CIV,2018.0,1,0,1
MCO,SWE,2004.0,1,0,1
URY,CAN,2003.0,2,0,2
CZE,TUN,2017.0,1,0,1
CAN,BDI,2017.0,1,0,1
SVN,BIH,2002.0,3,0,3
SWE,KNA,2015.0,1,0,1
NOR,TUN,2011.0,1,0,1
BRB,THA,2001.0,1,0,1
HUN,CUB,2012.0,1,0,1
BGD,NOR,2007.0,2,0,2
JAM,AUT,2010.0,1,0,1
AUT,CMR,2003.0,2,0,2
MYS,RUS,2011.0,1,0,1
TCA,GBR,2016.0,1,0,1
RWA,TUR,2017.0,1,0,1
MYS,BHR,2007.0,1,0,1
NLD,BRN,2015.0,1,0,1
MDG,BDI,1998.0,1,0,1
LTU,ISR,2003.0,1,0,1
BRN,FJI,2014.0,1,0,1
ISR,ZAF,2002.0,2,0,2
BEL,GEO,2001.0,1,0,1
MRT,DJI,2004.0,1,0,1
FIN,MDA,2011.0,2,0,2
ZAF,MLI,2017.0,2,0,2
IND,UGA,2008.0,1,0,1
TUR,JOR,2004.0,1,0,1
NZL,ARE,2003.0,4,0,4
TJK,,1999.0,1,0,1
,FSM,1995.0,1,0,1
MKD,HUN,2013.0,1,0,1
MEX,QAT,2012.0,1,0,1
TUN,IRL,2012.0,1,0,1
OMN,NGA,2015.0,1,0,1
IRN,ARE,2005.0,1,0,1
IRQ,DEU,2003.0,1,0,1
AUT,NOR,2004.0,5,0,5
LBY,ARE,2012.0,1,0,1
SVN,SWE,2003.0,2,0,2
KWT,CHN,2017.0,1,0,1
KEN,NZL,2021.0,2,0,2
DNK,NAM,2017.0,1,0,1
USA,MDV,2004.0,1,0,1
BEL,CMR,1997.0,1,0,1
HUN,PRT,2013.0,1,0,1
HKG,KEN,2019.0,3,0,3
ESP,LUX,2024.0,1,0,1
BIH,QAT,2006.0,1,0,1
MEX,SVK,2004.0,1,0,1
TON,,2013.0,3,0,3
SVK,ZAF,2005.0,1,0,1
,TCD,2003.0,3,0,3
BGR,KGZ,2006.0,2,0,2
ZAF,JOR,2006.0,1,0,1
ZWE,BRB,1997.0,1,0,1
CYP,ROU,2012.0,1,0,1
,MNE,1999.0,3,0,3
JOR,MAR,2019.0,1,0,1
JOR,MAR,2021.0,1,0,1
LAO,PHL,2012.0,1,0,1
MOZ,LUX,2014.0,1,0,1
BTN,THA,2016.0,1,0,1
FJI,NZL,2014.0,2,0,2
LBN,IND,2016.0,1,0,1
GRC,NGA,2016.0,1,0,1
TGO,GBR,2019.0,1,0,1
UKR,BGR,2014.0,1,0,1
NGA,MLI,2018.0,1,0,1
UGA,NZL,2014.0,1,0,1
NZL,LAO,2014.0,1,0,1
CHN,MMR,2013.0,1,0,1
BEL,MLT,2014.0,1,0,1
URY,FRA,2024.0,1,0,1
HKG,KAZ,2016.0,1,0,1
EGY,ALB,2019.0,1,0,1
MKD,GBR,2017.0,1,0,1
KOR,GBR,2024.0,1,0,1
PRY,BRA,1997.0,1,0,1
PRY,BRA,2002.0,1,0,1
IOT,IND,2011.0,1,0,1
BWA,AUT,2023.0,1,0,1
BFA,GIN,2023.0,1,0,1
MAR,CIV,2017.0,3,0,3
CUB,NZL,2018.0,1,0,1
BIH,SWE,2018.0,1,0,1
PRT,LBY,2017.0,1,0,1
CPV,PRT,2005.0,1,0,1
SLE,SOM,2020.0,1,0,1
NZL,PRT,2018.0,1,0,1
MOZ,ZWE,2020.0,1,0,1
JOR,HKG,2019.0,3,0,3
USA,AIA,2015.0,2,0,2
HRV,SWE,2009.0,1,0,1
ZAF,FJI,2013.0,1,0,1
IND,BMU,2012.0,1,0,1
VEN,SAU,2017.0,1,0,1
UZB,DEU,2002.0,2,0,2
BOL,PAN,2005.0,1,0,1
PAK,MAC,2023.0,1,0,1
MDG,LAO,2013.0,1,0,1
SVK,BEL,2023.0,1,0,1
NAM,AUS,2016.0,1,0,1
NPL,TWN,2017.0,1,0,1
NPL,BGD,2007.0,1,0,1
ETH,MLI,2000.0,1,0,1
GBR,MDG,2006.0,1,0,1
VAT,,2019.0,2,0,2
NOR,COL,2010.0,1,0,1
POL,BGR,2010.0,1,0,1
CHN,ZAF,1999.0,1,0,1
VNM,CHN,2001.0,1,0,1
PHL,PNG,1998.0,1,0,1
ESP,GUM,2003.0,1,0,1
SGP,QAT,2014.0,5,0,5
JPN,BLR,2019.0,1,0,1
BEL,MLT,2015.0,1,0,1
TZA,BEN,2022.0,1,0,1
BEL,MCO,2013.0,1,0,1
ZAF,ARG,2016.0,1,0,1
MAR,YEM,2013.0,2,0,2
CIV,GBR,2023.0,1,0,1
CAN,EUE,2019.0,1,0,1
RWA,VNM,2022.0,1,0,1
JPN,JAM,2014.0,3,0,3
NGA,IDN,2013.0,1,0,1
SWE,GBR,2024.0,1,0,1
RWA,IRQ,2018.0,1,0,1
KEN,NIC,2012.0,1,0,1
BRA,BGR,2017.0,1,0,1
KEN,JOR,2019.0,1,0,1
AUT,KWT,1998.0,1,0,1
SWE,OMN,2022.0,2,0,2
IRN,THA,2024.0,2,0,2
AFG,NLD,2022.0,1,0,1
IDN,LUX,2011.0,1,0,1
HUN,KAZ,2014.0,1,0,1
GRC,ISR,2023.0,1,0,1
BFA,NGA,2017.0,1,0,1
TUR,CHL,2018.0,1,0,1
TUR,PSE,2000.0,1,0,1
TUR,PRI,2003.0,1,0,1
ETH,FIN,2018.0,1,0,1
JOR,HUN,2018.0,1,0,1
NOR,NAM,2019.0,1,0,1
PRT,MAR,2018.0,1,0,1
MAC,IRL,2020.0,1,0,1
BWA,FIN,2020.0,1,0,1
ROU,VNM,2016.0,1,0,1
GHA,TGO,2021.0,1,0,1
IND,NAM,2023.0,3,0,3
ABW,NLD,2020.0,2,0,2
RUS,MCO,2020.0,1,0,1
MMR,CHE,2023.0,2,0,2
IDN,BDI,2020.0,1,0,1
AZE,ARM,2022.0,1,0,1
CHN,LBY,2009.0,1,0,1
TUR,ARE,2005.0,2,0,2
CYP,MLT,2005.0,1,0,1
NGA,CRI,2019.0,1,0,1
UGA,NGA,2010.0,1,0,1
GHA,BWA,2011.0,1,0,1
TKM,,2003.0,1,0,1
LBN,CHL,2020.0,1,0,1
,TUV,2001.0,1,0,1
TUV,,2024.0,1,0,1
KEN,THA,2012.0,1,0,1
CHE,BWA,2015.0,1,0,1
NLD,PER,2011.0,1,0,1
LTU,TWN,2008.0,1,0,1
SVK,PRI,2009.0,1,0,1
BEL,GAB,2004.0,1,0,1
ITA,PER,2015.0,1,0,1
CAN,LVA,2007.0,1,0,1
LTU,NLD,2001.0,1,0,1
CZE,KWT,2004.0,1,0,1
ISL,CHE,2004.0,1,0,1
FRA,COD,2004.0,1,0,1
COD,,2006.0,2,0,2
UKR,BGR,2008.0,1,0,1
,MRT,2001.0,1,0,1
MRT,SAU,2016.0,1,0,1
FRA,TCD,1999.0,2,0,2
ISL,FIN,2003.0,1,0,1
KEN,LKA,2019.0,1,0,1
TGO,BEN,2009.0,3,0,3
UZB,ISR,2017.0,1,0,1
AUT,BIH,2010.0,1,0,1
BIH,ARG,2011.0,1,0,1
UZB,KAZ,2011.0,1,0,1
USA,LCA,2014.0,1,0,1
KEN,RUS,2010.0,1,0,1
USA,COG,1997.0,1,0,1
IDN,IRL,2005.0,1,0,1
ARE,DNK,2010.0,2,0,2
SRB,KOR,1999.0,1,0,1
HKG,KOR,1997.0,1,0,1
KOR,IDN,2004.0,1,0,1
TWN,CHE,2000.0,1,0,1
PAN,CRI,2003.0,2,0,2
NOR,SJM,2020.0,1,0,1
ASM,ARM,2011.0,1,0,1
MYS,DZA,2008.0,1,0,1
FRA,YEM,1999.0,1,0,1
MLI,PHL,2010.0,1,0,1
ECU,BEL,2007.0,2,0,2
UZB,KGZ,2017.0,1,0,1
KEN,UGA,1998.0,1,0,1
ZAF,MOZ,2004.0,1,0,1
ROU,BHR,2014.0,1,0,1
PHL,MEX,2013.0,1,0,1
UGA,ZWE,2011.0,2,0,2
ROU,CZE,2004.0,2,0,2
TTO,,1999.0,1,0,1
SVN,UKR,2007.0,1,0,1
ITA,ECU,2011.0,1,0,1
CHL,AUT,2008.0,1,0,1
BRA,BGR,2016.0,1,0,1
GUF,MTQ,2018.0,1,0,1
ROU,IRL,2018.0,1,0,1
TUR,POL,2002.0,2,0,2
FIN,IRQ,2018.0,2,0,2
PSE,JPN,2005.0,1,0,1
AUT,PER,2005.0,1,0,1
PER,TWN,2013.0,1,0,1
MDG,DEU,2002.0,1,0,1
NLD,ZMB,2011.0,1,0,1
KGZ,LTU,2020.0,1,0,1
LTU,KGZ,2022.0,1,0,1
TWN,LTU,1999.0,1,0,1
MLI,NOR,2001.0,1,0,1
CHE,SYC,2004.0,1,0,1
MYS,MLI,2013.0,1,0,1
JOR,IRL,2006.0,1,0,1
GEO,NLD,2009.0,1,0,1
TUR,LBN,2015.0,1,0,1
GBR,VNM,1997.0,3,0,3
CMR,MDG,2011.0,1,0,1
MAR,MRT,2009.0,1,0,1
BEL,GHA,2015.0,3,0,3
GIN,COG,2017.0,1,0,1
MAR,NGA,2019.0,1,0,1
LTU,GRC,2013.0,1,0,1
CHN,BRB,2021.0,1,0,1
PRT,MDG,2017.0,1,0,1
ALB,GBR,2010.0,1,0,1
POL,PHL,2010.0,1,0,1
LBY,SAU,2010.0,2,0,2
BLR,GRC,2015.0,1,0,1
GRC,NGA,2017.0,1,0,1
BOL,BRA,2011.0,1,0,1
COG,GAB,2021.0,1,0,1
ZMB,NZL,2017.0,1,0,1
BGD,PER,2021.0,1,0,1
BOL,ECU,2020.0,7,0,7
KEN,KOR,2019.0,1,0,1
ESP,ALB,2019.0,2,0,2
ETH,SSD,2020.0,1,0,1
POL,CYP,2019.0,1,0,1
USA,MHL,2019.0,1,0,1
ARE,VNM,2019.0,2,0,2
COD,CMR,2019.0,2,0,2
TJK,CHN,2017.0,1,0,1
VNM,ECU,2018.0,1,0,1
MAR,CIV,2016.0,1,0,1
SLB,WSM,2019.0,1,0,1
PAN,PRI,2020.0,1,0,1
ROU,GIB,2020.0,1,0,1
LUX,LAO,2020.0,1,0,1
ISL,ROU,2022.0,1,0,1
CZE,KAZ,2023.0,1,0,1
VUT,FRA,1998.0,1,0,1
PHL,DNK,2020.0,2,0,2
,CCK,1994.0,1,0,1
USA,KNA,2005.0,1,0,1
MSR,TTO,2018.0,2,0,2
PHL,PRT,2009.0,1,0,1
TUR,ARE,2002.0,1,0,1
DEU,GRD,2003.0,1,0,1
GRD,DEU,2005.0,2,0,2
COL,POL,2001.0,2,0,2
USA,MNE,2016.0,2,0,2
GRC,POL,1998.0,1,0,1
SRB,SGP,2002.0,1,0,1
SGP,SRB,2003.0,1,0,1
RUS,JOR,1999.0,1,0,1
SWE,LIE,2016.0,1,0,1
MYS,PER,2012.0,1,0,1
DZA,NOR,2018.0,1,0,1
SDN,JPN,2019.0,3,0,3
SEN,JPN,2010.0,1,0,1
EST,BRA,2016.0,1,0,1
ZAF,MDG,2020.0,1,0,1
GBR,YEM,2009.0,1,0,1
SVK,IRL,2015.0,1,0,1
CHE,UZB,2020.0,1,0,1
HND,JPN,2014.0,1,0,1
NZL,EST,2013.0,1,0,1
LAO,GMB,2009.0,1,0,1
SRB,BRA,2022.0,1,0,1
BOL,ESP,2005.0,1,0,1
CAN,CRI,2008.0,1,0,1
GBR,LBR,2017.0,1,0,1
PRT,ARE,2021.0,1,0,1
CIV,GHA,1998.0,1,0,1
ABW,USA,2018.0,1,0,1
CZE,GTM,2022.0,1,0,1
SDN,JOR,2020.0,1,0,1
BEL,ARE,2006.0,1,0,1
ITA,BWA,2009.0,1,0,1
KAZ,KHM,2020.0,1,0,1
YEM,IRL,2022.0,1,0,1
CHN,LBY,2019.0,1,0,1
CHN,MUS,2015.0,1,0,1
MMR,KOR,2017.0,1,0,1
PAK,AZE,2022.0,1,0,1
LBY,MAR,2016.0,1,0,1
NGA,NOR,2011.0,1,0,1
AUT,HKG,2008.0,1,0,1
,FRO,2004.0,3,0,3
BEN,TGO,2016.0,3,0,3
SVN,BRA,2017.0,2,0,2
,GNQ,2007.0,1,0,1
NAM,CZE,2023.0,1,0,1
SSD,,2013.0,1,0,1
ROU,BGR,2006.0,1,0,1
BRA,HKG,2017.0,1,0,1
EST,CHN,2012.0,1,0,1
KEN,MRT,2008.0,1,0,1
MRT,KEN,2011.0,1,0,1
GTM,BLZ,2021.0,1,0,1
KAZ,AUT,2010.0,1,0,1
KHM,GLP,2005.0,1,0,1
SYR,IRL,2014.0,1,0,1
CMR,CIV,2012.0,2,0,2
ARM,ESP,2000.0,1,0,1
ARM,GRC,2002.0,1,0,1
SYR,MEX,2006.0,1,0,1
MCO,ESP,2016.0,1,0,1
NGA,GNQ,2012.0,1,0,1
KNA,USA,2003.0,1,0,1
MDA,CAN,2013.0,2,0,2
VEN,VNM,2000.0,4,0,4
IND,SYR,2011.0,1,0,1
KOR,BGR,2003.0,1,0,1
MDA,IRL,2009.0,1,0,1
KOR,OMN,2013.0,1,0,1
CHN,JOR,2012.0,1,0,1
FIN,ECU,2021.0,2,0,2
USA,YEM,2008.0,1,0,1
DEU,TZA,2004.0,2,0,2
ARG,SVK,2018.0,1,0,1
KEN,GMB,2009.0,1,0,1
BIH,ESP,2019.0,1,0,1
GRC,UKR,2021.0,1,0,1
IRN,SRB,2018.0,1,0,1
ZWE,NAM,2020.0,1,0,1
NAM,JPN,2021.0,1,0,1
BFA,KEN,2012.0,1,0,1
CHN,IRL,2024.0,1,0,1
LSO,SAU,2020.0,1,0,1
IND,DZA,2023.0,1,0,1
CHL,HND,2023.0,1,0,1
FLK,USA,2023.0,1,0,1
ISR,SDN,2023.0,1,0,1
MAC,IDN,2023.0,1,0,1
GHA,PER,2003.0,2,0,2
JPN,UZB,2010.0,1,0,1
ITA,LVA,2008.0,1,0,1
LKA,PAK,2007.0,1,0,1
LKA,GHA,2008.0,1,0,1
ARG,PER,2000.0,2,0,2
LTU,CYP,2021.0,1,0,1
ESP,PYF,2017.0,1,0,1
ARE,MEX,2009.0,1,0,1
NOR,TWN,2017.0,1,0,1
VCT,TTO,2014.0,1,0,1
CHN,IDN,2005.0,1,0,1
HKG,IDN,2013.0,1,0,1
EST,TWN,2018.0,1,0,1
COD,ITA,2008.0,1,0,1
UKR,IRL,2014.0,1,0,1
NOR,KGZ,2018.0,1,0,1
JPN,MOZ,2011.0,1,0,1
ESP,PAN,2007.0,1,0,1
ALB,DNK,2022.0,1,0,1
CAN,TCD,2020.0,1,0,1
PAK,UGA,2014.0,1,0,1
MWI,ZWE,2013.0,1,0,1
ZWE,DEU,2017.0,3,0,3
CHN,MWI,2016.0,3,0,3
PRT,KWT,2020.0,2,0,2
BRN,MYS,2008.0,2,0,2
KEN,ISL,2022.0,1,0,1
CMR,SEN,2016.0,1,0,1
LTU,BLR,1998.0,1,0,1
NER,IND,2021.0,1,0,1
TUR,IRQ,2007.0,1,0,1
IRQ,IRN,2008.0,1,0,1
MWI,IND,2014.0,1,0,1
CZE,COL,2015.0,2,0,2
ETH,OMN,2010.0,1,0,1
BGD,ZWE,2010.0,1,0,1
SRB,LBY,2014.0,1,0,1
GHA,IRN,2016.0,1,0,1
MEX,HND,2016.0,1,0,1
UKR,DZA,2019.0,1,0,1
THA,OMN,2006.0,1,0,1
LIE,AUT,2016.0,1,0,1
BLZ,JPN,2016.0,1,0,1
NLD,IRQ,2017.0,1,0,1
TZA,BEN,2017.0,2,0,2
BEN,DNK,2018.0,1,0,1
CHE,MOZ,2013.0,2,0,2
GBR,CPV,2022.0,1,0,1
MDV,AUS,2023.0,1,0,1
COL,AUT,2022.0,1,0,1
ARG,ARE,2022.0,2,0,2
PAK,LKA,2023.0,1,0,1
BIH,MNE,2022.0,2,0,2
MNE,BIH,2023.0,1,0,1
SAU,NPL,2022.0,1,0,1
IRQ,BGD,2022.0,1,0,1
PLW,USA,1997.0,2,0,2
GEO,PAK,2012.0,1,0,1
CHE,CYP,2006.0,2,0,2
EGY,YEM,1999.0,2,0,2
JAM,DEU,2021.0,1,0,1
GHA,NLD,1998.0,1,0,1
PNG,NLD,1999.0,1,0,1
PAK,HUN,2008.0,1,0,1
DEU,FLK,2009.0,1,0,1
HND,NIC,2001.0,1,0,1
NGA,AUT,2002.0,1,0,1
SAU,PRT,2021.0,1,0,1
UGA,CAN,2000.0,3,0,3
ROU,URY,2008.0,1,0,1
ECU,NLD,2001.0,2,0,2
EGY,IDN,2013.0,1,0,1
KAZ,GRC,2022.0,1,0,1
ITA,CAF,1997.0,1,0,1
KEN,UGA,1999.0,4,0,4
BEL,PRY,2009.0,1,0,1
SDN,IRL,1997.0,1,0,1
DNK,BOL,2009.0,1,0,1
DEU,VEN,1999.0,1,0,1
ZAF,MKD,2010.0,1,0,1
GUY,CAN,2001.0,1,0,1
PAK,GMB,2019.0,1,0,1
USA,LUX,2001.0,1,0,1
ETH,ZMB,2017.0,1,0,1
YEM,CPV,2004.0,1,0,1
KWT,NGA,2007.0,1,0,1
AUT,CIV,2018.0,1,0,1
SYR,TUR,2015.0,2,0,2
CHL,ZMB,2013.0,1,0,1
LSO,NOR,2016.0,1,0,1
JPN,MLT,2017.0,1,0,1
CHE,PSE,2016.0,2,0,2
,DJI,1997.0,1,0,1
SWE,BEN,2016.0,1,0,1
QAT,CYP,2023.0,1,0,1
TWN,HRV,2006.0,1,0,1
GNQ,GBR,2018.0,1,0,1
CUB,IRL,2006.0,1,0,1
DEU,FRO,2015.0,1,0,1
ESP,GNQ,2014.0,1,0,1
BLR,ITA,2011.0,1,0,1
TTO,BRB,2021.0,1,0,1
KGZ,MYS,2010.0,1,0,1
YEM,TUR,2014.0,1,0,1
CYP,MEX,2013.0,1,0,1
KOR,HUN,2012.0,1,0,1
COL,PRT,2000.0,1,0,1
MLT,SVK,2007.0,1,0,1
SVK,MLT,2012.0,1,0,1
RUS,TZA,2018.0,1,0,1
SYR,OMN,2021.0,2,0,2
OMN,IDN,2014.0,1,0,1
BLR,FIN,2015.0,1,0,1
LKA,MDG,2022.0,1,0,1
AUT,JOR,2023.0,1,0,1
RUS,NZL,2017.0,2,0,2
PRI,ISR,2019.0,1,0,1
TTO,KNA,2011.0,1,0,1
FJI,USA,2021.0,2,0,2
ZMB,MYS,2015.0,1,0,1
AUS,BLZ,2021.0,1,0,1
BIH,SWE,2022.0,1,0,1
MEX,THA,2022.0,1,0,1
IRL,VNM,2013.0,2,0,2
AFG,EGY,2021.0,1,0,1
PHL,KEN,2014.0,1,0,1
AUT,JAM,2009.0,1,0,1
GEO,AUT,2002.0,1,0,1
CHE,PAN,2003.0,1,0,1
NGA,ARE,2012.0,1,0,1
LTU,CZE,2006.0,1,0,1
SMR,,2016.0,1,0,1
KEN,GTM,2022.0,1,0,1
NZL,GMB,2003.0,1,0,1
MEX,ETH,2018.0,1,0,1
JPN,CRI,1999.0,1,0,1
AUS,COG,2017.0,1,0,1
MHL,USA,2017.0,1,0,1
HRV,NOR,2006.0,1,0,1
NLD,MAR,2013.0,2,0,2
TUN,NLD,2018.0,1,0,1
MYS,COM,2021.0,1,0,1
BLR,LTU,2012.0,1,0,1
SDN,ARE,2008.0,1,0,1
NZL,MHL,2010.0,1,0,1
SDN,TZA,2013.0,1,0,1
LBR,LBN,2004.0,1,0,1
VEN,BEL,2002.0,1,0,1
IND,CUB,2019.0,1,0,1
TWN,AZE,2014.0,1,0,1
BGD,SAU,2011.0,2,0,2
LBY,NPL,2010.0,1,0,1
ZAF,MYS,2004.0,1,0,1
FRA,DOM,2006.0,1,0,1
OMN,ROU,2017.0,1,0,1
CHN,BFA,2022.0,1,0,1
YEM,KWT,2010.0,1,0,1
IRQ,DNK,2020.0,2,0,2
,ATA,2006.0,1,0,1
SLE,PAK,2009.0,1,0,1
IRQ,OMN,2015.0,2,0,2
IRQ,QAT,2021.0,2,0,2
ARE,SOM,2019.0,1,0,1
DMA,ECU,2004.0,1,0,1
ECU,DMA,2007.0,1,0,1
PHL,CHE,2000.0,1,0,1
,BTN,1997.0,1,0,1
CRI,ISR,2009.0,1,0,1
NIC,NZL,2007.0,1,0,1
JPN,PER,2010.0,1,0,1
ISR,HUN,2007.0,1,0,1
YEM,LBN,2011.0,1,0,1
USA,QAT,1998.0,1,0,1
,WSM,1996.0,1,0,1
SRB,BGD,2002.0,1,0,1
CHE,EGY,1999.0,1,0,1
USA,DOM,2003.0,1,0,1
TTO,CAN,1999.0,4,0,4
GUM,AUS,2012.0,1,0,1
ISR,NZL,2010.0,2,0,2
NZL,FIN,2004.0,1,0,1
CMR,ITA,2021.0,2,0,2
JPN,SRB,1997.0,3,0,3
GEO,SRB,2021.0,1,0,1
JAM,NLD,1998.0,1,0,1
IRQ,ESP,2004.0,1,0,1
NOR,QAT,2009.0,1,0,1
KWT,CHE,2020.0,1,0,1
SGP,BRN,2021.0,1,0,1
CYM,,2008.0,1,0,1
VGB,PRI,2008.0,1,0,1
JAM,FRA,2016.0,1,0,1
SLV,ITA,2007.0,1,0,1
IDN,HUN,2017.0,1,0,1
SVK,BRA,2015.0,1,0,1
SVK,AUS,2013.0,1,0,1
BEL,CYP,2017.0,2,0,2
SWE,CMR,2014.0,1,0,1
JPN,BOL,2018.0,2,0,2
EGY,BGR,2011.0,1,0,1
HRV,RUS,2002.0,1,0,1
ECU,URY,2019.0,1,0,1
MAR,AUS,2011.0,1,0,1
LBR,GIN,2015.0,1,0,1
VNM,LUX,2021.0,1,0,1
ISL,THA,2018.0,2,0,2
UZB,BEL,2016.0,1,0,1
GBR,SEN,2016.0,2,0,2
SDN,QAT,2021.0,2,0,2
IRL,BGD,2014.0,1,0,1
,LCA,2015.0,3,0,3
CMR,ISR,2020.0,1,0,1
YEM,USA,2023.0,2,0,2
COL,ARE,2022.0,1,0,1
KEN,MLI,2017.0,2,0,2
AFG,CHE,2020.0,1,0,1
IDN,QAT,2017.0,1,0,1
SEN,DNK,2001.0,1,0,1
MDA,SRB,1997.0,1,0,1
DZA,NOR,2022.0,1,0,1
LBY,FRA,2022.0,1,0,1
RUS,KEN,2022.0,1,0,1
ESP,SWE,2024.0,1,0,1
BEL,BWA,2016.0,1,0,1
SGP,SAU,2002.0,1,0,1
FIN,IRQ,2022.0,1,0,1
DOM,BRA,2022.0,1,0,1
THA,MAC,2008.0,2,0,2
,ABW,2020.0,2,0,2
JAM,DOM,2018.0,1,0,1
ETH,DNK,2022.0,1,0,1
NOR,MYS,2004.0,1,0,1
BDI,KEN,2001.0,1,0,1
PAN,JPN,2001.0,1,0,1
THA,ISL,2010.0,1,0,1
JPN,NER,2004.0,1,0,1
SYC,NAM,1998.0,1,0,1
JPN,MAR,2013.0,1,0,1
GUF,,2004.0,1,0,1
OMN,ZAF,2001.0,1,0,1
FLK,AUS,1999.0,1,0,1
THA,OMN,2000.0,1,0,1
NOR,PER,2020.0,1,0,1
NGA,TZA,2016.0,1,0,1
BGD,GHA,2022.0,1,0,1
CHN,BLR,2008.0,1,0,1
MWI,SAU,2015.0,1,0,1
URY,CUB,2002.0,2,0,2
UKR,DZA,2021.0,1,0,1
NZL,EGY,2021.0,1,0,1
VNM,KHM,2018.0,1,0,1
FIN,NOR,2024.0,1,0,1
CRI,GTM,2006.0,1,0,1
OMN,ITA,1998.0,1,0,1
CMR,BRA,2008.0,1,0,1
LIE,ESP,2018.0,1,0,1
MAR,GAB,2020.0,1,0,1
IDN,CHN,2006.0,1,0,1
COG,JPN,2020.0,2,0,2
NGA,QAT,2021.0,1,0,1
TUR,YEM,2018.0,1,0,1
BMU,ISR,2020.0,1,0,1
BDI,GBR,2023.0,1,0,1
IND,PNG,1999.0,1,0,1
ESP,JAM,2015.0,1,0,1
TCA,GRD,2021.0,1,0,1
CUB,AUT,2021.0,1,0,1
HRV,URY,2020.0,1,0,1
LCA,USA,2018.0,1,0,1
GNB,CUB,2020.0,1,0,1
AUS,SYC,1997.0,1,0,1
SYC,,1999.0,1,0,1
BOL,GBR,2021.0,1,0,1
ITA,JPN,2024.0,2,0,2
CHN,PSE,2022.0,1,0,1
BEL,GIN,2011.0,2,0,2
JPN,BOL,2017.0,2,0,2
PER,NGA,2022.0,1,0,1
VNM,OMN,2023.0,1,0,1
LBR,LBY,2020.0,1,0,1
ESP,MOZ,2005.0,1,0,1
TON,DNK,2000.0,1,0,1
DNK,TON,2010.0,1,0,1
BGR,KWT,2007.0,1,0,1
MDA,JOR,2007.0,1,0,1
ESP,DZA,2008.0,2,0,2
CUB,AUT,2009.0,1,0,1
FRA,LTU,1999.0,4,0,4
BEL,SEN,1997.0,1,0,1
RWA,SEN,2013.0,1,0,1
MDG,GHA,2018.0,1,0,1
AUT,ZMB,2006.0,1,0,1
CHE,ZWE,2013.0,2,0,2
CMR,KEN,2008.0,1,0,1
CRI,RUS,2014.0,1,0,1
VNM,NLD,2002.0,1,0,1
CZE,LTU,2005.0,1,0,1
USA,DZA,2005.0,2,0,2
AUS,NAM,2017.0,1,0,1
FRA,MUS,2001.0,1,0,1
VEN,KAZ,2007.0,1,0,1
CHL,MCO,2005.0,1,0,1
LSO,SWZ,2010.0,1,0,1
ECU,SWE,2020.0,1,0,1
AUT,MCO,2013.0,2,0,2
ZAF,COG,2009.0,2,0,2
GBR,DZA,2001.0,2,0,2
CHE,SYC,2001.0,1,0,1
ETH,COG,2007.0,2,0,2
COG,GNQ,2011.0,1,0,1
TZA,BGD,2010.0,1,0,1
CHE,CUB,2006.0,1,0,1
,LCA,1996.0,1,0,1
LCA,CAN,2002.0,1,0,1
PHL,BRA,2013.0,1,0,1
HUN,IRN,2002.0,1,0,1
ZWE,UGA,2000.0,1,0,1
TCD,SEN,2008.0,1,0,1
GEO,BEL,2004.0,1,0,1
ARE,HUN,2017.0,2,0,2
MUS,KEN,2006.0,1,0,1
BRA,HUN,2009.0,1,0,1
MRT,GBR,2003.0,1,0,1
ECU,NZL,2019.0,1,0,1
NGA,DZA,2012.0,1,0,1
LKA,BEL,2003.0,1,0,1
AZE,KOR,2003.0,1,0,1
LBY,SAU,2006.0,1,0,1
BOL,VEN,2006.0,1,0,1
GMB,NZL,2002.0,1,0,1
SLV,,2007.0,1,0,1
NZL,CHE,2004.0,4,0,4
TGO,BFA,2007.0,1,0,1
CMR,SWZ,2009.0,1,0,1
DEU,MDG,2005.0,1,0,1
MDG,DEU,2012.0,1,0,1
SWE,BRN,2010.0,1,0,1
HKG,LKA,2002.0,1,0,1
PAN,CAN,2007.0,2,0,2
PRT,TUN,2001.0,1,0,1
ITA,LBN,2005.0,1,0,1
TWN,IDN,2008.0,1,0,1
SWE,CHL,2001.0,4,0,4
CHN,COG,2006.0,1,0,1
NLD,MKD,2003.0,1,0,1
ESP,THA,2007.0,1,0,1
WSM,CHE,2004.0,1,0,1
BGR,AUS,2002.0,4,0,4
SVK,ISR,2006.0,1,0,1
KWT,NZL,2014.0,1,0,1
KWT,QAT,2013.0,1,0,1
COL,MOZ,2006.0,1,0,1
POL,JAM,2016.0,1,0,1
JAM,POL,2017.0,1,0,1
SDN,RWA,2014.0,1,0,1
CYP,NZL,2008.0,1,0,1
MLT,QAT,2018.0,1,0,1
KHM,NZL,2011.0,1,0,1
ARE,MUS,2014.0,1,0,1
GMB,NGA,2017.0,1,0,1
BIH,GRC,2008.0,1,0,1
LAO,KOR,2010.0,1,0,1
FRA,PRI,2009.0,1,0,1
CYP,SWE,2015.0,1,0,1
BEL,SYR,2005.0,1,0,1
FRA,MUS,2014.0,1,0,1
GEO,KAZ,2013.0,1,0,1
NER,KEN,2009.0,1,0,1
UKR,IND,2005.0,2,0,2
SVK,ISR,2010.0,1,0,1
SDN,BGD,2022.0,1,0,1
EGY,IRL,2010.0,1,0,1
SVN,MKD,2011.0,1,0,1
ZAF,UKR,2020.0,1,0,1
PHL,EGY,2019.0,1,0,1
COD,LAO,2017.0,2,0,2
PRT,JOR,2017.0,1,0,1
ETH,NZL,2018.0,1,0,1
CHN,TGO,2020.0,1,0,1
SRB,KWT,2018.0,1,0,1
UKR,SWZ,2021.0,1,0,1
RWA,EGY,2023.0,1,0,1
CUB,AGO,2022.0,1,0,1
YEM,HKG,2018.0,1,0,1
JPN,HRV,2006.0,1,0,1
COL,MLT,2022.0,1,0,1
IDN,VUT,2017.0,1,0,1
JPN,QAT,2023.0,1,0,1
SGP,RUS,2022.0,1,0,1
,ISR,2021.0,4,0,4
BTN,ZAF,2021.0,1,0,1
THA,SAU,2014.0,1,0,1
SSD,COD,2023.0,1,0,1
IND,ARG,2005.0,1,0,1
,ZAF,2021.0,6,0,6
LTU,ISR,2013.0,1,0,1
FRA,PHL,2006.0,1,0,1
NLD,GMB,2008.0,2,0,2
MAR,DZA,2001.0,2,0,2
SAU,PER,2006.0,1,0,1
LAO,COD,2012.0,1,0,1
COL,ZAF,1998.0,1,0,1
HND,BOL,2000.0,1,0,1
DEU,CYP,1999.0,2,0,2
SWE,ZWE,2008.0,1,0,1
SRB,BEL,2011.0,1,0,1
SWE,MAR,2006.0,1,0,1
MDG,TZA,1997.0,1,0,1
KEN,NGA,2004.0,1,0,1
AUS,EST,2001.0,1,0,1
EST,AUS,2003.0,1,0,1
LBN,DEU,2002.0,1,0,1
FRA,ARE,2005.0,1,0,1
NOR,BIH,2005.0,2,0,2
MRT,NER,2002.0,1,0,1
BEL,LKA,2002.0,1,0,1
KAZ,CZE,1999.0,1,0,1
ZWE,TZA,1999.0,2,0,2
BLR,CHN,1998.0,1,0,1
POL,PAK,1997.0,1,0,1
NOR,EST,1998.0,1,0,1
NPL,MEX,2008.0,1,0,1
BLR,LVA,2002.0,1,0,1
IRN,SWE,1999.0,1,0,1
TWN,IRN,2000.0,1,0,1
LKA,FRA,1999.0,1,0,1
SVK,SLV,2002.0,1,0,1
BFA,TUN,2011.0,1,0,1
OMN,GRC,2019.0,1,0,1
SGP,KWT,2013.0,1,0,1
BRA,SGP,2009.0,1,0,1
MDV,,2013.0,1,0,1
UKR,SGP,2002.0,1,0,1
CHE,KHM,2020.0,1,0,1
COD,GBR,1999.0,1,0,1
MSR,TTO,2017.0,1,0,1
LCA,CAN,2012.0,1,0,1
CAN,SUR,2010.0,1,0,1
EST,LTU,2013.0,1,0,1
BEL,GHA,2014.0,1,0,1
PAN,ITA,2006.0,1,0,1
DEU,SEN,2014.0,1,0,1
TJK,CHE,2010.0,1,0,1
PSE,ITA,2012.0,1,0,1
GIN,VNM,2017.0,1,0,1
UZB,ARE,2010.0,2,0,2
BMU,CHN,2007.0,1,0,1
GBR,SOM,2013.0,1,0,1
CUB,GLP,2007.0,1,0,1
CAN,GIB,2006.0,1,0,1
KHM,ZAF,2010.0,1,0,1
MKD,NLD,2010.0,1,0,1
ISL,CHL,2013.0,1,0,1
GMB,FRA,2020.0,1,0,1
SAU,LUX,2016.0,1,0,1
IND,NOR,2002.0,2,0,2
DNK,LVA,2015.0,1,0,1
MLI,GBR,2021.0,1,0,1
MKD,HRV,2018.0,2,0,2
THA,CHN,2005.0,2,3,-1
SAU,FRA,2003.0,1,3,-2
SWE,GHA,2007.0,1,1,0
ARG,AUT,2006.0,1,1,0
NLD,ABW,2013.0,1,1,0
PNG,NZL,2019.0,1,1,0
DEU,KEN,2008.0,6,8,-2
NAM,GHA,2019.0,1,1,0
SWE,SAU,1998.0,2,2,0
IDN,KEN,2012.0,1,1,0
GTM,MEX,1998.0,1,1,0
FRA,CRI,1999.0,1,2,-1
GRC,ISR,2001.0,3,1,2
MEX,URY,2012.0,1,1,0
CAN,JAM,2003.0,2,1,1
IND,BRA,2006.0,1,3,-2
USA,ZWE,1997.0,4,2,2
CHE,IRN,2010.0,1,16,-15
NLD,ALB,2014.0,1,1,0
PER,ESP,2004.0,1,5,-4
SWZ,SWE,2010.0,2,1,1
DZA,USA,2018.0,4,10,-6
BOL,BEL,2011.0,2,1,1
AUS,KEN,2009.0,4,3,1
GBR,MDG,2014.0,2,2,0
MOZ,ZAF,2005.0,1,2,-1
CAN,TZA,2010.0,1,3,-2
ZAF,PAK,2012.0,1,2,-1
QAT,FRA,2009.0,1,3,-2
DNK,JPN,2023.0,2,7,-5
CHE,LBN,2020.0,2,3,-1
UGA,NGA,2008.0,1,2,-1
BRN,AUS,2021.0,2,2,0
CAN,DZA,2003.0,1,2,-1
KAZ,GBR,2010.0,2,1,1
DNK,LTU,2002.0,2,1,1
POL,IND,2015.0,4,8,-4
NIC,ESP,2008.0,1,2,-1
PAK,BRA,2005.0,1,1,0
TJK,UZB,2014.0,1,4,-3
CHE,ROU,1999.0,2,2,0
RUS,HUN,2021.0,2,1,1
ECU,CHL,2011.0,1,1,0
GRC,DZA,2017.0,1,1,0
QAT,JPN,2022.0,3,1,2
BGD,THA,2011.0,3,2,1
SAU,BRA,2016.0,2,2,0
GTM,ESP,2013.0,1,4,-3
FRA,GHA,2018.0,1,2,-1
OMN,KOR,2020.0,1,4,-3
COG,FRA,2009.0,5,3,2
NPL,PAK,2016.0,1,1,0
PRT,MAR,2012.0,1,1,0
MAR,PRT,2013.0,1,2,-1
KWT,IND,2009.0,2,7,-5
ITA,CUB,2018.0,2,3,-1
RUS,IRN,2015.0,3,7,-4
CZE,FIN,2013.0,2,2,0
BIH,USA,2014.0,3,1,2
KEN,NOR,2021.0,2,1,1
ROU,SRB,2009.0,1,2,-1
SWE,LTU,2022.0,3,3,0
PRT,KOR,2021.0,2,1,1
FRA,GEO,2013.0,1,11,-10
NZL,JOR,1999.0,1,1,0
BHR,IRL,2021.0,1,5,-4
AZE,ESP,2019.0,1,1,0
NOR,ETH,2013.0,4,7,-3
HUN,NZL,2016.0,2,1,1
DEU,MCO,2018.0,1,3,-2
DEU,AZE,2018.0,3,5,-2
OMN,FIN,2012.0,1,1,0
AUS,SVN,2016.0,1,3,-2
LBN,AUS,2017.0,2,3,-1
AUT,SRB,2022.0,2,5,-3
TUR,ZAF,2009.0,2,2,0
DEU,DOM,2012.0,1,1,0
DEU,COL,2005.0,4,4,0
SWE,SAU,1999.0,2,4,-2
NOR,ZAF,2023.0,2,2,0
BRA,GHA,2019.0,1,1,0
GIN,USA,2021.0,2,1,1
UKR,ROU,2021.0,1,1,0
PYF,AUS,2017.0,1,1,0
FRO,DNK,2020.0,3,11,-8
CMR,ZWE,2021.0,1,1,0
BEN,NER,2018.0,3,1,2
TGO,CAN,2021.0,1,1,0
POL,ROU,2011.0,1,1,0
CYP,CHE,2021.0,1,2,-1
SYR,IND,2023.0,2,1,1
JPN,PAK,2023.0,1,14,-13
ESP,KAZ,2018.0,1,2,-1
HUN,ESP,2019.0,4,9,-5
BIH,AUT,2020.0,2,4,-2
CHE,ALB,2018.0,1,1,0
PRK,KOR,2018.0,1,2,-1
ETH,JPN,2004.0,2,3,-1
ISR,DNK,2001.0,2,5,-3
AUT,ZAF,2023.0,4,5,-1
ARG,NOR,2018.0,1,2,-1
GRC,TWN,2018.0,1,1,0
ISL,IRL,2020.0,1,1,0
SWE,KAZ,2017.0,1,2,-1
IND,LBY,2020.0,1,3,-2
MEX,PRT,2021.0,3,1,2
GHA,BEN,2023.0,2,1,1
IRN,ARE,2017.0,3,3,0
AUS,PRT,2015.0,3,11,-8
ARG,PRT,2012.0,2,1,1
CHL,NLD,2009.0,2,1,1
NLD,NAM,2013.0,3,2,1
CHE,MDG,2019.0,2,2,0
HKG,ESP,2014.0,3,2,1
NLD,UGA,2016.0,3,1,2
CHE,MAR,1998.0,1,2,-1
NPL,CAN,2016.0,1,1,0
GBR,SHN,2020.0,1,1,0
CZE,CHL,2023.0,2,2,0
COL,KOR,2015.0,2,1,1
BEL,HUN,2023.0,1,2,-1
FRA,ISL,2021.0,3,2,1
AFG,IND,2019.0,1,5,-4
IND,BRA,2023.0,3,10,-7
IND,HUN,2011.0,2,2,0
BGR,CAN,1997.0,3,7,-4
TZA,JPN,2002.0,4,4,0
SDN,USA,2005.0,1,2,-1
PRI,PER,2004.0,1,1,0
RUS,VNM,2005.0,1,1,0
VNM,RUS,2008.0,1,6,-5
USA,KAZ,2003.0,1,1,0
LVA,USA,2005.0,2,3,-1
CAN,BEN,2001.0,1,1,0
GMB,GBR,2010.0,5,9,-4
URY,PRY,2018.0,2,1,1
PHL,SGP,2015.0,1,3,-2
BEL,TUN,2006.0,3,1,2
USA,NIC,2010.0,2,1,1
PRT,TUR,2013.0,3,3,0
ZAF,LKA,2005.0,1,1,0
GHA,KEN,2001.0,1,1,0
FJI,GBR,2017.0,2,4,-2
LBY,FRA,2012.0,1,2,-1
BLR,FRA,2013.0,1,1,0
USA,CIV,2009.0,2,2,0
BWA,CMR,2018.0,1,1,0
PRT,FIN,2012.0,2,3,-1
GHA,BEN,2010.0,1,1,0
GMB,GHA,2020.0,2,1,1
VNM,DEU,2000.0,2,4,-2
TUR,TWN,2002.0,2,1,1
FRA,CAF,2014.0,3,3,0
CZE,NOR,2004.0,2,1,1
USA,GUY,2006.0,3,2,1
ZAF,LKA,2012.0,1,1,0
NOR,TUR,2009.0,2,2,0
EST,NZL,2016.0,1,1,0
TUR,SOM,2023.0,3,5,-2
MKD,ITA,2012.0,1,4,-3
PNG,USA,1998.0,1,1,0
JPN,PRT,2000.0,2,4,-2
CAN,LTU,2008.0,1,1,0
TUR,LTU,2011.0,1,1,0
DNK,GRC,2013.0,1,13,-12
SAU,OMN,2014.0,4,4,0
PHL,FRA,2009.0,2,1,1
HUN,ZAF,2007.0,1,1,0
ZAF,HUN,2014.0,1,2,-1
DNK,ZAF,2014.0,4,1,3
AUT,NGA,2017.0,1,1,0
USA,MDV,2010.0,1,1,0
BRA,CRI,2018.0,3,1,2
MUS,CHN,2014.0,1,2,-1
CYP,ITA,2016.0,1,4,-3
IRQ,JOR,2008.0,1,1,0
MLT,DEU,2013.0,1,1,0
PRT,SRB,2020.0,2,2,0
CZE,IND,2013.0,3,15,-12
CHN,SVN,2020.0,1,3,-2
GBR,PRI,2010.0,1,2,-1
CZE,GRC,2021.0,3,6,-3
GBR,ARM,2018.0,1,3,-2
NOR,CYP,2020.0,2,1,1
BGD,DNK,2018.0,2,1,1
CAN,MLT,2020.0,1,1,0
ARE,PRT,2015.0,2,5,-3
CUB,VEN,2014.0,1,2,-1
KWT,SAU,2013.0,1,5,-4
ESP,HKG,2010.0,1,1,0
TWN,ARE,2020.0,2,2,0
BGR,SGP,2017.0,1,1,0
MAC,KOR,2019.0,1,1,0
AIA,USA,2017.0,7,1,6
LUX,ISR,2022.0,1,1,0
VEN,NLD,2017.0,1,1,0
ZAF,KAZ,2022.0,1,1,0
MEX,NIC,2017.0,1,1,0
COG,CMR,2018.0,2,1,1
MYS,UZB,2023.0,3,1,2
AUS,TTO,2018.0,3,1,2
ETH,GBR,2016.0,1,14,-13
SRB,DNK,2016.0,2,2,0
RUS,LVA,2021.0,4,3,1
GBR,BIH,2023.0,1,3,-2
LBN,NLD,2023.0,1,3,-2
GHA,RUS,2020.0,2,3,-1
PAK,AUS,2000.0,2,1,1
AIA,USA,2018.0,1,1,0
BHR,AUS,2020.0,1,2,-1
GBR,PNG,1997.0,1,3,-2
UKR,ITA,2000.0,6,2,4
NPL,ITA,2017.0,1,3,-2
ZAF,BFA,2001.0,1,1,0
PRT,GNB,2013.0,1,1,0
PRY,USA,2016.0,3,1,2
NPL,NZL,2023.0,1,2,-1
COG,CHE,2015.0,2,3,-1
MAR,CHN,2023.0,2,7,-5
NZL,KOR,2014.0,3,5,-2
SVN,HRV,2023.0,2,2,0
KNA,TTO,2017.0,1,9,-8
CAN,KWT,1997.0,1,3,-2
ESP,CRI,2007.0,3,2,1
TWN,SWE,2001.0,1,2,-1
MYS,SGP,2003.0,1,4,-3
VNM,GHA,2018.0,1,1,0
KWT,DEU,2001.0,2,2,0
MEX,SAU,2021.0,2,1,1
CAN,SYR,1998.0,1,1,0
LBN,MAR,2015.0,2,2,0
CHE,OMN,2009.0,1,1,0
NIC,USA,1997.0,1,1,0
BRA,UKR,1999.0,1,1,0
QAT,MYS,2020.0,2,12,-10
CHN,GRC,2004.0,1,1,0
GRC,IND,2007.0,1,2,-1
LAO,VNM,2018.0,1,2,-1
BEN,SEN,2012.0,1,2,-1
UGA,KOR,2019.0,1,2,-1
ARE,LBY,2019.0,1,1,0
NGA,MWI,2017.0,3,1,2
IRN,PAK,2012.0,3,4,-1
JPN,CHL,2018.0,2,4,-2
DZA,PAK,2015.0,1,1,0
NOR,OMN,2017.0,2,1,1
IRQ,ARE,2014.0,1,1,0
LVA,CZE,2017.0,1,1,0
TWN,TUR,2018.0,1,6,-5
CHN,TZA,2018.0,3,7,-4
SRB,HKG,2001.0,1,1,0
MEX,NOR,2001.0,1,1,0
LBR,USA,2015.0,1,5,-4
TJK,RUS,2020.0,2,7,-5
BEL,SLE,2016.0,1,1,0
SEN,CMR,2019.0,4,1,3
OMN,IRQ,2011.0,1,1,0
PHL,MYS,2018.0,2,2,0
CMR,NLD,2020.0,1,1,0
GBR,URY,2020.0,3,3,0
CHN,ROU,2020.0,2,5,-3
IDN,ITA,2018.0,1,1,0
CYP,NGA,2018.0,1,3,-2
BFA,AUT,2020.0,1,1,0
SWE,EGY,2005.0,1,1,0
TUN,PRT,2017.0,1,2,-1
ARE,SGP,2021.0,1,9,-8
CRI,AUS,2021.0,1,1,0
GEO,AUT,2017.0,1,1,0
SVK,FRA,2023.0,2,2,0
MEX,PAK,2019.0,1,1,0
KWT,FRA,2020.0,1,8,-7
RUS,MAR,2022.0,1,1,0
NZL,GHA,2021.0,1,1,0
IRL,MYS,2023.0,1,6,-5
GBR,KAZ,2023.0,3,7,-4
PSE,CHN,2020.0,1,1,0
AFG,CHN,2022.0,1,1,0
ISR,ZAF,2022.0,2,5,-3
GBR,LBY,2023.0,2,1,1
SVK,DNK,2007.0,2,1,1
NOR,HKG,2006.0,2,1,1
LBY,BEL,2014.0,1,1,0
BOL,PER,2010.0,1,1,0
COG,BFA,2021.0,2,1,1
UGA,BEL,2005.0,1,1,0
CZE,UKR,2004.0,2,5,-3
CAN,BIH,2004.0,1,1,0
DEU,EST,1998.0,1,4,-3
LBY,FRA,2005.0,1,1,0
BWA,KEN,2012.0,1,2,-1
THA,AUT,1999.0,1,5,-4
BEL,RWA,2000.0,1,2,-1
KAZ,DEU,2001.0,3,2,1
ZWE,CHE,2007.0,3,1,2
USA,LBY,2014.0,4,2,2
SWE,ROU,2007.0,1,1,0
SVN,SWE,2009.0,2,1,1
SYR,FRA,1999.0,1,1,0
ITA,NGA,2007.0,1,2,-1
SVK,IND,2014.0,1,1,0
BIH,AUT,2007.0,1,2,-1
SYR,ITA,2009.0,1,3,-2
ARE,BEL,2000.0,1,1,0
THA,IDN,2004.0,1,1,0
CHN,BLR,2010.0,2,1,1
SAU,JPN,2005.0,1,3,-2
CHN,MAC,1998.0,1,1,0
NLD,KOR,2003.0,3,5,-2
USA,SOM,2020.0,1,1,0
AUT,TUR,2004.0,2,1,1
CYP,FRA,2009.0,1,1,0
PHL,ITA,2008.0,2,1,1
NOR,TUR,2011.0,2,3,-1
LVA,SWE,2011.0,1,3,-2
USA,DMA,2011.0,1,3,-2
TUR,JPN,2000.0,3,6,-3
ITA,ECU,2013.0,5,3,2
FRA,LAO,2012.0,1,3,-2
POL,SGP,2009.0,3,2,1
KOR,NPL,2012.0,2,4,-2
CAN,BFA,2010.0,2,1,1
EGY,NLD,2009.0,2,1,1
LTU,GBR,2012.0,7,4,3
USA,BEN,2015.0,1,2,-1
VNM,CHN,2010.0,1,4,-3
GRC,PRT,2010.0,3,2,1
CAN,PHL,2012.0,1,1,0
HRV,AUS,2006.0,1,2,-1
MEX,SWE,2000.0,2,1,1
TZA,BDI,2022.0,1,1,0
KOR,IRL,2023.0,2,4,-2
ARG,SVN,2006.0,1,1,0
DZA,CHE,2013.0,1,2,-1
KEN,IDN,2002.0,1,1,0
IDN,GBR,2006.0,1,7,-6
BEL,TWN,2011.0,2,3,-1
SAU,CHE,2012.0,1,2,-1
KAZ,MYS,2021.0,1,4,-3
LVA,FRA,2018.0,1,3,-2
LTU,NOR,2020.0,2,1,1
CHL,ITA,2008.0,4,8,-4
COG,GAB,2013.0,1,1,0
ARM,IRN,2020.0,1,1,0
SGP,MAC,2013.0,1,3,-2
SVN,BIH,2017.0,2,2,0
ZAF,IRN,2010.0,1,1,0
SWE,CYP,2017.0,3,2,1
ARG,NLD,2017.0,4,4,0
PAN,BRA,2012.0,2,2,0
QAT,GBR,2013.0,1,29,-28
COG,USA,2012.0,8,11,-3
NOR,SRB,2016.0,1,4,-3
BGD,CHE,2022.0,1,1,0
ZWE,SWE,2016.0,1,1,0
ESP,HUN,1998.0,1,4,-3
RUS,LVA,2011.0,2,2,0
AUS,NPL,2013.0,1,11,-10
JPN,SRB,2017.0,2,3,-1
CHL,CRI,2020.0,1,5,-4
SWE,BGR,2014.0,2,4,-2
SRB,MKD,2011.0,2,17,-15
ZAF,SEN,2015.0,1,2,-1
DEU,SYR,2023.0,2,4,-2
CAN,BGR,2021.0,2,1,1
HUN,GRC,2022.0,1,2,-1
MAR,PSE,2020.0,1,1,0
FIN,MYS,2019.0,1,4,-3
CRI,ECU,2020.0,1,2,-1
TWN,VNM,2006.0,1,1,0
SRB,TUR,2020.0,1,6,-5
JAM,AUS,2022.0,1,2,-1
FRA,CUB,2020.0,2,6,-4
PRT,LUX,2019.0,4,1,3
UKR,KOR,2022.0,1,1,0
QAT,TUN,2022.0,3,4,-1
BEN,KEN,2021.0,1,1,0
CYP,TUR,2024.0,3,1,2
NOR,SGP,2017.0,1,1,0
IND,ERI,2016.0,1,2,-1
DEU,DZA,2005.0,2,2,0
ECU,AUS,2019.0,2,5,-3
CUB,BEL,2014.0,2,1,1
ITA,VNM,2003.0,1,1,0
NLD,LVA,2020.0,3,1,2
USA,MUS,2000.0,1,1,0
PER,ITA,1997.0,1,1,0
CZE,ISR,2000.0,1,4,-3
SAU,KWT,2003.0,1,1,0
PAK,CHE,1999.0,1,1,0
BGR,SWE,2010.0,2,1,1
USA,GTM,1998.0,1,3,-2
ZAF,HKG,1997.0,1,2,-1
LKA,CAN,2003.0,1,1,0
HUN,SVK,2003.0,3,6,-3
USA,HTI,2007.0,3,1,2
AUS,HRV,2008.0,1,2,-1
BLR,IRN,2015.0,1,1,0
TWN,SDN,2017.0,1,1,0
ZAF,AUT,1997.0,1,2,-1
KOR,BRA,2009.0,1,2,-1
ESP,GRC,2002.0,3,4,-1
COL,DEU,1997.0,1,1,0
ETH,BGD,2013.0,1,1,0
SVN,IND,2019.0,2,5,-3
TUR,HUN,2020.0,2,2,0
BDI,BEL,2012.0,1,1,0
JAM,JPN,2011.0,2,1,1
CIV,ZAF,2011.0,3,12,-9
SVK,BEL,2008.0,2,1,1
GBR,MUS,2018.0,3,1,2
DEU,OMN,2019.0,3,2,1
ESP,TWN,2012.0,1,4,-3
TTO,LCA,2011.0,1,1,0
SWZ,ZAF,2013.0,1,2,-1
PAK,KEN,2018.0,2,3,-1
JPN,LKA,2008.0,2,1,1
ITA,BFA,2016.0,2,2,0
NOR,POL,2012.0,1,6,-5
JPN,IRL,2010.0,6,4,2
DEU,MWI,2020.0,3,2,1
BEN,NGA,2005.0,1,2,-1
ISR,CZE,1998.0,1,1,0
DEU,YEM,2015.0,1,3,-2
DZA,SAU,2015.0,2,6,-4
PAK,EST,2020.0,2,1,1
USA,MOZ,2003.0,1,1,0
MNE,DEU,2016.0,1,1,0
TUR,EGY,2022.0,2,5,-3
NAM,BWA,2018.0,1,1,0
ROU,SWE,1997.0,1,1,0
POL,CZE,2003.0,6,2,4
DOM,ARG,2020.0,1,1,0
LTU,GBR,1997.0,2,3,-1
CAN,ETH,2016.0,3,4,-1
GRC,IRL,2012.0,1,5,-4
ZWE,JPN,2015.0,1,1,0
SRB,BEL,2013.0,2,4,-2
CAN,MWI,2017.0,3,2,1
LBY,ZAF,2022.0,1,2,-1
CMR,CIV,2018.0,1,1,0
CZE,NAM,2021.0,1,1,0
DEU,CUB,2019.0,2,7,-5
LBN,FIN,2021.0,1,1,0
HRV,SWE,2013.0,1,2,-1
CMR,EGY,2003.0,1,1,0
BTN,IND,2010.0,1,1,0
OMN,NLD,2010.0,1,4,-3
MNE,SRB,2011.0,1,8,-7
SWE,NIC,2012.0,1,2,-1
GRD,TTO,2012.0,1,10,-9
CMR,NLD,2007.0,1,2,-1
PRT,THA,2016.0,3,2,1
EGY,RUS,2009.0,1,2,-1
SAU,NLD,2010.0,2,1,1
NLD,LKA,2010.0,1,1,0
USA,TGO,2013.0,1,1,0
GBR,SYR,2006.0,2,1,1
BRN,DEU,2018.0,1,1,0
AUS,TZA,2007.0,1,1,0
ROU,FIN,2004.0,1,1,0
JEY,USA,2023.0,1,1,0
SGP,DEU,2024.0,1,1,0
ROU,AUS,2021.0,2,1,1
UGA,CAN,2015.0,1,3,-2
NGA,SLE,2018.0,1,2,-1
CAN,LUX,2016.0,1,1,0
CMR,ESP,2020.0,1,2,-1
JPN,COL,2021.0,3,2,1
TWN,DNK,2016.0,1,1,0
CYP,FRA,2021.0,2,6,-4
PRT,CZE,2016.0,2,7,-5
KOR,ARG,2022.0,1,1,0
CHE,SRB,2017.0,4,10,-6
SWE,TWN,2020.0,2,8,-6
HKG,ETH,2023.0,1,3,-2
SVK,ESP,2020.0,1,1,0
THA,MAC,2023.0,1,1,0
PRT,COL,2019.0,3,6,-3
SDN,SWE,2010.0,1,1,0
ARE,MAR,2008.0,1,1,0
POL,SVN,2020.0,1,1,0
IRL,CZE,2008.0,1,7,-6
IRL,COL,2020.0,2,1,1
LVA,GBR,2023.0,2,2,0
CHE,TWN,2013.0,4,1,3
FIN,BGD,2011.0,1,1,0
FIN,THA,2017.0,1,4,-3
AUT,SAU,2009.0,2,1,1
HKG,DNK,2010.0,1,1,0
TON,NZL,2006.0,1,1,0
BLR,LTU,2018.0,1,1,0
NER,BEL,2019.0,1,1,0
SRB,ISR,2017.0,2,1,1
IND,NER,2016.0,1,2,-1
EST,CAN,2000.0,1,1,0
SAU,BGD,2002.0,1,2,-1
ISL,NZL,2019.0,1,1,0
TUR,HRV,2019.0,2,4,-2
CHE,SEN,2015.0,3,1,2
HUN,AUS,2019.0,1,4,-3
PER,CHL,2012.0,1,3,-2
IRQ,ITA,2017.0,1,1,0
KAZ,POL,2016.0,1,2,-1
MUS,IND,2000.0,2,1,1
MEX,EGY,2016.0,1,1,0
IND,PRI,2010.0,2,1,1
ECU,NLD,2023.0,1,1,0
MWI,IND,2023.0,3,2,1
ITA,PHL,2020.0,2,3,-1
HUN,GHA,2023.0,1,3,-2
LKA,NPL,2013.0,2,1,1
LTU,EST,2019.0,3,2,1
BEL,ARG,2008.0,1,4,-3
SVN,ESP,2007.0,1,1,0
FRA,HRV,2008.0,2,1,1
LKA,ZAF,2007.0,1,1,0
PAN,ESP,2001.0,1,1,0
ZMB,AUS,2001.0,1,1,0
RUS,BGR,2009.0,2,4,-2
GAB,USA,2003.0,1,2,-1
SVK,SRB,2022.0,1,1,0
ITA,BLR,2009.0,1,1,0
FIN,SRB,2003.0,2,2,0
EGY,SWE,2009.0,1,3,-2
SRB,NZL,2018.0,1,1,0
LTU,RUS,1999.0,1,2,-1
SRB,AUS,2013.0,2,2,0
ESP,SRB,2010.0,2,1,1
QAT,BEL,2018.0,1,3,-2
NZL,BEL,2018.0,4,6,-2
WSM,USA,2018.0,1,1,0
CMR,KEN,2023.0,1,1,0
KEN,SWE,2014.0,1,5,-4
GBR,PNG,2005.0,1,1,0
GHA,NAM,2019.0,1,1,0
LVA,SWE,2019.0,2,4,-2
BEL,LTU,2017.0,1,2,-1
EGY,MEX,2016.0,1,1,0
USA,ALB,2019.0,1,1,0
KAZ,KGZ,2018.0,1,9,-8
THA,DNK,2023.0,2,3,-1
BEL,BDI,2020.0,1,1,0
DEU,LVA,2003.0,3,5,-2
JPN,SRB,2018.0,1,3,-2
ETH,MWI,2016.0,1,1,0
USA,ALB,2021.0,2,3,-1
SAU,SYR,2018.0,3,1,2
GBR,KHM,2017.0,2,4,-2
PRI,ESP,2020.0,1,6,-5
CRI,SWE,2005.0,1,1,0
NZL,FJI,2016.0,1,2,-1
BHS,CAN,2017.0,1,1,0
CHE,ESP,2024.0,1,2,-1
DNK,ZAF,2008.0,1,4,-3
SVN,CAN,2010.0,1,1,0
ZMB,CHN,2019.0,1,4,-3
IND,ROU,2016.0,2,1,1
BGR,IND,2021.0,4,2,2
TUR,ZAF,2019.0,1,2,-1
HUN,IRN,2017.0,3,3,0
MNE,DEU,2018.0,1,1,0
USA,NCL,2020.0,1,4,-3
GEO,CHE,2018.0,2,1,1
FRA,GHA,2022.0,1,3,-2
EST,GHA,2023.0,1,1,0
IRQ,IND,2018.0,1,14,-13
BEN,MDG,2018.0,1,2,-1
IDN,BHR,2020.0,1,2,-1
FIN,AUT,2022.0,2,10,-8
MMR,IDN,2021.0,1,2,-1
NLD,IRN,2004.0,1,3,-2
TWN,ISR,2019.0,1,2,-1
BGD,NGA,2022.0,2,1,1
DOM,CUB,2020.0,1,2,-1
HND,MEX,2021.0,2,2,0
ESP,TWN,2002.0,1,3,-2
ROU,CHN,2017.0,2,3,-1
BMU,CAN,2021.0,1,6,-5
NGA,SWE,2014.0,1,2,-1
NPL,JPN,1998.0,2,3,-1
THA,NPL,2007.0,1,2,-1
KAZ,ARE,2019.0,3,2,1
PAK,HKG,2010.0,1,1,0
CYP,ISR,2022.0,2,2,0
URY,SWE,2008.0,2,2,0
BGR,AUT,2005.0,2,1,1
DEU,BRN,2004.0,1,1,0
RUS,IRQ,2012.0,2,1,1
SVN,AUT,1998.0,2,3,-1
CIV,USA,2014.0,3,2,1
IND,ERI,2018.0,1,1,0
AUS,OMN,2010.0,2,5,-3
TUR,ROU,2011.0,1,2,-1
QAT,DZA,2020.0,1,2,-1
CRI,PER,2009.0,1,1,0
MKD,USA,2007.0,1,5,-4
RWA,ZAF,2013.0,3,1,2
PRY,CHL,2021.0,1,3,-2
SVN,POL,2020.0,1,1,0
PAK,SAU,1999.0,2,8,-6
SVN,IRL,2020.0,2,3,-1
LVA,BLR,2023.0,1,1,0
EGY,SYR,2022.0,1,1,0
CZE,IRN,2023.0,2,15,-13
SAU,AUT,2023.0,2,3,-1
PAK,GHA,2023.0,1,1,0
KWT,JOR,2006.0,1,1,0
BGR,CAN,2002.0,3,1,2
NPL,NLD,2001.0,1,1,0
NGA,BRA,2014.0,3,1,2
USA,EST,2000.0,3,5,-2
RWA,CHN,2015.0,2,2,0
EGY,CHE,1998.0,1,2,-1
USA,CYM,2010.0,2,3,-1
CYM,USA,2012.0,1,1,0
FRA,ARM,1998.0,1,1,0
KWT,SWE,2014.0,1,1,0
POL,SVK,1997.0,2,1,1
DEU,MYS,1998.0,1,1,0
BOL,BRA,2013.0,2,2,0
KOR,CHE,2002.0,4,4,0
ERI,IND,2006.0,1,2,-1
CHE,SVK,2013.0,2,7,-5
ITA,CYP,2006.0,1,1,0
JPN,SVN,2015.0,1,4,-3
IRN,GRC,2012.0,1,1,0
JPN,BLR,2013.0,1,1,0
TUN,DZA,2015.0,1,3,-2
VNM,COL,2019.0,2,2,0
AUT,KEN,2012.0,1,1,0
KAZ,ISR,2013.0,1,2,-1
UGA,CHN,2012.0,1,1,0
NLD,CRI,2012.0,2,1,1
TUN,CIV,2014.0,2,1,1
IND,MUS,2014.0,1,1,0
AZE,IRN,2004.0,1,1,0
URY,BRA,1997.0,1,2,-1
THA,IRN,2017.0,1,2,-1
ZAF,NOR,2005.0,1,2,-1
GMB,BEL,2020.0,2,1,1
BGR,DNK,2000.0,1,2,-1
KOR,BIH,2020.0,1,1,0
NOR,SGP,2016.0,1,2,-1
MWI,ETH,2020.0,1,2,-1
TUR,ISR,2002.0,3,4,-1
BRA,SLV,2021.0,1,2,-1
ARE,NLD,2018.0,1,7,-6
MKD,BGR,2006.0,1,5,-4
DEU,ITA,2024.0,1,8,-7
KAZ,HUN,2023.0,1,1,0
SGP,FIN,2008.0,1,2,-1
LKA,CHN,2018.0,1,1,0
HKG,IDN,2021.0,2,3,-1
CIV,SEN,2021.0,1,4,-3
CAN,SVK,2021.0,2,1,1
ARG,RUS,2021.0,1,1,0
ARE,IRL,2020.0,3,3,0
KWT,LBN,2023.0,1,2,-1
AZE,RUS,2023.0,1,4,-3
ROU,IRN,2023.0,1,1,0
HUN,NOR,2005.0,1,1,0
PNG,USA,2007.0,1,1,0
SWE,PER,2012.0,1,2,-1
GRC,IRL,2005.0,3,4,-1
IRL,KOR,1998.0,1,1,0
SDN,JPN,2003.0,1,2,-1
BRA,CHN,2001.0,2,2,0
CMR,AUS,2017.0,1,1,0
TZA,MWI,2020.0,1,1,0
IRQ,PAK,2021.0,4,5,-1
ESP,MKD,2020.0,1,1,0
GRC,AUS,2021.0,2,9,-7
QAT,ITA,2022.0,1,2,-1
NGA,AUT,2017.0,1,1,0
SAU,NZL,2014.0,1,4,-3
AUS,COL,2000.0,1,1,0
PAK,YEM,2022.0,1,1,0
JOR,CHN,2015.0,1,2,-1
SDN,CHE,2020.0,1,1,0
JPN,COD,2022.0,2,2,0
SWE,RWA,2017.0,2,4,-2
CIV,CHN,2020.0,1,2,-1
THA,IRQ,2019.0,1,2,-1
NLD,RWA,2023.0,1,1,0
ZWE,ZMB,2022.0,1,1,0
USA,KHM,2002.0,1,2,-1
ESP,EGY,1998.0,1,1,0
CHL,PER,1997.0,1,1,0
FIN,TWN,2020.0,2,2,0
BGD,DNK,2022.0,1,3,-2
TZA,ZWE,2021.0,1,3,-2
IRQ,MAR,2022.0,1,1,0
CHN,LUX,2016.0,2,2,0
NOR,SDN,2021.0,2,1,1
GBR,SYC,2023.0,1,2,-1
YEM,SDN,2023.0,1,1,0
GBR,DZA,2000.0,2,1,1
MLT,USA,2013.0,1,1,0
SEN,BEN,2017.0,2,1,1
ALB,GRC,1999.0,1,1,0
NLD,SDN,2001.0,1,1,0
UKR,HKG,2002.0,1,1,0
EGY,ZAF,2021.0,2,3,-1
UGA,SWE,1999.0,1,1,0
LTU,CZE,2004.0,1,1,0
NGA,SLE,2017.0,2,1,1
GBR,PNG,2002.0,1,1,0
ITA,TUN,2009.0,2,2,0
ETH,NLD,2005.0,1,4,-3
BEL,BDI,1998.0,1,2,-1
DEU,MAR,2013.0,1,2,-1
CHE,LIE,2007.0,1,3,-2
BGR,GRC,2006.0,1,2,-1
BLR,LTU,2017.0,1,1,0
SWE,ARE,2009.0,2,1,1
ISL,BEL,2014.0,1,3,-2
MAR,CHE,2010.0,1,1,0
UGA,ZAF,2006.0,1,2,-1
CAN,LKA,2004.0,2,2,0
CAN,OMN,1997.0,2,2,0
UGA,NOR,2003.0,2,1,1
BWA,NAM,2018.0,1,1,0
PRY,BRA,2016.0,1,4,-3
IRL,IRN,2010.0,3,7,-4
CZE,NOR,2014.0,1,1,0
CAN,RWA,2012.0,1,1,0
SWE,BOL,2008.0,1,2,-1
MKD,DEU,2003.0,2,1,1
SGP,IRL,2009.0,1,4,-3
POL,LTU,2004.0,1,1,0
DEU,PSE,2004.0,1,2,-1
IDN,DEU,2003.0,2,3,-1
CAN,BWA,2012.0,1,1,0
LTU,BEL,2012.0,1,2,-1
JPN,NZL,2016.0,2,11,-9
TUN,CHE,2009.0,3,2,1
JAM,TTO,2021.0,1,6,-5
ITA,UZB,2007.0,1,1,0
ETH,CZE,2008.0,1,1,0
MEX,CHE,2005.0,1,6,-5
CIV,CMR,2016.0,2,1,1
CYP,QAT,2020.0,1,2,-1
ROU,MDA,1997.0,1,2,-1
MDA,DEU,2005.0,2,1,1
MMR,AUS,2014.0,1,1,0
VNM,TWN,2009.0,1,3,-2
NPL,MYS,2021.0,1,3,-2
VNM,IDN,2023.0,1,2,-1
GBR,NER,2017.0,3,1,2
HKG,RUS,2018.0,1,5,-4
IRQ,CYP,2020.0,1,5,-4
TUR,ROU,2021.0,3,1,2
MYS,SLE,2023.0,1,1,0
KOR,CHL,2018.0,1,1,0
TTO,IND,2023.0,1,2,-1
NOR,LTU,1998.0,2,2,0
USA,PSE,1998.0,2,1,1
SEN,CIV,2007.0,1,1,0
HRV,JPN,2002.0,1,1,0
PRT,BGR,2000.0,1,1,0
BLZ,USA,2007.0,1,1,0
FIN,ISL,2002.0,2,2,0
LAO,DEU,2013.0,1,2,-1
SWE,SVN,2002.0,1,2,-1
MAR,MEX,2002.0,1,1,0
MMR,IND,2006.0,1,1,0
EST,NOR,1997.0,1,1,0
ROU,SWE,2002.0,3,3,0
AUT,BFA,2017.0,1,1,0
DEU,URY,1997.0,2,3,-1
COG,CMR,2016.0,1,1,0
UGA,FRA,2011.0,1,1,0
TUN,EGY,2011.0,3,2,1
KOR,UKR,2021.0,1,3,-2
MWI,TWN,2022.0,1,1,0
ITA,SYR,2013.0,1,1,0
HUN,GRC,2018.0,1,2,-1
FRA,MUS,2010.0,2,1,1
JAM,JPN,2009.0,2,1,1
MYS,ITA,2012.0,2,5,-3
SVN,KOR,2016.0,1,2,-1
KOR,SVN,2022.0,1,2,-1
AUT,ISR,2018.0,2,5,-3
LTU,RUS,2020.0,1,8,-7
GBR,IRQ,2005.0,1,2,-1
NGA,TUR,2009.0,1,1,0
FIN,KAZ,2014.0,1,1,0
HRV,CHN,2009.0,1,1,0
ROU,SRB,2011.0,1,3,-2
ITA,UKR,2024.0,1,1,0
FIN,BGD,2021.0,1,1,0
RUS,BRA,2018.0,3,12,-9
URY,ITA,2014.0,2,3,-1
CUB,BEL,2015.0,1,3,-2
ECU,FIN,2020.0,1,1,0
GBR,GIB,2022.0,1,1,0
DEU,UGA,2012.0,1,2,-1
THA,KHM,2014.0,1,2,-1
TUR,MYS,2012.0,1,2,-1
BEN,NLD,2014.0,2,1,1
HRV,MKD,2015.0,1,3,-2
ZAF,ITA,2004.0,1,7,-6
MWI,BEL,2018.0,2,2,0
PRT,CHN,1997.0,2,2,0
BRA,NGA,2011.0,1,2,-1
VNM,RUS,2014.0,1,11,-10
NGA,BRA,2004.0,1,1,0
NCL,USA,2018.0,1,8,-7
MWI,ZMB,2011.0,2,1,1
CHN,JOR,2017.0,1,2,-1
BRA,DZA,2021.0,1,1,0
NPL,CHN,2015.0,1,5,-4
LTU,CHN,2019.0,2,2,0
CHL,IRL,2017.0,2,3,-1
NLD,SVN,1999.0,2,1,1
HUN,BRA,2021.0,1,6,-5
KAZ,DEU,2015.0,1,1,0
SVN,AUS,2012.0,3,1,2
ZAF,OMN,2019.0,1,1,0
RWA,GBR,2012.0,1,3,-2
BFA,TGO,2017.0,1,4,-3
CHE,SAU,2012.0,2,1,1
ISL,NLD,2019.0,1,7,-6
PSE,SAU,2015.0,1,1,0
PSE,CAN,2020.0,1,1,0
SWE,CUB,2005.0,1,1,0
GHA,NGA,2001.0,1,1,0
NOR,PRT,2009.0,1,2,-1
CMR,NGA,2005.0,2,2,0
CHL,JPN,2008.0,1,4,-3
BEL,DZA,2004.0,3,3,0
ETH,SWE,2005.0,2,4,-2
TUR,TUN,2015.0,1,1,0
KWT,AUS,2017.0,1,5,-4
SAU,JPN,2002.0,1,3,-2
POL,KOR,2013.0,1,3,-2
ARE,THA,2018.0,1,1,0
DEU,ETH,2010.0,3,4,-1
MYS,IRL,2009.0,1,3,-2
PHL,NGA,2018.0,1,2,-1
IND,IDN,2004.0,1,2,-1
POL,GRC,2015.0,1,1,0
CIV,CRI,2015.0,1,1,0
GBR,PNG,2012.0,1,2,-1
AUT,ARG,2003.0,1,2,-1
USA,BEN,2004.0,2,2,0
ESP,HKG,2000.0,2,1,1
FIN,PRT,2004.0,1,2,-1
BGR,FIN,2000.0,1,1,0
BGR,POL,1999.0,1,1,0
MAR,CHE,2000.0,1,1,0
VNM,USA,1997.0,2,3,-1
TWN,NLD,2000.0,1,2,-1
CHE,PNG,2013.0,1,1,0
JOR,PAK,2019.0,1,2,-1
TZA,CYP,2023.0,1,1,0
QAT,CHE,2015.0,1,2,-1
AUS,TTO,2017.0,1,1,0
CHE,CMR,2013.0,2,1,1
SVN,SGP,2017.0,1,1,0
ARG,NOR,2017.0,1,4,-3
KAZ,POL,2022.0,1,6,-5
VNM,POL,2014.0,1,1,0
OMN,DEU,2016.0,2,7,-5
GBR,SDN,2008.0,3,1,2
LUX,POL,2016.0,1,2,-1
AUS,CYP,2018.0,1,3,-2
THA,NOR,2021.0,1,2,-1
VNM,ITA,2017.0,2,11,-9
RWA,KOR,2019.0,1,1,0
IDN,BEL,2017.0,1,5,-4
HRV,MNE,2019.0,1,3,-2
THA,LKA,2023.0,1,2,-1
COD,ZAF,2023.0,1,6,-5
COL,IND,2023.0,1,4,-3
ZAF,IRN,2023.0,2,5,-3
MLT,NLD,2014.0,1,1,0
GBR,MOZ,1999.0,1,1,0
MDA,ESP,2006.0,1,2,-1
ZAF,CZE,2007.0,1,2,-1
LUX,NLD,2002.0,1,3,-2
BGD,PRT,2020.0,1,3,-2
SYR,BEL,2010.0,1,2,-1
VNM,POL,2010.0,1,1,0
SEN,MLI,2022.0,1,5,-4
CAN,BLR,2009.0,1,2,-1
PRT,NZL,2011.0,1,2,-1
LBY,ISR,2019.0,1,1,0
DZA,BEL,2015.0,1,5,-4
BEN,CHN,2021.0,2,2,0
MMR,DEU,2015.0,1,1,0
HUN,KEN,2020.0,1,1,0
AUS,COL,2008.0,1,1,0
SVK,HRV,2018.0,1,1,0
BEL,BEN,2018.0,1,4,-3
TUN,SAU,2004.0,1,1,0
ARG,CHE,2005.0,5,2,3
ZMB,ZWE,2022.0,1,1,0
ITA,BEN,2012.0,1,1,0
SWE,ISR,1999.0,2,4,-2
KOR,BEL,2009.0,1,4,-3
MEX,PRI,2009.0,2,3,-1
PAN,ITA,2023.0,1,2,-1
JPN,FJI,2008.0,1,1,0
MDG,USA,2001.0,2,2,0
JOR,TWN,2015.0,2,2,0
AUT,BEL,1999.0,2,5,-3
NZL,FIN,2008.0,1,1,0
IRL,ARG,2011.0,1,2,-1
GBR,MUS,2005.0,1,2,-1
DZA,NLD,1999.0,1,1,0
OMN,DEU,2005.0,1,2,-1
BEN,CIV,2015.0,1,1,0
USA,BMU,2000.0,1,1,0
DNK,EGY,2010.0,1,1,0
CZE,HRV,2013.0,1,5,-4
BEL,MYS,2022.0,2,5,-3
LUX,FIN,2016.0,2,2,0
UKR,IRL,2015.0,1,1,0
SGP,LUX,2018.0,1,1,0
GAB,MAR,2015.0,1,2,-1
GBR,RWA,2018.0,2,2,0
PRI,COL,2013.0,1,1,0
BLR,GBR,2017.0,1,1,0
ESP,LTU,2022.0,2,2,0
ARG,VEN,2001.0,1,3,-2
GHA,HKG,2019.0,1,3,-2
MLT,NLD,2023.0,1,1,0
BEL,IDN,2023.0,1,4,-3
MEX,ZAF,2010.0,1,1,0
BGD,AUT,2018.0,1,1,0
PAN,COL,2021.0,1,3,-2
GHA,KEN,2023.0,1,5,-4
AUT,LUX,2023.0,1,3,-2
RWA,ETH,2020.0,2,1,1
THA,BEL,1998.0,1,1,0
CZE,TWN,1998.0,1,2,-1
GHA,CHE,2008.0,1,1,0
MLI,BFA,2013.0,1,2,-1
JOR,SYR,2011.0,1,1,0
USA,BHS,2007.0,1,1,0
HKG,NZL,2000.0,3,4,-1
USA,CMR,1999.0,2,3,-1
AUT,ARG,2011.0,1,2,-1
ARG,AUT,2015.0,1,1,0
USA,FSM,2018.0,2,1,1
ECU,ESP,2002.0,1,2,-1
DNK,ETH,2002.0,1,3,-2
DEU,BEN,1999.0,1,1,0
ISR,TUR,2023.0,1,1,0
PER,CUB,2021.0,1,2,-1
URY,CHL,2021.0,3,7,-4
ISL,BEL,2023.0,1,1,0
NZL,ESP,2010.0,3,1,2
GRC,MEX,2021.0,1,2,-1
HRV,USA,2023.0,1,3,-2
IDN,SAU,2023.0,2,6,-4
PSE,TUR,2018.0,1,3,-2
CAN,BHR,2023.0,1,2,-1
TGO,BFA,2020.0,1,2,-1
GBR,BGR,1998.0,3,7,-4
USA,GMB,2013.0,1,3,-2
AUS,OMN,2004.0,1,2,-1
NZL,COL,2014.0,1,1,0
CAN,JOR,1999.0,2,1,1
NOR,NZL,2000.0,1,2,-1
NPL,CAN,2002.0,1,2,-1
GMB,ZAF,2007.0,1,1,0
KOR,POL,2005.0,1,1,0
AUT,ETH,2016.0,2,1,1
SVN,ITA,2003.0,2,3,-1
DZA,ESP,1999.0,1,1,0
GTM,FRA,2013.0,1,1,0
NGA,SAU,2004.0,3,6,-3
COG,COD,2004.0,2,1,1
MWI,UGA,2013.0,1,1,0
CHE,MDA,1997.0,1,2,-1
BRN,USA,1998.0,1,1,0
SVK,CAN,2002.0,1,2,-1
ZAF,CAF,2012.0,1,1,0
MCO,CHE,2001.0,1,1,0
NOR,ITA,1998.0,1,16,-15
ISR,ZAF,1997.0,1,4,-3
EST,USA,1998.0,1,5,-4
SRB,ISR,2002.0,2,1,1
AUS,MMR,2014.0,1,1,0
BHR,TUR,2013.0,1,1,0
GBR,ZMB,2011.0,1,3,-2
IRN,PAK,2018.0,2,2,0
PRI,IND,2005.0,1,1,0
HKG,NGA,2019.0,2,5,-3
TGO,FRA,2015.0,1,6,-5
BOL,BEL,2013.0,1,4,-3
KWT,NOR,2008.0,1,1,0
OMN,DEU,2012.0,1,3,-2
NPL,PHL,2019.0,2,1,1
AUS,PER,2023.0,1,3,-2
CRI,VEN,2012.0,1,3,-2
MOZ,KEN,2017.0,2,1,1
IRL,JPN,1997.0,1,1,0
FRA,OMN,2020.0,2,1,1
AUT,MEX,1998.0,1,2,-1
MOZ,USA,2023.0,3,5,-2
LCA,USA,2017.0,1,2,-1
NLD,SRB,2023.0,1,4,-3
CRI,AUS,2013.0,1,2,-1
LUX,CHN,2018.0,3,4,-1
AUS,UKR,2020.0,2,1,1
SEN,NER,2015.0,1,1,0
BGR,SWE,2015.0,2,1,1
ZMB,NLD,2021.0,2,3,-1
BGD,CZE,2014.0,2,1,1
KHM,DEU,2022.0,3,2,1
ETH,GBR,1997.0,1,4,-3
DNK,UKR,1999.0,1,1,0
ZAF,RUS,2007.0,1,3,-2
USA,CIV,2013.0,1,3,-2
MDA,ESP,2004.0,1,1,0
USA,SYR,2005.0,1,2,-1
ARM,BRA,2021.0,1,1,0
MLT,ARE,2017.0,1,1,0
LVA,GBR,2008.0,1,1,0
ZAF,JPN,2001.0,1,2,-1
BLR,UKR,1999.0,4,4,0
JOR,CHE,2010.0,1,1,0
AUS,COL,2004.0,2,3,-1
IDN,CHN,2023.0,3,8,-5
CIV,USA,2000.0,4,1,3
IRQ,YEM,2022.0,1,1,0
RUS,CHN,2006.0,3,4,-1
SAU,KWT,2009.0,1,1,0
ESP,AZE,2017.0,1,1,0
CIV,BFA,1999.0,2,3,-1
LAO,USA,2018.0,1,6,-5
UKR,BGR,2001.0,1,4,-3
SRB,CHL,2014.0,1,1,0
ZAF,POL,1997.0,1,1,0
COL,IRN,2017.0,1,1,0
EST,GRC,2012.0,1,2,-1
LIE,AUT,2017.0,1,3,-2
BEN,CMR,2010.0,1,1,0
TTO,JAM,2017.0,2,13,-11
HUN,CHN,2013.0,2,2,0
MLT,USA,2009.0,1,3,-2
PRI,ARG,2014.0,1,3,-2
CHE,KEN,2009.0,1,4,-3
BIH,MNE,2017.0,1,2,-1
ZMB,MWI,2012.0,1,2,-1
FRA,DJI,2011.0,4,1,3
CUB,JPN,2007.0,1,1,0
NLD,ARE,2010.0,1,1,0
CRI,ARG,2021.0,2,1,1
SGP,COL,2018.0,1,1,0
FIN,ISR,2012.0,1,2,-1
URY,VEN,2008.0,1,1,0
NPL,CHE,2010.0,1,2,-1
DEU,LIE,2013.0,2,2,0
GBR,PAK,2024.0,1,1,0
DNK,POL,2022.0,1,9,-8
AUT,DNK,1998.0,1,1,0
AUS,VUT,2019.0,1,1,0
BMU,USA,2012.0,1,2,-1
SWE,CHL,2004.0,1,3,-2
IRL,MEX,1998.0,1,2,-1
LKA,CHN,2012.0,1,2,-1
ISR,ISL,2012.0,1,4,-3
IRL,RUS,2009.0,1,5,-4
MYS,MAR,2016.0,1,1,0
BGR,SVN,2012.0,1,2,-1
NZL,PER,2010.0,1,1,0
BTN,AUS,2014.0,1,3,-2
TUR,ISR,2017.0,1,6,-5
MDV,NZL,2018.0,1,1,0
ARM,AUS,2021.0,1,1,0
TUN,LUX,2022.0,2,1,1
NGA,BFA,2014.0,2,2,0
SWE,LVA,2021.0,1,3,-2
SDN,ARE,2015.0,3,1,2
BEL,MLI,2020.0,1,1,0
BEL,NPL,2017.0,1,1,0
BRA,VEN,2014.0,2,11,-9
AUS,WSM,2019.0,2,1,1
SVN,GRC,2017.0,1,2,-1
DZA,TUR,2017.0,1,2,-1
RWA,CHE,2019.0,1,1,0
SVK,NZL,2017.0,1,1,0
CMR,TCD,2023.0,2,1,1
LAO,USA,2022.0,1,4,-3
KOR,HKG,2006.0,1,5,-4
BEN,MLI,2022.0,1,1,0
BGR,CZE,2017.0,2,3,-1
FJI,MYS,2012.0,1,1,0
EST,MEX,2020.0,1,1,0
COL,PAN,2009.0,1,1,0
DEU,NAM,2007.0,1,1,0
KEN,ESP,2014.0,1,1,0
VEN,TTO,2004.0,1,1,0
CHL,CZE,2008.0,1,1,0
AUS,BWA,2007.0,1,1,0
SRB,CZE,2006.0,1,4,-3
SDN,JPN,2009.0,2,3,-1
CHE,BLR,2018.0,1,1,0
BOL,ITA,2020.0,1,2,-1
TWN,THA,2009.0,1,2,-1
POL,PAN,1998.0,2,5,-3
FRA,MYS,2002.0,1,4,-3
LBN,ZAF,2007.0,1,1,0
PAN,CAN,2020.0,1,1,0
URY,FRA,2000.0,3,5,-2
KEN,BWA,2004.0,2,1,1
EST,NOR,2016.0,2,2,0
FIN,MYS,2013.0,1,1,0
ETH,DNK,2017.0,2,3,-1
BEL,PER,2006.0,2,2,0
DEU,NER,2009.0,1,1,0
NLD,CRI,2016.0,1,1,0
RWA,KEN,2016.0,1,2,-1
TUR,GRC,2006.0,1,2,-1
AZE,DEU,2016.0,2,2,0
AUT,CRI,2018.0,1,2,-1
BEN,DEU,2020.0,2,4,-2
BRN,SGP,2007.0,1,1,0
CZE,CHN,2002.0,1,7,-6
PAK,KWT,2007.0,1,2,-1
SDN,NLD,2001.0,1,1,0
NOR,ZAF,2008.0,2,2,0
NOR,BLR,2012.0,1,1,0
ETH,KEN,2011.0,2,5,-3
DEU,CRI,1999.0,1,2,-1
UKR,ITA,2014.0,2,5,-3
MEX,ETH,2022.0,1,1,0
MLI,CIV,2021.0,1,4,-3
NGA,BWA,2016.0,1,2,-1
ISR,POL,2008.0,1,2,-1
MYS,ETH,2015.0,3,1,2
BEL,HKG,2017.0,1,1,0
BGR,DNK,2008.0,1,2,-1
NOR,HUN,1999.0,1,1,0
TGO,SEN,2015.0,1,3,-2
MMR,USA,2020.0,2,2,0
MWI,AUS,2009.0,2,1,1
PNG,GIN,2016.0,1,1,0
LTU,BEL,2022.0,1,1,0
VEN,CRI,2023.0,1,1,0
DNK,ZAF,2023.0,3,3,0
KOR,NGA,2001.0,2,2,0
PRT,TWN,2009.0,1,1,0
SEN,GHA,2021.0,1,1,0
BRA,MAR,2023.0,1,1,0
KEN,SWE,2023.0,1,1,0
MCO,GBR,2023.0,1,1,0
MKD,GRC,2019.0,1,1,0
EGY,JOR,2016.0,1,4,-3
MMR,NOR,2017.0,1,1,0
PHL,ITA,2023.0,1,1,0
RUS,TJK,2023.0,1,1,0
BGD,ESP,2018.0,1,1,0
ISL,CAN,1999.0,2,3,-1
EST,IND,2018.0,1,2,-1
AUT,MKD,2021.0,1,1,0
JOR,IND,2004.0,1,4,-3
NGA,IRQ,2020.0,1,2,-1
AZE,CAN,2021.0,1,1,0
IRQ,DEU,2013.0,3,2,1
MEX,SWE,2001.0,1,4,-3
NLD,OMN,2000.0,1,2,-1
GEO,ITA,2015.0,1,3,-2
TTO,ESP,2014.0,1,1,0
ITA,GEO,2003.0,1,1,0
TGO,FRA,2001.0,2,5,-3
GEO,ESP,1998.0,1,1,0
TUR,ROU,2003.0,1,3,-2
EGY,NLD,2003.0,2,4,-2
DEU,BOL,2007.0,1,3,-2
IND,KEN,1997.0,1,1,0
IRN,RUS,2002.0,1,5,-4
IRN,AUS,1998.0,2,13,-11
GHA,DEU,2008.0,1,4,-3
FIN,LTU,2000.0,1,1,0
TZA,NOR,2002.0,2,5,-3
PRT,GRC,2011.0,1,2,-1
SVK,HRV,2016.0,1,2,-1
JOR,SWE,2012.0,1,1,0
NGA,NER,2001.0,1,2,-1
PER,ARG,2011.0,1,1,0
KHM,CHE,2015.0,1,1,0
NOR,NZL,2010.0,1,3,-2
AUS,NER,2012.0,1,1,0
PSE,EGY,2016.0,1,2,-1
BGD,MYS,1998.0,1,1,0
DZA,DEU,2014.0,2,1,1
ARE,OMN,2010.0,1,3,-2
NIC,SWE,2009.0,1,1,0
CHN,GRC,2010.0,1,1,0
MAR,ARE,2008.0,1,1,0
USA,SWZ,2022.0,2,5,-3
BHR,GBR,2009.0,1,5,-4
CZE,ARE,2014.0,1,1,0
ISL,IRN,2013.0,1,2,-1
CHE,VEN,2013.0,1,1,0
MYS,HKG,2013.0,2,4,-2
ROU,SRB,2013.0,2,5,-3
SYR,ITA,2013.0,1,1,0
ESP,GTM,2018.0,2,2,0
BRA,ROU,2015.0,1,2,-1
LUX,AUS,2015.0,1,1,0
DNK,LKA,2017.0,1,1,0
CHN,TKM,2017.0,1,1,0
THA,PRT,2012.0,1,1,0
MNG,AUT,2019.0,1,2,-1
LVA,RUS,2023.0,1,6,-5
MEX,TUR,2018.0,1,1,0
CIV,MLI,2011.0,1,4,-3
ZAF,PAK,2018.0,1,1,0
EGY,IRL,2023.0,1,5,-4
BIH,GBR,2021.0,1,3,-2
DNK,THA,2000.0,1,1,0
KEN,PER,2014.0,1,2,-1
URY,MEX,2021.0,1,6,-5
KEN,CMR,2023.0,1,1,0
AUT,EST,2021.0,1,2,-1
CRI,ARG,2019.0,1,1,0
CHN,MNG,2004.0,1,1,0
ATG,IND,2023.0,1,1,0
JOR,CHN,2023.0,1,3,-2
ROU,SAU,2023.0,2,1,1
BRA,BVT,2019.0,1,2,-1
HUN,TUR,2017.0,1,1,0
USA,ERI,1998.0,1,1,0
GBR,AFG,2022.0,1,2,-1
FRA,KHM,2006.0,2,2,0
ISR,DNK,2000.0,1,3,-2
DZA,USA,2002.0,1,2,-1
MYS,UZB,2014.0,1,2,-1
LKA,BRA,2014.0,1,1,0
AUS,IRL,2024.0,1,2,-1
BEL,CUB,1999.0,1,1,0
TWN,POL,2007.0,1,2,-1
BLR,FRA,2009.0,1,2,-1
JOR,BHR,1997.0,1,1,0
BGR,ISR,2006.0,1,1,0
SRB,NLD,2003.0,2,1,1
BRA,NOR,2005.0,1,2,-1
AUT,BGR,2001.0,1,9,-8
QAT,DNK,2016.0,1,2,-1
ISR,SVK,2003.0,1,1,0
DNK,KEN,1998.0,1,2,-1
DEU,OMN,2003.0,1,1,0
CZE,ESP,1999.0,1,2,-1
BIH,DEU,2007.0,2,3,-1
MYS,NPL,2009.0,1,1,0
ESP,MOZ,2012.0,2,3,-1
YEM,RUS,2023.0,1,2,-1
NLD,KWT,2018.0,1,1,0
GAB,ZAF,2011.0,1,3,-2
YEM,JOR,2009.0,1,1,0
OMN,KWT,2012.0,1,1,0
CHL,CHN,2009.0,1,3,-2
AUS,LBN,2011.0,1,1,0
MKD,ITA,2022.0,1,1,0
GUF,CHE,2021.0,1,1,0
LUX,CHE,2021.0,2,9,-7
CUB,QAT,2021.0,1,1,0
BFA,NGA,2022.0,1,3,-2
SOM,ITA,2023.0,2,1,1
KEN,IDN,2016.0,1,3,-2
PSE,NLD,2013.0,1,1,0
POL,FIN,2002.0,1,5,-4
TUR,MYS,2016.0,1,6,-5
SDN,SSD,2017.0,1,4,-3
FIN,IRL,2003.0,1,1,0
VNM,BRN,2020.0,1,1,0
LUX,IRL,2016.0,1,2,-1
ZAF,TTO,2010.0,1,1,0
CHE,BFA,2009.0,1,2,-1
ZWE,AUS,2020.0,1,1,0
YEM,JOR,2019.0,1,3,-2
HRV,ISR,2020.0,1,2,-1
BHR,KWT,2020.0,1,4,-3
JOR,KOR,2018.0,1,2,-1
HRV,PRT,2021.0,1,1,0
CAN,AZE,2021.0,1,1,0
CHE,JOR,2019.0,1,2,-1
NOR,COL,2023.0,1,2,-1
MWI,COD,2021.0,1,1,0
ZWE,KEN,2019.0,2,2,0
KEN,ZWE,2020.0,1,3,-2
POL,BLR,2023.0,1,3,-2
UKR,AUS,2022.0,1,1,0
SGP,THA,2004.0,1,2,-1
MKD,AUT,2018.0,1,5,-4
JPN,VNM,1997.0,2,4,-2
ESP,DZA,2001.0,1,1,0
CZE,FIN,2011.0,2,7,-5
KWT,OMN,2003.0,1,1,0
CYP,CAN,2003.0,1,1,0
THA,BRA,2018.0,1,2,-1
CHN,MWI,2018.0,2,1,1
LTU,POL,2018.0,1,3,-2
BLR,JPN,2012.0,1,1,0
LVA,GBR,2015.0,1,1,0
EGY,BRA,2011.0,1,2,-1
KOR,PRK,2016.0,1,4,-3
PSE,AUT,2015.0,1,2,-1
SYR,ARE,2019.0,1,1,0
ARE,SRB,2018.0,1,1,0
EST,JPN,2023.0,1,1,0
PRT,AGO,2020.0,1,5,-4
KOR,AUT,2023.0,1,8,-7
SVN,MEX,2012.0,1,2,-1
IDN,IND,1999.0,1,2,-1
IND,CIV,2023.0,1,1,0
VNM,MYS,2018.0,2,8,-6
CUB,ECU,2023.0,1,4,-3
CYP,DEU,2013.0,1,2,-1
VNM,POL,2024.0,1,1,0
CZE,SWE,1997.0,1,7,-6
SEN,GBR,2007.0,1,3,-2
TTO,IND,2014.0,1,4,-3
PAK,NZL,2015.0,1,10,-9
SVK,IND,2023.0,1,4,-3
IND,MWI,2015.0,2,1,1
NOR,NZL,2023.0,1,5,-4
ZAF,KOR,2008.0,1,1,0
USA,MDA,2008.0,2,1,1
MOZ,KEN,2018.0,1,3,-2
POL,HUN,2001.0,2,1,1
BEN,BEL,2010.0,2,2,0
JPN,SVK,1999.0,1,2,-1
ARE,NZL,2002.0,1,2,-1
UKR,BEL,2004.0,2,4,-2
FRA,LUX,1999.0,2,1,1
CAN,MYS,2002.0,1,2,-1
TWN,ZAF,2018.0,1,2,-1
IRL,JPN,2002.0,1,5,-4
BGR,AUS,2005.0,1,2,-1
GRC,ARE,2011.0,1,1,0
COL,MEX,1997.0,1,6,-5
ARM,DNK,2001.0,1,1,0
FIN,UKR,2020.0,1,1,0
JPN,EST,2012.0,1,1,0
DEU,UGA,2018.0,1,4,-3
QAT,KOR,2022.0,1,2,-1
LKA,MYS,2015.0,1,3,-2
BEN,CAN,2015.0,1,3,-2
CAN,PER,2020.0,1,2,-1
GRC,MEX,2019.0,1,1,0
OMN,CYP,2019.0,1,2,-1
ISR,PSE,1999.0,1,5,-4
CHL,VNM,2016.0,1,1,0
ITA,TWN,2008.0,1,2,-1
AUT,BGR,2015.0,1,2,-1
BGR,BRA,2019.0,1,2,-1
KOR,ARE,2011.0,1,2,-1
ZAF,PRT,2012.0,1,1,0
AUS,MKD,2007.0,1,2,-1
GUF,USA,2017.0,1,1,0
BEL,KOR,2004.0,1,1,0
CHE,SEN,2023.0,1,2,-1
BOL,BRA,2019.0,1,8,-7
GUY,AUS,2018.0,1,1,0
KHM,NLD,2022.0,1,2,-1
USA,MNE,2018.0,1,1,0
ARE,MEX,2021.0,1,3,-2
QAT,KOR,2016.0,1,6,-5
ESP,IRQ,2019.0,1,1,0
ESP,SRB,2008.0,1,2,-1
RWA,USA,1998.0,1,1,0
ESP,GNQ,2008.0,2,1,1
LVA,RUS,2010.0,1,3,-2
CAN,ISL,2009.0,2,2,0
MOZ,ESP,2015.0,1,3,-2
QAT,SWE,2015.0,1,3,-2
GHA,CIV,2020.0,1,2,-1
DNK,PAK,2008.0,1,1,0
VEN,BRA,2023.0,1,1,0
ECU,DEU,2009.0,1,1,0
HTI,CHE,2019.0,1,1,0
SGP,FIN,2006.0,1,3,-2
BGD,HKG,2007.0,1,2,-1
GIN,MLI,2017.0,1,4,-3
DEU,UGA,2017.0,1,9,-8
SEN,CMR,2003.0,1,1,0
CHL,AUT,2015.0,1,5,-4
ISR,CHL,1998.0,1,1,0
TUR,SAU,1999.0,1,1,0
IRQ,BGD,2017.0,1,1,0
DZA,NLD,2020.0,1,1,0
ZAF,GMB,2017.0,1,1,0
ZAF,GMB,2022.0,1,1,0
ALB,CHE,2018.0,1,1,0
SEN,MAR,2020.0,1,2,-1
SAU,NLD,2001.0,1,1,0
JPN,UZB,2006.0,1,1,0
TWN,MAR,2003.0,1,2,-1
POL,LTU,2006.0,1,4,-3
USA,HND,2005.0,1,3,-2
BHR,EGY,2010.0,1,2,-1
CHE,CIV,2005.0,1,1,0
MDA,ESP,2008.0,1,1,0
DNK,BRA,2002.0,1,2,-1
PRT,VEN,2017.0,1,1,0
IRL,TUN,2009.0,1,1,0
AUS,MUS,2013.0,1,1,0
GHA,KEN,2010.0,2,1,1
NOR,MYS,2015.0,1,1,0
BEL,NGA,2009.0,1,1,0
URY,DEU,2002.0,1,1,0
BIH,ARE,2021.0,1,1,0
LUX,FRA,2004.0,1,19,-18
KHM,GBR,2008.0,1,7,-6
SRB,DNK,2005.0,1,6,-5
HUN,MEX,2015.0,1,1,0
AUS,NGA,2014.0,1,5,-4
ETH,CHE,2015.0,1,2,-1
IDN,ITA,2012.0,1,1,0
FIN,THA,2012.0,1,1,0
NIC,ESP,2010.0,1,1,0
JPN,TUN,2011.0,1,1,0
EGY,DNK,2019.0,1,6,-5
ARE,NZL,2012.0,1,5,-4
BWA,NGA,2014.0,1,4,-3
MSR,USA,2019.0,1,1,0
VNM,AUT,2016.0,1,2,-1
FRA,SDN,2020.0,1,3,-2
BRA,TUR,2014.0,2,4,-2
BFA,BEL,2014.0,1,1,0
SWE,VNM,2023.0,1,4,-3
CRI,NLD,2004.0,1,3,-2
MEX,NGA,2023.0,1,2,-1
KEN,GHA,2007.0,1,1,0
MOZ,ESP,2014.0,1,3,-2
YEM,IND,2009.0,1,1,0
EGY,PAK,2012.0,1,5,-4
AUT,BGR,2004.0,1,1,0
OMN,DEU,1997.0,1,1,0
GHA,LKA,2014.0,1,1,0
KAZ,DEU,2000.0,1,2,-1
NOR,BEL,2006.0,1,1,0
URY,SWE,2000.0,1,2,-1
MEX,NIC,2002.0,1,1,0
HUN,ECU,2017.0,1,1,0
AUT,TUN,2015.0,1,1,0
ARG,PHL,2015.0,2,1,1
NOR,BRA,2008.0,1,1,0
BGD,PHL,2022.0,1,3,-2
CHN,MEX,2003.0,1,4,-3
POL,LVA,2003.0,1,1,0
PRT,HUN,2007.0,1,1,0
GBR,AFG,2016.0,1,2,-1
CHN,HUN,2017.0,1,5,-4
EST,NOR,2017.0,1,1,0
PER,GBR,2005.0,1,2,-1
USA,YEM,2015.0,1,3,-2
KEN,DNK,2018.0,1,4,-3
BRA,MAR,2010.0,1,1,0
BOL,COL,2011.0,1,2,-1
FRA,PRI,2019.0,1,1,0
NER,NGA,2008.0,1,9,-8
CZE,IRN,2014.0,1,6,-5
SGP,IDN,2009.0,1,1,0
SGP,BRA,2013.0,1,3,-2
LKA,SWE,2012.0,1,4,-3
SYR,CAN,2017.0,1,1,0
AGO,USA,2017.0,1,1,0
LUX,CAN,2019.0,1,3,-2
ASM,WSM,2021.0,1,1,0
QAT,AUT,2018.0,2,0,2
BRN,CAN,2004.0,1,0,1
BGD,PHL,1997.0,2,0,2
BGD,NIC,2002.0,1,0,1
NLD,ABW,2003.0,1,0,1
UZB,BEL,2002.0,2,0,2
COM,USA,2019.0,1,0,1
MLI,TGO,1997.0,1,0,1
MDA,UKR,2004.0,3,0,3
VEN,JPN,2001.0,1,0,1
ISR,OMN,2002.0,1,0,1
OMN,ISR,2003.0,1,0,1
HKG,MUS,2010.0,1,0,1
CHL,MDG,2003.0,1,0,1
NGA,TZA,2012.0,2,0,2
ITA,PHL,1999.0,1,0,1
KEN,ESP,2000.0,1,0,1
PRI,AUS,2010.0,1,0,1
IDN,MYS,2004.0,2,0,2
BRN,NZL,1999.0,1,0,1
PHL,KHM,2003.0,1,0,1
GMB,CHE,2012.0,1,0,1
CHE,GMB,2013.0,1,0,1
NGA,ZMB,1997.0,1,0,1
VEN,IND,2007.0,2,0,2
IND,VEN,2008.0,2,0,2
ISR,SRB,2011.0,1,0,1
PRI,ARG,2023.0,2,0,2
TZA,UGA,2003.0,1,0,1
THA,MMR,1999.0,1,0,1
BEL,PER,2004.0,1,0,1
CHE,CYP,2014.0,2,0,2
CZE,DZA,2009.0,1,0,1
IND,GNB,2008.0,1,0,1
TON,FJI,2010.0,1,0,1
NGA,FRA,2005.0,1,0,1
ZWE,COG,2004.0,1,0,1
NER,MLI,2018.0,1,0,1
PRT,MLT,2022.0,2,0,2
URY,AUS,2007.0,2,0,2
MAR,HRV,2009.0,1,0,1
LUX,MAR,2023.0,1,0,1
BRA,CPV,2016.0,1,0,1
TTO,SGP,2020.0,1,0,1
,VCT,2001.0,1,0,1
GBR,VIR,2005.0,1,0,1
CMR,GHA,2012.0,1,0,1
TLS,JPN,2009.0,2,0,2
FSM,,2015.0,1,0,1
THA,MOZ,2011.0,3,0,3
CHN,LSO,2011.0,1,0,1
ZAF,ROU,2010.0,1,0,1
MEX,ISL,2020.0,2,0,2
GMB,,2013.0,5,0,5
,BDI,2005.0,3,0,3
,AND,1996.0,1,0,1
IRN,YEM,2008.0,1,0,1
DZA,GRC,2013.0,1,0,1
AUS,PRI,2008.0,1,0,1
ARE,CZE,2016.0,1,0,1
UKR,BRN,2014.0,1,0,1
VEN,IDN,2019.0,1,0,1
KEN,CHE,2005.0,1,0,1
CYP,ARE,2014.0,1,0,1
CAN,LSO,2013.0,1,0,1
NCL,KIR,2006.0,1,0,1
LTU,CZE,2014.0,1,0,1
HUN,BGR,2005.0,2,0,2
KHM,CHE,2023.0,2,0,2
MYS,MMR,2020.0,3,0,3
NER,MLI,2016.0,1,0,1
IND,LTU,2016.0,1,0,1
ARE,HUN,2012.0,1,0,1
SEN,MRT,2019.0,1,0,1
ETH,HUN,2012.0,1,0,1
GMB,NZL,2018.0,2,0,2
HRV,CRI,2015.0,1,0,1
CAF,GBR,2017.0,1,0,1
VGB,,2017.0,1,0,1
ISR,GIB,2015.0,1,0,1
UKR,LVA,2015.0,1,0,1
PRT,MLT,2017.0,2,0,2
NZL,KWT,2015.0,1,0,1
IRN,YEM,2014.0,1,0,1
MYS,DOM,2020.0,1,0,1
JOR,NOR,2013.0,1,0,1
MNE,HRV,2010.0,1,0,1
CHN,AFG,2016.0,1,0,1
TCA,NLD,2012.0,1,0,1
HKG,ROU,2013.0,1,0,1
NIC,NLD,2012.0,1,0,1
GTM,PAN,2013.0,1,0,1
VNM,BHR,2016.0,1,0,1
SWE,BWA,2018.0,2,0,2
EGY,DZA,2018.0,1,0,1
HKG,OMN,2011.0,1,0,1
COL,VNM,2021.0,1,0,1
ALB,POL,2017.0,1,0,1
IRN,LVA,2021.0,2,0,2
CMR,UGA,2010.0,1,0,1
CUB,PRI,2011.0,1,0,1
BFA,BRA,1997.0,1,0,1
EUE,GBR,2007.0,1,0,1
ISR,LTU,2007.0,2,0,2
LBN,BRN,2002.0,1,0,1
KEN,SLE,2013.0,1,0,1
SLE,TZA,2015.0,1,0,1
USA,LBY,2001.0,1,0,1
SYR,FIN,2016.0,1,0,1
,GIB,2013.0,1,0,1
,CYM,1998.0,1,0,1
COG,BEN,2018.0,2,0,2
SUR,OMN,2020.0,1,0,1
BLR,VNM,2020.0,1,0,1
HUN,GMB,2019.0,1,0,1
SYR,ARE,2013.0,1,0,1
UGA,LBR,2021.0,1,0,1
ARM,ROU,2021.0,1,0,1
KEN,ISR,2017.0,1,0,1
ROU,UKR,2014.0,1,0,1
TZA,ZWE,2019.0,1,0,1
COL,TWN,2021.0,1,0,1
IRQ,BEL,2021.0,1,0,1
PSE,KWT,2021.0,1,0,1
TWN,ARG,2020.0,1,0,1
BEN,GIN,2018.0,1,0,1
NGA,AUT,2022.0,2,0,2
SEN,GLP,2009.0,1,0,1
SWE,BWA,2016.0,1,0,1
BTN,IND,2023.0,2,0,2
TCD,,2026.0,1,0,1
WSM,USA,2022.0,1,0,1
BOL,URY,2019.0,2,0,2
,CYM,2020.0,1,0,1
EGY,MAR,2021.0,4,0,4
MNP,USA,2023.0,1,0,1
JOR,OMN,2013.0,2,0,2
DNK,MLT,2016.0,1,0,1
NAM,NLD,2015.0,2,0,2
ITA,MUS,2020.0,2,0,2
LUX,BDI,2012.0,1,0,1
PAN,NIC,2015.0,1,0,1
NOR,BGD,2013.0,2,0,2
BDI,COD,2017.0,1,0,1
SAU,ZWE,2022.0,1,0,1
MLI,COD,2019.0,1,0,1
LKA,QAT,2015.0,1,0,1
BRB,ISR,2017.0,1,0,1
DEU,TUN,2014.0,2,0,2
THA,OMN,2015.0,1,0,1
MEX,SUR,2018.0,1,0,1
SUR,MEX,2022.0,1,0,1
KOR,UZB,2016.0,2,0,2
NZL,CZE,2013.0,1,0,1
VEN,IRL,2017.0,1,0,1
LVA,ARM,1999.0,2,0,2
MWI,CHE,2001.0,1,0,1
HRV,ALB,2022.0,1,0,1
TUN,PAK,2013.0,1,0,1
CHE,LAO,2002.0,1,0,1
GRD,CAN,2007.0,1,0,1
MEX,SYR,2005.0,1,0,1
TUR,OMN,2021.0,1,0,1
NCL,DEU,2019.0,1,0,1
JAM,NZL,2011.0,1,0,1
MCO,SWE,2000.0,1,0,1
CYP,IRL,2010.0,1,0,1
RUS,RWA,2009.0,2,0,2
RWA,TZA,2012.0,1,0,1
VUT,FJI,2001.0,2,0,2
GLP,CMR,2008.0,1,0,1
LBR,LBN,2010.0,1,0,1
MEX,CHL,2000.0,4,0,4
UKR,SVN,2012.0,3,0,3
CZE,MEX,1998.0,1,0,1
BEL,GHA,2010.0,1,0,1
SVK,AUS,2009.0,1,0,1
NOR,NAM,2003.0,1,0,1
UZB,BEL,2005.0,1,0,1
ARG,ECU,2002.0,1,0,1
ZAF,THA,2012.0,1,0,1
KEN,ZMB,2018.0,2,0,2
TTO,ARG,2011.0,1,0,1
GEO,BEL,2000.0,1,0,1
PHL,SGP,2004.0,2,0,2
CIV,CRI,2004.0,1,0,1
FRA,JAM,2014.0,1,0,1
AUS,SLV,2004.0,1,0,1
HUN,LBY,2003.0,1,0,1
QAT,MYS,2007.0,1,0,1
MYS,SEN,2017.0,1,0,1
IRQ,,1999.0,3,0,3
DNK,EST,2013.0,1,0,1
QAT,IRQ,2007.0,1,0,1
USA,NER,1999.0,2,0,2
CZE,JOR,2008.0,1,0,1
JPN,PRT,2006.0,2,0,2
IRL,PHL,2005.0,1,0,1
SWZ,BWA,2011.0,1,0,1
GRD,,2008.0,2,0,2
BGD,AUT,2002.0,1,0,1
CZE,LUX,2009.0,1,0,1
KWT,SVN,2001.0,1,0,1
TZA,RWA,2009.0,3,0,3
POL,HKG,2007.0,1,0,1
ZAF,KWT,2007.0,1,0,1
LKA,EST,2023.0,1,0,1
TUR,BGR,2023.0,1,0,1
CAN,KNA,2016.0,1,0,1
LTU,TUR,2015.0,1,0,1
MYS,QAT,2005.0,2,0,2
GBR,MAC,2008.0,1,0,1
TTO,AUS,2008.0,1,0,1
AUS,GRD,2012.0,1,0,1
AND,,2009.0,1,0,1
THA,ZMB,2022.0,1,0,1
IRN,MEX,2013.0,1,0,1
POL,UZB,2004.0,1,0,1
UZB,ARE,2015.0,1,0,1
ARE,UZB,2017.0,1,0,1
UKR,MYS,2016.0,1,0,1
URY,COL,2019.0,1,0,1
CAN,NER,2019.0,1,0,1
NER,MLI,2022.0,3,0,3
PAK,BWA,2020.0,1,0,1
KOR,OMN,2019.0,1,0,1
KGZ,QAT,2023.0,1,0,1
KEN,BWA,2000.0,1,0,1
NER,UGA,2014.0,1,0,1
NOR,BIH,2017.0,1,0,1
ESP,LAO,2021.0,1,0,1
CUB,SWE,2011.0,1,0,1
KEN,SOM,2014.0,1,0,1
KAZ,BLR,2016.0,1,0,1
MWI,COG,2017.0,1,0,1
PAK,KGZ,2022.0,1,0,1
PRT,SEN,1999.0,1,0,1
NIC,MEX,2018.0,1,0,1
FIN,ZMB,2019.0,1,0,1
HND,CHL,2018.0,1,0,1
HUN,EST,2019.0,1,0,1
CAF,CIV,2016.0,2,0,2
SRB,DNK,2018.0,1,0,1
PRT,CPV,2007.0,1,0,1
CIV,JPN,2017.0,1,0,1
COL,DOM,2019.0,2,0,2
MYS,ARE,2004.0,2,0,2
AUS,PRI,2001.0,1,0,1
HUN,ARE,2010.0,1,0,1
GRL,DNK,1998.0,2,0,2
ECU,WSM,2010.0,1,0,1
SAU,VEN,2010.0,1,0,1
USA,VGB,2021.0,1,0,1
AGO,COG,2013.0,1,0,1
LBR,ZWE,2020.0,1,0,1
BIH,EGY,2016.0,1,0,1
ISR,ROU,2007.0,1,0,1
NLD,PAN,2020.0,1,0,1
ITA,LKA,2023.0,1,0,1
AUS,NAM,2012.0,1,0,1
OMN,THA,2010.0,1,0,1
GAB,GBR,2011.0,2,0,2
SVN,MYS,2010.0,1,0,1
ZWE,BWA,2021.0,3,0,3
KHM,GHA,2015.0,1,0,1
MYS,KNA,2016.0,1,0,1
SWE,VEN,1999.0,3,0,3
GBR,CIV,1999.0,1,0,1
CUB,PRI,2019.0,1,0,1
FIN,MAC,2017.0,2,0,2
MYS,KWT,2000.0,1,0,1
LBY,BHR,2012.0,1,0,1
OMN,CHE,2005.0,3,0,3
SAU,IRL,1998.0,1,0,1
GBR,WLF,2021.0,1,0,1
ARE,NOR,2013.0,1,0,1
IRN,NGA,2014.0,1,0,1
ARM,ISR,2020.0,1,0,1
BLR,JPN,2018.0,2,0,2
JOR,NZL,2020.0,1,0,1
AZE,COL,2010.0,1,0,1
CIV,CRI,2014.0,2,0,2
HUN,GEO,2017.0,1,0,1
RUS,YEM,2013.0,1,0,1
FIN,GHA,2014.0,1,0,1
NGA,PHL,2016.0,1,0,1
PER,NOR,2012.0,1,0,1
ITA,SAU,2009.0,3,0,3
CZE,SAU,2016.0,1,0,1
DNK,BOL,2013.0,1,0,1
TUR,TWN,2012.0,1,0,1
ALB,ESP,2013.0,1,0,1
WLF,FRA,2012.0,2,0,2
SGP,GHA,2008.0,1,0,1
CZE,SVK,2024.0,1,0,1
GIN,GBR,2014.0,1,0,1
HND,CAN,2016.0,1,0,1
CAF,PAK,2017.0,1,0,1
ESP,HND,2013.0,2,0,2
IND,LAO,2017.0,1,0,1
AGO,KHM,2017.0,1,0,1
KHM,AGO,2022.0,1,0,1
GRC,NPL,2016.0,1,0,1
LTU,LUX,2017.0,1,0,1
KAZ,LTU,2022.0,1,0,1
LTU,KAZ,2023.0,2,0,2
TCD,KEN,2018.0,1,0,1
DEU,TTO,2016.0,2,0,2
ESP,ARM,1997.0,1,0,1
URY,NZL,2015.0,1,0,1
ZWE,AUT,2008.0,1,0,1
USA,REU,2006.0,1,0,1
ETH,HKG,2019.0,1,0,1
ESP,KNA,2022.0,1,0,1
POL,ETH,2019.0,1,0,1
,VGB,2014.0,1,0,1
MAR,CHL,2022.0,2,0,2
,MSR,2014.0,1,0,1
GEO,ITA,2024.0,1,0,1
BLR,LVA,2017.0,1,0,1
CHE,URY,2013.0,1,0,1
FIN,BLR,2017.0,1,0,1
IND,UKR,2015.0,1,0,1
TWN,JOR,2021.0,2,0,2
MAR,DNK,2014.0,1,0,1
AUS,UZB,2020.0,3,0,3
GMB,SEN,2018.0,1,0,1
DNK,LVA,2023.0,1,0,1
CHN,SVN,1998.0,1,0,1
LBN,OMN,2021.0,2,0,2
,MHL,2017.0,4,0,4
ISR,KEN,2022.0,1,0,1
BDI,IDN,2021.0,1,0,1
CHE,DZA,2023.0,1,0,1
NPL,ROU,2022.0,1,0,1
CHE,DZA,2006.0,1,0,1
BRA,TUR,2023.0,1,0,1
NGA,SVK,2012.0,1,0,1
GEO,GAB,2023.0,1,0,1
SYR,QAT,2010.0,1,0,1
DEU,LKA,2005.0,3,0,3
CAF,CHN,2006.0,1,0,1
IRL,BIH,2012.0,1,0,1
CRI,SWE,2012.0,1,0,1
HKG,NOR,2012.0,1,0,1
KEN,PER,2000.0,1,0,1
UKR,DNK,2012.0,3,0,3
ITA,TCD,2019.0,1,0,1
MLT,CYP,2008.0,1,0,1
TON,AUS,2004.0,1,0,1
AUS,TON,2007.0,1,0,1
ZAF,MLI,2002.0,1,0,1
AUT,IDN,2002.0,1,0,1
CHL,LBN,2021.0,1,0,1
CAF,USA,2012.0,2,0,2
GRC,JOR,2012.0,1,0,1
BWA,TZA,2007.0,1,0,1
LTU,EST,2009.0,2,0,2
CZE,LVA,2007.0,1,0,1
CHE,ARE,2005.0,2,0,2
CAN,MTQ,2015.0,1,0,1
SRB,FIN,2023.0,1,0,1
IRL,BHR,2003.0,1,0,1
BEL,MKD,2005.0,1,0,1
TUR,BLR,2009.0,1,0,1
DZA,HRV,2003.0,1,0,1
BEL,ALB,1998.0,1,0,1
LVA,ITA,2005.0,2,0,2
ITA,LVA,2006.0,1,0,1
GTM,DOM,2014.0,1,0,1
AUS,PYF,2009.0,1,0,1
MUS,CHE,2011.0,1,0,1
POL,LBY,2001.0,2,0,2
BFA,USA,2008.0,1,0,1
FJI,VUT,1999.0,1,0,1
BIH,QAT,2014.0,1,0,1
DNK,SAU,2007.0,1,0,1
NIC,ESP,2001.0,2,0,2
DEU,FLK,2003.0,2,0,2
CHN,SRB,2004.0,1,0,1
SRB,CHN,2006.0,2,0,2
SJM,,2023.0,1,0,1
MOZ,KOR,2000.0,1,0,1
ITA,PHL,2007.0,1,0,1
GBR,MDG,2004.0,1,0,1
ESP,GIN,2015.0,1,0,1
NLD,CIV,2009.0,1,0,1
AZE,DNK,2013.0,1,0,1
POL,NZL,2010.0,1,0,1
NGA,ARG,2012.0,1,0,1
PRT,MOZ,2005.0,1,0,1
IRL,QAT,2007.0,1,0,1
TCD,USA,2012.0,1,0,1
BRA,BGR,2012.0,2,0,2
BGR,BRA,2013.0,1,0,1
CHL,PRT,2010.0,2,0,2
TWN,ARG,2007.0,1,0,1
VUT,GBR,2006.0,1,0,1
AUT,LBN,2018.0,1,0,1
MWI,SLE,2013.0,1,0,1
GHA,VNM,2020.0,1,0,1
POL,TUR,2005.0,1,0,1
KOR,KEN,2007.0,1,0,1
CYP,HUN,2008.0,1,0,1
CHN,LKA,2003.0,1,0,1
ZAF,AUT,2002.0,2,0,2
FRA,MRT,1999.0,1,0,1
ARE,SRB,2005.0,1,0,1
,MSR,2004.0,3,0,3
CIV,KOR,2015.0,1,0,1
HRV,FIN,2008.0,1,0,1
SGP,RUS,2005.0,1,0,1
MYS,KAZ,2022.0,1,0,1
VNM,POL,2001.0,1,0,1
POL,VNM,2004.0,1,0,1
LTU,SGP,2016.0,1,0,1
CMR,MDG,2013.0,2,0,2
ITA,AGO,2019.0,1,0,1
SEN,CIV,1999.0,1,0,1
GAB,GIN,2016.0,1,0,1
NGA,MAR,2011.0,2,0,2
IRN,EST,2014.0,1,0,1
PRI,ARE,2019.0,1,0,1
SDN,OMN,2023.0,1,0,1
MHL,GBR,2016.0,1,0,1
SRB,SGP,2018.0,2,0,2
FRO,,2014.0,1,0,1
NLD,GEO,2008.0,1,0,1
PHL,LAO,2018.0,1,0,1
JAM,IRL,2011.0,1,0,1
TUR,ECU,2014.0,1,0,1
LBY,SAU,2015.0,3,0,3
USA,SUR,2012.0,1,0,1
,SOM,2008.0,1,0,1
BEL,BIH,2010.0,1,0,1
BFA,,2026.0,2,0,2
CUB,AUT,2013.0,2,0,2
BEN,KOR,2022.0,1,0,1
BOL,FRA,2022.0,2,0,2
FIN,PAN,2018.0,1,0,1
CHN,TJK,2023.0,2,0,2
GHA,PRT,2013.0,1,0,1
ROU,PAK,2021.0,2,0,2
TWN,HTI,2022.0,1,0,1
ZAF,SDN,2023.0,1,0,1
THA,GUF,2005.0,1,0,1
NZL,BRA,1999.0,2,0,2
UKR,SRB,2014.0,1,0,1
CMR,NLD,1999.0,1,0,1
SEN,CIV,1998.0,1,0,1
SDN,ITA,1999.0,1,0,1
BRA,ZAF,2001.0,1,0,1
HRV,AUS,2000.0,1,0,1
SWE,GRL,2008.0,1,0,1
GLP,ITA,2007.0,1,0,1
BLR,ISR,2015.0,1,0,1
UKR,SVN,2002.0,1,0,1
DEU,GMB,1997.0,3,0,3
LVA,FIN,2009.0,1,0,1
FLK,,2008.0,1,0,1
FIN,LUX,2003.0,2,0,2
NLD,CUW,2014.0,1,0,1
SWE,PRI,1998.0,1,0,1
NGA,IRL,2006.0,1,0,1
CYP,TUR,2000.0,1,0,1
FIN,MEX,1997.0,2,0,2
BRA,QAT,2019.0,2,0,2
,VCT,2008.0,1,0,1
ARG,POL,2018.0,1,0,1
LIE,AUT,2012.0,3,0,3
ITA,PRY,2020.0,1,0,1
POL,SRB,2008.0,1,0,1
NIC,GBR,2018.0,1,0,1
LUX,SRB,2017.0,1,0,1
EGY,LBY,2008.0,3,0,3
SAU,SGP,2000.0,2,0,2
TWN,ARE,1999.0,1,0,1
SWE,LIE,2012.0,1,0,1
LBY,USA,2000.0,1,0,1
LSO,POL,2003.0,1,0,1
,RWA,1999.0,3,0,3
RWA,BWA,2002.0,1,0,1
DNK,SAU,2020.0,4,0,4
BRA,CPV,2018.0,2,0,2
GAB,ESP,1998.0,1,0,1
PER,ECU,1999.0,1,0,1
HUN,BGR,1997.0,1,0,1
PSE,BRN,2021.0,1,0,1
ZAF,RWA,2003.0,1,0,1
KEN,MEX,2002.0,1,0,1
ARG,GRC,2019.0,1,0,1
ESP,TWN,2005.0,1,0,1
ARG,DOM,2022.0,1,0,1
MDA,GBR,2015.0,1,0,1
KAZ,BGR,2022.0,2,0,2
USA,FLK,2021.0,1,0,1
ARG,POL,2022.0,1,0,1
ESP,GIB,2021.0,2,0,2
DEU,TGO,2017.0,1,0,1
CAN,PRI,2019.0,1,0,1
ECU,ARE,2021.0,1,0,1
CHN,MEX,2011.0,2,0,2
NZL,MAC,2019.0,1,0,1
CHE,SSD,2017.0,2,0,2
LTU,JPN,2006.0,1,0,1
BLZ,GTM,2007.0,1,0,1
TTO,IRL,2011.0,1,0,1
AUT,KAZ,2009.0,1,0,1
AUS,MWI,2004.0,2,0,2
MEX,TZA,1998.0,1,0,1
URY,DNK,2007.0,1,0,1
UKR,IRN,2011.0,2,0,2
MEX,ETH,2012.0,1,0,1
ZAF,DZA,2010.0,1,0,1
MKD,GRC,2013.0,3,0,3
GBR,AFG,2012.0,1,0,1
JPN,YEM,2015.0,1,0,1
MMR,DEU,2006.0,1,0,1
UZB,POL,2009.0,1,0,1
ZAF,SYR,2010.0,1,0,1
SVN,BRA,2012.0,1,0,1
CUB,AUT,2003.0,1,0,1
ALB,NLD,2013.0,1,0,1
IRN,CZE,2008.0,2,0,2
ZAF,PHL,2010.0,1,0,1
BLR,CAN,2000.0,1,0,1
BGD,PHL,2002.0,1,0,1
MLT,USA,2003.0,1,0,1
ITA,GEO,2021.0,1,0,1
GMB,KEN,2008.0,2,0,2
KWT,NZL,2010.0,1,0,1
GRC,KOR,2007.0,1,0,1
TJK,RUS,2007.0,1,0,1
BRA,SVN,2016.0,1,0,1
QAT,LTU,2021.0,1,0,1
SGP,CHE,2024.0,1,0,1
IRN,DZA,2018.0,1,0,1
RUS,RWA,2021.0,1,0,1
ITA,PNG,2019.0,1,0,1
NPL,IRL,2022.0,2,0,2
EST,GEO,2022.0,1,0,1
TUN,GUF,2020.0,1,0,1
BRN,JPN,2023.0,1,0,1
VNM,EGY,2020.0,2,0,2
CHN,PRI,2023.0,1,0,1
GAB,NLD,2022.0,1,0,1
TZA,HUN,2022.0,1,0,1
ITA,MLI,2021.0,2,0,2
AFG,BRA,2021.0,1,0,1
THA,LTU,2021.0,1,0,1
CZE,NPL,2023.0,1,0,1
GMB,SEN,2022.0,2,0,2
NOR,THA,2003.0,1,0,1
ZWE,SLE,2015.0,1,0,1
SGP,ROU,2020.0,2,0,2
HUN,LVA,2015.0,1,0,1
CHN,ROU,2007.0,1,0,1
CPV,BRA,2019.0,2,0,2
SYR,POL,2012.0,1,0,1
LBY,IRQ,2012.0,1,0,1
UGA,TZA,2008.0,1,0,1
FRA,PAN,2019.0,1,0,1
POL,LVA,2009.0,1,0,1
NOR,BGR,2021.0,1,0,1
TUR,BRA,2007.0,1,0,1
THA,KOR,2005.0,1,0,1
SWE,PER,2002.0,2,0,2
BEL,URY,2013.0,1,0,1
COG,GBR,2013.0,1,0,1
NPL,NZL,2006.0,1,0,1
KAZ,JAM,2009.0,1,0,1
MDG,TUN,2012.0,1,0,1
BWA,CHE,2006.0,1,0,1
KHM,VNM,2017.0,1,0,1
AUT,NGA,2018.0,1,0,1
TJK,USA,2022.0,1,0,1
FRO,USA,2016.0,1,0,1
,TCA,2010.0,2,0,2
SWE,MNG,2013.0,1,0,1
CMR,CAF,2014.0,1,0,1
KWT,IRN,2001.0,1,0,1
ETH,DJI,2023.0,1,0,1
MUS,MYS,2014.0,1,0,1
IRN,IRQ,2010.0,2,0,2
HUN,BGD,2010.0,1,0,1
PER,PHL,2016.0,1,0,1
NOR,VNM,2016.0,1,0,1
NAM,FRA,2016.0,1,0,1
PAN,TWN,2019.0,1,0,1
KEN,GRC,2015.0,1,0,1
DZA,UKR,2017.0,1,0,1
LBN,ESP,2015.0,1,0,1
SAU,CHN,2024.0,3,0,3
ETH,TTO,2023.0,1,0,1
ECU,HND,2020.0,1,0,1
IDN,PRT,2021.0,1,0,1
PAK,MOZ,2022.0,1,0,1
CMR,NZL,2022.0,1,0,1
SRB,BRA,2012.0,1,0,1
SYR,SWE,2022.0,1,0,1
CHL,GTM,1998.0,1,0,1
LTU,EST,2021.0,1,0,1
FRA,KHM,2004.0,1,0,1
MWI,LUX,2003.0,1,0,1
LBN,RUS,2002.0,1,0,1
NER,BOL,2000.0,1,0,1
FIN,LBY,2014.0,1,0,1
,FLK,2000.0,1,0,1
COL,CHN,2018.0,2,0,2
PHL,ASM,2006.0,1,0,1
LVA,BEL,1997.0,1,0,1
BEL,LVA,1998.0,1,0,1
SRB,MLT,2000.0,1,0,1
POL,VNM,2008.0,1,0,1
NZL,ISR,2002.0,1,0,1
IDN,EGY,2014.0,1,0,1
AUT,KEN,1997.0,1,0,1
DOM,RUS,2007.0,1,0,1
BRA,UZB,1997.0,1,0,1
MKD,USA,1998.0,1,0,1
CRI,CHN,2016.0,1,0,1
BGR,BLR,1998.0,1,0,1
GLP,CHE,2016.0,1,0,1
SWZ,ZWE,2011.0,1,0,1
KEN,IRN,2011.0,2,0,2
CZE,ISL,2017.0,1,0,1
ZAF,COG,2013.0,2,0,2
ATG,ARG,2015.0,1,0,1
SYR,AUT,2015.0,1,0,1
EST,COL,2013.0,1,0,1
LKA,FJI,2013.0,1,0,1
BWA,MEX,2018.0,1,0,1
DEU,BFA,2020.0,1,0,1
CHE,ARE,2012.0,1,0,1
SWZ,MWI,2020.0,1,0,1
LVA,SVN,2014.0,1,0,1
LTU,CZE,2015.0,1,0,1
TWN,PRI,2015.0,1,0,1
SYR,MYS,2017.0,1,0,1
CHN,SLE,2014.0,1,0,1
CHL,DOM,2012.0,1,0,1
SYC,ITA,2018.0,1,0,1
GHA,NAM,2021.0,1,0,1
IRL,TTO,1999.0,2,0,2
KAZ,NLD,2020.0,2,0,2
TGO,USA,2016.0,2,0,2
UGA,CHN,2002.0,1,0,1
TUR,UZB,2016.0,2,0,2
SWE,GEO,2018.0,1,0,1
BLR,SWE,2015.0,2,0,2
VEN,SVN,2007.0,1,0,1
IRL,SWZ,2011.0,1,0,1
GUF,SUR,2015.0,1,0,1
RUS,IDN,2023.0,1,0,1
JPN,ZWE,2018.0,1,0,1
SSD,KEN,2010.0,1,0,1
PSE,QAT,2018.0,1,0,1
AUT,NPL,2020.0,1,0,1
CHL,HKG,2012.0,1,0,1
SVK,IRN,2017.0,1,0,1
MYS,ZMB,2020.0,1,0,1
ROU,SVN,2019.0,1,0,1
ITA,GTM,2010.0,1,0,1
GHA,HUN,2018.0,2,0,2
PER,LUX,2021.0,1,0,1
IRQ,SDN,2015.0,1,0,1
IRQ,ECU,2022.0,1,0,1
SLB,USA,2018.0,1,0,1
GRC,TTO,2018.0,1,0,1
GEO,NOR,2017.0,1,0,1
,AND,2004.0,2,0,2
ROU,UKR,2015.0,2,0,2
PAN,CHL,2018.0,1,0,1
IRN,NOR,2024.0,1,0,1
,AND,2014.0,2,0,2
,KIR,2018.0,1,0,1
GRD,GBR,2009.0,1,0,1
BGR,PRT,2013.0,1,0,1
POL,BGR,2015.0,1,0,1
BEL,HKG,2002.0,1,0,1
MWI,NOR,2012.0,2,0,2
LTU,EGY,2019.0,1,0,1
FRA,PRI,2013.0,2,0,2
NLD,COG,2011.0,1,0,1
HUN,LVA,2004.0,1,0,1
BOL,NLD,2006.0,1,0,1
AUT,NPL,2007.0,1,0,1
BEL,NAM,2012.0,1,0,1
LTU,RUS,2007.0,1,0,1
FJI,WSM,2008.0,1,0,1
BGR,EGY,2003.0,1,0,1
TUN,ARE,2018.0,2,0,2
DZA,QAT,2018.0,1,0,1
BDI,BEL,2005.0,1,0,1
AZE,TWN,2015.0,1,0,1
PAK,PSE,2011.0,1,0,1
NZL,FIN,2000.0,1,0,1
NAM,FIN,2009.0,1,0,1
NOR,LVA,2003.0,1,0,1
NGA,TZA,2002.0,2,0,2
ISR,ZMB,2014.0,1,0,1
GUM,FRA,2021.0,1,0,1
ISR,PAK,2021.0,1,0,1
ARG,HND,2018.0,1,0,1
JPN,NAM,2020.0,1,0,1
IRN,BRN,2023.0,1,0,1
CUB,VNM,2021.0,1,0,1
ALB,BGR,2020.0,1,0,1
RUS,PAK,2018.0,1,0,1
POL,IDN,2023.0,1,0,1
MEX,NLD,2024.0,3,0,3
KEN,JOR,2013.0,1,0,1
SLV,AUS,2022.0,1,0,1
SYC,MLT,2022.0,1,0,1
KOR,JOR,2015.0,2,0,2
BEN,MWI,2023.0,1,0,1
IDN,BTN,2022.0,1,0,1
KAZ,IRL,2023.0,1,0,1
MMR,,2026.0,4,0,4
SDN,PAK,2022.0,1,0,1
PRY,ARG,2003.0,1,0,1
UKR,VEN,2000.0,1,0,1
MEX,PAK,2011.0,1,0,1
RUS,TZA,2012.0,1,0,1
PAK,ARE,1997.0,2,0,2
CHL,IRL,2016.0,1,0,1
DEU,LBN,2004.0,1,0,1
GBR,CRI,2000.0,1,0,1
LIE,,2003.0,2,0,2
ISR,PRT,2002.0,1,0,1
HKG,DNK,2006.0,2,0,2
PRI,ARG,2000.0,1,0,1
GUF,,2006.0,3,0,3
NLD,BLR,2010.0,1,0,1
BGR,NZL,2006.0,1,0,1
GMB,GIN,2021.0,1,0,1
AZE,KOR,2019.0,1,0,1
CMR,NER,2010.0,1,0,1
MDA,GBR,2004.0,1,0,1
,VGB,1996.0,1,0,1
QAT,PRY,2021.0,1,0,1
,VGB,2004.0,1,0,1
VGB,USA,2013.0,1,0,1
BEL,MLT,2010.0,1,0,1
SRB,SGP,2017.0,1,0,1
GRC,ARG,2017.0,1,0,1
NGA,CAF,2019.0,1,0,1
FRA,RWA,2009.0,1,0,1
VGB,GBR,2010.0,1,0,1
NGA,PRT,2015.0,1,0,1
MWI,BWA,2002.0,1,0,1
BWA,MWI,2012.0,1,0,1
MKD,SVK,2021.0,1,0,1
MDV,NPL,2019.0,1,0,1
KAZ,AUT,2015.0,2,0,2
FJI,ITA,2009.0,1,0,1
DNK,ECU,2017.0,2,0,2
GBR,KIR,2012.0,1,0,1
UGA,AGO,2014.0,1,0,1
CIV,NGA,2017.0,1,0,1
SVN,FIN,2013.0,1,0,1
GUF,MTQ,2012.0,1,0,1
NAM,UGA,2022.0,1,0,1
UGA,OMN,2014.0,1,0,1
ISR,QAT,2019.0,1,0,1
AUS,PER,2008.0,1,0,1
SVK,EST,2023.0,1,0,1
CHN,NPL,2007.0,1,0,1
TZA,ZWE,2011.0,1,0,1
PSE,AUS,2019.0,2,0,2
PAN,SGP,2014.0,1,0,1
BLZ,FRA,2008.0,1,0,1
IDN,ZMB,2021.0,1,0,1
MDG,NER,2003.0,1,0,1
NER,NCL,2009.0,1,0,1
JPN,KWT,2020.0,1,0,1
DNK,LVA,2000.0,1,0,1
DMA,,2007.0,2,0,2
PAN,NZL,2016.0,1,0,1
CAF,KHM,2012.0,1,0,1
BEL,UZB,2021.0,1,0,1
SWE,GEO,2017.0,1,0,1
AUS,BRN,2012.0,1,0,1
DZA,TUR,2002.0,1,0,1
ISL,VNM,2020.0,1,0,1
TGO,CHN,2023.0,1,0,1
CHN,SVN,1999.0,1,0,1
SAU,ISR,2015.0,2,0,2
ARE,BEL,2024.0,1,0,1
CZE,ARM,2017.0,2,0,2
KWT,IRN,2014.0,1,0,1
NLD,CUB,1999.0,1,0,1
PRY,BEL,2022.0,1,0,1
MYS,ARE,2001.0,1,0,1
KOR,GAB,2020.0,1,0,1
MOZ,UGA,2021.0,1,0,1
CHE,EST,2004.0,1,0,1
IRQ,ARE,2001.0,1,0,1
PRT,DOM,2019.0,1,0,1
MAC,THA,2007.0,1,0,1
CAN,FJI,2015.0,1,0,1
CAF,CIV,2022.0,1,0,1
JOR,CYP,2018.0,1,0,1
CAN,NCL,2019.0,1,0,1
SUR,USA,2002.0,1,0,1
JAM,IRL,2019.0,1,0,1
GBR,FRO,2020.0,2,0,2
ISL,CHN,1997.0,1,0,1
FJI,MHL,2004.0,1,0,1
MHL,FJI,2006.0,1,0,1
SWE,TWN,1998.0,3,0,3
ARM,ESP,2015.0,1,0,1
BEL,PHL,2004.0,1,0,1
PHL,ARG,2006.0,1,0,1
FLK,,2001.0,1,0,1
KEN,FIN,2019.0,1,0,1
BTN,NLD,2015.0,1,0,1
ARG,ARM,2009.0,1,0,1
MNG,RUS,2005.0,1,0,1
BHS,ARE,2015.0,1,0,1
GBR,ERI,2017.0,1,0,1
CRI,CUB,2019.0,2,0,2
CMR,CAF,2015.0,1,0,1
TUN,EST,2022.0,2,0,2
IND,ETH,2002.0,2,0,2
CHN,TTO,2021.0,1,0,1
TCD,BDI,2019.0,1,0,1
GRL,SWE,1999.0,1,0,1
HUN,PHL,2020.0,1,0,1
NLD,HRV,2008.0,1,0,1
PAK,JOR,2014.0,1,0,1
SWE,CMR,2023.0,1,0,1
CRI,PER,2021.0,2,0,2
MYS,MDV,2021.0,1,0,1
NLD,MAR,2021.0,1,0,1
USA,TCD,2020.0,1,0,1
MOZ,PSE,2017.0,1,0,1
JPN,PRI,2000.0,2,0,2
LVA,AUT,2023.0,1,0,1
,CMR,2021.0,2,0,2
,VUT,2020.0,4,0,4
VEN,ARG,2023.0,1,0,1
JOR,SDN,2023.0,1,0,1
CHL,JAM,2021.0,1,0,1
PRI,IND,2018.0,1,0,1
MNG,,2000.0,1,0,1
PHL,IDN,2012.0,1,0,1
BRN,PNG,2011.0,1,0,1
RWA,GHA,2004.0,1,0,1
AUT,LTU,1999.0,1,0,1
JOR,SWE,2017.0,1,0,1
GIN,GNB,2015.0,1,0,1
NGA,GNQ,2016.0,1,0,1
ESP,GEO,2010.0,3,0,3
JPN,MMR,2008.0,1,0,1
CAN,BFA,2006.0,2,0,2
ZAF,PER,2008.0,1,0,1
CHL,SRB,2006.0,1,0,1
UKR,HKG,2012.0,1,0,1
HKG,UKR,2014.0,1,0,1
EST,SGP,2016.0,1,0,1
ARE,ROU,2021.0,1,0,1
BLR,NLD,2003.0,1,0,1
KWT,PSE,2013.0,1,0,1
CHN,PSE,2012.0,1,0,1
SDN,KWT,2006.0,1,0,1
GHA,ETH,2007.0,1,0,1
OMN,SGP,2000.0,1,0,1
SGP,ARE,2002.0,1,0,1
HRV,MKD,2014.0,1,0,1
BRB,TTO,2007.0,1,0,1
SWE,CIV,2019.0,1,0,1
AUT,MNG,2000.0,1,0,1
USA,MRT,2007.0,1,0,1
ZAF,NGA,1997.0,1,0,1
NER,BEN,2014.0,1,0,1
MYS,MAR,2012.0,1,0,1
NGA,GHA,2002.0,3,0,3
LTU,CHE,2003.0,1,0,1
PRI,FRA,1999.0,1,0,1
FLK,,2015.0,1,0,1
PSE,PRT,2003.0,1,0,1
IRN,BRA,1999.0,2,0,2
FIN,NZL,1999.0,2,0,2
GRC,MDG,2005.0,1,0,1
DJI,LUX,2010.0,1,0,1
BFA,ITA,1999.0,1,0,1
KHM,ZWE,2007.0,1,0,1
ZWE,SWZ,2006.0,2,0,2
JPN,MDG,2012.0,1,0,1
IRQ,TUN,2011.0,1,0,1
NZL,BRN,2014.0,1,0,1
NZL,SVN,2020.0,1,0,1
TWN,BGD,2007.0,1,0,1
NGA,SWZ,2016.0,1,0,1
LKA,NZL,2006.0,1,0,1
FJI,NZL,2010.0,2,0,2
JPN,MDV,1998.0,1,0,1
AUS,MMR,2006.0,2,0,2
MMR,AUS,2008.0,1,0,1
BRA,PSE,2020.0,1,0,1
GEO,IRL,1998.0,1,0,1
BGD,MMR,2014.0,1,0,1
ITA,UGA,2018.0,1,0,1
MMR,THA,2007.0,1,0,1
SEN,NLD,2003.0,1,0,1
NGA,ZMB,2002.0,1,0,1
KAZ,CHE,2015.0,1,0,1
NAM,BWA,2016.0,1,0,1
NLD,GRD,2014.0,1,0,1
CUB,SWE,2021.0,1,0,1
OMN,NZL,2020.0,2,0,2
THA,TTO,2006.0,1,0,1
SRB,QAT,2013.0,2,0,2
SEN,ETH,2021.0,1,0,1
ESP,AZE,2012.0,1,0,1
SVK,KEN,2016.0,1,0,1
CZE,LUX,2021.0,2,0,2
KEN,NOR,2009.0,1,0,1
CHN,LSO,2009.0,1,0,1
SDN,SVK,2008.0,1,0,1
FRA,PRY,2008.0,1,0,1
COL,IND,2006.0,1,0,1
JOR,CZE,2009.0,1,0,1
MYS,SVN,2008.0,1,0,1
TKM,,2011.0,1,0,1
BLR,CZE,2006.0,1,0,1
CYP,ROU,2016.0,1,0,1
ESP,PSE,2008.0,2,0,2
ESP,GHA,2019.0,2,0,2
ETH,LBR,2023.0,1,0,1
PRT,PSE,2018.0,1,0,1
PAK,YEM,2016.0,1,0,1
ITA,DOM,2021.0,1,0,1
UKR,NOR,2007.0,2,0,2
VUT,LAO,2021.0,1,0,1
NPL,ISR,2016.0,1,0,1
NOR,SOM,2017.0,1,0,1
NOR,YEM,2019.0,1,0,1
IND,TUN,2016.0,1,0,1
MYS,TWN,2000.0,1,0,1
DEU,GRD,2019.0,1,0,1
JOR,SWE,2022.0,2,0,2
USA,MUS,2023.0,1,0,1
COD,SEN,2022.0,1,0,1
IDN,CHN,2001.0,1,0,1
JOR,PAK,2021.0,1,0,1
HRV,TUR,2023.0,1,0,1
AZE,AUT,2021.0,1,0,1
LTU,BGD,2022.0,1,0,1
CHE,MMR,2009.0,1,0,1
IDN,ITA,2022.0,1,0,1
ETH,AFG,2023.0,1,0,1
ARE,ROU,2019.0,1,0,1
WSM,IND,2023.0,1,0,1
LBY,SDN,2023.0,1,0,1
ZAF,TUN,2024.0,1,0,1
BEL,MDG,2007.0,1,0,1
GNB,ISL,2001.0,1,0,1
CRI,BRA,1997.0,1,0,1
CHE,MAR,2007.0,1,0,1
BEL,SRB,1999.0,3,0,3
IRQ,SYR,2005.0,1,0,1
MHL,USA,2002.0,2,0,2
ZWE,IND,2011.0,2,0,2
UGA,BFA,2000.0,1,0,1
ESP,GTM,2002.0,1,0,1
GTM,ESP,2003.0,1,0,1
SVN,JPN,2014.0,1,0,1
ITA,SMR,1998.0,1,0,1
URY,NZL,2001.0,1,0,1
CHE,TGO,2011.0,1,0,1
IND,UGA,2000.0,1,0,1
NGA,NOR,2003.0,1,0,1
BGD,OMN,1999.0,1,0,1
NLD,SWZ,2016.0,1,0,1
FIN,BGR,1997.0,1,0,1
TTO,COL,2003.0,1,0,1
COL,JAM,2005.0,1,0,1
CHE,CYP,2004.0,1,0,1
CAF,BDI,2002.0,1,0,1
TWN,BLR,2019.0,1,0,1
ERI,KEN,2005.0,1,0,1
NOR,MUS,2007.0,1,0,1
ZMB,DEU,1998.0,1,0,1
RUS,BEN,2012.0,1,0,1
CHE,LIE,1999.0,2,0,2
RUS,GRL,2013.0,1,0,1
CAN,ALB,2001.0,1,0,1
BHR,SDN,2005.0,1,0,1
SGP,UKR,2005.0,1,0,1
GBR,MLI,2011.0,1,0,1
TWN,SDN,2018.0,1,0,1
,LCA,2006.0,1,0,1
EST,AUT,2010.0,2,0,2
CHE,IRQ,2008.0,1,0,1
NGA,SAU,2010.0,1,0,1
TCD,ESP,2013.0,1,0,1
MEX,HUN,2012.0,1,0,1
ETH,ISR,2011.0,1,0,1
ESP,MYS,2010.0,1,0,1
PER,CUB,2003.0,1,0,1
CUB,GTM,2005.0,1,0,1
SOM,,2017.0,1,0,1
IND,MAR,2014.0,1,0,1
CAN,GIB,2014.0,1,0,1
ITA,ISL,2007.0,1,0,1
VEN,IRL,2022.0,1,0,1
CAN,COD,2016.0,1,0,1
USA,MTQ,2014.0,1,0,1
BFA,AUT,2007.0,1,0,1
NLD,ISL,2000.0,1,0,1
MEX,MCO,2009.0,1,0,1
KHM,DEU,2012.0,1,0,1
AUT,PER,2018.0,1,0,1
NCL,GLP,2019.0,1,0,1
EGY,HKG,2011.0,1,0,1
PRK,,2013.0,3,0,3
,WSM,2010.0,2,0,2
KEN,CMR,2015.0,2,0,2
UKR,ZAF,2018.0,1,0,1
MYS,AZE,2013.0,1,0,1
ECU,NZL,2013.0,1,0,1
NZL,ETH,2017.0,1,0,1
THA,UGA,2014.0,1,0,1
SLB,CHE,2015.0,1,0,1
PER,BHR,2017.0,1,0,1
ARM,CHL,2013.0,1,0,1
TCD,SLE,2014.0,1,0,1
COD,FRA,2016.0,1,0,1
NLD,SYC,2013.0,2,0,2
NCL,BGD,2017.0,1,0,1
MMR,NZL,2017.0,1,0,1
AUS,EST,2023.0,2,0,2
GHA,HUN,2017.0,1,0,1
BRA,CIV,2020.0,2,0,2
ARE,GRC,2006.0,1,0,1
JPN,HND,2008.0,1,0,1
JPN,TUN,2003.0,1,0,1
TUN,TWN,2018.0,1,0,1
GLP,HTI,2015.0,1,0,1
ETH,IRL,2002.0,1,0,1
BLZ,,2016.0,1,0,1
BRA,SGP,2003.0,1,0,1
MAR,ARE,2010.0,1,0,1
NLD,GEO,2014.0,1,0,1
BEL,IDN,2001.0,2,0,2
SGP,HRV,2019.0,1,0,1
ETH,FIN,2005.0,1,0,1
CUB,CAN,2000.0,2,0,2
BGR,ZAF,2004.0,1,0,1
NLD,ZMB,2003.0,1,0,1
FRA,DJI,2003.0,1,0,1
BRA,MCO,2001.0,1,0,1
TWN,QAT,2020.0,1,0,1
ESP,AND,1999.0,1,0,1
GIN,ITA,2001.0,1,0,1
PHL,MEX,2021.0,1,0,1
USA,WSM,2000.0,1,0,1
ZAF,BRA,2008.0,1,0,1
NZL,BRA,1998.0,1,0,1
BLR,SWE,2004.0,1,0,1
BRA,BFA,2009.0,1,0,1
LCA,CAN,2016.0,1,0,1
GBR,SEN,2005.0,1,0,1
PER,SAU,2000.0,1,0,1
ZWE,LSO,2000.0,1,0,1
SRB,EGY,2007.0,1,0,1
LAO,TUR,2011.0,1,0,1
LIE,LUX,2020.0,1,0,1
MUS,KWT,2004.0,1,0,1
JPN,COG,2007.0,1,0,1
BOL,USA,1997.0,1,0,1
NLD,ISL,2010.0,2,0,2
ISL,NLD,2011.0,2,0,2
GBR,SSD,2015.0,1,0,1
SSD,CHE,2016.0,1,0,1
ZAF,BGR,2012.0,1,0,1
LKA,MLT,2017.0,1,0,1
YEM,MAR,2015.0,1,0,1
ISR,KGZ,2014.0,2,0,2
KEN,CMR,2014.0,1,0,1
NGA,SYC,2007.0,1,0,1
IRQ,KOR,2015.0,1,0,1
HKG,SDN,2013.0,1,0,1
TWN,NOR,2013.0,1,0,1
GHA,IND,2003.0,1,0,1
COG,RWA,2020.0,1,0,1
KEN,HUN,2021.0,2,0,2
KHM,ZAF,2014.0,1,0,1
CHL,HND,2014.0,1,0,1
ERI,ETH,2012.0,1,0,1
NOR,PHL,2018.0,1,0,1
SLE,MLI,2017.0,1,0,1
BFA,TCD,2017.0,1,0,1
MWI,VNM,2022.0,1,0,1
SYR,KOR,2016.0,1,0,1
CYP,NGA,2016.0,1,0,1
IRN,KOR,2024.0,1,0,1
UGA,LBR,2019.0,1,0,1
LBR,GBR,2019.0,2,0,2
PAK,ISL,2022.0,1,0,1
BRN,QAT,2023.0,1,0,1
ISR,NPL,2020.0,1,0,1
USA,ABW,2019.0,1,0,1
MDV,IND,2023.0,2,0,2
ETH,SLE,2023.0,1,0,1
ALB,HRV,2023.0,1,0,1
ZAF,CCK,2023.0,1,0,1
GEO,ITA,2023.0,1,0,1
NCL,GBR,2009.0,1,0,1
RUS,CHL,2005.0,1,0,1
SHN,DEU,2019.0,1,0,1
NLD,SEN,2017.0,1,0,1
BEL,SYR,2002.0,1,0,1
GAB,GHA,2014.0,1,0,1
COL,RUS,2018.0,1,0,1
ITA,GUF,2017.0,1,0,1
NZL,PRT,2016.0,1,0,1
FLK,USA,2010.0,1,0,1
KHM,SWE,2015.0,1,0,1
CHN,GNQ,2016.0,1,0,1
AUS,MCO,2021.0,1,0,1
FRA,COD,2015.0,1,0,1
AUT,HKG,2015.0,1,0,1
PER,MOZ,2014.0,1,0,1
AUT,MWI,2022.0,1,0,1
CMR,MDG,2019.0,1,0,1
COG,TZA,2018.0,1,0,1
DJI,GBR,2022.0,1,0,1
GRC,AZE,2013.0,1,0,1
QAT,NPL,2019.0,1,0,1
ARE,QAT,1999.0,1,0,1
GUY,FRA,2010.0,1,0,1
NGA,CYP,2005.0,1,0,1
PRT,THA,2002.0,1,0,1
MLI,GAB,2006.0,2,0,2
ARG,ZAF,2011.0,2,0,2
GAB,ETH,2021.0,2,0,2
POL,DZA,1999.0,1,0,1
,GNQ,1999.0,1,0,1
ARG,SRB,2012.0,2,0,2
CUB,KHM,2006.0,1,0,1
GBR,GTM,2015.0,1,0,1
EGY,SRB,2004.0,1,0,1
GRL,,2003.0,1,0,1
FIN,PER,2003.0,1,0,1
NOR,QAT,2021.0,1,0,1
UGA,DNK,2001.0,1,0,1
THA,BGR,1999.0,1,0,1
AUT,BGD,2015.0,1,0,1
AUT,CMR,2013.0,1,0,1
PRT,TLS,2017.0,1,0,1
IRQ,IRL,2012.0,1,0,1
YEM,PRT,2014.0,1,0,1
KOR,IRQ,2014.0,1,0,1
KAZ,ROU,2015.0,1,0,1
CAN,MOZ,2018.0,1,0,1
MOZ,CAN,2021.0,1,0,1
NZL,LBR,2017.0,1,0,1
DEU,PRY,2013.0,1,0,1
GHA,BEN,2015.0,1,0,1
ZWE,MOZ,2014.0,1,0,1
FIN,LUX,2019.0,2,0,2
BRA,LAO,2015.0,1,0,1
SDN,UGA,2021.0,1,0,1
CHN,TKM,2022.0,1,0,1
ITA,TGO,2022.0,1,0,1
CHE,JOR,2009.0,1,0,1
BLR,DNK,2008.0,1,0,1
CHN,CAF,2020.0,1,0,1
GBR,GUY,2019.0,1,0,1
MEX,DOM,2019.0,2,0,2
UGA,IRN,2019.0,1,0,1
CMR,GHA,2022.0,1,0,1
GHA,CMR,2023.0,1,0,1
AUS,BRN,2022.0,1,0,1
GUY,FRA,2023.0,1,0,1
EGY,PNG,2022.0,1,0,1
PNG,NPL,2019.0,1,0,1
UKR,IDN,2020.0,1,0,1
AUT,BIH,2023.0,1,0,1
ITA,LBY,2022.0,1,0,1
,GNQ,2020.0,1,0,1
USA,BMU,2023.0,1,0,1
ETH,OMN,2023.0,1,0,1
PHL,SAU,2001.0,1,0,1
ARG,ZAF,2009.0,1,0,1
MMR,SAU,2023.0,1,0,1
KHM,GBR,2001.0,1,0,1
GBR,KHM,2002.0,1,0,1
FIN,SRB,2011.0,1,0,1
UGA,CAN,2006.0,1,0,1
CAN,GAB,2006.0,1,0,1
PRI,ARG,2004.0,1,0,1
CUB,PAN,2020.0,2,0,2
KEN,PRI,1998.0,1,0,1
DNK,CHL,2002.0,2,0,2
NPL,AUS,2003.0,1,0,1
BOL,PRT,2018.0,1,0,1
THA,TUN,2008.0,1,0,1
BEL,NAM,2016.0,1,0,1
USA,NAM,1997.0,1,0,1
SVK,KOR,2011.0,1,0,1
BRN,CHN,1999.0,1,0,1
,DMA,1994.0,1,0,1
USA,AZE,2005.0,1,0,1
LBN,KWT,2015.0,2,0,2
GUY,GUF,2008.0,1,0,1
IRQ,UZB,2023.0,1,0,1
ISL,ESP,2019.0,1,0,1
UKR,FIN,2012.0,2,0,2
NAM,IRL,2022.0,1,0,1
IRQ,IDN,2023.0,1,0,1
BHR,BGD,2023.0,2,0,2
LKA,USA,2024.0,1,0,1
SGP,PRI,2012.0,1,0,1
AUS,GUF,2020.0,1,0,1
SAU,POL,1999.0,1,0,1
NLD,BIH,2007.0,2,0,2
NER,SDN,2021.0,1,0,1
BRA,EGY,2007.0,1,0,1
MKD,SWE,2001.0,1,0,1
NCL,GBR,2003.0,1,0,1
BGD,KWT,2005.0,1,0,1
KWT,BGD,2012.0,1,0,1
BWA,ZAF,1998.0,1,0,1
USA,LIE,2011.0,2,0,2
AUS,BGR,2003.0,1,0,1
FRA,PER,1999.0,1,0,1
HKG,HRV,2017.0,1,0,1
ETH,LSO,2001.0,1,0,1
RWA,CAF,2021.0,1,0,1
MDG,BEN,2019.0,1,0,1
SLE,GMB,2007.0,1,0,1
BLR,IRL,2012.0,1,0,1
DNK,KOR,1999.0,1,0,1
POL,MYS,2015.0,1,0,1
GHA,ITA,2012.0,1,0,1
CRI,NLD,2015.0,2,0,2
BEL,CRI,2014.0,1,0,1
CUB,TTO,2021.0,1,0,1
GTM,PER,2019.0,1,0,1
LUX,RUS,2019.0,1,0,1
ZAF,THA,2016.0,1,0,1
HRV,UKR,2020.0,1,0,1
JPN,SVN,2006.0,1,0,1
ZAF,HUN,2000.0,1,0,1
TUN,OMN,2010.0,2,0,2
CAN,GUF,2014.0,1,0,1
JOR,IRL,2000.0,1,0,1
CHN,MWI,2017.0,1,0,1
MAC,ESP,2019.0,1,0,1
UGA,GEO,2018.0,1,0,1
ARE,ISR,2016.0,1,0,1
ISR,ARE,2020.0,1,0,1
SYR,BHR,2016.0,1,0,1
PAN,CRI,2013.0,1,0,1
EGY,KOR,1999.0,1,0,1
SYR,LBN,1999.0,1,0,1
,STP,2014.0,3,0,3
ESP,DMA,2019.0,1,0,1
HKG,TZA,2018.0,1,0,1
PNG,CAN,2016.0,1,0,1
COD,KOR,2017.0,1,0,1
HKG,FJI,2018.0,1,0,1
MUS,ITA,2022.0,1,0,1
TUR,ISL,2022.0,1,0,1
AFG,UZB,2023.0,1,0,1
DEU,KHM,2019.0,2,0,2
MEX,LTU,2022.0,1,0,1
UKR,TUR,2009.0,1,0,1
CIV,CAN,2002.0,1,0,1
CHE,CIV,2002.0,1,0,1
IND,PRT,1998.0,1,0,1
BLR,CZE,2001.0,1,0,1
BGR,UKR,2009.0,1,0,1
MUS,ZAF,2015.0,1,0,1
CHE,QAT,2014.0,2,0,2
EGY,YEM,1998.0,1,0,1
BLR,CAN,2015.0,1,0,1
PAN,CZE,2009.0,1,0,1
ISR,POL,2004.0,1,0,1
URY,NLD,2000.0,1,0,1
HKG,IRN,2007.0,1,0,1
VEN,CZE,2019.0,1,0,1
TUR,ESP,1999.0,1,0,1
SAU,GHA,2011.0,1,0,1
MKD,CAN,2000.0,1,0,1
IND,DZA,2000.0,1,0,1
POL,IRL,1999.0,1,0,1
EST,DNK,1997.0,1,0,1
AUT,PRT,1998.0,2,0,2
AUS,ZMB,1998.0,1,0,1
HKG,ARE,2005.0,1,0,1
SVK,HUN,1999.0,1,0,1
QAT,LAO,2014.0,1,0,1
MLT,ITA,1999.0,1,0,1
NLD,SYR,2004.0,1,0,1
AUS,EST,2008.0,1,0,1
BGR,CHN,2015.0,1,0,1
GEO,TUR,2000.0,1,0,1
JPN,SLB,2003.0,1,0,1
ESP,NZL,2006.0,1,0,1
GRC,EST,2011.0,1,0,1
PER,POL,2019.0,1,0,1
THA,MAR,2016.0,1,0,1
CHE,BIH,2015.0,1,0,1
PNG,TZA,2005.0,1,0,1
PHL,DNK,2007.0,1,0,1
MNE,RUS,2018.0,1,0,1
GBR,GEO,2009.0,1,0,1
SYR,AUS,2004.0,1,0,1
ARG,TUN,2012.0,1,0,1
TUR,CHN,2005.0,1,0,1
GBR,MLI,2003.0,1,0,1
MLI,COG,1998.0,1,0,1
DNK,MDA,2006.0,1,0,1
GHA,KEN,2006.0,1,0,1
CAN,COG,2011.0,1,0,1
FRA,HTI,2019.0,2,0,2
IRN,MEX,2011.0,1,0,1
AUS,NPL,2009.0,1,0,1
BEL,MLT,2008.0,1,0,1
BGR,KAZ,2023.0,1,0,1
NGA,BRA,2023.0,2,0,2
CAN,BLR,2019.0,1,0,1
EGY,CMR,2023.0,1,0,1
SAU,NPL,2016.0,1,0,1
JPN,LTU,2017.0,1,0,1
MOZ,USA,2000.0,2,0,2
PRT,HKG,2006.0,1,0,1
COL,HRV,2001.0,1,0,1
MYS,KWT,2001.0,1,0,1
HKG,UKR,2010.0,1,0,1
BFA,KEN,2002.0,1,0,1
KEN,BFA,2003.0,1,0,1
PAK,NZL,2004.0,1,0,1
NZL,PAK,2006.0,1,0,1
MCO,SWE,2014.0,1,0,1
SWE,MCO,2016.0,1,0,1
BIH,DEU,1998.0,1,0,1
JEY,GBR,2023.0,1,0,1
ITA,MOZ,2017.0,1,0,1
AUT,BIH,2006.0,1,0,1
,STP,2015.0,1,0,1
GBR,KHM,2005.0,1,0,1
ETH,EST,2017.0,1,0,1
JOR,PAK,2013.0,1,0,1
IRL,RWA,2019.0,1,0,1
ZAF,SYC,2012.0,2,0,2
BRB,EGY,2020.0,1,0,1
FRA,ZWE,2013.0,1,0,1
TGO,BEN,2011.0,1,0,1
GMB,ITA,1998.0,1,0,1
USA,TLS,2011.0,1,0,1
MWI,BEL,2012.0,2,0,2
EST,AUT,2015.0,1,0,1
SVN,RUS,2011.0,1,0,1
ARE,MEX,2019.0,1,0,1
FRA,COM,2015.0,1,0,1
CHN,NER,2012.0,1,0,1
GRC,BRN,2021.0,1,0,1
,GIB,2011.0,1,0,1
IND,MAC,2020.0,1,0,1
ZWE,SWZ,2015.0,1,0,1
AUS,AZE,2019.0,1,0,1
ZAF,GAB,2020.0,1,0,1
ZAF,URY,2008.0,1,0,1
BGR,MEX,2014.0,1,0,1
LVA,TUR,2016.0,1,0,1
CYP,LVA,2023.0,1,0,1
LSO,ZWE,2013.0,1,0,1
ZWE,LSO,2014.0,1,0,1
GHA,NZL,2016.0,1,0,1
CHE,KWT,2015.0,1,0,1
TUN,BRA,2021.0,1,0,1
KOR,KGZ,2020.0,1,0,1
THA,IDN,2000.0,1,0,1
MAC,AUT,2017.0,1,0,1
CAF,NPL,2019.0,1,0,1
ETH,UZB,2019.0,1,0,1
AIA,,2022.0,2,0,2
PRY,NZL,2021.0,1,0,1
ITA,PER,2014.0,1,0,1
NZL,SEN,2022.0,1,0,1
MAR,POL,2021.0,1,0,1
BIH,LUX,2022.0,1,0,1
GBR,MAC,2000.0,1,0,1
UKR,DNK,2022.0,2,0,2
CHN,BDI,2021.0,1,0,1
MEX,PRI,2021.0,2,0,2
BFA,CYP,2019.0,2,0,2
MUS,SAU,2020.0,1,0,1
CHE,MLI,2005.0,1,0,1
AUT,BEN,2011.0,1,0,1
ARM,BLR,2018.0,1,0,1
PER,PRY,2016.0,1,0,1
BGD,MMR,2023.0,1,0,1
GBR,BLZ,2013.0,1,0,1
FRA,NGA,2003.0,1,0,1
GEO,ISR,2001.0,1,0,1
NZL,MDV,2013.0,1,0,1
CAN,SWZ,2010.0,1,0,1
BGR,SWE,2008.0,1,0,1
JPN,SDN,2010.0,1,0,1
NLD,LSO,2005.0,1,0,1
MLT,ARE,2016.0,1,0,1
KOR,ROU,2004.0,1,0,1
MDA,CMR,2002.0,1,0,1
ZAF,PNG,2008.0,1,0,1
TUR,GEO,2010.0,1,0,1
QAT,IRN,2004.0,2,0,2
SVK,FIN,2014.0,1,0,1
IND,YEM,2004.0,1,0,1
,GRD,2003.0,1,0,1
SEN,TGO,2006.0,2,0,2
MLI,KEN,2007.0,1,0,1
LAO,LSO,2007.0,1,0,1
LSO,AUS,2009.0,1,0,1
LKA,NZL,2004.0,1,0,1
SEN,NLD,2021.0,1,0,1
KEN,ARE,2001.0,1,0,1
GBR,GAB,2002.0,1,0,1
ZAF,SVK,2018.0,1,0,1
AFG,MYS,2019.0,1,0,1
PHL,OMN,2021.0,1,0,1
NCL,VNM,2016.0,1,0,1
HUN,BLR,2000.0,1,0,1
BLR,HUN,2001.0,1,0,1
MOZ,SWZ,2017.0,1,0,1
AUT,UGA,2016.0,2,0,2
ETH,SLE,2015.0,1,0,1
BGR,AUT,2016.0,1,0,1
CMR,ETH,2020.0,1,0,1
NOR,ALB,2014.0,1,0,1
ESP,PSE,2023.0,1,0,1
MCO,ROU,2020.0,1,0,1
KWT,ALB,2020.0,1,0,1
PNG,ETH,2020.0,1,0,1
NAM,AUS,2022.0,1,0,1
PYF,USA,2011.0,1,0,1
SDN,EGY,1998.0,1,0,1
TWN,CAN,2024.0,1,0,1
HUN,HKG,2010.0,1,0,1
AUT,BRA,2001.0,1,0,1
FJI,USA,2009.0,1,0,1
BDI,USA,2007.0,1,0,1
UGA,VNM,2020.0,1,0,1
ZAF,TWN,1997.0,1,0,1
BHR,NLD,2008.0,1,0,1
CYP,FIN,2014.0,1,0,1
ARE,ETH,2015.0,1,0,1
GAB,CAF,2011.0,1,0,1
ITA,ARM,2011.0,1,0,1
AUT,CYP,2011.0,1,0,1
SVN,MNE,2016.0,1,0,1
,KNA,1996.0,1,0,1
ZAF,NER,2019.0,1,0,1
CRI,ARG,2011.0,1,0,1
CUB,HUN,2014.0,1,0,1
ATA,,2020.0,1,0,1
MYS,CZE,2014.0,2,0,2
BRA,GIB,2016.0,1,0,1
DZA,NOR,2016.0,1,0,1
AUT,PRI,2012.0,1,0,1
SRB,DNK,2012.0,2,0,2
MNE,COL,2010.0,1,0,1
COL,ARE,2016.0,1,0,1
CMR,NER,2015.0,1,0,1
ETH,LBN,2015.0,1,0,1
CAN,MAC,2016.0,1,0,1
,BMU,2011.0,1,0,1
GHA,SVN,2016.0,1,0,1
PRT,MYS,2010.0,1,0,1
ISR,COL,2015.0,1,0,1
NRU,,2018.0,1,0,1
CHE,IRQ,2023.0,1,0,1
FJI,HKG,2013.0,1,0,1
KAZ,ITA,2015.0,1,0,1
ERI,CHN,2016.0,1,0,1
CYP,SDN,2017.0,1,0,1
EST,LIE,2017.0,1,0,1
GBR,KGZ,2016.0,1,0,1
ESP,PRY,2005.0,1,0,1
UKR,KAZ,2013.0,1,0,1
BVT,,2023.0,1,0,1
BGD,WSM,2017.0,1,0,1
BRA,NPL,2019.0,1,0,1
BOL,NOR,2021.0,1,0,1
IRN,TUR,1998.0,1,0,1
AFG,CAN,2022.0,1,0,1
BEN,JPN,2011.0,1,0,1
CAN,GUY,2022.0,1,0,1
,GHA,2021.0,3,0,3
EGY,LBY,2024.0,1,0,1
CUB,MOZ,2022.0,1,0,1
,SRB,2021.0,7,0,7
,GUF,2021.0,1,0,1
BEL,EUE,2022.0,1,0,1
ZMB,NZL,2016.0,1,0,1
ZAF,FSM,2002.0,1,0,1
GHA,NGA,2000.0,1,0,1
MEX,SGP,2002.0,1,0,1
USA,KGZ,2002.0,1,0,1
GEO,JPN,2009.0,1,0,1
KOR,GEO,2014.0,1,0,1
CMR,DEU,1999.0,1,0,1
LBR,ZAF,2001.0,1,0,1
POL,VNM,2006.0,1,0,1
CHL,BOL,2006.0,1,0,1
SWE,LAO,2005.0,1,0,1
VNM,SGP,2007.0,1,0,1
BIH,VNM,2018.0,1,0,1
VNM,BIH,2021.0,1,0,1
GRC,SVK,2003.0,1,0,1
ARM,MEX,2000.0,1,0,1
ARE,SYR,2003.0,1,0,1
ECU,CAN,2000.0,1,0,1
UKR,FIN,2005.0,1,0,1
ITA,GHA,2005.0,1,0,1
GEO,ITA,2004.0,2,0,2
CMR,BRB,2014.0,1,0,1
BFA,JPN,2001.0,1,0,1
FIN,TZA,1999.0,1,0,1
ETH,ZMB,2022.0,1,0,1
OMN,AUT,2002.0,1,0,1
ERI,DEU,2002.0,1,0,1
LTU,CAN,1997.0,1,0,1
MKD,PRT,2002.0,1,0,1
USA,BFA,2003.0,1,0,1
BEL,LBN,2008.0,1,0,1
LTU,AUT,2006.0,1,0,1
ZAF,BRB,2008.0,1,0,1
PRY,URY,2016.0,1,0,1
ETH,NIC,2017.0,1,0,1
GBR,LBR,2018.0,1,0,1
NLD,MOZ,2009.0,1,0,1
IND,LUX,2012.0,1,0,1
GBR,MAC,2006.0,1,0,1
HKG,HRV,2018.0,1,0,1
BGR,NOR,2012.0,1,0,1
PRT,ZAF,2005.0,1,0,1
HRV,ARE,2014.0,1,0,1
DMA,KNA,2016.0,1,0,1
SYR,MAR,2002.0,1,0,1
PRT,AUT,2002.0,1,0,1
COL,MAR,2023.0,1,0,1
ARE,SWZ,2020.0,1,0,1
BHS,LSO,2006.0,1,0,1
DEU,MRT,1999.0,1,0,1
CHE,TJK,2019.0,1,0,1
JPN,PRY,2016.0,1,0,1
ISL,ROU,2017.0,1,0,1
ARM,SWE,2015.0,1,0,1
THA,ECU,2012.0,1,0,1
ROU,RUS,2013.0,1,0,1
GBR,PRI,2014.0,1,0,1
NAM,ITA,2011.0,1,0,1
DNK,LKA,2018.0,1,0,1
IRN,SRB,2017.0,1,0,1
CRI,SWE,2016.0,1,0,1
CYP,LBN,2010.0,1,0,1
ZMB,IND,1999.0,1,0,1
IRL,JAM,2012.0,1,0,1
COL,ZAF,2007.0,2,0,2
FLK,AUS,2007.0,1,0,1
MYS,KHM,2014.0,1,0,1
MYS,DZA,2014.0,1,0,1
KHM,CHN,2022.0,1,0,1
BEL,MAC,2007.0,1,0,1
BDI,NLD,2018.0,1,0,1
JPN,BFA,2018.0,1,0,1
JPN,CMR,2015.0,1,0,1
GTM,JPN,2019.0,1,0,1
ESP,SOM,2016.0,1,0,1
,SWZ,1998.0,1,0,1
SWZ,BWA,2003.0,1,0,1
ZWE,ARE,2021.0,1,0,1
DOM,MEX,2016.0,2,0,2
ARM,AUS,2011.0,1,0,1
NCL,LAO,2019.0,1,0,1
GMB,RWA,2007.0,1,0,1
TUR,MEX,2016.0,1,0,1
ARE,SDN,2003.0,1,0,1
ROU,JOR,2011.0,1,0,1
ZAF,SWZ,1997.0,1,0,1
GRC,SVN,2020.0,1,0,1
ALB,NLD,2021.0,1,0,1
ESP,GMB,2012.0,1,0,1
NGA,SDN,2023.0,1,0,1
PRI,GBR,2016.0,1,0,1
CHE,PAK,2013.0,1,0,1
IRN,ZWE,2020.0,1,0,1
TWN,IRQ,2021.0,1,0,1
ROU,KOR,2022.0,1,0,1
TCD,USA,2022.0,1,0,1
AFG,LKA,2021.0,1,0,1
ETH,GRC,2021.0,1,0,1
THA,TLS,2021.0,1,0,1
GAB,CHE,2013.0,1,0,1
SGP,ZAF,2000.0,1,0,1
,AND,2000.0,1,0,1
USA,REU,2015.0,1,0,1
OMN,MYS,2000.0,1,0,1
PAN,PRT,2003.0,1,0,1
TWN,CZE,2005.0,1,0,1
POL,COL,2011.0,2,0,2
BLR,ISR,2000.0,1,0,1
KAZ,BRA,1998.0,1,0,1
POL,QAT,2002.0,1,0,1
CHE,LUX,2003.0,1,0,1
NPL,MYS,2003.0,2,0,2
DEU,MNE,2006.0,1,0,1
ITA,LBN,1997.0,1,0,1
IRQ,ARE,2000.0,1,0,1
GRD,,2000.0,1,0,1
ESP,MCO,1998.0,1,0,1
CHE,LKA,2003.0,1,0,1
JPN,OMN,1998.0,1,0,1
ITA,FLK,2004.0,1,0,1
USA,REU,2004.0,1,0,1
ISR,JOR,2001.0,1,0,1
GRD,JAM,2014.0,1,0,1
LBY,BGD,2003.0,1,0,1
BGD,LBY,2006.0,1,0,1
PRI,DEU,2012.0,1,0,1
FIN,UGA,2013.0,1,0,1
PER,IRN,2022.0,1,0,1
BEL,RWA,2015.0,1,0,1
IRL,KEN,2020.0,2,0,2
,BTN,2005.0,1,0,1
IDN,FIN,2016.0,1,0,1
SGP,CAF,2019.0,1,0,1
POL,ROU,2003.0,2,0,2
CMR,FIN,2008.0,1,0,1
PAN,SLV,2014.0,1,0,1
TCA,,2018.0,2,0,2
MCO,CAN,2014.0,1,0,1
PRK,KOR,2012.0,1,0,1
GLP,THA,2008.0,1,0,1
PRT,AUT,1997.0,1,0,1
CHN,ISL,2005.0,1,0,1
CZE,GEO,2020.0,1,0,1
TZA,BGD,2023.0,1,0,1
ISL,IND,2001.0,1,0,1
MAC,,2005.0,1,0,1
,FLK,2001.0,1,0,1
ISL,AUT,2002.0,1,0,1
GTM,CRI,1997.0,1,0,1
GAB,TCD,2019.0,1,0,1
GAB,TCD,2021.0,1,0,1
SDN,RUS,2022.0,1,0,1
URY,SAU,2022.0,1,0,1
TWN,ROU,2019.0,1,0,1
MYS,TLS,2021.0,1,0,1
JPN,MOZ,2021.0,1,0,1
UGA,HUN,2022.0,1,0,1
MLI,CHN,2019.0,1,0,1
VNM,RUS,2024.0,1,0,1
CIV,GUF,2011.0,1,0,1
TWN,URY,2003.0,1,0,1
KNA,ZAF,2013.0,1,0,1
GRC,SVN,1999.0,1,0,1
ITA,CYM,2011.0,1,0,1
UKR,BRN,2000.0,1,0,1
IND,ERI,2002.0,1,0,1
IND,AUT,1998.0,1,0,1
MOZ,SWE,2003.0,1,0,1
PRT,HKG,2000.0,1,0,1
HUN,QAT,2016.0,1,0,1
BIH,ITA,2002.0,1,0,1
IDN,ZWE,2001.0,1,0,1
ZWE,IDN,2005.0,1,0,1
ISR,IRN,1998.0,1,0,1
CZE,VNM,1999.0,1,0,1
JOR,BHR,2002.0,2,0,2
TZA,ATG,2005.0,1,0,1
NLD,BDI,2012.0,1,0,1
LVA,UZB,2023.0,1,0,1
BRA,STP,2006.0,1,0,1
SAU,CYP,2002.0,1,0,1
RWA,USA,1999.0,1,0,1
TWN,IRQ,2011.0,1,0,1
HKG,ISR,1998.0,1,0,1
IDN,IND,1998.0,1,0,1
MEX,GHA,2013.0,1,0,1
LUX,NOR,2017.0,1,0,1
CAN,BDI,2016.0,1,0,1
TKM,,2013.0,1,0,1
KWT,PSE,2019.0,1,0,1
SDN,SLE,2022.0,1,0,1
SLE,SDN,2023.0,1,0,1
VAT,USA,2019.0,1,0,1
AUS,CYP,2005.0,1,0,1
THA,HUN,2023.0,1,0,1
RUS,BWA,2019.0,1,0,1
HUN,ECU,2018.0,1,0,1
VAT,,2021.0,1,0,1
PNG,PRY,2009.0,1,0,1
TUN,DZA,2024.0,1,0,1
JPN,LAO,2022.0,1,0,1
HUN,TZA,2023.0,1,0,1
MAC,ESP,2021.0,1,0,1
EST,GRC,2005.0,1,0,1
PNG,GBR,2009.0,1,0,1
RUS,PSE,2003.0,1,0,1
IRL,KAZ,2013.0,1,0,1
LKA,JOR,2017.0,1,0,1
PAK,ISR,2013.0,1,0,1
THA,ISR,2015.0,1,0,1
ASM,USA,1997.0,1,0,1
USA,ASM,2002.0,1,0,1
CRI,GTM,2000.0,1,0,1
GTM,CRI,2002.0,1,0,1
MUS,PRT,2016.0,1,0,1
MNP,USA,2001.0,1,0,1
TGO,NZL,2012.0,1,0,1
LKA,FRA,2020.0,1,0,1
ETH,KAZ,2009.0,1,0,1
FRA,DJI,2021.0,1,0,1
COL,HKG,2015.0,1,0,1
SWE,LBY,2022.0,1,0,1
TGO,MAR,2018.0,1,0,1
MAR,MTQ,2020.0,1,0,1
NOR,KAZ,2015.0,2,0,2
BLR,EST,2018.0,1,0,1
KOR,MYS,2001.0,1,0,1
POL,MAR,2019.0,1,0,1
NGA,SEN,2021.0,1,0,1
,SLB,1999.0,2,0,2
SWE,OMN,2018.0,1,0,1
GBR,MLT,2024.0,1,0,1
KNA,ISL,2018.0,1,0,1
CIV,FRA,2024.0,1,0,1
GHA,UKR,2022.0,1,0,1
IRN,BWA,2022.0,1,0,1
RUS,BGD,2013.0,1,0,1
CHE,CYP,2024.0,1,0,1
NGA,UZB,2021.0,1,0,1
ISR,BGD,2023.0,1,0,1
PAK,KWT,2020.0,1,0,1
ARG,FRA,2024.0,1,0,1
PRT,PAK,2012.0,1,0,1
BOL,PRT,2022.0,1,0,1
GMB,DEU,2004.0,1,0,1
KWT,IRN,2006.0,1,0,1
IRN,KWT,2007.0,1,0,1
BRA,MAC,1997.0,1,0,1
ZWE,FJI,2001.0,1,0,1
FJI,CAN,2009.0,1,0,1
DEU,GTM,2002.0,1,0,1
BRA,LTU,1998.0,1,0,1
SRB,MLT,2008.0,1,0,1
PRT,CZE,1997.0,1,0,1
LTU,JPN,2004.0,1,0,1
FRA,GHA,2005.0,1,0,1
TUR,NZL,2011.0,1,0,1
SEN,ESP,2003.0,1,0,1
IRN,DZA,2012.0,1,0,1
MWI,RUS,2014.0,1,0,1
MCO,ITA,2015.0,1,0,1
BEL,UZB,2013.0,1,0,1
KEN,PHL,2020.0,1,0,1
NLD,ARM,2006.0,1,0,1
BEL,LBN,2001.0,1,0,1
BLR,DNK,2001.0,1,0,1
VIR,,1999.0,1,0,1
GNB,GUF,2003.0,1,0,1
CYP,UKR,2019.0,1,0,1
SDN,LBY,2015.0,1,0,1
AUS,AZE,2011.0,2,0,2
CHN,RWA,2012.0,1,0,1
IRN,MAR,2018.0,1,0,1
NIC,PER,2015.0,1,0,1
NZL,OMN,2021.0,1,0,1
BWA,THA,2014.0,1,0,1
DZA,CIV,2013.0,1,0,1
PAK,MAR,2023.0,1,0,1
IND,SVK,2011.0,1,0,1
BRA,TZA,2021.0,1,0,1
ETH,ERI,2011.0,1,0,1
ESP,GAB,2016.0,1,0,1
UKR,ZAF,2012.0,1,0,1
VIR,,2020.0,1,0,1
FIN,RWA,2012.0,1,0,1
BEL,PYF,2016.0,1,0,1
HRV,NZL,2018.0,1,0,1
IDN,BOL,2015.0,1,0,1
AUT,CIV,2017.0,1,0,1
HRV,MNE,2013.0,1,0,1
MWI,JPN,2016.0,1,0,1
BWA,BRN,2008.0,1,0,1
DEU,BRN,2006.0,1,0,1
SWE,LBR,2014.0,1,0,1
NIC,CHL,2012.0,1,0,1
IDN,HKG,2015.0,1,0,1
THA,LAO,2009.0,1,0,1
SSD,CHN,2020.0,1,0,1
YEM,TUR,2015.0,1,0,1
SVK,MEX,2020.0,1,0,1
TTO,GUY,2017.0,1,0,1
ISL,LVA,2014.0,1,0,1
BHS,GBR,2014.0,1,0,1
KOR,POL,2002.0,1,0,1
NGA,OMN,1999.0,1,0,1
,NIU,2014.0,1,0,1
IND,KGZ,2021.0,1,0,1
EGY,CHN,2024.0,1,0,1
NPL,CAN,2005.0,2,0,2
TWN,MAC,2013.0,1,0,1
SGP,BLR,2012.0,1,0,1
FRA,GEO,2011.0,1,0,1
PRT,CZE,2002.0,1,0,1
HRV,TWN,2008.0,1,0,1
TGO,ITA,2013.0,1,0,1
SWE,URY,2018.0,1,0,1
NOR,ZWE,2016.0,1,0,1
COL,VNM,2013.0,1,0,1
UKR,KAZ,2003.0,1,0,1
FIN,OMN,2009.0,1,0,1
BLR,ESP,2011.0,1,0,1
SYC,GBR,2008.0,1,0,1
GBR,SYC,2014.0,1,0,1
KEN,SSD,2015.0,1,0,1
NZL,ECU,2005.0,1,0,1
HND,,2009.0,2,0,2
ARE,SOM,2009.0,1,0,1
NLD,DOM,2013.0,1,0,1
,DJI,2005.0,2,0,2
BEL,ARG,2006.0,1,0,1
BGR,TWN,2006.0,1,0,1
RWA,NAM,2013.0,1,0,1
CHE,NAM,2020.0,1,0,1
SWE,MAR,2010.0,1,0,1
UKR,GRC,2023.0,1,0,1
BWA,IND,2005.0,1,0,1
ETH,GUY,2018.0,1,0,1
JAM,CUB,2005.0,1,0,1
TUR,VEN,2011.0,1,0,1
MLI,BEL,2010.0,1,0,1
REU,CHE,2017.0,1,0,1
TZA,COD,2021.0,1,0,1
KOR,SLB,2020.0,1,0,1
BFA,SWE,2005.0,1,0,1
CIV,COD,1998.0,1,0,1
ISR,LKA,2009.0,1,0,1
LKA,ISR,2013.0,1,0,1
GEO,FRA,2009.0,1,0,1
DNK,BIH,2023.0,1,0,1
SGP,CHL,2022.0,1,0,1
AZE,TUN,2023.0,1,0,1
MEX,NGA,2010.0,1,0,1
ISR,SAU,2016.0,1,0,1
EST,ESP,2003.0,1,0,1
IRN,MYS,1998.0,1,0,1
GRL,ISL,2017.0,1,0,1
POL,TUR,2016.0,1,0,1
BLR,NGA,2019.0,1,0,1
CZE,MMR,2021.0,1,0,1
NOR,MOZ,2022.0,1,0,1
FIN,NAM,2019.0,1,0,1
IDN,EST,2018.0,1,0,1
ECU,CHE,2022.0,1,0,1
HUN,FJI,2010.0,1,0,1
TUR,GRC,2000.0,1,0,1
BEL,BFA,2004.0,1,0,1
TZA,ITA,2003.0,1,0,1
HKG,TTO,2001.0,1,0,1
BDI,FRA,2000.0,1,0,1
ARE,DZA,2005.0,1,0,1
AUS,LIE,2014.0,1,0,1
NZL,WSM,2011.0,1,0,1
SYR,NLD,2009.0,1,0,1
BEN,ZAF,1999.0,1,0,1
CHN,KHM,2015.0,1,0,1
ETH,MMR,2003.0,1,0,1
FIN,ARG,2003.0,1,0,1
TUN,EGY,2003.0,1,0,1
FIN,MYS,2003.0,1,0,1
NGA,COL,2007.0,1,0,1
JOR,BEL,2010.0,1,0,1
SVN,CZE,1997.0,1,0,1
FRA,KGZ,2003.0,1,0,1
IND,LUX,2005.0,1,0,1
MMR,AUS,2000.0,1,0,1
BRB,CAN,2007.0,1,0,1
NLD,CYP,2007.0,1,0,1
ROU,BGR,2000.0,1,0,1
,ATG,1995.0,1,0,1
BGR,NLD,1997.0,1,0,1
PRY,CAN,2002.0,1,0,1
MEX,KWT,2017.0,1,0,1
ATG,,2014.0,1,0,1
TZA,BDI,2012.0,1,0,1
KAZ,NOR,2023.0,1,0,1
LUX,ISR,2012.0,1,0,1
TTO,ATG,2012.0,1,0,1
TGO,CIV,2016.0,1,0,1
KOR,PRY,2017.0,1,0,1
BHR,CHN,2022.0,1,0,1
KHM,IND,2012.0,1,0,1
SEN,BEL,2007.0,1,0,1
VUT,,2013.0,1,0,1
ARE,ARM,2015.0,3,0,3
HKG,ROU,2019.0,1,0,1
SDN,ESP,2018.0,1,0,1
DZA,OMN,2001.0,1,0,1
TON,KHM,2008.0,1,0,1
CAN,GEO,1997.0,1,0,1
MAC,FRA,2015.0,1,0,1
POL,ITA,2024.0,1,0,1
RUS,CYP,2018.0,1,0,1
FSM,PNG,2013.0,1,0,1
PRT,PRY,2020.0,1,0,1
TUR,ESP,1998.0,1,0,1
BFA,GHA,2022.0,1,0,1
NER,MYS,2019.0,1,0,1
ZMB,AUS,2023.0,1,0,1
TWN,AUT,2017.0,1,0,1
NLD,MNG,2019.0,1,0,1
GBR,GRD,2023.0,1,0,1
EGY,SRB,2015.0,1,0,1
UKR,SRB,2023.0,1,0,1
CYP,CMR,2020.0,1,0,1
ITA,MDA,2007.0,1,0,1
PSE,PAN,2011.0,1,0,1
MCO,SRB,2008.0,1,0,1
NLD,BDI,2005.0,1,0,1
POL,MKD,2003.0,1,0,1
SRB,HKG,2000.0,1,0,1
HKG,SRB,2011.0,1,0,1
NOR,BGR,2003.0,1,0,1
BEN,GHA,2001.0,1,0,1
SLE,DEU,1998.0,1,0,1
REU,MEX,2014.0,1,0,1
GRC,MNG,2008.0,1,0,1
SRB,ROU,2003.0,1,0,1
SRB,ISR,2012.0,1,0,1
ITA,COL,1998.0,1,0,1
NAM,USA,2005.0,1,0,1
CHL,PAN,1999.0,1,0,1
LBY,BEL,2000.0,1,0,1
FRA,MUS,2015.0,1,0,1
CAN,TGO,2008.0,1,0,1
COG,GBR,2011.0,1,0,1
TUN,POL,2019.0,1,0,1
TUR,LBN,2014.0,1,0,1
FRA,GIN,2003.0,1,0,1
TUR,CZE,2003.0,1,0,1
ITA,CIV,2002.0,1,0,1
ARE,RUS,2015.0,1,0,1
MNG,IRL,2013.0,1,0,1
SLE,COG,2020.0,1,0,1
BGR,FIN,2015.0,1,0,1
CHN,KEN,2003.0,2,0,2
PRT,UKR,2005.0,1,0,1
UGA,TUN,2012.0,1,0,1
FRA,GMB,2005.0,1,0,1
QAT,IRN,2008.0,1,0,1
COG,MWI,2006.0,1,0,1
HUN,ARE,2001.0,1,0,1
BOL,ESP,1997.0,1,0,1
KOR,BLR,2008.0,1,0,1
MMR,NPL,2019.0,1,0,1
NGA,BWA,2017.0,1,0,1
SYR,SAU,2010.0,1,0,1
POL,LTU,2024.0,1,0,1
GBR,MUS,2002.0,1,0,1
SVK,IND,2010.0,1,0,1
NLD,COG,2013.0,1,0,1
ZAF,GRC,2008.0,1,0,1
NGA,BEN,2009.0,1,0,1
FIN,ISL,2016.0,1,0,1
YEM,JPN,2005.0,1,0,1
KEN,NZL,2009.0,1,0,1
BLZ,HND,2022.0,1,0,1
FJI,EST,2018.0,1,0,1
IND,CZE,2005.0,1,0,1
ITA,PRI,2008.0,1,0,1
LVA,CAN,2000.0,1,0,1
UKR,JOR,2005.0,1,0,1
DNK,HRV,2010.0,1,0,1
COG,CHE,2010.0,1,0,1
NLD,PRI,2010.0,1,0,1
GEO,QAT,2010.0,1,0,1
KIR,PNG,2015.0,1,0,1
FIN,SVN,2018.0,1,0,1
CMR,COG,2013.0,1,0,1
CMR,MLI,2018.0,1,0,1
BEL,TGO,2015.0,1,0,1
POL,COL,2009.0,1,0,1
LVA,KAZ,2020.0,1,0,1
BOL,GTM,2013.0,1,0,1
GRC,PSE,2019.0,1,0,1
FJI,CAN,2011.0,1,0,1
BIH,MKD,2009.0,1,0,1
PRI,ARG,2008.0,1,0,1
BWA,KEN,2016.0,1,0,1
CZE,SRB,2010.0,1,0,1
ISR,UZB,2010.0,1,0,1
KGZ,FIN,2010.0,1,0,1
SVN,SAU,2014.0,1,0,1
PRI,ARE,2013.0,1,0,1
TCD,BFA,2014.0,1,0,1
COL,NOR,2007.0,1,0,1
AZE,DZA,2016.0,1,0,1
DZA,AZE,2018.0,1,0,1
GMB,ESP,2023.0,1,0,1
SWE,BEN,2017.0,1,0,1
USA,SSD,2021.0,1,0,1
EGY,SSD,2015.0,1,0,1
CHE,GHA,2013.0,1,0,1
IND,PAN,2015.0,1,0,1
UKR,IRQ,2014.0,1,0,1
HUN,MEX,2014.0,1,0,1
MAR,TGO,2016.0,1,0,1
SGP,SVK,2021.0,1,0,1
GRC,PAK,2021.0,1,0,1
PAK,GRC,2022.0,1,0,1
VNM,FIN,2016.0,1,0,1
CHL,TUR,2014.0,1,0,1
CZE,GHA,2015.0,1,0,1
FRA,AGO,2019.0,1,0,1
MKD,GBR,2016.0,1,0,1
JPN,GEO,2002.0,1,1,0
NZL,HKG,1999.0,4,10,-6
ETH,KEN,2003.0,1,2,-1
TWN,BEL,2010.0,1,2,-1
HRV,CAN,2002.0,1,2,-1
UKR,AZE,2021.0,1,1,0
IRL,NAM,2021.0,1,1,0
PSE,MAR,2023.0,1,1,0
BGD,NPL,2023.0,1,1,0
TZA,RWA,2021.0,1,1,0
DNK,LKA,2005.0,1,2,-1
LTU,NOR,1999.0,2,1,1
SGP,ITA,2023.0,1,5,-4
GRC,ZAF,2021.0,1,1,0
SWE,KEN,2013.0,2,4,-2
BGR,POL,1998.0,1,1,0
URY,CHL,2003.0,1,1,0
TZA,CHE,1997.0,1,1,0
ARE,TUR,2004.0,1,1,0
PAK,BGD,2008.0,1,11,-10
IRN,GRC,2002.0,1,1,0
CUB,BRA,2005.0,3,1,2
CMR,BEN,2003.0,1,1,0
GAB,FRA,2004.0,2,7,-5
SWE,VEN,1998.0,1,3,-2
MAC,CHN,2004.0,1,8,-7
BGR,SWE,2006.0,1,2,-1
JPN,ZAF,1999.0,1,2,-1
UKR,AUT,1999.0,1,2,-1
GBR,VEN,2012.0,2,4,-2
KOR,MEX,2008.0,1,2,-1
BRA,SVN,2018.0,1,1,0
CYP,CHE,2011.0,2,3,-1
ITA,BOL,2017.0,1,3,-2
ITA,BGD,2013.0,3,4,-1
CAN,JAM,2013.0,2,2,0
NPL,BEL,2008.0,1,1,0
BEL,NPL,2012.0,1,3,-2
PER,CUB,2013.0,1,1,0
GAB,MAR,2023.0,1,1,0
ISR,GRC,2018.0,1,6,-5
MNG,DEU,2001.0,1,4,-3
CHN,KHM,2023.0,1,2,-1
AUT,CYP,2013.0,1,1,0
POL,EGY,2013.0,1,1,0
LUX,TUR,2021.0,1,2,-1
SVK,NOR,2019.0,2,1,1
HRV,NOR,2014.0,1,1,0
PAN,FRA,2023.0,1,1,0
NZL,GRC,2020.0,1,2,-1
CZE,KOR,2021.0,2,4,-2
URY,COL,2009.0,1,1,0
CHE,MAR,1999.0,1,2,-1
POL,SAU,2015.0,1,1,0
AUS,SLB,2019.0,1,3,-2
ZWE,MWI,2018.0,1,3,-2
PRT,IRN,2023.0,2,10,-8
QAT,IRL,2020.0,2,5,-3
KAZ,ESP,2016.0,1,1,0
CYP,IND,2022.0,1,4,-3
RWA,KOR,2021.0,1,2,-1
GBR,ALB,2022.0,1,1,0
GTM,CRI,2022.0,1,1,0
CAN,CIV,1998.0,1,1,0
MDA,GBR,2008.0,1,1,0
FRA,TGO,1999.0,1,7,-6
PRT,EGY,2011.0,1,3,-2
ISR,FIN,2017.0,1,4,-3
FIN,ISR,2018.0,1,2,-1
DNK,IRL,2002.0,2,3,-1
ZAF,POL,2016.0,1,5,-4
MEX,MAR,2002.0,1,1,0
PER,CHL,1997.0,1,1,0
CHL,POL,2008.0,1,4,-3
BGR,IRL,2012.0,1,1,0
SRB,BRA,2002.0,1,3,-2
RUS,CHL,2002.0,1,2,-1
COL,VEN,2003.0,3,1,2
DNK,ISL,1997.0,1,2,-1
JOR,IRQ,2004.0,1,2,-1
RUS,EST,2008.0,1,1,0
ETH,DEU,2000.0,1,2,-1
IRN,UKR,2015.0,1,1,0
MEX,SWE,2006.0,2,5,-3
GEO,GBR,2007.0,1,4,-3
BGD,TUR,2020.0,1,6,-5
ETH,AUS,2010.0,1,1,0
COL,CHN,2017.0,1,2,-1
CHN,EGY,2006.0,1,3,-2
ISR,CZE,2007.0,1,3,-2
NOR,NPL,2022.0,2,4,-2
ZAF,RWA,2013.0,1,3,-2
BEL,BOL,2011.0,1,2,-1
IND,LBN,2014.0,1,1,0
ROU,BGR,2014.0,1,3,-2
FIN,TUN,2010.0,1,1,0
IND,BWA,2018.0,1,1,0
ITA,JOR,2009.0,1,1,0
KOR,MYS,2023.0,1,4,-3
ECU,HUN,2023.0,1,1,0
QAT,IRN,2023.0,1,3,-2
HKG,IRL,1998.0,1,1,0
CIV,USA,2008.0,2,2,0
DEU,ECU,1998.0,1,2,-1
IRL,UKR,2015.0,1,1,0
OMN,MYS,2015.0,1,13,-12
PRT,COL,2009.0,1,2,-1
FJI,IND,2003.0,1,1,0
NOR,LTU,2007.0,1,1,0
CIV,JPN,2016.0,1,1,0
MWI,NLD,2003.0,1,1,0
BOL,CHL,2016.0,1,1,0
TZA,AUS,2018.0,1,3,-2
KHM,LAO,2010.0,1,1,0
ARE,BEL,2023.0,2,2,0
FRA,ZWE,2009.0,1,1,0
SWE,IDN,2010.0,1,3,-2
PER,JPN,2013.0,1,3,-2
USA,ALB,2011.0,2,1,1
TWN,CRI,2012.0,1,1,0
MOZ,NLD,2020.0,1,1,0
IND,LBN,2015.0,1,1,0
CAN,PRI,2011.0,1,3,-2
AUS,UGA,2023.0,1,3,-2
TUN,IRN,2015.0,1,1,0
DEU,URY,2002.0,1,1,0
CHN,JOR,2018.0,1,1,0
DEU,MNE,2014.0,1,1,0
FRA,LAO,2005.0,2,1,1
NZL,GHA,2019.0,2,2,0
IDN,SWE,2017.0,1,5,-4
THA,GHA,2018.0,1,2,-1
IRL,IDN,2020.0,1,2,-1
RUS,IRN,2014.0,1,4,-3
VNM,SWE,2019.0,1,7,-6
TCD,GBR,2017.0,1,3,-2
LBY,IRL,2014.0,1,1,0
GMB,KEN,2015.0,1,1,0
MEX,IDN,2017.0,1,1,0
BIH,SVK,2020.0,1,1,0
MAR,ROU,2023.0,1,1,0
GEO,GBR,2020.0,2,2,0
IRL,HUN,2017.0,2,6,-4
URY,CAN,2021.0,2,4,-2
SAU,IRQ,2021.0,2,1,1
PRI,CAN,2014.0,1,2,-1
NGA,BWA,2002.0,1,1,0
UGA,COG,2014.0,1,1,0
IRL,ISR,2007.0,1,3,-2
SVK,FIN,2006.0,1,1,0
ETH,DNK,2012.0,1,1,0
IND,BHR,2007.0,1,1,0
DEU,AZE,2016.0,2,2,0
PAN,POL,2002.0,2,1,1
FIN,PER,2011.0,1,1,0
TUN,MAR,1999.0,1,5,-4
UGA,TZA,2001.0,1,2,-1
KEN,TZA,2003.0,1,1,0
JPN,COL,2009.0,1,3,-2
TZA,CHE,2005.0,1,2,-1
DNK,ETH,2018.0,1,2,-1
MRT,SEN,2002.0,1,1,0
BWA,DEU,2017.0,1,1,0
NGA,CMR,2014.0,1,3,-2
KWT,RUS,2023.0,1,1,0
CHN,AFG,2022.0,1,1,0
SLV,ESP,2017.0,1,3,-2
GRC,PRT,2006.0,1,1,0
CHE,EST,2001.0,1,1,0
JPN,SYR,2010.0,1,1,0
KEN,FRA,2009.0,1,2,-1
ARG,CUB,1999.0,1,1,0
SRB,KWT,2012.0,1,1,0
NOR,BLR,2022.0,1,1,0
PAN,CRI,2021.0,1,2,-1
RUS,GRC,2009.0,1,3,-2
AUT,URY,2012.0,1,1,0
KWT,SGP,2016.0,1,1,0
NOR,TWN,2012.0,1,3,-2
GBR,CRI,2010.0,1,1,0
RUS,COL,1998.0,2,1,1
RUS,GRC,2011.0,2,2,0
HUN,CUB,2017.0,2,1,1
MEX,LUX,2017.0,1,1,0
NGA,ITA,2011.0,1,2,-1
PAK,BRN,2023.0,1,2,-1
CAN,UGA,2014.0,1,1,0
CZE,SRB,2014.0,1,3,-2
IDN,COG,2021.0,1,1,0
SGP,KHM,2017.0,1,2,-1
MYS,TZA,2014.0,1,1,0
DEU,GTM,2018.0,1,1,0
KGZ,CHE,2015.0,1,1,0
BTN,IND,2006.0,1,1,0
SWE,NPL,2014.0,3,1,2
ARE,CHE,2015.0,2,5,-3
EGY,SYR,2018.0,1,3,-2
PAK,POL,2014.0,1,1,0
POL,PAK,2018.0,1,1,0
ARM,ITA,2017.0,1,1,0
CZE,SVN,2016.0,1,2,-1
UKR,ROU,2019.0,1,1,0
QAT,TUN,2017.0,1,5,-4
CHN,BWA,2015.0,1,1,0
HUN,EGY,2019.0,1,5,-4
IND,ROU,2017.0,2,1,1
AUS,LAO,2019.0,1,3,-2
CHE,BGD,2018.0,1,4,-3
RUS,SGP,1998.0,1,1,0
OMN,BHR,2020.0,2,3,-1
MAR,MYS,2018.0,1,1,0
CHN,PYF,2017.0,1,1,0
TUR,HRV,2021.0,2,2,0
TLS,AUS,2021.0,1,1,0
COG,BEL,2023.0,1,1,0
BFA,CIV,2023.0,1,2,-1
DEU,IRN,1998.0,5,1,4
USA,BOL,2022.0,1,6,-5
LKA,ETH,2011.0,1,2,-1
TUR,NOR,2000.0,1,3,-2
FRA,MRT,2007.0,1,3,-2
OMN,NZL,1999.0,1,1,0
FIN,BEL,1997.0,1,2,-1
JPN,GEO,2005.0,1,1,0
KEN,RWA,2012.0,1,3,-2
NOR,BEL,2008.0,1,4,-3
LAO,KOR,2008.0,1,2,-1
CZE,POL,1998.0,1,10,-9
GBR,BEN,2010.0,1,2,-1
IRN,CHE,2001.0,1,1,0
BEL,SRB,1998.0,1,1,0
SAU,SWE,2000.0,2,2,0
EST,DNK,2022.0,2,1,1
UGA,CAN,2001.0,1,1,0
CZE,ISR,2006.0,1,1,0
CAN,LTU,2001.0,1,1,0
FIN,GRC,2006.0,1,3,-2
BOL,DEU,2002.0,1,1,0
NOR,AUT,2001.0,1,2,-1
BGD,NZL,2015.0,1,2,-1
UKR,OMN,2010.0,1,1,0
RUS,ROU,2008.0,2,1,1
AUT,BGR,2010.0,1,2,-1
ARE,OMN,2001.0,1,2,-1
GTM,CRI,2016.0,1,2,-1
IRL,TTO,2020.0,1,1,0
TZA,ZAF,2009.0,1,1,0
MEX,NZL,2011.0,1,3,-2
WSM,FJI,2021.0,1,1,0
AZE,USA,2007.0,1,1,0
CAN,KHM,2016.0,1,1,0
NGA,CHN,2013.0,1,3,-2
EGY,OMN,2007.0,1,3,-2
NAM,BWA,2017.0,1,1,0
AUS,PAK,2003.0,1,1,0
ESP,COL,2024.0,1,5,-4
CAN,SVN,2012.0,1,1,0
QAT,JPN,2017.0,1,2,-1
TZA,DNK,2009.0,1,2,-1
ZWE,MWI,2022.0,1,1,0
LAO,VNM,2022.0,1,2,-1
GRD,ESP,2014.0,1,2,-1
BEL,COL,2021.0,1,8,-7
NGA,COG,2013.0,1,2,-1
GUM,CAN,2006.0,1,1,0
NPL,NLD,2014.0,1,1,0
GEO,SWE,2004.0,1,2,-1
PRI,IND,2022.0,1,1,0
DEU,KAZ,2015.0,1,1,0
GBR,DZA,2010.0,1,2,-1
MMR,AUS,2015.0,1,1,0
CHE,SEN,2008.0,1,1,0
IRQ,RUS,2018.0,1,12,-11
SVN,EST,2020.0,1,1,0
SDN,NLD,2010.0,1,3,-2
ZWE,CHN,2021.0,1,5,-4
NPL,ITA,2022.0,1,3,-2
PRT,HRV,2021.0,1,1,0
CZE,GRC,2009.0,1,1,0
SOM,EGY,2022.0,1,1,0
RUS,BIH,2021.0,1,1,0
BRA,VEN,2023.0,1,1,0
PHL,KOR,2012.0,3,11,-8
KOR,NGA,2010.0,1,1,0
REU,USA,2018.0,1,1,0
POL,CHL,2021.0,1,3,-2
USA,AFG,2005.0,1,3,-2
NOR,ETH,2003.0,2,4,-2
FIN,ARE,2021.0,1,1,0
DEU,MDA,2013.0,2,4,-2
LBN,GBR,2001.0,1,6,-5
AUT,BRA,2000.0,1,3,-2
PRT,ARG,2002.0,1,3,-2
PRT,ARG,2005.0,1,1,0
NZL,RUS,2010.0,1,3,-2
CHE,ETH,2009.0,1,2,-1
QAT,GBR,2003.0,1,2,-1
ARG,AUS,1997.0,1,1,0
ROU,BGR,2004.0,1,3,-2
MAR,FRA,2024.0,1,1,0
SYC,FRA,2008.0,1,1,0
CHL,CRI,2007.0,1,2,-1
TUN,JPN,2016.0,1,4,-3
GMB,UGA,2015.0,1,1,0
HRV,IRL,2019.0,1,2,-1
COL,JPN,2016.0,1,2,-1
KAZ,TUR,2013.0,1,1,0
CUB,GBR,2008.0,1,2,-1
ITA,TZA,2010.0,1,2,-1
ZMB,JPN,2007.0,1,2,-1
GRC,PRT,2000.0,1,1,0
THA,NZL,2012.0,1,2,-1
IRQ,PAK,2019.0,1,4,-3
UGA,DEU,2007.0,1,2,-1
BWA,JPN,2019.0,1,1,0
CHL,CUB,2021.0,2,15,-13
USA,GMB,2021.0,3,3,0
TWN,NGA,2021.0,1,2,-1
GHA,PAK,2023.0,1,1,0
CMR,CIV,2022.0,1,1,0
HND,BRA,2023.0,1,1,0
USA,CPV,2016.0,1,1,0
BMU,USA,2022.0,1,1,0
TZA,KEN,2007.0,1,2,-1
KOR,NZL,2009.0,1,5,-4
BHR,EGY,2008.0,1,1,0
CHE,TZA,1997.0,1,1,0
OMN,JOR,2017.0,1,4,-3
MAC,USA,2009.0,1,5,-4
AUS,BRN,2002.0,1,3,-2
DEU,UGA,1997.0,1,2,-1
TWN,EGY,2008.0,1,1,0
SVK,DNK,1999.0,1,2,-1
FRA,KEN,2003.0,1,2,-1
CZE,FIN,2003.0,1,1,0
MTQ,GLP,2017.0,1,1,0
NOR,PAK,2010.0,1,3,-2
DEU,COL,1997.0,1,1,0
GHA,ETH,2020.0,1,2,-1
UZB,JPN,2008.0,1,2,-1
EST,AUT,2023.0,2,1,1
NIC,ESP,2015.0,1,1,0
USA,AGO,2013.0,1,1,0
IRL,NGA,2013.0,1,1,0
HRV,BGR,2020.0,1,1,0
CHE,CUB,2015.0,1,1,0
ARE,AUT,2012.0,1,1,0
CZE,KAZ,2015.0,1,2,-1
ITA,IDN,2012.0,1,1,0
SVK,NOR,2021.0,2,1,1
LBN,EGY,2009.0,1,2,-1
URY,COL,2021.0,1,3,-2
USA,SLV,2010.0,1,1,0
SAU,ETH,2019.0,1,2,-1
HUN,ZAF,2020.0,1,3,-2
PRT,HRV,2019.0,1,3,-2
POL,VNM,2014.0,1,1,0
HKG,ESP,2001.0,1,2,-1
OMN,DEU,2022.0,2,1,1
WSM,AUS,2021.0,1,1,0
HUN,KAZ,2023.0,1,1,0
KHM,GBR,2006.0,1,1,0
NOR,ZAF,2000.0,2,1,1
CHE,PHL,2005.0,1,5,-4
BHR,JOR,1997.0,1,1,0
AUS,EST,2010.0,1,2,-1
DNK,NZL,1998.0,2,3,-1
NZL,NCL,2004.0,1,1,0
NZL,EGY,2003.0,1,1,0
NOR,NZL,2015.0,1,4,-3
USA,LBY,2015.0,2,5,-3
ECU,BRA,2011.0,1,4,-3
BEL,GUF,2019.0,1,1,0
GUF,BEL,2020.0,1,1,0
ARE,CHE,2014.0,1,1,0
BIH,KWT,2022.0,1,1,0
SGP,BRN,2013.0,3,2,1
DEU,AZE,2017.0,2,2,0
ZWE,ZMB,2016.0,1,6,-5
CHE,MMR,2019.0,1,5,-4
KWT,QAT,2019.0,1,2,-1
IND,KWT,2013.0,1,2,-1
BRA,CRI,2017.0,1,5,-4
SRB,SGP,2022.0,1,1,0
COG,DEU,2018.0,1,2,-1
GBR,KAZ,2010.0,1,2,-1
DOM,ESP,2019.0,1,3,-2
IND,KAZ,2015.0,1,1,0
AFG,OMN,2022.0,1,1,0
ARE,IND,2024.0,1,1,0
BGD,PAK,1999.0,1,1,0
COD,KEN,1999.0,1,1,0
NLD,BEN,1999.0,1,1,0
AUS,TUR,2005.0,1,4,-3
NZL,COL,2010.0,1,2,-1
IND,UKR,2004.0,1,1,0
SWE,QAT,2018.0,1,1,0
USA,SYC,2020.0,1,3,-2
CHE,NGA,2003.0,1,1,0
BGR,PRT,2003.0,1,1,0
JPN,UZB,2001.0,1,1,0
AUT,KOR,2005.0,1,2,-1
GBR,SDN,2001.0,1,5,-4
ISR,AUT,1998.0,1,4,-3
CZE,EGY,2002.0,1,1,0
SEN,CHN,2014.0,1,2,-1
GBR,BDI,2011.0,1,1,0
MOZ,BEL,2015.0,1,1,0
ARE,IRN,2011.0,1,3,-2
BWA,IND,2022.0,2,3,-1
KOR,POL,2016.0,1,5,-4
ECU,CUB,2015.0,1,32,-31
FIN,MAR,2021.0,1,1,0
AUS,HRV,2015.0,1,1,0
GBR,CIV,1998.0,1,1,0
CRI,AUS,2019.0,1,2,-1
COL,PER,2013.0,1,3,-2
ZWE,BWA,2019.0,1,2,-1
TUN,DEU,2007.0,1,2,-1
ARE,NLD,2017.0,1,3,-2
EST,RUS,2020.0,1,6,-5
FJI,JPN,2015.0,1,2,-1
TUR,MEX,2012.0,1,2,-1
MNP,USA,2010.0,1,1,0
OMN,TUN,2021.0,1,4,-3
CHL,MYS,2019.0,1,2,-1
GHA,DNK,2013.0,1,1,0
AUS,MCO,2013.0,1,1,0
DZA,GBR,2015.0,1,7,-6
NLD,ERI,2006.0,1,2,-1
HUN,EGY,2011.0,1,2,-1
BEN,CHE,2013.0,1,1,0
AUS,LUX,2015.0,1,1,0
AUT,LUX,2015.0,1,3,-2
CMR,SEN,2002.0,1,1,0
LBN,MAR,2008.0,1,1,0
GHA,NGA,2014.0,1,5,-4
LTU,DNK,2005.0,1,2,-1
LBY,LBN,2013.0,1,3,-2
BFA,SWE,2017.0,1,2,-1
ISR,NGA,2020.0,1,1,0
POL,LVA,2021.0,1,1,0
MEX,LUX,2022.0,1,3,-2
NOR,COL,2014.0,1,1,0
PRT,VNM,2021.0,1,1,0
NCL,USA,2022.0,1,7,-6
EGY,CZE,2021.0,1,3,-2
LUX,IRN,2022.0,1,9,-8
CYP,BEL,2019.0,1,3,-2
DNK,BGD,2011.0,2,2,0
OMN,KWT,2017.0,1,1,0
KHM,IND,2017.0,1,1,0
USA,BFA,2009.0,1,3,-2
NLD,ARM,2001.0,1,1,0
IDN,NLD,1998.0,2,4,-2
ARG,FIN,2002.0,1,1,0
MDA,POL,2012.0,1,2,-1
MUS,GBR,1997.0,2,1,1
CAN,LBN,1999.0,2,4,-2
UZB,PAK,2015.0,1,1,0
SWE,ZAF,1997.0,1,1,0
POL,ISR,2007.0,1,1,0
SYR,GBR,1997.0,1,1,0
ZWE,BWA,2011.0,1,1,0
DEU,PAN,2008.0,1,1,0
BGR,NOR,2017.0,1,1,0
NOR,GRC,1999.0,1,1,0
ESP,PHL,2007.0,1,3,-2
CZE,NOR,2001.0,1,2,-1
COL,DNK,2005.0,1,1,0
ARE,FRA,2009.0,1,8,-7
CZE,LTU,2016.0,1,2,-1
FRA,RWA,2021.0,1,2,-1
CHE,KOR,1998.0,1,2,-1
MNE,BIH,2015.0,1,1,0
SWE,BGR,2015.0,1,2,-1
MEX,NZL,2021.0,1,2,-1
NOR,MEX,2019.0,1,3,-2
MAC,CAN,2008.0,1,1,0
MLI,CIV,2003.0,1,1,0
VEN,BEL,2016.0,1,3,-2
SVK,CAN,2016.0,1,1,0
EST,GRC,2016.0,1,2,-1
KOR,ISR,1999.0,1,1,0
SGP,BEL,2012.0,1,5,-4
POL,NZL,2023.0,1,1,0
TUR,PSE,2014.0,1,3,-2
ARE,SDN,2019.0,1,3,-2
TWN,CHL,2020.0,1,3,-2
CAN,GRL,2023.0,1,1,0
ESP,NGA,2020.0,1,2,-1
BRA,DOM,2020.0,1,1,0
NLD,BGR,2022.0,1,5,-4
SWE,SAU,2007.0,1,1,0
BEL,BEN,2002.0,1,1,0
CHL,COL,2002.0,1,1,0
GBR,BFA,2002.0,1,1,0
IDN,NZL,2008.0,1,2,-1
RUS,CHL,2012.0,1,2,-1
PER,DEU,2000.0,1,1,0
SAU,OMN,2008.0,1,1,0
COL,PRI,2018.0,1,1,0
TUR,JOR,2010.0,1,1,0
GRC,NZL,2014.0,1,1,0
THA,CHE,2004.0,1,6,-5
SRB,UKR,2005.0,1,1,0
PRT,BGR,2006.0,1,1,0
CHE,ZMB,2020.0,1,1,0
PRT,ISR,2013.0,1,2,-1
COG,BEL,2010.0,1,3,-2
PYF,CAN,2017.0,1,2,-1
SVK,RUS,2011.0,1,1,0
BWA,ZMB,2003.0,1,1,0
MEX,DNK,2007.0,1,3,-2
GBR,BLR,2008.0,1,2,-1
SEN,BFA,2002.0,1,3,-2
SVK,GRC,2023.0,1,1,0
ARE,NZL,2022.0,1,4,-3
SAU,SGP,2010.0,1,14,-13
PRT,COL,2011.0,1,2,-1
NLD,CMR,2020.0,1,1,0
ISR,TUR,2015.0,1,3,-2
COL,ISR,2009.0,1,3,-2
KOR,BRA,2011.0,1,4,-3
GBR,GAB,2017.0,1,2,-1
ESP,GNQ,2006.0,1,1,0
COL,TWN,2019.0,1,1,0
PHL,NPL,2017.0,1,1,0
KOR,KAZ,2022.0,1,6,-5
ISR,SRB,2019.0,1,1,0
FJI,FRA,2019.0,1,1,0
UKR,IND,2016.0,1,1,0
EST,IRN,2022.0,1,6,-5
NAM,NLD,2014.0,1,1,0
FRA,FJI,2020.0,1,1,0
CHE,AUT,2018.0,72,61,11
ESP,CHE,2019.0,120,92,28
DEU,BRA,2001.0,54,44,10
IND,DEU,2017.0,208,138,70
NZL,BEL,2002.0,3,1,2
ZAF,CHE,2010.0,13,8,5
LBY,IND,2012.0,12,2,10
MYS,DEU,2018.0,18,19,-1
IND,NGA,2013.0,10,14,-4
RUS,AUS,2023.0,12,2,10
FRA,ECU,2016.0,13,2,11
THA,KOR,2016.0,10,17,-7
HUN,KOR,2015.0,2,1,1
ETH,IRL,2022.0,1,2,-1
IRL,CHE,2001.0,7,5,2
IND,FIN,2001.0,3,3,0
LBN,GBR,2006.0,2,6,-4
ISR,KOR,2010.0,3,1,2
GRC,DNK,2003.0,1,2,-1
ITA,SVN,2004.0,3,3,0
NGA,GMB,2023.0,3,1,2
SWE,PER,2017.0,1,1,0
ZAF,ISR,1999.0,1,1,0
GBR,DZA,2008.0,2,3,-1
ETH,IND,2008.0,3,6,-3
CZE,SVN,2002.0,1,1,0
SDN,SAU,1997.0,2,1,1
PRT,ISR,2009.0,4,1,3
PHL,GBR,2007.0,2,3,-1
CHE,KAZ,2021.0,2,3,-1
GNB,SWE,2002.0,1,1,0
LAO,AUS,2013.0,3,2,1
HKG,NZL,2023.0,1,4,-3
CAN,LTU,2023.0,1,4,-3
POL,ARE,2023.0,1,1,0
MNG,AUS,2015.0,1,1,0
BFA,BEL,2015.0,2,5,-3
AUT,ECU,2018.0,1,1,0
ITA,LBN,2002.0,1,1,0
NOR,THA,2011.0,1,2,-1
MYS,NGA,2008.0,1,4,-3
BEL,ZWE,2020.0,1,1,0
AUS,NGA,2015.0,2,5,-3
KEN,NZL,2019.0,1,3,-2
AUS,NZL,2024.0,1,2,-1
USA,BRB,1999.0,1,2,-1
UKR,BEL,2008.0,1,2,-1
POL,KOR,2011.0,1,1,0
VEN,CRI,2010.0,1,3,-2
MNG,JPN,2017.0,1,11,-10
HRV,JPN,2017.0,1,1,0
PSE,TUR,2017.0,1,8,-7
RUS,TUR,2020.0,1,1,0
MOZ,CHE,2017.0,1,1,0
IRN,GRC,2022.0,1,1,0
SLV,ESP,2012.0,1,2,-1
PRT,EGY,2013.0,2,3,-1
GBR,ARM,2012.0,2,1,1
NLD,PHL,2005.0,1,1,0
EGY,BEL,2002.0,1,3,-2
PHL,SGP,2023.0,1,4,-3
CRI,CIV,2015.0,1,1,0
ROU,CZE,2008.0,2,2,0
NIC,MEX,2002.0,1,1,0
SLE,NLD,2017.0,1,3,-2
MWI,RWA,2022.0,1,1,0
THA,BRA,2022.0,1,4,-3
UKR,CYP,2021.0,1,1,0
SEN,MLI,2017.0,1,1,0
KEN,COL,2000.0,1,1,0
JPN,ETH,2017.0,1,2,-1
CHL,ISR,2016.0,1,1,0
ARM,NLD,2001.0,1,1,0
ARM,ITA,1997.0,1,2,-1
ROU,ECU,2019.0,1,1,0
LTU,CZE,2010.0,1,1,0
DNK,KEN,2020.0,1,1,0
NAM,DEU,2018.0,1,3,-2
BWA,ZWE,2017.0,1,1,0
POL,KOR,2019.0,2,6,-4
IND,MHL,2000.0,1,0,1
AND,NLD,2003.0,1,0,1
OMN,CRI,2007.0,1,0,1
ARG,MYS,2005.0,1,0,1
ZAF,IRL,1999.0,1,0,1
ARG,VEN,2006.0,1,0,1
CHN,BRN,1998.0,1,0,1
ECU,AUT,2009.0,1,0,1
,NRU,2003.0,1,0,1
NRU,GBR,2007.0,1,0,1
MAR,AUT,2000.0,1,0,1
MNG,AUS,2023.0,1,0,1
ROU,CMR,2020.0,1,0,1
EGY,BGD,2019.0,1,0,1
HKG,ECU,2021.0,1,0,1
IND,VEN,2001.0,1,0,1
QAT,IDN,2020.0,1,0,1
NOR,KEN,1999.0,1,0,1
IND,BEN,2009.0,1,0,1
ZWE,RWA,2009.0,1,0,1
EST,POL,1998.0,1,0,1
ARG,FIN,2012.0,2,0,2
SWE,MKD,2000.0,1,0,1
BEL,SWZ,2004.0,1,0,1
AUT,BGD,2000.0,1,0,1
LBN,BEL,2000.0,1,0,1
TJK,EST,2003.0,1,0,1
ZAF,JOR,2014.0,1,0,1
NOR,SVK,2015.0,2,0,2
ZAF,DZA,2000.0,1,0,1
ARE,DEU,1999.0,1,0,1
BOL,GEO,2019.0,2,0,2
MEX,KWT,2012.0,1,0,1
NGA,ETH,1998.0,1,0,1
KAZ,NLD,2007.0,1,0,1
HRV,TUR,2000.0,1,0,1
ITA,VAT,2015.0,1,0,1
CAF,CMR,1999.0,1,0,1
DEU,LKA,2002.0,1,0,1
NGA,CHE,2006.0,1,0,1
NLD,EST,1998.0,1,0,1
VEN,PRI,2009.0,1,0,1
VEN,DOM,2023.0,1,0,1
BFA,BEN,2005.0,1,0,1
BEN,MDG,2016.0,1,0,1
BWA,ISR,2005.0,1,0,1
SVN,PRT,2013.0,2,0,2
GRC,BRA,2012.0,1,0,1
KNA,DMA,2013.0,1,0,1
ESP,FJI,2020.0,1,0,1
RUS,NZL,2012.0,2,0,2
HRV,LUX,2021.0,1,0,1
TZA,CHN,2003.0,1,0,1
SRB,NZL,2016.0,1,0,1
SVN,SAU,2023.0,1,0,1
IDN,LAO,2020.0,1,0,1
TGO,MAR,2012.0,1,0,1
ROU,CIV,2016.0,2,0,2
CRI,GTM,2015.0,1,0,1
CAF,COG,2020.0,1,0,1
EST,CHN,2017.0,2,0,2
SWE,ARM,2023.0,1,0,1
DZA,SVK,2015.0,1,0,1
BGR,MKD,2015.0,1,0,1
IRL,IRQ,2014.0,1,0,1
BGD,AUT,2005.0,1,0,1
HUN,GBR,2024.0,1,0,1
PSE,IRQ,2018.0,1,0,1
NOR,MNG,2022.0,1,0,1
NPL,FRA,2023.0,1,0,1
ESP,DZA,2024.0,1,0,1
PRI,CUB,2021.0,1,0,1
CZE,BGD,2015.0,1,0,1
MDG,CHN,2023.0,1,0,1
IRQ,NZL,2019.0,1,0,1
VNM,DNK,2023.0,1,0,1
EGY,PSE,2008.0,1,0,1
USA,SMR,2022.0,1,0,1
ROU,DNK,2022.0,1,0,1
GRC,ALB,2012.0,1,0,1
IND,KHM,2011.0,1,0,1
THA,SEN,2010.0,1,0,1
GRC,FIN,1997.0,1,0,1
TUN,ESP,2002.0,1,0,1
MNG,CHN,2005.0,1,0,1
UKR,BGR,2010.0,1,0,1
EST,BEL,2008.0,1,0,1
MYS,TUR,1998.0,1,0,1
BIH,USA,2001.0,1,0,1
LAO,USA,2005.0,1,0,1
SEN,SWE,2016.0,1,0,1
GEO,EGY,2000.0,1,0,1
RWA,COG,2011.0,1,0,1
JPN,ETH,2002.0,1,0,1
HKG,NLD,1999.0,1,0,1
BWA,GHA,2001.0,1,0,1
MEX,HND,2005.0,2,0,2
HND,MEX,2011.0,1,0,1
PHL,THA,1999.0,1,0,1
DMA,NGA,2005.0,1,0,1
LBN,JPN,2003.0,1,0,1
HUN,MAR,2006.0,1,0,1
ARE,JOR,1997.0,1,0,1
MAR,ZAF,2000.0,1,0,1
BFA,CIV,2010.0,1,0,1
FRA,GUY,2002.0,1,0,1
LUX,ITA,1999.0,1,0,1
CYP,SWE,2010.0,1,0,1
LBY,PAK,1999.0,1,0,1
COG,ZAF,2005.0,1,0,1
PNG,BWA,1998.0,1,0,1
SMR,,2002.0,1,0,1
HRV,BEL,2002.0,2,0,2
MAR,CAN,2024.0,1,0,1
BFA,GIN,2004.0,1,0,1
MWI,NZL,2016.0,1,0,1
BEL,NGA,2003.0,1,0,1
LBR,,2011.0,2,0,2
JPN,TON,2016.0,1,0,1
MLI,LBR,2019.0,1,0,1
MRT,MLI,2012.0,1,0,1
MLI,MRT,2018.0,1,0,1
USA,MNE,2005.0,1,0,1
CRI,DEU,2005.0,1,0,1
TUN,ARG,2013.0,1,0,1
IRL,LKA,2016.0,2,0,2
CZE,GHA,2010.0,1,0,1
BDI,UGA,2014.0,1,0,1
ARE,SVN,2021.0,1,0,1
ISR,KEN,2018.0,1,0,1
BEL,ARE,2015.0,2,0,2
SWE,MYS,2003.0,1,0,1
BOL,BEL,2009.0,1,0,1
GEO,MEX,2018.0,1,0,1
HRV,NZL,1997.0,1,0,1
TWN,PRT,2012.0,2,0,2
ZAF,COL,2017.0,2,0,2
IRL,GHA,2007.0,1,0,1
CZE,ARE,2023.0,1,0,1
NZL,MEX,2023.0,1,0,1
,MAF,2019.0,1,0,1
,FSM,2020.0,1,0,1
ESP,KAZ,2022.0,1,0,1
ZWE,SWZ,2023.0,1,0,1
NPL,SAU,2015.0,1,0,1
NGA,URY,2016.0,1,0,1
THA,ARE,2007.0,1,0,1
NZL,SLB,2005.0,1,0,1
SLB,NZL,2006.0,1,0,1
IND,ABW,2017.0,1,0,1
MDA,CHE,1998.0,1,0,1
HND,JPN,2006.0,1,0,1
UKR,BRA,2010.0,1,0,1
SAU,PHL,2009.0,1,0,1
FJI,,2003.0,1,0,1
NLD,ALB,2004.0,1,0,1
ARM,CZE,2015.0,1,0,1
,ATA,2008.0,1,0,1
GBR,SWZ,2011.0,1,0,1
CHE,IRQ,2014.0,1,0,1
IRL,BEN,2017.0,1,0,1
SEN,COG,2009.0,1,0,1
NZL,GMB,2019.0,1,0,1
KHM,NLD,2012.0,1,0,1
ESP,LKA,2023.0,1,0,1
NZL,MDV,2011.0,1,0,1
HRV,MLT,2015.0,1,0,1
PHL,NPL,2018.0,1,0,1
CHE,VNM,2008.0,1,0,1
BRA,BFA,2019.0,1,0,1
ERI,THA,2019.0,1,0,1
BLR,SWE,2014.0,1,0,1
NPL,CAN,2018.0,2,0,2
CYP,LVA,2014.0,1,0,1
ARE,NZL,2016.0,2,0,2
ESP,CMR,2022.0,1,0,1
LAO,KOR,2015.0,1,0,1
BRA,ECU,2006.0,1,0,1
BGR,CHN,2010.0,1,0,1
BRN,DEU,2017.0,2,0,2
LTU,TUR,2014.0,1,0,1
NZL,ROU,2017.0,1,0,1
,VIR,2018.0,1,0,1
URY,PRY,2022.0,1,0,1
TUR,BDI,2021.0,1,0,1
BDI,KEN,2023.0,1,0,1
PHL,IRN,2022.0,1,0,1
RWA,CMR,2018.0,1,0,1
BGD,EST,2020.0,1,0,1
EST,BGD,2022.0,1,0,1
FRA,EST,2024.0,1,0,1
MYS,FJI,2011.0,1,0,1
LBR,ZAF,2010.0,1,0,1
ISR,GEO,2003.0,1,0,1
TUR,SHN,2016.0,2,0,2
ARM,ESP,2008.0,1,0,1
TUR,BRB,2014.0,1,0,1
OMN,NZL,2007.0,1,0,1
SEN,USA,1999.0,1,0,1
DEU,LSO,2011.0,1,0,1
NZL,BRA,2007.0,1,0,1
QAT,JOR,2006.0,2,0,2
HRV,MNE,2011.0,1,0,1
SDN,SYR,2012.0,1,0,1
AUT,QAT,2012.0,1,0,1
MLT,ARE,2012.0,1,0,1
HKG,KEN,2003.0,1,0,1
PHL,CZE,2003.0,1,0,1
TTO,SGP,2007.0,1,0,1
MAR,HUN,2004.0,1,0,1
MDA,UKR,2008.0,1,0,1
PSE,NOR,2010.0,1,0,1
JPN,MAR,2011.0,1,0,1
PNG,CAN,2002.0,1,0,1
TUR,LKA,2000.0,1,0,1
PRT,IRL,2001.0,1,0,1
NCL,,2002.0,3,0,3
NER,CHE,2020.0,1,0,1
IRN,PRT,2007.0,1,0,1
ZAF,KAZ,2017.0,1,0,1
PRI,DOM,2008.0,1,0,1
FIN,LVA,2017.0,1,0,1
PRT,PSE,2016.0,1,0,1
SDN,KOR,2015.0,1,0,1
FRA,LKA,1997.0,1,0,1
CYP,QAT,2007.0,1,0,1
BGR,TWN,2004.0,1,0,1
TGO,BEL,2020.0,1,0,1
RUS,MKD,2020.0,1,0,1
BIH,CHE,2019.0,2,0,2
CZE,ISL,2018.0,1,0,1
CYP,ARE,2015.0,2,0,2
ZAF,MLI,2005.0,1,0,1
MEX,PAN,2003.0,1,0,1
ESP,SLV,2007.0,1,0,1
KWT,PAK,1999.0,1,0,1
EGY,PRT,2005.0,1,0,1
URY,VEN,2000.0,1,0,1
MNG,CHN,1997.0,2,0,2
PAK,IRN,2002.0,1,0,1
GBR,PRI,2006.0,1,0,1
HKG,HUN,2013.0,1,0,1
HUN,HKG,2014.0,2,0,2
VEN,COL,1999.0,3,0,3
NOR,BLR,2017.0,1,0,1
GUF,USA,1997.0,1,0,1
ISR,SAU,2012.0,1,0,1
HRV,POL,2010.0,1,0,1
JOR,LTU,2021.0,1,0,1
CHE,BLR,2012.0,1,0,1
URY,AUT,2008.0,1,0,1
USA,YEM,2010.0,2,0,2
GRC,LBN,2019.0,1,0,1
AUT,KGZ,2019.0,1,0,1
ISL,CHE,2006.0,1,0,1
BRA,COG,2012.0,1,0,1
NGA,SLE,2016.0,1,0,1
HUN,NOR,1997.0,1,0,1
UKR,VNM,2011.0,1,0,1
CMR,PRT,2017.0,1,0,1
SWE,HND,2019.0,1,0,1
JOR,IRN,2010.0,1,0,1
BEL,BTN,2017.0,1,0,1
TWN,VNM,2024.0,1,0,1
KGZ,ESP,2021.0,1,0,1
ZAF,KHM,2012.0,1,0,1
DNK,AGO,2019.0,1,0,1
ARE,UZB,2018.0,1,0,1
CAN,GIN,2021.0,1,0,1
TWN,TTO,2011.0,1,0,1
TTO,SWE,2019.0,1,0,1
WLF,,2022.0,2,0,2
SAU,MAR,2024.0,1,0,1
POL,PAK,2016.0,1,0,1
TUN,KWT,2020.0,1,0,1
MNE,ARE,2019.0,2,0,2
KNA,JAM,2016.0,1,0,1
POL,NPL,2022.0,2,0,2
AUS,GUM,2020.0,1,0,1
EST,BEL,2014.0,1,0,1
CHN,MLI,2020.0,2,0,2
BEL,MCO,2011.0,1,0,1
MEX,SAU,2011.0,1,0,1
IRN,NLD,2024.0,1,0,1
ALB,TUR,2023.0,1,0,1
SDN,IRL,2022.0,1,0,1
GUY,TZA,2021.0,1,0,1
THA,LBN,2023.0,1,0,1
COG,DEU,2016.0,1,0,1
IRL,KWT,2005.0,1,0,1
,ZWE,2021.0,1,0,1
KWT,FRA,1999.0,1,0,1
SUR,,2007.0,1,0,1
LKA,ETH,2009.0,1,0,1
PER,BRA,1998.0,1,0,1
ARM,KAZ,2008.0,1,0,1
UZB,IND,1999.0,1,0,1
IND,UZB,2003.0,1,0,1
MDG,REU,2015.0,1,0,1
USA,COD,2005.0,1,0,1
NOR,GRC,1998.0,1,0,1
TTO,ESP,2006.0,1,0,1
PAN,VEN,2014.0,1,0,1
URY,AUS,1999.0,1,0,1
RUS,COL,2020.0,1,0,1
PAN,GBR,2010.0,1,0,1
BGD,MLI,2013.0,1,0,1
NOR,NGA,2013.0,1,0,1
NCL,POL,2011.0,1,0,1
HND,,2003.0,1,0,1
BRN,NGA,2015.0,1,0,1
PHL,GUM,2005.0,1,0,1
CMR,KEN,2006.0,1,0,1
NGA,KOR,1999.0,1,0,1
BEL,BDI,2007.0,1,0,1
ESP,GEO,2000.0,1,0,1
BRN,IND,1997.0,1,0,1
LUX,CAN,2013.0,1,0,1
IND,ATG,2005.0,1,0,1
ATG,SAU,2013.0,1,0,1
RUS,IRN,2001.0,1,0,1
GMB,BFA,2007.0,2,0,2
LTU,AUT,2001.0,1,0,1
BRB,ZAF,2007.0,1,0,1
COD,BEL,1999.0,1,0,1
KOR,NOR,2006.0,1,0,1
,FLK,2006.0,1,0,1
ROU,DZA,2010.0,1,0,1
LBN,CYP,2007.0,1,0,1
NOR,BGR,2011.0,1,0,1
BEL,UZB,2019.0,1,0,1
ARG,PAN,2008.0,1,0,1
MYS,VNM,2009.0,1,0,1
HRV,BRA,2009.0,1,0,1
ZAF,DMA,2015.0,1,0,1
FJI,MHL,2015.0,1,0,1
RUS,KEN,2012.0,1,0,1
SYR,NZL,2012.0,1,0,1
AUS,ATA,2009.0,1,0,1
AUT,OMN,2005.0,1,0,1
FIN,UGA,2011.0,1,0,1
FRA,BHR,2013.0,1,0,1
MRT,EGY,2001.0,1,0,1
SWE,LKA,2015.0,1,0,1
CMR,IDN,2017.0,1,0,1
TUR,CZE,2009.0,1,0,1
ROU,ISL,2016.0,1,0,1
ROU,ISL,2018.0,1,0,1
DZA,TUR,2012.0,1,0,1
SGP,SRB,2019.0,1,0,1
DNK,SVK,2020.0,1,0,1
BLR,IRN,2014.0,1,0,1
RUS,ARG,2023.0,1,0,1
COM,COG,2012.0,1,0,1
GBR,GTM,2000.0,1,0,1
MDG,BEL,2015.0,1,0,1
USA,GLP,2013.0,1,0,1
COL,AUT,2005.0,1,0,1
TUN,POL,2013.0,1,0,1
IRQ,IRN,2006.0,1,0,1
IRL,JAM,2017.0,1,0,1
MNG,FRA,2020.0,1,0,1
DNK,NAM,2012.0,1,0,1
DZA,IRQ,2016.0,1,0,1
GBR,TCD,2011.0,1,0,1
TKM,,2019.0,1,0,1
TWN,IDN,2024.0,1,0,1
GRC,MLT,2016.0,2,0,2
NAM,TON,2014.0,1,0,1
KEN,ESP,2006.0,1,0,1
MYS,CYP,2021.0,1,0,1
SYC,USA,1998.0,1,0,1
VEN,GEO,2014.0,1,0,1
COL,DNK,2012.0,1,0,1
BHR,MLT,2015.0,1,0,1
BFA,BEL,2000.0,1,0,1
OMN,PHL,1997.0,1,0,1
MAC,JPN,2020.0,1,0,1
ASM,FRA,2018.0,1,0,1
KAZ,BLR,2018.0,1,0,1
PRT,FJI,2020.0,1,0,1
CHN,EGY,2000.0,1,0,1
ETH,CHE,2000.0,2,0,2
CUB,NOR,2020.0,1,0,1
CAN,COG,2013.0,1,0,1
UGA,DNK,2010.0,1,0,1
RUS,GHA,2024.0,1,0,1
MNE,MAR,2021.0,1,0,1
ITA,LSO,2022.0,1,0,1
ARE,CMR,2021.0,1,0,1
BFA,COD,2022.0,1,0,1
PSE,SDN,2023.0,1,0,1
LBY,AUT,2022.0,1,0,1
SVN,ISR,2004.0,1,0,1
QAT,AFG,2024.0,1,0,1
UKR,VNM,2019.0,1,0,1
MWI,SWE,2021.0,1,0,1
TZA,BRA,2022.0,1,0,1
UKR,LVA,2008.0,1,0,1
LVA,UKR,2010.0,1,0,1
ISR,ROU,1998.0,1,0,1
FRA,ECU,1997.0,1,0,1
COG,MLI,2017.0,1,0,1
CHE,CRI,2000.0,1,0,1
URY,HUN,2000.0,1,0,1
MDA,KOR,2009.0,1,0,1
KOR,MDA,2019.0,1,0,1
EGY,KEN,2004.0,1,0,1
AUS,BRB,2016.0,1,0,1
GMB,DEU,2000.0,1,0,1
PAN,GTM,2003.0,1,0,1
BIH,BEL,2000.0,1,0,1
CYP,BEL,2011.0,1,0,1
AUS,LBN,2003.0,1,0,1
SVK,BEL,2004.0,1,0,1
DNK,SVN,2007.0,1,0,1
BRN,OMN,2018.0,1,0,1
IND,SVK,2003.0,1,0,1
USA,MHL,2003.0,1,0,1
USA,SHN,2015.0,1,0,1
BGR,ISR,2004.0,1,0,1
ISR,MAR,2000.0,1,0,1
BRA,PAK,2002.0,1,0,1
CHL,PRI,2007.0,1,0,1
TWN,SRB,2020.0,1,0,1
CIV,GUF,2003.0,1,0,1
CAN,GRD,2013.0,1,0,1
SGP,BHR,2007.0,1,0,1
AUT,GHA,1999.0,1,0,1
GAB,CMR,1999.0,1,0,1
DZA,ITA,1997.0,1,0,1
MYS,KHM,2010.0,1,0,1
MWI,PER,2019.0,1,0,1
CYP,SAU,2015.0,1,0,1
COL,BOL,2007.0,1,0,1
ROU,CIV,2017.0,1,0,1
MOZ,AGO,2008.0,1,0,1
KAZ,TJK,2013.0,1,0,1
IND,SVN,2015.0,2,0,2
CRI,KEN,2023.0,1,0,1
BEL,PSE,2012.0,1,0,1
BTN,AUS,2010.0,1,0,1
SDN,FRA,2010.0,1,0,1
NZL,FLK,2012.0,1,0,1
BEL,NGA,2013.0,2,0,2
CAN,MCO,2016.0,1,0,1
JOR,YEM,2004.0,1,0,1
AUS,BHR,2019.0,1,0,1
GLP,THA,2010.0,1,0,1
IND,NER,2018.0,1,0,1
BRA,DZA,2019.0,1,0,1
FLK,USA,2004.0,1,0,1
MOZ,DEU,2006.0,1,0,1
CRI,GTM,2001.0,1,0,1
BEN,CAN,2023.0,1,0,1
EGY,RUS,2011.0,1,0,1
MUS,NPL,2005.0,1,0,1
,DJI,2017.0,2,0,2
FJI,CHN,2012.0,1,0,1
VEN,VNM,2015.0,1,0,1
CHN,ZWE,1999.0,1,0,1
GRC,CYP,1997.0,1,0,1
CYP,LBN,2004.0,1,0,1
SGP,SYC,2009.0,1,0,1
ARE,MYS,2003.0,1,0,1
CYM,ESP,2012.0,1,0,1
CHE,THA,2001.0,1,0,1
PRI,PAN,2001.0,2,0,2
CAN,BOL,2003.0,1,0,1
ESP,PAK,2008.0,1,0,1
IDN,ZWE,2006.0,1,0,1
NLD,KHM,2005.0,1,0,1
DNK,COL,2006.0,1,0,1
CHN,LBN,2019.0,1,0,1
FIN,BRA,2003.0,1,0,1
MLI,SEN,2006.0,1,0,1
BGD,KWT,2016.0,1,0,1
CHE,HRV,1998.0,1,0,1
BRA,PHL,2006.0,1,0,1
JAM,DNK,2014.0,1,0,1
ZMB,CHN,2009.0,1,0,1
UKR,KOR,2018.0,1,0,1
DNK,IRL,1997.0,1,0,1
CHE,PRI,1997.0,1,0,1
MUS,NZL,2019.0,1,0,1
MEX,KOR,2013.0,1,0,1
IRL,BRB,2013.0,1,0,1
PHL,IRN,2018.0,1,0,1
PER,IDN,2016.0,1,0,1
IND,BRB,2020.0,1,0,1
PER,PRI,2014.0,1,0,1
SRB,MCO,2017.0,1,0,1
COD,CHE,2017.0,2,0,2
NLD,BTN,2021.0,1,0,1
KHM,COL,2010.0,1,0,1
NZL,EST,2011.0,1,0,1
COG,SEN,2014.0,1,0,1
GEO,NZL,2020.0,1,0,1
FIN,ARG,2019.0,1,0,1
GLP,MTQ,2011.0,2,0,2
FRA,BIH,2020.0,1,0,1
BWA,CZE,2018.0,1,0,1
PRY,NLD,2019.0,1,0,1
GRC,MLT,2022.0,1,0,1
SVK,UZB,2018.0,1,0,1
COL,URY,2020.0,2,0,2
MNE,USA,2014.0,1,0,1
ITA,PRK,2019.0,1,0,1
ESP,MWI,2017.0,1,0,1
LUX,FIN,2002.0,1,0,1
LUX,DNK,2005.0,1,0,1
ZWE,IRL,2021.0,1,0,1
ZAF,LUX,2006.0,1,0,1
BWA,CHN,2022.0,1,0,1
SRB,THA,2020.0,1,0,1
LBY,USA,2023.0,1,0,1
IRL,NZL,1997.0,1,0,1
IRL,IRN,2000.0,1,0,1
AUS,GUM,2007.0,1,0,1
NOR,UGA,1997.0,2,0,2
CHL,LBN,2011.0,1,0,1
MYS,SDN,2005.0,1,0,1
PRT,EST,2004.0,1,0,1
PRI,JPN,1999.0,1,0,1
CYP,UKR,2013.0,1,0,1
ESP,SDN,2011.0,1,0,1
BEL,BLZ,2018.0,1,0,1
,KNA,2000.0,1,0,1
NZL,PRT,1997.0,1,0,1
COG,,2026.0,1,0,1
BEL,GUF,2021.0,1,0,1
FJI,FSM,2014.0,1,0,1
GBR,GRL,2021.0,1,0,1
ARE,CMR,2019.0,1,0,1
CHN,CRI,2019.0,1,0,1
ESP,LBN,2020.0,1,0,1
ARG,SAU,2012.0,1,0,1
ESP,BRB,2021.0,1,0,1
SLB,AUS,2004.0,1,0,1
TTO,BHS,2017.0,1,0,1
BWA,SWE,2022.0,1,0,1
NGA,LSO,2019.0,2,0,2
MWI,AUS,2003.0,1,0,1
TZA,VNM,2021.0,1,0,1
CHL,PHL,2011.0,1,0,1
LBN,KHM,2023.0,1,0,1
SGP,SRB,2021.0,1,0,1
BRA,MAC,2022.0,1,0,1
ISR,MCO,2022.0,1,0,1
AUS,PSE,2011.0,1,0,1
EGY,BIH,2022.0,1,0,1
MUS,CAN,2021.0,1,0,1
GBR,MCO,2016.0,1,0,1
CHL,PHL,2021.0,1,0,1
NER,JOR,2020.0,1,0,1
TZA,THA,2022.0,1,0,1
KWT,IRN,2015.0,1,0,1
CYP,SAU,2004.0,1,0,1
CHN,SAU,2005.0,1,0,1
KEN,COD,1998.0,1,0,1
SVN,SLV,1997.0,2,0,2
SVN,HUN,2000.0,1,0,1
JOR,IRQ,2001.0,3,0,3
IRQ,QAT,2013.0,1,0,1
IRN,SDN,2008.0,1,0,1
TUR,KWT,2005.0,1,0,1
TUR,KWT,2012.0,1,0,1
ITA,MYS,2000.0,1,0,1
AUT,IRL,1998.0,1,0,1
IRN,HUN,2007.0,1,0,1
CZE,PRI,2003.0,1,0,1
SAU,PER,2008.0,1,0,1
CAF,GUF,2018.0,1,0,1
HUN,HKG,2001.0,1,0,1
UKR,HUN,2009.0,1,0,1
MCO,GBR,2004.0,1,0,1
AUS,BGR,2009.0,1,0,1
PYF,CHE,2014.0,1,0,1
GTM,URY,2014.0,1,0,1
BHR,AUS,1999.0,1,0,1
ITA,MCO,2018.0,1,0,1
CYP,BRA,2002.0,1,0,1
KWT,NLD,2017.0,1,0,1
TTO,BEL,2019.0,1,0,1
ISR,QAT,2011.0,1,0,1
ETH,BRA,2012.0,1,0,1
EST,BEL,2015.0,1,0,1
COL,NIC,2016.0,1,0,1
IRQ,CHN,2012.0,1,0,1
PHL,NGA,2017.0,1,0,1
CYP,IRN,2012.0,1,0,1
MYS,LKA,2014.0,2,0,2
CHN,BWA,2014.0,1,0,1
ERI,CHE,2012.0,1,0,1
KNA,TTO,2022.0,1,0,1
GBR,SSD,2014.0,1,0,1
PRT,IRN,2024.0,1,0,1
ROU,EGY,2012.0,1,0,1
BWA,SAU,2017.0,1,0,1
ISL,ISR,2007.0,1,0,1
NPL,ABW,2014.0,1,0,1
WSM,MYS,2021.0,1,0,1
CHE,SDN,2004.0,1,0,1
MWI,CHE,2014.0,2,0,2
RUS,VNM,2002.0,1,0,1
HRV,ZAF,2020.0,1,0,1
LCA,,2023.0,1,0,1
PAK,LBR,2014.0,1,0,1
URY,ZAF,1997.0,1,0,1
EST,MDA,2014.0,1,0,1
LVA,FRA,2017.0,1,0,1
AUT,SDN,2016.0,1,0,1
LUX,CHL,2023.0,1,0,1
SLV,BRA,2017.0,1,0,1
KNA,HKG,2023.0,1,0,1
BRA,ETH,2018.0,1,0,1
LIE,ROU,2019.0,1,0,1
EUE,SVK,2018.0,1,0,1
NIC,ETH,2013.0,1,0,1
CHN,GEO,2011.0,1,0,1
KWT,PAN,2018.0,1,0,1
CHL,AUT,2024.0,1,0,1
PNG,CHE,2009.0,1,0,1
CHN,CMR,2005.0,1,0,1
,BDI,1997.0,1,0,1
BEL,KOR,2000.0,1,0,1
KEN,SEN,2005.0,1,0,1
URY,SWE,2015.0,1,0,1
MYS,CHL,2020.0,1,0,1
IRL,CMR,2011.0,1,0,1
COG,IND,2019.0,1,0,1
BGR,ISR,2015.0,1,0,1
PRY,ECU,2012.0,1,0,1
VEN,BEL,2017.0,1,0,1
GBR,MUS,2016.0,1,0,1
SSD,UGA,2017.0,1,0,1
PRT,MAC,2007.0,1,0,1
JPN,QAT,2008.0,1,0,1
MWI,DNK,2008.0,1,0,1
TWN,MAR,2009.0,1,0,1
TUR,SVN,2008.0,1,0,1
FRA,BDI,2018.0,1,0,1
EGY,DZA,2017.0,1,0,1
GEO,KAZ,2019.0,1,0,1
AUT,SDN,2018.0,1,0,1
NZL,QAT,2007.0,1,0,1
BLR,ESP,2003.0,1,0,1
TUN,AUT,2011.0,1,0,1
NZL,LBN,2018.0,1,0,1
GBR,BLR,2004.0,1,0,1
IDN,NZL,2001.0,1,0,1
CHL,PRI,1998.0,1,0,1
FJI,WSM,2014.0,1,0,1
NER,MRT,2000.0,1,0,1
SYR,YEM,2019.0,1,0,1
VNM,PRT,2022.0,1,0,1
DEU,BRN,2014.0,1,0,1
AGO,USA,2005.0,1,0,1
SWE,KGZ,2017.0,1,0,1
CIV,KEN,2016.0,1,0,1
CHN,LSO,2021.0,1,0,1
BRN,DNK,2022.0,1,0,1
FJI,HUN,2011.0,1,0,1
UZB,JPN,2004.0,1,0,1
PAK,MEX,2000.0,1,0,1
TUN,ESP,1997.0,1,0,1
GBR,COG,2012.0,1,0,1
HUN,IND,2005.0,1,0,1
UZB,ISR,2002.0,1,0,1
ALB,CHE,1997.0,1,0,1
BWA,TZA,1999.0,1,0,1
GHA,SYR,2004.0,1,0,1
SYR,NLD,2013.0,1,0,1
FJI,ESP,2008.0,1,0,1
BGD,SRB,2007.0,1,0,1
ZWE,NZL,2010.0,1,0,1
FRA,ZMB,2006.0,1,0,1
MDA,POL,2005.0,1,0,1
ECU,GTM,2004.0,1,0,1
COL,AUS,1998.0,1,0,1
SWZ,,2005.0,1,0,1
HUN,HRV,1998.0,1,0,1
GRC,PHL,2017.0,1,0,1
PHL,BRA,2009.0,1,0,1
SWE,NGA,1997.0,1,0,1
DEU,DOM,1997.0,1,0,1
TUR,BIH,2004.0,1,0,1
AUT,IRN,2003.0,1,0,1
TUR,BRA,1999.0,1,0,1
CHN,LTU,2016.0,1,0,1
LBN,KWT,2010.0,1,0,1
AUT,ETH,1997.0,1,0,1
FIN,SVK,1997.0,1,0,1
MLI,USA,1998.0,1,0,1
BRA,KAZ,2003.0,1,0,1
ATG,,2000.0,1,0,1
CAF,NLD,2001.0,1,0,1
MYS,BRN,2002.0,1,0,1
ABW,USA,2002.0,1,0,1
ESP,LUX,2001.0,1,0,1
AUT,NCL,2007.0,1,0,1
TGO,CMR,2012.0,1,0,1
ARG,RUS,2009.0,1,0,1
PRT,SVN,2010.0,1,0,1
PRY,KOR,2016.0,1,0,1
PAK,AFG,2013.0,2,0,2
IRL,MLT,2014.0,1,0,1
GRC,KHM,2006.0,1,0,1
IND,LUX,2017.0,1,0,1
LUX,ZAF,2018.0,1,0,1
OMN,KAZ,2019.0,1,0,1
KNA,ZAF,2019.0,1,0,1
EST,BRA,2012.0,1,0,1
AUT,LVA,2022.0,1,0,1
SWE,JOR,2021.0,1,0,1
AZE,DEU,2012.0,1,0,1
POL,HUN,2024.0,1,0,1
BGD,BRN,2012.0,1,0,1
GEO,VNM,2017.0,1,0,1
PNG,CHE,2021.0,1,0,1
SGP,SVN,2022.0,1,0,1
MUS,ARE,2022.0,1,0,1
BRA,SLV,2019.0,1,0,1
NCL,PYF,2023.0,1,0,1
ESP,PSE,2001.0,1,0,1
ZAF,SEN,2014.0,1,0,1
NAM,DNK,2023.0,1,0,1
PAK,SOM,2022.0,1,0,1
MYS,BRA,2019.0,1,0,1
CMR,CYP,2019.0,1,0,1
SWE,PHL,2000.0,1,0,1
NGA,CZE,1999.0,1,0,1
BEL,COG,1998.0,1,0,1
NLD,MLI,2004.0,1,0,1
LBN,URY,2014.0,1,0,1
IND,YEM,2006.0,1,0,1
KAZ,SRB,2003.0,1,0,1
PAN,GBR,2000.0,1,0,1
JPN,BOL,1997.0,1,0,1
ITA,URY,2007.0,1,0,1
BEL,LBY,2005.0,1,0,1
LKA,GHA,2006.0,1,0,1
BGR,NGA,2006.0,1,0,1
GRC,MKD,2006.0,1,0,1
YEM,ESP,2011.0,1,0,1
AUS,PRT,2004.0,1,0,1
BDI,SEN,2015.0,1,0,1
BGR,MAR,2004.0,1,0,1
NPL,KOR,2001.0,1,0,1
SWZ,ZAF,2003.0,1,0,1
SLV,HRV,2015.0,1,0,1
MKD,CAN,2008.0,1,0,1
FJI,FSM,2008.0,1,0,1
DEU,BFA,1999.0,1,0,1
IRL,VEN,2004.0,1,0,1
BLR,KOR,2004.0,1,0,1
PRT,NZL,2013.0,1,0,1
YEM,OMN,2007.0,1,0,1
OMN,YEM,2010.0,1,0,1
BGR,CZE,2005.0,1,0,1
UZB,MDA,2008.0,1,0,1
SAU,NZL,2004.0,1,0,1
GEO,KOR,1998.0,1,0,1
COG,ESP,1997.0,1,0,1
NGA,GRC,2004.0,1,0,1
GRC,NGA,2005.0,1,0,1
IND,GRC,2003.0,1,0,1
RUS,CMR,2011.0,1,0,1
FRA,MWI,2003.0,1,0,1
PAN,CHE,2020.0,1,0,1
PRI,PAN,2008.0,1,0,1
LUX,AUS,2010.0,1,0,1
EGY,CZE,2011.0,1,0,1
AUT,ZMB,2008.0,1,0,1
HRV,POL,2000.0,1,0,1
JOR,HRV,2009.0,1,0,1
USA,GNQ,2015.0,1,0,1
DNK,LUX,2013.0,1,0,1
NZL,JOR,2007.0,1,0,1
HRV,HUN,2006.0,1,0,1
COL,POL,2010.0,1,0,1
SWE,LBN,2012.0,1,0,1
SVN,POL,2007.0,1,0,1
VGB,,2016.0,1,0,1
MDG,SGP,2012.0,1,0,1
ETH,SYR,2012.0,1,0,1
AUS,MOZ,2011.0,1,0,1
DNK,PER,2020.0,1,0,1
SLE,IRL,2014.0,1,0,1
SAU,SVN,2015.0,1,0,1
MDG,KHM,2018.0,1,0,1
NCL,ZAF,2012.0,1,0,1
IDN,BOL,2010.0,1,0,1
CHE,NPL,2020.0,1,0,1
SVN,ISR,2014.0,1,0,1
NOR,TGO,2013.0,1,0,1
CHE,PSE,2012.0,1,0,1
KAZ,IND,2017.0,1,0,1
,TUV,2010.0,1,0,1
ARG,ISL,2019.0,1,0,1
BRA,CMR,2019.0,1,0,1
CHL,FIN,2011.0,1,0,1
NPL,PHL,2013.0,1,0,1
IRN,EST,2015.0,1,0,1
MDA,CZE,2015.0,1,0,1
JPN,TLS,2019.0,1,0,1
AUS,GHA,2009.0,1,0,1
CAN,QAT,2008.0,8,3,5
EST,CHN,2018.0,2,2,0
FRA,BEL,2004.0,144,135,9
AUS,CHE,1999.0,15,27,-12
GHA,USA,2018.0,32,33,-1
PRT,RUS,2014.0,5,3,2
UKR,ESP,2012.0,3,2,1
CAN,ETH,2017.0,2,2,0
TWN,CHE,2004.0,2,2,0
AUT,SWE,2005.0,6,11,-5
FIN,POL,1998.0,2,2,0
ISR,SGP,2002.0,3,1,2
USA,TUN,2016.0,7,8,-1
SWE,IRL,2012.0,10,6,4
PSE,DEU,2022.0,1,3,-2
SLB,USA,2022.0,1,1,0
IND,AFG,2019.0,5,1,4
SWE,UKR,2019.0,7,7,0
VEN,FRA,2018.0,4,4,0
FIN,ARG,2021.0,2,1,1
HUN,SRB,2012.0,1,3,-2
ITA,BFA,2017.0,1,2,-1
AUS,ARG,2023.0,1,4,-3
USA,COG,2018.0,13,5,8
HUN,CAN,2018.0,5,7,-2
GRC,BGR,2012.0,3,1,2
DNK,THA,2001.0,1,2,-1
NCL,AUS,2018.0,3,3,0
QAT,FRA,2019.0,2,9,-7
COL,NZL,2009.0,2,1,1
MAR,USA,2010.0,5,8,-3
RUS,LTU,2020.0,8,1,7
PHL,BEL,2017.0,3,3,0
TUR,JPN,2023.0,3,2,1
KOR,VNM,2004.0,3,1,2
NLD,ROU,2002.0,1,10,-9
BOL,USA,2005.0,3,3,0
LTU,POL,2002.0,2,2,0
NOR,SAU,2020.0,3,3,0
MYS,IRL,2019.0,6,9,-3
MEX,ARG,2006.0,2,6,-4
LBN,EGY,2019.0,2,8,-6
KAZ,KGZ,2016.0,2,2,0
SWE,BGD,2008.0,2,4,-2
VEN,CHL,2008.0,7,2,5
NLD,COL,2004.0,3,1,2
SRB,ESP,2010.0,1,2,-1
ZWE,KEN,2003.0,2,3,-1
BOL,CHE,2016.0,1,1,0
MNG,USA,2023.0,4,2,2
IND,CHL,2023.0,8,8,0
POL,DNK,2003.0,7,9,-2
SWE,LKA,2008.0,3,1,2
SEN,ETH,2019.0,2,1,1
AUS,SYC,2018.0,1,1,0
BGD,IRL,2007.0,2,1,1
BEL,EGY,2013.0,5,6,-1
AND,ESP,2004.0,2,1,1
KWT,MYS,2020.0,3,5,-2
SWE,BGD,2015.0,4,3,1
OMN,ZAF,2010.0,1,1,0
GHA,EGY,2017.0,1,2,-1
UKR,HUN,2021.0,2,1,1
GBR,BIH,2010.0,1,1,0
BRN,GBR,2006.0,1,2,-1
DEU,SEN,2006.0,2,2,0
SWE,VNM,2001.0,2,7,-5
GAB,FRA,2014.0,6,6,0
ARE,SAU,2008.0,3,9,-6
EST,CHE,2015.0,5,4,1
ISR,PRT,2012.0,1,2,-1
CHN,PHL,2019.0,6,7,-1
BEL,SEN,2016.0,2,2,0
BEL,SEN,2018.0,2,1,1
MAC,MKD,2017.0,2,4,-2
DNK,PRT,2013.0,3,9,-6
BGR,GBR,2022.0,3,2,1
KAZ,JPN,2017.0,2,1,1
ESP,PAK,2014.0,3,3,0
DEU,KAZ,2008.0,2,3,-1
MLI,FRA,2022.0,1,9,-8
BGD,GBR,1998.0,3,11,-8
USA,KGZ,2016.0,1,1,0
USA,FJI,2017.0,2,1,1
MAC,USA,2011.0,2,9,-7
CHL,IRL,2018.0,2,3,-1
PRT,ZAF,2022.0,3,6,-3
BEL,TWN,2021.0,4,8,-4
GBR,SWZ,2019.0,1,4,-3
IDN,CHN,2015.0,1,2,-1
ARE,BHR,2008.0,1,3,-2
FRA,SVN,2003.0,4,3,1
TWN,THA,2013.0,2,4,-2
FRA,BLR,2021.0,3,2,1
IRQ,JOR,2014.0,2,3,-1
MYS,PSE,2012.0,5,3,2
AUT,ZAF,2000.0,3,2,1
BFA,GAB,2016.0,1,1,0
SRB,ROU,2011.0,3,1,2
JOR,ISR,1997.0,1,1,0
EST,ESP,2009.0,4,2,2
NGA,MYS,1998.0,1,1,0
UGA,GHA,2021.0,1,2,-1
CHN,CZE,2000.0,1,2,-1
COL,IRL,2020.0,1,2,-1
AUT,URY,2005.0,3,1,2
KOR,NLD,2000.0,3,1,2
SVN,SVK,1998.0,1,4,-3
ESP,UKR,2021.0,2,1,1
MAC,HKG,2011.0,1,7,-6
MEX,ZAF,2008.0,1,1,0
JPN,SVN,2001.0,1,3,-2
RUS,BRA,2022.0,4,8,-4
OMN,KWT,2022.0,1,1,0
SWE,ROU,1999.0,1,4,-3
BGD,TWN,2020.0,1,3,-2
NCL,FRA,2003.0,7,14,-7
CHE,SEN,2014.0,1,2,-1
ESP,NOR,2000.0,4,7,-3
PER,GBR,2016.0,5,8,-3
IRL,HUN,2016.0,2,4,-2
JPN,TZA,2008.0,1,2,-1
HRV,RUS,2017.0,2,1,1
ESP,UKR,2009.0,2,1,1
POL,NGA,2019.0,1,1,0
AUS,HUN,2016.0,2,7,-5
DEU,GHA,2009.0,3,1,2
NZL,IRN,2019.0,3,30,-27
DNK,EGY,2015.0,3,1,2
IRN,AZE,2017.0,2,3,-1
THA,ITA,2013.0,2,4,-2
DNK,MYS,2010.0,1,2,-1
GRC,TWN,2022.0,2,1,1
GHA,CMR,2015.0,1,3,-2
SVK,POL,2012.0,5,4,1
TWN,GRC,2020.0,1,1,0
BEL,TWN,2009.0,1,2,-1
ZAF,GRC,2000.0,3,3,0
EST,NZL,2022.0,1,1,0
HKG,LKA,2018.0,1,2,-1
MAR,JOR,2020.0,1,1,0
USA,HND,2016.0,2,6,-4
BRN,AUS,2019.0,3,5,-2
IRQ,SWE,2014.0,1,2,-1
NGA,BFA,2010.0,1,1,0
ARG,PRI,2014.0,3,1,2
BEN,NLD,2015.0,1,2,-1
POL,IND,2001.0,1,3,-2
SLE,USA,2008.0,1,2,-1
FIN,IRL,2011.0,1,6,-5
FRA,PHL,2015.0,2,4,-2
SWE,ROU,1998.0,1,4,-3
LTU,IRL,2020.0,2,1,1
UGA,CAN,2014.0,1,1,0
VUT,AUS,2019.0,1,1,0
MOZ,GBR,1999.0,1,1,0
CAN,PAN,2016.0,2,3,-1
FRA,QAT,2009.0,3,1,2
ZWE,MWI,2016.0,2,1,1
IRL,MKD,2017.0,1,1,0
DNK,BGR,2003.0,1,1,0
KOR,POL,2017.0,1,3,-2
SWE,SVN,1997.0,2,1,1
LVA,RUS,2004.0,1,1,0
CZE,AUS,2024.0,1,1,0
PHL,BEL,2016.0,1,3,-2
EST,CHN,2022.0,1,5,-4
EST,AUS,2019.0,2,1,1
NCL,CAN,2018.0,2,1,1
SWE,MYS,2013.0,3,5,-2
BRA,KHM,2021.0,1,1,0
KHM,AUS,2017.0,1,4,-3
MEX,URY,2002.0,1,1,0
ISL,FRO,2019.0,1,3,-2
JPN,KAZ,2010.0,1,1,0
SVN,SLV,2002.0,1,4,-3
BEL,SEN,2017.0,2,2,0
BEL,SAU,2023.0,2,2,0
IDN,NGA,2020.0,1,1,0
BEN,BFA,2021.0,1,1,0
JOR,IRN,2023.0,1,2,-1
SGP,TUR,2013.0,1,3,-2
UKR,SGP,2018.0,1,2,-1
ZMB,MWI,2016.0,1,4,-3
BEL,PAK,2016.0,1,5,-4
GMB,NGA,2012.0,1,2,-1
MNG,AUS,2010.0,1,1,0
UGA,SSD,2022.0,1,1,0
AUS,PER,2015.0,1,2,-1
KOR,FJI,2020.0,1,1,0
ALB,NOR,2016.0,1,2,-1
GBR,MCO,2017.0,1,1,0
UGA,FIN,2020.0,1,2,-1
ROU,MAR,2023.0,1,1,0
HRV,NLD,2009.0,1,2,-1
HKG,PRT,2020.0,1,1,0
CHN,OMN,2003.0,1,1,0
ISR,AUT,2007.0,2,2,0
DEU,MLT,1999.0,1,3,-2
UZB,MYS,2013.0,1,1,0
CZE,KOR,2011.0,1,1,0
CHN,GEO,2019.0,1,2,-1
COL,BEL,1997.0,1,1,0
SVK,POL,1997.0,1,2,-1
GAB,CAF,2013.0,1,2,-1
UKR,BLR,2007.0,1,1,0
ARG,NIC,2009.0,1,1,0
RUS,LVA,2009.0,1,1,0
UKR,KOR,2017.0,1,1,0
AUT,SYR,2006.0,1,1,0
POL,HUN,2006.0,2,3,-1
SGP,ZAF,2004.0,1,1,0
DZA,CHN,2015.0,1,1,0
ISL,POL,2020.0,1,1,0
ZAF,MEX,2008.0,1,1,0
ESP,KAZ,2017.0,1,1,0
SVK,POL,2005.0,1,1,0
CZE,IRN,2006.0,1,1,0
RUS,TWN,2023.0,1,2,-1
HRV,RUS,2018.0,1,1,0
OMN,JPN,2018.0,1,2,-1
