year,countrycode,padded_population_of_researchers,paddedpop,number_of_inmigrations,number_of_outmigrations,netmigration,outmigrationrate,inmigrationrate,netmigrationrate
2000.0,ABW,2,2,0,0,0,0.0,0.0,0.0
2002.0,ABW,3,3,0,0,0,0.0,0.0,0.0
2004.0,ABW,2,2,0,0,0,0.0,0.0,0.0
2012.0,ABW,8,8,0,0,0,0.0,0.0,0.0
2013.0,ABW,11,11,1,0,1,0.0,0.09090909,0.09090909
2014.0,ABW,12,12,0,0,0,0.0,0.0,0.0
2015.0,ABW,11,11,0,1,-1,0.09090909,0.0,-0.09090909
2016.0,ABW,8,8,0,2,-2,0.25,0.0,-0.25
2019.0,ABW,18,18,2,0,2,0.0,0.11111111,0.11111111
2020.0,ABW,15,15,0,1,-1,0.06666667,0.0,-0.06666667
2021.0,ABW,18,18,3,0,3,0.0,0.16666667,0.16666667
2001.0,AFG,6,6,0,0,0,0.0,0.0,0.0
2003.0,AFG,11,11,1,1,0,0.09090909,0.09090909,0.0
2004.0,AFG,15,15,4,2,2,0.13333334,0.26666668,0.13333334
2005.0,AFG,20,20,3,1,2,0.05,0.15,0.1
2006.0,AFG,27,27,6,1,5,0.037037037,0.22222222,0.18518518
2007.0,AFG,30,30,4,5,-1,0.16666667,0.13333334,-0.033333335
2008.0,AFG,41,41,2,1,1,0.024390243,0.048780486,0.024390243
2009.0,AFG,64,64,12,5,7,0.078125,0.1875,0.109375
2010.0,AFG,75,75,5,6,-1,0.08,0.06666667,-0.013333334
2011.0,AFG,72,72,7,14,-7,0.19444445,0.097222224,-0.097222224
2012.0,AFG,90,90,13,4,9,0.044444446,0.14444445,0.1
2013.0,AFG,86,86,8,11,-3,0.12790698,0.093023255,-0.034883723
2014.0,AFG,99,99,11,9,2,0.09090909,0.11111111,0.02020202
2015.0,AFG,107,107,7,13,-6,0.12149533,0.06542056,-0.056074765
2016.0,AFG,131,131,6,7,-1,0.053435113,0.045801528,-0.007633588
2017.0,AFG,173,173,19,12,7,0.06936416,0.10982659,0.040462427
2018.0,AFG,229,229,18,5,13,0.02183406,0.07860262,0.05676856
2019.0,AFG,281,281,21,15,6,0.053380784,0.07473309,0.021352313
2020.0,AFG,293,293,27,16,11,0.054607507,0.092150174,0.037542664
2021.0,AFG,278,278,13,16,-3,0.05755396,0.04676259,-0.010791367
1999.0,AGO,12,12,0,0,0,0.0,0.0,0.0
2000.0,AGO,15,15,0,0,0,0.0,0.0,0.0
2001.0,AGO,18,18,2,1,1,0.055555556,0.11111111,0.055555556
2002.0,AGO,19,19,2,3,-1,0.15789473,0.10526316,-0.05263158
2003.0,AGO,25,25,5,2,3,0.08,0.2,0.12
2004.0,AGO,26,26,2,0,2,0.0,0.07692308,0.07692308
2005.0,AGO,34,34,6,1,5,0.029411765,0.1764706,0.14705883
2006.0,AGO,36,36,1,1,0,0.027777778,0.027777778,0.0
2007.0,AGO,42,42,1,2,-1,0.04761905,0.023809524,-0.023809524
2008.0,AGO,41,41,1,8,-7,0.19512194,0.024390243,-0.17073171
2009.0,AGO,55,55,5,2,3,0.036363635,0.09090909,0.054545455
2010.0,AGO,67,67,0,4,-4,0.05970149,0.0,-0.05970149
2011.0,AGO,82,82,6,1,5,0.0121951215,0.07317073,0.06097561
2012.0,AGO,93,93,3,5,-2,0.05376344,0.032258064,-0.021505376
2013.0,AGO,114,114,6,1,5,0.00877193,0.05263158,0.04385965
2014.0,AGO,139,139,13,6,7,0.043165468,0.09352518,0.05035971
2015.0,AGO,156,156,16,4,12,0.025641026,0.102564104,0.07692308
2016.0,AGO,158,158,5,9,-4,0.056962024,0.03164557,-0.025316456
2017.0,AGO,165,165,7,11,-4,0.06666667,0.042424243,-0.024242423
2018.0,AGO,169,169,9,6,3,0.03550296,0.053254437,0.01775148
2019.0,AGO,166,166,7,5,2,0.030120483,0.042168673,0.012048192
2020.0,AGO,156,156,7,2,5,0.012820513,0.044871796,0.032051284
2021.0,AGO,149,149,9,3,6,0.020134227,0.060402684,0.040268455
2012.0,AIA,2,2,0,0,0,0.0,0.0,0.0
2013.0,AIA,5,5,2,0,2,0.0,0.4,0.4
2015.0,AIA,7,7,1,0,1,0.0,0.14285715,0.14285715
2018.0,AIA,11,11,2,1,1,0.09090909,0.18181819,0.09090909
2019.0,AIA,9,9,0,1,-1,0.11111111,0.0,-0.11111111
2020.0,AIA,7,7,1,3,-2,0.42857143,0.14285715,-0.2857143
2021.0,AIA,6,6,0,1,-1,0.16666667,0.0,-0.16666667
1996.0,ALB,18,18,0,0,0,0.0,0.0,0.0
1997.0,ALB,22,22,1,0,1,0.0,0.045454547,0.045454547
1998.0,ALB,31,31,0,0,0,0.0,0.0,0.0
1999.0,ALB,39,39,0,1,-1,0.025641026,0.0,-0.025641026
2000.0,ALB,62,62,0,0,0,0.0,0.0,0.0
2001.0,ALB,72,72,2,1,1,0.013888889,0.027777778,0.013888889
2002.0,ALB,86,86,3,2,1,0.023255814,0.034883723,0.011627907
2003.0,ALB,94,94,2,4,-2,0.04255319,0.021276595,-0.021276595
2004.0,ALB,109,109,3,1,2,0.0091743115,0.027522936,0.018348623
2005.0,ALB,131,131,3,0,3,0.0,0.022900764,0.022900764
2006.0,ALB,156,156,5,4,1,0.025641026,0.032051284,0.0064102565
2007.0,ALB,220,220,5,5,0,0.022727273,0.022727273,0.0
2008.0,ALB,312,312,8,1,7,0.0032051282,0.025641026,0.022435898
2009.0,ALB,399,399,11,3,8,0.007518797,0.027568921,0.020050125
2010.0,ALB,514,514,14,7,7,0.013618677,0.027237354,0.013618677
2011.0,ALB,656,656,12,7,5,0.010670732,0.018292682,0.0076219514
2012.0,ALB,759,759,13,9,4,0.011857707,0.017127799,0.0052700923
2013.0,ALB,793,793,12,7,5,0.008827238,0.015132409,0.0063051702
2014.0,ALB,850,850,22,11,11,0.012941176,0.025882352,0.012941176
2015.0,ALB,854,854,24,16,8,0.018735362,0.028103044,0.009367681
2016.0,ALB,813,813,22,12,10,0.014760148,0.02706027,0.012300123
2017.0,ALB,791,791,19,15,4,0.018963337,0.024020227,0.00505689
2018.0,ALB,814,814,25,19,6,0.023341523,0.03071253,0.0073710075
2019.0,ALB,858,858,25,19,6,0.022144523,0.02913753,0.006993007
2020.0,ALB,839,839,19,22,-3,0.026221693,0.022646008,-0.0035756854
2021.0,ALB,779,779,12,11,1,0.014120667,0.015404365,0.0012836971
1998.0,AND,1,1,0,0,0,0.0,0.0,0.0
2001.0,AND,6,6,1,0,1,0.0,0.16666667,0.16666667
2003.0,AND,14,14,3,1,2,0.071428575,0.21428572,0.14285715
2004.0,AND,15,15,1,2,-1,0.13333334,0.06666667,-0.06666667
2005.0,AND,15,15,1,4,-3,0.26666668,0.06666667,-0.2
2006.0,AND,19,19,2,0,2,0.0,0.10526316,0.10526316
2007.0,AND,23,23,2,0,2,0.0,0.08695652,0.08695652
2008.0,AND,29,29,5,1,4,0.03448276,0.1724138,0.13793103
2009.0,AND,30,30,5,1,4,0.033333335,0.16666667,0.13333334
2010.0,AND,33,33,2,1,1,0.030303031,0.060606062,0.030303031
2011.0,AND,27,27,1,8,-7,0.2962963,0.037037037,-0.25925925
2012.0,AND,23,23,2,4,-2,0.17391305,0.08695652,-0.08695652
2014.0,AND,19,19,2,1,1,0.05263158,0.10526316,0.05263158
2015.0,AND,21,21,3,2,1,0.0952381,0.14285715,0.04761905
2016.0,AND,27,27,4,0,4,0.0,0.14814815,0.14814815
2017.0,AND,29,29,5,1,4,0.03448276,0.1724138,0.13793103
2018.0,AND,29,29,1,2,-1,0.06896552,0.03448276,-0.03448276
2020.0,AND,30,30,2,2,0,0.06666667,0.06666667,0.0
2021.0,AND,35,35,7,0,7,0.0,0.2,0.2
1996.0,ARE,143,143,0,0,0,0.0,0.0,0.0
1997.0,ARE,176,176,3,3,0,0.017045455,0.017045455,0.0
1998.0,ARE,323,323,12,9,3,0.027863776,0.0371517,0.009287925
1999.0,ARE,470,470,22,14,8,0.029787235,0.04680851,0.017021276
2000.0,ARE,581,581,28,10,18,0.017211704,0.04819277,0.030981068
2001.0,ARE,742,742,52,25,27,0.03369272,0.07008086,0.03638814
2002.0,ARE,881,881,86,48,38,0.05448354,0.097616345,0.043132804
2003.0,ARE,1015,1015,80,46,34,0.045320198,0.07881773,0.03349754
2004.0,ARE,1144,1144,87,45,42,0.039335664,0.07604895,0.036713287
2005.0,ARE,1281,1281,115,51,64,0.039812647,0.08977362,0.049960967
2006.0,ARE,1439,1439,106,54,52,0.03752606,0.073662266,0.036136206
2007.0,ARE,1631,1631,132,78,54,0.04782342,0.08093195,0.03310852
2008.0,ARE,1839,1839,169,65,104,0.035345297,0.09189777,0.056552473
2009.0,ARE,2081,2081,189,67,122,0.03219606,0.09082172,0.05862566
2010.0,ARE,2339,2339,199,78,121,0.033347584,0.085079096,0.05173151
2011.0,ARE,2639,2639,203,89,114,0.033724897,0.07692308,0.04319818
2012.0,ARE,3033,3033,245,90,155,0.029673591,0.08077811,0.051104516
2013.0,ARE,3489,3489,303,112,191,0.03210089,0.08684437,0.05474348
2014.0,ARE,3965,3965,352,150,202,0.03783102,0.0887768,0.050945774
2015.0,ARE,4573,4573,387,131,256,0.028646402,0.08462716,0.055980757
2016.0,ARE,5258,5258,452,191,261,0.0363256,0.08596425,0.049638648
2017.0,ARE,5982,5982,529,235,294,0.03928452,0.08843196,0.049147442
2018.0,ARE,6838,6838,601,268,333,0.039192747,0.0878912,0.04869845
2019.0,ARE,7480,7480,650,310,340,0.04144385,0.086898394,0.045454547
2020.0,ARE,7550,7550,622,338,284,0.04476821,0.08238411,0.037615895
2021.0,ARE,7339,7339,429,278,151,0.03787982,0.05845483,0.020575011
2022.0,ARE,0,0,248,173,75,,,
1996.0,ARG,4247,4247,0,0,0,0.0,0.0,0.0
1997.0,ARG,5401,5401,33,43,-10,0.007961488,0.0061099795,-0.001851509
1998.0,ARG,8665,8665,65,74,-9,0.008540104,0.0075014425,-0.0010386612
1999.0,ARG,11732,11732,117,128,-11,0.01091033,0.009972724,-0.00093760656
2000.0,ARG,14238,14238,131,104,27,0.0073043965,0.00920073,0.0018963338
2001.0,ARG,16141,16141,171,283,-112,0.017532991,0.010594139,-0.0069388514
2002.0,ARG,18078,18078,289,337,-48,0.018641442,0.015986282,-0.002655161
2003.0,ARG,19409,19409,262,398,-136,0.020505952,0.013498892,-0.0070070587
2004.0,ARG,20742,20742,187,386,-199,0.018609585,0.009015524,-0.0095940605
2005.0,ARG,22074,22074,222,382,-160,0.017305426,0.010057081,-0.0072483467
2006.0,ARG,23628,23628,253,362,-109,0.015320806,0.010707635,-0.004613171
2007.0,ARG,25319,25319,290,302,-12,0.011927801,0.011453849,-0.00047395236
2008.0,ARG,27393,27393,341,316,25,0.011535794,0.012448436,0.00091264193
2009.0,ARG,29171,29171,327,329,-2,0.011278325,0.011209764,-6.856124e-05
2010.0,ARG,31058,31058,340,324,16,0.010432094,0.01094726,0.00051516516
2011.0,ARG,32940,32940,342,333,9,0.01010929,0.0103825135,0.00027322405
2012.0,ARG,34559,34559,334,349,-15,0.010098672,0.009664631,-0.00043404032
2013.0,ARG,36029,36029,348,356,-8,0.009880929,0.009658886,-0.00022204335
2014.0,ARG,37409,37409,351,378,-27,0.01010452,0.0093827685,-0.0007217514
2015.0,ARG,38798,38798,414,390,24,0.010052064,0.010670654,0.0006185886
2016.0,ARG,40199,40199,387,377,10,0.009378343,0.009627105,0.0002487624
2017.0,ARG,41108,41108,396,441,-45,0.010727839,0.009633161,-0.0010946775
2018.0,ARG,41738,41738,398,430,-32,0.010302362,0.009535675,-0.00076668744
2019.0,ARG,41419,41419,375,449,-74,0.0108404355,0.009053816,-0.0017866197
2020.0,ARG,39549,39549,354,494,-140,0.012490834,0.008950922,-0.0035399124
2021.0,ARG,36540,36540,237,372,-135,0.010180624,0.006486043,-0.0036945813
1996.0,ARM,415,415,0,0,0,0.0,0.0,0.0
1997.0,ARM,481,481,3,12,-9,0.024948025,0.0062370063,-0.01871102
1998.0,ARM,649,649,4,6,-2,0.009244992,0.0061633284,-0.0030816642
1999.0,ARM,789,789,6,5,1,0.0063371356,0.0076045627,0.0012674271
2000.0,ARM,883,883,6,15,-9,0.016987542,0.006795017,-0.010192526
2001.0,ARM,967,967,14,23,-9,0.023784902,0.014477766,-0.009307136
2002.0,ARM,1087,1087,11,17,-6,0.015639374,0.010119596,-0.0055197794
2003.0,ARM,1120,1120,21,24,-3,0.021428572,0.01875,-0.0026785715
2004.0,ARM,1155,1155,9,10,-1,0.008658009,0.007792208,-0.0008658009
2005.0,ARM,1234,1234,12,19,-7,0.015397083,0.009724474,-0.0056726094
2006.0,ARM,1305,1305,11,22,-11,0.016858237,0.008429118,-0.008429118
2007.0,ARM,1358,1358,9,15,-6,0.011045655,0.0066273934,-0.0044182623
2008.0,ARM,1441,1441,8,19,-11,0.013185288,0.0055517,-0.007633588
2009.0,ARM,1533,1533,20,17,3,0.011089367,0.013046314,0.0019569471
2010.0,ARM,1630,1630,14,27,-13,0.016564418,0.008588957,-0.00797546
2011.0,ARM,1693,1693,17,28,-11,0.016538689,0.010041347,-0.006497342
2012.0,ARM,1733,1733,17,32,-15,0.018465089,0.009809579,-0.008655511
2013.0,ARM,1759,1759,10,34,-24,0.019329164,0.005685048,-0.013644116
2014.0,ARM,1799,1799,21,24,-3,0.013340745,0.0116731515,-0.0016675931
2015.0,ARM,1797,1797,12,27,-15,0.015025042,0.006677796,-0.008347246
2016.0,ARM,1820,1820,15,35,-20,0.01923077,0.008241759,-0.010989011
2017.0,ARM,1906,1906,19,29,-10,0.01521511,0.00996852,-0.00524659
2018.0,ARM,1939,1939,24,25,-1,0.012893244,0.0123775145,-0.0005157298
2019.0,ARM,1918,1918,19,26,-7,0.0135557875,0.009906152,-0.003649635
2020.0,ARM,1833,1833,32,22,10,0.012002182,0.01745772,0.0054555372
2021.0,ARM,1696,1696,9,17,-8,0.010023585,0.005306604,-0.004716981
2002.0,ASM,6,6,0,0,0,0.0,0.0,0.0
2003.0,ASM,7,7,1,0,1,0.0,0.14285715,0.14285715
2004.0,ASM,8,8,0,1,-1,0.125,0.0,-0.125
2006.0,ASM,10,10,2,1,1,0.1,0.2,0.1
2007.0,ASM,9,9,1,0,1,0.0,0.11111111,0.11111111
2011.0,ASM,8,8,1,1,0,0.125,0.125,0.0
2013.0,ASM,10,10,1,0,1,0.0,0.1,0.1
2014.0,ASM,9,9,0,1,-1,0.11111111,0.0,-0.11111111
2015.0,ASM,8,8,0,1,-1,0.125,0.0,-0.125
2018.0,ASM,7,7,1,0,1,0.0,0.14285715,0.14285715
2019.0,ASM,8,8,1,0,1,0.0,0.125,0.125
2000.0,ATA,5,5,0,0,0,0.0,0.0,0.0
2017.0,ATA,3,3,0,0,0,0.0,0.0,0.0
2018.0,ATA,3,3,0,1,-1,0.33333334,0.0,-0.33333334
2020.0,ATA,2,2,0,1,-1,0.5,0.0,-0.5
1996.0,ATG,1,1,0,0,0,0.0,0.0,0.0
2001.0,ATG,2,2,0,0,0,0.0,0.0,0.0
2003.0,ATG,4,4,0,0,0,0.0,0.0,0.0
2005.0,ATG,8,8,2,0,2,0.0,0.25,0.25
2007.0,ATG,11,11,0,0,0,0.0,0.0,0.0
2008.0,ATG,12,12,0,0,0,0.0,0.0,0.0
2009.0,ATG,12,12,0,0,0,0.0,0.0,0.0
2010.0,ATG,10,10,0,1,-1,0.1,0.0,-0.1
2012.0,ATG,7,7,1,2,-1,0.2857143,0.14285715,-0.14285715
2014.0,ATG,9,9,1,0,1,0.0,0.11111111,0.11111111
2015.0,ATG,14,14,2,1,1,0.071428575,0.14285715,0.071428575
2016.0,ATG,16,16,1,0,1,0.0,0.0625,0.0625
2017.0,ATG,17,17,1,0,1,0.0,0.05882353,0.05882353
2018.0,ATG,17,17,2,2,0,0.11764706,0.11764706,0.0
2019.0,ATG,15,15,1,3,-2,0.2,0.06666667,-0.13333334
2020.0,ATG,15,15,2,1,1,0.06666667,0.13333334,0.06666667
2021.0,ATG,12,12,1,2,-1,0.16666667,0.083333336,-0.083333336
1996.0,AUS,12131,12131,0,0,0,0.0,0.0,0.0
1997.0,AUS,14855,14855,169,166,3,0.011174689,0.011376641,0.0002019522
1998.0,AUS,26975,26975,353,301,52,0.01115848,0.013086191,0.0019277108
1999.0,AUS,37513,37513,592,527,65,0.014048464,0.015781196,0.0017327326
2000.0,AUS,45082,45082,433,436,-3,0.009671265,0.00960472,-6.6545406e-05
2001.0,AUS,51604,51604,1019,1102,-83,0.021354934,0.01974653,-0.0016084025
2002.0,AUS,58318,58318,1592,1599,-7,0.027418636,0.027298605,-0.00012003155
2003.0,AUS,63687,63687,1666,1623,43,0.025484007,0.026159184,0.000675177
2004.0,AUS,68821,68821,1570,1454,116,0.021127272,0.022812804,0.001685532
2005.0,AUS,73596,73596,1703,1594,109,0.021658786,0.023139844,0.0014810588
2006.0,AUS,78832,78832,1907,1609,298,0.020410493,0.024190685,0.0037801908
2007.0,AUS,84345,84345,2133,1683,450,0.019953761,0.025288992,0.0053352304
2008.0,AUS,90165,90165,2345,1841,504,0.020418122,0.026007874,0.005589752
2009.0,AUS,95987,95987,2524,1902,622,0.019815184,0.026295228,0.006480044
2010.0,AUS,101905,101905,2734,2065,669,0.020263972,0.02682891,0.006564938
2011.0,AUS,108729,108729,2943,2217,726,0.020390144,0.027067296,0.0066771517
2012.0,AUS,116009,116009,3168,2252,916,0.019412287,0.027308226,0.007895939
2013.0,AUS,123275,123275,3575,2390,1185,0.019387549,0.029000202,0.009612654
2014.0,AUS,130048,130048,3598,2656,942,0.020423228,0.027666708,0.007243479
2015.0,AUS,136120,136120,3669,2876,793,0.021128416,0.026954157,0.005825742
2016.0,AUS,141505,141505,3635,3215,420,0.022720044,0.025688138,0.002968093
2017.0,AUS,146163,146163,3717,3331,386,0.022789625,0.025430512,0.0026408872
2018.0,AUS,149754,149754,3900,3579,321,0.023899194,0.02604271,0.0021435153
2019.0,AUS,150372,150372,4072,3604,468,0.023967229,0.02707951,0.0031122814
2020.0,AUS,143793,143793,3638,3520,118,0.024479633,0.025300259,0.0008206241
2021.0,AUS,133916,133916,2646,2715,-69,0.020273903,0.019758655,-0.0005152484
2022.0,AUS,0,0,1381,1660,-279,,,
1996.0,AUT,4563,4563,0,0,0,0.0,0.0,0.0
1997.0,AUT,5427,5427,74,79,-5,0.014556846,0.013635526,-0.00092131936
1998.0,AUT,8616,8616,118,148,-30,0.017177345,0.0136954505,-0.0034818943
1999.0,AUT,11692,11692,224,215,9,0.018388642,0.019158399,0.0007697571
2000.0,AUT,13853,13853,208,180,28,0.012993575,0.015014798,0.0020212228
2001.0,AUT,15885,15885,396,373,23,0.023481272,0.024929179,0.0014479068
2002.0,AUT,17851,17851,545,549,-4,0.03075458,0.030530503,-0.00022407708
2003.0,AUT,19501,19501,579,556,23,0.028511358,0.029690785,0.0011794267
2004.0,AUT,20951,20951,525,459,66,0.021908263,0.02505847,0.0031502077
2005.0,AUT,22276,22276,592,540,52,0.024241336,0.026575686,0.002334351
2006.0,AUT,23745,23745,599,527,72,0.022194145,0.025226364,0.0030322173
2007.0,AUT,25314,25314,666,542,124,0.021411076,0.026309552,0.004898475
2008.0,AUT,26683,26683,672,620,52,0.023235768,0.025184574,0.0019488063
2009.0,AUT,28279,28279,711,716,-5,0.025319142,0.025142333,-0.00017680964
2010.0,AUT,29615,29615,806,763,43,0.025763972,0.027215937,0.0014519669
2011.0,AUT,31044,31044,865,815,50,0.02625306,0.027863678,0.0016106172
2012.0,AUT,32567,32567,897,882,15,0.02708263,0.027543219,0.00046058893
2013.0,AUT,34076,34076,945,965,-20,0.028319051,0.027732128,-0.0005869233
2014.0,AUT,35539,35539,1039,952,87,0.026787473,0.029235488,0.002448015
2015.0,AUT,36711,36711,1066,987,79,0.026885675,0.029037619,0.0021519435
2016.0,AUT,37933,37933,1113,973,140,0.025650488,0.029341206,0.0036907177
2017.0,AUT,38874,38874,1108,1040,68,0.0267531,0.028502341,0.0017492411
2018.0,AUT,39775,39775,1179,1020,159,0.025644248,0.029641734,0.003997486
2019.0,AUT,39697,39697,1152,1102,50,0.027760284,0.029019825,0.001259541
2020.0,AUT,37925,37925,1189,982,207,0.02589321,0.03135135,0.005458141
2021.0,AUT,35247,35247,922,751,171,0.021306777,0.026158255,0.0048514768
1996.0,AZE,296,296,0,0,0,0.0,0.0,0.0
1997.0,AZE,334,334,3,4,-1,0.011976048,0.008982036,-0.002994012
1998.0,AZE,408,408,4,8,-4,0.019607844,0.009803922,-0.009803922
1999.0,AZE,439,439,1,4,-3,0.009111618,0.0022779044,-0.006833713
2000.0,AZE,511,511,6,11,-5,0.021526419,0.011741683,-0.009784736
2001.0,AZE,600,600,7,7,0,0.011666667,0.011666667,0.0
2002.0,AZE,721,721,4,4,0,0.0055478504,0.0055478504,0.0
2003.0,AZE,819,819,8,14,-6,0.017094018,0.00976801,-0.0073260074
2004.0,AZE,873,873,10,13,-3,0.01489118,0.011454754,-0.0034364262
2005.0,AZE,1009,1009,7,8,-1,0.007928642,0.006937562,-0.0009910803
2006.0,AZE,1174,1174,16,5,11,0.0042589437,0.01362862,0.009369676
2007.0,AZE,1354,1354,6,14,-8,0.010339734,0.0044313148,-0.0059084194
2008.0,AZE,1521,1521,12,15,-3,0.009861933,0.007889546,-0.0019723866
2009.0,AZE,1682,1682,13,17,-4,0.010107015,0.0077288942,-0.0023781213
2010.0,AZE,1740,1740,19,13,6,0.0074712643,0.01091954,0.0034482758
2011.0,AZE,1778,1778,16,23,-7,0.012935883,0.0089988755,-0.003937008
2012.0,AZE,1782,1782,20,13,7,0.007295174,0.011223344,0.0039281705
2013.0,AZE,1815,1815,18,18,0,0.009917355,0.009917355,0.0
2014.0,AZE,1861,1861,19,23,-4,0.012358947,0.010209565,-0.0021493821
2015.0,AZE,1953,1953,16,13,3,0.006656426,0.008192524,0.0015360983
2016.0,AZE,2078,2078,37,18,19,0.008662175,0.017805582,0.009143407
2017.0,AZE,2275,2275,22,21,1,0.009230769,0.009670329,0.00043956045
2018.0,AZE,2430,2430,25,13,12,0.0053497944,0.010288066,0.004938272
2019.0,AZE,2447,2447,25,22,3,0.008990601,0.010216592,0.001225991
2020.0,AZE,2298,2298,19,23,-4,0.010008703,0.008268059,-0.001740644
2021.0,AZE,2069,2069,14,17,-3,0.00821653,0.006766554,-0.0014499759
1996.0,BDI,2,2,0,0,0,0.0,0.0,0.0
2001.0,BDI,8,8,1,0,1,0.0,0.125,0.125
2002.0,BDI,11,11,1,2,-1,0.18181819,0.09090909,-0.09090909
2003.0,BDI,13,13,0,0,0,0.0,0.0,0.0
2004.0,BDI,13,13,1,1,0,0.07692308,0.07692308,0.0
2005.0,BDI,16,16,2,2,0,0.125,0.125,0.0
2007.0,BDI,21,21,1,1,0,0.04761905,0.04761905,0.0
2008.0,BDI,27,27,1,1,0,0.037037037,0.037037037,0.0
2009.0,BDI,35,35,3,1,2,0.028571429,0.08571429,0.057142857
2010.0,BDI,46,46,4,1,3,0.02173913,0.08695652,0.06521739
2011.0,BDI,55,55,1,3,-2,0.054545455,0.018181818,-0.036363635
2012.0,BDI,65,65,1,2,-1,0.03076923,0.015384615,-0.015384615
2013.0,BDI,68,68,4,0,4,0.0,0.05882353,0.05882353
2014.0,BDI,76,76,1,2,-1,0.02631579,0.013157895,-0.013157895
2015.0,BDI,80,80,3,4,-1,0.05,0.0375,-0.0125
2016.0,BDI,92,92,6,1,5,0.010869565,0.06521739,0.054347824
2017.0,BDI,101,101,4,2,2,0.01980198,0.03960396,0.01980198
2018.0,BDI,110,110,10,2,8,0.018181818,0.09090909,0.07272727
2019.0,BDI,108,108,10,6,4,0.055555556,0.09259259,0.037037037
2020.0,BDI,104,104,6,3,3,0.028846154,0.057692308,0.028846154
1996.0,BEL,5999,5999,0,0,0,0.0,0.0,0.0
1997.0,BEL,7179,7179,108,108,0,0.015043878,0.015043878,0.0
1998.0,BEL,11867,11867,176,142,34,0.011965956,0.014831044,0.0028650882
1999.0,BEL,16114,16114,275,290,-15,0.017996773,0.017065905,-0.00093086757
2000.0,BEL,19375,19375,230,239,-9,0.012335484,0.011870968,-0.00046451614
2001.0,BEL,22105,22105,555,545,10,0.024655055,0.025107441,0.00045238633
2002.0,BEL,24901,24901,708,814,-106,0.03268945,0.028432593,-0.004256857
2003.0,BEL,27224,27224,709,782,-73,0.028724656,0.026043197,-0.0026814574
2004.0,BEL,29113,29113,589,714,-125,0.024525126,0.020231511,-0.0042936145
2005.0,BEL,31004,31004,672,695,-23,0.022416463,0.021674622,-0.00074183976
2006.0,BEL,32868,32868,687,756,-69,0.023001095,0.02090179,-0.0020993063
2007.0,BEL,34863,34863,743,789,-46,0.022631442,0.021311993,-0.0013194504
2008.0,BEL,36656,36656,850,815,35,0.022233741,0.023188563,0.0009548232
2009.0,BEL,38604,38604,935,848,87,0.021966636,0.024220288,0.0022536526
2010.0,BEL,40552,40552,1029,973,56,0.023993885,0.025374828,0.001380943
2011.0,BEL,42518,42518,1059,1045,14,0.024577826,0.0249071,0.0003292723
2012.0,BEL,44573,44573,1150,1084,66,0.024319656,0.025800372,0.001480717
2013.0,BEL,46546,46546,1238,1183,55,0.025415719,0.026597345,0.0011816268
2014.0,BEL,48317,48317,1318,1326,-8,0.027443757,0.027278183,-0.00016557319
2015.0,BEL,49793,49793,1385,1343,42,0.026971662,0.027815154,0.00084349205
2016.0,BEL,50972,50972,1408,1523,-115,0.029879149,0.027623009,-0.0022561406
2017.0,BEL,51571,51571,1432,1580,-148,0.030637374,0.027767545,-0.00286983
2018.0,BEL,52055,52055,1501,1670,-169,0.03208145,0.028834887,-0.003246566
2019.0,BEL,51368,51368,1605,1576,29,0.03068058,0.031245133,0.00056455383
2020.0,BEL,48696,48696,1543,1503,40,0.030864958,0.03168638,0.0008214227
2021.0,BEL,44963,44963,1240,1196,44,0.02659965,0.027578231,0.0009785824
1996.0,BEN,21,21,0,0,0,0.0,0.0,0.0
1997.0,BEN,33,33,0,1,-1,0.030303031,0.0,-0.030303031
1998.0,BEN,59,59,0,1,-1,0.016949153,0.0,-0.016949153
1999.0,BEN,74,74,1,3,-2,0.04054054,0.013513514,-0.027027028
2000.0,BEN,115,115,3,5,-2,0.04347826,0.026086956,-0.017391304
2001.0,BEN,157,157,13,8,5,0.050955415,0.08280255,0.031847134
2002.0,BEN,209,209,13,11,2,0.05263158,0.062200956,0.009569378
2003.0,BEN,252,252,19,10,9,0.03968254,0.07539683,0.035714287
2004.0,BEN,298,298,11,11,0,0.03691275,0.03691275,0.0
2005.0,BEN,360,360,24,11,13,0.030555556,0.06666667,0.036111113
2006.0,BEN,396,396,22,10,12,0.025252525,0.055555556,0.030303031
2007.0,BEN,443,443,19,12,7,0.027088037,0.04288939,0.015801355
2008.0,BEN,506,506,27,15,12,0.02964427,0.053359684,0.023715414
2009.0,BEN,583,583,31,26,5,0.044596914,0.05317324,0.008576329
2010.0,BEN,690,690,30,15,15,0.02173913,0.04347826,0.02173913
2011.0,BEN,806,806,27,21,6,0.026054591,0.03349876,0.007444169
2012.0,BEN,875,875,28,25,3,0.028571429,0.032,0.0034285714
2013.0,BEN,964,964,22,29,-7,0.030082988,0.022821577,-0.007261411
2014.0,BEN,1027,1027,33,23,10,0.022395326,0.032132424,0.009737099
2015.0,BEN,1100,1100,16,21,-5,0.01909091,0.014545455,-0.0045454544
2016.0,BEN,1200,1200,31,29,2,0.024166666,0.025833333,0.0016666667
2017.0,BEN,1306,1306,35,36,-1,0.027565084,0.026799388,-0.0007656968
2018.0,BEN,1373,1373,43,34,9,0.024763292,0.03131828,0.006554989
2019.0,BEN,1381,1381,19,43,-24,0.031136857,0.013758146,-0.01737871
2020.0,BEN,1337,1337,32,38,-6,0.02842184,0.023934182,-0.004487659
2021.0,BEN,1232,1232,24,30,-6,0.024350649,0.019480519,-0.0048701297
1996.0,BFA,54,54,0,0,0,0.0,0.0,0.0
1997.0,BFA,85,85,0,0,0,0.0,0.0,0.0
1998.0,BFA,143,143,10,4,6,0.027972028,0.06993007,0.04195804
1999.0,BFA,218,218,2,4,-2,0.018348623,0.0091743115,-0.0091743115
2000.0,BFA,294,294,9,11,-2,0.037414964,0.030612245,-0.006802721
2001.0,BFA,345,345,9,7,2,0.020289855,0.026086956,0.0057971017
2002.0,BFA,395,395,22,18,4,0.04556962,0.055696204,0.010126582
2003.0,BFA,455,455,25,20,5,0.043956045,0.054945055,0.010989011
2004.0,BFA,507,507,10,17,-7,0.03353057,0.019723866,-0.013806706
2005.0,BFA,542,542,10,20,-10,0.036900368,0.018450184,-0.018450184
2006.0,BFA,616,616,16,20,-4,0.032467533,0.025974026,-0.0064935065
2007.0,BFA,700,700,29,22,7,0.03142857,0.04142857,0.01
2008.0,BFA,791,791,22,20,2,0.02528445,0.027812894,0.002528445
2009.0,BFA,865,865,26,14,12,0.01618497,0.030057803,0.013872832
2010.0,BFA,957,957,21,23,-2,0.024033438,0.021943573,-0.002089864
2011.0,BFA,1024,1024,27,31,-4,0.030273438,0.026367188,-0.00390625
2012.0,BFA,1117,1117,31,33,-2,0.02954342,0.02775291,-0.0017905103
2013.0,BFA,1235,1235,39,31,8,0.025101215,0.031578947,0.0064777327
2014.0,BFA,1318,1318,42,27,15,0.020485584,0.031866465,0.01138088
2015.0,BFA,1383,1383,42,46,-4,0.033261027,0.030368764,-0.0028922632
2016.0,BFA,1465,1465,43,34,9,0.023208192,0.029351536,0.0061433446
2017.0,BFA,1511,1511,43,45,-2,0.029781602,0.028457975,-0.0013236267
2018.0,BFA,1521,1521,52,40,12,0.026298488,0.034188036,0.007889546
2019.0,BFA,1542,1542,47,28,19,0.018158237,0.030479897,0.01232166
2020.0,BFA,1476,1476,32,37,-5,0.02506775,0.021680217,-0.0033875338
2021.0,BFA,1377,1377,34,16,18,0.011619463,0.024691358,0.013071896
1996.0,BGD,319,319,0,0,0,0.0,0.0,0.0
1997.0,BGD,396,396,4,7,-3,0.017676767,0.01010101,-0.007575758
1998.0,BGD,758,758,13,5,8,0.006596306,0.017150396,0.01055409
1999.0,BGD,1091,1091,18,18,0,0.016498625,0.016498625,0.0
2000.0,BGD,1373,1373,18,25,-7,0.018208303,0.013109978,-0.0050983247
2001.0,BGD,1664,1664,50,41,9,0.024639424,0.030048076,0.005408654
2002.0,BGD,1998,1998,62,70,-8,0.035035037,0.031031031,-0.004004004
2003.0,BGD,2275,2275,68,69,-1,0.03032967,0.02989011,-0.00043956045
2004.0,BGD,2640,2640,65,56,9,0.021212121,0.024621213,0.003409091
2005.0,BGD,3094,3094,98,87,11,0.02811894,0.03167421,0.0035552683
2006.0,BGD,3498,3498,89,94,-5,0.026872499,0.02544311,-0.0014293882
2007.0,BGD,3977,3977,85,94,-9,0.023635907,0.021372894,-0.0022630123
2008.0,BGD,4491,4491,111,150,-39,0.033400133,0.0247161,-0.008684034
2009.0,BGD,5019,5019,124,164,-40,0.032675833,0.024706116,-0.007969715
2010.0,BGD,5608,5608,148,174,-26,0.031027105,0.026390871,-0.004636234
2011.0,BGD,6261,6261,176,207,-31,0.03306181,0.028110525,-0.0049512857
2012.0,BGD,6996,6996,213,243,-30,0.034734134,0.030445969,-0.0042881644
2013.0,BGD,7677,7677,244,253,-9,0.032955583,0.03178325,-0.0011723329
2014.0,BGD,8266,8266,251,295,-44,0.035688363,0.030365352,-0.00532301
2015.0,BGD,8696,8696,229,358,-129,0.041168354,0.026333947,-0.014834407
2016.0,BGD,9326,9326,280,339,-59,0.03634999,0.03002359,-0.0063263993
2017.0,BGD,10172,10172,346,382,-36,0.03755407,0.034014944,-0.003539127
2018.0,BGD,11608,11608,398,416,-18,0.035837352,0.0342867,-0.0015506548
2019.0,BGD,12753,12753,451,415,36,0.032541364,0.03536423,0.0028228653
2020.0,BGD,12670,12670,509,445,64,0.035122335,0.04017364,0.0050513023
2021.0,BGD,12118,12118,356,320,36,0.026406998,0.029377785,0.0029707872
2022.0,BGD,0,0,188,253,-65,,,
1996.0,BGR,1051,1051,0,0,0,0.0,0.0,0.0
1997.0,BGR,1261,1261,15,16,-1,0.0126883425,0.011895321,-0.0007930214
1998.0,BGR,2136,2136,24,32,-8,0.014981274,0.011235955,-0.0037453184
1999.0,BGR,2828,2828,31,51,-20,0.018033946,0.01096181,-0.007072136
2000.0,BGR,3393,3393,37,54,-17,0.01591512,0.010904804,-0.005010315
2001.0,BGR,3826,3826,40,138,-98,0.036069002,0.010454783,-0.025614219
2002.0,BGR,4267,4267,88,106,-18,0.02484181,0.02062339,-0.0042184205
2003.0,BGR,4566,4566,100,116,-16,0.025405169,0.021901008,-0.0035041613
2004.0,BGR,4759,4759,78,104,-26,0.02185333,0.016389998,-0.0054633324
2005.0,BGR,5064,5064,64,91,-27,0.017969985,0.012638231,-0.0053317538
2006.0,BGR,5332,5332,64,87,-23,0.01631658,0.012003001,-0.0043135784
2007.0,BGR,5729,5729,72,66,6,0.011520335,0.012567638,0.0010473032
2008.0,BGR,5999,5999,73,74,-1,0.012335389,0.012168695,-0.00016669444
2009.0,BGR,6243,6243,72,77,-5,0.012333814,0.011532917,-0.000800897
2010.0,BGR,6555,6555,67,96,-29,0.014645309,0.010221206,-0.0044241035
2011.0,BGR,6845,6845,61,82,-21,0.011979547,0.008911614,-0.0030679328
2012.0,BGR,7050,7050,77,83,-6,0.01177305,0.010921986,-0.0008510638
2013.0,BGR,7225,7225,68,67,1,0.009273357,0.009411764,0.0001384083
2014.0,BGR,7476,7476,73,80,-7,0.010700909,0.00976458,-0.0009363296
2015.0,BGR,7704,7704,76,67,9,0.008696781,0.0098650055,0.0011682243
2016.0,BGR,7995,7995,71,70,1,0.0087554725,0.00888055,0.00012507818
2017.0,BGR,8188,8188,81,61,20,0.007449927,0.009892526,0.002442599
2018.0,BGR,8418,8418,87,52,35,0.006177239,0.0103349965,0.0041577574
2019.0,BGR,8399,8399,68,59,9,0.007024646,0.008096202,0.0010715561
2020.0,BGR,8064,8064,70,48,22,0.005952381,0.008680556,0.0027281747
2021.0,BGR,7443,7443,40,36,4,0.0048367595,0.005374177,0.0005374177
2022.0,BGR,0,0,16,16,0,,,
1996.0,BHR,60,60,0,0,0,0.0,0.0,0.0
1997.0,BHR,63,63,0,3,-3,0.04761905,0.0,-0.04761905
1998.0,BHR,95,95,0,2,-2,0.021052632,0.0,-0.021052632
1999.0,BHR,125,125,4,3,1,0.024,0.032,0.008
2000.0,BHR,158,158,5,2,3,0.012658228,0.03164557,0.01898734
2001.0,BHR,207,207,10,2,8,0.009661836,0.048309177,0.038647342
2002.0,BHR,239,239,8,7,1,0.029288704,0.033472802,0.0041841003
2003.0,BHR,290,290,11,4,7,0.013793103,0.037931036,0.024137931
2004.0,BHR,324,324,13,10,3,0.030864198,0.040123455,0.009259259
2005.0,BHR,359,359,19,8,11,0.022284122,0.05292479,0.03064067
2006.0,BHR,397,397,20,10,10,0.025188917,0.050377835,0.025188917
2007.0,BHR,408,408,14,9,5,0.022058824,0.034313727,0.012254902
2008.0,BHR,405,405,14,16,-2,0.039506175,0.0345679,-0.004938272
2009.0,BHR,427,427,17,12,5,0.028103044,0.039812647,0.011709602
2010.0,BHR,462,462,25,11,14,0.023809524,0.054112554,0.030303031
2011.0,BHR,493,493,23,13,10,0.026369167,0.046653144,0.020283977
2012.0,BHR,538,538,21,15,6,0.027881041,0.039033458,0.0111524165
2013.0,BHR,572,572,27,17,10,0.02972028,0.047202796,0.017482517
2014.0,BHR,614,614,28,21,7,0.034201954,0.045602605,0.011400651
2015.0,BHR,709,709,40,18,22,0.02538787,0.056417488,0.03102962
2016.0,BHR,806,806,39,22,17,0.027295286,0.048387095,0.021091811
2017.0,BHR,891,891,44,21,23,0.023569023,0.049382716,0.025813693
2018.0,BHR,982,982,46,25,21,0.025458248,0.04684318,0.021384928
2019.0,BHR,1022,1022,51,38,13,0.037181996,0.049902152,0.012720156
2020.0,BHR,1010,1010,58,31,27,0.03069307,0.05742574,0.026732674
2021.0,BHR,953,953,38,23,15,0.024134312,0.03987408,0.015739769
1999.0,BHS,2,2,0,0,0,0.0,0.0,0.0
2001.0,BHS,5,5,0,0,0,0.0,0.0,0.0
2002.0,BHS,6,6,1,0,1,0.0,0.16666667,0.16666667
2003.0,BHS,10,10,1,0,1,0.0,0.1,0.1
2005.0,BHS,21,21,1,0,1,0.0,0.04761905,0.04761905
2006.0,BHS,26,26,1,1,0,0.03846154,0.03846154,0.0
2007.0,BHS,28,28,2,1,1,0.035714287,0.071428575,0.035714287
2008.0,BHS,29,29,2,0,2,0.0,0.06896552,0.06896552
2009.0,BHS,32,32,1,0,1,0.0,0.03125,0.03125
2010.0,BHS,32,32,0,1,-1,0.03125,0.0,-0.03125
2011.0,BHS,42,42,2,1,1,0.023809524,0.04761905,0.023809524
2012.0,BHS,45,45,1,2,-1,0.044444446,0.022222223,-0.022222223
2013.0,BHS,52,52,3,1,2,0.01923077,0.057692308,0.03846154
2014.0,BHS,58,58,7,2,5,0.03448276,0.12068965,0.0862069
2015.0,BHS,65,65,9,4,5,0.06153846,0.13846155,0.07692308
2016.0,BHS,65,65,6,4,2,0.06153846,0.092307694,0.03076923
2017.0,BHS,62,62,5,5,0,0.08064516,0.08064516,0.0
2018.0,BHS,63,63,9,8,1,0.12698413,0.14285715,0.015873017
2019.0,BHS,57,57,5,6,-1,0.10526316,0.0877193,-0.01754386
2020.0,BHS,54,54,11,8,3,0.14814815,0.2037037,0.055555556
1996.0,BIH,14,14,0,0,0,0.0,0.0,0.0
1997.0,BIH,22,22,0,1,-1,0.045454547,0.0,-0.045454547
1998.0,BIH,76,76,0,0,0,0.0,0.0,0.0
1999.0,BIH,171,171,2,2,0,0.0116959065,0.0116959065,0.0
2000.0,BIH,296,296,2,0,2,0.0,0.006756757,0.006756757
2001.0,BIH,411,411,3,3,0,0.00729927,0.00729927,0.0
2002.0,BIH,591,591,15,5,10,0.008460237,0.02538071,0.016920473
2003.0,BIH,724,724,20,6,14,0.008287293,0.027624309,0.019337017
2004.0,BIH,873,873,25,11,14,0.012600229,0.028636884,0.016036656
2005.0,BIH,1000,1000,27,15,12,0.015,0.027,0.012
2006.0,BIH,1179,1179,28,23,5,0.019508058,0.02374894,0.004240882
2007.0,BIH,1389,1389,37,32,5,0.023038156,0.026637869,0.003599712
2008.0,BIH,1566,1566,32,16,16,0.010217113,0.020434227,0.010217113
2009.0,BIH,1715,1715,25,22,3,0.012827989,0.014577259,0.0017492712
2010.0,BIH,1859,1859,25,14,11,0.0075309305,0.01344809,0.00591716
2011.0,BIH,2054,2054,44,16,28,0.007789679,0.021421617,0.013631938
2012.0,BIH,2198,2198,40,31,9,0.01410373,0.018198362,0.0040946314
2013.0,BIH,2318,2318,38,21,17,0.009059534,0.016393442,0.0073339087
2014.0,BIH,2383,2383,31,39,-8,0.016365925,0.013008812,-0.0033571129
2015.0,BIH,2559,2559,34,25,9,0.009769442,0.01328644,0.0035169988
2016.0,BIH,2751,2751,36,38,-2,0.0138131585,0.01308615,-0.0007270084
2017.0,BIH,2935,2935,40,39,1,0.013287905,0.01362862,0.00034071552
2018.0,BIH,3073,3073,45,40,5,0.013016596,0.014643671,0.0016270746
2019.0,BIH,3109,3109,41,48,-7,0.0154390475,0.01318752,-0.0022515277
2020.0,BIH,2961,2961,30,50,-20,0.016886188,0.010131712,-0.0067544747
2021.0,BIH,2745,2745,22,21,1,0.0076502734,0.008014572,0.00036429873
1996.0,BLR,1344,1344,0,0,0,0.0,0.0,0.0
1997.0,BLR,1552,1552,14,19,-5,0.012242268,0.009020618,-0.0032216494
1998.0,BLR,1954,1954,9,29,-20,0.014841351,0.0046059364,-0.010235415
1999.0,BLR,2299,2299,18,31,-13,0.013484123,0.007829491,-0.0056546326
2000.0,BLR,2528,2528,22,37,-15,0.014636076,0.008702531,-0.005933544
2001.0,BLR,2779,2779,32,62,-30,0.022310184,0.011514934,-0.010795251
2002.0,BLR,2995,2995,58,81,-23,0.027045075,0.019365609,-0.0076794657
2003.0,BLR,3087,3087,44,66,-22,0.021379981,0.01425332,-0.00712666
2004.0,BLR,3173,3173,31,54,-23,0.017018594,0.009769934,-0.0072486605
2005.0,BLR,3251,3251,26,59,-33,0.018148262,0.007997539,-0.010150723
2006.0,BLR,3238,3238,34,52,-18,0.016059296,0.010500309,-0.005558987
2007.0,BLR,3308,3308,35,56,-21,0.016928658,0.010580411,-0.0063482467
2008.0,BLR,3326,3326,28,46,-18,0.013830427,0.008418521,-0.005411906
2009.0,BLR,3354,3354,25,42,-17,0.012522361,0.0074537867,-0.005068575
2010.0,BLR,3343,3343,29,42,-13,0.012563566,0.008674843,-0.0038887227
2011.0,BLR,3441,3441,24,44,-20,0.012786981,0.0069747167,-0.005812264
2012.0,BLR,3472,3472,31,39,-8,0.011232719,0.008928572,-0.0023041475
2013.0,BLR,3525,3525,36,42,-6,0.011914894,0.010212766,-0.0017021276
2014.0,BLR,3635,3635,30,49,-19,0.013480055,0.008253095,-0.00522696
2015.0,BLR,3694,3694,14,44,-30,0.011911208,0.0037899297,-0.008121278
2016.0,BLR,3812,3812,35,57,-22,0.014952781,0.009181532,-0.0057712486
2017.0,BLR,4013,4013,39,40,-1,0.009967606,0.009718415,-0.00024919014
2018.0,BLR,4094,4094,33,48,-15,0.011724475,0.008060576,-0.0036638984
2019.0,BLR,4116,4116,26,56,-30,0.013605442,0.0063168122,-0.0072886297
2020.0,BLR,3894,3894,22,40,-18,0.010272213,0.0056497175,-0.004622496
2021.0,BLR,3603,3603,20,27,-7,0.0074937553,0.00555093,-0.0019428254
1998.0,BLZ,2,2,0,0,0,0.0,0.0,0.0
2002.0,BLZ,8,8,0,0,0,0.0,0.0,0.0
2003.0,BLZ,12,12,1,0,1,0.0,0.083333336,0.083333336
2004.0,BLZ,14,14,1,0,1,0.0,0.071428575,0.071428575
2005.0,BLZ,18,18,0,0,0,0.0,0.0,0.0
2006.0,BLZ,20,20,0,0,0,0.0,0.0,0.0
2007.0,BLZ,21,21,0,0,0,0.0,0.0,0.0
2008.0,BLZ,24,24,1,0,1,0.0,0.041666668,0.041666668
2009.0,BLZ,24,24,0,0,0,0.0,0.0,0.0
2010.0,BLZ,24,24,1,1,0,0.041666668,0.041666668,0.0
2011.0,BLZ,27,27,2,2,0,0.074074075,0.074074075,0.0
2012.0,BLZ,30,30,1,0,1,0.0,0.033333335,0.033333335
2013.0,BLZ,30,30,2,1,1,0.033333335,0.06666667,0.033333335
2014.0,BLZ,30,30,1,3,-2,0.1,0.033333335,-0.06666667
2015.0,BLZ,35,35,3,1,2,0.028571429,0.08571429,0.057142857
2016.0,BLZ,33,33,1,3,-2,0.09090909,0.030303031,-0.060606062
2017.0,BLZ,46,46,6,0,6,0.0,0.13043478,0.13043478
2018.0,BLZ,45,45,0,2,-2,0.044444446,0.0,-0.044444446
2019.0,BLZ,46,46,3,3,0,0.06521739,0.06521739,0.0
2020.0,BLZ,40,40,1,3,-2,0.075,0.025,-0.05
2021.0,BLZ,40,40,1,0,1,0.0,0.025,0.025
1997.0,BMU,6,6,0,0,0,0.0,0.0,0.0
1998.0,BMU,10,10,0,0,0,0.0,0.0,0.0
2000.0,BMU,26,26,0,1,-1,0.03846154,0.0,-0.03846154
2001.0,BMU,26,26,0,2,-2,0.07692308,0.0,-0.07692308
2002.0,BMU,27,27,5,6,-1,0.22222222,0.18518518,-0.037037037
2003.0,BMU,29,29,1,4,-3,0.13793103,0.03448276,-0.10344828
2004.0,BMU,29,29,2,3,-1,0.10344828,0.06896552,-0.03448276
2005.0,BMU,35,35,4,3,1,0.08571429,0.114285715,0.028571429
2006.0,BMU,37,37,3,1,2,0.027027028,0.08108108,0.054054055
2007.0,BMU,39,39,3,2,1,0.051282052,0.07692308,0.025641026
2008.0,BMU,42,42,0,2,-2,0.04761905,0.0,-0.04761905
2009.0,BMU,44,44,2,3,-1,0.06818182,0.045454547,-0.022727273
2010.0,BMU,48,48,2,4,-2,0.083333336,0.041666668,-0.041666668
2011.0,BMU,49,49,5,7,-2,0.14285715,0.10204082,-0.040816326
2012.0,BMU,50,50,2,2,0,0.04,0.04,0.0
2013.0,BMU,47,47,3,7,-4,0.14893617,0.06382979,-0.08510638
2014.0,BMU,47,47,2,4,-2,0.08510638,0.04255319,-0.04255319
2015.0,BMU,41,41,1,6,-5,0.14634146,0.024390243,-0.12195122
2016.0,BMU,42,42,1,1,0,0.023809524,0.023809524,0.0
2018.0,BMU,44,44,1,2,-1,0.045454547,0.022727273,-0.022727273
1996.0,BOL,31,31,0,0,0,0.0,0.0,0.0
1997.0,BOL,46,46,0,0,0,0.0,0.0,0.0
1998.0,BOL,77,77,6,1,5,0.012987013,0.077922076,0.064935066
1999.0,BOL,102,102,1,2,-1,0.019607844,0.009803922,-0.009803922
2000.0,BOL,129,129,0,7,-7,0.054263566,0.0,-0.054263566
2001.0,BOL,145,145,0,4,-4,0.027586207,0.0,-0.027586207
2002.0,BOL,180,180,11,9,2,0.05,0.06111111,0.011111111
2003.0,BOL,207,207,11,9,2,0.04347826,0.053140096,0.009661836
2004.0,BOL,235,235,10,8,2,0.034042552,0.04255319,0.008510638
2005.0,BOL,277,277,7,14,-7,0.050541516,0.025270758,-0.025270758
2006.0,BOL,323,323,12,4,8,0.012383901,0.0371517,0.024767801
2007.0,BOL,348,348,7,14,-7,0.040229887,0.020114943,-0.020114943
2008.0,BOL,374,374,10,14,-4,0.037433155,0.026737968,-0.010695187
2009.0,BOL,412,412,12,8,4,0.019417476,0.029126214,0.009708738
2010.0,BOL,430,430,21,14,7,0.03255814,0.04883721,0.01627907
2011.0,BOL,437,437,19,18,1,0.04118993,0.04347826,0.0022883294
2012.0,BOL,452,452,13,21,-8,0.046460178,0.028761063,-0.017699115
2013.0,BOL,494,494,24,18,6,0.036437247,0.048582997,0.012145749
2014.0,BOL,518,518,25,16,9,0.03088803,0.048262548,0.017374517
2015.0,BOL,548,548,25,20,5,0.03649635,0.045620438,0.009124087
2016.0,BOL,558,558,19,21,-2,0.03763441,0.034050178,-0.0035842294
2017.0,BOL,574,574,26,17,9,0.029616725,0.045296166,0.015679443
2018.0,BOL,621,621,32,24,8,0.038647342,0.05152979,0.012882448
2019.0,BOL,616,616,22,19,3,0.030844156,0.035714287,0.0048701297
2020.0,BOL,597,597,28,24,4,0.040201005,0.046901174,0.0067001674
2021.0,BOL,532,532,9,15,-6,0.02819549,0.016917294,-0.011278195
1996.0,BRA,9650,9650,0,0,0,0.0,0.0,0.0
1997.0,BRA,12470,12470,98,71,27,0.005693665,0.007858861,0.0021651965
1998.0,BRA,21694,21694,160,116,44,0.0053471006,0.007375311,0.0020282106
1999.0,BRA,31635,31635,297,193,104,0.0061008376,0.009388336,0.0032874981
2000.0,BRA,40916,40916,232,228,4,0.005572392,0.0056701535,9.7761265e-05
2001.0,BRA,49567,49567,439,442,-3,0.008917223,0.008856699,-6.052414e-05
2002.0,BRA,59179,59179,641,621,20,0.010493588,0.010831545,0.00033795772
2003.0,BRA,68209,68209,706,589,117,0.008635224,0.01035054,0.0017153162
2004.0,BRA,80840,80840,576,555,21,0.0068654134,0.0071251853,0.00025977238
2005.0,BRA,94073,94073,622,640,-18,0.006803227,0.0066118864,-0.00019134076
2006.0,BRA,108761,108761,674,622,52,0.005718962,0.0061970744,0.00047811255
2007.0,BRA,123433,123433,694,754,-60,0.006108577,0.0056224833,-0.00048609366
2008.0,BRA,137823,137823,662,857,-195,0.0062181205,0.004803262,-0.0014148582
2009.0,BRA,152128,152128,778,966,-188,0.0063499156,0.0051141144,-0.0012358014
2010.0,BRA,167681,167681,854,998,-144,0.0059517776,0.005093004,-0.0008587735
2011.0,BRA,182168,182168,980,953,27,0.005231435,0.0053796493,0.00014821484
2012.0,BRA,196099,196099,1029,929,100,0.0047374032,0.0052473494,0.0005099465
2013.0,BRA,209630,209630,1080,1067,13,0.0050899205,0.0051519345,6.201403e-05
2014.0,BRA,223371,223371,1274,1214,60,0.0054349042,0.005703516,0.00026861142
2015.0,BRA,236450,236450,1403,1373,30,0.0058067245,0.0059336014,0.00012687672
2016.0,BRA,249371,249371,1475,1539,-64,0.006171528,0.005914882,-0.00025664573
2017.0,BRA,260440,260440,1408,1709,-301,0.006561972,0.005406236,-0.0011557364
2018.0,BRA,269758,269758,1380,2015,-635,0.007469658,0.005115696,-0.0023539618
2019.0,BRA,269471,269471,1262,2223,-961,0.008249496,0.0046832496,-0.0035662465
2020.0,BRA,255548,255548,1265,2388,-1123,0.009344624,0.004950146,-0.0043944777
2021.0,BRA,233950,233950,892,1765,-873,0.007544347,0.0038127806,-0.0037315665
2022.0,BRA,0,0,491,917,-426,,,
1996.0,BRB,8,8,0,0,0,0.0,0.0,0.0
1997.0,BRB,9,9,1,1,0,0.11111111,0.11111111,0.0
1998.0,BRB,24,24,0,0,0,0.0,0.0,0.0
1999.0,BRB,37,37,0,0,0,0.0,0.0,0.0
2000.0,BRB,44,44,1,0,1,0.0,0.022727273,0.022727273
2001.0,BRB,51,51,3,2,1,0.039215688,0.05882353,0.019607844
2002.0,BRB,63,63,1,5,-4,0.07936508,0.015873017,-0.06349207
2003.0,BRB,63,63,3,3,0,0.04761905,0.04761905,0.0
2004.0,BRB,67,67,7,3,4,0.04477612,0.104477614,0.05970149
2005.0,BRB,72,72,3,5,-2,0.06944445,0.041666668,-0.027777778
2006.0,BRB,88,88,6,6,0,0.06818182,0.06818182,0.0
2007.0,BRB,86,86,5,4,1,0.046511628,0.058139537,0.011627907
2008.0,BRB,89,89,3,6,-3,0.06741573,0.033707865,-0.033707865
2009.0,BRB,81,81,3,2,1,0.024691358,0.037037037,0.012345679
2010.0,BRB,85,85,5,1,4,0.011764706,0.05882353,0.047058824
2011.0,BRB,82,82,8,2,6,0.024390243,0.09756097,0.07317073
2012.0,BRB,81,81,6,3,3,0.037037037,0.074074075,0.037037037
2013.0,BRB,92,92,8,6,2,0.06521739,0.08695652,0.02173913
2014.0,BRB,97,97,3,3,0,0.030927835,0.030927835,0.0
2015.0,BRB,97,97,6,6,0,0.06185567,0.06185567,0.0
2016.0,BRB,100,100,6,13,-7,0.13,0.06,-0.07
2017.0,BRB,107,107,6,6,0,0.056074765,0.056074765,0.0
2018.0,BRB,111,111,9,6,3,0.054054055,0.08108108,0.027027028
2019.0,BRB,107,107,8,10,-2,0.093457945,0.07476635,-0.018691588
2020.0,BRB,112,112,4,1,3,0.008928572,0.035714287,0.026785715
2021.0,BRB,97,97,5,6,-1,0.06185567,0.05154639,-0.010309278
1996.0,BRN,25,25,0,0,0,0.0,0.0,0.0
1997.0,BRN,28,28,2,0,2,0.0,0.071428575,0.071428575
1998.0,BRN,40,40,1,2,-1,0.05,0.025,-0.025
1999.0,BRN,52,52,2,1,1,0.01923077,0.03846154,0.01923077
2000.0,BRN,59,59,4,2,2,0.033898305,0.06779661,0.033898305
2001.0,BRN,65,65,7,4,3,0.06153846,0.10769231,0.046153847
2002.0,BRN,79,79,6,6,0,0.07594936,0.07594936,0.0
2003.0,BRN,93,93,8,1,7,0.010752688,0.086021505,0.07526882
2004.0,BRN,87,87,4,3,1,0.03448276,0.04597701,0.011494253
2005.0,BRN,88,88,3,5,-2,0.056818184,0.03409091,-0.022727273
2006.0,BRN,106,106,17,6,11,0.056603774,0.16037735,0.10377359
2007.0,BRN,109,109,6,9,-3,0.08256881,0.055045873,-0.027522936
2008.0,BRN,132,132,10,6,4,0.045454547,0.07575758,0.030303031
2009.0,BRN,173,173,12,5,7,0.028901733,0.06936416,0.040462427
2010.0,BRN,217,217,15,6,9,0.02764977,0.06912442,0.041474655
2011.0,BRN,258,258,19,10,9,0.03875969,0.07364341,0.034883723
2012.0,BRN,303,303,21,11,10,0.036303632,0.06930693,0.0330033
2013.0,BRN,362,362,37,10,27,0.027624309,0.10220995,0.07458564
2014.0,BRN,419,419,32,18,14,0.042959426,0.07637232,0.03341289
2015.0,BRN,474,474,40,18,22,0.03797468,0.08438819,0.046413504
2016.0,BRN,508,508,43,13,30,0.025590552,0.084645666,0.05905512
2017.0,BRN,534,534,37,23,14,0.043071162,0.06928839,0.026217228
2018.0,BRN,573,573,38,33,5,0.057591625,0.066317625,0.008726004
2019.0,BRN,579,579,26,27,-1,0.046632126,0.044905007,-0.0017271157
2020.0,BRN,553,553,40,30,10,0.054249547,0.07233273,0.018083183
2021.0,BRN,530,530,24,14,10,0.026415095,0.04528302,0.018867925
2000.0,BTN,7,7,0,0,0,0.0,0.0,0.0
2001.0,BTN,8,8,0,1,-1,0.125,0.0,-0.125
2002.0,BTN,12,12,0,0,0,0.0,0.0,0.0
2003.0,BTN,15,15,0,1,-1,0.06666667,0.0,-0.06666667
2004.0,BTN,22,22,0,0,0,0.0,0.0,0.0
2005.0,BTN,25,25,0,1,-1,0.04,0.0,-0.04
2006.0,BTN,28,28,1,1,0,0.035714287,0.035714287,0.0
2007.0,BTN,26,26,0,4,-4,0.15384616,0.0,-0.15384616
2008.0,BTN,29,29,2,3,-1,0.10344828,0.06896552,-0.03448276
2009.0,BTN,34,34,1,1,0,0.029411765,0.029411765,0.0
2010.0,BTN,41,41,2,2,0,0.048780486,0.048780486,0.0
2011.0,BTN,59,59,0,1,-1,0.016949153,0.0,-0.016949153
2012.0,BTN,74,74,6,0,6,0.0,0.08108108,0.08108108
2013.0,BTN,80,80,6,2,4,0.025,0.075,0.05
2014.0,BTN,112,112,1,4,-3,0.035714287,0.008928572,-0.026785715
2015.0,BTN,138,138,2,4,-2,0.028985508,0.014492754,-0.014492754
2016.0,BTN,163,163,7,4,3,0.024539877,0.042944785,0.018404908
2017.0,BTN,184,184,13,15,-2,0.08152174,0.07065217,-0.010869565
2018.0,BTN,216,216,9,9,0,0.041666668,0.041666668,0.0
2019.0,BTN,226,226,15,12,3,0.053097345,0.06637168,0.013274336
2020.0,BTN,211,211,12,17,-5,0.08056872,0.056872036,-0.023696683
2021.0,BTN,207,207,16,6,10,0.028985508,0.077294685,0.048309177
1996.0,BWA,73,73,0,0,0,0.0,0.0,0.0
1997.0,BWA,101,101,2,2,0,0.01980198,0.01980198,0.0
1998.0,BWA,168,168,3,3,0,0.017857144,0.017857144,0.0
1999.0,BWA,218,218,4,7,-3,0.03211009,0.018348623,-0.013761468
2000.0,BWA,261,261,6,7,-1,0.026819924,0.022988506,-0.0038314175
2001.0,BWA,313,313,8,12,-4,0.038338657,0.025559105,-0.0127795525
2002.0,BWA,346,346,10,12,-2,0.03468208,0.028901733,-0.0057803467
2003.0,BWA,402,402,25,8,17,0.019900497,0.062189054,0.042288557
2004.0,BWA,465,465,24,14,10,0.030107526,0.051612902,0.021505376
2005.0,BWA,499,499,17,13,4,0.026052104,0.034068137,0.008016032
2006.0,BWA,529,529,24,24,0,0.04536862,0.04536862,0.0
2007.0,BWA,573,573,23,23,0,0.040139616,0.040139616,0.0
2008.0,BWA,602,602,21,29,-8,0.048172757,0.034883723,-0.013289036
2009.0,BWA,631,631,28,30,-2,0.04754358,0.044374008,-0.0031695722
2010.0,BWA,655,655,31,21,10,0.03206107,0.047328245,0.015267176
2011.0,BWA,703,703,28,28,0,0.039829303,0.039829303,0.0
2012.0,BWA,726,726,30,31,-1,0.042699724,0.041322313,-0.0013774105
2013.0,BWA,745,745,21,21,0,0.02818792,0.02818792,0.0
2014.0,BWA,802,802,38,30,8,0.037406486,0.047381546,0.009975063
2015.0,BWA,884,884,40,36,4,0.040723983,0.04524887,0.004524887
2016.0,BWA,976,976,47,32,15,0.032786883,0.048155736,0.015368853
2017.0,BWA,1029,1029,42,28,14,0.027210884,0.040816326,0.013605442
2018.0,BWA,1083,1083,62,38,24,0.03508772,0.057248384,0.022160664
2019.0,BWA,1135,1135,57,40,17,0.03524229,0.050220266,0.014977974
2020.0,BWA,1089,1089,38,42,-4,0.038567495,0.0348944,-0.0036730946
2021.0,BWA,1009,1009,31,30,1,0.029732408,0.030723488,0.0009910803
2022.0,BWA,0,0,19,13,6,,,
1996.0,CAF,3,3,0,0,0,0.0,0.0,0.0
1997.0,CAF,3,3,0,1,-1,0.33333334,0.0,-0.33333334
1999.0,CAF,15,15,0,0,0,0.0,0.0,0.0
2000.0,CAF,17,17,1,0,1,0.0,0.05882353,0.05882353
2001.0,CAF,25,25,0,4,-4,0.16,0.0,-0.16
2002.0,CAF,29,29,2,2,0,0.06896552,0.06896552,0.0
2003.0,CAF,48,48,10,1,9,0.020833334,0.20833333,0.1875
2004.0,CAF,59,59,4,2,2,0.033898305,0.06779661,0.033898305
2005.0,CAF,68,68,8,2,6,0.029411765,0.11764706,0.0882353
2006.0,CAF,65,65,0,4,-4,0.06153846,0.0,-0.06153846
2007.0,CAF,58,58,6,6,0,0.10344828,0.10344828,0.0
2008.0,CAF,62,62,5,6,-1,0.09677419,0.08064516,-0.016129032
2009.0,CAF,71,71,6,1,5,0.014084507,0.08450704,0.07042254
2010.0,CAF,78,78,3,4,-1,0.051282052,0.03846154,-0.012820513
2011.0,CAF,85,85,6,3,3,0.03529412,0.07058824,0.03529412
2012.0,CAF,93,93,7,6,1,0.06451613,0.07526882,0.010752688
2013.0,CAF,93,93,1,2,-1,0.021505376,0.010752688,-0.010752688
2014.0,CAF,100,100,3,4,-1,0.04,0.03,-0.01
2015.0,CAF,107,107,6,6,0,0.056074765,0.056074765,0.0
2016.0,CAF,114,114,4,3,1,0.02631579,0.03508772,0.00877193
2017.0,CAF,116,116,6,3,3,0.02586207,0.05172414,0.02586207
2018.0,CAF,109,109,6,6,0,0.055045873,0.055045873,0.0
2019.0,CAF,116,116,10,4,6,0.03448276,0.0862069,0.05172414
2020.0,CAF,111,111,5,1,4,0.009009009,0.045045044,0.036036037
2021.0,CAF,93,93,3,3,0,0.032258064,0.032258064,0.0
1996.0,CAN,19019,19019,0,0,0,0.0,0.0,0.0
1997.0,CAN,22412,22412,289,353,-64,0.01575049,0.012894878,-0.0028556131
1998.0,CAN,39916,39916,476,598,-122,0.014981461,0.011925043,-0.0030564184
1999.0,CAN,54718,54718,921,1033,-112,0.018878615,0.016831756,-0.0020468584
2000.0,CAN,66318,66318,780,763,17,0.011505172,0.011761513,0.00025634066
2001.0,CAN,76769,76769,1977,1968,9,0.025635347,0.025752582,0.00011723482
2002.0,CAN,87465,87465,2735,2603,132,0.029760476,0.03126965,0.001509175
2003.0,CAN,96756,96756,2970,2726,244,0.028173963,0.03069577,0.0025218073
2004.0,CAN,104900,104900,2895,2478,417,0.023622498,0.027597712,0.0039752144
2005.0,CAN,112749,112749,3010,2479,531,0.02198689,0.026696468,0.0047095763
2006.0,CAN,120503,120503,3218,2704,514,0.022439275,0.026704729,0.004265454
2007.0,CAN,128216,128216,3332,2931,401,0.022859862,0.025987396,0.0031275349
2008.0,CAN,135026,135026,3421,3249,172,0.024062032,0.025335861,0.0012738288
2009.0,CAN,141644,141644,3535,3370,165,0.023792041,0.024956934,0.0011648922
2010.0,CAN,147679,147679,3688,3711,-23,0.025128826,0.024973083,-0.0001557432
2011.0,CAN,153826,153826,3818,3790,28,0.024638228,0.024820251,0.00018202384
2012.0,CAN,159836,159836,3997,3943,54,0.024669036,0.025006883,0.0003378463
2013.0,CAN,166320,166320,4140,4158,-18,0.025,0.024891775,-0.00010822511
2014.0,CAN,172036,172036,4353,4278,75,0.024866888,0.025302844,0.00043595527
2015.0,CAN,176968,176968,4334,4475,-141,0.025287058,0.024490302,-0.0007967542
2016.0,CAN,181222,181222,4432,4689,-257,0.025874343,0.024456192,-0.0014181501
2017.0,CAN,184907,184907,4485,4703,-218,0.025434408,0.024255436,-0.001178971
2018.0,CAN,187280,187280,4587,4780,-193,0.02552328,0.024492739,-0.0010305425
2019.0,CAN,186499,186499,5317,4646,671,0.024911663,0.028509537,0.0035978744
2020.0,CAN,176703,176703,4858,4512,346,0.02553437,0.02749246,0.0019580878
2021.0,CAN,162768,162768,3564,3290,274,0.020212818,0.021896197,0.0016833775
2022.0,CAN,0,0,2006,1774,232,,,
2006.0,CCK,1,1,0,0,0,0.0,0.0,0.0
2009.0,CCK,2,2,0,0,0,0.0,0.0,0.0
2017.0,CCK,4,4,0,0,0,0.0,0.0,0.0
2018.0,CCK,4,4,0,0,0,0.0,0.0,0.0
1996.0,CHE,7526,7526,0,0,0,0.0,0.0,0.0
1997.0,CHE,9090,9090,252,226,26,0.024862487,0.027722772,0.002860286
1998.0,CHE,14820,14820,439,378,61,0.025506074,0.029622132,0.0041160593
1999.0,CHE,19536,19536,608,619,-11,0.031685095,0.03112203,-0.0005630631
2000.0,CHE,23236,23236,561,498,63,0.02143226,0.024143571,0.00271131
2001.0,CHE,26350,26350,1075,1098,-23,0.04166983,0.040796965,-0.00087286526
2002.0,CHE,29967,29967,1548,1351,197,0.045082923,0.051656824,0.006573898
2003.0,CHE,33083,33083,1735,1416,319,0.04280144,0.052443855,0.009642415
2004.0,CHE,35880,35880,1688,1226,462,0.034169454,0.047045708,0.0128762545
2005.0,CHE,38133,38133,1627,1333,294,0.0349566,0.042666458,0.0077098575
2006.0,CHE,40795,40795,1831,1428,403,0.035004288,0.044882953,0.0098786615
2007.0,CHE,43158,43158,1798,1570,228,0.03637796,0.041660875,0.005282914
2008.0,CHE,45721,45721,2109,1701,408,0.03720391,0.0461276,0.008923689
2009.0,CHE,48227,48227,2269,1845,424,0.03825658,0.047048334,0.008791756
2010.0,CHE,50852,50852,2429,1898,531,0.037324,0.047766067,0.010442067
2011.0,CHE,53799,53799,2677,1913,764,0.035558283,0.049759287,0.014201008
2012.0,CHE,56907,56907,2811,2024,787,0.035566803,0.049396385,0.013829581
2013.0,CHE,59799,59799,2852,2179,673,0.036438737,0.047693104,0.011254368
2014.0,CHE,62853,62853,3159,2306,853,0.036688782,0.05026013,0.013571349
2015.0,CHE,65417,65417,3103,2465,638,0.037681337,0.047434155,0.0097528165
2016.0,CHE,67816,67816,3323,2468,855,0.036392592,0.049000237,0.012607644
2017.0,CHE,69900,69900,3398,2492,906,0.03565093,0.048612304,0.012961374
2018.0,CHE,71478,71478,3350,2694,656,0.037689917,0.046867568,0.009177649
2019.0,CHE,71407,71407,3392,2729,663,0.03821754,0.047502346,0.009284804
2020.0,CHE,68178,68178,3345,2633,712,0.038619496,0.049062748,0.010443252
2021.0,CHE,63383,63383,2481,2026,455,0.031964406,0.03914299,0.007178581
1996.0,CHL,1639,1639,0,0,0,0.0,0.0,0.0
1997.0,CHL,2048,2048,27,23,4,0.011230469,0.013183594,0.001953125
1998.0,CHL,3141,3141,34,14,20,0.0044571795,0.010824578,0.006367399
1999.0,CHL,4212,4212,62,46,16,0.010921177,0.014719848,0.0037986704
2000.0,CHL,5302,5302,54,38,16,0.007167107,0.010184836,0.0030177291
2001.0,CHL,6248,6248,110,91,19,0.01456466,0.017605634,0.003040973
2002.0,CHL,7330,7330,177,125,52,0.017053206,0.02414734,0.0070941336
2003.0,CHL,8354,8354,198,128,70,0.015322002,0.02370122,0.008379219
2004.0,CHL,9542,9542,167,123,44,0.012890379,0.017501572,0.0046111927
2005.0,CHL,10810,10810,204,159,45,0.014708603,0.018871415,0.004162812
2006.0,CHL,12293,12293,213,193,20,0.015699992,0.017326934,0.0016269422
2007.0,CHL,13720,13720,238,200,38,0.014577259,0.01734694,0.0027696793
2008.0,CHL,15074,15074,252,249,3,0.016518509,0.016717527,0.00019901818
2009.0,CHL,16373,16373,288,256,32,0.015635498,0.017589934,0.0019544372
2010.0,CHL,17642,17642,331,276,55,0.015644485,0.018762045,0.0031175604
2011.0,CHL,18939,18939,365,335,30,0.017688368,0.0192724,0.0015840329
2012.0,CHL,20447,20447,399,306,93,0.01496552,0.019513866,0.0045483443
2013.0,CHL,21915,21915,419,377,42,0.01720283,0.019119324,0.0019164955
2014.0,CHL,23649,23649,604,381,223,0.016110618,0.025540192,0.009429574
2015.0,CHL,24982,24982,609,447,162,0.017892882,0.02437755,0.006484669
2016.0,CHL,26807,26807,629,476,153,0.017756555,0.02346402,0.0057074646
2017.0,CHL,28180,28180,683,515,168,0.018275373,0.024237048,0.0059616747
2018.0,CHL,29339,29339,642,557,85,0.01898497,0.021882137,0.0028971676
2019.0,CHL,29522,29522,682,566,116,0.019172143,0.023101415,0.003929273
2020.0,CHL,28257,28257,605,569,36,0.020136604,0.021410624,0.0012740206
2021.0,CHL,26204,26204,408,480,-72,0.018317815,0.015570142,-0.0027476721
1996.0,CHN,32244,32244,0,0,0,0.0,0.0,0.0
1997.0,CHN,44074,44074,244,188,56,0.0042655533,0.0055361437,0.0012705904
1998.0,CHN,69265,69265,279,370,-91,0.005341803,0.0040280083,-0.0013137949
1999.0,CHN,97987,97987,400,808,-408,0.008245992,0.004082174,-0.0041638175
2000.0,CHN,125620,125620,335,925,-590,0.0073634773,0.0026667728,-0.0046967044
2001.0,CHN,158486,158486,838,1484,-646,0.009363603,0.005287533,-0.0040760697
2002.0,CHN,206823,206823,1233,1855,-622,0.008969022,0.0059616193,-0.0030074024
2003.0,CHN,270767,270767,1573,1905,-332,0.0070355693,0.005809423,-0.0012261465
2004.0,CHN,335327,335327,1789,1759,30,0.005245626,0.0053350907,8.946491e-05
2005.0,CHN,400161,400161,1873,2016,-143,0.0050379722,0.004680616,-0.00035735616
2006.0,CHN,471049,471049,2048,2196,-148,0.0046619354,0.004347743,-0.00031419238
2007.0,CHN,544662,544662,2292,2501,-209,0.0045918385,0.0042081145,-0.00038372423
2008.0,CHN,616191,616191,2525,2961,-436,0.0048053283,0.0040977555,-0.0007075728
2009.0,CHN,690186,690186,2819,3486,-667,0.0050508124,0.0040844064,-0.00096640614
2010.0,CHN,774836,774836,3373,3982,-609,0.005139152,0.004353179,-0.00078597275
2011.0,CHN,878955,878955,3980,4263,-283,0.0048500774,0.0045281043,-0.00032197326
2012.0,CHN,989944,989944,4668,4377,291,0.0044214623,0.0047154184,0.00029395602
2013.0,CHN,1108353,1108353,5068,4682,386,0.004224286,0.0045725503,0.0003482645
2014.0,CHN,1230014,1230014,5518,5277,241,0.004290195,0.0044861278,0.00019593273
2015.0,CHN,1356982,1356982,6198,5623,575,0.0041437545,0.0045674886,0.00042373443
2016.0,CHN,1496323,1496323,6720,6140,580,0.004103392,0.004491009,0.00038761683
2017.0,CHN,1649457,1649457,7345,6489,856,0.003934022,0.0044529806,0.00051895867
2018.0,CHN,1794892,1794892,8210,6975,1235,0.0038860277,0.004574091,0.0006880637
2019.0,CHN,1891553,1891553,8897,7475,1422,0.003951779,0.0047035427,0.00075176323
2020.0,CHN,1802345,1802345,9074,8005,1069,0.004441436,0.0050345524,0.0005931162
2021.0,CHN,1682698,1682698,8059,6408,1651,0.0038081699,0.0047893324,0.0009811624
2022.0,CHN,0,0,5230,3801,1429,,,
1996.0,CIV,90,90,0,0,0,0.0,0.0,0.0
1997.0,CIV,127,127,4,3,1,0.023622047,0.031496063,0.007874016
1998.0,CIV,215,215,2,2,0,0.009302326,0.009302326,0.0
1999.0,CIV,295,295,4,8,-4,0.027118644,0.013559322,-0.013559322
2000.0,CIV,384,384,5,1,4,0.0026041667,0.013020833,0.010416667
2001.0,CIV,455,455,20,20,0,0.043956045,0.043956045,0.0
2002.0,CIV,548,548,13,23,-10,0.041970804,0.023722628,-0.018248174
2003.0,CIV,653,653,34,23,11,0.035222054,0.05206738,0.016845329
2004.0,CIV,749,749,16,30,-14,0.040053405,0.021361817,-0.018691588
2005.0,CIV,860,860,21,20,1,0.023255814,0.024418605,0.0011627907
2006.0,CIV,1009,1009,25,32,-7,0.03171457,0.024777006,-0.006937562
2007.0,CIV,1164,1164,40,11,29,0.009450172,0.03436426,0.02491409
2008.0,CIV,1245,1245,31,36,-5,0.028915662,0.024899598,-0.004016064
2009.0,CIV,1338,1338,24,44,-20,0.032884903,0.01793722,-0.014947684
2010.0,CIV,1451,1451,39,33,6,0.022742936,0.026878016,0.004135079
2011.0,CIV,1483,1483,49,31,18,0.020903574,0.033041134,0.012137559
2012.0,CIV,1573,1573,48,19,29,0.01207883,0.030514939,0.01843611
2013.0,CIV,1629,1629,48,28,20,0.01718846,0.02946593,0.012277471
2014.0,CIV,1636,1636,25,32,-7,0.019559903,0.015281173,-0.0042787287
2015.0,CIV,1677,1677,34,25,9,0.014907573,0.0202743,0.0053667263
2016.0,CIV,1754,1754,48,28,20,0.015963512,0.02736602,0.011402508
2017.0,CIV,1830,1830,40,27,13,0.014754098,0.021857923,0.007103825
2018.0,CIV,1815,1815,54,15,39,0.008264462,0.029752066,0.021487603
2019.0,CIV,1837,1837,50,28,22,0.015242243,0.027218292,0.011976048
2020.0,CIV,1734,1734,46,25,21,0.014417532,0.026528258,0.012110727
2021.0,CIV,1570,1570,29,15,14,0.00955414,0.018471338,0.008917198
1996.0,CMR,101,101,0,0,0,0.0,0.0,0.0
1997.0,CMR,132,132,1,1,0,0.007575758,0.007575758,0.0
1998.0,CMR,247,247,2,2,0,0.008097166,0.008097166,0.0
1999.0,CMR,366,366,5,8,-3,0.021857923,0.013661202,-0.008196721
2000.0,CMR,508,508,8,11,-3,0.021653544,0.015748031,-0.005905512
2001.0,CMR,642,642,23,23,0,0.035825547,0.035825547,0.0
2002.0,CMR,776,776,32,23,9,0.029639175,0.041237112,0.011597938
2003.0,CMR,992,992,47,20,27,0.02016129,0.04737903,0.027217742
2004.0,CMR,1179,1179,33,31,2,0.02629347,0.027989822,0.0016963528
2005.0,CMR,1348,1348,36,28,8,0.020771513,0.026706232,0.005934718
2006.0,CMR,1460,1460,16,35,-19,0.023972603,0.010958904,-0.013013699
2007.0,CMR,1633,1633,36,44,-8,0.026944274,0.022045316,-0.004898959
2008.0,CMR,1803,1803,36,36,0,0.019966722,0.019966722,0.0
2009.0,CMR,2027,2027,43,56,-13,0.027627034,0.021213615,-0.006413419
2010.0,CMR,2207,2207,42,58,-16,0.026280018,0.019030359,-0.0072496603
2011.0,CMR,2429,2429,46,42,4,0.017291067,0.018937834,0.0016467682
2012.0,CMR,2677,2677,59,45,14,0.016809862,0.022039596,0.005229735
2013.0,CMR,2974,2974,43,47,-4,0.015803631,0.014458641,-0.0013449899
2014.0,CMR,3304,3304,75,41,34,0.012409201,0.022699758,0.010290557
2015.0,CMR,3630,3630,92,62,30,0.01707989,0.025344353,0.008264462
2016.0,CMR,3951,3951,54,61,-7,0.015439129,0.013667426,-0.0017717034
2017.0,CMR,4280,4280,63,78,-15,0.018224299,0.014719626,-0.0035046728
2018.0,CMR,4630,4630,61,72,-11,0.015550756,0.013174946,-0.00237581
2019.0,CMR,4824,4824,74,77,-3,0.015961858,0.015339967,-0.00062189053
2020.0,CMR,4672,4672,86,63,23,0.013484589,0.018407535,0.004922945
2021.0,CMR,4424,4424,66,57,9,0.012884268,0.014918625,0.002034358
1996.0,COD,4,4,0,0,0,0.0,0.0,0.0
1997.0,COD,4,4,0,0,0,0.0,0.0,0.0
1998.0,COD,4,4,0,1,-1,0.25,0.0,-0.25
2000.0,COD,14,14,0,1,-1,0.071428575,0.0,-0.071428575
2001.0,COD,17,17,1,0,1,0.0,0.05882353,0.05882353
2002.0,COD,22,22,3,3,0,0.13636364,0.13636364,0.0
2003.0,COD,24,24,3,4,-1,0.16666667,0.125,-0.041666668
2004.0,COD,28,28,1,1,0,0.035714287,0.035714287,0.0
2005.0,COD,28,28,2,0,2,0.0,0.071428575,0.071428575
2006.0,COD,39,39,5,5,0,0.12820514,0.12820514,0.0
2007.0,COD,45,45,6,6,0,0.13333334,0.13333334,0.0
2008.0,COD,51,51,5,8,-3,0.15686275,0.09803922,-0.05882353
2009.0,COD,58,58,13,8,5,0.13793103,0.22413793,0.0862069
2010.0,COD,60,60,12,16,-4,0.26666668,0.2,-0.06666667
2011.0,COD,62,62,5,12,-7,0.19354838,0.08064516,-0.11290322
2012.0,COD,68,68,5,7,-2,0.10294118,0.073529415,-0.029411765
2013.0,COD,83,83,19,7,12,0.084337346,0.22891566,0.14457831
2014.0,COD,108,108,14,14,0,0.12962963,0.12962963,0.0
2015.0,COD,137,137,22,22,0,0.16058394,0.16058394,0.0
2016.0,COD,204,204,39,17,22,0.083333336,0.19117647,0.10784314
2017.0,COD,271,271,58,17,41,0.062730625,0.21402214,0.15129152
2018.0,COD,380,380,97,45,52,0.118421055,0.25526315,0.1368421
2019.0,COD,536,536,141,28,113,0.052238807,0.2630597,0.2108209
2020.0,COD,631,631,133,27,106,0.042789225,0.21077655,0.16798732
2021.0,COD,646,646,83,40,43,0.061919503,0.12848297,0.066563465
1996.0,COG,9,9,0,0,0,0.0,0.0,0.0
1997.0,COG,19,19,0,1,-1,0.05263158,0.0,-0.05263158
1998.0,COG,42,42,3,1,2,0.023809524,0.071428575,0.04761905
1999.0,COG,63,63,0,0,0,0.0,0.0,0.0
2000.0,COG,90,90,3,3,0,0.033333335,0.033333335,0.0
2001.0,COG,109,109,1,8,-7,0.07339449,0.0091743115,-0.06422018
2002.0,COG,153,153,5,4,1,0.026143791,0.03267974,0.006535948
2003.0,COG,220,220,14,8,6,0.036363635,0.06363636,0.027272727
2004.0,COG,267,267,15,7,8,0.026217228,0.056179777,0.029962547
2005.0,COG,328,328,23,7,16,0.021341464,0.07012195,0.048780486
2006.0,COG,378,378,15,14,1,0.037037037,0.03968254,0.0026455026
2007.0,COG,420,420,24,20,4,0.04761905,0.057142857,0.00952381
2008.0,COG,457,457,21,15,6,0.032822758,0.04595186,0.013129103
2009.0,COG,504,504,31,30,1,0.05952381,0.061507937,0.001984127
2010.0,COG,579,579,34,23,11,0.03972366,0.058721934,0.018998273
2011.0,COG,659,659,35,25,10,0.037936267,0.053110775,0.015174507
2012.0,COG,788,788,31,21,10,0.026649747,0.0393401,0.012690355
2013.0,COG,845,845,24,35,-11,0.041420117,0.028402368,-0.013017751
2014.0,COG,930,930,50,26,24,0.027956989,0.05376344,0.025806451
2015.0,COG,1001,1001,59,49,10,0.04895105,0.05894106,0.00999001
2016.0,COG,1013,1013,44,68,-24,0.06712735,0.04343534,-0.023692004
2017.0,COG,1004,1004,55,74,-19,0.07370518,0.054780878,-0.018924303
2018.0,COG,996,996,84,104,-20,0.104417674,0.084337346,-0.02008032
2019.0,COG,901,901,70,143,-73,0.15871254,0.07769145,-0.081021085
2020.0,COG,760,760,53,134,-81,0.17631578,0.069736846,-0.106578946
2021.0,COG,629,629,48,80,-32,0.12718602,0.0763116,-0.050874405
1996.0,COL,405,405,0,0,0,0.0,0.0,0.0
1997.0,COL,555,555,4,6,-2,0.010810811,0.0072072074,-0.0036036037
1998.0,COL,924,924,25,11,14,0.011904762,0.027056277,0.015151516
1999.0,COL,1348,1348,32,30,2,0.022255193,0.023738872,0.0014836795
2000.0,COL,1789,1789,36,41,-5,0.022917831,0.020122973,-0.0027948574
2001.0,COL,2188,2188,55,52,3,0.023765996,0.025137112,0.0013711152
2002.0,COL,2733,2733,97,82,15,0.03000366,0.035492133,0.0054884744
2003.0,COL,3322,3322,116,86,30,0.02588802,0.034918725,0.009030704
2004.0,COL,4000,4000,85,82,3,0.0205,0.02125,0.00075
2005.0,COL,4818,4818,118,102,16,0.02117061,0.02449149,0.00332088
2006.0,COL,6126,6126,133,115,18,0.018772446,0.02171074,0.0029382957
2007.0,COL,7471,7471,160,143,17,0.019140678,0.021416143,0.002275465
2008.0,COL,8842,8842,183,148,35,0.016738294,0.020696675,0.0039583803
2009.0,COL,10083,10083,168,182,-14,0.018050183,0.016661707,-0.0013884756
2010.0,COL,11598,11598,235,221,14,0.019055009,0.020262115,0.0012071047
2011.0,COL,13105,13105,262,249,13,0.019000381,0.01999237,0.0009919878
2012.0,COL,14602,14602,314,292,22,0.019997261,0.021503903,0.0015066429
2013.0,COL,16189,16189,330,304,26,0.018778183,0.020384211,0.0016060288
2014.0,COL,18302,18302,386,322,64,0.017593706,0.021090591,0.0034968855
2015.0,COL,20303,20303,463,353,110,0.017386593,0.022804512,0.0054179183
2016.0,COL,22280,22280,462,411,51,0.018447038,0.020736085,0.0022890484
2017.0,COL,24159,24159,564,408,156,0.016888116,0.023345336,0.0064572208
2018.0,COL,25945,25945,583,496,87,0.019117363,0.02247061,0.0033532472
2019.0,COL,26458,26458,560,563,-3,0.021279009,0.02116562,-0.00011338726
2020.0,COL,25350,25350,512,546,-34,0.02153846,0.020197239,-0.0013412229
2021.0,COL,23327,23327,332,415,-83,0.017790543,0.014232434,-0.0035581086
2000.0,COM,4,4,0,0,0,0.0,0.0,0.0
2001.0,COM,5,5,0,0,0,0.0,0.0,0.0
2003.0,COM,2,2,0,1,-1,0.5,0.0,-0.5
2009.0,COM,10,10,0,0,0,0.0,0.0,0.0
2010.0,COM,13,13,2,0,2,0.0,0.15384616,0.15384616
2011.0,COM,12,12,0,1,-1,0.083333336,0.0,-0.083333336
2012.0,COM,13,13,1,1,0,0.07692308,0.07692308,0.0
2014.0,COM,17,17,0,0,0,0.0,0.0,0.0
2015.0,COM,14,14,0,0,0,0.0,0.0,0.0
2016.0,COM,22,22,1,0,1,0.0,0.045454547,0.045454547
2017.0,COM,24,24,0,0,0,0.0,0.0,0.0
2018.0,COM,22,22,0,1,-1,0.045454547,0.0,-0.045454547
2019.0,COM,23,23,2,0,2,0.0,0.08695652,0.08695652
2020.0,COM,26,26,3,1,2,0.03846154,0.115384616,0.07692308
2003.0,CPV,2,2,0,0,0,0.0,0.0,0.0
2007.0,CPV,9,9,0,0,0,0.0,0.0,0.0
2008.0,CPV,14,14,2,0,2,0.0,0.14285715,0.14285715
2009.0,CPV,14,14,0,0,0,0.0,0.0,0.0
2010.0,CPV,17,17,0,0,0,0.0,0.0,0.0
2011.0,CPV,23,23,1,0,1,0.0,0.04347826,0.04347826
2012.0,CPV,32,32,1,0,1,0.0,0.03125,0.03125
2013.0,CPV,46,46,3,2,1,0.04347826,0.06521739,0.02173913
2014.0,CPV,49,49,0,2,-2,0.040816326,0.0,-0.040816326
2015.0,CPV,58,58,5,4,1,0.06896552,0.0862069,0.01724138
2016.0,CPV,66,66,6,3,3,0.045454547,0.09090909,0.045454547
2017.0,CPV,71,71,1,0,1,0.0,0.014084507,0.014084507
2018.0,CPV,81,81,4,1,3,0.012345679,0.049382716,0.037037037
2019.0,CPV,84,84,4,4,0,0.04761905,0.04761905,0.0
2020.0,CPV,79,79,3,2,1,0.025316456,0.03797468,0.012658228
2021.0,CPV,74,74,4,4,0,0.054054055,0.054054055,0.0
1996.0,CRI,131,131,0,0,0,0.0,0.0,0.0
1997.0,CRI,174,174,0,1,-1,0.0057471264,0.0,-0.0057471264
1998.0,CRI,235,235,3,4,-1,0.017021276,0.012765957,-0.004255319
1999.0,CRI,313,313,7,8,-1,0.025559105,0.022364218,-0.0031948881
2000.0,CRI,397,397,5,5,0,0.012594459,0.012594459,0.0
2001.0,CRI,440,440,9,14,-5,0.03181818,0.020454545,-0.011363637
2002.0,CRI,524,524,24,10,14,0.01908397,0.045801528,0.026717557
2003.0,CRI,595,595,30,22,8,0.03697479,0.05042017,0.013445378
2004.0,CRI,663,663,26,19,7,0.028657617,0.039215688,0.01055807
2005.0,CRI,723,723,19,12,7,0.016597511,0.026279392,0.009681881
2006.0,CRI,801,801,20,20,0,0.02496879,0.02496879,0.0
2007.0,CRI,860,860,27,20,7,0.023255814,0.03139535,0.008139535
2008.0,CRI,915,915,31,25,6,0.027322404,0.033879783,0.006557377
2009.0,CRI,974,974,24,37,-13,0.03798768,0.024640657,-0.013347022
2010.0,CRI,1025,1025,25,39,-14,0.03804878,0.024390243,-0.013658537
2011.0,CRI,1069,1069,28,24,4,0.022450889,0.026192704,0.0037418148
2012.0,CRI,1152,1152,38,46,-8,0.039930556,0.032986112,-0.0069444445
2013.0,CRI,1203,1203,42,34,8,0.028262677,0.034912717,0.006650042
2014.0,CRI,1335,1335,49,32,17,0.023970038,0.03670412,0.0127340825
2015.0,CRI,1481,1481,52,44,8,0.029709656,0.035111412,0.0054017557
2016.0,CRI,1578,1578,62,54,8,0.03422053,0.039290242,0.0050697085
2017.0,CRI,1696,1696,57,44,13,0.025943397,0.03360849,0.0076650945
2018.0,CRI,1847,1847,67,51,16,0.027612343,0.03627504,0.008662696
2019.0,CRI,1877,1877,74,58,16,0.030900372,0.039424613,0.008524241
2020.0,CRI,1798,1798,66,70,-4,0.03893215,0.036707453,-0.002224694
2021.0,CRI,1695,1695,41,43,-2,0.025368731,0.02418879,-0.001179941
1996.0,CUB,1357,1357,0,0,0,0.0,0.0,0.0
1997.0,CUB,1890,1890,7,5,2,0.0026455026,0.0037037036,0.0010582011
1998.0,CUB,2692,2692,14,12,2,0.004457652,0.005200594,0.00074294204
1999.0,CUB,3310,3310,12,31,-19,0.009365559,0.0036253775,-0.005740181
2000.0,CUB,3756,3756,19,45,-26,0.011980831,0.005058573,-0.0069222576
2001.0,CUB,4165,4165,43,57,-14,0.013685474,0.01032413,-0.0033613446
2002.0,CUB,4590,4590,70,69,1,0.01503268,0.015250545,0.00021786493
2003.0,CUB,4800,4800,45,83,-38,0.017291667,0.009375,-0.007916667
2004.0,CUB,5243,5243,59,59,0,0.011253099,0.011253099,0.0
2005.0,CUB,5513,5513,50,71,-21,0.012878651,0.009069473,-0.0038091782
2006.0,CUB,5934,5934,45,72,-27,0.012133468,0.0075834175,-0.0045500505
2007.0,CUB,6472,6472,42,88,-46,0.013597033,0.0064894934,-0.00710754
2008.0,CUB,6928,6928,59,77,-18,0.011114319,0.008516166,-0.0025981525
2009.0,CUB,7298,7298,57,86,-29,0.011784051,0.007810359,-0.0039736913
2010.0,CUB,7615,7615,56,84,-28,0.01103086,0.007353907,-0.0036769535
2011.0,CUB,7850,7850,48,102,-54,0.012993631,0.0061146496,-0.006878981
2012.0,CUB,8035,8035,39,104,-65,0.012943373,0.0048537645,-0.008089608
2013.0,CUB,8052,8052,45,111,-66,0.013785395,0.0055886735,-0.008196721
2014.0,CUB,7726,7726,44,138,-94,0.017861765,0.0056950557,-0.01216671
2015.0,CUB,7457,7457,47,166,-119,0.022260962,0.006302803,-0.01595816
2016.0,CUB,7164,7164,49,165,-116,0.023031825,0.0068397545,-0.016192071
2017.0,CUB,6786,6786,43,169,-126,0.024904214,0.0063365754,-0.018567638
2018.0,CUB,6622,6622,46,175,-129,0.026427062,0.006946542,-0.019480519
2019.0,CUB,6269,6269,40,144,-104,0.02297017,0.006380603,-0.016589567
2020.0,CUB,5645,5645,39,136,-97,0.024092117,0.006908769,-0.017183349
2021.0,CUB,4887,4887,32,48,-16,0.009821977,0.0065479847,-0.0032739923
1996.0,CUW,1,1,0,0,0,0.0,0.0,0.0
2001.0,CUW,3,3,0,0,0,0.0,0.0,0.0
2003.0,CUW,2,2,0,0,0,0.0,0.0,0.0
1996.0,CYP,75,75,0,0,0,0.0,0.0,0.0
1997.0,CYP,94,94,1,2,-1,0.021276595,0.010638298,-0.010638298
1998.0,CYP,171,171,8,4,4,0.023391813,0.046783626,0.023391813
1999.0,CYP,225,225,15,3,12,0.013333334,0.06666667,0.053333335
2000.0,CYP,283,283,8,12,-4,0.042402826,0.028268551,-0.014134276
2001.0,CYP,343,343,16,12,4,0.034985423,0.046647232,0.011661808
2002.0,CYP,424,424,24,12,12,0.028301887,0.056603774,0.028301887
2003.0,CYP,463,463,24,18,6,0.03887689,0.051835854,0.012958963
2004.0,CYP,539,539,30,16,14,0.029684601,0.055658627,0.025974026
2005.0,CYP,638,638,49,13,36,0.020376176,0.07680251,0.05642633
2006.0,CYP,751,751,46,23,23,0.030625831,0.061251663,0.030625831
2007.0,CYP,926,926,76,19,57,0.020518359,0.082073435,0.061555076
2008.0,CYP,1050,1050,62,30,32,0.028571429,0.05904762,0.03047619
2009.0,CYP,1194,1194,84,29,55,0.024288107,0.07035176,0.04606365
2010.0,CYP,1382,1382,100,32,68,0.023154847,0.0723589,0.04920405
2011.0,CYP,1594,1594,107,38,69,0.023839397,0.06712673,0.043287326
2012.0,CYP,1754,1754,116,48,68,0.02736602,0.06613455,0.03876853
2013.0,CYP,1900,1900,129,54,75,0.028421052,0.067894734,0.039473683
2014.0,CYP,2084,2084,123,75,48,0.035988484,0.05902111,0.02303263
2015.0,CYP,2305,2305,125,79,46,0.03427332,0.054229934,0.019956617
2016.0,CYP,2522,2522,172,97,75,0.03846154,0.06819984,0.029738303
2017.0,CYP,2717,2717,179,102,77,0.037541404,0.06588148,0.02834008
2018.0,CYP,2885,2885,189,125,64,0.043327555,0.065511264,0.022183709
2019.0,CYP,3037,3037,221,122,99,0.04017122,0.07276918,0.03259796
2020.0,CYP,3025,3025,236,121,115,0.04,0.07801653,0.038016528
2021.0,CYP,2869,2869,153,117,36,0.04078076,0.053328685,0.012547926
1996.0,CZE,4436,4436,0,0,0,0.0,0.0,0.0
1997.0,CZE,5566,5566,54,35,19,0.0062881783,0.0097017605,0.0034135825
1998.0,CZE,8069,8069,65,61,4,0.007559797,0.008055521,0.0004957244
1999.0,CZE,10369,10369,88,103,-15,0.009933456,0.008486836,-0.0014466197
2000.0,CZE,12203,12203,79,95,-16,0.007784971,0.006473818,-0.0013111529
2001.0,CZE,13863,13863,127,195,-68,0.014066219,0.0091610765,-0.0049051433
2002.0,CZE,15717,15717,208,237,-29,0.015079213,0.013234078,-0.0018451358
2003.0,CZE,17146,17146,240,225,15,0.013122594,0.013997434,0.0008748396
2004.0,CZE,18693,18693,190,200,-10,0.010699192,0.010164233,-0.0005349596
2005.0,CZE,20360,20360,183,207,-24,0.010166994,0.008988212,-0.001178782
2006.0,CZE,21842,21842,207,243,-36,0.011125355,0.009477154,-0.0016482007
2007.0,CZE,23447,23447,210,220,-10,0.0093828635,0.00895637,-0.0004264938
2008.0,CZE,25273,25273,258,229,29,0.009061053,0.010208523,0.0011474696
2009.0,CZE,27214,27214,255,221,34,0.00812082,0.009370177,0.0012493569
2010.0,CZE,28916,28916,263,234,29,0.008092405,0.00909531,0.001002905
2011.0,CZE,30523,30523,276,296,-20,0.009697605,0.009042362,-0.0006552436
2012.0,CZE,32579,32579,280,282,-2,0.008655882,0.008594493,-6.138924e-05
2013.0,CZE,34435,34435,384,287,97,0.008334544,0.011151445,0.0028169013
2014.0,CZE,36203,36203,470,312,158,0.008618071,0.01298235,0.004364279
2015.0,CZE,37697,37697,536,338,198,0.008966231,0.014218638,0.0052524074
2016.0,CZE,38823,38823,490,424,66,0.010921361,0.012621384,0.0017000232
2017.0,CZE,39798,39798,458,436,22,0.010955324,0.011508116,0.0005527916
2018.0,CZE,40543,40543,612,443,169,0.01092667,0.015095084,0.0041684136
2019.0,CZE,40403,40403,662,451,211,0.011162537,0.016384922,0.0052223844
2020.0,CZE,38566,38566,668,450,218,0.011668309,0.017320957,0.0056526475
2021.0,CZE,35945,35945,492,352,140,0.009792739,0.013687578,0.0038948394
1996.0,DEU,49505,49505,0,0,0,0.0,0.0,0.0
1997.0,DEU,60220,60220,695,707,-12,0.011740286,0.011541016,-0.00019926934
1998.0,DEU,89543,89543,1109,1148,-39,0.012820656,0.012385111,-0.00043554493
1999.0,DEU,116217,116217,1551,1893,-342,0.016288495,0.013345724,-0.002942771
2000.0,DEU,135144,135144,1380,1796,-416,0.013289528,0.01021133,-0.003078198
2001.0,DEU,151528,151528,3019,3111,-92,0.020530859,0.019923711,-0.0006071485
2002.0,DEU,168843,168843,4027,4194,-167,0.024839643,0.02385056,-0.0009890845
2003.0,DEU,184525,184525,4144,4183,-39,0.022669015,0.022457661,-0.00021135347
2004.0,DEU,195820,195820,3635,3959,-324,0.020217547,0.018562965,-0.0016545807
2005.0,DEU,205700,205700,3669,4201,-532,0.020422947,0.017836655,-0.0025862907
2006.0,DEU,215276,215276,3685,4665,-980,0.021669857,0.01711756,-0.0045522954
2007.0,DEU,225780,225780,3938,4871,-933,0.021574099,0.017441757,-0.004132341
2008.0,DEU,235687,235687,4111,5155,-1044,0.021872228,0.017442625,-0.0044296035
2009.0,DEU,245719,245719,4679,5179,-500,0.021076921,0.019042077,-0.0020348446
2010.0,DEU,256226,256226,4972,5139,-167,0.020056512,0.019404745,-0.00065176835
2011.0,DEU,267199,267199,5254,5703,-449,0.021343643,0.019663246,-0.0016803956
2012.0,DEU,278362,278362,5570,5689,-119,0.020437416,0.020009914,-0.00042750087
2013.0,DEU,289952,289952,5792,5867,-75,0.020234384,0.01997572,-0.0002586635
2014.0,DEU,300363,300363,6253,6129,124,0.02040531,0.020818144,0.00041283382
2015.0,DEU,309484,309484,6227,6297,-70,0.02034677,0.020120587,-0.00022618294
2016.0,DEU,317403,317403,6524,6547,-23,0.020626774,0.020554312,-7.246308e-05
2017.0,DEU,323337,323337,6601,6563,38,0.020297708,0.020415232,0.00011752444
2018.0,DEU,327007,327007,6835,6727,108,0.020571426,0.020901693,0.00033026817
2019.0,DEU,322651,322651,6882,6609,273,0.020483432,0.021329548,0.00084611546
2020.0,DEU,303014,303014,6775,6376,399,0.021041932,0.022358702,0.0013167708
2021.0,DEU,276943,276943,5070,4921,149,0.017769,0.018307017,0.00053801684
2022.0,DEU,0,0,2740,2668,72,,,
1996.0,DJI,4,4,0,0,0,0.0,0.0,0.0
1997.0,DJI,3,3,0,1,-1,0.33333334,0.0,-0.33333334
2001.0,DJI,6,6,1,0,1,0.0,0.16666667,0.16666667
2002.0,DJI,7,7,0,0,0,0.0,0.0,0.0
2007.0,DJI,7,7,1,1,0,0.14285715,0.14285715,0.0
2008.0,DJI,16,16,6,0,6,0.0,0.375,0.375
2010.0,DJI,30,30,6,7,-1,0.23333333,0.2,-0.033333335
2011.0,DJI,37,37,5,1,4,0.027027028,0.13513513,0.10810811
2012.0,DJI,45,45,4,3,1,0.06666667,0.08888889,0.022222223
2013.0,DJI,41,41,1,4,-3,0.09756097,0.024390243,-0.07317073
2014.0,DJI,43,43,6,4,2,0.093023255,0.13953489,0.046511628
2015.0,DJI,44,44,3,0,3,0.0,0.06818182,0.06818182
2016.0,DJI,47,47,6,1,5,0.021276595,0.12765957,0.10638298
2017.0,DJI,47,47,1,1,0,0.021276595,0.021276595,0.0
2018.0,DJI,47,47,4,3,1,0.06382979,0.08510638,0.021276595
2019.0,DJI,44,44,3,3,0,0.06818182,0.06818182,0.0
2020.0,DJI,46,46,2,0,2,0.0,0.04347826,0.04347826
2021.0,DJI,38,38,0,2,-2,0.05263158,0.0,-0.05263158
2001.0,DMA,2,2,0,0,0,0.0,0.0,0.0
2006.0,DMA,3,3,0,0,0,0.0,0.0,0.0
2014.0,DMA,4,4,0,0,0,0.0,0.0,0.0
2015.0,DMA,3,3,0,1,-1,0.33333334,0.0,-0.33333334
2017.0,DMA,4,4,1,0,1,0.0,0.25,0.25
2020.0,DMA,7,7,2,1,1,0.14285715,0.2857143,0.14285715
1996.0,DNK,4083,4083,0,0,0,0.0,0.0,0.0
1997.0,DNK,4992,4992,100,86,14,0.017227564,0.020032052,0.0028044872
1998.0,DNK,8595,8595,140,125,15,0.01454334,0.01628854,0.0017452007
1999.0,DNK,11643,11643,213,195,18,0.01674826,0.018294254,0.0015459933
2000.0,DNK,13765,13765,168,160,8,0.011623683,0.012204868,0.00058118417
2001.0,DNK,15650,15650,387,351,36,0.022428116,0.024728434,0.0023003195
2002.0,DNK,17533,17533,523,517,6,0.029487252,0.029829465,0.00034221183
2003.0,DNK,18957,18957,486,494,-8,0.026058976,0.025636967,-0.0004220077
2004.0,DNK,19988,19988,408,442,-34,0.022113267,0.020412248,-0.0017010206
2005.0,DNK,20983,20983,398,416,-18,0.019825574,0.018967737,-0.0008578373
2006.0,DNK,22307,22307,481,452,29,0.020262698,0.021562738,0.0013000404
2007.0,DNK,23625,23625,485,425,60,0.017989418,0.0205291,0.0025396824
2008.0,DNK,25175,25175,596,485,111,0.019265143,0.02367428,0.0044091363
2009.0,DNK,27082,27082,699,464,235,0.01713315,0.0258105,0.00867735
2010.0,DNK,29044,29044,694,481,213,0.01656108,0.023894781,0.0073337005
2011.0,DNK,31061,31061,759,527,232,0.016966615,0.024435788,0.0074691735
2012.0,DNK,33387,33387,725,614,111,0.018390391,0.02171504,0.0033246474
2013.0,DNK,35500,35500,823,664,159,0.018704226,0.023183098,0.004478873
2014.0,DNK,37407,37407,921,752,169,0.02010319,0.02462106,0.004517871
2015.0,DNK,39212,39212,1035,774,261,0.019738855,0.026394982,0.0066561257
2016.0,DNK,40855,40855,1041,908,133,0.022224942,0.025480358,0.0032554155
2017.0,DNK,42117,42117,1117,922,195,0.021891398,0.026521357,0.0046299594
2018.0,DNK,43066,43066,1152,975,177,0.02263967,0.02674964,0.0041099708
2019.0,DNK,42987,42987,1183,1053,130,0.024495779,0.027519949,0.0030241702
2020.0,DNK,40969,40969,1182,1021,161,0.024921281,0.028851083,0.0039298004
2021.0,DNK,38158,38158,932,809,123,0.02120132,0.02442476,0.0032234394
1996.0,DOM,11,11,0,0,0,0.0,0.0,0.0
1997.0,DOM,13,13,0,0,0,0.0,0.0,0.0
1998.0,DOM,18,18,0,1,-1,0.055555556,0.0,-0.055555556
1999.0,DOM,20,20,0,0,0,0.0,0.0,0.0
2000.0,DOM,22,22,2,2,0,0.09090909,0.09090909,0.0
2001.0,DOM,27,27,1,1,0,0.037037037,0.037037037,0.0
2002.0,DOM,31,31,1,1,0,0.032258064,0.032258064,0.0
2003.0,DOM,33,33,1,3,-2,0.09090909,0.030303031,-0.060606062
2004.0,DOM,43,43,1,0,1,0.0,0.023255814,0.023255814
2005.0,DOM,57,57,6,2,4,0.03508772,0.10526316,0.07017544
2006.0,DOM,71,71,3,2,1,0.028169014,0.04225352,0.014084507
2007.0,DOM,75,75,3,5,-2,0.06666667,0.04,-0.026666667
2008.0,DOM,81,81,4,4,0,0.049382716,0.049382716,0.0
2009.0,DOM,85,85,3,5,-2,0.05882353,0.03529412,-0.023529412
2010.0,DOM,97,97,4,6,-2,0.06185567,0.041237112,-0.020618556
2011.0,DOM,112,112,10,4,6,0.035714287,0.08928572,0.05357143
2012.0,DOM,136,136,11,2,9,0.014705882,0.080882356,0.066176474
2013.0,DOM,160,160,11,4,7,0.025,0.06875,0.04375
2014.0,DOM,186,186,10,1,9,0.005376344,0.05376344,0.048387095
2015.0,DOM,203,203,8,6,2,0.02955665,0.039408866,0.009852217
2016.0,DOM,235,235,13,8,5,0.034042552,0.05531915,0.021276595
2017.0,DOM,253,253,15,9,6,0.03557312,0.05928854,0.023715414
2018.0,DOM,279,279,18,8,10,0.028673835,0.06451613,0.035842296
2019.0,DOM,312,312,24,6,18,0.01923077,0.07692308,0.057692308
2020.0,DOM,299,299,19,14,5,0.04682274,0.06354515,0.016722407
2021.0,DOM,276,276,13,15,-2,0.054347824,0.04710145,-0.007246377
1996.0,DZA,264,264,0,0,0,0.0,0.0,0.0
1997.0,DZA,357,357,3,4,-1,0.011204482,0.008403362,-0.0028011205
1998.0,DZA,623,623,7,8,-1,0.0128410915,0.011235955,-0.0016051364
1999.0,DZA,985,985,17,15,2,0.015228426,0.017258883,0.002030457
2000.0,DZA,1317,1317,6,17,-11,0.012908124,0.004555809,-0.008352316
2001.0,DZA,1744,1744,37,27,10,0.015481652,0.021215597,0.005733945
2002.0,DZA,2220,2220,40,42,-2,0.018918918,0.018018018,-0.0009009009
2003.0,DZA,2720,2720,48,45,3,0.016544119,0.01764706,0.0011029412
2004.0,DZA,3399,3399,49,31,18,0.009120329,0.0144160045,0.0052956752
2005.0,DZA,4055,4055,37,46,-9,0.011344019,0.009124538,-0.002219482
2006.0,DZA,4876,4876,56,37,19,0.007588187,0.011484823,0.0038966367
2007.0,DZA,5896,5896,66,40,26,0.0067842607,0.01119403,0.0044097695
2008.0,DZA,6721,6721,67,46,21,0.0068442198,0.009968755,0.003124535
2009.0,DZA,7601,7601,86,72,14,0.009472438,0.011314301,0.0018418629
2010.0,DZA,8588,8588,96,64,32,0.007452259,0.011178388,0.0037261294
2011.0,DZA,9651,9651,131,60,71,0.006216972,0.013573723,0.007356751
2012.0,DZA,10844,10844,127,68,59,0.006270749,0.011711545,0.0054407967
2013.0,DZA,12260,12260,111,57,54,0.004649266,0.009053834,0.0044045676
2014.0,DZA,13824,13824,163,55,108,0.003978588,0.011791088,0.0078125
2015.0,DZA,15262,15262,140,68,72,0.0044555105,0.00917311,0.004717599
2016.0,DZA,16647,16647,148,74,74,0.0044452455,0.008890491,0.0044452455
2017.0,DZA,17745,17745,139,78,61,0.0043956046,0.007833192,0.003437588
2018.0,DZA,18588,18588,155,125,30,0.006724769,0.008338713,0.0016139445
2019.0,DZA,18876,18876,193,114,79,0.006039415,0.010224624,0.0041852086
2020.0,DZA,18306,18306,145,123,22,0.0067191087,0.0079209,0.0012017918
2021.0,DZA,16971,16971,81,75,6,0.0044193035,0.004772848,0.00035354428
2022.0,DZA,0,0,37,62,-25,,,
1996.0,ECU,41,41,0,0,0,0.0,0.0,0.0
1997.0,ECU,56,56,2,0,2,0.0,0.035714287,0.035714287
1998.0,ECU,91,91,1,4,-3,0.043956045,0.010989011,-0.032967035
1999.0,ECU,126,126,1,4,-3,0.031746034,0.007936508,-0.023809524
2000.0,ECU,183,183,4,2,2,0.010928961,0.021857923,0.010928961
2001.0,ECU,257,257,12,9,3,0.035019454,0.046692606,0.0116731515
2002.0,ECU,338,338,17,9,8,0.026627218,0.05029586,0.02366864
2003.0,ECU,389,389,21,14,7,0.035989717,0.053984575,0.017994858
2004.0,ECU,457,457,12,14,-2,0.030634573,0.026258206,-0.0043763677
2005.0,ECU,517,517,14,21,-7,0.040618956,0.027079303,-0.013539651
2006.0,ECU,551,551,18,24,-6,0.043557167,0.032667875,-0.010889292
2007.0,ECU,624,624,21,27,-6,0.043269232,0.033653848,-0.009615385
2008.0,ECU,721,721,31,22,9,0.030513177,0.04299584,0.012482663
2009.0,ECU,781,781,30,23,7,0.029449424,0.03841229,0.008962868
2010.0,ECU,841,841,21,32,-11,0.03804994,0.024970273,-0.013079667
2011.0,ECU,981,981,48,29,19,0.029561672,0.048929665,0.019367991
2012.0,ECU,1179,1179,43,39,4,0.03307888,0.036471587,0.0033927057
2013.0,ECU,1518,1518,92,56,36,0.036890645,0.060606062,0.023715414
2014.0,ECU,2097,2097,136,28,108,0.013352408,0.064854555,0.051502146
2015.0,ECU,2999,2999,199,49,150,0.01633878,0.06635545,0.05001667
2016.0,ECU,3900,3900,224,85,139,0.021794872,0.057435896,0.035641026
2017.0,ECU,4855,4855,261,101,160,0.020803295,0.053759012,0.032955717
2018.0,ECU,5658,5658,276,146,130,0.025804171,0.048780486,0.022976317
2019.0,ECU,6078,6078,261,140,121,0.023033893,0.042941757,0.019907864
2020.0,ECU,5980,5980,236,172,64,0.028762542,0.039464884,0.010702341
2021.0,ECU,5605,5605,136,154,-18,0.027475469,0.02426405,-0.0032114184
2022.0,ECU,0,0,67,64,3,,,
1996.0,EGY,1930,1930,0,0,0,0.0,0.0,0.0
1997.0,EGY,2314,2314,22,16,6,0.006914434,0.009507347,0.0025929126
1998.0,EGY,4008,4008,30,30,0,0.0074850298,0.0074850298,0.0
1999.0,EGY,5533,5533,57,40,17,0.007229351,0.010301826,0.0030724742
2000.0,EGY,6768,6768,69,58,11,0.00856974,0.0101950355,0.0016252955
2001.0,EGY,7957,7957,125,138,-13,0.01734322,0.015709437,-0.0016337816
2002.0,EGY,9217,9217,187,156,31,0.016925247,0.020288598,0.0033633504
2003.0,EGY,10256,10256,227,162,65,0.015795631,0.022133386,0.0063377535
2004.0,EGY,11334,11334,203,174,29,0.015352038,0.017910711,0.002558673
2005.0,EGY,12380,12380,220,182,38,0.014701131,0.017770598,0.003069467
2006.0,EGY,13684,13684,272,203,69,0.014834844,0.019877229,0.0050423853
2007.0,EGY,15909,15909,340,272,68,0.01709724,0.02137155,0.00427431
2008.0,EGY,18389,18389,357,262,95,0.014247648,0.01941378,0.005166132
2009.0,EGY,21442,21442,407,400,7,0.018654976,0.018981438,0.0003264621
2010.0,EGY,24470,24470,444,396,48,0.016183082,0.018144667,0.0019615856
2011.0,EGY,27333,27333,508,437,71,0.015988,0.018585593,0.0025975925
2012.0,EGY,29789,29789,558,455,103,0.015274094,0.018731747,0.0034576522
2013.0,EGY,32475,32475,578,475,103,0.014626636,0.017798306,0.0031716705
2014.0,EGY,35665,35665,651,467,184,0.013094069,0.018253189,0.0051591196
2015.0,EGY,38065,38065,670,486,184,0.012767634,0.017601471,0.004833837
2016.0,EGY,41242,41242,645,513,132,0.012438776,0.015639396,0.0032006206
2017.0,EGY,44697,44697,613,560,53,0.012528805,0.013714567,0.0011857619
2018.0,EGY,48409,48409,691,616,75,0.012724906,0.014274205,0.0015492986
2019.0,EGY,50442,50442,755,710,45,0.014075572,0.014967686,0.0008921137
2020.0,EGY,49670,49670,792,726,66,0.014616469,0.015945239,0.0013287698
2021.0,EGY,47189,47189,656,699,-43,0.014812774,0.013901545,-0.0009112293
2022.0,EGY,0,0,320,413,-93,,,
1996.0,ERI,5,5,0,0,0,0.0,0.0,0.0
1997.0,ERI,6,6,0,0,0,0.0,0.0,0.0
1998.0,ERI,11,11,1,0,1,0.0,0.09090909,0.09090909
1999.0,ERI,11,11,0,2,-2,0.18181819,0.0,-0.18181819
2000.0,ERI,16,16,1,0,1,0.0,0.0625,0.0625
2001.0,ERI,25,25,1,2,-1,0.08,0.04,-0.04
2002.0,ERI,30,30,4,2,2,0.06666667,0.13333334,0.06666667
2003.0,ERI,38,38,2,0,2,0.0,0.05263158,0.05263158
2004.0,ERI,60,60,5,2,3,0.033333335,0.083333336,0.05
2005.0,ERI,62,62,1,4,-3,0.06451613,0.016129032,-0.048387095
2006.0,ERI,64,64,4,3,1,0.046875,0.0625,0.015625
2007.0,ERI,57,57,3,5,-2,0.0877193,0.05263158,-0.03508772
2008.0,ERI,64,64,5,2,3,0.03125,0.078125,0.046875
2009.0,ERI,60,60,5,7,-2,0.11666667,0.083333336,-0.033333335
2010.0,ERI,50,50,3,4,-1,0.08,0.06,-0.02
2011.0,ERI,51,51,4,8,-4,0.15686275,0.078431375,-0.078431375
2012.0,ERI,48,48,3,7,-4,0.14583333,0.0625,-0.083333336
2013.0,ERI,47,47,1,6,-5,0.12765957,0.021276595,-0.10638298
2014.0,ERI,42,42,2,3,-1,0.071428575,0.04761905,-0.023809524
2015.0,ERI,62,62,6,1,5,0.016129032,0.09677419,0.08064516
2016.0,ERI,72,72,3,4,-1,0.055555556,0.041666668,-0.013888889
2017.0,ERI,90,90,7,3,4,0.033333335,0.07777778,0.044444446
2018.0,ERI,93,93,2,8,-6,0.086021505,0.021505376,-0.06451613
2019.0,ERI,94,94,2,6,-4,0.06382979,0.021276595,-0.04255319
2020.0,ERI,91,91,2,7,-5,0.07692308,0.021978023,-0.054945055
2021.0,ERI,73,73,0,7,-7,0.09589041,0.0,-0.09589041
1996.0,ESP,25203,25203,0,0,0,0.0,0.0,0.0
1997.0,ESP,32096,32096,179,180,-1,0.0056081754,0.005577019,-3.115653e-05
1998.0,ESP,48007,48007,300,331,-31,0.006894828,0.006249089,-0.00064573914
1999.0,ESP,62411,62411,463,525,-62,0.008411978,0.007418564,-0.0009934147
2000.0,ESP,74238,74238,483,498,-15,0.006708155,0.006506102,-0.00020205286
2001.0,ESP,85095,85095,893,950,-57,0.011163993,0.010494154,-0.0006698396
2002.0,ESP,96095,96095,1201,1216,-15,0.012654144,0.012498049,-0.00015609553
2003.0,ESP,105197,105197,1188,1251,-63,0.011891974,0.011293097,-0.0005988764
2004.0,ESP,114435,114435,1158,1082,76,0.009455149,0.010119282,0.0006641325
2005.0,ESP,122761,122761,1207,1133,74,0.009229315,0.009832113,0.0006027973
2006.0,ESP,131822,131822,1310,1223,87,0.009277662,0.009937643,0.00065998087
2007.0,ESP,140811,140811,1548,1326,222,0.009416878,0.010993459,0.0015765814
2008.0,ESP,149588,149588,1710,1546,164,0.010335053,0.011431398,0.0010963447
2009.0,ESP,158329,158329,1875,1775,100,0.011210833,0.01184243,0.00063159625
2010.0,ESP,167434,167434,2213,1865,348,0.011138718,0.013217148,0.002078431
2011.0,ESP,175189,175189,2092,2180,-88,0.012443704,0.011941389,-0.00050231465
2012.0,ESP,182854,182854,2038,2396,-358,0.01310335,0.011145504,-0.001957846
2013.0,ESP,190243,190243,1945,2807,-862,0.014754813,0.010223767,-0.0045310473
2014.0,ESP,196506,196506,1932,3373,-1441,0.017164871,0.009831761,-0.0073331096
2015.0,ESP,201643,201643,1937,3650,-1713,0.018101297,0.009606086,-0.008495212
2016.0,ESP,207238,207238,2210,3573,-1363,0.017241046,0.010664067,-0.006576979
2017.0,ESP,212531,212531,2374,3487,-1113,0.016407019,0.011170135,-0.005236883
2018.0,ESP,218599,218599,2669,3462,-793,0.015837219,0.012209571,-0.003627647
2019.0,ESP,219396,219396,2784,3235,-451,0.014745027,0.012689384,-0.0020556436
2020.0,ESP,210164,210164,2932,3019,-87,0.014364972,0.01395101,-0.00041396244
2021.0,ESP,195898,195898,2247,2277,-30,0.011623396,0.0114702545,-0.00015314092
2022.0,ESP,0,0,1301,1197,104,,,
1996.0,EST,341,341,0,0,0,0.0,0.0,0.0
1997.0,EST,489,489,2,5,-3,0.010224949,0.0040899795,-0.006134969
1998.0,EST,790,790,6,5,1,0.006329114,0.0075949365,0.0012658228
1999.0,EST,1074,1074,10,10,0,0.009310987,0.009310987,0.0
2000.0,EST,1318,1318,19,6,13,0.0045523522,0.014415782,0.00986343
2001.0,EST,1588,1588,25,18,7,0.0113350125,0.015743073,0.0044080606
2002.0,EST,1813,1813,38,29,9,0.015995588,0.020959735,0.0049641477
2003.0,EST,2028,2028,42,20,22,0.009861933,0.020710059,0.010848126
2004.0,EST,2269,2269,34,28,6,0.012340238,0.014984575,0.0026443368
2005.0,EST,2593,2593,32,22,10,0.008484381,0.012340918,0.003856537
2006.0,EST,2881,2881,29,20,9,0.0069420342,0.0100659495,0.0031239153
2007.0,EST,3119,3119,28,32,-4,0.010259699,0.008977236,-0.0012824624
2008.0,EST,3412,3412,55,39,16,0.011430246,0.016119579,0.0046893316
2009.0,EST,3750,3750,41,25,16,0.006666667,0.010933333,0.0042666667
2010.0,EST,4025,4025,56,45,11,0.011180124,0.013913044,0.0027329193
2011.0,EST,4296,4296,62,30,32,0.00698324,0.01443203,0.0074487897
2012.0,EST,4589,4589,66,45,21,0.009806058,0.014382218,0.0045761606
2013.0,EST,4790,4790,63,41,22,0.008559499,0.013152401,0.004592902
2014.0,EST,4998,4998,73,60,13,0.012004802,0.0146058425,0.0026010405
2015.0,EST,5114,5114,51,85,-34,0.01662104,0.0099726245,-0.006648416
2016.0,EST,5200,5200,76,86,-10,0.016538462,0.014615385,-0.0019230769
2017.0,EST,5247,5247,76,81,-5,0.0154373925,0.014484467,-0.0009529255
2018.0,EST,5343,5343,104,90,14,0.01684447,0.01946472,0.0026202507
2019.0,EST,5264,5264,129,88,41,0.016717326,0.024506079,0.0077887536
2020.0,EST,5036,5036,122,82,40,0.016282763,0.024225576,0.007942812
2021.0,EST,4680,4680,104,72,32,0.015384615,0.022222223,0.006837607
1996.0,ETH,55,55,0,0,0,0.0,0.0,0.0
1997.0,ETH,70,70,0,0,0,0.0,0.0,0.0
1998.0,ETH,202,202,4,2,2,0.00990099,0.01980198,0.00990099
1999.0,ETH,328,328,5,6,-1,0.018292682,0.015243903,-0.0030487804
2000.0,ETH,466,466,8,3,5,0.006437768,0.017167382,0.010729614
2001.0,ETH,569,569,14,20,-6,0.035149384,0.02460457,-0.010544815
2002.0,ETH,675,675,26,17,9,0.025185185,0.03851852,0.013333334
2003.0,ETH,761,761,36,42,-6,0.055190537,0.047306176,-0.007884363
2004.0,ETH,906,906,35,22,13,0.024282562,0.038631346,0.014348786
2005.0,ETH,1053,1053,43,30,13,0.02849003,0.04083571,0.012345679
2006.0,ETH,1225,1225,35,31,4,0.025306122,0.028571429,0.0032653061
2007.0,ETH,1411,1411,49,31,18,0.021970233,0.034727145,0.01275691
2008.0,ETH,1567,1567,39,44,-5,0.028079132,0.024888322,-0.0031908106
2009.0,ETH,1791,1791,44,60,-16,0.03350084,0.02456728,-0.008933556
2010.0,ETH,2153,2153,72,43,29,0.019972133,0.033441707,0.013469578
2011.0,ETH,2618,2618,78,60,18,0.022918258,0.029793736,0.0068754773
2012.0,ETH,3184,3184,91,70,21,0.021984925,0.028580401,0.0065954775
2013.0,ETH,3721,3721,69,87,-18,0.023380812,0.018543402,-0.004837409
2014.0,ETH,4340,4340,103,96,7,0.022119816,0.023732718,0.0016129032
2015.0,ETH,5157,5157,121,100,21,0.01939112,0.023463253,0.004072135
2016.0,ETH,6240,6240,185,108,77,0.017307693,0.029647436,0.012339744
2017.0,ETH,7441,7441,196,132,64,0.017739551,0.026340546,0.008600995
2018.0,ETH,9111,9111,252,172,80,0.01887828,0.027658874,0.008780595
2019.0,ETH,10461,10461,293,196,97,0.018736258,0.028008794,0.009272536
2020.0,ETH,10387,10387,267,194,73,0.018677192,0.025705209,0.007028016
2021.0,ETH,10009,10009,179,150,29,0.014986512,0.017883904,0.0028973923
2005.0,EUE,8,8,2,0,2,0.0,0.25,0.25
1996.0,FIN,4978,4978,0,0,0,0.0,0.0,0.0
1997.0,FIN,6348,6348,46,55,-9,0.008664146,0.007246377,-0.0014177694
1998.0,FIN,10014,10014,64,91,-27,0.009087278,0.0063910526,-0.0026962252
1999.0,FIN,13458,13458,132,133,-1,0.009882597,0.009808293,-7.4305244e-05
2000.0,FIN,15807,15807,119,133,-14,0.008413994,0.00752831,-0.0008856836
2001.0,FIN,17896,17896,270,235,35,0.013131426,0.0150871705,0.0019557443
2002.0,FIN,19826,19826,379,355,24,0.017905781,0.019116312,0.0012105316
2003.0,FIN,21392,21392,346,368,-22,0.017202692,0.01617427,-0.0010284218
2004.0,FIN,22659,22659,281,291,-10,0.012842579,0.012401253,-0.00044132574
2005.0,FIN,23711,23711,265,299,-34,0.012610181,0.011176247,-0.0014339336
2006.0,FIN,24824,24824,280,296,-16,0.011923945,0.011279407,-0.00064453756
2007.0,FIN,25900,25900,318,295,23,0.0113899615,0.012277992,0.00088803086
2008.0,FIN,26918,26918,345,355,-10,0.013188201,0.012816703,-0.00037149864
2009.0,FIN,27885,27885,324,370,-46,0.013268783,0.01161915,-0.0016496325
2010.0,FIN,28794,28794,398,406,-8,0.0141001595,0.013822324,-0.00027783567
2011.0,FIN,29694,29694,407,450,-43,0.015154577,0.013706473,-0.001448104
2012.0,FIN,30793,30793,485,452,33,0.014678661,0.015750334,0.0010716722
2013.0,FIN,31923,31923,476,435,41,0.013626539,0.01491088,0.0012843404
2014.0,FIN,32652,32652,519,497,22,0.01522112,0.015894892,0.0006737719
2015.0,FIN,33348,33348,551,564,-13,0.016912559,0.01652273,-0.00038982846
2016.0,FIN,34001,34001,576,656,-80,0.01929355,0.016940678,-0.002352872
2017.0,FIN,34392,34392,575,632,-57,0.018376367,0.016719004,-0.0016573622
2018.0,FIN,34672,34672,661,693,-32,0.01998731,0.019064374,-0.0009229349
2019.0,FIN,34326,34326,745,629,116,0.018324303,0.021703664,0.0033793626
2020.0,FIN,32785,32785,738,606,132,0.018484063,0.022510294,0.0040262314
2021.0,FIN,30569,30569,627,463,164,0.015146063,0.020510975,0.005364912
1996.0,FJI,15,15,0,0,0,0.0,0.0,0.0
1997.0,FJI,26,26,1,0,1,0.0,0.03846154,0.03846154
1998.0,FJI,38,38,2,0,2,0.0,0.05263158,0.05263158
1999.0,FJI,67,67,2,0,2,0.0,0.029850746,0.029850746
2000.0,FJI,93,93,4,3,1,0.032258064,0.043010753,0.010752688
2001.0,FJI,98,98,2,6,-4,0.06122449,0.020408163,-0.040816326
2002.0,FJI,122,122,6,10,-4,0.08196721,0.04918033,-0.032786883
2003.0,FJI,143,143,13,14,-1,0.0979021,0.09090909,-0.006993007
2004.0,FJI,168,168,17,13,4,0.077380955,0.10119048,0.023809524
2005.0,FJI,190,190,13,10,3,0.05263158,0.06842105,0.015789473
2006.0,FJI,210,210,11,6,5,0.028571429,0.052380953,0.023809524
2007.0,FJI,208,208,9,19,-10,0.09134615,0.043269232,-0.048076924
2008.0,FJI,216,216,9,13,-4,0.060185187,0.041666668,-0.018518519
2009.0,FJI,214,214,8,19,-11,0.088785045,0.037383176,-0.05140187
2010.0,FJI,223,223,15,22,-7,0.09865471,0.06726457,-0.031390134
2011.0,FJI,229,229,20,18,2,0.07860262,0.08733624,0.008733625
2012.0,FJI,242,242,9,18,-9,0.07438017,0.037190083,-0.037190083
2013.0,FJI,253,253,19,18,1,0.07114624,0.07509881,0.0039525693
2014.0,FJI,311,311,32,18,14,0.057877813,0.10289389,0.045016076
2015.0,FJI,351,351,29,19,10,0.054131053,0.08262108,0.02849003
2016.0,FJI,377,377,27,20,7,0.0530504,0.071618035,0.018567638
2017.0,FJI,404,404,25,24,1,0.05940594,0.06188119,0.0024752475
2018.0,FJI,452,452,24,27,-3,0.059734512,0.053097345,-0.006637168
2019.0,FJI,468,468,28,18,10,0.03846154,0.05982906,0.021367522
2020.0,FJI,446,446,24,26,-2,0.058295965,0.05381166,-0.004484305
2021.0,FJI,420,420,21,24,-3,0.057142857,0.05,-0.007142857
2001.0,FLK,14,14,0,0,0,0.0,0.0,0.0
2002.0,FLK,20,20,1,0,1,0.0,0.05,0.05
2003.0,FLK,21,21,0,0,0,0.0,0.0,0.0
2004.0,FLK,22,22,1,1,0,0.045454547,0.045454547,0.0
2005.0,FLK,24,24,0,0,0,0.0,0.0,0.0
2006.0,FLK,22,22,1,1,0,0.045454547,0.045454547,0.0
2007.0,FLK,21,21,1,1,0,0.04761905,0.04761905,0.0
2009.0,FLK,18,18,0,2,-2,0.11111111,0.0,-0.11111111
2010.0,FLK,19,19,2,2,0,0.10526316,0.10526316,0.0
2012.0,FLK,22,22,2,2,0,0.09090909,0.09090909,0.0
2013.0,FLK,26,26,3,3,0,0.115384616,0.115384616,0.0
2015.0,FLK,26,26,2,1,1,0.03846154,0.07692308,0.03846154
2017.0,FLK,21,21,1,2,-1,0.0952381,0.04761905,-0.04761905
2018.0,FLK,20,20,3,2,1,0.1,0.15,0.05
2020.0,FLK,20,20,3,3,0,0.15,0.15,0.0
1996.0,FRA,39085,39085,0,0,0,0.0,0.0,0.0
1997.0,FRA,46761,46761,454,441,13,0.009430936,0.009708946,0.00027800945
1998.0,FRA,73662,73662,652,783,-131,0.0106296325,0.008851239,-0.0017783932
1999.0,FRA,96919,96919,1088,1274,-186,0.013144997,0.011225869,-0.0019191283
2000.0,FRA,113320,113320,939,1141,-202,0.010068832,0.008286269,-0.0017825627
2001.0,FRA,126838,126838,2239,2361,-122,0.018614296,0.017652439,-0.00096185686
2002.0,FRA,140058,140058,2869,3342,-473,0.023861542,0.020484371,-0.0033771724
2003.0,FRA,150246,150246,2906,3354,-448,0.02232339,0.019341612,-0.0029817766
2004.0,FRA,158013,158013,2485,3026,-541,0.019150322,0.015726553,-0.003423769
2005.0,FRA,164834,164834,2660,3130,-470,0.018988801,0.016137447,-0.0028513535
2006.0,FRA,172210,172210,2925,3369,-444,0.019563325,0.016985076,-0.0025782476
2007.0,FRA,179772,179772,3218,3665,-447,0.020386934,0.017900452,-0.002486483
2008.0,FRA,187385,187385,3439,3786,-347,0.020204391,0.01835259,-0.0018518025
2009.0,FRA,194638,194638,3595,3902,-307,0.020047473,0.018470185,-0.0015772871
2010.0,FRA,201681,201681,3849,4225,-376,0.020948924,0.019084593,-0.0018643303
2011.0,FRA,208353,208353,4182,4569,-387,0.02192913,0.020071706,-0.0018574246
2012.0,FRA,215455,215455,4101,4712,-611,0.021869997,0.019034138,-0.002835859
2013.0,FRA,221928,221928,4217,4971,-754,0.022399157,0.019001659,-0.0033974983
2014.0,FRA,227538,227538,4586,5258,-672,0.023108227,0.020154875,-0.0029533529
2015.0,FRA,232085,232085,4551,5440,-889,0.023439689,0.019609194,-0.0038304932
2016.0,FRA,234977,234977,4598,5586,-988,0.02377254,0.019567873,-0.0042046667
2017.0,FRA,235900,235900,4622,5564,-942,0.023586266,0.019593047,-0.0039932174
2018.0,FRA,235970,235970,4654,5783,-1129,0.024507353,0.019722845,-0.0047845063
2019.0,FRA,231204,231204,4687,5601,-914,0.02422536,0.020272141,-0.003953219
2020.0,FRA,218615,218615,4533,5013,-480,0.022930723,0.020735083,-0.0021956407
2021.0,FRA,200767,200767,3447,3755,-308,0.018703273,0.017169157,-0.0015341167
1998.0,FRO,3,3,0,0,0,0.0,0.0,0.0
2000.0,FRO,8,8,0,0,0,0.0,0.0,0.0
2001.0,FRO,16,16,2,0,2,0.0,0.125,0.125
2002.0,FRO,19,19,1,0,1,0.0,0.05263158,0.05263158
2003.0,FRO,22,22,3,3,0,0.13636364,0.13636364,0.0
2004.0,FRO,27,27,1,0,1,0.0,0.037037037,0.037037037
2005.0,FRO,33,33,2,0,2,0.0,0.060606062,0.060606062
2006.0,FRO,36,36,1,1,0,0.027777778,0.027777778,0.0
2007.0,FRO,38,38,1,1,0,0.02631579,0.02631579,0.0
2008.0,FRO,48,48,5,3,2,0.0625,0.104166664,0.041666668
2009.0,FRO,47,47,2,3,-1,0.06382979,0.04255319,-0.021276595
2010.0,FRO,55,55,7,2,5,0.036363635,0.12727273,0.09090909
2011.0,FRO,63,63,5,1,4,0.015873017,0.07936508,0.06349207
2012.0,FRO,71,71,4,0,4,0.0,0.056338027,0.056338027
2013.0,FRO,67,67,2,4,-2,0.05970149,0.029850746,-0.029850746
2014.0,FRO,77,77,2,0,2,0.0,0.025974026,0.025974026
2015.0,FRO,96,96,11,4,7,0.041666668,0.114583336,0.072916664
2016.0,FRO,98,98,4,4,0,0.040816326,0.040816326,0.0
2017.0,FRO,108,108,3,3,0,0.027777778,0.027777778,0.0
2018.0,FRO,117,117,8,5,3,0.042735044,0.06837607,0.025641026
2019.0,FRO,115,115,4,3,1,0.026086956,0.034782607,0.008695652
2020.0,FRO,123,123,10,1,9,0.008130081,0.08130081,0.07317073
2021.0,FRO,118,118,5,4,1,0.033898305,0.042372882,0.008474576
1996.0,FSM,1,1,0,0,0,0.0,0.0,0.0
2000.0,FSM,8,8,0,0,0,0.0,0.0,0.0
2001.0,FSM,12,12,0,0,0,0.0,0.0,0.0
2003.0,FSM,20,20,1,2,-1,0.1,0.05,-0.05
2004.0,FSM,20,20,2,2,0,0.1,0.1,0.0
2005.0,FSM,22,22,2,3,-1,0.13636364,0.09090909,-0.045454547
2006.0,FSM,22,22,0,1,-1,0.045454547,0.0,-0.045454547
2007.0,FSM,30,30,4,0,4,0.0,0.13333334,0.13333334
2008.0,FSM,28,28,1,0,1,0.0,0.035714287,0.035714287
2009.0,FSM,26,26,0,1,-1,0.03846154,0.0,-0.03846154
2010.0,FSM,22,22,0,1,-1,0.045454547,0.0,-0.045454547
2012.0,FSM,20,20,0,0,0,0.0,0.0,0.0
2013.0,FSM,27,27,1,1,0,0.037037037,0.037037037,0.0
2014.0,FSM,33,33,2,1,1,0.030303031,0.060606062,0.030303031
2015.0,FSM,35,35,2,0,2,0.0,0.057142857,0.057142857
2017.0,FSM,31,31,1,1,0,0.032258064,0.032258064,0.0
2018.0,FSM,28,28,1,1,0,0.035714287,0.035714287,0.0
1996.0,GAB,23,23,0,0,0,0.0,0.0,0.0
1997.0,GAB,32,32,0,2,-2,0.0625,0.0,-0.0625
1998.0,GAB,65,65,3,1,2,0.015384615,0.046153847,0.03076923
1999.0,GAB,83,83,3,3,0,0.036144577,0.036144577,0.0
2000.0,GAB,85,85,2,7,-5,0.08235294,0.023529412,-0.05882353
2001.0,GAB,100,100,4,4,0,0.04,0.04,0.0
2002.0,GAB,125,125,17,7,10,0.056,0.136,0.08
2003.0,GAB,130,130,6,14,-8,0.10769231,0.046153847,-0.06153846
2004.0,GAB,138,138,7,9,-2,0.06521739,0.050724637,-0.014492754
2005.0,GAB,151,151,8,4,4,0.026490066,0.052980132,0.026490066
2006.0,GAB,156,156,10,5,5,0.032051284,0.06410257,0.032051284
2007.0,GAB,176,176,9,11,-2,0.0625,0.051136363,-0.011363637
2008.0,GAB,187,187,11,10,1,0.053475935,0.05882353,0.0053475937
2009.0,GAB,210,210,17,7,10,0.033333335,0.08095238,0.04761905
2010.0,GAB,223,223,4,6,-2,0.02690583,0.01793722,-0.00896861
2011.0,GAB,243,243,8,13,-5,0.053497944,0.03292181,-0.020576132
2012.0,GAB,264,264,14,12,2,0.045454547,0.053030305,0.007575758
2013.0,GAB,310,310,16,6,10,0.019354839,0.051612902,0.032258064
2014.0,GAB,338,338,21,9,12,0.026627218,0.06213018,0.03550296
2015.0,GAB,373,373,29,15,14,0.04021448,0.077747986,0.03753351
2016.0,GAB,401,401,26,23,3,0.057356607,0.0648379,0.0074812965
2017.0,GAB,417,417,17,19,-2,0.04556355,0.040767387,-0.004796163
2018.0,GAB,416,416,21,13,8,0.03125,0.050480768,0.01923077
2019.0,GAB,430,430,33,23,10,0.053488374,0.076744184,0.023255814
2020.0,GAB,413,413,22,17,5,0.041162226,0.053268764,0.012106538
2021.0,GAB,379,379,11,14,-3,0.036939315,0.029023746,-0.007915568
1996.0,GBR,43910,43910,0,0,0,0.0,0.0,0.0
1997.0,GBR,52077,52077,553,597,-44,0.011463794,0.010618892,-0.00084490277
1998.0,GBR,88439,88439,998,1087,-89,0.012290957,0.011284614,-0.0010063434
1999.0,GBR,117233,117233,1781,1804,-23,0.015388159,0.0151919685,-0.00019619049
2000.0,GBR,138346,138346,1523,1559,-36,0.011268848,0.0110086305,-0.00026021714
2001.0,GBR,156065,156065,3394,3621,-227,0.023201872,0.021747349,-0.0014545221
2002.0,GBR,173660,173660,4586,5072,-486,0.029206496,0.026407924,-0.002798572
2003.0,GBR,186400,186400,4573,5472,-899,0.029356223,0.024533262,-0.0048229615
2004.0,GBR,197249,197249,4164,4886,-722,0.024770722,0.021110373,-0.003660348
2005.0,GBR,207428,207428,4511,4992,-481,0.024066182,0.021747306,-0.0023188768
2006.0,GBR,217275,217275,5013,5115,-102,0.023541594,0.023072144,-0.00046945116
2007.0,GBR,227525,227525,5399,5336,63,0.023452368,0.023729261,0.00027689265
2008.0,GBR,237054,237054,5805,5622,183,0.023716114,0.024488091,0.000771976
2009.0,GBR,246230,246230,5817,6044,-227,0.024546156,0.023624254,-0.0009219023
2010.0,GBR,254715,254715,5962,6780,-818,0.026617985,0.023406552,-0.0032114324
2011.0,GBR,264130,264130,5988,7260,-1272,0.027486466,0.022670655,-0.0048158104
2012.0,GBR,272513,272513,6243,7624,-1381,0.027976647,0.022908999,-0.0050676484
2013.0,GBR,281085,281085,6787,7749,-962,0.027568173,0.02414572,-0.0034224524
2014.0,GBR,291886,291886,7942,7970,-28,0.02730518,0.027209252,-9.592786e-05
2015.0,GBR,300198,300198,8326,8113,213,0.027025497,0.027735028,0.0007095317
2016.0,GBR,308522,308522,8756,8098,658,0.026247723,0.028380472,0.002132749
2017.0,GBR,315613,315613,8859,8663,196,0.027448172,0.028069185,0.0006210137
2018.0,GBR,321251,321251,8851,9401,-550,0.029263722,0.027551666,-0.0017120569
2019.0,GBR,319574,319574,9061,9679,-618,0.030287195,0.02835337,-0.0019338244
2020.0,GBR,302910,302910,8559,9573,-1014,0.031603448,0.028255917,-0.0033475289
2021.0,GBR,278895,278895,6451,7198,-747,0.025808996,0.02313057,-0.0026784274
2022.0,GBR,0,0,3449,3890,-441,,,
1996.0,GEO,313,313,0,0,0,0.0,0.0,0.0
1997.0,GEO,395,395,4,3,1,0.0075949365,0.010126582,0.0025316456
1998.0,GEO,546,546,6,1,5,0.0018315018,0.010989011,0.00915751
1999.0,GEO,617,617,6,10,-4,0.016207455,0.009724474,-0.006482982
2000.0,GEO,700,700,6,6,0,0.008571428,0.008571428,0.0
2001.0,GEO,766,766,8,16,-8,0.020887729,0.010443864,-0.010443864
2002.0,GEO,830,830,12,15,-3,0.018072288,0.014457831,-0.0036144578
2003.0,GEO,975,975,16,24,-8,0.024615385,0.016410256,-0.008205128
2004.0,GEO,1123,1123,22,17,5,0.0151380235,0.019590383,0.00445236
2005.0,GEO,1196,1196,24,18,6,0.015050167,0.020066889,0.0050167223
2006.0,GEO,1285,1285,19,28,-9,0.021789884,0.014785992,-0.0070038913
2007.0,GEO,1392,1392,24,30,-6,0.021551725,0.01724138,-0.004310345
2008.0,GEO,1421,1421,28,21,7,0.014778325,0.019704433,0.0049261083
2009.0,GEO,1480,1480,25,17,8,0.0114864865,0.016891891,0.0054054055
2010.0,GEO,1551,1551,14,29,-15,0.018697614,0.009026434,-0.00967118
2011.0,GEO,1610,1610,27,28,-1,0.017391304,0.016770186,-0.000621118
2012.0,GEO,1680,1680,20,28,-8,0.016666668,0.011904762,-0.004761905
2013.0,GEO,1813,1813,29,41,-12,0.022614451,0.015995588,-0.006618864
2014.0,GEO,1932,1932,32,25,7,0.012939959,0.016563147,0.0036231885
2015.0,GEO,2059,2059,40,22,18,0.0106847985,0.019426906,0.008742108
2016.0,GEO,2229,2229,62,42,20,0.01884253,0.027815163,0.008972634
2017.0,GEO,2278,2278,37,74,-37,0.032484636,0.016242318,-0.016242318
2018.0,GEO,2244,2244,39,76,-37,0.033868093,0.017379679,-0.016488414
2019.0,GEO,2149,2149,49,84,-35,0.039087947,0.022801302,-0.016286645
2020.0,GEO,2020,2020,48,59,-11,0.02920792,0.023762377,-0.0054455446
2021.0,GEO,1802,1802,28,49,-21,0.02719201,0.015538291,-0.011653719
1996.0,GHA,52,52,0,0,0,0.0,0.0,0.0
1997.0,GHA,75,75,1,0,1,0.0,0.013333334,0.013333334
1998.0,GHA,166,166,5,0,5,0.0,0.030120483,0.030120483
1999.0,GHA,257,257,5,4,1,0.015564202,0.019455252,0.0038910506
2000.0,GHA,363,363,4,3,1,0.008264462,0.011019284,0.002754821
2001.0,GHA,466,466,9,9,0,0.019313306,0.019313306,0.0
2002.0,GHA,586,586,25,22,3,0.037542664,0.042662118,0.005119454
2003.0,GHA,689,689,27,19,8,0.027576197,0.039187226,0.01161103
2004.0,GHA,810,810,30,13,17,0.016049383,0.037037037,0.020987654
2005.0,GHA,920,920,22,14,8,0.015217391,0.023913043,0.008695652
2006.0,GHA,1101,1101,32,22,10,0.019981835,0.029064488,0.009082652
2007.0,GHA,1281,1281,40,28,12,0.021857923,0.031225605,0.009367681
2008.0,GHA,1536,1536,45,30,15,0.01953125,0.029296875,0.009765625
2009.0,GHA,1808,1808,35,25,10,0.013827434,0.019358408,0.0055309734
2010.0,GHA,2147,2147,54,26,28,0.01210992,0.025151374,0.013041453
2011.0,GHA,2475,2475,73,47,26,0.018989898,0.029494949,0.01050505
2012.0,GHA,2826,2826,72,50,22,0.017692853,0.025477707,0.007784855
2013.0,GHA,3205,3205,62,73,-11,0.022776911,0.019344773,-0.0034321372
2014.0,GHA,3722,3722,106,75,31,0.020150457,0.028479312,0.008328855
2015.0,GHA,4165,4165,108,84,24,0.020168068,0.025930373,0.005762305
2016.0,GHA,4689,4689,127,102,25,0.02175304,0.027084665,0.005331627
2017.0,GHA,5271,5271,148,139,9,0.026370708,0.028078163,0.0017074558
2018.0,GHA,5885,5885,161,153,8,0.0259983,0.027357688,0.0013593882
2019.0,GHA,6239,6239,216,178,38,0.028530214,0.034620933,0.0060907197
2020.0,GHA,6226,6226,216,167,49,0.026823001,0.034693222,0.0078702215
2021.0,GHA,6013,6013,192,145,47,0.024114419,0.031930815,0.007816398
2001.0,GIB,2,2,0,0,0,0.0,0.0,0.0
2002.0,GIB,2,2,1,1,0,0.5,0.5,0.0
2006.0,GIB,9,9,0,0,0,0.0,0.0,0.0
2007.0,GIB,10,10,1,0,1,0.0,0.1,0.1
2009.0,GIB,17,17,1,0,1,0.0,0.05882353,0.05882353
2010.0,GIB,14,14,0,1,-1,0.071428575,0.0,-0.071428575
2011.0,GIB,13,13,0,1,-1,0.07692308,0.0,-0.07692308
2013.0,GIB,14,14,0,0,0,0.0,0.0,0.0
2014.0,GIB,17,17,4,0,4,0.0,0.23529412,0.23529412
2017.0,GIB,20,20,0,2,-2,0.1,0.0,-0.1
2020.0,GIB,19,19,5,1,4,0.05263158,0.2631579,0.21052632
1996.0,GIN,8,8,0,0,0,0.0,0.0,0.0
1997.0,GIN,8,8,0,0,0,0.0,0.0,0.0
2000.0,GIN,33,33,0,0,0,0.0,0.0,0.0
2001.0,GIN,40,40,3,2,1,0.05,0.075,0.025
2002.0,GIN,45,45,2,6,-4,0.13333334,0.044444446,-0.08888889
2003.0,GIN,52,52,3,0,3,0.0,0.057692308,0.057692308
2004.0,GIN,62,62,2,2,0,0.032258064,0.032258064,0.0
2005.0,GIN,90,90,11,2,9,0.022222223,0.12222222,0.1
2006.0,GIN,102,102,5,2,3,0.019607844,0.04901961,0.029411765
2007.0,GIN,120,120,8,1,7,0.008333334,0.06666667,0.058333334
2008.0,GIN,118,118,4,8,-4,0.06779661,0.033898305,-0.033898305
2009.0,GIN,109,109,3,9,-6,0.08256881,0.027522936,-0.055045873
2010.0,GIN,96,96,2,6,-4,0.0625,0.020833334,-0.041666668
2011.0,GIN,106,106,6,3,3,0.028301887,0.056603774,0.028301887
2012.0,GIN,134,134,10,2,8,0.014925373,0.07462686,0.05970149
2013.0,GIN,151,151,5,4,1,0.026490066,0.03311258,0.0066225166
2014.0,GIN,195,195,12,3,9,0.015384615,0.06153846,0.046153847
2015.0,GIN,206,206,8,12,-4,0.058252428,0.03883495,-0.019417476
2016.0,GIN,212,212,12,9,3,0.04245283,0.056603774,0.014150944
2017.0,GIN,230,230,10,20,-10,0.08695652,0.04347826,-0.04347826
2018.0,GIN,258,258,23,12,11,0.046511628,0.089147285,0.04263566
2019.0,GIN,266,266,21,11,10,0.041353382,0.078947365,0.037593983
2020.0,GIN,248,248,11,16,-5,0.06451613,0.044354837,-0.02016129
2021.0,GIN,236,236,9,8,1,0.033898305,0.038135592,0.004237288
1997.0,GLP,34,34,3,0,3,0.0,0.0882353,0.0882353
1998.0,GLP,56,56,5,0,5,0.0,0.08928572,0.08928572
1999.0,GLP,62,62,1,3,-2,0.048387095,0.016129032,-0.032258064
2000.0,GLP,50,50,0,9,-9,0.18,0.0,-0.18
2001.0,GLP,46,46,3,13,-10,0.2826087,0.06521739,-0.2173913
2002.0,GLP,44,44,6,15,-9,0.3409091,0.13636364,-0.20454545
2003.0,GLP,59,59,17,7,10,0.118644066,0.2881356,0.16949153
2004.0,GLP,75,75,9,8,1,0.10666667,0.12,0.013333334
2005.0,GLP,81,81,14,10,4,0.12345679,0.17283951,0.049382716
2006.0,GLP,84,84,13,17,-4,0.20238096,0.15476191,-0.04761905
2007.0,GLP,89,89,12,18,-6,0.20224719,0.13483146,-0.06741573
2008.0,GLP,103,103,22,14,8,0.13592233,0.21359223,0.0776699
2009.0,GLP,93,93,14,21,-7,0.22580644,0.15053764,-0.07526882
2010.0,GLP,95,95,14,19,-5,0.2,0.14736842,-0.05263158
2011.0,GLP,104,104,14,14,0,0.13461539,0.13461539,0.0
2012.0,GLP,113,113,16,19,-3,0.16814159,0.14159292,-0.026548672
2013.0,GLP,112,112,17,14,3,0.125,0.15178572,0.026785715
2014.0,GLP,112,112,18,23,-5,0.20535715,0.16071428,-0.04464286
2015.0,GLP,101,101,11,19,-8,0.18811882,0.10891089,-0.07920792
2016.0,GLP,82,82,7,25,-18,0.30487806,0.085365854,-0.2195122
2018.0,GLP,40,40,8,22,-14,0.55,0.2,-0.35
2019.0,GLP,39,39,11,9,2,0.23076923,0.2820513,0.051282052
2020.0,GLP,29,29,6,10,-4,0.3448276,0.20689656,-0.13793103
2021.0,GLP,27,27,5,3,2,0.11111111,0.18518518,0.074074075
1996.0,GMB,39,39,0,0,0,0.0,0.0,0.0
1997.0,GMB,42,42,1,1,0,0.023809524,0.023809524,0.0
1998.0,GMB,55,55,0,1,-1,0.018181818,0.0,-0.018181818
1999.0,GMB,66,66,5,10,-5,0.15151516,0.07575758,-0.07575758
2000.0,GMB,77,77,4,2,2,0.025974026,0.051948052,0.025974026
2001.0,GMB,103,103,10,8,2,0.0776699,0.097087376,0.019417476
2002.0,GMB,114,114,14,17,-3,0.1491228,0.12280702,-0.02631579
2003.0,GMB,151,151,22,12,10,0.0794702,0.14569536,0.06622516
2004.0,GMB,158,158,17,14,3,0.088607594,0.10759494,0.01898734
2005.0,GMB,163,163,12,16,-4,0.09815951,0.073619634,-0.024539877
2006.0,GMB,179,179,14,18,-4,0.10055866,0.07821229,-0.022346368
2007.0,GMB,186,186,13,16,-3,0.086021505,0.06989247,-0.016129032
2008.0,GMB,201,201,20,12,8,0.05970149,0.09950249,0.039800994
2009.0,GMB,201,201,13,16,-3,0.07960199,0.06467662,-0.014925373
2010.0,GMB,199,199,6,16,-10,0.08040201,0.030150754,-0.050251257
2011.0,GMB,193,193,12,25,-13,0.12953368,0.062176164,-0.06735751
2012.0,GMB,193,193,11,18,-7,0.09326425,0.05699482,-0.03626943
2013.0,GMB,224,224,21,14,7,0.0625,0.09375,0.03125
2014.0,GMB,267,267,10,16,-6,0.059925094,0.037453182,-0.02247191
2015.0,GMB,284,284,13,15,-2,0.0528169,0.045774646,-0.0070422534
2016.0,GMB,296,296,18,11,7,0.037162162,0.06081081,0.02364865
2017.0,GMB,318,318,14,20,-6,0.062893085,0.044025157,-0.018867925
2018.0,GMB,336,336,24,33,-9,0.09821428,0.071428575,-0.026785715
2019.0,GMB,342,342,24,25,-1,0.07309941,0.07017544,-0.0029239766
2020.0,GMB,321,321,18,24,-6,0.07476635,0.056074765,-0.018691588
2021.0,GMB,315,315,22,15,7,0.04761905,0.06984127,0.022222223
1997.0,GNB,4,4,0,0,0,0.0,0.0,0.0
1998.0,GNB,5,5,1,0,1,0.0,0.2,0.2
2001.0,GNB,10,10,0,1,-1,0.1,0.0,-0.1
2002.0,GNB,22,22,8,0,8,0.0,0.36363637,0.36363637
2003.0,GNB,34,34,11,4,7,0.11764706,0.32352942,0.20588236
2004.0,GNB,40,40,5,3,2,0.075,0.125,0.05
2005.0,GNB,44,44,3,0,3,0.0,0.06818182,0.06818182
2006.0,GNB,41,41,2,5,-3,0.12195122,0.048780486,-0.07317073
2007.0,GNB,39,39,2,3,-1,0.07692308,0.051282052,-0.025641026
2008.0,GNB,39,39,1,4,-3,0.102564104,0.025641026,-0.07692308
2009.0,GNB,36,36,3,5,-2,0.1388889,0.083333336,-0.055555556
2010.0,GNB,44,44,5,4,1,0.09090909,0.11363637,0.022727273
2011.0,GNB,54,54,4,2,2,0.037037037,0.074074075,0.037037037
2012.0,GNB,58,58,1,4,-3,0.06896552,0.01724138,-0.05172414
2013.0,GNB,58,58,3,2,1,0.03448276,0.05172414,0.01724138
2014.0,GNB,61,61,2,5,-3,0.08196721,0.032786883,-0.04918033
2015.0,GNB,74,74,7,2,5,0.027027028,0.0945946,0.067567565
2016.0,GNB,67,67,5,6,-1,0.08955224,0.07462686,-0.014925373
2017.0,GNB,70,70,6,1,5,0.014285714,0.08571429,0.071428575
2018.0,GNB,60,60,4,14,-10,0.23333333,0.06666667,-0.16666667
2019.0,GNB,55,55,2,4,-2,0.07272727,0.036363635,-0.036363635
2020.0,GNB,53,53,4,1,3,0.018867925,0.0754717,0.056603774
2021.0,GNB,57,57,7,0,7,0.0,0.12280702,0.12280702
2001.0,GNQ,8,8,0,0,0,0.0,0.0,0.0
2002.0,GNQ,8,8,0,0,0,0.0,0.0,0.0
2003.0,GNQ,9,9,0,2,-2,0.22222222,0.0,-0.22222222
2005.0,GNQ,10,10,1,0,1,0.0,0.1,0.1
2006.0,GNQ,6,6,0,1,-1,0.16666667,0.0,-0.16666667
2009.0,GNQ,8,8,0,2,-2,0.25,0.0,-0.25
2010.0,GNQ,10,10,3,0,3,0.0,0.3,0.3
2011.0,GNQ,12,12,0,3,-3,0.25,0.0,-0.25
2013.0,GNQ,14,14,1,1,0,0.071428575,0.071428575,0.0
2014.0,GNQ,13,13,1,3,-2,0.23076923,0.07692308,-0.15384616
2015.0,GNQ,15,15,1,2,-1,0.13333334,0.06666667,-0.06666667
2017.0,GNQ,32,32,6,0,6,0.0,0.1875,0.1875
2018.0,GNQ,37,37,7,4,3,0.10810811,0.1891892,0.08108108
2019.0,GNQ,27,27,2,13,-11,0.4814815,0.074074075,-0.4074074
2020.0,GNQ,27,27,5,3,2,0.11111111,0.18518518,0.074074075
2021.0,GNQ,25,25,0,2,-2,0.08,0.0,-0.08
1996.0,GRC,2915,2915,0,0,0,0.0,0.0,0.0
1997.0,GRC,3519,3519,41,26,15,0.007388463,0.011651037,0.0042625745
1998.0,GRC,6993,6993,78,52,26,0.0074360073,0.011154011,0.0037180036
1999.0,GRC,10358,10358,146,68,78,0.006564974,0.014095386,0.0075304112
2000.0,GRC,13144,13144,117,68,49,0.0051734634,0.0089014,0.0037279367
2001.0,GRC,15907,15907,240,166,74,0.010435658,0.015087698,0.00465204
2002.0,GRC,18675,18675,356,276,80,0.014779116,0.019062918,0.0042838017
2003.0,GRC,21299,21299,421,239,182,0.011221184,0.019766185,0.008545002
2004.0,GRC,23690,23690,341,252,89,0.0106374,0.014394259,0.0037568593
2005.0,GRC,26034,26034,372,283,89,0.0108704,0.014289007,0.0034186065
2006.0,GRC,28114,28114,405,298,107,0.010599702,0.014405634,0.003805933
2007.0,GRC,30210,30210,425,377,48,0.012479312,0.014068189,0.0015888779
2008.0,GRC,31738,31738,461,393,68,0.012382633,0.014525175,0.002142542
2009.0,GRC,33051,33051,424,477,-53,0.014432241,0.012828658,-0.0016035823
2010.0,GRC,33925,33925,417,501,-84,0.01476787,0.01229182,-0.00247605
2011.0,GRC,34601,34601,428,545,-117,0.01575099,0.012369584,-0.0033814053
2012.0,GRC,35057,35057,427,656,-229,0.018712383,0.0121801635,-0.006532219
2013.0,GRC,35290,35290,394,768,-374,0.021762539,0.011164635,-0.010597903
2014.0,GRC,35470,35470,408,799,-391,0.022526078,0.0115026785,-0.0110234
2015.0,GRC,35660,35660,425,843,-418,0.023639932,0.011918115,-0.011721817
2016.0,GRC,35937,35937,410,841,-431,0.023402065,0.011408854,-0.011993211
2017.0,GRC,36111,36111,404,867,-463,0.024009304,0.011187727,-0.0128215775
2018.0,GRC,36789,36789,492,740,-248,0.020114709,0.013373563,-0.0067411456
2019.0,GRC,36913,36913,537,815,-278,0.022078943,0.014547721,-0.007531222
2020.0,GRC,35271,35271,511,699,-188,0.01981798,0.014487823,-0.005330158
2021.0,GRC,32695,32695,415,468,-53,0.014314115,0.012693073,-0.001621043
2000.0,GRD,4,4,0,0,0,0.0,0.0,0.0
2001.0,GRD,4,4,0,1,-1,0.25,0.0,-0.25
2002.0,GRD,9,9,2,0,2,0.0,0.22222222,0.22222222
2003.0,GRD,11,11,3,1,2,0.09090909,0.27272728,0.18181819
2004.0,GRD,21,21,2,0,2,0.0,0.0952381,0.0952381
2006.0,GRD,51,51,7,1,6,0.019607844,0.13725491,0.11764706
2007.0,GRD,66,66,2,0,2,0.0,0.030303031,0.030303031
2008.0,GRD,76,76,8,6,2,0.078947365,0.10526316,0.02631579
2009.0,GRD,91,91,4,9,-5,0.0989011,0.043956045,-0.054945055
2010.0,GRD,110,110,7,5,2,0.045454547,0.06363636,0.018181818
2011.0,GRD,119,119,6,8,-2,0.067226894,0.05042017,-0.016806724
2012.0,GRD,142,142,6,5,1,0.03521127,0.04225352,0.0070422534
2013.0,GRD,155,155,10,2,8,0.012903226,0.06451613,0.051612902
2014.0,GRD,159,159,7,7,0,0.044025157,0.044025157,0.0
2015.0,GRD,188,188,11,13,-2,0.069148935,0.05851064,-0.010638298
2016.0,GRD,192,192,10,15,-5,0.078125,0.052083332,-0.026041666
2017.0,GRD,191,191,13,11,2,0.057591625,0.06806283,0.010471204
2018.0,GRD,208,208,13,13,0,0.0625,0.0625,0.0
2019.0,GRD,201,201,16,25,-9,0.12437811,0.07960199,-0.04477612
2020.0,GRD,194,194,16,9,7,0.04639175,0.082474224,0.036082473
2021.0,GRD,171,171,9,11,-2,0.064327486,0.05263158,-0.0116959065
1996.0,GRL,3,3,0,0,0,0.0,0.0,0.0
1997.0,GRL,3,3,0,0,0,0.0,0.0,0.0
1998.0,GRL,5,5,0,0,0,0.0,0.0,0.0
2000.0,GRL,14,14,1,0,1,0.0,0.071428575,0.071428575
2001.0,GRL,20,20,1,0,1,0.0,0.05,0.05
2002.0,GRL,25,25,1,0,1,0.0,0.04,0.04
2003.0,GRL,30,30,3,2,1,0.06666667,0.1,0.033333335
2004.0,GRL,40,40,8,1,7,0.025,0.2,0.175
2005.0,GRL,50,50,5,4,1,0.08,0.1,0.02
2006.0,GRL,51,51,2,4,-2,0.078431375,0.039215688,-0.039215688
2007.0,GRL,51,51,3,4,-1,0.078431375,0.05882353,-0.019607844
2008.0,GRL,58,58,9,4,5,0.06896552,0.15517241,0.0862069
2009.0,GRL,62,62,9,5,4,0.08064516,0.14516129,0.06451613
2010.0,GRL,60,60,5,6,-1,0.1,0.083333336,-0.016666668
2011.0,GRL,66,66,3,4,-1,0.060606062,0.045454547,-0.015151516
2012.0,GRL,74,74,4,4,0,0.054054055,0.054054055,0.0
2013.0,GRL,79,79,6,5,1,0.06329114,0.07594936,0.012658228
2014.0,GRL,80,80,3,5,-2,0.0625,0.0375,-0.025
2015.0,GRL,80,80,6,5,1,0.0625,0.075,0.0125
2016.0,GRL,90,90,7,0,7,0.0,0.07777778,0.07777778
2017.0,GRL,95,95,9,4,5,0.042105265,0.094736844,0.05263158
2018.0,GRL,96,96,6,8,-2,0.083333336,0.0625,-0.020833334
2019.0,GRL,101,101,8,4,4,0.03960396,0.07920792,0.03960396
2020.0,GRL,102,102,10,4,6,0.039215688,0.09803922,0.05882353
2021.0,GRL,95,95,7,5,2,0.05263158,0.07368421,0.021052632
1996.0,GTM,17,17,0,0,0,0.0,0.0,0.0
1997.0,GTM,18,18,0,1,-1,0.055555556,0.0,-0.055555556
1999.0,GTM,30,30,1,5,-4,0.16666667,0.033333335,-0.13333334
2000.0,GTM,40,40,0,2,-2,0.05,0.0,-0.05
2001.0,GTM,49,49,2,3,-1,0.06122449,0.040816326,-0.020408163
2002.0,GTM,66,66,2,0,2,0.0,0.030303031,0.030303031
2003.0,GTM,83,83,7,7,0,0.084337346,0.084337346,0.0
2004.0,GTM,101,101,9,3,6,0.02970297,0.089108914,0.05940594
2005.0,GTM,115,115,9,3,6,0.026086956,0.07826087,0.052173913
2006.0,GTM,123,123,4,5,-1,0.040650405,0.032520324,-0.008130081
2007.0,GTM,150,150,11,8,3,0.053333335,0.07333333,0.02
2008.0,GTM,173,173,6,5,1,0.028901733,0.03468208,0.0057803467
2009.0,GTM,189,189,8,6,2,0.031746034,0.04232804,0.01058201
2010.0,GTM,217,217,7,9,-2,0.041474655,0.032258064,-0.00921659
2011.0,GTM,233,233,13,11,2,0.047210302,0.055793993,0.008583691
2012.0,GTM,283,283,22,9,13,0.03180212,0.077738516,0.045936394
2013.0,GTM,318,318,17,21,-4,0.06603774,0.05345912,-0.012578616
2014.0,GTM,358,358,14,12,2,0.033519555,0.039106146,0.005586592
2015.0,GTM,384,384,19,12,7,0.03125,0.049479168,0.018229166
2016.0,GTM,401,401,23,23,0,0.057356607,0.057356607,0.0
2017.0,GTM,413,413,6,20,-14,0.04842615,0.014527845,-0.033898305
2018.0,GTM,451,451,28,19,9,0.042128604,0.062084258,0.019955654
2019.0,GTM,471,471,31,30,1,0.06369427,0.06581741,0.0021231424
2020.0,GTM,450,450,22,21,1,0.046666667,0.04888889,0.0022222223
2021.0,GTM,412,412,17,13,4,0.0315534,0.041262135,0.009708738
1996.0,GUF,6,6,0,0,0,0.0,0.0,0.0
1998.0,GUF,8,8,1,2,-1,0.25,0.125,-0.125
1999.0,GUF,19,19,3,2,1,0.10526316,0.15789473,0.05263158
2000.0,GUF,30,30,5,1,4,0.033333335,0.16666667,0.13333334
2001.0,GUF,38,38,4,3,1,0.078947365,0.10526316,0.02631579
2002.0,GUF,52,52,13,4,9,0.07692308,0.25,0.17307693
2003.0,GUF,60,60,7,11,-4,0.18333334,0.11666667,-0.06666667
2004.0,GUF,72,72,18,7,11,0.097222224,0.25,0.15277778
2005.0,GUF,70,70,6,13,-7,0.18571429,0.08571429,-0.1
2006.0,GUF,88,88,16,8,8,0.09090909,0.18181819,0.09090909
2007.0,GUF,100,100,14,5,9,0.05,0.14,0.09
2008.0,GUF,104,104,16,12,4,0.115384616,0.15384616,0.03846154
2009.0,GUF,110,110,10,17,-7,0.15454546,0.09090909,-0.06363636
2010.0,GUF,127,127,17,11,6,0.08661418,0.13385826,0.047244094
2011.0,GUF,147,147,25,13,12,0.088435374,0.17006803,0.08163265
2012.0,GUF,146,146,15,22,-7,0.15068494,0.10273973,-0.047945205
2013.0,GUF,147,147,13,19,-6,0.1292517,0.088435374,-0.040816326
2014.0,GUF,150,150,18,27,-9,0.18,0.12,-0.06
2015.0,GUF,165,165,22,17,5,0.1030303,0.13333334,0.030303031
2016.0,GUF,183,183,29,22,7,0.12021858,0.15846995,0.038251366
2017.0,GUF,194,194,34,27,7,0.13917525,0.17525773,0.036082473
2018.0,GUF,205,205,28,30,-2,0.14634146,0.13658537,-0.009756098
2019.0,GUF,195,195,19,31,-12,0.15897436,0.0974359,-0.06153846
2020.0,GUF,195,195,23,14,9,0.071794875,0.11794872,0.046153847
2021.0,GUF,185,185,21,18,3,0.097297296,0.113513514,0.016216217
1996.0,GUM,8,8,0,0,0,0.0,0.0,0.0
1997.0,GUM,10,10,0,0,0,0.0,0.0,0.0
1998.0,GUM,13,13,1,0,1,0.0,0.07692308,0.07692308
1999.0,GUM,22,22,0,0,0,0.0,0.0,0.0
2000.0,GUM,24,24,0,3,-3,0.125,0.0,-0.125
2001.0,GUM,25,25,0,4,-4,0.16,0.0,-0.16
2002.0,GUM,29,29,0,2,-2,0.06896552,0.0,-0.06896552
2003.0,GUM,32,32,3,4,-1,0.125,0.09375,-0.03125
2004.0,GUM,33,33,5,4,1,0.121212125,0.15151516,0.030303031
2005.0,GUM,34,34,6,6,0,0.1764706,0.1764706,0.0
2006.0,GUM,30,30,3,4,-1,0.13333334,0.1,-0.033333335
2007.0,GUM,32,32,3,2,1,0.0625,0.09375,0.03125
2008.0,GUM,38,38,9,4,5,0.10526316,0.23684211,0.13157895
2009.0,GUM,52,52,8,1,7,0.01923077,0.15384616,0.13461539
2010.0,GUM,50,50,2,6,-4,0.12,0.04,-0.08
2011.0,GUM,56,56,6,4,2,0.071428575,0.10714286,0.035714287
2012.0,GUM,58,58,8,7,1,0.12068965,0.13793103,0.01724138
2013.0,GUM,65,65,7,6,1,0.092307694,0.10769231,0.015384615
2014.0,GUM,62,62,0,4,-4,0.06451613,0.0,-0.06451613
2015.0,GUM,59,59,1,5,-4,0.084745765,0.016949153,-0.06779661
2016.0,GUM,57,57,8,3,5,0.05263158,0.14035088,0.0877193
2017.0,GUM,55,55,4,4,0,0.07272727,0.07272727,0.0
2018.0,GUM,53,53,7,7,0,0.13207547,0.13207547,0.0
2019.0,GUM,61,61,11,5,6,0.08196721,0.18032786,0.09836066
2020.0,GUM,60,60,6,3,3,0.05,0.1,0.05
2021.0,GUM,54,54,4,6,-2,0.11111111,0.074074075,-0.037037037
1997.0,GUY,3,3,0,0,0,0.0,0.0,0.0
1998.0,GUY,8,8,0,0,0,0.0,0.0,0.0
1999.0,GUY,12,12,1,0,1,0.0,0.083333336,0.083333336
2000.0,GUY,13,13,0,0,0,0.0,0.0,0.0
2001.0,GUY,18,18,1,1,0,0.055555556,0.055555556,0.0
2002.0,GUY,18,18,3,3,0,0.16666667,0.16666667,0.0
2003.0,GUY,24,24,4,1,3,0.041666668,0.16666667,0.125
2004.0,GUY,25,25,3,7,-4,0.28,0.12,-0.16
2005.0,GUY,27,27,1,3,-2,0.11111111,0.037037037,-0.074074075
2006.0,GUY,24,24,5,3,2,0.125,0.20833333,0.083333336
2007.0,GUY,24,24,3,4,-1,0.16666667,0.125,-0.041666668
2008.0,GUY,28,28,3,6,-3,0.21428572,0.10714286,-0.10714286
2009.0,GUY,38,38,8,3,5,0.078947365,0.21052632,0.13157895
2010.0,GUY,43,43,2,1,1,0.023255814,0.046511628,0.023255814
2011.0,GUY,47,47,0,2,-2,0.04255319,0.0,-0.04255319
2012.0,GUY,52,52,2,2,0,0.03846154,0.03846154,0.0
2013.0,GUY,54,54,4,4,0,0.074074075,0.074074075,0.0
2014.0,GUY,60,60,5,4,1,0.06666667,0.083333336,0.016666668
2015.0,GUY,70,70,4,4,0,0.057142857,0.057142857,0.0
2016.0,GUY,70,70,3,6,-3,0.08571429,0.042857144,-0.042857144
2017.0,GUY,72,72,3,4,-1,0.055555556,0.041666668,-0.013888889
2018.0,GUY,79,79,8,4,4,0.050632913,0.101265825,0.050632913
2019.0,GUY,73,73,3,6,-3,0.08219178,0.04109589,-0.04109589
2020.0,GUY,71,71,3,1,2,0.014084507,0.04225352,0.028169014
2021.0,GUY,61,61,2,2,0,0.032786883,0.032786883,0.0
1996.0,HKG,2290,2290,0,0,0,0.0,0.0,0.0
1997.0,HKG,2820,2820,56,34,22,0.012056737,0.019858155,0.0078014187
1998.0,HKG,4853,4853,96,59,37,0.012157428,0.019781578,0.00762415
1999.0,HKG,6764,6764,168,131,37,0.019367239,0.024837375,0.005470136
2000.0,HKG,8287,8287,176,111,65,0.013394473,0.021238083,0.007843611
2001.0,HKG,9663,9663,292,307,-15,0.031770673,0.03021836,-0.001552313
2002.0,HKG,11113,11113,373,401,-28,0.036083866,0.033564296,-0.0025195717
2003.0,HKG,12176,12176,366,432,-66,0.03547963,0.030059133,-0.0054204995
2004.0,HKG,12989,12989,312,458,-146,0.035260607,0.024020325,-0.01124028
2005.0,HKG,13729,13729,323,460,-137,0.03350572,0.023526842,-0.009978876
2006.0,HKG,14494,14494,382,479,-97,0.033048157,0.026355734,-0.0066924244
2007.0,HKG,15243,15243,468,498,-30,0.032670733,0.030702617,-0.0019681165
2008.0,HKG,16050,16050,530,550,-20,0.034267914,0.033021808,-0.0012461059
2009.0,HKG,16896,16896,571,593,-22,0.035097063,0.03379498,-0.0013020834
2010.0,HKG,17629,17629,592,682,-90,0.038686257,0.03358103,-0.0051052244
2011.0,HKG,18381,18381,578,686,-108,0.037321147,0.031445514,-0.0058756326
2012.0,HKG,18998,18998,622,797,-175,0.041951783,0.032740287,-0.0092114955
2013.0,HKG,19952,19952,719,758,-39,0.037991177,0.036036488,-0.0019546913
2014.0,HKG,20818,20818,745,857,-112,0.041166298,0.03578634,-0.0053799595
2015.0,HKG,21722,21722,770,901,-131,0.041478686,0.035447933,-0.0060307523
2016.0,HKG,22698,22698,885,1024,-139,0.045114107,0.03899022,-0.0061238874
2017.0,HKG,23797,23797,900,1000,-100,0.042022105,0.037819892,-0.0042022103
2018.0,HKG,24926,24926,1020,1170,-150,0.04693894,0.040921126,-0.0060178125
2019.0,HKG,25396,25396,1084,1335,-251,0.052567333,0.04268389,-0.009883447
2020.0,HKG,24029,24029,1118,1321,-203,0.054975238,0.046527114,-0.008448125
2021.0,HKG,22263,22263,1049,1181,-132,0.053047657,0.047118537,-0.00592912
1996.0,HND,6,6,0,0,0,0.0,0.0,0.0
1998.0,HND,10,10,0,0,0,0.0,0.0,0.0
2000.0,HND,14,14,0,0,0,0.0,0.0,0.0
2001.0,HND,18,18,1,2,-1,0.11111111,0.055555556,-0.055555556
2002.0,HND,27,27,2,0,2,0.0,0.074074075,0.074074075
2003.0,HND,39,39,4,1,3,0.025641026,0.102564104,0.07692308
2004.0,HND,46,46,4,1,3,0.02173913,0.08695652,0.06521739
2005.0,HND,50,50,3,3,0,0.06,0.06,0.0
2006.0,HND,59,59,1,6,-5,0.10169491,0.016949153,-0.084745765
2007.0,HND,62,62,1,1,0,0.016129032,0.016129032,0.0
2008.0,HND,67,67,5,3,2,0.04477612,0.07462686,0.029850746
2009.0,HND,79,79,5,5,0,0.06329114,0.06329114,0.0
2010.0,HND,96,96,4,2,2,0.020833334,0.041666668,0.020833334
2011.0,HND,109,109,2,3,-1,0.027522936,0.018348623,-0.0091743115
2012.0,HND,117,117,3,4,-1,0.034188036,0.025641026,-0.008547009
2013.0,HND,133,133,9,2,7,0.015037594,0.067669176,0.05263158
2014.0,HND,146,146,7,5,2,0.034246575,0.047945205,0.01369863
2015.0,HND,167,167,4,6,-2,0.035928145,0.023952097,-0.011976048
2016.0,HND,195,195,7,7,0,0.035897437,0.035897437,0.0
2017.0,HND,218,218,8,8,0,0.036697246,0.036697246,0.0
2018.0,HND,243,243,10,9,1,0.037037037,0.041152265,0.004115226
2019.0,HND,275,275,15,4,11,0.014545455,0.054545455,0.04
2020.0,HND,267,267,5,7,-2,0.026217228,0.018726591,-0.007490637
2021.0,HND,249,249,10,9,1,0.036144577,0.04016064,0.004016064
1996.0,HRV,1525,1525,0,0,0,0.0,0.0,0.0
1997.0,HRV,2021,2021,7,6,1,0.0029688273,0.003463632,0.0004948045
1998.0,HRV,3292,3292,12,13,-1,0.003948967,0.0036452005,-0.00030376672
1999.0,HRV,4467,4467,23,24,-1,0.0053727333,0.0051488695,-0.00022386388
2000.0,HRV,5481,5481,17,28,-11,0.0051085567,0.0031016238,-0.002006933
2001.0,HRV,6462,6462,55,53,2,0.008201795,0.0085112965,0.00030950172
2002.0,HRV,7341,7341,70,82,-12,0.0111701405,0.009535486,-0.0016346547
2003.0,HRV,7994,7994,69,75,-6,0.0093820365,0.008631473,-0.00075056293
2004.0,HRV,8650,8650,61,57,4,0.006589595,0.007052023,0.00046242774
2005.0,HRV,9377,9377,49,53,-4,0.0056521273,0.005225552,-0.00042657566
2006.0,HRV,10124,10124,61,56,5,0.0055314107,0.0060252864,0.00049387594
2007.0,HRV,11058,11058,67,62,5,0.0056068003,0.0060589616,0.00045216133
2008.0,HRV,11933,11933,61,66,-5,0.0055308808,0.0051118745,-0.00041900613
2009.0,HRV,12998,12998,64,67,-3,0.005154639,0.0049238345,-0.00023080474
2010.0,HRV,13791,13791,91,80,11,0.0058008847,0.006598506,0.0007976216
2011.0,HRV,14404,14404,69,95,-26,0.0065953904,0.004790336,-0.0018050541
2012.0,HRV,14816,14816,69,112,-43,0.0075593954,0.0046571274,-0.0029022677
2013.0,HRV,15073,15073,85,132,-47,0.008757381,0.0056392225,-0.0031181583
2014.0,HRV,15257,15257,114,128,-14,0.008389591,0.00747198,-0.0009176116
2015.0,HRV,15557,15557,86,143,-57,0.009192004,0.005528058,-0.0036639455
2016.0,HRV,15867,15867,149,135,14,0.008508225,0.009390559,0.0008823344
2017.0,HRV,16196,16196,123,133,-10,0.008211904,0.0075944676,-0.0006174364
2018.0,HRV,16545,16545,119,147,-28,0.008884859,0.007192505,-0.0016923542
2019.0,HRV,16602,16602,102,161,-59,0.009697626,0.006143838,-0.0035537886
2020.0,HRV,15861,15861,114,145,-31,0.00914192,0.007187441,-0.0019544796
2021.0,HRV,14695,14695,69,80,-11,0.0054440284,0.0046954746,-0.00074855395
2022.0,HRV,0,0,40,35,5,,,
1998.0,HTI,6,6,0,0,0,0.0,0.0,0.0
2000.0,HTI,9,9,0,0,0,0.0,0.0,0.0
2001.0,HTI,15,15,0,2,-2,0.13333334,0.0,-0.13333334
2002.0,HTI,24,24,3,0,3,0.0,0.125,0.125
2003.0,HTI,33,33,1,1,0,0.030303031,0.030303031,0.0
2004.0,HTI,40,40,3,5,-2,0.125,0.075,-0.05
2005.0,HTI,48,48,2,2,0,0.041666668,0.041666668,0.0
2006.0,HTI,62,62,11,4,7,0.06451613,0.17741935,0.11290322
2007.0,HTI,65,65,3,1,2,0.015384615,0.046153847,0.03076923
2008.0,HTI,69,69,1,2,-1,0.028985508,0.014492754,-0.014492754
2009.0,HTI,77,77,0,2,-2,0.025974026,0.0,-0.025974026
2010.0,HTI,79,79,1,3,-2,0.03797468,0.012658228,-0.025316456
2011.0,HTI,110,110,7,1,6,0.009090909,0.06363636,0.054545455
2012.0,HTI,133,133,9,11,-2,0.082706764,0.067669176,-0.015037594
2013.0,HTI,154,154,8,12,-4,0.077922076,0.051948052,-0.025974026
2014.0,HTI,182,182,15,7,8,0.03846154,0.082417585,0.043956045
2015.0,HTI,206,206,11,10,1,0.048543688,0.053398058,0.004854369
2016.0,HTI,218,218,8,9,-1,0.041284405,0.036697246,-0.0045871558
2017.0,HTI,249,249,14,8,6,0.032128513,0.0562249,0.024096385
2018.0,HTI,255,255,7,8,-1,0.03137255,0.02745098,-0.003921569
2019.0,HTI,248,248,8,9,-1,0.03629032,0.032258064,-0.004032258
2020.0,HTI,240,240,9,4,5,0.016666668,0.0375,0.020833334
2021.0,HTI,221,221,6,6,0,0.027149322,0.027149322,0.0
1996.0,HUN,3770,3770,0,0,0,0.0,0.0,0.0
1997.0,HUN,4892,4892,59,26,33,0.0053147995,0.012060507,0.0067457072
1998.0,HUN,7087,7087,65,62,3,0.008748412,0.009171722,0.0004233103
1999.0,HUN,8984,8984,101,118,-17,0.013134461,0.011242208,-0.0018922529
2000.0,HUN,10321,10321,72,136,-64,0.013177018,0.006976068,-0.0062009497
2001.0,HUN,11481,11481,173,194,-21,0.016897483,0.015068374,-0.0018291089
2002.0,HUN,12571,12571,221,261,-40,0.020762071,0.017580144,-0.0031819267
2003.0,HUN,13560,13560,235,247,-12,0.01821534,0.017330384,-0.00088495575
2004.0,HUN,14350,14350,193,221,-28,0.015400697,0.013449477,-0.0019512195
2005.0,HUN,15123,15123,182,218,-36,0.014415129,0.012034649,-0.00238048
2006.0,HUN,15992,15992,187,216,-29,0.013506753,0.011693346,-0.0018134067
2007.0,HUN,16841,16841,205,192,13,0.011400748,0.012172674,0.00077192567
2008.0,HUN,17623,17623,191,250,-59,0.014186007,0.010838109,-0.0033478977
2009.0,HUN,18371,18371,182,302,-120,0.016438954,0.009906919,-0.0065320344
2010.0,HUN,19051,19051,191,288,-97,0.0151173165,0.01002572,-0.0050915964
2011.0,HUN,19770,19770,202,303,-101,0.015326252,0.010217501,-0.0051087504
2012.0,HUN,20597,20597,186,277,-91,0.013448561,0.009030442,-0.0044181193
2013.0,HUN,21401,21401,247,310,-63,0.014485304,0.0115415165,-0.0029437877
2014.0,HUN,22236,22236,229,312,-83,0.0140313,0.010298615,-0.0037326857
2015.0,HUN,22834,22834,228,312,-84,0.013663835,0.00998511,-0.0036787246
2016.0,HUN,23450,23450,246,350,-104,0.014925373,0.010490405,-0.004434968
2017.0,HUN,23911,23911,276,333,-57,0.013926645,0.011542805,-0.00238384
2018.0,HUN,24258,24258,264,361,-97,0.014881688,0.010883008,-0.003998681
2019.0,HUN,24233,24233,294,320,-26,0.013205133,0.012132216,-0.0010729171
2020.0,HUN,23136,23136,274,304,-30,0.013139696,0.011843015,-0.0012966805
2021.0,HUN,21434,21434,218,226,-8,0.010543996,0.010170757,-0.00037323878
1996.0,IDN,303,303,0,0,0,0.0,0.0,0.0
1997.0,IDN,391,391,5,8,-3,0.020460358,0.012787724,-0.0076726344
1998.0,IDN,717,717,2,4,-2,0.0055788006,0.0027894003,-0.0027894003
1999.0,IDN,975,975,15,20,-5,0.020512821,0.015384615,-0.0051282053
2000.0,IDN,1208,1208,25,14,11,0.011589404,0.020695364,0.00910596
2001.0,IDN,1401,1401,50,42,8,0.029978586,0.035688795,0.005710207
2002.0,IDN,1656,1656,70,62,8,0.037439615,0.04227053,0.004830918
2003.0,IDN,1909,1909,82,48,34,0.025144054,0.042954426,0.017810373
2004.0,IDN,2231,2231,93,40,53,0.01792918,0.041685343,0.023756163
2005.0,IDN,2557,2557,94,36,58,0.014078999,0.03676183,0.02268283
2006.0,IDN,2937,2937,102,46,56,0.01566224,0.034729317,0.019067075
2007.0,IDN,3539,3539,128,51,77,0.014410851,0.036168408,0.021757558
2008.0,IDN,4292,4292,132,64,68,0.0149114635,0.030754892,0.01584343
2009.0,IDN,5346,5346,198,63,135,0.011784512,0.037037037,0.025252525
2010.0,IDN,6674,6674,228,85,143,0.012735991,0.03416242,0.021426432
2011.0,IDN,8352,8352,235,104,131,0.012452107,0.028136972,0.015684865
2012.0,IDN,10576,10576,273,98,175,0.009266263,0.025813162,0.0165469
2013.0,IDN,13705,13705,342,114,228,0.008318132,0.024954395,0.016636264
2014.0,IDN,17688,17688,411,152,259,0.008593396,0.023236092,0.014642696
2015.0,IDN,23102,23102,471,152,319,0.006579517,0.020387845,0.013808329
2016.0,IDN,29730,29730,517,166,351,0.0055835857,0.017389841,0.011806256
2017.0,IDN,37936,37936,603,202,401,0.0053247577,0.015895192,0.010570435
2018.0,IDN,44478,44478,618,233,385,0.005238545,0.0138945095,0.008655964
2019.0,IDN,47612,47612,646,281,365,0.0059018736,0.013568008,0.0076661347
2020.0,IDN,47466,47466,627,302,325,0.006362449,0.013209456,0.0068470063
2021.0,IDN,45997,45997,403,277,126,0.006022132,0.008761441,0.002739309
2022.0,IDN,0,0,193,142,51,,,
1996.0,IND,16963,16963,0,0,0,0.0,0.0,0.0
1997.0,IND,20425,20425,90,94,-4,0.004602203,0.0044063646,-0.00019583844
1998.0,IND,33169,33169,125,204,-79,0.006150321,0.003768579,-0.002381742
1999.0,IND,44895,44895,200,392,-192,0.008731484,0.004454839,-0.0042766454
2000.0,IND,55219,55219,191,393,-202,0.0071171154,0.0034589544,-0.003658161
2001.0,IND,65333,65333,438,766,-328,0.011724549,0.006704116,-0.0050204336
2002.0,IND,75787,75787,617,1073,-456,0.014158101,0.008141238,-0.006016863
2003.0,IND,85649,85649,672,1127,-455,0.013158356,0.007845976,-0.0053123794
2004.0,IND,95185,95185,592,1297,-705,0.013626097,0.006219467,-0.007406629
2005.0,IND,105960,105960,730,1368,-638,0.012910532,0.006889392,-0.00602114
2006.0,IND,117997,117997,829,1522,-693,0.012898633,0.0070256023,-0.0058730305
2007.0,IND,132956,132956,942,1719,-777,0.012929089,0.007085051,-0.0058440384
2008.0,IND,151044,151044,1006,1952,-946,0.012923387,0.006660311,-0.006263076
2009.0,IND,172885,172885,1228,2202,-974,0.012736791,0.0071029877,-0.0056338026
2010.0,IND,194481,194481,1394,2395,-1001,0.012314828,0.007167795,-0.0051470324
2011.0,IND,217142,217142,1579,2393,-814,0.011020438,0.007271739,-0.003748699
2012.0,IND,242141,242141,1707,2572,-865,0.01062191,0.007049612,-0.0035722987
2013.0,IND,265934,265934,1945,2740,-795,0.010303308,0.0073138447,-0.0029894635
2014.0,IND,286706,286706,2060,2906,-846,0.010135818,0.0071850605,-0.002950758
2015.0,IND,304018,304018,2092,3136,-1044,0.010315179,0.0068811714,-0.0034340073
2016.0,IND,320769,320769,2098,3490,-1392,0.010880103,0.006540532,-0.0043395716
2017.0,IND,337370,337370,2131,3866,-1735,0.011459229,0.0063165072,-0.005142722
2018.0,IND,350627,350627,2327,4105,-1778,0.011707598,0.0066366824,-0.005070916
2019.0,IND,354273,354273,2351,4282,-1931,0.012086724,0.006636125,-0.005450599
2020.0,IND,336934,336934,2470,4363,-1893,0.012949124,0.0073308125,-0.005618311
2021.0,IND,311213,311213,1897,3032,-1135,0.009742524,0.006095504,-0.0036470199
2022.0,IND,0,0,1205,1616,-411,,,
1996.0,IRL,1706,1706,0,0,0,0.0,0.0,0.0
1997.0,IRL,1967,1967,43,33,10,0.016776817,0.021860702,0.005083884
1998.0,IRL,3219,3219,61,39,22,0.012115564,0.018949984,0.006834421
1999.0,IRL,4509,4509,149,125,24,0.027722333,0.03304502,0.005322688
2000.0,IRL,5549,5549,87,91,-4,0.016399352,0.0156785,-0.0007208506
2001.0,IRL,6481,6481,236,184,52,0.028390681,0.036414135,0.008023453
2002.0,IRL,7765,7765,365,265,100,0.034127496,0.047005795,0.0128783
2003.0,IRL,8921,8921,395,273,122,0.03060195,0.04427755,0.013675597
2004.0,IRL,9947,9947,370,309,61,0.031064643,0.037197147,0.006132502
2005.0,IRL,10966,10966,437,328,109,0.029910633,0.039850447,0.009939814
2006.0,IRL,12206,12206,487,348,139,0.028510569,0.03989841,0.011387842
2007.0,IRL,13478,13478,505,393,112,0.02915863,0.037468467,0.008309838
2008.0,IRL,14889,14889,581,452,129,0.030357983,0.039022096,0.008664114
2009.0,IRL,16269,16269,646,488,158,0.029995697,0.03970742,0.009711722
2010.0,IRL,17425,17425,662,581,81,0.033342898,0.037991393,0.0046484936
2011.0,IRL,18390,18390,565,651,-86,0.035399675,0.03072322,-0.0046764547
2012.0,IRL,19195,19195,543,768,-225,0.04001042,0.028288618,-0.011721803
2013.0,IRL,19935,19935,592,792,-200,0.03972912,0.029696513,-0.010032606
2014.0,IRL,20512,20512,629,847,-218,0.041292902,0.030664977,-0.010627925
2015.0,IRL,21228,21228,719,820,-101,0.038628228,0.03387036,-0.004757867
2016.0,IRL,21900,21900,727,840,-113,0.038356163,0.03319635,-0.005159817
2017.0,IRL,22622,22622,757,748,9,0.03306516,0.033463,0.0003978428
2018.0,IRL,23448,23448,917,820,97,0.034971,0.039107814,0.0041368133
2019.0,IRL,23683,23683,944,833,111,0.03517291,0.039859816,0.004686906
2020.0,IRL,22748,22748,899,787,112,0.034596447,0.03951996,0.00492351
2021.0,IRL,21225,21225,745,600,145,0.028268551,0.035100117,0.0068315663
1996.0,IRN,668,668,0,0,0,0.0,0.0,0.0
1997.0,IRN,918,918,11,5,6,0.005446623,0.01198257,0.006535948
1998.0,IRN,1900,1900,11,8,3,0.004210526,0.0057894737,0.0015789474
1999.0,IRN,3197,3197,34,12,22,0.003753519,0.01063497,0.0068814512
2000.0,IRN,4788,4788,26,17,9,0.003550543,0.005430242,0.0018796993
2001.0,IRN,6689,6689,74,39,35,0.005830468,0.011062939,0.005232471
2002.0,IRN,9249,9249,128,75,53,0.008108985,0.013839334,0.005730349
2003.0,IRN,12818,12818,155,100,55,0.007801529,0.012092371,0.004290841
2004.0,IRN,17301,17301,192,103,89,0.005953413,0.011097624,0.0051442115
2005.0,IRN,23107,23107,194,140,54,0.00605877,0.008395724,0.0023369542
2006.0,IRN,30083,30083,238,189,49,0.0062826183,0.007911445,0.001628827
2007.0,IRN,38361,38361,295,261,34,0.006803785,0.007690102,0.0008863168
2008.0,IRN,47177,47177,289,352,-63,0.007461263,0.0061258664,-0.0013353964
2009.0,IRN,58242,58242,338,508,-170,0.008722228,0.0058033722,-0.0029188558
2010.0,IRN,69207,69207,364,689,-325,0.00995564,0.0052595837,-0.0046960567
2011.0,IRN,79330,79330,446,854,-408,0.010765159,0.005622085,-0.0051430734
2012.0,IRN,89007,89007,444,1072,-628,0.012043997,0.004988372,-0.007055625
2013.0,IRN,97641,97641,464,1362,-898,0.013949058,0.0047521023,-0.009196957
2014.0,IRN,106187,106187,557,1428,-871,0.013447974,0.005245463,-0.008202511
2015.0,IRN,113177,113177,595,1506,-911,0.013306591,0.005257252,-0.008049339
2016.0,IRN,119924,119924,690,1557,-867,0.0129832225,0.005753644,-0.0072295787
2017.0,IRN,126488,126488,676,1652,-976,0.013060528,0.0053443806,-0.0077161468
2018.0,IRN,132811,132811,663,1739,-1076,0.013093795,0.004992056,-0.008101739
2019.0,IRN,134157,134157,613,2101,-1488,0.015660755,0.0045692734,-0.011091483
2020.0,IRN,127461,127461,520,2200,-1680,0.01726018,0.0040796795,-0.013180503
2021.0,IRN,117613,117613,392,1525,-1133,0.012966254,0.0033329648,-0.009633289
2022.0,IRN,0,0,227,846,-619,,,
1996.0,IRQ,44,44,0,0,0,0.0,0.0,0.0
1997.0,IRQ,49,49,0,0,0,0.0,0.0,0.0
1998.0,IRQ,90,90,0,3,-3,0.033333335,0.0,-0.033333335
1999.0,IRQ,142,142,0,1,-1,0.0070422534,0.0,-0.0070422534
2000.0,IRQ,183,183,1,6,-5,0.032786883,0.0054644807,-0.027322404
2001.0,IRQ,228,228,5,1,4,0.004385965,0.021929825,0.01754386
2002.0,IRQ,259,259,3,3,0,0.011583012,0.011583012,0.0
2003.0,IRQ,292,292,2,4,-2,0.01369863,0.006849315,-0.006849315
2004.0,IRQ,362,362,5,4,1,0.011049724,0.0138121545,0.002762431
2005.0,IRQ,439,439,7,4,3,0.009111618,0.01594533,0.006833713
2006.0,IRQ,550,550,11,8,3,0.014545455,0.02,0.0054545454
2007.0,IRQ,772,772,19,17,2,0.022020726,0.024611399,0.0025906735
2008.0,IRQ,1051,1051,14,21,-7,0.01998097,0.013320647,-0.0066603236
2009.0,IRQ,1411,1411,27,22,5,0.015591779,0.019135365,0.003543586
2010.0,IRQ,1800,1800,34,39,-5,0.021666666,0.018888889,-0.0027777778
2011.0,IRQ,2161,2161,48,25,23,0.011568719,0.02221194,0.0106432205
2012.0,IRQ,2531,2531,63,39,24,0.015408929,0.024891347,0.009482418
2013.0,IRQ,3011,3011,99,44,55,0.014613085,0.032879442,0.018266357
2014.0,IRQ,3868,3868,109,49,60,0.012668045,0.028179938,0.015511893
2015.0,IRQ,5092,5092,150,55,95,0.010801257,0.029457973,0.018656716
2016.0,IRQ,8346,8346,250,89,161,0.010663791,0.029954469,0.019290678
2017.0,IRQ,12148,12148,317,74,243,0.006091538,0.02609483,0.020003293
2018.0,IRQ,15101,15101,479,82,397,0.0054301037,0.031719755,0.02628965
2019.0,IRQ,16465,16465,543,109,434,0.006620103,0.032979045,0.026358943
2020.0,IRQ,16768,16768,458,110,348,0.0065601147,0.02731393,0.020753818
2021.0,IRQ,16503,16503,249,108,141,0.0065442645,0.015088166,0.008543901
2022.0,IRQ,0,0,126,56,70,,,
1996.0,ISL,174,174,0,0,0,0.0,0.0,0.0
1997.0,ISL,249,249,2,2,0,0.008032128,0.008032128,0.0
1998.0,ISL,367,367,8,2,6,0.005449591,0.021798365,0.016348774
1999.0,ISL,524,524,13,11,2,0.020992367,0.024809161,0.003816794
2000.0,ISL,706,706,15,9,6,0.012747875,0.02124646,0.008498584
2001.0,ISL,828,828,35,11,24,0.013285024,0.04227053,0.028985508
2002.0,ISL,979,979,65,31,34,0.031664964,0.06639428,0.034729317
2003.0,ISL,1071,1071,52,46,6,0.042950515,0.048552755,0.005602241
2004.0,ISL,1185,1185,32,25,7,0.021097047,0.02700422,0.005907173
2005.0,ISL,1249,1249,38,26,12,0.020816654,0.03042434,0.009607686
2006.0,ISL,1335,1335,49,46,3,0.034456927,0.03670412,0.002247191
2007.0,ISL,1437,1437,39,35,4,0.024356298,0.027139874,0.002783577
2008.0,ISL,1563,1563,53,30,23,0.019193858,0.03390915,0.014715292
2009.0,ISL,1658,1658,44,38,6,0.02291918,0.026537998,0.0036188178
2010.0,ISL,1792,1792,75,34,41,0.018973215,0.04185268,0.022879465
2011.0,ISL,1857,1857,46,49,-3,0.026386645,0.024771137,-0.0016155089
2012.0,ISL,1936,1936,57,50,7,0.025826447,0.029442148,0.0036157025
2013.0,ISL,1983,1983,54,58,-4,0.029248614,0.027231468,-0.0020171457
2014.0,ISL,2074,2074,65,66,-1,0.031822566,0.031340405,-0.00048216007
2015.0,ISL,2174,2174,91,57,34,0.02621895,0.041858327,0.015639374
2016.0,ISL,2248,2248,68,58,10,0.025800712,0.03024911,0.0044483985
2017.0,ISL,2335,2335,76,50,26,0.021413276,0.03254818,0.011134904
2018.0,ISL,2413,2413,74,60,14,0.024865313,0.03066722,0.0058019063
2019.0,ISL,2463,2463,104,66,38,0.026796589,0.04222493,0.015428339
2020.0,ISL,2375,2375,77,73,4,0.030736841,0.032421052,0.0016842105
2021.0,ISL,2237,2237,59,49,10,0.021904336,0.026374608,0.0044702725
1996.0,ISR,5222,5222,0,0,0,0.0,0.0,0.0
1997.0,ISR,6126,6126,68,75,-7,0.012242899,0.011100229,-0.0011426706
1998.0,ISR,11230,11230,172,118,54,0.010507569,0.015316118,0.0048085484
1999.0,ISR,15607,15607,259,178,81,0.011405138,0.016595118,0.005189979
2000.0,ISR,18600,18600,194,152,42,0.008172043,0.010430108,0.0022580645
2001.0,ISR,21145,21145,393,389,4,0.018396784,0.018585954,0.00018917002
2002.0,ISR,23592,23592,518,587,-69,0.024881316,0.021956595,-0.0029247203
2003.0,ISR,25504,25504,448,656,-208,0.025721455,0.017565873,-0.008155583
2004.0,ISR,26898,26898,376,609,-233,0.022641089,0.013978735,-0.008662354
2005.0,ISR,28065,28065,369,598,-229,0.021307679,0.013148049,-0.008159629
2006.0,ISR,29175,29175,364,603,-239,0.02066838,0.012476435,-0.008191945
2007.0,ISR,30203,30203,388,585,-197,0.019368937,0.012846406,-0.0065225307
2008.0,ISR,31153,31153,417,594,-177,0.019067185,0.013385549,-0.005681636
2009.0,ISR,31880,31880,511,668,-157,0.020953575,0.016028859,-0.004924718
2010.0,ISR,32810,32810,498,632,-134,0.01926242,0.0151782995,-0.0040841205
2011.0,ISR,33675,33675,566,619,-53,0.018381588,0.01680772,-0.0015738679
2012.0,ISR,34648,34648,578,677,-99,0.019539367,0.01668206,-0.0028573077
2013.0,ISR,35911,35911,636,633,3,0.017626911,0.017710451,8.353986e-05
2014.0,ISR,37109,37109,692,682,10,0.018378291,0.018647768,0.0002694764
2015.0,ISR,38424,38424,747,676,71,0.017593171,0.019440975,0.0018478035
2016.0,ISR,39604,39604,756,786,-30,0.01984648,0.019088982,-0.00075749925
2017.0,ISR,40392,40392,826,821,5,0.020325808,0.020449594,0.00012378689
2018.0,ISR,41126,41126,808,816,-8,0.019841462,0.019646939,-0.00019452414
2019.0,ISR,41144,41144,860,805,55,0.01956543,0.020902198,0.0013367684
2020.0,ISR,39517,39517,897,840,57,0.021256674,0.022699092,0.0014424172
2021.0,ISR,36790,36790,722,652,70,0.017722206,0.019624898,0.001902691
1996.0,ITA,34039,34039,0,0,0,0.0,0.0,0.0
1997.0,ITA,39030,39030,366,307,59,0.007865745,0.009377402,0.0015116577
1998.0,ITA,62457,62457,419,504,-85,0.008069552,0.0067086155,-0.0013609363
1999.0,ITA,82367,82367,708,741,-33,0.008996321,0.008595675,-0.0004006459
2000.0,ITA,96917,96917,574,627,-53,0.006469453,0.0059225936,-0.0005468597
2001.0,ITA,110223,110223,1181,1194,-13,0.010832584,0.010714642,-0.00011794271
2002.0,ITA,123700,123700,1661,1611,50,0.0130234435,0.013427648,0.00040420372
2003.0,ITA,134332,134332,1566,1586,-20,0.011806569,0.011657684,-0.00014888485
2004.0,ITA,143404,143404,1255,1399,-144,0.009755655,0.0087514995,-0.0010041561
2005.0,ITA,152290,152290,1274,1509,-235,0.009908726,0.008365618,-0.0015431085
2006.0,ITA,161040,161040,1457,1577,-120,0.009792598,0.009047441,-0.0007451565
2007.0,ITA,169086,169086,1440,1784,-344,0.010550844,0.008516376,-0.0020344676
2008.0,ITA,176182,176182,1425,1998,-573,0.0113405455,0.008088227,-0.0032523186
2009.0,ITA,182641,182641,1434,2249,-815,0.012313774,0.007851468,-0.004462306
2010.0,ITA,189368,189368,1554,2405,-851,0.01270014,0.008206244,-0.0044938955
2011.0,ITA,196946,196946,1585,2647,-1062,0.013440233,0.008047891,-0.005392341
2012.0,ITA,203791,203791,1759,2772,-1013,0.013602171,0.008631392,-0.0049707787
2013.0,ITA,210210,210210,1899,2965,-1066,0.014104943,0.009033823,-0.0050711194
2014.0,ITA,216262,216262,2042,3114,-1072,0.014399201,0.00944225,-0.0049569504
2015.0,ITA,221603,221603,2122,3241,-1119,0.014625253,0.009575683,-0.0050495705
2016.0,ITA,226090,226090,2065,3574,-1509,0.015807863,0.009133531,-0.006674333
2017.0,ITA,231024,231024,2226,3669,-1443,0.015881468,0.009635363,-0.0062461044
2018.0,ITA,237549,237549,2560,3713,-1153,0.01563046,0.010776724,-0.004853735
2019.0,ITA,238090,238090,2597,3531,-934,0.014830526,0.01090764,-0.003922886
2020.0,ITA,227647,227647,2706,3164,-458,0.013898712,0.011886825,-0.0020118868
2021.0,ITA,213416,213416,2333,2361,-28,0.011062901,0.010931701,-0.00013119917
2022.0,ITA,0,0,1351,1287,64,,,
1996.0,JAM,79,79,0,0,0,0.0,0.0,0.0
1997.0,JAM,88,88,2,2,0,0.022727273,0.022727273,0.0
1998.0,JAM,159,159,4,2,2,0.012578616,0.025157232,0.012578616
1999.0,JAM,227,227,1,6,-5,0.026431719,0.004405286,-0.02202643
2000.0,JAM,272,272,1,4,-3,0.014705882,0.0036764706,-0.011029412
2001.0,JAM,304,304,7,9,-2,0.029605264,0.023026315,-0.0065789474
2002.0,JAM,366,366,12,10,2,0.027322404,0.032786883,0.0054644807
2003.0,JAM,405,405,9,6,3,0.014814815,0.022222223,0.0074074073
2004.0,JAM,434,434,12,12,0,0.02764977,0.02764977,0.0
2005.0,JAM,455,455,3,10,-7,0.021978023,0.0065934067,-0.015384615
2006.0,JAM,495,495,10,15,-5,0.030303031,0.02020202,-0.01010101
2007.0,JAM,513,513,10,9,1,0.01754386,0.019493178,0.0019493178
2008.0,JAM,529,529,11,9,2,0.017013233,0.02079395,0.0037807184
2009.0,JAM,551,551,11,13,-2,0.023593467,0.019963702,-0.003629764
2010.0,JAM,570,570,13,22,-9,0.038596492,0.022807017,-0.015789473
2011.0,JAM,560,560,19,10,9,0.017857144,0.033928573,0.01607143
2012.0,JAM,583,583,14,6,8,0.010291595,0.024013722,0.013722127
2013.0,JAM,593,593,17,12,5,0.020236088,0.02866779,0.008431703
2014.0,JAM,592,592,15,13,2,0.02195946,0.025337838,0.0033783785
2015.0,JAM,570,570,14,18,-4,0.031578947,0.024561403,-0.007017544
2016.0,JAM,578,578,22,16,6,0.027681662,0.038062282,0.010380623
2017.0,JAM,572,572,16,10,6,0.017482517,0.027972028,0.01048951
2018.0,JAM,575,575,12,17,-5,0.029565217,0.020869566,-0.008695652
2019.0,JAM,573,573,20,20,0,0.034904014,0.034904014,0.0
2020.0,JAM,517,517,10,17,-7,0.032882012,0.01934236,-0.013539651
2021.0,JAM,469,469,14,9,5,0.019189766,0.029850746,0.010660981
1996.0,JOR,276,276,0,0,0,0.0,0.0,0.0
1997.0,JOR,350,350,3,1,2,0.0028571428,0.008571428,0.0057142857
1998.0,JOR,633,633,13,11,2,0.017377567,0.020537125,0.0031595577
1999.0,JOR,897,897,17,7,10,0.0078037903,0.018952062,0.011148272
2000.0,JOR,1111,1111,11,10,1,0.0090009,0.00990099,0.00090009003
2001.0,JOR,1282,1282,30,45,-15,0.035101403,0.023400936,-0.011700468
2002.0,JOR,1512,1512,49,32,17,0.02116402,0.032407407,0.011243386
2003.0,JOR,1704,1704,58,36,22,0.02112676,0.03403756,0.012910798
2004.0,JOR,1952,1952,71,40,31,0.020491803,0.036372952,0.015881147
2005.0,JOR,2201,2201,78,51,27,0.023171285,0.035438437,0.012267151
2006.0,JOR,2642,2642,103,43,60,0.01627555,0.038985617,0.022710068
2007.0,JOR,3058,3058,111,68,43,0.022236757,0.036298234,0.014061478
2008.0,JOR,3561,3561,127,56,71,0.01572592,0.035664137,0.01993822
2009.0,JOR,3961,3961,116,81,35,0.020449381,0.029285533,0.008836152
2010.0,JOR,4288,4288,119,131,-12,0.030550374,0.027751865,-0.0027985075
2011.0,JOR,4508,4508,130,126,4,0.027950311,0.028837621,0.0008873115
2012.0,JOR,4736,4736,154,143,11,0.030194256,0.032516893,0.0023226351
2013.0,JOR,4849,4849,141,139,2,0.028665705,0.029078161,0.00041245617
2014.0,JOR,5160,5160,182,140,42,0.027131783,0.035271317,0.008139535
2015.0,JOR,5520,5520,194,131,63,0.023731884,0.03514493,0.011413043
2016.0,JOR,6086,6086,218,161,57,0.026454156,0.035819914,0.009365758
2017.0,JOR,6831,6831,225,169,56,0.024740156,0.032938078,0.008197921
2018.0,JOR,7743,7743,248,182,66,0.023505101,0.03202893,0.008523828
2019.0,JOR,8283,8283,248,197,51,0.023783654,0.029940844,0.0061571896
2020.0,JOR,8173,8173,236,212,24,0.025939068,0.028875565,0.0029364983
2021.0,JOR,7818,7818,164,160,4,0.020465592,0.020977233,0.0005116398
2022.0,JOR,0,0,86,87,-1,,,
1996.0,JPN,68110,68110,0,0,0,0.0,0.0,0.0
1997.0,JPN,79010,79010,376,270,106,0.003417289,0.004758891,0.0013416023
1998.0,JPN,134158,134158,561,519,42,0.0038685729,0.0041816365,0.0003130637
1999.0,JPN,177575,177575,953,1008,-55,0.005676475,0.0053667463,-0.0003097283
2000.0,JPN,208505,208505,764,749,15,0.00359224,0.0036641806,7.194072e-05
2001.0,JPN,234770,234770,1748,1909,-161,0.0081313625,0.007445585,-0.0006857776
2002.0,JPN,261062,261062,2287,2694,-407,0.010319388,0.008760371,-0.0015590166
2003.0,JPN,280053,280053,2217,2747,-530,0.009808858,0.007916358,-0.0018924989
2004.0,JPN,292351,292351,1877,2502,-625,0.008558205,0.0064203646,-0.0021378412
2005.0,JPN,300941,300941,1954,2596,-642,0.008626276,0.0064929673,-0.0021333084
2006.0,JPN,308603,308603,1979,2514,-535,0.008146388,0.0064127697,-0.0017336189
2007.0,JPN,315716,315716,2041,2587,-546,0.008194073,0.006464671,-0.0017294023
2008.0,JPN,320591,320591,2047,2698,-651,0.008415707,0.0063850824,-0.0020306248
2009.0,JPN,325305,325305,2187,2818,-631,0.00866264,0.0067229215,-0.0019397181
2010.0,JPN,329591,329591,2196,2776,-580,0.00842256,0.0066628032,-0.0017597568
2011.0,JPN,333729,333729,2302,2742,-440,0.008216247,0.0068978122,-0.0013184351
2012.0,JPN,337087,337087,2146,2759,-613,0.008184831,0.006366309,-0.0018185216
2013.0,JPN,340779,340779,2251,2920,-669,0.008568604,0.006605454,-0.001963149
2014.0,JPN,343965,343965,2269,2894,-625,0.008413646,0.0065966016,-0.0018170454
2015.0,JPN,346708,346708,2193,2838,-645,0.008185563,0.006325207,-0.0018603551
2016.0,JPN,347708,347708,2390,2846,-456,0.008185029,0.0068735834,-0.0013114453
2017.0,JPN,347669,347669,2419,2802,-383,0.00805939,0.0069577675,-0.0011016225
2018.0,JPN,346826,346826,2388,2857,-469,0.00823756,0.006885297,-0.0013522631
2019.0,JPN,338572,338572,2459,2914,-455,0.008606737,0.007262857,-0.0013438796
2020.0,JPN,316019,316019,2271,2758,-487,0.008727323,0.007186277,-0.0015410465
2021.0,JPN,287040,287040,1731,1935,-204,0.0067412206,0.0060305186,-0.0007107023
2022.0,JPN,0,0,981,1037,-56,,,
1996.0,KAZ,253,253,0,0,0,0.0,0.0,0.0
1997.0,KAZ,289,289,3,7,-4,0.024221454,0.010380623,-0.013840831
1998.0,KAZ,382,382,6,7,-1,0.018324608,0.015706806,-0.002617801
1999.0,KAZ,471,471,4,13,-9,0.027600849,0.008492569,-0.01910828
2000.0,KAZ,553,553,10,8,2,0.0144665465,0.018083183,0.0036166366
2001.0,KAZ,644,644,13,8,5,0.0124223605,0.020186335,0.0077639753
2002.0,KAZ,699,699,11,17,-6,0.024320457,0.015736766,-0.008583691
2003.0,KAZ,768,768,12,12,0,0.015625,0.015625,0.0
2004.0,KAZ,796,796,15,13,2,0.016331658,0.01884422,0.0025125628
2005.0,KAZ,828,828,22,15,7,0.018115941,0.026570048,0.008454106
2006.0,KAZ,871,871,19,7,12,0.008036739,0.021814007,0.013777267
2007.0,KAZ,954,954,24,14,10,0.014675053,0.025157232,0.01048218
2008.0,KAZ,1035,1035,24,16,8,0.015458937,0.023188407,0.0077294684
2009.0,KAZ,1110,1110,17,18,-1,0.016216217,0.015315316,-0.0009009009
2010.0,KAZ,1374,1374,18,17,1,0.012372634,0.013100437,0.00072780205
2011.0,KAZ,2519,2519,34,18,16,0.0071456926,0.01349742,0.006351727
2012.0,KAZ,4006,4006,52,15,37,0.0037443833,0.012980529,0.009236146
2013.0,KAZ,5215,5215,55,23,32,0.004410355,0.010546501,0.006136146
2014.0,KAZ,7104,7104,91,36,55,0.0050675673,0.0128096845,0.007742117
2015.0,KAZ,8481,8481,90,48,42,0.00565971,0.010611956,0.0049522463
2016.0,KAZ,9533,9533,119,76,43,0.007972307,0.012482954,0.004510647
2017.0,KAZ,10455,10455,121,99,22,0.009469153,0.01157341,0.0021042563
2018.0,KAZ,11261,11261,138,99,39,0.008791404,0.012254684,0.0034632804
2019.0,KAZ,11424,11424,138,122,16,0.010679272,0.012079832,0.0014005603
2020.0,KAZ,10987,10987,119,109,10,0.009920816,0.010830982,0.00091016653
2021.0,KAZ,10125,10125,101,74,27,0.007308642,0.009975309,0.0026666666
1996.0,KEN,262,262,0,0,0,0.0,0.0,0.0
1997.0,KEN,303,303,4,2,2,0.0066006603,0.013201321,0.0066006603
1998.0,KEN,579,579,8,8,0,0.013816926,0.013816926,0.0
1999.0,KEN,849,849,9,22,-13,0.025912838,0.010600707,-0.0153121315
2000.0,KEN,1084,1084,10,16,-6,0.014760148,0.009225092,-0.0055350554
2001.0,KEN,1332,1332,48,40,8,0.03003003,0.036036037,0.006006006
2002.0,KEN,1592,1592,71,66,5,0.041457288,0.04459799,0.0031407035
2003.0,KEN,1802,1802,80,68,12,0.03773585,0.044395115,0.0066592675
2004.0,KEN,2010,2010,80,64,16,0.031840798,0.039800994,0.007960199
2005.0,KEN,2215,2215,61,66,-5,0.02979684,0.027539503,-0.0022573364
2006.0,KEN,2490,2490,70,73,-3,0.02931727,0.02811245,-0.0012048193
2007.0,KEN,2816,2816,108,88,20,0.03125,0.038352273,0.007102273
2008.0,KEN,3154,3154,88,90,-2,0.028535193,0.027901078,-0.0006341154
2009.0,KEN,3520,3520,102,77,25,0.021875,0.028977273,0.007102273
2010.0,KEN,3836,3836,124,120,4,0.031282585,0.03232534,0.0010427529
2011.0,KEN,4118,4118,133,123,10,0.02986887,0.03229723,0.0024283633
2012.0,KEN,4535,4535,137,122,15,0.026901875,0.030209482,0.0033076075
2013.0,KEN,4881,4881,167,138,29,0.028272895,0.0342143,0.0059414054
2014.0,KEN,5219,5219,190,159,31,0.030465607,0.03640544,0.005939835
2015.0,KEN,5489,5489,183,210,-27,0.038258336,0.033339407,-0.0049189287
2016.0,KEN,5887,5887,206,192,14,0.032614235,0.034992356,0.0023781213
2017.0,KEN,6264,6264,248,183,65,0.02921456,0.039591316,0.010376756
2018.0,KEN,6651,6651,241,218,23,0.032777026,0.036235154,0.0034581267
2019.0,KEN,6792,6792,261,240,21,0.03533569,0.03842756,0.003091873
2020.0,KEN,6549,6549,227,219,8,0.03344022,0.03466178,0.0012215605
2021.0,KEN,6089,6089,163,140,23,0.022992281,0.026769584,0.0037773033
1996.0,KGZ,19,19,0,0,0,0.0,0.0,0.0
1997.0,KGZ,24,24,0,0,0,0.0,0.0,0.0
1998.0,KGZ,46,46,0,0,0,0.0,0.0,0.0
1999.0,KGZ,58,58,1,0,1,0.0,0.01724138,0.01724138
2000.0,KGZ,61,61,0,2,-2,0.032786883,0.0,-0.032786883
2001.0,KGZ,67,67,4,2,2,0.029850746,0.05970149,0.029850746
2002.0,KGZ,78,78,2,5,-3,0.06410257,0.025641026,-0.03846154
2003.0,KGZ,85,85,4,3,1,0.03529412,0.047058824,0.011764706
2004.0,KGZ,89,89,1,2,-1,0.02247191,0.011235955,-0.011235955
2005.0,KGZ,99,99,4,2,2,0.02020202,0.04040404,0.02020202
2006.0,KGZ,101,101,1,3,-2,0.02970297,0.00990099,-0.01980198
2007.0,KGZ,118,118,3,5,-2,0.042372882,0.025423728,-0.016949153
2008.0,KGZ,118,118,2,2,0,0.016949153,0.016949153,0.0
2009.0,KGZ,125,125,4,3,1,0.024,0.032,0.008
2010.0,KGZ,150,150,7,6,1,0.04,0.046666667,0.006666667
2011.0,KGZ,173,173,10,5,5,0.028901733,0.057803467,0.028901733
2012.0,KGZ,193,193,5,7,-2,0.03626943,0.025906736,-0.010362694
2013.0,KGZ,206,206,7,8,-1,0.03883495,0.033980582,-0.004854369
2014.0,KGZ,265,265,10,7,3,0.026415095,0.03773585,0.011320755
2015.0,KGZ,299,299,9,16,-7,0.053511705,0.030100334,-0.02341137
2016.0,KGZ,346,346,17,12,5,0.03468208,0.049132947,0.014450867
2017.0,KGZ,414,414,12,8,4,0.019323671,0.028985508,0.009661836
2018.0,KGZ,443,443,12,17,-5,0.03837472,0.027088037,-0.0112866815
2019.0,KGZ,471,471,15,9,6,0.01910828,0.031847134,0.012738854
2020.0,KGZ,464,464,22,11,11,0.023706896,0.047413792,0.023706896
2021.0,KGZ,426,426,13,11,2,0.025821596,0.030516433,0.0046948357
1996.0,KHM,3,3,0,0,0,0.0,0.0,0.0
1998.0,KHM,10,10,0,1,-1,0.1,0.0,-0.1
2000.0,KHM,36,36,0,0,0,0.0,0.0,0.0
2001.0,KHM,54,54,3,1,2,0.018518519,0.055555556,0.037037037
2002.0,KHM,80,80,3,1,2,0.0125,0.0375,0.025
2003.0,KHM,111,111,5,6,-1,0.054054055,0.045045044,-0.009009009
2004.0,KHM,134,134,3,2,1,0.014925373,0.02238806,0.0074626864
2005.0,KHM,175,175,7,3,4,0.017142856,0.04,0.022857143
2006.0,KHM,201,201,9,9,0,0.04477612,0.04477612,0.0
2007.0,KHM,227,227,8,10,-2,0.04405286,0.03524229,-0.008810572
2008.0,KHM,259,259,12,9,3,0.034749035,0.046332046,0.011583012
2009.0,KHM,313,313,16,11,5,0.03514377,0.05111821,0.015974442
2010.0,KHM,351,351,18,20,-2,0.05698006,0.051282052,-0.0056980057
2011.0,KHM,403,403,18,11,7,0.027295286,0.044665013,0.017369727
2012.0,KHM,435,435,19,27,-8,0.062068965,0.04367816,-0.018390805
2013.0,KHM,473,473,16,11,5,0.023255814,0.033826638,0.010570824
2014.0,KHM,502,502,21,18,3,0.035856575,0.04183267,0.005976096
2015.0,KHM,540,540,25,27,-2,0.05,0.046296295,-0.0037037036
2016.0,KHM,587,587,27,24,3,0.040885862,0.04599659,0.0051107327
2017.0,KHM,605,605,32,35,-3,0.05785124,0.052892562,-0.0049586776
2018.0,KHM,658,658,51,26,25,0.039513677,0.0775076,0.037993923
2019.0,KHM,640,640,35,29,6,0.0453125,0.0546875,0.009375
2020.0,KHM,599,599,27,35,-8,0.058430716,0.045075126,-0.013355592
2021.0,KHM,557,557,29,18,11,0.032315977,0.05206463,0.019748654
2013.0,KIR,2,2,1,0,1,0.0,0.5,0.5
2016.0,KIR,4,4,0,0,0,0.0,0.0,0.0
2020.0,KIR,3,3,1,0,1,0.0,0.33333334,0.33333334
1998.0,KNA,1,1,0,0,0,0.0,0.0,0.0
2001.0,KNA,2,2,1,0,1,0.0,0.5,0.5
2008.0,KNA,12,12,1,1,0,0.083333336,0.083333336,0.0
2009.0,KNA,14,14,2,0,2,0.0,0.14285715,0.14285715
2010.0,KNA,15,15,0,1,-1,0.06666667,0.0,-0.06666667
2012.0,KNA,29,29,6,1,5,0.03448276,0.20689656,0.1724138
2013.0,KNA,36,36,7,2,5,0.055555556,0.19444445,0.1388889
2014.0,KNA,48,48,6,1,5,0.020833334,0.125,0.104166664
2015.0,KNA,64,64,7,1,6,0.015625,0.109375,0.09375
2016.0,KNA,74,74,11,7,4,0.0945946,0.14864865,0.054054055
2017.0,KNA,79,79,10,9,1,0.11392405,0.12658228,0.012658228
2018.0,KNA,85,85,4,4,0,0.047058824,0.047058824,0.0
2019.0,KNA,80,80,1,4,-3,0.05,0.0125,-0.0375
2020.0,KNA,78,78,8,7,1,0.08974359,0.102564104,0.012820513
2021.0,KNA,69,69,3,4,-1,0.057971016,0.04347826,-0.014492754
1996.0,KOR,8906,8906,0,0,0,0.0,0.0,0.0
1997.0,KOR,11446,11446,101,64,37,0.005591473,0.008824043,0.0032325704
1998.0,KOR,21086,21086,190,99,91,0.0046950583,0.009010718,0.00431566
1999.0,KOR,30907,30907,317,205,112,0.0066328016,0.010256576,0.0036237745
2000.0,KOR,39261,39261,273,231,42,0.0058837016,0.0069534653,0.0010697639
2001.0,KOR,47485,47485,576,453,123,0.009539855,0.012130146,0.0025902917
2002.0,KOR,56727,56727,766,690,76,0.01216352,0.01350327,0.00133975
2003.0,KOR,65213,65213,942,773,169,0.011853465,0.014444972,0.0025915077
2004.0,KOR,73044,73044,915,777,138,0.010637424,0.012526697,0.0018892722
2005.0,KOR,81972,81972,1111,791,320,0.009649636,0.013553409,0.003903772
2006.0,KOR,91249,91249,1143,927,216,0.010159016,0.012526165,0.0023671493
2007.0,KOR,100723,100723,1304,994,310,0.00986865,0.012946398,0.003077748
2008.0,KOR,111406,111406,1364,1035,329,0.009290343,0.012243506,0.0029531624
2009.0,KOR,121377,121377,1373,1167,206,0.009614672,0.011311863,0.0016971914
2010.0,KOR,131692,131692,1519,1320,199,0.010023388,0.01153449,0.0015111016
2011.0,KOR,141457,141457,1553,1396,157,0.009868723,0.010978601,0.001109878
2012.0,KOR,152108,152108,1655,1357,298,0.008921293,0.010880427,0.0019591344
2013.0,KOR,162748,162748,1806,1594,212,0.009794283,0.011096911,0.0013026274
2014.0,KOR,172029,172029,1808,1674,134,0.009730917,0.010509856,0.0007789384
2015.0,KOR,180751,180751,1808,1640,168,0.009073256,0.010002711,0.00092945545
2016.0,KOR,187397,187397,1775,1802,-27,0.009615949,0.00947187,-0.00014407915
2017.0,KOR,193765,193765,1755,1863,-108,0.00961474,0.0090573635,-0.0005573762
2018.0,KOR,197788,197788,1778,2051,-273,0.010369689,0.008989423,-0.0013802657
2019.0,KOR,196345,196345,1764,2148,-384,0.010939927,0.008984186,-0.001955741
2020.0,KOR,183231,183231,1735,2234,-499,0.0121922605,0.009468921,-0.0027233383
2021.0,KOR,167684,167684,1496,1665,-169,0.009929391,0.008921543,-0.0010078481
2022.0,KOR,0,0,894,842,52,,,
1996.0,KWT,346,346,0,0,0,0.0,0.0,0.0
1997.0,KWT,402,402,4,2,2,0.0049751243,0.0099502485,0.0049751243
1998.0,KWT,673,673,6,5,1,0.0074294205,0.008915304,0.0014858841
1999.0,KWT,909,909,24,15,9,0.01650165,0.026402641,0.00990099
2000.0,KWT,1051,1051,11,16,-5,0.015223596,0.010466223,-0.004757374
2001.0,KWT,1162,1162,24,31,-7,0.026678141,0.020654045,-0.006024096
2002.0,KWT,1313,1313,42,42,0,0.031987812,0.031987812,0.0
2003.0,KWT,1445,1445,48,31,17,0.021453287,0.033217993,0.011764706
2004.0,KWT,1587,1587,61,27,34,0.017013233,0.038437303,0.02142407
2005.0,KWT,1705,1705,52,25,27,0.014662757,0.030498534,0.015835777
2006.0,KWT,1854,1854,63,33,30,0.017799353,0.033980582,0.01618123
2007.0,KWT,1967,1967,61,30,31,0.015251652,0.031011693,0.01576004
2008.0,KWT,2048,2048,46,40,6,0.01953125,0.022460938,0.0029296875
2009.0,KWT,2103,2103,58,37,21,0.017593913,0.027579648,0.009985735
2010.0,KWT,2161,2161,66,31,35,0.014345211,0.030541416,0.016196206
2011.0,KWT,2215,2215,62,39,23,0.017607223,0.02799097,0.0103837475
2012.0,KWT,2167,2167,53,49,4,0.022611907,0.024457775,0.0018458698
2013.0,KWT,2260,2260,74,42,32,0.01858407,0.032743365,0.014159292
2014.0,KWT,2335,2335,99,36,63,0.015417559,0.042398285,0.026980728
2015.0,KWT,2407,2407,92,60,32,0.024927296,0.038221855,0.013294557
2016.0,KWT,2517,2517,113,61,52,0.0242352,0.044894718,0.020659516
2017.0,KWT,2673,2673,129,66,63,0.024691358,0.048260383,0.023569023
2018.0,KWT,2822,2822,118,68,50,0.024096385,0.041814316,0.017717931
2019.0,KWT,2916,2916,137,85,52,0.02914952,0.04698217,0.017832648
2020.0,KWT,2866,2866,117,62,55,0.021632938,0.04082345,0.019190509
2021.0,KWT,2680,2680,60,38,22,0.014179105,0.02238806,0.008208956
1996.0,LAO,8,8,0,0,0,0.0,0.0,0.0
1997.0,LAO,8,8,0,0,0,0.0,0.0,0.0
1998.0,LAO,14,14,0,0,0,0.0,0.0,0.0
2000.0,LAO,26,26,1,0,1,0.0,0.03846154,0.03846154
2001.0,LAO,37,37,1,0,1,0.0,0.027027028,0.027027028
2002.0,LAO,50,50,5,4,1,0.08,0.1,0.02
2003.0,LAO,64,64,5,2,3,0.03125,0.078125,0.046875
2004.0,LAO,92,92,5,1,4,0.010869565,0.054347824,0.04347826
2005.0,LAO,109,109,5,5,0,0.04587156,0.04587156,0.0
2006.0,LAO,130,130,10,3,7,0.023076924,0.07692308,0.053846154
2007.0,LAO,144,144,7,9,-2,0.0625,0.048611112,-0.013888889
2008.0,LAO,169,169,10,3,7,0.01775148,0.0591716,0.041420117
2009.0,LAO,199,199,10,4,6,0.020100502,0.050251257,0.030150754
2010.0,LAO,230,230,7,5,2,0.02173913,0.030434782,0.008695652
2011.0,LAO,258,258,10,7,3,0.027131783,0.03875969,0.011627907
2012.0,LAO,289,289,16,10,6,0.034602076,0.055363324,0.020761246
2013.0,LAO,313,313,18,19,-1,0.060702875,0.057507988,-0.0031948881
2014.0,LAO,327,327,14,17,-3,0.051987767,0.042813454,-0.0091743115
2015.0,LAO,345,345,14,16,-2,0.046376813,0.04057971,-0.0057971017
2016.0,LAO,380,380,27,13,14,0.034210525,0.07105263,0.036842104
2017.0,LAO,402,402,28,21,7,0.052238807,0.06965174,0.017412934
2018.0,LAO,421,421,23,15,8,0.035629455,0.05463183,0.019002376
2019.0,LAO,420,420,18,21,-3,0.05,0.042857144,-0.007142857
2020.0,LAO,414,414,28,12,16,0.028985508,0.06763285,0.038647342
2021.0,LAO,370,370,9,7,2,0.018918918,0.024324324,0.0054054055
1996.0,LBN,141,141,0,0,0,0.0,0.0,0.0
1997.0,LBN,173,173,3,3,0,0.01734104,0.01734104,0.0
1998.0,LBN,378,378,5,5,0,0.013227513,0.013227513,0.0
1999.0,LBN,649,649,26,2,24,0.0030816642,0.040061634,0.03697997
2000.0,LBN,848,848,15,7,8,0.008254717,0.017688679,0.009433962
2001.0,LBN,1063,1063,40,22,18,0.020696143,0.03762935,0.016933208
2002.0,LBN,1246,1246,39,39,0,0.03130016,0.03130016,0.0
2003.0,LBN,1435,1435,63,37,26,0.025783973,0.043902438,0.018118467
2004.0,LBN,1627,1627,66,58,8,0.03564843,0.040565457,0.004917025
2005.0,LBN,1804,1804,72,48,24,0.02660754,0.039911307,0.01330377
2006.0,LBN,2021,2021,73,57,16,0.02820386,0.03612073,0.007916872
2007.0,LBN,2183,2183,68,68,0,0.031149793,0.031149793,0.0
2008.0,LBN,2307,2307,72,97,-25,0.042045947,0.031209363,-0.0108365845
2009.0,LBN,2485,2485,82,95,-13,0.038229376,0.03299799,-0.0052313884
2010.0,LBN,2689,2689,93,99,-6,0.03681666,0.03458535,-0.0022313127
2011.0,LBN,2906,2906,95,96,-1,0.0330351,0.032690983,-0.00034411563
2012.0,LBN,3252,3252,168,89,79,0.027367774,0.051660515,0.024292743
2013.0,LBN,3545,3545,141,116,25,0.032722145,0.03977433,0.007052186
2014.0,LBN,3931,3931,164,142,22,0.036123123,0.041719664,0.0055965404
2015.0,LBN,4393,4393,175,124,51,0.028226724,0.0398361,0.011609378
2016.0,LBN,4923,4923,208,167,41,0.033922404,0.04225066,0.008328255
2017.0,LBN,5447,5447,204,175,29,0.032127775,0.037451807,0.0053240317
2018.0,LBN,5989,5989,229,169,60,0.0282184,0.038236767,0.010018367
2019.0,LBN,6140,6140,198,202,-4,0.032899022,0.03224756,-0.0006514658
2020.0,LBN,5874,5874,173,249,-76,0.042390194,0.029451821,-0.012938373
2021.0,LBN,5408,5408,112,205,-93,0.037906803,0.020710059,-0.017196745
2003.0,LBR,3,3,0,0,0,0.0,0.0,0.0
2004.0,LBR,4,4,0,0,0,0.0,0.0,0.0
2005.0,LBR,3,3,0,1,-1,0.33333334,0.0,-0.33333334
2006.0,LBR,3,3,0,0,0,0.0,0.0,0.0
2010.0,LBR,21,21,0,0,0,0.0,0.0,0.0
2011.0,LBR,27,27,2,0,2,0.0,0.074074075,0.074074075
2012.0,LBR,38,38,3,1,2,0.02631579,0.078947365,0.05263158
2013.0,LBR,54,54,3,2,1,0.037037037,0.055555556,0.018518519
2014.0,LBR,65,65,5,0,5,0.0,0.07692308,0.07692308
2015.0,LBR,72,72,6,7,-1,0.097222224,0.083333336,-0.013888889
2016.0,LBR,99,99,7,4,3,0.04040404,0.07070707,0.030303031
2017.0,LBR,125,125,15,4,11,0.032,0.12,0.088
2018.0,LBR,145,145,16,4,12,0.027586207,0.11034483,0.08275862
2019.0,LBR,142,142,15,17,-2,0.11971831,0.1056338,-0.014084507
2020.0,LBR,128,128,6,14,-8,0.109375,0.046875,-0.0625
2021.0,LBR,112,112,8,5,3,0.04464286,0.071428575,0.026785715
1996.0,LBY,24,24,0,0,0,0.0,0.0,0.0
1997.0,LBY,26,26,0,0,0,0.0,0.0,0.0
1998.0,LBY,45,45,2,0,2,0.0,0.044444446,0.044444446
1999.0,LBY,64,64,1,2,-1,0.03125,0.015625,-0.015625
2000.0,LBY,88,88,5,1,4,0.011363637,0.056818184,0.045454547
2001.0,LBY,109,109,6,4,2,0.036697246,0.055045873,0.018348623
2002.0,LBY,126,126,5,7,-2,0.055555556,0.03968254,-0.015873017
2003.0,LBY,147,147,5,6,-1,0.040816326,0.034013607,-0.006802721
2004.0,LBY,174,174,10,4,6,0.022988506,0.057471264,0.03448276
2005.0,LBY,192,192,11,2,9,0.010416667,0.057291668,0.046875
2006.0,LBY,221,221,9,8,1,0.036199097,0.040723983,0.004524887
2007.0,LBY,291,291,15,8,7,0.02749141,0.05154639,0.024054984
2008.0,LBY,369,369,42,6,36,0.016260162,0.11382114,0.09756097
2009.0,LBY,428,428,34,10,24,0.023364486,0.07943925,0.056074765
2010.0,LBY,454,454,29,12,17,0.026431719,0.06387665,0.037444934
2011.0,LBY,483,483,29,24,5,0.049689442,0.06004141,0.010351967
2012.0,LBY,501,501,44,30,14,0.059880238,0.08782435,0.027944112
2013.0,LBY,492,492,38,24,14,0.048780486,0.07723577,0.028455285
2014.0,LBY,512,512,48,19,29,0.037109375,0.09375,0.056640625
2015.0,LBY,530,530,41,24,17,0.04528302,0.07735849,0.032075472
2016.0,LBY,530,530,32,26,6,0.049056605,0.06037736,0.011320755
2017.0,LBY,543,543,43,14,29,0.02578269,0.07918969,0.053407
2018.0,LBY,598,598,50,28,22,0.04682274,0.08361204,0.036789298
2019.0,LBY,620,620,57,33,24,0.053225808,0.091935486,0.038709678
2020.0,LBY,605,605,54,28,26,0.04628099,0.0892562,0.042975206
2021.0,LBY,568,568,26,6,20,0.01056338,0.045774646,0.03521127
2006.0,LCA,2,2,0,0,0,0.0,0.0,0.0
2008.0,LCA,2,2,0,0,0,0.0,0.0,0.0
2011.0,LCA,2,2,0,0,0,0.0,0.0,0.0
2015.0,LCA,2,2,0,0,0,0.0,0.0,0.0
2018.0,LCA,4,4,0,0,0,0.0,0.0,0.0
2021.0,LCA,3,3,0,0,0,0.0,0.0,0.0
1996.0,LIE,8,8,0,0,0,0.0,0.0,0.0
1997.0,LIE,10,10,0,0,0,0.0,0.0,0.0
1998.0,LIE,18,18,2,0,2,0.0,0.11111111,0.11111111
1999.0,LIE,20,20,2,2,0,0.1,0.1,0.0
2000.0,LIE,25,25,4,0,4,0.0,0.16,0.16
2001.0,LIE,32,32,2,1,1,0.03125,0.0625,0.03125
2002.0,LIE,37,37,4,0,4,0.0,0.10810811,0.10810811
2003.0,LIE,50,50,5,4,1,0.08,0.1,0.02
2004.0,LIE,56,56,3,2,1,0.035714287,0.05357143,0.017857144
2005.0,LIE,58,58,3,1,2,0.01724138,0.05172414,0.03448276
2006.0,LIE,62,62,6,4,2,0.06451613,0.09677419,0.032258064
2007.0,LIE,72,72,7,3,4,0.041666668,0.097222224,0.055555556
2008.0,LIE,78,78,7,4,3,0.051282052,0.08974359,0.03846154
2009.0,LIE,73,73,1,2,-1,0.02739726,0.01369863,-0.01369863
2010.0,LIE,78,78,9,4,5,0.051282052,0.115384616,0.06410257
2011.0,LIE,81,81,12,4,8,0.049382716,0.14814815,0.09876543
2012.0,LIE,92,92,6,4,2,0.04347826,0.06521739,0.02173913
2013.0,LIE,101,101,7,3,4,0.02970297,0.06930693,0.03960396
2014.0,LIE,108,108,9,6,3,0.055555556,0.083333336,0.027777778
2015.0,LIE,108,108,8,8,0,0.074074075,0.074074075,0.0
2016.0,LIE,108,108,5,5,0,0.046296295,0.046296295,0.0
2017.0,LIE,106,106,6,5,1,0.047169812,0.056603774,0.009433962
2018.0,LIE,115,115,6,4,2,0.034782607,0.052173913,0.017391304
2019.0,LIE,113,113,12,8,4,0.07079646,0.10619469,0.03539823
2020.0,LIE,113,113,11,8,3,0.07079646,0.097345136,0.026548672
2021.0,LIE,111,111,13,6,7,0.054054055,0.117117114,0.06306306
1996.0,LKA,108,108,0,0,0,0.0,0.0,0.0
1997.0,LKA,134,134,1,0,1,0.0,0.0074626864,0.0074626864
1998.0,LKA,263,263,7,4,3,0.015209125,0.02661597,0.0114068445
1999.0,LKA,366,366,6,4,2,0.010928961,0.016393442,0.0054644807
2000.0,LKA,502,502,4,11,-7,0.021912351,0.007968128,-0.0139442235
2001.0,LKA,595,595,7,16,-9,0.026890757,0.011764706,-0.01512605
2002.0,LKA,693,693,14,23,-9,0.033189032,0.02020202,-0.012987013
2003.0,LKA,814,814,30,16,14,0.01965602,0.03685504,0.017199017
2004.0,LKA,905,905,33,33,0,0.036464088,0.036464088,0.0
2005.0,LKA,994,994,35,34,1,0.03420523,0.03521127,0.0010060362
2006.0,LKA,1121,1121,36,29,7,0.025869759,0.032114185,0.0062444247
2007.0,LKA,1261,1261,24,34,-10,0.026962727,0.019032514,-0.0079302145
2008.0,LKA,1348,1348,29,32,-3,0.023738872,0.021513354,-0.0022255194
2009.0,LKA,1498,1498,47,42,5,0.028037382,0.031375166,0.0033377837
2010.0,LKA,1589,1589,37,64,-27,0.040276904,0.023285085,-0.016991818
2011.0,LKA,1798,1798,65,43,22,0.023915462,0.03615128,0.0122358175
2012.0,LKA,1980,1980,59,59,0,0.02979798,0.02979798,0.0
2013.0,LKA,2187,2187,69,64,5,0.029263832,0.03155007,0.002286237
2014.0,LKA,2476,2476,84,46,38,0.018578352,0.033925686,0.015347335
2015.0,LKA,2810,2810,97,48,49,0.017081851,0.03451957,0.017437723
2016.0,LKA,3129,3129,98,57,41,0.018216683,0.03131991,0.013103228
2017.0,LKA,3473,3473,122,78,44,0.022458969,0.03512813,0.012669162
2018.0,LKA,3834,3834,135,96,39,0.025039123,0.03521127,0.010172144
2019.0,LKA,4107,4107,130,114,16,0.027757486,0.031653274,0.0038957878
2020.0,LKA,4038,4038,130,97,33,0.024021793,0.032194156,0.008172362
2021.0,LKA,3784,3784,72,71,1,0.018763214,0.019027485,0.0002642706
1996.0,LSO,7,7,0,0,0,0.0,0.0,0.0
1997.0,LSO,9,9,0,1,-1,0.11111111,0.0,-0.11111111
1998.0,LSO,11,11,0,0,0,0.0,0.0,0.0
1999.0,LSO,13,13,1,1,0,0.07692308,0.07692308,0.0
2000.0,LSO,17,17,1,1,0,0.05882353,0.05882353,0.0
2001.0,LSO,21,21,0,1,-1,0.04761905,0.0,-0.04761905
2002.0,LSO,21,21,0,1,-1,0.04761905,0.0,-0.04761905
2003.0,LSO,26,26,3,4,-1,0.15384616,0.115384616,-0.03846154
2004.0,LSO,30,30,1,1,0,0.033333335,0.033333335,0.0
2005.0,LSO,34,34,1,1,0,0.029411765,0.029411765,0.0
2006.0,LSO,43,43,6,2,4,0.046511628,0.13953489,0.093023255
2007.0,LSO,54,54,4,1,3,0.018518519,0.074074075,0.055555556
2008.0,LSO,62,62,6,1,5,0.016129032,0.09677419,0.08064516
2009.0,LSO,57,57,0,9,-9,0.15789473,0.0,-0.15789473
2010.0,LSO,65,65,4,5,-1,0.07692308,0.06153846,-0.015384615
2011.0,LSO,60,60,2,7,-5,0.11666667,0.033333335,-0.083333336
2012.0,LSO,64,64,2,3,-1,0.046875,0.03125,-0.015625
2013.0,LSO,67,67,7,8,-1,0.11940298,0.104477614,-0.014925373
2014.0,LSO,72,72,2,3,-1,0.041666668,0.027777778,-0.013888889
2015.0,LSO,73,73,3,10,-7,0.1369863,0.04109589,-0.09589041
2016.0,LSO,76,76,7,1,6,0.013157895,0.09210526,0.078947365
2017.0,LSO,90,90,6,3,3,0.033333335,0.06666667,0.033333335
2018.0,LSO,104,104,9,8,1,0.07692308,0.086538464,0.009615385
2019.0,LSO,117,117,11,6,5,0.051282052,0.094017096,0.042735044
2020.0,LSO,122,122,13,3,10,0.024590164,0.10655738,0.08196721
2021.0,LSO,111,111,10,9,1,0.08108108,0.09009009,0.009009009
1996.0,LTU,432,432,0,0,0,0.0,0.0,0.0
1997.0,LTU,601,601,3,3,0,0.0049916804,0.0049916804,0.0
1998.0,LTU,877,877,10,6,4,0.006841505,0.011402508,0.0045610033
1999.0,LTU,1098,1098,14,9,5,0.008196721,0.012750455,0.004553734
2000.0,LTU,1658,1658,8,16,-8,0.009650181,0.0048250905,-0.0048250905
2001.0,LTU,2175,2175,16,28,-12,0.012873563,0.007356322,-0.0055172415
2002.0,LTU,2649,2649,22,35,-13,0.013212533,0.008305021,-0.004907512
2003.0,LTU,3197,3197,33,39,-6,0.012198936,0.010322177,-0.0018767595
2004.0,LTU,3805,3805,36,25,11,0.0065703024,0.009461235,0.002890933
2005.0,LTU,4182,4182,41,38,3,0.009086561,0.009803922,0.0007173601
2006.0,LTU,4811,4811,41,39,2,0.008106423,0.008522137,0.000415714
2007.0,LTU,5272,5272,48,47,1,0.008915023,0.0091047045,0.00018968133
2008.0,LTU,5707,5707,40,44,-4,0.00770983,0.0070089363,-0.00070089364
2009.0,LTU,6222,6222,31,42,-11,0.006750241,0.0049823206,-0.0017679203
2010.0,LTU,6621,6621,41,39,2,0.005890349,0.0061924183,0.00030206918
2011.0,LTU,6951,6951,45,33,12,0.0047475183,0.0064738886,0.0017263703
2012.0,LTU,7265,7265,40,42,-2,0.0057811425,0.00550585,-0.0002752925
2013.0,LTU,7633,7633,48,42,6,0.0055024237,0.006288484,0.0007860605
2014.0,LTU,7896,7896,62,47,15,0.005952381,0.007852077,0.0018996961
2015.0,LTU,8100,8100,40,49,-9,0.0060493825,0.004938272,-0.0011111111
2016.0,LTU,8271,8271,54,69,-15,0.008342401,0.0065288357,-0.0018135655
2017.0,LTU,8437,8437,49,54,-5,0.0064003794,0.005807752,-0.00059262774
2018.0,LTU,8593,8593,70,76,-6,0.008844408,0.008146166,-0.00069824274
2019.0,LTU,8504,8504,60,74,-14,0.008701787,0.0070555033,-0.0016462841
2020.0,LTU,8133,8133,75,54,21,0.0066396166,0.00922169,0.002582073
2021.0,LTU,7559,7559,47,62,-15,0.008202143,0.0062177535,-0.0019843895
1996.0,LUX,32,32,0,0,0,0.0,0.0,0.0
1997.0,LUX,36,36,1,0,1,0.0,0.027777778,0.027777778
1998.0,LUX,74,74,2,0,2,0.0,0.027027028,0.027027028
1999.0,LUX,118,118,7,2,5,0.016949153,0.059322033,0.042372882
2000.0,LUX,141,141,4,5,-1,0.035460994,0.028368793,-0.0070921984
2001.0,LUX,184,184,19,2,17,0.010869565,0.10326087,0.092391305
2002.0,LUX,225,225,16,13,3,0.057777777,0.07111111,0.013333334
2003.0,LUX,281,281,26,19,7,0.06761566,0.09252669,0.024911031
2004.0,LUX,349,349,40,9,31,0.025787966,0.11461318,0.08882522
2005.0,LUX,438,438,42,12,30,0.02739726,0.09589041,0.06849315
2006.0,LUX,511,511,43,21,22,0.04109589,0.08414873,0.043052837
2007.0,LUX,640,640,67,22,45,0.034375,0.1046875,0.0703125
2008.0,LUX,762,762,75,26,49,0.034120735,0.098425195,0.06430446
2009.0,LUX,891,891,73,26,47,0.029180696,0.081930414,0.05274972
2010.0,LUX,1023,1023,104,31,73,0.030303031,0.10166178,0.07135875
2011.0,LUX,1189,1189,119,48,71,0.04037006,0.1000841,0.059714045
2012.0,LUX,1383,1383,128,56,72,0.040491685,0.09255242,0.05206074
2013.0,LUX,1532,1532,130,66,64,0.04308094,0.0848564,0.041775458
2014.0,LUX,1702,1702,169,77,92,0.045240894,0.099294946,0.054054055
2015.0,LUX,1837,1837,132,81,51,0.04409363,0.07185629,0.027762657
2016.0,LUX,1945,1945,146,95,51,0.048843186,0.075064264,0.02622108
2017.0,LUX,2055,2055,163,98,65,0.047688566,0.07931873,0.03163017
2018.0,LUX,2148,2148,159,108,51,0.05027933,0.074022345,0.023743017
2019.0,LUX,2246,2246,190,98,92,0.043633126,0.08459484,0.04096171
2020.0,LUX,2229,2229,170,119,51,0.05338717,0.076267384,0.022880215
2021.0,LUX,2171,2171,151,85,66,0.039152466,0.069553204,0.030400736
1996.0,LVA,347,347,0,0,0,0.0,0.0,0.0
1997.0,LVA,432,432,3,5,-2,0.011574074,0.0069444445,-0.0046296297
1998.0,LVA,591,591,3,4,-1,0.0067681894,0.005076142,-0.0016920473
1999.0,LVA,750,750,1,10,-9,0.013333334,0.0013333333,-0.012
2000.0,LVA,827,827,1,19,-18,0.022974607,0.0012091899,-0.021765416
2001.0,LVA,888,888,14,20,-6,0.022522522,0.015765766,-0.006756757
2002.0,LVA,950,950,25,14,11,0.014736842,0.02631579,0.011578947
2003.0,LVA,1022,1022,24,10,14,0.009784736,0.023483366,0.01369863
2004.0,LVA,1068,1068,15,10,5,0.0093632955,0.014044944,0.0046816478
2005.0,LVA,1183,1183,12,17,-5,0.014370245,0.010143703,-0.0042265425
2006.0,LVA,1390,1390,15,9,6,0.00647482,0.010791367,0.004316547
2007.0,LVA,1596,1596,20,11,9,0.0068922304,0.012531328,0.0056390977
2008.0,LVA,1827,1827,20,8,12,0.004378763,0.010946907,0.0065681445
2009.0,LVA,2071,2071,15,9,6,0.0043457267,0.007242878,0.002897151
2010.0,LVA,2330,2330,23,21,2,0.009012875,0.009871244,0.0008583691
2011.0,LVA,2596,2596,19,23,-4,0.008859784,0.007318952,-0.0015408321
2012.0,LVA,2752,2752,22,22,0,0.007994186,0.007994186,0.0
2013.0,LVA,2941,2941,18,23,-5,0.007820469,0.0061203674,-0.001700102
2014.0,LVA,3080,3080,29,29,0,0.009415585,0.009415585,0.0
2015.0,LVA,3227,3227,46,24,22,0.0074372482,0.014254726,0.0068174778
2016.0,LVA,3323,3323,30,43,-13,0.012940114,0.009027987,-0.0039121276
2017.0,LVA,3503,3503,30,29,1,0.008278619,0.008564088,0.0002854696
2018.0,LVA,3649,3649,32,35,-3,0.009591669,0.008769526,-0.00082214305
2019.0,LVA,3718,3718,35,29,6,0.007799892,0.009413663,0.0016137708
2020.0,LVA,3586,3586,30,22,8,0.006134969,0.008365868,0.002230898
2021.0,LVA,3333,3333,22,15,7,0.00450045,0.0066006603,0.00210021
1996.0,MAC,6,6,0,0,0,0.0,0.0,0.0
1997.0,MAC,10,10,1,0,1,0.0,0.1,0.1
1998.0,MAC,12,12,0,0,0,0.0,0.0,0.0
1999.0,MAC,17,17,0,2,-2,0.11764706,0.0,-0.11764706
2000.0,MAC,31,31,2,0,2,0.0,0.06451613,0.06451613
2001.0,MAC,49,49,3,0,3,0.0,0.06122449,0.06122449
2002.0,MAC,75,75,4,2,2,0.026666667,0.053333335,0.026666667
2003.0,MAC,102,102,8,2,6,0.019607844,0.078431375,0.05882353
2004.0,MAC,149,149,19,1,18,0.0067114094,0.12751678,0.12080537
2005.0,MAC,193,193,12,0,12,0.0,0.062176164,0.062176164
2006.0,MAC,266,266,24,4,20,0.015037594,0.09022556,0.075187966
2007.0,MAC,327,327,33,18,15,0.055045873,0.10091743,0.04587156
2008.0,MAC,404,404,25,14,11,0.034653466,0.06188119,0.027227722
2009.0,MAC,475,475,32,12,20,0.025263159,0.06736842,0.042105265
2010.0,MAC,545,545,43,24,19,0.044036698,0.078899086,0.034862384
2011.0,MAC,689,689,44,14,30,0.020319303,0.06386067,0.043541364
2012.0,MAC,845,845,58,17,41,0.020118343,0.068639055,0.04852071
2013.0,MAC,1010,1010,62,28,34,0.027722772,0.06138614,0.033663366
2014.0,MAC,1215,1215,91,41,50,0.033744857,0.07489712,0.041152265
2015.0,MAC,1459,1459,103,42,61,0.02878684,0.0705963,0.04180946
2016.0,MAC,1732,1732,120,58,62,0.033487298,0.06928407,0.035796765
2017.0,MAC,1934,1934,96,61,35,0.03154085,0.049638055,0.018097207
2018.0,MAC,2088,2088,114,122,-8,0.05842912,0.054597702,-0.0038314175
2019.0,MAC,2148,2148,103,181,-78,0.084264435,0.047951583,-0.03631285
2020.0,MAC,2072,2072,166,152,14,0.07335907,0.08011583,0.006756757
2021.0,MAC,1936,1936,161,171,-10,0.08832645,0.08316116,-0.005165289
1996.0,MAR,672,672,0,0,0,0.0,0.0,0.0
1997.0,MAR,887,887,17,5,12,0.0056369784,0.019165726,0.013528748
1998.0,MAR,1698,1698,25,4,21,0.0023557127,0.014723204,0.012367492
1999.0,MAR,2523,2523,27,21,6,0.0083234245,0.0107015455,0.0023781213
2000.0,MAR,3188,3188,29,27,2,0.008469259,0.009096612,0.00062735257
2001.0,MAR,3693,3693,80,61,19,0.016517736,0.021662604,0.0051448685
2002.0,MAR,4130,4130,71,80,-9,0.01937046,0.017191283,-0.0021791768
2003.0,MAR,4483,4483,87,81,6,0.018068258,0.019406646,0.0013383895
2004.0,MAR,4701,4701,67,90,-23,0.019144863,0.014252286,-0.004892576
2005.0,MAR,4876,4876,76,73,3,0.014971288,0.015586547,0.0006152584
2006.0,MAR,5176,5176,86,55,31,0.010625966,0.016615147,0.005989181
2007.0,MAR,5601,5601,97,51,46,0.009105517,0.017318336,0.008212819
2008.0,MAR,6217,6217,103,74,29,0.011902847,0.016567476,0.004664629
2009.0,MAR,6908,6908,91,71,20,0.010277939,0.013173132,0.0028951939
2010.0,MAR,7630,7630,123,70,53,0.0091743115,0.016120577,0.0069462648
2011.0,MAR,8449,8449,141,80,61,0.009468576,0.016688365,0.0072197895
2012.0,MAR,9526,9526,140,87,53,0.009132899,0.0146966195,0.00556372
2013.0,MAR,10626,10626,144,66,78,0.0062111802,0.0135516655,0.0073404857
2014.0,MAR,11876,11876,160,106,54,0.008925565,0.01347255,0.0045469855
2015.0,MAR,13218,13218,194,92,102,0.0069602057,0.0146769555,0.00771675
2016.0,MAR,14353,14353,162,106,56,0.0073852157,0.011286839,0.0039016234
2017.0,MAR,15554,15554,162,91,71,0.005850585,0.010415327,0.004564742
2018.0,MAR,16914,16914,167,112,55,0.0066217333,0.009873478,0.0032517442
2019.0,MAR,17690,17690,154,152,2,0.008592425,0.008705484,0.000113058224
2020.0,MAR,17106,17106,171,143,28,0.00835964,0.009996492,0.0016368525
2021.0,MAR,16179,16179,142,117,25,0.0072315964,0.008776809,0.0015452129
2022.0,MAR,0,0,78,80,-2,,,
1996.0,MCO,5,5,0,0,0,0.0,0.0,0.0
1997.0,MCO,7,7,1,0,1,0.0,0.14285715,0.14285715
1998.0,MCO,12,12,1,0,1,0.0,0.083333336,0.083333336
1999.0,MCO,18,18,2,2,0,0.11111111,0.11111111,0.0
2000.0,MCO,24,24,0,2,-2,0.083333336,0.0,-0.083333336
2001.0,MCO,44,44,9,1,8,0.022727273,0.20454545,0.18181819
2002.0,MCO,55,55,5,2,3,0.036363635,0.09090909,0.054545455
2003.0,MCO,60,60,5,5,0,0.083333336,0.083333336,0.0
2004.0,MCO,86,86,20,3,17,0.034883723,0.23255815,0.19767442
2005.0,MCO,92,92,4,4,0,0.04347826,0.04347826,0.0
2006.0,MCO,97,97,10,5,5,0.05154639,0.10309278,0.05154639
2007.0,MCO,100,100,12,10,2,0.1,0.12,0.02
2008.0,MCO,113,113,19,5,14,0.044247787,0.16814159,0.123893805
2009.0,MCO,114,114,9,12,-3,0.10526316,0.078947365,-0.02631579
2010.0,MCO,126,126,14,6,8,0.04761905,0.11111111,0.06349207
2011.0,MCO,133,133,10,7,3,0.05263158,0.075187966,0.02255639
2012.0,MCO,138,138,14,8,6,0.057971016,0.10144927,0.04347826
2013.0,MCO,148,148,17,6,11,0.04054054,0.11486486,0.074324325
2014.0,MCO,147,147,15,16,-1,0.108843535,0.10204082,-0.006802721
2015.0,MCO,153,153,16,5,11,0.03267974,0.104575165,0.07189543
2016.0,MCO,159,159,12,11,1,0.06918239,0.0754717,0.006289308
2017.0,MCO,169,169,17,10,7,0.0591716,0.10059172,0.041420117
2018.0,MCO,167,167,15,12,3,0.07185629,0.08982036,0.017964073
2019.0,MCO,180,180,24,9,15,0.05,0.13333334,0.083333336
2020.0,MCO,167,167,13,16,-3,0.09580839,0.077844314,-0.017964073
2021.0,MCO,156,156,7,6,1,0.03846154,0.044871796,0.0064102565
1996.0,MDA,173,173,0,0,0,0.0,0.0,0.0
1997.0,MDA,201,201,2,4,-2,0.019900497,0.0099502485,-0.0099502485
1998.0,MDA,279,279,2,10,-8,0.035842296,0.007168459,-0.028673835
1999.0,MDA,320,320,8,12,-4,0.0375,0.025,-0.0125
2000.0,MDA,347,347,8,8,0,0.023054754,0.023054754,0.0
2001.0,MDA,357,357,3,13,-10,0.036414567,0.008403362,-0.028011205
2002.0,MDA,384,384,3,12,-9,0.03125,0.0078125,-0.0234375
2003.0,MDA,390,390,11,10,1,0.025641026,0.028205128,0.0025641026
2004.0,MDA,389,389,9,16,-7,0.041131105,0.023136247,-0.017994858
2005.0,MDA,406,406,19,8,11,0.019704433,0.046798028,0.027093597
2006.0,MDA,441,441,9,18,-9,0.040816326,0.020408163,-0.020408163
2007.0,MDA,487,487,8,13,-5,0.026694044,0.016427105,-0.01026694
2008.0,MDA,520,520,13,8,5,0.015384615,0.025,0.009615385
2009.0,MDA,551,551,7,15,-8,0.027223231,0.012704174,-0.014519056
2010.0,MDA,613,613,14,11,3,0.017944535,0.0228385,0.004893964
2011.0,MDA,635,635,13,14,-1,0.022047244,0.02047244,-0.0015748031
2012.0,MDA,660,660,9,15,-6,0.022727273,0.013636364,-0.009090909
2013.0,MDA,670,670,14,11,3,0.016417911,0.020895522,0.0044776117
2014.0,MDA,710,710,14,7,7,0.009859155,0.01971831,0.009859155
2015.0,MDA,713,713,14,11,3,0.01542777,0.019635344,0.004207574
2016.0,MDA,721,721,18,21,-3,0.029126214,0.024965325,-0.0041608876
2017.0,MDA,704,704,7,18,-11,0.025568182,0.009943182,-0.015625
2018.0,MDA,734,734,11,15,-4,0.020435967,0.014986376,-0.005449591
2019.0,MDA,678,678,11,22,-11,0.032448377,0.016224189,-0.016224189
2020.0,MDA,598,598,11,25,-14,0.04180602,0.018394649,-0.02341137
2021.0,MDA,516,516,3,10,-7,0.019379845,0.0058139535,-0.013565891
1996.0,MDG,36,36,0,0,0,0.0,0.0,0.0
1997.0,MDG,40,40,0,0,0,0.0,0.0,0.0
1998.0,MDG,103,103,0,3,-3,0.029126214,0.0,-0.029126214
1999.0,MDG,150,150,8,2,6,0.013333334,0.053333335,0.04
2000.0,MDG,180,180,4,4,0,0.022222223,0.022222223,0.0
2001.0,MDG,206,206,3,13,-10,0.0631068,0.014563107,-0.048543688
2002.0,MDG,242,242,16,13,3,0.053719006,0.0661157,0.012396694
2003.0,MDG,283,283,17,7,10,0.024734983,0.06007067,0.03533569
2004.0,MDG,301,301,11,15,-4,0.049833886,0.036544852,-0.013289036
2005.0,MDG,364,364,14,7,7,0.01923077,0.03846154,0.01923077
2006.0,MDG,402,402,10,16,-6,0.039800994,0.024875622,-0.014925373
2007.0,MDG,455,455,18,12,6,0.026373627,0.03956044,0.013186813
2008.0,MDG,521,521,18,13,5,0.024952015,0.034548946,0.009596929
2009.0,MDG,582,582,13,11,2,0.018900344,0.02233677,0.0034364262
2010.0,MDG,606,606,10,17,-7,0.028052805,0.01650165,-0.011551155
2011.0,MDG,654,654,21,19,2,0.029051987,0.03211009,0.003058104
2012.0,MDG,699,699,25,15,10,0.021459227,0.03576538,0.014306151
2013.0,MDG,725,725,17,23,-6,0.031724136,0.023448275,-0.008275862
2014.0,MDG,755,755,12,20,-8,0.026490066,0.01589404,-0.010596027
2015.0,MDG,816,816,26,19,7,0.023284314,0.031862747,0.008578432
2016.0,MDG,863,863,22,20,2,0.023174971,0.025492469,0.002317497
2017.0,MDG,890,890,17,23,-6,0.025842696,0.019101124,-0.006741573
2018.0,MDG,952,952,31,23,8,0.024159664,0.032563027,0.008403362
2019.0,MDG,996,996,25,17,8,0.017068272,0.025100403,0.008032128
2020.0,MDG,949,949,24,23,1,0.024236038,0.02528978,0.0010537407
2021.0,MDG,885,885,15,13,2,0.014689266,0.016949153,0.002259887
1997.0,MDV,1,1,0,0,0,0.0,0.0,0.0
2004.0,MDV,1,1,0,0,0,0.0,0.0,0.0
2007.0,MDV,6,6,0,0,0,0.0,0.0,0.0
2008.0,MDV,6,6,1,1,0,0.16666667,0.16666667,0.0
2009.0,MDV,8,8,0,0,0,0.0,0.0,0.0
2011.0,MDV,7,7,1,2,-1,0.2857143,0.14285715,-0.14285715
2012.0,MDV,9,9,1,1,0,0.11111111,0.11111111,0.0
2013.0,MDV,15,15,2,0,2,0.0,0.13333334,0.13333334
2014.0,MDV,16,16,2,2,0,0.125,0.125,0.0
2015.0,MDV,17,17,1,1,0,0.05882353,0.05882353,0.0
2016.0,MDV,21,21,2,3,-1,0.14285715,0.0952381,-0.04761905
2017.0,MDV,25,25,5,0,5,0.0,0.2,0.2
2018.0,MDV,31,31,4,2,2,0.06451613,0.12903225,0.06451613
2019.0,MDV,39,39,4,2,2,0.051282052,0.102564104,0.051282052
2020.0,MDV,44,44,7,2,5,0.045454547,0.1590909,0.11363637
2021.0,MDV,44,44,4,1,3,0.022727273,0.09090909,0.06818182
1996.0,MEX,4683,4683,0,0,0,0.0,0.0,0.0
1997.0,MEX,6319,6319,40,42,-2,0.0066466215,0.0063301157,-0.0003165058
1998.0,MEX,9376,9376,97,76,21,0.008105802,0.010345563,0.0022397612
1999.0,MEX,12653,12653,184,110,74,0.008693591,0.014542006,0.005848415
2000.0,MEX,15413,15413,161,173,-12,0.011224291,0.010445728,-0.00077856355
2001.0,MEX,18170,18170,260,273,-13,0.015024766,0.014309301,-0.00071546505
2002.0,MEX,21028,21028,463,377,86,0.017928476,0.022018261,0.0040897853
2003.0,MEX,23728,23728,457,354,103,0.014919083,0.019259946,0.0043408633
2004.0,MEX,26220,26220,413,326,87,0.012433257,0.015751336,0.003318078
2005.0,MEX,28728,28728,449,314,135,0.010930103,0.015629351,0.004699248
2006.0,MEX,31622,31622,384,414,-30,0.013092151,0.012143444,-0.0009487066
2007.0,MEX,34576,34576,487,423,64,0.012233919,0.014084915,0.0018509949
2008.0,MEX,37311,37311,455,425,30,0.011390743,0.0121947955,0.0008040524
2009.0,MEX,40449,40449,483,489,-6,0.012089297,0.011940963,-0.00014833493
2010.0,MEX,44864,44864,507,561,-54,0.0125044575,0.01130082,-0.0012036377
2011.0,MEX,48687,48687,551,587,-36,0.012056607,0.01131719,-0.0007394171
2012.0,MEX,52422,52422,587,517,70,0.009862271,0.011197588,0.0013353173
2013.0,MEX,55597,55597,616,601,15,0.010809936,0.011079734,0.00026979874
2014.0,MEX,58185,58185,652,627,25,0.010775973,0.011205637,0.000429664
2015.0,MEX,61252,61252,728,685,43,0.011183308,0.011885326,0.0007020179
2016.0,MEX,64942,64942,810,725,85,0.0111638075,0.012472668,0.0013088603
2017.0,MEX,67999,67999,797,796,1,0.011706054,0.011720761,1.4706098e-05
2018.0,MEX,70513,70513,814,882,-68,0.012508332,0.011543971,-0.0009643612
2019.0,MEX,71047,71047,780,897,-117,0.012625445,0.0109786475,-0.0016467972
2020.0,MEX,68124,68124,698,896,-198,0.013152487,0.010246022,-0.0029064647
2021.0,MEX,63184,63184,480,650,-170,0.010287414,0.00759686,-0.0026905546
2000.0,MHL,7,7,0,0,0,0.0,0.0,0.0
2001.0,MHL,6,6,0,1,-1,0.16666667,0.0,-0.16666667
2002.0,MHL,6,6,1,2,-1,0.33333334,0.16666667,-0.16666667
2004.0,MHL,4,4,0,1,-1,0.25,0.0,-0.25
2005.0,MHL,5,5,1,0,1,0.0,0.2,0.2
2006.0,MHL,7,7,2,1,1,0.14285715,0.2857143,0.14285715
2008.0,MHL,4,4,0,1,-1,0.25,0.0,-0.25
2009.0,MHL,4,4,0,0,0,0.0,0.0,0.0
2012.0,MHL,2,2,0,0,0,0.0,0.0,0.0
2018.0,MHL,5,5,1,0,1,0.0,0.2,0.2
2019.0,MHL,5,5,1,0,1,0.0,0.2,0.2
1996.0,MKD,75,75,0,0,0,0.0,0.0,0.0
1997.0,MKD,90,90,2,1,1,0.011111111,0.022222223,0.011111111
1998.0,MKD,147,147,0,1,-1,0.006802721,0.0,-0.006802721
1999.0,MKD,208,208,1,1,0,0.0048076925,0.0048076925,0.0
2000.0,MKD,261,261,0,0,0,0.0,0.0,0.0
2001.0,MKD,304,304,7,5,2,0.016447369,0.023026315,0.0065789474
2002.0,MKD,353,353,5,20,-15,0.056657225,0.014164306,-0.04249292
2003.0,MKD,427,427,10,6,4,0.014051522,0.023419203,0.009367681
2004.0,MKD,500,500,15,5,10,0.01,0.03,0.02
2005.0,MKD,552,552,13,22,-9,0.039855074,0.023550725,-0.016304348
2006.0,MKD,660,660,11,21,-10,0.03181818,0.016666668,-0.015151516
2007.0,MKD,749,749,20,9,11,0.012016022,0.02670227,0.014686248
2008.0,MKD,862,862,18,14,4,0.016241299,0.020881671,0.004640371
2009.0,MKD,1002,1002,12,15,-3,0.0149700595,0.011976048,-0.002994012
2010.0,MKD,1106,1106,12,22,-10,0.0198915,0.01084991,-0.009041592
2011.0,MKD,1263,1263,12,16,-4,0.01266825,0.009501188,-0.0031670625
2012.0,MKD,1401,1401,13,18,-5,0.012847966,0.009279086,-0.0035688793
2013.0,MKD,1567,1567,16,13,3,0.008296107,0.010210593,0.0019144863
2014.0,MKD,1670,1670,20,19,1,0.011377245,0.011976048,0.0005988024
2015.0,MKD,1735,1735,23,18,5,0.01037464,0.013256484,0.0028818443
2016.0,MKD,1770,1770,16,25,-9,0.014124294,0.009039548,-0.0050847456
2017.0,MKD,1802,1802,22,29,-7,0.01609323,0.012208657,-0.0038845728
2018.0,MKD,1790,1790,20,30,-10,0.016759777,0.011173184,-0.005586592
2019.0,MKD,1737,1737,17,34,-17,0.019573977,0.009786989,-0.009786989
2020.0,MKD,1643,1643,24,21,3,0.012781497,0.014607426,0.0018259282
2021.0,MKD,1439,1439,1,13,-12,0.009034052,0.00069492706,-0.008339125
1996.0,MLI,24,24,0,0,0,0.0,0.0,0.0
1997.0,MLI,32,32,0,1,-1,0.03125,0.0,-0.03125
1998.0,MLI,49,49,1,2,-1,0.040816326,0.020408163,-0.020408163
1999.0,MLI,83,83,0,3,-3,0.036144577,0.0,-0.036144577
2000.0,MLI,115,115,1,3,-2,0.026086956,0.008695652,-0.017391304
2001.0,MLI,140,140,6,7,-1,0.05,0.042857144,-0.007142857
2002.0,MLI,174,174,13,8,5,0.04597701,0.07471264,0.028735632
2003.0,MLI,215,215,13,6,7,0.027906977,0.060465116,0.03255814
2004.0,MLI,274,274,15,4,11,0.01459854,0.054744527,0.040145986
2005.0,MLI,324,324,19,8,11,0.024691358,0.058641974,0.033950616
2006.0,MLI,367,367,16,9,7,0.024523161,0.04359673,0.01907357
2007.0,MLI,435,435,8,10,-2,0.022988506,0.018390805,-0.004597701
2008.0,MLI,470,470,17,10,7,0.021276595,0.036170214,0.0148936175
2009.0,MLI,513,513,17,22,-5,0.04288499,0.0331384,-0.009746589
2010.0,MLI,542,542,17,20,-3,0.036900368,0.031365313,-0.0055350554
2011.0,MLI,575,575,17,17,0,0.029565217,0.029565217,0.0
2012.0,MLI,583,583,13,15,-2,0.025728988,0.022298457,-0.0034305318
2013.0,MLI,604,604,11,23,-12,0.03807947,0.01821192,-0.01986755
2014.0,MLI,637,637,19,27,-8,0.042386185,0.029827315,-0.01255887
2015.0,MLI,669,669,19,21,-2,0.031390134,0.028400598,-0.0029895366
2016.0,MLI,729,729,44,11,33,0.015089164,0.060356654,0.04526749
2017.0,MLI,764,764,35,14,21,0.018324608,0.04581152,0.027486911
2018.0,MLI,799,799,39,21,18,0.026282854,0.048811015,0.02252816
2019.0,MLI,821,821,27,31,-4,0.03775883,0.032886725,-0.0048721074
2020.0,MLI,743,743,22,27,-5,0.036339164,0.029609691,-0.006729475
2021.0,MLI,670,670,16,12,4,0.017910447,0.023880597,0.0059701493
1996.0,MLT,24,24,0,0,0,0.0,0.0,0.0
1997.0,MLT,31,31,0,0,0,0.0,0.0,0.0
1998.0,MLT,54,54,3,2,1,0.037037037,0.055555556,0.018518519
1999.0,MLT,77,77,1,1,0,0.012987013,0.012987013,0.0
2000.0,MLT,103,103,6,2,4,0.019417476,0.058252428,0.03883495
2001.0,MLT,136,136,9,3,6,0.022058824,0.066176474,0.04411765
2002.0,MLT,160,160,4,3,1,0.01875,0.025,0.00625
2003.0,MLT,169,169,5,6,-1,0.03550296,0.0295858,-0.00591716
2004.0,MLT,193,193,4,4,0,0.020725388,0.020725388,0.0
2005.0,MLT,217,217,7,5,2,0.023041476,0.032258064,0.00921659
2006.0,MLT,276,276,11,8,3,0.028985508,0.039855074,0.010869565
2007.0,MLT,322,322,9,6,3,0.01863354,0.027950311,0.00931677
2008.0,MLT,394,394,16,5,11,0.012690355,0.040609136,0.027918782
2009.0,MLT,451,451,9,8,1,0.017738359,0.019955654,0.0022172949
2010.0,MLT,533,533,15,12,3,0.022514071,0.028142588,0.005628518
2011.0,MLT,586,586,10,10,0,0.017064847,0.017064847,0.0
2012.0,MLT,662,662,17,10,7,0.01510574,0.025679758,0.010574019
2013.0,MLT,747,747,21,12,9,0.016064256,0.02811245,0.012048192
2014.0,MLT,828,828,20,13,7,0.015700484,0.024154589,0.008454106
2015.0,MLT,908,908,27,20,7,0.02202643,0.029735683,0.0077092513
2016.0,MLT,979,979,32,16,16,0.016343208,0.032686416,0.016343208
2017.0,MLT,1054,1054,38,23,15,0.021821631,0.036053132,0.014231499
2018.0,MLT,1116,1116,38,31,7,0.027777778,0.034050178,0.0062724017
2019.0,MLT,1164,1164,53,29,24,0.02491409,0.045532648,0.020618556
2020.0,MLT,1156,1156,34,18,16,0.015570934,0.029411765,0.013840831
2021.0,MLT,1094,1094,25,21,4,0.019195613,0.02285192,0.0036563072
1997.0,MMR,3,3,0,0,0,0.0,0.0,0.0
1998.0,MMR,12,12,0,0,0,0.0,0.0,0.0
1999.0,MMR,20,20,0,0,0,0.0,0.0,0.0
2000.0,MMR,32,32,0,0,0,0.0,0.0,0.0
2001.0,MMR,39,39,0,1,-1,0.025641026,0.0,-0.025641026
2002.0,MMR,56,56,2,1,1,0.017857144,0.035714287,0.017857144
2003.0,MMR,69,69,6,0,6,0.0,0.08695652,0.08695652
2004.0,MMR,80,80,5,2,3,0.025,0.0625,0.0375
2005.0,MMR,87,87,2,1,1,0.011494253,0.022988506,0.011494253
2006.0,MMR,95,95,1,2,-1,0.021052632,0.010526316,-0.010526316
2007.0,MMR,117,117,3,1,2,0.008547009,0.025641026,0.017094018
2008.0,MMR,140,140,5,0,5,0.0,0.035714287,0.035714287
2009.0,MMR,152,152,3,3,0,0.019736841,0.019736841,0.0
2010.0,MMR,161,161,5,2,3,0.0124223605,0.031055901,0.01863354
2011.0,MMR,170,170,6,5,1,0.029411765,0.03529412,0.005882353
2012.0,MMR,193,193,7,5,2,0.025906736,0.03626943,0.010362694
2013.0,MMR,238,238,6,3,3,0.012605042,0.025210084,0.012605042
2014.0,MMR,278,278,9,10,-1,0.035971224,0.0323741,-0.0035971224
2015.0,MMR,326,326,11,13,-2,0.0398773,0.03374233,-0.006134969
2016.0,MMR,402,402,19,15,4,0.03731343,0.047263682,0.0099502485
2017.0,MMR,463,463,27,11,16,0.023758098,0.058315333,0.034557234
2018.0,MMR,540,540,33,17,16,0.031481482,0.06111111,0.02962963
2019.0,MMR,565,565,45,36,9,0.063716814,0.07964602,0.015929203
2020.0,MMR,550,550,30,20,10,0.036363635,0.054545455,0.018181818
2021.0,MMR,521,521,38,18,20,0.034548946,0.07293666,0.038387716
1997.0,MNE,14,14,1,0,1,0.0,0.071428575,0.071428575
1998.0,MNE,20,20,0,2,-2,0.1,0.0,-0.1
1999.0,MNE,26,26,0,0,0,0.0,0.0,0.0
2000.0,MNE,36,36,3,0,3,0.0,0.083333336,0.083333336
2001.0,MNE,53,53,4,0,4,0.0,0.0754717,0.0754717
2002.0,MNE,53,53,1,5,-4,0.094339624,0.018867925,-0.0754717
2003.0,MNE,69,69,3,2,1,0.028985508,0.04347826,0.014492754
2004.0,MNE,88,88,8,2,6,0.022727273,0.09090909,0.06818182
2005.0,MNE,107,107,5,1,4,0.009345794,0.046728972,0.037383176
2006.0,MNE,126,126,3,7,-4,0.055555556,0.023809524,-0.031746034
2007.0,MNE,152,152,5,1,4,0.0065789474,0.032894738,0.02631579
2008.0,MNE,204,204,12,1,11,0.004901961,0.05882353,0.05392157
2009.0,MNE,247,247,4,3,1,0.012145749,0.016194332,0.004048583
2010.0,MNE,298,298,6,6,0,0.020134227,0.020134227,0.0
2011.0,MNE,356,356,9,3,6,0.008426966,0.025280898,0.016853932
2012.0,MNE,440,440,13,2,11,0.0045454544,0.029545454,0.025
2013.0,MNE,493,493,8,5,3,0.010141988,0.01622718,0.006085193
2014.0,MNE,554,554,12,4,8,0.0072202166,0.02166065,0.014440433
2015.0,MNE,615,615,10,4,6,0.006504065,0.016260162,0.009756098
2016.0,MNE,657,657,19,8,11,0.01217656,0.02891933,0.01674277
2017.0,MNE,673,673,11,16,-5,0.023774145,0.016344724,-0.0074294205
2018.0,MNE,707,707,14,11,3,0.015558699,0.01980198,0.0042432817
2019.0,MNE,705,705,4,25,-21,0.035460994,0.0056737587,-0.029787235
2020.0,MNE,668,668,8,14,-6,0.020958085,0.011976048,-0.008982036
2021.0,MNE,610,610,10,17,-7,0.027868852,0.016393442,-0.011475409
1996.0,MNG,9,9,0,0,0,0.0,0.0,0.0
1997.0,MNG,13,13,1,0,1,0.0,0.07692308,0.07692308
1998.0,MNG,35,35,0,0,0,0.0,0.0,0.0
1999.0,MNG,57,57,2,0,2,0.0,0.03508772,0.03508772
2000.0,MNG,76,76,3,0,3,0.0,0.039473683,0.039473683
2001.0,MNG,88,88,3,6,-3,0.06818182,0.03409091,-0.03409091
2002.0,MNG,120,120,6,5,1,0.041666668,0.05,0.008333334
2003.0,MNG,142,142,7,2,5,0.014084507,0.049295776,0.03521127
2004.0,MNG,165,165,6,3,3,0.018181818,0.036363635,0.018181818
2005.0,MNG,192,192,3,5,-2,0.026041666,0.015625,-0.010416667
2006.0,MNG,221,221,5,5,0,0.022624435,0.022624435,0.0
2007.0,MNG,267,267,9,6,3,0.02247191,0.033707865,0.011235955
2008.0,MNG,324,324,14,7,7,0.021604938,0.043209877,0.021604938
2009.0,MNG,348,348,11,2,9,0.0057471264,0.031609196,0.02586207
2010.0,MNG,394,394,16,10,6,0.02538071,0.040609136,0.015228426
2011.0,MNG,409,409,12,12,0,0.029339854,0.029339854,0.0
2012.0,MNG,466,466,10,9,1,0.019313306,0.021459227,0.0021459227
2013.0,MNG,513,513,15,12,3,0.023391813,0.029239766,0.0058479533
2014.0,MNG,599,599,30,10,20,0.016694492,0.050083473,0.033388983
2015.0,MNG,672,672,32,9,23,0.013392857,0.04761905,0.03422619
2016.0,MNG,763,763,39,11,28,0.014416776,0.051114023,0.036697246
2017.0,MNG,839,839,33,9,24,0.010727056,0.03933254,0.028605483
2018.0,MNG,924,924,42,25,17,0.027056277,0.045454547,0.018398268
2019.0,MNG,952,952,50,36,14,0.037815128,0.05252101,0.014705882
2020.0,MNG,911,911,20,25,-5,0.027442371,0.021953898,-0.0054884744
2021.0,MNG,863,863,16,16,0,0.018539976,0.018539976,0.0
1997.0,MNP,1,1,0,0,0,0.0,0.0,0.0
2003.0,MNP,3,3,2,0,2,0.0,0.6666667,0.6666667
2008.0,MNP,1,1,0,0,0,0.0,0.0,0.0
2014.0,MNP,7,7,1,0,1,0.0,0.14285715,0.14285715
2015.0,MNP,7,7,1,1,0,0.14285715,0.14285715,0.0
2019.0,MNP,4,4,1,1,0,0.25,0.25,0.0
1996.0,MOZ,15,15,0,0,0,0.0,0.0,0.0
1997.0,MOZ,19,19,2,0,2,0.0,0.10526316,0.10526316
1998.0,MOZ,36,36,1,0,1,0.0,0.027777778,0.027777778
1999.0,MOZ,62,62,0,2,-2,0.032258064,0.0,-0.032258064
2000.0,MOZ,73,73,1,2,-1,0.02739726,0.01369863,-0.01369863
2001.0,MOZ,83,83,3,4,-1,0.04819277,0.036144577,-0.012048192
2002.0,MOZ,97,97,4,10,-6,0.10309278,0.041237112,-0.06185567
2003.0,MOZ,111,111,4,5,-1,0.045045044,0.036036037,-0.009009009
2004.0,MOZ,140,140,7,4,3,0.028571429,0.05,0.021428572
2005.0,MOZ,158,158,6,4,2,0.025316456,0.03797468,0.012658228
2006.0,MOZ,186,186,5,4,1,0.021505376,0.02688172,0.005376344
2007.0,MOZ,217,217,19,3,16,0.013824885,0.08755761,0.07373272
2008.0,MOZ,243,243,9,8,1,0.03292181,0.037037037,0.004115226
2009.0,MOZ,281,281,16,10,6,0.035587188,0.0569395,0.021352313
2010.0,MOZ,299,299,13,8,5,0.026755853,0.04347826,0.016722407
2011.0,MOZ,320,320,12,9,3,0.028125,0.0375,0.009375
2012.0,MOZ,394,394,16,8,8,0.020304568,0.040609136,0.020304568
2013.0,MOZ,486,486,15,7,8,0.014403292,0.030864198,0.016460905
2014.0,MOZ,548,548,19,15,4,0.027372263,0.034671534,0.00729927
2015.0,MOZ,623,623,29,17,12,0.02728732,0.046548955,0.019261638
2016.0,MOZ,699,699,30,23,7,0.032904148,0.042918455,0.010014306
2017.0,MOZ,742,742,22,25,-3,0.03369272,0.029649595,-0.0040431265
2018.0,MOZ,771,771,21,26,-5,0.033722438,0.027237354,-0.0064850845
2019.0,MOZ,805,805,29,20,9,0.024844721,0.036024846,0.011180124
2020.0,MOZ,785,785,42,22,20,0.028025478,0.053503186,0.025477707
2021.0,MOZ,733,733,18,16,2,0.021828104,0.024556616,0.002728513
1997.0,MRT,4,4,0,0,0,0.0,0.0,0.0
1998.0,MRT,6,6,0,0,0,0.0,0.0,0.0
1999.0,MRT,20,20,4,0,4,0.0,0.2,0.2
2000.0,MRT,25,25,1,0,1,0.0,0.04,0.04
2001.0,MRT,24,24,0,2,-2,0.083333336,0.0,-0.083333336
2002.0,MRT,21,21,3,6,-3,0.2857143,0.14285715,-0.14285715
2003.0,MRT,18,18,0,2,-2,0.11111111,0.0,-0.11111111
2004.0,MRT,21,21,4,3,1,0.14285715,0.1904762,0.04761905
2005.0,MRT,18,18,2,0,2,0.0,0.11111111,0.11111111
2006.0,MRT,24,24,4,0,4,0.0,0.16666667,0.16666667
2007.0,MRT,30,30,4,2,2,0.06666667,0.13333334,0.06666667
2008.0,MRT,34,34,1,0,1,0.0,0.029411765,0.029411765
2009.0,MRT,52,52,4,0,4,0.0,0.07692308,0.07692308
2010.0,MRT,54,54,3,3,0,0.055555556,0.055555556,0.0
2011.0,MRT,63,63,2,1,1,0.015873017,0.031746034,0.015873017
2012.0,MRT,77,77,4,0,4,0.0,0.051948052,0.051948052
2013.0,MRT,81,81,2,2,0,0.024691358,0.024691358,0.0
2014.0,MRT,90,90,3,1,2,0.011111111,0.033333335,0.022222223
2015.0,MRT,96,96,4,2,2,0.020833334,0.041666668,0.020833334
2016.0,MRT,117,117,9,2,7,0.017094018,0.07692308,0.05982906
2017.0,MRT,133,133,9,3,6,0.02255639,0.067669176,0.04511278
2018.0,MRT,142,142,6,2,4,0.014084507,0.04225352,0.028169014
2019.0,MRT,156,156,9,6,3,0.03846154,0.057692308,0.01923077
2020.0,MRT,150,150,7,0,7,0.0,0.046666667,0.046666667
2021.0,MRT,133,133,3,3,0,0.02255639,0.02255639,0.0
2001.0,MSR,2,2,0,0,0,0.0,0.0,0.0
2006.0,MSR,5,5,0,0,0,0.0,0.0,0.0
2007.0,MSR,6,6,1,0,1,0.0,0.16666667,0.16666667
2017.0,MSR,4,4,0,0,0,0.0,0.0,0.0
2020.0,MSR,5,5,0,0,0,0.0,0.0,0.0
1996.0,MTQ,21,21,0,0,0,0.0,0.0,0.0
1997.0,MTQ,29,29,0,1,-1,0.03448276,0.0,-0.03448276
1998.0,MTQ,53,53,16,4,12,0.0754717,0.3018868,0.2264151
1999.0,MTQ,60,60,2,6,-4,0.1,0.033333335,-0.06666667
2000.0,MTQ,55,55,1,9,-8,0.16363636,0.018181818,-0.14545454
2001.0,MTQ,42,42,6,12,-6,0.2857143,0.14285715,-0.14285715
2002.0,MTQ,47,47,7,9,-2,0.19148937,0.14893617,-0.04255319
2003.0,MTQ,57,57,7,5,2,0.0877193,0.12280702,0.03508772
2004.0,MTQ,79,79,17,5,12,0.06329114,0.21518987,0.15189873
2005.0,MTQ,77,77,11,12,-1,0.15584415,0.14285715,-0.012987013
2006.0,MTQ,76,76,11,16,-5,0.21052632,0.14473684,-0.065789476
2007.0,MTQ,75,75,17,15,2,0.2,0.22666667,0.026666667
2008.0,MTQ,70,70,9,14,-5,0.2,0.12857144,-0.071428575
2009.0,MTQ,69,69,14,16,-2,0.23188406,0.20289855,-0.028985508
2010.0,MTQ,70,70,17,17,0,0.24285714,0.24285714,0.0
2011.0,MTQ,77,77,23,12,11,0.15584415,0.2987013,0.14285715
2012.0,MTQ,113,113,32,6,26,0.053097345,0.28318584,0.2300885
2013.0,MTQ,108,108,21,30,-9,0.2777778,0.19444445,-0.083333336
2014.0,MTQ,105,105,17,28,-11,0.26666668,0.16190477,-0.104761906
2015.0,MTQ,109,109,21,23,-2,0.21100917,0.19266056,-0.018348623
2016.0,MTQ,105,105,17,23,-6,0.21904762,0.16190477,-0.057142857
2017.0,MTQ,100,100,19,22,-3,0.22,0.19,-0.03
2018.0,MTQ,100,100,26,23,3,0.23,0.26,0.03
2019.0,MTQ,86,86,17,30,-13,0.3488372,0.19767442,-0.15116279
2020.0,MTQ,71,71,10,20,-10,0.28169015,0.14084508,-0.14084508
2021.0,MTQ,63,63,15,11,4,0.17460318,0.23809524,0.06349207
1996.0,MUS,12,12,0,0,0,0.0,0.0,0.0
1997.0,MUS,17,17,0,0,0,0.0,0.0,0.0
1998.0,MUS,54,54,1,0,1,0.0,0.018518519,0.018518519
1999.0,MUS,73,73,0,0,0,0.0,0.0,0.0
2000.0,MUS,93,93,2,0,2,0.0,0.021505376,0.021505376
2001.0,MUS,104,104,2,2,0,0.01923077,0.01923077,0.0
2002.0,MUS,117,117,2,2,0,0.017094018,0.017094018,0.0
2003.0,MUS,124,124,2,4,-2,0.032258064,0.016129032,-0.016129032
2004.0,MUS,129,129,1,2,-1,0.015503876,0.007751938,-0.007751938
2005.0,MUS,131,131,3,6,-3,0.045801528,0.022900764,-0.022900764
2006.0,MUS,147,147,0,2,-2,0.013605442,0.0,-0.013605442
2007.0,MUS,167,167,6,2,4,0.011976048,0.035928145,0.023952097
2008.0,MUS,186,186,2,4,-2,0.021505376,0.010752688,-0.010752688
2009.0,MUS,199,199,2,5,-3,0.025125628,0.010050251,-0.015075377
2010.0,MUS,233,233,4,7,-3,0.030042918,0.017167382,-0.012875536
2011.0,MUS,246,246,3,10,-7,0.040650405,0.0121951215,-0.028455285
2012.0,MUS,268,268,4,3,1,0.01119403,0.014925373,0.0037313432
2013.0,MUS,285,285,6,4,2,0.014035088,0.021052632,0.007017544
2014.0,MUS,311,311,7,5,2,0.01607717,0.022508038,0.006430868
2015.0,MUS,340,340,5,4,1,0.011764706,0.014705882,0.0029411765
2016.0,MUS,370,370,11,1,10,0.0027027028,0.02972973,0.027027028
2017.0,MUS,386,386,12,12,0,0.031088082,0.031088082,0.0
2018.0,MUS,414,414,14,4,10,0.009661836,0.033816423,0.024154589
2019.0,MUS,427,427,20,15,5,0.035128806,0.046838406,0.011709602
2020.0,MUS,409,409,11,12,-1,0.029339854,0.026894866,-0.002444988
2021.0,MUS,388,388,8,5,3,0.012886598,0.020618556,0.0077319588
1996.0,MWI,29,29,0,0,0,0.0,0.0,0.0
1997.0,MWI,34,34,3,1,2,0.029411765,0.0882353,0.05882353
1998.0,MWI,80,80,1,2,-1,0.025,0.0125,-0.0125
1999.0,MWI,123,123,1,1,0,0.008130081,0.008130081,0.0
2000.0,MWI,170,170,1,2,-1,0.011764706,0.005882353,-0.005882353
2001.0,MWI,216,216,10,9,1,0.041666668,0.046296295,0.0046296297
2002.0,MWI,255,255,18,14,4,0.05490196,0.07058824,0.015686275
2003.0,MWI,291,291,14,14,0,0.048109967,0.048109967,0.0
2004.0,MWI,342,342,24,9,15,0.02631579,0.07017544,0.04385965
2005.0,MWI,385,385,13,23,-10,0.05974026,0.033766232,-0.025974026
2006.0,MWI,436,436,19,19,0,0.04357798,0.04357798,0.0
2007.0,MWI,478,478,23,17,6,0.035564855,0.048117153,0.012552301
2008.0,MWI,542,542,28,23,5,0.042435423,0.051660515,0.009225092
2009.0,MWI,627,627,31,31,0,0.049441785,0.049441785,0.0
2010.0,MWI,674,674,32,34,-2,0.050445102,0.047477745,-0.002967359
2011.0,MWI,753,753,28,27,1,0.035856575,0.037184596,0.0013280213
2012.0,MWI,823,823,37,48,-11,0.05832321,0.044957474,-0.013365735
2013.0,MWI,898,898,38,37,1,0.04120267,0.042316258,0.0011135858
2014.0,MWI,948,948,29,51,-22,0.05379747,0.030590717,-0.023206752
2015.0,MWI,1053,1053,51,46,5,0.04368471,0.048433047,0.004748338
2016.0,MWI,1141,1141,50,36,14,0.03155127,0.04382121,0.012269938
2017.0,MWI,1230,1230,73,49,24,0.039837398,0.059349593,0.019512195
2018.0,MWI,1347,1347,69,50,19,0.037119526,0.051224943,0.01410542
2019.0,MWI,1398,1398,64,66,-2,0.047210302,0.045779686,-0.0014306152
2020.0,MWI,1343,1343,76,66,10,0.04914371,0.056589726,0.007446016
2021.0,MWI,1250,1250,50,47,3,0.0376,0.04,0.0024
1996.0,MYS,588,588,0,0,0,0.0,0.0,0.0
1997.0,MYS,774,774,12,5,7,0.006459948,0.015503876,0.009043927
1998.0,MYS,1537,1537,13,8,5,0.005204945,0.008458035,0.0032530904
1999.0,MYS,2180,2180,27,22,5,0.010091743,0.012385321,0.0022935779
2000.0,MYS,2792,2792,23,24,-1,0.008595988,0.008237822,-0.0003581662
2001.0,MYS,3510,3510,43,53,-10,0.015099715,0.012250712,-0.0028490028
2002.0,MYS,4376,4376,101,79,22,0.018053016,0.023080438,0.005027422
2003.0,MYS,5242,5242,120,69,51,0.013162915,0.022892026,0.009729111
2004.0,MYS,6412,6412,115,87,28,0.013568309,0.017935121,0.0043668123
2005.0,MYS,7689,7689,137,93,44,0.012095201,0.017817661,0.005722461
2006.0,MYS,9705,9705,174,128,46,0.013189077,0.017928902,0.0047398247
2007.0,MYS,12733,12733,244,145,99,0.011387733,0.019162806,0.0077750725
2008.0,MYS,16195,16195,309,191,118,0.011793763,0.019079963,0.0072861994
2009.0,MYS,20596,20596,402,255,147,0.012381045,0.019518353,0.0071373084
2010.0,MYS,25104,25104,517,343,174,0.013663162,0.020594327,0.006931166
2011.0,MYS,30136,30136,586,410,176,0.013604991,0.019445183,0.005840191
2012.0,MYS,34756,34756,691,589,102,0.016946714,0.019881459,0.002934745
2013.0,MYS,39906,39906,856,711,145,0.01781687,0.021450408,0.0036335387
2014.0,MYS,44733,44733,913,788,125,0.017615631,0.020409988,0.0027943577
2015.0,MYS,48564,48564,829,992,-163,0.020426653,0.017070258,-0.0033563958
2016.0,MYS,51909,51909,758,1179,-421,0.022712825,0.014602478,-0.008110347
2017.0,MYS,54848,54848,704,1532,-828,0.027931739,0.012835473,-0.015096266
2018.0,MYS,56720,56720,723,1593,-870,0.028085332,0.012746827,-0.015338505
2019.0,MYS,56786,56786,716,1505,-789,0.026503012,0.012608741,-0.01389427
2020.0,MYS,53440,53440,637,1411,-774,0.026403444,0.01191991,-0.014483533
2021.0,MYS,49185,49185,470,911,-441,0.018521907,0.009555759,-0.008966148
2022.0,MYS,0,0,301,491,-190,,,
1996.0,NAM,8,8,0,0,0,0.0,0.0,0.0
1997.0,NAM,13,13,0,0,0,0.0,0.0,0.0
1998.0,NAM,20,20,2,0,2,0.0,0.1,0.1
1999.0,NAM,50,50,4,0,4,0.0,0.08,0.08
2000.0,NAM,64,64,0,2,-2,0.03125,0.0,-0.03125
2001.0,NAM,78,78,2,3,-1,0.03846154,0.025641026,-0.012820513
2002.0,NAM,89,89,8,5,3,0.056179777,0.08988764,0.033707865
2003.0,NAM,107,107,11,7,4,0.06542056,0.10280374,0.037383176
2004.0,NAM,109,109,3,5,-2,0.04587156,0.027522936,-0.018348623
2005.0,NAM,117,117,4,4,0,0.034188036,0.034188036,0.0
2006.0,NAM,117,117,2,4,-2,0.034188036,0.017094018,-0.017094018
2007.0,NAM,125,125,3,8,-5,0.064,0.024,-0.04
2008.0,NAM,128,128,7,3,4,0.0234375,0.0546875,0.03125
2009.0,NAM,151,151,8,2,6,0.013245033,0.052980132,0.0397351
2010.0,NAM,174,174,3,5,-2,0.028735632,0.01724138,-0.011494253
2011.0,NAM,221,221,15,7,8,0.03167421,0.06787331,0.036199097
2012.0,NAM,261,261,25,8,17,0.03065134,0.09578544,0.0651341
2013.0,NAM,300,300,24,7,17,0.023333333,0.08,0.05666667
2014.0,NAM,348,348,28,10,18,0.028735632,0.08045977,0.05172414
2015.0,NAM,368,368,14,19,-5,0.051630434,0.038043477,-0.013586956
2016.0,NAM,398,398,19,18,1,0.04522613,0.047738694,0.0025125628
2017.0,NAM,455,455,36,13,23,0.028571429,0.07912088,0.05054945
2018.0,NAM,496,496,21,19,2,0.038306452,0.04233871,0.004032258
2019.0,NAM,537,537,46,14,32,0.026070764,0.08566108,0.059590317
2020.0,NAM,523,523,22,22,0,0.04206501,0.04206501,0.0
2021.0,NAM,512,512,34,9,25,0.017578125,0.06640625,0.048828125
1998.0,NCL,22,22,3,0,3,0.0,0.13636364,0.13636364
2000.0,NCL,58,58,2,0,2,0.0,0.03448276,0.03448276
2001.0,NCL,73,73,7,2,5,0.02739726,0.09589041,0.06849315
2002.0,NCL,87,87,11,9,2,0.10344828,0.12643678,0.022988506
2003.0,NCL,111,111,12,9,3,0.08108108,0.10810811,0.027027028
2004.0,NCL,132,132,17,9,8,0.06818182,0.12878788,0.060606062
2005.0,NCL,152,152,21,10,11,0.065789476,0.13815789,0.07236842
2006.0,NCL,158,158,13,18,-5,0.11392405,0.08227848,-0.03164557
2007.0,NCL,177,177,17,9,8,0.050847456,0.096045196,0.04519774
2008.0,NCL,190,190,21,19,2,0.1,0.110526316,0.010526316
2009.0,NCL,198,198,20,10,10,0.05050505,0.1010101,0.05050505
2010.0,NCL,195,195,12,30,-18,0.15384616,0.06153846,-0.092307694
2011.0,NCL,192,192,16,28,-12,0.14583333,0.083333336,-0.0625
2012.0,NCL,226,226,33,15,18,0.06637168,0.1460177,0.07964602
2013.0,NCL,262,262,30,18,12,0.06870229,0.114503816,0.045801528
2014.0,NCL,280,280,17,17,0,0.060714286,0.060714286,0.0
2015.0,NCL,284,284,26,31,-5,0.10915493,0.09154929,-0.017605634
2016.0,NCL,296,296,31,21,10,0.07094595,0.10472973,0.033783782
2017.0,NCL,300,300,32,24,8,0.08,0.10666667,0.026666667
2018.0,NCL,312,312,41,28,13,0.08974359,0.13141026,0.041666668
2019.0,NCL,283,283,22,32,-10,0.113074206,0.077738516,-0.03533569
2020.0,NCL,263,263,27,27,0,0.102661595,0.102661595,0.0
2021.0,NCL,236,236,15,12,3,0.050847456,0.06355932,0.012711864
1996.0,NER,26,26,0,0,0,0.0,0.0,0.0
1997.0,NER,27,27,1,4,-3,0.14814815,0.037037037,-0.11111111
1998.0,NER,40,40,0,7,-7,0.175,0.0,-0.175
1999.0,NER,48,48,2,5,-3,0.104166664,0.041666668,-0.0625
2000.0,NER,54,54,1,3,-2,0.055555556,0.018518519,-0.037037037
2001.0,NER,63,63,5,9,-4,0.14285715,0.07936508,-0.06349207
2002.0,NER,78,78,8,6,2,0.07692308,0.102564104,0.025641026
2003.0,NER,92,92,6,6,0,0.06521739,0.06521739,0.0
2004.0,NER,115,115,18,6,12,0.052173913,0.15652174,0.104347825
2005.0,NER,130,130,3,6,-3,0.046153847,0.023076924,-0.023076924
2006.0,NER,138,138,14,9,5,0.06521739,0.10144927,0.036231883
2007.0,NER,155,155,9,7,2,0.045161292,0.058064517,0.012903226
2008.0,NER,163,163,7,4,3,0.024539877,0.042944785,0.018404908
2009.0,NER,177,177,10,17,-7,0.096045196,0.056497175,-0.03954802
2010.0,NER,192,192,4,9,-5,0.046875,0.020833334,-0.026041666
2011.0,NER,195,195,9,12,-3,0.06153846,0.046153847,-0.015384615
2012.0,NER,230,230,17,5,12,0.02173913,0.073913045,0.052173913
2013.0,NER,264,264,13,8,5,0.030303031,0.049242426,0.018939395
2014.0,NER,288,288,11,13,-2,0.045138888,0.038194444,-0.0069444445
2015.0,NER,302,302,17,10,7,0.03311258,0.05629139,0.023178808
2016.0,NER,329,329,18,10,8,0.030395137,0.054711245,0.02431611
2017.0,NER,331,331,13,10,3,0.03021148,0.039274924,0.009063444
2018.0,NER,355,355,21,13,8,0.03661972,0.059154928,0.02253521
2019.0,NER,337,337,12,8,4,0.023738872,0.03560831,0.011869436
2020.0,NER,327,327,16,12,4,0.036697246,0.048929665,0.012232416
2021.0,NER,307,307,10,5,5,0.016286645,0.03257329,0.016286645
1996.0,NGA,524,524,0,0,0,0.0,0.0,0.0
1997.0,NGA,680,680,5,4,1,0.005882353,0.007352941,0.0014705883
1998.0,NGA,1461,1461,8,14,-6,0.009582478,0.0054757018,-0.0041067763
1999.0,NGA,2246,2246,19,14,5,0.006233304,0.008459483,0.00222618
2000.0,NGA,2985,2985,16,17,-1,0.0056951423,0.005360134,-0.00033500837
2001.0,NGA,3621,3621,39,48,-9,0.013256007,0.010770505,-0.0024855013
2002.0,NGA,4398,4398,54,67,-13,0.0152341975,0.012278308,-0.002955889
2003.0,NGA,5175,5175,69,61,8,0.01178744,0.013333334,0.0015458937
2004.0,NGA,6316,6316,60,62,-2,0.009816339,0.009499683,-0.0003166561
2005.0,NGA,7551,7551,68,68,0,0.00900543,0.00900543,0.0
2006.0,NGA,8870,8870,90,75,15,0.008455467,0.010146561,0.0016910936
2007.0,NGA,10218,10218,72,104,-32,0.010178117,0.007046389,-0.0031317284
2008.0,NGA,11742,11742,81,114,-33,0.009708738,0.0068983138,-0.0028104242
2009.0,NGA,13077,13077,106,118,-12,0.009023476,0.008105835,-0.0009176417
2010.0,NGA,14107,14107,123,128,-5,0.00907351,0.0087190755,-0.00035443396
2011.0,NGA,15122,15122,107,156,-49,0.010316095,0.007075784,-0.0032403122
2012.0,NGA,16144,16144,159,201,-42,0.012450446,0.00984886,-0.0026015858
2013.0,NGA,16813,16813,173,176,-3,0.01046809,0.010289657,-0.00017843336
2014.0,NGA,17305,17305,200,212,-12,0.012250795,0.011557354,-0.0006934412
2015.0,NGA,18345,18345,260,247,13,0.013464159,0.014172799,0.00070864
2016.0,NGA,19883,19883,284,272,12,0.013680028,0.014283558,0.0006035307
2017.0,NGA,21616,21616,358,315,43,0.014572538,0.016561806,0.0019892673
2018.0,NGA,24013,24013,393,364,29,0.015158456,0.016366135,0.0012076792
2019.0,NGA,25224,25224,449,446,3,0.017681573,0.017800508,0.000118934346
2020.0,NGA,24676,24676,456,386,70,0.01564273,0.018479494,0.0028367646
2021.0,NGA,23183,23183,324,374,-50,0.016132511,0.013975758,-0.0021567529
1996.0,NIC,18,18,0,0,0,0.0,0.0,0.0
1997.0,NIC,19,19,0,0,0,0.0,0.0,0.0
1998.0,NIC,22,22,0,1,-1,0.045454547,0.0,-0.045454547
1999.0,NIC,20,20,0,1,-1,0.05,0.0,-0.05
2000.0,NIC,29,29,0,0,0,0.0,0.0,0.0
2001.0,NIC,36,36,1,1,0,0.027777778,0.027777778,0.0
2002.0,NIC,56,56,11,1,10,0.017857144,0.19642857,0.17857143
2003.0,NIC,85,85,10,0,10,0.0,0.11764706,0.11764706
2004.0,NIC,104,104,4,1,3,0.009615385,0.03846154,0.028846154
2005.0,NIC,98,98,3,6,-3,0.06122449,0.030612245,-0.030612245
2006.0,NIC,100,100,2,9,-7,0.09,0.02,-0.07
2007.0,NIC,112,112,5,5,0,0.04464286,0.04464286,0.0
2008.0,NIC,120,120,5,2,3,0.016666668,0.041666668,0.025
2009.0,NIC,140,140,5,8,-3,0.057142857,0.035714287,-0.021428572
2010.0,NIC,145,145,9,7,2,0.048275862,0.062068965,0.013793103
2011.0,NIC,149,149,2,6,-4,0.040268455,0.013422819,-0.026845638
2012.0,NIC,156,156,6,7,-1,0.044871796,0.03846154,-0.0064102565
2013.0,NIC,158,158,6,7,-1,0.044303797,0.03797468,-0.006329114
2014.0,NIC,159,159,4,5,-1,0.031446543,0.025157232,-0.006289308
2015.0,NIC,178,178,10,1,9,0.0056179776,0.056179777,0.050561797
2016.0,NIC,184,184,7,3,4,0.016304348,0.038043477,0.02173913
2017.0,NIC,181,181,4,6,-2,0.03314917,0.022099448,-0.011049724
2018.0,NIC,183,183,6,4,2,0.021857923,0.032786883,0.010928961
2019.0,NIC,175,175,5,3,2,0.017142856,0.028571429,0.011428571
2020.0,NIC,149,149,3,9,-6,0.060402684,0.020134227,-0.040268455
2021.0,NIC,120,120,0,8,-8,0.06666667,0.0,-0.06666667
2014.0,NIU,1,1,0,0,0,0.0,0.0,0.0
2017.0,NIU,2,2,0,0,0,0.0,0.0,0.0
1996.0,NLD,11431,11431,0,0,0,0.0,0.0,0.0
1997.0,NLD,13212,13212,128,165,-37,0.012488646,0.009688162,-0.0028004844
1998.0,NLD,23336,23336,272,275,-3,0.011784367,0.011655811,-0.00012855674
1999.0,NLD,31852,31852,499,410,89,0.012872033,0.015666205,0.002794173
2000.0,NLD,38169,38169,401,380,21,0.009955723,0.010505908,0.0005501847
2001.0,NLD,43424,43424,922,870,52,0.020035004,0.021232499,0.0011974945
2002.0,NLD,49101,49101,1333,1132,201,0.02305452,0.027148124,0.0040936028
2003.0,NLD,53529,53529,1232,1210,22,0.02260457,0.023015562,0.0004109922
2004.0,NLD,56991,56991,1106,1074,32,0.018845081,0.019406574,0.00056149217
2005.0,NLD,60030,60030,1061,1133,-72,0.018873896,0.017674496,-0.0011994003
2006.0,NLD,63191,63191,1131,1325,-194,0.020968176,0.017898118,-0.0030700574
2007.0,NLD,67043,67043,1265,1350,-85,0.02013633,0.018868487,-0.0012678431
2008.0,NLD,70585,70585,1395,1450,-55,0.020542609,0.019763406,-0.0007792024
2009.0,NLD,74560,74560,1532,1549,-17,0.020775214,0.020547211,-0.0002280043
2010.0,NLD,78312,78312,1631,1610,21,0.020558791,0.020826949,0.00026815812
2011.0,NLD,81912,81912,1702,1733,-31,0.021156851,0.020778397,-0.00037845492
2012.0,NLD,85314,85314,1776,1849,-73,0.021672878,0.020817216,-0.0008556626
2013.0,NLD,88726,88726,1774,1991,-217,0.022439871,0.01999414,-0.0024457318
2014.0,NLD,91585,91585,2021,2226,-205,0.02430529,0.022066932,-0.002238358
2015.0,NLD,94350,94350,2149,2415,-266,0.025596185,0.022776894,-0.00281929
2016.0,NLD,97332,97332,2269,2408,-139,0.024740065,0.023311963,-0.0014281018
2017.0,NLD,99337,99337,2263,2592,-329,0.026092997,0.022781039,-0.0033119584
2018.0,NLD,101067,101067,2511,2586,-75,0.025586987,0.024844905,-0.00074208196
2019.0,NLD,100352,100352,2624,2636,-12,0.026267538,0.02614796,-0.00011957908
2020.0,NLD,95662,95662,2604,2474,130,0.02586189,0.02722084,0.0013589513
2021.0,NLD,88979,88979,2112,1810,302,0.020341879,0.023735939,0.0033940594
2022.0,NLD,0,0,1131,980,151,,,
1996.0,NOR,2843,2843,0,0,0,0.0,0.0,0.0
1997.0,NOR,3419,3419,29,26,3,0.0076045627,0.008482012,0.0008774495
1998.0,NOR,6489,6489,73,54,19,0.008321775,0.011249808,0.002928032
1999.0,NOR,9020,9020,103,88,15,0.009756098,0.011419069,0.0016629712
2000.0,NOR,10833,10833,115,77,38,0.007107911,0.010615711,0.0035078002
2001.0,NOR,12367,12367,212,220,-8,0.017789278,0.017142395,-0.0006468828
2002.0,NOR,13906,13906,338,304,34,0.021861067,0.024306055,0.002444988
2003.0,NOR,15291,15291,343,282,61,0.018442221,0.022431497,0.0039892746
2004.0,NOR,16596,16596,298,201,97,0.012111352,0.017956134,0.005844782
2005.0,NOR,17882,17882,336,213,123,0.011911419,0.018789845,0.0068784254
2006.0,NOR,19167,19167,373,231,142,0.012051964,0.019460531,0.007408567
2007.0,NOR,20575,20575,409,241,168,0.011713244,0.019878494,0.008165249
2008.0,NOR,22046,22046,487,251,236,0.011385285,0.022090174,0.01070489
2009.0,NOR,23575,23575,521,293,228,0.01242842,0.022099681,0.0096712615
2010.0,NOR,24848,24848,562,344,218,0.0138441725,0.022617515,0.008773342
2011.0,NOR,26194,26194,551,325,226,0.012407421,0.02103535,0.00862793
2012.0,NOR,27664,27664,581,349,232,0.012615674,0.021002024,0.00838635
2013.0,NOR,28979,28979,651,421,230,0.014527761,0.022464544,0.007936782
2014.0,NOR,30247,30247,682,419,263,0.013852613,0.02254769,0.008695077
2015.0,NOR,31465,31465,747,464,283,0.014746544,0.023740664,0.00899412
2016.0,NOR,32735,32735,775,495,280,0.015121429,0.023674965,0.008553536
2017.0,NOR,33902,33902,789,480,309,0.014158457,0.023272963,0.009114507
2018.0,NOR,34997,34997,948,570,378,0.01628711,0.027088037,0.010800926
2019.0,NOR,35447,35447,899,592,307,0.01670099,0.025361808,0.0086608175
2020.0,NOR,34453,34453,921,572,349,0.016602328,0.02673207,0.010129742
2021.0,NOR,32483,32483,753,481,272,0.014807746,0.023181356,0.008373611
1996.0,NPL,25,25,0,0,0,0.0,0.0,0.0
1997.0,NPL,31,31,1,0,1,0.0,0.032258064,0.032258064
1998.0,NPL,93,93,0,2,-2,0.021505376,0.0,-0.021505376
1999.0,NPL,202,202,3,5,-2,0.024752475,0.014851485,-0.00990099
2000.0,NPL,273,273,0,2,-2,0.0073260074,0.0,-0.0073260074
2001.0,NPL,456,456,13,11,2,0.024122806,0.028508771,0.004385965
2002.0,NPL,612,612,20,22,-2,0.035947714,0.03267974,-0.003267974
2003.0,NPL,815,815,30,20,10,0.024539877,0.036809817,0.012269938
2004.0,NPL,976,976,30,29,1,0.029713115,0.030737706,0.0010245901
2005.0,NPL,1141,1141,43,34,9,0.029798422,0.03768624,0.007887818
2006.0,NPL,1290,1290,34,38,-4,0.029457364,0.026356589,-0.0031007752
2007.0,NPL,1451,1451,35,51,-16,0.035148174,0.024121296,-0.011026878
2008.0,NPL,1614,1614,41,42,-1,0.026022306,0.025402727,-0.0006195787
2009.0,NPL,1763,1763,61,66,-5,0.037436187,0.034600113,-0.002836075
2010.0,NPL,1901,1901,50,78,-28,0.041031037,0.026301946,-0.01472909
2011.0,NPL,2053,2053,47,67,-20,0.032635167,0.022893326,-0.009741841
2012.0,NPL,2193,2193,59,77,-18,0.035111718,0.026903784,-0.008207934
2013.0,NPL,2419,2419,75,70,5,0.028937578,0.031004548,0.0020669699
2014.0,NPL,2672,2672,81,93,-12,0.03480539,0.030314371,-0.004491018
2015.0,NPL,2984,2984,103,76,27,0.025469169,0.034517426,0.009048257
2016.0,NPL,3234,3234,90,112,-22,0.034632035,0.027829314,-0.006802721
2017.0,NPL,3677,3677,125,93,32,0.025292357,0.033995103,0.008702747
2018.0,NPL,4312,4312,122,122,0,0.028293135,0.028293135,0.0
2019.0,NPL,4649,4649,132,118,14,0.025381802,0.028393203,0.0030114003
2020.0,NPL,4567,4567,161,137,24,0.02999781,0.035252903,0.005255091
2021.0,NPL,4304,4304,100,107,-7,0.024860594,0.023234202,-0.0016263941
2001.0,NRU,1,1,0,0,0,0.0,0.0,0.0
2011.0,NRU,1,1,0,0,0,0.0,0.0,0.0
1996.0,NZL,2120,2120,0,0,0,0.0,0.0,0.0
1997.0,NZL,2639,2639,40,34,6,0.012883668,0.015157256,0.0022735884
1998.0,NZL,5042,5042,74,69,5,0.013685046,0.014676715,0.00099167
1999.0,NZL,7071,7071,130,124,6,0.017536417,0.018384952,0.00084853626
2000.0,NZL,8450,8450,125,129,-4,0.015266272,0.0147929,-0.00047337278
2001.0,NZL,9623,9623,262,279,-17,0.028993037,0.027226437,-0.0017666009
2002.0,NZL,10839,10839,369,398,-29,0.036719255,0.03404373,-0.0026755235
2003.0,NZL,11874,11874,445,431,14,0.036297794,0.03747684,0.0011790467
2004.0,NZL,12796,12796,412,391,21,0.030556424,0.03219756,0.0016411379
2005.0,NZL,13868,13868,460,409,51,0.029492356,0.033169888,0.003677531
2006.0,NZL,14803,14803,498,423,75,0.028575288,0.03364183,0.0050665406
2007.0,NZL,15629,15629,499,469,30,0.030008318,0.031927828,0.0019195086
2008.0,NZL,16600,16600,534,522,12,0.031445783,0.032168675,0.0007228916
2009.0,NZL,17509,17509,594,555,39,0.031697985,0.03392541,0.0022274258
2010.0,NZL,18267,18267,570,551,19,0.030163683,0.03120381,0.001040127
2011.0,NZL,19021,19021,553,620,-67,0.032595553,0.02907313,-0.0035224226
2012.0,NZL,19851,19851,628,586,42,0.029519923,0.031635687,0.0021157623
2013.0,NZL,20656,20656,598,655,-57,0.031709913,0.028950427,-0.0027594888
2014.0,NZL,21257,21257,568,714,-146,0.033588935,0.02672061,-0.0068683256
2015.0,NZL,21708,21708,602,702,-100,0.03233831,0.027731711,-0.0046065967
2016.0,NZL,22378,22378,615,703,-88,0.03141478,0.02748235,-0.0039324337
2017.0,NZL,22982,22982,667,702,-35,0.030545644,0.029022714,-0.001522931
2018.0,NZL,23377,23377,763,670,93,0.02866065,0.03263892,0.003978269
2019.0,NZL,23413,23413,817,722,95,0.03083757,0.034895144,0.004057575
2020.0,NZL,22346,22346,772,685,87,0.030654255,0.03454757,0.0038933142
2021.0,NZL,20783,20783,539,485,54,0.02333638,0.025934659,0.0025982775
1996.0,OMN,76,76,0,0,0,0.0,0.0,0.0
1997.0,OMN,87,87,2,1,1,0.011494253,0.022988506,0.011494253
1998.0,OMN,247,247,12,4,8,0.016194332,0.048582997,0.032388665
1999.0,OMN,366,366,14,6,8,0.016393442,0.038251366,0.021857923
2000.0,OMN,457,457,10,6,4,0.013129103,0.021881837,0.008752735
2001.0,OMN,561,561,30,10,20,0.017825311,0.053475935,0.035650622
2002.0,OMN,639,639,31,22,9,0.034428794,0.0485133,0.014084507
2003.0,OMN,714,714,41,27,14,0.037815128,0.05742297,0.019607844
2004.0,OMN,760,760,35,31,4,0.040789474,0.04605263,0.005263158
2005.0,OMN,855,855,55,32,23,0.0374269,0.064327486,0.026900584
2006.0,OMN,920,920,42,27,15,0.029347826,0.045652173,0.016304348
2007.0,OMN,1000,1000,50,31,19,0.031,0.05,0.019
2008.0,OMN,1098,1098,64,31,33,0.028233152,0.058287796,0.030054646
2009.0,OMN,1238,1238,66,35,31,0.028271405,0.053311795,0.025040388
2010.0,OMN,1369,1369,76,33,43,0.024105186,0.055514973,0.03140979
2011.0,OMN,1507,1507,82,42,40,0.02786994,0.05441274,0.0265428
2012.0,OMN,1645,1645,84,52,32,0.031610943,0.05106383,0.019452887
2013.0,OMN,1817,1817,127,50,77,0.027517887,0.06989543,0.042377546
2014.0,OMN,1974,1974,118,65,53,0.032928064,0.059777103,0.026849037
2015.0,OMN,2114,2114,116,64,52,0.030274361,0.05487228,0.024597919
2016.0,OMN,2208,2208,101,78,23,0.035326086,0.045742754,0.010416667
2017.0,OMN,2327,2327,140,75,65,0.03223034,0.0601633,0.02793296
2018.0,OMN,2472,2472,145,82,63,0.03317152,0.058656957,0.025485437
2019.0,OMN,2536,2536,144,93,51,0.036671925,0.056782335,0.02011041
2020.0,OMN,2458,2458,131,88,43,0.035801463,0.053295363,0.017493898
2021.0,OMN,2350,2350,91,54,37,0.022978723,0.038723405,0.01574468
2022.0,OMN,0,0,61,29,32,,,
1996.0,PAK,611,611,0,0,0,0.0,0.0,0.0
1997.0,PAK,738,738,8,11,-3,0.014905149,0.010840109,-0.0040650405
1998.0,PAK,1473,1473,14,11,3,0.007467753,0.009504412,0.00203666
1999.0,PAK,2300,2300,17,18,-1,0.007826087,0.0073913042,-0.00043478262
2000.0,PAK,3088,3088,21,20,1,0.006476684,0.006800518,0.0003238342
2001.0,PAK,3834,3834,40,65,-25,0.016953573,0.010432968,-0.006520605
2002.0,PAK,4637,4637,73,80,-7,0.017252535,0.015742937,-0.0015095967
2003.0,PAK,5661,5661,96,80,16,0.014131779,0.016958134,0.0028263559
2004.0,PAK,6856,6856,113,90,23,0.013127188,0.016481914,0.003354726
2005.0,PAK,8154,8154,106,105,1,0.012877116,0.012999754,0.00012263919
2006.0,PAK,9695,9695,134,117,17,0.012068076,0.013821557,0.0017534812
2007.0,PAK,11623,11623,157,159,-2,0.013679773,0.0135077005,-0.00017207261
2008.0,PAK,13737,13737,169,183,-14,0.013321686,0.01230254,-0.0010191454
2009.0,PAK,16372,16372,234,219,15,0.013376497,0.014292695,0.00091619836
2010.0,PAK,18800,18800,256,273,-17,0.014521277,0.013617021,-0.0009042553
2011.0,PAK,21379,21379,320,349,-29,0.01632443,0.014967959,-0.0013564713
2012.0,PAK,23833,23833,393,404,-11,0.016951285,0.01648974,-0.00046154493
2013.0,PAK,26007,26007,491,495,-4,0.019033337,0.018879533,-0.00015380475
2014.0,PAK,28527,28527,561,597,-36,0.020927543,0.01966558,-0.0012619623
2015.0,PAK,31369,31369,635,649,-14,0.020689216,0.020242915,-0.0004463005
2016.0,PAK,34665,34665,748,683,65,0.01970287,0.02157796,0.0018750902
2017.0,PAK,38062,38062,801,839,-38,0.022042982,0.021044612,-0.000998371
2018.0,PAK,42445,42445,994,893,101,0.021038992,0.023418542,0.00237955
2019.0,PAK,45098,45098,1075,991,84,0.021974366,0.023836978,0.0018626103
2020.0,PAK,44060,44060,1192,1058,134,0.024012709,0.027054017,0.0030413072
2021.0,PAK,41744,41744,921,804,117,0.019260254,0.02206305,0.002802798
2022.0,PAK,0,0,554,549,5,,,
1996.0,PAN,25,25,0,0,0,0.0,0.0,0.0
1997.0,PAN,34,34,2,0,2,0.0,0.05882353,0.05882353
1998.0,PAN,52,52,3,4,-1,0.07692308,0.057692308,-0.01923077
1999.0,PAN,70,70,3,4,-1,0.057142857,0.042857144,-0.014285714
2000.0,PAN,95,95,1,2,-1,0.021052632,0.010526316,-0.010526316
2001.0,PAN,115,115,6,6,0,0.052173913,0.052173913,0.0
2002.0,PAN,141,141,15,15,0,0.10638298,0.10638298,0.0
2003.0,PAN,154,154,12,16,-4,0.103896104,0.077922076,-0.025974026
2004.0,PAN,176,176,10,15,-5,0.08522727,0.056818184,-0.028409092
2005.0,PAN,213,213,20,6,14,0.028169014,0.09389672,0.065727696
2006.0,PAN,238,238,18,13,5,0.05462185,0.075630255,0.021008404
2007.0,PAN,272,272,20,13,7,0.04779412,0.073529415,0.025735294
2008.0,PAN,311,311,20,18,2,0.057877813,0.06430868,0.006430868
2009.0,PAN,348,348,22,19,3,0.054597702,0.06321839,0.00862069
2010.0,PAN,386,386,30,30,0,0.07772021,0.07772021,0.0
2011.0,PAN,454,454,43,18,25,0.039647575,0.09471366,0.05506608
2012.0,PAN,485,485,24,32,-8,0.065979384,0.049484536,-0.016494846
2013.0,PAN,543,543,28,16,12,0.02946593,0.05156538,0.022099448
2014.0,PAN,570,570,31,34,-3,0.05964912,0.054385964,-0.005263158
2015.0,PAN,606,606,27,25,2,0.041254126,0.044554457,0.0033003301
2016.0,PAN,645,645,38,20,18,0.031007752,0.05891473,0.027906977
2017.0,PAN,696,696,30,20,10,0.028735632,0.04310345,0.014367816
2018.0,PAN,732,732,36,27,9,0.036885247,0.04918033,0.012295082
2019.0,PAN,768,768,42,27,15,0.03515625,0.0546875,0.01953125
2020.0,PAN,738,738,39,37,2,0.0501355,0.05284553,0.0027100272
2021.0,PAN,706,706,28,27,1,0.038243625,0.039660055,0.0014164306
1996.0,PER,142,142,0,0,0,0.0,0.0,0.0
1997.0,PER,236,236,6,3,3,0.012711864,0.025423728,0.012711864
1998.0,PER,380,380,5,5,0,0.013157895,0.013157895,0.0
1999.0,PER,539,539,4,6,-2,0.011131725,0.0074211503,-0.0037105752
2000.0,PER,684,684,17,8,9,0.0116959065,0.024853801,0.013157895
2001.0,PER,834,834,13,27,-14,0.0323741,0.01558753,-0.016786572
2002.0,PER,982,982,45,45,0,0.045824848,0.045824848,0.0
2003.0,PER,1194,1194,49,34,15,0.028475711,0.041038524,0.012562814
2004.0,PER,1390,1390,38,36,2,0.02589928,0.02733813,0.0014388489
2005.0,PER,1596,1596,45,38,7,0.023809524,0.02819549,0.004385965
2006.0,PER,1816,1816,63,34,29,0.018722467,0.03469163,0.015969163
2007.0,PER,2086,2086,61,60,1,0.028763182,0.02924257,0.0004793864
2008.0,PER,2375,2375,78,63,15,0.026526315,0.032842107,0.0063157897
2009.0,PER,2642,2642,70,75,-5,0.028387586,0.026495079,-0.0018925057
2010.0,PER,2868,2868,73,81,-8,0.028242677,0.025453277,-0.0027894003
2011.0,PER,3085,3085,93,91,2,0.02949757,0.030145867,0.00064829824
2012.0,PER,3304,3304,69,73,-4,0.02209443,0.020883778,-0.0012106538
2013.0,PER,3677,3677,72,87,-15,0.023660593,0.01958118,-0.0040794127
2014.0,PER,4088,4088,113,101,12,0.024706459,0.02764188,0.0029354207
2015.0,PER,4637,4637,135,100,35,0.021565668,0.02911365,0.0075479834
2016.0,PER,5322,5322,143,110,33,0.020668922,0.026869599,0.0062006763
2017.0,PER,6158,6158,179,110,69,0.017862942,0.02906788,0.011204937
2018.0,PER,6971,6971,180,156,24,0.022378424,0.02582126,0.0034428346
2019.0,PER,7628,7628,199,152,47,0.019926587,0.026088096,0.00616151
2020.0,PER,7477,7477,211,153,58,0.020462753,0.028219875,0.0077571217
2021.0,PER,7051,7051,124,145,-21,0.02056446,0.017586159,-0.002978301
1996.0,PHL,192,192,0,0,0,0.0,0.0,0.0
1997.0,PHL,227,227,4,2,2,0.008810572,0.017621145,0.008810572
1998.0,PHL,446,446,6,3,3,0.0067264573,0.013452915,0.0067264573
1999.0,PHL,648,648,13,9,4,0.013888889,0.020061728,0.0061728396
2000.0,PHL,870,870,10,17,-7,0.01954023,0.011494253,-0.008045977
2001.0,PHL,1070,1070,41,25,16,0.023364486,0.03831776,0.0149532715
2002.0,PHL,1236,1236,48,56,-8,0.045307443,0.03883495,-0.006472492
2003.0,PHL,1416,1416,59,54,5,0.038135592,0.041666668,0.0035310735
2004.0,PHL,1532,1532,47,53,-6,0.0345953,0.030678852,-0.003916449
2005.0,PHL,1664,1664,48,53,-5,0.03185096,0.028846154,-0.0030048077
2006.0,PHL,1813,1813,58,57,1,0.031439602,0.031991176,0.00055157195
2007.0,PHL,2013,2013,61,52,9,0.02583209,0.030303031,0.004470939
2008.0,PHL,2225,2225,91,69,22,0.031011237,0.040898878,0.00988764
2009.0,PHL,2522,2522,71,81,-10,0.032117367,0.02815226,-0.0039651073
2010.0,PHL,2831,2831,112,74,38,0.026139174,0.03956199,0.013422819
2011.0,PHL,3166,3166,90,78,12,0.024636766,0.028427036,0.0037902717
2012.0,PHL,3552,3552,111,90,21,0.025337838,0.03125,0.0059121624
2013.0,PHL,4005,4005,88,93,-5,0.023220973,0.021972535,-0.0012484394
2014.0,PHL,4443,4443,111,110,1,0.024758046,0.02498312,0.00022507315
2015.0,PHL,4949,4949,151,94,57,0.018993735,0.030511213,0.011517478
2016.0,PHL,5505,5505,138,142,-4,0.025794731,0.02506812,-0.00072661217
2017.0,PHL,6166,6166,129,148,-19,0.024002595,0.02092118,-0.0030814142
2018.0,PHL,6707,6707,132,153,-21,0.022811988,0.01968093,-0.0031310571
2019.0,PHL,6983,6983,171,179,-8,0.025633682,0.024488043,-0.0011456395
2020.0,PHL,6763,6763,155,155,0,0.022918822,0.022918822,0.0
2021.0,PHL,6334,6334,107,122,-15,0.019261131,0.016892958,-0.0023681717
2000.0,PLW,8,8,2,1,1,0.125,0.25,0.125
2002.0,PLW,15,15,3,0,3,0.0,0.2,0.2
2004.0,PLW,14,14,5,2,3,0.14285715,0.35714287,0.21428572
2005.0,PLW,22,22,6,0,6,0.0,0.27272728,0.27272728
2006.0,PLW,16,16,0,6,-6,0.375,0.0,-0.375
2007.0,PLW,15,15,0,1,-1,0.06666667,0.0,-0.06666667
2010.0,PLW,17,17,0,0,0,0.0,0.0,0.0
2012.0,PLW,24,24,0,1,-1,0.041666668,0.0,-0.041666668
2013.0,PLW,25,25,2,0,2,0.0,0.08,0.08
2014.0,PLW,23,23,0,0,0,0.0,0.0,0.0
2015.0,PLW,24,24,1,1,0,0.041666668,0.041666668,0.0
2017.0,PLW,27,27,2,1,1,0.037037037,0.074074075,0.037037037
2020.0,PLW,24,24,0,1,-1,0.041666668,0.0,-0.041666668
1996.0,PNG,48,48,0,0,0,0.0,0.0,0.0
1997.0,PNG,64,64,2,1,1,0.015625,0.03125,0.015625
1998.0,PNG,94,94,1,6,-5,0.06382979,0.010638298,-0.05319149
1999.0,PNG,124,124,2,3,-1,0.024193548,0.016129032,-0.008064516
2000.0,PNG,135,135,3,10,-7,0.074074075,0.022222223,-0.05185185
2001.0,PNG,156,156,10,10,0,0.06410257,0.06410257,0.0
2002.0,PNG,169,169,10,10,0,0.0591716,0.0591716,0.0
2003.0,PNG,184,184,11,8,3,0.04347826,0.05978261,0.016304348
2004.0,PNG,191,191,11,8,3,0.041884817,0.057591625,0.015706806
2005.0,PNG,202,202,5,11,-6,0.054455444,0.024752475,-0.02970297
2006.0,PNG,203,203,3,8,-5,0.039408866,0.014778325,-0.024630541
2007.0,PNG,207,207,7,5,2,0.024154589,0.033816423,0.009661836
2008.0,PNG,228,228,4,10,-6,0.04385965,0.01754386,-0.02631579
2009.0,PNG,251,251,7,8,-1,0.03187251,0.027888447,-0.003984064
2010.0,PNG,251,251,12,7,5,0.027888447,0.047808766,0.01992032
2011.0,PNG,278,278,16,9,7,0.0323741,0.05755396,0.025179856
2012.0,PNG,308,308,12,15,-3,0.048701297,0.038961038,-0.0097402595
2013.0,PNG,311,311,10,10,0,0.03215434,0.03215434,0.0
2014.0,PNG,330,330,13,12,1,0.036363635,0.03939394,0.003030303
2015.0,PNG,335,335,6,12,-6,0.035820894,0.017910447,-0.017910447
2016.0,PNG,327,327,13,17,-4,0.051987767,0.03975535,-0.012232416
2017.0,PNG,346,346,19,20,-1,0.057803467,0.054913294,-0.0028901733
2018.0,PNG,365,365,21,15,6,0.04109589,0.057534248,0.016438356
2019.0,PNG,372,372,20,15,5,0.04032258,0.05376344,0.01344086
2020.0,PNG,357,357,10,9,1,0.025210084,0.028011205,0.0028011205
2021.0,PNG,325,325,7,9,-2,0.027692307,0.02153846,-0.006153846
1996.0,POL,9874,9874,0,0,0,0.0,0.0,0.0
1997.0,POL,12285,12285,121,93,28,0.0075702076,0.00984941,0.0022792022
1998.0,POL,19070,19070,135,98,37,0.0051389616,0.007079182,0.0019402202
1999.0,POL,25140,25140,153,177,-24,0.007040573,0.0060859188,-0.00095465395
2000.0,POL,30289,30289,164,175,-11,0.005777675,0.005414507,-0.00036316816
2001.0,POL,34874,34874,301,318,-17,0.009118541,0.008631072,-0.00048746917
2002.0,POL,39665,39665,385,432,-47,0.010891214,0.00970629,-0.0011849237
2003.0,POL,43396,43396,366,417,-51,0.0096091805,0.008433957,-0.0011752235
2004.0,POL,46803,46803,281,359,-78,0.0076704486,0.006003889,-0.0016665598
2005.0,POL,49865,49865,277,412,-135,0.008262308,0.0055549983,-0.0027073098
2006.0,POL,53621,53621,327,373,-46,0.00695623,0.006098357,-0.00085787283
2007.0,POL,56680,56680,316,437,-121,0.0077099507,0.0055751586,-0.0021347918
2008.0,POL,59682,59682,347,502,-155,0.008411246,0.005814148,-0.002597098
2009.0,POL,62670,62670,385,432,-47,0.00689325,0.00614329,-0.00074996013
2010.0,POL,66446,66446,473,514,-41,0.007735605,0.0071185622,-0.0006170424
2011.0,POL,71904,71904,1105,446,659,0.0062027145,0.015367713,0.009164997
2012.0,POL,76434,76434,1092,475,617,0.006214512,0.014286836,0.008072324
2013.0,POL,80887,80887,1050,612,438,0.0075661107,0.012981072,0.005414962
2014.0,POL,83601,83601,447,1571,-1124,0.018791642,0.005346826,-0.013444815
2015.0,POL,86042,86042,464,904,-440,0.010506497,0.0053927153,-0.0051137814
2016.0,POL,87763,87763,468,678,-210,0.007725351,0.0053325435,-0.002392808
2017.0,POL,90504,90504,523,693,-170,0.00765712,0.00577875,-0.0018783701
2018.0,POL,93319,93319,597,654,-57,0.007008219,0.006397411,-0.0006108081
2019.0,POL,93397,93397,649,655,-6,0.007013073,0.0069488315,-6.424189e-05
2020.0,POL,89355,89355,558,557,1,0.0062335627,0.006244754,1.1191316e-05
2021.0,POL,83702,83702,501,412,89,0.004922224,0.00598552,0.001063296
1996.0,PRI,209,209,0,0,0,0.0,0.0,0.0
1997.0,PRI,275,275,5,5,0,0.018181818,0.018181818,0.0
1998.0,PRI,436,436,12,8,4,0.018348623,0.027522936,0.0091743115
1999.0,PRI,589,589,25,17,8,0.028862478,0.04244482,0.013582343
2000.0,PRI,701,701,21,18,3,0.025677603,0.029957203,0.0042796005
2001.0,PRI,835,835,27,30,-3,0.035928145,0.03233533,-0.0035928143
2002.0,PRI,956,956,47,50,-3,0.052301254,0.04916318,-0.0031380753
2003.0,PRI,1057,1057,54,49,5,0.046357617,0.051087987,0.004730369
2004.0,PRI,1154,1154,59,57,2,0.049393415,0.051126517,0.0017331023
2005.0,PRI,1282,1282,53,60,-7,0.046801873,0.041341655,-0.0054602185
2006.0,PRI,1434,1434,77,46,31,0.032078102,0.053695954,0.021617852
2007.0,PRI,1517,1517,75,61,14,0.040210944,0.049439684,0.009228741
2008.0,PRI,1624,1624,81,64,17,0.039408866,0.049876846,0.01046798
2009.0,PRI,1666,1666,73,107,-34,0.06422569,0.043817528,-0.020408163
2010.0,PRI,1754,1754,92,73,19,0.041619156,0.05245154,0.010832383
2011.0,PRI,1769,1769,67,82,-15,0.046353873,0.037874505,-0.008479367
2012.0,PRI,1753,1753,55,93,-38,0.05305191,0.031374786,-0.021677125
2013.0,PRI,1738,1738,58,108,-50,0.06214039,0.03337169,-0.0287687
2014.0,PRI,1678,1678,53,105,-52,0.06257449,0.03158522,-0.030989273
2015.0,PRI,1688,1688,81,106,-25,0.062796205,0.04798578,-0.014810426
2016.0,PRI,1722,1722,99,104,-5,0.06039489,0.057491288,-0.0029036005
2017.0,PRI,1729,1729,81,112,-31,0.06477733,0.046847887,-0.017929439
2018.0,PRI,1705,1705,70,124,-54,0.07272727,0.04105572,-0.031671554
2019.0,PRI,1645,1645,87,124,-37,0.07537994,0.052887537,-0.022492401
2020.0,PRI,1500,1500,73,97,-24,0.064666666,0.048666667,-0.016
2021.0,PRI,1316,1316,34,57,-23,0.04331307,0.025835866,-0.017477203
2004.0,PRK,3,3,0,0,0,0.0,0.0,0.0
2006.0,PRK,8,8,0,0,0,0.0,0.0,0.0
2007.0,PRK,15,15,0,0,0,0.0,0.0,0.0
2008.0,PRK,18,18,0,1,-1,0.055555556,0.0,-0.055555556
2009.0,PRK,21,21,0,0,0,0.0,0.0,0.0
2010.0,PRK,24,24,1,0,1,0.0,0.041666668,0.041666668
2011.0,PRK,27,27,2,1,1,0.037037037,0.074074075,0.037037037
2012.0,PRK,37,37,2,0,2,0.0,0.054054055,0.054054055
2013.0,PRK,59,59,1,4,-3,0.06779661,0.016949153,-0.050847456
2014.0,PRK,90,90,1,1,0,0.011111111,0.011111111,0.0
2015.0,PRK,123,123,1,0,1,0.0,0.008130081,0.008130081
2016.0,PRK,187,187,6,3,3,0.01604278,0.03208556,0.01604278
2017.0,PRK,296,296,7,1,6,0.0033783785,0.02364865,0.02027027
2018.0,PRK,373,373,10,3,7,0.008042895,0.026809651,0.018766755
2019.0,PRK,435,435,13,5,8,0.011494253,0.029885057,0.018390805
2020.0,PRK,432,432,8,5,3,0.011574074,0.018518519,0.0069444445
2021.0,PRK,417,417,5,3,2,0.007194245,0.0119904075,0.004796163
1996.0,PRT,2314,2314,0,0,0,0.0,0.0,0.0
1997.0,PRT,2909,2909,21,24,-3,0.008250258,0.0072189756,-0.0010312822
1998.0,PRT,4907,4907,51,32,19,0.006521296,0.010393316,0.0038720195
1999.0,PRT,6947,6947,95,59,36,0.008492875,0.013674968,0.005182093
2000.0,PRT,8656,8656,90,62,28,0.0071626618,0.010397412,0.0032347504
2001.0,PRT,10304,10304,158,156,2,0.015139751,0.015333851,0.00019409938
2002.0,PRT,12270,12270,304,169,135,0.013773431,0.024775876,0.011002445
2003.0,PRT,13925,13925,306,181,125,0.012998205,0.021974865,0.008976661
2004.0,PRT,15526,15526,255,176,79,0.011335824,0.016424064,0.005088239
2005.0,PRT,17164,17164,241,216,25,0.0125844795,0.014041016,0.0014565369
2006.0,PRT,19099,19099,316,229,87,0.011990157,0.016545368,0.0045552123
2007.0,PRT,21107,21107,310,242,68,0.01146539,0.014687071,0.00322168
2008.0,PRT,23437,23437,374,280,94,0.011946921,0.015957674,0.0040107523
2009.0,PRT,25989,25989,406,333,73,0.012813114,0.015621994,0.0028088808
2010.0,PRT,28743,28743,527,381,146,0.0132554015,0.0183349,0.0050794976
2011.0,PRT,31552,31552,543,421,122,0.013343053,0.017209686,0.003866633
2012.0,PRT,34443,34443,538,443,95,0.012861829,0.01562001,0.0027581803
2013.0,PRT,36880,36880,545,537,8,0.014560738,0.014777658,0.00021691974
2014.0,PRT,38849,38849,544,725,-181,0.018661998,0.014002934,-0.0046590646
2015.0,PRT,40537,40537,556,793,-237,0.019562375,0.013715864,-0.0058465106
2016.0,PRT,42101,42101,586,822,-236,0.019524477,0.013918909,-0.0056055677
2017.0,PRT,43753,43753,593,845,-252,0.019312961,0.013553357,-0.005759605
2018.0,PRT,45431,45431,676,776,-100,0.017080847,0.014879707,-0.0022011402
2019.0,PRT,46087,46087,729,728,1,0.01579621,0.01581791,2.1698093e-05
2020.0,PRT,44339,44339,795,798,-3,0.017997699,0.017930038,-6.766053e-05
2021.0,PRT,41626,41626,559,530,29,0.012732427,0.013429107,0.00069668
1996.0,PRY,17,17,0,0,0,0.0,0.0,0.0
1997.0,PRY,19,19,0,0,0,0.0,0.0,0.0
1998.0,PRY,28,28,1,0,1,0.0,0.035714287,0.035714287
1999.0,PRY,40,40,0,2,-2,0.05,0.0,-0.05
2000.0,PRY,40,40,1,1,0,0.025,0.025,0.0
2001.0,PRY,50,50,2,0,2,0.0,0.04,0.04
2002.0,PRY,63,63,1,7,-6,0.11111111,0.015873017,-0.0952381
2003.0,PRY,87,87,4,3,1,0.03448276,0.04597701,0.011494253
2004.0,PRY,104,104,4,2,2,0.01923077,0.03846154,0.01923077
2005.0,PRY,112,112,2,4,-2,0.035714287,0.017857144,-0.017857144
2006.0,PRY,124,124,4,2,2,0.016129032,0.032258064,0.016129032
2007.0,PRY,150,150,6,2,4,0.013333334,0.04,0.026666667
2008.0,PRY,156,156,6,7,-1,0.044871796,0.03846154,-0.0064102565
2009.0,PRY,187,187,8,11,-3,0.05882353,0.04278075,-0.01604278
2010.0,PRY,217,217,5,8,-3,0.03686636,0.023041476,-0.013824885
2011.0,PRY,247,247,12,11,1,0.04453441,0.048582997,0.004048583
2012.0,PRY,259,259,8,7,1,0.027027028,0.03088803,0.0038610038
2013.0,PRY,280,280,10,8,2,0.028571429,0.035714287,0.007142857
2014.0,PRY,319,319,11,13,-2,0.04075235,0.03448276,-0.0062695923
2015.0,PRY,375,375,21,5,16,0.013333334,0.056,0.042666666
2016.0,PRY,409,409,16,16,0,0.039119806,0.039119806,0.0
2017.0,PRY,503,503,24,11,13,0.021868788,0.04771372,0.02584493
2018.0,PRY,528,528,17,12,5,0.022727273,0.03219697,0.009469697
2019.0,PRY,541,541,17,10,7,0.018484289,0.03142329,0.012939001
2020.0,PRY,521,521,21,10,11,0.019193858,0.0403071,0.021113243
2021.0,PRY,487,487,19,14,5,0.028747434,0.039014373,0.01026694
1996.0,PSE,26,26,0,0,0,0.0,0.0,0.0
1997.0,PSE,30,30,2,1,1,0.033333335,0.06666667,0.033333335
1998.0,PSE,53,53,1,1,0,0.018867925,0.018867925,0.0
1999.0,PSE,80,80,3,2,1,0.025,0.0375,0.0125
2000.0,PSE,119,119,6,1,5,0.008403362,0.05042017,0.042016808
2001.0,PSE,148,148,4,6,-2,0.04054054,0.027027028,-0.013513514
2002.0,PSE,170,170,10,8,2,0.047058824,0.05882353,0.011764706
2003.0,PSE,203,203,18,9,9,0.044334974,0.08866995,0.044334974
2004.0,PSE,247,247,12,7,5,0.02834008,0.048582997,0.020242915
2005.0,PSE,308,308,27,12,15,0.038961038,0.08766234,0.048701297
2006.0,PSE,352,352,30,14,16,0.039772727,0.08522727,0.045454547
2007.0,PSE,385,385,24,13,11,0.033766232,0.062337663,0.028571429
2008.0,PSE,419,419,26,24,2,0.057279237,0.062052507,0.00477327
2009.0,PSE,467,467,24,10,14,0.021413276,0.051391862,0.029978586
2010.0,PSE,525,525,42,24,18,0.045714285,0.08,0.034285713
2011.0,PSE,604,604,48,23,25,0.03807947,0.0794702,0.04139073
2012.0,PSE,701,701,54,15,39,0.021398002,0.07703281,0.055634808
2013.0,PSE,746,746,44,39,5,0.05227882,0.058981232,0.006702413
2014.0,PSE,833,833,52,24,28,0.028811524,0.06242497,0.033613447
2015.0,PSE,908,908,55,39,16,0.042951543,0.060572688,0.017621145
2016.0,PSE,1040,1040,72,24,48,0.023076924,0.06923077,0.046153847
2017.0,PSE,1158,1158,55,31,24,0.026770294,0.04749568,0.020725388
2018.0,PSE,1322,1322,77,34,43,0.025718609,0.05824508,0.032526474
2019.0,PSE,1440,1440,87,42,45,0.029166667,0.060416665,0.03125
2020.0,PSE,1422,1422,79,45,34,0.03164557,0.055555556,0.023909986
2021.0,PSE,1339,1339,52,47,5,0.03510082,0.03883495,0.00373413
1997.0,PYF,5,5,0,0,0,0.0,0.0,0.0
1999.0,PYF,48,48,1,0,1,0.0,0.020833334,0.020833334
2000.0,PYF,55,55,1,3,-2,0.054545455,0.018181818,-0.036363635
2001.0,PYF,65,65,2,4,-2,0.06153846,0.03076923,-0.03076923
2002.0,PYF,63,63,6,12,-6,0.1904762,0.0952381,-0.0952381
2003.0,PYF,72,72,10,3,7,0.041666668,0.1388889,0.097222224
2004.0,PYF,69,69,4,10,-6,0.14492753,0.057971016,-0.08695652
2005.0,PYF,76,76,7,5,2,0.065789476,0.09210526,0.02631579
2006.0,PYF,83,83,7,4,3,0.04819277,0.084337346,0.036144577
2007.0,PYF,90,90,7,8,-1,0.08888889,0.07777778,-0.011111111
2008.0,PYF,91,91,7,9,-2,0.0989011,0.07692308,-0.021978023
2009.0,PYF,98,98,11,5,6,0.05102041,0.1122449,0.06122449
2010.0,PYF,114,114,5,4,1,0.03508772,0.04385965,0.00877193
2011.0,PYF,124,124,16,5,11,0.04032258,0.12903225,0.088709675
2012.0,PYF,146,146,15,7,8,0.047945205,0.10273973,0.05479452
2013.0,PYF,166,166,17,11,6,0.06626506,0.10240964,0.036144577
2014.0,PYF,176,176,12,10,2,0.056818184,0.06818182,0.011363637
2015.0,PYF,194,194,25,8,17,0.041237112,0.12886597,0.087628864
2016.0,PYF,199,199,10,15,-5,0.07537688,0.050251257,-0.025125628
2017.0,PYF,187,187,11,21,-10,0.112299465,0.05882353,-0.053475935
2018.0,PYF,195,195,27,14,13,0.071794875,0.13846155,0.06666667
2019.0,PYF,197,197,15,11,4,0.055837564,0.07614213,0.020304568
2020.0,PYF,181,181,13,25,-12,0.13812155,0.0718232,-0.06629834
2021.0,PYF,160,160,12,14,-2,0.0875,0.075,-0.0125
1996.0,QAT,16,16,0,0,0,0.0,0.0,0.0
1997.0,QAT,24,24,1,2,-1,0.083333336,0.041666668,-0.041666668
1998.0,QAT,66,66,6,0,6,0.0,0.09090909,0.09090909
1999.0,QAT,124,124,2,2,0,0.016129032,0.016129032,0.0
2000.0,QAT,192,192,7,1,6,0.0052083335,0.036458332,0.03125
2001.0,QAT,256,256,12,2,10,0.0078125,0.046875,0.0390625
2002.0,QAT,305,305,9,10,-1,0.032786883,0.029508196,-0.0032786885
2003.0,QAT,371,371,20,11,9,0.029649595,0.053908356,0.02425876
2004.0,QAT,435,435,25,7,18,0.016091954,0.057471264,0.04137931
2005.0,QAT,481,481,20,12,8,0.024948025,0.04158004,0.016632017
2006.0,QAT,574,574,33,11,22,0.019163763,0.057491288,0.038327526
2007.0,QAT,653,653,42,10,32,0.0153139355,0.06431853,0.049004596
2008.0,QAT,767,767,61,16,45,0.020860495,0.07953064,0.058670145
2009.0,QAT,872,872,56,21,35,0.02408257,0.06422018,0.040137615
2010.0,QAT,1029,1029,88,23,65,0.022351798,0.085519925,0.06316812
2011.0,QAT,1193,1193,100,40,60,0.03352892,0.083822295,0.05029338
2012.0,QAT,1478,1478,139,51,88,0.03450609,0.09404601,0.059539918
2013.0,QAT,1872,1872,188,39,149,0.020833334,0.10042735,0.079594016
2014.0,QAT,2378,2378,283,55,228,0.023128679,0.11900757,0.09587889
2015.0,QAT,2818,2818,333,98,235,0.034776438,0.11816891,0.08339248
2016.0,QAT,3311,3311,334,122,212,0.036846872,0.10087587,0.06402899
2017.0,QAT,3774,3774,277,161,116,0.042660307,0.07339693,0.03073662
2018.0,QAT,4336,4336,278,200,78,0.04612546,0.06411439,0.01798893
2019.0,QAT,4703,4703,303,186,117,0.039549224,0.06442696,0.024877738
2020.0,QAT,4672,4672,300,188,112,0.040239725,0.06421233,0.023972603
2021.0,QAT,4509,4509,192,152,40,0.033710357,0.042581502,0.0088711465
2000.0,REU,8,8,0,0,0,0.0,0.0,0.0
2001.0,REU,5,5,0,3,-3,0.6,0.0,-0.6
2004.0,REU,15,15,4,1,3,0.06666667,0.26666668,0.2
2005.0,REU,24,24,4,2,2,0.083333336,0.16666667,0.083333336
2006.0,REU,36,36,12,3,9,0.083333336,0.33333334,0.25
2007.0,REU,45,45,12,10,2,0.22222222,0.26666668,0.044444446
2008.0,REU,59,59,15,10,5,0.16949153,0.2542373,0.084745765
2009.0,REU,57,57,10,12,-2,0.21052632,0.1754386,-0.03508772
2010.0,REU,67,67,13,11,2,0.1641791,0.19402985,0.029850746
2011.0,REU,68,68,15,15,0,0.22058824,0.22058824,0.0
2012.0,REU,62,62,15,18,-3,0.29032257,0.24193548,-0.048387095
2013.0,REU,44,44,5,20,-15,0.45454547,0.11363637,-0.3409091
2014.0,REU,36,36,6,17,-11,0.4722222,0.16666667,-0.30555555
2015.0,REU,37,37,8,9,-1,0.24324325,0.21621622,-0.027027028
2016.0,REU,40,40,8,6,2,0.15,0.2,0.05
2017.0,REU,44,44,19,15,4,0.3409091,0.4318182,0.09090909
2018.0,REU,54,54,24,16,8,0.2962963,0.44444445,0.14814815
2019.0,REU,43,43,9,19,-10,0.44186047,0.20930232,-0.23255815
2020.0,REU,41,41,9,11,-2,0.2682927,0.2195122,-0.048780486
1996.0,ROU,2029,2029,0,0,0,0.0,0.0,0.0
1997.0,ROU,2481,2481,14,20,-6,0.008061266,0.005642886,-0.0024183798
1998.0,ROU,3633,3633,21,34,-13,0.009358657,0.0057803467,-0.00357831
1999.0,ROU,4607,4607,22,64,-42,0.013891904,0.004775342,-0.009116562
2000.0,ROU,5415,5415,33,58,-25,0.010710988,0.006094183,-0.0046168054
2001.0,ROU,6221,6221,54,123,-69,0.019771742,0.008680277,-0.011091464
2002.0,ROU,7056,7056,84,162,-78,0.022959184,0.011904762,-0.011054422
2003.0,ROU,7886,7886,87,153,-66,0.01940147,0.011032209,-0.008369262
2004.0,ROU,8708,8708,97,127,-30,0.01458429,0.011139182,-0.003445108
2005.0,ROU,9822,9822,108,133,-25,0.013541031,0.010995724,-0.0025453065
2006.0,ROU,12159,12159,128,144,-16,0.011843079,0.010527181,-0.0013158977
2007.0,ROU,14918,14918,159,144,15,0.009652768,0.010658265,0.0010054967
2008.0,ROU,17292,17292,197,139,58,0.008038399,0.0113925515,0.0033541522
2009.0,ROU,19597,19597,201,149,52,0.0076032043,0.010256672,0.0026534675
2010.0,ROU,21421,21421,173,154,19,0.007189207,0.008076187,0.0008869801
2011.0,ROU,23007,23007,145,166,-21,0.0072151953,0.00630243,-0.0009127657
2012.0,ROU,24152,24152,154,167,-13,0.006914541,0.0063762837,-0.0005382577
2013.0,ROU,25132,25132,143,186,-43,0.007400923,0.005689957,-0.0017109661
2014.0,ROU,25789,25789,140,182,-42,0.0070572724,0.0054286714,-0.0016286013
2015.0,ROU,26286,26286,170,224,-54,0.008521646,0.006467321,-0.0020543255
2016.0,ROU,26588,26588,151,175,-24,0.0065819165,0.005679254,-0.00090266287
2017.0,ROU,27173,27173,178,177,1,0.0065138186,0.0065506203,3.6801237e-05
2018.0,ROU,27681,27681,168,166,2,0.005996893,0.0060691447,7.225172e-05
2019.0,ROU,27604,27604,181,178,3,0.0064483406,0.006557021,0.0001086799
2020.0,ROU,26416,26416,175,167,8,0.006321926,0.0066247727,0.00030284675
2021.0,ROU,24633,24633,117,98,19,0.003978403,0.004749726,0.00077132304
2022.0,ROU,0,0,59,62,-3,,,
1996.0,RUS,36288,36288,0,0,0,0.0,0.0,0.0
1997.0,RUS,42204,42204,226,258,-32,0.0061131646,0.0053549428,-0.00075822196
1998.0,RUS,54441,54441,239,454,-215,0.008339304,0.0043900735,-0.0039492296
1999.0,RUS,63142,63142,298,768,-470,0.012163061,0.004719521,-0.00744354
2000.0,RUS,70327,70327,311,674,-363,0.009583801,0.004422199,-0.005161602
2001.0,RUS,75558,75558,537,1053,-516,0.013936314,0.007107123,-0.006829191
2002.0,RUS,80421,80421,787,1268,-481,0.015767027,0.009786001,-0.005981025
2003.0,RUS,83743,83743,815,993,-178,0.011857707,0.009732157,-0.0021255508
2004.0,RUS,85333,85333,604,892,-288,0.0104531655,0.0070781526,-0.0033750131
2005.0,RUS,87278,87278,585,812,-227,0.009303604,0.00670272,-0.0026008845
2006.0,RUS,89772,89772,546,781,-235,0.008699818,0.0060820747,-0.0026177426
2007.0,RUS,92697,92697,498,714,-216,0.0077025145,0.005372342,-0.0023301726
2008.0,RUS,95827,95827,494,691,-197,0.0072109113,0.0051551233,-0.002055788
2009.0,RUS,100296,100296,502,701,-199,0.0069893114,0.0050051846,-0.001984127
2010.0,RUS,104546,104546,514,731,-217,0.0069921375,0.004916496,-0.0020756414
2011.0,RUS,111032,111032,503,727,-224,0.006547662,0.0045302254,-0.0020174363
2012.0,RUS,119867,119867,513,685,-172,0.005714667,0.0042797434,-0.0014349237
2013.0,RUS,132191,132191,596,651,-55,0.004924692,0.0045086276,-0.00041606463
2014.0,RUS,146688,146688,757,719,38,0.0049015596,0.005160613,0.00025905322
2015.0,RUS,159995,159995,861,690,171,0.004312635,0.0053814184,0.0010687833
2016.0,RUS,172866,172866,923,750,173,0.0043386207,0.0053393957,0.0010007751
2017.0,RUS,183855,183855,850,814,36,0.004427402,0.0046232087,0.00019580648
2018.0,RUS,190812,190812,814,851,-37,0.0044598873,0.004265979,-0.00019390814
2019.0,RUS,189301,189301,772,957,-185,0.0050554406,0.0040781614,-0.0009772796
2020.0,RUS,179840,179840,721,966,-245,0.005371441,0.0040091192,-0.001362322
2021.0,RUS,166034,166034,533,741,-208,0.0044629415,0.0032101858,-0.0012527554
2022.0,RUS,0,0,266,445,-179,,,
1996.0,RWA,7,7,0,0,0,0.0,0.0,0.0
1997.0,RWA,7,7,0,0,0,0.0,0.0,0.0
2001.0,RWA,11,11,0,0,0,0.0,0.0,0.0
2002.0,RWA,23,23,2,2,0,0.08695652,0.08695652,0.0
2003.0,RWA,32,32,4,3,1,0.09375,0.125,0.03125
2004.0,RWA,52,52,4,2,2,0.03846154,0.07692308,0.03846154
2005.0,RWA,65,65,2,3,-1,0.046153847,0.03076923,-0.015384615
2006.0,RWA,86,86,1,2,-1,0.023255814,0.011627907,-0.011627907
2007.0,RWA,125,125,8,4,4,0.032,0.064,0.032
2008.0,RWA,159,159,13,5,8,0.031446543,0.08176101,0.050314464
2009.0,RWA,233,233,16,5,11,0.021459227,0.06866953,0.047210302
2010.0,RWA,283,283,12,11,1,0.038869258,0.042402826,0.003533569
2011.0,RWA,379,379,19,10,9,0.026385223,0.050131924,0.023746701
2012.0,RWA,482,482,18,11,7,0.022821577,0.0373444,0.014522822
2013.0,RWA,537,537,27,21,6,0.039106146,0.05027933,0.011173184
2014.0,RWA,631,631,36,20,16,0.03169572,0.0570523,0.025356578
2015.0,RWA,676,676,34,37,-3,0.054733727,0.05029586,-0.00443787
2016.0,RWA,780,780,38,33,5,0.042307694,0.04871795,0.0064102565
2017.0,RWA,875,875,39,36,3,0.04114286,0.04457143,0.0034285714
2018.0,RWA,995,995,51,33,18,0.033165827,0.05125628,0.018090453
2019.0,RWA,1065,1065,59,42,17,0.03943662,0.05539906,0.01596244
2020.0,RWA,1037,1037,55,41,14,0.039537128,0.05303761,0.013500482
2021.0,RWA,969,969,29,42,-13,0.043343652,0.02992776,-0.013415893
1996.0,SAU,1033,1033,0,0,0,0.0,0.0,0.0
1997.0,SAU,1270,1270,16,11,5,0.008661417,0.012598425,0.003937008
1998.0,SAU,2038,2038,25,24,1,0.011776251,0.012266928,0.00049067714
1999.0,SAU,2594,2594,40,44,-4,0.01696222,0.0154202,-0.00154202
2000.0,SAU,3094,3094,47,45,2,0.014544279,0.015190692,0.00064641243
2001.0,SAU,3574,3574,104,81,23,0.022663683,0.029099049,0.0064353663
2002.0,SAU,4045,4045,149,106,43,0.026205191,0.0368356,0.010630408
2003.0,SAU,4390,4390,168,115,53,0.0261959,0.038268793,0.012072893
2004.0,SAU,4675,4675,179,123,56,0.02631016,0.03828877,0.0119786095
2005.0,SAU,4956,4956,168,113,55,0.022800645,0.033898305,0.011097659
2006.0,SAU,5289,5289,206,154,52,0.029117035,0.038948763,0.009831727
2007.0,SAU,5937,5937,295,161,134,0.027118074,0.049688395,0.022570321
2008.0,SAU,6722,6722,327,178,149,0.026480215,0.048646238,0.022166021
2009.0,SAU,7986,7986,510,195,315,0.024417732,0.06386176,0.039444026
2010.0,SAU,9764,9764,769,220,549,0.02253175,0.07875871,0.056226958
2011.0,SAU,11871,11871,887,230,657,0.019374948,0.074719906,0.055344958
2012.0,SAU,14090,14090,977,331,646,0.023491839,0.06933996,0.04584812
2013.0,SAU,16342,16342,1105,422,683,0.025823032,0.067617185,0.04179415
2014.0,SAU,18736,18736,1182,536,646,0.028608028,0.063087106,0.034479078
2015.0,SAU,21147,21147,1249,647,602,0.030595357,0.059062753,0.028467394
2016.0,SAU,23751,23751,1418,749,669,0.031535514,0.05970275,0.028167235
2017.0,SAU,26480,26480,1451,842,609,0.031797584,0.054796074,0.02299849
2018.0,SAU,29834,29834,1588,952,636,0.0319099,0.05322786,0.021317959
2019.0,SAU,32386,32386,1721,1064,657,0.032853704,0.053140245,0.020286543
2020.0,SAU,32347,32347,1806,943,863,0.029152626,0.05583207,0.026679445
2021.0,SAU,31339,31339,1293,733,560,0.023389388,0.041258495,0.01786911
2022.0,SAU,0,0,634,478,156,,,
1996.0,SDN,48,48,0,0,0,0.0,0.0,0.0
1997.0,SDN,51,51,1,1,0,0.019607844,0.019607844,0.0
1998.0,SDN,112,112,1,2,-1,0.017857144,0.008928572,-0.008928572
1999.0,SDN,151,151,2,4,-2,0.026490066,0.013245033,-0.013245033
2000.0,SDN,196,196,3,5,-2,0.025510205,0.015306123,-0.010204081
2001.0,SDN,231,231,11,12,-1,0.051948052,0.04761905,-0.0043290043
2002.0,SDN,278,278,11,18,-7,0.0647482,0.039568346,-0.025179856
2003.0,SDN,326,326,15,8,7,0.024539877,0.04601227,0.021472393
2004.0,SDN,381,381,14,7,7,0.018372703,0.036745407,0.018372703
2005.0,SDN,451,451,20,14,6,0.031042129,0.044345897,0.01330377
2006.0,SDN,520,520,17,15,2,0.028846154,0.03269231,0.0038461538
2007.0,SDN,623,623,16,10,6,0.016051365,0.025682183,0.009630819
2008.0,SDN,729,729,22,8,14,0.010973937,0.030178327,0.01920439
2009.0,SDN,868,868,22,13,9,0.014976959,0.025345622,0.010368664
2010.0,SDN,933,933,25,29,-4,0.03108253,0.026795285,-0.004287245
2011.0,SDN,1014,1014,33,24,9,0.02366864,0.03254438,0.00887574
2012.0,SDN,1067,1067,26,36,-10,0.033739455,0.024367385,-0.009372071
2013.0,SDN,1076,1076,29,43,-14,0.039962824,0.026951673,-0.013011153
2014.0,SDN,1112,1112,44,46,-2,0.041366905,0.039568346,-0.0017985612
2015.0,SDN,1122,1122,40,46,-6,0.040998217,0.035650622,-0.0053475937
2016.0,SDN,1184,1184,46,45,1,0.038006756,0.03885135,0.0008445946
2017.0,SDN,1255,1255,49,63,-14,0.050199203,0.039043825,-0.011155378
2018.0,SDN,1341,1341,68,60,8,0.04474273,0.050708428,0.005965697
2019.0,SDN,1378,1378,62,72,-10,0.052249637,0.044992745,-0.007256894
2020.0,SDN,1334,1334,83,70,13,0.052473765,0.06221889,0.0097451275
2021.0,SDN,1225,1225,38,56,-18,0.045714285,0.031020408,-0.014693878
1996.0,SEN,275,275,0,0,0,0.0,0.0,0.0
1997.0,SEN,354,354,8,6,2,0.016949153,0.02259887,0.0056497175
1998.0,SEN,459,459,6,17,-11,0.037037037,0.013071896,-0.02396514
1999.0,SEN,525,525,14,30,-16,0.057142857,0.026666667,-0.03047619
2000.0,SEN,616,616,6,29,-23,0.04707792,0.0097402595,-0.03733766
2001.0,SEN,722,722,27,27,0,0.03739612,0.03739612,0.0
2002.0,SEN,767,767,30,43,-13,0.056062583,0.03911343,-0.016949153
2003.0,SEN,859,859,31,29,2,0.033760186,0.036088474,0.0023282887
2004.0,SEN,920,920,36,31,5,0.033695653,0.039130434,0.0054347827
2005.0,SEN,978,978,34,31,3,0.03169734,0.034764826,0.0030674846
2006.0,SEN,1012,1012,37,36,1,0.03557312,0.036561266,0.0009881423
2007.0,SEN,1088,1088,40,41,-1,0.037683822,0.036764707,-0.00091911765
2008.0,SEN,1154,1154,42,38,4,0.032928944,0.036395147,0.0034662045
2009.0,SEN,1272,1272,39,38,1,0.029874213,0.030660378,0.0007861635
2010.0,SEN,1362,1362,40,32,8,0.02349486,0.029368576,0.005873715
2011.0,SEN,1466,1466,37,40,-3,0.027285129,0.025238745,-0.0020463846
2012.0,SEN,1557,1557,42,47,-5,0.030186256,0.026974952,-0.0032113038
2013.0,SEN,1710,1710,48,46,2,0.026900584,0.028070176,0.0011695906
2014.0,SEN,1881,1881,67,36,31,0.019138755,0.035619352,0.016480595
2015.0,SEN,1970,1970,59,52,7,0.02639594,0.029949239,0.0035532995
2016.0,SEN,1966,1966,51,66,-15,0.033570703,0.025940998,-0.007629705
2017.0,SEN,2023,2023,55,64,-9,0.031636182,0.027187346,-0.0044488385
2018.0,SEN,2006,2006,62,70,-8,0.034895316,0.030907279,-0.003988036
2019.0,SEN,1961,1961,52,55,-3,0.028046915,0.026517084,-0.0015298317
2020.0,SEN,1854,1854,63,59,4,0.031823084,0.033980582,0.0021574972
2021.0,SEN,1664,1664,35,43,-8,0.025841346,0.021033654,-0.0048076925
1996.0,SGP,1323,1323,0,0,0,0.0,0.0,0.0
1997.0,SGP,1731,1731,23,21,2,0.012131716,0.013287118,0.0011554015
1998.0,SGP,3457,3457,86,35,51,0.010124385,0.02487706,0.014752676
1999.0,SGP,4924,4924,168,63,105,0.012794476,0.034118604,0.021324126
2000.0,SGP,6265,6265,140,63,77,0.010055866,0.022346368,0.012290503
2001.0,SGP,7542,7542,246,174,72,0.023070803,0.03261734,0.00954654
2002.0,SGP,9102,9102,359,305,54,0.03350912,0.03944188,0.005932762
2003.0,SGP,10390,10390,380,339,41,0.032627527,0.03657363,0.003946102
2004.0,SGP,11431,11431,397,359,38,0.031405825,0.03473012,0.0033242935
2005.0,SGP,12259,12259,393,421,-28,0.034342118,0.03205808,-0.0022840363
2006.0,SGP,13348,13348,474,476,-2,0.035660774,0.03551094,-0.00014983518
2007.0,SGP,14435,14435,563,519,44,0.035954278,0.039002426,0.0030481468
2008.0,SGP,15706,15706,696,570,126,0.036291864,0.044314276,0.008022412
2009.0,SGP,17319,17319,813,593,220,0.03423985,0.046942662,0.0127028115
2010.0,SGP,18903,18903,861,626,235,0.033116437,0.045548327,0.012431889
2011.0,SGP,20590,20590,923,666,257,0.032345798,0.044827588,0.012481787
2012.0,SGP,22320,22320,1023,802,221,0.0359319,0.045833334,0.009901433
2013.0,SGP,23880,23880,1032,874,158,0.036599666,0.04321608,0.0066164155
2014.0,SGP,25308,25308,1123,988,135,0.039039038,0.044373322,0.005334282
2015.0,SGP,26606,26606,1177,1071,106,0.04025408,0.044238143,0.003984064
2016.0,SGP,27738,27738,1210,1093,117,0.039404426,0.043622468,0.00421804
2017.0,SGP,28594,28594,1226,1154,72,0.04035812,0.042876128,0.0025180108
2018.0,SGP,29313,29313,1202,1292,-90,0.044076007,0.041005697,-0.00307031
2019.0,SGP,29088,29088,1118,1355,-237,0.046582785,0.038435094,-0.0081476895
2020.0,SGP,27353,27353,1122,1247,-125,0.04558915,0.04101927,-0.0045698825
2021.0,SGP,24919,24919,794,1082,-288,0.043420684,0.03186324,-0.011557446
2015.0,SHN,2,2,0,0,0,0.0,0.0,0.0
1997.0,SLB,1,1,0,0,0,0.0,0.0,0.0
2000.0,SLB,5,5,0,0,0,0.0,0.0,0.0
2001.0,SLB,8,8,1,0,1,0.0,0.125,0.125
2003.0,SLB,6,6,1,1,0,0.16666667,0.16666667,0.0
2005.0,SLB,9,9,1,0,1,0.0,0.11111111,0.11111111
2006.0,SLB,11,11,0,0,0,0.0,0.0,0.0
2007.0,SLB,13,13,0,0,0,0.0,0.0,0.0
2008.0,SLB,15,15,2,0,2,0.0,0.13333334,0.13333334
2009.0,SLB,17,17,1,0,1,0.0,0.05882353,0.05882353
2010.0,SLB,23,23,1,0,1,0.0,0.04347826,0.04347826
2011.0,SLB,27,27,1,3,-2,0.11111111,0.037037037,-0.074074075
2012.0,SLB,31,31,1,1,0,0.032258064,0.032258064,0.0
2013.0,SLB,36,36,0,5,-5,0.1388889,0.0,-0.1388889
2014.0,SLB,40,40,1,3,-2,0.075,0.025,-0.05
2015.0,SLB,46,46,3,4,-1,0.08695652,0.06521739,-0.02173913
2016.0,SLB,57,57,3,2,1,0.03508772,0.05263158,0.01754386
2017.0,SLB,59,59,3,2,1,0.033898305,0.050847456,0.016949153
2018.0,SLB,58,58,3,2,1,0.03448276,0.05172414,0.01724138
2019.0,SLB,62,62,5,0,5,0.0,0.08064516,0.08064516
2020.0,SLB,61,61,2,3,-1,0.04918033,0.032786883,-0.016393442
2021.0,SLB,46,46,1,3,-2,0.06521739,0.02173913,-0.04347826
1997.0,SLE,5,5,0,0,0,0.0,0.0,0.0
1998.0,SLE,8,8,0,0,0,0.0,0.0,0.0
2000.0,SLE,15,15,0,0,0,0.0,0.0,0.0
2001.0,SLE,19,19,0,0,0,0.0,0.0,0.0
2002.0,SLE,17,17,0,5,-5,0.29411766,0.0,-0.29411766
2003.0,SLE,17,17,1,2,-1,0.11764706,0.05882353,-0.05882353
2004.0,SLE,20,20,2,1,1,0.05,0.1,0.05
2005.0,SLE,20,20,2,1,1,0.05,0.1,0.05
2006.0,SLE,28,28,3,1,2,0.035714287,0.10714286,0.071428575
2007.0,SLE,37,37,0,1,-1,0.027027028,0.0,-0.027027028
2008.0,SLE,53,53,2,3,-1,0.056603774,0.03773585,-0.018867925
2009.0,SLE,67,67,4,1,3,0.014925373,0.05970149,0.04477612
2010.0,SLE,80,80,5,0,5,0.0,0.0625,0.0625
2011.0,SLE,84,84,5,8,-3,0.0952381,0.05952381,-0.035714287
2012.0,SLE,121,121,9,2,7,0.016528925,0.07438017,0.05785124
2013.0,SLE,156,156,12,4,8,0.025641026,0.07692308,0.051282052
2014.0,SLE,198,198,12,5,7,0.025252525,0.060606062,0.035353534
2015.0,SLE,240,240,15,7,8,0.029166667,0.0625,0.033333335
2016.0,SLE,261,261,12,9,3,0.03448276,0.04597701,0.011494253
2017.0,SLE,280,280,15,12,3,0.042857144,0.05357143,0.010714286
2018.0,SLE,306,306,15,11,4,0.035947714,0.04901961,0.013071896
2019.0,SLE,320,320,17,13,4,0.040625,0.053125,0.0125
2020.0,SLE,310,310,23,12,11,0.038709678,0.074193545,0.03548387
2021.0,SLE,271,271,19,22,-3,0.08118081,0.0701107,-0.011070111
1997.0,SLV,3,3,0,0,0,0.0,0.0,0.0
2000.0,SLV,16,16,0,0,0,0.0,0.0,0.0
2001.0,SLV,17,17,1,1,0,0.05882353,0.05882353,0.0
2002.0,SLV,31,31,0,0,0,0.0,0.0,0.0
2004.0,SLV,43,43,2,0,2,0.0,0.046511628,0.046511628
2005.0,SLV,44,44,1,1,0,0.022727273,0.022727273,0.0
2006.0,SLV,49,49,3,1,2,0.020408163,0.06122449,0.040816326
2007.0,SLV,46,46,5,3,2,0.06521739,0.10869565,0.04347826
2008.0,SLV,66,66,5,5,0,0.07575758,0.07575758,0.0
2009.0,SLV,67,67,3,5,-2,0.07462686,0.04477612,-0.029850746
2010.0,SLV,78,78,3,6,-3,0.07692308,0.03846154,-0.03846154
2011.0,SLV,87,87,3,3,0,0.03448276,0.03448276,0.0
2012.0,SLV,94,94,4,4,0,0.04255319,0.04255319,0.0
2013.0,SLV,99,99,3,7,-4,0.07070707,0.030303031,-0.04040404
2014.0,SLV,95,95,4,5,-1,0.05263158,0.042105265,-0.010526316
2015.0,SLV,96,96,2,4,-2,0.041666668,0.020833334,-0.020833334
2016.0,SLV,94,94,5,2,3,0.021276595,0.05319149,0.031914894
2017.0,SLV,103,103,5,3,2,0.029126214,0.048543688,0.019417476
2018.0,SLV,114,114,5,4,1,0.03508772,0.04385965,0.00877193
2019.0,SLV,108,108,9,6,3,0.055555556,0.083333336,0.027777778
2020.0,SLV,107,107,6,3,3,0.028037382,0.056074765,0.028037382
1996.0,SMR,3,3,0,0,0,0.0,0.0,0.0
2001.0,SMR,3,3,0,0,0,0.0,0.0,0.0
2002.0,SMR,3,3,1,1,0,0.33333334,0.33333334,0.0
2005.0,SMR,3,3,0,0,0,0.0,0.0,0.0
2008.0,SMR,7,7,0,1,-1,0.14285715,0.0,-0.14285715
2009.0,SMR,6,6,0,0,0,0.0,0.0,0.0
2010.0,SMR,3,3,0,2,-2,0.6666667,0.0,-0.6666667
2012.0,SMR,11,11,2,1,1,0.09090909,0.18181819,0.09090909
2013.0,SMR,15,15,4,1,3,0.06666667,0.26666668,0.2
2014.0,SMR,18,18,2,1,1,0.055555556,0.11111111,0.055555556
2015.0,SMR,21,21,3,2,1,0.0952381,0.14285715,0.04761905
2016.0,SMR,16,16,0,4,-4,0.25,0.0,-0.25
2017.0,SMR,21,21,4,1,3,0.04761905,0.1904762,0.14285715
2018.0,SMR,20,20,3,3,0,0.15,0.15,0.0
2019.0,SMR,25,25,5,2,3,0.08,0.2,0.12
2021.0,SMR,29,29,7,0,7,0.0,0.2413793,0.2413793
1996.0,SOM,1,1,0,0,0,0.0,0.0,0.0
2002.0,SOM,2,2,0,0,0,0.0,0.0,0.0
2006.0,SOM,2,2,0,0,0,0.0,0.0,0.0
2009.0,SOM,7,7,1,0,1,0.0,0.14285715,0.14285715
2011.0,SOM,12,12,2,0,2,0.0,0.16666667,0.16666667
2012.0,SOM,11,11,1,0,1,0.0,0.09090909,0.09090909
2013.0,SOM,18,18,0,1,-1,0.055555556,0.0,-0.055555556
2014.0,SOM,23,23,3,1,2,0.04347826,0.13043478,0.08695652
2015.0,SOM,28,28,0,1,-1,0.035714287,0.0,-0.035714287
2016.0,SOM,31,31,1,1,0,0.032258064,0.032258064,0.0
2017.0,SOM,36,36,1,2,-1,0.055555556,0.027777778,-0.027777778
2018.0,SOM,59,59,8,2,6,0.033898305,0.13559322,0.10169491
2019.0,SOM,84,84,5,0,5,0.0,0.05952381,0.05952381
2020.0,SOM,91,91,14,3,11,0.032967035,0.15384616,0.12087912
2021.0,SOM,94,94,6,2,4,0.021276595,0.06382979,0.04255319
1996.0,SRB,1055,1055,0,0,0,0.0,0.0,0.0
1997.0,SRB,1285,1285,4,7,-3,0.005447471,0.0031128405,-0.0023346303
1998.0,SRB,2073,2073,12,15,-3,0.00723589,0.005788712,-0.001447178
1999.0,SRB,2639,2639,13,27,-14,0.010231148,0.0049261083,-0.0053050397
2000.0,SRB,3241,3241,15,44,-29,0.013576057,0.004628201,-0.008947856
2001.0,SRB,3781,3781,40,74,-34,0.019571543,0.010579212,-0.00899233
2002.0,SRB,4442,4442,64,82,-18,0.018460153,0.014407924,-0.0040522288
2003.0,SRB,5004,5004,62,77,-15,0.01538769,0.012390088,-0.0029976019
2004.0,SRB,5615,5615,70,98,-28,0.01745325,0.012466608,-0.004986643
2005.0,SRB,6502,6502,80,71,9,0.010919717,0.0123039065,0.0013841895
2006.0,SRB,7564,7564,106,79,27,0.010444209,0.01401375,0.0035695399
2007.0,SRB,8888,8888,88,93,-5,0.010463546,0.00990099,-0.00056255626
2008.0,SRB,10317,10317,88,80,8,0.007754192,0.008529611,0.00077541923
2009.0,SRB,11928,11928,119,87,32,0.0072937626,0.009976526,0.0026827632
2010.0,SRB,13570,13570,105,69,36,0.0050847456,0.0077376566,0.0026529108
2011.0,SRB,14900,14900,118,86,32,0.005771812,0.007919463,0.002147651
2012.0,SRB,15794,15794,122,101,21,0.0063948333,0.0077244523,0.0013296189
2013.0,SRB,16608,16608,103,96,7,0.0057803467,0.00620183,0.00042148362
2014.0,SRB,17371,17371,117,115,2,0.006620229,0.0067353635,0.00011513442
2015.0,SRB,17867,17867,124,134,-10,0.00749986,0.006940169,-0.00055969105
2016.0,SRB,18196,18196,106,161,-55,0.008848098,0.005825456,-0.0030226423
2017.0,SRB,18480,18480,117,167,-50,0.009036796,0.006331169,-0.0027056278
2018.0,SRB,18661,18661,96,176,-80,0.009431435,0.0051444187,-0.0042870156
2019.0,SRB,18607,18607,136,151,-15,0.0081152255,0.0073090773,-0.0008061482
2020.0,SRB,17802,17802,123,162,-39,0.009100101,0.006909336,-0.002190765
2021.0,SRB,16484,16484,84,112,-28,0.0067944676,0.0050958507,-0.0016986169
2011.0,SSD,3,3,1,0,1,0.0,0.33333334,0.33333334
2013.0,SSD,1,1,0,2,-2,2.0,0.0,-2.0
2017.0,SSD,8,8,2,0,2,0.0,0.25,0.25
2018.0,SSD,11,11,2,1,1,0.09090909,0.18181819,0.09090909
2019.0,SSD,10,10,0,1,-1,0.1,0.0,-0.1
2020.0,SSD,9,9,4,2,2,0.22222222,0.44444445,0.22222222
2006.0,STP,2,2,1,0,1,0.0,0.5,0.5
2014.0,STP,1,1,0,0,0,0.0,0.0,0.0
1998.0,SUR,7,7,0,0,0,0.0,0.0,0.0
2000.0,SUR,10,10,0,0,0,0.0,0.0,0.0
2001.0,SUR,12,12,0,0,0,0.0,0.0,0.0
2002.0,SUR,19,19,0,0,0,0.0,0.0,0.0
2003.0,SUR,22,22,0,0,0,0.0,0.0,0.0
2004.0,SUR,25,25,0,0,0,0.0,0.0,0.0
2005.0,SUR,27,27,1,0,1,0.0,0.037037037,0.037037037
2006.0,SUR,27,27,0,0,0,0.0,0.0,0.0
2007.0,SUR,28,28,0,1,-1,0.035714287,0.0,-0.035714287
2008.0,SUR,30,30,0,0,0,0.0,0.0,0.0
2009.0,SUR,30,30,1,2,-1,0.06666667,0.033333335,-0.033333335
2010.0,SUR,39,39,2,0,2,0.0,0.051282052,0.051282052
2011.0,SUR,36,36,1,1,0,0.027777778,0.027777778,0.0
2012.0,SUR,37,37,0,2,-2,0.054054055,0.0,-0.054054055
2013.0,SUR,56,56,3,0,3,0.0,0.05357143,0.05357143
2014.0,SUR,70,70,6,1,5,0.014285714,0.08571429,0.071428575
2015.0,SUR,81,81,7,1,6,0.012345679,0.086419754,0.074074075
2016.0,SUR,84,84,5,2,3,0.023809524,0.05952381,0.035714287
2017.0,SUR,88,88,2,3,-1,0.03409091,0.022727273,-0.011363637
2018.0,SUR,102,102,6,2,4,0.019607844,0.05882353,0.039215688
2019.0,SUR,105,105,10,2,8,0.01904762,0.0952381,0.07619048
2020.0,SUR,94,94,0,2,-2,0.021276595,0.0,-0.021276595
2021.0,SUR,93,93,4,2,2,0.021505376,0.043010753,0.021505376
1996.0,SVK,2065,2065,0,0,0,0.0,0.0,0.0
1997.0,SVK,2536,2536,23,21,2,0.008280757,0.009069401,0.00078864355
1998.0,SVK,3460,3460,33,21,12,0.006069364,0.009537572,0.003468208
1999.0,SVK,4231,4231,51,39,12,0.0092176795,0.012053888,0.002836209
2000.0,SVK,4864,4864,42,69,-27,0.014185855,0.008634868,-0.0055509866
2001.0,SVK,5406,5406,67,103,-36,0.019052904,0.012393637,-0.0066592675
2002.0,SVK,5984,5984,96,136,-40,0.022727273,0.01604278,-0.006684492
2003.0,SVK,6411,6411,100,142,-42,0.02214943,0.015598191,-0.00655124
2004.0,SVK,6774,6774,78,109,-31,0.016090935,0.011514614,-0.004576321
2005.0,SVK,7276,7276,69,126,-57,0.017317208,0.009483232,-0.007833974
2006.0,SVK,7789,7789,101,109,-8,0.013994094,0.012967004,-0.0010270894
2007.0,SVK,8169,8169,74,118,-44,0.014444852,0.009058637,-0.005386216
2008.0,SVK,8726,8726,83,129,-46,0.014783406,0.009511804,-0.005271602
2009.0,SVK,9352,9352,101,117,-16,0.012510693,0.010799829,-0.001710864
2010.0,SVK,9935,9935,120,99,21,0.009964771,0.012078511,0.0021137393
2011.0,SVK,10736,10736,93,126,-33,0.011736214,0.008662445,-0.0030737706
2012.0,SVK,11584,11584,92,127,-35,0.010963398,0.007941989,-0.0030214088
2013.0,SVK,12289,12289,106,131,-25,0.01065994,0.0086256005,-0.0020343396
2014.0,SVK,12984,12984,108,161,-53,0.0123998765,0.00831793,-0.004081947
2015.0,SVK,13524,13524,126,157,-31,0.011608992,0.00931677,-0.0022922212
2016.0,SVK,13983,13983,125,154,-29,0.011013374,0.008939426,-0.0020739469
2017.0,SVK,14343,14343,161,124,37,0.008645332,0.011224988,0.0025796555
2018.0,SVK,14667,14667,153,156,-3,0.010636122,0.010431581,-0.0002045408
2019.0,SVK,14500,14500,131,165,-34,0.01137931,0.009034483,-0.0023448276
2020.0,SVK,13700,13700,134,146,-12,0.010656934,0.009781022,-0.00087591243
2021.0,SVK,12712,12712,98,106,-8,0.008338578,0.0077092513,-0.0006293266
1996.0,SVN,921,921,0,0,0,0.0,0.0,0.0
1997.0,SVN,1209,1209,5,6,-1,0.004962779,0.004135649,-0.0008271299
1998.0,SVN,1931,1931,17,8,9,0.004142931,0.008803729,0.0046607973
1999.0,SVN,2577,2577,19,17,2,0.006596818,0.0073729143,0.00077609625
2000.0,SVN,3135,3135,18,7,11,0.002232855,0.005741627,0.003508772
2001.0,SVN,3660,3660,25,37,-12,0.01010929,0.006830601,-0.0032786885
2002.0,SVN,4169,4169,56,42,14,0.010074358,0.013432478,0.0033581194
2003.0,SVN,4629,4629,53,33,20,0.0071289698,0.011449557,0.0043205875
2004.0,SVN,5001,5001,47,39,8,0.0077984403,0.00939812,0.00159968
2005.0,SVN,5424,5424,56,45,11,0.00829646,0.010324484,0.0020280236
2006.0,SVN,5957,5957,56,44,12,0.007386268,0.009400705,0.0020144368
2007.0,SVN,6529,6529,62,53,9,0.008117629,0.009496095,0.0013784653
2008.0,SVN,7094,7094,52,59,-7,0.008316888,0.0073301382,-0.0009867494
2009.0,SVN,7702,7702,73,53,20,0.0068813297,0.009478058,0.002596728
2010.0,SVN,8130,8130,58,74,-16,0.009102091,0.0071340716,-0.0019680196
2011.0,SVN,8652,8652,85,89,-4,0.0102866385,0.009824318,-0.00046232084
2012.0,SVN,9023,9023,79,97,-18,0.010750305,0.008755403,-0.0019949018
2013.0,SVN,9377,9377,63,96,-33,0.010237816,0.0067185666,-0.0035192491
2014.0,SVN,9656,9656,77,114,-37,0.011806131,0.007974316,-0.0038318145
2015.0,SVN,9835,9835,84,111,-27,0.011286222,0.008540926,-0.0027452975
2016.0,SVN,9885,9885,86,137,-51,0.013859383,0.00870005,-0.0051593324
2017.0,SVN,9958,9958,91,125,-34,0.012552721,0.009138381,-0.0034143403
2018.0,SVN,10055,10055,99,128,-29,0.012729985,0.009845848,-0.0028841372
2019.0,SVN,9966,9966,126,113,13,0.0113385515,0.012642986,0.0013044351
2020.0,SVN,9497,9497,129,103,26,0.01084553,0.013583236,0.0027377068
2021.0,SVN,8948,8948,114,76,38,0.008493518,0.012740277,0.004246759
1996.0,SWE,8467,8467,0,0,0,0.0,0.0,0.0
1997.0,SWE,10675,10675,147,109,38,0.010210773,0.013770492,0.003559719
1998.0,SWE,17961,17961,238,201,37,0.011190914,0.013250933,0.002060019
1999.0,SWE,24487,24487,403,336,67,0.013721567,0.016457712,0.0027361456
2000.0,SWE,28822,28822,351,303,48,0.010512803,0.0121781975,0.0016653945
2001.0,SWE,32547,32547,669,757,-88,0.023258671,0.020554889,-0.0027037822
2002.0,SWE,36060,36060,897,1054,-157,0.029229064,0.024875209,-0.004353855
2003.0,SWE,38930,38930,939,986,-47,0.025327511,0.024120215,-0.0012072951
2004.0,SWE,41096,41096,815,853,-38,0.020756278,0.019831615,-0.0009246642
2005.0,SWE,42883,42883,735,880,-145,0.020520952,0.017139658,-0.0033812933
2006.0,SWE,44253,44253,739,1023,-284,0.023117077,0.016699433,-0.006417644
2007.0,SWE,45819,45819,841,1052,-211,0.022959907,0.018354831,-0.0046050763
2008.0,SWE,47197,47197,910,1087,-177,0.023031125,0.019280886,-0.0037502383
2009.0,SWE,48849,48849,1040,1041,-1,0.02131057,0.021290097,-2.0471249e-05
2010.0,SWE,50718,50718,1158,1151,7,0.022694113,0.022832131,0.00013801806
2011.0,SWE,52815,52815,1311,1075,236,0.020354066,0.024822494,0.0044684275
2012.0,SWE,54973,54973,1386,1152,234,0.020955741,0.025212377,0.004256635
2013.0,SWE,57233,57233,1528,1102,426,0.019254627,0.026697883,0.007443258
2014.0,SWE,59171,59171,1646,1296,350,0.02190262,0.027817681,0.0059150597
2015.0,SWE,61004,61004,1772,1308,464,0.021441218,0.029047275,0.007606059
2016.0,SWE,62366,62366,1755,1457,298,0.023362089,0.028140333,0.0047782445
2017.0,SWE,63367,63367,1871,1425,446,0.022488046,0.029526409,0.0070383637
2018.0,SWE,64078,64078,2027,1538,489,0.024001997,0.03163332,0.007631324
2019.0,SWE,63625,63625,2004,1562,442,0.024550099,0.031497054,0.006946955
2020.0,SWE,60993,60993,1955,1489,466,0.024412638,0.03205286,0.007640221
2021.0,SWE,56948,56948,1545,1147,398,0.02014118,0.027130013,0.006988832
1996.0,SWZ,11,11,0,0,0,0.0,0.0,0.0
1997.0,SWZ,13,13,1,1,0,0.07692308,0.07692308,0.0
1998.0,SWZ,17,17,1,0,1,0.0,0.05882353,0.05882353
1999.0,SWZ,22,22,1,0,1,0.0,0.045454547,0.045454547
2000.0,SWZ,27,27,0,0,0,0.0,0.0,0.0
2001.0,SWZ,30,30,1,1,0,0.033333335,0.033333335,0.0
2002.0,SWZ,35,35,3,4,-1,0.114285715,0.08571429,-0.028571429
2003.0,SWZ,42,42,2,3,-1,0.071428575,0.04761905,-0.023809524
2004.0,SWZ,46,46,4,0,4,0.0,0.08695652,0.08695652
2005.0,SWZ,46,46,0,3,-3,0.06521739,0.0,-0.06521739
2006.0,SWZ,55,55,3,1,2,0.018181818,0.054545455,0.036363635
2007.0,SWZ,60,60,2,2,0,0.033333335,0.033333335,0.0
2008.0,SWZ,77,77,8,4,4,0.051948052,0.103896104,0.051948052
2009.0,SWZ,82,82,5,5,0,0.06097561,0.06097561,0.0
2010.0,SWZ,80,80,5,6,-1,0.075,0.0625,-0.0125
2011.0,SWZ,87,87,7,4,3,0.04597701,0.08045977,0.03448276
2012.0,SWZ,90,90,6,10,-4,0.11111111,0.06666667,-0.044444446
2013.0,SWZ,87,87,7,4,3,0.04597701,0.08045977,0.03448276
2014.0,SWZ,80,80,1,9,-8,0.1125,0.0125,-0.1
2015.0,SWZ,97,97,9,5,4,0.05154639,0.0927835,0.041237112
2016.0,SWZ,111,111,9,8,1,0.072072074,0.08108108,0.009009009
2017.0,SWZ,124,124,14,6,8,0.048387095,0.11290322,0.06451613
2018.0,SWZ,147,147,19,11,8,0.07482993,0.1292517,0.054421768
2019.0,SWZ,153,153,18,15,3,0.09803922,0.11764706,0.019607844
2020.0,SWZ,152,152,14,8,6,0.05263158,0.09210526,0.039473683
2021.0,SWZ,140,140,11,11,0,0.07857143,0.07857143,0.0
1998.0,SYC,2,2,0,0,0,0.0,0.0,0.0
2000.0,SYC,7,7,0,0,0,0.0,0.0,0.0
2001.0,SYC,8,8,0,2,-2,0.25,0.0,-0.25
2002.0,SYC,14,14,4,0,4,0.0,0.2857143,0.2857143
2003.0,SYC,17,17,1,0,1,0.0,0.05882353,0.05882353
2004.0,SYC,24,24,2,0,2,0.0,0.083333336,0.083333336
2005.0,SYC,24,24,2,0,2,0.0,0.083333336,0.083333336
2006.0,SYC,22,22,0,0,0,0.0,0.0,0.0
2007.0,SYC,21,21,0,1,-1,0.04761905,0.0,-0.04761905
2009.0,SYC,22,22,2,1,1,0.045454547,0.09090909,0.045454547
2010.0,SYC,20,20,2,1,1,0.05,0.1,0.05
2011.0,SYC,22,22,2,4,-2,0.18181819,0.09090909,-0.09090909
2013.0,SYC,41,41,5,1,4,0.024390243,0.12195122,0.09756097
2014.0,SYC,41,41,3,1,2,0.024390243,0.07317073,0.048780486
2015.0,SYC,47,47,5,1,4,0.021276595,0.10638298,0.08510638
2016.0,SYC,37,37,1,5,-4,0.13513513,0.027027028,-0.10810811
2017.0,SYC,36,36,2,4,-2,0.11111111,0.055555556,-0.055555556
2019.0,SYC,41,41,2,4,-2,0.09756097,0.048780486,-0.048780486
2020.0,SYC,45,45,3,0,3,0.0,0.06666667,0.06666667
2021.0,SYC,46,46,5,2,3,0.04347826,0.10869565,0.06521739
1996.0,SYR,32,32,0,0,0,0.0,0.0,0.0
1997.0,SYR,45,45,0,2,-2,0.044444446,0.0,-0.044444446
1998.0,SYR,124,124,0,1,-1,0.008064516,0.0,-0.008064516
1999.0,SYR,180,180,4,4,0,0.022222223,0.022222223,0.0
2000.0,SYR,225,225,2,1,1,0.0044444446,0.008888889,0.0044444446
2001.0,SYR,245,245,4,10,-6,0.040816326,0.01632653,-0.024489796
2002.0,SYR,288,288,11,5,6,0.017361112,0.038194444,0.020833334
2003.0,SYR,319,319,17,7,10,0.021943573,0.053291537,0.031347964
2004.0,SYR,351,351,16,7,9,0.01994302,0.045584045,0.025641026
2005.0,SYR,391,391,18,12,6,0.030690538,0.046035804,0.015345269
2006.0,SYR,427,427,18,13,5,0.030444965,0.042154565,0.011709602
2007.0,SYR,457,457,11,3,8,0.0065645515,0.024070023,0.01750547
2008.0,SYR,541,541,19,15,4,0.027726432,0.03512015,0.0073937154
2009.0,SYR,632,632,34,15,19,0.023734177,0.05379747,0.030063292
2010.0,SYR,705,705,23,23,0,0.032624114,0.032624114,0.0
2011.0,SYR,833,833,43,13,30,0.015606242,0.051620647,0.036014404
2012.0,SYR,958,958,37,19,18,0.019832985,0.03862213,0.018789144
2013.0,SYR,1030,1030,40,39,1,0.037864078,0.03883495,0.0009708738
2014.0,SYR,1063,1063,20,45,-25,0.042333018,0.018814676,-0.023518344
2015.0,SYR,1080,1080,24,48,-24,0.044444446,0.022222223,-0.022222223
2016.0,SYR,1113,1113,19,41,-22,0.036837377,0.017070979,-0.019766398
2017.0,SYR,1133,1133,21,57,-36,0.050308913,0.018534863,-0.03177405
2018.0,SYR,1187,1187,28,39,-11,0.03285594,0.023588879,-0.00926706
2019.0,SYR,1230,1230,31,42,-11,0.034146342,0.025203252,-0.008943089
2020.0,SYR,1185,1185,17,27,-10,0.02278481,0.014345991,-0.008438818
2021.0,SYR,1077,1077,22,19,3,0.017641596,0.020427112,0.0027855153
2007.0,TCA,8,8,0,1,-1,0.125,0.0,-0.125
2009.0,TCA,7,7,0,0,0,0.0,0.0,0.0
2012.0,TCA,4,4,1,1,0,0.25,0.25,0.0
2016.0,TCA,7,7,2,0,2,0.0,0.2857143,0.2857143
1997.0,TCD,8,8,0,0,0,0.0,0.0,0.0
1999.0,TCD,11,11,0,0,0,0.0,0.0,0.0
2000.0,TCD,10,10,0,0,0,0.0,0.0,0.0
2001.0,TCD,19,19,1,0,1,0.0,0.05263158,0.05263158
2002.0,TCD,22,22,0,2,-2,0.09090909,0.0,-0.09090909
2003.0,TCD,27,27,4,1,3,0.037037037,0.14814815,0.11111111
2004.0,TCD,37,37,5,0,5,0.0,0.13513513,0.13513513
2005.0,TCD,34,34,1,3,-2,0.0882353,0.029411765,-0.05882353
2006.0,TCD,32,32,1,1,0,0.03125,0.03125,0.0
2007.0,TCD,31,31,1,2,-1,0.06451613,0.032258064,-0.032258064
2008.0,TCD,33,33,1,1,0,0.030303031,0.030303031,0.0
2009.0,TCD,29,29,1,3,-2,0.10344828,0.03448276,-0.06896552
2010.0,TCD,29,29,0,1,-1,0.03448276,0.0,-0.03448276
2011.0,TCD,39,39,1,1,0,0.025641026,0.025641026,0.0
2012.0,TCD,50,50,4,1,3,0.02,0.08,0.06
2013.0,TCD,60,60,3,2,1,0.033333335,0.05,0.016666668
2014.0,TCD,69,69,0,1,-1,0.014492754,0.0,-0.014492754
2015.0,TCD,73,73,1,5,-4,0.06849315,0.01369863,-0.05479452
2016.0,TCD,88,88,7,1,6,0.011363637,0.07954545,0.06818182
2017.0,TCD,96,96,6,4,2,0.041666668,0.0625,0.020833334
2018.0,TCD,96,96,2,0,2,0.0,0.020833334,0.020833334
2019.0,TCD,105,105,9,0,9,0.0,0.08571429,0.08571429
2020.0,TCD,100,100,6,1,5,0.01,0.06,0.05
2021.0,TCD,93,93,6,0,6,0.0,0.06451613,0.06451613
1996.0,TGO,23,23,0,0,0,0.0,0.0,0.0
1997.0,TGO,42,42,0,0,0,0.0,0.0,0.0
1998.0,TGO,51,51,0,0,0,0.0,0.0,0.0
1999.0,TGO,60,60,0,1,-1,0.016666668,0.0,-0.016666668
2000.0,TGO,88,88,0,1,-1,0.011363637,0.0,-0.011363637
2001.0,TGO,104,104,5,2,3,0.01923077,0.048076924,0.028846154
2002.0,TGO,118,118,6,2,4,0.016949153,0.050847456,0.033898305
2003.0,TGO,123,123,2,0,2,0.0,0.016260162,0.016260162
2004.0,TGO,137,137,7,5,2,0.03649635,0.05109489,0.01459854
2005.0,TGO,153,153,5,2,3,0.013071896,0.03267974,0.019607844
2006.0,TGO,194,194,10,4,6,0.020618556,0.05154639,0.030927835
2007.0,TGO,228,228,6,5,1,0.021929825,0.02631579,0.004385965
2008.0,TGO,268,268,9,0,9,0.0,0.03358209,0.03358209
2009.0,TGO,299,299,8,10,-2,0.033444814,0.026755853,-0.006688963
2010.0,TGO,337,337,8,8,0,0.023738872,0.023738872,0.0
2011.0,TGO,386,386,8,6,2,0.015544041,0.020725388,0.005181347
2012.0,TGO,433,433,9,5,4,0.011547344,0.02078522,0.009237875
2013.0,TGO,459,459,9,6,3,0.013071896,0.019607844,0.006535948
2014.0,TGO,507,507,12,10,2,0.019723866,0.02366864,0.003944773
2015.0,TGO,530,530,19,4,15,0.00754717,0.035849057,0.028301887
2016.0,TGO,558,558,7,4,3,0.007168459,0.012544803,0.005376344
2017.0,TGO,581,581,18,11,7,0.018932875,0.030981068,0.012048192
2018.0,TGO,602,602,12,11,1,0.018272426,0.019933555,0.0016611295
2019.0,TGO,590,590,6,9,-3,0.015254238,0.010169491,-0.0050847456
2020.0,TGO,558,558,17,7,10,0.012544803,0.03046595,0.017921148
2021.0,TGO,503,503,6,7,-1,0.013916501,0.01192843,-0.0019880715
1996.0,THA,908,908,0,0,0,0.0,0.0,0.0
1997.0,THA,1201,1201,9,9,0,0.0074937553,0.0074937553,0.0
1998.0,THA,2564,2564,20,11,9,0.0042901714,0.007800312,0.0035101403
1999.0,THA,3913,3913,43,23,20,0.005877843,0.010989011,0.0051111677
2000.0,THA,5177,5177,40,30,10,0.005794862,0.0077264826,0.0019316206
2001.0,THA,6363,6363,91,123,-32,0.019330505,0.01430143,-0.0050290744
2002.0,THA,7683,7683,217,144,73,0.018742679,0.028244175,0.009501497
2003.0,THA,9203,9203,299,142,157,0.015429751,0.032489404,0.017059654
2004.0,THA,10977,10977,325,144,181,0.013118339,0.029607361,0.016489023
2005.0,THA,12498,12498,365,158,207,0.012642023,0.029204672,0.01656265
2006.0,THA,14266,14266,360,196,164,0.01373896,0.025234824,0.011495864
2007.0,THA,16129,16129,334,222,112,0.0137640275,0.020708041,0.0069440138
2008.0,THA,18086,18086,441,253,188,0.01398872,0.0243835,0.010394781
2009.0,THA,19859,19859,394,247,147,0.012437685,0.019839872,0.0074021854
2010.0,THA,21796,21796,455,316,139,0.014498073,0.02087539,0.006377317
2011.0,THA,23627,23627,493,338,155,0.014305667,0.020865958,0.006560291
2012.0,THA,25467,25467,547,315,232,0.012368948,0.021478776,0.009109829
2013.0,THA,27260,27260,545,348,197,0.012765957,0.019992663,0.007226706
2014.0,THA,29118,29118,583,335,248,0.011504911,0.020021979,0.008517069
2015.0,THA,30998,30998,637,343,294,0.01106523,0.020549713,0.009484483
2016.0,THA,33411,33411,662,402,260,0.012031966,0.019813834,0.0077818683
2017.0,THA,35714,35714,652,411,241,0.011508092,0.018256146,0.006748054
2018.0,THA,37932,37932,710,415,295,0.010940631,0.018717706,0.007777075
2019.0,THA,39333,39333,661,460,201,0.011695014,0.016805228,0.0051102126
2020.0,THA,38403,38403,684,486,198,0.012655261,0.017811108,0.0051558474
2021.0,THA,36196,36196,451,330,121,0.00911703,0.01245994,0.003342911
2022.0,THA,0,0,255,187,68,,,
1996.0,TJK,41,41,0,0,0,0.0,0.0,0.0
1997.0,TJK,43,43,0,2,-2,0.046511628,0.0,-0.046511628
1998.0,TJK,60,60,0,0,0,0.0,0.0,0.0
1999.0,TJK,61,61,1,0,1,0.0,0.016393442,0.016393442
2000.0,TJK,76,76,0,3,-3,0.039473683,0.0,-0.039473683
2001.0,TJK,79,79,0,4,-4,0.050632913,0.0,-0.050632913
2002.0,TJK,91,91,1,1,0,0.010989011,0.010989011,0.0
2003.0,TJK,95,95,1,6,-5,0.06315789,0.010526316,-0.05263158
2004.0,TJK,100,100,1,2,-1,0.02,0.01,-0.01
2005.0,TJK,102,102,3,1,2,0.009803922,0.029411765,0.019607844
2006.0,TJK,116,116,3,0,3,0.0,0.02586207,0.02586207
2007.0,TJK,117,117,1,1,0,0.008547009,0.008547009,0.0
2008.0,TJK,129,129,3,3,0,0.023255814,0.023255814,0.0
2009.0,TJK,124,124,0,0,0,0.0,0.0,0.0
2010.0,TJK,127,127,0,4,-4,0.031496063,0.0,-0.031496063
2011.0,TJK,156,156,2,2,0,0.012820513,0.012820513,0.0
2012.0,TJK,172,172,1,2,-1,0.011627907,0.0058139535,-0.0058139535
2013.0,TJK,185,185,12,5,7,0.027027028,0.06486487,0.037837837
2014.0,TJK,210,210,3,11,-8,0.052380953,0.014285714,-0.03809524
2015.0,TJK,224,224,6,4,2,0.017857144,0.026785715,0.008928572
2016.0,TJK,227,227,0,7,-7,0.030837005,0.0,-0.030837005
2017.0,TJK,254,254,6,4,2,0.015748031,0.023622047,0.007874016
2018.0,TJK,283,283,12,4,8,0.014134276,0.042402826,0.028268551
2019.0,TJK,286,286,11,10,1,0.034965035,0.03846154,0.0034965035
2020.0,TJK,274,274,9,4,5,0.01459854,0.032846715,0.018248174
2021.0,TJK,255,255,3,2,1,0.007843138,0.011764706,0.003921569
1996.0,TKM,8,8,0,0,0,0.0,0.0,0.0
1997.0,TKM,10,10,1,0,1,0.0,0.1,0.1
1999.0,TKM,12,12,0,0,0,0.0,0.0,0.0
2000.0,TKM,13,13,1,0,1,0.0,0.07692308,0.07692308
2001.0,TKM,11,11,0,0,0,0.0,0.0,0.0
2002.0,TKM,11,11,0,2,-2,0.18181819,0.0,-0.18181819
2004.0,TKM,8,8,0,0,0,0.0,0.0,0.0
2007.0,TKM,10,10,0,0,0,0.0,0.0,0.0
2008.0,TKM,13,13,0,0,0,0.0,0.0,0.0
2009.0,TKM,12,12,0,1,-1,0.083333336,0.0,-0.083333336
2010.0,TKM,14,14,1,0,1,0.0,0.071428575,0.071428575
2012.0,TKM,23,23,1,0,1,0.0,0.04347826,0.04347826
2013.0,TKM,17,17,0,4,-4,0.23529412,0.0,-0.23529412
2014.0,TKM,19,19,2,0,2,0.0,0.10526316,0.10526316
2018.0,TKM,8,8,0,2,-2,0.25,0.0,-0.25
2021.0,TKM,7,7,0,0,0,0.0,0.0,0.0
2005.0,TLS,4,4,0,0,0,0.0,0.0,0.0
2006.0,TLS,5,5,0,0,0,0.0,0.0,0.0
2007.0,TLS,6,6,1,0,1,0.0,0.16666667,0.16666667
2008.0,TLS,6,6,0,0,0,0.0,0.0,0.0
2011.0,TLS,12,12,0,0,0,0.0,0.0,0.0
2012.0,TLS,17,17,0,0,0,0.0,0.0,0.0
2013.0,TLS,27,27,2,1,1,0.037037037,0.074074075,0.037037037
2014.0,TLS,32,32,2,1,1,0.03125,0.0625,0.03125
2015.0,TLS,39,39,3,0,3,0.0,0.07692308,0.07692308
2016.0,TLS,44,44,1,1,0,0.022727273,0.022727273,0.0
2017.0,TLS,49,49,2,2,0,0.040816326,0.040816326,0.0
2018.0,TLS,48,48,4,4,0,0.083333336,0.083333336,0.0
2019.0,TLS,51,51,3,3,0,0.05882353,0.05882353,0.0
2020.0,TLS,46,46,1,2,-1,0.04347826,0.02173913,-0.02173913
2021.0,TLS,39,39,3,2,1,0.051282052,0.07692308,0.025641026
2001.0,TON,6,6,0,0,0,0.0,0.0,0.0
2002.0,TON,7,7,0,2,-2,0.2857143,0.0,-0.2857143
2004.0,TON,9,9,1,0,1,0.0,0.11111111,0.11111111
2006.0,TON,6,6,1,2,-1,0.33333334,0.16666667,-0.16666667
2010.0,TON,5,5,0,0,0,0.0,0.0,0.0
2012.0,TON,8,8,1,0,1,0.0,0.125,0.125
2014.0,TON,5,5,0,2,-2,0.4,0.0,-0.4
2016.0,TON,11,11,0,0,0,0.0,0.0,0.0
2017.0,TON,13,13,1,0,1,0.0,0.07692308,0.07692308
2018.0,TON,13,13,2,2,0,0.15384616,0.15384616,0.0
2019.0,TON,13,13,1,2,-1,0.15384616,0.07692308,-0.07692308
2020.0,TON,14,14,2,0,2,0.0,0.14285715,0.14285715
2021.0,TON,15,15,1,0,1,0.0,0.06666667,0.06666667
1996.0,TTO,44,44,0,0,0,0.0,0.0,0.0
1997.0,TTO,48,48,0,1,-1,0.020833334,0.0,-0.020833334
1998.0,TTO,107,107,0,3,-3,0.028037382,0.0,-0.028037382
1999.0,TTO,163,163,5,1,4,0.006134969,0.030674847,0.024539877
2000.0,TTO,207,207,3,0,3,0.0,0.014492754,0.014492754
2001.0,TTO,264,264,5,9,-4,0.03409091,0.018939395,-0.015151516
2002.0,TTO,318,318,19,7,12,0.022012578,0.059748426,0.03773585
2003.0,TTO,367,367,17,11,6,0.029972753,0.046321526,0.016348774
2004.0,TTO,396,396,14,12,2,0.030303031,0.035353534,0.005050505
2005.0,TTO,439,439,22,6,16,0.013667426,0.050113894,0.03644647
2006.0,TTO,466,466,17,11,6,0.023605151,0.036480688,0.012875536
2007.0,TTO,510,510,17,11,6,0.021568628,0.033333335,0.011764706
2008.0,TTO,518,518,26,21,5,0.04054054,0.05019305,0.009652509
2009.0,TTO,575,575,23,17,6,0.029565217,0.04,0.010434783
2010.0,TTO,587,587,27,24,3,0.040885862,0.04599659,0.0051107327
2011.0,TTO,591,591,27,20,7,0.033840947,0.04568528,0.011844331
2012.0,TTO,607,607,15,23,-8,0.03789127,0.024711696,-0.013179571
2013.0,TTO,597,597,13,23,-10,0.03852596,0.021775544,-0.01675042
2014.0,TTO,603,603,19,21,-2,0.03482587,0.03150912,-0.0033167496
2015.0,TTO,645,645,27,17,10,0.026356589,0.041860465,0.015503876
2016.0,TTO,661,661,19,27,-8,0.0408472,0.028744327,-0.012102874
2017.0,TTO,711,711,35,18,17,0.025316456,0.04922644,0.023909986
2018.0,TTO,748,748,25,16,9,0.021390375,0.03342246,0.012032085
2019.0,TTO,747,747,17,22,-5,0.029451137,0.022757698,-0.0066934405
2020.0,TTO,684,684,20,26,-6,0.038011696,0.029239766,-0.00877193
2021.0,TTO,615,615,8,19,-11,0.03089431,0.01300813,-0.017886179
1996.0,TUN,613,613,0,0,0,0.0,0.0,0.0
1997.0,TUN,803,803,4,2,2,0.00249066,0.00498132,0.00249066
1998.0,TUN,1415,1415,13,4,9,0.002826855,0.009187279,0.006360424
1999.0,TUN,2237,2237,24,18,6,0.008046491,0.010728654,0.0026821636
2000.0,TUN,2970,2970,25,10,15,0.0033670033,0.008417509,0.005050505
2001.0,TUN,3662,3662,50,38,12,0.010376844,0.013653741,0.0032768978
2002.0,TUN,4490,4490,80,43,37,0.0095768375,0.017817372,0.008240535
2003.0,TUN,5345,5345,73,42,31,0.007857811,0.013657624,0.0057998127
2004.0,TUN,6239,6239,90,52,38,0.008334669,0.014425389,0.0060907197
2005.0,TUN,7166,7166,91,55,36,0.0076751327,0.012698855,0.005023723
2006.0,TUN,8105,8105,90,74,16,0.009130167,0.011104257,0.00197409
2007.0,TUN,9124,9124,122,82,40,0.008987286,0.013371329,0.004384042
2008.0,TUN,10116,10116,123,93,30,0.009193357,0.012158956,0.002965599
2009.0,TUN,10984,10984,116,119,-3,0.0108339405,0.010560816,-0.00027312455
2010.0,TUN,11765,11765,143,125,18,0.010624735,0.0121546965,0.0015299617
2011.0,TUN,12594,12594,146,149,-3,0.01183103,0.011592822,-0.00023820867
2012.0,TUN,13468,13468,136,161,-25,0.011954262,0.01009801,-0.0018562519
2013.0,TUN,14373,14373,164,165,-1,0.011479858,0.011410283,-6.95749e-05
2014.0,TUN,15315,15315,178,186,-8,0.012144956,0.011622592,-0.0005223637
2015.0,TUN,16208,16208,176,202,-26,0.012462981,0.010858835,-0.0016041461
2016.0,TUN,16979,16979,216,182,34,0.010719123,0.012721597,0.0020024737
2017.0,TUN,17529,17529,197,242,-45,0.013805693,0.011238519,-0.0025671744
2018.0,TUN,17832,17832,183,255,-72,0.014300135,0.010262449,-0.004037685
2019.0,TUN,17515,17515,175,362,-187,0.020667998,0.009991436,-0.010676563
2020.0,TUN,16371,16371,169,378,-209,0.02308961,0.010323132,-0.012766478
2021.0,TUN,14867,14867,124,233,-109,0.015672294,0.00834062,-0.007331674
1996.0,TUR,5022,5022,0,0,0,0.0,0.0,0.0
1997.0,TUR,7439,7439,21,13,8,0.0017475467,0.00282296,0.0010754133
1998.0,TUR,12456,12456,65,35,30,0.0028098908,0.0052183685,0.002408478
1999.0,TUR,18248,18248,98,70,28,0.003836037,0.0053704516,0.0015344147
2000.0,TUR,23832,23832,121,109,12,0.0045736823,0.005077207,0.0005035247
2001.0,TUR,29774,29774,209,171,38,0.005743266,0.0070195473,0.0012762813
2002.0,TUR,35611,35611,316,233,83,0.006542922,0.008873663,0.0023307404
2003.0,TUR,41663,41663,346,230,116,0.005520486,0.008304731,0.002784245
2004.0,TUR,47061,47061,305,253,52,0.0053760014,0.0064809504,0.0011049489
2005.0,TUR,52186,52186,317,279,38,0.0053462614,0.006074426,0.0007281646
2006.0,TUR,57223,57223,326,300,26,0.005242647,0.00569701,0.00045436274
2007.0,TUR,62802,62802,353,314,39,0.0049998406,0.00562084,0.0006209993
2008.0,TUR,68131,68131,356,351,5,0.00515184,0.0052252277,7.338803e-05
2009.0,TUR,73640,73640,383,357,26,0.004847909,0.005200978,0.000353069
2010.0,TUR,78781,78781,459,415,44,0.0052677677,0.005826278,0.0005585103
2011.0,TUR,84530,84530,481,484,-3,0.0057257777,0.0056902873,-3.5490357e-05
2012.0,TUR,90007,90007,511,462,49,0.005132934,0.0056773364,0.0005444021
2013.0,TUR,95176,95176,554,548,6,0.005757754,0.005820795,6.30411e-05
2014.0,TUR,100066,100066,624,487,137,0.0048667877,0.0062358845,0.0013690963
2015.0,TUR,103886,103886,679,569,110,0.0054771574,0.0065360107,0.001058853
2016.0,TUR,107304,107304,645,700,-55,0.006523522,0.0060109594,-0.00051256246
2017.0,TUR,110365,110365,667,870,-203,0.007882934,0.0060435827,-0.0018393513
2018.0,TUR,112670,112670,686,1009,-323,0.008955357,0.006088577,-0.002866779
2019.0,TUR,112254,112254,708,1019,-311,0.009077627,0.006307125,-0.0027705026
2020.0,TUR,106918,106918,657,959,-302,0.00896949,0.006144896,-0.0028245945
2021.0,TUR,99595,99595,494,664,-170,0.006667001,0.0049600885,-0.001706913
2022.0,TUR,0,0,295,334,-39,,,
2003.0,TUV,1,1,0,0,0,0.0,0.0,0.0
2007.0,TUV,1,1,0,0,0,0.0,0.0,0.0
1996.0,TWN,4927,4927,0,0,0,0.0,0.0,0.0
1997.0,TWN,6126,6126,55,34,21,0.0055501144,0.008978126,0.0034280117
1998.0,TWN,12802,12802,91,46,45,0.0035931885,0.007108264,0.0035150757
1999.0,TWN,19418,19418,176,77,99,0.0039653927,0.009063755,0.0050983625
2000.0,TWN,24658,24658,157,62,95,0.002514397,0.006367102,0.003852705
2001.0,TWN,29704,29704,322,179,143,0.0060261246,0.010840291,0.0048141666
2002.0,TWN,35309,35309,405,299,106,0.008468096,0.011470163,0.0030020676
2003.0,TWN,40778,40778,461,308,153,0.007553092,0.011305115,0.0037520232
2004.0,TWN,46396,46396,424,301,123,0.0064876284,0.009138719,0.0026510905
2005.0,TWN,51732,51732,457,289,168,0.005586484,0.00883399,0.0032475065
2006.0,TWN,57482,57482,570,322,248,0.0056017535,0.009916147,0.004314394
2007.0,TWN,62928,62928,560,384,176,0.0061022122,0.008899059,0.0027968471
2008.0,TWN,68408,68408,570,423,147,0.0061834874,0.008332359,0.0021488715
2009.0,TWN,73496,73496,634,481,153,0.0065445737,0.0086263195,0.002081746
2010.0,TWN,78280,78280,666,503,163,0.0064256517,0.00850792,0.0020822687
2011.0,TWN,82105,82105,632,575,57,0.0070032277,0.0076974607,0.000694233
2012.0,TWN,84991,84991,598,616,-18,0.007247826,0.007036039,-0.00021178713
2013.0,TWN,86933,86933,626,618,8,0.007108923,0.007200948,9.202489e-05
2014.0,TWN,87724,87724,614,698,-84,0.007956774,0.006999225,-0.0009575487
2015.0,TWN,87608,87608,635,760,-125,0.008675007,0.0072481963,-0.0014268103
2016.0,TWN,86429,86429,651,834,-183,0.009649539,0.0075321943,-0.0021173449
2017.0,TWN,85001,85001,611,855,-244,0.010058705,0.0071881507,-0.0028705546
2018.0,TWN,84231,84231,659,894,-235,0.01061367,0.007823722,-0.0027899467
2019.0,TWN,82286,82286,698,912,-214,0.011083295,0.00848261,-0.0026006855
2020.0,TWN,76527,76527,688,788,-100,0.010297019,0.008990291,-0.0013067283
2021.0,TWN,69582,69582,591,587,4,0.008436089,0.008493576,5.748613e-05
2022.0,TWN,0,0,320,324,-4,,,
1996.0,TZA,93,93,0,0,0,0.0,0.0,0.0
1997.0,TZA,128,128,1,2,-1,0.015625,0.0078125,-0.0078125
1998.0,TZA,253,253,11,5,6,0.019762846,0.04347826,0.023715414
1999.0,TZA,386,386,11,8,3,0.020725388,0.02849741,0.0077720205
2000.0,TZA,463,463,8,5,3,0.010799136,0.017278617,0.0064794817
2001.0,TZA,554,554,9,17,-8,0.03068592,0.016245488,-0.014440433
2002.0,TZA,686,686,30,29,1,0.042274054,0.04373178,0.001457726
2003.0,TZA,809,809,43,13,30,0.01606922,0.05315204,0.037082817
2004.0,TZA,962,962,29,24,5,0.024948025,0.03014553,0.005197505
2005.0,TZA,1134,1134,40,19,21,0.01675485,0.03527337,0.018518519
2006.0,TZA,1243,1243,34,21,13,0.01689461,0.027353179,0.010458568
2007.0,TZA,1323,1323,29,31,-2,0.023431595,0.021919878,-0.0015117158
2008.0,TZA,1458,1458,33,40,-7,0.027434843,0.022633744,-0.0048010973
2009.0,TZA,1611,1611,49,33,16,0.020484172,0.03041589,0.00993172
2010.0,TZA,1742,1742,65,48,17,0.027554534,0.03731343,0.009758898
2011.0,TZA,1850,1850,49,50,-1,0.027027028,0.026486486,-0.00054054055
2012.0,TZA,2092,2092,65,44,21,0.021032505,0.031070746,0.010038241
2013.0,TZA,2307,2307,89,61,28,0.026441265,0.03857824,0.012136974
2014.0,TZA,2537,2537,87,50,37,0.019708317,0.03429247,0.014584155
2015.0,TZA,2781,2781,90,58,32,0.020855807,0.03236246,0.011506652
2016.0,TZA,3012,3012,94,66,28,0.021912351,0.0312085,0.009296149
2017.0,TZA,3239,3239,99,69,30,0.021302871,0.03056499,0.009262118
2018.0,TZA,3465,3465,94,76,18,0.021933623,0.027128426,0.005194805
2019.0,TZA,3565,3565,121,98,23,0.027489481,0.033941094,0.006451613
2020.0,TZA,3462,3462,109,94,15,0.027151935,0.03148469,0.0043327557
2021.0,TZA,3256,3256,80,59,21,0.018120393,0.024570024,0.0064496314
1996.0,UGA,61,61,0,0,0,0.0,0.0,0.0
1997.0,UGA,65,65,1,5,-4,0.07692308,0.015384615,-0.06153846
1998.0,UGA,177,177,0,1,-1,0.0056497175,0.0,-0.0056497175
1999.0,UGA,273,273,3,8,-5,0.02930403,0.010989011,-0.01831502
2000.0,UGA,379,379,6,4,2,0.01055409,0.015831135,0.005277045
2001.0,UGA,506,506,17,5,12,0.009881423,0.03359684,0.023715414
2002.0,UGA,622,622,19,25,-6,0.040192924,0.030546624,-0.009646302
2003.0,UGA,736,736,32,22,10,0.029891305,0.04347826,0.013586956
2004.0,UGA,826,826,20,22,-2,0.026634382,0.024213076,-0.0024213076
2005.0,UGA,968,968,29,30,-1,0.030991735,0.029958678,-0.0010330578
2006.0,UGA,1178,1178,24,16,8,0.013582343,0.020373514,0.0067911716
2007.0,UGA,1347,1347,41,32,9,0.023756497,0.03043801,0.0066815144
2008.0,UGA,1564,1564,52,36,16,0.023017902,0.03324808,0.010230179
2009.0,UGA,1802,1802,48,39,9,0.02164262,0.02663707,0.0049944506
2010.0,UGA,2036,2036,48,38,10,0.018664047,0.02357564,0.0049115913
2011.0,UGA,2308,2308,61,58,3,0.025129983,0.02642981,0.0012998267
2012.0,UGA,2579,2579,78,65,13,0.025203567,0.030244282,0.0050407136
2013.0,UGA,2820,2820,49,62,-13,0.021985816,0.017375886,-0.004609929
2014.0,UGA,2979,2979,70,85,-15,0.028533066,0.023497818,-0.0050352467
2015.0,UGA,3163,3163,67,98,-31,0.030983243,0.021182422,-0.009800822
2016.0,UGA,3394,3394,96,119,-23,0.035061873,0.02828521,-0.006776665
2017.0,UGA,3635,3635,95,97,-2,0.026685007,0.0261348,-0.00055020634
2018.0,UGA,3959,3959,125,119,6,0.030058095,0.03157363,0.0015155342
2019.0,UGA,4217,4217,123,99,24,0.023476405,0.029167654,0.00569125
2020.0,UGA,4097,4097,128,95,33,0.023187699,0.031242372,0.008054675
2021.0,UGA,3894,3894,88,75,13,0.0192604,0.02259887,0.0033384694
1996.0,UKR,5874,5874,0,0,0,0.0,0.0,0.0
1997.0,UKR,7104,7104,47,59,-12,0.00830518,0.006615991,-0.0016891892
1998.0,UKR,8966,8966,63,113,-50,0.012603167,0.007026545,-0.0055766227
1999.0,UKR,10753,10753,85,148,-63,0.013763601,0.007904771,-0.00585883
2000.0,UKR,11812,11812,43,182,-139,0.01540806,0.0036403658,-0.011767694
2001.0,UKR,12603,12603,130,223,-93,0.0176942,0.010315005,-0.0073791957
2002.0,UKR,13332,13332,162,273,-111,0.020477047,0.012151215,-0.008325833
2003.0,UKR,13834,13834,162,241,-79,0.017420847,0.011710279,-0.0057105683
2004.0,UKR,13809,13809,132,208,-76,0.01506264,0.009558983,-0.005503657
2005.0,UKR,13968,13968,123,213,-90,0.015249141,0.008805842,-0.006443299
2006.0,UKR,14344,14344,101,179,-78,0.0124790855,0.007041272,-0.0054378137
2007.0,UKR,14995,14995,134,184,-50,0.012270757,0.008936312,-0.0033344447
2008.0,UKR,15698,15698,140,150,-10,0.0095553575,0.008918334,-0.0006370238
2009.0,UKR,16555,16555,126,159,-33,0.009604349,0.0076109935,-0.0019933556
2010.0,UKR,17482,17482,132,193,-61,0.011039927,0.0075506233,-0.0034893032
2011.0,UKR,18725,18725,126,165,-39,0.008811749,0.006728972,-0.002082777
2012.0,UKR,20299,20299,118,182,-64,0.008965959,0.0058130943,-0.0031528648
2013.0,UKR,21780,21780,116,218,-102,0.010009183,0.005325987,-0.0046831956
2014.0,UKR,23518,23518,151,308,-157,0.013096352,0.006420614,-0.006675738
2015.0,UKR,25542,25542,119,403,-284,0.015777934,0.004658993,-0.011118941
2016.0,UKR,27986,27986,138,460,-322,0.01643679,0.004931037,-0.011505753
2017.0,UKR,31064,31064,158,407,-249,0.013101983,0.0050862734,-0.00801571
2018.0,UKR,33544,33544,180,336,-156,0.010016695,0.0053660865,-0.004650608
2019.0,UKR,33940,33940,149,309,-160,0.009104302,0.0043901,-0.0047142017
2020.0,UKR,32520,32520,143,237,-94,0.0072878227,0.004397294,-0.0028905289
2021.0,UKR,30204,30204,98,163,-65,0.005396636,0.0032446033,-0.002152033
2022.0,UKR,0,0,66,74,-8,,,
1996.0,URY,141,141,0,0,0,0.0,0.0,0.0
1997.0,URY,208,208,1,1,0,0.0048076925,0.0048076925,0.0
1998.0,URY,384,384,1,3,-2,0.0078125,0.0026041667,-0.0052083335
1999.0,URY,597,597,9,7,2,0.0117252935,0.015075377,0.0033500837
2000.0,URY,767,767,12,6,6,0.007822686,0.015645372,0.007822686
2001.0,URY,925,925,21,21,0,0.022702703,0.022702703,0.0
2002.0,URY,1056,1056,28,31,-3,0.02935606,0.026515152,-0.0028409092
2003.0,URY,1190,1190,34,33,1,0.027731093,0.028571429,0.00084033614
2004.0,URY,1298,1298,26,27,-1,0.020801233,0.020030817,-0.00077041605
2005.0,URY,1394,1394,23,37,-14,0.026542325,0.016499283,-0.010043042
2006.0,URY,1556,1556,31,31,0,0.019922879,0.019922879,0.0
2007.0,URY,1720,1720,21,34,-13,0.019767443,0.012209303,-0.0075581395
2008.0,URY,1871,1871,35,35,0,0.018706573,0.018706573,0.0
2009.0,URY,2081,2081,42,39,3,0.01874099,0.020182604,0.0014416146
2010.0,URY,2279,2279,58,30,28,0.013163668,0.025449758,0.01228609
2011.0,URY,2449,2449,37,36,1,0.014699877,0.015108207,0.00040832994
2012.0,URY,2694,2694,61,30,31,0.011135858,0.02264291,0.011507053
2013.0,URY,2889,2889,53,38,15,0.013153341,0.01834545,0.005192108
2014.0,URY,3065,3065,54,34,20,0.011092985,0.01761827,0.0065252855
2015.0,URY,3199,3199,60,61,-1,0.019068459,0.01875586,-0.0003125977
2016.0,URY,3394,3394,68,51,17,0.015026517,0.020035356,0.005008839
2017.0,URY,3510,3510,90,55,35,0.015669515,0.025641026,0.00997151
2018.0,URY,3634,3634,77,54,23,0.014859659,0.021188773,0.006329114
2019.0,URY,3672,3672,72,62,10,0.016884532,0.019607844,0.0027233115
2020.0,URY,3572,3572,90,70,20,0.019596865,0.02519597,0.0055991043
2021.0,URY,3339,3339,59,43,16,0.012878107,0.01766996,0.004791854
1996.0,USA,186836,186836,0,0,0,0.0,0.0,0.0
1997.0,USA,218306,218306,1530,1869,-339,0.008561377,0.007008511,-0.0015528662
1998.0,USA,374718,374718,2853,2700,153,0.0072054183,0.0076137255,0.00040830704
1999.0,USA,501761,501761,5389,4376,1013,0.008721284,0.010740173,0.0020188894
2000.0,USA,600095,600095,4797,3174,1623,0.0052891625,0.007993734,0.0027045717
2001.0,USA,683917,683917,10291,7934,2357,0.011600823,0.015047148,0.0034463247
2002.0,USA,770026,770026,13697,11486,2211,0.014916379,0.017787712,0.0028713315
2003.0,USA,835248,835248,13519,12579,940,0.015060198,0.016185611,0.0011254143
2004.0,USA,887534,887534,12564,11109,1455,0.012516703,0.014156077,0.0016393738
2005.0,USA,932104,932104,12664,11184,1480,0.011998661,0.013586467,0.0015878057
2006.0,USA,977491,977491,13034,12031,1003,0.012308042,0.013334138,0.0010260964
2007.0,USA,1020846,1020846,13197,12609,588,0.01235152,0.012927513,0.00057599286
2008.0,USA,1063924,1063924,14125,13160,965,0.012369305,0.013276325,0.00090701965
2009.0,USA,1107862,1107862,14857,13723,1134,0.012386922,0.013410515,0.0010235932
2010.0,USA,1148959,1148959,15502,14669,833,0.01276721,0.013492214,0.0007250041
2011.0,USA,1189150,1189150,15990,15410,580,0.012958836,0.01344658,0.00048774335
2012.0,USA,1228200,1228200,16327,16084,243,0.0130955875,0.013293438,0.00019785052
2013.0,USA,1269605,1269605,17255,16536,719,0.013024523,0.013590842,0.0005663179
2014.0,USA,1305779,1305779,18212,17027,1185,0.013039726,0.01394723,0.00090750423
2015.0,USA,1339894,1339894,18451,17038,1413,0.012715931,0.013770493,0.001054561
2016.0,USA,1371185,1371185,19461,16997,2464,0.012395848,0.014192834,0.0017969859
2017.0,USA,1395522,1395522,20338,16930,3408,0.012131661,0.0145737585,0.0024420968
2018.0,USA,1412279,1412279,20633,17337,3296,0.012275903,0.01460972,0.0023338164
2019.0,USA,1396277,1396277,20323,17749,2574,0.012711661,0.014555135,0.0018434738
2020.0,USA,1317624,1317624,19404,17076,2328,0.012959691,0.0147265075,0.0017668166
2021.0,USA,1207696,1207696,13832,13211,621,0.010939011,0.011453213,0.0005142022
2022.0,USA,0,0,7465,7487,-22,,,
1996.0,UZB,488,488,0,0,0,0.0,0.0,0.0
1997.0,UZB,560,560,10,4,6,0.007142857,0.017857144,0.010714286
1998.0,UZB,739,739,5,6,-1,0.00811908,0.0067658997,-0.0013531799
1999.0,UZB,848,848,3,6,-3,0.007075472,0.003537736,-0.003537736
2000.0,UZB,914,914,5,16,-11,0.01750547,0.0054704593,-0.012035011
2001.0,UZB,956,956,10,17,-7,0.017782427,0.010460251,-0.007322176
2002.0,UZB,1039,1039,17,18,-1,0.01732435,0.016361887,-0.0009624639
2003.0,UZB,1088,1088,11,11,0,0.010110294,0.010110294,0.0
2004.0,UZB,1075,1075,10,19,-9,0.017674418,0.009302326,-0.008372093
2005.0,UZB,1082,1082,11,23,-12,0.021256931,0.010166358,-0.011090573
2006.0,UZB,1114,1114,21,18,3,0.016157988,0.018850988,0.0026929982
2007.0,UZB,1118,1118,14,27,-13,0.02415027,0.012522361,-0.011627907
2008.0,UZB,1162,1162,17,17,0,0.014629948,0.014629948,0.0
2009.0,UZB,1248,1248,16,19,-3,0.015224359,0.012820513,-0.0024038462
2010.0,UZB,1246,1246,12,24,-12,0.019261638,0.009630819,-0.009630819
2011.0,UZB,1299,1299,10,18,-8,0.013856813,0.0076982295,-0.0061585833
2012.0,UZB,1335,1335,19,21,-2,0.015730336,0.01423221,-0.0014981274
2013.0,UZB,1341,1341,16,32,-16,0.023862788,0.011931394,-0.011931394
2014.0,UZB,1328,1328,18,19,-1,0.014307229,0.013554217,-0.000753012
2015.0,UZB,1370,1370,23,22,1,0.016058395,0.01678832,0.000729927
2016.0,UZB,1371,1371,20,18,2,0.013129103,0.014587892,0.0014587892
2017.0,UZB,1665,1665,22,22,0,0.0132132135,0.0132132135,0.0
2018.0,UZB,2062,2062,29,34,-5,0.016488846,0.014064016,-0.0024248303
2019.0,UZB,2149,2149,37,21,16,0.009771987,0.01721731,0.0074453233
2020.0,UZB,2135,2135,54,11,43,0.005152225,0.02529274,0.020140516
2021.0,UZB,2059,2059,35,21,14,0.010199126,0.016998542,0.006799417
2007.0,VCT,1,1,0,0,0,0.0,0.0,0.0
2015.0,VCT,3,3,0,0,0,0.0,0.0,0.0
2020.0,VCT,6,6,1,0,1,0.0,0.16666667,0.16666667
1996.0,VEN,920,920,0,0,0,0.0,0.0,0.0
1997.0,VEN,1240,1240,14,5,9,0.004032258,0.011290323,0.0072580646
1998.0,VEN,1972,1972,15,14,1,0.0070993914,0.007606491,0.0005070994
1999.0,VEN,2634,2634,29,21,8,0.007972665,0.011009871,0.0030372057
2000.0,VEN,3141,3141,28,34,-6,0.010824578,0.008914359,-0.0019102197
2001.0,VEN,3647,3647,51,56,-5,0.015355086,0.013984096,-0.0013709898
2002.0,VEN,4088,4088,59,89,-30,0.021771038,0.014432485,-0.007338552
2003.0,VEN,4436,4436,100,75,25,0.016907124,0.02254283,0.0056357076
2004.0,VEN,4745,4745,72,87,-15,0.01833509,0.015173867,-0.0031612224
2005.0,VEN,5219,5219,80,85,-5,0.016286645,0.015328607,-0.0009580379
2006.0,VEN,5720,5720,82,103,-21,0.018006993,0.014335664,-0.0036713288
2007.0,VEN,6134,6134,92,102,-10,0.016628627,0.01499837,-0.0016302576
2008.0,VEN,6365,6365,67,93,-26,0.014611155,0.010526316,-0.004084839
2009.0,VEN,6539,6539,91,101,-10,0.0154457865,0.013916501,-0.0015292858
2010.0,VEN,6586,6586,77,125,-48,0.018979654,0.011691467,-0.0072881873
2011.0,VEN,6474,6474,63,115,-52,0.017763361,0.009731232,-0.008032128
2012.0,VEN,6184,6184,55,110,-55,0.01778784,0.00889392,-0.00889392
2013.0,VEN,5974,5974,54,127,-73,0.021258788,0.00903917,-0.012219618
2014.0,VEN,5758,5758,67,129,-62,0.022403613,0.011635984,-0.0107676275
2015.0,VEN,5504,5504,60,132,-72,0.023982558,0.010901162,-0.013081395
2016.0,VEN,5106,5106,55,176,-121,0.03446925,0.0107716415,-0.023697611
2017.0,VEN,4699,4699,65,207,-142,0.044051927,0.01383273,-0.030219195
2018.0,VEN,4250,4250,58,241,-183,0.05670588,0.013647059,-0.043058824
2019.0,VEN,3805,3805,54,210,-156,0.055190537,0.014191853,-0.040998686
2020.0,VEN,3170,3170,53,179,-126,0.056466877,0.016719243,-0.039747633
2021.0,VEN,2596,2596,43,76,-33,0.029275808,0.016563945,-0.012711864
2004.0,VGB,5,5,0,0,0,0.0,0.0,0.0
2006.0,VGB,6,6,0,0,0,0.0,0.0,0.0
2007.0,VGB,6,6,0,0,0,0.0,0.0,0.0
2011.0,VGB,2,2,0,0,0,0.0,0.0,0.0
2016.0,VGB,5,5,1,1,0,0.2,0.2,0.0
2018.0,VGB,3,3,0,1,-1,0.33333334,0.0,-0.33333334
2021.0,VGB,5,5,0,0,0,0.0,0.0,0.0
2003.0,VIR,2,2,0,0,0,0.0,0.0,0.0
2009.0,VIR,1,1,0,0,0,0.0,0.0,0.0
1996.0,VNM,154,154,0,0,0,0.0,0.0,0.0
1997.0,VNM,184,184,2,0,2,0.0,0.010869565,0.010869565
1998.0,VNM,291,291,9,4,5,0.013745705,0.030927835,0.01718213
1999.0,VNM,394,394,6,17,-11,0.043147206,0.015228426,-0.027918782
2000.0,VNM,500,500,6,12,-6,0.024,0.012,-0.012
2001.0,VNM,635,635,15,21,-6,0.033070866,0.023622047,-0.009448819
2002.0,VNM,834,834,47,33,14,0.039568346,0.056354918,0.016786572
2003.0,VNM,1005,1005,55,28,27,0.027860697,0.05472637,0.026865672
2004.0,VNM,1205,1205,36,30,6,0.024896266,0.029875519,0.0049792533
2005.0,VNM,1386,1386,46,33,13,0.023809524,0.033189032,0.00937951
2006.0,VNM,1708,1708,65,29,36,0.016978923,0.038056206,0.021077283
2007.0,VNM,2044,2044,67,39,28,0.019080235,0.032778867,0.01369863
2008.0,VNM,2458,2458,89,35,54,0.014239219,0.036208298,0.02196908
2009.0,VNM,2943,2943,95,58,37,0.01970778,0.032279987,0.012572206
2010.0,VNM,3588,3588,152,62,90,0.017279822,0.042363435,0.025083613
2011.0,VNM,4295,4295,168,72,96,0.016763678,0.03911525,0.022351572
2012.0,VNM,5039,5039,182,103,79,0.020440564,0.036118276,0.015677715
2013.0,VNM,5906,5906,214,102,112,0.017270572,0.036234338,0.018963765
2014.0,VNM,7027,7027,312,150,162,0.021346236,0.04440017,0.023053935
2015.0,VNM,8231,8231,333,150,183,0.018223789,0.04045681,0.022233022
2016.0,VNM,9921,9921,388,164,224,0.016530592,0.03910896,0.02257837
2017.0,VNM,12392,12392,483,169,314,0.0136378305,0.03897676,0.02533893
2018.0,VNM,15148,15148,668,193,475,0.012740956,0.044098232,0.031357273
2019.0,VNM,16797,16797,688,232,456,0.013811991,0.040959693,0.027147705
2020.0,VNM,16860,16860,718,281,437,0.016666668,0.042586002,0.025919335
2021.0,VNM,16281,16281,444,293,151,0.017996438,0.027271053,0.009274615
2022.0,VNM,0,0,196,194,2,,,
2000.0,VUT,8,8,0,0,0,0.0,0.0,0.0
2001.0,VUT,9,9,0,0,0,0.0,0.0,0.0
2002.0,VUT,11,11,0,1,-1,0.09090909,0.0,-0.09090909
2003.0,VUT,14,14,1,2,-1,0.14285715,0.071428575,-0.071428575
2004.0,VUT,16,16,2,1,1,0.0625,0.125,0.0625
2005.0,VUT,18,18,1,1,0,0.055555556,0.055555556,0.0
2006.0,VUT,18,18,1,5,-4,0.2777778,0.055555556,-0.22222222
2007.0,VUT,17,17,2,2,0,0.11764706,0.11764706,0.0
2008.0,VUT,19,19,1,1,0,0.05263158,0.05263158,0.0
2009.0,VUT,19,19,0,1,-1,0.05263158,0.0,-0.05263158
2010.0,VUT,19,19,0,0,0,0.0,0.0,0.0
2011.0,VUT,22,22,1,0,1,0.0,0.045454547,0.045454547
2012.0,VUT,29,29,1,1,0,0.03448276,0.03448276,0.0
2013.0,VUT,32,32,1,1,0,0.03125,0.03125,0.0
2014.0,VUT,36,36,3,0,3,0.0,0.083333336,0.083333336
2015.0,VUT,39,39,3,2,1,0.051282052,0.07692308,0.025641026
2016.0,VUT,42,42,2,5,-3,0.11904762,0.04761905,-0.071428575
2017.0,VUT,44,44,2,2,0,0.045454547,0.045454547,0.0
2018.0,VUT,45,45,3,3,0,0.06666667,0.06666667,0.0
2019.0,VUT,54,54,5,3,2,0.055555556,0.09259259,0.037037037
2020.0,VUT,52,52,0,4,-4,0.07692308,0.0,-0.07692308
2021.0,VUT,50,50,3,1,2,0.02,0.06,0.04
2005.0,WLF,2,2,0,0,0,0.0,0.0,0.0
2007.0,WLF,3,3,0,0,0,0.0,0.0,0.0
2009.0,WLF,2,2,0,0,0,0.0,0.0,0.0
2015.0,WLF,1,1,0,0,0,0.0,0.0,0.0
2000.0,WSM,5,5,0,0,0,0.0,0.0,0.0
2001.0,WSM,7,7,0,0,0,0.0,0.0,0.0
2002.0,WSM,9,9,0,0,0,0.0,0.0,0.0
2003.0,WSM,9,9,1,1,0,0.11111111,0.11111111,0.0
2004.0,WSM,14,14,1,0,1,0.0,0.071428575,0.071428575
2005.0,WSM,14,14,0,1,-1,0.071428575,0.0,-0.071428575
2006.0,WSM,13,13,0,0,0,0.0,0.0,0.0
2010.0,WSM,6,6,0,0,0,0.0,0.0,0.0
2011.0,WSM,7,7,2,1,1,0.14285715,0.2857143,0.14285715
2014.0,WSM,38,38,3,1,2,0.02631579,0.078947365,0.05263158
2015.0,WSM,38,38,1,0,1,0.0,0.02631579,0.02631579
2016.0,WSM,48,48,3,1,2,0.020833334,0.0625,0.041666668
2017.0,WSM,51,51,2,2,0,0.039215688,0.039215688,0.0
2018.0,WSM,68,68,4,3,1,0.04411765,0.05882353,0.014705882
2019.0,WSM,69,69,0,2,-2,0.028985508,0.0,-0.028985508
2020.0,WSM,71,71,5,1,4,0.014084507,0.07042254,0.056338027
2021.0,WSM,66,66,3,4,-1,0.060606062,0.045454547,-0.015151516
1996.0,YEM,15,15,0,0,0,0.0,0.0,0.0
1997.0,YEM,20,20,0,0,0,0.0,0.0,0.0
1998.0,YEM,33,33,0,2,-2,0.060606062,0.0,-0.060606062
1999.0,YEM,58,58,1,2,-1,0.03448276,0.01724138,-0.01724138
2000.0,YEM,65,65,1,2,-1,0.03076923,0.015384615,-0.015384615
2001.0,YEM,80,80,2,2,0,0.025,0.025,0.0
2002.0,YEM,105,105,5,1,4,0.00952381,0.04761905,0.03809524
2003.0,YEM,131,131,7,5,2,0.03816794,0.053435113,0.015267176
2004.0,YEM,150,150,6,5,1,0.033333335,0.04,0.006666667
2005.0,YEM,175,175,8,6,2,0.034285713,0.045714285,0.011428571
2006.0,YEM,200,200,9,7,2,0.035,0.045,0.01
2007.0,YEM,225,225,14,5,9,0.022222223,0.062222224,0.04
2008.0,YEM,256,256,10,12,-2,0.046875,0.0390625,-0.0078125
2009.0,YEM,294,294,17,8,9,0.027210884,0.05782313,0.030612245
2010.0,YEM,341,341,20,11,9,0.032258064,0.058651026,0.026392963
2011.0,YEM,379,379,22,11,11,0.029023746,0.058047492,0.029023746
2012.0,YEM,433,433,33,20,13,0.046189375,0.07621247,0.030023094
2013.0,YEM,446,446,25,13,12,0.029147983,0.05605381,0.02690583
2014.0,YEM,449,449,21,16,5,0.035634745,0.046770602,0.011135858
2015.0,YEM,479,479,33,24,9,0.050104383,0.06889353,0.018789144
2016.0,YEM,516,516,37,19,18,0.036821704,0.07170542,0.034883723
2017.0,YEM,518,518,35,22,13,0.042471044,0.067567565,0.025096525
2018.0,YEM,543,543,37,27,10,0.049723756,0.06813996,0.018416205
2019.0,YEM,609,609,61,33,28,0.054187194,0.100164205,0.04597701
2020.0,YEM,593,593,57,42,15,0.07082631,0.096121415,0.02529511
2021.0,YEM,558,558,34,21,13,0.03763441,0.0609319,0.02329749
2022.0,YEM,0,0,31,22,9,,,
1996.0,ZAF,2294,2294,0,0,0,0.0,0.0,0.0
1997.0,ZAF,2839,2839,28,22,6,0.0077492073,0.009862628,0.0021134203
1998.0,ZAF,4903,4903,45,46,-1,0.009382011,0.0091780545,-0.00020395676
1999.0,ZAF,6728,6728,84,83,1,0.012336504,0.012485136,0.00014863258
2000.0,ZAF,8154,8154,65,77,-12,0.009443218,0.007971548,-0.0014716703
2001.0,ZAF,9411,9411,168,227,-59,0.024120709,0.01785145,-0.0062692594
2002.0,ZAF,10775,10775,270,295,-25,0.02737819,0.025058005,-0.0023201855
2003.0,ZAF,11771,11771,258,333,-75,0.028289866,0.021918274,-0.0063715912
2004.0,ZAF,12832,12832,252,271,-19,0.021119077,0.019638404,-0.0014806733
2005.0,ZAF,13810,13810,292,243,49,0.017595945,0.021144098,0.0035481534
2006.0,ZAF,14997,14997,281,256,25,0.017070081,0.018737081,0.0016670001
2007.0,ZAF,16213,16213,314,286,28,0.017640166,0.019367175,0.0017270092
2008.0,ZAF,17500,17500,344,346,-2,0.019771429,0.019657142,-0.000114285715
2009.0,ZAF,18936,18936,354,334,20,0.017638361,0.01869455,0.0010561893
2010.0,ZAF,20424,20424,443,407,36,0.019927537,0.02169017,0.0017626322
2011.0,ZAF,22059,22059,456,393,63,0.017815858,0.020671835,0.002855977
2012.0,ZAF,24013,24013,541,461,80,0.019197935,0.022529462,0.0033315287
2013.0,ZAF,25882,25882,565,491,74,0.018970713,0.021829844,0.0028591298
2014.0,ZAF,28041,28041,676,480,196,0.01711779,0.024107557,0.006989765
2015.0,ZAF,29994,29994,699,585,114,0.0195039,0.023304662,0.0038007603
2016.0,ZAF,31878,31878,683,654,29,0.020515716,0.021425435,0.0009097183
2017.0,ZAF,33231,33231,640,744,-104,0.022388734,0.019259125,-0.003129608
2018.0,ZAF,34461,34461,671,776,-105,0.022518208,0.019471286,-0.0030469226
2019.0,ZAF,34631,34631,613,881,-268,0.025439635,0.017700903,-0.0077387313
2020.0,ZAF,32969,32969,594,893,-299,0.027086051,0.018016925,-0.009069125
2021.0,ZAF,30450,30450,457,676,-219,0.02220033,0.01500821,-0.007192118
1996.0,ZMB,44,44,0,0,0,0.0,0.0,0.0
1997.0,ZMB,49,49,1,4,-3,0.08163265,0.020408163,-0.06122449
1998.0,ZMB,69,69,3,3,0,0.04347826,0.04347826,0.0
1999.0,ZMB,106,106,3,9,-6,0.08490566,0.028301887,-0.056603774
2000.0,ZMB,124,124,3,4,-1,0.032258064,0.024193548,-0.008064516
2001.0,ZMB,145,145,4,6,-2,0.04137931,0.027586207,-0.013793103
2002.0,ZMB,175,175,11,11,0,0.06285714,0.06285714,0.0
2003.0,ZMB,205,205,10,7,3,0.034146342,0.048780486,0.014634146
2004.0,ZMB,236,236,10,8,2,0.033898305,0.042372882,0.008474576
2005.0,ZMB,270,270,8,9,-1,0.033333335,0.02962963,-0.0037037036
2006.0,ZMB,319,319,19,10,9,0.031347964,0.05956113,0.028213166
2007.0,ZMB,347,347,7,12,-5,0.034582134,0.02017291,-0.014409222
2008.0,ZMB,391,391,10,9,1,0.023017902,0.025575448,0.0025575447
2009.0,ZMB,430,430,15,18,-3,0.041860465,0.034883723,-0.006976744
2010.0,ZMB,486,486,15,13,2,0.026748972,0.030864198,0.004115226
2011.0,ZMB,536,536,15,22,-7,0.041044775,0.027985075,-0.013059702
2012.0,ZMB,606,606,21,18,3,0.02970297,0.034653466,0.004950495
2013.0,ZMB,716,716,28,25,3,0.0349162,0.039106146,0.0041899444
2014.0,ZMB,805,805,40,24,16,0.029813664,0.049689442,0.019875776
2015.0,ZMB,898,898,32,33,-1,0.03674833,0.035634745,-0.0011135858
2016.0,ZMB,992,992,35,42,-7,0.04233871,0.035282258,-0.0070564514
2017.0,ZMB,1066,1066,43,28,15,0.026266417,0.04033771,0.014071294
2018.0,ZMB,1132,1132,33,31,2,0.027385158,0.029151943,0.0017667845
2019.0,ZMB,1170,1170,45,36,9,0.03076923,0.03846154,0.0076923077
2020.0,ZMB,1120,1120,52,46,6,0.04107143,0.046428572,0.005357143
2021.0,ZMB,1041,1041,37,25,12,0.02401537,0.03554275,0.011527377
1996.0,ZWE,112,112,0,0,0,0.0,0.0,0.0
1997.0,ZWE,146,146,5,1,4,0.006849315,0.034246575,0.02739726
1998.0,ZWE,280,280,3,8,-5,0.028571429,0.010714286,-0.017857144
1999.0,ZWE,371,371,9,13,-4,0.03504043,0.02425876,-0.010781671
2000.0,ZWE,450,450,8,3,5,0.006666667,0.017777778,0.011111111
2001.0,ZWE,490,490,11,31,-20,0.06326531,0.02244898,-0.040816326
2002.0,ZWE,523,523,15,38,-23,0.07265774,0.028680688,-0.043977056
2003.0,ZWE,543,543,21,34,-13,0.062615104,0.038674034,-0.023941068
2004.0,ZWE,574,574,12,32,-20,0.05574913,0.020905923,-0.034843206
2005.0,ZWE,602,602,17,41,-24,0.06810631,0.028239202,-0.03986711
2006.0,ZWE,638,638,15,47,-32,0.07366771,0.023510972,-0.05015674
2007.0,ZWE,639,639,14,47,-33,0.07355242,0.021909233,-0.051643193
2008.0,ZWE,640,640,13,44,-31,0.06875,0.0203125,-0.0484375
2009.0,ZWE,651,651,12,57,-45,0.08755761,0.01843318,-0.06912442
2010.0,ZWE,711,711,18,51,-33,0.07172996,0.025316456,-0.046413504
2011.0,ZWE,785,785,20,37,-17,0.04713376,0.025477707,-0.021656051
2012.0,ZWE,913,913,28,40,-12,0.04381161,0.030668126,-0.013143483
2013.0,ZWE,1015,1015,52,42,10,0.04137931,0.051231526,0.009852217
2014.0,ZWE,1114,1114,44,45,-1,0.040394973,0.03949731,-0.0008976661
2015.0,ZWE,1190,1190,33,55,-22,0.04621849,0.027731093,-0.018487396
2016.0,ZWE,1261,1261,48,60,-12,0.047581285,0.038065027,-0.009516257
2017.0,ZWE,1343,1343,62,51,11,0.03797468,0.046165302,0.008190618
2018.0,ZWE,1433,1433,66,62,4,0.043265875,0.046057224,0.0027913467
2019.0,ZWE,1484,1484,73,66,7,0.044474393,0.049191374,0.004716981
2020.0,ZWE,1397,1397,57,72,-15,0.05153901,0.04080172,-0.010737294
2021.0,ZWE,1282,1282,39,60,-21,0.046801873,0.030421216,-0.016380655
