year,countrycode,padded_population_of_researchers,paddedpop,number_of_inmigrations,number_of_outmigrations,netmigration,outmigrationrate,inmigrationrate,netmigrationrate
1997.0,ABW,1,1,0,0,0,0.0,0.0,0.0
2000.0,ABW,2,2,0,0,0,0.0,0.0,0.0
2009.0,ABW,9,9,0,0,0,0.0,0.0,0.0
2010.0,ABW,11,11,1,0,1,0.0,0.09090909,0.09090909
2011.0,ABW,14,14,0,0,0,0.0,0.0,0.0
2012.0,ABW,18,18,1,3,-2,0.16666667,0.055555556,-0.11111111
2013.0,ABW,19,19,1,1,0,0.05263158,0.05263158,0.0
2014.0,ABW,20,20,2,1,1,0.05,0.1,0.05
2015.0,ABW,18,18,2,4,-2,0.22222222,0.11111111,-0.11111111
2016.0,ABW,16,16,0,1,-1,0.0625,0.0,-0.0625
2019.0,ABW,27,27,6,0,6,0.0,0.22222222,0.22222222
2020.0,ABW,24,24,2,4,-2,0.16666667,0.083333336,-0.083333336
2021.0,ABW,27,27,4,3,1,0.11111111,0.14814815,0.037037037
2022.0,ABW,0,0,5,1,4,,,
1999.0,AFG,6,6,1,0,1,0.0,0.16666667,0.16666667
2000.0,AFG,10,10,2,0,2,0.0,0.2,0.2
2001.0,AFG,15,15,0,2,-2,0.13333334,0.0,-0.13333334
2002.0,AFG,18,18,2,1,1,0.055555556,0.11111111,0.055555556
2003.0,AFG,24,24,6,3,3,0.125,0.25,0.125
2004.0,AFG,33,33,7,2,5,0.060606062,0.21212122,0.15151516
2005.0,AFG,39,39,5,6,-1,0.15384616,0.12820514,-0.025641026
2006.0,AFG,50,50,10,6,4,0.12,0.2,0.08
2007.0,AFG,60,60,2,6,-4,0.1,0.033333335,-0.06666667
2008.0,AFG,68,68,6,10,-4,0.14705883,0.0882353,-0.05882353
2009.0,AFG,105,105,22,6,16,0.057142857,0.20952381,0.15238096
2010.0,AFG,124,124,16,13,3,0.10483871,0.12903225,0.024193548
2011.0,AFG,144,144,16,12,4,0.083333336,0.11111111,0.027777778
2012.0,AFG,165,165,15,9,6,0.054545455,0.09090909,0.036363635
2013.0,AFG,157,157,7,16,-9,0.10191083,0.044585988,-0.05732484
2014.0,AFG,171,171,13,14,-1,0.081871346,0.07602339,-0.0058479533
2015.0,AFG,192,192,23,20,3,0.104166664,0.119791664,0.015625
2016.0,AFG,251,251,29,8,21,0.03187251,0.11553785,0.08366534
2017.0,AFG,328,328,45,25,20,0.076219514,0.13719513,0.06097561
2018.0,AFG,421,421,53,22,31,0.052256532,0.12589073,0.07363421
2019.0,AFG,487,487,54,50,4,0.1026694,0.11088296,0.008213553
2020.0,AFG,527,527,47,58,-11,0.11005693,0.08918406,-0.020872865
2021.0,AFG,485,485,27,68,-41,0.14020619,0.055670105,-0.08453608
2022.0,AFG,0,0,26,34,-8,,,
2023.0,AFG,0,0,20,27,-7,,,
1996.0,AGO,10,10,0,0,0,0.0,0.0,0.0
1997.0,AGO,13,13,0,2,-2,0.15384616,0.0,-0.15384616
1998.0,AGO,21,21,3,0,3,0.0,0.14285715,0.14285715
1999.0,AGO,24,24,2,2,0,0.083333336,0.083333336,0.0
2000.0,AGO,24,24,1,2,-1,0.083333336,0.041666668,-0.041666668
2001.0,AGO,23,23,2,4,-2,0.17391305,0.08695652,-0.08695652
2002.0,AGO,27,27,4,3,1,0.11111111,0.14814815,0.037037037
2003.0,AGO,38,38,5,0,5,0.0,0.13157895,0.13157895
2004.0,AGO,44,44,4,3,1,0.06818182,0.09090909,0.022727273
2005.0,AGO,48,48,6,5,1,0.104166664,0.125,0.020833334
2006.0,AGO,57,57,4,1,3,0.01754386,0.07017544,0.05263158
2007.0,AGO,68,68,2,2,0,0.029411765,0.029411765,0.0
2008.0,AGO,75,75,4,7,-3,0.093333334,0.053333335,-0.04
2009.0,AGO,85,85,6,2,4,0.023529412,0.07058824,0.047058824
2010.0,AGO,99,99,4,4,0,0.04040404,0.04040404,0.0
2011.0,AGO,118,118,7,2,5,0.016949153,0.059322033,0.042372882
2012.0,AGO,134,134,9,6,3,0.04477612,0.06716418,0.02238806
2013.0,AGO,156,156,12,2,10,0.012820513,0.07692308,0.06410257
2014.0,AGO,178,178,17,6,11,0.033707865,0.09550562,0.061797753
2015.0,AGO,200,200,16,4,12,0.02,0.08,0.06
2016.0,AGO,207,207,7,11,-4,0.053140096,0.033816423,-0.019323671
2017.0,AGO,225,225,11,13,-2,0.057777777,0.04888889,-0.008888889
2018.0,AGO,222,222,13,10,3,0.045045044,0.058558557,0.013513514
2019.0,AGO,253,253,23,5,18,0.019762846,0.09090909,0.07114624
2020.0,AGO,245,245,8,7,1,0.028571429,0.03265306,0.0040816325
2021.0,AGO,244,244,19,9,10,0.036885247,0.07786885,0.040983606
2022.0,AGO,0,0,7,9,-2,,,
2012.0,AIA,5,5,1,0,1,0.0,0.2,0.2
2013.0,AIA,12,12,1,0,1,0.0,0.083333336,0.083333336
2014.0,AIA,20,20,4,0,4,0.0,0.2,0.2
2015.0,AIA,22,22,2,0,2,0.0,0.09090909,0.09090909
2016.0,AIA,23,23,1,0,1,0.0,0.04347826,0.04347826
2018.0,AIA,16,16,1,1,0,0.0625,0.0625,0.0
2019.0,AIA,11,11,0,1,-1,0.09090909,0.0,-0.09090909
2020.0,AIA,12,12,2,3,-1,0.25,0.16666667,-0.083333336
1996.0,ALB,77,77,0,0,0,0.0,0.0,0.0
1997.0,ALB,96,96,3,3,0,0.03125,0.03125,0.0
1998.0,ALB,109,109,5,4,1,0.036697246,0.04587156,0.0091743115
1999.0,ALB,113,113,2,5,-3,0.044247787,0.017699115,-0.026548672
2000.0,ALB,131,131,4,7,-3,0.053435113,0.030534351,-0.022900764
2001.0,ALB,132,132,3,6,-3,0.045454547,0.022727273,-0.022727273
2002.0,ALB,137,137,3,6,-3,0.04379562,0.02189781,-0.02189781
2003.0,ALB,138,138,3,6,-3,0.04347826,0.02173913,-0.02173913
2004.0,ALB,152,152,4,7,-3,0.04605263,0.02631579,-0.019736841
2005.0,ALB,180,180,8,5,3,0.027777778,0.044444446,0.016666668
2006.0,ALB,212,212,9,6,3,0.028301887,0.04245283,0.014150944
2007.0,ALB,292,292,14,3,11,0.0102739725,0.047945205,0.037671234
2008.0,ALB,396,396,10,6,4,0.015151516,0.025252525,0.01010101
2009.0,ALB,507,507,17,4,13,0.007889546,0.03353057,0.025641026
2010.0,ALB,635,635,21,15,6,0.023622047,0.033070866,0.009448819
2011.0,ALB,793,793,15,16,-1,0.020176545,0.01891551,-0.001261034
2012.0,ALB,947,947,32,16,16,0.01689546,0.03379092,0.01689546
2013.0,ALB,1004,1004,22,24,-2,0.023904383,0.021912351,-0.001992032
2014.0,ALB,1073,1073,31,14,17,0.01304753,0.02889096,0.01584343
2015.0,ALB,1067,1067,22,23,-1,0.021555765,0.020618556,-0.00093720714
2016.0,ALB,1041,1041,45,24,21,0.023054754,0.043227665,0.02017291
2017.0,ALB,1017,1017,36,26,10,0.025565388,0.03539823,0.009832841
2018.0,ALB,1067,1067,43,19,24,0.017806936,0.040299907,0.022492971
2019.0,ALB,1168,1168,40,28,12,0.023972603,0.034246575,0.0102739725
2020.0,ALB,1268,1268,38,37,1,0.029179811,0.029968454,0.00078864355
2021.0,ALB,1295,1295,47,32,15,0.024710424,0.036293436,0.011583012
2022.0,ALB,0,0,32,36,-4,,,
1996.0,AND,3,3,0,0,0,0.0,0.0,0.0
1998.0,AND,2,2,0,0,0,0.0,0.0,0.0
2001.0,AND,13,13,2,1,1,0.07692308,0.15384616,0.07692308
2002.0,AND,13,13,0,1,-1,0.07692308,0.0,-0.07692308
2003.0,AND,17,17,4,4,0,0.23529412,0.23529412,0.0
2004.0,AND,19,19,2,2,0,0.10526316,0.10526316,0.0
2005.0,AND,20,20,1,3,-2,0.15,0.05,-0.1
2006.0,AND,52,52,6,2,4,0.03846154,0.115384616,0.07692308
2007.0,AND,58,58,4,0,4,0.0,0.06896552,0.06896552
2008.0,AND,60,60,6,3,3,0.05,0.1,0.05
2009.0,AND,60,60,4,2,2,0.033333335,0.06666667,0.033333335
2011.0,AND,57,57,1,9,-8,0.15789473,0.01754386,-0.14035088
2012.0,AND,53,53,2,4,-2,0.0754717,0.03773585,-0.03773585
2013.0,AND,26,26,4,0,4,0.0,0.15384616,0.15384616
2014.0,AND,30,30,2,2,0,0.06666667,0.06666667,0.0
2015.0,AND,32,32,3,3,0,0.09375,0.09375,0.0
2016.0,AND,35,35,3,0,3,0.0,0.08571429,0.08571429
2017.0,AND,38,38,6,2,4,0.05263158,0.15789473,0.10526316
2018.0,AND,35,35,2,4,-2,0.114285715,0.057142857,-0.057142857
2019.0,AND,40,40,3,2,1,0.05,0.075,0.025
2020.0,AND,40,40,3,4,-1,0.1,0.075,-0.025
2021.0,AND,48,48,11,3,8,0.0625,0.22916667,0.16666667
2022.0,AND,0,0,10,3,7,,,
1996.0,ARE,460,460,0,0,0,0.0,0.0,0.0
1997.0,ARE,545,545,40,19,21,0.034862384,0.07339449,0.03853211
1998.0,ARE,609,609,36,40,-4,0.06568144,0.0591133,-0.0065681445
1999.0,ARE,707,707,70,42,28,0.05940594,0.0990099,0.03960396
2000.0,ARE,790,790,111,48,63,0.060759492,0.14050633,0.079746835
2001.0,ARE,927,927,100,48,52,0.051779937,0.10787486,0.05609493
2002.0,ARE,1024,1024,105,61,44,0.059570312,0.10253906,0.04296875
2003.0,ARE,1146,1146,100,58,42,0.05061082,0.08726004,0.036649216
2004.0,ARE,1267,1267,108,67,41,0.05288082,0.08524073,0.032359906
2005.0,ARE,1428,1428,132,61,71,0.042717088,0.09243698,0.04971989
2006.0,ARE,1620,1620,139,66,73,0.04074074,0.085802466,0.04506173
2007.0,ARE,1854,1854,148,83,65,0.04476807,0.0798274,0.035059333
2008.0,ARE,2103,2103,217,77,140,0.036614362,0.10318592,0.06657156
2009.0,ARE,2360,2360,209,75,134,0.03177966,0.08855932,0.05677966
2010.0,ARE,2648,2648,233,101,132,0.038141996,0.08799094,0.049848944
2011.0,ARE,2970,2970,253,125,128,0.042087544,0.085185185,0.04309764
2012.0,ARE,3373,3373,292,131,161,0.03883783,0.086569816,0.047731988
2013.0,ARE,3852,3852,355,156,199,0.040498443,0.09215992,0.051661473
2014.0,ARE,4402,4402,414,180,234,0.040890504,0.09404816,0.053157657
2015.0,ARE,5117,5117,485,182,303,0.035567716,0.0947821,0.059214383
2016.0,ARE,5929,5929,530,246,284,0.041490976,0.08939113,0.04790015
2017.0,ARE,6814,6814,609,289,320,0.04241268,0.08937482,0.04696214
2018.0,ARE,7958,7958,713,332,381,0.041719023,0.08959538,0.04787635
2019.0,ARE,9005,9005,686,373,313,0.041421432,0.0761799,0.034758467
2020.0,ARE,9810,9810,773,417,356,0.042507645,0.07879715,0.036289502
2021.0,ARE,9902,9902,779,437,342,0.044132497,0.07867098,0.034538478
2022.0,ARE,0,0,680,401,279,,,
2023.0,ARE,0,0,533,299,234,,,
1996.0,ARG,11370,11370,0,0,0,0.0,0.0,0.0
1997.0,ARG,13346,13346,210,189,21,0.014161547,0.015735053,0.0015735051
1998.0,ARG,15202,15202,212,259,-47,0.017037231,0.013945534,-0.0030916985
1999.0,ARG,16414,16414,257,338,-81,0.020592177,0.015657365,-0.004934812
2000.0,ARG,17568,17568,291,363,-72,0.020662569,0.016564207,-0.0040983604
2001.0,ARG,18576,18576,329,410,-81,0.02207149,0.017711025,-0.0043604653
2002.0,ARG,19739,19739,381,436,-55,0.022088252,0.01930189,-0.002786362
2003.0,ARG,20580,20580,321,499,-178,0.024246842,0.015597668,-0.008649174
2004.0,ARG,21747,21747,279,467,-188,0.021474225,0.012829356,-0.0086448705
2005.0,ARG,22970,22970,284,422,-138,0.018371789,0.012363953,-0.006007836
2006.0,ARG,24521,24521,346,414,-68,0.016883487,0.014110355,-0.0027731333
2007.0,ARG,26207,26207,389,407,-18,0.015530202,0.014843362,-0.0006868394
2008.0,ARG,28277,28277,401,371,30,0.013120203,0.014181136,0.0010609329
2009.0,ARG,30093,30093,410,410,0,0.013624431,0.013624431,0.0
2010.0,ARG,31989,31989,408,427,-19,0.013348338,0.012754384,-0.0005939542
2011.0,ARG,33855,33855,455,436,19,0.012878452,0.013439669,0.00056121696
2012.0,ARG,35588,35588,449,464,-15,0.013038103,0.012616612,-0.0004214904
2013.0,ARG,37233,37233,430,483,-53,0.012972363,0.011548894,-0.0014234685
2014.0,ARG,38855,38855,503,484,19,0.012456569,0.012945567,0.00048899755
2015.0,ARG,40340,40340,522,520,2,0.012890431,0.01294001,4.9578583e-05
2016.0,ARG,42035,42035,560,502,58,0.011942429,0.013322231,0.0013798026
2017.0,ARG,43444,43444,569,569,0,0.013097321,0.013097321,0.0
2018.0,ARG,44749,44749,568,558,10,0.012469552,0.012693021,0.00022346868
2019.0,ARG,45466,45466,511,627,-116,0.013790525,0.011239167,-0.002551357
2020.0,ARG,44850,44850,486,682,-196,0.015206243,0.010836121,-0.0043701227
2021.0,ARG,43101,43101,460,693,-233,0.016078513,0.0106726065,-0.005405907
2022.0,ARG,0,0,344,587,-243,,,
2023.0,ARG,0,0,207,319,-112,,,
1996.0,ARM,743,743,0,0,0,0.0,0.0,0.0
1997.0,ARM,844,844,13,23,-10,0.027251184,0.015402843,-0.011848342
1998.0,ARM,990,990,15,32,-17,0.032323234,0.015151516,-0.017171716
1999.0,ARM,1076,1076,17,27,-10,0.025092937,0.015799256,-0.00929368
2000.0,ARM,1158,1158,26,29,-3,0.025043178,0.022452503,-0.0025906735
2001.0,ARM,1187,1187,27,32,-5,0.026958719,0.02274642,-0.0042123
2002.0,ARM,1250,1250,20,28,-8,0.0224,0.016,-0.0064
2003.0,ARM,1250,1250,32,35,-3,0.028,0.0256,-0.0024
2004.0,ARM,1291,1291,21,17,4,0.013168086,0.01626646,0.0030983733
2005.0,ARM,1358,1358,21,25,-4,0.018409425,0.0154639175,-0.002945508
2006.0,ARM,1426,1426,27,22,5,0.01542777,0.018934082,0.0035063114
2007.0,ARM,1483,1483,17,26,-9,0.01753203,0.01146325,-0.0060687796
2008.0,ARM,1567,1567,15,33,-18,0.02105935,0.009572431,-0.011486918
2009.0,ARM,1656,1656,25,30,-5,0.018115941,0.015096619,-0.0030193236
2010.0,ARM,1754,1754,20,39,-19,0.022234892,0.011402508,-0.010832383
2011.0,ARM,1805,1805,30,43,-13,0.023822716,0.016620498,-0.007202216
2012.0,ARM,1854,1854,42,43,-1,0.023193097,0.022653721,-0.0005393743
2013.0,ARM,1870,1870,22,44,-22,0.023529412,0.011764706,-0.011764706
2014.0,ARM,1926,1926,39,35,4,0.018172378,0.020249221,0.0020768433
2015.0,ARM,1959,1959,28,36,-8,0.018376723,0.014293007,-0.0040837163
2016.0,ARM,2006,2006,35,47,-12,0.02342971,0.017447658,-0.005982054
2017.0,ARM,2124,2124,38,33,5,0.015536723,0.017890772,0.002354049
2018.0,ARM,2192,2192,33,41,-8,0.018704379,0.015054745,-0.003649635
2019.0,ARM,2258,2258,36,38,-2,0.016829053,0.015943313,-0.0008857396
2020.0,ARM,2298,2298,47,34,13,0.014795475,0.020452568,0.005657093
2021.0,ARM,2254,2254,33,34,-1,0.015084295,0.014640639,-0.00044365574
2022.0,ARM,0,0,28,27,1,,,
1996.0,ASM,5,5,0,0,0,0.0,0.0,0.0
1997.0,ASM,3,3,0,2,-2,0.6666667,0.0,-0.6666667
2000.0,ASM,4,4,0,1,-1,0.25,0.0,-0.25
2002.0,ASM,5,5,1,0,1,0.0,0.2,0.2
2004.0,ASM,12,12,1,1,0,0.083333336,0.083333336,0.0
2006.0,ASM,22,22,5,1,4,0.045454547,0.22727273,0.18181819
2007.0,ASM,21,21,0,1,-1,0.04761905,0.0,-0.04761905
2008.0,ASM,21,21,2,3,-1,0.14285715,0.0952381,-0.04761905
2009.0,ASM,29,29,10,1,9,0.03448276,0.3448276,0.31034482
2010.0,ASM,26,26,5,9,-4,0.34615386,0.1923077,-0.15384616
2011.0,ASM,26,26,2,5,-3,0.1923077,0.07692308,-0.115384616
2012.0,ASM,27,27,4,5,-1,0.18518518,0.14814815,-0.037037037
2013.0,ASM,28,28,3,2,1,0.071428575,0.10714286,0.035714287
2014.0,ASM,23,23,3,4,-1,0.17391305,0.13043478,-0.04347826
2015.0,ASM,25,25,4,4,0,0.16,0.16,0.0
2016.0,ASM,26,26,2,3,-1,0.115384616,0.07692308,-0.03846154
2017.0,ASM,23,23,2,2,0,0.08695652,0.08695652,0.0
2018.0,ASM,23,23,5,4,1,0.17391305,0.2173913,0.04347826
2019.0,ASM,22,22,4,3,1,0.13636364,0.18181819,0.045454547
2000.0,ATA,4,4,1,0,1,0.0,0.25,0.25
2008.0,ATA,4,4,2,0,2,0.0,0.5,0.5
2010.0,ATA,5,5,2,4,-2,0.8,0.4,-0.4
2014.0,ATA,3,3,0,0,0,0.0,0.0,0.0
2017.0,ATA,6,6,1,0,1,0.0,0.16666667,0.16666667
2018.0,ATA,6,6,0,1,-1,0.16666667,0.0,-0.16666667
2020.0,ATA,6,6,0,2,-2,0.33333334,0.0,-0.33333334
2021.0,ATA,4,4,0,1,-1,0.25,0.0,-0.25
1997.0,ATG,1,1,0,0,0,0.0,0.0,0.0
2000.0,ATG,4,4,0,0,0,0.0,0.0,0.0
2003.0,ATG,5,5,2,0,2,0.0,0.4,0.4
2005.0,ATG,13,13,3,0,3,0.0,0.23076923,0.23076923
2006.0,ATG,14,14,0,1,-1,0.071428575,0.0,-0.071428575
2007.0,ATG,17,17,1,0,1,0.0,0.05882353,0.05882353
2008.0,ATG,17,17,0,1,-1,0.05882353,0.0,-0.05882353
2009.0,ATG,15,15,1,2,-1,0.13333334,0.06666667,-0.06666667
2010.0,ATG,16,16,4,1,3,0.0625,0.25,0.1875
2012.0,ATG,9,9,3,2,1,0.22222222,0.33333334,0.11111111
2015.0,ATG,17,17,3,2,1,0.11764706,0.1764706,0.05882353
2016.0,ATG,20,20,1,0,1,0.0,0.05,0.05
2017.0,ATG,17,17,4,5,-1,0.29411766,0.23529412,-0.05882353
2018.0,ATG,20,20,2,1,1,0.05,0.1,0.05
2019.0,ATG,21,21,2,3,-1,0.14285715,0.0952381,-0.04761905
2020.0,ATG,24,24,5,3,2,0.125,0.20833333,0.083333336
2021.0,ATG,20,20,2,4,-2,0.2,0.1,-0.1
2022.0,ATG,0,0,11,6,5,,,
1996.0,AUS,38329,38329,0,0,0,0.0,0.0,0.0
1997.0,AUS,44545,44545,1055,1019,36,0.022875743,0.023683915,0.0008081715
1998.0,AUS,50596,50596,1333,1316,17,0.026009962,0.026345957,0.00033599493
1999.0,AUS,54827,54827,1460,1560,-100,0.028453134,0.026629215,-0.0018239189
2000.0,AUS,58116,58116,1599,1714,-115,0.02949274,0.027513938,-0.001978801
2001.0,AUS,61123,61123,1818,1955,-137,0.031984687,0.029743304,-0.0022413821
2002.0,AUS,64914,64914,2090,2063,27,0.03178051,0.032196444,0.00041593492
2003.0,AUS,68375,68375,2083,1988,95,0.029074954,0.030464351,0.0013893967
2004.0,AUS,72589,72589,1913,1770,143,0.02438386,0.026353855,0.0019699954
2005.0,AUS,76771,76771,1987,1895,92,0.0246838,0.02588217,0.0011983692
2006.0,AUS,81879,81879,2188,1798,390,0.021959232,0.026722359,0.004763126
2007.0,AUS,87488,87488,2509,2045,464,0.023374634,0.028678218,0.0053035845
2008.0,AUS,93575,93575,2811,2194,617,0.023446433,0.030040074,0.0065936414
2009.0,AUS,99544,99544,3006,2305,701,0.023155589,0.030197702,0.007042112
2010.0,AUS,105823,105823,3364,2508,856,0.023699952,0.03178893,0.008088979
2011.0,AUS,112623,112623,3426,2892,534,0.025678592,0.030420074,0.0047414824
2012.0,AUS,120004,120004,3688,2803,885,0.023357555,0.03073231,0.007374754
2013.0,AUS,127544,127544,4081,2879,1202,0.022572603,0.0319968,0.009424198
2014.0,AUS,134573,134573,4114,3231,883,0.024009274,0.030570768,0.0065614944
2015.0,AUS,140934,140934,4202,3542,660,0.025132332,0.029815374,0.0046830433
2016.0,AUS,146893,146893,4243,3865,378,0.02631167,0.028884972,0.0025733016
2017.0,AUS,152677,152677,4422,4010,412,0.026264599,0.028963106,0.0026985074
2018.0,AUS,157714,157714,4525,4356,169,0.027619615,0.028691174,0.00107156
2019.0,AUS,161829,161829,4795,4385,410,0.027096502,0.02963004,0.0025335385
2020.0,AUS,161965,161965,4684,4586,98,0.02831476,0.028919829,0.000605069
2021.0,AUS,155473,155473,4195,4409,-214,0.028358622,0.026982177,-0.0013764448
2022.0,AUS,0,0,3203,3723,-520,,,
2023.0,AUS,0,0,2064,2302,-238,,,
1996.0,AUT,11790,11790,0,0,0,0.0,0.0,0.0
1997.0,AUT,13648,13648,358,385,-27,0.028209262,0.02623095,-0.001978312
1998.0,AUT,15302,15302,390,513,-123,0.03352503,0.025486864,-0.008038165
1999.0,AUT,16845,16845,526,520,6,0.030869694,0.031225882,0.00035618877
2000.0,AUT,17941,17941,540,595,-55,0.03316426,0.030098656,-0.003065604
2001.0,AUT,19023,19023,637,674,-37,0.035430793,0.03348578,-0.0019450139
2002.0,AUT,20128,20128,723,717,6,0.03562202,0.03592011,0.0002980922
2003.0,AUT,21327,21327,716,635,81,0.029774465,0.033572465,0.0037980026
2004.0,AUT,22548,22548,617,543,74,0.024081958,0.027363846,0.0032818876
2005.0,AUT,23764,23764,670,599,71,0.025206193,0.028193906,0.0029877126
2006.0,AUT,25067,25067,689,635,54,0.02533211,0.027486337,0.0021542266
2007.0,AUT,26578,26578,739,688,51,0.025886072,0.027804952,0.0019188803
2008.0,AUT,27983,27983,784,738,46,0.026373155,0.02801701,0.0016438552
2009.0,AUT,29505,29505,836,851,-15,0.028842568,0.02833418,-0.0005083884
2010.0,AUT,30800,30800,958,916,42,0.029740259,0.031103896,0.0013636363
2011.0,AUT,32199,32199,1018,970,48,0.03012516,0.031615887,0.0014907295
2012.0,AUT,33788,33788,1050,1041,9,0.030809755,0.031076122,0.00026636675
2013.0,AUT,35285,35285,1050,1147,-97,0.03250673,0.029757688,-0.0027490435
2014.0,AUT,36873,36873,1236,1116,120,0.030266048,0.033520464,0.0032544138
2015.0,AUT,38300,38300,1273,1134,139,0.029608356,0.0332376,0.0036292428
2016.0,AUT,39661,39661,1341,1204,137,0.030357277,0.033811554,0.003454275
2017.0,AUT,40822,40822,1352,1260,92,0.03086571,0.033119395,0.0022536868
2018.0,AUT,42211,42211,1407,1213,194,0.028736586,0.033332545,0.0045959586
2019.0,AUT,43408,43408,1385,1264,121,0.029119056,0.03190656,0.0027875046
2020.0,AUT,43590,43590,1569,1252,317,0.028722184,0.035994492,0.00727231
2021.0,AUT,41913,41913,1464,1216,248,0.029012479,0.034929495,0.0059170187
2022.0,AUT,0,0,1259,1127,132,,,
2023.0,AUT,0,0,808,704,104,,,
1996.0,AZE,445,445,0,0,0,0.0,0.0,0.0
1997.0,AZE,517,517,13,10,3,0.01934236,0.025145067,0.0058027077
1998.0,AZE,580,580,10,20,-10,0.03448276,0.01724138,-0.01724138
1999.0,AZE,607,607,11,9,2,0.014827018,0.018121911,0.0032948928
2000.0,AZE,644,644,14,16,-2,0.024844721,0.02173913,-0.0031055901
2001.0,AZE,698,698,10,18,-8,0.025787966,0.014326648,-0.0114613185
2002.0,AZE,793,793,10,12,-2,0.015132409,0.0126103405,-0.002522068
2003.0,AZE,878,878,11,15,-4,0.017084282,0.0125284735,-0.004555809
2004.0,AZE,926,926,19,16,3,0.017278617,0.020518359,0.0032397409
2005.0,AZE,1070,1070,13,13,0,0.012149532,0.012149532,0.0
2006.0,AZE,1270,1270,29,14,15,0.011023622,0.022834646,0.011811024
2007.0,AZE,1468,1468,12,19,-7,0.012942779,0.008174387,-0.0047683925
2008.0,AZE,1650,1650,26,23,3,0.013939394,0.015757576,0.0018181818
2009.0,AZE,1824,1824,20,20,0,0.010964912,0.010964912,0.0
2010.0,AZE,1869,1869,26,39,-13,0.020866774,0.013911182,-0.006955591
2011.0,AZE,1901,1901,26,28,-2,0.01472909,0.013677012,-0.0010520779
2012.0,AZE,1922,1922,28,15,13,0.0078043705,0.014568158,0.006763788
2013.0,AZE,1968,1968,29,29,0,0.014735772,0.014735772,0.0
2014.0,AZE,2043,2043,41,26,15,0.012726382,0.020068526,0.007342144
2015.0,AZE,2144,2144,27,23,4,0.010727612,0.012593283,0.0018656716
2016.0,AZE,2300,2300,49,28,21,0.012173913,0.021304348,0.009130435
2017.0,AZE,2655,2655,38,27,11,0.010169491,0.0143126175,0.0041431263
2018.0,AZE,2889,2889,41,29,12,0.010038075,0.014191762,0.0041536866
2019.0,AZE,3013,3013,34,36,-2,0.011948224,0.011284434,-0.00066379027
2020.0,AZE,3096,3096,43,37,6,0.0119509045,0.013888889,0.0019379845
2021.0,AZE,2978,2978,40,32,8,0.010745467,0.013431833,0.0026863667
2022.0,AZE,0,0,31,24,7,,,
2023.0,AZE,0,0,23,12,11,,,
1996.0,BDI,25,25,0,0,0,0.0,0.0,0.0
1997.0,BDI,25,25,1,2,-1,0.08,0.04,-0.04
1998.0,BDI,25,25,3,3,0,0.12,0.12,0.0
1999.0,BDI,22,22,1,1,0,0.045454547,0.045454547,0.0
2003.0,BDI,15,15,2,0,2,0.0,0.13333334,0.13333334
2004.0,BDI,16,16,1,0,1,0.0,0.0625,0.0625
2007.0,BDI,26,26,1,1,0,0.03846154,0.03846154,0.0
2008.0,BDI,33,33,2,1,1,0.030303031,0.060606062,0.030303031
2009.0,BDI,42,42,3,0,3,0.0,0.071428575,0.071428575
2010.0,BDI,53,53,4,1,3,0.018867925,0.0754717,0.056603774
2011.0,BDI,71,71,5,1,4,0.014084507,0.07042254,0.056338027
2012.0,BDI,85,85,6,2,4,0.023529412,0.07058824,0.047058824
2013.0,BDI,91,91,6,3,3,0.032967035,0.06593407,0.032967035
2014.0,BDI,102,102,5,3,2,0.029411765,0.04901961,0.019607844
2015.0,BDI,108,108,6,7,-1,0.06481481,0.055555556,-0.009259259
2016.0,BDI,130,130,12,4,8,0.03076923,0.092307694,0.06153846
2017.0,BDI,143,143,10,6,4,0.04195804,0.06993007,0.027972028
2018.0,BDI,166,166,16,3,13,0.018072288,0.09638554,0.078313254
2019.0,BDI,191,191,20,8,12,0.041884817,0.10471204,0.06282722
2020.0,BDI,193,193,11,11,0,0.05699482,0.05699482,0.0
2021.0,BDI,189,189,13,9,4,0.04761905,0.06878307,0.02116402
2022.0,BDI,0,0,11,6,5,,,
1996.0,BEL,16938,16938,0,0,0,0.0,0.0,0.0
1997.0,BEL,19468,19468,509,523,-14,0.026864598,0.02614547,-0.0007191288
1998.0,BEL,21829,21829,574,606,-32,0.027761236,0.026295295,-0.0014659398
1999.0,BEL,23688,23688,635,722,-87,0.030479567,0.026806822,-0.0036727458
2000.0,BEL,25436,25436,805,845,-40,0.033220634,0.03164806,-0.0015725743
2001.0,BEL,26858,26858,983,890,93,0.03313724,0.036599897,0.0034626555
2002.0,BEL,28284,28284,967,1056,-89,0.037335597,0.03418894,-0.0031466554
2003.0,BEL,29671,29671,911,1016,-105,0.03424219,0.03070338,-0.003538809
2004.0,BEL,31089,31089,711,844,-133,0.027147865,0.022869825,-0.0042780405
2005.0,BEL,32740,32740,816,845,-29,0.025809407,0.024923641,-0.00088576664
2006.0,BEL,34488,34488,815,906,-91,0.026270008,0.023631409,-0.002638599
2007.0,BEL,36509,36509,881,928,-47,0.02541839,0.024131035,-0.0012873538
2008.0,BEL,38273,38273,991,1017,-26,0.026572257,0.025892926,-0.0006793301
2009.0,BEL,40291,40291,1149,1022,127,0.025365466,0.028517535,0.0031520687
2010.0,BEL,42253,42253,1206,1217,-11,0.02880269,0.028542353,-0.00026033656
2011.0,BEL,44314,44314,1260,1246,14,0.028117524,0.028433451,0.00031592726
2012.0,BEL,46336,46336,1313,1297,16,0.027991194,0.028336499,0.00034530388
2013.0,BEL,48422,48422,1494,1393,101,0.028767915,0.030853745,0.0020858287
2014.0,BEL,50343,50343,1553,1578,-25,0.031344973,0.03084838,-0.00049659336
2015.0,BEL,52010,52010,1613,1605,8,0.03085945,0.031013267,0.00015381657
2016.0,BEL,53412,53412,1701,1779,-78,0.03330712,0.031846777,-0.001460346
2017.0,BEL,54351,54351,1725,1906,-181,0.03506835,0.031738147,-0.0033302056
2018.0,BEL,55555,55555,1831,1986,-155,0.03574836,0.03295833,-0.002790028
2019.0,BEL,56342,56342,1924,1911,13,0.03391786,0.034148593,0.00023073373
2020.0,BEL,56136,56136,2038,1977,61,0.03521804,0.03630469,0.0010866467
2021.0,BEL,53776,53776,2061,1881,180,0.03497843,0.03832565,0.003347218
2022.0,BEL,0,0,1712,1581,131,,,
2023.0,BEL,0,0,1109,986,123,,,
1996.0,BEN,140,140,0,0,0,0.0,0.0,0.0
1997.0,BEN,172,172,5,2,3,0.011627907,0.029069768,0.017441861
1998.0,BEN,192,192,5,13,-8,0.067708336,0.026041666,-0.041666668
1999.0,BEN,199,199,10,9,1,0.04522613,0.050251257,0.0050251256
2000.0,BEN,209,209,8,12,-4,0.057416268,0.03827751,-0.019138755
2001.0,BEN,218,218,17,29,-12,0.13302752,0.07798165,-0.055045873
2002.0,BEN,261,261,24,16,8,0.06130268,0.09195402,0.03065134
2003.0,BEN,308,308,34,14,20,0.045454547,0.11038961,0.064935066
2004.0,BEN,355,355,24,21,3,0.059154928,0.06760564,0.008450705
2005.0,BEN,430,430,41,15,26,0.034883723,0.095348835,0.060465116
2006.0,BEN,480,480,32,22,10,0.045833334,0.06666667,0.020833334
2007.0,BEN,527,527,25,20,5,0.037950665,0.04743833,0.009487666
2008.0,BEN,576,576,27,24,3,0.041666668,0.046875,0.0052083335
2009.0,BEN,661,661,44,33,11,0.04992436,0.06656581,0.016641453
2010.0,BEN,774,774,32,23,9,0.029715762,0.04134367,0.011627907
2011.0,BEN,899,899,44,29,15,0.032258064,0.04894327,0.016685206
2012.0,BEN,971,971,42,43,-1,0.044284243,0.043254375,-0.0010298662
2013.0,BEN,1086,1086,34,37,-3,0.03406998,0.031307552,-0.002762431
2014.0,BEN,1162,1162,44,38,6,0.032702237,0.03786575,0.0051635113
2015.0,BEN,1264,1264,57,44,13,0.034810126,0.045094937,0.01028481
2016.0,BEN,1381,1381,51,38,13,0.027516292,0.03692976,0.009413469
2017.0,BEN,1524,1524,50,70,-20,0.04593176,0.0328084,-0.0131233595
2018.0,BEN,1646,1646,74,68,6,0.041312274,0.044957474,0.0036452005
2019.0,BEN,1739,1739,56,70,-14,0.04025302,0.032202415,-0.008050604
2020.0,BEN,1793,1793,61,50,11,0.027886225,0.034021195,0.006134969
2021.0,BEN,1741,1741,54,61,-7,0.035037335,0.031016657,-0.004020678
2022.0,BEN,0,0,50,44,6,,,
2023.0,BEN,0,0,31,26,5,,,
1996.0,BFA,229,229,0,0,0,0.0,0.0,0.0
1997.0,BFA,280,280,9,6,3,0.021428572,0.03214286,0.010714286
1998.0,BFA,317,317,18,13,5,0.041009463,0.056782335,0.01577287
1999.0,BFA,355,355,18,19,-1,0.053521127,0.050704226,-0.0028169013
2000.0,BFA,409,409,33,23,10,0.056234717,0.080684595,0.024449877
2001.0,BFA,429,429,22,18,4,0.04195804,0.051282052,0.0093240095
2002.0,BFA,458,458,32,17,15,0.037117902,0.069869,0.03275109
2003.0,BFA,498,498,35,28,7,0.0562249,0.070281126,0.014056225
2004.0,BFA,543,543,20,28,-8,0.05156538,0.03683241,-0.014732965
2005.0,BFA,585,585,24,25,-1,0.042735044,0.041025642,-0.0017094017
2006.0,BFA,651,651,27,36,-9,0.05529954,0.041474655,-0.013824885
2007.0,BFA,756,756,45,25,20,0.033068784,0.05952381,0.026455026
2008.0,BFA,844,844,36,28,8,0.033175357,0.04265403,0.009478673
2009.0,BFA,938,938,45,23,22,0.024520256,0.047974415,0.023454158
2010.0,BFA,1047,1047,41,37,4,0.035339065,0.039159503,0.0038204393
2011.0,BFA,1122,1122,42,50,-8,0.04456328,0.037433155,-0.0071301246
2012.0,BFA,1240,1240,55,46,9,0.037096772,0.044354837,0.0072580646
2013.0,BFA,1370,1370,70,48,22,0.035036497,0.05109489,0.016058395
2014.0,BFA,1480,1480,60,45,15,0.030405406,0.04054054,0.010135135
2015.0,BFA,1521,1521,57,86,-29,0.05654175,0.037475344,-0.019066405
2016.0,BFA,1611,1611,60,52,8,0.032278087,0.037243947,0.00496586
2017.0,BFA,1747,1747,67,65,2,0.03720664,0.03835146,0.0011448197
2018.0,BFA,1851,1851,73,61,12,0.03295516,0.039438143,0.006482982
2019.0,BFA,1989,1989,75,50,25,0.02513826,0.037707392,0.01256913
2020.0,BFA,2065,2065,70,43,27,0.020823244,0.033898305,0.01307506
2021.0,BFA,2047,2047,71,53,18,0.025891548,0.034684904,0.008793356
2022.0,BFA,0,0,52,45,7,,,
1996.0,BGD,1082,1082,0,0,0,0.0,0.0,0.0
1997.0,BGD,1323,1323,44,37,7,0.027966741,0.03325775,0.005291005
1998.0,BGD,1564,1564,45,53,-8,0.03388747,0.028772378,-0.0051150895
1999.0,BGD,1733,1733,74,50,24,0.028851703,0.042700518,0.013848817
2000.0,BGD,1856,1856,58,97,-39,0.052262932,0.03125,-0.02101293
2001.0,BGD,2031,2031,79,77,2,0.037912358,0.038897093,0.0009847366
2002.0,BGD,2218,2218,84,92,-8,0.04147881,0.037871957,-0.003606853
2003.0,BGD,2397,2397,84,98,-14,0.04088444,0.035043806,-0.005840634
2004.0,BGD,2723,2723,79,89,-10,0.03268454,0.02901212,-0.00367242
2005.0,BGD,3153,3153,124,106,18,0.033618774,0.039327625,0.0057088486
2006.0,BGD,3541,3541,94,107,-13,0.030217452,0.026546173,-0.0036712794
2007.0,BGD,4052,4052,138,126,12,0.031095754,0.034057256,0.0029615005
2008.0,BGD,4602,4602,131,178,-47,0.038678836,0.028465884,-0.010212951
2009.0,BGD,5210,5210,155,201,-46,0.038579654,0.02975048,-0.008829175
2010.0,BGD,5861,5861,165,206,-41,0.035147585,0.028152192,-0.0069953934
2011.0,BGD,6548,6548,217,266,-49,0.04062309,0.03313989,-0.007483201
2012.0,BGD,7327,7327,261,286,-25,0.03903371,0.035621673,-0.0034120376
2013.0,BGD,8079,8079,264,292,-28,0.036143087,0.03267731,-0.0034657754
2014.0,BGD,8720,8720,297,361,-64,0.041399084,0.034059633,-0.0073394496
2015.0,BGD,9264,9264,322,395,-73,0.042638168,0.034758203,-0.007879965
2016.0,BGD,9869,9869,332,445,-113,0.045090687,0.033640694,-0.0114499945
2017.0,BGD,10975,10975,434,476,-42,0.043371297,0.03954442,-0.0038268792
2018.0,BGD,12745,12745,480,527,-47,0.04134955,0.037661828,-0.0036877207
2019.0,BGD,15052,15052,549,504,45,0.033483922,0.036473557,0.002989636
2020.0,BGD,16449,16449,619,601,18,0.036537174,0.037631467,0.0010942915
2021.0,BGD,16348,16348,657,621,36,0.037986297,0.040188402,0.0022021043
2022.0,BGD,0,0,559,632,-73,,,
2023.0,BGD,0,0,354,443,-89,,,
1996.0,BGR,4171,4171,0,0,0,0.0,0.0,0.0
1997.0,BGR,4798,4798,84,90,-6,0.018757816,0.017507294,-0.001250521
1998.0,BGR,5285,5285,82,132,-50,0.024976349,0.015515611,-0.009460738
1999.0,BGR,5481,5481,83,161,-78,0.029374203,0.015143222,-0.01423098
2000.0,BGR,5534,5534,111,161,-50,0.02909288,0.020057824,-0.009035056
2001.0,BGR,5545,5545,112,242,-130,0.043642923,0.020198377,-0.023444545
2002.0,BGR,5639,5639,129,167,-38,0.02961518,0.022876397,-0.0067387833
2003.0,BGR,5703,5703,127,168,-41,0.02945818,0.02226898,-0.007189199
2004.0,BGR,5886,5886,105,133,-28,0.02259599,0.01783894,-0.0047570504
2005.0,BGR,6234,6234,104,107,-3,0.01716394,0.016682709,-0.00048123195
2006.0,BGR,6504,6504,93,141,-48,0.021678967,0.014298893,-0.007380074
2007.0,BGR,7019,7019,120,90,30,0.012822339,0.017096452,0.004274113
2008.0,BGR,7286,7286,115,108,7,0.014822948,0.015783696,0.00096074666
2009.0,BGR,7510,7510,103,98,5,0.013049267,0.013715046,0.00066577893
2010.0,BGR,7811,7811,91,135,-44,0.017283319,0.011650237,-0.005633082
2011.0,BGR,8157,8157,111,107,4,0.013117568,0.013607944,0.0004903764
2012.0,BGR,8343,8343,97,107,-10,0.012825123,0.011626514,-0.0011986096
2013.0,BGR,8559,8559,94,95,-1,0.011099428,0.010982592,-0.000116836076
2014.0,BGR,8805,8805,87,116,-29,0.013174333,0.0098807495,-0.0032935832
2015.0,BGR,9062,9062,102,93,9,0.010262636,0.011255793,0.0009931582
2016.0,BGR,9459,9459,91,82,9,0.008668993,0.009620467,0.00095147477
2017.0,BGR,9750,9750,103,85,18,0.008717949,0.010564103,0.0018461539
2018.0,BGR,10088,10088,117,82,35,0.00812847,0.011597938,0.0034694686
2019.0,BGR,10322,10322,104,96,8,0.009300523,0.010075566,0.0007750436
2020.0,BGR,10370,10370,109,99,10,0.00954677,0.01051109,0.00096432015
2021.0,BGR,9972,9972,94,77,17,0.0077216206,0.009426394,0.0017047734
2022.0,BGR,0,0,59,52,7,,,
2023.0,BGR,0,0,28,36,-8,,,
1996.0,BHR,174,174,0,0,0,0.0,0.0,0.0
1997.0,BHR,203,203,8,11,-3,0.054187194,0.039408866,-0.014778325
1998.0,BHR,230,230,14,15,-1,0.06521739,0.060869563,-0.004347826
1999.0,BHR,240,240,14,11,3,0.045833334,0.058333334,0.0125
2000.0,BHR,242,242,8,13,-5,0.053719006,0.03305785,-0.020661157
2001.0,BHR,272,272,11,5,6,0.018382354,0.040441178,0.022058824
2002.0,BHR,285,285,17,10,7,0.03508772,0.05964912,0.024561403
2003.0,BHR,329,329,20,7,13,0.021276595,0.060790274,0.039513677
2004.0,BHR,364,364,18,12,6,0.032967035,0.04945055,0.016483517
2005.0,BHR,398,398,20,11,9,0.027638191,0.050251257,0.022613065
2006.0,BHR,450,450,20,7,13,0.015555556,0.044444446,0.028888889
2007.0,BHR,472,472,21,9,12,0.019067796,0.044491526,0.025423728
2008.0,BHR,474,474,24,21,3,0.044303797,0.050632913,0.006329114
2009.0,BHR,486,486,19,16,3,0.03292181,0.03909465,0.0061728396
2010.0,BHR,517,517,28,15,13,0.029013539,0.054158606,0.025145067
2011.0,BHR,573,573,29,16,13,0.027923211,0.05061082,0.022687608
2012.0,BHR,617,617,30,22,8,0.035656404,0.048622366,0.012965964
2013.0,BHR,654,654,31,21,10,0.03211009,0.047400612,0.01529052
2014.0,BHR,703,703,28,33,-5,0.04694168,0.039829303,-0.0071123755
2015.0,BHR,816,816,46,27,19,0.033088237,0.05637255,0.023284314
2016.0,BHR,928,928,54,28,26,0.030172413,0.058189657,0.028017242
2017.0,BHR,1040,1040,50,27,23,0.025961539,0.048076924,0.022115385
2018.0,BHR,1206,1206,61,28,33,0.023217248,0.05058043,0.027363185
2019.0,BHR,1298,1298,56,47,9,0.036209553,0.0431433,0.006933744
2020.0,BHR,1350,1350,67,53,14,0.03925926,0.04962963,0.01037037
2021.0,BHR,1327,1327,77,52,25,0.039186135,0.05802562,0.018839488
2022.0,BHR,0,0,70,56,14,,,
1996.0,BHS,7,7,0,0,0,0.0,0.0,0.0
1997.0,BHS,11,11,1,0,1,0.0,0.09090909,0.09090909
1998.0,BHS,10,10,0,1,-1,0.1,0.0,-0.1
1999.0,BHS,12,12,1,0,1,0.0,0.083333336,0.083333336
2001.0,BHS,15,15,1,0,1,0.0,0.06666667,0.06666667
2002.0,BHS,14,14,1,3,-2,0.21428572,0.071428575,-0.14285715
2003.0,BHS,19,19,2,2,0,0.10526316,0.10526316,0.0
2004.0,BHS,25,25,1,0,1,0.0,0.04,0.04
2005.0,BHS,31,31,2,1,1,0.032258064,0.06451613,0.032258064
2006.0,BHS,37,37,2,1,1,0.027027028,0.054054055,0.027027028
2007.0,BHS,39,39,3,1,2,0.025641026,0.07692308,0.051282052
2008.0,BHS,37,37,2,2,0,0.054054055,0.054054055,0.0
2009.0,BHS,40,40,3,4,-1,0.1,0.075,-0.025
2010.0,BHS,44,44,4,5,-1,0.11363637,0.09090909,-0.022727273
2011.0,BHS,61,61,4,4,0,0.06557377,0.06557377,0.0
2012.0,BHS,69,69,3,4,-1,0.057971016,0.04347826,-0.014492754
2013.0,BHS,82,82,5,4,1,0.048780486,0.06097561,0.0121951215
2014.0,BHS,87,87,6,3,3,0.03448276,0.06896552,0.03448276
2015.0,BHS,94,94,12,6,6,0.06382979,0.12765957,0.06382979
2016.0,BHS,88,88,7,9,-2,0.10227273,0.07954545,-0.022727273
2017.0,BHS,86,86,6,5,1,0.058139537,0.069767445,0.011627907
2018.0,BHS,90,90,6,5,1,0.055555556,0.06666667,0.011111111
2019.0,BHS,96,96,11,4,7,0.041666668,0.114583336,0.072916664
2020.0,BHS,94,94,13,9,4,0.095744684,0.13829787,0.04255319
2021.0,BHS,89,89,6,6,0,0.06741573,0.06741573,0.0
2022.0,BHS,0,0,2,9,-7,,,
1996.0,BIH,99,99,0,0,0,0.0,0.0,0.0
1997.0,BIH,169,169,5,5,0,0.0295858,0.0295858,0.0
1998.0,BIH,221,221,9,8,1,0.036199097,0.040723983,0.004524887
1999.0,BIH,277,277,16,6,10,0.02166065,0.057761732,0.036101084
2000.0,BIH,340,340,18,14,4,0.04117647,0.052941177,0.011764706
2001.0,BIH,422,422,13,10,3,0.023696683,0.030805686,0.0071090045
2002.0,BIH,542,542,23,24,-1,0.044280443,0.042435423,-0.0018450185
2003.0,BIH,666,666,30,8,22,0.012012012,0.045045044,0.033033032
2004.0,BIH,825,825,44,11,33,0.013333334,0.053333335,0.04
2005.0,BIH,994,994,48,29,19,0.02917505,0.04828974,0.019114688
2006.0,BIH,1213,1213,51,23,28,0.018961253,0.042044517,0.023083264
2007.0,BIH,1439,1439,47,32,15,0.022237666,0.032661572,0.010423905
2008.0,BIH,1638,1638,51,29,22,0.017704519,0.031135531,0.013431014
2009.0,BIH,1802,1802,31,33,-2,0.018312985,0.017203107,-0.001109878
2010.0,BIH,1956,1956,34,24,10,0.012269938,0.017382413,0.0051124743
2011.0,BIH,2165,2165,58,31,27,0.0143187065,0.026789838,0.012471132
2012.0,BIH,2337,2337,62,37,25,0.015832264,0.026529739,0.010697476
2013.0,BIH,2475,2475,51,33,18,0.013333334,0.020606061,0.0072727273
2014.0,BIH,2550,2550,35,59,-24,0.023137255,0.01372549,-0.009411764
2015.0,BIH,2738,2738,64,36,28,0.013148284,0.023374727,0.0102264425
2016.0,BIH,2987,2987,59,58,1,0.019417476,0.01975226,0.00033478407
2017.0,BIH,3297,3297,68,40,28,0.012132241,0.02062481,0.008492569
2018.0,BIH,3515,3515,69,52,17,0.0147937415,0.019630156,0.0048364154
2019.0,BIH,3698,3698,66,56,10,0.015143321,0.017847486,0.0027041645
2020.0,BIH,3734,3734,59,66,-7,0.017675415,0.01580075,-0.0018746653
2021.0,BIH,3638,3638,64,63,1,0.017317208,0.017592084,0.0002748763
2022.0,BIH,0,0,32,42,-10,,,
1996.0,BLR,2337,2337,0,0,0,0.0,0.0,0.0
1997.0,BLR,2698,2698,57,49,8,0.0181616,0.02112676,0.0029651595
1998.0,BLR,2990,2990,67,79,-12,0.026421405,0.022408027,-0.0040133777
1999.0,BLR,3201,3201,51,84,-33,0.0262418,0.01593252,-0.010309278
2000.0,BLR,3299,3299,58,86,-28,0.026068505,0.017581085,-0.00848742
2001.0,BLR,3392,3392,76,106,-30,0.03125,0.02240566,-0.008844339
2002.0,BLR,3447,3447,86,122,-36,0.035393097,0.024949232,-0.010443864
2003.0,BLR,3456,3456,64,100,-36,0.028935185,0.018518519,-0.010416667
2004.0,BLR,3492,3492,52,61,-9,0.017468499,0.01489118,-0.0025773195
2005.0,BLR,3501,3501,56,64,-8,0.018280491,0.01599543,-0.0022850614
2006.0,BLR,3476,3476,49,64,-15,0.018411968,0.014096662,-0.004315305
2007.0,BLR,3518,3518,38,70,-32,0.01989767,0.010801592,-0.009096078
2008.0,BLR,3519,3519,51,76,-25,0.021597045,0.014492754,-0.007104291
2009.0,BLR,3541,3541,57,57,0,0.016097147,0.016097147,0.0
2010.0,BLR,3548,3548,62,70,-8,0.019729424,0.017474633,-0.0022547913
2011.0,BLR,3645,3645,41,58,-17,0.015912209,0.011248285,-0.0046639233
2012.0,BLR,3699,3699,53,59,-6,0.015950257,0.014328197,-0.00162206
2013.0,BLR,3755,3755,54,68,-14,0.018109187,0.014380826,-0.0037283623
2014.0,BLR,3877,3877,52,58,-6,0.014960021,0.013412433,-0.0015475884
2015.0,BLR,3963,3963,44,73,-29,0.018420389,0.0111027,-0.007317689
2016.0,BLR,4091,4091,47,65,-18,0.015888536,0.011488633,-0.004399902
2017.0,BLR,4532,4532,60,56,4,0.012356576,0.013239188,0.00088261254
2018.0,BLR,4723,4723,51,60,-9,0.01270379,0.010798221,-0.0019055685
2019.0,BLR,4923,4923,44,77,-33,0.01564087,0.00893764,-0.0067032296
2020.0,BLR,4914,4914,56,62,-6,0.0126170125,0.011396011,-0.0012210013
2021.0,BLR,4734,4734,55,61,-6,0.012885509,0.011618082,-0.0012674271
2022.0,BLR,0,0,27,71,-44,,,
1996.0,BLZ,10,10,0,0,0,0.0,0.0,0.0
1997.0,BLZ,13,13,1,0,1,0.0,0.07692308,0.07692308
1998.0,BLZ,13,13,1,2,-1,0.15384616,0.07692308,-0.07692308
1999.0,BLZ,11,11,1,3,-2,0.27272728,0.09090909,-0.18181819
2000.0,BLZ,12,12,0,2,-2,0.16666667,0.0,-0.16666667
2001.0,BLZ,18,18,1,0,1,0.0,0.055555556,0.055555556
2002.0,BLZ,23,23,2,1,1,0.04347826,0.08695652,0.04347826
2003.0,BLZ,27,27,2,2,0,0.074074075,0.074074075,0.0
2004.0,BLZ,33,33,3,3,0,0.09090909,0.09090909,0.0
2005.0,BLZ,32,32,0,2,-2,0.0625,0.0,-0.0625
2006.0,BLZ,36,36,2,2,0,0.055555556,0.055555556,0.0
2007.0,BLZ,34,34,1,2,-1,0.05882353,0.029411765,-0.029411765
2008.0,BLZ,38,38,2,1,1,0.02631579,0.05263158,0.02631579
2009.0,BLZ,41,41,5,0,5,0.0,0.12195122,0.12195122
2010.0,BLZ,45,45,2,0,2,0.0,0.044444446,0.044444446
2011.0,BLZ,49,49,6,5,1,0.10204082,0.12244898,0.020408163
2012.0,BLZ,51,51,4,4,0,0.078431375,0.078431375,0.0
2013.0,BLZ,48,48,3,3,0,0.0625,0.0625,0.0
2014.0,BLZ,59,59,4,3,1,0.050847456,0.06779661,0.016949153
2015.0,BLZ,65,65,2,3,-1,0.046153847,0.03076923,-0.015384615
2016.0,BLZ,65,65,4,5,-1,0.07692308,0.06153846,-0.015384615
2017.0,BLZ,85,85,12,1,11,0.011764706,0.14117648,0.12941177
2018.0,BLZ,97,97,8,6,2,0.06185567,0.082474224,0.020618556
2019.0,BLZ,98,98,4,8,-4,0.08163265,0.040816326,-0.040816326
2020.0,BLZ,95,95,4,4,0,0.042105265,0.042105265,0.0
2021.0,BLZ,95,95,6,6,0,0.06315789,0.06315789,0.0
2022.0,BLZ,0,0,5,5,0,,,
1996.0,BMU,11,11,0,0,0,0.0,0.0,0.0
1997.0,BMU,13,13,2,0,2,0.0,0.15384616,0.15384616
1998.0,BMU,20,20,0,0,0,0.0,0.0,0.0
2000.0,BMU,34,34,3,3,0,0.0882353,0.0882353,0.0
2001.0,BMU,31,31,3,6,-3,0.19354838,0.09677419,-0.09677419
2002.0,BMU,36,36,7,5,2,0.1388889,0.19444445,0.055555556
2003.0,BMU,35,35,2,7,-5,0.2,0.057142857,-0.14285715
2004.0,BMU,60,60,2,3,-1,0.05,0.033333335,-0.016666668
2005.0,BMU,63,63,5,6,-1,0.0952381,0.07936508,-0.015873017
2006.0,BMU,74,74,7,0,7,0.0,0.0945946,0.0945946
2007.0,BMU,53,53,8,30,-22,0.5660377,0.1509434,-0.41509435
2008.0,BMU,55,55,2,4,-2,0.07272727,0.036363635,-0.036363635
2010.0,BMU,53,53,4,4,0,0.0754717,0.0754717,0.0
2011.0,BMU,49,49,5,6,-1,0.12244898,0.10204082,-0.020408163
2012.0,BMU,56,56,7,2,5,0.035714287,0.125,0.08928572
2013.0,BMU,57,57,5,8,-3,0.14035088,0.0877193,-0.05263158
2014.0,BMU,55,55,3,8,-5,0.14545454,0.054545455,-0.09090909
2015.0,BMU,46,46,1,8,-7,0.17391305,0.02173913,-0.1521739
2016.0,BMU,50,50,3,3,0,0.06,0.06,0.0
2018.0,BMU,57,57,2,4,-2,0.07017544,0.03508772,-0.03508772
2019.0,BMU,64,64,6,3,3,0.046875,0.09375,0.046875
2020.0,BMU,63,63,10,11,-1,0.17460318,0.15873016,-0.015873017
2021.0,BMU,67,67,11,6,5,0.08955224,0.1641791,0.07462686
2022.0,BMU,0,0,5,16,-11,,,
1996.0,BOL,135,135,0,0,0,0.0,0.0,0.0
1997.0,BOL,175,175,5,7,-2,0.04,0.028571429,-0.011428571
1998.0,BOL,201,201,11,10,1,0.049751244,0.05472637,0.0049751243
1999.0,BOL,224,224,10,3,7,0.013392857,0.04464286,0.03125
2000.0,BOL,237,237,13,18,-5,0.07594936,0.05485232,-0.021097047
2001.0,BOL,240,240,12,13,-1,0.054166667,0.05,-0.004166667
2002.0,BOL,255,255,23,20,3,0.078431375,0.09019608,0.011764706
2003.0,BOL,276,276,17,22,-5,0.07971015,0.061594203,-0.018115941
2004.0,BOL,296,296,11,16,-5,0.054054055,0.037162162,-0.016891891
2005.0,BOL,348,348,16,20,-4,0.057471264,0.04597701,-0.011494253
2006.0,BOL,396,396,20,13,7,0.032828283,0.05050505,0.017676767
2007.0,BOL,422,422,9,20,-11,0.047393367,0.021327015,-0.02606635
2008.0,BOL,467,467,33,21,12,0.04496788,0.07066381,0.025695931
2009.0,BOL,499,499,19,24,-5,0.04809619,0.03807615,-0.01002004
2010.0,BOL,511,511,28,27,1,0.052837573,0.05479452,0.0019569471
2011.0,BOL,540,540,31,25,6,0.046296295,0.05740741,0.011111111
2012.0,BOL,562,562,20,26,-6,0.046263345,0.035587188,-0.010676157
2013.0,BOL,609,609,30,20,10,0.03284072,0.049261082,0.01642036
2014.0,BOL,612,612,22,26,-4,0.04248366,0.035947714,-0.006535948
2015.0,BOL,643,643,32,26,6,0.04043546,0.04976672,0.00933126
2016.0,BOL,670,670,27,26,1,0.03880597,0.040298507,0.0014925373
2017.0,BOL,725,725,45,21,24,0.028965518,0.062068965,0.033103447
2018.0,BOL,762,762,43,34,9,0.044619422,0.056430448,0.011811024
2019.0,BOL,823,823,45,22,23,0.02673147,0.054678008,0.027946537
2020.0,BOL,841,841,45,35,10,0.04161712,0.05350773,0.011890606
2021.0,BOL,787,787,32,38,-6,0.048284624,0.040660735,-0.007623888
2022.0,BOL,0,0,25,29,-4,,,
1996.0,BRA,25385,25385,0,0,0,0.0,0.0,0.0
1997.0,BRA,31647,31647,541,351,190,0.011091099,0.017094828,0.0060037286
1998.0,BRA,38076,38076,659,476,183,0.012501313,0.01730749,0.004806177
1999.0,BRA,43768,43768,722,548,174,0.012520563,0.01649607,0.0039755073
2000.0,BRA,49851,49851,793,649,144,0.013018796,0.015907405,0.002888608
2001.0,BRA,55623,55623,859,772,87,0.013879151,0.0154432515,0.0015641012
2002.0,BRA,62522,62522,926,812,114,0.012987428,0.014810787,0.0018233581
2003.0,BRA,70098,70098,886,785,101,0.011198607,0.012639448,0.00144084
2004.0,BRA,82099,82099,771,747,24,0.009098771,0.009391101,0.00029233
2005.0,BRA,94768,94768,807,793,14,0.008367804,0.008515533,0.0001477292
2006.0,BRA,108995,108995,883,781,102,0.0071654664,0.008101289,0.0009358227
2007.0,BRA,123857,123857,912,939,-27,0.007581324,0.00736333,-0.00021799334
2008.0,BRA,138376,138376,936,1072,-136,0.007747008,0.0067641786,-0.0009828294
2009.0,BRA,152915,152915,1050,1182,-132,0.0077297846,0.00686656,-0.0008632247
2010.0,BRA,168955,168955,1167,1213,-46,0.0071794265,0.0069071646,-0.00027226185
2011.0,BRA,184065,184065,1299,1227,72,0.0066661234,0.0070572896,0.00039116616
2012.0,BRA,198719,198719,1413,1202,211,0.006048742,0.007110543,0.0010618009
2013.0,BRA,212914,212914,1367,1360,7,0.0063875555,0.0064204326,3.2877124e-05
2014.0,BRA,227483,227483,1597,1576,21,0.0069279904,0.007020305,9.231459e-05
2015.0,BRA,241588,241588,1773,1782,-9,0.007376194,0.0073389406,-3.7253507e-05
2016.0,BRA,256208,256208,1902,1973,-71,0.0077007744,0.0074236556,-0.00027711858
2017.0,BRA,270933,270933,1880,2203,-323,0.008131161,0.006938985,-0.0011921767
2018.0,BRA,285435,285435,1870,2446,-576,0.008569377,0.006551404,-0.0020179725
2019.0,BRA,294515,294515,1742,2593,-851,0.008804305,0.005914809,-0.0028894963
2020.0,BRA,292965,292965,1726,2993,-1267,0.010216237,0.005891489,-0.0043247486
2021.0,BRA,278786,278786,1713,2945,-1232,0.010563659,0.006144498,-0.00441916
2022.0,BRA,0,0,1387,2371,-984,,,
2023.0,BRA,0,0,802,1600,-798,,,
1996.0,BRB,62,62,0,0,0,0.0,0.0,0.0
1997.0,BRB,72,72,6,3,3,0.041666668,0.083333336,0.041666668
1998.0,BRB,82,82,5,6,-1,0.07317073,0.06097561,-0.0121951215
1999.0,BRB,79,79,2,6,-4,0.07594936,0.025316456,-0.050632913
2000.0,BRB,91,91,7,4,3,0.043956045,0.07692308,0.032967035
2001.0,BRB,96,96,11,6,5,0.0625,0.114583336,0.052083332
2002.0,BRB,106,106,4,9,-5,0.08490566,0.03773585,-0.047169812
2003.0,BRB,116,116,9,5,4,0.04310345,0.077586204,0.03448276
2004.0,BRB,134,134,12,5,7,0.03731343,0.08955224,0.052238807
2005.0,BRB,146,146,15,8,7,0.05479452,0.10273973,0.047945205
2006.0,BRB,167,167,6,10,-4,0.059880238,0.035928145,-0.023952097
2007.0,BRB,178,178,12,7,5,0.039325844,0.06741573,0.028089888
2008.0,BRB,189,189,10,8,2,0.04232804,0.052910052,0.01058201
2009.0,BRB,175,175,9,10,-1,0.057142857,0.05142857,-0.0057142857
2010.0,BRB,179,179,12,11,1,0.061452515,0.06703911,0.005586592
2011.0,BRB,192,192,26,5,21,0.026041666,0.13541667,0.109375
2012.0,BRB,198,198,20,12,8,0.060606062,0.1010101,0.04040404
2013.0,BRB,226,226,15,9,6,0.03982301,0.06637168,0.026548672
2014.0,BRB,235,235,14,15,-1,0.06382979,0.05957447,-0.004255319
2015.0,BRB,233,233,9,13,-4,0.055793993,0.03862661,-0.017167382
2016.0,BRB,241,241,19,16,3,0.066390045,0.07883818,0.012448133
2017.0,BRB,237,237,10,18,-8,0.07594936,0.042194095,-0.033755273
2018.0,BRB,245,245,15,17,-2,0.06938776,0.06122449,-0.008163265
2019.0,BRB,267,267,21,11,10,0.041198503,0.07865169,0.037453182
2020.0,BRB,270,270,12,7,5,0.025925925,0.044444446,0.018518519
2021.0,BRB,260,260,17,7,10,0.026923077,0.06538462,0.03846154
2022.0,BRB,0,0,8,11,-3,,,
1996.0,BRN,54,54,0,0,0,0.0,0.0,0.0
1997.0,BRN,66,66,8,6,2,0.09090909,0.121212125,0.030303031
1998.0,BRN,75,75,6,5,1,0.06666667,0.08,0.013333334
1999.0,BRN,78,78,8,8,0,0.102564104,0.102564104,0.0
2000.0,BRN,76,76,5,10,-5,0.13157895,0.065789476,-0.065789476
2001.0,BRN,79,79,11,6,5,0.07594936,0.1392405,0.06329114
2002.0,BRN,83,83,13,9,4,0.10843374,0.15662651,0.04819277
2003.0,BRN,95,95,10,3,7,0.031578947,0.10526316,0.07368421
2004.0,BRN,93,93,8,7,1,0.07526882,0.086021505,0.010752688
2005.0,BRN,97,97,7,6,1,0.06185567,0.072164945,0.010309278
2006.0,BRN,116,116,16,4,12,0.03448276,0.13793103,0.10344828
2007.0,BRN,117,117,9,10,-1,0.08547009,0.07692308,-0.008547009
2008.0,BRN,139,139,13,8,5,0.05755396,0.09352518,0.035971224
2009.0,BRN,176,176,12,11,1,0.0625,0.06818182,0.0056818184
2010.0,BRN,219,219,12,2,10,0.00913242,0.05479452,0.0456621
2011.0,BRN,274,274,30,15,15,0.054744527,0.10948905,0.054744527
2012.0,BRN,329,329,29,12,17,0.036474165,0.0881459,0.051671732
2013.0,BRN,388,388,40,21,19,0.05412371,0.10309278,0.04896907
2014.0,BRN,443,443,36,20,16,0.045146726,0.08126411,0.036117382
2015.0,BRN,519,519,51,18,33,0.03468208,0.098265894,0.06358381
2016.0,BRN,537,537,39,25,14,0.046554934,0.0726257,0.026070764
2017.0,BRN,589,589,47,24,23,0.040747028,0.07979626,0.039049234
2018.0,BRN,615,615,38,45,-7,0.07317073,0.06178862,-0.011382114
2019.0,BRN,653,653,32,29,3,0.044410415,0.049004596,0.0045941807
2020.0,BRN,669,669,46,38,8,0.056801196,0.068759345,0.0119581465
2021.0,BRN,676,676,43,28,15,0.041420117,0.063609466,0.022189349
2022.0,BRN,0,0,31,21,10,,,
2023.0,BRN,0,0,27,20,7,,,
1996.0,BTN,2,2,0,0,0,0.0,0.0,0.0
1997.0,BTN,4,4,1,0,1,0.0,0.25,0.25
1999.0,BTN,10,10,0,0,0,0.0,0.0,0.0
2000.0,BTN,15,15,0,0,0,0.0,0.0,0.0
2001.0,BTN,14,14,0,4,-4,0.2857143,0.0,-0.2857143
2002.0,BTN,19,19,0,0,0,0.0,0.0,0.0
2003.0,BTN,27,27,0,1,-1,0.037037037,0.0,-0.037037037
2004.0,BTN,42,42,0,0,0,0.0,0.0,0.0
2005.0,BTN,44,44,2,0,2,0.0,0.045454547,0.045454547
2006.0,BTN,48,48,2,2,0,0.041666668,0.041666668,0.0
2007.0,BTN,59,59,1,2,-1,0.033898305,0.016949153,-0.016949153
2008.0,BTN,66,66,1,2,-1,0.030303031,0.015151516,-0.015151516
2009.0,BTN,78,78,2,3,-1,0.03846154,0.025641026,-0.012820513
2010.0,BTN,81,81,2,4,-2,0.049382716,0.024691358,-0.024691358
2011.0,BTN,108,108,2,4,-2,0.037037037,0.018518519,-0.018518519
2012.0,BTN,120,120,7,4,3,0.033333335,0.058333334,0.025
2013.0,BTN,146,146,14,2,12,0.01369863,0.09589041,0.08219178
2014.0,BTN,179,179,9,6,3,0.033519555,0.05027933,0.016759777
2015.0,BTN,225,225,6,11,-5,0.04888889,0.026666667,-0.022222223
2016.0,BTN,264,264,7,3,4,0.011363637,0.026515152,0.015151516
2017.0,BTN,293,293,14,16,-2,0.054607507,0.04778157,-0.0068259384
2018.0,BTN,343,343,17,12,5,0.034985423,0.04956268,0.014577259
2019.0,BTN,386,386,19,21,-2,0.054404143,0.049222797,-0.005181347
2020.0,BTN,397,397,16,23,-7,0.057934508,0.040302265,-0.017632242
2021.0,BTN,414,414,30,22,8,0.053140096,0.072463766,0.019323671
2022.0,BTN,0,0,21,14,7,,,
2018.0,BVT,4,4,1,0,1,0.0,0.25,0.25
2019.0,BVT,3,3,1,2,-1,0.6666667,0.33333334,-0.33333334
1996.0,BWA,169,169,0,0,0,0.0,0.0,0.0
1997.0,BWA,220,220,8,9,-1,0.04090909,0.036363635,-0.0045454544
1998.0,BWA,279,279,8,5,3,0.017921148,0.028673835,0.010752688
1999.0,BWA,309,309,15,12,3,0.03883495,0.048543688,0.009708738
2000.0,BWA,356,356,22,11,11,0.030898876,0.061797753,0.030898876
2001.0,BWA,386,386,17,25,-8,0.06476684,0.04404145,-0.020725388
2002.0,BWA,418,418,20,12,8,0.028708134,0.04784689,0.019138755
2003.0,BWA,464,464,29,16,13,0.03448276,0.0625,0.028017242
2004.0,BWA,523,523,29,31,-2,0.05927342,0.05544933,-0.0038240917
2005.0,BWA,559,559,26,21,5,0.037567083,0.046511628,0.008944544
2006.0,BWA,584,584,33,29,4,0.049657535,0.05650685,0.006849315
2007.0,BWA,623,623,26,27,-1,0.043338683,0.041733548,-0.0016051364
2008.0,BWA,655,655,27,35,-8,0.053435113,0.041221373,-0.0122137405
2009.0,BWA,672,672,29,40,-11,0.05952381,0.04315476,-0.016369049
2010.0,BWA,696,696,41,30,11,0.04310345,0.058908045,0.015804598
2011.0,BWA,752,752,38,32,6,0.04255319,0.050531916,0.007978723
2012.0,BWA,805,805,47,38,9,0.047204968,0.058385093,0.011180124
2013.0,BWA,833,833,26,28,-2,0.033613447,0.031212484,-0.0024009603
2014.0,BWA,908,908,56,36,20,0.039647575,0.06167401,0.02202643
2015.0,BWA,1013,1013,59,52,7,0.051332675,0.058242843,0.0069101676
2016.0,BWA,1107,1107,61,39,22,0.035230353,0.055103883,0.019873532
2017.0,BWA,1170,1170,51,46,5,0.03931624,0.043589745,0.0042735045
2018.0,BWA,1242,1242,66,43,23,0.034621578,0.053140096,0.018518519
2019.0,BWA,1317,1317,64,53,11,0.040242977,0.04859529,0.008352316
2020.0,BWA,1344,1344,67,53,14,0.039434522,0.04985119,0.010416667
2021.0,BWA,1313,1313,59,46,13,0.035034273,0.044935264,0.00990099
2022.0,BWA,0,0,53,37,16,,,
1996.0,CAF,35,35,0,0,0,0.0,0.0,0.0
1997.0,CAF,39,39,1,3,-2,0.07692308,0.025641026,-0.051282052
1998.0,CAF,50,50,5,2,3,0.04,0.1,0.06
1999.0,CAF,39,39,1,10,-9,0.25641027,0.025641026,-0.23076923
2000.0,CAF,46,46,6,9,-3,0.19565217,0.13043478,-0.06521739
2001.0,CAF,46,46,1,6,-5,0.13043478,0.02173913,-0.10869565
2002.0,CAF,43,43,4,5,-1,0.11627907,0.093023255,-0.023255814
2003.0,CAF,63,63,10,3,7,0.04761905,0.15873016,0.11111111
2004.0,CAF,73,73,6,5,1,0.06849315,0.08219178,0.01369863
2005.0,CAF,87,87,10,1,9,0.011494253,0.11494253,0.10344828
2006.0,CAF,83,83,2,9,-7,0.10843374,0.024096385,-0.084337346
2007.0,CAF,78,78,9,10,-1,0.12820514,0.115384616,-0.012820513
2008.0,CAF,83,83,10,8,2,0.09638554,0.12048193,0.024096385
2009.0,CAF,90,90,9,6,3,0.06666667,0.1,0.033333335
2010.0,CAF,93,93,8,3,5,0.032258064,0.086021505,0.05376344
2011.0,CAF,108,108,12,6,6,0.055555556,0.11111111,0.055555556
2012.0,CAF,111,111,9,17,-8,0.15315315,0.08108108,-0.072072074
2013.0,CAF,119,119,9,9,0,0.075630255,0.075630255,0.0
2014.0,CAF,132,132,11,7,4,0.053030305,0.083333336,0.030303031
2015.0,CAF,151,151,14,7,7,0.046357617,0.09271523,0.046357617
2016.0,CAF,163,163,15,6,9,0.036809817,0.09202454,0.055214725
2017.0,CAF,152,152,8,18,-10,0.118421055,0.05263158,-0.065789476
2018.0,CAF,149,149,5,5,0,0.033557046,0.033557046,0.0
2019.0,CAF,148,148,12,7,5,0.0472973,0.08108108,0.033783782
2020.0,CAF,149,149,10,12,-2,0.08053691,0.06711409,-0.013422819
2021.0,CAF,144,144,13,2,11,0.013888889,0.090277776,0.07638889
2022.0,CAF,0,0,9,6,3,,,
1996.0,CAN,61186,61186,0,0,0,0.0,0.0,0.0
1997.0,CAN,69809,69809,1753,2052,-299,0.02939449,0.025111375,-0.0042831153
1998.0,CAN,77801,77801,2135,2555,-420,0.032840196,0.027441807,-0.005398388
1999.0,CAN,83140,83140,2367,2755,-388,0.03313688,0.02847005,-0.004666827
2000.0,CAN,87767,87767,2710,3014,-304,0.034340926,0.030877208,-0.0034637165
2001.0,CAN,92474,92474,3292,3424,-132,0.037026625,0.035599194,-0.0014274282
2002.0,CAN,98379,98379,3615,3413,202,0.034692362,0.036745645,0.0020532836
2003.0,CAN,104442,104442,3587,3353,234,0.032103945,0.03434442,0.002240478
2004.0,CAN,111105,111105,3362,2930,432,0.026371451,0.030259665,0.0038882138
2005.0,CAN,117893,117893,3450,2973,477,0.025217783,0.029263824,0.0040460415
2006.0,CAN,125281,125281,3654,3140,514,0.025063656,0.029166434,0.0041027768
2007.0,CAN,132909,132909,3878,3422,456,0.02574694,0.02917786,0.0034309188
2008.0,CAN,139625,139625,3967,3745,222,0.026821844,0.028411817,0.0015899731
2009.0,CAN,146053,146053,4008,3968,40,0.02716822,0.027442092,0.0002738732
2010.0,CAN,152272,152272,4387,4430,-43,0.029092677,0.028810287,-0.0002823894
2011.0,CAN,158624,158624,4458,4431,27,0.027933983,0.028104195,0.00017021384
2012.0,CAN,164910,164910,4523,4502,21,0.02729974,0.027427081,0.00012734218
2013.0,CAN,171947,171947,4720,4698,22,0.027322372,0.02745032,0.0001279464
2014.0,CAN,177796,177796,4850,4959,-109,0.027891517,0.027278453,-0.0006130622
2015.0,CAN,183262,183262,5087,5162,-75,0.028167324,0.027758073,-0.00040925015
2016.0,CAN,188351,188351,5180,5409,-229,0.02871766,0.027501846,-0.0012158152
2017.0,CAN,193550,193550,5302,5477,-175,0.028297598,0.027393438,-0.00090415915
2018.0,CAN,198528,198528,5507,5571,-64,0.028061533,0.02773916,-0.00032237265
2019.0,CAN,203093,203093,6192,5591,601,0.02752926,0.030488495,0.0029592353
2020.0,CAN,202216,202216,6250,5788,462,0.028622858,0.030907545,0.0022846856
2021.0,CAN,193101,193101,5861,5382,479,0.027871424,0.030351993,0.0024805672
2022.0,CAN,0,0,5165,4310,855,,,
2023.0,CAN,0,0,2997,2879,118,,,
1996.0,CCK,2,2,0,0,0,0.0,0.0,0.0
1998.0,CCK,2,2,0,0,0,0.0,0.0,0.0
2007.0,CCK,8,8,1,0,1,0.0,0.125,0.125
2009.0,CCK,10,10,3,0,3,0.0,0.3,0.3
2012.0,CCK,10,10,1,0,1,0.0,0.1,0.1
2015.0,CCK,13,13,1,1,0,0.07692308,0.07692308,0.0
2016.0,CCK,14,14,0,1,-1,0.071428575,0.0,-0.071428575
2017.0,CCK,12,12,0,2,-2,0.16666667,0.0,-0.16666667
2018.0,CCK,15,15,3,0,3,0.0,0.2,0.2
2022.0,CCK,0,0,1,1,0,,,
1996.0,CHE,21060,21060,0,0,0,0.0,0.0,0.0
1997.0,CHE,24196,24196,1155,1074,81,0.0443875,0.047735162,0.0033476609
1998.0,CHE,27266,27266,1355,1290,65,0.04731167,0.049695592,0.0023839213
1999.0,CHE,29480,29480,1438,1412,26,0.04789688,0.048778832,0.00088195386
2000.0,CHE,31438,31438,1590,1533,57,0.048762646,0.050575737,0.0018130924
2001.0,CHE,32695,32695,1811,1792,19,0.054809604,0.055390734,0.00058112864
2002.0,CHE,34781,34781,2043,1716,327,0.049337283,0.058738966,0.009401685
2003.0,CHE,36613,36613,2057,1729,328,0.047223665,0.05618223,0.008958567
2004.0,CHE,38733,38733,1951,1535,416,0.03963029,0.050370485,0.010740195
2005.0,CHE,40526,40526,1906,1586,320,0.03913537,0.047031537,0.007896165
2006.0,CHE,43036,43036,2078,1683,395,0.039106794,0.048285156,0.009178362
2007.0,CHE,45364,45364,2056,1827,229,0.040274225,0.04532228,0.0050480557
2008.0,CHE,47955,47955,2502,1942,560,0.040496297,0.052173913,0.011677614
2009.0,CHE,50536,50536,2588,2211,377,0.04375099,0.051211018,0.0074600284
2010.0,CHE,53185,53185,2773,2301,472,0.04326408,0.05213876,0.008874683
2011.0,CHE,56316,56316,3043,2241,802,0.03979331,0.05403438,0.014241069
2012.0,CHE,59507,59507,3188,2361,827,0.039676003,0.05357353,0.013897524
2013.0,CHE,62582,62582,3225,2571,654,0.0410821,0.051532388,0.01045029
2014.0,CHE,65525,65525,3420,2722,698,0.041541398,0.05219382,0.010652423
2015.0,CHE,68470,68470,3518,2807,711,0.040996056,0.051380165,0.01038411
2016.0,CHE,71031,71031,3668,2868,800,0.040376738,0.051639426,0.011262688
2017.0,CHE,73843,73843,3844,2845,999,0.038527686,0.05205639,0.013528703
2018.0,CHE,76294,76294,3751,3085,666,0.040435683,0.049165074,0.008729389
2019.0,CHE,78384,78384,3889,3105,784,0.039612677,0.049614716,0.010002041
2020.0,CHE,78387,78387,4148,3290,858,0.041971244,0.052916937,0.010945693
2021.0,CHE,75607,75607,3945,3123,822,0.0413057,0.05217771,0.010872009
2022.0,CHE,0,0,3443,2644,799,,,
2023.0,CHE,0,0,2485,1820,665,,,
1996.0,CHL,4009,4009,0,0,0,0.0,0.0,0.0
1997.0,CHL,4767,4767,88,90,-2,0.0188798,0.018460248,-0.00041955107
1998.0,CHL,5556,5556,134,94,40,0.016918646,0.024118071,0.007199424
1999.0,CHL,6063,6063,146,123,23,0.020286987,0.024080489,0.0037935015
2000.0,CHL,6680,6680,146,131,15,0.01961078,0.021856287,0.002245509
2001.0,CHL,7297,7297,228,163,65,0.022337947,0.031245718,0.008907771
2002.0,CHL,8001,8001,236,173,63,0.021622296,0.029496312,0.007874016
2003.0,CHL,8817,8817,239,176,63,0.019961437,0.027106727,0.0071452875
2004.0,CHL,9953,9953,221,189,32,0.01898925,0.02220436,0.003215111
2005.0,CHL,11094,11094,257,201,56,0.018117901,0.023165675,0.0050477735
2006.0,CHL,12514,12514,289,245,44,0.019578073,0.023094134,0.003516062
2007.0,CHL,13940,13940,310,296,14,0.021233859,0.022238163,0.0010043042
2008.0,CHL,15332,15332,335,310,25,0.020219149,0.021849725,0.0016305766
2009.0,CHL,16644,16644,362,346,16,0.020788273,0.02174958,0.0009613074
2010.0,CHL,17984,17984,442,365,77,0.02029582,0.024577402,0.0042815837
2011.0,CHL,19372,19372,474,448,26,0.02312616,0.024468305,0.0013421433
2012.0,CHL,20959,20959,503,373,130,0.01779665,0.023999237,0.006202586
2013.0,CHL,22588,22588,564,466,98,0.020630423,0.02496901,0.0043385867
2014.0,CHL,24525,24525,735,476,259,0.019408766,0.029969418,0.010560652
2015.0,CHL,26082,26082,740,556,184,0.021317383,0.028372057,0.0070546735
2016.0,CHL,28124,28124,741,576,165,0.020480728,0.026347604,0.0058668754
2017.0,CHL,29921,29921,842,605,237,0.020219913,0.02814077,0.007920858
2018.0,CHL,31615,31615,795,747,48,0.023628024,0.02514629,0.0015182666
2019.0,CHL,32898,32898,835,695,140,0.021125905,0.025381481,0.004255578
2020.0,CHL,33167,33167,800,713,87,0.021497272,0.02412036,0.0026230891
2021.0,CHL,32028,32028,787,802,-15,0.02504059,0.02457225,-0.0004683402
2022.0,CHL,0,0,572,672,-100,,,
2023.0,CHL,0,0,335,369,-34,,,
1996.0,CHN,64060,64060,0,0,0,0.0,0.0,0.0
1997.0,CHN,81120,81120,791,796,-5,0.009812623,0.0097509865,-6.163708e-05
1998.0,CHN,99954,99954,905,1172,-267,0.011725394,0.009054165,-0.0026712287
1999.0,CHN,121690,121690,1076,1349,-273,0.011085546,0.0088421395,-0.0022434054
2000.0,CHN,143408,143408,1239,1787,-548,0.012460951,0.008639686,-0.0038212652
2001.0,CHN,170352,170352,1615,1988,-373,0.011669954,0.00948037,-0.0021895838
2002.0,CHN,212730,212730,1768,2371,-603,0.011145583,0.008311004,-0.002834579
2003.0,CHN,272920,272920,2035,2356,-321,0.008632567,0.0074563976,-0.0011761688
2004.0,CHN,335971,335971,2269,2164,105,0.006441032,0.006753559,0.00031252697
2005.0,CHN,399969,399969,2389,2412,-23,0.0060304673,0.005972963,-5.7504458e-05
2006.0,CHN,470617,470617,2537,2594,-57,0.005511913,0.0053907954,-0.0001211176
2007.0,CHN,544184,544184,2818,2966,-148,0.0054503623,0.0051783957,-0.00027196683
2008.0,CHN,615763,615763,3174,3502,-328,0.005687253,0.005154581,-0.00053267245
2009.0,CHN,690240,690240,3683,4303,-620,0.0062340633,0.005335825,-0.0008982383
2010.0,CHN,776003,776003,4705,4915,-210,0.0063337386,0.006063121,-0.00027061751
2011.0,CHN,881558,881558,5502,5491,11,0.006228745,0.006241223,1.2477908e-05
2012.0,CHN,994344,994344,6184,5755,429,0.0057877353,0.0062191756,0.00043144022
2013.0,CHN,1115147,1115147,6551,5992,559,0.005373283,0.0058745616,0.0005012792
2014.0,CHN,1240387,1240387,7183,6579,604,0.0053039896,0.0057909344,0.0004869448
2015.0,CHN,1371872,1371872,7937,7138,799,0.0052031092,0.0057855253,0.00058241584
2016.0,CHN,1519586,1519586,8559,8120,439,0.0053435606,0.005632455,0.0002888945
2017.0,CHN,1697218,1697218,9506,8503,1003,0.005009963,0.0056009307,0.0005909671
2018.0,CHN,1883727,1883727,10831,9193,1638,0.0048802188,0.0057497714,0.0008695528
2019.0,CHN,2079854,2079854,12043,10009,2034,0.004812357,0.0057903104,0.0009779533
2020.0,CHN,2251676,2251676,12885,11201,1684,0.0049745166,0.005722404,0.00074788736
2021.0,CHN,2168290,2168290,13177,11203,1974,0.0051667443,0.006077139,0.0009103948
2022.0,CHN,0,0,12484,9646,2838,,,
2023.0,CHN,0,0,8304,6924,1380,,,
1996.0,CIV,368,368,0,0,0,0.0,0.0,0.0
1997.0,CIV,457,457,10,13,-3,0.02844639,0.021881837,-0.0065645515
1998.0,CIV,510,510,27,30,-3,0.05882353,0.052941177,-0.005882353
1999.0,CIV,561,561,33,20,13,0.035650622,0.05882353,0.023172906
2000.0,CIV,591,591,32,40,-8,0.06768189,0.054145515,-0.013536379
2001.0,CIV,589,589,34,40,-6,0.067911714,0.057724956,-0.010186757
2002.0,CIV,651,651,32,35,-3,0.05376344,0.049155146,-0.004608295
2003.0,CIV,749,749,55,41,14,0.054739654,0.07343124,0.018691588
2004.0,CIV,838,838,42,39,3,0.04653938,0.050119333,0.0035799523
2005.0,CIV,937,937,28,30,-2,0.032017075,0.029882604,-0.0021344717
2006.0,CIV,1085,1085,34,41,-7,0.03778802,0.031336404,-0.006451613
2007.0,CIV,1243,1243,52,33,19,0.026548672,0.041834272,0.015285599
2008.0,CIV,1322,1322,43,49,-6,0.03706505,0.032526474,-0.004538578
2009.0,CIV,1412,1412,47,73,-26,0.051699717,0.03328612,-0.018413598
2010.0,CIV,1507,1507,45,70,-25,0.0464499,0.029860651,-0.01658925
2011.0,CIV,1597,1597,86,41,45,0.025673138,0.05385097,0.028177833
2012.0,CIV,1695,1695,81,43,38,0.025368731,0.04778761,0.022418879
2013.0,CIV,1747,1747,64,56,8,0.03205495,0.03663423,0.0045792786
2014.0,CIV,1758,1758,52,66,-14,0.037542664,0.029579068,-0.007963595
2015.0,CIV,1824,1824,99,60,39,0.032894738,0.054276317,0.02138158
2016.0,CIV,1952,1952,111,66,45,0.033811476,0.056864753,0.02305328
2017.0,CIV,2156,2156,107,50,57,0.023191094,0.049628943,0.026437847
2018.0,CIV,2268,2268,111,37,74,0.016313933,0.0489418,0.032627866
2019.0,CIV,2383,2383,103,53,50,0.022240873,0.04322283,0.020981956
2020.0,CIV,2392,2392,92,50,42,0.02090301,0.03846154,0.017558528
2021.0,CIV,2361,2361,81,48,33,0.020330368,0.0343075,0.013977128
2022.0,CIV,0,0,39,38,1,,,
2023.0,CIV,0,0,27,18,9,,,
1996.0,CMR,447,447,0,0,0,0.0,0.0,0.0
1997.0,CMR,522,522,25,17,8,0.03256705,0.04789272,0.01532567
1998.0,CMR,575,575,15,34,-19,0.059130434,0.026086956,-0.033043478
1999.0,CMR,640,640,37,19,18,0.0296875,0.0578125,0.028125
2000.0,CMR,698,698,27,33,-6,0.04727794,0.038681947,-0.008595988
2001.0,CMR,792,792,41,36,5,0.045454547,0.051767677,0.006313131
2002.0,CMR,864,864,43,40,3,0.046296295,0.04976852,0.0034722222
2003.0,CMR,1084,1084,60,29,31,0.026752768,0.055350553,0.028597785
2004.0,CMR,1260,1260,34,39,-5,0.030952381,0.026984127,-0.003968254
2005.0,CMR,1447,1447,56,34,22,0.02349689,0.03870076,0.01520387
2006.0,CMR,1569,1569,35,50,-15,0.031867433,0.022307202,-0.009560229
2007.0,CMR,1759,1759,53,58,-5,0.032973282,0.030130757,-0.002842524
2008.0,CMR,1944,1944,50,56,-6,0.028806584,0.025720164,-0.0030864198
2009.0,CMR,2178,2178,58,67,-9,0.030762168,0.026629936,-0.004132231
2010.0,CMR,2514,2514,83,73,10,0.02903739,0.033015117,0.003977725
2011.0,CMR,2766,2766,85,68,17,0.024584237,0.030730296,0.0061460594
2012.0,CMR,3031,3031,65,70,-5,0.023094688,0.021445068,-0.0016496206
2013.0,CMR,3375,3375,71,64,7,0.018962963,0.021037037,0.002074074
2014.0,CMR,3733,3733,98,61,37,0.016340746,0.026252344,0.0099116
2015.0,CMR,4075,4075,111,79,32,0.019386504,0.027239263,0.007852761
2016.0,CMR,4482,4482,89,78,11,0.017402945,0.019857207,0.0024542615
2017.0,CMR,4948,4948,95,93,2,0.018795474,0.019199677,0.00040420372
2018.0,CMR,5371,5371,101,84,17,0.015639545,0.018804692,0.003165146
2019.0,CMR,5838,5838,115,112,3,0.019184653,0.019698527,0.00051387463
2020.0,CMR,6158,6158,146,86,60,0.013965573,0.023708997,0.009743423
2021.0,CMR,6112,6112,128,130,-2,0.021269634,0.020942409,-0.00032722513
2022.0,CMR,0,0,89,111,-22,,,
2023.0,CMR,0,0,61,62,-1,,,
1996.0,COD,25,25,0,0,0,0.0,0.0,0.0
1997.0,COD,28,28,4,3,1,0.10714286,0.14285715,0.035714287
1998.0,COD,26,26,5,8,-3,0.30769232,0.1923077,-0.115384616
1999.0,COD,21,21,2,11,-9,0.52380955,0.0952381,-0.42857143
2000.0,COD,23,23,2,7,-5,0.3043478,0.08695652,-0.2173913
2001.0,COD,18,18,0,2,-2,0.11111111,0.0,-0.11111111
2002.0,COD,33,33,6,3,3,0.09090909,0.18181819,0.09090909
2003.0,COD,37,37,4,7,-3,0.1891892,0.10810811,-0.08108108
2004.0,COD,49,49,3,1,2,0.020408163,0.06122449,0.040816326
2005.0,COD,52,52,7,5,2,0.09615385,0.13461539,0.03846154
2006.0,COD,66,66,8,11,-3,0.16666667,0.121212125,-0.045454547
2007.0,COD,75,75,9,8,1,0.10666667,0.12,0.013333334
2008.0,COD,88,88,15,23,-8,0.26136363,0.17045455,-0.09090909
2009.0,COD,108,108,28,14,14,0.12962963,0.25925925,0.12962963
2010.0,COD,113,113,26,26,0,0.2300885,0.2300885,0.0
2011.0,COD,113,113,9,31,-22,0.27433628,0.07964602,-0.19469027
2012.0,COD,139,139,26,17,9,0.12230216,0.18705036,0.0647482
2013.0,COD,151,151,31,34,-3,0.22516556,0.205298,-0.01986755
2014.0,COD,182,182,34,35,-1,0.1923077,0.18681319,-0.0054945056
2015.0,COD,236,236,53,39,14,0.16525424,0.22457626,0.059322033
2016.0,COD,356,356,89,30,59,0.084269665,0.25,0.16573034
2017.0,COD,493,493,107,52,55,0.10547667,0.21703854,0.111561865
2018.0,COD,735,735,187,73,114,0.099319726,0.25442177,0.15510204
2019.0,COD,1038,1038,250,72,178,0.06936416,0.24084778,0.17148362
2020.0,COD,1301,1301,250,64,186,0.049192928,0.19215988,0.14296696
2021.0,COD,1378,1378,224,110,114,0.07982583,0.16255443,0.082728595
2022.0,COD,0,0,152,96,56,,,
1996.0,COG,86,86,0,0,0,0.0,0.0,0.0
1997.0,COG,113,113,6,7,-1,0.061946902,0.053097345,-0.0088495575
1998.0,COG,146,146,16,5,11,0.034246575,0.10958904,0.07534247
1999.0,COG,161,161,14,14,0,0.08695652,0.08695652,0.0
2000.0,COG,169,169,7,9,-2,0.053254437,0.041420117,-0.01183432
2001.0,COG,188,188,8,16,-8,0.08510638,0.04255319,-0.04255319
2002.0,COG,211,211,6,17,-11,0.08056872,0.028436018,-0.0521327
2003.0,COG,286,286,27,10,17,0.034965035,0.09440559,0.05944056
2004.0,COG,336,336,18,13,5,0.038690478,0.05357143,0.014880952
2005.0,COG,420,420,24,11,13,0.026190476,0.057142857,0.030952381
2006.0,COG,479,479,34,22,12,0.04592902,0.07098121,0.025052192
2007.0,COG,529,529,42,20,22,0.037807185,0.079395086,0.0415879
2008.0,COG,574,574,36,26,10,0.045296166,0.06271777,0.017421603
2009.0,COG,600,600,43,50,-7,0.083333336,0.071666665,-0.011666667
2010.0,COG,664,664,42,40,2,0.060240965,0.063253015,0.003012048
2011.0,COG,809,809,64,33,31,0.0407911,0.07911001,0.038318913
2012.0,COG,1000,1000,72,39,33,0.039,0.072,0.033
2013.0,COG,1119,1119,73,52,21,0.04647006,0.06523682,0.018766755
2014.0,COG,1233,1233,74,53,21,0.04298459,0.060016222,0.01703163
2015.0,COG,1292,1292,82,86,-4,0.066563465,0.063467495,-0.0030959751
2016.0,COG,1276,1276,70,138,-68,0.10815047,0.054858934,-0.053291537
2017.0,COG,1273,1273,93,125,-32,0.09819324,0.073055774,-0.025137471
2018.0,COG,1250,1250,126,182,-56,0.1456,0.1008,-0.0448
2019.0,COG,1135,1135,107,238,-131,0.20969163,0.09427313,-0.1154185
2020.0,COG,993,993,100,226,-126,0.22759315,0.10070494,-0.12688822
2021.0,COG,896,896,135,190,-55,0.21205357,0.15066965,-0.06138393
2022.0,COG,0,0,95,127,-32,,,
1996.0,COL,1129,1129,0,0,0,0.0,0.0,0.0
1997.0,COL,1408,1408,60,41,19,0.029119318,0.042613637,0.013494318
1998.0,COL,1747,1747,91,57,34,0.032627363,0.052089296,0.019461935
1999.0,COL,2014,2014,91,72,19,0.035749752,0.045183714,0.009433962
2000.0,COL,2267,2267,84,101,-17,0.04455227,0.037053373,-0.007498897
2001.0,COL,2555,2555,105,104,1,0.0407045,0.04109589,0.00039138945
2002.0,COL,2971,2971,139,131,8,0.044092897,0.046785593,0.0026926962
2003.0,COL,3505,3505,127,120,7,0.034236804,0.03623395,0.001997147
2004.0,COL,4203,4203,136,110,26,0.026171783,0.032357838,0.0061860573
2005.0,COL,5053,5053,167,122,45,0.024144072,0.033049673,0.008905601
2006.0,COL,6451,6451,177,132,45,0.020461943,0.027437607,0.006975663
2007.0,COL,7907,7907,242,176,66,0.022258759,0.030605793,0.008347034
2008.0,COL,9326,9326,236,200,36,0.021445422,0.025305597,0.0038601758
2009.0,COL,10715,10715,255,246,9,0.022958469,0.023798414,0.000839944
2010.0,COL,12351,12351,346,339,7,0.02744717,0.028013926,0.0005667557
2011.0,COL,13895,13895,370,361,9,0.02598057,0.026628284,0.000647715
2012.0,COL,15470,15470,422,396,26,0.025597932,0.027278604,0.0016806723
2013.0,COL,17264,17264,440,407,33,0.02357507,0.025486562,0.0019114921
2014.0,COL,19558,19558,496,453,43,0.023161877,0.025360467,0.0021985888
2015.0,COL,21897,21897,587,435,152,0.019865735,0.026807325,0.00694159
2016.0,COL,24353,24353,628,490,138,0.020120725,0.025787378,0.005666653
2017.0,COL,26964,26964,732,570,162,0.021139298,0.027147308,0.006008011
2018.0,COL,29780,29780,739,637,102,0.021390194,0.024815312,0.0034251176
2019.0,COL,31810,31810,770,678,92,0.021314053,0.024206225,0.0028921722
2020.0,COL,32431,32431,709,735,-26,0.0226635,0.021861799,-0.0008017021
2021.0,COL,31359,31359,702,768,-66,0.024490576,0.022385918,-0.0021046589
2022.0,COL,0,0,494,661,-167,,,
2023.0,COL,0,0,263,384,-121,,,
1996.0,COM,3,3,0,0,0,0.0,0.0,0.0
1997.0,COM,5,5,1,0,1,0.0,0.2,0.2
1999.0,COM,9,9,1,0,1,0.0,0.11111111,0.11111111
2000.0,COM,7,7,1,0,1,0.0,0.14285715,0.14285715
2001.0,COM,7,7,0,1,-1,0.14285715,0.0,-0.14285715
2003.0,COM,4,4,0,1,-1,0.25,0.0,-0.25
2004.0,COM,3,3,0,2,-2,0.6666667,0.0,-0.6666667
2005.0,COM,7,7,1,2,-1,0.2857143,0.14285715,-0.14285715
2007.0,COM,15,15,4,0,4,0.0,0.26666668,0.26666668
2008.0,COM,18,18,0,1,-1,0.055555556,0.0,-0.055555556
2009.0,COM,20,20,0,1,-1,0.05,0.0,-0.05
2010.0,COM,18,18,3,1,2,0.055555556,0.16666667,0.11111111
2011.0,COM,23,23,1,2,-1,0.08695652,0.04347826,-0.04347826
2012.0,COM,30,30,3,4,-1,0.13333334,0.1,-0.033333335
2013.0,COM,36,36,5,0,5,0.0,0.1388889,0.1388889
2014.0,COM,32,32,2,9,-7,0.28125,0.0625,-0.21875
2015.0,COM,35,35,3,3,0,0.08571429,0.08571429,0.0
2016.0,COM,38,38,2,3,-1,0.078947365,0.05263158,-0.02631579
2017.0,COM,49,49,2,0,2,0.0,0.040816326,0.040816326
2018.0,COM,49,49,1,2,-1,0.040816326,0.020408163,-0.020408163
2019.0,COM,46,46,3,3,0,0.06521739,0.06521739,0.0
2020.0,COM,47,47,1,1,0,0.021276595,0.021276595,0.0
2021.0,COM,52,52,4,0,4,0.0,0.07692308,0.07692308
2022.0,COM,0,0,2,0,2,,,
1996.0,CPV,1,1,0,0,0,0.0,0.0,0.0
1999.0,CPV,3,3,0,0,0,0.0,0.0,0.0
2003.0,CPV,3,3,0,0,0,0.0,0.0,0.0
2004.0,CPV,6,6,1,1,0,0.16666667,0.16666667,0.0
2006.0,CPV,8,8,0,0,0,0.0,0.0,0.0
2008.0,CPV,14,14,1,1,0,0.071428575,0.071428575,0.0
2009.0,CPV,15,15,2,0,2,0.0,0.13333334,0.13333334
2010.0,CPV,19,19,1,2,-1,0.10526316,0.05263158,-0.05263158
2011.0,CPV,26,26,0,1,-1,0.03846154,0.0,-0.03846154
2012.0,CPV,42,42,4,2,2,0.04761905,0.0952381,0.04761905
2013.0,CPV,60,60,5,3,2,0.05,0.083333336,0.033333335
2014.0,CPV,65,65,0,2,-2,0.03076923,0.0,-0.03076923
2015.0,CPV,79,79,6,3,3,0.03797468,0.07594936,0.03797468
2016.0,CPV,75,75,6,9,-3,0.12,0.08,-0.04
2017.0,CPV,88,88,2,1,1,0.011363637,0.022727273,0.011363637
2018.0,CPV,103,103,9,3,6,0.029126214,0.08737864,0.058252428
2019.0,CPV,111,111,7,5,2,0.045045044,0.06306306,0.018018018
2020.0,CPV,120,120,7,1,6,0.008333334,0.058333334,0.05
2021.0,CPV,118,118,9,7,2,0.059322033,0.076271184,0.016949153
2022.0,CPV,0,0,6,3,3,,,
1996.0,CRI,395,395,0,0,0,0.0,0.0,0.0
1997.0,CRI,467,467,28,17,11,0.03640257,0.059957173,0.023554605
1998.0,CRI,499,499,24,45,-21,0.09018036,0.04809619,-0.04208417
1999.0,CRI,535,535,18,33,-15,0.061682243,0.03364486,-0.028037382
2000.0,CRI,593,593,38,32,6,0.0539629,0.064080946,0.010118044
2001.0,CRI,604,604,29,32,-3,0.052980132,0.048013244,-0.0049668876
2002.0,CRI,680,680,47,23,24,0.03382353,0.06911765,0.03529412
2003.0,CRI,753,753,47,29,18,0.038512617,0.062417,0.023904383
2004.0,CRI,818,818,41,31,10,0.03789731,0.05012225,0.012224939
2005.0,CRI,884,884,29,27,2,0.030542986,0.03280543,0.0022624435
2006.0,CRI,951,951,24,31,-7,0.032597266,0.025236594,-0.007360673
2007.0,CRI,1010,1010,39,30,9,0.02970297,0.03861386,0.008910891
2008.0,CRI,1070,1070,34,34,0,0.0317757,0.0317757,0.0
2009.0,CRI,1127,1127,45,56,-11,0.049689442,0.039929014,-0.009760426
2010.0,CRI,1193,1193,40,54,-14,0.04526404,0.03352892,-0.011735122
2011.0,CRI,1252,1252,48,45,3,0.03594249,0.038338657,0.002396166
2012.0,CRI,1349,1349,82,71,11,0.05263158,0.060785767,0.008154188
2013.0,CRI,1393,1393,53,52,1,0.037329506,0.03804738,0.0007178751
2014.0,CRI,1539,1539,75,58,17,0.03768681,0.048732944,0.011046134
2015.0,CRI,1691,1691,58,75,-17,0.044352453,0.034299232,-0.010053223
2016.0,CRI,1822,1822,88,77,11,0.04226125,0.04829857,0.0060373214
2017.0,CRI,2015,2015,79,67,12,0.03325062,0.039205953,0.005955335
2018.0,CRI,2246,2246,111,83,28,0.036954585,0.049421195,0.012466608
2019.0,CRI,2420,2420,117,76,41,0.031404957,0.048347108,0.016942149
2020.0,CRI,2474,2474,116,98,18,0.039611965,0.046887632,0.007275667
2021.0,CRI,2452,2452,91,83,8,0.033849917,0.03711256,0.0032626428
2022.0,CRI,0,0,65,68,-3,,,
1996.0,CUB,2631,2631,0,0,0,0.0,0.0,0.0
1997.0,CUB,3350,3350,31,42,-11,0.012537314,0.009253731,-0.0032835822
1998.0,CUB,4057,4057,55,63,-8,0.015528716,0.013556816,-0.0019719005
1999.0,CUB,4521,4521,61,71,-10,0.01570449,0.01349259,-0.0022119
2000.0,CUB,4870,4870,73,101,-28,0.02073922,0.014989733,-0.005749487
2001.0,CUB,5004,5004,68,106,-38,0.021183053,0.013589129,-0.0075939246
2002.0,CUB,5267,5267,88,98,-10,0.018606417,0.016707804,-0.001898614
2003.0,CUB,5372,5372,71,96,-25,0.01787044,0.013216679,-0.00465376
2004.0,CUB,5838,5838,94,75,19,0.012846866,0.016101405,0.0032545393
2005.0,CUB,6061,6061,57,80,-23,0.013199142,0.009404388,-0.0037947532
2006.0,CUB,6573,6573,73,75,-2,0.011410315,0.011106039,-0.00030427508
2007.0,CUB,7186,7186,65,99,-34,0.0137767885,0.009045366,-0.0047314223
2008.0,CUB,7676,7676,86,87,-1,0.011334028,0.011203752,-0.00013027618
2009.0,CUB,8057,8057,67,117,-50,0.014521534,0.00831575,-0.0062057837
2010.0,CUB,8358,8358,87,122,-35,0.014596794,0.010409188,-0.004187605
2011.0,CUB,8659,8659,75,129,-54,0.014897794,0.008661509,-0.006236286
2012.0,CUB,8840,8840,77,136,-59,0.015384615,0.008710408,-0.006674208
2013.0,CUB,8924,8924,70,140,-70,0.015688032,0.007844016,-0.007844016
2014.0,CUB,8627,8627,85,170,-85,0.019705575,0.0098527875,-0.0098527875
2015.0,CUB,8330,8330,60,195,-135,0.023409363,0.007202881,-0.016206482
2016.0,CUB,7998,7998,68,218,-150,0.027256815,0.008502126,-0.018754689
2017.0,CUB,7762,7762,82,200,-118,0.025766555,0.010564287,-0.015202267
2018.0,CUB,7712,7712,79,207,-128,0.026841287,0.010243776,-0.016597511
2019.0,CUB,7736,7736,88,189,-101,0.02443123,0.011375388,-0.013055842
2020.0,CUB,7526,7526,83,190,-107,0.025245814,0.011028435,-0.0142173795
2021.0,CUB,7007,7007,85,118,-33,0.016840303,0.012130726,-0.0047095763
2022.0,CUB,0,0,45,131,-86,,,
2019.0,CUW,13,13,7,0,7,0.0,0.53846157,0.53846157
2021.0,CUW,46,46,10,0,10,0.0,0.2173913,0.2173913
2022.0,CUW,0,0,8,4,4,,,
1996.0,CYM,6,6,0,0,0,0.0,0.0,0.0
1997.0,CYM,9,9,1,0,1,0.0,0.11111111,0.11111111
1998.0,CYM,9,9,1,2,-1,0.22222222,0.11111111,-0.11111111
1999.0,CYM,10,10,0,0,0,0.0,0.0,0.0
2000.0,CYM,8,8,0,1,-1,0.125,0.0,-0.125
2001.0,CYM,5,5,0,4,-4,0.8,0.0,-0.8
2002.0,CYM,4,4,0,0,0,0.0,0.0,0.0
2003.0,CYM,11,11,4,0,4,0.0,0.36363637,0.36363637
2005.0,CYM,20,20,0,0,0,0.0,0.0,0.0
2006.0,CYM,22,22,0,1,-1,0.045454547,0.0,-0.045454547
2007.0,CYM,24,24,2,2,0,0.083333336,0.083333336,0.0
2008.0,CYM,20,20,1,5,-4,0.25,0.05,-0.2
2009.0,CYM,25,25,6,2,4,0.08,0.24,0.16
2011.0,CYM,37,37,6,1,5,0.027027028,0.16216215,0.13513513
2012.0,CYM,38,38,1,5,-4,0.13157895,0.02631579,-0.10526316
2013.0,CYM,28,28,2,6,-4,0.21428572,0.071428575,-0.14285715
2014.0,CYM,26,26,1,3,-2,0.115384616,0.03846154,-0.07692308
2015.0,CYM,32,32,5,3,2,0.09375,0.15625,0.0625
2016.0,CYM,37,37,1,3,-2,0.08108108,0.027027028,-0.054054055
2017.0,CYM,37,37,3,1,2,0.027027028,0.08108108,0.054054055
2018.0,CYM,36,36,1,1,0,0.027777778,0.027777778,0.0
2019.0,CYM,44,44,9,3,6,0.06818182,0.20454545,0.13636364
2020.0,CYM,45,45,5,5,0,0.11111111,0.11111111,0.0
2021.0,CYM,41,41,4,6,-2,0.14634146,0.09756097,-0.048780486
2022.0,CYM,0,0,8,4,4,,,
1996.0,CYP,216,216,0,0,0,0.0,0.0,0.0
1997.0,CYP,260,260,8,8,0,0.03076923,0.03076923,0.0
1998.0,CYP,325,325,29,13,16,0.04,0.08923077,0.04923077
1999.0,CYP,359,359,27,12,15,0.033426184,0.07520892,0.04178273
2000.0,CYP,420,420,33,13,20,0.030952381,0.07857143,0.04761905
2001.0,CYP,457,457,23,23,0,0.05032823,0.05032823,0.0
2002.0,CYP,524,524,36,17,19,0.03244275,0.06870229,0.036259543
2003.0,CYP,570,570,42,25,17,0.04385965,0.07368421,0.02982456
2004.0,CYP,668,668,53,24,29,0.035928145,0.079341315,0.043413173
2005.0,CYP,779,779,59,25,34,0.032092426,0.075738125,0.0436457
2006.0,CYP,892,892,58,39,19,0.043721974,0.065022424,0.021300448
2007.0,CYP,1107,1107,84,28,56,0.025293587,0.07588076,0.050587174
2008.0,CYP,1235,1235,90,39,51,0.031578947,0.072874494,0.041295547
2009.0,CYP,1398,1398,105,43,62,0.030758226,0.0751073,0.04434907
2010.0,CYP,1593,1593,113,54,59,0.033898305,0.07093534,0.037037037
2011.0,CYP,1827,1827,143,61,82,0.033388067,0.07827039,0.04488232
2012.0,CYP,2011,2011,167,79,88,0.03928394,0.08304326,0.043759324
2013.0,CYP,2195,2195,174,88,86,0.040091116,0.07927107,0.039179955
2014.0,CYP,2416,2416,175,123,52,0.050910596,0.07243378,0.02152318
2015.0,CYP,2661,2661,182,142,40,0.053363398,0.06839534,0.015031943
2016.0,CYP,2971,2971,225,130,95,0.04375631,0.075732075,0.031975765
2017.0,CYP,3267,3267,260,156,104,0.04775023,0.07958372,0.031833485
2018.0,CYP,3566,3566,283,201,82,0.056365676,0.07936063,0.022994952
2019.0,CYP,3882,3882,298,226,72,0.058217414,0.076764554,0.01854714
2020.0,CYP,4016,4016,326,239,87,0.059511952,0.0811753,0.021663347
2021.0,CYP,3959,3959,350,268,82,0.06769386,0.08840616,0.020712301
2022.0,CYP,0,0,290,256,34,,,
1996.0,CZE,9503,9503,0,0,0,0.0,0.0,0.0
1997.0,CZE,11140,11140,219,186,33,0.016696589,0.019658888,0.002962298
1998.0,CZE,12734,12734,219,184,35,0.014449505,0.017198052,0.0027485471
1999.0,CZE,13950,13950,230,235,-5,0.016845878,0.016487455,-0.00035842293
2000.0,CZE,15064,15064,256,220,36,0.014604355,0.016994158,0.0023898035
2001.0,CZE,16131,16131,255,294,-39,0.018225776,0.015808072,-0.002417705
2002.0,CZE,17287,17287,272,328,-56,0.018973796,0.015734367,-0.0032394284
2003.0,CZE,18354,18354,322,290,32,0.01580037,0.01754386,0.0017434892
2004.0,CZE,19743,19743,269,245,24,0.012409462,0.013625083,0.0012156208
2005.0,CZE,21343,21343,245,258,-13,0.012088273,0.011479174,-0.000609099
2006.0,CZE,22788,22788,275,294,-19,0.012901527,0.012067755,-0.0008337722
2007.0,CZE,24386,24386,280,327,-47,0.013409333,0.011481998,-0.0019273354
2008.0,CZE,26238,26238,355,329,26,0.012539065,0.0135299945,0.0009909292
2009.0,CZE,28230,28230,356,297,59,0.010520723,0.012610698,0.0020899752
2010.0,CZE,29997,29997,367,303,64,0.01010101,0.0122345565,0.0021335466
2011.0,CZE,31686,31686,384,366,18,0.011550843,0.012118917,0.00056807423
2012.0,CZE,33835,33835,351,368,-17,0.010876312,0.010373874,-0.0005024383
2013.0,CZE,35830,35830,511,358,153,0.009991627,0.0142617915,0.0042701648
2014.0,CZE,37843,37843,597,414,183,0.010939936,0.015775705,0.0048357686
2015.0,CZE,39428,39428,603,445,158,0.011286396,0.0152937,0.0040073046
2016.0,CZE,40668,40668,574,558,16,0.013720862,0.014114291,0.0003934297
2017.0,CZE,41957,41957,574,574,0,0.013680673,0.013680673,0.0
2018.0,CZE,43108,43108,760,583,177,0.013524172,0.017630138,0.0041059665
2019.0,CZE,44167,44167,819,571,248,0.012928205,0.018543256,0.005615052
2020.0,CZE,43971,43971,808,583,225,0.013258738,0.018375747,0.005117009
2021.0,CZE,42357,42357,825,617,208,0.01456666,0.0194773,0.0049106404
2022.0,CZE,0,0,684,619,65,,,
2023.0,CZE,0,0,408,411,-3,,,
1996.0,DEU,117741,117741,0,0,0,0.0,0.0,0.0
1997.0,DEU,136001,136001,2795,2910,-115,0.021396901,0.02055132,-0.000845582
1998.0,DEU,153308,153308,3473,3552,-79,0.023169044,0.022653744,-0.0005153025
1999.0,DEU,166722,166722,3646,4113,-467,0.02466981,0.02186874,-0.00280107
2000.0,DEU,175895,175895,4198,4482,-284,0.02548111,0.023866512,-0.0016145996
2001.0,DEU,182757,182757,5024,4958,66,0.02712892,0.027490055,0.0003611353
2002.0,DEU,190113,190113,5139,5319,-180,0.027978098,0.027031291,-0.00094680535
2003.0,DEU,198595,198595,5036,5085,-49,0.025604874,0.02535814,-0.0002467333
2004.0,DEU,206256,206256,4332,4690,-358,0.022738732,0.021003025,-0.001735707
2005.0,DEU,213811,213811,4328,4897,-569,0.022903405,0.020242177,-0.0026612289
2006.0,DEU,222103,222103,4309,5364,-1055,0.024150956,0.019400908,-0.0047500483
2007.0,DEU,232107,232107,4719,5594,-875,0.024100954,0.02033114,-0.003769813
2008.0,DEU,241578,241578,4805,6009,-1204,0.024873953,0.019890057,-0.0049838973
2009.0,DEU,251535,251535,5507,5939,-432,0.023611028,0.021893574,-0.0017174549
2010.0,DEU,262475,262475,5955,6102,-147,0.02324793,0.022687875,-0.00056005333
2011.0,DEU,273965,273965,6196,6568,-372,0.023973865,0.022616027,-0.0013578377
2012.0,DEU,285881,285881,6524,6502,22,0.02274373,0.022820685,7.69551e-05
2013.0,DEU,298112,298112,6704,6811,-107,0.022847118,0.022488192,-0.0003589255
2014.0,DEU,309351,309351,7192,7060,132,0.022821972,0.023248672,0.00042669976
2015.0,DEU,319411,319411,7116,7282,-166,0.022798212,0.022278506,-0.0005197066
2016.0,DEU,328854,328854,7623,7620,3,0.023171376,0.0231805,9.122589e-06
2017.0,DEU,337136,337136,7706,7651,55,0.022694105,0.022857245,0.00016313892
2018.0,DEU,345158,345158,8023,7821,202,0.022659188,0.023244428,0.0005852392
2019.0,DEU,350844,350844,8175,7949,226,0.022656793,0.023300955,0.00064416096
2020.0,DEU,346699,346699,8498,8098,400,0.023357436,0.024511175,0.0011537386
2021.0,DEU,328003,328003,8121,7865,256,0.02397844,0.02475892,0.0007804807
2022.0,DEU,0,0,7088,6599,489,,,
2023.0,DEU,0,0,4452,4194,258,,,
1996.0,DJI,9,9,0,0,0,0.0,0.0,0.0
1997.0,DJI,9,9,0,1,-1,0.11111111,0.0,-0.11111111
1998.0,DJI,9,9,1,1,0,0.11111111,0.11111111,0.0
1999.0,DJI,11,11,0,0,0,0.0,0.0,0.0
2001.0,DJI,6,6,0,0,0,0.0,0.0,0.0
2002.0,DJI,7,7,2,1,1,0.14285715,0.2857143,0.14285715
2005.0,DJI,16,16,0,0,0,0.0,0.0,0.0
2007.0,DJI,14,14,1,2,-1,0.14285715,0.071428575,-0.071428575
2008.0,DJI,20,20,5,0,5,0.0,0.25,0.25
2010.0,DJI,38,38,6,5,1,0.13157895,0.15789473,0.02631579
2011.0,DJI,44,44,5,3,2,0.06818182,0.11363637,0.045454547
2012.0,DJI,53,53,5,1,4,0.018867925,0.094339624,0.0754717
2013.0,DJI,49,49,2,6,-4,0.12244898,0.040816326,-0.08163265
2014.0,DJI,52,52,7,4,3,0.07692308,0.13461539,0.057692308
2015.0,DJI,50,50,4,3,1,0.06,0.08,0.02
2016.0,DJI,46,46,5,2,3,0.04347826,0.10869565,0.06521739
2017.0,DJI,48,48,3,2,1,0.041666668,0.0625,0.020833334
2018.0,DJI,55,55,7,1,6,0.018181818,0.12727273,0.10909091
2019.0,DJI,53,53,4,3,1,0.056603774,0.0754717,0.018867925
2020.0,DJI,60,60,4,0,4,0.0,0.06666667,0.06666667
2021.0,DJI,55,55,2,1,1,0.018181818,0.036363635,0.018181818
2022.0,DJI,0,0,5,2,3,,,
1996.0,DMA,3,3,0,0,0,0.0,0.0,0.0
1997.0,DMA,3,3,0,0,0,0.0,0.0,0.0
2001.0,DMA,11,11,2,0,2,0.0,0.18181819,0.18181819
2002.0,DMA,9,9,0,2,-2,0.22222222,0.0,-0.22222222
2003.0,DMA,13,13,1,0,1,0.0,0.07692308,0.07692308
2005.0,DMA,15,15,2,1,1,0.06666667,0.13333334,0.06666667
2006.0,DMA,14,14,1,0,1,0.0,0.071428575,0.071428575
2007.0,DMA,15,15,2,1,1,0.06666667,0.13333334,0.06666667
2010.0,DMA,19,19,1,1,0,0.05263158,0.05263158,0.0
2011.0,DMA,22,22,3,4,-1,0.18181819,0.13636364,-0.045454547
2012.0,DMA,31,31,5,1,4,0.032258064,0.16129032,0.12903225
2013.0,DMA,34,34,5,6,-1,0.1764706,0.14705883,-0.029411765
2014.0,DMA,44,44,8,4,4,0.09090909,0.18181819,0.09090909
2015.0,DMA,49,49,11,9,2,0.18367347,0.2244898,0.040816326
2016.0,DMA,46,46,3,13,-10,0.2826087,0.06521739,-0.2173913
2017.0,DMA,46,46,7,6,1,0.13043478,0.1521739,0.02173913
2018.0,DMA,48,48,11,8,3,0.16666667,0.22916667,0.0625
2019.0,DMA,44,44,4,9,-5,0.20454545,0.09090909,-0.11363637
2020.0,DMA,34,34,6,11,-5,0.32352942,0.1764706,-0.14705883
2021.0,DMA,27,27,1,5,-4,0.18518518,0.037037037,-0.14814815
2022.0,DMA,0,0,3,2,1,,,
1996.0,DNK,12349,12349,0,0,0,0.0,0.0,0.0
1997.0,DNK,14079,14079,371,340,31,0.024149442,0.026351303,0.002201861
1998.0,DNK,15790,15790,424,413,11,0.026155794,0.026852438,0.00069664343
1999.0,DNK,17000,17000,497,451,46,0.02652941,0.029235294,0.0027058823
2000.0,DNK,17921,17921,557,509,48,0.028402433,0.031080855,0.002678422
2001.0,DNK,18606,18606,604,639,-35,0.03434376,0.032462645,-0.0018811136
2002.0,DNK,19619,19619,699,655,44,0.033386003,0.03562873,0.002242724
2003.0,DNK,20391,20391,591,621,-30,0.030454611,0.028983375,-0.0014712373
2004.0,DNK,21167,21167,521,522,-1,0.024661029,0.024613786,-4.724335e-05
2005.0,DNK,21936,21936,461,507,-46,0.023112692,0.021015681,-0.0020970094
2006.0,DNK,23157,23157,585,544,41,0.023491817,0.025262339,0.0017705229
2007.0,DNK,24451,24451,589,534,55,0.021839598,0.024088994,0.0022493966
2008.0,DNK,26005,26005,723,605,118,0.023264756,0.027802346,0.004537589
2009.0,DNK,27872,27872,801,547,254,0.01962543,0.02873852,0.009113088
2010.0,DNK,29845,29845,818,597,221,0.02000335,0.027408276,0.0074049253
2011.0,DNK,31775,31775,833,684,149,0.021526357,0.026215577,0.0046892213
2012.0,DNK,34161,34161,851,732,119,0.021427944,0.024911448,0.0034835045
2013.0,DNK,36360,36360,946,791,155,0.021754675,0.026017603,0.0042629265
2014.0,DNK,38395,38395,1008,875,133,0.022789426,0.026253419,0.0034639926
2015.0,DNK,40349,40349,1160,865,295,0.021437954,0.028749164,0.0073112096
2016.0,DNK,42223,42223,1221,1023,198,0.0242285,0.028917888,0.0046893875
2017.0,DNK,43766,43766,1253,1121,132,0.02561349,0.02862953,0.00301604
2018.0,DNK,45277,45277,1324,1143,181,0.025244605,0.02924222,0.0039976146
2019.0,DNK,46357,46357,1365,1218,147,0.02627435,0.029445391,0.003171042
2020.0,DNK,46210,46210,1452,1294,158,0.028002597,0.03142177,0.0034191734
2021.0,DNK,44479,44479,1425,1245,180,0.027990738,0.03203759,0.0040468536
2022.0,DNK,0,0,1306,1077,229,,,
2023.0,DNK,0,0,893,680,213,,,
1996.0,DOM,42,42,0,0,0,0.0,0.0,0.0
1997.0,DOM,49,49,3,1,2,0.020408163,0.06122449,0.040816326
1998.0,DOM,54,54,0,2,-2,0.037037037,0.0,-0.037037037
1999.0,DOM,53,53,6,8,-2,0.1509434,0.11320755,-0.03773585
2000.0,DOM,51,51,2,7,-5,0.13725491,0.039215688,-0.09803922
2001.0,DOM,53,53,2,1,1,0.018867925,0.03773585,0.018867925
2002.0,DOM,57,57,3,2,1,0.03508772,0.05263158,0.01754386
2003.0,DOM,58,58,2,4,-2,0.06896552,0.03448276,-0.03448276
2004.0,DOM,65,65,3,2,1,0.03076923,0.046153847,0.015384615
2005.0,DOM,80,80,8,2,6,0.025,0.1,0.075
2006.0,DOM,95,95,7,3,4,0.031578947,0.07368421,0.042105265
2007.0,DOM,101,101,6,8,-2,0.07920792,0.05940594,-0.01980198
2008.0,DOM,112,112,5,3,2,0.026785715,0.04464286,0.017857144
2009.0,DOM,131,131,4,3,1,0.022900764,0.030534351,0.007633588
2010.0,DOM,148,148,9,6,3,0.04054054,0.06081081,0.02027027
2011.0,DOM,179,179,16,6,10,0.033519555,0.08938547,0.05586592
2012.0,DOM,208,208,14,8,6,0.03846154,0.067307696,0.028846154
2013.0,DOM,240,240,12,6,6,0.025,0.05,0.025
2014.0,DOM,252,252,7,15,-8,0.05952381,0.027777778,-0.031746034
2015.0,DOM,279,279,21,15,6,0.05376344,0.07526882,0.021505376
2016.0,DOM,311,311,25,16,9,0.051446944,0.08038585,0.028938906
2017.0,DOM,342,342,21,17,4,0.049707603,0.06140351,0.0116959065
2018.0,DOM,376,376,18,16,2,0.04255319,0.047872342,0.005319149
2019.0,DOM,430,430,32,9,23,0.020930232,0.074418604,0.053488374
2020.0,DOM,445,445,33,27,6,0.060674157,0.074157305,0.013483146
2021.0,DOM,447,447,44,19,25,0.042505592,0.098434,0.055928413
2022.0,DOM,0,0,21,18,3,,,
1996.0,DZA,784,784,0,0,0,0.0,0.0,0.0
1997.0,DZA,1033,1033,28,27,1,0.026137464,0.027105518,0.0009680542
1998.0,DZA,1319,1319,34,29,5,0.021986354,0.025777103,0.0037907506
1999.0,DZA,1525,1525,36,32,4,0.020983607,0.023606557,0.0026229508
2000.0,DZA,1740,1740,49,40,9,0.022988506,0.02816092,0.005172414
2001.0,DZA,2038,2038,68,44,24,0.021589793,0.033366047,0.011776251
2002.0,DZA,2357,2357,55,66,-11,0.028001698,0.023334747,-0.0046669496
2003.0,DZA,2779,2779,70,57,13,0.020510975,0.025188917,0.0046779416
2004.0,DZA,3456,3456,83,45,38,0.013020833,0.024016203,0.01099537
2005.0,DZA,4134,4134,61,59,2,0.014271892,0.014755685,0.00048379294
2006.0,DZA,4988,4988,86,49,37,0.009823577,0.01724138,0.0074178027
2007.0,DZA,6056,6056,104,64,40,0.010568032,0.017173052,0.00660502
2008.0,DZA,6911,6911,107,83,24,0.0120098395,0.015482564,0.0034727247
2009.0,DZA,7836,7836,132,99,33,0.012633997,0.016845329,0.004211332
2010.0,DZA,8852,8852,161,71,90,0.008020787,0.01818798,0.010167194
2011.0,DZA,9967,9967,188,85,103,0.008528143,0.018862246,0.010334102
2012.0,DZA,11209,11209,183,86,97,0.0076724063,0.016326167,0.00865376
2013.0,DZA,12705,12705,172,106,66,0.008343172,0.013537977,0.005194805
2014.0,DZA,14390,14390,235,96,139,0.0066712997,0.016330786,0.009659486
2015.0,DZA,15975,15975,219,104,115,0.006510172,0.01370892,0.007198748
2016.0,DZA,17565,17565,232,127,105,0.0072302874,0.013208084,0.005977797
2017.0,DZA,18924,18924,233,126,107,0.006658212,0.012312408,0.005654196
2018.0,DZA,20139,20139,252,154,98,0.0076468545,0.012513034,0.00486618
2019.0,DZA,20961,20961,282,135,147,0.0064405324,0.013453556,0.0070130243
2020.0,DZA,21576,21576,260,163,97,0.0075546904,0.012050427,0.004495736
2021.0,DZA,21303,21303,268,158,110,0.007416796,0.012580387,0.005163592
2022.0,DZA,0,0,144,124,20,,,
2023.0,DZA,0,0,82,61,21,,,
1996.0,ECU,209,209,0,0,0,0.0,0.0,0.0
1997.0,ECU,251,251,7,2,5,0.007968128,0.027888447,0.01992032
1998.0,ECU,292,292,9,15,-6,0.051369864,0.030821918,-0.020547945
1999.0,ECU,313,313,13,13,0,0.041533545,0.041533545,0.0
2000.0,ECU,338,338,18,19,-1,0.056213018,0.053254437,-0.00295858
2001.0,ECU,381,381,26,34,-8,0.089238845,0.06824147,-0.020997375
2002.0,ECU,436,436,26,21,5,0.04816514,0.059633028,0.01146789
2003.0,ECU,485,485,29,31,-2,0.063917525,0.059793815,-0.0041237115
2004.0,ECU,539,539,17,33,-16,0.06122449,0.031539887,-0.029684601
2005.0,ECU,590,590,27,32,-5,0.054237287,0.04576271,-0.008474576
2006.0,ECU,633,633,33,37,-4,0.058451816,0.0521327,-0.0063191154
2007.0,ECU,709,709,30,36,-6,0.05077574,0.042313118,-0.008462624
2008.0,ECU,795,795,40,27,13,0.033962265,0.050314464,0.0163522
2009.0,ECU,856,856,45,47,-2,0.054906543,0.052570093,-0.0023364485
2010.0,ECU,935,935,37,28,9,0.029946525,0.039572194,0.009625669
2011.0,ECU,1079,1079,59,40,19,0.037071362,0.054680258,0.017608898
2012.0,ECU,1265,1265,62,57,5,0.04505929,0.049011856,0.0039525693
2013.0,ECU,1682,1682,118,60,58,0.03567182,0.07015458,0.03448276
2014.0,ECU,2261,2261,145,61,84,0.026979214,0.06413092,0.0371517
2015.0,ECU,3303,3303,263,56,207,0.016954284,0.079624586,0.0626703
2016.0,ECU,4400,4400,264,106,158,0.024090908,0.06,0.03590909
2017.0,ECU,5615,5615,312,131,181,0.023330364,0.05556545,0.032235086
2018.0,ECU,6684,6684,340,205,135,0.030670257,0.050867744,0.020197487
2019.0,ECU,7562,7562,341,209,132,0.027638191,0.04509389,0.017455699
2020.0,ECU,7982,7982,340,237,103,0.029691806,0.04259584,0.012904034
2021.0,ECU,7764,7764,280,287,-7,0.036965482,0.036063883,-0.0009015971
2022.0,ECU,0,0,228,213,15,,,
2023.0,ECU,0,0,125,88,37,,,
1996.0,EGY,5442,5442,0,0,0,0.0,0.0,0.0
1997.0,EGY,6554,6554,150,106,44,0.01617333,0.022886787,0.0067134574
1998.0,EGY,7688,7688,190,145,45,0.018860562,0.02471384,0.0058532776
1999.0,EGY,8219,8219,189,176,13,0.021413798,0.022995498,0.001581701
2000.0,EGY,8702,8702,219,180,39,0.0206849,0.025166629,0.004481728
2001.0,EGY,9214,9214,227,239,-12,0.025938788,0.024636423,-0.0013023659
2002.0,EGY,9848,9848,262,205,57,0.02081641,0.026604386,0.0057879775
2003.0,EGY,10594,10594,308,210,98,0.019822542,0.02907306,0.009250519
2004.0,EGY,11563,11563,258,216,42,0.018680273,0.022312548,0.0036322754
2005.0,EGY,12566,12566,287,228,59,0.018144198,0.022839408,0.004695209
2006.0,EGY,13826,13826,345,256,89,0.01851584,0.024952987,0.0064371475
2007.0,EGY,16048,16048,426,314,112,0.019566301,0.026545364,0.0069790627
2008.0,EGY,18549,18549,459,324,135,0.01746725,0.024745269,0.0072780205
2009.0,EGY,21603,21603,468,460,8,0.021293338,0.021663658,0.00037031894
2010.0,EGY,24685,24685,526,512,14,0.020741342,0.021308487,0.00056714605
2011.0,EGY,27584,27584,613,555,58,0.02012036,0.022223027,0.0021026682
2012.0,EGY,30129,30129,724,609,115,0.020213084,0.024030004,0.0038169206
2013.0,EGY,32862,32862,718,636,82,0.019353662,0.021848945,0.0024952833
2014.0,EGY,36143,36143,774,730,44,0.020197548,0.021414936,0.0012173865
2015.0,EGY,38558,38558,832,747,85,0.019373411,0.021577884,0.0022044713
2016.0,EGY,42069,42069,904,775,129,0.018422116,0.021488506,0.003066391
2017.0,EGY,46131,46131,838,853,-15,0.01849082,0.01816566,-0.00032516095
2018.0,EGY,50820,50820,1010,923,87,0.01816214,0.019874066,0.0017119244
2019.0,EGY,54865,54865,1061,1046,15,0.019064978,0.019338377,0.00027339833
2020.0,EGY,57808,57808,1204,1092,112,0.018890118,0.020827567,0.001937448
2021.0,EGY,57145,57145,1167,1149,18,0.020106746,0.020421734,0.0003149882
2022.0,EGY,0,0,973,1006,-33,,,
2023.0,EGY,0,0,641,696,-55,,,
1996.0,ERI,9,9,0,0,0,0.0,0.0,0.0
1997.0,ERI,11,11,2,0,2,0.0,0.18181819,0.18181819
1998.0,ERI,16,16,2,1,1,0.0625,0.125,0.0625
2000.0,ERI,21,21,3,0,3,0.0,0.14285715,0.14285715
2001.0,ERI,33,33,4,1,3,0.030303031,0.121212125,0.09090909
2002.0,ERI,40,40,6,2,4,0.05,0.15,0.1
2003.0,ERI,53,53,5,1,4,0.018867925,0.094339624,0.0754717
2004.0,ERI,78,78,5,3,2,0.03846154,0.06410257,0.025641026
2005.0,ERI,75,75,3,9,-6,0.12,0.04,-0.08
2006.0,ERI,75,75,5,4,1,0.053333335,0.06666667,0.013333334
2007.0,ERI,73,73,4,3,1,0.04109589,0.05479452,0.01369863
2008.0,ERI,76,76,4,2,2,0.02631579,0.05263158,0.02631579
2009.0,ERI,69,69,3,12,-9,0.17391305,0.04347826,-0.13043478
2010.0,ERI,50,50,3,5,-2,0.1,0.06,-0.04
2011.0,ERI,60,60,5,4,1,0.06666667,0.083333336,0.016666668
2012.0,ERI,55,55,1,10,-9,0.18181819,0.018181818,-0.16363636
2013.0,ERI,60,60,4,5,-1,0.083333336,0.06666667,-0.016666668
2014.0,ERI,52,52,2,2,0,0.03846154,0.03846154,0.0
2015.0,ERI,69,69,5,3,2,0.04347826,0.072463766,0.028985508
2016.0,ERI,81,81,2,5,-3,0.061728396,0.024691358,-0.037037037
2017.0,ERI,108,108,7,2,5,0.018518519,0.06481481,0.046296295
2018.0,ERI,120,120,4,5,-1,0.041666668,0.033333335,-0.008333334
2019.0,ERI,131,131,5,6,-1,0.045801528,0.03816794,-0.007633588
2020.0,ERI,138,138,4,10,-6,0.072463766,0.028985508,-0.04347826
2021.0,ERI,122,122,0,7,-7,0.057377048,0.0,-0.057377048
2022.0,ERI,0,0,4,9,-5,,,
1996.0,ESP,59926,59926,0,0,0,0.0,0.0,0.0
1997.0,ESP,69867,69867,920,871,49,0.012466543,0.013167876,0.0007013325
1998.0,ESP,79407,79407,975,1142,-167,0.014381603,0.012278515,-0.0021030891
1999.0,ESP,85906,85906,1140,1196,-56,0.013922194,0.0132703185,-0.0006518753
2000.0,ESP,91951,91951,1292,1273,19,0.01384433,0.0140509615,0.0002066318
2001.0,ESP,97399,97399,1485,1529,-44,0.015698314,0.015246563,-0.00045175
2002.0,ESP,103416,103416,1563,1590,-27,0.015374797,0.015113715,-0.00026108147
2003.0,ESP,109748,109748,1565,1539,26,0.014023035,0.014259941,0.00023690637
2004.0,ESP,117767,117767,1427,1429,-2,0.012134129,0.0121171465,-1.6982685e-05
2005.0,ESP,124965,124965,1485,1391,94,0.011131117,0.011883328,0.0007522106
2006.0,ESP,133595,133595,1606,1508,98,0.0112878475,0.012021408,0.00073356036
2007.0,ESP,142607,142607,1887,1619,268,0.011352879,0.01323217,0.0018792907
2008.0,ESP,151302,151302,2066,1972,94,0.013033535,0.013654809,0.000621274
2009.0,ESP,160138,160138,2298,2163,135,0.0135071,0.014350123,0.0008430229
2010.0,ESP,169806,169806,2693,2286,407,0.0134624215,0.015859274,0.002396853
2011.0,ESP,178055,178055,2595,2568,27,0.01442251,0.014574149,0.00015163854
2012.0,ESP,186166,186166,2482,2897,-415,0.01556138,0.013332187,-0.0022291932
2013.0,ESP,194016,194016,2467,3356,-889,0.017297542,0.012715446,-0.0045820964
2014.0,ESP,200813,200813,2451,3934,-1483,0.019590365,0.012205385,-0.00738498
2015.0,ESP,206831,206831,2580,4252,-1672,0.020557847,0.012473952,-0.008083895
2016.0,ESP,213245,213245,2811,4284,-1473,0.020089569,0.013182021,-0.006907548
2017.0,ESP,220319,220319,3121,4230,-1109,0.019199433,0.014165823,-0.0050336104
2018.0,ESP,228629,228629,3359,4130,-771,0.0180642,0.014691925,-0.0033722755
2019.0,ESP,236230,236230,3527,4006,-479,0.016958049,0.014930365,-0.0020276848
2020.0,ESP,237537,237537,3800,3893,-93,0.016389025,0.015997509,-0.00039151794
2021.0,ESP,229577,229577,3619,3889,-270,0.01693985,0.015763775,-0.001176076
2022.0,ESP,0,0,3348,3065,283,,,
2023.0,ESP,0,0,2211,1844,367,,,
1996.0,EST,1052,1052,0,0,0,0.0,0.0,0.0
1997.0,EST,1274,1274,29,26,3,0.020408163,0.02276295,0.0023547881
1998.0,EST,1454,1454,22,28,-6,0.019257221,0.0151306745,-0.0041265474
1999.0,EST,1554,1554,29,30,-1,0.019305019,0.01866152,-0.00064350065
2000.0,EST,1655,1655,39,48,-9,0.02900302,0.023564955,-0.0054380666
2001.0,EST,1829,1829,50,40,10,0.021869874,0.027337343,0.0054674684
2002.0,EST,1975,1975,60,35,25,0.017721519,0.030379746,0.012658228
2003.0,EST,2142,2142,48,37,11,0.017273577,0.022408964,0.0051353876
2004.0,EST,2395,2395,44,33,11,0.013778706,0.018371608,0.004592902
2005.0,EST,2709,2709,38,28,10,0.010335918,0.014027316,0.003691399
2006.0,EST,3025,3025,37,19,18,0.0062809917,0.012231405,0.005950413
2007.0,EST,3292,3292,38,40,-2,0.012150669,0.011543135,-0.00060753344
2008.0,EST,3582,3582,60,48,12,0.013400335,0.01675042,0.0033500837
2009.0,EST,3924,3924,55,35,20,0.00891947,0.01401631,0.0050968397
2010.0,EST,4198,4198,74,49,25,0.011672225,0.017627442,0.005955217
2011.0,EST,4483,4483,90,48,42,0.010707116,0.020075843,0.009368726
2012.0,EST,4769,4769,80,69,11,0.014468442,0.016775005,0.0023065633
2013.0,EST,4995,4995,79,58,21,0.011611612,0.015815815,0.0042042043
2014.0,EST,5204,5204,89,77,12,0.01479631,0.017102228,0.0023059186
2015.0,EST,5342,5342,83,109,-26,0.020404343,0.015537252,-0.004867091
2016.0,EST,5439,5439,97,112,-15,0.02059202,0.01783416,-0.0027578599
2017.0,EST,5544,5544,112,109,3,0.019660894,0.02020202,0.00054112554
2018.0,EST,5700,5700,127,113,14,0.01982456,0.022280702,0.0024561402
2019.0,EST,5756,5756,145,137,8,0.02380125,0.025191104,0.0013898541
2020.0,EST,5758,5758,157,106,51,0.01840917,0.027266411,0.008857242
2021.0,EST,5553,5553,153,119,34,0.021429857,0.027552674,0.0061228164
2022.0,EST,0,0,169,117,52,,,
2023.0,EST,0,0,81,87,-6,,,
1996.0,ETH,397,397,0,0,0,0.0,0.0,0.0
1997.0,ETH,476,476,12,19,-7,0.039915968,0.025210084,-0.014705882
1998.0,ETH,553,553,22,21,1,0.03797468,0.039783,0.0018083183
1999.0,ETH,606,606,27,21,6,0.034653466,0.044554457,0.00990099
2000.0,ETH,658,658,25,42,-17,0.06382979,0.037993923,-0.025835866
2001.0,ETH,711,711,36,39,-3,0.05485232,0.050632913,-0.004219409
2002.0,ETH,749,749,30,35,-5,0.046728972,0.040053405,-0.0066755675
2003.0,ETH,831,831,61,46,15,0.055354994,0.073405534,0.018050542
2004.0,ETH,967,967,55,35,20,0.036194414,0.05687694,0.020682523
2005.0,ETH,1109,1109,52,38,14,0.034265105,0.04688909,0.012623985
2006.0,ETH,1304,1304,57,37,20,0.028374232,0.043711655,0.015337423
2007.0,ETH,1487,1487,62,48,14,0.03227976,0.041694686,0.009414929
2008.0,ETH,1699,1699,69,48,21,0.028251912,0.040612124,0.012360211
2009.0,ETH,1959,1959,70,81,-11,0.041347627,0.035732515,-0.0056151096
2010.0,ETH,2340,2340,87,72,15,0.03076923,0.03717949,0.0064102565
2011.0,ETH,2836,2836,103,84,19,0.029619182,0.03631876,0.006699577
2012.0,ETH,3462,3462,111,93,18,0.026863085,0.032062393,0.0051993066
2013.0,ETH,4076,4076,111,105,6,0.02576055,0.027232582,0.0014720313
2014.0,ETH,4766,4766,139,138,1,0.028955098,0.029164918,0.00020981955
2015.0,ETH,5657,5657,145,144,1,0.025455188,0.02563196,0.00017677214
2016.0,ETH,6852,6852,220,152,68,0.022183305,0.032107413,0.00992411
2017.0,ETH,8275,8275,235,171,64,0.020664653,0.028398791,0.007734139
2018.0,ETH,10337,10337,302,211,91,0.020412112,0.02921544,0.008803328
2019.0,ETH,12695,12695,340,221,119,0.017408429,0.026782198,0.009373769
2020.0,ETH,14511,14511,388,245,143,0.016883744,0.026738336,0.009854593
2021.0,ETH,14470,14470,370,280,90,0.01935038,0.025570145,0.006219765
2022.0,ETH,0,0,280,258,22,,,
2023.0,ETH,0,0,181,218,-37,,,
2004.0,EUE,8,8,0,0,0,0.0,0.0,0.0
2005.0,EUE,10,10,2,0,2,0.0,0.2,0.2
2017.0,EUE,1,1,0,0,0,0.0,0.0,0.0
2020.0,EUE,14,14,3,0,3,0.0,0.21428572,0.21428572
2021.0,EUE,9,9,1,6,-5,0.6666667,0.11111111,-0.5555556
1996.0,FIN,13013,13013,0,0,0,0.0,0.0,0.0
1997.0,FIN,14978,14978,252,238,14,0.015889972,0.016824676,0.0009347042
1998.0,FIN,16926,16926,281,304,-23,0.017960533,0.016601678,-0.0013588562
1999.0,FIN,18426,18426,322,315,7,0.01709541,0.017475307,0.00037989797
2000.0,FIN,19579,19579,341,386,-45,0.019715,0.01741662,-0.002298381
2001.0,FIN,20662,20662,427,423,4,0.020472365,0.020665957,0.0001935921
2002.0,FIN,21662,21662,463,463,0,0.021373834,0.021373834,0.0
2003.0,FIN,22658,22658,434,437,-3,0.019286785,0.019154383,-0.00013240357
2004.0,FIN,23654,23654,361,354,7,0.014965756,0.015261689,0.00029593304
2005.0,FIN,24592,24592,336,345,-9,0.014028952,0.01366298,-0.00036597266
2006.0,FIN,25633,25633,346,360,-14,0.014044396,0.013498225,-0.0005461709
2007.0,FIN,26625,26625,353,351,2,0.013183098,0.013258216,7.511737e-05
2008.0,FIN,27545,27545,391,425,-34,0.015429297,0.014194953,-0.0012343439
2009.0,FIN,28485,28485,390,442,-52,0.015516939,0.013691417,-0.0018255222
2010.0,FIN,29355,29355,477,501,-24,0.017066939,0.01624936,-0.00081757794
2011.0,FIN,30260,30260,482,531,-49,0.017547918,0.015928619,-0.0016192994
2012.0,FIN,31407,31407,558,524,34,0.016684178,0.01776674,0.0010825612
2013.0,FIN,32610,32610,573,523,50,0.016038025,0.017571297,0.001533272
2014.0,FIN,33462,33462,604,579,25,0.01730321,0.018050326,0.0007471161
2015.0,FIN,34255,34255,647,662,-15,0.019325646,0.018887755,-0.00043789227
2016.0,FIN,35013,35013,660,781,-121,0.022306,0.018850142,-0.0034558591
2017.0,FIN,35573,35573,683,774,-91,0.021758076,0.019199954,-0.0025581198
2018.0,FIN,36236,36236,769,804,-35,0.02218788,0.02122199,-0.0009658903
2019.0,FIN,36741,36741,884,732,152,0.019923247,0.024060315,0.0041370676
2020.0,FIN,36508,36508,896,769,127,0.021063877,0.024542566,0.0034786896
2021.0,FIN,35159,35159,907,744,163,0.02116101,0.025797093,0.004636082
2022.0,FIN,0,0,868,627,241,,,
2023.0,FIN,0,0,516,460,56,,,
1996.0,FJI,44,44,0,0,0,0.0,0.0,0.0
1997.0,FJI,63,63,4,2,2,0.031746034,0.06349207,0.031746034
1998.0,FJI,80,80,5,3,2,0.0375,0.0625,0.025
1999.0,FJI,96,96,6,5,1,0.052083332,0.0625,0.010416667
2000.0,FJI,119,119,7,5,2,0.042016808,0.05882353,0.016806724
2001.0,FJI,124,124,9,10,-1,0.08064516,0.07258064,-0.008064516
2002.0,FJI,137,137,5,12,-7,0.08759124,0.03649635,-0.05109489
2003.0,FJI,153,153,20,15,5,0.09803922,0.13071896,0.03267974
2004.0,FJI,183,183,17,13,4,0.07103825,0.09289618,0.021857923
2005.0,FJI,206,206,14,14,0,0.067961164,0.067961164,0.0
2006.0,FJI,230,230,16,8,8,0.034782607,0.069565214,0.034782607
2007.0,FJI,229,229,11,21,-10,0.09170306,0.048034936,-0.04366812
2008.0,FJI,234,234,13,23,-10,0.0982906,0.055555556,-0.042735044
2009.0,FJI,229,229,11,21,-10,0.09170306,0.048034936,-0.04366812
2010.0,FJI,244,244,18,20,-2,0.08196721,0.07377049,-0.008196721
2011.0,FJI,264,264,22,16,6,0.060606062,0.083333336,0.022727273
2012.0,FJI,289,289,22,25,-3,0.08650519,0.076124564,-0.010380623
2013.0,FJI,309,309,21,19,2,0.061488673,0.067961164,0.006472492
2014.0,FJI,370,370,32,26,6,0.07027027,0.08648649,0.016216217
2015.0,FJI,405,405,36,25,11,0.061728396,0.08888889,0.027160494
2016.0,FJI,443,443,36,24,12,0.054176074,0.08126411,0.027088037
2017.0,FJI,496,496,41,25,16,0.050403226,0.08266129,0.032258064
2018.0,FJI,551,551,35,34,1,0.061705988,0.06352087,0.001814882
2019.0,FJI,596,596,39,32,7,0.053691275,0.065436244,0.011744967
2020.0,FJI,604,604,39,36,3,0.059602648,0.06456953,0.0049668876
2021.0,FJI,584,584,28,38,-10,0.06506849,0.047945205,-0.017123288
2022.0,FJI,0,0,22,27,-5,,,
1997.0,FLK,8,8,2,0,2,0.0,0.25,0.25
1998.0,FLK,10,10,2,2,0,0.2,0.2,0.0
1999.0,FLK,12,12,1,1,0,0.083333336,0.083333336,0.0
2000.0,FLK,12,12,3,4,-1,0.33333334,0.25,-0.083333336
2001.0,FLK,16,16,4,1,3,0.0625,0.25,0.1875
2002.0,FLK,21,21,5,4,1,0.1904762,0.23809524,0.04761905
2003.0,FLK,25,25,4,1,3,0.04,0.16,0.12
2004.0,FLK,28,28,3,2,1,0.071428575,0.10714286,0.035714287
2005.0,FLK,31,31,4,1,3,0.032258064,0.12903225,0.09677419
2006.0,FLK,27,27,4,6,-2,0.22222222,0.14814815,-0.074074075
2007.0,FLK,26,26,3,3,0,0.115384616,0.115384616,0.0
2008.0,FLK,26,26,2,5,-3,0.1923077,0.07692308,-0.115384616
2009.0,FLK,22,22,1,3,-2,0.13636364,0.045454547,-0.09090909
2010.0,FLK,23,23,2,5,-3,0.2173913,0.08695652,-0.13043478
2012.0,FLK,25,25,3,1,2,0.04,0.12,0.08
2013.0,FLK,28,28,2,3,-1,0.10714286,0.071428575,-0.035714287
2014.0,FLK,28,28,3,2,1,0.071428575,0.10714286,0.035714287
2015.0,FLK,33,33,5,2,3,0.060606062,0.15151516,0.09090909
2016.0,FLK,32,32,4,6,-2,0.1875,0.125,-0.0625
2017.0,FLK,33,33,6,4,2,0.121212125,0.18181819,0.060606062
2018.0,FLK,29,29,3,4,-1,0.13793103,0.10344828,-0.03448276
2020.0,FLK,38,38,6,2,4,0.05263158,0.15789473,0.10526316
2021.0,FLK,38,38,6,5,1,0.13157895,0.15789473,0.02631579
2022.0,FLK,0,0,3,9,-6,,,
1996.0,FRA,103986,103986,0,0,0,0.0,0.0,0.0
1997.0,FRA,117849,117849,2180,2377,-197,0.020169878,0.018498247,-0.0016716307
1998.0,FRA,130193,130193,2521,2980,-459,0.022889096,0.01936356,-0.003525535
1999.0,FRA,139276,139276,2722,3398,-676,0.024397599,0.019543927,-0.004853672
2000.0,FRA,145804,145804,3076,3700,-624,0.025376532,0.021096814,-0.004279718
2001.0,FRA,150619,150619,3475,4060,-585,0.026955431,0.023071459,-0.003883972
2002.0,FRA,155454,155454,3713,4343,-630,0.027937524,0.02388488,-0.004052646
2003.0,FRA,160362,160362,3668,4175,-507,0.026034847,0.022873249,-0.0031615968
2004.0,FRA,165583,165583,3128,3730,-602,0.022526467,0.018890828,-0.0036356389
2005.0,FRA,170794,170794,3277,3846,-569,0.022518355,0.019186856,-0.0033314987
2006.0,FRA,177593,177593,3525,4041,-516,0.022754274,0.019848755,-0.00290552
2007.0,FRA,184835,184835,3809,4351,-542,0.023539914,0.020607568,-0.002932345
2008.0,FRA,192535,192535,4171,4538,-367,0.02356974,0.021663593,-0.0019061469
2009.0,FRA,199865,199865,4354,4704,-350,0.023535887,0.021784704,-0.001751182
2010.0,FRA,207123,207123,4717,5053,-336,0.024396133,0.022773907,-0.0016222245
2011.0,FRA,213982,213982,4897,5403,-506,0.025249787,0.022885103,-0.0023646848
2012.0,FRA,221536,221536,4862,5636,-774,0.02544056,0.021946771,-0.003493789
2013.0,FRA,228488,228488,4917,5770,-853,0.025252968,0.02151973,-0.0037332377
2014.0,FRA,234696,234696,5329,6063,-734,0.025833419,0.022705968,-0.00312745
2015.0,FRA,240084,240084,5393,6276,-883,0.02614085,0.022462972,-0.0036778795
2016.0,FRA,243979,243979,5605,6537,-932,0.02679329,0.022973288,-0.003820001
2017.0,FRA,246268,246268,5516,6582,-1066,0.02672698,0.022398362,-0.004328618
2018.0,FRA,248621,248621,5618,6885,-1267,0.027692754,0.022596642,-0.00509611
2019.0,FRA,249039,249039,5582,6781,-1199,0.027228666,0.02241416,-0.004814507
2020.0,FRA,244313,244313,5630,6513,-883,0.026658425,0.02304421,-0.003614216
2021.0,FRA,232315,232315,5518,6190,-672,0.026644858,0.023752233,-0.0028926244
2022.0,FRA,0,0,4766,4810,-44,,,
2023.0,FRA,0,0,2817,2891,-74,,,
1996.0,FRO,10,10,0,0,0,0.0,0.0,0.0
1997.0,FRO,10,10,0,1,-1,0.1,0.0,-0.1
1998.0,FRO,12,12,2,1,1,0.083333336,0.16666667,0.083333336
1999.0,FRO,14,14,1,0,1,0.0,0.071428575,0.071428575
2000.0,FRO,16,16,1,2,-1,0.125,0.0625,-0.0625
2001.0,FRO,19,19,1,1,0,0.05263158,0.05263158,0.0
2002.0,FRO,23,23,2,0,2,0.0,0.08695652,0.08695652
2003.0,FRO,30,30,6,2,4,0.06666667,0.2,0.13333334
2004.0,FRO,36,36,3,0,3,0.0,0.083333336,0.083333336
2005.0,FRO,40,40,2,1,1,0.025,0.05,0.025
2006.0,FRO,39,39,1,3,-2,0.07692308,0.025641026,-0.051282052
2007.0,FRO,42,42,2,1,1,0.023809524,0.04761905,0.023809524
2008.0,FRO,52,52,5,4,1,0.07692308,0.09615385,0.01923077
2009.0,FRO,57,57,5,3,2,0.05263158,0.0877193,0.03508772
2010.0,FRO,66,66,6,4,2,0.060606062,0.09090909,0.030303031
2011.0,FRO,69,69,3,2,1,0.028985508,0.04347826,0.014492754
2012.0,FRO,77,77,5,2,3,0.025974026,0.064935066,0.038961038
2013.0,FRO,80,80,5,3,2,0.0375,0.0625,0.025
2014.0,FRO,90,90,4,1,3,0.011111111,0.044444446,0.033333335
2015.0,FRO,104,104,10,5,5,0.048076924,0.09615385,0.048076924
2016.0,FRO,105,105,5,3,2,0.028571429,0.04761905,0.01904762
2017.0,FRO,119,119,3,3,0,0.025210084,0.025210084,0.0
2018.0,FRO,130,130,10,5,5,0.03846154,0.07692308,0.03846154
2019.0,FRO,134,134,9,7,2,0.052238807,0.06716418,0.014925373
2020.0,FRO,151,151,16,6,10,0.0397351,0.105960265,0.06622516
2021.0,FRO,150,150,11,4,7,0.026666667,0.07333333,0.046666667
2022.0,FRO,0,0,7,9,-2,,,
1996.0,FSM,5,5,0,0,0,0.0,0.0,0.0
1997.0,FSM,7,7,1,0,1,0.0,0.14285715,0.14285715
1998.0,FSM,10,10,0,0,0,0.0,0.0,0.0
1999.0,FSM,11,11,2,2,0,0.18181819,0.18181819,0.0
2000.0,FSM,7,7,0,3,-3,0.42857143,0.0,-0.42857143
2001.0,FSM,10,10,0,2,-2,0.2,0.0,-0.2
2003.0,FSM,21,21,2,1,1,0.04761905,0.0952381,0.04761905
2004.0,FSM,23,23,4,3,1,0.13043478,0.17391305,0.04347826
2005.0,FSM,25,25,0,1,-1,0.04,0.0,-0.04
2006.0,FSM,27,27,0,0,0,0.0,0.0,0.0
2007.0,FSM,34,34,4,0,4,0.0,0.11764706,0.11764706
2008.0,FSM,36,36,2,0,2,0.0,0.055555556,0.055555556
2009.0,FSM,33,33,0,3,-3,0.09090909,0.0,-0.09090909
2010.0,FSM,32,32,0,0,0,0.0,0.0,0.0
2011.0,FSM,37,37,2,2,0,0.054054055,0.054054055,0.0
2012.0,FSM,31,31,0,0,0,0.0,0.0,0.0
2013.0,FSM,36,36,2,3,-1,0.083333336,0.055555556,-0.027777778
2014.0,FSM,38,38,4,4,0,0.10526316,0.10526316,0.0
2015.0,FSM,41,41,3,2,1,0.048780486,0.07317073,0.024390243
2016.0,FSM,47,47,5,0,5,0.0,0.10638298,0.10638298
2017.0,FSM,43,43,2,3,-1,0.069767445,0.046511628,-0.023255814
2018.0,FSM,42,42,2,1,1,0.023809524,0.04761905,0.023809524
2020.0,FSM,33,33,1,0,1,0.0,0.030303031,0.030303031
2022.0,FSM,0,0,0,3,-3,,,
1996.0,GAB,103,103,0,0,0,0.0,0.0,0.0
1997.0,GAB,117,117,4,7,-3,0.05982906,0.034188036,-0.025641026
1998.0,GAB,135,135,11,9,2,0.06666667,0.08148148,0.014814815
1999.0,GAB,138,138,7,12,-5,0.08695652,0.050724637,-0.036231883
2000.0,GAB,140,140,7,12,-5,0.08571429,0.05,-0.035714287
2001.0,GAB,144,144,13,15,-2,0.104166664,0.090277776,-0.013888889
2002.0,GAB,164,164,14,12,2,0.07317073,0.085365854,0.0121951215
2003.0,GAB,171,171,5,15,-10,0.0877193,0.029239766,-0.058479533
2004.0,GAB,200,200,18,6,12,0.03,0.09,0.06
2005.0,GAB,234,234,19,10,9,0.042735044,0.081196584,0.03846154
2006.0,GAB,243,243,22,13,9,0.053497944,0.09053498,0.037037037
2007.0,GAB,264,264,20,22,-2,0.083333336,0.07575758,-0.007575758
2008.0,GAB,286,286,22,14,8,0.04895105,0.07692308,0.027972028
2009.0,GAB,318,318,31,21,10,0.06603774,0.097484276,0.031446543
2010.0,GAB,328,328,10,18,-8,0.05487805,0.030487806,-0.024390243
2011.0,GAB,360,360,25,19,6,0.05277778,0.06944445,0.016666668
2012.0,GAB,370,370,20,25,-5,0.067567565,0.054054055,-0.013513514
2013.0,GAB,411,411,14,18,-4,0.04379562,0.03406326,-0.00973236
2014.0,GAB,416,416,23,20,3,0.048076924,0.05528846,0.0072115385
2015.0,GAB,446,446,32,29,3,0.065022424,0.07174888,0.0067264573
2016.0,GAB,480,480,30,35,-5,0.072916664,0.0625,-0.010416667
2017.0,GAB,515,515,35,21,14,0.0407767,0.067961164,0.027184466
2018.0,GAB,526,526,36,19,17,0.036121674,0.06844106,0.032319393
2019.0,GAB,581,581,46,29,17,0.049913943,0.07917384,0.029259896
2020.0,GAB,600,600,32,31,1,0.051666666,0.053333335,0.0016666667
2021.0,GAB,593,593,26,23,3,0.038785834,0.043844856,0.005059022
2022.0,GAB,0,0,32,18,14,,,
1996.0,GBR,124601,124601,0,0,0,0.0,0.0,0.0
1997.0,GBR,143613,143613,3322,3597,-275,0.025046479,0.02313161,-0.0019148685
1998.0,GBR,162310,162310,4075,4379,-304,0.026979238,0.025106277,-0.0018729592
1999.0,GBR,174757,174757,4575,4889,-314,0.02797599,0.02617921,-0.0017967806
2000.0,GBR,184504,184504,5244,5358,-114,0.02904002,0.028422149,-0.0006178728
2001.0,GBR,191548,191548,5894,6435,-541,0.033594713,0.030770356,-0.0028243572
2002.0,GBR,198706,198706,6166,6893,-727,0.03468944,0.031030769,-0.0036586716
2003.0,GBR,204138,204138,5785,6979,-1194,0.034187656,0.028338673,-0.0058489847
2004.0,GBR,211447,211447,5200,6109,-909,0.028891401,0.024592452,-0.0042989496
2005.0,GBR,219720,219720,5484,6016,-532,0.027380303,0.024959039,-0.0024212634
2006.0,GBR,228431,228431,5909,6125,-216,0.026813349,0.025867768,-0.00094558095
2007.0,GBR,238094,238094,6331,6364,-33,0.02672894,0.026590338,-0.00013860072
2008.0,GBR,247231,247231,6851,6908,-57,0.02794148,0.027710926,-0.00023055362
2009.0,GBR,256178,256178,6885,7321,-436,0.028577786,0.026875844,-0.0017019416
2010.0,GBR,264744,264744,7245,8221,-976,0.03105264,0.027366059,-0.0036865803
2011.0,GBR,274555,274555,7398,8648,-1250,0.031498242,0.026945421,-0.0045528216
2012.0,GBR,283496,283496,7546,8999,-1453,0.031742953,0.02661766,-0.0051252926
2013.0,GBR,293037,293037,8048,9310,-1262,0.031770732,0.027464109,-0.0043066232
2014.0,GBR,304347,304347,9020,9476,-456,0.031135513,0.029637223,-0.0014982898
2015.0,GBR,313354,313354,9495,9678,-183,0.030885197,0.030301193,-0.00058400404
2016.0,GBR,322952,322952,10342,9766,576,0.030239789,0.032023333,0.0017835468
2017.0,GBR,332244,332244,10439,10465,-26,0.031497937,0.03141968,-7.825574e-05
2018.0,GBR,341374,341374,10598,11466,-868,0.033587795,0.03104513,-0.002542666
2019.0,GBR,348323,348323,10641,11978,-1337,0.034387622,0.030549232,-0.0038383913
2020.0,GBR,344091,344091,10881,12387,-1506,0.035999198,0.031622447,-0.004376749
2021.0,GBR,327546,327546,10639,11854,-1215,0.03619034,0.032480933,-0.0037094026
2022.0,GBR,0,0,8750,10250,-1500,,,
2023.0,GBR,0,0,5577,5969,-392,,,
1996.0,GEO,627,627,0,0,0,0.0,0.0,0.0
1997.0,GEO,792,792,24,30,-6,0.03787879,0.030303031,-0.007575758
1998.0,GEO,894,894,23,47,-24,0.05257271,0.025727069,-0.026845638
1999.0,GEO,970,970,48,39,9,0.040206186,0.049484536,0.0092783505
2000.0,GEO,1000,1000,57,44,13,0.044,0.057,0.013
2001.0,GEO,1025,1025,60,75,-15,0.07317073,0.058536585,-0.014634146
2002.0,GEO,1023,1023,56,72,-16,0.07038123,0.054740958,-0.015640274
2003.0,GEO,1150,1150,47,77,-30,0.06695652,0.040869564,-0.026086956
2004.0,GEO,1288,1288,58,57,1,0.044254657,0.045031056,0.00077639753
2005.0,GEO,1374,1374,63,41,22,0.029839883,0.04585153,0.016011644
2006.0,GEO,1502,1502,53,61,-8,0.040612515,0.035286285,-0.0053262315
2007.0,GEO,1634,1634,65,52,13,0.031823747,0.03977968,0.007955937
2008.0,GEO,1691,1691,74,52,22,0.030751035,0.04376109,0.013010053
2009.0,GEO,1760,1760,80,68,12,0.038636364,0.045454547,0.006818182
2010.0,GEO,1821,1821,50,78,-28,0.042833608,0.02745744,-0.015376167
2011.0,GEO,1873,1873,72,65,7,0.034703683,0.038441002,0.0037373197
2012.0,GEO,1978,1978,75,61,14,0.03083923,0.03791709,0.0070778565
2013.0,GEO,2124,2124,70,71,-1,0.033427496,0.032956686,-0.00047080978
2014.0,GEO,2304,2304,111,88,23,0.038194444,0.048177082,0.009982639
2015.0,GEO,2518,2518,144,92,52,0.036536936,0.057188246,0.02065131
2016.0,GEO,2802,2802,216,100,116,0.035688795,0.0770878,0.041399002
2017.0,GEO,3029,3029,243,196,47,0.06470782,0.0802245,0.015516672
2018.0,GEO,3110,3110,271,279,-8,0.08971061,0.087138265,-0.0025723472
2019.0,GEO,3143,3143,294,249,45,0.07922367,0.093541205,0.014317531
2020.0,GEO,3067,3067,309,325,-16,0.10596674,0.10074992,-0.0052168244
2021.0,GEO,2962,2962,249,254,-5,0.08575287,0.08406482,-0.0016880486
2022.0,GEO,0,0,218,147,71,,,
1996.0,GHA,393,393,0,0,0,0.0,0.0,0.0
1997.0,GHA,460,460,15,16,-1,0.034782607,0.032608695,-0.002173913
1998.0,GHA,544,544,32,21,11,0.03860294,0.05882353,0.020220589
1999.0,GHA,575,575,19,36,-17,0.0626087,0.033043478,-0.029565217
2000.0,GHA,610,610,24,24,0,0.039344262,0.039344262,0.0
2001.0,GHA,661,661,33,21,12,0.031770047,0.04992436,0.018154312
2002.0,GHA,727,727,39,39,0,0.053645115,0.053645115,0.0
2003.0,GHA,825,825,44,29,15,0.035151515,0.053333335,0.018181818
2004.0,GHA,936,936,42,21,21,0.022435898,0.044871796,0.022435898
2005.0,GHA,1053,1053,40,31,9,0.029439695,0.037986703,0.008547009
2006.0,GHA,1211,1211,44,39,5,0.03220479,0.03633361,0.0041288193
2007.0,GHA,1425,1425,52,35,17,0.024561403,0.036491226,0.011929825
2008.0,GHA,1698,1698,53,38,15,0.02237927,0.031213192,0.008833922
2009.0,GHA,2009,2009,56,34,22,0.016923843,0.027874565,0.010950722
2010.0,GHA,2356,2356,75,61,14,0.025891341,0.031833615,0.005942275
2011.0,GHA,2745,2745,103,57,46,0.020765027,0.03752277,0.016757742
2012.0,GHA,3162,3162,93,64,29,0.020240353,0.029411765,0.00917141
2013.0,GHA,3622,3622,95,74,21,0.0204307,0.026228603,0.0057979017
2014.0,GHA,4190,4190,129,96,33,0.022911694,0.030787589,0.007875895
2015.0,GHA,4760,4760,163,117,46,0.024579832,0.0342437,0.009663866
2016.0,GHA,5440,5440,173,129,44,0.023713235,0.03180147,0.008088236
2017.0,GHA,6227,6227,215,180,35,0.028906375,0.03452706,0.005620684
2018.0,GHA,7087,7087,202,192,10,0.027091859,0.028502893,0.0014110343
2019.0,GHA,7898,7898,235,218,17,0.027601924,0.029754369,0.0021524436
2020.0,GHA,8619,8619,293,238,55,0.027613413,0.033994664,0.006381251
2021.0,GHA,8670,8670,348,253,95,0.029181084,0.04013841,0.010957324
2022.0,GHA,0,0,320,216,104,,,
2023.0,GHA,0,0,169,167,2,,,
1999.0,GIB,1,1,0,0,0,0.0,0.0,0.0
2002.0,GIB,1,1,0,0,0,0.0,0.0,0.0
2006.0,GIB,13,13,2,0,2,0.0,0.15384616,0.15384616
2007.0,GIB,11,11,1,3,-2,0.27272728,0.09090909,-0.18181819
2009.0,GIB,19,19,1,2,-1,0.10526316,0.05263158,-0.05263158
2010.0,GIB,15,15,1,1,0,0.06666667,0.06666667,0.0
2011.0,GIB,15,15,0,0,0,0.0,0.0,0.0
2013.0,GIB,16,16,0,1,-1,0.0625,0.0,-0.0625
2014.0,GIB,21,21,5,0,5,0.0,0.23809524,0.23809524
2015.0,GIB,27,27,7,1,6,0.037037037,0.25925925,0.22222222
2016.0,GIB,30,30,5,2,3,0.06666667,0.16666667,0.1
2017.0,GIB,27,27,1,6,-5,0.22222222,0.037037037,-0.18518518
2019.0,GIB,22,22,2,1,1,0.045454547,0.09090909,0.045454547
2020.0,GIB,22,22,3,2,1,0.09090909,0.13636364,0.045454547
2021.0,GIB,25,25,6,2,4,0.08,0.24,0.16
2022.0,GIB,0,0,1,1,0,,,
1996.0,GIN,24,24,0,0,0,0.0,0.0,0.0
1997.0,GIN,26,26,1,4,-3,0.15384616,0.03846154,-0.115384616
1998.0,GIN,35,35,3,4,-1,0.114285715,0.08571429,-0.028571429
1999.0,GIN,46,46,0,2,-2,0.04347826,0.0,-0.04347826
2000.0,GIN,50,50,3,3,0,0.06,0.06,0.0
2001.0,GIN,53,53,4,4,0,0.0754717,0.0754717,0.0
2002.0,GIN,68,68,4,1,3,0.014705882,0.05882353,0.04411765
2003.0,GIN,79,79,3,0,3,0.0,0.03797468,0.03797468
2004.0,GIN,93,93,2,1,1,0.010752688,0.021505376,0.010752688
2005.0,GIN,114,114,7,5,2,0.04385965,0.06140351,0.01754386
2006.0,GIN,120,120,5,3,2,0.025,0.041666668,0.016666668
2007.0,GIN,132,132,8,6,2,0.045454547,0.060606062,0.015151516
2008.0,GIN,133,133,3,10,-7,0.075187966,0.02255639,-0.05263158
2009.0,GIN,135,135,6,6,0,0.044444446,0.044444446,0.0
2010.0,GIN,128,128,6,10,-4,0.078125,0.046875,-0.03125
2011.0,GIN,136,136,8,6,2,0.04411765,0.05882353,0.014705882
2012.0,GIN,166,166,16,12,4,0.072289154,0.09638554,0.024096385
2013.0,GIN,195,195,19,14,5,0.071794875,0.0974359,0.025641026
2014.0,GIN,249,249,21,8,13,0.032128513,0.084337346,0.052208837
2015.0,GIN,287,287,17,17,0,0.05923345,0.05923345,0.0
2016.0,GIN,322,322,30,17,13,0.05279503,0.0931677,0.04037267
2017.0,GIN,357,357,27,29,-2,0.081232496,0.075630255,-0.005602241
2018.0,GIN,390,390,31,33,-2,0.08461539,0.07948718,-0.0051282053
2019.0,GIN,404,404,29,13,16,0.03217822,0.07178218,0.03960396
2020.0,GIN,407,407,18,25,-7,0.06142506,0.044226043,-0.017199017
2021.0,GIN,404,404,35,26,9,0.06435644,0.08663366,0.022277229
2022.0,GIN,0,0,22,13,9,,,
1996.0,GLP,88,88,0,0,0,0.0,0.0,0.0
1997.0,GLP,98,98,11,14,-3,0.14285715,0.1122449,-0.030612245
1998.0,GLP,103,103,14,19,-5,0.18446602,0.13592233,-0.048543688
1999.0,GLP,112,112,21,18,3,0.16071428,0.1875,0.026785715
2000.0,GLP,109,109,16,19,-3,0.17431192,0.14678898,-0.027522936
2001.0,GLP,105,105,10,21,-11,0.2,0.0952381,-0.104761906
2002.0,GLP,107,107,20,17,3,0.1588785,0.18691589,0.028037382
2003.0,GLP,126,126,32,17,15,0.13492064,0.25396827,0.11904762
2004.0,GLP,132,132,19,29,-10,0.21969697,0.14393939,-0.07575758
2005.0,GLP,149,149,23,14,9,0.093959734,0.15436241,0.060402684
2006.0,GLP,149,149,24,27,-3,0.18120806,0.16107382,-0.020134227
2007.0,GLP,186,186,44,29,15,0.15591398,0.23655914,0.08064516
2008.0,GLP,199,199,36,34,2,0.17085427,0.18090452,0.010050251
2009.0,GLP,211,211,45,32,13,0.15165877,0.21327014,0.061611373
2010.0,GLP,180,180,19,53,-34,0.29444444,0.10555556,-0.18888889
2011.0,GLP,185,185,33,42,-9,0.22702703,0.17837837,-0.048648648
2012.0,GLP,200,200,37,37,0,0.185,0.185,0.0
2013.0,GLP,219,219,50,30,20,0.1369863,0.2283105,0.0913242
2014.0,GLP,199,199,34,51,-17,0.2562814,0.17085427,-0.085427135
2015.0,GLP,172,172,30,55,-25,0.31976745,0.1744186,-0.14534883
2016.0,GLP,149,149,29,46,-17,0.30872482,0.19463088,-0.11409396
2017.0,GLP,124,124,33,41,-8,0.33064517,0.26612905,-0.06451613
2018.0,GLP,91,91,26,51,-25,0.5604396,0.2857143,-0.2747253
2019.0,GLP,108,108,30,24,6,0.22222222,0.2777778,0.055555556
2020.0,GLP,108,108,34,28,6,0.25925925,0.3148148,0.055555556
2021.0,GLP,88,88,20,33,-13,0.375,0.22727273,-0.14772727
2022.0,GLP,0,0,30,29,1,,,
1996.0,GMB,105,105,0,0,0,0.0,0.0,0.0
1997.0,GMB,119,119,9,10,-1,0.084033616,0.075630255,-0.008403362
1998.0,GMB,131,131,11,9,2,0.06870229,0.08396947,0.015267176
1999.0,GMB,133,133,6,9,-3,0.067669176,0.04511278,-0.02255639
2000.0,GMB,130,130,8,15,-7,0.115384616,0.06153846,-0.053846154
2001.0,GMB,137,137,16,22,-6,0.16058394,0.11678832,-0.04379562
2002.0,GMB,148,148,26,22,4,0.14864865,0.17567568,0.027027028
2003.0,GMB,178,178,29,16,13,0.08988764,0.16292135,0.073033705
2004.0,GMB,183,183,16,19,-3,0.10382514,0.08743169,-0.016393442
2005.0,GMB,189,189,15,19,-4,0.1005291,0.07936508,-0.02116402
2006.0,GMB,206,206,16,16,0,0.0776699,0.0776699,0.0
2007.0,GMB,207,207,16,23,-7,0.11111111,0.077294685,-0.033816423
2008.0,GMB,224,224,23,16,7,0.071428575,0.102678575,0.03125
2009.0,GMB,220,220,15,21,-6,0.095454544,0.06818182,-0.027272727
2010.0,GMB,225,225,17,16,1,0.07111111,0.075555556,0.0044444446
2011.0,GMB,233,233,17,25,-8,0.10729614,0.072961375,-0.034334764
2012.0,GMB,237,237,10,17,-7,0.07172996,0.042194095,-0.029535865
2013.0,GMB,264,264,26,20,6,0.07575758,0.09848485,0.022727273
2014.0,GMB,319,319,21,19,2,0.05956113,0.06583072,0.0062695923
2015.0,GMB,345,345,18,17,1,0.04927536,0.052173913,0.0028985508
2016.0,GMB,367,367,22,21,1,0.05722071,0.059945505,0.0027247956
2017.0,GMB,390,390,14,23,-9,0.05897436,0.035897437,-0.023076924
2018.0,GMB,402,402,17,42,-25,0.104477614,0.042288557,-0.062189054
2019.0,GMB,425,425,27,27,0,0.06352941,0.06352941,0.0
2020.0,GMB,436,436,33,33,0,0.07568807,0.07568807,0.0
2021.0,GMB,452,452,42,24,18,0.053097345,0.092920355,0.03982301
2022.0,GMB,0,0,35,35,0,,,
1996.0,GNB,13,13,0,0,0,0.0,0.0,0.0
1997.0,GNB,17,17,0,1,-1,0.05882353,0.0,-0.05882353
1998.0,GNB,16,16,1,3,-2,0.1875,0.0625,-0.125
1999.0,GNB,17,17,2,3,-1,0.1764706,0.11764706,-0.05882353
2000.0,GNB,19,19,2,4,-2,0.21052632,0.10526316,-0.10526316
2001.0,GNB,20,20,3,2,1,0.1,0.15,0.05
2002.0,GNB,21,21,5,6,-1,0.2857143,0.23809524,-0.04761905
2004.0,GNB,39,39,5,1,4,0.025641026,0.12820514,0.102564104
2005.0,GNB,43,43,10,2,8,0.046511628,0.23255815,0.18604651
2006.0,GNB,36,36,4,12,-8,0.33333334,0.11111111,-0.22222222
2007.0,GNB,40,40,3,3,0,0.075,0.075,0.0
2008.0,GNB,44,44,5,5,0,0.11363637,0.11363637,0.0
2009.0,GNB,45,45,3,8,-5,0.17777778,0.06666667,-0.11111111
2010.0,GNB,57,57,9,4,5,0.07017544,0.15789473,0.0877193
2011.0,GNB,70,70,6,1,5,0.014285714,0.08571429,0.071428575
2012.0,GNB,74,74,7,5,2,0.067567565,0.0945946,0.027027028
2013.0,GNB,69,69,2,6,-4,0.08695652,0.028985508,-0.057971016
2014.0,GNB,70,70,3,7,-4,0.1,0.042857144,-0.057142857
2015.0,GNB,80,80,10,8,2,0.1,0.125,0.025
2016.0,GNB,81,81,10,6,4,0.074074075,0.12345679,0.049382716
2017.0,GNB,88,88,6,3,3,0.03409091,0.06818182,0.03409091
2019.0,GNB,85,85,5,4,1,0.047058824,0.05882353,0.011764706
2020.0,GNB,80,80,6,3,3,0.0375,0.075,0.0375
2021.0,GNB,83,83,9,4,5,0.04819277,0.10843374,0.060240965
2022.0,GNB,0,0,4,3,1,,,
1996.0,GNQ,4,4,0,0,0,0.0,0.0,0.0
1997.0,GNQ,6,6,0,0,0,0.0,0.0,0.0
1998.0,GNQ,6,6,1,1,0,0.16666667,0.16666667,0.0
1999.0,GNQ,6,6,0,0,0,0.0,0.0,0.0
2001.0,GNQ,12,12,2,0,2,0.0,0.16666667,0.16666667
2002.0,GNQ,16,16,1,0,1,0.0,0.0625,0.0625
2003.0,GNQ,19,19,1,1,0,0.05263158,0.05263158,0.0
2004.0,GNQ,26,26,5,0,5,0.0,0.1923077,0.1923077
2005.0,GNQ,27,27,4,3,1,0.11111111,0.14814815,0.037037037
2006.0,GNQ,25,25,1,2,-1,0.08,0.04,-0.04
2007.0,GNQ,23,23,2,2,0,0.08695652,0.08695652,0.0
2008.0,GNQ,24,24,7,6,1,0.25,0.29166666,0.041666668
2009.0,GNQ,25,25,3,6,-3,0.24,0.12,-0.12
2010.0,GNQ,25,25,0,1,-1,0.04,0.0,-0.04
2011.0,GNQ,30,30,1,4,-3,0.13333334,0.033333335,-0.1
2012.0,GNQ,30,30,1,3,-2,0.1,0.033333335,-0.06666667
2013.0,GNQ,29,29,2,4,-2,0.13793103,0.06896552,-0.06896552
2014.0,GNQ,41,41,1,1,0,0.024390243,0.024390243,0.0
2015.0,GNQ,48,48,3,4,-1,0.083333336,0.0625,-0.020833334
2016.0,GNQ,52,52,7,8,-1,0.15384616,0.13461539,-0.01923077
2017.0,GNQ,61,61,7,5,2,0.08196721,0.114754096,0.032786883
2018.0,GNQ,60,60,10,13,-3,0.21666667,0.16666667,-0.05
2019.0,GNQ,59,59,4,9,-5,0.15254237,0.06779661,-0.084745765
2020.0,GNQ,65,65,9,2,7,0.03076923,0.13846155,0.10769231
2021.0,GNQ,57,57,1,10,-9,0.1754386,0.01754386,-0.15789473
2022.0,GNQ,0,0,8,3,5,,,
1996.0,GRC,10391,10391,0,0,0,0.0,0.0,0.0
1997.0,GRC,12277,12277,256,199,57,0.016209172,0.020852,0.004642828
1998.0,GRC,14279,14279,320,193,127,0.0135163525,0.022410532,0.00889418
1999.0,GRC,15728,15728,313,270,43,0.017166836,0.019900814,0.0027339775
2000.0,GRC,17200,17200,391,280,111,0.01627907,0.022732558,0.0064534885
2001.0,GRC,18843,18843,424,303,121,0.016080242,0.022501726,0.0064214827
2002.0,GRC,20710,20710,489,370,119,0.017865766,0.023611782,0.0057460163
2003.0,GRC,22855,22855,504,323,181,0.014132575,0.022052068,0.007919492
2004.0,GRC,25102,25102,427,309,118,0.012309776,0.017010598,0.0047008204
2005.0,GRC,27327,27327,452,343,109,0.012551689,0.016540417,0.0039887293
2006.0,GRC,29371,29371,473,347,126,0.0118143745,0.01610432,0.004289946
2007.0,GRC,31524,31524,517,442,75,0.014021063,0.016400203,0.0023791397
2008.0,GRC,33040,33040,548,473,75,0.0143159805,0.016585957,0.0022699758
2009.0,GRC,34377,34377,504,533,-29,0.015504552,0.014660965,-0.0008435873
2010.0,GRC,35259,35259,520,609,-89,0.017272186,0.014748008,-0.0025241782
2011.0,GRC,35877,35877,501,666,-165,0.018563425,0.013964378,-0.004599047
2012.0,GRC,36319,36319,524,765,-241,0.021063356,0.01442771,-0.0066356454
2013.0,GRC,36520,36520,478,860,-382,0.02354874,0.013088718,-0.010460022
2014.0,GRC,36708,36708,490,954,-464,0.025988886,0.013348589,-0.0126402965
2015.0,GRC,37042,37042,520,919,-399,0.024809675,0.0140381185,-0.010771557
2016.0,GRC,37500,37500,489,923,-434,0.024613334,0.01304,-0.011573333
2017.0,GRC,37983,37983,537,959,-422,0.025248138,0.014137904,-0.011110233
2018.0,GRC,39128,39128,606,923,-317,0.023589246,0.01548763,-0.008101615
2019.0,GRC,40315,40315,658,912,-254,0.022621853,0.01632147,-0.0063003846
2020.0,GRC,40796,40796,658,900,-242,0.022060987,0.016129032,-0.005931954
2021.0,GRC,39402,39402,699,794,-95,0.020151261,0.017740216,-0.0024110451
2022.0,GRC,0,0,616,593,23,,,
2023.0,GRC,0,0,373,392,-19,,,
1996.0,GRD,3,3,0,0,0,0.0,0.0,0.0
1999.0,GRD,6,6,1,0,1,0.0,0.16666667,0.16666667
2002.0,GRD,13,13,3,1,2,0.07692308,0.23076923,0.15384616
2004.0,GRD,25,25,3,2,1,0.08,0.12,0.04
2005.0,GRD,35,35,5,2,3,0.057142857,0.14285715,0.08571429
2006.0,GRD,56,56,7,3,4,0.05357143,0.125,0.071428575
2007.0,GRD,62,62,1,3,-2,0.048387095,0.016129032,-0.032258064
2008.0,GRD,66,66,9,5,4,0.07575758,0.13636364,0.060606062
2009.0,GRD,70,70,4,16,-12,0.22857143,0.057142857,-0.17142858
2010.0,GRD,90,90,10,10,0,0.11111111,0.11111111,0.0
2011.0,GRD,108,108,13,7,6,0.06481481,0.12037037,0.055555556
2012.0,GRD,149,149,19,5,14,0.033557046,0.12751678,0.093959734
2013.0,GRD,163,163,12,11,1,0.06748466,0.073619634,0.006134969
2014.0,GRD,179,179,17,8,9,0.044692736,0.09497207,0.05027933
2015.0,GRD,206,206,16,17,-1,0.08252427,0.0776699,-0.004854369
2016.0,GRD,214,214,14,15,-1,0.07009346,0.06542056,-0.004672897
2017.0,GRD,211,211,19,13,6,0.061611373,0.0900474,0.028436018
2018.0,GRD,239,239,22,17,5,0.07112971,0.09205021,0.020920502
2019.0,GRD,252,252,20,25,-5,0.09920635,0.07936508,-0.01984127
2020.0,GRD,254,254,21,19,2,0.07480315,0.08267716,0.007874016
2021.0,GRD,225,225,18,28,-10,0.12444445,0.08,-0.044444446
2022.0,GRD,0,0,10,16,-6,,,
1996.0,GRL,16,16,0,0,0,0.0,0.0,0.0
1997.0,GRL,16,16,1,1,0,0.0625,0.0625,0.0
1998.0,GRL,20,20,0,2,-2,0.1,0.0,-0.1
2000.0,GRL,26,26,2,2,0,0.07692308,0.07692308,0.0
2001.0,GRL,32,32,4,1,3,0.03125,0.125,0.09375
2002.0,GRL,35,35,2,3,-1,0.08571429,0.057142857,-0.028571429
2003.0,GRL,44,44,6,1,5,0.022727273,0.13636364,0.11363637
2004.0,GRL,49,49,8,5,3,0.10204082,0.1632653,0.06122449
2005.0,GRL,54,54,3,4,-1,0.074074075,0.055555556,-0.018518519
2006.0,GRL,58,58,7,6,1,0.10344828,0.12068965,0.01724138
2007.0,GRL,59,59,3,4,-1,0.06779661,0.050847456,-0.016949153
2008.0,GRL,62,62,10,9,1,0.14516129,0.16129032,0.016129032
2009.0,GRL,65,65,9,7,2,0.10769231,0.13846155,0.03076923
2010.0,GRL,69,69,5,4,1,0.057971016,0.072463766,0.014492754
2011.0,GRL,81,81,6,4,2,0.049382716,0.074074075,0.024691358
2012.0,GRL,91,91,5,4,1,0.043956045,0.054945055,0.010989011
2013.0,GRL,94,94,7,5,2,0.05319149,0.07446808,0.021276595
2014.0,GRL,98,98,6,7,-1,0.071428575,0.06122449,-0.010204081
2015.0,GRL,94,94,8,6,2,0.06382979,0.08510638,0.021276595
2016.0,GRL,105,105,12,3,9,0.028571429,0.114285715,0.08571429
2017.0,GRL,102,102,10,13,-3,0.12745099,0.09803922,-0.029411765
2018.0,GRL,107,107,10,11,-1,0.10280374,0.093457945,-0.009345794
2019.0,GRL,114,114,14,8,6,0.07017544,0.12280702,0.05263158
2020.0,GRL,116,116,7,7,0,0.060344826,0.060344826,0.0
2021.0,GRL,116,116,17,8,9,0.06896552,0.14655173,0.077586204
2022.0,GRL,0,0,8,13,-5,,,
1996.0,GTM,81,81,0,0,0,0.0,0.0,0.0
1997.0,GTM,103,103,4,5,-1,0.048543688,0.03883495,-0.009708738
1998.0,GTM,113,113,6,6,0,0.053097345,0.053097345,0.0
1999.0,GTM,112,112,6,9,-3,0.08035714,0.05357143,-0.026785715
2000.0,GTM,105,105,8,13,-5,0.123809524,0.07619048,-0.04761905
2001.0,GTM,112,112,7,8,-1,0.071428575,0.0625,-0.008928572
2002.0,GTM,121,121,12,10,2,0.08264463,0.09917355,0.016528925
2003.0,GTM,150,150,22,8,14,0.053333335,0.14666666,0.093333334
2004.0,GTM,172,172,13,6,7,0.034883723,0.075581394,0.040697675
2005.0,GTM,192,192,14,7,7,0.036458332,0.072916664,0.036458332
2006.0,GTM,197,197,6,9,-3,0.04568528,0.030456852,-0.015228426
2007.0,GTM,230,230,18,12,6,0.052173913,0.07826087,0.026086956
2008.0,GTM,248,248,6,11,-5,0.044354837,0.024193548,-0.02016129
2009.0,GTM,271,271,12,8,4,0.029520296,0.044280443,0.014760148
2010.0,GTM,291,291,13,16,-3,0.05498282,0.04467354,-0.010309278
2011.0,GTM,316,316,17,18,-1,0.056962024,0.05379747,-0.003164557
2012.0,GTM,350,350,24,15,9,0.042857144,0.068571426,0.025714286
2013.0,GTM,421,421,31,21,10,0.049881235,0.07363421,0.023752969
2014.0,GTM,470,470,17,19,-2,0.04042553,0.036170214,-0.004255319
2015.0,GTM,521,521,25,11,14,0.021113243,0.047984645,0.026871402
2016.0,GTM,556,556,37,28,9,0.05035971,0.06654676,0.01618705
2017.0,GTM,579,579,18,33,-15,0.05699482,0.031088082,-0.025906736
2018.0,GTM,624,624,29,29,0,0.04647436,0.04647436,0.0
2019.0,GTM,686,686,36,30,6,0.04373178,0.052478135,0.008746356
2020.0,GTM,687,687,37,27,10,0.03930131,0.053857353,0.014556041
2021.0,GTM,641,641,33,34,-1,0.05304212,0.05148206,-0.0015600624
2022.0,GTM,0,0,34,22,12,,,
1996.0,GUF,27,27,0,0,0,0.0,0.0,0.0
1997.0,GUF,28,28,5,7,-2,0.25,0.17857143,-0.071428575
1998.0,GUF,41,41,12,4,8,0.09756097,0.29268292,0.19512194
1999.0,GUF,39,39,3,9,-6,0.23076923,0.07692308,-0.15384616
2000.0,GUF,49,49,10,10,0,0.20408164,0.20408164,0.0
2001.0,GUF,57,57,10,6,4,0.10526316,0.1754386,0.07017544
2002.0,GUF,61,61,15,9,6,0.14754099,0.24590164,0.09836066
2003.0,GUF,77,77,20,13,7,0.16883117,0.25974026,0.09090909
2004.0,GUF,86,86,17,14,3,0.1627907,0.19767442,0.034883723
2005.0,GUF,94,94,14,15,-1,0.15957446,0.14893617,-0.010638298
2006.0,GUF,111,111,16,11,5,0.0990991,0.14414415,0.045045044
2007.0,GUF,130,130,23,9,14,0.06923077,0.17692308,0.10769231
2008.0,GUF,133,133,17,17,0,0.12781955,0.12781955,0.0
2009.0,GUF,130,130,11,25,-14,0.1923077,0.08461539,-0.10769231
2010.0,GUF,153,153,30,20,10,0.13071896,0.19607843,0.06535948
2011.0,GUF,174,174,31,25,6,0.14367816,0.17816092,0.03448276
2012.0,GUF,181,181,32,29,3,0.160221,0.17679559,0.016574586
2013.0,GUF,205,205,41,31,10,0.15121952,0.2,0.048780486
2014.0,GUF,191,191,17,48,-31,0.2513089,0.08900524,-0.16230367
2015.0,GUF,191,191,29,38,-9,0.19895288,0.15183246,-0.04712042
2016.0,GUF,189,189,25,32,-7,0.16931216,0.13227513,-0.037037037
2017.0,GUF,190,190,40,45,-5,0.23684211,0.21052632,-0.02631579
2018.0,GUF,226,226,65,41,24,0.18141593,0.28761062,0.10619469
2019.0,GUF,237,237,39,41,-2,0.17299578,0.16455697,-0.008438818
2020.0,GUF,253,253,44,25,19,0.09881423,0.17391305,0.07509881
2021.0,GUF,253,253,44,29,15,0.11462451,0.17391305,0.05928854
2022.0,GUF,0,0,23,45,-22,,,
2023.0,GUF,0,0,30,23,7,,,
1996.0,GUM,37,37,0,0,0,0.0,0.0,0.0
1997.0,GUM,41,41,2,4,-2,0.09756097,0.048780486,-0.048780486
1998.0,GUM,54,54,12,3,9,0.055555556,0.22222222,0.16666667
1999.0,GUM,54,54,3,8,-5,0.14814815,0.055555556,-0.09259259
2000.0,GUM,43,43,2,17,-15,0.39534885,0.046511628,-0.3488372
2001.0,GUM,38,38,3,8,-5,0.21052632,0.078947365,-0.13157895
2002.0,GUM,41,41,8,9,-1,0.2195122,0.19512194,-0.024390243
2003.0,GUM,49,49,8,7,1,0.14285715,0.1632653,0.020408163
2004.0,GUM,49,49,8,8,0,0.1632653,0.1632653,0.0
2005.0,GUM,52,52,7,4,3,0.07692308,0.13461539,0.057692308
2006.0,GUM,52,52,6,5,1,0.09615385,0.115384616,0.01923077
2007.0,GUM,53,53,4,7,-3,0.13207547,0.0754717,-0.056603774
2008.0,GUM,49,49,5,9,-4,0.18367347,0.10204082,-0.08163265
2009.0,GUM,55,55,7,7,0,0.12727273,0.12727273,0.0
2010.0,GUM,52,52,6,7,-1,0.13461539,0.115384616,-0.01923077
2011.0,GUM,67,67,16,4,12,0.05970149,0.23880596,0.17910448
2012.0,GUM,70,70,9,11,-2,0.15714286,0.12857144,-0.028571429
2013.0,GUM,76,76,7,7,0,0.09210526,0.09210526,0.0
2014.0,GUM,69,69,3,8,-5,0.11594203,0.04347826,-0.072463766
2015.0,GUM,69,69,6,6,0,0.08695652,0.08695652,0.0
2016.0,GUM,65,65,13,10,3,0.15384616,0.2,0.046153847
2017.0,GUM,66,66,10,13,-3,0.1969697,0.15151516,-0.045454547
2018.0,GUM,71,71,17,13,4,0.18309858,0.23943663,0.056338027
2019.0,GUM,86,86,16,15,1,0.1744186,0.18604651,0.011627907
2020.0,GUM,90,90,9,9,0,0.1,0.1,0.0
2021.0,GUM,91,91,22,19,3,0.20879121,0.24175824,0.032967035
2022.0,GUM,0,0,20,8,12,,,
1996.0,GUY,13,13,0,0,0,0.0,0.0,0.0
1997.0,GUY,22,22,2,1,1,0.045454547,0.09090909,0.045454547
1999.0,GUY,25,25,4,4,0,0.16,0.16,0.0
2000.0,GUY,25,25,7,10,-3,0.4,0.28,-0.12
2001.0,GUY,25,25,2,5,-3,0.2,0.08,-0.12
2002.0,GUY,29,29,4,3,1,0.10344828,0.13793103,0.03448276
2003.0,GUY,37,37,8,4,4,0.10810811,0.21621622,0.10810811
2004.0,GUY,44,44,5,5,0,0.11363637,0.11363637,0.0
2005.0,GUY,46,46,7,6,1,0.13043478,0.1521739,0.02173913
2006.0,GUY,41,41,5,4,1,0.09756097,0.12195122,0.024390243
2007.0,GUY,40,40,6,9,-3,0.225,0.15,-0.075
2008.0,GUY,49,49,5,8,-3,0.1632653,0.10204082,-0.06122449
2009.0,GUY,60,60,10,3,7,0.05,0.16666667,0.11666667
2010.0,GUY,60,60,2,5,-3,0.083333336,0.033333335,-0.05
2011.0,GUY,65,65,4,4,0,0.06153846,0.06153846,0.0
2012.0,GUY,73,73,3,5,-2,0.06849315,0.04109589,-0.02739726
2013.0,GUY,69,69,3,5,-2,0.072463766,0.04347826,-0.028985508
2014.0,GUY,80,80,8,4,4,0.05,0.1,0.05
2015.0,GUY,90,90,6,7,-1,0.07777778,0.06666667,-0.011111111
2016.0,GUY,90,90,5,10,-5,0.11111111,0.055555556,-0.055555556
2017.0,GUY,101,101,7,6,1,0.05940594,0.06930693,0.00990099
2018.0,GUY,123,123,9,5,4,0.040650405,0.07317073,0.032520324
2019.0,GUY,133,133,10,3,7,0.02255639,0.075187966,0.05263158
2020.0,GUY,143,143,15,8,7,0.055944055,0.10489511,0.04895105
2021.0,GUY,140,140,11,11,0,0.07857143,0.07857143,0.0
2022.0,GUY,0,0,6,12,-6,,,
1996.0,HKG,5688,5688,0,0,0,0.0,0.0,0.0
1997.0,HKG,6844,6844,280,187,93,0.027323203,0.04091175,0.013588545
1998.0,HKG,8100,8100,390,269,121,0.033209875,0.048148148,0.014938272
1999.0,HKG,9126,9126,338,371,-33,0.04065308,0.037037037,-0.003616042
2000.0,HKG,10201,10201,466,392,74,0.038427606,0.045681797,0.0072541907
2001.0,HKG,11166,11166,509,527,-18,0.047196846,0.045584813,-0.0016120365
2002.0,HKG,12176,12176,534,579,-45,0.047552563,0.043856766,-0.003695795
2003.0,HKG,12985,12985,538,616,-78,0.04743935,0.04143242,-0.006006931
2004.0,HKG,13684,13684,481,634,-153,0.046331484,0.03515054,-0.011180941
2005.0,HKG,14510,14510,539,562,-23,0.03873191,0.037146796,-0.0015851137
2006.0,HKG,15337,15337,541,583,-42,0.03801265,0.035274174,-0.0027384756
2007.0,HKG,16134,16134,579,625,-46,0.03873807,0.035886947,-0.0028511218
2008.0,HKG,16817,16817,618,723,-105,0.042992212,0.03674853,-0.006243682
2009.0,HKG,17445,17445,681,846,-165,0.04849527,0.039036974,-0.009458298
2010.0,HKG,17809,17809,699,1111,-412,0.06238419,0.03924982,-0.02313437
2011.0,HKG,18477,18477,896,1064,-168,0.057585105,0.048492722,-0.009092385
2012.0,HKG,19210,19210,1079,1102,-23,0.057365954,0.05616866,-0.001197293
2013.0,HKG,20382,20382,1108,1017,91,0.049896967,0.05436169,0.0044647236
2014.0,HKG,21329,21329,1051,1131,-80,0.053026397,0.049275633,-0.003750762
2015.0,HKG,22298,22298,1071,1211,-140,0.054309804,0.048031215,-0.00627859
2016.0,HKG,23434,23434,1267,1374,-107,0.058632758,0.05406674,-0.004566015
2017.0,HKG,24756,24756,1339,1291,48,0.052148975,0.0540879,0.0019389238
2018.0,HKG,25949,25949,1340,1599,-259,0.061620872,0.051639754,-0.009981117
2019.0,HKG,26862,26862,1324,1901,-577,0.07076912,0.04928896,-0.021480158
2020.0,HKG,27283,27283,1596,2049,-453,0.07510171,0.058497965,-0.016603746
2021.0,HKG,26069,26069,1973,2030,-57,0.077870265,0.075683765,-0.0021865051
2022.0,HKG,0,0,1861,1961,-100,,,
2023.0,HKG,0,0,1460,1423,37,,,
1996.0,HND,34,34,0,0,0,0.0,0.0,0.0
1997.0,HND,43,43,1,2,-1,0.046511628,0.023255814,-0.023255814
1998.0,HND,46,46,1,2,-1,0.04347826,0.02173913,-0.02173913
1999.0,HND,49,49,6,3,3,0.06122449,0.12244898,0.06122449
2000.0,HND,47,47,0,4,-4,0.08510638,0.0,-0.08510638
2001.0,HND,44,44,3,3,0,0.06818182,0.06818182,0.0
2002.0,HND,46,46,1,2,-1,0.04347826,0.02173913,-0.02173913
2003.0,HND,58,58,9,4,5,0.06896552,0.15517241,0.0862069
2004.0,HND,75,75,6,0,6,0.0,0.08,0.08
2005.0,HND,75,75,4,3,1,0.04,0.053333335,0.013333334
2006.0,HND,82,82,3,10,-7,0.12195122,0.036585364,-0.085365854
2007.0,HND,85,85,4,6,-2,0.07058824,0.047058824,-0.023529412
2008.0,HND,91,91,6,10,-4,0.10989011,0.06593407,-0.043956045
2009.0,HND,104,104,7,6,1,0.057692308,0.067307696,0.009615385
2010.0,HND,129,129,8,5,3,0.03875969,0.062015504,0.023255814
2011.0,HND,145,145,6,7,-1,0.048275862,0.04137931,-0.0068965517
2012.0,HND,162,162,6,3,3,0.018518519,0.037037037,0.018518519
2013.0,HND,181,181,7,4,3,0.022099448,0.038674034,0.016574586
2014.0,HND,190,190,8,13,-5,0.06842105,0.042105265,-0.02631579
2015.0,HND,217,217,6,3,3,0.013824885,0.02764977,0.013824885
2016.0,HND,244,244,6,9,-3,0.036885247,0.024590164,-0.012295082
2017.0,HND,265,265,9,8,1,0.03018868,0.033962265,0.003773585
2018.0,HND,291,291,14,12,2,0.041237112,0.048109967,0.0068728523
2019.0,HND,342,342,20,9,11,0.02631579,0.058479533,0.032163743
2020.0,HND,370,370,17,15,2,0.04054054,0.045945946,0.0054054055
2021.0,HND,359,359,17,14,3,0.038997214,0.04735376,0.008356546
2022.0,HND,0,0,17,19,-2,,,
1996.0,HRV,4114,4114,0,0,0,0.0,0.0,0.0
1997.0,HRV,4827,4827,38,53,-15,0.010979905,0.007872384,-0.0031075203
1998.0,HRV,5686,5686,65,56,9,0.009848751,0.011431586,0.001582835
1999.0,HRV,6333,6333,81,68,13,0.010737407,0.012790147,0.0020527397
2000.0,HRV,6925,6925,89,97,-8,0.01400722,0.012851985,-0.0011552346
2001.0,HRV,7615,7615,94,90,4,0.011818779,0.012344058,0.000525279
2002.0,HRV,8187,8187,101,119,-18,0.014535239,0.012336631,-0.0021986077
2003.0,HRV,8699,8699,85,95,-10,0.010920796,0.009771238,-0.0011495574
2004.0,HRV,9311,9311,66,78,-12,0.008377188,0.00708839,-0.0012887982
2005.0,HRV,10023,10023,63,84,-21,0.008380724,0.006285543,-0.002095181
2006.0,HRV,10731,10731,70,91,-21,0.008480105,0.006523157,-0.0019569471
2007.0,HRV,11696,11696,96,85,11,0.007267442,0.008207934,0.0009404925
2008.0,HRV,12595,12595,80,85,-5,0.00674871,0.006351727,-0.00039698294
2009.0,HRV,13693,13693,89,85,4,0.0062075513,0.0064996714,0.00029212006
2010.0,HRV,14585,14585,121,104,17,0.0071306136,0.0082961945,0.001165581
2011.0,HRV,15238,15238,89,123,-34,0.0080719255,0.0058406615,-0.002231264
2012.0,HRV,15734,15734,98,135,-37,0.0085801445,0.0062285494,-0.0023515953
2013.0,HRV,16085,16085,98,150,-52,0.009325459,0.0060926327,-0.0032328255
2014.0,HRV,16304,16304,131,164,-33,0.010058882,0.008034838,-0.0020240431
2015.0,HRV,16638,16638,128,176,-48,0.010578195,0.0076932325,-0.0028849621
2016.0,HRV,17023,17023,186,180,6,0.010573929,0.010926394,0.00035246433
2017.0,HRV,17490,17490,154,175,-21,0.010005717,0.008805032,-0.0012006861
2018.0,HRV,17998,17998,165,184,-19,0.010223358,0.009167685,-0.0010556729
2019.0,HRV,18597,18597,156,234,-78,0.012582675,0.008388449,-0.0041942247
2020.0,HRV,18680,18680,150,191,-41,0.01022484,0.008029979,-0.0021948607
2021.0,HRV,18027,18027,143,166,-23,0.00920841,0.007932546,-0.001275864
2022.0,HRV,0,0,122,112,10,,,
2023.0,HRV,0,0,70,76,-6,,,
1996.0,HTI,18,18,0,0,0,0.0,0.0,0.0
1997.0,HTI,23,23,4,0,4,0.0,0.17391305,0.17391305
1998.0,HTI,27,27,1,4,-3,0.14814815,0.037037037,-0.11111111
1999.0,HTI,22,22,0,7,-7,0.3181818,0.0,-0.3181818
2000.0,HTI,28,28,2,0,2,0.0,0.071428575,0.071428575
2001.0,HTI,25,25,2,2,0,0.08,0.08,0.0
2002.0,HTI,32,32,2,1,1,0.03125,0.0625,0.03125
2003.0,HTI,43,43,4,0,4,0.0,0.093023255,0.093023255
2004.0,HTI,59,59,3,5,-2,0.084745765,0.050847456,-0.033898305
2005.0,HTI,69,69,1,2,-1,0.028985508,0.014492754,-0.014492754
2006.0,HTI,88,88,13,1,12,0.011363637,0.14772727,0.13636364
2007.0,HTI,93,93,4,5,-1,0.05376344,0.043010753,-0.010752688
2008.0,HTI,98,98,1,6,-5,0.06122449,0.010204081,-0.05102041
2009.0,HTI,114,114,8,5,3,0.04385965,0.07017544,0.02631579
2010.0,HTI,125,125,2,0,2,0.0,0.016,0.016
2011.0,HTI,168,168,12,7,5,0.041666668,0.071428575,0.029761905
2012.0,HTI,193,193,11,20,-9,0.103626944,0.05699482,-0.046632126
2013.0,HTI,220,220,6,12,-6,0.054545455,0.027272727,-0.027272727
2014.0,HTI,257,257,27,6,21,0.023346303,0.105058365,0.08171206
2015.0,HTI,300,300,17,11,6,0.036666665,0.05666667,0.02
2016.0,HTI,311,311,11,13,-2,0.041800644,0.035369776,-0.006430868
2017.0,HTI,359,359,26,14,12,0.038997214,0.0724234,0.033426184
2018.0,HTI,365,365,13,22,-9,0.06027397,0.03561644,-0.024657534
2019.0,HTI,350,350,15,15,0,0.042857144,0.042857144,0.0
2020.0,HTI,352,352,19,11,8,0.03125,0.053977273,0.022727273
2021.0,HTI,349,349,25,16,9,0.045845274,0.071633235,0.025787966
2022.0,HTI,0,0,7,11,-4,,,
1996.0,HUN,8426,8426,0,0,0,0.0,0.0,0.0
1997.0,HUN,9754,9754,196,184,12,0.018864056,0.02009432,0.0012302645
1998.0,HUN,11061,11061,218,247,-29,0.02233071,0.019708887,-0.0026218244
1999.0,HUN,11923,11923,202,268,-66,0.022477563,0.016942045,-0.0055355197
2000.0,HUN,12660,12660,252,312,-60,0.02464455,0.019905213,-0.0047393367
2001.0,HUN,13227,13227,292,291,1,0.022000454,0.022076057,7.560293e-05
2002.0,HUN,13850,13850,281,329,-48,0.023754513,0.020288808,-0.003465704
2003.0,HUN,14444,14444,300,331,-31,0.02291609,0.02076987,-0.0021462198
2004.0,HUN,15077,15077,248,294,-46,0.0194999,0.016448896,-0.0030510048
2005.0,HUN,15745,15745,246,287,-41,0.01822801,0.015624007,-0.0026040012
2006.0,HUN,16639,16639,266,274,-8,0.016467337,0.015986538,-0.00048079813
2007.0,HUN,17468,17468,279,273,6,0.015628578,0.015972063,0.00034348524
2008.0,HUN,18250,18250,254,323,-69,0.01769863,0.013917808,-0.0037808218
2009.0,HUN,19021,19021,245,342,-97,0.017980127,0.0128805,-0.0050996267
2010.0,HUN,19743,19743,271,366,-95,0.018538216,0.013726384,-0.004811832
2011.0,HUN,20464,20464,274,362,-88,0.0176896,0.013389367,-0.0043002344
2012.0,HUN,21325,21325,270,348,-78,0.016318874,0.012661195,-0.0036576788
2013.0,HUN,22150,22150,304,384,-80,0.017336342,0.013724605,-0.003611738
2014.0,HUN,23057,23057,289,411,-122,0.01782539,0.012534155,-0.0052912347
2015.0,HUN,23796,23796,317,367,-50,0.0154227605,0.013321566,-0.0021011934
2016.0,HUN,24536,24536,344,427,-83,0.017403,0.014020215,-0.0033827845
2017.0,HUN,25329,25329,362,439,-77,0.017331911,0.014291918,-0.0030399936
2018.0,HUN,26092,26092,353,436,-83,0.016710103,0.013529051,-0.0031810517
2019.0,HUN,26879,26879,391,384,7,0.014286246,0.014546672,0.00026042634
2020.0,HUN,27067,27067,366,403,-37,0.0148889795,0.013522001,-0.0013669783
2021.0,HUN,26052,26052,398,452,-54,0.017349916,0.015277138,-0.0020727776
2022.0,HUN,0,0,346,388,-42,,,
2023.0,HUN,0,0,179,220,-41,,,
1996.0,IDN,874,874,0,0,0,0.0,0.0,0.0
1997.0,IDN,1122,1122,48,26,22,0.023172906,0.04278075,0.019607844
1998.0,IDN,1424,1424,66,47,19,0.033005618,0.046348315,0.013342696
1999.0,IDN,1586,1586,72,56,16,0.035308953,0.045397226,0.010088272
2000.0,IDN,1662,1662,80,93,-13,0.05595668,0.048134778,-0.007821902
2001.0,IDN,1723,1723,93,97,-4,0.056297157,0.053975623,-0.0023215322
2002.0,IDN,1853,1853,113,84,29,0.045331895,0.06098219,0.015650297
2003.0,IDN,2052,2052,129,65,64,0.03167641,0.062865496,0.031189084
2004.0,IDN,2349,2349,101,56,45,0.023839932,0.04299702,0.019157087
2005.0,IDN,2702,2702,129,52,77,0.019245004,0.04774241,0.02849741
2006.0,IDN,3083,3083,125,67,58,0.021732079,0.040544923,0.018812845
2007.0,IDN,3716,3716,181,82,99,0.022066738,0.04870829,0.02664155
2008.0,IDN,4515,4515,204,97,107,0.021483943,0.045182724,0.023698783
2009.0,IDN,5632,5632,253,85,168,0.015092329,0.044921875,0.029829545
2010.0,IDN,7012,7012,296,114,182,0.016257843,0.042213347,0.025955506
2011.0,IDN,8695,8695,296,144,152,0.016561242,0.034042552,0.01748131
2012.0,IDN,10982,10982,351,141,210,0.012839192,0.031961393,0.0191222
2013.0,IDN,14361,14361,435,168,267,0.011698349,0.030290369,0.01859202
2014.0,IDN,18718,18718,555,191,364,0.010204081,0.029650604,0.019446522
2015.0,IDN,24652,24652,591,215,376,0.008721402,0.023973715,0.015252313
2016.0,IDN,32282,32282,668,253,415,0.007837185,0.020692647,0.012855461
2017.0,IDN,42959,42959,764,306,458,0.007123071,0.0177844,0.010661328
2018.0,IDN,52405,52405,803,331,472,0.006316191,0.015322966,0.009006774
2019.0,IDN,59288,59288,845,401,444,0.0067635947,0.014252462,0.0074888677
2020.0,IDN,64219,64219,1022,544,478,0.008471013,0.015914293,0.00744328
2021.0,IDN,64382,64382,973,626,347,0.009723214,0.01511292,0.0053897053
2022.0,IDN,0,0,728,545,183,,,
2023.0,IDN,0,0,399,339,60,,,
1996.0,IND,44461,44461,0,0,0,0.0,0.0,0.0
1997.0,IND,52665,52665,476,578,-102,0.010975031,0.009038261,-0.0019367702
1998.0,IND,60182,60182,512,826,-314,0.013725034,0.008507527,-0.005217507
1999.0,IND,65579,65579,573,973,-400,0.014837067,0.008737553,-0.0060995137
2000.0,IND,70860,70860,666,1138,-472,0.016059836,0.009398814,-0.0066610216
2001.0,IND,76524,76524,757,1282,-525,0.016752914,0.009892321,-0.006860593
2002.0,IND,82609,82609,835,1423,-588,0.017225726,0.010107857,-0.0071178684
2003.0,IND,90129,90129,868,1378,-510,0.015289197,0.009630641,-0.0056585562
2004.0,IND,98714,98714,829,1516,-687,0.015357497,0.008397998,-0.0069594993
2005.0,IND,108606,108606,923,1541,-618,0.014188903,0.00849861,-0.0056902934
2006.0,IND,120680,120680,1104,1694,-590,0.014037123,0.00914816,-0.0048889625
2007.0,IND,135780,135780,1175,1883,-708,0.013868022,0.008653704,-0.0052143172
2008.0,IND,153944,153944,1258,2187,-929,0.014206464,0.008171802,-0.006034662
2009.0,IND,176056,176056,1468,2412,-944,0.013700186,0.008338256,-0.0053619305
2010.0,IND,198244,198244,1714,2653,-939,0.013382498,0.008645911,-0.0047365874
2011.0,IND,221554,221554,1912,2678,-766,0.012087347,0.008629951,-0.0034573963
2012.0,IND,247820,247820,2069,2802,-733,0.011306593,0.008348801,-0.002957792
2013.0,IND,272778,272778,2292,2993,-701,0.010972292,0.008402437,-0.0025698554
2014.0,IND,295045,295045,2454,3255,-801,0.011032215,0.008317376,-0.00271484
2015.0,IND,314144,314144,2521,3517,-996,0.011195502,0.008024982,-0.0031705205
2016.0,IND,333321,333321,2514,3866,-1352,0.011598429,0.007542279,-0.00405615
2017.0,IND,355218,355218,2562,4402,-1840,0.01239239,0.007212472,-0.005179918
2018.0,IND,374986,374986,2778,4638,-1860,0.012368462,0.0074082767,-0.0049601854
2019.0,IND,392111,392111,2939,4936,-1997,0.012588272,0.0074953265,-0.0050929454
2020.0,IND,405022,405022,3087,5285,-2198,0.013048674,0.007621808,-0.0054268655
2021.0,IND,391164,391164,3275,4996,-1721,0.012772136,0.008372447,-0.004399689
2022.0,IND,0,0,2869,4258,-1389,,,
2023.0,IND,0,0,1960,3025,-1065,,,
1997.0,IOT,1,1,0,0,0,0.0,0.0,0.0
2012.0,IOT,2,2,1,1,0,0.5,0.5,0.0
2015.0,IOT,2,2,0,0,0,0.0,0.0,0.0
2020.0,IOT,2,2,0,1,-1,0.5,0.0,-0.5
1996.0,IRL,4567,4567,0,0,0,0.0,0.0,0.0
1997.0,IRL,5329,5329,206,192,14,0.036029276,0.03865641,0.0026271346
1998.0,IRL,6182,6182,280,261,19,0.04221935,0.045292787,0.003073439
1999.0,IRL,6858,6858,288,303,-15,0.044181976,0.04199475,-0.0021872267
2000.0,IRL,7506,7506,355,304,51,0.04050093,0.047295496,0.0067945644
2001.0,IRL,8025,8025,439,332,107,0.041370716,0.05470405,0.013333334
2002.0,IRL,8956,8956,500,408,92,0.045556054,0.055828493,0.010272443
2003.0,IRL,9794,9794,478,391,87,0.0399224,0.04880539,0.008882989
2004.0,IRL,10690,10690,463,382,81,0.03573433,0.043311507,0.007577175
2005.0,IRL,11681,11681,532,411,121,0.035185345,0.045544047,0.010358702
2006.0,IRL,12897,12897,563,428,135,0.03318601,0.043653563,0.010467551
2007.0,IRL,14251,14251,630,460,170,0.032278437,0.044207424,0.011928988
2008.0,IRL,15759,15759,727,549,178,0.034837235,0.046132367,0.011295133
2009.0,IRL,17181,17181,752,588,164,0.03422385,0.04376928,0.009545428
2010.0,IRL,18305,18305,801,736,65,0.040207595,0.043758538,0.0035509423
2011.0,IRL,19259,19259,718,804,-86,0.041746717,0.03728127,-0.004465445
2012.0,IRL,20030,20030,660,886,-226,0.04423365,0.032950573,-0.011283075
2013.0,IRL,20825,20825,706,937,-231,0.044993997,0.03390156,-0.011092437
2014.0,IRL,21523,21523,719,913,-194,0.042419735,0.033406124,-0.009013614
2015.0,IRL,22299,22299,804,917,-113,0.04112292,0.036055427,-0.005067492
2016.0,IRL,23061,23061,837,978,-141,0.042409264,0.036295045,-0.006114219
2017.0,IRL,24086,24086,948,871,77,0.036162086,0.039358962,0.003196878
2018.0,IRL,25477,25477,1156,963,193,0.0377988,0.04537426,0.0075754602
2019.0,IRL,26797,26797,1263,973,290,0.036310036,0.047132142,0.010822107
2020.0,IRL,27086,27086,1327,1105,222,0.040795982,0.048992097,0.008196116
2021.0,IRL,26075,26075,1252,1199,53,0.04598274,0.04801534,0.0020325982
2022.0,IRL,0,0,1188,989,199,,,
2023.0,IRL,0,0,685,666,19,,,
1996.0,IRN,1969,1969,0,0,0,0.0,0.0,0.0
1997.0,IRN,2591,2591,42,37,5,0.014280201,0.016209958,0.0019297568
1998.0,IRN,3480,3480,97,43,54,0.012356322,0.027873563,0.015517241
1999.0,IRN,4347,4347,126,51,75,0.011732229,0.028985508,0.017253278
2000.0,IRN,5627,5627,130,65,65,0.011551448,0.023102896,0.011551448
2001.0,IRN,7233,7233,168,90,78,0.01244297,0.023226878,0.010783907
2002.0,IRN,9559,9559,230,111,119,0.011612093,0.024061095,0.012449001
2003.0,IRN,13006,13006,244,141,103,0.01084115,0.018760571,0.007919421
2004.0,IRN,17515,17515,268,140,128,0.007993149,0.015301171,0.0073080217
2005.0,IRN,23394,23394,287,177,110,0.0075660427,0.012268103,0.0047020605
2006.0,IRN,30461,30461,328,229,99,0.0075178095,0.010767867,0.0032500573
2007.0,IRN,38872,38872,372,300,72,0.0077176373,0.00956987,0.001852233
2008.0,IRN,47844,47844,356,405,-49,0.008465012,0.007440849,-0.0010241618
2009.0,IRN,59170,59170,445,548,-103,0.00926145,0.007520703,-0.001740747
2010.0,IRN,70385,70385,462,775,-313,0.0110108685,0.0065638986,-0.0044469703
2011.0,IRN,80781,80781,561,939,-378,0.0116240205,0.0069447025,-0.004679318
2012.0,IRN,90842,90842,561,1184,-623,0.013033619,0.0061755576,-0.006858061
2013.0,IRN,100030,100030,576,1443,-867,0.014425673,0.0057582725,-0.0086674
2014.0,IRN,109232,109232,665,1523,-858,0.0139428,0.0060879597,-0.007854841
2015.0,IRN,116998,116998,696,1574,-878,0.013453222,0.0059488197,-0.0075044017
2016.0,IRN,124722,124722,836,1637,-801,0.0131251905,0.0067029074,-0.006422283
2017.0,IRN,133721,133721,850,1756,-906,0.01313182,0.0063565182,-0.006775301
2018.0,IRN,142548,142548,878,1915,-1037,0.013434071,0.006159329,-0.0072747427
2019.0,IRN,148380,148380,806,2310,-1504,0.015568136,0.005431999,-0.010136137
2020.0,IRN,150213,150213,799,2602,-1803,0.017322069,0.0053191134,-0.012002956
2021.0,IRN,143899,143899,791,2605,-1814,0.018102976,0.0054969112,-0.012606064
2022.0,IRN,0,0,663,2272,-1609,,,
2023.0,IRN,0,0,445,1461,-1016,,,
1996.0,IRQ,156,156,0,0,0,0.0,0.0,0.0
1997.0,IRQ,190,190,1,2,-1,0.010526316,0.005263158,-0.005263158
1998.0,IRQ,230,230,1,7,-6,0.030434782,0.004347826,-0.026086956
1999.0,IRQ,268,268,1,4,-3,0.014925373,0.0037313432,-0.01119403
2000.0,IRQ,291,291,5,8,-3,0.02749141,0.01718213,-0.010309278
2001.0,IRQ,313,313,5,3,2,0.009584664,0.015974442,0.0063897762
2002.0,IRQ,328,328,7,7,0,0.021341464,0.021341464,0.0
2003.0,IRQ,358,358,3,8,-5,0.022346368,0.008379889,-0.01396648
2004.0,IRQ,429,429,13,12,1,0.027972028,0.030303031,0.0023310024
2005.0,IRQ,508,508,10,7,3,0.0137795275,0.01968504,0.005905512
2006.0,IRQ,622,622,13,11,2,0.017684888,0.020900322,0.003215434
2007.0,IRQ,865,865,24,26,-2,0.030057803,0.027745664,-0.0023121387
2008.0,IRQ,1161,1161,21,22,-1,0.01894918,0.018087855,-0.00086132647
2009.0,IRQ,1574,1574,25,29,-4,0.018424397,0.015883101,-0.002541296
2010.0,IRQ,2021,2021,45,32,13,0.015833745,0.022266205,0.006432459
2011.0,IRQ,2456,2456,68,39,29,0.015879478,0.027687296,0.011807818
2012.0,IRQ,2853,2853,82,48,34,0.016824394,0.028741676,0.01191728
2013.0,IRQ,3356,3356,116,53,63,0.01579261,0.034564957,0.018772349
2014.0,IRQ,4280,4280,137,76,61,0.01775701,0.032009345,0.014252337
2015.0,IRQ,5591,5591,175,94,81,0.016812734,0.031300303,0.014487569
2016.0,IRQ,9383,9383,302,105,197,0.011190451,0.032185867,0.020995418
2017.0,IRQ,14197,14197,416,101,315,0.007114179,0.029301966,0.022187786
2018.0,IRQ,18463,18463,604,133,471,0.007203596,0.032714076,0.02551048
2019.0,IRQ,21049,21049,685,188,497,0.008931541,0.032543115,0.023611574
2020.0,IRQ,23308,23308,695,207,488,0.008881071,0.029818088,0.020937018
2021.0,IRQ,23569,23569,647,275,372,0.011667869,0.027451314,0.015783444
2022.0,IRQ,0,0,414,197,217,,,
2023.0,IRQ,0,0,213,128,85,,,
1996.0,ISL,594,594,0,0,0,0.0,0.0,0.0
1997.0,ISL,687,687,26,18,8,0.026200874,0.037845705,0.011644833
1998.0,ISL,796,796,27,18,9,0.022613065,0.0339196,0.011306533
1999.0,ISL,850,850,37,40,-3,0.047058824,0.04352941,-0.0035294117
2000.0,ISL,982,982,53,27,26,0.02749491,0.053971488,0.026476579
2001.0,ISL,1047,1047,69,46,23,0.043935053,0.065902576,0.021967527
2002.0,ISL,1148,1148,84,46,38,0.040069688,0.07317073,0.033101045
2003.0,ISL,1208,1208,65,66,-1,0.054635763,0.053807948,-0.00082781457
2004.0,ISL,1300,1300,48,38,10,0.02923077,0.036923077,0.0076923077
2005.0,ISL,1367,1367,48,24,24,0.017556693,0.035113387,0.017556693
2006.0,ISL,1442,1442,54,54,0,0.03744799,0.03744799,0.0
2007.0,ISL,1551,1551,60,40,20,0.025789812,0.03868472,0.012894906
2008.0,ISL,1688,1688,58,37,21,0.021919431,0.03436019,0.012440759
2009.0,ISL,1802,1802,67,37,30,0.020532742,0.03718091,0.01664817
2010.0,ISL,1968,1968,105,38,67,0.019308943,0.05335366,0.034044717
2011.0,ISL,2032,2032,54,74,-20,0.036417324,0.026574804,-0.00984252
2012.0,ISL,2106,2106,74,70,4,0.033238366,0.0351377,0.0018993352
2013.0,ISL,2135,2135,58,79,-21,0.037002344,0.027166277,-0.009836066
2014.0,ISL,2226,2226,79,88,-9,0.039532796,0.035489667,-0.0040431265
2015.0,ISL,2324,2324,102,67,35,0.028829604,0.043889847,0.015060241
2016.0,ISL,2403,2403,83,71,12,0.0295464,0.034540158,0.0049937577
2017.0,ISL,2510,2510,85,63,22,0.025099602,0.033864543,0.00876494
2018.0,ISL,2610,2610,96,76,20,0.029118774,0.03678161,0.007662835
2019.0,ISL,2655,2655,105,85,20,0.032015067,0.03954802,0.0075329565
2020.0,ISL,2660,2660,102,88,14,0.033082705,0.038345866,0.005263158
2021.0,ISL,2606,2606,108,89,19,0.034151956,0.041442823,0.007290867
2022.0,ISL,0,0,88,53,35,,,
2023.0,ISL,0,0,50,60,-10,,,
1996.0,ISR,16302,16302,0,0,0,0.0,0.0,0.0
1997.0,ISR,18575,18575,465,429,36,0.02309556,0.025033647,0.0019380888
1998.0,ISR,20855,20855,528,508,20,0.024358667,0.025317669,0.00095900265
1999.0,ISR,22504,22504,562,529,33,0.023506932,0.024973338,0.0014664059
2000.0,ISR,23704,23704,593,621,-28,0.02619811,0.025016874,-0.0011812352
2001.0,ISR,24974,24974,678,672,6,0.026907984,0.027148234,0.00024024986
2002.0,ISR,26274,26274,684,748,-64,0.028469209,0.02603334,-0.0024358681
2003.0,ISR,27339,27339,550,800,-250,0.029262226,0.02011778,-0.009144446
2004.0,ISR,28311,28311,458,724,-266,0.025573099,0.016177457,-0.009395641
2005.0,ISR,29304,29304,475,686,-211,0.023409773,0.016209392,-0.007200382
2006.0,ISR,30331,30331,446,676,-230,0.022287428,0.014704428,-0.0075830007
2007.0,ISR,31283,31283,472,691,-219,0.022088675,0.015088067,-0.0070006074
2008.0,ISR,32249,32249,523,700,-177,0.021706099,0.016217558,-0.0054885424
2009.0,ISR,32943,32943,619,782,-163,0.02373797,0.01879003,-0.0049479404
2010.0,ISR,33855,33855,604,738,-134,0.021798847,0.017840791,-0.003958056
2011.0,ISR,34784,34784,710,727,-17,0.020900413,0.020411683,-0.00048873044
2012.0,ISR,35812,35812,679,762,-83,0.021277783,0.018960126,-0.0023176589
2013.0,ISR,37149,37149,725,744,-19,0.020027457,0.019516002,-0.0005114539
2014.0,ISR,38358,38358,796,814,-18,0.021221127,0.020751864,-0.00046926326
2015.0,ISR,39822,39822,906,813,93,0.02041585,0.022751244,0.0023353924
2016.0,ISR,41122,41122,892,953,-61,0.023174943,0.021691551,-0.0014833909
2017.0,ISR,42219,42219,945,954,-9,0.022596462,0.022383288,-0.00021317416
2018.0,ISR,43537,43537,978,982,-4,0.022555528,0.022463651,-9.1875874e-05
2019.0,ISR,44757,44757,1056,968,88,0.021627901,0.023594074,0.0019661728
2020.0,ISR,45002,45002,1103,1037,66,0.02304342,0.024510022,0.0014666015
2021.0,ISR,43410,43410,1071,1039,32,0.023934577,0.024671735,0.00073715736
2022.0,ISR,0,0,825,818,7,,,
2023.0,ISR,0,0,574,566,8,,,
1996.0,ITA,87791,87791,0,0,0,0.0,0.0,0.0
1997.0,ITA,98764,98764,1198,1262,-64,0.012777936,0.012129926,-0.0006480094
1998.0,ITA,109446,109446,1305,1605,-300,0.014664766,0.011923688,-0.0027410777
1999.0,ITA,116811,116811,1473,1630,-157,0.013954165,0.012610114,-0.0013440514
2000.0,ITA,122539,122539,1636,1808,-172,0.014754486,0.013350852,-0.0014036348
2001.0,ITA,127888,127888,1915,2017,-102,0.015771613,0.01497404,-0.0007975729
2002.0,ITA,134353,134353,2119,2067,52,0.0153848445,0.015771884,0.0003870401
2003.0,ITA,141054,141054,1880,1982,-102,0.014051356,0.013328229,-0.00072312733
2004.0,ITA,148212,148212,1556,1709,-153,0.01153078,0.010498475,-0.0010323051
2005.0,ITA,155800,155800,1575,1774,-199,0.011386393,0.010109114,-0.0012772785
2006.0,ITA,163939,163939,1697,1831,-134,0.011168788,0.010351411,-0.0008173772
2007.0,ITA,171867,171867,1708,2075,-367,0.01207329,0.009937917,-0.002135372
2008.0,ITA,178738,178738,1728,2349,-621,0.013142141,0.009667782,-0.0034743592
2009.0,ITA,185501,185501,1806,2577,-771,0.013892109,0.009735797,-0.004156312
2010.0,ITA,192472,192472,1953,2779,-826,0.014438463,0.010146931,-0.0042915335
2011.0,ITA,200673,200673,2046,3031,-985,0.015104175,0.010195691,-0.004908483
2012.0,ITA,207746,207746,2115,3190,-1075,0.01535529,0.0101807015,-0.0051745884
2013.0,ITA,214719,214719,2282,3382,-1100,0.015750818,0.010627843,-0.0051229745
2014.0,ITA,221386,221386,2483,3535,-1052,0.015967585,0.0112157045,-0.004751881
2015.0,ITA,227418,227418,2496,3767,-1271,0.016564213,0.010975384,-0.0055888277
2016.0,ITA,232859,232859,2582,4097,-1515,0.017594337,0.011088255,-0.006506083
2017.0,ITA,239388,239388,2754,4232,-1478,0.017678414,0.011504336,-0.0061740773
2018.0,ITA,248905,248905,3045,4276,-1231,0.017179245,0.012233583,-0.004945662
2019.0,ITA,256592,256592,3244,4237,-993,0.016512595,0.012642639,-0.003869957
2020.0,ITA,258415,258415,3510,4011,-501,0.015521545,0.013582803,-0.001938742
2021.0,ITA,249361,249361,3697,3812,-115,0.015287073,0.014825895,-0.00046117877
2022.0,ITA,0,0,3195,3225,-30,,,
2023.0,ITA,0,0,2180,2062,118,,,
1996.0,JAM,276,276,0,0,0,0.0,0.0,0.0
1997.0,JAM,320,320,11,13,-2,0.040625,0.034375,-0.00625
1998.0,JAM,355,355,6,15,-9,0.04225352,0.01690141,-0.025352113
1999.0,JAM,401,401,20,12,8,0.029925186,0.04987531,0.019950125
2000.0,JAM,425,425,14,20,-6,0.047058824,0.032941177,-0.014117647
2001.0,JAM,453,453,25,14,11,0.030905077,0.05518764,0.024282562
2002.0,JAM,495,495,21,22,-1,0.044444446,0.042424243,-0.002020202
2003.0,JAM,521,521,19,20,-1,0.038387716,0.03646833,-0.0019193857
2004.0,JAM,532,532,12,26,-14,0.04887218,0.02255639,-0.02631579
2005.0,JAM,564,564,14,17,-3,0.030141843,0.024822695,-0.005319149
2006.0,JAM,632,632,24,15,9,0.023734177,0.03797468,0.014240506
2007.0,JAM,661,661,12,13,-1,0.019667171,0.018154312,-0.0015128592
2008.0,JAM,663,663,19,28,-9,0.04223228,0.028657617,-0.013574661
2009.0,JAM,701,701,30,33,-3,0.047075607,0.042796005,-0.0042796005
2010.0,JAM,727,727,24,43,-19,0.05914718,0.03301238,-0.0261348
2011.0,JAM,745,745,48,17,31,0.022818793,0.06442953,0.041610736
2012.0,JAM,772,772,29,21,8,0.027202072,0.037564766,0.010362694
2013.0,JAM,792,792,27,34,-7,0.04292929,0.03409091,-0.0088383835
2014.0,JAM,805,805,38,26,12,0.032298137,0.047204968,0.014906832
2015.0,JAM,808,808,42,36,6,0.044554457,0.051980197,0.0074257427
2016.0,JAM,803,803,28,39,-11,0.04856787,0.03486924,-0.01369863
2017.0,JAM,808,808,33,31,2,0.038366336,0.040841583,0.0024752475
2018.0,JAM,804,804,35,32,3,0.039800994,0.043532338,0.0037313432
2019.0,JAM,815,815,35,41,-6,0.05030675,0.042944785,-0.0073619634
2020.0,JAM,786,786,27,41,-14,0.05216285,0.034351144,-0.017811704
2021.0,JAM,743,743,36,33,3,0.044414535,0.04845222,0.004037685
2022.0,JAM,0,0,17,32,-15,,,
1996.0,JOR,818,818,0,0,0,0.0,0.0,0.0
1997.0,JOR,1009,1009,31,30,1,0.029732408,0.030723488,0.0009910803
1998.0,JOR,1212,1212,53,32,21,0.026402641,0.043729372,0.017326733
1999.0,JOR,1336,1336,61,47,14,0.03517964,0.04565868,0.010479042
2000.0,JOR,1431,1431,48,56,-8,0.039133474,0.033542976,-0.005590496
2001.0,JOR,1512,1512,67,65,2,0.042989418,0.044312168,0.0013227513
2002.0,JOR,1648,1648,67,47,20,0.028519418,0.04065534,0.012135922
2003.0,JOR,1832,1832,70,49,21,0.026746726,0.038209606,0.011462882
2004.0,JOR,2091,2091,84,51,33,0.024390243,0.040172167,0.015781922
2005.0,JOR,2342,2342,99,72,27,0.030742954,0.042271562,0.011528608
2006.0,JOR,2790,2790,121,54,67,0.019354839,0.043369174,0.024014337
2007.0,JOR,3225,3225,131,80,51,0.024806201,0.040620156,0.015813954
2008.0,JOR,3732,3732,140,80,60,0.021436227,0.037513398,0.01607717
2009.0,JOR,4159,4159,127,92,35,0.022120703,0.030536186,0.008415485
2010.0,JOR,4491,4491,141,155,-14,0.03451347,0.031396125,-0.0031173457
2011.0,JOR,4735,4735,153,156,-3,0.032946147,0.032312565,-0.00063357974
2012.0,JOR,4981,4981,167,164,3,0.032925114,0.033527404,0.0006022887
2013.0,JOR,5146,5146,183,163,20,0.03167509,0.035561603,0.0038865139
2014.0,JOR,5478,5478,210,147,63,0.02683461,0.03833516,0.011500548
2015.0,JOR,5879,5879,236,170,66,0.028916482,0.040142883,0.011226399
2016.0,JOR,6504,6504,265,206,59,0.031672817,0.040744156,0.009071341
2017.0,JOR,7390,7390,274,213,61,0.028822733,0.037077133,0.008254398
2018.0,JOR,8572,8572,287,240,47,0.027998133,0.033481102,0.005482968
2019.0,JOR,9650,9650,281,240,41,0.024870466,0.029119171,0.0042487048
2020.0,JOR,10442,10442,338,294,44,0.028155526,0.03236928,0.004213752
2021.0,JOR,10363,10363,330,300,30,0.028949145,0.03184406,0.0028949147
2022.0,JOR,0,0,263,249,14,,,
2023.0,JOR,0,0,169,198,-29,,,
1996.0,JPN,185821,185821,0,0,0,0.0,0.0,0.0
1997.0,JPN,214086,214086,1850,1745,105,0.00815093,0.008641387,0.0004904571
1998.0,JPN,239976,239976,2155,2123,32,0.008846718,0.008980065,0.00013334666
1999.0,JPN,259011,259011,2340,2413,-73,0.009316207,0.009034365,-0.00028184132
2000.0,JPN,270814,270814,2535,2810,-275,0.010376126,0.009360668,-0.0010154571
2001.0,JPN,279163,279163,2714,3245,-531,0.011624034,0.009721919,-0.0019021145
2002.0,JPN,286926,286926,2843,3491,-648,0.012166901,0.009908478,-0.002258422
2003.0,JPN,292444,292444,2813,3506,-693,0.01198862,0.009618935,-0.0023696844
2004.0,JPN,298366,298366,2382,3073,-691,0.010299431,0.007983483,-0.0023159476
2005.0,JPN,303098,303098,2461,3136,-675,0.010346489,0.008119486,-0.0022270025
2006.0,JPN,308664,308664,2403,2999,-596,0.0097160665,0.0077851643,-0.0019309022
2007.0,JPN,315383,315383,2570,3087,-517,0.009788099,0.008148822,-0.0016392767
2008.0,JPN,320031,320031,2541,3168,-627,0.009899041,0.007939856,-0.001959185
2009.0,JPN,324581,324581,2677,3250,-573,0.010012909,0.008247556,-0.0017653529
2010.0,JPN,329235,329235,2719,3301,-582,0.010026273,0.008258538,-0.0017677343
2011.0,JPN,334016,334016,2784,3238,-454,0.009694146,0.00833493,-0.0013592163
2012.0,JPN,337446,337446,2624,3351,-727,0.0099304775,0.007776059,-0.0021544187
2013.0,JPN,341323,341323,2676,3415,-739,0.010005185,0.007840081,-0.0021651045
2014.0,JPN,345223,345223,2730,3553,-823,0.010291899,0.007907932,-0.0023839662
2015.0,JPN,348592,348592,2695,3411,-716,0.0097850785,0.007731101,-0.0020539772
2016.0,JPN,351161,351161,3066,3432,-366,0.009773294,0.008731038,-0.001042257
2017.0,JPN,353067,353067,2916,3506,-590,0.009930126,0.008259055,-0.0016710709
2018.0,JPN,356238,356238,2947,3542,-595,0.009942791,0.008272559,-0.0016702317
2019.0,JPN,357321,357321,3106,3593,-487,0.010055385,0.008692464,-0.0013629202
2020.0,JPN,350499,350499,3057,3697,-640,0.010547819,0.008721851,-0.0018259682
2021.0,JPN,330028,330028,2896,3259,-363,0.009874919,0.008775013,-0.0010999066
2022.0,JPN,0,0,2295,2844,-549,,,
2023.0,JPN,0,0,1505,1672,-167,,,
1996.0,KAZ,495,495,0,0,0,0.0,0.0,0.0
1997.0,KAZ,607,607,14,20,-6,0.03294893,0.02306425,-0.009884679
1998.0,KAZ,701,701,17,21,-4,0.029957203,0.02425107,-0.0057061343
1999.0,KAZ,754,754,13,12,1,0.01591512,0.01724138,0.0013262599
2000.0,KAZ,825,825,18,25,-7,0.030303031,0.021818181,-0.008484849
2001.0,KAZ,891,891,19,22,-3,0.024691358,0.021324355,-0.0033670033
2002.0,KAZ,921,921,19,15,4,0.016286645,0.02062975,0.0043431055
2003.0,KAZ,980,980,17,15,2,0.015306123,0.01734694,0.0020408162
2004.0,KAZ,1020,1020,22,15,7,0.014705882,0.021568628,0.006862745
2005.0,KAZ,1058,1058,31,18,13,0.017013233,0.029300567,0.012287335
2006.0,KAZ,1066,1066,19,26,-7,0.024390243,0.01782364,-0.006566604
2007.0,KAZ,1113,1113,20,30,-10,0.026954178,0.017969452,-0.008984726
2008.0,KAZ,1172,1172,24,28,-4,0.023890786,0.020477816,-0.0034129692
2009.0,KAZ,1279,1279,37,23,14,0.0179828,0.02892885,0.010946051
2010.0,KAZ,1564,1564,34,26,8,0.01662404,0.02173913,0.0051150895
2011.0,KAZ,2816,2816,57,23,34,0.008167613,0.020241477,0.012073863
2012.0,KAZ,4411,4411,76,32,44,0.0072545907,0.017229654,0.009975063
2013.0,KAZ,5772,5772,81,31,50,0.005370755,0.0140332645,0.008662509
2014.0,KAZ,7866,7866,101,49,52,0.0062293415,0.012840071,0.0066107297
2015.0,KAZ,9431,9431,126,86,40,0.009118863,0.013360195,0.004241332
2016.0,KAZ,10686,10686,169,91,78,0.008515815,0.015815085,0.00729927
2017.0,KAZ,11942,11942,193,128,65,0.010718472,0.016161447,0.005442974
2018.0,KAZ,13164,13164,178,143,35,0.01086296,0.013521726,0.0026587662
2019.0,KAZ,13862,13862,174,139,35,0.010027413,0.012552301,0.0025248881
2020.0,KAZ,14333,14333,190,151,39,0.010535128,0.013256122,0.0027209935
2021.0,KAZ,14086,14086,209,122,87,0.008661082,0.014837427,0.0061763455
2022.0,KAZ,0,0,166,110,56,,,
2023.0,KAZ,0,0,111,80,31,,,
1996.0,KEN,1082,1082,0,0,0,0.0,0.0,0.0
1997.0,KEN,1261,1261,57,52,5,0.041237112,0.04520222,0.0039651073
1998.0,KEN,1425,1425,54,60,-6,0.042105265,0.037894737,-0.004210526
1999.0,KEN,1521,1521,78,72,6,0.04733728,0.051282052,0.003944773
2000.0,KEN,1624,1624,79,69,10,0.042487685,0.04864532,0.0061576352
2001.0,KEN,1725,1725,87,109,-22,0.063188404,0.050434783,-0.012753624
2002.0,KEN,1862,1862,112,115,-3,0.061761547,0.060150377,-0.0016111708
2003.0,KEN,2090,2090,124,84,40,0.040191386,0.059330143,0.019138755
2004.0,KEN,2280,2280,98,92,6,0.040350877,0.042982455,0.002631579
2005.0,KEN,2503,2503,88,92,-4,0.036755893,0.03515781,-0.0015980822
2006.0,KEN,2823,2823,108,89,19,0.031526744,0.038257174,0.0067304284
2007.0,KEN,3180,3180,141,114,27,0.035849057,0.044339623,0.008490566
2008.0,KEN,3583,3583,127,110,17,0.03070053,0.035445157,0.0047446275
2009.0,KEN,3997,3997,143,125,18,0.031273454,0.03577683,0.0045033777
2010.0,KEN,4334,4334,141,143,-2,0.032994922,0.032533456,-0.00046146745
2011.0,KEN,4683,4683,171,156,15,0.033311978,0.036515053,0.003203075
2012.0,KEN,5196,5196,200,152,48,0.029253272,0.03849115,0.009237875
2013.0,KEN,5632,5632,226,178,48,0.031605113,0.04012784,0.0085227275
2014.0,KEN,6047,6047,241,179,62,0.029601455,0.039854474,0.010253018
2015.0,KEN,6444,6444,232,219,13,0.0339851,0.036002483,0.0020173804
2016.0,KEN,6942,6942,259,237,22,0.034140017,0.037309133,0.0031691156
2017.0,KEN,7476,7476,320,256,64,0.03424291,0.042803638,0.008560727
2018.0,KEN,8050,8050,330,293,37,0.036397517,0.040993787,0.0045962734
2019.0,KEN,8586,8586,348,295,53,0.03435826,0.0405311,0.0061728396
2020.0,KEN,8797,8797,332,326,6,0.03705809,0.037740137,0.0006820507
2021.0,KEN,8574,8574,315,295,20,0.034406345,0.036738977,0.0023326336
2022.0,KEN,0,0,307,254,53,,,
2023.0,KEN,0,0,176,175,1,,,
1996.0,KGZ,59,59,0,0,0,0.0,0.0,0.0
1997.0,KGZ,74,74,3,1,2,0.013513514,0.04054054,0.027027028
1998.0,KGZ,98,98,6,3,3,0.030612245,0.06122449,0.030612245
1999.0,KGZ,108,108,3,3,0,0.027777778,0.027777778,0.0
2000.0,KGZ,105,105,2,6,-4,0.057142857,0.01904762,-0.03809524
2001.0,KGZ,108,108,8,3,5,0.027777778,0.074074075,0.046296295
2002.0,KGZ,120,120,4,4,0,0.033333335,0.033333335,0.0
2003.0,KGZ,129,129,8,4,4,0.031007752,0.062015504,0.031007752
2004.0,KGZ,143,143,11,8,3,0.055944055,0.07692308,0.02097902
2005.0,KGZ,150,150,4,6,-2,0.04,0.026666667,-0.013333334
2006.0,KGZ,166,166,5,3,2,0.018072288,0.030120483,0.012048192
2007.0,KGZ,181,181,7,8,-1,0.044198897,0.038674034,-0.005524862
2008.0,KGZ,192,192,4,2,2,0.010416667,0.020833334,0.010416667
2009.0,KGZ,200,200,5,8,-3,0.04,0.025,-0.015
2010.0,KGZ,204,204,6,15,-9,0.073529415,0.029411765,-0.04411765
2011.0,KGZ,228,228,14,8,6,0.03508772,0.06140351,0.02631579
2012.0,KGZ,250,250,15,10,5,0.04,0.06,0.02
2013.0,KGZ,273,273,9,11,-2,0.04029304,0.032967035,-0.0073260074
2014.0,KGZ,352,352,18,8,10,0.022727273,0.051136363,0.028409092
2015.0,KGZ,420,420,15,12,3,0.028571429,0.035714287,0.007142857
2016.0,KGZ,484,484,20,14,6,0.02892562,0.041322313,0.012396694
2017.0,KGZ,598,598,27,13,14,0.02173913,0.045150504,0.02341137
2018.0,KGZ,678,678,25,24,1,0.03539823,0.036873158,0.0014749262
2019.0,KGZ,742,742,26,11,15,0.014824797,0.03504043,0.020215634
2020.0,KGZ,772,772,29,30,-1,0.038860105,0.037564766,-0.0012953368
2021.0,KGZ,745,745,30,37,-7,0.04966443,0.040268455,-0.009395973
2022.0,KGZ,0,0,28,18,10,,,
1996.0,KHM,20,20,0,0,0,0.0,0.0,0.0
1997.0,KHM,26,26,2,2,0,0.07692308,0.07692308,0.0
1998.0,KHM,41,41,2,1,1,0.024390243,0.048780486,0.024390243
1999.0,KHM,46,46,2,3,-1,0.06521739,0.04347826,-0.02173913
2000.0,KHM,67,67,7,5,2,0.07462686,0.104477614,0.029850746
2001.0,KHM,92,92,6,3,3,0.032608695,0.06521739,0.032608695
2002.0,KHM,121,121,6,4,2,0.03305785,0.049586777,0.016528925
2003.0,KHM,162,162,15,9,6,0.055555556,0.09259259,0.037037037
2004.0,KHM,206,206,9,6,3,0.029126214,0.04368932,0.014563107
2005.0,KHM,261,261,11,6,5,0.022988506,0.042145595,0.019157087
2006.0,KHM,298,298,15,11,4,0.03691275,0.05033557,0.013422819
2007.0,KHM,333,333,17,16,1,0.04804805,0.05105105,0.003003003
2008.0,KHM,389,389,25,15,10,0.038560413,0.06426735,0.025706941
2009.0,KHM,435,435,19,16,3,0.03678161,0.04367816,0.0068965517
2010.0,KHM,490,490,28,23,5,0.046938777,0.057142857,0.010204081
2011.0,KHM,558,558,31,18,13,0.032258064,0.055555556,0.02329749
2012.0,KHM,603,603,25,37,-12,0.061359867,0.04145937,-0.019900497
2013.0,KHM,678,678,40,16,24,0.02359882,0.05899705,0.03539823
2014.0,KHM,731,731,35,22,13,0.03009576,0.047879618,0.017783858
2015.0,KHM,813,813,54,27,27,0.033210333,0.06642067,0.033210333
2016.0,KHM,903,903,40,37,3,0.040974528,0.04429679,0.003322259
2017.0,KHM,951,951,49,40,9,0.04206099,0.05152471,0.009463723
2018.0,KHM,1037,1037,69,33,36,0.031822566,0.06653809,0.034715526
2019.0,KHM,1034,1034,58,56,2,0.054158606,0.056092843,0.001934236
2020.0,KHM,1054,1054,69,60,9,0.056925997,0.0654649,0.008538899
2021.0,KHM,1012,1012,66,46,20,0.045454547,0.06521739,0.019762846
2022.0,KHM,0,0,48,44,4,,,
2003.0,KIR,2,2,0,0,0,0.0,0.0,0.0
2006.0,KIR,4,4,2,0,2,0.0,0.5,0.5
2010.0,KIR,2,2,0,0,0,0.0,0.0,0.0
2012.0,KIR,9,9,2,0,2,0.0,0.22222222,0.22222222
2013.0,KIR,10,10,0,0,0,0.0,0.0,0.0
2014.0,KIR,14,14,2,0,2,0.0,0.14285715,0.14285715
2015.0,KIR,15,15,0,1,-1,0.06666667,0.0,-0.06666667
2016.0,KIR,14,14,0,0,0,0.0,0.0,0.0
2017.0,KIR,12,12,0,1,-1,0.083333336,0.0,-0.083333336
2019.0,KIR,20,20,2,0,2,0.0,0.1,0.1
2020.0,KIR,19,19,1,0,1,0.0,0.05263158,0.05263158
2021.0,KIR,18,18,0,0,0,0.0,0.0,0.0
1998.0,KNA,2,2,0,0,0,0.0,0.0,0.0
1999.0,KNA,2,2,0,0,0,0.0,0.0,0.0
2002.0,KNA,4,4,0,0,0,0.0,0.0,0.0
2004.0,KNA,4,4,1,0,1,0.0,0.25,0.25
2007.0,KNA,14,14,1,1,0,0.071428575,0.071428575,0.0
2008.0,KNA,14,14,4,4,0,0.2857143,0.2857143,0.0
2009.0,KNA,14,14,3,3,0,0.21428572,0.21428572,0.0
2012.0,KNA,35,35,7,3,4,0.08571429,0.2,0.114285715
2013.0,KNA,43,43,11,7,4,0.1627907,0.25581396,0.093023255
2014.0,KNA,57,57,7,3,4,0.05263158,0.12280702,0.07017544
2015.0,KNA,61,61,9,13,-4,0.21311475,0.14754099,-0.06557377
2016.0,KNA,76,76,20,9,11,0.118421055,0.2631579,0.14473684
2017.0,KNA,105,105,22,11,11,0.104761906,0.20952381,0.104761906
2018.0,KNA,126,126,12,9,3,0.071428575,0.0952381,0.023809524
2019.0,KNA,138,138,13,4,9,0.028985508,0.0942029,0.06521739
2020.0,KNA,155,155,20,12,8,0.077419356,0.12903225,0.051612902
2021.0,KNA,143,143,12,18,-6,0.12587413,0.08391608,-0.04195804
2022.0,KNA,0,0,9,16,-7,,,
1996.0,KOR,22906,22906,0,0,0,0.0,0.0,0.0
1997.0,KOR,28941,28941,534,292,242,0.010089492,0.018451331,0.00836184
1998.0,KOR,35419,35419,687,434,253,0.0122533105,0.019396368,0.007143059
1999.0,KOR,41701,41701,732,511,221,0.012253903,0.017553536,0.005299633
2000.0,KOR,47778,47778,778,616,162,0.012892963,0.016283644,0.003390682
2001.0,KOR,53838,53838,907,762,145,0.014153572,0.016846837,0.002693265
2002.0,KOR,60582,60582,967,908,59,0.01498795,0.015961837,0.00097388664
2003.0,KOR,67176,67176,1115,922,193,0.01372514,0.01659819,0.0028730498
2004.0,KOR,73995,73995,1084,932,152,0.012595446,0.014649639,0.0020541928
2005.0,KOR,82459,82459,1251,961,290,0.011654276,0.015171176,0.0035168994
2006.0,KOR,91612,91612,1320,1043,277,0.011384971,0.014408593,0.0030236214
2007.0,KOR,101101,101101,1458,1123,335,0.011107705,0.014421223,0.0033135181
2008.0,KOR,111772,111772,1569,1162,407,0.010396164,0.014037505,0.0036413413
2009.0,KOR,121684,121684,1578,1362,216,0.011192926,0.012968016,0.0017750895
2010.0,KOR,132090,132090,1712,1477,235,0.01118177,0.01296086,0.00177909
2011.0,KOR,141898,141898,1790,1632,158,0.011501219,0.012614695,0.0011134759
2012.0,KOR,152456,152456,1911,1603,308,0.010514509,0.012534764,0.002020255
2013.0,KOR,163261,163261,1989,1819,170,0.011141669,0.012182946,0.0010412774
2014.0,KOR,172868,172868,2013,1868,145,0.010805933,0.011644723,0.00083879026
2015.0,KOR,182040,182040,2044,1919,125,0.010541639,0.011228302,0.0006866623
2016.0,KOR,189647,189647,2085,2014,71,0.010619731,0.01099411,0.00037437977
2017.0,KOR,197759,197759,2035,2224,-189,0.011246012,0.010290303,-0.00095570873
2018.0,KOR,204526,204526,2078,2396,-318,0.0117148915,0.010160077,-0.0015548145
2019.0,KOR,209183,209183,2086,2551,-465,0.012195064,0.00997213,-0.002222934
2020.0,KOR,208288,208288,2088,2716,-628,0.013039637,0.010024581,-0.003015056
2021.0,KOR,195922,195922,2157,2532,-375,0.012923511,0.011009484,-0.001914027
2022.0,KOR,0,0,2160,2101,59,,,
2023.0,KOR,0,0,1401,1498,-97,,,
1996.0,KWT,920,920,0,0,0,0.0,0.0,0.0
1997.0,KWT,1122,1122,42,18,24,0.01604278,0.037433155,0.021390375
1998.0,KWT,1254,1254,50,43,7,0.034290273,0.039872408,0.005582137
1999.0,KWT,1389,1389,57,39,18,0.028077753,0.041036718,0.012958963
2000.0,KWT,1486,1486,61,47,14,0.031628534,0.041049797,0.009421265
2001.0,KWT,1478,1478,53,65,-12,0.04397835,0.03585927,-0.00811908
2002.0,KWT,1535,1535,61,54,7,0.035179153,0.039739415,0.0045602606
2003.0,KWT,1596,1596,49,51,-2,0.03195489,0.030701755,-0.0012531328
2004.0,KWT,1727,1727,74,37,37,0.021424435,0.04284887,0.021424435
2005.0,KWT,1873,1873,70,32,38,0.017084891,0.037373196,0.020288307
2006.0,KWT,2012,2012,70,44,26,0.021868788,0.034791254,0.012922465
2007.0,KWT,2125,2125,63,40,23,0.018823529,0.02964706,0.010823529
2008.0,KWT,2198,2198,52,48,4,0.021838035,0.023657871,0.0018198362
2009.0,KWT,2252,2252,73,47,26,0.020870337,0.032415632,0.011545293
2010.0,KWT,2320,2320,84,43,41,0.018534483,0.036206897,0.017672414
2011.0,KWT,2372,2372,82,51,31,0.021500843,0.034569982,0.01306914
2012.0,KWT,2330,2330,84,60,24,0.025751073,0.0360515,0.01030043
2013.0,KWT,2419,2419,81,48,33,0.01984291,0.03348491,0.013642001
2014.0,KWT,2496,2496,131,59,72,0.02363782,0.052483976,0.028846154
2015.0,KWT,2594,2594,128,76,52,0.02929838,0.04934464,0.02004626
2016.0,KWT,2706,2706,124,78,46,0.028824834,0.045824096,0.016999261
2017.0,KWT,2893,2893,145,79,66,0.027307294,0.050120983,0.022813689
2018.0,KWT,3116,3116,148,90,58,0.028883183,0.047496792,0.018613607
2019.0,KWT,3348,3348,194,98,96,0.029271206,0.057945043,0.028673835
2020.0,KWT,3509,3509,175,84,91,0.023938444,0.049871758,0.025933314
2021.0,KWT,3463,3463,137,106,31,0.030609298,0.039561074,0.008951776
2022.0,KWT,0,0,127,87,40,,,
1996.0,LAO,27,27,0,0,0,0.0,0.0,0.0
1997.0,LAO,27,27,0,2,-2,0.074074075,0.0,-0.074074075
1998.0,LAO,44,44,5,1,4,0.022727273,0.11363637,0.09090909
1999.0,LAO,43,43,1,3,-2,0.069767445,0.023255814,-0.046511628
2000.0,LAO,55,55,3,1,2,0.018181818,0.054545455,0.036363635
2001.0,LAO,71,71,4,3,1,0.04225352,0.056338027,0.014084507
2002.0,LAO,92,92,11,4,7,0.04347826,0.11956522,0.07608695
2003.0,LAO,101,101,7,4,3,0.03960396,0.06930693,0.02970297
2004.0,LAO,142,142,10,4,6,0.028169014,0.07042254,0.04225352
2005.0,LAO,179,179,13,3,10,0.016759777,0.0726257,0.05586592
2006.0,LAO,206,206,9,3,6,0.014563107,0.04368932,0.029126214
2007.0,LAO,227,227,9,8,1,0.03524229,0.039647575,0.004405286
2008.0,LAO,252,252,13,11,2,0.043650795,0.051587302,0.007936508
2009.0,LAO,280,280,13,12,1,0.042857144,0.046428572,0.0035714286
2010.0,LAO,323,323,15,8,7,0.024767801,0.04643963,0.021671826
2011.0,LAO,363,363,22,18,4,0.049586777,0.060606062,0.011019284
2012.0,LAO,402,402,29,20,9,0.049751244,0.0721393,0.02238806
2013.0,LAO,432,432,30,32,-2,0.074074075,0.06944445,-0.0046296297
2014.0,LAO,465,465,27,28,-1,0.060215052,0.058064517,-0.0021505377
2015.0,LAO,504,504,40,24,16,0.04761905,0.07936508,0.031746034
2016.0,LAO,546,546,43,22,21,0.04029304,0.07875458,0.03846154
2017.0,LAO,575,575,42,41,1,0.07130435,0.07304348,0.0017391305
2018.0,LAO,611,611,48,22,26,0.036006548,0.07855974,0.04255319
2019.0,LAO,621,621,41,38,3,0.061191626,0.066022545,0.004830918
2020.0,LAO,625,625,43,27,16,0.0432,0.0688,0.0256
2021.0,LAO,588,588,40,26,14,0.044217687,0.06802721,0.023809524
2022.0,LAO,0,0,23,12,11,,,
1996.0,LBN,581,581,0,0,0,0.0,0.0,0.0
1997.0,LBN,735,735,39,22,17,0.029931974,0.053061225,0.02312925
1998.0,LBN,920,920,63,27,36,0.029347826,0.068478264,0.039130434
1999.0,LBN,1073,1073,61,34,27,0.03168686,0.056849953,0.025163094
2000.0,LBN,1171,1171,66,54,12,0.046114434,0.056362085,0.0102476515
2001.0,LBN,1320,1320,74,45,29,0.03409091,0.056060605,0.021969697
2002.0,LBN,1429,1429,57,70,-13,0.048985306,0.03988803,-0.009097271
2003.0,LBN,1563,1563,92,58,34,0.037108127,0.058861166,0.02175304
2004.0,LBN,1741,1741,93,61,32,0.035037335,0.053417575,0.018380241
2005.0,LBN,1903,1903,82,64,18,0.03363111,0.04308986,0.00945875
2006.0,LBN,2129,2129,90,68,22,0.03193988,0.04227337,0.01033349
2007.0,LBN,2282,2282,81,92,-11,0.040315513,0.03549518,-0.004820333
2008.0,LBN,2393,2393,91,120,-29,0.05014626,0.03802758,-0.0121186795
2009.0,LBN,2609,2609,117,110,7,0.042161748,0.04484477,0.0026830204
2010.0,LBN,2814,2814,124,122,2,0.043354657,0.044065386,0.00071073207
2011.0,LBN,3064,3064,146,117,29,0.03818538,0.047650132,0.009464752
2012.0,LBN,3419,3419,182,112,70,0.032758117,0.05323194,0.020473823
2013.0,LBN,3718,3718,177,144,33,0.038730502,0.04760624,0.00887574
2014.0,LBN,4137,4137,205,191,14,0.046168722,0.049552817,0.0033840947
2015.0,LBN,4628,4628,222,164,58,0.035436474,0.047968887,0.012532411
2016.0,LBN,5178,5178,230,208,22,0.04016995,0.044418696,0.004248745
2017.0,LBN,5820,5820,246,219,27,0.037628867,0.04226804,0.0046391753
2018.0,LBN,6491,6491,304,224,80,0.03450932,0.046834078,0.012324757
2019.0,LBN,6956,6956,269,248,21,0.035652675,0.03867165,0.0030189764
2020.0,LBN,7136,7136,249,313,-64,0.04386211,0.034893498,-0.00896861
2021.0,LBN,6726,6726,226,414,-188,0.061552186,0.033600952,-0.027951233
2022.0,LBN,0,0,159,434,-275,,,
2023.0,LBN,0,0,111,257,-146,,,
1996.0,LBR,4,4,0,0,0,0.0,0.0,0.0
1997.0,LBR,2,2,0,2,-2,1.0,0.0,-1.0
2000.0,LBR,4,4,0,0,0,0.0,0.0,0.0
2002.0,LBR,7,7,2,0,2,0.0,0.2857143,0.2857143
2004.0,LBR,7,7,0,1,-1,0.14285715,0.0,-0.14285715
2006.0,LBR,8,8,2,0,2,0.0,0.25,0.25
2010.0,LBR,34,34,2,3,-1,0.0882353,0.05882353,-0.029411765
2011.0,LBR,37,37,4,5,-1,0.13513513,0.10810811,-0.027027028
2012.0,LBR,56,56,9,4,5,0.071428575,0.16071428,0.08928572
2013.0,LBR,90,90,9,2,7,0.022222223,0.1,0.07777778
2014.0,LBR,121,121,13,1,12,0.008264462,0.10743801,0.09917355
2015.0,LBR,145,145,12,6,6,0.04137931,0.08275862,0.04137931
2016.0,LBR,210,210,26,6,20,0.028571429,0.123809524,0.0952381
2017.0,LBR,248,248,32,18,14,0.07258064,0.12903225,0.05645161
2018.0,LBR,263,263,24,18,6,0.06844106,0.091254756,0.022813689
2019.0,LBR,279,279,17,21,-4,0.07526882,0.0609319,-0.014336918
2020.0,LBR,275,275,19,34,-15,0.123636365,0.06909091,-0.054545455
2021.0,LBR,268,268,36,18,18,0.06716418,0.13432837,0.06716418
2022.0,LBR,0,0,71,16,55,,,
1996.0,LBY,95,95,0,0,0,0.0,0.0,0.0
1997.0,LBY,118,118,5,1,4,0.008474576,0.042372882,0.033898305
1998.0,LBY,138,138,3,7,-4,0.050724637,0.02173913,-0.028985508
1999.0,LBY,149,149,7,3,4,0.020134227,0.046979867,0.026845638
2000.0,LBY,157,157,9,10,-1,0.06369427,0.05732484,-0.006369427
2001.0,LBY,164,164,8,10,-2,0.06097561,0.048780486,-0.0121951215
2002.0,LBY,167,167,11,10,1,0.059880238,0.065868266,0.005988024
2003.0,LBY,182,182,14,7,7,0.03846154,0.07692308,0.03846154
2004.0,LBY,200,200,15,13,2,0.065,0.075,0.01
2005.0,LBY,228,228,16,5,11,0.021929825,0.07017544,0.048245613
2006.0,LBY,265,265,16,12,4,0.04528302,0.06037736,0.01509434
2007.0,LBY,343,343,24,10,14,0.029154519,0.069970846,0.040816326
2008.0,LBY,447,447,50,10,40,0.022371365,0.111856826,0.08948546
2009.0,LBY,500,500,30,8,22,0.016,0.06,0.044
2010.0,LBY,538,538,38,15,23,0.027881041,0.07063197,0.04275093
2011.0,LBY,556,556,36,31,5,0.055755395,0.0647482,0.008992806
2012.0,LBY,575,575,53,39,14,0.067826085,0.09217391,0.024347827
2013.0,LBY,543,543,48,21,27,0.038674034,0.08839779,0.049723756
2014.0,LBY,557,557,48,39,9,0.070017956,0.08617594,0.016157988
2015.0,LBY,571,571,48,42,6,0.073555164,0.084063046,0.010507881
2016.0,LBY,578,578,48,35,13,0.060553633,0.08304498,0.022491349
2017.0,LBY,592,592,45,27,18,0.045608107,0.07601351,0.030405406
2018.0,LBY,673,673,61,39,22,0.05794948,0.09063893,0.03268945
2019.0,LBY,770,770,67,28,39,0.036363635,0.087012984,0.050649352
2020.0,LBY,838,838,92,35,57,0.04176611,0.1097852,0.06801909
2021.0,LBY,855,855,84,34,50,0.03976608,0.09824561,0.058479533
2022.0,LBY,0,0,48,26,22,,,
1996.0,LCA,5,5,0,0,0,0.0,0.0,0.0
1997.0,LCA,3,3,0,2,-2,0.6666667,0.0,-0.6666667
1998.0,LCA,1,1,0,2,-2,2.0,0.0,-2.0
2001.0,LCA,2,2,1,0,1,0.0,0.5,0.5
2006.0,LCA,5,5,0,0,0,0.0,0.0,0.0
2008.0,LCA,6,6,0,1,-1,0.16666667,0.0,-0.16666667
2010.0,LCA,5,5,0,0,0,0.0,0.0,0.0
2013.0,LCA,10,10,2,0,2,0.0,0.2,0.2
2014.0,LCA,16,16,4,1,3,0.0625,0.25,0.1875
2015.0,LCA,17,17,0,0,0,0.0,0.0,0.0
2016.0,LCA,20,20,3,2,1,0.1,0.15,0.05
2017.0,LCA,19,19,3,4,-1,0.21052632,0.15789473,-0.05263158
2018.0,LCA,21,21,2,1,1,0.04761905,0.0952381,0.04761905
2020.0,LCA,21,21,3,2,1,0.0952381,0.14285715,0.04761905
2021.0,LCA,16,16,1,2,-1,0.125,0.0625,-0.0625
1996.0,LIE,22,22,0,0,0,0.0,0.0,0.0
1997.0,LIE,27,27,3,1,2,0.037037037,0.11111111,0.074074075
1998.0,LIE,33,33,7,4,3,0.121212125,0.21212122,0.09090909
1999.0,LIE,37,37,4,2,2,0.054054055,0.10810811,0.054054055
2000.0,LIE,41,41,7,1,6,0.024390243,0.17073171,0.14634146
2001.0,LIE,42,42,5,7,-2,0.16666667,0.11904762,-0.04761905
2002.0,LIE,47,47,6,3,3,0.06382979,0.12765957,0.06382979
2003.0,LIE,53,53,8,4,4,0.0754717,0.1509434,0.0754717
2004.0,LIE,68,68,9,2,7,0.029411765,0.13235295,0.10294118
2005.0,LIE,68,68,6,6,0,0.0882353,0.0882353,0.0
2006.0,LIE,73,73,6,3,3,0.04109589,0.08219178,0.04109589
2007.0,LIE,82,82,10,7,3,0.085365854,0.12195122,0.036585364
2008.0,LIE,90,90,9,2,7,0.022222223,0.1,0.07777778
2009.0,LIE,83,83,3,5,-2,0.060240965,0.036144577,-0.024096385
2010.0,LIE,89,89,12,6,6,0.06741573,0.13483146,0.06741573
2011.0,LIE,88,88,13,5,8,0.056818184,0.14772727,0.09090909
2012.0,LIE,98,98,11,5,6,0.05102041,0.1122449,0.06122449
2013.0,LIE,106,106,12,9,3,0.08490566,0.11320755,0.028301887
2014.0,LIE,122,122,15,5,10,0.040983606,0.12295082,0.08196721
2015.0,LIE,123,123,7,7,0,0.05691057,0.05691057,0.0
2016.0,LIE,132,132,7,4,3,0.030303031,0.053030305,0.022727273
2017.0,LIE,135,135,14,6,8,0.044444446,0.1037037,0.05925926
2018.0,LIE,143,143,9,9,0,0.062937066,0.062937066,0.0
2019.0,LIE,143,143,12,15,-3,0.10489511,0.08391608,-0.02097902
2020.0,LIE,152,152,16,7,9,0.04605263,0.10526316,0.059210528
2021.0,LIE,148,148,19,16,3,0.10810811,0.12837838,0.02027027
2022.0,LIE,0,0,16,12,4,,,
1996.0,LKA,399,399,0,0,0,0.0,0.0,0.0
1997.0,LKA,516,516,16,6,10,0.011627907,0.031007752,0.019379845
1998.0,LKA,618,618,26,13,13,0.021035599,0.042071197,0.021035599
1999.0,LKA,670,670,20,20,0,0.029850746,0.029850746,0.0
2000.0,LKA,759,759,34,33,1,0.04347826,0.044795785,0.0013175231
2001.0,LKA,833,833,28,24,4,0.028811524,0.033613447,0.0048019206
2002.0,LKA,904,904,47,33,14,0.036504425,0.05199115,0.015486726
2003.0,LKA,1004,1004,46,34,12,0.033864543,0.045816734,0.011952192
2004.0,LKA,1117,1117,54,46,8,0.041181736,0.048343778,0.007162041
2005.0,LKA,1215,1215,52,51,1,0.04197531,0.042798355,0.00082304527
2006.0,LKA,1349,1349,41,38,3,0.028169014,0.030392883,0.0022238696
2007.0,LKA,1510,1510,40,47,-7,0.031125829,0.026490066,-0.0046357615
2008.0,LKA,1620,1620,49,47,2,0.029012345,0.030246913,0.001234568
2009.0,LKA,1774,1774,43,50,-7,0.028184893,0.024239007,-0.003945885
2010.0,LKA,1915,1915,56,79,-23,0.041253265,0.02924282,-0.012010444
2011.0,LKA,2135,2135,82,70,12,0.032786883,0.038407493,0.005620609
2012.0,LKA,2341,2341,77,91,-14,0.038872276,0.032891925,-0.00598035
2013.0,LKA,2613,2613,101,76,25,0.029085342,0.03865289,0.009567547
2014.0,LKA,2940,2940,110,66,44,0.02244898,0.037414964,0.014965987
2015.0,LKA,3268,3268,120,88,32,0.026927784,0.036719706,0.009791922
2016.0,LKA,3669,3669,138,72,66,0.019623876,0.037612427,0.017988553
2017.0,LKA,4105,4105,150,97,53,0.02362972,0.036540803,0.012911084
2018.0,LKA,4562,4562,151,136,15,0.029811487,0.033099517,0.0032880316
2019.0,LKA,5026,5026,162,160,2,0.03183446,0.032232393,0.00039793077
2020.0,LKA,5363,5363,198,132,66,0.02461309,0.036919635,0.012306545
2021.0,LKA,5228,5228,158,162,-4,0.030986993,0.030221881,-0.00076511095
2022.0,LKA,0,0,134,152,-18,,,
2023.0,LKA,0,0,78,97,-19,,,
1996.0,LSO,14,14,0,0,0,0.0,0.0,0.0
1997.0,LSO,16,16,1,2,-1,0.125,0.0625,-0.0625
1999.0,LSO,18,18,2,2,0,0.11111111,0.11111111,0.0
2000.0,LSO,21,21,2,3,-1,0.14285715,0.0952381,-0.04761905
2001.0,LSO,30,30,4,2,2,0.06666667,0.13333334,0.06666667
2002.0,LSO,27,27,0,2,-2,0.074074075,0.0,-0.074074075
2003.0,LSO,23,23,1,9,-8,0.39130434,0.04347826,-0.3478261
2005.0,LSO,32,32,4,1,3,0.03125,0.125,0.09375
2006.0,LSO,37,37,6,1,5,0.027027028,0.16216215,0.13513513
2007.0,LSO,50,50,6,5,1,0.1,0.12,0.02
2008.0,LSO,56,56,6,4,2,0.071428575,0.10714286,0.035714287
2009.0,LSO,58,58,5,11,-6,0.18965517,0.0862069,-0.10344828
2010.0,LSO,69,69,6,6,0,0.08695652,0.08695652,0.0
2011.0,LSO,67,67,8,11,-3,0.1641791,0.11940298,-0.04477612
2012.0,LSO,78,78,6,5,1,0.06410257,0.07692308,0.012820513
2013.0,LSO,87,87,8,11,-3,0.12643678,0.09195402,-0.03448276
2014.0,LSO,96,96,5,4,1,0.041666668,0.052083332,0.010416667
2015.0,LSO,106,106,7,9,-2,0.08490566,0.06603774,-0.018867925
2016.0,LSO,115,115,12,9,3,0.07826087,0.104347825,0.026086956
2017.0,LSO,139,139,6,5,1,0.035971224,0.043165468,0.007194245
2018.0,LSO,157,157,15,10,5,0.06369427,0.0955414,0.031847134
2019.0,LSO,188,188,22,5,17,0.026595745,0.11702128,0.09042553
2020.0,LSO,205,205,22,9,13,0.043902438,0.107317075,0.06341463
2021.0,LSO,195,195,17,17,0,0.08717949,0.08717949,0.0
2022.0,LSO,0,0,16,10,6,,,
1996.0,LTU,1084,1084,0,0,0,0.0,0.0,0.0
1997.0,LTU,1369,1369,30,21,9,0.015339664,0.021913806,0.006574142
1998.0,LTU,1607,1607,29,39,-10,0.024268825,0.01804605,-0.006222775
1999.0,LTU,1769,1769,41,19,22,0.010740532,0.023176936,0.012436405
2000.0,LTU,2256,2256,38,46,-8,0.020390071,0.01684397,-0.0035460992
2001.0,LTU,2697,2697,39,59,-20,0.021876158,0.0144605115,-0.007415647
2002.0,LTU,3117,3117,47,41,6,0.013153673,0.015078601,0.0019249278
2003.0,LTU,3628,3628,53,55,-2,0.015159868,0.0146086,-0.00055126793
2004.0,LTU,4195,4195,46,36,10,0.008581645,0.010965435,0.0023837902
2005.0,LTU,4591,4591,65,47,18,0.010237421,0.014158135,0.0039207144
2006.0,LTU,5229,5229,48,47,1,0.008988334,0.009179575,0.00019124115
2007.0,LTU,5708,5708,56,57,-1,0.009985984,0.009810792,-0.0001751927
2008.0,LTU,6143,6143,63,63,0,0.010255575,0.010255575,0.0
2009.0,LTU,6575,6575,37,46,-9,0.0069961976,0.0056273765,-0.0013688212
2010.0,LTU,6910,6910,54,48,6,0.0069464543,0.007814761,0.0008683068
2011.0,LTU,7175,7175,47,46,1,0.0064111496,0.0065505225,0.00013937282
2012.0,LTU,7482,7482,48,56,-8,0.0074846298,0.006415397,-0.0010692328
2013.0,LTU,7869,7869,75,59,16,0.0074977763,0.009531071,0.002033295
2014.0,LTU,8172,8172,75,70,5,0.008565835,0.00917768,0.00061184535
2015.0,LTU,8404,8404,57,58,-1,0.0069014756,0.0067824847,-0.00011899096
2016.0,LTU,8639,8639,62,81,-19,0.009376085,0.0071767564,-0.0021993287
2017.0,LTU,8979,8979,63,68,-5,0.0075732265,0.0070163715,-0.0005568549
2018.0,LTU,9248,9248,84,115,-31,0.012435121,0.009083045,-0.003352076
2019.0,LTU,9421,9421,90,87,3,0.009234688,0.009553126,0.00031843752
2020.0,LTU,9418,9418,112,86,26,0.00913145,0.011892121,0.002760671
2021.0,LTU,9076,9076,108,118,-10,0.013001322,0.011899515,-0.001101807
2022.0,LTU,0,0,108,80,28,,,
2023.0,LTU,0,0,69,58,11,,,
1996.0,LUX,131,131,0,0,0,0.0,0.0,0.0
1997.0,LUX,163,163,10,9,1,0.055214725,0.061349694,0.006134969
1998.0,LUX,197,197,17,10,7,0.05076142,0.08629441,0.035532996
1999.0,LUX,213,213,12,11,1,0.051643193,0.056338027,0.0046948357
2000.0,LUX,229,229,17,20,-3,0.08733624,0.074235804,-0.013100437
2001.0,LUX,263,263,36,16,20,0.0608365,0.13688213,0.076045625
2002.0,LUX,306,306,34,18,16,0.05882353,0.11111111,0.052287582
2003.0,LUX,346,346,39,27,12,0.078034684,0.112716764,0.03468208
2004.0,LUX,420,420,51,15,36,0.035714287,0.12142857,0.08571429
2005.0,LUX,506,506,51,19,32,0.037549406,0.100790516,0.06324111
2006.0,LUX,597,597,71,26,45,0.043551087,0.11892797,0.07537688
2007.0,LUX,734,734,73,30,43,0.040871933,0.09945504,0.058583107
2008.0,LUX,865,865,86,24,62,0.027745664,0.09942196,0.0716763
2009.0,LUX,1003,1003,94,35,59,0.034895316,0.09371884,0.05882353
2010.0,LUX,1135,1135,125,62,63,0.054625552,0.11013216,0.05550661
2011.0,LUX,1298,1298,130,61,69,0.04699538,0.10015408,0.053158704
2012.0,LUX,1490,1490,148,72,76,0.04832215,0.09932886,0.051006712
2013.0,LUX,1652,1652,148,79,69,0.04782082,0.08958838,0.041767556
2014.0,LUX,1823,1823,196,102,94,0.05595173,0.10751508,0.051563356
2015.0,LUX,1972,1972,166,104,62,0.052738335,0.0841785,0.03144016
2016.0,LUX,2090,2090,167,126,41,0.06028708,0.0799043,0.019617224
2017.0,LUX,2244,2244,207,114,93,0.050802138,0.09224599,0.04144385
2018.0,LUX,2360,2360,193,147,46,0.062288135,0.08177966,0.019491525
2019.0,LUX,2561,2561,245,116,129,0.045294806,0.09566575,0.05037095
2020.0,LUX,2686,2686,235,156,79,0.058078926,0.08749069,0.029411765
2021.0,LUX,2734,2734,270,145,125,0.053035844,0.0987564,0.045720555
2022.0,LUX,0,0,208,140,68,,,
2023.0,LUX,0,0,140,101,39,,,
1996.0,LVA,709,709,0,0,0,0.0,0.0,0.0
1997.0,LVA,867,867,18,20,-2,0.02306805,0.020761246,-0.002306805
1998.0,LVA,968,968,17,22,-5,0.022727273,0.017561983,-0.005165289
1999.0,LVA,1038,1038,11,28,-17,0.026974952,0.010597303,-0.01637765
2000.0,LVA,1042,1042,12,39,-27,0.03742802,0.011516315,-0.025911707
2001.0,LVA,1067,1067,30,29,1,0.027179006,0.028116213,0.00093720714
2002.0,LVA,1087,1087,28,20,8,0.018399265,0.02575897,0.0073597054
2003.0,LVA,1122,1122,30,14,16,0.012477718,0.026737968,0.014260249
2004.0,LVA,1147,1147,18,14,4,0.012205754,0.015693113,0.0034873583
2005.0,LVA,1264,1264,20,20,0,0.015822785,0.015822785,0.0
2006.0,LVA,1497,1497,25,15,10,0.01002004,0.016700067,0.0066800267
2007.0,LVA,1712,1712,25,25,0,0.014602804,0.014602804,0.0
2008.0,LVA,1935,1935,27,20,7,0.010335918,0.013953488,0.003617571
2009.0,LVA,2204,2204,23,22,1,0.009981851,0.010435572,0.0004537205
2010.0,LVA,2481,2481,36,22,14,0.008867392,0.014510278,0.005642886
2011.0,LVA,2783,2783,29,25,4,0.008983112,0.01042041,0.0014372979
2012.0,LVA,2949,2949,32,26,6,0.008816548,0.010851136,0.002034588
2013.0,LVA,3170,3170,25,36,-11,0.011356466,0.007886435,-0.0034700315
2014.0,LVA,3337,3337,36,33,3,0.009889122,0.010788133,0.0008990111
2015.0,LVA,3501,3501,46,29,17,0.008283348,0.013139104,0.0048557557
2016.0,LVA,3607,3607,39,48,-9,0.013307458,0.01081231,-0.0024951482
2017.0,LVA,3838,3838,33,41,-8,0.010682647,0.008598228,-0.002084419
2018.0,LVA,4047,4047,43,41,2,0.010130961,0.010625155,0.0004941932
2019.0,LVA,4296,4296,53,41,12,0.009543762,0.012337058,0.002793296
2020.0,LVA,4408,4408,49,40,9,0.00907441,0.011116153,0.0020417422
2021.0,LVA,4317,4317,56,35,21,0.008107482,0.012971971,0.004864489
2022.0,LVA,0,0,60,41,19,,,
2023.0,LVA,0,0,32,23,9,,,
1996.0,MAC,18,18,0,0,0,0.0,0.0,0.0
1997.0,MAC,25,25,1,0,1,0.0,0.04,0.04
1998.0,MAC,28,28,1,1,0,0.035714287,0.035714287,0.0
1999.0,MAC,31,31,1,3,-2,0.09677419,0.032258064,-0.06451613
2000.0,MAC,37,37,3,5,-2,0.13513513,0.08108108,-0.054054055
2001.0,MAC,54,54,4,1,3,0.018518519,0.074074075,0.055555556
2002.0,MAC,75,75,8,7,1,0.093333334,0.10666667,0.013333334
2003.0,MAC,104,104,15,7,8,0.067307696,0.14423077,0.07692308
2004.0,MAC,157,157,27,2,25,0.012738854,0.17197452,0.15923567
2005.0,MAC,196,196,19,8,11,0.040816326,0.096938774,0.05612245
2006.0,MAC,270,270,39,14,25,0.05185185,0.14444445,0.09259259
2007.0,MAC,325,325,30,21,9,0.064615384,0.092307694,0.027692307
2008.0,MAC,392,392,29,28,1,0.071428575,0.073979594,0.0025510204
2009.0,MAC,465,465,46,17,29,0.03655914,0.09892473,0.06236559
2010.0,MAC,541,541,60,40,20,0.073937155,0.11090573,0.036968578
2011.0,MAC,675,675,64,47,17,0.06962963,0.094814815,0.025185185
2012.0,MAC,849,849,102,41,61,0.048292108,0.12014134,0.071849234
2013.0,MAC,1062,1062,106,42,64,0.03954802,0.09981167,0.060263652
2014.0,MAC,1271,1271,124,66,58,0.051927615,0.09756097,0.04563336
2015.0,MAC,1553,1553,142,54,88,0.03477141,0.09143593,0.05666452
2016.0,MAC,1834,1834,161,98,63,0.053435113,0.08778626,0.034351144
2017.0,MAC,2054,2054,140,107,33,0.052093476,0.06815969,0.016066212
2018.0,MAC,2187,2187,150,195,-45,0.08916324,0.0685871,-0.020576132
2019.0,MAC,2202,2202,157,399,-242,0.18119891,0.07129882,-0.10990009
2020.0,MAC,2443,2443,305,324,-19,0.13262382,0.1248465,-0.007777323
2021.0,MAC,2408,2408,364,329,35,0.13662791,0.15116279,0.014534884
2022.0,MAC,0,0,419,323,96,,,
2023.0,MAC,0,0,320,379,-59,,,
2021.0,MAF,2,2,0,0,0,0.0,0.0,0.0
2022.0,MAF,0,0,0,1,-1,,,
1996.0,MAR,2141,2141,0,0,0,0.0,0.0,0.0
1997.0,MAR,2764,2764,80,38,42,0.013748191,0.02894356,0.015195369
1998.0,MAR,3304,3304,99,46,53,0.013922518,0.02996368,0.016041161
1999.0,MAR,3745,3745,100,77,23,0.020560747,0.02670227,0.006141522
2000.0,MAR,4168,4168,124,85,39,0.020393474,0.02975048,0.009357005
2001.0,MAR,4449,4449,139,100,39,0.022476962,0.031242976,0.008766015
2002.0,MAR,4647,4647,121,116,5,0.024962341,0.026038304,0.001075963
2003.0,MAR,4875,4875,113,96,17,0.019692307,0.023179486,0.0034871795
2004.0,MAR,5065,5065,97,106,-9,0.020927938,0.019151036,-0.0017769003
2005.0,MAR,5222,5222,101,91,10,0.017426273,0.019341249,0.0019149751
2006.0,MAR,5520,5520,122,63,59,0.011413043,0.022101449,0.0106884055
2007.0,MAR,6033,6033,133,65,68,0.010774076,0.022045417,0.011271341
2008.0,MAR,6606,6606,127,98,29,0.014834998,0.019224947,0.0043899487
2009.0,MAR,7327,7327,140,96,44,0.013102225,0.01910741,0.006005186
2010.0,MAR,8022,8022,160,97,63,0.0120917475,0.01994515,0.007853403
2011.0,MAR,8914,8914,188,99,89,0.011106125,0.02109042,0.009984294
2012.0,MAR,10035,10035,212,115,97,0.011459891,0.021126058,0.009666168
2013.0,MAR,11214,11214,204,105,99,0.0093632955,0.018191546,0.008828251
2014.0,MAR,12553,12553,227,128,99,0.010196766,0.018083327,0.007886561
2015.0,MAR,13900,13900,229,143,86,0.01028777,0.01647482,0.00618705
2016.0,MAR,15120,15120,198,137,61,0.009060847,0.013095238,0.0040343916
2017.0,MAR,16544,16544,228,129,99,0.007797389,0.013781431,0.005984043
2018.0,MAR,18271,18271,206,174,32,0.009523288,0.011274697,0.0017514094
2019.0,MAR,19875,19875,219,228,-9,0.011471698,0.011018868,-0.0004528302
2020.0,MAR,21158,21158,279,199,80,0.009405426,0.013186501,0.0037810758
2021.0,MAR,20849,20849,257,215,42,0.010312245,0.01232673,0.0020144852
2022.0,MAR,0,0,202,225,-23,,,
2023.0,MAR,0,0,126,126,0,,,
1996.0,MCO,53,53,0,0,0,0.0,0.0,0.0
1997.0,MCO,62,62,8,7,1,0.11290322,0.12903225,0.016129032
1998.0,MCO,69,69,8,8,0,0.11594203,0.11594203,0.0
1999.0,MCO,72,72,8,10,-2,0.1388889,0.11111111,-0.027777778
2000.0,MCO,77,77,8,10,-2,0.12987013,0.103896104,-0.025974026
2001.0,MCO,86,86,19,10,9,0.11627907,0.22093023,0.10465116
2002.0,MCO,95,95,12,8,4,0.08421053,0.12631579,0.042105265
2003.0,MCO,108,108,17,8,9,0.074074075,0.1574074,0.083333336
2004.0,MCO,121,121,20,10,10,0.08264463,0.16528925,0.08264463
2005.0,MCO,126,126,9,9,0,0.071428575,0.071428575,0.0
2006.0,MCO,124,124,16,10,6,0.08064516,0.12903225,0.048387095
2007.0,MCO,141,141,22,8,14,0.056737587,0.15602838,0.09929078
2008.0,MCO,155,155,19,7,12,0.045161292,0.12258065,0.077419356
2009.0,MCO,142,142,11,26,-15,0.18309858,0.07746479,-0.1056338
2010.0,MCO,152,152,16,8,8,0.05263158,0.10526316,0.05263158
2011.0,MCO,156,156,19,9,10,0.057692308,0.12179487,0.06410257
2012.0,MCO,153,153,12,14,-2,0.09150327,0.078431375,-0.013071896
2013.0,MCO,160,160,22,19,3,0.11875,0.1375,0.01875
2014.0,MCO,172,172,18,12,6,0.069767445,0.10465116,0.034883723
2015.0,MCO,181,181,21,8,13,0.044198897,0.1160221,0.0718232
2016.0,MCO,198,198,25,12,13,0.060606062,0.12626262,0.065656565
2017.0,MCO,207,207,24,23,1,0.11111111,0.11594203,0.004830918
2018.0,MCO,218,218,27,14,13,0.06422018,0.123853214,0.059633028
2019.0,MCO,241,241,31,15,16,0.062240664,0.12863071,0.066390045
2020.0,MCO,230,230,26,29,-3,0.12608695,0.11304348,-0.013043478
2021.0,MCO,211,211,15,22,-7,0.1042654,0.07109005,-0.033175357
2022.0,MCO,0,0,19,13,6,,,
1996.0,MDA,328,328,0,0,0,0.0,0.0,0.0
1997.0,MDA,385,385,12,16,-4,0.04155844,0.031168832,-0.01038961
1998.0,MDA,434,434,12,20,-8,0.04608295,0.02764977,-0.01843318
1999.0,MDA,454,454,11,16,-5,0.03524229,0.024229076,-0.011013215
2000.0,MDA,453,453,16,25,-9,0.05518764,0.03532009,-0.01986755
2001.0,MDA,442,442,6,19,-13,0.042986427,0.013574661,-0.029411765
2002.0,MDA,461,461,12,21,-9,0.045553144,0.02603037,-0.019522777
2003.0,MDA,467,467,10,15,-5,0.032119915,0.021413276,-0.010706638
2004.0,MDA,460,460,13,22,-9,0.047826085,0.02826087,-0.019565217
2005.0,MDA,479,479,15,7,8,0.014613778,0.03131524,0.016701462
2006.0,MDA,526,526,12,13,-1,0.02471483,0.022813689,-0.0019011407
2007.0,MDA,579,579,15,20,-5,0.034542315,0.025906736,-0.008635579
2008.0,MDA,602,602,14,10,4,0.016611295,0.023255814,0.006644518
2009.0,MDA,642,642,14,20,-6,0.031152649,0.021806853,-0.009345794
2010.0,MDA,707,707,17,17,0,0.024045262,0.024045262,0.0
2011.0,MDA,750,750,19,16,3,0.021333333,0.025333334,0.004
2012.0,MDA,785,785,20,23,-3,0.029299363,0.025477707,-0.003821656
2013.0,MDA,796,796,19,21,-2,0.02638191,0.023869347,-0.0025125628
2014.0,MDA,843,843,15,21,-6,0.024911031,0.017793594,-0.0071174377
2015.0,MDA,862,862,23,20,3,0.023201857,0.026682135,0.0034802784
2016.0,MDA,888,888,27,29,-2,0.032657657,0.030405406,-0.0022522523
2017.0,MDA,957,957,31,19,12,0.01985371,0.032392893,0.012539185
2018.0,MDA,1057,1057,22,32,-10,0.030274361,0.020813623,-0.009460738
2019.0,MDA,1084,1084,27,26,1,0.02398524,0.02490775,0.00092250924
2020.0,MDA,1066,1066,17,34,-17,0.031894933,0.015947467,-0.015947467
2021.0,MDA,1030,1030,26,19,7,0.018446602,0.025242718,0.0067961165
2022.0,MDA,0,0,17,18,-1,,,
1996.0,MDG,162,162,0,0,0,0.0,0.0,0.0
1997.0,MDG,193,193,4,7,-3,0.03626943,0.020725388,-0.015544041
1998.0,MDG,235,235,12,8,4,0.034042552,0.05106383,0.017021276
1999.0,MDG,250,250,8,15,-7,0.06,0.032,-0.028
2000.0,MDG,262,262,12,16,-4,0.061068702,0.045801528,-0.015267176
2001.0,MDG,290,290,14,19,-5,0.06551724,0.048275862,-0.01724138
2002.0,MDG,321,321,27,17,10,0.0529595,0.08411215,0.031152649
2003.0,MDG,349,349,16,8,8,0.022922637,0.045845274,0.022922637
2004.0,MDG,355,355,13,22,-9,0.061971832,0.03661972,-0.025352113
2005.0,MDG,416,416,23,11,12,0.026442308,0.05528846,0.028846154
2006.0,MDG,459,459,17,14,3,0.03050109,0.037037037,0.006535948
2007.0,MDG,511,511,23,14,9,0.02739726,0.045009784,0.017612524
2008.0,MDG,561,561,18,18,0,0.03208556,0.03208556,0.0
2009.0,MDG,633,633,21,19,2,0.030015798,0.033175357,0.0031595577
2010.0,MDG,676,676,27,20,7,0.0295858,0.039940827,0.010355029
2011.0,MDG,729,729,31,18,13,0.024691358,0.042524006,0.017832648
2012.0,MDG,804,804,31,14,17,0.017412934,0.038557213,0.021144278
2013.0,MDG,849,849,29,26,3,0.030624263,0.03415783,0.003533569
2014.0,MDG,895,895,33,26,7,0.02905028,0.036871508,0.007821229
2015.0,MDG,949,949,27,29,-2,0.030558482,0.028451001,-0.0021074815
2016.0,MDG,1000,1000,28,26,2,0.026,0.028,0.002
2017.0,MDG,1047,1047,40,28,12,0.026743075,0.038204394,0.0114613185
2018.0,MDG,1147,1147,45,34,11,0.029642547,0.039232783,0.009590236
2019.0,MDG,1218,1218,42,34,8,0.027914613,0.03448276,0.0065681445
2020.0,MDG,1207,1207,29,36,-7,0.029826015,0.024026511,-0.005799503
2021.0,MDG,1177,1177,34,37,-3,0.031435855,0.028887,-0.002548853
2022.0,MDG,0,0,30,16,14,,,
1996.0,MDV,4,4,0,0,0,0.0,0.0,0.0
1997.0,MDV,3,3,0,1,-1,0.33333334,0.0,-0.33333334
2001.0,MDV,5,5,0,0,0,0.0,0.0,0.0
2003.0,MDV,4,4,0,1,-1,0.25,0.0,-0.25
2004.0,MDV,7,7,3,1,2,0.14285715,0.42857143,0.2857143
2006.0,MDV,11,11,0,0,0,0.0,0.0,0.0
2007.0,MDV,13,13,1,0,1,0.0,0.07692308,0.07692308
2008.0,MDV,15,15,2,1,1,0.06666667,0.13333334,0.06666667
2009.0,MDV,23,23,2,0,2,0.0,0.08695652,0.08695652
2010.0,MDV,25,25,1,1,0,0.04,0.04,0.0
2011.0,MDV,24,24,1,2,-1,0.083333336,0.041666668,-0.041666668
2012.0,MDV,24,24,3,5,-2,0.20833333,0.125,-0.083333336
2013.0,MDV,29,29,5,1,4,0.03448276,0.1724138,0.13793103
2014.0,MDV,35,35,4,2,2,0.057142857,0.114285715,0.057142857
2015.0,MDV,36,36,2,5,-3,0.1388889,0.055555556,-0.083333336
2016.0,MDV,36,36,5,9,-4,0.25,0.1388889,-0.11111111
2017.0,MDV,42,42,6,1,5,0.023809524,0.14285715,0.11904762
2018.0,MDV,60,60,11,8,3,0.13333334,0.18333334,0.05
2019.0,MDV,75,75,7,11,-4,0.14666666,0.093333334,-0.053333335
2020.0,MDV,94,94,17,2,15,0.021276595,0.18085106,0.15957446
2021.0,MDV,98,98,13,9,4,0.091836736,0.13265306,0.040816326
2022.0,MDV,0,0,12,9,3,,,
1996.0,MEX,11473,11473,0,0,0,0.0,0.0,0.0
1997.0,MEX,13903,13903,267,236,31,0.016974753,0.019204488,0.0022297346
1998.0,MEX,16244,16244,391,321,70,0.019761143,0.024070427,0.0043092836
1999.0,MEX,17970,17970,460,342,118,0.01903172,0.025598219,0.0065665
2000.0,MEX,19463,19463,472,471,1,0.024199763,0.024251143,5.1379542e-05
2001.0,MEX,21151,21151,566,485,81,0.022930358,0.026759963,0.003829606
2002.0,MEX,22976,22976,638,521,117,0.022675836,0.027768105,0.00509227
2003.0,MEX,25131,25131,584,496,88,0.01973658,0.023238232,0.0035016513
2004.0,MEX,27473,27473,547,425,122,0.015469734,0.019910457,0.0044407235
2005.0,MEX,29775,29775,564,446,118,0.0149790095,0.018942066,0.0039630565
2006.0,MEX,32625,32625,531,491,40,0.015049809,0.016275862,0.0012260537
2007.0,MEX,35647,35647,641,575,66,0.01613039,0.017981878,0.0018514883
2008.0,MEX,38367,38367,621,557,64,0.0145176845,0.016185785,0.0016681002
2009.0,MEX,41598,41598,655,657,-2,0.01579403,0.015745949,-4.8079233e-05
2010.0,MEX,46019,46019,693,720,-27,0.01564571,0.015058997,-0.0005867142
2011.0,MEX,50030,50030,736,731,5,0.014611233,0.014711173,9.9940036e-05
2012.0,MEX,53884,53884,746,705,41,0.013083661,0.013844555,0.00076089374
2013.0,MEX,57420,57420,782,785,-3,0.013671195,0.013618948,-5.2246603e-05
2014.0,MEX,60394,60394,877,796,81,0.013180117,0.01452131,0.0013411929
2015.0,MEX,63863,63863,958,886,72,0.013873448,0.015000861,0.0011274134
2016.0,MEX,68108,68108,1033,969,64,0.014227403,0.015167087,0.00093968405
2017.0,MEX,72114,72114,1077,1004,73,0.013922401,0.014934687,0.001012286
2018.0,MEX,76079,76079,1126,1020,106,0.013407116,0.014800405,0.0013932886
2019.0,MEX,78875,78875,1117,1126,-9,0.014275753,0.014161648,-0.000114104594
2020.0,MEX,79206,79206,1023,1261,-238,0.01592051,0.012915689,-0.0030048229
2021.0,MEX,76412,76412,932,1222,-290,0.015992252,0.012197037,-0.0037952154
2022.0,MEX,0,0,763,1016,-253,,,
2023.0,MEX,0,0,477,557,-80,,,
1996.0,MHL,2,2,0,0,0,0.0,0.0,0.0
1997.0,MHL,1,1,0,1,-1,1.0,0.0,-1.0
2000.0,MHL,9,9,1,0,1,0.0,0.11111111,0.11111111
2001.0,MHL,8,8,0,2,-2,0.25,0.0,-0.25
2003.0,MHL,7,7,1,1,0,0.14285715,0.14285715,0.0
2005.0,MHL,13,13,2,1,1,0.07692308,0.15384616,0.07692308
2006.0,MHL,13,13,2,2,0,0.15384616,0.15384616,0.0
2009.0,MHL,10,10,0,0,0,0.0,0.0,0.0
2012.0,MHL,9,9,0,0,0,0.0,0.0,0.0
2014.0,MHL,7,7,2,0,2,0.0,0.2857143,0.2857143
2018.0,MHL,14,14,2,0,2,0.0,0.14285715,0.14285715
2019.0,MHL,19,19,1,0,1,0.0,0.05263158,0.05263158
2020.0,MHL,21,21,2,1,1,0.04761905,0.0952381,0.04761905
2021.0,MHL,21,21,0,0,0,0.0,0.0,0.0
1996.0,MKD,221,221,0,0,0,0.0,0.0,0.0
1997.0,MKD,278,278,9,7,2,0.025179856,0.0323741,0.007194245
1998.0,MKD,337,337,10,16,-6,0.047477745,0.029673591,-0.017804155
1999.0,MKD,387,387,14,14,0,0.03617571,0.03617571,0.0
2000.0,MKD,424,424,16,14,2,0.03301887,0.03773585,0.004716981
2001.0,MKD,466,466,23,18,5,0.03862661,0.049356222,0.010729614
2002.0,MKD,542,542,32,33,-1,0.06088561,0.05904059,-0.0018450185
2003.0,MKD,628,628,32,17,15,0.027070064,0.050955415,0.02388535
2004.0,MKD,748,748,53,15,38,0.020053476,0.07085562,0.050802138
2005.0,MKD,803,803,44,79,-35,0.09838107,0.05479452,-0.043586552
2006.0,MKD,931,931,33,54,-21,0.058002148,0.035445757,-0.02255639
2007.0,MKD,1069,1069,35,36,-1,0.033676334,0.03274088,-0.0009354537
2008.0,MKD,1194,1194,38,37,1,0.030988274,0.031825796,0.0008375209
2009.0,MKD,1311,1311,37,63,-26,0.04805492,0.02822273,-0.019832188
2010.0,MKD,1396,1396,17,65,-48,0.046561606,0.012177651,-0.034383953
2011.0,MKD,1543,1543,20,29,-9,0.018794555,0.012961763,-0.005832793
2012.0,MKD,1676,1676,22,27,-5,0.016109785,0.013126492,-0.0029832935
2013.0,MKD,1837,1837,21,25,-4,0.013609146,0.011431682,-0.0021774631
2014.0,MKD,1944,1944,23,38,-15,0.019547325,0.011831276,-0.0077160494
2015.0,MKD,2017,2017,29,25,4,0.012394645,0.014377789,0.0019831434
2016.0,MKD,2077,2077,27,38,-11,0.018295618,0.012999519,-0.0052961
2017.0,MKD,2152,2152,37,43,-6,0.019981412,0.017193308,-0.0027881041
2018.0,MKD,2166,2166,45,52,-7,0.024007387,0.020775624,-0.0032317636
2019.0,MKD,2152,2152,34,61,-27,0.028345725,0.015799256,-0.0125464685
2020.0,MKD,2140,2140,47,46,1,0.021495327,0.021962617,0.00046728973
2021.0,MKD,1991,1991,21,34,-13,0.017076846,0.010547464,-0.0065293824
2022.0,MKD,0,0,29,28,1,,,
1996.0,MLI,129,129,0,0,0,0.0,0.0,0.0
1997.0,MLI,151,151,6,8,-2,0.052980132,0.0397351,-0.013245033
1998.0,MLI,160,160,4,13,-9,0.08125,0.025,-0.05625
1999.0,MLI,175,175,11,9,2,0.05142857,0.06285714,0.011428571
2000.0,MLI,198,198,13,16,-3,0.08080808,0.065656565,-0.015151516
2001.0,MLI,208,208,9,15,-6,0.072115384,0.043269232,-0.028846154
2002.0,MLI,233,233,14,12,2,0.051502146,0.060085837,0.008583691
2003.0,MLI,254,254,13,13,0,0.051181104,0.051181104,0.0
2004.0,MLI,313,313,19,9,10,0.028753994,0.060702875,0.031948883
2005.0,MLI,382,382,26,11,15,0.028795812,0.06806283,0.039267015
2006.0,MLI,437,437,29,12,17,0.027459955,0.066361554,0.0389016
2007.0,MLI,499,499,17,18,-1,0.036072146,0.034068137,-0.002004008
2008.0,MLI,524,524,15,25,-10,0.047709923,0.028625954,-0.01908397
2009.0,MLI,565,565,21,37,-16,0.06548673,0.03716814,-0.028318584
2010.0,MLI,613,613,34,28,6,0.045677,0.055464927,0.009787928
2011.0,MLI,630,630,25,22,3,0.034920637,0.03968254,0.004761905
2012.0,MLI,666,666,33,24,9,0.036036037,0.04954955,0.013513514
2013.0,MLI,679,679,23,32,-9,0.04712813,0.033873342,-0.013254787
2014.0,MLI,728,728,46,33,13,0.04532967,0.06318682,0.017857144
2015.0,MLI,752,752,34,36,-2,0.047872342,0.045212764,-0.0026595744
2016.0,MLI,819,819,59,21,38,0.025641026,0.072039075,0.046398047
2017.0,MLI,869,869,49,37,12,0.042577676,0.05638665,0.013808976
2018.0,MLI,938,938,60,28,32,0.029850746,0.06396589,0.03411514
2019.0,MLI,1016,1016,63,34,29,0.033464566,0.062007874,0.028543307
2020.0,MLI,1003,1003,44,37,7,0.036889333,0.043868396,0.0069790627
2021.0,MLI,962,962,43,33,10,0.034303535,0.044698544,0.01039501
2022.0,MLI,0,0,35,26,9,,,
1996.0,MLT,115,115,0,0,0,0.0,0.0,0.0
1997.0,MLT,124,124,2,7,-5,0.05645161,0.016129032,-0.04032258
1998.0,MLT,142,142,9,9,0,0.06338028,0.06338028,0.0
1999.0,MLT,150,150,7,13,-6,0.086666666,0.046666667,-0.04
2000.0,MLT,175,175,10,4,6,0.022857143,0.057142857,0.034285713
2001.0,MLT,195,195,9,6,3,0.03076923,0.046153847,0.015384615
2002.0,MLT,218,218,9,6,3,0.027522936,0.041284405,0.013761468
2003.0,MLT,225,225,5,6,-1,0.026666667,0.022222223,-0.0044444446
2004.0,MLT,256,256,14,4,10,0.015625,0.0546875,0.0390625
2005.0,MLT,289,289,13,2,11,0.0069204154,0.044982698,0.038062282
2006.0,MLT,347,347,14,15,-1,0.043227665,0.04034582,-0.0028818443
2007.0,MLT,395,395,4,9,-5,0.02278481,0.010126582,-0.012658228
2008.0,MLT,460,460,17,10,7,0.02173913,0.036956523,0.015217391
2009.0,MLT,508,508,16,14,2,0.027559055,0.031496063,0.003937008
2010.0,MLT,583,583,15,14,1,0.024013722,0.025728988,0.0017152659
2011.0,MLT,654,654,23,13,10,0.019877676,0.035168197,0.01529052
2012.0,MLT,736,736,20,13,7,0.017663043,0.027173912,0.009510869
2013.0,MLT,829,829,19,15,4,0.018094089,0.02291918,0.0048250905
2014.0,MLT,934,934,31,20,11,0.021413276,0.03319058,0.011777302
2015.0,MLT,1030,1030,36,19,17,0.018446602,0.034951456,0.016504854
2016.0,MLT,1097,1097,36,25,11,0.022789426,0.03281677,0.010027347
2017.0,MLT,1165,1165,42,31,11,0.026609441,0.0360515,0.00944206
2018.0,MLT,1254,1254,46,41,5,0.032695375,0.036682617,0.0039872406
2019.0,MLT,1352,1352,49,36,13,0.026627218,0.036242604,0.009615385
2020.0,MLT,1415,1415,54,29,25,0.0204947,0.038162544,0.017667845
2021.0,MLT,1400,1400,50,42,8,0.03,0.035714287,0.0057142857
2022.0,MLT,0,0,37,29,8,,,
1996.0,MMR,39,39,0,0,0,0.0,0.0,0.0
1997.0,MMR,55,55,0,0,0,0.0,0.0,0.0
1998.0,MMR,75,75,2,0,2,0.0,0.026666667,0.026666667
1999.0,MMR,91,91,8,1,7,0.010989011,0.08791209,0.07692308
2000.0,MMR,94,94,2,7,-5,0.07446808,0.021276595,-0.05319149
2001.0,MMR,100,100,5,4,1,0.04,0.05,0.01
2002.0,MMR,114,114,2,3,-1,0.02631579,0.01754386,-0.00877193
2003.0,MMR,131,131,13,1,12,0.007633588,0.099236645,0.091603056
2004.0,MMR,138,138,6,4,2,0.028985508,0.04347826,0.014492754
2005.0,MMR,143,143,4,0,4,0.0,0.027972028,0.027972028
2006.0,MMR,153,153,4,6,-2,0.039215688,0.026143791,-0.013071896
2007.0,MMR,165,165,3,6,-3,0.036363635,0.018181818,-0.018181818
2008.0,MMR,184,184,3,3,0,0.016304348,0.016304348,0.0
2009.0,MMR,201,201,7,2,5,0.0099502485,0.03482587,0.024875622
2010.0,MMR,229,229,8,4,4,0.01746725,0.0349345,0.01746725
2011.0,MMR,254,254,11,8,3,0.031496063,0.04330709,0.011811024
2012.0,MMR,279,279,9,7,2,0.025089607,0.032258064,0.007168459
2013.0,MMR,368,368,24,7,17,0.019021738,0.06521739,0.046195652
2014.0,MMR,437,437,20,6,14,0.013729977,0.045766592,0.032036614
2015.0,MMR,554,554,28,13,15,0.023465704,0.050541516,0.027075812
2016.0,MMR,699,699,36,23,13,0.032904148,0.051502146,0.018597998
2017.0,MMR,825,825,46,26,20,0.03151515,0.055757575,0.024242423
2018.0,MMR,970,970,51,29,22,0.029896908,0.05257732,0.022680413
2019.0,MMR,1029,1029,64,60,4,0.058309037,0.062196307,0.0038872692
2020.0,MMR,1037,1037,55,36,19,0.034715526,0.05303761,0.018322082
2021.0,MMR,1012,1012,76,54,22,0.053359684,0.07509881,0.02173913
2022.0,MMR,0,0,47,46,1,,,
2023.0,MMR,0,0,30,22,8,,,
1996.0,MNE,10,10,0,0,0,0.0,0.0,0.0
1997.0,MNE,24,24,0,0,0,0.0,0.0,0.0
1998.0,MNE,27,27,3,3,0,0.11111111,0.11111111,0.0
1999.0,MNE,30,30,3,2,1,0.06666667,0.1,0.033333335
2000.0,MNE,33,33,1,2,-1,0.060606062,0.030303031,-0.030303031
2001.0,MNE,46,46,6,2,4,0.04347826,0.13043478,0.08695652
2002.0,MNE,41,41,3,9,-6,0.2195122,0.07317073,-0.14634146
2003.0,MNE,62,62,2,1,1,0.016129032,0.032258064,0.016129032
2004.0,MNE,71,71,9,7,2,0.09859155,0.12676056,0.028169014
2005.0,MNE,97,97,13,3,10,0.030927835,0.13402061,0.10309278
2006.0,MNE,132,132,15,13,2,0.09848485,0.11363637,0.015151516
2007.0,MNE,169,169,14,6,8,0.03550296,0.082840234,0.04733728
2008.0,MNE,231,231,24,7,17,0.030303031,0.103896104,0.07359307
2009.0,MNE,283,283,13,3,10,0.010600707,0.045936394,0.03533569
2010.0,MNE,343,343,19,5,14,0.014577259,0.055393588,0.040816326
2011.0,MNE,406,406,12,4,8,0.009852217,0.02955665,0.019704433
2012.0,MNE,490,490,10,4,6,0.008163265,0.020408163,0.012244898
2013.0,MNE,548,548,10,10,0,0.018248174,0.018248174,0.0
2014.0,MNE,627,627,27,8,19,0.0127591705,0.043062203,0.030303031
2015.0,MNE,701,701,19,10,9,0.014265335,0.027104137,0.012838801
2016.0,MNE,755,755,29,13,16,0.017218543,0.038410597,0.021192053
2017.0,MNE,792,792,23,27,-4,0.03409091,0.029040404,-0.005050505
2018.0,MNE,832,832,23,25,-2,0.030048076,0.02764423,-0.0024038462
2019.0,MNE,831,831,12,41,-29,0.049338147,0.014440433,-0.034897715
2020.0,MNE,795,795,21,54,-33,0.06792453,0.026415095,-0.041509435
2021.0,MNE,702,702,29,94,-65,0.13390313,0.04131054,-0.09259259
2022.0,MNE,0,0,56,62,-6,,,
1996.0,MNG,77,77,0,0,0,0.0,0.0,0.0
1997.0,MNG,80,80,1,8,-7,0.1,0.0125,-0.0875
1998.0,MNG,108,108,3,4,-1,0.037037037,0.027777778,-0.009259259
1999.0,MNG,114,114,2,3,-1,0.02631579,0.01754386,-0.00877193
2000.0,MNG,129,129,5,3,2,0.023255814,0.03875969,0.015503876
2001.0,MNG,141,141,8,14,-6,0.09929078,0.056737587,-0.04255319
2002.0,MNG,160,160,14,6,8,0.0375,0.0875,0.05
2003.0,MNG,182,182,11,4,7,0.021978023,0.06043956,0.03846154
2004.0,MNG,211,211,13,8,5,0.037914693,0.061611373,0.023696683
2005.0,MNG,246,246,6,7,-1,0.028455285,0.024390243,-0.0040650405
2006.0,MNG,292,292,7,8,-1,0.02739726,0.023972603,-0.0034246575
2007.0,MNG,339,339,14,10,4,0.029498525,0.041297935,0.01179941
2008.0,MNG,408,408,20,9,11,0.022058824,0.04901961,0.026960785
2009.0,MNG,425,425,14,7,7,0.016470589,0.032941177,0.016470589
2010.0,MNG,476,476,20,20,0,0.042016808,0.042016808,0.0
2011.0,MNG,508,508,22,14,8,0.027559055,0.04330709,0.015748031
2012.0,MNG,603,603,30,7,23,0.011608624,0.049751244,0.03814262
2013.0,MNG,657,657,24,19,5,0.02891933,0.03652968,0.00761035
2014.0,MNG,747,747,41,17,24,0.022757698,0.05488621,0.032128513
2015.0,MNG,816,816,41,40,1,0.04901961,0.0502451,0.0012254902
2016.0,MNG,910,910,46,25,21,0.027472528,0.05054945,0.023076924
2017.0,MNG,1001,1001,42,17,25,0.016983017,0.04195804,0.024975024
2018.0,MNG,1122,1122,53,39,14,0.034759358,0.047237076,0.012477718
2019.0,MNG,1260,1260,84,38,46,0.03015873,0.06666667,0.036507938
2020.0,MNG,1300,1300,62,41,21,0.03153846,0.047692306,0.016153846
2021.0,MNG,1306,1306,72,40,32,0.030627871,0.05513017,0.024502298
2022.0,MNG,0,0,37,36,1,,,
1997.0,MNP,2,2,0,0,0,0.0,0.0,0.0
1998.0,MNP,3,3,0,0,0,0.0,0.0,0.0
2000.0,MNP,2,2,0,1,-1,0.5,0.0,-0.5
2001.0,MNP,2,2,0,1,-1,0.5,0.0,-0.5
2003.0,MNP,8,8,0,0,0,0.0,0.0,0.0
2005.0,MNP,8,8,0,0,0,0.0,0.0,0.0
2007.0,MNP,8,8,0,0,0,0.0,0.0,0.0
2008.0,MNP,7,7,2,1,1,0.14285715,0.2857143,0.14285715
2012.0,MNP,8,8,2,3,-1,0.375,0.25,-0.125
2014.0,MNP,10,10,1,0,1,0.0,0.1,0.1
2015.0,MNP,13,13,3,0,3,0.0,0.23076923,0.23076923
2017.0,MNP,10,10,4,1,3,0.1,0.4,0.3
2019.0,MNP,15,15,3,1,2,0.06666667,0.2,0.13333334
2021.0,MNP,13,13,1,0,1,0.0,0.07692308,0.07692308
2022.0,MNP,0,0,1,6,-5,,,
1996.0,MOZ,59,59,0,0,0,0.0,0.0,0.0
1997.0,MOZ,75,75,6,3,3,0.04,0.08,0.04
1998.0,MOZ,101,101,7,4,3,0.03960396,0.06930693,0.02970297
1999.0,MOZ,120,120,3,7,-4,0.058333334,0.025,-0.033333335
2000.0,MOZ,127,127,5,9,-4,0.070866145,0.03937008,-0.031496063
2001.0,MOZ,130,130,3,6,-3,0.046153847,0.023076924,-0.023076924
2002.0,MOZ,143,143,6,8,-2,0.055944055,0.04195804,-0.013986014
2003.0,MOZ,152,152,5,7,-2,0.04605263,0.032894738,-0.013157895
2004.0,MOZ,193,193,10,4,6,0.020725388,0.051813472,0.031088082
2005.0,MOZ,217,217,10,5,5,0.023041476,0.04608295,0.023041476
2006.0,MOZ,235,235,8,13,-5,0.05531915,0.034042552,-0.021276595
2007.0,MOZ,271,271,14,3,11,0.011070111,0.051660515,0.040590405
2008.0,MOZ,287,287,14,16,-2,0.05574913,0.048780486,-0.006968641
2009.0,MOZ,331,331,17,18,-1,0.054380666,0.051359516,-0.003021148
2010.0,MOZ,349,349,23,15,8,0.042979944,0.065902576,0.022922637
2011.0,MOZ,375,375,29,20,9,0.053333335,0.07733333,0.024
2012.0,MOZ,463,463,23,14,9,0.030237582,0.049676027,0.019438446
2013.0,MOZ,574,574,28,17,11,0.029616725,0.048780486,0.019163763
2014.0,MOZ,637,637,34,25,9,0.039246466,0.053375196,0.014128729
2015.0,MOZ,747,747,46,32,14,0.04283802,0.061579652,0.018741634
2016.0,MOZ,846,846,47,33,14,0.039007094,0.055555556,0.016548464
2017.0,MOZ,934,934,46,40,6,0.042826552,0.049250536,0.006423983
2018.0,MOZ,1003,1003,47,39,8,0.03888335,0.04685942,0.007976072
2019.0,MOZ,1122,1122,59,40,19,0.035650622,0.05258467,0.016934047
2020.0,MOZ,1178,1178,68,37,31,0.031409167,0.057724956,0.02631579
2021.0,MOZ,1152,1152,53,34,19,0.029513888,0.046006944,0.016493056
2022.0,MOZ,0,0,44,51,-7,,,
1996.0,MRT,13,13,0,0,0,0.0,0.0,0.0
1997.0,MRT,15,15,0,2,-2,0.13333334,0.0,-0.13333334
1998.0,MRT,19,19,2,1,1,0.05263158,0.10526316,0.05263158
1999.0,MRT,32,32,3,0,3,0.0,0.09375,0.09375
2000.0,MRT,37,37,2,0,2,0.0,0.054054055,0.054054055
2001.0,MRT,34,34,1,4,-3,0.11764706,0.029411765,-0.0882353
2002.0,MRT,32,32,2,6,-4,0.1875,0.0625,-0.125
2003.0,MRT,30,30,1,3,-2,0.1,0.033333335,-0.06666667
2004.0,MRT,32,32,4,3,1,0.09375,0.125,0.03125
2005.0,MRT,35,35,4,3,1,0.08571429,0.114285715,0.028571429
2006.0,MRT,40,40,6,1,5,0.025,0.15,0.125
2007.0,MRT,41,41,3,4,-1,0.09756097,0.07317073,-0.024390243
2008.0,MRT,47,47,2,2,0,0.04255319,0.04255319,0.0
2009.0,MRT,76,76,6,1,5,0.013157895,0.078947365,0.065789476
2010.0,MRT,87,87,4,1,3,0.011494253,0.04597701,0.03448276
2011.0,MRT,95,95,2,5,-3,0.05263158,0.021052632,-0.031578947
2012.0,MRT,111,111,7,3,4,0.027027028,0.06306306,0.036036037
2013.0,MRT,118,118,2,2,0,0.016949153,0.016949153,0.0
2014.0,MRT,129,129,4,3,1,0.023255814,0.031007752,0.007751938
2015.0,MRT,132,132,6,4,2,0.030303031,0.045454547,0.015151516
2016.0,MRT,154,154,8,4,4,0.025974026,0.051948052,0.025974026
2017.0,MRT,177,177,13,6,7,0.033898305,0.073446326,0.03954802
2018.0,MRT,184,184,8,6,2,0.032608695,0.04347826,0.010869565
2019.0,MRT,208,208,20,8,12,0.03846154,0.09615385,0.057692308
2020.0,MRT,215,215,10,1,9,0.004651163,0.046511628,0.041860465
2021.0,MRT,216,216,12,10,2,0.046296295,0.055555556,0.009259259
2022.0,MRT,0,0,11,0,11,,,
1997.0,MSR,11,11,4,0,4,0.0,0.36363637,0.36363637
2001.0,MSR,7,7,2,0,2,0.0,0.2857143,0.2857143
2005.0,MSR,12,12,0,1,-1,0.083333336,0.0,-0.083333336
2006.0,MSR,13,13,2,1,1,0.07692308,0.15384616,0.07692308
2007.0,MSR,15,15,3,1,2,0.06666667,0.2,0.13333334
2009.0,MSR,9,9,0,1,-1,0.11111111,0.0,-0.11111111
2014.0,MSR,9,9,1,1,0,0.11111111,0.11111111,0.0
2016.0,MSR,11,11,1,1,0,0.09090909,0.09090909,0.0
2017.0,MSR,12,12,2,1,1,0.083333336,0.16666667,0.083333336
2020.0,MSR,5,5,0,3,-3,0.6,0.0,-0.6
1996.0,MTQ,79,79,0,0,0,0.0,0.0,0.0
1997.0,MTQ,86,86,7,7,0,0.08139535,0.08139535,0.0
1998.0,MTQ,87,87,8,13,-5,0.14942528,0.09195402,-0.057471264
1999.0,MTQ,76,76,9,17,-8,0.2236842,0.118421055,-0.10526316
2000.0,MTQ,62,62,11,24,-13,0.38709676,0.17741935,-0.20967741
2001.0,MTQ,44,44,7,15,-8,0.3409091,0.1590909,-0.18181819
2002.0,MTQ,51,51,14,8,6,0.15686275,0.27450982,0.11764706
2003.0,MTQ,66,66,13,9,4,0.13636364,0.1969697,0.060606062
2004.0,MTQ,99,99,24,5,19,0.05050505,0.24242425,0.1919192
2005.0,MTQ,100,100,15,16,-1,0.16,0.15,-0.01
2006.0,MTQ,103,103,13,18,-5,0.17475729,0.1262136,-0.048543688
2007.0,MTQ,108,108,23,17,6,0.1574074,0.21296297,0.055555556
2008.0,MTQ,109,109,15,14,1,0.12844037,0.13761468,0.0091743115
2009.0,MTQ,95,95,13,24,-11,0.25263157,0.1368421,-0.11578947
2010.0,MTQ,91,91,22,20,2,0.21978022,0.24175824,0.021978023
2011.0,MTQ,101,101,29,12,17,0.11881188,0.28712872,0.16831683
2012.0,MTQ,141,141,41,15,26,0.10638298,0.29078013,0.18439716
2013.0,MTQ,135,135,20,37,-17,0.27407408,0.14814815,-0.12592593
2014.0,MTQ,140,140,22,27,-5,0.19285715,0.15714286,-0.035714287
2015.0,MTQ,157,157,32,31,1,0.19745223,0.20382166,0.006369427
2016.0,MTQ,139,139,20,35,-15,0.25179857,0.1438849,-0.107913665
2017.0,MTQ,123,123,19,26,-7,0.21138212,0.15447155,-0.05691057
2018.0,MTQ,112,112,28,41,-13,0.36607143,0.25,-0.116071425
2019.0,MTQ,108,108,31,28,3,0.25925925,0.28703704,0.027777778
2020.0,MTQ,107,107,22,28,-6,0.26168224,0.20560747,-0.056074765
2022.0,MTQ,0,0,14,12,2,,,
1996.0,MUS,51,51,0,0,0,0.0,0.0,0.0
1997.0,MUS,72,72,1,4,-3,0.055555556,0.013888889,-0.041666668
1998.0,MUS,104,104,7,0,7,0.0,0.067307696,0.067307696
1999.0,MUS,112,112,0,4,-4,0.035714287,0.0,-0.035714287
2000.0,MUS,123,123,7,4,3,0.032520324,0.05691057,0.024390243
2001.0,MUS,127,127,2,4,-2,0.031496063,0.015748031,-0.015748031
2002.0,MUS,128,128,2,4,-2,0.03125,0.015625,-0.015625
2003.0,MUS,139,139,5,3,2,0.021582734,0.035971224,0.01438849
2004.0,MUS,146,146,3,2,1,0.01369863,0.020547945,0.006849315
2005.0,MUS,150,150,5,6,-1,0.04,0.033333335,-0.006666667
2006.0,MUS,169,169,2,4,-2,0.02366864,0.01183432,-0.01183432
2007.0,MUS,201,201,9,4,5,0.019900497,0.04477612,0.024875622
2008.0,MUS,220,220,4,5,-1,0.022727273,0.018181818,-0.0045454544
2009.0,MUS,241,241,9,10,-1,0.041493777,0.0373444,-0.004149378
2010.0,MUS,282,282,10,11,-1,0.039007094,0.035460994,-0.0035460992
2011.0,MUS,300,300,11,14,-3,0.046666667,0.036666665,-0.01
2012.0,MUS,317,317,7,10,-3,0.03154574,0.02208202,-0.009463723
2013.0,MUS,337,337,5,4,1,0.011869436,0.014836796,0.002967359
2014.0,MUS,373,373,12,6,6,0.01608579,0.03217158,0.01608579
2015.0,MUS,411,411,11,3,8,0.00729927,0.02676399,0.01946472
2016.0,MUS,435,435,9,4,5,0.009195402,0.020689655,0.011494253
2017.0,MUS,458,458,15,17,-2,0.037117902,0.03275109,-0.0043668123
2018.0,MUS,508,508,23,11,12,0.021653544,0.04527559,0.023622047
2019.0,MUS,525,525,21,18,3,0.034285713,0.04,0.0057142857
2020.0,MUS,532,532,26,12,14,0.02255639,0.04887218,0.02631579
2021.0,MUS,534,534,21,13,8,0.02434457,0.039325844,0.014981274
2022.0,MUS,0,0,10,7,3,,,
1996.0,MWI,125,125,0,0,0,0.0,0.0,0.0
1997.0,MWI,155,155,4,7,-3,0.045161292,0.025806451,-0.019354839
1998.0,MWI,201,201,16,8,8,0.039800994,0.07960199,0.039800994
1999.0,MWI,221,221,12,13,-1,0.05882353,0.054298643,-0.004524887
2000.0,MWI,244,244,17,19,-2,0.07786885,0.06967213,-0.008196721
2001.0,MWI,262,262,18,29,-11,0.110687025,0.06870229,-0.041984733
2002.0,MWI,301,301,28,21,7,0.069767445,0.093023255,0.023255814
2003.0,MWI,346,346,24,15,9,0.0433526,0.06936416,0.02601156
2004.0,MWI,410,410,34,17,17,0.041463416,0.08292683,0.041463416
2005.0,MWI,471,471,18,22,-4,0.046709128,0.03821656,-0.008492569
2006.0,MWI,535,535,32,23,9,0.042990655,0.059813086,0.01682243
2007.0,MWI,585,585,25,18,7,0.03076923,0.042735044,0.011965812
2008.0,MWI,656,656,35,38,-3,0.05792683,0.05335366,-0.0045731706
2009.0,MWI,769,769,51,45,6,0.058517557,0.0663199,0.0078023407
2010.0,MWI,855,855,42,38,4,0.044444446,0.049122807,0.0046783625
2011.0,MWI,950,950,61,52,9,0.05473684,0.06421053,0.009473684
2012.0,MWI,1061,1061,66,59,7,0.05560792,0.062205467,0.0065975497
2013.0,MWI,1117,1117,41,71,-30,0.063563116,0.03670546,-0.026857654
2014.0,MWI,1190,1190,43,72,-29,0.0605042,0.036134455,-0.024369748
2015.0,MWI,1335,1335,73,63,10,0.047191013,0.054681648,0.007490637
2016.0,MWI,1484,1484,88,65,23,0.04380054,0.05929919,0.015498652
2017.0,MWI,1616,1616,91,67,24,0.041460395,0.056311883,0.014851485
2018.0,MWI,1761,1761,71,84,-13,0.04770017,0.040318,-0.0073821694
2019.0,MWI,1908,1908,100,86,14,0.045073375,0.0524109,0.0073375264
2020.0,MWI,1956,1956,103,87,16,0.04447853,0.052658487,0.008179959
2021.0,MWI,1894,1894,95,84,11,0.04435058,0.050158396,0.005807814
2022.0,MWI,0,0,85,68,17,,,
1996.0,MYS,1939,1939,0,0,0,0.0,0.0,0.0
1997.0,MYS,2397,2397,56,50,6,0.020859407,0.023362536,0.002503129
1998.0,MYS,2961,2961,82,49,33,0.016548464,0.027693346,0.011144884
1999.0,MYS,3296,3296,108,71,37,0.021541262,0.03276699,0.011225728
2000.0,MYS,3705,3705,129,75,54,0.020242915,0.034817815,0.014574898
2001.0,MYS,4175,4175,97,98,-1,0.023473054,0.023233533,-0.00023952096
2002.0,MYS,4821,4821,164,116,48,0.024061399,0.03401784,0.009956441
2003.0,MYS,5584,5584,168,84,84,0.01504298,0.03008596,0.01504298
2004.0,MYS,6767,6767,151,111,40,0.016403133,0.022314172,0.0059110387
2005.0,MYS,8062,8062,175,139,36,0.01724138,0.021706773,0.0044653933
2006.0,MYS,10165,10165,219,143,76,0.01406788,0.021544516,0.0074766357
2007.0,MYS,13299,13299,281,175,106,0.013158884,0.021129409,0.007970524
2008.0,MYS,16840,16840,373,235,138,0.0139548695,0.022149643,0.008194774
2009.0,MYS,21381,21381,467,285,182,0.013329592,0.021841822,0.008512231
2010.0,MYS,26085,26085,586,392,194,0.015027794,0.022465019,0.0074372245
2011.0,MYS,31263,31263,661,461,200,0.014745866,0.021143204,0.0063973386
2012.0,MYS,36046,36046,795,699,96,0.019391889,0.022055151,0.0026632636
2013.0,MYS,41397,41397,938,832,106,0.020098075,0.022658646,0.002560572
2014.0,MYS,46458,46458,1051,935,116,0.020125706,0.022622583,0.0024968788
2015.0,MYS,50507,50507,942,1153,-211,0.02282852,0.01865088,-0.004177639
2016.0,MYS,54245,54245,909,1346,-437,0.024813347,0.016757306,-0.008056042
2017.0,MYS,57984,57984,846,1735,-889,0.029922048,0.014590232,-0.015331816
2018.0,MYS,60755,60755,924,1805,-881,0.029709488,0.015208625,-0.014500864
2019.0,MYS,62806,62806,903,1735,-832,0.027624749,0.014377607,-0.013247142
2020.0,MYS,63202,63202,961,1737,-776,0.027483307,0.015205215,-0.012278092
2021.0,MYS,60238,60238,934,1666,-732,0.027656961,0.015505163,-0.012151798
2022.0,MYS,0,0,784,1275,-491,,,
2023.0,MYS,0,0,528,845,-317,,,
1996.0,NAM,88,88,0,0,0,0.0,0.0,0.0
1997.0,NAM,107,107,9,3,6,0.028037382,0.08411215,0.056074765
1998.0,NAM,118,118,4,2,2,0.016949153,0.033898305,0.016949153
1999.0,NAM,129,129,5,9,-4,0.069767445,0.03875969,-0.031007752
2000.0,NAM,128,128,4,9,-5,0.0703125,0.03125,-0.0390625
2001.0,NAM,129,129,2,7,-5,0.054263566,0.015503876,-0.03875969
2002.0,NAM,130,130,12,8,4,0.06153846,0.092307694,0.03076923
2003.0,NAM,153,153,16,8,8,0.052287582,0.104575165,0.052287582
2004.0,NAM,155,155,9,14,-5,0.090322584,0.058064517,-0.032258064
2005.0,NAM,163,163,4,5,-1,0.030674847,0.024539877,-0.006134969
2006.0,NAM,161,161,4,12,-8,0.07453416,0.024844721,-0.049689442
2007.0,NAM,172,172,5,11,-6,0.06395349,0.029069768,-0.034883723
2008.0,NAM,177,177,14,5,9,0.028248588,0.07909604,0.050847456
2009.0,NAM,209,209,15,3,12,0.014354067,0.07177033,0.057416268
2010.0,NAM,240,240,11,5,6,0.020833334,0.045833334,0.025
2011.0,NAM,297,297,24,8,16,0.026936026,0.08080808,0.053872053
2012.0,NAM,353,353,33,9,24,0.02549575,0.09348442,0.06798867
2013.0,NAM,398,398,24,13,11,0.032663316,0.06030151,0.027638191
2014.0,NAM,438,438,24,18,6,0.04109589,0.05479452,0.01369863
2015.0,NAM,462,462,21,26,-5,0.056277055,0.045454547,-0.010822511
2016.0,NAM,503,503,27,24,3,0.04771372,0.05367793,0.005964215
2017.0,NAM,555,555,40,32,8,0.05765766,0.072072074,0.014414415
2018.0,NAM,634,634,36,24,12,0.03785489,0.056782335,0.018927446
2019.0,NAM,691,691,54,28,26,0.040520985,0.07814761,0.037626628
2020.0,NAM,733,733,43,25,18,0.03410641,0.05866303,0.024556616
2021.0,NAM,734,734,48,33,15,0.044959128,0.065395094,0.020435967
2022.0,NAM,0,0,30,31,-1,,,
2023.0,NAM,0,0,25,18,7,,,
1996.0,NCL,65,65,0,0,0,0.0,0.0,0.0
1997.0,NCL,73,73,6,5,1,0.06849315,0.08219178,0.01369863
1998.0,NCL,83,83,9,10,-1,0.12048193,0.10843374,-0.012048192
1999.0,NCL,93,93,16,11,5,0.11827957,0.17204301,0.05376344
2000.0,NCL,100,100,12,6,6,0.06,0.12,0.06
2001.0,NCL,110,110,13,7,6,0.06363636,0.11818182,0.054545455
2002.0,NCL,108,108,14,14,0,0.12962963,0.12962963,0.0
2003.0,NCL,134,134,18,12,6,0.08955224,0.13432837,0.04477612
2004.0,NCL,159,159,26,15,11,0.094339624,0.16352202,0.06918239
2005.0,NCL,194,194,32,17,15,0.087628864,0.16494845,0.077319585
2006.0,NCL,217,217,32,26,6,0.11981567,0.14746544,0.02764977
2007.0,NCL,247,247,29,13,16,0.05263158,0.11740891,0.06477733
2008.0,NCL,267,267,28,18,10,0.06741573,0.10486891,0.037453182
2009.0,NCL,250,250,17,29,-12,0.116,0.068,-0.048
2010.0,NCL,245,245,18,34,-16,0.13877551,0.073469386,-0.06530612
2011.0,NCL,227,227,22,46,-24,0.20264317,0.0969163,-0.105726875
2012.0,NCL,266,266,40,25,15,0.09398496,0.15037593,0.05639098
2013.0,NCL,297,297,45,29,16,0.0976431,0.15151516,0.053872053
2014.0,NCL,331,331,39,30,9,0.09063444,0.11782477,0.027190333
2015.0,NCL,333,333,36,36,0,0.10810811,0.10810811,0.0
2016.0,NCL,328,328,34,40,-6,0.12195122,0.103658535,-0.018292682
2017.0,NCL,351,351,48,26,22,0.074074075,0.13675214,0.06267806
2018.0,NCL,365,365,45,39,6,0.10684931,0.12328767,0.016438356
2019.0,NCL,345,345,36,58,-22,0.16811594,0.104347825,-0.06376812
2020.0,NCL,327,327,50,65,-15,0.19877675,0.1529052,-0.04587156
2021.0,NCL,323,323,41,34,7,0.10526316,0.12693499,0.021671826
2022.0,NCL,0,0,41,22,19,,,
1996.0,NER,70,70,0,0,0,0.0,0.0,0.0
1997.0,NER,74,74,8,10,-2,0.13513513,0.10810811,-0.027027028
1998.0,NER,78,78,9,14,-5,0.17948718,0.115384616,-0.06410257
1999.0,NER,88,88,8,10,-2,0.11363637,0.09090909,-0.022727273
2000.0,NER,84,84,6,13,-7,0.15476191,0.071428575,-0.083333336
2001.0,NER,89,89,10,11,-1,0.123595506,0.11235955,-0.011235955
2002.0,NER,86,86,7,11,-4,0.12790698,0.08139535,-0.046511628
2003.0,NER,103,103,10,10,0,0.097087376,0.097087376,0.0
2004.0,NER,125,125,21,8,13,0.064,0.168,0.104
2005.0,NER,157,157,17,9,8,0.05732484,0.10828026,0.050955415
2006.0,NER,169,169,15,8,7,0.04733728,0.088757396,0.041420117
2007.0,NER,197,197,16,13,3,0.065989845,0.08121827,0.015228426
2008.0,NER,235,235,16,2,14,0.008510638,0.068085104,0.05957447
2009.0,NER,269,269,43,25,18,0.09293681,0.1598513,0.0669145
2010.0,NER,281,281,30,32,-2,0.113879,0.10676157,-0.0071174377
2011.0,NER,259,259,19,47,-28,0.18146718,0.07335907,-0.10810811
2012.0,NER,288,288,27,27,0,0.09375,0.09375,0.0
2013.0,NER,336,336,31,17,14,0.05059524,0.0922619,0.041666668
2014.0,NER,389,389,31,20,11,0.051413883,0.079691514,0.028277636
2015.0,NER,429,429,40,28,12,0.06526806,0.09324009,0.027972028
2016.0,NER,452,452,27,32,-5,0.07079646,0.059734512,-0.011061947
2017.0,NER,470,470,31,26,5,0.05531915,0.06595745,0.010638298
2018.0,NER,504,504,36,26,10,0.051587302,0.071428575,0.01984127
2019.0,NER,508,508,23,30,-7,0.05905512,0.04527559,-0.0137795275
2020.0,NER,518,518,33,21,12,0.04054054,0.06370656,0.023166023
2021.0,NER,525,525,36,19,17,0.036190476,0.068571426,0.032380953
2022.0,NER,0,0,15,18,-3,,,
2008.0,NFK,1,1,0,0,0,0.0,0.0,0.0
2022.0,NFK,0,0,0,0,0,,,
1996.0,NGA,2350,2350,0,0,0,0.0,0.0,0.0
1997.0,NGA,2871,2871,55,73,-18,0.02542668,0.019157087,-0.0062695923
1998.0,NGA,3420,3420,78,94,-16,0.02748538,0.022807017,-0.0046783625
1999.0,NGA,3708,3708,76,87,-11,0.023462784,0.020496225,-0.0029665588
2000.0,NGA,4078,4078,85,72,13,0.017655713,0.02084355,0.003187837
2001.0,NGA,4515,4515,84,97,-13,0.021483943,0.018604651,-0.0028792913
2002.0,NGA,5017,5017,82,100,-18,0.019932231,0.016344428,-0.0035878015
2003.0,NGA,5749,5749,120,86,34,0.014959123,0.020873195,0.005914072
2004.0,NGA,6919,6919,116,87,29,0.012574071,0.016765429,0.004191357
2005.0,NGA,8147,8147,94,109,-15,0.0133791575,0.01153799,-0.0018411685
2006.0,NGA,9565,9565,116,108,8,0.011291166,0.012127548,0.0008363826
2007.0,NGA,11007,11007,101,130,-29,0.011810666,0.009175979,-0.002634687
2008.0,NGA,12606,12606,119,145,-26,0.011502459,0.009439949,-0.00206251
2009.0,NGA,14059,14059,141,177,-36,0.0125898,0.010029163,-0.0025606374
2010.0,NGA,15189,15189,192,206,-14,0.013562446,0.012640727,-0.00092171965
2011.0,NGA,16298,16298,197,229,-32,0.014050804,0.012087373,-0.001963431
2012.0,NGA,17419,17419,217,254,-37,0.014581778,0.012457661,-0.0021241175
2013.0,NGA,18057,18057,230,237,-7,0.013125104,0.012737443,-0.0003876613
2014.0,NGA,18634,18634,267,293,-26,0.015723946,0.0143286465,-0.0013952989
2015.0,NGA,19791,19791,321,326,-5,0.016472133,0.016219493,-0.00025264008
2016.0,NGA,21578,21578,346,375,-29,0.017378813,0.01603485,-0.0013439615
2017.0,NGA,23961,23961,452,417,35,0.01740328,0.018863987,0.0014607069
2018.0,NGA,27169,27169,523,465,58,0.017115094,0.01924988,0.002134786
2019.0,NGA,29695,29695,573,585,-12,0.019700287,0.019296179,-0.00040410843
2020.0,NGA,31230,31230,645,593,52,0.018988153,0.020653218,0.0016650656
2021.0,NGA,30857,30857,653,653,0,0.021162136,0.021162136,0.0
2022.0,NGA,0,0,559,635,-76,,,
2023.0,NGA,0,0,306,460,-154,,,
1996.0,NIC,54,54,0,0,0,0.0,0.0,0.0
1997.0,NIC,66,66,5,6,-1,0.09090909,0.07575758,-0.015151516
1998.0,NIC,75,75,7,4,3,0.053333335,0.093333334,0.04
1999.0,NIC,74,74,6,6,0,0.08108108,0.08108108,0.0
2000.0,NIC,71,71,6,9,-3,0.12676056,0.08450704,-0.04225352
2001.0,NIC,71,71,2,9,-7,0.12676056,0.028169014,-0.09859155
2002.0,NIC,84,84,13,5,8,0.05952381,0.15476191,0.0952381
2003.0,NIC,104,104,12,5,7,0.048076924,0.115384616,0.067307696
2004.0,NIC,122,122,6,7,-1,0.057377048,0.04918033,-0.008196721
2005.0,NIC,136,136,7,2,5,0.014705882,0.05147059,0.036764707
2006.0,NIC,157,157,10,5,5,0.031847134,0.06369427,0.031847134
2007.0,NIC,177,177,10,9,1,0.050847456,0.056497175,0.0056497175
2008.0,NIC,190,190,9,8,1,0.042105265,0.047368422,0.005263158
2009.0,NIC,220,220,12,9,3,0.04090909,0.054545455,0.013636364
2010.0,NIC,222,222,11,9,2,0.04054054,0.04954955,0.009009009
2011.0,NIC,209,209,6,24,-18,0.114832535,0.028708134,-0.086124405
2012.0,NIC,216,216,10,13,-3,0.060185187,0.046296295,-0.013888889
2013.0,NIC,235,235,17,9,8,0.038297873,0.07234043,0.034042552
2014.0,NIC,235,235,8,13,-5,0.05531915,0.034042552,-0.021276595
2015.0,NIC,258,258,14,5,9,0.019379845,0.054263566,0.034883723
2016.0,NIC,266,266,12,10,2,0.037593983,0.04511278,0.007518797
2017.0,NIC,261,261,6,8,-2,0.03065134,0.022988506,-0.007662835
2018.0,NIC,259,259,15,16,-1,0.06177606,0.057915058,-0.0038610038
2019.0,NIC,254,254,10,11,-1,0.04330709,0.03937008,-0.003937008
2020.0,NIC,238,238,10,13,-3,0.05462185,0.042016808,-0.012605042
2021.0,NIC,206,206,4,14,-10,0.067961164,0.019417476,-0.048543688
2022.0,NIC,0,0,12,4,8,,,
2014.0,NIU,3,3,0,0,0,0.0,0.0,0.0
2016.0,NIU,4,4,0,0,0,0.0,0.0,0.0
2017.0,NIU,3,3,0,0,0,0.0,0.0,0.0
1996.0,NLD,35768,35768,0,0,0,0.0,0.0,0.0
1997.0,NLD,40363,40363,785,876,-91,0.021703044,0.019448506,-0.00225454
1998.0,NLD,44986,44986,1023,1047,-24,0.023273908,0.022740409,-0.0005334993
1999.0,NLD,48042,48042,1158,1051,107,0.02187669,0.02410391,0.002227218
2000.0,NLD,50540,50540,1337,1326,11,0.026236644,0.026454294,0.00021764939
2001.0,NLD,52450,52450,1514,1513,1,0.02884652,0.028865587,1.9065777e-05
2002.0,NLD,55071,55071,1695,1494,201,0.027128616,0.030778449,0.0036498338
2003.0,NLD,57573,57573,1530,1469,61,0.025515433,0.026574956,0.0010595245
2004.0,NLD,60118,60118,1277,1291,-14,0.021474434,0.021241559,-0.00023287535
2005.0,NLD,62506,62506,1261,1372,-111,0.021949893,0.020174064,-0.0017758295
2006.0,NLD,65326,65326,1285,1525,-240,0.023344457,0.019670576,-0.0036738818
2007.0,NLD,69138,69138,1507,1573,-66,0.022751598,0.021796986,-0.0009546125
2008.0,NLD,72654,72654,1627,1636,-9,0.022517687,0.022393811,-0.00012387481
2009.0,NLD,76614,76614,1797,1750,47,0.022841778,0.023455244,0.0006134649
2010.0,NLD,80587,80587,2023,1884,139,0.02337846,0.025103305,0.001724844
2011.0,NLD,84365,84365,2038,2037,1,0.024145084,0.024156937,1.1853257e-05
2012.0,NLD,87894,87894,2073,2109,-36,0.023994813,0.023585228,-0.00040958426
2013.0,NLD,91483,91483,2162,2273,-111,0.024846146,0.023632806,-0.0012133402
2014.0,NLD,94546,94546,2353,2636,-283,0.027880609,0.024887357,-0.002993252
2015.0,NLD,97401,97401,2395,2829,-434,0.029044876,0.02458907,-0.004455806
2016.0,NLD,100715,100715,2639,2802,-163,0.027821079,0.02620265,-0.0016184283
2017.0,NLD,103204,103204,2655,3004,-349,0.0291074,0.025725747,-0.0033816518
2018.0,NLD,106271,106271,3011,3046,-35,0.02866257,0.028333224,-0.00032934666
2019.0,NLD,108460,108460,3211,3103,108,0.028609626,0.029605385,0.0009957588
2020.0,NLD,108057,108057,3353,3191,162,0.029530711,0.03102992,0.0014992087
2021.0,NLD,103960,103960,3468,3035,433,0.029193921,0.033358984,0.0041650636
2022.0,NLD,0,0,3038,2462,576,,,
2023.0,NLD,0,0,1857,1590,267,,,
1996.0,NOR,9561,9561,0,0,0,0.0,0.0,0.0
1997.0,NOR,10999,10999,189,173,16,0.015728703,0.01718338,0.0014546777
1998.0,NOR,12440,12440,290,226,64,0.018167203,0.023311896,0.0051446944
1999.0,NOR,13416,13416,316,236,80,0.017590936,0.023553966,0.0059630293
2000.0,NOR,14118,14118,332,312,20,0.022099448,0.02351608,0.0014166313
2001.0,NOR,14738,14738,357,367,-10,0.024901615,0.024223097,-0.0006785181
2002.0,NOR,15499,15499,455,392,63,0.025291955,0.029356733,0.0040647783
2003.0,NOR,16472,16472,424,354,70,0.021491015,0.025740651,0.0042496356
2004.0,NOR,17565,17565,369,274,95,0.015599203,0.021007685,0.0054084826
2005.0,NOR,18799,18799,401,279,122,0.014841215,0.021330921,0.0064897067
2006.0,NOR,20028,20028,446,269,177,0.013431196,0.022268824,0.008837627
2007.0,NOR,21427,21427,488,313,175,0.014607738,0.022775004,0.008167266
2008.0,NOR,22907,22907,588,353,235,0.015410136,0.02566901,0.010258873
2009.0,NOR,24399,24399,629,386,243,0.01582032,0.025779745,0.009959425
2010.0,NOR,25608,25608,648,483,165,0.018861294,0.025304593,0.006443299
2011.0,NOR,26945,26945,680,443,237,0.016440898,0.025236594,0.008795695
2012.0,NOR,28428,28428,656,454,202,0.01597017,0.023075841,0.0071056704
2013.0,NOR,29744,29744,692,501,191,0.016843732,0.023265196,0.006421463
2014.0,NOR,31071,31071,775,501,274,0.01612436,0.024942873,0.008818513
2015.0,NOR,32385,32385,845,576,269,0.017786013,0.026092326,0.008306314
2016.0,NOR,33733,33733,889,630,259,0.018676074,0.026354015,0.0076779416
2017.0,NOR,35110,35110,903,651,252,0.018541725,0.025719168,0.0071774423
2018.0,NOR,36578,36578,1104,712,392,0.019465253,0.030182077,0.010716824
2019.0,NOR,37981,37981,1087,706,381,0.018588241,0.028619573,0.010031331
2020.0,NOR,38364,38364,1136,753,383,0.019627776,0.029611094,0.009983318
2021.0,NOR,37459,37459,1165,818,347,0.021837208,0.03110067,0.009263461
2022.0,NOR,0,0,934,677,257,,,
2023.0,NOR,0,0,644,454,190,,,
1996.0,NPL,191,191,0,0,0,0.0,0.0,0.0
1997.0,NPL,266,266,10,7,3,0.02631579,0.037593983,0.011278195
1998.0,NPL,316,316,12,12,0,0.03797468,0.03797468,0.0
1999.0,NPL,386,386,25,14,11,0.03626943,0.06476684,0.02849741
2000.0,NPL,425,425,24,29,-5,0.06823529,0.056470588,-0.011764706
2001.0,NPL,573,573,29,30,-1,0.05235602,0.05061082,-0.0017452007
2002.0,NPL,711,711,51,24,27,0.033755273,0.07172996,0.03797468
2003.0,NPL,895,895,41,34,7,0.037988827,0.045810055,0.007821229
2004.0,NPL,1060,1060,42,36,6,0.033962265,0.039622642,0.0056603774
2005.0,NPL,1225,1225,54,42,12,0.034285713,0.044081632,0.009795918
2006.0,NPL,1383,1383,45,49,-4,0.035430223,0.03253796,-0.0028922632
2007.0,NPL,1540,1540,30,66,-36,0.042857144,0.019480519,-0.023376623
2008.0,NPL,1717,1717,56,59,-3,0.03436226,0.032615025,-0.0017472336
2009.0,NPL,1876,1876,69,78,-9,0.041577823,0.036780383,-0.0047974414
2010.0,NPL,2066,2066,67,86,-19,0.04162633,0.032429814,-0.009196515
2011.0,NPL,2262,2262,61,82,-21,0.036251105,0.026967285,-0.009283819
2012.0,NPL,2435,2435,68,89,-21,0.03655031,0.027926078,-0.00862423
2013.0,NPL,2745,2745,103,88,15,0.032058287,0.03752277,0.0054644807
2014.0,NPL,3051,3051,99,122,-23,0.03998689,0.032448377,-0.007538512
2015.0,NPL,3425,3425,127,90,37,0.026277373,0.03708029,0.01080292
2016.0,NPL,3805,3805,130,129,1,0.03390276,0.034165572,0.0002628121
2017.0,NPL,4373,4373,150,135,15,0.030871255,0.034301396,0.0034301395
2018.0,NPL,5220,5220,159,158,1,0.0302682,0.030459771,0.00019157089
2019.0,NPL,6089,6089,182,155,27,0.02545574,0.029889965,0.0044342256
2020.0,NPL,6496,6496,212,190,22,0.029248768,0.03263547,0.0033866996
2021.0,NPL,6411,6411,208,179,29,0.027920762,0.032444235,0.004523475
2022.0,NPL,0,0,180,194,-14,,,
2023.0,NPL,0,0,90,105,-15,,,
2005.0,NRU,1,1,0,0,0,0.0,0.0,0.0
2011.0,NRU,4,4,0,0,0,0.0,0.0,0.0
2013.0,NRU,5,5,1,0,1,0.0,0.2,0.2
2016.0,NRU,3,3,0,0,0,0.0,0.0,0.0
2020.0,NRU,3,3,0,0,0,0.0,0.0,0.0
2022.0,NRU,0,0,0,0,0,,,
1996.0,NZL,7476,7476,0,0,0,0.0,0.0,0.0
1997.0,NZL,8707,8707,264,255,9,0.029286781,0.030320432,0.0010336511
1998.0,NZL,9846,9846,316,332,-16,0.033719275,0.03209425,-0.0016250254
1999.0,NZL,10699,10699,407,354,53,0.033087205,0.03804094,0.004953734
2000.0,NZL,11232,11232,394,456,-62,0.040598292,0.035078347,-0.005519943
2001.0,NZL,11731,11731,491,520,-29,0.044327,0.041854914,-0.0024720826
2002.0,NZL,12282,12282,480,536,-56,0.0436411,0.039081585,-0.004559518
2003.0,NZL,12932,12932,554,508,46,0.0392824,0.042839468,0.0035570678
2004.0,NZL,13701,13701,519,437,82,0.03189548,0.037880447,0.005984965
2005.0,NZL,14705,14705,518,454,64,0.030873852,0.035226114,0.0043522613
2006.0,NZL,15519,15519,540,484,56,0.031187577,0.034796055,0.0036084799
2007.0,NZL,16309,16309,553,524,29,0.0321295,0.03390766,0.0017781593
2008.0,NZL,17316,17316,612,581,31,0.033552784,0.035343036,0.0017902518
2009.0,NZL,18240,18240,608,607,1,0.03327851,0.033333335,5.4824563e-05
2010.0,NZL,19073,19073,652,626,26,0.032821264,0.03418445,0.0013631836
2011.0,NZL,19863,19863,638,702,-64,0.035342094,0.032120023,-0.003222071
2012.0,NZL,20689,20689,688,648,40,0.031320993,0.033254385,0.0019333946
2013.0,NZL,21529,21529,692,767,-75,0.035626363,0.03214269,-0.003483673
2014.0,NZL,22160,22160,649,794,-145,0.035830326,0.029287003,-0.006543321
2015.0,NZL,22694,22694,707,786,-79,0.034634706,0.031153608,-0.0034810964
2016.0,NZL,23479,23479,738,794,-56,0.033817455,0.031432346,-0.0023851101
2017.0,NZL,24280,24280,798,816,-18,0.033607908,0.032866556,-0.00074135093
2018.0,NZL,25027,25027,890,803,87,0.032085348,0.035561595,0.0034762456
2019.0,NZL,25599,25599,892,831,61,0.032462206,0.03484511,0.0023829057
2020.0,NZL,25559,25559,970,866,104,0.03388239,0.037951406,0.004069017
2021.0,NZL,24571,24571,850,773,77,0.03145985,0.034593627,0.0031337757
2022.0,NZL,0,0,580,706,-126,,,
2023.0,NZL,0,0,374,422,-48,,,
1996.0,OMN,283,283,0,0,0,0.0,0.0,0.0
1997.0,OMN,328,328,19,23,-4,0.07012195,0.05792683,-0.0121951215
1998.0,OMN,461,461,45,14,31,0.030368764,0.097613886,0.06724512
1999.0,OMN,547,547,46,27,19,0.049360145,0.08409506,0.034734916
2000.0,OMN,610,610,39,34,5,0.055737704,0.06393442,0.008196721
2001.0,OMN,667,667,41,30,11,0.044977512,0.061469264,0.016491754
2002.0,OMN,726,726,49,39,10,0.053719006,0.06749311,0.013774104
2003.0,OMN,793,793,49,40,9,0.050441362,0.061790667,0.011349306
2004.0,OMN,837,837,39,39,0,0.04659498,0.04659498,0.0
2005.0,OMN,942,942,65,43,22,0.045647558,0.06900212,0.023354564
2006.0,OMN,1015,1015,54,37,17,0.036453202,0.05320197,0.01674877
2007.0,OMN,1100,1100,59,46,13,0.041818183,0.053636365,0.011818182
2008.0,OMN,1232,1232,94,44,50,0.035714287,0.0762987,0.040584415
2009.0,OMN,1388,1388,89,59,30,0.042507205,0.06412104,0.021613833
2010.0,OMN,1559,1559,118,53,65,0.03399615,0.07568955,0.041693393
2011.0,OMN,1702,1702,94,74,20,0.04347826,0.055229142,0.011750882
2012.0,OMN,1853,1853,96,72,24,0.03885591,0.05180788,0.01295197
2013.0,OMN,2064,2064,134,51,83,0.024709303,0.06492248,0.04021318
2014.0,OMN,2240,2240,125,90,35,0.04017857,0.05580357,0.015625
2015.0,OMN,2418,2418,148,77,71,0.0318445,0.06120761,0.02936311
2016.0,OMN,2568,2568,135,97,38,0.037772585,0.052570093,0.014797508
2017.0,OMN,2717,2717,156,113,43,0.04158999,0.057416268,0.01582628
2018.0,OMN,2949,2949,180,107,73,0.036283486,0.06103764,0.024754154
2019.0,OMN,3190,3190,191,111,80,0.034796238,0.05987461,0.02507837
2020.0,OMN,3403,3403,206,97,109,0.028504262,0.060534824,0.03203056
2021.0,OMN,3408,3408,182,113,69,0.033157278,0.053403758,0.02024648
2022.0,OMN,0,0,171,119,52,,,
2023.0,OMN,0,0,105,89,16,,,
1996.0,PAK,2226,2226,0,0,0,0.0,0.0,0.0
1997.0,PAK,2741,2741,53,53,0,0.01933601,0.01933601,0.0
1998.0,PAK,3285,3285,68,62,6,0.018873667,0.020700153,0.001826484
1999.0,PAK,3757,3757,82,75,7,0.019962735,0.021825925,0.0018631887
2000.0,PAK,4219,4219,70,99,-29,0.023465276,0.016591609,-0.006873667
2001.0,PAK,4720,4720,90,101,-11,0.021398306,0.019067796,-0.0023305085
2002.0,PAK,5237,5237,105,106,-1,0.020240596,0.020049646,-0.00019094902
2003.0,PAK,6106,6106,128,100,28,0.016377334,0.020962987,0.0045856535
2004.0,PAK,7273,7273,134,114,20,0.015674412,0.01842431,0.0027498968
2005.0,PAK,8617,8617,129,125,4,0.014506209,0.014970407,0.00046419867
2006.0,PAK,10193,10193,157,153,4,0.015010301,0.015402728,0.00039242618
2007.0,PAK,12222,12222,169,164,5,0.013418426,0.013827524,0.00040909834
2008.0,PAK,14402,14402,206,197,9,0.013678656,0.014303569,0.0006249132
2009.0,PAK,17130,17130,251,268,-17,0.015645066,0.014652656,-0.0009924109
2010.0,PAK,19650,19650,292,324,-32,0.01648855,0.014860051,-0.0016284988
2011.0,PAK,22364,22364,363,396,-33,0.01770703,0.016231444,-0.0014755857
2012.0,PAK,24958,24958,483,463,20,0.018551165,0.019352512,0.00080134626
2013.0,PAK,27373,27373,560,565,-5,0.020640777,0.020458115,-0.00018266175
2014.0,PAK,30117,30117,627,651,-24,0.021615699,0.020818807,-0.0007968921
2015.0,PAK,33198,33198,717,755,-38,0.022742335,0.021597687,-0.0011446472
2016.0,PAK,36862,36862,852,820,32,0.02224513,0.023113234,0.00086810265
2017.0,PAK,41719,41719,978,995,-17,0.023850044,0.023442555,-0.0004074882
2018.0,PAK,47844,47844,1140,1084,56,0.022656968,0.02382744,0.0011704707
2019.0,PAK,52871,52871,1327,1166,161,0.022053678,0.025098825,0.0030451475
2020.0,PAK,55923,55923,1389,1302,87,0.023282012,0.024837723,0.0015557106
2021.0,PAK,54900,54900,1530,1369,161,0.024936248,0.027868852,0.0029326046
2022.0,PAK,0,0,1360,1232,128,,,
2023.0,PAK,0,0,850,1095,-245,,,
1996.0,PAN,105,105,0,0,0,0.0,0.0,0.0
1997.0,PAN,123,123,11,15,-4,0.12195122,0.08943089,-0.032520324
1998.0,PAN,135,135,16,16,0,0.11851852,0.11851852,0.0
1999.0,PAN,137,137,17,17,0,0.124087594,0.124087594,0.0
2000.0,PAN,151,151,11,16,-5,0.105960265,0.07284768,-0.03311258
2001.0,PAN,167,167,19,19,0,0.11377245,0.11377245,0.0
2002.0,PAN,184,184,22,26,-4,0.14130434,0.11956522,-0.02173913
2003.0,PAN,200,200,29,32,-3,0.16,0.145,-0.015
2004.0,PAN,223,223,20,17,3,0.076233186,0.089686096,0.013452915
2005.0,PAN,252,252,22,17,5,0.06746032,0.08730159,0.01984127
2006.0,PAN,277,277,20,22,-2,0.079422385,0.07220217,-0.0072202166
2007.0,PAN,301,301,21,20,1,0.06644518,0.069767445,0.003322259
2008.0,PAN,340,340,35,32,3,0.09411765,0.10294118,0.00882353
2009.0,PAN,378,378,31,27,4,0.071428575,0.08201058,0.01058201
2010.0,PAN,417,417,38,41,-3,0.09832134,0.0911271,-0.007194245
2011.0,PAN,480,480,55,35,20,0.072916664,0.114583336,0.041666668
2012.0,PAN,537,537,41,37,4,0.0689013,0.07635009,0.0074487897
2013.0,PAN,611,611,48,37,11,0.060556464,0.07855974,0.018003274
2014.0,PAN,650,650,51,42,9,0.064615384,0.078461535,0.013846153
2015.0,PAN,689,689,33,44,-11,0.06386067,0.047895502,-0.015965167
2016.0,PAN,737,737,50,39,11,0.05291723,0.0678426,0.014925373
2017.0,PAN,813,813,51,30,21,0.036900368,0.062730625,0.025830258
2018.0,PAN,867,867,43,43,0,0.04959631,0.04959631,0.0
2019.0,PAN,958,958,75,42,33,0.043841336,0.0782881,0.034446765
2020.0,PAN,986,986,74,57,17,0.05780933,0.07505071,0.01724138
2021.0,PAN,1020,1020,80,36,44,0.03529412,0.078431375,0.043137256
2022.0,PAN,0,0,47,61,-14,,,
1996.0,PER,384,384,0,0,0,0.0,0.0,0.0
1997.0,PER,540,540,20,18,2,0.033333335,0.037037037,0.0037037036
1998.0,PER,657,657,18,29,-11,0.04414003,0.02739726,-0.01674277
1999.0,PER,754,754,36,23,13,0.030503979,0.04774536,0.01724138
2000.0,PER,865,865,48,36,12,0.041618496,0.05549133,0.013872832
2001.0,PER,978,978,45,62,-17,0.06339468,0.04601227,-0.017382413
2002.0,PER,1097,1097,53,50,3,0.045578852,0.048313584,0.0027347312
2003.0,PER,1284,1284,62,40,22,0.031152649,0.048286606,0.017133957
2004.0,PER,1515,1515,62,43,19,0.028382838,0.04092409,0.012541254
2005.0,PER,1731,1731,61,46,15,0.026574235,0.035239745,0.008665511
2006.0,PER,1966,1966,93,45,48,0.022889115,0.047304172,0.024415055
2007.0,PER,2250,2250,86,70,16,0.031111112,0.038222224,0.007111111
2008.0,PER,2534,2534,105,74,31,0.029202841,0.041436464,0.012233622
2009.0,PER,2778,2778,86,100,-14,0.03599712,0.030957524,-0.005039597
2010.0,PER,2998,2998,83,116,-33,0.038692463,0.027685123,-0.011007338
2011.0,PER,3235,3235,90,98,-8,0.030293664,0.02782071,-0.002472952
2012.0,PER,3493,3493,104,96,8,0.027483538,0.029773833,0.002290295
2013.0,PER,3982,3982,107,102,5,0.02561527,0.02687092,0.0012556504
2014.0,PER,4428,4428,133,113,20,0.025519421,0.030036133,0.004516712
2015.0,PER,5082,5082,173,111,62,0.021841794,0.034041718,0.0121999215
2016.0,PER,5843,5843,183,161,22,0.027554339,0.03131953,0.003765189
2017.0,PER,6945,6945,216,151,65,0.02174226,0.031101512,0.009359252
2018.0,PER,8249,8249,254,170,84,0.02060856,0.03079161,0.010183052
2019.0,PER,9747,9747,257,195,62,0.020006156,0.026367087,0.006360932
2020.0,PER,10917,10917,316,194,122,0.01777045,0.02894568,0.011175231
2021.0,PER,10773,10773,295,224,71,0.020792723,0.027383273,0.0065905503
2022.0,PER,0,0,213,186,27,,,
2023.0,PER,0,0,125,144,-19,,,
1996.0,PHL,784,784,0,0,0,0.0,0.0,0.0
1997.0,PHL,972,972,36,33,3,0.033950616,0.037037037,0.0030864198
1998.0,PHL,1151,1151,50,53,-3,0.046046916,0.043440487,-0.0026064292
1999.0,PHL,1268,1268,78,41,37,0.032334384,0.061514195,0.029179811
2000.0,PHL,1363,1363,68,85,-17,0.062362436,0.04988995,-0.012472487
2001.0,PHL,1471,1471,83,88,-5,0.05982325,0.0564242,-0.0033990482
2002.0,PHL,1526,1526,76,102,-26,0.066841416,0.049803406,-0.017038008
2003.0,PHL,1658,1658,92,84,8,0.05066345,0.05548854,0.0048250905
2004.0,PHL,1759,1759,66,75,-9,0.042637862,0.037521318,-0.0051165433
2005.0,PHL,1886,1886,74,78,-4,0.041357372,0.03923648,-0.002120891
2006.0,PHL,2047,2047,69,82,-13,0.040058624,0.033707865,-0.006350757
2007.0,PHL,2258,2258,82,73,9,0.032329496,0.036315322,0.0039858283
2008.0,PHL,2469,2469,108,98,10,0.039692182,0.043742407,0.0040502227
2009.0,PHL,2762,2762,103,111,-8,0.040188268,0.037291817,-0.0028964519
2010.0,PHL,3130,3130,146,109,37,0.034824282,0.046645366,0.0118210865
2011.0,PHL,3543,3543,122,103,19,0.02907141,0.034434095,0.005362687
2012.0,PHL,3973,3973,139,115,24,0.02894538,0.034986157,0.006040775
2013.0,PHL,4533,4533,131,130,1,0.02867858,0.028899183,0.00022060446
2014.0,PHL,5035,5035,153,141,12,0.028003972,0.03038729,0.0023833169
2015.0,PHL,5639,5639,179,121,58,0.021457706,0.031743217,0.010285512
2016.0,PHL,6313,6313,180,171,9,0.027086964,0.028512593,0.0014256296
2017.0,PHL,7188,7188,188,190,-2,0.026432944,0.026154703,-0.00027824152
2018.0,PHL,7979,7979,175,192,-17,0.024063166,0.021932572,-0.0021305927
2019.0,PHL,8796,8796,249,226,23,0.025693497,0.028308323,0.002614825
2020.0,PHL,9248,9248,252,242,10,0.02616782,0.027249135,0.0010813149
2021.0,PHL,9048,9048,225,233,-8,0.025751548,0.024867374,-0.0008841733
2022.0,PHL,0,0,175,194,-19,,,
2023.0,PHL,0,0,110,128,-18,,,
1996.0,PLW,6,6,0,0,0,0.0,0.0,0.0
1997.0,PLW,4,4,0,2,-2,0.5,0.0,-0.5
1998.0,PLW,4,4,0,0,0,0.0,0.0,0.0
2001.0,PLW,10,10,3,1,2,0.1,0.3,0.2
2002.0,PLW,19,19,6,1,5,0.05263158,0.31578946,0.2631579
2004.0,PLW,19,19,5,1,4,0.05263158,0.2631579,0.21052632
2005.0,PLW,21,21,3,2,1,0.0952381,0.14285715,0.04761905
2006.0,PLW,21,21,2,2,0,0.0952381,0.0952381,0.0
2009.0,PLW,23,23,1,0,1,0.0,0.04347826,0.04347826
2010.0,PLW,22,22,0,0,0,0.0,0.0,0.0
2012.0,PLW,31,31,0,1,-1,0.032258064,0.0,-0.032258064
2013.0,PLW,32,32,2,1,1,0.03125,0.0625,0.03125
2014.0,PLW,32,32,2,3,-1,0.09375,0.0625,-0.03125
2015.0,PLW,36,36,1,0,1,0.0,0.027777778,0.027777778
2016.0,PLW,45,45,4,2,2,0.044444446,0.08888889,0.044444446
2017.0,PLW,42,42,2,2,0,0.04761905,0.04761905,0.0
2018.0,PLW,42,42,0,1,-1,0.023809524,0.0,-0.023809524
2020.0,PLW,49,49,2,1,1,0.020408163,0.040816326,0.020408163
2022.0,PLW,0,0,1,2,-1,,,
1996.0,PNG,172,172,0,0,0,0.0,0.0,0.0
1997.0,PNG,195,195,7,14,-7,0.071794875,0.035897437,-0.035897437
1998.0,PNG,228,228,20,8,12,0.03508772,0.0877193,0.05263158
1999.0,PNG,236,236,15,15,0,0.06355932,0.06355932,0.0
2000.0,PNG,239,239,20,26,-6,0.10878661,0.08368201,-0.025104603
2001.0,PNG,229,229,13,29,-16,0.12663755,0.05676856,-0.069869
2002.0,PNG,221,221,16,14,2,0.06334842,0.07239819,0.009049774
2003.0,PNG,230,230,18,15,3,0.06521739,0.07826087,0.013043478
2004.0,PNG,228,228,8,11,-3,0.048245613,0.03508772,-0.013157895
2005.0,PNG,231,231,8,12,-4,0.051948052,0.034632035,-0.017316017
2006.0,PNG,240,240,5,5,0,0.020833334,0.020833334,0.0
2007.0,PNG,242,242,14,11,3,0.045454547,0.05785124,0.012396694
2008.0,PNG,270,270,16,15,1,0.055555556,0.05925926,0.0037037036
2009.0,PNG,290,290,17,14,3,0.048275862,0.05862069,0.010344828
2010.0,PNG,295,295,17,21,-4,0.07118644,0.05762712,-0.013559322
2011.0,PNG,320,320,18,10,8,0.03125,0.05625,0.025
2012.0,PNG,373,373,32,11,21,0.029490616,0.08579089,0.056300268
2013.0,PNG,370,370,13,15,-2,0.04054054,0.035135135,-0.0054054055
2014.0,PNG,399,399,18,17,1,0.042606518,0.04511278,0.0025062656
2015.0,PNG,405,405,12,16,-4,0.039506175,0.02962963,-0.009876544
2016.0,PNG,400,400,9,21,-12,0.0525,0.0225,-0.03
2017.0,PNG,427,427,19,23,-4,0.05386417,0.044496488,-0.009367681
2018.0,PNG,454,454,23,12,11,0.026431719,0.050660793,0.024229076
2019.0,PNG,481,481,23,21,2,0.043659043,0.047817048,0.004158004
2020.0,PNG,483,483,20,21,-1,0.04347826,0.04140787,-0.0020703934
2021.0,PNG,454,454,19,21,-2,0.046255507,0.04185022,-0.004405286
2022.0,PNG,0,0,16,15,1,,,
1996.0,POL,21964,21964,0,0,0,0.0,0.0,0.0
1997.0,POL,26057,26057,408,331,77,0.0127029205,0.01565798,0.00295506
1998.0,POL,29807,29807,387,355,32,0.011909954,0.012983527,0.0010735734
1999.0,POL,32527,32527,435,426,9,0.013096812,0.013373505,0.0002766932
2000.0,POL,35467,35467,464,420,44,0.011841994,0.013082583,0.0012405899
2001.0,POL,38221,38221,481,512,-31,0.013395777,0.012584705,-0.0008110725
2002.0,POL,41398,41398,487,580,-93,0.014010339,0.011763853,-0.0022464853
2003.0,POL,44417,44417,501,551,-50,0.01240516,0.011279465,-0.0011256951
2004.0,POL,47617,47617,378,463,-85,0.009723418,0.007938341,-0.0017850768
2005.0,POL,50488,50488,375,489,-114,0.00968547,0.0074275075,-0.0022579622
2006.0,POL,54139,54139,415,511,-96,0.009438667,0.007665454,-0.0017732134
2007.0,POL,57425,57425,457,538,-81,0.009368742,0.007958206,-0.0014105355
2008.0,POL,60488,60488,432,653,-221,0.01079553,0.0071419124,-0.0036536173
2009.0,POL,63642,63642,497,574,-77,0.009019202,0.0078093084,-0.0012098928
2010.0,POL,67587,67587,516,589,-73,0.008714694,0.0076346043,-0.0010800894
2011.0,POL,72040,72040,567,540,27,0.0074958354,0.007870628,0.0003747918
2012.0,POL,76316,76316,579,563,16,0.0073772212,0.0075868755,0.0002096546
2013.0,POL,80684,80684,551,528,23,0.0065440484,0.006829111,0.0002850627
2014.0,POL,84994,84994,570,584,-14,0.006871073,0.0067063556,-0.00016471751
2015.0,POL,88356,88356,592,600,-8,0.00679071,0.0067001674,-9.05428e-05
2016.0,POL,91589,91589,634,696,-62,0.0075991657,0.0069222287,-0.00067693717
2017.0,POL,95640,95640,700,739,-39,0.0077268924,0.0073191132,-0.00040777918
2018.0,POL,99865,99865,794,716,78,0.0071696793,0.007950733,0.00078105443
2019.0,POL,102890,102890,868,754,114,0.0073282146,0.008436194,0.0011079794
2020.0,POL,102620,102620,806,751,55,0.0073182615,0.0078542195,0.0005359579
2021.0,POL,98932,98932,900,739,161,0.007469777,0.009097158,0.0016273804
2022.0,POL,0,0,838,692,146,,,
2023.0,POL,0,0,570,465,105,,,
1996.0,PRI,580,580,0,0,0,0.0,0.0,0.0
1997.0,PRI,718,718,54,33,21,0.045961004,0.07520892,0.029247912
1998.0,PRI,843,843,78,51,27,0.06049822,0.09252669,0.03202847
1999.0,PRI,914,914,64,62,2,0.0678337,0.07002188,0.0021881838
2000.0,PRI,953,953,64,78,-14,0.081846796,0.067156345,-0.014690451
2001.0,PRI,1034,1034,83,83,0,0.08027079,0.08027079,0.0
2002.0,PRI,1060,1060,80,117,-37,0.11037736,0.0754717,-0.03490566
2003.0,PRI,1159,1159,110,89,21,0.07679033,0.09490941,0.018119069
2004.0,PRI,1243,1243,96,97,-1,0.07803701,0.0772325,-0.00080450525
2005.0,PRI,1369,1369,103,85,18,0.062089115,0.0752374,0.013148284
2006.0,PRI,1492,1492,120,125,-5,0.08378016,0.08042896,-0.0033512064
2007.0,PRI,1594,1594,125,114,11,0.07151819,0.078419074,0.006900878
2008.0,PRI,1742,1742,164,133,31,0.07634903,0.094144665,0.017795637
2009.0,PRI,1764,1764,128,190,-62,0.10770975,0.07256236,-0.03514739
2010.0,PRI,1889,1889,176,139,37,0.07358391,0.09317099,0.019587083
2011.0,PRI,1901,1901,153,170,-17,0.089426614,0.08048396,-0.008942662
2012.0,PRI,1935,1935,123,170,-47,0.087855294,0.063565895,-0.024289405
2013.0,PRI,1857,1857,110,243,-133,0.13085622,0.059235327,-0.0716209
2014.0,PRI,1800,1800,143,221,-78,0.122777775,0.079444446,-0.043333333
2015.0,PRI,1726,1726,165,255,-90,0.14774044,0.09559675,-0.052143686
2016.0,PRI,1842,1842,255,239,16,0.12975027,0.13843648,0.008686211
2017.0,PRI,1850,1850,193,234,-41,0.12648648,0.104324326,-0.022162162
2018.0,PRI,1869,1869,190,234,-44,0.12520064,0.10165864,-0.023542002
2019.0,PRI,1844,1844,185,253,-68,0.13720174,0.10032538,-0.036876354
2020.0,PRI,1895,1895,231,187,44,0.09868074,0.12189974,0.023218997
2021.0,PRI,1861,1861,237,204,33,0.109618485,0.12735088,0.017732402
2022.0,PRI,0,0,229,146,83,,,
2005.0,PRK,4,4,0,0,0,0.0,0.0,0.0
2007.0,PRK,21,21,2,1,1,0.04761905,0.0952381,0.04761905
2008.0,PRK,24,24,0,1,-1,0.041666668,0.0,-0.041666668
2009.0,PRK,22,22,3,5,-2,0.22727273,0.13636364,-0.09090909
2010.0,PRK,23,23,0,3,-3,0.13043478,0.0,-0.13043478
2012.0,PRK,33,33,1,1,0,0.030303031,0.030303031,0.0
2013.0,PRK,55,55,1,2,-1,0.036363635,0.018181818,-0.018181818
2014.0,PRK,104,104,4,2,2,0.01923077,0.03846154,0.01923077
2015.0,PRK,145,145,8,1,7,0.0068965517,0.055172414,0.048275862
2016.0,PRK,223,223,6,7,-1,0.031390134,0.02690583,-0.004484305
2017.0,PRK,342,342,14,9,5,0.02631579,0.040935673,0.014619883
2018.0,PRK,467,467,25,3,22,0.006423983,0.05353319,0.04710921
2019.0,PRK,582,582,21,13,8,0.02233677,0.036082473,0.013745705
2020.0,PRK,639,639,23,13,10,0.020344287,0.03599374,0.015649453
2021.0,PRK,638,638,20,11,9,0.01724138,0.031347964,0.014106583
2022.0,PRK,0,0,21,14,7,,,
1996.0,PRT,6327,6327,0,0,0,0.0,0.0,0.0
1997.0,PRT,7658,7658,132,129,3,0.01684513,0.017236877,0.0003917472
1998.0,PRT,8957,8957,206,153,53,0.017081613,0.022998773,0.00591716
1999.0,PRT,9891,9891,252,206,46,0.020827014,0.025477707,0.0046506925
2000.0,PRT,10859,10859,298,198,100,0.018233724,0.027442675,0.009208951
2001.0,PRT,11873,11873,314,319,-5,0.026867682,0.026446559,-0.00042112355
2002.0,PRT,13162,13162,373,274,99,0.020817505,0.028339159,0.007521653
2003.0,PRT,14550,14550,396,224,172,0.015395189,0.027216494,0.011821305
2004.0,PRT,16044,16044,352,247,105,0.015395164,0.021939665,0.0065445025
2005.0,PRT,17589,17589,319,270,49,0.015350503,0.018136336,0.0027858322
2006.0,PRT,19482,19482,359,285,74,0.014628888,0.018427266,0.003798378
2007.0,PRT,21514,21514,381,307,74,0.014269778,0.017709399,0.0034396206
2008.0,PRT,23778,23778,464,367,97,0.015434436,0.019513836,0.004079401
2009.0,PRT,26359,26359,526,427,99,0.0161994,0.019955233,0.003755833
2010.0,PRT,29101,29101,632,493,139,0.016940998,0.021717466,0.004776468
2011.0,PRT,31934,31934,695,529,166,0.016565416,0.021763638,0.005198221
2012.0,PRT,34908,34908,660,573,87,0.016414575,0.018906841,0.0024922653
2013.0,PRT,37572,37572,669,626,43,0.016661344,0.017805813,0.0011444692
2014.0,PRT,39777,39777,671,844,-173,0.021218292,0.016869046,-0.004349247
2015.0,PRT,41592,41592,708,971,-263,0.023345836,0.017022504,-0.0063233315
2016.0,PRT,43416,43416,729,950,-221,0.021881334,0.016791046,-0.0050902893
2017.0,PRT,45494,45494,752,1030,-278,0.022640347,0.016529651,-0.006110696
2018.0,PRT,47866,47866,827,932,-105,0.019471023,0.0172774,-0.002193624
2019.0,PRT,50091,50091,897,938,-41,0.018725919,0.017907409,-0.0008185103
2020.0,PRT,50784,50784,1017,978,39,0.019258033,0.020025993,0.0007679584
2021.0,PRT,49363,49363,972,920,52,0.018637441,0.019690862,0.0010534206
2022.0,PRT,0,0,904,808,96,,,
2023.0,PRT,0,0,498,489,9,,,
1996.0,PRY,54,54,0,0,0,0.0,0.0,0.0
1997.0,PRY,65,65,3,1,2,0.015384615,0.046153847,0.03076923
1998.0,PRY,74,74,2,0,2,0.0,0.027027028,0.027027028
1999.0,PRY,73,73,1,4,-3,0.05479452,0.01369863,-0.04109589
2000.0,PRY,69,69,2,3,-1,0.04347826,0.028985508,-0.014492754
2001.0,PRY,73,73,5,2,3,0.02739726,0.06849315,0.04109589
2002.0,PRY,79,79,3,9,-6,0.11392405,0.03797468,-0.07594936
2003.0,PRY,98,98,6,3,3,0.030612245,0.06122449,0.030612245
2004.0,PRY,127,127,7,4,3,0.031496063,0.05511811,0.023622047
2005.0,PRY,143,143,9,4,5,0.027972028,0.062937066,0.034965035
2006.0,PRY,156,156,7,5,2,0.032051284,0.044871796,0.012820513
2007.0,PRY,181,181,10,7,3,0.038674034,0.055248618,0.016574586
2008.0,PRY,199,199,14,9,5,0.04522613,0.07035176,0.025125628
2009.0,PRY,223,223,12,11,1,0.049327355,0.05381166,0.004484305
2010.0,PRY,249,249,5,11,-6,0.044176705,0.02008032,-0.024096385
2011.0,PRY,280,280,19,12,7,0.042857144,0.067857146,0.025
2012.0,PRY,298,298,12,10,2,0.033557046,0.040268455,0.0067114094
2013.0,PRY,327,327,12,11,1,0.033639144,0.036697246,0.003058104
2014.0,PRY,382,382,18,11,7,0.028795812,0.04712042,0.018324608
2015.0,PRY,450,450,22,7,15,0.015555556,0.04888889,0.033333335
2016.0,PRY,517,517,20,17,3,0.032882012,0.03868472,0.0058027077
2017.0,PRY,632,632,30,13,17,0.02056962,0.047468353,0.026898734
2018.0,PRY,691,691,24,13,11,0.018813314,0.03473227,0.015918959
2019.0,PRY,758,758,30,24,6,0.03166227,0.039577838,0.007915568
2020.0,PRY,805,805,38,20,18,0.024844721,0.047204968,0.022360248
2021.0,PRY,820,820,41,18,23,0.021951219,0.05,0.02804878
2022.0,PRY,0,0,26,18,8,,,
1996.0,PSE,49,49,0,0,0,0.0,0.0,0.0
1997.0,PSE,66,66,6,1,5,0.015151516,0.09090909,0.07575758
1998.0,PSE,84,84,10,6,4,0.071428575,0.11904762,0.04761905
1999.0,PSE,97,97,7,10,-3,0.10309278,0.072164945,-0.030927835
2000.0,PSE,134,134,15,6,9,0.04477612,0.1119403,0.06716418
2001.0,PSE,171,171,27,7,20,0.040935673,0.15789473,0.116959065
2002.0,PSE,200,200,24,11,13,0.055,0.12,0.065
2003.0,PSE,233,233,24,11,13,0.047210302,0.10300429,0.055793993
2004.0,PSE,273,273,21,15,6,0.054945055,0.07692308,0.021978023
2005.0,PSE,340,340,37,21,16,0.061764706,0.10882353,0.047058824
2006.0,PSE,387,387,38,16,22,0.04134367,0.09819122,0.056847546
2007.0,PSE,432,432,34,11,23,0.025462963,0.0787037,0.053240743
2008.0,PSE,474,474,31,28,3,0.05907173,0.06540085,0.006329114
2009.0,PSE,531,531,39,24,15,0.04519774,0.073446326,0.028248588
2010.0,PSE,578,578,55,39,16,0.067474045,0.09515571,0.027681662
2011.0,PSE,655,655,55,41,14,0.06259542,0.08396947,0.021374045
2012.0,PSE,749,749,64,30,34,0.040053405,0.08544727,0.045393858
2013.0,PSE,808,808,55,44,11,0.054455444,0.06806931,0.013613861
2014.0,PSE,898,898,65,33,32,0.03674833,0.072383076,0.035634745
2015.0,PSE,997,997,69,57,12,0.057171516,0.06920762,0.012036108
2016.0,PSE,1169,1169,111,34,77,0.029084688,0.09495295,0.065868266
2017.0,PSE,1333,1333,74,52,22,0.039009754,0.055513877,0.016504126
2018.0,PSE,1546,1546,94,51,43,0.03298836,0.06080207,0.027813712
2019.0,PSE,1806,1806,117,51,66,0.028239202,0.06478405,0.036544852
2020.0,PSE,1960,1960,109,68,41,0.03469388,0.055612244,0.020918367
2021.0,PSE,1965,1965,117,69,48,0.035114504,0.059541985,0.024427481
2022.0,PSE,0,0,103,41,62,,,
2023.0,PSE,0,0,44,29,15,,,
1996.0,PYF,58,58,0,0,0,0.0,0.0,0.0
1997.0,PYF,68,68,7,9,-2,0.13235295,0.10294118,-0.029411765
1998.0,PYF,79,79,4,6,-2,0.07594936,0.050632913,-0.025316456
1999.0,PYF,85,85,13,9,4,0.105882354,0.15294118,0.047058824
2000.0,PYF,84,84,3,12,-9,0.14285715,0.035714287,-0.10714286
2001.0,PYF,87,87,10,13,-3,0.14942528,0.11494253,-0.03448276
2002.0,PYF,89,89,10,13,-3,0.14606741,0.11235955,-0.033707865
2003.0,PYF,89,89,10,11,-1,0.123595506,0.11235955,-0.011235955
2004.0,PYF,84,84,6,11,-5,0.13095239,0.071428575,-0.05952381
2005.0,PYF,88,88,7,10,-3,0.11363637,0.07954545,-0.03409091
2006.0,PYF,105,105,14,7,7,0.06666667,0.13333334,0.06666667
2007.0,PYF,112,112,9,11,-2,0.09821428,0.08035714,-0.017857144
2008.0,PYF,114,114,14,12,2,0.10526316,0.12280702,0.01754386
2009.0,PYF,125,125,17,10,7,0.08,0.136,0.056
2010.0,PYF,138,138,10,7,3,0.050724637,0.072463766,0.02173913
2011.0,PYF,150,150,20,11,9,0.07333333,0.13333334,0.06
2012.0,PYF,177,177,26,12,14,0.06779661,0.14689265,0.07909604
2013.0,PYF,190,190,19,20,-1,0.10526316,0.1,-0.005263158
2014.0,PYF,213,213,23,14,9,0.065727696,0.10798122,0.04225352
2015.0,PYF,221,221,28,19,9,0.08597285,0.12669684,0.040723983
2016.0,PYF,225,225,19,24,-5,0.10666667,0.08444444,-0.022222223
2017.0,PYF,217,217,20,32,-12,0.14746544,0.0921659,-0.05529954
2018.0,PYF,236,236,40,24,16,0.10169491,0.16949153,0.06779661
2019.0,PYF,244,244,24,21,3,0.086065575,0.09836066,0.012295082
2020.0,PYF,236,236,21,23,-2,0.097457625,0.08898305,-0.008474576
2021.0,PYF,221,221,26,28,-2,0.12669684,0.11764706,-0.009049774
2022.0,PYF,0,0,16,12,4,,,
2023.0,PYF,0,0,10,11,-1,,,
1996.0,QAT,94,94,0,0,0,0.0,0.0,0.0
1997.0,QAT,118,118,9,5,4,0.042372882,0.076271184,0.033898305
1998.0,QAT,150,150,15,10,5,0.06666667,0.1,0.033333335
1999.0,QAT,189,189,12,8,4,0.04232804,0.06349207,0.02116402
2000.0,QAT,231,231,8,8,0,0.034632035,0.034632035,0.0
2001.0,QAT,287,287,23,12,11,0.041811846,0.080139376,0.038327526
2002.0,QAT,333,333,14,9,5,0.027027028,0.042042043,0.015015015
2003.0,QAT,396,396,21,13,8,0.032828283,0.053030305,0.02020202
2004.0,QAT,475,475,33,8,25,0.016842104,0.069473684,0.05263158
2005.0,QAT,517,517,24,15,9,0.029013539,0.046421662,0.017408123
2006.0,QAT,610,610,40,13,27,0.021311475,0.06557377,0.044262294
2007.0,QAT,676,676,46,24,22,0.03550296,0.06804734,0.03254438
2008.0,QAT,811,811,73,19,54,0.023427866,0.09001233,0.06658446
2009.0,QAT,913,913,60,29,31,0.031763416,0.065717414,0.033954
2010.0,QAT,1093,1093,100,27,73,0.024702653,0.09149131,0.06678866
2011.0,QAT,1297,1297,123,43,80,0.03315343,0.09483423,0.0616808
2012.0,QAT,1613,1613,153,45,108,0.027898327,0.09485431,0.06695598
2013.0,QAT,2030,2030,203,57,146,0.028078817,0.1,0.071921185
2014.0,QAT,2562,2562,307,81,226,0.031615924,0.11982826,0.08821233
2015.0,QAT,3050,3050,352,118,234,0.038688526,0.115409836,0.07672131
2016.0,QAT,3601,3601,372,143,229,0.039711192,0.10330464,0.06359345
2017.0,QAT,4090,4090,297,187,110,0.04572127,0.07261614,0.026894866
2018.0,QAT,4758,4758,307,218,89,0.04581757,0.06452291,0.018705338
2019.0,QAT,5499,5499,346,217,129,0.03946172,0.06292053,0.02345881
2020.0,QAT,5847,5847,333,225,108,0.038481273,0.056952283,0.01847101
2021.0,QAT,5764,5764,277,251,26,0.043546148,0.048056904,0.0045107566
2022.0,QAT,0,0,271,236,35,,,
2023.0,QAT,0,0,195,153,42,,,
1996.0,REU,15,15,0,0,0,0.0,0.0,0.0
1997.0,REU,15,15,4,7,-3,0.46666667,0.26666668,-0.2
1998.0,REU,15,15,1,5,-4,0.33333334,0.06666667,-0.26666668
1999.0,REU,19,19,4,2,2,0.10526316,0.21052632,0.10526316
2000.0,REU,26,26,7,3,4,0.115384616,0.26923078,0.15384616
2001.0,REU,21,21,3,9,-6,0.42857143,0.14285715,-0.2857143
2002.0,REU,18,18,3,6,-3,0.33333334,0.16666667,-0.16666667
2003.0,REU,20,20,6,4,2,0.2,0.3,0.1
2004.0,REU,45,45,13,5,8,0.11111111,0.2888889,0.17777778
2005.0,REU,66,66,14,4,10,0.060606062,0.21212122,0.15151516
2006.0,REU,98,98,26,8,18,0.08163265,0.26530612,0.18367347
2007.0,REU,117,117,34,23,11,0.1965812,0.2905983,0.094017096
2008.0,REU,116,116,16,29,-13,0.25,0.13793103,-0.112068966
2009.0,REU,122,122,27,23,4,0.18852459,0.22131148,0.032786883
2010.0,REU,132,132,33,36,-3,0.27272728,0.25,-0.022727273
2011.0,REU,123,123,30,41,-11,0.33333334,0.24390244,-0.08943089
2012.0,REU,113,113,21,31,-10,0.27433628,0.18584071,-0.088495575
2013.0,REU,113,113,29,32,-3,0.28318584,0.25663716,-0.026548672
2014.0,REU,105,105,21,31,-10,0.2952381,0.2,-0.0952381
2015.0,REU,108,108,31,37,-6,0.3425926,0.28703704,-0.055555556
2016.0,REU,92,92,25,41,-16,0.4456522,0.27173913,-0.17391305
2017.0,REU,92,92,31,30,1,0.32608697,0.33695653,0.010869565
2018.0,REU,97,97,33,26,7,0.26804122,0.34020618,0.072164945
2019.0,REU,84,84,21,38,-17,0.45238096,0.25,-0.20238096
2020.0,REU,100,100,32,18,14,0.18,0.32,0.14
2021.0,REU,98,98,32,23,9,0.23469388,0.3265306,0.091836736
2022.0,REU,0,0,21,29,-8,,,
1996.0,ROU,4411,4411,0,0,0,0.0,0.0,0.0
1997.0,ROU,5369,5369,92,82,10,0.015272862,0.017135408,0.0018625442
1998.0,ROU,6067,6067,89,149,-60,0.02455909,0.014669524,-0.009889566
1999.0,ROU,6628,6628,112,137,-25,0.020669885,0.016898008,-0.003771877
2000.0,ROU,6920,6920,95,187,-92,0.027023122,0.013728323,-0.013294797
2001.0,ROU,7322,7322,124,217,-93,0.02963671,0.016935263,-0.012701448
2002.0,ROU,7726,7726,115,238,-123,0.030805074,0.014884804,-0.015920268
2003.0,ROU,8248,8248,135,204,-69,0.02473327,0.016367605,-0.008365665
2004.0,ROU,8907,8907,136,173,-37,0.019422926,0.015268889,-0.0041540363
2005.0,ROU,9979,9979,154,158,-4,0.01583325,0.015432408,-0.00040084176
2006.0,ROU,12419,12419,161,178,-17,0.0143328775,0.0129640065,-0.0013688703
2007.0,ROU,15288,15288,207,183,24,0.011970173,0.013540031,0.0015698588
2008.0,ROU,17708,17708,255,164,91,0.009261351,0.014400271,0.00513892
2009.0,ROU,20118,20118,238,168,70,0.008350731,0.011830201,0.0034794712
2010.0,ROU,22036,22036,218,219,-1,0.009938283,0.009892902,-4.5380286e-05
2011.0,ROU,23767,23767,229,221,8,0.009298608,0.009635208,0.00033660117
2012.0,ROU,24980,24980,221,232,-11,0.00928743,0.008847077,-0.00044035228
2013.0,ROU,26162,26162,211,228,-17,0.00871493,0.008065132,-0.00064979744
2014.0,ROU,26936,26936,193,261,-68,0.009689635,0.007165132,-0.0025245026
2015.0,ROU,27566,27566,242,264,-22,0.009577015,0.008778931,-0.0007980846
2016.0,ROU,28060,28060,212,242,-30,0.008624377,0.007555239,-0.0010691376
2017.0,ROU,29084,29084,222,243,-21,0.008355109,0.007633063,-0.0007220465
2018.0,ROU,30069,30069,227,209,18,0.00695068,0.007549303,0.0005986232
2019.0,ROU,31086,31086,261,219,42,0.007044972,0.008396063,0.0013510905
2020.0,ROU,31685,31685,239,248,-9,0.007827047,0.0075430013,-0.00028404608
2021.0,ROU,30743,30743,212,233,-21,0.007578961,0.006895879,-0.0006830823
2022.0,ROU,0,0,175,195,-20,,,
2023.0,ROU,0,0,101,140,-39,,,
1996.0,RUS,61173,61173,0,0,0,0.0,0.0,0.0
1997.0,RUS,70212,70212,816,1000,-184,0.014242579,0.011621945,-0.0026206346
1998.0,RUS,78069,78069,872,1108,-236,0.014192573,0.011169607,-0.003022967
1999.0,RUS,82135,82135,797,1335,-538,0.016253728,0.0097035365,-0.006550192
2000.0,RUS,84672,84672,840,1541,-701,0.018199641,0.009920635,-0.008279006
2001.0,RUS,85815,85815,1003,1709,-706,0.019914933,0.0116879335,-0.008227
2002.0,RUS,86523,86523,1131,1648,-517,0.019046959,0.013071669,-0.0059752897
2003.0,RUS,87581,87581,1109,1410,-301,0.016099382,0.0126625635,-0.0034368185
2004.0,RUS,88056,88056,937,1132,-195,0.012855455,0.0106409555,-0.0022144997
2005.0,RUS,89290,89290,874,1008,-134,0.011289058,0.00978833,-0.001500728
2006.0,RUS,91601,91601,800,963,-163,0.010512985,0.008733529,-0.0017794565
2007.0,RUS,94597,94597,721,915,-194,0.009672611,0.007621806,-0.002050805
2008.0,RUS,97858,97858,730,901,-171,0.009207219,0.0074597886,-0.00174743
2009.0,RUS,102534,102534,759,898,-139,0.008758071,0.007402423,-0.0013556479
2010.0,RUS,107237,107237,769,908,-139,0.008467227,0.0071710325,-0.0012961944
2011.0,RUS,114343,114343,733,924,-191,0.008080949,0.006410537,-0.0016704127
2012.0,RUS,123653,123653,722,874,-152,0.0070681665,0.0058389204,-0.0012292464
2013.0,RUS,136775,136775,802,849,-47,0.0062072747,0.0058636446,-0.00034363006
2014.0,RUS,152151,152151,964,932,32,0.006125494,0.006335811,0.00021031738
2015.0,RUS,166465,166465,1165,943,222,0.0056648543,0.006998468,0.0013336136
2016.0,RUS,180738,180738,1192,956,236,0.0052894247,0.0065951818,0.0013057576
2017.0,RUS,197096,197096,1247,1066,181,0.005408532,0.006326866,0.00091833423
2018.0,RUS,207684,207684,1088,1232,-144,0.005932089,0.005238728,-0.00069336104
2019.0,RUS,212953,212953,1053,1213,-160,0.0056960927,0.004944753,-0.0007513395
2020.0,RUS,212216,212216,1034,1328,-294,0.0062577752,0.0048723943,-0.001385381
2021.0,RUS,202010,202010,951,1312,-361,0.006494728,0.0047076875,-0.0017870403
2022.0,RUS,0,0,714,1257,-543,,,
2023.0,RUS,0,0,448,1318,-870,,,
1996.0,RWA,21,21,0,0,0,0.0,0.0,0.0
1997.0,RWA,29,29,8,3,5,0.10344828,0.27586207,0.1724138
1998.0,RWA,28,28,2,5,-3,0.17857143,0.071428575,-0.10714286
1999.0,RWA,28,28,2,4,-2,0.14285715,0.071428575,-0.071428575
2000.0,RWA,24,24,2,3,-1,0.125,0.083333336,-0.041666668
2001.0,RWA,23,23,4,3,1,0.13043478,0.17391305,0.04347826
2002.0,RWA,28,28,1,3,-2,0.10714286,0.035714287,-0.071428575
2003.0,RWA,37,37,5,3,2,0.08108108,0.13513513,0.054054055
2004.0,RWA,62,62,6,2,4,0.032258064,0.09677419,0.06451613
2005.0,RWA,83,83,3,3,0,0.036144577,0.036144577,0.0
2006.0,RWA,110,110,4,6,-2,0.054545455,0.036363635,-0.018181818
2007.0,RWA,162,162,13,5,8,0.030864198,0.08024691,0.049382716
2008.0,RWA,201,201,18,6,12,0.029850746,0.08955224,0.05970149
2009.0,RWA,283,283,29,10,19,0.03533569,0.1024735,0.06713781
2010.0,RWA,339,339,20,17,3,0.050147492,0.05899705,0.0088495575
2011.0,RWA,440,440,26,20,6,0.045454547,0.05909091,0.013636364
2012.0,RWA,540,540,26,21,5,0.03888889,0.048148148,0.009259259
2013.0,RWA,609,609,35,28,7,0.04597701,0.057471264,0.011494253
2014.0,RWA,706,706,46,29,17,0.04107649,0.065155804,0.024079321
2015.0,RWA,758,758,36,48,-12,0.06332454,0.047493402,-0.015831135
2016.0,RWA,892,892,62,40,22,0.044843048,0.06950673,0.024663677
2017.0,RWA,1016,1016,58,51,7,0.05019685,0.057086613,0.0068897638
2018.0,RWA,1168,1168,61,59,2,0.0505137,0.052226026,0.0017123288
2019.0,RWA,1354,1354,91,52,39,0.038404725,0.067208275,0.028803546
2020.0,RWA,1466,1466,100,69,31,0.04706685,0.06821282,0.021145975
2021.0,RWA,1435,1435,88,82,6,0.057142857,0.06132404,0.004181185
2022.0,RWA,0,0,82,74,8,,,
1996.0,SAU,3032,3032,0,0,0,0.0,0.0,0.0
1997.0,SAU,3535,3535,122,95,27,0.026874116,0.034512024,0.007637907
1998.0,SAU,3973,3973,131,118,13,0.029700479,0.032972563,0.0032720866
1999.0,SAU,4152,4152,125,126,-1,0.03034682,0.030105973,-0.00024084779
2000.0,SAU,4314,4314,175,156,19,0.036161337,0.0405656,0.004404265
2001.0,SAU,4443,4443,207,154,53,0.034661263,0.046590142,0.011928877
2002.0,SAU,4630,4630,223,155,68,0.03347732,0.048164148,0.014686825
2003.0,SAU,4828,4828,234,160,74,0.033140015,0.048467275,0.015327258
2004.0,SAU,5050,5050,225,158,67,0.03128713,0.044554457,0.013267327
2005.0,SAU,5275,5275,202,156,46,0.02957346,0.03829384,0.008720379
2006.0,SAU,5581,5581,261,198,63,0.03547751,0.04676581,0.011288299
2007.0,SAU,6229,6229,336,190,146,0.030502489,0.053941242,0.023438754
2008.0,SAU,7043,7043,384,246,138,0.034928296,0.05452222,0.019593922
2009.0,SAU,8328,8328,564,237,327,0.028458213,0.06772334,0.03926513
2010.0,SAU,10170,10170,872,288,584,0.028318584,0.08574238,0.057423797
2011.0,SAU,12457,12457,1068,312,756,0.025046159,0.085734926,0.060688768
2012.0,SAU,14795,14795,1147,453,694,0.030618452,0.07752619,0.046907738
2013.0,SAU,17261,17261,1314,533,781,0.03087886,0.07612537,0.045246508
2014.0,SAU,19823,19823,1417,686,731,0.034606267,0.07148262,0.036876354
2015.0,SAU,22543,22543,1528,813,715,0.03606441,0.067781575,0.031717163
2016.0,SAU,25410,25410,1660,1019,641,0.04010232,0.06532861,0.02522629
2017.0,SAU,28639,28639,1787,1104,683,0.03854883,0.06239743,0.023848599
2018.0,SAU,32875,32875,1937,1266,671,0.038509507,0.058920152,0.020410646
2019.0,SAU,37429,37429,2245,1384,861,0.036976676,0.05998023,0.023003554
2020.0,SAU,41035,41035,2337,1376,961,0.03353235,0.05695138,0.023419032
2021.0,SAU,41091,41091,2213,1422,791,0.034606118,0.053856075,0.019249957
2022.0,SAU,0,0,1699,1279,420,,,
2023.0,SAU,0,0,1115,826,289,,,
1996.0,SDN,194,194,0,0,0,0.0,0.0,0.0
1997.0,SDN,233,233,7,8,-1,0.034334764,0.030042918,-0.0042918455
1998.0,SDN,276,276,12,9,3,0.032608695,0.04347826,0.010869565
1999.0,SDN,286,286,4,11,-7,0.03846154,0.013986014,-0.024475524
2000.0,SDN,305,305,13,13,0,0.04262295,0.04262295,0.0
2001.0,SDN,311,311,16,17,-1,0.05466238,0.051446944,-0.003215434
2002.0,SDN,334,334,14,23,-9,0.068862274,0.04191617,-0.026946107
2003.0,SDN,384,384,32,12,20,0.03125,0.083333336,0.052083332
2004.0,SDN,439,439,17,9,8,0.020501139,0.038724374,0.018223235
2005.0,SDN,522,522,21,14,7,0.026819924,0.040229887,0.013409962
2006.0,SDN,622,622,28,15,13,0.024115756,0.045016076,0.020900322
2007.0,SDN,752,752,23,19,4,0.025265958,0.030585106,0.005319149
2008.0,SDN,891,891,36,20,16,0.022446688,0.04040404,0.017957352
2009.0,SDN,1048,1048,33,16,17,0.015267176,0.03148855,0.016221374
2010.0,SDN,1109,1109,31,39,-8,0.03516682,0.02795311,-0.007213706
2011.0,SDN,1201,1201,44,31,13,0.025811823,0.036636136,0.010824313
2012.0,SDN,1242,1242,42,53,-11,0.042673107,0.033816423,-0.008856683
2013.0,SDN,1223,1223,38,61,-23,0.04987735,0.031071136,-0.018806214
2014.0,SDN,1235,1235,57,75,-18,0.060728744,0.046153847,-0.014574898
2015.0,SDN,1295,1295,59,62,-3,0.047876447,0.045559846,-0.0023166023
2016.0,SDN,1365,1365,73,61,12,0.044688646,0.053479854,0.008791209
2017.0,SDN,1490,1490,65,66,-1,0.044295304,0.043624163,-0.00067114097
2018.0,SDN,1639,1639,79,72,7,0.043929227,0.048200123,0.004270897
2019.0,SDN,1765,1765,90,99,-9,0.056090653,0.0509915,-0.0050991504
2020.0,SDN,1880,1880,130,110,20,0.05851064,0.069148935,0.010638298
2021.0,SDN,1813,1813,98,137,-39,0.07556536,0.054054055,-0.021511307
2022.0,SDN,0,0,72,88,-16,,,
2023.0,SDN,0,0,47,39,8,,,
1996.0,SEN,555,555,0,0,0,0.0,0.0,0.0
1997.0,SEN,688,688,25,22,3,0.031976745,0.036337208,0.0043604653
1998.0,SEN,780,780,33,29,4,0.03717949,0.042307694,0.0051282053
1999.0,SEN,817,817,34,34,0,0.04161567,0.04161567,0.0
2000.0,SEN,831,831,23,60,-37,0.07220217,0.027677497,-0.04452467
2001.0,SEN,895,895,37,49,-12,0.054748602,0.041340783,-0.013407821
2002.0,SEN,898,898,55,53,2,0.059020046,0.061247215,0.0022271716
2003.0,SEN,953,953,54,49,5,0.05141658,0.05666317,0.00524659
2004.0,SEN,1007,1007,38,38,0,0.03773585,0.03773585,0.0
2005.0,SEN,1072,1072,50,43,7,0.04011194,0.04664179,0.006529851
2006.0,SEN,1110,1110,61,53,8,0.047747746,0.054954953,0.0072072074
2007.0,SEN,1177,1177,61,47,14,0.03993203,0.05182668,0.011894647
2008.0,SEN,1242,1242,55,49,6,0.039452497,0.044283412,0.004830918
2009.0,SEN,1355,1355,50,67,-17,0.049446493,0.036900368,-0.012546126
2010.0,SEN,1436,1436,65,64,1,0.044568244,0.045264624,0.0006963788
2011.0,SEN,1551,1551,63,61,2,0.039329465,0.040618956,0.0012894906
2012.0,SEN,1689,1689,78,62,16,0.036708113,0.046181172,0.009473061
2013.0,SEN,1843,1843,57,53,4,0.02875746,0.030927835,0.0021703744
2014.0,SEN,2001,2001,81,72,9,0.03598201,0.04047976,0.004497751
2015.0,SEN,2101,2101,85,89,-4,0.04236078,0.040456925,-0.0019038554
2016.0,SEN,2097,2097,86,107,-21,0.051025275,0.04101097,-0.010014306
2017.0,SEN,2218,2218,98,91,7,0.041027952,0.04418395,0.0031559963
2018.0,SEN,2285,2285,101,85,16,0.037199125,0.044201314,0.0070021884
2019.0,SEN,2339,2339,88,77,11,0.03292005,0.037622917,0.0047028647
2020.0,SEN,2341,2341,101,87,14,0.037163604,0.043143954,0.00598035
2021.0,SEN,2231,2231,84,82,2,0.036754817,0.037651278,0.000896459
2022.0,SEN,0,0,77,51,26,,,
1996.0,SGP,3989,3989,0,0,0,0.0,0.0,0.0
1997.0,SGP,5010,5010,172,100,72,0.01996008,0.034331337,0.014371257
1998.0,SGP,6175,6175,283,130,153,0.021052632,0.04582996,0.024777329
1999.0,SGP,7192,7192,346,168,178,0.023359288,0.04810901,0.024749722
2000.0,SGP,8234,8234,393,214,179,0.025989799,0.04772893,0.02173913
2001.0,SGP,9110,9110,401,315,86,0.03457739,0.044017565,0.009440175
2002.0,SGP,10285,10285,454,367,87,0.035683032,0.044141956,0.008458921
2003.0,SGP,11291,11291,436,419,17,0.037109204,0.038614824,0.0015056239
2004.0,SGP,12219,12219,409,405,4,0.033145104,0.03347246,0.00032735904
2005.0,SGP,13079,13079,481,449,32,0.034329843,0.036776513,0.0024466703
2006.0,SGP,14163,14163,546,523,23,0.036927205,0.038551155,0.0016239497
2007.0,SGP,15301,15301,603,551,52,0.03601072,0.03940919,0.0033984706
2008.0,SGP,16520,16520,742,644,98,0.03898305,0.044915255,0.0059322035
2009.0,SGP,18146,18146,894,673,221,0.037088063,0.049267057,0.012178993
2010.0,SGP,19729,19729,971,762,209,0.038623348,0.04921689,0.010593543
2011.0,SGP,21489,21489,1056,753,303,0.035041183,0.049141422,0.014100238
2012.0,SGP,23297,23297,1139,929,210,0.03987638,0.048890416,0.0090140365
2013.0,SGP,24980,24980,1171,988,183,0.03955164,0.046877503,0.0073258607
2014.0,SGP,26513,26513,1217,1100,117,0.04148908,0.04590201,0.0044129295
2015.0,SGP,27936,27936,1346,1222,124,0.04374284,0.048181556,0.004438717
2016.0,SGP,29237,29237,1345,1247,98,0.042651433,0.046003353,0.003351917
2017.0,SGP,30308,30308,1404,1348,56,0.044476707,0.046324402,0.001847697
2018.0,SGP,31446,31446,1424,1445,-21,0.04595179,0.04528398,-0.0006678115
2019.0,SGP,32065,32065,1365,1565,-200,0.04880711,0.04256978,-0.0062373304
2020.0,SGP,31996,31996,1413,1545,-132,0.048287287,0.04416177,-0.0041255155
2021.0,SGP,30087,30087,1266,1615,-349,0.053677667,0.042077973,-0.011599694
2022.0,SGP,0,0,1092,1376,-284,,,
2023.0,SGP,0,0,767,864,-97,,,
2009.0,SGS,2,2,0,0,0,0.0,0.0,0.0
2020.0,SGS,1,1,0,1,-1,1.0,0.0,-1.0
2009.0,SHN,2,2,0,0,0,0.0,0.0,0.0
2013.0,SHN,3,3,0,0,0,0.0,0.0,0.0
2015.0,SHN,15,15,4,0,4,0.0,0.26666668,0.26666668
2017.0,SHN,22,22,6,1,5,0.045454547,0.27272728,0.22727273
2018.0,SHN,17,17,6,13,-7,0.7647059,0.3529412,-0.4117647
2019.0,SHN,10,10,1,7,-6,0.7,0.1,-0.6
2020.0,SHN,10,10,2,2,0,0.2,0.2,0.0
2021.0,SHN,8,8,3,4,-1,0.5,0.375,-0.125
2004.0,SJM,2,2,0,0,0,0.0,0.0,0.0
1996.0,SLB,16,16,0,0,0,0.0,0.0,0.0
1997.0,SLB,19,19,3,0,3,0.0,0.15789473,0.15789473
1998.0,SLB,22,22,1,1,0,0.045454547,0.045454547,0.0
2000.0,SLB,18,18,0,4,-4,0.22222222,0.0,-0.22222222
2001.0,SLB,21,21,2,3,-1,0.14285715,0.0952381,-0.04761905
2003.0,SLB,16,16,1,2,-1,0.125,0.0625,-0.0625
2004.0,SLB,16,16,1,1,0,0.0625,0.0625,0.0
2005.0,SLB,27,27,7,0,7,0.0,0.25925925,0.25925925
2006.0,SLB,28,28,1,1,0,0.035714287,0.035714287,0.0
2007.0,SLB,36,36,1,0,1,0.0,0.027777778,0.027777778
2008.0,SLB,43,43,1,2,-1,0.046511628,0.023255814,-0.023255814
2009.0,SLB,59,59,2,1,1,0.016949153,0.033898305,0.016949153
2010.0,SLB,70,70,3,1,2,0.014285714,0.042857144,0.028571429
2011.0,SLB,69,69,1,4,-3,0.057971016,0.014492754,-0.04347826
2012.0,SLB,73,73,1,1,0,0.01369863,0.01369863,0.0
2013.0,SLB,89,89,3,4,-1,0.04494382,0.033707865,-0.011235955
2014.0,SLB,94,94,10,6,4,0.06382979,0.10638298,0.04255319
2015.0,SLB,112,112,11,3,8,0.026785715,0.09821428,0.071428575
2016.0,SLB,127,127,5,4,1,0.031496063,0.03937008,0.007874016
2017.0,SLB,127,127,4,7,-3,0.05511811,0.031496063,-0.023622047
2018.0,SLB,125,125,4,4,0,0.032,0.032,0.0
2019.0,SLB,126,126,4,4,0,0.031746034,0.031746034,0.0
2020.0,SLB,130,130,6,3,3,0.023076924,0.046153847,0.023076924
2021.0,SLB,119,119,9,5,4,0.042016808,0.075630255,0.033613447
2022.0,SLB,0,0,4,4,0,,,
1996.0,SLE,32,32,0,0,0,0.0,0.0,0.0
1997.0,SLE,33,33,1,2,-1,0.060606062,0.030303031,-0.030303031
1998.0,SLE,34,34,0,2,-2,0.05882353,0.0,-0.05882353
1999.0,SLE,29,29,0,8,-8,0.27586207,0.0,-0.27586207
2000.0,SLE,24,24,2,2,0,0.083333336,0.083333336,0.0
2001.0,SLE,25,25,3,1,2,0.04,0.12,0.08
2002.0,SLE,19,19,1,5,-4,0.2631579,0.05263158,-0.21052632
2003.0,SLE,24,24,2,3,-1,0.125,0.083333336,-0.041666668
2004.0,SLE,26,26,1,0,1,0.0,0.03846154,0.03846154
2005.0,SLE,27,27,4,1,3,0.037037037,0.14814815,0.11111111
2006.0,SLE,35,35,2,3,-1,0.08571429,0.057142857,-0.028571429
2007.0,SLE,45,45,2,3,-1,0.06666667,0.044444446,-0.022222223
2008.0,SLE,60,60,2,3,-1,0.05,0.033333335,-0.016666668
2009.0,SLE,87,87,6,2,4,0.022988506,0.06896552,0.04597701
2010.0,SLE,98,98,7,4,3,0.040816326,0.071428575,0.030612245
2011.0,SLE,114,114,9,6,3,0.05263158,0.078947365,0.02631579
2012.0,SLE,156,156,9,2,7,0.012820513,0.057692308,0.044871796
2013.0,SLE,202,202,12,2,10,0.00990099,0.05940594,0.04950495
2014.0,SLE,269,269,17,5,12,0.01858736,0.063197024,0.044609666
2015.0,SLE,336,336,18,7,11,0.020833334,0.05357143,0.032738097
2016.0,SLE,360,360,18,13,5,0.036111113,0.05,0.013888889
2017.0,SLE,408,408,44,25,19,0.06127451,0.10784314,0.04656863
2018.0,SLE,473,473,32,28,4,0.059196617,0.067653276,0.0084566595
2019.0,SLE,517,517,38,20,18,0.03868472,0.07350097,0.034816246
2020.0,SLE,534,534,38,28,10,0.052434456,0.07116105,0.018726591
2021.0,SLE,521,521,37,27,10,0.051823415,0.07101727,0.019193858
2022.0,SLE,0,0,24,17,7,,,
1996.0,SLV,17,17,0,0,0,0.0,0.0,0.0
1997.0,SLV,23,23,5,1,4,0.04347826,0.2173913,0.17391305
1998.0,SLV,22,22,2,10,-8,0.45454547,0.09090909,-0.36363637
1999.0,SLV,24,24,4,5,-1,0.20833333,0.16666667,-0.041666668
2000.0,SLV,35,35,5,2,3,0.057142857,0.14285715,0.08571429
2001.0,SLV,40,40,7,8,-1,0.2,0.175,-0.025
2002.0,SLV,59,59,6,4,2,0.06779661,0.10169491,0.033898305
2003.0,SLV,65,65,9,4,5,0.06153846,0.13846155,0.07692308
2004.0,SLV,76,76,6,5,1,0.065789476,0.078947365,0.013157895
2005.0,SLV,78,78,6,9,-3,0.115384616,0.07692308,-0.03846154
2006.0,SLV,79,79,9,9,0,0.11392405,0.11392405,0.0
2007.0,SLV,85,85,14,7,7,0.08235294,0.16470589,0.08235294
2008.0,SLV,119,119,10,10,0,0.084033616,0.084033616,0.0
2009.0,SLV,141,141,15,11,4,0.07801419,0.10638298,0.028368793
2010.0,SLV,174,174,29,19,10,0.109195404,0.16666667,0.057471264
2011.0,SLV,172,172,15,27,-12,0.15697674,0.0872093,-0.069767445
2012.0,SLV,175,175,15,29,-14,0.16571428,0.08571429,-0.08
2013.0,SLV,195,195,15,21,-6,0.10769231,0.07692308,-0.03076923
2014.0,SLV,196,196,23,21,2,0.10714286,0.11734694,0.010204081
2015.0,SLV,219,219,22,19,3,0.08675799,0.10045662,0.01369863
2016.0,SLV,219,219,16,24,-8,0.10958904,0.07305936,-0.03652968
2017.0,SLV,218,218,16,21,-5,0.09633028,0.07339449,-0.02293578
2018.0,SLV,201,201,14,31,-17,0.15422885,0.06965174,-0.08457711
2019.0,SLV,219,219,29,25,4,0.11415525,0.1324201,0.01826484
2020.0,SLV,218,218,18,16,2,0.07339449,0.08256881,0.0091743115
2021.0,SLV,207,207,16,20,-4,0.096618354,0.077294685,-0.019323671
2022.0,SLV,0,0,17,9,8,,,
1996.0,SMR,7,7,0,0,0,0.0,0.0,0.0
1998.0,SMR,10,10,1,0,1,0.0,0.1,0.1
2000.0,SMR,14,14,2,0,2,0.0,0.14285715,0.14285715
2001.0,SMR,8,8,0,2,-2,0.25,0.0,-0.25
2002.0,SMR,6,6,0,1,-1,0.16666667,0.0,-0.16666667
2005.0,SMR,7,7,1,0,1,0.0,0.14285715,0.14285715
2007.0,SMR,14,14,0,0,0,0.0,0.0,0.0
2008.0,SMR,18,18,0,1,-1,0.055555556,0.0,-0.055555556
2009.0,SMR,17,17,0,1,-1,0.05882353,0.0,-0.05882353
2010.0,SMR,13,13,0,1,-1,0.07692308,0.0,-0.07692308
2012.0,SMR,19,19,6,1,5,0.05263158,0.31578946,0.2631579
2013.0,SMR,27,27,5,2,3,0.074074075,0.18518518,0.11111111
2014.0,SMR,30,30,1,3,-2,0.1,0.033333335,-0.06666667
2015.0,SMR,40,40,6,4,2,0.1,0.15,0.05
2016.0,SMR,38,38,2,7,-5,0.18421052,0.05263158,-0.13157895
2017.0,SMR,48,48,7,3,4,0.0625,0.14583333,0.083333336
2018.0,SMR,56,56,8,1,7,0.017857144,0.14285715,0.125
2019.0,SMR,59,59,7,5,2,0.084745765,0.118644066,0.033898305
2020.0,SMR,65,65,9,4,5,0.06153846,0.13846155,0.07692308
2021.0,SMR,68,68,12,5,7,0.073529415,0.1764706,0.10294118
2022.0,SMR,0,0,7,5,2,,,
1996.0,SOM,3,3,0,0,0,0.0,0.0,0.0
1997.0,SOM,3,3,1,1,0,0.33333334,0.33333334,0.0
2002.0,SOM,4,4,0,0,0,0.0,0.0,0.0
2003.0,SOM,4,4,0,0,0,0.0,0.0,0.0
2006.0,SOM,5,5,0,0,0,0.0,0.0,0.0
2008.0,SOM,10,10,2,1,1,0.1,0.2,0.1
2009.0,SOM,9,9,1,1,0,0.11111111,0.11111111,0.0
2010.0,SOM,10,10,1,1,0,0.1,0.1,0.0
2011.0,SOM,14,14,3,1,2,0.071428575,0.21428572,0.14285715
2012.0,SOM,15,15,1,2,-1,0.13333334,0.06666667,-0.06666667
2013.0,SOM,31,31,1,2,-1,0.06451613,0.032258064,-0.032258064
2014.0,SOM,37,37,5,0,5,0.0,0.13513513,0.13513513
2015.0,SOM,42,42,0,3,-3,0.071428575,0.0,-0.071428575
2016.0,SOM,44,44,5,2,3,0.045454547,0.11363637,0.06818182
2017.0,SOM,57,57,7,3,4,0.05263158,0.12280702,0.07017544
2018.0,SOM,95,95,12,3,9,0.031578947,0.12631579,0.094736844
2019.0,SOM,147,147,15,2,13,0.013605442,0.10204082,0.088435374
2020.0,SOM,225,225,25,3,22,0.013333334,0.11111111,0.09777778
2021.0,SOM,240,240,26,10,16,0.041666668,0.108333334,0.06666667
2022.0,SOM,0,0,30,6,24,,,
2012.0,SPM,2,2,0,0,0,0.0,0.0,0.0
1996.0,SRB,3562,3562,0,0,0,0.0,0.0,0.0
1997.0,SRB,4203,4203,112,67,45,0.015940994,0.026647633,0.010706638
1998.0,SRB,4651,4651,95,146,-51,0.0313911,0.020425715,-0.010965384
1999.0,SRB,4860,4860,93,157,-64,0.032304525,0.019135803,-0.013168724
2000.0,SRB,5016,5016,84,180,-96,0.035885166,0.016746411,-0.019138755
2001.0,SRB,5246,5246,146,165,-19,0.031452537,0.027830727,-0.003621807
2002.0,SRB,5615,5615,157,194,-37,0.034550313,0.02796082,-0.0065894923
2003.0,SRB,6201,6201,212,148,64,0.02386712,0.034188036,0.010320916
2004.0,SRB,6838,6838,244,232,12,0.033928048,0.035682946,0.001754899
2005.0,SRB,7755,7755,290,190,100,0.024500322,0.037395228,0.012894906
2006.0,SRB,8832,8832,269,287,-18,0.032495473,0.030457428,-0.0020380435
2007.0,SRB,9981,9981,109,335,-226,0.03356377,0.010920749,-0.022643022
2008.0,SRB,11431,11431,152,181,-29,0.015834136,0.013297174,-0.0025369609
2009.0,SRB,12943,12943,173,154,19,0.011898323,0.013366299,0.001467975
2010.0,SRB,14716,14716,183,109,74,0.007406904,0.012435445,0.0050285403
2011.0,SRB,16095,16095,183,148,35,0.009195402,0.011369991,0.0021745884
2012.0,SRB,17095,17095,185,134,51,0.007838549,0.010821878,0.0029833284
2013.0,SRB,17945,17945,158,138,20,0.0076901643,0.008804681,0.0011145166
2014.0,SRB,18801,18801,170,195,-25,0.010371788,0.009042072,-0.0013297165
2015.0,SRB,19321,19321,185,194,-9,0.010040889,0.009575074,-0.0004658144
2016.0,SRB,19689,19689,191,232,-41,0.011783229,0.009700848,-0.002082381
2017.0,SRB,20158,20158,175,243,-68,0.012054767,0.0086814165,-0.0033733505
2018.0,SRB,20477,20477,167,257,-90,0.012550667,0.008155491,-0.0043951753
2019.0,SRB,20770,20770,222,235,-13,0.011314396,0.010688493,-0.0006259027
2020.0,SRB,20765,20765,255,266,-11,0.012810017,0.01228028,-0.00052973756
2021.0,SRB,19976,19976,251,241,10,0.012064477,0.012565078,0.0005006007
2022.0,SRB,0,0,205,212,-7,,,
2023.0,SRB,0,0,98,131,-33,,,
2008.0,SSD,1,1,0,0,0,0.0,0.0,0.0
2014.0,SSD,23,23,6,0,6,0.0,0.26086956,0.26086956
2015.0,SSD,31,31,8,1,7,0.032258064,0.2580645,0.22580644
2016.0,SSD,39,39,4,4,0,0.102564104,0.102564104,0.0
2017.0,SSD,35,35,4,7,-3,0.2,0.114285715,-0.08571429
2018.0,SSD,43,43,10,4,6,0.093023255,0.23255815,0.13953489
2019.0,SSD,58,58,15,6,9,0.10344828,0.25862068,0.15517241
2020.0,SSD,74,74,12,5,7,0.067567565,0.16216215,0.0945946
2021.0,SSD,92,92,28,5,23,0.054347824,0.3043478,0.25
2022.0,SSD,0,0,18,4,14,,,
1996.0,STP,1,1,0,0,0,0.0,0.0,0.0
2000.0,STP,3,3,0,1,-1,0.33333334,0.0,-0.33333334
2001.0,STP,2,2,0,1,-1,0.5,0.0,-0.5
2005.0,STP,8,8,0,0,0,0.0,0.0,0.0
2006.0,STP,9,9,1,0,1,0.0,0.11111111,0.11111111
2009.0,STP,13,13,1,0,1,0.0,0.07692308,0.07692308
2010.0,STP,7,7,0,1,-1,0.14285715,0.0,-0.14285715
2014.0,STP,8,8,0,0,0,0.0,0.0,0.0
2015.0,STP,9,9,2,1,1,0.11111111,0.22222222,0.11111111
2016.0,STP,8,8,1,3,-2,0.375,0.125,-0.25
2017.0,STP,11,11,1,0,1,0.0,0.09090909,0.09090909
2018.0,STP,13,13,0,2,-2,0.15384616,0.0,-0.15384616
2019.0,STP,20,20,5,0,5,0.0,0.25,0.25
2020.0,STP,26,26,4,0,4,0.0,0.15384616,0.15384616
2021.0,STP,26,26,2,2,0,0.07692308,0.07692308,0.0
2022.0,STP,0,0,0,1,-1,,,
1996.0,SUR,9,9,0,0,0,0.0,0.0,0.0
1997.0,SUR,11,11,0,0,0,0.0,0.0,0.0
1999.0,SUR,16,16,0,0,0,0.0,0.0,0.0
2000.0,SUR,18,18,0,0,0,0.0,0.0,0.0
2001.0,SUR,20,20,2,0,2,0.0,0.1,0.1
2002.0,SUR,25,25,3,1,2,0.04,0.12,0.08
2003.0,SUR,34,34,0,0,0,0.0,0.0,0.0
2004.0,SUR,38,38,2,0,2,0.0,0.05263158,0.05263158
2005.0,SUR,36,36,0,2,-2,0.055555556,0.0,-0.055555556
2006.0,SUR,37,37,1,1,0,0.027027028,0.027027028,0.0
2007.0,SUR,37,37,0,1,-1,0.027027028,0.0,-0.027027028
2008.0,SUR,38,38,0,0,0,0.0,0.0,0.0
2009.0,SUR,41,41,2,1,1,0.024390243,0.048780486,0.024390243
2010.0,SUR,53,53,2,1,1,0.018867925,0.03773585,0.018867925
2011.0,SUR,49,49,2,1,1,0.020408163,0.040816326,0.020408163
2012.0,SUR,54,54,4,1,3,0.018518519,0.074074075,0.055555556
2013.0,SUR,80,80,6,1,5,0.0125,0.075,0.0625
2014.0,SUR,101,101,8,0,8,0.0,0.07920792,0.07920792
2015.0,SUR,114,114,11,3,8,0.02631579,0.096491225,0.07017544
2016.0,SUR,111,111,1,6,-5,0.054054055,0.009009009,-0.045045044
2017.0,SUR,124,124,4,4,0,0.032258064,0.032258064,0.0
2018.0,SUR,131,131,7,6,1,0.045801528,0.053435113,0.007633588
2019.0,SUR,141,141,13,3,10,0.021276595,0.09219858,0.07092199
2020.0,SUR,123,123,0,7,-7,0.05691057,0.0,-0.05691057
2021.0,SUR,128,128,9,7,2,0.0546875,0.0703125,0.015625
2022.0,SUR,0,0,5,5,0,,,
1996.0,SVK,4405,4405,0,0,0,0.0,0.0,0.0
1997.0,SVK,5089,5089,98,98,0,0.019257221,0.019257221,0.0
1998.0,SVK,5723,5723,96,100,-4,0.017473353,0.01677442,-0.00069893413
1999.0,SVK,6075,6075,84,96,-12,0.01580247,0.013827161,-0.0019753086
2000.0,SVK,6382,6382,113,141,-28,0.022093387,0.017706048,-0.0043873396
2001.0,SVK,6653,6653,134,165,-31,0.024800843,0.02014129,-0.004659552
2002.0,SVK,6914,6914,137,213,-76,0.030807057,0.019814868,-0.01099219
2003.0,SVK,7183,7183,142,204,-62,0.02840039,0.0197689,-0.008631491
2004.0,SVK,7435,7435,112,165,-53,0.022192333,0.015063887,-0.0071284464
2005.0,SVK,7840,7840,103,168,-65,0.021428572,0.013137755,-0.008290816
2006.0,SVK,8334,8334,128,152,-24,0.01823854,0.015358771,-0.0028797695
2007.0,SVK,8746,8746,139,165,-26,0.018865768,0.015892979,-0.0029727875
2008.0,SVK,9288,9288,146,191,-45,0.020564169,0.015719207,-0.004844961
2009.0,SVK,9906,9906,152,179,-27,0.018069856,0.015344236,-0.0027256208
2010.0,SVK,10487,10487,176,180,-4,0.017164107,0.016782684,-0.00038142462
2011.0,SVK,11285,11285,172,181,-9,0.01603899,0.015241471,-0.0007975188
2012.0,SVK,12178,12178,175,191,-16,0.01568402,0.014370176,-0.0013138447
2013.0,SVK,12922,12922,189,201,-12,0.015554868,0.014626219,-0.0009286488
2014.0,SVK,13628,13628,188,230,-42,0.016877018,0.013795128,-0.0030818903
2015.0,SVK,14221,14221,184,211,-27,0.014837213,0.012938612,-0.0018986006
2016.0,SVK,14704,14704,205,219,-14,0.014893906,0.013941784,-0.00095212186
2017.0,SVK,15150,15150,243,199,44,0.013135314,0.016039604,0.0029042903
2018.0,SVK,15650,15650,247,234,13,0.014952077,0.015782747,0.00083067094
2019.0,SVK,15920,15920,208,229,-21,0.014384422,0.013065327,-0.0013190955
2020.0,SVK,15794,15794,214,212,2,0.013422819,0.013549449,0.00012663036
2021.0,SVK,15180,15180,220,202,18,0.013306983,0.014492754,0.0011857707
2022.0,SVK,0,0,184,160,24,,,
2023.0,SVK,0,0,103,105,-2,,,
1996.0,SVN,2384,2384,0,0,0,0.0,0.0,0.0
1997.0,SVN,2814,2814,31,41,-10,0.014570007,0.0110163465,-0.0035536604
1998.0,SVN,3369,3369,65,35,30,0.010388839,0.01929356,0.00890472
1999.0,SVN,3783,3783,47,52,-5,0.013745705,0.012424002,-0.0013217024
2000.0,SVN,4155,4155,53,51,2,0.012274369,0.012755716,0.0004813478
2001.0,SVN,4555,4555,54,79,-25,0.017343579,0.011855104,-0.0054884744
2002.0,SVN,4937,4937,83,60,23,0.012153129,0.016811829,0.0046586995
2003.0,SVN,5352,5352,75,64,11,0.0119581465,0.014013452,0.0020553065
2004.0,SVN,5727,5727,69,60,9,0.01047669,0.012048192,0.0015715034
2005.0,SVN,6199,6199,84,60,24,0.00967898,0.013550573,0.0038715922
2006.0,SVN,6774,6774,101,70,31,0.010333628,0.01490995,0.004576321
2007.0,SVN,7377,7377,103,82,21,0.011115629,0.013962315,0.0028466857
2008.0,SVN,7923,7923,97,115,-18,0.014514704,0.012242837,-0.0022718667
2009.0,SVN,8514,8514,108,113,-5,0.0132722575,0.01268499,-0.00058726803
2010.0,SVN,8944,8944,93,121,-28,0.013528623,0.010398032,-0.0031305903
2011.0,SVN,9435,9435,112,149,-37,0.015792264,0.011870694,-0.003921569
2012.0,SVN,9833,9833,134,151,-17,0.015356453,0.01362758,-0.0017288722
2013.0,SVN,10213,10213,97,132,-35,0.012924704,0.009497699,-0.003427005
2014.0,SVN,10501,10501,112,175,-63,0.016665079,0.0106656505,-0.0059994287
2015.0,SVN,10702,10702,113,154,-41,0.014389833,0.010558774,-0.0038310597
2016.0,SVN,10819,10819,136,185,-49,0.017099546,0.012570478,-0.004529069
2017.0,SVN,10993,10993,155,171,-16,0.015555354,0.014099882,-0.0014554716
2018.0,SVN,11201,11201,166,181,-15,0.016159272,0.014820105,-0.0013391662
2019.0,SVN,11372,11372,178,185,-7,0.016268026,0.01565248,-0.00061554695
2020.0,SVN,11311,11311,181,177,4,0.015648484,0.016002122,0.00035363805
2021.0,SVN,11001,11001,195,162,33,0.014725934,0.017725661,0.0029997274
2022.0,SVN,0,0,128,141,-13,,,
2023.0,SVN,0,0,102,74,28,,,
1996.0,SWE,25579,25579,0,0,0,0.0,0.0,0.0
1997.0,SWE,29272,29272,625,662,-37,0.022615468,0.021351462,-0.0012640066
1998.0,SWE,32659,32659,831,820,11,0.025107933,0.025444748,0.00033681374
1999.0,SWE,35169,35169,936,923,13,0.026244704,0.026614347,0.00036964373
2000.0,SWE,37065,37065,1051,1007,44,0.027168488,0.028355591,0.0011871037
2001.0,SWE,38782,38782,1199,1256,-57,0.032386158,0.030916404,-0.001469754
2002.0,SWE,40371,40371,1164,1352,-188,0.033489387,0.028832577,-0.004656808
2003.0,SWE,42060,42060,1147,1224,-77,0.029101284,0.027270567,-0.001830718
2004.0,SWE,43483,43483,967,1087,-120,0.024998276,0.022238577,-0.0027596992
2005.0,SWE,44897,44897,939,1097,-158,0.024433704,0.020914538,-0.003519166
2006.0,SWE,46096,46096,944,1190,-246,0.025815688,0.020479001,-0.005336689
2007.0,SWE,47596,47596,997,1264,-267,0.026556853,0.020947138,-0.005609715
2008.0,SWE,48898,48898,1138,1262,-124,0.025808826,0.023272935,-0.002535891
2009.0,SWE,50424,50424,1228,1318,-90,0.026138347,0.024353482,-0.0017848643
2010.0,SWE,52279,52279,1383,1352,31,0.025861245,0.026454216,0.0005929723
2011.0,SWE,54319,54319,1568,1320,248,0.02430089,0.02886651,0.0045656217
2012.0,SWE,56435,56435,1634,1424,210,0.025232568,0.028953664,0.0037210952
2013.0,SWE,58812,58812,1813,1330,483,0.022614432,0.030827042,0.008212609
2014.0,SWE,60827,60827,1848,1600,248,0.026304109,0.030381246,0.004077137
2015.0,SWE,62861,62861,2044,1520,524,0.024180334,0.032516185,0.008335852
2016.0,SWE,64352,64352,2043,1768,275,0.027473893,0.031747267,0.0042733713
2017.0,SWE,65695,65695,2199,1757,442,0.026744805,0.033472866,0.0067280615
2018.0,SWE,66922,66922,2320,1896,424,0.02833149,0.034667224,0.006335734
2019.0,SWE,67748,67748,2294,1945,349,0.028709335,0.033860777,0.0051514436
2020.0,SWE,67401,67401,2469,1918,551,0.028456552,0.036631502,0.008174953
2021.0,SWE,65159,65159,2458,1941,517,0.029788671,0.03772311,0.007934437
2022.0,SWE,0,0,1935,1738,197,,,
2023.0,SWE,0,0,1293,1053,240,,,
1996.0,SWZ,25,25,0,0,0,0.0,0.0,0.0
1997.0,SWZ,30,30,4,4,0,0.13333334,0.13333334,0.0
1998.0,SWZ,34,34,6,3,3,0.0882353,0.1764706,0.0882353
1999.0,SWZ,34,34,3,4,-1,0.11764706,0.0882353,-0.029411765
2000.0,SWZ,36,36,4,5,-1,0.1388889,0.11111111,-0.027777778
2001.0,SWZ,29,29,1,7,-6,0.2413793,0.03448276,-0.20689656
2002.0,SWZ,39,39,7,3,4,0.07692308,0.17948718,0.102564104
2003.0,SWZ,47,47,3,2,1,0.04255319,0.06382979,0.021276595
2004.0,SWZ,55,55,5,1,4,0.018181818,0.09090909,0.07272727
2005.0,SWZ,57,57,2,4,-2,0.07017544,0.03508772,-0.03508772
2006.0,SWZ,68,68,5,3,2,0.04411765,0.073529415,0.029411765
2007.0,SWZ,81,81,8,3,5,0.037037037,0.09876543,0.061728396
2008.0,SWZ,108,108,11,6,5,0.055555556,0.10185185,0.046296295
2009.0,SWZ,123,123,17,12,5,0.09756097,0.13821138,0.040650405
2010.0,SWZ,131,131,20,19,1,0.14503817,0.15267175,0.007633588
2011.0,SWZ,130,130,18,17,1,0.13076924,0.13846155,0.0076923077
2012.0,SWZ,139,139,24,27,-3,0.19424461,0.17266187,-0.021582734
2013.0,SWZ,134,134,17,22,-5,0.1641791,0.12686567,-0.03731343
2014.0,SWZ,155,155,17,18,-1,0.11612903,0.10967742,-0.006451613
2015.0,SWZ,194,194,31,13,18,0.067010306,0.15979381,0.0927835
2016.0,SWZ,230,230,25,20,5,0.08695652,0.10869565,0.02173913
2017.0,SWZ,227,227,20,29,-9,0.1277533,0.08810572,-0.039647575
2018.0,SWZ,253,253,27,22,5,0.08695652,0.10671937,0.019762846
2019.0,SWZ,272,272,31,29,2,0.106617644,0.113970585,0.007352941
2020.0,SWZ,275,275,33,31,2,0.11272727,0.12,0.0072727273
2021.0,SWZ,261,261,31,36,-5,0.13793103,0.118773945,-0.019157087
2022.0,SWZ,0,0,34,22,12,,,
2021.0,SXM,8,8,3,0,3,0.0,0.375,0.375
2022.0,SXM,0,0,10,3,7,,,
1996.0,SYC,12,12,0,0,0,0.0,0.0,0.0
1997.0,SYC,13,13,1,0,1,0.0,0.07692308,0.07692308
1998.0,SYC,15,15,0,2,-2,0.13333334,0.0,-0.13333334
2000.0,SYC,17,17,1,0,1,0.0,0.05882353,0.05882353
2002.0,SYC,23,23,4,1,3,0.04347826,0.17391305,0.13043478
2003.0,SYC,26,26,1,0,1,0.0,0.03846154,0.03846154
2004.0,SYC,36,36,3,1,2,0.027777778,0.083333336,0.055555556
2005.0,SYC,37,37,1,0,1,0.0,0.027027028,0.027027028
2006.0,SYC,35,35,1,1,0,0.028571429,0.028571429,0.0
2007.0,SYC,37,37,2,2,0,0.054054055,0.054054055,0.0
2008.0,SYC,38,38,2,4,-2,0.10526316,0.05263158,-0.05263158
2009.0,SYC,41,41,4,5,-1,0.12195122,0.09756097,-0.024390243
2010.0,SYC,41,41,3,3,0,0.07317073,0.07317073,0.0
2011.0,SYC,47,47,7,4,3,0.08510638,0.14893617,0.06382979
2012.0,SYC,56,56,6,2,4,0.035714287,0.10714286,0.071428575
2013.0,SYC,72,72,8,3,5,0.041666668,0.11111111,0.06944445
2014.0,SYC,74,74,6,5,1,0.067567565,0.08108108,0.013513514
2015.0,SYC,79,79,6,1,5,0.012658228,0.07594936,0.06329114
2016.0,SYC,66,66,1,6,-5,0.09090909,0.015151516,-0.07575758
2017.0,SYC,75,75,10,5,5,0.06666667,0.13333334,0.06666667
2019.0,SYC,98,98,4,9,-5,0.091836736,0.040816326,-0.05102041
2020.0,SYC,102,102,9,6,3,0.05882353,0.0882353,0.029411765
2021.0,SYC,112,112,17,6,11,0.05357143,0.15178572,0.09821428
2022.0,SYC,0,0,7,4,3,,,
1996.0,SYR,158,158,0,0,0,0.0,0.0,0.0
1997.0,SYR,209,209,4,9,-5,0.043062203,0.019138755,-0.023923445
1998.0,SYR,266,266,15,5,10,0.018796992,0.05639098,0.037593983
1999.0,SYR,280,280,11,11,0,0.039285716,0.039285716,0.0
2000.0,SYR,303,303,21,13,8,0.04290429,0.06930693,0.026402641
2001.0,SYR,298,298,11,23,-12,0.077181205,0.03691275,-0.040268455
2002.0,SYR,329,329,17,13,4,0.039513677,0.051671732,0.012158055
2003.0,SYR,355,355,23,16,7,0.04507042,0.06478873,0.01971831
2004.0,SYR,385,385,20,10,10,0.025974026,0.051948052,0.025974026
2005.0,SYR,429,429,24,12,12,0.027972028,0.055944055,0.027972028
2006.0,SYR,492,492,32,22,10,0.044715445,0.06504065,0.020325202
2007.0,SYR,522,522,19,7,12,0.013409962,0.036398467,0.022988506
2008.0,SYR,599,599,28,19,9,0.031719532,0.046744574,0.015025042
2009.0,SYR,688,688,36,27,9,0.039244186,0.05232558,0.013081395
2010.0,SYR,785,785,34,27,7,0.034394905,0.043312103,0.008917198
2011.0,SYR,922,922,51,18,33,0.019522777,0.055314533,0.03579176
2012.0,SYR,1066,1066,44,26,18,0.024390243,0.041275796,0.016885553
2013.0,SYR,1147,1147,37,46,-9,0.04010462,0.032258064,-0.007846557
2014.0,SYR,1164,1164,27,67,-40,0.05756014,0.023195876,-0.03436426
2015.0,SYR,1188,1188,31,54,-23,0.045454547,0.026094276,-0.019360268
2016.0,SYR,1255,1255,25,35,-10,0.027888447,0.01992032,-0.007968128
2017.0,SYR,1305,1305,23,49,-26,0.037547894,0.017624522,-0.019923372
2018.0,SYR,1420,1420,34,34,0,0.023943663,0.023943663,0.0
2019.0,SYR,1558,1558,36,44,-8,0.028241334,0.023106547,-0.0051347883
2020.0,SYR,1671,1671,33,31,2,0.018551765,0.019748654,0.001196888
2021.0,SYR,1622,1622,41,50,-9,0.03082614,0.025277436,-0.0055487053
2022.0,SYR,0,0,24,29,-5,,,
1997.0,TCA,2,2,0,0,0,0.0,0.0,0.0
2001.0,TCA,2,2,0,0,0,0.0,0.0,0.0
2008.0,TCA,10,10,0,0,0,0.0,0.0,0.0
2009.0,TCA,10,10,0,0,0,0.0,0.0,0.0
2012.0,TCA,10,10,1,1,0,0.1,0.1,0.0
2013.0,TCA,9,9,1,0,1,0.0,0.11111111,0.11111111
2016.0,TCA,13,13,4,1,3,0.07692308,0.30769232,0.23076923
2020.0,TCA,13,13,1,0,1,0.0,0.07692308,0.07692308
2021.0,TCA,13,13,3,2,1,0.15384616,0.23076923,0.07692308
1996.0,TCD,6,6,0,0,0,0.0,0.0,0.0
1997.0,TCD,8,8,0,2,-2,0.25,0.0,-0.25
1999.0,TCD,14,14,2,0,2,0.0,0.14285715,0.14285715
2001.0,TCD,27,27,2,0,2,0.0,0.074074075,0.074074075
2002.0,TCD,32,32,3,1,2,0.03125,0.09375,0.0625
2003.0,TCD,37,37,5,2,3,0.054054055,0.13513513,0.08108108
2004.0,TCD,47,47,5,2,3,0.04255319,0.10638298,0.06382979
2005.0,TCD,47,47,1,2,-1,0.04255319,0.021276595,-0.021276595
2006.0,TCD,43,43,1,4,-3,0.093023255,0.023255814,-0.069767445
2007.0,TCD,44,44,2,2,0,0.045454547,0.045454547,0.0
2008.0,TCD,47,47,4,4,0,0.08510638,0.08510638,0.0
2009.0,TCD,41,41,4,6,-2,0.14634146,0.09756097,-0.048780486
2010.0,TCD,43,43,0,2,-2,0.046511628,0.0,-0.046511628
2011.0,TCD,51,51,2,4,-2,0.078431375,0.039215688,-0.039215688
2012.0,TCD,70,70,4,4,0,0.057142857,0.057142857,0.0
2013.0,TCD,83,83,2,4,-2,0.04819277,0.024096385,-0.024096385
2014.0,TCD,98,98,5,4,1,0.040816326,0.05102041,0.010204081
2015.0,TCD,105,105,3,9,-6,0.08571429,0.028571429,-0.057142857
2016.0,TCD,125,125,9,4,5,0.032,0.072,0.04
2017.0,TCD,142,142,12,5,7,0.03521127,0.08450704,0.049295776
2018.0,TCD,142,142,5,6,-1,0.04225352,0.03521127,-0.0070422534
2019.0,TCD,167,167,17,1,16,0.005988024,0.1017964,0.09580839
2020.0,TCD,186,186,10,7,3,0.03763441,0.05376344,0.016129032
2021.0,TCD,183,183,16,3,13,0.016393442,0.08743169,0.07103825
2022.0,TCD,0,0,7,4,3,,,
1996.0,TGO,106,106,0,0,0,0.0,0.0,0.0
1997.0,TGO,128,128,2,3,-1,0.0234375,0.015625,-0.0078125
1998.0,TGO,139,139,7,3,4,0.021582734,0.05035971,0.02877698
1999.0,TGO,138,138,2,8,-6,0.057971016,0.014492754,-0.04347826
2000.0,TGO,156,156,3,3,0,0.01923077,0.01923077,0.0
2001.0,TGO,169,169,9,3,6,0.01775148,0.053254437,0.03550296
2002.0,TGO,154,154,6,8,-2,0.051948052,0.038961038,-0.012987013
2003.0,TGO,157,157,4,2,2,0.012738854,0.025477707,0.012738854
2004.0,TGO,167,167,9,8,1,0.047904193,0.053892214,0.005988024
2005.0,TGO,185,185,7,3,4,0.016216217,0.037837837,0.021621622
2006.0,TGO,219,219,12,6,6,0.02739726,0.05479452,0.02739726
2007.0,TGO,266,266,9,5,4,0.018796992,0.033834588,0.015037594
2008.0,TGO,301,301,7,5,2,0.016611295,0.023255814,0.006644518
2009.0,TGO,336,336,9,8,1,0.023809524,0.026785715,0.0029761905
2010.0,TGO,373,373,6,7,-1,0.018766755,0.01608579,-0.0026809652
2011.0,TGO,416,416,9,7,2,0.016826924,0.021634616,0.0048076925
2012.0,TGO,461,461,9,11,-2,0.023861172,0.019522777,-0.004338395
2013.0,TGO,504,504,16,6,10,0.011904762,0.031746034,0.01984127
2014.0,TGO,558,558,17,15,2,0.02688172,0.03046595,0.0035842294
2015.0,TGO,598,598,26,5,21,0.008361204,0.04347826,0.035117056
2016.0,TGO,637,637,10,14,-4,0.021978023,0.015698588,-0.006279435
2017.0,TGO,671,671,22,14,8,0.020864382,0.032786883,0.011922504
2018.0,TGO,709,709,14,12,2,0.016925247,0.019746121,0.0028208746
2019.0,TGO,737,737,23,13,10,0.017639078,0.031207599,0.0135685215
2020.0,TGO,758,758,29,15,14,0.019788919,0.038258575,0.018469658
2021.0,TGO,734,734,23,19,4,0.025885558,0.03133515,0.005449591
2022.0,TGO,0,0,17,6,11,,,
1996.0,THA,3314,3314,0,0,0,0.0,0.0,0.0
1997.0,THA,4199,4199,110,55,55,0.013098356,0.026196713,0.013098356
1998.0,THA,5121,5121,142,88,54,0.017184144,0.02772896,0.010544815
1999.0,THA,5931,5931,165,123,42,0.020738492,0.02781993,0.0070814365
2000.0,THA,6778,6778,188,133,55,0.019622307,0.027736796,0.008114488
2001.0,THA,7626,7626,255,208,47,0.027275112,0.03343824,0.0061631263
2002.0,THA,8560,8560,305,226,79,0.02640187,0.03563084,0.009228972
2003.0,THA,9915,9915,401,207,194,0.020877458,0.04044377,0.019566314
2004.0,THA,11596,11596,418,193,225,0.01664367,0.03604691,0.019403242
2005.0,THA,13034,13034,432,224,208,0.017185822,0.033144083,0.015958263
2006.0,THA,14841,14841,425,231,194,0.015564989,0.028636884,0.013071896
2007.0,THA,16843,16843,504,297,207,0.017633438,0.029923411,0.012289972
2008.0,THA,18855,18855,542,305,237,0.01617608,0.02874569,0.01256961
2009.0,THA,20731,20731,531,300,231,0.014471082,0.025613815,0.0111427335
2010.0,THA,22681,22681,534,411,123,0.018120894,0.023543935,0.0054230415
2011.0,THA,24524,24524,586,404,182,0.016473658,0.02389496,0.0074213017
2012.0,THA,26397,26397,641,405,236,0.015342653,0.024283063,0.00894041
2013.0,THA,28245,28245,661,452,209,0.016002832,0.023402372,0.00739954
2014.0,THA,30212,30212,716,448,268,0.014828545,0.023699192,0.008870647
2015.0,THA,32281,32281,751,458,293,0.014187912,0.023264458,0.009076547
2016.0,THA,35016,35016,804,527,277,0.015050263,0.022960933,0.00791067
2017.0,THA,37868,37868,813,571,242,0.015078695,0.021469314,0.00639062
2018.0,THA,40962,40962,922,530,392,0.012938822,0.022508666,0.009569845
2019.0,THA,43996,43996,849,638,211,0.014501318,0.019297209,0.0047958908
2020.0,THA,45663,45663,946,697,249,0.015263999,0.020716991,0.0054529924
2021.0,THA,44975,44975,939,677,262,0.0150528075,0.020878267,0.0058254586
2022.0,THA,0,0,682,511,171,,,
2023.0,THA,0,0,430,402,28,,,
1996.0,TJK,64,64,0,0,0,0.0,0.0,0.0
1997.0,TJK,79,79,1,2,-1,0.025316456,0.012658228,-0.012658228
1998.0,TJK,92,92,1,6,-5,0.06521739,0.010869565,-0.054347824
1999.0,TJK,97,97,2,0,2,0.0,0.020618556,0.020618556
2000.0,TJK,102,102,1,4,-3,0.039215688,0.009803922,-0.029411765
2001.0,TJK,101,101,2,4,-2,0.03960396,0.01980198,-0.01980198
2002.0,TJK,106,106,1,3,-2,0.028301887,0.009433962,-0.018867925
2003.0,TJK,107,107,1,6,-5,0.056074765,0.009345794,-0.046728972
2004.0,TJK,108,108,2,2,0,0.018518519,0.018518519,0.0
2005.0,TJK,110,110,1,1,0,0.009090909,0.009090909,0.0
2006.0,TJK,123,123,2,0,2,0.0,0.016260162,0.016260162
2007.0,TJK,128,128,0,1,-1,0.0078125,0.0,-0.0078125
2008.0,TJK,141,141,4,2,2,0.014184397,0.028368793,0.014184397
2009.0,TJK,135,135,0,5,-5,0.037037037,0.0,-0.037037037
2010.0,TJK,141,141,2,6,-4,0.04255319,0.014184397,-0.028368793
2011.0,TJK,181,181,6,2,4,0.011049724,0.03314917,0.022099448
2012.0,TJK,201,201,2,4,-2,0.019900497,0.0099502485,-0.0099502485
2013.0,TJK,217,217,12,7,5,0.032258064,0.05529954,0.023041476
2014.0,TJK,242,242,8,14,-6,0.05785124,0.03305785,-0.024793388
2015.0,TJK,270,270,15,7,8,0.025925925,0.055555556,0.02962963
2016.0,TJK,282,282,4,10,-6,0.035460994,0.014184397,-0.021276595
2017.0,TJK,317,317,9,9,0,0.028391168,0.028391168,0.0
2018.0,TJK,365,365,14,5,9,0.01369863,0.038356163,0.024657534
2019.0,TJK,392,392,14,8,6,0.020408163,0.035714287,0.015306123
2020.0,TJK,398,398,18,5,13,0.012562814,0.04522613,0.032663316
2021.0,TJK,376,376,8,12,-4,0.031914894,0.021276595,-0.010638298
2022.0,TJK,0,0,10,5,5,,,
2004.0,TKL,1,1,0,0,0,0.0,0.0,0.0
2009.0,TKL,2,2,0,0,0,0.0,0.0,0.0
1996.0,TKM,13,13,0,0,0,0.0,0.0,0.0
1997.0,TKM,15,15,2,0,2,0.0,0.13333334,0.13333334
1998.0,TKM,16,16,0,2,-2,0.125,0.0,-0.125
2000.0,TKM,16,16,2,0,2,0.0,0.125,0.125
2001.0,TKM,14,14,0,1,-1,0.071428575,0.0,-0.071428575
2002.0,TKM,15,15,1,2,-1,0.13333334,0.06666667,-0.06666667
2004.0,TKM,11,11,0,0,0,0.0,0.0,0.0
2006.0,TKM,12,12,0,0,0,0.0,0.0,0.0
2007.0,TKM,15,15,0,0,0,0.0,0.0,0.0
2008.0,TKM,19,19,0,0,0,0.0,0.0,0.0
2009.0,TKM,18,18,0,0,0,0.0,0.0,0.0
2010.0,TKM,18,18,1,3,-2,0.16666667,0.055555556,-0.11111111
2011.0,TKM,23,23,2,0,2,0.0,0.08695652,0.08695652
2012.0,TKM,27,27,0,0,0,0.0,0.0,0.0
2013.0,TKM,23,23,0,3,-3,0.13043478,0.0,-0.13043478
2014.0,TKM,24,24,3,0,3,0.0,0.125,0.125
2015.0,TKM,13,13,0,4,-4,0.30769232,0.0,-0.30769232
2018.0,TKM,14,14,0,2,-2,0.14285715,0.0,-0.14285715
2019.0,TKM,14,14,1,3,-2,0.21428572,0.071428575,-0.14285715
2020.0,TKM,18,18,0,1,-1,0.055555556,0.0,-0.055555556
2021.0,TKM,16,16,0,1,-1,0.0625,0.0,-0.0625
2022.0,TKM,0,0,1,0,1,,,
2006.0,TLS,8,8,1,0,1,0.0,0.125,0.125
2007.0,TLS,10,10,0,1,-1,0.1,0.0,-0.1
2008.0,TLS,13,13,1,1,0,0.07692308,0.07692308,0.0
2009.0,TLS,11,11,1,2,-1,0.18181819,0.09090909,-0.09090909
2010.0,TLS,15,15,1,3,-2,0.2,0.06666667,-0.13333334
2012.0,TLS,35,35,2,1,1,0.028571429,0.057142857,0.028571429
2013.0,TLS,40,40,5,2,3,0.05,0.125,0.075
2014.0,TLS,52,52,9,3,6,0.057692308,0.17307693,0.115384616
2015.0,TLS,53,53,2,4,-2,0.0754717,0.03773585,-0.03773585
2016.0,TLS,56,56,0,3,-3,0.05357143,0.0,-0.05357143
2017.0,TLS,64,64,11,1,10,0.015625,0.171875,0.15625
2018.0,TLS,72,72,4,0,4,0.0,0.055555556,0.055555556
2019.0,TLS,80,80,5,5,0,0.0625,0.0625,0.0
2020.0,TLS,89,89,5,5,0,0.056179777,0.056179777,0.0
2021.0,TLS,90,90,9,2,7,0.022222223,0.1,0.07777778
2022.0,TLS,0,0,8,3,5,,,
1997.0,TON,4,4,0,0,0,0.0,0.0,0.0
1998.0,TON,4,4,0,1,-1,0.25,0.0,-0.25
1999.0,TON,6,6,0,0,0,0.0,0.0,0.0
2000.0,TON,8,8,0,1,-1,0.125,0.0,-0.125
2001.0,TON,8,8,0,0,0,0.0,0.0,0.0
2002.0,TON,10,10,0,2,-2,0.2,0.0,-0.2
2003.0,TON,10,10,1,0,1,0.0,0.1,0.1
2004.0,TON,12,12,0,1,-1,0.083333336,0.0,-0.083333336
2006.0,TON,14,14,3,1,2,0.071428575,0.21428572,0.14285715
2007.0,TON,15,15,1,0,1,0.0,0.06666667,0.06666667
2009.0,TON,17,17,3,0,3,0.0,0.1764706,0.1764706
2010.0,TON,16,16,1,2,-1,0.125,0.0625,-0.0625
2011.0,TON,19,19,1,0,1,0.0,0.05263158,0.05263158
2012.0,TON,17,17,0,0,0,0.0,0.0,0.0
2013.0,TON,20,20,0,0,0,0.0,0.0,0.0
2014.0,TON,18,18,2,3,-1,0.16666667,0.11111111,-0.055555556
2015.0,TON,25,25,2,2,0,0.08,0.08,0.0
2016.0,TON,26,26,1,2,-1,0.07692308,0.03846154,-0.03846154
2017.0,TON,29,29,2,1,1,0.03448276,0.06896552,0.03448276
2018.0,TON,28,28,3,3,0,0.10714286,0.10714286,0.0
2019.0,TON,35,35,6,2,4,0.057142857,0.17142858,0.114285715
2021.0,TON,32,32,2,2,0,0.0625,0.0625,0.0
1996.0,TTO,209,209,0,0,0,0.0,0.0,0.0
1997.0,TTO,246,246,9,7,2,0.028455285,0.036585364,0.008130081
1998.0,TTO,284,284,10,21,-11,0.07394366,0.03521127,-0.038732395
1999.0,TTO,328,328,18,11,7,0.033536587,0.05487805,0.021341464
2000.0,TTO,349,349,14,14,0,0.04011461,0.04011461,0.0
2001.0,TTO,395,395,23,17,6,0.043037973,0.05822785,0.015189873
2002.0,TTO,417,417,23,18,5,0.043165468,0.055155877,0.0119904075
2003.0,TTO,453,453,30,24,6,0.052980132,0.06622516,0.013245033
2004.0,TTO,474,474,21,20,1,0.042194095,0.044303797,0.0021097045
2005.0,TTO,516,516,21,10,11,0.019379845,0.040697675,0.02131783
2006.0,TTO,559,559,33,16,17,0.02862254,0.05903399,0.030411448
2007.0,TTO,619,619,19,11,8,0.017770598,0.03069467,0.012924071
2008.0,TTO,652,652,43,26,17,0.0398773,0.06595092,0.02607362
2009.0,TTO,732,732,49,29,20,0.039617486,0.06693989,0.027322404
2010.0,TTO,758,758,51,39,12,0.051451188,0.06728232,0.015831135
2011.0,TTO,754,754,39,58,-19,0.07692308,0.05172414,-0.025198938
2012.0,TTO,784,784,35,42,-7,0.05357143,0.04464286,-0.008928572
2013.0,TTO,767,767,26,43,-17,0.056062583,0.033898305,-0.022164276
2014.0,TTO,759,759,31,44,-13,0.057971016,0.040843215,-0.017127799
2015.0,TTO,808,808,47,43,4,0.05321782,0.058168318,0.004950495
2016.0,TTO,836,836,42,34,8,0.040669855,0.050239235,0.009569378
2017.0,TTO,894,894,59,38,21,0.042505592,0.06599553,0.023489933
2018.0,TTO,944,944,36,38,-2,0.04025424,0.038135592,-0.002118644
2019.0,TTO,967,967,47,42,5,0.043433297,0.04860393,0.0051706308
2020.0,TTO,930,930,34,43,-9,0.04623656,0.03655914,-0.009677419
2021.0,TTO,879,879,28,45,-17,0.051194537,0.03185438,-0.01934016
2022.0,TTO,0,0,19,17,2,,,
1996.0,TUN,1850,1850,0,0,0,0.0,0.0,0.0
1997.0,TUN,2287,2287,40,29,11,0.012680368,0.017490162,0.0048097945
1998.0,TUN,2779,2779,56,36,20,0.0129543,0.020151133,0.0071968334
1999.0,TUN,3236,3236,79,42,37,0.012978987,0.024412856,0.011433869
2000.0,TUN,3748,3748,90,39,51,0.01040555,0.024012808,0.013607257
2001.0,TUN,4241,4241,98,69,29,0.016269747,0.023107758,0.0068380097
2002.0,TUN,4908,4908,112,68,44,0.013854931,0.022819886,0.008964955
2003.0,TUN,5710,5710,121,51,70,0.008931699,0.021190893,0.012259195
2004.0,TUN,6616,6616,117,52,65,0.007859734,0.017684402,0.009824667
2005.0,TUN,7541,7541,118,77,41,0.0102108475,0.015647791,0.005436945
2006.0,TUN,8548,8548,128,84,44,0.00982686,0.014974263,0.005147403
2007.0,TUN,9558,9558,141,96,45,0.010043942,0.014752041,0.004708098
2008.0,TUN,10577,10577,172,108,64,0.010210834,0.0162617,0.006050865
2009.0,TUN,11462,11462,164,161,3,0.014046414,0.014308149,0.0002617344
2010.0,TUN,12235,12235,182,170,12,0.0138945645,0.014875358,0.0009807928
2011.0,TUN,13079,13079,202,186,16,0.014221271,0.015444606,0.0012233352
2012.0,TUN,13973,13973,198,166,32,0.011880054,0.014170186,0.002290131
2013.0,TUN,14912,14912,208,189,19,0.012674356,0.013948498,0.0012741416
2014.0,TUN,15766,15766,225,241,-16,0.015286058,0.0142712165,-0.0010148421
2015.0,TUN,16633,16633,212,278,-66,0.016713763,0.012745746,-0.0039680153
2016.0,TUN,17416,17416,286,319,-33,0.01831649,0.016421681,-0.0018948094
2017.0,TUN,18165,18165,351,308,43,0.016955685,0.019322874,0.0023671896
2018.0,TUN,18641,18641,286,339,-53,0.01818572,0.015342524,-0.002843195
2019.0,TUN,18717,18717,239,449,-210,0.023988888,0.01276914,-0.011219746
2020.0,TUN,18515,18515,268,440,-172,0.023764515,0.0144747505,-0.009289765
2021.0,TUN,17676,17676,269,373,-104,0.02110206,0.015218375,-0.005883684
2022.0,TUN,0,0,193,294,-101,,,
2023.0,TUN,0,0,131,200,-69,,,
1996.0,TUR,15211,15211,0,0,0,0.0,0.0,0.0
1997.0,TUR,18486,18486,160,130,30,0.007032349,0.008655199,0.0016228497
1998.0,TUR,21710,21710,232,162,70,0.007461999,0.010686319,0.0032243205
1999.0,TUR,24338,24338,257,241,16,0.009902211,0.0105596185,0.00065740815
2000.0,TUR,28052,28052,354,294,60,0.010480536,0.012619421,0.002138885
2001.0,TUR,32460,32460,386,296,90,0.009118916,0.011891559,0.0027726432
2002.0,TUR,37200,37200,450,311,139,0.008360215,0.012096774,0.003736559
2003.0,TUR,42623,42623,435,331,104,0.00776576,0.010205758,0.0024399972
2004.0,TUR,47819,47819,397,332,65,0.006942847,0.008302139,0.0013592923
2005.0,TUR,52753,52753,434,375,59,0.0071086003,0.0082270205,0.0011184198
2006.0,TUR,57761,57761,438,377,61,0.0065268953,0.0075829714,0.0010560759
2007.0,TUR,63368,63368,457,410,47,0.006470143,0.007211842,0.0007416993
2008.0,TUR,68709,68709,430,436,-6,0.0063456027,0.0062582777,-8.732481e-05
2009.0,TUR,74339,74339,516,461,55,0.006201321,0.006941175,0.0007398539
2010.0,TUR,79603,79603,572,555,17,0.006972099,0.007185659,0.00021355979
2011.0,TUR,85639,85639,640,602,38,0.007029508,0.007473231,0.00044372308
2012.0,TUR,91402,91402,649,571,78,0.006247128,0.007100501,0.000853373
2013.0,TUR,96906,96906,682,674,8,0.006955194,0.007037748,8.255423e-05
2014.0,TUR,102172,102172,818,662,156,0.0064792703,0.008006107,0.0015268371
2015.0,TUR,106445,106445,829,703,126,0.0066043497,0.00778806,0.00118371
2016.0,TUR,110520,110520,821,935,-114,0.008460008,0.00742852,-0.0010314875
2017.0,TUR,114993,114993,859,1146,-287,0.009965824,0.00747002,-0.002495804
2018.0,TUR,119262,119262,941,1225,-284,0.010271503,0.007890191,-0.0023813117
2019.0,TUR,122500,122500,955,1256,-301,0.010253062,0.0077959183,-0.0024571428
2020.0,TUR,124081,124081,971,1378,-407,0.011105649,0.007825533,-0.0032801153
2021.0,TUR,120612,120612,1013,1374,-361,0.011391901,0.008398833,-0.0029930687
2022.0,TUR,0,0,808,1144,-336,,,
2023.0,TUR,0,0,537,779,-242,,,
2002.0,TUV,2,2,0,0,0,0.0,0.0,0.0
2003.0,TUV,2,2,0,0,0,0.0,0.0,0.0
2012.0,TUV,2,2,0,0,0,0.0,0.0,0.0
2013.0,TUV,2,2,0,0,0,0.0,0.0,0.0
2017.0,TUV,6,6,1,1,0,0.16666667,0.16666667,0.0
2018.0,TUV,7,7,1,0,1,0.0,0.14285715,0.14285715
2022.0,TUV,0,0,0,0,0,,,
1996.0,TWN,17670,17670,0,0,0,0.0,0.0,0.0
1997.0,TWN,21423,21423,356,206,150,0.009615834,0.016617654,0.0070018205
1998.0,TWN,25200,25200,449,242,207,0.009603174,0.01781746,0.008214286
1999.0,TWN,28702,28702,434,286,148,0.009964462,0.015120897,0.005156435
2000.0,TWN,31821,31821,524,289,235,0.009082053,0.016467113,0.00738506
2001.0,TWN,34819,34819,557,423,134,0.01214854,0.015997013,0.0038484735
2002.0,TWN,38554,38554,632,492,140,0.012761322,0.016392592,0.0036312705
2003.0,TWN,42853,42853,654,425,229,0.009917625,0.015261475,0.00534385
2004.0,TWN,47907,47907,578,398,180,0.008307763,0.012065043,0.0037572798
2005.0,TWN,53030,53030,572,366,206,0.0069017536,0.010786347,0.0038845937
2006.0,TWN,58631,58631,671,411,260,0.0070099435,0.011444458,0.0044345143
2007.0,TWN,64113,64113,653,452,201,0.0070500523,0.010185142,0.0031350895
2008.0,TWN,69594,69594,661,534,127,0.0076730754,0.009497945,0.00182487
2009.0,TWN,74832,74832,817,597,220,0.00797787,0.010917789,0.0029399188
2010.0,TWN,79646,79646,870,701,169,0.008801446,0.010923335,0.0021218893
2011.0,TWN,83558,83558,828,801,27,0.009586155,0.009909284,0.00032312886
2012.0,TWN,86536,86536,727,751,-24,0.008678469,0.0084011275,-0.00027734123
2013.0,TWN,88584,88584,768,712,56,0.008037569,0.008669737,0.0006321683
2014.0,TWN,89557,89557,778,877,-99,0.009792646,0.008687205,-0.0011054412
2015.0,TWN,89629,89629,772,952,-180,0.010621563,0.008613284,-0.0020082786
2016.0,TWN,88769,88769,802,956,-154,0.010769526,0.009034686,-0.0017348399
2017.0,TWN,87927,87927,742,1067,-325,0.012135067,0.008438818,-0.003696248
2018.0,TWN,88196,88196,874,1157,-283,0.013118509,0.009909746,-0.0032087623
2019.0,TWN,88784,88784,897,1224,-327,0.0137862675,0.010103172,-0.003683096
2020.0,TWN,87729,87729,1029,1141,-112,0.013005962,0.011729303,-0.0012766588
2021.0,TWN,82498,82498,1071,1117,-46,0.013539722,0.012982133,-0.0005575893
2022.0,TWN,0,0,875,945,-70,,,
2023.0,TWN,0,0,540,647,-107,,,
1996.0,TZA,435,435,0,0,0,0.0,0.0,0.0
1997.0,TZA,546,546,29,13,16,0.023809524,0.053113554,0.02930403
1998.0,TZA,622,622,30,26,4,0.041800644,0.048231512,0.006430868
1999.0,TZA,663,663,36,44,-8,0.06636501,0.054298643,-0.012066365
2000.0,TZA,672,672,36,48,-12,0.071428575,0.05357143,-0.017857144
2001.0,TZA,737,737,44,33,11,0.04477612,0.05970149,0.014925373
2002.0,TZA,819,819,44,46,-2,0.056166057,0.053724054,-0.0024420025
2003.0,TZA,942,942,63,24,39,0.025477707,0.06687898,0.041401275
2004.0,TZA,1118,1118,44,34,10,0.030411448,0.039355993,0.008944544
2005.0,TZA,1291,1291,60,26,34,0.020139426,0.0464756,0.026336173
2006.0,TZA,1413,1413,50,28,22,0.019815994,0.035385706,0.01556971
2007.0,TZA,1496,1496,47,44,3,0.029411765,0.031417113,0.0020053475
2008.0,TZA,1654,1654,53,51,2,0.030834341,0.03204353,0.0012091899
2009.0,TZA,1816,1816,67,52,15,0.028634362,0.036894273,0.008259912
2010.0,TZA,1965,1965,85,54,31,0.027480915,0.043256998,0.015776081
2011.0,TZA,2107,2107,69,58,11,0.02752729,0.032747984,0.005220693
2012.0,TZA,2400,2400,91,67,24,0.027916666,0.037916668,0.01
2013.0,TZA,2642,2642,106,81,25,0.030658592,0.04012112,0.009462528
2014.0,TZA,2911,2911,133,68,65,0.02335967,0.045688767,0.022329096
2015.0,TZA,3187,3187,132,92,40,0.028867273,0.04141826,0.012550988
2016.0,TZA,3461,3461,135,84,51,0.024270441,0.03900607,0.014735625
2017.0,TZA,3769,3769,147,100,47,0.026532236,0.03900239,0.012470151
2018.0,TZA,4101,4101,123,95,28,0.023165083,0.029992685,0.006827603
2019.0,TZA,4356,4356,143,147,-4,0.033746555,0.032828283,-0.00091827364
2020.0,TZA,4544,4544,161,137,24,0.030149648,0.035431337,0.00528169
2021.0,TZA,4523,4523,195,127,68,0.028078709,0.04311298,0.01503427
2022.0,TZA,0,0,161,95,66,,,
2023.0,TZA,0,0,74,84,-10,,,
1996.0,UGA,276,276,0,0,0,0.0,0.0,0.0
1997.0,UGA,355,355,13,15,-2,0.04225352,0.03661972,-0.0056338026
1998.0,UGA,445,445,22,14,8,0.031460673,0.0494382,0.017977528
1999.0,UGA,522,522,27,13,14,0.024904214,0.05172414,0.026819924
2000.0,UGA,580,580,17,27,-10,0.046551723,0.029310346,-0.01724138
2001.0,UGA,651,651,35,34,1,0.052227344,0.05376344,0.0015360983
2002.0,UGA,742,742,44,32,12,0.043126684,0.05929919,0.016172506
2003.0,UGA,845,845,56,28,28,0.033136096,0.06627219,0.033136096
2004.0,UGA,968,968,35,27,8,0.027892562,0.036157023,0.008264462
2005.0,UGA,1119,1119,44,41,3,0.036639858,0.039320823,0.0026809652
2006.0,UGA,1308,1308,40,24,16,0.018348623,0.03058104,0.012232416
2007.0,UGA,1492,1492,52,50,2,0.033512063,0.034852546,0.0013404826
2008.0,UGA,1721,1721,72,47,25,0.027309705,0.041836143,0.014526438
2009.0,UGA,1986,1986,58,45,13,0.02265861,0.029204432,0.0065458207
2010.0,UGA,2280,2280,73,57,16,0.025,0.032017544,0.007017544
2011.0,UGA,2572,2572,74,70,4,0.027216174,0.028771384,0.00155521
2012.0,UGA,2875,2875,95,82,13,0.028521739,0.033043478,0.004521739
2013.0,UGA,3137,3137,82,95,-13,0.03028371,0.026139624,-0.0041440865
2014.0,UGA,3323,3323,98,116,-18,0.034908216,0.029491423,-0.005416792
2015.0,UGA,3594,3594,108,99,9,0.02754591,0.030050084,0.0025041737
2016.0,UGA,3922,3922,145,163,-18,0.04156043,0.036970932,-0.0045894952
2017.0,UGA,4252,4252,141,127,14,0.029868297,0.033160865,0.0032925683
2018.0,UGA,4780,4780,156,142,14,0.029707113,0.032635983,0.0029288703
2019.0,UGA,5284,5284,160,125,35,0.023656322,0.03028009,0.0066237696
2020.0,UGA,5534,5534,177,128,49,0.023129743,0.0319841,0.008854355
2021.0,UGA,5488,5488,174,162,12,0.02951895,0.03170554,0.002186589
2022.0,UGA,0,0,156,153,3,,,
1996.0,UKR,10852,10852,0,0,0,0.0,0.0,0.0
1997.0,UKR,12574,12574,194,229,-35,0.018212184,0.015428662,-0.0027835215
1998.0,UKR,13932,13932,207,253,-46,0.018159632,0.014857881,-0.0033017513
1999.0,UKR,14649,14649,182,329,-147,0.022458872,0.012424056,-0.0100348145
2000.0,UKR,14840,14840,182,380,-198,0.025606468,0.012264151,-0.013342318
2001.0,UKR,14845,14845,210,330,-120,0.022229707,0.014146177,-0.00808353
2002.0,UKR,14856,14856,217,346,-129,0.023290252,0.014606893,-0.00868336
2003.0,UKR,14913,14913,220,309,-89,0.020720176,0.01475223,-0.0059679477
2004.0,UKR,14629,14629,180,240,-60,0.016405769,0.012304327,-0.004101442
2005.0,UKR,14637,14637,153,264,-111,0.018036483,0.010452962,-0.0075835213
2006.0,UKR,14953,14953,157,238,-81,0.01591654,0.010499565,-0.005416973
2007.0,UKR,15604,15604,194,216,-22,0.013842604,0.012432709,-0.0014098949
2008.0,UKR,16218,16218,214,240,-26,0.014798372,0.013195215,-0.001603157
2009.0,UKR,16963,16963,181,303,-122,0.017862406,0.010670282,-0.007192124
2010.0,UKR,18005,18005,243,312,-69,0.01732852,0.013496251,-0.0038322688
2011.0,UKR,19509,19509,284,226,58,0.011584397,0.014557384,0.0029729868
2012.0,UKR,21265,21265,207,245,-38,0.011521279,0.009734306,-0.0017869739
2013.0,UKR,22974,22974,198,277,-79,0.012057108,0.008618439,-0.0034386697
2014.0,UKR,24993,24993,199,408,-209,0.01632457,0.00796223,-0.008362342
2015.0,UKR,27273,27273,188,473,-285,0.01734316,0.0068932646,-0.010449896
2016.0,UKR,30303,30303,205,482,-277,0.015906015,0.0067650066,-0.009141009
2017.0,UKR,35525,35525,228,450,-222,0.012667136,0.0064180153,-0.0062491205
2018.0,UKR,39792,39792,285,379,-94,0.009524528,0.0071622436,-0.0023622839
2019.0,UKR,42374,42374,242,374,-132,0.008826167,0.0057110493,-0.0031151178
2020.0,UKR,43195,43195,257,384,-127,0.008889918,0.0059497626,-0.002940155
2021.0,UKR,41756,41756,246,346,-100,0.008286234,0.0058913687,-0.0023948655
2022.0,UKR,0,0,183,362,-179,,,
2023.0,UKR,0,0,121,302,-181,,,
1996.0,URY,627,627,0,0,0,0.0,0.0,0.0
1997.0,URY,768,768,27,15,12,0.01953125,0.03515625,0.015625
1998.0,URY,886,886,25,29,-4,0.032731377,0.028216705,-0.004514673
1999.0,URY,1010,1010,26,29,-3,0.02871287,0.025742574,-0.0029702971
2000.0,URY,1107,1107,38,31,7,0.028003613,0.03432701,0.0063233967
2001.0,URY,1226,1226,56,38,18,0.030995106,0.045677,0.0146818925
2002.0,URY,1302,1302,40,54,-14,0.041474655,0.030721966,-0.010752688
2003.0,URY,1380,1380,45,49,-4,0.035507247,0.032608695,-0.0028985508
2004.0,URY,1481,1481,37,39,-2,0.02633356,0.02498312,-0.0013504389
2005.0,URY,1565,1565,40,44,-4,0.028115015,0.025559105,-0.0025559105
2006.0,URY,1729,1729,45,48,-3,0.027761713,0.026026605,-0.001735107
2007.0,URY,1912,1912,42,46,-4,0.024058577,0.021966526,-0.0020920502
2008.0,URY,2094,2094,49,47,2,0.02244508,0.023400191,0.00095510983
2009.0,URY,2313,2313,53,60,-7,0.025940338,0.022913964,-0.0030263728
2010.0,URY,2490,2490,56,44,12,0.017670684,0.02248996,0.004819277
2011.0,URY,2650,2650,50,48,2,0.018113207,0.018867925,0.000754717
2012.0,URY,2862,2862,74,57,17,0.019916143,0.025856044,0.0059399023
2013.0,URY,3030,3030,62,72,-10,0.023762377,0.020462045,-0.0033003301
2014.0,URY,3258,3258,88,49,39,0.015039902,0.027010435,0.011970534
2015.0,URY,3451,3451,91,62,29,0.017965807,0.026369167,0.008403362
2016.0,URY,3701,3701,93,69,24,0.01864361,0.025128344,0.006484734
2017.0,URY,3838,3838,101,74,27,0.019280875,0.02631579,0.007034914
2018.0,URY,4071,4071,94,64,30,0.015720952,0.02309015,0.007369197
2019.0,URY,4190,4190,92,79,13,0.018854415,0.02195704,0.0031026253
2020.0,URY,4259,4259,129,75,54,0.017609768,0.0302888,0.012679033
2021.0,URY,4149,4149,113,71,42,0.017112557,0.027235478,0.010122921
2022.0,URY,0,0,73,60,13,,,
1996.0,USA,538303,538303,0,0,0,0.0,0.0,0.0
1997.0,USA,616846,616846,8875,9226,-351,0.014956731,0.014387708,-0.0005690237
1998.0,USA,692451,692451,11501,10403,1098,0.015023446,0.016609117,0.0015856718
1999.0,USA,744670,744670,13178,10912,2266,0.01465347,0.017696429,0.0030429587
2000.0,USA,787187,787187,15100,12051,3049,0.015308942,0.019182228,0.0038732856
2001.0,USA,821701,821701,17046,13770,3276,0.01675792,0.020744773,0.003986852
2002.0,USA,858712,858712,17770,15261,2509,0.017771965,0.020693783,0.0029218178
2003.0,USA,892573,892573,16638,15607,1031,0.017485404,0.018640492,0.0011550876
2004.0,USA,928492,928492,15192,14013,1179,0.015092214,0.016362015,0.0012698009
2005.0,USA,961166,961166,14775,14191,584,0.014764359,0.015371954,0.0006075954
2006.0,USA,1000413,1000413,15145,14881,264,0.014874857,0.015138748,0.000263891
2007.0,USA,1042233,1042233,15570,15406,164,0.014781724,0.014939078,0.00015735444
2008.0,USA,1084259,1084259,16622,16049,573,0.014801814,0.015330286,0.00052847154
2009.0,USA,1128212,1128212,17628,16734,894,0.014832319,0.015624723,0.0007924043
2010.0,USA,1170963,1170963,18517,18175,342,0.015521413,0.01581348,0.0002920673
2011.0,USA,1213560,1213560,19065,19097,-32,0.015736345,0.015709978,-2.63687e-05
2012.0,USA,1254862,1254862,19422,19480,-58,0.015523619,0.015477399,-4.6220222e-05
2013.0,USA,1300121,1300121,20565,19879,686,0.015290115,0.015817758,0.0005276432
2014.0,USA,1339874,1339874,21450,20685,765,0.015438018,0.016008968,0.0005709492
2015.0,USA,1378251,1378251,22177,21214,963,0.015391971,0.016090684,0.0006987116
2016.0,USA,1414582,1414582,23346,21553,1793,0.015236303,0.016503815,0.0012675122
2017.0,USA,1448410,1448410,24443,21600,2843,0.014912904,0.016875746,0.001962842
2018.0,USA,1481431,1481431,24990,22652,2338,0.015290621,0.016868824,0.0015782038
2019.0,USA,1502514,1502514,24985,23205,1780,0.015444116,0.016628796,0.0011846812
2020.0,USA,1486847,1486847,24932,23310,1622,0.01567747,0.01676837,0.0010908991
2021.0,USA,1412938,1412938,23274,22269,1005,0.015760776,0.01647206,0.0007112839
2022.0,USA,0,0,19112,19062,50,,,
2023.0,USA,0,0,13123,11147,1976,,,
1996.0,UZB,857,857,0,0,0,0.0,0.0,0.0
1997.0,UZB,989,989,18,14,4,0.014155713,0.018200202,0.0040444895
1998.0,UZB,1115,1115,13,21,-8,0.01883408,0.011659193,-0.0071748877
1999.0,UZB,1202,1202,18,18,0,0.014975041,0.014975041,0.0
2000.0,UZB,1202,1202,18,39,-21,0.032445922,0.014975041,-0.017470881
2001.0,UZB,1210,1210,21,41,-20,0.033884298,0.017355371,-0.016528925
2002.0,UZB,1231,1231,31,36,-5,0.029244516,0.025182778,-0.0040617385
2003.0,UZB,1243,1243,18,20,-2,0.016090104,0.014481094,-0.0016090105
2004.0,UZB,1210,1210,16,24,-8,0.01983471,0.0132231405,-0.0066115703
2005.0,UZB,1192,1192,14,33,-19,0.027684564,0.011744967,-0.015939597
2006.0,UZB,1208,1208,33,28,5,0.023178808,0.027317882,0.0041390727
2007.0,UZB,1200,1200,24,36,-12,0.03,0.02,-0.01
2008.0,UZB,1242,1242,23,22,1,0.017713366,0.018518519,0.000805153
2009.0,UZB,1338,1338,28,39,-11,0.029147983,0.020926757,-0.008221226
2010.0,UZB,1357,1357,24,33,-9,0.024318349,0.017686073,-0.0066322773
2011.0,UZB,1427,1427,20,34,-14,0.023826208,0.014015417,-0.009810792
2012.0,UZB,1474,1474,24,26,-2,0.017639078,0.016282225,-0.0013568521
2013.0,UZB,1507,1507,25,32,-7,0.02123424,0.01658925,-0.00464499
2014.0,UZB,1502,1502,23,24,-1,0.015978696,0.015312916,-0.00066577893
2015.0,UZB,1543,1543,23,34,-11,0.022034997,0.014906027,-0.0071289698
2016.0,UZB,1536,1536,25,31,-6,0.020182291,0.016276041,-0.00390625
2017.0,UZB,1911,1911,23,41,-18,0.021454737,0.012035583,-0.0094191525
2018.0,UZB,2458,2458,42,43,-1,0.017493898,0.017087063,-0.00040683482
2019.0,UZB,2776,2776,51,21,30,0.0075648413,0.018371757,0.010806916
2020.0,UZB,3094,3094,87,19,68,0.006140918,0.02811894,0.021978023
2021.0,UZB,3120,3120,73,36,37,0.011538462,0.023397436,0.011858975
2022.0,UZB,0,0,70,32,38,,,
2023.0,UZB,0,0,44,19,25,,,
2012.0,VAT,4,4,1,1,0,0.25,0.25,0.0
2017.0,VAT,7,7,4,0,4,0.0,0.5714286,0.5714286
2021.0,VAT,5,5,1,0,1,0.0,0.2,0.2
1996.0,VCT,2,2,0,0,0,0.0,0.0,0.0
1997.0,VCT,3,3,1,0,1,0.0,0.33333334,0.33333334
2002.0,VCT,4,4,2,0,2,0.0,0.5,0.5
2003.0,VCT,4,4,0,0,0,0.0,0.0,0.0
2007.0,VCT,3,3,2,1,1,0.33333334,0.6666667,0.33333334
2010.0,VCT,3,3,1,1,0,0.33333334,0.33333334,0.0
2013.0,VCT,11,11,2,1,1,0.09090909,0.18181819,0.09090909
2015.0,VCT,10,10,2,1,1,0.1,0.2,0.1
2016.0,VCT,10,10,1,0,1,0.0,0.1,0.1
2018.0,VCT,18,18,2,0,2,0.0,0.11111111,0.11111111
2019.0,VCT,18,18,1,0,1,0.0,0.055555556,0.055555556
2020.0,VCT,21,21,3,3,0,0.14285715,0.14285715,0.0
2021.0,VCT,20,20,4,4,0,0.2,0.2,0.0
2022.0,VCT,0,0,2,2,0,,,
1996.0,VEN,2200,2200,0,0,0,0.0,0.0,0.0
1997.0,VEN,2701,2701,57,58,-1,0.021473529,0.021103295,-0.00037023326
1998.0,VEN,3277,3277,94,72,22,0.021971315,0.028684773,0.0067134574
1999.0,VEN,3662,3662,113,85,28,0.02321136,0.030857455,0.007646095
2000.0,VEN,3946,3946,85,109,-24,0.027622908,0.0215408,-0.0060821082
2001.0,VEN,4231,4231,128,137,-9,0.032380052,0.030252894,-0.0021271566
2002.0,VEN,4513,4513,107,134,-27,0.029692002,0.023709284,-0.0059827166
2003.0,VEN,4780,4780,153,102,51,0.021338912,0.03200837,0.010669456
2004.0,VEN,5052,5052,107,130,-23,0.025732383,0.02117973,-0.0045526526
2005.0,VEN,5496,5496,118,111,7,0.020196507,0.02147016,0.0012736536
2006.0,VEN,6051,6051,126,122,4,0.020161957,0.020823004,0.00066104776
2007.0,VEN,6465,6465,118,142,-24,0.021964423,0.018252127,-0.003712297
2008.0,VEN,6685,6685,111,126,-15,0.018848168,0.016604338,-0.0022438294
2009.0,VEN,6859,6859,131,153,-22,0.022306459,0.019098993,-0.0032074647
2010.0,VEN,6879,6879,126,179,-53,0.026021224,0.018316615,-0.007704608
2011.0,VEN,6719,6719,104,171,-67,0.025450217,0.015478494,-0.009971722
2012.0,VEN,6414,6414,98,167,-69,0.026036795,0.015279077,-0.010757717
2013.0,VEN,6176,6176,102,184,-82,0.029792747,0.016515544,-0.013277202
2014.0,VEN,5958,5958,108,164,-56,0.027526015,0.018126888,-0.009399127
2015.0,VEN,5658,5658,85,206,-121,0.036408626,0.015022976,-0.02138565
2016.0,VEN,5267,5267,95,223,-128,0.042339094,0.018036833,-0.02430226
2017.0,VEN,4838,4838,95,241,-146,0.04981397,0.019636214,-0.030177759
2018.0,VEN,4452,4452,74,251,-177,0.056379154,0.016621742,-0.039757412
2019.0,VEN,4105,4105,81,249,-168,0.060657736,0.019732034,-0.0409257
2020.0,VEN,3620,3620,81,215,-134,0.059392266,0.02237569,-0.037016574
2021.0,VEN,3183,3183,73,152,-79,0.04775369,0.022934338,-0.024819354
2022.0,VEN,0,0,47,112,-65,,,
1997.0,VGB,2,2,0,0,0,0.0,0.0,0.0
1998.0,VGB,2,2,0,0,0,0.0,0.0,0.0
2001.0,VGB,2,2,0,1,-1,0.5,0.0,-0.5
2004.0,VGB,6,6,0,0,0,0.0,0.0,0.0
2005.0,VGB,9,9,0,0,0,0.0,0.0,0.0
2006.0,VGB,8,8,0,1,-1,0.125,0.0,-0.125
2007.0,VGB,7,7,0,0,0,0.0,0.0,0.0
2011.0,VGB,11,11,5,1,4,0.09090909,0.45454547,0.36363637
2013.0,VGB,6,6,0,2,-2,0.33333334,0.0,-0.33333334
2016.0,VGB,8,8,1,0,1,0.0,0.125,0.125
2018.0,VGB,8,8,1,2,-1,0.25,0.125,-0.125
2019.0,VGB,11,11,0,0,0,0.0,0.0,0.0
2021.0,VGB,16,16,1,0,1,0.0,0.0625,0.0625
1996.0,VIR,12,12,0,0,0,0.0,0.0,0.0
1997.0,VIR,16,16,2,0,2,0.0,0.125,0.125
1998.0,VIR,13,13,0,5,-5,0.3846154,0.0,-0.3846154
1999.0,VIR,11,11,1,3,-2,0.27272728,0.09090909,-0.18181819
2000.0,VIR,11,11,3,2,1,0.18181819,0.27272728,0.09090909
2003.0,VIR,16,16,3,3,0,0.1875,0.1875,0.0
2004.0,VIR,24,24,3,1,2,0.041666668,0.125,0.083333336
2005.0,VIR,22,22,2,3,-1,0.13636364,0.09090909,-0.045454547
2006.0,VIR,18,18,2,7,-5,0.3888889,0.11111111,-0.2777778
2008.0,VIR,23,23,6,4,2,0.17391305,0.26086956,0.08695652
2009.0,VIR,19,19,0,4,-4,0.21052632,0.0,-0.21052632
2010.0,VIR,14,14,1,6,-5,0.42857143,0.071428575,-0.35714287
2012.0,VIR,16,16,3,2,1,0.125,0.1875,0.0625
2014.0,VIR,14,14,3,2,1,0.14285715,0.21428572,0.071428575
2015.0,VIR,21,21,2,2,0,0.0952381,0.0952381,0.0
2016.0,VIR,20,20,3,5,-2,0.25,0.15,-0.1
2017.0,VIR,20,20,3,0,3,0.0,0.15,0.15
2018.0,VIR,20,20,6,7,-1,0.35,0.3,-0.05
2020.0,VIR,16,16,6,1,5,0.0625,0.375,0.3125
2021.0,VIR,27,27,13,2,11,0.074074075,0.4814815,0.4074074
1996.0,VNM,440,440,0,0,0,0.0,0.0,0.0
1997.0,VNM,569,569,29,12,17,0.02108963,0.05096661,0.029876977
1998.0,VNM,687,687,24,11,13,0.016011644,0.0349345,0.018922852
1999.0,VNM,790,790,34,29,5,0.03670886,0.043037973,0.006329114
2000.0,VNM,849,849,34,39,-5,0.045936394,0.040047113,-0.0058892816
2001.0,VNM,968,968,39,49,-10,0.050619833,0.040289257,-0.010330578
2002.0,VNM,1131,1131,68,52,16,0.04597701,0.060123783,0.014146773
2003.0,VNM,1298,1298,77,36,41,0.027734976,0.059322033,0.031587057
2004.0,VNM,1532,1532,58,40,18,0.02610966,0.037859008,0.011749348
2005.0,VNM,1737,1737,59,44,15,0.02533103,0.03396661,0.008635579
2006.0,VNM,2099,2099,90,42,48,0.020009529,0.042877562,0.022868032
2007.0,VNM,2453,2453,81,58,23,0.023644516,0.03302079,0.0093762735
2008.0,VNM,2912,2912,122,60,62,0.020604396,0.041895606,0.02129121
2009.0,VNM,3431,3431,124,84,40,0.024482658,0.036141068,0.011658409
2010.0,VNM,4127,4127,193,115,78,0.027865278,0.046765205,0.018899927
2011.0,VNM,4968,4968,249,86,163,0.017310789,0.050120775,0.032809984
2012.0,VNM,5806,5806,242,132,110,0.022735102,0.04168102,0.018945917
2013.0,VNM,6804,6804,298,140,158,0.020576132,0.043797765,0.023221634
2014.0,VNM,8028,8028,353,181,172,0.022546088,0.043971103,0.021425012
2015.0,VNM,9454,9454,407,192,215,0.020308863,0.04305056,0.022741696
2016.0,VNM,11442,11442,490,250,240,0.021849327,0.04282468,0.020975353
2017.0,VNM,14624,14624,621,240,381,0.016411379,0.042464443,0.026053064
2018.0,VNM,18446,18446,812,274,538,0.0148541685,0.044020385,0.029166214
2019.0,VNM,21515,21515,866,324,542,0.015059261,0.040250987,0.025191726
2020.0,VNM,23857,23857,943,389,554,0.016305488,0.03952718,0.023221696
2021.0,VNM,23797,23797,830,516,314,0.021683406,0.034878347,0.013194941
2022.0,VNM,0,0,585,416,169,,,
2023.0,VNM,0,0,380,258,122,,,
1996.0,VUT,10,10,0,0,0,0.0,0.0,0.0
1997.0,VUT,12,12,1,0,1,0.0,0.083333336,0.083333336
1998.0,VUT,17,17,0,1,-1,0.05882353,0.0,-0.05882353
1999.0,VUT,21,21,3,1,2,0.04761905,0.14285715,0.0952381
2000.0,VUT,22,22,1,0,1,0.0,0.045454547,0.045454547
2001.0,VUT,20,20,0,3,-3,0.15,0.0,-0.15
2002.0,VUT,24,24,0,2,-2,0.083333336,0.0,-0.083333336
2003.0,VUT,23,23,2,3,-1,0.13043478,0.08695652,-0.04347826
2004.0,VUT,27,27,2,2,0,0.074074075,0.074074075,0.0
2005.0,VUT,29,29,1,0,1,0.0,0.03448276,0.03448276
2006.0,VUT,24,24,0,7,-7,0.29166666,0.0,-0.29166666
2007.0,VUT,26,26,2,3,-1,0.115384616,0.07692308,-0.03846154
2008.0,VUT,29,29,0,2,-2,0.06896552,0.0,-0.06896552
2009.0,VUT,32,32,1,1,0,0.03125,0.03125,0.0
2010.0,VUT,35,35,3,0,3,0.0,0.08571429,0.08571429
2011.0,VUT,42,42,2,2,0,0.04761905,0.04761905,0.0
2012.0,VUT,49,49,4,2,2,0.040816326,0.08163265,0.040816326
2013.0,VUT,49,49,1,2,-1,0.040816326,0.020408163,-0.020408163
2014.0,VUT,55,55,5,3,2,0.054545455,0.09090909,0.036363635
2015.0,VUT,62,62,8,4,4,0.06451613,0.12903225,0.06451613
2016.0,VUT,68,68,3,6,-3,0.0882353,0.04411765,-0.04411765
2017.0,VUT,72,72,3,4,-1,0.055555556,0.041666668,-0.013888889
2018.0,VUT,72,72,6,5,1,0.06944445,0.083333336,0.013888889
2019.0,VUT,85,85,5,4,1,0.047058824,0.05882353,0.011764706
2020.0,VUT,87,87,3,4,-1,0.04597701,0.03448276,-0.011494253
2021.0,VUT,88,88,5,2,3,0.022727273,0.056818184,0.03409091
2022.0,VUT,0,0,2,1,1,,,
2005.0,WLF,2,2,0,0,0,0.0,0.0,0.0
2007.0,WLF,2,2,0,0,0,0.0,0.0,0.0
2011.0,WLF,5,5,0,1,-1,0.2,0.0,-0.2
2013.0,WLF,4,4,0,1,-1,0.25,0.0,-0.25
2015.0,WLF,3,3,0,1,-1,0.33333334,0.0,-0.33333334
1996.0,WSM,4,4,0,0,0,0.0,0.0,0.0
1997.0,WSM,11,11,4,0,4,0.0,0.36363637,0.36363637
1998.0,WSM,11,11,1,1,0,0.09090909,0.09090909,0.0
1999.0,WSM,16,16,1,1,0,0.0625,0.0625,0.0
2001.0,WSM,23,23,0,1,-1,0.04347826,0.0,-0.04347826
2002.0,WSM,21,21,1,1,0,0.04761905,0.04761905,0.0
2003.0,WSM,16,16,1,4,-3,0.25,0.0625,-0.1875
2004.0,WSM,15,15,1,6,-5,0.4,0.06666667,-0.33333334
2006.0,WSM,16,16,0,1,-1,0.0625,0.0,-0.0625
2007.0,WSM,13,13,0,3,-3,0.23076923,0.0,-0.23076923
2009.0,WSM,17,17,2,0,2,0.0,0.11764706,0.11764706
2011.0,WSM,18,18,2,3,-1,0.16666667,0.11111111,-0.055555556
2012.0,WSM,33,33,5,3,2,0.09090909,0.15151516,0.060606062
2013.0,WSM,43,43,4,3,1,0.069767445,0.093023255,0.023255814
2014.0,WSM,54,54,6,2,4,0.037037037,0.11111111,0.074074075
2015.0,WSM,57,57,4,2,2,0.03508772,0.07017544,0.03508772
2016.0,WSM,67,67,3,8,-5,0.11940298,0.04477612,-0.07462686
2017.0,WSM,75,75,5,2,3,0.026666667,0.06666667,0.04
2018.0,WSM,93,93,4,4,0,0.043010753,0.043010753,0.0
2019.0,WSM,102,102,3,3,0,0.029411765,0.029411765,0.0
2020.0,WSM,114,114,6,3,3,0.02631579,0.05263158,0.02631579
2021.0,WSM,112,112,9,9,0,0.08035714,0.08035714,0.0
2022.0,WSM,0,0,1,6,-5,,,
1996.0,YEM,65,65,0,0,0,0.0,0.0,0.0
1997.0,YEM,76,76,1,4,-3,0.05263158,0.013157895,-0.039473683
1998.0,YEM,92,92,6,4,2,0.04347826,0.06521739,0.02173913
1999.0,YEM,104,104,8,6,2,0.057692308,0.07692308,0.01923077
2000.0,YEM,97,97,6,11,-5,0.11340206,0.06185567,-0.05154639
2001.0,YEM,110,110,11,4,7,0.036363635,0.1,0.06363636
2002.0,YEM,125,125,6,6,0,0.048,0.048,0.0
2003.0,YEM,153,153,9,8,1,0.052287582,0.05882353,0.006535948
2004.0,YEM,166,166,6,5,1,0.030120483,0.036144577,0.006024096
2005.0,YEM,195,195,12,10,2,0.051282052,0.06153846,0.010256411
2006.0,YEM,222,222,10,9,1,0.04054054,0.045045044,0.0045045046
2007.0,YEM,247,247,15,9,6,0.036437247,0.060728744,0.024291499
2008.0,YEM,293,293,13,11,2,0.037542664,0.044368602,0.0068259384
2009.0,YEM,334,334,21,12,9,0.035928145,0.06287425,0.026946107
2010.0,YEM,383,383,26,16,10,0.041775458,0.067885116,0.02610966
2011.0,YEM,421,421,22,14,8,0.033254158,0.052256532,0.019002376
2012.0,YEM,482,482,38,22,16,0.045643155,0.07883818,0.033195022
2013.0,YEM,492,492,32,16,16,0.032520324,0.06504065,0.032520324
2014.0,YEM,506,506,27,22,5,0.04347826,0.053359684,0.009881423
2015.0,YEM,526,526,32,30,2,0.05703422,0.0608365,0.0038022813
2016.0,YEM,557,557,39,22,17,0.03949731,0.070017956,0.030520646
2017.0,YEM,580,580,47,28,19,0.048275862,0.08103448,0.03275862
2018.0,YEM,639,639,49,37,12,0.057902973,0.076682314,0.018779343
2019.0,YEM,739,739,77,34,43,0.046008117,0.10419486,0.05818674
2020.0,YEM,781,781,69,49,20,0.06274008,0.08834827,0.025608195
2021.0,YEM,796,796,88,51,37,0.06407035,0.110552765,0.04648241
2022.0,YEM,0,0,87,57,30,,,
2023.0,YEM,0,0,47,56,-9,,,
1996.0,ZAF,7277,7277,0,0,0,0.0,0.0,0.0
1997.0,ZAF,8513,8513,156,155,1,0.018207448,0.018324915,0.0001174674
1998.0,ZAF,9668,9668,182,224,-42,0.023169218,0.018824989,-0.004344228
1999.0,ZAF,10512,10512,284,264,20,0.025114154,0.027016742,0.0019025875
2000.0,ZAF,11148,11148,275,314,-39,0.028166488,0.024668101,-0.0034983854
2001.0,ZAF,11729,11729,342,396,-54,0.03376247,0.029158495,-0.004603973
2002.0,ZAF,12430,12430,394,407,-13,0.032743365,0.031697504,-0.0010458567
2003.0,ZAF,13017,13017,357,468,-111,0.035952985,0.027425675,-0.008527311
2004.0,ZAF,13899,13899,365,371,-6,0.026692567,0.026260883,-0.00043168574
2005.0,ZAF,14841,14841,406,337,69,0.022707365,0.027356647,0.0046492824
2006.0,ZAF,15958,15958,330,367,-37,0.02299787,0.020679284,-0.0023185862
2007.0,ZAF,17161,17161,398,361,37,0.02103607,0.023192123,0.0021560516
2008.0,ZAF,18481,18481,456,451,5,0.024403442,0.024673989,0.00027054813
2009.0,ZAF,19968,19968,482,452,30,0.022636218,0.024138622,0.0015024039
2010.0,ZAF,21531,21531,588,541,47,0.025126562,0.02730946,0.002182899
2011.0,ZAF,23277,23277,657,543,114,0.02332775,0.028225286,0.0048975386
2012.0,ZAF,25333,25333,681,580,101,0.022895038,0.026881933,0.0039868946
2013.0,ZAF,27361,27361,760,665,95,0.024304667,0.027776763,0.0034720954
2014.0,ZAF,29692,29692,851,643,208,0.021655666,0.02866092,0.007005254
2015.0,ZAF,31835,31835,859,761,98,0.023904508,0.026982881,0.003078373
2016.0,ZAF,33963,33963,908,825,83,0.024291141,0.026734976,0.0024438358
2017.0,ZAF,35564,35564,863,1137,-274,0.03197053,0.024266113,-0.00770442
2018.0,ZAF,37445,37445,984,1082,-98,0.028895713,0.026278542,-0.002617172
2019.0,ZAF,38747,38747,890,1141,-251,0.029447442,0.02296952,-0.006477921
2020.0,ZAF,38758,38758,878,1225,-347,0.03160638,0.022653388,-0.00895299
2021.0,ZAF,36933,36933,762,1270,-508,0.03438659,0.020631956,-0.013754637
2022.0,ZAF,0,0,719,1036,-317,,,
2023.0,ZAF,0,0,439,652,-213,,,
1996.0,ZMB,138,138,0,0,0,0.0,0.0,0.0
1997.0,ZMB,165,165,11,8,3,0.048484847,0.06666667,0.018181818
1998.0,ZMB,193,193,13,10,3,0.051813472,0.06735751,0.015544041
1999.0,ZMB,204,204,8,17,-9,0.083333336,0.039215688,-0.04411765
2000.0,ZMB,209,209,13,15,-2,0.07177033,0.062200956,-0.009569378
2001.0,ZMB,212,212,8,15,-7,0.070754714,0.03773585,-0.03301887
2002.0,ZMB,217,217,15,20,-5,0.0921659,0.06912442,-0.023041476
2003.0,ZMB,240,240,20,14,6,0.058333334,0.083333336,0.025
2004.0,ZMB,275,275,14,8,6,0.02909091,0.05090909,0.021818181
2005.0,ZMB,326,326,12,7,5,0.021472393,0.036809817,0.015337423
2006.0,ZMB,380,380,18,12,6,0.031578947,0.047368422,0.015789473
2007.0,ZMB,417,417,12,14,-2,0.033573143,0.02877698,-0.004796163
2008.0,ZMB,473,473,25,13,12,0.027484143,0.052854124,0.02536998
2009.0,ZMB,529,529,22,20,2,0.037807185,0.0415879,0.0037807184
2010.0,ZMB,593,593,24,18,6,0.030354131,0.040472176,0.010118044
2011.0,ZMB,657,657,32,32,0,0.04870624,0.04870624,0.0
2012.0,ZMB,754,754,33,23,10,0.030503979,0.043766577,0.0132626
2013.0,ZMB,884,884,40,42,-2,0.047511313,0.04524887,-0.0022624435
2014.0,ZMB,1011,1011,50,37,13,0.036597427,0.049455985,0.012858556
2015.0,ZMB,1147,1147,52,34,18,0.029642547,0.045335658,0.015693113
2016.0,ZMB,1265,1265,42,51,-9,0.040316205,0.033201583,-0.0071146246
2017.0,ZMB,1386,1386,70,43,27,0.03102453,0.05050505,0.019480519
2018.0,ZMB,1490,1490,66,64,2,0.04295302,0.044295304,0.0013422819
2019.0,ZMB,1607,1607,74,64,10,0.039825764,0.046048537,0.006222775
2020.0,ZMB,1663,1663,84,58,26,0.03487673,0.050511125,0.015634395
2021.0,ZMB,1635,1635,84,67,17,0.040978592,0.051376145,0.010397553
2022.0,ZMB,0,0,69,49,20,,,
1996.0,ZWE,506,506,0,0,0,0.0,0.0,0.0
1997.0,ZWE,618,618,22,20,2,0.03236246,0.035598706,0.003236246
1998.0,ZWE,706,706,35,31,4,0.04390935,0.04957507,0.0056657223
1999.0,ZWE,723,723,29,35,-6,0.048409406,0.04011065,-0.008298756
2000.0,ZWE,734,734,24,41,-17,0.05585831,0.032697547,-0.023160763
2001.0,ZWE,742,742,28,44,-16,0.05929919,0.03773585,-0.021563342
2002.0,ZWE,711,711,27,58,-31,0.081575245,0.03797468,-0.043600563
2003.0,ZWE,712,712,36,40,-4,0.056179777,0.050561797,-0.0056179776
2004.0,ZWE,740,740,29,55,-26,0.074324325,0.03918919,-0.035135135
2005.0,ZWE,782,782,29,54,-25,0.06905371,0.0370844,-0.03196931
2006.0,ZWE,792,792,25,55,-30,0.06944445,0.031565655,-0.03787879
2007.0,ZWE,789,789,21,61,-40,0.07731306,0.02661597,-0.050697085
2008.0,ZWE,815,815,24,60,-36,0.073619634,0.029447854,-0.04417178
2009.0,ZWE,823,823,22,80,-58,0.09720535,0.02673147,-0.07047388
2010.0,ZWE,869,869,26,68,-42,0.07825086,0.029919447,-0.048331417
2011.0,ZWE,1000,1000,50,57,-7,0.057,0.05,-0.007
2012.0,ZWE,1168,1168,40,53,-13,0.04537671,0.034246575,-0.011130137
2013.0,ZWE,1284,1284,70,67,3,0.052180685,0.054517135,0.0023364485
2014.0,ZWE,1425,1425,64,57,7,0.04,0.044912282,0.0049122805
2015.0,ZWE,1518,1518,56,83,-27,0.054677207,0.036890645,-0.01778656
2016.0,ZWE,1639,1639,73,84,-11,0.051250763,0.044539355,-0.0067114094
2017.0,ZWE,1752,1752,94,82,12,0.046803653,0.05365297,0.006849315
2018.0,ZWE,1918,1918,107,90,17,0.04692388,0.05578728,0.0088634
2019.0,ZWE,2048,2048,106,93,13,0.045410156,0.051757812,0.0063476562
2020.0,ZWE,2083,2083,89,99,-10,0.047527604,0.042726837,-0.004800768
2021.0,ZWE,2024,2024,113,121,-8,0.05978261,0.05583004,-0.0039525693
2022.0,ZWE,0,0,82,99,-17,,,
2023.0,ZWE,0,0,47,69,-22,,,
